,enrollment_id,username,course_id,no_of_objects3,bno_access3,bno_pageclose3,bno_problem3,bno_video3,bno_discussion3,bno_navigate3,bno_wiki3,bno_total3,bno_avg3,no_of_active_days3,time_consumption3,browser_access3,browser_pageclose3,browser_problem3,browser_video3,server_access3,server_discussion3,server_problem3,server_navigate3,server_wiki3,bno_browser3,bno_server3,label
0,3,1qXC7Fjbwp66GPQc6pHLfEuO8WKozxG4,7GRhBDsirIGkRZBtSMEzNTyDr2JQm4xx,25,15,6,28,4,21,2,0,76,10.857142857142858,2,-12754870.0,6,6,27,4,9,21,1,2,0,43,33,0
1,5,p1Mp7WkVfzUijX0peVQKSHbgd5pXyl4c,7GRhBDsirIGkRZBtSMEzNTyDr2JQm4xx,5,4,2,0,0,0,2,0,8,1.1428571428571428,1,0.0,1,2,0,0,3,0,0,2,0,3,5,0
2,7,I1KwJ6EdCZnEPLfC8Q7yWpIkLOHn7h02,7GRhBDsirIGkRZBtSMEzNTyDr2JQm4xx,38,72,16,28,34,15,3,0,168,24.0,3,0.0,51,16,23,34,21,15,5,3,0,124,44,1
3,45,5Tz6BGN7p1lkmdoopAY1Z5ufYTrUsi9E,7GRhBDsirIGkRZBtSMEzNTyDr2JQm4xx,50,154,49,73,36,27,13,0,352,50.285714285714285,6,0.0,74,49,59,36,80,27,14,13,0,218,134,0
4,49,2oTvbzieHn2y5oozeOgSnruqE6N0BtR5,7GRhBDsirIGkRZBtSMEzNTyDr2JQm4xx,23,52,26,0,12,221,31,0,342,48.857142857142854,7,0.0,12,26,0,12,40,221,0,31,0,50,292,0
5,50,LnNj9zDI8D38ixGOYTIjTH2iF5m36v9S,7GRhBDsirIGkRZBtSMEzNTyDr2JQm4xx,9,9,4,20,0,0,1,0,34,4.857142857142857,1,0.0,4,4,17,0,5,0,3,1,0,25,9,1
6,58,l9KseRU4xYtwOzoILYmGcicF0iiXQqxl,7GRhBDsirIGkRZBtSMEzNTyDr2JQm4xx,35,70,24,36,16,0,10,0,156,22.285714285714285,5,0.0,16,24,31,16,54,0,5,10,0,87,69,0
7,96,KXi2lu4GlKmrO1lJTLg3t4l701rvNXNZ,7GRhBDsirIGkRZBtSMEzNTyDr2JQm4xx,5,5,3,0,0,0,1,0,9,1.2857142857142858,1,0.0,1,3,0,0,4,0,0,1,0,4,5,1
8,141,CB4JYroUtmiKv572P6g4vrvJCi6Pzr9h,7GRhBDsirIGkRZBtSMEzNTyDr2JQm4xx,31,51,21,53,19,20,21,0,185,26.428571428571427,4,0.0,29,21,45,19,22,20,8,21,0,114,71,1
9,192,hCxbmPBmjgsEuMY36HnZH4x3BwWFnCUn,7GRhBDsirIGkRZBtSMEzNTyDr2JQm4xx,32,37,14,4,15,0,21,0,91,13.0,5,0.0,20,14,4,15,17,0,0,21,0,53,38,0
10,199,OEQBiRbbo3yEBzKSHcNX9ESBTSUy08ze,7GRhBDsirIGkRZBtSMEzNTyDr2JQm4xx,42,97,41,54,26,88,14,1,321,45.857142857142854,5,0.0,42,41,44,26,55,88,10,14,1,153,168,0
11,219,088SASUPOVYUGhoEly8vlrkGvRBJoNwp,7GRhBDsirIGkRZBtSMEzNTyDr2JQm4xx,7,17,4,0,0,0,2,0,23,3.2857142857142856,1,0.0,8,4,0,0,9,0,0,2,0,12,11,0
12,255,O6WL6sxvoPCZnvTLyTPxdXbnpOz3wcJ4,7GRhBDsirIGkRZBtSMEzNTyDr2JQm4xx,27,47,12,64,7,2,5,0,137,19.571428571428573,2,0.0,21,12,52,7,26,2,12,5,0,92,45,0
13,284,L9qMLlGWAeAI6zWAZIyJtn0wISNa3dxg,7GRhBDsirIGkRZBtSMEzNTyDr2JQm4xx,3,0,0,0,0,35,9,0,44,6.285714285714286,3,0.0,0,0,0,0,0,35,0,9,0,0,44,0
14,433,PEDnL2c66c2DN92O9BTVM9D6p19gGbT6,7GRhBDsirIGkRZBtSMEzNTyDr2JQm4xx,34,64,29,27,28,57,17,0,222,31.714285714285715,7,0.0,35,29,23,28,29,57,4,17,0,115,107,0
15,493,xNkIHhqS8GZXIqyoWwwS3ZeYfSmUsNJo,7GRhBDsirIGkRZBtSMEzNTyDr2JQm4xx,7,10,4,0,4,0,1,0,19,2.7142857142857144,3,0.0,1,4,0,4,9,0,0,1,0,9,10,0
16,630,BbZEGv8zMCuD8c0LXrenf9W1lGSlVd04,7GRhBDsirIGkRZBtSMEzNTyDr2JQm4xx,7,10,1,0,0,1,1,0,13,1.8571428571428572,1,0.0,0,1,0,0,10,1,0,1,0,1,12,1
17,777,bLIF0ETNcg7fjkutu8YBWJptM3zxtu2Z,7GRhBDsirIGkRZBtSMEzNTyDr2JQm4xx,37,83,27,58,34,16,18,0,236,33.714285714285715,4,0.0,53,27,53,34,30,16,5,18,0,167,69,0
18,780,anqtRE1JbVfWjk9aVYgpNXBcTCoFe9WO,7GRhBDsirIGkRZBtSMEzNTyDr2JQm4xx,47,79,31,0,29,11,17,3,170,24.285714285714285,4,0.0,41,31,0,29,38,11,0,17,3,101,69,1
19,884,c3CVim2QZeSVk1wACFUHDmf9ZjEIwtuP,7GRhBDsirIGkRZBtSMEzNTyDr2JQm4xx,31,67,19,90,18,0,4,0,198,28.285714285714285,2,0.0,44,19,73,18,23,0,17,4,0,154,44,0
20,936,Z4uUjFPFbGNbmcg4E2opeBQCoO0nQyZe,7GRhBDsirIGkRZBtSMEzNTyDr2JQm4xx,57,284,69,95,40,13,22,0,523,74.71428571428571,5,0.0,119,69,74,40,165,13,21,22,0,302,221,1
21,937,uQjl8NGtIQkRfoe9edBiMgtYYmdkzVXR,7GRhBDsirIGkRZBtSMEzNTyDr2JQm4xx,36,122,36,84,13,18,12,0,285,40.714285714285715,6,0.0,55,36,70,13,67,18,14,12,0,174,111,0
22,1030,uDdfaOyae5qLVYC8BQlj5xLhiV3is9wS,7GRhBDsirIGkRZBtSMEzNTyDr2JQm4xx,17,57,26,0,2,41,12,0,138,19.714285714285715,5,0.0,20,26,0,2,37,41,0,12,0,48,90,0
23,1090,9ct6Fth9rRpjZJrFIHs9xOnW9W5hBHw6,7GRhBDsirIGkRZBtSMEzNTyDr2JQm4xx,30,67,20,66,18,1,7,0,179,25.571428571428573,4,0.0,42,20,57,18,25,1,9,7,0,137,42,1
24,1134,Q3zkClKdiEJIkoKspwBuSNOwYXuxalAX,7GRhBDsirIGkRZBtSMEzNTyDr2JQm4xx,20,28,11,8,10,0,7,0,64,9.142857142857142,4,0.0,10,11,8,10,18,0,0,7,0,39,25,1
25,1147,gCxbOVEJ7FeSqOiwKbB6HzPEL3I9x6ca,7GRhBDsirIGkRZBtSMEzNTyDr2JQm4xx,5,4,3,0,0,0,1,0,8,1.1428571428571428,1,0.0,0,3,0,0,4,0,0,1,0,3,5,0
26,1206,ymJGsoe3Y9XwSfD9UhxMG8gRl87RdPUe,7GRhBDsirIGkRZBtSMEzNTyDr2JQm4xx,11,32,19,4,5,1,5,0,66,9.428571428571429,3,0.0,3,19,4,5,29,1,0,5,0,31,35,1
27,1223,o7MfiO1X5Ui1AYG08PXFhTcXSShcuNhK,7GRhBDsirIGkRZBtSMEzNTyDr2JQm4xx,36,61,33,66,22,13,11,3,209,29.857142857142858,4,0.0,20,33,61,22,41,13,5,11,3,136,73,0
28,1227,RuOAeaUVW53IP9AqfP0jxaXbNkmd7lKN,7GRhBDsirIGkRZBtSMEzNTyDr2JQm4xx,6,5,0,14,0,0,5,0,24,3.4285714285714284,1,0.0,3,0,11,0,2,0,3,5,0,14,10,0
29,1252,mZIaM3Lmux7GERtSm258BKPOSUYFlwyy,7GRhBDsirIGkRZBtSMEzNTyDr2JQm4xx,37,117,38,40,21,53,15,0,284,40.57142857142857,5,0.0,30,38,31,21,87,53,9,15,0,120,164,0
30,1260,beV03mdN2n7VoZwDqBMCKGETqOChXWUx,7GRhBDsirIGkRZBtSMEzNTyDr2JQm4xx,28,81,23,39,10,17,11,3,184,26.285714285714285,2,0.0,34,23,36,10,47,17,3,11,3,103,81,0
31,1289,zlsPhArkUaQ0CCdgZTO1797WJjiciHBk,7GRhBDsirIGkRZBtSMEzNTyDr2JQm4xx,23,35,14,57,3,38,7,1,155,22.142857142857142,1,0.0,16,14,47,3,19,38,10,7,1,80,75,0
32,1315,kNG9cn23NW62SZcqQSqyW9wMtO0GajdN,7GRhBDsirIGkRZBtSMEzNTyDr2JQm4xx,48,94,24,147,21,6,10,1,303,43.285714285714285,3,0.0,62,24,123,21,32,6,24,10,1,230,73,0
33,1429,YbP52dGau1RB8H6599HdGbUKOVHWxxw1,7GRhBDsirIGkRZBtSMEzNTyDr2JQm4xx,62,166,72,105,13,0,9,0,365,52.142857142857146,4,0.0,73,72,72,13,93,0,33,9,0,230,135,0
34,1450,q88579uTDrz7tsNTbZoL3mbWXAP4ClqK,7GRhBDsirIGkRZBtSMEzNTyDr2JQm4xx,55,79,29,8,26,9,26,5,182,26.0,3,0.0,42,29,8,26,37,9,0,26,5,105,77,0
35,1472,Qc7qhDYnMQ0se5itn8lyxOFjZ1zzyfhE,7GRhBDsirIGkRZBtSMEzNTyDr2JQm4xx,42,109,19,124,26,40,27,2,347,49.57142857142857,4,0.0,55,19,110,26,54,40,14,27,2,210,137,0
36,1491,lCyf3TRKW0i3K1mBgKz23OONMdCWqNsI,7GRhBDsirIGkRZBtSMEzNTyDr2JQm4xx,50,176,6,131,21,17,30,3,384,54.857142857142854,4,0.0,106,6,114,21,70,17,17,30,3,247,137,0
37,1502,1rAHmNrxrqnzHEQFMlydmQ968LsZW0oG,7GRhBDsirIGkRZBtSMEzNTyDr2JQm4xx,9,11,7,4,7,1,0,0,30,4.285714285714286,1,0.0,3,7,4,7,8,1,0,0,0,21,9,0
38,1529,DT600yQDJaU6nnkoEQdVx5gZnWz5FfNY,7GRhBDsirIGkRZBtSMEzNTyDr2JQm4xx,18,27,6,84,2,8,3,0,130,18.571428571428573,1,0.0,17,6,74,2,10,8,10,3,0,99,31,0
39,1576,d9rEzZ3v1PmiMyudpVDJ4ystf1RU9dCH,7GRhBDsirIGkRZBtSMEzNTyDr2JQm4xx,6,3,2,0,1,0,2,0,8,1.1428571428571428,1,0.0,0,2,0,1,3,0,0,2,0,3,5,1
40,1593,rLQXRKLwDTvBugA3fH8VUxASy31pAAsE,7GRhBDsirIGkRZBtSMEzNTyDr2JQm4xx,20,41,16,12,5,17,5,0,96,13.714285714285714,4,0.0,15,16,10,5,26,17,2,5,0,46,50,1
41,1594,argwyep7vMTLtgODtMQ0gxLXJNoq9csR,7GRhBDsirIGkRZBtSMEzNTyDr2JQm4xx,10,34,6,6,7,0,4,0,57,8.142857142857142,3,0.0,12,6,6,7,22,0,0,4,0,31,26,1
42,1616,Bi4hHmeTLwTbUCScu9tC6ZZN7frLUhVP,7GRhBDsirIGkRZBtSMEzNTyDr2JQm4xx,58,132,43,84,24,0,9,0,292,41.714285714285715,2,0.0,68,43,82,24,64,0,2,9,0,217,75,0
43,1630,BN8wlDCfm46NLUt2P4jjdpJvase6IJc9,7GRhBDsirIGkRZBtSMEzNTyDr2JQm4xx,4,4,1,0,0,0,1,0,6,0.8571428571428571,1,0.0,1,1,0,0,3,0,0,1,0,2,4,1
44,1651,iR2FNNwwVPECfrAWwxLxHcw8art5BqJj,7GRhBDsirIGkRZBtSMEzNTyDr2JQm4xx,52,149,48,55,51,7,8,0,318,45.42857142857143,3,0.0,72,48,36,51,77,7,19,8,0,207,111,0
45,1697,LdIFMEp4Gma3xMuOQ2mpp1BJ3jFvB9c2,7GRhBDsirIGkRZBtSMEzNTyDr2JQm4xx,47,90,25,72,29,0,1,0,217,31.0,5,0.0,32,25,59,29,58,0,13,1,0,145,72,0
46,1708,PVIjAE0m0OeJAYOHc5gIjzktRijtXdS4,7GRhBDsirIGkRZBtSMEzNTyDr2JQm4xx,33,69,24,62,12,4,9,1,181,25.857142857142858,3,0.0,37,24,53,12,32,4,9,9,1,126,55,1
47,1755,qLrXKwo0jPQz47eKqKRnMiywjqEMxYd1,7GRhBDsirIGkRZBtSMEzNTyDr2JQm4xx,92,173,52,135,46,16,17,0,439,62.714285714285715,5,0.0,66,52,119,46,107,16,16,17,0,283,156,0
48,1756,wc32nzp9MMjroUa1gifXyCPIfYwLXy9J,7GRhBDsirIGkRZBtSMEzNTyDr2JQm4xx,3,3,2,0,2,0,0,0,7,1.0,2,0.0,0,2,0,2,3,0,0,0,0,4,3,1
49,1788,ZsmdkNcVTPviDi6RDTzc0nnIspFki9Ld,7GRhBDsirIGkRZBtSMEzNTyDr2JQm4xx,21,29,19,20,2,6,4,0,80,11.428571428571429,1,0.0,9,19,18,2,20,6,2,4,0,48,32,0
50,1804,qRMvc4T53dkwmyfrgm76E5HygPUZo2vr,fbPkOYLVPtPgIt0MxizjfFJov3JbHyAi,13,23,11,5,3,17,8,0,67,9.571428571428571,5,0.0,4,11,4,3,19,17,1,8,0,22,45,0
51,1807,tvXgoUvFgvHT9SyDah6Ue0bK2mvIbZdy,fbPkOYLVPtPgIt0MxizjfFJov3JbHyAi,22,55,36,15,10,20,6,0,142,20.285714285714285,3,0.0,12,36,13,10,43,20,2,6,0,71,71,0
52,1815,EZXku3HiM8iDGMBMsO2RMLHj3AEpHhBq,fbPkOYLVPtPgIt0MxizjfFJov3JbHyAi,22,49,0,11,12,22,8,2,104,14.857142857142858,2,0.0,27,0,10,12,22,22,1,8,2,49,55,0
53,1819,dg1Id0ZrueajjkgW22Z2GRzCY20snksW,fbPkOYLVPtPgIt0MxizjfFJov3JbHyAi,2,0,0,0,0,0,3,0,3,0.42857142857142855,2,0.0,0,0,0,0,0,0,0,3,0,0,3,1
54,1822,v1Dw0XqubI6wLrO1l5puralkQ2Aofi2j,fbPkOYLVPtPgIt0MxizjfFJov3JbHyAi,25,46,18,13,15,38,10,0,140,20.0,6,0.0,22,18,10,15,24,38,3,10,0,65,75,0
55,1823,SnTftKVvcKGSnHeK28R5spRYYXrrxUfB,fbPkOYLVPtPgIt0MxizjfFJov3JbHyAi,7,5,3,0,2,0,4,0,14,2.0,1,0.0,0,3,0,2,5,0,0,4,0,5,9,1
56,1826,5BwluL2iwK0HgKhM8FgXFAWZQHsXkB8V,fbPkOYLVPtPgIt0MxizjfFJov3JbHyAi,6,9,1,0,0,12,5,0,27,3.857142857142857,2,0.0,0,1,0,0,9,12,0,5,0,1,26,0
57,1827,tfcv93vJo2GySad9H44VOkIGpLaZ6vJT,fbPkOYLVPtPgIt0MxizjfFJov3JbHyAi,43,124,56,34,28,106,28,1,377,53.857142857142854,5,0.0,44,56,29,28,80,106,5,28,1,157,220,0
58,1830,dtAiYXul2PNEQLlJvo6qGgg8Rx9ORbY3,fbPkOYLVPtPgIt0MxizjfFJov3JbHyAi,5,4,3,0,1,0,2,0,10,1.4285714285714286,1,0.0,0,3,0,1,4,0,0,2,0,4,6,1
59,1832,IIfD9UPHJEG512IBEQGZwkZbr6HRQ12X,fbPkOYLVPtPgIt0MxizjfFJov3JbHyAi,12,5,3,7,3,0,5,0,23,3.2857142857142856,1,0.0,1,3,4,3,4,0,3,5,0,11,12,1
60,1835,EF6CIWnoQbVOAhqoxFyrjqUraX7wKiE2,fbPkOYLVPtPgIt0MxizjfFJov3JbHyAi,7,3,1,0,1,0,5,0,10,1.4285714285714286,1,0.0,0,1,0,1,3,0,0,5,0,2,8,1
61,1845,oaoj9be4jW2Hot8wYgYrzLRvB0RU4KYy,fbPkOYLVPtPgIt0MxizjfFJov3JbHyAi,3,4,2,0,0,0,3,0,9,1.2857142857142858,2,0.0,0,2,0,0,4,0,0,3,0,2,7,0
62,1856,ScOtpH9Zf7UmvFfXBxi9XtXFmhGO9CpS,fbPkOYLVPtPgIt0MxizjfFJov3JbHyAi,20,48,12,13,22,9,4,0,108,15.428571428571429,4,0.0,33,12,13,22,15,9,0,4,0,80,28,0
63,1859,renLevNnf6MkkqeGAoBcuGxp4Cuebb9X,fbPkOYLVPtPgIt0MxizjfFJov3JbHyAi,6,4,2,0,1,0,1,0,8,1.1428571428571428,1,0.0,0,2,0,1,4,0,0,1,0,3,5,0
64,1861,wHW6M4zJx3WQvnkWxa8NK7bA13uSffjE,fbPkOYLVPtPgIt0MxizjfFJov3JbHyAi,27,76,39,14,17,84,32,7,269,38.42857142857143,7,0.0,21,39,12,17,55,84,2,32,7,89,180,0
65,1891,s6iksgptFmyh2vfiarKdJkiKnp6RLi3f,fbPkOYLVPtPgIt0MxizjfFJov3JbHyAi,6,6,3,0,0,5,1,0,15,2.142857142857143,1,0.0,0,3,0,0,6,5,0,1,0,3,12,0
66,1894,Vc4rFh1HQZiO6qLgOrealEeiZYYPbmOY,fbPkOYLVPtPgIt0MxizjfFJov3JbHyAi,20,26,11,24,6,6,3,0,76,10.857142857142858,2,0.0,5,11,19,6,21,6,5,3,0,41,35,0
67,1899,CXDFvBGg10x2RDdl5BC09Fv76dN9FJm7,fbPkOYLVPtPgIt0MxizjfFJov3JbHyAi,21,35,8,20,7,4,5,0,79,11.285714285714286,1,0.0,15,8,20,7,20,4,0,5,0,50,29,0
68,1903,TkQQvYTOoXkFjbJKIO2v3OeQa3imG4fA,fbPkOYLVPtPgIt0MxizjfFJov3JbHyAi,22,36,9,5,12,3,6,0,71,10.142857142857142,3,0.0,20,9,5,12,16,3,0,6,0,46,25,0
69,1910,CtgLRd04Cnda49EWlN19NulXjkuBNDXd,fbPkOYLVPtPgIt0MxizjfFJov3JbHyAi,5,12,1,0,0,3,1,0,17,2.4285714285714284,1,0.0,0,1,0,0,12,3,0,1,0,1,16,0
70,1913,OXDIjQPBiuWpB7PdzfniEtiITaq40Kxq,fbPkOYLVPtPgIt0MxizjfFJov3JbHyAi,1,0,0,0,0,0,2,0,2,0.2857142857142857,1,0.0,0,0,0,0,0,0,0,2,0,0,2,1
71,1922,ddq0oVEKEWGKWnbGS4cfbzVZj0yFimxw,fbPkOYLVPtPgIt0MxizjfFJov3JbHyAi,19,28,19,9,7,0,5,0,68,9.714285714285714,4,0.0,5,19,9,7,23,0,0,5,0,40,28,0
72,1923,UgNr6maIjrTPAjpLAvEGxJ6P02hrpr0j,fbPkOYLVPtPgIt0MxizjfFJov3JbHyAi,9,11,6,2,2,0,4,0,25,3.5714285714285716,3,0.0,1,6,2,2,10,0,0,4,0,11,14,0
73,1931,gUUf0vmNg6gEFqYol91VXQX0Cn6Mly3v,fbPkOYLVPtPgIt0MxizjfFJov3JbHyAi,22,25,18,5,13,0,3,4,68,9.714285714285714,1,0.0,7,18,5,13,18,0,0,3,4,43,25,0
74,1932,0QuoKrP2mZHT58SMwYhNVh8QIa2Bx3jw,fbPkOYLVPtPgIt0MxizjfFJov3JbHyAi,17,17,11,0,9,3,8,3,51,7.285714285714286,1,0.0,2,11,0,9,15,3,0,8,3,22,29,0
75,1933,mNLR1O6gqXF6Zqi4uIf130gITni9gN1A,fbPkOYLVPtPgIt0MxizjfFJov3JbHyAi,23,34,19,6,11,11,6,1,88,12.571428571428571,4,0.0,5,19,6,11,29,11,0,6,1,41,47,0
76,1939,GpNHaNdhxCDdSQ7DpRSuzDihSlnkIh3f,fbPkOYLVPtPgIt0MxizjfFJov3JbHyAi,9,2,1,0,1,0,5,1,10,1.4285714285714286,1,0.0,0,1,0,1,2,0,0,5,1,2,8,1
77,1940,a7VEIs7rhyootOFOxpi9zJBtM0N2POJ5,fbPkOYLVPtPgIt0MxizjfFJov3JbHyAi,5,4,2,0,1,0,1,0,8,1.1428571428571428,1,0.0,1,2,0,1,3,0,0,1,0,4,4,1
78,1943,S1MqxZA8wNnn30FSBfJ8uK4pTicj2Ko9,fbPkOYLVPtPgIt0MxizjfFJov3JbHyAi,20,33,17,7,7,1,8,2,75,10.714285714285714,2,0.0,8,17,7,7,25,1,0,8,2,39,36,0
79,3986,lri3Bm6mGdJ1wEpJO4c8fcTdLtxpvXa6,fbPkOYLVPtPgIt0MxizjfFJov3JbHyAi,5,6,4,0,0,4,4,0,18,2.5714285714285716,1,0.0,0,4,0,0,6,4,0,4,0,4,14,0
80,3991,affppoxqvCZhtMd3A1khAMJ6PTtvZhf9,fbPkOYLVPtPgIt0MxizjfFJov3JbHyAi,20,25,16,4,4,6,15,10,80,11.428571428571429,2,0.0,3,16,3,4,22,6,1,15,10,26,54,1
81,3999,4IkxYjTflPhoHxhEdrFyf3T4ZXNMTaKd,fbPkOYLVPtPgIt0MxizjfFJov3JbHyAi,21,55,19,12,5,0,11,0,102,14.571428571428571,3,0.0,10,19,10,5,45,0,2,11,0,44,58,0
82,4000,A8rz0vMThAU17OyS7TiHPCSZ088mScoQ,fbPkOYLVPtPgIt0MxizjfFJov3JbHyAi,10,12,8,0,3,0,3,0,26,3.7142857142857144,1,0.0,0,8,0,3,12,0,0,3,0,11,15,1
83,4016,0OQWZBG0W4kepi8nreWMZMMypwSc3KLe,fbPkOYLVPtPgIt0MxizjfFJov3JbHyAi,5,7,3,0,0,7,4,0,21,3.0,1,0.0,2,3,0,0,5,7,0,4,0,5,16,0
84,4018,PueCTOZid1NIenGrGQNvEExDupERGR94,fbPkOYLVPtPgIt0MxizjfFJov3JbHyAi,3,2,1,0,0,0,1,0,4,0.5714285714285714,1,0.0,0,1,0,0,2,0,0,1,0,1,3,1
85,4021,2txyeJeVHewFPGKztIs7LVNsRtu62SIj,fbPkOYLVPtPgIt0MxizjfFJov3JbHyAi,7,5,3,6,1,0,1,0,16,2.2857142857142856,1,0.0,1,3,5,1,4,0,1,1,0,10,6,0
86,4024,UInMBEH8f1h2vxXVslRsWyLOTv8ggYq3,fbPkOYLVPtPgIt0MxizjfFJov3JbHyAi,8,16,8,0,1,0,6,0,31,4.428571428571429,3,0.0,0,8,0,1,16,0,0,6,0,9,22,0
87,4054,hOv5RKQK1RGRxpJJGcW0k2cA3RwQ8Rk5,fbPkOYLVPtPgIt0MxizjfFJov3JbHyAi,2,0,0,0,0,0,2,0,2,0.2857142857142857,1,0.0,0,0,0,0,0,0,0,2,0,0,2,1
88,4062,GfQva8AQrZlwGbvyDGDInKzkvq0dln6l,fbPkOYLVPtPgIt0MxizjfFJov3JbHyAi,10,12,5,0,6,0,1,0,24,3.4285714285714284,1,0.0,4,5,0,6,8,0,0,1,0,15,9,1
89,4070,bUizg9a7xaQ9xo39EDPwubco3asipi0e,fbPkOYLVPtPgIt0MxizjfFJov3JbHyAi,20,16,14,0,9,3,2,0,44,6.285714285714286,2,0.0,0,14,0,9,16,3,0,2,0,23,21,1
90,4071,HH3HV5HDJ35z2ldQAEIDXBOSBTxLd6O9,fbPkOYLVPtPgIt0MxizjfFJov3JbHyAi,5,5,3,0,1,0,2,0,11,1.5714285714285714,2,0.0,0,3,0,1,5,0,0,2,0,4,7,1
91,4072,kHp5QZURLzbWn4koqFYZnQmO0kliz5hb,fbPkOYLVPtPgIt0MxizjfFJov3JbHyAi,4,3,2,0,0,0,1,0,6,0.8571428571428571,1,0.0,0,2,0,0,3,0,0,1,0,2,4,0
92,4084,a4RYqILKcnu8c617gYSbD0KQIm9DqZnc,fbPkOYLVPtPgIt0MxizjfFJov3JbHyAi,3,2,0,0,0,0,1,0,3,0.42857142857142855,1,0.0,0,0,0,0,2,0,0,1,0,0,3,1
93,4095,ijFjDmHOLiyu54Ko0v4roRDWdDCIX5i1,fbPkOYLVPtPgIt0MxizjfFJov3JbHyAi,52,67,38,34,21,25,10,0,195,27.857142857142858,6,0.0,13,38,30,21,54,25,4,10,0,102,93,0
94,4126,u4TNxfYOFL4kSz0gq3emLn9aOKma8Z0X,fbPkOYLVPtPgIt0MxizjfFJov3JbHyAi,2,1,1,0,0,0,0,0,2,0.2857142857142857,1,0.0,0,1,0,0,1,0,0,0,0,1,1,1
95,4127,iMXZvpdXIEwupZ3KLZs1wDk19TeUIZDi,fbPkOYLVPtPgIt0MxizjfFJov3JbHyAi,23,38,15,19,15,13,6,0,106,15.142857142857142,4,0.0,16,15,17,15,22,13,2,6,0,63,43,1
96,4133,sT9hGAnww95aeGvqwQpJlS3ORhWDT49F,fbPkOYLVPtPgIt0MxizjfFJov3JbHyAi,21,34,18,7,9,9,6,0,83,11.857142857142858,1,0.0,9,18,7,9,25,9,0,6,0,43,40,0
97,4136,WfTazznjeVMuts1c6fhfvqWuaprKs7C3,fbPkOYLVPtPgIt0MxizjfFJov3JbHyAi,8,5,3,0,2,46,10,0,66,9.428571428571429,2,0.0,0,3,0,2,5,46,0,10,0,5,61,1
98,4137,Z9qi5pq1C1bndfjP0mrTCfL8YAf6Qiv7,fbPkOYLVPtPgIt0MxizjfFJov3JbHyAi,14,17,9,7,10,0,2,0,45,6.428571428571429,1,0.0,8,9,6,10,9,0,1,2,0,33,12,0
99,4143,9sFMHkQmozo76x80tFTC9ms1LtFpAvDD,fbPkOYLVPtPgIt0MxizjfFJov3JbHyAi,20,26,7,15,12,0,2,0,62,8.857142857142858,1,0.0,19,7,14,12,7,0,1,2,0,52,10,0
100,4157,ZfaQRDpYRWxr1tKliyWhtiIkOEpZJsx1,fbPkOYLVPtPgIt0MxizjfFJov3JbHyAi,8,11,8,0,0,7,2,0,28,4.0,1,0.0,0,8,0,0,11,7,0,2,0,8,20,1
101,4164,6PFF6a3rTtp143lPxgdGFZZ0CCZBKH49,fbPkOYLVPtPgIt0MxizjfFJov3JbHyAi,26,36,12,12,13,0,4,3,80,11.428571428571429,1,0.0,17,12,10,13,19,0,2,4,3,52,28,1
102,4171,uHgH8m4GJET0eE5mE8JCyLZD7HEKwM4t,SpATywNh6bZuzm8s1ceuBUnMUAeoAHHw,2,0,0,0,0,0,2,0,2,0.2857142857142857,2,0.0,0,0,0,0,0,0,0,2,0,0,2,0
103,4182,HgeZmyLysCZF827lPwLNCfqcskKVvNDd,SpATywNh6bZuzm8s1ceuBUnMUAeoAHHw,12,18,2,9,0,14,12,0,55,7.857142857142857,3,0.0,2,2,9,0,16,14,0,12,0,13,42,0
104,4218,EReWp6ilgaQY61GGX2jAkIc5IQisheJq,SpATywNh6bZuzm8s1ceuBUnMUAeoAHHw,27,27,12,34,6,0,6,0,85,12.142857142857142,4,0.0,8,12,28,6,19,0,6,6,0,54,31,1
105,4219,Jm4nQ05ndX10jbofbWx6S0r9VXrqia6S,bWdj2GDclj5ofokWjzoa5jAwMkxCykd6,3,2,1,0,0,0,1,0,4,0.5714285714285714,1,0.0,0,1,0,0,2,0,0,1,0,1,3,0
106,4237,SVFfJJhaWd2RlHPtvg5SWBRGj8N0paMQ,SpATywNh6bZuzm8s1ceuBUnMUAeoAHHw,7,11,4,0,0,0,13,0,28,4.0,5,0.0,0,4,0,0,11,0,0,13,0,4,24,0
107,4238,hevZgCUVQAVwtaivzco7bLaVpTOAAfiG,SpATywNh6bZuzm8s1ceuBUnMUAeoAHHw,5,10,7,0,1,0,0,0,18,2.5714285714285716,3,0.0,2,7,0,1,8,0,0,0,0,10,8,0
108,4247,0NGZq9HZW5KOrSfzSGGipuN20pCRDMWu,G8EPVSXsOYB5YQWZGiz1aVq5Pgr2GrQu,19,90,35,0,5,25,21,1,177,25.285714285714285,1,0.0,12,35,0,5,78,25,0,21,1,52,125,0
109,4250,DHUv7XpIZcPp2QYGNmTXjhgg7Zq4BpJ7,SpATywNh6bZuzm8s1ceuBUnMUAeoAHHw,8,8,4,0,3,0,1,0,16,2.2857142857142856,1,0.0,3,4,0,3,5,0,0,1,0,10,6,1
110,4254,J5PQMceXoOVyN05md7NqKfAhSfcgJgVJ,SpATywNh6bZuzm8s1ceuBUnMUAeoAHHw,2,0,0,0,0,7,1,0,8,1.1428571428571428,1,0.0,0,0,0,0,0,7,0,1,0,0,8,0
111,4268,nYFWhKbFKiXgZ193lmJEmg3xQ65UNrPv,SpATywNh6bZuzm8s1ceuBUnMUAeoAHHw,6,4,3,3,2,0,0,0,12,1.7142857142857142,1,0.0,2,3,3,2,2,0,0,0,0,10,2,1
112,4270,xmsckIAcvM2S7rjWsHHPvyDsjVFjwdMr,SpATywNh6bZuzm8s1ceuBUnMUAeoAHHw,20,34,1,22,0,13,5,0,75,10.714285714285714,3,0.0,11,1,20,0,23,13,2,5,0,32,43,1
113,4278,iVNWfvqx80bYGUpxbD5kOVH2Fugs6QtQ,SpATywNh6bZuzm8s1ceuBUnMUAeoAHHw,1,0,0,0,0,0,2,0,2,0.2857142857142857,2,0.0,0,0,0,0,0,0,0,2,0,0,2,0
114,4286,i9UIJe9BPLqUSVYMtAIMhpSeBf6cbruQ,SpATywNh6bZuzm8s1ceuBUnMUAeoAHHw,4,5,3,0,1,0,0,0,9,1.2857142857142858,4,0.0,1,3,0,1,4,0,0,0,0,5,4,0
115,4290,EVhDvNThWnvwe7HGJiMKoMo6EeAXDH9R,bWdj2GDclj5ofokWjzoa5jAwMkxCykd6,9,4,3,0,1,1,5,3,17,2.4285714285714284,1,0.0,0,3,0,1,4,1,0,5,3,4,13,1
116,4292,5IOZn10arhSe83Sz47oGoyNxbAFXZkA2,SpATywNh6bZuzm8s1ceuBUnMUAeoAHHw,8,8,0,0,0,0,1,0,9,1.2857142857142858,1,0.0,0,0,0,0,8,0,0,1,0,0,9,1
117,4301,QOK5LHvwN0A5g3JhxMPHBffh5Rh2wZF8,SpATywNh6bZuzm8s1ceuBUnMUAeoAHHw,6,5,1,0,0,2,1,0,9,1.2857142857142858,1,0.0,0,1,0,0,5,2,0,1,0,1,8,1
118,4313,l80sDXQh6tFmRSRsJvWJgP55drvQUfT2,SpATywNh6bZuzm8s1ceuBUnMUAeoAHHw,16,30,9,14,2,0,24,1,80,11.428571428571429,3,0.0,8,9,13,2,22,0,1,24,1,32,48,1
119,4327,glS180WZt8C6hB13WP6NUijid7zN96cg,SpATywNh6bZuzm8s1ceuBUnMUAeoAHHw,1,0,0,0,0,0,1,0,1,0.14285714285714285,1,0.0,0,0,0,0,0,0,0,1,0,0,1,0
120,4342,gqe5NXbZbf5uXY0rPviLeIFOMpQyekdp,G8EPVSXsOYB5YQWZGiz1aVq5Pgr2GrQu,38,37,3,70,4,0,7,0,121,17.285714285714285,5,0.0,1,3,62,4,36,0,8,7,0,70,51,1
121,4344,xq251j4u37TVpTeMx1v6QtnvJbeUYzjd,SpATywNh6bZuzm8s1ceuBUnMUAeoAHHw,19,44,7,12,0,0,18,0,81,11.571428571428571,3,0.0,4,7,11,0,40,0,1,18,0,22,59,1
122,4352,3OBHdoV61de7ICMrnWAXr689Eb2AyuN0,SpATywNh6bZuzm8s1ceuBUnMUAeoAHHw,20,17,11,14,6,10,10,1,69,9.857142857142858,3,0.0,2,11,13,6,15,10,1,10,1,32,37,0
123,4361,jygZDxdNc5vnyQVPVME6xQbLWCY2Zptq,SpATywNh6bZuzm8s1ceuBUnMUAeoAHHw,4,5,1,0,1,0,0,0,7,1.0,1,0.0,0,1,0,1,5,0,0,0,0,2,5,1
124,4364,dVnTQl9ANUhHsXIPIWBdmTgLVkOgcfeV,bWdj2GDclj5ofokWjzoa5jAwMkxCykd6,5,2,1,0,1,0,2,0,6,0.8571428571428571,1,0.0,0,1,0,1,2,0,0,2,0,2,4,1
125,4365,ebO6e76NCFlMeek1yPjM9gz3mJBPl1yH,RXDvfPUBYFlVdlueBFbLW0mhhAyGEqpt,72,86,49,137,21,43,26,2,364,52.0,4,0.0,18,49,131,21,68,43,6,26,2,219,145,1
126,4395,C6xrhZPOmVH2gCVNP26gSSPka2CcwgB5,SpATywNh6bZuzm8s1ceuBUnMUAeoAHHw,11,4,4,2,3,0,5,0,18,2.5714285714285716,1,0.0,0,4,2,3,4,0,0,5,0,9,9,1
127,4396,5c5BMuD35oybcLij9FEBpLM3FZXJ5QAD,G8EPVSXsOYB5YQWZGiz1aVq5Pgr2GrQu,28,55,5,24,2,1,25,1,113,16.142857142857142,5,0.0,6,5,19,2,49,1,5,25,1,32,81,0
128,4406,U0MChqulsymiJYCtbj873TXGFuXiZDFk,SpATywNh6bZuzm8s1ceuBUnMUAeoAHHw,1,0,0,0,0,0,3,0,3,0.42857142857142855,2,0.0,0,0,0,0,0,0,0,3,0,0,3,0
129,4430,sWkTuB7KUS6C7uaxH84rlQvKN8aRF9JC,bWdj2GDclj5ofokWjzoa5jAwMkxCykd6,3,2,1,0,0,8,4,0,15,2.142857142857143,1,0.0,0,1,0,0,2,8,0,4,0,1,14,1
130,4432,kdQVQcPehC1WZyKhleQe5vDaCQv1dpj8,SpATywNh6bZuzm8s1ceuBUnMUAeoAHHw,17,13,7,16,3,3,6,1,49,7.0,3,0.0,2,7,16,3,11,3,0,6,1,28,21,0
131,4435,bN6JhUz4s97Xsh7eq2ZH1ilTMaKJDuUF,bWdj2GDclj5ofokWjzoa5jAwMkxCykd6,8,27,5,0,3,5,3,0,43,6.142857142857143,6,0.0,1,5,0,3,26,5,0,3,0,9,34,0
132,4440,ZhTCqX8GMUcn0a0betuEauHNuCk1aRhm,bWdj2GDclj5ofokWjzoa5jAwMkxCykd6,17,26,10,16,4,33,6,0,95,13.571428571428571,2,0.0,4,10,16,4,22,33,0,6,0,34,61,0
133,4453,4sZlPbPnBCwNHbrOUXcVAiPkTKHriJTV,SpATywNh6bZuzm8s1ceuBUnMUAeoAHHw,3,2,0,0,0,0,3,0,5,0.7142857142857143,2,0.0,0,0,0,0,2,0,0,3,0,0,5,0
134,4454,lMy0A59BRo4770ALzvOjsBS5HJkCRV78,bWdj2GDclj5ofokWjzoa5jAwMkxCykd6,19,16,9,12,3,0,12,0,52,7.428571428571429,1,0.0,3,9,12,3,13,0,0,12,0,27,25,1
135,4481,XjrP1VAGwJCwkRm4KgImIkZYNjnvGQN9,RXDvfPUBYFlVdlueBFbLW0mhhAyGEqpt,23,60,13,0,8,57,34,8,180,25.714285714285715,7,0.0,9,13,0,8,51,57,0,34,8,30,150,0
136,4498,dxoTIhhPXBvqzWGLltH0slJdxsuyggjI,G8EPVSXsOYB5YQWZGiz1aVq5Pgr2GrQu,8,3,2,0,1,17,9,0,32,4.571428571428571,3,0.0,0,2,0,1,3,17,0,9,0,3,29,0
137,4499,2ZP4iw9joeRPfEuWLWQQFnKchFtuqx5l,SpATywNh6bZuzm8s1ceuBUnMUAeoAHHw,5,3,2,2,0,0,1,0,8,1.1428571428571428,1,0.0,0,2,2,0,3,0,0,1,0,4,4,0
138,4506,j1jdy8OF5VQw4rqSYOkbK2pQplvvvz37,G8EPVSXsOYB5YQWZGiz1aVq5Pgr2GrQu,23,35,9,18,1,21,11,4,99,14.142857142857142,5,0.0,7,9,14,1,28,21,4,11,4,31,68,0
139,4507,HuDaXYBstQFpbEGg5tkyPhxLKzB3hVSB,SpATywNh6bZuzm8s1ceuBUnMUAeoAHHw,4,16,8,0,0,0,10,0,34,4.857142857142857,7,0.0,0,8,0,0,16,0,0,10,0,8,26,0
140,4524,j1jdy8OF5VQw4rqSYOkbK2pQplvvvz37,bWdj2GDclj5ofokWjzoa5jAwMkxCykd6,14,33,4,10,2,0,11,0,60,8.571428571428571,3,0.0,5,4,9,2,28,0,1,11,0,20,40,1
141,4547,fczke4UuC99kQHbLPBF9eDbT99FMycXd,SpATywNh6bZuzm8s1ceuBUnMUAeoAHHw,3,0,0,0,0,0,6,0,6,0.8571428571428571,2,0.0,0,0,0,0,0,0,0,6,0,0,6,0
142,4548,kla9cpzzaIqMfwRx5dULfeceoZisiJXJ,SpATywNh6bZuzm8s1ceuBUnMUAeoAHHw,5,2,1,0,0,4,10,1,18,2.5714285714285716,4,0.0,0,1,0,0,2,4,0,10,1,1,17,0
143,4560,LUmOTPPHIX2y7l2dFV3yMvYCAxk1M4FC,SpATywNh6bZuzm8s1ceuBUnMUAeoAHHw,18,38,27,0,0,1,14,3,83,11.857142857142858,2,0.0,5,27,0,0,33,1,0,14,3,32,51,1
144,4571,PUW0i4IuafllkJEtV0GCqmTDeLHkDmH3,bWdj2GDclj5ofokWjzoa5jAwMkxCykd6,2,0,0,0,0,8,1,0,9,1.2857142857142858,1,0.0,0,0,0,0,0,8,0,1,0,0,9,0
145,4585,HqsJVGNbokPBStWiDvKZXbvoLlDHixpp,SpATywNh6bZuzm8s1ceuBUnMUAeoAHHw,13,39,6,12,0,0,4,0,61,8.714285714285714,4,0.0,22,6,10,0,17,0,2,4,0,38,23,0
146,4598,izDb8XjXh0aaLsv56xtUKjGq4nGYtog4,G8EPVSXsOYB5YQWZGiz1aVq5Pgr2GrQu,51,62,50,0,25,0,5,0,142,20.285714285714285,3,0.0,7,50,0,25,55,0,0,5,0,82,60,0
147,4610,sZNhT3IqtfFMwMod3w0cGQK1HKvrIFwI,SpATywNh6bZuzm8s1ceuBUnMUAeoAHHw,17,12,7,27,3,8,1,0,58,8.285714285714286,1,0.0,4,7,26,3,8,8,1,1,0,40,18,1
148,4613,aVE6FAaI67jjqObdfL3BkKQUvDsOp43M,SpATywNh6bZuzm8s1ceuBUnMUAeoAHHw,4,2,1,0,0,0,3,0,6,0.8571428571428571,1,0.0,0,1,0,0,2,0,0,3,0,1,5,0
149,4614,D77mYRAEHVmHmrch91cWflZwkGfWXMn3,SpATywNh6bZuzm8s1ceuBUnMUAeoAHHw,1,1,0,0,0,0,0,0,1,0.14285714285714285,1,0.0,0,0,0,0,1,0,0,0,0,0,1,1
150,4619,y7HHpDc09mCS3h1lthBIJASJI1RnROT7,SpATywNh6bZuzm8s1ceuBUnMUAeoAHHw,1,0,0,0,0,0,1,0,1,0.14285714285714285,1,0.0,0,0,0,0,0,0,0,1,0,0,1,1
151,4625,qRy2DimM9SNsqYvrYrrnIw2oQKcYB3wP,SpATywNh6bZuzm8s1ceuBUnMUAeoAHHw,5,7,1,2,0,0,4,0,14,2.0,2,0.0,0,1,1,0,7,0,1,4,0,2,12,0
152,4630,DLDhUvvvfnnYFJuV65Zt2yaS0jPJgvzq,G8EPVSXsOYB5YQWZGiz1aVq5Pgr2GrQu,114,142,1,284,3,31,28,2,491,70.14285714285714,7,0.0,52,1,218,3,90,31,66,28,2,274,217,0
153,4637,jWkqymVvvfv6xuX5RWgcj99r1zpcnb3g,SpATywNh6bZuzm8s1ceuBUnMUAeoAHHw,23,65,2,19,1,0,14,0,101,14.428571428571429,7,0.0,12,2,16,1,53,0,3,14,0,31,70,0
154,4641,8oxFWBumsNA4SJ0CIJujNkjFW8ZzMgtQ,SpATywNh6bZuzm8s1ceuBUnMUAeoAHHw,18,37,3,27,3,22,29,4,125,17.857142857142858,5,0.0,6,3,21,3,31,22,6,29,4,33,92,0
155,4647,MKlpymF14KtyI236a0RjVjNdDlFXwHJE,SpATywNh6bZuzm8s1ceuBUnMUAeoAHHw,2,8,6,0,0,0,0,0,14,2.0,4,0.0,0,6,0,0,8,0,0,0,0,6,8,0
156,4652,D1N0ONIJFdYniASKJjZ0ujwEVr50txl7,A3fsA9Zfv1X2fVEQhTw51lKENdNrEqT3,1,0,0,0,0,0,1,0,1,0.14285714285714285,1,0.0,0,0,0,0,0,0,0,1,0,0,1,1
157,4664,kMN5uYNaj23K9PVTrdyiL9iDB1lCye57,SpATywNh6bZuzm8s1ceuBUnMUAeoAHHw,17,36,14,18,5,4,7,0,84,12.0,4,0.0,9,14,15,5,27,4,3,7,0,43,41,0
158,4672,LBkf4MhTcgqLqBnp8u6ZnAtRKKkDVT0Y,RXDvfPUBYFlVdlueBFbLW0mhhAyGEqpt,24,33,24,15,6,6,3,0,87,12.428571428571429,1,0.0,8,24,15,6,25,6,0,3,0,53,34,0
159,4685,vdpA0dH9z73XaAQ0RErmDlnn6qBKeXm2,SpATywNh6bZuzm8s1ceuBUnMUAeoAHHw,2,0,0,0,0,0,2,0,2,0.2857142857142857,1,0.0,0,0,0,0,0,0,0,2,0,0,2,1
160,4690,uOFQjpYGMV24K1kl5khOKpWKqO5hcEHE,SpATywNh6bZuzm8s1ceuBUnMUAeoAHHw,25,53,5,39,4,13,13,3,130,18.571428571428573,5,0.0,21,5,33,4,32,13,6,13,3,63,67,0
161,4697,Dth3GgZsbd3MjUskvlTR45iDGsOfcse1,bWdj2GDclj5ofokWjzoa5jAwMkxCykd6,9,6,0,0,1,0,7,1,15,2.142857142857143,1,0.0,2,0,0,1,4,0,0,7,1,3,12,1
162,4713,2d73pTPKGJeE59DtbgirchSdsN0c5ZX8,G8EPVSXsOYB5YQWZGiz1aVq5Pgr2GrQu,30,15,10,97,1,0,4,0,127,18.142857142857142,2,0.0,3,10,88,1,12,0,9,4,0,102,25,1
163,4717,pYVXRlnQ0YvWKNjc7FEDAmE4Ai0Z428V,SpATywNh6bZuzm8s1ceuBUnMUAeoAHHw,5,1,1,0,1,0,2,0,5,0.7142857142857143,1,0.0,0,1,0,1,1,0,0,2,0,2,3,1
164,4724,CjC2ROZAsG20pDynA7ZPw7kC7J3IUQLv,SpATywNh6bZuzm8s1ceuBUnMUAeoAHHw,11,13,3,13,0,0,2,0,31,4.428571428571429,1,0.0,2,3,13,0,11,0,0,2,0,18,13,0
165,4731,LgFsEu5TARkqPf6cgrTX0NqpOzewq5Lk,SpATywNh6bZuzm8s1ceuBUnMUAeoAHHw,1,0,0,0,0,0,3,0,3,0.42857142857142855,3,0.0,0,0,0,0,0,0,0,3,0,0,3,0
166,4742,24nfIqL449Y829FZxcDvbCwFktTYfhAB,SpATywNh6bZuzm8s1ceuBUnMUAeoAHHw,1,0,0,0,0,0,1,0,1,0.14285714285714285,1,0.0,0,0,0,0,0,0,0,1,0,0,1,1
167,4743,24nfIqL449Y829FZxcDvbCwFktTYfhAB,bWdj2GDclj5ofokWjzoa5jAwMkxCykd6,5,2,1,0,1,0,2,0,6,0.8571428571428571,1,0.0,0,1,0,1,2,0,0,2,0,2,4,1
168,4747,2YrfQZgyUPdiZGXhplgKBSkvHochAfw6,SpATywNh6bZuzm8s1ceuBUnMUAeoAHHw,12,25,9,18,0,3,10,0,65,9.285714285714286,4,0.0,4,9,16,0,21,3,2,10,0,29,36,0
169,4756,5QI6OaFhCHlCtRcFfvDdZQ38fgw6K7ZS,SpATywNh6bZuzm8s1ceuBUnMUAeoAHHw,1,0,0,0,0,0,1,0,1,0.14285714285714285,1,0.0,0,0,0,0,0,0,0,1,0,0,1,1
170,4767,OLNUzQUHvlNsi2WFlH5eEyaieqKXrEz7,SpATywNh6bZuzm8s1ceuBUnMUAeoAHHw,7,4,3,0,2,5,2,0,16,2.2857142857142856,1,0.0,0,3,0,2,4,5,0,2,0,5,11,1
171,4772,6BV3xjXq9ekiRfYm3O3pN6jZMMACVAnm,G8EPVSXsOYB5YQWZGiz1aVq5Pgr2GrQu,1,0,0,0,0,0,1,0,1,0.14285714285714285,1,0.0,0,0,0,0,0,0,0,1,0,0,1,1
172,4773,29ctmAiYEOKj7HqUZOWS8Kj1hgVEvKs8,bWdj2GDclj5ofokWjzoa5jAwMkxCykd6,9,20,1,14,1,0,1,0,37,5.285714285714286,1,0.0,5,1,14,1,15,0,0,1,0,21,16,1
173,4774,urHq1UPtLFVLJW8r9uUffDflKlN7AYRL,SpATywNh6bZuzm8s1ceuBUnMUAeoAHHw,5,4,2,0,0,0,2,0,8,1.1428571428571428,1,0.0,1,2,0,0,3,0,0,2,0,3,5,0
174,4801,uvl7kPB3Po3jrDtnQvCsunCWcJhdeQPU,A3fsA9Zfv1X2fVEQhTw51lKENdNrEqT3,7,6,3,0,1,3,6,1,20,2.857142857142857,1,0.0,0,3,0,1,6,3,0,6,1,4,16,1
175,4802,aI2WbSCktVyijPTHCbgAdpzpfdnFGcq9,RXDvfPUBYFlVdlueBFbLW0mhhAyGEqpt,3,0,0,0,0,0,7,0,7,1.0,3,0.0,0,0,0,0,0,0,0,7,0,0,7,0
176,4806,iGjPcJm3i62KsWTQKhrsxcQv7n97iair,G8EPVSXsOYB5YQWZGiz1aVq5Pgr2GrQu,34,70,17,63,6,0,8,0,164,23.428571428571427,3,0.0,17,17,47,6,53,0,16,8,0,87,77,0
177,4813,8956nHnvCL40778s76lABgHdN1UGjdzq,bWdj2GDclj5ofokWjzoa5jAwMkxCykd6,5,3,1,0,1,0,2,0,7,1.0,1,0.0,0,1,0,1,3,0,0,2,0,2,5,1
178,4825,q3SjGV3d1qwn1q3ehoXsAmC01281iVQV,SpATywNh6bZuzm8s1ceuBUnMUAeoAHHw,15,18,10,18,3,0,4,0,53,7.571428571428571,1,0.0,7,10,15,3,11,0,3,4,0,35,18,0
179,4827,yNygMjDRQbsmQrkdzv6Ni3gEhrA9rC9T,SpATywNh6bZuzm8s1ceuBUnMUAeoAHHw,3,4,2,0,0,0,1,0,7,1.0,1,0.0,0,2,0,0,4,0,0,1,0,2,5,0
180,4846,7gQzvY1ridUPLjuboweNhi3eMZVeaUA3,SpATywNh6bZuzm8s1ceuBUnMUAeoAHHw,1,0,0,0,0,0,1,0,1,0.14285714285714285,1,0.0,0,0,0,0,0,0,0,1,0,0,1,1
181,4852,bvRAS0uJ0Teq8mZcNb9rxcXigDj59DTa,RXDvfPUBYFlVdlueBFbLW0mhhAyGEqpt,11,13,8,0,2,0,3,0,26,3.7142857142857144,2,0.0,1,8,0,2,12,0,0,3,0,11,15,0
182,4859,WFpcwuADsWD4IXIxExn0sUfX41HgFWZg,SpATywNh6bZuzm8s1ceuBUnMUAeoAHHw,6,5,2,0,2,0,1,0,10,1.4285714285714286,1,0.0,0,2,0,2,5,0,0,1,0,4,6,1
183,4903,jJEQAKDG1yT0OS9qRBZrNXlEJDxE8Etq,A3fsA9Zfv1X2fVEQhTw51lKENdNrEqT3,14,25,8,10,1,83,28,2,157,22.428571428571427,7,0.0,2,8,7,1,23,83,3,28,2,18,139,0
184,4907,24hyIKTWvGbDpRNiVA2hNdG9ApRuVKWS,SpATywNh6bZuzm8s1ceuBUnMUAeoAHHw,2,0,0,0,0,0,4,0,4,0.5714285714285714,1,0.0,0,0,0,0,0,0,0,4,0,0,4,0
185,4910,FlH4hJdTFopI7d7C8aCFmJunlCxyAcSh,SpATywNh6bZuzm8s1ceuBUnMUAeoAHHw,20,22,10,17,4,4,11,2,70,10.0,4,0.0,7,10,15,4,15,4,2,11,2,36,34,1
186,4916,zgScsnx97lbYEQNQ5ihDmYHFxSK6ucUx,SpATywNh6bZuzm8s1ceuBUnMUAeoAHHw,1,0,0,0,0,0,1,0,1,0.14285714285714285,1,0.0,0,0,0,0,0,0,0,1,0,0,1,1
187,4919,QDpN8D19Mr8RZumTONWpZNlCWcHCCTbH,bWdj2GDclj5ofokWjzoa5jAwMkxCykd6,7,7,1,0,1,0,1,0,10,1.4285714285714286,1,0.0,1,1,0,1,6,0,0,1,0,3,7,1
188,4924,bef1HHNzLfXpAEPkvkmDyHD9r4t8l5gN,RXDvfPUBYFlVdlueBFbLW0mhhAyGEqpt,2,0,0,0,0,0,2,0,2,0.2857142857142857,1,0.0,0,0,0,0,0,0,0,2,0,0,2,1
189,4927,WYPfgLKE9VINcT4gmCjKg6KY4hGmzmxN,SpATywNh6bZuzm8s1ceuBUnMUAeoAHHw,13,12,5,8,2,0,3,0,30,4.285714285714286,1,0.0,6,5,7,2,6,0,1,3,0,20,10,0
190,4931,eiL4sJzBUqNqEAwJXavGTHQchRgg0E9e,G8EPVSXsOYB5YQWZGiz1aVq5Pgr2GrQu,17,42,2,0,0,7,12,1,64,9.142857142857142,6,0.0,19,2,0,0,23,7,0,12,1,21,43,0
191,4934,RkupeBiDJM8eQAHegSIZXnYfypYMPCFs,SpATywNh6bZuzm8s1ceuBUnMUAeoAHHw,9,23,10,2,0,0,4,0,39,5.571428571428571,4,0.0,6,10,2,0,17,0,0,4,0,18,21,0
192,4937,aZcgamrUxwqX7Nt2qxeI2ZGGKhcvbWIt,SpATywNh6bZuzm8s1ceuBUnMUAeoAHHw,1,0,0,0,0,0,2,0,2,0.2857142857142857,1,0.0,0,0,0,0,0,0,0,2,0,0,2,0
193,4948,D8SfZbudbfX5pEFjOEna12FQCnvrJwde,SpATywNh6bZuzm8s1ceuBUnMUAeoAHHw,7,10,5,0,0,1,7,1,24,3.4285714285714284,2,0.0,0,5,0,0,10,1,0,7,1,5,19,1
194,4954,w9jybkX7jENxFw2ZN48ruQIJfCGfUCTe,bWdj2GDclj5ofokWjzoa5jAwMkxCykd6,16,28,1,52,4,1,4,0,90,12.857142857142858,3,0.0,11,1,47,4,17,1,5,4,0,63,27,1
195,4956,w9jybkX7jENxFw2ZN48ruQIJfCGfUCTe,A3fsA9Zfv1X2fVEQhTw51lKENdNrEqT3,6,5,0,0,0,0,1,0,6,0.8571428571428571,1,0.0,0,0,0,0,5,0,0,1,0,0,6,1
196,4979,dSloiolTuQA1YnIVrIEZb5m23cL24cRw,bWdj2GDclj5ofokWjzoa5jAwMkxCykd6,6,6,2,0,2,0,3,0,13,1.8571428571428572,2,0.0,0,2,0,2,6,0,0,3,0,4,9,1
197,4982,3ZzNkdWgGb47Go07PRKPf0XZ6jjhVCB4,A3fsA9Zfv1X2fVEQhTw51lKENdNrEqT3,18,8,5,32,1,1,5,0,52,7.428571428571429,2,0.0,1,5,27,1,7,1,5,5,0,34,18,0
198,4984,3h1zqwMTeQWdhoWHPgvllPWyD6P0qFtr,SpATywNh6bZuzm8s1ceuBUnMUAeoAHHw,27,44,16,24,8,5,9,2,108,15.428571428571429,3,0.0,19,16,24,8,25,5,0,9,2,67,41,0
199,4989,WxVM9kOqNmenlQy1YKMo3yVYKYKkewCz,A3fsA9Zfv1X2fVEQhTw51lKENdNrEqT3,31,14,9,102,3,5,4,0,137,19.571428571428573,2,0.0,3,9,81,3,11,5,21,4,0,96,41,0
200,5009,lgip049r6Eu24ga2SPdixKHu4ShoVkOP,SpATywNh6bZuzm8s1ceuBUnMUAeoAHHw,1,0,0,0,0,0,1,0,1,0.14285714285714285,1,0.0,0,0,0,0,0,0,0,1,0,0,1,0
201,5014,CIp7kQvL8WZLrf0lp78hw3OiOipB94Fc,SpATywNh6bZuzm8s1ceuBUnMUAeoAHHw,1,0,0,0,0,0,1,0,1,0.14285714285714285,1,0.0,0,0,0,0,0,0,0,1,0,0,1,1
202,5028,v1AqHfMoNhUox9GyIOrxftKibIp07zrt,RXDvfPUBYFlVdlueBFbLW0mhhAyGEqpt,2,0,0,0,0,15,2,0,17,2.4285714285714284,2,0.0,0,0,0,0,0,15,0,2,0,0,17,1
203,5042,QP1Im9jEj4yDlujZ0cdksBwzi1qoq6uz,A3fsA9Zfv1X2fVEQhTw51lKENdNrEqT3,11,6,5,0,4,0,1,0,16,2.2857142857142856,1,0.0,0,5,0,4,6,0,0,1,0,9,7,1
204,5058,UJNew1tDOTKAwtlVI7Xin0dzgnQGk4oE,SpATywNh6bZuzm8s1ceuBUnMUAeoAHHw,3,2,1,0,0,0,2,0,5,0.7142857142857143,2,0.0,0,1,0,0,2,0,0,2,0,1,4,0
205,5081,EEKRPW8tn9Mg3QBn5MHwc7463f6P9lSa,SpATywNh6bZuzm8s1ceuBUnMUAeoAHHw,13,22,0,7,0,0,5,0,34,4.857142857142857,3,0.0,5,0,6,0,17,0,1,5,0,11,23,1
206,5084,kMzMJEHy7fAHiNUZU0um3I2BsPC7gMll,bWdj2GDclj5ofokWjzoa5jAwMkxCykd6,16,13,9,20,8,5,5,0,60,8.571428571428571,3,0.0,3,9,16,8,10,5,4,5,0,36,24,0
207,5106,77HeNUdRA0IEkObqGpfDRUjK9MGFXlcs,SpATywNh6bZuzm8s1ceuBUnMUAeoAHHw,7,7,1,0,1,0,4,0,13,1.8571428571428572,1,0.0,0,1,0,1,7,0,0,4,0,2,11,0
208,5112,eXHbDnPXGOepjGY8R1QdCMeSWp9NDZZc,SpATywNh6bZuzm8s1ceuBUnMUAeoAHHw,12,26,11,0,3,0,5,0,45,6.428571428571429,4,0.0,7,11,0,3,19,0,0,5,0,21,24,0
209,5114,3SWDgl41jXPWPBCB5sVpNEwmW9L3MerS,SpATywNh6bZuzm8s1ceuBUnMUAeoAHHw,3,4,4,0,0,0,2,0,10,1.4285714285714286,4,0.0,0,4,0,0,4,0,0,2,0,4,6,0
210,5136,35QP8hkG1fMgJT5B2mWO7L1K5UDzKccP,SpATywNh6bZuzm8s1ceuBUnMUAeoAHHw,9,11,1,0,1,0,1,0,14,2.0,1,0.0,0,1,0,1,11,0,0,1,0,2,12,1
211,5148,uN992cfJ2NJqNQmns1XgyEcZyWUiJR0U,SpATywNh6bZuzm8s1ceuBUnMUAeoAHHw,16,31,14,0,4,10,14,0,73,10.428571428571429,5,0.0,6,14,0,4,25,10,0,14,0,24,49,0
212,5168,UWuyaaoLwLnyFDmtW8yT3lff7bHBBBqe,SpATywNh6bZuzm8s1ceuBUnMUAeoAHHw,5,22,3,0,3,0,0,0,28,4.0,6,0.0,0,3,0,3,22,0,0,0,0,6,22,0
213,5205,VhlYBZ7MZgP2ChzlwqizJv2MimYYdGta,SpATywNh6bZuzm8s1ceuBUnMUAeoAHHw,6,8,6,0,6,0,0,0,20,2.857142857142857,1,0.0,0,6,0,6,8,0,0,0,0,12,8,1
214,5209,884KSEusRiMlLTSulMFf41A22MivDNwN,G8EPVSXsOYB5YQWZGiz1aVq5Pgr2GrQu,7,3,2,0,2,0,5,0,12,1.7142857142857142,1,0.0,0,2,0,2,3,0,0,5,0,4,8,1
215,5212,4HfbFsCyYszJO7w4OHW3KiOw346tCEQ3,SpATywNh6bZuzm8s1ceuBUnMUAeoAHHw,27,26,13,19,7,0,2,0,67,9.571428571428571,2,0.0,11,13,18,7,15,0,1,2,0,49,18,1
216,5238,S4uinMe8PGabKcmtVdXuBZWFnRj2oMAw,bWdj2GDclj5ofokWjzoa5jAwMkxCykd6,1,0,0,0,0,0,1,0,1,0.14285714285714285,1,0.0,0,0,0,0,0,0,0,1,0,0,1,1
217,5245,17IsanlXziT2tczTSDkapcsRHmSWuCWH,SpATywNh6bZuzm8s1ceuBUnMUAeoAHHw,8,30,1,0,0,0,1,0,32,4.571428571428571,1,0.0,0,1,0,0,30,0,0,1,0,1,31,0
218,5249,TCQ7j55cp3iQY2crxSrod75YneerL94o,SpATywNh6bZuzm8s1ceuBUnMUAeoAHHw,2,0,0,0,0,0,2,0,2,0.2857142857142857,1,0.0,0,0,0,0,0,0,0,2,0,0,2,1
219,5255,0NbLYZNvmNdh82upKkBVVwJoa5b6RKVj,SpATywNh6bZuzm8s1ceuBUnMUAeoAHHw,19,29,9,18,1,1,16,0,74,10.571428571428571,3,0.0,2,9,15,1,27,1,3,16,0,27,47,0
220,5272,ClI23A4eXCdUFVQKR5uvI4exGZKJHgkV,SpATywNh6bZuzm8s1ceuBUnMUAeoAHHw,6,6,0,0,0,0,2,0,8,1.1428571428571428,4,0.0,0,0,0,0,6,0,0,2,0,0,8,1
221,5280,nsvq9MYt4IahoN4kXXFtAP2mFM9VmORm,SpATywNh6bZuzm8s1ceuBUnMUAeoAHHw,7,6,3,0,1,0,1,0,11,1.5714285714285714,1,0.0,1,3,0,1,5,0,0,1,0,5,6,1
222,5284,QqE2Xjwy9gUzOvFdkDqAwAaNZLBZkxvd,RXDvfPUBYFlVdlueBFbLW0mhhAyGEqpt,14,33,4,2,2,65,43,0,149,21.285714285714285,6,0.0,1,4,1,2,32,65,1,43,0,8,141,0
223,5290,4xEpIgR9alQqM4xeSug69KmBmO9gpD69,A3fsA9Zfv1X2fVEQhTw51lKENdNrEqT3,36,47,21,72,11,5,22,0,178,25.428571428571427,6,0.0,2,21,63,11,45,5,9,22,0,97,81,0
224,5294,KZD0EIKZJQdXNs947RuceyEoKIUwV8dz,SpATywNh6bZuzm8s1ceuBUnMUAeoAHHw,1,0,0,0,0,0,1,0,1,0.14285714285714285,1,0.0,0,0,0,0,0,0,0,1,0,0,1,1
225,5311,SFbTZDEo0JTOG7VHfxeJz2kz3qSzlHq4,SpATywNh6bZuzm8s1ceuBUnMUAeoAHHw,1,0,0,0,0,0,3,0,3,0.42857142857142855,3,0.0,0,0,0,0,0,0,0,3,0,0,3,0
226,5316,0tT4cQq52T8bu4irQ9KewNXtlD33hVZo,SpATywNh6bZuzm8s1ceuBUnMUAeoAHHw,16,9,6,17,4,0,2,0,38,5.428571428571429,1,0.0,2,6,16,4,7,0,1,2,0,28,10,0
227,5337,a6f3gPi6axX0cfBnUGVliBDQrPx92l1r,bWdj2GDclj5ofokWjzoa5jAwMkxCykd6,16,47,27,40,14,0,9,0,137,19.571428571428573,5,0.0,9,27,32,14,38,0,8,9,0,82,55,1
228,5368,dXV6CXhMuL2MovsaBcVnWuwVAfDnBy3D,A3fsA9Zfv1X2fVEQhTw51lKENdNrEqT3,7,10,0,0,0,54,3,0,67,9.571428571428571,2,0.0,0,0,0,0,10,54,0,3,0,0,67,1
229,5369,AcgDUm5SSEb0zgM8tYKiOFvTewc0KRAc,SpATywNh6bZuzm8s1ceuBUnMUAeoAHHw,19,14,9,11,4,3,2,0,43,6.142857142857143,2,0.0,4,9,11,4,10,3,0,2,0,28,15,0
230,5374,Z9h5SEHVh1MWbNBNnOXUduD5djAjdPpF,SpATywNh6bZuzm8s1ceuBUnMUAeoAHHw,2,0,0,0,0,0,3,0,3,0.42857142857142855,1,0.0,0,0,0,0,0,0,0,3,0,0,3,1
231,5416,nds56JS5tgInTRshD1ZJkwXi4oW5Ln7a,RXDvfPUBYFlVdlueBFbLW0mhhAyGEqpt,5,11,6,0,0,5,8,0,30,4.285714285714286,5,0.0,0,6,0,0,11,5,0,8,0,6,24,0
232,5470,acVvGaaH1iVFQOYF94V9THpGPkF7EIj3,SpATywNh6bZuzm8s1ceuBUnMUAeoAHHw,6,7,3,0,1,0,1,0,12,1.7142857142857142,1,0.0,3,3,0,1,4,0,0,1,0,7,5,0
233,5471,ZWj0iRzT4HOMV032BfEyYj9IEk1Rdo03,SpATywNh6bZuzm8s1ceuBUnMUAeoAHHw,4,0,0,0,0,9,6,0,15,2.142857142857143,2,0.0,0,0,0,0,0,9,0,6,0,0,15,0
234,5482,lfAQ0nsHdkBDoIcTW4jXyPy4wOsVYtMB,RXDvfPUBYFlVdlueBFbLW0mhhAyGEqpt,63,65,37,149,17,16,7,0,291,41.57142857142857,3,0.0,25,37,140,17,40,16,9,7,0,219,72,1
235,5495,xsW19PmjvHmfOgtSCjdxnkpzOWqbKfLn,SpATywNh6bZuzm8s1ceuBUnMUAeoAHHw,4,7,4,0,0,0,6,0,17,2.4285714285714284,4,0.0,0,4,0,0,7,0,0,6,0,4,13,0
236,5509,BSZDIT15eAtNgfldCBCd9uZr5nmLTo1Y,RXDvfPUBYFlVdlueBFbLW0mhhAyGEqpt,1,0,0,0,0,0,1,0,1,0.14285714285714285,1,0.0,0,0,0,0,0,0,0,1,0,0,1,1
237,5519,BsWy5ImeTPQvYgOCRPYHOm3gBOyZfxYj,SpATywNh6bZuzm8s1ceuBUnMUAeoAHHw,16,15,7,14,4,0,2,0,42,6.0,2,0.0,7,7,14,4,8,0,0,2,0,32,10,0
238,5523,njb10SfHXKB30cApzPJzWBcqA8VQx0HA,SpATywNh6bZuzm8s1ceuBUnMUAeoAHHw,2,0,0,0,0,0,2,0,2,0.2857142857142857,1,0.0,0,0,0,0,0,0,0,2,0,0,2,1
239,5546,sc5S8mzwcw7LbcetViv5Dahuhyet4uF1,SpATywNh6bZuzm8s1ceuBUnMUAeoAHHw,17,30,9,36,0,25,8,3,111,15.857142857142858,2,0.0,17,9,30,0,13,25,6,8,3,56,55,0
240,5558,WRVD7vy9jlNHm0bah44rHP1heNWkqPcT,G8EPVSXsOYB5YQWZGiz1aVq5Pgr2GrQu,1,0,0,0,0,0,1,0,1,0.14285714285714285,1,0.0,0,0,0,0,0,0,0,1,0,0,1,1
241,5562,XERB0lrfKs66PgzJO1IOD0FHZqNqZnJ6,G8EPVSXsOYB5YQWZGiz1aVq5Pgr2GrQu,5,2,1,0,1,0,2,0,6,0.8571428571428571,1,0.0,0,1,0,1,2,0,0,2,0,2,4,1
242,5584,Qt99KRFUK6FY5ovJvB9yRLziSf5bEirX,SpATywNh6bZuzm8s1ceuBUnMUAeoAHHw,18,27,11,8,5,1,2,0,54,7.714285714285714,2,0.0,6,11,8,5,21,1,0,2,0,30,24,1
243,5585,9SqAB4FNYGY3EljMvCEjcqYhPFLwBD3j,SpATywNh6bZuzm8s1ceuBUnMUAeoAHHw,7,3,0,0,0,16,7,1,27,3.857142857142857,1,0.0,0,0,0,0,3,16,0,7,1,0,27,1
244,5606,Ecxkox9cBNw9DlXWEeDlSJP4O73ORQaY,SpATywNh6bZuzm8s1ceuBUnMUAeoAHHw,7,21,5,0,2,0,3,0,31,4.428571428571429,4,0.0,0,5,0,2,21,0,0,3,0,7,24,0
245,5623,0V0UTSnfmpjJ4ctKxsLk1IHNpN42J6mH,G8EPVSXsOYB5YQWZGiz1aVq5Pgr2GrQu,4,2,0,0,0,0,3,0,5,0.7142857142857143,1,0.0,0,0,0,0,2,0,0,3,0,0,5,1
246,5635,7bFemKDlww8gPchsZMuFNOn3TtHTqbHw,bWdj2GDclj5ofokWjzoa5jAwMkxCykd6,6,7,2,0,1,0,11,0,21,3.0,3,0.0,0,2,0,1,7,0,0,11,0,3,18,1
247,5641,dzQyKxZ43BiLWGC6nfqSfnHfJKyWUbky,SpATywNh6bZuzm8s1ceuBUnMUAeoAHHw,11,8,6,0,5,0,4,0,23,3.2857142857142856,1,0.0,0,6,0,5,8,0,0,4,0,11,12,1
248,5642,IAvuP4GGmvnNj3Zisz3jDfo3mSmXiJSb,A3fsA9Zfv1X2fVEQhTw51lKENdNrEqT3,14,31,2,0,1,0,2,0,36,5.142857142857143,2,0.0,0,2,0,1,31,0,0,2,0,3,33,1
249,5644,J388HMX5pYHjqXdA7jEUkFec6orRQtIq,A3fsA9Zfv1X2fVEQhTw51lKENdNrEqT3,11,18,10,0,2,0,1,0,31,4.428571428571429,1,0.0,0,10,0,2,18,0,0,1,0,12,19,0
250,5655,PztWYF4ZTLP8rvUvCUcN3hQiYuYJPY9t,bWdj2GDclj5ofokWjzoa5jAwMkxCykd6,4,2,0,0,0,0,2,0,4,0.5714285714285714,1,0.0,0,0,0,0,2,0,0,2,0,0,4,1
251,5660,CZZkgDgsqVR6ftNFrTmx0jPpBHh2f3Zo,SpATywNh6bZuzm8s1ceuBUnMUAeoAHHw,5,9,0,0,0,0,7,0,16,2.2857142857142856,5,0.0,0,0,0,0,9,0,0,7,0,0,16,0
252,5672,HbDaABEakQmE8DQEoFoIphu2SH13rFRy,bWdj2GDclj5ofokWjzoa5jAwMkxCykd6,3,4,2,0,0,0,2,0,8,1.1428571428571428,1,0.0,0,2,0,0,4,0,0,2,0,2,6,1
253,5675,HbDaABEakQmE8DQEoFoIphu2SH13rFRy,RXDvfPUBYFlVdlueBFbLW0mhhAyGEqpt,7,10,7,0,2,0,3,0,22,3.142857142857143,2,0.0,0,7,0,2,10,0,0,3,0,9,13,1
254,5702,C6xrhZPOmVH2gCVNP26gSSPka2CcwgB5,bWdj2GDclj5ofokWjzoa5jAwMkxCykd6,13,7,4,20,2,0,2,0,35,5.0,1,0.0,3,4,19,2,4,0,1,2,0,28,7,1
255,5705,TwYAYdYU7yn5FjnP72W4DEwE8N7Dqkqq,bWdj2GDclj5ofokWjzoa5jAwMkxCykd6,7,6,2,0,2,0,5,0,15,2.142857142857143,2,0.0,0,2,0,2,6,0,0,5,0,4,11,1
256,5724,9b2fchNyVZPjqpmxjleqzL9edi9EOH23,SpATywNh6bZuzm8s1ceuBUnMUAeoAHHw,6,1,1,0,1,0,4,0,7,1.0,2,0.0,0,1,0,1,1,0,0,4,0,2,5,1
257,5740,PizUKf6mRUas66X3VMYXf9aygnN1CUCf,SpATywNh6bZuzm8s1ceuBUnMUAeoAHHw,15,20,11,0,4,0,3,0,38,5.428571428571429,1,0.0,7,11,0,4,13,0,0,3,0,22,16,1
258,5743,57qzgJAwfROYPxzSOrsA3G5DLHP95ajU,RXDvfPUBYFlVdlueBFbLW0mhhAyGEqpt,3,10,5,0,0,0,7,0,22,3.142857142857143,5,0.0,0,5,0,0,10,0,0,7,0,5,17,0
259,5746,seRgjh60dHSex83x3yaP07EkHkNZ3zq1,SpATywNh6bZuzm8s1ceuBUnMUAeoAHHw,21,35,17,14,7,0,5,0,78,11.142857142857142,4,0.0,14,17,13,7,21,0,1,5,0,51,27,0
260,5768,ytK9EwjDrcEsoXMvgjh9BEVuEXIjTD3M,bWdj2GDclj5ofokWjzoa5jAwMkxCykd6,7,4,2,0,2,0,4,0,12,1.7142857142857142,1,0.0,0,2,0,2,4,0,0,4,0,4,8,1
261,5777,FVINYuQhNwQ1IBS2HaRVFMtFczGjKWmz,SpATywNh6bZuzm8s1ceuBUnMUAeoAHHw,1,0,0,0,0,0,1,0,1,0.14285714285714285,1,0.0,0,0,0,0,0,0,0,1,0,0,1,1
262,5781,D2S5bjWjmtwLivqx7n7FZWso5Kd6We5x,bWdj2GDclj5ofokWjzoa5jAwMkxCykd6,5,3,1,0,1,0,1,0,6,0.8571428571428571,1,0.0,0,1,0,1,3,0,0,1,0,2,4,0
263,5785,Llzpy0Dk1LPSE6nBLZ8vNVNgQXCzGpc1,SpATywNh6bZuzm8s1ceuBUnMUAeoAHHw,2,0,0,0,0,0,4,0,4,0.5714285714285714,3,0.0,0,0,0,0,0,0,0,4,0,0,4,1
264,5788,zysr84QD6b78mLaezXoryEdhH6kH14EQ,SpATywNh6bZuzm8s1ceuBUnMUAeoAHHw,22,24,14,21,5,0,6,0,70,10.0,5,0.0,5,14,21,5,19,0,0,6,0,45,25,0
265,5792,GIb3glgYrsEfHWtEWPWpwONqwE7RMf6f,bWdj2GDclj5ofokWjzoa5jAwMkxCykd6,22,124,67,41,8,71,30,0,341,48.714285714285715,6,0.0,5,67,36,8,119,71,5,30,0,116,225,0
266,5803,sD3rDh1CtXsAdfDDyFRBf917K7ELQzHQ,SpATywNh6bZuzm8s1ceuBUnMUAeoAHHw,22,56,27,32,9,0,14,0,138,19.714285714285715,4,0.0,14,27,31,9,42,0,1,14,0,81,57,0
267,5805,VUYRWxIK25dyFla7xdkPw6qN6gZPPejU,SpATywNh6bZuzm8s1ceuBUnMUAeoAHHw,17,17,15,6,7,0,2,0,47,6.714285714285714,2,0.0,0,15,6,7,17,0,0,2,0,28,19,0
268,5807,8tzllCaQFf5FO2XcYgqoYiMGBjUwujYx,bWdj2GDclj5ofokWjzoa5jAwMkxCykd6,5,15,0,0,1,0,6,0,22,3.142857142857143,2,0.0,3,0,0,1,12,0,0,6,0,4,18,1
269,5822,yXIAbgjR7S4042oicRyG8kfTX0pG8yI5,SpATywNh6bZuzm8s1ceuBUnMUAeoAHHw,20,27,1,14,1,4,3,0,50,7.142857142857143,1,0.0,6,1,13,1,21,4,1,3,0,21,29,0
270,5826,zTf8XOQnwWWl1KDwh9NJmoY9QiDPt6oU,SpATywNh6bZuzm8s1ceuBUnMUAeoAHHw,1,0,0,0,0,0,3,0,3,0.42857142857142855,3,0.0,0,0,0,0,0,0,0,3,0,0,3,0
271,5841,eKmIYKU6Yx5AUBketpCKhFRjn0XSrN5J,SpATywNh6bZuzm8s1ceuBUnMUAeoAHHw,30,54,31,22,16,3,16,1,143,20.428571428571427,3,0.0,8,31,22,16,46,3,0,16,1,77,66,0
272,5865,Ojf2FGMPjkgcQ8cOS7KSlXqYowZOsPoh,A3fsA9Zfv1X2fVEQhTw51lKENdNrEqT3,10,17,9,0,0,0,9,0,35,5.0,6,0.0,0,9,0,0,17,0,0,9,0,9,26,0
273,5876,5hXpDY3fUOWXeNSNssxdgQEXyy5gGZpD,SpATywNh6bZuzm8s1ceuBUnMUAeoAHHw,6,5,1,0,1,0,2,0,9,1.2857142857142858,1,0.0,1,1,0,1,4,0,0,2,0,3,6,1
274,5890,8c2gk77rfHeG4kEZpifVHT547X2ayTNE,RXDvfPUBYFlVdlueBFbLW0mhhAyGEqpt,31,55,34,42,10,18,15,3,177,25.285714285714285,1,0.0,10,34,41,10,45,18,1,15,3,95,82,0
275,5892,1YxknoiTrSwQgclDlSAh4oMYHRyARhLv,SpATywNh6bZuzm8s1ceuBUnMUAeoAHHw,22,31,13,8,6,0,6,0,64,9.142857142857142,3,0.0,15,13,8,6,16,0,0,6,0,42,22,0
276,5894,biGiKcwkAdzTvOFIAeW8Vs1H1jbCmhSY,SpATywNh6bZuzm8s1ceuBUnMUAeoAHHw,4,2,0,0,0,0,2,0,4,0.5714285714285714,1,0.0,0,0,0,0,2,0,0,2,0,0,4,1
277,5902,7o8xhk1rh0BQyK6zL1slDKappRA3D8Mk,SpATywNh6bZuzm8s1ceuBUnMUAeoAHHw,21,20,0,27,0,3,9,1,60,8.571428571428571,2,0.0,9,0,26,0,11,3,1,9,1,35,25,0
278,5927,vYyC3PI9WOfKd54xBrxSVvrhn62CQxzz,SpATywNh6bZuzm8s1ceuBUnMUAeoAHHw,14,14,9,7,4,0,2,0,36,5.142857142857143,2,0.0,2,9,7,4,12,0,0,2,0,22,14,1
279,5934,hdKqkkWKrDzbKE9btGChBqiCfsTwp68E,A3fsA9Zfv1X2fVEQhTw51lKENdNrEqT3,20,18,14,0,3,29,15,1,80,11.428571428571429,4,0.0,0,14,0,3,18,29,0,15,1,17,63,0
280,5971,XVAvU5kUUejQSld1XjHX8mt1uGOkgzW4,RXDvfPUBYFlVdlueBFbLW0mhhAyGEqpt,9,6,5,0,3,0,2,0,16,2.2857142857142856,2,0.0,0,5,0,3,6,0,0,2,0,8,8,1
281,6001,Wb4KcRKSzKNnIp1HnFKSZY95LILGuTll,SpATywNh6bZuzm8s1ceuBUnMUAeoAHHw,23,33,0,31,1,1,7,0,73,10.428571428571429,2,0.0,13,0,28,1,20,1,3,7,0,42,31,0
282,6004,dlFVVLBV3ZD4RhjUk38UJOj8FktRTHQw,SpATywNh6bZuzm8s1ceuBUnMUAeoAHHw,1,0,0,0,0,0,2,0,2,0.2857142857142857,2,0.0,0,0,0,0,0,0,0,2,0,0,2,1
283,6018,cJcuhtji0eqLhfXtnFSDlw6v5huTlvOS,SpATywNh6bZuzm8s1ceuBUnMUAeoAHHw,1,0,0,0,0,0,2,0,2,0.2857142857142857,2,0.0,0,0,0,0,0,0,0,2,0,0,2,0
284,6022,zzh7OhB1yuFx7KNMW6cKx1t3e2ezVcvZ,SpATywNh6bZuzm8s1ceuBUnMUAeoAHHw,6,4,1,0,1,0,2,0,8,1.1428571428571428,1,0.0,0,1,0,1,4,0,0,2,0,2,6,1
285,6031,H2B0ZVh2RYo5LjimmBQ15UDjcAOL7h2y,A3fsA9Zfv1X2fVEQhTw51lKENdNrEqT3,8,2,2,0,2,0,4,0,10,1.4285714285714286,1,0.0,0,2,0,2,2,0,0,4,0,4,6,1
286,6032,sc5S8mzwcw7LbcetViv5Dahuhyet4uF1,bWdj2GDclj5ofokWjzoa5jAwMkxCykd6,17,17,9,16,1,24,12,1,80,11.428571428571429,3,0.0,0,9,16,1,17,24,0,12,1,26,54,1
287,6048,hf7YI3B1kTTuvmd2vS9DIoiPGXbrQyBH,SpATywNh6bZuzm8s1ceuBUnMUAeoAHHw,3,4,1,0,0,0,4,0,9,1.2857142857142858,3,0.0,0,1,0,0,4,0,0,4,0,1,8,0
288,6058,KrIVcXIiCdwRGUI4WguKXHPsvZChbtIb,A3fsA9Zfv1X2fVEQhTw51lKENdNrEqT3,24,27,16,0,4,0,13,0,60,8.571428571428571,2,0.0,2,16,0,4,25,0,0,13,0,22,38,0
289,6059,RDBly29xbybxfRPXjsOP81xd2Sgww6yI,bWdj2GDclj5ofokWjzoa5jAwMkxCykd6,8,6,3,34,1,0,9,0,53,7.571428571428571,3,0.0,1,3,33,1,5,0,1,9,0,38,15,1
290,6069,imazrFpyX68kLUAydat119Z5XKshja9y,SpATywNh6bZuzm8s1ceuBUnMUAeoAHHw,3,8,4,0,0,0,5,0,17,2.4285714285714284,4,0.0,0,4,0,0,8,0,0,5,0,4,13,0
291,6084,egIcBO9xXh5XDAWBOR2C58eTHcHVaPTq,SpATywNh6bZuzm8s1ceuBUnMUAeoAHHw,9,5,4,0,3,0,1,0,13,1.8571428571428572,1,0.0,0,4,0,3,5,0,0,1,0,7,6,1
292,6086,ZL7VsgZBlKFfi6BGNSyN1gGJros1L9ra,SpATywNh6bZuzm8s1ceuBUnMUAeoAHHw,16,16,7,12,3,6,4,0,48,6.857142857142857,1,0.0,4,7,9,3,12,6,3,4,0,23,25,1
293,6087,uUWoPLkJSFKbD6KppcebOwMXezopCcLj,SpATywNh6bZuzm8s1ceuBUnMUAeoAHHw,7,14,0,0,0,0,4,0,18,2.5714285714285716,1,0.0,4,0,0,0,10,0,0,4,0,4,14,0
294,6090,Qsrx4kwwBFByqyYPAbCeTAurBzPDhOG4,SpATywNh6bZuzm8s1ceuBUnMUAeoAHHw,3,4,2,0,0,0,2,0,8,1.1428571428571428,2,0.0,0,2,0,0,4,0,0,2,0,2,6,1
295,6125,CovNnemmooeYpLX2YfcP75dIKg65MoIW,SpATywNh6bZuzm8s1ceuBUnMUAeoAHHw,4,2,1,0,1,0,1,0,5,0.7142857142857143,1,0.0,0,1,0,1,2,0,0,1,0,2,3,1
296,6136,sF8Qur7NIXPGJG744QNBCJLJgM51K1cT,SpATywNh6bZuzm8s1ceuBUnMUAeoAHHw,7,10,5,0,2,1,3,0,21,3.0,2,0.0,0,5,0,2,10,1,0,3,0,7,14,1
297,6184,Ui5s6msHQkQWoojIHrlye6CrlPfuJtqr,SpATywNh6bZuzm8s1ceuBUnMUAeoAHHw,7,4,1,0,1,0,2,0,8,1.1428571428571428,1,0.0,0,1,0,1,4,0,0,2,0,2,6,1
298,6197,6A2JLpLWnCwUlo9pD1HHlgEwNLvzcllv,SpATywNh6bZuzm8s1ceuBUnMUAeoAHHw,11,10,6,0,3,0,4,0,23,3.2857142857142856,2,0.0,0,6,0,3,10,0,0,4,0,9,14,1
299,6200,P1GB7lMEFMwTm3zg0Vd2JWGeu5aUPfGc,bWdj2GDclj5ofokWjzoa5jAwMkxCykd6,1,0,0,0,0,0,1,0,1,0.14285714285714285,1,0.0,0,0,0,0,0,0,0,1,0,0,1,1
300,6203,qwOn6svjZUr6PbEPbdgCynJcocJs2Tff,SpATywNh6bZuzm8s1ceuBUnMUAeoAHHw,4,3,1,0,0,0,1,0,5,0.7142857142857143,1,0.0,0,1,0,0,3,0,0,1,0,1,4,0
301,6215,FgYPvBwLri7YiFI9og6clP9FuKJ08jX7,SpATywNh6bZuzm8s1ceuBUnMUAeoAHHw,16,17,10,8,4,0,2,0,41,5.857142857142857,2,0.0,4,10,8,4,13,0,0,2,0,26,15,1
302,6222,2CJPniJdzPQB2xVD7usFld4N6998DubA,SpATywNh6bZuzm8s1ceuBUnMUAeoAHHw,7,5,2,0,1,0,9,0,17,2.4285714285714284,3,0.0,0,2,0,1,5,0,0,9,0,3,14,0
303,6235,ywdL3xkp7d2PSjbvnflAvIe7Wp6Q4SRe,A3fsA9Zfv1X2fVEQhTw51lKENdNrEqT3,29,25,1,72,0,0,8,0,106,15.142857142857142,3,0.0,1,1,67,0,24,0,5,8,0,69,37,0
304,6238,rc6U1IMtYVyu2KS4UAAUQ2nFc3tipLM4,SpATywNh6bZuzm8s1ceuBUnMUAeoAHHw,3,0,0,0,0,0,3,0,3,0.42857142857142855,1,0.0,0,0,0,0,0,0,0,3,0,0,3,1
305,6241,JOowoFboUWVsMh86KvKaqn28cyqJccLu,SpATywNh6bZuzm8s1ceuBUnMUAeoAHHw,6,3,0,0,0,0,5,0,8,1.1428571428571428,2,0.0,0,0,0,0,3,0,0,5,0,0,8,1
306,6251,xHZbSROhwP4RRQerUVWvcNTfOGc2DHWf,A3fsA9Zfv1X2fVEQhTw51lKENdNrEqT3,39,59,33,162,10,107,37,2,410,58.57142857142857,7,0.0,6,33,124,10,53,107,38,37,2,173,237,0
307,6275,CMyYXmkdotyZIBj4pIMXARl4LU8dOntR,RXDvfPUBYFlVdlueBFbLW0mhhAyGEqpt,15,13,6,0,3,4,7,3,36,5.142857142857143,1,0.0,2,6,0,3,11,4,0,7,3,11,25,1
308,6276,e05jFgKTpMKrOATktordZrOlXAadcmLm,bWdj2GDclj5ofokWjzoa5jAwMkxCykd6,3,2,0,0,0,0,1,0,3,0.42857142857142855,1,0.0,0,0,0,0,2,0,0,1,0,0,3,1
309,6301,4NUGABfnQkRS9FoH90Vgnhdha4tRSmOB,A3fsA9Zfv1X2fVEQhTw51lKENdNrEqT3,37,35,23,64,9,0,14,0,145,20.714285714285715,7,0.0,3,23,54,9,32,0,10,14,0,89,56,0
310,6310,K0OSl2yDmHYQ9TtZdxy9shErNwx3ga0n,SpATywNh6bZuzm8s1ceuBUnMUAeoAHHw,11,8,3,20,0,0,1,0,32,4.571428571428571,1,0.0,4,3,19,0,4,0,1,1,0,26,6,1
311,6322,2IvFgMw0NfaiiFt35dmyYrQHt1TRMHZA,SpATywNh6bZuzm8s1ceuBUnMUAeoAHHw,1,0,0,0,0,0,1,0,1,0.14285714285714285,1,0.0,0,0,0,0,0,0,0,1,0,0,1,0
312,6333,VRqncpDBm1hyq75gsrR3U5uyrx0nFI6D,G8EPVSXsOYB5YQWZGiz1aVq5Pgr2GrQu,4,3,0,0,0,0,1,0,4,0.5714285714285714,1,0.0,0,0,0,0,3,0,0,1,0,0,4,0
313,6344,e09uq36QgLuBVK5DERoejsHeMH2uPMRM,RXDvfPUBYFlVdlueBFbLW0mhhAyGEqpt,7,5,1,0,1,0,2,0,9,1.2857142857142858,1,0.0,0,1,0,1,5,0,0,2,0,2,7,1
314,6360,S6vBzHKpSh31SFGGZmwgKaOH2RvW3RpH,A3fsA9Zfv1X2fVEQhTw51lKENdNrEqT3,1,0,0,0,0,0,1,0,1,0.14285714285714285,1,0.0,0,0,0,0,0,0,0,1,0,0,1,0
315,6361,8nT76hrzyl8ZAUdI7W6kfrIzHxI3puKM,A3fsA9Zfv1X2fVEQhTw51lKENdNrEqT3,10,13,0,0,0,0,3,0,16,2.2857142857142856,1,0.0,0,0,0,0,13,0,0,3,0,0,16,0
316,6386,sgU8bYbkNg27HLTOfRzwWIg1HmjCd9Xd,SpATywNh6bZuzm8s1ceuBUnMUAeoAHHw,2,0,0,0,0,0,4,0,4,0.5714285714285714,2,0.0,0,0,0,0,0,0,0,4,0,0,4,0
317,6391,VWT0erf4AD2BzAGMlVwaBcrhUFyVXGW3,SpATywNh6bZuzm8s1ceuBUnMUAeoAHHw,1,0,0,0,0,0,2,0,2,0.2857142857142857,2,0.0,0,0,0,0,0,0,0,2,0,0,2,0
318,6396,mXsmDArxUTe9rMFHp3cGPJEx5ACYKD90,SpATywNh6bZuzm8s1ceuBUnMUAeoAHHw,5,9,5,0,0,104,7,0,125,17.857142857142858,5,0.0,0,5,0,0,9,104,0,7,0,5,120,0
319,6407,y7mamutAMELy79Bgdj0zOeVjiQ071oNX,SpATywNh6bZuzm8s1ceuBUnMUAeoAHHw,4,3,1,0,1,0,0,0,5,0.7142857142857143,2,0.0,0,1,0,1,3,0,0,0,0,2,3,0
320,6419,ogzPi8CzE9rbCDvKtEdVGoEcOcn50cII,G8EPVSXsOYB5YQWZGiz1aVq5Pgr2GrQu,1,0,0,0,0,0,1,0,1,0.14285714285714285,1,0.0,0,0,0,0,0,0,0,1,0,0,1,1
321,6423,46NDON0KgB1jK61LBfpVyB2xpUlT8XUc,SpATywNh6bZuzm8s1ceuBUnMUAeoAHHw,4,2,0,0,0,0,4,0,6,0.8571428571428571,1,0.0,0,0,0,0,2,0,0,4,0,0,6,1
322,6427,vuqnfFRpmwKE9RdxK6XJMNF9m6H6VyTM,RXDvfPUBYFlVdlueBFbLW0mhhAyGEqpt,3,1,1,0,0,0,1,0,3,0.42857142857142855,1,0.0,0,1,0,0,1,0,0,1,0,1,2,0
323,6453,thQSVbeIiNRLplpbUVbYa004tKe0jz1z,SpATywNh6bZuzm8s1ceuBUnMUAeoAHHw,8,11,1,0,0,0,1,0,13,1.8571428571428572,1,0.0,0,1,0,0,11,0,0,1,0,1,12,1
324,6473,QYNtwRXZGk0TiZU9fvvZmyYTg9wzmVe8,bWdj2GDclj5ofokWjzoa5jAwMkxCykd6,16,12,0,16,0,31,11,0,70,10.0,5,0.0,3,0,14,0,9,31,2,11,0,17,53,0
325,6475,4NUGABfnQkRS9FoH90Vgnhdha4tRSmOB,SpATywNh6bZuzm8s1ceuBUnMUAeoAHHw,16,23,12,0,5,0,16,0,56,8.0,6,0.0,8,12,0,5,15,0,0,16,0,25,31,0
326,6476,5l7JbkjmfBonHdF7CbCa3GMejToAwTQZ,SpATywNh6bZuzm8s1ceuBUnMUAeoAHHw,2,0,0,0,0,0,3,0,3,0.42857142857142855,1,0.0,0,0,0,0,0,0,0,3,0,0,3,1
327,6480,fFnDSL1hWADv25SE5UTFI35tGRTcYBEF,SpATywNh6bZuzm8s1ceuBUnMUAeoAHHw,22,51,2,30,1,1,8,0,93,13.285714285714286,2,0.0,14,2,26,1,37,1,4,8,0,43,50,0
328,6490,CozZoSX7AwprtwyJFCAeFUYiCq7OSEAP,G8EPVSXsOYB5YQWZGiz1aVq5Pgr2GrQu,16,44,17,0,11,0,2,0,74,10.571428571428571,4,0.0,0,17,0,11,44,0,0,2,0,28,46,0
329,6494,w1o1S1rsKOagmFCmrSXvpPsO3fHW3lAq,A3fsA9Zfv1X2fVEQhTw51lKENdNrEqT3,4,5,3,0,0,0,3,0,11,1.5714285714285714,1,0.0,0,3,0,0,5,0,0,3,0,3,8,1
330,6497,QYNtwRXZGk0TiZU9fvvZmyYTg9wzmVe8,A3fsA9Zfv1X2fVEQhTw51lKENdNrEqT3,12,12,2,18,1,2,6,0,41,5.857142857142857,5,0.0,1,2,16,1,11,2,2,6,0,20,21,0
331,6502,MFUbiMqXEmfaBzK7hirtX5aBXDvqfQ39,RXDvfPUBYFlVdlueBFbLW0mhhAyGEqpt,24,16,11,34,7,2,0,0,70,10.0,2,0.0,4,11,31,7,12,2,3,0,0,53,17,0
332,6507,srJeJbIuD6nlvLtYdUFiQcvh7X1ghk8m,bWdj2GDclj5ofokWjzoa5jAwMkxCykd6,1,0,0,0,0,0,1,0,1,0.14285714285714285,1,0.0,0,0,0,0,0,0,0,1,0,0,1,1
333,6527,iYw8kPkvjn3xb3wtZEyAytTepRhqUlKj,SpATywNh6bZuzm8s1ceuBUnMUAeoAHHw,7,6,4,0,0,2,5,1,18,2.5714285714285716,2,0.0,0,4,0,0,6,2,0,5,1,4,14,0
334,6542,wSw0H7eAN6dfAeYMaWU4nG5bgtRJyFlj,SpATywNh6bZuzm8s1ceuBUnMUAeoAHHw,22,43,18,14,6,32,11,1,125,17.857142857142858,4,0.0,4,18,11,6,39,32,3,11,1,39,86,0
335,6547,6U06x0rZdU2wXE04MeChX934BjpYCGYO,A3fsA9Zfv1X2fVEQhTw51lKENdNrEqT3,11,7,5,0,3,0,1,0,16,2.2857142857142856,1,0.0,0,5,0,3,7,0,0,1,0,8,8,0
336,6551,uiGGvm5bzelA6YjURZYgSYljUTVOBIB1,A3fsA9Zfv1X2fVEQhTw51lKENdNrEqT3,3,2,1,0,0,0,1,0,4,0.5714285714285714,1,0.0,0,1,0,0,2,0,0,1,0,1,3,1
337,6556,xeRiyg2Y5ZgvqPGiWyjXk0hLMBeGkeoJ,RXDvfPUBYFlVdlueBFbLW0mhhAyGEqpt,17,12,4,48,4,2,8,1,79,11.285714285714286,1,0.0,5,4,39,4,7,2,9,8,1,52,27,0
338,6562,KnR9Rn7adHv02cUeYZsmQrRux2GhqbgV,SpATywNh6bZuzm8s1ceuBUnMUAeoAHHw,7,9,6,0,1,0,5,0,21,3.0,3,0.0,0,6,0,1,9,0,0,5,0,7,14,1
339,6579,FxyjnTbjAUnINdJgNqjfUflUXLEYBAKC,SpATywNh6bZuzm8s1ceuBUnMUAeoAHHw,5,5,1,0,0,0,3,0,9,1.2857142857142858,2,0.0,2,1,0,0,3,0,0,3,0,3,6,0
340,6605,xR1z4zZU6RpVYkLfGcAdkLgM2fC8s4Qf,SpATywNh6bZuzm8s1ceuBUnMUAeoAHHw,1,0,0,0,0,0,1,0,1,0.14285714285714285,1,0.0,0,0,0,0,0,0,0,1,0,0,1,1
341,6606,vqNQHlaqBAqN0Ghl4wYJYkeoe3u1AJkM,SpATywNh6bZuzm8s1ceuBUnMUAeoAHHw,4,4,2,0,0,0,5,0,11,1.5714285714285714,1,0.0,0,2,0,0,4,0,0,5,0,2,9,1
342,6619,TgtZeZ58ebuFniTgQX061K6ibFhvtBpU,SpATywNh6bZuzm8s1ceuBUnMUAeoAHHw,3,4,2,0,0,0,2,0,8,1.1428571428571428,2,0.0,0,2,0,0,4,0,0,2,0,2,6,0
343,6633,hu8eak1Xmf8voE8pnxPzkSD2dZP9Sipf,SpATywNh6bZuzm8s1ceuBUnMUAeoAHHw,11,9,0,13,0,14,12,0,48,6.857142857142857,2,0.0,2,0,11,0,7,14,2,12,0,13,35,0
344,6634,CozZoSX7AwprtwyJFCAeFUYiCq7OSEAP,SpATywNh6bZuzm8s1ceuBUnMUAeoAHHw,18,50,21,0,15,0,4,0,90,12.857142857142858,5,0.0,0,21,0,15,50,0,0,4,0,36,54,0
345,6635,xKsPjk1jm2BE3h1iJlr6XUhvP4lcDdRk,RXDvfPUBYFlVdlueBFbLW0mhhAyGEqpt,4,6,4,0,0,0,2,0,12,1.7142857142857142,2,0.0,0,4,0,0,6,0,0,2,0,4,8,0
346,6645,jzhfcjSJMALhuWl4kOoGHRTc9xbTfPXO,SpATywNh6bZuzm8s1ceuBUnMUAeoAHHw,3,6,2,0,0,0,2,0,10,1.4285714285714286,2,0.0,0,2,0,0,6,0,0,2,0,2,8,0
347,6646,JV1BgG1khCT6s4RU5oY7ZOSmwW31Qjbp,SpATywNh6bZuzm8s1ceuBUnMUAeoAHHw,1,0,0,0,0,0,2,0,2,0.2857142857142857,2,0.0,0,0,0,0,0,0,0,2,0,0,2,0
348,6651,imazrFpyX68kLUAydat119Z5XKshja9y,G8EPVSXsOYB5YQWZGiz1aVq5Pgr2GrQu,8,5,4,0,2,0,1,0,12,1.7142857142857142,1,0.0,0,4,0,2,5,0,0,1,0,6,6,1
349,6654,WIULTFMTHtU9DH0SABu7cidImBPYBDLB,SpATywNh6bZuzm8s1ceuBUnMUAeoAHHw,8,5,0,0,0,1,6,1,13,1.8571428571428572,1,0.0,0,0,0,0,5,1,0,6,1,0,13,1
350,6664,7nQB7cjVdr2HijR82OoX1oMRPa42JjfY,bWdj2GDclj5ofokWjzoa5jAwMkxCykd6,13,7,4,12,2,20,6,0,51,7.285714285714286,1,0.0,2,4,10,2,5,20,2,6,0,18,33,0
351,6665,tanZAGaF7HXSgqth6P4eBUao9FBYSWWr,G8EPVSXsOYB5YQWZGiz1aVq5Pgr2GrQu,6,6,1,0,1,0,5,0,13,1.8571428571428572,1,0.0,3,1,0,1,3,0,0,5,0,5,8,1
352,6666,MFUbiMqXEmfaBzK7hirtX5aBXDvqfQ39,A3fsA9Zfv1X2fVEQhTw51lKENdNrEqT3,2,1,1,0,0,0,0,0,2,0.2857142857142857,1,0.0,0,1,0,0,1,0,0,0,0,1,1,1
353,6668,FFC6l9rAl1GAsErQ9wySBY8QQVxtUctK,SpATywNh6bZuzm8s1ceuBUnMUAeoAHHw,3,0,0,0,0,0,3,0,3,0.42857142857142855,1,0.0,0,0,0,0,0,0,0,3,0,0,3,1
354,6680,dSGnj6srDjb9PWIgErMSQXx2qQzyzYUX,SpATywNh6bZuzm8s1ceuBUnMUAeoAHHw,15,15,10,0,7,0,2,0,34,4.857142857142857,2,0.0,1,10,0,7,14,0,0,2,0,18,16,0
355,6682,hl9NS7ZQVsxPwew9lFoMcbw555xXfA7K,SpATywNh6bZuzm8s1ceuBUnMUAeoAHHw,3,2,1,0,0,0,1,0,4,0.5714285714285714,1,0.0,0,1,0,0,2,0,0,1,0,1,3,1
356,6710,7FUJzRatex45Tiw3cL91Uz5fZD5gpQMy,RXDvfPUBYFlVdlueBFbLW0mhhAyGEqpt,2,0,0,0,0,0,2,0,2,0.2857142857142857,1,0.0,0,0,0,0,0,0,0,2,0,0,2,1
357,6721,5EbadEY64E8d6mWCOGPXe4HNciATivZW,SpATywNh6bZuzm8s1ceuBUnMUAeoAHHw,7,11,2,4,0,0,9,0,26,3.7142857142857144,2,0.0,3,2,4,0,8,0,0,9,0,9,17,0
358,6722,r5hJNp3FkX6JOBVI5bSeTBPneDl7PaKl,A3fsA9Zfv1X2fVEQhTw51lKENdNrEqT3,5,4,0,0,0,0,5,0,9,1.2857142857142858,1,0.0,0,0,0,0,4,0,0,5,0,0,9,1
359,6723,e12uQn96OlYfknMdqSXCXdImglIj4IRR,A3fsA9Zfv1X2fVEQhTw51lKENdNrEqT3,18,38,22,0,4,54,20,1,139,19.857142857142858,5,0.0,8,22,0,4,30,54,0,20,1,34,105,0
360,6724,2VLDXf2vRwSQsnPUMIG8jcgCB93IxRHm,SpATywNh6bZuzm8s1ceuBUnMUAeoAHHw,2,0,0,0,0,0,4,0,4,0.5714285714285714,1,0.0,0,0,0,0,0,0,0,4,0,0,4,1
361,6725,2LSIOP9EwUlEUMR84kNdXwxCTBof59AV,SpATywNh6bZuzm8s1ceuBUnMUAeoAHHw,1,0,0,0,0,0,2,0,2,0.2857142857142857,2,0.0,0,0,0,0,0,0,0,2,0,0,2,0
362,6734,XxYK4zbyqtm9UELp1oR6gZVKRAER78zL,A3fsA9Zfv1X2fVEQhTw51lKENdNrEqT3,29,31,17,50,7,10,19,1,135,19.285714285714285,4,0.0,4,17,39,7,27,10,11,19,1,67,68,1
363,6739,D5mwgoAPtfwdsFrdNADBqEJQSy8E0CUi,SpATywNh6bZuzm8s1ceuBUnMUAeoAHHw,1,0,0,0,0,0,1,0,1,0.14285714285714285,1,0.0,0,0,0,0,0,0,0,1,0,0,1,0
364,6740,YkHlvsvfON124uz3tNHCqQavCTgfzIIn,SpATywNh6bZuzm8s1ceuBUnMUAeoAHHw,8,6,2,0,1,6,8,1,24,3.4285714285714284,1,0.0,0,2,0,1,6,6,0,8,1,3,21,1
365,6741,uOAgQLQslSL4cABC9ZqhaeK1XrisqlGh,SpATywNh6bZuzm8s1ceuBUnMUAeoAHHw,14,12,5,6,3,0,6,0,32,4.571428571428571,3,0.0,4,5,6,3,8,0,0,6,0,18,14,0
366,6761,DTS3O3ZujmzMefQXzAvfnTTqItcbsW8A,SpATywNh6bZuzm8s1ceuBUnMUAeoAHHw,9,15,1,0,0,21,5,1,43,6.142857142857143,3,0.0,0,1,0,0,15,21,0,5,1,1,42,0
367,6762,MFUbiMqXEmfaBzK7hirtX5aBXDvqfQ39,bWdj2GDclj5ofokWjzoa5jAwMkxCykd6,6,4,3,0,3,0,1,0,11,1.5714285714285714,1,0.0,0,3,0,3,4,0,0,1,0,6,5,1
368,6776,r5hJNp3FkX6JOBVI5bSeTBPneDl7PaKl,bWdj2GDclj5ofokWjzoa5jAwMkxCykd6,1,0,0,0,0,0,1,0,1,0.14285714285714285,1,0.0,0,0,0,0,0,0,0,1,0,0,1,1
369,6778,lVgq3gYt1tDiZq5EPAUcQ3qHGrMei1Rm,SpATywNh6bZuzm8s1ceuBUnMUAeoAHHw,1,0,0,0,0,0,1,0,1,0.14285714285714285,1,0.0,0,0,0,0,0,0,0,1,0,0,1,0
370,6781,eWIsTbhL2p3ztTyrIxD7wf9RK1qPkZuf,SpATywNh6bZuzm8s1ceuBUnMUAeoAHHw,3,6,2,0,0,0,3,0,11,1.5714285714285714,3,0.0,0,2,0,0,6,0,0,3,0,2,9,0
371,6783,hjSv3nB1dzB315OJ0MdIWlJoWmd5FDgm,bWdj2GDclj5ofokWjzoa5jAwMkxCykd6,2,0,0,0,0,6,1,0,7,1.0,1,0.0,0,0,0,0,0,6,0,1,0,0,7,1
372,6785,ptoBkN66Bt2QtZB1aEXx1ZVYWGKSe4nx,SpATywNh6bZuzm8s1ceuBUnMUAeoAHHw,23,39,18,21,5,2,13,0,98,14.0,2,0.0,14,18,20,5,25,2,1,13,0,57,41,0
373,6823,DeZ9eduD0lM3aHUAAOCnUrOhgp8jUmje,SpATywNh6bZuzm8s1ceuBUnMUAeoAHHw,2,0,0,0,0,0,6,0,6,0.8571428571428571,3,0.0,0,0,0,0,0,0,0,6,0,0,6,0
374,6825,QwrR0O4UOobB3AXjFyYOVMeWzFnayzmx,SpATywNh6bZuzm8s1ceuBUnMUAeoAHHw,18,9,6,15,4,0,9,1,44,6.285714285714286,3,0.0,2,6,13,4,7,0,2,9,1,25,19,1
375,6842,sbyXmrcpTszqVBWlyhJ5lsnmstVyQQWU,SpATywNh6bZuzm8s1ceuBUnMUAeoAHHw,1,0,0,0,0,0,2,0,2,0.2857142857142857,1,0.0,0,0,0,0,0,0,0,2,0,0,2,1
376,6862,JtMmp5BCDQnYE7CMI3NvnX4aRCZsQW9K,A3fsA9Zfv1X2fVEQhTw51lKENdNrEqT3,8,15,9,0,3,15,21,0,63,9.0,4,0.0,3,9,0,3,12,15,0,21,0,15,48,0
377,6866,ysSrXViwdbNw9df0HT1ETP8r4aB84YLw,SpATywNh6bZuzm8s1ceuBUnMUAeoAHHw,6,4,1,0,1,0,1,0,7,1.0,1,0.0,0,1,0,1,4,0,0,1,0,2,5,1
378,6878,7fC3V6ivG07wUIMOmiYFzSlyjWvbYnYf,SpATywNh6bZuzm8s1ceuBUnMUAeoAHHw,1,0,0,0,0,0,3,0,3,0.42857142857142855,3,0.0,0,0,0,0,0,0,0,3,0,0,3,0
379,6896,WVOs4Pi3ll5FpomkXlRuIpcugHN3f0rV,SpATywNh6bZuzm8s1ceuBUnMUAeoAHHw,6,5,3,0,1,0,7,0,16,2.2857142857142856,3,0.0,0,3,0,1,5,0,0,7,0,4,12,0
380,6915,V29AZJRcvBxCayax5I99yuRivRNPAZjj,SpATywNh6bZuzm8s1ceuBUnMUAeoAHHw,3,2,1,0,0,0,2,0,5,0.7142857142857143,1,0.0,0,1,0,0,2,0,0,2,0,1,4,0
381,6923,FXwY1YS9Ue01cJBRQTifvzVPDx1ARw9E,SpATywNh6bZuzm8s1ceuBUnMUAeoAHHw,5,4,0,0,0,0,2,0,6,0.8571428571428571,1,0.0,0,0,0,0,4,0,0,2,0,0,6,1
382,6934,nsZMAREUaN1W79W768VHLU7EdYuf3Qrp,G8EPVSXsOYB5YQWZGiz1aVq5Pgr2GrQu,12,13,1,0,3,0,4,0,21,3.0,2,0.0,0,1,0,3,13,0,0,4,0,4,17,0
383,6935,JR1R4x5j4WkP10KgaKlpdN5JIGsgsmdk,SpATywNh6bZuzm8s1ceuBUnMUAeoAHHw,5,3,2,0,1,0,2,0,8,1.1428571428571428,1,0.0,0,2,0,1,3,0,0,2,0,3,5,1
384,6944,cG2zraudtV44kPzel5abcAzgwVOUaAs4,A3fsA9Zfv1X2fVEQhTw51lKENdNrEqT3,1,0,0,0,0,0,1,0,1,0.14285714285714285,1,0.0,0,0,0,0,0,0,0,1,0,0,1,1
385,6972,ySy2zYThCkVZr5MjEXuKxq60wfOynxkJ,RXDvfPUBYFlVdlueBFbLW0mhhAyGEqpt,24,42,0,20,0,15,10,0,87,12.428571428571429,2,0.0,2,0,18,0,40,15,2,10,0,20,67,0
386,6975,ztNAIyTwcTmZ7oVMH6qBDo3dC1RimDND,SpATywNh6bZuzm8s1ceuBUnMUAeoAHHw,11,8,5,0,4,1,3,0,21,3.0,1,0.0,2,5,0,4,6,1,0,3,0,11,10,0
387,6977,EO1ssFp8oIj0TSE3bDdD8GeuhxRs5RVg,SpATywNh6bZuzm8s1ceuBUnMUAeoAHHw,7,7,2,0,2,0,9,0,20,2.857142857142857,2,0.0,0,2,0,2,7,0,0,9,0,4,16,0
388,6982,R0LbBsHoep5Au5A4mW7do32jHSfgQD8E,SpATywNh6bZuzm8s1ceuBUnMUAeoAHHw,18,40,15,14,3,37,14,2,125,17.857142857142858,4,0.0,19,15,11,3,21,37,3,14,2,48,77,1
389,6986,7fC3V6ivG07wUIMOmiYFzSlyjWvbYnYf,bWdj2GDclj5ofokWjzoa5jAwMkxCykd6,16,18,0,38,0,0,7,0,63,9.0,4,0.0,3,0,31,0,15,0,7,7,0,34,29,0
390,6992,YvR8b2YAoaLYLpo6WJ6bDiEtPLllysRd,RXDvfPUBYFlVdlueBFbLW0mhhAyGEqpt,21,23,16,26,5,0,8,0,78,11.142857142857142,1,0.0,3,16,23,5,20,0,3,8,0,47,31,0
391,6996,Ah63NhKhS4EP98tjvGlVfvoLlBn6V6BJ,A3fsA9Zfv1X2fVEQhTw51lKENdNrEqT3,1,0,0,0,0,0,1,0,1,0.14285714285714285,1,0.0,0,0,0,0,0,0,0,1,0,0,1,1
392,7009,oBSB2zh7bYN4yELh7x5ItqnxR463BvKC,bWdj2GDclj5ofokWjzoa5jAwMkxCykd6,17,69,21,22,18,0,12,0,142,20.285714285714285,5,0.0,17,21,18,18,52,0,4,12,0,74,68,0
393,7013,FTzllWD6ZzVNVacMJQ1FqQQ50E09onOa,bWdj2GDclj5ofokWjzoa5jAwMkxCykd6,9,9,4,0,2,4,8,1,28,4.0,1,0.0,0,4,0,2,9,4,0,8,1,6,22,1
394,7025,EFMEoi5W4mceo8rjft5LKrYvvT3E2eat,bWdj2GDclj5ofokWjzoa5jAwMkxCykd6,4,2,0,0,0,9,3,1,15,2.142857142857143,2,0.0,0,0,0,0,2,9,0,3,1,0,15,1
395,7030,AntKijOf83pltCnII9LLX8PQYe0F20yO,G8EPVSXsOYB5YQWZGiz1aVq5Pgr2GrQu,9,9,5,0,2,0,4,0,20,2.857142857142857,2,0.0,0,5,0,2,9,0,0,4,0,7,13,0
396,7033,hplRuUXyLFhHcMqMJcb12YjqquTYp3Qw,A3fsA9Zfv1X2fVEQhTw51lKENdNrEqT3,1,0,1,0,0,0,0,0,1,0.14285714285714285,1,0.0,0,1,0,0,0,0,0,0,0,1,0,0
397,7037,1pusTPLSLF5m0UuZqZkNpGlAq8VrQ1KA,SpATywNh6bZuzm8s1ceuBUnMUAeoAHHw,30,29,17,21,8,6,9,0,90,12.857142857142858,3,0.0,7,17,20,8,22,6,1,9,0,52,38,0
398,7045,Qo4EYwRduG0qocv3scjgK3zQnLtIvid1,SpATywNh6bZuzm8s1ceuBUnMUAeoAHHw,9,14,5,0,2,0,8,0,29,4.142857142857143,5,0.0,0,5,0,2,14,0,0,8,0,7,22,0
399,7060,dGqImSq9UHavQbhAMWmMoDizcuOefX1Y,SpATywNh6bZuzm8s1ceuBUnMUAeoAHHw,19,23,2,18,2,1,9,1,56,8.0,3,0.0,6,2,15,2,17,1,3,9,1,25,31,0
400,7080,KqUCRL8ws5CG5PQvlspSHJpgFexIO4Jl,SpATywNh6bZuzm8s1ceuBUnMUAeoAHHw,1,0,0,0,0,0,1,0,1,0.14285714285714285,1,0.0,0,0,0,0,0,0,0,1,0,0,1,0
401,7083,k85NFhuORfuDcrrXLAFWOhl0dHDWmC1t,bWdj2GDclj5ofokWjzoa5jAwMkxCykd6,10,10,7,2,1,0,5,0,25,3.5714285714285716,2,0.0,0,7,2,1,10,0,0,5,0,10,15,1
402,7091,zBYq3S89hCrsMeRBWwKxH3wWGwuZLtQd,SpATywNh6bZuzm8s1ceuBUnMUAeoAHHw,13,11,1,22,0,0,1,0,35,5.0,1,0.0,5,1,22,0,6,0,0,1,0,28,7,1
403,7093,cz3HVUxVHDVORvVKi9yREbYasmzZlaFd,G8EPVSXsOYB5YQWZGiz1aVq5Pgr2GrQu,25,37,6,10,5,0,15,0,73,10.428571428571429,4,0.0,2,6,10,5,35,0,0,15,0,23,50,0
404,7117,RHl3DsvAX7TisJ7qBptmgrrtDAQvH7mr,A3fsA9Zfv1X2fVEQhTw51lKENdNrEqT3,10,14,8,0,1,0,3,0,26,3.7142857142857144,3,0.0,1,8,0,1,13,0,0,3,0,10,16,0
405,7124,DRhlp1eJHQqsxjCL0bRD6kkHN20HbJ4w,SpATywNh6bZuzm8s1ceuBUnMUAeoAHHw,3,16,7,0,0,0,8,0,31,4.428571428571429,5,0.0,0,7,0,0,16,0,0,8,0,7,24,0
406,7128,RvFRgUGsoT6kl0oxj3AEZMdMRkNHUTgp,SpATywNh6bZuzm8s1ceuBUnMUAeoAHHw,15,23,6,38,0,1,11,0,79,11.285714285714286,3,0.0,15,6,31,0,8,1,7,11,0,52,27,1
407,7137,rT1OrFQC18rdvYkTGYqwRgC7eDvihHsc,bWdj2GDclj5ofokWjzoa5jAwMkxCykd6,12,23,14,0,3,103,21,1,165,23.571428571428573,7,0.0,1,14,0,3,22,103,0,21,1,18,147,0
408,7142,YE22fRNdaFtk3nhWfjSOMHWERX5O7Ymi,A3fsA9Zfv1X2fVEQhTw51lKENdNrEqT3,37,61,5,62,2,0,11,0,141,20.142857142857142,5,0.0,2,5,55,2,59,0,7,11,0,64,77,0
409,7158,Ky3k8JBiR8OkS6sd2foNFIGjx3wXRsFp,G8EPVSXsOYB5YQWZGiz1aVq5Pgr2GrQu,32,55,2,8,2,20,19,3,109,15.571428571428571,2,0.0,13,2,4,2,42,20,4,19,3,21,88,0
410,7179,3HOnjRDe3XaKpyhDvtGYWIvTQ5R0B6U5,RXDvfPUBYFlVdlueBFbLW0mhhAyGEqpt,1,0,0,0,0,0,2,0,2,0.2857142857142857,1,0.0,0,0,0,0,0,0,0,2,0,0,2,1
411,7181,29zlPnPFaHRpKhWmQq4cQrKoDn0GEyMA,SpATywNh6bZuzm8s1ceuBUnMUAeoAHHw,4,9,4,0,0,0,3,0,16,2.2857142857142856,4,0.0,0,4,0,0,9,0,0,3,0,4,12,1
412,7197,yiOlNWWu3p4vJ73FHFCmMYCNgzMDTrne,A3fsA9Zfv1X2fVEQhTw51lKENdNrEqT3,32,10,7,76,4,0,3,0,100,14.285714285714286,1,0.0,1,7,69,4,9,0,7,3,0,81,19,1
413,7219,t0cRwLqt3PES7T3WXJUMfvNkz6DOAsQy,G8EPVSXsOYB5YQWZGiz1aVq5Pgr2GrQu,5,6,3,0,2,0,1,0,12,1.7142857142857142,2,0.0,0,3,0,2,6,0,0,1,0,5,7,0
414,7222,7abxlkdMiNWAIk78NzVnHWo2fZI6eMvl,SpATywNh6bZuzm8s1ceuBUnMUAeoAHHw,2,0,0,0,0,2,1,0,3,0.42857142857142855,1,0.0,0,0,0,0,0,2,0,1,0,0,3,1
415,7229,iZlqOil8HuQgM9wIdCp3EDJlfdWSJRmO,SpATywNh6bZuzm8s1ceuBUnMUAeoAHHw,3,2,0,0,0,0,1,0,3,0.42857142857142855,1,0.0,0,0,0,0,2,0,0,1,0,0,3,0
416,7240,HJ4qDtw6u2JHJE7qmEDgWJOzWUYAv4mG,A3fsA9Zfv1X2fVEQhTw51lKENdNrEqT3,41,28,20,82,10,11,7,0,158,22.571428571428573,2,0.0,1,20,71,10,27,11,11,7,0,102,56,0
417,7256,D1NRZnTG0gvNQpfa2XPRkdGhYZVx3Bz8,RXDvfPUBYFlVdlueBFbLW0mhhAyGEqpt,6,5,3,0,1,0,5,0,14,2.0,3,0.0,0,3,0,1,5,0,0,5,0,4,10,0
418,7262,WIuYkRjZD9FutPqnDeyA4qgpxVJpTEdL,SpATywNh6bZuzm8s1ceuBUnMUAeoAHHw,1,0,0,0,0,0,1,0,1,0.14285714285714285,1,0.0,0,0,0,0,0,0,0,1,0,0,1,0
419,7274,YZ1MgmwJiUridNKhbKx061bAjGk955T1,G8EPVSXsOYB5YQWZGiz1aVq5Pgr2GrQu,20,47,1,50,0,0,0,0,98,14.0,4,0.0,1,1,40,0,46,0,10,0,0,42,56,0
420,7291,o7nB1nybhMcFgLy31X3R6RDOK94b1Iaa,SpATywNh6bZuzm8s1ceuBUnMUAeoAHHw,15,25,2,8,2,0,4,0,41,5.857142857142857,2,0.0,3,2,7,2,22,0,1,4,0,14,27,0
421,7296,ObMYjZj16p1bGCa8nmaBIv8cDUPUXE5o,SpATywNh6bZuzm8s1ceuBUnMUAeoAHHw,3,0,0,0,0,0,8,0,8,1.1428571428571428,4,0.0,0,0,0,0,0,0,0,8,0,0,8,0
422,7297,bAkMyE6uCR0gc04pERZmDJrGVqJ4Z2Yi,G8EPVSXsOYB5YQWZGiz1aVq5Pgr2GrQu,18,31,25,0,16,0,7,0,79,11.285714285714286,6,0.0,0,25,0,16,31,0,0,7,0,41,38,0
423,7298,VSEOcWZYpZiKC2PUmidzj4VqbBnc3GAo,bWdj2GDclj5ofokWjzoa5jAwMkxCykd6,17,11,5,14,1,16,26,2,75,10.714285714285714,4,0.0,3,5,14,1,8,16,0,26,2,23,52,0
424,7301,Yby0It9Tj4ASosIcvg72qeavqJKBNZLT,bWdj2GDclj5ofokWjzoa5jAwMkxCykd6,1,0,0,0,0,0,1,0,1,0.14285714285714285,1,0.0,0,0,0,0,0,0,0,1,0,0,1,1
425,7318,7glymc4Wt1TTt6LrLi78VQNF5GV1r6UY,bWdj2GDclj5ofokWjzoa5jAwMkxCykd6,8,4,2,8,1,0,2,0,17,2.4285714285714284,1,0.0,1,2,8,1,3,0,0,2,0,12,5,1
426,7325,3jh7S7idreXg4tLgwxk2JirIFS2kxatr,SpATywNh6bZuzm8s1ceuBUnMUAeoAHHw,11,13,10,0,7,0,5,0,35,5.0,3,0.0,0,10,0,7,13,0,0,5,0,17,18,0
427,7328,83p9ejSELsW1j5wNlAyUXF2YWFL8Z8tc,bWdj2GDclj5ofokWjzoa5jAwMkxCykd6,10,7,3,0,3,0,1,0,14,2.0,2,0.0,0,3,0,3,7,0,0,1,0,6,8,0
428,7344,B9KqNNxXBxHFUsJnQKQysblL3f8zF7sg,A3fsA9Zfv1X2fVEQhTw51lKENdNrEqT3,12,36,5,0,0,0,9,0,50,7.142857142857143,4,0.0,0,5,0,0,36,0,0,9,0,5,45,0
429,7350,ve9ySeJmFQKT879uz3hqg8kvVYA6FA8D,SpATywNh6bZuzm8s1ceuBUnMUAeoAHHw,1,0,0,0,0,0,2,0,2,0.2857142857142857,1,0.0,0,0,0,0,0,0,0,2,0,0,2,1
430,7356,uXSmZuPz2xNXPk2qFBcPykAtedr98vP4,RXDvfPUBYFlVdlueBFbLW0mhhAyGEqpt,8,10,7,0,5,0,2,0,24,3.4285714285714284,2,0.0,0,7,0,5,10,0,0,2,0,12,12,0
431,7372,32uJBAomTJQIXKZnCX4K7PYoVfESGbct,A3fsA9Zfv1X2fVEQhTw51lKENdNrEqT3,29,17,2,60,1,0,2,0,82,11.714285714285714,3,0.0,1,2,58,1,16,0,2,2,0,62,20,1
432,7385,ErlOpSNxC1ZbmJguJSp3ZjxFq4nCmwgx,G8EPVSXsOYB5YQWZGiz1aVq5Pgr2GrQu,6,4,1,0,1,0,4,0,10,1.4285714285714286,2,0.0,2,1,0,1,2,0,0,4,0,4,6,0
433,7391,7L5unYIhab1TebFiFv55Vd3f3JppE4WH,A3fsA9Zfv1X2fVEQhTw51lKENdNrEqT3,8,10,8,0,5,0,2,0,25,3.5714285714285716,1,0.0,0,8,0,5,10,0,0,2,0,13,12,0
434,7440,5TRqp5WlxU778HZGbnj0S6xLTaRfUJxG,SpATywNh6bZuzm8s1ceuBUnMUAeoAHHw,17,30,1,21,1,3,9,0,65,9.285714285714286,3,0.0,16,1,18,1,14,3,3,9,0,36,29,0
435,7463,zdqliI4eCBGH6nGv4KKIRZFL1YFXBytK,SpATywNh6bZuzm8s1ceuBUnMUAeoAHHw,7,5,3,0,0,13,8,0,29,4.142857142857143,2,0.0,0,3,0,0,5,13,0,8,0,3,26,0
436,7466,lFMYqumkG36iLJm9YwVpbzadzxUvswUa,SpATywNh6bZuzm8s1ceuBUnMUAeoAHHw,4,4,3,0,0,0,1,0,8,1.1428571428571428,1,0.0,0,3,0,0,4,0,0,1,0,3,5,0
437,7488,uUSTKM8g1hIskJbYHh1UiIQ6epHTSTNR,A3fsA9Zfv1X2fVEQhTw51lKENdNrEqT3,8,6,4,2,1,0,1,0,14,2.0,1,0.0,1,4,2,1,5,0,0,1,0,8,6,1
438,7491,uUSTKM8g1hIskJbYHh1UiIQ6epHTSTNR,RXDvfPUBYFlVdlueBFbLW0mhhAyGEqpt,23,19,12,22,8,1,7,1,70,10.0,2,0.0,3,12,20,8,16,1,2,7,1,43,27,0
439,7503,0PrF4PViZdaRQhbt6FYXwLbcetJ8RnwC,A3fsA9Zfv1X2fVEQhTw51lKENdNrEqT3,49,27,1,192,0,0,8,0,228,32.57142857142857,2,0.0,6,1,163,0,21,0,29,8,0,170,58,0
440,7504,NH2DAS5rCP8HjIcwHAZxDBAjUjjdHeyM,SpATywNh6bZuzm8s1ceuBUnMUAeoAHHw,2,0,0,0,0,0,3,0,3,0.42857142857142855,1,0.0,0,0,0,0,0,0,0,3,0,0,3,0
441,7521,a3StgABPgimfVHzW1FR4usG9kIA0tZV5,bWdj2GDclj5ofokWjzoa5jAwMkxCykd6,12,19,1,20,3,0,2,0,45,6.428571428571429,2,0.0,6,1,18,3,13,0,2,2,0,28,17,1
442,7525,xNkIHhqS8GZXIqyoWwwS3ZeYfSmUsNJo,A3fsA9Zfv1X2fVEQhTw51lKENdNrEqT3,10,10,5,0,3,0,3,0,21,3.0,2,0.0,0,5,0,3,10,0,0,3,0,8,13,0
443,7535,8a9f5zlAzg00IZpxpFpd0Yys1Z1UDN82,RXDvfPUBYFlVdlueBFbLW0mhhAyGEqpt,7,6,5,0,2,0,2,0,15,2.142857142857143,2,0.0,0,5,0,2,6,0,0,2,0,7,8,1
444,7550,EGswqlieknT0DkOMjaOEPr1kJjoddSSw,G8EPVSXsOYB5YQWZGiz1aVq5Pgr2GrQu,6,5,0,0,0,3,5,1,14,2.0,2,0.0,0,0,0,0,5,3,0,5,1,0,14,0
445,7552,ljmWZCzWPqv1RXsn1q2wpsQtrnA1zct2,SpATywNh6bZuzm8s1ceuBUnMUAeoAHHw,3,2,1,0,0,0,1,0,4,0.5714285714285714,1,0.0,0,1,0,0,2,0,0,1,0,1,3,0
446,7581,QoKkWqCz9JSPf2G2l4XrJl2BfFSq9X9B,RXDvfPUBYFlVdlueBFbLW0mhhAyGEqpt,35,30,0,91,2,22,11,2,158,22.571428571428573,2,0.0,12,0,87,2,18,22,4,11,2,101,57,0
447,7628,hRBUrY0Ipi1X9aVKI1Gcp4xJWynJPCa6,SpATywNh6bZuzm8s1ceuBUnMUAeoAHHw,3,9,6,0,0,0,1,0,16,2.2857142857142856,3,0.0,0,6,0,0,9,0,0,1,0,6,10,0
448,7633,11ljuSLdnPtPyfemLE7b9qn6qXcmssv1,SpATywNh6bZuzm8s1ceuBUnMUAeoAHHw,3,2,1,0,0,0,1,0,4,0.5714285714285714,1,0.0,0,1,0,0,2,0,0,1,0,1,3,1
449,7652,PQ7ibn4CoD7R92qj9CnBXvU4YpUOqVHi,SpATywNh6bZuzm8s1ceuBUnMUAeoAHHw,2,0,0,0,0,0,2,0,2,0.2857142857142857,1,0.0,0,0,0,0,0,0,0,2,0,0,2,0
450,7653,v9Jp2iBPSFTVxP8FrUe1odwfz8Hd1wS3,RXDvfPUBYFlVdlueBFbLW0mhhAyGEqpt,1,0,0,0,0,0,1,0,1,0.14285714285714285,1,0.0,0,0,0,0,0,0,0,1,0,0,1,0
451,7675,LiEDHNjd9tDT7NPtKiOjuDJtkaP8cSxY,bWdj2GDclj5ofokWjzoa5jAwMkxCykd6,29,25,16,56,4,10,7,0,118,16.857142857142858,2,0.0,2,16,46,4,23,10,10,7,0,68,50,0
452,7702,ulNRkVxxtx7SLWYKYYIDWhAGHHFqHWWG,SpATywNh6bZuzm8s1ceuBUnMUAeoAHHw,1,0,0,0,0,0,2,0,2,0.2857142857142857,2,0.0,0,0,0,0,0,0,0,2,0,0,2,0
453,7707,Om7TmUpRVXmKCq1XRkQCdyE9M7r8n9tE,SpATywNh6bZuzm8s1ceuBUnMUAeoAHHw,11,12,5,14,0,0,2,0,33,4.714285714285714,1,0.0,5,5,12,0,7,0,2,2,0,22,11,0
454,7711,U4GXlaQk4qQjr2K7P59OKvXX0vv1Pxee,SpATywNh6bZuzm8s1ceuBUnMUAeoAHHw,3,2,0,0,0,0,2,0,4,0.5714285714285714,1,0.0,0,0,0,0,2,0,0,2,0,0,4,0
455,7713,0W4XScVx81tfxJ0Qr09mHB39FqA62JyS,SpATywNh6bZuzm8s1ceuBUnMUAeoAHHw,7,7,0,12,0,0,0,0,19,2.7142857142857144,1,0.0,2,0,12,0,5,0,0,0,0,14,5,1
456,7721,MAlRgKpZXlP3WrMKjRw2YskqEALVtCKw,SpATywNh6bZuzm8s1ceuBUnMUAeoAHHw,5,8,1,0,0,0,2,0,11,1.5714285714285714,2,0.0,2,1,0,0,6,0,0,2,0,3,8,0
457,7727,h5vEAVTb94xGNGjpn4Ohi5mNcXfM0rMl,RXDvfPUBYFlVdlueBFbLW0mhhAyGEqpt,11,17,1,8,3,0,2,0,31,4.428571428571429,1,0.0,7,1,8,3,10,0,0,2,0,19,12,1
458,7742,zu1WAijSG0F2wy5x45xxD1w2SrPWGtuK,RXDvfPUBYFlVdlueBFbLW0mhhAyGEqpt,8,4,0,2,0,7,12,0,25,3.5714285714285716,2,0.0,1,0,1,0,3,7,1,12,0,2,23,0
459,7752,nIJT2WzxvFmAAdv0mMRGLvQiPT819gU3,SpATywNh6bZuzm8s1ceuBUnMUAeoAHHw,4,2,1,0,0,0,4,0,7,1.0,2,0.0,0,1,0,0,2,0,0,4,0,1,6,0
460,7762,2Sqmg51RWZnvGf1B4BEysn1wJm7yLaQl,G8EPVSXsOYB5YQWZGiz1aVq5Pgr2GrQu,28,68,13,30,2,8,8,0,129,18.428571428571427,3,0.0,26,13,16,2,42,8,14,8,0,57,72,0
461,7769,QV7Z9LfpjzP9d797QCfKxmoOjdo08shd,SpATywNh6bZuzm8s1ceuBUnMUAeoAHHw,3,4,2,0,0,3,2,0,11,1.5714285714285714,2,0.0,0,2,0,0,4,3,0,2,0,2,9,0
462,7784,Y96AzEZtgYGN39EPdmAzdYPvLhv1Tzsf,SpATywNh6bZuzm8s1ceuBUnMUAeoAHHw,4,2,1,0,0,0,2,0,5,0.7142857142857143,1,0.0,0,1,0,0,2,0,0,2,0,1,4,0
463,7787,b87ksD29UBdF2YCxTtUOCsx5OJsZrMS6,SpATywNh6bZuzm8s1ceuBUnMUAeoAHHw,3,2,1,0,0,0,1,0,4,0.5714285714285714,1,0.0,0,1,0,0,2,0,0,1,0,1,3,1
464,7817,KLERBlLR5to2IuMEV6VaweaoU18ID2Ks,SpATywNh6bZuzm8s1ceuBUnMUAeoAHHw,18,31,18,19,11,0,10,0,89,12.714285714285714,2,0.0,8,18,18,11,23,0,1,10,0,55,34,1
465,7818,LMGbvXS3ZBgtTcKCRLMcqBHrfADBxwXe,SpATywNh6bZuzm8s1ceuBUnMUAeoAHHw,5,4,2,0,0,0,5,0,11,1.5714285714285714,2,0.0,0,2,0,0,4,0,0,5,0,2,9,0
466,7839,WYNpj52NyIePFOfUouGRXkQmACPQnP2J,SpATywNh6bZuzm8s1ceuBUnMUAeoAHHw,6,5,2,0,0,58,17,0,82,11.714285714285714,4,0.0,0,2,0,0,5,58,0,17,0,2,80,0
467,7853,70BrIR23BcsI705EZj4LSyr7fHWI0Xjf,A3fsA9Zfv1X2fVEQhTw51lKENdNrEqT3,3,6,2,0,0,12,3,0,23,3.2857142857142856,2,0.0,0,2,0,0,6,12,0,3,0,2,21,0
468,7858,Ak0ru019Ynz1X1qhUbDFCskGZavLrHBc,SpATywNh6bZuzm8s1ceuBUnMUAeoAHHw,6,5,2,0,0,0,5,0,12,1.7142857142857142,2,0.0,2,2,0,0,3,0,0,5,0,4,8,0
469,7860,rWA9BhwEXXwDdj5p5FXRqP1JA3HaX1US,SpATywNh6bZuzm8s1ceuBUnMUAeoAHHw,12,12,9,0,4,0,2,0,27,3.857142857142857,1,0.0,0,9,0,4,12,0,0,2,0,13,14,1
470,7863,bDqqR2hng29QNjexgLbMGRH4AJBfyli8,SpATywNh6bZuzm8s1ceuBUnMUAeoAHHw,9,15,8,2,1,0,4,0,30,4.285714285714286,2,0.0,2,8,2,1,13,0,0,4,0,13,17,1
471,7868,ptvDGcVFI5vzF4lBwRLTADNrenNp2tF2,SpATywNh6bZuzm8s1ceuBUnMUAeoAHHw,6,6,3,0,0,3,7,1,20,2.857142857142857,3,0.0,0,3,0,0,6,3,0,7,1,3,17,0
472,7870,sj7wQJWVAxmId67LlkoaFzAmqWKmeC7I,SpATywNh6bZuzm8s1ceuBUnMUAeoAHHw,16,32,1,12,1,3,14,0,63,9.0,4,0.0,13,1,10,1,19,3,2,14,0,25,38,0
473,7923,pJUI0Hs11rZxgXk3r1clZCyuDCtGsbvH,SpATywNh6bZuzm8s1ceuBUnMUAeoAHHw,1,0,0,0,0,0,2,0,2,0.2857142857142857,2,0.0,0,0,0,0,0,0,0,2,0,0,2,1
474,7937,ywdL3xkp7d2PSjbvnflAvIe7Wp6Q4SRe,SpATywNh6bZuzm8s1ceuBUnMUAeoAHHw,4,13,5,0,0,0,8,0,26,3.7142857142857144,5,0.0,0,5,0,0,13,0,0,8,0,5,21,0
475,7942,JNo2rLqKe6aBGDwGzu8tXd13uOC5tEnq,bWdj2GDclj5ofokWjzoa5jAwMkxCykd6,4,2,2,0,0,0,6,0,10,1.4285714285714286,2,0.0,0,2,0,0,2,0,0,6,0,2,8,0
476,7949,FnY3or5QaQRvUAAgyu53eYBfcMnduugT,SpATywNh6bZuzm8s1ceuBUnMUAeoAHHw,3,4,1,0,0,0,3,0,8,1.1428571428571428,2,0.0,0,1,0,0,4,0,0,3,0,1,7,0
477,7952,CI12SZIYH2QOfgaDvq8F4VKXwDinb334,SpATywNh6bZuzm8s1ceuBUnMUAeoAHHw,7,5,3,0,1,0,1,0,10,1.4285714285714286,1,0.0,0,3,0,1,5,0,0,1,0,4,6,0
478,7954,WzyWOzB7f8AVbQvaWeU3O4gxEwZ13sIC,RXDvfPUBYFlVdlueBFbLW0mhhAyGEqpt,5,3,2,0,1,0,1,0,7,1.0,1,0.0,0,2,0,1,3,0,0,1,0,3,4,0
479,7956,ljmWZCzWPqv1RXsn1q2wpsQtrnA1zct2,G8EPVSXsOYB5YQWZGiz1aVq5Pgr2GrQu,30,19,15,75,2,2,5,0,118,16.857142857142858,2,0.0,2,15,61,2,17,2,14,5,0,80,38,1
480,7962,mtW8rWxW2XwZIB5TM8b8gUVmE4UACp0R,SpATywNh6bZuzm8s1ceuBUnMUAeoAHHw,4,5,3,0,0,0,3,0,11,1.5714285714285714,3,0.0,0,3,0,0,5,0,0,3,0,3,8,0
481,7964,z8zMi50azvRwAPUNW2f5Gt0F6WOr8PI9,A3fsA9Zfv1X2fVEQhTw51lKENdNrEqT3,5,3,2,0,1,0,1,0,7,1.0,1,0.0,0,2,0,1,3,0,0,1,0,3,4,1
482,7967,Wyji6pvgj7unEJ4mD7FWwu0Sma8fUdv4,SpATywNh6bZuzm8s1ceuBUnMUAeoAHHw,14,24,18,0,8,0,5,1,56,8.0,4,0.0,0,18,0,8,24,0,0,5,1,26,30,0
483,7973,SUqHrTqjE8jHVpASqCaMjjR6iZ17k2Gq,SpATywNh6bZuzm8s1ceuBUnMUAeoAHHw,6,11,5,0,0,0,10,0,26,3.7142857142857144,4,0.0,2,5,0,0,9,0,0,10,0,7,19,0
484,7975,EwJz8sdPLnTPbvCqxQKV7YueKEdP0wYf,SpATywNh6bZuzm8s1ceuBUnMUAeoAHHw,4,3,2,0,0,0,2,0,7,1.0,2,0.0,0,2,0,0,3,0,0,2,0,2,5,0
485,7999,j55CnsxXtuPHDTIgqOvx7oExU3RRtQ4I,SpATywNh6bZuzm8s1ceuBUnMUAeoAHHw,1,0,0,0,0,0,1,0,1,0.14285714285714285,1,0.0,0,0,0,0,0,0,0,1,0,0,1,1
486,8000,YiNeIrEOhZYEzsuuN5nQKcsVr5To2nDU,SpATywNh6bZuzm8s1ceuBUnMUAeoAHHw,2,0,0,0,0,0,3,0,3,0.42857142857142855,2,0.0,0,0,0,0,0,0,0,3,0,0,3,0
487,8001,DI3YZyhWTKxhZZnQuVUpGne2QEEoyvnw,SpATywNh6bZuzm8s1ceuBUnMUAeoAHHw,3,2,1,0,0,0,1,0,4,0.5714285714285714,1,0.0,0,1,0,0,2,0,0,1,0,1,3,0
488,8029,cuDL2ISAKT9SiekAD9CQynXiu9fQTVyV,G8EPVSXsOYB5YQWZGiz1aVq5Pgr2GrQu,5,5,2,0,0,0,4,0,11,1.5714285714285714,2,0.0,0,2,0,0,5,0,0,4,0,2,9,0
489,8059,W8K4VS8rPvnPTNUJrqgtS2FKH93KmR91,bWdj2GDclj5ofokWjzoa5jAwMkxCykd6,6,5,3,0,1,0,1,0,10,1.4285714285714286,1,0.0,0,3,0,1,5,0,0,1,0,4,6,1
490,8061,eDdFtfGTTqvukOdpQCeNfhpEnZacRMyL,SpATywNh6bZuzm8s1ceuBUnMUAeoAHHw,1,0,0,0,0,0,1,0,1,0.14285714285714285,1,0.0,0,0,0,0,0,0,0,1,0,0,1,0
491,8078,nD2aR2lBTYEZ05tUWGjogkwgt2d7zeNx,bWdj2GDclj5ofokWjzoa5jAwMkxCykd6,15,15,0,29,0,0,1,0,45,6.428571428571429,1,0.0,0,0,24,0,15,0,5,1,0,24,21,1
492,8155,S6HVmLPlerZStE1FmYWcP13FOlr0Ldio,SpATywNh6bZuzm8s1ceuBUnMUAeoAHHw,3,2,0,0,0,0,2,0,4,0.5714285714285714,1,0.0,0,0,0,0,2,0,0,2,0,0,4,1
493,8164,OvIrFDXnTf7lPGXHN37tKh2m9dXSHGJK,RXDvfPUBYFlVdlueBFbLW0mhhAyGEqpt,20,31,18,19,4,10,6,0,88,12.571428571428571,1,0.0,5,18,19,4,26,10,0,6,0,46,42,0
494,8167,4OFy9ZLb1svxpVgXkgI60wOGeiU4V4oA,SpATywNh6bZuzm8s1ceuBUnMUAeoAHHw,18,21,12,18,5,1,5,0,62,8.857142857142858,1,0.0,2,12,15,5,19,1,3,5,0,34,28,1
495,8171,Agc8I1aREEPfi2PqA7NK0aenTcuvE1HC,SpATywNh6bZuzm8s1ceuBUnMUAeoAHHw,1,0,0,0,0,0,3,0,3,0.42857142857142855,2,0.0,0,0,0,0,0,0,0,3,0,0,3,0
496,8174,ZFeBOOLKgUUTF7XgzMMbqDAJmFSviC7K,SpATywNh6bZuzm8s1ceuBUnMUAeoAHHw,4,4,3,0,0,0,2,0,9,1.2857142857142858,1,0.0,0,3,0,0,4,0,0,2,0,3,6,0
497,8183,FFyynYy7wGQKjNauntgybGuFHItz8juf,G8EPVSXsOYB5YQWZGiz1aVq5Pgr2GrQu,35,31,14,86,8,0,2,0,141,20.142857142857142,2,0.0,5,14,74,8,26,0,12,2,0,101,40,0
498,8200,myPDU4mr5TIDvQCh3WcoSxbhe6fCunPv,SpATywNh6bZuzm8s1ceuBUnMUAeoAHHw,9,11,5,14,0,0,6,0,36,5.142857142857143,1,0.0,2,5,13,0,9,0,1,6,0,20,16,0
499,8224,5u57vWlYBlYDQJhbIpJzLY4ZLMAv0Mtf,SpATywNh6bZuzm8s1ceuBUnMUAeoAHHw,3,2,0,0,0,0,2,0,4,0.5714285714285714,1,0.0,1,0,0,0,1,0,0,2,0,1,3,1
500,8241,EV3yvBrX41XoJgzc87hp5TvHhhtAvyFn,SpATywNh6bZuzm8s1ceuBUnMUAeoAHHw,4,3,2,0,0,0,2,0,7,1.0,1,0.0,0,2,0,0,3,0,0,2,0,2,5,1
501,8242,3mL78JhEm154Hwp0XQW8ZVuzbvUw5uCk,SpATywNh6bZuzm8s1ceuBUnMUAeoAHHw,3,2,1,0,0,0,2,0,5,0.7142857142857143,2,0.0,0,1,0,0,2,0,0,2,0,1,4,0
502,8252,HKDSRzc7MQzCfJsk49D6xFQK4oFHHvy7,SpATywNh6bZuzm8s1ceuBUnMUAeoAHHw,2,0,0,0,0,0,4,0,4,0.5714285714285714,2,0.0,0,0,0,0,0,0,0,4,0,0,4,0
503,8258,JTNAXWhf5PjT17BvIH89SNZsmQ5O87y8,SpATywNh6bZuzm8s1ceuBUnMUAeoAHHw,15,11,9,0,5,0,1,0,26,3.7142857142857144,1,0.0,1,9,0,5,10,0,0,1,0,15,11,1
504,8259,DVIil2NM7ZWOtqe6rhlMzwEUAb2wuaeh,bWdj2GDclj5ofokWjzoa5jAwMkxCykd6,25,39,20,30,5,8,9,0,111,15.857142857142858,5,0.0,3,20,30,5,36,8,0,9,0,58,53,0
505,8260,DVIil2NM7ZWOtqe6rhlMzwEUAb2wuaeh,A3fsA9Zfv1X2fVEQhTw51lKENdNrEqT3,33,70,31,30,10,5,8,0,154,22.0,4,0.0,1,31,30,10,69,5,0,8,0,72,82,0
506,8271,Bf5XnSmEHpp62KAmmEq9Qh5nAQvits8I,SpATywNh6bZuzm8s1ceuBUnMUAeoAHHw,16,19,10,12,8,0,4,0,53,7.571428571428571,2,0.0,8,10,11,8,11,0,1,4,0,37,16,1
507,8275,GHabqgRgi0KXSBTYXxIc3mcQESEOp0QM,SpATywNh6bZuzm8s1ceuBUnMUAeoAHHw,7,6,3,0,0,53,9,0,71,10.142857142857142,4,0.0,2,3,0,0,4,53,0,9,0,5,66,0
508,8276,V7y3ErWDx79HQwDxdGqBqCI3nEwG2a9C,SpATywNh6bZuzm8s1ceuBUnMUAeoAHHw,12,13,4,2,3,0,1,0,23,3.2857142857142856,1,0.0,0,4,2,3,13,0,0,1,0,9,14,0
509,8280,41Lg2hcbw0N9iuSjhrPTYqB7aTnux5zG,SpATywNh6bZuzm8s1ceuBUnMUAeoAHHw,4,4,1,0,0,0,2,0,7,1.0,1,0.0,0,1,0,0,4,0,0,2,0,1,6,0
510,8327,Rxx8uEqY3FOt7Egy2EEEwihJJCyVsQKy,G8EPVSXsOYB5YQWZGiz1aVq5Pgr2GrQu,8,7,3,8,3,0,2,0,23,3.2857142857142856,2,0.0,3,3,5,3,4,0,3,2,0,14,9,0
511,8335,2tvGCUYYinrGZmVDaUEHPItUSSMqiKmY,SpATywNh6bZuzm8s1ceuBUnMUAeoAHHw,1,0,0,0,0,0,1,0,1,0.14285714285714285,1,0.0,0,0,0,0,0,0,0,1,0,0,1,0
512,8336,UgRvVqO3twMvJzAlD49rqrTbxTS8yLpX,A3fsA9Zfv1X2fVEQhTw51lKENdNrEqT3,57,26,20,116,16,0,4,0,182,26.0,4,0.0,2,20,105,16,24,0,11,4,0,143,39,1
513,8347,jMKMopo0fDIDt1YMaxiGrP1SNRt3VtFz,SpATywNh6bZuzm8s1ceuBUnMUAeoAHHw,6,7,3,0,1,0,1,0,12,1.7142857142857142,1,0.0,3,3,0,1,4,0,0,1,0,7,5,0
514,8372,Ja8xgxpUQSylPcWwfGyX1RUCUJ6MhJqT,SpATywNh6bZuzm8s1ceuBUnMUAeoAHHw,24,38,16,10,7,29,10,0,110,15.714285714285714,3,0.0,9,16,9,7,29,29,1,10,0,41,69,0
515,8389,NngMZQTGAdrhmbSK51CUolNQSpFXDhiO,SpATywNh6bZuzm8s1ceuBUnMUAeoAHHw,1,0,0,0,0,0,1,0,1,0.14285714285714285,1,0.0,0,0,0,0,0,0,0,1,0,0,1,0
516,8391,tF8i4h1a2Nm3JCN3xA7kONOWBOERcJ4Q,SpATywNh6bZuzm8s1ceuBUnMUAeoAHHw,3,4,4,0,0,0,2,0,10,1.4285714285714286,2,0.0,0,4,0,0,4,0,0,2,0,4,6,0
517,8393,4sCPuVlkq4rBRlBYNyTR5EDg94co1oy4,bWdj2GDclj5ofokWjzoa5jAwMkxCykd6,1,0,0,0,0,0,1,0,1,0.14285714285714285,1,0.0,0,0,0,0,0,0,0,1,0,0,1,0
518,8400,LutlROyPHhGEkAfetUikskFihdvWMQNQ,SpATywNh6bZuzm8s1ceuBUnMUAeoAHHw,2,0,0,0,0,0,3,0,3,0.42857142857142855,1,0.0,0,0,0,0,0,0,0,3,0,0,3,1
519,8405,kWUbu8oK1dFJKpHhiF15MwcSzNzv8GaS,bWdj2GDclj5ofokWjzoa5jAwMkxCykd6,14,9,5,22,2,0,2,0,40,5.714285714285714,1,0.0,2,5,20,2,7,0,2,2,0,29,11,0
520,8416,mrUvSMVJRVrLlCOcTH6rs5HGHSxrWvwY,A3fsA9Zfv1X2fVEQhTw51lKENdNrEqT3,5,4,3,0,1,0,2,0,10,1.4285714285714286,1,0.0,0,3,0,1,4,0,0,2,0,4,6,1
521,8435,j1jdy8OF5VQw4rqSYOkbK2pQplvvvz37,A3fsA9Zfv1X2fVEQhTw51lKENdNrEqT3,29,23,1,72,1,0,9,0,106,15.142857142857142,3,0.0,1,1,61,1,22,0,11,9,0,64,42,0
522,8437,12tfSRcVHU1LY6VYbYjnNdGrVUGUAhWB,SpATywNh6bZuzm8s1ceuBUnMUAeoAHHw,3,2,1,0,0,0,1,0,4,0.5714285714285714,1,0.0,0,1,0,0,2,0,0,1,0,1,3,0
523,8446,oDnQYjxji4p3XVFJMOGI9NvIvASqoqC1,A3fsA9Zfv1X2fVEQhTw51lKENdNrEqT3,20,6,4,44,2,0,3,0,59,8.428571428571429,1,0.0,1,4,35,2,5,0,9,3,0,42,17,1
524,8456,Ve3uiMw5Q81FgfkGuxFl4mQAXBScEtc6,G8EPVSXsOYB5YQWZGiz1aVq5Pgr2GrQu,28,11,8,69,6,0,2,0,96,13.714285714285714,1,0.0,0,8,54,6,11,0,15,2,0,68,28,1
525,8461,tH916xRbn4bSZXJ6Z57PlnTAPQfz04PX,SpATywNh6bZuzm8s1ceuBUnMUAeoAHHw,3,2,1,0,0,0,2,0,5,0.7142857142857143,1,0.0,0,1,0,0,2,0,0,2,0,1,4,0
526,8486,BeZnyZhcScrHr8WAPYtxUxDjMPiK7yK1,SpATywNh6bZuzm8s1ceuBUnMUAeoAHHw,3,2,1,0,0,0,2,0,5,0.7142857142857143,1,0.0,0,1,0,0,2,0,0,2,0,1,4,0
527,8494,gir9E9ZUbwj6bCUNLD2kQmOx1nsVwG4J,SpATywNh6bZuzm8s1ceuBUnMUAeoAHHw,1,0,0,0,0,0,1,0,1,0.14285714285714285,1,0.0,0,0,0,0,0,0,0,1,0,0,1,1
528,8503,PtXR7nBc6ugMebaEp6mKjp0TYO5kZtvE,SpATywNh6bZuzm8s1ceuBUnMUAeoAHHw,6,5,3,0,0,0,3,0,11,1.5714285714285714,2,0.0,0,3,0,0,5,0,0,3,0,3,8,0
529,8534,sYJH30p3sjRgvjLciMuuEKpuHxukMGmh,bWdj2GDclj5ofokWjzoa5jAwMkxCykd6,4,4,2,0,0,0,3,0,9,1.2857142857142858,1,0.0,0,2,0,0,4,0,0,3,0,2,7,1
530,8539,ApFdQQBcLqTLoA4wIvtlnnwFs4FrlVS1,A3fsA9Zfv1X2fVEQhTw51lKENdNrEqT3,56,26,20,168,9,0,19,0,242,34.57142857142857,4,0.0,3,20,166,9,23,0,2,19,0,198,44,0
531,8562,2YohZ5UKGzy1qUgVAShosLdhgm3pfvsR,RXDvfPUBYFlVdlueBFbLW0mhhAyGEqpt,8,10,0,0,0,0,1,0,11,1.5714285714285714,1,0.0,0,0,0,0,10,0,0,1,0,0,11,1
532,8576,HHsJECDPslzJS0fyoCEbSGrnL1evzSJb,SpATywNh6bZuzm8s1ceuBUnMUAeoAHHw,1,0,0,0,0,0,1,0,1,0.14285714285714285,1,0.0,0,0,0,0,0,0,0,1,0,0,1,0
533,8580,NbSKhx4CxJyTkjcYgC3wEU9PLylFddj5,SpATywNh6bZuzm8s1ceuBUnMUAeoAHHw,7,17,0,4,0,0,13,0,34,4.857142857142857,3,0.0,4,0,3,0,13,0,1,13,0,7,27,0
534,8589,QiGOPB8shOtQ5nbvOvvOxzT1SShMMuAf,SpATywNh6bZuzm8s1ceuBUnMUAeoAHHw,3,3,2,0,0,1,3,0,9,1.2857142857142858,1,0.0,0,2,0,0,3,1,0,3,0,2,7,0
535,8590,tQHFI5lya7DKbCzO4oTkHd2600sh8kNe,G8EPVSXsOYB5YQWZGiz1aVq5Pgr2GrQu,3,2,0,0,0,0,2,0,4,0.5714285714285714,1,0.0,0,0,0,0,2,0,0,2,0,0,4,1
536,8603,NDWoO09mCIeS4HdBeNYH7dNkyhIv3eXv,SpATywNh6bZuzm8s1ceuBUnMUAeoAHHw,2,0,0,0,0,0,2,0,2,0.2857142857142857,1,0.0,0,0,0,0,0,0,0,2,0,0,2,1
537,8635,jH123vWnpYTVLfmuSyled9Oau0AYvcx6,G8EPVSXsOYB5YQWZGiz1aVq5Pgr2GrQu,3,2,1,0,0,0,1,0,4,0.5714285714285714,1,0.0,0,1,0,0,2,0,0,1,0,1,3,1
538,8638,kXndrjnvT5RUWACXG428KqXdIpBxsEit,A3fsA9Zfv1X2fVEQhTw51lKENdNrEqT3,5,4,0,0,0,0,1,0,5,0.7142857142857143,1,0.0,0,0,0,0,4,0,0,1,0,0,5,1
539,8654,nquBmikiqPFYvs17N894M5iUc88scoVO,SpATywNh6bZuzm8s1ceuBUnMUAeoAHHw,3,4,0,0,0,7,2,0,13,1.8571428571428572,1,0.0,0,0,0,0,4,7,0,2,0,0,13,0
540,8700,je9A6l6tP7wnbFhNJD7vbbHTYhqshuqB,G8EPVSXsOYB5YQWZGiz1aVq5Pgr2GrQu,25,45,10,44,3,1,6,1,110,15.714285714285714,1,0.0,26,10,31,3,19,1,13,6,1,70,40,0
541,8701,kxC3AAELak9RRmJoG2dzH7rfP0Xyo0FH,SpATywNh6bZuzm8s1ceuBUnMUAeoAHHw,1,0,0,0,0,0,1,0,1,0.14285714285714285,1,0.0,0,0,0,0,0,0,0,1,0,0,1,1
542,8735,WNT8mFhPmDPRuQT8JLsnindelSr1MnST,SpATywNh6bZuzm8s1ceuBUnMUAeoAHHw,5,2,1,0,0,1,7,0,11,1.5714285714285714,2,0.0,0,1,0,0,2,1,0,7,0,1,10,1
543,8761,7ye3FQXc4XBmC7UwnNQWxsWGDnaNcvG6,SpATywNh6bZuzm8s1ceuBUnMUAeoAHHw,4,6,0,0,0,0,5,0,11,1.5714285714285714,2,0.0,0,0,0,0,6,0,0,5,0,0,11,1
544,8793,Ga4lr67F0RIjyUetWH1EgQ3xzSHDnViF,bWdj2GDclj5ofokWjzoa5jAwMkxCykd6,1,0,0,0,0,0,1,0,1,0.14285714285714285,1,0.0,0,0,0,0,0,0,0,1,0,0,1,0
545,8794,br8lmEhz6IHlXV0QfsU4Spi9BczfMT8x,SpATywNh6bZuzm8s1ceuBUnMUAeoAHHw,3,3,2,0,0,0,2,0,7,1.0,1,0.0,0,2,0,0,3,0,0,2,0,2,5,0
546,8814,8IuzZOXaXVUql9pLZtNuJIyLoDJ8ZL4V,SpATywNh6bZuzm8s1ceuBUnMUAeoAHHw,3,4,2,0,0,0,2,0,8,1.1428571428571428,1,0.0,0,2,0,0,4,0,0,2,0,2,6,0
547,8852,1sf1a7OMEvwky5hvLFD12TaOsmoNw2Qb,SpATywNh6bZuzm8s1ceuBUnMUAeoAHHw,3,2,1,0,0,0,1,0,4,0.5714285714285714,1,0.0,0,1,0,0,2,0,0,1,0,1,3,0
548,8900,fY0uxi2rFKNgoTYTvIZdgXrk3XKUTjS3,SpATywNh6bZuzm8s1ceuBUnMUAeoAHHw,7,27,6,0,2,0,0,0,35,5.0,1,0.0,0,6,0,2,27,0,0,0,0,8,27,0
549,8917,5vUuq5ZeDCNce4LmvH0naoUjpb3qbNOp,SpATywNh6bZuzm8s1ceuBUnMUAeoAHHw,4,3,2,0,0,0,1,0,6,0.8571428571428571,1,0.0,0,2,0,0,3,0,0,1,0,2,4,1
550,8925,PenDUeO0eoR8hyLVdfPN6H7q2FnTGMus,A3fsA9Zfv1X2fVEQhTw51lKENdNrEqT3,7,6,3,0,1,0,3,0,13,1.8571428571428572,2,0.0,0,3,0,1,6,0,0,3,0,4,9,0
551,8935,pYasYOOyUapjKdoqnDhFpArs52eNDPLb,SpATywNh6bZuzm8s1ceuBUnMUAeoAHHw,1,0,0,0,0,0,2,0,2,0.2857142857142857,2,0.0,0,0,0,0,0,0,0,2,0,0,2,0
552,8956,JtMmp5BCDQnYE7CMI3NvnX4aRCZsQW9K,bWdj2GDclj5ofokWjzoa5jAwMkxCykd6,3,0,0,0,0,2,3,0,5,0.7142857142857143,2,0.0,0,0,0,0,0,2,0,3,0,0,5,0
553,8966,qFpdcx3mtZSSE0KVCMsIlMdOIeoOzyoo,SpATywNh6bZuzm8s1ceuBUnMUAeoAHHw,13,30,9,19,3,0,8,0,69,9.857142857142858,5,0.0,10,9,16,3,20,0,3,8,0,38,31,0
554,8971,p04QzukP32kpPk8EGoBhDUGJJQqJUoNz,SpATywNh6bZuzm8s1ceuBUnMUAeoAHHw,2,0,0,0,0,12,1,0,13,1.8571428571428572,1,0.0,0,0,0,0,0,12,0,1,0,0,13,0
555,9011,sNZ43ghPU2QwNk3cu7wYztVZWvmkGmKL,SpATywNh6bZuzm8s1ceuBUnMUAeoAHHw,3,4,2,0,0,1,0,0,7,1.0,1,0.0,1,2,0,0,3,1,0,0,0,3,4,0
556,9017,a5tgLYkHndhh8Yb10TacQs9Vi34mi45u,RXDvfPUBYFlVdlueBFbLW0mhhAyGEqpt,42,30,16,78,9,4,8,8,153,21.857142857142858,2,0.0,12,16,71,9,18,4,7,8,8,108,45,0
557,9048,8IYoAw78mc8ysNlcBgXt630ETnnEuaUM,SpATywNh6bZuzm8s1ceuBUnMUAeoAHHw,4,2,1,0,0,0,2,0,5,0.7142857142857143,1,0.0,1,1,0,0,1,0,0,2,0,2,3,0
558,9124,0mJoMFAp6vm88Kg6ltLw74tsdf8pNH48,SpATywNh6bZuzm8s1ceuBUnMUAeoAHHw,5,3,1,0,1,0,1,0,6,0.8571428571428571,1,0.0,0,1,0,1,3,0,0,1,0,2,4,0
559,9129,x8EozFE9amTkjsgRipu221C7Pejcw9dl,RXDvfPUBYFlVdlueBFbLW0mhhAyGEqpt,2,0,0,0,0,0,2,0,2,0.2857142857142857,1,0.0,0,0,0,0,0,0,0,2,0,0,2,1
560,9145,RFW46IpEEo40HQZmVwQOMd3VcTSwzvKz,SpATywNh6bZuzm8s1ceuBUnMUAeoAHHw,4,2,1,0,0,0,2,0,5,0.7142857142857143,1,0.0,0,1,0,0,2,0,0,2,0,1,4,0
561,9165,fnvAURpBgndjkYxbDVVMCKsNQuRUMiGS,SpATywNh6bZuzm8s1ceuBUnMUAeoAHHw,1,0,0,0,0,0,2,0,2,0.2857142857142857,2,0.0,0,0,0,0,0,0,0,2,0,0,2,0
562,9214,cw1zp7V2E9LtJgGgHmRoYt6oelCovAzM,bWdj2GDclj5ofokWjzoa5jAwMkxCykd6,5,3,2,0,1,0,2,0,8,1.1428571428571428,2,0.0,0,2,0,1,3,0,0,2,0,3,5,1
563,9221,DHqQemLc6gAFLZmIcghnnHYSJ9DiwwJJ,A3fsA9Zfv1X2fVEQhTw51lKENdNrEqT3,10,4,1,16,0,0,1,0,22,3.142857142857143,1,0.0,0,1,15,0,4,0,1,1,0,16,6,1
564,9263,cgHFcM0rIMOzMpGf6lXZssDwXCb8l7YM,SpATywNh6bZuzm8s1ceuBUnMUAeoAHHw,5,4,2,0,0,13,6,0,25,3.5714285714285716,2,0.0,0,2,0,0,4,13,0,6,0,2,23,0
565,9266,9Gijx5H37DPofktlpBMoMZTbguUDFGMv,SpATywNh6bZuzm8s1ceuBUnMUAeoAHHw,1,0,0,0,0,0,1,0,1,0.14285714285714285,1,0.0,0,0,0,0,0,0,0,1,0,0,1,0
566,9300,V2BC6P9m08ZwtWifNk1sABHW864l2OQe,SpATywNh6bZuzm8s1ceuBUnMUAeoAHHw,14,10,5,10,3,0,1,0,29,4.142857142857143,1,0.0,3,5,10,3,7,0,0,1,0,21,8,0
567,9326,cw1zp7V2E9LtJgGgHmRoYt6oelCovAzM,A3fsA9Zfv1X2fVEQhTw51lKENdNrEqT3,4,4,2,0,0,0,3,0,9,1.2857142857142858,2,0.0,0,2,0,0,4,0,0,3,0,2,7,0
568,9359,aR6DmUHNNFHdBeCRliKxXxLUoIhOd6AH,SpATywNh6bZuzm8s1ceuBUnMUAeoAHHw,1,0,0,0,0,0,2,0,2,0.2857142857142857,2,0.0,0,0,0,0,0,0,0,2,0,0,2,1
569,9361,8Eqf4bSicFmRziRU1kFgF89C5yGB8WDX,A3fsA9Zfv1X2fVEQhTw51lKENdNrEqT3,36,34,8,66,4,3,32,3,150,21.428571428571427,5,0.0,1,8,63,4,33,3,3,32,3,76,74,0
570,9368,gGSMkNgPdXpBQgdZzyjzifomyCxFSNyt,RXDvfPUBYFlVdlueBFbLW0mhhAyGEqpt,2,1,1,0,0,0,0,0,2,0.2857142857142857,1,0.0,0,1,0,0,1,0,0,0,0,1,1,1
571,9407,iY3PnTi5AY3h01aMZ0ccsJOuRXfKtImU,SpATywNh6bZuzm8s1ceuBUnMUAeoAHHw,1,0,0,0,0,0,1,0,1,0.14285714285714285,1,0.0,0,0,0,0,0,0,0,1,0,0,1,0
572,9412,ZoicU1K1NYxoyDJQjMEMlarFqaZkNBQL,SpATywNh6bZuzm8s1ceuBUnMUAeoAHHw,8,9,0,12,0,0,4,0,25,3.5714285714285716,2,0.0,2,0,12,0,7,0,0,4,0,14,11,0
573,9421,mVo6pZlclrtmbfR2GbQ4wq8gZuK7O36S,SpATywNh6bZuzm8s1ceuBUnMUAeoAHHw,2,4,2,0,0,3,0,0,9,1.2857142857142858,2,0.0,0,2,0,0,4,3,0,0,0,2,7,0
574,9443,mt466qDcj0vZCLdMYFtb42Vnaf84dHao,SpATywNh6bZuzm8s1ceuBUnMUAeoAHHw,4,8,3,0,0,0,9,0,20,2.857142857142857,3,0.0,0,3,0,0,8,0,0,9,0,3,17,1
575,9451,3tkFTpynSNaQLF6kINch4bQXEK1IrheG,SpATywNh6bZuzm8s1ceuBUnMUAeoAHHw,17,20,12,13,5,0,4,0,54,7.714285714285714,2,0.0,4,12,11,5,16,0,2,4,0,32,22,0
576,9461,L22HEShRU3FqNfdzTYdzEWxS4vfndGJu,SpATywNh6bZuzm8s1ceuBUnMUAeoAHHw,1,0,0,0,0,0,1,0,1,0.14285714285714285,1,0.0,0,0,0,0,0,0,0,1,0,0,1,0
577,9496,lzjn3SIRVbYq5ZVBPCRXRd4xV1z1jylE,SpATywNh6bZuzm8s1ceuBUnMUAeoAHHw,7,9,7,0,3,11,3,0,33,4.714285714285714,1,0.0,0,7,0,3,9,11,0,3,0,10,23,0
578,9498,tNcQJSYfIwP0RRLCMvpsyr5j06z8N8iO,G8EPVSXsOYB5YQWZGiz1aVq5Pgr2GrQu,28,44,16,37,7,53,14,6,177,25.285714285714285,3,0.0,10,16,32,7,34,53,5,14,6,65,112,0
579,9513,onGGlsMh4Ah4OxYC5tqGXHHp3fKlLcL2,RXDvfPUBYFlVdlueBFbLW0mhhAyGEqpt,3,2,1,0,0,0,2,0,5,0.7142857142857143,1,0.0,0,1,0,0,2,0,0,2,0,1,4,1
580,9531,KwyWbYzWCyNQryHYqWYU5PuARebCENlh,SpATywNh6bZuzm8s1ceuBUnMUAeoAHHw,1,0,0,0,0,0,1,0,1,0.14285714285714285,1,0.0,0,0,0,0,0,0,0,1,0,0,1,0
581,9583,InTDVHpDSVoZu5vOSvueBLdJOgZb9Qu8,bWdj2GDclj5ofokWjzoa5jAwMkxCykd6,8,10,5,2,1,4,2,0,24,3.4285714285714284,1,0.0,2,5,2,1,8,4,0,2,0,10,14,0
582,9589,oJ9j9ejTgKixczg3tSE8Sg8DPI7YQpJq,A3fsA9Zfv1X2fVEQhTw51lKENdNrEqT3,11,12,9,0,3,0,3,0,27,3.857142857142857,2,0.0,0,9,0,3,12,0,0,3,0,12,15,0
583,9597,op6fYsDSJ7UTrHBvFtSBIo32ykj3vZlc,SpATywNh6bZuzm8s1ceuBUnMUAeoAHHw,2,0,0,0,0,0,4,0,4,0.5714285714285714,2,0.0,0,0,0,0,0,0,0,4,0,0,4,0
584,9602,op6fYsDSJ7UTrHBvFtSBIo32ykj3vZlc,bWdj2GDclj5ofokWjzoa5jAwMkxCykd6,2,0,0,0,0,0,4,0,4,0.5714285714285714,2,0.0,0,0,0,0,0,0,0,4,0,0,4,1
585,9626,foCA7ZrrJkil1q7yKxvukoHCZEz5fz8N,bWdj2GDclj5ofokWjzoa5jAwMkxCykd6,18,36,1,66,2,0,6,0,111,15.857142857142858,2,0.0,5,1,64,2,31,0,2,6,0,72,39,0
586,9647,bPCZpicN2hhnN8uELNOuVf328EONwoA2,SpATywNh6bZuzm8s1ceuBUnMUAeoAHHw,6,2,1,0,0,1,5,1,10,1.4285714285714286,1,0.0,0,1,0,0,2,1,0,5,1,1,9,1
587,9662,tRu7kc3B7i0xOP4FswhcDsdZx5KznD0T,SpATywNh6bZuzm8s1ceuBUnMUAeoAHHw,12,19,2,9,1,0,2,0,33,4.714285714285714,2,0.0,7,2,9,1,12,0,0,2,0,19,14,0
588,9673,Bi4hHmeTLwTbUCScu9tC6ZZN7frLUhVP,bWdj2GDclj5ofokWjzoa5jAwMkxCykd6,19,16,10,12,7,8,8,1,62,8.857142857142858,1,0.0,5,10,12,7,11,8,0,8,1,34,28,0
589,9684,LdhLlSD36AR268yKf0v6JE8vG5XYPHSF,RXDvfPUBYFlVdlueBFbLW0mhhAyGEqpt,14,17,1,8,1,0,2,0,29,4.142857142857143,1,0.0,3,1,6,1,14,0,2,2,0,11,18,0
590,9718,0dBn4alo7QBTd62VD5XO0yNMbQ5QN2OQ,A3fsA9Zfv1X2fVEQhTw51lKENdNrEqT3,6,9,3,0,1,0,1,0,14,2.0,1,0.0,0,3,0,1,9,0,0,1,0,4,10,0
591,9719,STRzNG5Wp366HphlQVfWFRMC5QrerXCb,SpATywNh6bZuzm8s1ceuBUnMUAeoAHHw,4,6,3,0,0,0,2,0,11,1.5714285714285714,2,0.0,1,3,0,0,5,0,0,2,0,4,7,0
592,9754,UhHoLs8knx0jlEPi8SMFvlBmI0lPgR6y,SpATywNh6bZuzm8s1ceuBUnMUAeoAHHw,3,2,0,0,0,0,2,0,4,0.5714285714285714,1,0.0,0,0,0,0,2,0,0,2,0,0,4,1
593,9770,Z719Tc3zuVfTrBRe6VKkZp0coC11gNCc,SpATywNh6bZuzm8s1ceuBUnMUAeoAHHw,3,2,2,0,2,0,0,0,6,0.8571428571428571,1,0.0,0,2,0,2,2,0,0,0,0,4,2,1
594,9787,EYniy2nQGNpFME0mRi8PdZNA2QjnXIxY,RXDvfPUBYFlVdlueBFbLW0mhhAyGEqpt,12,23,0,8,1,2,2,0,36,5.142857142857143,1,0.0,3,0,7,1,20,2,1,2,0,11,25,0
595,9806,q0a8XSQyj8ok2HbWv28MubA9x20SFg4i,SpATywNh6bZuzm8s1ceuBUnMUAeoAHHw,4,2,0,0,0,0,2,0,4,0.5714285714285714,1,0.0,0,0,0,0,2,0,0,2,0,0,4,0
596,9835,a9OOTcAZgZGDa68djsRaJXsHoRuNVOvz,SpATywNh6bZuzm8s1ceuBUnMUAeoAHHw,8,8,6,0,0,3,5,0,22,3.142857142857143,2,0.0,0,6,0,0,8,3,0,5,0,6,16,1
597,9836,nknXXbQsC6Q6nMDyRKc0MDJZg6KtAXBE,SpATywNh6bZuzm8s1ceuBUnMUAeoAHHw,4,5,3,0,0,0,5,0,13,1.8571428571428572,4,0.0,0,3,0,0,5,0,0,5,0,3,10,0
598,9842,MVF65xcT9c1o85EvDPizEzpYwxjeii1v,SpATywNh6bZuzm8s1ceuBUnMUAeoAHHw,6,9,1,0,0,0,5,0,15,2.142857142857143,2,0.0,0,1,0,0,9,0,0,5,0,1,14,1
599,9857,qDhyxHmDfIFLWQlPUBxWy3YNuv335dWU,SpATywNh6bZuzm8s1ceuBUnMUAeoAHHw,3,2,1,0,0,0,2,0,5,0.7142857142857143,1,0.0,0,1,0,0,2,0,0,2,0,1,4,0
600,9874,mZIaM3Lmux7GERtSm258BKPOSUYFlwyy,SpATywNh6bZuzm8s1ceuBUnMUAeoAHHw,4,3,2,0,0,0,1,0,6,0.8571428571428571,1,0.0,0,2,0,0,3,0,0,1,0,2,4,0
601,9878,iw5QtMAk2wyMi9Kh4hTv1WAFOj2rnxVj,SpATywNh6bZuzm8s1ceuBUnMUAeoAHHw,8,8,2,0,2,0,0,0,12,1.7142857142857142,2,0.0,0,2,0,2,8,0,0,0,0,4,8,0
602,9896,47Lhswr4ZfAxhCMxQ5kAgIIaZKdQ7ZYE,SpATywNh6bZuzm8s1ceuBUnMUAeoAHHw,3,6,1,0,0,0,1,0,8,1.1428571428571428,1,0.0,0,1,0,0,6,0,0,1,0,1,7,0
603,9910,FUkw8gvbqykqbH4tdSuG6VwP03f4pQvB,SpATywNh6bZuzm8s1ceuBUnMUAeoAHHw,1,0,0,0,0,0,1,0,1,0.14285714285714285,1,0.0,0,0,0,0,0,0,0,1,0,0,1,0
604,9911,Jd5OP6GIsguRdsq9k3eSYNENmzhPbdGe,bWdj2GDclj5ofokWjzoa5jAwMkxCykd6,4,5,3,0,0,0,2,0,10,1.4285714285714286,2,0.0,0,3,0,0,5,0,0,2,0,3,7,1
605,9921,Mv7oSGs75OaCjYLhHCNmqqrqaAjjO5gs,RXDvfPUBYFlVdlueBFbLW0mhhAyGEqpt,10,22,1,10,0,0,7,0,40,5.714285714285714,2,0.0,2,1,9,0,20,0,1,7,0,12,28,1
606,9944,IUn6MADAjAYkGlJisA1WiDvCeNlJd5Xd,G8EPVSXsOYB5YQWZGiz1aVq5Pgr2GrQu,7,8,4,0,2,0,1,0,15,2.142857142857143,3,0.0,0,4,0,2,8,0,0,1,0,6,9,1
607,9965,XL8OObjZsaGHAKex6gNHyGuTbyi42iwz,SpATywNh6bZuzm8s1ceuBUnMUAeoAHHw,12,26,0,10,1,9,5,0,51,7.285714285714286,2,0.0,7,0,9,1,19,9,1,5,0,17,34,1
608,9973,pqAmXCZ0vs0c5YNrZSPIZNZIkmuJCMBN,RXDvfPUBYFlVdlueBFbLW0mhhAyGEqpt,5,3,2,8,0,5,2,0,20,2.857142857142857,2,0.0,0,2,7,0,3,5,1,2,0,9,11,0
609,9989,GVRJN4wkoooaXJUVmwnX983A87KsrZPK,A3fsA9Zfv1X2fVEQhTw51lKENdNrEqT3,1,0,0,0,0,0,1,0,1,0.14285714285714285,1,0.0,0,0,0,0,0,0,0,1,0,0,1,0
610,10001,vsk33lNJbFXN2L68Y5R9TSkfONwNMOQ8,SpATywNh6bZuzm8s1ceuBUnMUAeoAHHw,4,0,0,0,0,6,4,0,10,1.4285714285714286,2,0.0,0,0,0,0,0,6,0,4,0,0,10,0
611,10012,vqSgORDp5PsEpveQVJoPh4dnJvR6AQkK,RXDvfPUBYFlVdlueBFbLW0mhhAyGEqpt,8,8,6,4,0,13,3,0,34,4.857142857142857,2,0.0,0,6,4,0,8,13,0,3,0,10,24,0
612,10013,NYNmhRIaW3AmhvVQt7ReXvH6yAc7z73U,RXDvfPUBYFlVdlueBFbLW0mhhAyGEqpt,5,2,1,0,0,14,3,1,21,3.0,1,0.0,0,1,0,0,2,14,0,3,1,1,20,1
613,10042,RCWIrGGQZDVLNIofIMbc1GdSrqA961jg,RXDvfPUBYFlVdlueBFbLW0mhhAyGEqpt,1,0,0,0,0,0,1,0,1,0.14285714285714285,1,0.0,0,0,0,0,0,0,0,1,0,0,1,1
614,10065,GV5J9MUmZdHez5d6vsAQtSAbOI4jKQlj,bWdj2GDclj5ofokWjzoa5jAwMkxCykd6,26,28,17,94,6,39,11,0,195,27.857142857142858,1,0.0,2,17,80,6,26,39,14,11,0,105,90,0
615,10067,IkfMHDVbFGQIQxWjHsEqTwjNnrBCaA7O,SpATywNh6bZuzm8s1ceuBUnMUAeoAHHw,8,10,0,0,0,0,2,0,12,1.7142857142857142,2,0.0,1,0,0,0,9,0,0,2,0,1,11,0
616,10068,GV5J9MUmZdHez5d6vsAQtSAbOI4jKQlj,A3fsA9Zfv1X2fVEQhTw51lKENdNrEqT3,6,2,1,0,0,0,4,0,7,1.0,1,0.0,0,1,0,0,2,0,0,4,0,1,6,1
617,10070,FkxhG6zHFqigfK7M5JQhv4MT6lPE3kxN,RXDvfPUBYFlVdlueBFbLW0mhhAyGEqpt,20,24,14,36,8,0,2,0,84,12.0,2,0.0,8,14,31,8,16,0,5,2,0,61,23,0
618,10073,3VQVtsFphnOA3h1KWYRcAEMgfViLsPnF,A3fsA9Zfv1X2fVEQhTw51lKENdNrEqT3,7,8,0,0,0,0,1,0,9,1.2857142857142858,1,0.0,0,0,0,0,8,0,0,1,0,0,9,1
619,10081,2LiXT3Fppj80YAOl6K8p0HtAK0LHy6KG,SpATywNh6bZuzm8s1ceuBUnMUAeoAHHw,1,0,0,0,0,0,2,0,2,0.2857142857142857,2,0.0,0,0,0,0,0,0,0,2,0,0,2,0
620,10095,JQVJEgOcL8lOPq9QqGxWJ7NUVC20wQ1o,SpATywNh6bZuzm8s1ceuBUnMUAeoAHHw,23,37,17,44,5,3,7,1,114,16.285714285714285,2,0.0,15,17,37,5,22,3,7,7,1,74,40,0
621,10122,NiXPZUmEILmWUPwXexYxtHvaIL7QdjCQ,RXDvfPUBYFlVdlueBFbLW0mhhAyGEqpt,5,2,1,0,0,2,7,0,12,1.7142857142857142,3,0.0,0,1,0,0,2,2,0,7,0,1,11,0
622,10147,ng7eSUGwAsEpodxFM2MoBV45uXU9cRkh,SpATywNh6bZuzm8s1ceuBUnMUAeoAHHw,23,30,11,15,6,0,3,0,65,9.285714285714286,1,0.0,10,11,14,6,20,0,1,3,0,41,24,1
623,10193,T6JL6sNT8M40gVvb059fgHfBQIftQwIF,SpATywNh6bZuzm8s1ceuBUnMUAeoAHHw,6,7,4,0,0,0,4,0,15,2.142857142857143,2,0.0,1,4,0,0,6,0,0,4,0,5,10,1
624,10200,Sb9hMB1NLdfMmS0ToFmgrY6MZEZ6TYgo,SpATywNh6bZuzm8s1ceuBUnMUAeoAHHw,3,2,1,0,0,0,2,0,5,0.7142857142857143,1,0.0,0,1,0,0,2,0,0,2,0,1,4,0
625,10204,nJbKKV1iJX5hAlKTzoiNMNIkB5aNJcfW,G8EPVSXsOYB5YQWZGiz1aVq5Pgr2GrQu,8,8,1,0,0,0,1,0,10,1.4285714285714286,1,0.0,0,1,0,0,8,0,0,1,0,1,9,0
626,10207,Qf6P6bxCyzplkdXIQa3YsHmpzfUnMGYL,SpATywNh6bZuzm8s1ceuBUnMUAeoAHHw,14,19,9,0,5,1,7,1,42,6.0,2,0.0,0,9,0,5,19,1,0,7,1,14,28,0
627,10227,SnivjdMp3HL6G23yPscSnzZlAD2Rbyt6,A3fsA9Zfv1X2fVEQhTw51lKENdNrEqT3,36,20,15,66,9,0,4,0,114,16.285714285714285,2,0.0,1,15,57,9,19,0,9,4,0,82,32,0
628,10232,zXzBBpTV9epJ0NK0fVVhqGAiB4MQXdB4,SpATywNh6bZuzm8s1ceuBUnMUAeoAHHw,5,3,2,0,0,0,2,0,7,1.0,1,0.0,0,2,0,0,3,0,0,2,0,2,5,0
629,10244,5gwirWhcaVB1Z2yy4RRslODx7MsCrRca,SpATywNh6bZuzm8s1ceuBUnMUAeoAHHw,4,5,3,0,0,0,2,0,10,1.4285714285714286,1,0.0,0,3,0,0,5,0,0,2,0,3,7,0
630,10271,1kFTVSLESXiimtERcEyClh5CUMgpZbSa,SpATywNh6bZuzm8s1ceuBUnMUAeoAHHw,19,24,12,12,6,8,8,2,72,10.285714285714286,1,0.0,5,12,12,6,19,8,0,8,2,35,37,0
631,10276,6pYrzEgLAB7Gx24u5Kn0l64uyJLXY41J,SpATywNh6bZuzm8s1ceuBUnMUAeoAHHw,2,0,0,0,0,0,2,0,2,0.2857142857142857,1,0.0,0,0,0,0,0,0,0,2,0,0,2,0
632,10280,dtlGqEkxytgl4rvxvygVAnxqgcqdYicp,SpATywNh6bZuzm8s1ceuBUnMUAeoAHHw,2,1,1,0,0,0,0,0,2,0.2857142857142857,1,0.0,0,1,0,0,1,0,0,0,0,1,1,0
633,10307,ZBhV1m5APkbtG3EQZyk5pMZqkJsFLe6t,SpATywNh6bZuzm8s1ceuBUnMUAeoAHHw,7,3,3,0,3,0,2,0,11,1.5714285714285714,1,0.0,0,3,0,3,3,0,0,2,0,6,5,1
634,10328,GSkYUOcl4XzYMWSWhE6gXRGQ9kqPeXsi,SpATywNh6bZuzm8s1ceuBUnMUAeoAHHw,3,5,2,0,0,0,5,0,12,1.7142857142857142,2,0.0,0,2,0,0,5,0,0,5,0,2,10,0
635,10358,Nzrw7pk0OZ13UV7zfdLy7gEMwvTA7qqG,SpATywNh6bZuzm8s1ceuBUnMUAeoAHHw,4,6,5,0,0,10,6,0,27,3.857142857142857,3,0.0,0,5,0,0,6,10,0,6,0,5,22,0
636,10380,ziZWaDkSdnYYFQL9rVa6Bhv9eL7a9wWX,SpATywNh6bZuzm8s1ceuBUnMUAeoAHHw,16,21,1,16,1,2,17,0,58,8.285714285714286,3,0.0,8,1,14,1,13,2,2,17,0,24,34,0
637,10388,SaHrUfZXnTghdXjrd2g1gBsj8aUTXhNX,SpATywNh6bZuzm8s1ceuBUnMUAeoAHHw,7,4,0,2,0,0,3,0,9,1.2857142857142858,2,0.0,0,0,2,0,4,0,0,3,0,2,7,0
638,10403,VgIpHnZLrMLRtvQcwLJvvhrvLtLKds8Y,SpATywNh6bZuzm8s1ceuBUnMUAeoAHHw,14,28,2,2,2,0,6,0,40,5.714285714285714,1,0.0,0,2,2,2,28,0,0,6,0,6,34,1
639,10407,xLsstPG4sh6BOKWjwGwQnQICDDoIsKTd,SpATywNh6bZuzm8s1ceuBUnMUAeoAHHw,4,3,1,0,0,0,3,0,7,1.0,3,0.0,0,1,0,0,3,0,0,3,0,1,6,0
640,10422,Eu9HoDt3WhECHgcXaERosbI6lMj7Hipb,RXDvfPUBYFlVdlueBFbLW0mhhAyGEqpt,4,4,2,0,0,0,1,0,7,1.0,1,0.0,0,2,0,0,4,0,0,1,0,2,5,0
641,10427,Daw06K1PSOXldo19kBgHP5sewulb7Vu5,SpATywNh6bZuzm8s1ceuBUnMUAeoAHHw,1,0,0,0,0,0,2,0,2,0.2857142857142857,1,0.0,0,0,0,0,0,0,0,2,0,0,2,1
642,10441,KRLjLXKoKEagD4g49Zuzvz0geq7JPqfn,bWdj2GDclj5ofokWjzoa5jAwMkxCykd6,14,37,17,40,10,0,9,1,114,16.285714285714285,4,0.0,6,17,36,10,31,0,4,9,1,69,45,0
643,10481,4baDuWDcygh3I7gf3DfgmuPMN0Tyoi19,SpATywNh6bZuzm8s1ceuBUnMUAeoAHHw,1,0,0,0,0,0,1,0,1,0.14285714285714285,1,0.0,0,0,0,0,0,0,0,1,0,0,1,0
644,10489,VC1Fuf9dV49znO9PkMawj1ZQqMcKHAjm,SpATywNh6bZuzm8s1ceuBUnMUAeoAHHw,3,4,3,0,3,1,0,0,11,1.5714285714285714,4,0.0,0,3,0,3,4,1,0,0,0,6,5,0
645,10502,vx1j5ZdbVcqMnaq8fewmENptts2XnB9X,SpATywNh6bZuzm8s1ceuBUnMUAeoAHHw,9,20,0,12,0,0,1,0,33,4.714285714285714,1,0.0,15,0,10,0,5,0,2,1,0,25,8,0
646,10509,gtq5s5jDEXDrRLbMZLZJIjHVD4oTJM3K,SpATywNh6bZuzm8s1ceuBUnMUAeoAHHw,12,13,0,16,0,8,7,1,45,6.428571428571429,1,0.0,4,0,15,0,9,8,1,7,1,19,26,1
647,10518,rzGwtyhvOohTorRAFSpekt9j8KJVn1Nq,SpATywNh6bZuzm8s1ceuBUnMUAeoAHHw,11,6,5,0,4,0,2,0,17,2.4285714285714284,1,0.0,0,5,0,4,6,0,0,2,0,9,8,0
648,10527,VYMfm0tgVS6x4Eosz9NPpRPYpCrgFsMy,A3fsA9Zfv1X2fVEQhTw51lKENdNrEqT3,32,31,1,140,0,0,9,0,181,25.857142857142858,2,0.0,3,1,124,0,28,0,16,9,0,128,53,0
649,10535,TyLciGh9B6yO4eY9EZiNs3MwXyb1sWVv,SpATywNh6bZuzm8s1ceuBUnMUAeoAHHw,8,9,0,13,0,0,5,0,27,3.857142857142857,1,0.0,4,0,13,0,5,0,0,5,0,17,10,1
650,10540,Cwlc0kvvLoKXxEuXNQkjFRo818TDMpZS,SpATywNh6bZuzm8s1ceuBUnMUAeoAHHw,4,15,6,0,0,0,5,0,26,3.7142857142857144,4,0.0,5,6,0,0,10,0,0,5,0,11,15,0
651,10542,r2u5KF0HWbXOmPd8SinNo3Ik67swOdP7,SpATywNh6bZuzm8s1ceuBUnMUAeoAHHw,1,0,0,0,0,0,1,0,1,0.14285714285714285,1,0.0,0,0,0,0,0,0,0,1,0,0,1,0
652,10555,QqE2Xjwy9gUzOvFdkDqAwAaNZLBZkxvd,bWdj2GDclj5ofokWjzoa5jAwMkxCykd6,9,6,0,0,0,0,16,0,22,3.142857142857143,4,0.0,0,0,0,0,6,0,0,16,0,0,22,0
653,10558,Cvs414mYH2FKto3axCpDhfQljawQ5dk9,SpATywNh6bZuzm8s1ceuBUnMUAeoAHHw,4,4,2,0,0,0,2,0,8,1.1428571428571428,1,0.0,0,2,0,0,4,0,0,2,0,2,6,0
654,10591,wbbNGhodAmSlYSg7ZSWYtWMdb0rjLgRw,G8EPVSXsOYB5YQWZGiz1aVq5Pgr2GrQu,29,19,10,60,2,11,6,0,108,15.428571428571429,2,0.0,0,10,54,2,19,11,6,6,0,66,42,0
655,10604,UKrQdzHwNJRJK7ZoTzKsoWlrkEbsQk7X,G8EPVSXsOYB5YQWZGiz1aVq5Pgr2GrQu,43,54,25,82,6,4,14,1,186,26.571428571428573,5,0.0,2,25,76,6,52,4,6,14,1,109,77,1
656,10606,BOBLP6pTmRtpQ8LtVgJyutFMDL3q6xno,SpATywNh6bZuzm8s1ceuBUnMUAeoAHHw,4,3,2,0,0,0,1,0,6,0.8571428571428571,1,0.0,0,2,0,0,3,0,0,1,0,2,4,0
657,10608,a3StgABPgimfVHzW1FR4usG9kIA0tZV5,SpATywNh6bZuzm8s1ceuBUnMUAeoAHHw,1,0,0,0,0,0,1,0,1,0.14285714285714285,1,0.0,0,0,0,0,0,0,0,1,0,0,1,0
658,10609,VYMfm0tgVS6x4Eosz9NPpRPYpCrgFsMy,bWdj2GDclj5ofokWjzoa5jAwMkxCykd6,12,24,2,0,3,0,5,0,34,4.857142857142857,3,0.0,8,2,0,3,16,0,0,5,0,13,21,1
659,10619,CGB0PTeWY2VA2Nk2INJOsdD7IvpzgObV,G8EPVSXsOYB5YQWZGiz1aVq5Pgr2GrQu,33,47,25,35,15,24,9,0,155,22.142857142857142,2,0.0,15,25,30,15,32,24,5,9,0,85,70,1
660,10623,dzaUNwKZy91BtYj96fOhuSgIlp9lXQDU,SpATywNh6bZuzm8s1ceuBUnMUAeoAHHw,3,2,0,0,0,0,1,0,3,0.42857142857142855,1,0.0,0,0,0,0,2,0,0,1,0,0,3,0
661,10634,OUOJlObKrXM0JmEUq0o8KzZHzr8jy9dn,bWdj2GDclj5ofokWjzoa5jAwMkxCykd6,3,0,0,0,0,1,4,0,5,0.7142857142857143,2,0.0,0,0,0,0,0,1,0,4,0,0,5,0
662,10637,uzPUKUi7vVAcTKZXvlLeqjC4erxz8WBI,bWdj2GDclj5ofokWjzoa5jAwMkxCykd6,19,11,10,34,9,0,2,0,66,9.428571428571429,4,0.0,0,10,31,9,11,0,3,2,0,50,16,0
663,10655,39GYbZ8lJRbKZppnA1dQGPRJvzLTR46Q,SpATywNh6bZuzm8s1ceuBUnMUAeoAHHw,2,1,1,0,0,0,0,0,2,0.2857142857142857,1,0.0,0,1,0,0,1,0,0,0,0,1,1,0
664,10667,gvBW2L5p7TFF6lkwpHMNMz6nt7oEVYk1,SpATywNh6bZuzm8s1ceuBUnMUAeoAHHw,16,17,8,9,5,0,3,0,42,6.0,1,0.0,6,8,9,5,11,0,0,3,0,28,14,0
665,10676,Bv9FSXvHlE6wLC4E4yrAKqe3BQhrrtfx,SpATywNh6bZuzm8s1ceuBUnMUAeoAHHw,1,0,0,0,0,0,2,0,2,0.2857142857142857,2,0.0,0,0,0,0,0,0,0,2,0,0,2,0
666,10692,rTYF0meww41Jaf1ZhSKn71dF6UobIHyn,SpATywNh6bZuzm8s1ceuBUnMUAeoAHHw,3,2,1,0,0,0,1,0,4,0.5714285714285714,1,0.0,0,1,0,0,2,0,0,1,0,1,3,0
667,10693,ZAehH9zLr3mvrD0qfr21tfeJdYtTkUHf,SpATywNh6bZuzm8s1ceuBUnMUAeoAHHw,5,4,1,8,0,0,1,0,14,2.0,1,0.0,1,1,7,0,3,0,1,1,0,9,5,1
668,10700,jX1wtG8uym7vm2Ny85W79HCXnEeqhUm4,bWdj2GDclj5ofokWjzoa5jAwMkxCykd6,23,79,39,74,4,19,29,0,244,34.857142857142854,4,0.0,6,39,65,4,73,19,9,29,0,114,130,0
669,10730,mJZNVvZltlGUOWmItS7lca1ZZKMYLgfv,A3fsA9Zfv1X2fVEQhTw51lKENdNrEqT3,49,21,1,170,1,0,6,0,199,28.428571428571427,2,0.0,3,1,168,1,18,0,2,6,0,173,26,1
670,10743,98UEGByxiN7tned6NDQeKfQDq4HCSGvQ,SpATywNh6bZuzm8s1ceuBUnMUAeoAHHw,1,0,0,0,0,0,1,0,1,0.14285714285714285,1,0.0,0,0,0,0,0,0,0,1,0,0,1,0
671,10758,JjZeMsAmsZa7SQS0vTrtExRB1lmjwAQ2,SpATywNh6bZuzm8s1ceuBUnMUAeoAHHw,1,0,0,0,0,0,1,0,1,0.14285714285714285,1,0.0,0,0,0,0,0,0,0,1,0,0,1,0
672,10761,Grmueh4kYgLYo2kInw23ZHrSQJbjli7D,SpATywNh6bZuzm8s1ceuBUnMUAeoAHHw,18,9,6,17,4,3,7,1,47,6.714285714285714,2,0.0,2,6,16,4,7,3,1,7,1,28,19,0
673,10763,tby14fMJpDIjTBkK50rauZ0P5DHnQphs,SpATywNh6bZuzm8s1ceuBUnMUAeoAHHw,16,29,11,14,5,0,4,0,63,9.0,3,0.0,2,11,11,5,27,0,3,4,0,29,34,1
674,10774,QmKLhFuFtodx97KXUUkaok1RXKwJOs6p,SpATywNh6bZuzm8s1ceuBUnMUAeoAHHw,19,17,10,20,6,0,4,0,57,8.142857142857142,1,0.0,6,10,16,6,11,0,4,4,0,38,19,0
675,10784,4fg1E2X2Iqab02UjKHSaN93jLrNDtbK1,SpATywNh6bZuzm8s1ceuBUnMUAeoAHHw,2,0,1,0,1,0,0,0,2,0.2857142857142857,1,0.0,0,1,0,1,0,0,0,0,0,2,0,1
676,10805,mJAgtJKHxy28GsPIeuAEUCIOXmHzCywF,SpATywNh6bZuzm8s1ceuBUnMUAeoAHHw,5,2,1,0,0,0,3,0,6,0.8571428571428571,1,0.0,0,1,0,0,2,0,0,3,0,1,5,0
677,10863,SE8wOQdHqwRS7ESACXcTxQAuYFlgu1Py,SpATywNh6bZuzm8s1ceuBUnMUAeoAHHw,15,16,9,11,0,0,4,2,42,6.0,1,0.0,6,9,8,0,10,0,3,4,2,23,19,1
678,10867,n6zGNJI1hLWYjlMIVXYesa3jTXjLwizj,SpATywNh6bZuzm8s1ceuBUnMUAeoAHHw,3,8,4,0,0,0,4,0,16,2.2857142857142856,4,0.0,0,4,0,0,8,0,0,4,0,4,12,0
679,10868,d9cbpiPwBULo3iFfJzjTidseoxKi3AEA,SpATywNh6bZuzm8s1ceuBUnMUAeoAHHw,3,2,1,0,0,0,2,0,5,0.7142857142857143,1,0.0,0,1,0,0,2,0,0,2,0,1,4,0
680,10881,31ZWCwEsmLt26QDeYIg9aUSXrbkhFpxl,SpATywNh6bZuzm8s1ceuBUnMUAeoAHHw,16,12,8,14,3,0,4,0,41,5.857142857142857,2,0.0,2,8,12,3,10,0,2,4,0,25,16,0
681,10903,896KUUFdpc0Ig8weMXOkWbw7cjXtmIVV,SpATywNh6bZuzm8s1ceuBUnMUAeoAHHw,8,8,3,0,2,0,3,0,16,2.2857142857142856,1,0.0,0,3,0,2,8,0,0,3,0,5,11,0
682,10961,1N6nOsYXnkatuA8YMolfRAv0tQpjn2uG,SpATywNh6bZuzm8s1ceuBUnMUAeoAHHw,16,14,9,10,4,0,3,0,40,5.714285714285714,3,0.0,2,9,9,4,12,0,1,3,0,24,16,0
683,10970,IdRsdksEKIk9aXKOiGRUkjb7QPozokDa,SpATywNh6bZuzm8s1ceuBUnMUAeoAHHw,9,11,6,0,1,0,5,1,24,3.4285714285714284,2,0.0,0,6,0,1,11,0,0,5,1,7,17,0
684,10981,gFIubR5L7uAqsUwFMmCtpUtAJn2LXJti,SpATywNh6bZuzm8s1ceuBUnMUAeoAHHw,3,2,1,0,0,0,1,0,4,0.5714285714285714,1,0.0,0,1,0,0,2,0,0,1,0,1,3,1
685,10992,EaV63ns250Za7MNTuadlc0JeYoVcm5bM,SpATywNh6bZuzm8s1ceuBUnMUAeoAHHw,3,4,2,0,0,0,3,0,9,1.2857142857142858,2,0.0,0,2,0,0,4,0,0,3,0,2,7,0
686,11000,zyIWmJjaz36PnMZpAzR2HEZCUbJWe8iQ,bWdj2GDclj5ofokWjzoa5jAwMkxCykd6,16,9,5,12,3,0,1,0,30,4.285714285714286,1,0.0,3,5,12,3,6,0,0,1,0,23,7,1
687,11018,bjG4XBkL5oSJA9TxyrmgPKXKYOTfiWVp,bWdj2GDclj5ofokWjzoa5jAwMkxCykd6,15,10,6,35,4,0,0,0,55,7.857142857142857,1,0.0,2,6,31,4,8,0,4,0,0,43,12,0
688,11095,ALXyvdc776DMhlVyaaoPo6cQhevpwTYD,SpATywNh6bZuzm8s1ceuBUnMUAeoAHHw,2,0,0,0,0,0,2,0,2,0.2857142857142857,1,0.0,0,0,0,0,0,0,0,2,0,0,2,0
689,11096,vogj6DdqvLTkNOGuPksobO32JsQUkuqr,SpATywNh6bZuzm8s1ceuBUnMUAeoAHHw,3,6,1,0,0,2,1,0,10,1.4285714285714286,2,0.0,0,1,0,0,6,2,0,1,0,1,9,0
690,11098,R5MIWOdfQPF58rt5zIICrbN58FLsYSLK,SpATywNh6bZuzm8s1ceuBUnMUAeoAHHw,3,2,1,0,0,0,1,0,4,0.5714285714285714,1,0.0,0,1,0,0,2,0,0,1,0,1,3,0
691,11110,fNM6a78gna3DBlYrxiSuwL1HfiXFBx1X,SpATywNh6bZuzm8s1ceuBUnMUAeoAHHw,27,25,13,21,7,1,10,2,79,11.285714285714286,2,0.0,9,13,17,7,16,1,4,10,2,46,33,1
692,11117,yBKClM5or0v37bBK9shMFXqtoOJsEOKi,SpATywNh6bZuzm8s1ceuBUnMUAeoAHHw,4,3,1,0,0,0,1,0,5,0.7142857142857143,1,0.0,0,1,0,0,3,0,0,1,0,1,4,0
693,11118,8G3TIfWeYnotKEBloHzMAvSj0jab6YCE,SpATywNh6bZuzm8s1ceuBUnMUAeoAHHw,18,42,1,14,1,0,8,0,66,9.428571428571429,3,0.0,3,1,13,1,39,0,1,8,0,18,48,0
694,11140,kQ63n93d5CTXewyEhcoySFeLgYStuYpO,SpATywNh6bZuzm8s1ceuBUnMUAeoAHHw,3,2,1,0,0,0,2,0,5,0.7142857142857143,2,0.0,0,1,0,0,2,0,0,2,0,1,4,0
695,11145,UnV0HDk59T6cuzi8hS829ZOjCdT0CRoB,SpATywNh6bZuzm8s1ceuBUnMUAeoAHHw,18,28,15,12,7,14,10,11,97,13.857142857142858,2,0.0,6,15,11,7,22,14,1,10,11,39,58,0
696,11153,h8eBexpHr95TQpIPdJzX4ggtrj3rthKs,SpATywNh6bZuzm8s1ceuBUnMUAeoAHHw,2,0,0,0,0,1,1,0,2,0.2857142857142857,1,0.0,0,0,0,0,0,1,0,1,0,0,2,0
697,11196,0K6JPqiivQzicxY4EV4nqMLCL3a08A97,A3fsA9Zfv1X2fVEQhTw51lKENdNrEqT3,5,1,1,0,1,0,2,0,5,0.7142857142857143,1,0.0,0,1,0,1,1,0,0,2,0,2,3,1
698,11218,ESIDCh7JUpjIHOXvPcQBcrSs3Att83qK,SpATywNh6bZuzm8s1ceuBUnMUAeoAHHw,7,20,1,9,0,1,13,0,44,6.285714285714286,4,0.0,2,1,9,0,18,1,0,13,0,12,32,0
699,11231,FpAFHYP26eZqx6Z5sDhKdTJPTBgbDKt4,SpATywNh6bZuzm8s1ceuBUnMUAeoAHHw,4,2,1,0,0,0,3,0,6,0.8571428571428571,1,0.0,0,1,0,0,2,0,0,3,0,1,5,0
700,11232,wmD7RtZPHqOfpVEXsJ4kv2jVIQOymIt7,G8EPVSXsOYB5YQWZGiz1aVq5Pgr2GrQu,5,6,0,0,0,0,1,0,7,1.0,1,0.0,2,0,0,0,4,0,0,1,0,2,5,1
701,11277,fOGAjxxxpsDuk08vAdjWtxgrvUhA2ic8,SpATywNh6bZuzm8s1ceuBUnMUAeoAHHw,12,14,0,12,0,0,1,0,27,3.857142857142857,1,0.0,3,0,10,0,11,0,2,1,0,13,14,1
702,11325,urVw10ZOKTw1O1zHFnsutUzT6EcZdTal,SpATywNh6bZuzm8s1ceuBUnMUAeoAHHw,1,0,0,0,0,0,2,0,2,0.2857142857142857,2,0.0,0,0,0,0,0,0,0,2,0,0,2,0
703,11351,1YxknoiTrSwQgclDlSAh4oMYHRyARhLv,A3fsA9Zfv1X2fVEQhTw51lKENdNrEqT3,7,4,1,6,0,0,1,0,12,1.7142857142857142,1,0.0,1,1,6,0,3,0,0,1,0,8,4,1
704,11366,GsMuFjXWxUh2UrLHKPEnIwFvWlVxAcB7,SpATywNh6bZuzm8s1ceuBUnMUAeoAHHw,3,2,1,0,0,0,1,0,4,0.5714285714285714,1,0.0,0,1,0,0,2,0,0,1,0,1,3,0
705,11367,zEiNHlokNuJTLVoV4Hy4kJd9kzaIjztD,SpATywNh6bZuzm8s1ceuBUnMUAeoAHHw,1,0,0,0,0,0,1,0,1,0.14285714285714285,1,0.0,0,0,0,0,0,0,0,1,0,0,1,0
706,11369,7KNecsubFdywoFPLyTu2kgv5VbQekjao,SpATywNh6bZuzm8s1ceuBUnMUAeoAHHw,4,5,1,0,0,0,1,0,7,1.0,1,0.0,2,1,0,0,3,0,0,1,0,3,4,1
707,11387,8xe55v4hJPUrl0YZIl8G73vP4j2l4PsW,SpATywNh6bZuzm8s1ceuBUnMUAeoAHHw,3,2,1,0,0,0,1,0,4,0.5714285714285714,1,0.0,0,1,0,0,2,0,0,1,0,1,3,0
708,11393,D1fgtFfIsG1EcZQzDGeiCx6sI7k5ShWV,G8EPVSXsOYB5YQWZGiz1aVq5Pgr2GrQu,11,15,1,10,3,0,4,0,33,4.714285714285714,2,0.0,9,1,7,3,6,0,3,4,0,20,13,1
709,11418,Km3IX0L3OZADSpnXU3tgLmBjn4mYhfRJ,SpATywNh6bZuzm8s1ceuBUnMUAeoAHHw,4,2,0,0,0,8,5,0,15,2.142857142857143,1,0.0,0,0,0,0,2,8,0,5,0,0,15,0
710,11448,tLAxgBhXx0zpE8fWNnwggaJx5LeHI2h1,RXDvfPUBYFlVdlueBFbLW0mhhAyGEqpt,3,2,1,0,0,0,1,0,4,0.5714285714285714,1,0.0,0,1,0,0,2,0,0,1,0,1,3,1
711,11450,HnptwVrdWLkMWuHezQcYS6A0pyVov5BG,SpATywNh6bZuzm8s1ceuBUnMUAeoAHHw,5,5,3,0,0,0,2,0,10,1.4285714285714286,1,0.0,0,3,0,0,5,0,0,2,0,3,7,0
712,11456,CWDKRVVm01sfgssULmzIPwx9dbULLbqB,A3fsA9Zfv1X2fVEQhTw51lKENdNrEqT3,33,31,25,84,13,0,5,0,158,22.571428571428573,2,0.0,1,25,72,13,30,0,12,5,0,111,47,0
713,11461,cW0TF0QgesgeR4yvyFNeSG2Tsy7pGtpm,A3fsA9Zfv1X2fVEQhTw51lKENdNrEqT3,1,0,0,0,0,0,1,0,1,0.14285714285714285,1,0.0,0,0,0,0,0,0,0,1,0,0,1,1
714,11483,fG7nauhHd6Hp0Y6uPPSQifF45RcZ5wiO,SpATywNh6bZuzm8s1ceuBUnMUAeoAHHw,5,6,1,0,0,0,1,0,8,1.1428571428571428,1,0.0,2,1,0,0,4,0,0,1,0,3,5,1
715,11494,nBVpguvJeCUz3AWDoX9CCNT2qyeZb33T,G8EPVSXsOYB5YQWZGiz1aVq5Pgr2GrQu,3,2,1,0,0,0,1,0,4,0.5714285714285714,1,0.0,0,1,0,0,2,0,0,1,0,1,3,0
716,11516,aSlIMkfly6xTMJCGTWDQcnFZjajcWM6y,RXDvfPUBYFlVdlueBFbLW0mhhAyGEqpt,3,1,1,0,1,0,0,0,3,0.42857142857142855,1,0.0,0,1,0,1,1,0,0,0,0,2,1,0
717,11541,vIBcYbs1BLdmaaP30fcE2FS7kB7v7QRn,A3fsA9Zfv1X2fVEQhTw51lKENdNrEqT3,3,2,1,0,0,0,1,0,4,0.5714285714285714,1,0.0,0,1,0,0,2,0,0,1,0,1,3,1
718,11546,9PS6Icub6VXkyVUcoskrzajETE7Qoarh,SpATywNh6bZuzm8s1ceuBUnMUAeoAHHw,16,17,10,12,4,0,2,0,45,6.428571428571429,1,0.0,6,10,10,4,11,0,2,2,0,30,15,0
719,11564,ZPbUovw1YoDeaWUVrbGEj5A5WdIXTYjf,SpATywNh6bZuzm8s1ceuBUnMUAeoAHHw,5,16,4,0,2,0,1,0,23,3.2857142857142856,1,0.0,11,4,0,2,5,0,0,1,0,17,6,1
720,11568,l1IK9ZY8MbRv8UoeCkxEH7P4W2dtATGX,SpATywNh6bZuzm8s1ceuBUnMUAeoAHHw,6,6,3,0,2,0,4,0,15,2.142857142857143,3,0.0,0,3,0,2,6,0,0,4,0,5,10,0
721,11574,ypwDBeQLkxtWilMLhemtoXkZG88PSCik,SpATywNh6bZuzm8s1ceuBUnMUAeoAHHw,4,36,18,0,0,0,1,0,55,7.857142857142857,7,0.0,0,18,0,0,36,0,0,1,0,18,37,0
722,11581,PXjkYsNMSYVKdz07qjMtS6mMBWIuSmKF,bWdj2GDclj5ofokWjzoa5jAwMkxCykd6,7,14,3,0,0,0,7,1,25,3.5714285714285716,3,0.0,2,3,0,0,12,0,0,7,1,5,20,1
723,11586,GIK69AVoFAXQo5stVHHEqOqo5xlrkSOx,SpATywNh6bZuzm8s1ceuBUnMUAeoAHHw,8,8,2,0,0,18,14,2,44,6.285714285714286,5,0.0,2,2,0,0,6,18,0,14,2,4,40,0
724,11591,nlq4r6xc3rTUqTwcYhL6wudXdN6RIE52,A3fsA9Zfv1X2fVEQhTw51lKENdNrEqT3,16,14,11,0,7,0,4,0,36,5.142857142857143,2,0.0,0,11,0,7,14,0,0,4,0,18,18,0
725,11593,wmwDf7eIRrKPL0l8cNmMygnEPd5vzoqs,SpATywNh6bZuzm8s1ceuBUnMUAeoAHHw,3,2,1,0,0,0,1,0,4,0.5714285714285714,1,0.0,0,1,0,0,2,0,0,1,0,1,3,0
726,11599,GD5KzWMBHDnHVJHzVFtf3u7bIC7XYtJH,SpATywNh6bZuzm8s1ceuBUnMUAeoAHHw,3,8,0,0,0,0,5,0,13,1.8571428571428572,4,0.0,0,0,0,0,8,0,0,5,0,0,13,0
727,11609,lk3lGbNCFxoPG1OVILbfGp3s2wN91K2M,SpATywNh6bZuzm8s1ceuBUnMUAeoAHHw,4,6,1,0,0,0,0,0,7,1.0,1,0.0,0,1,0,0,6,0,0,0,0,1,6,1
728,11624,Kw83ufYGIFIihz0PdiaJro4hz0pKGozQ,SpATywNh6bZuzm8s1ceuBUnMUAeoAHHw,7,9,1,0,1,0,2,0,13,1.8571428571428572,2,0.0,0,1,0,1,9,0,0,2,0,2,11,1
729,11628,BHczT02DEALJmy7zbrGU6QbzLcOGM0Lz,SpATywNh6bZuzm8s1ceuBUnMUAeoAHHw,4,8,0,0,0,0,5,0,13,1.8571428571428572,2,0.0,0,0,0,0,8,0,0,5,0,0,13,0
730,11637,glYOnGBygagQ3d4VwvOcHKnCEWLKXuzk,SpATywNh6bZuzm8s1ceuBUnMUAeoAHHw,8,8,1,0,0,10,8,1,28,4.0,3,0.0,0,1,0,0,8,10,0,8,1,1,27,0
731,11650,ilWzYGLWBh9DSc1MV8g2C4Go5wDNgUHX,SpATywNh6bZuzm8s1ceuBUnMUAeoAHHw,6,6,2,4,0,0,2,0,14,2.0,2,0.0,3,2,2,0,3,0,2,2,0,7,7,0
732,11651,tnLfm9tutF6YoqDXNIONCmii1aynBy80,G8EPVSXsOYB5YQWZGiz1aVq5Pgr2GrQu,6,15,6,0,1,0,3,0,25,3.5714285714285716,3,0.0,5,6,0,1,10,0,0,3,0,12,13,0
733,11653,WHRYwHaNw8C182lJomkvSukjZ7e91Upo,G8EPVSXsOYB5YQWZGiz1aVq5Pgr2GrQu,20,14,6,22,4,7,2,0,55,7.857142857142857,2,0.0,8,6,14,4,6,7,8,2,0,32,23,1
734,11668,3D1G3v8o9ZJD4YifQcvj5oZ6l4EKMMc3,SpATywNh6bZuzm8s1ceuBUnMUAeoAHHw,5,9,0,0,0,0,5,0,14,2.0,3,0.0,2,0,0,0,7,0,0,5,0,2,12,0
735,11682,VLIaJAnZiJEAdolQsQ0bq4zJoZaIUmTN,SpATywNh6bZuzm8s1ceuBUnMUAeoAHHw,7,6,1,0,1,0,3,0,11,1.5714285714285714,1,0.0,0,1,0,1,6,0,0,3,0,2,9,1
736,11699,fJdUKH8czX92V7yfMeG7e087z1xbQDMc,SpATywNh6bZuzm8s1ceuBUnMUAeoAHHw,4,6,4,0,0,0,3,0,13,1.8571428571428572,2,0.0,0,4,0,0,6,0,0,3,0,4,9,0
737,11719,cr12tMBqYKzLJbEmIsyFvFLKAg0DiCbM,SpATywNh6bZuzm8s1ceuBUnMUAeoAHHw,6,5,3,0,1,0,2,0,11,1.5714285714285714,2,0.0,0,3,0,1,5,0,0,2,0,4,7,0
738,11732,6L205IIarnrBFjrCXSXMQhtSJJ5O5hiQ,SpATywNh6bZuzm8s1ceuBUnMUAeoAHHw,9,6,4,0,3,0,1,0,14,2.0,1,0.0,0,4,0,3,6,0,0,1,0,7,7,0
739,11773,gxkoHTlKe7FVuciB5TU7TNQLS1IuXLYY,SpATywNh6bZuzm8s1ceuBUnMUAeoAHHw,4,3,2,0,0,0,1,0,6,0.8571428571428571,1,0.0,0,2,0,0,3,0,0,1,0,2,4,1
740,11782,twnWF0mfZYHjmoqBvUs9g7jWpDxNR6WV,SpATywNh6bZuzm8s1ceuBUnMUAeoAHHw,6,7,4,0,1,0,1,0,13,1.8571428571428572,1,0.0,2,4,0,1,5,0,0,1,0,7,6,1
741,11797,ejIJpZTu0P4rcWcZmBKl6OiURGceVpiA,SpATywNh6bZuzm8s1ceuBUnMUAeoAHHw,3,2,1,0,0,0,2,0,5,0.7142857142857143,2,0.0,0,1,0,0,2,0,0,2,0,1,4,0
742,11803,jpgFrFPODuxdIxVKUbbelvbFMPtUp7jo,SpATywNh6bZuzm8s1ceuBUnMUAeoAHHw,2,0,0,0,0,0,4,0,4,0.5714285714285714,2,0.0,0,0,0,0,0,0,0,4,0,0,4,0
743,11866,0Ycdp4l6pgMwD7gJz4jynSnW5FA5aOcj,RXDvfPUBYFlVdlueBFbLW0mhhAyGEqpt,16,13,7,25,4,0,2,0,51,7.285714285714286,1,0.0,4,7,23,4,9,0,2,2,0,38,13,0
744,11875,s1zoJG6TsTv8LP9PRWCYbeiv4OLIivpy,SpATywNh6bZuzm8s1ceuBUnMUAeoAHHw,1,0,0,0,0,0,2,0,2,0.2857142857142857,2,0.0,0,0,0,0,0,0,0,2,0,0,2,0
745,11891,BeyfLbwb8pdDQU6WTI5ee3FkxRPRP7B2,A3fsA9Zfv1X2fVEQhTw51lKENdNrEqT3,1,0,0,0,0,0,1,0,1,0.14285714285714285,1,0.0,0,0,0,0,0,0,0,1,0,0,1,1
746,11909,Hh6CQ9eQF89j5a5Oi2NUf2uAs2DZd4QT,A3fsA9Zfv1X2fVEQhTw51lKENdNrEqT3,8,9,5,26,0,9,5,0,54,7.714285714285714,3,0.0,0,5,19,0,9,9,7,5,0,24,30,1
747,11912,5FSqkpRO54sosmyXXDdXixBIUlxd8QNQ,SpATywNh6bZuzm8s1ceuBUnMUAeoAHHw,10,19,12,11,0,0,10,0,52,7.428571428571429,3,0.0,2,12,9,0,17,0,2,10,0,23,29,0
748,11928,syrttArug8Mpzs9L0IHsvBtATawYF9J2,A3fsA9Zfv1X2fVEQhTw51lKENdNrEqT3,3,2,1,0,0,0,2,0,5,0.7142857142857143,1,0.0,0,1,0,0,2,0,0,2,0,1,4,0
749,11933,OmF4aFe06TkjIpsTgGpQ4vBzMWi2jjQV,bWdj2GDclj5ofokWjzoa5jAwMkxCykd6,16,15,8,24,3,0,6,0,56,8.0,2,0.0,3,8,18,3,12,0,6,6,0,32,24,0
750,11955,oyFfPK6y9oPPwQR5mbsXW98FJaEnU88b,SpATywNh6bZuzm8s1ceuBUnMUAeoAHHw,5,3,2,0,1,0,1,0,7,1.0,1,0.0,0,2,0,1,3,0,0,1,0,3,4,1
751,11958,HG2MGN3erjLUr4zPCv4UJukzIqIJPVZ2,SpATywNh6bZuzm8s1ceuBUnMUAeoAHHw,13,15,6,18,2,0,3,0,44,6.285714285714286,2,0.0,7,6,15,2,8,0,3,3,0,30,14,1
752,11969,RhMByUF03fgdIuaHANL6m20mbMakGgJs,SpATywNh6bZuzm8s1ceuBUnMUAeoAHHw,3,2,1,0,0,0,1,0,4,0.5714285714285714,1,0.0,0,1,0,0,2,0,0,1,0,1,3,0
753,11975,MAjx1xtQvL5ZiofHx4xuO3WtfmkLHjqM,SpATywNh6bZuzm8s1ceuBUnMUAeoAHHw,19,20,12,0,8,1,2,0,43,6.142857142857143,2,0.0,3,12,0,8,17,1,0,2,0,23,20,1
754,11981,FZjjoikxEifQwEx2vf6LYlhg4yyTwbym,A3fsA9Zfv1X2fVEQhTw51lKENdNrEqT3,21,31,14,24,6,26,9,0,110,15.714285714285714,2,0.0,4,14,19,6,27,26,5,9,0,43,67,1
755,11982,BA5BMBRmhCtFQyjTLAMMLlVS5ABrW2hi,SpATywNh6bZuzm8s1ceuBUnMUAeoAHHw,14,11,7,10,3,4,5,1,41,5.857142857142857,2,0.0,2,7,9,3,9,4,1,5,1,21,20,0
756,11998,NHPpKvbnrSpxM8e1DORBWJbRCpmrxZw8,SpATywNh6bZuzm8s1ceuBUnMUAeoAHHw,3,2,1,0,0,0,1,0,4,0.5714285714285714,1,0.0,0,1,0,0,2,0,0,1,0,1,3,0
757,12019,UaSh8dwx8gnofYbXlmpqj9uYDbpJ89pX,bWdj2GDclj5ofokWjzoa5jAwMkxCykd6,30,94,16,94,11,47,19,1,282,40.285714285714285,4,0.0,25,16,84,11,69,47,10,19,1,136,146,0
758,12052,g3902agYIRHzac78MKVZlvljLMXXNpQ7,SpATywNh6bZuzm8s1ceuBUnMUAeoAHHw,5,5,3,0,0,0,3,0,11,1.5714285714285714,2,0.0,0,3,0,0,5,0,0,3,0,3,8,0
759,12097,LclkEDGY7WCR76zraNkzkcQywMJivp2l,SpATywNh6bZuzm8s1ceuBUnMUAeoAHHw,2,0,0,0,0,0,3,0,3,0.42857142857142855,2,0.0,0,0,0,0,0,0,0,3,0,0,3,1
760,12119,x0VzAeYdlywtGLqE1HF68qQMYZTLfsw9,A3fsA9Zfv1X2fVEQhTw51lKENdNrEqT3,6,10,6,0,2,1,6,0,25,3.5714285714285716,3,0.0,0,6,0,2,10,1,0,6,0,8,17,1
761,12137,jkbAnCxwl3OIEg7uH62X9N4RjNwDvZxg,SpATywNh6bZuzm8s1ceuBUnMUAeoAHHw,9,18,5,0,4,0,4,0,31,4.428571428571429,4,0.0,0,5,0,4,18,0,0,4,0,9,22,1
762,12166,x6CSpC8D3vQdEDfFDD93c2HvZ1J8Rtto,RXDvfPUBYFlVdlueBFbLW0mhhAyGEqpt,3,2,1,0,0,0,1,0,4,0.5714285714285714,1,0.0,0,1,0,0,2,0,0,1,0,1,3,1
763,12197,RPansaKc9yPYyKahcqLAJO6a0GoBHglr,SpATywNh6bZuzm8s1ceuBUnMUAeoAHHw,2,0,0,0,0,0,2,0,2,0.2857142857142857,1,0.0,0,0,0,0,0,0,0,2,0,0,2,0
764,12212,KXPHZfgM3L9NmmWzrburRZrpNwRct3s8,SpATywNh6bZuzm8s1ceuBUnMUAeoAHHw,5,5,3,0,0,0,1,0,9,1.2857142857142858,1,0.0,0,3,0,0,5,0,0,1,0,3,6,1
765,12220,9b4Qm8eSvDuZev1N90TcJBdVRXi0Jx1k,SpATywNh6bZuzm8s1ceuBUnMUAeoAHHw,3,2,0,0,0,0,1,0,3,0.42857142857142855,1,0.0,0,0,0,0,2,0,0,1,0,0,3,1
766,12308,CQOn4KWCA0duDCOSP1DQzvXZ3yAfq1zW,SpATywNh6bZuzm8s1ceuBUnMUAeoAHHw,3,4,2,0,0,0,4,0,10,1.4285714285714286,2,0.0,0,2,0,0,4,0,0,4,0,2,8,0
767,12323,dceX0m9075YvlWaEabJwd03DyXl3MtL8,SpATywNh6bZuzm8s1ceuBUnMUAeoAHHw,4,7,3,0,0,0,2,0,12,1.7142857142857142,3,0.0,2,3,0,0,5,0,0,2,0,5,7,0
768,12348,ZhTCqX8GMUcn0a0betuEauHNuCk1aRhm,A3fsA9Zfv1X2fVEQhTw51lKENdNrEqT3,24,7,4,44,0,22,5,0,82,11.714285714285714,3,0.0,1,4,41,0,6,22,3,5,0,46,36,0
769,12371,Dx1ZzKpwFtwNhE9gdaLaohssqGyqrqjD,SpATywNh6bZuzm8s1ceuBUnMUAeoAHHw,2,0,0,0,0,13,1,0,14,2.0,1,0.0,0,0,0,0,0,13,0,1,0,0,14,0
770,12384,bKVslXuzEQ1pv4c6iV5mVjs6X6avUbmL,RXDvfPUBYFlVdlueBFbLW0mhhAyGEqpt,22,74,48,0,16,239,73,7,457,65.28571428571429,7,0.0,4,48,0,16,70,239,0,73,7,68,389,0
771,12415,9xXPu4XrxUEQD4kiDWTsMvTkTFxGkYzI,A3fsA9Zfv1X2fVEQhTw51lKENdNrEqT3,1,1,0,0,0,0,0,0,1,0.14285714285714285,1,0.0,0,0,0,0,1,0,0,0,0,0,1,1
772,12448,AQaaG4AcAnObnM2M4NcHCUkX6lEg0Mlu,SpATywNh6bZuzm8s1ceuBUnMUAeoAHHw,1,0,0,0,0,0,1,0,1,0.14285714285714285,1,0.0,0,0,0,0,0,0,0,1,0,0,1,1
773,12546,LRHDYNgQAsG2UssS8TgaqkiYDbFlVrrj,A3fsA9Zfv1X2fVEQhTw51lKENdNrEqT3,2,1,1,0,0,0,0,0,2,0.2857142857142857,1,0.0,0,1,0,0,1,0,0,0,0,1,1,1
774,12557,Vx74c4EnHqTcmxhMcO6kRvadcvYQC7Hl,SpATywNh6bZuzm8s1ceuBUnMUAeoAHHw,3,4,2,0,0,0,3,0,9,1.2857142857142858,2,0.0,0,2,0,0,4,0,0,3,0,2,7,0
775,12564,D59LfxtLBEXUXJuXCGYTJcy2S1d5nPYE,SpATywNh6bZuzm8s1ceuBUnMUAeoAHHw,4,2,1,0,0,0,2,0,5,0.7142857142857143,1,0.0,0,1,0,0,2,0,0,2,0,1,4,0
776,12566,ph8ToQs4xH6gdMMZGt7KWlSytujO4hy7,bWdj2GDclj5ofokWjzoa5jAwMkxCykd6,17,17,9,32,0,10,12,0,80,11.428571428571429,2,0.0,1,9,31,0,16,10,1,12,0,41,39,0
777,12590,g8m22R7W0Wo8v9RXY0TMbj5qf5RFgvht,A3fsA9Zfv1X2fVEQhTw51lKENdNrEqT3,46,37,29,54,21,0,2,0,143,20.428571428571427,1,0.0,6,29,53,21,31,0,1,2,0,109,34,1
778,12598,0MgLdwlRWQ7TpUbl7lDTcNpvvpvRxwZk,SpATywNh6bZuzm8s1ceuBUnMUAeoAHHw,6,7,3,0,1,0,2,0,13,1.8571428571428572,2,0.0,0,3,0,1,7,0,0,2,0,4,9,1
779,12678,v8Csqzh937f2Vg9ZqHM3p8LLheZjBof3,SpATywNh6bZuzm8s1ceuBUnMUAeoAHHw,1,0,0,0,0,0,1,0,1,0.14285714285714285,1,0.0,0,0,0,0,0,0,0,1,0,0,1,0
780,12702,piMSzq394zCurmILy54TdIfNK5vFDgeH,SpATywNh6bZuzm8s1ceuBUnMUAeoAHHw,6,11,7,0,2,0,4,0,24,3.4285714285714284,1,0.0,0,7,0,2,11,0,0,4,0,9,15,1
781,12725,yXkO3eR7yt6I5YPt7SbP4lJC7f4DWsPi,SpATywNh6bZuzm8s1ceuBUnMUAeoAHHw,9,17,0,32,0,0,4,0,53,7.571428571428571,2,0.0,6,0,25,0,11,0,7,4,0,31,22,0
782,12781,xI2qMeJnp6aq2CKhFmXJQYegY0eBgJqh,SpATywNh6bZuzm8s1ceuBUnMUAeoAHHw,4,8,3,0,0,0,1,0,12,1.7142857142857142,1,0.0,4,3,0,0,4,0,0,1,0,7,5,0
783,12797,0r0opwFyJ4N25MV6ZjVs69MBQP4LTfaz,RXDvfPUBYFlVdlueBFbLW0mhhAyGEqpt,26,27,15,39,7,0,2,0,90,12.857142857142858,2,0.0,9,15,39,7,18,0,0,2,0,70,20,0
784,12798,SZOXOmDilP1KR3OJXHpIlLf61tEoqX1S,SpATywNh6bZuzm8s1ceuBUnMUAeoAHHw,6,8,0,0,0,2,5,0,15,2.142857142857143,1,0.0,2,0,0,0,6,2,0,5,0,2,13,1
785,12801,N5iDERl36Pe29yDG8gDe9a99dYgqwB7y,bWdj2GDclj5ofokWjzoa5jAwMkxCykd6,23,24,3,81,0,0,7,0,115,16.428571428571427,2,0.0,5,3,68,0,19,0,13,7,0,76,39,1
786,12802,n2H1RsIyXGWShdCbCzwLRVNV0gBoMcRI,bWdj2GDclj5ofokWjzoa5jAwMkxCykd6,11,14,7,4,5,0,8,1,39,5.571428571428571,1,0.0,5,7,4,5,9,0,0,8,1,21,18,1
787,12830,L0KQTTHes3X5LPSdqQrdBMVgea19D6tJ,SpATywNh6bZuzm8s1ceuBUnMUAeoAHHw,4,2,1,0,0,0,2,0,5,0.7142857142857143,1,0.0,0,1,0,0,2,0,0,2,0,1,4,1
788,12838,D1VQybdJv05b8bnQWlTwVLnxuzPr9TGg,SpATywNh6bZuzm8s1ceuBUnMUAeoAHHw,3,2,0,0,0,0,1,0,3,0.42857142857142855,1,0.0,0,0,0,0,2,0,0,1,0,0,3,0
789,12878,nxXaLxK1WzKt8vz8gfQ7mw2jj0DmsYuz,SpATywNh6bZuzm8s1ceuBUnMUAeoAHHw,2,0,0,0,0,0,7,0,7,1.0,3,0.0,0,0,0,0,0,0,0,7,0,0,7,0
790,12919,UaSh8dwx8gnofYbXlmpqj9uYDbpJ89pX,SpATywNh6bZuzm8s1ceuBUnMUAeoAHHw,4,2,0,0,0,9,2,0,13,1.8571428571428572,1,0.0,0,0,0,0,2,9,0,2,0,0,13,0
791,12922,uqIn0vdfJ1SDJCOeCVEAQPRFBBKQA2eB,A3fsA9Zfv1X2fVEQhTw51lKENdNrEqT3,33,29,12,80,10,0,4,0,135,19.285714285714285,2,0.0,1,12,70,10,28,0,10,4,0,93,42,1
792,12939,BZIh5Ji4WRsl5XFn0vcayrSAt3EwPPq7,SpATywNh6bZuzm8s1ceuBUnMUAeoAHHw,4,11,0,0,0,0,10,0,21,3.0,6,0.0,0,0,0,0,11,0,0,10,0,0,21,0
793,12941,agXxlcmOoEfRNuHGmntEOJrJqSCOihJk,SpATywNh6bZuzm8s1ceuBUnMUAeoAHHw,8,9,0,6,0,0,1,0,16,2.2857142857142856,1,0.0,3,0,6,0,6,0,0,1,0,9,7,1
794,12960,QxcB9RiJu5tiHZOch1DPGex1fIsAotsI,SpATywNh6bZuzm8s1ceuBUnMUAeoAHHw,8,8,0,0,0,2,7,2,19,2.7142857142857144,2,0.0,0,0,0,0,8,2,0,7,2,0,19,0
795,12973,7fFZLbLMI7Ucj1mdrBxpY9hCEcczhOLF,RXDvfPUBYFlVdlueBFbLW0mhhAyGEqpt,3,2,1,0,0,0,3,0,6,0.8571428571428571,3,0.0,0,1,0,0,2,0,0,3,0,1,5,0
796,12998,MM2B2653YFHORo361rzambfOSuqgdvxU,SpATywNh6bZuzm8s1ceuBUnMUAeoAHHw,3,2,1,0,0,0,1,0,4,0.5714285714285714,2,0.0,0,1,0,0,2,0,0,1,0,1,3,1
797,13002,qBuOYvjWXxAt6x3Clq0Mm94iVtXMfRzl,A3fsA9Zfv1X2fVEQhTw51lKENdNrEqT3,13,8,6,0,4,1,4,1,24,3.4285714285714284,1,0.0,0,6,0,4,8,1,0,4,1,10,14,1
798,13038,Ys5FH0nq7NeLEdwGoDUOp7Sz8iAMAB3d,SpATywNh6bZuzm8s1ceuBUnMUAeoAHHw,5,4,2,0,1,0,1,0,8,1.1428571428571428,1,0.0,0,2,0,1,4,0,0,1,0,3,5,1
799,13064,FH8uaUgDtH5I6cjMpNACS7MT4OVRdm6l,SpATywNh6bZuzm8s1ceuBUnMUAeoAHHw,2,0,0,0,0,0,2,0,2,0.2857142857142857,1,0.0,0,0,0,0,0,0,0,2,0,0,2,0
800,13068,Oewk1cgUhxDAPgxI9Y8opSnbFrQ56lFp,G8EPVSXsOYB5YQWZGiz1aVq5Pgr2GrQu,29,34,13,26,8,3,27,0,111,15.857142857142858,3,0.0,7,13,22,8,27,3,4,27,0,50,61,0
801,13084,iKiK6wMQ7FsUhBHmZmA4WSvuLlgoIAIT,SpATywNh6bZuzm8s1ceuBUnMUAeoAHHw,5,13,4,0,0,0,2,0,19,2.7142857142857144,2,0.0,7,4,0,0,6,0,0,2,0,11,8,1
802,13096,WkW7xhOBov4cdi1HI8MIcYy2tcL8JIqM,G8EPVSXsOYB5YQWZGiz1aVq5Pgr2GrQu,29,31,11,74,5,1,11,0,133,19.0,3,0.0,18,11,58,5,13,1,16,11,0,92,41,0
803,13097,jSElHDudYQXAurrUrZvr8PEvqza2483p,SpATywNh6bZuzm8s1ceuBUnMUAeoAHHw,9,11,1,0,2,0,3,0,17,2.4285714285714284,2,0.0,0,1,0,2,11,0,0,3,0,3,14,0
804,13171,Xz4KwNrqILWO256erDoEJKlZ22fLi17K,bWdj2GDclj5ofokWjzoa5jAwMkxCykd6,3,1,0,0,0,0,2,0,3,0.42857142857142855,1,0.0,0,0,0,0,1,0,0,2,0,0,3,1
805,13182,Gur5FuhE9EyV9K1F0qLPk7AenhoY8PBS,A3fsA9Zfv1X2fVEQhTw51lKENdNrEqT3,5,5,2,0,1,0,1,0,9,1.2857142857142858,1,0.0,0,2,0,1,5,0,0,1,0,3,6,0
806,13231,CGCo1ulRSzYrFke9WXpheptgBfQxf2gK,SpATywNh6bZuzm8s1ceuBUnMUAeoAHHw,16,33,17,14,7,3,7,0,81,11.571428571428571,3,0.0,6,17,13,7,27,3,1,7,0,43,38,0
807,13270,ffLXxfgMU4yir9uI5fIkKo2iZzEw2Lpz,SpATywNh6bZuzm8s1ceuBUnMUAeoAHHw,3,2,1,0,0,0,1,0,4,0.5714285714285714,1,0.0,0,1,0,0,2,0,0,1,0,1,3,1
808,13297,0b8UUNX7vDapSg0uCVOk0glpsbuPbDat,SpATywNh6bZuzm8s1ceuBUnMUAeoAHHw,1,0,0,0,0,0,1,0,1,0.14285714285714285,1,0.0,0,0,0,0,0,0,0,1,0,0,1,0
809,13309,1dxQmK9WwlHWuIG7ZTn4PsJ2vflQBDH3,A3fsA9Zfv1X2fVEQhTw51lKENdNrEqT3,3,2,1,0,0,0,1,0,4,0.5714285714285714,1,0.0,0,1,0,0,2,0,0,1,0,1,3,0
810,13318,Xzt2w1aRoJeIAP02oHWxu8IVeFzxqDvF,SpATywNh6bZuzm8s1ceuBUnMUAeoAHHw,1,0,0,0,0,0,1,0,1,0.14285714285714285,1,0.0,0,0,0,0,0,0,0,1,0,0,1,0
811,13327,M3xTB6LenTJvMpybZKparVtRZKzrRM1R,SpATywNh6bZuzm8s1ceuBUnMUAeoAHHw,6,5,3,0,1,0,2,0,11,1.5714285714285714,1,0.0,0,3,0,1,5,0,0,2,0,4,7,0
812,13353,Aw7PeIkLW9CDHbPpPSjrFUdtBaUuHUXm,A3fsA9Zfv1X2fVEQhTw51lKENdNrEqT3,34,25,18,64,8,0,29,0,144,20.571428571428573,6,0.0,2,18,51,8,23,0,13,29,0,79,65,0
813,13392,Zp81uMflvqqrfEwxhUzFhFbNFp63e2qq,SpATywNh6bZuzm8s1ceuBUnMUAeoAHHw,9,10,2,0,0,0,2,0,14,2.0,5,0.0,0,2,0,0,10,0,0,2,0,2,12,0
814,13417,P6cCvRjvbpDjgLjSjFoCoaUi3J3jrMaV,bWdj2GDclj5ofokWjzoa5jAwMkxCykd6,13,18,2,16,1,4,7,1,49,7.0,1,0.0,1,2,16,1,17,4,0,7,1,20,29,1
815,13442,Q459I6WtHQ4LYscZN5C0n5NrNaEwzARk,A3fsA9Zfv1X2fVEQhTw51lKENdNrEqT3,5,2,1,0,1,0,5,0,9,1.2857142857142858,1,0.0,0,1,0,1,2,0,0,5,0,2,7,0
816,13502,Zdseq1rQmkAi5wZl57d3RwjzOxlL3B5I,A3fsA9Zfv1X2fVEQhTw51lKENdNrEqT3,3,2,2,0,0,0,1,0,5,0.7142857142857143,2,0.0,0,2,0,0,2,0,0,1,0,2,3,0
817,13503,2YfvPW4RjjB1wuYNlMfzfMUdSCE4Rwzu,SpATywNh6bZuzm8s1ceuBUnMUAeoAHHw,7,11,1,0,1,0,4,0,17,2.4285714285714284,3,0.0,0,1,0,1,11,0,0,4,0,2,15,0
818,13513,OsjipUObm67JsyJjOy7xHoa32L8CSYg5,RXDvfPUBYFlVdlueBFbLW0mhhAyGEqpt,16,21,3,11,1,9,3,0,48,6.857142857142857,2,0.0,0,3,11,1,21,9,0,3,0,15,33,0
819,13529,Ge8ZKyoh7v3U8XFFvvntz8tE5dDD1txz,SpATywNh6bZuzm8s1ceuBUnMUAeoAHHw,3,2,1,0,0,0,2,0,5,0.7142857142857143,1,0.0,0,1,0,0,2,0,0,2,0,1,4,1
820,13538,LjMEB9aIUIvEfq4JTf4C9ef9fHbbyj0M,SpATywNh6bZuzm8s1ceuBUnMUAeoAHHw,1,0,0,0,0,0,1,0,1,0.14285714285714285,1,0.0,0,0,0,0,0,0,0,1,0,0,1,0
821,13541,dQ6ARJIxCHLlztvK37NHQ0C1ttipx0zg,SpATywNh6bZuzm8s1ceuBUnMUAeoAHHw,9,8,6,0,4,0,1,0,19,2.7142857142857144,1,0.0,0,6,0,4,8,0,0,1,0,10,9,0
822,13562,Du4OhdznDw29gaWDeHXBUWRKyEVAbHaQ,SpATywNh6bZuzm8s1ceuBUnMUAeoAHHw,4,11,5,0,0,0,7,0,23,3.2857142857142856,3,0.0,3,5,0,0,8,0,0,7,0,8,15,0
823,13568,r0yAsNzYkqEPYi6zNhQfzuueDjmcyFRr,G8EPVSXsOYB5YQWZGiz1aVq5Pgr2GrQu,25,12,8,30,3,0,7,0,60,8.571428571428571,1,0.0,3,8,25,3,9,0,5,7,0,39,21,1
824,13571,QFQlbn421RXpUzVVaKhkxpBlvQfTJy18,SpATywNh6bZuzm8s1ceuBUnMUAeoAHHw,1,0,0,0,0,0,1,0,1,0.14285714285714285,1,0.0,0,0,0,0,0,0,0,1,0,0,1,0
825,13574,BOWTvQlkFu3OONGPj2orMpzJbZOzBXuG,SpATywNh6bZuzm8s1ceuBUnMUAeoAHHw,4,4,1,0,0,0,2,0,7,1.0,1,0.0,0,1,0,0,4,0,0,2,0,1,6,0
826,13577,r9n2Z7iYkL5tKegLJwMIOxTHQqxopYp0,SpATywNh6bZuzm8s1ceuBUnMUAeoAHHw,9,13,3,22,1,0,1,0,40,5.714285714285714,1,0.0,9,3,19,1,4,0,3,1,0,32,8,1
827,13591,thD3JQHh1xpY9SdL9w6TAUhWjJrPsSHi,SpATywNh6bZuzm8s1ceuBUnMUAeoAHHw,9,11,7,0,4,0,2,0,24,3.4285714285714284,2,0.0,1,7,0,4,10,0,0,2,0,12,12,0
828,13615,SFczaSY6Hc3uft6fwzUwvxTQx8AOyArS,G8EPVSXsOYB5YQWZGiz1aVq5Pgr2GrQu,16,11,1,18,0,4,7,1,42,6.0,1,0.0,0,1,14,0,11,4,4,7,1,15,27,1
829,13617,q1nSg7gMR4fmcENPvRW7b84TFAk5YaYv,SpATywNh6bZuzm8s1ceuBUnMUAeoAHHw,3,2,0,0,0,0,2,0,4,0.5714285714285714,1,0.0,0,0,0,0,2,0,0,2,0,0,4,1
830,13635,ePpfrPKFmuYE4CHcpunEZ73b0FxyOz0q,A3fsA9Zfv1X2fVEQhTw51lKENdNrEqT3,33,10,8,92,5,0,2,0,117,16.714285714285715,1,0.0,1,8,74,5,9,0,18,2,0,88,29,1
831,13639,6ZFGnTjh94PbXkR7sbTLWokikXbcLQlV,A3fsA9Zfv1X2fVEQhTw51lKENdNrEqT3,4,4,2,0,0,0,1,0,7,1.0,1,0.0,0,2,0,0,4,0,0,1,0,2,5,0
832,13658,BRb6GOIqcgYg1e6c431h8FubF4jTJim3,SpATywNh6bZuzm8s1ceuBUnMUAeoAHHw,3,2,1,0,0,0,1,0,4,0.5714285714285714,1,0.0,0,1,0,0,2,0,0,1,0,1,3,1
833,13668,ZFgJH3XPKn6EjDuXV9VLOpKftzENCqEZ,G8EPVSXsOYB5YQWZGiz1aVq5Pgr2GrQu,18,15,10,38,0,23,7,0,93,13.285714285714286,3,0.0,2,10,34,0,13,23,4,7,0,46,47,0
834,13677,ZFgJH3XPKn6EjDuXV9VLOpKftzENCqEZ,RXDvfPUBYFlVdlueBFbLW0mhhAyGEqpt,12,9,8,0,1,4,4,0,26,3.7142857142857144,2,0.0,0,8,0,1,9,4,0,4,0,9,17,0
835,13692,dB9soxJVmgwXZSiR7r7fYfCigeYZx4rK,SpATywNh6bZuzm8s1ceuBUnMUAeoAHHw,1,0,0,0,0,0,1,0,1,0.14285714285714285,1,0.0,0,0,0,0,0,0,0,1,0,0,1,1
836,13695,eosk3dY7502Pbg6Dsnx0qWKWUpRTliXK,SpATywNh6bZuzm8s1ceuBUnMUAeoAHHw,9,15,3,0,3,0,4,0,25,3.5714285714285716,3,0.0,0,3,0,3,15,0,0,4,0,6,19,1
837,13752,GUhU3sa7QMussHGi4kspdulqSqF9Ft42,SpATywNh6bZuzm8s1ceuBUnMUAeoAHHw,3,2,0,0,0,0,5,0,7,1.0,3,0.0,0,0,0,0,2,0,0,5,0,0,7,0
838,13771,I1KwJ6EdCZnEPLfC8Q7yWpIkLOHn7h02,A3fsA9Zfv1X2fVEQhTw51lKENdNrEqT3,6,6,4,0,1,0,2,0,13,1.8571428571428572,2,0.0,0,4,0,1,6,0,0,2,0,5,8,1
839,14546,82UlWF6Fm1gkNum7nNbVw0yOV1BUdNoS,7GRhBDsirIGkRZBtSMEzNTyDr2JQm4xx,24,50,23,22,14,25,4,0,138,19.714285714285715,3,0.0,22,23,17,14,28,25,5,4,0,76,62,1
840,14609,Q9kdHcV1kbonm0KnIW9OSERwU5lfVZ8s,7GRhBDsirIGkRZBtSMEzNTyDr2JQm4xx,32,70,11,18,16,3,1,0,119,17.0,1,0.0,35,11,15,16,35,3,3,1,0,77,42,1
841,14654,StcQZMEDAMldF4GFQUzkrPFNVNZnPaeq,7GRhBDsirIGkRZBtSMEzNTyDr2JQm4xx,33,164,54,63,27,22,4,0,334,47.714285714285715,2,0.0,100,54,49,27,64,22,14,4,0,230,104,0
842,14744,fznl9GLBUcCuiLFhCkHOSxn8Xeb6YOkl,7GRhBDsirIGkRZBtSMEzNTyDr2JQm4xx,9,18,6,0,7,0,2,0,33,4.714285714285714,1,0.0,12,6,0,7,6,0,0,2,0,25,8,1
843,14816,NJcCHbOJUQpAuhbw958dR9qCvbh6GNk7,7GRhBDsirIGkRZBtSMEzNTyDr2JQm4xx,6,8,2,0,2,0,2,0,14,2.0,3,0.0,1,2,0,2,7,0,0,2,0,5,9,1
844,14847,1CUoIZB9t7SxaldyOLjOrt0HiuV3YmmT,7GRhBDsirIGkRZBtSMEzNTyDr2JQm4xx,29,63,26,0,3,3,16,2,113,16.142857142857142,1,0.0,16,26,0,3,47,3,0,16,2,45,68,0
845,15048,YUqXNrT8XQT6xSTrWrerz6EWyspe1b7c,7GRhBDsirIGkRZBtSMEzNTyDr2JQm4xx,28,63,28,48,10,1,1,0,151,21.571428571428573,2,0.0,32,28,40,10,31,1,8,1,0,110,41,0
846,15082,0ogceMBqbMfusFqG89X9sBzEnUGema9q,7GRhBDsirIGkRZBtSMEzNTyDr2JQm4xx,2,0,1,0,1,0,0,0,2,0.2857142857142857,1,0.0,0,1,0,1,0,0,0,0,0,2,0,1
847,15083,AsBtR21xGFKZ6c2LKvPTdlawgiUBcaPL,7GRhBDsirIGkRZBtSMEzNTyDr2JQm4xx,29,74,37,54,25,14,8,0,212,30.285714285714285,4,0.0,28,37,43,25,46,14,11,8,0,133,79,0
848,15187,q36eiA77bwwsXGg05ifhgnTFDpR9Ar4V,7GRhBDsirIGkRZBtSMEzNTyDr2JQm4xx,44,69,20,70,18,0,8,0,185,26.428571428571427,2,0.0,33,20,58,18,36,0,12,8,0,129,56,0
849,15240,9PiJFDewOyLmHT48JZWbbQ236haTndT7,7GRhBDsirIGkRZBtSMEzNTyDr2JQm4xx,16,36,7,11,1,0,6,0,61,8.714285714285714,4,0.0,23,7,11,1,13,0,0,6,0,42,19,1
850,15242,CYwEz0VhssUEnyi7GLISc2cCNlhTg5eu,7GRhBDsirIGkRZBtSMEzNTyDr2JQm4xx,17,15,1,23,4,0,1,0,44,6.285714285714286,1,0.0,9,1,20,4,6,0,3,1,0,34,10,1
851,15296,S0OJjF6aof0iTnIX6lUAxekoH3m4w7V0,7GRhBDsirIGkRZBtSMEzNTyDr2JQm4xx,40,69,28,65,25,6,13,0,206,29.428571428571427,4,0.0,31,28,55,25,38,6,10,13,0,139,67,0
852,15361,CrwYq2YvOe70PhTOuriN4QumcrUjBJDI,7GRhBDsirIGkRZBtSMEzNTyDr2JQm4xx,13,27,6,8,2,6,4,0,53,7.571428571428571,1,0.0,19,6,7,2,8,6,1,4,0,34,19,0
853,15367,nnTxxp3z9fcrPPkS4kzYDi6mu4P5bdue,7GRhBDsirIGkRZBtSMEzNTyDr2JQm4xx,19,25,10,10,6,1,8,0,60,8.571428571428571,2,0.0,12,10,8,6,13,1,2,8,0,36,24,0
854,15563,VVltscgfR96aweHb5nQdD1Q7dsOwuOJz,7GRhBDsirIGkRZBtSMEzNTyDr2JQm4xx,8,6,0,2,1,0,2,0,11,1.5714285714285714,1,0.0,2,0,2,1,4,0,0,2,0,5,6,0
855,15700,p8pFuUg19xWGOlJygMvSlQjonA3l7FUn,7GRhBDsirIGkRZBtSMEzNTyDr2JQm4xx,5,4,2,0,1,0,2,0,9,1.2857142857142858,1,0.0,1,2,0,1,3,0,0,2,0,4,5,1
856,15713,UQMPqDnQtELOyig8xWMMs5ktcYwtyCzh,7GRhBDsirIGkRZBtSMEzNTyDr2JQm4xx,20,32,16,0,15,2,10,0,75,10.714285714285714,4,0.0,0,16,0,15,32,2,0,10,0,31,44,0
857,15716,W2ohBuN5JfRDGloM0s99vkGQJHKKrtyK,7GRhBDsirIGkRZBtSMEzNTyDr2JQm4xx,7,9,4,0,2,0,3,0,18,2.5714285714285716,4,0.0,0,4,0,2,9,0,0,3,0,6,12,1
858,15810,WJLMraoon9e2y7OtDk9UrQjU4oqkoa0t,7GRhBDsirIGkRZBtSMEzNTyDr2JQm4xx,7,10,7,0,3,0,2,0,22,3.142857142857143,1,0.0,0,7,0,3,10,0,0,2,0,10,12,0
859,15814,g7u6ac7DR9jMW4aOouB4W8Gur81b4cDe,7GRhBDsirIGkRZBtSMEzNTyDr2JQm4xx,34,34,13,47,14,0,11,0,119,17.0,4,0.0,19,13,36,14,15,0,11,11,0,82,37,0
860,15881,W8K4VS8rPvnPTNUJrqgtS2FKH93KmR91,7GRhBDsirIGkRZBtSMEzNTyDr2JQm4xx,3,2,1,0,0,0,1,0,4,0.5714285714285714,1,0.0,0,1,0,0,2,0,0,1,0,1,3,1
861,15900,MvkVXPKImqjQobZ7zCJXq4GfQ4IthLq9,7GRhBDsirIGkRZBtSMEzNTyDr2JQm4xx,31,33,10,26,8,0,6,0,83,11.857142857142858,4,0.0,9,10,26,8,24,0,0,6,0,53,30,0
862,15912,hJo1MgKiPZFXuH2ko6hqPTd9dbjMQKDO,7GRhBDsirIGkRZBtSMEzNTyDr2JQm4xx,35,45,14,56,12,0,15,3,145,20.714285714285715,3,0.0,21,14,45,12,24,0,11,15,3,92,53,1
863,15919,oho8eUx0qt2QgQUM9H4Puo64w9V5nVUl,7GRhBDsirIGkRZBtSMEzNTyDr2JQm4xx,20,25,11,10,10,0,9,0,65,9.285714285714286,3,0.0,10,11,9,10,15,0,1,9,0,40,25,1
864,15922,OHdLWfOkVYVSxh9avWbeG6oGLyuN9vvx,7GRhBDsirIGkRZBtSMEzNTyDr2JQm4xx,10,17,6,13,6,3,3,0,48,6.857142857142857,1,0.0,8,6,10,6,9,3,3,3,0,30,18,1
865,15956,wg7c1wZNHnWuQEzOFg3X7UO4UvdvZ0Nl,7GRhBDsirIGkRZBtSMEzNTyDr2JQm4xx,18,11,4,87,2,0,1,0,105,15.0,1,0.0,4,4,79,2,7,0,8,1,0,89,16,1
866,15959,KD5stEhIDxW0wB7Mr1YVPQQ5AGRkzqAA,7GRhBDsirIGkRZBtSMEzNTyDr2JQm4xx,52,91,35,88,19,11,22,1,267,38.142857142857146,5,0.0,46,35,72,19,45,11,16,22,1,172,95,1
867,15966,dWGIj0UEkV1WxMBYGHRsdtDhUsNSq5LC,7GRhBDsirIGkRZBtSMEzNTyDr2JQm4xx,11,30,10,0,3,4,4,0,51,7.285714285714286,2,0.0,17,10,0,3,13,4,0,4,0,30,21,0
868,15982,yUo0f8mA9XEAtzr6kcSUh5ydpzcuIcml,7GRhBDsirIGkRZBtSMEzNTyDr2JQm4xx,28,74,16,36,20,13,6,0,165,23.571428571428573,3,0.0,40,16,32,20,34,13,4,6,0,108,57,1
869,16020,ywdL3xkp7d2PSjbvnflAvIe7Wp6Q4SRe,7GRhBDsirIGkRZBtSMEzNTyDr2JQm4xx,3,2,0,0,0,0,1,0,3,0.42857142857142855,1,0.0,0,0,0,0,2,0,0,1,0,0,3,1
870,16038,NoaJNfAZAESYC7salsh3Qwaa5hC3sdBk,7GRhBDsirIGkRZBtSMEzNTyDr2JQm4xx,11,23,8,2,1,1,3,0,38,5.428571428571429,2,0.0,10,8,1,1,13,1,1,3,0,20,18,0
871,16087,SIdEQEXoagJ5WwAcAkPtkVF6pipatiIa,7GRhBDsirIGkRZBtSMEzNTyDr2JQm4xx,28,41,9,14,14,0,1,0,79,11.285714285714286,1,0.0,12,9,12,14,29,0,2,1,0,47,32,0
872,16131,cwM32Iyo8DmzSk0EybXLo5ksFWhXG4Da,7GRhBDsirIGkRZBtSMEzNTyDr2JQm4xx,53,84,22,27,22,0,3,0,158,22.571428571428573,5,0.0,48,22,18,22,36,0,9,3,0,110,48,0
873,16168,DLDhUvvvfnnYFJuV65Zt2yaS0jPJgvzq,7GRhBDsirIGkRZBtSMEzNTyDr2JQm4xx,7,6,0,2,0,0,1,0,9,1.2857142857142858,1,0.0,1,0,1,0,5,0,1,1,0,2,7,1
874,16238,4NRUo07WkcrdRLUhlPTipY45aaERRn99,7GRhBDsirIGkRZBtSMEzNTyDr2JQm4xx,30,66,18,50,15,1,2,0,152,21.714285714285715,1,0.0,24,18,44,15,42,1,6,2,0,101,51,0
875,16378,RjbxXw1YYmiUcedHIl1VrXvYXiS6wbOC,7GRhBDsirIGkRZBtSMEzNTyDr2JQm4xx,25,26,0,66,5,1,2,0,100,14.285714285714286,1,0.0,16,0,56,5,10,1,10,2,0,77,23,0
876,16415,096xYyhB9kL7G6lT7J9rVrXyGNwUToLF,7GRhBDsirIGkRZBtSMEzNTyDr2JQm4xx,22,48,22,0,1,0,3,0,74,10.571428571428571,2,0.0,17,22,0,1,31,0,0,3,0,40,34,0
877,16460,KDzfaWgTSBqeMJLFLmFuh4CMLsva9aWu,7GRhBDsirIGkRZBtSMEzNTyDr2JQm4xx,23,44,0,42,2,5,6,0,99,14.142857142857142,4,0.0,9,0,35,2,35,5,7,6,0,46,53,0
878,16541,tDBUBIMhJEJx4Pe5n9oY4eK5G81QRmVq,7GRhBDsirIGkRZBtSMEzNTyDr2JQm4xx,38,87,34,90,32,6,3,0,252,36.0,2,0.0,45,34,74,32,42,6,16,3,0,185,67,0
879,16559,WbPhqfwmFYggW432ooC1iHmgUJBCP9Le,7GRhBDsirIGkRZBtSMEzNTyDr2JQm4xx,32,52,29,10,31,2,7,0,131,18.714285714285715,2,0.0,18,29,10,31,34,2,0,7,0,88,43,0
880,16632,uPNpQwnvEtjDufLcIcScg8qVljQjes1y,7GRhBDsirIGkRZBtSMEzNTyDr2JQm4xx,7,8,2,15,0,0,0,0,25,3.5714285714285716,2,0.0,5,2,15,0,3,0,0,0,0,22,3,1
881,16696,EshSTNSaPVDLcPEwlm2e07DrZJhzPNHK,7GRhBDsirIGkRZBtSMEzNTyDr2JQm4xx,40,76,31,47,29,3,10,0,196,28.0,3,0.0,38,31,37,29,38,3,10,10,0,135,61,0
882,16828,FhnsJdRTpIANrPfAv3Fv2vn7QGHPfOsl,7GRhBDsirIGkRZBtSMEzNTyDr2JQm4xx,1,0,0,0,0,0,1,0,1,0.14285714285714285,1,0.0,0,0,0,0,0,0,0,1,0,0,1,0
883,16923,oSfAVLTcGEmcT7y7OMQrYnvkkm78yh0P,7GRhBDsirIGkRZBtSMEzNTyDr2JQm4xx,41,47,19,78,18,21,2,0,185,26.428571428571427,1,0.0,22,19,67,18,25,21,11,2,0,126,59,1
884,16957,5fUv2a4WMEi2Bc60cQo0Uzo1I7SufPfI,7GRhBDsirIGkRZBtSMEzNTyDr2JQm4xx,11,11,0,26,4,2,1,0,44,6.285714285714286,1,0.0,7,0,22,4,4,2,4,1,0,33,11,1
885,16978,9gZpfuq1OK1diJdWcNoIpwo7QJUSplIt,7GRhBDsirIGkRZBtSMEzNTyDr2JQm4xx,6,9,3,0,0,0,4,0,16,2.2857142857142856,1,0.0,4,3,0,0,5,0,0,4,0,7,9,1
886,16999,Jb792VQeMGhUz59LQDa5JysSU082aNRs,7GRhBDsirIGkRZBtSMEzNTyDr2JQm4xx,5,7,1,2,0,0,1,0,11,1.5714285714285714,1,0.0,4,1,1,0,3,0,1,1,0,6,5,0
887,17028,HF98YPKzT8oi2j9flZW9kstZcvL3ZimG,7GRhBDsirIGkRZBtSMEzNTyDr2JQm4xx,8,13,6,6,2,0,3,0,30,4.285714285714286,2,0.0,2,6,5,2,11,0,1,3,0,15,15,0
888,17049,4i80ssNqIa74pSBDzjYYryTbL6MBe9I9,7GRhBDsirIGkRZBtSMEzNTyDr2JQm4xx,40,67,32,61,26,3,23,0,212,30.285714285714285,4,0.0,33,32,50,26,34,3,11,23,0,141,71,1
889,17055,CxUPOQRaQMGLmbOcfniIQOhh24PXLDR6,7GRhBDsirIGkRZBtSMEzNTyDr2JQm4xx,2,2,1,0,0,0,0,0,3,0.42857142857142855,2,0.0,0,1,0,0,2,0,0,0,0,1,2,0
890,17104,oxYTAYYaR98reRev5BqLPii4AFJGZbGZ,7GRhBDsirIGkRZBtSMEzNTyDr2JQm4xx,8,7,4,0,1,0,3,0,15,2.142857142857143,1,0.0,2,4,0,1,5,0,0,3,0,7,8,1
891,17267,5nhjk1VnZY8a3OWnkRujRs0BorgiAKUm,7GRhBDsirIGkRZBtSMEzNTyDr2JQm4xx,5,2,0,0,0,0,3,0,5,0.7142857142857143,1,0.0,0,0,0,0,2,0,0,3,0,0,5,1
892,17332,Dy53HBwqZRiUys0tuL4RoOSu6jKEN99b,7GRhBDsirIGkRZBtSMEzNTyDr2JQm4xx,43,149,3,77,21,14,8,4,276,39.42857142857143,2,0.0,95,3,69,21,54,14,8,8,4,188,88,0
893,17382,B9q7BVaj4oZ0WT5JELnStUq4yahYsvGS,7GRhBDsirIGkRZBtSMEzNTyDr2JQm4xx,12,25,4,0,7,0,1,0,37,5.285714285714286,1,0.0,10,4,0,7,15,0,0,1,0,21,16,1
894,17388,QRh7ApSBJNbSH61R3OkAQmXanxVzZM0F,7GRhBDsirIGkRZBtSMEzNTyDr2JQm4xx,20,39,12,14,6,12,4,0,87,12.428571428571429,1,0.0,23,12,7,6,16,12,7,4,0,48,39,0
895,17389,Qj89AM8R8CzDfUmyoFjU0iKz1g513ZXt,7GRhBDsirIGkRZBtSMEzNTyDr2JQm4xx,37,65,17,36,17,23,12,1,171,24.428571428571427,2,0.0,22,17,29,17,43,23,7,12,1,85,86,1
896,17459,1Ueye4RWWjvz8urTBfWMjk9mmqk3rMDD,7GRhBDsirIGkRZBtSMEzNTyDr2JQm4xx,8,11,3,4,2,0,2,0,22,3.142857142857143,1,0.0,5,3,4,2,6,0,0,2,0,14,8,1
897,17510,riM9GkB0ajSqpIPlVq4tRzOjk7wJ6NHE,7GRhBDsirIGkRZBtSMEzNTyDr2JQm4xx,14,26,7,8,11,4,14,1,71,10.142857142857142,3,0.0,14,7,7,11,12,4,1,14,1,39,32,0
898,17586,TwDUv8vbemLEqdAHMCXeJ0dOJyZMBx6V,7GRhBDsirIGkRZBtSMEzNTyDr2JQm4xx,31,72,18,69,10,4,4,0,177,25.285714285714285,2,0.0,26,18,62,10,46,4,7,4,0,116,61,0
899,17626,uol5rXltLKrhjm5SMrTU5qkZcMAMKTe6,7GRhBDsirIGkRZBtSMEzNTyDr2JQm4xx,9,11,6,6,5,0,2,0,30,4.285714285714286,1,0.0,2,6,5,5,9,0,1,2,0,18,12,1
900,17660,UaSh8dwx8gnofYbXlmpqj9uYDbpJ89pX,7GRhBDsirIGkRZBtSMEzNTyDr2JQm4xx,35,113,6,52,8,36,13,0,228,32.57142857142857,3,0.0,70,6,44,8,43,36,8,13,0,128,100,0
901,17677,7VmmzXV3A639hzlpZwrx655FqwOsl8uh,7GRhBDsirIGkRZBtSMEzNTyDr2JQm4xx,8,7,0,0,0,0,5,0,12,1.7142857142857142,1,0.0,0,0,0,0,7,0,0,5,0,0,12,1
902,17707,8hNQWXBoItm3CRzdk0wSJDwYSfUbhUCO,7GRhBDsirIGkRZBtSMEzNTyDr2JQm4xx,20,33,11,20,5,1,2,0,72,10.285714285714286,1,0.0,12,11,15,5,21,1,5,2,0,43,29,1
903,19580,3W09pasLSoDWuQqGyvECJ7WiykG165j2,fbPkOYLVPtPgIt0MxizjfFJov3JbHyAi,13,14,8,4,1,8,2,0,37,5.285714285714286,1,0.0,2,8,3,1,12,8,1,2,0,14,23,1
904,19586,z5Htt0utseDft2JjH8T5zYokNhpAiHNE,fbPkOYLVPtPgIt0MxizjfFJov3JbHyAi,8,10,0,0,1,23,5,0,39,5.571428571428571,1,0.0,3,0,0,1,7,23,0,5,0,4,35,0
905,19588,EFioWHTkYv074j9vSFY7qmw2MvFzZ0mo,fbPkOYLVPtPgIt0MxizjfFJov3JbHyAi,21,31,12,14,10,0,7,0,74,10.571428571428571,3,0.0,15,12,12,10,16,0,2,7,0,49,25,0
906,19591,I91CCtQfetYUPwkEXIvTFBP6tbrp1spN,fbPkOYLVPtPgIt0MxizjfFJov3JbHyAi,27,56,31,20,12,0,8,0,127,18.142857142857142,4,0.0,11,31,16,12,45,0,4,8,0,70,57,0
907,19593,sYGG7Hl1IcaeWwJigpwVXXbQKD0HFEPn,fbPkOYLVPtPgIt0MxizjfFJov3JbHyAi,9,7,5,0,3,0,1,0,16,2.2857142857142856,1,0.0,1,5,0,3,6,0,0,1,0,9,7,1
908,19598,rUHwInfwrT2VCsoj7SngGENcoxIrK2aA,fbPkOYLVPtPgIt0MxizjfFJov3JbHyAi,4,13,1,0,1,0,1,0,16,2.2857142857142856,1,0.0,10,1,0,1,3,0,0,1,0,12,4,1
909,19607,BCPOhUa2LrfH93ebCE15VbF0VEWEyi7T,fbPkOYLVPtPgIt0MxizjfFJov3JbHyAi,1,0,0,0,0,0,1,0,1,0.14285714285714285,1,0.0,0,0,0,0,0,0,0,1,0,0,1,1
910,19612,XVNXZTDLYViPgXZBTcX5RWMvf5SNK18Y,fbPkOYLVPtPgIt0MxizjfFJov3JbHyAi,8,5,3,0,2,0,3,0,13,1.8571428571428572,2,0.0,0,3,0,2,5,0,0,3,0,5,8,1
911,19621,P7cWTzqHbKs2w7IhW7Eb0IWuvmS7VHHm,fbPkOYLVPtPgIt0MxizjfFJov3JbHyAi,33,42,23,13,11,27,8,1,125,17.857142857142858,2,0.0,16,23,13,11,26,27,0,8,1,63,62,0
912,19624,2we3WxltFBT1dd0FjP3YZ8iHf2xpHEei,fbPkOYLVPtPgIt0MxizjfFJov3JbHyAi,4,6,1,0,0,0,1,0,8,1.1428571428571428,2,0.0,1,1,0,0,5,0,0,1,0,2,6,1
913,19626,HnvxqugChFN5yjBU90JTvP996KYT36S0,fbPkOYLVPtPgIt0MxizjfFJov3JbHyAi,4,3,2,0,0,0,1,0,6,0.8571428571428571,1,0.0,0,2,0,0,3,0,0,1,0,2,4,1
914,19629,G0JgmTQ55TeK9aeblJVq6TYQNTXqJFIQ,fbPkOYLVPtPgIt0MxizjfFJov3JbHyAi,2,2,1,0,0,0,0,0,3,0.42857142857142855,1,0.0,0,1,0,0,2,0,0,0,0,1,2,1
915,19646,ggEr2STKTwtSSUdtGCmiPr3DBu3TJ34B,fbPkOYLVPtPgIt0MxizjfFJov3JbHyAi,20,31,9,5,12,5,3,0,65,9.285714285714286,2,0.0,19,9,5,12,12,5,0,3,0,45,20,1
916,19650,9Q3q5ak3WAEiXRLChbacNd3Hje0Wa6sd,fbPkOYLVPtPgIt0MxizjfFJov3JbHyAi,5,4,0,0,0,0,1,0,5,0.7142857142857143,1,0.0,0,0,0,0,4,0,0,1,0,0,5,1
917,19656,gsUbcjiJXGVEzC0HsE7H7oNZQUP3vN7h,fbPkOYLVPtPgIt0MxizjfFJov3JbHyAi,8,4,3,0,2,10,5,1,25,3.5714285714285716,1,0.0,0,3,0,2,4,10,0,5,1,5,20,1
918,19659,p8vHkfo5SI0V6B4KROfqrnRCgCCEpojM,fbPkOYLVPtPgIt0MxizjfFJov3JbHyAi,15,20,7,20,6,0,1,0,54,7.714285714285714,1,0.0,10,7,15,6,10,0,5,1,0,38,16,1
919,19671,m38kM2O7Y9dS9qRyh326gVCH42EwGlbN,fbPkOYLVPtPgIt0MxizjfFJov3JbHyAi,2,0,0,0,0,0,2,0,2,0.2857142857142857,1,0.0,0,0,0,0,0,0,0,2,0,0,2,1
920,19695,3SP9iNDvUt8m67ZMqC5DpQRe6ekkTpsP,fbPkOYLVPtPgIt0MxizjfFJov3JbHyAi,1,0,0,0,0,0,1,0,1,0.14285714285714285,1,0.0,0,0,0,0,0,0,0,1,0,0,1,0
921,19705,nbIGolByJC5FPssjDvcKL2vGL3vYMGAq,fbPkOYLVPtPgIt0MxizjfFJov3JbHyAi,47,91,42,38,30,11,20,1,233,33.285714285714285,3,0.0,29,42,33,30,62,11,5,20,1,134,99,0
922,19709,uMtCQ7Qbv3rm9GwFXfsL1kyH8D7nIalM,fbPkOYLVPtPgIt0MxizjfFJov3JbHyAi,7,14,1,0,1,0,2,0,18,2.5714285714285716,3,0.0,0,1,0,1,14,0,0,2,0,2,16,0
923,19714,uuyAyzBNPZJSqNkYTwX3ItAQ7Xcq5lqK,fbPkOYLVPtPgIt0MxizjfFJov3JbHyAi,25,27,15,14,10,3,4,0,73,10.428571428571429,2,0.0,9,15,12,10,18,3,2,4,0,46,27,1
924,19723,jWMVSdUkBIApMFEIB4X88BTUfxnffWAx,fbPkOYLVPtPgIt0MxizjfFJov3JbHyAi,5,3,2,0,1,0,1,0,7,1.0,1,0.0,0,2,0,1,3,0,0,1,0,3,4,1
925,19742,c2xUxg7vuhPItQZr96ojei2FNm4xg1X0,fbPkOYLVPtPgIt0MxizjfFJov3JbHyAi,4,4,3,0,0,0,1,0,8,1.1428571428571428,1,0.0,0,3,0,0,4,0,0,1,0,3,5,1
926,19748,P9CRp0z2n5HfPA3EY25pk86UB1hpP0VE,fbPkOYLVPtPgIt0MxizjfFJov3JbHyAi,1,0,0,0,0,0,1,0,1,0.14285714285714285,1,0.0,0,0,0,0,0,0,0,1,0,0,1,1
927,19767,GKKNtfrAHKD2xUEQBz7HLN3kKO9SrWyD,fbPkOYLVPtPgIt0MxizjfFJov3JbHyAi,4,2,1,0,0,1,3,0,7,1.0,1,0.0,0,1,0,0,2,1,0,3,0,1,6,1
928,19788,gfuRBmlPKlXNn3u69OCkIXEsqvf1vpRo,fbPkOYLVPtPgIt0MxizjfFJov3JbHyAi,8,5,4,0,2,0,1,0,12,1.7142857142857142,1,0.0,0,4,0,2,5,0,0,1,0,6,6,1
929,19803,DAe94MkHTdcPmdhTmwEa78RpI8unH7VU,fbPkOYLVPtPgIt0MxizjfFJov3JbHyAi,1,0,0,0,0,0,1,0,1,0.14285714285714285,1,0.0,0,0,0,0,0,0,0,1,0,0,1,1
930,19804,WRgbGIz2wotOKHxhxfqrZ7xS0r15aDGp,fbPkOYLVPtPgIt0MxizjfFJov3JbHyAi,10,4,4,0,4,0,6,0,18,2.5714285714285716,3,0.0,0,4,0,4,4,0,0,6,0,8,10,1
931,19806,mV6vIHBrgth3lTaajvzuqQeEfK5qY5yY,fbPkOYLVPtPgIt0MxizjfFJov3JbHyAi,12,15,9,0,7,0,13,0,44,6.285714285714286,2,0.0,2,9,0,7,13,0,0,13,0,18,26,1
932,19807,FkDqcRzVuKxo8KhYGAYk6Shrbs7IlfbL,fbPkOYLVPtPgIt0MxizjfFJov3JbHyAi,6,3,1,0,1,0,2,0,7,1.0,1,0.0,0,1,0,1,3,0,0,2,0,2,5,1
933,19809,pApGdDVXhze4S6UmutYTLmYS4Jr9ACYb,fbPkOYLVPtPgIt0MxizjfFJov3JbHyAi,20,37,0,0,1,1,13,0,52,7.428571428571429,3,0.0,0,0,0,1,37,1,0,13,0,1,51,1
934,19810,Gwx6NHIDtKbDhZ9qq0DoHrv95iBiEB1U,fbPkOYLVPtPgIt0MxizjfFJov3JbHyAi,2,0,0,0,0,0,2,0,2,0.2857142857142857,2,0.0,0,0,0,0,0,0,0,2,0,0,2,0
935,19814,lxHUxupmVUuN6U299GOAnBvW4C4Ubp0H,fbPkOYLVPtPgIt0MxizjfFJov3JbHyAi,15,20,9,0,6,0,4,0,39,5.571428571428571,2,0.0,0,9,0,6,20,0,0,4,0,15,24,1
936,19815,1NMKAl678ZBpdBkhXfYTAgEyYygMZz0x,fbPkOYLVPtPgIt0MxizjfFJov3JbHyAi,5,2,1,0,1,4,2,0,10,1.4285714285714286,1,0.0,0,1,0,1,2,4,0,2,0,2,8,1
937,19818,vjUSE4bgwDQC5HnxxZ5hkgXMs7C5kFpu,fbPkOYLVPtPgIt0MxizjfFJov3JbHyAi,8,8,6,0,1,0,9,2,26,3.7142857142857144,2,0.0,0,6,0,1,8,0,0,9,2,7,19,1
938,19819,Psc0x9bwTA2QigjfdORw9GCdjVkSZA2A,fbPkOYLVPtPgIt0MxizjfFJov3JbHyAi,7,7,0,0,2,14,5,1,29,4.142857142857143,1,0.0,4,0,0,2,3,14,0,5,1,6,23,1
939,19820,uUas23B5BASlNq70mr2W0D90rbZsDp9I,fbPkOYLVPtPgIt0MxizjfFJov3JbHyAi,1,0,0,0,0,0,3,0,3,0.42857142857142855,1,0.0,0,0,0,0,0,0,0,3,0,0,3,1
940,19821,zXwLjZ50Cji8fztc0B2bslPL9Qi2XHaI,fbPkOYLVPtPgIt0MxizjfFJov3JbHyAi,12,5,3,4,3,1,6,1,23,3.2857142857142856,1,0.0,1,3,3,3,4,1,1,6,1,10,13,1
941,19822,5MN7pHb9NYTV49RYHFa2nAB0siwac3Fy,fbPkOYLVPtPgIt0MxizjfFJov3JbHyAi,4,0,0,0,0,1,4,0,5,0.7142857142857143,1,0.0,0,0,0,0,0,1,0,4,0,0,5,1
942,19823,bUWcfbWQ4EJOw9u39LuSlWdeodW7fOna,fbPkOYLVPtPgIt0MxizjfFJov3JbHyAi,9,7,4,0,5,0,2,0,18,2.5714285714285716,1,0.0,2,4,0,5,5,0,0,2,0,11,7,1
943,19824,eNb7XRS8Q3wFtMfryy1D5nNWvhGj2o8v,fbPkOYLVPtPgIt0MxizjfFJov3JbHyAi,1,0,0,0,0,0,1,0,1,0.14285714285714285,1,0.0,0,0,0,0,0,0,0,1,0,0,1,1
944,19825,MXrTIwWI5paes908dD3STKMpnrGJOoNO,fbPkOYLVPtPgIt0MxizjfFJov3JbHyAi,12,18,6,4,6,0,4,3,41,5.857142857142857,2,0.0,8,6,3,6,10,0,1,4,3,23,18,1
945,19827,IKvqinkDWiPNKr8H3jp05XvxFjOVjhOj,fbPkOYLVPtPgIt0MxizjfFJov3JbHyAi,8,5,1,0,1,0,7,1,15,2.142857142857143,2,0.0,0,1,0,1,5,0,0,7,1,2,13,1
946,19828,35U2BNXuS9D65uTVA2fa3pi1wj26AmH8,fbPkOYLVPtPgIt0MxizjfFJov3JbHyAi,41,80,59,19,31,2,8,0,199,28.428571428571427,2,0.0,18,59,19,31,62,2,0,8,0,127,72,1
947,19829,XQUx3MwVudtjeHmsju8PhHxsdXW0kluK,fbPkOYLVPtPgIt0MxizjfFJov3JbHyAi,43,114,64,46,32,2,12,0,270,38.57142857142857,3,0.0,40,64,44,32,74,2,2,12,0,180,90,1
948,19833,HgGs6QavYmEoVlzJBRQZ1VM1JzFodPBe,fbPkOYLVPtPgIt0MxizjfFJov3JbHyAi,7,8,3,4,3,0,2,0,20,2.857142857142857,1,0.0,4,3,3,3,4,0,1,2,0,13,7,1
949,19834,uVhSYke06PCowTkKK0TnzYsz7ytxSXo0,fbPkOYLVPtPgIt0MxizjfFJov3JbHyAi,7,3,2,0,0,2,6,2,15,2.142857142857143,1,0.0,0,2,0,0,3,2,0,6,2,2,13,1
950,19836,Je1fglzWzz7Ubv1tp06pLOT4u9z98Ytt,fbPkOYLVPtPgIt0MxizjfFJov3JbHyAi,7,3,2,0,2,0,2,0,9,1.2857142857142858,1,0.0,0,2,0,2,3,0,0,2,0,4,5,1
951,19838,t0CXTWQ7WrgANKqIJnC4VUgKY5pjWYTr,fbPkOYLVPtPgIt0MxizjfFJov3JbHyAi,10,8,5,2,4,0,3,0,22,3.142857142857143,1,0.0,1,5,2,4,7,0,0,3,0,12,10,1
952,19840,cp0mDdUb6VxZ2pGbwlIxMgdC20NVEaQ4,fbPkOYLVPtPgIt0MxizjfFJov3JbHyAi,1,0,0,0,0,0,1,0,1,0.14285714285714285,1,0.0,0,0,0,0,0,0,0,1,0,0,1,1
953,19841,a9t5CEcjAfQWyvzEkAK92JIcTHveQuDM,fbPkOYLVPtPgIt0MxizjfFJov3JbHyAi,7,8,2,0,1,0,2,0,13,1.8571428571428572,1,0.0,0,2,0,1,8,0,0,2,0,3,10,1
954,19842,bKIU4h5S6pxVBBvQYicGGZljVmGThQTZ,fbPkOYLVPtPgIt0MxizjfFJov3JbHyAi,11,22,6,8,6,1,4,0,47,6.714285714285714,2,0.0,7,6,6,6,15,1,2,4,0,25,22,1
955,19843,T3QyKd9fTQnVL3QXwMXmpa9VWP9rOfpT,fbPkOYLVPtPgIt0MxizjfFJov3JbHyAi,5,2,1,0,1,0,2,0,6,0.8571428571428571,1,0.0,0,1,0,1,2,0,0,2,0,2,4,1
956,19844,TlJVvBC6ZZacGRqb7kuKo7HQvBARJCM4,fbPkOYLVPtPgIt0MxizjfFJov3JbHyAi,6,2,1,0,1,0,6,0,10,1.4285714285714286,1,0.0,0,1,0,1,2,0,0,6,0,2,8,1
957,19847,KRnn8XVP0dgmIdWOTGU35QhJLJDHduYk,fbPkOYLVPtPgIt0MxizjfFJov3JbHyAi,1,0,0,0,0,0,1,0,1,0.14285714285714285,1,0.0,0,0,0,0,0,0,0,1,0,0,1,1
958,19849,mvpXmdYDyNuTBu09E8ipnS5MHRHy94Z3,fbPkOYLVPtPgIt0MxizjfFJov3JbHyAi,1,0,0,0,0,0,1,0,1,0.14285714285714285,1,0.0,0,0,0,0,0,0,0,1,0,0,1,1
959,19850,UpdEFuakVIRY83Er2LIy9VWQWoA2gpIx,fbPkOYLVPtPgIt0MxizjfFJov3JbHyAi,6,2,1,0,1,0,3,1,8,1.1428571428571428,1,0.0,0,1,0,1,2,0,0,3,1,2,6,1
960,19851,9JKtUaJcAEBh7CYVmXIhRY2O1dODpq4M,fbPkOYLVPtPgIt0MxizjfFJov3JbHyAi,8,5,2,0,2,1,6,1,17,2.4285714285714284,1,0.0,0,2,0,2,5,1,0,6,1,4,13,1
961,19852,4qaBwsaC0pfXg0219Ny01dop8gTlFMu6,fbPkOYLVPtPgIt0MxizjfFJov3JbHyAi,8,4,3,0,2,0,2,0,11,1.5714285714285714,1,0.0,0,3,0,2,4,0,0,2,0,5,6,1
962,19853,yDFNgKY5UYQPIwh86Jl7JH0GU7drQgSP,fbPkOYLVPtPgIt0MxizjfFJov3JbHyAi,1,0,0,0,0,0,1,0,1,0.14285714285714285,1,0.0,0,0,0,0,0,0,0,1,0,0,1,1
963,19854,yEEPICUjqVU7brBN4wrh8xK8bTVFbXDy,fbPkOYLVPtPgIt0MxizjfFJov3JbHyAi,7,6,2,0,2,0,2,0,12,1.7142857142857142,1,0.0,0,2,0,2,6,0,0,2,0,4,8,1
964,19855,hr3tXA8jmCXsxdUFfi43JuiRTUpoDlMt,fbPkOYLVPtPgIt0MxizjfFJov3JbHyAi,3,2,0,0,0,1,1,0,4,0.5714285714285714,1,0.0,0,0,0,0,2,1,0,1,0,0,4,0
965,19857,oB66Su2y0fKCmlftIiys81THD7pT5Kwq,fbPkOYLVPtPgIt0MxizjfFJov3JbHyAi,4,2,1,0,0,0,2,0,5,0.7142857142857143,1,0.0,0,1,0,0,2,0,0,2,0,1,4,1
966,19859,xqYFyIT46SV7QvhQMGzYnnx9x1RIvm9K,fbPkOYLVPtPgIt0MxizjfFJov3JbHyAi,4,0,0,0,0,1,3,1,5,0.7142857142857143,1,0.0,0,0,0,0,0,1,0,3,1,0,5,1
967,19860,GFpBLlPKlIeg4yYkbxEh26IfN8cMuAmf,fbPkOYLVPtPgIt0MxizjfFJov3JbHyAi,8,5,2,0,3,0,6,0,16,2.2857142857142856,1,0.0,2,2,0,3,3,0,0,6,0,7,9,1
968,19861,kMADhIGduPqSkYFwoAlaAOq4Z3kg8su8,fbPkOYLVPtPgIt0MxizjfFJov3JbHyAi,11,24,16,0,10,1,8,0,59,8.428571428571429,3,0.0,0,16,0,10,24,1,0,8,0,26,33,0
969,19866,BOBLP6pTmRtpQ8LtVgJyutFMDL3q6xno,fbPkOYLVPtPgIt0MxizjfFJov3JbHyAi,12,14,9,5,5,4,1,0,38,5.428571428571429,4,0.0,2,9,4,5,12,4,1,1,0,20,18,0
970,19867,SxX5znCjYpr86kkQyrVn3BfwaCzWOPGc,fbPkOYLVPtPgIt0MxizjfFJov3JbHyAi,1,0,0,0,0,0,1,0,1,0.14285714285714285,1,0.0,0,0,0,0,0,0,0,1,0,0,1,1
971,19868,IW1rPvW2Bte4OLapfIZWsk9LSVWmKs26,fbPkOYLVPtPgIt0MxizjfFJov3JbHyAi,9,12,8,0,5,2,6,0,33,4.714285714285714,1,0.0,0,8,0,5,12,2,0,6,0,13,20,1
972,19869,jUJD4zc1LqwiHBuYXxVgX9j6xi6RKWgV,fbPkOYLVPtPgIt0MxizjfFJov3JbHyAi,23,14,9,0,8,7,8,1,47,6.714285714285714,2,0.0,2,9,0,8,12,7,0,8,1,19,28,1
973,19870,ynbQlisqFiyBzv22bYVgrb1CTn5JfjMW,fbPkOYLVPtPgIt0MxizjfFJov3JbHyAi,7,3,2,0,2,0,2,0,9,1.2857142857142858,1,0.0,0,2,0,2,3,0,0,2,0,4,5,1
974,19871,vuIldWG0zIZiagbsArdWgNONid3wMi26,fbPkOYLVPtPgIt0MxizjfFJov3JbHyAi,16,18,0,0,0,0,14,2,34,4.857142857142857,2,0.0,0,0,0,0,18,0,0,14,2,0,34,0
975,19872,foOeNx7QB7iDsgeA0D657sokODh0QEAw,fbPkOYLVPtPgIt0MxizjfFJov3JbHyAi,7,6,1,3,2,0,1,0,13,1.8571428571428572,1,0.0,2,1,2,2,4,0,1,1,0,7,6,1
976,19873,gVvL6RmTRBe8pjHtydeg9sOn3yGJFctB,fbPkOYLVPtPgIt0MxizjfFJov3JbHyAi,6,1,0,0,0,2,4,1,8,1.1428571428571428,1,0.0,0,0,0,0,1,2,0,4,1,0,8,1
977,19874,FJnM8KTgJkJ4RTmU7j0GlObcSBlrkSGR,fbPkOYLVPtPgIt0MxizjfFJov3JbHyAi,7,3,2,0,2,0,2,0,9,1.2857142857142858,1,0.0,0,2,0,2,3,0,0,2,0,4,5,1
978,19875,YCFIP2rd7N9mtFDuRY6Eqqkecqrs4vTb,fbPkOYLVPtPgIt0MxizjfFJov3JbHyAi,7,6,3,0,1,9,4,1,24,3.4285714285714284,1,0.0,0,3,0,1,6,9,0,4,1,4,20,1
979,19876,ig6krYSkue3MO5KtEMkAXakLUYviTHgU,fbPkOYLVPtPgIt0MxizjfFJov3JbHyAi,5,7,0,0,0,0,5,0,12,1.7142857142857142,1,0.0,0,0,0,0,7,0,0,5,0,0,12,1
980,19877,9OvnGSufsqgkF0zk0lt4wMrdl04PgMkr,fbPkOYLVPtPgIt0MxizjfFJov3JbHyAi,1,0,0,0,0,0,1,0,1,0.14285714285714285,1,0.0,0,0,0,0,0,0,0,1,0,0,1,1
981,19879,1foSXZwCCr5lR9Aws6pCnQ1ZUbu5TIHp,fbPkOYLVPtPgIt0MxizjfFJov3JbHyAi,5,5,3,0,1,0,1,0,10,1.4285714285714286,1,0.0,0,3,0,1,5,0,0,1,0,4,6,0
982,19884,NqKjMSY6eOZQ1uSyzlPrquJVqzjvSO7O,fbPkOYLVPtPgIt0MxizjfFJov3JbHyAi,14,11,6,8,4,0,3,0,32,4.571428571428571,2,0.0,3,6,6,4,8,0,2,3,0,19,13,1
983,19885,A6nWdlGih5qGNSA7X8sCBpQ5KoSeu0HC,fbPkOYLVPtPgIt0MxizjfFJov3JbHyAi,2,0,0,0,0,0,3,0,3,0.42857142857142855,2,0.0,0,0,0,0,0,0,0,3,0,0,3,1
984,19886,ovFlS72dfchdekZxDK8eGHjXjC0Q6ofX,fbPkOYLVPtPgIt0MxizjfFJov3JbHyAi,8,16,8,0,3,0,3,0,30,4.285714285714286,2,0.0,0,8,0,3,16,0,0,3,0,11,19,1
985,19887,VleZx6AMrGRAMIGS9OzdztH8msuxEpLN,fbPkOYLVPtPgIt0MxizjfFJov3JbHyAi,1,0,0,0,0,0,1,0,1,0.14285714285714285,1,0.0,0,0,0,0,0,0,0,1,0,0,1,1
986,19888,dgZyMqZ7S2zEOAUOkBV4Iw21KUChsDnG,fbPkOYLVPtPgIt0MxizjfFJov3JbHyAi,1,0,0,0,0,0,1,0,1,0.14285714285714285,1,0.0,0,0,0,0,0,0,0,1,0,0,1,1
987,19889,esagsd88OzgcWVyUBv4e4lrejs4sAfDh,fbPkOYLVPtPgIt0MxizjfFJov3JbHyAi,4,3,0,0,0,0,3,0,6,0.8571428571428571,1,0.0,0,0,0,0,3,0,0,3,0,0,6,0
988,19893,NAeglY8cYFpzQKpSfjAgfrtdD2qzmpB5,fbPkOYLVPtPgIt0MxizjfFJov3JbHyAi,13,26,10,0,3,8,10,0,57,8.142857142857142,5,0.0,0,10,0,3,26,8,0,10,0,13,44,0
989,19894,csHCA49GIFIMIMhddtJXr13v0W45c2zX,fbPkOYLVPtPgIt0MxizjfFJov3JbHyAi,5,2,1,0,1,0,2,0,6,0.8571428571428571,1,0.0,0,1,0,1,2,0,0,2,0,2,4,1
990,19895,DNuzfFZaKzq1rWcHLzrBtPkDL7hdOTyB,fbPkOYLVPtPgIt0MxizjfFJov3JbHyAi,9,16,8,4,8,0,7,0,43,6.142857142857143,2,0.0,6,8,3,8,10,0,1,7,0,25,18,1
991,19896,XPjAO3f97ZJcCpAApqMVf8ngBFZ3HzQd,fbPkOYLVPtPgIt0MxizjfFJov3JbHyAi,3,2,0,0,0,0,1,0,3,0.42857142857142855,1,0.0,0,0,0,0,2,0,0,1,0,0,3,1
992,19897,xdXdQD6d3ouQxPFQHtUqoRivYIjaf4BI,fbPkOYLVPtPgIt0MxizjfFJov3JbHyAi,10,9,3,0,2,15,12,3,44,6.285714285714286,2,0.0,0,3,0,2,9,15,0,12,3,5,39,1
993,19898,Ng1jToRjDK8omnYgabDdTz8XK2pnHjqz,fbPkOYLVPtPgIt0MxizjfFJov3JbHyAi,7,6,2,0,1,0,3,0,12,1.7142857142857142,1,0.0,0,2,0,1,6,0,0,3,0,3,9,1
994,19903,yUSW5IznwhnzD0ElBVHBvUlhh23ZO3ve,fbPkOYLVPtPgIt0MxizjfFJov3JbHyAi,5,2,1,0,1,0,2,0,6,0.8571428571428571,1,0.0,0,1,0,1,2,0,0,2,0,2,4,1
995,19905,3GUwU7gGfH9QSI4jt2ezx9kun1vMueYz,fbPkOYLVPtPgIt0MxizjfFJov3JbHyAi,7,3,1,0,1,1,4,1,11,1.5714285714285714,1,0.0,0,1,0,1,3,1,0,4,1,2,9,1
996,19906,0CXKn1HfInqkCvrX7MeQPFZQO5dZ0oCE,fbPkOYLVPtPgIt0MxizjfFJov3JbHyAi,9,6,5,0,5,0,2,0,18,2.5714285714285716,1,0.0,0,5,0,5,6,0,0,2,0,10,8,1
997,19907,vDr9SspvKA7PR8FwpNzXdQMEFONy3TNW,fbPkOYLVPtPgIt0MxizjfFJov3JbHyAi,1,0,0,0,0,0,1,0,1,0.14285714285714285,1,0.0,0,0,0,0,0,0,0,1,0,0,1,1
998,19908,sxJROJWWpXBhtZ5cBce4vLa62HcIMLBD,fbPkOYLVPtPgIt0MxizjfFJov3JbHyAi,5,3,2,0,2,0,2,0,9,1.2857142857142858,1,0.0,0,2,0,2,3,0,0,2,0,4,5,1
999,19912,pvxjw4szSuluDWQ3DWPes9Mzs1MCvxjI,fbPkOYLVPtPgIt0MxizjfFJov3JbHyAi,9,7,4,0,2,1,4,1,19,2.7142857142857144,1,0.0,0,4,0,2,7,1,0,4,1,6,13,1
1000,19916,AhEZQvNIIn2lXBelWns2lgtmj9ZMEiO6,fbPkOYLVPtPgIt0MxizjfFJov3JbHyAi,1,0,0,0,0,0,1,0,1,0.14285714285714285,1,0.0,0,0,0,0,0,0,0,1,0,0,1,1
1001,19917,HwGdYA9FLmZeF9QWVKJTGzkq5gZ7zUGa,fbPkOYLVPtPgIt0MxizjfFJov3JbHyAi,6,3,2,0,2,0,1,0,8,1.1428571428571428,1,0.0,0,2,0,2,3,0,0,1,0,4,4,1
1002,19918,xZymr065e4jMs1k7FdN1s1dPRCmzgAiD,fbPkOYLVPtPgIt0MxizjfFJov3JbHyAi,1,0,0,0,0,0,1,0,1,0.14285714285714285,1,0.0,0,0,0,0,0,0,0,1,0,0,1,1
1003,19920,VfXq2XzbXkkKi937rrheKnFTqIJJNxri,fbPkOYLVPtPgIt0MxizjfFJov3JbHyAi,1,0,0,0,0,0,2,0,2,0.2857142857142857,1,0.0,0,0,0,0,0,0,0,2,0,0,2,1
1004,19926,1InE8cdjhx7tJRBfUjLOpNXVGiOXTrtd,fbPkOYLVPtPgIt0MxizjfFJov3JbHyAi,11,22,15,0,3,35,12,1,88,12.571428571428571,2,0.0,0,15,0,3,22,35,0,12,1,18,70,1
1005,19928,97ov4fTuLcUGM3NRcbowYBsVQSUEYP2S,fbPkOYLVPtPgIt0MxizjfFJov3JbHyAi,1,0,0,0,0,0,1,0,1,0.14285714285714285,1,0.0,0,0,0,0,0,0,0,1,0,0,1,1
1006,19932,G2qWD1bGIYovTM2Y7RxiPiKf92aFGc9X,fbPkOYLVPtPgIt0MxizjfFJov3JbHyAi,27,36,19,16,14,36,12,0,133,19.0,1,0.0,13,19,14,14,23,36,2,12,0,60,73,1
1007,19933,wnXrCFQnu5K77E0TUKHPXLbEZiXu32Gt,fbPkOYLVPtPgIt0MxizjfFJov3JbHyAi,36,41,27,33,21,0,3,0,125,17.857142857142858,1,0.0,11,27,30,21,30,0,3,3,0,89,36,1
1008,19934,GyWTABuPpZEqO585EnNTIpM2B2faPYN3,fbPkOYLVPtPgIt0MxizjfFJov3JbHyAi,5,3,2,0,1,0,1,0,7,1.0,1,0.0,0,2,0,1,3,0,0,1,0,3,4,1
1009,19935,wEajQeQse5CzhcFd5XXOtEsUUddZZAU5,fbPkOYLVPtPgIt0MxizjfFJov3JbHyAi,15,29,10,13,11,1,8,1,73,10.428571428571429,1,0.0,16,10,10,11,13,1,3,8,1,47,26,0
1010,19936,viuKt4GgrX0rYL5EpHoxJbsiC9TblSuk,fbPkOYLVPtPgIt0MxizjfFJov3JbHyAi,5,3,2,0,0,0,3,0,8,1.1428571428571428,3,0.0,0,2,0,0,3,0,0,3,0,2,6,0
1011,19937,TW2XIE8RVUXEKU7cj0LXiqnV9PpOeW5X,fbPkOYLVPtPgIt0MxizjfFJov3JbHyAi,9,5,4,0,3,0,3,0,15,2.142857142857143,1,0.0,0,4,0,3,5,0,0,3,0,7,8,1
1012,19938,33YJhO56Hz6X3YkBaXAE8jLXj3hGQz0E,fbPkOYLVPtPgIt0MxizjfFJov3JbHyAi,12,12,7,4,4,0,5,0,32,4.571428571428571,3,0.0,2,7,3,4,10,0,1,5,0,16,16,1
1013,19939,7uDVcwukNss0paMtTOJXNPZUXWP9vYuG,fbPkOYLVPtPgIt0MxizjfFJov3JbHyAi,4,2,1,0,1,0,1,0,5,0.7142857142857143,1,0.0,0,1,0,1,2,0,0,1,0,2,3,1
1014,19940,eeYj7ooXMmKNnXyjLGvyz7RVwRLoScYs,fbPkOYLVPtPgIt0MxizjfFJov3JbHyAi,7,3,2,0,2,0,2,0,9,1.2857142857142858,1,0.0,0,2,0,2,3,0,0,2,0,4,5,1
1015,19941,a7hY9wWK5IElJ1dZWTInS8ONEoRm1ika,fbPkOYLVPtPgIt0MxizjfFJov3JbHyAi,4,2,0,0,0,0,3,0,5,0.7142857142857143,2,0.0,0,0,0,0,2,0,0,3,0,0,5,1
1016,19942,je9A6l6tP7wnbFhNJD7vbbHTYhqshuqB,fbPkOYLVPtPgIt0MxizjfFJov3JbHyAi,6,3,0,0,0,1,4,1,9,1.2857142857142858,2,0.0,0,0,0,0,3,1,0,4,1,0,9,1
1017,19943,yS4oyG8z71VcMw1yy9w2LWRiDWgGhtKA,fbPkOYLVPtPgIt0MxizjfFJov3JbHyAi,1,0,0,0,0,0,1,0,1,0.14285714285714285,1,0.0,0,0,0,0,0,0,0,1,0,0,1,1
1018,19947,ZkhJUa8EJMEosRkUx3uFogoZkW9dBDLF,fbPkOYLVPtPgIt0MxizjfFJov3JbHyAi,5,2,1,0,1,0,2,0,6,0.8571428571428571,1,0.0,0,1,0,1,2,0,0,2,0,2,4,1
1019,19948,yvyZaz4xAz9F6HZ98hADpdZbO8B3aQLI,fbPkOYLVPtPgIt0MxizjfFJov3JbHyAi,4,2,0,0,0,0,3,0,5,0.7142857142857143,1,0.0,0,0,0,0,2,0,0,3,0,0,5,1
1020,19949,lulY8D00ct0beDGYE4CRU9KsINnQRaV8,fbPkOYLVPtPgIt0MxizjfFJov3JbHyAi,10,17,8,0,5,1,8,1,40,5.714285714285714,2,0.0,2,8,0,5,15,1,0,8,1,15,25,0
1021,19951,rPw77eL90jbIeSFJYyvVIXe9A8wT4cw5,fbPkOYLVPtPgIt0MxizjfFJov3JbHyAi,5,2,1,0,1,3,3,0,10,1.4285714285714286,1,0.0,0,1,0,1,2,3,0,3,0,2,8,1
1022,19953,7rTP5bps09htLBiewU1OlHyTn48UEKTD,fbPkOYLVPtPgIt0MxizjfFJov3JbHyAi,4,2,1,0,1,0,1,0,5,0.7142857142857143,1,0.0,0,1,0,1,2,0,0,1,0,2,3,1
1023,19955,Y7REnesylqzkGeCcXJqxiJ4B25LlDJnj,fbPkOYLVPtPgIt0MxizjfFJov3JbHyAi,8,4,3,0,2,0,2,0,11,1.5714285714285714,1,0.0,0,3,0,2,4,0,0,2,0,5,6,1
1024,19956,MelNG8TL1wwoBfj4YB6xJw5vokLsJ0c9,fbPkOYLVPtPgIt0MxizjfFJov3JbHyAi,1,0,0,0,0,0,1,0,1,0.14285714285714285,1,0.0,0,0,0,0,0,0,0,1,0,0,1,1
1025,21459,NH0hsgo5xcqAdosarQoW4RQUZxH32Gzl,7GRhBDsirIGkRZBtSMEzNTyDr2JQm4xx,26,77,31,10,24,7,6,0,155,22.142857142857142,4,0.0,27,31,9,24,50,7,1,6,0,91,64,0
1026,21468,Hj6wuu6IJzCenxWAs1sLyWNMm32YIpDq,7GRhBDsirIGkRZBtSMEzNTyDr2JQm4xx,32,115,45,89,21,28,12,0,310,44.285714285714285,6,0.0,37,45,81,21,78,28,8,12,0,184,126,0
1027,21473,fd2e5NJVnyVwHFHuiTOOM639ZY1uThtn,7GRhBDsirIGkRZBtSMEzNTyDr2JQm4xx,17,41,19,40,1,66,7,0,174,24.857142857142858,5,0.0,10,19,34,1,31,66,6,7,0,64,110,1
1028,21485,l3mz2aAslwaCLhkdMrM7sQ5OXLzl6A2r,7GRhBDsirIGkRZBtSMEzNTyDr2JQm4xx,16,33,1,16,8,5,1,0,64,9.142857142857142,1,0.0,19,1,13,8,14,5,3,1,0,41,23,0
1029,21487,ppwn795jM3X8HLmfBGWlJ1RCSK9HLpNe,7GRhBDsirIGkRZBtSMEzNTyDr2JQm4xx,5,3,2,0,1,0,1,0,7,1.0,1,0.0,0,2,0,1,3,0,0,1,0,3,4,0
1030,21496,z6p7uYa25VIrmVARFxz5koBofuqHB2cM,7GRhBDsirIGkRZBtSMEzNTyDr2JQm4xx,72,102,35,94,29,3,9,0,272,38.857142857142854,3,0.0,60,35,82,29,42,3,12,9,0,206,66,0
1031,21497,NToJOpRtq67cszdyzl1RlLKqGwS5lZl5,7GRhBDsirIGkRZBtSMEzNTyDr2JQm4xx,21,21,11,20,6,0,2,0,60,8.571428571428571,2,0.0,8,11,17,6,13,0,3,2,0,42,18,1
1032,21514,ZhTCqX8GMUcn0a0betuEauHNuCk1aRhm,7GRhBDsirIGkRZBtSMEzNTyDr2JQm4xx,30,34,17,26,7,39,7,0,130,18.571428571428573,2,0.0,9,17,25,7,25,39,1,7,0,58,72,0
1033,21524,6Ysh3EXeoiNCd1uXxsjEQronkryNKRU5,7GRhBDsirIGkRZBtSMEzNTyDr2JQm4xx,17,52,12,16,13,2,4,0,99,14.142857142857142,3,0.0,36,12,14,13,16,2,2,4,0,75,24,1
1034,21529,Lf0mThPYOrtlCzgRGBCVTPy1hiGUII8h,7GRhBDsirIGkRZBtSMEzNTyDr2JQm4xx,10,12,7,0,0,1,7,0,27,3.857142857142857,2,0.0,0,7,0,0,12,1,0,7,0,7,20,0
1035,21531,GvY4Z1NOjK4oYpeBStbrl7zpe2zlFqoT,7GRhBDsirIGkRZBtSMEzNTyDr2JQm4xx,29,59,20,95,10,1,4,0,189,27.0,3,0.0,31,20,82,10,28,1,13,4,0,143,46,0
1036,21537,ofcigTTYbE1oojdrdB7FR2yHe6nxdUzR,7GRhBDsirIGkRZBtSMEzNTyDr2JQm4xx,66,101,31,42,57,2,8,0,241,34.42857142857143,5,0.0,68,31,36,57,33,2,6,8,0,192,49,0
1037,21545,be7952wawx5BhhJ4vIqX6Vxi48lNKbM1,7GRhBDsirIGkRZBtSMEzNTyDr2JQm4xx,3,1,1,0,1,0,0,0,3,0.42857142857142855,1,0.0,0,1,0,1,1,0,0,0,0,2,1,1
1038,21558,dQBjOw3ZDQ2EPHOdT4W6pRAoF6sniGIc,7GRhBDsirIGkRZBtSMEzNTyDr2JQm4xx,4,2,2,0,1,0,0,0,5,0.7142857142857143,1,0.0,0,2,0,1,2,0,0,0,0,3,2,1
1039,21561,OaI9ma7KxaY6DFxSwgYhrXCPXva2T3pp,7GRhBDsirIGkRZBtSMEzNTyDr2JQm4xx,66,148,57,132,33,9,21,0,400,57.142857142857146,6,0.0,62,57,110,33,86,9,22,21,0,262,138,0
1040,21564,w1NKmDhRc1aeBgZmDEyDguSkZ23SdrlX,7GRhBDsirIGkRZBtSMEzNTyDr2JQm4xx,14,9,4,4,3,0,7,0,27,3.857142857142857,1,0.0,2,4,3,3,7,0,1,7,0,12,15,1
1041,21570,y9BxmAhm0ieCF6b0HaF7gMrGu5BDtZs5,7GRhBDsirIGkRZBtSMEzNTyDr2JQm4xx,59,148,53,168,53,11,20,0,453,64.71428571428571,4,0.0,78,53,136,53,70,11,32,20,0,320,133,0
1042,21618,TzODuX5kuf2iqGNG9vk0uMzeGNqx5LsA,7GRhBDsirIGkRZBtSMEzNTyDr2JQm4xx,39,140,9,47,8,0,21,2,227,32.42857142857143,2,0.0,55,9,31,8,85,0,16,21,2,103,124,0
1043,21638,mwc0YjZS72xD4dO6Zk7KmFewdh7PWkAS,7GRhBDsirIGkRZBtSMEzNTyDr2JQm4xx,23,30,13,0,15,0,4,0,62,8.857142857142858,2,0.0,13,13,0,15,17,0,0,4,0,41,21,0
1044,21640,yf6f57VN5vQ3uXtZoopqYTtboGpfts8e,7GRhBDsirIGkRZBtSMEzNTyDr2JQm4xx,27,18,7,28,5,0,3,0,61,8.714285714285714,1,0.0,8,7,25,5,10,0,3,3,0,45,16,0
1045,21659,D5mwgoAPtfwdsFrdNADBqEJQSy8E0CUi,7GRhBDsirIGkRZBtSMEzNTyDr2JQm4xx,41,51,24,34,22,0,12,0,143,20.428571428571427,2,0.0,19,24,29,22,32,0,5,12,0,94,49,0
1046,21672,c9jABEJQla4i8vH29nKPFM4cx5bWdrLS,7GRhBDsirIGkRZBtSMEzNTyDr2JQm4xx,87,251,114,83,93,7,17,1,566,80.85714285714286,5,0.0,118,114,79,93,133,7,4,17,1,404,162,0
1047,21690,mezQjcBtwPIB1SXkjHJo9kxjc5UIXdOH,7GRhBDsirIGkRZBtSMEzNTyDr2JQm4xx,89,161,59,145,51,14,20,0,450,64.28571428571429,5,0.0,82,59,115,51,79,14,30,20,0,307,143,1
1048,21708,aU6SEeOgxLKetBRDwfHMDunWavvfr54M,7GRhBDsirIGkRZBtSMEzNTyDr2JQm4xx,18,46,16,15,23,13,7,0,120,17.142857142857142,3,0.0,21,16,14,23,25,13,1,7,0,74,46,0
1049,21870,3OGm4X1PEnAaZoBoZXt04kXOR4TFtoHS,7GRhBDsirIGkRZBtSMEzNTyDr2JQm4xx,31,65,26,47,34,0,14,0,186,26.571428571428573,5,0.0,36,26,40,34,29,0,7,14,0,136,50,1
1050,21900,LRwPaW9GtyhH2VMWEMsABaY8IaWh4rBR,7GRhBDsirIGkRZBtSMEzNTyDr2JQm4xx,100,105,28,171,43,21,9,1,378,54.0,2,0.0,72,28,132,43,33,21,39,9,1,275,103,1
1051,21922,UyrB62TC80PvjIx5mHAqyBQJHo9hnImU,7GRhBDsirIGkRZBtSMEzNTyDr2JQm4xx,6,3,2,0,2,0,1,0,8,1.1428571428571428,1,0.0,0,2,0,2,3,0,0,1,0,4,4,1
1052,21976,MYCZGZUUB6h2kR5SWwXC3erQhe8wj439,7GRhBDsirIGkRZBtSMEzNTyDr2JQm4xx,33,49,11,43,11,13,14,0,141,20.142857142857142,2,0.0,34,11,42,11,15,13,1,14,0,98,43,0
1053,21999,r6bvKJ2a2G72TbQZE3LacWwmKi7rGXEx,7GRhBDsirIGkRZBtSMEzNTyDr2JQm4xx,13,35,11,8,9,0,1,0,64,9.142857142857142,1,0.0,7,11,7,9,28,0,1,1,0,34,30,1
1054,22062,MuwljKZkWjKmChDtxaHsKSqu30ykavpg,7GRhBDsirIGkRZBtSMEzNTyDr2JQm4xx,4,6,2,0,0,0,1,0,9,1.2857142857142858,1,0.0,3,2,0,0,3,0,0,1,0,5,4,0
1055,22212,ezzV2inIlk654APZ7lOJdt6ubCpUxMCa,7GRhBDsirIGkRZBtSMEzNTyDr2JQm4xx,20,41,2,10,3,41,8,1,106,15.142857142857142,4,0.0,13,2,9,3,28,41,1,8,1,27,79,0
1056,22268,tixL6jRbFRYTnAeCUMfXKIdV2z5MfmCZ,7GRhBDsirIGkRZBtSMEzNTyDr2JQm4xx,10,14,13,0,8,0,2,0,37,5.285714285714286,2,0.0,0,13,0,8,14,0,0,2,0,21,16,1
1057,22640,SXQudUQxotVyHX3jIj58IdonMUWj4z4L,RXDvfPUBYFlVdlueBFbLW0mhhAyGEqpt,57,132,70,114,15,1,26,0,358,51.142857142857146,3,0.0,36,70,112,15,96,1,2,26,0,233,125,0
1058,22647,ytmo5vQStkDdkr7G8Cx66kM5tANiVYa8,G8EPVSXsOYB5YQWZGiz1aVq5Pgr2GrQu,45,36,34,66,13,0,3,1,153,21.857142857142858,1,0.0,1,34,48,13,35,0,18,3,1,96,57,1
1059,22651,bPMM8JJVMbo3dHwzrkYwNanOXVlVjIZM,SpATywNh6bZuzm8s1ceuBUnMUAeoAHHw,20,31,15,18,12,4,1,0,81,11.571428571428571,4,0.0,15,15,15,12,16,4,3,1,0,57,24,0
1060,22656,6r68uLeYBa0U5j97XGrLINpoFwwpiU0a,SpATywNh6bZuzm8s1ceuBUnMUAeoAHHw,9,13,2,0,0,0,6,4,25,3.5714285714285716,2,0.0,3,2,0,0,10,0,0,6,4,5,20,0
1061,22661,zgbCsvFYb3b53axsu4K7VNjBEGD1Bru2,G8EPVSXsOYB5YQWZGiz1aVq5Pgr2GrQu,8,9,2,1,2,0,2,0,16,2.2857142857142856,2,0.0,1,2,1,2,8,0,0,2,0,6,10,1
1062,22666,8NZmD5KXyLIfbrDZRanIJvBfumgIsUhW,SpATywNh6bZuzm8s1ceuBUnMUAeoAHHw,11,21,9,8,0,0,3,0,41,5.857142857142857,2,0.0,8,9,8,0,13,0,0,3,0,25,16,0
1063,22672,xtQFPkqe4Pp8hbaCpifaLA8aJ90k2oDs,SpATywNh6bZuzm8s1ceuBUnMUAeoAHHw,2,1,1,0,0,0,0,0,2,0.2857142857142857,1,0.0,0,1,0,0,1,0,0,0,0,1,1,0
1064,22675,FZWt1vapJFvo3kXFvlr3Pcq5dqSsXIdl,A3fsA9Zfv1X2fVEQhTw51lKENdNrEqT3,5,3,2,0,1,0,2,0,8,1.1428571428571428,1,0.0,0,2,0,1,3,0,0,2,0,3,5,1
1065,22688,6aazLDsf7EAZ2t5BIjBNI9Ug5zAk9J2O,SpATywNh6bZuzm8s1ceuBUnMUAeoAHHw,3,2,1,0,0,0,2,0,5,0.7142857142857143,2,0.0,0,1,0,0,2,0,0,2,0,1,4,0
1066,22699,f7tZxTkA0B7yOxMWeydGO2hW0y86mAhD,A3fsA9Zfv1X2fVEQhTw51lKENdNrEqT3,3,4,2,0,0,0,2,0,8,1.1428571428571428,2,0.0,0,2,0,0,4,0,0,2,0,2,6,0
1067,22711,TPPsOieQBcwqH8dqABTR3mddQ5gDzlZO,SpATywNh6bZuzm8s1ceuBUnMUAeoAHHw,3,2,1,0,0,0,3,0,6,0.8571428571428571,2,0.0,0,1,0,0,2,0,0,3,0,1,5,0
1068,22720,4iz2t15J5bzEPElZVcStT3H8hpTNKJIQ,SpATywNh6bZuzm8s1ceuBUnMUAeoAHHw,6,4,2,4,0,0,1,0,11,1.5714285714285714,1,0.0,0,2,3,0,4,0,1,1,0,5,6,0
1069,22733,IQ4ladQoM2x2909mlbY9xWKwXIcK6uEd,A3fsA9Zfv1X2fVEQhTw51lKENdNrEqT3,5,1,1,0,1,0,2,0,5,0.7142857142857143,1,0.0,0,1,0,1,1,0,0,2,0,2,3,0
1070,22760,xQ0oPcnoBqnptb23qNnWO05KL2jCqFC5,SpATywNh6bZuzm8s1ceuBUnMUAeoAHHw,6,23,9,0,0,0,4,0,36,5.142857142857143,3,0.0,8,9,0,0,15,0,0,4,0,17,19,1
1071,22796,NEe9TsP56Xype0U6CLfwX8CaejtfAtDd,SpATywNh6bZuzm8s1ceuBUnMUAeoAHHw,14,34,6,22,1,0,12,0,75,10.714285714285714,3,0.0,7,6,18,1,27,0,4,12,0,32,43,0
1072,22825,pgtfwPx3gBWk0s41FLIY8xNKvQvpnNYF,SpATywNh6bZuzm8s1ceuBUnMUAeoAHHw,3,1,1,0,1,0,0,0,3,0.42857142857142855,1,0.0,0,1,0,1,1,0,0,0,0,2,1,0
1073,22847,uKSoXEJNhPBaLwogtj5AI2INbh67Hhkx,G8EPVSXsOYB5YQWZGiz1aVq5Pgr2GrQu,4,3,0,0,0,0,1,0,4,0.5714285714285714,1,0.0,0,0,0,0,3,0,0,1,0,0,4,1
1074,22849,Wd5Y51TL4njlLeYHUjz5D9nrsHvDXUZ8,A3fsA9Zfv1X2fVEQhTw51lKENdNrEqT3,26,22,12,62,1,0,9,0,106,15.142857142857142,5,0.0,1,12,56,1,21,0,6,9,0,70,36,0
1075,22855,4J9zAQq4ZlZzXgNIT2zhfBx7kGs24C6D,SpATywNh6bZuzm8s1ceuBUnMUAeoAHHw,4,4,2,0,0,0,6,0,12,1.7142857142857142,3,0.0,0,2,0,0,4,0,0,6,0,2,10,0
1076,22867,ec87BaRQsrP5IAuQEXYeAFWoVPURyRtj,SpATywNh6bZuzm8s1ceuBUnMUAeoAHHw,1,0,0,0,0,0,1,0,1,0.14285714285714285,1,0.0,0,0,0,0,0,0,0,1,0,0,1,0
1077,22882,53VGMeycKD8ekdZB7srikqwK1dcTbnwu,bWdj2GDclj5ofokWjzoa5jAwMkxCykd6,1,0,0,0,0,0,1,0,1,0.14285714285714285,1,0.0,0,0,0,0,0,0,0,1,0,0,1,1
1078,22891,tnLfm9tutF6YoqDXNIONCmii1aynBy80,SpATywNh6bZuzm8s1ceuBUnMUAeoAHHw,6,8,5,2,0,0,5,0,20,2.857142857142857,3,0.0,0,5,1,0,8,0,1,5,0,6,14,0
1079,22896,kwtDMW6kCF4Dj4cVANDmT2RtqpyiMQZT,A3fsA9Zfv1X2fVEQhTw51lKENdNrEqT3,37,56,18,78,11,0,21,0,184,26.285714285714285,5,0.0,1,18,69,11,55,0,9,21,0,99,85,0
1080,22916,dLoTMfurIDgppPqjn68MhR8oLIGjxbCC,A3fsA9Zfv1X2fVEQhTw51lKENdNrEqT3,5,6,3,0,0,0,3,0,12,1.7142857142857142,1,0.0,0,3,0,0,6,0,0,3,0,3,9,1
1081,22962,M6VmJD8JYDR5w6GV5uzAgWpIXM5eanml,G8EPVSXsOYB5YQWZGiz1aVq5Pgr2GrQu,40,75,38,51,16,2,9,0,191,27.285714285714285,3,0.0,5,38,46,16,70,2,5,9,0,105,86,0
1082,22970,dT92IjRcuruPiAlpqVUTtu3wNL9IIegT,bWdj2GDclj5ofokWjzoa5jAwMkxCykd6,16,17,6,8,3,37,5,0,76,10.857142857142858,2,0.0,1,6,6,3,16,37,2,5,0,16,60,1
1083,22988,mYyzW7j4oHjgvbS0hfWvmpiecRMbZDgq,SpATywNh6bZuzm8s1ceuBUnMUAeoAHHw,5,5,3,0,0,0,1,0,9,1.2857142857142858,1,0.0,1,3,0,0,4,0,0,1,0,4,5,1
1084,22993,WaZjCMCq9zHT0tGjpLu6Y2rc6ox0JLNd,A3fsA9Zfv1X2fVEQhTw51lKENdNrEqT3,28,9,5,86,3,0,1,0,104,14.857142857142858,1,0.0,3,5,67,3,6,0,19,1,0,78,26,1
1085,22996,W9f8UmYzSEsFhECsZDg6FwyOA22yb0R3,SpATywNh6bZuzm8s1ceuBUnMUAeoAHHw,5,5,2,0,0,5,7,0,19,2.7142857142857144,2,0.0,0,2,0,0,5,5,0,7,0,2,17,0
1086,23006,UInMBEH8f1h2vxXVslRsWyLOTv8ggYq3,A3fsA9Zfv1X2fVEQhTw51lKENdNrEqT3,15,21,9,0,5,1,4,0,40,5.714285714285714,2,0.0,2,9,0,5,19,1,0,4,0,16,24,1
1087,23014,UInMBEH8f1h2vxXVslRsWyLOTv8ggYq3,bWdj2GDclj5ofokWjzoa5jAwMkxCykd6,9,8,4,0,3,0,1,0,16,2.2857142857142856,1,0.0,0,4,0,3,8,0,0,1,0,7,9,0
1088,23054,aOK5wIKpKN9ikUy2a1FUGeQDEt1AAFa3,G8EPVSXsOYB5YQWZGiz1aVq5Pgr2GrQu,4,2,1,0,0,0,2,0,5,0.7142857142857143,1,0.0,0,1,0,0,2,0,0,2,0,1,4,1
1089,23058,Dp9gZlmwGRMU0Crlqtgk7QHM4JW7fsY6,SpATywNh6bZuzm8s1ceuBUnMUAeoAHHw,8,11,1,0,0,0,4,0,16,2.2857142857142856,2,0.0,0,1,0,0,11,0,0,4,0,1,15,0
1090,23073,gZWf27ETcHz4bBmwZPjiPumw55JZ4IOR,SpATywNh6bZuzm8s1ceuBUnMUAeoAHHw,1,0,0,0,0,0,1,0,1,0.14285714285714285,1,0.0,0,0,0,0,0,0,0,1,0,0,1,0
1091,23084,mjoKY29bSBUSIg1iJCO4z3ZZIabGnClW,SpATywNh6bZuzm8s1ceuBUnMUAeoAHHw,5,8,3,0,0,0,6,0,17,2.4285714285714284,2,0.0,0,3,0,0,8,0,0,6,0,3,14,0
1092,23091,aOhrgEBrLoAbudoZk6lY36jneHxQbWdO,G8EPVSXsOYB5YQWZGiz1aVq5Pgr2GrQu,17,9,7,38,1,6,11,3,75,10.714285714285714,1,0.0,0,7,31,1,9,6,7,11,3,39,36,0
1093,23140,0Tg2flbTUdD7fODqYIfpiJiK0IDdFiOP,RXDvfPUBYFlVdlueBFbLW0mhhAyGEqpt,8,7,5,0,0,18,1,0,31,4.428571428571429,2,0.0,0,5,0,0,7,18,0,1,0,5,26,0
1094,23145,VO6tFMF3YqIQYaW8tkV9BLtheEJyKKQK,SpATywNh6bZuzm8s1ceuBUnMUAeoAHHw,3,2,1,0,0,0,1,0,4,0.5714285714285714,1,0.0,0,1,0,0,2,0,0,1,0,1,3,0
1095,23181,PwNax3W8g4wFzRQCUhWcP9EnmZeticjo,SpATywNh6bZuzm8s1ceuBUnMUAeoAHHw,3,4,2,0,0,0,2,0,8,1.1428571428571428,2,0.0,0,2,0,0,4,0,0,2,0,2,6,1
1096,23188,HycevJIm7cBjf1oJ5QCBMMXEBTG8jyRF,RXDvfPUBYFlVdlueBFbLW0mhhAyGEqpt,3,2,1,0,0,0,2,0,5,0.7142857142857143,1,0.0,0,1,0,0,2,0,0,2,0,1,4,0
1097,23259,xqwUV9iQK4erbWJ9fEZ3Fau5k4aAZ9DO,SpATywNh6bZuzm8s1ceuBUnMUAeoAHHw,4,0,0,0,0,6,3,0,9,1.2857142857142858,1,0.0,0,0,0,0,0,6,0,3,0,0,9,0
1098,23264,XTgYONXtkRAl3sCFaGFF8e1mU9AMcEwg,SpATywNh6bZuzm8s1ceuBUnMUAeoAHHw,12,8,6,0,4,0,2,0,20,2.857142857142857,2,0.0,0,6,0,4,8,0,0,2,0,10,10,1
1099,23265,knRZtWEcWI5MFAs7PYIJdk2jdyAY8A24,SpATywNh6bZuzm8s1ceuBUnMUAeoAHHw,19,17,10,8,4,2,11,1,53,7.571428571428571,2,0.0,4,10,8,4,13,2,0,11,1,26,27,0
1100,23268,XJpmNtat26NZxNAZqQE63m1qpYdHanqw,RXDvfPUBYFlVdlueBFbLW0mhhAyGEqpt,22,34,25,8,5,0,1,0,73,10.428571428571429,2,0.0,1,25,7,5,33,0,1,1,0,38,35,0
1101,23297,3cB0rEpxJxC0jjqfQ9EPT6ntxFajOXrx,A3fsA9Zfv1X2fVEQhTw51lKENdNrEqT3,14,8,7,0,5,0,1,0,21,3.0,1,0.0,0,7,0,5,8,0,0,1,0,12,9,0
1102,23304,WEwbMamm1WQzZcIYKs7fv3KkFwrZAu4n,SpATywNh6bZuzm8s1ceuBUnMUAeoAHHw,3,2,1,0,0,0,2,0,5,0.7142857142857143,1,0.0,0,1,0,0,2,0,0,2,0,1,4,0
1103,23307,S1PbXrIuvwc8AvxDGKhjkWzwRdM8cFN0,SpATywNh6bZuzm8s1ceuBUnMUAeoAHHw,3,2,1,0,0,0,2,0,5,0.7142857142857143,1,0.0,0,1,0,0,2,0,0,2,0,1,4,0
1104,23341,1cMpA6zMPA0affI3yASPkTig9lUEcx1e,G8EPVSXsOYB5YQWZGiz1aVq5Pgr2GrQu,4,3,1,0,0,0,1,0,5,0.7142857142857143,1,0.0,0,1,0,0,3,0,0,1,0,1,4,1
1105,23388,HZWZtPkCTeK90eQ90MHe5cWcAqiVgkGk,bWdj2GDclj5ofokWjzoa5jAwMkxCykd6,34,98,56,132,27,22,21,0,356,50.857142857142854,4,0.0,23,56,114,27,75,22,18,21,0,220,136,0
1106,23390,lfrqXPATBesMooHpdCa9ZnxlXhb59rmp,SpATywNh6bZuzm8s1ceuBUnMUAeoAHHw,18,33,21,18,5,11,8,0,96,13.714285714285714,2,0.0,3,21,17,5,30,11,1,8,0,46,50,1
1107,23399,QUw5YB8tw6ArwfIF1vjOH2aXsMxDBB6n,SpATywNh6bZuzm8s1ceuBUnMUAeoAHHw,15,10,6,10,3,2,2,0,33,4.714285714285714,1,0.0,3,6,8,3,7,2,2,2,0,20,13,0
1108,23405,3AFvyqpOB7zyiycGY1NpbFOUZUj9K9Bb,SpATywNh6bZuzm8s1ceuBUnMUAeoAHHw,5,3,2,0,0,0,2,0,7,1.0,1,0.0,0,2,0,0,3,0,0,2,0,2,5,1
1109,23416,1ulA4jhwI0WhLE9MVLjWBxEEeOzdq7WL,SpATywNh6bZuzm8s1ceuBUnMUAeoAHHw,21,32,17,12,6,11,12,3,93,13.285714285714286,3,0.0,9,17,12,6,23,11,0,12,3,44,49,0
1110,23440,lHNqd6KTSO9CrJzRDAqosVITLVN3mMHR,bWdj2GDclj5ofokWjzoa5jAwMkxCykd6,10,21,12,0,3,0,7,0,43,6.142857142857143,2,0.0,2,12,0,3,19,0,0,7,0,17,26,1
1111,23450,RKjVof9Yhxeyyya4gtkZu1fqgIbPHIOB,A3fsA9Zfv1X2fVEQhTw51lKENdNrEqT3,3,0,0,0,0,0,3,0,3,0.42857142857142855,1,0.0,0,0,0,0,0,0,0,3,0,0,3,0
1112,23477,wctOEAfOfHjaIn2ukTVBg3NDDfP2Pt1c,SpATywNh6bZuzm8s1ceuBUnMUAeoAHHw,6,17,11,0,2,0,5,0,35,5.0,3,0.0,0,11,0,2,17,0,0,5,0,13,22,0
1113,23490,Id4UmIRRQiLXHoJYSjh5OCO1CRaFgQ2K,SpATywNh6bZuzm8s1ceuBUnMUAeoAHHw,3,2,1,0,0,0,2,0,5,0.7142857142857143,1,0.0,0,1,0,0,2,0,0,2,0,1,4,1
1114,23510,GIb3glgYrsEfHWtEWPWpwONqwE7RMf6f,A3fsA9Zfv1X2fVEQhTw51lKENdNrEqT3,23,35,18,24,9,0,12,0,98,14.0,6,0.0,4,18,22,9,31,0,2,12,0,53,45,0
1115,23515,Oqfkhjg6t51PZcyyCwvjWtQ6bDHYceB1,SpATywNh6bZuzm8s1ceuBUnMUAeoAHHw,5,3,2,0,0,0,4,0,9,1.2857142857142858,2,0.0,0,2,0,0,3,0,0,4,0,2,7,0
1116,23542,d4mvkfcwFcYKWYB1PuCW432MT8LvqlFh,SpATywNh6bZuzm8s1ceuBUnMUAeoAHHw,13,32,13,0,2,0,10,0,57,8.142857142857142,3,0.0,15,13,0,2,17,0,0,10,0,30,27,1
1117,23552,H0WeKsbXeLHWXz7EV7ygxgCQNCt5DOUD,SpATywNh6bZuzm8s1ceuBUnMUAeoAHHw,3,8,4,0,0,0,4,0,16,2.2857142857142856,4,0.0,0,4,0,0,8,0,0,4,0,4,12,0
1118,23573,MwhE2MowwPvamSVFrLUWaatDsrzcIgQY,SpATywNh6bZuzm8s1ceuBUnMUAeoAHHw,20,21,13,6,5,2,9,1,57,8.142857142857142,2,0.0,2,13,6,5,19,2,0,9,1,26,31,0
1119,23596,DdGVDKNQwSkPIQKeE1XouOkZR5kVZ7SK,SpATywNh6bZuzm8s1ceuBUnMUAeoAHHw,10,15,1,20,0,0,2,0,38,5.428571428571429,1,0.0,7,1,17,0,8,0,3,2,0,25,13,1
1120,23603,0wJhtCWK60WPCeRF62m8T80DtNpWhRrg,SpATywNh6bZuzm8s1ceuBUnMUAeoAHHw,3,2,1,0,0,0,3,0,6,0.8571428571428571,1,0.0,0,1,0,0,2,0,0,3,0,1,5,0
1121,23633,o6ILANWxUGmdLZhlBol9mZCEolnG5bhy,SpATywNh6bZuzm8s1ceuBUnMUAeoAHHw,3,2,1,0,0,0,1,0,4,0.5714285714285714,1,0.0,0,1,0,0,2,0,0,1,0,1,3,1
1122,23639,tMPZYG0DCvDSDEuO4KsQAdk0iwwmXKYt,A3fsA9Zfv1X2fVEQhTw51lKENdNrEqT3,24,30,18,28,15,0,2,0,93,13.285714285714286,1,0.0,1,18,23,15,29,0,5,2,0,57,36,0
1123,23640,9uqkwYb5ddQJIw4su6OaF1hwvWEdLp1S,A3fsA9Zfv1X2fVEQhTw51lKENdNrEqT3,3,2,1,0,0,0,1,0,4,0.5714285714285714,1,0.0,0,1,0,0,2,0,0,1,0,1,3,0
1124,23671,9sTtmQQAXG5XvwtZJPuuRKLnfgaYWfWO,SpATywNh6bZuzm8s1ceuBUnMUAeoAHHw,1,0,0,0,0,0,1,0,1,0.14285714285714285,1,0.0,0,0,0,0,0,0,0,1,0,0,1,1
1125,23674,l9KseRU4xYtwOzoILYmGcicF0iiXQqxl,SpATywNh6bZuzm8s1ceuBUnMUAeoAHHw,3,2,1,0,0,4,3,0,10,1.4285714285714286,1,0.0,0,1,0,0,2,4,0,3,0,1,9,0
1126,23675,pJj2PU7RZQK2Nwrb96O5DurQcsPoqkDx,bWdj2GDclj5ofokWjzoa5jAwMkxCykd6,1,0,0,0,0,0,1,0,1,0.14285714285714285,1,0.0,0,0,0,0,0,0,0,1,0,0,1,1
1127,23710,3iJrlZJEv2h7DgWBpz6wZtSXPXEy6IAY,A3fsA9Zfv1X2fVEQhTw51lKENdNrEqT3,1,0,0,0,0,0,1,0,1,0.14285714285714285,1,0.0,0,0,0,0,0,0,0,1,0,0,1,0
1128,23740,oJ9j9ejTgKixczg3tSE8Sg8DPI7YQpJq,SpATywNh6bZuzm8s1ceuBUnMUAeoAHHw,4,3,2,0,0,0,1,0,6,0.8571428571428571,1,0.0,0,2,0,0,3,0,0,1,0,2,4,0
1129,23754,atxTINx1wNa0Kz1uw7bW34Z47POxkGeq,SpATywNh6bZuzm8s1ceuBUnMUAeoAHHw,7,12,3,0,3,0,9,0,27,3.857142857142857,3,0.0,0,3,0,3,12,0,0,9,0,6,21,0
1130,23760,6uy0rYsVs6ntSHgwhJ1mwDkW5uKAQxi4,SpATywNh6bZuzm8s1ceuBUnMUAeoAHHw,7,7,5,0,3,0,2,0,17,2.4285714285714284,2,0.0,0,5,0,3,7,0,0,2,0,8,9,1
1131,23798,GOPMGFz5xoFESgugOmv6JtNIOPfS0GCX,SpATywNh6bZuzm8s1ceuBUnMUAeoAHHw,5,5,0,0,0,0,0,0,5,0.7142857142857143,1,0.0,0,0,0,0,5,0,0,0,0,0,5,0
1132,23840,FBu5R2eGEtl9EDw0VwXtH1t5i2ELpdqI,SpATywNh6bZuzm8s1ceuBUnMUAeoAHHw,7,11,5,0,3,0,2,0,21,3.0,2,0.0,0,5,0,3,11,0,0,2,0,8,13,1
1133,23862,YxEAEqB4R6GTRBWDvga1GWE0URAxGc6U,A3fsA9Zfv1X2fVEQhTw51lKENdNrEqT3,6,8,6,0,0,0,2,0,16,2.2857142857142856,2,0.0,0,6,0,0,8,0,0,2,0,6,10,1
1134,23891,FBu5R2eGEtl9EDw0VwXtH1t5i2ELpdqI,A3fsA9Zfv1X2fVEQhTw51lKENdNrEqT3,30,20,9,92,4,0,5,0,130,18.571428571428573,3,0.0,1,9,80,4,19,0,12,5,0,94,36,1
1135,23893,dkQw8oK3XR4qlNNv9mJoCG5KMSpfLA0u,SpATywNh6bZuzm8s1ceuBUnMUAeoAHHw,1,0,0,0,0,0,1,0,1,0.14285714285714285,1,0.0,0,0,0,0,0,0,0,1,0,0,1,1
1136,23920,v5teTtQ61doFtyEryEU1FEZNTQeJUrxX,SpATywNh6bZuzm8s1ceuBUnMUAeoAHHw,7,10,1,0,0,0,10,0,21,3.0,3,0.0,2,1,0,0,8,0,0,10,0,3,18,0
1137,23942,yk8HuNxXIum8r8XDIOHqnAVeWfg9tYo1,A3fsA9Zfv1X2fVEQhTw51lKENdNrEqT3,1,0,0,0,0,0,1,0,1,0.14285714285714285,1,0.0,0,0,0,0,0,0,0,1,0,0,1,1
1138,23944,ZKAk08L8Iriz8Uv5UOeqSbrNnzg1rlMz,RXDvfPUBYFlVdlueBFbLW0mhhAyGEqpt,16,9,8,0,6,0,1,0,24,3.4285714285714284,1,0.0,0,8,0,6,9,0,0,1,0,14,10,0
1139,23955,5mJ1itg2cQYRNscuJuLNd4sNUrdim8JB,bWdj2GDclj5ofokWjzoa5jAwMkxCykd6,32,65,27,39,4,10,17,0,162,23.142857142857142,2,0.0,5,27,39,4,60,10,0,17,0,75,87,0
1140,23975,xCPsccPRbQTL93kwam6OPz5i1lU77hqE,SpATywNh6bZuzm8s1ceuBUnMUAeoAHHw,3,4,1,0,0,0,2,0,7,1.0,1,0.0,0,1,0,0,4,0,0,2,0,1,6,0
1141,23976,PSJftXZeDfoFySmsRqkLgFson1mEyJqX,SpATywNh6bZuzm8s1ceuBUnMUAeoAHHw,2,0,0,0,0,0,5,0,5,0.7142857142857143,2,0.0,0,0,0,0,0,0,0,5,0,0,5,0
1142,23982,3W09pasLSoDWuQqGyvECJ7WiykG165j2,RXDvfPUBYFlVdlueBFbLW0mhhAyGEqpt,5,4,3,0,0,7,1,0,15,2.142857142857143,1,0.0,0,3,0,0,4,7,0,1,0,3,12,1
1143,23985,T23nrSnpQ3vWpr6CtL4ZskVcSM0KOOu0,A3fsA9Zfv1X2fVEQhTw51lKENdNrEqT3,37,13,10,40,8,0,2,0,73,10.428571428571429,1,0.0,2,10,39,8,11,0,1,2,0,59,14,1
1144,24019,tML4IQ8jFiP4YuH9NbvzKQFqAdof0qcO,G8EPVSXsOYB5YQWZGiz1aVq5Pgr2GrQu,13,9,1,34,0,0,3,0,47,6.714285714285714,1,0.0,0,1,29,0,9,0,5,3,0,30,17,0
1145,24035,j5UlwBty5MOwHf8rgRJk1hdlEvwivM1k,SpATywNh6bZuzm8s1ceuBUnMUAeoAHHw,6,12,6,0,0,0,18,1,37,5.285714285714286,1,0.0,0,6,0,0,12,0,0,18,1,6,31,0
1146,24053,eosk3dY7502Pbg6Dsnx0qWKWUpRTliXK,A3fsA9Zfv1X2fVEQhTw51lKENdNrEqT3,7,7,0,0,0,0,2,0,9,1.2857142857142858,1,0.0,0,0,0,0,7,0,0,2,0,0,9,1
1147,24066,kXKIMNlMdItv4EM1IWayIAvXYTB44MoC,RXDvfPUBYFlVdlueBFbLW0mhhAyGEqpt,14,38,15,0,6,0,4,0,63,9.0,1,0.0,0,15,0,6,38,0,0,4,0,21,42,1
1148,24077,1xg9Qkt1ODqUyNotraxCzvVYE0R3XRTq,SpATywNh6bZuzm8s1ceuBUnMUAeoAHHw,9,20,14,0,0,0,10,0,44,6.285714285714286,2,0.0,0,14,0,0,20,0,0,10,0,14,30,0
1149,24139,oz1karFupMeBQM5wp1X9Aheb4RKufic7,SpATywNh6bZuzm8s1ceuBUnMUAeoAHHw,1,0,0,0,0,0,1,0,1,0.14285714285714285,1,0.0,0,0,0,0,0,0,0,1,0,0,1,0
1150,24142,6zt7VkEpMezYkke6xelTowmnsTySao1Z,SpATywNh6bZuzm8s1ceuBUnMUAeoAHHw,13,6,5,10,3,0,4,0,28,4.0,3,0.0,2,5,9,3,4,0,1,4,0,19,9,1
1151,24146,W41zjpcR5alpzNzSmbyy9bBZYrT6UXxL,RXDvfPUBYFlVdlueBFbLW0mhhAyGEqpt,11,15,9,18,2,0,9,0,53,7.571428571428571,2,0.0,3,9,13,2,12,0,5,9,0,27,26,1
1152,24149,yEc0qGRUsnGavj0JPbk8pVtWktClrURk,SpATywNh6bZuzm8s1ceuBUnMUAeoAHHw,3,6,3,0,0,0,5,0,14,2.0,4,0.0,0,3,0,0,6,0,0,5,0,3,11,0
1153,24150,7mxOgTUP9lSjAUBOPZ9fhNEhVSHMvF2J,bWdj2GDclj5ofokWjzoa5jAwMkxCykd6,25,37,6,71,2,26,3,0,145,20.714285714285715,3,0.0,4,6,61,2,33,26,10,3,0,73,72,0
1154,24187,GlAlbUSi7bTkQeCE1bsVWDk5GBPq0ZBP,bWdj2GDclj5ofokWjzoa5jAwMkxCykd6,11,9,5,6,2,4,4,0,30,4.285714285714286,1,0.0,2,5,6,2,7,4,0,4,0,15,15,1
1155,24191,VVltscgfR96aweHb5nQdD1Q7dsOwuOJz,A3fsA9Zfv1X2fVEQhTw51lKENdNrEqT3,3,2,0,0,0,0,2,0,4,0.5714285714285714,1,0.0,0,0,0,0,2,0,0,2,0,0,4,1
1156,24255,SvdoxHaqv4If8vTEQE4Ye6pIzdBuUEi9,G8EPVSXsOYB5YQWZGiz1aVq5Pgr2GrQu,23,34,23,28,10,13,4,0,112,16.0,2,0.0,7,23,24,10,27,13,4,4,0,64,48,1
1157,24283,yZoviGGxgr5NFf9klHeC5PfXfdVd14QP,A3fsA9Zfv1X2fVEQhTw51lKENdNrEqT3,3,2,1,0,0,0,2,0,5,0.7142857142857143,1,0.0,0,1,0,0,2,0,0,2,0,1,4,1
1158,24285,Kd69M9W1nim0woqVm1QxfVaSebsYtFIh,RXDvfPUBYFlVdlueBFbLW0mhhAyGEqpt,5,4,2,0,1,0,1,0,8,1.1428571428571428,1,0.0,0,2,0,1,4,0,0,1,0,3,5,1
1159,24290,Ms0MC4W5moiGJLWP7iE3FImeH9CHN4KT,A3fsA9Zfv1X2fVEQhTw51lKENdNrEqT3,6,7,3,0,1,0,7,0,18,2.5714285714285716,4,0.0,0,3,0,1,7,0,0,7,0,4,14,0
1160,24313,Evco2d15cNydZMimph5VWFT3j0HfgNP5,SpATywNh6bZuzm8s1ceuBUnMUAeoAHHw,3,2,1,0,0,0,2,0,5,0.7142857142857143,2,0.0,0,1,0,0,2,0,0,2,0,1,4,0
1161,24324,W41zjpcR5alpzNzSmbyy9bBZYrT6UXxL,A3fsA9Zfv1X2fVEQhTw51lKENdNrEqT3,5,3,2,0,1,0,1,0,7,1.0,1,0.0,0,2,0,1,3,0,0,1,0,3,4,1
1162,24351,iugl3Rn3u1ci3BiC2tfekDHOQsD5QVGj,A3fsA9Zfv1X2fVEQhTw51lKENdNrEqT3,7,7,5,0,0,0,4,0,16,2.2857142857142856,2,0.0,0,5,0,0,7,0,0,4,0,5,11,1
1163,24375,vx3ISVZde9Js9SAljxLNpat5gkbJKEY2,RXDvfPUBYFlVdlueBFbLW0mhhAyGEqpt,33,33,9,53,8,13,13,0,129,18.428571428571427,3,0.0,15,9,49,8,18,13,4,13,0,81,48,0
1164,24391,5tGNQxzw9lFd1DSnmxNCdWwVZfTyj1IB,bWdj2GDclj5ofokWjzoa5jAwMkxCykd6,3,2,1,0,0,0,2,0,5,0.7142857142857143,2,0.0,0,1,0,0,2,0,0,2,0,1,4,1
1165,24445,mFNGHC6aCmhHmhRXFCDO0uvnGnNYaro0,bWdj2GDclj5ofokWjzoa5jAwMkxCykd6,2,1,0,0,0,0,1,0,2,0.2857142857142857,1,0.0,0,0,0,0,1,0,0,1,0,0,2,1
1166,24447,bSOq11L6zS91mDTcR42LcWMRdkU0Htpv,SpATywNh6bZuzm8s1ceuBUnMUAeoAHHw,5,6,2,0,0,1,6,0,15,2.142857142857143,1,0.0,0,2,0,0,6,1,0,6,0,2,13,1
1167,24475,1yAfuEW0CNQiRXnPO0v79LFUyx4hhTWm,bWdj2GDclj5ofokWjzoa5jAwMkxCykd6,13,5,4,38,0,0,4,0,51,7.285714285714286,1,0.0,0,4,33,0,5,0,5,4,0,37,14,0
1168,24542,GW33fgaq0ndGNQkirzfpXhCeUuV3tuD2,SpATywNh6bZuzm8s1ceuBUnMUAeoAHHw,16,21,12,13,10,0,2,0,58,8.285714285714286,2,0.0,3,12,12,10,18,0,1,2,0,37,21,0
1169,24550,qr1Y8xuPrcpdzScNHYsirGXqasfUdOVa,SpATywNh6bZuzm8s1ceuBUnMUAeoAHHw,1,0,0,0,0,0,1,0,1,0.14285714285714285,1,0.0,0,0,0,0,0,0,0,1,0,0,1,1
1170,24551,foJyfq5hSUj3jzVw8TG0nT1wv3hLMMNc,G8EPVSXsOYB5YQWZGiz1aVq5Pgr2GrQu,7,16,0,0,1,0,3,0,20,2.857142857142857,1,0.0,0,0,0,1,16,0,0,3,0,1,19,0
1171,24552,foJyfq5hSUj3jzVw8TG0nT1wv3hLMMNc,SpATywNh6bZuzm8s1ceuBUnMUAeoAHHw,3,2,0,0,0,0,2,0,4,0.5714285714285714,1,0.0,0,0,0,0,2,0,0,2,0,0,4,0
1172,24587,f7pgA2Hp0s8DkqzKuvE0Kw8QRuoBh3Zv,RXDvfPUBYFlVdlueBFbLW0mhhAyGEqpt,14,18,12,10,2,4,2,0,48,6.857142857142857,2,0.0,4,12,5,2,14,4,5,2,0,23,25,0
1173,24619,0JvlwMe8wRQNeLJu71UvJCaEJca2naUP,7GRhBDsirIGkRZBtSMEzNTyDr2JQm4xx,36,45,15,34,12,9,14,2,131,18.714285714285715,2,0.0,17,15,28,12,28,9,6,14,2,72,59,1
1174,24640,a34YLXSKFcXb1SBjIduE3dfW4OSAFwK1,A3fsA9Zfv1X2fVEQhTw51lKENdNrEqT3,100,155,110,216,62,92,16,1,652,93.14285714285714,4,0.0,9,110,186,62,146,92,30,16,1,367,285,0
1175,24661,ZgPDgY8Y43cADkyBad03WZKNqaM99vmp,7GRhBDsirIGkRZBtSMEzNTyDr2JQm4xx,29,68,2,10,11,3,32,3,129,18.428571428571427,2,0.0,29,2,8,11,39,3,2,32,3,50,79,0
1176,24744,S6vBzHKpSh31SFGGZmwgKaOH2RvW3RpH,bWdj2GDclj5ofokWjzoa5jAwMkxCykd6,8,5,3,0,1,0,6,0,15,2.142857142857143,1,0.0,0,3,0,1,5,0,0,6,0,4,11,1
1177,24783,3b2PIBrJ06iLfdDIB9BTmuEwfL5TZfMa,RXDvfPUBYFlVdlueBFbLW0mhhAyGEqpt,65,57,33,112,17,8,9,1,237,33.857142857142854,3,0.0,15,33,103,17,42,8,9,9,1,168,69,0
1178,24796,8tSKdZ8K9lE8Sg5tXOt7ENrj00lNonld,SpATywNh6bZuzm8s1ceuBUnMUAeoAHHw,13,12,1,16,0,0,4,0,33,4.714285714285714,2,0.0,2,1,14,0,10,0,2,4,0,17,16,0
1179,24834,NsnGWsRio9JsRS5X1oYgeBjF7tc8iDdA,7GRhBDsirIGkRZBtSMEzNTyDr2JQm4xx,1,0,0,0,0,0,1,0,1,0.14285714285714285,1,0.0,0,0,0,0,0,0,0,1,0,0,1,1
1180,24885,7AeiHdeG7nh46bg2JDAmPWtQ1zuvRpUT,A3fsA9Zfv1X2fVEQhTw51lKENdNrEqT3,8,2,0,0,0,1,8,1,12,1.7142857142857142,1,0.0,0,0,0,0,2,1,0,8,1,0,12,0
1181,24886,rO1KHHxaPbWq8U3I08PqNPYplaZaPb83,RXDvfPUBYFlVdlueBFbLW0mhhAyGEqpt,1,0,0,0,0,0,1,0,1,0.14285714285714285,1,0.0,0,0,0,0,0,0,0,1,0,0,1,1
1182,24909,pyd2EL5x8zMZ7LCIvrt0VYq229eSSKrd,SpATywNh6bZuzm8s1ceuBUnMUAeoAHHw,30,40,27,32,16,7,6,1,129,18.428571428571427,2,0.0,11,27,28,16,29,7,4,6,1,82,47,0
1183,24929,hCRoH0np1tajD5PHKKgVw7dH4NZJLfD2,A3fsA9Zfv1X2fVEQhTw51lKENdNrEqT3,33,17,10,80,5,19,10,0,141,20.142857142857142,4,0.0,1,10,69,5,16,19,11,10,0,85,56,0
1184,24984,p8pFuUg19xWGOlJygMvSlQjonA3l7FUn,A3fsA9Zfv1X2fVEQhTw51lKENdNrEqT3,26,22,19,0,13,0,3,0,57,8.142857142857142,3,0.0,0,19,0,13,22,0,0,3,0,32,25,0
1185,24996,tLK32ryOHeiJecBcFzaTeN36vYEmQ8Nk,SpATywNh6bZuzm8s1ceuBUnMUAeoAHHw,1,0,0,0,0,0,1,0,1,0.14285714285714285,1,0.0,0,0,0,0,0,0,0,1,0,0,1,1
1186,25033,BuZcYQWwWDSVZcqno1RGBiY1PDnVqtUZ,G8EPVSXsOYB5YQWZGiz1aVq5Pgr2GrQu,6,4,1,0,1,0,1,0,7,1.0,1,0.0,0,1,0,1,4,0,0,1,0,2,5,1
1187,25049,zkOr0wwuxAzYftPuxG6iQaCtbl1egkTS,A3fsA9Zfv1X2fVEQhTw51lKENdNrEqT3,11,9,5,0,1,3,13,1,32,4.571428571428571,2,0.0,1,5,0,1,8,3,0,13,1,7,25,0
1188,25067,aQ6WrdDe9pTNwVW3vmaMOs1pxy5r3Dxa,A3fsA9Zfv1X2fVEQhTw51lKENdNrEqT3,22,20,14,42,6,8,7,0,97,13.857142857142858,3,0.0,1,14,33,6,19,8,9,7,0,54,43,0
1189,25073,WQKoaWRi4j5EUCfZEZsK4LU6GIHATRae,SpATywNh6bZuzm8s1ceuBUnMUAeoAHHw,16,11,8,14,6,0,5,0,44,6.285714285714286,3,0.0,2,8,11,6,9,0,3,5,0,27,17,1
1190,25134,tyleDimh7zmzFWTVgvg7bgaQaZGfwPk2,A3fsA9Zfv1X2fVEQhTw51lKENdNrEqT3,8,7,1,0,0,0,4,0,12,1.7142857142857142,1,0.0,0,1,0,0,7,0,0,4,0,1,11,0
1191,25194,evrdwGhLAFWdgr0Clw2EFTM91w358eNP,SpATywNh6bZuzm8s1ceuBUnMUAeoAHHw,25,19,14,6,8,10,8,2,67,9.571428571428571,1,0.0,3,14,6,8,16,10,0,8,2,31,36,0
1192,25212,95whmOrr6ttgAKmA8d5EYFggt87ONgHi,SpATywNh6bZuzm8s1ceuBUnMUAeoAHHw,6,5,3,0,1,0,2,0,11,1.5714285714285714,1,0.0,0,3,0,1,5,0,0,2,0,4,7,1
1193,25219,skOScgcMIkYsPXikHjLqvicjdb3rv6St,A3fsA9Zfv1X2fVEQhTw51lKENdNrEqT3,6,10,4,14,0,0,5,0,33,4.714285714285714,3,0.0,2,4,12,0,8,0,2,5,0,18,15,1
1194,25235,BgFWtuiCvZoByaUpZ5qN1JDEWuWXlm2n,G8EPVSXsOYB5YQWZGiz1aVq5Pgr2GrQu,16,18,5,26,1,0,2,0,52,7.428571428571429,1,0.0,12,5,13,1,6,0,13,2,0,31,21,1
1195,25249,ycTj3YOXaJ7pHDIwrzbh7koMVXAXAOVY,bWdj2GDclj5ofokWjzoa5jAwMkxCykd6,37,38,22,186,12,2,11,1,272,38.857142857142854,2,0.0,11,22,177,12,27,2,9,11,1,222,50,0
1196,25265,9va79rFsgW625mCi6PBHbhUMC5acSS5i,bWdj2GDclj5ofokWjzoa5jAwMkxCykd6,19,9,7,36,4,0,6,0,62,8.857142857142858,2,0.0,2,7,32,4,7,0,4,6,0,45,17,0
1197,25284,6DpgdlGoKRdZ3TeMwKLdUESj04TqApO6,7GRhBDsirIGkRZBtSMEzNTyDr2JQm4xx,12,19,10,23,2,0,3,0,57,8.142857142857142,2,0.0,5,10,22,2,14,0,1,3,0,39,18,1
1198,25287,ETzcC9n39CwhBb4MTbqq1Ng4NqGIoiPj,SpATywNh6bZuzm8s1ceuBUnMUAeoAHHw,14,26,1,8,2,0,4,0,41,5.857142857142857,1,0.0,9,1,8,2,17,0,0,4,0,20,21,1
1199,25295,ETzcC9n39CwhBb4MTbqq1Ng4NqGIoiPj,bWdj2GDclj5ofokWjzoa5jAwMkxCykd6,18,18,0,32,0,1,7,0,58,8.285714285714286,1,0.0,1,0,28,0,17,1,4,7,0,29,29,1
1200,25299,NwQCoUHJKyAdqdG7U0utXO1oyZsmr8V3,A3fsA9Zfv1X2fVEQhTw51lKENdNrEqT3,89,41,8,252,6,21,18,1,347,49.57142857142857,3,0.0,5,8,218,6,36,21,34,18,1,237,110,0
1201,25330,JQkQWFK6hvLU3dRb6IiKAH09cV6i6Ru3,SpATywNh6bZuzm8s1ceuBUnMUAeoAHHw,17,23,1,21,1,1,5,1,53,7.571428571428571,1,0.0,11,1,18,1,12,1,3,5,1,31,22,0
1202,25371,tMJpDv6ZjEPz2ELzUVp4mZTT6G7u49T6,bWdj2GDclj5ofokWjzoa5jAwMkxCykd6,6,5,2,0,0,0,8,0,15,2.142857142857143,3,0.0,0,2,0,0,5,0,0,8,0,2,13,0
1203,25409,tvH2SB0L50iCqaXyQDY3u7qaByLbL0rV,RXDvfPUBYFlVdlueBFbLW0mhhAyGEqpt,7,5,1,0,1,1,1,0,9,1.2857142857142858,1,0.0,0,1,0,1,5,1,0,1,0,2,7,1
1204,25411,zTKXcgMSZF7JvFUNYP705peyaFADazmR,bWdj2GDclj5ofokWjzoa5jAwMkxCykd6,8,9,6,0,2,1,8,0,26,3.7142857142857144,2,0.0,0,6,0,2,9,1,0,8,0,8,18,0
1205,25414,JGLccTidDHJDu8gDiATpQDW1eozc4icT,G8EPVSXsOYB5YQWZGiz1aVq5Pgr2GrQu,40,24,19,116,13,0,1,0,173,24.714285714285715,1,0.0,4,19,101,13,20,0,15,1,0,137,36,1
1206,25443,rpvfqHO7dPQYBUZWKnS2wc1t5Qy6pGj6,bWdj2GDclj5ofokWjzoa5jAwMkxCykd6,3,2,0,0,0,0,1,0,3,0.42857142857142855,1,0.0,0,0,0,0,2,0,0,1,0,0,3,1
1207,25461,TvoBOfhroHgtNwfOxtnATpVOdfdysLPf,SpATywNh6bZuzm8s1ceuBUnMUAeoAHHw,13,9,1,8,1,1,5,1,26,3.7142857142857144,1,0.0,4,1,7,1,5,1,1,5,1,13,13,1
1208,25511,RtpaISGKG8FC1poFd4XAu8898XLnl6EI,SpATywNh6bZuzm8s1ceuBUnMUAeoAHHw,9,19,8,0,3,0,6,0,36,5.142857142857143,6,0.0,3,8,0,3,16,0,0,6,0,14,22,0
1209,25527,qEjaWdK86bYd7lCS9YD68MsK6migCUpH,SpATywNh6bZuzm8s1ceuBUnMUAeoAHHw,15,13,6,7,4,0,5,0,35,5.0,1,0.0,2,6,7,4,11,0,0,5,0,19,16,0
1210,25546,rfOApTbQ4xF2665bHZIBhoJqQcTU6i9L,A3fsA9Zfv1X2fVEQhTw51lKENdNrEqT3,10,8,5,0,1,0,5,0,19,2.7142857142857144,1,0.0,0,5,0,1,8,0,0,5,0,6,13,1
1211,25588,fEjyEDOkalYa6eH46cG6UcR1E7twiXyF,SpATywNh6bZuzm8s1ceuBUnMUAeoAHHw,32,32,19,36,7,51,16,1,162,23.142857142857142,2,0.0,6,19,30,7,26,51,6,16,1,62,100,0
1212,25607,s5bmHBniKJzstjkFlsJcJn6YQEnj7XjP,SpATywNh6bZuzm8s1ceuBUnMUAeoAHHw,4,2,1,0,1,0,2,0,6,0.8571428571428571,1,0.0,0,1,0,1,2,0,0,2,0,2,4,0
1213,25655,TOdJr6wpv1Do14qMOudEcAu5ZtPnzG5P,SpATywNh6bZuzm8s1ceuBUnMUAeoAHHw,29,20,11,22,7,7,8,1,76,10.857142857142858,3,0.0,6,11,22,7,14,7,0,8,1,46,30,0
1214,25675,wgifE6A0kxnDEjw7myKTY39TRuCgYxaB,A3fsA9Zfv1X2fVEQhTw51lKENdNrEqT3,18,23,7,0,5,0,4,0,39,5.571428571428571,2,0.0,0,7,0,5,23,0,0,4,0,12,27,1
1215,25678,8hHM4gMR8PLgcGE0KxgxZ4wD71iRPNWp,RXDvfPUBYFlVdlueBFbLW0mhhAyGEqpt,32,73,27,26,19,0,6,0,151,21.571428571428573,1,0.0,23,27,26,19,50,0,0,6,0,95,56,1
1216,25706,udBjfCluZTte9l6GhqqG4v3kEGoKKcxC,SpATywNh6bZuzm8s1ceuBUnMUAeoAHHw,13,20,6,12,2,1,5,0,46,6.571428571428571,2,0.0,10,6,11,2,10,1,1,5,0,29,17,0
1217,25720,v0qndwa3TlbOqgdTUBH2afnl049VDWzU,SpATywNh6bZuzm8s1ceuBUnMUAeoAHHw,17,31,16,12,5,0,11,0,75,10.714285714285714,5,0.0,6,16,12,5,25,0,0,11,0,39,36,0
1218,25733,AHQHegrW1VuEGnFOHlvBpkb4mWL3NKW9,SpATywNh6bZuzm8s1ceuBUnMUAeoAHHw,29,122,50,33,16,3,41,4,269,38.42857142857143,4,0.0,23,50,27,16,99,3,6,41,4,116,153,0
1219,25804,E7Frt6tr6owhsgLSRkD2PqDaTSKmNLId,7GRhBDsirIGkRZBtSMEzNTyDr2JQm4xx,4,10,2,0,0,0,3,0,15,2.142857142857143,2,0.0,3,2,0,0,7,0,0,3,0,5,10,1
1220,25814,XfsOspDiOb9wQgSI2MsAsoTalG7mdDaH,A3fsA9Zfv1X2fVEQhTw51lKENdNrEqT3,26,56,2,0,2,0,18,2,80,11.428571428571429,5,0.0,1,2,0,2,55,0,0,18,2,5,75,1
1221,25816,lMefkcgNh5NMvOXiUOkNuemhw07vFq2i,SpATywNh6bZuzm8s1ceuBUnMUAeoAHHw,21,15,12,0,7,6,9,0,49,7.0,2,0.0,1,12,0,7,14,6,0,9,0,20,29,0
1222,25826,mLf710wFmDQbZB0X7jv0DPpqMqjMZwPk,SpATywNh6bZuzm8s1ceuBUnMUAeoAHHw,18,20,10,14,6,3,3,0,56,8.0,1,0.0,8,10,14,6,12,3,0,3,0,38,18,1
1223,25915,iyIAPlnIEma306NSolsaccbjttZIVUuH,SpATywNh6bZuzm8s1ceuBUnMUAeoAHHw,29,33,13,31,7,0,7,0,91,13.0,3,0.0,17,13,28,7,16,0,3,7,0,65,26,0
1224,25927,OrVbBbY1FlOrLC1xq9uXlMrFdoBE11eg,SpATywNh6bZuzm8s1ceuBUnMUAeoAHHw,16,15,7,10,4,4,1,0,41,5.857142857142857,1,0.0,3,7,9,4,12,4,1,1,0,23,18,0
1225,25936,Q0eCH09NIGOawcyrOKgsrxZbMJuOLuiw,A3fsA9Zfv1X2fVEQhTw51lKENdNrEqT3,57,80,38,68,30,0,5,0,221,31.571428571428573,2,0.0,1,38,57,30,79,0,11,5,0,126,95,0
1226,25939,Krxyy23fZ28ymHlUM9cR68oteYOpMEoc,bWdj2GDclj5ofokWjzoa5jAwMkxCykd6,4,3,2,0,0,0,1,0,6,0.8571428571428571,1,0.0,0,2,0,0,3,0,0,1,0,2,4,0
1227,25956,iHFiZ9SvBVcIu7YGo4eFTUpkfFG44jX7,SpATywNh6bZuzm8s1ceuBUnMUAeoAHHw,3,5,3,0,0,0,1,0,9,1.2857142857142858,3,0.0,0,3,0,0,5,0,0,1,0,3,6,0
1228,26009,RADrfrSrqd2D1lhkJRYdtWMv0TybV2Zk,A3fsA9Zfv1X2fVEQhTw51lKENdNrEqT3,7,5,1,0,1,0,2,0,9,1.2857142857142858,2,0.0,0,1,0,1,5,0,0,2,0,2,7,1
1229,26024,niLMw8MCObO7SSR2V1jNg9WQt5oSjDFJ,7GRhBDsirIGkRZBtSMEzNTyDr2JQm4xx,4,7,2,0,0,0,1,0,10,1.4285714285714286,1,0.0,4,2,0,0,3,0,0,1,0,6,4,1
1230,26078,ByDjTuY0oLVzrle7JgW0XGlu5bLAo5Uj,SpATywNh6bZuzm8s1ceuBUnMUAeoAHHw,1,0,0,0,0,0,3,0,3,0.42857142857142855,3,0.0,0,0,0,0,0,0,0,3,0,0,3,0
1231,26245,SrYdmWsdLgR34Xuoeb5msz3OavGm9rEt,SpATywNh6bZuzm8s1ceuBUnMUAeoAHHw,6,9,5,0,0,0,4,0,18,2.5714285714285716,2,0.0,1,5,0,0,8,0,0,4,0,6,12,0
1232,26268,tynbQ4TjTy74SqA5UqLPd55W0CYMmxkv,bWdj2GDclj5ofokWjzoa5jAwMkxCykd6,13,19,9,10,4,0,7,0,49,7.0,3,0.0,7,9,7,4,12,0,3,7,0,27,22,0
1233,26300,skOScgcMIkYsPXikHjLqvicjdb3rv6St,G8EPVSXsOYB5YQWZGiz1aVq5Pgr2GrQu,14,19,6,33,2,0,5,0,65,9.285714285714286,1,0.0,3,6,27,2,16,0,6,5,0,38,27,1
1234,26317,Ke04PwAVtaYumEPrCNIyUmIZgpnMElWJ,SpATywNh6bZuzm8s1ceuBUnMUAeoAHHw,7,5,4,0,1,0,1,0,11,1.5714285714285714,1,0.0,0,4,0,1,5,0,0,1,0,5,6,1
1235,26340,nLSyDmuwtZ9VcSdeL7kW6FG97w0wmm94,SpATywNh6bZuzm8s1ceuBUnMUAeoAHHw,18,23,14,14,8,0,5,0,64,9.142857142857142,3,0.0,4,14,13,8,19,0,1,5,0,39,25,0
1236,26353,EHRxEuwJ6W1Usro8hvBy0CGhrazjH6cO,SpATywNh6bZuzm8s1ceuBUnMUAeoAHHw,11,6,4,0,4,0,2,0,16,2.2857142857142856,1,0.0,0,4,0,4,6,0,0,2,0,8,8,0
1237,26357,BNkiF9A7J88AJfBxuk7BTxSVookFJYSj,SpATywNh6bZuzm8s1ceuBUnMUAeoAHHw,15,20,1,16,0,19,8,1,65,9.285714285714286,2,0.0,2,1,14,0,18,19,2,8,1,17,48,0
1238,26398,x4ez09GGWUnioTSf6qckx5goNY5giLKq,7GRhBDsirIGkRZBtSMEzNTyDr2JQm4xx,36,59,15,120,18,4,10,0,226,32.285714285714285,2,0.0,38,15,108,18,21,4,12,10,0,179,47,0
1239,26399,Ke04PwAVtaYumEPrCNIyUmIZgpnMElWJ,A3fsA9Zfv1X2fVEQhTw51lKENdNrEqT3,9,4,2,14,0,0,1,0,21,3.0,1,0.0,1,2,14,0,3,0,0,1,0,17,4,1
1240,26430,LqtuGUVCKWBEA86X4uy5b4ZjnXPoVVJt,SpATywNh6bZuzm8s1ceuBUnMUAeoAHHw,14,16,1,12,0,0,1,0,30,4.285714285714286,1,0.0,6,1,10,0,10,0,2,1,0,17,13,0
1241,26436,J7iejq5NtsfdHjPTK3MrPhGPRoJN9WrB,A3fsA9Zfv1X2fVEQhTw51lKENdNrEqT3,1,1,0,0,0,0,0,0,1,0.14285714285714285,1,0.0,0,0,0,0,1,0,0,0,0,0,1,0
1242,26460,oNf6qoW6E6dhoPJKSUjvElFlUKN9drLY,SpATywNh6bZuzm8s1ceuBUnMUAeoAHHw,14,17,7,0,4,0,2,0,30,4.285714285714286,1,0.0,9,7,0,4,8,0,0,2,0,20,10,0
1243,26464,xioMf6frC9P8sc1cIrYLanKwZwDuxRiz,G8EPVSXsOYB5YQWZGiz1aVq5Pgr2GrQu,44,25,10,121,12,1,10,1,180,25.714285714285715,2,0.0,15,10,104,12,10,1,17,10,1,141,39,0
1244,26489,PD0QXI0Ip2PVwJ6kJaKkkINkj7BvGZMC,SpATywNh6bZuzm8s1ceuBUnMUAeoAHHw,17,28,0,27,0,0,5,0,60,8.571428571428571,1,0.0,10,0,23,0,18,0,4,5,0,33,27,0
1245,26497,lHqsd1041AF6CV0C0CnR0FxJTQGWXgTK,SpATywNh6bZuzm8s1ceuBUnMUAeoAHHw,7,5,0,0,2,0,1,0,8,1.1428571428571428,1,0.0,1,0,0,2,4,0,0,1,0,3,5,1
1246,26528,CiVcRubRqdt8MrzyUg75lzZmUZcaVQVo,SpATywNh6bZuzm8s1ceuBUnMUAeoAHHw,1,0,0,0,0,0,2,0,2,0.2857142857142857,1,0.0,0,0,0,0,0,0,0,2,0,0,2,0
1247,26572,h5vEAVTb94xGNGjpn4Ohi5mNcXfM0rMl,SpATywNh6bZuzm8s1ceuBUnMUAeoAHHw,9,16,4,0,3,0,8,0,31,4.428571428571429,2,0.0,0,4,0,3,16,0,0,8,0,7,24,0
1248,26574,kSTg1JLYdhltSJsPuKhUcTkKXIqnVUW2,SpATywNh6bZuzm8s1ceuBUnMUAeoAHHw,4,3,1,0,0,0,1,0,5,0.7142857142857143,1,0.0,0,1,0,0,3,0,0,1,0,1,4,1
1249,26610,xzPjA6KrslcE6S6chFTjdwgsvoAelzjQ,G8EPVSXsOYB5YQWZGiz1aVq5Pgr2GrQu,15,16,8,2,5,0,3,0,34,4.857142857142857,2,0.0,4,8,1,5,12,0,1,3,0,18,16,0
1250,26624,bwFkbWIAdNVUMLQhE1w1MjvyFVabaAgW,SpATywNh6bZuzm8s1ceuBUnMUAeoAHHw,11,13,8,0,4,0,4,0,29,4.142857142857143,4,0.0,0,8,0,4,13,0,0,4,0,12,17,0
1251,26634,rrQbAPV4QBpP2BW10bzZtz96beXLch00,SpATywNh6bZuzm8s1ceuBUnMUAeoAHHw,14,13,8,8,4,0,4,0,37,5.285714285714286,3,0.0,2,8,7,4,11,0,1,4,0,21,16,1
1252,26640,RbUxQb46RHLKt8MRdcRI6KFNQeGEWd4E,7GRhBDsirIGkRZBtSMEzNTyDr2JQm4xx,19,45,21,6,12,0,8,0,92,13.142857142857142,4,0.0,20,21,6,12,25,0,0,8,0,59,33,1
1253,26672,XN0YlXkOOCzzQkjkPHbmHYzBt2kMHbPM,G8EPVSXsOYB5YQWZGiz1aVq5Pgr2GrQu,9,22,2,0,2,0,4,0,30,4.285714285714286,2,0.0,2,2,0,2,20,0,0,4,0,6,24,0
1254,26693,HAPPxnLUjIhcauBZnnWBFk3JE6gETTxa,A3fsA9Zfv1X2fVEQhTw51lKENdNrEqT3,20,17,12,0,11,0,2,0,42,6.0,1,0.0,4,12,0,11,13,0,0,2,0,27,15,1
1255,26763,6gAyvwJKSeHOrljTS7vTc1U71cPBh7nb,RXDvfPUBYFlVdlueBFbLW0mhhAyGEqpt,3,2,0,0,0,0,1,0,3,0.42857142857142855,1,0.0,0,0,0,0,2,0,0,1,0,0,3,0
1256,26801,q2xQCstASp96wpspi8iqsuaqJ7gzfsux,SpATywNh6bZuzm8s1ceuBUnMUAeoAHHw,4,4,3,0,0,0,2,0,9,1.2857142857142858,1,0.0,0,3,0,0,4,0,0,2,0,3,6,0
1257,26811,S4x7F2zwGMymIPjPy7YGoWTUwlKzmNvg,SpATywNh6bZuzm8s1ceuBUnMUAeoAHHw,1,0,0,0,0,0,1,0,1,0.14285714285714285,1,0.0,0,0,0,0,0,0,0,1,0,0,1,0
1258,26816,HCwyZ32TalGxA6ZNHNOB04su4fWSeWBj,A3fsA9Zfv1X2fVEQhTw51lKENdNrEqT3,3,2,1,0,0,0,2,0,5,0.7142857142857143,1,0.0,0,1,0,0,2,0,0,2,0,1,4,0
1259,26863,erDgXJOtYMWq3DbmDGyxl8sIhvZ9oKFE,SpATywNh6bZuzm8s1ceuBUnMUAeoAHHw,21,33,15,31,8,6,10,0,103,14.714285714285714,4,0.0,4,15,26,8,29,6,5,10,0,53,50,0
1260,26877,nE23LYiQpabdXkj6YvKSja9sZnHRizmo,bWdj2GDclj5ofokWjzoa5jAwMkxCykd6,4,10,1,0,0,0,2,0,13,1.8571428571428572,3,0.0,0,1,0,0,10,0,0,2,0,1,12,0
1261,26902,wlMzjZIA65JiQ9JE1VQhTzG17NZZPeo3,SpATywNh6bZuzm8s1ceuBUnMUAeoAHHw,11,23,5,0,3,4,14,1,50,7.142857142857143,5,0.0,0,5,0,3,23,4,0,14,1,8,42,0
1262,26903,1YVr5Tebgu8QXWBg3164QQg1YdmUcYYo,7GRhBDsirIGkRZBtSMEzNTyDr2JQm4xx,4,3,0,0,0,0,1,0,4,0.5714285714285714,1,0.0,0,0,0,0,3,0,0,1,0,0,4,1
1263,26907,sTDzO3bjgLIIYNoWgHN2HiaPZw68DTyo,7GRhBDsirIGkRZBtSMEzNTyDr2JQm4xx,1,0,0,0,0,0,1,0,1,0.14285714285714285,1,0.0,0,0,0,0,0,0,0,1,0,0,1,0
1264,26928,0eeJP6MiDq1cOnP8cGxNMZEXCvgY0tHY,SpATywNh6bZuzm8s1ceuBUnMUAeoAHHw,7,8,6,0,0,0,2,0,16,2.2857142857142856,2,0.0,0,6,0,0,8,0,0,2,0,6,10,0
1265,26931,luNGlNTmJ26UVXohAPNf4yZNgIUDcpxK,SpATywNh6bZuzm8s1ceuBUnMUAeoAHHw,3,2,1,0,0,0,3,0,6,0.8571428571428571,2,0.0,0,1,0,0,2,0,0,3,0,1,5,0
1266,26955,V44Q36yyz0HxZhlrCwrLJjYwv8UzqoCn,A3fsA9Zfv1X2fVEQhTw51lKENdNrEqT3,10,17,8,0,2,0,4,0,31,4.428571428571429,3,0.0,0,8,0,2,17,0,0,4,0,10,21,1
1267,26967,GXmApUIE1IechykqO3xyhcbVn1kfVOsr,SpATywNh6bZuzm8s1ceuBUnMUAeoAHHw,1,0,0,0,0,0,1,0,1,0.14285714285714285,1,0.0,0,0,0,0,0,0,0,1,0,0,1,0
1268,27019,CIg0k418cM4NKEJ0IrZ66fdZQiBikcx7,G8EPVSXsOYB5YQWZGiz1aVq5Pgr2GrQu,7,7,0,0,0,3,5,0,15,2.142857142857143,1,0.0,0,0,0,0,7,3,0,5,0,0,15,0
1269,27085,Y1uVq657IWCue4abNsh62IVHKtmwsQHQ,SpATywNh6bZuzm8s1ceuBUnMUAeoAHHw,20,24,14,12,6,1,7,1,65,9.285714285714286,2,0.0,6,14,12,6,18,1,0,7,1,38,27,0
1270,27087,1sf1a7OMEvwky5hvLFD12TaOsmoNw2Qb,G8EPVSXsOYB5YQWZGiz1aVq5Pgr2GrQu,5,5,2,0,1,0,1,0,9,1.2857142857142858,1,0.0,1,2,0,1,4,0,0,1,0,4,5,0
1271,27140,9zKzyrDc2ZLmZJn8iNzeeCTIcbRbidfo,A3fsA9Zfv1X2fVEQhTw51lKENdNrEqT3,27,9,6,48,0,14,14,1,92,13.142857142857142,1,0.0,1,6,44,0,8,14,4,14,1,51,41,0
1272,27145,5pjAdY5K4FfgQPLSzQKwXaKF78ph9a0y,A3fsA9Zfv1X2fVEQhTw51lKENdNrEqT3,8,10,6,0,0,0,5,0,21,3.0,2,0.0,0,6,0,0,10,0,0,5,0,6,15,0
1273,27154,zi3yOAhUK1J3AbYoEq9VqjXWOhiWlKvY,SpATywNh6bZuzm8s1ceuBUnMUAeoAHHw,13,18,0,0,1,32,5,0,56,8.0,1,0.0,6,0,0,1,12,32,0,5,0,7,49,0
1274,27171,EUmZ5qzjwgko2PIWEnctkvYh7APnUrX9,G8EPVSXsOYB5YQWZGiz1aVq5Pgr2GrQu,5,2,1,0,1,0,3,0,7,1.0,2,0.0,0,1,0,1,2,0,0,3,0,2,5,1
1275,27209,147kfUKOVzUnQEgEhu4oFkvvuFRbAg9Y,bWdj2GDclj5ofokWjzoa5jAwMkxCykd6,9,7,5,0,5,2,1,0,20,2.857142857142857,1,0.0,0,5,0,5,7,2,0,1,0,10,10,1
1276,27230,uciz4weP1kSziQB1Oe1Psu4CdK1uNqzl,SpATywNh6bZuzm8s1ceuBUnMUAeoAHHw,10,11,6,0,1,16,4,0,38,5.428571428571429,1,0.0,3,6,0,1,8,16,0,4,0,10,28,0
1277,27245,L6Tc39ltUCigrI45L69IfmvrMsjwxFPz,RXDvfPUBYFlVdlueBFbLW0mhhAyGEqpt,21,16,8,51,9,41,8,0,133,19.0,2,0.0,6,8,46,9,10,41,5,8,0,69,64,0
1278,27263,X5ugOWLhdmTxo3CYqfXWDVoDsvjcSnkc,SpATywNh6bZuzm8s1ceuBUnMUAeoAHHw,4,2,1,0,0,0,3,0,6,0.8571428571428571,2,0.0,0,1,0,0,2,0,0,3,0,1,5,0
1279,27306,tTMyaWTlizKdT72ief23Wjd2wqSzEHSk,bWdj2GDclj5ofokWjzoa5jAwMkxCykd6,10,14,7,0,5,0,3,0,29,4.142857142857143,1,0.0,0,7,0,5,14,0,0,3,0,12,17,0
1280,27327,JiMk3YzOg8oAYgApOK7xg1JGgnoRvDfl,SpATywNh6bZuzm8s1ceuBUnMUAeoAHHw,21,23,8,15,5,3,7,3,64,9.142857142857142,1,0.0,14,8,12,5,9,3,3,7,3,39,25,0
1281,27386,jQaCxlcrIW3B0ti76HtzjtRZOLJHPbzy,RXDvfPUBYFlVdlueBFbLW0mhhAyGEqpt,6,12,7,0,0,16,2,0,37,5.285714285714286,2,0.0,0,7,0,0,12,16,0,2,0,7,30,0
1282,27387,FFlICu8a1PeaY8oKBFESJAT3q6I5h6Xu,SpATywNh6bZuzm8s1ceuBUnMUAeoAHHw,4,3,2,0,0,0,1,0,6,0.8571428571428571,1,0.0,0,2,0,0,3,0,0,1,0,2,4,0
1283,27401,BvCRPlMfMau2kDEBEjyV1l6RJMQy5B5l,7GRhBDsirIGkRZBtSMEzNTyDr2JQm4xx,8,9,5,0,0,0,2,0,16,2.2857142857142856,1,0.0,1,5,0,0,8,0,0,2,0,6,10,1
1284,27412,JKpUdoayexmnBaGuLjDe4nN4yf5KTJWi,SpATywNh6bZuzm8s1ceuBUnMUAeoAHHw,8,7,4,0,3,0,3,0,17,2.4285714285714284,1,0.0,0,4,0,3,7,0,0,3,0,7,10,0
1285,27418,46ijefZyx5KF4YGCmdayIapXrAG6omzt,SpATywNh6bZuzm8s1ceuBUnMUAeoAHHw,7,5,2,10,0,0,1,0,18,2.5714285714285716,2,0.0,2,2,9,0,3,0,1,1,0,13,5,0
1286,27445,M5fmtGmpo2DUfH2kBcBzBwkDFjGnGDqf,7GRhBDsirIGkRZBtSMEzNTyDr2JQm4xx,5,5,0,2,0,0,2,0,9,1.2857142857142858,1,0.0,2,0,1,0,3,0,1,2,0,3,6,1
1287,27464,XLmXRx6QIJBEWZLK5otMq8wfQNXonT4D,SpATywNh6bZuzm8s1ceuBUnMUAeoAHHw,2,0,1,0,1,0,0,0,2,0.2857142857142857,1,0.0,0,1,0,1,0,0,0,0,0,2,0,0
1288,27475,mEMC3mPRFcLDpf0MVM7Pji9FNHa590x9,SpATywNh6bZuzm8s1ceuBUnMUAeoAHHw,17,39,18,13,0,2,5,0,77,11.0,2,0.0,16,18,10,0,23,2,3,5,0,44,33,1
1289,27478,dgp1qm7PjXoVV4MjyzuvWetQrJ3T9kos,7GRhBDsirIGkRZBtSMEzNTyDr2JQm4xx,22,70,33,8,36,20,6,0,173,24.714285714285715,2,0.0,32,33,8,36,38,20,0,6,0,109,64,1
1290,27523,8ga3z0NKN1WQ3YzAZr5NtUzbD9BjtY0C,G8EPVSXsOYB5YQWZGiz1aVq5Pgr2GrQu,5,8,5,0,0,0,5,0,18,2.5714285714285716,1,0.0,0,5,0,0,8,0,0,5,0,5,13,0
1291,27548,azOWgfyXQBkztOqJ4AAsFqAk137ZwNDW,SpATywNh6bZuzm8s1ceuBUnMUAeoAHHw,20,33,23,18,0,6,15,1,96,13.714285714285714,3,0.0,2,23,14,0,31,6,4,15,1,39,57,0
1292,30652,c0SE05tRjiEOaThvWcYxSYbAxboLNaZo,7GRhBDsirIGkRZBtSMEzNTyDr2JQm4xx,2,0,0,0,0,0,4,0,4,0.5714285714285714,1,0.0,0,0,0,0,0,0,0,4,0,0,4,0
1293,30662,4Y6ySID5iQf80xGHEGKPq13tPSHHOAOF,7GRhBDsirIGkRZBtSMEzNTyDr2JQm4xx,20,24,7,40,5,0,3,0,79,11.285714285714286,2,0.0,9,7,32,5,15,0,8,3,0,53,26,0
1294,30690,AcpmcKbkGL0wHG2z3MmcGuG9z6KsBEJe,7GRhBDsirIGkRZBtSMEzNTyDr2JQm4xx,22,39,17,24,7,4,8,0,99,14.142857142857142,4,0.0,17,17,20,7,22,4,4,8,0,61,38,0
1295,30695,uqA5Smdw6BACOcL0f2tmxwTTxZXBpZpE,7GRhBDsirIGkRZBtSMEzNTyDr2JQm4xx,20,27,8,12,9,6,1,0,63,9.0,1,0.0,15,8,7,9,12,6,5,1,0,39,24,1
1296,30717,Upqz62cwWKexlUMk4uvP9aosOnbcADgX,7GRhBDsirIGkRZBtSMEzNTyDr2JQm4xx,72,116,32,132,17,2,23,0,322,46.0,5,0.0,54,32,120,17,62,2,12,23,0,223,99,0
1297,30722,N0Sos51WanCzoSGKDmMPzQtMlLxY3bFb,7GRhBDsirIGkRZBtSMEzNTyDr2JQm4xx,31,39,21,12,21,0,2,0,95,13.571428571428571,1,0.0,16,21,11,21,23,0,1,2,0,69,26,0
1298,30730,NoqigwhYAB9TtnANg1WMYh4zsRGoOl0D,7GRhBDsirIGkRZBtSMEzNTyDr2JQm4xx,69,89,51,61,34,0,21,0,256,36.57142857142857,4,0.0,30,51,46,34,59,0,15,21,0,161,95,0
1299,30742,m7YQyhtMcEUVm4YEl0ls7E37ljO7KzRy,7GRhBDsirIGkRZBtSMEzNTyDr2JQm4xx,28,86,30,46,4,2,7,0,175,25.0,3,0.0,38,30,42,4,48,2,4,7,0,114,61,0
1300,30747,tLopTDeUShprCRgfwS3p7Zbir4u3Yxe8,7GRhBDsirIGkRZBtSMEzNTyDr2JQm4xx,9,7,5,0,5,0,1,0,18,2.5714285714285716,1,0.0,0,5,0,5,7,0,0,1,0,10,8,1
1301,30750,yk7hISr9k5KlTllac6P28wE1wuN0cd27,7GRhBDsirIGkRZBtSMEzNTyDr2JQm4xx,45,125,15,123,29,24,6,0,322,46.0,3,0.0,90,15,108,29,35,24,15,6,0,242,80,0
1302,30756,5He5r20lSAk84shJAoxdWcVq0zVfBWNL,7GRhBDsirIGkRZBtSMEzNTyDr2JQm4xx,50,91,33,135,6,50,6,0,321,45.857142857142854,2,0.0,32,33,114,6,59,50,21,6,0,185,136,0
1303,30776,YtymNq1ebo5JQ6VlWg3H52cMIU1je3tP,SpATywNh6bZuzm8s1ceuBUnMUAeoAHHw,6,8,4,0,1,0,1,0,14,2.0,1,0.0,2,4,0,1,6,0,0,1,0,7,7,0
1304,30784,SmONSyS4YgG4Afnv6ZxU81t7p4CQPV5P,SpATywNh6bZuzm8s1ceuBUnMUAeoAHHw,24,41,3,23,1,2,6,3,79,11.285714285714286,1,0.0,13,3,20,1,28,2,3,6,3,37,42,1
1305,30797,S0OJjF6aof0iTnIX6lUAxekoH3m4w7V0,bWdj2GDclj5ofokWjzoa5jAwMkxCykd6,18,12,6,12,3,0,5,0,38,5.428571428571429,2,0.0,3,6,12,3,9,0,0,5,0,24,14,0
1306,30824,VpttOLX6WfGZBZLZt8acfk7430VwqHRi,RXDvfPUBYFlVdlueBFbLW0mhhAyGEqpt,51,48,35,93,16,31,6,0,229,32.714285714285715,1,0.0,9,35,92,16,39,31,1,6,0,152,77,1
1307,30830,Uj0YzcfvBcWRuM5ooqhtOKSU0RtOgHEO,SpATywNh6bZuzm8s1ceuBUnMUAeoAHHw,23,16,13,10,7,0,2,0,48,6.857142857142857,2,0.0,1,13,9,7,15,0,1,2,0,30,18,0
1308,30842,aacyvESmAfP5D5oPQjdLdL2QR8GRVLet,SpATywNh6bZuzm8s1ceuBUnMUAeoAHHw,18,20,10,9,5,0,3,0,47,6.714285714285714,1,0.0,3,10,8,5,17,0,1,3,0,26,21,0
1309,30844,BzAEXi273boWm5fg8ZX5MfzoC5AJdE3M,SpATywNh6bZuzm8s1ceuBUnMUAeoAHHw,18,11,8,10,4,0,2,0,35,5.0,1,0.0,2,8,10,4,9,0,0,2,0,24,11,1
1310,30851,dEqFTu442IbDfPtop0GcM4lzz1lxVMo1,7GRhBDsirIGkRZBtSMEzNTyDr2JQm4xx,12,26,6,2,5,0,2,0,41,5.857142857142857,3,0.0,4,6,2,5,22,0,0,2,0,17,24,0
1311,30887,1NNWgXZojZkqAeoQhcUz4Xc8qgLXmALC,SpATywNh6bZuzm8s1ceuBUnMUAeoAHHw,6,44,29,0,25,0,2,0,100,14.285714285714286,7,0.0,0,29,0,25,44,0,0,2,0,54,46,0
1312,30889,9MbsP03nqyzNF8ytIM40Tx9W50TUxwHO,SpATywNh6bZuzm8s1ceuBUnMUAeoAHHw,18,46,1,9,1,0,11,0,68,9.714285714285714,4,0.0,2,1,9,1,44,0,0,11,0,13,55,0
1313,30905,5GkxvaD11peDsZoT8jF1pQZKBzcvYxOV,G8EPVSXsOYB5YQWZGiz1aVq5Pgr2GrQu,11,8,5,10,1,1,10,0,35,5.0,3,0.0,0,5,9,1,8,1,1,10,0,15,20,0
1314,30907,LKEJY5MvP0gj7M4NL5iRnXDBazXBKsOA,SpATywNh6bZuzm8s1ceuBUnMUAeoAHHw,2,0,0,0,0,0,7,0,7,1.0,3,0.0,0,0,0,0,0,0,0,7,0,0,7,0
1315,30948,CfeENerIdAGepleePWSt0SV88ctt0Tmw,G8EPVSXsOYB5YQWZGiz1aVq5Pgr2GrQu,65,87,41,128,22,0,3,0,281,40.142857142857146,6,0.0,10,41,112,22,77,0,16,3,0,185,96,0
1316,31010,u8YPaORaz1zRBmx3Zp1zm30bQFzwDInM,SpATywNh6bZuzm8s1ceuBUnMUAeoAHHw,17,45,14,17,5,0,3,0,84,12.0,2,0.0,17,14,16,5,28,0,1,3,0,52,32,0
1317,31062,CfeENerIdAGepleePWSt0SV88ctt0Tmw,A3fsA9Zfv1X2fVEQhTw51lKENdNrEqT3,8,14,6,0,1,0,3,0,24,3.4285714285714284,3,0.0,0,6,0,1,14,0,0,3,0,7,17,1
1318,31089,MxVVcAtMSnLQjlvLOx5XySlZblFVugTc,SpATywNh6bZuzm8s1ceuBUnMUAeoAHHw,18,54,0,18,0,0,14,0,86,12.285714285714286,2,0.0,13,0,17,0,41,0,1,14,0,30,56,0
1319,31137,JP79INNRcQzkUx6dZie4v1QvuMQ7OVUy,RXDvfPUBYFlVdlueBFbLW0mhhAyGEqpt,36,120,4,53,5,8,12,1,203,29.0,3,0.0,11,4,45,5,109,8,8,12,1,65,138,0
1320,31176,In25hAYYA32yjVT3Fete5XUoGWlQgd5t,G8EPVSXsOYB5YQWZGiz1aVq5Pgr2GrQu,44,19,0,90,0,0,1,0,110,15.714285714285714,1,0.0,4,0,85,0,15,0,5,1,0,89,21,0
1321,31215,5Gf23uaI2ID1BMi2tbrzYBqwuoTD7nj1,G8EPVSXsOYB5YQWZGiz1aVq5Pgr2GrQu,31,30,19,42,3,0,11,0,105,15.0,4,0.0,2,19,42,3,28,0,0,11,0,66,39,0
1322,31225,FHIf7MUGEVUr0CqbuDIIiBw1QO6ZVxVj,SpATywNh6bZuzm8s1ceuBUnMUAeoAHHw,16,40,0,2,1,24,21,2,90,12.857142857142858,3,0.0,9,0,2,1,31,24,0,21,2,12,78,0
1323,31294,wAJGUOfaMNSu8fVs50XbquwP1qlCP18o,7GRhBDsirIGkRZBtSMEzNTyDr2JQm4xx,47,156,45,73,34,17,9,0,334,47.714285714285715,4,0.0,85,45,53,34,71,17,20,9,0,217,117,0
1324,31314,lk5cMwU2ei6fPMwij7uDCwcTMg6KbTEh,RXDvfPUBYFlVdlueBFbLW0mhhAyGEqpt,26,40,20,0,12,0,7,1,80,11.428571428571429,2,0.0,0,20,0,12,40,0,0,7,1,32,48,0
1325,31315,flpVPPsUWfhNx2m3NGTbdkxp57HITcVF,SpATywNh6bZuzm8s1ceuBUnMUAeoAHHw,5,9,5,0,0,0,8,0,22,3.142857142857143,5,0.0,0,5,0,0,9,0,0,8,0,5,17,0
1326,31322,HgQbl59wfMZ62eOeVscJctviZYi0GAnj,SpATywNh6bZuzm8s1ceuBUnMUAeoAHHw,17,13,8,19,3,10,5,1,59,8.428571428571429,1,0.0,4,8,16,3,9,10,3,5,1,31,28,0
1327,31349,RAFVAKoL6cQatcQ8rTN5mIwPhy02koDR,A3fsA9Zfv1X2fVEQhTw51lKENdNrEqT3,3,8,4,0,0,0,5,0,17,2.4285714285714284,4,0.0,0,4,0,0,8,0,0,5,0,4,13,0
1328,31368,q15es4hix4DJR5zOH0N1aGsdTpjonWNC,SpATywNh6bZuzm8s1ceuBUnMUAeoAHHw,4,6,1,0,0,32,5,0,44,6.285714285714286,3,0.0,0,1,0,0,6,32,0,5,0,1,43,0
1329,31414,StcFIgK5T4YiiLiOpPHFjzohTVz9Jaf7,A3fsA9Zfv1X2fVEQhTw51lKENdNrEqT3,3,4,4,0,4,0,0,0,12,1.7142857142857142,3,0.0,0,4,0,4,4,0,0,0,0,8,4,0
1330,31419,o7pzdRTO1dnxuhf9kxurH0oMz67aa1kw,SpATywNh6bZuzm8s1ceuBUnMUAeoAHHw,1,0,0,0,0,0,1,0,1,0.14285714285714285,1,0.0,0,0,0,0,0,0,0,1,0,0,1,1
1331,31452,ouZJjXOMfv0cgbezRQ2yVqJJVKJPFP9g,SpATywNh6bZuzm8s1ceuBUnMUAeoAHHw,9,17,1,0,1,0,3,0,22,3.142857142857143,2,0.0,0,1,0,1,17,0,0,3,0,2,20,1
1332,31455,AX9Hte0A6zp61WUmhFkv1rU3P0cKffFQ,SpATywNh6bZuzm8s1ceuBUnMUAeoAHHw,13,16,2,16,0,0,7,0,41,5.857142857142857,3,0.0,2,2,14,0,14,0,2,7,0,18,23,0
1333,31486,CTfjOlWW4k8IhTEXOJYJ7bo74K8z07kZ,bWdj2GDclj5ofokWjzoa5jAwMkxCykd6,16,22,8,10,7,1,7,1,56,8.0,1,0.0,4,8,8,7,18,1,2,7,1,27,29,0
1334,31493,iGNqI0WQkdTRPPMB99MG4DRoKjQuEfCJ,SpATywNh6bZuzm8s1ceuBUnMUAeoAHHw,9,11,1,6,0,0,4,0,22,3.142857142857143,4,0.0,0,1,5,0,11,0,1,4,0,6,16,0
1335,31521,SQBW44VzMb5zXQWTfzFzAP2RU7qxP2su,bWdj2GDclj5ofokWjzoa5jAwMkxCykd6,14,40,24,16,9,0,1,0,90,12.857142857142858,3,0.0,6,24,12,9,34,0,4,1,0,51,39,1
1336,31532,oNX40hvUpCseO8BHKhGJvG2jyQpYKQyk,RXDvfPUBYFlVdlueBFbLW0mhhAyGEqpt,19,19,14,14,2,0,6,0,55,7.857142857142857,2,0.0,0,14,14,2,19,0,0,6,0,30,25,0
1337,31557,H3GbKrAtFVtLEXWNNdFaZDFbuKQIUVPU,SpATywNh6bZuzm8s1ceuBUnMUAeoAHHw,4,8,4,0,0,0,5,0,17,2.4285714285714284,4,0.0,0,4,0,0,8,0,0,5,0,4,13,0
1338,31568,c49ANcMlFceMxZBmI2dFNiETx72UlFpt,SpATywNh6bZuzm8s1ceuBUnMUAeoAHHw,7,6,1,2,0,0,3,0,12,1.7142857142857142,2,0.0,0,1,1,0,6,0,1,3,0,2,10,0
1339,31616,fvZ0NGV51VzyC0WSd0PRSRn84KNPjRPi,SpATywNh6bZuzm8s1ceuBUnMUAeoAHHw,18,19,0,8,0,5,6,0,38,5.428571428571429,1,0.0,0,0,8,0,19,5,0,6,0,8,30,0
1340,31636,8V9pnrkvwK33pI3AiYSlsgxV7TeKgfNZ,G8EPVSXsOYB5YQWZGiz1aVq5Pgr2GrQu,4,4,2,0,0,0,1,0,7,1.0,1,0.0,1,2,0,0,3,0,0,1,0,3,4,0
1341,31637,5vZRuON34JUuUxkGF08Mu94iTiQzZas4,RXDvfPUBYFlVdlueBFbLW0mhhAyGEqpt,6,7,3,0,1,0,2,0,13,1.8571428571428572,1,0.0,0,3,0,1,7,0,0,2,0,4,9,0
1342,31672,kGJ0kJD3LGzwfPeuS19lVyqb4r7gscqA,SpATywNh6bZuzm8s1ceuBUnMUAeoAHHw,6,5,4,0,4,0,1,0,14,2.0,1,0.0,0,4,0,4,5,0,0,1,0,8,6,0
1343,31695,yWhbSfRhq0GQaIid8lmuGTuOjD7iQVVR,SpATywNh6bZuzm8s1ceuBUnMUAeoAHHw,4,5,2,0,0,0,11,0,18,2.5714285714285716,4,0.0,0,2,0,0,5,0,0,11,0,2,16,1
1344,31718,TJ0V0Q8Q7PU7JaM3K55nOnFdpx29qUfy,SpATywNh6bZuzm8s1ceuBUnMUAeoAHHw,5,9,4,0,0,0,5,0,18,2.5714285714285716,2,0.0,0,4,0,0,9,0,0,5,0,4,14,0
1345,31742,Ol0EltSC0dLtmI4Ws0ziQYNZlpSWDTB5,SpATywNh6bZuzm8s1ceuBUnMUAeoAHHw,20,73,4,0,3,1,19,1,101,14.428571428571429,2,0.0,18,4,0,3,55,1,0,19,1,25,76,0
1346,31785,WMHp5hy6JREfQvjE2o6B3Iu0aAWFRyny,SpATywNh6bZuzm8s1ceuBUnMUAeoAHHw,1,0,0,0,0,0,2,0,2,0.2857142857142857,2,0.0,0,0,0,0,0,0,0,2,0,0,2,0
1347,31792,ZNcLOAJ2r3H5DqhbGk1CiPtwI7ixaCeK,A3fsA9Zfv1X2fVEQhTw51lKENdNrEqT3,30,16,13,34,9,0,4,0,76,10.857142857142858,2,0.0,0,13,33,9,16,0,1,4,0,55,21,0
1348,31869,R2cga9JVVM2tXEVs2saYswslfxAU4nMk,SpATywNh6bZuzm8s1ceuBUnMUAeoAHHw,7,3,1,8,0,0,3,0,15,2.142857142857143,1,0.0,2,1,8,0,1,0,0,3,0,11,4,0
1349,31877,ioaeb7d1U29jI9wsI7DHJ7aiuWWVX3KB,RXDvfPUBYFlVdlueBFbLW0mhhAyGEqpt,3,2,0,0,0,0,2,0,4,0.5714285714285714,1,0.0,0,0,0,0,2,0,0,2,0,0,4,0
1350,31996,TZQnDQD4c1wLJcg98vkGC4z0YxJAykwb,SpATywNh6bZuzm8s1ceuBUnMUAeoAHHw,22,30,19,9,12,10,7,3,90,12.857142857142858,2,0.0,5,19,8,12,25,10,1,7,3,44,46,0
1351,32072,oV1ETioZLdwgIeANYoTTe9mpmAow2qIk,A3fsA9Zfv1X2fVEQhTw51lKENdNrEqT3,8,3,2,0,2,0,6,0,13,1.8571428571428572,1,0.0,0,2,0,2,3,0,0,6,0,4,9,0
1352,32112,Jf77UYIvUtofHBGpvQMQ0qUfMZBh9rRJ,SpATywNh6bZuzm8s1ceuBUnMUAeoAHHw,3,2,1,0,0,0,3,0,6,0.8571428571428571,2,0.0,0,1,0,0,2,0,0,3,0,1,5,0
1353,32124,SWaMMFaEgBIwWimOSjcPRySyg7Gfrl6L,SpATywNh6bZuzm8s1ceuBUnMUAeoAHHw,29,29,13,27,7,0,4,1,81,11.571428571428571,1,0.0,6,13,24,7,23,0,3,4,1,50,31,0
1354,32135,610PtRFkaYif9s7nz1Kdra5qTHjPTrYT,SpATywNh6bZuzm8s1ceuBUnMUAeoAHHw,1,0,0,0,0,0,1,0,1,0.14285714285714285,1,0.0,0,0,0,0,0,0,0,1,0,0,1,0
1355,32154,JB5wgKgEAIwYsiifcpDf7iv2yPgMBOVA,SpATywNh6bZuzm8s1ceuBUnMUAeoAHHw,13,26,1,17,0,0,5,0,49,7.0,3,0.0,6,1,16,0,20,0,1,5,0,23,26,0
1356,32159,DyQHVTNiwX6W4PiKOVh8BCoKQr8u7ImW,bWdj2GDclj5ofokWjzoa5jAwMkxCykd6,11,18,1,0,1,0,6,0,26,3.7142857142857144,1,0.0,3,1,0,1,15,0,0,6,0,5,21,1
1357,32162,kAQFM0dEgOQIxOG9jTMe5puRtNxZZWMN,A3fsA9Zfv1X2fVEQhTw51lKENdNrEqT3,28,18,1,102,0,0,4,0,125,17.857142857142858,3,0.0,2,1,90,0,16,0,12,4,0,93,32,0
1358,32165,xVQ88VrIuIA75ygDlevnROobNkwcFnsc,SpATywNh6bZuzm8s1ceuBUnMUAeoAHHw,4,8,0,0,0,9,5,0,22,3.142857142857143,2,0.0,0,0,0,0,8,9,0,5,0,0,22,0
1359,32181,yz5W8rI4J1brvBsiH8Bk8UlG6rKQV6QY,SpATywNh6bZuzm8s1ceuBUnMUAeoAHHw,6,6,5,2,0,0,3,0,16,2.2857142857142856,1,0.0,0,5,1,0,6,0,1,3,0,6,10,0
1360,32220,dpAJ54wEPUDHZcYRCRrxvDfIakq9pmaQ,SpATywNh6bZuzm8s1ceuBUnMUAeoAHHw,1,0,0,0,0,0,2,0,2,0.2857142857142857,2,0.0,0,0,0,0,0,0,0,2,0,0,2,1
1361,32248,s54A0hFU7GzRUM0cq0hWJTDlnMIM1TAX,SpATywNh6bZuzm8s1ceuBUnMUAeoAHHw,10,8,6,0,4,0,2,0,20,2.857142857142857,1,0.0,0,6,0,4,8,0,0,2,0,10,10,1
1362,32253,ttxTsF9ExfVKBVMcQbsoZt6AA8x2bWVB,SpATywNh6bZuzm8s1ceuBUnMUAeoAHHw,12,31,4,22,0,7,8,1,73,10.428571428571429,2,0.0,22,4,19,0,9,7,3,8,1,45,28,1
1363,32266,JfQVgXDVu1NGs9lcRBOD4w6V7BSaZCc2,SpATywNh6bZuzm8s1ceuBUnMUAeoAHHw,31,38,18,24,11,4,8,1,104,14.857142857142858,1,0.0,15,18,24,11,23,4,0,8,1,68,36,1
1364,32281,SSlieJULaqRb1C7jSzOwyPvbJnH3adQv,7GRhBDsirIGkRZBtSMEzNTyDr2JQm4xx,3,1,1,0,1,0,0,0,3,0.42857142857142855,1,0.0,0,1,0,1,1,0,0,0,0,2,1,1
1365,32289,5getYNIZ2hnUwVH9nwJiD9At1XFs260U,RXDvfPUBYFlVdlueBFbLW0mhhAyGEqpt,6,3,0,14,0,0,1,0,18,2.5714285714285716,1,0.0,0,0,13,0,3,0,1,1,0,13,5,0
1366,32338,AgNNzeJI1RzulgZ7Mt174twC5BMmXMhy,SpATywNh6bZuzm8s1ceuBUnMUAeoAHHw,16,49,21,0,0,0,6,0,76,10.857142857142858,1,0.0,10,21,0,0,39,0,0,6,0,31,45,0
1367,32378,dnBboDTKZBSq62soTT8p1zFH5HInmJMi,SpATywNh6bZuzm8s1ceuBUnMUAeoAHHw,7,4,3,0,2,1,4,0,14,2.0,1,0.0,0,3,0,2,4,1,0,4,0,5,9,0
1368,32387,40BfkvCbbDiXljpQ7TxzzDakjMbYaL3S,SpATywNh6bZuzm8s1ceuBUnMUAeoAHHw,3,3,3,0,0,0,1,0,7,1.0,1,0.0,0,3,0,0,3,0,0,1,0,3,4,0
1369,32435,QqE2Xjwy9gUzOvFdkDqAwAaNZLBZkxvd,7GRhBDsirIGkRZBtSMEzNTyDr2JQm4xx,6,5,1,0,0,0,4,0,10,1.4285714285714286,2,0.0,0,1,0,0,5,0,0,4,0,1,9,1
1370,32437,gGSMkNgPdXpBQgdZzyjzifomyCxFSNyt,A3fsA9Zfv1X2fVEQhTw51lKENdNrEqT3,36,23,14,52,7,7,10,0,113,16.142857142857142,5,0.0,1,14,47,7,22,7,5,10,0,69,44,0
1371,32439,sbafJyL5hxYHWbu0cbLBSCFDQh5Oe8Ww,RXDvfPUBYFlVdlueBFbLW0mhhAyGEqpt,16,22,1,1,1,7,1,0,33,4.714285714285714,1,0.0,0,1,1,1,22,7,0,1,0,3,30,0
1372,32471,1BEoeS35Ni9RflXqhdHAKpKpQ07oVqkG,SpATywNh6bZuzm8s1ceuBUnMUAeoAHHw,15,24,1,12,1,0,4,0,42,6.0,2,0.0,7,1,12,1,17,0,0,4,0,21,21,0
1373,32477,LPul7vNnoWP2lahy0vntgg039NwfmlYY,SpATywNh6bZuzm8s1ceuBUnMUAeoAHHw,15,16,1,12,1,0,4,0,34,4.857142857142857,2,0.0,2,1,9,1,14,0,3,4,0,13,21,0
1374,32483,MauXcYq2z30gm4QmDqcfc1IfWjnRlPwg,SpATywNh6bZuzm8s1ceuBUnMUAeoAHHw,5,5,0,0,0,0,1,0,6,0.8571428571428571,1,0.0,0,0,0,0,5,0,0,1,0,0,6,0
1375,32520,AFUJTbEqqgSsqCkUsNrjbPAjZvFwpzeW,G8EPVSXsOYB5YQWZGiz1aVq5Pgr2GrQu,10,20,5,16,5,0,1,0,47,6.714285714285714,1,0.0,6,5,12,5,14,0,4,1,0,28,19,0
1376,32547,wkfBzItw0JCH6ZUz2WUZn7ngJ5M4Oksy,SpATywNh6bZuzm8s1ceuBUnMUAeoAHHw,27,59,5,18,4,71,21,0,178,25.428571428571427,6,0.0,6,5,17,4,53,71,1,21,0,32,146,0
1377,32555,g14jBWDuqUHRwpf4jHpBljeNVwCyjgqd,G8EPVSXsOYB5YQWZGiz1aVq5Pgr2GrQu,13,15,8,0,8,0,1,0,32,4.571428571428571,1,0.0,2,8,0,8,13,0,0,1,0,18,14,1
1378,32579,rQ8twu2Y4JlbZAVSeNSb6mmUSGGvpIAq,SpATywNh6bZuzm8s1ceuBUnMUAeoAHHw,2,0,0,0,0,0,3,0,3,0.42857142857142855,2,0.0,0,0,0,0,0,0,0,3,0,0,3,0
1379,32600,jaDaYkvR41YbLhesvf9mW32i93zNzaSK,RXDvfPUBYFlVdlueBFbLW0mhhAyGEqpt,7,8,5,0,1,0,3,0,17,2.4285714285714284,1,0.0,0,5,0,1,8,0,0,3,0,6,11,0
1380,32617,ncKGr6xR4Vhs3wPeU0aqO1sSEow8LN64,SpATywNh6bZuzm8s1ceuBUnMUAeoAHHw,7,6,3,0,2,0,2,0,13,1.8571428571428572,2,0.0,0,3,0,2,6,0,0,2,0,5,8,0
1381,32634,vjkHj7F0L8pzTZztOfHA8KLslVpjNBKq,G8EPVSXsOYB5YQWZGiz1aVq5Pgr2GrQu,33,33,4,76,2,1,15,3,134,19.142857142857142,2,0.0,14,4,57,2,19,1,19,15,3,77,57,0
1382,32652,nqDX1tmEeTnbqCn9T8Crn5CYQgmIy9Eq,SpATywNh6bZuzm8s1ceuBUnMUAeoAHHw,21,39,24,12,8,10,14,2,109,15.571428571428571,4,0.0,7,24,12,8,32,10,0,14,2,51,58,0
1383,32654,zQwNebC3qLt6HHOuoG7oSsRj8l42sEdO,7GRhBDsirIGkRZBtSMEzNTyDr2JQm4xx,10,16,4,0,2,0,3,1,26,3.7142857142857144,1,0.0,0,4,0,2,16,0,0,3,1,6,20,1
1384,32661,qKc8EuUOlEzXysFMoXghKaieW3HIaePV,SpATywNh6bZuzm8s1ceuBUnMUAeoAHHw,26,51,13,36,7,1,8,0,116,16.571428571428573,3,0.0,13,13,30,7,38,1,6,8,0,63,53,0
1385,32663,RQ7L9CpArhwtUrlKYRf29Ou4YmyW3xpx,A3fsA9Zfv1X2fVEQhTw51lKENdNrEqT3,5,2,2,0,2,0,0,0,6,0.8571428571428571,1,0.0,0,2,0,2,2,0,0,0,0,4,2,0
1386,32675,S65yhLgjTGwwuDt6C6cjI82AJbGfYIiK,SpATywNh6bZuzm8s1ceuBUnMUAeoAHHw,11,9,6,0,3,0,1,0,19,2.7142857142857144,1,0.0,1,6,0,3,8,0,0,1,0,10,9,1
1387,32681,t6I1fQ9ItZRIjAyoxww7ONpoKNI8Ya9L,SpATywNh6bZuzm8s1ceuBUnMUAeoAHHw,11,9,0,22,0,0,7,0,38,5.428571428571429,1,0.0,6,0,20,0,3,0,2,7,0,26,12,0
1388,32686,DE2u0bz0HnoULwJGtrWEHwtLyRyGfjcB,SpATywNh6bZuzm8s1ceuBUnMUAeoAHHw,24,24,13,11,9,2,2,0,61,8.714285714285714,1,0.0,9,13,10,9,15,2,1,2,0,41,20,0
1389,32688,vsH3qB64VOSnSTFhrkJQnHqm8c83psRR,SpATywNh6bZuzm8s1ceuBUnMUAeoAHHw,3,3,2,0,0,8,1,0,14,2.0,1,0.0,0,2,0,0,3,8,0,1,0,2,12,0
1390,32693,NrExtDPytZeckpp4FyIosvaEjFjzywmC,A3fsA9Zfv1X2fVEQhTw51lKENdNrEqT3,21,3,0,68,0,0,5,0,76,10.857142857142858,1,0.0,2,0,63,0,1,0,5,5,0,65,11,1
1391,32701,abaCPMr6xWMrCiOErEioyXWBSEERS1tE,7GRhBDsirIGkRZBtSMEzNTyDr2JQm4xx,12,8,5,0,4,0,6,1,24,3.4285714285714284,1,0.0,3,5,0,4,5,0,0,6,1,12,12,1
1392,32710,HJ2gv3yF0WCJxGH8T6tjLTFYdM4sCizz,RXDvfPUBYFlVdlueBFbLW0mhhAyGEqpt,3,2,1,0,0,0,1,0,4,0.5714285714285714,1,0.0,0,1,0,0,2,0,0,1,0,1,3,0
1393,32722,Jd5OP6GIsguRdsq9k3eSYNENmzhPbdGe,A3fsA9Zfv1X2fVEQhTw51lKENdNrEqT3,7,7,5,0,1,0,2,0,15,2.142857142857143,2,0.0,0,5,0,1,7,0,0,2,0,6,9,0
1394,32732,L74tKRZpBi1qsh0NM3EwE5D87acCLK8s,A3fsA9Zfv1X2fVEQhTw51lKENdNrEqT3,30,31,19,88,10,0,9,0,157,22.428571428571427,6,0.0,2,19,88,10,29,0,0,9,0,119,38,0
1395,32769,vEKYOhRdGZ59kfXY6wTO63YZY4EqPYqX,SpATywNh6bZuzm8s1ceuBUnMUAeoAHHw,1,0,0,0,0,0,1,0,1,0.14285714285714285,1,0.0,0,0,0,0,0,0,0,1,0,0,1,0
1396,32826,wCKxyDpTEsiI3UuDi33CaUGYhXjKnrBv,SpATywNh6bZuzm8s1ceuBUnMUAeoAHHw,14,11,6,6,4,0,2,0,29,4.142857142857143,1,0.0,2,6,5,4,9,0,1,2,0,17,12,0
1397,32837,wZVSpaATIDuE7qW0svZJi84Cpi6PMqWg,SpATywNh6bZuzm8s1ceuBUnMUAeoAHHw,8,16,3,0,1,0,6,0,26,3.7142857142857144,2,0.0,1,3,0,1,15,0,0,6,0,5,21,1
1398,32884,z2Zz9wVXxnQo0wOtqHQc06HPM9iWXDoN,SpATywNh6bZuzm8s1ceuBUnMUAeoAHHw,5,3,2,0,1,0,3,0,9,1.2857142857142858,1,0.0,0,2,0,1,3,0,0,3,0,3,6,0
1399,32887,9WVTv7dWHzTCHwCGLSPAioAO2udyHWmu,SpATywNh6bZuzm8s1ceuBUnMUAeoAHHw,5,13,5,0,5,0,9,0,32,4.571428571428571,2,0.0,3,5,0,5,10,0,0,9,0,13,19,0
1400,32906,ZE27RADj3bE2oGbL4tXAfIaeVlYNn4oN,SpATywNh6bZuzm8s1ceuBUnMUAeoAHHw,5,8,4,0,2,2,2,0,18,2.5714285714285716,2,0.0,0,4,0,2,8,2,0,2,0,6,12,0
1401,32923,NqKjMSY6eOZQ1uSyzlPrquJVqzjvSO7O,SpATywNh6bZuzm8s1ceuBUnMUAeoAHHw,6,7,0,0,0,3,5,0,15,2.142857142857143,2,0.0,1,0,0,0,6,3,0,5,0,1,14,0
1402,32983,BtS3BvehCjq4QaGPbzrC7JIugP6OKoPy,7GRhBDsirIGkRZBtSMEzNTyDr2JQm4xx,7,12,6,0,4,1,3,0,26,3.7142857142857144,1,0.0,3,6,0,4,9,1,0,3,0,13,13,1
1403,33024,P7HoHyQzVXLghYr6m3MYTEIsDQbHfDfp,SpATywNh6bZuzm8s1ceuBUnMUAeoAHHw,22,18,11,26,6,0,1,0,62,8.857142857142858,2,0.0,6,11,25,6,12,0,1,1,0,48,14,0
1404,33080,5ADMlR48WDr3F57JEz4JNbgGytxoga6J,SpATywNh6bZuzm8s1ceuBUnMUAeoAHHw,12,13,0,13,0,0,15,0,41,5.857142857142857,2,0.0,2,0,13,0,11,0,0,15,0,15,26,0
1405,33108,ixS1p3tBQwqQrlFRj6LavXiIpA0ocHQj,SpATywNh6bZuzm8s1ceuBUnMUAeoAHHw,25,60,4,34,1,0,9,1,109,15.571428571428571,3,0.0,34,4,32,1,26,0,2,9,1,71,38,1
1406,33127,FAyJy1gyoIxzJtXvVglyOve11ozvFF4C,SpATywNh6bZuzm8s1ceuBUnMUAeoAHHw,28,32,15,21,9,0,4,0,81,11.571428571428571,2,0.0,5,15,19,9,27,0,2,4,0,48,33,0
1407,33150,vU01Fxors0KlSd7gao1Z0nHesILTHNPI,SpATywNh6bZuzm8s1ceuBUnMUAeoAHHw,2,0,0,0,0,0,10,0,10,1.4285714285714286,5,0.0,0,0,0,0,0,0,0,10,0,0,10,0
1408,33164,AJYnlahOLAGVXTJrzU8y7gkOQqLtYt6X,SpATywNh6bZuzm8s1ceuBUnMUAeoAHHw,7,8,3,0,0,0,3,0,14,2.0,1,0.0,0,3,0,0,8,0,0,3,0,3,11,0
1409,33169,FPQSXji4bDip0jB4obm0vWFPXClGuSyC,7GRhBDsirIGkRZBtSMEzNTyDr2JQm4xx,3,2,1,0,0,0,1,0,4,0.5714285714285714,1,0.0,0,1,0,0,2,0,0,1,0,1,3,0
1410,33179,79cpMMK2EsbvkowaPozXyQoZKeC4iKuw,A3fsA9Zfv1X2fVEQhTw51lKENdNrEqT3,10,12,8,0,3,0,2,0,25,3.5714285714285716,2,0.0,1,8,0,3,11,0,0,2,0,12,13,0
1411,33203,6oSvXBiE6hMQm6ur1TzQBxRkuWf4UJ1w,SpATywNh6bZuzm8s1ceuBUnMUAeoAHHw,3,2,1,0,0,0,1,0,4,0.5714285714285714,1,0.0,0,1,0,0,2,0,0,1,0,1,3,0
1412,33224,M5i9wheFDK1paYxXA7PsW9kp3DBbWp4e,bWdj2GDclj5ofokWjzoa5jAwMkxCykd6,16,41,12,136,8,2,8,2,209,29.857142857142858,5,0.0,20,12,130,8,21,2,6,8,2,170,39,0
1413,33266,ANj8LPP4QCqsLHbhaQj263PWrIQ9dqGZ,SpATywNh6bZuzm8s1ceuBUnMUAeoAHHw,9,15,0,8,0,0,3,0,26,3.7142857142857144,2,0.0,2,0,6,0,13,0,2,3,0,8,18,0
1414,33270,BFrfDseDfXCBvtTfCsJAy36Ogk6b0Rfx,SpATywNh6bZuzm8s1ceuBUnMUAeoAHHw,3,8,4,0,0,0,4,0,16,2.2857142857142856,4,0.0,0,4,0,0,8,0,0,4,0,4,12,0
1415,33284,jRnFs6XBk6vGxxB24JG9v0Qh3pYfUtLh,RXDvfPUBYFlVdlueBFbLW0mhhAyGEqpt,2,6,1,0,0,0,0,0,7,1.0,3,0.0,0,1,0,0,6,0,0,0,0,1,6,0
1416,33298,wjqMTSqGRhad7XTyyuysYYbP0x4J6ulv,bWdj2GDclj5ofokWjzoa5jAwMkxCykd6,3,1,0,0,0,0,2,0,3,0.42857142857142855,1,0.0,0,0,0,0,1,0,0,2,0,0,3,1
1417,33331,mJNmN9AbVBmhzBfxSlHeSff1yTyr8w50,SpATywNh6bZuzm8s1ceuBUnMUAeoAHHw,3,2,1,0,0,0,1,0,4,0.5714285714285714,1,0.0,0,1,0,0,2,0,0,1,0,1,3,0
1418,33348,we9tWnySpl1G7k7FqyXPj8wmC2gUYK0W,SpATywNh6bZuzm8s1ceuBUnMUAeoAHHw,12,12,0,12,0,3,2,0,29,4.142857142857143,1,0.0,4,0,11,0,8,3,1,2,0,15,14,0
1419,33368,hJo1MgKiPZFXuH2ko6hqPTd9dbjMQKDO,bWdj2GDclj5ofokWjzoa5jAwMkxCykd6,36,32,16,202,7,0,6,0,263,37.57142857142857,4,0.0,10,16,188,7,22,0,14,6,0,221,42,0
1420,33431,viuKt4GgrX0rYL5EpHoxJbsiC9TblSuk,A3fsA9Zfv1X2fVEQhTw51lKENdNrEqT3,11,7,5,0,0,68,14,1,95,13.571428571428571,4,0.0,0,5,0,0,7,68,0,14,1,5,90,0
1421,33443,viuKt4GgrX0rYL5EpHoxJbsiC9TblSuk,bWdj2GDclj5ofokWjzoa5jAwMkxCykd6,18,18,11,6,3,42,13,1,94,13.428571428571429,2,0.0,0,11,3,3,18,42,3,13,1,17,77,0
1422,33455,7usMWWPRRbqHqTGVe4yfuQMnaM8GH1DT,SpATywNh6bZuzm8s1ceuBUnMUAeoAHHw,8,6,4,0,3,1,6,0,20,2.857142857142857,2,0.0,0,4,0,3,6,1,0,6,0,7,13,0
1423,33469,viuKt4GgrX0rYL5EpHoxJbsiC9TblSuk,G8EPVSXsOYB5YQWZGiz1aVq5Pgr2GrQu,20,47,27,0,3,37,11,0,125,17.857142857142858,3,0.0,8,27,0,3,39,37,0,11,0,38,87,0
1424,33481,viuKt4GgrX0rYL5EpHoxJbsiC9TblSuk,RXDvfPUBYFlVdlueBFbLW0mhhAyGEqpt,6,2,1,0,0,19,8,8,38,5.428571428571429,2,0.0,0,1,0,0,2,19,0,8,8,1,37,0
1425,33521,kOcsNetIsK9HFRaYNeKiWrndfQDPUf2b,7GRhBDsirIGkRZBtSMEzNTyDr2JQm4xx,17,41,12,10,12,2,3,0,80,11.428571428571429,3,0.0,26,12,10,12,15,2,0,3,0,60,20,1
1426,33529,sYEBB7Cezd6bYcnMjhqBrC5c63jbJN18,SpATywNh6bZuzm8s1ceuBUnMUAeoAHHw,19,21,13,0,9,0,5,0,48,6.857142857142857,3,0.0,5,13,0,9,16,0,0,5,0,27,21,0
1427,33576,KshwCmsAWd7PYW2Qdxpd0Dd8iC7QTJ5v,SpATywNh6bZuzm8s1ceuBUnMUAeoAHHw,1,0,0,0,0,0,1,0,1,0.14285714285714285,1,0.0,0,0,0,0,0,0,0,1,0,0,1,0
1428,33638,kGNoIC9AxgB9nCs6frsN1R7EeU5BsStD,SpATywNh6bZuzm8s1ceuBUnMUAeoAHHw,9,7,2,9,0,1,1,0,20,2.857142857142857,1,0.0,2,2,8,0,5,1,1,1,0,12,8,1
1429,33644,eE4DAv5aHElS2DPaTad4VXPjk6A3xvPl,G8EPVSXsOYB5YQWZGiz1aVq5Pgr2GrQu,19,24,18,29,3,0,2,0,76,10.857142857142858,2,0.0,0,18,27,3,24,0,2,2,0,48,28,0
1430,33674,Ry5r3PlRYtX7RdQht9vGdro0Bt4zHDPw,SpATywNh6bZuzm8s1ceuBUnMUAeoAHHw,32,56,20,42,8,28,20,3,177,25.285714285714285,4,0.0,18,20,35,8,38,28,7,20,3,81,96,0
1431,33676,csMt1h4jwoK6sZ6rEkcutiAH8F6ocCR4,A3fsA9Zfv1X2fVEQhTw51lKENdNrEqT3,23,4,0,46,0,0,3,0,53,7.571428571428571,1,0.0,1,0,46,0,3,0,0,3,0,47,6,1
1432,34640,n6oy92A0COsM84uyQbTNZ7pqWc0u5Wg0,7GRhBDsirIGkRZBtSMEzNTyDr2JQm4xx,1,0,0,0,0,0,1,0,1,0.14285714285714285,1,0.0,0,0,0,0,0,0,0,1,0,0,1,1
1433,34665,X0fr45rfdEeZ9hURKvWR9AGDFDSFFsR7,7GRhBDsirIGkRZBtSMEzNTyDr2JQm4xx,12,22,6,2,2,0,5,0,37,5.285714285714286,2,0.0,1,6,1,2,21,0,1,5,0,10,27,1
1434,34710,521YJDVy6G9ul5QyLTUZAuztPLpe7gqW,7GRhBDsirIGkRZBtSMEzNTyDr2JQm4xx,3,0,0,0,0,0,3,0,3,0.42857142857142855,1,0.0,0,0,0,0,0,0,0,3,0,0,3,1
1435,34719,42bX0uPWOXgBHMwF4wqdnl1Ve6wIHNQe,7GRhBDsirIGkRZBtSMEzNTyDr2JQm4xx,9,5,3,0,3,0,2,0,13,1.8571428571428572,1,0.0,1,3,0,3,4,0,0,2,0,7,6,1
1436,34725,n8Qj7926d7yvtreYunFCLT4mrboYdeRa,7GRhBDsirIGkRZBtSMEzNTyDr2JQm4xx,14,14,5,4,5,3,9,1,41,5.857142857142857,1,0.0,3,5,3,5,11,3,1,9,1,16,25,1
1437,34738,4en36s6M5dWiGXaOz7Ao485PkasQppcC,7GRhBDsirIGkRZBtSMEzNTyDr2JQm4xx,34,44,15,18,14,10,6,4,111,15.857142857142858,3,0.0,23,15,9,14,21,10,9,6,4,61,50,1
1438,34752,Ul8fOM41ROTx6GwtVQf8fol92V0sOxIU,7GRhBDsirIGkRZBtSMEzNTyDr2JQm4xx,1,0,0,0,0,0,2,0,2,0.2857142857142857,2,0.0,0,0,0,0,0,0,0,2,0,0,2,1
1439,34771,1znu7Xzg4p1qA4YkunjQTwOhXoKFFWr0,7GRhBDsirIGkRZBtSMEzNTyDr2JQm4xx,24,32,2,16,3,1,3,0,57,8.142857142857142,2,0.0,13,2,9,3,19,1,7,3,0,27,30,0
1440,34808,t6gbXbSU5L3FPpVibBhtf9ABrcXvjFov,7GRhBDsirIGkRZBtSMEzNTyDr2JQm4xx,1,0,0,0,0,0,1,0,1,0.14285714285714285,1,0.0,0,0,0,0,0,0,0,1,0,0,1,0
1441,34836,XZ6wb1QGJGwEfyG45cl1hveOKOr0OgzY,7GRhBDsirIGkRZBtSMEzNTyDr2JQm4xx,5,2,1,0,1,0,2,0,6,0.8571428571428571,1,0.0,0,1,0,1,2,0,0,2,0,2,4,1
1442,34841,DBI154fAsTYpTW5PDGxgInzkEniSAAwK,7GRhBDsirIGkRZBtSMEzNTyDr2JQm4xx,1,0,0,0,0,0,1,0,1,0.14285714285714285,1,0.0,0,0,0,0,0,0,0,1,0,0,1,1
1443,34851,BkozGGotFoRWvs7kivTQvwwV5JZ8hddc,7GRhBDsirIGkRZBtSMEzNTyDr2JQm4xx,1,0,0,0,0,0,1,0,1,0.14285714285714285,1,0.0,0,0,0,0,0,0,0,1,0,0,1,0
1444,34867,ZmcKxihZ1R64O2ndnnAR75Wj8TfQ1PuJ,7GRhBDsirIGkRZBtSMEzNTyDr2JQm4xx,8,4,0,4,0,0,5,0,13,1.8571428571428572,1,0.0,1,0,3,0,3,0,1,5,0,4,9,1
1445,34870,OE6rKd9Nqgw6uyQXd4G7Xvv5u5KYnYfc,7GRhBDsirIGkRZBtSMEzNTyDr2JQm4xx,1,0,0,0,0,0,1,0,1,0.14285714285714285,1,0.0,0,0,0,0,0,0,0,1,0,0,1,0
1446,34887,tjK76iagpFGbk5YoF97wIV91VIkWMXeI,7GRhBDsirIGkRZBtSMEzNTyDr2JQm4xx,1,0,0,0,0,0,1,0,1,0.14285714285714285,1,0.0,0,0,0,0,0,0,0,1,0,0,1,1
1447,34895,TPjv2mgvzs8mtuY7ccAmTpwjgR5agCrX,7GRhBDsirIGkRZBtSMEzNTyDr2JQm4xx,4,6,2,0,0,1,2,0,11,1.5714285714285714,1,0.0,2,2,0,0,4,1,0,2,0,4,7,1
1448,34905,lB6Kl0if51YgTDbpdNoXtX6HKiMZvllY,7GRhBDsirIGkRZBtSMEzNTyDr2JQm4xx,1,0,0,0,0,0,1,0,1,0.14285714285714285,1,0.0,0,0,0,0,0,0,0,1,0,0,1,1
1449,34952,Fc6or2UHUceP4nvPJGhwD2OTewY2syOC,7GRhBDsirIGkRZBtSMEzNTyDr2JQm4xx,5,4,1,0,2,0,2,0,9,1.2857142857142858,1,0.0,2,1,0,2,2,0,0,2,0,5,4,1
1450,35056,Az35wHR97uuRkRSgT8BjE6DkhH91OHMF,7GRhBDsirIGkRZBtSMEzNTyDr2JQm4xx,10,11,5,2,3,0,6,1,28,4.0,3,0.0,1,5,2,3,10,0,0,6,1,11,17,1
1451,35087,CfeENerIdAGepleePWSt0SV88ctt0Tmw,7GRhBDsirIGkRZBtSMEzNTyDr2JQm4xx,1,0,0,0,0,0,1,0,1,0.14285714285714285,1,0.0,0,0,0,0,0,0,0,1,0,0,1,1
1452,35128,rOp8aBXrvMFn99ymSn6pN6nQjBR9XCcF,7GRhBDsirIGkRZBtSMEzNTyDr2JQm4xx,5,4,0,0,0,0,3,0,7,1.0,1,0.0,0,0,0,0,4,0,0,3,0,0,7,1
1453,35150,AvQhWM9grultmx48matDmWO7LLNb13dd,7GRhBDsirIGkRZBtSMEzNTyDr2JQm4xx,39,43,12,48,16,4,4,0,127,18.142857142857142,3,0.0,25,12,39,16,18,4,9,4,0,92,35,0
1454,35152,VsfU7jeSb2K8k0CBzCZzXJjDlMye1sB1,7GRhBDsirIGkRZBtSMEzNTyDr2JQm4xx,32,79,34,47,18,0,8,0,186,26.571428571428573,4,0.0,38,34,42,18,41,0,5,8,0,132,54,1
1455,35154,6TeNHmnZsy2QqeLuJegGqbjbPJMrX0FT,7GRhBDsirIGkRZBtSMEzNTyDr2JQm4xx,2,0,0,0,0,0,2,0,2,0.2857142857142857,1,0.0,0,0,0,0,0,0,0,2,0,0,2,1
1456,35156,WDMP5c2Ubx8vVSFegA0mXeU23cYb0qCY,7GRhBDsirIGkRZBtSMEzNTyDr2JQm4xx,11,19,1,14,0,4,5,0,43,6.142857142857143,3,0.0,9,1,10,0,10,4,4,5,0,20,23,1
1457,35159,dJJJLtI6F18pblO9KPkBPg9ZKTgQPaQc,7GRhBDsirIGkRZBtSMEzNTyDr2JQm4xx,30,57,4,79,8,6,4,0,158,22.571428571428573,4,0.0,28,4,71,8,29,6,8,4,0,111,47,0
1458,35160,kThSxP6kRJAiUPqrS6DypsJwuP8aoEPr,7GRhBDsirIGkRZBtSMEzNTyDr2JQm4xx,2,0,0,0,0,0,2,0,2,0.2857142857142857,1,0.0,0,0,0,0,0,0,0,2,0,0,2,0
1459,35165,Gvn1GQVBkQxq6rZTkkY4CKnlRmLWyiJO,7GRhBDsirIGkRZBtSMEzNTyDr2JQm4xx,1,0,0,0,0,0,1,0,1,0.14285714285714285,1,0.0,0,0,0,0,0,0,0,1,0,0,1,1
1460,35167,eU4MPF9R01ru4sQN9giW756pdpNlnW4H,7GRhBDsirIGkRZBtSMEzNTyDr2JQm4xx,29,21,9,30,5,0,5,0,70,10.0,3,0.0,9,9,29,5,12,0,1,5,0,52,18,0
1461,35175,SWRtXIccwFeW0V06tTCrQAmJKwDAOcQm,7GRhBDsirIGkRZBtSMEzNTyDr2JQm4xx,1,0,0,0,0,0,1,0,1,0.14285714285714285,1,0.0,0,0,0,0,0,0,0,1,0,0,1,1
1462,35558,hJwtwnOzJaTrAeP4eXJAEwz2xbKsgc4M,7GRhBDsirIGkRZBtSMEzNTyDr2JQm4xx,3,0,0,0,0,0,6,0,6,0.8571428571428571,2,0.0,0,0,0,0,0,0,0,6,0,0,6,1
1463,35583,O36QxtTrV6jSigC0QBjRMiqSpx0KHX6w,7GRhBDsirIGkRZBtSMEzNTyDr2JQm4xx,40,72,35,52,29,3,9,0,200,28.571428571428573,3,0.0,30,35,42,29,42,3,10,9,0,136,64,0
1464,35592,WgQR6nrfyl7yDpgHC595JSoog2R9VhVs,7GRhBDsirIGkRZBtSMEzNTyDr2JQm4xx,46,73,26,47,28,17,11,1,203,29.0,2,0.0,28,26,38,28,45,17,9,11,1,120,83,0
1465,35594,d6aHeIWZcsirh8eDlHrmG2KrUzDWnJuj,7GRhBDsirIGkRZBtSMEzNTyDr2JQm4xx,11,14,4,0,1,0,6,0,25,3.5714285714285716,1,0.0,6,4,0,1,8,0,0,6,0,11,14,1
1466,35646,CCMzevo14iTCqMsIpKsbx331FhP08gFZ,7GRhBDsirIGkRZBtSMEzNTyDr2JQm4xx,2,0,0,0,0,0,2,0,2,0.2857142857142857,1,0.0,0,0,0,0,0,0,0,2,0,0,2,1
1467,35726,xHZbSROhwP4RRQerUVWvcNTfOGc2DHWf,7GRhBDsirIGkRZBtSMEzNTyDr2JQm4xx,5,5,3,0,1,0,2,0,11,1.5714285714285714,2,0.0,0,3,0,1,5,0,0,2,0,4,7,1
1468,35868,PeCugnCDRTxTqifK7mkc0ffuLTN5EPRT,7GRhBDsirIGkRZBtSMEzNTyDr2JQm4xx,7,10,4,0,1,0,4,0,19,2.7142857142857144,2,0.0,4,4,0,1,6,0,0,4,0,9,10,0
1469,37600,NHGmMinB9WoQusKCx50F4M4nJF124Ms4,A3fsA9Zfv1X2fVEQhTw51lKENdNrEqT3,53,31,24,56,17,0,8,0,136,19.428571428571427,4,0.0,3,24,50,17,28,0,6,8,0,94,42,1
1470,37607,NvmmlHTgNmxqyrQU3a9c6oM8kVrIYu3Q,SpATywNh6bZuzm8s1ceuBUnMUAeoAHHw,5,3,2,0,1,0,1,0,7,1.0,1,0.0,0,2,0,1,3,0,0,1,0,3,4,1
1471,37621,7ynsHGhJ1N4494Hez57ckblgtBNGbed9,A3fsA9Zfv1X2fVEQhTw51lKENdNrEqT3,2,0,0,0,0,0,2,0,2,0.2857142857142857,1,0.0,0,0,0,0,0,0,0,2,0,0,2,1
1472,37627,61Btwz5kWZaS3OIGnNTMXi3lqbtcLCB7,SpATywNh6bZuzm8s1ceuBUnMUAeoAHHw,5,3,1,0,0,0,4,0,8,1.1428571428571428,1,0.0,0,1,0,0,3,0,0,4,0,1,7,1
1473,37675,4P8kDd8yuaZj29FYuMADbc9LGiIxpIwD,bWdj2GDclj5ofokWjzoa5jAwMkxCykd6,13,9,1,36,1,2,11,0,60,8.571428571428571,1,0.0,3,1,31,1,6,2,5,11,0,36,24,1
1474,37686,UkQJwGAwu2oSVR7bdUsiWWEqFzH2qHlf,SpATywNh6bZuzm8s1ceuBUnMUAeoAHHw,3,2,0,0,0,23,1,0,26,3.7142857142857144,1,0.0,0,0,0,0,2,23,0,1,0,0,26,0
1475,37700,bLIF0ETNcg7fjkutu8YBWJptM3zxtu2Z,A3fsA9Zfv1X2fVEQhTw51lKENdNrEqT3,1,0,0,0,0,0,1,0,1,0.14285714285714285,1,0.0,0,0,0,0,0,0,0,1,0,0,1,1
1476,37730,z3YnX73v2uoVHmuLGzQD2gKKBoJqIQxK,bWdj2GDclj5ofokWjzoa5jAwMkxCykd6,4,3,1,0,0,0,1,0,5,0.7142857142857143,1,0.0,0,1,0,0,3,0,0,1,0,1,4,0
1477,37750,GpHiOkm3UY3R1sigoD8RZsfbPyCjOvL2,bWdj2GDclj5ofokWjzoa5jAwMkxCykd6,1,1,0,0,0,0,0,0,1,0.14285714285714285,1,0.0,0,0,0,0,1,0,0,0,0,0,1,1
1478,37778,MT2eJtF59AVNdUs7mwFqputROb2HgEm3,A3fsA9Zfv1X2fVEQhTw51lKENdNrEqT3,33,11,8,84,5,0,4,0,112,16.0,2,0.0,1,8,72,5,10,0,12,4,0,86,26,0
1479,37794,uQjl8NGtIQkRfoe9edBiMgtYYmdkzVXR,A3fsA9Zfv1X2fVEQhTw51lKENdNrEqT3,10,36,21,0,9,0,7,0,73,10.428571428571429,4,0.0,0,21,0,9,36,0,0,7,0,30,43,0
1480,37806,0FuB48Egjj7khWsNq1DtKTVsB7OEgidM,bWdj2GDclj5ofokWjzoa5jAwMkxCykd6,15,15,13,0,8,0,3,0,39,5.571428571428571,1,0.0,0,13,0,8,15,0,0,3,0,21,18,1
1481,37809,eEE69ZWSNrdmveqNEUHZYk60iG9wpaEc,SpATywNh6bZuzm8s1ceuBUnMUAeoAHHw,13,14,5,14,1,0,2,0,36,5.142857142857143,1,0.0,6,5,13,1,8,0,1,2,0,25,11,1
1482,37810,NcPdgwZnF0RkLUxC56tG83zG3V3KP94S,SpATywNh6bZuzm8s1ceuBUnMUAeoAHHw,14,7,5,10,3,10,2,0,37,5.285714285714286,1,0.0,2,5,9,3,5,10,1,2,0,19,18,1
1483,37823,2Y3h62Lps0fU6B3C4MXM4YNVNDf25XBr,SpATywNh6bZuzm8s1ceuBUnMUAeoAHHw,25,32,18,49,13,1,2,0,115,16.428571428571427,2,0.0,12,18,38,13,20,1,11,2,0,81,34,0
1484,37830,0FuB48Egjj7khWsNq1DtKTVsB7OEgidM,A3fsA9Zfv1X2fVEQhTw51lKENdNrEqT3,22,14,12,0,8,0,6,0,40,5.714285714285714,1,0.0,0,12,0,8,14,0,0,6,0,20,20,0
1485,37900,qZhmmNUvkNXdf3u04DTUQOFEBxxO10p4,SpATywNh6bZuzm8s1ceuBUnMUAeoAHHw,1,0,0,0,0,0,1,0,1,0.14285714285714285,1,0.0,0,0,0,0,0,0,0,1,0,0,1,0
1486,37922,j3dtYivg2u73ZbuSWbPPpSBQQec6vBYH,A3fsA9Zfv1X2fVEQhTw51lKENdNrEqT3,10,23,12,0,3,0,10,0,48,6.857142857142857,5,0.0,0,12,0,3,23,0,0,10,0,15,33,0
1487,37935,OkJ0lKmMXuQ2MGftQ8Isfw1JciMpapRC,SpATywNh6bZuzm8s1ceuBUnMUAeoAHHw,10,15,10,0,6,0,7,1,39,5.571428571428571,1,0.0,0,10,0,6,15,0,0,7,1,16,23,0
1488,37940,QmHQ7ayFECnRsgCVpHpJI6yMYR4kf5re,bWdj2GDclj5ofokWjzoa5jAwMkxCykd6,32,29,16,179,6,16,3,0,249,35.57142857142857,3,0.0,9,16,151,6,20,16,28,3,0,182,67,0
1489,37960,bz2uqvuFRCLaJmY4vFLIXrs9g0cTBHJC,A3fsA9Zfv1X2fVEQhTw51lKENdNrEqT3,3,2,1,0,0,0,1,0,4,0.5714285714285714,1,0.0,0,1,0,0,2,0,0,1,0,1,3,1
1490,38004,QEbMAkKsvpPGPL1XkTiHjXblquVwKrlD,A3fsA9Zfv1X2fVEQhTw51lKENdNrEqT3,5,2,1,0,0,0,6,0,9,1.2857142857142858,1,0.0,0,1,0,0,2,0,0,6,0,1,8,1
1491,38068,PmZJAFj6wJkOD163WkhaJjRHdYOMjBZW,SpATywNh6bZuzm8s1ceuBUnMUAeoAHHw,9,7,5,0,2,5,1,0,20,2.857142857142857,2,0.0,0,5,0,2,7,5,0,1,0,7,13,1
1492,38097,MkuttLQlAg2ibzg21YKyuq14uYFl6Q9Q,A3fsA9Zfv1X2fVEQhTw51lKENdNrEqT3,1,0,0,0,0,0,1,0,1,0.14285714285714285,1,0.0,0,0,0,0,0,0,0,1,0,0,1,1
1493,38144,0Hl4WpPV6z0OC8rO0L3mZy6harAUBUs7,G8EPVSXsOYB5YQWZGiz1aVq5Pgr2GrQu,1,0,0,0,0,0,1,0,1,0.14285714285714285,1,0.0,0,0,0,0,0,0,0,1,0,0,1,1
1494,38147,OHOHfGJUvl8C8rOynV86vKj0FrD2jzFO,SpATywNh6bZuzm8s1ceuBUnMUAeoAHHw,13,13,1,21,0,0,3,0,38,5.428571428571429,2,0.0,5,1,18,0,8,0,3,3,0,24,14,1
1495,38170,vs0vqlNXzuHsqVxOsB15kGfpvGf2pUt3,SpATywNh6bZuzm8s1ceuBUnMUAeoAHHw,4,6,4,0,0,0,2,0,12,1.7142857142857142,2,0.0,0,4,0,0,6,0,0,2,0,4,8,0
1496,38187,SX4dmJ5a5AfJLGZkCiiWab293xeIyxbW,SpATywNh6bZuzm8s1ceuBUnMUAeoAHHw,3,6,4,0,0,0,2,0,12,1.7142857142857142,5,0.0,0,4,0,0,6,0,0,2,0,4,8,0
1497,38264,DPr3Hy8387gfJi0Jc3ohxKBzY0mvhH1G,SpATywNh6bZuzm8s1ceuBUnMUAeoAHHw,1,0,0,0,0,0,1,0,1,0.14285714285714285,1,0.0,0,0,0,0,0,0,0,1,0,0,1,0
1498,38269,gzTBwYPoQwnODJJ2vedsUKp2EoGao5Fz,bWdj2GDclj5ofokWjzoa5jAwMkxCykd6,5,4,0,0,0,0,2,0,6,0.8571428571428571,2,0.0,1,0,0,0,3,0,0,2,0,1,5,1
1499,38348,DTsOT0NTIRutfokoKq4yB8bQe3U1fEsD,SpATywNh6bZuzm8s1ceuBUnMUAeoAHHw,30,50,17,20,7,21,6,1,122,17.428571428571427,2,0.0,22,17,20,7,28,21,0,6,1,66,56,0
1500,38377,qkZ3BaC1M1zrdLJXoQVUnE0RxlFverb8,A3fsA9Zfv1X2fVEQhTw51lKENdNrEqT3,27,45,14,28,5,1,13,1,107,15.285714285714286,2,0.0,2,14,22,5,43,1,6,13,1,43,64,1
1501,38393,NgT4xv3zS3UyiRdDnPLyxI49HQKeMn2D,G8EPVSXsOYB5YQWZGiz1aVq5Pgr2GrQu,10,6,1,2,0,12,9,0,30,4.285714285714286,1,0.0,0,1,2,0,6,12,0,9,0,3,27,1
1502,38514,88mqKZu0uTbuMx2E6ZRqhvo4tmoL4qfn,SpATywNh6bZuzm8s1ceuBUnMUAeoAHHw,14,16,1,14,1,4,3,0,39,5.571428571428571,1,0.0,4,1,11,1,12,4,3,3,0,17,22,1
1503,38520,WRiHtWJX61VUGyAGQFSHJ3czdrgqxeQW,RXDvfPUBYFlVdlueBFbLW0mhhAyGEqpt,3,0,0,0,0,5,3,0,8,1.1428571428571428,2,0.0,0,0,0,0,0,5,0,3,0,0,8,1
1504,38532,8SZ4vKq1qHRfFJV3A51uH46l0c4FRvvR,SpATywNh6bZuzm8s1ceuBUnMUAeoAHHw,8,11,6,0,3,0,0,0,20,2.857142857142857,2,0.0,0,6,0,3,11,0,0,0,0,9,11,0
1505,38554,tajSblOKlQlXdpIXIOLLEJCHn56vIOfT,bWdj2GDclj5ofokWjzoa5jAwMkxCykd6,5,6,0,0,0,0,2,0,8,1.1428571428571428,1,0.0,1,0,0,0,5,0,0,2,0,1,7,1
1506,38596,spd8M0wss3Tbv0YQ5WcIllIwTexcZnnW,SpATywNh6bZuzm8s1ceuBUnMUAeoAHHw,14,21,5,16,2,0,2,0,46,6.571428571428571,3,0.0,3,5,15,2,18,0,1,2,0,25,21,0
1507,38621,C800geUBh3GYBhoh4cW6ReKUGj5LAMGi,SpATywNh6bZuzm8s1ceuBUnMUAeoAHHw,9,6,3,0,3,0,4,0,16,2.2857142857142856,2,0.0,0,3,0,3,6,0,0,4,0,6,10,0
1508,38623,aKS3VkxSVtZSsON0tlb1uUJK6seiU1iY,SpATywNh6bZuzm8s1ceuBUnMUAeoAHHw,5,2,1,0,0,0,3,1,7,1.0,1,0.0,0,1,0,0,2,0,0,3,1,1,6,1
1509,38625,Na52PtAqm4VlTMUv1OPLGNjij0a5votC,A3fsA9Zfv1X2fVEQhTw51lKENdNrEqT3,3,2,1,0,0,0,1,0,4,0.5714285714285714,1,0.0,0,1,0,0,2,0,0,1,0,1,3,1
1510,38668,NjnyUEkQdbuj3M7NhvY8iDqgWMA59DIH,SpATywNh6bZuzm8s1ceuBUnMUAeoAHHw,1,0,0,0,0,0,1,0,1,0.14285714285714285,1,0.0,0,0,0,0,0,0,0,1,0,0,1,1
1511,38685,FncubT1DgrtJxWo1YRhPHqwgNARiG5Jv,SpATywNh6bZuzm8s1ceuBUnMUAeoAHHw,11,18,0,4,1,0,4,0,27,3.857142857142857,2,0.0,0,0,4,1,18,0,0,4,0,5,22,0
1512,38692,ktbF3sxXQk0MrToCOKFGvH2bCmfBVgYK,G8EPVSXsOYB5YQWZGiz1aVq5Pgr2GrQu,25,30,21,0,17,0,2,0,70,10.0,1,0.0,2,21,0,17,28,0,0,2,0,40,30,0
1513,38708,QWAnJ98MRtHXbl78XXr3UpScat4E7MnZ,SpATywNh6bZuzm8s1ceuBUnMUAeoAHHw,16,17,9,14,4,0,2,0,46,6.571428571428571,1,0.0,5,9,14,4,12,0,0,2,0,32,14,0
1514,38769,OygU41dc8lyatpKc4JEBkP0ni21xzfvB,SpATywNh6bZuzm8s1ceuBUnMUAeoAHHw,3,2,1,0,0,0,4,0,7,1.0,3,0.0,0,1,0,0,2,0,0,4,0,1,6,0
1515,38808,xy8Pu3m8OtRxFLhTfix6XvZn0H18zyZc,G8EPVSXsOYB5YQWZGiz1aVq5Pgr2GrQu,5,4,0,0,0,0,1,0,5,0.7142857142857143,1,0.0,0,0,0,0,4,0,0,1,0,0,5,0
1516,38811,T6EWQ7jVP89JlHzj41KN1gEtGYevpSQM,SpATywNh6bZuzm8s1ceuBUnMUAeoAHHw,8,8,4,4,0,0,2,0,18,2.5714285714285716,2,0.0,2,4,4,0,6,0,0,2,0,10,8,0
1517,38815,RfVW0lNKrf9tzkgd827lLFW37SMuSXSa,SpATywNh6bZuzm8s1ceuBUnMUAeoAHHw,14,19,1,12,1,0,1,0,34,4.857142857142857,1,0.0,2,1,12,1,17,0,0,1,0,16,18,1
1518,38826,RLA6GL5vSBJRKc1kwf2CaEaK6FOv9roZ,RXDvfPUBYFlVdlueBFbLW0mhhAyGEqpt,26,33,1,0,3,1,6,2,46,6.571428571428571,2,0.0,1,1,0,3,32,1,0,6,2,5,41,0
1519,38860,aSq9IJ4ZfLUbnD7QSBT8oeA7EtoTrGal,bWdj2GDclj5ofokWjzoa5jAwMkxCykd6,5,3,1,0,1,0,1,0,6,0.8571428571428571,1,0.0,0,1,0,1,3,0,0,1,0,2,4,1
1520,38912,35Qckp7squ2ifhCEFcVeQZHmfUAJiaXc,SpATywNh6bZuzm8s1ceuBUnMUAeoAHHw,3,2,1,0,0,0,2,0,5,0.7142857142857143,1,0.0,0,1,0,0,2,0,0,2,0,1,4,1
1521,38942,VrBnKyI7RjgXozKQXJ2DSbj5Gvev22L0,SpATywNh6bZuzm8s1ceuBUnMUAeoAHHw,15,13,8,14,3,0,3,0,41,5.857142857142857,2,0.0,2,8,14,3,11,0,0,3,0,27,14,0
1522,39050,St7zx5CuqYmo3cCQEAdzvR5kNp3mDM9y,SpATywNh6bZuzm8s1ceuBUnMUAeoAHHw,10,7,5,0,2,0,3,0,17,2.4285714285714284,1,0.0,0,5,0,2,7,0,0,3,0,7,10,0
1523,39054,blGSSjmsnVQQQrRQxZJTHNQQUXxgUvBL,SpATywNh6bZuzm8s1ceuBUnMUAeoAHHw,8,5,2,0,2,0,1,0,10,1.4285714285714286,1,0.0,0,2,0,2,5,0,0,1,0,4,6,0
1524,39060,T4lMOZ9NGQ0RS4ue5IeZuDcW1ySIGZ9u,A3fsA9Zfv1X2fVEQhTw51lKENdNrEqT3,11,8,6,20,4,0,1,0,39,5.571428571428571,1,0.0,0,6,17,4,8,0,3,1,0,27,12,1
1525,39090,fTfrYxb6cRWvjdEVjIZ7skF0s5uk6kd9,SpATywNh6bZuzm8s1ceuBUnMUAeoAHHw,1,0,0,0,0,0,2,0,2,0.2857142857142857,2,0.0,0,0,0,0,0,0,0,2,0,0,2,0
1526,39102,7nUtazUwwSnnXJpIKdQBJGpXV6Po42DQ,SpATywNh6bZuzm8s1ceuBUnMUAeoAHHw,20,25,0,14,2,1,10,1,53,7.571428571428571,1,0.0,7,0,11,2,18,1,3,10,1,20,33,1
1527,39113,VvziK1FrzCcoikfRc0daxkE7fq3iFq0v,SpATywNh6bZuzm8s1ceuBUnMUAeoAHHw,3,2,1,0,0,0,1,0,4,0.5714285714285714,1,0.0,0,1,0,0,2,0,0,1,0,1,3,0
1528,39131,uJIh67cllxQLgAhipzdDZMEunDbuBxvF,RXDvfPUBYFlVdlueBFbLW0mhhAyGEqpt,15,8,7,0,5,0,2,0,22,3.142857142857143,1,0.0,0,7,0,5,8,0,0,2,0,12,10,0
1529,39246,fv07Mlz09PBHitYybJt9eVrK276xe9YI,SpATywNh6bZuzm8s1ceuBUnMUAeoAHHw,3,0,0,0,0,0,6,0,6,0.8571428571428571,2,0.0,0,0,0,0,0,0,0,6,0,0,6,0
1530,39274,2nLjdaVfmxwWCLw5sEI1KKYk7UXViPES,SpATywNh6bZuzm8s1ceuBUnMUAeoAHHw,12,13,0,6,1,0,1,0,21,3.0,1,0.0,5,0,6,1,8,0,0,1,0,12,9,0
1531,39293,59KrgCJlOEHQHzBNjsHoSd6BkQVArDrc,SpATywNh6bZuzm8s1ceuBUnMUAeoAHHw,5,4,2,0,1,0,1,0,8,1.1428571428571428,1,0.0,0,2,0,1,4,0,0,1,0,3,5,1
1532,39296,R2cga9JVVM2tXEVs2saYswslfxAU4nMk,bWdj2GDclj5ofokWjzoa5jAwMkxCykd6,4,1,1,0,0,0,2,0,4,0.5714285714285714,1,0.0,0,1,0,0,1,0,0,2,0,1,3,1
1533,39301,ezp80xTAgodAGV4fsnNivfTneJn97tLE,RXDvfPUBYFlVdlueBFbLW0mhhAyGEqpt,3,2,1,0,0,0,1,0,4,0.5714285714285714,1,0.0,0,1,0,0,2,0,0,1,0,1,3,0
1534,39312,5taolCXbi4GnZeqgvcKlHbiPurs2tpgr,SpATywNh6bZuzm8s1ceuBUnMUAeoAHHw,17,15,9,12,4,0,2,0,42,6.0,2,0.0,4,9,12,4,11,0,0,2,0,29,13,0
1535,39330,YY7yHizDn0UpGHVq4qoTfbulP3ev5TkC,SpATywNh6bZuzm8s1ceuBUnMUAeoAHHw,3,2,1,0,0,0,1,0,4,0.5714285714285714,1,0.0,0,1,0,0,2,0,0,1,0,1,3,0
1536,39349,8eqcmJf66b25Hdf1a71yMHA6gdhfVvDC,G8EPVSXsOYB5YQWZGiz1aVq5Pgr2GrQu,59,109,46,40,28,24,13,0,260,37.142857142857146,2,0.0,5,46,35,28,104,24,5,13,0,114,146,0
1537,39367,SgAa84aajahM2sd2hvCdYRfO014ocPV5,SpATywNh6bZuzm8s1ceuBUnMUAeoAHHw,16,21,12,12,6,0,3,0,54,7.714285714285714,2,0.0,6,12,11,6,15,0,1,3,0,35,19,0
1538,39377,M0xQooArrVMTCCgk3YkWTaBSUVldkFxi,SpATywNh6bZuzm8s1ceuBUnMUAeoAHHw,3,5,3,0,0,0,2,0,10,1.4285714285714286,1,0.0,0,3,0,0,5,0,0,2,0,3,7,0
1539,39407,W7Pzvj7hPa3qVKdWluutDHqjcp3iIpAb,SpATywNh6bZuzm8s1ceuBUnMUAeoAHHw,8,9,4,0,1,0,3,0,17,2.4285714285714284,3,0.0,3,4,0,1,6,0,0,3,0,8,9,0
1540,39430,IAvuP4GGmvnNj3Zisz3jDfo3mSmXiJSb,bWdj2GDclj5ofokWjzoa5jAwMkxCykd6,4,3,0,0,0,0,2,0,5,0.7142857142857143,1,0.0,0,0,0,0,3,0,0,2,0,0,5,0
1541,39432,roGokqGBKtukTNGPdY1C2VEr66iWn5eT,G8EPVSXsOYB5YQWZGiz1aVq5Pgr2GrQu,6,5,3,0,1,0,2,0,11,1.5714285714285714,1,0.0,0,3,0,1,5,0,0,2,0,4,7,1
1542,39441,VsLOJ7Xi4SI8kpOP7KF7SoJJkHTp6ASm,SpATywNh6bZuzm8s1ceuBUnMUAeoAHHw,3,2,1,0,0,0,2,0,5,0.7142857142857143,2,0.0,0,1,0,0,2,0,0,2,0,1,4,0
1543,39485,O9c4mZKt6PM5RxUHcRjnRJOfvI41UF2p,SpATywNh6bZuzm8s1ceuBUnMUAeoAHHw,4,1,1,0,1,0,1,0,4,0.5714285714285714,1,0.0,0,1,0,1,1,0,0,1,0,2,2,0
1544,39499,nBZt0s4EJwoCi0gxserLJGtn0aLrx1yc,A3fsA9Zfv1X2fVEQhTw51lKENdNrEqT3,17,29,8,0,6,0,5,0,48,6.857142857142857,4,0.0,0,8,0,6,29,0,0,5,0,14,34,1
1545,39504,1BLAPxf3lDzwOBM6NeFyerOFp0vZobfY,SpATywNh6bZuzm8s1ceuBUnMUAeoAHHw,4,2,1,0,0,0,2,0,5,0.7142857142857143,1,0.0,0,1,0,0,2,0,0,2,0,1,4,0
1546,39527,BZSYb0PJXmPcTlknqBAAi8E9uLmy4IRE,SpATywNh6bZuzm8s1ceuBUnMUAeoAHHw,5,4,3,0,0,0,1,0,8,1.1428571428571428,1,0.0,0,3,0,0,4,0,0,1,0,3,5,1
1547,39540,xnObPmivHmj7phvTSVLNuvvFk898J2aO,SpATywNh6bZuzm8s1ceuBUnMUAeoAHHw,3,2,0,0,0,0,2,0,4,0.5714285714285714,1,0.0,0,0,0,0,2,0,0,2,0,0,4,1
1548,39560,tfLWXkHQA3FBV54C2lvq1caDx4Pi6QwO,SpATywNh6bZuzm8s1ceuBUnMUAeoAHHw,4,3,1,0,0,0,3,0,7,1.0,1,0.0,0,1,0,0,3,0,0,3,0,1,6,0
1549,39567,YC5UG6m05nI4uxDXYqrNEKgzKHSk4oSu,SpATywNh6bZuzm8s1ceuBUnMUAeoAHHw,16,12,7,10,5,0,3,0,37,5.285714285714286,2,0.0,3,7,9,5,9,0,1,3,0,24,13,0
1550,39568,veYIONVCJwpad8Khvzq7a5rgGQHvYo6S,G8EPVSXsOYB5YQWZGiz1aVq5Pgr2GrQu,6,4,2,0,1,0,1,0,8,1.1428571428571428,1,0.0,0,2,0,1,4,0,0,1,0,3,5,0
1551,39587,X14gKVD1ZKu0qL0NchpqxwhoYSEpz9QI,SpATywNh6bZuzm8s1ceuBUnMUAeoAHHw,1,0,0,0,0,0,4,0,4,0.5714285714285714,2,0.0,0,0,0,0,0,0,0,4,0,0,4,0
1552,39630,3Aezv8lgcVyIW4Uwgi3KMiL4RZSkwke5,bWdj2GDclj5ofokWjzoa5jAwMkxCykd6,4,7,4,0,0,0,3,0,14,2.0,3,0.0,0,4,0,0,7,0,0,3,0,4,10,0
1553,39632,YHL8SFwBUtFpO36pvl6xAPsnC0mLXaOp,G8EPVSXsOYB5YQWZGiz1aVq5Pgr2GrQu,1,0,0,0,0,0,1,0,1,0.14285714285714285,1,0.0,0,0,0,0,0,0,0,1,0,0,1,1
1554,39652,6FzXe5nPWUHRxntREHsQRnp7x1pxuhUz,bWdj2GDclj5ofokWjzoa5jAwMkxCykd6,3,2,2,0,2,0,0,0,6,0.8571428571428571,1,0.0,0,2,0,2,2,0,0,0,0,4,2,1
1555,39723,wg81hfugF770xMHAXCLP7YJmOhdUJnHl,SpATywNh6bZuzm8s1ceuBUnMUAeoAHHw,3,2,1,0,0,0,1,0,4,0.5714285714285714,1,0.0,0,1,0,0,2,0,0,1,0,1,3,0
1556,39776,OdMr7dE5UlAme9Tp979vREBvY5CV50po,bWdj2GDclj5ofokWjzoa5jAwMkxCykd6,17,19,10,12,4,0,4,0,49,7.0,3,0.0,6,10,12,4,13,0,0,4,0,32,17,0
1557,39817,vkw8WV6aYKsdxKvxTMS0euMnMdoDV8qN,bWdj2GDclj5ofokWjzoa5jAwMkxCykd6,1,0,0,0,0,0,1,0,1,0.14285714285714285,1,0.0,0,0,0,0,0,0,0,1,0,0,1,1
1558,39824,ZKL2WgbeR5PdyCIYfqDQ4XNCHZlCFLIz,bWdj2GDclj5ofokWjzoa5jAwMkxCykd6,5,3,2,0,1,0,1,0,7,1.0,1,0.0,0,2,0,1,3,0,0,1,0,3,4,1
1559,39828,ke8J6J68PMmqZ8rK8FCDUgXlLZQpLLZW,A3fsA9Zfv1X2fVEQhTw51lKENdNrEqT3,3,2,1,0,0,0,1,0,4,0.5714285714285714,1,0.0,0,1,0,0,2,0,0,1,0,1,3,1
1560,39885,g6UH67YbvJtewLNXQNVZTYui0XC1Hxpo,G8EPVSXsOYB5YQWZGiz1aVq5Pgr2GrQu,4,5,3,0,0,0,3,0,11,1.5714285714285714,2,0.0,0,3,0,0,5,0,0,3,0,3,8,0
1561,39906,xOGjXyyeq87fCMSZ9z7Yuds9sMvR7Ohh,RXDvfPUBYFlVdlueBFbLW0mhhAyGEqpt,12,10,8,0,5,0,1,0,24,3.4285714285714284,1,0.0,0,8,0,5,10,0,0,1,0,13,11,0
1562,39925,muBWBBbWzkNF6Dzg57EIx35WmD2zp0yP,SpATywNh6bZuzm8s1ceuBUnMUAeoAHHw,7,4,1,0,1,0,2,0,8,1.1428571428571428,1,0.0,0,1,0,1,4,0,0,2,0,2,6,0
1563,39928,ygXUYNlms6qOypCR1kXz9dAuLrVhdPds,SpATywNh6bZuzm8s1ceuBUnMUAeoAHHw,6,9,5,0,0,1,4,0,19,2.7142857142857144,2,0.0,2,5,0,0,7,1,0,4,0,7,12,1
1564,39941,Z90b24vMiOddvA3R8cPrefim6f9EiVmz,SpATywNh6bZuzm8s1ceuBUnMUAeoAHHw,16,22,5,27,0,8,6,3,71,10.142857142857142,1,0.0,16,5,21,0,6,8,6,6,3,42,29,0
1565,39956,CHAwTqWzS9gyj5Ro2Bvsw8FCNCA8dW6W,RXDvfPUBYFlVdlueBFbLW0mhhAyGEqpt,5,5,0,0,1,0,2,0,8,1.1428571428571428,1,0.0,3,0,0,1,2,0,0,2,0,4,4,1
1566,39967,VFl026LXCSxME7l2ZLRhGKmh3R96duCq,SpATywNh6bZuzm8s1ceuBUnMUAeoAHHw,5,14,9,0,0,0,9,0,32,4.571428571428571,5,0.0,0,9,0,0,14,0,0,9,0,9,23,0
1567,40039,28PHU9suTM8EqUKsQwsvQ03DzFXi0yDl,A3fsA9Zfv1X2fVEQhTw51lKENdNrEqT3,6,9,5,0,0,0,4,0,18,2.5714285714285716,2,0.0,1,5,0,0,8,0,0,4,0,6,12,0
1568,40054,dlphjzS7Cck7yL7KPK4kXgmYSbBOCuFC,bWdj2GDclj5ofokWjzoa5jAwMkxCykd6,6,5,1,2,0,0,1,0,9,1.2857142857142858,1,0.0,1,1,2,0,4,0,0,1,0,4,5,0
1569,40063,l5LfU8gApOG72AnBkdAbfOLQLwFH7Zo2,bWdj2GDclj5ofokWjzoa5jAwMkxCykd6,9,10,2,0,0,0,2,0,14,2.0,1,0.0,0,2,0,0,10,0,0,2,0,2,12,1
1570,40079,2A7IXlmbeljDbPAl1ZsZqwpJw9LPGGGX,SpATywNh6bZuzm8s1ceuBUnMUAeoAHHw,24,18,12,16,6,0,2,0,54,7.714285714285714,1,0.0,4,12,13,6,14,0,3,2,0,35,19,1
1571,40081,zyMs55MEXcYV6llnecBHL4KGyjGwZwbR,SpATywNh6bZuzm8s1ceuBUnMUAeoAHHw,7,6,1,14,0,0,2,0,23,3.2857142857142856,1,0.0,3,1,13,0,3,0,1,2,0,17,6,0
1572,40104,FUMcFXXfXADMgcSzTyKSabMQ45EVJp0n,A3fsA9Zfv1X2fVEQhTw51lKENdNrEqT3,25,11,8,60,3,0,6,0,88,12.571428571428571,2,0.0,0,8,48,3,11,0,12,6,0,59,29,1
1573,40137,7Blw5DXu09ENSrwHZywqqUdODuz4CZi6,SpATywNh6bZuzm8s1ceuBUnMUAeoAHHw,6,5,1,0,0,0,9,0,15,2.142857142857143,2,0.0,0,1,0,0,5,0,0,9,0,1,14,0
1574,40156,BM23agkLBTvZTkItMt2GtI7Rt9Nmmgof,SpATywNh6bZuzm8s1ceuBUnMUAeoAHHw,3,6,3,0,0,12,3,0,24,3.4285714285714284,2,0.0,0,3,0,0,6,12,0,3,0,3,21,0
1575,40175,m2y02R5W4wE10TMNO80PJL5IOUbHqLJ2,SpATywNh6bZuzm8s1ceuBUnMUAeoAHHw,18,28,18,10,5,0,8,0,69,9.857142857142858,4,0.0,2,18,10,5,26,0,0,8,0,35,34,0
1576,40198,w1whp42bLIFDRZ3YUW58J4w8I7T8mTT8,SpATywNh6bZuzm8s1ceuBUnMUAeoAHHw,8,14,0,0,0,0,7,0,21,3.0,3,0.0,1,0,0,0,13,0,0,7,0,1,20,1
1577,40257,IRfJ2J3e4oTjcMA6yNpRgLvZtLwyduUa,SpATywNh6bZuzm8s1ceuBUnMUAeoAHHw,18,24,10,11,6,7,8,0,66,9.428571428571429,2,0.0,2,10,10,6,22,7,1,8,0,28,38,0
1578,40282,CSh5hGbaSFu2yCb31iVMOVwKocrH471Q,A3fsA9Zfv1X2fVEQhTw51lKENdNrEqT3,3,2,1,0,0,0,1,0,4,0.5714285714285714,1,0.0,0,1,0,0,2,0,0,1,0,1,3,1
1579,40319,wg81hfugF770xMHAXCLP7YJmOhdUJnHl,A3fsA9Zfv1X2fVEQhTw51lKENdNrEqT3,4,3,2,0,0,0,2,0,7,1.0,1,0.0,0,2,0,0,3,0,0,2,0,2,5,0
1580,40327,5vUuq5ZeDCNce4LmvH0naoUjpb3qbNOp,A3fsA9Zfv1X2fVEQhTw51lKENdNrEqT3,52,68,36,76,8,3,18,1,210,30.0,3,0.0,3,36,57,8,65,3,19,18,1,104,106,1
1581,40332,JCQSo9f9Aey0YG4wslCCbhR6oOLB0oC6,SpATywNh6bZuzm8s1ceuBUnMUAeoAHHw,4,2,1,0,0,0,3,0,6,0.8571428571428571,2,0.0,0,1,0,0,2,0,0,3,0,1,5,0
1582,40358,EEH4DLdmIdcQf1RzjjDafMrB5kVed71w,A3fsA9Zfv1X2fVEQhTw51lKENdNrEqT3,4,0,0,0,0,0,5,0,5,0.7142857142857143,1,0.0,0,0,0,0,0,0,0,5,0,0,5,1
1583,40467,bNBhDpviOcrLuVFG9Qda6S7fiYJ6jIvc,SpATywNh6bZuzm8s1ceuBUnMUAeoAHHw,4,3,1,0,0,0,1,0,5,0.7142857142857143,1,0.0,0,1,0,0,3,0,0,1,0,1,4,1
1584,40512,l01aGQuAgd5VHAVuk21pZMIeJcDQOX6i,RXDvfPUBYFlVdlueBFbLW0mhhAyGEqpt,13,11,5,34,4,0,1,0,55,7.857142857142857,1,0.0,4,5,34,4,7,0,0,1,0,47,8,0
1585,40514,weKRMLBzfxs8ekS11Y9oGFXbhmcomWRF,A3fsA9Zfv1X2fVEQhTw51lKENdNrEqT3,6,9,6,0,3,0,3,0,21,3.0,2,0.0,0,6,0,3,9,0,0,3,0,9,12,0
1586,40554,vG6SgKMKhZDlcYDUDKC1NlbpiW2uFCxn,A3fsA9Zfv1X2fVEQhTw51lKENdNrEqT3,5,6,0,0,0,0,0,0,6,0.8571428571428571,1,0.0,0,0,0,0,6,0,0,0,0,0,6,1
1587,40583,EVKTxmdXvqH9f0V4XuFLHjVRnnUWi9xh,A3fsA9Zfv1X2fVEQhTw51lKENdNrEqT3,29,19,8,44,3,1,16,1,92,13.142857142857142,3,0.0,9,8,37,3,10,1,7,16,1,57,35,1
1588,40622,FUMcFXXfXADMgcSzTyKSabMQ45EVJp0n,bWdj2GDclj5ofokWjzoa5jAwMkxCykd6,44,33,19,131,7,12,18,1,221,31.571428571428573,3,0.0,5,19,104,7,28,12,27,18,1,135,86,0
1589,40670,AMHmOq5PY3K2Bq5bkWrg2Cz6hshdhVde,SpATywNh6bZuzm8s1ceuBUnMUAeoAHHw,9,10,0,7,0,0,3,0,20,2.857142857142857,1,0.0,2,0,6,0,8,0,1,3,0,8,12,1
1590,40694,EY3QtJOWsoMIz6ZJR9ZEsrPPDsaYmN0t,SpATywNh6bZuzm8s1ceuBUnMUAeoAHHw,5,3,0,0,0,0,4,0,7,1.0,1,0.0,0,0,0,0,3,0,0,4,0,0,7,1
1591,40717,P11RKOPCDL5miqBQ5O3oznfREAcXF9hp,A3fsA9Zfv1X2fVEQhTw51lKENdNrEqT3,7,10,5,0,6,0,2,0,23,3.2857142857142856,2,0.0,0,5,0,6,10,0,0,2,0,11,12,0
1592,40788,TXXodrsD3gpNuvLWnhSXeHO4v2Kp7PZ2,SpATywNh6bZuzm8s1ceuBUnMUAeoAHHw,5,4,2,0,1,0,1,0,8,1.1428571428571428,1,0.0,0,2,0,1,4,0,0,1,0,3,5,1
1593,40818,0wm7bVyJC7jfhIoeylaV85sHOH5JOhtj,RXDvfPUBYFlVdlueBFbLW0mhhAyGEqpt,1,0,0,0,0,0,1,0,1,0.14285714285714285,1,0.0,0,0,0,0,0,0,0,1,0,0,1,1
1594,40858,dJJJLtI6F18pblO9KPkBPg9ZKTgQPaQc,SpATywNh6bZuzm8s1ceuBUnMUAeoAHHw,5,11,2,0,0,0,3,0,16,2.2857142857142856,2,0.0,3,2,0,0,8,0,0,3,0,5,11,0
1595,40861,40L77km5z19sJEVeJ6u4qpa9SAG2ZSIF,SpATywNh6bZuzm8s1ceuBUnMUAeoAHHw,1,0,0,0,0,0,1,0,1,0.14285714285714285,1,0.0,0,0,0,0,0,0,0,1,0,0,1,0
1596,40905,aldLXGpzmiip2CUSDhqN8A5UpGMVUHxY,bWdj2GDclj5ofokWjzoa5jAwMkxCykd6,20,16,9,24,2,10,5,0,66,9.428571428571429,3,0.0,2,9,24,2,14,10,0,5,0,37,29,0
1597,40910,M2AmcvqhvMtUlyRV6vMvvoM2IhrMmAwT,A3fsA9Zfv1X2fVEQhTw51lKENdNrEqT3,37,20,11,38,5,6,12,3,95,13.571428571428571,4,0.0,4,11,38,5,16,6,0,12,3,58,37,1
1598,40928,qoIGs6RP8XMC5yN9VowJtSVp77FsPrRk,A3fsA9Zfv1X2fVEQhTw51lKENdNrEqT3,5,4,3,0,2,0,1,0,10,1.4285714285714286,1,0.0,0,3,0,2,4,0,0,1,0,5,5,1
1599,40947,G14xjTwMWbfsqTNiU3Ie1utHyPegqSvR,SpATywNh6bZuzm8s1ceuBUnMUAeoAHHw,6,4,3,5,0,0,1,0,13,1.8571428571428572,1,0.0,0,3,5,0,4,0,0,1,0,8,5,1
1600,40994,WmqMKoevd5yMpzwxk3BDNFkg4y1FZjx5,G8EPVSXsOYB5YQWZGiz1aVq5Pgr2GrQu,17,22,2,0,0,0,5,0,29,4.142857142857143,3,0.0,0,2,0,0,22,0,0,5,0,2,27,1
1601,41018,Htb70W0lnqw4QeBjeePevzE0xRg4O6vF,7GRhBDsirIGkRZBtSMEzNTyDr2JQm4xx,5,4,2,0,1,0,1,0,8,1.1428571428571428,1,0.0,1,2,0,1,3,0,0,1,0,4,4,1
1602,41023,8Ht2Zmfn81Gwb093X2QMQmBGW6qi8rRd,7GRhBDsirIGkRZBtSMEzNTyDr2JQm4xx,17,34,12,17,13,2,3,0,81,11.571428571428571,2,0.0,18,12,15,13,16,2,2,3,0,58,23,1
1603,41082,DVIil2NM7ZWOtqe6rhlMzwEUAb2wuaeh,7GRhBDsirIGkRZBtSMEzNTyDr2JQm4xx,9,7,5,2,1,0,1,0,16,2.2857142857142856,1,0.0,1,5,1,1,6,0,1,1,0,8,8,0
1604,41300,qJQBhMSxZNb9FZGkj9PyIWzMqhMNvrJp,7GRhBDsirIGkRZBtSMEzNTyDr2JQm4xx,14,19,1,4,3,0,6,0,33,4.714285714285714,1,0.0,5,1,4,3,14,0,0,6,0,13,20,0
1605,41485,xg6gozDtJtmbriZIHFk0YIJKhyzF16Dg,7GRhBDsirIGkRZBtSMEzNTyDr2JQm4xx,18,42,18,2,12,0,5,0,79,11.285714285714286,2,0.0,16,18,1,12,26,0,1,5,0,47,32,1
1606,41514,TDsFMiW3NmfZzVauB4oMkOZiSJ5XLe6I,7GRhBDsirIGkRZBtSMEzNTyDr2JQm4xx,9,3,2,0,1,1,9,0,16,2.2857142857142856,2,0.0,0,2,0,1,3,1,0,9,0,3,13,1
1607,41533,8zcddBOPFYuIEkUZpmoApSiBFpQCKBLf,7GRhBDsirIGkRZBtSMEzNTyDr2JQm4xx,5,5,1,0,0,0,2,0,8,1.1428571428571428,1,0.0,2,1,0,0,3,0,0,2,0,3,5,1
1608,41762,FJJqBn1iTJmAbav7Ov5Y4ycyF65fvY1E,7GRhBDsirIGkRZBtSMEzNTyDr2JQm4xx,2,0,0,0,0,2,1,0,3,0.42857142857142855,1,0.0,0,0,0,0,0,2,0,1,0,0,3,0
1609,41807,txRaMeFRdTsCsziGBMMxzL5gSPIB7mbk,7GRhBDsirIGkRZBtSMEzNTyDr2JQm4xx,37,93,39,30,2,7,22,0,193,27.571428571428573,2,0.0,40,39,28,2,53,7,2,22,0,109,84,1
1610,43668,s78QKjJp2qJWP86SKhU5XdBMn22opRSP,7GRhBDsirIGkRZBtSMEzNTyDr2JQm4xx,11,10,6,0,5,0,2,0,23,3.2857142857142856,2,0.0,1,6,0,5,9,0,0,2,0,12,11,0
1611,43673,Y53vJNK6NsQxTqlgv0AKozWzT5IkWSVb,7GRhBDsirIGkRZBtSMEzNTyDr2JQm4xx,9,11,6,9,0,0,1,0,27,3.857142857142857,1,0.0,2,6,6,0,9,0,3,1,0,14,13,0
1612,43695,z0WA70zlCYNC0D6ukf1TU1erCNwbETr4,7GRhBDsirIGkRZBtSMEzNTyDr2JQm4xx,8,8,0,4,1,0,2,0,15,2.142857142857143,1,0.0,3,0,2,1,5,0,2,2,0,6,9,1
1613,43711,astaomdRwCWRae7GfR14orvLqERJnyWg,7GRhBDsirIGkRZBtSMEzNTyDr2JQm4xx,26,27,9,36,1,17,15,0,105,15.0,2,0.0,16,9,31,1,11,17,5,15,0,57,48,0
1614,43724,bbBEHMN2ei4wG0H7nW7BSSaBcqs1CEnx,7GRhBDsirIGkRZBtSMEzNTyDr2JQm4xx,2,0,0,0,0,0,2,0,2,0.2857142857142857,1,0.0,0,0,0,0,0,0,0,2,0,0,2,1
1615,43725,6QRfbLtBjFn7GPZrNgqut0wbkSDHHl9M,7GRhBDsirIGkRZBtSMEzNTyDr2JQm4xx,15,11,1,80,0,0,2,0,94,13.428571428571429,1,0.0,6,1,72,0,5,0,8,2,0,79,15,1
1616,44022,PDXGFyBPYCflMZuvp1Ir4M4S3e0nyboZ,fbPkOYLVPtPgIt0MxizjfFJov3JbHyAi,30,71,30,14,6,1,6,0,128,18.285714285714285,3,0.0,17,30,14,6,54,1,0,6,0,67,61,1
1617,44035,AOTrlTWQ3Oa2ClznlEkXg5ypb6eqlCbx,fbPkOYLVPtPgIt0MxizjfFJov3JbHyAi,7,1,1,0,1,0,5,2,10,1.4285714285714286,1,0.0,0,1,0,1,1,0,0,5,2,2,8,1
1618,44059,VCAUk6CdtYtSQUkeIHqrUkYmOmbAoytN,fbPkOYLVPtPgIt0MxizjfFJov3JbHyAi,3,1,1,0,1,0,0,0,3,0.42857142857142855,1,0.0,0,1,0,1,1,0,0,0,0,2,1,1
1619,44080,bheLkhWEWGgBqIkahX9VmPOuI7dx9l0C,fbPkOYLVPtPgIt0MxizjfFJov3JbHyAi,4,2,1,0,0,1,4,0,8,1.1428571428571428,1,0.0,0,1,0,0,2,1,0,4,0,1,7,1
1620,44082,YzWgrkJXzobheYWSTdIFQuZL9QRQEEwo,fbPkOYLVPtPgIt0MxizjfFJov3JbHyAi,7,4,1,0,1,0,2,0,8,1.1428571428571428,1,0.0,0,1,0,1,4,0,0,2,0,2,6,1
1621,44089,No6TsyszmhFBqFzsKXtnzkYT0Jt4BFGw,fbPkOYLVPtPgIt0MxizjfFJov3JbHyAi,5,2,1,0,0,11,4,0,18,2.5714285714285716,1,0.0,0,1,0,0,2,11,0,4,0,1,17,0
1622,44106,futHw5ylJYoore6oNuefdx05Xc1Es6E8,fbPkOYLVPtPgIt0MxizjfFJov3JbHyAi,4,7,2,0,0,0,4,0,13,1.8571428571428572,2,0.0,2,2,0,0,5,0,0,4,0,4,9,1
1623,44110,e4cZqrYucFu6WeO5quZuqBqXvsVJ1X82,fbPkOYLVPtPgIt0MxizjfFJov3JbHyAi,1,0,0,0,0,0,1,0,1,0.14285714285714285,1,0.0,0,0,0,0,0,0,0,1,0,0,1,1
1624,44147,zeUi2UnQZPPF6bRQXw2s8LZ41ZOdqRAa,fbPkOYLVPtPgIt0MxizjfFJov3JbHyAi,1,0,0,0,0,0,1,0,1,0.14285714285714285,1,0.0,0,0,0,0,0,0,0,1,0,0,1,1
1625,44149,W7N7he2GGE1A2J3fJvsUdwOZI9P4besV,fbPkOYLVPtPgIt0MxizjfFJov3JbHyAi,3,2,1,0,0,0,1,0,4,0.5714285714285714,1,0.0,0,1,0,0,2,0,0,1,0,1,3,1
1626,44178,ZUj8ciewoY1krerme1rA06bZgMQzwUwF,fbPkOYLVPtPgIt0MxizjfFJov3JbHyAi,9,7,3,0,2,0,3,0,15,2.142857142857143,1,0.0,1,3,0,2,6,0,0,3,0,6,9,0
1627,44186,mJ5BZ6EJA3wLg8jbGMObtpjRK8yspzI5,fbPkOYLVPtPgIt0MxizjfFJov3JbHyAi,11,10,8,4,1,0,1,0,24,3.4285714285714284,1,0.0,1,8,4,1,9,0,0,1,0,14,10,1
1628,44194,nkWrffpo6kobU01lUWepcu6aQb60BdxH,fbPkOYLVPtPgIt0MxizjfFJov3JbHyAi,7,9,4,0,2,0,3,0,18,2.5714285714285716,2,0.0,2,4,0,2,7,0,0,3,0,8,10,0
1629,44203,4cRZxyVNjv13lU3nu2aK2rwyndExVCGa,fbPkOYLVPtPgIt0MxizjfFJov3JbHyAi,3,2,1,0,0,0,1,0,4,0.5714285714285714,1,0.0,0,1,0,0,2,0,0,1,0,1,3,1
1630,44228,R1FqqBKIoe5gb1Zm4cRd6C2dKym4oN3J,fbPkOYLVPtPgIt0MxizjfFJov3JbHyAi,9,19,11,0,5,0,9,0,44,6.285714285714286,2,0.0,1,11,0,5,18,0,0,9,0,17,27,0
1631,44236,jagu0OJDhWTGFhfCMk0ghqluLpW3kzdC,fbPkOYLVPtPgIt0MxizjfFJov3JbHyAi,7,8,6,0,1,6,8,0,29,4.142857142857143,2,0.0,0,6,0,1,8,6,0,8,0,7,22,0
1632,44244,g2zZYnTJ1Pk3cSjsVP5SH4UjJdsbDJv7,fbPkOYLVPtPgIt0MxizjfFJov3JbHyAi,9,6,3,6,2,0,1,0,18,2.5714285714285716,1,0.0,2,3,5,2,4,0,1,1,0,12,6,0
1633,45309,cvmNQvB8C9tzfr5JL4ScqNRXsUkWS0qq,RXDvfPUBYFlVdlueBFbLW0mhhAyGEqpt,16,30,15,0,4,26,3,0,78,11.142857142857142,3,0.0,0,15,0,4,30,26,0,3,0,19,59,0
1634,45316,KUdvYZYC6ZViW3z5eiAU2e6Me0VXEfY4,RXDvfPUBYFlVdlueBFbLW0mhhAyGEqpt,8,6,0,0,0,0,5,0,11,1.5714285714285714,1,0.0,0,0,0,0,6,0,0,5,0,0,11,1
1635,45340,Q57EC9WScoWjECRp7MT77bmBt9oZMVVG,RXDvfPUBYFlVdlueBFbLW0mhhAyGEqpt,7,6,3,0,0,253,44,9,315,45.0,4,0.0,0,3,0,0,6,253,0,44,9,3,312,0
1636,45366,4v506xwnN2gFG9XeSNIeiBlmXImooi1O,RXDvfPUBYFlVdlueBFbLW0mhhAyGEqpt,65,96,44,139,35,0,3,0,317,45.285714285714285,1,0.0,43,44,134,35,53,0,5,3,0,256,61,0
1637,46389,gGFmJyNMerYTj0kT96HuKIvL9JdTq2vY,RXDvfPUBYFlVdlueBFbLW0mhhAyGEqpt,8,5,3,0,2,0,3,0,13,1.8571428571428572,1,0.0,1,3,0,2,4,0,0,3,0,6,7,0
1638,46503,DPR39VXlEgPnSvHJlcrFWVjZyCJYvn9R,fbPkOYLVPtPgIt0MxizjfFJov3JbHyAi,10,5,4,0,4,0,1,0,14,2.0,1,0.0,0,4,0,4,5,0,0,1,0,8,6,1
1639,46505,kBNWoa4A4jmNOoJaSAupB8wyNzpsoJAN,fbPkOYLVPtPgIt0MxizjfFJov3JbHyAi,20,16,10,11,5,0,2,0,44,6.285714285714286,2,0.0,5,10,10,5,11,0,1,2,0,30,14,0
1640,46511,xeCFX5y6IRjmYKFA9y4Rgt3SG4YPELud,fbPkOYLVPtPgIt0MxizjfFJov3JbHyAi,21,58,19,9,10,4,4,0,104,14.857142857142858,1,0.0,5,19,8,10,53,4,1,4,0,42,62,0
1641,46517,MN4wOgynUY4QcRaraCB5Ym52vNjUttfc,fbPkOYLVPtPgIt0MxizjfFJov3JbHyAi,6,3,2,0,2,0,1,0,8,1.1428571428571428,1,0.0,0,2,0,2,3,0,0,1,0,4,4,1
1642,46527,8JTz84ZDdJm6tvsd7hgyCl1RB6wU6r2e,fbPkOYLVPtPgIt0MxizjfFJov3JbHyAi,3,2,1,0,0,0,1,0,4,0.5714285714285714,1,0.0,0,1,0,0,2,0,0,1,0,1,3,1
1643,46531,KbMG2R5hi7lV4ttClunSqF2UarKF8FNZ,fbPkOYLVPtPgIt0MxizjfFJov3JbHyAi,17,35,9,10,4,25,5,0,88,12.571428571428571,2,0.0,5,9,10,4,30,25,0,5,0,28,60,1
1644,46536,8HQsMOkKLewVMfte6VD2DYuU0urKWHXv,fbPkOYLVPtPgIt0MxizjfFJov3JbHyAi,9,14,6,0,3,3,7,0,33,4.714285714285714,3,0.0,2,6,0,3,12,3,0,7,0,11,22,0
1645,46549,4ApVgPYGz6bz2SJLoGELpZ6RPnXwOa88,fbPkOYLVPtPgIt0MxizjfFJov3JbHyAi,22,50,23,18,13,1,9,0,114,16.285714285714285,6,0.0,19,23,14,13,31,1,4,9,0,69,45,0
1646,46567,UPecCjx5RBL6BceSov5rJLAaDoiPXUhg,fbPkOYLVPtPgIt0MxizjfFJov3JbHyAi,4,2,1,0,0,0,4,0,7,1.0,2,0.0,0,1,0,0,2,0,0,4,0,1,6,1
1647,46580,sn1OZIzg3ZOiyRClBvvQLUKwx6tymOkC,fbPkOYLVPtPgIt0MxizjfFJov3JbHyAi,15,9,7,0,4,0,3,1,24,3.4285714285714284,1,0.0,1,7,0,4,8,0,0,3,1,12,12,1
1648,46588,yfppFvC7mTSlPuhod9GGDRPkzP1HmCAu,fbPkOYLVPtPgIt0MxizjfFJov3JbHyAi,48,58,25,29,20,0,9,0,141,20.142857142857142,3,0.0,20,25,24,20,38,0,5,9,0,89,52,1
1649,47680,5j9EQkqR4CZfRV8sku9HLld3NnlBiUj6,7GRhBDsirIGkRZBtSMEzNTyDr2JQm4xx,26,35,0,16,7,0,3,0,61,8.714285714285714,1,0.0,21,0,11,7,14,0,5,3,0,39,22,1
1650,47725,yO35UgaD8utoCb4qpLRXsAlxVi0i8Hs2,7GRhBDsirIGkRZBtSMEzNTyDr2JQm4xx,24,35,6,12,9,2,9,1,74,10.571428571428571,1,0.0,16,6,7,9,19,2,5,9,1,38,36,1
1651,47739,GpxTNWiiHORZrtpaNpqPl31grEf03aBZ,7GRhBDsirIGkRZBtSMEzNTyDr2JQm4xx,2,0,0,0,0,0,2,0,2,0.2857142857142857,1,0.0,0,0,0,0,0,0,0,2,0,0,2,1
1652,47781,JelJmDAgdvYMwysu2S8khlhEiSoRMDm3,fbPkOYLVPtPgIt0MxizjfFJov3JbHyAi,21,20,8,12,7,0,3,0,50,7.142857142857143,1,0.0,11,8,12,7,9,0,0,3,0,38,12,0
1653,47803,93FWPuXY2azQQwZQWS80tdORRpOo60jj,fbPkOYLVPtPgIt0MxizjfFJov3JbHyAi,4,2,1,0,1,0,0,0,4,0.5714285714285714,1,0.0,0,1,0,1,2,0,0,0,0,2,2,1
1654,47813,pzBdNMI6l60tGyYDZDsD8a3IbqJH27O8,fbPkOYLVPtPgIt0MxizjfFJov3JbHyAi,10,12,3,0,1,0,6,0,22,3.142857142857143,4,0.0,0,3,0,1,12,0,0,6,0,4,18,0
1655,47844,P4gIdHzF607L8e8VPH3Qb09lxgNZRJFa,fbPkOYLVPtPgIt0MxizjfFJov3JbHyAi,5,9,3,0,4,0,1,0,17,2.4285714285714284,1,0.0,5,3,0,4,4,0,0,1,0,12,5,1
1656,47845,QQOQ1mBFT0hbDG4vhxUnw8WQ7hq3XsN0,fbPkOYLVPtPgIt0MxizjfFJov3JbHyAi,4,2,1,0,0,0,2,0,5,0.7142857142857143,1,0.0,0,1,0,0,2,0,0,2,0,1,4,1
1657,47854,gRdV8TKfYOuiXGGwKnVS8SiUiAxajq1L,fbPkOYLVPtPgIt0MxizjfFJov3JbHyAi,7,6,3,0,1,0,5,0,15,2.142857142857143,2,0.0,2,3,0,1,4,0,0,5,0,6,9,1
1658,47903,H938uEDZMr5x6mZr5R8OyAsB16zTacVQ,SpATywNh6bZuzm8s1ceuBUnMUAeoAHHw,14,14,1,12,0,0,2,0,29,4.142857142857143,1,0.0,2,1,11,0,12,0,1,2,0,14,15,1
1659,47931,ExNrdfeKsdYl3xmpiJlCBa13JPKyssuX,A3fsA9Zfv1X2fVEQhTw51lKENdNrEqT3,6,7,1,0,0,0,6,0,14,2.0,1,0.0,0,1,0,0,7,0,0,6,0,1,13,0
1660,47944,6u4AKdJzjLLZR1AtlnLDuMzDbZ4kM1Iv,bWdj2GDclj5ofokWjzoa5jAwMkxCykd6,11,14,8,0,7,4,5,0,38,5.428571428571429,2,0.0,2,8,0,7,12,4,0,5,0,17,21,1
1661,47949,9A7NeA8CSGMqqHgIDjiMNeFZF78KMRT6,bWdj2GDclj5ofokWjzoa5jAwMkxCykd6,8,5,1,0,0,1,7,2,16,2.2857142857142856,1,0.0,0,1,0,0,5,1,0,7,2,1,15,0
1662,47959,grSdEhkb3V38lf9YQcXO8O3GBe0inhXx,SpATywNh6bZuzm8s1ceuBUnMUAeoAHHw,4,4,0,0,0,0,2,0,6,0.8571428571428571,2,0.0,1,0,0,0,3,0,0,2,0,1,5,0
1663,47976,HhK8Fr5pAwm4jm0sdGfJEGDMiAvZjcpI,bWdj2GDclj5ofokWjzoa5jAwMkxCykd6,8,12,7,0,2,0,4,0,25,3.5714285714285716,2,0.0,0,7,0,2,12,0,0,4,0,9,16,1
1664,47983,nC6UOgoIicf8pr79f2rdG7NgUQiopW9Q,A3fsA9Zfv1X2fVEQhTw51lKENdNrEqT3,4,2,1,0,1,0,1,0,5,0.7142857142857143,1,0.0,0,1,0,1,2,0,0,1,0,2,3,0
1665,47991,w37wSK655FONLskeVHZ1T8H2i8llhkAq,SpATywNh6bZuzm8s1ceuBUnMUAeoAHHw,16,36,4,15,2,0,7,0,64,9.142857142857142,3,0.0,8,4,13,2,28,0,2,7,0,27,37,1
1666,48006,PihBsIILx8UWSnCui7TqzlKGzY1fk9nJ,RXDvfPUBYFlVdlueBFbLW0mhhAyGEqpt,18,13,8,0,4,0,6,2,33,4.714285714285714,1,0.0,1,8,0,4,12,0,0,6,2,13,20,1
1667,48037,tK5QWvLAN98DDvHjcCO96Vrig3bCPcrd,RXDvfPUBYFlVdlueBFbLW0mhhAyGEqpt,27,62,4,78,10,7,9,1,171,24.428571428571427,1,0.0,23,4,66,10,39,7,12,9,1,103,68,0
1668,48061,LUgTh6GVAZUuu6P6ClIsXLbxeQUErBSM,SpATywNh6bZuzm8s1ceuBUnMUAeoAHHw,6,6,1,0,1,0,2,0,10,1.4285714285714286,1,0.0,0,1,0,1,6,0,0,2,0,2,8,1
1669,48066,waLyzusenGGt78OBjbfLuixQktneXMVQ,SpATywNh6bZuzm8s1ceuBUnMUAeoAHHw,15,22,0,17,0,0,5,1,45,6.428571428571429,1,0.0,6,0,13,0,16,0,4,5,1,19,26,0
1670,48069,S0OJjF6aof0iTnIX6lUAxekoH3m4w7V0,A3fsA9Zfv1X2fVEQhTw51lKENdNrEqT3,36,39,24,78,5,0,16,0,162,23.142857142857142,6,0.0,4,24,58,5,35,0,20,16,0,91,71,0
1671,48088,jQM28yyQ4L2nHSWUJsgj6ijycvLum07J,bWdj2GDclj5ofokWjzoa5jAwMkxCykd6,11,8,6,0,2,0,7,1,24,3.4285714285714284,2,0.0,0,6,0,2,8,0,0,7,1,8,16,1
1672,48089,Yr9in8tqNPW6lzKPGBlYAXmDVewnbDn1,SpATywNh6bZuzm8s1ceuBUnMUAeoAHHw,21,14,9,6,7,12,4,0,52,7.428571428571429,1,0.0,4,9,5,7,10,12,1,4,0,25,27,0
1673,48092,TUbsPVDtB54KSPR2qHUpWUmDnVtGYqAT,SpATywNh6bZuzm8s1ceuBUnMUAeoAHHw,16,16,2,0,1,2,8,1,30,4.285714285714286,2,0.0,0,2,0,1,16,2,0,8,1,3,27,0
1674,48100,MEAK3CtWNpeCicplOKHcDUkHm4e2Gnat,A3fsA9Zfv1X2fVEQhTw51lKENdNrEqT3,7,8,7,0,6,0,3,0,24,3.4285714285714284,1,0.0,0,7,0,6,8,0,0,3,0,13,11,0
1675,48118,9pydrkItOvXReb7xWe6yqdMpXhFzfa5K,SpATywNh6bZuzm8s1ceuBUnMUAeoAHHw,5,6,0,0,0,4,7,0,17,2.4285714285714284,3,0.0,0,0,0,0,6,4,0,7,0,0,17,0
1676,48135,gtGDHRUZ7LgMlMOjWieE5uKSYCgIoTZ0,G8EPVSXsOYB5YQWZGiz1aVq5Pgr2GrQu,3,2,1,0,0,0,1,0,4,0.5714285714285714,1,0.0,0,1,0,0,2,0,0,1,0,1,3,0
1677,48138,f3FFKNKPDIkY4ZzespQ1tkojfbmyOtUb,SpATywNh6bZuzm8s1ceuBUnMUAeoAHHw,5,7,1,0,0,0,8,0,16,2.2857142857142856,2,0.0,0,1,0,0,7,0,0,8,0,1,15,0
1678,48139,6hXBi8QXIGsuTrfCDVW9WjrIWoxnhuCE,SpATywNh6bZuzm8s1ceuBUnMUAeoAHHw,1,0,0,0,0,0,1,0,1,0.14285714285714285,1,0.0,0,0,0,0,0,0,0,1,0,0,1,1
1679,48148,2zQQnqY1LiZ9lcEXTzcE3zimEdKe8CdV,SpATywNh6bZuzm8s1ceuBUnMUAeoAHHw,4,3,2,0,0,0,2,0,7,1.0,2,0.0,0,2,0,0,3,0,0,2,0,2,5,0
1680,48197,5KWnGsOw1ONkUhC7cQevc5FAKOxsvvUS,SpATywNh6bZuzm8s1ceuBUnMUAeoAHHw,6,5,2,0,1,0,4,0,12,1.7142857142857142,2,0.0,0,2,0,1,5,0,0,4,0,3,9,1
1681,48215,PEmuWJA7a0s7F0V9aIB9k0qqsQOvzH5e,A3fsA9Zfv1X2fVEQhTw51lKENdNrEqT3,9,2,2,0,2,0,5,0,11,1.5714285714285714,1,0.0,0,2,0,2,2,0,0,5,0,4,7,1
1682,48218,VBP5PzVQEKJYFH0y5ffEek5WfP9EW7uc,A3fsA9Zfv1X2fVEQhTw51lKENdNrEqT3,5,7,4,0,0,0,2,0,13,1.8571428571428572,2,0.0,0,4,0,0,7,0,0,2,0,4,9,1
1683,48221,eznmpA5TU6txEde6CJT70lkRbK5fBPvC,A3fsA9Zfv1X2fVEQhTw51lKENdNrEqT3,26,6,1,84,0,7,14,0,112,16.0,3,0.0,3,1,69,0,3,7,15,14,0,73,39,0
1684,48223,GfRp1O86gI5zJJh8SIJ1bczUJPWlAqoK,SpATywNh6bZuzm8s1ceuBUnMUAeoAHHw,7,5,1,0,0,2,16,1,25,3.5714285714285716,4,0.0,0,1,0,0,5,2,0,16,1,1,24,0
1685,48239,5dHhwSyX3MJPaRvMe9fCcvMfYGdzfWsb,SpATywNh6bZuzm8s1ceuBUnMUAeoAHHw,2,0,0,0,0,0,2,0,2,0.2857142857142857,1,0.0,0,0,0,0,0,0,0,2,0,0,2,1
1686,48255,gLAW4GOuyz8JKg5RO5Sf2rzir65isCiq,G8EPVSXsOYB5YQWZGiz1aVq5Pgr2GrQu,9,16,1,0,1,0,2,0,20,2.857142857142857,2,0.0,0,1,0,1,16,0,0,2,0,2,18,0
1687,48268,EhHrinjt1AkEWC09AFZwBuP61S5NJgjn,A3fsA9Zfv1X2fVEQhTw51lKENdNrEqT3,33,30,17,54,10,0,9,0,120,17.142857142857142,2,0.0,1,17,44,10,29,0,10,9,0,72,48,1
1688,48277,KJnvgR26H5LLeKdyvjJHjjqg4mjHEhgN,A3fsA9Zfv1X2fVEQhTw51lKENdNrEqT3,26,6,3,92,0,0,6,0,107,15.285714285714286,2,0.0,1,3,85,0,5,0,7,6,0,89,18,1
1689,48303,ibgC3AgPCiKxZzQtLwOtyIa6DJRV6K2p,SpATywNh6bZuzm8s1ceuBUnMUAeoAHHw,4,7,4,0,0,0,4,0,15,2.142857142857143,3,0.0,0,4,0,0,7,0,0,4,0,4,11,0
1690,48304,H5UEKpeYUS8ZwAU1o3ZTuTx8QVBIM5mj,SpATywNh6bZuzm8s1ceuBUnMUAeoAHHw,1,0,0,0,0,0,1,0,1,0.14285714285714285,1,0.0,0,0,0,0,0,0,0,1,0,0,1,1
1691,48308,UqMl8IgLVIouo6TVWfUzDQbBX8JDKQrY,SpATywNh6bZuzm8s1ceuBUnMUAeoAHHw,18,17,11,0,8,1,3,0,40,5.714285714285714,1,0.0,2,11,0,8,15,1,0,3,0,21,19,1
1692,48343,KJnvgR26H5LLeKdyvjJHjjqg4mjHEhgN,bWdj2GDclj5ofokWjzoa5jAwMkxCykd6,41,52,25,184,19,43,22,1,346,49.42857142857143,4,0.0,23,25,166,19,29,43,18,22,1,233,113,0
1693,48353,kiVzCvDoEqSB7iO0TU3ERoanC9pEAYCs,A3fsA9Zfv1X2fVEQhTw51lKENdNrEqT3,2,0,0,0,0,0,4,0,4,0.5714285714285714,1,0.0,0,0,0,0,0,0,0,4,0,0,4,1
1694,48354,YUkia24kFQkJdU9Tc0bEfJWS5kFL3fnZ,SpATywNh6bZuzm8s1ceuBUnMUAeoAHHw,3,0,0,0,0,8,5,0,13,1.8571428571428572,3,0.0,0,0,0,0,0,8,0,5,0,0,13,0
1695,48364,TMaAbfbbsUXbGWJIhu1feBQgRZO29am6,G8EPVSXsOYB5YQWZGiz1aVq5Pgr2GrQu,62,68,39,163,23,46,21,2,362,51.714285714285715,4,0.0,6,39,135,23,62,46,28,21,2,203,159,0
1696,48366,eQnxTOv5tF733HrH1v8IIfXTQQ20WB86,SpATywNh6bZuzm8s1ceuBUnMUAeoAHHw,1,0,0,0,0,0,2,0,2,0.2857142857142857,2,0.0,0,0,0,0,0,0,0,2,0,0,2,0
1697,48410,fKzNFTbPePkMpMq31aLHMmVifATbrx2C,A3fsA9Zfv1X2fVEQhTw51lKENdNrEqT3,5,4,1,0,0,0,1,0,6,0.8571428571428571,2,0.0,0,1,0,0,4,0,0,1,0,1,5,1
1698,48450,oWaJx5przpU6lf15eldDAW9VD7f9UZbS,SpATywNh6bZuzm8s1ceuBUnMUAeoAHHw,20,12,8,6,4,16,5,1,52,7.428571428571429,1,0.0,2,8,6,4,10,16,0,5,1,20,32,0
1699,48466,zOGgv8cnkqEW7Y2l6fqZ3IzLqplNhsIx,SpATywNh6bZuzm8s1ceuBUnMUAeoAHHw,6,7,1,0,1,3,2,0,14,2.0,1,0.0,0,1,0,1,7,3,0,2,0,2,12,1
1700,48480,T2e7T1KVGbCZHkx82TLCiB6K2groJqnl,SpATywNh6bZuzm8s1ceuBUnMUAeoAHHw,15,16,0,14,0,8,5,0,43,6.142857142857143,1,0.0,5,0,13,0,11,8,1,5,0,18,25,1
1701,48498,VEdQQ1yOFNqPNBrecyFKsnw5QECT7x69,SpATywNh6bZuzm8s1ceuBUnMUAeoAHHw,5,3,1,0,1,0,1,0,6,0.8571428571428571,1,0.0,0,1,0,1,3,0,0,1,0,2,4,1
1702,48509,a41llItPMmO7jtwR6NH41lmydyfI26Gz,SpATywNh6bZuzm8s1ceuBUnMUAeoAHHw,9,16,0,18,0,13,5,0,52,7.428571428571429,2,0.0,10,0,15,0,6,13,3,5,0,25,27,0
1703,48515,NCU9xqLhC281ErH7IwNmupIJSyhaNMZW,SpATywNh6bZuzm8s1ceuBUnMUAeoAHHw,11,12,0,13,0,0,5,0,30,4.285714285714286,2,0.0,3,0,12,0,9,0,1,5,0,15,15,0
1704,48520,EBgUhfQ9Yh2Xchyg5A4RNjz8pUXCnWl0,SpATywNh6bZuzm8s1ceuBUnMUAeoAHHw,23,45,0,25,0,0,4,0,74,10.571428571428571,1,0.0,13,0,21,0,32,0,4,4,0,34,40,1
1705,48524,aYYkr3EBoQc6U0mONjplTV8V30x3QwMR,SpATywNh6bZuzm8s1ceuBUnMUAeoAHHw,17,45,13,47,0,22,32,3,162,23.142857142857142,4,0.0,20,13,40,0,25,22,7,32,3,73,89,0
1706,48557,CMxWacrlvHBos1yTh6CX0stfBtIQjdRZ,SpATywNh6bZuzm8s1ceuBUnMUAeoAHHw,11,15,4,13,2,4,1,0,39,5.571428571428571,1,0.0,8,4,12,2,7,4,1,1,0,26,13,0
1707,48572,RvDbqb1jf5bMQYeeBsAiuychmXlXMqZ3,SpATywNh6bZuzm8s1ceuBUnMUAeoAHHw,3,4,2,0,0,0,1,0,7,1.0,1,0.0,0,2,0,0,4,0,0,1,0,2,5,0
1708,48579,OmRwEqIcEcFH28h4LCCN9RZtwAWWiBmW,SpATywNh6bZuzm8s1ceuBUnMUAeoAHHw,5,9,0,0,0,0,2,0,11,1.5714285714285714,1,0.0,0,0,0,0,9,0,0,2,0,0,11,1
1709,48580,PTsQJZyhlmM5FQqbiEkU0C6Xoz9Oth0N,RXDvfPUBYFlVdlueBFbLW0mhhAyGEqpt,4,2,0,0,0,0,2,0,4,0.5714285714285714,1,0.0,0,0,0,0,2,0,0,2,0,0,4,0
1710,48581,ZmRlQUxjzuIBTqGZ1TI9p3XDJluy6dCH,SpATywNh6bZuzm8s1ceuBUnMUAeoAHHw,26,37,27,11,15,20,8,0,118,16.857142857142858,3,0.0,0,27,10,15,37,20,1,8,0,52,66,0
1711,48590,Bm1ROY20Td8ahvL40ylWLEiakWpICc5q,SpATywNh6bZuzm8s1ceuBUnMUAeoAHHw,29,29,16,44,6,78,9,6,188,26.857142857142858,2,0.0,7,16,37,6,22,78,7,9,6,66,122,0
1712,48627,SRvotFFDI4c4Tqustgf1LZhg7uROitU6,SpATywNh6bZuzm8s1ceuBUnMUAeoAHHw,10,7,1,0,0,0,12,3,23,3.2857142857142856,1,0.0,0,1,0,0,7,0,0,12,3,1,22,1
1713,48637,rhEIW0I6psA9HvuF18HCB0BDkVKeLeRv,SpATywNh6bZuzm8s1ceuBUnMUAeoAHHw,6,2,1,0,1,0,3,0,7,1.0,1,0.0,0,1,0,1,2,0,0,3,0,2,5,1
1714,48647,A5P9jrlzLqQKpA3sVBvwbPCf9CAYmtxw,SpATywNh6bZuzm8s1ceuBUnMUAeoAHHw,4,0,0,0,0,2,4,1,7,1.0,2,0.0,0,0,0,0,0,2,0,4,1,0,7,0
1715,48677,miskafWCgRGEerOwmFhGeXinZmiVq8Xq,SpATywNh6bZuzm8s1ceuBUnMUAeoAHHw,19,28,14,12,6,8,9,1,78,11.142857142857142,1,0.0,4,14,10,6,24,8,2,9,1,34,44,0
1716,48710,2wpbmqMFHp4amvfRnEjwZEJ5A6Okr1xC,G8EPVSXsOYB5YQWZGiz1aVq5Pgr2GrQu,6,3,1,0,1,0,2,0,7,1.0,1,0.0,0,1,0,1,3,0,0,2,0,2,5,1
1717,48718,5AugieBFEAlTT6fEoe5Ptq1jAvWA2bXj,SpATywNh6bZuzm8s1ceuBUnMUAeoAHHw,17,19,1,19,1,0,3,0,43,6.142857142857143,1,0.0,7,1,16,1,12,0,3,3,0,25,18,1
1718,48727,2XL6bjSwWRsdF2Id5N4HOR8GedxbL8Tj,SpATywNh6bZuzm8s1ceuBUnMUAeoAHHw,16,20,0,8,0,0,5,0,33,4.714285714285714,3,0.0,2,0,7,0,18,0,1,5,0,9,24,0
1719,48733,mitKAcO5Yq84LGwUL473CFioIDbwQfRi,SpATywNh6bZuzm8s1ceuBUnMUAeoAHHw,4,2,1,0,0,0,5,0,8,1.1428571428571428,2,0.0,0,1,0,0,2,0,0,5,0,1,7,0
1720,48743,geHYnGH5sQ7aHnnwLKBvDRjabqJU8jWh,RXDvfPUBYFlVdlueBFbLW0mhhAyGEqpt,42,56,3,96,5,4,10,1,175,25.0,3,0.0,18,3,82,5,38,4,14,10,1,108,67,1
1721,48764,oWaJx5przpU6lf15eldDAW9VD7f9UZbS,RXDvfPUBYFlVdlueBFbLW0mhhAyGEqpt,27,36,22,30,11,29,5,0,133,19.0,1,0.0,10,22,29,11,26,29,1,5,0,72,61,0
1722,48788,IN0xY05lGNY1Rxj5WWCYq1C0mF0lQ2fJ,SpATywNh6bZuzm8s1ceuBUnMUAeoAHHw,27,33,13,12,7,6,7,0,78,11.142857142857142,2,0.0,7,13,9,7,26,6,3,7,0,36,42,0
1723,48861,0WvPxKqLdXDP6VJDS60sOhS8Syb4RdJF,G8EPVSXsOYB5YQWZGiz1aVq5Pgr2GrQu,27,100,1,0,1,0,8,1,111,15.857142857142858,2,0.0,2,1,0,1,98,0,0,8,1,4,107,1
1724,48876,Ufo4AkS2vTW82q9Kpcrkrp0gG0Us5zu9,SpATywNh6bZuzm8s1ceuBUnMUAeoAHHw,22,33,6,11,3,0,15,1,69,9.857142857142858,3,0.0,5,6,10,3,28,0,1,15,1,24,45,0
1725,48881,n7yQ1FvfAXqDnBpszfIUjZkrvw3J2aJC,A3fsA9Zfv1X2fVEQhTw51lKENdNrEqT3,3,0,0,0,0,3,2,0,5,0.7142857142857143,1,0.0,0,0,0,0,0,3,0,2,0,0,5,1
1726,48903,TdcZVkuHoNELu59WVF9f7EUYKiYIHP14,A3fsA9Zfv1X2fVEQhTw51lKENdNrEqT3,13,16,8,0,3,0,10,0,37,5.285714285714286,3,0.0,0,8,0,3,16,0,0,10,0,11,26,0
1727,48953,cPrlzYoTDFDvccHbBKlJUrITep6ieC7X,SpATywNh6bZuzm8s1ceuBUnMUAeoAHHw,5,7,1,0,0,0,8,0,16,2.2857142857142856,4,0.0,0,1,0,0,7,0,0,8,0,1,15,0
1728,48972,4IxIKalU9kAsrSpHM9QUN57NRdKohmHA,SpATywNh6bZuzm8s1ceuBUnMUAeoAHHw,11,11,1,7,0,0,6,1,26,3.7142857142857144,2,0.0,4,1,7,0,7,0,0,6,1,12,14,0
1729,48991,aOfddFrct0TUA0MYqpcFv1UssmM1IX2e,SpATywNh6bZuzm8s1ceuBUnMUAeoAHHw,3,2,1,0,0,25,2,0,30,4.285714285714286,1,0.0,0,1,0,0,2,25,0,2,0,1,29,1
1730,49001,xLRXz6THj9rNHROqVgV4eCcKXyO03jXb,RXDvfPUBYFlVdlueBFbLW0mhhAyGEqpt,22,59,27,46,12,0,5,0,149,21.285714285714285,3,0.0,2,27,42,12,57,0,4,5,0,83,66,1
1731,49011,1fjO19pGLwHG3depgSJxIFrDpr07UqZK,SpATywNh6bZuzm8s1ceuBUnMUAeoAHHw,16,19,2,12,1,2,5,0,41,5.857142857142857,3,0.0,6,2,12,1,13,2,0,5,0,21,20,0
1732,49017,1fjO19pGLwHG3depgSJxIFrDpr07UqZK,bWdj2GDclj5ofokWjzoa5jAwMkxCykd6,25,36,19,58,5,35,16,0,169,24.142857142857142,4,0.0,0,19,51,5,36,35,7,16,0,75,94,1
1733,49024,SLljRLEQVmbKytDsyUG54XDlcZasHRnD,SpATywNh6bZuzm8s1ceuBUnMUAeoAHHw,12,21,6,4,2,1,18,0,52,7.428571428571429,3,0.0,0,6,3,2,21,1,1,18,0,11,41,0
1734,49047,PcQbQt2Pubz9h6iRkhILIzmVZ7ajU4yi,SpATywNh6bZuzm8s1ceuBUnMUAeoAHHw,10,19,0,19,0,0,4,0,42,6.0,1,0.0,4,0,17,0,15,0,2,4,0,21,21,1
1735,49076,WSyXGkhm7NDepRlMA3agJj8k8GLnavsP,SpATywNh6bZuzm8s1ceuBUnMUAeoAHHw,8,8,7,0,4,0,1,0,20,2.857142857142857,1,0.0,0,7,0,4,8,0,0,1,0,11,9,0
1736,49088,se5zs87qj8m5HDpiAuY9fHW8e8hfOFuJ,A3fsA9Zfv1X2fVEQhTw51lKENdNrEqT3,1,0,0,0,0,0,1,0,1,0.14285714285714285,1,0.0,0,0,0,0,0,0,0,1,0,0,1,1
1737,49093,KcyotPC829BMj56l23keqhJ3VB5WV4xY,A3fsA9Zfv1X2fVEQhTw51lKENdNrEqT3,4,3,1,0,1,0,0,0,5,0.7142857142857143,1,0.0,1,1,0,1,2,0,0,0,0,3,2,1
1738,49096,etO9cGvtnbcyDOUow8PWemZvzpbkeWT2,SpATywNh6bZuzm8s1ceuBUnMUAeoAHHw,16,29,16,14,3,1,7,0,70,10.0,3,0.0,7,16,12,3,22,1,2,7,0,38,32,0
1739,49114,1uHLOYSfEFwzZFuLCsgyZIWEkaqBo7Qo,A3fsA9Zfv1X2fVEQhTw51lKENdNrEqT3,1,0,0,0,0,0,1,0,1,0.14285714285714285,1,0.0,0,0,0,0,0,0,0,1,0,0,1,1
1740,49129,5VPsupm8AUE2ZBwqUxHjS8zxcSp1Mcls,SpATywNh6bZuzm8s1ceuBUnMUAeoAHHw,6,4,2,0,0,3,7,1,17,2.4285714285714284,2,0.0,0,2,0,0,4,3,0,7,1,2,15,0
1741,49132,gSsRzqNvll8eqcaaEGmB933OlJpuGX1g,G8EPVSXsOYB5YQWZGiz1aVq5Pgr2GrQu,59,42,25,138,16,32,13,0,266,38.0,4,0.0,9,25,117,16,33,32,21,13,0,167,99,0
1742,49143,Jt2ZVEP2fRpS6kT1yCei4p4So6yqdxLs,SpATywNh6bZuzm8s1ceuBUnMUAeoAHHw,5,3,2,0,0,0,2,0,7,1.0,1,0.0,0,2,0,0,3,0,0,2,0,2,5,0
1743,49155,xbEgNPkq7oopGIGH4RYgTrlgPLk46GrG,SpATywNh6bZuzm8s1ceuBUnMUAeoAHHw,16,18,1,30,0,1,10,1,61,8.714285714285714,1,0.0,12,1,29,0,6,1,1,10,1,42,19,0
1744,49174,WjU8VISsquSeFe2LBisgFs90fx26laYI,SpATywNh6bZuzm8s1ceuBUnMUAeoAHHw,8,8,0,0,0,2,12,1,23,3.2857142857142856,1,0.0,0,0,0,0,8,2,0,12,1,0,23,0
1745,49188,tg4dRbWUPF4nI55illP72uaDj0KVwE07,SpATywNh6bZuzm8s1ceuBUnMUAeoAHHw,2,0,0,0,0,0,2,0,2,0.2857142857142857,1,0.0,0,0,0,0,0,0,0,2,0,0,2,1
1746,49196,FFLpMSWkcYP9u5pfR9jmdACaFpKaDwug,SpATywNh6bZuzm8s1ceuBUnMUAeoAHHw,18,13,10,0,8,0,4,0,35,5.0,2,0.0,0,10,0,8,13,0,0,4,0,18,17,0
1747,49197,sHAdbtjkiytWLt2Io4BZ2tzs5Et0ae7f,A3fsA9Zfv1X2fVEQhTw51lKENdNrEqT3,4,2,0,0,0,0,5,0,7,1.0,1,0.0,0,0,0,0,2,0,0,5,0,0,7,1
1748,49204,KWhhYcngkyB7QbL1Y9080mTGvLlZLj2v,SpATywNh6bZuzm8s1ceuBUnMUAeoAHHw,17,14,9,14,5,0,2,0,44,6.285714285714286,2,0.0,2,9,11,5,12,0,3,2,0,27,17,1
1749,49212,l70wRZ2DS0s6LjbT7C4gRoGrF27x9p2H,SpATywNh6bZuzm8s1ceuBUnMUAeoAHHw,4,5,0,0,0,0,3,0,8,1.1428571428571428,3,0.0,0,0,0,0,5,0,0,3,0,0,8,0
1750,49227,Qv53J5pwTj9vVvZOfTayJrmLGAxLRscw,A3fsA9Zfv1X2fVEQhTw51lKENdNrEqT3,7,2,1,0,1,1,5,0,10,1.4285714285714286,1,0.0,0,1,0,1,2,1,0,5,0,2,8,1
1751,49237,Et66VbQRwkFnF42twZ8Z4ErFWQLehmwC,G8EPVSXsOYB5YQWZGiz1aVq5Pgr2GrQu,6,7,2,0,2,0,4,0,15,2.142857142857143,1,0.0,1,2,0,2,6,0,0,4,0,5,10,1
1752,49313,YQzUeDQQAfJF96X2O80R1owwrQ0VWsFN,SpATywNh6bZuzm8s1ceuBUnMUAeoAHHw,14,8,7,0,7,0,2,0,24,3.4285714285714284,2,0.0,0,7,0,7,8,0,0,2,0,14,10,0
1753,49351,eFBES6IMQYn0JaXFDvfen5eqvCA8gBJT,A3fsA9Zfv1X2fVEQhTw51lKENdNrEqT3,1,0,0,0,0,0,1,0,1,0.14285714285714285,1,0.0,0,0,0,0,0,0,0,1,0,0,1,1
1754,49353,W6MGFBQ1Tov9lOeRQ8QlzHUMCDNEGRDq,SpATywNh6bZuzm8s1ceuBUnMUAeoAHHw,13,12,0,27,0,0,2,0,41,5.857142857142857,1,0.0,6,0,24,0,6,0,3,2,0,30,11,1
1755,49376,endumB3uNuPZEFkf3CSbVDfBrwPiEVSP,A3fsA9Zfv1X2fVEQhTw51lKENdNrEqT3,9,5,5,0,4,0,4,0,18,2.5714285714285716,1,0.0,0,5,0,4,5,0,0,4,0,9,9,1
1756,49397,uZVvmJaNXb0GsvOW7SvWgzrpxZ3muXeW,SpATywNh6bZuzm8s1ceuBUnMUAeoAHHw,3,2,1,0,0,0,2,0,5,0.7142857142857143,1,0.0,0,1,0,0,2,0,0,2,0,1,4,0
1757,49410,tzUG2qRl7N6mPYRCQUU2RS3J3hIQZLrD,bWdj2GDclj5ofokWjzoa5jAwMkxCykd6,17,31,18,28,11,8,6,0,102,14.571428571428571,1,0.0,7,18,24,11,24,8,4,6,0,60,42,1
1758,49428,HxubVk6qxALTKY86iFsfskUh9kA3f2Wx,SpATywNh6bZuzm8s1ceuBUnMUAeoAHHw,31,70,28,51,14,29,16,3,211,30.142857142857142,4,0.0,22,28,40,14,48,29,11,16,3,104,107,0
1759,49457,KdLS3BVh0aFKrdvLPEqJwR9P75VBUiUC,SpATywNh6bZuzm8s1ceuBUnMUAeoAHHw,8,8,5,0,5,0,3,0,21,3.0,1,0.0,1,5,0,5,7,0,0,3,0,11,10,1
1760,49481,2uoMQOxqyRzmIYFGnyAflqy5t44QW2xE,G8EPVSXsOYB5YQWZGiz1aVq5Pgr2GrQu,25,21,11,46,6,0,1,0,85,12.142857142857142,2,0.0,8,11,34,6,13,0,12,1,0,59,26,0
1761,49491,4WZA45bzzwtSAshCx00ZUSQpyrxBtdvp,SpATywNh6bZuzm8s1ceuBUnMUAeoAHHw,7,7,6,0,6,0,2,0,21,3.0,2,0.0,0,6,0,6,7,0,0,2,0,12,9,1
1762,49492,8zWgVyFjldbfjgOVhyVSCY9hVHofzB37,SpATywNh6bZuzm8s1ceuBUnMUAeoAHHw,6,4,3,0,1,0,2,0,10,1.4285714285714286,1,0.0,0,3,0,1,4,0,0,2,0,4,6,0
1763,49502,zbDDJL57Eoinf5rQFwxv5qPElJd1fdtI,SpATywNh6bZuzm8s1ceuBUnMUAeoAHHw,3,2,0,0,0,0,1,0,3,0.42857142857142855,1,0.0,0,0,0,0,2,0,0,1,0,0,3,1
1764,49506,ZOJ5QbCRlZ7Fm01C02cxFKL8leZWKfBc,SpATywNh6bZuzm8s1ceuBUnMUAeoAHHw,25,62,1,35,0,6,14,2,120,17.142857142857142,3,0.0,17,1,28,0,45,6,7,14,2,46,74,0
1765,49547,PIAH3m3yXecwsaiYYmcRmhzQt3oUmGgZ,A3fsA9Zfv1X2fVEQhTw51lKENdNrEqT3,2,0,0,0,0,0,2,0,2,0.2857142857142857,1,0.0,0,0,0,0,0,0,0,2,0,0,2,1
1766,49574,jdOdZxrxaATCu1ggjNzD0BD26QmUeIwp,A3fsA9Zfv1X2fVEQhTw51lKENdNrEqT3,1,0,0,0,0,0,1,0,1,0.14285714285714285,1,0.0,0,0,0,0,0,0,0,1,0,0,1,1
1767,49593,tLAxgBhXx0zpE8fWNnwggaJx5LeHI2h1,A3fsA9Zfv1X2fVEQhTw51lKENdNrEqT3,34,41,23,96,24,0,4,0,188,26.857142857142858,2,0.0,1,23,79,24,40,0,17,4,0,127,61,1
1768,49594,cvoMRtPY6qflB97uu9pYZ8EABJnJiTnH,A3fsA9Zfv1X2fVEQhTw51lKENdNrEqT3,7,7,1,0,1,0,3,0,12,1.7142857142857142,2,0.0,1,1,0,1,6,0,0,3,0,3,9,1
1769,49602,7vO4g7GKU63bpLmNrZ8Z66FvgSw6Sbgl,A3fsA9Zfv1X2fVEQhTw51lKENdNrEqT3,4,2,1,0,1,0,1,0,5,0.7142857142857143,1,0.0,0,1,0,1,2,0,0,1,0,2,3,1
1770,49675,vEvuCci9jxTTRH9CGXFnMQL31rdrARkm,RXDvfPUBYFlVdlueBFbLW0mhhAyGEqpt,47,81,40,110,23,11,22,2,289,41.285714285714285,6,0.0,18,40,99,23,63,11,11,22,2,180,109,1
1771,49676,1rh5VRO8SYrfP8Lu1XXtrSs551JhH1SG,SpATywNh6bZuzm8s1ceuBUnMUAeoAHHw,32,40,21,31,10,19,21,1,143,20.428571428571427,4,0.0,12,21,28,10,28,19,3,21,1,71,72,0
1772,49684,RSF86CJJRRqjqcjlLpUNS7gfvntoDbsR,SpATywNh6bZuzm8s1ceuBUnMUAeoAHHw,22,48,19,12,10,1,3,0,93,13.285714285714286,1,0.0,9,19,9,10,39,1,3,3,0,47,46,0
1773,49689,M4KtR07p6NuW0Nzc9JWKn4kOJ33eMAHm,G8EPVSXsOYB5YQWZGiz1aVq5Pgr2GrQu,22,28,6,30,4,1,5,1,75,10.714285714285714,1,0.0,20,6,16,4,8,1,14,5,1,46,29,1
1774,49713,3mhHS6HFiNSDTjK0MItggE081qDKfyqL,SpATywNh6bZuzm8s1ceuBUnMUAeoAHHw,1,0,0,0,0,0,2,0,2,0.2857142857142857,1,0.0,0,0,0,0,0,0,0,2,0,0,2,0
1775,49733,YIbC1cuJA4PbBVwCZRQOVlAtofCW8hIn,A3fsA9Zfv1X2fVEQhTw51lKENdNrEqT3,31,13,8,60,4,0,2,0,87,12.428571428571429,1,0.0,2,8,54,4,11,0,6,2,0,68,19,1
1776,49746,pFE82fh5DH8NUVtvV1y83suNQP2lNeAe,RXDvfPUBYFlVdlueBFbLW0mhhAyGEqpt,18,17,1,24,1,0,1,0,44,6.285714285714286,1,0.0,6,1,23,1,11,0,1,1,0,31,13,0
1777,49779,W6MGFBQ1Tov9lOeRQ8QlzHUMCDNEGRDq,A3fsA9Zfv1X2fVEQhTw51lKENdNrEqT3,40,36,19,48,9,3,13,2,130,18.571428571428573,2,0.0,2,19,48,9,34,3,0,13,2,78,52,0
1778,49819,TN2mpCmjDkqLDPlwKTIBj6ZZbjnMqCiy,A3fsA9Zfv1X2fVEQhTw51lKENdNrEqT3,25,18,13,0,11,0,10,0,52,7.428571428571429,2,0.0,0,13,0,11,18,0,0,10,0,24,28,1
1779,49837,lBlhCim6cr1auRYAm96gRvGD6qkdcp2T,A3fsA9Zfv1X2fVEQhTw51lKENdNrEqT3,2,0,0,0,0,0,4,0,4,0.5714285714285714,1,0.0,0,0,0,0,0,0,0,4,0,0,4,1
1780,49867,ajdXJNtmFj3djCMALYMagt4EstfNGU3t,SpATywNh6bZuzm8s1ceuBUnMUAeoAHHw,21,17,12,9,7,11,14,0,70,10.0,3,0.0,2,12,9,7,15,11,0,14,0,30,40,0
1781,49875,0Akk5gAtNLhWs93rvoK6BfZzftMu43VT,SpATywNh6bZuzm8s1ceuBUnMUAeoAHHw,29,37,15,32,7,3,11,2,107,15.285714285714286,2,0.0,8,15,30,7,29,3,2,11,2,60,47,0
1782,49878,fvzGqz3wcA15cPFjEfZNgqzkQDubcDYj,SpATywNh6bZuzm8s1ceuBUnMUAeoAHHw,17,29,15,14,0,16,31,7,112,16.0,5,0.0,7,15,12,0,22,16,2,31,7,34,78,0
1783,49939,WMFV7sfGiymyypraYicGVqscWxGZ0nHz,SpATywNh6bZuzm8s1ceuBUnMUAeoAHHw,5,3,0,0,0,0,4,0,7,1.0,1,0.0,0,0,0,0,3,0,0,4,0,0,7,1
1784,49941,C4q4gNQYEpjKh7pq1qjN8i3L7uSpUX9d,RXDvfPUBYFlVdlueBFbLW0mhhAyGEqpt,18,19,14,32,11,1,6,1,84,12.0,2,0.0,2,14,28,11,17,1,4,6,1,55,29,1
1785,49947,xXjBI1Nf4mgkfSUkf8YjQF9E0XahXwSr,SpATywNh6bZuzm8s1ceuBUnMUAeoAHHw,19,20,8,8,4,0,5,0,45,6.428571428571429,2,0.0,9,8,8,4,11,0,0,5,0,29,16,0
1786,49957,BJvWyg8XIdrq4SNeVAfLk9dJg6cRJiup,A3fsA9Zfv1X2fVEQhTw51lKENdNrEqT3,2,0,0,0,0,0,5,0,5,0.7142857142857143,1,0.0,0,0,0,0,0,0,0,5,0,0,5,1
1787,49960,5DZRIacIZU0OycjWEAvqBXR0CzjjwwCH,SpATywNh6bZuzm8s1ceuBUnMUAeoAHHw,20,22,0,27,0,0,7,0,56,8.0,2,0.0,10,0,25,0,12,0,2,7,0,35,21,0
1788,49980,fFjj8aLqWVfTrDoDqL54VYBbLQmMY3Y1,G8EPVSXsOYB5YQWZGiz1aVq5Pgr2GrQu,1,0,0,0,0,0,1,0,1,0.14285714285714285,1,0.0,0,0,0,0,0,0,0,1,0,0,1,1
1789,49981,Q0d1WItnRJvnzlnn5VcAU6GMGN4rfbYJ,A3fsA9Zfv1X2fVEQhTw51lKENdNrEqT3,21,41,26,0,14,0,5,0,86,12.285714285714286,3,0.0,0,26,0,14,41,0,0,5,0,40,46,1
1790,49986,cT0XTodWylQtczhaeg1zuAXwbhCqeXWR,SpATywNh6bZuzm8s1ceuBUnMUAeoAHHw,5,3,1,0,1,0,1,0,6,0.8571428571428571,1,0.0,0,1,0,1,3,0,0,1,0,2,4,0
1791,50006,IjWCyY0OMptnbDif5zdKxFY839cuvS21,SpATywNh6bZuzm8s1ceuBUnMUAeoAHHw,5,5,4,0,2,0,2,0,13,1.8571428571428572,2,0.0,0,4,0,2,5,0,0,2,0,6,7,0
1792,50015,me65WsEaHvTZs0TNYVukzNrKK1hdRpMM,A3fsA9Zfv1X2fVEQhTw51lKENdNrEqT3,7,5,3,0,1,0,3,0,12,1.7142857142857142,1,0.0,0,3,0,1,5,0,0,3,0,4,8,1
1793,50023,Eu9HoDt3WhECHgcXaERosbI6lMj7Hipb,A3fsA9Zfv1X2fVEQhTw51lKENdNrEqT3,22,17,15,0,12,0,2,0,46,6.571428571428571,2,0.0,0,15,0,12,17,0,0,2,0,27,19,1
1794,50027,tWEnJYIhXMJ03Foo959mubaAJUHZPTw0,SpATywNh6bZuzm8s1ceuBUnMUAeoAHHw,7,29,0,0,0,19,21,1,70,10.0,6,0.0,1,0,0,0,28,19,0,21,1,1,69,0
1795,50028,9e5dcfJQbPUU8sTcmzE9DWoDPOA9Nhu3,A3fsA9Zfv1X2fVEQhTw51lKENdNrEqT3,4,5,0,0,0,0,3,0,8,1.1428571428571428,1,0.0,0,0,0,0,5,0,0,3,0,0,8,0
1796,50032,aKjAC5UWlmbeTD1k9n3NGSA3VSvaAKtm,SpATywNh6bZuzm8s1ceuBUnMUAeoAHHw,22,35,23,12,6,0,7,0,83,11.857142857142858,2,0.0,8,23,11,6,27,0,1,7,0,48,35,0
1797,50084,1HlQxNM9nR1hj1jXFLyimiGxZiQUWT8w,RXDvfPUBYFlVdlueBFbLW0mhhAyGEqpt,33,33,17,53,11,4,5,1,124,17.714285714285715,1,0.0,9,17,52,11,24,4,1,5,1,89,35,1
1798,50113,YGwgPZSZDAKlEa7pV7OgIimz6xfMMXoJ,A3fsA9Zfv1X2fVEQhTw51lKENdNrEqT3,1,0,0,0,0,0,1,0,1,0.14285714285714285,1,0.0,0,0,0,0,0,0,0,1,0,0,1,1
1799,50157,QxxdakYrISiiDLexNlB0fwU8yeNcfQh4,SpATywNh6bZuzm8s1ceuBUnMUAeoAHHw,16,15,8,17,3,1,2,0,46,6.571428571428571,1,0.0,4,8,15,3,11,1,2,2,0,30,16,1
1800,50161,vQxwNbtZgUat9SDZRmE7MEKdvAizpBwk,SpATywNh6bZuzm8s1ceuBUnMUAeoAHHw,7,12,4,0,1,0,2,0,19,2.7142857142857144,2,0.0,0,4,0,1,12,0,0,2,0,5,14,0
1801,50170,jJ6KwmQPdHVF9SNnawJ7zfgWoExKlRbO,SpATywNh6bZuzm8s1ceuBUnMUAeoAHHw,14,20,9,12,3,0,2,0,46,6.571428571428571,1,0.0,5,9,10,3,15,0,2,2,0,27,19,1
1802,50173,lVM3D8yPmd62Fdb29hI2YI0VPwlNvI4t,bWdj2GDclj5ofokWjzoa5jAwMkxCykd6,11,20,7,8,8,0,4,0,47,6.714285714285714,1,0.0,10,7,7,8,10,0,1,4,0,32,15,1
1803,50203,8ZgsKNDzCbgk8zoZndfYiYFsfvE0SQgi,SpATywNh6bZuzm8s1ceuBUnMUAeoAHHw,2,0,0,0,0,0,4,0,4,0.5714285714285714,2,0.0,0,0,0,0,0,0,0,4,0,0,4,0
1804,50223,l5LfU8gApOG72AnBkdAbfOLQLwFH7Zo2,SpATywNh6bZuzm8s1ceuBUnMUAeoAHHw,3,2,0,0,0,0,1,0,3,0.42857142857142855,1,0.0,0,0,0,0,2,0,0,1,0,0,3,0
1805,50279,CyelsVXrffOJcI4D4Ax6e4uKbn9S9AKP,A3fsA9Zfv1X2fVEQhTw51lKENdNrEqT3,2,0,0,0,0,0,2,0,2,0.2857142857142857,1,0.0,0,0,0,0,0,0,0,2,0,0,2,1
1806,50294,mexTVUuTBaMSHWugjgX7gCSwX1B8AubF,SpATywNh6bZuzm8s1ceuBUnMUAeoAHHw,5,4,1,0,1,0,1,0,7,1.0,1,0.0,0,1,0,1,4,0,0,1,0,2,5,0
1807,50320,1OwZz25mXZNgO62URLrpwxju1xtv0yd9,SpATywNh6bZuzm8s1ceuBUnMUAeoAHHw,11,25,4,24,0,6,13,1,73,10.428571428571429,3,0.0,11,4,20,0,14,6,4,13,1,35,38,0
1808,50322,jxVbF1puB335S13Sh1SeiyqryzWrY9TH,SpATywNh6bZuzm8s1ceuBUnMUAeoAHHw,8,9,2,0,3,0,8,0,22,3.142857142857143,2,0.0,0,2,0,3,9,0,0,8,0,5,17,1
1809,50352,BS7u1moD4G6tIsp3i8TsGiKk2duVqSQ0,G8EPVSXsOYB5YQWZGiz1aVq5Pgr2GrQu,6,5,3,0,2,0,3,0,13,1.8571428571428572,1,0.0,0,3,0,2,5,0,0,3,0,5,8,1
1810,50361,Gur5FuhE9EyV9K1F0qLPk7AenhoY8PBS,SpATywNh6bZuzm8s1ceuBUnMUAeoAHHw,4,2,0,0,0,0,3,0,5,0.7142857142857143,1,0.0,0,0,0,0,2,0,0,3,0,0,5,1
1811,50380,Xdag5jOmE7uWC3FmBvgPc5F7lO3QNcPW,bWdj2GDclj5ofokWjzoa5jAwMkxCykd6,27,44,20,117,7,18,13,0,219,31.285714285714285,4,0.0,6,20,107,7,38,18,10,13,0,140,79,0
1812,50383,wcXKTRp3782w7z3pcKy7I4KlcLaVU81W,SpATywNh6bZuzm8s1ceuBUnMUAeoAHHw,3,2,0,0,0,0,1,0,3,0.42857142857142855,1,0.0,0,0,0,0,2,0,0,1,0,0,3,0
1813,50401,dk07gP54X69nuCMty25BNGOYSGmkxtJW,SpATywNh6bZuzm8s1ceuBUnMUAeoAHHw,25,38,1,23,0,4,22,2,90,12.857142857142858,3,0.0,16,1,21,0,22,4,2,22,2,38,52,0
1814,50417,zYT144o5gG83ITHydzc0I4BahBKUTuVY,A3fsA9Zfv1X2fVEQhTw51lKENdNrEqT3,6,6,0,0,0,0,5,0,11,1.5714285714285714,2,0.0,0,0,0,0,6,0,0,5,0,0,11,1
1815,50422,SnivjdMp3HL6G23yPscSnzZlAD2Rbyt6,bWdj2GDclj5ofokWjzoa5jAwMkxCykd6,40,52,24,86,18,9,4,0,193,27.571428571428573,3,0.0,19,24,74,18,33,9,12,4,0,135,58,1
1816,50455,9jNN69RJsAFkkuYDPHWQVpfsVwA6mFxd,SpATywNh6bZuzm8s1ceuBUnMUAeoAHHw,9,13,9,0,0,0,6,0,28,4.0,3,0.0,0,9,0,0,13,0,0,6,0,9,19,0
1817,50460,DRhlp1eJHQqsxjCL0bRD6kkHN20HbJ4w,RXDvfPUBYFlVdlueBFbLW0mhhAyGEqpt,6,6,4,0,1,3,1,0,15,2.142857142857143,1,0.0,0,4,0,1,6,3,0,1,0,5,10,1
1818,50479,wfvJgFT5spPJFxchmb7eMbxy7ga4Z42J,A3fsA9Zfv1X2fVEQhTw51lKENdNrEqT3,31,30,1,80,0,18,27,3,159,22.714285714285715,3,0.0,2,1,66,0,28,18,14,27,3,69,90,0
1819,50485,bZVDIvmAMciYIQrrbhRx0jvH9Tiicfyn,SpATywNh6bZuzm8s1ceuBUnMUAeoAHHw,4,3,0,0,0,0,1,0,4,0.5714285714285714,1,0.0,0,0,0,0,3,0,0,1,0,0,4,0
1820,50495,3kOFsgHC3tWJNSzqIlZ1BKfxh1AIkRy9,SpATywNh6bZuzm8s1ceuBUnMUAeoAHHw,7,3,2,0,2,0,2,0,9,1.2857142857142858,1,0.0,0,2,0,2,3,0,0,2,0,4,5,0
1821,50498,Crsle3QdAPcjxEbhDM61m0114QeooRDa,A3fsA9Zfv1X2fVEQhTw51lKENdNrEqT3,2,0,0,0,0,0,2,0,2,0.2857142857142857,1,0.0,0,0,0,0,0,0,0,2,0,0,2,1
1822,50515,E7wBgQCkgD4tkfXLdP9URnDZqb2ubvF0,A3fsA9Zfv1X2fVEQhTw51lKENdNrEqT3,1,0,0,0,0,0,1,0,1,0.14285714285714285,1,0.0,0,0,0,0,0,0,0,1,0,0,1,0
1823,50568,Ikx8dqw7N29O68oP7rbQGE7AGY4iLNon,SpATywNh6bZuzm8s1ceuBUnMUAeoAHHw,5,6,2,0,2,0,2,0,12,1.7142857142857142,1,0.0,0,2,0,2,6,0,0,2,0,4,8,0
1824,50609,THlX4ibtjGYQg6ZUfc8ItvnKMtOly4Xi,SpATywNh6bZuzm8s1ceuBUnMUAeoAHHw,1,0,0,0,0,0,1,0,1,0.14285714285714285,1,0.0,0,0,0,0,0,0,0,1,0,0,1,0
1825,50619,U0ut2RIK4RMVOoanuVtPF17vT9gKZVmq,A3fsA9Zfv1X2fVEQhTw51lKENdNrEqT3,8,5,3,0,1,0,3,0,12,1.7142857142857142,1,0.0,0,3,0,1,5,0,0,3,0,4,8,1
1826,50670,IDqUeKOsakXfpJsNR0qoC3jJJuHYmkPd,SpATywNh6bZuzm8s1ceuBUnMUAeoAHHw,10,53,17,0,0,10,8,0,88,12.571428571428571,1,0.0,20,17,0,0,33,10,0,8,0,37,51,0
1827,50700,ZjAnj7LejyrDjdytaW8xiEftNjkACZgi,A3fsA9Zfv1X2fVEQhTw51lKENdNrEqT3,1,0,0,0,0,0,1,0,1,0.14285714285714285,1,0.0,0,0,0,0,0,0,0,1,0,0,1,1
1828,50736,6EsKULTJVMq3E9IpeZllE0vOQuFiZwCm,SpATywNh6bZuzm8s1ceuBUnMUAeoAHHw,16,19,5,28,3,11,6,2,74,10.571428571428571,1,0.0,13,5,24,3,6,11,4,6,2,45,29,1
1829,50761,EttKeSyg9r0EcjglXuiRsuMNde5ZPNQV,A3fsA9Zfv1X2fVEQhTw51lKENdNrEqT3,5,3,2,0,0,0,2,0,7,1.0,1,0.0,0,2,0,0,3,0,0,2,0,2,5,1
1830,50776,kQmP7eUv8W6zmkJRQJGIL9eNv0mJSlzv,SpATywNh6bZuzm8s1ceuBUnMUAeoAHHw,7,7,2,0,2,0,1,0,12,1.7142857142857142,1,0.0,0,2,0,2,7,0,0,1,0,4,8,1
1831,50792,oidXTGaCUuuF1QPNvhmiPoqhWsTY245r,bWdj2GDclj5ofokWjzoa5jAwMkxCykd6,6,4,3,0,3,0,2,0,12,1.7142857142857142,1,0.0,0,3,0,3,4,0,0,2,0,6,6,0
1832,50795,c0bjMduOwhlaRS3h8xRhAhid9jTsLzPD,A3fsA9Zfv1X2fVEQhTw51lKENdNrEqT3,13,15,7,0,5,0,4,0,31,4.428571428571429,2,0.0,0,7,0,5,15,0,0,4,0,12,19,1
1833,50797,BWuaSpfjjWoQ6suviyDvOJ1XUJLgJBtc,SpATywNh6bZuzm8s1ceuBUnMUAeoAHHw,3,0,0,0,0,9,2,0,11,1.5714285714285714,1,0.0,0,0,0,0,0,9,0,2,0,0,11,0
1834,50805,1HrXazG6mMhlQyrWzEYwtGHFWa0bXXko,SpATywNh6bZuzm8s1ceuBUnMUAeoAHHw,24,31,0,22,0,73,8,1,135,19.285714285714285,2,0.0,7,0,18,0,24,73,4,8,1,25,110,0
1835,50808,xm9wUIf1J8EjTNxXT4ffEWzhuySk21YK,RXDvfPUBYFlVdlueBFbLW0mhhAyGEqpt,3,2,1,0,0,0,1,0,4,0.5714285714285714,1,0.0,0,1,0,0,2,0,0,1,0,1,3,0
1836,50814,tOVeFZbpewRX07F0N4KV6g00WNGootzd,SpATywNh6bZuzm8s1ceuBUnMUAeoAHHw,2,0,0,0,0,0,2,0,2,0.2857142857142857,1,0.0,0,0,0,0,0,0,0,2,0,0,2,1
1837,50835,KH1qoBE3q99uPmQbxyBhuyXhrxNuFdJJ,A3fsA9Zfv1X2fVEQhTw51lKENdNrEqT3,1,0,0,0,0,0,1,0,1,0.14285714285714285,1,0.0,0,0,0,0,0,0,0,1,0,0,1,1
1838,50841,POGRFFRZzlPiBHiCHXnlCDCb459JTEzc,G8EPVSXsOYB5YQWZGiz1aVq5Pgr2GrQu,55,74,3,185,3,0,30,0,295,42.142857142857146,4,0.0,8,3,163,3,66,0,22,30,0,177,118,0
1839,52418,AWLXkSqW4e7SbhduVpZ7fOXghxuuP6q1,7GRhBDsirIGkRZBtSMEzNTyDr2JQm4xx,6,3,2,0,1,1,5,0,12,1.7142857142857142,1,0.0,0,2,0,1,3,1,0,5,0,3,9,1
1840,52648,PCT9UecTLFgHQMLESQLM3zo2VKyldhOq,7GRhBDsirIGkRZBtSMEzNTyDr2JQm4xx,7,6,1,2,1,0,1,0,11,1.5714285714285714,1,0.0,2,1,1,1,4,0,1,1,0,5,6,0
1841,52730,8XaoEwTyWeXdGPkk69feFC4MnARlyEPY,7GRhBDsirIGkRZBtSMEzNTyDr2JQm4xx,58,89,3,72,9,8,13,1,195,27.857142857142858,1,0.0,60,3,70,9,29,8,2,13,1,142,53,0
1842,53041,FW02PfU8vx3pzmS7oOXpJualmcvfngs4,SpATywNh6bZuzm8s1ceuBUnMUAeoAHHw,5,5,0,0,0,0,2,0,7,1.0,1,0.0,0,0,0,0,5,0,0,2,0,0,7,0
1843,53043,4LLdV2zTWS697dAsOgAPJZPFwfNnrjt6,SpATywNh6bZuzm8s1ceuBUnMUAeoAHHw,4,3,2,0,0,0,1,0,6,0.8571428571428571,1,0.0,0,2,0,0,3,0,0,1,0,2,4,0
1844,53074,vwFaMtviPYvvdeDxiexQOh059O9Yefj1,SpATywNh6bZuzm8s1ceuBUnMUAeoAHHw,6,6,1,0,1,0,1,0,9,1.2857142857142858,1,0.0,0,1,0,1,6,0,0,1,0,2,7,1
1845,53099,l5zm2dyq1Lp4ch4ILKl8mqNj892nMhsW,A3fsA9Zfv1X2fVEQhTw51lKENdNrEqT3,42,18,14,72,8,4,9,1,126,18.0,1,0.0,1,14,55,8,17,4,17,9,1,78,48,1
1846,53104,f3SUvLtMnVyEZPEDJVhRMSC5cEFasHSH,G8EPVSXsOYB5YQWZGiz1aVq5Pgr2GrQu,3,3,2,0,2,0,0,0,7,1.0,1,0.0,1,2,0,2,2,0,0,0,0,5,2,1
1847,53109,fFw6uRnMpWU4RqpwQO2WZ8GCAi6hyn9t,SpATywNh6bZuzm8s1ceuBUnMUAeoAHHw,1,0,0,0,0,0,1,0,1,0.14285714285714285,1,0.0,0,0,0,0,0,0,0,1,0,0,1,0
1848,53157,H8hoxOy1VDjrCqtl8Y1RjEzCSImzfPb1,SpATywNh6bZuzm8s1ceuBUnMUAeoAHHw,1,0,0,0,0,0,1,0,1,0.14285714285714285,1,0.0,0,0,0,0,0,0,0,1,0,0,1,1
1849,53162,4nHfdAZtp0niyFyrjm2L6LhTVPrJBlZM,A3fsA9Zfv1X2fVEQhTw51lKENdNrEqT3,38,23,12,60,5,0,14,1,115,16.428571428571427,3,0.0,4,12,55,5,19,0,5,14,1,76,39,1
1850,53190,cWykzNKAq5sFQBA059QN4Jx74YGPkfwB,SpATywNh6bZuzm8s1ceuBUnMUAeoAHHw,12,12,0,8,0,0,2,0,22,3.142857142857143,1,0.0,0,0,8,0,12,0,0,2,0,8,14,0
1851,53199,RfxrjGWEyzBCwnQEmvcmVh3DEMcbhg4m,bWdj2GDclj5ofokWjzoa5jAwMkxCykd6,7,4,4,0,4,0,0,0,12,1.7142857142857142,1,0.0,0,4,0,4,4,0,0,0,0,8,4,1
1852,53233,nOWqKetxGFQ9o73UNfcoh0XyCt3ITawR,SpATywNh6bZuzm8s1ceuBUnMUAeoAHHw,1,0,0,0,0,0,1,0,1,0.14285714285714285,1,0.0,0,0,0,0,0,0,0,1,0,0,1,0
1853,53245,2Bc3e8bWl6DTvfTPBZCyShFFG8OApkva,G8EPVSXsOYB5YQWZGiz1aVq5Pgr2GrQu,4,8,4,0,0,7,2,0,21,3.0,1,0.0,2,4,0,0,6,7,0,2,0,6,15,1
1854,53253,nsNOT1cU6IuLaV7JjnTNsqpFb1YDxqEb,SpATywNh6bZuzm8s1ceuBUnMUAeoAHHw,14,29,14,14,0,26,10,11,104,14.857142857142858,4,0.0,7,14,13,0,22,26,1,10,11,34,70,0
1855,53264,cWykzNKAq5sFQBA059QN4Jx74YGPkfwB,bWdj2GDclj5ofokWjzoa5jAwMkxCykd6,5,4,0,0,0,0,1,0,5,0.7142857142857143,1,0.0,0,0,0,0,4,0,0,1,0,0,5,0
1856,53297,wEZByhPumKHDR8Jv649KZn2fKnoB4Z7a,RXDvfPUBYFlVdlueBFbLW0mhhAyGEqpt,8,15,4,9,0,0,2,0,30,4.285714285714286,3,0.0,0,4,8,0,15,0,1,2,0,12,18,0
1857,53345,FtZzEliHSUjgpcn9CYNSke7IZriM02xT,SpATywNh6bZuzm8s1ceuBUnMUAeoAHHw,9,10,7,19,0,0,2,0,38,5.428571428571429,1,0.0,2,7,16,0,8,0,3,2,0,25,13,1
1858,53355,NiXPZUmEILmWUPwXexYxtHvaIL7QdjCQ,A3fsA9Zfv1X2fVEQhTw51lKENdNrEqT3,8,10,5,0,0,0,11,0,26,3.7142857142857144,1,0.0,1,5,0,0,9,0,0,11,0,6,20,1
1859,53367,qJEf5DGSDkSxZ1JIhipEbBFRbrhnAj1a,SpATywNh6bZuzm8s1ceuBUnMUAeoAHHw,7,7,5,0,2,0,3,0,17,2.4285714285714284,1,0.0,0,5,0,2,7,0,0,3,0,7,10,0
1860,53378,5IoXxgwnl1RIJLxkp1FnmYezwVSXlFjr,SpATywNh6bZuzm8s1ceuBUnMUAeoAHHw,21,22,14,6,6,3,10,1,62,8.857142857142858,3,0.0,0,14,5,6,22,3,1,10,1,25,37,0
1861,53488,OnFhgQq4yBEqO4X7tLyRDBVhde68jGdf,RXDvfPUBYFlVdlueBFbLW0mhhAyGEqpt,2,0,0,0,0,3,1,0,4,0.5714285714285714,1,0.0,0,0,0,0,0,3,0,1,0,0,4,0
1862,53502,MrmZgmDV3fLNPBur1xb2HpNXhTz9Exkt,SpATywNh6bZuzm8s1ceuBUnMUAeoAHHw,2,0,0,0,0,0,6,0,6,0.8571428571428571,3,0.0,0,0,0,0,0,0,0,6,0,0,6,0
1863,53520,MhrFHIexWYn2dilUXh03cpnfpoe9tMBe,SpATywNh6bZuzm8s1ceuBUnMUAeoAHHw,1,0,0,0,0,0,1,0,1,0.14285714285714285,1,0.0,0,0,0,0,0,0,0,1,0,0,1,1
1864,53562,KhZJrlhAYzlNSzHg9PDkxBUGTDjg8IXY,SpATywNh6bZuzm8s1ceuBUnMUAeoAHHw,6,3,1,0,1,0,2,0,7,1.0,1,0.0,0,1,0,1,3,0,0,2,0,2,5,1
1865,53678,uqIn0vdfJ1SDJCOeCVEAQPRFBBKQA2eB,bWdj2GDclj5ofokWjzoa5jAwMkxCykd6,14,12,5,12,3,0,1,0,33,4.714285714285714,1,0.0,2,5,12,3,10,0,0,1,0,22,11,1
1866,53714,Ar22lkOE5FvesxoMKtYhm8Cbv4MUQUYF,RXDvfPUBYFlVdlueBFbLW0mhhAyGEqpt,8,6,0,12,1,0,6,0,25,3.5714285714285716,1,0.0,3,0,9,1,3,0,3,6,0,13,12,1
1867,53720,eeYgUeHIQERDYwF1mxwVIZYsVaVSgwlV,A3fsA9Zfv1X2fVEQhTw51lKENdNrEqT3,3,2,1,0,0,0,1,0,4,0.5714285714285714,1,0.0,0,1,0,0,2,0,0,1,0,1,3,1
1868,53750,DHyGbluRYDb9YK4sD54nYIDtRwaCVU4f,SpATywNh6bZuzm8s1ceuBUnMUAeoAHHw,7,5,1,0,1,0,2,0,9,1.2857142857142858,2,0.0,0,1,0,1,5,0,0,2,0,2,7,1
1869,53758,Hu906OsUOpYkLeeay2GUzLMtBtAH0201,SpATywNh6bZuzm8s1ceuBUnMUAeoAHHw,4,6,2,0,0,0,6,0,14,2.0,3,0.0,0,2,0,0,6,0,0,6,0,2,12,1
1870,53800,j69quqIKpcCSzqXo9ZsaY7H1y4DglvlA,SpATywNh6bZuzm8s1ceuBUnMUAeoAHHw,7,4,3,0,2,0,1,0,10,1.4285714285714286,1,0.0,0,3,0,2,4,0,0,1,0,5,5,1
1871,53813,JfKuoH41ocsNDmphdAQOIFuKNZWqJJwf,SpATywNh6bZuzm8s1ceuBUnMUAeoAHHw,17,21,18,2,0,10,7,2,60,8.571428571428571,2,0.0,0,18,1,0,21,10,1,7,2,19,41,1
1872,53815,zSmc8rKmn3W7ClGZoLsZk5lSBVQHeitz,SpATywNh6bZuzm8s1ceuBUnMUAeoAHHw,2,0,0,0,0,0,6,0,6,0.8571428571428571,2,0.0,0,0,0,0,0,0,0,6,0,0,6,0
1873,53842,tN95ymRxU88OqvEeFVj1h9MemYWUdm2H,A3fsA9Zfv1X2fVEQhTw51lKENdNrEqT3,5,3,1,0,0,0,2,0,6,0.8571428571428571,1,0.0,0,1,0,0,3,0,0,2,0,1,5,1
1874,53858,6Upqh8KDtBiZuS1AWTucTCCkEJCPfX5m,SpATywNh6bZuzm8s1ceuBUnMUAeoAHHw,6,17,0,4,0,0,3,0,24,3.4285714285714284,3,0.0,7,0,2,0,10,0,2,3,0,9,15,0
1875,53861,Su9COtUoYOdyYjAUoqvAULKdQODTHr7E,bWdj2GDclj5ofokWjzoa5jAwMkxCykd6,29,45,9,107,2,0,12,0,175,25.0,6,0.0,7,9,98,2,38,0,9,12,0,116,59,0
1876,53875,wgifE6A0kxnDEjw7myKTY39TRuCgYxaB,bWdj2GDclj5ofokWjzoa5jAwMkxCykd6,6,3,1,0,1,0,3,0,8,1.1428571428571428,1,0.0,0,1,0,1,3,0,0,3,0,2,6,1
1877,53904,SjgqKMmF4tqpvhmgO66D1TdoOxgqcy2V,RXDvfPUBYFlVdlueBFbLW0mhhAyGEqpt,15,21,7,18,2,2,1,0,51,7.285714285714286,1,0.0,5,7,18,2,16,2,0,1,0,32,19,0
1878,53962,HH3HV5HDJ35z2ldQAEIDXBOSBTxLd6O9,bWdj2GDclj5ofokWjzoa5jAwMkxCykd6,17,15,7,118,6,0,3,0,149,21.285714285714285,2,0.0,7,7,113,6,8,0,5,3,0,133,16,1
1879,53980,f50myi7Wnjd1BWfZdyqaXMcdfMAdeGX9,G8EPVSXsOYB5YQWZGiz1aVq5Pgr2GrQu,37,27,0,84,0,0,10,0,121,17.285714285714285,5,0.0,5,0,78,0,22,0,6,10,0,83,38,0
1880,54001,Gglvz7f1jVuISouyvTJRaLDdezGOZ6EL,SpATywNh6bZuzm8s1ceuBUnMUAeoAHHw,1,0,0,0,0,0,1,0,1,0.14285714285714285,1,0.0,0,0,0,0,0,0,0,1,0,0,1,0
1881,54002,FHrj4N2SCEsxza13qmFjgJkCjs8BkrF3,bWdj2GDclj5ofokWjzoa5jAwMkxCykd6,12,14,8,28,3,5,5,0,63,9.0,2,0.0,2,8,24,3,12,5,4,5,0,37,26,1
1882,54009,U2oiAxypJX3TTENRYPio3LHOtQ2XmXGS,SpATywNh6bZuzm8s1ceuBUnMUAeoAHHw,3,2,1,0,0,0,1,0,4,0.5714285714285714,1,0.0,0,1,0,0,2,0,0,1,0,1,3,0
1883,54018,dyoINQ9hlelfXhGgA7SokU45MaV6r2b8,SpATywNh6bZuzm8s1ceuBUnMUAeoAHHw,7,5,4,0,1,0,1,0,11,1.5714285714285714,1,0.0,0,4,0,1,5,0,0,1,0,5,6,0
1884,54026,gw1ywpstRy3gY1kWojp1woauzVM2ZYVr,SpATywNh6bZuzm8s1ceuBUnMUAeoAHHw,5,4,2,0,1,0,1,0,8,1.1428571428571428,1,0.0,0,2,0,1,4,0,0,1,0,3,5,0
1885,54029,So8gZ8cXseEZ7lXf4idNMqcN46bXtlIA,SpATywNh6bZuzm8s1ceuBUnMUAeoAHHw,11,14,9,0,7,0,5,0,35,5.0,3,0.0,0,9,0,7,14,0,0,5,0,16,19,0
1886,54071,vYeGcWGAJP4B8Lvbjdr2jkY9NnpHN8xb,SpATywNh6bZuzm8s1ceuBUnMUAeoAHHw,1,0,0,0,0,0,1,0,1,0.14285714285714285,1,0.0,0,0,0,0,0,0,0,1,0,0,1,1
1887,54094,Fdt86Xu5OLPdaOgl6M1XDpiJ3zar7SU6,SpATywNh6bZuzm8s1ceuBUnMUAeoAHHw,4,2,0,0,0,1,4,0,7,1.0,2,0.0,0,0,0,0,2,1,0,4,0,0,7,0
1888,54129,qKOvjGeHnXAGhScloNy1qhNnfc1xHZ3T,SpATywNh6bZuzm8s1ceuBUnMUAeoAHHw,5,10,2,0,2,0,3,0,17,2.4285714285714284,3,0.0,0,2,0,2,10,0,0,3,0,4,13,0
1889,54132,PfTpx7WgTJY6IpNokJ2POml34GMs7LTI,bWdj2GDclj5ofokWjzoa5jAwMkxCykd6,15,12,7,14,4,0,5,0,42,6.0,3,0.0,2,7,14,4,10,0,0,5,0,27,15,0
1890,54134,BtB75B9l8XyH0uPaKeOkkRrm2NqBrtQe,A3fsA9Zfv1X2fVEQhTw51lKENdNrEqT3,16,10,8,0,6,0,3,0,27,3.857142857142857,2,0.0,0,8,0,6,10,0,0,3,0,14,13,1
1891,54145,uL6960SAwN5kJgcsaw9m5ztApNeZFO95,A3fsA9Zfv1X2fVEQhTw51lKENdNrEqT3,4,3,1,0,0,0,1,0,5,0.7142857142857143,1,0.0,0,1,0,0,3,0,0,1,0,1,4,1
1892,54176,i2jPckJdA9hhx8KLohXM0CrojRerYpdv,SpATywNh6bZuzm8s1ceuBUnMUAeoAHHw,3,2,1,0,0,0,1,0,4,0.5714285714285714,1,0.0,0,1,0,0,2,0,0,1,0,1,3,0
1893,54185,0fPKzumQAfSwGfxF7d6bvXWcsMGpFXOP,SpATywNh6bZuzm8s1ceuBUnMUAeoAHHw,3,4,2,0,0,1,1,0,8,1.1428571428571428,1,0.0,0,2,0,0,4,1,0,1,0,2,6,0
1894,54287,kuiW3Le0WeMGiwxmKgXwp1GfHw3vKMeq,SpATywNh6bZuzm8s1ceuBUnMUAeoAHHw,1,0,0,0,0,0,1,0,1,0.14285714285714285,1,0.0,0,0,0,0,0,0,0,1,0,0,1,1
1895,54306,pQnR1td8vlxsKseVpfzZVvCBdR2iP4U6,A3fsA9Zfv1X2fVEQhTw51lKENdNrEqT3,14,13,5,0,4,0,4,0,26,3.7142857142857144,2,0.0,0,5,0,4,13,0,0,4,0,9,17,0
1896,54398,lg3JWapmXZgNYOt38qBO2QsZMUBFS5SJ,G8EPVSXsOYB5YQWZGiz1aVq5Pgr2GrQu,14,33,16,10,4,0,5,0,68,9.714285714285714,2,0.0,12,16,8,4,21,0,2,5,0,40,28,0
1897,54411,UZrNs5yPvW1ZVC8d6wdut2Js7XUvysRH,SpATywNh6bZuzm8s1ceuBUnMUAeoAHHw,5,3,2,0,1,0,1,0,7,1.0,1,0.0,0,2,0,1,3,0,0,1,0,3,4,1
1898,54467,Ha2E1KX6VBrxAJ0Y64ONsTCt1RbrAdiK,SpATywNh6bZuzm8s1ceuBUnMUAeoAHHw,4,2,1,0,0,0,3,0,6,0.8571428571428571,2,0.0,0,1,0,0,2,0,0,3,0,1,5,0
1899,54509,HPaDTzk2xymxbpoa0VdcxdHl3uFfOfZk,bWdj2GDclj5ofokWjzoa5jAwMkxCykd6,6,5,3,0,0,0,20,0,28,4.0,3,0.0,0,3,0,0,5,0,0,20,0,3,25,1
1900,54512,x6BtQH70uuLHaxqzHA21U9wmfT0SxzD9,SpATywNh6bZuzm8s1ceuBUnMUAeoAHHw,2,0,0,0,0,0,12,0,12,1.7142857142857142,4,0.0,0,0,0,0,0,0,0,12,0,0,12,0
1901,54524,CxUPOQRaQMGLmbOcfniIQOhh24PXLDR6,bWdj2GDclj5ofokWjzoa5jAwMkxCykd6,10,19,8,0,2,13,5,0,47,6.714285714285714,4,0.0,3,8,0,2,16,13,0,5,0,13,34,0
1902,54528,MXVve1Eg6sXSXHh1Skrb0tjPJ9Wtb0M7,SpATywNh6bZuzm8s1ceuBUnMUAeoAHHw,4,2,1,0,1,0,1,0,5,0.7142857142857143,1,0.0,0,1,0,1,2,0,0,1,0,2,3,1
1903,54568,fUMqQuy71n3a3vBlGt3GhPdNsIerKaNG,SpATywNh6bZuzm8s1ceuBUnMUAeoAHHw,5,5,3,0,1,0,1,0,10,1.4285714285714286,1,0.0,0,3,0,1,5,0,0,1,0,4,6,1
1904,54588,iL3U1k6BvBmHPE9rSR4M1VNouviCTM2t,fbPkOYLVPtPgIt0MxizjfFJov3JbHyAi,1,0,0,0,0,0,1,0,1,0.14285714285714285,1,0.0,0,0,0,0,0,0,0,1,0,0,1,1
1905,54593,S5r0CKOxIwwZ6o4r0E3DEfNq3HUydzP8,fbPkOYLVPtPgIt0MxizjfFJov3JbHyAi,5,2,1,0,1,0,2,0,6,0.8571428571428571,1,0.0,0,1,0,1,2,0,0,2,0,2,4,0
1906,54604,X3X3klM03RXeGUjty93sg2SlkZrg3xpQ,fbPkOYLVPtPgIt0MxizjfFJov3JbHyAi,7,6,3,0,1,0,1,0,11,1.5714285714285714,1,0.0,1,3,0,1,5,0,0,1,0,5,6,1
1907,54606,JKXm7kCLnrEkQn6smb2KejU80afBEA8I,fbPkOYLVPtPgIt0MxizjfFJov3JbHyAi,7,2,1,0,1,2,5,0,11,1.5714285714285714,1,0.0,0,1,0,1,2,2,0,5,0,2,9,1
1908,54616,cgTRAnMuMn887xEhHTcg5rpmYHHPoyIP,fbPkOYLVPtPgIt0MxizjfFJov3JbHyAi,20,29,16,14,5,4,3,0,71,10.142857142857142,2,0.0,10,16,12,5,19,4,2,3,0,43,28,0
1909,54621,NBbu054C30RuH0I4yDic7caWEQZO4bn5,fbPkOYLVPtPgIt0MxizjfFJov3JbHyAi,12,29,8,4,6,11,12,1,71,10.142857142857142,2,0.0,8,8,3,6,21,11,1,12,1,25,46,1
1910,54625,OJlmjkvuQW4IsXhvjyjAhhq68S3friGW,fbPkOYLVPtPgIt0MxizjfFJov3JbHyAi,20,33,10,12,13,1,8,1,78,11.142857142857142,2,0.0,20,10,10,13,13,1,2,8,1,53,25,1
1911,54629,AkvoyA0ovU8KwnK8lPG0oOHqQo6t4vfK,fbPkOYLVPtPgIt0MxizjfFJov3JbHyAi,24,28,21,0,14,6,17,2,88,12.571428571428571,2,0.0,3,21,0,14,25,6,0,17,2,38,50,1
1912,54646,gLf8tcvfqgbiET6dKZOWAuUewpIVftFZ,fbPkOYLVPtPgIt0MxizjfFJov3JbHyAi,9,14,6,4,4,0,2,0,30,4.285714285714286,1,0.0,6,6,4,4,8,0,0,2,0,20,10,0
1913,54668,KEpGXvdRkmZf3PNthZY5jtIyu6Bw3Rlp,SpATywNh6bZuzm8s1ceuBUnMUAeoAHHw,19,14,8,12,4,1,4,0,43,6.142857142857143,1,0.0,5,8,11,4,9,1,1,4,0,28,15,1
1914,54723,z5Ulo2w0cg5OjY2Cx9aYoywDQvm6hLIF,RXDvfPUBYFlVdlueBFbLW0mhhAyGEqpt,1,0,0,0,0,0,3,0,3,0.42857142857142855,1,0.0,0,0,0,0,0,0,0,3,0,0,3,0
1915,54724,XfiCSk5eLAbq9rzQtnLkX2OQTd6M8xFG,bWdj2GDclj5ofokWjzoa5jAwMkxCykd6,31,25,0,40,0,0,4,0,69,9.857142857142858,1,0.0,7,0,40,0,18,0,0,4,0,47,22,0
1916,54731,EBk8CcgfO89MwmYfmQzxphOJxpVE6Uvu,bWdj2GDclj5ofokWjzoa5jAwMkxCykd6,6,3,1,0,1,3,6,0,14,2.0,1,0.0,0,1,0,1,3,3,0,6,0,2,12,1
1917,54736,16QzaT3BGZQ3ycViO0KNFfkskSZdjqFw,SpATywNh6bZuzm8s1ceuBUnMUAeoAHHw,31,46,17,31,11,11,13,1,130,18.571428571428573,4,0.0,10,17,25,11,36,11,6,13,1,63,67,0
1918,54810,T6JGf7KDvuej9SKYUMtG3FHgkPZQV429,A3fsA9Zfv1X2fVEQhTw51lKENdNrEqT3,8,4,2,0,2,0,3,0,11,1.5714285714285714,1,0.0,0,2,0,2,4,0,0,3,0,4,7,0
1919,54823,NNTbkWufZqd6OEZ4OfeDtmQCNI4vEzJo,A3fsA9Zfv1X2fVEQhTw51lKENdNrEqT3,2,0,0,0,0,0,2,0,2,0.2857142857142857,1,0.0,0,0,0,0,0,0,0,2,0,0,2,1
1920,54871,H2pnCC5fUi5Ho09aPqAE97vnlsM8FGBU,bWdj2GDclj5ofokWjzoa5jAwMkxCykd6,5,3,2,6,0,0,2,0,13,1.8571428571428572,1,0.0,0,2,3,0,3,0,3,2,0,5,8,1
1921,54937,o076ufFxYjFcAtg8dPv0W5vwk5oKbSiz,SpATywNh6bZuzm8s1ceuBUnMUAeoAHHw,4,4,2,0,0,0,2,0,8,1.1428571428571428,1,0.0,0,2,0,0,4,0,0,2,0,2,6,1
1922,54942,ijpfz5cJPrusRBczJIwOiwlUzdR9aysy,SpATywNh6bZuzm8s1ceuBUnMUAeoAHHw,16,19,11,10,5,0,6,0,51,7.285714285714286,2,0.0,4,11,9,5,15,0,1,6,0,29,22,0
1923,55039,0Au7FrQGJI1dB5PAH0C5RtkL9GE7xsrQ,SpATywNh6bZuzm8s1ceuBUnMUAeoAHHw,12,23,9,0,5,1,6,0,44,6.285714285714286,4,0.0,1,9,0,5,22,1,0,6,0,15,29,1
1924,55082,UbxAJQUpM4nPUifCeu8NjmX0juFyLMFH,SpATywNh6bZuzm8s1ceuBUnMUAeoAHHw,5,5,1,0,1,0,2,0,9,1.2857142857142858,2,0.0,0,1,0,1,5,0,0,2,0,2,7,1
1925,55190,T71AtVPaJkGSIyo6SH0vxJiIfo9P5xoJ,bWdj2GDclj5ofokWjzoa5jAwMkxCykd6,1,0,0,0,0,0,2,0,2,0.2857142857142857,1,0.0,0,0,0,0,0,0,0,2,0,0,2,0
1926,55215,RHl3DsvAX7TisJ7qBptmgrrtDAQvH7mr,7GRhBDsirIGkRZBtSMEzNTyDr2JQm4xx,3,2,1,0,0,0,1,0,4,0.5714285714285714,1,0.0,0,1,0,0,2,0,0,1,0,1,3,1
1927,55252,SFUf9a1eQYyFSfDqOIKMZYV7yqLnThV1,SpATywNh6bZuzm8s1ceuBUnMUAeoAHHw,12,9,1,14,1,1,1,0,27,3.857142857142857,1,0.0,2,1,13,1,7,1,1,1,0,17,10,0
1928,55343,YPEupTuOqSGieSSneZcv3AcUcSBCtbGY,7GRhBDsirIGkRZBtSMEzNTyDr2JQm4xx,4,4,0,0,0,0,1,0,5,0.7142857142857143,1,0.0,0,0,0,0,4,0,0,1,0,0,5,1
1929,55346,7bnGjPq4sg9VhmEEoEqqXHNgeEpEuUDV,SpATywNh6bZuzm8s1ceuBUnMUAeoAHHw,11,9,4,8,2,0,2,0,25,3.5714285714285716,2,0.0,2,4,8,2,7,0,0,2,0,16,9,0
1930,55358,eeotL07J3Y8VeL6DbnIqkm9FhuiNkg7O,SpATywNh6bZuzm8s1ceuBUnMUAeoAHHw,1,0,0,0,0,0,1,0,1,0.14285714285714285,1,0.0,0,0,0,0,0,0,0,1,0,0,1,0
1931,55376,avsFLymnsxrXULvKpllQNNUZoqF0bJ35,SpATywNh6bZuzm8s1ceuBUnMUAeoAHHw,23,26,9,19,5,0,5,1,65,9.285714285714286,3,0.0,4,9,19,5,22,0,0,5,1,37,28,0
1932,55425,iDV5to1cYevkdTWvpbQHbqC1rLSJxp3m,SpATywNh6bZuzm8s1ceuBUnMUAeoAHHw,29,44,15,28,10,11,5,0,113,16.142857142857142,1,0.0,22,15,26,10,22,11,2,5,0,73,40,0
1933,55468,kYJNxYDAilMvu34mGr6cbIsnQA0irwNN,bWdj2GDclj5ofokWjzoa5jAwMkxCykd6,7,5,2,0,2,0,2,0,11,1.5714285714285714,1,0.0,0,2,0,2,5,0,0,2,0,4,7,0
1934,55483,C4q4gNQYEpjKh7pq1qjN8i3L7uSpUX9d,A3fsA9Zfv1X2fVEQhTw51lKENdNrEqT3,94,69,54,274,39,1,17,2,456,65.14285714285714,5,0.0,2,54,233,39,67,1,41,17,2,328,128,0
1935,55489,vCm3LfZ9M6wOLWnqELTZFsk5hnCTaEbi,SpATywNh6bZuzm8s1ceuBUnMUAeoAHHw,22,28,2,24,1,11,9,2,77,11.0,2,0.0,11,2,20,1,17,11,4,9,2,34,43,0
1936,55505,3DMtg3Ou9e33dDThiO2ndZwS8d6akzB7,RXDvfPUBYFlVdlueBFbLW0mhhAyGEqpt,18,15,1,0,2,2,6,0,26,3.7142857142857144,2,0.0,0,1,0,2,15,2,0,6,0,3,23,0
1937,55524,Sle0t5zy0VbRjUdpojBY9wV6zuG12LCM,A3fsA9Zfv1X2fVEQhTw51lKENdNrEqT3,34,10,7,48,5,3,3,0,76,10.857142857142858,2,0.0,1,7,45,5,9,3,3,3,0,58,18,1
1938,55537,QN2mu01aS3iQpw1z3TFQyQa0hQWsCjGH,SpATywNh6bZuzm8s1ceuBUnMUAeoAHHw,24,53,32,20,0,6,26,4,141,20.142857142857142,3,0.0,10,32,19,0,43,6,1,26,4,61,80,0
1939,55573,9MJtonlQxxOCrYvWkEprq1yVcFsrnJFZ,SpATywNh6bZuzm8s1ceuBUnMUAeoAHHw,19,27,13,0,9,0,5,0,54,7.714285714285714,3,0.0,0,13,0,9,27,0,0,5,0,22,32,1
1940,55591,9t2KBUQ5GiAw5lDqGOd0BuKNW0LVvTVG,A3fsA9Zfv1X2fVEQhTw51lKENdNrEqT3,39,43,21,94,6,0,7,0,171,24.428571428571427,2,0.0,13,21,80,6,30,0,14,7,0,120,51,0
1941,55593,9t2KBUQ5GiAw5lDqGOd0BuKNW0LVvTVG,bWdj2GDclj5ofokWjzoa5jAwMkxCykd6,17,16,11,26,1,3,7,0,64,9.142857142857142,2,0.0,0,11,24,1,16,3,2,7,0,36,28,0
1942,55696,jaCcwHYnVHfV5mSQjy3wPbHHjpbiHJ5a,SpATywNh6bZuzm8s1ceuBUnMUAeoAHHw,19,37,12,13,7,0,13,0,82,11.714285714285714,4,0.0,4,12,12,7,33,0,1,13,0,35,47,0
1943,55738,rCrf0hc0QRrKoK9w9R5Z8IvJlhGyjTyy,bWdj2GDclj5ofokWjzoa5jAwMkxCykd6,6,7,3,0,1,1,2,0,14,2.0,2,0.0,0,3,0,1,7,1,0,2,0,4,10,1
1944,55775,ZvdQafaVNGdhweIxI9FbVGKoGVxZDXFe,7GRhBDsirIGkRZBtSMEzNTyDr2JQm4xx,1,0,0,0,0,0,1,0,1,0.14285714285714285,1,0.0,0,0,0,0,0,0,0,1,0,0,1,1
1945,55777,aQ6WrdDe9pTNwVW3vmaMOs1pxy5r3Dxa,bWdj2GDclj5ofokWjzoa5jAwMkxCykd6,22,31,17,28,6,0,7,0,89,12.714285714285714,4,0.0,5,17,24,6,26,0,4,7,0,52,37,0
1946,55843,S2i0VW7GN0ACeCnuAPN00XONM8w8kvsN,SpATywNh6bZuzm8s1ceuBUnMUAeoAHHw,9,14,5,17,0,0,1,0,37,5.285714285714286,1,0.0,6,5,14,0,8,0,3,1,0,25,12,0
1947,55846,q7ZtC6SevF8q9PKkXEaBMzUJ37xWhTDz,SpATywNh6bZuzm8s1ceuBUnMUAeoAHHw,4,7,2,0,0,0,0,0,9,1.2857142857142858,2,0.0,0,2,0,0,7,0,0,0,0,2,7,1
1948,55877,GPe5tDvCMFa0yvoGbU7FbSxYbtu5eayz,SpATywNh6bZuzm8s1ceuBUnMUAeoAHHw,12,15,7,12,3,0,2,0,39,5.571428571428571,2,0.0,4,7,10,3,11,0,2,2,0,24,15,0
1949,55936,Uh4whLcptRuZuhdtjFruuYJY4YmOeYlV,SpATywNh6bZuzm8s1ceuBUnMUAeoAHHw,16,24,0,18,0,0,2,0,44,6.285714285714286,1,0.0,8,0,16,0,16,0,2,2,0,24,20,0
1950,55948,fOZTYKShrDEPywLsvnOq8r6y0esJP04d,G8EPVSXsOYB5YQWZGiz1aVq5Pgr2GrQu,14,16,8,10,6,0,1,0,41,5.857142857142857,1,0.0,7,8,5,6,9,0,5,1,0,26,15,0
1951,56001,7EU7vMf2b4Xv6MdI3zbAqQNQTiRVSvYt,bWdj2GDclj5ofokWjzoa5jAwMkxCykd6,8,5,4,0,2,0,1,0,12,1.7142857142857142,1,0.0,0,4,0,2,5,0,0,1,0,6,6,0
1952,56010,hJo1MgKiPZFXuH2ko6hqPTd9dbjMQKDO,A3fsA9Zfv1X2fVEQhTw51lKENdNrEqT3,3,4,2,0,0,0,2,0,8,1.1428571428571428,2,0.0,0,2,0,0,4,0,0,2,0,2,6,0
1953,56040,420Gm2AWh0nImDTapBba1KojOp3noScY,SpATywNh6bZuzm8s1ceuBUnMUAeoAHHw,3,2,0,0,0,0,1,0,3,0.42857142857142855,1,0.0,0,0,0,0,2,0,0,1,0,0,3,0
1954,56103,h7RW3AuXPtbIdr6MfEtTA3AoeBZHMuDe,SpATywNh6bZuzm8s1ceuBUnMUAeoAHHw,3,2,1,0,0,0,1,0,4,0.5714285714285714,1,0.0,0,1,0,0,2,0,0,1,0,1,3,1
1955,56136,Ooe9SpvA9vL8fZI7YLdrPaZtM6Unwf0C,SpATywNh6bZuzm8s1ceuBUnMUAeoAHHw,22,30,1,20,1,1,3,0,56,8.0,2,0.0,6,1,18,1,24,1,2,3,0,26,30,1
1956,56202,xbYSqp0T7Uu69VoCNyfTCvQcS3HV3UeU,SpATywNh6bZuzm8s1ceuBUnMUAeoAHHw,5,2,1,0,0,2,4,1,10,1.4285714285714286,1,0.0,0,1,0,0,2,2,0,4,1,1,9,1
1957,56223,7qDBI7pI0SQ1bfBBjf175GzJeqNA6CgO,7GRhBDsirIGkRZBtSMEzNTyDr2JQm4xx,3,2,1,0,0,0,1,0,4,0.5714285714285714,1,0.0,0,1,0,0,2,0,0,1,0,1,3,1
1958,56311,O0ctfeDXN3RQlb9YZzp4oH5DaLYaRlEd,A3fsA9Zfv1X2fVEQhTw51lKENdNrEqT3,29,21,17,65,13,0,6,0,122,17.428571428571427,3,0.0,0,17,61,13,21,0,4,6,0,91,31,1
1959,56321,YQloiHp4EDEAnQ7UnBm1Re3dyFVVFj8Z,SpATywNh6bZuzm8s1ceuBUnMUAeoAHHw,10,11,0,20,0,0,6,0,37,5.285714285714286,2,0.0,5,0,18,0,6,0,2,6,0,23,14,0
1960,56333,CwAitLaYuWheNSIoTgEZfJ56lAJf0HG8,7GRhBDsirIGkRZBtSMEzNTyDr2JQm4xx,16,14,5,12,8,0,10,0,49,7.0,1,0.0,8,5,11,8,6,0,1,10,0,32,17,1
1961,56398,aGbKep26uuguTzwAUYDcwjqS1RQNroF5,SpATywNh6bZuzm8s1ceuBUnMUAeoAHHw,2,0,0,0,0,0,3,0,3,0.42857142857142855,2,0.0,0,0,0,0,0,0,0,3,0,0,3,1
1962,56418,1yk3ITtkCTeBgpvC46EyEEfYcyKWD7Qc,SpATywNh6bZuzm8s1ceuBUnMUAeoAHHw,1,0,0,0,0,0,1,0,1,0.14285714285714285,1,0.0,0,0,0,0,0,0,0,1,0,0,1,0
1963,56423,ouOARkjMonPxhUKVUmTMgEZ4vGcTZcAk,7GRhBDsirIGkRZBtSMEzNTyDr2JQm4xx,24,25,0,96,2,0,1,0,124,17.714285714285715,1,0.0,14,0,94,2,11,0,2,1,0,110,14,1
1964,56444,bUYPIrKUhpdtG1KH0Y9GXp4xZk1AgdLJ,SpATywNh6bZuzm8s1ceuBUnMUAeoAHHw,1,0,0,0,0,0,1,0,1,0.14285714285714285,1,0.0,0,0,0,0,0,0,0,1,0,0,1,0
1965,56445,UalIk08w9p6VGqWfZ6drUaQL5GhjEzcw,SpATywNh6bZuzm8s1ceuBUnMUAeoAHHw,18,19,11,15,5,6,3,0,59,8.428571428571429,1,0.0,3,11,13,5,16,6,2,3,0,32,27,1
1966,56477,g5ozjvUCdaFJGkcIZvHKw5OmNcDvdyli,G8EPVSXsOYB5YQWZGiz1aVq5Pgr2GrQu,7,8,4,0,1,0,1,0,14,2.0,1,0.0,0,4,0,1,8,0,0,1,0,5,9,1
1967,56490,kqS8BwWN9R1093oeblGkvtCsQJ68Gh0G,SpATywNh6bZuzm8s1ceuBUnMUAeoAHHw,4,3,2,0,0,0,1,0,6,0.8571428571428571,1,0.0,0,2,0,0,3,0,0,1,0,2,4,0
1968,56514,57DmCkxeT4CodU6tDrBCDXqGpXQ0D1sF,A3fsA9Zfv1X2fVEQhTw51lKENdNrEqT3,8,8,4,22,0,0,2,0,36,5.142857142857143,2,0.0,2,4,17,0,6,0,5,2,0,23,13,0
1969,56520,Q0J8U0u6fxm0Djpm7255SwygxGBxa60v,A3fsA9Zfv1X2fVEQhTw51lKENdNrEqT3,7,4,2,0,1,1,4,0,12,1.7142857142857142,1,0.0,0,2,0,1,4,1,0,4,0,3,9,0
1970,56527,3t7GtELm6lLnb8FYC1DTga6GS5ymEox1,bWdj2GDclj5ofokWjzoa5jAwMkxCykd6,9,7,0,0,0,1,8,1,17,2.4285714285714284,1,0.0,1,0,0,0,6,1,0,8,1,1,16,1
1971,56559,Mr892OMsEEXQ3UZ94sswWXvqkTfFWjMB,SpATywNh6bZuzm8s1ceuBUnMUAeoAHHw,7,6,3,0,1,0,5,0,15,2.142857142857143,1,0.0,0,3,0,1,6,0,0,5,0,4,11,0
1972,56576,zlC9nEdRrqLSPX386Mctiz9fIdlU29GI,A3fsA9Zfv1X2fVEQhTw51lKENdNrEqT3,24,17,16,0,15,0,2,0,50,7.142857142857143,1,0.0,0,16,0,15,17,0,0,2,0,31,19,0
1973,56615,ktKfaRtFOnFJdZMcfSCqSP14OG6TxlMY,SpATywNh6bZuzm8s1ceuBUnMUAeoAHHw,5,2,0,0,0,0,4,0,6,0.8571428571428571,1,0.0,0,0,0,0,2,0,0,4,0,0,6,0
1974,56621,ma8nscMCD0ftKjbxujos5nzHFFtaZMo4,A3fsA9Zfv1X2fVEQhTw51lKENdNrEqT3,6,3,1,0,0,0,5,0,9,1.2857142857142858,1,0.0,1,1,0,0,2,0,0,5,0,2,7,0
1975,56683,MbewcgzgToNhp9B6eaNSolme5R0M2nkY,A3fsA9Zfv1X2fVEQhTw51lKENdNrEqT3,26,24,3,52,1,0,3,0,83,11.857142857142858,3,0.0,0,3,42,1,24,0,10,3,0,46,37,1
1976,56695,zEnfy6jGZRz4vOOACnUS9WJEmxBWMfYK,SpATywNh6bZuzm8s1ceuBUnMUAeoAHHw,20,38,0,32,0,7,21,6,104,14.857142857142858,3,0.0,17,0,29,0,21,7,3,21,6,46,58,0
1977,56696,ReIy3etnMmZBVQ3CosU4FbzEF29F9nHU,SpATywNh6bZuzm8s1ceuBUnMUAeoAHHw,10,10,0,10,0,0,0,0,20,2.857142857142857,1,0.0,3,0,9,0,7,0,1,0,0,12,8,0
1978,56701,6JgXcKWsc0MTV1avPvLw4YopCc17Rmgt,A3fsA9Zfv1X2fVEQhTw51lKENdNrEqT3,1,0,0,0,0,0,1,0,1,0.14285714285714285,1,0.0,0,0,0,0,0,0,0,1,0,0,1,1
1979,56707,bFvRESu40USsImLcj4Wu3bOXKdpnzC9Q,SpATywNh6bZuzm8s1ceuBUnMUAeoAHHw,3,2,0,0,0,0,2,0,4,0.5714285714285714,1,0.0,0,0,0,0,2,0,0,2,0,0,4,0
1980,56715,6iyCCTAEdDUFtgP0yXcCVROgqrKuAsJY,SpATywNh6bZuzm8s1ceuBUnMUAeoAHHw,18,17,11,22,5,0,2,0,57,8.142857142857142,2,0.0,4,11,19,5,13,0,3,2,0,39,18,0
1981,56718,TqNtDLLO1ShCV3mG6MbvpUVS2QVfiYPr,SpATywNh6bZuzm8s1ceuBUnMUAeoAHHw,1,0,0,0,0,0,1,0,1,0.14285714285714285,1,0.0,0,0,0,0,0,0,0,1,0,0,1,1
1982,56722,xYLJB56SVkFUOdT5vN3Qq6OYNlnP0Fjc,A3fsA9Zfv1X2fVEQhTw51lKENdNrEqT3,11,7,3,0,3,1,4,0,18,2.5714285714285716,2,0.0,0,3,0,3,7,1,0,4,0,6,12,1
1983,56725,Bxz1zTHFCCx9o1kJA9B0Pzm3PnmqKxr5,SpATywNh6bZuzm8s1ceuBUnMUAeoAHHw,12,17,16,0,9,0,0,0,42,6.0,3,0.0,1,16,0,9,16,0,0,0,0,26,16,1
1984,56736,csg0yBjjrshmLGGyq6UVgiiqMZP9T0vI,A3fsA9Zfv1X2fVEQhTw51lKENdNrEqT3,10,8,5,0,3,0,7,0,23,3.2857142857142856,2,0.0,0,5,0,3,8,0,0,7,0,8,15,1
1985,56763,bZSiNUbAIuydDBd77IMAJ15Hy6k2A1kT,SpATywNh6bZuzm8s1ceuBUnMUAeoAHHw,10,6,5,0,4,0,2,0,17,2.4285714285714284,1,0.0,0,5,0,4,6,0,0,2,0,9,8,0
1986,56771,I8C35PB4HAz5bxjARemPN0YBdl9xTOvv,SpATywNh6bZuzm8s1ceuBUnMUAeoAHHw,24,48,1,33,1,0,5,0,88,12.571428571428571,2,0.0,12,1,29,1,36,0,4,5,0,43,45,1
1987,56785,70BrIR23BcsI705EZj4LSyr7fHWI0Xjf,SpATywNh6bZuzm8s1ceuBUnMUAeoAHHw,5,2,1,0,1,0,2,0,6,0.8571428571428571,1,0.0,0,1,0,1,2,0,0,2,0,2,4,1
1988,56791,1G2HPMj7bCJEDZxxbF8ae2kPQCHvH8vB,bWdj2GDclj5ofokWjzoa5jAwMkxCykd6,1,0,0,0,0,0,1,0,1,0.14285714285714285,1,0.0,0,0,0,0,0,0,0,1,0,0,1,1
1989,56806,1ZeLZDjvvDkWWsoonk2q4KdJg9fzmSLS,SpATywNh6bZuzm8s1ceuBUnMUAeoAHHw,6,3,1,0,1,0,2,0,7,1.0,1,0.0,0,1,0,1,3,0,0,2,0,2,5,1
1990,56817,qzripbhm6sAPdZP3rld8n0avyAjcFNv4,G8EPVSXsOYB5YQWZGiz1aVq5Pgr2GrQu,7,7,2,0,2,0,2,0,13,1.8571428571428572,2,0.0,0,2,0,2,7,0,0,2,0,4,9,0
1991,56834,i86rWeuy3cBtKeVeDiyieBp3ovKTOVnd,SpATywNh6bZuzm8s1ceuBUnMUAeoAHHw,12,22,10,1,3,1,2,0,39,5.571428571428571,1,0.0,5,10,1,3,17,1,0,2,0,19,20,1
1992,56836,PihBsIILx8UWSnCui7TqzlKGzY1fk9nJ,SpATywNh6bZuzm8s1ceuBUnMUAeoAHHw,1,0,0,0,0,0,1,0,1,0.14285714285714285,1,0.0,0,0,0,0,0,0,0,1,0,0,1,1
1993,56846,JQHOsaQcbZuyd8KUhRwPnej9sALKGQEC,SpATywNh6bZuzm8s1ceuBUnMUAeoAHHw,15,25,3,30,0,10,7,3,78,11.142857142857142,3,0.0,7,3,23,0,18,10,7,7,3,33,45,0
1994,56864,y64BqR5f4fJBfwxF4aLt14ViHkvnjGLs,A3fsA9Zfv1X2fVEQhTw51lKENdNrEqT3,4,3,2,0,0,0,2,0,7,1.0,2,0.0,0,2,0,0,3,0,0,2,0,2,5,1
1995,56875,T8TKNQciNYxyZa02JNR1WAwQ2Y5qXjum,G8EPVSXsOYB5YQWZGiz1aVq5Pgr2GrQu,22,14,9,42,0,10,10,0,85,12.142857142857142,2,0.0,0,9,41,0,14,10,1,10,0,50,35,0
1996,56922,O1q1xXNHTWodSWO9JfUWT4rggWDNTlDY,SpATywNh6bZuzm8s1ceuBUnMUAeoAHHw,7,8,4,0,0,0,2,0,14,2.0,1,0.0,3,4,0,0,5,0,0,2,0,7,7,0
1997,56928,GXmApUIE1IechykqO3xyhcbVn1kfVOsr,A3fsA9Zfv1X2fVEQhTw51lKENdNrEqT3,1,0,0,0,0,0,1,0,1,0.14285714285714285,1,0.0,0,0,0,0,0,0,0,1,0,0,1,1
1998,56931,T6EWQ7jVP89JlHzj41KN1gEtGYevpSQM,bWdj2GDclj5ofokWjzoa5jAwMkxCykd6,12,12,9,0,4,0,2,0,27,3.857142857142857,2,0.0,1,9,0,4,11,0,0,2,0,14,13,1
1999,56934,8rmN9H3w27FWPHiV35iZMwZvoCzyP6Mm,RXDvfPUBYFlVdlueBFbLW0mhhAyGEqpt,9,10,7,0,5,0,4,0,26,3.7142857142857144,1,0.0,0,7,0,5,10,0,0,4,0,12,14,1
2000,56936,6YrlVe0EsBFAYrnxnMsqTpBboV8J5mFJ,SpATywNh6bZuzm8s1ceuBUnMUAeoAHHw,5,3,2,0,0,0,2,0,7,1.0,1,0.0,0,2,0,0,3,0,0,2,0,2,5,1
2001,56950,kSTVldlILQTC4uvQjFTvUZT6Q6PR2etw,SpATywNh6bZuzm8s1ceuBUnMUAeoAHHw,11,17,2,26,0,3,5,0,53,7.571428571428571,2,0.0,5,2,21,0,12,3,5,5,0,28,25,0
2002,56956,6iOLSqRTRABETCaDgzA6NufDV3dLbSSl,bWdj2GDclj5ofokWjzoa5jAwMkxCykd6,18,17,13,20,9,0,11,0,70,10.0,3,0.0,4,13,16,9,13,0,4,11,0,42,28,1
2003,56962,0XE1X3Ctb7lK10K23BNZFxwGgwh0UjZf,SpATywNh6bZuzm8s1ceuBUnMUAeoAHHw,9,14,9,0,0,0,4,0,27,3.857142857142857,1,0.0,2,9,0,0,12,0,0,4,0,11,16,1
2004,56963,GKzw24uGItaRbrNpOwWtTqnRbaZohHHZ,SpATywNh6bZuzm8s1ceuBUnMUAeoAHHw,19,25,13,22,7,5,5,0,77,11.0,2,0.0,8,13,19,7,17,5,3,5,0,47,30,0
2005,56973,yeTZ5KMDDEc73UUfQpRLrz0nY0YDQXhl,SpATywNh6bZuzm8s1ceuBUnMUAeoAHHw,28,56,21,25,9,3,6,0,120,17.142857142857142,2,0.0,5,21,25,9,51,3,0,6,0,60,60,1
2006,56974,ca0FiReQbSJ11H1fqXLWoWnOvLbBbR3V,SpATywNh6bZuzm8s1ceuBUnMUAeoAHHw,13,34,11,23,2,0,5,0,75,10.714285714285714,4,0.0,11,11,16,2,23,0,7,5,0,40,35,0
2007,57000,iCeqWib80JT1adwU3NbFJnaBIJ2wIhjE,RXDvfPUBYFlVdlueBFbLW0mhhAyGEqpt,10,8,1,0,1,0,4,0,14,2.0,2,0.0,1,1,0,1,7,0,0,4,0,3,11,1
2008,57017,RVthfCRYYRCiFRx3Qkq6vL0caXa3Y6XL,SpATywNh6bZuzm8s1ceuBUnMUAeoAHHw,5,7,1,2,0,0,6,0,16,2.2857142857142856,1,0.0,6,1,1,0,1,0,1,6,0,8,8,0
2009,57039,pJVtkRFEs9CaJKE9rNOcmTvOB8uBPejR,A3fsA9Zfv1X2fVEQhTw51lKENdNrEqT3,7,5,2,0,1,0,3,0,11,1.5714285714285714,2,0.0,0,2,0,1,5,0,0,3,0,3,8,0
2010,57041,LiEq7cB8PYL97VcZAVnxJwY7r8Xsvmdl,SpATywNh6bZuzm8s1ceuBUnMUAeoAHHw,4,2,0,0,0,0,3,0,5,0.7142857142857143,1,0.0,0,0,0,0,2,0,0,3,0,0,5,1
2011,57042,7QBdZ8YakikUsDbHJXtRSZV9tfWCg7qW,SpATywNh6bZuzm8s1ceuBUnMUAeoAHHw,20,25,10,33,3,0,4,0,75,10.714285714285714,2,0.0,10,10,29,3,15,0,4,4,0,52,23,0
2012,57048,I7IIrHAh1LzzCf8lcvI92o8deFulzAh8,G8EPVSXsOYB5YQWZGiz1aVq5Pgr2GrQu,1,0,0,0,0,0,2,0,2,0.2857142857142857,2,0.0,0,0,0,0,0,0,0,2,0,0,2,1
2013,57049,I7IIrHAh1LzzCf8lcvI92o8deFulzAh8,RXDvfPUBYFlVdlueBFbLW0mhhAyGEqpt,1,0,0,0,0,0,4,0,4,0.5714285714285714,2,0.0,0,0,0,0,0,0,0,4,0,0,4,1
2014,57051,I7IIrHAh1LzzCf8lcvI92o8deFulzAh8,A3fsA9Zfv1X2fVEQhTw51lKENdNrEqT3,1,0,0,0,0,0,1,0,1,0.14285714285714285,1,0.0,0,0,0,0,0,0,0,1,0,0,1,1
2015,57057,uMWcv4ZmW7X4PBv6egGkJZliUjuRluME,A3fsA9Zfv1X2fVEQhTw51lKENdNrEqT3,5,3,0,0,0,0,2,0,5,0.7142857142857143,1,0.0,0,0,0,0,3,0,0,2,0,0,5,1
2016,57071,ZAm3LJlcyCl8h6ue5pLqqLpG5qq07BLo,A3fsA9Zfv1X2fVEQhTw51lKENdNrEqT3,1,0,0,0,0,0,1,0,1,0.14285714285714285,1,0.0,0,0,0,0,0,0,0,1,0,0,1,0
2017,57088,Wwec43la23BkGWuxstkp5xbmi9HpOvs1,G8EPVSXsOYB5YQWZGiz1aVq5Pgr2GrQu,12,15,1,0,1,0,4,0,21,3.0,1,0.0,0,1,0,1,15,0,0,4,0,2,19,0
2018,57094,NY9lbGArbud0VjFCO45IgKzDykuc5Wkn,G8EPVSXsOYB5YQWZGiz1aVq5Pgr2GrQu,3,2,0,0,0,0,2,0,4,0.5714285714285714,1,0.0,0,0,0,0,2,0,0,2,0,0,4,1
2019,57105,91awV6zWN0QiCEvZkSCaXQj0382CBE5H,A3fsA9Zfv1X2fVEQhTw51lKENdNrEqT3,1,0,0,0,0,0,1,0,1,0.14285714285714285,1,0.0,0,0,0,0,0,0,0,1,0,0,1,1
2020,57116,FeZn6c6vb5R5SPZtACtqOXKJC1inbsZN,SpATywNh6bZuzm8s1ceuBUnMUAeoAHHw,16,22,1,18,1,4,2,0,48,6.857142857142857,2,0.0,5,1,15,1,17,4,3,2,0,22,26,0
2021,57131,3CLlQYPJzaDqTsMDCyIWfYEpsKmi9sXD,G8EPVSXsOYB5YQWZGiz1aVq5Pgr2GrQu,7,2,0,0,0,0,17,0,19,2.7142857142857144,2,0.0,0,0,0,0,2,0,0,17,0,0,19,0
2022,57162,aHtknnRqNt7Y7dvI5B5U8KGn3pFw6RdZ,G8EPVSXsOYB5YQWZGiz1aVq5Pgr2GrQu,23,30,22,0,0,7,7,1,67,9.571428571428571,1,0.0,6,22,0,0,24,7,0,7,1,28,39,1
2023,57182,n2sxBm1YdWdbqY5218d4GO8H7c30aZzU,SpATywNh6bZuzm8s1ceuBUnMUAeoAHHw,1,0,0,0,0,0,1,0,1,0.14285714285714285,1,0.0,0,0,0,0,0,0,0,1,0,0,1,1
2024,57183,5jlZO84otZB9xpGdUF5HgmcrtViZn9QR,SpATywNh6bZuzm8s1ceuBUnMUAeoAHHw,1,0,0,0,0,0,1,0,1,0.14285714285714285,1,0.0,0,0,0,0,0,0,0,1,0,0,1,1
2025,57190,ZzEeIm98vbP9lRunZYePLW46UyhiVxbR,A3fsA9Zfv1X2fVEQhTw51lKENdNrEqT3,8,9,2,0,1,0,4,1,17,2.4285714285714284,2,0.0,3,2,0,1,6,0,0,4,1,6,11,1
2026,57193,v6sJocXlJFeoDG1nXrmoTeUih19304GZ,SpATywNh6bZuzm8s1ceuBUnMUAeoAHHw,8,8,2,0,2,0,2,0,14,2.0,2,0.0,0,2,0,2,8,0,0,2,0,4,10,1
2027,57213,iSYj2oDe5RyCcvKGOIlJlpq8H0342az5,SpATywNh6bZuzm8s1ceuBUnMUAeoAHHw,4,1,1,0,0,0,2,0,4,0.5714285714285714,1,0.0,0,1,0,0,1,0,0,2,0,1,3,1
2028,57215,XP5riJnXYg5EQATrHDgwlSDdWk49ZnJK,SpATywNh6bZuzm8s1ceuBUnMUAeoAHHw,17,30,1,14,1,2,6,1,55,7.857142857142857,2,0.0,10,1,12,1,20,2,2,6,1,24,31,1
2029,57223,CYN3tl2d8PV3r7FRKTn3DmaQTLhkh777,A3fsA9Zfv1X2fVEQhTw51lKENdNrEqT3,19,21,0,0,0,4,15,1,41,5.857142857142857,2,0.0,0,0,0,0,21,4,0,15,1,0,41,1
2030,57225,Ct3eFzamQizfpV2I2rZSBKqavcN2kzGI,bWdj2GDclj5ofokWjzoa5jAwMkxCykd6,18,34,21,14,13,0,4,0,86,12.285714285714286,3,0.0,7,21,14,13,27,0,0,4,0,55,31,1
2031,57247,mAtPYhgVQEdXuexaQz1O6am3axcwvcQv,SpATywNh6bZuzm8s1ceuBUnMUAeoAHHw,8,6,1,0,1,1,4,0,13,1.8571428571428572,1,0.0,0,1,0,1,6,1,0,4,0,2,11,0
2032,57274,a91ewPLjlp1X8KqwrnZISs7xgERRXuh7,SpATywNh6bZuzm8s1ceuBUnMUAeoAHHw,10,21,6,6,0,0,5,0,38,5.428571428571429,2,0.0,0,6,5,0,21,0,1,5,0,11,27,0
2033,57275,2Al3Sg2oc4NVlws5jTNzQZvd3PHAcnAl,SpATywNh6bZuzm8s1ceuBUnMUAeoAHHw,11,10,5,0,4,0,1,0,20,2.857142857142857,1,0.0,0,5,0,4,10,0,0,1,0,9,11,1
2034,57289,JfftjOGdDbpgbrupi0Gwr899R0jzXikJ,SpATywNh6bZuzm8s1ceuBUnMUAeoAHHw,3,6,3,0,0,0,8,0,17,2.4285714285714284,5,0.0,0,3,0,0,6,0,0,8,0,3,14,0
2035,57303,CaX18aJHbUP3ScD0zmD3Y89LmBQVHmQw,SpATywNh6bZuzm8s1ceuBUnMUAeoAHHw,9,11,1,0,1,0,5,0,18,2.5714285714285716,1,0.0,0,1,0,1,11,0,0,5,0,2,16,1
2036,57310,amNosdi6Uiilljdy8esSBA3F29NKPLUW,A3fsA9Zfv1X2fVEQhTw51lKENdNrEqT3,8,4,3,0,0,1,6,0,14,2.0,2,0.0,0,3,0,0,4,1,0,6,0,3,11,1
2037,57326,v5WfKNQF0CY0mETK5LltBghiZQFigDWQ,A3fsA9Zfv1X2fVEQhTw51lKENdNrEqT3,5,0,0,0,0,0,8,0,8,1.1428571428571428,1,0.0,0,0,0,0,0,0,0,8,0,0,8,1
2038,57331,lG1rIQFzGK2zgeecJjKcKMBkKt4Dzz9j,RXDvfPUBYFlVdlueBFbLW0mhhAyGEqpt,7,3,2,0,2,0,2,0,9,1.2857142857142858,1,0.0,0,2,0,2,3,0,0,2,0,4,5,1
2039,57336,7FBwqoodmzhvrGGLuwBjRrxsykocUv8u,A3fsA9Zfv1X2fVEQhTw51lKENdNrEqT3,24,88,67,0,35,22,15,1,228,32.57142857142857,3,0.0,9,67,0,35,79,22,0,15,1,111,117,1
2040,57348,YPxQmDfYnmHgiT7CBa1xK3KUyMZAnQfd,SpATywNh6bZuzm8s1ceuBUnMUAeoAHHw,3,2,1,0,0,0,1,0,4,0.5714285714285714,1,0.0,0,1,0,0,2,0,0,1,0,1,3,1
2041,57351,m8heXBwBoAingce16ZKybSsmTBnHzE4y,SpATywNh6bZuzm8s1ceuBUnMUAeoAHHw,1,0,0,0,0,0,1,0,1,0.14285714285714285,1,0.0,0,0,0,0,0,0,0,1,0,0,1,1
2042,57356,3SNPt0tgFaFs22ZCc56rWyLmizBS9I72,RXDvfPUBYFlVdlueBFbLW0mhhAyGEqpt,1,0,0,0,0,0,1,0,1,0.14285714285714285,1,0.0,0,0,0,0,0,0,0,1,0,0,1,1
2043,57359,Arkq8NiPd69nYa08JuNw4PEusLHNf9hH,SpATywNh6bZuzm8s1ceuBUnMUAeoAHHw,4,6,1,0,0,0,2,0,9,1.2857142857142858,1,0.0,0,1,0,0,6,0,0,2,0,1,8,1
2044,57362,VrrBciftY2IctWxZzgYOD4l9QhmKgryv,SpATywNh6bZuzm8s1ceuBUnMUAeoAHHw,1,0,0,0,0,0,2,0,2,0.2857142857142857,2,0.0,0,0,0,0,0,0,0,2,0,0,2,0
2045,57385,XJf8gYhDJm1hrkVJvLQ4HKEnvPd3mIMq,SpATywNh6bZuzm8s1ceuBUnMUAeoAHHw,3,2,0,0,0,0,1,0,3,0.42857142857142855,1,0.0,0,0,0,0,2,0,0,1,0,0,3,0
2046,57396,YTd6RUCxKSrzEOkqGgY5uphLrJJcaHu6,RXDvfPUBYFlVdlueBFbLW0mhhAyGEqpt,1,0,0,0,0,0,1,0,1,0.14285714285714285,1,0.0,0,0,0,0,0,0,0,1,0,0,1,1
2047,57398,jHVltfBYXhDsXX9G7YWEMLSGV2wRodE1,SpATywNh6bZuzm8s1ceuBUnMUAeoAHHw,2,0,0,0,0,0,3,0,3,0.42857142857142855,1,0.0,0,0,0,0,0,0,0,3,0,0,3,1
2048,57414,sQhlNn7KiXOhhd3W8wdYsXetKwfQaOrI,SpATywNh6bZuzm8s1ceuBUnMUAeoAHHw,14,35,2,5,2,0,2,0,46,6.571428571428571,2,0.0,23,2,5,2,12,0,0,2,0,32,14,0
2049,57416,VrQWFYHS8Y40ZzXEJSIKFiNDL1oCM4M9,G8EPVSXsOYB5YQWZGiz1aVq5Pgr2GrQu,7,3,2,0,2,0,2,0,9,1.2857142857142858,1,0.0,0,2,0,2,3,0,0,2,0,4,5,1
2050,57421,xVSPiuldrfuaqB5x0wSqqh0RzPMsoNZK,SpATywNh6bZuzm8s1ceuBUnMUAeoAHHw,11,15,13,0,11,0,1,0,40,5.714285714285714,1,0.0,0,13,0,11,15,0,0,1,0,24,16,0
2051,57430,trbTOxlGHBKj11KndbOpMZg4seGBeXai,SpATywNh6bZuzm8s1ceuBUnMUAeoAHHw,1,0,0,0,0,0,1,0,1,0.14285714285714285,1,0.0,0,0,0,0,0,0,0,1,0,0,1,1
2052,57441,VR8oLKZP6LgyxXON0sRbhHMwM11kusu8,bWdj2GDclj5ofokWjzoa5jAwMkxCykd6,2,0,0,0,0,0,4,0,4,0.5714285714285714,1,0.0,0,0,0,0,0,0,0,4,0,0,4,1
2053,57444,VR8oLKZP6LgyxXON0sRbhHMwM11kusu8,A3fsA9Zfv1X2fVEQhTw51lKENdNrEqT3,1,0,0,0,0,0,1,0,1,0.14285714285714285,1,0.0,0,0,0,0,0,0,0,1,0,0,1,1
2054,57462,QLGFenndIPaX8I2vSI7keErJ6m5JCAL7,A3fsA9Zfv1X2fVEQhTw51lKENdNrEqT3,19,6,6,0,6,0,12,2,32,4.571428571428571,1,0.0,0,6,0,6,6,0,0,12,2,12,20,1
2055,57477,5OgjW4RBhSCbfYx5XYwPp5mVp3N7l8JT,SpATywNh6bZuzm8s1ceuBUnMUAeoAHHw,6,5,2,0,1,0,3,0,11,1.5714285714285714,2,0.0,0,2,0,1,5,0,0,3,0,3,8,1
2056,57497,h8ApK52PAIR0nuhXQv52hCsI8LxUHnXl,SpATywNh6bZuzm8s1ceuBUnMUAeoAHHw,6,5,1,0,0,0,1,0,7,1.0,1,0.0,0,1,0,0,5,0,0,1,0,1,6,1
2057,57510,CUu3LU8HdtJIouVTGHl3Ax78lqpPSeMD,A3fsA9Zfv1X2fVEQhTw51lKENdNrEqT3,12,12,7,0,3,0,4,0,26,3.7142857142857144,3,0.0,0,7,0,3,12,0,0,4,0,10,16,1
2058,57513,UzQguR9rIMiPdU8z0yQro6T1cVdElqDP,RXDvfPUBYFlVdlueBFbLW0mhhAyGEqpt,1,0,0,0,0,0,1,0,1,0.14285714285714285,1,0.0,0,0,0,0,0,0,0,1,0,0,1,1
2059,57540,q9BQrPVmTGVLXUZRKxvQUgkPlzz6bi8e,SpATywNh6bZuzm8s1ceuBUnMUAeoAHHw,1,0,0,0,0,0,1,0,1,0.14285714285714285,1,0.0,0,0,0,0,0,0,0,1,0,0,1,1
2060,57564,eAArxLyCThtu9N3Mv8rQculKbGSa66j9,bWdj2GDclj5ofokWjzoa5jAwMkxCykd6,1,0,0,0,0,0,1,0,1,0.14285714285714285,1,0.0,0,0,0,0,0,0,0,1,0,0,1,1
2061,57568,73lhhrOcE2srJj5BkIzSweWSnQRZBT2o,SpATywNh6bZuzm8s1ceuBUnMUAeoAHHw,13,27,18,14,0,0,5,0,64,9.142857142857142,5,0.0,2,18,12,0,25,0,2,5,0,32,32,1
2062,57575,2OPkOMgZitV39CjjFQfjbadYph2VzorR,SpATywNh6bZuzm8s1ceuBUnMUAeoAHHw,6,3,1,0,1,0,2,0,7,1.0,1,0.0,0,1,0,1,3,0,0,2,0,2,5,1
2063,57594,OOsRSTJd6U7cE43XHk99M9ofvrefufrh,A3fsA9Zfv1X2fVEQhTw51lKENdNrEqT3,18,18,9,0,7,0,3,0,37,5.285714285714286,2,0.0,0,9,0,7,18,0,0,3,0,16,21,0
2064,57617,NVzsLV2hJQHxCBnLyaDpT9HrhRSWUOfa,RXDvfPUBYFlVdlueBFbLW0mhhAyGEqpt,8,13,0,0,0,7,2,0,22,3.142857142857143,1,0.0,0,0,0,0,13,7,0,2,0,0,22,1
2065,57619,WN542VQFBPN1yXud5IZMh3hZ3MXP7IGT,SpATywNh6bZuzm8s1ceuBUnMUAeoAHHw,6,0,0,0,0,1,7,1,9,1.2857142857142858,1,0.0,0,0,0,0,0,1,0,7,1,0,9,1
2066,57636,D5gDQ8hFb4klemeBiodWmMPe9KIvqw9O,A3fsA9Zfv1X2fVEQhTw51lKENdNrEqT3,5,3,1,0,1,0,3,0,8,1.1428571428571428,3,0.0,0,1,0,1,3,0,0,3,0,2,6,1
2067,57647,4nbfL8rG09dpITd3UJqnI29RM9ZdkZtq,SpATywNh6bZuzm8s1ceuBUnMUAeoAHHw,2,0,0,0,0,0,2,0,2,0.2857142857142857,2,0.0,0,0,0,0,0,0,0,2,0,0,2,0
2068,57651,4nbfL8rG09dpITd3UJqnI29RM9ZdkZtq,RXDvfPUBYFlVdlueBFbLW0mhhAyGEqpt,1,0,0,0,0,0,1,0,1,0.14285714285714285,1,0.0,0,0,0,0,0,0,0,1,0,0,1,1
2069,57656,Y3ZpN8DOQK8YTfD0eUtklxiZfpWuBIeU,SpATywNh6bZuzm8s1ceuBUnMUAeoAHHw,15,18,12,13,8,2,3,0,56,8.0,2,0.0,2,12,13,8,16,2,0,3,0,35,21,0
2070,57658,gVmGREkYa5QlWPxC36Kl2VgCKKIwVXGZ,SpATywNh6bZuzm8s1ceuBUnMUAeoAHHw,1,0,0,0,0,0,1,0,1,0.14285714285714285,1,0.0,0,0,0,0,0,0,0,1,0,0,1,1
2071,57662,Py3KfqJj0ayFe0tkBJK6rKEFzXLKIBTS,RXDvfPUBYFlVdlueBFbLW0mhhAyGEqpt,18,19,1,0,1,0,1,0,22,3.142857142857143,1,0.0,1,1,0,1,18,0,0,1,0,3,19,0
2072,57663,bMJNLK5q5EUyioc5VWWKIebvvb4KHRiu,SpATywNh6bZuzm8s1ceuBUnMUAeoAHHw,14,20,2,18,1,0,8,1,50,7.142857142857143,2,0.0,10,2,15,1,10,0,3,8,1,28,22,1
2073,57671,j2LUphS0wjc6SNX1uC1d62i1omfcNa3o,SpATywNh6bZuzm8s1ceuBUnMUAeoAHHw,1,0,0,0,0,0,1,0,1,0.14285714285714285,1,0.0,0,0,0,0,0,0,0,1,0,0,1,1
2074,57674,o51Y4SLAGY9EUpnbYlzlny2aYMXKv66D,RXDvfPUBYFlVdlueBFbLW0mhhAyGEqpt,32,25,19,0,15,2,4,0,65,9.285714285714286,2,0.0,0,19,0,15,25,2,0,4,0,34,31,0
2075,57682,srWiqmJDli77OpcMHfZ4qTkRYOHonVJT,SpATywNh6bZuzm8s1ceuBUnMUAeoAHHw,18,18,0,10,0,1,8,0,37,5.285714285714286,3,0.0,0,0,10,0,18,1,0,8,0,10,27,0
2076,57711,cIl5ErCL6J4OGJVSovWEaY2KTpWCk21L,SpATywNh6bZuzm8s1ceuBUnMUAeoAHHw,20,19,7,38,2,16,7,2,91,13.0,1,0.0,11,7,33,2,8,16,5,7,2,53,38,1
2077,57712,p8eEbMqW5LefqN7qPq07exxdOPrIZY20,SpATywNh6bZuzm8s1ceuBUnMUAeoAHHw,11,28,11,0,7,1,12,2,61,8.714285714285714,4,0.0,1,11,0,7,27,1,0,12,2,19,42,1
2078,57719,3t9ZicXafEarB5kevklUjZj2RJMyb5VH,A3fsA9Zfv1X2fVEQhTw51lKENdNrEqT3,8,13,4,0,2,7,6,0,32,4.571428571428571,1,0.0,0,4,0,2,13,7,0,6,0,6,26,1
2079,57721,s61FWJSeWbhAUVg6RnrheusxdyXUW2UQ,bWdj2GDclj5ofokWjzoa5jAwMkxCykd6,1,0,0,0,0,0,1,0,1,0.14285714285714285,1,0.0,0,0,0,0,0,0,0,1,0,0,1,1
2080,57723,s61FWJSeWbhAUVg6RnrheusxdyXUW2UQ,A3fsA9Zfv1X2fVEQhTw51lKENdNrEqT3,1,0,0,0,0,0,1,0,1,0.14285714285714285,1,0.0,0,0,0,0,0,0,0,1,0,0,1,1
2081,57731,VfWuQS8OTjJmyvWxq07hV2rzKtyu1LCX,SpATywNh6bZuzm8s1ceuBUnMUAeoAHHw,4,4,3,0,0,0,2,0,9,1.2857142857142858,1,0.0,0,3,0,0,4,0,0,2,0,3,6,0
2082,57735,uhbUne0Zqx7l0LKNWrxxR44WistJmxKI,SpATywNh6bZuzm8s1ceuBUnMUAeoAHHw,23,44,5,32,3,0,9,0,93,13.285714285714286,4,0.0,8,5,29,3,36,0,3,9,0,45,48,1
2083,57739,6hTHLv2ACZhw5sTOpdEFsUQMXrnQn22A,RXDvfPUBYFlVdlueBFbLW0mhhAyGEqpt,3,2,1,0,0,0,2,0,5,0.7142857142857143,2,0.0,0,1,0,0,2,0,0,2,0,1,4,1
2084,57745,2cQ9kfcrQBQHmPAj78FQajELUCejB41f,bWdj2GDclj5ofokWjzoa5jAwMkxCykd6,6,2,1,0,1,0,3,0,7,1.0,1,0.0,0,1,0,1,2,0,0,3,0,2,5,1
2085,57750,c7B7iseemfO0QdFbtlw4FK4yHsx5NyMH,SpATywNh6bZuzm8s1ceuBUnMUAeoAHHw,11,6,4,6,3,0,2,0,21,3.0,1,0.0,1,4,5,3,5,0,1,2,0,13,8,1
2086,57770,TiyssQ1xBxRpSE8M84hoblpjLNawoMPM,A3fsA9Zfv1X2fVEQhTw51lKENdNrEqT3,1,0,0,0,0,0,3,0,3,0.42857142857142855,2,0.0,0,0,0,0,0,0,0,3,0,0,3,1
2087,57777,RDWXbk79jB26meX1BrQSCYz1EfxumOsd,bWdj2GDclj5ofokWjzoa5jAwMkxCykd6,1,0,0,0,0,0,1,0,1,0.14285714285714285,1,0.0,0,0,0,0,0,0,0,1,0,0,1,1
2088,57793,QiC1wt4ygzMS12Sok49ryeSwI2RAnFQT,bWdj2GDclj5ofokWjzoa5jAwMkxCykd6,4,3,0,0,0,0,4,0,7,1.0,1,0.0,0,0,0,0,3,0,0,4,0,0,7,1
2089,57797,bZSiNUbAIuydDBd77IMAJ15Hy6k2A1kT,A3fsA9Zfv1X2fVEQhTw51lKENdNrEqT3,33,19,15,52,12,0,2,0,100,14.285714285714286,1,0.0,2,15,43,12,17,0,9,2,0,72,28,0
2090,57814,qdfZW2ffZy8gfDfLseVXmzjU3pjHztuR,SpATywNh6bZuzm8s1ceuBUnMUAeoAHHw,1,0,0,0,0,0,1,0,1,0.14285714285714285,1,0.0,0,0,0,0,0,0,0,1,0,0,1,1
2091,57823,nTCOXKuQTHlcdJy5DLRFkg6Zh0x7ymZf,SpATywNh6bZuzm8s1ceuBUnMUAeoAHHw,15,29,5,12,2,0,9,0,57,8.142857142857142,1,0.0,4,5,12,2,25,0,0,9,0,23,34,0
2092,57840,97ov4fTuLcUGM3NRcbowYBsVQSUEYP2S,SpATywNh6bZuzm8s1ceuBUnMUAeoAHHw,7,6,3,0,3,0,1,0,13,1.8571428571428572,1,0.0,0,3,0,3,6,0,0,1,0,6,7,0
2093,57842,pJxqH2g5fYbOQNkZyqRIriBj2xa6OAqj,A3fsA9Zfv1X2fVEQhTw51lKENdNrEqT3,12,7,5,0,4,0,3,0,19,2.7142857142857144,2,0.0,0,5,0,4,7,0,0,3,0,9,10,0
2094,57865,6R0qSS2YfDD3HGMPKZeKRUJLbFOIEhNG,SpATywNh6bZuzm8s1ceuBUnMUAeoAHHw,11,8,1,0,1,0,2,0,12,1.7142857142857142,1,0.0,0,1,0,1,8,0,0,2,0,2,10,0
2095,57882,X5rINxWa3wsNz25becwIKIJ1YSNrjMdg,bWdj2GDclj5ofokWjzoa5jAwMkxCykd6,2,0,0,0,0,0,2,0,2,0.2857142857142857,1,0.0,0,0,0,0,0,0,0,2,0,0,2,0
2096,57891,zwagDP4QQaMM8mzfViYvCtx8beK29IaC,A3fsA9Zfv1X2fVEQhTw51lKENdNrEqT3,5,2,1,0,1,0,3,0,7,1.0,1,0.0,0,1,0,1,2,0,0,3,0,2,5,1
2097,57921,LJN1NW4KDrkfGUEkF9SJPSL4rdPIFcim,RXDvfPUBYFlVdlueBFbLW0mhhAyGEqpt,6,4,1,0,1,0,1,0,7,1.0,1,0.0,0,1,0,1,4,0,0,1,0,2,5,1
2098,57923,g6dPr9Qj9PAMVLVyPAgx25XT3ANwjQos,A3fsA9Zfv1X2fVEQhTw51lKENdNrEqT3,3,4,2,0,0,0,3,0,9,1.2857142857142858,2,0.0,0,2,0,0,4,0,0,3,0,2,7,1
2099,57973,pZOzdWSKDu3gPwQbI7bGCPRq9RkLjBvS,SpATywNh6bZuzm8s1ceuBUnMUAeoAHHw,1,0,0,0,0,0,1,0,1,0.14285714285714285,1,0.0,0,0,0,0,0,0,0,1,0,0,1,1
2100,57974,kdNglpfKE0K2VvGEZqSD6DoYNnlqyGGv,SpATywNh6bZuzm8s1ceuBUnMUAeoAHHw,11,12,1,5,1,0,2,0,21,3.0,2,0.0,1,1,5,1,11,0,0,2,0,8,13,1
2101,57983,Di7uZGkXU7ZYc44baVoHLFkrq0yYlHlb,SpATywNh6bZuzm8s1ceuBUnMUAeoAHHw,28,37,15,27,7,2,9,0,97,13.857142857142858,2,0.0,9,15,26,7,28,2,1,9,0,57,40,0
2102,57985,Fg273P4R5QIMcXX0ux53RnorAp03dcGp,SpATywNh6bZuzm8s1ceuBUnMUAeoAHHw,5,7,1,0,1,0,2,0,11,1.5714285714285714,1,0.0,0,1,0,1,7,0,0,2,0,2,9,1
2103,58010,iHNKByBLJR2ePn7ZhbbN3FnmeYGE5yyC,SpATywNh6bZuzm8s1ceuBUnMUAeoAHHw,8,10,4,0,2,0,3,2,21,3.0,1,0.0,2,4,0,2,8,0,0,3,2,8,13,1
2104,58047,RTEXU8778fHYGtEiPFJloCtKj0eYc7zl,SpATywNh6bZuzm8s1ceuBUnMUAeoAHHw,6,3,0,0,0,4,4,0,11,1.5714285714285714,1,0.0,0,0,0,0,3,4,0,4,0,0,11,1
2105,58064,rtg3Ki4vk14kI9MkEBE0pkOCAO2AnCnU,A3fsA9Zfv1X2fVEQhTw51lKENdNrEqT3,10,10,7,0,2,0,3,0,22,3.142857142857143,2,0.0,0,7,0,2,10,0,0,3,0,9,13,0
2106,58067,pAWmot8vJjNkDuzTDPJSBxqvPejAjgVS,RXDvfPUBYFlVdlueBFbLW0mhhAyGEqpt,7,3,3,0,3,0,5,0,14,2.0,1,0.0,0,3,0,3,3,0,0,5,0,6,8,1
2107,58072,QWCcSRplc8XLohtOnjfleuw3Kl55Wt2l,G8EPVSXsOYB5YQWZGiz1aVq5Pgr2GrQu,14,18,9,4,5,0,1,0,37,5.285714285714286,1,0.0,5,9,3,5,13,0,1,1,0,22,15,1
2108,58081,VdrjT29t1tCYeqV5Pjs9K79bb5dKTQSe,SpATywNh6bZuzm8s1ceuBUnMUAeoAHHw,6,2,1,0,0,1,4,1,9,1.2857142857142858,1,0.0,0,1,0,0,2,1,0,4,1,1,8,1
2109,58088,ohNbQfFfbGDEMVmhwhRAFtQhn1peVJYy,SpATywNh6bZuzm8s1ceuBUnMUAeoAHHw,10,6,5,0,3,0,2,0,16,2.2857142857142856,1,0.0,0,5,0,3,6,0,0,2,0,8,8,1
2110,58090,02SLgXn6QytDv0WqMwkosTxHkpEuP7VB,bWdj2GDclj5ofokWjzoa5jAwMkxCykd6,5,2,1,0,1,0,2,0,6,0.8571428571428571,1,0.0,0,1,0,1,2,0,0,2,0,2,4,0
2111,58102,RPQvIQfjeayIRS4PyDyrIytbJ9ZHNktA,SpATywNh6bZuzm8s1ceuBUnMUAeoAHHw,5,11,6,0,0,0,7,0,24,3.4285714285714284,4,0.0,0,6,0,0,11,0,0,7,0,6,18,1
2112,58103,7bgBjtUo1mIawwXbLRcW3oiIroDcQOz6,SpATywNh6bZuzm8s1ceuBUnMUAeoAHHw,5,2,1,0,1,0,2,0,6,0.8571428571428571,1,0.0,0,1,0,1,2,0,0,2,0,2,4,1
2113,58112,Bf025FfgNrlcqN8gYGnmBAhjBy0v5Xmo,A3fsA9Zfv1X2fVEQhTw51lKENdNrEqT3,6,3,2,0,1,0,2,0,8,1.1428571428571428,1,0.0,0,2,0,1,3,0,0,2,0,3,5,1
2114,58123,YUqfabBN24DH37opLol4A70oThsuifuQ,SpATywNh6bZuzm8s1ceuBUnMUAeoAHHw,1,0,0,0,0,0,1,0,1,0.14285714285714285,1,0.0,0,0,0,0,0,0,0,1,0,0,1,1
2115,58128,th3jtP88bHr6FB2R2HdadrOKTixMDxTi,SpATywNh6bZuzm8s1ceuBUnMUAeoAHHw,10,11,3,0,3,0,11,0,28,4.0,2,0.0,0,3,0,3,11,0,0,11,0,6,22,1
2116,58133,dytCdr5a5mu9Lr4Kt80AVLD7WwBUELzE,A3fsA9Zfv1X2fVEQhTw51lKENdNrEqT3,13,23,12,0,5,0,5,0,45,6.428571428571429,2,0.0,0,12,0,5,23,0,0,5,0,17,28,1
2117,58150,7a8ZShKuD962zsBaN4mct9BkYS1KNLrF,SpATywNh6bZuzm8s1ceuBUnMUAeoAHHw,15,16,10,5,6,1,5,0,43,6.142857142857143,1,0.0,2,10,4,6,14,1,1,5,0,22,21,0
2118,58153,5IgfYzsKnLRjBd3YVdiUAOaMV18WR5D2,SpATywNh6bZuzm8s1ceuBUnMUAeoAHHw,1,0,0,0,0,0,1,0,1,0.14285714285714285,1,0.0,0,0,0,0,0,0,0,1,0,0,1,1
2119,58161,0WJYCLUpH1qPXc41N4k9wHMseoSu2vAz,SpATywNh6bZuzm8s1ceuBUnMUAeoAHHw,30,42,19,29,8,5,6,0,109,15.571428571428571,3,0.0,17,19,26,8,25,5,3,6,0,70,39,0
2120,58181,XuNt1i5t4SR1AjDP4UHvsoux0R9qVf5C,A3fsA9Zfv1X2fVEQhTw51lKENdNrEqT3,23,15,7,52,2,0,3,0,79,11.285714285714286,1,0.0,0,7,49,2,15,0,3,3,0,58,21,1
2121,58216,nZTn5dZMRyIKKNGuMbIWH6lpWaWoYX62,bWdj2GDclj5ofokWjzoa5jAwMkxCykd6,5,3,1,0,1,0,2,0,7,1.0,1,0.0,0,1,0,1,3,0,0,2,0,2,5,1
2122,58242,JaIi02fnjAZfoUxjYtpyJ7uZYWKdC5yF,RXDvfPUBYFlVdlueBFbLW0mhhAyGEqpt,7,11,1,0,1,0,1,0,14,2.0,1,0.0,2,1,0,1,9,0,0,1,0,4,10,1
2123,58254,hkGRaSb7xMufUFhBVJXaeYKKkPgEjvNE,SpATywNh6bZuzm8s1ceuBUnMUAeoAHHw,12,9,1,0,1,0,3,1,15,2.142857142857143,1,0.0,0,1,0,1,9,0,0,3,1,2,13,1
2124,58255,zzLagpOecSivjjn7PNG5qmEhwa4PmnNX,SpATywNh6bZuzm8s1ceuBUnMUAeoAHHw,14,28,14,16,3,0,12,0,73,10.428571428571429,3,0.0,8,14,15,3,20,0,1,12,0,40,33,1
2125,58270,49oypRKmbhsESvRt5ynYhyueQezYQsCQ,bWdj2GDclj5ofokWjzoa5jAwMkxCykd6,4,2,0,0,0,0,3,0,5,0.7142857142857143,2,0.0,0,0,0,0,2,0,0,3,0,0,5,1
2126,58271,S8Q8neHdkaiSIrDXkWMhuMhsENfqfEdt,G8EPVSXsOYB5YQWZGiz1aVq5Pgr2GrQu,8,10,3,0,5,0,5,0,23,3.2857142857142856,1,0.0,6,3,0,5,4,0,0,5,0,14,9,1
2127,58272,xOB7vl3l1Tpb0i0cSWni40BfJ5FBclms,A3fsA9Zfv1X2fVEQhTw51lKENdNrEqT3,41,39,10,74,8,3,20,0,154,22.0,4,0.0,3,10,66,8,36,3,8,20,0,87,67,1
2128,58273,YkzGM7FCSZusATw7cM0Pqx3TXux1w8Gj,SpATywNh6bZuzm8s1ceuBUnMUAeoAHHw,5,2,1,0,1,0,2,0,6,0.8571428571428571,1,0.0,0,1,0,1,2,0,0,2,0,2,4,1
2129,58286,y6i20DJpIul6LihHwgZcWxbdAap5GcBP,A3fsA9Zfv1X2fVEQhTw51lKENdNrEqT3,1,0,0,0,0,0,1,0,1,0.14285714285714285,1,0.0,0,0,0,0,0,0,0,1,0,0,1,1
2130,58291,PCPmtsqEtkHe7GooXQswbqyH8cnukgFn,G8EPVSXsOYB5YQWZGiz1aVq5Pgr2GrQu,27,31,9,40,4,1,1,0,86,12.285714285714286,1,0.0,14,9,29,4,17,1,11,1,0,56,30,0
2131,58293,3ZzhbGHk0AMavVBVS0pUAaZvWnLoQODp,A3fsA9Zfv1X2fVEQhTw51lKENdNrEqT3,5,3,1,0,1,0,1,0,6,0.8571428571428571,1,0.0,0,1,0,1,3,0,0,1,0,2,4,0
2132,58300,uQw9hBSE2Dk9ZRkbmlhR0YJ8RRLoEt0U,SpATywNh6bZuzm8s1ceuBUnMUAeoAHHw,5,4,1,0,1,0,1,0,7,1.0,1,0.0,0,1,0,1,4,0,0,1,0,2,5,1
2133,58316,GfppdBt6zqP8G2m8ukjaahHhJ4ewTb0w,SpATywNh6bZuzm8s1ceuBUnMUAeoAHHw,13,25,1,14,0,0,2,0,42,6.0,3,0.0,5,1,12,0,20,0,2,2,0,18,24,0
2134,58328,bwboRgaiFEflIqviFAKUixpzo8aJUZGL,G8EPVSXsOYB5YQWZGiz1aVq5Pgr2GrQu,49,198,1,116,4,0,14,1,334,47.714285714285715,4,0.0,66,1,64,4,132,0,52,14,1,135,199,0
2135,58357,OdMr7dE5UlAme9Tp979vREBvY5CV50po,A3fsA9Zfv1X2fVEQhTw51lKENdNrEqT3,50,20,12,118,3,0,6,0,159,22.714285714285715,3,0.0,4,12,107,3,16,0,11,6,0,126,33,0
2136,58359,czKChsqaxfwVoznY2WnWYH2vLIXb6X34,bWdj2GDclj5ofokWjzoa5jAwMkxCykd6,9,5,4,0,3,0,1,0,13,1.8571428571428572,1,0.0,0,4,0,3,5,0,0,1,0,7,6,1
2137,58371,O77ylT4ugXOb86DaYG0RYlYAbEVpuj16,bWdj2GDclj5ofokWjzoa5jAwMkxCykd6,6,3,1,0,2,0,3,0,9,1.2857142857142858,1,0.0,2,1,0,2,1,0,0,3,0,5,4,1
2138,58383,ewcDv7X6I323ciCMJsU4n4MdvO632A9I,bWdj2GDclj5ofokWjzoa5jAwMkxCykd6,8,11,1,136,1,0,3,0,152,21.714285714285715,1,0.0,7,1,135,1,4,0,1,3,0,144,8,1
2139,58387,AsOtGuZjIIEs9Ge9E033Sbp9VeIeUiUH,A3fsA9Zfv1X2fVEQhTw51lKENdNrEqT3,9,7,5,0,4,0,2,0,18,2.5714285714285716,2,0.0,0,5,0,4,7,0,0,2,0,9,9,1
2140,58396,vMwiflFInrKAqz6Uhuhl7ZJhinTtaSMK,SpATywNh6bZuzm8s1ceuBUnMUAeoAHHw,1,0,0,0,0,0,1,0,1,0.14285714285714285,1,0.0,0,0,0,0,0,0,0,1,0,0,1,1
2141,58403,Xn2ydtleLSG85TyAEd0OMkY2BfH9jhfO,SpATywNh6bZuzm8s1ceuBUnMUAeoAHHw,3,2,1,0,0,0,1,0,4,0.5714285714285714,1,0.0,0,1,0,0,2,0,0,1,0,1,3,0
2142,58404,RBJm407yEn5NJTf66xkOViV4vHRGXhZs,A3fsA9Zfv1X2fVEQhTw51lKENdNrEqT3,37,40,20,0,17,0,7,0,84,12.0,1,0.0,0,20,0,17,40,0,0,7,0,37,47,0
2143,58453,fgzbUfrTxXYCuiFYTG1cTemcEJUl36an,A3fsA9Zfv1X2fVEQhTw51lKENdNrEqT3,3,4,0,0,0,0,2,0,6,0.8571428571428571,2,0.0,0,0,0,0,4,0,0,2,0,0,6,1
2144,58459,UO0yW1yQ6dpOPTHCocxgWJWaWMRmXAmV,SpATywNh6bZuzm8s1ceuBUnMUAeoAHHw,15,18,5,4,4,0,6,0,37,5.285714285714286,3,0.0,1,5,3,4,17,0,1,6,0,13,24,0
2145,58485,UO0yW1yQ6dpOPTHCocxgWJWaWMRmXAmV,A3fsA9Zfv1X2fVEQhTw51lKENdNrEqT3,1,0,0,0,0,0,1,0,1,0.14285714285714285,1,0.0,0,0,0,0,0,0,0,1,0,0,1,1
2146,58503,uznRyNJNtd1ZgZ95fF39jNQxAuIkBivb,A3fsA9Zfv1X2fVEQhTw51lKENdNrEqT3,29,36,27,12,22,0,12,0,109,15.571428571428571,3,0.0,2,27,12,22,34,0,0,12,0,63,46,0
2147,58524,T761UltC8HrAVgHTpcJuQFf7vNJ3Ud9J,A3fsA9Zfv1X2fVEQhTw51lKENdNrEqT3,39,40,28,0,21,0,3,0,92,13.142857142857142,2,0.0,0,28,0,21,40,0,0,3,0,49,43,0
2148,58526,OgKWYLWF7k4jNyuIPtj4HfbaQ79kKNws,A3fsA9Zfv1X2fVEQhTw51lKENdNrEqT3,11,9,7,0,4,0,4,0,24,3.4285714285714284,2,0.0,0,7,0,4,9,0,0,4,0,11,13,1
2149,58544,bpxaFadaQixJuWRVtAAq5miKiBM3zC6u,A3fsA9Zfv1X2fVEQhTw51lKENdNrEqT3,9,17,1,0,0,0,8,0,26,3.7142857142857144,3,0.0,0,1,0,0,17,0,0,8,0,1,25,0
2150,58546,u1YszrViylpVYfK1eoJx8s7LOLPdQuxR,G8EPVSXsOYB5YQWZGiz1aVq5Pgr2GrQu,8,6,1,0,1,1,5,1,15,2.142857142857143,1,0.0,3,1,0,1,3,1,0,5,1,5,10,1
2151,58560,3wojMge418Q4FflCb29r3hem59j6egRX,SpATywNh6bZuzm8s1ceuBUnMUAeoAHHw,14,36,1,20,0,4,18,0,79,11.285714285714286,4,0.0,14,1,16,0,22,4,4,18,0,31,48,1
2152,58581,2rfL8B4HbJAOL6vHmGEftXwUPWvgkqAq,G8EPVSXsOYB5YQWZGiz1aVq5Pgr2GrQu,2,0,0,0,0,0,2,0,2,0.2857142857142857,1,0.0,0,0,0,0,0,0,0,2,0,0,2,1
2153,58582,o0M6SOlciWGWtqkYLASaq6tS76D18V6N,SpATywNh6bZuzm8s1ceuBUnMUAeoAHHw,1,0,0,0,0,0,1,0,1,0.14285714285714285,1,0.0,0,0,0,0,0,0,0,1,0,0,1,0
2154,58598,7Yap2PcZ1Tcmw27mR2CH7ZbGwXBMRlQy,bWdj2GDclj5ofokWjzoa5jAwMkxCykd6,7,3,1,0,1,0,8,1,14,2.0,1,0.0,0,1,0,1,3,0,0,8,1,2,12,1
2155,58600,O3gLgOLI0OlNHxEv48gq43YbMqSfrrr5,SpATywNh6bZuzm8s1ceuBUnMUAeoAHHw,1,0,0,0,0,0,1,0,1,0.14285714285714285,1,0.0,0,0,0,0,0,0,0,1,0,0,1,1
2156,58601,pIkx6nDAjTla5NYVEsjhMXOIu5zXDzmO,G8EPVSXsOYB5YQWZGiz1aVq5Pgr2GrQu,9,5,4,0,3,0,1,0,13,1.8571428571428572,1,0.0,0,4,0,3,5,0,0,1,0,7,6,0
2157,58614,Elb131j0dQdh1y8beabFLrOKaH2n8x2C,SpATywNh6bZuzm8s1ceuBUnMUAeoAHHw,1,0,0,0,0,0,1,0,1,0.14285714285714285,1,0.0,0,0,0,0,0,0,0,1,0,0,1,1
2158,58637,2CPNIar2bLO0Nk3gqpw6tYIpylWKP9T0,RXDvfPUBYFlVdlueBFbLW0mhhAyGEqpt,20,26,9,28,13,0,10,0,86,12.285714285714286,3,0.0,17,9,26,13,9,0,2,10,0,65,21,0
2159,58640,z0d4GdTRWwPphB67CIM0rjy94Artnm4E,bWdj2GDclj5ofokWjzoa5jAwMkxCykd6,13,16,9,4,7,15,9,1,61,8.714285714285714,2,0.0,2,9,4,7,14,15,0,9,1,22,39,1
2160,58641,0du1ow9RqiNaGy3uHg59U3uAi9Pl6foI,SpATywNh6bZuzm8s1ceuBUnMUAeoAHHw,6,3,1,0,1,0,2,0,7,1.0,1,0.0,0,1,0,1,3,0,0,2,0,2,5,1
2161,58642,ALYZFAVviUOGzyN4znk46d3PmVgvtUAM,A3fsA9Zfv1X2fVEQhTw51lKENdNrEqT3,27,14,1,38,1,0,2,0,56,8.0,1,0.0,1,1,31,1,13,0,7,2,0,34,22,1
2162,58644,zWZdErlwOQ1yvd6vlyAltL2Balhdc8gj,G8EPVSXsOYB5YQWZGiz1aVq5Pgr2GrQu,65,62,39,124,14,10,9,0,258,36.857142857142854,4,0.0,11,39,108,14,51,10,16,9,0,172,86,0
2163,58658,CG3QLsuznsakuKho7ljIoKCjBowMzxNf,SpATywNh6bZuzm8s1ceuBUnMUAeoAHHw,6,3,2,0,2,0,1,0,8,1.1428571428571428,1,0.0,0,2,0,2,3,0,0,1,0,4,4,0
2164,58675,jm31Z85lUKPglpGy76SHR0pRWJW0VhuU,SpATywNh6bZuzm8s1ceuBUnMUAeoAHHw,11,11,1,12,0,0,1,0,25,3.5714285714285716,1,0.0,4,1,12,0,7,0,0,1,0,17,8,1
2165,58686,y9A8XMlmfPaglBBuQFjiuxUOvb1WQu2v,bWdj2GDclj5ofokWjzoa5jAwMkxCykd6,1,0,0,0,0,0,1,0,1,0.14285714285714285,1,0.0,0,0,0,0,0,0,0,1,0,0,1,0
2166,58692,2rfL8B4HbJAOL6vHmGEftXwUPWvgkqAq,A3fsA9Zfv1X2fVEQhTw51lKENdNrEqT3,5,2,1,0,1,0,3,0,7,1.0,1,0.0,0,1,0,1,2,0,0,3,0,2,5,1
2167,58693,2AEx3J0dyYAsdnSPWbdrCmQApLqSYiKY,SpATywNh6bZuzm8s1ceuBUnMUAeoAHHw,18,20,11,12,5,0,2,0,50,7.142857142857143,1,0.0,7,11,9,5,13,0,3,2,0,32,18,0
2168,58738,eFoLZ7Ff0p8wCkYKEUOC13yf0OTaGh2R,A3fsA9Zfv1X2fVEQhTw51lKENdNrEqT3,2,0,0,0,0,0,6,0,6,0.8571428571428571,1,0.0,0,0,0,0,0,0,0,6,0,0,6,1
2169,58755,Hw4Baku6JlYmMCYHpyYlIRmyrGYxbxqZ,bWdj2GDclj5ofokWjzoa5jAwMkxCykd6,4,2,1,0,1,0,1,0,5,0.7142857142857143,1,0.0,0,1,0,1,2,0,0,1,0,2,3,1
2170,58763,HZ8Q7bQ1EwRW8jOabrhMI019qnvyVzyL,G8EPVSXsOYB5YQWZGiz1aVq5Pgr2GrQu,63,108,26,86,23,20,10,3,276,39.42857142857143,4,0.0,51,26,52,23,57,20,34,10,3,152,124,0
2171,58765,rc05wotvNjs6yb6NUxWRBXqWQTWfWnjs,SpATywNh6bZuzm8s1ceuBUnMUAeoAHHw,9,10,1,0,0,0,4,0,15,2.142857142857143,1,0.0,0,1,0,0,10,0,0,4,0,1,14,1
2172,58777,4Ofl2Ny0Hi8mgxaGCrkktZk3mHl8PQkx,SpATywNh6bZuzm8s1ceuBUnMUAeoAHHw,1,0,0,0,0,0,1,0,1,0.14285714285714285,1,0.0,0,0,0,0,0,0,0,1,0,0,1,1
2173,58791,rc05wotvNjs6yb6NUxWRBXqWQTWfWnjs,bWdj2GDclj5ofokWjzoa5jAwMkxCykd6,1,0,0,0,0,0,1,0,1,0.14285714285714285,1,0.0,0,0,0,0,0,0,0,1,0,0,1,1
2174,58794,1zErz13s8fNQRVaEvkOtvw6bLhr23yB4,SpATywNh6bZuzm8s1ceuBUnMUAeoAHHw,9,9,4,13,0,0,1,0,27,3.857142857142857,1,0.0,4,4,11,0,5,0,2,1,0,19,8,0
2175,58800,irZDaKqT4KdxcZGgiOHoDpvTtZyUugWP,G8EPVSXsOYB5YQWZGiz1aVq5Pgr2GrQu,54,38,11,157,6,0,10,0,222,31.714285714285715,4,0.0,0,11,145,6,38,0,12,10,0,162,60,0
2176,58804,OUbh6hvaOJDp9RK7kgTBzzPmjzmkYhZF,SpATywNh6bZuzm8s1ceuBUnMUAeoAHHw,3,6,0,0,0,0,3,0,9,1.2857142857142858,3,0.0,0,0,0,0,6,0,0,3,0,0,9,0
2177,58806,Sz4iN9vM7plSJObu2Kgng7aJijtNNsts,SpATywNh6bZuzm8s1ceuBUnMUAeoAHHw,9,11,1,0,0,1,1,0,14,2.0,1,0.0,1,1,0,0,10,1,0,1,0,2,12,1
2178,58812,x2TXADDQJTDLVMnKDb6BhJyWEoYQjlQy,SpATywNh6bZuzm8s1ceuBUnMUAeoAHHw,1,0,0,0,0,0,2,0,2,0.2857142857142857,2,0.0,0,0,0,0,0,0,0,2,0,0,2,1
2179,58818,67rSRaCVWXo14Jy7qMP7vHh2SS3POF3M,G8EPVSXsOYB5YQWZGiz1aVq5Pgr2GrQu,55,50,31,20,21,2,20,4,148,21.142857142857142,3,0.0,10,31,10,21,40,2,10,20,4,72,76,0
2180,58833,z9n4TGh9UXCrVLnylY34Ni1zPy7fphxP,G8EPVSXsOYB5YQWZGiz1aVq5Pgr2GrQu,8,15,10,0,0,1,2,0,28,4.0,2,0.0,2,10,0,0,13,1,0,2,0,12,16,1
2181,58849,9UxAqNYuBtvS2ppV37y5D8wZyoNAl3Em,SpATywNh6bZuzm8s1ceuBUnMUAeoAHHw,6,13,5,0,2,0,3,0,23,3.2857142857142856,2,0.0,0,5,0,2,13,0,0,3,0,7,16,1
2182,58855,6K3h9aDeHI9AUqOKTvZxzGkKh6WMc7A3,SpATywNh6bZuzm8s1ceuBUnMUAeoAHHw,4,2,1,0,0,0,2,0,5,0.7142857142857143,1,0.0,0,1,0,0,2,0,0,2,0,1,4,0
2183,58877,Hoitr98hXhrf7xDGgACEFamKhiarA3wg,SpATywNh6bZuzm8s1ceuBUnMUAeoAHHw,7,10,7,0,1,0,4,0,22,3.142857142857143,3,0.0,0,7,0,1,10,0,0,4,0,8,14,0
2184,58887,7wyfXvc1g99QNmXzEb4w8C1vE0Vi2bHm,RXDvfPUBYFlVdlueBFbLW0mhhAyGEqpt,10,7,4,0,3,0,1,0,15,2.142857142857143,1,0.0,0,4,0,3,7,0,0,1,0,7,8,0
2185,58893,Oh4qObC7j4dz8QtvEnVVjGNXqScAv0Td,A3fsA9Zfv1X2fVEQhTw51lKENdNrEqT3,1,0,0,0,0,0,1,0,1,0.14285714285714285,1,0.0,0,0,0,0,0,0,0,1,0,0,1,0
2186,58928,oxKInSadxtDVW8xImZsLo8dMy3cZAYYB,G8EPVSXsOYB5YQWZGiz1aVq5Pgr2GrQu,6,2,2,0,2,0,6,0,12,1.7142857142857142,1,0.0,0,2,0,2,2,0,0,6,0,4,8,0
2187,58931,KF0Hp0kY1zRx3PfsDN1lrNbV34F9NU2o,SpATywNh6bZuzm8s1ceuBUnMUAeoAHHw,1,0,0,0,0,0,1,0,1,0.14285714285714285,1,0.0,0,0,0,0,0,0,0,1,0,0,1,1
2188,58937,BWQpUowEHGBDEzSf23lNUZVBPlEw3Sq1,SpATywNh6bZuzm8s1ceuBUnMUAeoAHHw,15,16,1,12,0,0,5,0,34,4.857142857142857,3,0.0,4,1,9,0,12,0,3,5,0,14,20,0
2189,58988,yQ30DktO8KD929ApuNMOdNKTtmTpkfc3,SpATywNh6bZuzm8s1ceuBUnMUAeoAHHw,3,0,0,0,0,8,4,0,12,1.7142857142857142,2,0.0,0,0,0,0,0,8,0,4,0,0,12,1
2190,58995,s52sWVKWNW4BhZF8lEKgLOTywZdUL59a,A3fsA9Zfv1X2fVEQhTw51lKENdNrEqT3,46,42,24,76,14,1,23,4,184,26.285714285714285,4,0.0,3,24,65,14,39,1,11,23,4,106,78,1
2191,59000,yQ30DktO8KD929ApuNMOdNKTtmTpkfc3,bWdj2GDclj5ofokWjzoa5jAwMkxCykd6,3,0,0,0,0,4,2,0,6,0.8571428571428571,1,0.0,0,0,0,0,0,4,0,2,0,0,6,1
2192,59003,yQ30DktO8KD929ApuNMOdNKTtmTpkfc3,RXDvfPUBYFlVdlueBFbLW0mhhAyGEqpt,3,0,0,0,0,4,2,0,6,0.8571428571428571,1,0.0,0,0,0,0,0,4,0,2,0,0,6,1
2193,59023,1zErz13s8fNQRVaEvkOtvw6bLhr23yB4,G8EPVSXsOYB5YQWZGiz1aVq5Pgr2GrQu,22,15,9,32,3,0,2,0,61,8.714285714285714,2,0.0,4,9,24,3,11,0,8,2,0,40,21,0
2194,59030,yxVlIOgiPy2uO2769tIJMAsvrTHms87z,SpATywNh6bZuzm8s1ceuBUnMUAeoAHHw,1,0,0,0,0,0,1,0,1,0.14285714285714285,1,0.0,0,0,0,0,0,0,0,1,0,0,1,1
2195,59043,SicKtTdinGjYgkh3dK0y8UiEfELy0LiN,A3fsA9Zfv1X2fVEQhTw51lKENdNrEqT3,4,3,2,0,0,0,1,0,6,0.8571428571428571,1,0.0,0,2,0,0,3,0,0,1,0,2,4,1
2196,59059,WyukafQHQxismOtYiPzoFkAc38hAOB09,SpATywNh6bZuzm8s1ceuBUnMUAeoAHHw,4,5,2,0,0,0,2,0,9,1.2857142857142858,2,0.0,2,2,0,0,3,0,0,2,0,4,5,0
2197,59061,XviXJdbSmJpUjtXY3NDPcBVoPrslVGvz,A3fsA9Zfv1X2fVEQhTw51lKENdNrEqT3,2,0,0,0,0,0,2,0,2,0.2857142857142857,1,0.0,0,0,0,0,0,0,0,2,0,0,2,1
2198,59074,pspPjjKHZe0z6Fq8OVRjBFFpabOEyxUN,G8EPVSXsOYB5YQWZGiz1aVq5Pgr2GrQu,1,0,0,0,0,0,1,0,1,0.14285714285714285,1,0.0,0,0,0,0,0,0,0,1,0,0,1,0
2199,59086,QscGDFmAAH7jp4ntcbRqVptjZvFSEe7R,bWdj2GDclj5ofokWjzoa5jAwMkxCykd6,1,0,0,0,0,0,1,0,1,0.14285714285714285,1,0.0,0,0,0,0,0,0,0,1,0,0,1,1
2200,59096,ycTj3YOXaJ7pHDIwrzbh7koMVXAXAOVY,A3fsA9Zfv1X2fVEQhTw51lKENdNrEqT3,9,4,3,0,3,0,2,0,12,1.7142857142857142,1,0.0,0,3,0,3,4,0,0,2,0,6,6,1
2201,59112,SSR2C7GBXM7XyR67GN0wwOxiCuLYjW4G,SpATywNh6bZuzm8s1ceuBUnMUAeoAHHw,26,50,2,39,2,5,24,2,124,17.714285714285715,4,0.0,12,2,33,2,38,5,6,24,2,49,75,0
2202,59123,GDXKLbggMsEQESvte5Fm99YDi8EaSknC,SpATywNh6bZuzm8s1ceuBUnMUAeoAHHw,2,0,0,0,0,0,2,0,2,0.2857142857142857,1,0.0,0,0,0,0,0,0,0,2,0,0,2,1
2203,59133,kqS8BwWN9R1093oeblGkvtCsQJ68Gh0G,A3fsA9Zfv1X2fVEQhTw51lKENdNrEqT3,6,5,3,0,0,3,4,0,15,2.142857142857143,1,0.0,1,3,0,0,4,3,0,4,0,4,11,1
2204,59152,1QXHZAtBZ2KaQglYqYbNwbUn7ThwuB1g,A3fsA9Zfv1X2fVEQhTw51lKENdNrEqT3,1,0,0,0,0,0,1,0,1,0.14285714285714285,1,0.0,0,0,0,0,0,0,0,1,0,0,1,1
2205,59154,xkk52A95ro7prnFrC4vTRChCiKRyqt9P,bWdj2GDclj5ofokWjzoa5jAwMkxCykd6,13,11,6,4,7,1,6,1,36,5.142857142857143,2,0.0,4,6,4,7,7,1,0,6,1,21,15,1
2206,59155,1QXHZAtBZ2KaQglYqYbNwbUn7ThwuB1g,RXDvfPUBYFlVdlueBFbLW0mhhAyGEqpt,11,10,2,12,2,4,8,1,39,5.571428571428571,1,0.0,6,2,10,2,4,4,2,8,1,20,19,1
2207,59158,83bogZlv4TVHMx4MUYOU3yEQWNYHnGAe,A3fsA9Zfv1X2fVEQhTw51lKENdNrEqT3,6,4,2,0,0,0,3,1,10,1.4285714285714286,1,0.0,0,2,0,0,4,0,0,3,1,2,8,1
2208,59163,Jx3Mosyeukaoh3SiTDGSPF6OEZs0bdWa,bWdj2GDclj5ofokWjzoa5jAwMkxCykd6,15,9,7,0,6,4,7,1,34,4.857142857142857,1,0.0,0,7,0,6,9,4,0,7,1,13,21,1
2209,59172,jImHfNEIObE674KdIbKVj7cCJ4ufqzHJ,SpATywNh6bZuzm8s1ceuBUnMUAeoAHHw,3,2,1,0,0,0,1,0,4,0.5714285714285714,1,0.0,0,1,0,0,2,0,0,1,0,1,3,0
2210,59176,EEY05e2oBdca2rsoXfuwyrFxbCmUnL6Y,SpATywNh6bZuzm8s1ceuBUnMUAeoAHHw,1,0,0,0,0,0,2,0,2,0.2857142857142857,2,0.0,0,0,0,0,0,0,0,2,0,0,2,1
2211,59184,GBRSAR4GUGDv32LhHoze2mah1gIJQuBL,bWdj2GDclj5ofokWjzoa5jAwMkxCykd6,1,0,0,0,0,0,1,0,1,0.14285714285714285,1,0.0,0,0,0,0,0,0,0,1,0,0,1,1
2212,60061,bYV2ECkbVEzILNLnjio0M2wLrbMzskol,7GRhBDsirIGkRZBtSMEzNTyDr2JQm4xx,2,0,0,0,0,0,2,0,2,0.2857142857142857,1,0.0,0,0,0,0,0,0,0,2,0,0,2,1
2213,60066,OkJ0lKmMXuQ2MGftQ8Isfw1JciMpapRC,7GRhBDsirIGkRZBtSMEzNTyDr2JQm4xx,1,0,0,0,0,0,1,0,1,0.14285714285714285,1,0.0,0,0,0,0,0,0,0,1,0,0,1,1
2214,60074,Vve0UwhmiGWZN8bT2t4sC82sMWi2ZyY8,7GRhBDsirIGkRZBtSMEzNTyDr2JQm4xx,11,8,3,14,4,0,6,0,35,5.0,1,0.0,4,3,13,4,4,0,1,6,0,24,11,1
2215,60186,YIoKCUIP4Rx4Vrk0MaySMDs3xqxsTZ0O,7GRhBDsirIGkRZBtSMEzNTyDr2JQm4xx,27,22,10,33,6,0,7,0,78,11.142857142857142,2,0.0,9,10,30,6,13,0,3,7,0,55,23,1
2216,60189,trY5Yo0vbJ00GveQ31z4FIOxjL0ITdnW,7GRhBDsirIGkRZBtSMEzNTyDr2JQm4xx,5,2,1,0,1,0,2,0,6,0.8571428571428571,1,0.0,0,1,0,1,2,0,0,2,0,2,4,0
2217,60193,ya3v1iYETjj0QFCSbW4Y8PQXQRFY49xl,7GRhBDsirIGkRZBtSMEzNTyDr2JQm4xx,40,91,27,70,28,16,10,0,242,34.57142857142857,4,0.0,42,27,57,28,49,16,13,10,0,154,88,1
2218,60210,wGqhUJlJ3fGYOW2r7IbwNL0CdAR0avoU,7GRhBDsirIGkRZBtSMEzNTyDr2JQm4xx,29,41,14,26,7,60,1,0,149,21.285714285714285,1,0.0,24,14,16,7,17,60,10,1,0,61,88,1
2219,60214,Y3uwxWCm13Ol5xozrT2GPjOPhBlC2kOq,7GRhBDsirIGkRZBtSMEzNTyDr2JQm4xx,34,58,9,46,12,0,5,0,130,18.571428571428573,3,0.0,19,9,41,12,39,0,5,5,0,81,49,1
2220,60224,Glan4HLmS50xRoKOWAXnEjHiOG5ALXJa,7GRhBDsirIGkRZBtSMEzNTyDr2JQm4xx,2,0,0,0,0,0,2,0,2,0.2857142857142857,1,0.0,0,0,0,0,0,0,0,2,0,0,2,1
2221,60229,4IJ56QlJSL8avuRQEkrBcEyhUIO3LIP3,7GRhBDsirIGkRZBtSMEzNTyDr2JQm4xx,31,64,21,14,20,0,9,0,128,18.285714285714285,2,0.0,40,21,10,20,24,0,4,9,0,91,37,1
2222,60241,n2vbSLePtnxy4AVvThroeNvlXpcTMINy,7GRhBDsirIGkRZBtSMEzNTyDr2JQm4xx,11,11,1,0,2,0,3,0,17,2.4285714285714284,1,0.0,1,1,0,2,10,0,0,3,0,4,13,0
2223,60245,yO1Jj5u6PMEcpPI9xjxordPxwxelX8AU,7GRhBDsirIGkRZBtSMEzNTyDr2JQm4xx,1,0,0,0,0,0,1,0,1,0.14285714285714285,1,0.0,0,0,0,0,0,0,0,1,0,0,1,1
2224,60264,iSrdvAXagFyTWuVpDzl1vXqwXkCyI8Nx,7GRhBDsirIGkRZBtSMEzNTyDr2JQm4xx,2,0,0,0,0,0,2,0,2,0.2857142857142857,1,0.0,0,0,0,0,0,0,0,2,0,0,2,1
2225,60279,vxpUumLCzU7FedUSJgEG4isBVr1VqobO,7GRhBDsirIGkRZBtSMEzNTyDr2JQm4xx,5,2,0,0,0,0,3,0,5,0.7142857142857143,1,0.0,0,0,0,0,2,0,0,3,0,0,5,1
2226,60283,uRNJHauAxW10nQZrIpEU1nj0mhvBnDcR,7GRhBDsirIGkRZBtSMEzNTyDr2JQm4xx,5,3,2,0,1,0,2,0,8,1.1428571428571428,1,0.0,0,2,0,1,3,0,0,2,0,3,5,1
2227,60285,3A3xnhkl0PPjpuPQj8ksbgab2OoOm2Bf,7GRhBDsirIGkRZBtSMEzNTyDr2JQm4xx,2,0,0,0,0,0,2,0,2,0.2857142857142857,1,0.0,0,0,0,0,0,0,0,2,0,0,2,1
2228,60295,zKEKzDZvBY5bjlEOjPTJFe0fxEtpR0hq,7GRhBDsirIGkRZBtSMEzNTyDr2JQm4xx,1,0,0,0,0,0,1,0,1,0.14285714285714285,1,0.0,0,0,0,0,0,0,0,1,0,0,1,1
2229,60359,FMaoSj6PouPVBL36elw7C1ayn8NuceeR,7GRhBDsirIGkRZBtSMEzNTyDr2JQm4xx,1,0,0,0,0,0,1,0,1,0.14285714285714285,1,0.0,0,0,0,0,0,0,0,1,0,0,1,1
2230,60427,r3TtJNrYEPB9JfkbBp23luDTSVLZGHt2,7GRhBDsirIGkRZBtSMEzNTyDr2JQm4xx,37,83,5,66,12,1,13,0,180,25.714285714285715,4,0.0,37,5,56,12,46,1,10,13,0,110,70,0
2231,60442,76btfIjeEvKDRqZ07unLyzOBWCQVXirv,7GRhBDsirIGkRZBtSMEzNTyDr2JQm4xx,29,22,8,46,8,0,3,0,87,12.428571428571429,2,0.0,12,8,40,8,10,0,6,3,0,68,19,0
2232,60518,r639bFH7kDBWMyuyounNz9zTrG9jbNqa,7GRhBDsirIGkRZBtSMEzNTyDr2JQm4xx,63,168,41,112,31,24,19,0,395,56.42857142857143,2,0.0,67,41,101,31,101,24,11,19,0,240,155,0
2233,60531,Vdzl3X3O6ZP4Npa6oBdNxCc6U3L9nvWo,7GRhBDsirIGkRZBtSMEzNTyDr2JQm4xx,48,141,37,78,27,8,15,0,306,43.714285714285715,5,0.0,68,37,66,27,73,8,12,15,0,198,108,0
2234,60537,HixqtECIw1MfDhOlFHcd4iKMiA1aAB20,7GRhBDsirIGkRZBtSMEzNTyDr2JQm4xx,1,0,0,0,0,0,1,0,1,0.14285714285714285,1,0.0,0,0,0,0,0,0,0,1,0,0,1,1
2235,60551,yYnzwoX1EEo9O5PANf4AeqhApgmnqHcZ,7GRhBDsirIGkRZBtSMEzNTyDr2JQm4xx,48,77,36,48,25,5,12,0,203,29.0,2,0.0,34,36,42,25,43,5,6,12,0,137,66,1
2236,60575,u5mzcmE18EKn09QMnw59wiWLJPMqcNLU,7GRhBDsirIGkRZBtSMEzNTyDr2JQm4xx,11,5,4,0,4,0,2,0,15,2.142857142857143,1,0.0,0,4,0,4,5,0,0,2,0,8,7,1
2237,60578,n8xDhUwKlkQ0nvvpXIE3P2WLYZ4QLCAp,7GRhBDsirIGkRZBtSMEzNTyDr2JQm4xx,1,0,0,0,0,0,1,0,1,0.14285714285714285,1,0.0,0,0,0,0,0,0,0,1,0,0,1,1
2238,60612,hXKu4e2xQzaCku75DATROcU5QTIKASt0,7GRhBDsirIGkRZBtSMEzNTyDr2JQm4xx,9,4,3,0,3,0,4,0,14,2.0,1,0.0,0,3,0,3,4,0,0,4,0,6,8,1
2239,60698,yWBM5NSXn0oxTlghKgVFEOhem7bIKtAR,7GRhBDsirIGkRZBtSMEzNTyDr2JQm4xx,1,0,0,0,0,0,1,0,1,0.14285714285714285,1,0.0,0,0,0,0,0,0,0,1,0,0,1,1
2240,60726,YmnL5Vd2hwZrlPvojHN5WzyBYQvWTeW1,7GRhBDsirIGkRZBtSMEzNTyDr2JQm4xx,2,0,0,0,0,0,2,0,2,0.2857142857142857,1,0.0,0,0,0,0,0,0,0,2,0,0,2,1
2241,60736,c9pXHqWvBB8LbdUhG5A5ihiNKOhfyXDu,7GRhBDsirIGkRZBtSMEzNTyDr2JQm4xx,6,7,0,0,0,0,3,0,10,1.4285714285714286,3,0.0,0,0,0,0,7,0,0,3,0,0,10,1
2242,60936,3bqMPd7dmQ6bVwYt9AjfxpDPMW8ppczj,7GRhBDsirIGkRZBtSMEzNTyDr2JQm4xx,4,2,1,0,1,1,1,0,6,0.8571428571428571,1,0.0,0,1,0,1,2,1,0,1,0,2,4,1
2243,60940,QVVTY0MAE22SN6rxHu950HeUm4kG0Wko,7GRhBDsirIGkRZBtSMEzNTyDr2JQm4xx,6,6,3,0,1,0,1,0,11,1.5714285714285714,1,0.0,0,3,0,1,6,0,0,1,0,4,7,1
2244,60941,GhWSz5WEMmds3hiXd5zoNrNGoNsN9LXL,7GRhBDsirIGkRZBtSMEzNTyDr2JQm4xx,14,14,6,0,4,1,12,1,38,5.428571428571429,2,0.0,5,6,0,4,9,1,0,12,1,15,23,1
2245,60960,hcKYo6bLhlANvHE0FxLuR4YY8jocfBwJ,7GRhBDsirIGkRZBtSMEzNTyDr2JQm4xx,1,0,0,0,0,0,1,0,1,0.14285714285714285,1,0.0,0,0,0,0,0,0,0,1,0,0,1,1
2246,60976,loY20pnf7suv2LWREXjC0h3XNawzaj7l,7GRhBDsirIGkRZBtSMEzNTyDr2JQm4xx,9,4,3,0,3,0,2,0,12,1.7142857142857142,1,0.0,0,3,0,3,4,0,0,2,0,6,6,1
2247,61001,KwMhn6xKDQ4sc6tWHQxhmw9vLZQikEKV,7GRhBDsirIGkRZBtSMEzNTyDr2JQm4xx,2,0,0,0,0,0,2,0,2,0.2857142857142857,1,0.0,0,0,0,0,0,0,0,2,0,0,2,1
2248,61039,RzKvPu4qwYnkKioYxIJem5I7hV4q5Zey,7GRhBDsirIGkRZBtSMEzNTyDr2JQm4xx,2,0,0,0,0,0,2,0,2,0.2857142857142857,1,0.0,0,0,0,0,0,0,0,2,0,0,2,0
2249,61087,GDHvw72iSHIz6VwsSteleP4praXBxk8h,7GRhBDsirIGkRZBtSMEzNTyDr2JQm4xx,18,42,1,12,0,8,1,0,64,9.142857142857142,1,0.0,22,1,6,0,20,8,6,1,0,29,35,1
2250,61130,v6Wfy2XnikKgnCNfehO3TIQzyPp7MzcN,7GRhBDsirIGkRZBtSMEzNTyDr2JQm4xx,2,0,0,0,0,0,2,0,2,0.2857142857142857,1,0.0,0,0,0,0,0,0,0,2,0,0,2,1
2251,61150,Z0pyF529vY6gfAXTUXYd2MCguE49KLJ7,7GRhBDsirIGkRZBtSMEzNTyDr2JQm4xx,2,0,0,0,0,0,4,0,4,0.5714285714285714,2,0.0,0,0,0,0,0,0,0,4,0,0,4,1
2252,61163,5HJHxaIfd0nCZcEUKuXJqPamaYk6aBtq,7GRhBDsirIGkRZBtSMEzNTyDr2JQm4xx,5,4,1,0,2,0,2,0,9,1.2857142857142858,1,0.0,2,1,0,2,2,0,0,2,0,5,4,1
2253,61200,Y3GsHv1t2an649bMll1LdxvN2SIICjxG,7GRhBDsirIGkRZBtSMEzNTyDr2JQm4xx,5,2,1,0,1,0,3,0,7,1.0,1,0.0,0,1,0,1,2,0,0,3,0,2,5,1
2254,61208,5REjJFENp7n9hcI3zWF81mKx1k4GQz67,7GRhBDsirIGkRZBtSMEzNTyDr2JQm4xx,12,11,1,12,0,5,7,0,36,5.142857142857143,2,0.0,10,1,6,0,1,5,6,7,0,17,19,1
2255,61235,qDUQ1iBvNWtXbHcBUbRaieW5ktYMRWE0,7GRhBDsirIGkRZBtSMEzNTyDr2JQm4xx,1,0,0,0,0,0,1,0,1,0.14285714285714285,1,0.0,0,0,0,0,0,0,0,1,0,0,1,1
2256,61609,0RRA0LeDh4nSJ7FMl9qY1fE7T0M4oANR,SpATywNh6bZuzm8s1ceuBUnMUAeoAHHw,17,11,7,17,4,0,9,0,48,6.857142857142857,2,0.0,2,7,15,4,9,0,2,9,0,28,20,0
2257,61675,gejGa8SAgjHkzsw2hD6p8TKYmXAjocFe,A3fsA9Zfv1X2fVEQhTw51lKENdNrEqT3,14,10,6,0,6,0,3,0,25,3.5714285714285716,1,0.0,0,6,0,6,10,0,0,3,0,12,13,1
2258,61713,MYsCU1zkMrWxPhV1b7wSL5LZIo1zGyhU,bWdj2GDclj5ofokWjzoa5jAwMkxCykd6,15,13,10,0,7,0,2,0,32,4.571428571428571,1,0.0,1,10,0,7,12,0,0,2,0,18,14,0
2259,61740,I9yi1jZjIznCPzP5fpMJEhPDMiUaetUu,SpATywNh6bZuzm8s1ceuBUnMUAeoAHHw,21,28,17,15,4,55,8,3,130,18.571428571428573,1,0.0,4,17,12,4,24,55,3,8,3,37,93,0
2260,61744,l30g3WB045lPyRkHzrw7l9v0SYLqOMWO,SpATywNh6bZuzm8s1ceuBUnMUAeoAHHw,6,20,8,0,3,1,5,0,37,5.285714285714286,1,0.0,0,8,0,3,20,1,0,5,0,11,26,0
2261,61745,ZQ6y2Bmw7qT9LD8jxMjYzUpaHRmpaQsM,A3fsA9Zfv1X2fVEQhTw51lKENdNrEqT3,4,2,0,0,0,0,3,0,5,0.7142857142857143,1,0.0,0,0,0,0,2,0,0,3,0,0,5,0
2262,61801,2we3WxltFBT1dd0FjP3YZ8iHf2xpHEei,SpATywNh6bZuzm8s1ceuBUnMUAeoAHHw,16,17,8,8,5,0,2,0,40,5.714285714285714,2,0.0,2,8,7,5,15,0,1,2,0,22,18,1
2263,61837,2yFrrfFKwmpyH7xPcC8i0UYFZJHtjntf,SpATywNh6bZuzm8s1ceuBUnMUAeoAHHw,14,14,6,23,3,0,2,0,48,6.857142857142857,1,0.0,3,6,18,3,11,0,5,2,0,30,18,0
2264,61916,XDPvGyFLLEYwbNEQik2MM4yiADs5rrYJ,A3fsA9Zfv1X2fVEQhTw51lKENdNrEqT3,5,5,2,0,1,0,2,0,10,1.4285714285714286,1,0.0,1,2,0,1,4,0,0,2,0,4,6,0
2265,61934,8dPQDWD7NMlHSztQh4Fh3dqPVx6xptft,SpATywNh6bZuzm8s1ceuBUnMUAeoAHHw,4,2,1,0,0,0,3,0,6,0.8571428571428571,2,0.0,0,1,0,0,2,0,0,3,0,1,5,0
2266,61941,aJMNcTer76nTaYZZR58xtdmLr8BYq1Op,bWdj2GDclj5ofokWjzoa5jAwMkxCykd6,4,2,1,0,1,0,1,0,5,0.7142857142857143,1,0.0,0,1,0,1,2,0,0,1,0,2,3,0
2267,61977,XupxNoKQxp2aAQkFy5RiZK4Yl6Wd1tRi,SpATywNh6bZuzm8s1ceuBUnMUAeoAHHw,9,21,3,0,3,0,5,0,32,4.571428571428571,4,0.0,0,3,0,3,21,0,0,5,0,6,26,0
2268,62011,vPv7PsanhRceiGshTPXtgrOmcrOEYM8O,SpATywNh6bZuzm8s1ceuBUnMUAeoAHHw,17,11,8,1,5,0,2,0,27,3.857142857142857,2,0.0,0,8,1,5,11,0,0,2,0,14,13,1
2269,62072,VWEcCKiwp28lQZuBYYNslDL0523gk0Z6,SpATywNh6bZuzm8s1ceuBUnMUAeoAHHw,8,7,5,0,3,0,2,0,17,2.4285714285714284,2,0.0,0,5,0,3,7,0,0,2,0,8,9,0
2270,62235,2cdJoONM7ugDmkPkQHwnxWZwEOIANTXn,SpATywNh6bZuzm8s1ceuBUnMUAeoAHHw,10,28,15,0,1,25,14,1,84,12.0,4,0.0,0,15,0,1,28,25,0,14,1,16,68,0
2271,62290,FAyKTlOaLRLHiyLG5PXQhYddpdx56j0F,SpATywNh6bZuzm8s1ceuBUnMUAeoAHHw,7,8,6,0,0,0,2,0,16,2.2857142857142856,1,0.0,0,6,0,0,8,0,0,2,0,6,10,0
2272,62305,jFuORSL1URM2oqg9zp9eOfHmKoYyUgBh,SpATywNh6bZuzm8s1ceuBUnMUAeoAHHw,16,15,7,12,4,0,1,0,39,5.571428571428571,1,0.0,3,7,11,4,12,0,1,1,0,25,14,1
2273,62392,FLIojen7fff3GhtDNtEDgYWfLgv0g8w4,A3fsA9Zfv1X2fVEQhTw51lKENdNrEqT3,1,0,0,0,0,0,1,0,1,0.14285714285714285,1,0.0,0,0,0,0,0,0,0,1,0,0,1,1
2274,62516,l7f4vHvlZkxCYoU9qM63V45bmndBSeZQ,A3fsA9Zfv1X2fVEQhTw51lKENdNrEqT3,5,3,2,4,0,0,2,0,11,1.5714285714285714,1,0.0,0,2,4,0,3,0,0,2,0,6,5,1
2275,62571,E96VmAw6m1AOHRckdqiq2ASKbnHBlpAb,SpATywNh6bZuzm8s1ceuBUnMUAeoAHHw,14,17,8,6,3,4,4,0,42,6.0,3,0.0,5,8,6,3,12,4,0,4,0,22,20,0
2276,62578,Q11HqpDxrpVz5YMzRCx4zOr85dBot8E5,A3fsA9Zfv1X2fVEQhTw51lKENdNrEqT3,8,2,0,0,0,2,8,0,12,1.7142857142857142,1,0.0,0,0,0,0,2,2,0,8,0,0,12,0
2277,62637,7PJjcgOQXwj0M6oz8Sxyd66Tvypm0TFY,SpATywNh6bZuzm8s1ceuBUnMUAeoAHHw,7,4,3,0,2,0,1,0,10,1.4285714285714286,1,0.0,0,3,0,2,4,0,0,1,0,5,5,0
2278,62685,xhufFs72rOwOGZDYtQtHTXdheNyqrUTX,SpATywNh6bZuzm8s1ceuBUnMUAeoAHHw,4,9,4,0,0,0,11,0,24,3.4285714285714284,4,0.0,0,4,0,0,9,0,0,11,0,4,20,0
2279,62739,CaM5OJ40UpPm5AoorpoNghXDZnct2Zfn,SpATywNh6bZuzm8s1ceuBUnMUAeoAHHw,20,21,9,14,5,11,5,1,66,9.428571428571429,1,0.0,10,9,13,5,11,11,1,5,1,37,29,1
2280,62764,XsK920toyXvpWwNS6lvZzDVJcrgCTFKd,SpATywNh6bZuzm8s1ceuBUnMUAeoAHHw,3,2,1,0,0,0,1,0,4,0.5714285714285714,1,0.0,0,1,0,0,2,0,0,1,0,1,3,0
2281,62805,LJYBef7iIBiSZz8D7KTtMTsdkyd91gnR,A3fsA9Zfv1X2fVEQhTw51lKENdNrEqT3,7,6,3,0,2,0,4,0,15,2.142857142857143,2,0.0,0,3,0,2,6,0,0,4,0,5,10,1
2282,62809,EEgHvStGR7XKoMKoPOCBxkxFHcb7UdMh,SpATywNh6bZuzm8s1ceuBUnMUAeoAHHw,3,2,1,0,0,0,3,0,6,0.8571428571428571,2,0.0,0,1,0,0,2,0,0,3,0,1,5,0
2283,62813,reVwvLtud5XxET1iG7iTTQOqQC7njl8h,SpATywNh6bZuzm8s1ceuBUnMUAeoAHHw,7,4,2,5,1,0,2,0,14,2.0,1,0.0,1,2,5,1,3,0,0,2,0,9,5,0
2284,62837,k4ieA0VLPLUG1GV8FhtBGpWAykZRhHXI,7GRhBDsirIGkRZBtSMEzNTyDr2JQm4xx,30,99,38,90,24,2,5,0,258,36.857142857142854,4,0.0,57,38,79,24,42,2,11,5,0,198,60,1
2285,62903,6WyBLtTebYxWs237cTFazhrWvguV9PiM,7GRhBDsirIGkRZBtSMEzNTyDr2JQm4xx,31,43,0,135,3,0,1,0,182,26.0,1,0.0,16,0,121,3,27,0,14,1,0,140,42,1
2286,62913,VnWhM3BeDRhDK8eiBuMGZHGyfJnGv0sM,SpATywNh6bZuzm8s1ceuBUnMUAeoAHHw,15,18,1,15,0,0,5,0,39,5.571428571428571,2,0.0,2,1,15,0,16,0,0,5,0,18,21,1
2287,62957,iugl3Rn3u1ci3BiC2tfekDHOQsD5QVGj,bWdj2GDclj5ofokWjzoa5jAwMkxCykd6,20,51,32,59,5,44,20,2,213,30.428571428571427,3,0.0,3,32,52,5,48,44,7,20,2,92,121,0
2288,62975,fV0W6675p3fpyY1tGNGM2NdIFpKgGWLW,SpATywNh6bZuzm8s1ceuBUnMUAeoAHHw,5,0,0,0,0,1,5,0,6,0.8571428571428571,1,0.0,0,0,0,0,0,1,0,5,0,0,6,0
2289,63126,8nlNDsWSaxHCvsMKtqhBs81sknEiTCeb,bWdj2GDclj5ofokWjzoa5jAwMkxCykd6,42,35,17,104,13,0,6,0,175,25.0,4,0.0,13,17,80,13,22,0,24,6,0,123,52,0
2290,63128,5uO2cAopKsWa3VCKCGDarnhTzdurYycs,SpATywNh6bZuzm8s1ceuBUnMUAeoAHHw,1,0,0,0,0,0,1,0,1,0.14285714285714285,1,0.0,0,0,0,0,0,0,0,1,0,0,1,0
2291,63158,U24ZSbLp0qd6U36m7tKLx7zFvStnoEpw,A3fsA9Zfv1X2fVEQhTw51lKENdNrEqT3,9,4,3,0,3,0,2,0,12,1.7142857142857142,1,0.0,0,3,0,3,4,0,0,2,0,6,6,1
2292,63165,lECqbqrkQ3HlfeNWRN0jqJEeRHxVUCOh,A3fsA9Zfv1X2fVEQhTw51lKENdNrEqT3,43,17,14,84,12,0,1,0,128,18.285714285714285,2,0.0,2,14,68,12,15,0,16,1,0,96,32,1
2293,63233,MvNnLQma2eBM9bCcMIR159XYSNp8VREs,A3fsA9Zfv1X2fVEQhTw51lKENdNrEqT3,73,32,24,167,17,31,9,0,280,40.0,4,0.0,4,24,130,17,28,31,37,9,0,175,105,0
2294,63541,kq2xSgp8UyUnYWtPUU1dLGJ6LLqx20W2,A3fsA9Zfv1X2fVEQhTw51lKENdNrEqT3,11,10,6,0,3,0,6,0,25,3.5714285714285716,1,0.0,1,6,0,3,9,0,0,6,0,10,15,0
2295,63571,EwaALzeaojV7pPZOsHFx7jzB7xjVDGvQ,A3fsA9Zfv1X2fVEQhTw51lKENdNrEqT3,25,8,0,84,0,0,6,0,98,14.0,1,0.0,1,0,68,0,7,0,16,6,0,69,29,1
2296,63583,CLsYy7g1hYWHJyj1aROfKK9oTeo5yxJx,7GRhBDsirIGkRZBtSMEzNTyDr2JQm4xx,13,19,2,4,5,0,2,0,32,4.571428571428571,1,0.0,10,2,4,5,9,0,0,2,0,21,11,1
2297,64025,VmlXkvuP00sXBlaPmnRadtsHqWz5E4fz,7GRhBDsirIGkRZBtSMEzNTyDr2JQm4xx,39,175,35,58,18,8,11,0,305,43.57142857142857,5,0.0,81,35,45,18,94,8,13,11,0,179,126,0
2298,64036,4dC723f2ZXGHBwWoh8xH8B5ftd5Zr0Rn,A3fsA9Zfv1X2fVEQhTw51lKENdNrEqT3,5,4,1,0,1,0,2,0,8,1.1428571428571428,2,0.0,0,1,0,1,4,0,0,2,0,2,6,1
2299,64177,SSM7wEvdZo8FZW0zxJcXGwdA1S6Vbn5Q,A3fsA9Zfv1X2fVEQhTw51lKENdNrEqT3,21,15,12,0,9,0,3,0,39,5.571428571428571,2,0.0,0,12,0,9,15,0,0,3,0,21,18,1
2300,65688,EP1XQRGS4HZOG1hdGzNZdD1HFhJcHpos,7GRhBDsirIGkRZBtSMEzNTyDr2JQm4xx,1,0,0,0,0,0,1,0,1,0.14285714285714285,1,0.0,0,0,0,0,0,0,0,1,0,0,1,1
2301,65717,Qp3BNNi2PRh8N3k7qOPk9z3KeApis9gf,7GRhBDsirIGkRZBtSMEzNTyDr2JQm4xx,8,2,1,0,1,2,5,0,11,1.5714285714285714,1,0.0,0,1,0,1,2,2,0,5,0,2,9,1
2302,65731,rsQSljy58PFsI3No6cbIG6iDQtqQAtCs,7GRhBDsirIGkRZBtSMEzNTyDr2JQm4xx,1,0,0,0,0,0,1,0,1,0.14285714285714285,1,0.0,0,0,0,0,0,0,0,1,0,0,1,1
2303,65788,aszS4GIQTgIfNXx5jr5Ct6AzWRVtVT5s,7GRhBDsirIGkRZBtSMEzNTyDr2JQm4xx,16,19,7,19,7,0,1,0,53,7.571428571428571,4,0.0,8,7,17,7,11,0,2,1,0,39,14,1
2304,65790,ee5z0tJLP6Khk8QhqHWb5RZbzlS7e0OS,7GRhBDsirIGkRZBtSMEzNTyDr2JQm4xx,1,0,0,0,0,0,1,0,1,0.14285714285714285,1,0.0,0,0,0,0,0,0,0,1,0,0,1,1
2305,65802,60AdiK8bE6l0acvscYCimI00NJzONtxh,7GRhBDsirIGkRZBtSMEzNTyDr2JQm4xx,13,10,0,4,0,0,3,1,18,2.5714285714285716,1,0.0,2,0,2,0,8,0,2,3,1,4,14,1
2306,65812,h0zdkMb61woGfNMOXfs3Ua8AU5wIq6lQ,7GRhBDsirIGkRZBtSMEzNTyDr2JQm4xx,1,0,0,0,0,0,1,0,1,0.14285714285714285,1,0.0,0,0,0,0,0,0,0,1,0,0,1,1
2307,65830,MolmRPAkFPlZY7OScpgwiUUkM3K4fMlt,7GRhBDsirIGkRZBtSMEzNTyDr2JQm4xx,28,57,26,18,20,3,12,0,136,19.428571428571427,4,0.0,20,26,13,20,37,3,5,12,0,79,57,0
2308,65865,GR3SserD0hZUoJkJpGFDq48sIZDvaFeW,7GRhBDsirIGkRZBtSMEzNTyDr2JQm4xx,8,7,0,2,1,0,4,0,14,2.0,2,0.0,3,0,1,1,4,0,1,4,0,5,9,1
2309,65923,RoVG0kiFP0OBGlNfg8NpT0lrHhQWFVjU,7GRhBDsirIGkRZBtSMEzNTyDr2JQm4xx,51,63,27,70,34,1,5,0,200,28.571428571428573,2,0.0,35,27,54,34,28,1,16,5,0,150,50,1
2310,65973,aIukhaeMXO0Xpo45YRTaW0ARdMHoLnbr,7GRhBDsirIGkRZBtSMEzNTyDr2JQm4xx,7,2,1,0,1,4,4,1,13,1.8571428571428572,1,0.0,0,1,0,1,2,4,0,4,1,2,11,1
2311,66551,fkrSqTHnPEweVdPiAW6RgeMJZWZWaXQt,G8EPVSXsOYB5YQWZGiz1aVq5Pgr2GrQu,7,2,2,0,2,0,2,0,8,1.1428571428571428,1,0.0,0,2,0,2,2,0,0,2,0,4,4,0
2312,66558,z6Xzy59qUrOr9kg6qBkR4Bly4uQ6Qoy2,SpATywNh6bZuzm8s1ceuBUnMUAeoAHHw,3,2,1,0,0,0,1,0,4,0.5714285714285714,1,0.0,0,1,0,0,2,0,0,1,0,1,3,1
2313,66570,MpNfjrXai4aLf7BfVSQwZSS0DPolU3oZ,RXDvfPUBYFlVdlueBFbLW0mhhAyGEqpt,5,6,4,0,2,0,2,0,14,2.0,2,0.0,0,4,0,2,6,0,0,2,0,6,8,0
2314,66594,Jkvg2vrMG0bsI6gC4CJJwz6mYReBwqyD,bWdj2GDclj5ofokWjzoa5jAwMkxCykd6,4,4,2,0,0,0,1,0,7,1.0,1,0.0,0,2,0,0,4,0,0,1,0,2,5,1
2315,66606,yceNLUK4FCR6SZUYW0W0TAVYCfKl5jP6,SpATywNh6bZuzm8s1ceuBUnMUAeoAHHw,8,12,0,10,0,0,4,0,26,3.7142857142857144,1,0.0,2,0,10,0,10,0,0,4,0,12,14,1
2316,66633,tuzr7UEFeueCuu7trKtH12YoCRZa4u3J,SpATywNh6bZuzm8s1ceuBUnMUAeoAHHw,21,31,16,8,9,0,7,0,71,10.142857142857142,2,0.0,8,16,8,9,23,0,0,7,0,41,30,1
2317,66642,7i6uHx2i3AcAV22o4Aq16TZJzUL7SbJ8,SpATywNh6bZuzm8s1ceuBUnMUAeoAHHw,5,3,1,0,1,0,1,0,6,0.8571428571428571,1,0.0,0,1,0,1,3,0,0,1,0,2,4,0
2318,66649,Gmz5iMjiwcyTx4KusyWM0rOecmUutZaf,RXDvfPUBYFlVdlueBFbLW0mhhAyGEqpt,23,15,10,35,5,0,2,0,67,9.571428571428571,1,0.0,4,10,33,5,11,0,2,2,0,52,15,0
2319,66724,cWGbfR2Lw2D62YH4zDUtSEtnjy8NlUpm,SpATywNh6bZuzm8s1ceuBUnMUAeoAHHw,4,2,1,0,0,0,2,0,5,0.7142857142857143,1,0.0,0,1,0,0,2,0,0,2,0,1,4,1
2320,66735,BF8BUQGTWJSC3An0NoOdiFsCvGqN90lp,SpATywNh6bZuzm8s1ceuBUnMUAeoAHHw,6,4,3,0,1,0,1,0,9,1.2857142857142858,1,0.0,0,3,0,1,4,0,0,1,0,4,5,1
2321,66748,IGtuwcXa7Vvuptxp2yP0y7DMlNgXBbkF,SpATywNh6bZuzm8s1ceuBUnMUAeoAHHw,8,8,6,0,0,0,1,0,15,2.142857142857143,1,0.0,1,6,0,0,7,0,0,1,0,7,8,1
2322,66761,jZW7RSw8d3NHdCMzGR4TAiNXCrcYo90E,SpATywNh6bZuzm8s1ceuBUnMUAeoAHHw,9,11,3,18,1,0,1,0,34,4.857142857142857,1,0.0,7,3,18,1,4,0,0,1,0,29,5,0
2323,66771,DSoedfH3iEqkDSoEfnR9hPK9fGA03nvE,SpATywNh6bZuzm8s1ceuBUnMUAeoAHHw,6,3,2,0,1,3,2,0,11,1.5714285714285714,1,0.0,0,2,0,1,3,3,0,2,0,3,8,1
2324,66831,grwjhoAI1dEZsOpkE7fbBAVHWaIfQbiU,SpATywNh6bZuzm8s1ceuBUnMUAeoAHHw,6,8,5,0,4,0,0,0,17,2.4285714285714284,1,0.0,0,5,0,4,8,0,0,0,0,9,8,1
2325,66973,AtBEE9J055aDlITLvmg36iywfRw9ii2d,SpATywNh6bZuzm8s1ceuBUnMUAeoAHHw,10,5,4,0,3,0,2,0,14,2.0,1,0.0,0,4,0,3,5,0,0,2,0,7,7,1
2326,67034,yZ9FndAKqVsKwZtO1B2JJJblefdbhZ02,SpATywNh6bZuzm8s1ceuBUnMUAeoAHHw,1,0,0,0,0,0,1,0,1,0.14285714285714285,1,0.0,0,0,0,0,0,0,0,1,0,0,1,0
2327,67077,wDMKq3Xvq95ERd20zjEMEb0BtCbHx7BM,SpATywNh6bZuzm8s1ceuBUnMUAeoAHHw,4,2,0,0,0,0,6,0,8,1.1428571428571428,3,0.0,0,0,0,0,2,0,0,6,0,0,8,0
2328,67080,CgsguvEs0KUN3Abw9Qjh5ZZT0chwXUSw,SpATywNh6bZuzm8s1ceuBUnMUAeoAHHw,19,31,15,16,4,142,4,0,212,30.285714285714285,1,0.0,12,15,16,4,19,142,0,4,0,47,165,0
2329,67104,8IdT3BpziJuUIg1uIZIVpj0NWmeXuSS8,G8EPVSXsOYB5YQWZGiz1aVq5Pgr2GrQu,7,5,1,2,1,0,1,0,10,1.4285714285714286,1,0.0,1,1,1,1,4,0,1,1,0,4,6,1
2330,67111,KOlp6BtLHFtxPjNN0KYQVjD6WvIwSYtA,SpATywNh6bZuzm8s1ceuBUnMUAeoAHHw,3,2,0,0,0,0,2,0,4,0.5714285714285714,1,0.0,0,0,0,0,2,0,0,2,0,0,4,0
2331,67128,dL3mb41Bm8AhTujPtToBfgUCEqTQ4yms,G8EPVSXsOYB5YQWZGiz1aVq5Pgr2GrQu,8,7,0,0,0,0,1,0,8,1.1428571428571428,1,0.0,0,0,0,0,7,0,0,1,0,0,8,1
2332,67133,iU8sg5PBq7mTADvs0COG4jXH4nM6hq2B,SpATywNh6bZuzm8s1ceuBUnMUAeoAHHw,3,4,1,0,0,5,3,0,13,1.8571428571428572,2,0.0,0,1,0,0,4,5,0,3,0,1,12,1
2333,67158,07nBIjV5wvxeipK7Zz3uxWH8hv0V5VvH,SpATywNh6bZuzm8s1ceuBUnMUAeoAHHw,3,2,1,0,0,0,1,0,4,0.5714285714285714,1,0.0,0,1,0,0,2,0,0,1,0,1,3,0
2334,67195,MPLO46zeqSAmGFkKKuWvnx6pcJItRavU,SpATywNh6bZuzm8s1ceuBUnMUAeoAHHw,8,4,2,0,0,4,6,5,21,3.0,1,0.0,1,2,0,0,3,4,0,6,5,3,18,0
2335,67213,IHjTTbtSKJcagLP8HZiMzotl9tnHf7ev,SpATywNh6bZuzm8s1ceuBUnMUAeoAHHw,13,17,8,0,3,0,10,0,38,5.428571428571429,2,0.0,0,8,0,3,17,0,0,10,0,11,27,0
2336,67262,4hqkXkyq5mjsuNE9t6Q3zzOu4OQAJfqm,SpATywNh6bZuzm8s1ceuBUnMUAeoAHHw,5,3,2,0,1,0,1,0,7,1.0,1,0.0,0,2,0,1,3,0,0,1,0,3,4,1
2337,67266,X0qiYFDfIWOz74gDCjJtjtlJKUHThKgm,SpATywNh6bZuzm8s1ceuBUnMUAeoAHHw,1,0,0,0,0,0,1,0,1,0.14285714285714285,1,0.0,0,0,0,0,0,0,0,1,0,0,1,0
2338,67328,HurK028hfari9vlQzhAchljjKEaGMu7l,SpATywNh6bZuzm8s1ceuBUnMUAeoAHHw,1,0,0,0,0,0,1,0,1,0.14285714285714285,1,0.0,0,0,0,0,0,0,0,1,0,0,1,1
2339,67424,kuV8TXv5cFVPIWK37fDR8nnl0vrHyjjA,RXDvfPUBYFlVdlueBFbLW0mhhAyGEqpt,5,4,1,0,1,0,1,0,7,1.0,1,0.0,1,1,0,1,3,0,0,1,0,3,4,0
2340,67427,vS0PO2z5tTpDl1S200qdqNDkFjNmdjxd,G8EPVSXsOYB5YQWZGiz1aVq5Pgr2GrQu,22,12,10,0,9,0,1,0,32,4.571428571428571,1,0.0,0,10,0,9,12,0,0,1,0,19,13,1
2341,67435,gK0C2Qn10uFCDrXyxIuukzeUErx51I1a,SpATywNh6bZuzm8s1ceuBUnMUAeoAHHw,1,0,0,0,0,0,1,0,1,0.14285714285714285,1,0.0,0,0,0,0,0,0,0,1,0,0,1,0
2342,67437,H1gNXDemnE2i9lW82GrGfdWk3AATsmHy,SpATywNh6bZuzm8s1ceuBUnMUAeoAHHw,19,21,8,6,5,2,5,2,49,7.0,1,0.0,5,8,6,5,16,2,0,5,2,24,25,0
2343,67444,Cow0Edw3V8JD4s2oOxNrhyd18ZVv78TG,SpATywNh6bZuzm8s1ceuBUnMUAeoAHHw,12,15,6,7,3,0,1,0,32,4.571428571428571,1,0.0,5,6,6,3,10,0,1,1,0,20,12,1
2344,67445,Q9jQ2QVFcDk6rCEN1ap0bZmI7VqzGuqs,SpATywNh6bZuzm8s1ceuBUnMUAeoAHHw,16,29,5,12,3,3,4,0,56,8.0,1,0.0,10,5,10,3,19,3,2,4,0,28,28,0
2345,67454,7KhKGJPxu4uQKYHNs7O3NjmuTH6NjrVY,bWdj2GDclj5ofokWjzoa5jAwMkxCykd6,4,8,3,0,0,1,8,0,20,2.857142857142857,2,0.0,0,3,0,0,8,1,0,8,0,3,17,0
2346,67464,uBWT9p90Ea0JVvR5wbRV9EQLPt0ehYR1,SpATywNh6bZuzm8s1ceuBUnMUAeoAHHw,4,2,0,0,0,0,3,0,5,0.7142857142857143,1,0.0,0,0,0,0,2,0,0,3,0,0,5,1
2347,67510,9by6FuLW9p6hAe2x8b5HjrOAjJeqk2av,SpATywNh6bZuzm8s1ceuBUnMUAeoAHHw,17,11,7,6,4,0,2,0,30,4.285714285714286,1,0.0,3,7,6,4,8,0,0,2,0,20,10,0
2348,67566,tYJFbmbzeY9dNgPSZvFhNskxnqvhh3AK,SpATywNh6bZuzm8s1ceuBUnMUAeoAHHw,19,14,11,10,7,4,5,0,51,7.285714285714286,2,0.0,2,11,9,7,12,4,1,5,0,29,22,0
2349,67589,PiJ3gX6gddDaZL8DcE6EIcui1JUSTcfU,SpATywNh6bZuzm8s1ceuBUnMUAeoAHHw,8,7,6,0,4,0,1,0,18,2.5714285714285716,1,0.0,0,6,0,4,7,0,0,1,0,10,8,1
2350,67594,MwsjD881hF2KUCEG3rXUPSq3GKMfMo2d,SpATywNh6bZuzm8s1ceuBUnMUAeoAHHw,3,2,1,0,0,0,1,0,4,0.5714285714285714,1,0.0,0,1,0,0,2,0,0,1,0,1,3,0
2351,67655,tkE1JI2oJkZLA1XOzEZ3Jn8IFDQS4QJ9,G8EPVSXsOYB5YQWZGiz1aVq5Pgr2GrQu,19,18,6,22,0,0,1,0,47,6.714285714285714,1,0.0,10,6,13,0,8,0,9,1,0,29,18,0
2352,67690,nPRsjektHdbQkeAf1fIK4JbhrESPbPsA,G8EPVSXsOYB5YQWZGiz1aVq5Pgr2GrQu,11,13,1,8,1,0,1,0,24,3.4285714285714284,1,0.0,6,1,5,1,7,0,3,1,0,13,11,0
2353,67710,zDAtaSKsAJQmmJ6xHQBbAGN68vDebyev,SpATywNh6bZuzm8s1ceuBUnMUAeoAHHw,9,7,0,30,0,0,2,0,39,5.571428571428571,1,0.0,2,0,30,0,5,0,0,2,0,32,7,0
2354,67796,X2XXZYuDF6JxTO2GjiNfzkEyj4FQesn5,SpATywNh6bZuzm8s1ceuBUnMUAeoAHHw,17,10,5,10,4,0,6,2,37,5.285714285714286,3,0.0,5,5,10,4,5,0,0,6,2,24,13,0
2355,67820,opdILbT2IBFIYJvyIT5NXM7ymKeuMTcM,SpATywNh6bZuzm8s1ceuBUnMUAeoAHHw,15,15,11,0,7,0,6,0,39,5.571428571428571,4,0.0,2,11,0,7,13,0,0,6,0,20,19,0
2356,67845,ndNZsN4dzAawDolPqzrjn2BmwgSJmFEf,bWdj2GDclj5ofokWjzoa5jAwMkxCykd6,5,1,0,0,1,0,3,0,5,0.7142857142857143,1,0.0,0,0,0,1,1,0,0,3,0,1,4,1
2357,67853,oseHKim5ugRciFh8lXIQ174blllPPfFO,SpATywNh6bZuzm8s1ceuBUnMUAeoAHHw,3,4,2,0,0,0,4,0,10,1.4285714285714286,2,0.0,0,2,0,0,4,0,0,4,0,2,8,0
2358,67867,YJjGstHCH0jRUJlDUc92oNrPq0d0Zijd,SpATywNh6bZuzm8s1ceuBUnMUAeoAHHw,18,25,14,9,5,0,5,0,58,8.285714285714286,3,0.0,6,14,9,5,19,0,0,5,0,34,24,1
2359,67897,yKgKNljfs8EwbfiKqNgGPLaIDdrvaFSp,SpATywNh6bZuzm8s1ceuBUnMUAeoAHHw,7,11,3,0,0,0,2,0,16,2.2857142857142856,1,0.0,0,3,0,0,11,0,0,2,0,3,13,0
2360,67942,PXSCTSolyT6nzbTsv2Nsca26yVAoeW5q,SpATywNh6bZuzm8s1ceuBUnMUAeoAHHw,13,14,5,18,1,3,5,1,47,6.714285714285714,1,0.0,8,5,15,1,6,3,3,5,1,29,18,0
2361,67961,TauShxFiSmmTBchoFAIoZD1cYw24SbpR,SpATywNh6bZuzm8s1ceuBUnMUAeoAHHw,13,25,0,17,0,3,10,0,55,7.857142857142857,2,0.0,7,0,15,0,18,3,2,10,0,22,33,1
2362,68017,Ea76prVlgHXbifiTXOy9yoJBa7oRFv41,SpATywNh6bZuzm8s1ceuBUnMUAeoAHHw,3,2,0,0,0,0,1,0,3,0.42857142857142855,1,0.0,0,0,0,0,2,0,0,1,0,0,3,1
2363,68019,c4Lb4MH2H2BBD2Eny5diwcURGPUNIr88,G8EPVSXsOYB5YQWZGiz1aVq5Pgr2GrQu,14,13,4,14,2,0,0,0,33,4.714285714285714,1,0.0,9,4,7,2,4,0,7,0,0,22,11,1
2364,68021,YxdX3NPpzVJ59dpoBODWSD8Noi3lkajj,G8EPVSXsOYB5YQWZGiz1aVq5Pgr2GrQu,64,59,46,158,23,0,12,0,298,42.57142857142857,5,0.0,2,46,128,23,57,0,30,12,0,199,99,0
2365,68049,EBHdi8xR8rUEs7i0QRogmtFZNO8JeTy8,SpATywNh6bZuzm8s1ceuBUnMUAeoAHHw,1,0,0,0,0,0,1,0,1,0.14285714285714285,1,0.0,0,0,0,0,0,0,0,1,0,0,1,1
2366,68051,CORJXNhWUR52sdjQNNf8qLspXXnCgswJ,SpATywNh6bZuzm8s1ceuBUnMUAeoAHHw,20,28,8,18,4,8,12,3,81,11.571428571428571,1,0.0,15,8,15,4,13,8,3,12,3,42,39,0
2367,68058,8qyr4gmatx7C6lBFbhpf1S75SesVpGhm,SpATywNh6bZuzm8s1ceuBUnMUAeoAHHw,3,2,1,0,0,0,3,0,6,0.8571428571428571,2,0.0,0,1,0,0,2,0,0,3,0,1,5,0
2368,68181,wCP7MM6FfvdZx8uOqp7AG8m1oFJcqLHB,SpATywNh6bZuzm8s1ceuBUnMUAeoAHHw,3,4,2,0,0,0,2,0,8,1.1428571428571428,2,0.0,0,2,0,0,4,0,0,2,0,2,6,1
2369,68194,3F9rh0xtO3MPjBfGcFPCm9PRbwYuY4I3,SpATywNh6bZuzm8s1ceuBUnMUAeoAHHw,7,5,0,13,0,6,2,0,26,3.7142857142857144,1,0.0,2,0,12,0,3,6,1,2,0,14,12,1
2370,68234,CR4gghlbM9RsvrMmN4aq9I8yiSZncbD8,SpATywNh6bZuzm8s1ceuBUnMUAeoAHHw,12,12,8,8,2,0,4,0,34,4.857142857142857,2,0.0,2,8,8,2,10,0,0,4,0,20,14,0
2371,68241,i2PPXz5Z5PB2ZfiVAI64TcWxYgJR1QQ1,RXDvfPUBYFlVdlueBFbLW0mhhAyGEqpt,21,10,9,12,5,6,4,1,47,6.714285714285714,1,0.0,0,9,11,5,10,6,1,4,1,25,22,1
2372,68252,5N9UtpTd0Iyfm1Amzky3t1R9JrMPidgw,SpATywNh6bZuzm8s1ceuBUnMUAeoAHHw,20,30,15,0,13,0,8,0,66,9.428571428571429,2,0.0,0,15,0,13,30,0,0,8,0,28,38,0
2373,68263,pbaQcU38LWlEY15kC2Yb0jdLNtMAYhsA,SpATywNh6bZuzm8s1ceuBUnMUAeoAHHw,15,28,14,14,6,0,1,0,63,9.0,3,0.0,8,14,13,6,20,0,1,1,0,41,22,0
2374,68273,1qOWHE2SxHYAOzNCTuiHl1kSZUHL0gyU,SpATywNh6bZuzm8s1ceuBUnMUAeoAHHw,16,24,9,12,0,0,9,0,54,7.714285714285714,2,0.0,11,9,12,0,13,0,0,9,0,32,22,0
2375,68296,b1g4AWG6A2zG5plnQY4paLSHRFnrgObC,G8EPVSXsOYB5YQWZGiz1aVq5Pgr2GrQu,6,5,1,0,0,1,2,0,9,1.2857142857142858,1,0.0,0,1,0,0,5,1,0,2,0,1,8,1
2376,68332,hJo1MgKiPZFXuH2ko6hqPTd9dbjMQKDO,SpATywNh6bZuzm8s1ceuBUnMUAeoAHHw,13,20,9,10,3,0,3,0,45,6.428571428571429,3,0.0,7,9,10,3,13,0,0,3,0,29,16,0
2377,68352,clbUGnOQsN7CuaV7idGJ2LVbYN3t8qC3,SpATywNh6bZuzm8s1ceuBUnMUAeoAHHw,14,17,1,8,1,0,3,0,30,4.285714285714286,3,0.0,4,1,8,1,13,0,0,3,0,14,16,0
2378,68379,b4M5OphEGf9HhlcR04bazUL6wKV8uIkU,G8EPVSXsOYB5YQWZGiz1aVq5Pgr2GrQu,1,0,0,0,0,0,2,0,2,0.2857142857142857,1,0.0,0,0,0,0,0,0,0,2,0,0,2,1
2379,68398,LNdimqsJkOxQDP9dT4IGwewg9YvH7zfV,SpATywNh6bZuzm8s1ceuBUnMUAeoAHHw,3,2,1,0,0,0,1,0,4,0.5714285714285714,1,0.0,0,1,0,0,2,0,0,1,0,1,3,1
2380,68399,TTmbjhCeX7YmnFUettVVam4HwYq17paa,SpATywNh6bZuzm8s1ceuBUnMUAeoAHHw,3,2,0,0,0,0,2,0,4,0.5714285714285714,1,0.0,0,0,0,0,2,0,0,2,0,0,4,0
2381,68412,0KxBv7TNEUj27dsp2zMGG4WpBswpgOyf,SpATywNh6bZuzm8s1ceuBUnMUAeoAHHw,7,8,5,5,0,0,2,0,20,2.857142857142857,2,0.0,0,5,5,0,8,0,0,2,0,10,10,0
2382,68494,yvCmfQ3z3fMLbjXX0h1AIIPVh4np9hhq,SpATywNh6bZuzm8s1ceuBUnMUAeoAHHw,4,2,1,0,0,0,3,0,6,0.8571428571428571,2,0.0,0,1,0,0,2,0,0,3,0,1,5,0
2383,68513,PRgLfGkxJHP58QbJdXg5l5vWjuJI88nv,SpATywNh6bZuzm8s1ceuBUnMUAeoAHHw,15,11,8,0,5,0,1,0,25,3.5714285714285716,1,0.0,2,8,0,5,9,0,0,1,0,15,10,1
2384,68543,kS5Tu2RHO9HzXMOZp3CUIdzW6Y8prRRh,SpATywNh6bZuzm8s1ceuBUnMUAeoAHHw,4,3,0,0,0,0,1,0,4,0.5714285714285714,1,0.0,0,0,0,0,3,0,0,1,0,0,4,1
2385,68544,neZ18tPUzdX2s40f6yVBysxDUKCDyzmG,SpATywNh6bZuzm8s1ceuBUnMUAeoAHHw,7,8,1,0,1,0,2,0,12,1.7142857142857142,1,0.0,0,1,0,1,8,0,0,2,0,2,10,0
2386,68563,8fwUYmiU3p577nM1EutDr5QOZIKfzBRc,RXDvfPUBYFlVdlueBFbLW0mhhAyGEqpt,9,6,4,0,1,10,4,1,26,3.7142857142857144,1,0.0,1,4,0,1,5,10,0,4,1,6,20,0
2387,68675,ZBFATksKEZIW0yZpEc4DInpubrEeq3eS,SpATywNh6bZuzm8s1ceuBUnMUAeoAHHw,4,4,1,0,0,0,0,0,5,0.7142857142857143,1,0.0,0,1,0,0,4,0,0,0,0,1,4,1
2388,68690,vsAcPV04LnM01WalbcA4jNxiuu2qNyeQ,SpATywNh6bZuzm8s1ceuBUnMUAeoAHHw,9,7,3,0,3,0,2,0,15,2.142857142857143,3,0.0,0,3,0,3,7,0,0,2,0,6,9,0
2389,68735,3JdonxNhNI9NQjhEwg0qbYv0wUomYvrC,SpATywNh6bZuzm8s1ceuBUnMUAeoAHHw,4,4,3,0,0,0,3,0,10,1.4285714285714286,1,0.0,0,3,0,0,4,0,0,3,0,3,7,1
2390,68742,kv6R7WjolUetaoWMs79hGLWsktu3yDdz,bWdj2GDclj5ofokWjzoa5jAwMkxCykd6,15,29,3,0,4,0,4,0,40,5.714285714285714,1,0.0,12,3,0,4,17,0,0,4,0,19,21,1
2391,68831,SmLgezr6vw2mXwO7w10XynKKHaO5xE5n,SpATywNh6bZuzm8s1ceuBUnMUAeoAHHw,1,0,0,0,0,0,1,0,1,0.14285714285714285,1,0.0,0,0,0,0,0,0,0,1,0,0,1,1
2392,68844,EleMlloryvuXR0G9AOtui0gfdXfrUQfc,SpATywNh6bZuzm8s1ceuBUnMUAeoAHHw,4,2,1,0,0,1,2,0,6,0.8571428571428571,1,0.0,0,1,0,0,2,1,0,2,0,1,5,1
2393,68957,03OlEjthtH7bdIcwtrFwO8IymW2gZt4t,SpATywNh6bZuzm8s1ceuBUnMUAeoAHHw,12,15,0,23,0,0,2,0,40,5.714285714285714,2,0.0,6,0,19,0,9,0,4,2,0,25,15,0
2394,68982,jvjNqoblvibp0tKoaV1BTGpJ4j9v7r5a,SpATywNh6bZuzm8s1ceuBUnMUAeoAHHw,6,6,1,0,1,0,4,0,12,1.7142857142857142,1,0.0,0,1,0,1,6,0,0,4,0,2,10,0
2395,69038,DanoP5XpHODQZmwuFGZgNKBiu5nY9yH1,A3fsA9Zfv1X2fVEQhTw51lKENdNrEqT3,4,5,2,0,0,0,2,0,9,1.2857142857142858,1,0.0,0,2,0,0,5,0,0,2,0,2,7,1
2396,69046,iOxekl9VdW2ENNqFsiAkjUDt6XuQIiCO,G8EPVSXsOYB5YQWZGiz1aVq5Pgr2GrQu,6,13,2,0,1,0,4,0,20,2.857142857142857,1,0.0,2,2,0,1,11,0,0,4,0,5,15,1
2397,69066,0a6HihupPBi4xpjolN637qOYG6WSN1Gx,SpATywNh6bZuzm8s1ceuBUnMUAeoAHHw,9,18,7,8,0,0,3,0,36,5.142857142857143,1,0.0,7,7,8,0,11,0,0,3,0,22,14,0
2398,69070,g5yKalRrHBvoyNkzpNTa67etQfVwykko,SpATywNh6bZuzm8s1ceuBUnMUAeoAHHw,3,5,5,0,2,2,0,0,14,2.0,3,0.0,0,5,0,2,5,2,0,0,0,7,7,0
2399,69076,cy1UxkAxcqJswFy9Syqm01bsE17PQcla,SpATywNh6bZuzm8s1ceuBUnMUAeoAHHw,18,30,17,15,6,10,15,0,93,13.285714285714286,5,0.0,3,17,12,6,27,10,3,15,0,38,55,0
2400,69087,sydTASQZF88RFtSW5G7BxBO6Hd5gV1Jf,A3fsA9Zfv1X2fVEQhTw51lKENdNrEqT3,39,34,15,90,10,2,6,1,158,22.571428571428573,1,0.0,5,15,72,10,29,2,18,6,1,102,56,1
2401,69130,pGYLDmhkSj1iBp1YljlDSId0XSrjZNZR,SpATywNh6bZuzm8s1ceuBUnMUAeoAHHw,1,0,0,0,0,0,1,0,1,0.14285714285714285,1,0.0,0,0,0,0,0,0,0,1,0,0,1,1
2402,69138,C5Rja3fyOmRxfpM2pXQmwA2G5rEfb320,SpATywNh6bZuzm8s1ceuBUnMUAeoAHHw,1,0,0,0,0,0,1,0,1,0.14285714285714285,1,0.0,0,0,0,0,0,0,0,1,0,0,1,1
2403,69179,WX5bge9EFbPypYuObEiSD1Gyvh8Z866G,A3fsA9Zfv1X2fVEQhTw51lKENdNrEqT3,7,6,3,0,1,0,2,0,12,1.7142857142857142,1,0.0,0,3,0,1,6,0,0,2,0,4,8,1
2404,69262,X9IKf8GgqS6dvoKX3VBo51mIr8yb4uFC,A3fsA9Zfv1X2fVEQhTw51lKENdNrEqT3,22,36,16,0,11,0,2,0,65,9.285714285714286,1,0.0,2,16,0,11,34,0,0,2,0,29,36,1
2405,69270,2XqSSCGvWuNVBTm3MCFePDMOSuloLKPQ,SpATywNh6bZuzm8s1ceuBUnMUAeoAHHw,1,1,0,0,0,0,0,0,1,0.14285714285714285,1,0.0,0,0,0,0,1,0,0,0,0,0,1,1
2406,69313,JZ8D07WpMQUIA2O2a3f2Q2gV7h70rqbC,SpATywNh6bZuzm8s1ceuBUnMUAeoAHHw,2,0,0,0,0,2,1,0,3,0.42857142857142855,1,0.0,0,0,0,0,0,2,0,1,0,0,3,1
2407,69346,4G8hhK38eDoUtZ2viIFKnYiWqmC4nF56,SpATywNh6bZuzm8s1ceuBUnMUAeoAHHw,18,23,1,10,0,0,1,0,35,5.0,1,0.0,6,1,10,0,17,0,0,1,0,17,18,1
2408,69439,WELjmgdsP962Pc1teJ96xvofKraKe6qa,A3fsA9Zfv1X2fVEQhTw51lKENdNrEqT3,1,0,0,0,0,0,1,0,1,0.14285714285714285,1,0.0,0,0,0,0,0,0,0,1,0,0,1,1
2409,69443,JnRbwXg3XGYAmOXQP1OiJxv44LsKYQS5,SpATywNh6bZuzm8s1ceuBUnMUAeoAHHw,3,4,0,0,0,0,3,0,7,1.0,2,0.0,0,0,0,0,4,0,0,3,0,0,7,0
2410,69466,DcPL5Zur8S33yRX2fv1HxqidGklhFV5P,SpATywNh6bZuzm8s1ceuBUnMUAeoAHHw,4,3,0,0,0,0,1,0,4,0.5714285714285714,1,0.0,0,0,0,0,3,0,0,1,0,0,4,1
2411,69477,FlAkKX6ow9SvOzk0dTWPWgnX5766zY29,G8EPVSXsOYB5YQWZGiz1aVq5Pgr2GrQu,10,8,5,2,2,0,1,0,18,2.5714285714285716,1,0.0,0,5,2,2,8,0,0,1,0,9,9,0
2412,69500,pNxcbeMWYcUZBxJCtPF9qmCQyBYd1bU7,SpATywNh6bZuzm8s1ceuBUnMUAeoAHHw,4,4,2,0,0,0,4,0,10,1.4285714285714286,2,0.0,0,2,0,0,4,0,0,4,0,2,8,1
2413,69682,DpqUZKEZpIFvZzvEXk8oaJMRAbEfypNN,A3fsA9Zfv1X2fVEQhTw51lKENdNrEqT3,1,0,0,0,0,0,1,0,1,0.14285714285714285,1,0.0,0,0,0,0,0,0,0,1,0,0,1,1
2414,69728,RGp0TGYq2GqXU0ffAofLYX0dCiUdIWSh,SpATywNh6bZuzm8s1ceuBUnMUAeoAHHw,3,2,1,0,0,0,2,0,5,0.7142857142857143,1,0.0,0,1,0,0,2,0,0,2,0,1,4,0
2415,69749,1mwVsEWRdpRYvoqkUN67uGNzTUomXEbQ,G8EPVSXsOYB5YQWZGiz1aVq5Pgr2GrQu,12,3,1,34,0,0,2,0,40,5.714285714285714,1,0.0,0,1,29,0,3,0,5,2,0,30,10,1
2416,69783,Nr4xgaqWlp3GY7Luca1HZwWSVTgxpORh,A3fsA9Zfv1X2fVEQhTw51lKENdNrEqT3,2,2,2,0,0,0,0,0,4,0.5714285714285714,2,0.0,0,2,0,0,2,0,0,0,0,2,2,0
2417,69809,j7794Az14TTh7tEEmhTpADHq4ipGllnd,SpATywNh6bZuzm8s1ceuBUnMUAeoAHHw,3,2,1,0,0,0,1,0,4,0.5714285714285714,1,0.0,0,1,0,0,2,0,0,1,0,1,3,0
2418,69811,RN9YqqNsHa7lmCtbb4sE8JmcbttJklXE,SpATywNh6bZuzm8s1ceuBUnMUAeoAHHw,5,3,1,0,1,0,1,0,6,0.8571428571428571,1,0.0,0,1,0,1,3,0,0,1,0,2,4,1
2419,69847,LyDM0yrwn8zKtQsuxEGqFMxdhffaZNVY,SpATywNh6bZuzm8s1ceuBUnMUAeoAHHw,7,4,1,0,1,0,2,0,8,1.1428571428571428,1,0.0,0,1,0,1,4,0,0,2,0,2,6,1
2420,69849,jSFXNgNICT3cTdtFY1qrRx06ncJbHNIL,SpATywNh6bZuzm8s1ceuBUnMUAeoAHHw,24,28,12,14,5,10,11,3,83,11.857142857142858,3,0.0,10,12,12,5,18,10,2,11,3,39,44,0
2421,69852,jGWjfQmpnKrCWFzIMxwjgnePo6w3vCLc,SpATywNh6bZuzm8s1ceuBUnMUAeoAHHw,7,9,5,0,2,0,4,0,20,2.857142857142857,1,0.0,0,5,0,2,9,0,0,4,0,7,13,1
2422,69856,SBz1G9CPNh7b1YKxwzjWQ2S8H7JkEfYW,SpATywNh6bZuzm8s1ceuBUnMUAeoAHHw,3,2,0,0,0,0,2,0,4,0.5714285714285714,1,0.0,0,0,0,0,2,0,0,2,0,0,4,0
2423,69879,T7hyLHRci3AaSKtnxgzZP9PZimkugFag,SpATywNh6bZuzm8s1ceuBUnMUAeoAHHw,13,9,6,10,3,0,2,0,30,4.285714285714286,1,0.0,2,6,10,3,7,0,0,2,0,21,9,1
2424,69886,C89edYjc0egHm9DK0UhG6TICXc3cgfYt,SpATywNh6bZuzm8s1ceuBUnMUAeoAHHw,5,5,1,0,1,0,1,0,8,1.1428571428571428,2,0.0,0,1,0,1,5,0,0,1,0,2,6,1
2425,69933,GRXlFzfh4xOjZLiMJPGMcltQGlQAKqSw,A3fsA9Zfv1X2fVEQhTw51lKENdNrEqT3,1,0,0,0,0,0,1,0,1,0.14285714285714285,1,0.0,0,0,0,0,0,0,0,1,0,0,1,0
2426,69975,xL2GGqHxlfngRtz8ATMPQBFRBvX6HArr,SpATywNh6bZuzm8s1ceuBUnMUAeoAHHw,7,7,4,0,0,5,14,2,32,4.571428571428571,2,0.0,0,4,0,0,7,5,0,14,2,4,28,0
2427,70006,wBxOvXavxcvDHQtsCbkdt1VRzmB8Qh9E,bWdj2GDclj5ofokWjzoa5jAwMkxCykd6,4,10,5,0,0,3,4,0,22,3.142857142857143,1,0.0,0,5,0,0,10,3,0,4,0,5,17,1
2428,70119,NXyco71N78GkVfHnZsK8R307XzQzXNS1,SpATywNh6bZuzm8s1ceuBUnMUAeoAHHw,6,4,3,0,1,0,1,0,9,1.2857142857142858,1,0.0,0,3,0,1,4,0,0,1,0,4,5,0
2429,70139,j4hecXKY3USBQpRwMuzKA9d9SPzBKhRY,bWdj2GDclj5ofokWjzoa5jAwMkxCykd6,20,18,12,0,8,4,5,0,47,6.714285714285714,2,0.0,0,12,0,8,18,4,0,5,0,20,27,1
2430,70363,u2uyYrsZ1NxMBxwWaoB6Ro03rTqsVsmy,fbPkOYLVPtPgIt0MxizjfFJov3JbHyAi,9,6,4,0,1,1,18,2,32,4.571428571428571,1,0.0,0,4,0,1,6,1,0,18,2,5,27,1
2431,70365,p48vWUMspFuVCwMv8mYFsyaHTRvcpcL8,fbPkOYLVPtPgIt0MxizjfFJov3JbHyAi,7,10,5,0,2,0,7,0,24,3.4285714285714284,1,0.0,0,5,0,2,10,0,0,7,0,7,17,1
2432,70368,4AzWdcwb3SG5chIViRUSkI6mbhUE2J75,fbPkOYLVPtPgIt0MxizjfFJov3JbHyAi,23,37,16,0,14,0,4,0,71,10.142857142857142,3,0.0,0,16,0,14,37,0,0,4,0,30,41,1
2433,70371,kC7JLQowN0BSKnzXXKRn5vuXi1nnM0dA,fbPkOYLVPtPgIt0MxizjfFJov3JbHyAi,14,14,12,0,9,0,2,0,37,5.285714285714286,2,0.0,0,12,0,9,14,0,0,2,0,21,16,1
2434,70372,FQa7FML2dxClmAhYk6OVYx2GHs5nEEVz,fbPkOYLVPtPgIt0MxizjfFJov3JbHyAi,11,15,5,0,3,0,4,0,27,3.857142857142857,1,0.0,0,5,0,3,15,0,0,4,0,8,19,1
2435,70373,cX0P9gUHB3WzWCloaI5EOvK7S6ZZ4sV6,fbPkOYLVPtPgIt0MxizjfFJov3JbHyAi,1,0,0,0,0,0,1,0,1,0.14285714285714285,1,0.0,0,0,0,0,0,0,0,1,0,0,1,1
2436,70375,0U0tIMU8GJAaJuwFbrHTH59SwJZ2uGnq,fbPkOYLVPtPgIt0MxizjfFJov3JbHyAi,5,2,1,0,1,0,2,0,6,0.8571428571428571,1,0.0,0,1,0,1,2,0,0,2,0,2,4,1
2437,70376,61PsrnqGMh19xjWowe2Lz8ELqYCTUUqE,fbPkOYLVPtPgIt0MxizjfFJov3JbHyAi,21,44,27,13,1,9,10,0,104,14.857142857142858,5,0.0,8,27,12,1,36,9,1,10,0,48,56,0
2438,70377,F1rdosKmYTZ6HBhTBGWJEe9EBJKQd8S8,fbPkOYLVPtPgIt0MxizjfFJov3JbHyAi,8,9,6,0,4,4,4,0,27,3.857142857142857,1,0.0,1,6,0,4,8,4,0,4,0,11,16,1
2439,70378,msjMVm4wh7wQYNgRDY7af8l1AlP1idBu,fbPkOYLVPtPgIt0MxizjfFJov3JbHyAi,13,6,3,9,3,0,4,0,25,3.5714285714285716,1,0.0,2,3,7,3,4,0,2,4,0,15,10,1
2440,70379,XjdksOkSKZrf2p0cWebK5cufRcdWg90c,fbPkOYLVPtPgIt0MxizjfFJov3JbHyAi,7,7,2,0,3,0,2,0,14,2.0,1,0.0,4,2,0,3,3,0,0,2,0,9,5,1
2441,70381,i67qzouvUD7nINgK6d1xrH4pvufZqbFd,fbPkOYLVPtPgIt0MxizjfFJov3JbHyAi,4,2,1,0,1,0,1,0,5,0.7142857142857143,1,0.0,0,1,0,1,2,0,0,1,0,2,3,1
2442,70384,QJS32fOTs325a0GlAhy998Sct293VriJ,fbPkOYLVPtPgIt0MxizjfFJov3JbHyAi,8,2,1,0,1,0,8,1,13,1.8571428571428572,1,0.0,0,1,0,1,2,0,0,8,1,2,11,1
2443,70385,BQwPjuIfQmrx5lpYZY3tsAMsirLTrL44,fbPkOYLVPtPgIt0MxizjfFJov3JbHyAi,9,4,3,0,3,0,2,0,12,1.7142857142857142,1,0.0,0,3,0,3,4,0,0,2,0,6,6,1
2444,70388,3VWYOIqoNbquvkyiG0UxiMd0Ny2ffzYn,fbPkOYLVPtPgIt0MxizjfFJov3JbHyAi,1,0,0,0,0,0,1,0,1,0.14285714285714285,1,0.0,0,0,0,0,0,0,0,1,0,0,1,1
2445,70389,AHPbZNsGkOJLnomSDr66Lsr56SzydeZ9,fbPkOYLVPtPgIt0MxizjfFJov3JbHyAi,4,0,0,0,0,0,4,0,4,0.5714285714285714,1,0.0,0,0,0,0,0,0,0,4,0,0,4,1
2446,70390,CZolsxTOSFE94rXDRXRTcZmeVsLJ3JH7,fbPkOYLVPtPgIt0MxizjfFJov3JbHyAi,19,13,10,0,8,0,3,0,34,4.857142857142857,2,0.0,0,10,0,8,13,0,0,3,0,18,16,1
2447,70391,33mJ0RGBAyjE4CKOfiTALYWXunuMDP86,fbPkOYLVPtPgIt0MxizjfFJov3JbHyAi,9,5,3,0,2,0,6,0,16,2.2857142857142856,1,0.0,0,3,0,2,5,0,0,6,0,5,11,1
2448,70392,RObsRvS6ivBKFOxQvJXBp0LqecTCcxns,fbPkOYLVPtPgIt0MxizjfFJov3JbHyAi,5,3,1,0,1,3,5,0,13,1.8571428571428572,2,0.0,0,1,0,1,3,3,0,5,0,2,11,1
2449,70393,NRRB20JWU11ewowP1RJ7HD6jBKqLT3DC,fbPkOYLVPtPgIt0MxizjfFJov3JbHyAi,1,0,0,0,0,0,1,0,1,0.14285714285714285,1,0.0,0,0,0,0,0,0,0,1,0,0,1,1
2450,70394,jVBLsQocjzyX8TfhIQuGcF0tRTsZU0fl,fbPkOYLVPtPgIt0MxizjfFJov3JbHyAi,7,5,3,0,2,0,1,0,11,1.5714285714285714,1,0.0,1,3,0,2,4,0,0,1,0,6,5,1
2451,70395,e0E9n0HmHiD7GloTGo5pwSGRifRse0is,fbPkOYLVPtPgIt0MxizjfFJov3JbHyAi,1,0,0,0,0,0,1,0,1,0.14285714285714285,1,0.0,0,0,0,0,0,0,0,1,0,0,1,1
2452,70396,WxiMfvuIhzGtTOKN3rfExm4cBAegUNmS,fbPkOYLVPtPgIt0MxizjfFJov3JbHyAi,4,0,0,0,0,1,7,0,8,1.1428571428571428,1,0.0,0,0,0,0,0,1,0,7,0,0,8,1
2453,70397,1CMLhtavMvC0VlqRyCT3yzXnyLuHWoin,fbPkOYLVPtPgIt0MxizjfFJov3JbHyAi,7,8,4,0,2,0,4,0,18,2.5714285714285716,1,0.0,0,4,0,2,8,0,0,4,0,6,12,1
2454,70398,ZDwBma59xbolXq5GHAmKUUQnUT2REqrt,fbPkOYLVPtPgIt0MxizjfFJov3JbHyAi,1,0,0,0,0,0,1,0,1,0.14285714285714285,1,0.0,0,0,0,0,0,0,0,1,0,0,1,1
2455,70399,MjMfsXNTnm5lSVaPE42HKPGjEP4JdYyv,fbPkOYLVPtPgIt0MxizjfFJov3JbHyAi,11,5,2,8,2,0,6,1,24,3.4285714285714284,1,0.0,1,2,6,2,4,0,2,6,1,11,13,1
2456,70400,SdUI7MFv1cY1lGHTqsLRYstBYRI0xIIR,fbPkOYLVPtPgIt0MxizjfFJov3JbHyAi,17,21,14,10,7,2,5,0,59,8.428571428571429,2,0.0,5,14,8,7,16,2,2,5,0,34,25,1
2457,70401,Fnv71uLEZTKv4jXhwN4OiZMjnP26bZSP,fbPkOYLVPtPgIt0MxizjfFJov3JbHyAi,3,0,0,0,0,0,5,0,5,0.7142857142857143,1,0.0,0,0,0,0,0,0,0,5,0,0,5,1
2458,70404,8ZhpSkXuKXWxDMEbryu3zVTkh7o5swmt,fbPkOYLVPtPgIt0MxizjfFJov3JbHyAi,1,0,0,0,0,0,1,0,1,0.14285714285714285,1,0.0,0,0,0,0,0,0,0,1,0,0,1,1
2459,70406,6Ozqfp4jaBSg7FmT8HpyXWJDqKSyAP5W,fbPkOYLVPtPgIt0MxizjfFJov3JbHyAi,2,0,0,0,0,0,2,0,2,0.2857142857142857,1,0.0,0,0,0,0,0,0,0,2,0,0,2,1
2460,70407,2G7A4QoutYqsQhCEpYdHlicpDLnRQDr3,fbPkOYLVPtPgIt0MxizjfFJov3JbHyAi,2,0,0,0,0,0,2,0,2,0.2857142857142857,1,0.0,0,0,0,0,0,0,0,2,0,0,2,1
2461,70409,rmhIiBxDtXLZVL14b2QxLmm4nyg5Vaki,fbPkOYLVPtPgIt0MxizjfFJov3JbHyAi,1,0,0,0,0,0,1,0,1,0.14285714285714285,1,0.0,0,0,0,0,0,0,0,1,0,0,1,1
2462,70410,XRUsgF0CDtpOGrnGNBjxKyyDO6IoyuZv,fbPkOYLVPtPgIt0MxizjfFJov3JbHyAi,1,0,0,0,0,0,1,0,1,0.14285714285714285,1,0.0,0,0,0,0,0,0,0,1,0,0,1,1
2463,70412,HJDBhocphGBunDu6wRNi5xUX9mlf7tO8,fbPkOYLVPtPgIt0MxizjfFJov3JbHyAi,26,44,16,23,14,0,7,0,104,14.857142857142858,2,0.0,14,16,20,14,30,0,3,7,0,64,40,1
2464,70414,DxcYMrQ21AStjf17HASizKXEPVvKuUI9,fbPkOYLVPtPgIt0MxizjfFJov3JbHyAi,10,6,1,0,0,2,7,1,17,2.4285714285714284,1,0.0,0,1,0,0,6,2,0,7,1,1,16,1
2465,70419,SDT3ZftpiolwjTigpC58j5o0ZRUhDG2F,fbPkOYLVPtPgIt0MxizjfFJov3JbHyAi,12,12,5,5,6,12,3,0,43,6.142857142857143,1,0.0,5,5,4,6,7,12,1,3,0,20,23,1
2466,70423,LBz8eebDA0q3o7gWfqXlzvsHwwqTUJzd,fbPkOYLVPtPgIt0MxizjfFJov3JbHyAi,14,15,7,4,3,0,8,1,38,5.428571428571429,2,0.0,5,7,3,3,10,0,1,8,1,18,20,1
2467,70424,umLfDUbxjnrT5PppK2cJ5eTNtkgpa74K,fbPkOYLVPtPgIt0MxizjfFJov3JbHyAi,1,0,0,0,0,0,1,0,1,0.14285714285714285,1,0.0,0,0,0,0,0,0,0,1,0,0,1,1
2468,70427,xlOz0HV4EOx3YcSKdziNkU6Tif0rYjnx,fbPkOYLVPtPgIt0MxizjfFJov3JbHyAi,6,6,4,0,2,0,3,0,15,2.142857142857143,2,0.0,0,4,0,2,6,0,0,3,0,6,9,1
2469,70428,XuNpmX60qMeqTMm6loZLPt3hrjsNO9oc,fbPkOYLVPtPgIt0MxizjfFJov3JbHyAi,5,2,1,0,1,0,2,0,6,0.8571428571428571,1,0.0,0,1,0,1,2,0,0,2,0,2,4,1
2470,70429,ndJjad3g9fi4m3MaVbqG9HoSdy5NpmWc,fbPkOYLVPtPgIt0MxizjfFJov3JbHyAi,5,2,1,0,1,0,2,0,6,0.8571428571428571,1,0.0,0,1,0,1,2,0,0,2,0,2,4,1
2471,70431,2g8zxwHmn0vyZ27TucfkG6P7s8LClDHy,fbPkOYLVPtPgIt0MxizjfFJov3JbHyAi,2,0,0,0,0,0,2,0,2,0.2857142857142857,1,0.0,0,0,0,0,0,0,0,2,0,0,2,1
2472,70433,guAAb9ckvAjdsS0lv2pnwyDARfevxUzH,fbPkOYLVPtPgIt0MxizjfFJov3JbHyAi,6,3,2,0,2,0,1,0,8,1.1428571428571428,1,0.0,0,2,0,2,3,0,0,1,0,4,4,1
2473,70434,lSCJ8ylZ5PCl7TN61VRBQOeN1dbHBCKj,fbPkOYLVPtPgIt0MxizjfFJov3JbHyAi,7,5,3,0,3,0,2,0,13,1.8571428571428572,2,0.0,0,3,0,3,5,0,0,2,0,6,7,1
2474,70435,bexdM93ug7d9XS96XYNBLrki1Em3eYQu,fbPkOYLVPtPgIt0MxizjfFJov3JbHyAi,1,0,0,0,0,0,1,0,1,0.14285714285714285,1,0.0,0,0,0,0,0,0,0,1,0,0,1,1
2475,70436,5tNddvEPZ6adptKjdq6L9gHvDOUDmliH,fbPkOYLVPtPgIt0MxizjfFJov3JbHyAi,7,10,2,0,2,0,2,0,16,2.2857142857142856,1,0.0,5,2,0,2,5,0,0,2,0,9,7,1
2476,70437,zlHnyn2o1Q4DVHdUqyCbAWLuHmOKttM3,fbPkOYLVPtPgIt0MxizjfFJov3JbHyAi,1,0,0,0,0,0,1,0,1,0.14285714285714285,1,0.0,0,0,0,0,0,0,0,1,0,0,1,1
2477,70438,TcuUuOMUA0rnssmvuX7CLScapgs7yDzA,fbPkOYLVPtPgIt0MxizjfFJov3JbHyAi,9,6,2,0,1,0,4,1,14,2.0,1,0.0,0,2,0,1,6,0,0,4,1,3,11,1
2478,70439,qgV0HNJ9ICkZ7TcoJUGdc2JSSqNGtGZ7,fbPkOYLVPtPgIt0MxizjfFJov3JbHyAi,8,10,6,5,4,0,3,0,28,4.0,1,0.0,3,6,4,4,7,0,1,3,0,17,11,1
2479,70441,a4heGNfxWtaNpzRnv4l5t37neKjFR36r,fbPkOYLVPtPgIt0MxizjfFJov3JbHyAi,6,2,0,0,0,0,5,1,8,1.1428571428571428,1,0.0,0,0,0,0,2,0,0,5,1,0,8,1
2480,70445,jJnHLWNDobnCPy5FiRkgK6gW3VoeZNER,fbPkOYLVPtPgIt0MxizjfFJov3JbHyAi,12,6,5,0,4,10,3,0,28,4.0,1,0.0,0,5,0,4,6,10,0,3,0,9,19,1
2481,70446,ZbaPpC6DlaDgy5Ic6oj7YX9qkm2j3Pmr,fbPkOYLVPtPgIt0MxizjfFJov3JbHyAi,2,0,0,0,0,0,2,0,2,0.2857142857142857,1,0.0,0,0,0,0,0,0,0,2,0,0,2,1
2482,70449,OuD2K7J68ITZFWHHO1jbGZ6J29NSRzcb,fbPkOYLVPtPgIt0MxizjfFJov3JbHyAi,1,0,0,0,0,0,2,0,2,0.2857142857142857,1,0.0,0,0,0,0,0,0,0,2,0,0,2,1
2483,70452,BtObcKvoRLWw2wTYrIxs3nRcUhT64kDl,fbPkOYLVPtPgIt0MxizjfFJov3JbHyAi,5,3,2,0,1,0,1,0,7,1.0,1,0.0,0,2,0,1,3,0,0,1,0,3,4,1
2484,70455,UdUawMbovWyI95L2WHmtm8dSD2c6Mirq,fbPkOYLVPtPgIt0MxizjfFJov3JbHyAi,1,0,0,0,0,0,3,0,3,0.42857142857142855,2,0.0,0,0,0,0,0,0,0,3,0,0,3,1
2485,70456,glPr7QpSO3UuaddnFvb5PsvEyV64Bjzf,fbPkOYLVPtPgIt0MxizjfFJov3JbHyAi,6,9,2,4,4,0,1,0,20,2.857142857142857,1,0.0,6,2,3,4,3,0,1,1,0,15,5,1
2486,70457,yGll7cBEK4l513wg08W8WjrXiINZSUwd,fbPkOYLVPtPgIt0MxizjfFJov3JbHyAi,1,0,0,0,0,0,1,0,1,0.14285714285714285,1,0.0,0,0,0,0,0,0,0,1,0,0,1,1
2487,70458,TLnrwcxEgz2mrbehNNXwzL2eSvPdN3Si,fbPkOYLVPtPgIt0MxizjfFJov3JbHyAi,18,22,10,2,5,0,2,0,41,5.857142857142857,1,0.0,1,10,2,5,21,0,0,2,0,18,23,1
2488,70459,jR6b1WwZvYbWar4qY41wd06uzAZM2Wm4,fbPkOYLVPtPgIt0MxizjfFJov3JbHyAi,1,0,0,0,0,0,1,0,1,0.14285714285714285,1,0.0,0,0,0,0,0,0,0,1,0,0,1,1
2489,70461,6s9Xh8eciyhZj6AHFu4vTyr6KvYwFOCT,fbPkOYLVPtPgIt0MxizjfFJov3JbHyAi,2,0,0,0,0,0,2,0,2,0.2857142857142857,1,0.0,0,0,0,0,0,0,0,2,0,0,2,1
2490,70462,q7Q44V2N9alRALsjF38u0JgTcKmJyVSV,fbPkOYLVPtPgIt0MxizjfFJov3JbHyAi,8,4,2,0,1,0,6,0,13,1.8571428571428572,1,0.0,0,2,0,1,4,0,0,6,0,3,10,1
2491,70463,q5Mh1DiRxqFPerzFhySJn3OvdiZ2Qdjc,fbPkOYLVPtPgIt0MxizjfFJov3JbHyAi,7,3,2,0,1,1,4,2,13,1.8571428571428572,1,0.0,0,2,0,1,3,1,0,4,2,3,10,1
2492,70469,wsHrywXqK9pQHQooNVLXSXuDfHuX10wJ,fbPkOYLVPtPgIt0MxizjfFJov3JbHyAi,11,8,5,0,4,1,6,1,25,3.5714285714285716,1,0.0,0,5,0,4,8,1,0,6,1,9,16,1
2493,70470,RbeBYSWxB5YUB8XfumpP3ReeBILP8GQy,fbPkOYLVPtPgIt0MxizjfFJov3JbHyAi,6,4,2,0,1,0,3,0,10,1.4285714285714286,1,0.0,0,2,0,1,4,0,0,3,0,3,7,1
2494,70471,qbl5rpxJliTRqjMlXPxrXNDAwFWGT88v,fbPkOYLVPtPgIt0MxizjfFJov3JbHyAi,4,2,1,0,1,0,1,0,5,0.7142857142857143,1,0.0,0,1,0,1,2,0,0,1,0,2,3,1
2495,70472,Jxzkhh0U3PjsXsXvIQ1RukUNEABuBZir,fbPkOYLVPtPgIt0MxizjfFJov3JbHyAi,6,1,1,0,1,0,3,0,6,0.8571428571428571,1,0.0,0,1,0,1,1,0,0,3,0,2,4,1
2496,70473,TfXAnflKNnQz6DuwkJiGkjk0fNqIcdbb,fbPkOYLVPtPgIt0MxizjfFJov3JbHyAi,9,3,2,0,2,0,4,0,11,1.5714285714285714,1,0.0,0,2,0,2,3,0,0,4,0,4,7,1
2497,70474,NvOjhiruQj7OPLj435mRJgxxBFzX5464,fbPkOYLVPtPgIt0MxizjfFJov3JbHyAi,1,0,0,0,0,0,1,0,1,0.14285714285714285,1,0.0,0,0,0,0,0,0,0,1,0,0,1,1
2498,70476,EiRrHQO9y6KZsQm1S959e8bTml9ewKqm,fbPkOYLVPtPgIt0MxizjfFJov3JbHyAi,6,2,1,0,1,0,5,0,9,1.2857142857142858,1,0.0,0,1,0,1,2,0,0,5,0,2,7,1
2499,70477,jEK7s8PazjYlgavgxBhEJ34esgHb5r59,fbPkOYLVPtPgIt0MxizjfFJov3JbHyAi,8,8,5,0,4,3,7,0,27,3.857142857142857,1,0.0,0,5,0,4,8,3,0,7,0,9,18,1
2500,70478,KUQVcSgCXyv6H6oERclsfGhdo9VFKXlH,fbPkOYLVPtPgIt0MxizjfFJov3JbHyAi,9,4,3,0,3,0,3,0,13,1.8571428571428572,1,0.0,0,3,0,3,4,0,0,3,0,6,7,1
2501,70481,bcuHKGDPi1i2lleukutg2XopIRt9zCPL,fbPkOYLVPtPgIt0MxizjfFJov3JbHyAi,1,0,0,0,0,0,2,0,2,0.2857142857142857,1,0.0,0,0,0,0,0,0,0,2,0,0,2,1
2502,70482,jHiBXPRyvnOA5W3dD5pIjKcoACQXqFJ5,fbPkOYLVPtPgIt0MxizjfFJov3JbHyAi,5,2,1,0,1,0,2,0,6,0.8571428571428571,1,0.0,0,1,0,1,2,0,0,2,0,2,4,1
2503,70484,NZGDKrLK9sMpIPoDEekWqKbifVFi38Go,fbPkOYLVPtPgIt0MxizjfFJov3JbHyAi,5,2,1,0,1,2,10,0,16,2.2857142857142856,1,0.0,0,1,0,1,2,2,0,10,0,2,14,1
2504,70485,scWFbDUGBDAED5tZERDIuB5WNVjTVxwA,fbPkOYLVPtPgIt0MxizjfFJov3JbHyAi,13,6,4,0,4,0,5,0,19,2.7142857142857144,1,0.0,0,4,0,4,6,0,0,5,0,8,11,1
2505,70486,HpRhpantip3wKMH4DG1UO07aIjpFrvNc,fbPkOYLVPtPgIt0MxizjfFJov3JbHyAi,1,0,0,0,0,0,1,0,1,0.14285714285714285,1,0.0,0,0,0,0,0,0,0,1,0,0,1,1
2506,70487,bNsQaARwlcoPz5iHn0mmqTE4ae2nNQLk,fbPkOYLVPtPgIt0MxizjfFJov3JbHyAi,5,2,1,0,1,0,2,0,6,0.8571428571428571,1,0.0,0,1,0,1,2,0,0,2,0,2,4,0
2507,70488,OJtIvWrXfQPJJSf2ovLSm6YwghN7AEL1,fbPkOYLVPtPgIt0MxizjfFJov3JbHyAi,7,3,2,0,2,0,2,0,9,1.2857142857142858,1,0.0,0,2,0,2,3,0,0,2,0,4,5,1
2508,70490,txE1eLKUbbtrl9557b0RVmjAcidcH23D,fbPkOYLVPtPgIt0MxizjfFJov3JbHyAi,4,2,1,0,0,0,2,0,5,0.7142857142857143,1,0.0,0,1,0,0,2,0,0,2,0,1,4,1
2509,70492,MlowXT3hhqxu8JbBXveSGYwt4gmwlpxF,fbPkOYLVPtPgIt0MxizjfFJov3JbHyAi,9,12,6,0,3,6,5,1,33,4.714285714285714,1,0.0,2,6,0,3,10,6,0,5,1,11,22,1
2510,70495,STkYkZEAJSwprBqpDKOiSfNJUIRyo0Bq,fbPkOYLVPtPgIt0MxizjfFJov3JbHyAi,5,2,1,0,1,0,3,0,7,1.0,1,0.0,0,1,0,1,2,0,0,3,0,2,5,0
2511,70496,AzLeSPI7N5fTBGeJQXVJiiiwHcrcLWj9,fbPkOYLVPtPgIt0MxizjfFJov3JbHyAi,7,2,1,0,1,0,10,0,14,2.0,1,0.0,0,1,0,1,2,0,0,10,0,2,12,1
2512,70501,QRNZCYPVLmCISEPDuklXJvVOWAcJbKvm,fbPkOYLVPtPgIt0MxizjfFJov3JbHyAi,1,0,0,0,0,0,1,0,1,0.14285714285714285,1,0.0,0,0,0,0,0,0,0,1,0,0,1,1
2513,70502,fd3M5GFuTNibIF234PDGuNuJ7TaPIle6,fbPkOYLVPtPgIt0MxizjfFJov3JbHyAi,1,0,0,0,0,0,1,0,1,0.14285714285714285,1,0.0,0,0,0,0,0,0,0,1,0,0,1,1
2514,70503,yoIXcPh3WeERNBgp3KavFpHxxtSbEbDw,fbPkOYLVPtPgIt0MxizjfFJov3JbHyAi,1,0,0,0,0,0,1,0,1,0.14285714285714285,1,0.0,0,0,0,0,0,0,0,1,0,0,1,1
2515,70504,hx5sJ7jwWSrYbv8AAwrwIYlkyA5lh0xw,fbPkOYLVPtPgIt0MxizjfFJov3JbHyAi,1,0,0,0,0,0,1,0,1,0.14285714285714285,1,0.0,0,0,0,0,0,0,0,1,0,0,1,1
2516,70506,mfNh4uOHHxwzdcujnNlWt7NLyD4AZdsC,fbPkOYLVPtPgIt0MxizjfFJov3JbHyAi,6,6,1,0,1,0,2,0,10,1.4285714285714286,1,0.0,0,1,0,1,6,0,0,2,0,2,8,1
2517,70617,UNVbIrcEO0nclbN5f0xdIeSb61jrpRSX,fbPkOYLVPtPgIt0MxizjfFJov3JbHyAi,5,3,2,0,1,0,1,0,7,1.0,1,0.0,0,2,0,1,3,0,0,1,0,3,4,1
2518,70622,vL40lDIpwhva8z6IagRWvDtekT2W0mhZ,fbPkOYLVPtPgIt0MxizjfFJov3JbHyAi,8,4,3,0,2,0,2,0,11,1.5714285714285714,1,0.0,0,3,0,2,4,0,0,2,0,5,6,1
2519,70627,VJsbRtMXxy8aqyccEZDzV7pPAGBosBu1,fbPkOYLVPtPgIt0MxizjfFJov3JbHyAi,31,53,39,16,25,0,4,0,137,19.571428571428573,2,0.0,10,39,14,25,43,0,2,4,0,88,49,0
2520,70641,2uadn8x6eG3s1sEJofJgCr35bh3OHGLh,fbPkOYLVPtPgIt0MxizjfFJov3JbHyAi,12,9,7,0,1,2,4,0,23,3.2857142857142856,1,0.0,0,7,0,1,9,2,0,4,0,8,15,1
2521,70664,8djQJACWabqqdfUYlZxiiBK5fRdO0gWZ,fbPkOYLVPtPgIt0MxizjfFJov3JbHyAi,5,5,3,0,0,1,3,0,12,1.7142857142857142,2,0.0,0,3,0,0,5,1,0,3,0,3,9,1
2522,70670,mgRmoo6F9KYYizHMOajedFcuJHtEV6by,fbPkOYLVPtPgIt0MxizjfFJov3JbHyAi,13,11,6,7,0,0,1,0,25,3.5714285714285716,1,0.0,4,6,7,0,7,0,0,1,0,17,8,1
2523,70674,tsQNS0TFi4T2OwDWxOZsXYloXeaBeZAv,fbPkOYLVPtPgIt0MxizjfFJov3JbHyAi,4,3,1,0,0,0,1,0,5,0.7142857142857143,1,0.0,0,1,0,0,3,0,0,1,0,1,4,1
2524,70685,HUREvJ7y9WAOKVUwE1W5wjAznpJ2uyCs,fbPkOYLVPtPgIt0MxizjfFJov3JbHyAi,9,4,3,0,3,0,3,0,13,1.8571428571428572,1,0.0,0,3,0,3,4,0,0,3,0,6,7,1
2525,70687,EjU0dAqbUvEwc53uCAdZVva4XIVSaRPC,fbPkOYLVPtPgIt0MxizjfFJov3JbHyAi,5,2,1,0,1,0,4,0,8,1.1428571428571428,1,0.0,0,1,0,1,2,0,0,4,0,2,6,1
2526,70688,RtFjOHQ78yo3bQ6aRAVmoLevb4Ve3GxB,fbPkOYLVPtPgIt0MxizjfFJov3JbHyAi,7,5,3,0,1,0,5,0,14,2.0,2,0.0,0,3,0,1,5,0,0,5,0,4,10,1
2527,70690,R8o5XScw0cHktAR1kvrGC4Hk6nsNJ50O,fbPkOYLVPtPgIt0MxizjfFJov3JbHyAi,7,4,2,0,2,0,2,0,10,1.4285714285714286,1,0.0,0,2,0,2,4,0,0,2,0,4,6,1
2528,70691,sW1u9EOUYrJApfkaDSoDkISZzFP3ogv6,fbPkOYLVPtPgIt0MxizjfFJov3JbHyAi,6,4,2,0,2,0,1,0,9,1.2857142857142858,1,0.0,0,2,0,2,4,0,0,1,0,4,5,1
2529,70693,10zM0lTEidXp4ysKuDBYxHMLWTshL529,fbPkOYLVPtPgIt0MxizjfFJov3JbHyAi,1,0,0,0,0,0,1,0,1,0.14285714285714285,1,0.0,0,0,0,0,0,0,0,1,0,0,1,1
2530,70695,aR3fk0CNwd9ygarvr0BOVu5p8WeU32I1,fbPkOYLVPtPgIt0MxizjfFJov3JbHyAi,5,2,1,0,1,0,4,0,8,1.1428571428571428,2,0.0,0,1,0,1,2,0,0,4,0,2,6,0
2531,70697,ZQ7aIrw0oaneyIJXr1o9BaGyCupjLIKv,fbPkOYLVPtPgIt0MxizjfFJov3JbHyAi,8,9,3,0,3,0,2,0,17,2.4285714285714284,1,0.0,4,3,0,3,5,0,0,2,0,10,7,1
2532,70699,w5ZVCLR3vfwLftGVhyQYRVOjp6YWhw1i,fbPkOYLVPtPgIt0MxizjfFJov3JbHyAi,14,19,6,2,6,0,11,2,46,6.571428571428571,1,0.0,7,6,2,6,12,0,0,11,2,21,25,1
2533,70700,TaMOkXsZdqqtZoisxF7gCh53bqhSIWJo,fbPkOYLVPtPgIt0MxizjfFJov3JbHyAi,8,3,1,0,1,2,6,1,14,2.0,1,0.0,0,1,0,1,3,2,0,6,1,2,12,1
2534,70701,u71FEuwuCmO3r4p2rE2moG5KipMWcySZ,fbPkOYLVPtPgIt0MxizjfFJov3JbHyAi,6,3,0,0,0,0,6,2,11,1.5714285714285714,1,0.0,0,0,0,0,3,0,0,6,2,0,11,1
2535,70702,0x2sITGXbmptNoJgvpnNEvFzUs19fgRa,fbPkOYLVPtPgIt0MxizjfFJov3JbHyAi,5,3,1,0,1,0,2,0,7,1.0,1,0.0,0,1,0,1,3,0,0,2,0,2,5,1
2536,70703,Evomveryl9GU6Kyv21VjN2TZpSsXcU7r,fbPkOYLVPtPgIt0MxizjfFJov3JbHyAi,2,0,0,0,0,0,3,0,3,0.42857142857142855,1,0.0,0,0,0,0,0,0,0,3,0,0,3,1
2537,70704,vyZYP10ZbNOAlqCfJpVxupzTWedLnj63,fbPkOYLVPtPgIt0MxizjfFJov3JbHyAi,1,0,0,0,0,0,1,0,1,0.14285714285714285,1,0.0,0,0,0,0,0,0,0,1,0,0,1,1
2538,70705,tdygDfFACDU3UgcaUQcaQlbTc0CT910g,fbPkOYLVPtPgIt0MxizjfFJov3JbHyAi,5,2,0,0,0,0,4,0,6,0.8571428571428571,1,0.0,0,0,0,0,2,0,0,4,0,0,6,1
2539,70706,2j7JDJ8MsffyV0kSC0vh7baFkUIS4GAx,fbPkOYLVPtPgIt0MxizjfFJov3JbHyAi,8,7,4,5,3,0,0,0,19,2.7142857142857144,1,0.0,3,4,4,3,4,0,1,0,0,14,5,1
2540,70708,7h2Z9QDw2si8maJ5It93IgGcw9Rvo97L,fbPkOYLVPtPgIt0MxizjfFJov3JbHyAi,7,2,1,0,1,0,3,0,7,1.0,1,0.0,0,1,0,1,2,0,0,3,0,2,5,1
2541,70709,bxNjpvJUyYuoYRYlnOXzFxygMwQkPpdy,fbPkOYLVPtPgIt0MxizjfFJov3JbHyAi,1,0,0,0,0,0,1,0,1,0.14285714285714285,1,0.0,0,0,0,0,0,0,0,1,0,0,1,1
2542,70710,ZbRcmeUPJ5YWlzvZySRNdBYY12qzZPLH,fbPkOYLVPtPgIt0MxizjfFJov3JbHyAi,2,0,0,0,0,0,5,0,5,0.7142857142857143,1,0.0,0,0,0,0,0,0,0,5,0,0,5,1
2543,70711,898EWlvcqwFCOnhtz4G2TeXb2eJQJsSY,fbPkOYLVPtPgIt0MxizjfFJov3JbHyAi,6,4,0,0,0,0,5,1,10,1.4285714285714286,1,0.0,0,0,0,0,4,0,0,5,1,0,10,1
2544,70712,OXXS9H9b2CvKWuZ1kgFXpystd5LpKcni,fbPkOYLVPtPgIt0MxizjfFJov3JbHyAi,1,0,0,0,0,0,2,0,2,0.2857142857142857,1,0.0,0,0,0,0,0,0,0,2,0,0,2,1
2545,70713,4aIAxdudlKdNnJYDYlmurnayXljF85dB,fbPkOYLVPtPgIt0MxizjfFJov3JbHyAi,5,2,1,0,1,0,2,0,6,0.8571428571428571,1,0.0,0,1,0,1,2,0,0,2,0,2,4,1
2546,70715,fMmuNXjPEhNXfnU1x4BfSanHlv9m7fK3,fbPkOYLVPtPgIt0MxizjfFJov3JbHyAi,7,6,2,0,3,0,2,0,13,1.8571428571428572,1,0.0,3,2,0,3,3,0,0,2,0,8,5,1
2547,70717,ptm9xuFWpeV3IYsTqQHb5OT1hlhuZP2R,fbPkOYLVPtPgIt0MxizjfFJov3JbHyAi,5,2,1,0,1,0,2,0,6,0.8571428571428571,1,0.0,0,1,0,1,2,0,0,2,0,2,4,1
2548,70721,vKb5mkAesgp0CxIabJFr8I3VERLyILwt,fbPkOYLVPtPgIt0MxizjfFJov3JbHyAi,2,0,0,0,0,0,2,0,2,0.2857142857142857,1,0.0,0,0,0,0,0,0,0,2,0,0,2,1
2549,70722,x3bkOAcKf3YrvrKxnJbZKaEoApnaabtK,fbPkOYLVPtPgIt0MxizjfFJov3JbHyAi,2,0,0,0,0,0,5,0,5,0.7142857142857143,1,0.0,0,0,0,0,0,0,0,5,0,0,5,1
2550,70723,IkoiWVr2ygCLdZNh2Bkmtx3mmgIErIzY,fbPkOYLVPtPgIt0MxizjfFJov3JbHyAi,1,0,0,0,0,0,1,0,1,0.14285714285714285,1,0.0,0,0,0,0,0,0,0,1,0,0,1,1
2551,70727,jtRMyLnPrQKBYosd7A0axGxYdzZLfoyG,fbPkOYLVPtPgIt0MxizjfFJov3JbHyAi,5,2,1,0,1,0,2,0,6,0.8571428571428571,1,0.0,0,1,0,1,2,0,0,2,0,2,4,1
2552,70728,txNRRPx9OJW1ssLv0i1BuynOrKT6T5bw,fbPkOYLVPtPgIt0MxizjfFJov3JbHyAi,7,3,2,0,2,0,2,0,9,1.2857142857142858,1,0.0,0,2,0,2,3,0,0,2,0,4,5,1
2553,70729,D7NGYdR3TLx6U0EvEqMYenyKGPerYPxa,fbPkOYLVPtPgIt0MxizjfFJov3JbHyAi,4,2,1,0,1,0,1,0,5,0.7142857142857143,1,0.0,0,1,0,1,2,0,0,1,0,2,3,1
2554,70730,OdsEBh425XZxll0hTUv04OAotDf6aGtE,fbPkOYLVPtPgIt0MxizjfFJov3JbHyAi,1,0,0,0,0,0,1,0,1,0.14285714285714285,1,0.0,0,0,0,0,0,0,0,1,0,0,1,1
2555,70732,1Z5BGBo2C4Yx5dovaTv5L9hwpHiDBAED,fbPkOYLVPtPgIt0MxizjfFJov3JbHyAi,6,0,0,0,0,0,5,3,8,1.1428571428571428,1,0.0,0,0,0,0,0,0,0,5,3,0,8,1
2556,70734,5W0RrimHGXv2rlPQ5YUetmDKQyAz3Zx5,fbPkOYLVPtPgIt0MxizjfFJov3JbHyAi,5,2,1,0,1,0,4,0,8,1.1428571428571428,1,0.0,0,1,0,1,2,0,0,4,0,2,6,1
2557,70736,pVY9a8xiiW5Hoddx6sJePwV7ScRr5XzD,fbPkOYLVPtPgIt0MxizjfFJov3JbHyAi,5,2,1,0,1,0,2,0,6,0.8571428571428571,1,0.0,0,1,0,1,2,0,0,2,0,2,4,1
2558,70737,Dht5yukEe9IZ0iWFi8cUIe1SOPRbmo8J,fbPkOYLVPtPgIt0MxizjfFJov3JbHyAi,1,0,0,0,0,0,1,0,1,0.14285714285714285,1,0.0,0,0,0,0,0,0,0,1,0,0,1,1
2559,70742,cMdcyYeaotcfCR4kGKYkD6AiwNH9y3n3,fbPkOYLVPtPgIt0MxizjfFJov3JbHyAi,1,0,0,0,0,0,1,0,1,0.14285714285714285,1,0.0,0,0,0,0,0,0,0,1,0,0,1,1
2560,70743,vIbI2SixV9mKPlPtOmgytvBhorWx01zg,fbPkOYLVPtPgIt0MxizjfFJov3JbHyAi,9,20,5,4,7,0,4,0,40,5.714285714285714,2,0.0,5,5,4,7,15,0,0,4,0,21,19,1
2561,70744,JRuzCriX6hvuTQ943ttXKlmrFVyfxMHr,fbPkOYLVPtPgIt0MxizjfFJov3JbHyAi,9,17,10,0,8,0,5,0,40,5.714285714285714,2,0.0,0,10,0,8,17,0,0,5,0,18,22,1
2562,70747,lzZwGZ8LEp741qdGyudVx7KySokTlOIW,fbPkOYLVPtPgIt0MxizjfFJov3JbHyAi,2,0,0,0,0,0,2,0,2,0.2857142857142857,1,0.0,0,0,0,0,0,0,0,2,0,0,2,1
2563,70749,R7ezqxAQ4nt5CDDIMvGiu8qnbxIzzY4p,fbPkOYLVPtPgIt0MxizjfFJov3JbHyAi,12,18,5,5,7,7,5,0,47,6.714285714285714,1,0.0,11,5,4,7,7,7,1,5,0,27,20,1
2564,70750,IUee3dxL3SpdHZIyH7i51dwHDxPaEBUA,fbPkOYLVPtPgIt0MxizjfFJov3JbHyAi,5,4,3,0,0,2,2,0,11,1.5714285714285714,1,0.0,0,3,0,0,4,2,0,2,0,3,8,1
2565,70752,SQJaiB30pTjKgZfQdgaYh0tKJZ2Vbeya,fbPkOYLVPtPgIt0MxizjfFJov3JbHyAi,5,2,1,0,1,5,4,0,13,1.8571428571428572,1,0.0,0,1,0,1,2,5,0,4,0,2,11,1
2566,70753,pPpyZpCndPvCUqSYWY13yKivGYGNWTDN,fbPkOYLVPtPgIt0MxizjfFJov3JbHyAi,10,5,2,0,2,0,6,1,16,2.2857142857142856,2,0.0,0,2,0,2,5,0,0,6,1,4,12,1
2567,70757,lvOGlvq1OFLMKhaj3JewwbbVHWgR6eFx,fbPkOYLVPtPgIt0MxizjfFJov3JbHyAi,5,2,1,0,1,0,2,0,6,0.8571428571428571,1,0.0,0,1,0,1,2,0,0,2,0,2,4,1
2568,70760,OqvR8B9aeDPyw7GoFTuy14iBmyo2yUUo,fbPkOYLVPtPgIt0MxizjfFJov3JbHyAi,1,0,0,0,0,0,1,0,1,0.14285714285714285,1,0.0,0,0,0,0,0,0,0,1,0,0,1,1
2569,70761,jlGY9VVNLsG0TC6XiI2Gb1hDNr4xsLUL,fbPkOYLVPtPgIt0MxizjfFJov3JbHyAi,1,0,0,0,0,0,1,0,1,0.14285714285714285,1,0.0,0,0,0,0,0,0,0,1,0,0,1,1
2570,70762,WwezrN5LILw3d1vvAAZRdwCqhKY8Em85,fbPkOYLVPtPgIt0MxizjfFJov3JbHyAi,1,0,0,0,0,0,1,0,1,0.14285714285714285,1,0.0,0,0,0,0,0,0,0,1,0,0,1,1
2571,70764,tLk8QFN3K7Bcj6ufd8b4XKqxIHVe1uKA,fbPkOYLVPtPgIt0MxizjfFJov3JbHyAi,5,2,1,0,1,0,2,0,6,0.8571428571428571,1,0.0,0,1,0,1,2,0,0,2,0,2,4,1
2572,70765,tGM2jlTFxHBYs0VdqQh38eEUGkMospiQ,fbPkOYLVPtPgIt0MxizjfFJov3JbHyAi,5,6,0,0,0,2,2,0,10,1.4285714285714286,1,0.0,1,0,0,0,5,2,0,2,0,1,9,1
2573,70769,ZkpfVZ9dukn1hNLus0iW46eniC4TxZ6X,fbPkOYLVPtPgIt0MxizjfFJov3JbHyAi,1,0,0,0,0,0,1,0,1,0.14285714285714285,1,0.0,0,0,0,0,0,0,0,1,0,0,1,1
2574,70770,HTGoS5GBox39vCiJgxlIGI9vDOWsXL3B,fbPkOYLVPtPgIt0MxizjfFJov3JbHyAi,1,0,0,0,0,0,1,0,1,0.14285714285714285,1,0.0,0,0,0,0,0,0,0,1,0,0,1,1
2575,70771,4kLcf1sktZawnqU0fFOj7xHNGXJNEsqd,fbPkOYLVPtPgIt0MxizjfFJov3JbHyAi,5,2,1,0,1,0,2,0,6,0.8571428571428571,1,0.0,0,1,0,1,2,0,0,2,0,2,4,1
2576,70772,pSL3xyt1UkD2OS3D0WJIKUXPhJ7M3COF,fbPkOYLVPtPgIt0MxizjfFJov3JbHyAi,5,3,1,0,1,4,4,0,13,1.8571428571428572,2,0.0,0,1,0,1,3,4,0,4,0,2,11,1
2577,70773,0HbAPj0XnG7vlXZFqJF9LLMjlYRkGlju,fbPkOYLVPtPgIt0MxizjfFJov3JbHyAi,5,2,1,0,1,0,2,0,6,0.8571428571428571,1,0.0,0,1,0,1,2,0,0,2,0,2,4,1
2578,70774,u8utNBdxE23PvPDWJ6xVLDwIgTiwdrjZ,fbPkOYLVPtPgIt0MxizjfFJov3JbHyAi,7,3,2,0,2,0,5,0,12,1.7142857142857142,1,0.0,0,2,0,2,3,0,0,5,0,4,8,1
2579,70775,gefkY5cBNvxKJUtGlDogpcQymljtkCst,fbPkOYLVPtPgIt0MxizjfFJov3JbHyAi,7,7,2,0,1,0,5,0,15,2.142857142857143,1,0.0,0,2,0,1,7,0,0,5,0,3,12,1
2580,70776,QjEHoumOE3gC1HJbKGy6t8704j46vuue,fbPkOYLVPtPgIt0MxizjfFJov3JbHyAi,5,2,1,0,1,0,2,0,6,0.8571428571428571,1,0.0,0,1,0,1,2,0,0,2,0,2,4,1
2581,70779,i26V50afV6u2Oz8a9ixc5ngW3fXqCcxA,fbPkOYLVPtPgIt0MxizjfFJov3JbHyAi,1,0,0,0,0,0,1,0,1,0.14285714285714285,1,0.0,0,0,0,0,0,0,0,1,0,0,1,1
2582,70780,sEr814ypFl2X1b9bje9rxXB65bZC1Pq5,fbPkOYLVPtPgIt0MxizjfFJov3JbHyAi,6,1,1,0,1,0,6,0,9,1.2857142857142858,1,0.0,0,1,0,1,1,0,0,6,0,2,7,1
2583,70781,ctdO04zd7K8QUa5HFdH2dxaEs6nEQGcX,fbPkOYLVPtPgIt0MxizjfFJov3JbHyAi,5,4,3,0,1,1,2,0,11,1.5714285714285714,1,0.0,0,3,0,1,4,1,0,2,0,4,7,0
2584,70783,mjSdUbH7OSJo2BOaPOnuv8MaiHH7FYld,fbPkOYLVPtPgIt0MxizjfFJov3JbHyAi,7,7,1,0,1,0,6,0,15,2.142857142857143,1,0.0,0,1,0,1,7,0,0,6,0,2,13,1
2585,70784,aF5137RwRQKiOvbUfzDxmAlUCEx92fD4,fbPkOYLVPtPgIt0MxizjfFJov3JbHyAi,1,0,0,0,0,0,1,0,1,0.14285714285714285,1,0.0,0,0,0,0,0,0,0,1,0,0,1,1
2586,70787,Oul8bw2tz24DOZALLi9OxblcSUmg6nEp,fbPkOYLVPtPgIt0MxizjfFJov3JbHyAi,1,0,0,0,0,0,1,0,1,0.14285714285714285,1,0.0,0,0,0,0,0,0,0,1,0,0,1,1
2587,70789,mCnzi5BmvpEBZDUN0ETW99FPkWmNtKNX,fbPkOYLVPtPgIt0MxizjfFJov3JbHyAi,1,0,0,0,0,0,1,0,1,0.14285714285714285,1,0.0,0,0,0,0,0,0,0,1,0,0,1,1
2588,70793,7SossPIJgp94YSmcs9GpN1Sm5zV7LKJL,fbPkOYLVPtPgIt0MxizjfFJov3JbHyAi,7,2,1,0,1,0,3,0,7,1.0,1,0.0,0,1,0,1,2,0,0,3,0,2,5,1
2589,70794,JMM8zz1Uply0QN5h5fJ96sYTBK2yeOxI,fbPkOYLVPtPgIt0MxizjfFJov3JbHyAi,9,6,1,0,1,0,6,0,14,2.0,1,0.0,0,1,0,1,6,0,0,6,0,2,12,1
2590,70796,t9IYCo7lv1UoShjijTGehWjAkf2pn5n5,fbPkOYLVPtPgIt0MxizjfFJov3JbHyAi,5,7,0,0,0,0,4,0,11,1.5714285714285714,1,0.0,0,0,0,0,7,0,0,4,0,0,11,1
2591,70797,uu7UzVxYYlz1pgYD2MFJ9iOaqFHTpesA,fbPkOYLVPtPgIt0MxizjfFJov3JbHyAi,7,4,2,0,1,2,4,1,14,2.0,2,0.0,0,2,0,1,4,2,0,4,1,3,11,1
2592,70799,fanbcR91UHcbTVNiIv1nQj1qUYZ30rX0,fbPkOYLVPtPgIt0MxizjfFJov3JbHyAi,1,0,0,0,0,0,1,0,1,0.14285714285714285,1,0.0,0,0,0,0,0,0,0,1,0,0,1,1
2593,70803,ssyd9rdEHVqPnd0fx1MHuvIhEU773VLT,fbPkOYLVPtPgIt0MxizjfFJov3JbHyAi,2,0,0,0,0,0,3,0,3,0.42857142857142855,1,0.0,0,0,0,0,0,0,0,3,0,0,3,1
2594,70804,1NKuiSaTPUbZFDACCyv5YoUfO7qDer9w,fbPkOYLVPtPgIt0MxizjfFJov3JbHyAi,6,6,2,0,1,0,2,0,11,1.5714285714285714,1,0.0,2,2,0,1,4,0,0,2,0,5,6,1
2595,70808,lpmkkM8oiYpde5WjxbhcBFXAV9lrOr4z,fbPkOYLVPtPgIt0MxizjfFJov3JbHyAi,2,0,0,0,0,0,3,0,3,0.42857142857142855,1,0.0,0,0,0,0,0,0,0,3,0,0,3,1
2596,70809,Fr6BZTrWQKFo57dNUS0jHL2UnsMPDOqr,fbPkOYLVPtPgIt0MxizjfFJov3JbHyAi,6,1,1,0,1,0,3,0,6,0.8571428571428571,1,0.0,0,1,0,1,1,0,0,3,0,2,4,1
2597,70812,CkTzCZEBDUKVj2CxuBE6PIjgAxiqFn5E,fbPkOYLVPtPgIt0MxizjfFJov3JbHyAi,2,0,0,0,0,0,2,0,2,0.2857142857142857,1,0.0,0,0,0,0,0,0,0,2,0,0,2,1
2598,70813,yk15CHpjIZz9cgwSjdiK1bpIkmjG49Ja,fbPkOYLVPtPgIt0MxizjfFJov3JbHyAi,3,0,0,0,0,0,3,0,3,0.42857142857142855,1,0.0,0,0,0,0,0,0,0,3,0,0,3,1
2599,70814,7DDb0W5dNil3mOKBSIGlg2cdwn7LYTP2,fbPkOYLVPtPgIt0MxizjfFJov3JbHyAi,9,9,5,0,4,0,5,0,23,3.2857142857142856,1,0.0,0,5,0,4,9,0,0,5,0,9,14,1
2600,70817,D8q3p28oNnCDKOIbiGQbgveHVNlF4K29,fbPkOYLVPtPgIt0MxizjfFJov3JbHyAi,4,3,0,0,0,0,1,0,4,0.5714285714285714,1,0.0,0,0,0,0,3,0,0,1,0,0,4,1
2601,70820,ELhlMyuHt1scQfOhkxfCzXRENMteryFF,fbPkOYLVPtPgIt0MxizjfFJov3JbHyAi,5,1,1,0,1,0,2,0,5,0.7142857142857143,1,0.0,0,1,0,1,1,0,0,2,0,2,3,1
2602,70821,1DYVtevZL3aXGY7HGRbaRGOoCf6sTS9c,fbPkOYLVPtPgIt0MxizjfFJov3JbHyAi,6,3,1,0,1,0,2,0,7,1.0,1,0.0,0,1,0,1,3,0,0,2,0,2,5,1
2603,70822,k8AJw7WDdTwEOJNmtUY3WESJ7YjggqcB,fbPkOYLVPtPgIt0MxizjfFJov3JbHyAi,8,3,2,0,2,0,5,0,12,1.7142857142857142,1,0.0,0,2,0,2,3,0,0,5,0,4,8,1
2604,70823,EORvS3nZwxrQaK5VcaXN4Zq4BMWJUMRs,fbPkOYLVPtPgIt0MxizjfFJov3JbHyAi,5,2,1,0,1,0,2,0,6,0.8571428571428571,1,0.0,0,1,0,1,2,0,0,2,0,2,4,1
2605,70824,V68nYWLc75b2tl11Mh8jvaF8SbKiBV2d,fbPkOYLVPtPgIt0MxizjfFJov3JbHyAi,8,2,2,0,2,0,5,0,11,1.5714285714285714,1,0.0,0,2,0,2,2,0,0,5,0,4,7,1
2606,70825,oPTYZ3PJdSd8ml5amG32UA8HE12eiUok,fbPkOYLVPtPgIt0MxizjfFJov3JbHyAi,1,0,0,0,0,0,1,0,1,0.14285714285714285,1,0.0,0,0,0,0,0,0,0,1,0,0,1,1
2607,70826,j3jyWJflvqAFzJJxwhnXOjHUHBgIVWxk,fbPkOYLVPtPgIt0MxizjfFJov3JbHyAi,5,0,0,0,0,0,8,1,9,1.2857142857142858,1,0.0,0,0,0,0,0,0,0,8,1,0,9,1
2608,70828,fK4SC23SdBJjy6ZJHLxy5rG3k6OEQhRL,fbPkOYLVPtPgIt0MxizjfFJov3JbHyAi,2,0,0,0,0,0,2,0,2,0.2857142857142857,1,0.0,0,0,0,0,0,0,0,2,0,0,2,1
2609,70829,xUwzuL2GpG7tsntxE4jr1sQzSM0uvwiU,fbPkOYLVPtPgIt0MxizjfFJov3JbHyAi,1,0,0,0,0,0,2,0,2,0.2857142857142857,1,0.0,0,0,0,0,0,0,0,2,0,0,2,1
2610,70830,riMtgGmUwEsIgmPcMgfRpJw7h8RVspUI,fbPkOYLVPtPgIt0MxizjfFJov3JbHyAi,8,5,3,0,2,0,5,0,15,2.142857142857143,1,0.0,0,3,0,2,5,0,0,5,0,5,10,1
2611,70831,o5TpAjMe8TM6a528HMcKqr5zZTFMsmaP,fbPkOYLVPtPgIt0MxizjfFJov3JbHyAi,5,2,1,0,1,0,3,0,7,1.0,1,0.0,0,1,0,1,2,0,0,3,0,2,5,1
2612,70832,YZxXVaDyfqjJPwTonj6xC3yeCKyyMcwI,fbPkOYLVPtPgIt0MxizjfFJov3JbHyAi,13,7,5,0,4,1,14,1,32,4.571428571428571,1,0.0,0,5,0,4,7,1,0,14,1,9,23,1
2613,70833,4kqdE82TaUj9Ob6PVxpRbM2PysfdMkCH,fbPkOYLVPtPgIt0MxizjfFJov3JbHyAi,2,0,0,0,0,0,2,0,2,0.2857142857142857,1,0.0,0,0,0,0,0,0,0,2,0,0,2,1
2614,70836,2WmhxllOxqyxpNvuB1Z1rT8LyIpEZOpF,fbPkOYLVPtPgIt0MxizjfFJov3JbHyAi,5,2,1,0,1,0,4,0,8,1.1428571428571428,1,0.0,0,1,0,1,2,0,0,4,0,2,6,1
2615,70837,afJgM79zX2Cd4ccBAriQnfjQcEwLizk6,fbPkOYLVPtPgIt0MxizjfFJov3JbHyAi,6,2,1,0,1,0,4,0,8,1.1428571428571428,1,0.0,0,1,0,1,2,0,0,4,0,2,6,1
2616,70839,Kc2ZLOGfjK9xNvMUO1HfN3eAcuOUNA78,fbPkOYLVPtPgIt0MxizjfFJov3JbHyAi,8,6,4,6,4,0,2,0,22,3.142857142857143,1,0.0,1,4,5,4,5,0,1,2,0,14,8,1
2617,70840,5fjtZf3Xc8lWt8s6egMqZtlShhUGjtFd,fbPkOYLVPtPgIt0MxizjfFJov3JbHyAi,1,0,0,0,0,0,2,0,2,0.2857142857142857,1,0.0,0,0,0,0,0,0,0,2,0,0,2,1
2618,70842,fZXWFljczIs2zKTKNU8XHxkkGuihaYBi,fbPkOYLVPtPgIt0MxizjfFJov3JbHyAi,9,2,2,0,2,0,9,0,15,2.142857142857143,1,0.0,0,2,0,2,2,0,0,9,0,4,11,1
2619,70845,32PywyFA7AkNsj9LytGcBkA7FP2gdk44,fbPkOYLVPtPgIt0MxizjfFJov3JbHyAi,11,6,4,0,4,0,2,0,16,2.2857142857142856,1,0.0,1,4,0,4,5,0,0,2,0,9,7,1
2620,70846,9MUoTs0to78yIRrWTuXVx5TqwwKqlOPH,fbPkOYLVPtPgIt0MxizjfFJov3JbHyAi,5,3,0,0,0,0,6,0,9,1.2857142857142858,1,0.0,0,0,0,0,3,0,0,6,0,0,9,1
2621,70847,RAvsZ60Di0pQF1FWzazLKNgo4gQa7NT4,fbPkOYLVPtPgIt0MxizjfFJov3JbHyAi,5,2,1,0,1,0,2,0,6,0.8571428571428571,1,0.0,0,1,0,1,2,0,0,2,0,2,4,1
2622,70850,ynbc4a4L1nKWaQxbZwKtj7FjbYhjhhuF,fbPkOYLVPtPgIt0MxizjfFJov3JbHyAi,9,9,4,0,4,6,8,1,32,4.571428571428571,1,0.0,2,4,0,4,7,6,0,8,1,10,22,1
2623,70854,tg8ij1J8ppYeqUKBQEMOpFULhUiviSC2,fbPkOYLVPtPgIt0MxizjfFJov3JbHyAi,9,6,3,0,2,0,3,0,14,2.0,1,0.0,0,3,0,2,6,0,0,3,0,5,9,1
2624,70855,qpLrdk2TB7GVW6GaJkCWKNJYyd2ZkyLM,fbPkOYLVPtPgIt0MxizjfFJov3JbHyAi,1,0,0,0,0,0,1,0,1,0.14285714285714285,1,0.0,0,0,0,0,0,0,0,1,0,0,1,1
2625,70858,4oK5zfJFZ9TDAoTvsTlgrbulTcK542q2,fbPkOYLVPtPgIt0MxizjfFJov3JbHyAi,1,0,0,0,0,0,1,0,1,0.14285714285714285,1,0.0,0,0,0,0,0,0,0,1,0,0,1,1
2626,70859,VkEXjyLrlFj2CVFPhpeVw6CAqjFXGva0,fbPkOYLVPtPgIt0MxizjfFJov3JbHyAi,2,0,0,0,0,0,2,0,2,0.2857142857142857,1,0.0,0,0,0,0,0,0,0,2,0,0,2,1
2627,70861,6IJVUSEMpeG6F6UAW6d6aBbrEWsQ8azq,fbPkOYLVPtPgIt0MxizjfFJov3JbHyAi,8,4,2,0,2,0,2,0,10,1.4285714285714286,1,0.0,0,2,0,2,4,0,0,2,0,4,6,1
2628,70862,I1a9vqQH46q1bfrkbp3ETeJrS6dPcAC4,fbPkOYLVPtPgIt0MxizjfFJov3JbHyAi,4,2,1,0,1,0,1,0,5,0.7142857142857143,1,0.0,0,1,0,1,2,0,0,1,0,2,3,1
2629,70864,YJYft8Pp3kKpsnAX9YvA8ajUcBQBHE3D,fbPkOYLVPtPgIt0MxizjfFJov3JbHyAi,2,0,0,0,0,0,4,0,4,0.5714285714285714,1,0.0,0,0,0,0,0,0,0,4,0,0,4,1
2630,70866,I6VmaLF2DMFBmVoL127xEyjprXeqzx0a,fbPkOYLVPtPgIt0MxizjfFJov3JbHyAi,1,0,0,0,0,0,1,0,1,0.14285714285714285,1,0.0,0,0,0,0,0,0,0,1,0,0,1,1
2631,70867,Y1l5HeKL2xGQ4Lkb5zNCgu2DeFrAlTw8,fbPkOYLVPtPgIt0MxizjfFJov3JbHyAi,1,0,0,0,0,0,1,0,1,0.14285714285714285,1,0.0,0,0,0,0,0,0,0,1,0,0,1,1
2632,70869,LowxZv7QGeTRZfT1csfuXH5r1UZa4mVS,fbPkOYLVPtPgIt0MxizjfFJov3JbHyAi,2,0,0,0,0,0,2,0,2,0.2857142857142857,1,0.0,0,0,0,0,0,0,0,2,0,0,2,1
2633,70870,NaTkGN0OVzlcYhXnPctl6N7eYxY7z7gT,fbPkOYLVPtPgIt0MxizjfFJov3JbHyAi,9,8,6,0,4,0,3,0,21,3.0,1,0.0,2,6,0,4,6,0,0,3,0,12,9,1
2634,70872,tqL96lBifCNy09m1ns0UwqJwea5MwY8p,fbPkOYLVPtPgIt0MxizjfFJov3JbHyAi,5,2,1,0,1,0,2,0,6,0.8571428571428571,1,0.0,0,1,0,1,2,0,0,2,0,2,4,1
2635,70875,nFDMbovZeON7sHMHTJjtcsqufxGoPyJM,fbPkOYLVPtPgIt0MxizjfFJov3JbHyAi,7,3,2,0,2,13,3,0,23,3.2857142857142856,1,0.0,0,2,0,2,3,13,0,3,0,4,19,1
2636,70876,MJ4Uban6VG5v2fJm4mTva4c0ih2DGhnb,fbPkOYLVPtPgIt0MxizjfFJov3JbHyAi,1,0,0,0,0,0,1,0,1,0.14285714285714285,1,0.0,0,0,0,0,0,0,0,1,0,0,1,1
2637,70877,54WhnApSVDtiavajsWLmVxiyF7WDQOJu,fbPkOYLVPtPgIt0MxizjfFJov3JbHyAi,6,2,1,0,1,0,3,1,8,1.1428571428571428,1,0.0,0,1,0,1,2,0,0,3,1,2,6,1
2638,70884,d5N36ltJLuexchMmFNrBfpp3LZsF74JT,fbPkOYLVPtPgIt0MxizjfFJov3JbHyAi,6,4,2,0,3,0,4,1,14,2.0,1,0.0,1,2,0,3,3,0,0,4,1,6,8,0
2639,70885,Qn4oQ1lJoD4ucx7ZxtRp3oFmTZaTCpvg,fbPkOYLVPtPgIt0MxizjfFJov3JbHyAi,6,11,1,0,1,0,2,0,15,2.142857142857143,1,0.0,0,1,0,1,11,0,0,2,0,2,13,1
2640,70888,Xa0yw5PV4YIPq4eEJJzljtBOuhOF0jib,fbPkOYLVPtPgIt0MxizjfFJov3JbHyAi,1,0,0,0,0,0,1,0,1,0.14285714285714285,1,0.0,0,0,0,0,0,0,0,1,0,0,1,1
2641,70889,k1wwEuRLRVBVQA9v2crFDSBLM3kZLoUU,fbPkOYLVPtPgIt0MxizjfFJov3JbHyAi,1,0,0,0,0,0,1,0,1,0.14285714285714285,1,0.0,0,0,0,0,0,0,0,1,0,0,1,1
2642,70891,Q1IUtiIo2SS94zzJgNzczdxtoIMSWoLW,fbPkOYLVPtPgIt0MxizjfFJov3JbHyAi,1,0,0,0,0,0,1,0,1,0.14285714285714285,1,0.0,0,0,0,0,0,0,0,1,0,0,1,1
2643,70894,oKN2xGH7PD9pLBHMPHUcfj3zTJV8tvd5,fbPkOYLVPtPgIt0MxizjfFJov3JbHyAi,5,2,1,0,1,0,2,0,6,0.8571428571428571,1,0.0,0,1,0,1,2,0,0,2,0,2,4,1
2644,70896,U6LzAVwYbxAVbRMMxjnV16LKATxmA2bk,fbPkOYLVPtPgIt0MxizjfFJov3JbHyAi,7,2,1,0,1,0,4,1,9,1.2857142857142858,1,0.0,0,1,0,1,2,0,0,4,1,2,7,1
2645,70897,83JPfkin3GX4GLKqML2uaHSZ5KvsuJhM,fbPkOYLVPtPgIt0MxizjfFJov3JbHyAi,2,0,0,0,0,0,2,0,2,0.2857142857142857,1,0.0,0,0,0,0,0,0,0,2,0,0,2,1
2646,70898,u8Y97sSr2xWs294k9cdsB9u79pU8RMWs,fbPkOYLVPtPgIt0MxizjfFJov3JbHyAi,7,3,2,0,2,0,2,0,9,1.2857142857142858,1,0.0,0,2,0,2,3,0,0,2,0,4,5,0
2647,70899,tfQATW81rZGgOpzlf2lkFqeziBeMELEX,fbPkOYLVPtPgIt0MxizjfFJov3JbHyAi,2,0,0,0,0,0,3,0,3,0.42857142857142855,1,0.0,0,0,0,0,0,0,0,3,0,0,3,1
2648,70905,OrhyJL1JbaOfmgNByKgbYgqzq4Sm4HlT,G8EPVSXsOYB5YQWZGiz1aVq5Pgr2GrQu,39,37,14,76,8,0,6,0,141,20.142857142857142,2,0.0,17,14,53,8,20,0,23,6,0,92,49,1
2649,70908,B6p5x6qI5IapFaeXO9jhM5m7rqDF4l8p,SpATywNh6bZuzm8s1ceuBUnMUAeoAHHw,7,3,2,6,1,0,3,0,15,2.142857142857143,2,0.0,1,2,5,1,2,0,1,3,0,9,6,0
2650,70917,Iv5H8eRk1KgfQB11AxWDsPacAIgml2Fq,SpATywNh6bZuzm8s1ceuBUnMUAeoAHHw,15,20,10,10,4,0,4,0,48,6.857142857142857,2,0.0,5,10,9,4,15,0,1,4,0,28,20,1
2651,70941,hplRuUXyLFhHcMqMJcb12YjqquTYp3Qw,bWdj2GDclj5ofokWjzoa5jAwMkxCykd6,7,8,5,0,3,0,1,0,17,2.4285714285714284,3,0.0,0,5,0,3,8,0,0,1,0,8,9,1
2652,70964,AtOHbVb7kxzZIoD2M5RWKjBCYCoDUPL6,SpATywNh6bZuzm8s1ceuBUnMUAeoAHHw,17,28,8,28,2,0,5,0,71,10.142857142857142,4,0.0,18,8,23,2,10,0,5,5,0,51,20,0
2653,70969,Ooaq1toVrKJC9KROMnT52Id1rqx2sDam,A3fsA9Zfv1X2fVEQhTw51lKENdNrEqT3,28,26,12,90,1,11,13,0,153,21.857142857142858,6,0.0,1,12,70,1,25,11,20,13,0,84,69,0
2654,70994,EMrObXWheuWLSYoJOoJqZbkDhx4X9COM,SpATywNh6bZuzm8s1ceuBUnMUAeoAHHw,20,29,1,16,0,5,7,1,59,8.428571428571429,2,0.0,3,1,15,0,26,5,1,7,1,19,40,1
2655,70998,VuxUQKMDYsA4LWFsDh3lY6mcAw5xbtkR,SpATywNh6bZuzm8s1ceuBUnMUAeoAHHw,7,15,3,0,1,2,4,0,25,3.5714285714285716,2,0.0,5,3,0,1,10,2,0,4,0,9,16,0
2656,71000,SuOS5e9JRupQcpgzaLejcvmk4nnyhsIA,A3fsA9Zfv1X2fVEQhTw51lKENdNrEqT3,6,4,3,0,3,0,1,0,11,1.5714285714285714,1,0.0,0,3,0,3,4,0,0,1,0,6,5,1
2657,71001,Qty87BeKrf3ZgzVA2PT9rBe28vADAPbJ,A3fsA9Zfv1X2fVEQhTw51lKENdNrEqT3,3,2,1,0,0,0,1,0,4,0.5714285714285714,1,0.0,0,1,0,0,2,0,0,1,0,1,3,0
2658,71025,Sk4DUKJRImF6lijTnkABuH01jDj9zcnP,RXDvfPUBYFlVdlueBFbLW0mhhAyGEqpt,1,0,0,0,0,0,1,0,1,0.14285714285714285,1,0.0,0,0,0,0,0,0,0,1,0,0,1,1
2659,71027,oDMwcP97XCFhatRKDALyEk29j0A66Zee,A3fsA9Zfv1X2fVEQhTw51lKENdNrEqT3,11,4,3,0,3,1,18,1,30,4.285714285714286,4,0.0,1,3,0,3,3,1,0,18,1,7,23,1
2660,71036,SbxWcDAQO1PnIdll82O1Qa8HqEHuIfT7,SpATywNh6bZuzm8s1ceuBUnMUAeoAHHw,4,2,0,0,0,0,3,0,5,0.7142857142857143,1,0.0,0,0,0,0,2,0,0,3,0,0,5,1
2661,71042,Rz8bL6jCH0Pf0jvKzb91yxe7VkOLAlQk,SpATywNh6bZuzm8s1ceuBUnMUAeoAHHw,7,8,0,0,0,0,10,2,20,2.857142857142857,1,0.0,0,0,0,0,8,0,0,10,2,0,20,1
2662,71078,dfEK3xvueeR9teWVma5VAaO4dthOOslM,bWdj2GDclj5ofokWjzoa5jAwMkxCykd6,14,24,1,18,1,0,12,0,56,8.0,2,0.0,6,1,16,1,18,0,2,12,0,24,32,1
2663,71085,niCfrernMgxaiAe4XJm2E9uKlmDuNpx3,SpATywNh6bZuzm8s1ceuBUnMUAeoAHHw,1,0,0,0,0,0,1,0,1,0.14285714285714285,1,0.0,0,0,0,0,0,0,0,1,0,0,1,1
2664,71094,8IMVGvB09WRKHeXEjWGkZOVu6CXmlVXA,RXDvfPUBYFlVdlueBFbLW0mhhAyGEqpt,6,4,1,0,1,0,1,0,7,1.0,1,0.0,0,1,0,1,4,0,0,1,0,2,5,1
2665,71101,kv6R7WjolUetaoWMs79hGLWsktu3yDdz,SpATywNh6bZuzm8s1ceuBUnMUAeoAHHw,5,4,1,0,0,0,2,0,7,1.0,2,0.0,0,1,0,0,4,0,0,2,0,1,6,1
2666,71121,WonWbBpwgN3XpAwPD3B5sUYZEtzBanfo,A3fsA9Zfv1X2fVEQhTw51lKENdNrEqT3,2,0,0,0,0,0,3,0,3,0.42857142857142855,1,0.0,0,0,0,0,0,0,0,3,0,0,3,1
2667,71122,WonWbBpwgN3XpAwPD3B5sUYZEtzBanfo,bWdj2GDclj5ofokWjzoa5jAwMkxCykd6,1,0,0,0,0,0,1,0,1,0.14285714285714285,1,0.0,0,0,0,0,0,0,0,1,0,0,1,1
2668,71124,5niJhzBqY5BWt03iPKjNSLwlp6bq9sIM,SpATywNh6bZuzm8s1ceuBUnMUAeoAHHw,7,3,1,0,2,0,2,0,8,1.1428571428571428,1,0.0,0,1,0,2,3,0,0,2,0,3,5,1
2669,71144,Ze9kgklMuT1yRhjZzYqZ128xNCVJ9Ing,G8EPVSXsOYB5YQWZGiz1aVq5Pgr2GrQu,6,4,1,0,1,0,2,0,8,1.1428571428571428,1,0.0,0,1,0,1,4,0,0,2,0,2,6,1
2670,71148,nzvOBXg9mmjIbNHZZO9eP5MzuZiA7QBu,SpATywNh6bZuzm8s1ceuBUnMUAeoAHHw,8,8,6,0,3,0,3,0,20,2.857142857142857,2,0.0,0,6,0,3,8,0,0,3,0,9,11,1
2671,71161,FixP7IuJ80KsWtzMzcQsJZKOjLxDKZgC,bWdj2GDclj5ofokWjzoa5jAwMkxCykd6,1,0,0,0,0,0,1,0,1,0.14285714285714285,1,0.0,0,0,0,0,0,0,0,1,0,0,1,1
2672,71164,GqY8cM6bEQ2o2zTrfF7msueNZ1f4HNE4,A3fsA9Zfv1X2fVEQhTw51lKENdNrEqT3,10,7,1,0,1,0,2,0,11,1.5714285714285714,1,0.0,0,1,0,1,7,0,0,2,0,2,9,1
2673,71174,axaScF3P7Dmq9RVjqcR7oOXvuGJjIWKx,SpATywNh6bZuzm8s1ceuBUnMUAeoAHHw,6,7,1,0,1,0,2,0,11,1.5714285714285714,1,0.0,0,1,0,1,7,0,0,2,0,2,9,0
2674,71177,moqDrkL7HaqSVPAIPOv1C3iTYb2EoCoF,A3fsA9Zfv1X2fVEQhTw51lKENdNrEqT3,36,25,1,82,0,12,6,0,126,18.0,1,0.0,3,1,67,0,22,12,15,6,0,71,55,1
2675,71183,v6Wfy2XnikKgnCNfehO3TIQzyPp7MzcN,RXDvfPUBYFlVdlueBFbLW0mhhAyGEqpt,2,0,0,0,0,0,2,0,2,0.2857142857142857,1,0.0,0,0,0,0,0,0,0,2,0,0,2,1
2676,71191,a5Mkdg3fnTGCu7x8lN0CyRFil7seaApN,SpATywNh6bZuzm8s1ceuBUnMUAeoAHHw,10,22,10,0,1,3,24,0,60,8.571428571428571,2,0.0,0,10,0,1,22,3,0,24,0,11,49,1
2677,71194,AeStUweNOwwDKml97drefO9KmmqkdvwG,bWdj2GDclj5ofokWjzoa5jAwMkxCykd6,2,0,0,0,0,0,2,0,2,0.2857142857142857,1,0.0,0,0,0,0,0,0,0,2,0,0,2,1
2678,71195,4k7x6DcNdq1PRhbqFmfcKoI6JpPSJsyb,G8EPVSXsOYB5YQWZGiz1aVq5Pgr2GrQu,17,43,1,0,1,0,6,0,51,7.285714285714286,2,0.0,0,1,0,1,43,0,0,6,0,2,49,1
2679,71212,VaOhD86uWnK2TjloSi50DgiXbw9C3K0T,A3fsA9Zfv1X2fVEQhTw51lKENdNrEqT3,11,29,9,0,6,0,4,0,48,6.857142857142857,2,0.0,0,9,0,6,29,0,0,4,0,15,33,1
2680,71222,mRThjjGON0zU0Y2plEdpqVN16fEiXwSr,bWdj2GDclj5ofokWjzoa5jAwMkxCykd6,7,4,3,0,2,0,1,0,10,1.4285714285714286,1,0.0,0,3,0,2,4,0,0,1,0,5,5,1
2681,71253,TPJCnKhFzWhbo2FKOiMksWmjMVFIKGgD,SpATywNh6bZuzm8s1ceuBUnMUAeoAHHw,5,3,1,0,1,0,2,0,7,1.0,1,0.0,1,1,0,1,2,0,0,2,0,3,4,1
2682,71272,CeGIsWlT0KBVS1hQGCUY2KCY4J9xzr3t,SpATywNh6bZuzm8s1ceuBUnMUAeoAHHw,14,10,0,14,0,0,3,0,27,3.857142857142857,1,0.0,2,0,13,0,8,0,1,3,0,15,12,1
2683,71289,VObPdzDYiBKi8TLPXY1g1HS4rT0eO4IR,RXDvfPUBYFlVdlueBFbLW0mhhAyGEqpt,20,22,10,30,8,0,7,0,77,11.0,1,0.0,7,10,27,8,15,0,3,7,0,52,25,1
2684,71291,TdqsraGiWnME5OctPE2I7wQ3BMLqTuwl,SpATywNh6bZuzm8s1ceuBUnMUAeoAHHw,5,9,1,0,1,0,3,0,14,2.0,2,0.0,2,1,0,1,7,0,0,3,0,4,10,1
2685,71305,lBX5Yzu1Dk0lwimtM6RHOAgAth8sqjDN,G8EPVSXsOYB5YQWZGiz1aVq5Pgr2GrQu,22,24,6,26,2,0,1,0,59,8.428571428571429,1,0.0,12,6,14,2,12,0,12,1,0,34,25,1
2686,71355,HwPaWKFgttQqp1SWzLrqkMuI2ELbGJaG,G8EPVSXsOYB5YQWZGiz1aVq5Pgr2GrQu,1,0,0,0,0,0,1,0,1,0.14285714285714285,1,0.0,0,0,0,0,0,0,0,1,0,0,1,1
2687,71362,f6IvpzZQ4NKKZIUTkgWEi3BVq577qLnM,SpATywNh6bZuzm8s1ceuBUnMUAeoAHHw,5,2,1,0,0,10,7,0,20,2.857142857142857,2,0.0,0,1,0,0,2,10,0,7,0,1,19,0
2688,71375,fol611Bi6YnD4zjFVUOPJixEwpbUH6yt,SpATywNh6bZuzm8s1ceuBUnMUAeoAHHw,2,0,0,0,0,0,3,0,3,0.42857142857142855,2,0.0,0,0,0,0,0,0,0,3,0,0,3,0
2689,71380,4Q0hw7idVzdmILVQjJdMPqXbEU97hajF,A3fsA9Zfv1X2fVEQhTw51lKENdNrEqT3,1,0,0,0,0,0,2,0,2,0.2857142857142857,1,0.0,0,0,0,0,0,0,0,2,0,0,2,1
2690,71393,bzlTCtIUcO5BfACSIQwT3PRYSdK0QGTr,SpATywNh6bZuzm8s1ceuBUnMUAeoAHHw,15,15,11,0,5,0,3,0,34,4.857142857142857,2,0.0,1,11,0,5,14,0,0,3,0,17,17,1
2691,71441,VG72z05p4N4OFvxvgLIqa7VdIfM3Q8YO,A3fsA9Zfv1X2fVEQhTw51lKENdNrEqT3,1,0,0,0,0,0,1,0,1,0.14285714285714285,1,0.0,0,0,0,0,0,0,0,1,0,0,1,1
2692,71454,gxNweITMLFQ6uKW8j94tIvo0aCJTBt29,SpATywNh6bZuzm8s1ceuBUnMUAeoAHHw,2,0,0,0,0,0,2,0,2,0.2857142857142857,1,0.0,0,0,0,0,0,0,0,2,0,0,2,1
2693,71478,au4q0hHoeIchXXu4o0X9kRH2tLR2LkOi,SpATywNh6bZuzm8s1ceuBUnMUAeoAHHw,5,0,0,0,0,1,4,1,6,0.8571428571428571,1,0.0,0,0,0,0,0,1,0,4,1,0,6,1
2694,71492,AgmWWSmPg3HCFtB0FkZujRvKdZYey1as,SpATywNh6bZuzm8s1ceuBUnMUAeoAHHw,6,7,5,0,2,0,3,0,17,2.4285714285714284,2,0.0,0,5,0,2,7,0,0,3,0,7,10,1
2695,71503,2YohZ5UKGzy1qUgVAShosLdhgm3pfvsR,A3fsA9Zfv1X2fVEQhTw51lKENdNrEqT3,5,2,1,0,1,0,2,0,6,0.8571428571428571,1,0.0,0,1,0,1,2,0,0,2,0,2,4,1
2696,71505,vP0leqUpaGisQu73FfHJ6k2A2vAG6aiB,bWdj2GDclj5ofokWjzoa5jAwMkxCykd6,5,2,1,0,1,0,2,0,6,0.8571428571428571,1,0.0,0,1,0,1,2,0,0,2,0,2,4,1
2697,71521,SmONSyS4YgG4Afnv6ZxU81t7p4CQPV5P,G8EPVSXsOYB5YQWZGiz1aVq5Pgr2GrQu,1,0,0,0,0,0,1,0,1,0.14285714285714285,1,0.0,0,0,0,0,0,0,0,1,0,0,1,1
2698,71523,SmONSyS4YgG4Afnv6ZxU81t7p4CQPV5P,RXDvfPUBYFlVdlueBFbLW0mhhAyGEqpt,2,0,0,0,0,0,2,0,2,0.2857142857142857,1,0.0,0,0,0,0,0,0,0,2,0,0,2,0
2699,71526,PrwfjW9YGtDxqVBHDm7KtO2cr4GlU48n,SpATywNh6bZuzm8s1ceuBUnMUAeoAHHw,24,25,12,27,5,6,7,1,83,11.857142857142858,1,0.0,7,12,26,5,18,6,1,7,1,50,33,0
2700,71534,6kmRTTlm2tGjO1GkeO8yvcp6lmCvKO0m,A3fsA9Zfv1X2fVEQhTw51lKENdNrEqT3,8,4,2,0,1,1,5,0,13,1.8571428571428572,1,0.0,0,2,0,1,4,1,0,5,0,3,10,1
2701,71546,f1e5g73OiAut7IKbJN1QM0zdAV9QZu4j,G8EPVSXsOYB5YQWZGiz1aVq5Pgr2GrQu,19,23,8,0,6,2,8,0,47,6.714285714285714,1,0.0,4,8,0,6,19,2,0,8,0,18,29,0
2702,71552,wEaTyOJwwvOCk7eUttQISK5WPXL7ANNV,G8EPVSXsOYB5YQWZGiz1aVq5Pgr2GrQu,1,0,0,0,0,0,1,0,1,0.14285714285714285,1,0.0,0,0,0,0,0,0,0,1,0,0,1,1
2703,71612,L56U1ayQBSvA3ytGNrFwHPNpiuCpgXCq,A3fsA9Zfv1X2fVEQhTw51lKENdNrEqT3,36,15,9,50,8,0,4,0,86,12.285714285714286,1,0.0,4,9,46,8,11,0,4,4,0,67,19,1
2704,71616,Lt7VPheILDSvy2io7NudVCZ6gMhwTn9j,SpATywNh6bZuzm8s1ceuBUnMUAeoAHHw,1,0,0,0,0,0,1,0,1,0.14285714285714285,1,0.0,0,0,0,0,0,0,0,1,0,0,1,1
2705,71625,ddRUcnq8CFHBGHWZEDIhMAjA3ypo6C57,RXDvfPUBYFlVdlueBFbLW0mhhAyGEqpt,7,4,1,0,1,0,2,0,8,1.1428571428571428,1,0.0,0,1,0,1,4,0,0,2,0,2,6,1
2706,71642,YZqjHyJb9T1aeLqKSF3CKbXzYGNTpFDA,SpATywNh6bZuzm8s1ceuBUnMUAeoAHHw,5,3,0,0,0,0,2,0,5,0.7142857142857143,2,0.0,0,0,0,0,3,0,0,2,0,0,5,1
2707,71654,qTtdX55CV2fJxnEb7mhnsvXbisJZJyaM,bWdj2GDclj5ofokWjzoa5jAwMkxCykd6,2,0,0,0,0,0,2,0,2,0.2857142857142857,1,0.0,0,0,0,0,0,0,0,2,0,0,2,1
2708,71671,ElsXlbvFFCxkAZK5wxKh1k6NT3PqrFej,bWdj2GDclj5ofokWjzoa5jAwMkxCykd6,1,0,0,0,0,0,1,0,1,0.14285714285714285,1,0.0,0,0,0,0,0,0,0,1,0,0,1,1
2709,71679,udXq1W3W39FL5ELVdayz2yBuWe1SMQSB,SpATywNh6bZuzm8s1ceuBUnMUAeoAHHw,3,0,0,0,0,0,3,0,3,0.42857142857142855,1,0.0,0,0,0,0,0,0,0,3,0,0,3,1
2710,71687,G0R41qglSXZRKpF9p8Vfr2YtoPUNtseQ,A3fsA9Zfv1X2fVEQhTw51lKENdNrEqT3,1,0,0,0,0,0,1,0,1,0.14285714285714285,1,0.0,0,0,0,0,0,0,0,1,0,0,1,1
2711,71700,qGPfY7GDQqrO1DPuPdsJnIrEGeJp1MpX,SpATywNh6bZuzm8s1ceuBUnMUAeoAHHw,10,17,2,0,2,0,3,0,24,3.4285714285714284,1,0.0,0,2,0,2,17,0,0,3,0,4,20,1
2712,71702,JUwnpYDokyUXTC7SfWpuPqShDK4ZEqmX,A3fsA9Zfv1X2fVEQhTw51lKENdNrEqT3,11,5,4,0,4,1,7,1,22,3.142857142857143,3,0.0,0,4,0,4,5,1,0,7,1,8,14,1
2713,71712,TztthVt5KMop1hWx6wFArC8xg8H9VhnG,SpATywNh6bZuzm8s1ceuBUnMUAeoAHHw,13,10,7,0,4,0,4,0,25,3.5714285714285716,3,0.0,0,7,0,4,10,0,0,4,0,11,14,1
2714,71718,pcpAhLjoTN8lH8rrB4WzhaKSF9JUuI0T,G8EPVSXsOYB5YQWZGiz1aVq5Pgr2GrQu,7,5,4,0,3,0,3,0,15,2.142857142857143,1,0.0,0,4,0,3,5,0,0,3,0,7,8,1
2715,71737,5VlUeVUXRN1CcPaOOWsH3KOAj8dOWksi,G8EPVSXsOYB5YQWZGiz1aVq5Pgr2GrQu,27,25,13,24,8,0,4,0,74,10.571428571428571,2,0.0,6,13,18,8,19,0,6,4,0,45,29,1
2716,71765,RNIlCFbK1TpIi5Jv91aZZHNNmFBjGDjQ,SpATywNh6bZuzm8s1ceuBUnMUAeoAHHw,1,0,0,0,0,0,1,0,1,0.14285714285714285,1,0.0,0,0,0,0,0,0,0,1,0,0,1,1
2717,71782,bvymgtoEENeCZc8oxchZvznMloDqHCnU,bWdj2GDclj5ofokWjzoa5jAwMkxCykd6,5,5,3,0,0,0,4,0,12,1.7142857142857142,2,0.0,0,3,0,0,5,0,0,4,0,3,9,1
2718,71802,YkfUrC2IjNSUcSjXepY6IHt6QpgdD85G,SpATywNh6bZuzm8s1ceuBUnMUAeoAHHw,14,18,10,11,5,0,1,0,45,6.428571428571429,1,0.0,7,10,11,5,11,0,0,1,0,33,12,1
2719,71822,Z1BvcrHFnz5lnLSAy2ZEcjcmCxIRFxqE,bWdj2GDclj5ofokWjzoa5jAwMkxCykd6,1,0,0,0,0,0,1,0,1,0.14285714285714285,1,0.0,0,0,0,0,0,0,0,1,0,0,1,1
2720,71823,Z1BvcrHFnz5lnLSAy2ZEcjcmCxIRFxqE,A3fsA9Zfv1X2fVEQhTw51lKENdNrEqT3,1,0,0,0,0,0,1,0,1,0.14285714285714285,1,0.0,0,0,0,0,0,0,0,1,0,0,1,1
2721,71842,ErXNe7efkRl64E8pJRc91VCcYddra1a4,SpATywNh6bZuzm8s1ceuBUnMUAeoAHHw,10,22,10,0,2,4,4,0,42,6.0,2,0.0,7,10,0,2,15,4,0,4,0,19,23,0
2722,71844,yjE4tqKQR2WC3DLToz6n1TUHIiH6cjX1,SpATywNh6bZuzm8s1ceuBUnMUAeoAHHw,10,8,6,0,3,0,2,0,19,2.7142857142857144,2,0.0,0,6,0,3,8,0,0,2,0,9,10,0
2723,71845,Bl9yotIOWBgbQXjSe795sBrgMyA0TCNf,RXDvfPUBYFlVdlueBFbLW0mhhAyGEqpt,53,37,1,110,1,0,4,0,153,21.857142857142858,2,0.0,12,1,102,1,25,0,8,4,0,116,37,1
2724,71854,It5GZoF42fMzBpqBoHOwTBOzCr0aB6Mf,SpATywNh6bZuzm8s1ceuBUnMUAeoAHHw,4,2,1,0,0,0,2,0,5,0.7142857142857143,1,0.0,0,1,0,0,2,0,0,2,0,1,4,0
2725,71855,PzUJiLnP9HZJxQE6JmMTkx1KTzCMtAvI,SpATywNh6bZuzm8s1ceuBUnMUAeoAHHw,6,5,3,0,2,0,3,0,13,1.8571428571428572,1,0.0,0,3,0,2,5,0,0,3,0,5,8,1
2726,71873,nBOtam7XKIa3PxdTZIAJPzc36wtmbKH4,A3fsA9Zfv1X2fVEQhTw51lKENdNrEqT3,59,27,18,144,9,1,9,0,208,29.714285714285715,2,0.0,5,18,141,9,22,1,3,9,0,173,35,1
2727,71885,STpGdIPaHCaW4TikUdsIz5l3OEI1w4EH,SpATywNh6bZuzm8s1ceuBUnMUAeoAHHw,5,2,1,0,1,0,2,0,6,0.8571428571428571,1,0.0,0,1,0,1,2,0,0,2,0,2,4,1
2728,71888,sr89KLsFZj5opXIwIPCyClXHTk70EGW9,SpATywNh6bZuzm8s1ceuBUnMUAeoAHHw,7,6,5,0,3,0,2,0,16,2.2857142857142856,1,0.0,0,5,0,3,6,0,0,2,0,8,8,1
2729,71930,fvtcu8mnRKcOOxIrvdMmUWRWOCvOPCJY,A3fsA9Zfv1X2fVEQhTw51lKENdNrEqT3,4,2,1,0,0,0,2,0,5,0.7142857142857143,1,0.0,0,1,0,0,2,0,0,2,0,1,4,1
2730,71935,Cg7iNBAj8Tw36V9R4YA417eEEGy00kAz,SpATywNh6bZuzm8s1ceuBUnMUAeoAHHw,8,8,4,17,0,0,3,0,32,4.571428571428571,2,0.0,2,4,15,0,6,0,2,3,0,21,11,0
2731,71946,ap47j49GydESvLtt85D5zvr7ZznC8gTV,bWdj2GDclj5ofokWjzoa5jAwMkxCykd6,10,11,2,0,2,1,8,2,26,3.7142857142857144,1,0.0,0,2,0,2,11,1,0,8,2,4,22,1
2732,71949,ap47j49GydESvLtt85D5zvr7ZznC8gTV,RXDvfPUBYFlVdlueBFbLW0mhhAyGEqpt,13,11,6,0,2,14,15,1,49,7.0,1,0.0,0,6,0,2,11,14,0,15,1,8,41,0
2733,71966,Zs0g0mKdq0TdImqBhrX0faEWu7slOeJl,G8EPVSXsOYB5YQWZGiz1aVq5Pgr2GrQu,7,3,2,0,2,0,2,0,9,1.2857142857142858,1,0.0,0,2,0,2,3,0,0,2,0,4,5,1
2734,71970,51xlIGXGRsE7YMneHTw1mXYuaEFgELF3,A3fsA9Zfv1X2fVEQhTw51lKENdNrEqT3,3,2,1,0,0,0,1,0,4,0.5714285714285714,1,0.0,0,1,0,0,2,0,0,1,0,1,3,0
2735,71985,1LkX4t7QGG0LPbqqJvnwJmrweFNAYkvm,bWdj2GDclj5ofokWjzoa5jAwMkxCykd6,9,12,1,0,3,0,1,0,17,2.4285714285714284,2,0.0,3,1,0,3,9,0,0,1,0,7,10,1
2736,71991,imshqH7JQ2KBPUk9GL3zPD8OWwRSwtuq,SpATywNh6bZuzm8s1ceuBUnMUAeoAHHw,7,5,3,0,2,35,7,1,53,7.571428571428571,2,0.0,0,3,0,2,5,35,0,7,1,5,48,1
2737,71997,1twNQDvdxBOgcj0lq6GVrkkiWBY4fWuM,A3fsA9Zfv1X2fVEQhTw51lKENdNrEqT3,2,0,0,0,0,0,5,0,5,0.7142857142857143,2,0.0,0,0,0,0,0,0,0,5,0,0,5,1
2738,72013,ukCIrv5h45nbdIEPPmMlvipT87B8fFE7,A3fsA9Zfv1X2fVEQhTw51lKENdNrEqT3,1,0,0,0,0,0,1,0,1,0.14285714285714285,1,0.0,0,0,0,0,0,0,0,1,0,0,1,1
2739,72028,rGUcxYNOJhuu9K9SMgsP5W3xbSiphSwH,SpATywNh6bZuzm8s1ceuBUnMUAeoAHHw,8,6,4,0,2,0,1,0,13,1.8571428571428572,1,0.0,0,4,0,2,6,0,0,1,0,6,7,1
2740,72034,4D3Mr9GTnnSeHqe4k4RduVTIffzivKXV,SpATywNh6bZuzm8s1ceuBUnMUAeoAHHw,5,2,1,0,0,0,3,1,7,1.0,1,0.0,0,1,0,0,2,0,0,3,1,1,6,1
2741,72036,X5enyutaN4BslWhmXx6XhoGlJxHpkXgF,SpATywNh6bZuzm8s1ceuBUnMUAeoAHHw,5,3,1,0,0,0,3,0,7,1.0,1,0.0,0,1,0,0,3,0,0,3,0,1,6,1
2742,72066,FCXISzNoe8FGZLEA3b4ES0P455MShvJn,SpATywNh6bZuzm8s1ceuBUnMUAeoAHHw,1,0,0,0,0,0,2,0,2,0.2857142857142857,1,0.0,0,0,0,0,0,0,0,2,0,0,2,1
2743,72074,RuDy1GBbehKUBaX6QEes5OGfFL3kKVSX,SpATywNh6bZuzm8s1ceuBUnMUAeoAHHw,1,0,0,0,0,0,1,0,1,0.14285714285714285,1,0.0,0,0,0,0,0,0,0,1,0,0,1,1
2744,72106,zIrlaPdUoa4jAQzQMvRWsAtbCae2mGEc,G8EPVSXsOYB5YQWZGiz1aVq5Pgr2GrQu,1,0,0,0,0,0,1,0,1,0.14285714285714285,1,0.0,0,0,0,0,0,0,0,1,0,0,1,1
2745,72117,Sel2OIwsCKHe9RO5oHI96p00tLi1mx10,RXDvfPUBYFlVdlueBFbLW0mhhAyGEqpt,1,0,0,0,0,0,1,0,1,0.14285714285714285,1,0.0,0,0,0,0,0,0,0,1,0,0,1,1
2746,72123,a8HvMkBRr1QnoDxivZVIhrkeiZFWplka,bWdj2GDclj5ofokWjzoa5jAwMkxCykd6,23,18,11,65,3,9,5,0,111,15.857142857142858,2,0.0,3,11,53,3,15,9,12,5,0,70,41,1
2747,72166,yS4hKsLzPsdj6M1qMcvQzXXEbCXgtzUx,A3fsA9Zfv1X2fVEQhTw51lKENdNrEqT3,11,7,1,0,1,11,7,1,28,4.0,1,0.0,0,1,0,1,7,11,0,7,1,2,26,1
2748,72180,h3JQOcsvjUnoJCiMtN2qNwJvDlNp6yEa,SpATywNh6bZuzm8s1ceuBUnMUAeoAHHw,6,3,2,0,2,0,1,0,8,1.1428571428571428,1,0.0,0,2,0,2,3,0,0,1,0,4,4,1
2749,72187,pg03VLobZ1zAAslEUdBaTgGu7kih28vz,SpATywNh6bZuzm8s1ceuBUnMUAeoAHHw,6,3,1,0,1,0,2,0,7,1.0,1,0.0,0,1,0,1,3,0,0,2,0,2,5,0
2750,72195,2XrVfo49pLwaH12euHkVNsz60Xa54j5d,SpATywNh6bZuzm8s1ceuBUnMUAeoAHHw,1,0,0,0,0,0,1,0,1,0.14285714285714285,1,0.0,0,0,0,0,0,0,0,1,0,0,1,1
2751,72198,dRTXM152V1lTMTi8e61qXn3u4WelzJ82,A3fsA9Zfv1X2fVEQhTw51lKENdNrEqT3,20,20,1,0,2,0,6,0,29,4.142857142857143,2,0.0,0,1,0,2,20,0,0,6,0,3,26,1
2752,72200,ZRC032b6bAMTdyW8JO1vU2llk0mQNPce,SpATywNh6bZuzm8s1ceuBUnMUAeoAHHw,11,12,5,18,1,2,2,1,41,5.857142857142857,1,0.0,6,5,14,1,6,2,4,2,1,26,15,1
2753,72206,2t2mFcXnjCSGOBpya1wSPFZtPiud9I2F,SpATywNh6bZuzm8s1ceuBUnMUAeoAHHw,15,19,1,10,0,0,17,2,49,7.0,5,0.0,4,1,9,0,15,0,1,17,2,14,35,0
2754,72215,6ngga8jBuXKmnKYc00TBjXbVEmc0f4XL,SpATywNh6bZuzm8s1ceuBUnMUAeoAHHw,5,4,2,0,1,0,1,0,8,1.1428571428571428,1,0.0,0,2,0,1,4,0,0,1,0,3,5,1
2755,72250,SozblGZP0jqptTVCGb8oKsTCWZZGfIvg,SpATywNh6bZuzm8s1ceuBUnMUAeoAHHw,11,17,1,18,1,0,1,0,38,5.428571428571429,1,0.0,11,1,16,1,6,0,2,1,0,29,9,0
2756,72268,hluzPB1y7zkKLSSzVkJvXfWNLyDAuRho,RXDvfPUBYFlVdlueBFbLW0mhhAyGEqpt,6,4,2,0,1,0,1,0,8,1.1428571428571428,1,0.0,0,2,0,1,4,0,0,1,0,3,5,1
2757,72270,VCY6PHshXOjPWWfmo1l8Uf1lH1o7rZ3R,bWdj2GDclj5ofokWjzoa5jAwMkxCykd6,1,0,0,0,0,0,1,0,1,0.14285714285714285,1,0.0,0,0,0,0,0,0,0,1,0,0,1,1
2758,72321,cfFiO9ikb1PkctbOzz1e9XkphXHtxdbN,A3fsA9Zfv1X2fVEQhTw51lKENdNrEqT3,10,4,2,0,2,0,7,0,15,2.142857142857143,1,0.0,0,2,0,2,4,0,0,7,0,4,11,1
2759,72327,vpU9FFM3siBSv5Tq74CkiYBZ5nbD9oub,SpATywNh6bZuzm8s1ceuBUnMUAeoAHHw,6,4,0,0,0,0,6,0,10,1.4285714285714286,1,0.0,1,0,0,0,3,0,0,6,0,1,9,1
2760,72328,iq2dRooMckypJXruhYgCykZbS7Y4UNpS,SpATywNh6bZuzm8s1ceuBUnMUAeoAHHw,2,0,0,0,0,0,2,0,2,0.2857142857142857,1,0.0,0,0,0,0,0,0,0,2,0,0,2,1
2761,72342,AImx2eHFGaeqTe0d3fwuX86fffC0rd9k,RXDvfPUBYFlVdlueBFbLW0mhhAyGEqpt,6,4,3,0,1,0,1,0,9,1.2857142857142858,1,0.0,0,3,0,1,4,0,0,1,0,4,5,1
2762,72354,4ZKN4qjeNhliROr2sm8vB8zmpPTrlPXO,A3fsA9Zfv1X2fVEQhTw51lKENdNrEqT3,7,11,1,0,1,0,2,0,15,2.142857142857143,1,0.0,1,1,0,1,10,0,0,2,0,3,12,1
2763,72370,WI9rk8aS11tBAJzjcX0JSIgomYYRQVjW,SpATywNh6bZuzm8s1ceuBUnMUAeoAHHw,11,10,0,10,0,0,10,0,30,4.285714285714286,2,0.0,2,0,10,0,8,0,0,10,0,12,18,0
2764,72371,iahhmqoMx53j5nO5miK92n3wdWI8ut4z,RXDvfPUBYFlVdlueBFbLW0mhhAyGEqpt,1,0,0,0,0,0,2,0,2,0.2857142857142857,2,0.0,0,0,0,0,0,0,0,2,0,0,2,1
2765,72375,jpXIq3stqWScWG27acYJbNKpdTmc6kli,bWdj2GDclj5ofokWjzoa5jAwMkxCykd6,8,14,9,0,3,0,4,0,30,4.285714285714286,3,0.0,1,9,0,3,13,0,0,4,0,13,17,0
2766,72406,m2qlFWWWmt2hJc2nGhR4gu4Qag46wOrg,bWdj2GDclj5ofokWjzoa5jAwMkxCykd6,15,9,6,0,4,0,9,1,29,4.142857142857143,3,0.0,0,6,0,4,9,0,0,9,1,10,19,1
2767,72412,NIlxh2g7VTAquieuVc9RGErPkOzbSh2Z,SpATywNh6bZuzm8s1ceuBUnMUAeoAHHw,3,2,1,0,0,0,3,0,6,0.8571428571428571,1,0.0,0,1,0,0,2,0,0,3,0,1,5,1
2768,72416,iPefB9aOL6bAjIaS6Gks903vpOsT6Kof,SpATywNh6bZuzm8s1ceuBUnMUAeoAHHw,1,0,0,0,0,0,1,0,1,0.14285714285714285,1,0.0,0,0,0,0,0,0,0,1,0,0,1,1
2769,72418,idKVU6p7Q7GgRNB8N8uPXj3SONpH1Rke,SpATywNh6bZuzm8s1ceuBUnMUAeoAHHw,9,10,1,0,1,0,3,0,15,2.142857142857143,1,0.0,0,1,0,1,10,0,0,3,0,2,13,1
2770,72426,B9BCqbSn4dXX7PoOMPBly9mxS1ETXKHH,SpATywNh6bZuzm8s1ceuBUnMUAeoAHHw,4,3,2,0,0,0,1,0,6,0.8571428571428571,1,0.0,0,2,0,0,3,0,0,1,0,2,4,1
2771,72429,GwQix8XlCp4q9CmSxf5jg9NO42lfroib,SpATywNh6bZuzm8s1ceuBUnMUAeoAHHw,1,0,0,0,0,0,1,0,1,0.14285714285714285,1,0.0,0,0,0,0,0,0,0,1,0,0,1,1
2772,72438,7o7xgD7LMzcqbchAXccb0936AlSMEPrX,G8EPVSXsOYB5YQWZGiz1aVq5Pgr2GrQu,3,2,0,0,0,0,1,0,3,0.42857142857142855,1,0.0,0,0,0,0,2,0,0,1,0,0,3,1
2773,72442,LWfPQEZcfqcdY03cxPtuNt5LIUXK1J1h,bWdj2GDclj5ofokWjzoa5jAwMkxCykd6,8,10,1,0,0,0,4,0,15,2.142857142857143,1,0.0,1,1,0,0,9,0,0,4,0,2,13,1
2774,72443,r4duLXpBfZecmSM9LE5BQOC4ssd1sXJk,SpATywNh6bZuzm8s1ceuBUnMUAeoAHHw,1,0,0,0,0,0,1,0,1,0.14285714285714285,1,0.0,0,0,0,0,0,0,0,1,0,0,1,1
2775,72445,r4duLXpBfZecmSM9LE5BQOC4ssd1sXJk,bWdj2GDclj5ofokWjzoa5jAwMkxCykd6,3,0,0,0,0,0,4,0,4,0.5714285714285714,1,0.0,0,0,0,0,0,0,0,4,0,0,4,1
2776,72448,Ln23tN1YAlBNEBT8tndbR9JhZVhVTsS7,SpATywNh6bZuzm8s1ceuBUnMUAeoAHHw,28,42,22,36,11,1,10,0,122,17.428571428571427,3,0.0,14,22,33,11,28,1,3,10,0,80,42,1
2777,72451,9FaPBbsYKn0C9myyRYf9vYNhns2eJDpD,bWdj2GDclj5ofokWjzoa5jAwMkxCykd6,16,53,21,0,8,0,13,0,95,13.571428571428571,4,0.0,0,21,0,8,53,0,0,13,0,29,66,0
2778,72452,MU4dVyJTD7iIRSTZIdJZ9VoLOxogfKQN,A3fsA9Zfv1X2fVEQhTw51lKENdNrEqT3,3,2,1,0,0,0,1,0,4,0.5714285714285714,1,0.0,0,1,0,0,2,0,0,1,0,1,3,0
2779,72465,ypoGZw2r9uT31DVWRK8Ak5IwBPQDf2ZW,A3fsA9Zfv1X2fVEQhTw51lKENdNrEqT3,6,5,2,0,0,0,4,0,11,1.5714285714285714,2,0.0,0,2,0,0,5,0,0,4,0,2,9,1
2780,72468,clbUGnOQsN7CuaV7idGJ2LVbYN3t8qC3,bWdj2GDclj5ofokWjzoa5jAwMkxCykd6,14,18,1,18,0,0,3,0,40,5.714285714285714,2,0.0,5,1,16,0,13,0,2,3,0,22,18,0
2781,72485,H1nbdkC904EOh8jWeVVcV5piaqMVBsli,RXDvfPUBYFlVdlueBFbLW0mhhAyGEqpt,9,9,2,0,0,0,3,0,14,2.0,2,0.0,0,2,0,0,9,0,0,3,0,2,12,0
2782,72488,KQPXidcwG060yQGJPDlINxK2yFVflTSt,bWdj2GDclj5ofokWjzoa5jAwMkxCykd6,1,0,0,0,0,0,1,0,1,0.14285714285714285,1,0.0,0,0,0,0,0,0,0,1,0,0,1,1
2783,72489,RJYmcEEhHfwNHiJXK5LzE5hkiIIoNU9v,RXDvfPUBYFlVdlueBFbLW0mhhAyGEqpt,1,0,0,0,0,0,1,0,1,0.14285714285714285,1,0.0,0,0,0,0,0,0,0,1,0,0,1,1
2784,72499,sD8qOTBQiDeb2NJjPdXUeUPzMkOLP9sv,G8EPVSXsOYB5YQWZGiz1aVq5Pgr2GrQu,18,17,5,17,4,1,14,2,60,8.571428571428571,1,0.0,7,5,14,4,10,1,3,14,2,30,30,1
2785,72510,0Zbkv3HIeYhldfQXVnfym9fVEiuNqjhW,G8EPVSXsOYB5YQWZGiz1aVq5Pgr2GrQu,10,21,2,0,2,1,12,1,39,5.571428571428571,1,0.0,0,2,0,2,21,1,0,12,1,4,35,1
2786,72521,8UBuXoKnbGMq6Q0kIIWDMawKN4aOMWdt,SpATywNh6bZuzm8s1ceuBUnMUAeoAHHw,6,7,5,0,4,0,1,0,17,2.4285714285714284,1,0.0,0,5,0,4,7,0,0,1,0,9,8,1
2787,72523,bBon9Fz54W0VEKu51qXuvXYwLHShFyI1,SpATywNh6bZuzm8s1ceuBUnMUAeoAHHw,5,7,2,0,0,0,4,0,13,1.8571428571428572,1,0.0,4,2,0,0,3,0,0,4,0,6,7,1
2788,72527,3RFxfyZdyTuIPVV58WHND3p7FoSeVnvd,SpATywNh6bZuzm8s1ceuBUnMUAeoAHHw,1,0,0,0,0,0,1,0,1,0.14285714285714285,1,0.0,0,0,0,0,0,0,0,1,0,0,1,1
2789,72532,QPoypIc1fBONo2zEXZGrqFPP68plPMOG,A3fsA9Zfv1X2fVEQhTw51lKENdNrEqT3,30,22,1,134,1,0,7,0,165,23.571428571428573,3,0.0,3,1,100,1,19,0,34,7,0,105,60,0
2790,72540,3RFxfyZdyTuIPVV58WHND3p7FoSeVnvd,G8EPVSXsOYB5YQWZGiz1aVq5Pgr2GrQu,6,8,4,0,3,0,4,0,19,2.7142857142857144,1,0.0,0,4,0,3,8,0,0,4,0,7,12,1
2791,72547,ACrAvl4ssWNFndB2wDhI3oY0Vqi5B1FR,RXDvfPUBYFlVdlueBFbLW0mhhAyGEqpt,47,28,18,88,9,2,3,0,148,21.142857142857142,2,0.0,7,18,86,9,21,2,2,3,0,120,28,1
2792,72554,92DwnWdf0DjZODrvrNNLdxmEfzQWnu5Z,A3fsA9Zfv1X2fVEQhTw51lKENdNrEqT3,17,11,10,0,8,4,11,1,45,6.428571428571429,2,0.0,0,10,0,8,11,4,0,11,1,18,27,1
2793,72588,5fUv2a4WMEi2Bc60cQo0Uzo1I7SufPfI,SpATywNh6bZuzm8s1ceuBUnMUAeoAHHw,1,0,0,0,0,0,1,0,1,0.14285714285714285,1,0.0,0,0,0,0,0,0,0,1,0,0,1,0
2794,72593,rPY59o3LLmGBPTPMGcA5vX57KVfmywv5,bWdj2GDclj5ofokWjzoa5jAwMkxCykd6,1,0,0,0,0,0,1,0,1,0.14285714285714285,1,0.0,0,0,0,0,0,0,0,1,0,0,1,1
2795,72609,qIgfmlfsBIhgTbQqqVFddAaDPPK19iKa,SpATywNh6bZuzm8s1ceuBUnMUAeoAHHw,6,6,3,0,0,0,3,0,12,1.7142857142857142,1,0.0,2,3,0,0,4,0,0,3,0,5,7,1
2796,72622,3RFxfyZdyTuIPVV58WHND3p7FoSeVnvd,A3fsA9Zfv1X2fVEQhTw51lKENdNrEqT3,1,0,0,0,0,0,1,0,1,0.14285714285714285,1,0.0,0,0,0,0,0,0,0,1,0,0,1,1
2797,72626,KQPXidcwG060yQGJPDlINxK2yFVflTSt,A3fsA9Zfv1X2fVEQhTw51lKENdNrEqT3,2,0,0,0,0,0,3,0,3,0.42857142857142855,1,0.0,0,0,0,0,0,0,0,3,0,0,3,1
2798,72636,xOB7vl3l1Tpb0i0cSWni40BfJ5FBclms,bWdj2GDclj5ofokWjzoa5jAwMkxCykd6,1,0,0,0,0,0,1,0,1,0.14285714285714285,1,0.0,0,0,0,0,0,0,0,1,0,0,1,1
2799,72659,Ikx8dqw7N29O68oP7rbQGE7AGY4iLNon,A3fsA9Zfv1X2fVEQhTw51lKENdNrEqT3,6,3,1,0,1,0,3,0,8,1.1428571428571428,1,0.0,0,1,0,1,3,0,0,3,0,2,6,1
2800,72685,2IlOpdUgsPu5FVltj0flScFk4CeI7uHm,RXDvfPUBYFlVdlueBFbLW0mhhAyGEqpt,3,2,1,0,0,0,1,0,4,0.5714285714285714,1,0.0,0,1,0,0,2,0,0,1,0,1,3,0
2801,72692,H2pnCC5fUi5Ho09aPqAE97vnlsM8FGBU,A3fsA9Zfv1X2fVEQhTw51lKENdNrEqT3,27,7,5,84,1,0,3,0,100,14.285714285714286,1,0.0,1,5,84,1,6,0,0,3,0,91,9,0
2802,72701,h2ynGKkFoAy58qRjHGCAYsp0Afa0leqG,SpATywNh6bZuzm8s1ceuBUnMUAeoAHHw,1,2,0,0,0,0,0,0,2,0.2857142857142857,2,0.0,0,0,0,0,2,0,0,0,0,0,2,1
2803,72716,0VjAWG5aLQgXyXeTqTPnha195szz41mH,RXDvfPUBYFlVdlueBFbLW0mhhAyGEqpt,24,16,10,40,6,21,2,0,95,13.571428571428571,1,0.0,5,10,40,6,11,21,0,2,0,61,34,1
2804,72721,1UwRwlLE0RwxPaY5NbrfjlESNYQllZZa,A3fsA9Zfv1X2fVEQhTw51lKENdNrEqT3,17,18,7,0,5,0,6,0,36,5.142857142857143,2,0.0,0,7,0,5,18,0,0,6,0,12,24,0
2805,72726,0bJvCDj0GgBeU0HMz26Zp0pAIP7Ku0m6,G8EPVSXsOYB5YQWZGiz1aVq5Pgr2GrQu,14,13,7,0,8,0,3,0,31,4.428571428571429,1,0.0,5,7,0,8,8,0,0,3,0,20,11,0
2806,72729,gfqBONxF3vgkgkzNGOBh2NvmbBtnV553,A3fsA9Zfv1X2fVEQhTw51lKENdNrEqT3,22,17,15,0,12,0,7,0,51,7.285714285714286,1,0.0,0,15,0,12,17,0,0,7,0,27,24,1
2807,72741,CVH6urFvexNmD0aVZsmcYsZiC7ATsEWQ,SpATywNh6bZuzm8s1ceuBUnMUAeoAHHw,23,35,12,23,5,16,4,0,95,13.571428571428571,2,0.0,14,12,19,5,21,16,4,4,0,50,45,1
2808,72750,Jd5OP6GIsguRdsq9k3eSYNENmzhPbdGe,RXDvfPUBYFlVdlueBFbLW0mhhAyGEqpt,1,0,0,0,0,0,1,0,1,0.14285714285714285,1,0.0,0,0,0,0,0,0,0,1,0,0,1,1
2809,72760,V7hPLACO2aZJMGkqrqGs8iTi1dh1D640,A3fsA9Zfv1X2fVEQhTw51lKENdNrEqT3,8,3,2,0,2,1,6,0,14,2.0,1,0.0,0,2,0,2,3,1,0,6,0,4,10,1
2810,72764,Sr1toTUNefJAFbhTUg77mqKaZFTtdaV4,A3fsA9Zfv1X2fVEQhTw51lKENdNrEqT3,5,0,0,0,0,3,5,2,10,1.4285714285714286,1,0.0,0,0,0,0,0,3,0,5,2,0,10,1
2811,72794,GcYYdMUd1jTzTWqukpvr0rVRxsxU8er2,G8EPVSXsOYB5YQWZGiz1aVq5Pgr2GrQu,1,0,0,0,0,0,1,0,1,0.14285714285714285,1,0.0,0,0,0,0,0,0,0,1,0,0,1,1
2812,72811,QmwPzVmCybpAgMwyMz1fwIqSJEweIwjc,SpATywNh6bZuzm8s1ceuBUnMUAeoAHHw,12,8,5,0,3,4,5,3,28,4.0,1,0.0,1,5,0,3,7,4,0,5,3,9,19,1
2813,72814,kPOhZ6qf9bbLzunMF2utkZU62wMNJPxJ,SpATywNh6bZuzm8s1ceuBUnMUAeoAHHw,13,15,4,12,2,0,2,0,35,5.0,1,0.0,9,4,11,2,6,0,1,2,0,26,9,1
2814,72824,UZj9qZ6lkWkIz7HEEFyBh5LFRNaz4SI2,bWdj2GDclj5ofokWjzoa5jAwMkxCykd6,5,2,1,0,1,0,2,0,6,0.8571428571428571,1,0.0,0,1,0,1,2,0,0,2,0,2,4,1
2815,72844,pQdSl7i5ZuZeH9uPILgdHrvwskp4vc4V,A3fsA9Zfv1X2fVEQhTw51lKENdNrEqT3,4,2,1,0,1,0,2,0,6,0.8571428571428571,1,0.0,0,1,0,1,2,0,0,2,0,2,4,1
2816,72847,OUbh6hvaOJDp9RK7kgTBzzPmjzmkYhZF,bWdj2GDclj5ofokWjzoa5jAwMkxCykd6,5,6,0,0,0,0,2,0,8,1.1428571428571428,2,0.0,0,0,0,0,6,0,0,2,0,0,8,1
2817,72850,QqE2Xjwy9gUzOvFdkDqAwAaNZLBZkxvd,G8EPVSXsOYB5YQWZGiz1aVq5Pgr2GrQu,9,10,1,0,0,0,10,0,21,3.0,5,0.0,3,1,0,0,7,0,0,10,0,4,17,1
2818,72861,uynRJ81lKSVTwiBUWysuMw4GfvXEQcj1,A3fsA9Zfv1X2fVEQhTw51lKENdNrEqT3,1,0,0,0,0,0,1,0,1,0.14285714285714285,1,0.0,0,0,0,0,0,0,0,1,0,0,1,1
2819,72878,3z37iBp19kh1LYVfVTprpt7Nc7WFUSh9,bWdj2GDclj5ofokWjzoa5jAwMkxCykd6,13,15,9,0,7,0,6,0,37,5.285714285714286,2,0.0,2,9,0,7,13,0,0,6,0,18,19,1
2820,72885,czhzfQM5hzKsjmfr33GA4a86kqhVxJHf,A3fsA9Zfv1X2fVEQhTw51lKENdNrEqT3,44,19,13,70,11,0,6,0,119,17.0,2,0.0,1,13,60,11,18,0,10,6,0,85,34,1
2821,72922,ria1rZm5v1iNiSZkl2at79lKlYWZvHeF,SpATywNh6bZuzm8s1ceuBUnMUAeoAHHw,4,4,0,0,0,0,2,0,6,0.8571428571428571,2,0.0,0,0,0,0,4,0,0,2,0,0,6,0
2822,72950,5lXEnKEAbuix9ITMHrIbzKht9sQOw1oR,A3fsA9Zfv1X2fVEQhTw51lKENdNrEqT3,1,0,0,0,0,0,1,0,1,0.14285714285714285,1,0.0,0,0,0,0,0,0,0,1,0,0,1,1
2823,72951,Ou3iHiBDr7O5XF3iHhMwgAvySH9eHz42,RXDvfPUBYFlVdlueBFbLW0mhhAyGEqpt,6,1,1,0,1,0,8,0,11,1.5714285714285714,2,0.0,0,1,0,1,1,0,0,8,0,2,9,1
2824,72964,rN6lunIjAbCWqlUClfGlFjDjxcPvXSQ8,G8EPVSXsOYB5YQWZGiz1aVq5Pgr2GrQu,1,0,0,0,0,0,1,0,1,0.14285714285714285,1,0.0,0,0,0,0,0,0,0,1,0,0,1,1
2825,72967,NYagfMVvA1FDdZ7PZwzv8OVDbZ0jsy8R,SpATywNh6bZuzm8s1ceuBUnMUAeoAHHw,4,2,0,0,0,0,2,0,4,0.5714285714285714,2,0.0,0,0,0,0,2,0,0,2,0,0,4,1
2826,73009,l569pvTkqA1hwU8mlPA8zjV2SyK4a7w2,SpATywNh6bZuzm8s1ceuBUnMUAeoAHHw,4,6,0,0,0,0,3,0,9,1.2857142857142858,2,0.0,0,0,0,0,6,0,0,3,0,0,9,0
2827,73024,LzA5wgwJJZVLbqKdv9NjOOvbbtbdWAC9,SpATywNh6bZuzm8s1ceuBUnMUAeoAHHw,5,2,1,0,1,0,2,0,6,0.8571428571428571,1,0.0,0,1,0,1,2,0,0,2,0,2,4,1
2828,73036,zcVtFTrToAbXyBSFxcFkJCnMsb7Jt1Wc,SpATywNh6bZuzm8s1ceuBUnMUAeoAHHw,6,6,4,0,0,0,1,0,11,1.5714285714285714,1,0.0,0,4,0,0,6,0,0,1,0,4,7,1
2829,73080,y1PyjNePB0NOk56DVMODQe87hVVXR5yE,bWdj2GDclj5ofokWjzoa5jAwMkxCykd6,1,0,0,0,0,0,1,0,1,0.14285714285714285,1,0.0,0,0,0,0,0,0,0,1,0,0,1,1
2830,73091,bVDYKiZvgd2IcK5UYf7mO2QJtYbh5uZ8,SpATywNh6bZuzm8s1ceuBUnMUAeoAHHw,5,2,1,0,1,0,2,0,6,0.8571428571428571,1,0.0,0,1,0,1,2,0,0,2,0,2,4,1
2831,73105,O2ctwJV4MPvP5qTfQJUUGlNEKgJxJSl6,G8EPVSXsOYB5YQWZGiz1aVq5Pgr2GrQu,1,0,0,0,0,0,1,0,1,0.14285714285714285,1,0.0,0,0,0,0,0,0,0,1,0,0,1,1
2832,73141,YWIcWPk2owvGQjJvioCvuMwwhqp9Hu6o,SpATywNh6bZuzm8s1ceuBUnMUAeoAHHw,2,0,0,0,0,0,2,0,2,0.2857142857142857,1,0.0,0,0,0,0,0,0,0,2,0,0,2,1
2833,73173,afdo7sttc7aaNvz9ca7YCfhlkfRUdKCm,SpATywNh6bZuzm8s1ceuBUnMUAeoAHHw,1,0,0,0,0,0,3,0,3,0.42857142857142855,1,0.0,0,0,0,0,0,0,0,3,0,0,3,1
2834,73180,uoufNidjh1zD724gB2zYdd5MROgtTWHO,A3fsA9Zfv1X2fVEQhTw51lKENdNrEqT3,22,15,11,0,10,0,1,0,37,5.285714285714286,1,0.0,1,11,0,10,14,0,0,1,0,22,15,1
2835,73514,eAreSTsX7Dih2J54vyrFl8ByPnikZNX4,fbPkOYLVPtPgIt0MxizjfFJov3JbHyAi,23,20,12,16,5,2,4,0,59,8.428571428571429,1,0.0,5,12,14,5,15,2,2,4,0,36,23,0
2836,73521,tZsZwfZKEwgih9HC8eRqwpFt6sEwssno,fbPkOYLVPtPgIt0MxizjfFJov3JbHyAi,8,5,3,0,2,0,3,0,13,1.8571428571428572,1,0.0,0,3,0,2,5,0,0,3,0,5,8,0
2837,73885,zlC9nEdRrqLSPX386Mctiz9fIdlU29GI,7GRhBDsirIGkRZBtSMEzNTyDr2JQm4xx,47,54,22,16,31,0,1,0,124,17.714285714285715,1,0.0,31,22,16,31,23,0,0,1,0,100,24,1
2838,73937,28W5CJrYp73LQgjHivjzAixkCQuqTCh6,A3fsA9Zfv1X2fVEQhTw51lKENdNrEqT3,8,8,5,0,3,0,2,0,18,2.5714285714285716,1,0.0,0,5,0,3,8,0,0,2,0,8,10,0
2839,73941,vaBnFuKrFzaRvpuQOGO2KMutesPcXn34,SpATywNh6bZuzm8s1ceuBUnMUAeoAHHw,8,8,3,14,0,0,2,0,27,3.857142857142857,2,0.0,4,3,13,0,4,0,1,2,0,20,7,0
2840,73970,j32U9Y949ZW1nXMwG0aPWZXCmluBzel9,7GRhBDsirIGkRZBtSMEzNTyDr2JQm4xx,1,0,0,0,0,0,1,0,1,0.14285714285714285,1,0.0,0,0,0,0,0,0,0,1,0,0,1,1
2841,73975,YmZgT8JqU8nh2NPc6NVlnnDgPwwbycrT,SpATywNh6bZuzm8s1ceuBUnMUAeoAHHw,17,19,9,19,6,0,2,0,55,7.857142857142857,3,0.0,6,9,17,6,13,0,2,2,0,38,17,0
2842,73976,7mxOgTUP9lSjAUBOPZ9fhNEhVSHMvF2J,A3fsA9Zfv1X2fVEQhTw51lKENdNrEqT3,9,9,5,0,0,0,5,0,19,2.7142857142857144,1,0.0,0,5,0,0,9,0,0,5,0,5,14,0
2843,74009,obFplu8p0J5bdsesTSoaj6Bc4UGbTB6M,bWdj2GDclj5ofokWjzoa5jAwMkxCykd6,1,0,0,0,0,0,1,0,1,0.14285714285714285,1,0.0,0,0,0,0,0,0,0,1,0,0,1,1
2844,74012,1rnRBDe6QdlyFMXjNKkPkQwNjoqRhDMp,SpATywNh6bZuzm8s1ceuBUnMUAeoAHHw,16,22,10,26,0,4,7,0,69,9.857142857142858,2,0.0,7,10,25,0,15,4,1,7,0,42,27,0
2845,74046,vQAS0obh0bWlfi2VaK7gKWVKUzPkWalY,bWdj2GDclj5ofokWjzoa5jAwMkxCykd6,6,2,1,0,1,0,3,0,7,1.0,1,0.0,0,1,0,1,2,0,0,3,0,2,5,1
2846,74114,OakZIwMalw5UgG2N0rTydClOEPiV8rki,SpATywNh6bZuzm8s1ceuBUnMUAeoAHHw,22,24,14,4,7,0,2,0,51,7.285714285714286,1,0.0,0,14,4,7,24,0,0,2,0,25,26,0
2847,74115,NFrovzSNFaGOKX4ckxlOk5TIATwQWZDv,SpATywNh6bZuzm8s1ceuBUnMUAeoAHHw,22,47,23,26,6,12,14,2,130,18.571428571428573,2,0.0,15,23,19,6,32,12,7,14,2,63,67,0
2848,74121,Ym1ZTRs6QB0e3lMSh4qwLaB0p6ohf0Ak,RXDvfPUBYFlVdlueBFbLW0mhhAyGEqpt,23,17,8,26,6,0,3,0,60,8.571428571428571,2,0.0,6,8,23,6,11,0,3,3,0,43,17,0
2849,74268,NFrovzSNFaGOKX4ckxlOk5TIATwQWZDv,RXDvfPUBYFlVdlueBFbLW0mhhAyGEqpt,54,38,25,96,16,0,4,0,179,25.571428571428573,2,0.0,9,25,86,16,29,0,10,4,0,136,43,1
2850,74329,vCnaR7A3EMdV2eOQ4pBMh0byIjK5VwLE,SpATywNh6bZuzm8s1ceuBUnMUAeoAHHw,4,3,0,0,0,0,1,0,4,0.5714285714285714,2,0.0,0,0,0,0,3,0,0,1,0,0,4,1
2851,74397,FzKYBP9DQh3u0w9lQRHJGeubpb75FItD,A3fsA9Zfv1X2fVEQhTw51lKENdNrEqT3,9,7,1,0,0,0,7,1,16,2.2857142857142856,1,0.0,0,1,0,0,7,0,0,7,1,1,15,0
2852,74453,XKfrMCVtqlIZ8enVJyGd7DD1q7PXaYx0,bWdj2GDclj5ofokWjzoa5jAwMkxCykd6,8,3,0,0,0,0,5,1,9,1.2857142857142858,1,0.0,0,0,0,0,3,0,0,5,1,0,9,1
2853,74461,z2UutrDxctGBl3XhV09hNxXdsZmqDZvY,A3fsA9Zfv1X2fVEQhTw51lKENdNrEqT3,28,31,25,2,16,17,13,1,105,15.0,2,0.0,2,25,2,16,29,17,0,13,1,45,60,1
2854,74483,SP7hg1EWo2mZkHuxZFtI4Vbcyr5vcP4h,SpATywNh6bZuzm8s1ceuBUnMUAeoAHHw,4,2,1,0,0,0,3,0,6,0.8571428571428571,2,0.0,0,1,0,0,2,0,0,3,0,1,5,0
2855,74522,ZYGzPhdrKsCQft8z3gUrz2GR31kmqGY8,SpATywNh6bZuzm8s1ceuBUnMUAeoAHHw,18,47,23,17,6,6,4,0,103,14.714285714285714,2,0.0,15,23,15,6,32,6,2,4,0,59,44,0
2856,74644,NoceYrOX1tWqokyDfvqtevfQbA2rhFqB,SpATywNh6bZuzm8s1ceuBUnMUAeoAHHw,5,5,3,0,2,0,2,0,12,1.7142857142857142,1,0.0,0,3,0,2,5,0,0,2,0,5,7,0
2857,74697,RYEl9qV5WolRR4P8IF9M1gxceAzD6Axt,SpATywNh6bZuzm8s1ceuBUnMUAeoAHHw,17,24,10,25,3,35,7,0,104,14.857142857142858,2,0.0,12,10,21,3,12,35,4,7,0,46,58,1
2858,74725,dg1KWi5LRRms7lQMyP0ii5Pv3KonWqiG,7GRhBDsirIGkRZBtSMEzNTyDr2JQm4xx,8,10,4,0,2,0,1,0,17,2.4285714285714284,1,0.0,5,4,0,2,5,0,0,1,0,11,6,1
2859,74737,xMjaHywxqKHoEbgcAEYnpZkLLGRuzCTC,SpATywNh6bZuzm8s1ceuBUnMUAeoAHHw,4,5,1,0,0,0,2,0,8,1.1428571428571428,1,0.0,0,1,0,0,5,0,0,2,0,1,7,0
2860,74840,FvY4K2RN2da3T8MEGlPk2LmHUIxOyg0h,SpATywNh6bZuzm8s1ceuBUnMUAeoAHHw,5,4,1,0,1,0,1,0,7,1.0,1,0.0,0,1,0,1,4,0,0,1,0,2,5,0
2861,74855,pTjlgRGlVEY0q8gZSgoQhD2BjMBUQLrl,SpATywNh6bZuzm8s1ceuBUnMUAeoAHHw,11,4,3,0,2,1,10,2,22,3.142857142857143,1,0.0,0,3,0,2,4,1,0,10,2,5,17,1
2862,74858,mB36rXDIKgGQROGEKlrDrvsLRYA6xyWr,bWdj2GDclj5ofokWjzoa5jAwMkxCykd6,1,0,0,0,0,0,1,0,1,0.14285714285714285,1,0.0,0,0,0,0,0,0,0,1,0,0,1,1
2863,74868,Ob4gv0EanZge2ZoC1mjpKSlZhrSnoOS3,SpATywNh6bZuzm8s1ceuBUnMUAeoAHHw,4,2,1,0,1,0,1,0,5,0.7142857142857143,2,0.0,0,1,0,1,2,0,0,1,0,2,3,0
2864,74888,hB4yTUnQMne1LtjUUKgpcnhj6jq7S5Co,7GRhBDsirIGkRZBtSMEzNTyDr2JQm4xx,13,12,5,6,5,0,2,0,30,4.285714285714286,1,0.0,5,5,5,5,7,0,1,2,0,20,10,0
2865,74911,KXR3u54SykbWYMuF2sF6lcMFs68otiQO,SpATywNh6bZuzm8s1ceuBUnMUAeoAHHw,3,3,2,0,0,0,0,0,5,0.7142857142857143,1,0.0,0,2,0,0,3,0,0,0,0,2,3,0
2866,74934,knxAJpSFDgjN8jBmnCV7BB7s4fbgoTt1,SpATywNh6bZuzm8s1ceuBUnMUAeoAHHw,12,9,6,15,0,0,2,0,32,4.571428571428571,1,0.0,2,6,13,0,7,0,2,2,0,21,11,0
2867,75002,0FC20UDeWvUi5UrOg2NVCepKkW4oulyY,SpATywNh6bZuzm8s1ceuBUnMUAeoAHHw,22,23,10,32,3,11,8,1,88,12.571428571428571,3,0.0,10,10,29,3,13,11,3,8,1,52,36,1
2868,75093,Wcbtj2ddFRjLWK9tTZ7uzCDmpegrAZ78,A3fsA9Zfv1X2fVEQhTw51lKENdNrEqT3,9,5,4,0,3,0,2,0,14,2.0,1,0.0,0,4,0,3,5,0,0,2,0,7,7,0
2869,75102,7PsSHlEYnB89Jan9VqppndjNHL90G8j5,7GRhBDsirIGkRZBtSMEzNTyDr2JQm4xx,1,0,0,0,0,0,1,0,1,0.14285714285714285,1,0.0,0,0,0,0,0,0,0,1,0,0,1,1
2870,75120,H2nT05aeA6Q1zZKHa66kquyct5PT5SXn,SpATywNh6bZuzm8s1ceuBUnMUAeoAHHw,14,24,2,12,0,2,3,0,43,6.142857142857143,2,0.0,10,2,12,0,14,2,0,3,0,24,19,0
2871,75307,80mucTACVCDvIo1wfgGJkZ9oDdziiwCh,SpATywNh6bZuzm8s1ceuBUnMUAeoAHHw,31,46,16,30,9,9,12,1,123,17.571428571428573,2,0.0,21,16,29,9,25,9,1,12,1,75,48,0
2872,75314,2IlOpdUgsPu5FVltj0flScFk4CeI7uHm,A3fsA9Zfv1X2fVEQhTw51lKENdNrEqT3,34,18,11,42,5,12,7,0,95,13.571428571428571,1,0.0,3,11,42,5,15,12,0,7,0,61,34,1
2873,75379,MYsCU1zkMrWxPhV1b7wSL5LZIo1zGyhU,A3fsA9Zfv1X2fVEQhTw51lKENdNrEqT3,14,12,10,0,7,0,2,0,31,4.428571428571429,2,0.0,0,10,0,7,12,0,0,2,0,17,14,0
2874,75401,i93wq7dpRKS8LWX4FM6N5PqvNqUj0cQr,G8EPVSXsOYB5YQWZGiz1aVq5Pgr2GrQu,15,13,4,34,3,0,5,0,59,8.428571428571429,1,0.0,8,4,28,3,5,0,6,5,0,43,16,1
2875,75511,MYsCU1zkMrWxPhV1b7wSL5LZIo1zGyhU,RXDvfPUBYFlVdlueBFbLW0mhhAyGEqpt,4,2,0,0,0,0,2,0,4,0.5714285714285714,1,0.0,0,0,0,0,2,0,0,2,0,0,4,0
2876,75642,jZTK26BTfBLHQKFhPE9kcyNEiSpfCkRJ,SpATywNh6bZuzm8s1ceuBUnMUAeoAHHw,6,5,1,0,1,0,1,0,8,1.1428571428571428,1,0.0,0,1,0,1,5,0,0,1,0,2,6,0
2877,75690,BSh5O31gIGvDrYgmsU5wxbvxaTpBXZ4G,A3fsA9Zfv1X2fVEQhTw51lKENdNrEqT3,1,0,0,0,0,0,1,0,1,0.14285714285714285,1,0.0,0,0,0,0,0,0,0,1,0,0,1,1
2878,75736,bwGV7RxO9uTA6WTvdbogMOQvBlvVU3Dn,A3fsA9Zfv1X2fVEQhTw51lKENdNrEqT3,5,2,1,0,1,0,2,0,6,0.8571428571428571,1,0.0,0,1,0,1,2,0,0,2,0,2,4,1
2879,75752,0CuRIhBavvQKL5rTT1QWf2kztAfRXZug,A3fsA9Zfv1X2fVEQhTw51lKENdNrEqT3,45,34,18,100,7,1,6,2,168,24.0,3,0.0,3,18,78,7,31,1,22,6,2,106,62,0
2880,75760,87yFIXn8YjKLNtiBpBtMqW5Rij3yU58s,SpATywNh6bZuzm8s1ceuBUnMUAeoAHHw,1,0,0,0,0,0,1,0,1,0.14285714285714285,1,0.0,0,0,0,0,0,0,0,1,0,0,1,0
2881,75772,nknXXbQsC6Q6nMDyRKc0MDJZg6KtAXBE,G8EPVSXsOYB5YQWZGiz1aVq5Pgr2GrQu,6,6,2,0,1,0,3,1,13,1.8571428571428572,2,0.0,0,2,0,1,6,0,0,3,1,3,10,0
2882,75790,rT1OrFQC18rdvYkTGYqwRgC7eDvihHsc,A3fsA9Zfv1X2fVEQhTw51lKENdNrEqT3,1,0,0,0,0,0,1,0,1,0.14285714285714285,1,0.0,0,0,0,0,0,0,0,1,0,0,1,1
2883,75879,Slk5JcZSYHmDLQZXaNVmcMDmjJ16kBhI,SpATywNh6bZuzm8s1ceuBUnMUAeoAHHw,2,0,0,0,0,0,3,0,3,0.42857142857142855,2,0.0,0,0,0,0,0,0,0,3,0,0,3,0
2884,76169,6RuWsSvS3Ngnjl37PzNAaaGn8Jd9a1lW,A3fsA9Zfv1X2fVEQhTw51lKENdNrEqT3,9,9,2,0,2,0,4,0,17,2.4285714285714284,2,0.0,0,2,0,2,9,0,0,4,0,4,13,0
2885,76192,eeUPLnGQx37dkxrDcGRSCAvma26w8Yjq,RXDvfPUBYFlVdlueBFbLW0mhhAyGEqpt,9,12,6,0,2,2,6,0,28,4.0,1,0.0,0,6,0,2,12,2,0,6,0,8,20,0
2886,76232,o9SCOAY5nuSxaVorNF1mq3E0AGKQbCox,G8EPVSXsOYB5YQWZGiz1aVq5Pgr2GrQu,1,0,0,0,0,0,1,0,1,0.14285714285714285,1,0.0,0,0,0,0,0,0,0,1,0,0,1,1
2887,76235,jByBG50ghoSer5UP92qpkAfDGFpraaH7,SpATywNh6bZuzm8s1ceuBUnMUAeoAHHw,2,0,0,0,0,0,2,0,2,0.2857142857142857,1,0.0,0,0,0,0,0,0,0,2,0,0,2,0
2888,76295,Slk5JcZSYHmDLQZXaNVmcMDmjJ16kBhI,bWdj2GDclj5ofokWjzoa5jAwMkxCykd6,15,22,5,24,1,0,4,0,56,8.0,3,0.0,9,5,18,1,13,0,6,4,0,33,23,0
2889,76368,Kcl98h3mNpyExmJuf2coZt58rSEztGxk,7GRhBDsirIGkRZBtSMEzNTyDr2JQm4xx,39,76,31,64,31,33,8,0,243,34.714285714285715,3,0.0,39,31,55,31,37,33,9,8,0,156,87,0
2890,76949,QzYbn86ruFNwqcTxxFURk0zGhEatBUQQ,7GRhBDsirIGkRZBtSMEzNTyDr2JQm4xx,3,2,0,0,0,0,1,0,3,0.42857142857142855,1,0.0,0,0,0,0,2,0,0,1,0,0,3,0
2891,76950,e1Ni97fhQkMnOfSs68693wQS8Fze4UXJ,7GRhBDsirIGkRZBtSMEzNTyDr2JQm4xx,32,22,20,0,14,1,1,0,58,8.285714285714286,1,0.0,0,20,0,14,22,1,0,1,0,34,24,1
2892,76967,2NKObRqEjsRrxsIaHNv4gzcAP6eW660j,7GRhBDsirIGkRZBtSMEzNTyDr2JQm4xx,1,0,0,0,0,0,1,0,1,0.14285714285714285,1,0.0,0,0,0,0,0,0,0,1,0,0,1,1
2893,77031,uLw7Ns7eU6sxKEU6M5svYmkgyCUXe32f,7GRhBDsirIGkRZBtSMEzNTyDr2JQm4xx,18,29,3,5,4,0,4,0,45,6.428571428571429,1,0.0,1,3,3,4,28,0,2,4,0,11,34,0
2894,77034,s6iksgptFmyh2vfiarKdJkiKnp6RLi3f,7GRhBDsirIGkRZBtSMEzNTyDr2JQm4xx,10,8,6,0,4,0,4,0,22,3.142857142857143,2,0.0,0,6,0,4,8,0,0,4,0,10,12,0
2895,77042,h2A0iMKtZOnc2TftPlP9GQGNtfgyyhcj,7GRhBDsirIGkRZBtSMEzNTyDr2JQm4xx,1,0,0,0,0,0,1,0,1,0.14285714285714285,1,0.0,0,0,0,0,0,0,0,1,0,0,1,1
2896,77064,h18jWYSAObqvOO5XjUcCaWiyguLiAvCC,7GRhBDsirIGkRZBtSMEzNTyDr2JQm4xx,2,0,0,0,0,0,2,0,2,0.2857142857142857,1,0.0,0,0,0,0,0,0,0,2,0,0,2,1
2897,77122,Q4w60uH4MK8mN5fYaKMbhF5stFXWr0Vi,7GRhBDsirIGkRZBtSMEzNTyDr2JQm4xx,2,0,0,0,0,0,4,0,4,0.5714285714285714,1,0.0,0,0,0,0,0,0,0,4,0,0,4,1
2898,77123,s6dupzTq7IPrRZizdsz3m7uW9SFh4kDC,7GRhBDsirIGkRZBtSMEzNTyDr2JQm4xx,20,26,12,8,12,0,2,0,60,8.571428571428571,1,0.0,10,12,4,12,16,0,4,2,0,38,22,1
2899,77128,KsfSaMDW3YtqB9HKnB6Qn6E8m6zJPOJA,7GRhBDsirIGkRZBtSMEzNTyDr2JQm4xx,7,6,3,0,1,0,3,0,13,1.8571428571428572,1,0.0,1,3,0,1,5,0,0,3,0,5,8,1
2900,77148,80y9S8r32w7HjdSrNUEAoEBMUZWJtxmp,7GRhBDsirIGkRZBtSMEzNTyDr2JQm4xx,1,0,0,0,0,0,1,0,1,0.14285714285714285,1,0.0,0,0,0,0,0,0,0,1,0,0,1,1
2901,77151,CDzHyYO40Bybwfq6RBlk0Sz8LcMuVYAa,7GRhBDsirIGkRZBtSMEzNTyDr2JQm4xx,1,0,0,0,0,0,2,0,2,0.2857142857142857,1,0.0,0,0,0,0,0,0,0,2,0,0,2,1
2902,77179,eoSLO9oJFq2ypi74bXNS4eHCMDLAFDL3,fbPkOYLVPtPgIt0MxizjfFJov3JbHyAi,6,17,4,0,1,0,2,0,24,3.4285714285714284,2,0.0,3,4,0,1,14,0,0,2,0,8,16,0
2903,77848,4s6cwLPbdRkDxHfFtEkiNoQ9RLKrwhVv,A3fsA9Zfv1X2fVEQhTw51lKENdNrEqT3,7,3,3,0,1,0,3,0,10,1.4285714285714286,2,0.0,0,3,0,1,3,0,0,3,0,4,6,1
2904,77859,FbNQPrTC7bI79XxVFKHE9WIoUItnOpDj,SpATywNh6bZuzm8s1ceuBUnMUAeoAHHw,17,14,11,12,7,0,2,0,46,6.571428571428571,1,0.0,2,11,12,7,12,0,0,2,0,32,14,1
2905,77863,YV0OYizek02yKJ88HEeJHkNjkL20XUDk,SpATywNh6bZuzm8s1ceuBUnMUAeoAHHw,27,82,15,23,3,8,13,1,145,20.714285714285715,3,0.0,38,15,20,3,44,8,3,13,1,76,69,0
2906,77865,mqEWhrPz1lKF0rYKRYPaEdxo5F8aEixX,bWdj2GDclj5ofokWjzoa5jAwMkxCykd6,3,2,1,0,0,1,1,0,5,0.7142857142857143,1,0.0,0,1,0,0,2,1,0,1,0,1,4,0
2907,77895,ywdL3xkp7d2PSjbvnflAvIe7Wp6Q4SRe,bWdj2GDclj5ofokWjzoa5jAwMkxCykd6,15,26,6,16,2,0,7,0,57,8.142857142857142,3,0.0,3,6,15,2,23,0,1,7,0,26,31,0
2908,77897,rxZkN71X2cLXhIjLr3jy095yRsk5XsRc,RXDvfPUBYFlVdlueBFbLW0mhhAyGEqpt,32,76,12,40,2,0,16,7,153,21.857142857142858,2,0.0,18,12,39,2,58,0,1,16,7,71,82,1
2909,77906,lzBQ7nLCxYOqaheVjLakGDqP6Wmnlnpq,A3fsA9Zfv1X2fVEQhTw51lKENdNrEqT3,2,0,0,0,0,0,2,0,2,0.2857142857142857,1,0.0,0,0,0,0,0,0,0,2,0,0,2,1
2910,77917,UpJrRBQ59x3Gn5L7s007cXh7Wi1pgqj5,A3fsA9Zfv1X2fVEQhTw51lKENdNrEqT3,1,0,0,0,0,0,1,0,1,0.14285714285714285,1,0.0,0,0,0,0,0,0,0,1,0,0,1,1
2911,77956,1hThKgDvGcWwSWVkG0XRyCPk0C8L5ypr,SpATywNh6bZuzm8s1ceuBUnMUAeoAHHw,7,2,0,0,0,0,6,1,9,1.2857142857142858,1,0.0,0,0,0,0,2,0,0,6,1,0,9,1
2912,77959,oL1G89Phk4nduULmJ17br7A4xddcHdc4,bWdj2GDclj5ofokWjzoa5jAwMkxCykd6,1,0,0,0,0,0,1,0,1,0.14285714285714285,1,0.0,0,0,0,0,0,0,0,1,0,0,1,1
2913,77984,lmR86sBtJRFaUISdgjy7MTzO5iilHcad,G8EPVSXsOYB5YQWZGiz1aVq5Pgr2GrQu,18,8,7,0,7,4,3,0,29,4.142857142857143,1,0.0,0,7,0,7,8,4,0,3,0,14,15,1
2914,77993,c8WJAdYLV71mOx4ZXSglpCNd0dBUR3Om,A3fsA9Zfv1X2fVEQhTw51lKENdNrEqT3,35,17,11,94,7,0,10,0,139,19.857142857142858,4,0.0,1,11,88,7,16,0,6,10,0,107,32,0
2915,78000,fFuKiCeoQQwOgD8VAud2ta198Mbq05KK,bWdj2GDclj5ofokWjzoa5jAwMkxCykd6,14,16,10,34,0,17,10,0,87,12.428571428571429,3,0.0,0,10,32,0,16,17,2,10,0,42,45,0
2916,78011,G1AkjrLrzxk8VSlUiuwTegO49rw4sqVB,SpATywNh6bZuzm8s1ceuBUnMUAeoAHHw,6,4,1,0,1,0,2,0,8,1.1428571428571428,1,0.0,0,1,0,1,4,0,0,2,0,2,6,1
2917,78033,PqRGPZDwCt8mcSQTJP9YLW5JCb0jrVN9,SpATywNh6bZuzm8s1ceuBUnMUAeoAHHw,5,2,1,0,1,0,2,0,6,0.8571428571428571,1,0.0,0,1,0,1,2,0,0,2,0,2,4,1
2918,78049,92DwnWdf0DjZODrvrNNLdxmEfzQWnu5Z,bWdj2GDclj5ofokWjzoa5jAwMkxCykd6,9,5,3,0,2,0,8,1,19,2.7142857142857144,1,0.0,0,3,0,2,5,0,0,8,1,5,14,1
2919,78061,CTzsOL49UPUArAP2sAfnnQhe79FdliFF,bWdj2GDclj5ofokWjzoa5jAwMkxCykd6,5,3,1,0,1,0,1,0,6,0.8571428571428571,1,0.0,0,1,0,1,3,0,0,1,0,2,4,1
2920,78074,69m94gHdGGbBNOXpX0bnvC61pSot80tW,SpATywNh6bZuzm8s1ceuBUnMUAeoAHHw,19,21,11,18,5,1,4,0,60,8.571428571428571,1,0.0,7,11,15,5,14,1,3,4,0,38,22,1
2921,78082,kVKFY3wJD9F9OUo7qKYWy4VSNf8ef9A6,SpATywNh6bZuzm8s1ceuBUnMUAeoAHHw,11,11,0,0,0,9,8,1,29,4.142857142857143,2,0.0,0,0,0,0,11,9,0,8,1,0,29,1
2922,78089,hL8JceSXib9VR5R33sNp2RkuLry7d4Yu,SpATywNh6bZuzm8s1ceuBUnMUAeoAHHw,11,12,0,13,0,0,4,0,29,4.142857142857143,1,0.0,2,0,12,0,10,0,1,4,0,14,15,1
2923,78095,pd8vtyQRUNRd6UqLQhDDx4sQEKhI3nO6,SpATywNh6bZuzm8s1ceuBUnMUAeoAHHw,4,4,1,0,0,0,2,0,7,1.0,1,0.0,0,1,0,0,4,0,0,2,0,1,6,1
2924,78101,ew5XZC7WSosl0QdXH45kYD3syMSGbOj6,SpATywNh6bZuzm8s1ceuBUnMUAeoAHHw,10,8,6,0,4,0,2,0,20,2.857142857142857,1,0.0,0,6,0,4,8,0,0,2,0,10,10,1
2925,78102,3iVQIJ2a6dmEKXpiFwzH2EedoHvLyisM,bWdj2GDclj5ofokWjzoa5jAwMkxCykd6,7,4,1,0,1,1,6,0,13,1.8571428571428572,1,0.0,0,1,0,1,4,1,0,6,0,2,11,1
2926,78113,95wznOdbj11g3FRFEWLtWETJ4xtU9Lr5,G8EPVSXsOYB5YQWZGiz1aVq5Pgr2GrQu,5,2,1,0,0,5,3,1,12,1.7142857142857142,1,0.0,0,1,0,0,2,5,0,3,1,1,11,1
2927,78118,5s2QZF0oRCYI8h2ElmgC6T7pH2gEDZ5h,G8EPVSXsOYB5YQWZGiz1aVq5Pgr2GrQu,1,0,0,0,0,0,1,0,1,0.14285714285714285,1,0.0,0,0,0,0,0,0,0,1,0,0,1,1
2928,78124,ipCWNN8EoPw4ehuG3rBsqrmm1abywAYg,SpATywNh6bZuzm8s1ceuBUnMUAeoAHHw,9,8,4,0,3,0,3,0,18,2.5714285714285716,2,0.0,1,4,0,3,7,0,0,3,0,8,10,1
2929,78127,2RG1wvJ2Akp0VzrUn9TPDWB6kxO9ia9I,SpATywNh6bZuzm8s1ceuBUnMUAeoAHHw,1,0,0,0,0,0,1,0,1,0.14285714285714285,1,0.0,0,0,0,0,0,0,0,1,0,0,1,1
2930,78129,JntXNtR3vyFADq0v1flreEKkRmGG9OQK,A3fsA9Zfv1X2fVEQhTw51lKENdNrEqT3,3,1,0,0,0,0,3,0,4,0.5714285714285714,1,0.0,0,0,0,0,1,0,0,3,0,0,4,1
2931,78136,s8Jf0qU6li81AKZyIKNz4C8LkYvCndM9,SpATywNh6bZuzm8s1ceuBUnMUAeoAHHw,8,2,1,0,1,0,4,1,9,1.2857142857142858,1,0.0,0,1,0,1,2,0,0,4,1,2,7,1
2932,78149,LXuJhI2cIog5nvobdVGbKieoIrAAgMV0,A3fsA9Zfv1X2fVEQhTw51lKENdNrEqT3,13,8,6,0,4,0,3,0,21,3.0,1,0.0,0,6,0,4,8,0,0,3,0,10,11,1
2933,78152,SozAkRr5kfRi3urQaoczmRXQoW70onBa,RXDvfPUBYFlVdlueBFbLW0mhhAyGEqpt,26,143,4,2,5,0,22,1,177,25.285714285714285,3,0.0,3,4,2,5,140,0,0,22,1,14,163,1
2934,78155,6D9tNiLYL0h3Qh7QJGbRexG5UNsHPfh9,bWdj2GDclj5ofokWjzoa5jAwMkxCykd6,6,2,1,0,1,1,3,1,9,1.2857142857142858,1,0.0,0,1,0,1,2,1,0,3,1,2,7,1
2935,78193,qxN9EXLVijHnXOSweK0J0YYviNolRhYg,SpATywNh6bZuzm8s1ceuBUnMUAeoAHHw,10,6,1,0,1,2,8,2,20,2.857142857142857,1,0.0,0,1,0,1,6,2,0,8,2,2,18,1
2936,78198,WnXohtCVTjGmg2VYZ7QMusUaSQiMqg1z,SpATywNh6bZuzm8s1ceuBUnMUAeoAHHw,1,0,0,0,0,0,1,0,1,0.14285714285714285,1,0.0,0,0,0,0,0,0,0,1,0,0,1,1
2937,78207,KxuHPQOdlWxQw9hyxXdRrGHh12yzsPD2,SpATywNh6bZuzm8s1ceuBUnMUAeoAHHw,5,7,0,2,0,0,2,0,11,1.5714285714285714,2,0.0,0,0,1,0,7,0,1,2,0,1,10,0
2938,78230,Q9vRNhatkLDJJU3tGkLQZvY6VPiyvyvp,SpATywNh6bZuzm8s1ceuBUnMUAeoAHHw,9,17,1,4,1,0,0,0,23,3.2857142857142856,2,0.0,6,1,3,1,11,0,1,0,0,11,12,1
2939,78253,oDMwcP97XCFhatRKDALyEk29j0A66Zee,bWdj2GDclj5ofokWjzoa5jAwMkxCykd6,10,6,3,16,4,0,11,0,40,5.714285714285714,2,0.0,3,3,14,4,3,0,2,11,0,24,16,1
2940,78254,CWfEuozBd4liyBTvOMVgNSWJo0S8l1jG,A3fsA9Zfv1X2fVEQhTw51lKENdNrEqT3,2,0,0,0,0,0,2,0,2,0.2857142857142857,1,0.0,0,0,0,0,0,0,0,2,0,0,2,1
2941,78272,wnNKMl9xF7Ymo4g0NZCDRhkVYih1owQr,SpATywNh6bZuzm8s1ceuBUnMUAeoAHHw,8,9,6,0,2,0,2,0,19,2.7142857142857144,1,0.0,1,6,0,2,8,0,0,2,0,9,10,1
2942,78273,XE05vZThEHf17O6FM08AySNf2qZFgNWa,SpATywNh6bZuzm8s1ceuBUnMUAeoAHHw,9,7,4,8,0,0,2,0,21,3.0,2,0.0,2,4,8,0,5,0,0,2,0,14,7,0
2943,78287,4If157RX0kFtn3QRqNwswYxl3iATvTeY,SpATywNh6bZuzm8s1ceuBUnMUAeoAHHw,13,27,9,17,0,4,8,0,65,9.285714285714286,1,0.0,15,9,14,0,12,4,3,8,0,38,27,1
2944,78302,CwyPNNTiGuAPbLEEKCBOpScgD8z9aW45,G8EPVSXsOYB5YQWZGiz1aVq5Pgr2GrQu,7,2,1,0,1,1,7,0,12,1.7142857142857142,1,0.0,0,1,0,1,2,1,0,7,0,2,10,1
2945,78317,kGMrZZF6IokC4ENFCmz5DqVfi7S4EU7Y,A3fsA9Zfv1X2fVEQhTw51lKENdNrEqT3,11,5,4,0,4,1,4,0,18,2.5714285714285716,1,0.0,0,4,0,4,5,1,0,4,0,8,10,1
2946,78320,d7dHJyfZvhoC9wAanfH162cM80LBpWIS,SpATywNh6bZuzm8s1ceuBUnMUAeoAHHw,6,7,4,0,1,0,5,0,17,2.4285714285714284,1,0.0,2,4,0,1,5,0,0,5,0,7,10,1
2947,78323,VhJqWY1s8NggIUb1uIcah3mgkAeL4PFu,SpATywNh6bZuzm8s1ceuBUnMUAeoAHHw,1,0,0,0,0,0,1,0,1,0.14285714285714285,1,0.0,0,0,0,0,0,0,0,1,0,0,1,1
2948,78327,VhJqWY1s8NggIUb1uIcah3mgkAeL4PFu,bWdj2GDclj5ofokWjzoa5jAwMkxCykd6,1,0,0,0,0,0,1,0,1,0.14285714285714285,1,0.0,0,0,0,0,0,0,0,1,0,0,1,1
2949,78376,QAguKdvn52pCJKW91rO3BCY8l8ZCAdvQ,bWdj2GDclj5ofokWjzoa5jAwMkxCykd6,4,2,1,0,1,0,1,0,5,0.7142857142857143,1,0.0,0,1,0,1,2,0,0,1,0,2,3,0
2950,78403,yndqePvRltfbBBHRj2cAuoKRvu7Id8hO,A3fsA9Zfv1X2fVEQhTw51lKENdNrEqT3,5,2,1,0,1,0,4,0,8,1.1428571428571428,1,0.0,0,1,0,1,2,0,0,4,0,2,6,1
2951,78404,r83Hvy5kcw0EMVIlIEQofYLVkxqypRN2,A3fsA9Zfv1X2fVEQhTw51lKENdNrEqT3,1,0,0,0,0,0,1,0,1,0.14285714285714285,1,0.0,0,0,0,0,0,0,0,1,0,0,1,1
2952,78411,Bz3KWhAEO9yzXIB0jVNYIzbr7mGbueA4,A3fsA9Zfv1X2fVEQhTw51lKENdNrEqT3,8,4,3,0,2,0,2,0,11,1.5714285714285714,1,0.0,0,3,0,2,4,0,0,2,0,5,6,1
2953,78414,VzHARyOCXw9czoqgTkAm6CGUmYU7yDEA,A3fsA9Zfv1X2fVEQhTw51lKENdNrEqT3,2,0,0,0,0,0,2,0,2,0.2857142857142857,1,0.0,0,0,0,0,0,0,0,2,0,0,2,1
2954,78418,XE05vZThEHf17O6FM08AySNf2qZFgNWa,A3fsA9Zfv1X2fVEQhTw51lKENdNrEqT3,23,18,14,0,11,0,2,0,45,6.428571428571429,2,0.0,1,14,0,11,17,0,0,2,0,26,19,1
2955,78425,z0WA70zlCYNC0D6ukf1TU1erCNwbETr4,SpATywNh6bZuzm8s1ceuBUnMUAeoAHHw,10,10,3,7,1,1,4,1,27,3.857142857142857,1,0.0,6,3,6,1,4,1,1,4,1,16,11,0
2956,78439,urVw10ZOKTw1O1zHFnsutUzT6EcZdTal,A3fsA9Zfv1X2fVEQhTw51lKENdNrEqT3,5,5,0,0,0,0,1,0,6,0.8571428571428571,1,0.0,0,0,0,0,5,0,0,1,0,0,6,1
2957,78450,FKaIUzhQjfUDPqxWuQzJXyqHP4qLLgRX,SpATywNh6bZuzm8s1ceuBUnMUAeoAHHw,17,27,1,19,1,0,6,0,54,7.714285714285714,2,0.0,11,1,16,1,16,0,3,6,0,29,25,0
2958,78456,eBckG9AVr6bIBOpezfRr2S1KzQMM7OtD,SpATywNh6bZuzm8s1ceuBUnMUAeoAHHw,6,5,2,0,1,0,1,0,9,1.2857142857142858,1,0.0,0,2,0,1,5,0,0,1,0,3,6,1
2959,78467,J2luenZYZZPbaRbefvLso2Jyw46qiM9q,G8EPVSXsOYB5YQWZGiz1aVq5Pgr2GrQu,46,49,17,82,10,0,7,0,165,23.571428571428573,3,0.0,26,17,55,10,23,0,27,7,0,108,57,1
2960,78480,NnzxbmsIt5XwCuqd88R8ZxWHliFkPx5u,A3fsA9Zfv1X2fVEQhTw51lKENdNrEqT3,4,2,0,0,0,0,2,0,4,0.5714285714285714,1,0.0,0,0,0,0,2,0,0,2,0,0,4,1
2961,78495,btLR1bWGFkTXEBZ7Aiu8bAmygJLuQ8xU,SpATywNh6bZuzm8s1ceuBUnMUAeoAHHw,1,0,0,0,0,0,1,0,1,0.14285714285714285,1,0.0,0,0,0,0,0,0,0,1,0,0,1,1
2962,78501,OX8GRDjTfhi0f98MbIiYM0XH4DZcRvix,SpATywNh6bZuzm8s1ceuBUnMUAeoAHHw,4,2,1,0,1,0,1,0,5,0.7142857142857143,1,0.0,0,1,0,1,2,0,0,1,0,2,3,1
2963,78507,BSh5O31gIGvDrYgmsU5wxbvxaTpBXZ4G,bWdj2GDclj5ofokWjzoa5jAwMkxCykd6,38,67,23,158,14,6,11,1,280,40.0,2,0.0,20,23,148,14,47,6,10,11,1,205,75,1
2964,78511,98Rmjqd0huhIhiHJIK65vNiEBdUVwDLb,A3fsA9Zfv1X2fVEQhTw51lKENdNrEqT3,6,4,2,0,1,0,1,0,8,1.1428571428571428,1,0.0,0,2,0,1,4,0,0,1,0,3,5,1
2965,78545,Ckb71Ev9RlsIUvVDfkFS0AumQJilppvB,SpATywNh6bZuzm8s1ceuBUnMUAeoAHHw,1,0,0,0,0,0,1,0,1,0.14285714285714285,1,0.0,0,0,0,0,0,0,0,1,0,0,1,1
2966,78551,n2o2ZtJFwUSYSGDBSers3t9xfBVg1pV7,SpATywNh6bZuzm8s1ceuBUnMUAeoAHHw,12,13,2,0,2,0,3,0,20,2.857142857142857,2,0.0,0,2,0,2,13,0,0,3,0,4,16,1
2967,78556,cWykzNKAq5sFQBA059QN4Jx74YGPkfwB,A3fsA9Zfv1X2fVEQhTw51lKENdNrEqT3,5,5,0,0,0,0,2,0,7,1.0,2,0.0,0,0,0,0,5,0,0,2,0,0,7,1
2968,78559,MkNNXRtvb2oEn4QkB8O2p0cdUi1EqesX,SpATywNh6bZuzm8s1ceuBUnMUAeoAHHw,9,6,3,0,2,1,7,1,20,2.857142857142857,1,0.0,0,3,0,2,6,1,0,7,1,5,15,1
2969,78562,QMBvXsBcxfHzg1mixrcjUrcMaoA4FrQo,SpATywNh6bZuzm8s1ceuBUnMUAeoAHHw,6,3,1,0,1,0,2,0,7,1.0,1,0.0,0,1,0,1,3,0,0,2,0,2,5,1
2970,78564,X8qfNjsHrwR5R67KkU9t7FXc6jQSGsyo,A3fsA9Zfv1X2fVEQhTw51lKENdNrEqT3,8,6,4,0,2,2,6,0,20,2.857142857142857,1,0.0,0,4,0,2,6,2,0,6,0,6,14,1
2971,78584,5bg7aQCg1xT3BNwuorGcguCUDl8W5Lwl,bWdj2GDclj5ofokWjzoa5jAwMkxCykd6,6,6,0,0,0,9,5,1,21,3.0,1,0.0,1,0,0,0,5,9,0,5,1,1,20,1
2972,78622,0gWJ7DFjheSDJbXHYhPpXkJuq9a45Fds,bWdj2GDclj5ofokWjzoa5jAwMkxCykd6,1,0,0,0,0,0,2,0,2,0.2857142857142857,2,0.0,0,0,0,0,0,0,0,2,0,0,2,1
2973,78627,mJ6Ucc9SqO7RDdkh3xF9KLI6sTyfYc24,SpATywNh6bZuzm8s1ceuBUnMUAeoAHHw,15,30,14,15,3,2,9,0,73,10.428571428571429,2,0.0,5,14,15,3,25,2,0,9,0,37,36,1
2974,78660,uhbUne0Zqx7l0LKNWrxxR44WistJmxKI,RXDvfPUBYFlVdlueBFbLW0mhhAyGEqpt,5,5,1,0,0,0,2,0,8,1.1428571428571428,1,0.0,0,1,0,0,5,0,0,2,0,1,7,1
2975,78664,97xUfvFptTHex9YOgZiJKjEEIQ0YhjLh,bWdj2GDclj5ofokWjzoa5jAwMkxCykd6,7,5,3,0,3,4,1,0,16,2.2857142857142856,1,0.0,0,3,0,3,5,4,0,1,0,6,10,1
2976,78686,38U4yWxOl4oZXP5u7g0lCPmmavOa19Ln,A3fsA9Zfv1X2fVEQhTw51lKENdNrEqT3,5,3,1,0,1,0,1,0,6,0.8571428571428571,1,0.0,0,1,0,1,3,0,0,1,0,2,4,1
2977,78691,tmJw00mRQLbE68iN3hs2GcRMynHK5cxp,A3fsA9Zfv1X2fVEQhTw51lKENdNrEqT3,13,4,2,42,0,0,1,0,49,7.0,1,0.0,1,2,37,0,3,0,5,1,0,40,9,1
2978,78700,avCGoxb1ZCWUYXGamrmyET2g851xKp7v,SpATywNh6bZuzm8s1ceuBUnMUAeoAHHw,4,6,0,0,0,0,4,0,10,1.4285714285714286,1,0.0,0,0,0,0,6,0,0,4,0,0,10,1
2979,78716,rjA1flUm5W5QdousXm9Zvd4FhEyMHlGN,SpATywNh6bZuzm8s1ceuBUnMUAeoAHHw,6,5,2,0,1,0,1,0,9,1.2857142857142858,1,0.0,0,2,0,1,5,0,0,1,0,3,6,1
2980,78733,hiYWxbK79jotdVc0LNw6xFpPROtaee83,SpATywNh6bZuzm8s1ceuBUnMUAeoAHHw,7,6,2,0,1,0,3,0,12,1.7142857142857142,2,0.0,0,2,0,1,6,0,0,3,0,3,9,0
2981,78761,w7e18flx60x3aWIj6WG7yk02Ben80Ufh,SpATywNh6bZuzm8s1ceuBUnMUAeoAHHw,6,1,1,0,1,0,3,0,6,0.8571428571428571,1,0.0,0,1,0,1,1,0,0,3,0,2,4,1
2982,78765,UwNh19bGTGX7YEBtcKZFqxDpmh2gUs3A,A3fsA9Zfv1X2fVEQhTw51lKENdNrEqT3,17,17,10,0,8,0,2,0,37,5.285714285714286,2,0.0,0,10,0,8,17,0,0,2,0,18,19,1
2983,78773,Hua13xdEo1dQEcejfla3D6xiVkGTobMn,A3fsA9Zfv1X2fVEQhTw51lKENdNrEqT3,44,23,19,62,16,0,5,0,125,17.857142857142858,3,0.0,1,19,51,16,22,0,11,5,0,87,38,1
2984,78776,eAArxLyCThtu9N3Mv8rQculKbGSa66j9,A3fsA9Zfv1X2fVEQhTw51lKENdNrEqT3,5,3,2,0,0,0,2,0,7,1.0,2,0.0,0,2,0,0,3,0,0,2,0,2,5,1
2985,78793,hUKI9vR9OSrT9NXeUijAdTM2tdFNBSDI,SpATywNh6bZuzm8s1ceuBUnMUAeoAHHw,5,0,0,0,0,1,4,1,6,0.8571428571428571,1,0.0,0,0,0,0,0,1,0,4,1,0,6,1
2986,78822,WmqMKoevd5yMpzwxk3BDNFkg4y1FZjx5,A3fsA9Zfv1X2fVEQhTw51lKENdNrEqT3,18,31,3,0,2,0,6,0,42,6.0,3,0.0,1,3,0,2,30,0,0,6,0,6,36,1
2987,78828,DLDhUvvvfnnYFJuV65Zt2yaS0jPJgvzq,RXDvfPUBYFlVdlueBFbLW0mhhAyGEqpt,1,0,0,0,0,0,1,0,1,0.14285714285714285,1,0.0,0,0,0,0,0,0,0,1,0,0,1,1
2988,78834,Ffohn9JNnGJQD2IavzMTS00ubnVtcb2T,bWdj2GDclj5ofokWjzoa5jAwMkxCykd6,17,17,9,16,6,3,3,0,54,7.714285714285714,2,0.0,5,9,14,6,12,3,2,3,0,34,20,0
2989,78843,FSe393m4kqHOdsL9YDo8QralMIqcUHdZ,A3fsA9Zfv1X2fVEQhTw51lKENdNrEqT3,38,34,0,88,0,1,12,1,136,19.428571428571427,1,0.0,4,0,71,0,30,1,17,12,1,75,61,1
2990,78852,CfllunMvXOvFI7xojIDlg3YUnXMpOZhH,SpATywNh6bZuzm8s1ceuBUnMUAeoAHHw,1,0,0,0,0,0,1,0,1,0.14285714285714285,1,0.0,0,0,0,0,0,0,0,1,0,0,1,1
2991,78879,8a6lcOY5tqRSg2M4LEQLAhRHX2NBy9qe,G8EPVSXsOYB5YQWZGiz1aVq5Pgr2GrQu,46,59,26,64,17,12,12,3,193,27.571428571428573,4,0.0,25,26,47,17,34,12,17,12,3,115,78,0
2992,78880,b5FAs3DRd36MUCxhLKFjsHu3HN0mJvs6,SpATywNh6bZuzm8s1ceuBUnMUAeoAHHw,4,4,2,0,0,0,1,0,7,1.0,1,0.0,1,2,0,0,3,0,0,1,0,3,4,1
2993,78881,toLFcom7KFecBZf6qB124Knuopx8NQmy,SpATywNh6bZuzm8s1ceuBUnMUAeoAHHw,4,3,1,0,0,0,1,0,5,0.7142857142857143,1,0.0,0,1,0,0,3,0,0,1,0,1,4,0
2994,78893,m4OoBDaIG24Lym5ngdexbjC54oYFKP8C,SpATywNh6bZuzm8s1ceuBUnMUAeoAHHw,10,9,2,0,2,0,7,0,20,2.857142857142857,2,0.0,0,2,0,2,9,0,0,7,0,4,16,0
2995,78897,E96VmAw6m1AOHRckdqiq2ASKbnHBlpAb,A3fsA9Zfv1X2fVEQhTw51lKENdNrEqT3,7,9,2,0,0,0,7,0,18,2.5714285714285716,2,0.0,0,2,0,0,9,0,0,7,0,2,16,0
2996,78914,azVElWk7I3VwRJA3S907C5a9P0Jn3yCG,SpATywNh6bZuzm8s1ceuBUnMUAeoAHHw,15,19,14,20,7,0,0,0,60,8.571428571428571,2,0.0,4,14,16,7,15,0,4,0,0,41,19,1
2997,78923,8Sqo9fjyeTTkNJlQMuecsmvzSyQTiwcU,A3fsA9Zfv1X2fVEQhTw51lKENdNrEqT3,2,0,0,0,0,0,2,0,2,0.2857142857142857,1,0.0,0,0,0,0,0,0,0,2,0,0,2,1
2998,78937,oZKhsAromYlsN9MhR64yAv55dJDSDM8L,A3fsA9Zfv1X2fVEQhTw51lKENdNrEqT3,43,33,15,76,10,0,6,1,141,20.142857142857142,2,0.0,1,15,63,10,32,0,13,6,1,89,52,1
2999,78947,v9rP8OpiFSURJRERz1ekVHhngFGnpcnQ,A3fsA9Zfv1X2fVEQhTw51lKENdNrEqT3,1,0,0,0,0,0,1,0,1,0.14285714285714285,1,0.0,0,0,0,0,0,0,0,1,0,0,1,1
3000,78948,0OC0czg5KrchA85VzU71XhGpYSu49K6t,SpATywNh6bZuzm8s1ceuBUnMUAeoAHHw,1,0,0,0,0,0,1,0,1,0.14285714285714285,1,0.0,0,0,0,0,0,0,0,1,0,0,1,0
3001,78967,GCaUOiguxLs9b5sngb0RwjOWSkIZZOW6,G8EPVSXsOYB5YQWZGiz1aVq5Pgr2GrQu,18,24,0,26,0,0,5,0,55,7.857142857142857,2,0.0,10,0,15,0,14,0,11,5,0,25,30,1
3002,78972,ef55znmweQJrijlI0fO1Ekc271nZnV0m,SpATywNh6bZuzm8s1ceuBUnMUAeoAHHw,4,9,5,0,0,0,4,0,18,2.5714285714285716,3,0.0,1,5,0,0,8,0,0,4,0,6,12,0
3003,78980,B07cELO2KlXRGPLctjDn89XuHJVdJwZi,SpATywNh6bZuzm8s1ceuBUnMUAeoAHHw,4,0,0,0,0,1,3,0,4,0.5714285714285714,1,0.0,0,0,0,0,0,1,0,3,0,0,4,1
3004,78981,NohnA6aI0IdpBmazHAgdTY50K8lYcWSq,A3fsA9Zfv1X2fVEQhTw51lKENdNrEqT3,1,0,0,0,0,0,1,0,1,0.14285714285714285,1,0.0,0,0,0,0,0,0,0,1,0,0,1,1
3005,78984,v6Va3YleqjOFxWX0C18ItZbiVgGPA6xX,RXDvfPUBYFlVdlueBFbLW0mhhAyGEqpt,6,17,2,0,0,5,3,0,27,3.857142857142857,2,0.0,0,2,0,0,17,5,0,3,0,2,25,1
3006,78990,bYjPoNbc5ILh7K7s9YR8HLOMNJGN6Ums,bWdj2GDclj5ofokWjzoa5jAwMkxCykd6,4,3,1,0,1,0,1,0,6,0.8571428571428571,1,0.0,0,1,0,1,3,0,0,1,0,2,4,1
3007,79004,xsisvuj6gK52B2ADQNofz9kAaPqANNhO,SpATywNh6bZuzm8s1ceuBUnMUAeoAHHw,5,3,0,0,0,0,3,0,6,0.8571428571428571,1,0.0,0,0,0,0,3,0,0,3,0,0,6,1
3008,79006,mP6z9RZ14UwkQFXdxH2YSItn6R2tzg1x,SpATywNh6bZuzm8s1ceuBUnMUAeoAHHw,3,1,1,0,1,0,0,0,3,0.42857142857142855,1,0.0,0,1,0,1,1,0,0,0,0,2,1,1
3009,79007,THie45OT0ypeHdwObqe2tZANN0miCnWz,SpATywNh6bZuzm8s1ceuBUnMUAeoAHHw,1,0,0,0,0,0,2,0,2,0.2857142857142857,1,0.0,0,0,0,0,0,0,0,2,0,0,2,1
3010,79020,lYvVL2L87vZrMtNfBHPIK2tByK515zCD,SpATywNh6bZuzm8s1ceuBUnMUAeoAHHw,4,3,2,0,0,4,1,0,10,1.4285714285714286,1,0.0,0,2,0,0,3,4,0,1,0,2,8,1
3011,79022,twCpzhGO216Hze2mrl4NXCjfHuwTo4Bh,SpATywNh6bZuzm8s1ceuBUnMUAeoAHHw,3,2,1,0,0,0,2,0,5,0.7142857142857143,1,0.0,0,1,0,0,2,0,0,2,0,1,4,0
3012,79046,L7niq1ncOBb383w11rnZfYbZzDjcQtn7,SpATywNh6bZuzm8s1ceuBUnMUAeoAHHw,1,0,0,0,0,0,1,0,1,0.14285714285714285,1,0.0,0,0,0,0,0,0,0,1,0,0,1,1
3013,79047,XEg540lTawnkyAL3QhiV5067z0uxHwgk,A3fsA9Zfv1X2fVEQhTw51lKENdNrEqT3,5,2,1,0,1,0,2,0,6,0.8571428571428571,1,0.0,0,1,0,1,2,0,0,2,0,2,4,1
3014,79052,3Ue58lEEP6phWdiZFyqYsSebxfUI01kl,G8EPVSXsOYB5YQWZGiz1aVq5Pgr2GrQu,1,0,0,0,0,0,1,0,1,0.14285714285714285,1,0.0,0,0,0,0,0,0,0,1,0,0,1,1
3015,79055,zTHTtX2nKd2KBXQuLnlYdTrAwR5h128q,SpATywNh6bZuzm8s1ceuBUnMUAeoAHHw,7,6,1,0,1,0,1,0,9,1.2857142857142858,1,0.0,1,1,0,1,5,0,0,1,0,3,6,1
3016,79060,iTtOMe88nbiuPASutV8uClvRUhsz01ky,SpATywNh6bZuzm8s1ceuBUnMUAeoAHHw,14,24,1,15,1,4,2,0,47,6.714285714285714,2,0.0,10,1,13,1,14,4,2,2,0,25,22,1
3017,79061,MoBz0U3Ui9CRWte6snkIzBaarIFflstn,SpATywNh6bZuzm8s1ceuBUnMUAeoAHHw,15,21,7,17,4,0,1,0,50,7.142857142857143,1,0.0,9,7,17,4,12,0,0,1,0,37,13,1
3018,79072,J5syH0FXR6WjYKnEvVUNdcCFIQBe5xVs,SpATywNh6bZuzm8s1ceuBUnMUAeoAHHw,10,7,4,0,3,0,4,0,18,2.5714285714285716,1,0.0,0,4,0,3,7,0,0,4,0,7,11,1
3019,79091,jSkiatUtSnpEyEODEjICZMBSnZji4UaY,SpATywNh6bZuzm8s1ceuBUnMUAeoAHHw,9,11,4,0,3,0,6,0,24,3.4285714285714284,1,0.0,0,4,0,3,11,0,0,6,0,7,17,1
3020,79092,7YLwmbXkWTQcIOGJa3UGeXl0rdNkt9r0,SpATywNh6bZuzm8s1ceuBUnMUAeoAHHw,15,25,11,20,4,0,10,0,70,10.0,2,0.0,8,11,17,4,17,0,3,10,0,40,30,1
3021,79110,TpoKGwVbR1z5uy5X3SWIdHRQv5iAfdP8,G8EPVSXsOYB5YQWZGiz1aVq5Pgr2GrQu,8,8,5,0,3,0,2,0,18,2.5714285714285716,1,0.0,0,5,0,3,8,0,0,2,0,8,10,0
3022,79137,uGhg5UtMcNJmxDTYVPsOvlEYnzl32Hxh,SpATywNh6bZuzm8s1ceuBUnMUAeoAHHw,1,0,0,0,0,0,1,0,1,0.14285714285714285,1,0.0,0,0,0,0,0,0,0,1,0,0,1,1
3023,79141,uGhg5UtMcNJmxDTYVPsOvlEYnzl32Hxh,bWdj2GDclj5ofokWjzoa5jAwMkxCykd6,1,0,0,0,0,0,1,0,1,0.14285714285714285,1,0.0,0,0,0,0,0,0,0,1,0,0,1,1
3024,79163,LwwIfMdYfjJJxHB8Z4Fggv4xXuygh6dE,A3fsA9Zfv1X2fVEQhTw51lKENdNrEqT3,5,10,0,0,0,0,7,0,17,2.4285714285714284,3,0.0,2,0,0,0,8,0,0,7,0,2,15,1
3025,79167,Zz3pwLjAzfZui2iOxDBByv28nniL3g2U,SpATywNh6bZuzm8s1ceuBUnMUAeoAHHw,8,6,4,0,1,0,1,0,12,1.7142857142857142,1,0.0,0,4,0,1,6,0,0,1,0,5,7,1
3026,79169,LwwIfMdYfjJJxHB8Z4Fggv4xXuygh6dE,bWdj2GDclj5ofokWjzoa5jAwMkxCykd6,14,10,2,42,0,14,3,0,71,10.142857142857142,3,0.0,0,2,36,0,10,14,6,3,0,38,33,0
3027,79170,h774wdF6vIIcl50Js74gckwUtlv9SBGH,SpATywNh6bZuzm8s1ceuBUnMUAeoAHHw,7,23,10,0,0,0,7,1,41,5.857142857142857,4,0.0,5,10,0,0,18,0,0,7,1,15,26,0
3028,79172,layckrYedWZgFw7etRwkXZmJxZfLSCWL,RXDvfPUBYFlVdlueBFbLW0mhhAyGEqpt,7,6,3,0,1,0,5,0,15,2.142857142857143,2,0.0,0,3,0,1,6,0,0,5,0,4,11,1
3029,79174,D34T8AaHzLaSWIuVXlXMljij4qGduaRA,bWdj2GDclj5ofokWjzoa5jAwMkxCykd6,4,3,0,0,0,0,4,0,7,1.0,1,0.0,0,0,0,0,3,0,0,4,0,0,7,1
3030,79178,7JsrwSACMJjWauKMGXgtvQhEeYIhl4Zy,G8EPVSXsOYB5YQWZGiz1aVq5Pgr2GrQu,19,15,10,0,8,0,2,0,35,5.0,1,0.0,2,10,0,8,13,0,0,2,0,20,15,1
3031,79180,PT6UXcwKy3wc3VzHkqI3gbGZ6DxtjZzB,SpATywNh6bZuzm8s1ceuBUnMUAeoAHHw,10,8,2,0,1,0,4,0,15,2.142857142857143,2,0.0,1,2,0,1,7,0,0,4,0,4,11,0
3032,79195,InUllTAkGXfLdwKOwLDshmASkFan6oBH,SpATywNh6bZuzm8s1ceuBUnMUAeoAHHw,1,0,0,0,0,0,1,0,1,0.14285714285714285,1,0.0,0,0,0,0,0,0,0,1,0,0,1,1
3033,79198,Edg0dAozE0JCiiLSAwIR5kwd1RYH2rd2,G8EPVSXsOYB5YQWZGiz1aVq5Pgr2GrQu,4,2,0,0,0,0,2,0,4,0.5714285714285714,1,0.0,0,0,0,0,2,0,0,2,0,0,4,1
3034,79238,KDatTi0m54YiEzXl0F0AXQe6UojttDHe,SpATywNh6bZuzm8s1ceuBUnMUAeoAHHw,2,0,0,0,0,0,2,0,2,0.2857142857142857,1,0.0,0,0,0,0,0,0,0,2,0,0,2,1
3035,79239,U7VST4h8u3L0dHQ2t3EXKPCnNxPfh7x1,SpATywNh6bZuzm8s1ceuBUnMUAeoAHHw,2,0,0,0,0,0,2,0,2,0.2857142857142857,1,0.0,0,0,0,0,0,0,0,2,0,0,2,1
3036,79244,Rq4yaO7GHrMIHqYMcL0bgP4mTQfRB57T,bWdj2GDclj5ofokWjzoa5jAwMkxCykd6,6,3,1,0,1,0,4,2,11,1.5714285714285714,1,0.0,0,1,0,1,3,0,0,4,2,2,9,1
3037,79263,ZnZiec7AmaGxSp844K5Oif1ySc9WoZ4f,SpATywNh6bZuzm8s1ceuBUnMUAeoAHHw,1,0,0,0,0,0,1,0,1,0.14285714285714285,1,0.0,0,0,0,0,0,0,0,1,0,0,1,1
3038,79273,DpXkrIHIAIPNESKyvFah0WhpVT5PHFeL,A3fsA9Zfv1X2fVEQhTw51lKENdNrEqT3,4,3,2,0,0,0,1,0,6,0.8571428571428571,1,0.0,0,2,0,0,3,0,0,1,0,2,4,1
3039,79281,1bKMONcV6Mq58szdlIajPdFyqaw4BvrA,A3fsA9Zfv1X2fVEQhTw51lKENdNrEqT3,5,2,1,0,1,0,2,0,6,0.8571428571428571,1,0.0,0,1,0,1,2,0,0,2,0,2,4,1
3040,79287,wd4pAwN3deBeynXwR5OfOX4prNtBduEk,bWdj2GDclj5ofokWjzoa5jAwMkxCykd6,6,5,3,0,1,0,1,0,10,1.4285714285714286,1,0.0,0,3,0,1,5,0,0,1,0,4,6,1
3041,79290,vtrHNbtnxRGyZem1sSOdKIp109fZtSKY,SpATywNh6bZuzm8s1ceuBUnMUAeoAHHw,3,2,1,0,0,0,1,0,4,0.5714285714285714,1,0.0,0,1,0,0,2,0,0,1,0,1,3,0
3042,79299,gpn05NwMGqKm6lLZGRrnOmPlhHxlC7Wb,A3fsA9Zfv1X2fVEQhTw51lKENdNrEqT3,29,16,9,67,1,0,6,0,99,14.142857142857142,2,0.0,2,9,61,1,14,0,6,6,0,73,26,1
3043,79307,3MN9gqffGxZJqVwbda6Nr5mGlWwnaW7z,G8EPVSXsOYB5YQWZGiz1aVq5Pgr2GrQu,73,73,42,134,33,0,3,0,285,40.714285714285715,2,0.0,27,42,110,33,46,0,24,3,0,212,73,0
3044,79315,b9hN1tjIpM67gB8PuwPQ3u561lqo1V2f,A3fsA9Zfv1X2fVEQhTw51lKENdNrEqT3,6,3,2,0,1,0,2,0,8,1.1428571428571428,2,0.0,0,2,0,1,3,0,0,2,0,3,5,1
3045,79316,tOQd1UTCcWjv4TzfNnDKeVxaYKZcK6zC,SpATywNh6bZuzm8s1ceuBUnMUAeoAHHw,6,7,5,0,3,0,4,0,19,2.7142857142857144,2,0.0,0,5,0,3,7,0,0,4,0,8,11,1
3046,79320,xJW8ZtKDlfhPg81A47phNyXQMCFChGTr,A3fsA9Zfv1X2fVEQhTw51lKENdNrEqT3,1,0,0,0,0,0,1,0,1,0.14285714285714285,1,0.0,0,0,0,0,0,0,0,1,0,0,1,1
3047,79325,O8PspZcvgkNwi1MucHwbb6Csnu0UqahQ,SpATywNh6bZuzm8s1ceuBUnMUAeoAHHw,7,8,4,0,3,0,1,0,16,2.2857142857142856,2,0.0,2,4,0,3,6,0,0,1,0,9,7,1
3048,79338,pubFqThb9vS8zwU3cGWTlZ3rwYEdRpLE,SpATywNh6bZuzm8s1ceuBUnMUAeoAHHw,9,7,3,0,3,0,4,2,19,2.7142857142857144,1,0.0,0,3,0,3,7,0,0,4,2,6,13,1
3049,79352,giXuT5U1RtMqgo8IXt5j9x4mrlpr0AWq,SpATywNh6bZuzm8s1ceuBUnMUAeoAHHw,13,15,1,12,1,0,3,0,32,4.571428571428571,2,0.0,4,1,12,1,11,0,0,3,0,18,14,0
3050,79358,YUp9wnsqBKRrw8pzgc3Bo2ZNocfIQJ74,SpATywNh6bZuzm8s1ceuBUnMUAeoAHHw,5,3,1,0,1,0,3,0,8,1.1428571428571428,1,0.0,1,1,0,1,2,0,0,3,0,3,5,1
3051,79374,2Z36vzEoy2AuTF2qkFNHld62ohkbaoik,G8EPVSXsOYB5YQWZGiz1aVq5Pgr2GrQu,1,0,0,0,0,0,1,0,1,0.14285714285714285,1,0.0,0,0,0,0,0,0,0,1,0,0,1,1
3052,79378,LgPlpopSU02baX8XsEJO6rWixplusEKm,SpATywNh6bZuzm8s1ceuBUnMUAeoAHHw,8,8,6,0,2,0,2,0,18,2.5714285714285716,2,0.0,0,6,0,2,8,0,0,2,0,8,10,0
3053,79382,txR343znllIAYfUTT6ID4MaG49Hdxeix,A3fsA9Zfv1X2fVEQhTw51lKENdNrEqT3,12,8,7,0,4,1,12,0,32,4.571428571428571,2,0.0,1,7,0,4,7,1,0,12,0,12,20,1
3054,79392,yUyVc0xcETBdtpqOJUXovZ3QcO5gddPt,SpATywNh6bZuzm8s1ceuBUnMUAeoAHHw,10,9,4,0,2,0,3,0,18,2.5714285714285716,3,0.0,2,4,0,2,7,0,0,3,0,8,10,1
3055,79408,xrzB2fu1qTsTekSF1ue54a05GliBSiQw,G8EPVSXsOYB5YQWZGiz1aVq5Pgr2GrQu,1,0,0,0,0,0,1,0,1,0.14285714285714285,1,0.0,0,0,0,0,0,0,0,1,0,0,1,0
3056,79415,hDbCMto0j5iDn7Maxag0gQGk8WC8ErXx,A3fsA9Zfv1X2fVEQhTw51lKENdNrEqT3,1,0,0,0,0,0,1,0,1,0.14285714285714285,1,0.0,0,0,0,0,0,0,0,1,0,0,1,1
3057,79416,s1GlDLVUCJ2BKuqNJCwk2KXE92Q3fWuw,SpATywNh6bZuzm8s1ceuBUnMUAeoAHHw,2,0,0,0,0,0,2,0,2,0.2857142857142857,1,0.0,0,0,0,0,0,0,0,2,0,0,2,1
3058,79417,hDbCMto0j5iDn7Maxag0gQGk8WC8ErXx,bWdj2GDclj5ofokWjzoa5jAwMkxCykd6,1,0,0,0,0,0,1,0,1,0.14285714285714285,1,0.0,0,0,0,0,0,0,0,1,0,0,1,1
3059,79430,3MN9gqffGxZJqVwbda6Nr5mGlWwnaW7z,SpATywNh6bZuzm8s1ceuBUnMUAeoAHHw,13,17,10,0,4,0,4,0,35,5.0,2,0.0,2,10,0,4,15,0,0,4,0,16,19,0
3060,79443,FhE6YIauK1Fn9VMPL41bdd6jvfL2mFQX,SpATywNh6bZuzm8s1ceuBUnMUAeoAHHw,20,26,12,20,5,2,9,1,75,10.714285714285714,3,0.0,10,12,17,5,16,2,3,9,1,44,31,1
3061,79447,xhSNxzAdJZ3UvqN1HWRUi586YbiFg3gP,A3fsA9Zfv1X2fVEQhTw51lKENdNrEqT3,2,0,0,0,0,0,4,0,4,0.5714285714285714,1,0.0,0,0,0,0,0,0,0,4,0,0,4,1
3062,79458,onuTApdLgDnonVluLQhn0MEl8fr7acBD,SpATywNh6bZuzm8s1ceuBUnMUAeoAHHw,6,5,0,0,0,0,10,0,15,2.142857142857143,1,0.0,0,0,0,0,5,0,0,10,0,0,15,1
3063,79468,f1tp9GXe4J7KK6zPunhxBF4LGwylqtkw,A3fsA9Zfv1X2fVEQhTw51lKENdNrEqT3,1,0,0,0,0,0,1,0,1,0.14285714285714285,1,0.0,0,0,0,0,0,0,0,1,0,0,1,1
3064,79469,fu60FMGFqAwgUp8glfVKZNcdqYonSFb4,bWdj2GDclj5ofokWjzoa5jAwMkxCykd6,1,0,0,0,0,0,1,0,1,0.14285714285714285,1,0.0,0,0,0,0,0,0,0,1,0,0,1,1
3065,79478,JpLo3QIFwGWGVDbiGmNZwT1Vbl57aYGg,bWdj2GDclj5ofokWjzoa5jAwMkxCykd6,9,7,1,14,3,0,4,0,29,4.142857142857143,1,0.0,5,1,14,3,2,0,0,4,0,23,6,1
3066,79498,GPbq86k98Rz9tUbijEEopIymy9u0Fcyf,RXDvfPUBYFlVdlueBFbLW0mhhAyGEqpt,1,0,0,0,0,0,1,0,1,0.14285714285714285,1,0.0,0,0,0,0,0,0,0,1,0,0,1,1
3067,79565,9XlOX9Eokvp6Ei0R3cZVPHieVEjDZ3jD,SpATywNh6bZuzm8s1ceuBUnMUAeoAHHw,1,0,0,0,0,0,1,0,1,0.14285714285714285,1,0.0,0,0,0,0,0,0,0,1,0,0,1,1
3068,79568,rZUdPpi92l1qQIS8kuhajEO9kujkZRBg,SpATywNh6bZuzm8s1ceuBUnMUAeoAHHw,1,0,0,0,0,0,2,0,2,0.2857142857142857,1,0.0,0,0,0,0,0,0,0,2,0,0,2,1
3069,79580,D5cI8Qw5g3uZUHpPzRKVsXECgTB7bAYQ,SpATywNh6bZuzm8s1ceuBUnMUAeoAHHw,7,3,1,0,1,0,3,0,8,1.1428571428571428,1,0.0,0,1,0,1,3,0,0,3,0,2,6,1
3070,79596,dOESZLIKPuHnZVCxKOM963mYGkTHRDgL,SpATywNh6bZuzm8s1ceuBUnMUAeoAHHw,1,0,0,0,0,0,1,0,1,0.14285714285714285,1,0.0,0,0,0,0,0,0,0,1,0,0,1,1
3071,79606,ZOTpNZ0MPCzhXQVB7FrlPGVckR2bh01V,SpATywNh6bZuzm8s1ceuBUnMUAeoAHHw,15,43,1,17,2,2,9,1,75,10.714285714285714,2,0.0,19,1,16,2,24,2,1,9,1,38,37,0
3072,79608,cqucGUKHc5OyzV7unT5Cx0FmLMjKSwuY,SpATywNh6bZuzm8s1ceuBUnMUAeoAHHw,23,30,1,25,0,1,9,1,67,9.571428571428571,3,0.0,11,1,25,0,19,1,0,9,1,37,30,1
3073,79612,WEqJEPw3UV2Mp3IuXDKYrDsEow0Eq2np,SpATywNh6bZuzm8s1ceuBUnMUAeoAHHw,22,14,9,8,7,0,3,0,41,5.857142857142857,1,0.0,5,9,8,7,9,0,0,3,0,29,12,1
3074,79614,fIRimGrxWNqdzbEvkhoxiWFjGRhUXcWW,A3fsA9Zfv1X2fVEQhTw51lKENdNrEqT3,4,3,1,0,0,0,1,0,5,0.7142857142857143,1,0.0,0,1,0,0,3,0,0,1,0,1,4,0
3075,79639,HHjw6PARN0UbkiffbOwvG4RULtVIyY0R,RXDvfPUBYFlVdlueBFbLW0mhhAyGEqpt,8,8,1,0,1,4,2,0,16,2.2857142857142856,2,0.0,0,1,0,1,8,4,0,2,0,2,14,0
3076,79644,tx5OZwe4nbDaE4essnf26SrQBKKIE3v3,SpATywNh6bZuzm8s1ceuBUnMUAeoAHHw,12,19,3,0,3,1,11,0,37,5.285714285714286,1,0.0,0,3,0,3,19,1,0,11,0,6,31,1
3077,79685,gcVoHE2eZKEdZoZi7osuc3qSbsrdZukl,SpATywNh6bZuzm8s1ceuBUnMUAeoAHHw,5,2,1,0,1,0,2,0,6,0.8571428571428571,1,0.0,0,1,0,1,2,0,0,2,0,2,4,1
3078,79689,yMKOk0dVftHnVR1CEiO9scq4ARXi4xK4,RXDvfPUBYFlVdlueBFbLW0mhhAyGEqpt,31,15,15,0,14,0,9,0,53,7.571428571428571,2,0.0,0,15,0,14,15,0,0,9,0,29,24,1
3079,79716,WIkPVA3ZQexYqPa7aSal3hPiR2XYOXKW,SpATywNh6bZuzm8s1ceuBUnMUAeoAHHw,5,4,2,0,0,0,2,0,8,1.1428571428571428,1,0.0,1,2,0,0,3,0,0,2,0,3,5,1
3080,79730,DfqPNSIrdvOzcxA1l2O2553pTk1dT4j1,SpATywNh6bZuzm8s1ceuBUnMUAeoAHHw,6,3,2,0,2,0,1,0,8,1.1428571428571428,1,0.0,0,2,0,2,3,0,0,1,0,4,4,1
3081,79754,wYJCkBOQ32exeR75AeEladGac7kG04uu,G8EPVSXsOYB5YQWZGiz1aVq5Pgr2GrQu,2,0,0,0,0,0,2,0,2,0.2857142857142857,1,0.0,0,0,0,0,0,0,0,2,0,0,2,1
3082,79762,cRzRjCJgmuuwG5N13DvLSiSY2kvou3I1,RXDvfPUBYFlVdlueBFbLW0mhhAyGEqpt,7,3,2,0,2,0,3,0,10,1.4285714285714286,1,0.0,0,2,0,2,3,0,0,3,0,4,6,1
3083,79783,MMo67tZd2HnjPcYw7tUwheGT7fqD2cqI,SpATywNh6bZuzm8s1ceuBUnMUAeoAHHw,30,40,14,38,10,28,16,4,150,21.428571428571427,1,0.0,25,14,35,10,15,28,3,16,4,84,66,0
3084,79797,ziI4sKMlAzhuWPMy9t2U96G01O68Dxyj,A3fsA9Zfv1X2fVEQhTw51lKENdNrEqT3,23,4,0,54,0,0,4,0,62,8.857142857142858,1,0.0,1,0,47,0,3,0,7,4,0,48,14,0
3085,79798,tFCnCHPhdyVxBnAUk6TxLus2jXyEZIZz,SpATywNh6bZuzm8s1ceuBUnMUAeoAHHw,1,0,0,0,0,0,1,0,1,0.14285714285714285,1,0.0,0,0,0,0,0,0,0,1,0,0,1,1
3086,79806,Ku1kMcdvssJWj6FcSWxZr39sjgOG0VOZ,SpATywNh6bZuzm8s1ceuBUnMUAeoAHHw,17,20,11,18,6,3,9,0,67,9.571428571428571,2,0.0,6,11,15,6,14,3,3,9,0,38,29,1
3087,79813,qMFAmPw34z5IViYTtA1Kkpcn2uEg1WBM,RXDvfPUBYFlVdlueBFbLW0mhhAyGEqpt,5,3,2,0,1,0,1,0,7,1.0,1,0.0,0,2,0,1,3,0,0,1,0,3,4,1
3088,79820,h8BwrBZ61dHhi5fhxZzTUeeYh9J3sER4,SpATywNh6bZuzm8s1ceuBUnMUAeoAHHw,2,0,0,0,0,0,2,0,2,0.2857142857142857,1,0.0,0,0,0,0,0,0,0,2,0,0,2,1
3089,79825,TsxkgE9HYxx9Zb0VBXE5lsblSSqIkd78,SpATywNh6bZuzm8s1ceuBUnMUAeoAHHw,5,15,5,0,1,0,1,0,22,3.142857142857143,1,0.0,0,5,0,1,15,0,0,1,0,6,16,1
3090,79851,g8GfWRB0OxvXROL4NPNW5ZSi8XCvG0Vj,SpATywNh6bZuzm8s1ceuBUnMUAeoAHHw,1,0,0,0,0,0,1,0,1,0.14285714285714285,1,0.0,0,0,0,0,0,0,0,1,0,0,1,1
3091,79859,gEzMd6gbgpZIm67NWd6vqHpEEo3Eo4i8,SpATywNh6bZuzm8s1ceuBUnMUAeoAHHw,7,3,2,0,2,4,4,0,15,2.142857142857143,1,0.0,0,2,0,2,3,4,0,4,0,4,11,1
3092,79861,E2JkawM7swORjZfJKIvXjkQElhQ86LjY,SpATywNh6bZuzm8s1ceuBUnMUAeoAHHw,5,2,0,0,1,0,2,0,5,0.7142857142857143,1,0.0,0,0,0,1,2,0,0,2,0,1,4,1
3093,79872,kFWoX8WayJBb1JiJ1zWV3jeUZLUqB1uv,SpATywNh6bZuzm8s1ceuBUnMUAeoAHHw,1,0,0,0,0,0,1,0,1,0.14285714285714285,1,0.0,0,0,0,0,0,0,0,1,0,0,1,1
3094,79874,P9ocaJAKrVY3fEwlpYkQdiICF2x4gV0B,SpATywNh6bZuzm8s1ceuBUnMUAeoAHHw,1,0,0,0,0,0,1,0,1,0.14285714285714285,1,0.0,0,0,0,0,0,0,0,1,0,0,1,1
3095,79887,yonwfYKGqRaxFqA59D8fadwOwcb5hmqL,SpATywNh6bZuzm8s1ceuBUnMUAeoAHHw,16,35,15,14,7,9,10,0,90,12.857142857142858,4,0.0,6,15,13,7,29,9,1,10,0,41,49,1
3096,79893,Wd5Y51TL4njlLeYHUjz5D9nrsHvDXUZ8,bWdj2GDclj5ofokWjzoa5jAwMkxCykd6,4,2,1,0,1,0,1,0,5,0.7142857142857143,1,0.0,0,1,0,1,2,0,0,1,0,2,3,1
3097,79950,mvNsYHmLGVvx6RdgKEq4DO6WGtgd6ICk,G8EPVSXsOYB5YQWZGiz1aVq5Pgr2GrQu,2,0,0,0,0,0,2,0,2,0.2857142857142857,1,0.0,0,0,0,0,0,0,0,2,0,0,2,1
3098,79951,mvNsYHmLGVvx6RdgKEq4DO6WGtgd6ICk,RXDvfPUBYFlVdlueBFbLW0mhhAyGEqpt,2,0,0,0,0,0,2,0,2,0.2857142857142857,1,0.0,0,0,0,0,0,0,0,2,0,0,2,1
3099,79954,U0h9ZcOzwmSa5zXabz3gRq51gj9CVPUf,SpATywNh6bZuzm8s1ceuBUnMUAeoAHHw,22,37,19,28,7,7,9,0,107,15.285714285714286,3,0.0,9,19,27,7,28,7,1,9,0,62,45,0
3100,79959,ViTvmoQakNqraCyfp2YEkEE863w1n9bk,A3fsA9Zfv1X2fVEQhTw51lKENdNrEqT3,10,8,6,0,5,0,3,0,22,3.142857142857143,1,0.0,1,6,0,5,7,0,0,3,0,12,10,1
3101,79973,lxjW2IwfKKnK2DrRSZaIR9GsDl9lxdt8,A3fsA9Zfv1X2fVEQhTw51lKENdNrEqT3,10,9,6,0,5,0,2,0,22,3.142857142857143,2,0.0,0,6,0,5,9,0,0,2,0,11,11,0
3102,79979,CNhJjrWccp5AYlucreTqDX8ieLTPwczE,bWdj2GDclj5ofokWjzoa5jAwMkxCykd6,1,0,0,0,0,0,1,0,1,0.14285714285714285,1,0.0,0,0,0,0,0,0,0,1,0,0,1,1
3103,79986,4LisTHudeBfv9ZX0nmcSnvoJT2p6nfzE,RXDvfPUBYFlVdlueBFbLW0mhhAyGEqpt,5,2,0,0,0,0,4,1,7,1.0,1,0.0,0,0,0,0,2,0,0,4,1,0,7,1
3104,79987,N3hAbbmjAcgnrOfHxCtYgYIWhCN4yU2c,SpATywNh6bZuzm8s1ceuBUnMUAeoAHHw,29,48,15,37,8,8,11,5,132,18.857142857142858,1,0.0,18,15,33,8,30,8,4,11,5,74,58,1
3105,79991,CmIaRR2qgpGVOUIbsTC8R6ZChGQweVzS,SpATywNh6bZuzm8s1ceuBUnMUAeoAHHw,1,0,0,0,0,0,1,0,1,0.14285714285714285,1,0.0,0,0,0,0,0,0,0,1,0,0,1,1
3106,79992,zYV55JtHGMyWJNzyklwx9RUxhxbuIU91,SpATywNh6bZuzm8s1ceuBUnMUAeoAHHw,16,15,11,16,0,0,6,0,48,6.857142857142857,2,0.0,2,11,13,0,13,0,3,6,0,26,22,1
3107,80003,8MTzNIeHZxoPzUB3QuA9UPwzkLipeLI2,SpATywNh6bZuzm8s1ceuBUnMUAeoAHHw,27,26,15,28,8,0,2,0,79,11.285714285714286,1,0.0,9,15,24,8,17,0,4,2,0,56,23,0
3108,80028,HW81M2taDDpjfIALyR6RGLxMn7Z51s6I,SpATywNh6bZuzm8s1ceuBUnMUAeoAHHw,6,3,1,0,1,0,2,0,7,1.0,1,0.0,0,1,0,1,3,0,0,2,0,2,5,1
3109,80047,QjwQzuiA6TAJjCb0ag4sYfZRjiTOPACp,SpATywNh6bZuzm8s1ceuBUnMUAeoAHHw,11,9,7,21,2,0,1,0,40,5.714285714285714,2,0.0,2,7,17,2,7,0,4,1,0,28,12,0
3110,80052,dALdfMzfktV6uHq0TdqzSFS1vTHWuBBf,RXDvfPUBYFlVdlueBFbLW0mhhAyGEqpt,1,0,0,0,0,0,1,0,1,0.14285714285714285,1,0.0,0,0,0,0,0,0,0,1,0,0,1,1
3111,80060,PeuNsQ0DfVUJN0dfnSQ4wu6EhabO3RIr,SpATywNh6bZuzm8s1ceuBUnMUAeoAHHw,6,11,4,0,2,0,5,0,22,3.142857142857143,2,0.0,0,4,0,2,11,0,0,5,0,6,16,1
3112,80068,u88ty77IjrBmBqGSc7g01hskCAQHKUhV,SpATywNh6bZuzm8s1ceuBUnMUAeoAHHw,1,0,0,0,0,0,1,0,1,0.14285714285714285,1,0.0,0,0,0,0,0,0,0,1,0,0,1,1
3113,80090,IAOTVxG7e06ArppQIZcVBCeppiZS52Zi,bWdj2GDclj5ofokWjzoa5jAwMkxCykd6,1,0,0,0,0,0,1,0,1,0.14285714285714285,1,0.0,0,0,0,0,0,0,0,1,0,0,1,1
3114,80097,RPansaKc9yPYyKahcqLAJO6a0GoBHglr,bWdj2GDclj5ofokWjzoa5jAwMkxCykd6,4,3,2,0,0,0,1,0,6,0.8571428571428571,1,0.0,0,2,0,0,3,0,0,1,0,2,4,1
3115,80124,CUvKB4XQpBmSBshZw5ZdyRvSPwxCLw87,SpATywNh6bZuzm8s1ceuBUnMUAeoAHHw,1,0,0,0,0,0,1,0,1,0.14285714285714285,1,0.0,0,0,0,0,0,0,0,1,0,0,1,1
3116,80132,hnPqEloZo6dqHCQR5BDkkOtRq9rLOuCJ,RXDvfPUBYFlVdlueBFbLW0mhhAyGEqpt,2,0,0,0,0,0,2,0,2,0.2857142857142857,1,0.0,0,0,0,0,0,0,0,2,0,0,2,1
3117,80136,XQFWhrsULMJrGiXoFieAPwx4Rm1ETQ8D,SpATywNh6bZuzm8s1ceuBUnMUAeoAHHw,4,5,3,0,0,0,2,0,10,1.4285714285714286,2,0.0,0,3,0,0,5,0,0,2,0,3,7,0
3118,80140,yvsrEHHhwnRtY4nOPyuGoTME5YnK10XZ,SpATywNh6bZuzm8s1ceuBUnMUAeoAHHw,6,7,1,0,1,0,2,0,11,1.5714285714285714,1,0.0,0,1,0,1,7,0,0,2,0,2,9,1
3119,80145,LW6Tlr1sh6qRnRRoccMyoktiDikrPY7X,SpATywNh6bZuzm8s1ceuBUnMUAeoAHHw,5,2,1,0,1,0,2,0,6,0.8571428571428571,1,0.0,0,1,0,1,2,0,0,2,0,2,4,1
3120,80153,WltsLfDHgmeE6MCb49VMxs0TpIKzPZYO,SpATywNh6bZuzm8s1ceuBUnMUAeoAHHw,6,3,1,0,1,0,2,0,7,1.0,1,0.0,0,1,0,1,3,0,0,2,0,2,5,1
3121,80167,P4jUBX1wYi9y3sCR2kOEae0bW8qmRIv0,SpATywNh6bZuzm8s1ceuBUnMUAeoAHHw,8,13,6,0,3,0,6,0,28,4.0,1,0.0,0,6,0,3,13,0,0,6,0,9,19,1
3122,80202,fmLFfxTDbxBjR0ZGqW3ABKUJvjXC97BH,RXDvfPUBYFlVdlueBFbLW0mhhAyGEqpt,8,3,1,0,1,0,4,1,10,1.4285714285714286,1,0.0,0,1,0,1,3,0,0,4,1,2,8,1
3123,80207,53qrF6M0dMx7kKnOiKvVv5yJevXuY3XD,RXDvfPUBYFlVdlueBFbLW0mhhAyGEqpt,8,6,5,0,1,0,1,0,13,1.8571428571428572,1,0.0,0,5,0,1,6,0,0,1,0,6,7,1
3124,80208,A6qBZik0VBfWjUh1l97ldNrUQvZV7VDA,bWdj2GDclj5ofokWjzoa5jAwMkxCykd6,7,5,2,0,2,0,2,0,11,1.5714285714285714,1,0.0,0,2,0,2,5,0,0,2,0,4,7,1
3125,80226,IVH8kKmCoTvdDqBRydeePjJ8DeEc5nxo,G8EPVSXsOYB5YQWZGiz1aVq5Pgr2GrQu,3,1,1,0,1,0,0,0,3,0.42857142857142855,1,0.0,0,1,0,1,1,0,0,0,0,2,1,1
3126,80231,v20UMppd3ocHkd49REEhfohYTaesL83r,SpATywNh6bZuzm8s1ceuBUnMUAeoAHHw,3,2,1,0,0,0,1,0,4,0.5714285714285714,1,0.0,0,1,0,0,2,0,0,1,0,1,3,1
3127,80243,JouvtE8n4ChPr4xaVaDvsPHmw4GRKG3o,SpATywNh6bZuzm8s1ceuBUnMUAeoAHHw,2,0,0,0,0,0,2,0,2,0.2857142857142857,1,0.0,0,0,0,0,0,0,0,2,0,0,2,1
3128,80256,qbxr7nsJKbupU2nnOZ4AXSvMY5DklIDV,SpATywNh6bZuzm8s1ceuBUnMUAeoAHHw,11,10,7,0,3,0,4,0,24,3.4285714285714284,3,0.0,0,7,0,3,10,0,0,4,0,10,14,0
3129,80259,BJsE566nx9Uhzip3qBQTh9T7yFdMy0IZ,SpATywNh6bZuzm8s1ceuBUnMUAeoAHHw,6,4,1,0,1,0,1,0,7,1.0,1,0.0,0,1,0,1,4,0,0,1,0,2,5,1
3130,80283,TY4t65XwSRMNK0q3MPTxoH0jDDniCwnz,bWdj2GDclj5ofokWjzoa5jAwMkxCykd6,1,0,0,0,0,0,1,0,1,0.14285714285714285,1,0.0,0,0,0,0,0,0,0,1,0,0,1,1
3131,80287,TY4t65XwSRMNK0q3MPTxoH0jDDniCwnz,RXDvfPUBYFlVdlueBFbLW0mhhAyGEqpt,2,0,0,0,0,0,2,0,2,0.2857142857142857,1,0.0,0,0,0,0,0,0,0,2,0,0,2,1
3132,80289,ZNeDcv9lqRN7ZQjZM2CkfhEwlbeNJpas,SpATywNh6bZuzm8s1ceuBUnMUAeoAHHw,3,4,2,0,0,0,3,0,9,1.2857142857142858,3,0.0,0,2,0,0,4,0,0,3,0,2,7,0
3133,80298,TY4t65XwSRMNK0q3MPTxoH0jDDniCwnz,SpATywNh6bZuzm8s1ceuBUnMUAeoAHHw,1,0,0,0,0,0,1,0,1,0.14285714285714285,1,0.0,0,0,0,0,0,0,0,1,0,0,1,1
3134,80333,3BztBUlI63kL9yRcRfPOmeFpKMf9EWqH,SpATywNh6bZuzm8s1ceuBUnMUAeoAHHw,13,24,5,16,3,0,1,0,49,7.0,1,0.0,15,5,13,3,9,0,3,1,0,36,13,1
3135,80339,XT1waMohYamMih4d0cft0xqoQTrmFfop,SpATywNh6bZuzm8s1ceuBUnMUAeoAHHw,5,2,1,0,1,0,4,0,8,1.1428571428571428,1,0.0,0,1,0,1,2,0,0,4,0,2,6,1
3136,80344,EFMEoi5W4mceo8rjft5LKrYvvT3E2eat,A3fsA9Zfv1X2fVEQhTw51lKENdNrEqT3,2,0,0,0,0,0,2,0,2,0.2857142857142857,1,0.0,0,0,0,0,0,0,0,2,0,0,2,1
3137,80347,XEEROzXFwjY4oyjlmSc2mETyORRAjvE9,RXDvfPUBYFlVdlueBFbLW0mhhAyGEqpt,1,0,0,0,0,0,1,0,1,0.14285714285714285,1,0.0,0,0,0,0,0,0,0,1,0,0,1,1
3138,80348,9D8Fr85Y0xJSTSvXENunTRQkQQzpKKhe,bWdj2GDclj5ofokWjzoa5jAwMkxCykd6,2,0,0,0,0,0,4,0,4,0.5714285714285714,1,0.0,0,0,0,0,0,0,0,4,0,0,4,1
3139,80349,d7Yl1K2nrAPh1Q4Gl4OFPqaLmDsQKnZb,SpATywNh6bZuzm8s1ceuBUnMUAeoAHHw,11,10,1,3,0,0,2,0,16,2.2857142857142856,1,0.0,4,1,3,0,6,0,0,2,0,8,8,1
3140,80360,eShFyPGgCT65uThL7XGiKvmljTNciFAA,G8EPVSXsOYB5YQWZGiz1aVq5Pgr2GrQu,2,0,0,0,0,0,2,0,2,0.2857142857142857,1,0.0,0,0,0,0,0,0,0,2,0,0,2,1
3141,80373,YrgwsEFjLyT5SXSOyIIpFlTBfXK1acSP,bWdj2GDclj5ofokWjzoa5jAwMkxCykd6,15,9,6,22,4,0,3,1,45,6.428571428571429,1,0.0,2,6,17,4,7,0,5,3,1,29,16,0
3142,80396,3B3YADugrZ4bBgjxxClgqtVXSh5LmkAW,SpATywNh6bZuzm8s1ceuBUnMUAeoAHHw,1,0,0,0,0,0,1,0,1,0.14285714285714285,1,0.0,0,0,0,0,0,0,0,1,0,0,1,1
3143,80406,9d6HoNqzGbbCd66bGVck7uPSgkXTez3M,G8EPVSXsOYB5YQWZGiz1aVq5Pgr2GrQu,3,4,1,0,0,0,2,0,7,1.0,2,0.0,0,1,0,0,4,0,0,2,0,1,6,1
3144,80429,3WaaFhQhqNoXoyRVVZyUHNenDiDckaYh,bWdj2GDclj5ofokWjzoa5jAwMkxCykd6,1,0,0,0,0,0,1,0,1,0.14285714285714285,1,0.0,0,0,0,0,0,0,0,1,0,0,1,1
3145,80437,ef12hM7jr4TcIrwraImsdOigb7ZzGQBR,SpATywNh6bZuzm8s1ceuBUnMUAeoAHHw,13,15,1,12,1,2,3,0,34,4.857142857142857,2,0.0,3,1,12,1,12,2,0,3,0,17,17,1
3146,80439,hw4USDUss7xpmyvWKsTyQsT2eAX2LBFT,SpATywNh6bZuzm8s1ceuBUnMUAeoAHHw,1,0,0,0,0,0,1,0,1,0.14285714285714285,1,0.0,0,0,0,0,0,0,0,1,0,0,1,1
3147,80442,d50GHjVwwNPRl6KQMtLsCG0z8s5vd7XF,bWdj2GDclj5ofokWjzoa5jAwMkxCykd6,4,2,0,0,0,0,2,0,4,0.5714285714285714,1,0.0,0,0,0,0,2,0,0,2,0,0,4,1
3148,80452,oIncNl2qqfpjBksI2zhFahnNU9rnYXqO,SpATywNh6bZuzm8s1ceuBUnMUAeoAHHw,8,5,1,0,1,2,6,1,16,2.2857142857142856,2,0.0,0,1,0,1,5,2,0,6,1,2,14,1
3149,80454,SicKtTdinGjYgkh3dK0y8UiEfELy0LiN,bWdj2GDclj5ofokWjzoa5jAwMkxCykd6,3,4,2,0,0,0,2,0,8,1.1428571428571428,1,0.0,0,2,0,0,4,0,0,2,0,2,6,1
3150,80455,zB3DnodqJETqBAtFNKyb5VwXIslDdCgP,RXDvfPUBYFlVdlueBFbLW0mhhAyGEqpt,24,15,14,0,11,0,2,0,42,6.0,1,0.0,0,14,0,11,15,0,0,2,0,25,17,1
3151,80462,6I4onWELkk7bHacbwPRHkBZyFy5av4gK,G8EPVSXsOYB5YQWZGiz1aVq5Pgr2GrQu,1,0,0,0,0,0,1,0,1,0.14285714285714285,1,0.0,0,0,0,0,0,0,0,1,0,0,1,1
3152,80464,KY2OGJhlQwlrWsxzAaVbFxD3T2YixWes,SpATywNh6bZuzm8s1ceuBUnMUAeoAHHw,19,35,0,39,0,0,6,0,80,11.428571428571429,1,0.0,17,0,32,0,18,0,7,6,0,49,31,1
3153,80475,53qrF6M0dMx7kKnOiKvVv5yJevXuY3XD,bWdj2GDclj5ofokWjzoa5jAwMkxCykd6,16,11,5,32,4,2,6,1,61,8.714285714285714,1,0.0,4,5,27,4,7,2,5,6,1,40,21,1
3154,80505,I7kUxTrFR4kUt4IUmZUgm3AQtDQNh7Pu,G8EPVSXsOYB5YQWZGiz1aVq5Pgr2GrQu,8,2,2,0,2,0,4,0,10,1.4285714285714286,1,0.0,0,2,0,2,2,0,0,4,0,4,6,0
3155,80518,vrIS3rOFH8II8t7yTEWKp29B27kjVKhm,RXDvfPUBYFlVdlueBFbLW0mhhAyGEqpt,2,0,0,0,0,0,2,0,2,0.2857142857142857,1,0.0,0,0,0,0,0,0,0,2,0,0,2,1
3156,80537,LPlZQJB3VT531jm1uSCcLkocTrYuWDuM,SpATywNh6bZuzm8s1ceuBUnMUAeoAHHw,5,2,0,0,0,0,3,0,5,0.7142857142857143,1,0.0,0,0,0,0,2,0,0,3,0,0,5,1
3157,80561,0TYsGSagjtpdvts8BjnEYwbdzO0Cq9cu,bWdj2GDclj5ofokWjzoa5jAwMkxCykd6,6,16,7,0,3,0,4,0,30,4.285714285714286,2,0.0,3,7,0,3,13,0,0,4,0,13,17,1
3158,80568,ADKumVbkV9N5Z2ohQ2vgzJz2AGQtvwrg,G8EPVSXsOYB5YQWZGiz1aVq5Pgr2GrQu,2,0,0,0,0,0,2,0,2,0.2857142857142857,1,0.0,0,0,0,0,0,0,0,2,0,0,2,1
3159,80594,7U17eU07Q58xc6IhNX4TREySfrRlxt89,SpATywNh6bZuzm8s1ceuBUnMUAeoAHHw,5,2,1,0,1,0,2,0,6,0.8571428571428571,1,0.0,0,1,0,1,2,0,0,2,0,2,4,1
3160,80598,OLmaTq1VRWq8uhF6WwamKt59rXmIqMgh,bWdj2GDclj5ofokWjzoa5jAwMkxCykd6,1,0,0,0,0,0,1,0,1,0.14285714285714285,1,0.0,0,0,0,0,0,0,0,1,0,0,1,1
3161,80602,gpn05NwMGqKm6lLZGRrnOmPlhHxlC7Wb,bWdj2GDclj5ofokWjzoa5jAwMkxCykd6,1,0,0,0,0,0,1,0,1,0.14285714285714285,1,0.0,0,0,0,0,0,0,0,1,0,0,1,1
3162,80608,ci9OqCUCFmkuIFOKMHsPsoK829Gh2eXP,SpATywNh6bZuzm8s1ceuBUnMUAeoAHHw,6,3,2,0,1,0,2,0,8,1.1428571428571428,1,0.0,0,2,0,1,3,0,0,2,0,3,5,1
3163,80625,OtvBXiuty3fVhm4b8HhX0yrFKjgkxxYs,bWdj2GDclj5ofokWjzoa5jAwMkxCykd6,1,0,0,0,0,0,1,0,1,0.14285714285714285,1,0.0,0,0,0,0,0,0,0,1,0,0,1,1
3164,80632,4CBJi9FPwBtDwABbM6tdSqW9vKh1q7Z5,SpATywNh6bZuzm8s1ceuBUnMUAeoAHHw,12,15,5,21,0,5,10,1,57,8.142857142857142,4,0.0,7,5,18,0,8,5,3,10,1,30,27,1
3165,80634,LoPeI5vpiJIc8eFJHRcQzxkTVUzWtzqj,SpATywNh6bZuzm8s1ceuBUnMUAeoAHHw,4,3,2,0,0,0,1,0,6,0.8571428571428571,1,0.0,0,2,0,0,3,0,0,1,0,2,4,1
3166,80638,s4hqnx8xUoYKrJLqweBa2aNshVWoic6X,SpATywNh6bZuzm8s1ceuBUnMUAeoAHHw,1,0,0,0,0,0,1,0,1,0.14285714285714285,1,0.0,0,0,0,0,0,0,0,1,0,0,1,1
3167,80639,29gH0FAs4oAb41p5WLnz0d22eodFn1iN,bWdj2GDclj5ofokWjzoa5jAwMkxCykd6,7,4,3,0,3,0,2,0,12,1.7142857142857142,1,0.0,0,3,0,3,4,0,0,2,0,6,6,1
3168,80654,NKR2Krh4HHLg8axBFiC363Ms5CaLr3EI,SpATywNh6bZuzm8s1ceuBUnMUAeoAHHw,1,0,0,0,0,0,1,0,1,0.14285714285714285,1,0.0,0,0,0,0,0,0,0,1,0,0,1,1
3169,80660,TMS9M7AUlYgaEtdQAX29SchyEATrODFG,G8EPVSXsOYB5YQWZGiz1aVq5Pgr2GrQu,2,1,1,0,0,0,0,0,2,0.2857142857142857,1,0.0,0,1,0,0,1,0,0,0,0,1,1,1
3170,80666,TaFs8IDIsMzdpxbnD04ku2RkLxSKkkwk,SpATywNh6bZuzm8s1ceuBUnMUAeoAHHw,7,7,1,4,0,0,1,0,13,1.8571428571428572,1,0.0,0,1,3,0,7,0,1,1,0,4,9,1
3171,80681,SyrTnLXKpH34dNmIyW3n9ptk8gbsqg3F,SpATywNh6bZuzm8s1ceuBUnMUAeoAHHw,1,0,0,0,0,0,1,0,1,0.14285714285714285,1,0.0,0,0,0,0,0,0,0,1,0,0,1,1
3172,80707,29gH0FAs4oAb41p5WLnz0d22eodFn1iN,RXDvfPUBYFlVdlueBFbLW0mhhAyGEqpt,5,2,1,0,1,0,3,0,7,1.0,1,0.0,0,1,0,1,2,0,0,3,0,2,5,1
3173,80714,ATgF2ilKXTZ2e87FKuPjMOOGbSWS0Lln,bWdj2GDclj5ofokWjzoa5jAwMkxCykd6,1,0,0,0,0,0,1,0,1,0.14285714285714285,1,0.0,0,0,0,0,0,0,0,1,0,0,1,1
3174,80717,eVZffGeL4uoEevrNNMdcmW6f0YwT8plW,SpATywNh6bZuzm8s1ceuBUnMUAeoAHHw,8,5,4,0,2,0,1,0,12,1.7142857142857142,1,0.0,0,4,0,2,5,0,0,1,0,6,6,1
3175,80728,EZ8RICWKm2CZHfClKFJxNtx1ItORs9so,SpATywNh6bZuzm8s1ceuBUnMUAeoAHHw,3,2,1,0,0,0,1,0,4,0.5714285714285714,1,0.0,0,1,0,0,2,0,0,1,0,1,3,1
3176,80729,nuKEM7FMFD9npzL9DafH3T1pYgMoLJoQ,RXDvfPUBYFlVdlueBFbLW0mhhAyGEqpt,7,9,6,0,5,0,1,0,21,3.0,1,0.0,0,6,0,5,9,0,0,1,0,11,10,0
3177,80735,qOBlKap97zfj4fiqNpXMa6P8l1mqWQt7,SpATywNh6bZuzm8s1ceuBUnMUAeoAHHw,1,0,0,0,0,0,2,0,2,0.2857142857142857,1,0.0,0,0,0,0,0,0,0,2,0,0,2,1
3178,80758,T4bTYOzPYArqtWPF4tmIGoxoB2vrFxrw,SpATywNh6bZuzm8s1ceuBUnMUAeoAHHw,15,14,8,11,2,2,9,0,46,6.571428571428571,3,0.0,2,8,10,2,12,2,1,9,0,22,24,1
3179,80769,OmF4aFe06TkjIpsTgGpQ4vBzMWi2jjQV,RXDvfPUBYFlVdlueBFbLW0mhhAyGEqpt,1,0,0,0,0,0,1,0,1,0.14285714285714285,1,0.0,0,0,0,0,0,0,0,1,0,0,1,1
3180,80779,6qgQAmX6y5wh5nEPRINOiKrZNoTl5yfT,bWdj2GDclj5ofokWjzoa5jAwMkxCykd6,8,6,4,0,1,7,8,0,26,3.7142857142857144,2,0.0,0,4,0,1,6,7,0,8,0,5,21,1
3181,80780,Nn60hlJlXHP7n7M6lOuhaSQUkd1WY1lX,A3fsA9Zfv1X2fVEQhTw51lKENdNrEqT3,1,0,0,0,0,0,1,0,1,0.14285714285714285,1,0.0,0,0,0,0,0,0,0,1,0,0,1,1
3182,80798,B0jVKFlvXfKwVR9pXnhJZcf2VbxqeEJP,SpATywNh6bZuzm8s1ceuBUnMUAeoAHHw,13,16,10,4,3,0,1,0,34,4.857142857142857,1,0.0,4,10,4,3,12,0,0,1,0,21,13,1
3183,80799,cJ9a9VybEQZXRFqEMI78WQ8ukmEaaVlE,SpATywNh6bZuzm8s1ceuBUnMUAeoAHHw,17,13,8,14,4,0,1,0,40,5.714285714285714,2,0.0,2,8,13,4,11,0,1,1,0,27,13,0
3184,80810,XGZlC1RvsVEr4DyOUAX5cTpjhf6EgwX5,G8EPVSXsOYB5YQWZGiz1aVq5Pgr2GrQu,1,0,0,0,0,0,1,0,1,0.14285714285714285,1,0.0,0,0,0,0,0,0,0,1,0,0,1,1
3185,80825,IH2c5uYafZAMnz8GRu5q3bfkjqRBG0d4,bWdj2GDclj5ofokWjzoa5jAwMkxCykd6,1,0,0,0,0,0,1,0,1,0.14285714285714285,1,0.0,0,0,0,0,0,0,0,1,0,0,1,1
3186,80832,GMSc5TEkkpgIO0gc1xREEszljcEWZiiA,SpATywNh6bZuzm8s1ceuBUnMUAeoAHHw,32,43,25,30,12,16,19,3,148,21.142857142857142,2,0.0,13,25,24,12,30,16,6,19,3,74,74,1
3187,80835,GMSc5TEkkpgIO0gc1xREEszljcEWZiiA,bWdj2GDclj5ofokWjzoa5jAwMkxCykd6,5,2,1,0,1,0,2,0,6,0.8571428571428571,1,0.0,0,1,0,1,2,0,0,2,0,2,4,1
3188,80849,2mD1u3b1vLrSJM0DZTrsvLcZVBVwwd27,A3fsA9Zfv1X2fVEQhTw51lKENdNrEqT3,3,0,0,0,0,0,4,0,4,0.5714285714285714,1,0.0,0,0,0,0,0,0,0,4,0,0,4,1
3189,80851,okZrRzk81VekqLN26qutXWOBN8y8aCor,SpATywNh6bZuzm8s1ceuBUnMUAeoAHHw,7,3,1,0,1,0,3,0,8,1.1428571428571428,1,0.0,0,1,0,1,3,0,0,3,0,2,6,1
3190,80859,diZ65EjFunlRsT8e2068pcUuzCl79D1p,G8EPVSXsOYB5YQWZGiz1aVq5Pgr2GrQu,4,2,0,0,0,0,2,0,4,0.5714285714285714,1,0.0,0,0,0,0,2,0,0,2,0,0,4,1
3191,80881,whV1nFYZoFkMMEitqUr4NmhBR8HyCOwO,fbPkOYLVPtPgIt0MxizjfFJov3JbHyAi,1,0,0,0,0,0,1,0,1,0.14285714285714285,1,0.0,0,0,0,0,0,0,0,1,0,0,1,1
3192,80889,K8SEVoLEOyaxiId31CfQ3tViDlX904mj,fbPkOYLVPtPgIt0MxizjfFJov3JbHyAi,5,4,2,0,1,0,1,0,8,1.1428571428571428,1,0.0,0,2,0,1,4,0,0,1,0,3,5,1
3193,82292,vCT5TWno1npWLslO7yYTAIaOZBV06mao,fbPkOYLVPtPgIt0MxizjfFJov3JbHyAi,3,2,0,0,0,0,1,0,3,0.42857142857142855,1,0.0,0,0,0,0,2,0,0,1,0,0,3,1
3194,82294,mPSu9wD4am4oNde1aNJ4Hx4pSuKdoZ9s,fbPkOYLVPtPgIt0MxizjfFJov3JbHyAi,1,0,0,0,0,0,1,0,1,0.14285714285714285,1,0.0,0,0,0,0,0,0,0,1,0,0,1,1
3195,82295,2vTiDJaUXObkB4MCSVV6b36fCzIFNmlO,fbPkOYLVPtPgIt0MxizjfFJov3JbHyAi,1,0,0,0,0,0,1,0,1,0.14285714285714285,1,0.0,0,0,0,0,0,0,0,1,0,0,1,1
3196,82297,mucqYKQHr68fZN1W1bDFGJobVl8lTzGk,fbPkOYLVPtPgIt0MxizjfFJov3JbHyAi,5,2,1,0,1,0,4,0,8,1.1428571428571428,1,0.0,0,1,0,1,2,0,0,4,0,2,6,1
3197,82299,qGj2UPAGCVKaEMFWyN0RHLn8amW4mHcs,fbPkOYLVPtPgIt0MxizjfFJov3JbHyAi,2,0,0,0,0,0,2,0,2,0.2857142857142857,1,0.0,0,0,0,0,0,0,0,2,0,0,2,1
3198,82301,qDO5LP5T3lr3EoF63npeMJOU1F5CHwlT,fbPkOYLVPtPgIt0MxizjfFJov3JbHyAi,1,0,0,0,0,0,1,0,1,0.14285714285714285,1,0.0,0,0,0,0,0,0,0,1,0,0,1,1
3199,82302,LJ7sgKzaMtvAPFXeVXXiaB5SrStNVwGH,fbPkOYLVPtPgIt0MxizjfFJov3JbHyAi,2,0,0,0,0,0,2,0,2,0.2857142857142857,1,0.0,0,0,0,0,0,0,0,2,0,0,2,1
3200,82303,7cOxNQ9QY0kpQ3XCTHRP00ygFCzb9CpO,fbPkOYLVPtPgIt0MxizjfFJov3JbHyAi,3,1,1,0,1,0,0,0,3,0.42857142857142855,1,0.0,0,1,0,1,1,0,0,0,0,2,1,1
3201,82304,zrkzLXbSKLZ5TMR3XqCd3VcTJUh1RbFU,fbPkOYLVPtPgIt0MxizjfFJov3JbHyAi,7,3,2,0,2,0,2,0,9,1.2857142857142858,1,0.0,0,2,0,2,3,0,0,2,0,4,5,1
3202,82305,5D84XSx425N7nheLe6kqFUzsI4xGTRr7,fbPkOYLVPtPgIt0MxizjfFJov3JbHyAi,15,23,7,8,10,4,7,1,60,8.571428571428571,1,0.0,13,7,6,10,10,4,2,7,1,36,24,1
3203,82307,i6tlOFL86lQi7en8qXwdqAGtc3xj3T2v,fbPkOYLVPtPgIt0MxizjfFJov3JbHyAi,1,0,0,0,0,0,1,0,1,0.14285714285714285,1,0.0,0,0,0,0,0,0,0,1,0,0,1,1
3204,82308,dMfbUZDFyVyywHwJG3Dt4QrakRtLnsTX,fbPkOYLVPtPgIt0MxizjfFJov3JbHyAi,7,3,2,0,2,0,2,0,9,1.2857142857142858,1,0.0,0,2,0,2,3,0,0,2,0,4,5,1
3205,82309,R2bsNKaCyFNpEJtfIBR7wHhqazhTieVv,fbPkOYLVPtPgIt0MxizjfFJov3JbHyAi,5,3,2,0,1,0,1,0,7,1.0,1,0.0,0,2,0,1,3,0,0,1,0,3,4,1
3206,82310,2Hh0hyPi2bcd1tRNePJ2qIF1dysf5ndk,fbPkOYLVPtPgIt0MxizjfFJov3JbHyAi,6,2,1,0,1,0,6,0,10,1.4285714285714286,1,0.0,1,1,0,1,1,0,0,6,0,3,7,1
3207,82311,Ll3IzS1S6bZksUUlpyvq7rkVFnPwdP4J,fbPkOYLVPtPgIt0MxizjfFJov3JbHyAi,7,3,2,0,2,0,4,0,11,1.5714285714285714,1,0.0,0,2,0,2,3,0,0,4,0,4,7,1
3208,82312,Ocs5vn2Cz5hAUdTB4aWABUkRHND3d6Kt,fbPkOYLVPtPgIt0MxizjfFJov3JbHyAi,6,6,3,0,2,0,4,0,15,2.142857142857143,2,0.0,0,3,0,2,6,0,0,4,0,5,10,1
3209,82313,x2Dh8FpB4LfDSl1DvzXzmScd6yLeEPWy,fbPkOYLVPtPgIt0MxizjfFJov3JbHyAi,4,0,0,0,0,0,5,0,5,0.7142857142857143,1,0.0,0,0,0,0,0,0,0,5,0,0,5,1
3210,82314,XIDZAAoEp5yiaJ1NSNfTaFGT6RLKKbeY,fbPkOYLVPtPgIt0MxizjfFJov3JbHyAi,1,0,0,0,0,0,1,0,1,0.14285714285714285,1,0.0,0,0,0,0,0,0,0,1,0,0,1,1
3211,82315,t2E5rQgbhesaMxxpyksf3DgIq81BWWBg,fbPkOYLVPtPgIt0MxizjfFJov3JbHyAi,5,4,2,0,1,0,2,0,9,1.2857142857142858,1,0.0,0,2,0,1,4,0,0,2,0,3,6,1
3212,82337,0XFCa4HLY6qqhFLkbyOG8QvQlbZdVLQp,7GRhBDsirIGkRZBtSMEzNTyDr2JQm4xx,3,0,0,0,0,0,3,0,3,0.42857142857142855,1,0.0,0,0,0,0,0,0,0,3,0,0,3,1
3213,82347,HMYpimZGFgj5IczDutkfjUfnxl45PoHW,7GRhBDsirIGkRZBtSMEzNTyDr2JQm4xx,1,0,0,0,0,0,4,0,4,0.5714285714285714,2,0.0,0,0,0,0,0,0,0,4,0,0,4,1
3214,82354,4Kx1Tk1FEFaPAhJJ1qabZH7R2QRjZNC4,7GRhBDsirIGkRZBtSMEzNTyDr2JQm4xx,11,8,4,2,3,1,2,0,20,2.857142857142857,1,0.0,2,4,1,3,6,1,1,2,0,10,10,1
3215,82357,1v1hnAW2fjxDgMlfMAcBqTKOh6UMFrVl,7GRhBDsirIGkRZBtSMEzNTyDr2JQm4xx,29,31,15,2,15,0,12,0,75,10.714285714285714,2,0.0,12,15,1,15,19,0,1,12,0,43,32,1
3216,82369,1EoPeAPt0rQExpDMUB0Oh9LRcg1yhFWa,7GRhBDsirIGkRZBtSMEzNTyDr2JQm4xx,1,0,0,0,0,0,1,0,1,0.14285714285714285,1,0.0,0,0,0,0,0,0,0,1,0,0,1,1
3217,82391,r6vCAWlYIzTyZ2tN64AHwtfHr1599fdG,7GRhBDsirIGkRZBtSMEzNTyDr2JQm4xx,33,104,4,79,6,2,31,1,227,32.42857142857143,4,0.0,70,4,66,6,34,2,13,31,1,146,81,0
3218,82419,kkrf4aiGvXPFoVcEvoantT9MIbaoN3ev,7GRhBDsirIGkRZBtSMEzNTyDr2JQm4xx,2,0,0,0,0,0,2,0,2,0.2857142857142857,1,0.0,0,0,0,0,0,0,0,2,0,0,2,1
3219,82425,AYyigeqx54KlykjSn8XXM8xIAmNPwwgy,7GRhBDsirIGkRZBtSMEzNTyDr2JQm4xx,1,0,0,0,0,0,1,0,1,0.14285714285714285,1,0.0,0,0,0,0,0,0,0,1,0,0,1,1
3220,82439,nsVUUOs0l2kNCEJWP7CuzEzLUL7HHA2o,7GRhBDsirIGkRZBtSMEzNTyDr2JQm4xx,1,0,0,0,0,0,1,0,1,0.14285714285714285,1,0.0,0,0,0,0,0,0,0,1,0,0,1,1
3221,82443,506JH480T3Hay89W7G1dTs4qRT8mnHIv,7GRhBDsirIGkRZBtSMEzNTyDr2JQm4xx,4,3,1,0,0,0,2,0,6,0.8571428571428571,1,0.0,0,1,0,0,3,0,0,2,0,1,5,1
3222,82444,0OsY8LWQHJyrf2iZ6AGYuDrpmW3bfvqO,7GRhBDsirIGkRZBtSMEzNTyDr2JQm4xx,23,29,14,14,8,0,5,0,70,10.0,1,0.0,11,14,8,8,18,0,6,5,0,41,29,1
3223,82445,BA6kCSqOZYgPcpy87C2hTl09S7lpFd09,7GRhBDsirIGkRZBtSMEzNTyDr2JQm4xx,8,8,2,6,3,2,2,0,23,3.2857142857142856,1,0.0,2,2,5,3,6,2,1,2,0,12,11,0
3224,82479,iVw6PFrlJCMW2i4yQDVBv0p8rh0bg8oB,7GRhBDsirIGkRZBtSMEzNTyDr2JQm4xx,10,10,3,0,1,9,15,0,38,5.428571428571429,2,0.0,2,3,0,1,8,9,0,15,0,6,32,1
3225,82501,C90t4OTJKLckQlEHPGqMg6X9e1cv22jh,7GRhBDsirIGkRZBtSMEzNTyDr2JQm4xx,5,2,1,0,1,0,3,0,7,1.0,1,0.0,0,1,0,1,2,0,0,3,0,2,5,1
3226,82516,akfKNyiclQIBJSqS87A1d10ODSvejPEf,7GRhBDsirIGkRZBtSMEzNTyDr2JQm4xx,4,2,0,0,0,0,2,0,4,0.5714285714285714,1,0.0,0,0,0,0,2,0,0,2,0,0,4,1
3227,82545,mnt6WUJv4Nm9SlBAqM8Wy80LtV0oy5xh,7GRhBDsirIGkRZBtSMEzNTyDr2JQm4xx,1,0,0,0,0,0,1,0,1,0.14285714285714285,1,0.0,0,0,0,0,0,0,0,1,0,0,1,1
3228,82548,2DJrQZ1DQwZ17FIT9rErCdsuhNRIOxUc,7GRhBDsirIGkRZBtSMEzNTyDr2JQm4xx,1,0,0,0,0,0,1,0,1,0.14285714285714285,1,0.0,0,0,0,0,0,0,0,1,0,0,1,1
3229,82551,UJiJ4PvH4qodyDnURbFXyi5LWwaSKUwb,7GRhBDsirIGkRZBtSMEzNTyDr2JQm4xx,11,11,6,8,5,0,2,0,32,4.571428571428571,1,0.0,2,6,6,5,9,0,2,2,0,19,13,1
3230,82552,z6hFsPzsbEnFbaZ8fz961gcLxQ5khAMh,7GRhBDsirIGkRZBtSMEzNTyDr2JQm4xx,1,0,0,0,0,0,1,0,1,0.14285714285714285,1,0.0,0,0,0,0,0,0,0,1,0,0,1,1
3231,82581,aq4CF7Ase1niDETNNnN3SPNstQIkMzIb,7GRhBDsirIGkRZBtSMEzNTyDr2JQm4xx,1,0,0,0,0,0,1,0,1,0.14285714285714285,1,0.0,0,0,0,0,0,0,0,1,0,0,1,1
3232,82587,4BgAKbYEi6Ae1ZfaDy8dVhzCZKLQsM2C,7GRhBDsirIGkRZBtSMEzNTyDr2JQm4xx,2,0,0,0,0,0,2,0,2,0.2857142857142857,1,0.0,0,0,0,0,0,0,0,2,0,0,2,1
3233,82609,8t2I7RZ6tGpzDNhY5KSmkbKJTicFPhFD,SpATywNh6bZuzm8s1ceuBUnMUAeoAHHw,26,36,18,32,6,0,15,0,107,15.285714285714286,3,0.0,13,18,29,6,23,0,3,15,0,66,41,0
3234,82611,7xsMLAoX5cfA1ELNnW1Jyq3921JNch8p,bWdj2GDclj5ofokWjzoa5jAwMkxCykd6,7,5,2,0,1,0,9,0,17,2.4285714285714284,1,0.0,0,2,0,1,5,0,0,9,0,3,14,1
3235,82619,HBNOGDmQrCA8ZCNHwMOm4mGR9448iscJ,A3fsA9Zfv1X2fVEQhTw51lKENdNrEqT3,9,3,2,0,2,0,8,1,16,2.2857142857142856,2,0.0,0,2,0,2,3,0,0,8,1,4,12,0
3236,82626,1LsKSfuKnKljzcVBDuX88jdA4iNAFPmK,SpATywNh6bZuzm8s1ceuBUnMUAeoAHHw,8,35,17,0,13,0,9,0,74,10.571428571428571,1,0.0,2,17,0,13,33,0,0,9,0,32,42,0
3237,82633,xLA7fhjHBFsq0q4kxpkXfUkRljEs0TAd,SpATywNh6bZuzm8s1ceuBUnMUAeoAHHw,7,7,5,0,0,0,4,0,16,2.2857142857142856,1,0.0,0,5,0,0,7,0,0,4,0,5,11,0
3238,82635,xLA7fhjHBFsq0q4kxpkXfUkRljEs0TAd,bWdj2GDclj5ofokWjzoa5jAwMkxCykd6,17,21,14,28,1,7,8,0,79,11.285714285714286,1,0.0,1,14,27,1,20,7,1,8,0,43,36,0
3239,82641,TqooiK8GaIskZ1TWtOHUh45RuTpvOkj9,SpATywNh6bZuzm8s1ceuBUnMUAeoAHHw,7,6,4,0,3,0,3,0,16,2.2857142857142856,1,0.0,0,4,0,3,6,0,0,3,0,7,9,0
3240,82642,7IO6p4687fQRowFKh8aP2BRrTBz96sXF,G8EPVSXsOYB5YQWZGiz1aVq5Pgr2GrQu,5,3,2,0,1,0,1,0,7,1.0,2,0.0,0,2,0,1,3,0,0,1,0,3,4,0
3241,82661,pSfJ0uMpX5mtiDADVfED9j2PrehMi4qf,SpATywNh6bZuzm8s1ceuBUnMUAeoAHHw,11,14,5,0,4,0,2,0,25,3.5714285714285716,1,0.0,8,5,0,4,6,0,0,2,0,17,8,1
3242,82682,pSfJ0uMpX5mtiDADVfED9j2PrehMi4qf,bWdj2GDclj5ofokWjzoa5jAwMkxCykd6,7,4,2,0,2,0,2,0,10,1.4285714285714286,1,0.0,1,2,0,2,3,0,0,2,0,5,5,1
3243,82686,r2H5XCYvW75clbYorkxbeTJTDpcuYsqR,A3fsA9Zfv1X2fVEQhTw51lKENdNrEqT3,1,0,0,0,0,0,1,0,1,0.14285714285714285,1,0.0,0,0,0,0,0,0,0,1,0,0,1,1
3244,82713,Qej7uJiPxPofj5VkSw5arNMXnDFwdHaU,bWdj2GDclj5ofokWjzoa5jAwMkxCykd6,1,0,0,0,0,0,1,0,1,0.14285714285714285,1,0.0,0,0,0,0,0,0,0,1,0,0,1,1
3245,82714,dmKq4wezB2pymsF6jHa3iwdFnCP4NIvi,SpATywNh6bZuzm8s1ceuBUnMUAeoAHHw,4,2,0,0,0,0,2,0,4,0.5714285714285714,1,0.0,0,0,0,0,2,0,0,2,0,0,4,1
3246,82722,i0k5iK0fS6RmfXLKfz70zhtGt8sKmdev,G8EPVSXsOYB5YQWZGiz1aVq5Pgr2GrQu,8,13,3,0,0,0,1,0,17,2.4285714285714284,1,0.0,0,3,0,0,13,0,0,1,0,3,14,1
3247,82751,8kDMxN2jxnl0uIdlggQjT6QmHT7F6WvQ,A3fsA9Zfv1X2fVEQhTw51lKENdNrEqT3,4,2,0,0,0,0,3,0,5,0.7142857142857143,3,0.0,0,0,0,0,2,0,0,3,0,0,5,0
3248,82772,ydoaEAxmO4gHSSp9D7mNNRYfsM5IVoFl,SpATywNh6bZuzm8s1ceuBUnMUAeoAHHw,6,0,0,0,0,1,5,1,7,1.0,1,0.0,0,0,0,0,0,1,0,5,1,0,7,1
3249,82820,PCDzowxElNLixXyfAFPkQqlbkMlIrEa9,SpATywNh6bZuzm8s1ceuBUnMUAeoAHHw,1,0,0,0,0,0,1,0,1,0.14285714285714285,1,0.0,0,0,0,0,0,0,0,1,0,0,1,1
3250,82832,bNG7kJA3jy4DW8PDzMNAT9OoyHwhutqS,bWdj2GDclj5ofokWjzoa5jAwMkxCykd6,28,59,0,128,4,0,14,1,206,29.428571428571427,2,0.0,14,0,119,4,45,0,9,14,1,137,69,1
3251,82834,rXk8o13Kpmo1kUY0hqp1VAqDdB7oaIVw,SpATywNh6bZuzm8s1ceuBUnMUAeoAHHw,1,0,0,0,0,0,1,0,1,0.14285714285714285,1,0.0,0,0,0,0,0,0,0,1,0,0,1,1
3252,82840,Jee7EGsn5XYP5oawysLFsO8VcnPFjYWM,SpATywNh6bZuzm8s1ceuBUnMUAeoAHHw,5,3,2,0,1,0,1,0,7,1.0,1,0.0,0,2,0,1,3,0,0,1,0,3,4,1
3253,82856,2Pkptevs7J69rsFmJqSHjNMBnKCLyXs7,SpATywNh6bZuzm8s1ceuBUnMUAeoAHHw,11,16,13,0,5,0,6,0,40,5.714285714285714,1,0.0,0,13,0,5,16,0,0,6,0,18,22,1
3254,82860,MWgepnFrbhIoMtzaoOzOjEjpjYI14nzb,bWdj2GDclj5ofokWjzoa5jAwMkxCykd6,5,3,0,0,0,0,4,0,7,1.0,1,0.0,0,0,0,0,3,0,0,4,0,0,7,1
3255,82865,UVY9zxbBVUyhzTA4AJhTZxTOHFZ2duQd,SpATywNh6bZuzm8s1ceuBUnMUAeoAHHw,20,26,3,16,0,2,5,0,52,7.428571428571429,1,0.0,5,3,14,0,21,2,2,5,0,22,30,1
3256,82875,LSxdutAKHjruUktaLYDzR4TTFH4npHSj,SpATywNh6bZuzm8s1ceuBUnMUAeoAHHw,15,27,12,14,6,0,6,0,65,9.285714285714286,2,0.0,10,12,13,6,17,0,1,6,0,41,24,1
3257,82911,g1LVeBlQiVCOcKiTDDTy4PafQkGd4pbr,A3fsA9Zfv1X2fVEQhTw51lKENdNrEqT3,55,18,12,144,8,0,4,1,187,26.714285714285715,1,0.0,3,12,125,8,15,0,19,4,1,148,39,0
3258,82912,dSKLyWRwDNYp6bnGVfES0oxRsg4F2fbZ,SpATywNh6bZuzm8s1ceuBUnMUAeoAHHw,12,18,0,16,1,0,1,0,36,5.142857142857143,1,0.0,6,0,13,1,12,0,3,1,0,20,16,1
3259,82914,cJcuhtji0eqLhfXtnFSDlw6v5huTlvOS,A3fsA9Zfv1X2fVEQhTw51lKENdNrEqT3,4,2,1,0,1,0,1,0,5,0.7142857142857143,1,0.0,0,1,0,1,2,0,0,1,0,2,3,1
3260,82928,xJa5HsLvA8jsaOm3YgI5AyYKc4qtiOFH,SpATywNh6bZuzm8s1ceuBUnMUAeoAHHw,5,4,1,0,1,0,2,0,8,1.1428571428571428,2,0.0,0,1,0,1,4,0,0,2,0,2,6,1
3261,82934,Vrjrap5JcUBcGnZI9GyoeJ8llD9p1BxJ,SpATywNh6bZuzm8s1ceuBUnMUAeoAHHw,9,5,4,0,4,0,4,0,17,2.4285714285714284,1,0.0,0,4,0,4,5,0,0,4,0,8,9,1
3262,82964,jMzDAkDrCqzTj207GrZXDfLQXbYc8WXP,A3fsA9Zfv1X2fVEQhTw51lKENdNrEqT3,4,0,0,0,0,0,4,0,4,0.5714285714285714,1,0.0,0,0,0,0,0,0,0,4,0,0,4,1
3263,82965,jMzDAkDrCqzTj207GrZXDfLQXbYc8WXP,bWdj2GDclj5ofokWjzoa5jAwMkxCykd6,9,11,5,0,2,0,7,0,25,3.5714285714285716,1,0.0,0,5,0,2,11,0,0,7,0,7,18,0
3264,82968,k3mZz4gOE5kxngWJdlg5ZkSuFCPjQxmM,A3fsA9Zfv1X2fVEQhTw51lKENdNrEqT3,17,13,10,0,9,0,2,0,34,4.857142857142857,1,0.0,0,10,0,9,13,0,0,2,0,19,15,1
3265,82994,pzQmB4p3u9FrEJSWAX6BNOWRPavo1Lrn,A3fsA9Zfv1X2fVEQhTw51lKENdNrEqT3,1,0,0,0,0,0,1,0,1,0.14285714285714285,1,0.0,0,0,0,0,0,0,0,1,0,0,1,1
3266,83039,2T4Z0Imx9CFpIzAb5WFSfhS9FT4FpZWV,SpATywNh6bZuzm8s1ceuBUnMUAeoAHHw,6,4,3,0,2,0,1,0,10,1.4285714285714286,1,0.0,0,3,0,2,4,0,0,1,0,5,5,1
3267,83046,c9uDpmjbhEZRV8vNkDH73VXR3MBTMWZN,SpATywNh6bZuzm8s1ceuBUnMUAeoAHHw,3,3,0,0,0,0,1,0,4,0.5714285714285714,1,0.0,0,0,0,0,3,0,0,1,0,0,4,1
3268,83062,srfjFpufe5zNlnc0Z3dNMD37ukToEJo1,bWdj2GDclj5ofokWjzoa5jAwMkxCykd6,5,2,1,0,1,0,2,0,6,0.8571428571428571,1,0.0,0,1,0,1,2,0,0,2,0,2,4,1
3269,83077,U58EahcrdrWDxUCYXDIka19POAAfjp1t,SpATywNh6bZuzm8s1ceuBUnMUAeoAHHw,1,0,0,0,0,0,1,0,1,0.14285714285714285,1,0.0,0,0,0,0,0,0,0,1,0,0,1,1
3270,83082,OIznJTzf0VYpJo8slc0B4fnJO5XA07gY,SpATywNh6bZuzm8s1ceuBUnMUAeoAHHw,3,0,0,0,0,0,3,0,3,0.42857142857142855,1,0.0,0,0,0,0,0,0,0,3,0,0,3,1
3271,83123,ZNcLOAJ2r3H5DqhbGk1CiPtwI7ixaCeK,bWdj2GDclj5ofokWjzoa5jAwMkxCykd6,30,18,13,36,9,3,2,0,81,11.571428571428571,1,0.0,2,13,35,9,16,3,1,2,0,59,22,0
3272,83126,Lcn36O95deZy87mO20P7rqE00Sa7JkLZ,SpATywNh6bZuzm8s1ceuBUnMUAeoAHHw,3,2,1,0,0,0,1,0,4,0.5714285714285714,1,0.0,0,1,0,0,2,0,0,1,0,1,3,1
3273,83139,vwYpmLrcF8bt1idVso7bAZqs27Gfb44w,SpATywNh6bZuzm8s1ceuBUnMUAeoAHHw,1,0,0,0,0,0,2,0,2,0.2857142857142857,2,0.0,0,0,0,0,0,0,0,2,0,0,2,1
3274,83152,eDH23vVDxXZaCChKrwOZtbVMeyImNCFQ,SpATywNh6bZuzm8s1ceuBUnMUAeoAHHw,22,21,10,20,6,0,1,0,58,8.285714285714286,1,0.0,4,10,18,6,17,0,2,1,0,38,20,1
3275,83161,pAklb1PvY7ruK0UegPVyIZm4Osf6iC9m,bWdj2GDclj5ofokWjzoa5jAwMkxCykd6,1,0,0,0,0,0,1,0,1,0.14285714285714285,1,0.0,0,0,0,0,0,0,0,1,0,0,1,1
3276,83169,8xLHRJYQMKIoYFTLtqTA4nbHlXLKnGUi,SpATywNh6bZuzm8s1ceuBUnMUAeoAHHw,1,0,0,0,0,0,1,0,1,0.14285714285714285,1,0.0,0,0,0,0,0,0,0,1,0,0,1,0
3277,83173,TxlSnMAR26IaOfJh6C0k9qQhw2BgogEc,A3fsA9Zfv1X2fVEQhTw51lKENdNrEqT3,25,26,10,0,10,0,16,0,62,8.857142857142858,2,0.0,0,10,0,10,26,0,0,16,0,20,42,1
3278,83179,x0laSvoDXG0a7WULReVXZ8zh05t91jGU,bWdj2GDclj5ofokWjzoa5jAwMkxCykd6,9,25,6,0,0,0,2,0,33,4.714285714285714,1,0.0,0,6,0,0,25,0,0,2,0,6,27,1
3279,83203,cpPSwRiyzrnBZYcFR4yyg60XVFgQxQi4,A3fsA9Zfv1X2fVEQhTw51lKENdNrEqT3,2,0,0,0,0,0,2,0,2,0.2857142857142857,1,0.0,0,0,0,0,0,0,0,2,0,0,2,1
3280,83225,PQOxOuUmyRHKBoJFPoN8Q817ShM1EBnU,SpATywNh6bZuzm8s1ceuBUnMUAeoAHHw,18,25,8,3,6,0,5,0,47,6.714285714285714,2,0.0,14,8,3,6,11,0,0,5,0,31,16,1
3281,83229,x0laSvoDXG0a7WULReVXZ8zh05t91jGU,SpATywNh6bZuzm8s1ceuBUnMUAeoAHHw,10,29,7,0,0,0,2,0,38,5.428571428571429,1,0.0,0,7,0,0,29,0,0,2,0,7,31,1
3282,83231,d7WW3KTRknYcXaBZVYoIbNodkFYiI6Ik,A3fsA9Zfv1X2fVEQhTw51lKENdNrEqT3,18,18,8,0,6,2,8,1,43,6.142857142857143,2,0.0,0,8,0,6,18,2,0,8,1,14,29,1
3283,83237,EzJ8kmSst3q4WJG0Np16XBDvh9hFUAyd,SpATywNh6bZuzm8s1ceuBUnMUAeoAHHw,7,6,1,4,0,0,1,0,12,1.7142857142857142,2,0.0,0,1,4,0,6,0,0,1,0,5,7,0
3284,83259,kGjYv3fIEEVtPJnIV3ey8jABNxw0G9DP,A3fsA9Zfv1X2fVEQhTw51lKENdNrEqT3,8,6,3,0,1,0,5,0,15,2.142857142857143,1,0.0,0,3,0,1,6,0,0,5,0,4,11,1
3285,83271,8rZiJk9Qyng7Kz2M0sWaeZmr6L3VBmoQ,A3fsA9Zfv1X2fVEQhTw51lKENdNrEqT3,1,0,0,0,0,0,1,0,1,0.14285714285714285,1,0.0,0,0,0,0,0,0,0,1,0,0,1,1
3286,83274,nronI72HtraF0IcAJUYxB4sbj9I4wtB0,bWdj2GDclj5ofokWjzoa5jAwMkxCykd6,27,48,25,134,12,0,8,0,227,32.42857142857143,2,0.0,8,25,125,12,40,0,9,8,0,170,57,1
3287,83294,drMAzq4nC1GseQmyuPqctPxioPnjLJpD,bWdj2GDclj5ofokWjzoa5jAwMkxCykd6,7,4,1,2,2,0,3,1,13,1.8571428571428572,1,0.0,2,1,2,2,2,0,0,3,1,7,6,1
3288,83296,WlpCtlv6l7VubBVcQacaEfXgsH5IUowW,bWdj2GDclj5ofokWjzoa5jAwMkxCykd6,2,0,0,0,0,0,2,0,2,0.2857142857142857,1,0.0,0,0,0,0,0,0,0,2,0,0,2,1
3289,83305,4NR9J7NrWx9P8bFiOFbZEGtYIezzdGum,SpATywNh6bZuzm8s1ceuBUnMUAeoAHHw,3,2,1,0,0,0,2,0,5,0.7142857142857143,1,0.0,0,1,0,0,2,0,0,2,0,1,4,1
3290,83313,6cy8BWaUGaMCAOjojQczbStvsRKYISdK,SpATywNh6bZuzm8s1ceuBUnMUAeoAHHw,10,12,6,0,0,0,5,0,23,3.2857142857142856,1,0.0,0,6,0,0,12,0,0,5,0,6,17,0
3291,83314,n49l3ufDNhve5wMzUe1UGnoLeZWomGLA,SpATywNh6bZuzm8s1ceuBUnMUAeoAHHw,6,4,2,0,1,0,1,0,8,1.1428571428571428,1,0.0,0,2,0,1,4,0,0,1,0,3,5,1
3292,83320,7uDVcwukNss0paMtTOJXNPZUXWP9vYuG,SpATywNh6bZuzm8s1ceuBUnMUAeoAHHw,5,5,0,0,0,0,1,0,6,0.8571428571428571,1,0.0,0,0,0,0,5,0,0,1,0,0,6,1
3293,83351,9HqwJ8d4m6K7QOSGhF3dVzXYAYpOl0vj,SpATywNh6bZuzm8s1ceuBUnMUAeoAHHw,4,2,1,0,1,0,1,0,5,0.7142857142857143,1,0.0,0,1,0,1,2,0,0,1,0,2,3,1
3294,83362,UROHliIogkXuXAccUzTqFupOwNjOEbXL,SpATywNh6bZuzm8s1ceuBUnMUAeoAHHw,7,7,1,0,1,0,4,0,13,1.8571428571428572,1,0.0,0,1,0,1,7,0,0,4,0,2,11,1
3295,83387,6rAXQgJka1nTTwbebP8kTYZLBZ3H51fb,A3fsA9Zfv1X2fVEQhTw51lKENdNrEqT3,6,3,1,0,1,0,2,0,7,1.0,1,0.0,0,1,0,1,3,0,0,2,0,2,5,1
3296,83403,e7qNFJlKhMPlLeAG8swrUc3pRnnUCD82,SpATywNh6bZuzm8s1ceuBUnMUAeoAHHw,1,0,0,0,0,0,1,0,1,0.14285714285714285,1,0.0,0,0,0,0,0,0,0,1,0,0,1,0
3297,83407,DmtYVZArE2EvS9aiKUqKSMgZGIBgO1QS,RXDvfPUBYFlVdlueBFbLW0mhhAyGEqpt,12,7,5,21,3,0,2,0,38,5.428571428571429,1,0.0,1,5,17,3,6,0,4,2,0,26,12,1
3298,83412,AImx2eHFGaeqTe0d3fwuX86fffC0rd9k,SpATywNh6bZuzm8s1ceuBUnMUAeoAHHw,6,5,2,2,1,0,1,0,11,1.5714285714285714,1,0.0,2,2,2,1,3,0,0,1,0,7,4,1
3299,83436,Pp6wRQkPti9Bk2fBcpI0VrxeT3AtZv4c,A3fsA9Zfv1X2fVEQhTw51lKENdNrEqT3,1,0,0,0,0,0,1,0,1,0.14285714285714285,1,0.0,0,0,0,0,0,0,0,1,0,0,1,1
3300,83457,ZxhebDCFWL0m0f61BciDLXGRMOKOE45R,SpATywNh6bZuzm8s1ceuBUnMUAeoAHHw,2,0,0,0,0,0,3,0,3,0.42857142857142855,1,0.0,0,0,0,0,0,0,0,3,0,0,3,1
3301,83515,EHQfOyQJIuqt0P1nyDah8NPkqTS1EGa4,SpATywNh6bZuzm8s1ceuBUnMUAeoAHHw,13,10,7,0,5,1,7,1,31,4.428571428571429,1,0.0,0,7,0,5,10,1,0,7,1,12,19,1
3302,83519,OmeHT0PntcI0ieBORzxyW3ukuMNHL2Uw,bWdj2GDclj5ofokWjzoa5jAwMkxCykd6,1,0,0,0,0,0,1,0,1,0.14285714285714285,1,0.0,0,0,0,0,0,0,0,1,0,0,1,1
3303,83520,AIxODBgirdS9q7XBbO7B4LHcFYA0NbGc,bWdj2GDclj5ofokWjzoa5jAwMkxCykd6,7,13,2,30,6,0,2,0,53,7.571428571428571,1,0.0,10,2,29,6,3,0,1,2,0,47,6,0
3304,83524,4Uyhf3xkbmSb7blGg2niZUhegHNb0hzL,SpATywNh6bZuzm8s1ceuBUnMUAeoAHHw,10,8,4,0,3,0,2,0,17,2.4285714285714284,1,0.0,0,4,0,3,8,0,0,2,0,7,10,0
3305,83525,8Rf4S0ug2TWWxQ3mSUdOeqp73t5YEeYH,RXDvfPUBYFlVdlueBFbLW0mhhAyGEqpt,9,6,3,0,4,0,4,0,17,2.4285714285714284,1,0.0,2,3,0,4,4,0,0,4,0,9,8,1
3306,83574,bzc6yymc6ktkSbBvgdjBytLe8to97DFg,SpATywNh6bZuzm8s1ceuBUnMUAeoAHHw,5,2,1,0,1,0,2,0,6,0.8571428571428571,1,0.0,0,1,0,1,2,0,0,2,0,2,4,1
3307,83578,t8qBiDTvOvYmrxcVIErRuEOf38tywm6t,A3fsA9Zfv1X2fVEQhTw51lKENdNrEqT3,4,2,1,0,0,0,2,0,5,0.7142857142857143,1,0.0,0,1,0,0,2,0,0,2,0,1,4,1
3308,83597,kzdGmpsGUR2isiUTRf34FiwBn190CZX2,SpATywNh6bZuzm8s1ceuBUnMUAeoAHHw,7,9,1,1,1,0,1,0,13,1.8571428571428572,1,0.0,5,1,1,1,4,0,0,1,0,8,5,1
3309,83610,LsCKaHxDojvW6mqkt4YixGtP1AxIvEcR,SpATywNh6bZuzm8s1ceuBUnMUAeoAHHw,3,2,0,0,0,0,2,0,4,0.5714285714285714,1,0.0,0,0,0,0,2,0,0,2,0,0,4,0
3310,83614,f0G6xN4ok96NnHxUb12ID1EOiKvmCYmR,SpATywNh6bZuzm8s1ceuBUnMUAeoAHHw,4,6,3,0,0,0,2,0,11,1.5714285714285714,1,0.0,0,3,0,0,6,0,0,2,0,3,8,1
3311,83619,DBdf78JfZqUu6Xrj5qSlBFRqX4eZFYBh,SpATywNh6bZuzm8s1ceuBUnMUAeoAHHw,5,5,1,0,0,0,2,0,8,1.1428571428571428,1,0.0,2,1,0,0,3,0,0,2,0,3,5,1
3312,83624,uZO11U6xkUn8TqWyabhD9DUasFPbf13L,SpATywNh6bZuzm8s1ceuBUnMUAeoAHHw,2,0,0,0,0,0,2,0,2,0.2857142857142857,1,0.0,0,0,0,0,0,0,0,2,0,0,2,0
3313,83631,q4FzN29BOCqmKsQz24UjDiDoY7rAOM1p,SpATywNh6bZuzm8s1ceuBUnMUAeoAHHw,1,0,0,0,0,0,1,0,1,0.14285714285714285,1,0.0,0,0,0,0,0,0,0,1,0,0,1,1
3314,83647,5lUjtpVDM24Ky0bHM8HFsUs8uLGNBspP,SpATywNh6bZuzm8s1ceuBUnMUAeoAHHw,3,2,0,0,0,0,1,0,3,0.42857142857142855,1,0.0,0,0,0,0,2,0,0,1,0,0,3,1
3315,83654,gGPwEyB8WM9RKY8d6MZCxjfZZkbEQNgr,A3fsA9Zfv1X2fVEQhTw51lKENdNrEqT3,1,0,0,0,0,0,1,0,1,0.14285714285714285,1,0.0,0,0,0,0,0,0,0,1,0,0,1,1
3316,83664,KqTFA16VVILHiK0IYy8jaNTctvzYX8nu,bWdj2GDclj5ofokWjzoa5jAwMkxCykd6,11,12,1,0,1,0,1,0,15,2.142857142857143,1,0.0,0,1,0,1,12,0,0,1,0,2,13,1
3317,83704,z38xWziicrZeTyki4GmVJQHBKXdJd40R,bWdj2GDclj5ofokWjzoa5jAwMkxCykd6,2,0,0,0,0,0,8,0,8,1.1428571428571428,1,0.0,0,0,0,0,0,0,0,8,0,0,8,1
3318,83713,bAltXvR0FBKFy91atPslJEMIb77R3lRC,A3fsA9Zfv1X2fVEQhTw51lKENdNrEqT3,12,9,4,0,4,0,5,0,22,3.142857142857143,1,0.0,0,4,0,4,9,0,0,5,0,8,14,1
3319,83729,CioR8peuoSw6UJW12F3PHl1hUYQxgYtj,SpATywNh6bZuzm8s1ceuBUnMUAeoAHHw,17,24,7,28,1,5,7,0,72,10.285714285714286,2,0.0,13,7,27,1,11,5,1,7,0,48,24,1
3320,83775,uiC9EHMxnf2w4h6Qgd2IixJ8SdchRJcU,A3fsA9Zfv1X2fVEQhTw51lKENdNrEqT3,1,0,0,0,0,0,1,0,1,0.14285714285714285,1,0.0,0,0,0,0,0,0,0,1,0,0,1,1
3321,83795,P0VuZGgCaFPCBxKorH7bJdlMsmBgjIrL,bWdj2GDclj5ofokWjzoa5jAwMkxCykd6,1,0,0,0,0,0,1,0,1,0.14285714285714285,1,0.0,0,0,0,0,0,0,0,1,0,0,1,1
3322,83829,73yLreN6EzcjveHRceJMpzYK9XWfEA6F,A3fsA9Zfv1X2fVEQhTw51lKENdNrEqT3,1,0,0,0,0,0,1,0,1,0.14285714285714285,1,0.0,0,0,0,0,0,0,0,1,0,0,1,1
3323,83851,hkZJZMuEk3eRSgWhjH7jPcJrlgv2RTNl,A3fsA9Zfv1X2fVEQhTw51lKENdNrEqT3,9,9,8,0,4,0,2,0,23,3.2857142857142856,1,0.0,0,8,0,4,9,0,0,2,0,12,11,1
3324,83854,4IJ56QlJSL8avuRQEkrBcEyhUIO3LIP3,bWdj2GDclj5ofokWjzoa5jAwMkxCykd6,23,23,13,54,5,11,13,0,119,17.0,2,0.0,7,13,44,5,16,11,10,13,0,69,50,0
3325,83861,yfR3kQ7JpR4tbAAtg2uJogcbjyExFgIX,A3fsA9Zfv1X2fVEQhTw51lKENdNrEqT3,45,13,0,174,0,0,5,0,192,27.428571428571427,1,0.0,3,0,174,0,10,0,0,5,0,177,15,1
3326,83875,3CXEafcVCxECgohc6attm6JVlndHTBVL,SpATywNh6bZuzm8s1ceuBUnMUAeoAHHw,8,15,9,0,5,0,4,0,33,4.714285714285714,2,0.0,0,9,0,5,15,0,0,4,0,14,19,1
3327,83891,vIXg8cSMNeH6m9S64QuOOXQlNK5JgpP1,SpATywNh6bZuzm8s1ceuBUnMUAeoAHHw,4,2,1,0,1,1,1,0,6,0.8571428571428571,1,0.0,0,1,0,1,2,1,0,1,0,2,4,1
3328,83898,mbeSuuMfzSoN2eC8D2XuG5snuf7K1Ab4,SpATywNh6bZuzm8s1ceuBUnMUAeoAHHw,5,2,1,0,1,0,3,0,7,1.0,1,0.0,0,1,0,1,2,0,0,3,0,2,5,1
3329,83900,YUf9YSE5dta2ffkPJrkUXDrdyRDcwPmp,SpATywNh6bZuzm8s1ceuBUnMUAeoAHHw,4,2,0,0,0,3,2,0,7,1.0,1,0.0,0,0,0,0,2,3,0,2,0,0,7,1
3330,83916,9gwK2SMO9RzFmbR3NVs20xNig2HGOi8l,A3fsA9Zfv1X2fVEQhTw51lKENdNrEqT3,5,3,1,0,1,0,1,0,6,0.8571428571428571,1,0.0,0,1,0,1,3,0,0,1,0,2,4,1
3331,83924,m5tZ7113qZA5gPphfQM81fCEbUkxpJsE,SpATywNh6bZuzm8s1ceuBUnMUAeoAHHw,3,3,0,0,0,0,1,0,4,0.5714285714285714,1,0.0,0,0,0,0,3,0,0,1,0,0,4,1
3332,83933,bA4tnPZD0UU4XAL3OkL7nUjtkAzbgj9d,bWdj2GDclj5ofokWjzoa5jAwMkxCykd6,39,51,19,75,9,14,7,0,175,25.0,2,0.0,7,19,69,9,44,14,6,7,0,104,71,0
3333,83937,riM9GkB0ajSqpIPlVq4tRzOjk7wJ6NHE,SpATywNh6bZuzm8s1ceuBUnMUAeoAHHw,3,2,1,0,0,0,1,0,4,0.5714285714285714,1,0.0,0,1,0,0,2,0,0,1,0,1,3,1
3334,83952,3FEVPp7qXQqf7zefGcAP21t6w7dOpf6B,SpATywNh6bZuzm8s1ceuBUnMUAeoAHHw,5,2,1,0,1,0,2,0,6,0.8571428571428571,1,0.0,0,1,0,1,2,0,0,2,0,2,4,1
3335,83957,JXoruAOSjfsBsWMnWERJPrR6Egi77l6M,SpATywNh6bZuzm8s1ceuBUnMUAeoAHHw,4,2,0,0,0,0,2,0,4,0.5714285714285714,1,0.0,0,0,0,0,2,0,0,2,0,0,4,1
3336,83972,h2AAA2rscYTKabHFKWYAQiMOilyMV9Ba,SpATywNh6bZuzm8s1ceuBUnMUAeoAHHw,2,0,0,0,0,0,2,0,2,0.2857142857142857,1,0.0,0,0,0,0,0,0,0,2,0,0,2,1
3337,83978,19iVDfShKixZpg8xTJAbBZz9CTfyTS2H,A3fsA9Zfv1X2fVEQhTw51lKENdNrEqT3,13,14,7,0,6,0,1,0,28,4.0,1,0.0,0,7,0,6,14,0,0,1,0,13,15,1
3338,83989,QbrhOgnPl8mnx3TbklxYm9mtjH3wH9bH,A3fsA9Zfv1X2fVEQhTw51lKENdNrEqT3,18,12,9,0,8,5,9,0,43,6.142857142857143,1,0.0,0,9,0,8,12,5,0,9,0,17,26,1
3339,84000,rdlMbs5MAmZwKWZ5MP6d4JJy7danp2Mg,bWdj2GDclj5ofokWjzoa5jAwMkxCykd6,1,0,0,0,0,0,1,0,1,0.14285714285714285,1,0.0,0,0,0,0,0,0,0,1,0,0,1,1
3340,84001,rdlMbs5MAmZwKWZ5MP6d4JJy7danp2Mg,A3fsA9Zfv1X2fVEQhTw51lKENdNrEqT3,7,1,0,0,0,0,7,1,9,1.2857142857142858,1,0.0,0,0,0,0,1,0,0,7,1,0,9,1
3341,84035,dhO2y8sIijAlPYlXxsHK1aEk6O7FL2Q2,SpATywNh6bZuzm8s1ceuBUnMUAeoAHHw,1,0,0,0,0,0,1,0,1,0.14285714285714285,1,0.0,0,0,0,0,0,0,0,1,0,0,1,1
3342,84057,JA3GjaqmpFLtt1yojsnNXLqhMexKQ8aw,SpATywNh6bZuzm8s1ceuBUnMUAeoAHHw,7,4,1,0,1,0,2,0,8,1.1428571428571428,1,0.0,0,1,0,1,4,0,0,2,0,2,6,1
3343,84087,bl8YOhounxXowMizQE2ibaM5H4dVfT77,A3fsA9Zfv1X2fVEQhTw51lKENdNrEqT3,1,0,0,0,0,0,1,0,1,0.14285714285714285,1,0.0,0,0,0,0,0,0,0,1,0,0,1,1
3344,84111,uiC9EHMxnf2w4h6Qgd2IixJ8SdchRJcU,SpATywNh6bZuzm8s1ceuBUnMUAeoAHHw,1,0,0,0,0,0,1,0,1,0.14285714285714285,1,0.0,0,0,0,0,0,0,0,1,0,0,1,1
3345,84133,bVLtn3iBc4ibW8xWVzLLM3Hs9gCB0qb7,A3fsA9Zfv1X2fVEQhTw51lKENdNrEqT3,1,0,0,0,0,0,1,0,1,0.14285714285714285,1,0.0,0,0,0,0,0,0,0,1,0,0,1,1
3346,84158,8xjONclmnIBNB55spM8y9l5QMEcAlTZb,SpATywNh6bZuzm8s1ceuBUnMUAeoAHHw,7,5,1,0,1,1,3,0,11,1.5714285714285714,1,0.0,0,1,0,1,5,1,0,3,0,2,9,1
3347,84165,n1ESpvyobZkFsfrWJhKOuY4URaa1sUc5,SpATywNh6bZuzm8s1ceuBUnMUAeoAHHw,9,10,7,0,3,3,3,0,26,3.7142857142857144,2,0.0,0,7,0,3,10,3,0,3,0,10,16,0
3348,84170,YTpSaD5WvcxnMj244x9U8tK7ZjCb9sw0,A3fsA9Zfv1X2fVEQhTw51lKENdNrEqT3,2,0,0,0,0,0,2,0,2,0.2857142857142857,1,0.0,0,0,0,0,0,0,0,2,0,0,2,1
3349,84178,btDL3pREx87iBHbN4DIhDQi5ERLMYVWp,bWdj2GDclj5ofokWjzoa5jAwMkxCykd6,1,0,0,0,0,0,1,0,1,0.14285714285714285,1,0.0,0,0,0,0,0,0,0,1,0,0,1,1
3350,84435,OOJh2Yrr6RQf9QAHFBo7EBzeZ2OAmLfw,SpATywNh6bZuzm8s1ceuBUnMUAeoAHHw,7,4,3,6,0,0,1,0,14,2.0,1,0.0,0,3,5,0,4,0,1,1,0,8,6,1
3351,84453,9g6dyxp7tVOU5kbyy5pf6QgprdOQv6vZ,RXDvfPUBYFlVdlueBFbLW0mhhAyGEqpt,12,15,7,16,5,0,3,1,47,6.714285714285714,1,0.0,7,7,14,5,8,0,2,3,1,33,14,1
3352,84456,RGf4k3THi4AV4qsAjc1UEOWiIeDYcchf,RXDvfPUBYFlVdlueBFbLW0mhhAyGEqpt,6,3,1,0,1,0,2,0,7,1.0,1,0.0,0,1,0,1,3,0,0,2,0,2,5,1
3353,84492,unG4C0Ae6YJ39WbV1xtmGVvK7bPgQLG7,RXDvfPUBYFlVdlueBFbLW0mhhAyGEqpt,8,9,4,0,1,0,3,0,17,2.4285714285714284,1,0.0,1,4,0,1,8,0,0,3,0,6,11,1
3354,84553,nUVa7zKjNimx07QWGFgK3J5PX7DLOyrU,RXDvfPUBYFlVdlueBFbLW0mhhAyGEqpt,1,0,0,0,0,0,1,0,1,0.14285714285714285,1,0.0,0,0,0,0,0,0,0,1,0,0,1,1
3355,84556,OatCEetKd31vq2MFNsgH6MMikZrZEqiC,bWdj2GDclj5ofokWjzoa5jAwMkxCykd6,1,0,0,0,0,0,1,0,1,0.14285714285714285,1,0.0,0,0,0,0,0,0,0,1,0,0,1,1
3356,84646,RiDnEhaXHtwiFRournEb2192YjpdBStU,G8EPVSXsOYB5YQWZGiz1aVq5Pgr2GrQu,1,0,0,0,0,0,1,0,1,0.14285714285714285,1,0.0,0,0,0,0,0,0,0,1,0,0,1,1
3357,84666,hBNiP82EasOgIR36wjHyg8vPIDQi3YO9,bWdj2GDclj5ofokWjzoa5jAwMkxCykd6,5,3,2,0,0,0,2,0,7,1.0,1,0.0,0,2,0,0,3,0,0,2,0,2,5,1
3358,84728,GEuM5Jv5mgEiHQoZ7WZazbnkG2fcrd9Y,SpATywNh6bZuzm8s1ceuBUnMUAeoAHHw,6,7,4,0,1,0,5,0,17,2.4285714285714284,2,0.0,0,4,0,1,7,0,0,5,0,5,12,0
3359,84847,FeSQQc9CIFMTYLlHcSRbUJqf0NNwxJ2K,A3fsA9Zfv1X2fVEQhTw51lKENdNrEqT3,1,0,0,0,0,0,1,0,1,0.14285714285714285,1,0.0,0,0,0,0,0,0,0,1,0,0,1,0
3360,84859,tW4kGyQmGPxJ7lQyOwGHaOFglTma7gIC,A3fsA9Zfv1X2fVEQhTw51lKENdNrEqT3,1,0,0,0,0,0,1,0,1,0.14285714285714285,1,0.0,0,0,0,0,0,0,0,1,0,0,1,1
3361,84872,eLmalTVeebqdOV7NU54KOewS5jRaHr8U,G8EPVSXsOYB5YQWZGiz1aVq5Pgr2GrQu,9,6,5,0,3,0,2,0,16,2.2857142857142856,1,0.0,0,5,0,3,6,0,0,2,0,8,8,1
3362,84900,kFEFWVRKxySg48KS2BQ5EGBj2Fy43YYR,SpATywNh6bZuzm8s1ceuBUnMUAeoAHHw,3,2,1,0,0,0,2,0,5,0.7142857142857143,2,0.0,0,1,0,0,2,0,0,2,0,1,4,0
3363,85019,aIIHBjdeRcv9jhajcTkxD39vpVMqF1ri,RXDvfPUBYFlVdlueBFbLW0mhhAyGEqpt,6,10,4,0,2,0,3,0,19,2.7142857142857144,1,0.0,4,4,0,2,6,0,0,3,0,10,9,1
3364,85144,CVCf4od7ffnWY5VcGG9qXOV7fsgr6eo9,G8EPVSXsOYB5YQWZGiz1aVq5Pgr2GrQu,1,0,0,0,0,0,1,0,1,0.14285714285714285,1,0.0,0,0,0,0,0,0,0,1,0,0,1,1
3365,85180,TNWu8lQOCqXwhlhWhjlBSPXoG0TmfsH5,G8EPVSXsOYB5YQWZGiz1aVq5Pgr2GrQu,1,0,0,0,0,0,2,0,2,0.2857142857142857,1,0.0,0,0,0,0,0,0,0,2,0,0,2,1
3366,85215,hu8eak1Xmf8voE8pnxPzkSD2dZP9Sipf,RXDvfPUBYFlVdlueBFbLW0mhhAyGEqpt,3,2,0,0,0,0,7,0,9,1.2857142857142858,2,0.0,0,0,0,0,2,0,0,7,0,0,9,1
3367,85251,vSCx3udDUOJuH4qQxIeZOxrYva69olaR,G8EPVSXsOYB5YQWZGiz1aVq5Pgr2GrQu,10,7,2,0,2,1,5,0,17,2.4285714285714284,1,0.0,4,2,0,2,3,1,0,5,0,8,9,1
3368,85254,5AnTWuSZRA41O05i9OVXdtPUlL8FmaJL,SpATywNh6bZuzm8s1ceuBUnMUAeoAHHw,3,4,0,0,0,0,4,0,8,1.1428571428571428,2,0.0,0,0,0,0,4,0,0,4,0,0,8,1
3369,85263,NTSPR2Wl1tIxtx1KX6XExiYGpKCsz0n8,G8EPVSXsOYB5YQWZGiz1aVq5Pgr2GrQu,1,0,0,0,0,0,1,0,1,0.14285714285714285,1,0.0,0,0,0,0,0,0,0,1,0,0,1,1
3370,85324,4ZtOohTiezs8VzIzc66Ao14rrfIGFCZG,G8EPVSXsOYB5YQWZGiz1aVq5Pgr2GrQu,10,9,4,0,2,1,8,1,25,3.5714285714285716,2,0.0,0,4,0,2,9,1,0,8,1,6,19,1
3371,85347,qr1Y8xuPrcpdzScNHYsirGXqasfUdOVa,A3fsA9Zfv1X2fVEQhTw51lKENdNrEqT3,1,0,0,0,0,0,1,0,1,0.14285714285714285,1,0.0,0,0,0,0,0,0,0,1,0,0,1,1
3372,85360,sT9hGAnww95aeGvqwQpJlS3ORhWDT49F,SpATywNh6bZuzm8s1ceuBUnMUAeoAHHw,3,2,0,0,0,0,1,0,3,0.42857142857142855,1,0.0,0,0,0,0,2,0,0,1,0,0,3,0
3373,85381,MaYaRLQWCfitDjLO89g6UksqHgmMxPRV,SpATywNh6bZuzm8s1ceuBUnMUAeoAHHw,3,2,1,0,0,0,1,0,4,0.5714285714285714,1,0.0,0,1,0,0,2,0,0,1,0,1,3,0
3374,86898,JUAvN6CchqwicZ9lfSkTbwue3bPu0qhC,A3fsA9Zfv1X2fVEQhTw51lKENdNrEqT3,2,0,0,0,0,0,2,0,2,0.2857142857142857,1,0.0,0,0,0,0,0,0,0,2,0,0,2,1
3375,86974,HB5xN5WvO63fyle8L9OU8KEV5tvW4m0R,SpATywNh6bZuzm8s1ceuBUnMUAeoAHHw,24,21,10,27,6,0,2,0,66,9.428571428571429,1,0.0,10,10,26,6,11,0,1,2,0,52,14,0
3376,86997,hXvrvs517Cljnw9n8TIqf0EZFGKj5tLN,A3fsA9Zfv1X2fVEQhTw51lKENdNrEqT3,1,0,0,0,0,0,1,0,1,0.14285714285714285,1,0.0,0,0,0,0,0,0,0,1,0,0,1,1
3377,87001,0dwnge5EOc1G7OI2GIE4cTm6v44kkXQF,A3fsA9Zfv1X2fVEQhTw51lKENdNrEqT3,1,0,0,0,0,0,1,0,1,0.14285714285714285,1,0.0,0,0,0,0,0,0,0,1,0,0,1,0
3378,87049,1BQpAvqrBw6EmiaIW2MwJ2rv4x4Q2s0V,SpATywNh6bZuzm8s1ceuBUnMUAeoAHHw,5,5,2,0,0,0,2,0,9,1.2857142857142858,1,0.0,1,2,0,0,4,0,0,2,0,3,6,0
3379,87087,ycZcyaRZkRmTmfTyJcaxWvg5l6N3L4CN,SpATywNh6bZuzm8s1ceuBUnMUAeoAHHw,1,0,0,0,0,0,1,0,1,0.14285714285714285,1,0.0,0,0,0,0,0,0,0,1,0,0,1,1
3380,87094,TPPsOieQBcwqH8dqABTR3mddQ5gDzlZO,A3fsA9Zfv1X2fVEQhTw51lKENdNrEqT3,3,2,1,0,0,0,2,0,5,0.7142857142857143,1,0.0,0,1,0,0,2,0,0,2,0,1,4,1
3381,87122,NFGYUC7dcOkWJh2BiZLJheVSucAvXvpt,A3fsA9Zfv1X2fVEQhTw51lKENdNrEqT3,9,18,0,0,0,0,4,0,22,3.142857142857143,2,0.0,0,0,0,0,18,0,0,4,0,0,22,1
3382,87147,PHBho9Sc0XQZt8wGEuns5tbDU5eoHa8g,A3fsA9Zfv1X2fVEQhTw51lKENdNrEqT3,49,21,2,138,0,0,5,0,166,23.714285714285715,2,0.0,4,2,125,0,17,0,13,5,0,131,35,0
3383,87162,RgxmGDfKcBuOKimrAda6q6r1m3kTwJWg,SpATywNh6bZuzm8s1ceuBUnMUAeoAHHw,2,0,0,0,0,0,2,0,2,0.2857142857142857,1,0.0,0,0,0,0,0,0,0,2,0,0,2,1
3384,87169,BYoagvhtaQZvEdBOdm0fSGLXeMikTNAf,SpATywNh6bZuzm8s1ceuBUnMUAeoAHHw,4,4,0,0,0,0,1,0,5,0.7142857142857143,1,0.0,0,0,0,0,4,0,0,1,0,0,5,1
3385,87330,ChO2roT5np1gHX6O4LZD82zuXuaO1HXn,A3fsA9Zfv1X2fVEQhTw51lKENdNrEqT3,35,19,16,24,13,5,6,0,83,11.857142857142858,1,0.0,0,16,20,13,19,5,4,6,0,49,34,1
3386,87402,Xz40w2Sa6ycZOmupSA5XfcYT02Ov8S1m,A3fsA9Zfv1X2fVEQhTw51lKENdNrEqT3,11,8,4,0,3,0,2,0,17,2.4285714285714284,1,0.0,0,4,0,3,8,0,0,2,0,7,10,1
3387,87485,HqS5s3hltvHSRLR6PzHeJNPRu48XNpMR,A3fsA9Zfv1X2fVEQhTw51lKENdNrEqT3,1,0,0,0,0,0,1,0,1,0.14285714285714285,1,0.0,0,0,0,0,0,0,0,1,0,0,1,1
3388,87514,UUyRymVa7K1uXcxu9NV7wrw7koSoKJkA,A3fsA9Zfv1X2fVEQhTw51lKENdNrEqT3,9,7,6,0,3,0,2,0,18,2.5714285714285716,1,0.0,0,6,0,3,7,0,0,2,0,9,9,1
3389,87544,HF98YPKzT8oi2j9flZW9kstZcvL3ZimG,SpATywNh6bZuzm8s1ceuBUnMUAeoAHHw,12,23,3,6,4,0,2,0,38,5.428571428571429,1,0.0,3,3,6,4,20,0,0,2,0,16,22,0
3390,87552,VfEelXsd4Sgrcy5E8mk405V2S0XUGtSK,A3fsA9Zfv1X2fVEQhTw51lKENdNrEqT3,5,2,0,0,0,1,4,1,8,1.1428571428571428,1,0.0,0,0,0,0,2,1,0,4,1,0,8,1
3391,87563,mLnrkBxCMzHzCOgxlcePLHngsSsyrmY0,SpATywNh6bZuzm8s1ceuBUnMUAeoAHHw,7,6,0,4,0,0,2,0,12,1.7142857142857142,1,0.0,1,0,4,0,5,0,0,2,0,5,7,0
3392,87601,fXFz6g5r2Tp8eWARWPVXqKuqaMAimuJv,A3fsA9Zfv1X2fVEQhTw51lKENdNrEqT3,6,4,2,0,2,0,1,0,9,1.2857142857142858,1,0.0,0,2,0,2,4,0,0,1,0,4,5,1
3393,87645,or5tGmwIQtkxzns3Abayo6pKJnoHWcAG,A3fsA9Zfv1X2fVEQhTw51lKENdNrEqT3,8,4,2,0,1,0,3,1,11,1.5714285714285714,1,0.0,0,2,0,1,4,0,0,3,1,3,8,1
3394,87649,KCgqr6mS6kq5aoFQfmLbsIxQVUeF53Nr,SpATywNh6bZuzm8s1ceuBUnMUAeoAHHw,9,11,0,9,0,0,2,1,23,3.2857142857142856,1,0.0,1,0,7,0,10,0,2,2,1,8,15,0
3395,87732,L1FTG9TM6RI5TBCTexQgshQhXhu2oZpJ,RXDvfPUBYFlVdlueBFbLW0mhhAyGEqpt,4,2,1,0,0,0,2,0,5,0.7142857142857143,1,0.0,0,1,0,0,2,0,0,2,0,1,4,1
3396,87742,TvtViclCsd2PmV5PrW2DKEwPmoLOSaRh,A3fsA9Zfv1X2fVEQhTw51lKENdNrEqT3,67,46,3,110,2,1,11,1,174,24.857142857142858,1,0.0,5,3,99,2,41,1,11,11,1,109,65,1
3397,87752,waDceRgc2N0BjPJorKWJj1WtKs87R7xP,A3fsA9Zfv1X2fVEQhTw51lKENdNrEqT3,11,11,7,0,5,0,3,0,26,3.7142857142857144,1,0.0,1,7,0,5,10,0,0,3,0,13,13,1
3398,87764,VPCWV7vv7mSXLXdyKv2YQuYNd5q5tnVr,A3fsA9Zfv1X2fVEQhTw51lKENdNrEqT3,1,0,0,0,0,0,1,0,1,0.14285714285714285,1,0.0,0,0,0,0,0,0,0,1,0,0,1,1
3399,87826,yGll7cBEK4l513wg08W8WjrXiINZSUwd,SpATywNh6bZuzm8s1ceuBUnMUAeoAHHw,4,2,1,0,1,0,2,0,6,0.8571428571428571,1,0.0,0,1,0,1,2,0,0,2,0,2,4,1
3400,87920,1uj3lODORrX2PgjuF1fpWy9nhOirDGas,G8EPVSXsOYB5YQWZGiz1aVq5Pgr2GrQu,5,5,0,0,0,0,0,0,5,0.7142857142857143,1,0.0,0,0,0,0,5,0,0,0,0,0,5,0
3401,87928,cszgTMCcWdEja3BpEwPP5MtLXTMUMJXE,A3fsA9Zfv1X2fVEQhTw51lKENdNrEqT3,1,0,0,0,0,0,1,0,1,0.14285714285714285,1,0.0,0,0,0,0,0,0,0,1,0,0,1,1
3402,87982,MQK4DgM2xSqvXiKh3zV47i5iY5mt4VPL,SpATywNh6bZuzm8s1ceuBUnMUAeoAHHw,4,2,1,0,1,0,1,0,5,0.7142857142857143,1,0.0,0,1,0,1,2,0,0,1,0,2,3,1
3403,87987,Ffohn9JNnGJQD2IavzMTS00ubnVtcb2T,SpATywNh6bZuzm8s1ceuBUnMUAeoAHHw,3,2,1,0,0,0,2,0,5,0.7142857142857143,2,0.0,0,1,0,0,2,0,0,2,0,1,4,0
3404,87994,Y51MqWhaiGyWdNickwBkKEZ7LC7se5uV,A3fsA9Zfv1X2fVEQhTw51lKENdNrEqT3,1,0,0,0,0,0,1,0,1,0.14285714285714285,1,0.0,0,0,0,0,0,0,0,1,0,0,1,1
3405,88029,bSaZ1hYnI1zX06sBhHjW0JtYDEAqEuPp,SpATywNh6bZuzm8s1ceuBUnMUAeoAHHw,5,2,0,0,0,0,4,0,6,0.8571428571428571,1,0.0,0,0,0,0,2,0,0,4,0,0,6,0
3406,88086,ffLXxfgMU4yir9uI5fIkKo2iZzEw2Lpz,A3fsA9Zfv1X2fVEQhTw51lKENdNrEqT3,4,2,1,0,1,0,1,0,5,0.7142857142857143,1,0.0,0,1,0,1,2,0,0,1,0,2,3,1
3407,88089,x44blDMbARj16T0tLu8ojXSHZTWR98Zp,A3fsA9Zfv1X2fVEQhTw51lKENdNrEqT3,6,2,0,0,0,0,5,0,7,1.0,1,0.0,0,0,0,0,2,0,0,5,0,0,7,1
3408,88114,giXuT5U1RtMqgo8IXt5j9x4mrlpr0AWq,A3fsA9Zfv1X2fVEQhTw51lKENdNrEqT3,33,29,3,56,0,0,6,0,94,13.428571428571429,3,0.0,5,3,52,0,24,0,4,6,0,60,34,1
3409,88115,57QNpq0y9acG53aqB6y56Mpy1s4uWqKM,A3fsA9Zfv1X2fVEQhTw51lKENdNrEqT3,18,10,8,0,7,0,6,0,31,4.428571428571429,2,0.0,0,8,0,7,10,0,0,6,0,15,16,1
3410,88117,os5aeAM18BF9yPST9BbZNwxdgfyb3iSj,A3fsA9Zfv1X2fVEQhTw51lKENdNrEqT3,4,2,1,0,1,0,6,0,10,1.4285714285714286,1,0.0,0,1,0,1,2,0,0,6,0,2,8,1
3411,88775,zNnqmF2sQm5pVrk4EjykARlvIbp0hTq0,fbPkOYLVPtPgIt0MxizjfFJov3JbHyAi,5,3,1,0,1,0,2,0,7,1.0,1,0.0,0,1,0,1,3,0,0,2,0,2,5,1
3412,88832,xLVZrHAd2rcd4gjL2AH8LHStjVOxoTXH,fbPkOYLVPtPgIt0MxizjfFJov3JbHyAi,6,4,2,0,1,0,1,0,8,1.1428571428571428,1,0.0,0,2,0,1,4,0,0,1,0,3,5,1
3413,89219,Mqke4gGiYdtmQuFOtXx8ilrWhvfHEVOG,SpATywNh6bZuzm8s1ceuBUnMUAeoAHHw,5,2,1,0,1,0,2,0,6,0.8571428571428571,1,0.0,0,1,0,1,2,0,0,2,0,2,4,1
3414,89564,CywE8FKIbY3F3QxzorcpvAYCApeOH4J5,SpATywNh6bZuzm8s1ceuBUnMUAeoAHHw,4,4,2,0,0,0,1,0,7,1.0,1,0.0,0,2,0,0,4,0,0,1,0,2,5,1
3415,89582,IVRKzAf1gWN5ButpaPiczzsxf6iD5MK8,SpATywNh6bZuzm8s1ceuBUnMUAeoAHHw,5,4,3,0,0,0,1,0,8,1.1428571428571428,1,0.0,0,3,0,0,4,0,0,1,0,3,5,0
3416,89605,f3LgSSewSBsudoWmIigH2aapqGCxH8CK,SpATywNh6bZuzm8s1ceuBUnMUAeoAHHw,1,0,0,0,0,0,1,0,1,0.14285714285714285,1,0.0,0,0,0,0,0,0,0,1,0,0,1,0
3417,89637,9FULiZu6qUnuIs2MyDSoVO8NHl3dw8Ao,SpATywNh6bZuzm8s1ceuBUnMUAeoAHHw,14,21,1,14,1,0,4,0,41,5.857142857142857,2,0.0,4,1,14,1,17,0,0,4,0,20,21,1
3418,89651,4qM7n65VbCTp8lq3dbzhDmImmEZcwgn8,bWdj2GDclj5ofokWjzoa5jAwMkxCykd6,5,3,2,0,1,0,1,0,7,1.0,1,0.0,0,2,0,1,3,0,0,1,0,3,4,1
3419,89764,Ur5YqRaNsaD6KYfRfGA2p4Zmd8kpRITc,SpATywNh6bZuzm8s1ceuBUnMUAeoAHHw,3,4,2,0,0,1,2,0,9,1.2857142857142858,2,0.0,0,2,0,0,4,1,0,2,0,2,7,0
3420,89829,sfmDw8Mu24TwJAISRGKb3tkGixPCex4a,SpATywNh6bZuzm8s1ceuBUnMUAeoAHHw,5,14,2,0,0,0,3,0,19,2.7142857142857144,1,0.0,0,2,0,0,14,0,0,3,0,2,17,1
3421,89893,HAAyQYNYY3ULmqhNC56bxv5FSwyMVoqP,SpATywNh6bZuzm8s1ceuBUnMUAeoAHHw,3,2,1,0,0,0,1,0,4,0.5714285714285714,1,0.0,0,1,0,0,2,0,0,1,0,1,3,1
3422,89897,HAAyQYNYY3ULmqhNC56bxv5FSwyMVoqP,bWdj2GDclj5ofokWjzoa5jAwMkxCykd6,3,3,2,0,0,0,1,0,6,0.8571428571428571,1,0.0,0,2,0,0,3,0,0,1,0,2,4,1
3423,90055,kGkU7DU5zOC0IQHNRlo6r0rouCnUfi6R,RXDvfPUBYFlVdlueBFbLW0mhhAyGEqpt,6,5,1,0,1,0,1,0,8,1.1428571428571428,1,0.0,0,1,0,1,5,0,0,1,0,2,6,1
3424,90097,ilWzYGLWBh9DSc1MV8g2C4Go5wDNgUHX,bWdj2GDclj5ofokWjzoa5jAwMkxCykd6,3,2,1,0,0,1,1,0,5,0.7142857142857143,1,0.0,0,1,0,0,2,1,0,1,0,1,4,1
3425,90418,fBvSAwv6uc40UeqRCaejhOfI13E4tjda,SpATywNh6bZuzm8s1ceuBUnMUAeoAHHw,3,4,0,0,0,0,2,0,6,0.8571428571428571,1,0.0,0,0,0,0,4,0,0,2,0,0,6,1
3426,90471,AcoYRXM9MxEJpHYoq7SsbSwZ8unsRtq3,SpATywNh6bZuzm8s1ceuBUnMUAeoAHHw,7,4,0,13,0,0,3,0,20,2.857142857142857,1,0.0,2,0,13,0,2,0,0,3,0,15,5,0
3427,90479,09hA70zHHsdFY99KewQn0t7W1Th1KuA4,RXDvfPUBYFlVdlueBFbLW0mhhAyGEqpt,14,7,6,12,5,0,8,1,39,5.571428571428571,1,0.0,1,6,11,5,6,0,1,8,1,23,16,1
3428,90549,Z3cBuyK57dLpleXUvGj6emfcnGidOatN,SpATywNh6bZuzm8s1ceuBUnMUAeoAHHw,3,2,1,0,0,0,1,0,4,0.5714285714285714,1,0.0,0,1,0,0,2,0,0,1,0,1,3,1
3429,90553,Urctwx56OvAe8Aa2Ler31rqDl5pjO2bG,G8EPVSXsOYB5YQWZGiz1aVq5Pgr2GrQu,5,3,1,0,1,0,1,0,6,0.8571428571428571,1,0.0,0,1,0,1,3,0,0,1,0,2,4,1
3430,90560,QqAAFsY8kslizUQKd5uhHbFKpFbb6EW2,SpATywNh6bZuzm8s1ceuBUnMUAeoAHHw,4,2,1,0,0,0,2,0,5,0.7142857142857143,1,0.0,0,1,0,0,2,0,0,2,0,1,4,0
3431,90571,i6jKFDXXIDyjle2n9K5Y7L1CTASMdeNx,RXDvfPUBYFlVdlueBFbLW0mhhAyGEqpt,27,37,0,40,0,3,8,10,98,14.0,2,0.0,10,0,39,0,27,3,1,8,10,49,49,0
3432,90650,cvuy8HaLnRoF5suMAoOqjooUG2AEFLC2,bWdj2GDclj5ofokWjzoa5jAwMkxCykd6,10,8,1,2,2,0,4,0,17,2.4285714285714284,1,0.0,1,1,2,2,7,0,0,4,0,6,11,1
3433,90671,PwGj8ON4yrWpMaoZE0ES8sG2eAqFQNfN,SpATywNh6bZuzm8s1ceuBUnMUAeoAHHw,8,7,4,0,1,0,2,0,14,2.0,2,0.0,0,4,0,1,7,0,0,2,0,5,9,1
3434,90673,yDc9ZpbUycr11xuvu88deR54WnL37yET,SpATywNh6bZuzm8s1ceuBUnMUAeoAHHw,11,29,1,14,0,0,5,0,49,7.0,3,0.0,15,1,12,0,14,0,2,5,0,28,21,0
3435,90674,bLDIg7orV5sh30oIBmQ342IswZTJ8Q5l,RXDvfPUBYFlVdlueBFbLW0mhhAyGEqpt,5,3,2,0,1,0,1,0,7,1.0,1,0.0,0,2,0,1,3,0,0,1,0,3,4,1
3436,90685,p1glD11J2O4xqRjpc7tPhfftojomVp8l,G8EPVSXsOYB5YQWZGiz1aVq5Pgr2GrQu,5,1,1,0,1,1,3,0,7,1.0,1,0.0,0,1,0,1,1,1,0,3,0,2,5,1
3437,90749,Y5EybULOrY5dAmMMQWE7bK5wg4bsR2Lr,bWdj2GDclj5ofokWjzoa5jAwMkxCykd6,3,6,3,0,0,0,1,0,10,1.4285714285714286,1,0.0,0,3,0,0,6,0,0,1,0,3,7,1
3438,90789,bEGwB6bxwamH303rlcp1dTooqcWaF93C,SpATywNh6bZuzm8s1ceuBUnMUAeoAHHw,1,0,0,0,0,0,1,0,1,0.14285714285714285,1,0.0,0,0,0,0,0,0,0,1,0,0,1,0
3439,90832,Qsw20Q5PeTwiq1PxYe0LRVTTkwenKksO,SpATywNh6bZuzm8s1ceuBUnMUAeoAHHw,5,8,2,0,0,0,3,0,13,1.8571428571428572,1,0.0,5,2,0,0,3,0,0,3,0,7,6,1
3440,90855,KogrHROquIJLSXIZqzhYU9Hcb9zVebwT,SpATywNh6bZuzm8s1ceuBUnMUAeoAHHw,16,12,7,12,4,0,1,0,36,5.142857142857143,1,0.0,4,7,10,4,8,0,2,1,0,25,11,1
3441,90887,GVUw4u2UhYktwQlrJTo9fWmDS2qzWpQC,SpATywNh6bZuzm8s1ceuBUnMUAeoAHHw,3,0,0,0,0,28,2,0,30,4.285714285714286,1,0.0,0,0,0,0,0,28,0,2,0,0,30,0
3442,91160,urxyBMLwqPoccprp1W7NCQtPStGZDqxd,SpATywNh6bZuzm8s1ceuBUnMUAeoAHHw,2,0,0,0,0,0,2,0,2,0.2857142857142857,1,0.0,0,0,0,0,0,0,0,2,0,0,2,1
3443,91167,XMtcnsDNasKCOMBWrsjCVH5NONQyEryR,bWdj2GDclj5ofokWjzoa5jAwMkxCykd6,10,16,11,0,1,0,2,0,30,4.285714285714286,1,0.0,3,11,0,1,13,0,0,2,0,15,15,0
3444,91172,EJfQNb5Mu8lcO1ocmk4PtmUhkW8FMGb9,RXDvfPUBYFlVdlueBFbLW0mhhAyGEqpt,5,3,2,0,1,0,1,0,7,1.0,1,0.0,0,2,0,1,3,0,0,1,0,3,4,0
3445,91491,CwyOL3RMOVLomxrxyN9D4jPa9R0iWrS5,SpATywNh6bZuzm8s1ceuBUnMUAeoAHHw,17,28,18,10,9,0,4,0,69,9.857142857142858,2,0.0,2,18,9,9,26,0,1,4,0,38,31,1
3446,91509,sytW49I21SJ70ElOkXGU5SHeeHl1E3fL,bWdj2GDclj5ofokWjzoa5jAwMkxCykd6,3,2,1,0,0,0,2,0,5,0.7142857142857143,1,0.0,0,1,0,0,2,0,0,2,0,1,4,1
3447,91586,vOpj8ur6jA13uE8NuDJFu1oyU88RJP1w,bWdj2GDclj5ofokWjzoa5jAwMkxCykd6,3,4,0,0,0,0,1,0,5,0.7142857142857143,1,0.0,0,0,0,0,4,0,0,1,0,0,5,1
3448,91591,Jp26ywpmjw8PCn9zJ6Emr3JwxCXz1vqU,SpATywNh6bZuzm8s1ceuBUnMUAeoAHHw,2,0,0,0,0,0,2,0,2,0.2857142857142857,1,0.0,0,0,0,0,0,0,0,2,0,0,2,1
3449,91595,gDaSFJD4b80GGtFaPG7wjh3sxtnlKrIT,SpATywNh6bZuzm8s1ceuBUnMUAeoAHHw,14,13,7,14,5,0,2,0,41,5.857142857142857,1,0.0,3,7,13,5,10,0,1,2,0,28,13,0
3450,92954,erkNYBqLpKRElyeL8GeAgO43CMazg6Rt,bWdj2GDclj5ofokWjzoa5jAwMkxCykd6,2,0,0,0,0,0,2,0,2,0.2857142857142857,1,0.0,0,0,0,0,0,0,0,2,0,0,2,1
3451,93026,faeF4I5p3gAJMB1p4LfYVeCLQZKervYV,RXDvfPUBYFlVdlueBFbLW0mhhAyGEqpt,12,12,1,12,2,0,2,0,29,4.142857142857143,1,0.0,6,1,12,2,6,0,0,2,0,21,8,1
3452,93166,wjcBLe1692KFPJUkCwcKQrXvoLbsDg0j,A3fsA9Zfv1X2fVEQhTw51lKENdNrEqT3,6,8,4,0,1,0,2,0,15,2.142857142857143,2,0.0,0,4,0,1,8,0,0,2,0,5,10,1
3453,93414,LiD14ALXLddUqpdQnujGFxQiBSoJOZGF,bWdj2GDclj5ofokWjzoa5jAwMkxCykd6,8,4,1,10,1,0,2,0,18,2.5714285714285716,1,0.0,1,1,8,1,3,0,2,2,0,11,7,0
3454,93444,wfUVHBmDLe0V8vTm9YNAi5Eoe98kipNK,RXDvfPUBYFlVdlueBFbLW0mhhAyGEqpt,17,27,1,0,1,0,4,1,34,4.857142857142857,1,0.0,0,1,0,1,27,0,0,4,1,2,32,1
3455,93454,IdPM07Tobfo8uXfAGdfrnlSPQUjcS5lw,SpATywNh6bZuzm8s1ceuBUnMUAeoAHHw,15,11,6,17,5,0,3,0,42,6.0,1,0.0,5,6,14,5,6,0,3,3,0,30,12,1
3456,93478,ouHHL7JxNnPJ7sZc8oGHgugCfHuyBFzn,bWdj2GDclj5ofokWjzoa5jAwMkxCykd6,5,2,1,0,0,1,3,1,8,1.1428571428571428,1,0.0,0,1,0,0,2,1,0,3,1,1,7,1
3457,93518,I3RIPLupgcaFBN4TZgx1kwE7cqUmhNGE,SpATywNh6bZuzm8s1ceuBUnMUAeoAHHw,7,8,1,0,1,0,2,0,12,1.7142857142857142,1,0.0,0,1,0,1,8,0,0,2,0,2,10,1
3458,93523,7KhKGJPxu4uQKYHNs7O3NjmuTH6NjrVY,A3fsA9Zfv1X2fVEQhTw51lKENdNrEqT3,26,18,14,0,9,2,7,1,51,7.285714285714286,2,0.0,0,14,0,9,18,2,0,7,1,23,28,0
3459,93531,RHEMdhoy3TVz84IqO3CiO0ZVmx7sjl4N,A3fsA9Zfv1X2fVEQhTw51lKENdNrEqT3,12,7,6,0,4,0,1,0,18,2.5714285714285716,1,0.0,0,6,0,4,7,0,0,1,0,10,8,0
3460,93799,SvayS3hRjiQUsZJZ3Z80XuRW7pnvNCGH,SpATywNh6bZuzm8s1ceuBUnMUAeoAHHw,4,6,4,0,0,0,6,0,16,2.2857142857142856,1,0.0,0,4,0,0,6,0,0,6,0,4,12,1
3461,93862,MdwJcKhWKSfBlz1JQsWSYPZY8VplWXai,SpATywNh6bZuzm8s1ceuBUnMUAeoAHHw,1,0,0,0,0,0,1,0,1,0.14285714285714285,1,0.0,0,0,0,0,0,0,0,1,0,0,1,1
3462,93900,L1FTG9TM6RI5TBCTexQgshQhXhu2oZpJ,A3fsA9Zfv1X2fVEQhTw51lKENdNrEqT3,60,23,16,116,10,0,9,0,174,24.857142857142858,3,0.0,2,16,109,10,21,0,7,9,0,137,37,0
3463,94083,sTlxlEkJ3MbMUAeSajnaHOGfpyW9hgq1,SpATywNh6bZuzm8s1ceuBUnMUAeoAHHw,24,33,15,26,5,1,4,0,84,12.0,2,0.0,10,15,25,5,23,1,1,4,0,55,29,0
3464,94086,uKZ87zwhOlE6XjyVFr8vmJl9wOD1B9qQ,A3fsA9Zfv1X2fVEQhTw51lKENdNrEqT3,6,5,3,0,1,0,3,0,12,1.7142857142857142,2,0.0,0,3,0,1,5,0,0,3,0,4,8,1
3465,94113,nVXGW3QRysmVp7bseFXpH5xogt6vyuOe,A3fsA9Zfv1X2fVEQhTw51lKENdNrEqT3,1,0,0,0,0,0,1,0,1,0.14285714285714285,1,0.0,0,0,0,0,0,0,0,1,0,0,1,1
3466,94154,sEtktPcVAhFQ7PqkOK3agQy8gf3suIv1,SpATywNh6bZuzm8s1ceuBUnMUAeoAHHw,17,38,2,17,1,8,5,4,75,10.714285714285714,4,0.0,4,2,15,1,34,8,2,5,4,22,53,0
3467,94229,dzvyuk189tsgDZIOFuacAzCgRiphRz5M,SpATywNh6bZuzm8s1ceuBUnMUAeoAHHw,7,6,3,0,1,0,2,0,12,1.7142857142857142,1,0.0,1,3,0,1,5,0,0,2,0,5,7,0
3468,94286,M8C9BDFICk4ida59GU0jjp556zazDEi1,A3fsA9Zfv1X2fVEQhTw51lKENdNrEqT3,8,5,3,0,0,0,5,0,13,1.8571428571428572,1,0.0,0,3,0,0,5,0,0,5,0,3,10,1
3469,94291,r2j4kmS3sSw2bBC6XtGVEzDG8uZSaMde,bWdj2GDclj5ofokWjzoa5jAwMkxCykd6,1,0,0,0,0,0,1,0,1,0.14285714285714285,1,0.0,0,0,0,0,0,0,0,1,0,0,1,1
3470,94294,M8C9BDFICk4ida59GU0jjp556zazDEi1,bWdj2GDclj5ofokWjzoa5jAwMkxCykd6,3,2,1,0,0,3,2,0,8,1.1428571428571428,1,0.0,0,1,0,0,2,3,0,2,0,1,7,1
3471,94318,VykAceZUulaqkCpokuW5Za4FHqwbjR1t,bWdj2GDclj5ofokWjzoa5jAwMkxCykd6,1,0,0,0,0,0,1,0,1,0.14285714285714285,1,0.0,0,0,0,0,0,0,0,1,0,0,1,1
3472,94360,Wx74KNuo9MEhjxtzU2HbTG4AbGSUPoBd,SpATywNh6bZuzm8s1ceuBUnMUAeoAHHw,6,7,3,0,1,0,2,0,13,1.8571428571428572,1,0.0,0,3,0,1,7,0,0,2,0,4,9,1
3473,94436,dgp1qm7PjXoVV4MjyzuvWetQrJ3T9kos,A3fsA9Zfv1X2fVEQhTw51lKENdNrEqT3,6,4,3,0,1,0,2,0,10,1.4285714285714286,1,0.0,0,3,0,1,4,0,0,2,0,4,6,1
3474,94473,KkeLwwXyUiCfeVvKPcarXSSK8DrECkDe,A3fsA9Zfv1X2fVEQhTw51lKENdNrEqT3,4,3,2,0,0,0,1,0,6,0.8571428571428571,1,0.0,0,2,0,0,3,0,0,1,0,2,4,1
3475,94925,PF30Vqy17JIy50CbxBzrrEB7UvSbzYk3,fbPkOYLVPtPgIt0MxizjfFJov3JbHyAi,1,0,0,0,0,0,1,0,1,0.14285714285714285,1,0.0,0,0,0,0,0,0,0,1,0,0,1,1
3476,95621,nH3NRDQLecB3hMbOpaitsdqKrlyEIXGh,SpATywNh6bZuzm8s1ceuBUnMUAeoAHHw,7,7,4,0,1,0,1,0,13,1.8571428571428572,1,0.0,2,4,0,1,5,0,0,1,0,7,6,0
3477,95841,AEeLy9n4nUl6UlG8WfSP7Q5sqAzFdtaD,A3fsA9Zfv1X2fVEQhTw51lKENdNrEqT3,7,3,3,0,3,0,0,0,9,1.2857142857142858,1,0.0,0,3,0,3,3,0,0,0,0,6,3,0
3478,95914,rTLMEQB78zn1g6bt6KRypanGZ8QWPbQv,A3fsA9Zfv1X2fVEQhTw51lKENdNrEqT3,22,15,2,74,1,6,4,0,102,14.571428571428571,2,0.0,2,2,60,1,13,6,14,4,0,65,37,0
3479,96114,XYKEbaRABcMuBHmMB2I3YkBepzCp0swB,A3fsA9Zfv1X2fVEQhTw51lKENdNrEqT3,10,8,1,10,0,14,2,0,35,5.0,1,0.0,0,1,8,0,8,14,2,2,0,9,26,1
3480,96140,QTgmoEmFx7yveY8D3dDCUQU4BnndurNn,RXDvfPUBYFlVdlueBFbLW0mhhAyGEqpt,15,25,15,6,43,0,2,0,91,13.0,3,0.0,1,15,6,43,24,0,0,2,0,65,26,0
3481,96720,nyH7Jx4kN1AdDJdwkZQoUDqYoovHgbk5,SpATywNh6bZuzm8s1ceuBUnMUAeoAHHw,13,10,5,16,1,0,1,0,33,4.714285714285714,1,0.0,4,5,15,1,6,0,1,1,0,25,8,1
3482,96818,ULdF32fTmMpV957Ngz6P80D0kuxYFb2A,SpATywNh6bZuzm8s1ceuBUnMUAeoAHHw,5,2,1,0,0,0,7,0,10,1.4285714285714286,2,0.0,0,1,0,0,2,0,0,7,0,1,9,0
3483,96932,RdNoFjcCRsxTOOSC7N4ELIdxTaySGrVr,SpATywNh6bZuzm8s1ceuBUnMUAeoAHHw,27,34,14,26,7,3,4,0,88,12.571428571428571,2,0.0,16,14,26,7,18,3,0,4,0,63,25,0
3484,96981,lWM0T55BVqig0BJS7dua8PmdCMELT35Y,SpATywNh6bZuzm8s1ceuBUnMUAeoAHHw,6,7,2,0,1,0,3,0,13,1.8571428571428572,1,0.0,0,2,0,1,7,0,0,3,0,3,10,0
3485,97065,M2tv4JvKfiiNHzXtHrilXY5dpWpYAsaI,7GRhBDsirIGkRZBtSMEzNTyDr2JQm4xx,31,42,20,52,10,5,12,2,143,20.428571428571427,1,0.0,19,20,46,10,23,5,6,12,2,95,48,1
3486,97117,c8WJAdYLV71mOx4ZXSglpCNd0dBUR3Om,7GRhBDsirIGkRZBtSMEzNTyDr2JQm4xx,22,14,5,24,3,0,1,0,47,6.714285714285714,1,0.0,8,5,24,3,6,0,0,1,0,40,7,0
3487,97214,9HiOT9GgvrP1q1oAqpQLpBir7zKJrsoX,A3fsA9Zfv1X2fVEQhTw51lKENdNrEqT3,4,4,3,0,0,0,1,0,8,1.1428571428571428,1,0.0,0,3,0,0,4,0,0,1,0,3,5,0
3488,97263,7xpmz6LF4dl35fFKZgRU70OZyF8UO4PL,A3fsA9Zfv1X2fVEQhTw51lKENdNrEqT3,11,11,5,0,7,0,2,0,25,3.5714285714285716,1,0.0,1,5,0,7,10,0,0,2,0,13,12,0
3489,97345,PUW0i4IuafllkJEtV0GCqmTDeLHkDmH3,7GRhBDsirIGkRZBtSMEzNTyDr2JQm4xx,24,21,7,39,2,0,2,0,71,10.142857142857142,1,0.0,13,7,39,2,8,0,0,2,0,61,10,0
3490,97428,92TVODkqWtTMaGGihgBsUR7wsg2cHNWw,A3fsA9Zfv1X2fVEQhTw51lKENdNrEqT3,1,0,0,0,0,0,1,0,1,0.14285714285714285,1,0.0,0,0,0,0,0,0,0,1,0,0,1,1
3491,97503,kuZwBvEdgeUtKZ495C2FptBbxEtLtmVH,A3fsA9Zfv1X2fVEQhTw51lKENdNrEqT3,23,18,10,72,1,0,3,0,104,14.857142857142858,3,0.0,1,10,64,1,17,0,8,3,0,76,28,0
3492,99029,qg6GOCuPcDwehPMMAEed7GZuAdyiaV9B,bWdj2GDclj5ofokWjzoa5jAwMkxCykd6,16,39,2,20,4,3,12,2,82,11.714285714285714,4,0.0,15,2,17,4,24,3,3,12,2,38,44,0
3493,99058,84jM92o4oluSWHz68fjJdNU1O5aejzX8,G8EPVSXsOYB5YQWZGiz1aVq5Pgr2GrQu,29,25,6,46,3,0,7,0,87,12.428571428571429,4,0.0,0,6,43,3,25,0,3,7,0,52,35,0
3494,99070,9e5dcfJQbPUU8sTcmzE9DWoDPOA9Nhu3,RXDvfPUBYFlVdlueBFbLW0mhhAyGEqpt,3,2,0,0,0,0,1,0,3,0.42857142857142855,1,0.0,0,0,0,0,2,0,0,1,0,0,3,0
3495,99100,ZMTgNYkbfDsBe4X8ZM8wJYJMTUYSz0bl,SpATywNh6bZuzm8s1ceuBUnMUAeoAHHw,12,22,0,8,0,0,1,0,31,4.428571428571429,1,0.0,8,0,8,0,14,0,0,1,0,16,15,1
3496,99209,cKCzrCCCXe9nkBgWepq9AEXje7SITRTz,RXDvfPUBYFlVdlueBFbLW0mhhAyGEqpt,1,0,0,0,0,0,1,0,1,0.14285714285714285,1,0.0,0,0,0,0,0,0,0,1,0,0,1,1
3497,99271,Pe5w2Jkb1gsjqOIYHp7FZfmU0KM6bSQ8,SpATywNh6bZuzm8s1ceuBUnMUAeoAHHw,9,4,1,10,0,0,4,0,19,2.7142857142857144,1,0.0,2,1,10,0,2,0,0,4,0,13,6,1
3498,99324,zZiKahy0aUh5eIyH06AprK07k6t9S0px,SpATywNh6bZuzm8s1ceuBUnMUAeoAHHw,3,2,0,0,0,0,1,0,3,0.42857142857142855,1,0.0,0,0,0,0,2,0,0,1,0,0,3,1
3499,99344,JbEjxQ5AsXJ2R3WBH2hwFnQgUiz9YCm1,RXDvfPUBYFlVdlueBFbLW0mhhAyGEqpt,5,8,1,0,0,0,2,0,11,1.5714285714285714,2,0.0,2,1,0,0,6,0,0,2,0,3,8,0
3500,99548,hbUthRcRktel8CTk5FJE2GFw0tsGaPJX,SpATywNh6bZuzm8s1ceuBUnMUAeoAHHw,4,3,0,0,0,0,1,0,4,0.5714285714285714,1,0.0,0,0,0,0,3,0,0,1,0,0,4,1
3501,99653,2ENDZhPlfPQ7xqwHjrfLuuWg5Duw7ZBj,SpATywNh6bZuzm8s1ceuBUnMUAeoAHHw,13,12,6,4,4,0,1,0,27,3.857142857142857,1,0.0,1,6,4,4,11,0,0,1,0,15,12,0
3502,99752,v8s2hAX8tQgFD6i9MrUt2cuWPYPq3DuN,G8EPVSXsOYB5YQWZGiz1aVq5Pgr2GrQu,3,4,2,0,0,0,2,0,8,1.1428571428571428,1,0.0,0,2,0,0,4,0,0,2,0,2,6,0
3503,99839,TdfXOtlNb7Av3MtzwkldFOrTHIZeitdz,SpATywNh6bZuzm8s1ceuBUnMUAeoAHHw,7,9,3,3,0,0,3,0,18,2.5714285714285716,1,0.0,1,3,3,0,8,0,0,3,0,7,11,0
3504,100028,AMKNyvONM5p8NpA87JkQdxEGdnEv8UBc,SpATywNh6bZuzm8s1ceuBUnMUAeoAHHw,3,2,1,0,0,0,1,0,4,0.5714285714285714,1,0.0,0,1,0,0,2,0,0,1,0,1,3,1
3505,100141,OMeQBd65CGlFdF9LPjtleDAWNG4SlWp3,SpATywNh6bZuzm8s1ceuBUnMUAeoAHHw,16,20,14,0,5,0,3,0,42,6.0,1,0.0,0,14,0,5,20,0,0,3,0,19,23,1
3506,100599,2sNFZBlVAcN0C3ozIX9ouOQIe9XjJNO6,RXDvfPUBYFlVdlueBFbLW0mhhAyGEqpt,1,0,0,0,0,0,1,0,1,0.14285714285714285,1,0.0,0,0,0,0,0,0,0,1,0,0,1,1
3507,100614,qeHXe8DRkB9urr63HS1yAMwTxQkwIbff,RXDvfPUBYFlVdlueBFbLW0mhhAyGEqpt,16,15,1,0,1,0,4,7,28,4.0,2,0.0,2,1,0,1,13,0,0,4,7,4,24,1
3508,100779,Qi3PLuC7w2Yo9hFgq37MObjY8icnRdc6,bWdj2GDclj5ofokWjzoa5jAwMkxCykd6,23,49,23,34,8,23,5,0,142,20.285714285714285,2,0.0,10,23,27,8,39,23,7,5,0,68,74,1
3509,100990,CnuwKGLCLbXYnPgy82VEWYA1NOiOhvr0,SpATywNh6bZuzm8s1ceuBUnMUAeoAHHw,1,0,0,0,0,0,1,0,1,0.14285714285714285,1,0.0,0,0,0,0,0,0,0,1,0,0,1,0
3510,100997,coZTr10eytnE55me2AxqRWq6qrVXEB7M,SpATywNh6bZuzm8s1ceuBUnMUAeoAHHw,20,19,14,8,5,0,6,0,52,7.428571428571429,2,0.0,2,14,8,5,17,0,0,6,0,29,23,1
3511,101024,WSII4CAtuXXVd816MewodzGLKdBCCfc2,SpATywNh6bZuzm8s1ceuBUnMUAeoAHHw,18,36,11,0,5,0,13,0,65,9.285714285714286,2,0.0,2,11,0,5,34,0,0,13,0,18,47,0
3512,101152,7B5rcRMuJ6A1xAdnnIVDusvPjMkwnC77,bWdj2GDclj5ofokWjzoa5jAwMkxCykd6,26,28,0,62,1,4,9,1,105,15.0,2,0.0,6,0,55,1,22,4,7,9,1,62,43,1
3513,101178,uAXW7zeSaEEtMIdMcVsYpUquscAKUnr7,bWdj2GDclj5ofokWjzoa5jAwMkxCykd6,1,0,0,0,0,0,1,0,1,0.14285714285714285,1,0.0,0,0,0,0,0,0,0,1,0,0,1,1
3514,102868,eGy9PbpiLJ8MX3YMIjoO70TYhFvF8s3p,SpATywNh6bZuzm8s1ceuBUnMUAeoAHHw,6,2,1,0,1,2,3,1,10,1.4285714285714286,1,0.0,0,1,0,1,2,2,0,3,1,2,8,1
3515,102871,j91nMgV3K6rtEcjFaPoRw8ZzxTKSNRyI,A3fsA9Zfv1X2fVEQhTw51lKENdNrEqT3,12,6,5,0,5,0,1,0,17,2.4285714285714284,1,0.0,0,5,0,5,6,0,0,1,0,10,7,1
3516,102874,ovOrxCTVGxQyC9labPGJ3gKHEzv9s9aZ,A3fsA9Zfv1X2fVEQhTw51lKENdNrEqT3,1,0,0,0,0,0,1,0,1,0.14285714285714285,1,0.0,0,0,0,0,0,0,0,1,0,0,1,1
3517,102890,QBgKSCSCtuy3kameVOAw6Wwz0K2iKBbH,G8EPVSXsOYB5YQWZGiz1aVq5Pgr2GrQu,10,11,5,0,4,0,3,0,23,3.2857142857142856,1,0.0,0,5,0,4,11,0,0,3,0,9,14,1
3518,102893,c5JhVDkXO4Xl1o4x0X5wpbuFHZccHbBn,SpATywNh6bZuzm8s1ceuBUnMUAeoAHHw,1,0,0,0,0,0,1,0,1,0.14285714285714285,1,0.0,0,0,0,0,0,0,0,1,0,0,1,1
3519,102894,2cEDKyYGVPkvyTHRF0ybKZjw6PISqB33,SpATywNh6bZuzm8s1ceuBUnMUAeoAHHw,8,1,1,0,1,0,5,6,14,2.0,1,0.0,0,1,0,1,1,0,0,5,6,2,12,1
3520,102905,s6iksgptFmyh2vfiarKdJkiKnp6RLi3f,A3fsA9Zfv1X2fVEQhTw51lKENdNrEqT3,3,0,0,0,0,8,3,0,11,1.5714285714285714,1,0.0,0,0,0,0,0,8,0,3,0,0,11,0
3521,102911,YbWp9q0RRrBwQyXxgLzRZdIoNM6EmpNj,A3fsA9Zfv1X2fVEQhTw51lKENdNrEqT3,2,0,0,0,0,0,3,0,3,0.42857142857142855,1,0.0,0,0,0,0,0,0,0,3,0,0,3,1
3522,102912,34XPBSlARSAdEabwWriA5XSSURJsqF6Q,bWdj2GDclj5ofokWjzoa5jAwMkxCykd6,5,2,1,0,1,0,2,0,6,0.8571428571428571,1,0.0,0,1,0,1,2,0,0,2,0,2,4,1
3523,102927,wpXUynmsiSu4GN2ibkxsqCGp9o4mfy5I,bWdj2GDclj5ofokWjzoa5jAwMkxCykd6,16,18,5,10,6,0,6,0,45,6.428571428571429,1,0.0,8,5,9,6,10,0,1,6,0,28,17,1
3524,102943,Gkxx7PBptGwgdrd4W0pkw1awMXPiihSA,SpATywNh6bZuzm8s1ceuBUnMUAeoAHHw,6,5,1,0,1,0,2,0,9,1.2857142857142858,1,0.0,0,1,0,1,5,0,0,2,0,2,7,1
3525,102944,23V5Y4dLt5dAp7zCNE7sBan2cormM1XH,SpATywNh6bZuzm8s1ceuBUnMUAeoAHHw,10,4,2,0,2,1,4,1,14,2.0,1,0.0,0,2,0,2,4,1,0,4,1,4,10,1
3526,102949,qqzld2DbTg8EBxOLVVgl3AZMKcPoFnE4,RXDvfPUBYFlVdlueBFbLW0mhhAyGEqpt,5,2,1,0,1,0,2,0,6,0.8571428571428571,1,0.0,0,1,0,1,2,0,0,2,0,2,4,1
3527,102952,F7KfRJPBsgtS0jdyt11WgvAWy4zhSMkM,A3fsA9Zfv1X2fVEQhTw51lKENdNrEqT3,1,0,0,0,0,0,1,0,1,0.14285714285714285,1,0.0,0,0,0,0,0,0,0,1,0,0,1,1
3528,102963,1uu9vv80QLeZErtdx0I8CPsrCRhlMRmo,RXDvfPUBYFlVdlueBFbLW0mhhAyGEqpt,6,2,1,0,1,0,3,0,7,1.0,1,0.0,0,1,0,1,2,0,0,3,0,2,5,1
3529,102964,pNiUFQveXjumuZsJcsFdYJDy5O0Fbp3m,G8EPVSXsOYB5YQWZGiz1aVq5Pgr2GrQu,5,2,1,0,1,0,2,0,6,0.8571428571428571,1,0.0,0,1,0,1,2,0,0,2,0,2,4,0
3530,102974,l569pvTkqA1hwU8mlPA8zjV2SyK4a7w2,A3fsA9Zfv1X2fVEQhTw51lKENdNrEqT3,3,3,0,0,0,0,1,0,4,0.5714285714285714,1,0.0,0,0,0,0,3,0,0,1,0,0,4,0
3531,102975,DvNxKU9g5rp8dv94zJRF8Ah76URW61cr,SpATywNh6bZuzm8s1ceuBUnMUAeoAHHw,11,6,5,0,4,0,5,0,20,2.857142857142857,2,0.0,0,5,0,4,6,0,0,5,0,9,11,1
3532,102978,t3ySM4Gbs4aIhGFWYbt2nw6OG5oriaOF,A3fsA9Zfv1X2fVEQhTw51lKENdNrEqT3,8,7,2,0,1,0,2,0,12,1.7142857142857142,1,0.0,0,2,0,1,7,0,0,2,0,3,9,1
3533,102980,uD8Spqeq0tcI9O6lX7gMmMVhDE2HC0Al,SpATywNh6bZuzm8s1ceuBUnMUAeoAHHw,1,0,0,0,0,0,1,0,1,0.14285714285714285,1,0.0,0,0,0,0,0,0,0,1,0,0,1,1
3534,102993,BxKAgVcecbK566xlIeUHElTAEVt3GzGl,bWdj2GDclj5ofokWjzoa5jAwMkxCykd6,1,0,0,0,0,0,1,0,1,0.14285714285714285,1,0.0,0,0,0,0,0,0,0,1,0,0,1,1
3535,102999,9WjmBPp7tHUxJcX9cD1TMvtq8VTyCZtX,SpATywNh6bZuzm8s1ceuBUnMUAeoAHHw,8,6,5,0,5,0,1,0,17,2.4285714285714284,1,0.0,0,5,0,5,6,0,0,1,0,10,7,1
3536,103025,l6kshSYgIFjkBtVOYi7kIq0LGbdGcRje,A3fsA9Zfv1X2fVEQhTw51lKENdNrEqT3,2,0,0,0,0,0,3,0,3,0.42857142857142855,1,0.0,0,0,0,0,0,0,0,3,0,0,3,1
3537,103038,TGrjsRoxwzZ35wp3zciCPp8r5aOpBmZm,SpATywNh6bZuzm8s1ceuBUnMUAeoAHHw,1,0,0,0,0,0,1,0,1,0.14285714285714285,1,0.0,0,0,0,0,0,0,0,1,0,0,1,1
3538,103075,8hmY23T5sCq9C2hlUNLSrX2yqFt52Pgt,RXDvfPUBYFlVdlueBFbLW0mhhAyGEqpt,7,3,2,0,2,0,2,0,9,1.2857142857142858,1,0.0,0,2,0,2,3,0,0,2,0,4,5,1
3539,103089,Sd54wuYLJGE9pQgAE1cFvsQCM2O9iNXw,bWdj2GDclj5ofokWjzoa5jAwMkxCykd6,5,2,1,0,1,0,2,0,6,0.8571428571428571,1,0.0,0,1,0,1,2,0,0,2,0,2,4,1
3540,103104,JXOo8fki25FPq0plM7J4NKpdKtv8nAso,A3fsA9Zfv1X2fVEQhTw51lKENdNrEqT3,1,0,0,0,0,0,1,0,1,0.14285714285714285,1,0.0,0,0,0,0,0,0,0,1,0,0,1,1
3541,103120,UFSjkDLycCAe1fUAiyo92id2TiybbTZT,SpATywNh6bZuzm8s1ceuBUnMUAeoAHHw,1,0,0,0,0,0,1,0,1,0.14285714285714285,1,0.0,0,0,0,0,0,0,0,1,0,0,1,1
3542,103134,PeVPWFtqmyzNVNGrKsrCqRCUp0alyzHv,SpATywNh6bZuzm8s1ceuBUnMUAeoAHHw,1,0,0,0,0,0,1,0,1,0.14285714285714285,1,0.0,0,0,0,0,0,0,0,1,0,0,1,1
3543,103157,8IuzZOXaXVUql9pLZtNuJIyLoDJ8ZL4V,A3fsA9Zfv1X2fVEQhTw51lKENdNrEqT3,3,2,1,0,0,0,2,0,5,0.7142857142857143,1,0.0,0,1,0,0,2,0,0,2,0,1,4,1
3544,103175,pta6TaYSQ4VWeJjoWzSVUA5Zasc1vOWe,SpATywNh6bZuzm8s1ceuBUnMUAeoAHHw,1,0,0,0,0,0,1,0,1,0.14285714285714285,1,0.0,0,0,0,0,0,0,0,1,0,0,1,1
3545,103198,lUbIMCaPWDbgwiRy3ym2mDRgVr1wLki4,SpATywNh6bZuzm8s1ceuBUnMUAeoAHHw,11,8,1,0,1,0,2,0,12,1.7142857142857142,1,0.0,0,1,0,1,8,0,0,2,0,2,10,1
3546,103224,TINvhk9VLXQ3D49XU1y8baDw0NlbVtwm,G8EPVSXsOYB5YQWZGiz1aVq5Pgr2GrQu,4,2,1,0,1,0,1,0,5,0.7142857142857143,1,0.0,0,1,0,1,2,0,0,1,0,2,3,1
3547,103258,FBzPXWPyPigVHlzVcgyn2CNx30l85SaP,RXDvfPUBYFlVdlueBFbLW0mhhAyGEqpt,9,13,1,0,0,0,4,0,18,2.5714285714285716,2,0.0,5,1,0,0,8,0,0,4,0,6,12,0
3548,103271,DPNeCmHDELHrss8mkRKEcvkApu8OfWuh,G8EPVSXsOYB5YQWZGiz1aVq5Pgr2GrQu,19,10,8,0,6,1,12,1,38,5.428571428571429,1,0.0,0,8,0,6,10,1,0,12,1,14,24,0
3549,103283,XDwcqxWI4I9CO2vb10lgpVeZsspXXaL1,SpATywNh6bZuzm8s1ceuBUnMUAeoAHHw,1,0,0,0,0,0,1,0,1,0.14285714285714285,1,0.0,0,0,0,0,0,0,0,1,0,0,1,1
3550,103303,0Yuzh7q9awy4giTrLKNAtc9FYnhCvFKA,SpATywNh6bZuzm8s1ceuBUnMUAeoAHHw,4,9,2,0,0,0,1,0,12,1.7142857142857142,1,0.0,6,2,0,0,3,0,0,1,0,8,4,1
3551,103314,DPNeCmHDELHrss8mkRKEcvkApu8OfWuh,SpATywNh6bZuzm8s1ceuBUnMUAeoAHHw,1,0,0,0,0,0,1,0,1,0.14285714285714285,1,0.0,0,0,0,0,0,0,0,1,0,0,1,1
3552,103326,1Gr28fGQi0AhhBsOfiHtkCfOBAY8S9VF,bWdj2GDclj5ofokWjzoa5jAwMkxCykd6,5,3,1,0,1,0,2,0,7,1.0,1,0.0,0,1,0,1,3,0,0,2,0,2,5,1
3553,103339,D2lFXeOodglgSTRNVccRvVrNvHlYgfLJ,bWdj2GDclj5ofokWjzoa5jAwMkxCykd6,1,0,0,0,0,0,1,0,1,0.14285714285714285,1,0.0,0,0,0,0,0,0,0,1,0,0,1,1
3554,103347,hNJz0qbOhrUgajUkzqSdDbybHkuRglfs,SpATywNh6bZuzm8s1ceuBUnMUAeoAHHw,3,4,2,0,0,0,3,0,9,1.2857142857142858,3,0.0,0,2,0,0,4,0,0,3,0,2,7,0
3555,103363,Cd9PhUepdZFgXcqgJFSSyoIXTR4PezW8,SpATywNh6bZuzm8s1ceuBUnMUAeoAHHw,7,3,2,0,1,12,3,1,22,3.142857142857143,1,0.0,0,2,0,1,3,12,0,3,1,3,19,1
3556,103397,vuxD2zMfzfccChKnwKAggsxPZbOiZaTb,RXDvfPUBYFlVdlueBFbLW0mhhAyGEqpt,5,0,0,0,0,1,5,2,8,1.1428571428571428,1,0.0,0,0,0,0,0,1,0,5,2,0,8,1
3557,103413,YJBz2hu0xpzNzWrBf0qrKIvgi0aKng9X,SpATywNh6bZuzm8s1ceuBUnMUAeoAHHw,1,0,0,0,0,0,1,0,1,0.14285714285714285,1,0.0,0,0,0,0,0,0,0,1,0,0,1,1
3558,103417,0sAOKVns8BSkUL9PacRKzX0uoHgRzVTD,SpATywNh6bZuzm8s1ceuBUnMUAeoAHHw,9,5,0,0,0,1,8,1,15,2.142857142857143,1,0.0,0,0,0,0,5,1,0,8,1,0,15,1
3559,103438,A7splZdp3CZV6tKUIRVHnnLOftJO8UXC,A3fsA9Zfv1X2fVEQhTw51lKENdNrEqT3,7,10,0,0,0,1,4,0,15,2.142857142857143,1,0.0,0,0,0,0,10,1,0,4,0,0,15,1
3560,103443,U3lhctDRAiyFJZP8fBSRJ5CxsYPJfYQW,SpATywNh6bZuzm8s1ceuBUnMUAeoAHHw,1,0,0,0,0,0,1,0,1,0.14285714285714285,1,0.0,0,0,0,0,0,0,0,1,0,0,1,1
3561,103445,YR1IgV2TtttHJ35h5NJxgcWKWfmLYszA,SpATywNh6bZuzm8s1ceuBUnMUAeoAHHw,6,4,3,0,2,0,0,0,9,1.2857142857142858,1,0.0,0,3,0,2,4,0,0,0,0,5,4,0
3562,103451,74Dywe4dn2al60hXONYhqNpcRQDf18AP,RXDvfPUBYFlVdlueBFbLW0mhhAyGEqpt,9,6,5,0,2,0,1,0,14,2.0,1,0.0,0,5,0,2,6,0,0,1,0,7,7,1
3563,103453,0ClPvfgZ3teF26LrMInT4RNIPntzqSzr,SpATywNh6bZuzm8s1ceuBUnMUAeoAHHw,4,2,1,0,1,0,1,0,5,0.7142857142857143,1,0.0,0,1,0,1,2,0,0,1,0,2,3,0
3564,103454,Fl2rv0GIrb1pZGPCAVV4X3WnsKhjbfP2,bWdj2GDclj5ofokWjzoa5jAwMkxCykd6,8,5,2,0,3,0,5,0,15,2.142857142857143,2,0.0,2,2,0,3,3,0,0,5,0,7,8,1
3565,103456,uAXW7zeSaEEtMIdMcVsYpUquscAKUnr7,A3fsA9Zfv1X2fVEQhTw51lKENdNrEqT3,6,2,1,0,1,0,6,0,10,1.4285714285714286,1,0.0,0,1,0,1,2,0,0,6,0,2,8,0
3566,103457,XvNNzv39b8VqKid0q4fV9ms2wVNAdWks,bWdj2GDclj5ofokWjzoa5jAwMkxCykd6,21,27,12,50,0,0,14,0,103,14.714285714285714,3,0.0,2,12,46,0,25,0,4,14,0,60,43,0
3567,103479,ZdJ1BYcCBDVkoF1RDWOaW7qs4fUuQvAO,SpATywNh6bZuzm8s1ceuBUnMUAeoAHHw,17,23,9,8,2,2,9,1,54,7.714285714285714,1,0.0,9,9,7,2,14,2,1,9,1,27,27,0
3568,103502,Cp2BbG4q7QXu1vAJ8MUQKIeyJJyHFg2f,G8EPVSXsOYB5YQWZGiz1aVq5Pgr2GrQu,1,0,0,0,0,0,1,0,1,0.14285714285714285,1,0.0,0,0,0,0,0,0,0,1,0,0,1,1
3569,103504,OM0KD57nHAa4Wr8wJ1ilvxhef5Muhj8p,A3fsA9Zfv1X2fVEQhTw51lKENdNrEqT3,21,19,0,0,0,0,2,0,21,3.0,1,0.0,0,0,0,0,19,0,0,2,0,0,21,1
3570,103509,DhyvKgcTrgxrQOa9DadKHClSdCqlYrTj,SpATywNh6bZuzm8s1ceuBUnMUAeoAHHw,1,0,0,0,0,0,1,0,1,0.14285714285714285,1,0.0,0,0,0,0,0,0,0,1,0,0,1,1
3571,103534,YEF0QYiQE86qWLJG6v6QSOKqWyf11mYZ,SpATywNh6bZuzm8s1ceuBUnMUAeoAHHw,9,5,2,0,1,1,7,1,17,2.4285714285714284,1,0.0,0,2,0,1,5,1,0,7,1,3,14,1
3572,103557,vPv7PsanhRceiGshTPXtgrOmcrOEYM8O,RXDvfPUBYFlVdlueBFbLW0mhhAyGEqpt,10,5,5,0,3,0,3,1,17,2.4285714285714284,1,0.0,0,5,0,3,5,0,0,3,1,8,9,1
3573,103566,OSDu5tMGaniTUgLVQTpKE1MEiHaSe3gW,A3fsA9Zfv1X2fVEQhTw51lKENdNrEqT3,3,2,1,0,0,0,1,0,4,0.5714285714285714,1,0.0,0,1,0,0,2,0,0,1,0,1,3,1
3574,103581,QYxvxdCf3BqEP6mnoIkBRIai2RDjDRx6,SpATywNh6bZuzm8s1ceuBUnMUAeoAHHw,4,6,1,0,0,0,2,0,9,1.2857142857142858,1,0.0,3,1,0,0,3,0,0,2,0,4,5,1
3575,103600,5ZyvCd3AP7a8azCiLN5JfLAP53iZpAyD,RXDvfPUBYFlVdlueBFbLW0mhhAyGEqpt,1,0,0,0,0,0,1,0,1,0.14285714285714285,1,0.0,0,0,0,0,0,0,0,1,0,0,1,1
3576,103643,02x1393HfdHWlTjjnIgsA4Mhbk6lI383,SpATywNh6bZuzm8s1ceuBUnMUAeoAHHw,6,2,1,0,1,0,3,0,7,1.0,1,0.0,0,1,0,1,2,0,0,3,0,2,5,0
3577,103651,xzqF2LiZ7Zp1COlqOBger1kuvNL9t5JK,A3fsA9Zfv1X2fVEQhTw51lKENdNrEqT3,26,19,3,30,1,0,6,0,59,8.428571428571429,2,0.0,0,3,27,1,19,0,3,6,0,31,28,1
3578,103661,Z5Gd8RjsJSljoHUoBd3hvIVNy4VKuGq0,SpATywNh6bZuzm8s1ceuBUnMUAeoAHHw,4,3,2,0,0,0,1,0,6,0.8571428571428571,1,0.0,0,2,0,0,3,0,0,1,0,2,4,0
3579,103666,6TVAbHzle9P1EfKyH9hEoMksSxlp6T76,SpATywNh6bZuzm8s1ceuBUnMUAeoAHHw,22,18,14,10,11,0,5,0,58,8.285714285714286,2,0.0,1,14,9,11,17,0,1,5,0,35,23,1
3580,103668,p9NcQP74LARrulF6JzGeab5yk6ciJM9V,SpATywNh6bZuzm8s1ceuBUnMUAeoAHHw,3,2,0,0,0,0,1,0,3,0.42857142857142855,1,0.0,0,0,0,0,2,0,0,1,0,0,3,0
3581,103682,gMeZHtHbmrRB8drlaFHRYNGQ6Z4lgho8,bWdj2GDclj5ofokWjzoa5jAwMkxCykd6,1,0,0,0,0,0,1,0,1,0.14285714285714285,1,0.0,0,0,0,0,0,0,0,1,0,0,1,1
3582,103690,4GnibPWQ8lJjDFqzggHzR1fwcHUGxpIS,A3fsA9Zfv1X2fVEQhTw51lKENdNrEqT3,40,16,11,86,9,0,3,0,125,17.857142857142858,1,0.0,4,11,72,9,12,0,14,3,0,96,29,1
3583,103692,lQ2haPSIRb6ySD072MeaIkhUrCYHIGKE,A3fsA9Zfv1X2fVEQhTw51lKENdNrEqT3,7,4,1,0,1,0,3,0,9,1.2857142857142858,1,0.0,0,1,0,1,4,0,0,3,0,2,7,1
3584,103730,yYnx2Djc2xdWmysqfYS5LaytJ644aZht,G8EPVSXsOYB5YQWZGiz1aVq5Pgr2GrQu,4,3,2,0,0,0,2,0,7,1.0,1,0.0,0,2,0,0,3,0,0,2,0,2,5,0
3585,103737,ANBM6p9EaEI4Seaj9IaAoVJfXZGQglbd,bWdj2GDclj5ofokWjzoa5jAwMkxCykd6,4,2,0,0,0,0,5,0,7,1.0,1,0.0,0,0,0,0,2,0,0,5,0,0,7,1
3586,103746,rJa06nlcyBimvgL7PoPXhuOUbmR9mddR,SpATywNh6bZuzm8s1ceuBUnMUAeoAHHw,17,16,9,12,5,0,3,0,45,6.428571428571429,2,0.0,5,9,12,5,11,0,0,3,0,31,14,1
3587,103753,4wd4ZPQBIu7cqe3jxupr4Gm26uh0zMx7,A3fsA9Zfv1X2fVEQhTw51lKENdNrEqT3,9,3,2,0,2,5,13,1,26,3.7142857142857144,1,0.0,0,2,0,2,3,5,0,13,1,4,22,1
3588,103794,x29OOChdmJGXK62DnUpwKbwJurqULmnD,SpATywNh6bZuzm8s1ceuBUnMUAeoAHHw,16,19,12,0,8,0,2,0,41,5.857142857142857,1,0.0,4,12,0,8,15,0,0,2,0,24,17,1
3589,103837,nSjkfSPbC0LXqtynr3m9X0CV4GIunTid,G8EPVSXsOYB5YQWZGiz1aVq5Pgr2GrQu,5,2,1,0,1,0,2,0,6,0.8571428571428571,1,0.0,0,1,0,1,2,0,0,2,0,2,4,1
3590,103847,i4SeHiwnbIIoq9LoP3weAeDXl7e5RBtg,A3fsA9Zfv1X2fVEQhTw51lKENdNrEqT3,2,0,0,0,0,0,3,0,3,0.42857142857142855,1,0.0,0,0,0,0,0,0,0,3,0,0,3,1
3591,103849,9poFqdhDn1jEwJp6tGIQlD3gMA14zAqO,SpATywNh6bZuzm8s1ceuBUnMUAeoAHHw,3,2,1,0,0,0,1,0,4,0.5714285714285714,1,0.0,0,1,0,0,2,0,0,1,0,1,3,1
3592,103865,WuuGUCveHVXII42bEeLxc9ae8hzxCCU9,SpATywNh6bZuzm8s1ceuBUnMUAeoAHHw,4,4,0,0,0,1,3,0,8,1.1428571428571428,1,0.0,0,0,0,0,4,1,0,3,0,0,8,1
3593,103875,XmievsUMm7pYjS9V5usB7AjkzDHh9x5X,SpATywNh6bZuzm8s1ceuBUnMUAeoAHHw,5,2,1,0,1,0,2,0,6,0.8571428571428571,1,0.0,0,1,0,1,2,0,0,2,0,2,4,1
3594,103881,JNia6gKvSZOSZQHrR3Kro8PKF3m40Fop,A3fsA9Zfv1X2fVEQhTw51lKENdNrEqT3,1,0,0,0,0,0,1,0,1,0.14285714285714285,1,0.0,0,0,0,0,0,0,0,1,0,0,1,1
3595,103884,PGaKSLZzbsk1Y4PL9tj5XLuPkFqOZE5w,SpATywNh6bZuzm8s1ceuBUnMUAeoAHHw,2,0,0,0,0,0,2,0,2,0.2857142857142857,1,0.0,0,0,0,0,0,0,0,2,0,0,2,0
3596,103894,RS2Yi11w0LQ7fKvpNddEmwppsyvf2NcO,SpATywNh6bZuzm8s1ceuBUnMUAeoAHHw,14,8,6,0,5,0,5,1,25,3.5714285714285716,1,0.0,0,6,0,5,8,0,0,5,1,11,14,1
3597,103896,D5E2Qt7jBeIZBIFcDabwhaaXeayXbs8U,A3fsA9Zfv1X2fVEQhTw51lKENdNrEqT3,2,0,0,0,0,0,2,0,2,0.2857142857142857,1,0.0,0,0,0,0,0,0,0,2,0,0,2,1
3598,103912,923Md4hufFSw6fyqcrCqvjLKbertSNtk,A3fsA9Zfv1X2fVEQhTw51lKENdNrEqT3,2,0,0,0,0,0,2,0,2,0.2857142857142857,1,0.0,0,0,0,0,0,0,0,2,0,0,2,1
3599,103930,Txv4UTCXPzwxfIDD6g3LwRLt3kYLBXuk,SpATywNh6bZuzm8s1ceuBUnMUAeoAHHw,1,0,0,0,0,0,2,0,2,0.2857142857142857,2,0.0,0,0,0,0,0,0,0,2,0,0,2,0
3600,103942,JsgxGxJYDhwgnBgYbCILUrGTg0zFV4WJ,A3fsA9Zfv1X2fVEQhTw51lKENdNrEqT3,5,2,1,0,1,0,2,0,6,0.8571428571428571,1,0.0,0,1,0,1,2,0,0,2,0,2,4,1
3601,103953,IAJw4YtfScJYA1rvh3QXP9oI1WE1l0cK,SpATywNh6bZuzm8s1ceuBUnMUAeoAHHw,1,0,0,0,0,0,1,0,1,0.14285714285714285,1,0.0,0,0,0,0,0,0,0,1,0,0,1,1
3602,103958,1twD6my472TWNbA8IiJP0V3NsZHRSKHs,SpATywNh6bZuzm8s1ceuBUnMUAeoAHHw,9,8,1,0,1,3,8,1,22,3.142857142857143,1,0.0,2,1,0,1,6,3,0,8,1,4,18,0
3603,103963,dCHgtAVwX12C1h73zUIzcSalawnmf1Ly,SpATywNh6bZuzm8s1ceuBUnMUAeoAHHw,1,0,0,0,0,0,1,0,1,0.14285714285714285,1,0.0,0,0,0,0,0,0,0,1,0,0,1,1
3604,103991,ov5fYk5qZ3Ni8oW2PufqBBemq0WW1ldD,SpATywNh6bZuzm8s1ceuBUnMUAeoAHHw,7,4,2,0,2,0,2,0,10,1.4285714285714286,1,0.0,1,2,0,2,3,0,0,2,0,5,5,1
3605,104001,ZD6t0gZaLreJsx23cvmpLJAxc5XEYPzo,G8EPVSXsOYB5YQWZGiz1aVq5Pgr2GrQu,9,6,1,0,1,0,3,0,11,1.5714285714285714,1,0.0,0,1,0,1,6,0,0,3,0,2,9,1
3606,104008,TfPlmQ2inId9ipwO1Tkp44zWAUy81HnS,A3fsA9Zfv1X2fVEQhTw51lKENdNrEqT3,2,0,0,0,0,0,2,0,2,0.2857142857142857,1,0.0,0,0,0,0,0,0,0,2,0,0,2,1
3607,104034,uGLBXaq2O6Oj4FwXgJgHiKB87ZAsGOij,RXDvfPUBYFlVdlueBFbLW0mhhAyGEqpt,7,3,2,0,2,0,2,0,9,1.2857142857142858,1,0.0,0,2,0,2,3,0,0,2,0,4,5,1
3608,104065,Mf49DzxpNroXZrZEzTyFS3opux1fUHZq,SpATywNh6bZuzm8s1ceuBUnMUAeoAHHw,4,2,1,0,1,0,1,0,5,0.7142857142857143,1,0.0,0,1,0,1,2,0,0,1,0,2,3,1
3609,104075,Jeb6HFnTv5BAeG7m0GpNhKDbGECtxEse,RXDvfPUBYFlVdlueBFbLW0mhhAyGEqpt,18,27,1,0,0,1,10,2,41,5.857142857142857,3,0.0,1,1,0,0,26,1,0,10,2,2,39,1
3610,104089,fGDhAQY2WhkQYcL5XaYeDMBiOUQEoTnX,bWdj2GDclj5ofokWjzoa5jAwMkxCykd6,19,11,6,86,5,0,5,0,113,16.142857142857142,2,0.0,3,6,77,5,8,0,9,5,0,91,22,1
3611,104091,Whrc7O8OYrwQtVL43oMCOWkRLnJ5RAnq,A3fsA9Zfv1X2fVEQhTw51lKENdNrEqT3,1,0,0,0,0,0,1,0,1,0.14285714285714285,1,0.0,0,0,0,0,0,0,0,1,0,0,1,1
3612,104095,YI86C9tMYiPNH60fwrrOqDqOHSDWv9QR,SpATywNh6bZuzm8s1ceuBUnMUAeoAHHw,5,2,1,0,1,0,2,0,6,0.8571428571428571,1,0.0,0,1,0,1,2,0,0,2,0,2,4,1
3613,104119,1aQoKDna73jstuOrupWa9Kq8V3FdvbRU,SpATywNh6bZuzm8s1ceuBUnMUAeoAHHw,1,0,0,0,0,0,1,0,1,0.14285714285714285,1,0.0,0,0,0,0,0,0,0,1,0,0,1,1
3614,104144,XFHjgUTOXGdMfDJPVsJ9fIgVszICPgyz,A3fsA9Zfv1X2fVEQhTw51lKENdNrEqT3,9,4,3,0,3,0,2,0,12,1.7142857142857142,1,0.0,0,3,0,3,4,0,0,2,0,6,6,1
3615,104157,3mm3mJxVS0eLh8IUtBxaLL8aknBAQjDa,bWdj2GDclj5ofokWjzoa5jAwMkxCykd6,1,0,0,0,0,0,1,0,1,0.14285714285714285,1,0.0,0,0,0,0,0,0,0,1,0,0,1,1
3616,104162,I8C35PB4HAz5bxjARemPN0YBdl9xTOvv,A3fsA9Zfv1X2fVEQhTw51lKENdNrEqT3,9,5,0,0,0,8,7,1,21,3.0,1,0.0,0,0,0,0,5,8,0,7,1,0,21,0
3617,104178,YTd6RUCxKSrzEOkqGgY5uphLrJJcaHu6,SpATywNh6bZuzm8s1ceuBUnMUAeoAHHw,4,3,0,0,0,0,1,0,4,0.5714285714285714,1,0.0,0,0,0,0,3,0,0,1,0,0,4,1
3618,104194,7EU7vMf2b4Xv6MdI3zbAqQNQTiRVSvYt,A3fsA9Zfv1X2fVEQhTw51lKENdNrEqT3,5,2,1,0,1,0,2,0,6,0.8571428571428571,1,0.0,0,1,0,1,2,0,0,2,0,2,4,1
3619,104211,t5GAapz2qu7QW3ZA52Mo1qG5gvWMLT4H,A3fsA9Zfv1X2fVEQhTw51lKENdNrEqT3,1,0,0,0,0,0,1,0,1,0.14285714285714285,1,0.0,0,0,0,0,0,0,0,1,0,0,1,1
3620,104219,r7mxDUU76gpRNfXXfJxT6UdxuWsIdonz,A3fsA9Zfv1X2fVEQhTw51lKENdNrEqT3,3,3,0,0,0,0,1,0,4,0.5714285714285714,1,0.0,1,0,0,0,2,0,0,1,0,1,3,1
3621,104241,ixafWGJcoRhCM5cJdtULfcNp2InCr2Sa,A3fsA9Zfv1X2fVEQhTw51lKENdNrEqT3,22,13,11,0,6,4,11,2,47,6.714285714285714,1,0.0,0,11,0,6,13,4,0,11,2,17,30,1
3622,104273,TldFKIBOCwaUWZkv8geqqO2kCXoWqpzq,SpATywNh6bZuzm8s1ceuBUnMUAeoAHHw,14,8,7,0,5,0,1,0,21,3.0,1,0.0,0,7,0,5,8,0,0,1,0,12,9,1
3623,104546,h2uPViUap57On5JUqQ9igq5GDP75Rgzf,SpATywNh6bZuzm8s1ceuBUnMUAeoAHHw,15,15,7,0,6,0,2,0,30,4.285714285714286,1,0.0,0,7,0,6,15,0,0,2,0,13,17,1
3624,104697,HlYiU2TA92it9HWOPDlsBmlpdZ7J7QTJ,A3fsA9Zfv1X2fVEQhTw51lKENdNrEqT3,4,3,2,0,0,0,1,0,6,0.8571428571428571,1,0.0,0,2,0,0,3,0,0,1,0,2,4,1
3625,105065,qhE0nq1HVP5Z55HX3UNFMVHvllKc96Rl,SpATywNh6bZuzm8s1ceuBUnMUAeoAHHw,5,5,1,0,0,0,1,0,7,1.0,1,0.0,0,1,0,0,5,0,0,1,0,1,6,1
3626,105153,qTzYx0lbBuxcg0Yki7msaMyOo4bFeb91,SpATywNh6bZuzm8s1ceuBUnMUAeoAHHw,1,0,0,0,0,0,1,0,1,0.14285714285714285,1,0.0,0,0,0,0,0,0,0,1,0,0,1,0
3627,105191,BFrfDseDfXCBvtTfCsJAy36Ogk6b0Rfx,G8EPVSXsOYB5YQWZGiz1aVq5Pgr2GrQu,3,2,1,0,0,0,1,0,4,0.5714285714285714,1,0.0,0,1,0,0,2,0,0,1,0,1,3,1
3628,105260,IK3mtf86eqab6u3Svud8svoyG25XbueY,SpATywNh6bZuzm8s1ceuBUnMUAeoAHHw,5,3,1,0,1,0,1,0,6,0.8571428571428571,1,0.0,0,1,0,1,3,0,0,1,0,2,4,1
3629,105331,Sk4DUKJRImF6lijTnkABuH01jDj9zcnP,bWdj2GDclj5ofokWjzoa5jAwMkxCykd6,3,3,2,0,0,2,3,0,10,1.4285714285714286,1,0.0,0,2,0,0,3,2,0,3,0,2,8,1
3630,105445,LdIFMEp4Gma3xMuOQ2mpp1BJ3jFvB9c2,bWdj2GDclj5ofokWjzoa5jAwMkxCykd6,14,12,7,46,0,0,3,0,68,9.714285714285714,3,0.0,0,7,37,0,12,0,9,3,0,44,24,0
3631,105615,yt2gjsEupK8sBRyKpoF6RM4kG7zfvxKC,SpATywNh6bZuzm8s1ceuBUnMUAeoAHHw,18,20,9,11,4,0,5,0,49,7.0,2,0.0,4,9,11,4,16,0,0,5,0,28,21,0
3632,105671,wpA3YODDDsWaFQtfPR7v2M6HEJbcAeIY,SpATywNh6bZuzm8s1ceuBUnMUAeoAHHw,5,3,2,0,1,0,1,0,7,1.0,1,0.0,0,2,0,1,3,0,0,1,0,3,4,1
3633,105729,EhHrinjt1AkEWC09AFZwBuP61S5NJgjn,7GRhBDsirIGkRZBtSMEzNTyDr2JQm4xx,28,57,2,20,0,4,6,0,89,12.714285714285714,1,0.0,22,2,13,0,35,4,7,6,0,37,52,1
3634,105731,IG8NI5PgTAnRqVnVRaFxoKgrZHc8y65q,7GRhBDsirIGkRZBtSMEzNTyDr2JQm4xx,1,0,0,0,0,0,1,0,1,0.14285714285714285,1,0.0,0,0,0,0,0,0,0,1,0,0,1,1
3635,105736,r0ZdlKlEsmKZY094aSTCPxTKx82Pv4jZ,7GRhBDsirIGkRZBtSMEzNTyDr2JQm4xx,3,2,1,0,0,0,1,0,4,0.5714285714285714,1,0.0,0,1,0,0,2,0,0,1,0,1,3,1
3636,105746,szmVnhPypUPoSdN8Z8D02a6M8Gjrnwmf,7GRhBDsirIGkRZBtSMEzNTyDr2JQm4xx,5,3,2,0,1,0,1,0,7,1.0,1,0.0,0,2,0,1,3,0,0,1,0,3,4,1
3637,105767,mjObtvp4vmduPSr2e6gxrQuYRjgGF8wF,7GRhBDsirIGkRZBtSMEzNTyDr2JQm4xx,17,31,6,36,1,5,6,1,86,12.285714285714286,2,0.0,22,6,32,1,9,5,4,6,1,61,25,0
3638,105784,QDpN8D19Mr8RZumTONWpZNlCWcHCCTbH,7GRhBDsirIGkRZBtSMEzNTyDr2JQm4xx,5,2,1,0,1,0,5,0,9,1.2857142857142858,1,0.0,0,1,0,1,2,0,0,5,0,2,7,1
3639,105836,67qAsD8gffFwGGRYP2VtVSy5y3Ookejk,7GRhBDsirIGkRZBtSMEzNTyDr2JQm4xx,7,3,2,0,2,0,2,0,9,1.2857142857142858,1,0.0,0,2,0,2,3,0,0,2,0,4,5,1
3640,105879,CkUOqtA27OCG1GaoeglcnLgN2xB1KvvL,7GRhBDsirIGkRZBtSMEzNTyDr2JQm4xx,2,0,0,0,0,0,2,0,2,0.2857142857142857,1,0.0,0,0,0,0,0,0,0,2,0,0,2,1
3641,105990,V1VqVvaNADQhdwUg7X6GrtUrah1AYvnF,7GRhBDsirIGkRZBtSMEzNTyDr2JQm4xx,6,4,0,0,0,0,6,0,10,1.4285714285714286,2,0.0,0,0,0,0,4,0,0,6,0,0,10,1
3642,106003,wwh7y5mxviojWrVEvWbfoKIYQ3Sgn2tu,7GRhBDsirIGkRZBtSMEzNTyDr2JQm4xx,6,4,1,0,1,0,3,0,9,1.2857142857142858,2,0.0,0,1,0,1,4,0,0,3,0,2,7,1
3643,106004,ZPzO2Jq9MyhQSTfjOYO9iqzdnziVzHhF,7GRhBDsirIGkRZBtSMEzNTyDr2JQm4xx,3,2,1,0,0,0,1,0,4,0.5714285714285714,1,0.0,0,1,0,0,2,0,0,1,0,1,3,1
3644,106010,VLqeHUMgi9PQ3Cs8paSU7gHzDiYDPzML,7GRhBDsirIGkRZBtSMEzNTyDr2JQm4xx,5,2,1,0,1,0,2,0,6,0.8571428571428571,1,0.0,0,1,0,1,2,0,0,2,0,2,4,1
3645,106019,UBfqapbt41rZhlFda9dIX0sXKEHUoNRR,7GRhBDsirIGkRZBtSMEzNTyDr2JQm4xx,1,0,0,0,0,0,1,0,1,0.14285714285714285,1,0.0,0,0,0,0,0,0,0,1,0,0,1,1
3646,106434,i6H5zxz2U3b7Stgpyc7yvkBTJYyhoQYo,SpATywNh6bZuzm8s1ceuBUnMUAeoAHHw,11,12,1,10,1,0,2,0,26,3.7142857142857144,1,0.0,7,1,8,1,5,0,2,2,0,17,9,1
3647,106591,rxfzVJVj4XNymQN7SX1pdLUM549NCrW7,SpATywNh6bZuzm8s1ceuBUnMUAeoAHHw,3,2,1,0,0,0,1,0,4,0.5714285714285714,1,0.0,0,1,0,0,2,0,0,1,0,1,3,0
3648,106655,5r9OEsSFtsP3T0AQQIuWD6ouO08AmGp2,bWdj2GDclj5ofokWjzoa5jAwMkxCykd6,7,8,1,0,2,0,2,0,13,1.8571428571428572,1,0.0,2,1,0,2,6,0,0,2,0,5,8,1
3649,106698,AuIQbwKCl1rpgmIzQXLySneETBtGUcy9,SpATywNh6bZuzm8s1ceuBUnMUAeoAHHw,6,9,1,0,1,0,1,0,12,1.7142857142857142,1,0.0,4,1,0,1,5,0,0,1,0,6,6,1
3650,106853,DSkyPIUtT8xxP5Yu1DrvohPZBHHgxJAD,SpATywNh6bZuzm8s1ceuBUnMUAeoAHHw,2,0,0,0,0,0,2,0,2,0.2857142857142857,1,0.0,0,0,0,0,0,0,0,2,0,0,2,1
3651,106940,NKTsGtocSBmn1p0LL8TfbQ17Oh6XvCt3,SpATywNh6bZuzm8s1ceuBUnMUAeoAHHw,3,2,0,0,0,0,3,0,5,0.7142857142857143,2,0.0,0,0,0,0,2,0,0,3,0,0,5,0
3652,106955,wMYwbasBu7kj6nAVyuyEqjGmi3ogAq0E,SpATywNh6bZuzm8s1ceuBUnMUAeoAHHw,9,9,6,0,4,0,2,0,21,3.0,1,0.0,0,6,0,4,9,0,0,2,0,10,11,1
3653,106991,foZomfeiH5mdSFjeB6umSt6lwP9hfSDR,A3fsA9Zfv1X2fVEQhTw51lKENdNrEqT3,2,0,0,0,0,0,4,0,4,0.5714285714285714,1,0.0,0,0,0,0,0,0,0,4,0,0,4,1
3654,108075,EboqTOLce3Kcnbr13rePsINEM3noHrcD,A3fsA9Zfv1X2fVEQhTw51lKENdNrEqT3,33,14,9,62,5,29,5,0,124,17.714285714285715,2,0.0,3,9,55,5,11,29,7,5,0,72,52,1
3655,108386,eBckG9AVr6bIBOpezfRr2S1KzQMM7OtD,G8EPVSXsOYB5YQWZGiz1aVq5Pgr2GrQu,17,17,10,0,5,6,3,0,41,5.857142857142857,2,0.0,0,10,0,5,17,6,0,3,0,15,26,0
3656,108740,z8PlFZ3kRCGZCtReInG4syWyRUKvCeDo,RXDvfPUBYFlVdlueBFbLW0mhhAyGEqpt,10,25,1,10,0,0,1,0,37,5.285714285714286,1,0.0,5,1,8,0,20,0,2,1,0,14,23,0
3657,108845,VBP5PzVQEKJYFH0y5ffEek5WfP9EW7uc,bWdj2GDclj5ofokWjzoa5jAwMkxCykd6,5,3,2,0,1,0,1,0,7,1.0,1,0.0,0,2,0,1,3,0,0,1,0,3,4,1
3658,108946,xCHQAq5m2mtyQES4gfg6MjCHDUVD1J71,SpATywNh6bZuzm8s1ceuBUnMUAeoAHHw,7,7,0,0,0,0,1,0,8,1.1428571428571428,2,0.0,0,0,0,0,7,0,0,1,0,0,8,0
3659,108993,SvKqfRpvSIeLIO42O4cF9tQtaigEgElY,A3fsA9Zfv1X2fVEQhTw51lKENdNrEqT3,1,0,0,0,0,0,1,0,1,0.14285714285714285,1,0.0,0,0,0,0,0,0,0,1,0,0,1,1
3660,109016,tJDZI9sjRcU2ZrvrdL12AwFT0OmQXIcr,A3fsA9Zfv1X2fVEQhTw51lKENdNrEqT3,1,0,0,0,0,0,1,0,1,0.14285714285714285,1,0.0,0,0,0,0,0,0,0,1,0,0,1,1
3661,109132,ZVmjT1rppq7ilCPRRtmAl1wo0gOugsCt,A3fsA9Zfv1X2fVEQhTw51lKENdNrEqT3,21,11,10,0,9,0,1,0,31,4.428571428571429,1,0.0,0,10,0,9,11,0,0,1,0,19,12,1
3662,109193,SclrH2608f72JlTtkBQ5xWQXCuDyyco3,A3fsA9Zfv1X2fVEQhTw51lKENdNrEqT3,3,2,1,0,0,0,2,0,5,0.7142857142857143,2,0.0,0,1,0,0,2,0,0,2,0,1,4,0
3663,109241,XuNt1i5t4SR1AjDP4UHvsoux0R9qVf5C,SpATywNh6bZuzm8s1ceuBUnMUAeoAHHw,4,3,0,0,0,0,2,0,5,0.7142857142857143,2,0.0,0,0,0,0,3,0,0,2,0,0,5,1
3664,109281,MFZvBtjHJjKdCSK87D1kJEMGtcPTGn4S,A3fsA9Zfv1X2fVEQhTw51lKENdNrEqT3,1,0,0,0,0,0,1,0,1,0.14285714285714285,1,0.0,0,0,0,0,0,0,0,1,0,0,1,1
3665,109493,kajklFKczHkuBeWWHTIA518Xzi7jmX3b,A3fsA9Zfv1X2fVEQhTw51lKENdNrEqT3,1,0,0,0,0,0,1,0,1,0.14285714285714285,1,0.0,0,0,0,0,0,0,0,1,0,0,1,1
3666,109555,Cv1aavObJnuABKfipF6OGePzg0BnGPFs,G8EPVSXsOYB5YQWZGiz1aVq5Pgr2GrQu,22,3,3,88,0,0,6,0,100,14.285714285714286,2,0.0,0,3,74,0,3,0,14,6,0,77,23,1
3667,109682,HYMxLb0qNi7DvNLdn0aBxzsZewAG7tgU,SpATywNh6bZuzm8s1ceuBUnMUAeoAHHw,5,3,1,0,1,0,1,0,6,0.8571428571428571,1,0.0,0,1,0,1,3,0,0,1,0,2,4,1
3668,109705,HMYpimZGFgj5IczDutkfjUfnxl45PoHW,A3fsA9Zfv1X2fVEQhTw51lKENdNrEqT3,6,3,1,0,0,1,3,0,8,1.1428571428571428,1,0.0,0,1,0,0,3,1,0,3,0,1,7,1
3669,109858,45qf8dslh2FbT82HZJkVQ8o4xBP1tetJ,SpATywNh6bZuzm8s1ceuBUnMUAeoAHHw,5,4,1,0,1,0,1,0,7,1.0,1,0.0,0,1,0,1,4,0,0,1,0,2,5,1
3670,109884,TiyssQ1xBxRpSE8M84hoblpjLNawoMPM,bWdj2GDclj5ofokWjzoa5jAwMkxCykd6,1,0,0,0,0,0,1,0,1,0.14285714285714285,1,0.0,0,0,0,0,0,0,0,1,0,0,1,1
3671,109938,jhSBNR9EEysD5KhTnnFndvZuefk9V3rI,SpATywNh6bZuzm8s1ceuBUnMUAeoAHHw,2,0,0,0,0,0,2,0,2,0.2857142857142857,1,0.0,0,0,0,0,0,0,0,2,0,0,2,0
3672,113825,xUhDcXiX03QQg1jNR3Lksh9CrGcRUkPg,7GRhBDsirIGkRZBtSMEzNTyDr2JQm4xx,29,62,2,20,8,3,11,0,106,15.142857142857142,6,0.0,24,2,12,8,38,3,8,11,0,46,60,0
3673,113935,nDRvdnRCphlivJCuFTuhDKgd5jyHoHuK,7GRhBDsirIGkRZBtSMEzNTyDr2JQm4xx,41,99,54,50,30,3,17,1,254,36.285714285714285,7,0.0,29,54,41,30,70,3,9,17,1,154,100,0
3674,114045,40f11BuizcEv7ZFFxcPqa0v1O1iUUbkI,7GRhBDsirIGkRZBtSMEzNTyDr2JQm4xx,3,3,2,0,0,0,1,0,6,0.8571428571428571,1,0.0,0,2,0,0,3,0,0,1,0,2,4,1
3675,114118,hNtOw8NhFSEVmWVm0uZ7niVIy1y64lqK,7GRhBDsirIGkRZBtSMEzNTyDr2JQm4xx,1,0,0,0,0,0,1,0,1,0.14285714285714285,1,0.0,0,0,0,0,0,0,0,1,0,0,1,1
3676,114136,tkUa5CpArdCreqMyzIcAuTFrrxiEVJbS,7GRhBDsirIGkRZBtSMEzNTyDr2JQm4xx,10,14,6,0,3,0,2,0,25,3.5714285714285716,2,0.0,6,6,0,3,8,0,0,2,0,15,10,1
3677,114179,QZbPGbTnAqz8GS6cm25XcpeiETovvLN6,7GRhBDsirIGkRZBtSMEzNTyDr2JQm4xx,89,174,42,140,42,9,29,1,437,62.42857142857143,3,0.0,94,42,109,42,80,9,31,29,1,287,150,0
3678,114458,hu8eak1Xmf8voE8pnxPzkSD2dZP9Sipf,7GRhBDsirIGkRZBtSMEzNTyDr2JQm4xx,56,45,0,75,0,4,18,0,142,20.285714285714285,3,0.0,28,0,75,0,17,4,0,18,0,103,39,0
3679,114460,gBUQvhjVwGtG2bUGFkuQNt86DA2hmTm5,7GRhBDsirIGkRZBtSMEzNTyDr2JQm4xx,30,55,37,0,26,3,7,0,128,18.285714285714285,2,0.0,16,37,0,26,39,3,0,7,0,79,49,1
3680,114562,BQSRjVmgixA5nv8k53vKwJ20bVp0NOMd,7GRhBDsirIGkRZBtSMEzNTyDr2JQm4xx,31,30,11,10,18,4,3,0,76,10.857142857142858,2,0.0,16,11,10,18,14,4,0,3,0,55,21,0
3681,114609,niCmhuSfQsMKGJA13iBf3xqhHudkRRY5,fbPkOYLVPtPgIt0MxizjfFJov3JbHyAi,10,17,8,0,5,3,18,0,51,7.285714285714286,2,0.0,0,8,0,5,17,3,0,18,0,13,38,0
3682,114611,5x7PJKAlpwjJHVKa6EUCDUMMHmJ1P3I6,fbPkOYLVPtPgIt0MxizjfFJov3JbHyAi,7,3,2,0,2,0,2,0,9,1.2857142857142858,1,0.0,0,2,0,2,3,0,0,2,0,4,5,1
3683,114613,ov7BYx7M6nQf9HtywUVu0CvVUbJ2cMz9,fbPkOYLVPtPgIt0MxizjfFJov3JbHyAi,5,2,1,0,1,1,4,0,9,1.2857142857142858,1,0.0,0,1,0,1,2,1,0,4,0,2,7,1
3684,114626,6tmxpsRtsjoDY9zXnzo3i4nW1oQa44E2,fbPkOYLVPtPgIt0MxizjfFJov3JbHyAi,1,0,0,0,0,0,1,0,1,0.14285714285714285,1,0.0,0,0,0,0,0,0,0,1,0,0,1,0
3685,114639,IXyECojptU5NkfL9RFdtwIRy87m56pw9,fbPkOYLVPtPgIt0MxizjfFJov3JbHyAi,21,47,24,28,11,20,21,8,159,22.714285714285715,4,0.0,15,24,18,11,32,20,10,21,8,68,91,1
3686,114643,WfE8YobKj49KJJchFTR0mkLGdZ0KFFcq,fbPkOYLVPtPgIt0MxizjfFJov3JbHyAi,7,3,2,0,2,6,3,0,16,2.2857142857142856,1,0.0,0,2,0,2,3,6,0,3,0,4,12,1
3687,114652,wuaIkUodYTr49NZ7BbMPsEdpO0t0C8Nt,fbPkOYLVPtPgIt0MxizjfFJov3JbHyAi,12,11,0,7,0,4,5,0,27,3.857142857142857,2,0.0,3,0,5,0,8,4,2,5,0,8,19,1
3688,117356,BEpwi711y09XyC4DFTNZ8NMJ5PwUJeE1,fbPkOYLVPtPgIt0MxizjfFJov3JbHyAi,36,82,34,28,7,25,13,0,189,27.0,5,0.0,20,34,27,7,62,25,1,13,0,88,101,0
3689,117372,frevGWOFyf2Wo6uQjpFNvZnyWeFbKP0E,fbPkOYLVPtPgIt0MxizjfFJov3JbHyAi,20,15,9,12,6,0,1,0,43,6.142857142857143,1,0.0,5,9,12,6,10,0,0,1,0,32,11,1
3690,117375,70RbSAVcGIyny9mWjCd20wt9FfgzeOIU,fbPkOYLVPtPgIt0MxizjfFJov3JbHyAi,11,17,8,0,3,2,6,0,36,5.142857142857143,2,0.0,0,8,0,3,17,2,0,6,0,11,25,1
3691,117394,x61GVEFoUQZEIHnVsxBCw0kitfDOhP0p,fbPkOYLVPtPgIt0MxizjfFJov3JbHyAi,14,19,15,0,9,0,1,0,44,6.285714285714286,1,0.0,0,15,0,9,19,0,0,1,0,24,20,1
3692,117423,NXEwBXbU6vvce77sujWgRB6LivhFJvRb,fbPkOYLVPtPgIt0MxizjfFJov3JbHyAi,5,4,3,0,0,0,1,0,8,1.1428571428571428,1,0.0,0,3,0,0,4,0,0,1,0,3,5,1
3693,117433,M75L90OOMTV1kEiI3n7vM0ty47YBFna9,fbPkOYLVPtPgIt0MxizjfFJov3JbHyAi,3,3,1,0,0,0,1,0,5,0.7142857142857143,1,0.0,0,1,0,0,3,0,0,1,0,1,4,1
3694,117459,8BPmxHv8u8jXk5HWBs0qXnY9uZ2rLMGq,fbPkOYLVPtPgIt0MxizjfFJov3JbHyAi,1,4,0,0,0,0,0,0,4,0.5714285714285714,2,0.0,0,0,0,0,4,0,0,0,0,0,4,0
3695,117465,c0uK7fknnbIb1l1yn1QtakefMn1Gi8lI,fbPkOYLVPtPgIt0MxizjfFJov3JbHyAi,1,0,0,0,0,0,1,0,1,0.14285714285714285,1,0.0,0,0,0,0,0,0,0,1,0,0,1,1
3696,117480,O85WftB5NCrDTb9pXVSgYQyFNgKq9cya,fbPkOYLVPtPgIt0MxizjfFJov3JbHyAi,5,3,2,0,1,0,1,0,7,1.0,1,0.0,0,2,0,1,3,0,0,1,0,3,4,1
3697,117487,UvYdE00Z5Ts8a6wK0WxKxxpGT2cAkrRh,fbPkOYLVPtPgIt0MxizjfFJov3JbHyAi,32,54,18,17,19,0,4,0,112,16.0,2,0.0,33,18,15,19,21,0,2,4,0,85,27,0
3698,117494,bXLdnFxUVQAW3oOCSdQxNLLTqr9NOtgu,fbPkOYLVPtPgIt0MxizjfFJov3JbHyAi,5,1,1,0,1,0,2,0,5,0.7142857142857143,1,0.0,0,1,0,1,1,0,0,2,0,2,3,1
3699,117509,ydSu1htsBf3RzcwY9UTcwNk58kfOh1CK,SpATywNh6bZuzm8s1ceuBUnMUAeoAHHw,3,2,0,0,0,0,1,0,3,0.42857142857142855,1,0.0,0,0,0,0,2,0,0,1,0,0,3,0
3700,117515,Djtv0PgEw9uZSQc7WiXmZsJgnFOxrvrt,RXDvfPUBYFlVdlueBFbLW0mhhAyGEqpt,1,0,0,0,0,0,2,0,2,0.2857142857142857,2,0.0,0,0,0,0,0,0,0,2,0,0,2,1
3701,117534,qX3w4IgztgXyu9swieirFObama3kJyza,bWdj2GDclj5ofokWjzoa5jAwMkxCykd6,4,3,1,0,0,0,1,0,5,0.7142857142857143,1,0.0,0,1,0,0,3,0,0,1,0,1,4,1
3702,117535,dB6JlfpSJir7ay6MgDMKvaO3E6lmbl8u,bWdj2GDclj5ofokWjzoa5jAwMkxCykd6,5,7,0,0,0,0,1,0,8,1.1428571428571428,1,0.0,0,0,0,0,7,0,0,1,0,0,8,1
3703,117536,f07Kut7kBpGHis5iRAbMzHKfd6CS5vLr,A3fsA9Zfv1X2fVEQhTw51lKENdNrEqT3,11,38,26,0,0,127,11,0,202,28.857142857142858,4,0.0,5,26,0,0,33,127,0,11,0,31,171,0
3704,117543,EX3gOxFqlG8z0KCJnBCBLiCIiQRkFF4q,bWdj2GDclj5ofokWjzoa5jAwMkxCykd6,4,1,0,0,0,0,4,0,5,0.7142857142857143,1,0.0,0,0,0,0,1,0,0,4,0,0,5,1
3705,117545,EX3gOxFqlG8z0KCJnBCBLiCIiQRkFF4q,G8EPVSXsOYB5YQWZGiz1aVq5Pgr2GrQu,15,8,4,8,3,0,6,0,29,4.142857142857143,1,0.0,3,4,5,3,5,0,3,6,0,15,14,1
3706,117552,wKSiPD3ccCI47tDYWhx56Wd2BJP8ki2L,SpATywNh6bZuzm8s1ceuBUnMUAeoAHHw,12,17,2,0,2,0,3,0,24,3.4285714285714284,3,0.0,3,2,0,2,14,0,0,3,0,7,17,0
3707,117557,Z9nbZek76s4RBuA56w1WtME3e9ClZkaP,SpATywNh6bZuzm8s1ceuBUnMUAeoAHHw,26,18,12,18,7,1,2,0,58,8.285714285714286,1,0.0,5,12,15,7,13,1,3,2,0,39,19,0
3708,117561,ADL0cXowUMs4wyiAOHKMOrtTHu5tmUqi,A3fsA9Zfv1X2fVEQhTw51lKENdNrEqT3,3,2,1,0,0,0,3,0,6,0.8571428571428571,1,0.0,0,1,0,0,2,0,0,3,0,1,5,0
3709,117563,W5xQOH5MemwXn7klqn6rjd1MM4WzuzQi,SpATywNh6bZuzm8s1ceuBUnMUAeoAHHw,18,13,8,6,4,0,8,0,39,5.571428571428571,3,0.0,2,8,6,4,11,0,0,8,0,20,19,0
3710,117573,0i4PCdH5yACfB3MbD4JgsC2DeGE0OI6C,SpATywNh6bZuzm8s1ceuBUnMUAeoAHHw,5,3,2,0,1,0,1,0,7,1.0,1,0.0,0,2,0,1,3,0,0,1,0,3,4,1
3711,117602,BcsAFxTYYWhC1bNDfK977UfoS17oCWvP,SpATywNh6bZuzm8s1ceuBUnMUAeoAHHw,5,8,1,0,0,0,1,0,10,1.4285714285714286,1,0.0,4,1,0,0,4,0,0,1,0,5,5,0
3712,117611,BbvGM92sGSMMIrRMXDFdD1GEnySzXRYT,SpATywNh6bZuzm8s1ceuBUnMUAeoAHHw,3,12,2,0,0,0,6,0,20,2.857142857142857,5,0.0,0,2,0,0,12,0,0,6,0,2,18,0
3713,117616,GLClE8eg40BpWvmEfcSMwSvtSTOkzETn,SpATywNh6bZuzm8s1ceuBUnMUAeoAHHw,10,15,4,0,3,0,4,0,26,3.7142857142857144,2,0.0,0,4,0,3,15,0,0,4,0,7,19,0
3714,117626,wj1Ce3w6RyUCBwI2hTV32GMvTMsHncyy,SpATywNh6bZuzm8s1ceuBUnMUAeoAHHw,14,11,5,17,3,0,2,0,38,5.428571428571429,1,0.0,5,5,15,3,6,0,2,2,0,28,10,1
3715,117662,1ujJ0EpnNLNXPSSRc7XEx7I0RReWnlus,SpATywNh6bZuzm8s1ceuBUnMUAeoAHHw,2,0,0,0,0,0,2,0,2,0.2857142857142857,1,0.0,0,0,0,0,0,0,0,2,0,0,2,1
3716,117664,wbMM6yL6hpsJkBDUrCRoi5Fuo2kgSUdK,SpATywNh6bZuzm8s1ceuBUnMUAeoAHHw,20,22,0,14,0,0,1,0,37,5.285714285714286,3,0.0,7,0,14,0,15,0,0,1,0,21,16,1
3717,117668,ZvlB6WVwV84B3g1S1DABzlXirXgL69kV,SpATywNh6bZuzm8s1ceuBUnMUAeoAHHw,1,0,0,0,0,0,1,0,1,0.14285714285714285,1,0.0,0,0,0,0,0,0,0,1,0,0,1,1
3718,117669,3xN41ERTxK2f1CGWRDLSjBdLqp0aeXRu,SpATywNh6bZuzm8s1ceuBUnMUAeoAHHw,17,41,7,14,1,54,25,5,147,21.0,3,0.0,14,7,12,1,27,54,2,25,5,34,113,1
3719,117674,5MqtNGumkUVehW5cfaAfZ7nPmHPSTQ7V,bWdj2GDclj5ofokWjzoa5jAwMkxCykd6,1,0,0,0,0,0,1,0,1,0.14285714285714285,1,0.0,0,0,0,0,0,0,0,1,0,0,1,1
3720,117698,JjO25OOm89Iye7MTZHSNIwd1wvv7Llpy,bWdj2GDclj5ofokWjzoa5jAwMkxCykd6,7,2,1,0,1,2,6,1,13,1.8571428571428572,1,0.0,0,1,0,1,2,2,0,6,1,2,11,1
3721,117703,70SrKRY1oWl5d62cNgc8OZe8Ra3cen1a,SpATywNh6bZuzm8s1ceuBUnMUAeoAHHw,4,13,0,0,0,19,4,0,36,5.142857142857143,3,0.0,8,0,0,0,5,19,0,4,0,8,28,0
3722,117724,IspEVPShBbjx8d4IihOvyrT9DEmhjxUS,SpATywNh6bZuzm8s1ceuBUnMUAeoAHHw,1,0,0,0,0,0,2,0,2,0.2857142857142857,1,0.0,0,0,0,0,0,0,0,2,0,0,2,1
3723,117732,cQJEH4N9NA86ElT2x4zkE6ToN6rVT4MQ,A3fsA9Zfv1X2fVEQhTw51lKENdNrEqT3,17,10,10,0,7,0,0,0,27,3.857142857142857,1,0.0,0,10,0,7,10,0,0,0,0,17,10,1
3724,117744,UqgvfgWyOQuTxiMgyBKfmUFRwGDD6lWb,SpATywNh6bZuzm8s1ceuBUnMUAeoAHHw,9,8,4,0,2,0,2,0,16,2.2857142857142856,1,0.0,3,4,0,2,5,0,0,2,0,9,7,0
3725,117749,yNygMjDRQbsmQrkdzv6Ni3gEhrA9rC9T,G8EPVSXsOYB5YQWZGiz1aVq5Pgr2GrQu,3,2,1,0,0,0,1,0,4,0.5714285714285714,1,0.0,0,1,0,0,2,0,0,1,0,1,3,1
3726,117763,VeWfrT5492g1p7PzRa92mFX1sE44kxoq,bWdj2GDclj5ofokWjzoa5jAwMkxCykd6,5,2,1,0,1,0,2,0,6,0.8571428571428571,1,0.0,0,1,0,1,2,0,0,2,0,2,4,1
3727,117776,8EDi9ELIY5NaafGr5ul94OArAKYSlPLk,SpATywNh6bZuzm8s1ceuBUnMUAeoAHHw,27,45,22,27,10,3,10,0,117,16.714285714285715,3,0.0,18,22,27,10,27,3,0,10,0,77,40,0
3728,117782,usFuTvFQpKrRjDwn3CiAVcIq4WWtoKl0,RXDvfPUBYFlVdlueBFbLW0mhhAyGEqpt,6,1,1,0,1,11,8,0,22,3.142857142857143,4,0.0,0,1,0,1,1,11,0,8,0,2,20,0
3729,117794,koupoV2Bo5oQSD6MVvXaJhUITtX0e3bf,bWdj2GDclj5ofokWjzoa5jAwMkxCykd6,10,10,7,0,5,2,13,2,39,5.571428571428571,1,0.0,0,7,0,5,10,2,0,13,2,12,27,1
3730,117796,2HxuGhGQGzCNLHdg582isvj2k1uv2pCi,SpATywNh6bZuzm8s1ceuBUnMUAeoAHHw,19,47,3,14,1,21,16,2,104,14.857142857142858,1,0.0,24,3,14,1,23,21,0,16,2,42,62,0
3731,117802,n4PMPT9vVmStYaQ48auvwvWym2rE6F0p,bWdj2GDclj5ofokWjzoa5jAwMkxCykd6,1,0,0,0,0,0,1,0,1,0.14285714285714285,1,0.0,0,0,0,0,0,0,0,1,0,0,1,1
3732,117830,2RJ8BBRkfXWUgOvINgxOSXP2ac2oP7fh,SpATywNh6bZuzm8s1ceuBUnMUAeoAHHw,8,7,3,0,1,0,6,0,17,2.4285714285714284,1,0.0,2,3,0,1,5,0,0,6,0,6,11,1
3733,117833,sDtEwaD6losyMUPLsmLS1gJz6VpRuXBt,G8EPVSXsOYB5YQWZGiz1aVq5Pgr2GrQu,6,3,1,0,1,0,2,0,7,1.0,1,0.0,0,1,0,1,3,0,0,2,0,2,5,1
3734,117834,R81t3oSweiKsqxrzFQTifbMpcqBh0IJe,SpATywNh6bZuzm8s1ceuBUnMUAeoAHHw,6,3,1,0,1,0,2,0,7,1.0,1,0.0,0,1,0,1,3,0,0,2,0,2,5,1
3735,117838,E6GtLgX3I7VGOpV74LvaV5V5J9ND1jUQ,SpATywNh6bZuzm8s1ceuBUnMUAeoAHHw,6,10,4,0,1,0,5,0,20,2.857142857142857,3,0.0,0,4,0,1,10,0,0,5,0,5,15,1
3736,117865,57P5UbCfzn8GLpyzVkqMDPp8kp3hFIaz,bWdj2GDclj5ofokWjzoa5jAwMkxCykd6,1,0,0,0,0,0,1,0,1,0.14285714285714285,1,0.0,0,0,0,0,0,0,0,1,0,0,1,1
3737,117866,o7ztEzN1VLXMPiKeM3Eu4FDhVLhHjR47,A3fsA9Zfv1X2fVEQhTw51lKENdNrEqT3,7,3,2,0,1,31,7,0,44,6.285714285714286,1,0.0,0,2,0,1,3,31,0,7,0,3,41,1
3738,117906,NoA9xueUUthCTfidqnFplOKsMZsY3DHa,A3fsA9Zfv1X2fVEQhTw51lKENdNrEqT3,7,7,4,0,1,0,2,0,14,2.0,2,0.0,1,4,0,1,6,0,0,2,0,6,8,1
3739,117907,Z3bFvTwttDZ4bCfkqeyPSBE9NPAPKPqN,SpATywNh6bZuzm8s1ceuBUnMUAeoAHHw,10,24,3,13,0,0,5,0,45,6.428571428571429,2,0.0,9,3,13,0,15,0,0,5,0,25,20,0
3740,117910,QtoTN2OyyTcqe6Us4ENFLFoSg3hJkA40,SpATywNh6bZuzm8s1ceuBUnMUAeoAHHw,15,25,0,12,0,12,8,1,58,8.285714285714286,2,0.0,6,0,11,0,19,12,1,8,1,17,41,0
3741,117917,ch9tY2TtGdyg7x6KOapt9NQCSfX2sV8p,SpATywNh6bZuzm8s1ceuBUnMUAeoAHHw,2,0,0,0,0,0,2,0,2,0.2857142857142857,1,0.0,0,0,0,0,0,0,0,2,0,0,2,1
3742,117920,Tsqz3H4jIOz4dWir6zrZDbKSFYTGo0K7,G8EPVSXsOYB5YQWZGiz1aVq5Pgr2GrQu,29,51,9,24,5,0,29,2,120,17.142857142857142,3,0.0,1,9,20,5,50,0,4,29,2,35,85,0
3743,117927,M45J6fNUaggda3LzoFU6r4v9Do7R8HkV,bWdj2GDclj5ofokWjzoa5jAwMkxCykd6,32,56,38,32,6,5,13,2,152,21.714285714285715,4,0.0,8,38,16,6,48,5,16,13,2,68,84,0
3744,117931,2FyRSMemMx0WQNXDNdLObUL8ox2VWXod,G8EPVSXsOYB5YQWZGiz1aVq5Pgr2GrQu,2,0,0,0,0,0,2,0,2,0.2857142857142857,1,0.0,0,0,0,0,0,0,0,2,0,0,2,1
3745,117940,JYCXGTBUXKAgLYAuYSVkBAkWpoJ7TYUE,G8EPVSXsOYB5YQWZGiz1aVq5Pgr2GrQu,29,26,12,70,2,11,17,0,138,19.714285714285715,4,0.0,3,12,51,2,23,11,19,17,0,68,70,0
3746,117944,Lx03w1Z7uki61iSuRTBJrJMgf0kqOIrF,SpATywNh6bZuzm8s1ceuBUnMUAeoAHHw,17,17,7,10,5,0,3,0,42,6.0,1,0.0,7,7,9,5,10,0,1,3,0,28,14,0
3747,117946,yXqCA1yQnzskdA15yvjJGzN0ZJtznFpO,RXDvfPUBYFlVdlueBFbLW0mhhAyGEqpt,21,20,1,36,2,0,3,0,62,8.857142857142858,4,0.0,5,1,36,2,15,0,0,3,0,44,18,1
3748,117948,1AlOrbJ2y8dS4ycbJ2sP2OTCfMGEqZ01,SpATywNh6bZuzm8s1ceuBUnMUAeoAHHw,5,2,1,0,0,0,7,0,10,1.4285714285714286,2,0.0,0,1,0,0,2,0,0,7,0,1,9,0
3749,117952,bAb84TA4vcs2wtZNieDCHeBDjeqCrQIp,SpATywNh6bZuzm8s1ceuBUnMUAeoAHHw,1,0,0,0,0,0,1,0,1,0.14285714285714285,1,0.0,0,0,0,0,0,0,0,1,0,0,1,1
3750,117954,jFYWygr5nLqLhHkXltZRkT0S1zQoLEVR,SpATywNh6bZuzm8s1ceuBUnMUAeoAHHw,21,22,10,22,4,0,3,0,61,8.714285714285714,2,0.0,7,10,19,4,15,0,3,3,0,40,21,0
3751,117985,LL81eYdCoRvNJLX5R1NjId0q1BUIEnQb,SpATywNh6bZuzm8s1ceuBUnMUAeoAHHw,2,0,0,0,0,0,2,0,2,0.2857142857142857,1,0.0,0,0,0,0,0,0,0,2,0,0,2,1
3752,117998,NbBykb0b9cShqzgiHDyBRNbubH18qJTN,SpATywNh6bZuzm8s1ceuBUnMUAeoAHHw,7,3,2,0,2,0,2,0,9,1.2857142857142858,1,0.0,0,2,0,2,3,0,0,2,0,4,5,1
3753,118025,DBl0Whn7bz7gT7myQMnidYa3zRNL4McA,SpATywNh6bZuzm8s1ceuBUnMUAeoAHHw,10,30,17,23,0,0,4,0,74,10.571428571428571,1,0.0,9,17,20,0,21,0,3,4,0,46,28,1
3754,118033,86F6XnjIRLQFbYrnQo4SUAq6YeqsWqJH,SpATywNh6bZuzm8s1ceuBUnMUAeoAHHw,7,4,2,0,1,0,2,1,10,1.4285714285714286,1,0.0,0,2,0,1,4,0,0,2,1,3,7,1
3755,118043,ZfEmNtZnnnOMQU2ZxafVmay1LudDsU5A,bWdj2GDclj5ofokWjzoa5jAwMkxCykd6,10,12,1,0,1,1,9,1,25,3.5714285714285716,2,0.0,2,1,0,1,10,1,0,9,1,4,21,0
3756,118051,PHrtg3UspIdS1qc6Vp5GAq4YFnlF3cc7,G8EPVSXsOYB5YQWZGiz1aVq5Pgr2GrQu,3,1,1,0,1,0,0,0,3,0.42857142857142855,1,0.0,0,1,0,1,1,0,0,0,0,2,1,1
3757,118070,nqDX1tmEeTnbqCn9T8Crn5CYQgmIy9Eq,RXDvfPUBYFlVdlueBFbLW0mhhAyGEqpt,45,59,34,91,14,22,11,0,231,33.0,3,0.0,15,34,83,14,44,22,8,11,0,146,85,0
3758,118081,E0Vc68zQyaBo1QGFDy3X2ztIvkjoKV3F,SpATywNh6bZuzm8s1ceuBUnMUAeoAHHw,4,3,0,0,0,0,1,0,4,0.5714285714285714,1,0.0,0,0,0,0,3,0,0,1,0,0,4,1
3759,118083,hJwtwnOzJaTrAeP4eXJAEwz2xbKsgc4M,SpATywNh6bZuzm8s1ceuBUnMUAeoAHHw,1,0,0,0,0,0,4,0,4,0.5714285714285714,4,0.0,0,0,0,0,0,0,0,4,0,0,4,0
3760,118101,bwCuicApqXH6S91HqGdXTXLfYA9d5SDK,SpATywNh6bZuzm8s1ceuBUnMUAeoAHHw,20,18,0,28,0,0,8,0,54,7.714285714285714,2,0.0,8,0,26,0,10,0,2,8,0,34,20,0
3761,118122,kQLFlWsDSg3FfLQ3EFfSSjFDdN5HLm8p,SpATywNh6bZuzm8s1ceuBUnMUAeoAHHw,6,6,1,0,0,0,1,0,8,1.1428571428571428,1,0.0,0,1,0,0,6,0,0,1,0,1,7,1
3762,118124,11qZqrXXcQbdqet0TC5DW03t5yp66Tzn,SpATywNh6bZuzm8s1ceuBUnMUAeoAHHw,15,9,6,10,3,0,3,0,31,4.428571428571429,2,0.0,2,6,10,3,7,0,0,3,0,21,10,0
3763,118135,JMvgr9jBzvLjspIkuYALsrL220eD0j0v,bWdj2GDclj5ofokWjzoa5jAwMkxCykd6,8,4,3,0,3,0,6,0,16,2.2857142857142856,1,0.0,0,3,0,3,4,0,0,6,0,6,10,1
3764,118136,9YxIQGUlsiIIuBjadM8J3jzezyJ6kq36,G8EPVSXsOYB5YQWZGiz1aVq5Pgr2GrQu,4,2,0,0,0,0,2,0,4,0.5714285714285714,1,0.0,0,0,0,0,2,0,0,2,0,0,4,1
3765,118145,CUEyHbsjLlbX6I7tsbnNjxFI1v5Lj4iD,SpATywNh6bZuzm8s1ceuBUnMUAeoAHHw,6,9,3,0,1,0,4,0,17,2.4285714285714284,3,0.0,0,3,0,1,9,0,0,4,0,4,13,0
3766,118153,UwereIH21fVhvJGOSErkxB1cQ9i013xS,SpATywNh6bZuzm8s1ceuBUnMUAeoAHHw,4,2,1,0,0,0,2,0,5,0.7142857142857143,1,0.0,0,1,0,0,2,0,0,2,0,1,4,0
3767,118159,Wwe1S3XdwkCpnmMkWe7RNAVs8cVL63mN,RXDvfPUBYFlVdlueBFbLW0mhhAyGEqpt,11,14,1,0,1,0,5,0,21,3.0,1,0.0,0,1,0,1,14,0,0,5,0,2,19,1
3768,118165,cQJEH4N9NA86ElT2x4zkE6ToN6rVT4MQ,RXDvfPUBYFlVdlueBFbLW0mhhAyGEqpt,19,18,14,16,7,0,3,0,58,8.285714285714286,4,0.0,2,14,15,7,16,0,1,3,0,38,20,1
3769,118171,U3R4m4eLMm2lirgI7HLueBKsNpxhFpn9,A3fsA9Zfv1X2fVEQhTw51lKENdNrEqT3,6,6,4,4,0,0,2,0,16,2.2857142857142856,2,0.0,0,4,4,0,6,0,0,2,0,8,8,0
3770,118178,qAVFbR5cx9X92KNDPDJmLoSTth8nEsRM,RXDvfPUBYFlVdlueBFbLW0mhhAyGEqpt,4,16,6,0,0,0,7,0,29,4.142857142857143,5,0.0,0,6,0,0,16,0,0,7,0,6,23,0
3771,118201,P6CjwZWiHeS0SJlPQAf4bN1TR1u7fnyP,bWdj2GDclj5ofokWjzoa5jAwMkxCykd6,1,0,0,0,0,0,1,0,1,0.14285714285714285,1,0.0,0,0,0,0,0,0,0,1,0,0,1,1
3772,118207,K1IFYdQkJo7QdfpjXetMWMiwm2r5nqZr,SpATywNh6bZuzm8s1ceuBUnMUAeoAHHw,5,3,1,0,0,0,3,0,7,1.0,1,0.0,0,1,0,0,3,0,0,3,0,1,6,1
3773,118209,5R4HgbQ9BkBXMi8Hq5UrA8kCLhbx6Nxh,SpATywNh6bZuzm8s1ceuBUnMUAeoAHHw,21,15,11,9,6,0,2,0,43,6.142857142857143,2,0.0,0,11,7,6,15,0,2,2,0,24,19,1
3774,118220,XzisIBOnMp6oTIH0sCLKHdwnfcGCSxLi,SpATywNh6bZuzm8s1ceuBUnMUAeoAHHw,5,2,1,0,1,0,4,0,8,1.1428571428571428,1,0.0,0,1,0,1,2,0,0,4,0,2,6,1
3775,118222,IONYwfWuSLUzRHMHVpaPTPvGauCNosjD,SpATywNh6bZuzm8s1ceuBUnMUAeoAHHw,11,17,12,0,8,1,2,0,40,5.714285714285714,2,0.0,3,12,0,8,14,1,0,2,0,23,17,1
3776,118237,rT3zpA0g6rjJ1jZXfn6mCIcHmMcmU756,SpATywNh6bZuzm8s1ceuBUnMUAeoAHHw,3,2,1,0,0,1,1,0,5,0.7142857142857143,1,0.0,0,1,0,0,2,1,0,1,0,1,4,1
3777,118241,5R4HgbQ9BkBXMi8Hq5UrA8kCLhbx6Nxh,G8EPVSXsOYB5YQWZGiz1aVq5Pgr2GrQu,8,4,3,0,3,0,1,0,11,1.5714285714285714,1,0.0,0,3,0,3,4,0,0,1,0,6,5,1
3778,118247,j7aoEpW6aHY6ARo8v41e8m4DhCg6TYM9,SpATywNh6bZuzm8s1ceuBUnMUAeoAHHw,20,19,9,5,7,0,3,0,43,6.142857142857143,1,0.0,2,9,4,7,17,0,1,3,0,22,21,1
3779,118267,GyWTABuPpZEqO585EnNTIpM2B2faPYN3,SpATywNh6bZuzm8s1ceuBUnMUAeoAHHw,5,3,2,0,0,0,2,0,7,1.0,1,0.0,0,2,0,0,3,0,0,2,0,2,5,1
3780,118277,LULTOx14kVdHaym020tyvEUUMDRXiDOf,SpATywNh6bZuzm8s1ceuBUnMUAeoAHHw,6,4,3,0,1,0,3,0,11,1.5714285714285714,2,0.0,0,3,0,1,4,0,0,3,0,4,7,1
3781,118284,iRkGn6DaWx0LZKTkLTjixCrksMnftQiz,SpATywNh6bZuzm8s1ceuBUnMUAeoAHHw,11,9,0,12,0,0,1,0,22,3.142857142857143,1,0.0,2,0,10,0,7,0,2,1,0,12,10,1
3782,118295,wlSHoMLYlXnNV9DeRulnbWIuryuBkIhv,RXDvfPUBYFlVdlueBFbLW0mhhAyGEqpt,1,0,0,0,0,0,1,0,1,0.14285714285714285,1,0.0,0,0,0,0,0,0,0,1,0,0,1,1
3783,118321,vCel5g8zGhrngsDNZ5YOyxEmQk5qV7ac,bWdj2GDclj5ofokWjzoa5jAwMkxCykd6,1,0,0,0,0,0,2,0,2,0.2857142857142857,2,0.0,0,0,0,0,0,0,0,2,0,0,2,1
3784,118324,QRV1oI1S8Ffuh8TqoOSVsQ6W4xedCLat,SpATywNh6bZuzm8s1ceuBUnMUAeoAHHw,3,8,1,0,0,0,3,0,12,1.7142857142857142,3,0.0,0,1,0,0,8,0,0,3,0,1,11,0
3785,118328,oyFfPK6y9oPPwQR5mbsXW98FJaEnU88b,RXDvfPUBYFlVdlueBFbLW0mhhAyGEqpt,21,15,11,25,6,0,1,0,58,8.285714285714286,1,0.0,2,11,22,6,13,0,3,1,0,41,17,1
3786,118336,50cUUtrBaOZeeifZra0Sj4seKRuBEyFS,SpATywNh6bZuzm8s1ceuBUnMUAeoAHHw,19,41,4,21,0,2,8,1,77,11.0,6,0.0,13,4,18,0,28,2,3,8,1,35,42,0
3787,118363,FOCCuGaJ7zYTl7CCCo7T3PqrLtxGVeiU,SpATywNh6bZuzm8s1ceuBUnMUAeoAHHw,25,31,0,24,0,8,13,2,78,11.142857142857142,3,0.0,11,0,21,0,20,8,3,13,2,32,46,0
3788,118375,iCakYP1w40pz3A1o7VgcbnomKTMQfUiT,SpATywNh6bZuzm8s1ceuBUnMUAeoAHHw,12,9,6,0,5,0,1,0,21,3.0,1,0.0,0,6,0,5,9,0,0,1,0,11,10,1
3789,118395,LVTU4qA4F3wWkxH81iGfu4ZuIt77nyhh,A3fsA9Zfv1X2fVEQhTw51lKENdNrEqT3,6,3,1,0,1,0,4,0,9,1.2857142857142858,1,0.0,0,1,0,1,3,0,0,4,0,2,7,0
3790,118399,DMK7oEoztjNgXbVpWXavlWU4oVL3bMJ2,bWdj2GDclj5ofokWjzoa5jAwMkxCykd6,1,0,0,0,0,0,1,0,1,0.14285714285714285,1,0.0,0,0,0,0,0,0,0,1,0,0,1,1
3791,118423,9iGaqBGS5kkoXjLd87hUL2eIJMVUVKfU,bWdj2GDclj5ofokWjzoa5jAwMkxCykd6,3,2,1,0,0,0,1,0,4,0.5714285714285714,1,0.0,0,1,0,0,2,0,0,1,0,1,3,1
3792,118427,ycOAtB1gwFcaAwvsqsJPeGAqm0EVwIDN,G8EPVSXsOYB5YQWZGiz1aVq5Pgr2GrQu,3,2,0,0,0,0,3,0,5,0.7142857142857143,1,0.0,0,0,0,0,2,0,0,3,0,0,5,1
3793,118432,LFsOk9gu14yLVtdY9pNmboBkRA6YhVq4,SpATywNh6bZuzm8s1ceuBUnMUAeoAHHw,1,0,0,0,0,0,1,0,1,0.14285714285714285,1,0.0,0,0,0,0,0,0,0,1,0,0,1,1
3794,118453,X285XxvFlCKmuDlV3vzMxZpCu1V9X67P,G8EPVSXsOYB5YQWZGiz1aVq5Pgr2GrQu,17,18,7,36,3,0,1,0,65,9.285714285714286,1,0.0,10,7,30,3,8,0,6,1,0,50,15,1
3795,118464,zGN54ktgVO57s42kNnMz1KyURivx1q9t,bWdj2GDclj5ofokWjzoa5jAwMkxCykd6,1,0,0,0,0,0,1,0,1,0.14285714285714285,1,0.0,0,0,0,0,0,0,0,1,0,0,1,1
3796,118469,HlHSVt6QwV3D8zM3oQa4RZqHTHgBTeDb,G8EPVSXsOYB5YQWZGiz1aVq5Pgr2GrQu,7,3,3,0,0,1,4,1,12,1.7142857142857142,1,0.0,0,3,0,0,3,1,0,4,1,3,9,1
3797,118484,grhneBVDCBhvBD53OXACTDGfdH3pEWQ2,SpATywNh6bZuzm8s1ceuBUnMUAeoAHHw,3,14,3,0,0,0,7,0,24,3.4285714285714284,6,0.0,0,3,0,0,14,0,0,7,0,3,21,0
3798,118497,D42av4RgpD46CqlOrc3UqYUQGU69fX7w,SpATywNh6bZuzm8s1ceuBUnMUAeoAHHw,6,6,3,0,2,0,0,0,11,1.5714285714285714,1,0.0,0,3,0,2,6,0,0,0,0,5,6,1
3799,118503,AT8SDkvzrK4J3OL7I6ScWwycekA3DBUB,bWdj2GDclj5ofokWjzoa5jAwMkxCykd6,2,0,0,0,0,0,3,0,3,0.42857142857142855,1,0.0,0,0,0,0,0,0,0,3,0,0,3,1
3800,118517,AADHk2CnqIXqU54SVoJYYzHXkzsT7VVX,SpATywNh6bZuzm8s1ceuBUnMUAeoAHHw,6,10,5,0,0,0,5,0,20,2.857142857142857,2,0.0,1,5,0,0,9,0,0,5,0,6,14,0
3801,118525,ZPaxHFRYfWHILqdYYtzCUV3i0tOspO75,SpATywNh6bZuzm8s1ceuBUnMUAeoAHHw,9,3,2,0,1,3,10,2,21,3.0,1,0.0,0,2,0,1,3,3,0,10,2,3,18,1
3802,118542,bwCuicApqXH6S91HqGdXTXLfYA9d5SDK,RXDvfPUBYFlVdlueBFbLW0mhhAyGEqpt,1,0,0,0,0,0,1,0,1,0.14285714285714285,1,0.0,0,0,0,0,0,0,0,1,0,0,1,1
3803,118557,p5WcSuRgNcVvsptKJrB8fiizrHjqBhQI,bWdj2GDclj5ofokWjzoa5jAwMkxCykd6,1,0,0,0,0,0,1,0,1,0.14285714285714285,1,0.0,0,0,0,0,0,0,0,1,0,0,1,1
3804,118567,TQy9wSoPujib2kvNE4TTZJIA8yQmRsFr,bWdj2GDclj5ofokWjzoa5jAwMkxCykd6,1,2,0,0,0,0,0,0,2,0.2857142857142857,1,0.0,0,0,0,0,2,0,0,0,0,0,2,1
3805,118582,P27ziZ47DXA6Hi97vj6kZGIGFjWpnnsR,SpATywNh6bZuzm8s1ceuBUnMUAeoAHHw,8,4,2,0,2,0,2,0,10,1.4285714285714286,1,0.0,0,2,0,2,4,0,0,2,0,4,6,1
3806,118589,r0yZNwEG828V0TMkCl61Reya5Y5HO5aR,bWdj2GDclj5ofokWjzoa5jAwMkxCykd6,3,3,1,0,0,0,2,0,6,0.8571428571428571,1,0.0,0,1,0,0,3,0,0,2,0,1,5,0
3807,118592,RiCs84yGV6JCwVfBOhcXa8oCpUMbIJNf,SpATywNh6bZuzm8s1ceuBUnMUAeoAHHw,3,2,0,0,0,0,3,0,5,0.7142857142857143,2,0.0,0,0,0,0,2,0,0,3,0,0,5,0
3808,118611,OPuJXMBkJWOSkPuaVgsFtLgnzHpMTbpE,SpATywNh6bZuzm8s1ceuBUnMUAeoAHHw,7,2,1,0,1,0,4,0,8,1.1428571428571428,1,0.0,0,1,0,1,2,0,0,4,0,2,6,1
3809,118618,TQ8OFVc2xBKvPKyjEssWVNNgqzlZ0PAa,bWdj2GDclj5ofokWjzoa5jAwMkxCykd6,38,55,31,197,15,2,11,0,311,44.42857142857143,5,0.0,10,31,172,15,45,2,25,11,0,228,83,0
3810,118626,sjQQWItXAp5E8ocdOnRRzFCiZKv0PVqn,SpATywNh6bZuzm8s1ceuBUnMUAeoAHHw,1,0,0,0,0,0,2,0,2,0.2857142857142857,2,0.0,0,0,0,0,0,0,0,2,0,0,2,0
3811,118627,PpZEAa1Mdati01h1lf363alLOjmVtvBB,bWdj2GDclj5ofokWjzoa5jAwMkxCykd6,5,0,0,0,0,1,4,1,6,0.8571428571428571,1,0.0,0,0,0,0,0,1,0,4,1,0,6,1
3812,118629,f4eElh7NTKGsWnUHRO9BuyTOQtrsnWlM,SpATywNh6bZuzm8s1ceuBUnMUAeoAHHw,2,0,0,0,0,3,1,0,4,0.5714285714285714,1,0.0,0,0,0,0,0,3,0,1,0,0,4,1
3813,118633,NuFKQkAxfn2PT3wbGN0i3erkBYbjqkix,A3fsA9Zfv1X2fVEQhTw51lKENdNrEqT3,4,3,0,0,0,0,2,0,5,0.7142857142857143,1,0.0,0,0,0,0,3,0,0,2,0,0,5,0
3814,118635,U6N64321JOuc5ylM9RcniwscGjdKavd0,bWdj2GDclj5ofokWjzoa5jAwMkxCykd6,1,0,0,0,0,0,1,0,1,0.14285714285714285,1,0.0,0,0,0,0,0,0,0,1,0,0,1,1
3815,118651,ANtHTaCISHkEW6ENLanE6G1HEnRFLZdw,SpATywNh6bZuzm8s1ceuBUnMUAeoAHHw,3,2,1,0,0,0,1,0,4,0.5714285714285714,1,0.0,0,1,0,0,2,0,0,1,0,1,3,1
3816,118662,ANtHTaCISHkEW6ENLanE6G1HEnRFLZdw,RXDvfPUBYFlVdlueBFbLW0mhhAyGEqpt,3,2,1,0,0,0,2,0,5,0.7142857142857143,2,0.0,0,1,0,0,2,0,0,2,0,1,4,1
3817,118665,eNgDL8k9xOLyBlZ3UNlseJHly8SfPZZu,A3fsA9Zfv1X2fVEQhTw51lKENdNrEqT3,11,10,7,0,2,0,6,0,25,3.5714285714285716,4,0.0,0,7,0,2,10,0,0,6,0,9,16,0
3818,118667,oamKaVYtYcTWlWXxR9gjWFZVaqJSv9QD,RXDvfPUBYFlVdlueBFbLW0mhhAyGEqpt,7,10,3,0,3,1,4,0,21,3.0,2,0.0,1,3,0,3,9,1,0,4,0,7,14,0
3819,118672,dtI4aHSJprK2Oz02958rC7RUVW99jWdh,SpATywNh6bZuzm8s1ceuBUnMUAeoAHHw,10,5,4,7,2,0,2,0,20,2.857142857142857,1,0.0,0,4,6,2,5,0,1,2,0,12,8,1
3820,118692,34Xbf7uBGJ4LnJBXPtvvptwjUQQdkYUg,A3fsA9Zfv1X2fVEQhTw51lKENdNrEqT3,34,38,14,68,5,7,14,1,147,21.0,2,0.0,1,14,59,5,37,7,9,14,1,79,68,0
3821,118695,DvqqmzfQOqhniG6rRYaSYRCVzVLc6KPG,bWdj2GDclj5ofokWjzoa5jAwMkxCykd6,1,0,0,0,0,0,1,0,1,0.14285714285714285,1,0.0,0,0,0,0,0,0,0,1,0,0,1,1
3822,118697,xMj985YGbnpmmaLLf9WHP3PHD8Af4HUa,SpATywNh6bZuzm8s1ceuBUnMUAeoAHHw,7,2,1,0,1,0,6,1,11,1.5714285714285714,1,0.0,0,1,0,1,2,0,0,6,1,2,9,1
3823,118711,uIfDz0U6olmuGEmtRQWevpWq94B8FOe9,SpATywNh6bZuzm8s1ceuBUnMUAeoAHHw,5,2,1,0,1,0,2,0,6,0.8571428571428571,1,0.0,0,1,0,1,2,0,0,2,0,2,4,1
3824,118713,GzZqgl4giqqW7TCBTX5a2jDyy6Q646Os,SpATywNh6bZuzm8s1ceuBUnMUAeoAHHw,5,4,0,0,0,0,1,0,5,0.7142857142857143,1,0.0,0,0,0,0,4,0,0,1,0,0,5,1
3825,118738,I3IAdtd399keUxdhVZ1J3PIkz3kC7zL8,RXDvfPUBYFlVdlueBFbLW0mhhAyGEqpt,21,23,2,34,7,0,2,0,68,9.714285714285714,2,0.0,14,2,31,7,9,0,3,2,0,54,14,1
3826,118752,v5ZzaFsvASHZHFHDQx30X4bWu2OAn0TJ,bWdj2GDclj5ofokWjzoa5jAwMkxCykd6,1,0,0,0,0,0,1,0,1,0.14285714285714285,1,0.0,0,0,0,0,0,0,0,1,0,0,1,1
3827,118765,GGymFCz4p00DxUzTcaDeYIcqN4hoSzTk,SpATywNh6bZuzm8s1ceuBUnMUAeoAHHw,1,0,0,0,0,0,1,0,1,0.14285714285714285,1,0.0,0,0,0,0,0,0,0,1,0,0,1,1
3828,118771,lrp5AGJUh69hKuCI5IYUEU19E2beipwd,A3fsA9Zfv1X2fVEQhTw51lKENdNrEqT3,38,28,2,96,0,16,3,0,145,20.714285714285715,3,0.0,1,2,81,0,27,16,15,3,0,84,61,1
3829,118774,DqNAxwTcrk055KEf1va6hv0cFfrqGSiY,A3fsA9Zfv1X2fVEQhTw51lKENdNrEqT3,10,11,9,0,7,0,2,0,29,4.142857142857143,1,0.0,0,9,0,7,11,0,0,2,0,16,13,1
3830,118783,bKVslXuzEQ1pv4c6iV5mVjs6X6avUbmL,G8EPVSXsOYB5YQWZGiz1aVq5Pgr2GrQu,7,4,2,0,1,0,3,0,10,1.4285714285714286,2,0.0,0,2,0,1,4,0,0,3,0,3,7,0
3831,118800,AXOBQLaknxwaGBasKpj34YfhU436HR6z,G8EPVSXsOYB5YQWZGiz1aVq5Pgr2GrQu,24,31,12,10,10,0,20,1,84,12.0,4,0.0,8,12,5,10,23,0,5,20,1,35,49,0
3832,118816,v25EcAT5A0ySpzSARJj7hsNjPFXZUc3f,bWdj2GDclj5ofokWjzoa5jAwMkxCykd6,8,10,2,98,3,0,11,0,124,17.714285714285715,1,0.0,6,2,97,3,4,0,1,11,0,108,16,1
3833,118825,j9NZdBIxAXb3GeboncXceewydTlKXuYz,bWdj2GDclj5ofokWjzoa5jAwMkxCykd6,6,4,3,0,3,0,1,0,11,1.5714285714285714,1,0.0,0,3,0,3,4,0,0,1,0,6,5,1
3834,118828,QXEPfF2pAnokf1BSO0tTVCPJ0yWgZtcC,SpATywNh6bZuzm8s1ceuBUnMUAeoAHHw,6,5,1,0,0,0,2,1,9,1.2857142857142858,1,0.0,0,1,0,0,5,0,0,2,1,1,8,1
3835,118858,uvmnuTMWO7CUJMGmbknJbfcrAcbdWpqR,SpATywNh6bZuzm8s1ceuBUnMUAeoAHHw,1,0,0,0,0,0,1,0,1,0.14285714285714285,1,0.0,0,0,0,0,0,0,0,1,0,0,1,1
3836,118862,uvmnuTMWO7CUJMGmbknJbfcrAcbdWpqR,bWdj2GDclj5ofokWjzoa5jAwMkxCykd6,1,0,0,0,0,0,1,0,1,0.14285714285714285,1,0.0,0,0,0,0,0,0,0,1,0,0,1,1
3837,118863,uvmnuTMWO7CUJMGmbknJbfcrAcbdWpqR,RXDvfPUBYFlVdlueBFbLW0mhhAyGEqpt,1,0,0,0,0,0,1,0,1,0.14285714285714285,1,0.0,0,0,0,0,0,0,0,1,0,0,1,1
3838,118876,eLhnZqVqldawLLuaLdbS0XPiIKiZAief,RXDvfPUBYFlVdlueBFbLW0mhhAyGEqpt,4,2,0,0,0,0,2,0,4,0.5714285714285714,1,0.0,0,0,0,0,2,0,0,2,0,0,4,0
3839,118879,wuMhhjy7NxtqcBPxbigACLOqg9Xy71R7,SpATywNh6bZuzm8s1ceuBUnMUAeoAHHw,30,53,24,38,9,1,12,0,137,19.571428571428573,4,0.0,20,24,32,9,33,1,6,12,0,85,52,0
3840,118885,a3fDqs2SnQqVu7YeLa2fNuIYzGrHnHDE,SpATywNh6bZuzm8s1ceuBUnMUAeoAHHw,7,8,0,0,0,1,4,0,13,1.8571428571428572,1,0.0,0,0,0,0,8,1,0,4,0,0,13,1
3841,118889,a3fDqs2SnQqVu7YeLa2fNuIYzGrHnHDE,bWdj2GDclj5ofokWjzoa5jAwMkxCykd6,5,2,0,0,0,0,3,0,5,0.7142857142857143,1,0.0,0,0,0,0,2,0,0,3,0,0,5,1
3842,118913,xUhDcXiX03QQg1jNR3Lksh9CrGcRUkPg,A3fsA9Zfv1X2fVEQhTw51lKENdNrEqT3,10,11,7,0,5,38,5,0,66,9.428571428571429,3,0.0,2,7,0,5,9,38,0,5,0,14,52,0
3843,118918,TOHE2cn8sx2ym4g7cRhp3c9gQIpGV4UB,SpATywNh6bZuzm8s1ceuBUnMUAeoAHHw,10,10,5,0,2,1,8,1,27,3.857142857142857,2,0.0,2,5,0,2,8,1,0,8,1,9,18,1
3844,118926,efygWYkxxUMOGInRZT4qEeuzMRlIpQq6,SpATywNh6bZuzm8s1ceuBUnMUAeoAHHw,9,7,3,7,0,0,4,0,21,3.0,2,0.0,2,3,7,0,5,0,0,4,0,12,9,0
3845,118930,fiLsrcAU0ZFm61T8xhRUwb5p8PN605CT,SpATywNh6bZuzm8s1ceuBUnMUAeoAHHw,5,5,3,0,0,0,4,0,12,1.7142857142857142,2,0.0,0,3,0,0,5,0,0,4,0,3,9,1
3846,118931,ZRfFWalEoINhUGe05gZETSGzjQUd6T5n,SpATywNh6bZuzm8s1ceuBUnMUAeoAHHw,16,12,8,10,5,0,2,0,37,5.285714285714286,3,0.0,2,8,8,5,10,0,2,2,0,23,14,1
3847,118943,6hOFMnbpcErHmlwc3MeiSQOkkbkZvsdF,SpATywNh6bZuzm8s1ceuBUnMUAeoAHHw,3,6,3,0,0,0,2,0,11,1.5714285714285714,1,0.0,0,3,0,0,6,0,0,2,0,3,8,0
3848,118993,5R2yvtH9LNaB7I0DFs0y5Dgzft4SPkTz,SpATywNh6bZuzm8s1ceuBUnMUAeoAHHw,4,1,1,0,0,0,3,0,5,0.7142857142857143,1,0.0,0,1,0,0,1,0,0,3,0,1,4,1
3849,118995,UoQ0PEeqIO4n6Ln8avpcjf2ZoIAx1YCQ,A3fsA9Zfv1X2fVEQhTw51lKENdNrEqT3,29,11,5,106,3,0,3,0,128,18.285714285714285,3,0.0,1,5,89,3,10,0,17,3,0,98,30,0
3850,119001,DXaGQeTbJkNEulVow7g1qYtfMHcxt0Bb,SpATywNh6bZuzm8s1ceuBUnMUAeoAHHw,8,10,1,0,0,0,3,0,14,2.0,3,0.0,0,1,0,0,10,0,0,3,0,1,13,0
3851,119027,5tL0goZ0bMjNeuGHJZ9VZymSM6PzqaXn,SpATywNh6bZuzm8s1ceuBUnMUAeoAHHw,7,11,3,6,0,0,3,0,23,3.2857142857142856,2,0.0,6,3,6,0,5,0,0,3,0,15,8,0
3852,119043,D5jAgVwgvpw2Kr66NxyapnkPl0dnzBLu,A3fsA9Zfv1X2fVEQhTw51lKENdNrEqT3,1,0,0,0,0,0,14,0,14,2.0,6,0.0,0,0,0,0,0,0,0,14,0,0,14,1
3853,119057,pKoUS2SEKCFMATrFfyk1PMmORYo186Kb,G8EPVSXsOYB5YQWZGiz1aVq5Pgr2GrQu,23,17,1,54,0,0,1,0,73,10.428571428571429,1,0.0,2,1,48,0,15,0,6,1,0,51,22,0
3854,119104,jq4JfpgApzrMRuCNvYDPIsQTWPeEZuhJ,G8EPVSXsOYB5YQWZGiz1aVq5Pgr2GrQu,6,2,0,0,0,1,5,0,8,1.1428571428571428,1,0.0,0,0,0,0,2,1,0,5,0,0,8,1
3855,119109,PZtj1GnJa5qYIICIjESUcqp401L5vmnR,G8EPVSXsOYB5YQWZGiz1aVq5Pgr2GrQu,43,32,2,98,5,2,6,0,145,20.714285714285715,1,0.0,22,2,73,5,10,2,25,6,0,102,43,1
3856,119143,YMxXtA5A6XX1bdm998q3OXZqnuIpo8I0,SpATywNh6bZuzm8s1ceuBUnMUAeoAHHw,3,2,1,0,0,0,1,0,4,0.5714285714285714,1,0.0,0,1,0,0,2,0,0,1,0,1,3,0
3857,119192,NoA9xueUUthCTfidqnFplOKsMZsY3DHa,SpATywNh6bZuzm8s1ceuBUnMUAeoAHHw,1,0,0,0,0,0,2,0,2,0.2857142857142857,2,0.0,0,0,0,0,0,0,0,2,0,0,2,1
3858,119243,q3pPbgY0JhPpTgQfSrEbBAWd7rbmYjI4,SpATywNh6bZuzm8s1ceuBUnMUAeoAHHw,4,9,0,0,0,0,13,0,22,3.142857142857143,3,0.0,0,0,0,0,9,0,0,13,0,0,22,0
3859,119245,7RIgMHzHpMzY7qBXHPj6WiDKK3U9H2Wz,SpATywNh6bZuzm8s1ceuBUnMUAeoAHHw,3,2,1,0,0,0,1,0,4,0.5714285714285714,1,0.0,0,1,0,0,2,0,0,1,0,1,3,0
3860,119266,iacqYcgHTn7FZ8NE4roe5kgAUjDF0efr,SpATywNh6bZuzm8s1ceuBUnMUAeoAHHw,10,16,6,16,0,0,8,0,46,6.571428571428571,3,0.0,6,6,13,0,10,0,3,8,0,25,21,0
3861,119305,kLbYKjAePyQg6GOXHiVGeoyhhDvXEfjN,SpATywNh6bZuzm8s1ceuBUnMUAeoAHHw,7,15,0,0,0,1,4,0,20,2.857142857142857,1,0.0,6,0,0,0,9,1,0,4,0,6,14,0
3862,119309,kWr0BhoQMxiu9wSeKhtyX0T1P5JfsERH,SpATywNh6bZuzm8s1ceuBUnMUAeoAHHw,3,2,1,0,0,0,3,0,6,0.8571428571428571,3,0.0,0,1,0,0,2,0,0,3,0,1,5,0
3863,119325,grNuFIQJF1sOOkw8RJjaExhlwTJt52uU,SpATywNh6bZuzm8s1ceuBUnMUAeoAHHw,10,11,7,0,0,9,9,3,39,5.571428571428571,2,0.0,1,7,0,0,10,9,0,9,3,8,31,0
3864,119330,Xx6t23p3XIha0hNmBziFcHG3GcEwTmQl,SpATywNh6bZuzm8s1ceuBUnMUAeoAHHw,5,4,2,0,0,1,4,0,11,1.5714285714285714,1,0.0,0,2,0,0,4,1,0,4,0,2,9,0
3865,119372,RwvuGEh3euIR11rktJrGBhzDqcQMkhOC,SpATywNh6bZuzm8s1ceuBUnMUAeoAHHw,1,0,0,0,0,0,1,0,1,0.14285714285714285,1,0.0,0,0,0,0,0,0,0,1,0,0,1,0
3866,119401,rSKz43hYiPnNMTLyx15fL1ocrthBLweg,SpATywNh6bZuzm8s1ceuBUnMUAeoAHHw,7,3,2,0,0,3,6,7,21,3.0,1,0.0,0,2,0,0,3,3,0,6,7,2,19,1
3867,119413,HNjmezOX8bu6iW67SYkfKBzixQs4v7AY,SpATywNh6bZuzm8s1ceuBUnMUAeoAHHw,22,23,15,8,5,12,6,1,70,10.0,2,0.0,6,15,8,5,17,12,0,6,1,34,36,0
3868,119422,8bsgdKFaSfwROHIZCKXm97BMUW4OFzed,SpATywNh6bZuzm8s1ceuBUnMUAeoAHHw,3,6,3,0,0,5,4,0,18,2.5714285714285716,2,0.0,0,3,0,0,6,5,0,4,0,3,15,0
3869,119437,WnuLHUQ0J3BeGgl165qL2l7BKuVDR3LS,RXDvfPUBYFlVdlueBFbLW0mhhAyGEqpt,6,4,1,0,1,0,1,0,7,1.0,1,0.0,0,1,0,1,4,0,0,1,0,2,5,0
3870,119461,6ZwHbtvdiS8islxnPJXOOnLtMpvU3IpT,SpATywNh6bZuzm8s1ceuBUnMUAeoAHHw,3,1,1,0,1,0,0,0,3,0.42857142857142855,1,0.0,0,1,0,1,1,0,0,0,0,2,1,0
3871,119482,S2q1gEPtloNcMfcAwTCrDjaeEJ3ox2aC,A3fsA9Zfv1X2fVEQhTw51lKENdNrEqT3,10,17,13,10,5,5,2,0,52,7.428571428571429,1,0.0,2,13,8,5,15,5,2,2,0,28,24,1
3872,119501,iWlNj0RlfLQkFgeY87o4tMiHnUMI1yTI,G8EPVSXsOYB5YQWZGiz1aVq5Pgr2GrQu,4,0,0,0,0,0,6,0,6,0.8571428571428571,1,0.0,0,0,0,0,0,0,0,6,0,0,6,1
3873,119515,0mqsqXT4HPDOQPxpDnEoZEe1KeuUzpQx,SpATywNh6bZuzm8s1ceuBUnMUAeoAHHw,7,12,1,2,0,0,2,0,17,2.4285714285714284,1,0.0,4,1,1,0,8,0,1,2,0,6,11,0
3874,119520,ZQcWT47pZxjNboL0V0inwxjvImMCbKfc,SpATywNh6bZuzm8s1ceuBUnMUAeoAHHw,2,0,0,0,0,0,3,0,3,0.42857142857142855,1,0.0,0,0,0,0,0,0,0,3,0,0,3,0
3875,119577,ZtIdVQN3EYruDP82MkDXBV4HsWJ99nHc,SpATywNh6bZuzm8s1ceuBUnMUAeoAHHw,1,0,0,0,0,0,1,0,1,0.14285714285714285,1,0.0,0,0,0,0,0,0,0,1,0,0,1,1
3876,119580,TnET23MWjnuobi5dYEzVGlV9qd1ZWPbL,A3fsA9Zfv1X2fVEQhTw51lKENdNrEqT3,32,29,22,0,14,0,0,0,65,9.285714285714286,1,0.0,0,22,0,14,29,0,0,0,0,36,29,0
3877,119603,RwVsCYe1en11KhE66sG3vEW9DQBctFlb,SpATywNh6bZuzm8s1ceuBUnMUAeoAHHw,20,23,14,15,7,0,5,0,64,9.142857142857142,2,0.0,5,14,15,7,18,0,0,5,0,41,23,1
3878,119633,owff2SMFy8taj2Sp3iBe2dPorkqov8kW,SpATywNh6bZuzm8s1ceuBUnMUAeoAHHw,3,2,2,0,2,0,0,0,6,0.8571428571428571,2,0.0,0,2,0,2,2,0,0,0,0,4,2,0
3879,119685,OOIu03NBEHePUSUIFa86FGFP5M136EAn,SpATywNh6bZuzm8s1ceuBUnMUAeoAHHw,1,0,0,0,0,0,2,0,2,0.2857142857142857,2,0.0,0,0,0,0,0,0,0,2,0,0,2,0
3880,119699,poqFOGQT2LdvIPHVhQsrQlPpawp1crlg,RXDvfPUBYFlVdlueBFbLW0mhhAyGEqpt,12,14,5,0,5,0,0,0,24,3.4285714285714284,1,0.0,0,5,0,5,14,0,0,0,0,10,14,0
3881,119742,PHTS4r6mOEHpVZfm3SzAd9KLg785EPpx,SpATywNh6bZuzm8s1ceuBUnMUAeoAHHw,12,19,9,12,3,7,5,0,55,7.857142857142857,3,0.0,3,9,12,3,16,7,0,5,0,27,28,0
3882,119748,wIXH3gEY2v8CIGUg8D6sapoHRbIUXs86,SpATywNh6bZuzm8s1ceuBUnMUAeoAHHw,4,2,1,0,0,0,2,0,5,0.7142857142857143,1,0.0,0,1,0,0,2,0,0,2,0,1,4,1
3883,119759,eXv6ACzt62C4hMSoDSIQMvmz4LEnGBtm,SpATywNh6bZuzm8s1ceuBUnMUAeoAHHw,5,2,1,0,0,0,8,0,11,1.5714285714285714,4,0.0,0,1,0,0,2,0,0,8,0,1,10,0
3884,119802,pgn1580cn8cQemEJzrm47II2SqctZZrK,G8EPVSXsOYB5YQWZGiz1aVq5Pgr2GrQu,4,5,1,0,1,0,1,0,8,1.1428571428571428,1,0.0,2,1,0,1,3,0,0,1,0,4,4,0
3885,119833,DhGcyoTp73fKDVPL51XtXQlMqfdtfXVc,SpATywNh6bZuzm8s1ceuBUnMUAeoAHHw,2,0,0,0,0,7,2,0,9,1.2857142857142858,1,0.0,0,0,0,0,0,7,0,2,0,0,9,1
3886,119878,T7izEMyckZ14Dpb0HXCCbCEgRCtemG2v,A3fsA9Zfv1X2fVEQhTw51lKENdNrEqT3,4,3,1,0,0,0,1,0,5,0.7142857142857143,1,0.0,0,1,0,0,3,0,0,1,0,1,4,1
3887,119923,nrDkIZH2wqEVh6i4pBxcbRBJIMc9s20b,SpATywNh6bZuzm8s1ceuBUnMUAeoAHHw,6,11,0,0,0,0,5,0,16,2.2857142857142856,2,0.0,2,0,0,0,9,0,0,5,0,2,14,0
3888,119935,4uCHoIviHPzCtwadirbZDGuLNqx4H5qx,SpATywNh6bZuzm8s1ceuBUnMUAeoAHHw,3,2,1,0,0,0,1,0,4,0.5714285714285714,1,0.0,0,1,0,0,2,0,0,1,0,1,3,0
3889,119942,D9eQoamtTDpiMV0b0OdGca728kthGUV3,SpATywNh6bZuzm8s1ceuBUnMUAeoAHHw,3,2,0,0,0,0,1,0,3,0.42857142857142855,1,0.0,0,0,0,0,2,0,0,1,0,0,3,0
3890,119974,VLq5RjmauxaFZfPnx2f9r9Dehjw868o9,SpATywNh6bZuzm8s1ceuBUnMUAeoAHHw,7,6,5,0,4,0,1,0,16,2.2857142857142856,1,0.0,0,5,0,4,6,0,0,1,0,9,7,0
3891,119983,8ZvgmVWPuU4xKWq9tw3YZdhhMDnHsFgT,SpATywNh6bZuzm8s1ceuBUnMUAeoAHHw,2,0,0,0,0,0,7,0,7,1.0,3,0.0,0,0,0,0,0,0,0,7,0,0,7,0
3892,120022,npXfYqxF0TCNN5vliwdRJdFcBk0rmfXv,bWdj2GDclj5ofokWjzoa5jAwMkxCykd6,6,2,0,0,0,1,9,1,13,1.8571428571428572,1,0.0,0,0,0,0,2,1,0,9,1,0,13,0
3893,120026,ZH0VWJ7XJWogjYH6Qq2Nr4TMh6fe5JGW,SpATywNh6bZuzm8s1ceuBUnMUAeoAHHw,1,0,0,0,0,0,1,0,1,0.14285714285714285,1,0.0,0,0,0,0,0,0,0,1,0,0,1,0
3894,120078,saXRSf4MnhO78zgLoljZlslavqJjBtLm,bWdj2GDclj5ofokWjzoa5jAwMkxCykd6,4,0,0,0,0,4,5,0,9,1.2857142857142858,2,0.0,0,0,0,0,0,4,0,5,0,0,9,1
3895,120088,ZOVfvlm206voHlGJ4V6McNGjtxTxB7JQ,A3fsA9Zfv1X2fVEQhTw51lKENdNrEqT3,15,8,7,0,6,0,1,0,22,3.142857142857143,2,0.0,0,7,0,6,8,0,0,1,0,13,9,1
3896,120111,aGyzysUQgcpficWqTygk8rcuo677dPZU,SpATywNh6bZuzm8s1ceuBUnMUAeoAHHw,20,40,11,25,2,0,4,0,82,11.714285714285714,3,0.0,18,11,20,2,22,0,5,4,0,51,31,0
3897,120118,cPZ5ch8V46zptI5nnRGh9SfMnAQrVDUi,bWdj2GDclj5ofokWjzoa5jAwMkxCykd6,5,6,1,0,0,0,1,0,8,1.1428571428571428,1,0.0,0,1,0,0,6,0,0,1,0,1,7,0
3898,120134,nKMPTOF6v1sp7aVmO78zmSRg9f9QXrTf,A3fsA9Zfv1X2fVEQhTw51lKENdNrEqT3,32,26,18,102,6,0,5,0,157,22.428571428571427,2,0.0,3,18,89,6,23,0,13,5,0,116,41,1
3899,120149,LY15AitabC9VNRy9N91XwsKL39G9Yhym,SpATywNh6bZuzm8s1ceuBUnMUAeoAHHw,1,0,0,0,0,0,1,0,1,0.14285714285714285,1,0.0,0,0,0,0,0,0,0,1,0,0,1,1
3900,120153,la15uCtK5VeDQX41dystrGx2B895Oqjw,RXDvfPUBYFlVdlueBFbLW0mhhAyGEqpt,1,0,0,0,0,0,1,0,1,0.14285714285714285,1,0.0,0,0,0,0,0,0,0,1,0,0,1,1
3901,120177,83cBV2IXkwoW1nUaa1kxaJ98L3bxFsPn,A3fsA9Zfv1X2fVEQhTw51lKENdNrEqT3,9,10,9,0,0,0,1,0,20,2.857142857142857,3,0.0,0,9,0,0,10,0,0,1,0,9,11,0
3902,120230,LY15AitabC9VNRy9N91XwsKL39G9Yhym,G8EPVSXsOYB5YQWZGiz1aVq5Pgr2GrQu,12,19,4,0,4,0,3,0,30,4.285714285714286,2,0.0,6,4,0,4,13,0,0,3,0,14,16,1
3903,120345,DsvMkutBFtLefRL1hsHU5bFQpdJBtlsH,SpATywNh6bZuzm8s1ceuBUnMUAeoAHHw,3,2,0,0,0,0,2,0,4,0.5714285714285714,1,0.0,0,0,0,0,2,0,0,2,0,0,4,1
3904,120371,XQgYe2uvAKPXdUiz5f6AHKp9LdPbPxAU,A3fsA9Zfv1X2fVEQhTw51lKENdNrEqT3,3,2,1,0,0,0,1,0,4,0.5714285714285714,1,0.0,0,1,0,0,2,0,0,1,0,1,3,1
3905,120435,OifsLGRBGBgFFNsSrNDnK5W8Vbn9qLGX,SpATywNh6bZuzm8s1ceuBUnMUAeoAHHw,1,1,0,0,0,0,0,0,1,0.14285714285714285,1,0.0,0,0,0,0,1,0,0,0,0,0,1,1
3906,120471,I6qoCcohBrCkqxmkans73ezft5aIvcN6,SpATywNh6bZuzm8s1ceuBUnMUAeoAHHw,4,2,1,0,0,0,2,0,5,0.7142857142857143,1,0.0,0,1,0,0,2,0,0,2,0,1,4,1
3907,120480,GJdrQdNnhszyte4F0GpLkVjDN5SstsoH,SpATywNh6bZuzm8s1ceuBUnMUAeoAHHw,3,7,1,0,0,0,3,0,11,1.5714285714285714,2,0.0,0,1,0,0,7,0,0,3,0,1,10,0
3908,120538,kJkXo4nSNqbMETrXDpi6P9tfSt1mYjrM,SpATywNh6bZuzm8s1ceuBUnMUAeoAHHw,4,4,2,0,0,0,3,0,9,1.2857142857142858,2,0.0,0,2,0,0,4,0,0,3,0,2,7,1
3909,120547,6T4qq3cdISFF5pyvVKMrcmEINY6BysCY,A3fsA9Zfv1X2fVEQhTw51lKENdNrEqT3,25,17,7,84,0,21,9,0,138,19.714285714285715,4,0.0,3,7,72,0,14,21,12,9,0,82,56,0
3910,120567,VL7NPBJuyzF1uV3nhlsl7JEimjvq8BIB,SpATywNh6bZuzm8s1ceuBUnMUAeoAHHw,1,0,0,0,0,0,3,0,3,0.42857142857142855,3,0.0,0,0,0,0,0,0,0,3,0,0,3,0
3911,120576,WIgM6nvV9YFBo82xFhtQp6923xmcbs69,SpATywNh6bZuzm8s1ceuBUnMUAeoAHHw,1,0,0,0,0,0,1,0,1,0.14285714285714285,1,0.0,0,0,0,0,0,0,0,1,0,0,1,0
3912,120580,tepLda5wSKMdrl1YSxQ7o9ErmWSmjLIs,SpATywNh6bZuzm8s1ceuBUnMUAeoAHHw,11,13,8,0,1,0,21,0,43,6.142857142857143,3,0.0,0,8,0,1,13,0,0,21,0,9,34,0
3913,120628,T84tM0SY1NeTwy8ZOUv1K7SYM12l3y0u,SpATywNh6bZuzm8s1ceuBUnMUAeoAHHw,4,9,1,0,0,0,1,0,11,1.5714285714285714,1,0.0,6,1,0,0,3,0,0,1,0,7,4,1
3914,120650,AqOYZE1KwO9ElxY4ESIL8wZt1KCX4QiQ,SpATywNh6bZuzm8s1ceuBUnMUAeoAHHw,1,0,0,0,0,0,2,0,2,0.2857142857142857,2,0.0,0,0,0,0,0,0,0,2,0,0,2,0
3915,120654,8eYQfp27L4KqSIcQS2lfdmoY7VEE1qFC,RXDvfPUBYFlVdlueBFbLW0mhhAyGEqpt,3,2,1,0,0,0,1,0,4,0.5714285714285714,1,0.0,0,1,0,0,2,0,0,1,0,1,3,1
3916,120707,YBlpuOz29CjjHYq0RuGLiSzLtjKLdYy2,RXDvfPUBYFlVdlueBFbLW0mhhAyGEqpt,11,15,4,0,0,0,6,0,25,3.5714285714285716,2,0.0,0,4,0,0,15,0,0,6,0,4,21,0
3917,120743,es5GTyNQHE6XqsHqRasxkSTkn6q7y8k2,SpATywNh6bZuzm8s1ceuBUnMUAeoAHHw,4,2,0,0,0,0,2,0,4,0.5714285714285714,1,0.0,0,0,0,0,2,0,0,2,0,0,4,0
3918,120755,PQyLGsdBWhEy27jacipkmntLAvcsGeQa,SpATywNh6bZuzm8s1ceuBUnMUAeoAHHw,5,6,3,0,0,0,1,0,10,1.4285714285714286,1,0.0,2,3,0,0,4,0,0,1,0,5,5,0
3919,120768,lu6LWsHgfburMRdWsFabIR2bIQ3MFD6f,RXDvfPUBYFlVdlueBFbLW0mhhAyGEqpt,6,4,0,10,0,0,3,0,17,2.4285714285714284,2,0.0,1,0,9,0,3,0,1,3,0,10,7,0
3920,120807,KHl8vTLwoQOTsjJg2pVXTnG0Is0a8K1K,SpATywNh6bZuzm8s1ceuBUnMUAeoAHHw,3,2,0,0,0,0,1,0,3,0.42857142857142855,1,0.0,0,0,0,0,2,0,0,1,0,0,3,1
3921,120878,edVuZXQuYE4LHUfAzzB1uGhpYsPr0vJx,SpATywNh6bZuzm8s1ceuBUnMUAeoAHHw,1,0,0,0,0,0,1,0,1,0.14285714285714285,1,0.0,0,0,0,0,0,0,0,1,0,0,1,0
3922,120896,u5ObOMoHUcvVsOQTGkiv0BRKKcn8v2w8,A3fsA9Zfv1X2fVEQhTw51lKENdNrEqT3,9,15,10,0,7,0,2,0,34,4.857142857142857,1,0.0,0,10,0,7,15,0,0,2,0,17,17,0
3923,120927,4bcOXBC1lhgwF9Pg3IMx9vJFVwNtFyik,SpATywNh6bZuzm8s1ceuBUnMUAeoAHHw,4,6,3,0,0,0,3,0,12,1.7142857142857142,1,0.0,0,3,0,0,6,0,0,3,0,3,9,1
3924,120936,i0ksX07HnsV5rQlWqOr1uKEuc7yNU24c,A3fsA9Zfv1X2fVEQhTw51lKENdNrEqT3,3,2,1,0,0,0,1,0,4,0.5714285714285714,1,0.0,0,1,0,0,2,0,0,1,0,1,3,0
3925,120948,TevGcL3mCy823FJCU3MpLHqDSnMlx8KC,SpATywNh6bZuzm8s1ceuBUnMUAeoAHHw,3,2,1,0,0,0,1,0,4,0.5714285714285714,1,0.0,0,1,0,0,2,0,0,1,0,1,3,0
3926,120953,HGkuwdB1J817cl9wl529SZa2OTu14HFB,SpATywNh6bZuzm8s1ceuBUnMUAeoAHHw,5,4,2,0,0,0,6,0,12,1.7142857142857142,2,0.0,0,2,0,0,4,0,0,6,0,2,10,0
3927,120969,hNYqJEuS1AXT481SIEkT37fZObOmjXuX,G8EPVSXsOYB5YQWZGiz1aVq5Pgr2GrQu,4,5,3,0,0,0,1,0,9,1.2857142857142858,1,0.0,0,3,0,0,5,0,0,1,0,3,6,1
3928,121001,k2w7Fl2HRg9SZoDIHFnK8RXCKuBBE2y7,A3fsA9Zfv1X2fVEQhTw51lKENdNrEqT3,33,18,10,52,6,0,4,0,90,12.857142857142858,2,0.0,1,10,47,6,17,0,5,4,0,64,26,1
3929,121053,npZiJYBXIvuULdTyVSfZOjhsnEdX6i82,SpATywNh6bZuzm8s1ceuBUnMUAeoAHHw,1,0,0,0,0,0,2,0,2,0.2857142857142857,2,0.0,0,0,0,0,0,0,0,2,0,0,2,0
3930,121085,hWWjbjEJOX0Ph07p1EJp8Ya48hU8wP5v,SpATywNh6bZuzm8s1ceuBUnMUAeoAHHw,2,0,0,0,0,0,2,0,2,0.2857142857142857,1,0.0,0,0,0,0,0,0,0,2,0,0,2,0
3931,121101,34fQh4AyuAWML6hByTmQJCsftdAFH2Hu,SpATywNh6bZuzm8s1ceuBUnMUAeoAHHw,4,3,1,0,0,0,1,0,5,0.7142857142857143,1,0.0,0,1,0,0,3,0,0,1,0,1,4,1
3932,121122,GlVmjWGZ8XsOuLGdZvtzRw0xzELGNzxx,bWdj2GDclj5ofokWjzoa5jAwMkxCykd6,2,3,1,0,0,0,0,0,4,0.5714285714285714,1,0.0,0,1,0,0,3,0,0,0,0,1,3,1
3933,121141,YhSlQp6TZH2sVWIgjyn2YxpekmOBzjQt,SpATywNh6bZuzm8s1ceuBUnMUAeoAHHw,1,0,0,0,0,0,1,0,1,0.14285714285714285,1,0.0,0,0,0,0,0,0,0,1,0,0,1,0
3934,121145,atoEVjauO8UqqxbDs90qm3bNJMwCLIt0,SpATywNh6bZuzm8s1ceuBUnMUAeoAHHw,29,24,11,27,7,6,4,0,79,11.285714285714286,1,0.0,10,11,22,7,14,6,5,4,0,50,29,0
3935,121161,Yl3fWDphM6Ifhmu0NrJgclA0dIl02Kms,A3fsA9Zfv1X2fVEQhTw51lKENdNrEqT3,7,4,3,0,2,0,1,0,10,1.4285714285714286,1,0.0,0,3,0,2,4,0,0,1,0,5,5,1
3936,121171,w81M8LsxqroaoVvhuOiOu12ogu2TTrVp,SpATywNh6bZuzm8s1ceuBUnMUAeoAHHw,1,0,0,0,0,0,1,0,1,0.14285714285714285,1,0.0,0,0,0,0,0,0,0,1,0,0,1,1
3937,121205,irUhnQtLaQWO9Ilnw5LLg2nfVwuwwh1f,SpATywNh6bZuzm8s1ceuBUnMUAeoAHHw,1,1,0,0,0,0,0,0,1,0.14285714285714285,1,0.0,0,0,0,0,1,0,0,0,0,0,1,1
3938,121225,6lL0tobxamv6kkGYMIOtqqnjmWQC4apa,A3fsA9Zfv1X2fVEQhTw51lKENdNrEqT3,1,0,0,0,0,0,1,0,1,0.14285714285714285,1,0.0,0,0,0,0,0,0,0,1,0,0,1,1
3939,121334,X9tesPfVRQu9R7pVopuvpFNecLnZt8Km,SpATywNh6bZuzm8s1ceuBUnMUAeoAHHw,6,4,2,0,0,0,5,1,12,1.7142857142857142,1,0.0,0,2,0,0,4,0,0,5,1,2,10,1
3940,121350,OaR2omePx63fXdBiAV1sA954f6IcbIvq,A3fsA9Zfv1X2fVEQhTw51lKENdNrEqT3,1,0,0,0,0,0,1,0,1,0.14285714285714285,1,0.0,0,0,0,0,0,0,0,1,0,0,1,0
3941,121395,Xn0msswMya4DdeH7Dc0xTOd0ODvYwWM7,SpATywNh6bZuzm8s1ceuBUnMUAeoAHHw,4,3,0,0,0,0,2,0,5,0.7142857142857143,1,0.0,0,0,0,0,3,0,0,2,0,0,5,1
3942,121400,BMjIPGqtYoLatxXDEHrhiIMt72Ckp0Wf,SpATywNh6bZuzm8s1ceuBUnMUAeoAHHw,5,3,0,0,0,0,2,0,5,0.7142857142857143,1,0.0,0,0,0,0,3,0,0,2,0,0,5,1
3943,121419,I6qGclNEImKeNJdvIwY5PrrMknw1zeQu,SpATywNh6bZuzm8s1ceuBUnMUAeoAHHw,1,0,0,0,0,0,1,0,1,0.14285714285714285,1,0.0,0,0,0,0,0,0,0,1,0,0,1,0
3944,121611,bDlowck7PoswtmYozGMoa41g1GVEejKh,RXDvfPUBYFlVdlueBFbLW0mhhAyGEqpt,20,19,14,6,7,47,4,1,98,14.0,2,0.0,2,14,6,7,17,47,0,4,1,29,69,0
3945,121662,5HXdL6OatNrhiY174KvxQUp0tpTJ3ory,SpATywNh6bZuzm8s1ceuBUnMUAeoAHHw,8,15,0,0,0,0,7,0,22,3.142857142857143,2,0.0,2,0,0,0,13,0,0,7,0,2,20,0
3946,121787,x4Txzgd0OUi5yqi55NtM21eJpZWiZeEW,A3fsA9Zfv1X2fVEQhTw51lKENdNrEqT3,37,16,12,44,8,0,3,0,83,11.857142857142858,1,0.0,2,12,43,8,14,0,1,3,0,65,18,1
3947,121893,Q8D1GMU9DUO6Nj6ySx5rrvLwl2bu2DGZ,SpATywNh6bZuzm8s1ceuBUnMUAeoAHHw,18,20,10,12,4,24,7,0,77,11.0,2,0.0,7,10,12,4,13,24,0,7,0,33,44,0
3948,121906,DPTAQ5lGsvjESrb4v1mwHpMaZuqLNytl,SpATywNh6bZuzm8s1ceuBUnMUAeoAHHw,7,5,3,0,0,0,5,0,13,1.8571428571428572,1,0.0,0,3,0,0,5,0,0,5,0,3,10,0
3949,122035,PFXaSbylT2XRWmnFTzI7TT06KKEcrU02,G8EPVSXsOYB5YQWZGiz1aVq5Pgr2GrQu,4,2,1,0,1,0,3,0,7,1.0,1,0.0,0,1,0,1,2,0,0,3,0,2,5,1
3950,122079,cderIDaWBR3ykedbqXoG7yh75mThXkpL,A3fsA9Zfv1X2fVEQhTw51lKENdNrEqT3,44,43,17,84,3,10,15,1,173,24.714285714285715,4,0.0,1,17,71,3,42,10,13,15,1,92,81,1
3951,124650,efygWYkxxUMOGInRZT4qEeuzMRlIpQq6,7GRhBDsirIGkRZBtSMEzNTyDr2JQm4xx,11,17,7,2,4,0,2,0,32,4.571428571428571,1,0.0,8,7,1,4,9,0,1,2,0,20,12,0
3952,124702,Xv0DoRVy2WPaq7NGSTl3PflvzGmHzjVJ,7GRhBDsirIGkRZBtSMEzNTyDr2JQm4xx,20,33,3,23,5,6,11,0,81,11.571428571428571,3,0.0,21,3,18,5,12,6,5,11,0,47,34,0
3953,124784,Eh1GmQ1l1uLUtTdjFKV3N8aG3h7KeTZw,7GRhBDsirIGkRZBtSMEzNTyDr2JQm4xx,7,4,3,0,2,1,1,0,11,1.5714285714285714,1,0.0,0,3,0,2,4,1,0,1,0,5,6,1
3954,124806,Th577tzrUuQ2mCFol11GPYRTSP1uxDgy,7GRhBDsirIGkRZBtSMEzNTyDr2JQm4xx,1,0,0,0,0,0,2,0,2,0.2857142857142857,1,0.0,0,0,0,0,0,0,0,2,0,0,2,1
3955,124920,gZWf27ETcHz4bBmwZPjiPumw55JZ4IOR,7GRhBDsirIGkRZBtSMEzNTyDr2JQm4xx,4,2,0,0,0,0,3,0,5,0.7142857142857143,1,0.0,0,0,0,0,2,0,0,3,0,0,5,1
3956,124935,VRS5uIqYlw2SwZ8kUgzPCb9ckuRb5DEy,7GRhBDsirIGkRZBtSMEzNTyDr2JQm4xx,50,163,1,149,18,2,22,1,356,50.857142857142854,3,0.0,81,1,131,18,82,2,18,22,1,231,125,1
3957,124961,MQKEfJfHQjDI3xyJjnjmz4WwmQkpOvq2,7GRhBDsirIGkRZBtSMEzNTyDr2JQm4xx,5,3,2,0,1,4,1,0,11,1.5714285714285714,1,0.0,0,2,0,1,3,4,0,1,0,3,8,1
3958,125015,wuCb3DAs0UTa3nnL6gSfoBgjTkpbfyNt,7GRhBDsirIGkRZBtSMEzNTyDr2JQm4xx,2,0,0,0,0,0,2,0,2,0.2857142857142857,1,0.0,0,0,0,0,0,0,0,2,0,0,2,0
3959,125428,7tmNprOSiahGzByaY8XiUnCFEIQfWwuf,7GRhBDsirIGkRZBtSMEzNTyDr2JQm4xx,11,17,2,0,3,0,2,0,24,3.4285714285714284,2,0.0,8,2,0,3,9,0,0,2,0,13,11,0
3960,125793,xpwei0fjDTwQJLJhl5FjMPXksqpuR5GG,7GRhBDsirIGkRZBtSMEzNTyDr2JQm4xx,27,23,10,27,7,0,2,0,69,9.857142857142858,1,0.0,12,10,27,7,11,0,0,2,0,56,13,0
3961,126626,0PTt7yojLQH47Ob79awcf5jvqfHw2L3I,fbPkOYLVPtPgIt0MxizjfFJov3JbHyAi,21,19,9,17,5,1,4,1,56,8.0,1,0.0,3,9,15,5,16,1,2,4,1,32,24,1
3962,126650,LD7pbuVHju3VTu9U8udNh6I7JCsw9ECG,fbPkOYLVPtPgIt0MxizjfFJov3JbHyAi,29,28,16,14,10,0,4,0,72,10.285714285714286,2,0.0,8,16,14,10,20,0,0,4,0,48,24,0
3963,126698,9LD2dY2JJUiq4N2gerCXLTVCO162xgQP,fbPkOYLVPtPgIt0MxizjfFJov3JbHyAi,11,14,7,0,0,21,17,2,61,8.714285714285714,1,0.0,0,7,0,0,14,21,0,17,2,7,54,1
3964,126700,ltYfR4c85t4WE2sNzApQ2jUPBpU7b957,fbPkOYLVPtPgIt0MxizjfFJov3JbHyAi,7,3,2,0,1,0,4,0,10,1.4285714285714286,1,0.0,0,2,0,1,3,0,0,4,0,3,7,1
3965,126720,ILgj2bRC3L9liHZTpRi1J62GsWMdjm7i,fbPkOYLVPtPgIt0MxizjfFJov3JbHyAi,18,25,18,11,10,16,3,0,83,11.857142857142858,1,0.0,4,18,10,10,21,16,1,3,0,42,41,0
3966,126727,okqN4nBVKRYYrkYonKicKGOmPqVGYjZh,fbPkOYLVPtPgIt0MxizjfFJov3JbHyAi,1,0,0,0,0,0,1,0,1,0.14285714285714285,1,0.0,0,0,0,0,0,0,0,1,0,0,1,0
3967,126760,VAqYNROCUp4auixkrMgowB877fUTXjiq,fbPkOYLVPtPgIt0MxizjfFJov3JbHyAi,9,4,2,0,1,0,5,1,13,1.8571428571428572,1,0.0,0,2,0,1,4,0,0,5,1,3,10,1
3968,126762,tedGThhHMqVARfBh6zyzyocTKbTJYJpB,fbPkOYLVPtPgIt0MxizjfFJov3JbHyAi,5,3,2,0,1,2,2,0,10,1.4285714285714286,2,0.0,0,2,0,1,3,2,0,2,0,3,7,0
3969,126763,paw4uFNhxlmHKr4qI1FVQJCklV7n0vFs,fbPkOYLVPtPgIt0MxizjfFJov3JbHyAi,2,0,0,0,0,0,3,0,3,0.42857142857142855,1,0.0,0,0,0,0,0,0,0,3,0,0,3,1
3970,126764,dzZvmhMBCZUS7A4bdHQZaWrZNWx9wlnR,fbPkOYLVPtPgIt0MxizjfFJov3JbHyAi,5,2,1,0,1,0,2,0,6,0.8571428571428571,1,0.0,0,1,0,1,2,0,0,2,0,2,4,0
3971,126766,YDTJdQorIvDsVBFXmCLdVqB4blieQHew,fbPkOYLVPtPgIt0MxizjfFJov3JbHyAi,8,3,1,0,1,0,6,0,11,1.5714285714285714,1,0.0,0,1,0,1,3,0,0,6,0,2,9,1
3972,126767,xPpQ4dt3yAtdD8kr7bwSICTMyO3G9j2v,fbPkOYLVPtPgIt0MxizjfFJov3JbHyAi,2,0,0,0,0,0,2,0,2,0.2857142857142857,1,0.0,0,0,0,0,0,0,0,2,0,0,2,1
3973,126768,0WQD9JgXnh1Oc60hHZOmb4uDwk3oDBzG,fbPkOYLVPtPgIt0MxizjfFJov3JbHyAi,1,0,0,0,0,0,1,0,1,0.14285714285714285,1,0.0,0,0,0,0,0,0,0,1,0,0,1,1
3974,126771,xMKGcYeHMuhMu436Dx8qNr2iLxqOhlEy,fbPkOYLVPtPgIt0MxizjfFJov3JbHyAi,6,6,3,0,1,0,4,0,14,2.0,1,0.0,0,3,0,1,6,0,0,4,0,4,10,1
3975,126773,BD211S7WnIRsylhDTuEdNrGmy3W7uQ04,fbPkOYLVPtPgIt0MxizjfFJov3JbHyAi,4,2,1,0,0,0,2,0,5,0.7142857142857143,1,0.0,0,1,0,0,2,0,0,2,0,1,4,1
3976,126774,4FlFuHK6TBPGfbsvWig6oHoWLKBiaFvx,fbPkOYLVPtPgIt0MxizjfFJov3JbHyAi,24,39,16,20,19,5,4,0,103,14.714285714285714,3,0.0,20,16,17,19,19,5,3,4,0,72,31,1
3977,126778,ukV83h2gop6RgQ4r0p0CZA73Nn6q15H2,fbPkOYLVPtPgIt0MxizjfFJov3JbHyAi,9,5,4,0,3,0,5,0,17,2.4285714285714284,1,0.0,0,4,0,3,5,0,0,5,0,7,10,1
3978,126780,k0j1JTbNvF4wEJZ0EFYHSB55VWnrDKJ0,fbPkOYLVPtPgIt0MxizjfFJov3JbHyAi,1,0,0,0,0,0,1,0,1,0.14285714285714285,1,0.0,0,0,0,0,0,0,0,1,0,0,1,1
3979,126783,fZTrS29Fp3monLBfDxON161JJDMC3kWz,fbPkOYLVPtPgIt0MxizjfFJov3JbHyAi,8,7,0,0,0,2,5,0,14,2.0,2,0.0,0,0,0,0,7,2,0,5,0,0,14,1
3980,126786,2urzmdkueRAEgx9jksBRYegBWc6qjd5N,fbPkOYLVPtPgIt0MxizjfFJov3JbHyAi,7,3,2,0,2,0,2,0,9,1.2857142857142858,1,0.0,0,2,0,2,3,0,0,2,0,4,5,1
3981,126787,SudTrjctDId1aP2BFyvfpzdEUNt4tVpn,fbPkOYLVPtPgIt0MxizjfFJov3JbHyAi,1,0,0,0,0,0,1,0,1,0.14285714285714285,1,0.0,0,0,0,0,0,0,0,1,0,0,1,1
3982,126788,oAeA1FcKJgCgppNdDO8cyAq9ijjrn0WR,fbPkOYLVPtPgIt0MxizjfFJov3JbHyAi,7,2,1,0,1,0,5,0,9,1.2857142857142858,1,0.0,0,1,0,1,2,0,0,5,0,2,7,1
3983,126789,9TAoWA17iJi4aGxReuxcPCWmtwK9xK5D,fbPkOYLVPtPgIt0MxizjfFJov3JbHyAi,4,2,1,0,0,0,2,0,5,0.7142857142857143,1,0.0,0,1,0,0,2,0,0,2,0,1,4,1
3984,126790,bXfZmQuCdk4kcCEmwkhxKTGNfBpAQ8z2,fbPkOYLVPtPgIt0MxizjfFJov3JbHyAi,6,3,2,0,2,0,1,0,8,1.1428571428571428,1,0.0,0,2,0,2,3,0,0,1,0,4,4,1
3985,126791,fx2VHlFzMiSpt4HdfnAJod2kZRWQGzoD,fbPkOYLVPtPgIt0MxizjfFJov3JbHyAi,8,5,3,0,2,1,9,0,20,2.857142857142857,2,0.0,0,3,0,2,5,1,0,9,0,5,15,0
3986,126792,i2PPXz5Z5PB2ZfiVAI64TcWxYgJR1QQ1,fbPkOYLVPtPgIt0MxizjfFJov3JbHyAi,10,7,5,0,4,0,4,0,20,2.857142857142857,2,0.0,0,5,0,4,7,0,0,4,0,9,11,1
3987,126793,w81M8LsxqroaoVvhuOiOu12ogu2TTrVp,fbPkOYLVPtPgIt0MxizjfFJov3JbHyAi,10,5,3,0,2,0,6,0,16,2.2857142857142856,1,0.0,0,3,0,2,5,0,0,6,0,5,11,1
3988,126794,9og5l3kBrvNmeUS7WEJnLIW5U5JOFnlr,fbPkOYLVPtPgIt0MxizjfFJov3JbHyAi,1,0,0,0,0,0,1,0,1,0.14285714285714285,1,0.0,0,0,0,0,0,0,0,1,0,0,1,1
3989,126795,dlcs3mIk1dQaLsNVv2V1gEVdgllvLwJb,fbPkOYLVPtPgIt0MxizjfFJov3JbHyAi,1,0,0,0,0,0,1,0,1,0.14285714285714285,1,0.0,0,0,0,0,0,0,0,1,0,0,1,1
3990,126796,nRLTavEl1bXxEwhFINnyKEh9SYy7D5ak,fbPkOYLVPtPgIt0MxizjfFJov3JbHyAi,5,3,1,0,1,0,1,0,6,0.8571428571428571,1,0.0,0,1,0,1,3,0,0,1,0,2,4,1
3991,126799,GZEmn2jDYiPNelTXdP84Wl4gxgVXz7UQ,fbPkOYLVPtPgIt0MxizjfFJov3JbHyAi,7,7,4,0,2,0,3,0,16,2.2857142857142856,1,0.0,1,4,0,2,6,0,0,3,0,7,9,1
3992,126800,03LSJMJGCEPYScMXgYv3wZ9A4zZCWROs,fbPkOYLVPtPgIt0MxizjfFJov3JbHyAi,5,2,1,0,1,0,3,0,7,1.0,2,0.0,0,1,0,1,2,0,0,3,0,2,5,1
3993,126802,Ae7TpzHEpVWIeUEcofOMHxfQYB9IZpIZ,fbPkOYLVPtPgIt0MxizjfFJov3JbHyAi,4,3,0,0,0,0,2,0,5,0.7142857142857143,1,0.0,1,0,0,0,2,0,0,2,0,1,4,1
3994,126803,baVXGFYC1QSmRnztVLPGhtEiVUNUt9jm,fbPkOYLVPtPgIt0MxizjfFJov3JbHyAi,9,13,8,0,4,7,5,0,37,5.285714285714286,2,0.0,0,8,0,4,13,7,0,5,0,12,25,1
3995,126804,udjvqTKwWnl3kdnagqtGxHOib49LhYFP,fbPkOYLVPtPgIt0MxizjfFJov3JbHyAi,1,0,0,0,0,0,1,0,1,0.14285714285714285,1,0.0,0,0,0,0,0,0,0,1,0,0,1,1
3996,126805,tb2OgRXfqTZBzkHrdlQDSZ9zV3ijuuxF,fbPkOYLVPtPgIt0MxizjfFJov3JbHyAi,5,0,0,0,0,2,14,5,21,3.0,2,0.0,0,0,0,0,0,2,0,14,5,0,21,1
3997,126807,9a82SEYCdqbKx1WLnzqNRiSe6ROiwLtA,fbPkOYLVPtPgIt0MxizjfFJov3JbHyAi,8,2,1,0,1,1,6,1,12,1.7142857142857142,1,0.0,0,1,0,1,2,1,0,6,1,2,10,1
3998,126808,fwOw0LJBQGN43wSD5bc3nLA7e72R3dmo,fbPkOYLVPtPgIt0MxizjfFJov3JbHyAi,1,0,0,0,0,0,1,0,1,0.14285714285714285,1,0.0,0,0,0,0,0,0,0,1,0,0,1,1
3999,126809,hcIMsJjzliCUSfKNV7VjadwRGqNrlbcK,fbPkOYLVPtPgIt0MxizjfFJov3JbHyAi,5,7,6,0,0,0,2,0,15,2.142857142857143,1,0.0,0,6,0,0,7,0,0,2,0,6,9,0
4000,126812,HO2p5gxVWMQedHP7d588CVyHIhMACwbO,fbPkOYLVPtPgIt0MxizjfFJov3JbHyAi,7,4,2,0,2,0,7,0,15,2.142857142857143,1,0.0,0,2,0,2,4,0,0,7,0,4,11,1
4001,126818,UKVpy6yMY2LOCbd33JRDxwPZtMJSUcsq,fbPkOYLVPtPgIt0MxizjfFJov3JbHyAi,1,0,0,0,0,0,1,0,1,0.14285714285714285,1,0.0,0,0,0,0,0,0,0,1,0,0,1,1
4002,126819,bmUODmp9W7t1pFfRc25oTW8BqLenSXaz,fbPkOYLVPtPgIt0MxizjfFJov3JbHyAi,4,2,0,0,0,0,2,0,4,0.5714285714285714,1,0.0,0,0,0,0,2,0,0,2,0,0,4,1
4003,126820,qDTU2XGTiB220mLDzlsck7xSj3wUhIhe,fbPkOYLVPtPgIt0MxizjfFJov3JbHyAi,7,3,1,0,1,3,5,1,14,2.0,1,0.0,0,1,0,1,3,3,0,5,1,2,12,1
4004,130039,Z5sEt151hX78nE6qWmPF09aVI6QGewvL,7GRhBDsirIGkRZBtSMEzNTyDr2JQm4xx,21,33,0,6,2,0,10,1,52,7.428571428571429,2,0.0,15,0,3,2,18,0,3,10,1,20,32,0
4005,130041,tlBnmsKf0J20KHkh9Qq2FoTYGO7e78wj,7GRhBDsirIGkRZBtSMEzNTyDr2JQm4xx,22,20,8,81,3,0,5,0,117,16.714285714285715,1,0.0,12,8,68,3,8,0,13,5,0,91,26,1
4006,130047,jcZzyelmNOUxuY7TWiZZyoS3gSdLYxDW,7GRhBDsirIGkRZBtSMEzNTyDr2JQm4xx,24,25,7,8,12,1,5,0,58,8.285714285714286,1,0.0,18,7,4,12,7,1,4,5,0,41,17,1
4007,130051,V6I2tWMT4J6OaEfYWYGJXMvy6YbJ0vQk,7GRhBDsirIGkRZBtSMEzNTyDr2JQm4xx,1,0,0,0,0,0,1,0,1,0.14285714285714285,1,0.0,0,0,0,0,0,0,0,1,0,0,1,0
4008,130059,1xcKG4Eeqo6PRlQtqz4lRNBDzvKhe7qL,7GRhBDsirIGkRZBtSMEzNTyDr2JQm4xx,9,9,2,0,2,0,3,0,16,2.2857142857142856,2,0.0,0,2,0,2,9,0,0,3,0,4,12,0
4009,130126,Kt9qeiacR1tBDeKKHUR6O60ehH5pm7C9,7GRhBDsirIGkRZBtSMEzNTyDr2JQm4xx,7,7,1,0,0,0,1,0,9,1.2857142857142858,1,0.0,0,1,0,0,7,0,0,1,0,1,8,1
4010,130170,bVkBiR8Ol1DpipPI05IgYIPbLOO6oZNi,7GRhBDsirIGkRZBtSMEzNTyDr2JQm4xx,29,45,13,14,11,1,9,1,94,13.428571428571429,1,0.0,16,13,12,11,29,1,2,9,1,52,42,0
4011,130205,D5GqwXfacfySSvxPJ9v7ORjiX9Oa23f1,7GRhBDsirIGkRZBtSMEzNTyDr2JQm4xx,76,83,26,113,33,10,17,6,288,41.142857142857146,4,0.0,52,26,95,33,31,10,18,17,6,206,82,1
4012,130239,ECkqmAuIkv3ncN9wNJby8oOn15qTd9kR,7GRhBDsirIGkRZBtSMEzNTyDr2JQm4xx,1,0,0,0,0,0,1,0,1,0.14285714285714285,1,0.0,0,0,0,0,0,0,0,1,0,0,1,0
4013,130318,Mms6sMIkW4Omst3uLD38oJJ4C0ZCQcDW,7GRhBDsirIGkRZBtSMEzNTyDr2JQm4xx,8,12,1,0,1,0,2,0,16,2.2857142857142856,1,0.0,0,1,0,1,12,0,0,2,0,2,14,1
4014,130321,gzS6aH9DKKq1TfiY1ctxHgUplSbkMYNf,7GRhBDsirIGkRZBtSMEzNTyDr2JQm4xx,11,8,4,6,1,0,10,0,29,4.142857142857143,1,0.0,4,4,5,1,4,0,1,10,0,14,15,1
4015,134909,GfFjXeeiX86hNL5LrfmBqRsIDiX1X26k,SpATywNh6bZuzm8s1ceuBUnMUAeoAHHw,3,2,1,0,0,0,2,0,5,0.7142857142857143,1,0.0,0,1,0,0,2,0,0,2,0,1,4,1
4016,134917,yNC8T7gdWO96Y2q3tzTQeJUMY0F51xnO,RXDvfPUBYFlVdlueBFbLW0mhhAyGEqpt,3,4,2,0,0,0,2,0,8,1.1428571428571428,2,0.0,0,2,0,0,4,0,0,2,0,2,6,1
4017,134982,CW7Zlsz0NoDYd7q0tu1Krgi9b7wpQUwQ,A3fsA9Zfv1X2fVEQhTw51lKENdNrEqT3,1,0,0,0,0,0,1,0,1,0.14285714285714285,1,0.0,0,0,0,0,0,0,0,1,0,0,1,0
4018,135022,f0rWHmI4rV7ssYizy9jzg3UxqKTtG19Y,SpATywNh6bZuzm8s1ceuBUnMUAeoAHHw,1,0,0,0,0,0,1,0,1,0.14285714285714285,1,0.0,0,0,0,0,0,0,0,1,0,0,1,0
4019,135025,tedGThhHMqVARfBh6zyzyocTKbTJYJpB,SpATywNh6bZuzm8s1ceuBUnMUAeoAHHw,2,0,0,0,0,0,2,0,2,0.2857142857142857,1,0.0,0,0,0,0,0,0,0,2,0,0,2,1
4020,135035,wQjDRlC3tPpszGzQ3Dfiq7I6azQztJ02,A3fsA9Zfv1X2fVEQhTw51lKENdNrEqT3,1,0,0,0,0,0,1,0,1,0.14285714285714285,1,0.0,0,0,0,0,0,0,0,1,0,0,1,1
4021,135065,g9QyBrQkEVh9IC3JA81b7KgVa01DwgUa,SpATywNh6bZuzm8s1ceuBUnMUAeoAHHw,1,0,0,0,0,0,1,0,1,0.14285714285714285,1,0.0,0,0,0,0,0,0,0,1,0,0,1,1
4022,135079,GFArLd1huQSmyLkNR2x5AlhFrFWDXs0N,SpATywNh6bZuzm8s1ceuBUnMUAeoAHHw,4,5,3,0,0,0,1,0,9,1.2857142857142858,4,0.0,0,3,0,0,5,0,0,1,0,3,6,0
4023,135137,A3FGIvcpmP9UeVzECTe66iC9lFbKmHRb,A3fsA9Zfv1X2fVEQhTw51lKENdNrEqT3,32,17,13,68,6,0,1,0,105,15.0,1,0.0,1,13,60,6,16,0,8,1,0,80,25,1
4024,135172,qLscbApWydA7z1h7Ht7RN2UnF0mvGZpF,RXDvfPUBYFlVdlueBFbLW0mhhAyGEqpt,7,6,0,0,0,0,1,0,7,1.0,1,0.0,0,0,0,0,6,0,0,1,0,0,7,1
4025,135205,ps2zbzmz8NQnCm6f0pvJpkBQkQh2tR1v,bWdj2GDclj5ofokWjzoa5jAwMkxCykd6,18,14,10,50,7,0,0,0,81,11.571428571428571,1,0.0,4,10,43,7,10,0,7,0,0,64,17,1
4026,135390,IGFSjvLtGQCYdnhMcrAQcaIreY53ybWv,bWdj2GDclj5ofokWjzoa5jAwMkxCykd6,19,16,8,24,6,0,7,1,62,8.857142857142858,2,0.0,3,8,18,6,13,0,6,7,1,35,27,0
4027,135442,x6BtQH70uuLHaxqzHA21U9wmfT0SxzD9,RXDvfPUBYFlVdlueBFbLW0mhhAyGEqpt,2,0,0,0,0,0,3,0,3,0.42857142857142855,2,0.0,0,0,0,0,0,0,0,3,0,0,3,1
4028,135459,EXZ81qqSldwR1xdBEwBZ7wmgbTHF86sl,bWdj2GDclj5ofokWjzoa5jAwMkxCykd6,7,5,3,10,2,0,1,0,21,3.0,1,0.0,1,3,8,2,4,0,2,1,0,14,7,0
4029,135560,p7o6CUVxTvhF5zDZdbTejHoySKfqycmC,A3fsA9Zfv1X2fVEQhTw51lKENdNrEqT3,3,2,1,0,0,0,1,0,4,0.5714285714285714,1,0.0,0,1,0,0,2,0,0,1,0,1,3,1
4030,135570,JoLD64z5yUuFbScCfKMnv8dODXOTXhRU,RXDvfPUBYFlVdlueBFbLW0mhhAyGEqpt,17,19,1,32,2,4,1,0,59,8.428571428571429,1,0.0,6,1,29,2,13,4,3,1,0,38,21,1
4031,135590,VYMfm0tgVS6x4Eosz9NPpRPYpCrgFsMy,RXDvfPUBYFlVdlueBFbLW0mhhAyGEqpt,7,8,5,0,0,9,4,0,26,3.7142857142857144,2,0.0,0,5,0,0,8,9,0,4,0,5,21,0
4032,135613,8lCrBaMkcXk8KsL7M8AYgjnsyFuSP4yK,SpATywNh6bZuzm8s1ceuBUnMUAeoAHHw,1,0,0,0,0,0,1,0,1,0.14285714285714285,1,0.0,0,0,0,0,0,0,0,1,0,0,1,0
4033,135619,dmVv4oc5Gy8IXIoX1c6y61vCY7ZjC5c1,SpATywNh6bZuzm8s1ceuBUnMUAeoAHHw,1,0,0,0,0,0,2,0,2,0.2857142857142857,2,0.0,0,0,0,0,0,0,0,2,0,0,2,1
4034,135627,p8PDk7PIRcdv8OilLQ1EB9K2d3Uc8Sea,SpATywNh6bZuzm8s1ceuBUnMUAeoAHHw,11,8,6,0,4,0,3,0,21,3.0,2,0.0,0,6,0,4,8,0,0,3,0,10,11,1
4035,135709,EvNxwwShcQXgwZllGhuS7z5fGOL08A9A,SpATywNh6bZuzm8s1ceuBUnMUAeoAHHw,4,4,2,0,0,0,2,0,8,1.1428571428571428,2,0.0,0,2,0,0,4,0,0,2,0,2,6,0
4036,135730,H8XaU1gbefHT7MZ45ya2B80ofczKeIUJ,bWdj2GDclj5ofokWjzoa5jAwMkxCykd6,17,15,9,34,2,9,12,0,81,11.571428571428571,2,0.0,2,9,31,2,13,9,3,12,0,44,37,0
4037,135731,NBdBSIIhFodg28Tlkf7g5CN58dT0AVfw,A3fsA9Zfv1X2fVEQhTw51lKENdNrEqT3,2,0,0,0,0,6,1,0,7,1.0,1,0.0,0,0,0,0,0,6,0,1,0,0,7,1
4038,135843,QGuKTIBC2KLaYpPdOnB4nXCWgxMM1Dog,bWdj2GDclj5ofokWjzoa5jAwMkxCykd6,22,42,22,34,13,0,5,0,116,16.571428571428573,2,0.0,7,22,29,13,35,0,5,5,0,71,45,0
4039,135862,vVomSgkHkyw3sqrRqYKc3zE1eWaa2d4G,A3fsA9Zfv1X2fVEQhTw51lKENdNrEqT3,29,7,3,52,1,30,34,1,128,18.285714285714285,1,0.0,3,3,51,1,4,30,1,34,1,58,70,0
4040,135962,sd2HYLRck3MQjoR7Fod62oDtNeNgK3C5,A3fsA9Zfv1X2fVEQhTw51lKENdNrEqT3,14,17,12,0,9,0,7,0,45,6.428571428571429,2,0.0,1,12,0,9,16,0,0,7,0,22,23,1
4041,136004,XpLwBNjV7lkbo9HRLwBFqy6jHSpPfym2,SpATywNh6bZuzm8s1ceuBUnMUAeoAHHw,7,4,3,2,1,0,1,0,11,1.5714285714285714,1,0.0,0,3,2,1,4,0,0,1,0,6,5,0
4042,136085,ISRJxWtuG9U7GF6GcMl2UZgUHAWLyOgM,A3fsA9Zfv1X2fVEQhTw51lKENdNrEqT3,7,3,2,0,2,4,4,0,15,2.142857142857143,2,0.0,0,2,0,2,3,4,0,4,0,4,11,0
4043,136153,UTOVD7URrJRdTcIox1GiNWQleZgjmsMx,SpATywNh6bZuzm8s1ceuBUnMUAeoAHHw,12,34,15,0,6,2,6,0,63,9.0,2,0.0,4,15,0,6,30,2,0,6,0,25,38,0
4044,136155,GgCLl5NjwqMgkh5JCvkbSguhpqbBPXLG,7GRhBDsirIGkRZBtSMEzNTyDr2JQm4xx,13,25,1,12,4,0,2,0,44,6.285714285714286,1,0.0,11,1,10,4,14,0,2,2,0,26,18,1
4045,136257,8uSQsFhnhoJeSVZylwMfyqKR37MO9Qyr,SpATywNh6bZuzm8s1ceuBUnMUAeoAHHw,13,15,6,26,0,6,9,0,62,8.857142857142858,2,0.0,4,6,25,0,11,6,1,9,0,35,27,0
4046,136280,1pbL8yRf5isuKA2AbZrt88AKZzNS9VL8,SpATywNh6bZuzm8s1ceuBUnMUAeoAHHw,5,4,3,0,3,0,3,0,13,1.8571428571428572,2,0.0,0,3,0,3,4,0,0,3,0,6,7,1
4047,136282,no2ug7TKVsupL4LU2a5jY2GhYHkskTdw,SpATywNh6bZuzm8s1ceuBUnMUAeoAHHw,18,19,11,8,4,1,4,0,47,6.714285714285714,2,0.0,5,11,8,4,14,1,0,4,0,28,19,0
4048,136368,3RPGU51kghTa1yQ8sk1JkQkDTlLpjaeu,A3fsA9Zfv1X2fVEQhTw51lKENdNrEqT3,34,23,2,64,1,0,5,0,95,13.571428571428571,2,0.0,3,2,50,1,20,0,14,5,0,56,39,1
4049,136386,FM7LvWy0SQdmiC09CRsUT44n0BqWWa2S,SpATywNh6bZuzm8s1ceuBUnMUAeoAHHw,3,2,1,0,0,0,1,0,4,0.5714285714285714,1,0.0,0,1,0,0,2,0,0,1,0,1,3,0
4050,136410,4veNYFa5yTlgZEZ3CkxGfwseJV8Djm6t,bWdj2GDclj5ofokWjzoa5jAwMkxCykd6,7,4,0,0,0,0,8,0,12,1.7142857142857142,1,0.0,0,0,0,0,4,0,0,8,0,0,12,1
4051,136421,hB4yTUnQMne1LtjUUKgpcnhj6jq7S5Co,SpATywNh6bZuzm8s1ceuBUnMUAeoAHHw,30,36,20,18,10,1,12,0,97,13.857142857142858,3,0.0,11,20,17,10,25,1,1,12,0,58,39,0
4052,136447,ecut1h0rhjLzcs1jrL1hILYqwNtlJCKC,7GRhBDsirIGkRZBtSMEzNTyDr2JQm4xx,27,59,16,38,10,0,4,0,127,18.142857142857142,2,0.0,19,16,37,10,40,0,1,4,0,82,45,1
4053,136562,UUf7W9nrVz0icOeIhIvztvvypaJKgHhN,SpATywNh6bZuzm8s1ceuBUnMUAeoAHHw,7,5,2,8,0,0,1,0,16,2.2857142857142856,1,0.0,2,2,8,0,3,0,0,1,0,12,4,1
4054,136615,Cv1aavObJnuABKfipF6OGePzg0BnGPFs,RXDvfPUBYFlVdlueBFbLW0mhhAyGEqpt,20,11,7,20,0,3,3,0,44,6.285714285714286,1,0.0,4,7,20,0,7,3,0,3,0,31,13,1
4055,136641,ndSSvoqRP9UOBqRicNUijfD0pPNDqiTJ,7GRhBDsirIGkRZBtSMEzNTyDr2JQm4xx,27,40,22,35,25,0,4,0,126,18.0,4,0.0,13,22,31,25,27,0,4,4,0,91,35,0
4056,136683,J3FKLxbUlPTor4lyG8lMpHc8oUQEjfcp,RXDvfPUBYFlVdlueBFbLW0mhhAyGEqpt,3,2,1,0,0,0,1,0,4,0.5714285714285714,1,0.0,0,1,0,0,2,0,0,1,0,1,3,0
4057,136697,ZbpLZuhcPXDt8MCBlzIEU31Qmn57Ldle,G8EPVSXsOYB5YQWZGiz1aVq5Pgr2GrQu,3,2,1,0,0,0,1,0,4,0.5714285714285714,1,0.0,0,1,0,0,2,0,0,1,0,1,3,0
4058,136709,gx5zIbRkvVmYAkHaGQMR5zm5BpTwVwIe,A3fsA9Zfv1X2fVEQhTw51lKENdNrEqT3,10,6,1,8,0,0,2,0,17,2.4285714285714284,1,0.0,0,1,7,0,6,0,1,2,0,8,9,0
4059,136845,OmBhuxpgNHza1UgJ4sJoDmhlFXyn8dEO,SpATywNh6bZuzm8s1ceuBUnMUAeoAHHw,15,61,0,16,1,1,11,1,91,13.0,1,0.0,8,0,15,1,53,1,1,11,1,24,67,0
4060,136961,Cx9UgN9CA3ZQNCspfULD8FGJJpSFtxJF,bWdj2GDclj5ofokWjzoa5jAwMkxCykd6,26,33,15,86,4,7,7,1,153,21.857142857142858,2,0.0,14,15,78,4,19,7,8,7,1,111,42,0
4061,137007,1vvo0r6a7F7cnmAi2geIjNYeLW8STOBo,bWdj2GDclj5ofokWjzoa5jAwMkxCykd6,25,29,11,38,0,0,4,1,83,11.857142857142858,1,0.0,9,11,36,0,20,0,2,4,1,56,27,0
4062,137027,qggUO4B0NhIPqMhJwgIAZM8ZaIbpr9nE,A3fsA9Zfv1X2fVEQhTw51lKENdNrEqT3,99,52,42,180,27,9,26,3,339,48.42857142857143,2,0.0,5,42,167,27,47,9,13,26,3,241,98,0
4063,137107,XWnCbgeYVoaeV4iWRMUFAsMH4LdV0YRz,7GRhBDsirIGkRZBtSMEzNTyDr2JQm4xx,13,9,3,20,0,0,3,0,35,5.0,1,0.0,5,3,18,0,4,0,2,3,0,26,9,1
4064,137201,xHyTBb0oAY3Apc4pTvqPrWVv46063zDF,bWdj2GDclj5ofokWjzoa5jAwMkxCykd6,5,0,0,0,0,0,4,1,5,0.7142857142857143,1,0.0,0,0,0,0,0,0,0,4,1,0,5,1
4065,137244,v8s2hAX8tQgFD6i9MrUt2cuWPYPq3DuN,7GRhBDsirIGkRZBtSMEzNTyDr2JQm4xx,7,21,12,0,0,0,5,0,38,5.428571428571429,4,0.0,4,12,0,0,17,0,0,5,0,16,22,0
4066,137259,jx3H6f2miwKbLN02Gt82PEqx2tCxuPiz,SpATywNh6bZuzm8s1ceuBUnMUAeoAHHw,7,11,0,0,0,0,3,0,14,2.0,2,0.0,2,0,0,0,9,0,0,3,0,2,12,0
4067,137277,bAAKqYTvNa29c4TuCorKR61JLnTy6u4P,SpATywNh6bZuzm8s1ceuBUnMUAeoAHHw,1,0,0,0,0,0,1,0,1,0.14285714285714285,1,0.0,0,0,0,0,0,0,0,1,0,0,1,1
4068,137294,2AVqf09WA2itMEZz0u7FX3Fi3x3FZzPg,fbPkOYLVPtPgIt0MxizjfFJov3JbHyAi,16,23,11,0,9,4,4,0,51,7.285714285714286,2,0.0,2,11,0,9,21,4,0,4,0,22,29,1
4069,137378,1wIqcRX58Bpw6RXvGnbxsc6WbPwWGwXd,fbPkOYLVPtPgIt0MxizjfFJov3JbHyAi,3,2,1,0,0,2,3,0,8,1.1428571428571428,1,0.0,0,1,0,0,2,2,0,3,0,1,7,1
4070,137416,A41hdT15T7mumzDW53QCDXRUsOilvTI0,fbPkOYLVPtPgIt0MxizjfFJov3JbHyAi,28,36,29,0,19,6,7,0,97,13.857142857142858,1,0.0,0,29,0,19,36,6,0,7,0,48,49,0
4071,138172,jb9pTa916Vn2VeH0D7ExYaf2JyoI9zrO,7GRhBDsirIGkRZBtSMEzNTyDr2JQm4xx,39,52,1,20,16,0,3,0,92,13.142857142857142,1,0.0,24,1,16,16,28,0,4,3,0,57,35,0
4072,138201,irIVLRvkXyea4TMdg5wZQ17APoQLOStn,7GRhBDsirIGkRZBtSMEzNTyDr2JQm4xx,5,2,1,0,1,0,2,0,6,0.8571428571428571,1,0.0,0,1,0,1,2,0,0,2,0,2,4,1
4073,138314,W6AT73CXG4URTyD2I7QWXXVZx4oeh86N,7GRhBDsirIGkRZBtSMEzNTyDr2JQm4xx,4,6,3,0,0,0,2,0,11,1.5714285714285714,1,0.0,0,3,0,0,6,0,0,2,0,3,8,1
4074,138319,yq5rHqpCTagxs6XCaAXxmCSySzn2U3u8,SpATywNh6bZuzm8s1ceuBUnMUAeoAHHw,20,22,14,12,10,1,4,0,63,9.0,2,0.0,3,14,9,10,19,1,3,4,0,36,27,1
4075,138326,t4tnBhQAPqBnCFRCjzr4Y2gSOW7MaWb7,SpATywNh6bZuzm8s1ceuBUnMUAeoAHHw,3,4,1,0,0,0,3,0,8,1.1428571428571428,2,0.0,0,1,0,0,4,0,0,3,0,1,7,0
4076,138338,V8TGMBMhFLQdnr9mQNCNr5CucGxVWBvw,RXDvfPUBYFlVdlueBFbLW0mhhAyGEqpt,8,6,5,0,3,0,1,0,15,2.142857142857143,1,0.0,0,5,0,3,6,0,0,1,0,8,7,1
4077,138346,dd7Jtt1fMMutX1RG7iWTpWNKUpGu8Lqf,SpATywNh6bZuzm8s1ceuBUnMUAeoAHHw,23,52,21,28,0,34,11,3,149,21.285714285714285,1,0.0,15,21,26,0,37,34,2,11,3,62,87,0
4078,138351,drMAzq4nC1GseQmyuPqctPxioPnjLJpD,A3fsA9Zfv1X2fVEQhTw51lKENdNrEqT3,2,0,0,0,0,0,2,0,2,0.2857142857142857,1,0.0,0,0,0,0,0,0,0,2,0,0,2,1
4079,138367,KAW52VBDXCvurEAry0tITiLWjcxVkV8S,SpATywNh6bZuzm8s1ceuBUnMUAeoAHHw,16,13,8,5,4,0,1,0,31,4.428571428571429,1,0.0,3,8,5,4,10,0,0,1,0,20,11,0
4080,138379,NgtHGelgTuQd8iaakUkaIRT8CwQkRy7Z,SpATywNh6bZuzm8s1ceuBUnMUAeoAHHw,30,27,18,37,10,10,8,1,111,15.857142857142858,1,0.0,5,18,33,10,22,10,4,8,1,66,45,1
4081,138515,2Vr8sMi8Nmtw7GvPlYj3ww9EzMgjDWh8,SpATywNh6bZuzm8s1ceuBUnMUAeoAHHw,18,46,16,15,8,0,7,0,92,13.142857142857142,2,0.0,11,16,14,8,35,0,1,7,0,49,43,0
4082,138523,BhCvmy8WtOEti83wDjK9xOLWP4oCctij,RXDvfPUBYFlVdlueBFbLW0mhhAyGEqpt,16,25,0,34,0,0,1,0,60,8.571428571428571,1,0.0,8,0,32,0,17,0,2,1,0,40,20,1
4083,138559,WNxlasM9yolV5j0jIrxkqf7jn6zMrkGu,SpATywNh6bZuzm8s1ceuBUnMUAeoAHHw,14,20,5,23,0,2,4,0,54,7.714285714285714,2,0.0,13,5,21,0,7,2,2,4,0,39,15,0
4084,138605,0TwmbDZ9MIyhTy6dnWnLvFIAROrnAMuZ,A3fsA9Zfv1X2fVEQhTw51lKENdNrEqT3,11,9,6,0,4,0,11,0,30,4.285714285714286,1,0.0,1,6,0,4,8,0,0,11,0,11,19,0
4085,138692,ixs1CEJxkJS0gIphbPcsPzQNrY8VNX7l,bWdj2GDclj5ofokWjzoa5jAwMkxCykd6,16,23,10,46,9,34,14,2,138,19.714285714285715,2,0.0,8,10,45,9,15,34,1,14,2,72,66,1
4086,138711,2mcFXXl5IuZRP6QuFfHO1XF6KcVjhONf,SpATywNh6bZuzm8s1ceuBUnMUAeoAHHw,11,5,4,8,3,0,2,0,22,3.142857142857143,1,0.0,0,4,6,3,5,0,2,2,0,13,9,0
4087,138808,wZxGcsfZmDyO3eZaMEp8V4Qxwmu1n6lt,A3fsA9Zfv1X2fVEQhTw51lKENdNrEqT3,31,28,19,112,5,17,7,0,188,26.857142857142858,3,0.0,3,19,88,5,25,17,24,7,0,115,73,0
4088,138921,SdmxANaN4VeJNVCXABSOs77O0krJ65nl,SpATywNh6bZuzm8s1ceuBUnMUAeoAHHw,5,6,3,0,0,0,2,0,11,1.5714285714285714,1,0.0,1,3,0,0,5,0,0,2,0,4,7,1
4089,138979,9Mbi6CksSOlTvzJd1jV7pzorOP4mmF9E,SpATywNh6bZuzm8s1ceuBUnMUAeoAHHw,6,7,2,4,0,0,2,0,15,2.142857142857143,2,0.0,1,2,3,0,6,0,1,2,0,6,9,0
4090,139001,PLKaanKvHCtHMqtCskLE9sVgrYP9vmXy,SpATywNh6bZuzm8s1ceuBUnMUAeoAHHw,8,12,4,14,0,0,2,0,32,4.571428571428571,1,0.0,5,4,13,0,7,0,1,2,0,22,10,0
4091,139128,QaUj3eOwCavlOK096M7ra3BPeu9HLHwH,SpATywNh6bZuzm8s1ceuBUnMUAeoAHHw,6,3,1,0,1,0,2,0,7,1.0,1,0.0,0,1,0,1,3,0,0,2,0,2,5,0
4092,139165,emLy0wxTS6s6x2ntzW39vmfcR0P0HK07,G8EPVSXsOYB5YQWZGiz1aVq5Pgr2GrQu,6,6,4,0,1,0,2,0,13,1.8571428571428572,2,0.0,0,4,0,1,6,0,0,2,0,5,8,1
4093,139217,OOIu03NBEHePUSUIFa86FGFP5M136EAn,RXDvfPUBYFlVdlueBFbLW0mhhAyGEqpt,3,6,2,0,0,0,3,0,11,1.5714285714285714,1,0.0,0,2,0,0,6,0,0,3,0,2,9,0
4094,139246,3nkAYJy31glMu7RttArFOqU7gmkfxNPM,SpATywNh6bZuzm8s1ceuBUnMUAeoAHHw,17,48,9,39,3,0,10,3,112,16.0,3,0.0,38,9,35,3,10,0,4,10,3,85,27,0
4095,139252,AKVd0gnvEJlgz6OnGwqybMUQOVjHL58y,SpATywNh6bZuzm8s1ceuBUnMUAeoAHHw,9,9,5,17,0,7,3,0,41,5.857142857142857,2,0.0,2,5,15,0,7,7,2,3,0,22,19,0
4096,139322,AAAvWauitKfXD0xRpNsfpOKQu223kCXG,A3fsA9Zfv1X2fVEQhTw51lKENdNrEqT3,13,10,6,0,3,1,4,0,24,3.4285714285714284,1,0.0,1,6,0,3,9,1,0,4,0,10,14,1
4097,139324,hT3A3NhtOhvHOWKsgHNINVDyTB0qBxh1,SpATywNh6bZuzm8s1ceuBUnMUAeoAHHw,7,16,4,0,1,0,2,0,23,3.2857142857142856,1,0.0,2,4,0,1,14,0,0,2,0,7,16,0
4098,139331,jIQxdn4syEISmeL05XWgww3FZktzs7MC,SpATywNh6bZuzm8s1ceuBUnMUAeoAHHw,17,27,19,14,4,7,19,0,90,12.857142857142858,3,0.0,2,19,13,4,25,7,1,19,0,38,52,0
4099,139380,LIoGzJO9iWdcU74H9UnplKXzxcDk8cHj,SpATywNh6bZuzm8s1ceuBUnMUAeoAHHw,10,12,1,12,0,0,1,0,26,3.7142857142857144,1,0.0,4,1,10,0,8,0,2,1,0,15,11,0
4100,139404,fgEJIqkp4SMlTSJ7SAm1OLRW7sHHzj7J,RXDvfPUBYFlVdlueBFbLW0mhhAyGEqpt,3,2,1,0,0,0,1,0,4,0.5714285714285714,1,0.0,0,1,0,0,2,0,0,1,0,1,3,0
4101,139436,YOvd9uht0tZm889aIFQH8jd68xtH7inE,bWdj2GDclj5ofokWjzoa5jAwMkxCykd6,24,26,9,66,4,0,7,0,112,16.0,2,0.0,9,9,56,4,17,0,10,7,0,78,34,0
4102,139535,S33lH053HmB7Cz0IWipiL27cwx1QXBWr,SpATywNh6bZuzm8s1ceuBUnMUAeoAHHw,12,17,1,8,0,0,10,0,36,5.142857142857143,2,0.0,4,1,7,0,13,0,1,10,0,12,24,0
4103,139666,OiCP77rDGj7m0OeIgoy8NyAC1iklb2Wq,A3fsA9Zfv1X2fVEQhTw51lKENdNrEqT3,3,0,0,0,0,0,3,0,3,0.42857142857142855,1,0.0,0,0,0,0,0,0,0,3,0,0,3,1
4104,140068,dRD1DS5DuggVygcG59W7832HdVYwtgOn,7GRhBDsirIGkRZBtSMEzNTyDr2JQm4xx,1,0,0,0,0,0,3,0,3,0.42857142857142855,1,0.0,0,0,0,0,0,0,0,3,0,0,3,1
4105,140129,OEm3RfkF7zW7QGdEGDuqH9AvGYPU4cwb,7GRhBDsirIGkRZBtSMEzNTyDr2JQm4xx,1,0,0,0,0,0,1,0,1,0.14285714285714285,1,0.0,0,0,0,0,0,0,0,1,0,0,1,1
4106,140136,SzHyVEPONSslDMujP3r42FOEaBM1wLth,7GRhBDsirIGkRZBtSMEzNTyDr2JQm4xx,11,9,2,0,1,0,9,2,23,3.2857142857142856,2,0.0,0,2,0,1,9,0,0,9,2,3,20,1
4107,140141,EAibjZcnMEl7Giq03ulFFl7NUllRXm8X,7GRhBDsirIGkRZBtSMEzNTyDr2JQm4xx,1,0,0,0,0,0,2,0,2,0.2857142857142857,2,0.0,0,0,0,0,0,0,0,2,0,0,2,1
4108,140151,KFG6G55toGAeaWBt5UmyioW5n1NVxSjT,7GRhBDsirIGkRZBtSMEzNTyDr2JQm4xx,1,0,0,0,0,0,1,0,1,0.14285714285714285,1,0.0,0,0,0,0,0,0,0,1,0,0,1,1
4109,140155,B0ju9Oei4oSfT1FPNsvUdPiFSJAhjLX7,7GRhBDsirIGkRZBtSMEzNTyDr2JQm4xx,4,2,1,0,0,0,3,0,6,0.8571428571428571,2,0.0,0,1,0,0,2,0,0,3,0,1,5,1
4110,140161,QP61WzTD88M7Z43YJUY0WRxs9mL5DaLN,7GRhBDsirIGkRZBtSMEzNTyDr2JQm4xx,8,1,0,0,0,1,12,0,14,2.0,2,0.0,0,0,0,0,1,1,0,12,0,0,14,1
4111,140165,4NbBJgtOnvI4dKJO6U04PsO19ilNdxDa,7GRhBDsirIGkRZBtSMEzNTyDr2JQm4xx,8,2,1,0,1,1,6,2,13,1.8571428571428572,1,0.0,0,1,0,1,2,1,0,6,2,2,11,1
4112,140282,xcD6YWhnGA2xukGmX4eaYrm6VS9ffz1H,7GRhBDsirIGkRZBtSMEzNTyDr2JQm4xx,30,75,3,56,5,7,12,0,158,22.571428571428573,3,0.0,33,3,46,5,42,7,10,12,0,87,71,0
4113,140306,Ob79Za99PdIwrqcyAnuLEFhl9GSQ6Xz6,7GRhBDsirIGkRZBtSMEzNTyDr2JQm4xx,1,0,0,0,0,0,1,0,1,0.14285714285714285,1,0.0,0,0,0,0,0,0,0,1,0,0,1,1
4114,140329,H3cyUU6nxPSmVjGMKYWWKOtYQjRDHxeD,7GRhBDsirIGkRZBtSMEzNTyDr2JQm4xx,1,0,0,0,0,0,1,0,1,0.14285714285714285,1,0.0,0,0,0,0,0,0,0,1,0,0,1,1
4115,140341,IUMl6TF9SZyzdSkTs0p0M3q4lvkSdDmi,7GRhBDsirIGkRZBtSMEzNTyDr2JQm4xx,13,15,5,0,6,4,19,4,53,7.571428571428571,1,0.0,8,5,0,6,7,4,0,19,4,19,34,1
4116,140358,XawXAsPAfBtlXBQzpKPcgk3ZhHAMJWNJ,7GRhBDsirIGkRZBtSMEzNTyDr2JQm4xx,54,82,14,87,8,1,35,0,227,32.42857142857143,4,0.0,34,14,72,8,48,1,15,35,0,128,99,1
4117,140617,jxqH1Y0Ll1dSqJHW2X4uLUdvrbgDj0Cd,7GRhBDsirIGkRZBtSMEzNTyDr2JQm4xx,6,2,1,0,1,0,3,0,7,1.0,1,0.0,0,1,0,1,2,0,0,3,0,2,5,1
4118,140630,TYNUH36wQX48EZFChTHsXflAW5aqSPOs,7GRhBDsirIGkRZBtSMEzNTyDr2JQm4xx,3,0,0,0,0,3,2,0,5,0.7142857142857143,1,0.0,0,0,0,0,0,3,0,2,0,0,5,1
4119,140660,w8Pvw8WQP7Chw590vs3wc2RvlZ6Vvee0,7GRhBDsirIGkRZBtSMEzNTyDr2JQm4xx,20,31,0,14,0,6,10,1,62,8.857142857142858,1,0.0,9,0,7,0,22,6,7,10,1,16,46,0
4120,140667,yq9vHLk2LjPpNFyoMkV6FPLMiEC0nSyT,7GRhBDsirIGkRZBtSMEzNTyDr2JQm4xx,26,20,11,4,7,5,9,1,57,8.142857142857142,1,0.0,6,11,3,7,14,5,1,9,1,27,30,1
4121,143607,3iJrlZJEv2h7DgWBpz6wZtSXPXEy6IAY,bWdj2GDclj5ofokWjzoa5jAwMkxCykd6,5,3,2,0,1,0,1,0,7,1.0,1,0.0,0,2,0,1,3,0,0,1,0,3,4,1
4122,143623,HtMha1d9fNJoHGbwIKcB3HWdDU94w7Lj,SpATywNh6bZuzm8s1ceuBUnMUAeoAHHw,5,4,3,0,1,0,2,0,10,1.4285714285714286,1,0.0,0,3,0,1,4,0,0,2,0,4,6,1
4123,143858,uVezMKauDUYUFjTOlrwzQHcegaGFiPmr,A3fsA9Zfv1X2fVEQhTw51lKENdNrEqT3,31,21,1,62,1,0,6,0,91,13.0,1,0.0,1,1,58,1,20,0,4,6,0,61,30,1
4124,143867,Pnezq6slEV4CIBxIFIPqhlGLNILa8T8M,SpATywNh6bZuzm8s1ceuBUnMUAeoAHHw,4,3,0,0,0,0,2,0,5,0.7142857142857143,2,0.0,0,0,0,0,3,0,0,2,0,0,5,0
4125,143887,SKJH5bhXUHUXBV3YRjTcw0Oe5kVFAmnw,SpATywNh6bZuzm8s1ceuBUnMUAeoAHHw,7,5,4,4,0,0,1,0,14,2.0,1,0.0,0,4,3,0,5,0,1,1,0,7,7,1
4126,143888,CdBS5mGJVzgaGDeY8NzEjALJKus99MGR,SpATywNh6bZuzm8s1ceuBUnMUAeoAHHw,7,4,3,0,2,0,1,0,10,1.4285714285714286,1,0.0,0,3,0,2,4,0,0,1,0,5,5,1
4127,143891,UpT5KvhktZoGfL90nOmM9gx3GU38kT3j,bWdj2GDclj5ofokWjzoa5jAwMkxCykd6,3,0,0,0,0,0,5,0,5,0.7142857142857143,1,0.0,0,0,0,0,0,0,0,5,0,0,5,0
4128,143900,NWUbBzN3rFqJYQQKuHujeEDgr8fxabPr,SpATywNh6bZuzm8s1ceuBUnMUAeoAHHw,14,25,2,32,0,23,5,0,87,12.428571428571429,3,0.0,9,2,27,0,16,23,5,5,0,38,49,0
4129,143909,nwFT4lnmg30fCvHRB6tbALo9FpcanuLx,A3fsA9Zfv1X2fVEQhTw51lKENdNrEqT3,3,2,1,0,0,0,2,0,5,0.7142857142857143,1,0.0,0,1,0,0,2,0,0,2,0,1,4,1
4130,143933,Mi4V9PN04XHkOYjYbsNOyLc2HUiygd5R,SpATywNh6bZuzm8s1ceuBUnMUAeoAHHw,4,11,0,0,0,0,1,0,12,1.7142857142857142,1,0.0,0,0,0,0,11,0,0,1,0,0,12,1
4131,143945,U0EvfjsY5qqb8sRRReWuk6YqXYpCTRVc,SpATywNh6bZuzm8s1ceuBUnMUAeoAHHw,16,14,9,15,5,0,1,0,44,6.285714285714286,1,0.0,4,9,15,5,10,0,0,1,0,33,11,0
4132,144007,jSNLRK8jxSbbcqhbWW7DXZqoGlvGgXDY,SpATywNh6bZuzm8s1ceuBUnMUAeoAHHw,9,14,2,3,0,0,3,0,22,3.142857142857143,3,0.0,0,2,3,0,14,0,0,3,0,5,17,0
4133,144009,xbYSqp0T7Uu69VoCNyfTCvQcS3HV3UeU,A3fsA9Zfv1X2fVEQhTw51lKENdNrEqT3,4,2,1,0,0,2,2,0,7,1.0,1,0.0,0,1,0,0,2,2,0,2,0,1,6,1
4134,144041,oqyavd6F0mKguMPCfvp0hDFA1MAPWGfD,SpATywNh6bZuzm8s1ceuBUnMUAeoAHHw,5,3,2,0,1,0,1,0,7,1.0,1,0.0,0,2,0,1,3,0,0,1,0,3,4,0
4135,144071,N3PF6286hfkTToYfzWd10OYG6jiYeyxL,A3fsA9Zfv1X2fVEQhTw51lKENdNrEqT3,9,5,4,0,3,0,1,0,13,1.8571428571428572,1,0.0,0,4,0,3,5,0,0,1,0,7,6,1
4136,144112,A41hdT15T7mumzDW53QCDXRUsOilvTI0,A3fsA9Zfv1X2fVEQhTw51lKENdNrEqT3,7,5,3,0,2,0,1,0,11,1.5714285714285714,1,0.0,0,3,0,2,5,0,0,1,0,5,6,0
4137,144163,Mi04UWZgqcHrMSZckQSYxOftI8OPYCzT,G8EPVSXsOYB5YQWZGiz1aVq5Pgr2GrQu,68,27,1,260,1,0,8,0,297,42.42857142857143,1,0.0,6,1,222,1,21,0,38,8,0,230,67,0
4138,144173,mSs5bB1Rxg3xYWjWjJY9pVTt7WAiMgyu,A3fsA9Zfv1X2fVEQhTw51lKENdNrEqT3,7,3,2,0,0,0,5,0,10,1.4285714285714286,1,0.0,0,2,0,0,3,0,0,5,0,2,8,0
4139,144240,BPLF5bOPHidVrP3JGHCr9npCCCPEhz1g,SpATywNh6bZuzm8s1ceuBUnMUAeoAHHw,15,11,6,12,4,0,1,0,34,4.857142857142857,1,0.0,4,6,12,4,7,0,0,1,0,26,8,1
4140,144244,y3GJh8xEC6iboTvFOS91chZLMqYyEapH,G8EPVSXsOYB5YQWZGiz1aVq5Pgr2GrQu,9,15,1,0,1,0,1,0,18,2.5714285714285716,1,0.0,1,1,0,1,14,0,0,1,0,3,15,1
4141,144260,NxRna5VYeAvwKdtdFMhqdPkmD703DSHi,SpATywNh6bZuzm8s1ceuBUnMUAeoAHHw,5,3,2,0,1,0,1,0,7,1.0,1,0.0,0,2,0,1,3,0,0,1,0,3,4,1
4142,144325,IKQYwh1PoPanPyuEqIIRzDtzc0tOUD2x,SpATywNh6bZuzm8s1ceuBUnMUAeoAHHw,5,3,1,0,1,0,1,0,6,0.8571428571428571,1,0.0,0,1,0,1,3,0,0,1,0,2,4,0
4143,144327,SKemaavr5OG5spO92jXls0zhTMuWKDja,A3fsA9Zfv1X2fVEQhTw51lKENdNrEqT3,27,13,8,82,3,0,1,0,107,15.285714285714286,1,0.0,1,8,71,3,12,0,11,1,0,83,24,1
4144,144349,0Xxh6UWDrWwPPLaMpUv0ZEdnE00mPUSR,A3fsA9Zfv1X2fVEQhTw51lKENdNrEqT3,15,8,5,0,3,1,6,1,24,3.4285714285714284,1,0.0,0,5,0,3,8,1,0,6,1,8,16,0
4145,144370,BdodnRCsey53xS6PtugKwlzojwI7pwLX,bWdj2GDclj5ofokWjzoa5jAwMkxCykd6,5,3,2,0,1,0,1,0,7,1.0,1,0.0,0,2,0,1,3,0,0,1,0,3,4,0
4146,144415,6ElmeAobgOVWMQKbfyTe96fhVbG33C2X,SpATywNh6bZuzm8s1ceuBUnMUAeoAHHw,4,2,1,0,1,0,1,0,5,0.7142857142857143,1,0.0,0,1,0,1,2,0,0,1,0,2,3,1
4147,144479,85biSqbQ9pgTGTSoZq3mDHUWbBBUYgJi,SpATywNh6bZuzm8s1ceuBUnMUAeoAHHw,11,8,7,0,6,0,1,0,22,3.142857142857143,1,0.0,0,7,0,6,8,0,0,1,0,13,9,0
4148,144578,OUsTbnD6QZatQvggR5YjMxWOH6TYQEkw,SpATywNh6bZuzm8s1ceuBUnMUAeoAHHw,1,0,0,0,0,0,1,0,1,0.14285714285714285,1,0.0,0,0,0,0,0,0,0,1,0,0,1,1
4149,144604,5ehf4EFN8WhDbvmb2WvfZwpaBD0cj1oj,A3fsA9Zfv1X2fVEQhTw51lKENdNrEqT3,42,8,0,110,0,0,1,0,119,17.0,1,0.0,2,0,109,0,6,0,1,1,0,111,8,1
4150,144642,9qlyY7aaGl7nuKeZpypgQ9ZpHmFszatV,A3fsA9Zfv1X2fVEQhTw51lKENdNrEqT3,11,8,6,0,4,0,5,0,23,3.2857142857142856,1,0.0,0,6,0,4,8,0,0,5,0,10,13,1
4151,144667,uk1SKekwkpaHXYRLjN8ZintRuJ2tncOb,SpATywNh6bZuzm8s1ceuBUnMUAeoAHHw,9,12,11,0,10,0,1,0,34,4.857142857142857,1,0.0,0,11,0,10,12,0,0,1,0,21,13,0
4152,144703,Edq6Echk8wEs8ShX5RBw5c8Yx8ANHVje,A3fsA9Zfv1X2fVEQhTw51lKENdNrEqT3,4,5,3,0,0,0,3,0,11,1.5714285714285714,2,0.0,0,3,0,0,5,0,0,3,0,3,8,1
4153,144709,Edq6Echk8wEs8ShX5RBw5c8Yx8ANHVje,RXDvfPUBYFlVdlueBFbLW0mhhAyGEqpt,7,7,4,0,0,0,4,1,16,2.2857142857142856,1,0.0,0,4,0,0,7,0,0,4,1,4,12,1
4154,144772,yB2j2tPO2DVKCBBdsLv8a1lbHtfWINMh,A3fsA9Zfv1X2fVEQhTw51lKENdNrEqT3,10,12,9,0,6,0,4,0,31,4.428571428571429,3,0.0,0,9,0,6,12,0,0,4,0,15,16,0
4155,144793,Q4yECXO7W1LpqtiMAu4zBn3zpNL7asTt,RXDvfPUBYFlVdlueBFbLW0mhhAyGEqpt,1,0,0,0,0,0,1,0,1,0.14285714285714285,1,0.0,0,0,0,0,0,0,0,1,0,0,1,1
4156,144998,QbBXesiuS3b5lRVZqzzdKh71YLAIKh1k,A3fsA9Zfv1X2fVEQhTw51lKENdNrEqT3,12,5,4,0,2,1,6,1,19,2.7142857142857144,1,0.0,0,4,0,2,5,1,0,6,1,6,13,0
4157,145182,JkokNSOVQ0CmVMNuEphopYOXBxfXEJtF,SpATywNh6bZuzm8s1ceuBUnMUAeoAHHw,13,36,12,19,2,0,3,0,72,10.285714285714286,2,0.0,19,12,17,2,17,0,2,3,0,50,22,1
4158,145183,l5XRpi9H4fQ2XUHeEPRXRHL6Y4BckIOB,bWdj2GDclj5ofokWjzoa5jAwMkxCykd6,4,3,1,0,0,0,1,0,5,0.7142857142857143,1,0.0,0,1,0,0,3,0,0,1,0,1,4,1
4159,145473,UNqMz63UOiLuXMnJzd7YWyfD3qIuNdaK,A3fsA9Zfv1X2fVEQhTw51lKENdNrEqT3,92,23,19,176,15,0,8,0,241,34.42857142857143,2,0.0,3,19,158,15,20,0,18,8,0,195,46,1
4160,145608,3kzqQ9nu0puySXndbv8HvzuMPwBlBjfc,7GRhBDsirIGkRZBtSMEzNTyDr2JQm4xx,11,46,8,10,0,3,3,0,70,10.0,1,0.0,30,8,6,0,16,3,4,3,0,44,26,1
4161,145622,520kTOJ5a6HoTMe30flreSub2cyQqOhY,7GRhBDsirIGkRZBtSMEzNTyDr2JQm4xx,26,61,24,46,12,11,3,0,157,22.428571428571427,1,0.0,31,24,40,12,30,11,6,3,0,107,50,1
4162,145817,sqxWpMhcYtYMOXwrr0icUXKE79UdB0Zx,7GRhBDsirIGkRZBtSMEzNTyDr2JQm4xx,8,11,1,0,1,0,4,0,17,2.4285714285714284,2,0.0,0,1,0,1,11,0,0,4,0,2,15,1
4163,146597,hZ1mlUhiSpFjS9yt4BS7Q5R6oePk7XBR,7GRhBDsirIGkRZBtSMEzNTyDr2JQm4xx,2,0,0,0,0,0,2,0,2,0.2857142857142857,1,0.0,0,0,0,0,0,0,0,2,0,0,2,1
4164,146615,rmeg7X4GVDaLpVKMtXig1xBKyxmbOLNP,7GRhBDsirIGkRZBtSMEzNTyDr2JQm4xx,1,0,0,0,0,0,1,0,1,0.14285714285714285,1,0.0,0,0,0,0,0,0,0,1,0,0,1,0
4165,147774,GwBsELCYAYNo2pcJ3Hwab6UtiG3ye1Qj,fbPkOYLVPtPgIt0MxizjfFJov3JbHyAi,3,0,0,0,0,1,4,0,5,0.7142857142857143,1,0.0,0,0,0,0,0,1,0,4,0,0,5,1
4166,148334,7gxdF7npc77h7z0KnU9ezGYqtBJqY4fQ,7GRhBDsirIGkRZBtSMEzNTyDr2JQm4xx,7,4,3,0,2,0,1,0,10,1.4285714285714286,1,0.0,0,3,0,2,4,0,0,1,0,5,5,0
4167,148359,uZ1O39GxSmePAndNprQEBYYChQSQNkhB,fbPkOYLVPtPgIt0MxizjfFJov3JbHyAi,2,6,2,0,0,0,0,0,8,1.1428571428571428,2,0.0,0,2,0,0,6,0,0,0,0,2,6,1
4168,148380,mmXnUf3Xp68sXzzvqqAwsEL8YCYNkHx6,fbPkOYLVPtPgIt0MxizjfFJov3JbHyAi,7,7,4,0,3,0,1,0,15,2.142857142857143,1,0.0,2,4,0,3,5,0,0,1,0,9,6,1
4169,148454,te56qI7gFuKkLlkl183DRyiCJEOrbcwN,G8EPVSXsOYB5YQWZGiz1aVq5Pgr2GrQu,19,6,5,26,4,0,3,0,44,6.285714285714286,1,0.0,0,5,22,4,6,0,4,3,0,31,13,1
4170,148458,VMUftRICmOOnQZ0My9Or4atgcbBsD9Pm,A3fsA9Zfv1X2fVEQhTw51lKENdNrEqT3,11,5,4,0,4,0,3,0,16,2.2857142857142856,2,0.0,0,4,0,4,5,0,0,3,0,8,8,1
4171,148471,kvxGydllm6BLbdP0nm9jaxgMVk1FHTYp,bWdj2GDclj5ofokWjzoa5jAwMkxCykd6,6,6,3,0,0,0,4,0,13,1.8571428571428572,2,0.0,0,3,0,0,6,0,0,4,0,3,10,1
4172,148482,RyilkQdPLBJZ4lFr5oZI0Ei4sfkfiESh,A3fsA9Zfv1X2fVEQhTw51lKENdNrEqT3,11,5,4,0,4,0,2,0,15,2.142857142857143,1,0.0,0,4,0,4,5,0,0,2,0,8,7,1
4173,148536,uUMzdUTmgEhjr2EnA8XtLfriryCG2TOf,SpATywNh6bZuzm8s1ceuBUnMUAeoAHHw,22,21,0,18,0,10,7,2,58,8.285714285714286,1,0.0,9,0,16,0,12,10,2,7,2,25,33,0
4174,148537,Wz31P9oU8oqAKC2lD9NdSTmdPqPDYHDG,SpATywNh6bZuzm8s1ceuBUnMUAeoAHHw,12,11,7,2,3,0,3,0,26,3.7142857142857144,2,0.0,0,7,2,3,11,0,0,3,0,12,14,0
4175,148584,57XEpd7q9eLjUEqADz7df27SQD70MfYe,A3fsA9Zfv1X2fVEQhTw51lKENdNrEqT3,1,0,0,0,0,0,1,0,1,0.14285714285714285,1,0.0,0,0,0,0,0,0,0,1,0,0,1,1
4176,148587,LIH6u87VTR1542727Uc42mhP2iK5GaFP,SpATywNh6bZuzm8s1ceuBUnMUAeoAHHw,14,20,1,6,1,11,4,7,50,7.142857142857143,1,0.0,3,1,5,1,17,11,1,4,7,10,40,0
4177,148653,fO1rPCd8LF1QZM5kj2eXZwLqI6uO4Zpz,A3fsA9Zfv1X2fVEQhTw51lKENdNrEqT3,39,38,28,44,9,6,12,1,138,19.714285714285715,4,0.0,1,28,34,9,37,6,10,12,1,72,66,1
4178,148683,yIj21E2mCqn2XcQ0nicOfMS257aUaO89,A3fsA9Zfv1X2fVEQhTw51lKENdNrEqT3,1,0,0,0,0,0,1,0,1,0.14285714285714285,1,0.0,0,0,0,0,0,0,0,1,0,0,1,1
4179,148692,XydvMA0BgL1Al10q3L0D2wz1Y6wVb2rC,A3fsA9Zfv1X2fVEQhTw51lKENdNrEqT3,21,21,13,0,9,0,6,0,49,7.0,3,0.0,0,13,0,9,21,0,0,6,0,22,27,0
4180,148694,XydvMA0BgL1Al10q3L0D2wz1Y6wVb2rC,bWdj2GDclj5ofokWjzoa5jAwMkxCykd6,12,7,6,0,5,0,2,0,20,2.857142857142857,1,0.0,0,6,0,5,7,0,0,2,0,11,9,0
4181,148706,uhhlffPGiUyqHwKWs4eYUM0KXbbqijwF,A3fsA9Zfv1X2fVEQhTw51lKENdNrEqT3,4,2,1,0,1,0,1,0,5,0.7142857142857143,2,0.0,0,1,0,1,2,0,0,1,0,2,3,1
4182,148727,ztmaclrddFYSGIsZoWSUrGCZBLNiuvyf,A3fsA9Zfv1X2fVEQhTw51lKENdNrEqT3,8,6,1,0,1,0,3,0,11,1.5714285714285714,2,0.0,0,1,0,1,6,0,0,3,0,2,9,1
4183,148848,R2arBlVQ5DlnqBrwRZJfviZdapFQUxuy,A3fsA9Zfv1X2fVEQhTw51lKENdNrEqT3,7,4,3,0,3,0,6,0,16,2.2857142857142856,2,0.0,0,3,0,3,4,0,0,6,0,6,10,1
4184,148853,GMzSpgZQ6jzVsfHn8W8i83JsYNxnP00b,SpATywNh6bZuzm8s1ceuBUnMUAeoAHHw,16,16,9,20,3,0,3,0,51,7.285714285714286,2,0.0,4,9,16,3,12,0,4,3,0,32,19,0
4185,148860,19rBJNWc3TdUmLpZx1LViNSUBx0S4WJI,RXDvfPUBYFlVdlueBFbLW0mhhAyGEqpt,6,2,0,0,0,1,6,0,9,1.2857142857142858,1,0.0,0,0,0,0,2,1,0,6,0,0,9,0
4186,148904,xIxATd7wQJbG534PldlbQAAGp3iomo3s,SpATywNh6bZuzm8s1ceuBUnMUAeoAHHw,27,39,13,29,6,0,3,0,90,12.857142857142858,1,0.0,17,13,28,6,22,0,1,3,0,64,26,1
4187,148949,KVBhg9xLiQ9g29dG7acnqU2JhAhcB1WP,SpATywNh6bZuzm8s1ceuBUnMUAeoAHHw,5,5,4,0,1,1,2,0,13,1.8571428571428572,1,0.0,0,4,0,1,5,1,0,2,0,5,8,1
4188,149024,7FIeNTQkn5xTpBcMu7fzrbX3yIgG7ERg,SpATywNh6bZuzm8s1ceuBUnMUAeoAHHw,18,36,29,0,20,1,10,0,96,13.714285714285714,3,0.0,0,29,0,20,36,1,0,10,0,49,47,0
4189,149033,SfdcNKoJXbzDoiv0d6m3J1MnlTZjsesZ,SpATywNh6bZuzm8s1ceuBUnMUAeoAHHw,5,3,1,0,0,0,2,0,6,0.8571428571428571,1,0.0,0,1,0,0,3,0,0,2,0,1,5,1
4190,149077,tvs2CHlzCZXNqvPsCXS6KuyuottEQsCw,A3fsA9Zfv1X2fVEQhTw51lKENdNrEqT3,8,17,5,0,1,0,11,0,34,4.857142857142857,3,0.0,0,5,0,1,17,0,0,11,0,6,28,1
4191,149088,VdBr9evtUZMzf2druMXhbLcZsJI81UOn,A3fsA9Zfv1X2fVEQhTw51lKENdNrEqT3,43,25,14,50,11,0,6,0,106,15.142857142857142,2,0.0,4,14,46,11,21,0,4,6,0,75,31,1
4192,149100,L6Z8ewPMlWVkLltZWo9qRrYBvHNEsyN9,SpATywNh6bZuzm8s1ceuBUnMUAeoAHHw,10,16,3,0,2,0,7,1,29,4.142857142857143,3,0.0,1,3,0,2,15,0,0,7,1,6,23,0
4193,149109,5is3QPvmCTb2wCYPovTArJero2U5eHRU,SpATywNh6bZuzm8s1ceuBUnMUAeoAHHw,3,2,1,0,0,0,1,0,4,0.5714285714285714,1,0.0,0,1,0,0,2,0,0,1,0,1,3,0
4194,149160,aJHRT3LiLupkaY9OS8kHMvtwJmIsdmDj,A3fsA9Zfv1X2fVEQhTw51lKENdNrEqT3,1,0,0,0,0,0,1,0,1,0.14285714285714285,1,0.0,0,0,0,0,0,0,0,1,0,0,1,1
4195,149168,g1J6BQ7EhQE8jfd7gZPRzLZeukbRbkuA,SpATywNh6bZuzm8s1ceuBUnMUAeoAHHw,5,3,1,0,1,0,4,0,9,1.2857142857142858,1,0.0,0,1,0,1,3,0,0,4,0,2,7,0
4196,149169,SG7N8DhpCuhIu06IIzLX0CSolbyIDsIx,A3fsA9Zfv1X2fVEQhTw51lKENdNrEqT3,15,10,7,0,7,0,3,0,27,3.857142857142857,3,0.0,0,7,0,7,10,0,0,3,0,14,13,1
4197,149173,MTBFJm3bIEaE6OQdIPJiDEIIoJhDDIeA,A3fsA9Zfv1X2fVEQhTw51lKENdNrEqT3,33,15,1,50,1,0,6,0,73,10.428571428571429,2,0.0,1,1,49,1,14,0,1,6,0,52,21,1
4198,149281,SSmzTwHw2pJ3n53tqYFDDB8Zh2JeAHoz,SpATywNh6bZuzm8s1ceuBUnMUAeoAHHw,15,24,9,17,4,1,5,0,60,8.571428571428571,1,0.0,15,9,15,4,9,1,2,5,0,43,17,1
4199,149287,XqrZf8R9BrkWGkETcqhxlHJsow5TwWGG,SpATywNh6bZuzm8s1ceuBUnMUAeoAHHw,5,2,1,0,1,0,3,0,7,1.0,1,0.0,0,1,0,1,2,0,0,3,0,2,5,1
4200,149303,qVL008tAQyHTveNNTUZJN2fiJMviNw9f,A3fsA9Zfv1X2fVEQhTw51lKENdNrEqT3,3,4,1,0,0,0,2,0,7,1.0,1,0.0,0,1,0,0,4,0,0,2,0,1,6,1
4201,149332,9d8tCYKPfh5NHPKNlwRKmrZh3Cuf1Ls2,SpATywNh6bZuzm8s1ceuBUnMUAeoAHHw,24,45,15,0,7,3,8,2,80,11.428571428571429,1,0.0,0,15,0,7,45,3,0,8,2,22,58,0
4202,149365,TiIxJTIN7tI8yF4YwMuZjwFItOZJF5Yy,A3fsA9Zfv1X2fVEQhTw51lKENdNrEqT3,4,2,0,0,0,0,2,0,4,0.5714285714285714,1,0.0,0,0,0,0,2,0,0,2,0,0,4,1
4203,149416,PFJhF2sNLYftHHb21pjL43RM5viviTlT,SpATywNh6bZuzm8s1ceuBUnMUAeoAHHw,17,29,13,8,6,0,2,0,58,8.285714285714286,2,0.0,4,13,8,6,25,0,0,2,0,31,27,0
4204,149423,Pdvh6UTK9FXuCE4WVrV5Y121aJBdVbkt,RXDvfPUBYFlVdlueBFbLW0mhhAyGEqpt,30,43,29,21,7,7,11,1,119,17.0,2,0.0,6,29,21,7,37,7,0,11,1,63,56,0
4205,149431,I45Q3yivyiRN2kHVhbV8bUCfrXvtpUvU,SpATywNh6bZuzm8s1ceuBUnMUAeoAHHw,3,2,1,0,0,0,1,0,4,0.5714285714285714,1,0.0,0,1,0,0,2,0,0,1,0,1,3,0
4206,149449,RthO8kTkOrnZ3vUDn574hHyfG3vroBt1,RXDvfPUBYFlVdlueBFbLW0mhhAyGEqpt,27,53,27,0,15,2,9,0,106,15.142857142857142,2,0.0,12,27,0,15,41,2,0,9,0,54,52,0
4207,149458,bw2aO24aZZlJC7FupBFz9UeLH8ZisJZV,A3fsA9Zfv1X2fVEQhTw51lKENdNrEqT3,1,0,0,0,0,0,1,0,1,0.14285714285714285,1,0.0,0,0,0,0,0,0,0,1,0,0,1,1
4208,149492,Ev6KS9MaK9gTGqPDnT9PUK5kybHZnCjh,RXDvfPUBYFlVdlueBFbLW0mhhAyGEqpt,23,49,24,0,16,5,11,11,116,16.571428571428573,1,0.0,2,24,0,16,47,5,0,11,11,42,74,1
4209,149522,WqAusnIIyrtKc88YNA1pWn9FFnkfXjMW,A3fsA9Zfv1X2fVEQhTw51lKENdNrEqT3,12,20,2,0,1,0,12,0,35,5.0,1,0.0,0,2,0,1,20,0,0,12,0,3,32,1
4210,149525,HPkALZZsSIxF1Lb5N1jgVgi94EMe9pvG,SpATywNh6bZuzm8s1ceuBUnMUAeoAHHw,8,2,2,0,2,0,6,0,12,1.7142857142857142,2,0.0,0,2,0,2,2,0,0,6,0,4,8,1
4211,149572,PD0QXI0Ip2PVwJ6kJaKkkINkj7BvGZMC,A3fsA9Zfv1X2fVEQhTw51lKENdNrEqT3,3,1,0,0,0,0,12,0,13,1.8571428571428572,2,0.0,0,0,0,0,1,0,0,12,0,0,13,1
4212,149642,BvI5CiGNtYcKpjVG9fTMezMQs6vWmHfH,A3fsA9Zfv1X2fVEQhTw51lKENdNrEqT3,6,2,0,0,0,0,6,0,8,1.1428571428571428,2,0.0,0,0,0,0,2,0,0,6,0,0,8,1
4213,149665,0k9erSYQLRK4wIQFPxo1tbDP6EMqZIo0,A3fsA9Zfv1X2fVEQhTw51lKENdNrEqT3,7,2,2,0,2,0,2,0,8,1.1428571428571428,1,0.0,0,2,0,2,2,0,0,2,0,4,4,1
4214,149666,pAkhnLI0s5vboktZycO7Tobv6jbspULh,A3fsA9Zfv1X2fVEQhTw51lKENdNrEqT3,1,0,0,0,0,0,1,0,1,0.14285714285714285,1,0.0,0,0,0,0,0,0,0,1,0,0,1,1
4215,149756,3gPbGxzoDDN9YTm77syKKM4Upb2G3bUj,A3fsA9Zfv1X2fVEQhTw51lKENdNrEqT3,18,13,8,0,6,0,6,0,33,4.714285714285714,1,0.0,0,8,0,6,13,0,0,6,0,14,19,1
4216,149764,nKMPTOF6v1sp7aVmO78zmSRg9f9QXrTf,bWdj2GDclj5ofokWjzoa5jAwMkxCykd6,14,21,15,10,3,22,5,0,76,10.857142857142858,3,0.0,1,15,9,3,20,22,1,5,0,28,48,0
4217,149820,iSiPEDuhdTDGTEOpkEJzXCeneTDhblqT,A3fsA9Zfv1X2fVEQhTw51lKENdNrEqT3,2,0,0,0,0,0,7,0,7,1.0,1,0.0,0,0,0,0,0,0,0,7,0,0,7,1
4218,149821,j7cR8MulZ7sIljFq9IIvuWVX0W2fGIFM,SpATywNh6bZuzm8s1ceuBUnMUAeoAHHw,15,18,10,10,3,5,8,0,54,7.714285714285714,4,0.0,3,10,9,3,15,5,1,8,0,25,29,0
4219,149848,C8zDhaG0vPsQegBtS55u3JZHiYuueFnE,RXDvfPUBYFlVdlueBFbLW0mhhAyGEqpt,1,0,0,0,0,0,1,0,1,0.14285714285714285,1,0.0,0,0,0,0,0,0,0,1,0,0,1,1
4220,149884,Z95Ku89uNGg04oFkXKdLR1VrvyAEL044,SpATywNh6bZuzm8s1ceuBUnMUAeoAHHw,13,14,1,4,0,0,2,0,21,3.0,1,0.0,2,1,4,0,12,0,0,2,0,7,14,0
4221,150005,D5IkCYseUCO88GE1B1rMaRAAZyqCPk5T,SpATywNh6bZuzm8s1ceuBUnMUAeoAHHw,8,11,6,0,1,0,2,0,20,2.857142857142857,2,0.0,0,6,0,1,11,0,0,2,0,7,13,0
4222,150066,kFq2dX2idryINNQb9BQiBNQL0jaWL2j5,A3fsA9Zfv1X2fVEQhTw51lKENdNrEqT3,11,5,4,0,4,0,8,0,21,3.0,1,0.0,0,4,0,4,5,0,0,8,0,8,13,1
4223,150105,G2qtWwR1edRN2N5qfu1AgRch8m00Htg9,SpATywNh6bZuzm8s1ceuBUnMUAeoAHHw,10,9,5,0,2,0,5,0,21,3.0,3,0.0,0,5,0,2,9,0,0,5,0,7,14,1
4224,150109,gi01S7jVC7j5JiJq4Tw62NMLgY0GYZHL,A3fsA9Zfv1X2fVEQhTw51lKENdNrEqT3,45,28,17,80,10,15,9,2,161,23.0,2,0.0,2,17,62,10,26,15,18,9,2,91,70,1
4225,152931,bKVslXuzEQ1pv4c6iV5mVjs6X6avUbmL,7GRhBDsirIGkRZBtSMEzNTyDr2JQm4xx,1,1,0,0,0,0,0,0,1,0.14285714285714285,1,0.0,0,0,0,0,1,0,0,0,0,0,1,1
4226,152938,Lf93y7eBw6lMLWUxl2k8Aa6sTuqt3rkX,7GRhBDsirIGkRZBtSMEzNTyDr2JQm4xx,8,7,1,0,1,0,4,1,14,2.0,1,0.0,0,1,0,1,7,0,0,4,1,2,12,1
4227,153809,57xBvLPGpSkzxqkLuJgHQNjPmsEoPQJW,A3fsA9Zfv1X2fVEQhTw51lKENdNrEqT3,3,2,1,0,0,0,1,0,4,0.5714285714285714,1,0.0,0,1,0,0,2,0,0,1,0,1,3,1
4228,153874,KSxx5GQKyHs39JznmMANF7eJRsaveHfw,A3fsA9Zfv1X2fVEQhTw51lKENdNrEqT3,5,2,1,0,0,3,4,1,11,1.5714285714285714,1,0.0,0,1,0,0,2,3,0,4,1,1,10,1
4229,153950,4IJ56QlJSL8avuRQEkrBcEyhUIO3LIP3,A3fsA9Zfv1X2fVEQhTw51lKENdNrEqT3,28,10,5,36,1,0,7,0,59,8.428571428571429,2,0.0,3,5,36,1,7,0,0,7,0,45,14,0
4230,153958,LhMGo1H458StfoGsiIJMkiDJEIOqqbKe,SpATywNh6bZuzm8s1ceuBUnMUAeoAHHw,8,7,6,0,1,0,1,0,15,2.142857142857143,1,0.0,0,6,0,1,7,0,0,1,0,7,8,0
4231,153988,vN0Rkga5RDQhnR6Qd8HVKAqnd5DqO9Q9,G8EPVSXsOYB5YQWZGiz1aVq5Pgr2GrQu,4,3,1,0,1,0,2,0,7,1.0,1,0.0,0,1,0,1,3,0,0,2,0,2,5,1
4232,153990,wUS4QMZENKgcJOovrFGfoZniw3fDJWWg,SpATywNh6bZuzm8s1ceuBUnMUAeoAHHw,4,4,2,0,0,0,4,0,10,1.4285714285714286,4,0.0,1,2,0,0,3,0,0,4,0,3,7,0
4233,154093,p6TgFJdLQMaMzbR16kycIPcRPnBj3paK,SpATywNh6bZuzm8s1ceuBUnMUAeoAHHw,1,0,0,0,0,0,1,0,1,0.14285714285714285,1,0.0,0,0,0,0,0,0,0,1,0,0,1,1
4234,154104,9Jy1wR1kNKfVIlzkWjf6DnrfYfDGnPzT,SpATywNh6bZuzm8s1ceuBUnMUAeoAHHw,5,5,3,0,1,0,2,0,11,1.5714285714285714,1,0.0,0,3,0,1,5,0,0,2,0,4,7,0
4235,154200,ADL0cXowUMs4wyiAOHKMOrtTHu5tmUqi,bWdj2GDclj5ofokWjzoa5jAwMkxCykd6,5,3,2,0,1,0,2,0,8,1.1428571428571428,1,0.0,0,2,0,1,3,0,0,2,0,3,5,1
4236,154221,1L7XwCOwn8nIJFjaEmGoI47SzrXbe8CM,SpATywNh6bZuzm8s1ceuBUnMUAeoAHHw,19,22,2,16,1,58,20,5,124,17.714285714285715,3,0.0,8,2,14,1,14,58,2,20,5,25,99,0
4237,154301,Q95csmmf8N84WQQSbOMc5rN6dm3wzDuG,SpATywNh6bZuzm8s1ceuBUnMUAeoAHHw,12,45,1,5,0,0,1,0,52,7.428571428571429,1,0.0,0,1,4,0,45,0,1,1,0,5,47,0
4238,154428,Xbjcs0h4iqswHrts5r1qniR6WxCj6WXz,SpATywNh6bZuzm8s1ceuBUnMUAeoAHHw,8,2,1,0,1,1,6,1,12,1.7142857142857142,1,0.0,0,1,0,1,2,1,0,6,1,2,10,1
4239,154484,iacqYcgHTn7FZ8NE4roe5kgAUjDF0efr,7GRhBDsirIGkRZBtSMEzNTyDr2JQm4xx,4,5,3,0,0,0,3,0,11,1.5714285714285714,1,0.0,0,3,0,0,5,0,0,3,0,3,8,1
4240,154808,qk3k8D6g4BBZslMQhuZKH29auh1oUGgB,SpATywNh6bZuzm8s1ceuBUnMUAeoAHHw,7,12,7,2,2,0,2,0,25,3.5714285714285716,1,0.0,4,7,2,2,8,0,0,2,0,15,10,0
4241,155027,PexOV0LWT1fDCzyfhjsaD6ViAyGfZwtP,SpATywNh6bZuzm8s1ceuBUnMUAeoAHHw,17,16,8,22,6,0,2,0,54,7.714285714285714,2,0.0,4,8,18,6,12,0,4,2,0,36,18,1
4242,155262,B1DHRbN7OgYmrICROsReSgvpNCm4AE9D,A3fsA9Zfv1X2fVEQhTw51lKENdNrEqT3,1,0,0,0,0,0,1,0,1,0.14285714285714285,1,0.0,0,0,0,0,0,0,0,1,0,0,1,1
4243,155427,CORJXNhWUR52sdjQNNf8qLspXXnCgswJ,A3fsA9Zfv1X2fVEQhTw51lKENdNrEqT3,4,3,3,0,0,0,4,0,10,1.4285714285714286,1,0.0,0,3,0,0,3,0,0,4,0,3,7,1
4244,155458,anKy5XeCNcJg717tYlt4WP7NvJptZoH3,RXDvfPUBYFlVdlueBFbLW0mhhAyGEqpt,14,7,6,0,5,0,3,0,21,3.0,1,0.0,0,6,0,5,7,0,0,3,0,11,10,1
4245,155485,QjfVyTofFZLLFWX1ehKLt5ilQSOSAPiY,SpATywNh6bZuzm8s1ceuBUnMUAeoAHHw,28,30,16,38,7,9,4,0,104,14.857142857142858,1,0.0,13,16,33,7,17,9,5,4,0,69,35,1
4246,155497,QXCbenecbpNtho5u82xZRFTWClxbJ6H8,bWdj2GDclj5ofokWjzoa5jAwMkxCykd6,7,2,1,0,1,0,5,1,10,1.4285714285714286,1,0.0,0,1,0,1,2,0,0,5,1,2,8,1
4247,155502,4fggBiTulBMhqyvK9Klo3I0joX8sXLqR,G8EPVSXsOYB5YQWZGiz1aVq5Pgr2GrQu,1,0,0,0,0,0,1,0,1,0.14285714285714285,1,0.0,0,0,0,0,0,0,0,1,0,0,1,1
4248,155526,90qbve2c7woP8H6gtxTaHw527Ldlfcdt,SpATywNh6bZuzm8s1ceuBUnMUAeoAHHw,1,0,0,0,0,0,1,0,1,0.14285714285714285,1,0.0,0,0,0,0,0,0,0,1,0,0,1,1
4249,155529,90qbve2c7woP8H6gtxTaHw527Ldlfcdt,G8EPVSXsOYB5YQWZGiz1aVq5Pgr2GrQu,1,0,0,0,0,0,1,0,1,0.14285714285714285,1,0.0,0,0,0,0,0,0,0,1,0,0,1,1
4250,155530,j46DNjv2CGqL26N5PDFntx4e9zPVHO6p,G8EPVSXsOYB5YQWZGiz1aVq5Pgr2GrQu,2,0,0,0,0,0,2,0,2,0.2857142857142857,1,0.0,0,0,0,0,0,0,0,2,0,0,2,1
4251,155552,M3hg5TCyBFjaInA6DUnH93lf18qdYvu6,SpATywNh6bZuzm8s1ceuBUnMUAeoAHHw,10,3,2,0,2,8,8,1,24,3.4285714285714284,1,0.0,1,2,0,2,2,8,0,8,1,5,19,1
4252,155562,f7tZxTkA0B7yOxMWeydGO2hW0y86mAhD,RXDvfPUBYFlVdlueBFbLW0mhhAyGEqpt,3,2,1,0,0,0,1,0,4,0.5714285714285714,1,0.0,0,1,0,0,2,0,0,1,0,1,3,1
4253,155577,zvUmozhQnyXBySuAzEdyMCBcHeR55dKC,A3fsA9Zfv1X2fVEQhTw51lKENdNrEqT3,18,6,5,22,3,2,9,0,47,6.714285714285714,1,0.0,0,5,17,3,6,2,5,9,0,25,22,1
4254,155581,2ZRBFnStzt5cjrck9eS6oYGoTRuicZMh,G8EPVSXsOYB5YQWZGiz1aVq5Pgr2GrQu,4,3,1,0,1,0,0,0,5,0.7142857142857143,2,0.0,0,1,0,1,3,0,0,0,0,2,3,1
4255,155587,SKemaavr5OG5spO92jXls0zhTMuWKDja,bWdj2GDclj5ofokWjzoa5jAwMkxCykd6,1,0,0,0,0,0,1,0,1,0.14285714285714285,1,0.0,0,0,0,0,0,0,0,1,0,0,1,1
4256,155596,0qCFkatyVPL7csU80HaaNwiBF9ooLuJC,A3fsA9Zfv1X2fVEQhTw51lKENdNrEqT3,1,0,0,0,0,0,1,0,1,0.14285714285714285,1,0.0,0,0,0,0,0,0,0,1,0,0,1,1
4257,155605,SMXR6YI3QoKLXckr7byjkvJilyN0KrgC,bWdj2GDclj5ofokWjzoa5jAwMkxCykd6,5,7,2,0,3,0,5,0,17,2.4285714285714284,1,0.0,3,2,0,3,4,0,0,5,0,8,9,1
4258,155606,2rS9ufrltSIJVkQHjlKCjTvqcoR7anzz,bWdj2GDclj5ofokWjzoa5jAwMkxCykd6,4,3,1,0,1,0,1,0,6,0.8571428571428571,1,0.0,1,1,0,1,2,0,0,1,0,3,3,1
4259,155616,k0sbAnWIfD9ltAd5PyrJMhpQMWff3kVq,SpATywNh6bZuzm8s1ceuBUnMUAeoAHHw,10,16,7,0,7,0,1,0,31,4.428571428571429,2,0.0,0,7,0,7,16,0,0,1,0,14,17,1
4260,155617,VgnlAlKyJJS2tvM35xxyHRWLD1lxYQBK,SpATywNh6bZuzm8s1ceuBUnMUAeoAHHw,10,17,7,0,0,5,12,3,44,6.285714285714286,2,0.0,3,7,0,0,14,5,0,12,3,10,34,1
4261,155618,s6FY1tnJFeJCup1Eko54ROGWiTGeTtYm,SpATywNh6bZuzm8s1ceuBUnMUAeoAHHw,5,3,2,0,1,3,2,2,13,1.8571428571428572,1,0.0,0,2,0,1,3,3,0,2,2,3,10,0
4262,155629,R5PVQLHQfRcyGqt0KVpTkwcmfBgB3rs1,A3fsA9Zfv1X2fVEQhTw51lKENdNrEqT3,4,0,0,0,0,0,11,0,11,1.5714285714285714,2,0.0,0,0,0,0,0,0,0,11,0,0,11,0
4263,155640,dd7Jtt1fMMutX1RG7iWTpWNKUpGu8Lqf,bWdj2GDclj5ofokWjzoa5jAwMkxCykd6,8,13,7,18,0,11,13,0,62,8.857142857142858,3,0.0,2,7,17,0,11,11,1,13,0,26,36,1
4264,155648,RDFpcJ9K2LX0Y5xHquXqcoe5PIHy9Vd3,A3fsA9Zfv1X2fVEQhTw51lKENdNrEqT3,46,56,22,68,18,12,11,3,190,27.142857142857142,1,0.0,3,22,65,18,53,12,3,11,3,108,82,1
4265,155665,8958pt2z4OHwTl32JK0k9CAPziEN4Bzu,A3fsA9Zfv1X2fVEQhTw51lKENdNrEqT3,17,16,10,0,5,1,6,0,38,5.428571428571429,3,0.0,0,10,0,5,16,1,0,6,0,15,23,1
4266,155671,3s8l6Oo3c1fXiiE9X1tB8PxtDiwQqFs1,SpATywNh6bZuzm8s1ceuBUnMUAeoAHHw,12,10,0,36,0,0,1,0,47,6.714285714285714,1,0.0,5,0,31,0,5,0,5,1,0,36,11,1
4267,155683,8958pt2z4OHwTl32JK0k9CAPziEN4Bzu,bWdj2GDclj5ofokWjzoa5jAwMkxCykd6,19,32,14,20,4,22,27,3,122,17.428571428571427,3,0.0,3,14,14,4,29,22,6,27,3,35,87,1
4268,155689,f7tZxTkA0B7yOxMWeydGO2hW0y86mAhD,SpATywNh6bZuzm8s1ceuBUnMUAeoAHHw,1,0,0,0,0,0,1,0,1,0.14285714285714285,1,0.0,0,0,0,0,0,0,0,1,0,0,1,1
4269,155693,f7tZxTkA0B7yOxMWeydGO2hW0y86mAhD,G8EPVSXsOYB5YQWZGiz1aVq5Pgr2GrQu,1,0,0,0,0,0,1,0,1,0.14285714285714285,1,0.0,0,0,0,0,0,0,0,1,0,0,1,1
4270,155695,PFQeRq3Dsbcn80aUj0YZWAW88oFDtPF9,SpATywNh6bZuzm8s1ceuBUnMUAeoAHHw,2,0,0,0,0,0,2,0,2,0.2857142857142857,1,0.0,0,0,0,0,0,0,0,2,0,0,2,1
4271,155704,CFhLEVkKrtcBJJ6gRh8HSuSfw1jMfUb7,bWdj2GDclj5ofokWjzoa5jAwMkxCykd6,2,0,0,0,0,0,2,0,2,0.2857142857142857,1,0.0,0,0,0,0,0,0,0,2,0,0,2,1
4272,155706,vxDKJhpoE0ZU5RIXhXpWK5bdxd3obhJ3,SpATywNh6bZuzm8s1ceuBUnMUAeoAHHw,1,0,0,0,0,0,1,0,1,0.14285714285714285,1,0.0,0,0,0,0,0,0,0,1,0,0,1,1
4273,155758,t5V0ixfffVZaZSFsWXyfGfVsjL4VioUW,A3fsA9Zfv1X2fVEQhTw51lKENdNrEqT3,2,0,0,0,0,0,2,0,2,0.2857142857142857,1,0.0,0,0,0,0,0,0,0,2,0,0,2,1
4274,155802,rdXoyX5PzGEa2IlOBAhmWFuNeQw6DxzT,SpATywNh6bZuzm8s1ceuBUnMUAeoAHHw,1,0,0,0,0,0,3,0,3,0.42857142857142855,1,0.0,0,0,0,0,0,0,0,3,0,0,3,1
4275,155808,rdXoyX5PzGEa2IlOBAhmWFuNeQw6DxzT,A3fsA9Zfv1X2fVEQhTw51lKENdNrEqT3,1,0,0,0,0,0,1,0,1,0.14285714285714285,1,0.0,0,0,0,0,0,0,0,1,0,0,1,1
4276,155810,IzKetdEf2SXOpqRxnB5y7Dzf3jbTkLdh,SpATywNh6bZuzm8s1ceuBUnMUAeoAHHw,2,0,0,0,0,1,1,0,2,0.2857142857142857,1,0.0,0,0,0,0,0,1,0,1,0,0,2,1
4277,155814,JlBcK2LKfnCBQn41BaZyu4VHnRO1Fg7Y,SpATywNh6bZuzm8s1ceuBUnMUAeoAHHw,8,9,2,14,0,0,4,0,29,4.142857142857143,1,0.0,6,2,13,0,3,0,1,4,0,21,8,0
4278,155840,ONg1SelorbsBSSFMlaPS8zkHzOEuFXME,RXDvfPUBYFlVdlueBFbLW0mhhAyGEqpt,10,13,1,0,1,0,6,0,21,3.0,1,0.0,0,1,0,1,13,0,0,6,0,2,19,1
4279,155852,2hFUtWkuc2dxIm3EniXMbBFapm5m6LBh,RXDvfPUBYFlVdlueBFbLW0mhhAyGEqpt,13,8,7,0,3,0,2,0,20,2.857142857142857,1,0.0,0,7,0,3,8,0,0,2,0,10,10,1
4280,155869,A5TywkowEbOHLvVVnqjs9APzsGZaYsjO,SpATywNh6bZuzm8s1ceuBUnMUAeoAHHw,7,3,2,0,2,0,2,0,9,1.2857142857142858,1,0.0,0,2,0,2,3,0,0,2,0,4,5,1
4281,155880,N9KQH02KbukvyuWvom0gbDomFEZReA7X,SpATywNh6bZuzm8s1ceuBUnMUAeoAHHw,13,10,2,0,2,0,6,1,21,3.0,1,0.0,0,2,0,2,10,0,0,6,1,4,17,1
4282,155893,4G4cusC28dHeOh2Typ91i1q3Okbvvqth,SpATywNh6bZuzm8s1ceuBUnMUAeoAHHw,18,27,14,24,7,0,5,0,77,11.0,2,0.0,6,14,20,7,21,0,4,5,0,47,30,0
4283,155904,mbBmZOvWFQnr2jr80Xest0JLKlAyyOuX,A3fsA9Zfv1X2fVEQhTw51lKENdNrEqT3,22,14,13,0,12,0,7,1,47,6.714285714285714,1,0.0,0,13,0,12,14,0,0,7,1,25,22,1
4284,155908,kui6N1aCNXaCsOCuisWh9NWzU01ICH8U,A3fsA9Zfv1X2fVEQhTw51lKENdNrEqT3,1,0,0,0,0,0,1,0,1,0.14285714285714285,1,0.0,0,0,0,0,0,0,0,1,0,0,1,1
4285,155948,4fYqS5i8zH5iFL9FCzQ9Jw4wAZdnrAvU,A3fsA9Zfv1X2fVEQhTw51lKENdNrEqT3,7,4,3,0,3,0,2,0,12,1.7142857142857142,1,0.0,0,3,0,3,4,0,0,2,0,6,6,1
4286,155949,27kP6FdDHuUVxPZHHeymFgogwQfiPjhl,RXDvfPUBYFlVdlueBFbLW0mhhAyGEqpt,10,9,6,0,3,9,4,0,31,4.428571428571429,2,0.0,0,6,0,3,9,9,0,4,0,9,22,1
4287,155984,CCCbrBYe8XRHX4ZhfNEK7mAQPHEjIWLc,A3fsA9Zfv1X2fVEQhTw51lKENdNrEqT3,10,6,3,0,2,1,7,0,19,2.7142857142857144,1,0.0,0,3,0,2,6,1,0,7,0,5,14,1
4288,155994,xSvCHzbSKemMKYEdGEAC5YZv1OdVf9nN,A3fsA9Zfv1X2fVEQhTw51lKENdNrEqT3,1,0,0,0,0,0,1,0,1,0.14285714285714285,1,0.0,0,0,0,0,0,0,0,1,0,0,1,1
4289,156005,AEtcQOknCsZXTvFkJ2Dw6PQ26CmvNLPh,SpATywNh6bZuzm8s1ceuBUnMUAeoAHHw,1,0,0,0,0,0,1,0,1,0.14285714285714285,1,0.0,0,0,0,0,0,0,0,1,0,0,1,1
4290,156021,PTBT7vCebvS4BFc8gXeo7jxunCeWBjOU,SpATywNh6bZuzm8s1ceuBUnMUAeoAHHw,2,0,0,0,0,0,2,0,2,0.2857142857142857,1,0.0,0,0,0,0,0,0,0,2,0,0,2,1
4291,156050,LIH6u87VTR1542727Uc42mhP2iK5GaFP,RXDvfPUBYFlVdlueBFbLW0mhhAyGEqpt,1,0,0,0,0,0,2,0,2,0.2857142857142857,2,0.0,0,0,0,0,0,0,0,2,0,0,2,1
4292,156071,gSloYsDed4N39YdVhV4tNTApSxYbZ2HF,A3fsA9Zfv1X2fVEQhTw51lKENdNrEqT3,1,0,0,0,0,0,1,0,1,0.14285714285714285,1,0.0,0,0,0,0,0,0,0,1,0,0,1,1
4293,156076,kJbPd4KyCeUkny294dkEDUG2lkV9m74w,RXDvfPUBYFlVdlueBFbLW0mhhAyGEqpt,6,3,1,0,0,0,5,0,9,1.2857142857142858,1,0.0,0,1,0,0,3,0,0,5,0,1,8,1
4294,156079,NLfKoJ9aC8i7mKu1ZdgdkE6zG1FgejH0,SpATywNh6bZuzm8s1ceuBUnMUAeoAHHw,4,3,1,0,0,0,2,0,6,0.8571428571428571,1,0.0,0,1,0,0,3,0,0,2,0,1,5,1
4295,156083,65WrAm7LwtsX3nVDTLh1bnXt0L79cL04,bWdj2GDclj5ofokWjzoa5jAwMkxCykd6,9,11,6,0,1,2,7,1,28,4.0,1,0.0,0,6,0,1,11,2,0,7,1,7,21,0
4296,156096,VPJtyjlRgoD1Uh96mtOqMndW9SwTakqy,bWdj2GDclj5ofokWjzoa5jAwMkxCykd6,1,0,0,0,0,0,1,0,1,0.14285714285714285,1,0.0,0,0,0,0,0,0,0,1,0,0,1,0
4297,156099,GxWg4h8gAiKctUf8VxaJMnstU2gEPNkZ,SpATywNh6bZuzm8s1ceuBUnMUAeoAHHw,13,15,6,36,0,0,2,0,59,8.428571428571429,2,0.0,6,6,31,0,9,0,5,2,0,43,16,1
4298,156119,RK4dzyspr24Rnz8TQ13QOCSoSUcsVTY4,SpATywNh6bZuzm8s1ceuBUnMUAeoAHHw,5,4,2,0,0,0,4,0,10,1.4285714285714286,2,0.0,0,2,0,0,4,0,0,4,0,2,8,1
4299,156145,15UKel3wmzTW7LtBYJPrTEQPhHIKX4AO,A3fsA9Zfv1X2fVEQhTw51lKENdNrEqT3,2,0,0,0,0,0,2,0,2,0.2857142857142857,1,0.0,0,0,0,0,0,0,0,2,0,0,2,1
4300,156168,COpqi7PB37yJZ0BYYjHIpqMxiJ4vAe0U,bWdj2GDclj5ofokWjzoa5jAwMkxCykd6,1,0,0,0,0,0,1,0,1,0.14285714285714285,1,0.0,0,0,0,0,0,0,0,1,0,0,1,1
4301,156179,sGlMvtHnoZ3VKCRj86vjviJ0RxBg0FOx,SpATywNh6bZuzm8s1ceuBUnMUAeoAHHw,23,31,0,35,0,11,8,1,86,12.285714285714286,1,0.0,9,0,30,0,22,11,5,8,1,39,47,0
4302,156188,8o3Hi98AoLvhH8lRB2OWB562ZTdBh0M9,A3fsA9Zfv1X2fVEQhTw51lKENdNrEqT3,1,0,0,0,0,0,1,0,1,0.14285714285714285,1,0.0,0,0,0,0,0,0,0,1,0,0,1,1
4303,156211,KDWP2k3afTGhSxEaH7oA3UMXbJchV5C0,SpATywNh6bZuzm8s1ceuBUnMUAeoAHHw,5,3,2,0,1,0,1,0,7,1.0,1,0.0,0,2,0,1,3,0,0,1,0,3,4,0
4304,156223,EgnWqiW3LiA7qLbsztCmkjoYm253Rxt1,SpATywNh6bZuzm8s1ceuBUnMUAeoAHHw,1,0,0,0,0,0,1,0,1,0.14285714285714285,1,0.0,0,0,0,0,0,0,0,1,0,0,1,1
4305,156248,2rcvhx1rR5YxLdJduMzgm4BAqYgFhtji,G8EPVSXsOYB5YQWZGiz1aVq5Pgr2GrQu,6,3,1,0,1,0,2,0,7,1.0,1,0.0,0,1,0,1,3,0,0,2,0,2,5,1
4306,156255,3MlpYZJz2aixs29anq45r6qVwlCBHq0f,G8EPVSXsOYB5YQWZGiz1aVq5Pgr2GrQu,8,3,1,0,1,1,4,0,10,1.4285714285714286,1,0.0,0,1,0,1,3,1,0,4,0,2,8,1
4307,156260,TVPORDuXFZycPf0Vi3wZKRTY1n2f7P3G,A3fsA9Zfv1X2fVEQhTw51lKENdNrEqT3,2,0,0,0,0,0,6,0,6,0.8571428571428571,2,0.0,0,0,0,0,0,0,0,6,0,0,6,1
4308,156335,GMYiFsIWS5fNg7F5TvdvcvWY8TKSFKZz,SpATywNh6bZuzm8s1ceuBUnMUAeoAHHw,2,0,0,0,0,0,3,0,3,0.42857142857142855,1,0.0,0,0,0,0,0,0,0,3,0,0,3,1
4309,156341,4j0oreGLK5cXhR86icYUGacmhPp1TTs2,G8EPVSXsOYB5YQWZGiz1aVq5Pgr2GrQu,7,3,2,0,2,0,3,0,10,1.4285714285714286,1,0.0,0,2,0,2,3,0,0,3,0,4,6,1
4310,156384,eQeAZJfAlQDBFNhBayGkUGtYxXtMJqJ1,A3fsA9Zfv1X2fVEQhTw51lKENdNrEqT3,19,31,17,4,8,1,11,0,72,10.285714285714286,4,0.0,0,17,3,8,31,1,1,11,0,28,44,1
4311,156391,HptaxHcLRNNIglVlBAbROpX7eNhSXE5r,G8EPVSXsOYB5YQWZGiz1aVq5Pgr2GrQu,3,0,0,0,0,0,3,0,3,0.42857142857142855,1,0.0,0,0,0,0,0,0,0,3,0,0,3,1
4312,156411,wVyNNZlShsUBKENfExM0aYsh2zqsJcHZ,SpATywNh6bZuzm8s1ceuBUnMUAeoAHHw,1,0,0,0,0,0,1,0,1,0.14285714285714285,1,0.0,0,0,0,0,0,0,0,1,0,0,1,1
4313,156418,BJqHNXVOuknKXVN8kWe148UD34ryhX5w,A3fsA9Zfv1X2fVEQhTw51lKENdNrEqT3,9,5,3,0,3,0,1,0,12,1.7142857142857142,1,0.0,0,3,0,3,5,0,0,1,0,6,6,1
4314,156442,yLIplHU7bk7trasZvaOCHx4t4qY5x8AA,A3fsA9Zfv1X2fVEQhTw51lKENdNrEqT3,4,0,0,0,0,0,6,0,6,0.8571428571428571,1,0.0,0,0,0,0,0,0,0,6,0,0,6,1
4315,156446,grhneBVDCBhvBD53OXACTDGfdH3pEWQ2,G8EPVSXsOYB5YQWZGiz1aVq5Pgr2GrQu,3,2,0,0,0,0,1,0,3,0.42857142857142855,1,0.0,0,0,0,0,2,0,0,1,0,0,3,1
4316,156452,kiukAy7oxipXUU8Ys4wcsL36Pp7URsoj,RXDvfPUBYFlVdlueBFbLW0mhhAyGEqpt,14,13,2,0,2,0,2,0,19,2.7142857142857144,2,0.0,0,2,0,2,13,0,0,2,0,4,15,0
4317,156454,Uylyq7LmmNSvSWdWZxt9uRF9NmGdfp0A,A3fsA9Zfv1X2fVEQhTw51lKENdNrEqT3,12,13,10,0,7,0,5,0,35,5.0,2,0.0,0,10,0,7,13,0,0,5,0,17,18,1
4318,156455,e2xISjGUnUd5kxkj4EP9L59IdMd1R2EQ,SpATywNh6bZuzm8s1ceuBUnMUAeoAHHw,5,2,1,0,1,0,3,0,7,1.0,1,0.0,0,1,0,1,2,0,0,3,0,2,5,1
4319,156458,Xv79C7MvAlcrBgCLn9VASALUsdTDRY9k,A3fsA9Zfv1X2fVEQhTw51lKENdNrEqT3,1,0,0,0,0,0,1,0,1,0.14285714285714285,1,0.0,0,0,0,0,0,0,0,1,0,0,1,1
4320,156460,Xv79C7MvAlcrBgCLn9VASALUsdTDRY9k,bWdj2GDclj5ofokWjzoa5jAwMkxCykd6,4,3,1,0,0,0,2,0,6,0.8571428571428571,1,0.0,1,1,0,0,2,0,0,2,0,2,4,1
4321,156481,1MYBio9DblM2ma2YQCVmpn2rr8cupAiN,A3fsA9Zfv1X2fVEQhTw51lKENdNrEqT3,1,0,0,0,0,0,1,0,1,0.14285714285714285,1,0.0,0,0,0,0,0,0,0,1,0,0,1,1
4322,156483,1MYBio9DblM2ma2YQCVmpn2rr8cupAiN,G8EPVSXsOYB5YQWZGiz1aVq5Pgr2GrQu,1,0,0,0,0,0,1,0,1,0.14285714285714285,1,0.0,0,0,0,0,0,0,0,1,0,0,1,1
4323,156484,QCbtKC2wY9sgozuVQgVgy7Djz4UhLkqZ,SpATywNh6bZuzm8s1ceuBUnMUAeoAHHw,5,2,1,0,1,0,2,0,6,0.8571428571428571,1,0.0,0,1,0,1,2,0,0,2,0,2,4,1
4324,156522,pOXPjpm9uh7g9vxK8UCO5j9l2hW4sztB,G8EPVSXsOYB5YQWZGiz1aVq5Pgr2GrQu,5,1,1,0,1,0,4,0,7,1.0,1,0.0,0,1,0,1,1,0,0,4,0,2,5,1
4325,156559,Un3EzEE4Sz8i5Z84q9e50URbIAEkkVSB,bWdj2GDclj5ofokWjzoa5jAwMkxCykd6,10,4,2,0,2,0,9,1,18,2.5714285714285716,3,0.0,0,2,0,2,4,0,0,9,1,4,14,1
4326,156565,MTBFJm3bIEaE6OQdIPJiDEIIoJhDDIeA,SpATywNh6bZuzm8s1ceuBUnMUAeoAHHw,8,2,2,0,2,0,3,0,9,1.2857142857142858,1,0.0,0,2,0,2,2,0,0,3,0,4,5,1
4327,156571,OLSxCkluLildKVrVnzRIsj47tt9tVHj9,RXDvfPUBYFlVdlueBFbLW0mhhAyGEqpt,5,2,1,0,1,0,3,0,7,1.0,1,0.0,0,1,0,1,2,0,0,3,0,2,5,1
4328,156582,Vdk84P68xIHXBGrWqw3oEozZYT063dLv,SpATywNh6bZuzm8s1ceuBUnMUAeoAHHw,5,2,1,0,1,0,2,0,6,0.8571428571428571,1,0.0,0,1,0,1,2,0,0,2,0,2,4,0
4329,156591,j7YtZasgspNNzi8PoR1n8xBZYl8hPf0G,bWdj2GDclj5ofokWjzoa5jAwMkxCykd6,1,0,0,0,0,0,2,0,2,0.2857142857142857,1,0.0,0,0,0,0,0,0,0,2,0,0,2,1
4330,156611,zCl6F2bpK7NJ4O3NtU8qe3DgIKVmj35C,SpATywNh6bZuzm8s1ceuBUnMUAeoAHHw,5,2,1,0,1,0,2,0,6,0.8571428571428571,1,0.0,0,1,0,1,2,0,0,2,0,2,4,1
4331,156627,yoNF71FjmlchDw8CrVsPoTImtdirrSh8,SpATywNh6bZuzm8s1ceuBUnMUAeoAHHw,12,11,1,7,1,0,1,0,21,3.0,1,0.0,2,1,6,1,9,0,1,1,0,10,11,1
4332,156691,YSuxkE1Xqan24aiv5kdAAXS5OHLY0Aml,A3fsA9Zfv1X2fVEQhTw51lKENdNrEqT3,16,12,9,18,5,1,5,0,50,7.142857142857143,2,0.0,1,9,15,5,11,1,3,5,0,30,20,0
4333,156708,qzgqMBszLUnJd9ZV8Zyg9x0an59yJyuH,A3fsA9Zfv1X2fVEQhTw51lKENdNrEqT3,25,25,17,40,3,4,10,1,100,14.285714285714286,2,0.0,4,17,32,3,21,4,8,10,1,56,44,1
4334,156714,gLb9HBNsGES4iiLngE7LJlzcsHLIiWPc,bWdj2GDclj5ofokWjzoa5jAwMkxCykd6,6,5,0,0,1,0,2,0,8,1.1428571428571428,1,0.0,0,0,0,1,5,0,0,2,0,1,7,1
4335,156721,CUbueK74RGsaWBcRtztdoMN84Z7TxEjm,A3fsA9Zfv1X2fVEQhTw51lKENdNrEqT3,1,0,0,0,0,0,1,0,1,0.14285714285714285,1,0.0,0,0,0,0,0,0,0,1,0,0,1,0
4336,156738,OektSQ9TNN3cEy3ZKuUs35c7BdSOqtaQ,A3fsA9Zfv1X2fVEQhTw51lKENdNrEqT3,6,4,2,0,1,0,4,0,11,1.5714285714285714,2,0.0,0,2,0,1,4,0,0,4,0,3,8,1
4337,156741,uafClU57KYzpGT2uPAu1Hr0wJXO4izc7,bWdj2GDclj5ofokWjzoa5jAwMkxCykd6,2,0,0,0,0,0,3,0,3,0.42857142857142855,1,0.0,0,0,0,0,0,0,0,3,0,0,3,1
4338,156745,QtwtavP81h42E4zJzMznn2bf4MZADbs3,A3fsA9Zfv1X2fVEQhTw51lKENdNrEqT3,4,1,0,0,0,0,4,0,5,0.7142857142857143,1,0.0,0,0,0,0,1,0,0,4,0,0,5,1
4339,156757,MOcMwRKo0dtFqZ5xWBgRzquuZGKtQyf4,bWdj2GDclj5ofokWjzoa5jAwMkxCykd6,3,2,1,0,0,0,1,0,4,0.5714285714285714,1,0.0,0,1,0,0,2,0,0,1,0,1,3,1
4340,156758,Bt5rX9oXtFoN3UVn5z9aey4iI5wtlrvh,A3fsA9Zfv1X2fVEQhTw51lKENdNrEqT3,41,18,10,80,6,0,5,0,119,17.0,2,0.0,5,10,71,6,13,0,9,5,0,92,27,0
4341,156771,509hMngiUm6zrKoE3SecqGuN8tx0I6r6,SpATywNh6bZuzm8s1ceuBUnMUAeoAHHw,4,5,0,0,0,0,0,0,5,0.7142857142857143,1,0.0,0,0,0,0,5,0,0,0,0,0,5,1
4342,156772,509hMngiUm6zrKoE3SecqGuN8tx0I6r6,A3fsA9Zfv1X2fVEQhTw51lKENdNrEqT3,3,3,0,0,0,0,0,0,3,0.42857142857142855,1,0.0,0,0,0,0,3,0,0,0,0,0,3,1
4343,156782,5vvAIYSZAT26IXVwYTJynoQoKJk6ajG9,SpATywNh6bZuzm8s1ceuBUnMUAeoAHHw,7,3,2,0,2,0,3,0,10,1.4285714285714286,1,0.0,0,2,0,2,3,0,0,3,0,4,6,1
4344,156784,foHHzg8y8kVV0aOnqOspjjxNSKCSJYQ9,SpATywNh6bZuzm8s1ceuBUnMUAeoAHHw,9,7,5,0,3,0,3,0,18,2.5714285714285716,2,0.0,0,5,0,3,7,0,0,3,0,8,10,1
4345,156811,nqSXUXXEr4UIgbMex1vOrc4sZti4WIMg,bWdj2GDclj5ofokWjzoa5jAwMkxCykd6,4,4,2,0,0,0,2,0,8,1.1428571428571428,1,0.0,1,2,0,0,3,0,0,2,0,3,5,1
4346,156816,3yoGJn4wINiLioKDt9oLKFssOQfyQK8Z,SpATywNh6bZuzm8s1ceuBUnMUAeoAHHw,18,22,1,28,0,5,6,1,63,9.0,1,0.0,5,1,25,0,17,5,3,6,1,31,32,1
4347,157175,ZzYVZYoFRu6qmqfcBrYTS7mqaBTKsIny,7GRhBDsirIGkRZBtSMEzNTyDr2JQm4xx,1,0,0,0,0,0,1,0,1,0.14285714285714285,1,0.0,0,0,0,0,0,0,0,1,0,0,1,1
4348,157186,z6ogSWESGLxUuhgsxETNGPj2TtNqAMAt,7GRhBDsirIGkRZBtSMEzNTyDr2JQm4xx,2,0,0,0,0,0,2,0,2,0.2857142857142857,1,0.0,0,0,0,0,0,0,0,2,0,0,2,1
4349,157192,caQBTqoYm97O8lwsyp08CNg4MqbUA2Eo,7GRhBDsirIGkRZBtSMEzNTyDr2JQm4xx,7,6,3,0,1,0,5,0,15,2.142857142857143,1,0.0,0,3,0,1,6,0,0,5,0,4,11,1
4350,157193,i7vqGsozRewVYx6giRpm4P211SLUVjxQ,7GRhBDsirIGkRZBtSMEzNTyDr2JQm4xx,1,0,0,0,0,0,1,0,1,0.14285714285714285,1,0.0,0,0,0,0,0,0,0,1,0,0,1,1
4351,157196,YrBOxIkMDTPHtQeP4ha6MwTNuOzQva6q,7GRhBDsirIGkRZBtSMEzNTyDr2JQm4xx,2,0,0,0,0,0,8,0,8,1.1428571428571428,1,0.0,0,0,0,0,0,0,0,8,0,0,8,1
4352,157197,LpTOzhB0melA572OJERO4db65eD7w0cu,7GRhBDsirIGkRZBtSMEzNTyDr2JQm4xx,6,4,2,0,0,1,4,0,11,1.5714285714285714,1,0.0,1,2,0,0,3,1,0,4,0,3,8,1
4353,157201,0XtimRygN8aPS4UsgNYsDLh7g7VQkUin,7GRhBDsirIGkRZBtSMEzNTyDr2JQm4xx,2,0,0,0,0,0,3,0,3,0.42857142857142855,1,0.0,0,0,0,0,0,0,0,3,0,0,3,1
4354,157205,c3IQaJpJUkPE2qecKNSJwAyLl2PKb8yr,7GRhBDsirIGkRZBtSMEzNTyDr2JQm4xx,2,0,0,0,0,0,4,0,4,0.5714285714285714,1,0.0,0,0,0,0,0,0,0,4,0,0,4,1
4355,157207,1q7fbJprMr3n3JslWMG8Y37W51nC2LZB,7GRhBDsirIGkRZBtSMEzNTyDr2JQm4xx,5,3,1,0,1,1,4,0,10,1.4285714285714286,1,0.0,0,1,0,1,3,1,0,4,0,2,8,1
4356,157208,u1kEY9BTucDdRevAFNS3TzvwB9cnTuyG,7GRhBDsirIGkRZBtSMEzNTyDr2JQm4xx,2,0,0,0,0,0,2,0,2,0.2857142857142857,1,0.0,0,0,0,0,0,0,0,2,0,0,2,1
4357,157244,hrE2wqQITNDujGOu31qZ9nVLSRudlDFi,7GRhBDsirIGkRZBtSMEzNTyDr2JQm4xx,47,76,23,30,28,16,7,0,180,25.714285714285715,4,0.0,21,23,18,28,55,16,12,7,0,90,90,0
4358,157269,ZW10p50itaf2NuSU5aKpQEE3l8rBuIkc,7GRhBDsirIGkRZBtSMEzNTyDr2JQm4xx,1,0,0,0,0,0,1,0,1,0.14285714285714285,1,0.0,0,0,0,0,0,0,0,1,0,0,1,0
4359,157276,rw1CeO1TCa8fgCdp1zXNf3dRKMz7g6nk,7GRhBDsirIGkRZBtSMEzNTyDr2JQm4xx,2,0,0,0,0,0,2,0,2,0.2857142857142857,1,0.0,0,0,0,0,0,0,0,2,0,0,2,1
4360,157293,0Rc9QmalpGXvwxh2iIaT1Kf7aHCEMOJW,7GRhBDsirIGkRZBtSMEzNTyDr2JQm4xx,4,3,1,0,1,0,1,0,6,0.8571428571428571,1,0.0,0,1,0,1,3,0,0,1,0,2,4,1
4361,157295,RkMMgfrDoCy0k6xciXBqfQqum2o9XEow,7GRhBDsirIGkRZBtSMEzNTyDr2JQm4xx,5,2,0,0,0,0,4,0,6,0.8571428571428571,1,0.0,0,0,0,0,2,0,0,4,0,0,6,1
4362,157300,0a6HihupPBi4xpjolN637qOYG6WSN1Gx,7GRhBDsirIGkRZBtSMEzNTyDr2JQm4xx,10,9,5,0,5,0,4,0,23,3.2857142857142856,1,0.0,2,5,0,5,7,0,0,4,0,12,11,1
4363,157312,9FHojamNYxBNrQ6PYQ6fNVNJw4Al6wFf,7GRhBDsirIGkRZBtSMEzNTyDr2JQm4xx,5,3,1,0,0,0,2,0,6,0.8571428571428571,1,0.0,0,1,0,0,3,0,0,2,0,1,5,1
4364,157338,cOx2ivO0cjd2S3OxGikx2UdSMlRcgy0Q,7GRhBDsirIGkRZBtSMEzNTyDr2JQm4xx,1,0,0,0,0,0,2,0,2,0.2857142857142857,1,0.0,0,0,0,0,0,0,0,2,0,0,2,1
4365,157363,lBHUi5hQhqG9vQMxFTu02cmFxiJKc01u,7GRhBDsirIGkRZBtSMEzNTyDr2JQm4xx,2,0,0,0,0,0,2,0,2,0.2857142857142857,1,0.0,0,0,0,0,0,0,0,2,0,0,2,1
4366,157493,oBNu1yheXNm4QzvTpRG6uVhpeMCjpi7n,7GRhBDsirIGkRZBtSMEzNTyDr2JQm4xx,4,3,2,0,0,0,1,0,6,0.8571428571428571,1,0.0,0,2,0,0,3,0,0,1,0,2,4,1
4367,157525,1cJ3IiBP3iso6zCDFOfl79OCcoYhGWhv,7GRhBDsirIGkRZBtSMEzNTyDr2JQm4xx,1,0,0,0,0,0,1,0,1,0.14285714285714285,1,0.0,0,0,0,0,0,0,0,1,0,0,1,1
4368,157538,Qzxs3prleGy5HanVMqS0iFlTNJtBW0w6,7GRhBDsirIGkRZBtSMEzNTyDr2JQm4xx,1,0,0,0,0,0,1,0,1,0.14285714285714285,1,0.0,0,0,0,0,0,0,0,1,0,0,1,1
4369,157552,HkZ9cpNX2CkQYteixnJNqLUCAlpOg3MZ,7GRhBDsirIGkRZBtSMEzNTyDr2JQm4xx,1,0,0,0,0,0,1,0,1,0.14285714285714285,1,0.0,0,0,0,0,0,0,0,1,0,0,1,1
4370,157566,k3v7Eyu7Dh3B7oRJvMZeSglihGPbIbyB,7GRhBDsirIGkRZBtSMEzNTyDr2JQm4xx,2,0,0,0,0,0,2,0,2,0.2857142857142857,1,0.0,0,0,0,0,0,0,0,2,0,0,2,1
4371,157576,V1tEn8Shi0xM6f4Xd1g5Spwc7qOHvOqG,7GRhBDsirIGkRZBtSMEzNTyDr2JQm4xx,5,3,2,0,2,0,4,0,11,1.5714285714285714,2,0.0,0,2,0,2,3,0,0,4,0,4,7,1
4372,157622,mUDgTVmygSuewvWeFS0TPPpUtE7wznA7,7GRhBDsirIGkRZBtSMEzNTyDr2JQm4xx,13,27,14,0,1,1,2,0,45,6.428571428571429,1,0.0,7,14,0,1,20,1,0,2,0,22,23,1
4373,160311,0dBn4alo7QBTd62VD5XO0yNMbQ5QN2OQ,7GRhBDsirIGkRZBtSMEzNTyDr2JQm4xx,7,7,5,0,0,0,4,0,16,2.2857142857142856,1,0.0,0,5,0,0,7,0,0,4,0,5,11,1
4374,160315,bwArOOJKwGOF13mHU5aKU9fUr71McJvH,7GRhBDsirIGkRZBtSMEzNTyDr2JQm4xx,5,2,1,0,1,0,2,0,6,0.8571428571428571,1,0.0,0,1,0,1,2,0,0,2,0,2,4,1
4375,160320,DJenb7iikHj085JzrOjjcdsjyfa241f7,7GRhBDsirIGkRZBtSMEzNTyDr2JQm4xx,24,21,14,0,12,0,2,0,49,7.0,3,0.0,5,14,0,12,16,0,0,2,0,31,18,1
4376,160384,k0UdEkfpJlSzidBudzci9vFF4yrsXxgQ,7GRhBDsirIGkRZBtSMEzNTyDr2JQm4xx,1,0,0,0,0,0,1,0,1,0.14285714285714285,1,0.0,0,0,0,0,0,0,0,1,0,0,1,0
4377,160389,4TYIBYUjGx5Az0xYJI94tEHK7klSyatr,7GRhBDsirIGkRZBtSMEzNTyDr2JQm4xx,40,50,16,28,23,0,3,0,120,17.142857142857142,1,0.0,31,16,19,23,19,0,9,3,0,89,31,1
4378,160396,zO6yqNtTJB4M08etRFNDLB7i6krzXD0l,7GRhBDsirIGkRZBtSMEzNTyDr2JQm4xx,3,0,0,0,0,0,5,0,5,0.7142857142857143,1,0.0,0,0,0,0,0,0,0,5,0,0,5,1
4379,160401,rPClLoAvWie6mQgFe052QTDjrbW05Z38,7GRhBDsirIGkRZBtSMEzNTyDr2JQm4xx,9,9,6,0,4,7,4,0,30,4.285714285714286,1,0.0,1,6,0,4,8,7,0,4,0,11,19,1
4380,160411,5D8TCJus8jJePlvJzQ7Sr3SBFEIyS2MR,7GRhBDsirIGkRZBtSMEzNTyDr2JQm4xx,2,0,0,0,0,0,2,0,2,0.2857142857142857,1,0.0,0,0,0,0,0,0,0,2,0,0,2,1
4381,160432,uPwo7A29gDp2eZiRxT2ZvOEZhimArTNp,7GRhBDsirIGkRZBtSMEzNTyDr2JQm4xx,2,0,0,0,0,0,2,0,2,0.2857142857142857,1,0.0,0,0,0,0,0,0,0,2,0,0,2,1
4382,160442,YkNwKcv9lSDkBPqsMb0WziNidETs7ep9,7GRhBDsirIGkRZBtSMEzNTyDr2JQm4xx,2,0,0,0,0,0,2,0,2,0.2857142857142857,1,0.0,0,0,0,0,0,0,0,2,0,0,2,1
4383,160444,KBuOxjKuU610PCeSJDQZDprlbjuZT4li,7GRhBDsirIGkRZBtSMEzNTyDr2JQm4xx,21,36,14,8,11,0,3,0,72,10.285714285714286,1,0.0,19,14,4,11,17,0,4,3,0,48,24,1
4384,160471,PBSAJnWnXGHZ7IVhIZxN6aQTQb0G2vO7,7GRhBDsirIGkRZBtSMEzNTyDr2JQm4xx,1,0,0,0,0,0,1,0,1,0.14285714285714285,1,0.0,0,0,0,0,0,0,0,1,0,0,1,1
4385,160476,hD4u7K20MkeesFqmBh9Esq7QUUZdGCv9,7GRhBDsirIGkRZBtSMEzNTyDr2JQm4xx,3,0,0,0,0,0,3,0,3,0.42857142857142855,1,0.0,0,0,0,0,0,0,0,3,0,0,3,1
4386,160480,oYErMzphr0xt2i2tKTG42QELMDaumLkL,7GRhBDsirIGkRZBtSMEzNTyDr2JQm4xx,6,7,3,0,1,0,2,0,13,1.8571428571428572,1,0.0,1,3,0,1,6,0,0,2,0,5,8,1
4387,160486,GGB9bCfhLsvvSPzNJWyTOJucbjEzgrET,7GRhBDsirIGkRZBtSMEzNTyDr2JQm4xx,1,0,0,0,0,0,1,0,1,0.14285714285714285,1,0.0,0,0,0,0,0,0,0,1,0,0,1,1
4388,160500,KOlXIysOb8VF04tCZjd1kg0II2kb2mYu,7GRhBDsirIGkRZBtSMEzNTyDr2JQm4xx,1,0,0,0,0,0,1,0,1,0.14285714285714285,1,0.0,0,0,0,0,0,0,0,1,0,0,1,1
4389,160506,VJsbRtMXxy8aqyccEZDzV7pPAGBosBu1,7GRhBDsirIGkRZBtSMEzNTyDr2JQm4xx,1,0,0,0,0,0,1,0,1,0.14285714285714285,1,0.0,0,0,0,0,0,0,0,1,0,0,1,1
4390,160508,RoGFusJTdgK8k3Zd6iMFweLZIxW5k7pS,7GRhBDsirIGkRZBtSMEzNTyDr2JQm4xx,6,6,4,0,1,0,4,0,15,2.142857142857143,1,0.0,0,4,0,1,6,0,0,4,0,5,10,1
4391,160518,PRY10k18YynTwKp6d8DErN4q5S6hJbG0,7GRhBDsirIGkRZBtSMEzNTyDr2JQm4xx,3,2,0,0,0,0,1,0,3,0.42857142857142855,1,0.0,0,0,0,0,2,0,0,1,0,0,3,1
4392,160528,56J91Yo5ifJy5MJXjIh6Ft8DpaRkdQsg,7GRhBDsirIGkRZBtSMEzNTyDr2JQm4xx,1,0,0,0,0,0,1,0,1,0.14285714285714285,1,0.0,0,0,0,0,0,0,0,1,0,0,1,1
4393,160533,93Zm4nrRg1wL0XUZJzZZ7TfOboLDGoxJ,7GRhBDsirIGkRZBtSMEzNTyDr2JQm4xx,5,0,0,0,0,0,4,2,6,0.8571428571428571,1,0.0,0,0,0,0,0,0,0,4,2,0,6,1
4394,160536,jV3IFI6hAwcYex0pw7Nq9u1gcioXGewT,7GRhBDsirIGkRZBtSMEzNTyDr2JQm4xx,1,0,0,0,0,0,1,0,1,0.14285714285714285,1,0.0,0,0,0,0,0,0,0,1,0,0,1,1
4395,160762,JqVdWoQHyNqeUwMTtrPuJeUxrm3Ef7QH,SpATywNh6bZuzm8s1ceuBUnMUAeoAHHw,17,21,5,19,2,0,4,0,51,7.285714285714286,2,0.0,11,5,18,2,10,0,1,4,0,36,15,1
4396,160775,ZgNdO7hyoQRmg00lVh0JR0YxTL2sBLXr,SpATywNh6bZuzm8s1ceuBUnMUAeoAHHw,11,6,2,0,2,0,5,0,15,2.142857142857143,1,0.0,0,2,0,2,6,0,0,5,0,4,11,0
4397,160932,OAT2DaBS2qqaVHQUCn9wipcvqj5Upvl2,A3fsA9Zfv1X2fVEQhTw51lKENdNrEqT3,1,0,0,0,0,0,1,0,1,0.14285714285714285,1,0.0,0,0,0,0,0,0,0,1,0,0,1,1
4398,161027,CetRT5zy2dJHyaPU2zMnW0reXnT8Dv2y,bWdj2GDclj5ofokWjzoa5jAwMkxCykd6,2,0,0,0,0,0,4,0,4,0.5714285714285714,1,0.0,0,0,0,0,0,0,0,4,0,0,4,0
4399,161079,JDFQZtkjaBhYZM0MLFNIDJC3MmDM3j4N,SpATywNh6bZuzm8s1ceuBUnMUAeoAHHw,1,0,0,0,0,0,1,0,1,0.14285714285714285,1,0.0,0,0,0,0,0,0,0,1,0,0,1,0
4400,161286,ZfEmNtZnnnOMQU2ZxafVmay1LudDsU5A,A3fsA9Zfv1X2fVEQhTw51lKENdNrEqT3,5,2,1,0,1,0,2,0,6,0.8571428571428571,1,0.0,0,1,0,1,2,0,0,2,0,2,4,1
4401,161354,8mGbGwW0kqMWmEPWmvTNX7d3rQGPeEB8,SpATywNh6bZuzm8s1ceuBUnMUAeoAHHw,2,0,0,0,0,0,2,0,2,0.2857142857142857,1,0.0,0,0,0,0,0,0,0,2,0,0,2,0
4402,161386,adfbW7xBPY784GRXAIq3fInFogIbD6ro,SpATywNh6bZuzm8s1ceuBUnMUAeoAHHw,13,24,11,13,0,0,5,0,53,7.571428571428571,3,0.0,4,11,12,0,20,0,1,5,0,27,26,0
4403,161432,7Y5C8uyNuEClb8hOu715XyJadaHTCp61,SpATywNh6bZuzm8s1ceuBUnMUAeoAHHw,4,2,1,0,1,0,1,0,5,0.7142857142857143,1,0.0,0,1,0,1,2,0,0,1,0,2,3,1
4404,162648,Nc3ZZeizgzMQ7ljgRcfUdDiH0EOAXMpI,fbPkOYLVPtPgIt0MxizjfFJov3JbHyAi,10,14,9,2,5,0,5,0,35,5.0,3,0.0,1,9,2,5,13,0,0,5,0,17,18,1
4405,162661,KZBxo2oXfcrXYFa3c9hEkQ12gjuvG6yO,fbPkOYLVPtPgIt0MxizjfFJov3JbHyAi,8,10,4,0,1,0,3,0,18,2.5714285714285716,1,0.0,1,4,0,1,9,0,0,3,0,6,12,1
4406,162690,4fAtuZyf3pqLNg4NAgnHL2LTveUsNAHR,fbPkOYLVPtPgIt0MxizjfFJov3JbHyAi,8,11,0,0,0,0,2,0,13,1.8571428571428572,1,0.0,1,0,0,0,10,0,0,2,0,1,12,1
4407,162698,Qkc0CJeX5rSUk4cMC7WmTWxFf636HopV,fbPkOYLVPtPgIt0MxizjfFJov3JbHyAi,2,0,1,0,1,0,0,0,2,0.2857142857142857,1,0.0,0,1,0,1,0,0,0,0,0,2,0,1
4408,163119,roYkXgGyx3GWrvCQLlmWjFgv8fXNpbMZ,7GRhBDsirIGkRZBtSMEzNTyDr2JQm4xx,15,13,4,74,2,0,2,0,95,13.571428571428571,1,0.0,6,4,66,2,7,0,8,2,0,78,17,1
4409,163123,Fyuejl2dlbgFcYdGhx8H5nzT5OEI84Gi,7GRhBDsirIGkRZBtSMEzNTyDr2JQm4xx,14,23,0,12,1,6,1,0,43,6.142857142857143,1,0.0,14,0,6,1,9,6,6,1,0,21,22,1
4410,163143,0Hsb4jmfnz1a6io2949XgCNHeNRXVX7s,7GRhBDsirIGkRZBtSMEzNTyDr2JQm4xx,2,0,0,0,0,0,2,0,2,0.2857142857142857,1,0.0,0,0,0,0,0,0,0,2,0,0,2,1
4411,163169,tZMtcgGsCq7JvLpFL4lhYMv0agvGaZe2,7GRhBDsirIGkRZBtSMEzNTyDr2JQm4xx,5,4,0,0,0,0,1,0,5,0.7142857142857143,1,0.0,0,0,0,0,4,0,0,1,0,0,5,1
4412,163179,s6B1c6HsYtYgFfNQaANtHBiEvk3BxrNI,7GRhBDsirIGkRZBtSMEzNTyDr2JQm4xx,4,1,0,0,0,5,4,0,10,1.4285714285714286,1,0.0,0,0,0,0,1,5,0,4,0,0,10,1
4413,163201,3Mkd8wUIycmVOp3bXkQhrkLLJQvE7obi,7GRhBDsirIGkRZBtSMEzNTyDr2JQm4xx,1,0,0,0,0,0,2,0,2,0.2857142857142857,1,0.0,0,0,0,0,0,0,0,2,0,0,2,1
4414,163212,qPinNnuwG11dRyXbHR9eoc8JbfTOf2YH,7GRhBDsirIGkRZBtSMEzNTyDr2JQm4xx,1,0,0,0,0,0,1,0,1,0.14285714285714285,1,0.0,0,0,0,0,0,0,0,1,0,0,1,1
4415,163220,8Cr8Vd1mU7TZdVM3CmCM42IjN2PAOQUN,7GRhBDsirIGkRZBtSMEzNTyDr2JQm4xx,32,42,14,24,11,0,2,0,93,13.285714285714286,1,0.0,22,14,13,11,20,0,11,2,0,60,33,0
4416,163260,xWEkYGAfNptAwZnPYzVBCVMgcZk3qKaB,7GRhBDsirIGkRZBtSMEzNTyDr2JQm4xx,7,21,1,2,0,0,2,0,26,3.7142857142857144,1,0.0,5,1,1,0,16,0,1,2,0,7,19,1
4417,163270,qnvX4ck8f7yWnykYmnmSide0xnZ2M9gG,7GRhBDsirIGkRZBtSMEzNTyDr2JQm4xx,7,5,2,0,3,0,4,1,15,2.142857142857143,1,0.0,2,2,0,3,3,0,0,4,1,7,8,1
4418,163297,QjCKOuadW7uvxwklu6VUWdeXSYG5ZySL,7GRhBDsirIGkRZBtSMEzNTyDr2JQm4xx,5,2,1,0,1,0,2,0,6,0.8571428571428571,1,0.0,0,1,0,1,2,0,0,2,0,2,4,1
4419,163306,Wd5Y51TL4njlLeYHUjz5D9nrsHvDXUZ8,7GRhBDsirIGkRZBtSMEzNTyDr2JQm4xx,1,0,0,0,0,0,1,0,1,0.14285714285714285,1,0.0,0,0,0,0,0,0,0,1,0,0,1,1
4420,163542,CSh5hGbaSFu2yCb31iVMOVwKocrH471Q,G8EPVSXsOYB5YQWZGiz1aVq5Pgr2GrQu,2,0,0,0,0,0,2,0,2,0.2857142857142857,1,0.0,0,0,0,0,0,0,0,2,0,0,2,1
4421,163577,Uy2krOPQuopj6gsLDrvSnNpCmzlDZ3lx,G8EPVSXsOYB5YQWZGiz1aVq5Pgr2GrQu,13,14,0,18,0,0,2,0,34,4.857142857142857,1,0.0,9,0,11,0,5,0,7,2,0,20,14,1
4422,163631,F3LkPjPg6vCRHLtL3FvDerZrs5n7emOU,SpATywNh6bZuzm8s1ceuBUnMUAeoAHHw,4,1,1,0,1,0,1,0,4,0.5714285714285714,1,0.0,0,1,0,1,1,0,0,1,0,2,2,1
4423,163684,ewJfXKCM3UIjcsxxypCAlFJ00OIwALVK,SpATywNh6bZuzm8s1ceuBUnMUAeoAHHw,6,9,7,0,2,0,4,0,22,3.142857142857143,1,0.0,0,7,0,2,9,0,0,4,0,9,13,1
4424,163726,GEJT2aBPUnilxjCoBwgHhTPS1ahoPkLE,RXDvfPUBYFlVdlueBFbLW0mhhAyGEqpt,7,3,3,0,3,0,0,0,9,1.2857142857142858,1,0.0,0,3,0,3,3,0,0,0,0,6,3,1
4425,163886,Bos3zEEnAcYzPXQktMkJJ0ak5mhGWCAf,bWdj2GDclj5ofokWjzoa5jAwMkxCykd6,3,2,1,0,0,0,1,0,4,0.5714285714285714,1,0.0,0,1,0,0,2,0,0,1,0,1,3,0
4426,163934,5NIrDL6VpBxdJ6CyWDkvlKDqSlFChzvA,SpATywNh6bZuzm8s1ceuBUnMUAeoAHHw,5,4,3,0,0,0,1,0,8,1.1428571428571428,1,0.0,0,3,0,0,4,0,0,1,0,3,5,0
4427,163982,cikSh880jtc26b154AaVhDiV1L6H6F3g,SpATywNh6bZuzm8s1ceuBUnMUAeoAHHw,18,19,12,16,7,0,7,0,61,8.714285714285714,2,0.0,4,12,15,7,15,0,1,7,0,38,23,0
4428,164032,zQ5BnttGrAYjfbNnxAVeHGUEjC3wWZZU,SpATywNh6bZuzm8s1ceuBUnMUAeoAHHw,15,15,8,0,7,0,3,0,33,4.714285714285714,1,0.0,1,8,0,7,14,0,0,3,0,16,17,0
4429,164128,3iB62eqNt3nRiXslxHuT1UtvhrRX1eLs,SpATywNh6bZuzm8s1ceuBUnMUAeoAHHw,1,0,0,0,0,0,1,0,1,0.14285714285714285,1,0.0,0,0,0,0,0,0,0,1,0,0,1,0
4430,164167,g8GaCwXJUf6SPnVxk3h41vOpn1g2rMNj,SpATywNh6bZuzm8s1ceuBUnMUAeoAHHw,8,9,4,0,2,0,3,0,18,2.5714285714285716,1,0.0,0,4,0,2,9,0,0,3,0,6,12,1
4431,164199,Fk4hjEUqgyLHxBlk1cbfR9hWyVsJsJLo,bWdj2GDclj5ofokWjzoa5jAwMkxCykd6,5,5,3,0,0,0,1,0,9,1.2857142857142858,1,0.0,0,3,0,0,5,0,0,1,0,3,6,1
4432,164474,WLXtV9xU02TWrBcV5JQ79YomKzdOBWBA,bWdj2GDclj5ofokWjzoa5jAwMkxCykd6,3,2,1,0,0,0,1,0,4,0.5714285714285714,1,0.0,0,1,0,0,2,0,0,1,0,1,3,1
4433,164537,9poFqdhDn1jEwJp6tGIQlD3gMA14zAqO,RXDvfPUBYFlVdlueBFbLW0mhhAyGEqpt,6,9,0,0,0,0,3,0,12,1.7142857142857142,1,0.0,1,0,0,0,8,0,0,3,0,1,11,1
4434,164652,pOBmP02v5rRyUAaKAfr6us8i87HHPyHg,G8EPVSXsOYB5YQWZGiz1aVq5Pgr2GrQu,6,2,1,0,1,0,2,0,6,0.8571428571428571,1,0.0,0,1,0,1,2,0,0,2,0,2,4,1
4435,164769,w14rTBVaKAEl5wo1WnNS26mWscctUzrO,SpATywNh6bZuzm8s1ceuBUnMUAeoAHHw,7,3,3,0,3,0,0,0,9,1.2857142857142858,1,0.0,0,3,0,3,3,0,0,0,0,6,3,1
4436,164819,td1qPqbY65yQMbPFzvqLZhtQGNGi89Aa,SpATywNh6bZuzm8s1ceuBUnMUAeoAHHw,8,9,2,6,1,0,4,0,22,3.142857142857143,1,0.0,5,2,5,1,4,0,1,4,0,13,9,1
4437,164941,j0ueLtQ2R4YY5IElzCXogrNJYFltC4bt,G8EPVSXsOYB5YQWZGiz1aVq5Pgr2GrQu,11,11,1,0,3,0,1,0,16,2.2857142857142856,1,0.0,2,1,0,3,9,0,0,1,0,6,10,1
4438,164949,QJffKxs9lkFscQquMcfEw8hYo0ArYTkN,SpATywNh6bZuzm8s1ceuBUnMUAeoAHHw,5,4,0,0,0,0,1,0,5,0.7142857142857143,1,0.0,0,0,0,0,4,0,0,1,0,0,5,1
4439,164967,Jk09qA6alwSJzVuIqHppbDvZyk5u7ZHA,SpATywNh6bZuzm8s1ceuBUnMUAeoAHHw,1,0,0,0,0,0,1,0,1,0.14285714285714285,1,0.0,0,0,0,0,0,0,0,1,0,0,1,1
4440,165056,AOCx0foyQMeiMTgZQ1N4fT75yVQcQ0J9,A3fsA9Zfv1X2fVEQhTw51lKENdNrEqT3,12,15,7,0,3,0,1,0,26,3.7142857142857144,1,0.0,0,7,0,3,15,0,0,1,0,10,16,0
4441,165066,jaOmqqWd0RurZsiyeEDBNOhHZZXgisPQ,G8EPVSXsOYB5YQWZGiz1aVq5Pgr2GrQu,120,97,46,294,14,10,16,1,478,68.28571428571429,1,0.0,42,46,235,14,55,10,59,16,1,337,141,1
4442,165074,ij6lhOw7nYbJY8ZynpI4C6NhJmjCSNsH,bWdj2GDclj5ofokWjzoa5jAwMkxCykd6,10,7,5,0,3,0,2,0,17,2.4285714285714284,1,0.0,0,5,0,3,7,0,0,2,0,8,9,1
4443,165102,8IsnQQnfLzKrobCqyqui1F07ZqYQDg46,G8EPVSXsOYB5YQWZGiz1aVq5Pgr2GrQu,23,39,1,50,3,0,10,2,105,15.0,1,0.0,17,1,37,3,22,0,13,10,2,58,47,1
4444,165194,Qn3OccgDXQpcut9yLA9jXfau6FPbS72n,bWdj2GDclj5ofokWjzoa5jAwMkxCykd6,1,0,0,0,0,0,2,0,2,0.2857142857142857,1,0.0,0,0,0,0,0,0,0,2,0,0,2,1
4445,165254,SHOQyzWMzeXzTVojp4arGhfbJLLjl3Lx,A3fsA9Zfv1X2fVEQhTw51lKENdNrEqT3,12,12,6,0,4,0,3,0,25,3.5714285714285716,1,0.0,0,6,0,4,12,0,0,3,0,10,15,1
4446,165275,nIaUSG86MljehwfWdoHPVChPOF3VCDSs,SpATywNh6bZuzm8s1ceuBUnMUAeoAHHw,7,2,0,0,0,1,6,1,10,1.4285714285714286,2,0.0,0,0,0,0,2,1,0,6,1,0,10,1
4447,165340,oaoj9be4jW2Hot8wYgYrzLRvB0RU4KYy,SpATywNh6bZuzm8s1ceuBUnMUAeoAHHw,12,8,3,14,0,0,4,0,29,4.142857142857143,1,0.0,4,3,14,0,4,0,0,4,0,21,8,1
4448,165342,oaoj9be4jW2Hot8wYgYrzLRvB0RU4KYy,A3fsA9Zfv1X2fVEQhTw51lKENdNrEqT3,3,2,1,0,0,0,2,0,5,0.7142857142857143,1,0.0,0,1,0,0,2,0,0,2,0,1,4,0
4449,165376,yR0NraAWygNs5cts7Fvc0zvbt2sGOVtI,SpATywNh6bZuzm8s1ceuBUnMUAeoAHHw,16,10,9,0,7,0,3,0,29,4.142857142857143,1,0.0,0,9,0,7,10,0,0,3,0,16,13,1
4450,165489,WXsAy1py6xNoAtmIQsPWN4rhdvzggrq1,RXDvfPUBYFlVdlueBFbLW0mhhAyGEqpt,8,9,2,0,2,0,2,0,15,2.142857142857143,2,0.0,0,2,0,2,9,0,0,2,0,4,11,1
4451,165596,QqNuARzccJUP5HNszzjljOhC9t53eZLk,A3fsA9Zfv1X2fVEQhTw51lKENdNrEqT3,7,5,4,0,3,0,1,0,13,1.8571428571428572,1,0.0,0,4,0,3,5,0,0,1,0,7,6,1
4452,165681,zZk0zQJxr08CnTp44rAPtrScPbsUq7U7,SpATywNh6bZuzm8s1ceuBUnMUAeoAHHw,3,2,1,0,0,0,3,0,6,0.8571428571428571,1,0.0,0,1,0,0,2,0,0,3,0,1,5,0
4453,165703,9gwK2SMO9RzFmbR3NVs20xNig2HGOi8l,SpATywNh6bZuzm8s1ceuBUnMUAeoAHHw,11,17,5,18,2,0,1,0,43,6.142857142857143,1,0.0,10,5,14,2,7,0,4,1,0,31,12,1
4454,165760,zfQZFTiqHKQUgpAItjpYn7ZjkbIcP825,G8EPVSXsOYB5YQWZGiz1aVq5Pgr2GrQu,10,4,3,4,1,0,6,0,18,2.5714285714285716,1,0.0,0,3,3,1,4,0,1,6,0,7,11,1
4455,165762,6WkOKMKB5P2APoB7vbWWLXwAR3emifoG,A3fsA9Zfv1X2fVEQhTw51lKENdNrEqT3,41,24,16,68,10,0,4,0,122,17.428571428571427,1,0.0,5,16,58,10,19,0,10,4,0,89,33,1
4456,165799,tWEnJYIhXMJ03Foo959mubaAJUHZPTw0,RXDvfPUBYFlVdlueBFbLW0mhhAyGEqpt,1,0,0,0,0,0,1,0,1,0.14285714285714285,1,0.0,0,0,0,0,0,0,0,1,0,0,1,1
4457,165925,rPvLSBoy5Xxf5EmxbjvWGnOcsq8vXrWM,fbPkOYLVPtPgIt0MxizjfFJov3JbHyAi,7,2,1,0,1,0,4,1,9,1.2857142857142858,1,0.0,0,1,0,1,2,0,0,4,1,2,7,1
4458,165926,904Wr172N0WscSeMXJsTOyh1uuS7vDSG,fbPkOYLVPtPgIt0MxizjfFJov3JbHyAi,18,29,1,22,3,20,26,3,104,14.857142857142858,2,0.0,10,1,15,3,19,20,7,26,3,29,75,1
4459,165927,I527mLJhEnsnDN6Y7GHh8lgX5gYIWWow,fbPkOYLVPtPgIt0MxizjfFJov3JbHyAi,5,2,1,0,1,0,2,0,6,0.8571428571428571,1,0.0,0,1,0,1,2,0,0,2,0,2,4,1
4460,165928,KxL8nW6SNMH0yE9CjF6IkKPffZ4Ij1gU,fbPkOYLVPtPgIt0MxizjfFJov3JbHyAi,1,0,0,0,0,0,1,0,1,0.14285714285714285,1,0.0,0,0,0,0,0,0,0,1,0,0,1,1
4461,165930,W3Xzt3Uf7lx9itZ3S5DNN9hHwJZa9KRt,fbPkOYLVPtPgIt0MxizjfFJov3JbHyAi,7,3,2,0,2,0,3,0,10,1.4285714285714286,1,0.0,0,2,0,2,3,0,0,3,0,4,6,1
4462,165931,gS1462mjlX01iqp5mKCqQb48nCyM3t3B,fbPkOYLVPtPgIt0MxizjfFJov3JbHyAi,2,0,0,0,0,0,4,0,4,0.5714285714285714,1,0.0,0,0,0,0,0,0,0,4,0,0,4,1
4463,165934,b7To0QTiTYgZuoVzyuSEPS7F21SjVad4,fbPkOYLVPtPgIt0MxizjfFJov3JbHyAi,1,0,0,0,0,0,1,0,1,0.14285714285714285,1,0.0,0,0,0,0,0,0,0,1,0,0,1,1
4464,165939,ZNl8B1FHwYbYTfFDFqmJVkUQSDcZskKg,fbPkOYLVPtPgIt0MxizjfFJov3JbHyAi,9,9,6,0,3,0,6,0,24,3.4285714285714284,1,0.0,0,6,0,3,9,0,0,6,0,9,15,1
4465,165942,XGHgNQW6UqpJ7yEgcu0NHkLF9rVPokqB,fbPkOYLVPtPgIt0MxizjfFJov3JbHyAi,5,2,1,0,1,0,2,0,6,0.8571428571428571,1,0.0,0,1,0,1,2,0,0,2,0,2,4,1
4466,165943,a3LnV0Oo3dtcjCRZGppIsWuGj51V5eh2,fbPkOYLVPtPgIt0MxizjfFJov3JbHyAi,1,0,0,0,0,0,1,0,1,0.14285714285714285,1,0.0,0,0,0,0,0,0,0,1,0,0,1,1
4467,165944,6sTapLZsQ6AY8DHIM1OkTraivy1QDm3b,fbPkOYLVPtPgIt0MxizjfFJov3JbHyAi,11,7,6,0,6,0,2,0,21,3.0,1,0.0,0,6,0,6,7,0,0,2,0,12,9,1
4468,165947,PUhxV7BpYunwLMY1Fopzcxx9OAbpHDbj,fbPkOYLVPtPgIt0MxizjfFJov3JbHyAi,5,2,1,0,1,0,3,0,7,1.0,1,0.0,0,1,0,1,2,0,0,3,0,2,5,1
4469,165949,8WeCoc3LtA2zjcaZdCNg8zvUfjT2Msxf,fbPkOYLVPtPgIt0MxizjfFJov3JbHyAi,1,0,0,0,0,0,1,0,1,0.14285714285714285,1,0.0,0,0,0,0,0,0,0,1,0,0,1,1
4470,165951,P1bfM85NxrtE5GDV4Jjq3FQWhmzLv4fy,fbPkOYLVPtPgIt0MxizjfFJov3JbHyAi,1,0,0,0,0,0,1,0,1,0.14285714285714285,1,0.0,0,0,0,0,0,0,0,1,0,0,1,1
4471,165954,uFdzPnm0JPIeUpj3xMTZBNmEB1ozRTVJ,fbPkOYLVPtPgIt0MxizjfFJov3JbHyAi,5,2,1,0,1,0,2,0,6,0.8571428571428571,1,0.0,0,1,0,1,2,0,0,2,0,2,4,1
4472,165955,FDszCioKrM3p5Ww8Z6KhIumuxTlgQRlZ,fbPkOYLVPtPgIt0MxizjfFJov3JbHyAi,11,17,10,0,7,4,10,1,49,7.0,1,0.0,3,10,0,7,14,4,0,10,1,20,29,1
4473,165956,S1v43tmmk9czADWjyf7UYULOIOI7xfyL,fbPkOYLVPtPgIt0MxizjfFJov3JbHyAi,8,5,3,0,2,0,12,0,22,3.142857142857143,2,0.0,0,3,0,2,5,0,0,12,0,5,17,1
4474,165957,p45WUPIH3G1AOOJwU2wuCfHKdtB0xm6o,fbPkOYLVPtPgIt0MxizjfFJov3JbHyAi,8,2,1,0,1,2,5,1,12,1.7142857142857142,1,0.0,0,1,0,1,2,2,0,5,1,2,10,1
4475,165958,8SNKPwETcHAWtjYz28VSsqsWvRN9FLFQ,fbPkOYLVPtPgIt0MxizjfFJov3JbHyAi,1,0,0,0,0,0,1,0,1,0.14285714285714285,1,0.0,0,0,0,0,0,0,0,1,0,0,1,1
4476,165961,u889jcGO7u4YLeZfY23r5rctOxqBf6PA,fbPkOYLVPtPgIt0MxizjfFJov3JbHyAi,1,0,0,0,0,0,1,0,1,0.14285714285714285,1,0.0,0,0,0,0,0,0,0,1,0,0,1,1
4477,165963,HagPPbBJUvEmCdoqrDllEDEMmLNeq2iZ,fbPkOYLVPtPgIt0MxizjfFJov3JbHyAi,9,4,3,0,2,0,5,0,14,2.0,1,0.0,0,3,0,2,4,0,0,5,0,5,9,1
4478,165964,fR1Af80YYdXTiASRMfpJrGeUuotptcVr,fbPkOYLVPtPgIt0MxizjfFJov3JbHyAi,6,4,2,0,1,0,4,0,11,1.5714285714285714,1,0.0,0,2,0,1,4,0,0,4,0,3,8,1
4479,165965,Ni1JLdqzOxkLUpUAAhMXu8rPflxVDz5x,fbPkOYLVPtPgIt0MxizjfFJov3JbHyAi,1,0,0,0,0,0,1,0,1,0.14285714285714285,1,0.0,0,0,0,0,0,0,0,1,0,0,1,1
4480,165967,wDiJr7mYUlLmlRXPgZ91Gun6O95gTskL,fbPkOYLVPtPgIt0MxizjfFJov3JbHyAi,2,0,0,0,0,0,4,0,4,0.5714285714285714,1,0.0,0,0,0,0,0,0,0,4,0,0,4,1
4481,165969,spNi8Q5WiDgxakh0uckmQbexani6DCOh,fbPkOYLVPtPgIt0MxizjfFJov3JbHyAi,2,0,0,0,0,0,2,0,2,0.2857142857142857,1,0.0,0,0,0,0,0,0,0,2,0,0,2,0
4482,165970,iwWfjFQpV0JEdS2sLknknEHjLyTBDPKw,fbPkOYLVPtPgIt0MxizjfFJov3JbHyAi,9,5,2,0,2,1,4,1,15,2.142857142857143,1,0.0,2,2,0,2,3,1,0,4,1,6,9,1
4483,165974,hCvYtvOSJvPXrRc5VlUnEsp4YsplFn8e,fbPkOYLVPtPgIt0MxizjfFJov3JbHyAi,1,0,0,0,0,0,1,0,1,0.14285714285714285,1,0.0,0,0,0,0,0,0,0,1,0,0,1,1
4484,165975,qPpO6ViDO8p9Brl7zj83O8kE30x6kZ9T,fbPkOYLVPtPgIt0MxizjfFJov3JbHyAi,6,3,0,0,0,0,4,2,9,1.2857142857142858,1,0.0,0,0,0,0,3,0,0,4,2,0,9,1
4485,165976,5y3Cd3dGN1d00I5lwTujgeZECpSTe7zr,fbPkOYLVPtPgIt0MxizjfFJov3JbHyAi,1,0,0,0,0,0,1,0,1,0.14285714285714285,1,0.0,0,0,0,0,0,0,0,1,0,0,1,1
4486,165977,37ndc95rjuQyww4myZAV2pRajSa1vaet,fbPkOYLVPtPgIt0MxizjfFJov3JbHyAi,6,5,1,0,1,0,2,0,9,1.2857142857142858,1,0.0,0,1,0,1,5,0,0,2,0,2,7,1
4487,165978,0seZo711Nu6ZHdbNw0yAvl5v1wAAFkoU,fbPkOYLVPtPgIt0MxizjfFJov3JbHyAi,7,7,1,0,1,1,2,0,12,1.7142857142857142,1,0.0,0,1,0,1,7,1,0,2,0,2,10,1
4488,165979,1uzmYtVGAWS7t6COUTYsC7mZnu6avern,fbPkOYLVPtPgIt0MxizjfFJov3JbHyAi,5,2,1,0,1,0,2,0,6,0.8571428571428571,1,0.0,0,1,0,1,2,0,0,2,0,2,4,1
4489,165982,8EUQcb1E8DABiNIX80rEHPv9Sif56saE,fbPkOYLVPtPgIt0MxizjfFJov3JbHyAi,1,0,0,0,0,0,1,0,1,0.14285714285714285,1,0.0,0,0,0,0,0,0,0,1,0,0,1,1
4490,165983,h0jqPvJTofkhvn5R8iQDcsLGVojVRAC5,fbPkOYLVPtPgIt0MxizjfFJov3JbHyAi,8,4,3,0,3,0,1,0,11,1.5714285714285714,1,0.0,0,3,0,3,4,0,0,1,0,6,5,1
4491,165986,vUR2Rb4rC27WC9JMCKdgkNsSu9OE2g4Q,fbPkOYLVPtPgIt0MxizjfFJov3JbHyAi,8,6,4,0,3,0,3,0,16,2.2857142857142856,1,0.0,0,4,0,3,6,0,0,3,0,7,9,1
4492,165987,Z9EzO8SxShTXDAFqt77CSsGSze2gBnhK,fbPkOYLVPtPgIt0MxizjfFJov3JbHyAi,5,2,0,0,1,0,2,0,5,0.7142857142857143,1,0.0,0,0,0,1,2,0,0,2,0,1,4,1
4493,165990,ALLdRiupr5XE7F2FwbjCFY7Qd3WjBiQd,fbPkOYLVPtPgIt0MxizjfFJov3JbHyAi,10,3,2,0,2,1,6,2,16,2.2857142857142856,1,0.0,0,2,0,2,3,1,0,6,2,4,12,1
4494,165991,kr4lZ3nLoz0aX6j9TExEEntiFfGYyCjd,fbPkOYLVPtPgIt0MxizjfFJov3JbHyAi,1,0,0,0,0,0,1,0,1,0.14285714285714285,1,0.0,0,0,0,0,0,0,0,1,0,0,1,1
4495,165997,EGFrdPbQlZ45sFe1ldxnO4L7OBI2JHpu,fbPkOYLVPtPgIt0MxizjfFJov3JbHyAi,1,0,0,0,0,0,1,0,1,0.14285714285714285,1,0.0,0,0,0,0,0,0,0,1,0,0,1,1
4496,165998,F9bdhIa6mSzXfjRuqNv5xPUxLFQQSQPN,fbPkOYLVPtPgIt0MxizjfFJov3JbHyAi,1,0,0,0,0,0,1,0,1,0.14285714285714285,1,0.0,0,0,0,0,0,0,0,1,0,0,1,1
4497,165999,hvRHXkr5ZlhMWU7A6w9HeJGvJ6CsaNfS,fbPkOYLVPtPgIt0MxizjfFJov3JbHyAi,5,5,2,0,2,0,2,0,11,1.5714285714285714,1,0.0,0,2,0,2,5,0,0,2,0,4,7,1
4498,166002,caJeHwBfKoz4X9ir6E77hAcZOUW1xE69,fbPkOYLVPtPgIt0MxizjfFJov3JbHyAi,11,7,4,0,2,3,9,1,26,3.7142857142857144,1,0.0,1,4,0,2,6,3,0,9,1,7,19,1
4499,166003,sUgRMzV2VHvt6HuQejcpp5Z8McRxUZjg,fbPkOYLVPtPgIt0MxizjfFJov3JbHyAi,1,0,0,0,0,0,1,0,1,0.14285714285714285,1,0.0,0,0,0,0,0,0,0,1,0,0,1,1
4500,166005,PGGGHjUA1ku4qHrXObJrJMvRvyQ4ONL0,fbPkOYLVPtPgIt0MxizjfFJov3JbHyAi,5,2,0,0,0,0,5,0,7,1.0,2,0.0,0,0,0,0,2,0,0,5,0,0,7,1
4501,166006,Nc7kINeTdCLSL76oJ5133gWG2CsY0W54,fbPkOYLVPtPgIt0MxizjfFJov3JbHyAi,2,0,0,0,0,0,3,0,3,0.42857142857142855,2,0.0,0,0,0,0,0,0,0,3,0,0,3,1
4502,166009,mXNyb3sDzfYTKd0Jgpoq0ZfQhY7qZUdq,fbPkOYLVPtPgIt0MxizjfFJov3JbHyAi,6,3,2,0,1,0,2,0,8,1.1428571428571428,1,0.0,0,2,0,1,3,0,0,2,0,3,5,1
4503,166012,e312Bg0txOy7uWpjDbFsC3TLW38EvbT4,fbPkOYLVPtPgIt0MxizjfFJov3JbHyAi,7,2,1,0,1,1,6,1,12,1.7142857142857142,1,0.0,0,1,0,1,2,1,0,6,1,2,10,1
4504,166013,FIkFMKcyvR9UWi0Myle8WGVGpGy1qcBD,fbPkOYLVPtPgIt0MxizjfFJov3JbHyAi,5,2,1,0,1,0,2,0,6,0.8571428571428571,1,0.0,0,1,0,1,2,0,0,2,0,2,4,1
4505,166014,g3902agYIRHzac78MKVZlvljLMXXNpQ7,fbPkOYLVPtPgIt0MxizjfFJov3JbHyAi,1,0,0,0,0,0,1,0,1,0.14285714285714285,1,0.0,0,0,0,0,0,0,0,1,0,0,1,1
4506,166015,FcnD0Ciq8TWyjGNFUvJIbmP6wTYBGqdt,fbPkOYLVPtPgIt0MxizjfFJov3JbHyAi,2,0,0,0,0,0,5,0,5,0.7142857142857143,1,0.0,0,0,0,0,0,0,0,5,0,0,5,1
4507,166018,uAiXtjZln558M2i3rYEEm2XkgYlhSfMT,fbPkOYLVPtPgIt0MxizjfFJov3JbHyAi,5,2,1,0,1,0,2,0,6,0.8571428571428571,1,0.0,0,1,0,1,2,0,0,2,0,2,4,1
4508,166019,OdutB2jwjn089D8EX2NAa3HnsFlikWQS,fbPkOYLVPtPgIt0MxizjfFJov3JbHyAi,6,3,2,0,2,0,1,0,8,1.1428571428571428,1,0.0,0,2,0,2,3,0,0,1,0,4,4,1
4509,166098,FGCLu23qz5rUrelYuCtqPnMTqZtXAAMw,fbPkOYLVPtPgIt0MxizjfFJov3JbHyAi,1,0,0,0,0,0,2,0,2,0.2857142857142857,2,0.0,0,0,0,0,0,0,0,2,0,0,2,1
4510,166131,3qQdqfR3bXaxIIbbDNHql7PNKozwWJ0T,fbPkOYLVPtPgIt0MxizjfFJov3JbHyAi,7,5,2,0,2,0,2,0,11,1.5714285714285714,1,0.0,0,2,0,2,5,0,0,2,0,4,7,1
4511,166132,QH6lZrx6rTkTliuU8RlNmWQ26j8fabUH,fbPkOYLVPtPgIt0MxizjfFJov3JbHyAi,5,2,1,0,1,0,2,0,6,0.8571428571428571,1,0.0,0,1,0,1,2,0,0,2,0,2,4,1
4512,166133,IzageoSKsdXfc6SUEzsqUc9gQrqXXlhN,fbPkOYLVPtPgIt0MxizjfFJov3JbHyAi,18,34,16,25,15,6,10,2,108,15.428571428571429,1,0.0,13,16,21,15,21,6,4,10,2,65,43,1
4513,166134,M9r7XEg2B3D5ZR9GVCwEti8ZRWwHOp49,fbPkOYLVPtPgIt0MxizjfFJov3JbHyAi,1,0,0,0,0,0,1,0,1,0.14285714285714285,1,0.0,0,0,0,0,0,0,0,1,0,0,1,1
4514,166135,rH5NF332Zl0fvCKU7fDfkywLMxP5O2d8,fbPkOYLVPtPgIt0MxizjfFJov3JbHyAi,31,44,20,17,16,5,9,1,112,16.0,2,0.0,21,20,14,16,23,5,3,9,1,71,41,1
4515,166138,Rdvgrardg53H2oeCgmOt8vFxIUu5nogb,fbPkOYLVPtPgIt0MxizjfFJov3JbHyAi,11,10,5,4,4,0,2,0,25,3.5714285714285716,1,0.0,2,5,3,4,8,0,1,2,0,14,11,1
4516,166139,D8yJX6fJMCIpExk8o6FLH29T9XoXppFE,fbPkOYLVPtPgIt0MxizjfFJov3JbHyAi,3,0,0,0,0,0,3,0,3,0.42857142857142855,1,0.0,0,0,0,0,0,0,0,3,0,0,3,1
4517,166140,uM0mO72xR8FGxE8Qbk3uLYE3hJhpQzfR,fbPkOYLVPtPgIt0MxizjfFJov3JbHyAi,12,8,4,8,4,0,5,0,29,4.142857142857143,1,0.0,2,4,6,4,6,0,2,5,0,16,13,1
4518,166141,5onphScHMomc2vbgBcVESDnXfbNkWfY9,fbPkOYLVPtPgIt0MxizjfFJov3JbHyAi,1,0,0,0,0,0,1,0,1,0.14285714285714285,1,0.0,0,0,0,0,0,0,0,1,0,0,1,1
4519,166142,PsafF2SVukKJJLRMVxFeBBFQRkjLQ2oJ,fbPkOYLVPtPgIt0MxizjfFJov3JbHyAi,1,0,0,0,0,0,2,0,2,0.2857142857142857,1,0.0,0,0,0,0,0,0,0,2,0,0,2,1
4520,166143,Dc0PKVAv0QU3JBz2nVIWZwdXyqJ69QN3,fbPkOYLVPtPgIt0MxizjfFJov3JbHyAi,2,0,0,0,0,0,4,0,4,0.5714285714285714,1,0.0,0,0,0,0,0,0,0,4,0,0,4,1
4521,166144,aNJE1B7Om5LHj59YkXIa7Cp0ZqypQHhy,fbPkOYLVPtPgIt0MxizjfFJov3JbHyAi,1,0,0,0,0,0,1,0,1,0.14285714285714285,1,0.0,0,0,0,0,0,0,0,1,0,0,1,1
4522,166150,jEHens5h7cgKFnZtp09sIGIhAFBD7Jkg,fbPkOYLVPtPgIt0MxizjfFJov3JbHyAi,7,7,0,0,0,0,6,0,13,1.8571428571428572,1,0.0,0,0,0,0,7,0,0,6,0,0,13,1
4523,166151,BfWyYyUZnv5SdLMFrh8TGsAFKZNgKNeG,fbPkOYLVPtPgIt0MxizjfFJov3JbHyAi,8,5,4,0,3,0,5,0,17,2.4285714285714284,1,0.0,0,4,0,3,5,0,0,5,0,7,10,1
4524,166152,FXa0AcfgcW9wGv6x58fnAsUuMIzAEhoi,fbPkOYLVPtPgIt0MxizjfFJov3JbHyAi,9,9,4,0,3,0,4,0,20,2.857142857142857,1,0.0,0,4,0,3,9,0,0,4,0,7,13,1
4525,166159,9k6LwDB3o9YdtwgjHMlgmEiFhRXLRRJ9,fbPkOYLVPtPgIt0MxizjfFJov3JbHyAi,6,2,1,0,1,0,3,0,7,1.0,1,0.0,0,1,0,1,2,0,0,3,0,2,5,1
4526,166161,30rq8lRkOZXWqMCfPyVsaAPbaaM041Av,fbPkOYLVPtPgIt0MxizjfFJov3JbHyAi,11,9,6,0,4,17,9,3,48,6.857142857142857,1,0.0,0,6,0,4,9,17,0,9,3,10,38,1
4527,166162,NJgJq3P8IUUdiKHxAPOJ9vpHV39AmbrT,fbPkOYLVPtPgIt0MxizjfFJov3JbHyAi,10,7,4,0,3,0,8,0,22,3.142857142857143,1,0.0,0,4,0,3,7,0,0,8,0,7,15,1
4528,166165,4G4kKKQKhb6jz9KfkGMaSkBm1b7Ng8Fb,fbPkOYLVPtPgIt0MxizjfFJov3JbHyAi,9,6,4,0,3,1,8,4,26,3.7142857142857144,1,0.0,0,4,0,3,6,1,0,8,4,7,19,1
4529,166166,jUkfka13Wwz7qRRzZH3uNtDuXxBE9Awx,fbPkOYLVPtPgIt0MxizjfFJov3JbHyAi,9,4,2,0,1,1,7,1,16,2.2857142857142856,1,0.0,0,2,0,1,4,1,0,7,1,3,13,1
4530,166167,APZilLYYSE3pgnSCxo2zN4jsnzixmfIm,fbPkOYLVPtPgIt0MxizjfFJov3JbHyAi,8,13,4,0,2,0,4,0,23,3.2857142857142856,2,0.0,0,4,0,2,13,0,0,4,0,6,17,1
4531,166169,XR3klDTIaDghb3t3EKC7lItRK7pmZtK2,fbPkOYLVPtPgIt0MxizjfFJov3JbHyAi,5,2,1,0,1,0,2,0,6,0.8571428571428571,1,0.0,0,1,0,1,2,0,0,2,0,2,4,1
4532,166171,hTJ6uBnBZrjcmQsSdLFl27Z53HcqXPhu,fbPkOYLVPtPgIt0MxizjfFJov3JbHyAi,5,3,2,0,0,0,2,0,7,1.0,1,0.0,0,2,0,0,3,0,0,2,0,2,5,1
4533,166172,7APFlbQcu9slKLT1djMsjN8yfRoP5SXu,fbPkOYLVPtPgIt0MxizjfFJov3JbHyAi,5,2,1,0,1,0,4,0,8,1.1428571428571428,1,0.0,0,1,0,1,2,0,0,4,0,2,6,1
4534,166173,D7q0MzB6OQnySW7fFe0PsdLrln5h0cWD,fbPkOYLVPtPgIt0MxizjfFJov3JbHyAi,2,0,0,0,0,0,4,0,4,0.5714285714285714,1,0.0,0,0,0,0,0,0,0,4,0,0,4,1
4535,166174,PcwkLBV8GqMq4LN5muiU92scrdGQ7V6h,fbPkOYLVPtPgIt0MxizjfFJov3JbHyAi,7,3,1,0,1,3,6,0,14,2.0,1,0.0,0,1,0,1,3,3,0,6,0,2,12,1
4536,166176,4qYb0mwN1QXf1hE7gaSGAEjSfScRbt40,fbPkOYLVPtPgIt0MxizjfFJov3JbHyAi,1,0,0,0,0,0,1,0,1,0.14285714285714285,1,0.0,0,0,0,0,0,0,0,1,0,0,1,1
4537,166178,pE4phvQUtMVk8HRczaNhPWPwQSM1R9mD,fbPkOYLVPtPgIt0MxizjfFJov3JbHyAi,1,0,0,0,0,0,1,0,1,0.14285714285714285,1,0.0,0,0,0,0,0,0,0,1,0,0,1,1
4538,166179,VskbKna85vnBg6NRvImzwmzgF97qcqNl,fbPkOYLVPtPgIt0MxizjfFJov3JbHyAi,1,0,0,0,0,0,1,0,1,0.14285714285714285,1,0.0,0,0,0,0,0,0,0,1,0,0,1,1
4539,166180,gx7Co0YFNqJP8BvMpO5sc6zAa3XLv4OC,fbPkOYLVPtPgIt0MxizjfFJov3JbHyAi,1,0,0,0,0,0,1,0,1,0.14285714285714285,1,0.0,0,0,0,0,0,0,0,1,0,0,1,1
4540,166181,WavpPVbOYUl8MN821vVFxD4UKy4r5Gk2,fbPkOYLVPtPgIt0MxizjfFJov3JbHyAi,9,10,6,0,4,0,5,0,25,3.5714285714285716,1,0.0,2,6,0,4,8,0,0,5,0,12,13,1
4541,166183,pYc3zOC10Ig1Wz1Rc4vkJqpNCY1sRttg,fbPkOYLVPtPgIt0MxizjfFJov3JbHyAi,1,0,0,0,0,0,1,0,1,0.14285714285714285,1,0.0,0,0,0,0,0,0,0,1,0,0,1,1
4542,166184,PCr9TFHQnY1v0mGiWpUIzzoDKl5BgvEm,fbPkOYLVPtPgIt0MxizjfFJov3JbHyAi,7,5,2,0,2,0,2,0,11,1.5714285714285714,1,0.0,0,2,0,2,5,0,0,2,0,4,7,1
4543,166185,0AOM3Xsog3TT6hti2vJTJuPdhrxxQzqx,fbPkOYLVPtPgIt0MxizjfFJov3JbHyAi,1,0,0,0,0,0,1,0,1,0.14285714285714285,1,0.0,0,0,0,0,0,0,0,1,0,0,1,1
4544,166190,m0ftathRLrGnJCnhmZSV8vDms8QzsQ7P,fbPkOYLVPtPgIt0MxizjfFJov3JbHyAi,21,14,8,20,5,0,1,0,48,6.857142857142857,1,0.0,5,8,16,5,9,0,4,1,0,34,14,1
4545,166191,LSYyQey0vUBbPFiPb4RkXPSgn5CNqwVT,fbPkOYLVPtPgIt0MxizjfFJov3JbHyAi,5,2,1,0,1,0,2,0,6,0.8571428571428571,1,0.0,0,1,0,1,2,0,0,2,0,2,4,1
4546,166192,4WOIlm8GAd1KWxkI5IGSFyO5T1vsPvxi,fbPkOYLVPtPgIt0MxizjfFJov3JbHyAi,6,5,1,0,1,0,2,0,9,1.2857142857142858,1,0.0,0,1,0,1,5,0,0,2,0,2,7,1
4547,166193,rTT3Jo5pfzKPV7jQyyGPjKpE7vCtTnIg,fbPkOYLVPtPgIt0MxizjfFJov3JbHyAi,6,3,1,0,1,0,2,0,7,1.0,1,0.0,0,1,0,1,3,0,0,2,0,2,5,1
4548,166195,zswbtSZTlApL8NcRWKlBizb4x3nFlj4t,fbPkOYLVPtPgIt0MxizjfFJov3JbHyAi,1,0,0,0,0,0,1,0,1,0.14285714285714285,1,0.0,0,0,0,0,0,0,0,1,0,0,1,1
4549,166196,ajmRO2ByCJVVIxORXq9TY2juCehadeoK,fbPkOYLVPtPgIt0MxizjfFJov3JbHyAi,1,0,0,0,0,0,1,0,1,0.14285714285714285,1,0.0,0,0,0,0,0,0,0,1,0,0,1,1
4550,166197,7cis0UjQRmYBnfx6HjOswg5edwgBgCpE,fbPkOYLVPtPgIt0MxizjfFJov3JbHyAi,1,0,0,0,0,0,1,0,1,0.14285714285714285,1,0.0,0,0,0,0,0,0,0,1,0,0,1,1
4551,166199,Z2csWIUYxogRjTAASMgDj8yUhj5wsQf6,fbPkOYLVPtPgIt0MxizjfFJov3JbHyAi,1,0,0,0,0,0,1,0,1,0.14285714285714285,1,0.0,0,0,0,0,0,0,0,1,0,0,1,1
4552,166200,oFHquhoEL97QZy2GgeAYH2i1t5qjNxiI,fbPkOYLVPtPgIt0MxizjfFJov3JbHyAi,1,0,0,0,0,0,1,0,1,0.14285714285714285,1,0.0,0,0,0,0,0,0,0,1,0,0,1,1
4553,166201,WdyV9xz939F7AYWm4x7LDb09zLG7KCGo,fbPkOYLVPtPgIt0MxizjfFJov3JbHyAi,5,0,0,0,0,1,4,0,5,0.7142857142857143,1,0.0,0,0,0,0,0,1,0,4,0,0,5,1
4554,166202,iRTkgYZLUCCMjEju8FAVkQmJQ4dxsVf6,fbPkOYLVPtPgIt0MxizjfFJov3JbHyAi,7,3,2,0,2,0,2,0,9,1.2857142857142858,1,0.0,0,2,0,2,3,0,0,2,0,4,5,1
4555,166205,wu2GU267aApPVHAuPTRg0Nigjmr9Z1gM,fbPkOYLVPtPgIt0MxizjfFJov3JbHyAi,5,2,0,0,0,0,3,0,5,0.7142857142857143,1,0.0,0,0,0,0,2,0,0,3,0,0,5,1
4556,166206,jHAeFRHIxhlq1VuAgQnHiSkHKEAGqDQQ,fbPkOYLVPtPgIt0MxizjfFJov3JbHyAi,1,0,0,0,0,0,1,0,1,0.14285714285714285,1,0.0,0,0,0,0,0,0,0,1,0,0,1,1
4557,166208,c5e9iH45YdJ4nzTDABvuqRhlji3DhWTZ,fbPkOYLVPtPgIt0MxizjfFJov3JbHyAi,1,0,0,0,0,0,1,0,1,0.14285714285714285,1,0.0,0,0,0,0,0,0,0,1,0,0,1,1
4558,166209,ZhQM1oVDGLY3PxKguad7zSF6itqVpVMw,fbPkOYLVPtPgIt0MxizjfFJov3JbHyAi,6,0,0,0,0,0,5,1,6,0.8571428571428571,1,0.0,0,0,0,0,0,0,0,5,1,0,6,1
4559,166211,535rqCxCBVvAkDc6bSBePBKNVyS23A04,fbPkOYLVPtPgIt0MxizjfFJov3JbHyAi,3,2,2,0,2,0,0,0,6,0.8571428571428571,1,0.0,0,2,0,2,2,0,0,0,0,4,2,1
4560,166212,fvgTgMEEp9KwLpfVkpXX8oOhoWnoroKM,fbPkOYLVPtPgIt0MxizjfFJov3JbHyAi,4,2,1,0,0,0,2,0,5,0.7142857142857143,1,0.0,0,1,0,0,2,0,0,2,0,1,4,1
4561,166214,yDrPM411aoK4cy4pMUjRFGutYfIXnaY7,fbPkOYLVPtPgIt0MxizjfFJov3JbHyAi,9,4,3,0,3,0,2,0,12,1.7142857142857142,1,0.0,0,3,0,3,4,0,0,2,0,6,6,1
4562,166216,CYPNBoGwuLNGB9o6c5ymOZ8c1CNfYFkE,fbPkOYLVPtPgIt0MxizjfFJov3JbHyAi,5,2,1,0,1,1,4,0,9,1.2857142857142858,1,0.0,0,1,0,1,2,1,0,4,0,2,7,1
4563,166218,KFATKUNqDDFsPoUS8ZrDkYqpQpRP4f4L,fbPkOYLVPtPgIt0MxizjfFJov3JbHyAi,2,0,0,0,0,0,2,0,2,0.2857142857142857,1,0.0,0,0,0,0,0,0,0,2,0,0,2,1
4564,166219,pbVSIAGDAO8zkre7dnH0sTveAs2oHKDL,fbPkOYLVPtPgIt0MxizjfFJov3JbHyAi,5,3,2,0,0,1,2,0,8,1.1428571428571428,1,0.0,0,2,0,0,3,1,0,2,0,2,6,1
4565,166221,FCQ3GzlLjljyV0TB5O3VUpS5tYpT90fC,fbPkOYLVPtPgIt0MxizjfFJov3JbHyAi,1,0,0,0,0,0,1,0,1,0.14285714285714285,1,0.0,0,0,0,0,0,0,0,1,0,0,1,1
4566,166223,zn0OAApVYD2Uy6WJtu6WKbBPSOUAbiQP,fbPkOYLVPtPgIt0MxizjfFJov3JbHyAi,5,2,1,0,1,0,2,0,6,0.8571428571428571,1,0.0,0,1,0,1,2,0,0,2,0,2,4,1
4567,166224,VzrtRKXjnxu3j4Ng8zH1lMIMaH7VXugk,fbPkOYLVPtPgIt0MxizjfFJov3JbHyAi,11,8,5,0,3,9,9,2,36,5.142857142857143,1,0.0,0,5,0,3,8,9,0,9,2,8,28,1
4568,166226,Jc1XpiNQCchHcqFzVFHc90zIRXa0BSrx,fbPkOYLVPtPgIt0MxizjfFJov3JbHyAi,1,0,0,0,0,0,1,0,1,0.14285714285714285,1,0.0,0,0,0,0,0,0,0,1,0,0,1,1
4569,166228,lwLS4JZCmr2Z32OMnVpRrqT2jg66CVWM,fbPkOYLVPtPgIt0MxizjfFJov3JbHyAi,4,2,1,0,0,0,2,0,5,0.7142857142857143,1,0.0,0,1,0,0,2,0,0,2,0,1,4,1
4570,166234,cobl7A5HnM7LyfJMOxE7IO6H5ynMSZHE,fbPkOYLVPtPgIt0MxizjfFJov3JbHyAi,20,21,11,0,9,1,14,1,57,8.142857142857142,2,0.0,6,11,0,9,15,1,0,14,1,26,31,1
4571,166235,bZyPcrH7OrkATlDjIsQifL6bmPAhovyA,fbPkOYLVPtPgIt0MxizjfFJov3JbHyAi,1,0,0,0,0,0,1,0,1,0.14285714285714285,1,0.0,0,0,0,0,0,0,0,1,0,0,1,1
4572,166236,jZTOrC76oKbilWqOTQaLbKbRc8Z13tjL,fbPkOYLVPtPgIt0MxizjfFJov3JbHyAi,2,0,0,0,0,0,4,0,4,0.5714285714285714,1,0.0,0,0,0,0,0,0,0,4,0,0,4,1
4573,166238,K2ZkeKtW7K8uncjR7BZKciYiqiq9yWln,fbPkOYLVPtPgIt0MxizjfFJov3JbHyAi,1,0,0,0,0,0,1,0,1,0.14285714285714285,1,0.0,0,0,0,0,0,0,0,1,0,0,1,1
4574,166240,lGwFkUBS8Ax5ZfSjmM23Vm33yIAwYDi5,fbPkOYLVPtPgIt0MxizjfFJov3JbHyAi,3,0,0,0,0,0,4,0,4,0.5714285714285714,1,0.0,0,0,0,0,0,0,0,4,0,0,4,1
4575,166243,UO4mrSrrMyolBODgCqJnfueJEWhli7II,fbPkOYLVPtPgIt0MxizjfFJov3JbHyAi,1,0,0,0,0,0,2,0,2,0.2857142857142857,1,0.0,0,0,0,0,0,0,0,2,0,0,2,1
4576,166245,2jYgAHtB8HMROduTNzSC8WwjfYYRrdrW,fbPkOYLVPtPgIt0MxizjfFJov3JbHyAi,7,7,2,0,0,1,6,1,17,2.4285714285714284,1,0.0,0,2,0,0,7,1,0,6,1,2,15,1
4577,166246,DjTBWAUbIg70BCHJh9sAtqxHus5ltwy7,fbPkOYLVPtPgIt0MxizjfFJov3JbHyAi,7,2,1,0,1,1,5,0,10,1.4285714285714286,1,0.0,0,1,0,1,2,1,0,5,0,2,8,1
4578,166247,A0zXPJodVr0E8hKOlKGfpSvxe7QILd2e,fbPkOYLVPtPgIt0MxizjfFJov3JbHyAi,8,9,5,0,3,0,6,0,23,3.2857142857142856,1,0.0,0,5,0,3,9,0,0,6,0,8,15,1
4579,166248,RMepYbdXgEw3uPAlKurEbNiPXr5gNPWt,fbPkOYLVPtPgIt0MxizjfFJov3JbHyAi,10,10,4,0,5,0,2,0,21,3.0,1,0.0,2,4,0,5,8,0,0,2,0,11,10,1
4580,166249,4IRetwwONx8QH1sGkNwhu5Kz3lKUue7Z,fbPkOYLVPtPgIt0MxizjfFJov3JbHyAi,13,11,7,0,4,13,6,0,41,5.857142857142857,1,0.0,0,7,0,4,11,13,0,6,0,11,30,1
4581,166250,KlA2x8wP6TBpECd0ZN1eFvozBu7s4Isi,fbPkOYLVPtPgIt0MxizjfFJov3JbHyAi,7,3,2,0,2,0,2,0,9,1.2857142857142858,1,0.0,0,2,0,2,3,0,0,2,0,4,5,1
4582,166252,CA0MkNgNmIkfEXL0dnDRrevPXK8YBuup,fbPkOYLVPtPgIt0MxizjfFJov3JbHyAi,18,35,22,9,12,0,7,0,85,12.142857142857142,1,0.0,10,22,8,12,25,0,1,7,0,52,33,1
4583,166253,7IMXfuLxE8gGKFgkWFaN1RvRbpf1UO2y,fbPkOYLVPtPgIt0MxizjfFJov3JbHyAi,2,0,0,0,0,0,2,0,2,0.2857142857142857,1,0.0,0,0,0,0,0,0,0,2,0,0,2,1
4584,166255,kowHY6WB64zBwKrTN3ILoCz5UNyxhnFJ,fbPkOYLVPtPgIt0MxizjfFJov3JbHyAi,8,3,2,0,2,0,4,0,11,1.5714285714285714,1,0.0,0,2,0,2,3,0,0,4,0,4,7,1
4585,166257,wqiVx47rXEFqYvMIBdEO3TZz5x4INOeH,fbPkOYLVPtPgIt0MxizjfFJov3JbHyAi,1,0,0,0,0,0,2,0,2,0.2857142857142857,1,0.0,0,0,0,0,0,0,0,2,0,0,2,1
4586,166258,UOnQZubkkaxGovWrfoxkBtdZ1OIJQqVB,fbPkOYLVPtPgIt0MxizjfFJov3JbHyAi,10,6,3,0,2,1,5,1,18,2.5714285714285716,1,0.0,1,3,0,2,5,1,0,5,1,6,12,1
4587,166259,MnSTippsWfG9Oaeik7VL8PjJAAryn478,fbPkOYLVPtPgIt0MxizjfFJov3JbHyAi,1,0,0,0,0,0,1,0,1,0.14285714285714285,1,0.0,0,0,0,0,0,0,0,1,0,0,1,1
4588,166260,lgavhxj31ME1Vj5ukLJHRWTlXwDGQoVr,fbPkOYLVPtPgIt0MxizjfFJov3JbHyAi,5,3,1,0,1,0,5,0,10,1.4285714285714286,1,0.0,0,1,0,1,3,0,0,5,0,2,8,1
4589,166261,dVdgfUMBulFX4jVAvRAGPzBu21Uo5ky5,fbPkOYLVPtPgIt0MxizjfFJov3JbHyAi,2,0,0,0,0,0,2,0,2,0.2857142857142857,1,0.0,0,0,0,0,0,0,0,2,0,0,2,1
4590,166262,yKKt8zt4iB4hr1OVUIw42HenRNY3LaDc,fbPkOYLVPtPgIt0MxizjfFJov3JbHyAi,1,0,0,0,0,0,1,0,1,0.14285714285714285,1,0.0,0,0,0,0,0,0,0,1,0,0,1,1
4591,166263,9wJidXC6DsBSt4XJeGmG8tllGZ0Bh2yE,fbPkOYLVPtPgIt0MxizjfFJov3JbHyAi,5,0,0,0,0,1,5,1,7,1.0,1,0.0,0,0,0,0,0,1,0,5,1,0,7,1
4592,166264,h7D7NcJeqnvOSuVnZSj39Mgs0UPnBWOp,fbPkOYLVPtPgIt0MxizjfFJov3JbHyAi,11,19,9,0,6,3,9,1,47,6.714285714285714,1,0.0,2,9,0,6,17,3,0,9,1,17,30,1
4593,166267,2mlxTydWoLZJ5NQWesHHKUelrVUBGoHh,fbPkOYLVPtPgIt0MxizjfFJov3JbHyAi,6,4,2,0,2,0,2,0,10,1.4285714285714286,1,0.0,0,2,0,2,4,0,0,2,0,4,6,1
4594,166282,EUmZ5qzjwgko2PIWEnctkvYh7APnUrX9,SpATywNh6bZuzm8s1ceuBUnMUAeoAHHw,2,0,0,0,0,0,3,0,3,0.42857142857142855,1,0.0,0,0,0,0,0,0,0,3,0,0,3,1
4595,166304,cr6Tgf9hnYbWIgXq8hI7G8mwIYtkpuPn,SpATywNh6bZuzm8s1ceuBUnMUAeoAHHw,4,1,1,0,0,0,2,0,4,0.5714285714285714,2,0.0,0,1,0,0,1,0,0,2,0,1,3,1
4596,166307,C1W6BmVEm6dSkmMKEomLuJgZ8sQ5WGlZ,SpATywNh6bZuzm8s1ceuBUnMUAeoAHHw,10,16,5,0,3,0,2,0,26,3.7142857142857144,2,0.0,4,5,0,3,12,0,0,2,0,12,14,1
4597,166334,O9GgLjRVV0VZ4XM2UvjBFBWJXBSS6aK0,SpATywNh6bZuzm8s1ceuBUnMUAeoAHHw,8,6,5,0,4,0,6,0,21,3.0,2,0.0,0,5,0,4,6,0,0,6,0,9,12,1
4598,166336,dy0MHAcBl717YgRGnv4iZjdkJ8Cv0Ubw,SpATywNh6bZuzm8s1ceuBUnMUAeoAHHw,5,2,1,0,1,0,2,0,6,0.8571428571428571,1,0.0,0,1,0,1,2,0,0,2,0,2,4,1
4599,166338,VGpsDdnTGsfrp3adgxkdRhxpkaNF7Bg2,SpATywNh6bZuzm8s1ceuBUnMUAeoAHHw,8,6,1,0,1,0,1,0,9,1.2857142857142858,1,0.0,0,1,0,1,6,0,0,1,0,2,7,1
4600,166345,eBrNdoyiSxVd9fyLx3AqJC03wGlgXEr8,SpATywNh6bZuzm8s1ceuBUnMUAeoAHHw,2,0,0,0,0,0,2,0,2,0.2857142857142857,1,0.0,0,0,0,0,0,0,0,2,0,0,2,1
4601,166348,LdN96v488mT9MyrF8Dltq2COgz4qXNUV,SpATywNh6bZuzm8s1ceuBUnMUAeoAHHw,2,0,0,0,0,0,3,0,3,0.42857142857142855,1,0.0,0,0,0,0,0,0,0,3,0,0,3,1
4602,166382,aMWucSAl7KcOtmgcqhgckjtfv6QnsKKi,G8EPVSXsOYB5YQWZGiz1aVq5Pgr2GrQu,8,8,1,0,1,0,4,0,14,2.0,1,0.0,1,1,0,1,7,0,0,4,0,3,11,1
4603,166387,WO9GKA0lZwTMWZPNOUikUeUkOH5TeVRT,A3fsA9Zfv1X2fVEQhTw51lKENdNrEqT3,19,10,9,0,9,0,3,0,31,4.428571428571429,1,0.0,0,9,0,9,10,0,0,3,0,18,13,1
4604,166392,FR3djrgj8pkYcAIqYiRiT862Pvu77Ath,A3fsA9Zfv1X2fVEQhTw51lKENdNrEqT3,1,0,0,0,0,0,1,0,1,0.14285714285714285,1,0.0,0,0,0,0,0,0,0,1,0,0,1,1
4605,166398,KSpo19A6th76vdA61eFiN0BiY6Yi086y,bWdj2GDclj5ofokWjzoa5jAwMkxCykd6,6,2,1,0,1,0,4,0,8,1.1428571428571428,1,0.0,0,1,0,1,2,0,0,4,0,2,6,1
4606,166400,aJMNcTer76nTaYZZR58xtdmLr8BYq1Op,G8EPVSXsOYB5YQWZGiz1aVq5Pgr2GrQu,13,17,7,8,4,0,6,1,43,6.142857142857143,2,0.0,3,7,5,4,14,0,3,6,1,19,24,0
4607,166409,iIkBXne7Ob9Fgz6Oa5wXMKZwMdTiJR2o,SpATywNh6bZuzm8s1ceuBUnMUAeoAHHw,5,5,5,0,5,0,0,0,15,2.142857142857143,1,0.0,0,5,0,5,5,0,0,0,0,10,5,1
4608,166414,NkHKP7XmU89AhYrwGvkJ0gX5lfpDGkiJ,G8EPVSXsOYB5YQWZGiz1aVq5Pgr2GrQu,6,1,1,0,1,0,3,0,6,0.8571428571428571,1,0.0,0,1,0,1,1,0,0,3,0,2,4,1
4609,166445,yOLWJeEIp9ncdhH4y673tuFZt1rt1tLc,G8EPVSXsOYB5YQWZGiz1aVq5Pgr2GrQu,25,46,0,32,1,0,4,0,83,11.857142857142858,1,0.0,26,0,16,1,20,0,16,4,0,43,40,1
4610,166469,EpdHS9GR8oqIUKzHvPkVQRgoyyohb0m0,SpATywNh6bZuzm8s1ceuBUnMUAeoAHHw,3,2,1,0,0,0,1,0,4,0.5714285714285714,1,0.0,0,1,0,0,2,0,0,1,0,1,3,1
4611,166473,qMHt2pvEDzVNHM7ZHWzleDlEr3OuwQXq,SpATywNh6bZuzm8s1ceuBUnMUAeoAHHw,17,14,11,2,4,7,7,1,46,6.571428571428571,1,0.0,2,11,2,4,12,7,0,7,1,19,27,1
4612,166486,oGxuj25E6wfFXJnzkTIOBzgSMs7mphqX,SpATywNh6bZuzm8s1ceuBUnMUAeoAHHw,4,7,3,0,0,0,1,0,11,1.5714285714285714,1,0.0,3,3,0,0,4,0,0,1,0,6,5,1
4613,166495,YbJnM4aRUVyy4lj5U7KoiyOh79gNSdfq,A3fsA9Zfv1X2fVEQhTw51lKENdNrEqT3,9,5,4,0,4,0,2,0,15,2.142857142857143,2,0.0,0,4,0,4,5,0,0,2,0,8,7,1
4614,166507,lJQiDaJvMiupKv6v8L85WToj3Rei5ozq,SpATywNh6bZuzm8s1ceuBUnMUAeoAHHw,10,5,4,0,3,1,3,0,16,2.2857142857142856,1,0.0,0,4,0,3,5,1,0,3,0,7,9,1
4615,166508,8yNx2UHmvaqcPAlV7kUX1ya1n3dGGkKQ,SpATywNh6bZuzm8s1ceuBUnMUAeoAHHw,1,0,0,0,0,0,1,0,1,0.14285714285714285,1,0.0,0,0,0,0,0,0,0,1,0,0,1,1
4616,166523,QjfVyTofFZLLFWX1ehKLt5ilQSOSAPiY,G8EPVSXsOYB5YQWZGiz1aVq5Pgr2GrQu,24,19,12,22,9,0,4,1,67,9.571428571428571,1,0.0,0,12,19,9,19,0,3,4,1,40,27,1
4617,166543,5UIbCqH63Z5JY1aEquv4Lx7GZPK1n1Oz,RXDvfPUBYFlVdlueBFbLW0mhhAyGEqpt,1,0,0,0,0,0,1,0,1,0.14285714285714285,1,0.0,0,0,0,0,0,0,0,1,0,0,1,1
4618,166582,L3RDijFpI0BxbfI282CDkn8oc75EdrdD,SpATywNh6bZuzm8s1ceuBUnMUAeoAHHw,1,0,0,0,0,0,1,0,1,0.14285714285714285,1,0.0,0,0,0,0,0,0,0,1,0,0,1,1
4619,166584,EUmZ5qzjwgko2PIWEnctkvYh7APnUrX9,A3fsA9Zfv1X2fVEQhTw51lKENdNrEqT3,12,15,0,0,0,0,3,0,18,2.5714285714285716,1,0.0,0,0,0,0,15,0,0,3,0,0,18,1
4620,166631,XXGnjStFLZ9sx615YBVWt5w8zGA5PvJ7,SpATywNh6bZuzm8s1ceuBUnMUAeoAHHw,9,17,0,0,0,0,4,0,21,3.0,1,0.0,0,0,0,0,17,0,0,4,0,0,21,1
4621,166681,EQyfXomfeQ2aGwvJID8K9GdghyNxd6oh,bWdj2GDclj5ofokWjzoa5jAwMkxCykd6,14,27,12,60,6,1,6,0,112,16.0,2,0.0,6,12,59,6,21,1,1,6,0,83,29,1
4622,166691,Plovj3UdbSJXyESPLaHVaVRAVAVFjh4G,bWdj2GDclj5ofokWjzoa5jAwMkxCykd6,1,0,0,0,0,0,1,0,1,0.14285714285714285,1,0.0,0,0,0,0,0,0,0,1,0,0,1,1
4623,166751,ywzPrbVlDcrG4QIQVcquX0yb7l2KxUz1,SpATywNh6bZuzm8s1ceuBUnMUAeoAHHw,1,0,0,0,0,0,1,0,1,0.14285714285714285,1,0.0,0,0,0,0,0,0,0,1,0,0,1,1
4624,166755,e8Y4G90611rG6C14GJNj4shj65JVFISl,A3fsA9Zfv1X2fVEQhTw51lKENdNrEqT3,60,19,9,140,0,0,3,0,171,24.428571428571427,2,0.0,3,9,136,0,16,0,4,3,0,148,23,1
4625,166763,PtZQYu2omSISCEPobEkK00G9lPsFCpAH,SpATywNh6bZuzm8s1ceuBUnMUAeoAHHw,1,0,0,0,0,0,1,0,1,0.14285714285714285,1,0.0,0,0,0,0,0,0,0,1,0,0,1,1
4626,166767,CNzOzTxB6slz6reBTGQew76XrENqSZZu,A3fsA9Zfv1X2fVEQhTw51lKENdNrEqT3,6,6,0,0,0,0,5,0,11,1.5714285714285714,1,0.0,0,0,0,0,6,0,0,5,0,0,11,1
4627,166769,F5WXvUA8z1Vfdvlva1pujweut7tGE04r,bWdj2GDclj5ofokWjzoa5jAwMkxCykd6,5,0,0,0,0,2,4,1,7,1.0,1,0.0,0,0,0,0,0,2,0,4,1,0,7,1
4628,166778,AtDlkFSnWTgMt7xJ3PkbVdpoMvsEJuZd,SpATywNh6bZuzm8s1ceuBUnMUAeoAHHw,6,4,2,0,1,0,1,0,8,1.1428571428571428,1,0.0,0,2,0,1,4,0,0,1,0,3,5,1
4629,166787,35YnYP4Tkn7xvOTt0M51AeVR3m7l2sIt,SpATywNh6bZuzm8s1ceuBUnMUAeoAHHw,11,7,7,0,7,0,2,0,23,3.2857142857142856,1,0.0,0,7,0,7,7,0,0,2,0,14,9,1
4630,166850,TeBMvAv5VyOBol7RYdEZZqCEFBEIGxYI,SpATywNh6bZuzm8s1ceuBUnMUAeoAHHw,8,4,3,0,3,0,1,0,11,1.5714285714285714,1,0.0,0,3,0,3,4,0,0,1,0,6,5,1
4631,166855,7EXxZBxaHj6q1B0SK4ceBEflKEmD8hvL,bWdj2GDclj5ofokWjzoa5jAwMkxCykd6,3,0,0,0,0,0,8,0,8,1.1428571428571428,2,0.0,0,0,0,0,0,0,0,8,0,0,8,1
4632,166860,oJHnnpnFBdflow5PBV5uje04XEG79lqu,A3fsA9Zfv1X2fVEQhTw51lKENdNrEqT3,10,4,0,0,0,1,16,1,22,3.142857142857143,3,0.0,0,0,0,0,4,1,0,16,1,0,22,0
4633,166873,PDNsiMyTk72mYrcSTgVVhe2c68BJ17Ar,bWdj2GDclj5ofokWjzoa5jAwMkxCykd6,20,16,10,0,8,0,11,1,46,6.571428571428571,1,0.0,2,10,0,8,14,0,0,11,1,20,26,1
4634,166928,my33FPQMSZttKqR0p8zRP2Bz5eCFTYNb,bWdj2GDclj5ofokWjzoa5jAwMkxCykd6,16,21,4,6,4,1,15,0,51,7.285714285714286,3,0.0,3,4,6,4,18,1,0,15,0,17,34,1
4635,166942,4kvP66ucXESl9aXSUioaBWcuWa5i6uFa,SpATywNh6bZuzm8s1ceuBUnMUAeoAHHw,1,0,0,0,0,0,1,0,1,0.14285714285714285,1,0.0,0,0,0,0,0,0,0,1,0,0,1,1
4636,166981,KoUza1X6kek4yLxwsTzshNuuseZEHFu6,bWdj2GDclj5ofokWjzoa5jAwMkxCykd6,1,0,0,0,0,0,1,0,1,0.14285714285714285,1,0.0,0,0,0,0,0,0,0,1,0,0,1,1
4637,166987,49oypRKmbhsESvRt5ynYhyueQezYQsCQ,A3fsA9Zfv1X2fVEQhTw51lKENdNrEqT3,1,0,0,0,0,0,1,0,1,0.14285714285714285,1,0.0,0,0,0,0,0,0,0,1,0,0,1,1
4638,166991,H1TM0tfwQGan808kaqC5vLvGV8fCUgtO,SpATywNh6bZuzm8s1ceuBUnMUAeoAHHw,13,8,6,0,3,3,7,1,28,4.0,1,0.0,0,6,0,3,8,3,0,7,1,9,19,1
4639,167005,NLhSHOlvNcAzXTnIuTXBlyWdelKO6Po8,SpATywNh6bZuzm8s1ceuBUnMUAeoAHHw,1,0,0,0,0,0,1,0,1,0.14285714285714285,1,0.0,0,0,0,0,0,0,0,1,0,0,1,1
4640,167006,Sn4V2T6RAiQ47UvRCtMkFCdxnmF36LZI,G8EPVSXsOYB5YQWZGiz1aVq5Pgr2GrQu,4,4,2,0,2,0,1,0,9,1.2857142857142858,1,0.0,1,2,0,2,3,0,0,1,0,5,4,0
4641,167012,6x1ORFJhWxzWx07uL4IvCItSXSuL8CVc,G8EPVSXsOYB5YQWZGiz1aVq5Pgr2GrQu,6,3,1,0,1,0,2,0,7,1.0,1,0.0,0,1,0,1,3,0,0,2,0,2,5,1
4642,167024,lSXJXGWdv2XbDDcmfVzMwBcHxgsJFtm2,SpATywNh6bZuzm8s1ceuBUnMUAeoAHHw,1,0,0,0,0,0,1,0,1,0.14285714285714285,1,0.0,0,0,0,0,0,0,0,1,0,0,1,1
4643,167032,xMKGcYeHMuhMu436Dx8qNr2iLxqOhlEy,SpATywNh6bZuzm8s1ceuBUnMUAeoAHHw,10,6,4,2,3,0,1,0,16,2.2857142857142856,1,0.0,1,4,2,3,5,0,0,1,0,10,6,1
4644,167038,C3LGGw6vM3GlX5Dw8258DOqpO1L1iYv7,A3fsA9Zfv1X2fVEQhTw51lKENdNrEqT3,15,17,8,0,3,1,10,2,41,5.857142857142857,1,0.0,0,8,0,3,17,1,0,10,2,11,30,0
4645,167045,CNckAsfMKSEbkBf2UCjHJpPoGTdJKeyS,SpATywNh6bZuzm8s1ceuBUnMUAeoAHHw,1,0,0,0,0,0,1,0,1,0.14285714285714285,1,0.0,0,0,0,0,0,0,0,1,0,0,1,1
4646,167055,tcOuPvspwR8RIsYVlB8hdFhNn4mHp1dB,A3fsA9Zfv1X2fVEQhTw51lKENdNrEqT3,6,5,2,0,1,0,2,0,10,1.4285714285714286,1,0.0,0,2,0,1,5,0,0,2,0,3,7,1
4647,167070,hfflCpa9jLkmfdXytJuPOg7rRc5Xg9VZ,G8EPVSXsOYB5YQWZGiz1aVq5Pgr2GrQu,1,0,0,0,0,0,1,0,1,0.14285714285714285,1,0.0,0,0,0,0,0,0,0,1,0,0,1,1
4648,167084,OtGMx6eKyVYjbz3L87VVmC99kyg1WjEl,SpATywNh6bZuzm8s1ceuBUnMUAeoAHHw,3,4,2,0,0,0,2,0,8,1.1428571428571428,1,0.0,0,2,0,0,4,0,0,2,0,2,6,0
4649,167109,riXqOkhR5seretWfUGQsZViiD6naR0Fb,G8EPVSXsOYB5YQWZGiz1aVq5Pgr2GrQu,9,11,6,0,1,5,1,0,24,3.4285714285714284,1,0.0,0,6,0,1,11,5,0,1,0,7,17,1
4650,167110,EcPuYKhDy2VQKZUDtISpnuVnvHl1yyoH,A3fsA9Zfv1X2fVEQhTw51lKENdNrEqT3,11,8,2,0,2,0,6,0,18,2.5714285714285716,2,0.0,0,2,0,2,8,0,0,6,0,4,14,1
4651,167153,zLzrsjVhPiaEb3EDibB8rvomdeM0jowN,A3fsA9Zfv1X2fVEQhTw51lKENdNrEqT3,6,8,1,0,0,0,2,0,11,1.5714285714285714,1,0.0,0,1,0,0,8,0,0,2,0,1,10,1
4652,167160,qWdJx4ntsNtLd8GM8vVdR8CfHZUb8VJ1,SpATywNh6bZuzm8s1ceuBUnMUAeoAHHw,7,7,0,0,0,0,4,5,16,2.2857142857142856,1,0.0,0,0,0,0,7,0,0,4,5,0,16,0
4653,167164,AMZsJ16nuDGvS9hfq5BFOrn6l1y3GwHs,bWdj2GDclj5ofokWjzoa5jAwMkxCykd6,1,0,0,0,0,0,1,0,1,0.14285714285714285,1,0.0,0,0,0,0,0,0,0,1,0,0,1,1
4654,167174,jQg5UakMQRKmdDEXjxxf2nAUZSauWzhl,bWdj2GDclj5ofokWjzoa5jAwMkxCykd6,1,0,0,0,0,0,1,0,1,0.14285714285714285,1,0.0,0,0,0,0,0,0,0,1,0,0,1,1
4655,167177,UMYeL3JvH5xCKyH0vQfSARajUrJikDyh,SpATywNh6bZuzm8s1ceuBUnMUAeoAHHw,1,0,0,0,0,0,1,0,1,0.14285714285714285,1,0.0,0,0,0,0,0,0,0,1,0,0,1,1
4656,167207,l6rkobnqEUKXFQnaBVgonlwU5l25TkcG,A3fsA9Zfv1X2fVEQhTw51lKENdNrEqT3,1,0,0,0,0,0,1,0,1,0.14285714285714285,1,0.0,0,0,0,0,0,0,0,1,0,0,1,0
4657,167210,6ihb1oofKKDBkRZUjaHYZlnMwyNG8Px4,SpATywNh6bZuzm8s1ceuBUnMUAeoAHHw,11,5,4,0,4,0,3,0,16,2.2857142857142856,1,0.0,0,4,0,4,5,0,0,3,0,8,8,1
4658,167213,M3at3k1rzNLIb1jD1sERLP1bmTcUThqC,A3fsA9Zfv1X2fVEQhTw51lKENdNrEqT3,13,20,0,0,0,0,15,2,37,5.285714285714286,2,0.0,0,0,0,0,20,0,0,15,2,0,37,1
4659,167220,Me95BqnMi7W18LuJ9CGsC9vdXTLZ2e0Y,bWdj2GDclj5ofokWjzoa5jAwMkxCykd6,6,2,1,0,1,0,4,0,8,1.1428571428571428,1,0.0,0,1,0,1,2,0,0,4,0,2,6,1
4660,167228,3wg8Fx16VgJsTbW93ZS5qb0oY4bANqoR,A3fsA9Zfv1X2fVEQhTw51lKENdNrEqT3,51,24,11,164,2,0,14,0,215,30.714285714285715,1,0.0,3,11,135,2,21,0,29,14,0,151,64,1
4661,167230,EIH1YpezRj2Lrs71q1s3kjWajWGWK1FM,bWdj2GDclj5ofokWjzoa5jAwMkxCykd6,4,3,1,0,0,0,2,0,6,0.8571428571428571,1,0.0,0,1,0,0,3,0,0,2,0,1,5,1
4662,167243,XFT0aKbgPIc1KxMgUm9PqHuvehKJNjDt,A3fsA9Zfv1X2fVEQhTw51lKENdNrEqT3,1,0,0,0,0,0,1,0,1,0.14285714285714285,1,0.0,0,0,0,0,0,0,0,1,0,0,1,1
4663,167265,srnnzUkIJr2Uisav8LfnV4SnpbNw9CLp,RXDvfPUBYFlVdlueBFbLW0mhhAyGEqpt,1,0,0,0,0,0,1,0,1,0.14285714285714285,1,0.0,0,0,0,0,0,0,0,1,0,0,1,1
4664,167271,SG7N8DhpCuhIu06IIzLX0CSolbyIDsIx,RXDvfPUBYFlVdlueBFbLW0mhhAyGEqpt,1,0,0,0,0,0,1,0,1,0.14285714285714285,1,0.0,0,0,0,0,0,0,0,1,0,0,1,1
4665,167283,ilday4HM3BCIYcolQVgtTOYVZxbISCZm,G8EPVSXsOYB5YQWZGiz1aVq5Pgr2GrQu,7,8,4,0,3,0,1,0,16,2.2857142857142856,1,0.0,0,4,0,3,8,0,0,1,0,7,9,1
4666,167288,sm9cSvIl5TlGsEwD0oTwnhmYMTLPLj8P,bWdj2GDclj5ofokWjzoa5jAwMkxCykd6,7,3,2,0,2,0,2,0,9,1.2857142857142858,1,0.0,0,2,0,2,3,0,0,2,0,4,5,1
4667,167295,4uAdkCJ4XUaD1NQGV93nNifOuyurJNKS,bWdj2GDclj5ofokWjzoa5jAwMkxCykd6,5,3,1,0,1,0,2,0,7,1.0,1,0.0,0,1,0,1,3,0,0,2,0,2,5,1
4668,167326,yAxjMvvPF3HDitgCGIcnFlXrbnOszGcQ,A3fsA9Zfv1X2fVEQhTw51lKENdNrEqT3,1,0,0,0,0,0,1,0,1,0.14285714285714285,1,0.0,0,0,0,0,0,0,0,1,0,0,1,1
4669,167329,cGTjqosEXx9XAIsx39Oilmuyj8U0yqfw,A3fsA9Zfv1X2fVEQhTw51lKENdNrEqT3,2,0,0,0,0,0,2,0,2,0.2857142857142857,1,0.0,0,0,0,0,0,0,0,2,0,0,2,1
4670,167340,3wg8Fx16VgJsTbW93ZS5qb0oY4bANqoR,bWdj2GDclj5ofokWjzoa5jAwMkxCykd6,1,0,0,0,0,0,1,0,1,0.14285714285714285,1,0.0,0,0,0,0,0,0,0,1,0,0,1,1
4671,167358,dr13KuqOo10EJH5V4oOgMy17ewEUhD7o,bWdj2GDclj5ofokWjzoa5jAwMkxCykd6,8,5,3,0,3,0,1,0,12,1.7142857142857142,1,0.0,1,3,0,3,4,0,0,1,0,7,5,1
4672,167361,IrJFtwV20e4gt61fm0xRhF7i2xKfc3Wt,SpATywNh6bZuzm8s1ceuBUnMUAeoAHHw,6,3,1,0,1,0,3,0,8,1.1428571428571428,1,0.0,0,1,0,1,3,0,0,3,0,2,6,1
4673,167380,OId7ihHovZuj6RIQGiERiMwv6zBqdO48,SpATywNh6bZuzm8s1ceuBUnMUAeoAHHw,18,16,10,0,5,1,5,0,37,5.285714285714286,4,0.0,1,10,0,5,15,1,0,5,0,16,21,1
4674,167394,igrS7a4fgJSjVbKCLW8mOgk95ysQ2GkN,A3fsA9Zfv1X2fVEQhTw51lKENdNrEqT3,3,3,0,0,0,0,2,0,5,0.7142857142857143,1,0.0,0,0,0,0,3,0,0,2,0,0,5,1
4675,167407,eyR9iuqRP6NAP1R3ifarfP0UWEdrKp8A,A3fsA9Zfv1X2fVEQhTw51lKENdNrEqT3,2,0,0,0,0,0,2,0,2,0.2857142857142857,1,0.0,0,0,0,0,0,0,0,2,0,0,2,1
4676,167432,hb0tSuKbMyuHgl5YJ3vO5EnQOpHuAODO,SpATywNh6bZuzm8s1ceuBUnMUAeoAHHw,1,0,0,0,0,0,1,0,1,0.14285714285714285,1,0.0,0,0,0,0,0,0,0,1,0,0,1,1
4677,167440,6ne76rFv6J6TLXUe0mStK4MXCR4J8Kt5,A3fsA9Zfv1X2fVEQhTw51lKENdNrEqT3,6,5,2,0,2,0,4,0,13,1.8571428571428572,1,0.0,0,2,0,2,5,0,0,4,0,4,9,1
4678,167449,1sNCO2I2ugkApY4LVRJ2DyXeH2mxSN1W,G8EPVSXsOYB5YQWZGiz1aVq5Pgr2GrQu,5,12,0,0,0,0,2,0,14,2.0,1,0.0,0,0,0,0,12,0,0,2,0,0,14,1
4679,167465,sQxRXgPzRqzU7G3Pdnh2A5U6A9WnaHY5,bWdj2GDclj5ofokWjzoa5jAwMkxCykd6,7,1,1,0,1,0,4,0,7,1.0,1,0.0,0,1,0,1,1,0,0,4,0,2,5,1
4680,167491,qT76Xe5xaEtKYZkUI7rFvt9ufvg3XeEH,SpATywNh6bZuzm8s1ceuBUnMUAeoAHHw,7,5,4,0,1,0,1,0,11,1.5714285714285714,1,0.0,0,4,0,1,5,0,0,1,0,5,6,0
4681,167492,kMJdIf6lyKBj8d5FH5wYfeAvXu9zJZ2k,A3fsA9Zfv1X2fVEQhTw51lKENdNrEqT3,23,7,3,86,0,0,3,0,99,14.142857142857142,2,0.0,1,3,71,0,6,0,15,3,0,75,24,1
4682,167496,Yq1D9nN2WOKWLjCOIlbnWTVJWZSUTem6,A3fsA9Zfv1X2fVEQhTw51lKENdNrEqT3,2,0,0,0,0,0,2,0,2,0.2857142857142857,1,0.0,0,0,0,0,0,0,0,2,0,0,2,1
4683,167503,Mg6dUwdl29Cw5DED2LH0q16XcuO0xYuD,SpATywNh6bZuzm8s1ceuBUnMUAeoAHHw,8,6,2,0,2,1,4,0,15,2.142857142857143,2,0.0,0,2,0,2,6,1,0,4,0,4,11,1
4684,167509,pqW9PtvFaMrdSQupCOglYiHhuFKzGBi5,RXDvfPUBYFlVdlueBFbLW0mhhAyGEqpt,13,8,7,0,5,0,2,0,22,3.142857142857143,1,0.0,0,7,0,5,8,0,0,2,0,12,10,0
4685,167523,qT76Xe5xaEtKYZkUI7rFvt9ufvg3XeEH,G8EPVSXsOYB5YQWZGiz1aVq5Pgr2GrQu,4,2,1,0,1,0,1,0,5,0.7142857142857143,1,0.0,0,1,0,1,2,0,0,1,0,2,3,0
4686,167525,ySjZqVrtQh1EozvnE2NZCLTibblBWXx9,RXDvfPUBYFlVdlueBFbLW0mhhAyGEqpt,1,0,0,0,0,0,1,0,1,0.14285714285714285,1,0.0,0,0,0,0,0,0,0,1,0,0,1,1
4687,167544,9eohUJjz99qBfLZrerzU9mvxKvUKHTKa,SpATywNh6bZuzm8s1ceuBUnMUAeoAHHw,7,5,2,0,2,0,2,0,11,1.5714285714285714,1,0.0,0,2,0,2,5,0,0,2,0,4,7,1
4688,167558,gKnyqrdfTVsXquWsv3SHAmERz5CaeqZp,SpATywNh6bZuzm8s1ceuBUnMUAeoAHHw,6,2,1,0,1,0,3,1,8,1.1428571428571428,1,0.0,0,1,0,1,2,0,0,3,1,2,6,1
4689,167561,E8lMjkJcqZcrPtGwbo8pVkzTRx8M7QkS,A3fsA9Zfv1X2fVEQhTw51lKENdNrEqT3,1,0,0,0,0,0,1,0,1,0.14285714285714285,1,0.0,0,0,0,0,0,0,0,1,0,0,1,1
4690,167569,YfnUrAEbnMAPhZfA8XApGAMCNnmussT1,SpATywNh6bZuzm8s1ceuBUnMUAeoAHHw,1,0,0,0,0,0,2,0,2,0.2857142857142857,1,0.0,0,0,0,0,0,0,0,2,0,0,2,1
4691,167584,f8jfFGo37bmeRi1spfYTASayMTQa0E3F,A3fsA9Zfv1X2fVEQhTw51lKENdNrEqT3,7,8,1,0,0,0,4,0,13,1.8571428571428572,1,0.0,0,1,0,0,8,0,0,4,0,1,12,1
4692,167605,mkvoAcdNQZUqkTrSjEQHebVQkgmiPVSS,SpATywNh6bZuzm8s1ceuBUnMUAeoAHHw,6,6,0,0,0,0,2,0,8,1.1428571428571428,1,0.0,2,0,0,0,4,0,0,2,0,2,6,1
4693,167633,JRUKMEmBZ3p5F0JpSVHv1lQEiMQUvro3,bWdj2GDclj5ofokWjzoa5jAwMkxCykd6,1,0,0,0,0,0,1,0,1,0.14285714285714285,1,0.0,0,0,0,0,0,0,0,1,0,0,1,1
4694,167636,DTg7EG4lfjPjfkpYaGZXFcsjykgIpZH4,RXDvfPUBYFlVdlueBFbLW0mhhAyGEqpt,16,14,7,0,5,0,5,0,31,4.428571428571429,2,0.0,0,7,0,5,14,0,0,5,0,12,19,1
4695,167638,JRUKMEmBZ3p5F0JpSVHv1lQEiMQUvro3,RXDvfPUBYFlVdlueBFbLW0mhhAyGEqpt,1,0,0,0,0,0,1,0,1,0.14285714285714285,1,0.0,0,0,0,0,0,0,0,1,0,0,1,1
4696,167656,j5JRftGHwmY5lwmELzjqtaSr20rFNwcA,SpATywNh6bZuzm8s1ceuBUnMUAeoAHHw,1,0,0,0,0,0,1,0,1,0.14285714285714285,1,0.0,0,0,0,0,0,0,0,1,0,0,1,1
4697,167678,IoHuXwpFj6jpaLOU2cjm2xo4xL3oc4iA,G8EPVSXsOYB5YQWZGiz1aVq5Pgr2GrQu,2,0,0,0,0,0,2,0,2,0.2857142857142857,1,0.0,0,0,0,0,0,0,0,2,0,0,2,1
4698,167684,IwkHnS79j7DCN6kQlSDresD36YsGD4iB,G8EPVSXsOYB5YQWZGiz1aVq5Pgr2GrQu,1,0,0,0,0,0,1,0,1,0.14285714285714285,1,0.0,0,0,0,0,0,0,0,1,0,0,1,1
4699,167693,bEOs2EB6LytAmhUESt0L1yFXZPfFAnOp,A3fsA9Zfv1X2fVEQhTw51lKENdNrEqT3,9,4,1,0,1,0,7,1,14,2.0,1,0.0,0,1,0,1,4,0,0,7,1,2,12,1
4700,167700,Ujm7XeJHYzYOVDc0hFmfxPzKGkFTVoYw,SpATywNh6bZuzm8s1ceuBUnMUAeoAHHw,10,5,1,0,1,3,7,1,18,2.5714285714285716,1,0.0,1,1,0,1,4,3,0,7,1,3,15,1
4701,167701,YEYMa1UeAbDmjG2cCwIOrTIjhyXHc5JO,SpATywNh6bZuzm8s1ceuBUnMUAeoAHHw,5,2,1,0,1,0,3,0,7,1.0,1,0.0,0,1,0,1,2,0,0,3,0,2,5,1
4702,167712,JhqtKTVVZhx2wzcUoD48zfOf7XJtvv55,SpATywNh6bZuzm8s1ceuBUnMUAeoAHHw,3,2,1,0,0,0,1,0,4,0.5714285714285714,1,0.0,0,1,0,0,2,0,0,1,0,1,3,1
4703,167714,nyH7Jx4kN1AdDJdwkZQoUDqYoovHgbk5,G8EPVSXsOYB5YQWZGiz1aVq5Pgr2GrQu,8,8,7,2,4,0,1,0,22,3.142857142857143,1,0.0,0,7,2,4,8,0,0,1,0,13,9,1
4704,167723,W5xQOH5MemwXn7klqn6rjd1MM4WzuzQi,G8EPVSXsOYB5YQWZGiz1aVq5Pgr2GrQu,1,0,0,0,0,0,1,0,1,0.14285714285714285,1,0.0,0,0,0,0,0,0,0,1,0,0,1,1
4705,167725,4SwPkRwXa5n6GEnAhisQz0yWI5GHdoml,SpATywNh6bZuzm8s1ceuBUnMUAeoAHHw,1,0,0,0,0,0,1,0,1,0.14285714285714285,1,0.0,0,0,0,0,0,0,0,1,0,0,1,1
4706,167730,eJb0xHKhoVkWPAATxA33vCcHjeoUzUdU,SpATywNh6bZuzm8s1ceuBUnMUAeoAHHw,1,0,0,0,0,0,1,0,1,0.14285714285714285,1,0.0,0,0,0,0,0,0,0,1,0,0,1,1
4707,167732,KTO4rcwcNqZCBYJ04kXZU7uzHTeP1Eer,bWdj2GDclj5ofokWjzoa5jAwMkxCykd6,1,0,0,0,0,0,1,0,1,0.14285714285714285,1,0.0,0,0,0,0,0,0,0,1,0,0,1,1
4708,167733,qj8NUYtUMoWd1xGdKnBiRi4xrQOuNSyr,SpATywNh6bZuzm8s1ceuBUnMUAeoAHHw,7,4,0,0,0,11,8,2,25,3.5714285714285716,1,0.0,0,0,0,0,4,11,0,8,2,0,25,0
4709,167734,KTO4rcwcNqZCBYJ04kXZU7uzHTeP1Eer,A3fsA9Zfv1X2fVEQhTw51lKENdNrEqT3,27,5,3,54,0,0,4,0,66,9.428571428571429,1,0.0,1,3,48,0,4,0,6,4,0,52,14,1
4710,167736,T9568NbVeTbUTmE4rk1xM0kbLMHudWM2,SpATywNh6bZuzm8s1ceuBUnMUAeoAHHw,2,0,0,0,0,0,2,0,2,0.2857142857142857,1,0.0,0,0,0,0,0,0,0,2,0,0,2,1
4711,167738,8MuGb55gUM18pukCITXgZoTSobqXs9G4,A3fsA9Zfv1X2fVEQhTw51lKENdNrEqT3,44,5,0,154,0,0,4,0,163,23.285714285714285,2,0.0,0,0,154,0,5,0,0,4,0,154,9,1
4712,167739,mzdlx6QFLX0FKvpMfsWw3ZhcYcqCwlK5,SpATywNh6bZuzm8s1ceuBUnMUAeoAHHw,25,34,12,34,4,9,8,1,102,14.571428571428571,2,0.0,16,12,29,4,18,9,5,8,1,61,41,0
4713,167752,X7ZRKY7iYfh1hBkF13Zq6r3vncHYgHEH,A3fsA9Zfv1X2fVEQhTw51lKENdNrEqT3,1,0,0,0,0,0,1,0,1,0.14285714285714285,1,0.0,0,0,0,0,0,0,0,1,0,0,1,1
4714,167762,HubxyoHMVvWQ9uDYtdMVwcYvuPNvagty,SpATywNh6bZuzm8s1ceuBUnMUAeoAHHw,7,4,3,0,3,0,2,0,12,1.7142857142857142,1,0.0,0,3,0,3,4,0,0,2,0,6,6,1
4715,167767,8MuGb55gUM18pukCITXgZoTSobqXs9G4,bWdj2GDclj5ofokWjzoa5jAwMkxCykd6,4,3,0,0,0,0,4,0,7,1.0,3,0.0,0,0,0,0,3,0,0,4,0,0,7,1
4716,167777,BWZyBrJDBbkcDEXyE3CSVFoVlT2CRRku,bWdj2GDclj5ofokWjzoa5jAwMkxCykd6,5,3,0,0,0,3,6,0,12,1.7142857142857142,1,0.0,1,0,0,0,2,3,0,6,0,1,11,1
4717,167781,HhHFHVl0FdyFAQQ7F70xD2HQyGMqv85Q,G8EPVSXsOYB5YQWZGiz1aVq5Pgr2GrQu,9,11,3,0,2,0,3,0,19,2.7142857142857144,1,0.0,0,3,0,2,11,0,0,3,0,5,14,1
4718,167800,0LL9QDirPHiGZNR0VQr3Nl4vTFkZYpx9,SpATywNh6bZuzm8s1ceuBUnMUAeoAHHw,1,0,0,0,0,0,1,0,1,0.14285714285714285,1,0.0,0,0,0,0,0,0,0,1,0,0,1,1
4719,167802,RPbVtB8AwN8yynuRyP2nQSNV9Qygwfwj,bWdj2GDclj5ofokWjzoa5jAwMkxCykd6,1,0,0,0,0,0,1,0,1,0.14285714285714285,1,0.0,0,0,0,0,0,0,0,1,0,0,1,1
4720,167804,t1cN3fKfmsp5Xu7Bxx5kMtJx0UaXo72h,A3fsA9Zfv1X2fVEQhTw51lKENdNrEqT3,1,0,0,0,0,0,1,0,1,0.14285714285714285,1,0.0,0,0,0,0,0,0,0,1,0,0,1,1
4721,167809,cec6apEZZ4OuI8Z1bq3hYVAQOrfIot0q,G8EPVSXsOYB5YQWZGiz1aVq5Pgr2GrQu,5,2,1,0,1,0,5,0,9,1.2857142857142858,1,0.0,0,1,0,1,2,0,0,5,0,2,7,0
4722,167815,5sps38f5Y5pZOFcONQeuy3Uw9461fahZ,bWdj2GDclj5ofokWjzoa5jAwMkxCykd6,5,2,1,0,1,0,2,0,6,0.8571428571428571,1,0.0,0,1,0,1,2,0,0,2,0,2,4,1
4723,169705,Qty87BeKrf3ZgzVA2PT9rBe28vADAPbJ,fbPkOYLVPtPgIt0MxizjfFJov3JbHyAi,1,0,0,0,0,0,1,0,1,0.14285714285714285,1,0.0,0,0,0,0,0,0,0,1,0,0,1,1
4724,169725,udxFfabXtaVUvVlT3wEleIvfDBGe9yE2,fbPkOYLVPtPgIt0MxizjfFJov3JbHyAi,7,3,2,0,2,0,3,0,10,1.4285714285714286,1,0.0,0,2,0,2,3,0,0,3,0,4,6,1
4725,169772,l1rg3D8Gp1lv7dbBBYKvzTS3OZ5DRjWH,A3fsA9Zfv1X2fVEQhTw51lKENdNrEqT3,1,0,0,0,0,0,1,0,1,0.14285714285714285,1,0.0,0,0,0,0,0,0,0,1,0,0,1,1
4726,170032,GlWFWKrBQhsgqjbmoDsRUa17h8chqAsd,G8EPVSXsOYB5YQWZGiz1aVq5Pgr2GrQu,9,6,1,14,1,0,2,0,24,3.4285714285714284,1,0.0,3,1,11,1,3,0,3,2,0,16,8,1
4727,170257,UYAHgDyJ2Tcd8fTB7PMLIt7CemKCJ2QW,SpATywNh6bZuzm8s1ceuBUnMUAeoAHHw,5,3,1,0,1,0,2,0,7,1.0,1,0.0,0,1,0,1,3,0,0,2,0,2,5,0
4728,170412,Z6SakRvyvh7ZuaV4DHEE1b3QLOpPcfOm,SpATywNh6bZuzm8s1ceuBUnMUAeoAHHw,5,5,1,0,0,0,1,0,7,1.0,1,0.0,0,1,0,0,5,0,0,1,0,1,6,0
4729,172603,3Qa8OwRnF6RlLJIaj65bDtbQqyemzMgL,7GRhBDsirIGkRZBtSMEzNTyDr2JQm4xx,2,0,0,0,0,0,4,0,4,0.5714285714285714,1,0.0,0,0,0,0,0,0,0,4,0,0,4,1
4730,172607,NzrnPyQE2ugty7kkveeBlkFqr7w3UxlN,7GRhBDsirIGkRZBtSMEzNTyDr2JQm4xx,2,0,0,0,0,0,4,0,4,0.5714285714285714,1,0.0,0,0,0,0,0,0,0,4,0,0,4,1
4731,172625,6rGO7hPQfiSxYr5WLMk6ADh5tZXWjo5G,7GRhBDsirIGkRZBtSMEzNTyDr2JQm4xx,6,1,1,0,1,0,4,0,7,1.0,1,0.0,0,1,0,1,1,0,0,4,0,2,5,1
4732,172633,dbB5wvpXcG9crHY0IBSgcjC2RaEiLaLJ,7GRhBDsirIGkRZBtSMEzNTyDr2JQm4xx,33,44,12,45,7,1,2,0,111,15.857142857142858,1,0.0,30,12,36,7,14,1,9,2,0,85,26,1
4733,172648,4dKHuxqIxqkgnnPsJVGzxbywZwnO5Gk5,7GRhBDsirIGkRZBtSMEzNTyDr2JQm4xx,2,0,0,0,0,0,2,0,2,0.2857142857142857,1,0.0,0,0,0,0,0,0,0,2,0,0,2,1
4734,172664,qVPmJ4VDzezTrYKhrdeTeAkmNVvDpxTN,7GRhBDsirIGkRZBtSMEzNTyDr2JQm4xx,1,0,0,0,0,0,1,0,1,0.14285714285714285,1,0.0,0,0,0,0,0,0,0,1,0,0,1,1
4735,172672,tN0VqNMvyp7i1ARB8nPF5OPuXHimNIVo,7GRhBDsirIGkRZBtSMEzNTyDr2JQm4xx,2,0,0,0,0,0,2,0,2,0.2857142857142857,1,0.0,0,0,0,0,0,0,0,2,0,0,2,1
4736,172674,AEIKxehDViGug4MCURfXcZNkb3lq7o1x,7GRhBDsirIGkRZBtSMEzNTyDr2JQm4xx,19,14,10,0,10,0,4,0,38,5.428571428571429,1,0.0,0,10,0,10,14,0,0,4,0,20,18,1
4737,172706,ExYCcuGVzDNcCtA4rQqosA267qlGxHih,7GRhBDsirIGkRZBtSMEzNTyDr2JQm4xx,7,0,0,0,0,0,7,1,8,1.1428571428571428,1,0.0,0,0,0,0,0,0,0,7,1,0,8,1
4738,172707,JnYcKFBPT6ke8yr2Se5J0qjNCbQC2Yzq,7GRhBDsirIGkRZBtSMEzNTyDr2JQm4xx,7,5,1,0,0,0,6,1,13,1.8571428571428572,1,0.0,0,1,0,0,5,0,0,6,1,1,12,1
4739,172733,oKu6VLpnoojteApzRKKjWrPb4vBoBjWk,7GRhBDsirIGkRZBtSMEzNTyDr2JQm4xx,1,0,0,0,0,0,1,0,1,0.14285714285714285,1,0.0,0,0,0,0,0,0,0,1,0,0,1,1
4740,172778,u9U6O6GxVn6L6EV5GIFg6G5cI8qZfIM1,fbPkOYLVPtPgIt0MxizjfFJov3JbHyAi,5,3,2,0,1,0,2,0,8,1.1428571428571428,1,0.0,0,2,0,1,3,0,0,2,0,3,5,1
4741,173101,Sy0IBVghIdDN5uhsYaAtE4EZP4lbDR6C,bWdj2GDclj5ofokWjzoa5jAwMkxCykd6,6,3,2,0,2,0,1,0,8,1.1428571428571428,2,0.0,0,2,0,2,3,0,0,1,0,4,4,1
4742,173108,uRoRagoJb7klyYml2W2nJUADMGnmCLCh,A3fsA9Zfv1X2fVEQhTw51lKENdNrEqT3,5,5,0,0,0,0,2,0,7,1.0,1,0.0,0,0,0,0,5,0,0,2,0,0,7,1
4743,173115,WhBYED4roEqwKdd7WRGAiWGZl1X7zVBC,SpATywNh6bZuzm8s1ceuBUnMUAeoAHHw,22,17,8,18,7,0,2,0,52,7.428571428571429,1,0.0,2,8,15,7,15,0,3,2,0,32,20,1
4744,173122,MeAthuGTC0Mssqzv92bAUQ6CjEcP1h8d,A3fsA9Zfv1X2fVEQhTw51lKENdNrEqT3,71,85,64,188,27,52,18,2,436,62.285714285714285,3,0.0,3,64,139,27,82,52,49,18,2,233,203,0
4745,173128,6qUqUreFzudXqhzjQZQMQuj6XiqDCHSF,bWdj2GDclj5ofokWjzoa5jAwMkxCykd6,9,8,4,0,2,0,3,0,17,2.4285714285714284,1,0.0,0,4,0,2,8,0,0,3,0,6,11,1
4746,173137,jV4bQZTO8NhEnxumKD5qHxnk6auhtohn,SpATywNh6bZuzm8s1ceuBUnMUAeoAHHw,10,9,3,15,0,0,3,0,30,4.285714285714286,1,0.0,4,3,13,0,5,0,2,3,0,20,10,0
4747,173147,60Dduz8CDLu92eVkbOGEahQqaVwXLhUV,A3fsA9Zfv1X2fVEQhTw51lKENdNrEqT3,16,10,7,0,7,0,5,0,29,4.142857142857143,2,0.0,0,7,0,7,10,0,0,5,0,14,15,1
4748,173166,84jM92o4oluSWHz68fjJdNU1O5aejzX8,A3fsA9Zfv1X2fVEQhTw51lKENdNrEqT3,1,0,0,0,0,0,1,0,1,0.14285714285714285,1,0.0,0,0,0,0,0,0,0,1,0,0,1,1
4749,173167,R2PVhKsPZcwfUBkw7hJ62cbr2j1XWSh4,SpATywNh6bZuzm8s1ceuBUnMUAeoAHHw,6,4,3,0,0,0,2,1,10,1.4285714285714286,1,0.0,0,3,0,0,4,0,0,2,1,3,7,1
4750,173171,HsOuSjJr2KKry0RFy7J8sS4QwH7Xk1dF,SpATywNh6bZuzm8s1ceuBUnMUAeoAHHw,23,27,17,0,12,13,11,1,81,11.571428571428571,2,0.0,7,17,0,12,20,13,0,11,1,36,45,1
4751,173202,GhGGPl8wZwtcLQZXvpUQjKC1TVd0CdDS,bWdj2GDclj5ofokWjzoa5jAwMkxCykd6,8,1,1,0,1,1,9,1,14,2.0,1,0.0,0,1,0,1,1,1,0,9,1,2,12,1
4752,173205,CXCWo7FvfWmDFvByuj4kADS8SZwH1QxN,SpATywNh6bZuzm8s1ceuBUnMUAeoAHHw,2,0,0,0,0,0,2,0,2,0.2857142857142857,1,0.0,0,0,0,0,0,0,0,2,0,0,2,1
4753,173217,55qFOvzjFp79P87tCKKcDPlhphK7gh3v,A3fsA9Zfv1X2fVEQhTw51lKENdNrEqT3,1,0,0,0,0,0,1,0,1,0.14285714285714285,1,0.0,0,0,0,0,0,0,0,1,0,0,1,1
4754,173218,RXXY4sAswYRo10grAYknhMWNw9Y2YFYb,SpATywNh6bZuzm8s1ceuBUnMUAeoAHHw,16,11,5,11,5,0,20,0,52,7.428571428571429,2,0.0,1,5,10,5,10,0,1,20,0,21,31,0
4755,173228,v7cnqM7vYgsjiGOlSwxgim0qVwuXESGN,RXDvfPUBYFlVdlueBFbLW0mhhAyGEqpt,7,4,2,0,1,0,2,0,9,1.2857142857142858,1,0.0,0,2,0,1,4,0,0,2,0,3,6,1
4756,173243,XPZ2qUEZKADAXZXErutkhGpDp6JKqGtI,SpATywNh6bZuzm8s1ceuBUnMUAeoAHHw,15,13,6,14,4,0,6,0,43,6.142857142857143,1,0.0,6,6,13,4,7,0,1,6,0,29,14,1
4757,173247,WLAmx1xu6Oqj4DvlomeHAJXvMyktUiPG,SpATywNh6bZuzm8s1ceuBUnMUAeoAHHw,18,25,1,14,0,0,6,0,46,6.571428571428571,2,0.0,4,1,14,0,21,0,0,6,0,19,27,0
4758,173251,R5nDIhuemBUVJIMEekOzsWhsz8ABh67H,SpATywNh6bZuzm8s1ceuBUnMUAeoAHHw,3,2,0,0,0,0,2,0,4,0.5714285714285714,1,0.0,0,0,0,0,2,0,0,2,0,0,4,1
4759,173255,Utj92TYHIWVfdmSDWLIJybQdBOyLbHqU,SpATywNh6bZuzm8s1ceuBUnMUAeoAHHw,7,2,0,0,0,0,7,1,10,1.4285714285714286,1,0.0,0,0,0,0,2,0,0,7,1,0,10,1
4760,173261,0S6LD77Xb8NCAw50mR3BuCC8qj8MNTO7,SpATywNh6bZuzm8s1ceuBUnMUAeoAHHw,4,2,1,0,0,2,3,0,8,1.1428571428571428,1,0.0,0,1,0,0,2,2,0,3,0,1,7,1
4761,173271,5uCuxLE5XjM4y4nmjuWckCuNM8tm7Xz4,RXDvfPUBYFlVdlueBFbLW0mhhAyGEqpt,41,40,2,115,3,11,6,1,178,25.428571428571427,2,0.0,15,2,108,3,25,11,7,6,1,128,50,1
4762,173306,8NK3iaPYRi5tDjzHZVNIqLtQMUnR3yyG,SpATywNh6bZuzm8s1ceuBUnMUAeoAHHw,2,0,0,0,0,0,2,0,2,0.2857142857142857,1,0.0,0,0,0,0,0,0,0,2,0,0,2,1
4763,173325,CS2NVGM14Xy1CNBgiOvv29fLyH8Y1bY8,SpATywNh6bZuzm8s1ceuBUnMUAeoAHHw,5,3,2,0,0,0,2,0,7,1.0,1,0.0,0,2,0,0,3,0,0,2,0,2,5,1
4764,173333,ljhELjrE7nbOy1tZAQRzQ0d2zvHLtBFk,bWdj2GDclj5ofokWjzoa5jAwMkxCykd6,4,5,2,0,2,0,1,0,10,1.4285714285714286,1,0.0,0,2,0,2,5,0,0,1,0,4,6,1
4765,173335,XXmlSdsGrMmHZfufZWdeObNOjT4zg6AW,G8EPVSXsOYB5YQWZGiz1aVq5Pgr2GrQu,16,11,1,34,0,0,2,0,48,6.857142857142857,1,0.0,0,1,28,0,11,0,6,2,0,29,19,1
4766,173337,d5wcSNGd1z76FQrsNvFOCxhoOHps5LtC,bWdj2GDclj5ofokWjzoa5jAwMkxCykd6,1,0,0,0,0,0,1,0,1,0.14285714285714285,1,0.0,0,0,0,0,0,0,0,1,0,0,1,1
4767,173342,WsU7antS0XD0DLnUCoai3UEBgeJYqPfD,A3fsA9Zfv1X2fVEQhTw51lKENdNrEqT3,2,0,0,0,0,0,4,0,4,0.5714285714285714,1,0.0,0,0,0,0,0,0,0,4,0,0,4,1
4768,173356,SNwjM74zr1JfG7EVwxCRYPHz9bZcobb2,SpATywNh6bZuzm8s1ceuBUnMUAeoAHHw,1,0,0,0,0,0,1,0,1,0.14285714285714285,1,0.0,0,0,0,0,0,0,0,1,0,0,1,0
4769,173360,yZNPokdjhDRHAxyvIoZvfNcgrX1hi17e,SpATywNh6bZuzm8s1ceuBUnMUAeoAHHw,4,2,1,0,1,0,1,0,5,0.7142857142857143,2,0.0,0,1,0,1,2,0,0,1,0,2,3,1
4770,173369,2k8fsIzv9gal41vCmwSZyNE8PhUZWRlf,SpATywNh6bZuzm8s1ceuBUnMUAeoAHHw,18,16,7,23,3,1,10,1,61,8.714285714285714,1,0.0,4,7,19,3,12,1,4,10,1,33,28,0
4771,173371,gx5zIbRkvVmYAkHaGQMR5zm5BpTwVwIe,SpATywNh6bZuzm8s1ceuBUnMUAeoAHHw,6,3,1,0,1,0,2,0,7,1.0,1,0.0,0,1,0,1,3,0,0,2,0,2,5,1
4772,173397,PUvUSLbNhJCmhl8hY6hN43xWGmaNTEJm,SpATywNh6bZuzm8s1ceuBUnMUAeoAHHw,3,2,1,0,0,0,2,0,5,0.7142857142857143,1,0.0,0,1,0,0,2,0,0,2,0,1,4,1
4773,173411,Mum77MZ1mdjN6HFQFByj0Ds7jbAp3P8k,G8EPVSXsOYB5YQWZGiz1aVq5Pgr2GrQu,6,0,0,0,0,1,5,0,6,0.8571428571428571,1,0.0,0,0,0,0,0,1,0,5,0,0,6,1
4774,173420,OIunh5VlGgmCbVp6rN8NSUpYr9NyGfUf,SpATywNh6bZuzm8s1ceuBUnMUAeoAHHw,7,6,3,0,2,0,1,0,12,1.7142857142857142,1,0.0,0,3,0,2,6,0,0,1,0,5,7,1
4775,173454,j5Ehqr4JpEaPpLQaRCbPvKZDUsPQTugX,bWdj2GDclj5ofokWjzoa5jAwMkxCykd6,1,0,0,0,0,0,1,0,1,0.14285714285714285,1,0.0,0,0,0,0,0,0,0,1,0,0,1,1
4776,173461,l1rg3D8Gp1lv7dbBBYKvzTS3OZ5DRjWH,G8EPVSXsOYB5YQWZGiz1aVq5Pgr2GrQu,1,0,0,0,0,0,1,0,1,0.14285714285714285,1,0.0,0,0,0,0,0,0,0,1,0,0,1,1
4777,173473,drbDbeyMCCsWxOOyHvPueP03lfvUAkGe,bWdj2GDclj5ofokWjzoa5jAwMkxCykd6,1,0,0,0,0,0,2,0,2,0.2857142857142857,1,0.0,0,0,0,0,0,0,0,2,0,0,2,1
4778,173485,Gj6yrFuP2L0UySRxwG1ZhYaHhmyFPckw,SpATywNh6bZuzm8s1ceuBUnMUAeoAHHw,4,2,1,0,0,0,2,0,5,0.7142857142857143,1,0.0,0,1,0,0,2,0,0,2,0,1,4,1
4779,173497,2XXif95hPztKoUUhClFIQsvkcA4F6WPm,SpATywNh6bZuzm8s1ceuBUnMUAeoAHHw,1,0,0,0,0,0,1,0,1,0.14285714285714285,1,0.0,0,0,0,0,0,0,0,1,0,0,1,1
4780,173503,MCzItgyS8iSbD1IkbXNJceX9NOFHlbyx,SpATywNh6bZuzm8s1ceuBUnMUAeoAHHw,1,0,0,0,0,0,1,0,1,0.14285714285714285,1,0.0,0,0,0,0,0,0,0,1,0,0,1,1
4781,173504,r5DVNivQqR7zEdPGXI8XjDMOM8jGXSCY,bWdj2GDclj5ofokWjzoa5jAwMkxCykd6,14,12,8,10,8,0,3,0,41,5.857142857142857,1,0.0,2,8,8,8,10,0,2,3,0,26,15,1
4782,173506,aV96dKmuiAXZCpnpQwDdasPAhwqE3nqd,A3fsA9Zfv1X2fVEQhTw51lKENdNrEqT3,2,0,0,0,0,0,2,0,2,0.2857142857142857,1,0.0,0,0,0,0,0,0,0,2,0,0,2,1
4783,173511,AhSpjmDGb1sSCvDYt3Ot7jjy0f3gxRE7,SpATywNh6bZuzm8s1ceuBUnMUAeoAHHw,9,12,7,0,3,1,9,2,34,4.857142857142857,2,0.0,0,7,0,3,12,1,0,9,2,10,24,1
4784,173512,6bfN4bZg88fPQ84WPMXzkUepeo1lqShn,SpATywNh6bZuzm8s1ceuBUnMUAeoAHHw,18,11,9,10,6,1,4,0,41,5.857142857142857,1,0.0,0,9,9,6,11,1,1,4,0,24,17,1
4785,173522,3g8DXQOSCHdJiP6LWe15l41X630A24i1,SpATywNh6bZuzm8s1ceuBUnMUAeoAHHw,1,0,0,0,0,0,1,0,1,0.14285714285714285,1,0.0,0,0,0,0,0,0,0,1,0,0,1,1
4786,173530,Zf1Jc5QcquhjoJHRxG4pap7I4hzRTYJR,A3fsA9Zfv1X2fVEQhTw51lKENdNrEqT3,7,3,2,0,2,0,2,0,9,1.2857142857142858,1,0.0,0,2,0,2,3,0,0,2,0,4,5,1
4787,173535,uZJ608ZEkxlVFGqNKhsCeDZLWUbA4PD1,SpATywNh6bZuzm8s1ceuBUnMUAeoAHHw,6,4,1,0,1,0,2,0,8,1.1428571428571428,1,0.0,0,1,0,1,4,0,0,2,0,2,6,1
4788,173548,4FxJMUgmuz0VWA8d9le3ZfFA82TMBA1F,SpATywNh6bZuzm8s1ceuBUnMUAeoAHHw,2,0,0,0,0,0,3,0,3,0.42857142857142855,1,0.0,0,0,0,0,0,0,0,3,0,0,3,1
4789,173567,ikPOJW9YXh94C3mCvABDqiGTiH3LcmdS,SpATywNh6bZuzm8s1ceuBUnMUAeoAHHw,7,4,1,0,0,0,3,0,8,1.1428571428571428,1,0.0,0,1,0,0,4,0,0,3,0,1,7,1
4790,173571,G8jKS2LX80mKysjSCHh84D1ShEGtlmZQ,SpATywNh6bZuzm8s1ceuBUnMUAeoAHHw,7,4,3,0,3,0,2,0,12,1.7142857142857142,1,0.0,0,3,0,3,4,0,0,2,0,6,6,1
4791,173591,qggUO4B0NhIPqMhJwgIAZM8ZaIbpr9nE,SpATywNh6bZuzm8s1ceuBUnMUAeoAHHw,4,2,1,0,1,0,1,0,5,0.7142857142857143,1,0.0,0,1,0,1,2,0,0,1,0,2,3,1
4792,173594,fPM57KFy9Z8MO9ygSzYz3vMhCvMUYCpW,SpATywNh6bZuzm8s1ceuBUnMUAeoAHHw,3,2,0,0,0,0,1,0,3,0.42857142857142855,1,0.0,0,0,0,0,2,0,0,1,0,0,3,1
4793,173599,5tgxttwTGvGdqr8cj2QgTLRxUmP4TAY4,G8EPVSXsOYB5YQWZGiz1aVq5Pgr2GrQu,7,6,4,0,0,0,1,0,11,1.5714285714285714,1,0.0,0,4,0,0,6,0,0,1,0,4,7,1
4794,173608,cVDuOruQUULBpBiSrn6neQHWcaxV13ev,SpATywNh6bZuzm8s1ceuBUnMUAeoAHHw,5,3,0,0,0,0,2,0,5,0.7142857142857143,1,0.0,0,0,0,0,3,0,0,2,0,0,5,1
4795,173619,NEbJzZEXqlwyFwC2i2g8PArymW3iyx3y,SpATywNh6bZuzm8s1ceuBUnMUAeoAHHw,10,10,1,4,0,0,1,0,16,2.2857142857142856,1,0.0,3,1,4,0,7,0,0,1,0,8,8,1
4796,173626,aEIz8d9s1BC7n4fBeFuKK0VhLVqwpGhk,SpATywNh6bZuzm8s1ceuBUnMUAeoAHHw,17,13,9,9,3,5,5,0,44,6.285714285714286,1,0.0,2,9,8,3,11,5,1,5,0,22,22,0
4797,173633,XuL8lTuXJkhtcwxnA03sTLCPIFTjXstS,bWdj2GDclj5ofokWjzoa5jAwMkxCykd6,2,0,0,0,0,0,2,0,2,0.2857142857142857,1,0.0,0,0,0,0,0,0,0,2,0,0,2,0
4798,173640,CP7mFPmxcr1zJrcc0p3DHzVha0nwF2aG,SpATywNh6bZuzm8s1ceuBUnMUAeoAHHw,1,0,0,0,0,0,1,0,1,0.14285714285714285,1,0.0,0,0,0,0,0,0,0,1,0,0,1,1
4799,173668,3HZ5DvQGYoFNduhiKa7ozq49cGyUlk4Z,SpATywNh6bZuzm8s1ceuBUnMUAeoAHHw,6,5,2,0,2,0,2,0,11,1.5714285714285714,1,0.0,0,2,0,2,5,0,0,2,0,4,7,0
4800,173683,zKbFB2XJ8gemmfPKgB0q2D34TEqFCaPJ,SpATywNh6bZuzm8s1ceuBUnMUAeoAHHw,5,5,3,0,1,0,3,0,12,1.7142857142857142,1,0.0,0,3,0,1,5,0,0,3,0,4,8,1
4801,173716,egPy9UABAfgaiori25BYfS5YDOglEmVj,A3fsA9Zfv1X2fVEQhTw51lKENdNrEqT3,2,0,0,0,0,0,3,0,3,0.42857142857142855,1,0.0,0,0,0,0,0,0,0,3,0,0,3,0
4802,173736,4c2V13oAQFO59UU1chPRZLOl7FAujTC1,SpATywNh6bZuzm8s1ceuBUnMUAeoAHHw,6,3,1,0,1,0,2,0,7,1.0,1,0.0,0,1,0,1,3,0,0,2,0,2,5,1
4803,173756,erRTxWjweQfemDfGIdFiZtJElfHYWRHc,bWdj2GDclj5ofokWjzoa5jAwMkxCykd6,7,7,4,0,1,0,1,0,13,1.8571428571428572,1,0.0,1,4,0,1,6,0,0,1,0,6,7,1
4804,173759,OO1JwGoh4BUjbVi8UpZSb7D59mBcs3nt,bWdj2GDclj5ofokWjzoa5jAwMkxCykd6,7,6,3,0,2,0,1,0,12,1.7142857142857142,1,0.0,0,3,0,2,6,0,0,1,0,5,7,1
4805,173769,V1ZkNQzruX55Th98WMMJPdYTYscmY4w6,G8EPVSXsOYB5YQWZGiz1aVq5Pgr2GrQu,4,3,1,0,0,0,2,0,6,0.8571428571428571,1,0.0,0,1,0,0,3,0,0,2,0,1,5,1
4806,173785,0fD6SAnP4saPahYnGKjue5y2gN1ArEeV,SpATywNh6bZuzm8s1ceuBUnMUAeoAHHw,5,5,0,0,0,0,1,0,6,0.8571428571428571,1,0.0,1,0,0,0,4,0,0,1,0,1,5,1
4807,173789,V49kN7knz1Exa9SGBoqDofPGVg1bZJ1X,SpATywNh6bZuzm8s1ceuBUnMUAeoAHHw,5,2,0,0,0,0,4,0,6,0.8571428571428571,1,0.0,0,0,0,0,2,0,0,4,0,0,6,1
4808,173799,4c2V13oAQFO59UU1chPRZLOl7FAujTC1,bWdj2GDclj5ofokWjzoa5jAwMkxCykd6,1,0,0,0,0,0,1,0,1,0.14285714285714285,1,0.0,0,0,0,0,0,0,0,1,0,0,1,1
4809,173800,dGPrMGXdE7T0kXaLgwTiDqQes2xGwEfE,SpATywNh6bZuzm8s1ceuBUnMUAeoAHHw,5,2,1,0,1,0,2,0,6,0.8571428571428571,1,0.0,0,1,0,1,2,0,0,2,0,2,4,1
4810,173809,5hyT5z1JULhKBFcJhS5p5DOzWWc2tHLq,RXDvfPUBYFlVdlueBFbLW0mhhAyGEqpt,4,4,0,0,0,0,2,0,6,0.8571428571428571,1,0.0,0,0,0,0,4,0,0,2,0,0,6,1
4811,173822,7OJn5p0XJ3SSGp9HZOHLtXBrnpU9Ao4g,SpATywNh6bZuzm8s1ceuBUnMUAeoAHHw,2,0,0,0,0,0,2,0,2,0.2857142857142857,1,0.0,0,0,0,0,0,0,0,2,0,0,2,1
4812,173833,XM8B0k6MFN508SQSrRkwnYc2DfmjmqwC,SpATywNh6bZuzm8s1ceuBUnMUAeoAHHw,6,5,3,0,3,0,1,0,12,1.7142857142857142,1,0.0,0,3,0,3,5,0,0,1,0,6,6,1
4813,173841,L0oAkWkSvsRVgCYEWBvSdFU8AYt2U4nO,A3fsA9Zfv1X2fVEQhTw51lKENdNrEqT3,1,0,0,0,0,0,1,0,1,0.14285714285714285,1,0.0,0,0,0,0,0,0,0,1,0,0,1,1
4814,173846,0OgHQAVhQz83ex7oEMaYHMGoui5vuRU7,A3fsA9Zfv1X2fVEQhTw51lKENdNrEqT3,1,0,0,0,0,0,1,0,1,0.14285714285714285,1,0.0,0,0,0,0,0,0,0,1,0,0,1,1
4815,173849,quIYM1jY47tlZKkC1EmJRDFcBV4a3Pzy,SpATywNh6bZuzm8s1ceuBUnMUAeoAHHw,1,0,0,0,0,0,2,0,2,0.2857142857142857,1,0.0,0,0,0,0,0,0,0,2,0,0,2,1
4816,173856,CZSUlXr6WslbpIsEEc2qwnkdO6NycdZe,G8EPVSXsOYB5YQWZGiz1aVq5Pgr2GrQu,15,21,0,6,1,1,8,0,37,5.285714285714286,3,0.0,6,0,3,1,15,1,3,8,0,10,27,0
4817,173879,8jJMgDkLCzStXvEhF0AcTzprTsXGO4BQ,SpATywNh6bZuzm8s1ceuBUnMUAeoAHHw,6,3,2,0,2,0,1,0,8,1.1428571428571428,1,0.0,0,2,0,2,3,0,0,1,0,4,4,1
4818,173885,worFKZrD9eECXAuz5EQKtbbV0K7MG3Jl,bWdj2GDclj5ofokWjzoa5jAwMkxCykd6,7,3,2,0,2,0,2,0,9,1.2857142857142858,1,0.0,0,2,0,2,3,0,0,2,0,4,5,1
4819,173898,ufiE5JBFPedCyqKTJCAri6PUpUEK2djS,A3fsA9Zfv1X2fVEQhTw51lKENdNrEqT3,9,4,3,0,3,0,2,0,12,1.7142857142857142,1,0.0,0,3,0,3,4,0,0,2,0,6,6,1
4820,173920,5meVJnfzVUZ3TsgkTSkPAZOA5DSRKfSE,SpATywNh6bZuzm8s1ceuBUnMUAeoAHHw,6,3,1,0,1,0,3,0,8,1.1428571428571428,3,0.0,0,1,0,1,3,0,0,3,0,2,6,1
4821,173927,2jcDulxQhwaZp6ERelJB4WRzpPoEb0N3,G8EPVSXsOYB5YQWZGiz1aVq5Pgr2GrQu,6,6,3,0,1,0,2,0,12,1.7142857142857142,2,0.0,0,3,0,1,6,0,0,2,0,4,8,1
4822,173940,f05G8U1bqnSeHR5uQ0LJ86uC0GQPzhAD,A3fsA9Zfv1X2fVEQhTw51lKENdNrEqT3,8,3,2,0,2,0,3,1,11,1.5714285714285714,1,0.0,0,2,0,2,3,0,0,3,1,4,7,1
4823,173941,wyGIkmkgUJs3OEbZedPOFJN1j5K0BFAm,SpATywNh6bZuzm8s1ceuBUnMUAeoAHHw,7,3,2,0,2,0,2,0,9,1.2857142857142858,1,0.0,0,2,0,2,3,0,0,2,0,4,5,1
4824,173954,wLc4w0avBex1xIgZCkms6IVr5BNBkA7D,SpATywNh6bZuzm8s1ceuBUnMUAeoAHHw,2,0,0,0,0,0,3,0,3,0.42857142857142855,1,0.0,0,0,0,0,0,0,0,3,0,0,3,1
4825,174004,GEhSrQJnDGIPtxSV48fF8cpqKVHJt54S,RXDvfPUBYFlVdlueBFbLW0mhhAyGEqpt,1,0,0,0,0,0,1,0,1,0.14285714285714285,1,0.0,0,0,0,0,0,0,0,1,0,0,1,1
4826,174006,GEhSrQJnDGIPtxSV48fF8cpqKVHJt54S,G8EPVSXsOYB5YQWZGiz1aVq5Pgr2GrQu,1,0,0,0,0,0,2,0,2,0.2857142857142857,1,0.0,0,0,0,0,0,0,0,2,0,0,2,1
4827,174007,ylJgBhkBjfNNAcgSF9OKq7fmYB5lgYf4,G8EPVSXsOYB5YQWZGiz1aVq5Pgr2GrQu,15,16,0,6,2,1,9,1,35,5.0,1,0.0,8,0,3,2,8,1,3,9,1,13,22,1
4828,174023,qCRa9Z4oZ6HdXxtc9b3V1X8DNEfTKusC,SpATywNh6bZuzm8s1ceuBUnMUAeoAHHw,9,8,5,0,0,0,6,1,20,2.857142857142857,1,0.0,1,5,0,0,7,0,0,6,1,6,14,1
4829,174033,5meVJnfzVUZ3TsgkTSkPAZOA5DSRKfSE,G8EPVSXsOYB5YQWZGiz1aVq5Pgr2GrQu,16,13,3,28,3,0,4,0,51,7.285714285714286,3,0.0,1,3,25,3,12,0,3,4,0,32,19,1
4830,174069,kj5o7wMZl1s4q0cggcmipnm7O7L6g4Ps,A3fsA9Zfv1X2fVEQhTw51lKENdNrEqT3,4,2,1,0,1,0,1,0,5,0.7142857142857143,1,0.0,0,1,0,1,2,0,0,1,0,2,3,1
4831,174113,exn3Chqg3cdAcaAWKVncMLTyArQT03uh,SpATywNh6bZuzm8s1ceuBUnMUAeoAHHw,1,0,0,0,0,0,1,0,1,0.14285714285714285,1,0.0,0,0,0,0,0,0,0,1,0,0,1,1
4832,174123,vAGOe6e2RHZZ1EaDZrX2SIPJIAyfl840,SpATywNh6bZuzm8s1ceuBUnMUAeoAHHw,14,15,7,14,4,1,2,0,43,6.142857142857143,1,0.0,7,7,14,4,8,1,0,2,0,32,11,1
4833,174132,JCoigkJDdJ3HsiIMjInfwYucYJL9vwo0,SpATywNh6bZuzm8s1ceuBUnMUAeoAHHw,3,0,0,0,0,3,2,0,5,0.7142857142857143,1,0.0,0,0,0,0,0,3,0,2,0,0,5,1
4834,174137,bpg5GXp9dzB6QmyT9ugqcjAogW2XrJ6V,A3fsA9Zfv1X2fVEQhTw51lKENdNrEqT3,13,21,5,0,3,1,11,1,42,6.0,2,0.0,3,5,0,3,18,1,0,11,1,11,31,1
4835,174145,hkyduknaDdkH1HJr9UkRJTFi9zraFQAD,bWdj2GDclj5ofokWjzoa5jAwMkxCykd6,1,0,0,0,0,0,1,0,1,0.14285714285714285,1,0.0,0,0,0,0,0,0,0,1,0,0,1,1
4836,174164,osRDAcCAd45utdgmq4pkwlsU7g3nJpqb,SpATywNh6bZuzm8s1ceuBUnMUAeoAHHw,9,5,3,0,1,1,8,1,19,2.7142857142857144,1,0.0,0,3,0,1,5,1,0,8,1,4,15,1
4837,174176,w0gcF7HyzsXAZFiicWTJytmCnNq4PSCG,bWdj2GDclj5ofokWjzoa5jAwMkxCykd6,2,0,0,0,0,0,2,0,2,0.2857142857142857,1,0.0,0,0,0,0,0,0,0,2,0,0,2,0
4838,174180,IcbiyGfugViHKrRGeKalQAZxzQcRgoyB,A3fsA9Zfv1X2fVEQhTw51lKENdNrEqT3,21,24,12,4,9,0,2,0,51,7.285714285714286,2,0.0,0,12,3,9,24,0,1,2,0,24,27,0
4839,174191,nzlGlMNKXi0UdFirNX3xHB3tsyudhSZw,bWdj2GDclj5ofokWjzoa5jAwMkxCykd6,3,2,0,0,0,0,2,0,4,0.5714285714285714,1,0.0,0,0,0,0,2,0,0,2,0,0,4,1
4840,174215,nzlGlMNKXi0UdFirNX3xHB3tsyudhSZw,A3fsA9Zfv1X2fVEQhTw51lKENdNrEqT3,2,0,0,0,0,0,2,0,2,0.2857142857142857,1,0.0,0,0,0,0,0,0,0,2,0,0,2,1
4841,174216,6CvCYVrFGBiuqZvZsIm2rGLzCSub3t09,SpATywNh6bZuzm8s1ceuBUnMUAeoAHHw,1,0,0,0,0,0,1,0,1,0.14285714285714285,1,0.0,0,0,0,0,0,0,0,1,0,0,1,0
4842,174245,AUQbcN6sP8jOc3r7pDcomR6R8baoxLvG,A3fsA9Zfv1X2fVEQhTw51lKENdNrEqT3,1,0,0,0,0,0,1,0,1,0.14285714285714285,1,0.0,0,0,0,0,0,0,0,1,0,0,1,1
4843,174261,9D8Fr85Y0xJSTSvXENunTRQkQQzpKKhe,A3fsA9Zfv1X2fVEQhTw51lKENdNrEqT3,2,0,0,0,0,3,1,0,4,0.5714285714285714,1,0.0,0,0,0,0,0,3,0,1,0,0,4,1
4844,174270,JBAytsWAbTeV6GWhSZsHWNpJgF2JgbBV,SpATywNh6bZuzm8s1ceuBUnMUAeoAHHw,10,10,5,0,3,0,4,0,22,3.142857142857143,1,0.0,0,5,0,3,10,0,0,4,0,8,14,1
4845,174330,J3VXT3AGxePcqOmM7ZzWzkqh6USRsZv2,bWdj2GDclj5ofokWjzoa5jAwMkxCykd6,1,0,0,0,0,0,1,0,1,0.14285714285714285,1,0.0,0,0,0,0,0,0,0,1,0,0,1,1
4846,174333,J3VXT3AGxePcqOmM7ZzWzkqh6USRsZv2,A3fsA9Zfv1X2fVEQhTw51lKENdNrEqT3,1,0,0,0,0,0,1,0,1,0.14285714285714285,1,0.0,0,0,0,0,0,0,0,1,0,0,1,1
4847,174343,z5b37rtZXpcAYDG2omaxcs76JrGc20dV,SpATywNh6bZuzm8s1ceuBUnMUAeoAHHw,14,16,11,0,7,0,4,0,38,5.428571428571429,1,0.0,0,11,0,7,16,0,0,4,0,18,20,0
4848,174366,NiXPZUmEILmWUPwXexYxtHvaIL7QdjCQ,G8EPVSXsOYB5YQWZGiz1aVq5Pgr2GrQu,1,0,0,0,0,0,1,0,1,0.14285714285714285,1,0.0,0,0,0,0,0,0,0,1,0,0,1,1
4849,174374,kv6R7WjolUetaoWMs79hGLWsktu3yDdz,A3fsA9Zfv1X2fVEQhTw51lKENdNrEqT3,6,3,1,0,1,0,2,0,7,1.0,1,0.0,0,1,0,1,3,0,0,2,0,2,5,1
4850,174379,BeoWdDFNsVFqWVq3B4qjYh8vNjNTgwSB,A3fsA9Zfv1X2fVEQhTw51lKENdNrEqT3,3,5,3,0,0,0,2,0,10,1.4285714285714286,1,0.0,0,3,0,0,5,0,0,2,0,3,7,1
4851,174441,TVb48KNX44nTfeYliD6K0aUmcz1Uhqk3,SpATywNh6bZuzm8s1ceuBUnMUAeoAHHw,1,0,0,0,0,0,3,0,3,0.42857142857142855,1,0.0,0,0,0,0,0,0,0,3,0,0,3,1
4852,174476,2N9sOZSDFqgItMU0I0RAvak4oCcmSCqn,SpATywNh6bZuzm8s1ceuBUnMUAeoAHHw,1,0,0,0,0,0,1,0,1,0.14285714285714285,1,0.0,0,0,0,0,0,0,0,1,0,0,1,1
4853,174511,4JCvqkgGduxKKeDEkCNb6gSmycI4iKkL,SpATywNh6bZuzm8s1ceuBUnMUAeoAHHw,6,3,2,0,1,0,2,0,8,1.1428571428571428,1,0.0,0,2,0,1,3,0,0,2,0,3,5,1
4854,174524,OHjVywgSVBuE3jor7Q0ui9J2rATPYj5o,bWdj2GDclj5ofokWjzoa5jAwMkxCykd6,8,3,2,0,2,0,5,0,12,1.7142857142857142,1,0.0,0,2,0,2,3,0,0,5,0,4,8,1
4855,174526,YGWpaBK18BI7gxW0S5kJOHKnKUXsGFtx,SpATywNh6bZuzm8s1ceuBUnMUAeoAHHw,1,0,0,0,0,0,1,0,1,0.14285714285714285,1,0.0,0,0,0,0,0,0,0,1,0,0,1,1
4856,174562,wtDZ1vT1vZnNtf66B6E3homHnmEWYVrg,RXDvfPUBYFlVdlueBFbLW0mhhAyGEqpt,9,6,0,0,0,0,4,2,12,1.7142857142857142,1,0.0,0,0,0,0,6,0,0,4,2,0,12,1
4857,174588,GvWLI1Mjpde6Jh0s8HrsDR9KjfiyAndZ,SpATywNh6bZuzm8s1ceuBUnMUAeoAHHw,1,0,0,0,0,0,1,0,1,0.14285714285714285,1,0.0,0,0,0,0,0,0,0,1,0,0,1,1
4858,174599,zbOrtc172Sp0ZiF8CTU6kMNb51nYxkNM,G8EPVSXsOYB5YQWZGiz1aVq5Pgr2GrQu,7,3,2,0,2,0,2,0,9,1.2857142857142858,1,0.0,0,2,0,2,3,0,0,2,0,4,5,1
4859,174621,egEAM55ohFZCeKZbLS4kJXezxBBDUuZO,SpATywNh6bZuzm8s1ceuBUnMUAeoAHHw,5,2,1,0,1,0,2,0,6,0.8571428571428571,1,0.0,0,1,0,1,2,0,0,2,0,2,4,1
4860,174624,oGK3c8nk6Ftl3V2u1zOvslszD4LDLr3w,SpATywNh6bZuzm8s1ceuBUnMUAeoAHHw,6,6,5,0,2,0,2,0,15,2.142857142857143,1,0.0,0,5,0,2,6,0,0,2,0,7,8,1
4861,174627,egEAM55ohFZCeKZbLS4kJXezxBBDUuZO,G8EPVSXsOYB5YQWZGiz1aVq5Pgr2GrQu,5,2,1,0,1,0,2,0,6,0.8571428571428571,1,0.0,0,1,0,1,2,0,0,2,0,2,4,1
4862,174642,AuxkP8NAszvIKyEBwpG0mQcLLw7Eoojr,SpATywNh6bZuzm8s1ceuBUnMUAeoAHHw,6,4,1,0,1,0,2,0,8,1.1428571428571428,1,0.0,0,1,0,1,4,0,0,2,0,2,6,1
4863,174652,mKdNKRnKsY7oY3LUCJFqlU9FBtiBixdP,SpATywNh6bZuzm8s1ceuBUnMUAeoAHHw,2,0,0,0,0,0,3,0,3,0.42857142857142855,1,0.0,0,0,0,0,0,0,0,3,0,0,3,1
4864,174664,6FBBfTPa9rAGe2i9z04q5KK2WXVduwvy,bWdj2GDclj5ofokWjzoa5jAwMkxCykd6,5,3,2,0,2,0,2,0,9,1.2857142857142858,1,0.0,0,2,0,2,3,0,0,2,0,4,5,1
4865,174670,Nt2MuvKq8ehhC9cDQZ9wTGuVcTn0ishD,bWdj2GDclj5ofokWjzoa5jAwMkxCykd6,1,0,0,0,0,0,1,0,1,0.14285714285714285,1,0.0,0,0,0,0,0,0,0,1,0,0,1,1
4866,174671,oseHKim5ugRciFh8lXIQ174blllPPfFO,G8EPVSXsOYB5YQWZGiz1aVq5Pgr2GrQu,6,5,2,0,1,0,2,0,10,1.4285714285714286,1,0.0,0,2,0,1,5,0,0,2,0,3,7,1
4867,174690,DsHBF70w6SbplBHmPm6nRUC7pSdaJJWa,G8EPVSXsOYB5YQWZGiz1aVq5Pgr2GrQu,10,6,1,0,1,0,3,0,11,1.5714285714285714,1,0.0,0,1,0,1,6,0,0,3,0,2,9,1
4868,174691,5CEPXEXe8kyZX8bu6GUTNCOjuQHWI7O6,G8EPVSXsOYB5YQWZGiz1aVq5Pgr2GrQu,11,15,1,10,0,1,3,0,30,4.285714285714286,1,0.0,9,1,7,0,6,1,3,3,0,17,13,1
4869,174695,mu7Zdr1ChN6xNMWE8Otd7Si7TQhm7pEQ,bWdj2GDclj5ofokWjzoa5jAwMkxCykd6,1,0,0,0,0,0,1,0,1,0.14285714285714285,1,0.0,0,0,0,0,0,0,0,1,0,0,1,1
4870,174696,5OhdzLluLI4b0UetZ6QtwaKcHtelD4GM,SpATywNh6bZuzm8s1ceuBUnMUAeoAHHw,1,0,0,0,0,0,1,0,1,0.14285714285714285,1,0.0,0,0,0,0,0,0,0,1,0,0,1,1
4871,174705,Ec3rYw74ZqWh1F7dxiEcLU29Nc2ci1fM,SpATywNh6bZuzm8s1ceuBUnMUAeoAHHw,1,0,0,0,0,0,1,0,1,0.14285714285714285,1,0.0,0,0,0,0,0,0,0,1,0,0,1,1
4872,174721,ogurveh5dgwQ7omkU0IctcIseCFtiniL,bWdj2GDclj5ofokWjzoa5jAwMkxCykd6,1,0,0,0,0,0,1,0,1,0.14285714285714285,1,0.0,0,0,0,0,0,0,0,1,0,0,1,0
4873,174722,ynJJFwajTtaKh2c9i2j2wRxuEmNuGHmW,SpATywNh6bZuzm8s1ceuBUnMUAeoAHHw,11,10,1,0,1,0,3,0,15,2.142857142857143,1,0.0,0,1,0,1,10,0,0,3,0,2,13,1
4874,174743,RGm3JAeEXLRP4KOsIq5BNnrMmXFgjKxb,SpATywNh6bZuzm8s1ceuBUnMUAeoAHHw,6,2,1,0,1,0,6,0,10,1.4285714285714286,1,0.0,0,1,0,1,2,0,0,6,0,2,8,1
4875,174771,wKNO0Jje7WXvAVQ9yfigFflnCrR4q8AL,RXDvfPUBYFlVdlueBFbLW0mhhAyGEqpt,2,0,0,0,0,0,2,0,2,0.2857142857142857,1,0.0,0,0,0,0,0,0,0,2,0,0,2,1
4876,174774,gPm1W1ZGaxTMbwnt8Qfxv6TCL5SZrMk2,SpATywNh6bZuzm8s1ceuBUnMUAeoAHHw,5,3,1,0,1,0,2,0,7,1.0,1,0.0,0,1,0,1,3,0,0,2,0,2,5,1
4877,174803,t0EDN5m0sWGzS7LPSyhC6BROmEBzl1eB,SpATywNh6bZuzm8s1ceuBUnMUAeoAHHw,7,3,2,0,2,0,2,0,9,1.2857142857142858,1,0.0,0,2,0,2,3,0,0,2,0,4,5,1
4878,174807,UqNrOaSixV1onFxLeaR8LpJ04uyM9vCP,SpATywNh6bZuzm8s1ceuBUnMUAeoAHHw,6,5,2,0,1,0,2,0,10,1.4285714285714286,1,0.0,2,2,0,1,3,0,0,2,0,5,5,1
4879,174815,EUIAvqEpYGuf3oElkvmsxEBDGD0USQRc,SpATywNh6bZuzm8s1ceuBUnMUAeoAHHw,8,2,1,0,1,1,5,1,11,1.5714285714285714,1,0.0,0,1,0,1,2,1,0,5,1,2,9,1
4880,174834,jlfxlhUtD2UxnrEYxTWNdi2LKtu0owFx,SpATywNh6bZuzm8s1ceuBUnMUAeoAHHw,12,12,1,0,1,0,5,0,19,2.7142857142857144,1,0.0,0,1,0,1,12,0,0,5,0,2,17,1
4881,174850,JsUvqozri9AItThk54BBjEwYIqDey9JK,SpATywNh6bZuzm8s1ceuBUnMUAeoAHHw,18,48,14,14,5,0,3,0,84,12.0,1,0.0,6,14,14,5,42,0,0,3,0,39,45,1
4882,174851,wlfhNc0EqwNzSbWGuR5Gw22PX4idrOB9,bWdj2GDclj5ofokWjzoa5jAwMkxCykd6,6,4,3,0,2,0,2,0,11,1.5714285714285714,1,0.0,0,3,0,2,4,0,0,2,0,5,6,1
4883,174852,B4ycicxBkvAvNmF15lIWWxxW3Xn9MHa9,SpATywNh6bZuzm8s1ceuBUnMUAeoAHHw,1,0,0,0,0,0,1,0,1,0.14285714285714285,1,0.0,0,0,0,0,0,0,0,1,0,0,1,1
4884,174889,JsUvqozri9AItThk54BBjEwYIqDey9JK,bWdj2GDclj5ofokWjzoa5jAwMkxCykd6,1,0,0,0,0,0,1,0,1,0.14285714285714285,1,0.0,0,0,0,0,0,0,0,1,0,0,1,1
4885,174921,MkluYfJDefHhcRPY3QsRGiWxg2BDcm18,G8EPVSXsOYB5YQWZGiz1aVq5Pgr2GrQu,1,0,0,0,0,0,1,0,1,0.14285714285714285,1,0.0,0,0,0,0,0,0,0,1,0,0,1,1
4886,174933,OAGaZXcjJISx6VWaj2xIjx8JDYNnZK9L,SpATywNh6bZuzm8s1ceuBUnMUAeoAHHw,6,3,1,0,1,0,3,1,9,1.2857142857142858,1,0.0,0,1,0,1,3,0,0,3,1,2,7,1
4887,174955,FdYyZ3eUFT2W1b2FuK1FqAPaILYLChJS,SpATywNh6bZuzm8s1ceuBUnMUAeoAHHw,9,6,1,0,0,0,3,2,12,1.7142857142857142,1,0.0,0,1,0,0,6,0,0,3,2,1,11,0
4888,174972,3e3NS2FF76Q2Wd0Q299lzVRy95TZUP9V,SpATywNh6bZuzm8s1ceuBUnMUAeoAHHw,4,2,0,0,0,0,3,0,5,0.7142857142857143,1,0.0,0,0,0,0,2,0,0,3,0,0,5,1
4889,174973,igeK6rUQT7Ehyj7yY5oAEj8DvOITiuBO,G8EPVSXsOYB5YQWZGiz1aVq5Pgr2GrQu,19,11,9,32,6,0,2,0,60,8.571428571428571,1,0.0,0,9,27,6,11,0,5,2,0,42,18,1
4890,174983,ZzaZO5citAcoeYBQ4xnco2bMgq0deP0c,bWdj2GDclj5ofokWjzoa5jAwMkxCykd6,14,14,0,12,2,6,7,1,42,6.0,2,0.0,5,0,10,2,9,6,2,7,1,17,25,0
4891,174987,U9FricROMjKQqr8IqFFHC3G0wWxulVGt,G8EPVSXsOYB5YQWZGiz1aVq5Pgr2GrQu,4,6,1,0,1,0,2,0,10,1.4285714285714286,1,0.0,2,1,0,1,4,0,0,2,0,4,6,1
4892,175011,fC8iLtYIOHY1gQcgztWp75xXkE8muKRF,bWdj2GDclj5ofokWjzoa5jAwMkxCykd6,6,5,2,0,1,0,3,0,11,1.5714285714285714,1,0.0,1,2,0,1,4,0,0,3,0,4,7,1
4893,175031,fiQPKilJkIFWShuteKFoAKrsoRjAoTQq,G8EPVSXsOYB5YQWZGiz1aVq5Pgr2GrQu,5,5,2,0,1,1,1,0,10,1.4285714285714286,1,0.0,0,2,0,1,5,1,0,1,0,3,7,1
4894,175032,7OUEidh05JWByOEFcemhEZFfVFKOEreA,SpATywNh6bZuzm8s1ceuBUnMUAeoAHHw,7,4,2,0,2,0,2,0,10,1.4285714285714286,1,0.0,0,2,0,2,4,0,0,2,0,4,6,1
4895,175034,QXR5sUbv4S12yRWxM4AzFUAlm7Vhd4VU,bWdj2GDclj5ofokWjzoa5jAwMkxCykd6,7,2,1,0,1,0,6,1,11,1.5714285714285714,1,0.0,0,1,0,1,2,0,0,6,1,2,9,1
4896,175038,LeinRShMpys6hI3Pst69nKDdXo0lcJFw,bWdj2GDclj5ofokWjzoa5jAwMkxCykd6,3,2,0,0,0,0,1,0,3,0.42857142857142855,1,0.0,0,0,0,0,2,0,0,1,0,0,3,1
4897,175042,fN9yVRde7R2H7fN2gH8pJh2bfcNVmJQE,SpATywNh6bZuzm8s1ceuBUnMUAeoAHHw,15,16,6,13,2,1,5,1,44,6.285714285714286,1,0.0,9,6,11,2,7,1,2,5,1,28,16,1
4898,175054,WoXtpP4H4ghgkRBv3UuiyrHP7GFAl55y,SpATywNh6bZuzm8s1ceuBUnMUAeoAHHw,1,0,0,0,0,0,1,0,1,0.14285714285714285,1,0.0,0,0,0,0,0,0,0,1,0,0,1,1
4899,175059,WoXtpP4H4ghgkRBv3UuiyrHP7GFAl55y,RXDvfPUBYFlVdlueBFbLW0mhhAyGEqpt,1,0,0,0,0,0,1,0,1,0.14285714285714285,1,0.0,0,0,0,0,0,0,0,1,0,0,1,1
4900,175080,04NERqmo4Pna5vlN4nEAbOXFR0ZTnfBC,RXDvfPUBYFlVdlueBFbLW0mhhAyGEqpt,1,0,0,0,0,0,0,1,1,0.14285714285714285,1,0.0,0,0,0,0,0,0,0,0,1,0,1,1
4901,175088,tRdhN0lgigOD57KMBTj72ZVM1o7s8RGj,SpATywNh6bZuzm8s1ceuBUnMUAeoAHHw,3,0,0,0,0,1,2,1,4,0.5714285714285714,1,0.0,0,0,0,0,0,1,0,2,1,0,4,1
4902,175089,BCJye2AaALRUT5f6ppYoCiYPMviVlBsr,G8EPVSXsOYB5YQWZGiz1aVq5Pgr2GrQu,1,0,0,0,0,0,1,0,1,0.14285714285714285,1,0.0,0,0,0,0,0,0,0,1,0,0,1,1
4903,175094,8udxV2CUMzjrYKDDJj8ojQtJ8oHj3KH6,SpATywNh6bZuzm8s1ceuBUnMUAeoAHHw,1,0,0,0,0,0,1,0,1,0.14285714285714285,1,0.0,0,0,0,0,0,0,0,1,0,0,1,1
4904,175096,wqGS9CBgLL8X8ANSg0Bc9uExUh5JuoRs,SpATywNh6bZuzm8s1ceuBUnMUAeoAHHw,6,4,1,0,1,1,2,0,9,1.2857142857142858,1,0.0,0,1,0,1,4,1,0,2,0,2,7,1
4905,175099,YaVHU5tTcyyfMEQ1RbrZTjEqZdgwcEOg,SpATywNh6bZuzm8s1ceuBUnMUAeoAHHw,1,0,0,0,0,0,1,0,1,0.14285714285714285,1,0.0,0,0,0,0,0,0,0,1,0,0,1,1
4906,175102,9quScdvVngFePST1NL7WzZK7VxMmTv5I,SpATywNh6bZuzm8s1ceuBUnMUAeoAHHw,2,0,0,0,0,0,2,0,2,0.2857142857142857,1,0.0,0,0,0,0,0,0,0,2,0,0,2,1
4907,175103,GqIgVQOxdNB1N6Xk3EJGvsEMXjZzOyVC,RXDvfPUBYFlVdlueBFbLW0mhhAyGEqpt,1,0,0,0,0,0,1,0,1,0.14285714285714285,1,0.0,0,0,0,0,0,0,0,1,0,0,1,1
4908,175109,cKCzrCCCXe9nkBgWepq9AEXje7SITRTz,SpATywNh6bZuzm8s1ceuBUnMUAeoAHHw,1,0,0,0,0,0,1,0,1,0.14285714285714285,1,0.0,0,0,0,0,0,0,0,1,0,0,1,1
4909,175119,EssEs0A6tGxDo6Ay7pdYrTC6BG7PsXvp,SpATywNh6bZuzm8s1ceuBUnMUAeoAHHw,3,2,1,0,0,0,1,0,4,0.5714285714285714,1,0.0,0,1,0,0,2,0,0,1,0,1,3,1
4910,175124,bI8WLmS7QAEP1Zf4KEJ36LOr2fpYMzKz,SpATywNh6bZuzm8s1ceuBUnMUAeoAHHw,1,0,0,0,0,0,1,0,1,0.14285714285714285,1,0.0,0,0,0,0,0,0,0,1,0,0,1,1
4911,175146,JJM4kJdvA7b7ijrHBmkFLiNbnfS1jEmD,bWdj2GDclj5ofokWjzoa5jAwMkxCykd6,16,13,6,84,5,0,7,0,115,16.428571428571427,1,0.0,7,6,80,5,6,0,4,7,0,98,17,1
4912,175161,rgXYdeKsNCNQdUbzf1eDuMPLA1J24DWk,G8EPVSXsOYB5YQWZGiz1aVq5Pgr2GrQu,6,3,2,0,1,0,2,0,8,1.1428571428571428,1,0.0,0,2,0,1,3,0,0,2,0,3,5,1
4913,175167,o9SCOAY5nuSxaVorNF1mq3E0AGKQbCox,SpATywNh6bZuzm8s1ceuBUnMUAeoAHHw,15,17,0,4,1,7,3,0,32,4.571428571428571,1,0.0,6,0,3,1,11,7,1,3,0,10,22,1
4914,175169,lRD6FNYJFilie5IwmFYNqrJax7QPJsdZ,bWdj2GDclj5ofokWjzoa5jAwMkxCykd6,6,2,1,0,1,3,5,0,12,1.7142857142857142,1,0.0,0,1,0,1,2,3,0,5,0,2,10,1
4915,175176,wKRwl5IweKiDuBtEeNntISPadPzFvRK2,SpATywNh6bZuzm8s1ceuBUnMUAeoAHHw,4,2,1,0,0,0,2,0,5,0.7142857142857143,1,0.0,0,1,0,0,2,0,0,2,0,1,4,1
4916,175187,bF4ZkA0Htjy5dPXooPjuHY2mhd8vbWYM,bWdj2GDclj5ofokWjzoa5jAwMkxCykd6,4,3,2,0,2,0,1,0,8,1.1428571428571428,1,0.0,0,2,0,2,3,0,0,1,0,4,4,1
4917,175193,8RK6HQkv51lSsSE1n9EptQjyHrkMwfO0,G8EPVSXsOYB5YQWZGiz1aVq5Pgr2GrQu,1,0,0,0,0,0,1,0,1,0.14285714285714285,1,0.0,0,0,0,0,0,0,0,1,0,0,1,1
4918,175205,ieuEScQs74mRiAwwPAhRyLP4C41miyHf,SpATywNh6bZuzm8s1ceuBUnMUAeoAHHw,4,9,4,0,0,0,1,0,14,2.0,1,0.0,0,4,0,0,9,0,0,1,0,4,10,1
4919,175264,jiPhRLmAJuGQCkjQnkZRItYBXUJwjlNA,RXDvfPUBYFlVdlueBFbLW0mhhAyGEqpt,8,2,1,0,1,1,5,1,11,1.5714285714285714,1,0.0,0,1,0,1,2,1,0,5,1,2,9,1
4920,175272,vmZoErHPHgTkQX32S5GK0CiVkZhSYU5z,bWdj2GDclj5ofokWjzoa5jAwMkxCykd6,1,0,0,0,0,0,1,0,1,0.14285714285714285,1,0.0,0,0,0,0,0,0,0,1,0,0,1,1
4921,175288,0UufwnomhqqyQLnmEpyIsrXn6C4McKHM,SpATywNh6bZuzm8s1ceuBUnMUAeoAHHw,1,0,0,0,0,0,1,0,1,0.14285714285714285,1,0.0,0,0,0,0,0,0,0,1,0,0,1,1
4922,175292,0UufwnomhqqyQLnmEpyIsrXn6C4McKHM,RXDvfPUBYFlVdlueBFbLW0mhhAyGEqpt,1,0,0,0,0,0,1,0,1,0.14285714285714285,1,0.0,0,0,0,0,0,0,0,1,0,0,1,1
4923,175293,m4eQNvYwZjYoMZYM2VsuhiDxtIFSYKWh,RXDvfPUBYFlVdlueBFbLW0mhhAyGEqpt,9,8,1,0,2,0,2,0,13,1.8571428571428572,1,0.0,3,1,0,2,5,0,0,2,0,6,7,1
4924,175305,SZHxM16r0lTBVocJi0Li5OQAgxZ4K7jz,bWdj2GDclj5ofokWjzoa5jAwMkxCykd6,1,0,0,0,0,0,1,0,1,0.14285714285714285,1,0.0,0,0,0,0,0,0,0,1,0,0,1,1
4925,175309,qAxjBZuCZJr25UpKUqhYPsfHWE6cqLNR,bWdj2GDclj5ofokWjzoa5jAwMkxCykd6,6,3,1,0,2,1,4,0,11,1.5714285714285714,1,0.0,2,1,0,2,1,1,0,4,0,5,6,1
4926,175335,7NbjM2q5TtspVGtHsqtgwdUTaXZ3QvNC,SpATywNh6bZuzm8s1ceuBUnMUAeoAHHw,7,3,1,0,0,0,4,1,9,1.2857142857142858,1,0.0,0,1,0,0,3,0,0,4,1,1,8,1
4927,175344,2uB3uMcrVV3zJUl7YzGLBsKaaqyb6VDm,bWdj2GDclj5ofokWjzoa5jAwMkxCykd6,1,0,0,0,0,0,1,0,1,0.14285714285714285,1,0.0,0,0,0,0,0,0,0,1,0,0,1,1
4928,175349,JISGCdjNZHYHcQ6XpDypgJiHQutxiO7F,bWdj2GDclj5ofokWjzoa5jAwMkxCykd6,1,0,0,0,0,0,1,0,1,0.14285714285714285,1,0.0,0,0,0,0,0,0,0,1,0,0,1,1
4929,175376,JwpnWAbXqqokshNbyxBH2QHaOUPb8wrj,SpATywNh6bZuzm8s1ceuBUnMUAeoAHHw,5,1,1,0,1,0,2,0,5,0.7142857142857143,1,0.0,0,1,0,1,1,0,0,2,0,2,3,0
4930,175382,YcbMhXf6WOxBHwzY0X9hWTypvQthAicg,SpATywNh6bZuzm8s1ceuBUnMUAeoAHHw,1,0,0,0,0,0,1,0,1,0.14285714285714285,1,0.0,0,0,0,0,0,0,0,1,0,0,1,1
4931,175390,EvySN154YDM9eHA8rncD5Y4XnKitTOWj,SpATywNh6bZuzm8s1ceuBUnMUAeoAHHw,1,0,0,0,0,0,1,0,1,0.14285714285714285,1,0.0,0,0,0,0,0,0,0,1,0,0,1,1
4932,175392,7MT1Ev8neQja0JRLlNFWlmHGJaMzca7N,SpATywNh6bZuzm8s1ceuBUnMUAeoAHHw,1,0,0,0,0,0,1,0,1,0.14285714285714285,1,0.0,0,0,0,0,0,0,0,1,0,0,1,1
4933,175393,EvySN154YDM9eHA8rncD5Y4XnKitTOWj,bWdj2GDclj5ofokWjzoa5jAwMkxCykd6,1,0,0,0,0,0,1,0,1,0.14285714285714285,1,0.0,0,0,0,0,0,0,0,1,0,0,1,1
4934,175397,MoQLSLdgc8N78DNeGEQHypzHbyf063p0,bWdj2GDclj5ofokWjzoa5jAwMkxCykd6,1,0,0,0,0,0,1,0,1,0.14285714285714285,1,0.0,0,0,0,0,0,0,0,1,0,0,1,1
4935,175417,kEoxxa2otTzPL6nc12ZeJYYFyGEjvH7q,SpATywNh6bZuzm8s1ceuBUnMUAeoAHHw,1,0,0,0,0,0,1,0,1,0.14285714285714285,1,0.0,0,0,0,0,0,0,0,1,0,0,1,1
4936,175424,qMTyC3MFcCmdQ8Eat2z9hmr6N3Nnskt1,SpATywNh6bZuzm8s1ceuBUnMUAeoAHHw,6,2,1,0,0,3,5,0,11,1.5714285714285714,1,0.0,0,1,0,0,2,3,0,5,0,1,10,1
4937,176351,WnfN1AUOAXHdbXdeEDhl2CVqkvTuIggL,fbPkOYLVPtPgIt0MxizjfFJov3JbHyAi,5,7,1,0,1,0,1,0,10,1.4285714285714286,1,0.0,0,1,0,1,7,0,0,1,0,2,8,1
4938,176352,0Tg2flbTUdD7fODqYIfpiJiK0IDdFiOP,fbPkOYLVPtPgIt0MxizjfFJov3JbHyAi,1,0,0,0,0,0,1,0,1,0.14285714285714285,1,0.0,0,0,0,0,0,0,0,1,0,0,1,1
4939,176355,KJS7r9EjJHKntMFiDb2wMANmClPA9sbb,fbPkOYLVPtPgIt0MxizjfFJov3JbHyAi,1,0,0,0,0,0,1,0,1,0.14285714285714285,1,0.0,0,0,0,0,0,0,0,1,0,0,1,1
4940,176360,KRoFm4XNv5Pgle2ZS0CeLtv9ebvwgu1y,fbPkOYLVPtPgIt0MxizjfFJov3JbHyAi,9,10,4,0,3,4,4,0,25,3.5714285714285716,1,0.0,1,4,0,3,9,4,0,4,0,8,17,1
4941,176361,BmuAMS4WfX6ydPmjIcZND4OORiH4QIrO,fbPkOYLVPtPgIt0MxizjfFJov3JbHyAi,7,3,2,0,2,0,2,0,9,1.2857142857142858,1,0.0,0,2,0,2,3,0,0,2,0,4,5,1
4942,176365,Cm2FzbnvftvXUAfd52plpEGocR1jnm3F,fbPkOYLVPtPgIt0MxizjfFJov3JbHyAi,7,4,2,0,2,0,2,0,10,1.4285714285714286,1,0.0,1,2,0,2,3,0,0,2,0,5,5,1
4943,176368,p62NLzlqSMU9iNFHUVvUYCz9yDIitTLP,fbPkOYLVPtPgIt0MxizjfFJov3JbHyAi,7,3,0,0,0,0,7,1,11,1.5714285714285714,1,0.0,0,0,0,0,3,0,0,7,1,0,11,1
4944,176370,i9CWvduTcskommMHOeHEvsItP05JGHxW,fbPkOYLVPtPgIt0MxizjfFJov3JbHyAi,1,0,0,0,0,0,2,0,2,0.2857142857142857,1,0.0,0,0,0,0,0,0,0,2,0,0,2,1
4945,176372,ScH0NQfTgHr8NVyVOwPwgUgAUDqKXQgu,fbPkOYLVPtPgIt0MxizjfFJov3JbHyAi,2,0,0,0,0,0,4,0,4,0.5714285714285714,1,0.0,0,0,0,0,0,0,0,4,0,0,4,1
4946,176384,QU5veVGVoBVElxn9NViHXdfKseQ4NUTU,7GRhBDsirIGkRZBtSMEzNTyDr2JQm4xx,25,27,16,12,14,1,2,0,72,10.285714285714286,1,0.0,10,16,7,14,17,1,5,2,0,47,25,1
4947,176401,NwyEsAPgfXRjtBVHC91OfF1dna6dk38d,7GRhBDsirIGkRZBtSMEzNTyDr2JQm4xx,19,26,11,0,9,0,4,0,50,7.142857142857143,1,0.0,0,11,0,9,26,0,0,4,0,20,30,1
4948,176427,38HaiNGogMQZ7XFJyXto2il2akhOzypw,7GRhBDsirIGkRZBtSMEzNTyDr2JQm4xx,4,3,2,0,0,0,1,0,6,0.8571428571428571,1,0.0,0,2,0,0,3,0,0,1,0,2,4,1
4949,176450,7rsrCVMWlOWL1EBL5oTIUxzrypr861Ec,7GRhBDsirIGkRZBtSMEzNTyDr2JQm4xx,22,27,11,14,8,1,2,0,63,9.0,1,0.0,14,11,7,8,13,1,7,2,0,40,23,1
4950,176472,H3iVkRV8UPZvsbvYrU1dnbX51IlHemsF,7GRhBDsirIGkRZBtSMEzNTyDr2JQm4xx,1,0,0,0,0,0,1,0,1,0.14285714285714285,1,0.0,0,0,0,0,0,0,0,1,0,0,1,1
4951,176497,TdvOfODULzKCo3CRrsWuoBlElu9vlzI6,7GRhBDsirIGkRZBtSMEzNTyDr2JQm4xx,12,6,4,0,4,0,2,0,16,2.2857142857142856,1,0.0,0,4,0,4,6,0,0,2,0,8,8,1
4952,176512,uymreEOSNmNZtilEkQpiM8TbwZcRYgYz,7GRhBDsirIGkRZBtSMEzNTyDr2JQm4xx,6,7,3,0,3,0,4,0,17,2.4285714285714284,1,0.0,0,3,0,3,7,0,0,4,0,6,11,1
4953,176530,FwNBQnrMN6SVYSed0kgql3TnqU22qpDv,7GRhBDsirIGkRZBtSMEzNTyDr2JQm4xx,11,6,5,0,5,0,2,0,18,2.5714285714285716,1,0.0,0,5,0,5,6,0,0,2,0,10,8,1
4954,176578,Vrnp33q5W6vex5c7FhvE2pEw2kHEQLPj,SpATywNh6bZuzm8s1ceuBUnMUAeoAHHw,1,0,0,0,0,0,1,0,1,0.14285714285714285,1,0.0,0,0,0,0,0,0,0,1,0,0,1,1
4955,176580,WlyNOREFyee6wG3QSx9dsILJnChCOzeS,SpATywNh6bZuzm8s1ceuBUnMUAeoAHHw,1,0,0,0,0,0,1,0,1,0.14285714285714285,1,0.0,0,0,0,0,0,0,0,1,0,0,1,1
4956,176585,WlyNOREFyee6wG3QSx9dsILJnChCOzeS,bWdj2GDclj5ofokWjzoa5jAwMkxCykd6,1,0,0,0,0,0,1,0,1,0.14285714285714285,1,0.0,0,0,0,0,0,0,0,1,0,0,1,1
4957,176586,WlyNOREFyee6wG3QSx9dsILJnChCOzeS,A3fsA9Zfv1X2fVEQhTw51lKENdNrEqT3,1,0,0,0,0,0,1,0,1,0.14285714285714285,1,0.0,0,0,0,0,0,0,0,1,0,0,1,1
4958,176615,pIooitOY4Kj1UbygmuPfxFwwpH2R7NzD,bWdj2GDclj5ofokWjzoa5jAwMkxCykd6,1,0,0,0,0,0,1,0,1,0.14285714285714285,1,0.0,0,0,0,0,0,0,0,1,0,0,1,1
4959,176631,dgs5q517os0QP00EQ3rFo0TcrFNCs1kW,SpATywNh6bZuzm8s1ceuBUnMUAeoAHHw,13,12,4,13,3,0,2,0,34,4.857142857142857,1,0.0,4,4,13,3,8,0,0,2,0,24,10,1
4960,176634,t0m1BPy97jwvYrf5NqXFqeULLwloyg62,SpATywNh6bZuzm8s1ceuBUnMUAeoAHHw,11,19,0,18,0,0,3,0,40,5.714285714285714,1,0.0,11,0,15,0,8,0,3,3,0,26,14,0
4961,176642,K7nFLJJvhJnytzTEuQJeoArapKXlhdtY,A3fsA9Zfv1X2fVEQhTw51lKENdNrEqT3,3,2,1,0,0,0,2,0,5,0.7142857142857143,1,0.0,0,1,0,0,2,0,0,2,0,1,4,1
4962,176663,wQnqFfzf7T1nceXQBoyROaQMybFqk9YC,A3fsA9Zfv1X2fVEQhTw51lKENdNrEqT3,31,16,0,62,0,0,3,0,81,11.571428571428571,1,0.0,2,0,53,0,14,0,9,3,0,55,26,1
4963,176683,lsVTRIeOvE3c9uyXSsVkOz4L2qHzzgXN,bWdj2GDclj5ofokWjzoa5jAwMkxCykd6,6,4,2,0,1,0,4,0,11,1.5714285714285714,1,0.0,0,2,0,1,4,0,0,4,0,3,8,1
4964,176693,cZxcDNlAnm0tcnrjnkTKyh2S3nRuNP2Z,SpATywNh6bZuzm8s1ceuBUnMUAeoAHHw,7,3,1,0,1,0,3,1,9,1.2857142857142858,1,0.0,0,1,0,1,3,0,0,3,1,2,7,1
4965,176694,n5TgHqozAvMVxs3uLQhdtzkk63PUtkZ4,SpATywNh6bZuzm8s1ceuBUnMUAeoAHHw,3,2,0,0,0,0,1,0,3,0.42857142857142855,1,0.0,0,0,0,0,2,0,0,1,0,0,3,1
4966,176702,ngw0H084neoLUSHjmsnAwizUxOwdmBjF,SpATywNh6bZuzm8s1ceuBUnMUAeoAHHw,7,3,2,0,2,0,2,0,9,1.2857142857142858,1,0.0,0,2,0,2,3,0,0,2,0,4,5,1
4967,176703,M3Xa5IFPEZiaLK2rAjKqcPYFncjR6IsA,SpATywNh6bZuzm8s1ceuBUnMUAeoAHHw,2,0,0,0,0,0,2,0,2,0.2857142857142857,1,0.0,0,0,0,0,0,0,0,2,0,0,2,1
4968,176709,WMHw9zFx2owqfPWjdqgQ3dXmYN0CSXui,SpATywNh6bZuzm8s1ceuBUnMUAeoAHHw,4,3,2,0,0,0,1,0,6,0.8571428571428571,1,0.0,0,2,0,0,3,0,0,1,0,2,4,1
4969,176712,r9RAlcNOEU4tSJ3VTxa7tKQ4IwaYSNfB,A3fsA9Zfv1X2fVEQhTw51lKENdNrEqT3,2,0,0,0,0,0,4,0,4,0.5714285714285714,1,0.0,0,0,0,0,0,0,0,4,0,0,4,1
4970,176734,44GafVKSjOefcGtCUMS1SAXmrzlFFSGG,SpATywNh6bZuzm8s1ceuBUnMUAeoAHHw,6,4,1,0,1,0,2,0,8,1.1428571428571428,2,0.0,0,1,0,1,4,0,0,2,0,2,6,1
4971,176771,vP6SXmTWZNLDpRliX4cZDs2mXlaBaub0,A3fsA9Zfv1X2fVEQhTw51lKENdNrEqT3,4,0,0,0,0,0,5,0,5,0.7142857142857143,1,0.0,0,0,0,0,0,0,0,5,0,0,5,1
4972,176781,V073dr3Ejc08S0Z4K4o33HIYkTog3ITe,SpATywNh6bZuzm8s1ceuBUnMUAeoAHHw,23,16,13,10,9,0,4,0,52,7.428571428571429,1,0.0,2,13,9,9,14,0,1,4,0,33,19,1
4973,176829,UGilWCcjcjXGcBN3IoOXTqqH7xZPNWuh,A3fsA9Zfv1X2fVEQhTw51lKENdNrEqT3,9,6,0,0,0,10,12,0,28,4.0,1,0.0,0,0,0,0,6,10,0,12,0,0,28,1
4974,176834,1Ud2Nlb0y9uKsOXhkhM9qhPj1Xv6ImgU,SpATywNh6bZuzm8s1ceuBUnMUAeoAHHw,2,0,0,0,0,0,3,0,3,0.42857142857142855,1,0.0,0,0,0,0,0,0,0,3,0,0,3,1
4975,176845,tkxwTpjNIcKspgIQFJ1HEHtxSp5ThNsq,A3fsA9Zfv1X2fVEQhTw51lKENdNrEqT3,16,9,7,0,6,2,2,0,26,3.7142857142857144,1,0.0,0,7,0,6,9,2,0,2,0,13,13,1
4976,176849,IqdQlZEDPmhIudkuSm1qvVaQ2dYiBuyU,SpATywNh6bZuzm8s1ceuBUnMUAeoAHHw,7,3,1,0,1,1,4,0,10,1.4285714285714286,1,0.0,0,1,0,1,3,1,0,4,0,2,8,1
4977,176862,TBj8ERKtARA6ABLjSlKdebgRJkBjpHod,A3fsA9Zfv1X2fVEQhTw51lKENdNrEqT3,2,0,0,0,0,0,2,0,2,0.2857142857142857,1,0.0,0,0,0,0,0,0,0,2,0,0,2,1
4978,176907,RVhulbNKnSbDIMoCPANZFAOa0qbIDxQt,A3fsA9Zfv1X2fVEQhTw51lKENdNrEqT3,1,0,0,0,0,0,1,0,1,0.14285714285714285,1,0.0,0,0,0,0,0,0,0,1,0,0,1,1
4979,176932,oqfmspVsCDU25zVJJu97mvH8ZAyQzgs4,SpATywNh6bZuzm8s1ceuBUnMUAeoAHHw,6,8,0,0,0,0,2,0,10,1.4285714285714286,1,0.0,0,0,0,0,8,0,0,2,0,0,10,1
4980,176945,DnNU68583OkMDFomIoumeRI68tNSmB88,SpATywNh6bZuzm8s1ceuBUnMUAeoAHHw,1,0,0,0,0,0,1,0,1,0.14285714285714285,1,0.0,0,0,0,0,0,0,0,1,0,0,1,1
4981,176950,WczGVRZMmNzgMggUe3ZQ1bOs2IuTwUWO,bWdj2GDclj5ofokWjzoa5jAwMkxCykd6,1,0,0,0,0,0,1,0,1,0.14285714285714285,1,0.0,0,0,0,0,0,0,0,1,0,0,1,1
4982,176966,SzAtQzNOap38B7fNAidQGz1HfRyu6YSS,bWdj2GDclj5ofokWjzoa5jAwMkxCykd6,5,0,0,0,0,0,5,1,6,0.8571428571428571,1,0.0,0,0,0,0,0,0,0,5,1,0,6,1
4983,176967,bgwwZSIxTFRvIry4LocWcmZ15RQwBsJD,SpATywNh6bZuzm8s1ceuBUnMUAeoAHHw,1,0,0,0,0,0,1,0,1,0.14285714285714285,1,0.0,0,0,0,0,0,0,0,1,0,0,1,1
4984,176987,5JmpnTGe6ZHNgssYgcMaiqkF3B7C3AfJ,A3fsA9Zfv1X2fVEQhTw51lKENdNrEqT3,2,0,0,0,0,0,2,0,2,0.2857142857142857,1,0.0,0,0,0,0,0,0,0,2,0,0,2,1
4985,176988,AgYA7iHpk58icD4xPuYLYI9kpuqj6y1t,A3fsA9Zfv1X2fVEQhTw51lKENdNrEqT3,10,9,5,0,2,0,6,0,22,3.142857142857143,1,0.0,2,5,0,2,7,0,0,6,0,9,13,1
4986,176989,lBPkWmGWjMVGl7rjICN5T6By1CpF3Oh1,bWdj2GDclj5ofokWjzoa5jAwMkxCykd6,4,3,2,0,2,0,1,0,8,1.1428571428571428,1,0.0,0,2,0,2,3,0,0,1,0,4,4,1
4987,177051,QTuqQxk5mfpTPo5vfXzRqFyeBm1ocbxg,bWdj2GDclj5ofokWjzoa5jAwMkxCykd6,11,5,4,0,2,4,6,1,22,3.142857142857143,1,0.0,0,4,0,2,5,4,0,6,1,6,16,1
4988,177063,me3X50gZnHqxKqokwhcjCSa6sPS8gx2x,bWdj2GDclj5ofokWjzoa5jAwMkxCykd6,4,2,1,0,1,0,1,0,5,0.7142857142857143,1,0.0,0,1,0,1,2,0,0,1,0,2,3,1
4989,177084,KGMUqHbYYqeF4kil6zUa1qpianJR3FpM,SpATywNh6bZuzm8s1ceuBUnMUAeoAHHw,3,0,0,0,0,0,2,1,3,0.42857142857142855,1,0.0,0,0,0,0,0,0,0,2,1,0,3,1
4990,177087,9G22TFSpifXf2dRYsg4E8vgkMWfro3Ct,bWdj2GDclj5ofokWjzoa5jAwMkxCykd6,4,3,1,0,0,0,1,0,5,0.7142857142857143,1,0.0,0,1,0,0,3,0,0,1,0,1,4,1
4991,177109,EPVEir3f8DxjouE65Q4kYI9YaQMxGE89,A3fsA9Zfv1X2fVEQhTw51lKENdNrEqT3,7,7,1,0,0,4,3,0,15,2.142857142857143,1,0.0,0,1,0,0,7,4,0,3,0,1,14,1
4992,177111,niznzPsNcmf0qkvKVIABVzsBAFOWmMfr,bWdj2GDclj5ofokWjzoa5jAwMkxCykd6,2,0,0,0,0,0,2,0,2,0.2857142857142857,1,0.0,0,0,0,0,0,0,0,2,0,0,2,1
4993,177114,wingMAl29ucopfiyx66jxxaUInzOOQW5,SpATywNh6bZuzm8s1ceuBUnMUAeoAHHw,24,46,14,0,9,2,9,0,80,11.428571428571429,1,0.0,4,14,0,9,42,2,0,9,0,27,53,1
4994,177140,sN7SpMjN00gTdmZynEw6AXtweTyZtD7L,A3fsA9Zfv1X2fVEQhTw51lKENdNrEqT3,7,4,2,0,1,0,4,0,11,1.5714285714285714,1,0.0,1,2,0,1,3,0,0,4,0,4,7,1
4995,177146,GHoD8AIr3r5Mp1AqZoXIC9i225P9RubE,bWdj2GDclj5ofokWjzoa5jAwMkxCykd6,5,2,1,0,1,0,2,0,6,0.8571428571428571,1,0.0,0,1,0,1,2,0,0,2,0,2,4,1
4996,177154,1quHb10fObuEEg4CZXYAqSIkbHHSbI1d,SpATywNh6bZuzm8s1ceuBUnMUAeoAHHw,1,0,0,0,0,0,1,0,1,0.14285714285714285,1,0.0,0,0,0,0,0,0,0,1,0,0,1,1
4997,177191,RzpNewewHDhOLk08WWwTdZBpVAjeuouY,SpATywNh6bZuzm8s1ceuBUnMUAeoAHHw,1,0,0,0,0,0,1,0,1,0.14285714285714285,1,0.0,0,0,0,0,0,0,0,1,0,0,1,1
4998,177194,5K1YQb6WOjDwHsAIqvYsCK3LL78wZoyl,SpATywNh6bZuzm8s1ceuBUnMUAeoAHHw,5,2,1,0,1,0,2,0,6,0.8571428571428571,1,0.0,0,1,0,1,2,0,0,2,0,2,4,1
4999,177220,3iyvvUD6yZB0z0YjGBWx9vW081IJua41,A3fsA9Zfv1X2fVEQhTw51lKENdNrEqT3,4,2,0,0,0,0,4,0,6,0.8571428571428571,1,0.0,0,0,0,0,2,0,0,4,0,0,6,0
5000,177248,VJ6kjzPollQLDbYztoyg8LEnFGMc5bZx,bWdj2GDclj5ofokWjzoa5jAwMkxCykd6,2,0,0,0,0,0,3,0,3,0.42857142857142855,1,0.0,0,0,0,0,0,0,0,3,0,0,3,0
5001,177253,LxsrJ5jQBHgpoDvJjmW7B1PIBB1B9rOy,A3fsA9Zfv1X2fVEQhTw51lKENdNrEqT3,2,0,0,0,0,0,2,0,2,0.2857142857142857,1,0.0,0,0,0,0,0,0,0,2,0,0,2,1
5002,177267,QiYah6MaRTZX43IYRVARS0cRIO6IdBSv,A3fsA9Zfv1X2fVEQhTw51lKENdNrEqT3,1,0,0,0,0,0,1,0,1,0.14285714285714285,1,0.0,0,0,0,0,0,0,0,1,0,0,1,1
5003,177287,GFHYWWeeAuj1pePvOmCpIpIQDTy4Q3Iv,A3fsA9Zfv1X2fVEQhTw51lKENdNrEqT3,1,0,0,0,0,0,1,0,1,0.14285714285714285,1,0.0,0,0,0,0,0,0,0,1,0,0,1,1
5004,177292,MCY34unG8KB7lFkmy7ruLaHeUqkrRhUd,SpATywNh6bZuzm8s1ceuBUnMUAeoAHHw,13,18,6,4,3,0,2,0,33,4.714285714285714,1,0.0,7,6,4,3,11,0,0,2,0,20,13,1
5005,177294,0xRWiMAkDSQyarQpahb5IxRgJIgg5cjl,SpATywNh6bZuzm8s1ceuBUnMUAeoAHHw,1,0,0,0,0,0,1,0,1,0.14285714285714285,1,0.0,0,0,0,0,0,0,0,1,0,0,1,1
5006,177312,Vnz3YQtaGP9Lud4eJsx4REuNf7a7Z6K7,A3fsA9Zfv1X2fVEQhTw51lKENdNrEqT3,8,6,4,0,2,0,6,0,18,2.5714285714285716,2,0.0,0,4,0,2,6,0,0,6,0,6,12,1
5007,177338,ls1F2KUi19ehHJYjRRU9ukCpIm6Mq0QX,bWdj2GDclj5ofokWjzoa5jAwMkxCykd6,7,11,3,0,2,2,8,1,27,3.857142857142857,1,0.0,3,3,0,2,8,2,0,8,1,8,19,1
5008,177342,ukV83h2gop6RgQ4r0p0CZA73Nn6q15H2,SpATywNh6bZuzm8s1ceuBUnMUAeoAHHw,12,10,5,8,2,0,1,0,26,3.7142857142857144,1,0.0,4,5,8,2,6,0,0,1,0,19,7,1
5009,177357,bvUZAD2pQ0JG1rSj4fd4oSXQV1yLwXI1,bWdj2GDclj5ofokWjzoa5jAwMkxCykd6,1,0,0,0,0,0,1,0,1,0.14285714285714285,1,0.0,0,0,0,0,0,0,0,1,0,0,1,1
5010,177359,rrdUVc7PxY1K5CKjH5FZPZeykLw0CqkU,SpATywNh6bZuzm8s1ceuBUnMUAeoAHHw,5,3,1,0,1,0,6,0,11,1.5714285714285714,1,0.0,0,1,0,1,3,0,0,6,0,2,9,1
5011,177362,dGWL5aQxrmUKcXwkRJNonE7KRjTXcSnx,SpATywNh6bZuzm8s1ceuBUnMUAeoAHHw,4,3,0,0,0,0,2,0,5,0.7142857142857143,1,0.0,0,0,0,0,3,0,0,2,0,0,5,0
5012,177411,P5T4sFdQt6aGZ3iihRY0M991VNl2H2j2,SpATywNh6bZuzm8s1ceuBUnMUAeoAHHw,7,4,1,0,1,3,5,0,14,2.0,1,0.0,1,1,0,1,3,3,0,5,0,3,11,1
5013,177441,uUdFMnM36oHfhjmWTDXFNgr7FNTKYZUv,A3fsA9Zfv1X2fVEQhTw51lKENdNrEqT3,5,2,1,0,1,0,2,0,6,0.8571428571428571,1,0.0,0,1,0,1,2,0,0,2,0,2,4,0
5014,177447,ONzOWoX8tSfcZlukia6Q8bk2oPYRBqMN,bWdj2GDclj5ofokWjzoa5jAwMkxCykd6,1,0,0,0,0,0,1,0,1,0.14285714285714285,1,0.0,0,0,0,0,0,0,0,1,0,0,1,1
5015,177493,K3eaSd5rYP9Gkimldqt40pigYQrGeLsH,A3fsA9Zfv1X2fVEQhTw51lKENdNrEqT3,15,18,11,0,2,0,3,0,34,4.857142857142857,1,0.0,0,11,0,2,18,0,0,3,0,13,21,1
5016,177506,TL1aA8ITe7VP42GX52yE5M5UsjXNCOS3,SpATywNh6bZuzm8s1ceuBUnMUAeoAHHw,4,3,2,0,0,0,1,0,6,0.8571428571428571,1,0.0,0,2,0,0,3,0,0,1,0,2,4,1
5017,177521,UtuMMiTcYdEIPqLGUrTySvaHfGG20tSq,bWdj2GDclj5ofokWjzoa5jAwMkxCykd6,4,2,1,0,1,0,1,0,5,0.7142857142857143,1,0.0,0,1,0,1,2,0,0,1,0,2,3,1
5018,177534,y4HEate091nZSs6CdPCmi4GDN3wtU4uQ,bWdj2GDclj5ofokWjzoa5jAwMkxCykd6,1,0,0,0,0,0,1,0,1,0.14285714285714285,1,0.0,0,0,0,0,0,0,0,1,0,0,1,1
5019,177538,r4ZoHGMZmqAV8283r1kkNHYmSCMouZ71,SpATywNh6bZuzm8s1ceuBUnMUAeoAHHw,1,0,0,0,0,0,1,0,1,0.14285714285714285,1,0.0,0,0,0,0,0,0,0,1,0,0,1,1
5020,177671,pGYLDmhkSj1iBp1YljlDSId0XSrjZNZR,G8EPVSXsOYB5YQWZGiz1aVq5Pgr2GrQu,1,0,0,0,0,0,1,0,1,0.14285714285714285,1,0.0,0,0,0,0,0,0,0,1,0,0,1,1
5021,177704,M2AmcvqhvMtUlyRV6vMvvoM2IhrMmAwT,RXDvfPUBYFlVdlueBFbLW0mhhAyGEqpt,5,2,1,0,1,0,3,0,7,1.0,1,0.0,0,1,0,1,2,0,0,3,0,2,5,1
5022,177823,obnzTYQwwpz4VOaAZpvzueXnEk1orSl6,RXDvfPUBYFlVdlueBFbLW0mhhAyGEqpt,1,0,0,0,0,0,1,0,1,0.14285714285714285,1,0.0,0,0,0,0,0,0,0,1,0,0,1,1
5023,177841,M8GvXQvqlItd1uaUuAOKL5aVksmfHCxv,G8EPVSXsOYB5YQWZGiz1aVq5Pgr2GrQu,3,3,1,0,0,0,1,0,5,0.7142857142857143,1,0.0,0,1,0,0,3,0,0,1,0,1,4,1
5024,177879,M8C9BDFICk4ida59GU0jjp556zazDEi1,G8EPVSXsOYB5YQWZGiz1aVq5Pgr2GrQu,5,3,2,0,1,0,2,0,8,1.1428571428571428,1,0.0,0,2,0,1,3,0,0,2,0,3,5,1
5025,177947,t0soD7aQ6w7DGyhmXz7wyAfUbtBWT4NA,RXDvfPUBYFlVdlueBFbLW0mhhAyGEqpt,25,14,13,0,11,0,2,0,40,5.714285714285714,1,0.0,0,13,0,11,14,0,0,2,0,24,16,0
5026,178058,xk56WEVJEAYlfTe18KDPHjwyCpm6eESo,G8EPVSXsOYB5YQWZGiz1aVq5Pgr2GrQu,3,2,1,0,0,0,1,0,4,0.5714285714285714,1,0.0,0,1,0,0,2,0,0,1,0,1,3,1
5027,178097,dAqrHPlMsXnPrglFnOZUeJrfWBb2qFZV,G8EPVSXsOYB5YQWZGiz1aVq5Pgr2GrQu,1,0,0,0,0,0,2,0,2,0.2857142857142857,1,0.0,0,0,0,0,0,0,0,2,0,0,2,1
5028,178184,fKYKLbyU9DEbtWWdd9SkLOt7DfIpocNH,G8EPVSXsOYB5YQWZGiz1aVq5Pgr2GrQu,10,7,1,0,0,1,9,1,19,2.7142857142857144,1,0.0,0,1,0,0,7,1,0,9,1,1,18,0
5029,179095,oSzwRDot26Gzbo9Z51q8vW83UZefXQx4,A3fsA9Zfv1X2fVEQhTw51lKENdNrEqT3,1,0,0,0,0,0,1,0,1,0.14285714285714285,1,0.0,0,0,0,0,0,0,0,1,0,0,1,1
5030,179270,qdIBYHN1oo81Fn2PDQ4pWy5luAxUSnv8,A3fsA9Zfv1X2fVEQhTw51lKENdNrEqT3,2,0,0,0,0,0,2,0,2,0.2857142857142857,1,0.0,0,0,0,0,0,0,0,2,0,0,2,1
5031,179280,zeHCiMpomPiZgVEBNBLYszozi2RaN6ma,SpATywNh6bZuzm8s1ceuBUnMUAeoAHHw,7,3,1,0,1,0,4,0,9,1.2857142857142858,1,0.0,0,1,0,1,3,0,0,4,0,2,7,0
5032,179288,D9NEjP5of3onbOL7hxFUdKxRWVR3Zio0,A3fsA9Zfv1X2fVEQhTw51lKENdNrEqT3,4,2,1,0,1,0,1,0,5,0.7142857142857143,1,0.0,0,1,0,1,2,0,0,1,0,2,3,1
5033,179289,Yu225AU92v57j3uCc612YKq3vIxaCm7A,A3fsA9Zfv1X2fVEQhTw51lKENdNrEqT3,8,3,2,0,2,0,5,0,12,1.7142857142857142,1,0.0,0,2,0,2,3,0,0,5,0,4,8,1
5034,179369,4s7Pp1HkR1BKGnSREpCdC6xzkb7JZ7RX,A3fsA9Zfv1X2fVEQhTw51lKENdNrEqT3,10,5,4,0,4,0,2,0,15,2.142857142857143,1,0.0,0,4,0,4,5,0,0,2,0,8,7,1
5035,179406,QvbJWpQltbObszIwAlZse9I8csJFcFSS,A3fsA9Zfv1X2fVEQhTw51lKENdNrEqT3,1,0,0,0,0,0,1,0,1,0.14285714285714285,1,0.0,0,0,0,0,0,0,0,1,0,0,1,1
5036,179416,XDzOWUNLzBmGsjdfGLXHCvH3VtT0wXJy,A3fsA9Zfv1X2fVEQhTw51lKENdNrEqT3,2,0,0,0,0,0,2,0,2,0.2857142857142857,1,0.0,0,0,0,0,0,0,0,2,0,0,2,1
5037,179423,P2OYdgxBYF5HxGzcA6vhmPz346TpPX0X,A3fsA9Zfv1X2fVEQhTw51lKENdNrEqT3,9,4,2,0,2,0,5,0,13,1.8571428571428572,1,0.0,0,2,0,2,4,0,0,5,0,4,9,1
5038,179498,20eWtdYsYJ2HaokCydmTS0vY6S0PepZS,A3fsA9Zfv1X2fVEQhTw51lKENdNrEqT3,12,12,3,0,2,0,7,0,24,3.4285714285714284,2,0.0,0,3,0,2,12,0,0,7,0,5,19,1
5039,179562,0gS5Q732yxgOQo1BReYmVwLNG0PEmJtw,A3fsA9Zfv1X2fVEQhTw51lKENdNrEqT3,23,16,6,40,1,0,8,0,71,10.142857142857142,1,0.0,0,6,34,1,16,0,6,8,0,41,30,1
5040,179578,sgSB1EsUBw19mWgGeblLKNJdgffkgrqj,A3fsA9Zfv1X2fVEQhTw51lKENdNrEqT3,7,3,2,0,2,0,2,0,9,1.2857142857142858,1,0.0,0,2,0,2,3,0,0,2,0,4,5,1
5041,179672,bUAApLDRSsYoejMOs9wtzojFHzl0leoA,A3fsA9Zfv1X2fVEQhTw51lKENdNrEqT3,5,2,1,0,1,0,2,0,6,0.8571428571428571,1,0.0,0,1,0,1,2,0,0,2,0,2,4,1
5042,179724,NqjFMzdUzAzJwedggie2ZM67JdWuAq4g,A3fsA9Zfv1X2fVEQhTw51lKENdNrEqT3,5,5,1,0,0,0,1,0,7,1.0,1,0.0,0,1,0,0,5,0,0,1,0,1,6,1
5043,179801,fIbdXFPoTOYlPmaY1ETJ8qg0oyUmhp0g,A3fsA9Zfv1X2fVEQhTw51lKENdNrEqT3,1,0,0,0,0,0,1,0,1,0.14285714285714285,1,0.0,0,0,0,0,0,0,0,1,0,0,1,1
5044,179825,UeMhoIxbaZNEu0tYucIi541fjxr7wtKF,A3fsA9Zfv1X2fVEQhTw51lKENdNrEqT3,2,0,0,0,0,0,2,0,2,0.2857142857142857,1,0.0,0,0,0,0,0,0,0,2,0,0,2,1
5045,179834,ymWpwD3GRW9ut1JiVBQeAWpoDiatjwOa,A3fsA9Zfv1X2fVEQhTw51lKENdNrEqT3,11,13,11,0,8,0,2,0,34,4.857142857142857,1,0.0,1,11,0,8,12,0,0,2,0,20,14,1
5046,179930,y5aBZF9M42jQ3dd47gvkF1IzOdkUj0pK,A3fsA9Zfv1X2fVEQhTw51lKENdNrEqT3,2,0,0,0,0,0,2,0,2,0.2857142857142857,1,0.0,0,0,0,0,0,0,0,2,0,0,2,0
5047,179940,Atic9bcAYez6iPYGWH9qjmSkP3PGX2jq,A3fsA9Zfv1X2fVEQhTw51lKENdNrEqT3,9,13,5,0,3,6,5,0,32,4.571428571428571,1,0.0,0,5,0,3,13,6,0,5,0,8,24,1
5048,179998,xI5OWiIHjz0Mm9IrFHWY7FdkKyLqt0kf,A3fsA9Zfv1X2fVEQhTw51lKENdNrEqT3,6,11,2,0,0,0,7,0,20,2.857142857142857,1,0.0,0,2,0,0,11,0,0,7,0,2,18,1
5049,180029,KdOpYQwRTjGuX2z1c0SW0st7uOc9iGrk,A3fsA9Zfv1X2fVEQhTw51lKENdNrEqT3,9,5,4,0,3,0,2,0,14,2.0,1,0.0,0,4,0,3,5,0,0,2,0,7,7,1
5050,180039,279AIREJbSXhdF4OGkzTGbmlv4S3xwdE,A3fsA9Zfv1X2fVEQhTw51lKENdNrEqT3,19,7,6,0,6,4,7,1,31,4.428571428571429,1,0.0,0,6,0,6,7,4,0,7,1,12,19,0
5051,183283,3uajdhCj0s2q50MqyB5gJCI3ZNoF8Pn6,SpATywNh6bZuzm8s1ceuBUnMUAeoAHHw,12,15,0,17,0,3,2,0,37,5.285714285714286,1,0.0,5,0,15,0,10,3,2,2,0,20,17,0
5052,183468,SSM7wEvdZo8FZW0zxJcXGwdA1S6Vbn5Q,SpATywNh6bZuzm8s1ceuBUnMUAeoAHHw,1,0,0,0,0,0,1,0,1,0.14285714285714285,1,0.0,0,0,0,0,0,0,0,1,0,0,1,0
5053,183681,tUa09YYOUnb3wVzvjQGH0FvIpZ5hsZpt,SpATywNh6bZuzm8s1ceuBUnMUAeoAHHw,11,17,1,0,0,0,2,0,20,2.857142857142857,1,0.0,0,1,0,0,17,0,0,2,0,1,19,1
5054,185822,xr2T8ak6swOOfU9oanYvPbQ4STab9s9f,A3fsA9Zfv1X2fVEQhTw51lKENdNrEqT3,5,3,0,2,0,0,1,0,6,0.8571428571428571,1,0.0,0,0,2,0,3,0,0,1,0,2,4,1
5055,189412,B8lBbNEso7Bw3KF9oTlYX1eUGmqw99RL,SpATywNh6bZuzm8s1ceuBUnMUAeoAHHw,3,2,0,0,0,0,1,0,3,0.42857142857142855,1,0.0,0,0,0,0,2,0,0,1,0,0,3,1
5056,189841,c6EQxl5Y5srE1l7qShfQ6CExe7ZkgJ6z,7GRhBDsirIGkRZBtSMEzNTyDr2JQm4xx,12,15,7,4,2,1,3,0,32,4.571428571428571,1,0.0,5,7,3,2,10,1,1,3,0,17,15,0
5057,190970,LLbWHvDvBPRMaeOD85m6rAaUvdLFucgj,bWdj2GDclj5ofokWjzoa5jAwMkxCykd6,1,0,0,0,0,0,1,0,1,0.14285714285714285,1,0.0,0,0,0,0,0,0,0,1,0,0,1,1
5058,193458,YerAIqIks5QGT3cyYvkkT2PQJt80wdlv,bWdj2GDclj5ofokWjzoa5jAwMkxCykd6,3,2,0,0,0,0,1,0,3,0.42857142857142855,1,0.0,0,0,0,0,2,0,0,1,0,0,3,1
5059,193466,zoOHCo5ZSJYPyewUp3ZVEkAmNnY7HYHv,SpATywNh6bZuzm8s1ceuBUnMUAeoAHHw,8,5,3,0,3,0,3,0,14,2.0,1,0.0,0,3,0,3,5,0,0,3,0,6,8,1
5060,193475,GmYDZTMhI5TgBC2IOLdvnmJEf5uX4LR3,bWdj2GDclj5ofokWjzoa5jAwMkxCykd6,14,15,9,0,8,0,5,0,37,5.285714285714286,1,0.0,2,9,0,8,13,0,0,5,0,19,18,1
5061,193480,13q6Q2ftAOPzmfv0eOg5HLLohXKvBJn0,G8EPVSXsOYB5YQWZGiz1aVq5Pgr2GrQu,39,32,17,90,5,0,6,0,150,21.428571428571427,1,0.0,1,17,74,5,31,0,16,6,0,97,53,1
5062,193491,eDVRcT3oA39R4stYZnLSVwEtXbMKHF03,SpATywNh6bZuzm8s1ceuBUnMUAeoAHHw,3,1,0,0,0,0,2,0,3,0.42857142857142855,1,0.0,0,0,0,0,1,0,0,2,0,0,3,0
5063,193492,bershY3L5dsrOquW1lgM7Vxvmeies3St,A3fsA9Zfv1X2fVEQhTw51lKENdNrEqT3,8,5,1,0,1,0,2,0,9,1.2857142857142858,1,0.0,0,1,0,1,5,0,0,2,0,2,7,1
5064,193493,SBtS69Ct6IHarcvlSoYZArZJi3eatyfh,bWdj2GDclj5ofokWjzoa5jAwMkxCykd6,1,0,0,0,0,0,1,0,1,0.14285714285714285,1,0.0,0,0,0,0,0,0,0,1,0,0,1,1
5065,193497,SBtS69Ct6IHarcvlSoYZArZJi3eatyfh,SpATywNh6bZuzm8s1ceuBUnMUAeoAHHw,1,0,0,0,0,0,1,0,1,0.14285714285714285,1,0.0,0,0,0,0,0,0,0,1,0,0,1,1
5066,193518,cqIrvI5GKO10bpbizT8U9PReNX8yRrno,G8EPVSXsOYB5YQWZGiz1aVq5Pgr2GrQu,19,15,7,34,5,0,6,0,67,9.571428571428571,1,0.0,8,7,31,5,7,0,3,6,0,51,16,1
5067,193551,xwBZbOE6F0kqpjHJoYX4YfzqsGNvKWLp,A3fsA9Zfv1X2fVEQhTw51lKENdNrEqT3,2,0,0,0,0,0,2,0,2,0.2857142857142857,1,0.0,0,0,0,0,0,0,0,2,0,0,2,1
5068,193556,E5gNyf8gzkIFqEMMzFfX1babw0jRMtve,G8EPVSXsOYB5YQWZGiz1aVq5Pgr2GrQu,2,0,0,0,0,0,2,0,2,0.2857142857142857,1,0.0,0,0,0,0,0,0,0,2,0,0,2,1
5069,193606,0lEKKJq7wgGTJZ13dxv0HcjHfYwzJrxA,SpATywNh6bZuzm8s1ceuBUnMUAeoAHHw,1,0,0,0,0,0,1,0,1,0.14285714285714285,1,0.0,0,0,0,0,0,0,0,1,0,0,1,1
5070,193612,NpeRs7t4bBCf621U45j2j6LzoAMg7Erp,A3fsA9Zfv1X2fVEQhTw51lKENdNrEqT3,7,9,2,0,1,0,2,0,14,2.0,1,0.0,0,2,0,1,9,0,0,2,0,3,11,1
5071,193619,t7E1vZtGQbSSizV4xYOd5KHhRDOCUCjx,A3fsA9Zfv1X2fVEQhTw51lKENdNrEqT3,1,0,0,0,0,0,1,0,1,0.14285714285714285,1,0.0,0,0,0,0,0,0,0,1,0,0,1,1
5072,193635,XWdgQujmo1P2VLjvmb7PkUqKleCwQ4ss,A3fsA9Zfv1X2fVEQhTw51lKENdNrEqT3,11,7,5,0,3,0,4,0,19,2.7142857142857144,1,0.0,0,5,0,3,7,0,0,4,0,8,11,1
5073,193656,e5o0ZhPldcalqrDMbMLWYdrV0kqK4jyi,A3fsA9Zfv1X2fVEQhTw51lKENdNrEqT3,27,18,1,52,1,0,9,0,81,11.571428571428571,1,0.0,0,1,45,1,18,0,7,9,0,47,34,1
5074,193667,598cj7AyOso6FYrmmNL9sAZebmTaquiE,SpATywNh6bZuzm8s1ceuBUnMUAeoAHHw,1,0,0,0,0,0,1,0,1,0.14285714285714285,1,0.0,0,0,0,0,0,0,0,1,0,0,1,1
5075,193685,VAqYNROCUp4auixkrMgowB877fUTXjiq,SpATywNh6bZuzm8s1ceuBUnMUAeoAHHw,31,30,16,18,9,16,9,2,100,14.285714285714286,1,0.0,8,16,17,9,22,16,1,9,2,50,50,1
5076,193691,VwBmQMjyoGFc84WCvHOjmFbeW8jbYRgl,A3fsA9Zfv1X2fVEQhTw51lKENdNrEqT3,1,0,0,0,0,0,1,0,1,0.14285714285714285,1,0.0,0,0,0,0,0,0,0,1,0,0,1,1
5077,193695,GR5uAqC8TkTRctStVcrTSN6GkRpM0Sgw,A3fsA9Zfv1X2fVEQhTw51lKENdNrEqT3,10,9,6,0,4,0,3,0,22,3.142857142857143,1,0.0,0,6,0,4,9,0,0,3,0,10,12,1
5078,193727,9sblSYhBcICCvIfDQzNd8urCtUZhCG20,G8EPVSXsOYB5YQWZGiz1aVq5Pgr2GrQu,4,2,1,0,1,0,1,0,5,0.7142857142857143,1,0.0,0,1,0,1,2,0,0,1,0,2,3,1
5079,193742,dIBmr3CPQOqWuT2RbNcEQBxcZ3iYYFKJ,SpATywNh6bZuzm8s1ceuBUnMUAeoAHHw,5,0,0,0,0,1,4,1,6,0.8571428571428571,1,0.0,0,0,0,0,0,1,0,4,1,0,6,1
5080,193747,GTb2BLvnbd5mZTOqXcKad8NiMQFrBvAc,SpATywNh6bZuzm8s1ceuBUnMUAeoAHHw,18,23,10,14,6,0,6,0,59,8.428571428571429,1,0.0,2,10,11,6,21,0,3,6,0,29,30,1
5081,193748,hjvKRw9pmlUHPnwBerxV034YiZ4Sdtt0,G8EPVSXsOYB5YQWZGiz1aVq5Pgr2GrQu,9,6,5,0,5,0,2,0,18,2.5714285714285716,1,0.0,0,5,0,5,6,0,0,2,0,10,8,1
5082,193760,YbMwXn5lVdcJUwxsrilaG1YZqfrME5Ts,G8EPVSXsOYB5YQWZGiz1aVq5Pgr2GrQu,1,0,0,0,0,0,1,0,1,0.14285714285714285,1,0.0,0,0,0,0,0,0,0,1,0,0,1,1
5083,193761,DooyrB9PbCqKIV8AnNe2Wg3x6dZeRNaT,SpATywNh6bZuzm8s1ceuBUnMUAeoAHHw,7,6,2,0,0,0,3,2,13,1.8571428571428572,1,0.0,0,2,0,0,6,0,0,3,2,2,11,1
5084,193763,rKeYwK2azWmbL5uxRkzD5SXs7NFGZVCo,SpATywNh6bZuzm8s1ceuBUnMUAeoAHHw,6,3,0,0,0,0,4,0,7,1.0,1,0.0,0,0,0,0,3,0,0,4,0,0,7,1
5085,193788,j3WvRsPrA16gNidaQCOf3oXIUr2Xe5Lw,A3fsA9Zfv1X2fVEQhTw51lKENdNrEqT3,5,2,1,0,1,0,3,0,7,1.0,1,0.0,0,1,0,1,2,0,0,3,0,2,5,1
5086,193801,7ZZMGT0pRIPOqiHOaJOX6RxFZ8zRhWxt,A3fsA9Zfv1X2fVEQhTw51lKENdNrEqT3,8,3,2,0,2,1,3,0,11,1.5714285714285714,1,0.0,0,2,0,2,3,1,0,3,0,4,7,1
5087,193819,3vhCoT2dzeVdCpmcedhNzxK4VNLZ2l0r,bWdj2GDclj5ofokWjzoa5jAwMkxCykd6,1,0,0,0,0,0,1,0,1,0.14285714285714285,1,0.0,0,0,0,0,0,0,0,1,0,0,1,0
5088,193825,3VQVtsFphnOA3h1KWYRcAEMgfViLsPnF,bWdj2GDclj5ofokWjzoa5jAwMkxCykd6,4,3,1,0,0,0,2,0,6,0.8571428571428571,1,0.0,0,1,0,0,3,0,0,2,0,1,5,1
5089,193829,hvOZRLKsEVBLKIHheUWv5UUSup3awqeH,A3fsA9Zfv1X2fVEQhTw51lKENdNrEqT3,4,3,2,0,0,0,1,0,6,0.8571428571428571,1,0.0,0,2,0,0,3,0,0,1,0,2,4,1
5090,193835,FMDDO6Y1UiugRDKpi0pVbHvW0zsQHjbn,bWdj2GDclj5ofokWjzoa5jAwMkxCykd6,1,0,0,0,0,0,1,0,1,0.14285714285714285,1,0.0,0,0,0,0,0,0,0,1,0,0,1,1
5091,193836,WXzb3Y6xA6QJw9uAvme4qAoRdy9Swxz3,bWdj2GDclj5ofokWjzoa5jAwMkxCykd6,5,2,1,0,1,0,2,0,6,0.8571428571428571,1,0.0,0,1,0,1,2,0,0,2,0,2,4,1
5092,193842,z7DdTbSj1Gj3ZtxvkXQiSHlxkjIq13Om,A3fsA9Zfv1X2fVEQhTw51lKENdNrEqT3,2,0,0,0,0,0,2,0,2,0.2857142857142857,1,0.0,0,0,0,0,0,0,0,2,0,0,2,1
5093,193864,K9qobabPo7pZQt2fKdAjWYuJRDpZrqC7,RXDvfPUBYFlVdlueBFbLW0mhhAyGEqpt,11,5,4,0,4,0,2,0,15,2.142857142857143,1,0.0,0,4,0,4,5,0,0,2,0,8,7,1
5094,193885,F9X9HFVZRhtKo9yeebrZ2KAiEJUTDJRY,G8EPVSXsOYB5YQWZGiz1aVq5Pgr2GrQu,2,0,0,0,0,0,2,0,2,0.2857142857142857,1,0.0,0,0,0,0,0,0,0,2,0,0,2,1
5095,193887,8WWQhxaHRXxYqCPIQW9GmAgjD0ozXXnf,A3fsA9Zfv1X2fVEQhTw51lKENdNrEqT3,4,2,1,0,0,0,3,0,6,0.8571428571428571,1,0.0,0,1,0,0,2,0,0,3,0,1,5,0
5096,193897,45E6hpwDMHp9Q3Pt1xT8q04bbowKk87g,A3fsA9Zfv1X2fVEQhTw51lKENdNrEqT3,1,0,0,0,0,0,1,0,1,0.14285714285714285,1,0.0,0,0,0,0,0,0,0,1,0,0,1,1
5097,193929,e6mMhCeN7w5EZEy3n1NRYNLGTJO2KA59,SpATywNh6bZuzm8s1ceuBUnMUAeoAHHw,1,0,0,0,0,0,1,0,1,0.14285714285714285,1,0.0,0,0,0,0,0,0,0,1,0,0,1,1
5098,193932,B3ZfBfSKmpVIANk9dvhtttx7UlfawxPq,A3fsA9Zfv1X2fVEQhTw51lKENdNrEqT3,1,0,0,0,0,0,1,0,1,0.14285714285714285,1,0.0,0,0,0,0,0,0,0,1,0,0,1,1
5099,193941,Y3dD0pffbJaLSFte0rosi5cTQO2WHCFH,bWdj2GDclj5ofokWjzoa5jAwMkxCykd6,1,0,0,0,0,0,2,0,2,0.2857142857142857,1,0.0,0,0,0,0,0,0,0,2,0,0,2,1
5100,193942,hOgVLmzr652IyemyxTuY6cW83fi0l5Hj,G8EPVSXsOYB5YQWZGiz1aVq5Pgr2GrQu,1,0,0,0,0,0,1,0,1,0.14285714285714285,1,0.0,0,0,0,0,0,0,0,1,0,0,1,1
5101,193973,6KzTREX6cWCQkku3medBN2WKozKVI3fS,SpATywNh6bZuzm8s1ceuBUnMUAeoAHHw,3,2,0,0,0,0,2,0,4,0.5714285714285714,1,0.0,0,0,0,0,2,0,0,2,0,0,4,1
5102,193978,DysXuoUoTtoCjfxHxEQdZhXHC6tNfwru,bWdj2GDclj5ofokWjzoa5jAwMkxCykd6,7,3,2,0,1,0,9,0,15,2.142857142857143,1,0.0,0,2,0,1,3,0,0,9,0,3,12,1
5103,193993,S84ond6hhLSjNul8oHBvYzb7CeUyBJp8,SpATywNh6bZuzm8s1ceuBUnMUAeoAHHw,7,5,0,0,0,2,7,2,16,2.2857142857142856,1,0.0,0,0,0,0,5,2,0,7,2,0,16,1
5104,193996,3IFRUpYOJSQEJERfx1oONgKb2XoWBUXe,A3fsA9Zfv1X2fVEQhTw51lKENdNrEqT3,4,2,1,0,1,0,1,0,5,0.7142857142857143,1,0.0,0,1,0,1,2,0,0,1,0,2,3,1
5105,193997,eOxm8XEI11Xs6eiBi1Nu5QzIagZXwEm9,G8EPVSXsOYB5YQWZGiz1aVq5Pgr2GrQu,11,23,12,6,0,3,2,0,46,6.571428571428571,1,0.0,9,12,6,0,14,3,0,2,0,27,19,0
5106,193998,TV2QJkXjXW9uFHAZ7SV4Umcd3jhniZYh,A3fsA9Zfv1X2fVEQhTw51lKENdNrEqT3,1,0,0,0,0,0,1,0,1,0.14285714285714285,1,0.0,0,0,0,0,0,0,0,1,0,0,1,1
5107,194012,jnzTLvRDRqiUyW9xELuzH3YTLwUlWLlc,A3fsA9Zfv1X2fVEQhTw51lKENdNrEqT3,10,3,2,0,2,0,9,2,18,2.5714285714285716,1,0.0,0,2,0,2,3,0,0,9,2,4,14,1
5108,194028,jnzTLvRDRqiUyW9xELuzH3YTLwUlWLlc,bWdj2GDclj5ofokWjzoa5jAwMkxCykd6,6,0,0,0,0,1,6,2,9,1.2857142857142858,1,0.0,0,0,0,0,0,1,0,6,2,0,9,1
5109,194039,Zi4TkBqsB6TMu9rM1cOGrFhYXBZRNO2C,bWdj2GDclj5ofokWjzoa5jAwMkxCykd6,5,3,1,20,0,0,2,0,26,3.7142857142857144,1,0.0,1,1,19,0,2,0,1,2,0,21,5,1
5110,194043,DIV0XhnvCWVZ3iA9CwmqKCB9ziYsXVmI,A3fsA9Zfv1X2fVEQhTw51lKENdNrEqT3,40,35,13,46,8,1,5,0,108,15.428571428571429,1,0.0,3,13,43,8,32,1,3,5,0,67,41,1
5111,194050,mpIXHW5sILjjHOwn1u3NkBPJs6lkxDFU,bWdj2GDclj5ofokWjzoa5jAwMkxCykd6,7,2,1,0,1,0,7,1,12,1.7142857142857142,1,0.0,0,1,0,1,2,0,0,7,1,2,10,1
5112,194079,CuAHJ0dQPPKM3jbCnUFrdX2jG6XCUieg,G8EPVSXsOYB5YQWZGiz1aVq5Pgr2GrQu,2,0,0,0,0,0,3,0,3,0.42857142857142855,1,0.0,0,0,0,0,0,0,0,3,0,0,3,1
5113,194087,ss3omMaxz8HNXcYUFu5YCrRY08Nxx8VE,bWdj2GDclj5ofokWjzoa5jAwMkxCykd6,1,0,0,0,0,0,1,0,1,0.14285714285714285,1,0.0,0,0,0,0,0,0,0,1,0,0,1,1
5114,194124,YpnxbgvlHOSkecYk2lPrRwAg5SZiWPmr,bWdj2GDclj5ofokWjzoa5jAwMkxCykd6,1,0,0,0,0,0,1,0,1,0.14285714285714285,1,0.0,0,0,0,0,0,0,0,1,0,0,1,1
5115,194130,JijbcO7wMC3H8jX3AIAMeKa5y6Yx30jd,SpATywNh6bZuzm8s1ceuBUnMUAeoAHHw,3,3,1,0,0,0,2,0,6,0.8571428571428571,1,0.0,0,1,0,0,3,0,0,2,0,1,5,1
5116,194141,AEmia2YozeXaHvFO7t97makRXH4xCDlp,bWdj2GDclj5ofokWjzoa5jAwMkxCykd6,2,0,0,0,0,0,2,0,2,0.2857142857142857,1,0.0,0,0,0,0,0,0,0,2,0,0,2,1
5117,194152,7zIWtEX0UqW89kjtfLjI3UwXu7RlQqmU,SpATywNh6bZuzm8s1ceuBUnMUAeoAHHw,5,1,1,0,0,1,3,0,6,0.8571428571428571,1,0.0,0,1,0,0,1,1,0,3,0,1,5,1
5118,194158,D9eQoamtTDpiMV0b0OdGca728kthGUV3,G8EPVSXsOYB5YQWZGiz1aVq5Pgr2GrQu,17,7,2,50,0,0,3,0,62,8.857142857142858,1,0.0,0,2,43,0,7,0,7,3,0,45,17,0
5119,194167,2Dq9sTJAh9p2mCX2aKqNadJZj5lSg7Gc,SpATywNh6bZuzm8s1ceuBUnMUAeoAHHw,5,2,1,0,1,2,2,0,8,1.1428571428571428,1,0.0,0,1,0,1,2,2,0,2,0,2,6,1
5120,194168,GK7sYKSl1UGrgHpbh9Be7dVcfb79qHt9,SpATywNh6bZuzm8s1ceuBUnMUAeoAHHw,1,0,0,0,0,0,1,0,1,0.14285714285714285,1,0.0,0,0,0,0,0,0,0,1,0,0,1,1
5121,194184,l8hBRAS7ogrjP9TtrcfhUTQvRrT69YER,G8EPVSXsOYB5YQWZGiz1aVq5Pgr2GrQu,5,2,1,0,1,0,2,0,6,0.8571428571428571,1,0.0,0,1,0,1,2,0,0,2,0,2,4,1
5122,194188,OPg8TE3YHncvc9lX5Qzwkp0eoPsxjeaJ,SpATywNh6bZuzm8s1ceuBUnMUAeoAHHw,1,0,0,0,0,0,1,0,1,0.14285714285714285,1,0.0,0,0,0,0,0,0,0,1,0,0,1,1
5123,194198,1GmDhTbDGwGy4bZMeoK4qCn6roKlLWL8,G8EPVSXsOYB5YQWZGiz1aVq5Pgr2GrQu,1,0,0,0,0,0,1,0,1,0.14285714285714285,1,0.0,0,0,0,0,0,0,0,1,0,0,1,1
5124,194207,N3GQz89WFoRVhyYvEOMDsOOoq6FMOJl1,A3fsA9Zfv1X2fVEQhTw51lKENdNrEqT3,7,2,1,0,1,0,4,0,8,1.1428571428571428,1,0.0,0,1,0,1,2,0,0,4,0,2,6,1
5125,194209,2VapaY28kspg4nCvtglCw2KKfbfMlxS8,SpATywNh6bZuzm8s1ceuBUnMUAeoAHHw,5,3,1,0,1,0,1,0,6,0.8571428571428571,1,0.0,0,1,0,1,3,0,0,1,0,2,4,1
5126,194212,OvbupWSPA81Tk7Ur62Bs2bcQ5LB2mCRC,G8EPVSXsOYB5YQWZGiz1aVq5Pgr2GrQu,2,0,0,0,0,0,3,0,3,0.42857142857142855,1,0.0,0,0,0,0,0,0,0,3,0,0,3,0
5127,194214,OvbupWSPA81Tk7Ur62Bs2bcQ5LB2mCRC,A3fsA9Zfv1X2fVEQhTw51lKENdNrEqT3,2,0,0,0,0,0,2,0,2,0.2857142857142857,1,0.0,0,0,0,0,0,0,0,2,0,0,2,1
5128,194219,HFdRVQ3AaPvRF7mZbj3u7qUCAaYBGTcm,SpATywNh6bZuzm8s1ceuBUnMUAeoAHHw,1,0,0,0,0,0,1,0,1,0.14285714285714285,1,0.0,0,0,0,0,0,0,0,1,0,0,1,1
5129,194239,lxKYdDOq1adV5jGN5i0lYRRTeDyNW3Hr,SpATywNh6bZuzm8s1ceuBUnMUAeoAHHw,7,5,3,0,3,0,1,0,12,1.7142857142857142,1,0.0,0,3,0,3,5,0,0,1,0,6,6,1
5130,194245,BX7A5l848o20PbI9pokip60ZP55PjOzN,G8EPVSXsOYB5YQWZGiz1aVq5Pgr2GrQu,4,4,0,0,1,0,2,0,7,1.0,1,0.0,2,0,0,1,2,0,0,2,0,3,4,1
5131,194247,cpjQZOHgh4ZTeyEYZfjNyABlYC6nYoj2,A3fsA9Zfv1X2fVEQhTw51lKENdNrEqT3,7,6,5,0,0,0,3,0,14,2.0,1,0.0,0,5,0,0,6,0,0,3,0,5,9,1
5132,194267,hMqCjJdtfaejzSQ83KyhyoOldYIdBdX3,SpATywNh6bZuzm8s1ceuBUnMUAeoAHHw,1,0,0,0,0,0,1,0,1,0.14285714285714285,1,0.0,0,0,0,0,0,0,0,1,0,0,1,1
5133,194268,kITwW1gHtEbLza4IRMvPlhsE9m2pSgys,SpATywNh6bZuzm8s1ceuBUnMUAeoAHHw,11,7,4,1,3,1,2,0,18,2.5714285714285716,1,0.0,2,4,1,3,5,1,0,2,0,10,8,1
5134,194270,C5PwR3SXfivaQr9O4Dxv6rN0h0XMnUVV,SpATywNh6bZuzm8s1ceuBUnMUAeoAHHw,1,0,0,0,0,0,1,0,1,0.14285714285714285,1,0.0,0,0,0,0,0,0,0,1,0,0,1,1
5135,194286,Otjo8813Dg7RT9KCV4W4ruW1YbtDERlU,SpATywNh6bZuzm8s1ceuBUnMUAeoAHHw,4,2,0,0,0,0,2,0,4,0.5714285714285714,1,0.0,0,0,0,0,2,0,0,2,0,0,4,1
5136,194294,TrGtovPIL2DHRKTJya0pAHN8Ll5iZ4bG,bWdj2GDclj5ofokWjzoa5jAwMkxCykd6,9,7,2,0,3,0,6,0,18,2.5714285714285716,1,0.0,4,2,0,3,3,0,0,6,0,9,9,1
5137,194302,wOwiWQdQ27i4GIc2oZMP91541bkLucBc,SpATywNh6bZuzm8s1ceuBUnMUAeoAHHw,1,0,0,0,0,0,2,0,2,0.2857142857142857,1,0.0,0,0,0,0,0,0,0,2,0,0,2,1
5138,194321,y2Bn8Fz28yytP2MIRmHuQaPFEsenFCug,A3fsA9Zfv1X2fVEQhTw51lKENdNrEqT3,1,0,0,0,0,0,1,0,1,0.14285714285714285,1,0.0,0,0,0,0,0,0,0,1,0,0,1,1
5139,194322,OZuOlHrYkbmhjVMCUismPKuxxMPY633r,A3fsA9Zfv1X2fVEQhTw51lKENdNrEqT3,1,0,0,0,0,0,1,0,1,0.14285714285714285,1,0.0,0,0,0,0,0,0,0,1,0,0,1,1
5140,194334,hY4FeHGzGwAjlLDbag2MaeYtVg1riH9c,SpATywNh6bZuzm8s1ceuBUnMUAeoAHHw,8,8,4,0,3,0,2,1,18,2.5714285714285716,1,0.0,0,4,0,3,8,0,0,2,1,7,11,1
5141,194345,1qu57qTStFt2PB3HKgCdjae4zjIQPzMS,SpATywNh6bZuzm8s1ceuBUnMUAeoAHHw,2,0,0,0,0,0,2,0,2,0.2857142857142857,1,0.0,0,0,0,0,0,0,0,2,0,0,2,1
5142,194377,ebb0eUpPkZciTEOOrks9iaKBNMYE9SZU,SpATywNh6bZuzm8s1ceuBUnMUAeoAHHw,2,0,0,0,0,0,2,0,2,0.2857142857142857,1,0.0,0,0,0,0,0,0,0,2,0,0,2,1
5143,194388,hvbDeZzn9OgzafKXcnS1f48LEouOk3BF,bWdj2GDclj5ofokWjzoa5jAwMkxCykd6,1,0,0,0,0,0,1,0,1,0.14285714285714285,1,0.0,0,0,0,0,0,0,0,1,0,0,1,1
5144,194390,hvbDeZzn9OgzafKXcnS1f48LEouOk3BF,A3fsA9Zfv1X2fVEQhTw51lKENdNrEqT3,6,0,0,0,0,1,5,0,6,0.8571428571428571,1,0.0,0,0,0,0,0,1,0,5,0,0,6,1
5145,194406,WjTwXU0UqHfY2vRQjeMISV15DHgkpGUt,A3fsA9Zfv1X2fVEQhTw51lKENdNrEqT3,33,11,7,54,4,2,10,0,88,12.571428571428571,1,0.0,1,7,48,4,10,2,6,10,0,60,28,1
5146,194424,q43mSthmSExfF85hVnaL1eLCzsnwUSmi,SpATywNh6bZuzm8s1ceuBUnMUAeoAHHw,1,0,0,0,0,0,1,0,1,0.14285714285714285,1,0.0,0,0,0,0,0,0,0,1,0,0,1,1
5147,194471,uugcqDT99r37esUG18otF2qi3eWqvBzw,A3fsA9Zfv1X2fVEQhTw51lKENdNrEqT3,1,0,0,0,0,0,1,0,1,0.14285714285714285,1,0.0,0,0,0,0,0,0,0,1,0,0,1,1
5148,195616,Kcq3gQRtZRNf9DA8M7wqRqrJH838UPPz,7GRhBDsirIGkRZBtSMEzNTyDr2JQm4xx,17,30,12,6,5,17,8,0,78,11.142857142857142,1,0.0,8,12,3,5,22,17,3,8,0,28,50,1
5149,195619,DS74xqPNpZwZQjbZ7YGZYJfVghg7Q9HH,7GRhBDsirIGkRZBtSMEzNTyDr2JQm4xx,5,3,1,0,1,0,2,0,7,1.0,1,0.0,1,1,0,1,2,0,0,2,0,3,4,1
5150,195622,Tcaf2GTbOMScFZKlh1LFlKzosiyvJhfT,7GRhBDsirIGkRZBtSMEzNTyDr2JQm4xx,1,0,0,0,0,0,1,0,1,0.14285714285714285,1,0.0,0,0,0,0,0,0,0,1,0,0,1,1
5151,195648,juzfwxHXCKii6ul7funGUBQbDVPCyrBB,7GRhBDsirIGkRZBtSMEzNTyDr2JQm4xx,1,0,0,0,0,0,1,0,1,0.14285714285714285,1,0.0,0,0,0,0,0,0,0,1,0,0,1,1
5152,195720,GWmVmhZO8RKaiQ4dKIoawnWCScVz2MBi,7GRhBDsirIGkRZBtSMEzNTyDr2JQm4xx,2,0,0,0,0,0,2,0,2,0.2857142857142857,1,0.0,0,0,0,0,0,0,0,2,0,0,2,1
5153,195758,MpTAgw3ozhmeD7C8xc95FgAYRb7j4nGM,7GRhBDsirIGkRZBtSMEzNTyDr2JQm4xx,3,2,1,0,0,0,2,0,5,0.7142857142857143,1,0.0,0,1,0,0,2,0,0,2,0,1,4,1
5154,195772,E61JfTQnEaIkaCE4GRNSaG2A1gMqzhfA,7GRhBDsirIGkRZBtSMEzNTyDr2JQm4xx,1,0,0,0,0,0,1,0,1,0.14285714285714285,1,0.0,0,0,0,0,0,0,0,1,0,0,1,1
5155,195779,5AbPWjZ6ixqm6XZz56tS5VZ41TKzUcUl,7GRhBDsirIGkRZBtSMEzNTyDr2JQm4xx,1,0,0,0,0,0,1,0,1,0.14285714285714285,1,0.0,0,0,0,0,0,0,0,1,0,0,1,1
5156,195780,xyxmqhkuTJtB1dPu1gtPCQSBFbuRU8fb,7GRhBDsirIGkRZBtSMEzNTyDr2JQm4xx,9,6,0,4,0,1,6,3,20,2.857142857142857,1,0.0,2,0,3,0,4,1,1,6,3,5,15,1
5157,200157,CykijlBvrfCnopTb9AaXgis5gSkvGwzC,fbPkOYLVPtPgIt0MxizjfFJov3JbHyAi,7,1,1,0,1,1,7,1,12,1.7142857142857142,1,0.0,0,1,0,1,1,1,0,7,1,2,10,1
5158,200159,t9QYODxZ0thus7iFGBwx6fkPWEXFSW7S,fbPkOYLVPtPgIt0MxizjfFJov3JbHyAi,7,5,2,0,2,0,2,0,11,1.5714285714285714,1,0.0,0,2,0,2,5,0,0,2,0,4,7,1
5159,200162,dzURuE7IlCH80LFSI2yTw30zsMgWkp29,fbPkOYLVPtPgIt0MxizjfFJov3JbHyAi,6,2,0,0,0,0,8,0,10,1.4285714285714286,1,0.0,0,0,0,0,2,0,0,8,0,0,10,1
5160,200163,bNjBiMsX33gdPcYQXoqSFOjUJgLcFbHE,fbPkOYLVPtPgIt0MxizjfFJov3JbHyAi,7,4,2,0,2,0,6,0,14,2.0,1,0.0,1,2,0,2,3,0,0,6,0,5,9,1
5161,200165,SwWiPD24oHM8AndfY3AAAjHvKl9MggTk,fbPkOYLVPtPgIt0MxizjfFJov3JbHyAi,2,0,0,0,0,0,2,0,2,0.2857142857142857,1,0.0,0,0,0,0,0,0,0,2,0,0,2,1
5162,200166,Gv890Y8tWqdQL73srFfKZXsLtPUpIe2C,fbPkOYLVPtPgIt0MxizjfFJov3JbHyAi,8,3,1,0,1,0,5,0,10,1.4285714285714286,1,0.0,0,1,0,1,3,0,0,5,0,2,8,1
5163,200169,LiyIa3B6QhI7xyW0IVAj2eKqmqAeHza7,fbPkOYLVPtPgIt0MxizjfFJov3JbHyAi,10,3,2,0,2,0,8,1,16,2.2857142857142856,1,0.0,0,2,0,2,3,0,0,8,1,4,12,1
5164,200171,b42x9fEviD2KrosQFgO4BDKrSzPFH9d9,fbPkOYLVPtPgIt0MxizjfFJov3JbHyAi,29,29,13,20,15,3,9,1,90,12.857142857142858,1,0.0,14,13,15,15,15,3,5,9,1,57,33,1
5165,200173,uQYu0hHVc5jntgCyzuDA9TaZrd7lJp3t,fbPkOYLVPtPgIt0MxizjfFJov3JbHyAi,1,0,0,0,0,0,1,0,1,0.14285714285714285,1,0.0,0,0,0,0,0,0,0,1,0,0,1,1
5166,200175,D8LAFp7BvA55dAaLzF6AX6GIJkGB1HJQ,fbPkOYLVPtPgIt0MxizjfFJov3JbHyAi,1,0,0,0,0,0,1,0,1,0.14285714285714285,1,0.0,0,0,0,0,0,0,0,1,0,0,1,1
5167,200177,I463Z3P8xxMeNa2OIR0bwDIF8VjojVtU,fbPkOYLVPtPgIt0MxizjfFJov3JbHyAi,2,0,0,0,0,0,2,0,2,0.2857142857142857,1,0.0,0,0,0,0,0,0,0,2,0,0,2,1
5168,200178,kdbKnHrfUetCNFpkVPUjd1YS7pY3Y1xS,fbPkOYLVPtPgIt0MxizjfFJov3JbHyAi,7,4,3,0,3,0,2,0,12,1.7142857142857142,1,0.0,0,3,0,3,4,0,0,2,0,6,6,1
5169,200179,nONpoqUpw0PURu6ZnXs9gQtQMOWOg8ue,fbPkOYLVPtPgIt0MxizjfFJov3JbHyAi,7,3,2,0,2,0,2,0,9,1.2857142857142858,1,0.0,0,2,0,2,3,0,0,2,0,4,5,1
5170,200180,N1H6FHZ3dNzEs8oMwW9QQdJ6c3gTcjMQ,fbPkOYLVPtPgIt0MxizjfFJov3JbHyAi,1,0,0,0,0,0,1,0,1,0.14285714285714285,1,0.0,0,0,0,0,0,0,0,1,0,0,1,1
5171,200181,5AVv64HGNDPJGZDwAOSJQtcGvZuBdS1I,fbPkOYLVPtPgIt0MxizjfFJov3JbHyAi,1,0,0,0,0,0,1,0,1,0.14285714285714285,1,0.0,0,0,0,0,0,0,0,1,0,0,1,1
5172,200182,4TP43TWBhiZRfTTi5JD8xgUB7xZqttTW,fbPkOYLVPtPgIt0MxizjfFJov3JbHyAi,1,0,0,0,0,0,1,0,1,0.14285714285714285,1,0.0,0,0,0,0,0,0,0,1,0,0,1,1
