,enrollment_id,username,course_id,no_of_objects4,bno_access4,bno_pageclose4,bno_problem4,bno_video4,bno_discussion4,bno_navigate4,bno_wiki4,bno_total4,bno_avg4,no_of_active_days4,time_consumption4,browser_access4,browser_pageclose4,browser_problem4,browser_video4,server_access4,server_discussion4,server_problem4,server_navigate4,server_wiki4,bno_browser4,bno_server4,label
0,3,1qXC7Fjbwp66GPQc6pHLfEuO8WKozxG4,7GRhBDsirIGkRZBtSMEzNTyDr2JQm4xx,35,28,2,55,0,5,3,0,93,13.285714285714286,2,132239.0,12,2,53,0,16,5,2,3,0,67,26,0
1,5,p1Mp7WkVfzUijX0peVQKSHbgd5pXyl4c,7GRhBDsirIGkRZBtSMEzNTyDr2JQm4xx,54,79,24,58,39,14,8,0,222,31.714285714285715,4,0.0,48,24,48,39,31,14,10,8,0,159,63,0
2,7,I1KwJ6EdCZnEPLfC8Q7yWpIkLOHn7h02,7GRhBDsirIGkRZBtSMEzNTyDr2JQm4xx,20,23,10,18,4,0,4,0,59,8.428571428571429,3,0.0,8,10,9,4,15,0,9,4,0,31,28,1
3,13,hDbSkVrFRj9Ryk3c5E1JYJQLyxm4jLRb,5X6FeZozNMgE2VRi3MJYjkkFK8SETtu2,100,200,25,150,69,4,15,0,463,66.14285714285714,8,0.0,106,25,114,69,94,4,36,15,0,314,149,0
4,45,5Tz6BGN7p1lkmdoopAY1Z5ufYTrUsi9E,7GRhBDsirIGkRZBtSMEzNTyDr2JQm4xx,45,115,45,58,50,10,16,0,294,42.0,6,0.0,49,45,46,50,66,10,12,16,0,190,104,0
5,49,2oTvbzieHn2y5oozeOgSnruqE6N0BtR5,7GRhBDsirIGkRZBtSMEzNTyDr2JQm4xx,22,78,44,10,3,226,35,0,396,56.57142857142857,8,0.0,13,44,5,3,65,226,5,35,0,65,331,0
6,51,bYjPoNbc5ILh7K7s9YR8HLOMNJGN6Ums,5X6FeZozNMgE2VRi3MJYjkkFK8SETtu2,85,520,237,6,229,175,71,0,1238,176.85714285714286,26,0.0,200,237,3,229,320,175,3,71,0,669,569,0
7,58,l9KseRU4xYtwOzoILYmGcicF0iiXQqxl,7GRhBDsirIGkRZBtSMEzNTyDr2JQm4xx,8,11,3,2,2,0,1,0,19,2.7142857142857144,1,0.0,2,3,2,2,9,0,0,1,0,9,10,0
8,96,KXi2lu4GlKmrO1lJTLg3t4l701rvNXNZ,7GRhBDsirIGkRZBtSMEzNTyDr2JQm4xx,13,15,10,0,6,0,4,0,35,5.0,2,0.0,0,10,0,6,15,0,0,4,0,16,19,1
9,114,JNo2rLqKe6aBGDwGzu8tXd13uOC5tEnq,5X6FeZozNMgE2VRi3MJYjkkFK8SETtu2,5,1,1,0,0,0,5,0,7,1.0,1,0.0,0,1,0,0,1,0,0,5,0,1,6,1
10,134,Q5TmTVdy8nnH2vTL73s67ZseaCMO3k91,7GRhBDsirIGkRZBtSMEzNTyDr2JQm4xx,4,3,2,0,0,0,4,0,9,1.2857142857142858,2,0.0,0,2,0,0,3,0,0,4,0,2,7,1
11,141,CB4JYroUtmiKv572P6g4vrvJCi6Pzr9h,7GRhBDsirIGkRZBtSMEzNTyDr2JQm4xx,2,0,0,0,0,0,2,0,2,0.2857142857142857,1,0.0,0,0,0,0,0,0,0,2,0,0,2,1
12,192,hCxbmPBmjgsEuMY36HnZH4x3BwWFnCUn,7GRhBDsirIGkRZBtSMEzNTyDr2JQm4xx,30,143,21,0,22,0,26,0,212,30.285714285714285,7,0.0,78,21,0,22,65,0,0,26,0,121,91,0
13,199,OEQBiRbbo3yEBzKSHcNX9ESBTSUy08ze,7GRhBDsirIGkRZBtSMEzNTyDr2JQm4xx,44,73,31,41,19,22,14,3,203,29.0,2,0.0,36,31,32,19,37,22,9,14,3,118,85,0
14,200,tp9GLoYyljDV6mILQxrtrv1Iw4qcPl5Z,5X6FeZozNMgE2VRi3MJYjkkFK8SETtu2,6,8,3,0,3,0,4,0,18,2.5714285714285716,2,0.0,3,3,0,3,5,0,0,4,0,9,9,1
15,219,088SASUPOVYUGhoEly8vlrkGvRBJoNwp,7GRhBDsirIGkRZBtSMEzNTyDr2JQm4xx,48,304,60,90,9,222,30,1,716,102.28571428571429,6,0.0,168,60,65,9,136,222,25,30,1,302,414,0
16,255,O6WL6sxvoPCZnvTLyTPxdXbnpOz3wcJ4,7GRhBDsirIGkRZBtSMEzNTyDr2JQm4xx,46,88,22,46,17,4,12,0,189,27.0,6,0.0,26,22,35,17,62,4,11,12,0,100,89,0
17,272,BttUqG7aP3DWaBbIZQal1szLYpZUGYxR,5X6FeZozNMgE2VRi3MJYjkkFK8SETtu2,9,25,9,0,0,111,19,0,164,23.428571428571427,12,0.0,10,9,0,0,15,111,0,19,0,19,145,0
18,284,L9qMLlGWAeAI6zWAZIyJtn0wISNa3dxg,7GRhBDsirIGkRZBtSMEzNTyDr2JQm4xx,6,2,0,0,0,51,16,0,69,9.857142857142858,8,0.0,0,0,0,0,2,51,0,16,0,0,69,0
19,373,XUkSDdNHWcdano4aRGWpLSTI2IF8D1IH,7GRhBDsirIGkRZBtSMEzNTyDr2JQm4xx,28,71,20,66,0,6,17,0,180,25.714285714285715,5,0.0,30,20,55,0,41,6,11,17,0,105,75,0
20,433,PEDnL2c66c2DN92O9BTVM9D6p19gGbT6,7GRhBDsirIGkRZBtSMEzNTyDr2JQm4xx,3,6,5,0,0,0,6,0,17,2.4285714285714284,4,0.0,0,5,0,0,6,0,0,6,0,5,12,0
21,447,a2mtYqbDDrFbFqfnqiJDA0edBTN433cW,5X6FeZozNMgE2VRi3MJYjkkFK8SETtu2,2,0,0,0,0,0,2,0,2,0.2857142857142857,1,0.0,0,0,0,0,0,0,0,2,0,0,2,1
22,493,xNkIHhqS8GZXIqyoWwwS3ZeYfSmUsNJo,7GRhBDsirIGkRZBtSMEzNTyDr2JQm4xx,62,177,39,77,38,0,6,0,337,48.142857142857146,5,0.0,37,39,63,38,140,0,14,6,0,177,160,0
23,561,7LdIrvw2mKsGn0uQY4FG8nOBRXaRc1Ll,5X6FeZozNMgE2VRi3MJYjkkFK8SETtu2,37,95,24,46,22,4,15,0,206,29.428571428571427,3,0.0,57,24,35,22,38,4,11,15,0,138,68,0
24,721,8C8UfNr6FiHHVx6gYUCnrrjltp4r2EEf,5X6FeZozNMgE2VRi3MJYjkkFK8SETtu2,1,0,0,0,0,0,1,0,1,0.14285714285714285,1,0.0,0,0,0,0,0,0,0,1,0,0,1,1
25,744,4EmbBZZKe7031MRObaECOYTAuU5wz706,5X6FeZozNMgE2VRi3MJYjkkFK8SETtu2,8,9,4,0,4,0,2,0,19,2.7142857142857144,1,0.0,3,4,0,4,6,0,0,2,0,11,8,1
26,777,bLIF0ETNcg7fjkutu8YBWJptM3zxtu2Z,7GRhBDsirIGkRZBtSMEzNTyDr2JQm4xx,41,194,96,28,78,54,55,1,506,72.28571428571429,5,0.0,74,96,23,78,120,54,5,55,1,271,235,0
27,780,anqtRE1JbVfWjk9aVYgpNXBcTCoFe9WO,7GRhBDsirIGkRZBtSMEzNTyDr2JQm4xx,26,30,11,0,13,2,4,0,60,8.571428571428571,2,0.0,12,11,0,13,18,2,0,4,0,36,24,1
28,884,c3CVim2QZeSVk1wACFUHDmf9ZjEIwtuP,7GRhBDsirIGkRZBtSMEzNTyDr2JQm4xx,38,67,23,68,21,0,15,0,194,27.714285714285715,4,0.0,40,23,51,21,27,0,17,15,0,135,59,0
29,937,uQjl8NGtIQkRfoe9edBiMgtYYmdkzVXR,7GRhBDsirIGkRZBtSMEzNTyDr2JQm4xx,21,63,17,14,8,5,4,0,111,15.857142857142858,3,0.0,23,17,11,8,40,5,3,4,0,59,52,0
30,980,xMPFWnundpXFSWVcNEdsnGtZrrNJ2nna,5X6FeZozNMgE2VRi3MJYjkkFK8SETtu2,31,50,17,42,15,0,7,0,131,18.714285714285715,5,0.0,26,17,34,15,24,0,8,7,0,92,39,0
31,1072,9XUvtVr9N38jFL9d3KSBLe5NN0NI5Xv8,5X6FeZozNMgE2VRi3MJYjkkFK8SETtu2,1,0,0,0,0,0,2,0,2,0.2857142857142857,2,0.0,0,0,0,0,0,0,0,2,0,0,2,1
32,1134,Q3zkClKdiEJIkoKspwBuSNOwYXuxalAX,7GRhBDsirIGkRZBtSMEzNTyDr2JQm4xx,7,5,2,2,2,0,1,0,12,1.7142857142857142,1,0.0,2,2,2,2,3,0,0,1,0,8,4,1
33,1147,gCxbOVEJ7FeSqOiwKbB6HzPEL3I9x6ca,7GRhBDsirIGkRZBtSMEzNTyDr2JQm4xx,70,107,35,81,32,49,15,0,319,45.57142857142857,3,0.0,64,35,65,32,43,49,16,15,0,196,123,0
34,1153,y4C09JELGArMkj7EYnAM5VIhmCekYYoO,5X6FeZozNMgE2VRi3MJYjkkFK8SETtu2,4,4,1,0,0,0,2,0,7,1.0,1,0.0,0,1,0,0,4,0,0,2,0,1,6,1
35,1158,sO2CX3PTeWKMUH1S4FDuW0NDXEv7jZi0,5X6FeZozNMgE2VRi3MJYjkkFK8SETtu2,2,0,0,0,0,0,5,0,5,0.7142857142857143,3,0.0,0,0,0,0,0,0,0,5,0,0,5,0
36,1168,k27vxLq1BTsJ0FUzoqJDoc4NU2cleRtl,5X6FeZozNMgE2VRi3MJYjkkFK8SETtu2,15,21,14,1,8,3,6,0,53,7.571428571428571,3,0.0,2,14,1,8,19,3,0,6,0,25,28,1
37,1223,o7MfiO1X5Ui1AYG08PXFhTcXSShcuNhK,7GRhBDsirIGkRZBtSMEzNTyDr2JQm4xx,39,71,24,97,9,4,16,0,221,31.571428571428573,6,0.0,38,24,83,9,33,4,14,16,0,154,67,0
38,1227,RuOAeaUVW53IP9AqfP0jxaXbNkmd7lKN,7GRhBDsirIGkRZBtSMEzNTyDr2JQm4xx,37,43,4,20,18,0,20,0,105,15.0,4,0.0,21,4,14,18,22,0,6,20,0,57,48,0
39,1252,mZIaM3Lmux7GERtSm258BKPOSUYFlwyy,7GRhBDsirIGkRZBtSMEzNTyDr2JQm4xx,42,129,39,48,20,21,14,0,271,38.714285714285715,7,0.0,36,39,40,20,93,21,8,14,0,135,136,0
40,1260,beV03mdN2n7VoZwDqBMCKGETqOChXWUx,7GRhBDsirIGkRZBtSMEzNTyDr2JQm4xx,47,119,30,34,31,8,11,3,236,33.714285714285715,3,0.0,40,30,30,31,79,8,4,11,3,131,105,0
41,1289,zlsPhArkUaQ0CCdgZTO1797WJjiciHBk,7GRhBDsirIGkRZBtSMEzNTyDr2JQm4xx,78,149,55,102,64,27,17,0,414,59.142857142857146,3,0.0,52,55,83,64,97,27,19,17,0,254,160,0
42,1315,kNG9cn23NW62SZcqQSqyW9wMtO0GajdN,7GRhBDsirIGkRZBtSMEzNTyDr2JQm4xx,18,26,6,8,12,1,3,0,56,8.0,2,0.0,17,6,6,12,9,1,2,3,0,41,15,0
43,1328,wNK7ZCxNrr5YNZ14b6FlyAI0tpnOxaZ1,5X6FeZozNMgE2VRi3MJYjkkFK8SETtu2,20,21,2,8,11,0,3,0,45,6.428571428571429,2,0.0,12,2,7,11,9,0,1,3,0,32,13,1
44,1381,8W0dKFntzVy5gs8nAvO6lyUGOY4SLHwO,7GRhBDsirIGkRZBtSMEzNTyDr2JQm4xx,4,4,0,0,0,0,2,0,6,0.8571428571428571,1,0.0,0,0,0,0,4,0,0,2,0,0,6,1
45,1406,4zpruwryS301BhCHcVmaMPfD3MqLCk4h,5X6FeZozNMgE2VRi3MJYjkkFK8SETtu2,155,473,19,420,74,363,43,1,1393,199.0,16,0.0,224,19,324,74,249,363,96,43,1,641,752,0
46,1429,YbP52dGau1RB8H6599HdGbUKOVHWxxw1,7GRhBDsirIGkRZBtSMEzNTyDr2JQm4xx,65,151,45,96,44,4,4,0,344,49.142857142857146,3,0.0,95,45,63,44,56,4,33,4,0,247,97,0
47,1472,Qc7qhDYnMQ0se5itn8lyxOFjZ1zzyfhE,7GRhBDsirIGkRZBtSMEzNTyDr2JQm4xx,27,35,9,72,6,4,7,0,133,19.0,3,0.0,9,9,67,6,26,4,5,7,0,91,42,0
48,1491,lCyf3TRKW0i3K1mBgKz23OONMdCWqNsI,7GRhBDsirIGkRZBtSMEzNTyDr2JQm4xx,25,127,5,10,41,57,21,0,261,37.285714285714285,5,0.0,64,5,8,41,63,57,2,21,0,118,143,0
49,1502,1rAHmNrxrqnzHEQFMlydmQ968LsZW0oG,7GRhBDsirIGkRZBtSMEzNTyDr2JQm4xx,26,36,16,14,7,4,3,0,80,11.428571428571429,2,0.0,18,16,13,7,18,4,1,3,0,54,26,0
50,1521,IweRnM2AMTe7iVCwVnhk6LnMzajZZKLL,5X6FeZozNMgE2VRi3MJYjkkFK8SETtu2,102,251,16,225,75,0,1,0,568,81.14285714285714,18,0.0,173,16,170,75,78,0,55,1,0,434,134,0
51,1587,KKySZH8Vhrdd4z2bRf8FAPkHeGpE3JpX,5X6FeZozNMgE2VRi3MJYjkkFK8SETtu2,11,22,6,0,0,0,14,0,42,6.0,8,0.0,0,6,0,0,22,0,0,14,0,6,36,1
52,1594,argwyep7vMTLtgODtMQ0gxLXJNoq9csR,7GRhBDsirIGkRZBtSMEzNTyDr2JQm4xx,9,9,4,4,2,0,1,0,20,2.857142857142857,1,0.0,3,4,2,2,6,0,2,1,0,11,9,1
53,1617,Qq1YK4GwOtJbMK0bS6Tl6T4YUK2Aco59,5X6FeZozNMgE2VRi3MJYjkkFK8SETtu2,7,5,1,0,2,2,7,0,17,2.4285714285714284,2,0.0,2,1,0,2,3,2,0,7,0,5,12,1
54,1621,hM78zuTWvc2c2WdiFwwJZnLKCiMEzZwE,5X6FeZozNMgE2VRi3MJYjkkFK8SETtu2,98,101,29,122,25,11,13,0,301,43.0,2,0.0,66,29,116,25,35,11,6,13,0,236,65,1
55,1630,BN8wlDCfm46NLUt2P4jjdpJvase6IJc9,7GRhBDsirIGkRZBtSMEzNTyDr2JQm4xx,1,0,1,0,0,0,0,0,1,0.14285714285714285,1,0.0,0,1,0,0,0,0,0,0,0,1,0,1
56,1637,kgAOuue8T6gEPrjctmtIdYSqA3HuAr1W,5X6FeZozNMgE2VRi3MJYjkkFK8SETtu2,111,194,49,166,43,5,24,2,483,69.0,7,0.0,76,49,142,43,118,5,24,24,2,310,173,0
57,1651,iR2FNNwwVPECfrAWwxLxHcw8art5BqJj,7GRhBDsirIGkRZBtSMEzNTyDr2JQm4xx,5,4,1,0,0,2,3,0,10,1.4285714285714286,1,0.0,0,1,0,0,4,2,0,3,0,1,9,0
58,1687,oYErMzphr0xt2i2tKTG42QELMDaumLkL,5X6FeZozNMgE2VRi3MJYjkkFK8SETtu2,16,70,18,8,8,41,8,0,153,21.857142857142858,6,0.0,29,18,4,8,41,41,4,8,0,59,94,1
59,1688,Aw7PeIkLW9CDHbPpPSjrFUdtBaUuHUXm,5X6FeZozNMgE2VRi3MJYjkkFK8SETtu2,104,186,49,181,64,25,81,3,589,84.14285714285714,14,0.0,130,49,157,64,56,25,24,81,3,400,189,0
60,1697,LdIFMEp4Gma3xMuOQ2mpp1BJ3jFvB9c2,7GRhBDsirIGkRZBtSMEzNTyDr2JQm4xx,23,41,18,34,8,0,6,0,107,15.285714285714286,4,0.0,11,18,28,8,30,0,6,6,0,65,42,0
61,1708,PVIjAE0m0OeJAYOHc5gIjzktRijtXdS4,7GRhBDsirIGkRZBtSMEzNTyDr2JQm4xx,11,19,6,0,6,0,2,0,33,4.714285714285714,1,0.0,8,6,0,6,11,0,0,2,0,20,13,1
62,1749,AeXY5V6bNirN94d0GfQQQX1fFim1uqSr,5X6FeZozNMgE2VRi3MJYjkkFK8SETtu2,8,22,4,0,0,0,28,0,54,7.714285714285714,14,0.0,0,4,0,0,22,0,0,28,0,4,50,0
63,1755,qLrXKwo0jPQz47eKqKRnMiywjqEMxYd1,7GRhBDsirIGkRZBtSMEzNTyDr2JQm4xx,33,63,19,54,14,9,9,0,168,24.0,5,0.0,23,19,44,14,40,9,10,9,0,100,68,0
64,1788,ZsmdkNcVTPviDi6RDTzc0nnIspFki9Ld,7GRhBDsirIGkRZBtSMEzNTyDr2JQm4xx,19,33,14,6,9,0,3,0,65,9.285714285714286,2,0.0,15,14,3,9,18,0,3,3,0,41,24,0
65,1801,wy2vY5aiYwg0C5zglGAXrG2vaWLSbGC9,fbPkOYLVPtPgIt0MxizjfFJov3JbHyAi,9,16,2,0,0,19,8,2,47,6.714285714285714,2,0.0,1,2,0,0,15,19,0,8,2,3,44,1
66,1803,MlHPKmdi90dDdvX24jYoFlYEp8xS4RGn,fbPkOYLVPtPgIt0MxizjfFJov3JbHyAi,7,3,1,0,2,0,4,0,10,1.4285714285714286,2,0.0,0,1,0,2,3,0,0,4,0,3,7,1
67,1804,qRMvc4T53dkwmyfrgm76E5HygPUZo2vr,fbPkOYLVPtPgIt0MxizjfFJov3JbHyAi,30,72,35,11,14,19,17,0,168,24.0,7,0.0,17,35,11,14,55,19,0,17,0,77,91,0
68,1805,bPy7U6tSxZ9PLPL59Ctwyzm55OFpghJ1,fbPkOYLVPtPgIt0MxizjfFJov3JbHyAi,17,23,12,8,7,0,4,0,54,7.714285714285714,2,0.0,8,12,6,7,15,0,2,4,0,33,21,1
69,1806,NizqQaGjtKbKSjIbDqiqnHJildCbDYqn,fbPkOYLVPtPgIt0MxizjfFJov3JbHyAi,5,2,1,0,1,0,2,0,6,0.8571428571428571,1,0.0,0,1,0,1,2,0,0,2,0,2,4,1
70,1807,tvXgoUvFgvHT9SyDah6Ue0bK2mvIbZdy,fbPkOYLVPtPgIt0MxizjfFJov3JbHyAi,10,30,16,0,2,14,11,0,73,10.428571428571429,4,0.0,2,16,0,2,28,14,0,11,0,20,53,0
71,1811,466PN9Ek5iJamUCk5pZUwazAoeVcTj9e,fbPkOYLVPtPgIt0MxizjfFJov3JbHyAi,5,4,2,0,1,0,1,0,8,1.1428571428571428,1,0.0,1,2,0,1,3,0,0,1,0,4,4,1
72,1812,RAptfYJD6Shz4mBcU5ZDsgyIhOYMP4Cp,fbPkOYLVPtPgIt0MxizjfFJov3JbHyAi,12,18,7,4,8,0,16,1,54,7.714285714285714,3,0.0,6,7,3,8,12,0,1,16,1,24,30,1
73,1813,y28h4Mo8cYpNiUreeF5KoyNN24Uz0qpM,fbPkOYLVPtPgIt0MxizjfFJov3JbHyAi,5,7,3,0,3,0,2,0,15,2.142857142857143,1,0.0,3,3,0,3,4,0,0,2,0,9,6,1
74,1815,EZXku3HiM8iDGMBMsO2RMLHj3AEpHhBq,fbPkOYLVPtPgIt0MxizjfFJov3JbHyAi,7,7,0,0,0,9,3,0,19,2.7142857142857144,2,0.0,0,0,0,0,7,9,0,3,0,0,19,0
75,1816,uA8rfZuH0eMveW06zMXRELfenuAEs8xA,fbPkOYLVPtPgIt0MxizjfFJov3JbHyAi,1,0,0,0,0,0,1,0,1,0.14285714285714285,1,0.0,0,0,0,0,0,0,0,1,0,0,1,1
76,1817,bXMaalfz1ZqHKnJWw6VXCAoemSeuw45Q,fbPkOYLVPtPgIt0MxizjfFJov3JbHyAi,2,0,0,0,0,0,2,0,2,0.2857142857142857,1,0.0,0,0,0,0,0,0,0,2,0,0,2,0
77,1818,pIBqJuNsqTHvkyItKwWF6wLVRjCC6EZu,fbPkOYLVPtPgIt0MxizjfFJov3JbHyAi,10,24,6,6,8,0,1,0,45,6.428571428571429,2,0.0,14,6,6,8,10,0,0,1,0,34,11,1
78,1819,dg1Id0ZrueajjkgW22Z2GRzCY20snksW,fbPkOYLVPtPgIt0MxizjfFJov3JbHyAi,16,40,2,6,6,0,16,1,71,10.142857142857142,3,0.0,10,2,5,6,30,0,1,16,1,23,48,1
79,1821,dovSPYooNHmzLLH97Ddy4FG7Uxhw5XJl,fbPkOYLVPtPgIt0MxizjfFJov3JbHyAi,4,3,2,0,0,0,1,0,6,0.8571428571428571,1,0.0,0,2,0,0,3,0,0,1,0,2,4,1
80,1822,v1Dw0XqubI6wLrO1l5puralkQ2Aofi2j,fbPkOYLVPtPgIt0MxizjfFJov3JbHyAi,41,74,35,8,25,22,5,0,169,24.142857142857142,4,0.0,32,35,7,25,42,22,1,5,0,99,70,0
81,1823,SnTftKVvcKGSnHeK28R5spRYYXrrxUfB,fbPkOYLVPtPgIt0MxizjfFJov3JbHyAi,6,3,2,0,1,0,2,0,8,1.1428571428571428,1,0.0,0,2,0,1,3,0,0,2,0,3,5,1
82,1826,5BwluL2iwK0HgKhM8FgXFAWZQHsXkB8V,fbPkOYLVPtPgIt0MxizjfFJov3JbHyAi,24,45,2,8,2,8,7,0,72,10.285714285714286,3,0.0,9,2,8,2,36,8,0,7,0,21,51,0
83,1827,tfcv93vJo2GySad9H44VOkIGpLaZ6vJT,fbPkOYLVPtPgIt0MxizjfFJov3JbHyAi,38,78,42,35,22,67,12,1,257,36.714285714285715,6,0.0,22,42,32,22,56,67,3,12,1,118,139,0
84,1828,ybh9vQ6AAauphhK98Yeo3xSFaVKS2FRf,fbPkOYLVPtPgIt0MxizjfFJov3JbHyAi,7,6,1,0,1,2,7,0,17,2.4285714285714284,2,0.0,0,1,0,1,6,2,0,7,0,2,15,1
85,1829,xVFYGvJ70vgxoDUQx0bNSbGPI24xZu95,fbPkOYLVPtPgIt0MxizjfFJov3JbHyAi,21,45,16,8,7,0,8,0,84,12.0,1,0.0,1,16,6,7,44,0,2,8,0,30,54,1
86,1830,dtAiYXul2PNEQLlJvo6qGgg8Rx9ORbY3,fbPkOYLVPtPgIt0MxizjfFJov3JbHyAi,6,4,2,0,1,0,2,0,9,1.2857142857142858,1,0.0,1,2,0,1,3,0,0,2,0,4,5,1
87,1831,AJJNA78hu8M0U3iP5zWH5DCYqnQ40oOu,fbPkOYLVPtPgIt0MxizjfFJov3JbHyAi,1,0,0,0,0,0,1,0,1,0.14285714285714285,1,0.0,0,0,0,0,0,0,0,1,0,0,1,1
88,1832,IIfD9UPHJEG512IBEQGZwkZbr6HRQ12X,fbPkOYLVPtPgIt0MxizjfFJov3JbHyAi,6,3,1,0,1,0,2,0,7,1.0,1,0.0,1,1,0,1,2,0,0,2,0,3,4,1
89,1833,HmB7Zdy2V8HQu5G1BqmV4NlAuUyOhHRH,fbPkOYLVPtPgIt0MxizjfFJov3JbHyAi,5,2,1,0,1,0,2,0,6,0.8571428571428571,1,0.0,0,1,0,1,2,0,0,2,0,2,4,1
90,1835,EF6CIWnoQbVOAhqoxFyrjqUraX7wKiE2,fbPkOYLVPtPgIt0MxizjfFJov3JbHyAi,7,10,1,2,3,0,2,0,18,2.5714285714285716,1,0.0,7,1,2,3,3,0,0,2,0,13,5,1
91,1838,lWTcPPbtiIF5S9YQyk662ew20jbdMtY0,fbPkOYLVPtPgIt0MxizjfFJov3JbHyAi,8,6,4,0,3,0,3,0,16,2.2857142857142856,1,0.0,0,4,0,3,6,0,0,3,0,7,9,1
92,1842,Hie5jI1V7aqUGyRciLGioIx6C3WNaVxM,fbPkOYLVPtPgIt0MxizjfFJov3JbHyAi,8,6,4,0,3,0,3,0,16,2.2857142857142856,1,0.0,0,4,0,3,6,0,0,3,0,7,9,1
93,1844,FSrU0Uh74oBwrZKS577R74m2Rk2Lst8A,fbPkOYLVPtPgIt0MxizjfFJov3JbHyAi,10,10,7,0,3,2,2,0,24,3.4285714285714284,2,0.0,0,7,0,3,10,2,0,2,0,10,14,1
94,1845,oaoj9be4jW2Hot8wYgYrzLRvB0RU4KYy,fbPkOYLVPtPgIt0MxizjfFJov3JbHyAi,3,8,4,0,0,0,4,0,16,2.2857142857142856,4,0.0,0,4,0,0,8,0,0,4,0,4,12,0
95,1849,EwY7qFfJi5mALnvpyzKwHyXzi33SDVyS,fbPkOYLVPtPgIt0MxizjfFJov3JbHyAi,1,0,0,0,0,0,1,0,1,0.14285714285714285,1,0.0,0,0,0,0,0,0,0,1,0,0,1,1
96,1852,srnnzUkIJr2Uisav8LfnV4SnpbNw9CLp,fbPkOYLVPtPgIt0MxizjfFJov3JbHyAi,3,2,1,0,0,0,1,0,4,0.5714285714285714,1,0.0,0,1,0,0,2,0,0,1,0,1,3,1
97,1856,ScOtpH9Zf7UmvFfXBxi9XtXFmhGO9CpS,fbPkOYLVPtPgIt0MxizjfFJov3JbHyAi,18,119,51,2,19,6,26,1,224,32.0,4,0.0,10,51,2,19,109,6,0,26,1,82,142,0
98,1859,renLevNnf6MkkqeGAoBcuGxp4Cuebb9X,fbPkOYLVPtPgIt0MxizjfFJov3JbHyAi,12,10,8,0,3,0,3,0,24,3.4285714285714284,1,0.0,0,8,0,3,10,0,0,3,0,11,13,0
99,1861,wHW6M4zJx3WQvnkWxa8NK7bA13uSffjE,fbPkOYLVPtPgIt0MxizjfFJov3JbHyAi,34,102,42,12,33,35,25,0,249,35.57142857142857,6,0.0,43,42,12,33,59,35,0,25,0,130,119,0
100,1862,w85QVmINOIyrXRzegh8uuBeGTw3K4uG8,fbPkOYLVPtPgIt0MxizjfFJov3JbHyAi,7,8,4,0,2,0,1,0,15,2.142857142857143,1,0.0,3,4,0,2,5,0,0,1,0,9,6,0
101,1863,2HxHgYZUxjcTVAkRZXALZPpAKp12AIkW,fbPkOYLVPtPgIt0MxizjfFJov3JbHyAi,54,61,33,33,25,9,8,1,170,24.285714285714285,4,0.0,19,33,30,25,42,9,3,8,1,107,63,1
102,1864,FRQoIHmdY13z6FOe616T4ApTF4hqzTvO,fbPkOYLVPtPgIt0MxizjfFJov3JbHyAi,1,0,0,0,0,0,2,0,2,0.2857142857142857,1,0.0,0,0,0,0,0,0,0,2,0,0,2,1
103,1865,UA8vU3s92g3lXc62U363PEO0xor6Mpeg,fbPkOYLVPtPgIt0MxizjfFJov3JbHyAi,18,27,13,2,10,0,5,0,57,8.142857142857142,5,0.0,3,13,2,10,24,0,0,5,0,28,29,0
104,1867,ZfVW8NtYbpP20iy3ae2NWyUMggR9fJnX,fbPkOYLVPtPgIt0MxizjfFJov3JbHyAi,6,1,1,0,1,2,3,0,8,1.1428571428571428,1,0.0,0,1,0,1,1,2,0,3,0,2,6,1
105,1869,F2lMVOvthfQUdLTXVbrysvFvsOo64vSi,fbPkOYLVPtPgIt0MxizjfFJov3JbHyAi,1,0,0,0,0,0,1,0,1,0.14285714285714285,1,0.0,0,0,0,0,0,0,0,1,0,0,1,1
106,1870,hl0OrMfg8qb0yyqeozXaj4TvTbuGpido,fbPkOYLVPtPgIt0MxizjfFJov3JbHyAi,5,3,1,0,1,0,2,0,7,1.0,1,0.0,1,1,0,1,2,0,0,2,0,3,4,1
107,1871,h6FvnvKLn3PYeo7ymsUxV04MtM6t8VXd,fbPkOYLVPtPgIt0MxizjfFJov3JbHyAi,6,5,3,0,2,0,2,0,12,1.7142857142857142,1,0.0,0,3,0,2,5,0,0,2,0,5,7,0
108,1872,IEhRIW6aJG3VEfNQv5VS8sa7hXLIMUWs,fbPkOYLVPtPgIt0MxizjfFJov3JbHyAi,5,4,2,0,2,0,3,0,11,1.5714285714285714,2,0.0,0,2,0,2,4,0,0,3,0,4,7,1
109,1873,kkiICQcdDTiO8OFUMgn7HGjTwIHaL29F,fbPkOYLVPtPgIt0MxizjfFJov3JbHyAi,12,24,12,0,5,0,14,1,56,8.0,2,0.0,6,12,0,5,18,0,0,14,1,23,33,1
110,1874,PPK7S6McpqG1xker7o77HjrFULvz49Xg,fbPkOYLVPtPgIt0MxizjfFJov3JbHyAi,1,0,0,0,0,0,1,0,1,0.14285714285714285,1,0.0,0,0,0,0,0,0,0,1,0,0,1,1
111,1875,NmOI6yuIgn0ShW8ps51AeOISH4CX20PY,fbPkOYLVPtPgIt0MxizjfFJov3JbHyAi,6,5,0,0,0,0,3,0,8,1.1428571428571428,1,0.0,0,0,0,0,5,0,0,3,0,0,8,1
112,1876,fB8dnTYj30CwHncKJXhBKyfe0bv6lATH,fbPkOYLVPtPgIt0MxizjfFJov3JbHyAi,1,0,0,0,0,0,1,0,1,0.14285714285714285,1,0.0,0,0,0,0,0,0,0,1,0,0,1,1
113,1878,0UPVw8ecIiIpfGXqAIUJXTbKxiiOJqXC,fbPkOYLVPtPgIt0MxizjfFJov3JbHyAi,18,25,9,2,9,0,3,0,48,6.857142857142857,1,0.0,3,9,2,9,22,0,0,3,0,23,25,1
114,1879,29lVEZFZAjCojpdMgxYvJN3otXj3PLWe,fbPkOYLVPtPgIt0MxizjfFJov3JbHyAi,38,69,21,14,11,35,17,10,177,25.285714285714285,4,0.0,12,21,13,11,57,35,1,17,10,57,120,0
115,1880,DSWjfYVjIvEWi0MzNQ04NT3mnhbcHkJI,fbPkOYLVPtPgIt0MxizjfFJov3JbHyAi,9,6,5,0,4,0,1,0,16,2.2857142857142856,1,0.0,0,5,0,4,6,0,0,1,0,9,7,0
116,1882,QphSShJ8h2yJ72VG9nEiSoDfHxRIzVu7,fbPkOYLVPtPgIt0MxizjfFJov3JbHyAi,5,2,1,0,1,0,2,0,6,0.8571428571428571,1,0.0,0,1,0,1,2,0,0,2,0,2,4,1
117,1883,N9Ha8uFhXV9Cw5jdp4DZ3nwxS00UsWF7,fbPkOYLVPtPgIt0MxizjfFJov3JbHyAi,5,2,1,0,1,0,2,0,6,0.8571428571428571,1,0.0,0,1,0,1,2,0,0,2,0,2,4,1
118,1886,C8YNpI6QedFpxBsm2SSsdYc3sr1kuXhE,fbPkOYLVPtPgIt0MxizjfFJov3JbHyAi,11,6,5,0,2,0,3,0,16,2.2857142857142856,1,0.0,0,5,0,2,6,0,0,3,0,7,9,1
119,1888,lbgTV2YMskSv2TX4EXpaazpMVWfsftEV,fbPkOYLVPtPgIt0MxizjfFJov3JbHyAi,6,3,2,0,1,0,2,0,8,1.1428571428571428,1,0.0,0,2,0,1,3,0,0,2,0,3,5,0
120,1891,s6iksgptFmyh2vfiarKdJkiKnp6RLi3f,fbPkOYLVPtPgIt0MxizjfFJov3JbHyAi,7,7,3,0,1,11,4,0,26,3.7142857142857144,2,0.0,0,3,0,1,7,11,0,4,0,4,22,0
121,1893,oKLMQAZTIOtP37CLM9yXiFLXKHfYljGQ,fbPkOYLVPtPgIt0MxizjfFJov3JbHyAi,8,5,4,0,3,0,2,0,14,2.0,1,0.0,0,4,0,3,5,0,0,2,0,7,7,0
122,1894,Vc4rFh1HQZiO6qLgOrealEeiZYYPbmOY,fbPkOYLVPtPgIt0MxizjfFJov3JbHyAi,24,39,19,32,9,12,5,0,116,16.571428571428573,4,0.0,6,19,26,9,33,12,6,5,0,60,56,0
123,1895,OSy4QIw7JPCY2rc20jXdh8AKuQUlvuiP,fbPkOYLVPtPgIt0MxizjfFJov3JbHyAi,1,0,0,0,0,0,1,0,1,0.14285714285714285,1,0.0,0,0,0,0,0,0,0,1,0,0,1,1
124,1899,CXDFvBGg10x2RDdl5BC09Fv76dN9FJm7,fbPkOYLVPtPgIt0MxizjfFJov3JbHyAi,25,63,23,28,10,27,11,0,162,23.142857142857142,3,0.0,20,23,26,10,43,27,2,11,0,79,83,0
125,1901,d4vFRav8ffA9IVzingBKcuQRy85TQDkU,fbPkOYLVPtPgIt0MxizjfFJov3JbHyAi,2,0,0,0,0,0,2,0,2,0.2857142857142857,1,0.0,0,0,0,0,0,0,0,2,0,0,2,1
126,1902,Kd69M9W1nim0woqVm1QxfVaSebsYtFIh,fbPkOYLVPtPgIt0MxizjfFJov3JbHyAi,18,32,12,9,9,2,12,1,77,11.0,2,0.0,9,12,9,9,23,2,0,12,1,39,38,0
127,1903,TkQQvYTOoXkFjbJKIO2v3OeQa3imG4fA,fbPkOYLVPtPgIt0MxizjfFJov3JbHyAi,32,50,20,12,21,22,7,0,132,18.857142857142858,4,0.0,22,20,11,21,28,22,1,7,0,74,58,0
128,1906,9axGajSG0OSppcbacnyHhfFBFAa9eoTG,fbPkOYLVPtPgIt0MxizjfFJov3JbHyAi,7,5,2,0,0,5,6,1,19,2.7142857142857144,1,0.0,2,2,0,0,3,5,0,6,1,4,15,1
129,1909,ZV8DsXL77GGEtffNT3JZQjNfaNYGufcp,fbPkOYLVPtPgIt0MxizjfFJov3JbHyAi,1,0,0,0,0,0,1,0,1,0.14285714285714285,1,0.0,0,0,0,0,0,0,0,1,0,0,1,1
130,1910,CtgLRd04Cnda49EWlN19NulXjkuBNDXd,fbPkOYLVPtPgIt0MxizjfFJov3JbHyAi,39,64,14,28,15,21,6,0,148,21.142857142857142,3,0.0,25,14,25,15,39,21,3,6,0,79,69,0
131,1911,vW12OyfPXCTKZvYAAAyAdgYsdUu0MHKL,fbPkOYLVPtPgIt0MxizjfFJov3JbHyAi,2,0,0,0,0,0,3,0,3,0.42857142857142855,1,0.0,0,0,0,0,0,0,0,3,0,0,3,1
132,1913,OXDIjQPBiuWpB7PdzfniEtiITaq40Kxq,fbPkOYLVPtPgIt0MxizjfFJov3JbHyAi,8,8,4,0,3,0,5,0,20,2.857142857142857,2,0.0,0,4,0,3,8,0,0,5,0,7,13,1
133,1915,FCTGjFMpPr9Ardf2214VmZ4FrZJLQUjd,fbPkOYLVPtPgIt0MxizjfFJov3JbHyAi,1,0,0,0,0,0,1,0,1,0.14285714285714285,1,0.0,0,0,0,0,0,0,0,1,0,0,1,1
134,1917,Q7l1wAYa10mkA3laPizDBbeQPyCyYqgB,fbPkOYLVPtPgIt0MxizjfFJov3JbHyAi,1,0,0,0,0,0,1,0,1,0.14285714285714285,1,0.0,0,0,0,0,0,0,0,1,0,0,1,1
135,1918,rJw2uGGbceq8fztznJ85JmFc8aj1HUrB,fbPkOYLVPtPgIt0MxizjfFJov3JbHyAi,1,0,0,0,0,0,1,0,1,0.14285714285714285,1,0.0,0,0,0,0,0,0,0,1,0,0,1,1
136,1922,ddq0oVEKEWGKWnbGS4cfbzVZj0yFimxw,fbPkOYLVPtPgIt0MxizjfFJov3JbHyAi,16,11,8,0,5,0,4,0,28,4.0,2,0.0,0,8,0,5,11,0,0,4,0,13,15,0
137,1923,UgNr6maIjrTPAjpLAvEGxJ6P02hrpr0j,fbPkOYLVPtPgIt0MxizjfFJov3JbHyAi,33,45,17,26,12,0,5,0,105,15.0,3,0.0,11,17,25,12,34,0,1,5,0,65,40,0
138,1926,5ZyvCd3AP7a8azCiLN5JfLAP53iZpAyD,fbPkOYLVPtPgIt0MxizjfFJov3JbHyAi,1,0,0,0,0,0,1,0,1,0.14285714285714285,1,0.0,0,0,0,0,0,0,0,1,0,0,1,1
139,1928,qQzK8soi99yuu1apkrTsdydZJSsJ4gfB,fbPkOYLVPtPgIt0MxizjfFJov3JbHyAi,12,18,9,8,4,9,7,2,57,8.142857142857142,3,0.0,7,9,6,4,11,9,2,7,2,26,31,1
140,1929,v9mjKPlqj9n2M1xFKzFtpQVo3yi6HxGV,fbPkOYLVPtPgIt0MxizjfFJov3JbHyAi,8,5,4,0,2,0,1,0,12,1.7142857142857142,1,0.0,0,4,0,2,5,0,0,1,0,6,6,1
141,1931,gUUf0vmNg6gEFqYol91VXQX0Cn6Mly3v,fbPkOYLVPtPgIt0MxizjfFJov3JbHyAi,30,50,28,12,17,11,4,0,122,17.428571428571427,3,0.0,14,28,12,17,36,11,0,4,0,71,51,0
142,1932,0QuoKrP2mZHT58SMwYhNVh8QIa2Bx3jw,fbPkOYLVPtPgIt0MxizjfFJov3JbHyAi,37,53,38,0,23,0,5,0,119,17.0,3,0.0,0,38,0,23,53,0,0,5,0,61,58,0
143,1933,mNLR1O6gqXF6Zqi4uIf130gITni9gN1A,fbPkOYLVPtPgIt0MxizjfFJov3JbHyAi,23,21,12,11,7,0,3,0,54,7.714285714285714,2,0.0,6,12,11,7,15,0,0,3,0,36,18,0
144,1934,vLkHxueYkg4zIw30PVDRmNNDttOLjZ8Q,fbPkOYLVPtPgIt0MxizjfFJov3JbHyAi,8,8,3,0,4,0,2,0,17,2.4285714285714284,1,0.0,2,3,0,4,6,0,0,2,0,9,8,1
145,1936,YLLq9nLffaF9TP2dJ2OpMZwhKv5cSnoB,fbPkOYLVPtPgIt0MxizjfFJov3JbHyAi,6,10,5,0,1,1,1,0,18,2.5714285714285716,1,0.0,0,5,0,1,10,1,0,1,0,6,12,1
146,1938,TWWcfQljyWhMSOCysnI4EAWbqXZ7VNJj,fbPkOYLVPtPgIt0MxizjfFJov3JbHyAi,10,7,2,6,3,0,6,1,25,3.5714285714285716,1,0.0,4,2,5,3,3,0,1,6,1,14,11,1
147,1939,GpNHaNdhxCDdSQ7DpRSuzDihSlnkIh3f,fbPkOYLVPtPgIt0MxizjfFJov3JbHyAi,5,1,1,0,1,0,2,0,5,0.7142857142857143,1,0.0,0,1,0,1,1,0,0,2,0,2,3,1
148,1940,a7VEIs7rhyootOFOxpi9zJBtM0N2POJ5,fbPkOYLVPtPgIt0MxizjfFJov3JbHyAi,1,0,0,0,0,0,1,0,1,0.14285714285714285,1,0.0,0,0,0,0,0,0,0,1,0,0,1,1
149,1941,ieB6czVULq4QvL1aVq2UtWwf2TXRyCrf,fbPkOYLVPtPgIt0MxizjfFJov3JbHyAi,5,3,1,0,1,0,2,0,7,1.0,1,0.0,0,1,0,1,3,0,0,2,0,2,5,1
150,1943,S1MqxZA8wNnn30FSBfJ8uK4pTicj2Ko9,fbPkOYLVPtPgIt0MxizjfFJov3JbHyAi,27,49,33,10,21,9,6,0,128,18.285714285714285,5,0.0,9,33,10,21,40,9,0,6,0,73,55,0
151,1945,KM3IAf1A23ZYRH7BjTN3a6rzUKD52rd8,fbPkOYLVPtPgIt0MxizjfFJov3JbHyAi,2,0,0,0,0,0,4,0,4,0.5714285714285714,2,0.0,0,0,0,0,0,0,0,4,0,0,4,1
152,1947,bopoENydvuKHGXiexTKfIqhYixOE9yJX,fbPkOYLVPtPgIt0MxizjfFJov3JbHyAi,1,0,0,0,0,0,1,0,1,0.14285714285714285,1,0.0,0,0,0,0,0,0,0,1,0,0,1,1
153,1948,Ftq38qAgSBQ9kcYE1HcFamzukTfMOPPE,fbPkOYLVPtPgIt0MxizjfFJov3JbHyAi,8,10,6,0,6,2,5,0,29,4.142857142857143,1,0.0,2,6,0,6,8,2,0,5,0,14,15,1
154,1949,2AW6aH0SqKYjpe5J2qxXqfKxHscq7JWf,fbPkOYLVPtPgIt0MxizjfFJov3JbHyAi,1,0,0,0,0,0,1,0,1,0.14285714285714285,1,0.0,0,0,0,0,0,0,0,1,0,0,1,1
155,1950,yGZoU4KfSyze8yifx7Q3tvuL6vVequyW,fbPkOYLVPtPgIt0MxizjfFJov3JbHyAi,9,5,2,0,2,0,4,1,14,2.0,1,0.0,0,2,0,2,5,0,0,4,1,4,10,1
156,1951,dq3iqibSI5OSwCbWRZv7tfgbiuLwOgjh,fbPkOYLVPtPgIt0MxizjfFJov3JbHyAi,19,16,11,0,6,0,3,0,36,5.142857142857143,3,0.0,0,11,0,6,16,0,0,3,0,17,19,0
157,1952,GHASD1jXGkBlTg5fu3oCYk3lClJihiOZ,fbPkOYLVPtPgIt0MxizjfFJov3JbHyAi,8,5,4,0,3,0,2,0,14,2.0,1,0.0,0,4,0,3,5,0,0,2,0,7,7,1
158,1966,mR9Awu9GGhq6cpZDsN1vhsOMBBjHJTwu,5Gyp41oLVo7Gg7vF4vpmggWP5MU70QO6,20,45,18,12,9,3,14,1,102,14.571428571428571,4,0.0,12,18,6,9,33,3,6,14,1,45,57,0
159,1967,viuKt4GgrX0rYL5EpHoxJbsiC9TblSuk,5Gyp41oLVo7Gg7vF4vpmggWP5MU70QO6,43,185,100,3,48,49,59,0,444,63.42857142857143,11,0.0,29,100,3,48,156,49,0,59,0,180,264,0
160,1971,9W6HDa8nbr3i4rkBKbOa5qCJz73HRO2D,5Gyp41oLVo7Gg7vF4vpmggWP5MU70QO6,7,4,1,0,1,0,6,0,12,1.7142857142857142,4,0.0,0,1,0,1,4,0,0,6,0,2,10,0
161,2007,WwTMXNtl4b2JCcFe3lwVpQGXGiLdPZkR,5Gyp41oLVo7Gg7vF4vpmggWP5MU70QO6,48,145,56,38,39,36,28,1,343,49.0,13,0.0,44,56,31,39,101,36,7,28,1,170,173,0
162,2010,Wb6aI9r02EpZ5D98i2k8BFs1ifi8zKrN,5Gyp41oLVo7Gg7vF4vpmggWP5MU70QO6,31,44,22,18,10,12,8,0,114,16.285714285714285,3,0.0,13,22,11,10,31,12,7,8,0,56,58,1
163,2020,MT2eJtF59AVNdUs7mwFqputROb2HgEm3,5Gyp41oLVo7Gg7vF4vpmggWP5MU70QO6,47,84,39,40,27,2,17,2,211,30.142857142857142,5,0.0,34,39,26,27,50,2,14,17,2,126,85,0
164,2050,AAAvWauitKfXD0xRpNsfpOKQu223kCXG,5Gyp41oLVo7Gg7vF4vpmggWP5MU70QO6,7,11,5,0,0,0,8,0,24,3.4285714285714284,1,0.0,0,5,0,0,11,0,0,8,0,5,19,1
165,2052,YdQETnM22WB3LHnbv3lrj7jNNeRZbGOv,5Gyp41oLVo7Gg7vF4vpmggWP5MU70QO6,24,40,21,8,11,4,16,0,100,14.285714285714286,9,0.0,8,21,5,11,32,4,3,16,0,45,55,1
166,2090,EFLqetAC0SbN4lqTSizhSOwWBqOW5pzD,5Gyp41oLVo7Gg7vF4vpmggWP5MU70QO6,30,196,101,49,0,8,49,0,403,57.57142857142857,10,0.0,52,101,46,0,144,8,3,49,0,199,204,0
167,2095,tmFoPNpDaAjHzJfZZJ0IMTgD0xB27hlJ,5Gyp41oLVo7Gg7vF4vpmggWP5MU70QO6,40,114,56,16,15,210,12,1,424,60.57142857142857,10,0.0,29,56,10,15,85,210,6,12,1,110,314,0
168,2100,HL02PKMnOIDdiDp79NgTxbZJpjcKEWWT,5Gyp41oLVo7Gg7vF4vpmggWP5MU70QO6,41,155,79,41,19,31,45,6,376,53.714285714285715,14,0.0,24,79,36,19,131,31,5,45,6,158,218,0
169,2109,HAAyQYNYY3ULmqhNC56bxv5FSwyMVoqP,5Gyp41oLVo7Gg7vF4vpmggWP5MU70QO6,68,275,104,91,56,81,50,2,659,94.14285714285714,12,0.0,105,104,81,56,170,81,10,50,2,346,313,0
170,2110,uLcaXBNyG83zLSyGLz4DRe4DcdelO0kq,5Gyp41oLVo7Gg7vF4vpmggWP5MU70QO6,6,4,2,0,1,0,4,0,11,1.5714285714285714,2,0.0,0,2,0,1,4,0,0,4,0,3,8,1
171,2114,sOkc0wEXSSLpxtxlqjZObJqg94IyLpuY,5Gyp41oLVo7Gg7vF4vpmggWP5MU70QO6,65,409,174,50,96,22,97,2,850,121.42857142857143,20,0.0,128,174,42,96,281,22,8,97,2,440,410,0
172,2128,RKrHiM5fV6iRyDSg9nuc5aF1dnWrhOU4,5Gyp41oLVo7Gg7vF4vpmggWP5MU70QO6,34,82,38,28,32,5,12,0,197,28.142857142857142,9,0.0,36,38,17,32,46,5,11,12,0,123,74,1
173,2131,WyF6ThNl8T4ZuBisCQw24oD2MtmL93xx,5Gyp41oLVo7Gg7vF4vpmggWP5MU70QO6,32,74,29,26,22,108,29,1,289,41.285714285714285,6,0.0,28,29,16,22,46,108,10,29,1,95,194,0
174,2134,jZihjvtYP7amDpkoC0oh2f8rmnfsHP9b,5Gyp41oLVo7Gg7vF4vpmggWP5MU70QO6,21,42,19,16,4,0,5,0,86,12.285714285714286,3,0.0,9,19,12,4,33,0,4,5,0,44,42,1
175,2153,3IgwuZBiVdgdYRQ9ySaEvpMizbjCJFS0,5Gyp41oLVo7Gg7vF4vpmggWP5MU70QO6,36,79,36,27,18,19,29,0,208,29.714285714285715,8,0.0,12,36,22,18,67,19,5,29,0,88,120,0
176,2160,XY4zkM1XF8dydjqcvDmQyLNW1UDj6PeN,5Gyp41oLVo7Gg7vF4vpmggWP5MU70QO6,53,153,79,65,32,53,40,0,422,60.285714285714285,15,0.0,35,79,52,32,118,53,13,40,0,198,224,0
177,2179,MkhWkWrDBg7jFp3XklVC8uZQ46nAon3u,5Gyp41oLVo7Gg7vF4vpmggWP5MU70QO6,15,25,12,6,4,6,7,0,60,8.571428571428571,2,0.0,3,12,4,4,22,6,2,7,0,23,37,0
178,2197,nwB8ZmEmfTKf0a8lq14Fk2ak05qhI5uT,5Gyp41oLVo7Gg7vF4vpmggWP5MU70QO6,5,2,1,0,1,0,2,0,6,0.8571428571428571,1,0.0,0,1,0,1,2,0,0,2,0,2,4,1
179,2201,Yni8rK7aKtRJ53sTltPsG2WLebXl61tk,5Gyp41oLVo7Gg7vF4vpmggWP5MU70QO6,74,190,105,35,57,0,36,1,424,60.57142857142857,26,0.0,51,105,31,57,139,0,4,36,1,244,180,0
180,2213,4DUZBFD9Fwl71r8i0SB6pVZCzmNoxKnn,5Gyp41oLVo7Gg7vF4vpmggWP5MU70QO6,61,283,91,29,30,55,71,0,559,79.85714285714286,26,0.0,49,91,26,30,234,55,3,71,0,196,363,0
181,2233,IAOTVxG7e06ArppQIZcVBCeppiZS52Zi,5Gyp41oLVo7Gg7vF4vpmggWP5MU70QO6,7,3,2,0,2,0,2,0,9,1.2857142857142858,1,0.0,0,2,0,2,3,0,0,2,0,4,5,1
182,2251,i9KniaV1B46Y9GkyuEOezIhgC4L1zbPS,5Gyp41oLVo7Gg7vF4vpmggWP5MU70QO6,67,429,190,98,56,148,105,8,1034,147.71428571428572,24,0.0,88,190,87,56,341,148,11,105,8,421,613,0
183,2262,dgFOOUSNfQK8xIrT47Av0Q04bBFeE21W,5Gyp41oLVo7Gg7vF4vpmggWP5MU70QO6,18,41,16,15,10,3,10,0,95,13.571428571428571,4,0.0,16,16,10,10,25,3,5,10,0,52,43,1
184,2265,WdeZz7OyQpyfXtfu6OVEuvlOTlAEPRGd,5Gyp41oLVo7Gg7vF4vpmggWP5MU70QO6,36,173,9,29,15,19,32,1,278,39.714285714285715,14,0.0,34,9,23,15,139,19,6,32,1,81,197,0
185,2292,fCcstm1UmVtNkQjxvmynrnOTNEshrQAy,5Gyp41oLVo7Gg7vF4vpmggWP5MU70QO6,28,53,16,16,11,0,9,0,105,15.0,10,0.0,9,16,11,11,44,0,5,9,0,47,58,0
186,2296,foQ0qrxdc5pW7WTJ6CqhvwoYucCLIx5q,5Gyp41oLVo7Gg7vF4vpmggWP5MU70QO6,4,0,0,0,0,1,3,0,4,0.5714285714285714,1,0.0,0,0,0,0,0,1,0,3,0,0,4,1
187,2301,XrXHtqckCj56x4VbN0hXe9QBiRIdyn6o,5Gyp41oLVo7Gg7vF4vpmggWP5MU70QO6,18,22,10,2,12,0,6,1,53,7.571428571428571,2,0.0,7,10,1,12,15,0,1,6,1,30,23,1
188,2321,7mGdRiMzSbTybRB8CqLZKk01SINUa2wl,5Gyp41oLVo7Gg7vF4vpmggWP5MU70QO6,6,4,2,0,3,0,1,0,10,1.4285714285714286,1,0.0,1,2,0,3,3,0,0,1,0,6,4,1
189,2364,vMVabvpkzSgKBRSkZq6rXDzalfa01CME,5Gyp41oLVo7Gg7vF4vpmggWP5MU70QO6,1,0,0,0,0,0,1,0,1,0.14285714285714285,1,0.0,0,0,0,0,0,0,0,1,0,0,1,1
190,2385,CE7hlTWnMpoldcHVRqlfbEgzp5iUVo4d,5Gyp41oLVo7Gg7vF4vpmggWP5MU70QO6,51,164,70,52,69,21,60,6,442,63.142857142857146,15,0.0,62,70,38,69,102,21,14,60,6,239,203,0
191,2386,ZDVmuYiPoGm0gu1bR2BaE1soF6dU5v1W,5Gyp41oLVo7Gg7vF4vpmggWP5MU70QO6,32,122,74,50,2,92,17,3,360,51.42857142857143,7,0.0,28,74,42,2,94,92,8,17,3,146,214,1
192,2404,PZR92F4vjGduhGUb6Sp8QbsK0UCWUlwa,5Gyp41oLVo7Gg7vF4vpmggWP5MU70QO6,10,7,3,0,2,0,6,0,18,2.5714285714285716,2,0.0,0,3,0,2,7,0,0,6,0,5,13,1
193,2407,R3kslje9mLlSM7EKRZmEPd7ZEdwrTHI6,5Gyp41oLVo7Gg7vF4vpmggWP5MU70QO6,19,38,24,0,11,0,12,0,85,12.142857142857142,6,0.0,1,24,0,11,37,0,0,12,0,36,49,1
194,2415,qzW6QZMtIcHTMNtiHaANlHSnvdzPgQYz,5Gyp41oLVo7Gg7vF4vpmggWP5MU70QO6,9,7,5,0,3,2,10,4,31,4.428571428571429,1,0.0,0,5,0,3,7,2,0,10,4,8,23,1
195,2425,cS4j36iYvYOHHK4d6wWz4Cr0lyqpITjd,5Gyp41oLVo7Gg7vF4vpmggWP5MU70QO6,7,4,2,0,3,0,3,0,12,1.7142857142857142,1,0.0,1,2,0,3,3,0,0,3,0,6,6,1
196,2430,NxaQovohNGJ7YH62gDXL54m0ee7NBEMY,5Gyp41oLVo7Gg7vF4vpmggWP5MU70QO6,5,2,1,0,1,0,2,0,6,0.8571428571428571,1,0.0,0,1,0,1,2,0,0,2,0,2,4,1
197,2449,wN3D5V0PcvlAmjJOpaJoryMWfNHdUYCU,5Gyp41oLVo7Gg7vF4vpmggWP5MU70QO6,9,7,3,0,1,20,21,57,109,15.571428571428571,2,0.0,0,3,0,1,7,20,0,21,57,4,105,0
198,2455,xV9PPe0O5JVt8N996wddaP95GExzbGyi,5Gyp41oLVo7Gg7vF4vpmggWP5MU70QO6,1,0,0,0,0,0,1,0,1,0.14285714285714285,1,0.0,0,0,0,0,0,0,0,1,0,0,1,0
199,2472,1tZVjYbxh9CHPwBYYql5LZw9fjNAGkzN,5Gyp41oLVo7Gg7vF4vpmggWP5MU70QO6,31,141,80,39,36,32,45,11,384,54.857142857142854,17,0.0,20,80,25,36,121,32,14,45,11,161,223,0
200,2495,jRtgy99WPnw21snDCZC48Y86Vr0MWh80,5Gyp41oLVo7Gg7vF4vpmggWP5MU70QO6,5,2,1,0,1,0,2,0,6,0.8571428571428571,1,0.0,0,1,0,1,2,0,0,2,0,2,4,1
201,2505,YjJnZDIbpTQQAvSZDN4eLLymiczln0Oe,5Gyp41oLVo7Gg7vF4vpmggWP5MU70QO6,6,3,1,0,1,0,4,0,9,1.2857142857142858,2,0.0,0,1,0,1,3,0,0,4,0,2,7,1
202,2516,RgSsBQ3nqtDrfLpSobr2YuUHRErLTR4s,5Gyp41oLVo7Gg7vF4vpmggWP5MU70QO6,46,172,101,25,36,6,31,2,373,53.285714285714285,16,0.0,41,101,18,36,131,6,7,31,2,196,177,0
203,2534,ZhTCqX8GMUcn0a0betuEauHNuCk1aRhm,5Gyp41oLVo7Gg7vF4vpmggWP5MU70QO6,95,549,246,175,64,724,222,18,1998,285.42857142857144,30,0.0,177,246,150,64,372,724,25,222,18,637,1361,0
204,2559,HbDaABEakQmE8DQEoFoIphu2SH13rFRy,5Gyp41oLVo7Gg7vF4vpmggWP5MU70QO6,1,0,0,0,0,0,1,0,1,0.14285714285714285,1,0.0,0,0,0,0,0,0,0,1,0,0,1,1
205,2560,oJ9j9ejTgKixczg3tSE8Sg8DPI7YQpJq,5Gyp41oLVo7Gg7vF4vpmggWP5MU70QO6,39,156,87,43,34,23,34,7,384,54.857142857142854,19,0.0,37,87,37,34,119,23,6,34,7,195,189,0
206,2571,RJ1FVW8gXQIpK321uzh2Sh69ojlsqnvg,5Gyp41oLVo7Gg7vF4vpmggWP5MU70QO6,26,121,65,31,13,42,54,11,337,48.142857142857146,11,0.0,23,65,23,13,98,42,8,54,11,124,213,0
207,2577,IAvuP4GGmvnNj3Zisz3jDfo3mSmXiJSb,5Gyp41oLVo7Gg7vF4vpmggWP5MU70QO6,9,13,6,0,5,0,13,1,38,5.428571428571429,5,0.0,2,6,0,5,11,0,0,13,1,13,25,1
208,2600,bPuqI7fU2OAyevO36pU6vztTiLxuvJ4j,5Gyp41oLVo7Gg7vF4vpmggWP5MU70QO6,8,6,4,0,3,0,3,0,16,2.2857142857142856,2,0.0,0,4,0,3,6,0,0,3,0,7,9,1
209,2601,2hMeaUc14fgUG8b3kgXxN1xDYogexPXy,5Gyp41oLVo7Gg7vF4vpmggWP5MU70QO6,46,119,66,8,59,25,33,4,314,44.857142857142854,8,0.0,27,66,4,59,92,25,4,33,4,156,158,0
210,2603,FALCit9nnWsURM3iEkGUle8YXOvnt8ti,5Gyp41oLVo7Gg7vF4vpmggWP5MU70QO6,73,170,58,137,39,5,48,7,464,66.28571428571429,16,0.0,74,58,126,39,96,5,11,48,7,297,167,0
211,2606,hjUSUM6roI2mLGkMAqBjE0uxFRBSMYHJ,5Gyp41oLVo7Gg7vF4vpmggWP5MU70QO6,58,166,83,15,58,23,37,2,384,54.857142857142854,17,0.0,42,83,13,58,124,23,2,37,2,196,188,0
212,2610,4cRZxyVNjv13lU3nu2aK2rwyndExVCGa,5Gyp41oLVo7Gg7vF4vpmggWP5MU70QO6,46,68,30,34,20,0,14,0,166,23.714285714285715,8,0.0,22,30,24,20,46,0,10,14,0,96,70,1
213,2620,KaCDWxCgO010qDxS3HlQF8ZaUvXkCOjA,5Gyp41oLVo7Gg7vF4vpmggWP5MU70QO6,1,0,0,0,0,0,1,0,1,0.14285714285714285,1,0.0,0,0,0,0,0,0,0,1,0,0,1,1
214,2629,dqE1PGrWExsbP4JkEoKdSn4p50FzqbEb,5Gyp41oLVo7Gg7vF4vpmggWP5MU70QO6,14,59,25,2,13,35,33,4,171,24.428571428571427,5,0.0,11,25,2,13,48,35,0,33,4,51,120,1
215,2677,mQ8TrbvVdRK07e6nFL5h5mKREpzb2mbn,5Gyp41oLVo7Gg7vF4vpmggWP5MU70QO6,42,202,22,74,37,13,26,3,377,53.857142857142854,11,0.0,69,22,52,37,133,13,22,26,3,180,197,0
216,2689,vTDXcAyOYpiQ0ogAQ7JOjHcoNexnjoq5,5Gyp41oLVo7Gg7vF4vpmggWP5MU70QO6,1,0,0,0,0,0,1,0,1,0.14285714285714285,1,0.0,0,0,0,0,0,0,0,1,0,0,1,1
217,2692,owHNspB8DrsecsPRNmUB7UBdqXOlW955,5Gyp41oLVo7Gg7vF4vpmggWP5MU70QO6,16,12,8,0,5,3,9,1,38,5.428571428571429,3,0.0,0,8,0,5,12,3,0,9,1,13,25,0
218,2702,jcdJUvdxIg03VTKugjVUNiWSl6LwbiFS,5Gyp41oLVo7Gg7vF4vpmggWP5MU70QO6,42,100,49,29,33,17,21,3,252,36.0,8,0.0,36,49,23,33,64,17,6,21,3,141,111,0
219,2716,TMJz2EoPbsHk1FPWR3St1suTlnbZjyZn,5Gyp41oLVo7Gg7vF4vpmggWP5MU70QO6,15,16,10,12,4,0,3,0,45,6.428571428571429,2,0.0,3,10,10,4,13,0,2,3,0,27,18,0
220,2722,XIgFx2VwwDoVC2upnRyzGHvQjRJmijA1,5Gyp41oLVo7Gg7vF4vpmggWP5MU70QO6,1,0,0,0,0,0,1,0,1,0.14285714285714285,1,0.0,0,0,0,0,0,0,0,1,0,0,1,1
221,2747,HAPPxnLUjIhcauBZnnWBFk3JE6gETTxa,5Gyp41oLVo7Gg7vF4vpmggWP5MU70QO6,49,200,75,0,73,22,43,4,417,59.57142857142857,15,0.0,76,75,0,73,124,22,0,43,4,224,193,0
222,2753,PAlyBxBk6VLwEvpnrgSrO85KSF9PnIju,5Gyp41oLVo7Gg7vF4vpmggWP5MU70QO6,6,6,4,0,0,0,4,0,14,2.0,2,0.0,0,4,0,0,6,0,0,4,0,4,10,1
223,2775,jz1GL9oh8JwqUWgCaMuHQu1SAuzli1lI,5Gyp41oLVo7Gg7vF4vpmggWP5MU70QO6,6,3,1,0,1,0,2,0,7,1.0,1,0.0,0,1,0,1,3,0,0,2,0,2,5,1
224,2794,UD5FqfNicjboiN32GGPYtIcMIUIxLZOX,5Gyp41oLVo7Gg7vF4vpmggWP5MU70QO6,7,3,2,0,2,0,2,0,9,1.2857142857142858,1,0.0,0,2,0,2,3,0,0,2,0,4,5,1
225,2806,Ypjn6lJteU7Qmp6sXmdyBHqzJOAWqbT5,5Gyp41oLVo7Gg7vF4vpmggWP5MU70QO6,6,3,2,0,2,0,1,0,8,1.1428571428571428,1,0.0,0,2,0,2,3,0,0,1,0,4,4,1
226,2814,n4G59XocOCc4qmD9sEVWpzrFOQjZRmCQ,5Gyp41oLVo7Gg7vF4vpmggWP5MU70QO6,8,8,3,0,1,0,5,0,17,2.4285714285714284,1,0.0,1,3,0,1,7,0,0,5,0,5,12,1
227,2817,UEf9mhauGWJ0X68XBH7UwpOQwtQf9rHu,5Gyp41oLVo7Gg7vF4vpmggWP5MU70QO6,1,0,0,0,0,0,1,0,1,0.14285714285714285,1,0.0,0,0,0,0,0,0,0,1,0,0,1,1
228,2829,ipd5zyoOnSKFBbqUTGdeQ2JqK13k0hdA,5Gyp41oLVo7Gg7vF4vpmggWP5MU70QO6,18,33,12,16,2,4,10,2,79,11.285714285714286,3,0.0,14,12,8,2,19,4,8,10,2,36,43,1
229,2843,g3902agYIRHzac78MKVZlvljLMXXNpQ7,5Gyp41oLVo7Gg7vF4vpmggWP5MU70QO6,77,572,272,127,82,31,123,3,1210,172.85714285714286,24,0.0,157,272,111,82,415,31,16,123,3,622,588,0
230,2848,f6XlBSiBlYkzOyVOP1pzxGVC9XyhPDbP,5Gyp41oLVo7Gg7vF4vpmggWP5MU70QO6,1,0,0,0,0,0,1,0,1,0.14285714285714285,1,0.0,0,0,0,0,0,0,0,1,0,0,1,1
231,2856,DMUIuAv3fBvr0tRlOS42Z2GhVKzRRFaD,5Gyp41oLVo7Gg7vF4vpmggWP5MU70QO6,13,9,6,2,2,7,10,0,36,5.142857142857143,1,0.0,1,6,1,2,8,7,1,10,0,10,26,1
232,2865,KrIVcXIiCdwRGUI4WguKXHPsvZChbtIb,5Gyp41oLVo7Gg7vF4vpmggWP5MU70QO6,47,154,86,44,38,153,54,1,530,75.71428571428571,16,0.0,26,86,37,38,128,153,7,54,1,187,343,0
233,2883,2mD1u3b1vLrSJM0DZTrsvLcZVBVwwd27,5Gyp41oLVo7Gg7vF4vpmggWP5MU70QO6,53,121,81,12,60,2,79,1,356,50.857142857142854,23,0.0,29,81,9,60,92,2,3,79,1,179,177,0
234,2894,qQS3O1HMJ50lGdnO1g7QmXa7NMl9N6QM,5Gyp41oLVo7Gg7vF4vpmggWP5MU70QO6,5,2,1,0,1,0,3,0,7,1.0,1,0.0,0,1,0,1,2,0,0,3,0,2,5,0
235,2901,mJAgtJKHxy28GsPIeuAEUCIOXmHzCywF,5Gyp41oLVo7Gg7vF4vpmggWP5MU70QO6,54,350,191,47,85,129,107,5,914,130.57142857142858,23,0.0,81,191,41,85,269,129,6,107,5,398,516,0
236,2909,71ZP7KjXo0yq58HTstdsSNg0mxNnuR8j,5Gyp41oLVo7Gg7vF4vpmggWP5MU70QO6,4,2,0,0,0,0,3,0,5,0.7142857142857143,1,0.0,1,0,0,0,1,0,0,3,0,1,4,1
237,2910,R2cga9JVVM2tXEVs2saYswslfxAU4nMk,5Gyp41oLVo7Gg7vF4vpmggWP5MU70QO6,22,34,14,19,9,6,18,0,100,14.285714285714286,7,0.0,12,14,13,9,22,6,6,18,0,48,52,0
238,2923,0OQWZBG0W4kepi8nreWMZMMypwSc3KLe,5Gyp41oLVo7Gg7vF4vpmggWP5MU70QO6,63,230,114,68,39,121,74,4,650,92.85714285714286,18,0.0,72,114,53,39,158,121,15,74,4,278,372,0
239,2949,zILXfIGJjWXm6dA2MrEQWr2XeEUry8lN,5Gyp41oLVo7Gg7vF4vpmggWP5MU70QO6,26,110,55,17,9,44,37,0,272,38.857142857142854,14,0.0,21,55,14,9,89,44,3,37,0,99,173,0
240,2952,htMjNQEkszQDZ8v3ebxdPo7AiuYpf2pK,5Gyp41oLVo7Gg7vF4vpmggWP5MU70QO6,1,0,0,0,0,0,1,0,1,0.14285714285714285,1,0.0,0,0,0,0,0,0,0,1,0,0,1,1
241,2956,p9fSvL1QHeabgSWvdxgsdZ9twnsNAaXD,5Gyp41oLVo7Gg7vF4vpmggWP5MU70QO6,6,2,1,0,2,0,3,0,8,1.1428571428571428,1,0.0,1,1,0,2,1,0,0,3,0,4,4,1
242,2980,6PLuywzEAD5lv83Yke18fohzcg9K1vR5,5Gyp41oLVo7Gg7vF4vpmggWP5MU70QO6,38,93,49,4,26,34,22,1,229,32.714285714285715,4,0.0,27,49,4,26,66,34,0,22,1,106,123,1
243,3000,xO6Dx5ILltwlO66h9g17SP993fnZ6pHi,5Gyp41oLVo7Gg7vF4vpmggWP5MU70QO6,5,2,1,0,1,0,2,0,6,0.8571428571428571,1,0.0,0,1,0,1,2,0,0,2,0,2,4,1
244,3008,REW5UtvpMNQiskyvZjp6AaiGdPzBLXiY,5Gyp41oLVo7Gg7vF4vpmggWP5MU70QO6,44,127,10,68,15,8,47,9,284,40.57142857142857,10,0.0,47,10,58,15,80,8,10,47,9,130,154,0
245,3020,JDTEn5xJLcPCagcpPFhmwRsZ0N8AbJZ6,5Gyp41oLVo7Gg7vF4vpmggWP5MU70QO6,46,98,54,13,50,4,19,4,242,34.57142857142857,9,0.0,31,54,7,50,67,4,6,19,4,142,100,0
246,3029,RrCkixJREIfn0lQqmAjFjHO0cJoG2cW9,5Gyp41oLVo7Gg7vF4vpmggWP5MU70QO6,28,53,26,37,0,0,10,0,126,18.0,2,0.0,10,26,36,0,43,0,1,10,0,72,54,1
247,3036,af6Z43TpCc7kiut9b72BDJ48EEfhwWh3,5Gyp41oLVo7Gg7vF4vpmggWP5MU70QO6,26,48,24,30,0,0,8,0,110,15.714285714285714,2,0.0,13,24,30,0,35,0,0,8,0,67,43,1
248,3042,XkKS323fFxBVezQ5JyIgzxHDxEKEwwEf,5Gyp41oLVo7Gg7vF4vpmggWP5MU70QO6,47,103,49,32,6,20,37,4,251,35.857142857142854,4,0.0,27,49,29,6,76,20,3,37,4,111,140,1
249,3045,7WKXNJxTOEnqnRzamCaAUVNKwMcfpnEO,5Gyp41oLVo7Gg7vF4vpmggWP5MU70QO6,6,3,2,0,2,0,1,0,8,1.1428571428571428,1,0.0,0,2,0,2,3,0,0,1,0,4,4,1
250,3046,YaP2AuckukEZITP3IVvIt6Z8ci6RHew7,5Gyp41oLVo7Gg7vF4vpmggWP5MU70QO6,20,26,16,0,7,4,8,0,61,8.714285714285714,6,0.0,0,16,0,7,26,4,0,8,0,23,38,1
251,3055,2X7585R8U4bOw8knpAMGoshn3HeMlUXv,5Gyp41oLVo7Gg7vF4vpmggWP5MU70QO6,48,163,67,54,34,6,16,1,341,48.714285714285715,13,0.0,30,67,43,34,133,6,11,16,1,174,167,0
252,3064,Es0ufHExTzrmxAjsHHoEdZ2EBjvO050s,5Gyp41oLVo7Gg7vF4vpmggWP5MU70QO6,21,27,3,4,4,7,7,1,53,7.571428571428571,4,0.0,9,3,3,4,18,7,1,7,1,19,34,1
253,3065,niLMw8MCObO7SSR2V1jNg9WQt5oSjDFJ,5Gyp41oLVo7Gg7vF4vpmggWP5MU70QO6,31,57,39,10,14,3,20,0,143,20.428571428571427,6,0.0,8,39,9,14,49,3,1,20,0,70,73,0
254,3079,tAPBqKHBDdcLvdLNs6CmpzwZNP25c5j3,5Gyp41oLVo7Gg7vF4vpmggWP5MU70QO6,10,6,4,0,1,1,6,1,19,2.7142857142857144,2,0.0,0,4,0,1,6,1,0,6,1,5,14,1
255,3085,LU9kxt8aKnlOn8SnA2EuX2MLajf5Sg2a,5Gyp41oLVo7Gg7vF4vpmggWP5MU70QO6,22,39,3,0,7,0,24,1,74,10.571428571428571,13,0.0,1,3,0,7,38,0,0,24,1,11,63,0
256,3127,tX5rO3NEgwGap375QiX826UZxwo7eG7l,5Gyp41oLVo7Gg7vF4vpmggWP5MU70QO6,1,0,0,0,0,0,1,0,1,0.14285714285714285,1,0.0,0,0,0,0,0,0,0,1,0,0,1,1
257,3140,9uqkwYb5ddQJIw4su6OaF1hwvWEdLp1S,5Gyp41oLVo7Gg7vF4vpmggWP5MU70QO6,42,90,57,0,55,0,11,0,213,30.428571428571427,7,0.0,17,57,0,55,73,0,0,11,0,129,84,0
258,3146,LXkkU0Q9ED3oa1tokPnoPFpATycz64Oo,5Gyp41oLVo7Gg7vF4vpmggWP5MU70QO6,10,5,3,4,2,0,2,0,16,2.2857142857142856,1,0.0,1,3,2,2,4,0,2,2,0,8,8,1
259,3166,OPlk4et0QDh8unILE7N0m7DW2t62ExS3,5Gyp41oLVo7Gg7vF4vpmggWP5MU70QO6,20,49,24,41,4,50,9,2,179,25.571428571428573,6,0.0,16,24,29,4,33,50,12,9,2,73,106,0
260,3185,hwVOqX65HJP61knp4xwbZXR18Hh7HwAV,5Gyp41oLVo7Gg7vF4vpmggWP5MU70QO6,6,1,1,0,1,0,3,0,6,0.8571428571428571,1,0.0,0,1,0,1,1,0,0,3,0,2,4,1
261,3189,Ve30VVfu3WOSJCl56SL7TQHGBM98BQ3E,5Gyp41oLVo7Gg7vF4vpmggWP5MU70QO6,34,67,39,52,2,3,19,0,182,26.0,4,0.0,25,39,46,2,42,3,6,19,0,112,70,0
262,3198,sZW50FIndc0IzSzdKKo2sGFjArizKE5S,5Gyp41oLVo7Gg7vF4vpmggWP5MU70QO6,6,4,2,0,0,0,4,0,10,1.4285714285714286,3,0.0,0,2,0,0,4,0,0,4,0,2,8,0
263,3201,Ms0MC4W5moiGJLWP7iE3FImeH9CHN4KT,5Gyp41oLVo7Gg7vF4vpmggWP5MU70QO6,54,192,102,29,40,220,68,15,666,95.14285714285714,17,0.0,52,102,24,40,140,220,5,68,15,218,448,0
264,3214,UK0wMwBzvN90sgDmKYl9zi5a5BuEJyvZ,5Gyp41oLVo7Gg7vF4vpmggWP5MU70QO6,6,4,2,0,1,0,3,0,10,1.4285714285714286,2,0.0,0,2,0,1,4,0,0,3,0,3,7,1
265,3224,OUbrW18OgibVb4I41eHFiFhkobpgjEP2,5Gyp41oLVo7Gg7vF4vpmggWP5MU70QO6,45,67,32,0,51,0,13,0,163,23.285714285714285,5,0.0,28,32,0,51,39,0,0,13,0,111,52,0
266,3225,7rK7Uy26DYQFFceei5MF7BwFprvKz0Gb,5Gyp41oLVo7Gg7vF4vpmggWP5MU70QO6,6,1,1,0,1,0,3,0,6,0.8571428571428571,1,0.0,0,1,0,1,1,0,0,3,0,2,4,1
267,3231,da3Kt8w4H4PVhwdYyoSXcS80ozIENFOQ,5Gyp41oLVo7Gg7vF4vpmggWP5MU70QO6,43,84,44,46,20,9,36,2,241,34.42857142857143,7,0.0,30,44,34,20,54,9,12,36,2,128,113,1
268,3250,MOJ1BiwMK7lBUiFS9DTwwPvbUWIkdFFP,5Gyp41oLVo7Gg7vF4vpmggWP5MU70QO6,83,412,224,162,71,36,54,2,961,137.28571428571428,19,0.0,106,224,140,71,306,36,22,54,2,541,420,0
269,3264,s6iksgptFmyh2vfiarKdJkiKnp6RLi3f,5Gyp41oLVo7Gg7vF4vpmggWP5MU70QO6,13,47,17,0,6,78,25,2,175,25.0,6,0.0,8,17,0,6,39,78,0,25,2,31,144,0
270,3295,oWOfoMSwxFJkBlwLG8XI3GNMHdlBBaGM,5Gyp41oLVo7Gg7vF4vpmggWP5MU70QO6,44,266,165,21,86,44,56,4,642,91.71428571428571,18,0.0,68,165,17,86,198,44,4,56,4,336,306,0
271,3325,wpCDOX0slOiZnds0I4m6mUJjN54j7NHD,5Gyp41oLVo7Gg7vF4vpmggWP5MU70QO6,10,12,6,0,4,0,4,0,26,3.7142857142857144,3,0.0,3,6,0,4,9,0,0,4,0,13,13,1
272,3326,D4LPr9a0DKiZfUzg8gczdCFrU5mq2QDm,5Gyp41oLVo7Gg7vF4vpmggWP5MU70QO6,60,170,46,69,7,21,68,1,382,54.57142857142857,11,0.0,54,46,62,7,116,21,7,68,1,169,213,0
273,3327,ecpi7DZ71ZRx6H6XAh885uO1l0O5kvOG,5Gyp41oLVo7Gg7vF4vpmggWP5MU70QO6,6,6,3,1,0,0,1,0,11,1.5714285714285714,1,0.0,2,3,1,0,4,0,0,1,0,6,5,0
274,3331,layckrYedWZgFw7etRwkXZmJxZfLSCWL,5Gyp41oLVo7Gg7vF4vpmggWP5MU70QO6,48,190,84,83,24,81,53,3,518,74.0,14,0.0,47,84,70,24,143,81,13,53,3,225,293,0
275,3349,PWtrTBU08HcMIVKmBf17gfZfZrEKBCYw,5Gyp41oLVo7Gg7vF4vpmggWP5MU70QO6,12,9,6,0,3,0,4,0,22,3.142857142857143,2,0.0,0,6,0,3,9,0,0,4,0,9,13,1
276,3351,VXjfCuVPdUNjER0BgKDTzXxTuaTuHQ2o,5Gyp41oLVo7Gg7vF4vpmggWP5MU70QO6,39,107,46,27,20,3,30,1,234,33.42857142857143,8,0.0,37,46,20,20,70,3,7,30,1,123,111,1
277,3352,nlq4r6xc3rTUqTwcYhL6wudXdN6RIE52,5Gyp41oLVo7Gg7vF4vpmggWP5MU70QO6,54,134,80,6,56,0,20,0,296,42.285714285714285,14,0.0,24,80,3,56,110,0,3,20,0,163,133,0
278,3371,pdAqVvKgeCIaihAcxhTXOYjPQxxjaa8K,5Gyp41oLVo7Gg7vF4vpmggWP5MU70QO6,10,8,7,0,0,0,3,0,18,2.5714285714285716,2,0.0,0,7,0,0,8,0,0,3,0,7,11,1
279,3394,1I1Q3JgkX7LID2tw8cHgRGGETfsuXaK0,5Gyp41oLVo7Gg7vF4vpmggWP5MU70QO6,1,0,0,0,0,0,1,0,1,0.14285714285714285,1,0.0,0,0,0,0,0,0,0,1,0,0,1,1
280,3408,xn9XMOUsLFqfdTbtWya5WUWiCxZ2QGu8,5Gyp41oLVo7Gg7vF4vpmggWP5MU70QO6,11,10,4,4,1,21,9,2,51,7.285714285714286,1,0.0,2,4,2,1,8,21,2,9,2,9,42,0
281,3415,7k0pNzVH9lwkASYqqwWy0HckNIMsB4CP,5Gyp41oLVo7Gg7vF4vpmggWP5MU70QO6,42,80,43,67,2,11,41,1,245,35.0,7,0.0,32,43,53,2,48,11,14,41,1,130,115,0
282,3416,j1jdy8OF5VQw4rqSYOkbK2pQplvvvz37,5Gyp41oLVo7Gg7vF4vpmggWP5MU70QO6,71,283,141,72,72,65,80,12,725,103.57142857142857,20,0.0,81,141,57,72,202,65,15,80,12,351,374,0
283,3425,nZHDVGR2taFZ428UJIwMv53Rp94HbGnD,5Gyp41oLVo7Gg7vF4vpmggWP5MU70QO6,1,0,0,0,0,0,1,0,1,0.14285714285714285,1,0.0,0,0,0,0,0,0,0,1,0,0,1,1
284,3446,CS2NxxkxYN2gdGmgVH4QBWlYCL6CBUo7,5Gyp41oLVo7Gg7vF4vpmggWP5MU70QO6,16,19,8,14,3,3,4,0,51,7.285714285714286,1,0.0,8,8,7,3,11,3,7,4,0,26,25,1
285,3451,jD3UOYibaPKSzUrDAsr0OejITusd7VrV,5Gyp41oLVo7Gg7vF4vpmggWP5MU70QO6,2,0,0,0,0,0,2,0,2,0.2857142857142857,1,0.0,0,0,0,0,0,0,0,2,0,0,2,1
286,3461,GEB7lnRATVntgooFsQX8a3NQzClZLP1N,5Gyp41oLVo7Gg7vF4vpmggWP5MU70QO6,8,6,3,0,2,0,3,0,14,2.0,2,0.0,1,3,0,2,5,0,0,3,0,6,8,1
287,3469,zeUi2UnQZPPF6bRQXw2s8LZ41ZOdqRAa,5Gyp41oLVo7Gg7vF4vpmggWP5MU70QO6,5,4,2,0,0,24,5,0,35,5.0,3,0.0,0,2,0,0,4,24,0,5,0,2,33,1
288,3482,9zJGVvMDoimbmO5jrwImOVZINPfOiYqF,5Gyp41oLVo7Gg7vF4vpmggWP5MU70QO6,2,0,0,0,0,0,2,0,2,0.2857142857142857,1,0.0,0,0,0,0,0,0,0,2,0,0,2,1
289,3501,ehQsBJH6Sh0Hb1yGwhBgVwobig6KyUlg,5Gyp41oLVo7Gg7vF4vpmggWP5MU70QO6,63,240,122,30,44,185,85,3,709,101.28571428571429,12,0.0,66,122,23,44,174,185,7,85,3,255,454,0
290,3512,egu9R2zi3bUYOErhkCesp0oMig9lwpnh,5Gyp41oLVo7Gg7vF4vpmggWP5MU70QO6,33,63,31,81,1,4,12,0,192,27.428571428571427,4,0.0,25,31,67,1,38,4,14,12,0,124,68,1
291,3520,GoCzFgZtKHP9v4b0WP4lIjCorcS7Jt3F,5Gyp41oLVo7Gg7vF4vpmggWP5MU70QO6,7,6,3,0,2,0,3,0,14,2.0,3,0.0,0,3,0,2,6,0,0,3,0,5,9,1
292,3524,H12UkRTeuK8PiRUUsA27x5ar53xuK6n8,5Gyp41oLVo7Gg7vF4vpmggWP5MU70QO6,1,0,0,0,0,0,2,0,2,0.2857142857142857,2,0.0,0,0,0,0,0,0,0,2,0,0,2,1
293,3529,CmIaRR2qgpGVOUIbsTC8R6ZChGQweVzS,5Gyp41oLVo7Gg7vF4vpmggWP5MU70QO6,37,92,48,17,10,34,12,0,213,30.428571428571427,8,0.0,14,48,12,10,78,34,5,12,0,84,129,0
294,3539,uVKRpb0wpcO3OMHZp7JeDIDcxBS5RLcM,5Gyp41oLVo7Gg7vF4vpmggWP5MU70QO6,8,6,3,0,2,0,2,0,13,1.8571428571428572,1,0.0,1,3,0,2,5,0,0,2,0,6,7,1
295,3545,jSPjvvcGEGdnkGRTlhr1w4P4dzPL1W95,5Gyp41oLVo7Gg7vF4vpmggWP5MU70QO6,2,0,0,0,0,0,2,0,2,0.2857142857142857,1,0.0,0,0,0,0,0,0,0,2,0,0,2,1
296,3568,j3hbCNcvLarbvZL0w1bgZayyaRyrLQTj,5Gyp41oLVo7Gg7vF4vpmggWP5MU70QO6,8,7,4,2,1,0,2,0,16,2.2857142857142856,1,0.0,1,4,1,1,6,0,1,2,0,7,9,0
297,3569,3nIiTMbxCDiSlQaRR62YaLBBApxBbHsO,5Gyp41oLVo7Gg7vF4vpmggWP5MU70QO6,1,0,0,0,0,0,1,0,1,0.14285714285714285,1,0.0,0,0,0,0,0,0,0,1,0,0,1,1
298,3575,kvoUslzLG0mKlFKuSPgqASK2op5HSx76,5Gyp41oLVo7Gg7vF4vpmggWP5MU70QO6,13,43,21,0,11,2,14,5,96,13.714285714285714,4,0.0,2,21,0,11,41,2,0,14,5,34,62,0
299,3595,IzX1R0Q45PClKcuxYHyIKKmFuFt93Lx2,5Gyp41oLVo7Gg7vF4vpmggWP5MU70QO6,44,200,80,52,11,14,63,1,421,60.142857142857146,20,0.0,41,80,37,11,159,14,15,63,1,169,252,0
300,3613,FqIQ1li3eim3G1b9mwuqVSaOci5g4Yx0,5Gyp41oLVo7Gg7vF4vpmggWP5MU70QO6,6,7,5,0,0,0,5,0,17,2.4285714285714284,1,0.0,1,5,0,0,6,0,0,5,0,6,11,0
301,3644,9e5dcfJQbPUU8sTcmzE9DWoDPOA9Nhu3,5Gyp41oLVo7Gg7vF4vpmggWP5MU70QO6,19,40,15,17,3,0,6,0,81,11.571428571428571,2,0.0,5,15,16,3,35,0,1,6,0,39,42,1
302,3647,AFUJTbEqqgSsqCkUsNrjbPAjZvFwpzeW,5Gyp41oLVo7Gg7vF4vpmggWP5MU70QO6,88,240,88,109,65,13,36,0,551,78.71428571428571,16,0.0,65,88,90,65,175,13,19,36,0,308,243,0
303,3652,eq1oOsePtvDHcr5VwwIpagivS72utAhr,5Gyp41oLVo7Gg7vF4vpmggWP5MU70QO6,49,131,7,21,39,4,20,0,222,31.714285714285715,14,0.0,33,7,14,39,98,4,7,20,0,93,129,1
304,3658,86t1iR0NT9tOoJvgV2BHlNDh2I7ZFriX,5Gyp41oLVo7Gg7vF4vpmggWP5MU70QO6,1,0,0,0,0,0,2,0,2,0.2857142857142857,1,0.0,0,0,0,0,0,0,0,2,0,0,2,1
305,3716,ZSKBKnD8wfegggUigWIwrMo7a1rGr9YG,5Gyp41oLVo7Gg7vF4vpmggWP5MU70QO6,17,26,13,2,5,1,13,1,61,8.714285714285714,5,0.0,2,13,1,5,24,1,1,13,1,21,40,1
306,3724,nglaToodcU5Q8FzrMWGY4MUCnpZFGaF5,5Gyp41oLVo7Gg7vF4vpmggWP5MU70QO6,8,8,5,0,3,0,4,0,20,2.857142857142857,2,0.0,0,5,0,3,8,0,0,4,0,8,12,1
307,3727,2fI4wWrvurl3ODzFoF1kViu5y8Lc1NgZ,5Gyp41oLVo7Gg7vF4vpmggWP5MU70QO6,35,125,56,39,20,63,29,3,335,47.857142857142854,12,0.0,21,56,31,20,104,63,8,29,3,128,207,0
308,3737,uj6NI1xikJKmYtrSvOvp2gjQGnklt0N8,5Gyp41oLVo7Gg7vF4vpmggWP5MU70QO6,36,71,44,8,17,0,21,0,161,23.0,11,0.0,3,44,5,17,68,0,3,21,0,69,92,0
309,3757,CXT3urKvwCIfBmuQmODRcZXAAAJs07Dk,5Gyp41oLVo7Gg7vF4vpmggWP5MU70QO6,3,0,0,0,0,0,3,0,3,0.42857142857142855,1,0.0,0,0,0,0,0,0,0,3,0,0,3,1
310,3784,X8qfNjsHrwR5R67KkU9t7FXc6jQSGsyo,5Gyp41oLVo7Gg7vF4vpmggWP5MU70QO6,35,140,62,17,41,58,45,3,366,52.285714285714285,10,0.0,54,62,11,41,86,58,6,45,3,168,198,0
311,3785,ts7gxS52MJ8xeq4ZgoYDEEVK8tqcrK43,5Gyp41oLVo7Gg7vF4vpmggWP5MU70QO6,36,97,51,37,16,15,19,1,236,33.714285714285715,9,0.0,16,51,22,16,81,15,15,19,1,105,131,0
312,3802,CE0RG1R9BsnYR68sZcEdfpQ3RBoQAI8l,5Gyp41oLVo7Gg7vF4vpmggWP5MU70QO6,11,17,6,6,2,8,2,0,41,5.857142857142857,1,0.0,8,6,3,2,9,8,3,2,0,19,22,1
313,3833,sApH95kwlTdIi3RvuRD74A0dFhVPKais,5Gyp41oLVo7Gg7vF4vpmggWP5MU70QO6,23,30,26,0,13,2,6,1,78,11.142857142857142,5,0.0,0,26,0,13,30,2,0,6,1,39,39,1
314,3838,vlHmtLHxbw7S6zxC5oHlY3I9JCi1BY6K,5Gyp41oLVo7Gg7vF4vpmggWP5MU70QO6,11,7,4,0,3,0,6,0,20,2.857142857142857,1,0.0,0,4,0,3,7,0,0,6,0,7,13,1
315,3848,Aw4IDXePUvZHJziRsaCOUg8dgwu5BZXP,5Gyp41oLVo7Gg7vF4vpmggWP5MU70QO6,4,2,1,0,0,0,2,0,5,0.7142857142857143,1,0.0,0,1,0,0,2,0,0,2,0,1,4,1
316,3851,38HaiNGogMQZ7XFJyXto2il2akhOzypw,5Gyp41oLVo7Gg7vF4vpmggWP5MU70QO6,40,93,49,30,23,43,19,1,258,36.857142857142854,14,0.0,16,49,24,23,77,43,6,19,1,112,146,0
317,3876,Vy4WRiZ6wqh3K0MhM76WnkqAwo2EzenE,5Gyp41oLVo7Gg7vF4vpmggWP5MU70QO6,1,0,0,0,0,0,1,0,1,0.14285714285714285,1,0.0,0,0,0,0,0,0,0,1,0,0,1,0
318,3904,SZ1Dps7XHlF6LX8F5UjfRiNZqGOPfABK,5Gyp41oLVo7Gg7vF4vpmggWP5MU70QO6,1,0,0,0,0,0,1,0,1,0.14285714285714285,1,0.0,0,0,0,0,0,0,0,1,0,0,1,1
319,3912,VKDNE86ItuOpp2oVHDMGR3EPQG95zuXs,5Gyp41oLVo7Gg7vF4vpmggWP5MU70QO6,35,80,42,27,21,0,28,0,198,28.285714285714285,9,0.0,18,42,19,21,62,0,8,28,0,100,98,0
320,3913,CeHkW43YFk9n9jgYvcA4TSUcxZb4rdJe,5Gyp41oLVo7Gg7vF4vpmggWP5MU70QO6,7,3,2,0,2,0,3,0,10,1.4285714285714286,1,0.0,0,2,0,2,3,0,0,3,0,4,6,1
321,3914,n6BphJhAHOGzVmyCEt3aewV8nmcl7E7b,5Gyp41oLVo7Gg7vF4vpmggWP5MU70QO6,7,5,3,0,1,0,3,0,12,1.7142857142857142,1,0.0,0,3,0,1,5,0,0,3,0,4,8,1
322,3924,L50CznUPZXrrizGMyYwcQayFKBMeZJLf,5Gyp41oLVo7Gg7vF4vpmggWP5MU70QO6,8,7,4,0,2,0,3,0,16,2.2857142857142856,3,0.0,0,4,0,2,7,0,0,3,0,6,10,1
323,3929,GxWg4h8gAiKctUf8VxaJMnstU2gEPNkZ,5Gyp41oLVo7Gg7vF4vpmggWP5MU70QO6,31,58,28,32,7,0,7,0,132,18.857142857142858,4,0.0,11,28,26,7,47,0,6,7,0,72,60,0
324,3934,htua1xywlnpsMMY7EJSOsurL86GI912X,5Gyp41oLVo7Gg7vF4vpmggWP5MU70QO6,26,69,38,25,13,0,26,1,172,24.571428571428573,10,0.0,16,38,14,13,53,0,11,26,1,81,91,0
325,3936,4w65IJuU7aRi28m7eaz5o1EHevqyF6Ws,5Gyp41oLVo7Gg7vF4vpmggWP5MU70QO6,25,61,27,28,13,0,15,0,144,20.571428571428573,13,0.0,14,27,18,13,47,0,10,15,0,72,72,0
326,3940,SHmlUgNk9MPVdcZ7Cn8s2iFXGP9J6KWU,5Gyp41oLVo7Gg7vF4vpmggWP5MU70QO6,5,2,1,0,1,0,2,0,6,0.8571428571428571,1,0.0,0,1,0,1,2,0,0,2,0,2,4,1
327,3952,eXEITuHYjhxsbm5B6dP5cReIRssXuhPy,5Gyp41oLVo7Gg7vF4vpmggWP5MU70QO6,9,7,4,0,1,0,5,0,17,2.4285714285714284,3,0.0,0,4,0,1,7,0,0,5,0,5,12,1
328,3967,vcbB1O65ViiZQm6jlzGN6W2EH2EmJjQK,5Gyp41oLVo7Gg7vF4vpmggWP5MU70QO6,47,100,65,26,25,46,18,1,281,40.142857142857146,10,0.0,17,65,18,25,83,46,8,18,1,125,156,1
329,3975,rwZPkNP5jbYPX691iPVLQRdGmrqAlsLH,5Gyp41oLVo7Gg7vF4vpmggWP5MU70QO6,1,0,0,0,0,0,1,0,1,0.14285714285714285,1,0.0,0,0,0,0,0,0,0,1,0,0,1,1
330,3986,lri3Bm6mGdJ1wEpJO4c8fcTdLtxpvXa6,fbPkOYLVPtPgIt0MxizjfFJov3JbHyAi,18,34,11,19,6,3,1,0,74,10.571428571428571,1,0.0,12,11,18,6,22,3,1,1,0,47,27,0
331,3987,RvRsXzYULX8CJPXHa5mzL8AcNhscf6wx,fbPkOYLVPtPgIt0MxizjfFJov3JbHyAi,8,8,5,0,3,5,3,0,24,3.4285714285714284,1,0.0,1,5,0,3,7,5,0,3,0,9,15,1
332,3999,4IkxYjTflPhoHxhEdrFyf3T4ZXNMTaKd,fbPkOYLVPtPgIt0MxizjfFJov3JbHyAi,45,119,33,24,10,17,17,0,220,31.428571428571427,4,0.0,33,33,23,10,86,17,1,17,0,99,121,0
333,4016,0OQWZBG0W4kepi8nreWMZMMypwSc3KLe,fbPkOYLVPtPgIt0MxizjfFJov3JbHyAi,1,0,0,0,0,0,1,0,1,0.14285714285714285,1,0.0,0,0,0,0,0,0,0,1,0,0,1,0
334,4024,UInMBEH8f1h2vxXVslRsWyLOTv8ggYq3,fbPkOYLVPtPgIt0MxizjfFJov3JbHyAi,17,14,8,0,5,35,5,0,67,9.571428571428571,2,0.0,0,8,0,5,14,35,0,5,0,13,54,0
335,4040,tmmvczbZLiPw6t5Ru9DTWRYnvMI3hKxN,fbPkOYLVPtPgIt0MxizjfFJov3JbHyAi,3,2,1,0,0,0,1,0,4,0.5714285714285714,1,0.0,0,1,0,0,2,0,0,1,0,1,3,1
336,4070,bUizg9a7xaQ9xo39EDPwubco3asipi0e,fbPkOYLVPtPgIt0MxizjfFJov3JbHyAi,5,3,2,0,1,0,1,0,7,1.0,1,0.0,0,2,0,1,3,0,0,1,0,3,4,1
337,4072,kHp5QZURLzbWn4koqFYZnQmO0kliz5hb,fbPkOYLVPtPgIt0MxizjfFJov3JbHyAi,7,5,2,2,1,0,1,0,11,1.5714285714285714,1,0.0,1,2,2,1,4,0,0,1,0,6,5,0
338,4095,ijFjDmHOLiyu54Ko0v4roRDWdDCIX5i1,fbPkOYLVPtPgIt0MxizjfFJov3JbHyAi,9,19,13,0,8,0,6,0,46,6.571428571428571,5,0.0,0,13,0,8,19,0,0,6,0,21,25,0
339,4105,VJ15PTmNAjfB6ipRCoKMs7aSjJuraSNv,fbPkOYLVPtPgIt0MxizjfFJov3JbHyAi,10,28,10,0,1,0,3,0,42,6.0,2,0.0,2,10,0,1,26,0,0,3,0,13,29,1
340,4125,bGXe45VQE79P82jCvYbfBiOeISe1I8HL,fbPkOYLVPtPgIt0MxizjfFJov3JbHyAi,8,4,2,0,1,4,5,1,17,2.4285714285714284,1,0.0,0,2,0,1,4,4,0,5,1,3,14,1
341,4127,iMXZvpdXIEwupZ3KLZs1wDk19TeUIZDi,fbPkOYLVPtPgIt0MxizjfFJov3JbHyAi,12,11,5,4,3,25,6,1,55,7.857142857142857,1,0.0,4,5,3,3,7,25,1,6,1,15,40,1
342,4133,sT9hGAnww95aeGvqwQpJlS3ORhWDT49F,fbPkOYLVPtPgIt0MxizjfFJov3JbHyAi,23,30,11,14,11,10,3,0,79,11.285714285714286,2,0.0,16,11,13,11,14,10,1,3,0,51,28,0
343,4143,9sFMHkQmozo76x80tFTC9ms1LtFpAvDD,fbPkOYLVPtPgIt0MxizjfFJov3JbHyAi,7,3,3,0,0,15,9,0,30,4.285714285714286,3,0.0,0,3,0,0,3,15,0,9,0,3,27,0
344,4168,heWUPIsxtHSwXQGmJMsYqzGkbNQihssP,fbPkOYLVPtPgIt0MxizjfFJov3JbHyAi,10,8,5,3,4,0,1,0,21,3.0,1,0.0,1,5,3,4,7,0,0,1,0,13,8,1
345,4171,uHgH8m4GJET0eE5mE8JCyLZD7HEKwM4t,SpATywNh6bZuzm8s1ceuBUnMUAeoAHHw,20,25,14,13,7,0,5,0,64,9.142857142857142,3,0.0,8,14,10,7,17,0,3,5,0,39,25,0
346,4218,EReWp6ilgaQY61GGX2jAkIc5IQisheJq,SpATywNh6bZuzm8s1ceuBUnMUAeoAHHw,7,10,3,0,1,0,4,0,18,2.5714285714285716,3,0.0,0,3,0,1,10,0,0,4,0,4,14,1
347,4237,SVFfJJhaWd2RlHPtvg5SWBRGj8N0paMQ,SpATywNh6bZuzm8s1ceuBUnMUAeoAHHw,13,16,1,20,0,0,2,0,39,5.571428571428571,1,0.0,6,1,16,0,10,0,4,2,0,23,16,0
348,4238,hevZgCUVQAVwtaivzco7bLaVpTOAAfiG,SpATywNh6bZuzm8s1ceuBUnMUAeoAHHw,7,6,3,0,1,0,2,0,12,1.7142857142857142,1,0.0,0,3,0,1,6,0,0,2,0,4,8,0
349,4243,83p9ejSELsW1j5wNlAyUXF2YWFL8Z8tc,A3fsA9Zfv1X2fVEQhTw51lKENdNrEqT3,8,9,3,0,1,0,3,0,16,2.2857142857142856,3,0.0,0,3,0,1,9,0,0,3,0,4,12,0
350,4247,0NGZq9HZW5KOrSfzSGGipuN20pCRDMWu,G8EPVSXsOYB5YQWZGiz1aVq5Pgr2GrQu,58,163,38,0,11,31,18,0,261,37.285714285714285,6,0.0,43,38,0,11,120,31,0,18,0,92,169,0
351,4250,DHUv7XpIZcPp2QYGNmTXjhgg7Zq4BpJ7,SpATywNh6bZuzm8s1ceuBUnMUAeoAHHw,16,14,10,12,5,0,1,0,42,6.0,1,0.0,3,10,11,5,11,0,1,1,0,29,13,1
352,4254,J5PQMceXoOVyN05md7NqKfAhSfcgJgVJ,SpATywNh6bZuzm8s1ceuBUnMUAeoAHHw,15,20,2,16,0,5,4,0,47,6.714285714285714,3,0.0,5,2,13,0,15,5,3,4,0,20,27,0
353,4270,xmsckIAcvM2S7rjWsHHPvyDsjVFjwdMr,SpATywNh6bZuzm8s1ceuBUnMUAeoAHHw,13,16,11,0,6,0,4,0,37,5.285714285714286,3,0.0,0,11,0,6,16,0,0,4,0,17,20,1
354,4278,iVNWfvqx80bYGUpxbD5kOVH2Fugs6QtQ,SpATywNh6bZuzm8s1ceuBUnMUAeoAHHw,31,22,14,14,10,0,7,0,67,9.571428571428571,3,0.0,4,14,12,10,18,0,2,7,0,40,27,0
355,4286,i9UIJe9BPLqUSVYMtAIMhpSeBf6cbruQ,SpATywNh6bZuzm8s1ceuBUnMUAeoAHHw,13,19,7,0,4,0,2,0,32,4.571428571428571,1,0.0,3,7,0,4,16,0,0,2,0,14,18,0
356,4304,j1jdy8OF5VQw4rqSYOkbK2pQplvvvz37,5X6FeZozNMgE2VRi3MJYjkkFK8SETtu2,118,363,17,190,60,17,65,2,714,102.0,18,0.0,176,17,161,60,187,17,29,65,2,414,300,0
357,4313,l80sDXQh6tFmRSRsJvWJgP55drvQUfT2,SpATywNh6bZuzm8s1ceuBUnMUAeoAHHw,10,655,6,0,1,0,15,0,677,96.71428571428571,3,0.0,0,6,0,1,655,0,0,15,0,7,670,1
358,4327,glS180WZt8C6hB13WP6NUijid7zN96cg,SpATywNh6bZuzm8s1ceuBUnMUAeoAHHw,10,11,5,17,1,0,1,0,35,5.0,1,0.0,5,5,14,1,6,0,3,1,0,25,10,0
359,4342,gqe5NXbZbf5uXY0rPviLeIFOMpQyekdp,G8EPVSXsOYB5YQWZGiz1aVq5Pgr2GrQu,30,34,2,32,4,0,10,0,82,11.714285714285714,3,0.0,0,2,29,4,34,0,3,10,0,35,47,1
360,4365,ebO6e76NCFlMeek1yPjM9gz3mJBPl1yH,RXDvfPUBYFlVdlueBFbLW0mhhAyGEqpt,36,30,16,53,7,0,5,0,111,15.857142857142858,1,0.0,9,16,49,7,21,0,4,5,0,81,30,1
361,4393,PehZ8w7lhwueNJQVLn4O4a5DjlM7RVHJ,5X6FeZozNMgE2VRi3MJYjkkFK8SETtu2,30,42,9,60,15,5,4,0,135,19.285714285714285,3,0.0,14,9,52,15,28,5,8,4,0,90,45,1
362,4395,C6xrhZPOmVH2gCVNP26gSSPka2CcwgB5,SpATywNh6bZuzm8s1ceuBUnMUAeoAHHw,6,1,1,0,1,0,3,1,7,1.0,1,0.0,0,1,0,1,1,0,0,3,1,2,5,1
363,4396,5c5BMuD35oybcLij9FEBpLM3FZXJ5QAD,G8EPVSXsOYB5YQWZGiz1aVq5Pgr2GrQu,18,57,1,0,0,8,11,0,77,11.0,5,0.0,4,1,0,0,53,8,0,11,0,5,72,0
364,4406,U0MChqulsymiJYCtbj873TXGFuXiZDFk,SpATywNh6bZuzm8s1ceuBUnMUAeoAHHw,19,12,8,5,5,0,4,0,34,4.857142857142857,2,0.0,2,8,5,5,10,0,0,4,0,20,14,0
365,4432,kdQVQcPehC1WZyKhleQe5vDaCQv1dpj8,SpATywNh6bZuzm8s1ceuBUnMUAeoAHHw,19,19,14,11,8,0,3,0,55,7.857142857142857,3,0.0,2,14,11,8,17,0,0,3,0,35,20,0
366,4435,bN6JhUz4s97Xsh7eq2ZH1ilTMaKJDuUF,bWdj2GDclj5ofokWjzoa5jAwMkxCykd6,4,12,1,0,0,0,1,0,14,2.0,4,0.0,0,1,0,0,12,0,0,1,0,1,13,0
367,4440,ZhTCqX8GMUcn0a0betuEauHNuCk1aRhm,bWdj2GDclj5ofokWjzoa5jAwMkxCykd6,46,40,18,98,8,25,10,0,199,28.428571428571427,2,0.0,7,18,88,8,33,25,10,10,0,121,78,0
368,4453,4sZlPbPnBCwNHbrOUXcVAiPkTKHriJTV,SpATywNh6bZuzm8s1ceuBUnMUAeoAHHw,17,36,3,12,1,0,20,0,72,10.285714285714286,6,0.0,8,3,11,1,28,0,1,20,0,23,49,0
369,4454,lMy0A59BRo4770ALzvOjsBS5HJkCRV78,bWdj2GDclj5ofokWjzoa5jAwMkxCykd6,6,7,4,0,2,8,3,0,24,3.4285714285714284,2,0.0,0,4,0,2,7,8,0,3,0,6,18,1
370,4481,XjrP1VAGwJCwkRm4KgImIkZYNjnvGQN9,RXDvfPUBYFlVdlueBFbLW0mhhAyGEqpt,64,140,42,68,37,11,57,0,355,50.714285714285715,9,0.0,43,42,63,37,97,11,5,57,0,185,170,0
371,4487,K8rCvtgiQNoA3MkpXyD7cZBeSU2lQVue,5X6FeZozNMgE2VRi3MJYjkkFK8SETtu2,10,9,8,0,7,0,6,0,30,4.285714285714286,2,0.0,0,8,0,7,9,0,0,6,0,15,15,1
372,4498,dxoTIhhPXBvqzWGLltH0slJdxsuyggjI,G8EPVSXsOYB5YQWZGiz1aVq5Pgr2GrQu,86,98,78,0,57,16,19,1,269,38.42857142857143,6,0.0,2,78,0,57,96,16,0,19,1,137,132,0
373,4499,2ZP4iw9joeRPfEuWLWQQFnKchFtuqx5l,SpATywNh6bZuzm8s1ceuBUnMUAeoAHHw,7,5,3,0,1,0,4,0,13,1.8571428571428572,2,0.0,0,3,0,1,5,0,0,4,0,4,9,0
374,4506,j1jdy8OF5VQw4rqSYOkbK2pQplvvvz37,G8EPVSXsOYB5YQWZGiz1aVq5Pgr2GrQu,57,90,5,61,0,13,23,0,192,27.428571428571427,7,0.0,3,5,51,0,87,13,10,23,0,59,133,0
375,4507,HuDaXYBstQFpbEGg5tkyPhxLKzB3hVSB,SpATywNh6bZuzm8s1ceuBUnMUAeoAHHw,25,57,34,18,14,5,15,0,143,20.428571428571427,8,0.0,10,34,14,14,47,5,4,15,0,72,71,0
376,4524,j1jdy8OF5VQw4rqSYOkbK2pQplvvvz37,bWdj2GDclj5ofokWjzoa5jAwMkxCykd6,18,14,0,28,0,0,5,0,47,6.714285714285714,3,0.0,0,0,26,0,14,0,2,5,0,26,21,1
377,4533,4LLdV2zTWS697dAsOgAPJZPFwfNnrjt6,5X6FeZozNMgE2VRi3MJYjkkFK8SETtu2,60,134,71,74,68,2,11,0,360,51.42857142857143,9,0.0,37,71,61,68,97,2,13,11,0,237,123,0
378,4548,kla9cpzzaIqMfwRx5dULfeceoZisiJXJ,SpATywNh6bZuzm8s1ceuBUnMUAeoAHHw,9,17,8,0,2,2,6,0,35,5.0,3,0.0,5,8,0,2,12,2,0,6,0,15,20,0
379,4571,PUW0i4IuafllkJEtV0GCqmTDeLHkDmH3,bWdj2GDclj5ofokWjzoa5jAwMkxCykd6,18,24,8,28,0,0,3,0,63,9.0,2,0.0,7,8,26,0,17,0,2,3,0,41,22,0
380,4585,HqsJVGNbokPBStWiDvKZXbvoLlDHixpp,SpATywNh6bZuzm8s1ceuBUnMUAeoAHHw,13,12,2,6,0,0,1,0,21,3.0,2,0.0,2,2,6,0,10,0,0,1,0,10,11,0
381,4598,izDb8XjXh0aaLsv56xtUKjGq4nGYtog4,G8EPVSXsOYB5YQWZGiz1aVq5Pgr2GrQu,27,19,16,0,12,0,5,0,52,7.428571428571429,1,0.0,1,16,0,12,18,0,0,5,0,29,23,0
382,4602,1qPavhGaGseYAa3UI9iFE9Ty6uv8yxcD,5X6FeZozNMgE2VRi3MJYjkkFK8SETtu2,15,30,3,17,12,0,5,0,67,9.571428571428571,1,0.0,25,3,15,12,5,0,2,5,0,55,12,1
383,4613,aVE6FAaI67jjqObdfL3BkKQUvDsOp43M,SpATywNh6bZuzm8s1ceuBUnMUAeoAHHw,48,145,77,42,27,30,92,5,418,59.714285714285715,4,0.0,40,77,37,27,105,30,5,92,5,181,237,0
384,4614,D77mYRAEHVmHmrch91cWflZwkGfWXMn3,SpATywNh6bZuzm8s1ceuBUnMUAeoAHHw,10,11,0,0,0,0,2,0,13,1.8571428571428572,1,0.0,0,0,0,0,11,0,0,2,0,0,13,1
385,4625,qRy2DimM9SNsqYvrYrrnIw2oQKcYB3wP,SpATywNh6bZuzm8s1ceuBUnMUAeoAHHw,16,22,2,15,1,0,4,0,44,6.285714285714286,2,0.0,2,2,12,1,20,0,3,4,0,17,27,0
386,4630,DLDhUvvvfnnYFJuV65Zt2yaS0jPJgvzq,G8EPVSXsOYB5YQWZGiz1aVq5Pgr2GrQu,7,9,0,0,0,0,6,0,15,2.142857142857143,3,0.0,1,0,0,0,8,0,0,6,0,1,14,0
387,4637,jWkqymVvvfv6xuX5RWgcj99r1zpcnb3g,SpATywNh6bZuzm8s1ceuBUnMUAeoAHHw,14,19,2,6,1,2,6,0,36,5.142857142857143,2,0.0,0,2,5,1,19,2,1,6,0,8,28,0
388,4641,8oxFWBumsNA4SJ0CIJujNkjFW8ZzMgtQ,SpATywNh6bZuzm8s1ceuBUnMUAeoAHHw,16,39,1,15,0,10,23,1,89,12.714285714285714,5,0.0,4,1,12,0,35,10,3,23,1,17,72,0
389,4646,bfYktB6xMRG2G8ooGt6o3rE63qV6JxlI,5X6FeZozNMgE2VRi3MJYjkkFK8SETtu2,22,41,12,25,19,3,11,1,112,16.0,3,0.0,25,12,23,19,16,3,2,11,1,79,33,1
390,4647,MKlpymF14KtyI236a0RjVjNdDlFXwHJE,SpATywNh6bZuzm8s1ceuBUnMUAeoAHHw,17,27,9,5,1,3,2,0,47,6.714285714285714,4,0.0,6,9,5,1,21,3,0,2,0,21,26,0
391,4664,kMN5uYNaj23K9PVTrdyiL9iDB1lCye57,SpATywNh6bZuzm8s1ceuBUnMUAeoAHHw,22,40,15,12,6,14,9,0,96,13.714285714285714,4,0.0,7,15,11,6,33,14,1,9,0,39,57,0
392,4672,LBkf4MhTcgqLqBnp8u6ZnAtRKKkDVT0Y,RXDvfPUBYFlVdlueBFbLW0mhhAyGEqpt,77,81,47,89,22,5,9,1,254,36.285714285714285,3,0.0,27,47,83,22,54,5,6,9,1,179,75,0
393,4690,uOFQjpYGMV24K1kl5khOKpWKqO5hcEHE,SpATywNh6bZuzm8s1ceuBUnMUAeoAHHw,20,30,4,17,3,5,13,2,74,10.571428571428571,4,0.0,5,4,14,3,25,5,3,13,2,26,48,0
394,4721,f3gOHcsH9dxbGnjsoxzcxRnJIKI7kpN0,5X6FeZozNMgE2VRi3MJYjkkFK8SETtu2,17,21,5,14,8,3,11,2,64,9.142857142857142,1,0.0,13,5,13,8,8,3,1,11,2,39,25,1
395,4724,CjC2ROZAsG20pDynA7ZPw7kC7J3IUQLv,SpATywNh6bZuzm8s1ceuBUnMUAeoAHHw,16,13,8,10,4,0,2,0,37,5.285714285714286,2,0.0,2,8,10,4,11,0,0,2,0,24,13,0
396,4747,2YrfQZgyUPdiZGXhplgKBSkvHochAfw6,SpATywNh6bZuzm8s1ceuBUnMUAeoAHHw,21,74,36,0,12,2,16,0,140,20.0,6,0.0,4,36,0,12,70,2,0,16,0,52,88,0
397,4781,OOsRSTJd6U7cE43XHk99M9ofvrefufrh,5X6FeZozNMgE2VRi3MJYjkkFK8SETtu2,9,17,3,8,5,0,2,0,35,5.0,2,0.0,7,3,7,5,10,0,1,2,0,22,13,1
398,4790,WoOgbdNrXyv06YgEFJ3swrzgLpeYWjTw,5X6FeZozNMgE2VRi3MJYjkkFK8SETtu2,23,33,16,20,10,15,11,5,110,15.714285714285714,3,0.0,10,16,17,10,23,15,3,11,5,53,57,1
399,4792,SmONSyS4YgG4Afnv6ZxU81t7p4CQPV5P,5X6FeZozNMgE2VRi3MJYjkkFK8SETtu2,5,7,1,0,1,0,2,0,11,1.5714285714285714,2,0.0,0,1,0,1,7,0,0,2,0,2,9,1
400,4801,uvl7kPB3Po3jrDtnQvCsunCWcJhdeQPU,A3fsA9Zfv1X2fVEQhTw51lKENdNrEqT3,6,6,2,0,1,0,5,0,14,2.0,2,0.0,0,2,0,1,6,0,0,5,0,3,11,1
401,4802,aI2WbSCktVyijPTHCbgAdpzpfdnFGcq9,RXDvfPUBYFlVdlueBFbLW0mhhAyGEqpt,16,67,33,0,1,0,8,0,109,15.571428571428571,3,0.0,0,33,0,1,67,0,0,8,0,34,75,0
402,4806,iGjPcJm3i62KsWTQKhrsxcQv7n97iair,G8EPVSXsOYB5YQWZGiz1aVq5Pgr2GrQu,63,138,15,160,2,16,20,1,352,50.285714285714285,6,0.0,39,15,118,2,99,16,42,20,1,174,178,0
403,4819,srJeJbIuD6nlvLtYdUFiQcvh7X1ghk8m,5X6FeZozNMgE2VRi3MJYjkkFK8SETtu2,23,61,3,39,22,2,5,0,132,18.857142857142858,2,0.0,40,3,37,22,21,2,2,5,0,102,30,1
404,4825,q3SjGV3d1qwn1q3ehoXsAmC01281iVQV,SpATywNh6bZuzm8s1ceuBUnMUAeoAHHw,19,31,25,16,18,0,4,0,94,13.428571428571429,3,0.0,1,25,13,18,30,0,3,4,0,57,37,0
405,4827,yNygMjDRQbsmQrkdzv6Ni3gEhrA9rC9T,SpATywNh6bZuzm8s1ceuBUnMUAeoAHHw,5,6,4,0,0,0,2,0,12,1.7142857142857142,1,0.0,0,4,0,0,6,0,0,2,0,4,8,0
406,4852,bvRAS0uJ0Teq8mZcNb9rxcXigDj59DTa,RXDvfPUBYFlVdlueBFbLW0mhhAyGEqpt,8,7,5,0,0,0,2,0,14,2.0,1,0.0,0,5,0,0,7,0,0,2,0,5,9,0
407,4876,JEyrK2UFmqy57ey0eTcC8j1tS8jjredk,5X6FeZozNMgE2VRi3MJYjkkFK8SETtu2,11,12,6,0,4,0,9,1,32,4.571428571428571,2,0.0,2,6,0,4,10,0,0,9,1,12,20,1
408,4903,jJEQAKDG1yT0OS9qRBZrNXlEJDxE8Etq,A3fsA9Zfv1X2fVEQhTw51lKENdNrEqT3,10,25,4,5,0,67,12,0,113,16.142857142857142,8,0.0,0,4,4,0,25,67,1,12,0,8,105,0
409,4907,24hyIKTWvGbDpRNiVA2hNdG9ApRuVKWS,SpATywNh6bZuzm8s1ceuBUnMUAeoAHHw,27,22,15,18,11,0,4,0,70,10.0,2,0.0,4,15,15,11,18,0,3,4,0,45,25,0
410,4910,FlH4hJdTFopI7d7C8aCFmJunlCxyAcSh,SpATywNh6bZuzm8s1ceuBUnMUAeoAHHw,35,38,23,28,13,3,12,2,119,17.0,3,0.0,10,23,24,13,28,3,4,12,2,70,49,1
411,4920,QDpN8D19Mr8RZumTONWpZNlCWcHCCTbH,5X6FeZozNMgE2VRi3MJYjkkFK8SETtu2,15,25,1,0,12,0,3,0,41,5.857142857142857,3,0.0,12,1,0,12,13,0,0,3,0,25,16,1
412,4931,eiL4sJzBUqNqEAwJXavGTHQchRgg0E9e,G8EPVSXsOYB5YQWZGiz1aVq5Pgr2GrQu,60,44,5,208,2,0,12,2,273,39.0,6,0.0,11,5,170,2,33,0,38,12,2,188,85,0
413,4934,RkupeBiDJM8eQAHegSIZXnYfypYMPCFs,SpATywNh6bZuzm8s1ceuBUnMUAeoAHHw,7,10,6,0,0,0,2,0,18,2.5714285714285716,2,0.0,0,6,0,0,10,0,0,2,0,6,12,0
414,4937,aZcgamrUxwqX7Nt2qxeI2ZGGKhcvbWIt,SpATywNh6bZuzm8s1ceuBUnMUAeoAHHw,28,56,1,51,0,0,7,0,115,16.428571428571427,2,0.0,23,1,41,0,33,0,10,7,0,65,50,0
415,4954,w9jybkX7jENxFw2ZN48ruQIJfCGfUCTe,bWdj2GDclj5ofokWjzoa5jAwMkxCykd6,7,6,0,4,0,0,3,0,13,1.8571428571428572,2,0.0,0,0,2,0,6,0,2,3,0,2,11,1
416,4956,w9jybkX7jENxFw2ZN48ruQIJfCGfUCTe,A3fsA9Zfv1X2fVEQhTw51lKENdNrEqT3,7,6,0,0,0,0,5,0,11,1.5714285714285714,2,0.0,0,0,0,0,6,0,0,5,0,0,11,1
417,4982,3ZzNkdWgGb47Go07PRKPf0XZ6jjhVCB4,A3fsA9Zfv1X2fVEQhTw51lKENdNrEqT3,14,21,15,16,7,10,6,0,75,10.714285714285714,4,0.0,0,15,12,7,21,10,4,6,0,34,41,0
418,4984,3h1zqwMTeQWdhoWHPgvllPWyD6P0qFtr,SpATywNh6bZuzm8s1ceuBUnMUAeoAHHw,14,24,18,0,10,0,6,0,58,8.285714285714286,3,0.0,2,18,0,10,22,0,0,6,0,30,28,0
419,4989,WxVM9kOqNmenlQy1YKMo3yVYKYKkewCz,A3fsA9Zfv1X2fVEQhTw51lKENdNrEqT3,7,9,5,0,2,0,4,0,20,2.857142857142857,3,0.0,0,5,0,2,9,0,0,4,0,7,13,0
420,5009,lgip049r6Eu24ga2SPdixKHu4ShoVkOP,SpATywNh6bZuzm8s1ceuBUnMUAeoAHHw,33,27,18,12,11,1,11,1,81,11.571428571428571,2,0.0,5,18,10,11,22,1,2,11,1,44,37,0
421,5026,m9R5p8ELPeEGL2TgmgmNZypetc0YKw9N,5X6FeZozNMgE2VRi3MJYjkkFK8SETtu2,10,13,6,0,8,0,4,0,31,4.428571428571429,1,0.0,6,6,0,8,7,0,0,4,0,20,11,1
422,5028,v1AqHfMoNhUox9GyIOrxftKibIp07zrt,RXDvfPUBYFlVdlueBFbLW0mhhAyGEqpt,12,13,10,0,8,0,3,0,34,4.857142857142857,2,0.0,0,10,0,8,13,0,0,3,0,18,16,1
423,5058,UJNew1tDOTKAwtlVI7Xin0dzgnQGk4oE,SpATywNh6bZuzm8s1ceuBUnMUAeoAHHw,21,17,11,21,5,0,7,0,61,8.714285714285714,4,0.0,2,11,19,5,15,0,2,7,0,37,24,0
424,5081,EEKRPW8tn9Mg3QBn5MHwc7463f6P9lSa,SpATywNh6bZuzm8s1ceuBUnMUAeoAHHw,8,7,0,0,0,0,1,0,8,1.1428571428571428,1,0.0,0,0,0,0,7,0,0,1,0,0,8,1
425,5084,kMzMJEHy7fAHiNUZU0um3I2BsPC7gMll,bWdj2GDclj5ofokWjzoa5jAwMkxCykd6,31,31,19,78,11,8,10,0,157,22.428571428571427,7,0.0,5,19,65,11,26,8,13,10,0,100,57,0
426,5106,77HeNUdRA0IEkObqGpfDRUjK9MGFXlcs,SpATywNh6bZuzm8s1ceuBUnMUAeoAHHw,22,56,30,5,23,5,15,0,134,19.142857142857142,4,0.0,0,30,4,23,56,5,1,15,0,57,77,0
427,5112,eXHbDnPXGOepjGY8R1QdCMeSWp9NDZZc,SpATywNh6bZuzm8s1ceuBUnMUAeoAHHw,32,51,28,14,17,13,4,0,127,18.142857142857142,3,0.0,6,28,14,17,45,13,0,4,0,65,62,0
428,5114,3SWDgl41jXPWPBCB5sVpNEwmW9L3MerS,SpATywNh6bZuzm8s1ceuBUnMUAeoAHHw,36,50,32,29,15,0,5,0,131,18.714285714285715,4,0.0,9,32,25,15,41,0,4,5,0,81,50,0
429,5148,uN992cfJ2NJqNQmns1XgyEcZyWUiJR0U,SpATywNh6bZuzm8s1ceuBUnMUAeoAHHw,23,54,9,7,3,4,12,0,89,12.714285714285714,4,0.0,10,9,7,3,44,4,0,12,0,29,60,0
430,5163,nOBQYWrG3xrA9IeoO0kkFbpfztBbno3g,A3fsA9Zfv1X2fVEQhTw51lKENdNrEqT3,12,6,5,0,4,1,3,0,19,2.7142857142857144,1,0.0,0,5,0,4,6,1,0,3,0,9,10,1
431,5168,UWuyaaoLwLnyFDmtW8yT3lff7bHBBBqe,SpATywNh6bZuzm8s1ceuBUnMUAeoAHHw,17,23,2,14,2,0,4,0,45,6.428571428571429,3,0.0,2,2,12,2,21,0,2,4,0,18,27,0
432,5176,Qi3PLuC7w2Yo9hFgq37MObjY8icnRdc6,5X6FeZozNMgE2VRi3MJYjkkFK8SETtu2,4,3,1,0,1,0,1,0,6,0.8571428571428571,1,0.0,0,1,0,1,3,0,0,1,0,2,4,1
433,5255,0NbLYZNvmNdh82upKkBVVwJoa5b6RKVj,SpATywNh6bZuzm8s1ceuBUnMUAeoAHHw,16,32,11,6,5,0,4,0,58,8.285714285714286,3,0.0,3,11,5,5,29,0,1,4,0,24,34,0
434,5284,QqE2Xjwy9gUzOvFdkDqAwAaNZLBZkxvd,RXDvfPUBYFlVdlueBFbLW0mhhAyGEqpt,29,47,6,22,5,34,16,0,130,18.571428571428573,6,0.0,7,6,19,5,40,34,3,16,0,37,93,0
435,5290,4xEpIgR9alQqM4xeSug69KmBmO9gpD69,A3fsA9Zfv1X2fVEQhTw51lKENdNrEqT3,61,49,32,64,17,4,23,1,190,27.142857142857142,3,0.0,2,32,56,17,47,4,8,23,1,107,83,0
436,5293,Ta6WQlpuBnJV22uRUjTDrQopOfeygKUE,5X6FeZozNMgE2VRi3MJYjkkFK8SETtu2,25,34,12,44,11,0,4,0,105,15.0,2,0.0,19,12,34,11,15,0,10,4,0,76,29,1
437,5311,SFbTZDEo0JTOG7VHfxeJz2kz3qSzlHq4,SpATywNh6bZuzm8s1ceuBUnMUAeoAHHw,22,30,1,35,0,0,3,0,69,9.857142857142858,3,0.0,12,1,30,0,18,0,5,3,0,43,26,0
438,5316,0tT4cQq52T8bu4irQ9KewNXtlD33hVZo,SpATywNh6bZuzm8s1ceuBUnMUAeoAHHw,19,23,11,15,5,0,4,0,58,8.285714285714286,2,0.0,7,11,13,5,16,0,2,4,0,36,22,0
439,5337,a6f3gPi6axX0cfBnUGVliBDQrPx92l1r,bWdj2GDclj5ofokWjzoa5jAwMkxCykd6,10,16,11,0,4,0,3,0,34,4.857142857142857,2,0.0,2,11,0,4,14,0,0,3,0,17,17,1
440,5369,AcgDUm5SSEb0zgM8tYKiOFvTewc0KRAc,SpATywNh6bZuzm8s1ceuBUnMUAeoAHHw,40,40,26,22,14,1,9,1,113,16.142857142857142,4,0.0,9,26,19,14,31,1,3,9,1,68,45,0
441,5416,nds56JS5tgInTRshD1ZJkwXi4oW5Ln7a,RXDvfPUBYFlVdlueBFbLW0mhhAyGEqpt,43,87,45,76,20,73,32,1,334,47.714285714285715,8,0.0,16,45,74,20,71,73,2,32,1,155,179,0
442,5470,acVvGaaH1iVFQOYF94V9THpGPkF7EIj3,SpATywNh6bZuzm8s1ceuBUnMUAeoAHHw,15,14,6,28,0,6,6,0,60,8.571428571428571,2,0.0,5,6,25,0,9,6,3,6,0,36,24,0
443,5471,ZWj0iRzT4HOMV032BfEyYj9IEk1Rdo03,SpATywNh6bZuzm8s1ceuBUnMUAeoAHHw,38,57,34,27,12,40,24,0,194,27.714285714285715,7,0.0,13,34,25,12,44,40,2,24,0,84,110,0
444,5482,lfAQ0nsHdkBDoIcTW4jXyPy4wOsVYtMB,RXDvfPUBYFlVdlueBFbLW0mhhAyGEqpt,39,35,20,86,14,0,7,0,162,23.142857142857142,4,0.0,9,20,80,14,26,0,6,7,0,123,39,1
445,5495,xsW19PmjvHmfOgtSCjdxnkpzOWqbKfLn,SpATywNh6bZuzm8s1ceuBUnMUAeoAHHw,36,52,26,22,10,2,11,0,123,17.571428571428573,4,0.0,18,26,17,10,34,2,5,11,0,71,52,0
446,5507,n3cFXGx3rjoPJPOmeF5tlnmkFmFFJI7p,5X6FeZozNMgE2VRi3MJYjkkFK8SETtu2,5,2,1,0,1,0,2,0,6,0.8571428571428571,1,0.0,0,1,0,1,2,0,0,2,0,2,4,1
447,5548,c0aU5RgllqMj1NNDQEzDSUbWmFuFrvQ6,5X6FeZozNMgE2VRi3MJYjkkFK8SETtu2,6,3,2,0,2,0,2,0,9,1.2857142857142858,1,0.0,0,2,0,2,3,0,0,2,0,4,5,1
448,5584,Qt99KRFUK6FY5ovJvB9yRLziSf5bEirX,SpATywNh6bZuzm8s1ceuBUnMUAeoAHHw,8,10,5,0,3,0,2,0,20,2.857142857142857,1,0.0,0,5,0,3,10,0,0,2,0,8,12,1
449,5606,Ecxkox9cBNw9DlXWEeDlSJP4O73ORQaY,SpATywNh6bZuzm8s1ceuBUnMUAeoAHHw,4,9,1,0,0,0,2,0,12,1.7142857142857142,4,0.0,0,1,0,0,9,0,0,2,0,1,11,0
450,5641,dzQyKxZ43BiLWGC6nfqSfnHfJKyWUbky,SpATywNh6bZuzm8s1ceuBUnMUAeoAHHw,15,10,8,2,5,0,1,0,26,3.7142857142857144,1,0.0,0,8,2,5,10,0,0,1,0,15,11,1
451,5642,IAvuP4GGmvnNj3Zisz3jDfo3mSmXiJSb,A3fsA9Zfv1X2fVEQhTw51lKENdNrEqT3,1,0,0,0,0,0,2,0,2,0.2857142857142857,2,0.0,0,0,0,0,0,0,0,2,0,0,2,1
452,5644,J388HMX5pYHjqXdA7jEUkFec6orRQtIq,A3fsA9Zfv1X2fVEQhTw51lKENdNrEqT3,42,51,19,0,14,0,4,0,88,12.571428571428571,1,0.0,0,19,0,14,51,0,0,4,0,33,55,0
453,5660,CZZkgDgsqVR6ftNFrTmx0jPpBHh2f3Zo,SpATywNh6bZuzm8s1ceuBUnMUAeoAHHw,20,57,1,18,0,0,9,0,85,12.142857142857142,4,0.0,14,1,14,0,43,0,4,9,0,29,56,0
454,5671,HbDaABEakQmE8DQEoFoIphu2SH13rFRy,A3fsA9Zfv1X2fVEQhTw51lKENdNrEqT3,8,6,5,2,2,0,1,0,16,2.2857142857142856,1,0.0,0,5,2,2,6,0,0,1,0,9,7,1
455,5675,HbDaABEakQmE8DQEoFoIphu2SH13rFRy,RXDvfPUBYFlVdlueBFbLW0mhhAyGEqpt,9,5,3,8,1,0,1,0,18,2.5714285714285716,1,0.0,1,3,7,1,4,0,1,1,0,12,6,1
456,5709,PUW0i4IuafllkJEtV0GCqmTDeLHkDmH3,5X6FeZozNMgE2VRi3MJYjkkFK8SETtu2,16,56,25,4,15,1,12,0,113,16.142857142857142,4,0.0,20,25,3,15,36,1,1,12,0,63,50,1
457,5740,PizUKf6mRUas66X3VMYXf9aygnN1CUCf,SpATywNh6bZuzm8s1ceuBUnMUAeoAHHw,13,14,11,0,8,0,2,0,35,5.0,1,0.0,0,11,0,8,14,0,0,2,0,19,16,1
458,5742,SfZbjjvyiSDCCOAoK4WFbDb5dRmW5oVl,5X6FeZozNMgE2VRi3MJYjkkFK8SETtu2,1,0,0,0,0,0,1,0,1,0.14285714285714285,1,0.0,0,0,0,0,0,0,0,1,0,0,1,1
459,5743,57qzgJAwfROYPxzSOrsA3G5DLHP95ajU,RXDvfPUBYFlVdlueBFbLW0mhhAyGEqpt,20,20,15,0,9,0,4,0,48,6.857142857142857,4,0.0,1,15,0,9,19,0,0,4,0,25,23,0
460,5746,seRgjh60dHSex83x3yaP07EkHkNZ3zq1,SpATywNh6bZuzm8s1ceuBUnMUAeoAHHw,8,14,9,0,5,6,4,0,38,5.428571428571429,4,0.0,0,9,0,5,14,6,0,4,0,14,24,0
461,5785,Llzpy0Dk1LPSE6nBLZ8vNVNgQXCzGpc1,SpATywNh6bZuzm8s1ceuBUnMUAeoAHHw,17,10,7,9,5,0,1,0,32,4.571428571428571,1,0.0,2,7,9,5,8,0,0,1,0,23,9,1
462,5788,zysr84QD6b78mLaezXoryEdhH6kH14EQ,SpATywNh6bZuzm8s1ceuBUnMUAeoAHHw,5,9,3,0,0,0,5,0,17,2.4285714285714284,2,0.0,0,3,0,0,9,0,0,5,0,3,14,0
463,5789,C6xrhZPOmVH2gCVNP26gSSPka2CcwgB5,5X6FeZozNMgE2VRi3MJYjkkFK8SETtu2,16,21,6,14,10,0,10,0,61,8.714285714285714,2,0.0,15,6,13,10,6,0,1,10,0,44,17,1
464,5792,GIb3glgYrsEfHWtEWPWpwONqwE7RMf6f,bWdj2GDclj5ofokWjzoa5jAwMkxCykd6,49,69,34,94,8,36,18,1,260,37.142857142857146,6,0.0,12,34,83,8,57,36,11,18,1,137,123,0
465,5801,NMqhcmmxkLiM0RcDlPlkNnMgmo9q8VT7,5X6FeZozNMgE2VRi3MJYjkkFK8SETtu2,8,8,3,0,7,0,1,0,19,2.7142857142857144,1,0.0,4,3,0,7,4,0,0,1,0,14,5,1
466,5803,sD3rDh1CtXsAdfDDyFRBf917K7ELQzHQ,SpATywNh6bZuzm8s1ceuBUnMUAeoAHHw,21,66,6,24,1,0,14,0,111,15.857142857142858,5,0.0,13,6,21,1,53,0,3,14,0,41,70,0
467,5822,yXIAbgjR7S4042oicRyG8kfTX0pG8yI5,SpATywNh6bZuzm8s1ceuBUnMUAeoAHHw,8,15,5,0,5,0,1,0,26,3.7142857142857144,2,0.0,0,5,0,5,15,0,0,1,0,10,16,0
468,5826,zTf8XOQnwWWl1KDwh9NJmoY9QiDPt6oU,SpATywNh6bZuzm8s1ceuBUnMUAeoAHHw,9,13,5,10,0,0,6,0,34,4.857142857142857,1,0.0,5,5,10,0,8,0,0,6,0,20,14,0
469,5865,Ojf2FGMPjkgcQ8cOS7KSlXqYowZOsPoh,A3fsA9Zfv1X2fVEQhTw51lKENdNrEqT3,4,3,2,0,0,0,1,0,6,0.8571428571428571,1,0.0,0,2,0,0,3,0,0,1,0,2,4,0
470,5890,8c2gk77rfHeG4kEZpifVHT547X2ayTNE,RXDvfPUBYFlVdlueBFbLW0mhhAyGEqpt,9,9,6,0,0,5,5,0,25,3.5714285714285716,2,0.0,0,6,0,0,9,5,0,5,0,6,19,0
471,5891,PenDUeO0eoR8hyLVdfPN6H7q2FnTGMus,5X6FeZozNMgE2VRi3MJYjkkFK8SETtu2,9,15,2,2,1,7,7,1,35,5.0,1,0.0,8,2,2,1,7,7,0,7,1,13,22,1
472,5892,1YxknoiTrSwQgclDlSAh4oMYHRyARhLv,SpATywNh6bZuzm8s1ceuBUnMUAeoAHHw,8,6,3,5,0,0,3,0,17,2.4285714285714284,2,0.0,2,3,5,0,4,0,0,3,0,10,7,0
473,5902,7o8xhk1rh0BQyK6zL1slDKappRA3D8Mk,SpATywNh6bZuzm8s1ceuBUnMUAeoAHHw,17,26,4,11,4,0,26,0,71,10.142857142857142,3,0.0,2,4,11,4,24,0,0,26,0,21,50,0
474,5966,ClOQgL2YoKdTIw9nVe15uHQUMfFPajE3,5X6FeZozNMgE2VRi3MJYjkkFK8SETtu2,13,16,1,16,1,3,16,3,56,8.0,1,0.0,8,1,13,1,8,3,3,16,3,23,33,1
475,6001,Wb4KcRKSzKNnIp1HnFKSZY95LILGuTll,SpATywNh6bZuzm8s1ceuBUnMUAeoAHHw,14,20,0,12,0,0,2,0,34,4.857142857142857,1,0.0,3,0,10,0,17,0,2,2,0,13,21,0
476,6018,cJcuhtji0eqLhfXtnFSDlw6v5huTlvOS,SpATywNh6bZuzm8s1ceuBUnMUAeoAHHw,10,12,0,13,0,0,5,0,30,4.285714285714286,2,0.0,5,0,10,0,7,0,3,5,0,15,15,0
477,6031,H2B0ZVh2RYo5LjimmBQ15UDjcAOL7h2y,A3fsA9Zfv1X2fVEQhTw51lKENdNrEqT3,1,0,0,0,0,0,1,0,1,0.14285714285714285,1,0.0,0,0,0,0,0,0,0,1,0,0,1,1
478,6048,hf7YI3B1kTTuvmd2vS9DIoiPGXbrQyBH,SpATywNh6bZuzm8s1ceuBUnMUAeoAHHw,14,17,5,16,3,0,3,0,44,6.285714285714286,1,0.0,2,5,13,3,15,0,3,3,0,23,21,0
479,6058,KrIVcXIiCdwRGUI4WguKXHPsvZChbtIb,A3fsA9Zfv1X2fVEQhTw51lKENdNrEqT3,36,23,21,88,9,30,4,0,175,25.0,3,0.0,1,21,70,9,22,30,18,4,0,101,74,0
480,6061,KrIVcXIiCdwRGUI4WguKXHPsvZChbtIb,5X6FeZozNMgE2VRi3MJYjkkFK8SETtu2,30,71,32,52,13,55,27,0,250,35.714285714285715,12,0.0,19,32,41,13,52,55,11,27,0,105,145,0
481,6069,imazrFpyX68kLUAydat119Z5XKshja9y,SpATywNh6bZuzm8s1ceuBUnMUAeoAHHw,17,14,9,12,4,0,1,0,40,5.714285714285714,1,0.0,4,9,11,4,10,0,1,1,0,28,12,0
482,6086,ZL7VsgZBlKFfi6BGNSyN1gGJros1L9ra,SpATywNh6bZuzm8s1ceuBUnMUAeoAHHw,8,10,5,0,3,3,2,0,23,3.2857142857142856,1,0.0,0,5,0,3,10,3,0,2,0,8,15,1
483,6087,uUWoPLkJSFKbD6KppcebOwMXezopCcLj,SpATywNh6bZuzm8s1ceuBUnMUAeoAHHw,10,26,0,12,0,3,5,0,46,6.571428571428571,2,0.0,10,0,11,0,16,3,1,5,0,21,25,0
484,6135,bJ0ocYs4A8xL8l054ix6Xw9bRk0Rp5no,5X6FeZozNMgE2VRi3MJYjkkFK8SETtu2,7,13,0,6,0,1,9,1,30,4.285714285714286,4,0.0,0,0,6,0,13,1,0,9,1,6,24,1
485,6203,qwOn6svjZUr6PbEPbdgCynJcocJs2Tff,SpATywNh6bZuzm8s1ceuBUnMUAeoAHHw,21,23,11,7,7,1,8,1,58,8.285714285714286,4,0.0,2,11,7,7,21,1,0,8,1,27,31,0
486,6215,FgYPvBwLri7YiFI9og6clP9FuKJ08jX7,SpATywNh6bZuzm8s1ceuBUnMUAeoAHHw,26,21,14,6,9,0,4,0,54,7.714285714285714,3,0.0,3,14,6,9,18,0,0,4,0,32,22,1
487,6222,2CJPniJdzPQB2xVD7usFld4N6998DubA,SpATywNh6bZuzm8s1ceuBUnMUAeoAHHw,37,30,20,22,13,3,9,1,98,14.0,3,0.0,8,20,16,13,22,3,6,9,1,57,41,0
488,6225,f2GMLkjrqGdN19ysxF64zEiQj9fxR4cG,5X6FeZozNMgE2VRi3MJYjkkFK8SETtu2,2,0,0,0,0,0,4,0,4,0.5714285714285714,1,0.0,0,0,0,0,0,0,0,4,0,0,4,1
489,6235,ywdL3xkp7d2PSjbvnflAvIe7Wp6Q4SRe,A3fsA9Zfv1X2fVEQhTw51lKENdNrEqT3,44,29,18,116,14,0,6,0,183,26.142857142857142,2,0.0,1,18,116,14,28,0,0,6,0,149,34,0
490,6241,JOowoFboUWVsMh86KvKaqn28cyqJccLu,SpATywNh6bZuzm8s1ceuBUnMUAeoAHHw,26,45,2,25,0,0,6,0,78,11.142857142857142,3,0.0,6,2,20,0,39,0,5,6,0,28,50,1
491,6249,wlfhNc0EqwNzSbWGuR5Gw22PX4idrOB9,5X6FeZozNMgE2VRi3MJYjkkFK8SETtu2,30,88,25,44,24,0,20,1,202,28.857142857142858,5,0.0,48,25,36,24,40,0,8,20,1,133,69,1
492,6251,xHZbSROhwP4RRQerUVWvcNTfOGc2DHWf,A3fsA9Zfv1X2fVEQhTw51lKENdNrEqT3,75,68,38,182,15,35,37,0,375,53.57142857142857,8,0.0,2,38,147,15,66,35,35,37,0,202,173,0
493,6276,e05jFgKTpMKrOATktordZrOlXAadcmLm,bWdj2GDclj5ofokWjzoa5jAwMkxCykd6,1,0,0,0,0,0,1,0,1,0.14285714285714285,1,0.0,0,0,0,0,0,0,0,1,0,0,1,1
494,6301,4NUGABfnQkRS9FoH90Vgnhdha4tRSmOB,A3fsA9Zfv1X2fVEQhTw51lKENdNrEqT3,55,52,38,130,18,0,12,0,250,35.714285714285715,6,0.0,2,38,97,18,50,0,33,12,0,155,95,0
495,6322,2IvFgMw0NfaiiFt35dmyYrQHt1TRMHZA,SpATywNh6bZuzm8s1ceuBUnMUAeoAHHw,34,53,23,40,9,34,21,0,180,25.714285714285715,2,0.0,16,23,34,9,37,34,6,21,0,82,98,0
496,6360,S6vBzHKpSh31SFGGZmwgKaOH2RvW3RpH,A3fsA9Zfv1X2fVEQhTw51lKENdNrEqT3,1,0,0,0,0,0,1,0,1,0.14285714285714285,1,0.0,0,0,0,0,0,0,0,1,0,0,1,0
497,6361,8nT76hrzyl8ZAUdI7W6kfrIzHxI3puKM,A3fsA9Zfv1X2fVEQhTw51lKENdNrEqT3,47,23,0,200,0,0,10,0,233,33.285714285714285,4,0.0,6,0,167,0,17,0,33,10,0,173,60,0
498,6386,sgU8bYbkNg27HLTOfRzwWIg1HmjCd9Xd,SpATywNh6bZuzm8s1ceuBUnMUAeoAHHw,17,22,1,18,2,0,6,0,49,7.0,1,0.0,4,1,14,2,18,0,4,6,0,21,28,0
499,6391,VWT0erf4AD2BzAGMlVwaBcrhUFyVXGW3,SpATywNh6bZuzm8s1ceuBUnMUAeoAHHw,16,20,0,10,0,0,6,0,36,5.142857142857143,2,0.0,5,0,10,0,15,0,0,6,0,15,21,0
500,6396,mXsmDArxUTe9rMFHp3cGPJEx5ACYKD90,SpATywNh6bZuzm8s1ceuBUnMUAeoAHHw,29,37,10,22,6,12,11,2,100,14.285714285714286,4,0.0,7,10,17,6,30,12,5,11,2,40,60,0
501,6407,y7mamutAMELy79Bgdj0zOeVjiQ071oNX,SpATywNh6bZuzm8s1ceuBUnMUAeoAHHw,20,18,11,14,5,0,2,0,50,7.142857142857143,3,0.0,4,11,11,5,14,0,3,2,0,31,19,0
502,6427,vuqnfFRpmwKE9RdxK6XJMNF9m6H6VyTM,RXDvfPUBYFlVdlueBFbLW0mhhAyGEqpt,36,44,28,62,15,7,12,0,168,24.0,4,0.0,12,28,58,15,32,7,4,12,0,113,55,0
503,6473,QYNtwRXZGk0TiZU9fvvZmyYTg9wzmVe8,bWdj2GDclj5ofokWjzoa5jAwMkxCykd6,15,3,0,38,0,0,2,0,43,6.142857142857143,1,0.0,0,0,37,0,3,0,1,2,0,37,6,0
504,6475,4NUGABfnQkRS9FoH90Vgnhdha4tRSmOB,SpATywNh6bZuzm8s1ceuBUnMUAeoAHHw,21,38,20,10,9,2,16,0,95,13.571428571428571,6,0.0,8,20,8,9,30,2,2,16,0,45,50,0
505,6480,fFnDSL1hWADv25SE5UTFI35tGRTcYBEF,SpATywNh6bZuzm8s1ceuBUnMUAeoAHHw,4,3,1,0,0,0,1,0,5,0.7142857142857143,1,0.0,0,1,0,0,3,0,0,1,0,1,4,0
506,6490,CozZoSX7AwprtwyJFCAeFUYiCq7OSEAP,G8EPVSXsOYB5YQWZGiz1aVq5Pgr2GrQu,15,25,10,0,13,0,0,0,48,6.857142857142857,1,0.0,0,10,0,13,25,0,0,0,0,23,25,0
507,6497,QYNtwRXZGk0TiZU9fvvZmyYTg9wzmVe8,A3fsA9Zfv1X2fVEQhTw51lKENdNrEqT3,24,10,1,52,0,0,3,0,66,9.428571428571429,2,0.0,1,1,45,0,9,0,7,3,0,47,19,0
508,6502,MFUbiMqXEmfaBzK7hirtX5aBXDvqfQ39,RXDvfPUBYFlVdlueBFbLW0mhhAyGEqpt,5,6,3,0,1,0,3,0,13,1.8571428571428572,1,0.0,2,3,0,1,4,0,0,3,0,6,7,0
509,6527,iYw8kPkvjn3xb3wtZEyAytTepRhqUlKj,SpATywNh6bZuzm8s1ceuBUnMUAeoAHHw,12,26,19,0,12,0,9,0,66,9.428571428571429,4,0.0,0,19,0,12,26,0,0,9,0,31,35,0
510,6542,wSw0H7eAN6dfAeYMaWU4nG5bgtRJyFlj,SpATywNh6bZuzm8s1ceuBUnMUAeoAHHw,33,34,21,19,12,0,7,0,93,13.285714285714286,4,0.0,4,21,17,12,30,0,2,7,0,54,39,0
511,6547,6U06x0rZdU2wXE04MeChX934BjpYCGYO,A3fsA9Zfv1X2fVEQhTw51lKENdNrEqT3,4,3,2,0,0,0,1,0,6,0.8571428571428571,1,0.0,0,2,0,0,3,0,0,1,0,2,4,0
512,6556,xeRiyg2Y5ZgvqPGiWyjXk0hLMBeGkeoJ,RXDvfPUBYFlVdlueBFbLW0mhhAyGEqpt,8,8,5,0,2,1,7,0,23,3.2857142857142856,4,0.0,0,5,0,2,8,1,0,7,0,7,16,0
513,6582,MVGkJ43FVRFDNt0Uc0vZz4wcUGSmTO97,5X6FeZozNMgE2VRi3MJYjkkFK8SETtu2,5,2,1,0,1,0,3,0,7,1.0,1,0.0,0,1,0,1,2,0,0,3,0,2,5,1
514,6619,TgtZeZ58ebuFniTgQX061K6ibFhvtBpU,SpATywNh6bZuzm8s1ceuBUnMUAeoAHHw,19,24,10,9,5,0,4,0,52,7.428571428571429,4,0.0,4,10,8,5,20,0,1,4,0,27,25,0
515,6633,hu8eak1Xmf8voE8pnxPzkSD2dZP9Sipf,SpATywNh6bZuzm8s1ceuBUnMUAeoAHHw,2,0,0,0,0,0,2,0,2,0.2857142857142857,1,0.0,0,0,0,0,0,0,0,2,0,0,2,0
516,6634,CozZoSX7AwprtwyJFCAeFUYiCq7OSEAP,SpATywNh6bZuzm8s1ceuBUnMUAeoAHHw,12,31,13,0,10,0,0,0,54,7.714285714285714,3,0.0,0,13,0,10,31,0,0,0,0,23,31,0
517,6635,xKsPjk1jm2BE3h1iJlr6XUhvP4lcDdRk,RXDvfPUBYFlVdlueBFbLW0mhhAyGEqpt,6,5,3,0,1,0,2,0,11,1.5714285714285714,2,0.0,0,3,0,1,5,0,0,2,0,4,7,0
518,6645,jzhfcjSJMALhuWl4kOoGHRTc9xbTfPXO,SpATywNh6bZuzm8s1ceuBUnMUAeoAHHw,3,2,0,0,0,0,2,0,4,0.5714285714285714,1,0.0,0,0,0,0,2,0,0,2,0,0,4,0
519,6664,7nQB7cjVdr2HijR82OoX1oMRPa42JjfY,bWdj2GDclj5ofokWjzoa5jAwMkxCykd6,44,48,27,79,11,1,12,1,179,25.571428571428573,3,0.0,9,27,72,11,39,1,7,12,1,119,60,0
520,6680,dSGnj6srDjb9PWIgErMSQXx2qQzyzYUX,SpATywNh6bZuzm8s1ceuBUnMUAeoAHHw,6,4,2,0,1,0,1,0,8,1.1428571428571428,1,0.0,0,2,0,1,4,0,0,1,0,3,5,0
521,6721,5EbadEY64E8d6mWCOGPXe4HNciATivZW,SpATywNh6bZuzm8s1ceuBUnMUAeoAHHw,21,38,17,12,6,0,6,0,79,11.285714285714286,4,0.0,16,17,10,6,22,0,2,6,0,49,30,0
522,6722,r5hJNp3FkX6JOBVI5bSeTBPneDl7PaKl,A3fsA9Zfv1X2fVEQhTw51lKENdNrEqT3,7,3,0,0,0,0,5,0,8,1.1428571428571428,1,0.0,0,0,0,0,3,0,0,5,0,0,8,1
523,6723,e12uQn96OlYfknMdqSXCXdImglIj4IRR,A3fsA9Zfv1X2fVEQhTw51lKENdNrEqT3,89,89,61,78,19,57,45,2,351,50.142857142857146,8,0.0,8,61,78,19,81,57,0,45,2,166,185,0
524,6724,2VLDXf2vRwSQsnPUMIG8jcgCB93IxRHm,SpATywNh6bZuzm8s1ceuBUnMUAeoAHHw,1,0,0,0,0,0,1,0,1,0.14285714285714285,1,0.0,0,0,0,0,0,0,0,1,0,0,1,1
525,6725,2LSIOP9EwUlEUMR84kNdXwxCTBof59AV,SpATywNh6bZuzm8s1ceuBUnMUAeoAHHw,14,9,7,0,5,0,3,0,24,3.4285714285714284,2,0.0,0,7,0,5,9,0,0,3,0,12,12,0
526,6739,D5mwgoAPtfwdsFrdNADBqEJQSy8E0CUi,SpATywNh6bZuzm8s1ceuBUnMUAeoAHHw,35,37,23,14,11,0,14,5,104,14.857142857142858,2,0.0,8,23,13,11,29,0,1,14,5,55,49,0
527,6740,YkHlvsvfON124uz3tNHCqQavCTgfzIIn,SpATywNh6bZuzm8s1ceuBUnMUAeoAHHw,6,4,2,0,1,0,2,0,9,1.2857142857142858,1,0.0,0,2,0,1,4,0,0,2,0,3,6,1
528,6741,uOAgQLQslSL4cABC9ZqhaeK1XrisqlGh,SpATywNh6bZuzm8s1ceuBUnMUAeoAHHw,26,32,19,13,9,0,14,0,87,12.428571428571429,3,0.0,4,19,12,9,28,0,1,14,0,44,43,0
529,6761,DTS3O3ZujmzMefQXzAvfnTTqItcbsW8A,SpATywNh6bZuzm8s1ceuBUnMUAeoAHHw,10,17,3,0,1,11,2,0,34,4.857142857142857,4,0.0,2,3,0,1,15,11,0,2,0,6,28,0
530,6778,lVgq3gYt1tDiZq5EPAUcQ3qHGrMei1Rm,SpATywNh6bZuzm8s1ceuBUnMUAeoAHHw,35,59,35,18,16,37,20,1,186,26.571428571428573,5,0.0,12,35,14,16,47,37,4,20,1,77,109,0
531,6781,eWIsTbhL2p3ztTyrIxD7wf9RK1qPkZuf,SpATywNh6bZuzm8s1ceuBUnMUAeoAHHw,10,10,8,0,0,0,2,0,20,2.857142857142857,2,0.0,0,8,0,0,10,0,0,2,0,8,12,0
532,6785,ptoBkN66Bt2QtZB1aEXx1ZVYWGKSe4nx,SpATywNh6bZuzm8s1ceuBUnMUAeoAHHw,16,33,1,19,0,0,7,1,61,8.714285714285714,4,0.0,10,1,15,0,23,0,4,7,1,26,35,0
533,6823,DeZ9eduD0lM3aHUAAOCnUrOhgp8jUmje,SpATywNh6bZuzm8s1ceuBUnMUAeoAHHw,3,0,0,0,0,8,6,0,14,2.0,3,0.0,0,0,0,0,0,8,0,6,0,0,14,0
534,6825,QwrR0O4UOobB3AXjFyYOVMeWzFnayzmx,SpATywNh6bZuzm8s1ceuBUnMUAeoAHHw,20,12,8,7,5,3,5,0,40,5.714285714285714,2,0.0,2,8,7,5,10,3,0,5,0,22,18,1
535,6831,DeZ9eduD0lM3aHUAAOCnUrOhgp8jUmje,5X6FeZozNMgE2VRi3MJYjkkFK8SETtu2,7,9,0,8,2,0,4,0,23,3.2857142857142856,1,0.0,7,0,7,2,2,0,1,4,0,16,7,1
536,6841,dSloiolTuQA1YnIVrIEZb5m23cL24cRw,5X6FeZozNMgE2VRi3MJYjkkFK8SETtu2,4,2,1,0,1,0,1,0,5,0.7142857142857143,1,0.0,0,1,0,1,2,0,0,1,0,2,3,1
537,6862,JtMmp5BCDQnYE7CMI3NvnX4aRCZsQW9K,A3fsA9Zfv1X2fVEQhTw51lKENdNrEqT3,19,23,15,0,8,10,12,0,68,9.714285714285714,4,0.0,0,15,0,8,23,10,0,12,0,23,45,0
538,6878,7fC3V6ivG07wUIMOmiYFzSlyjWvbYnYf,SpATywNh6bZuzm8s1ceuBUnMUAeoAHHw,19,21,1,33,0,0,5,0,60,8.571428571428571,3,0.0,4,1,27,0,17,0,6,5,0,32,28,0
539,6896,WVOs4Pi3ll5FpomkXlRuIpcugHN3f0rV,SpATywNh6bZuzm8s1ceuBUnMUAeoAHHw,18,22,13,0,7,0,13,0,55,7.857142857142857,5,0.0,5,13,0,7,17,0,0,13,0,25,30,0
540,6907,CjvViMn5KClGeXFftICAvm8SWkvn3LHW,A3fsA9Zfv1X2fVEQhTw51lKENdNrEqT3,14,19,17,0,15,0,2,0,53,7.571428571428571,1,0.0,0,17,0,15,19,0,0,2,0,32,21,1
541,6908,bKbwS8bsj3eNxoCQcsrg5SKpHAoJ8uGu,5X6FeZozNMgE2VRi3MJYjkkFK8SETtu2,29,104,10,44,16,14,19,0,207,29.571428571428573,6,0.0,37,10,36,16,67,14,8,19,0,99,108,1
542,6934,nsZMAREUaN1W79W768VHLU7EdYuf3Qrp,G8EPVSXsOYB5YQWZGiz1aVq5Pgr2GrQu,12,19,3,0,6,0,10,0,38,5.428571428571429,4,0.0,0,3,0,6,19,0,0,10,0,9,29,0
543,6935,JR1R4x5j4WkP10KgaKlpdN5JIGsgsmdk,SpATywNh6bZuzm8s1ceuBUnMUAeoAHHw,5,4,2,0,0,0,1,0,7,1.0,1,0.0,0,2,0,0,4,0,0,1,0,2,5,1
544,6955,uarVJhEs6XLW7Dw1D7iBgEK6zPe65WwX,5X6FeZozNMgE2VRi3MJYjkkFK8SETtu2,28,81,38,48,37,23,12,0,239,34.142857142857146,8,0.0,32,38,36,37,49,23,12,12,0,143,96,1
545,6972,ySy2zYThCkVZr5MjEXuKxq60wfOynxkJ,RXDvfPUBYFlVdlueBFbLW0mhhAyGEqpt,42,265,0,43,0,21,45,1,375,53.57142857142857,7,0.0,27,0,37,0,238,21,6,45,1,64,311,0
546,6975,ztNAIyTwcTmZ7oVMH6qBDo3dC1RimDND,SpATywNh6bZuzm8s1ceuBUnMUAeoAHHw,16,34,0,24,1,2,10,2,73,10.428571428571429,1,0.0,19,0,19,1,15,2,5,10,2,39,34,0
547,6977,EO1ssFp8oIj0TSE3bDdD8GeuhxRs5RVg,SpATywNh6bZuzm8s1ceuBUnMUAeoAHHw,18,46,10,22,7,0,24,0,109,15.571428571428571,3,0.0,4,10,19,7,42,0,3,24,0,40,69,0
548,6982,R0LbBsHoep5Au5A4mW7do32jHSfgQD8E,SpATywNh6bZuzm8s1ceuBUnMUAeoAHHw,22,33,16,27,8,0,3,0,87,12.428571428571429,1,0.0,14,16,21,8,19,0,6,3,0,59,28,1
549,6986,7fC3V6ivG07wUIMOmiYFzSlyjWvbYnYf,bWdj2GDclj5ofokWjzoa5jAwMkxCykd6,38,21,0,152,0,0,5,0,178,25.428571428571427,3,0.0,6,0,127,0,15,0,25,5,0,133,45,0
550,6992,YvR8b2YAoaLYLpo6WJ6bDiEtPLllysRd,RXDvfPUBYFlVdlueBFbLW0mhhAyGEqpt,17,22,14,6,7,12,14,3,78,11.142857142857142,2,0.0,2,14,6,7,20,12,0,14,3,29,49,0
551,6999,4L8FEL9uQ33lr2hJ5CSJNyGu6GEq5daD,5X6FeZozNMgE2VRi3MJYjkkFK8SETtu2,9,10,6,0,3,18,9,0,46,6.571428571428571,6,0.0,1,6,0,3,9,18,0,9,0,10,36,1
552,7009,oBSB2zh7bYN4yELh7x5ItqnxR463BvKC,bWdj2GDclj5ofokWjzoa5jAwMkxCykd6,31,67,21,64,13,0,8,0,173,24.714285714285715,4,0.0,20,21,56,13,47,0,8,8,0,110,63,0
553,7025,EFMEoi5W4mceo8rjft5LKrYvvT3E2eat,bWdj2GDclj5ofokWjzoa5jAwMkxCykd6,7,9,1,0,2,7,3,0,22,3.142857142857143,2,0.0,2,1,0,2,7,7,0,3,0,5,17,1
554,7030,AntKijOf83pltCnII9LLX8PQYe0F20yO,G8EPVSXsOYB5YQWZGiz1aVq5Pgr2GrQu,14,13,7,18,2,0,3,0,43,6.142857142857143,1,0.0,1,7,16,2,12,0,2,3,0,26,17,0
555,7037,1pusTPLSLF5m0UuZqZkNpGlAq8VrQ1KA,SpATywNh6bZuzm8s1ceuBUnMUAeoAHHw,24,22,16,5,12,0,6,0,61,8.714285714285714,3,0.0,2,16,5,12,20,0,0,6,0,35,26,0
556,7045,Qo4EYwRduG0qocv3scjgK3zQnLtIvid1,SpATywNh6bZuzm8s1ceuBUnMUAeoAHHw,24,32,22,0,17,0,8,0,79,11.285714285714286,6,0.0,0,22,0,17,32,0,0,8,0,39,40,0
557,7055,tx4grxmlQgEoy6eADYfJTj1STA6T1B91,5X6FeZozNMgE2VRi3MJYjkkFK8SETtu2,11,9,5,8,1,10,7,0,40,5.714285714285714,3,0.0,0,5,8,1,9,10,0,7,0,14,26,1
558,7060,dGqImSq9UHavQbhAMWmMoDizcuOefX1Y,SpATywNh6bZuzm8s1ceuBUnMUAeoAHHw,7,14,3,0,0,0,3,0,20,2.857142857142857,2,0.0,0,3,0,0,14,0,0,3,0,3,17,0
559,7080,KqUCRL8ws5CG5PQvlspSHJpgFexIO4Jl,SpATywNh6bZuzm8s1ceuBUnMUAeoAHHw,15,32,4,22,1,0,1,0,60,8.571428571428571,1,0.0,8,4,18,1,24,0,4,1,0,31,29,0
560,7093,cz3HVUxVHDVORvVKi9yREbYasmzZlaFd,G8EPVSXsOYB5YQWZGiz1aVq5Pgr2GrQu,57,78,3,62,1,2,14,1,161,23.0,3,0.0,0,3,57,1,78,2,5,14,1,61,100,0
561,7117,RHl3DsvAX7TisJ7qBptmgrrtDAQvH7mr,A3fsA9Zfv1X2fVEQhTw51lKENdNrEqT3,13,13,5,22,1,0,4,0,45,6.428571428571429,2,0.0,2,5,20,1,11,0,2,4,0,28,17,0
562,7124,DRhlp1eJHQqsxjCL0bRD6kkHN20HbJ4w,SpATywNh6bZuzm8s1ceuBUnMUAeoAHHw,3,4,2,0,0,0,2,0,8,1.1428571428571428,2,0.0,0,2,0,0,4,0,0,2,0,2,6,0
563,7128,RvFRgUGsoT6kl0oxj3AEZMdMRkNHUTgp,SpATywNh6bZuzm8s1ceuBUnMUAeoAHHw,8,7,1,7,0,0,3,0,18,2.5714285714285716,3,0.0,2,1,7,0,5,0,0,3,0,10,8,1
564,7137,rT1OrFQC18rdvYkTGYqwRgC7eDvihHsc,bWdj2GDclj5ofokWjzoa5jAwMkxCykd6,12,15,9,0,2,312,45,1,384,54.857142857142854,9,0.0,0,9,0,2,15,312,0,45,1,11,373,0
565,7162,uJ1omfNa6wThHrODhBq1mtJVihr2Vf9k,5X6FeZozNMgE2VRi3MJYjkkFK8SETtu2,2,0,0,0,0,0,2,0,2,0.2857142857142857,1,0.0,0,0,0,0,0,0,0,2,0,0,2,1
566,7171,QzVwezWUOBpl33EMiprsTWQNwkGzpYUZ,A3fsA9Zfv1X2fVEQhTw51lKENdNrEqT3,4,4,3,0,0,0,3,0,10,1.4285714285714286,2,0.0,0,3,0,0,4,0,0,3,0,3,7,0
567,7181,29zlPnPFaHRpKhWmQq4cQrKoDn0GEyMA,SpATywNh6bZuzm8s1ceuBUnMUAeoAHHw,4,4,2,0,0,0,2,0,8,1.1428571428571428,2,0.0,0,2,0,0,4,0,0,2,0,2,6,1
568,7197,yiOlNWWu3p4vJ73FHFCmMYCNgzMDTrne,A3fsA9Zfv1X2fVEQhTw51lKENdNrEqT3,32,28,18,98,10,0,10,0,164,23.428571428571427,1,0.0,1,18,87,10,27,0,11,10,0,116,48,1
569,7219,t0cRwLqt3PES7T3WXJUMfvNkz6DOAsQy,G8EPVSXsOYB5YQWZGiz1aVq5Pgr2GrQu,5,4,2,0,1,0,1,0,8,1.1428571428571428,1,0.0,0,2,0,1,4,0,0,1,0,3,5,0
570,7221,Er0phLmicWoU9yr3sUBC2BCne0YIK1vQ,5X6FeZozNMgE2VRi3MJYjkkFK8SETtu2,4,2,0,0,0,0,5,0,7,1.0,3,0.0,0,0,0,0,2,0,0,5,0,0,7,1
571,7222,7abxlkdMiNWAIk78NzVnHWo2fZI6eMvl,SpATywNh6bZuzm8s1ceuBUnMUAeoAHHw,1,0,0,0,0,0,1,0,1,0.14285714285714285,1,0.0,0,0,0,0,0,0,0,1,0,0,1,1
572,7229,iZlqOil8HuQgM9wIdCp3EDJlfdWSJRmO,SpATywNh6bZuzm8s1ceuBUnMUAeoAHHw,16,19,0,17,0,29,15,3,83,11.857142857142858,3,0.0,2,0,14,0,17,29,3,15,3,16,67,0
573,7240,HJ4qDtw6u2JHJE7qmEDgWJOzWUYAv4mG,A3fsA9Zfv1X2fVEQhTw51lKENdNrEqT3,4,5,3,0,0,0,2,0,10,1.4285714285714286,2,0.0,0,3,0,0,5,0,0,2,0,3,7,0
574,7256,D1NRZnTG0gvNQpfa2XPRkdGhYZVx3Bz8,RXDvfPUBYFlVdlueBFbLW0mhhAyGEqpt,3,0,0,0,0,5,2,0,7,1.0,1,0.0,0,0,0,0,0,5,0,2,0,0,7,0
575,7262,WIuYkRjZD9FutPqnDeyA4qgpxVJpTEdL,SpATywNh6bZuzm8s1ceuBUnMUAeoAHHw,14,12,4,18,2,0,7,0,43,6.142857142857143,3,0.0,5,4,18,2,7,0,0,7,0,29,14,0
576,7274,YZ1MgmwJiUridNKhbKx061bAjGk955T1,G8EPVSXsOYB5YQWZGiz1aVq5Pgr2GrQu,32,29,5,102,1,0,1,0,138,19.714285714285715,6,0.0,0,5,87,1,29,0,15,1,0,93,45,0
577,7291,o7nB1nybhMcFgLy31X3R6RDOK94b1Iaa,SpATywNh6bZuzm8s1ceuBUnMUAeoAHHw,16,41,6,0,4,0,13,0,64,9.142857142857142,4,0.0,0,6,0,4,41,0,0,13,0,10,54,0
578,7296,ObMYjZj16p1bGCa8nmaBIv8cDUPUXE5o,SpATywNh6bZuzm8s1ceuBUnMUAeoAHHw,15,32,0,7,0,0,16,0,55,7.857142857142857,5,0.0,2,0,7,0,30,0,0,16,0,9,46,0
579,7297,bAkMyE6uCR0gc04pERZmDJrGVqJ4Z2Yi,G8EPVSXsOYB5YQWZGiz1aVq5Pgr2GrQu,72,85,32,170,19,25,10,0,341,48.714285714285715,5,0.0,17,32,148,19,68,25,22,10,0,216,125,0
580,7298,VSEOcWZYpZiKC2PUmidzj4VqbBnc3GAo,bWdj2GDclj5ofokWjzoa5jAwMkxCykd6,12,6,3,18,1,0,17,0,45,6.428571428571429,7,0.0,2,3,15,1,4,0,3,17,0,21,24,0
581,7325,3jh7S7idreXg4tLgwxk2JirIFS2kxatr,SpATywNh6bZuzm8s1ceuBUnMUAeoAHHw,24,27,11,15,7,0,5,0,65,9.285714285714286,3,0.0,9,11,13,7,18,0,2,5,0,40,25,0
582,7328,83p9ejSELsW1j5wNlAyUXF2YWFL8Z8tc,bWdj2GDclj5ofokWjzoa5jAwMkxCykd6,36,24,13,92,8,4,5,0,146,20.857142857142858,3,0.0,5,13,78,8,19,4,14,5,0,104,42,0
583,7344,B9KqNNxXBxHFUsJnQKQysblL3f8zF7sg,A3fsA9Zfv1X2fVEQhTw51lKENdNrEqT3,36,55,5,0,0,0,9,0,69,9.857142857142858,5,0.0,0,5,0,0,55,0,0,9,0,5,64,0
584,7352,CWDKRVVm01sfgssULmzIPwx9dbULLbqB,5X6FeZozNMgE2VRi3MJYjkkFK8SETtu2,111,493,137,244,120,41,63,1,1099,157.0,18,0.0,194,137,192,120,299,41,52,63,1,643,456,0
585,7365,84Vq27rxsidbGJFxLO0cd5e2CSiXRChu,5X6FeZozNMgE2VRi3MJYjkkFK8SETtu2,20,55,20,0,32,0,10,0,117,16.714285714285715,6,0.0,26,20,0,32,29,0,0,10,0,78,39,1
586,7372,32uJBAomTJQIXKZnCX4K7PYoVfESGbct,A3fsA9Zfv1X2fVEQhTw51lKENdNrEqT3,6,3,1,0,1,0,4,0,9,1.2857142857142858,1,0.0,0,1,0,1,3,0,0,4,0,2,7,1
587,7385,ErlOpSNxC1ZbmJguJSp3ZjxFq4nCmwgx,G8EPVSXsOYB5YQWZGiz1aVq5Pgr2GrQu,3,2,0,0,0,0,2,0,4,0.5714285714285714,1,0.0,0,0,0,0,2,0,0,2,0,0,4,0
588,7428,dTkPxaFmNowU6Qk7fnasqvgAevZOuRY9,RXDvfPUBYFlVdlueBFbLW0mhhAyGEqpt,4,2,1,0,0,0,2,0,5,0.7142857142857143,1,0.0,0,1,0,0,2,0,0,2,0,1,4,1
589,7440,5TRqp5WlxU778HZGbnj0S6xLTaRfUJxG,SpATywNh6bZuzm8s1ceuBUnMUAeoAHHw,24,54,3,14,2,0,13,0,86,12.285714285714286,5,0.0,11,3,12,2,43,0,2,13,0,28,58,0
590,7463,zdqliI4eCBGH6nGv4KKIRZFL1YFXBytK,SpATywNh6bZuzm8s1ceuBUnMUAeoAHHw,18,15,10,16,5,18,9,0,73,10.428571428571429,3,0.0,2,10,13,5,13,18,3,9,0,30,43,0
591,7466,lFMYqumkG36iLJm9YwVpbzadzxUvswUa,SpATywNh6bZuzm8s1ceuBUnMUAeoAHHw,10,15,8,9,0,0,2,0,34,4.857142857142857,1,0.0,5,8,9,0,10,0,0,2,0,22,12,0
592,7488,uUSTKM8g1hIskJbYHh1UiIQ6epHTSTNR,A3fsA9Zfv1X2fVEQhTw51lKENdNrEqT3,3,2,1,0,0,0,1,0,4,0.5714285714285714,1,0.0,0,1,0,0,2,0,0,1,0,1,3,1
593,7491,uUSTKM8g1hIskJbYHh1UiIQ6epHTSTNR,RXDvfPUBYFlVdlueBFbLW0mhhAyGEqpt,47,47,34,0,29,0,3,0,113,16.142857142857142,2,0.0,10,34,0,29,37,0,0,3,0,73,40,0
594,7496,6qVy3H4VOdeTnu4v49EIcz51mS5B3gWH,SpATywNh6bZuzm8s1ceuBUnMUAeoAHHw,13,24,14,5,0,8,5,0,56,8.0,3,0.0,5,14,5,0,19,8,0,5,0,24,32,0
595,7503,0PrF4PViZdaRQhbt6FYXwLbcetJ8RnwC,A3fsA9Zfv1X2fVEQhTw51lKENdNrEqT3,4,2,0,0,0,0,2,0,4,0.5714285714285714,1,0.0,0,0,0,0,2,0,0,2,0,0,4,0
596,7504,NH2DAS5rCP8HjIcwHAZxDBAjUjjdHeyM,SpATywNh6bZuzm8s1ceuBUnMUAeoAHHw,9,4,2,10,1,0,4,0,21,3.0,2,0.0,2,2,9,1,2,0,1,4,0,14,7,0
597,7521,a3StgABPgimfVHzW1FR4usG9kIA0tZV5,bWdj2GDclj5ofokWjzoa5jAwMkxCykd6,5,3,2,0,1,0,2,0,8,1.1428571428571428,1,0.0,0,2,0,1,3,0,0,2,0,3,5,1
598,7525,xNkIHhqS8GZXIqyoWwwS3ZeYfSmUsNJo,A3fsA9Zfv1X2fVEQhTw51lKENdNrEqT3,122,112,44,262,29,0,14,0,461,65.85714285714286,4,0.0,4,44,213,29,108,0,49,14,0,290,171,0
599,7550,EGswqlieknT0DkOMjaOEPr1kJjoddSSw,G8EPVSXsOYB5YQWZGiz1aVq5Pgr2GrQu,6,6,1,0,1,0,1,0,9,1.2857142857142858,1,0.0,2,1,0,1,4,0,0,1,0,4,5,0
600,7552,ljmWZCzWPqv1RXsn1q2wpsQtrnA1zct2,SpATywNh6bZuzm8s1ceuBUnMUAeoAHHw,39,70,22,36,11,0,6,0,145,20.714285714285715,3,0.0,31,22,29,11,39,0,7,6,0,93,52,0
601,7571,hPtqAQmVA3C7MVQi98nPJLfZYLyZ86Qe,SpATywNh6bZuzm8s1ceuBUnMUAeoAHHw,4,3,1,0,0,0,1,0,5,0.7142857142857143,1,0.0,0,1,0,0,3,0,0,1,0,1,4,1
602,7581,QoKkWqCz9JSPf2G2l4XrJl2BfFSq9X9B,RXDvfPUBYFlVdlueBFbLW0mhhAyGEqpt,4,5,1,0,0,0,3,0,9,1.2857142857142858,3,0.0,0,1,0,0,5,0,0,3,0,1,8,0
603,7628,hRBUrY0Ipi1X9aVKI1Gcp4xJWynJPCa6,SpATywNh6bZuzm8s1ceuBUnMUAeoAHHw,17,16,11,12,9,0,4,0,52,7.428571428571429,3,0.0,5,11,11,9,11,0,1,4,0,36,16,0
604,7633,11ljuSLdnPtPyfemLE7b9qn6qXcmssv1,SpATywNh6bZuzm8s1ceuBUnMUAeoAHHw,13,28,5,23,0,0,6,0,62,8.857142857142858,2,0.0,8,5,20,0,20,0,3,6,0,33,29,1
605,7642,WZSiXPjEuCIRtzYUNEK3DyAuPVNMLJ4a,SpATywNh6bZuzm8s1ceuBUnMUAeoAHHw,7,4,1,0,0,0,5,1,11,1.5714285714285714,1,0.0,0,1,0,0,4,0,0,5,1,1,10,1
606,7652,PQ7ibn4CoD7R92qj9CnBXvU4YpUOqVHi,SpATywNh6bZuzm8s1ceuBUnMUAeoAHHw,11,9,7,0,3,0,8,0,27,3.857142857142857,2,0.0,2,7,0,3,7,0,0,8,0,12,15,0
607,7653,v9Jp2iBPSFTVxP8FrUe1odwfz8Hd1wS3,RXDvfPUBYFlVdlueBFbLW0mhhAyGEqpt,65,128,64,94,22,28,16,2,354,50.57142857142857,3,0.0,36,64,84,22,92,28,10,16,2,206,148,0
608,7702,ulNRkVxxtx7SLWYKYYIDWhAGHHFqHWWG,SpATywNh6bZuzm8s1ceuBUnMUAeoAHHw,22,38,14,13,7,4,10,1,87,12.428571428571429,4,0.0,14,14,11,7,24,4,2,10,1,46,41,0
609,7711,U4GXlaQk4qQjr2K7P59OKvXX0vv1Pxee,SpATywNh6bZuzm8s1ceuBUnMUAeoAHHw,11,12,0,26,0,0,1,0,39,5.571428571428571,1,0.0,7,0,23,0,5,0,3,1,0,30,9,0
610,7721,MAlRgKpZXlP3WrMKjRw2YskqEALVtCKw,SpATywNh6bZuzm8s1ceuBUnMUAeoAHHw,24,44,0,14,0,0,17,2,77,11.0,3,0.0,9,0,13,0,35,0,1,17,2,22,55,0
611,7742,zu1WAijSG0F2wy5x45xxD1w2SrPWGtuK,RXDvfPUBYFlVdlueBFbLW0mhhAyGEqpt,18,14,1,0,0,6,16,0,37,5.285714285714286,3,0.0,0,1,0,0,14,6,0,16,0,1,36,0
612,7752,nIJT2WzxvFmAAdv0mMRGLvQiPT819gU3,SpATywNh6bZuzm8s1ceuBUnMUAeoAHHw,22,46,6,13,7,0,20,0,92,13.142857142857142,6,0.0,10,6,11,7,36,0,2,20,0,34,58,0
613,7753,kzQ1HmHoPnIhyiOH3J5g0gxiDZh4kW6J,RXDvfPUBYFlVdlueBFbLW0mhhAyGEqpt,17,7,4,16,3,0,3,0,33,4.714285714285714,1,0.0,3,4,15,3,4,0,1,3,0,25,8,1
614,7762,2Sqmg51RWZnvGf1B4BEysn1wJm7yLaQl,G8EPVSXsOYB5YQWZGiz1aVq5Pgr2GrQu,39,31,0,76,0,0,3,0,110,15.714285714285714,2,0.0,9,0,69,0,22,0,7,3,0,78,32,0
615,7769,QV7Z9LfpjzP9d797QCfKxmoOjdo08shd,SpATywNh6bZuzm8s1ceuBUnMUAeoAHHw,11,12,6,0,2,0,1,0,21,3.0,1,0.0,0,6,0,2,12,0,0,1,0,8,13,0
616,7784,Y96AzEZtgYGN39EPdmAzdYPvLhv1Tzsf,SpATywNh6bZuzm8s1ceuBUnMUAeoAHHw,5,3,2,0,1,0,1,0,7,1.0,1,0.0,0,2,0,1,3,0,0,1,0,3,4,0
617,7818,LMGbvXS3ZBgtTcKCRLMcqBHrfADBxwXe,SpATywNh6bZuzm8s1ceuBUnMUAeoAHHw,21,39,12,9,7,7,10,0,84,12.0,5,0.0,9,12,8,7,30,7,1,10,0,36,48,0
618,7838,S10grfxrn0tXcuL6DSaVTf7wyvXspCvq,SpATywNh6bZuzm8s1ceuBUnMUAeoAHHw,4,4,0,0,0,9,2,0,15,2.142857142857143,2,0.0,0,0,0,0,4,9,0,2,0,0,15,0
619,7839,WYNpj52NyIePFOfUouGRXkQmACPQnP2J,SpATywNh6bZuzm8s1ceuBUnMUAeoAHHw,16,20,10,0,4,195,28,0,257,36.714285714285715,7,0.0,0,10,0,4,20,195,0,28,0,14,243,0
620,7857,Z6YQS36VdHJFF4DkVSTcUgmOIdlOITNE,SpATywNh6bZuzm8s1ceuBUnMUAeoAHHw,20,38,15,13,6,0,5,0,77,11.0,2,0.0,9,15,12,6,29,0,1,5,0,42,35,0
621,7858,Ak0ru019Ynz1X1qhUbDFCskGZavLrHBc,SpATywNh6bZuzm8s1ceuBUnMUAeoAHHw,40,59,35,18,17,26,11,0,166,23.714285714285715,2,0.0,15,35,17,17,44,26,1,11,0,84,82,0
622,7868,ptvDGcVFI5vzF4lBwRLTADNrenNp2tF2,SpATywNh6bZuzm8s1ceuBUnMUAeoAHHw,29,75,3,10,3,5,27,3,126,18.0,4,0.0,4,3,10,3,71,5,0,27,3,20,106,0
623,7870,sj7wQJWVAxmId67LlkoaFzAmqWKmeC7I,SpATywNh6bZuzm8s1ceuBUnMUAeoAHHw,25,100,4,16,4,22,21,0,167,23.857142857142858,8,0.0,16,4,16,4,84,22,0,21,0,40,127,0
624,7883,JiNN6rHoPfwH1fuAk6q9tmTGqAFVjob4,SpATywNh6bZuzm8s1ceuBUnMUAeoAHHw,3,2,1,0,0,0,2,0,5,0.7142857142857143,1,0.0,0,1,0,0,2,0,0,2,0,1,4,0
625,7923,pJUI0Hs11rZxgXk3r1clZCyuDCtGsbvH,SpATywNh6bZuzm8s1ceuBUnMUAeoAHHw,25,26,0,15,2,0,5,0,48,6.857142857142857,2,0.0,4,0,15,2,22,0,0,5,0,21,27,1
626,7937,ywdL3xkp7d2PSjbvnflAvIe7Wp6Q4SRe,SpATywNh6bZuzm8s1ceuBUnMUAeoAHHw,34,65,26,43,12,0,25,0,171,24.428571428571427,8,0.0,8,26,40,12,57,0,3,25,0,86,85,0
627,7942,JNo2rLqKe6aBGDwGzu8tXd13uOC5tEnq,bWdj2GDclj5ofokWjzoa5jAwMkxCykd6,1,0,0,0,0,0,1,0,1,0.14285714285714285,1,0.0,0,0,0,0,0,0,0,1,0,0,1,0
628,7949,FnY3or5QaQRvUAAgyu53eYBfcMnduugT,SpATywNh6bZuzm8s1ceuBUnMUAeoAHHw,19,64,5,14,5,0,10,0,98,14.0,4,0.0,14,5,12,5,50,0,2,10,0,36,62,0
629,7952,CI12SZIYH2QOfgaDvq8F4VKXwDinb334,SpATywNh6bZuzm8s1ceuBUnMUAeoAHHw,33,25,17,14,12,0,4,0,72,10.285714285714286,3,0.0,4,17,13,12,21,0,1,4,0,46,26,0
630,7954,WzyWOzB7f8AVbQvaWeU3O4gxEwZ13sIC,RXDvfPUBYFlVdlueBFbLW0mhhAyGEqpt,25,42,20,48,12,18,13,1,154,22.0,5,0.0,5,20,44,12,37,18,4,13,1,81,73,0
631,7956,ljmWZCzWPqv1RXsn1q2wpsQtrnA1zct2,G8EPVSXsOYB5YQWZGiz1aVq5Pgr2GrQu,16,13,9,12,3,20,4,0,61,8.714285714285714,1,0.0,2,9,11,3,11,20,1,4,0,25,36,1
632,7962,mtW8rWxW2XwZIB5TM8b8gUVmE4UACp0R,SpATywNh6bZuzm8s1ceuBUnMUAeoAHHw,33,24,17,14,11,0,7,0,73,10.428571428571429,5,0.0,4,17,14,11,20,0,0,7,0,46,27,0
633,7964,z8zMi50azvRwAPUNW2f5Gt0F6WOr8PI9,A3fsA9Zfv1X2fVEQhTw51lKENdNrEqT3,3,2,1,0,0,0,1,0,4,0.5714285714285714,1,0.0,0,1,0,0,2,0,0,1,0,1,3,1
634,7967,Wyji6pvgj7unEJ4mD7FWwu0Sma8fUdv4,SpATywNh6bZuzm8s1ceuBUnMUAeoAHHw,14,17,13,4,6,0,2,0,42,6.0,1,0.0,2,13,4,6,15,0,0,2,0,25,17,0
635,7973,SUqHrTqjE8jHVpASqCaMjjR6iZ17k2Gq,SpATywNh6bZuzm8s1ceuBUnMUAeoAHHw,32,30,19,13,11,0,16,0,89,12.714285714285714,5,0.0,4,19,11,11,26,0,2,16,0,45,44,0
636,7975,EwJz8sdPLnTPbvCqxQKV7YueKEdP0wYf,SpATywNh6bZuzm8s1ceuBUnMUAeoAHHw,39,42,27,32,14,0,8,0,123,17.571428571428573,2,0.0,6,27,27,14,36,0,5,8,0,74,49,0
637,7999,j55CnsxXtuPHDTIgqOvx7oExU3RRtQ4I,SpATywNh6bZuzm8s1ceuBUnMUAeoAHHw,14,31,14,0,8,3,12,0,68,9.714285714285714,6,0.0,2,14,0,8,29,3,0,12,0,24,44,1
638,8000,YiNeIrEOhZYEzsuuN5nQKcsVr5To2nDU,SpATywNh6bZuzm8s1ceuBUnMUAeoAHHw,18,11,9,14,7,0,5,0,46,6.571428571428571,2,0.0,2,9,12,7,9,0,2,5,0,30,16,0
639,8001,DI3YZyhWTKxhZZnQuVUpGne2QEEoyvnw,SpATywNh6bZuzm8s1ceuBUnMUAeoAHHw,20,11,8,9,5,0,4,12,49,7.0,1,0.0,2,8,8,5,9,0,1,4,12,23,26,0
640,8016,0wTvjguYOmHTRx6CgVlID5lRmd6At3zN,RXDvfPUBYFlVdlueBFbLW0mhhAyGEqpt,47,62,51,0,39,3,10,0,165,23.571428571428573,4,0.0,0,51,0,39,62,3,0,10,0,90,75,0
641,8029,cuDL2ISAKT9SiekAD9CQynXiu9fQTVyV,G8EPVSXsOYB5YQWZGiz1aVq5Pgr2GrQu,7,5,1,0,1,0,2,0,9,1.2857142857142858,1,0.0,1,1,0,1,4,0,0,2,0,3,6,0
642,8031,Ra8GzsxOGVkAaMFXN2T6V1Y5fgtJJH5X,SpATywNh6bZuzm8s1ceuBUnMUAeoAHHw,6,17,0,0,0,0,2,0,19,2.7142857142857144,3,0.0,0,0,0,0,17,0,0,2,0,0,19,0
643,8061,eDdFtfGTTqvukOdpQCeNfhpEnZacRMyL,SpATywNh6bZuzm8s1ceuBUnMUAeoAHHw,16,12,8,13,7,0,2,0,42,6.0,1,0.0,2,8,11,7,10,0,2,2,0,28,14,0
644,8078,nD2aR2lBTYEZ05tUWGjogkwgt2d7zeNx,bWdj2GDclj5ofokWjzoa5jAwMkxCykd6,5,2,0,0,0,0,3,0,5,0.7142857142857143,1,0.0,0,0,0,0,2,0,0,3,0,0,5,1
645,8087,3nOS3JEH08BgwunQqioyEFfja4qIND4p,A3fsA9Zfv1X2fVEQhTw51lKENdNrEqT3,1,0,0,0,0,0,1,0,1,0.14285714285714285,1,0.0,0,0,0,0,0,0,0,1,0,0,1,1
646,8155,S6HVmLPlerZStE1FmYWcP13FOlr0Ldio,SpATywNh6bZuzm8s1ceuBUnMUAeoAHHw,9,8,1,0,1,0,1,0,11,1.5714285714285714,1,0.0,0,1,0,1,8,0,0,1,0,2,9,1
647,8164,OvIrFDXnTf7lPGXHN37tKh2m9dXSHGJK,RXDvfPUBYFlVdlueBFbLW0mhhAyGEqpt,42,33,19,42,8,37,8,0,147,21.0,2,0.0,10,19,42,8,23,37,0,8,0,79,68,0
648,8171,Agc8I1aREEPfi2PqA7NK0aenTcuvE1HC,SpATywNh6bZuzm8s1ceuBUnMUAeoAHHw,17,10,7,13,5,0,1,0,36,5.142857142857143,1,0.0,2,7,11,5,8,0,2,1,0,25,11,0
649,8174,ZFeBOOLKgUUTF7XgzMMbqDAJmFSviC7K,SpATywNh6bZuzm8s1ceuBUnMUAeoAHHw,36,48,29,25,16,0,18,0,136,19.428571428571427,6,0.0,9,29,23,16,39,0,2,18,0,77,59,0
650,8183,FFyynYy7wGQKjNauntgybGuFHItz8juf,G8EPVSXsOYB5YQWZGiz1aVq5Pgr2GrQu,47,39,20,85,12,0,6,0,162,23.142857142857142,4,0.0,0,20,73,12,39,0,12,6,0,105,57,0
651,8200,myPDU4mr5TIDvQCh3WcoSxbhe6fCunPv,SpATywNh6bZuzm8s1ceuBUnMUAeoAHHw,8,14,6,0,4,0,1,0,25,3.5714285714285716,1,0.0,0,6,0,4,14,0,0,1,0,10,15,0
652,8224,5u57vWlYBlYDQJhbIpJzLY4ZLMAv0Mtf,SpATywNh6bZuzm8s1ceuBUnMUAeoAHHw,22,34,15,12,12,0,12,0,85,12.142857142857142,3,0.0,4,15,11,12,30,0,1,12,0,42,43,1
653,8235,gNTGzjcOmHTKgzmUa0veV0Pk7aaKxz1N,SpATywNh6bZuzm8s1ceuBUnMUAeoAHHw,7,7,4,0,1,0,3,0,15,2.142857142857143,2,0.0,0,4,0,1,7,0,0,3,0,5,10,0
654,8242,3mL78JhEm154Hwp0XQW8ZVuzbvUw5uCk,SpATywNh6bZuzm8s1ceuBUnMUAeoAHHw,27,24,18,0,13,2,5,0,62,8.857142857142858,3,0.0,0,18,0,13,24,2,0,5,0,31,31,0
655,8252,HKDSRzc7MQzCfJsk49D6xFQK4oFHHvy7,SpATywNh6bZuzm8s1ceuBUnMUAeoAHHw,23,51,1,22,0,0,17,1,92,13.142857142857142,4,0.0,9,1,19,0,42,0,3,17,1,29,63,0
656,8259,DVIil2NM7ZWOtqe6rhlMzwEUAb2wuaeh,bWdj2GDclj5ofokWjzoa5jAwMkxCykd6,6,7,5,0,0,1,4,0,17,2.4285714285714284,3,0.0,0,5,0,0,7,1,0,4,0,5,12,0
657,8260,DVIil2NM7ZWOtqe6rhlMzwEUAb2wuaeh,A3fsA9Zfv1X2fVEQhTw51lKENdNrEqT3,7,7,5,0,0,0,2,0,14,2.0,2,0.0,0,5,0,0,7,0,0,2,0,5,9,0
658,8275,GHabqgRgi0KXSBTYXxIc3mcQESEOp0QM,SpATywNh6bZuzm8s1ceuBUnMUAeoAHHw,18,47,21,2,2,1502,69,0,1643,234.71428571428572,8,0.0,9,21,1,2,38,1502,1,69,0,33,1610,0
659,8276,V7y3ErWDx79HQwDxdGqBqCI3nEwG2a9C,SpATywNh6bZuzm8s1ceuBUnMUAeoAHHw,23,31,2,30,1,0,4,2,70,10.0,2,0.0,11,2,27,1,20,0,3,4,2,41,29,0
660,8280,41Lg2hcbw0N9iuSjhrPTYqB7aTnux5zG,SpATywNh6bZuzm8s1ceuBUnMUAeoAHHw,21,29,13,14,9,0,3,0,68,9.714285714285714,3,0.0,2,13,12,9,27,0,2,3,0,36,32,0
661,8327,Rxx8uEqY3FOt7Egy2EEEwihJJCyVsQKy,G8EPVSXsOYB5YQWZGiz1aVq5Pgr2GrQu,64,56,32,115,25,0,9,1,238,34.0,6,0.0,15,32,99,25,41,0,16,9,1,171,67,0
662,8335,2tvGCUYYinrGZmVDaUEHPItUSSMqiKmY,SpATywNh6bZuzm8s1ceuBUnMUAeoAHHw,19,40,18,13,14,0,4,0,89,12.714285714285714,2,0.0,5,18,11,14,35,0,2,4,0,48,41,0
663,8337,SP1OGXx7XA1zodabwHSZpThCzaY2Fjl2,SpATywNh6bZuzm8s1ceuBUnMUAeoAHHw,18,21,6,7,3,3,3,0,43,6.142857142857143,3,0.0,2,6,7,3,19,3,0,3,0,18,25,0
664,8347,jMKMopo0fDIDt1YMaxiGrP1SNRt3VtFz,SpATywNh6bZuzm8s1ceuBUnMUAeoAHHw,19,68,42,12,18,0,17,0,157,22.428571428571427,5,0.0,8,42,12,18,60,0,0,17,0,80,77,0
665,8359,xI8Nr9tpm5UYMfkPTEK7ZnHqHm9s1zwr,SpATywNh6bZuzm8s1ceuBUnMUAeoAHHw,17,31,0,12,1,0,3,0,47,6.714285714285714,3,0.0,2,0,10,1,29,0,2,3,0,13,34,1
666,8372,Ja8xgxpUQSylPcWwfGyX1RUCUJ6MhJqT,SpATywNh6bZuzm8s1ceuBUnMUAeoAHHw,27,54,20,16,7,14,8,2,121,17.285714285714285,3,0.0,13,20,14,7,41,14,2,8,2,54,67,0
667,8389,NngMZQTGAdrhmbSK51CUolNQSpFXDhiO,SpATywNh6bZuzm8s1ceuBUnMUAeoAHHw,36,52,28,13,16,1,11,1,122,17.428571428571427,2,0.0,10,28,13,16,42,1,0,11,1,67,55,0
668,8391,tF8i4h1a2Nm3JCN3xA7kONOWBOERcJ4Q,SpATywNh6bZuzm8s1ceuBUnMUAeoAHHw,22,24,13,23,5,3,2,0,70,10.0,3,0.0,10,13,18,5,14,3,5,2,0,46,24,0
669,8405,kWUbu8oK1dFJKpHhiF15MwcSzNzv8GaS,bWdj2GDclj5ofokWjzoa5jAwMkxCykd6,4,6,4,0,0,0,3,0,13,1.8571428571428572,1,0.0,0,4,0,0,6,0,0,3,0,4,9,0
670,8435,j1jdy8OF5VQw4rqSYOkbK2pQplvvvz37,A3fsA9Zfv1X2fVEQhTw51lKENdNrEqT3,65,50,1,101,1,0,18,0,171,24.428571428571427,3,0.0,5,1,85,1,45,0,16,18,0,92,79,0
671,8437,12tfSRcVHU1LY6VYbYjnNdGrVUGUAhWB,SpATywNh6bZuzm8s1ceuBUnMUAeoAHHw,30,22,18,7,12,0,3,0,62,8.857142857142858,2,0.0,2,18,7,12,20,0,0,3,0,39,23,0
672,8461,tH916xRbn4bSZXJ6Z57PlnTAPQfz04PX,SpATywNh6bZuzm8s1ceuBUnMUAeoAHHw,23,25,18,0,12,0,7,0,62,8.857142857142858,5,0.0,0,18,0,12,25,0,0,7,0,30,32,0
673,8486,BeZnyZhcScrHr8WAPYtxUxDjMPiK7yK1,SpATywNh6bZuzm8s1ceuBUnMUAeoAHHw,8,11,6,0,3,0,3,0,23,3.2857142857142856,2,0.0,0,6,0,3,11,0,0,3,0,9,14,0
674,8494,gir9E9ZUbwj6bCUNLD2kQmOx1nsVwG4J,SpATywNh6bZuzm8s1ceuBUnMUAeoAHHw,6,7,3,0,0,0,2,0,12,1.7142857142857142,2,0.0,0,3,0,0,7,0,0,2,0,3,9,1
675,8503,PtXR7nBc6ugMebaEp6mKjp0TYO5kZtvE,SpATywNh6bZuzm8s1ceuBUnMUAeoAHHw,21,41,29,13,16,16,13,0,128,18.285714285714285,3,0.0,2,29,13,16,39,16,0,13,0,60,68,0
676,8539,ApFdQQBcLqTLoA4wIvtlnnwFs4FrlVS1,A3fsA9Zfv1X2fVEQhTw51lKENdNrEqT3,7,6,4,0,0,0,11,0,21,3.0,5,0.0,0,4,0,0,6,0,0,11,0,4,17,0
677,8562,2YohZ5UKGzy1qUgVAShosLdhgm3pfvsR,RXDvfPUBYFlVdlueBFbLW0mhhAyGEqpt,11,11,1,14,0,10,1,0,37,5.285714285714286,1,0.0,2,1,13,0,9,10,1,1,0,16,21,1
678,8576,HHsJECDPslzJS0fyoCEbSGrnL1evzSJb,SpATywNh6bZuzm8s1ceuBUnMUAeoAHHw,57,75,35,26,21,2,17,1,177,25.285714285714285,4,0.0,27,35,26,21,48,2,0,17,1,109,68,0
679,8579,5SaN6rc1Jws1AbkuHmPyLN82qDTc23Xp,SpATywNh6bZuzm8s1ceuBUnMUAeoAHHw,12,25,2,6,0,4,8,2,47,6.714285714285714,1,0.0,1,2,5,0,24,4,1,8,2,8,39,1
680,8580,NbSKhx4CxJyTkjcYgC3wEU9PLylFddj5,SpATywNh6bZuzm8s1ceuBUnMUAeoAHHw,16,27,2,11,0,14,6,0,60,8.571428571428571,4,0.0,6,2,10,0,21,14,1,6,0,18,42,0
681,8603,NDWoO09mCIeS4HdBeNYH7dNkyhIv3eXv,SpATywNh6bZuzm8s1ceuBUnMUAeoAHHw,25,31,0,12,0,9,6,0,58,8.285714285714286,3,0.0,4,0,11,0,27,9,1,6,0,15,43,1
682,8654,nquBmikiqPFYvs17N894M5iUc88scoVO,SpATywNh6bZuzm8s1ceuBUnMUAeoAHHw,19,70,2,12,0,26,7,0,117,16.714285714285715,3,0.0,3,2,11,0,67,26,1,7,0,16,101,0
683,8691,ESjXyWS3x5wlkZHp5KISOO9gy5mDNyIG,SpATywNh6bZuzm8s1ceuBUnMUAeoAHHw,11,6,5,0,4,0,1,0,16,2.2857142857142856,1,0.0,0,5,0,4,6,0,0,1,0,9,7,1
684,8700,je9A6l6tP7wnbFhNJD7vbbHTYhqshuqB,G8EPVSXsOYB5YQWZGiz1aVq5Pgr2GrQu,39,58,29,116,13,9,13,0,238,34.0,4,0.0,14,29,89,13,44,9,27,13,0,145,93,0
685,8711,MQxVHrLqN67CEKfOyyeFlttLUKuqvrcv,RXDvfPUBYFlVdlueBFbLW0mhhAyGEqpt,29,45,23,12,53,4,2,0,139,19.857142857142858,2,0.0,0,23,11,53,45,4,1,2,0,87,52,0
686,8735,WNT8mFhPmDPRuQT8JLsnindelSr1MnST,SpATywNh6bZuzm8s1ceuBUnMUAeoAHHw,14,18,7,0,3,0,6,0,34,4.857142857142857,2,0.0,0,7,0,3,18,0,0,6,0,10,24,1
687,8761,7ye3FQXc4XBmC7UwnNQWxsWGDnaNcvG6,SpATywNh6bZuzm8s1ceuBUnMUAeoAHHw,4,3,0,0,0,0,1,0,4,0.5714285714285714,1,0.0,0,0,0,0,3,0,0,1,0,0,4,1
688,8780,l7cIWSn2QdqLoOKMFO8yNQGKfk999nJh,A3fsA9Zfv1X2fVEQhTw51lKENdNrEqT3,9,4,3,0,0,1,9,2,19,2.7142857142857144,1,0.0,0,3,0,0,4,1,0,9,2,3,16,1
689,8791,E2VKNfvaS8HbcvRZooqcq8161JUOvad2,RXDvfPUBYFlVdlueBFbLW0mhhAyGEqpt,1,0,0,0,0,0,1,0,1,0.14285714285714285,1,0.0,0,0,0,0,0,0,0,1,0,0,1,1
690,8793,Ga4lr67F0RIjyUetWH1EgQ3xzSHDnViF,bWdj2GDclj5ofokWjzoa5jAwMkxCykd6,16,25,10,28,6,2,5,2,78,11.142857142857142,2,0.0,11,10,23,6,14,2,5,5,2,50,28,0
691,8794,br8lmEhz6IHlXV0QfsU4Spi9BczfMT8x,SpATywNh6bZuzm8s1ceuBUnMUAeoAHHw,13,13,7,12,0,0,2,0,34,4.857142857142857,2,0.0,3,7,11,0,10,0,1,2,0,21,13,0
692,8809,ivdkzhYPhrTUKnU1xY68Yfp2rdDhgD3h,SpATywNh6bZuzm8s1ceuBUnMUAeoAHHw,40,67,32,24,14,3,13,1,154,22.0,3,0.0,16,32,21,14,51,3,3,13,1,83,71,0
693,8814,8IuzZOXaXVUql9pLZtNuJIyLoDJ8ZL4V,SpATywNh6bZuzm8s1ceuBUnMUAeoAHHw,3,2,1,0,0,0,1,0,4,0.5714285714285714,1,0.0,0,1,0,0,2,0,0,1,0,1,3,0
694,8852,1sf1a7OMEvwky5hvLFD12TaOsmoNw2Qb,SpATywNh6bZuzm8s1ceuBUnMUAeoAHHw,25,38,17,14,9,0,2,0,80,11.428571428571429,4,0.0,2,17,12,9,36,0,2,2,0,40,40,0
695,8900,fY0uxi2rFKNgoTYTvIZdgXrk3XKUTjS3,SpATywNh6bZuzm8s1ceuBUnMUAeoAHHw,26,39,14,35,5,2,7,0,102,14.571428571428571,4,0.0,6,14,29,5,33,2,6,7,0,54,48,0
696,8925,PenDUeO0eoR8hyLVdfPN6H7q2FnTGMus,A3fsA9Zfv1X2fVEQhTw51lKENdNrEqT3,30,23,11,102,2,67,17,1,223,31.857142857142858,3,0.0,3,11,83,2,20,67,19,17,1,99,124,0
697,8929,1oBn81XXDSWJtnCZIRPmhZcBWe7qP0iB,RXDvfPUBYFlVdlueBFbLW0mhhAyGEqpt,3,2,0,0,0,0,1,0,3,0.42857142857142855,1,0.0,0,0,0,0,2,0,0,1,0,0,3,1
698,8935,pYasYOOyUapjKdoqnDhFpArs52eNDPLb,SpATywNh6bZuzm8s1ceuBUnMUAeoAHHw,25,42,23,16,10,0,7,0,98,14.0,4,0.0,11,23,13,10,31,0,3,7,0,57,41,0
699,8956,JtMmp5BCDQnYE7CMI3NvnX4aRCZsQW9K,bWdj2GDclj5ofokWjzoa5jAwMkxCykd6,1,0,0,0,0,0,1,0,1,0.14285714285714285,1,0.0,0,0,0,0,0,0,0,1,0,0,1,0
700,8966,qFpdcx3mtZSSE0KVCMsIlMdOIeoOzyoo,SpATywNh6bZuzm8s1ceuBUnMUAeoAHHw,9,11,6,0,0,14,6,4,41,5.857142857142857,2,0.0,3,6,0,0,8,14,0,6,4,9,32,0
701,8971,p04QzukP32kpPk8EGoBhDUGJJQqJUoNz,SpATywNh6bZuzm8s1ceuBUnMUAeoAHHw,18,24,4,5,2,5,4,0,44,6.285714285714286,1,0.0,10,4,5,2,14,5,0,4,0,21,23,0
702,9011,sNZ43ghPU2QwNk3cu7wYztVZWvmkGmKL,SpATywNh6bZuzm8s1ceuBUnMUAeoAHHw,27,43,21,10,9,8,1,0,92,13.142857142857142,3,0.0,15,21,10,9,28,8,0,1,0,55,37,0
703,9018,pVooF8yxRpciMTpPCaLN6jM2lWrWpauA,SpATywNh6bZuzm8s1ceuBUnMUAeoAHHw,1,0,0,0,0,0,1,0,1,0.14285714285714285,1,0.0,0,0,0,0,0,0,0,1,0,0,1,1
704,9047,bssQsmzoNxPtkllVsM0XyYElvtsPU1iO,A3fsA9Zfv1X2fVEQhTw51lKENdNrEqT3,1,0,0,0,0,0,1,0,1,0.14285714285714285,1,0.0,0,0,0,0,0,0,0,1,0,0,1,1
705,9100,0K6JPqiivQzicxY4EV4nqMLCL3a08A97,bWdj2GDclj5ofokWjzoa5jAwMkxCykd6,7,2,2,0,2,0,7,0,13,1.8571428571428572,2,0.0,0,2,0,2,2,0,0,7,0,4,9,0
706,9129,x8EozFE9amTkjsgRipu221C7Pejcw9dl,RXDvfPUBYFlVdlueBFbLW0mhhAyGEqpt,7,9,5,0,3,0,3,0,20,2.857142857142857,1,0.0,0,5,0,3,9,0,0,3,0,8,12,1
707,9145,RFW46IpEEo40HQZmVwQOMd3VcTSwzvKz,SpATywNh6bZuzm8s1ceuBUnMUAeoAHHw,29,40,23,14,7,7,6,0,97,13.857142857142858,4,0.0,11,23,14,7,29,7,0,6,0,55,42,0
708,9165,fnvAURpBgndjkYxbDVVMCKsNQuRUMiGS,SpATywNh6bZuzm8s1ceuBUnMUAeoAHHw,14,26,14,0,8,0,7,0,55,7.857142857142857,2,0.0,3,14,0,8,23,0,0,7,0,25,30,0
709,9214,cw1zp7V2E9LtJgGgHmRoYt6oelCovAzM,bWdj2GDclj5ofokWjzoa5jAwMkxCykd6,3,2,1,0,0,0,1,0,4,0.5714285714285714,1,0.0,0,1,0,0,2,0,0,1,0,1,3,1
710,9249,0px3bu53b0JtWfgR2HZboUVCWvKPFWbh,SpATywNh6bZuzm8s1ceuBUnMUAeoAHHw,1,0,0,0,0,0,1,0,1,0.14285714285714285,1,0.0,0,0,0,0,0,0,0,1,0,0,1,1
711,9252,9YWFnwknNOzyIUIKR7l51R7vKAyWFRtw,SpATywNh6bZuzm8s1ceuBUnMUAeoAHHw,7,4,3,0,2,0,1,0,10,1.4285714285714286,1,0.0,0,3,0,2,4,0,0,1,0,5,5,1
712,9263,cgHFcM0rIMOzMpGf6lXZssDwXCb8l7YM,SpATywNh6bZuzm8s1ceuBUnMUAeoAHHw,40,43,26,27,15,0,10,0,121,17.285714285714285,4,0.0,10,26,27,15,33,0,0,10,0,78,43,0
713,9266,9Gijx5H37DPofktlpBMoMZTbguUDFGMv,SpATywNh6bZuzm8s1ceuBUnMUAeoAHHw,19,27,17,11,13,0,2,0,70,10.0,2,0.0,3,17,10,13,24,0,1,2,0,43,27,0
714,9300,V2BC6P9m08ZwtWifNk1sABHW864l2OQe,SpATywNh6bZuzm8s1ceuBUnMUAeoAHHw,34,29,16,30,10,0,8,0,93,13.285714285714286,4,0.0,8,16,25,10,21,0,5,8,0,59,34,0
715,9326,cw1zp7V2E9LtJgGgHmRoYt6oelCovAzM,A3fsA9Zfv1X2fVEQhTw51lKENdNrEqT3,5,5,3,0,0,0,2,0,10,1.4285714285714286,2,0.0,1,3,0,0,4,0,0,2,0,4,6,0
716,9331,U5AVDljh153RMBqEeJz3uJoBcMeMiYU5,RXDvfPUBYFlVdlueBFbLW0mhhAyGEqpt,57,38,23,76,18,2,5,0,162,23.142857142857142,2,0.0,11,23,72,18,27,2,4,5,0,124,38,0
717,9359,aR6DmUHNNFHdBeCRliKxXxLUoIhOd6AH,SpATywNh6bZuzm8s1ceuBUnMUAeoAHHw,29,42,20,0,12,4,7,0,85,12.142857142857142,4,0.0,1,20,0,12,41,4,0,7,0,33,52,1
718,9361,8Eqf4bSicFmRziRU1kFgF89C5yGB8WDX,A3fsA9Zfv1X2fVEQhTw51lKENdNrEqT3,3,4,0,0,0,0,7,0,11,1.5714285714285714,3,0.0,0,0,0,0,4,0,0,7,0,0,11,0
719,9373,y94TMklf7UHNxvOoBChAR2OERrGRdiJq,G8EPVSXsOYB5YQWZGiz1aVq5Pgr2GrQu,9,10,2,8,3,0,3,0,26,3.7142857142857144,1,0.0,7,2,5,3,3,0,3,3,0,17,9,0
720,9407,iY3PnTi5AY3h01aMZ0ccsJOuRXfKtImU,SpATywNh6bZuzm8s1ceuBUnMUAeoAHHw,15,12,7,0,5,0,3,0,27,3.857142857142857,1,0.0,4,7,0,5,8,0,0,3,0,16,11,0
721,9412,ZoicU1K1NYxoyDJQjMEMlarFqaZkNBQL,SpATywNh6bZuzm8s1ceuBUnMUAeoAHHw,9,11,1,0,1,0,3,0,16,2.2857142857142856,2,0.0,0,1,0,1,11,0,0,3,0,2,14,0
722,9421,mVo6pZlclrtmbfR2GbQ4wq8gZuK7O36S,SpATywNh6bZuzm8s1ceuBUnMUAeoAHHw,31,44,29,17,15,9,3,1,118,16.857142857142858,4,0.0,5,29,14,15,39,9,3,3,1,63,55,0
723,9443,mt466qDcj0vZCLdMYFtb42Vnaf84dHao,SpATywNh6bZuzm8s1ceuBUnMUAeoAHHw,8,6,4,0,1,0,4,0,15,2.142857142857143,2,0.0,0,4,0,1,6,0,0,4,0,5,10,1
724,9451,3tkFTpynSNaQLF6kINch4bQXEK1IrheG,SpATywNh6bZuzm8s1ceuBUnMUAeoAHHw,32,36,23,12,11,0,7,0,89,12.714285714285714,3,0.0,4,23,12,11,32,0,0,7,0,50,39,0
725,9461,L22HEShRU3FqNfdzTYdzEWxS4vfndGJu,SpATywNh6bZuzm8s1ceuBUnMUAeoAHHw,15,17,4,28,0,7,10,2,68,9.714285714285714,4,0.0,6,4,25,0,11,7,3,10,2,35,33,0
726,9496,lzjn3SIRVbYq5ZVBPCRXRd4xV1z1jylE,SpATywNh6bZuzm8s1ceuBUnMUAeoAHHw,21,11,8,13,6,6,3,0,47,6.714285714285714,1,0.0,2,8,11,6,9,6,2,3,0,27,20,0
727,9498,tNcQJSYfIwP0RRLCMvpsyr5j06z8N8iO,G8EPVSXsOYB5YQWZGiz1aVq5Pgr2GrQu,35,85,20,0,14,0,19,0,138,19.714285714285715,5,0.0,2,20,0,14,83,0,0,19,0,36,102,0
728,9515,FK87Mh9LEgwj1VU4pstPcNLLVrRCTWuM,SpATywNh6bZuzm8s1ceuBUnMUAeoAHHw,29,42,24,11,11,7,7,0,102,14.571428571428571,3,0.0,13,24,11,11,29,7,0,7,0,59,43,0
729,9524,qLAmicSwiz2res8NbViiztvss1lFMGpj,SpATywNh6bZuzm8s1ceuBUnMUAeoAHHw,19,21,1,9,0,0,2,0,33,4.714285714285714,2,0.0,2,1,9,0,19,0,0,2,0,12,21,1
730,9531,KwyWbYzWCyNQryHYqWYU5PuARebCENlh,SpATywNh6bZuzm8s1ceuBUnMUAeoAHHw,5,3,2,0,1,0,1,0,7,1.0,1,0.0,0,2,0,1,3,0,0,1,0,3,4,0
731,9562,ELMHLkq0bytqwO03zO0z2h1fRq8v5uwM,RXDvfPUBYFlVdlueBFbLW0mhhAyGEqpt,14,33,3,25,3,0,0,0,64,9.142857142857142,3,0.0,4,3,20,3,29,0,5,0,0,30,34,0
732,9570,kRNs7iQ9Dcre5KLj8rtojE3fVWuqCtop,SpATywNh6bZuzm8s1ceuBUnMUAeoAHHw,11,11,1,10,0,0,0,0,22,3.142857142857143,2,0.0,2,1,10,0,9,0,0,0,0,13,9,0
733,9597,op6fYsDSJ7UTrHBvFtSBIo32ykj3vZlc,SpATywNh6bZuzm8s1ceuBUnMUAeoAHHw,14,33,4,13,1,0,9,0,60,8.571428571428571,2,0.0,6,4,11,1,27,0,2,9,0,22,38,0
734,9626,foCA7ZrrJkil1q7yKxvukoHCZEz5fz8N,bWdj2GDclj5ofokWjzoa5jAwMkxCykd6,25,64,2,20,0,0,20,0,106,15.142857142857142,4,0.0,3,2,10,0,61,0,10,20,0,15,91,0
735,9673,Bi4hHmeTLwTbUCScu9tC6ZZN7frLUhVP,bWdj2GDclj5ofokWjzoa5jAwMkxCykd6,2,0,0,0,0,0,2,0,2,0.2857142857142857,1,0.0,0,0,0,0,0,0,0,2,0,0,2,0
736,9684,LdhLlSD36AR268yKf0v6JE8vG5XYPHSF,RXDvfPUBYFlVdlueBFbLW0mhhAyGEqpt,35,73,2,86,12,0,5,0,178,25.428571428571427,3,0.0,38,2,80,12,35,0,6,5,0,132,46,0
737,9707,5GS5OD1cmKWecEPymf3UVauvWYXb9WHE,SpATywNh6bZuzm8s1ceuBUnMUAeoAHHw,12,15,12,5,7,0,2,0,41,5.857142857142857,1,0.0,1,12,4,7,14,0,1,2,0,24,17,0
738,9718,0dBn4alo7QBTd62VD5XO0yNMbQ5QN2OQ,A3fsA9Zfv1X2fVEQhTw51lKENdNrEqT3,8,15,5,0,2,0,1,0,23,3.2857142857142856,1,0.0,0,5,0,2,15,0,0,1,0,7,16,0
739,9719,STRzNG5Wp366HphlQVfWFRMC5QrerXCb,SpATywNh6bZuzm8s1ceuBUnMUAeoAHHw,27,31,15,0,11,0,6,0,63,9.0,4,0.0,0,15,0,11,31,0,0,6,0,26,37,0
740,9754,UhHoLs8knx0jlEPi8SMFvlBmI0lPgR6y,SpATywNh6bZuzm8s1ceuBUnMUAeoAHHw,13,28,3,0,2,4,12,1,50,7.142857142857143,3,0.0,0,3,0,2,28,4,0,12,1,5,45,1
741,9785,gm1mCfFqKN0eTkg2YXDowzQf6xnuANVZ,SpATywNh6bZuzm8s1ceuBUnMUAeoAHHw,20,30,4,10,2,0,10,0,56,8.0,2,0.0,2,4,10,2,28,0,0,10,0,18,38,1
742,9786,LcO86mxxL8cZOPJBDybTSOoI4LZ5qE2M,SpATywNh6bZuzm8s1ceuBUnMUAeoAHHw,17,14,9,0,6,0,3,0,32,4.571428571428571,3,0.0,0,9,0,6,14,0,0,3,0,15,17,0
743,9787,EYniy2nQGNpFME0mRi8PdZNA2QjnXIxY,RXDvfPUBYFlVdlueBFbLW0mhhAyGEqpt,35,37,1,74,5,3,6,1,127,18.142857142857142,3,0.0,17,1,68,5,20,3,6,6,1,91,36,0
744,9806,q0a8XSQyj8ok2HbWv28MubA9x20SFg4i,SpATywNh6bZuzm8s1ceuBUnMUAeoAHHw,4,2,1,0,0,0,3,0,6,0.8571428571428571,1,0.0,0,1,0,0,2,0,0,3,0,1,5,0
745,9820,aHRdc7lsBBp8F9aMkgntONfsLpIf0i6y,SpATywNh6bZuzm8s1ceuBUnMUAeoAHHw,34,33,15,37,11,1,4,0,101,14.428571428571429,1,0.0,16,15,35,11,17,1,2,4,0,77,24,0
746,9833,31jhVyZsYwM3i4SgxR1MFYrhxZjgzlJ8,SpATywNh6bZuzm8s1ceuBUnMUAeoAHHw,33,29,21,37,15,0,3,0,105,15.0,3,0.0,4,21,32,15,25,0,5,3,0,72,33,0
747,9835,a9OOTcAZgZGDa68djsRaJXsHoRuNVOvz,SpATywNh6bZuzm8s1ceuBUnMUAeoAHHw,35,48,29,24,20,14,15,0,150,21.428571428571427,4,0.0,14,29,19,20,34,14,5,15,0,82,68,1
748,9836,nknXXbQsC6Q6nMDyRKc0MDJZg6KtAXBE,SpATywNh6bZuzm8s1ceuBUnMUAeoAHHw,13,21,12,0,2,0,4,0,39,5.571428571428571,2,0.0,5,12,0,2,16,0,0,4,0,19,20,0
749,9842,MVF65xcT9c1o85EvDPizEzpYwxjeii1v,SpATywNh6bZuzm8s1ceuBUnMUAeoAHHw,18,30,1,11,0,0,10,0,52,7.428571428571429,4,0.0,5,1,10,0,25,0,1,10,0,16,36,1
750,9857,qDhyxHmDfIFLWQlPUBxWy3YNuv335dWU,SpATywNh6bZuzm8s1ceuBUnMUAeoAHHw,16,31,12,10,4,0,8,0,65,9.285714285714286,5,0.0,2,12,10,4,29,0,0,8,0,28,37,0
751,9874,mZIaM3Lmux7GERtSm258BKPOSUYFlwyy,SpATywNh6bZuzm8s1ceuBUnMUAeoAHHw,27,35,9,14,4,0,3,0,65,9.285714285714286,2,0.0,7,9,13,4,28,0,1,3,0,33,32,0
752,9878,iw5QtMAk2wyMi9Kh4hTv1WAFOj2rnxVj,SpATywNh6bZuzm8s1ceuBUnMUAeoAHHw,12,11,0,15,0,0,0,0,26,3.7142857142857144,1,0.0,2,0,15,0,9,0,0,0,0,17,9,0
753,9894,MarhO8rhsTXcbFpvat4mcEiSQvbAftxM,SpATywNh6bZuzm8s1ceuBUnMUAeoAHHw,4,2,1,0,1,0,1,0,5,0.7142857142857143,1,0.0,0,1,0,1,2,0,0,1,0,2,3,1
754,9896,47Lhswr4ZfAxhCMxQ5kAgIIaZKdQ7ZYE,SpATywNh6bZuzm8s1ceuBUnMUAeoAHHw,10,18,0,11,0,0,6,0,35,5.0,2,0.0,6,0,11,0,12,0,0,6,0,17,18,0
755,9910,FUkw8gvbqykqbH4tdSuG6VwP03f4pQvB,SpATywNh6bZuzm8s1ceuBUnMUAeoAHHw,20,17,11,5,6,0,6,0,45,6.428571428571429,2,0.0,2,11,5,6,15,0,0,6,0,24,21,0
756,9921,Mv7oSGs75OaCjYLhHCNmqqrqaAjjO5gs,RXDvfPUBYFlVdlueBFbLW0mhhAyGEqpt,30,55,5,80,0,0,7,0,147,21.0,5,0.0,11,5,71,0,44,0,9,7,0,87,60,1
757,9965,XL8OObjZsaGHAKex6gNHyGuTbyi42iwz,SpATywNh6bZuzm8s1ceuBUnMUAeoAHHw,5,2,0,0,0,0,6,0,8,1.1428571428571428,1,0.0,0,0,0,0,2,0,0,6,0,0,8,1
758,9973,pqAmXCZ0vs0c5YNrZSPIZNZIkmuJCMBN,RXDvfPUBYFlVdlueBFbLW0mhhAyGEqpt,20,12,11,2,8,0,1,0,34,4.857142857142857,1,0.0,0,11,2,8,12,0,0,1,0,21,13,0
759,9989,GVRJN4wkoooaXJUVmwnX983A87KsrZPK,A3fsA9Zfv1X2fVEQhTw51lKENdNrEqT3,6,7,4,6,0,0,2,0,19,2.7142857142857144,2,0.0,1,4,5,0,6,0,1,2,0,10,9,0
760,10001,vsk33lNJbFXN2L68Y5R9TSkfONwNMOQ8,SpATywNh6bZuzm8s1ceuBUnMUAeoAHHw,21,16,10,7,6,0,5,0,44,6.285714285714286,2,0.0,4,10,7,6,12,0,0,5,0,27,17,0
761,10012,vqSgORDp5PsEpveQVJoPh4dnJvR6AQkK,RXDvfPUBYFlVdlueBFbLW0mhhAyGEqpt,32,51,26,30,14,28,9,0,158,22.571428571428573,5,0.0,13,26,28,14,38,28,2,9,0,81,77,0
762,10042,RCWIrGGQZDVLNIofIMbc1GdSrqA961jg,RXDvfPUBYFlVdlueBFbLW0mhhAyGEqpt,18,45,22,8,1,44,6,0,126,18.0,4,0.0,8,22,4,1,37,44,4,6,0,35,91,1
763,10048,X8GmwqDtWUFSMSOGWtivlDRmblWXusTi,SpATywNh6bZuzm8s1ceuBUnMUAeoAHHw,3,2,1,0,0,0,2,0,5,0.7142857142857143,1,0.0,0,1,0,0,2,0,0,2,0,1,4,0
764,10067,IkfMHDVbFGQIQxWjHsEqTwjNnrBCaA7O,SpATywNh6bZuzm8s1ceuBUnMUAeoAHHw,14,20,1,14,0,0,2,0,37,5.285714285714286,2,0.0,8,1,12,0,12,0,2,2,0,21,16,0
765,10070,FkxhG6zHFqigfK7M5JQhv4MT6lPE3kxN,RXDvfPUBYFlVdlueBFbLW0mhhAyGEqpt,61,71,44,130,25,1,10,1,282,40.285714285714285,5,0.0,18,44,108,25,53,1,22,10,1,195,87,0
766,10071,ivII4h55QUeXOce5qbbvWPv1IAJ1FXtO,SpATywNh6bZuzm8s1ceuBUnMUAeoAHHw,9,8,0,5,0,0,2,0,15,2.142857142857143,1,0.0,4,0,5,0,4,0,0,2,0,9,6,1
767,10073,3VQVtsFphnOA3h1KWYRcAEMgfViLsPnF,A3fsA9Zfv1X2fVEQhTw51lKENdNrEqT3,7,8,0,0,0,0,1,0,9,1.2857142857142858,1,0.0,0,0,0,0,8,0,0,1,0,0,9,1
768,10081,2LiXT3Fppj80YAOl6K8p0HtAK0LHy6KG,SpATywNh6bZuzm8s1ceuBUnMUAeoAHHw,36,38,26,24,16,0,14,0,118,16.857142857142858,5,0.0,4,26,23,16,34,0,1,14,0,69,49,0
769,10095,JQVJEgOcL8lOPq9QqGxWJ7NUVC20wQ1o,SpATywNh6bZuzm8s1ceuBUnMUAeoAHHw,26,31,16,33,8,21,10,1,120,17.142857142857142,4,0.0,10,16,29,8,21,21,4,10,1,63,57,0
770,10122,NiXPZUmEILmWUPwXexYxtHvaIL7QdjCQ,RXDvfPUBYFlVdlueBFbLW0mhhAyGEqpt,35,74,45,40,1,11,12,1,184,26.285714285714285,5,0.0,18,45,38,1,56,11,2,12,1,102,82,0
771,10129,7rP408Gy6dVEeyQ5Me3hr5GFRnqOotmL,A3fsA9Zfv1X2fVEQhTw51lKENdNrEqT3,46,22,15,74,11,0,7,1,130,18.571428571428573,1,0.0,5,15,61,11,17,0,13,7,1,92,38,1
772,10130,u3iTsADy3VjWLwiWIPabdGKGPi8ZLAbJ,SpATywNh6bZuzm8s1ceuBUnMUAeoAHHw,17,13,3,8,2,0,16,0,42,6.0,5,0.0,0,3,8,2,13,0,0,16,0,13,29,0
773,10190,h81tMgwEiasc4dN2MBVSIam9UKAPfs93,A3fsA9Zfv1X2fVEQhTw51lKENdNrEqT3,38,50,37,90,30,0,2,0,209,29.857142857142858,1,0.0,1,37,78,30,49,0,12,2,0,146,63,0
774,10200,Sb9hMB1NLdfMmS0ToFmgrY6MZEZ6TYgo,SpATywNh6bZuzm8s1ceuBUnMUAeoAHHw,29,38,31,14,22,0,4,0,109,15.571428571428571,4,0.0,3,31,12,22,35,0,2,4,0,68,41,0
775,10204,nJbKKV1iJX5hAlKTzoiNMNIkB5aNJcfW,G8EPVSXsOYB5YQWZGiz1aVq5Pgr2GrQu,4,2,1,0,0,0,2,0,5,0.7142857142857143,1,0.0,0,1,0,0,2,0,0,2,0,1,4,0
776,10207,Qf6P6bxCyzplkdXIQa3YsHmpzfUnMGYL,SpATywNh6bZuzm8s1ceuBUnMUAeoAHHw,30,57,22,13,15,0,9,0,116,16.571428571428573,3,0.0,6,22,10,15,51,0,3,9,0,53,63,0
777,10227,SnivjdMp3HL6G23yPscSnzZlAD2Rbyt6,A3fsA9Zfv1X2fVEQhTw51lKENdNrEqT3,26,6,4,62,2,0,1,0,75,10.714285714285714,1,0.0,1,4,55,2,5,0,7,1,0,62,13,0
778,10230,X9IfBkBBoI1jhyhTI5cK6hEB3eMT1rI2,SpATywNh6bZuzm8s1ceuBUnMUAeoAHHw,18,19,11,11,3,0,4,0,48,6.857142857142857,2,0.0,5,11,10,3,14,0,1,4,0,29,19,0
779,10232,zXzBBpTV9epJ0NK0fVVhqGAiB4MQXdB4,SpATywNh6bZuzm8s1ceuBUnMUAeoAHHw,19,10,7,7,5,2,3,1,35,5.0,1,0.0,2,7,6,5,8,2,1,3,1,20,15,0
780,10244,5gwirWhcaVB1Z2yy4RRslODx7MsCrRca,SpATywNh6bZuzm8s1ceuBUnMUAeoAHHw,19,26,13,19,7,0,4,0,69,9.857142857142858,3,0.0,7,13,16,7,19,0,3,4,0,43,26,0
781,10276,6pYrzEgLAB7Gx24u5Kn0l64uyJLXY41J,SpATywNh6bZuzm8s1ceuBUnMUAeoAHHw,6,3,1,0,1,0,10,0,15,2.142857142857143,2,0.0,0,1,0,1,3,0,0,10,0,2,13,0
782,10280,dtlGqEkxytgl4rvxvygVAnxqgcqdYicp,SpATywNh6bZuzm8s1ceuBUnMUAeoAHHw,15,16,8,13,3,0,3,0,43,6.142857142857143,2,0.0,2,8,11,3,14,0,2,3,0,24,19,0
783,10328,GSkYUOcl4XzYMWSWhE6gXRGQ9kqPeXsi,SpATywNh6bZuzm8s1ceuBUnMUAeoAHHw,19,13,10,12,6,0,1,0,42,6.0,1,0.0,2,10,11,6,11,0,1,1,0,29,13,0
784,10358,Nzrw7pk0OZ13UV7zfdLy7gEMwvTA7qqG,SpATywNh6bZuzm8s1ceuBUnMUAeoAHHw,22,49,30,17,5,72,16,0,189,27.0,6,0.0,11,30,14,5,38,72,3,16,0,60,129,0
785,10380,ziZWaDkSdnYYFQL9rVa6Bhv9eL7a9wWX,SpATywNh6bZuzm8s1ceuBUnMUAeoAHHw,19,29,2,12,2,47,20,0,112,16.0,5,0.0,4,2,11,2,25,47,1,20,0,19,93,0
786,10388,SaHrUfZXnTghdXjrd2g1gBsj8aUTXhNX,SpATywNh6bZuzm8s1ceuBUnMUAeoAHHw,14,23,2,8,1,3,3,0,40,5.714285714285714,1,0.0,8,2,8,1,15,3,0,3,0,19,21,0
787,10407,xLsstPG4sh6BOKWjwGwQnQICDDoIsKTd,SpATywNh6bZuzm8s1ceuBUnMUAeoAHHw,12,7,6,0,4,0,1,0,18,2.5714285714285716,1,0.0,0,6,0,4,7,0,0,1,0,10,8,0
788,10427,Daw06K1PSOXldo19kBgHP5sewulb7Vu5,SpATywNh6bZuzm8s1ceuBUnMUAeoAHHw,11,15,0,6,0,0,1,0,22,3.142857142857143,1,0.0,3,0,5,0,12,0,1,1,0,8,14,1
789,10441,KRLjLXKoKEagD4g49Zuzvz0geq7JPqfn,bWdj2GDclj5ofokWjzoa5jAwMkxCykd6,2,0,1,0,1,0,0,0,2,0.2857142857142857,1,0.0,0,1,0,1,0,0,0,0,0,2,0,0
790,10481,4baDuWDcygh3I7gf3DfgmuPMN0Tyoi19,SpATywNh6bZuzm8s1ceuBUnMUAeoAHHw,16,26,4,11,2,23,10,0,76,10.857142857142858,1,0.0,4,4,8,2,22,23,3,10,0,18,58,0
791,10489,VC1Fuf9dV49znO9PkMawj1ZQqMcKHAjm,SpATywNh6bZuzm8s1ceuBUnMUAeoAHHw,11,11,0,7,0,0,1,0,19,2.7142857142857144,1,0.0,2,0,7,0,9,0,0,1,0,9,10,0
792,10518,rzGwtyhvOohTorRAFSpekt9j8KJVn1Nq,SpATywNh6bZuzm8s1ceuBUnMUAeoAHHw,16,33,20,2,11,0,8,0,74,10.571428571428571,3,0.0,2,20,2,11,31,0,0,8,0,35,39,0
793,10522,6rHs7FPoWFgbGCrOeJU6CnRQs9oaZ934,SpATywNh6bZuzm8s1ceuBUnMUAeoAHHw,1,0,0,0,0,0,1,0,1,0.14285714285714285,1,0.0,0,0,0,0,0,0,0,1,0,0,1,0
794,10527,VYMfm0tgVS6x4Eosz9NPpRPYpCrgFsMy,A3fsA9Zfv1X2fVEQhTw51lKENdNrEqT3,11,19,6,0,2,0,5,0,32,4.571428571428571,2,0.0,0,6,0,2,19,0,0,5,0,8,24,0
795,10540,Cwlc0kvvLoKXxEuXNQkjFRo818TDMpZS,SpATywNh6bZuzm8s1ceuBUnMUAeoAHHw,18,47,10,30,6,0,4,0,97,13.857142857142858,3,0.0,6,10,26,6,41,0,4,4,0,48,49,0
796,10542,r2u5KF0HWbXOmPd8SinNo3Ik67swOdP7,SpATywNh6bZuzm8s1ceuBUnMUAeoAHHw,24,36,24,14,9,0,4,0,87,12.428571428571429,3,0.0,8,24,11,9,28,0,3,4,0,52,35,0
797,10558,Cvs414mYH2FKto3axCpDhfQljawQ5dk9,SpATywNh6bZuzm8s1ceuBUnMUAeoAHHw,7,10,7,0,0,2,8,0,27,3.857142857142857,3,0.0,0,7,0,0,10,2,0,8,0,7,20,0
798,10580,m1V3ygdnufe369wleiOQ11JelGyARbAF,SpATywNh6bZuzm8s1ceuBUnMUAeoAHHw,5,3,2,0,1,0,1,0,7,1.0,1,0.0,0,2,0,1,3,0,0,1,0,3,4,1
799,10591,wbbNGhodAmSlYSg7ZSWYtWMdb0rjLgRw,G8EPVSXsOYB5YQWZGiz1aVq5Pgr2GrQu,49,24,16,58,14,2,12,0,126,18.0,3,0.0,1,16,53,14,23,2,5,12,0,84,42,0
800,10604,UKrQdzHwNJRJK7ZoTzKsoWlrkEbsQk7X,G8EPVSXsOYB5YQWZGiz1aVq5Pgr2GrQu,11,18,12,0,1,0,4,0,35,5.0,4,0.0,0,12,0,1,18,0,0,4,0,13,22,1
801,10606,BOBLP6pTmRtpQ8LtVgJyutFMDL3q6xno,SpATywNh6bZuzm8s1ceuBUnMUAeoAHHw,6,4,3,0,1,0,1,0,9,1.2857142857142858,1,0.0,0,3,0,1,4,0,0,1,0,4,5,0
802,10608,a3StgABPgimfVHzW1FR4usG9kIA0tZV5,SpATywNh6bZuzm8s1ceuBUnMUAeoAHHw,25,41,2,19,1,3,8,0,74,10.571428571428571,3,0.0,4,2,17,1,37,3,2,8,0,24,50,0
803,10609,VYMfm0tgVS6x4Eosz9NPpRPYpCrgFsMy,bWdj2GDclj5ofokWjzoa5jAwMkxCykd6,16,20,4,24,3,0,7,0,58,8.285714285714286,2,0.0,3,4,21,3,17,0,3,7,0,31,27,1
804,10623,dzaUNwKZy91BtYj96fOhuSgIlp9lXQDU,SpATywNh6bZuzm8s1ceuBUnMUAeoAHHw,3,4,2,0,0,4,3,0,13,1.8571428571428572,2,0.0,0,2,0,0,4,4,0,3,0,2,11,0
805,10634,OUOJlObKrXM0JmEUq0o8KzZHzr8jy9dn,bWdj2GDclj5ofokWjzoa5jAwMkxCykd6,12,23,10,58,3,18,11,1,124,17.714285714285715,3,0.0,8,10,57,3,15,18,1,11,1,78,46,0
806,10637,uzPUKUi7vVAcTKZXvlLeqjC4erxz8WBI,bWdj2GDclj5ofokWjzoa5jAwMkxCykd6,14,16,15,0,16,0,3,0,50,7.142857142857143,7,0.0,0,15,0,16,16,0,0,3,0,31,19,0
807,10647,JqgIGUKaljto8rJQxV18FonxG0JqVkY4,SpATywNh6bZuzm8s1ceuBUnMUAeoAHHw,5,3,1,0,1,0,1,0,6,0.8571428571428571,1,0.0,0,1,0,1,3,0,0,1,0,2,4,1
808,10655,39GYbZ8lJRbKZppnA1dQGPRJvzLTR46Q,SpATywNh6bZuzm8s1ceuBUnMUAeoAHHw,11,25,13,2,2,0,6,0,48,6.857142857142857,3,0.0,4,13,2,2,21,0,0,6,0,21,27,0
809,10658,teqJGecOr4a6oVYU1O9bgvPkX5ZSKA8N,A3fsA9Zfv1X2fVEQhTw51lKENdNrEqT3,10,15,2,8,0,0,7,0,32,4.571428571428571,5,0.0,0,2,8,0,15,0,0,7,0,10,22,1
810,10667,gvBW2L5p7TFF6lkwpHMNMz6nt7oEVYk1,SpATywNh6bZuzm8s1ceuBUnMUAeoAHHw,8,6,4,0,2,0,2,0,14,2.0,2,0.0,0,4,0,2,6,0,0,2,0,6,8,0
811,10676,Bv9FSXvHlE6wLC4E4yrAKqe3BQhrrtfx,SpATywNh6bZuzm8s1ceuBUnMUAeoAHHw,16,20,1,15,1,0,5,0,42,6.0,2,0.0,3,1,12,1,17,0,3,5,0,17,25,0
812,10692,rTYF0meww41Jaf1ZhSKn71dF6UobIHyn,SpATywNh6bZuzm8s1ceuBUnMUAeoAHHw,21,51,3,15,0,1,17,2,89,12.714285714285714,4,0.0,8,3,14,0,43,1,1,17,2,25,64,0
813,10693,ZAehH9zLr3mvrD0qfr21tfeJdYtTkUHf,SpATywNh6bZuzm8s1ceuBUnMUAeoAHHw,16,21,2,0,2,0,3,0,28,4.0,2,0.0,0,2,0,2,21,0,0,3,0,4,24,1
814,10700,jX1wtG8uym7vm2Ny85W79HCXnEeqhUm4,bWdj2GDclj5ofokWjzoa5jAwMkxCykd6,4,8,3,0,0,0,4,0,15,2.142857142857143,2,0.0,0,3,0,0,8,0,0,4,0,3,12,0
815,10712,IaSb2U7ef1Fkefm60uQQgWhKloK1Rfe8,SpATywNh6bZuzm8s1ceuBUnMUAeoAHHw,23,31,3,5,3,0,5,0,47,6.714285714285714,5,0.0,5,3,5,3,26,0,0,5,0,16,31,0
816,10743,98UEGByxiN7tned6NDQeKfQDq4HCSGvQ,SpATywNh6bZuzm8s1ceuBUnMUAeoAHHw,7,8,5,0,4,0,1,0,18,2.5714285714285716,1,0.0,0,5,0,4,8,0,0,1,0,9,9,0
817,10758,JjZeMsAmsZa7SQS0vTrtExRB1lmjwAQ2,SpATywNh6bZuzm8s1ceuBUnMUAeoAHHw,19,24,1,9,0,0,3,0,37,5.285714285714286,3,0.0,0,1,9,0,24,0,0,3,0,10,27,0
818,10761,Grmueh4kYgLYo2kInw23ZHrSQJbjli7D,SpATywNh6bZuzm8s1ceuBUnMUAeoAHHw,31,51,39,14,25,0,8,0,137,19.571428571428573,5,0.0,4,39,14,25,47,0,0,8,0,82,55,0
819,10799,4wGoSTuzJXBCojeNmaxk9GbR1KaCV7ql,G8EPVSXsOYB5YQWZGiz1aVq5Pgr2GrQu,28,12,0,132,0,0,3,0,147,21.0,1,0.0,0,0,119,0,12,0,13,3,0,119,28,0
820,10802,7jkKKf5Pb7FrtJ3WnuF11G7ePioUPJm3,SpATywNh6bZuzm8s1ceuBUnMUAeoAHHw,19,19,12,11,6,2,5,0,55,7.857142857142857,2,0.0,3,12,11,6,16,2,0,5,0,32,23,0
821,10805,mJAgtJKHxy28GsPIeuAEUCIOXmHzCywF,SpATywNh6bZuzm8s1ceuBUnMUAeoAHHw,23,32,19,11,10,3,8,0,83,11.857142857142858,3,0.0,8,19,9,10,24,3,2,8,0,46,37,0
822,10850,O4Go02y0WzYwbHIZc8uk50WjYKUP2Q4Y,G8EPVSXsOYB5YQWZGiz1aVq5Pgr2GrQu,6,5,0,0,1,0,2,0,8,1.1428571428571428,1,0.0,0,0,0,1,5,0,0,2,0,1,7,1
823,10863,SE8wOQdHqwRS7ESACXcTxQAuYFlgu1Py,SpATywNh6bZuzm8s1ceuBUnMUAeoAHHw,4,5,3,0,0,0,0,0,8,1.1428571428571428,1,0.0,2,3,0,0,3,0,0,0,0,5,3,1
824,10867,n6zGNJI1hLWYjlMIVXYesa3jTXjLwizj,SpATywNh6bZuzm8s1ceuBUnMUAeoAHHw,9,17,10,0,2,0,6,0,35,5.0,4,0.0,0,10,0,2,17,0,0,6,0,12,23,0
825,10868,d9cbpiPwBULo3iFfJzjTidseoxKi3AEA,SpATywNh6bZuzm8s1ceuBUnMUAeoAHHw,1,0,0,0,0,0,2,0,2,0.2857142857142857,2,0.0,0,0,0,0,0,0,0,2,0,0,2,0
826,10881,31ZWCwEsmLt26QDeYIg9aUSXrbkhFpxl,SpATywNh6bZuzm8s1ceuBUnMUAeoAHHw,4,8,2,0,0,0,2,0,12,1.7142857142857142,1,0.0,0,2,0,0,8,0,0,2,0,2,10,0
827,10903,896KUUFdpc0Ig8weMXOkWbw7cjXtmIVV,SpATywNh6bZuzm8s1ceuBUnMUAeoAHHw,11,13,7,35,0,0,17,0,72,10.285714285714286,5,0.0,5,7,33,0,8,0,2,17,0,45,27,0
828,10907,90tR2Jy52lv1kJ6TwJ9Jqo5P6u0CqT0E,SpATywNh6bZuzm8s1ceuBUnMUAeoAHHw,34,43,27,35,15,0,15,0,135,19.285714285714285,6,0.0,6,27,32,15,37,0,3,15,0,80,55,0
829,10961,1N6nOsYXnkatuA8YMolfRAv0tQpjn2uG,SpATywNh6bZuzm8s1ceuBUnMUAeoAHHw,20,18,11,15,7,0,3,0,54,7.714285714285714,3,0.0,4,11,13,7,14,0,2,3,0,35,19,0
830,10966,DmvuE1XVhhp2s0ZR7GTfZK1NmSM6wJmI,SpATywNh6bZuzm8s1ceuBUnMUAeoAHHw,6,3,2,0,1,0,2,0,8,1.1428571428571428,1,0.0,0,2,0,1,3,0,0,2,0,3,5,1
831,10970,IdRsdksEKIk9aXKOiGRUkjb7QPozokDa,SpATywNh6bZuzm8s1ceuBUnMUAeoAHHw,37,99,33,21,19,1,18,1,192,27.428571428571427,5,0.0,8,33,19,19,91,1,2,18,1,79,113,0
832,10986,MN4wOgynUY4QcRaraCB5Ym52vNjUttfc,SpATywNh6bZuzm8s1ceuBUnMUAeoAHHw,8,7,5,0,3,0,2,0,17,2.4285714285714284,2,0.0,0,5,0,3,7,0,0,2,0,8,9,0
833,10992,EaV63ns250Za7MNTuadlc0JeYoVcm5bM,SpATywNh6bZuzm8s1ceuBUnMUAeoAHHw,35,22,15,21,10,0,4,1,73,10.428571428571429,2,0.0,5,15,18,10,17,0,3,4,1,48,25,0
834,11000,zyIWmJjaz36PnMZpAzR2HEZCUbJWe8iQ,bWdj2GDclj5ofokWjzoa5jAwMkxCykd6,14,3,2,47,0,4,4,1,61,8.714285714285714,2,0.0,0,2,46,0,3,4,1,4,1,48,13,1
835,11007,o6ABKk2KTrZIkABXncviG8GWvJhMxPWI,bWdj2GDclj5ofokWjzoa5jAwMkxCykd6,3,0,0,0,0,0,3,4,7,1.0,1,0.0,0,0,0,0,0,0,0,3,4,0,7,1
836,11018,bjG4XBkL5oSJA9TxyrmgPKXKYOTfiWVp,bWdj2GDclj5ofokWjzoa5jAwMkxCykd6,29,46,8,38,4,16,9,0,121,17.285714285714285,6,0.0,0,8,30,4,46,16,8,9,0,42,79,0
837,11072,48y8P1mBttkP3u0gtvk3ydvAiO35KU2g,SpATywNh6bZuzm8s1ceuBUnMUAeoAHHw,19,25,15,7,6,0,3,0,56,8.0,5,0.0,5,15,7,6,20,0,0,3,0,33,23,0
838,11095,ALXyvdc776DMhlVyaaoPo6cQhevpwTYD,SpATywNh6bZuzm8s1ceuBUnMUAeoAHHw,6,5,1,0,1,0,2,0,9,1.2857142857142858,2,0.0,0,1,0,1,5,0,0,2,0,2,7,0
839,11096,vogj6DdqvLTkNOGuPksobO32JsQUkuqr,SpATywNh6bZuzm8s1ceuBUnMUAeoAHHw,13,36,1,19,1,0,1,0,58,8.285714285714286,4,0.0,8,1,16,1,28,0,3,1,0,26,32,0
840,11098,R5MIWOdfQPF58rt5zIICrbN58FLsYSLK,SpATywNh6bZuzm8s1ceuBUnMUAeoAHHw,3,2,0,0,0,0,1,0,3,0.42857142857142855,1,0.0,0,0,0,0,2,0,0,1,0,0,3,0
841,11099,EfuhWoaB1h47xaBVO37JU7S7sIj3K77V,SpATywNh6bZuzm8s1ceuBUnMUAeoAHHw,9,4,2,9,0,9,5,1,30,4.285714285714286,1,0.0,2,2,8,0,2,9,1,5,1,12,18,0
842,11110,fNM6a78gna3DBlYrxiSuwL1HfiXFBx1X,SpATywNh6bZuzm8s1ceuBUnMUAeoAHHw,18,14,8,12,5,0,1,0,40,5.714285714285714,1,0.0,5,8,10,5,9,0,2,1,0,28,12,1
843,11117,yBKClM5or0v37bBK9shMFXqtoOJsEOKi,SpATywNh6bZuzm8s1ceuBUnMUAeoAHHw,32,36,16,23,10,2,3,0,90,12.857142857142858,2,0.0,4,16,21,10,32,2,2,3,0,51,39,0
844,11118,8G3TIfWeYnotKEBloHzMAvSj0jab6YCE,SpATywNh6bZuzm8s1ceuBUnMUAeoAHHw,17,20,3,9,2,0,6,0,40,5.714285714285714,3,0.0,2,3,9,2,18,0,0,6,0,16,24,0
845,11140,kQ63n93d5CTXewyEhcoySFeLgYStuYpO,SpATywNh6bZuzm8s1ceuBUnMUAeoAHHw,19,22,12,11,4,0,7,0,56,8.0,6,0.0,2,12,9,4,20,0,2,7,0,27,29,0
846,11145,UnV0HDk59T6cuzi8hS829ZOjCdT0CRoB,SpATywNh6bZuzm8s1ceuBUnMUAeoAHHw,32,48,27,21,12,21,16,0,145,20.714285714285715,6,0.0,7,27,19,12,41,21,2,16,0,65,80,0
847,11152,SuK945tkxadINDtal1yRSiV9QKse6fnl,G8EPVSXsOYB5YQWZGiz1aVq5Pgr2GrQu,22,10,5,56,3,0,1,0,75,10.714285714285714,1,0.0,3,5,49,3,7,0,7,1,0,60,15,0
848,11153,h8eBexpHr95TQpIPdJzX4ggtrj3rthKs,SpATywNh6bZuzm8s1ceuBUnMUAeoAHHw,10,18,4,0,1,0,2,0,25,3.5714285714285716,1,0.0,0,4,0,1,18,0,0,2,0,5,20,0
849,11218,ESIDCh7JUpjIHOXvPcQBcrSs3Att83qK,SpATywNh6bZuzm8s1ceuBUnMUAeoAHHw,21,60,2,19,1,0,22,0,104,14.857142857142858,6,0.0,6,2,16,1,54,0,3,22,0,25,79,0
850,11231,FpAFHYP26eZqx6Z5sDhKdTJPTBgbDKt4,SpATywNh6bZuzm8s1ceuBUnMUAeoAHHw,21,34,18,18,7,22,10,2,111,15.857142857142858,5,0.0,9,18,14,7,25,22,4,10,2,48,63,0
851,11277,fOGAjxxxpsDuk08vAdjWtxgrvUhA2ic8,SpATywNh6bZuzm8s1ceuBUnMUAeoAHHw,3,2,0,0,0,0,1,0,3,0.42857142857142855,1,0.0,0,0,0,0,2,0,0,1,0,0,3,1
852,11307,1dxQmK9WwlHWuIG7ZTn4PsJ2vflQBDH3,SpATywNh6bZuzm8s1ceuBUnMUAeoAHHw,3,2,1,0,0,0,1,0,4,0.5714285714285714,1,0.0,0,1,0,0,2,0,0,1,0,1,3,0
853,11325,urVw10ZOKTw1O1zHFnsutUzT6EcZdTal,SpATywNh6bZuzm8s1ceuBUnMUAeoAHHw,31,37,16,9,11,4,7,0,84,12.0,3,0.0,3,16,8,11,34,4,1,7,0,38,46,0
854,11341,mJAgtJKHxy28GsPIeuAEUCIOXmHzCywF,bWdj2GDclj5ofokWjzoa5jAwMkxCykd6,3,6,3,0,0,0,2,0,11,1.5714285714285714,2,0.0,0,3,0,0,6,0,0,2,0,3,8,0
855,11351,1YxknoiTrSwQgclDlSAh4oMYHRyARhLv,A3fsA9Zfv1X2fVEQhTw51lKENdNrEqT3,4,2,1,0,0,0,2,0,5,0.7142857142857143,1,0.0,0,1,0,0,2,0,0,2,0,1,4,1
856,11367,zEiNHlokNuJTLVoV4Hy4kJd9kzaIjztD,SpATywNh6bZuzm8s1ceuBUnMUAeoAHHw,3,4,2,0,0,0,1,0,7,1.0,1,0.0,0,2,0,0,4,0,0,1,0,2,5,0
857,11387,8xe55v4hJPUrl0YZIl8G73vP4j2l4PsW,SpATywNh6bZuzm8s1ceuBUnMUAeoAHHw,8,7,3,13,0,0,1,0,24,3.4285714285714284,1,0.0,3,3,10,0,4,0,3,1,0,16,8,0
858,11418,Km3IX0L3OZADSpnXU3tgLmBjn4mYhfRJ,SpATywNh6bZuzm8s1ceuBUnMUAeoAHHw,16,15,0,16,0,4,7,7,49,7.0,1,0.0,4,0,13,0,11,4,3,7,7,17,32,0
859,11442,Sz8jNgPmKJ1IbqEEVQqTtQlVUDGarqh2,A3fsA9Zfv1X2fVEQhTw51lKENdNrEqT3,5,8,4,0,0,0,4,0,16,2.2857142857142856,2,0.0,0,4,0,0,8,0,0,4,0,4,12,0
860,11448,tLAxgBhXx0zpE8fWNnwggaJx5LeHI2h1,RXDvfPUBYFlVdlueBFbLW0mhhAyGEqpt,31,33,12,71,5,0,2,0,123,17.571428571428573,1,0.0,9,12,64,5,24,0,7,2,0,90,33,1
861,11450,HnptwVrdWLkMWuHezQcYS6A0pyVov5BG,SpATywNh6bZuzm8s1ceuBUnMUAeoAHHw,20,18,12,13,6,14,6,1,70,10.0,1,0.0,4,12,12,6,14,14,1,6,1,34,36,0
862,11456,CWDKRVVm01sfgssULmzIPwx9dbULLbqB,A3fsA9Zfv1X2fVEQhTw51lKENdNrEqT3,74,56,46,188,37,0,5,0,332,47.42857142857143,3,0.0,2,46,162,37,54,0,26,5,0,247,85,0
863,11490,mDEirND7nLzt2vy8e34SZhdfEbglxCWs,SpATywNh6bZuzm8s1ceuBUnMUAeoAHHw,6,6,3,0,3,0,1,0,13,1.8571428571428572,2,0.0,0,3,0,3,6,0,0,1,0,6,7,0
864,11494,nBVpguvJeCUz3AWDoX9CCNT2qyeZb33T,G8EPVSXsOYB5YQWZGiz1aVq5Pgr2GrQu,14,27,18,0,0,0,2,0,47,6.714285714285714,1,0.0,4,18,0,0,23,0,0,2,0,22,25,0
865,11516,aSlIMkfly6xTMJCGTWDQcnFZjajcWM6y,RXDvfPUBYFlVdlueBFbLW0mhhAyGEqpt,6,8,1,0,1,0,0,0,10,1.4285714285714286,1,0.0,0,1,0,1,8,0,0,0,0,2,8,0
866,11541,vIBcYbs1BLdmaaP30fcE2FS7kB7v7QRn,A3fsA9Zfv1X2fVEQhTw51lKENdNrEqT3,3,5,2,0,0,0,2,0,9,1.2857142857142858,3,0.0,0,2,0,0,5,0,0,2,0,2,7,1
867,11546,9PS6Icub6VXkyVUcoskrzajETE7Qoarh,SpATywNh6bZuzm8s1ceuBUnMUAeoAHHw,16,19,5,39,2,0,5,0,70,10.0,2,0.0,8,5,36,2,11,0,3,5,0,51,19,0
868,11568,l1IK9ZY8MbRv8UoeCkxEH7P4W2dtATGX,SpATywNh6bZuzm8s1ceuBUnMUAeoAHHw,26,29,3,16,1,0,5,0,54,7.714285714285714,4,0.0,5,3,16,1,24,0,0,5,0,25,29,0
869,11574,ypwDBeQLkxtWilMLhemtoXkZG88PSCik,SpATywNh6bZuzm8s1ceuBUnMUAeoAHHw,17,100,47,0,1,0,0,0,148,21.142857142857142,9,0.0,9,47,0,1,91,0,0,0,0,57,91,0
870,11586,GIK69AVoFAXQo5stVHHEqOqo5xlrkSOx,SpATywNh6bZuzm8s1ceuBUnMUAeoAHHw,35,69,8,31,5,28,35,1,177,25.285714285714285,9,0.0,22,8,29,5,47,28,2,35,1,64,113,0
871,11591,nlq4r6xc3rTUqTwcYhL6wudXdN6RIE52,A3fsA9Zfv1X2fVEQhTw51lKENdNrEqT3,36,23,21,0,17,0,2,0,63,9.0,2,0.0,0,21,0,17,23,0,0,2,0,38,25,0
872,11593,wmwDf7eIRrKPL0l8cNmMygnEPd5vzoqs,SpATywNh6bZuzm8s1ceuBUnMUAeoAHHw,7,7,4,0,1,0,2,0,14,2.0,2,0.0,0,4,0,1,7,0,0,2,0,5,9,0
873,11599,GD5KzWMBHDnHVJHzVFtf3u7bIC7XYtJH,SpATywNh6bZuzm8s1ceuBUnMUAeoAHHw,15,44,0,24,0,0,10,0,78,11.142857142857142,3,0.0,11,0,17,0,33,0,7,10,0,28,50,0
874,11603,wrdkNhe8GmpsjdZUr22H6zTi43mdouZW,SpATywNh6bZuzm8s1ceuBUnMUAeoAHHw,6,4,1,0,1,0,2,0,8,1.1428571428571428,1,0.0,0,1,0,1,4,0,0,2,0,2,6,1
875,11624,Kw83ufYGIFIihz0PdiaJro4hz0pKGozQ,SpATywNh6bZuzm8s1ceuBUnMUAeoAHHw,10,7,0,14,0,0,2,0,23,3.2857142857142856,1,0.0,2,0,12,0,5,0,2,2,0,14,9,1
876,11628,BHczT02DEALJmy7zbrGU6QbzLcOGM0Lz,SpATywNh6bZuzm8s1ceuBUnMUAeoAHHw,17,31,3,6,2,0,6,3,51,7.285714285714286,3,0.0,2,3,5,2,29,0,1,6,3,12,39,0
877,11637,glYOnGBygagQ3d4VwvOcHKnCEWLKXuzk,SpATywNh6bZuzm8s1ceuBUnMUAeoAHHw,15,23,8,0,7,0,5,0,43,6.142857142857143,3,0.0,1,8,0,7,22,0,0,5,0,16,27,0
878,11650,ilWzYGLWBh9DSc1MV8g2C4Go5wDNgUHX,SpATywNh6bZuzm8s1ceuBUnMUAeoAHHw,31,29,19,11,6,6,4,0,75,10.714285714285714,3,0.0,7,19,9,6,22,6,2,4,0,41,34,0
879,11651,tnLfm9tutF6YoqDXNIONCmii1aynBy80,G8EPVSXsOYB5YQWZGiz1aVq5Pgr2GrQu,4,3,2,0,0,0,1,0,6,0.8571428571428571,1,0.0,0,2,0,0,3,0,0,1,0,2,4,0
880,11653,WHRYwHaNw8C182lJomkvSukjZ7e91Upo,G8EPVSXsOYB5YQWZGiz1aVq5Pgr2GrQu,2,0,0,0,0,1,1,0,2,0.2857142857142857,1,0.0,0,0,0,0,0,1,0,1,0,0,2,1
881,11668,3D1G3v8o9ZJD4YifQcvj5oZ6l4EKMMc3,SpATywNh6bZuzm8s1ceuBUnMUAeoAHHw,22,30,14,25,5,0,3,0,77,11.0,1,0.0,14,14,21,5,16,0,4,3,0,54,23,0
882,11688,QyLVPf4M60EkZ1E7DsOzioCPS0UDQt1T,SpATywNh6bZuzm8s1ceuBUnMUAeoAHHw,2,0,0,0,0,0,3,0,3,0.42857142857142855,1,0.0,0,0,0,0,0,0,0,3,0,0,3,1
883,11699,fJdUKH8czX92V7yfMeG7e087z1xbQDMc,SpATywNh6bZuzm8s1ceuBUnMUAeoAHHw,33,24,18,14,12,0,2,0,70,10.0,2,0.0,4,18,13,12,20,0,1,2,0,47,23,0
884,11732,6L205IIarnrBFjrCXSXMQhtSJJ5O5hiQ,SpATywNh6bZuzm8s1ceuBUnMUAeoAHHw,34,56,34,27,16,10,6,0,149,21.285714285714285,1,0.0,18,34,23,16,38,10,4,6,0,91,58,0
885,11765,CF9EOBndFkwfNq6XdrlnJGwplvjOhGZh,SpATywNh6bZuzm8s1ceuBUnMUAeoAHHw,17,32,0,20,0,53,8,0,113,16.142857142857142,3,0.0,16,0,18,0,16,53,2,8,0,34,79,0
886,11773,gxkoHTlKe7FVuciB5TU7TNQLS1IuXLYY,SpATywNh6bZuzm8s1ceuBUnMUAeoAHHw,21,22,14,8,8,0,4,0,56,8.0,5,0.0,0,14,6,8,22,0,2,4,0,28,28,1
887,11782,twnWF0mfZYHjmoqBvUs9g7jWpDxNR6WV,SpATywNh6bZuzm8s1ceuBUnMUAeoAHHw,14,13,8,2,4,0,3,0,30,4.285714285714286,1,0.0,3,8,2,4,10,0,0,3,0,17,13,1
888,11797,ejIJpZTu0P4rcWcZmBKl6OiURGceVpiA,SpATywNh6bZuzm8s1ceuBUnMUAeoAHHw,17,30,17,12,6,2,9,0,76,10.857142857142858,4,0.0,5,17,11,6,25,2,1,9,0,39,37,0
889,11803,jpgFrFPODuxdIxVKUbbelvbFMPtUp7jo,SpATywNh6bZuzm8s1ceuBUnMUAeoAHHw,37,46,27,18,16,8,13,0,128,18.285714285714285,4,0.0,11,27,16,16,35,8,2,13,0,70,58,0
890,11822,neCsLgPwvO3NM22QUF7ePoDh9jooDB1R,G8EPVSXsOYB5YQWZGiz1aVq5Pgr2GrQu,6,4,1,0,1,0,1,0,7,1.0,1,0.0,0,1,0,1,4,0,0,1,0,2,5,0
891,11866,0Ycdp4l6pgMwD7gJz4jynSnW5FA5aOcj,RXDvfPUBYFlVdlueBFbLW0mhhAyGEqpt,27,26,16,60,9,3,5,1,120,17.142857142857142,1,0.0,8,16,58,9,18,3,2,5,1,91,29,0
892,11868,grkG64gC1ukbqi3lu9n1P24tGPzF2BzQ,SpATywNh6bZuzm8s1ceuBUnMUAeoAHHw,31,35,25,12,13,0,5,0,90,12.857142857142858,3,0.0,5,25,11,13,30,0,1,5,0,54,36,0
893,11873,CLsYy7g1hYWHJyj1aROfKK9oTeo5yxJx,SpATywNh6bZuzm8s1ceuBUnMUAeoAHHw,31,23,14,7,10,19,5,0,78,11.142857142857142,2,0.0,5,14,6,10,18,19,1,5,0,35,43,0
894,11875,s1zoJG6TsTv8LP9PRWCYbeiv4OLIivpy,SpATywNh6bZuzm8s1ceuBUnMUAeoAHHw,18,21,16,0,10,0,4,0,51,7.285714285714286,2,0.0,1,16,0,10,20,0,0,4,0,27,24,0
895,11912,5FSqkpRO54sosmyXXDdXixBIUlxd8QNQ,SpATywNh6bZuzm8s1ceuBUnMUAeoAHHw,20,62,35,14,18,0,13,0,142,20.285714285714285,6,0.0,3,35,12,18,59,0,2,13,0,68,74,0
896,11928,syrttArug8Mpzs9L0IHsvBtATawYF9J2,A3fsA9Zfv1X2fVEQhTw51lKENdNrEqT3,9,5,3,2,2,0,1,0,13,1.8571428571428572,1,0.0,0,3,2,2,5,0,0,1,0,7,6,0
897,11955,oyFfPK6y9oPPwQR5mbsXW98FJaEnU88b,SpATywNh6bZuzm8s1ceuBUnMUAeoAHHw,6,3,2,0,1,0,2,0,8,1.1428571428571428,1,0.0,0,2,0,1,3,0,0,2,0,3,5,1
898,11958,HG2MGN3erjLUr4zPCv4UJukzIqIJPVZ2,SpATywNh6bZuzm8s1ceuBUnMUAeoAHHw,20,14,9,17,5,0,5,0,50,7.142857142857143,1,0.0,2,9,14,5,12,0,3,5,0,30,20,1
899,11969,RhMByUF03fgdIuaHANL6m20mbMakGgJs,SpATywNh6bZuzm8s1ceuBUnMUAeoAHHw,4,5,3,0,0,0,2,0,10,1.4285714285714286,2,0.0,0,3,0,0,5,0,0,2,0,3,7,0
900,11998,NHPpKvbnrSpxM8e1DORBWJbRCpmrxZw8,SpATywNh6bZuzm8s1ceuBUnMUAeoAHHw,36,40,22,25,10,7,10,0,114,16.285714285714285,3,0.0,13,22,19,10,27,7,6,10,0,64,50,0
901,12016,matrDCCbXVpxlcX50EwFfEaLRW1d7v0q,SpATywNh6bZuzm8s1ceuBUnMUAeoAHHw,1,0,0,0,0,0,1,0,1,0.14285714285714285,1,0.0,0,0,0,0,0,0,0,1,0,0,1,1
902,12019,UaSh8dwx8gnofYbXlmpqj9uYDbpJ89pX,bWdj2GDclj5ofokWjzoa5jAwMkxCykd6,12,15,6,76,0,25,7,0,129,18.428571428571427,4,0.0,0,6,75,0,15,25,1,7,0,81,48,0
903,12052,g3902agYIRHzac78MKVZlvljLMXXNpQ7,SpATywNh6bZuzm8s1ceuBUnMUAeoAHHw,34,40,26,18,14,0,12,0,110,15.714285714285714,4,0.0,8,26,17,14,32,0,1,12,0,65,45,0
904,12119,x0VzAeYdlywtGLqE1HF68qQMYZTLfsw9,A3fsA9Zfv1X2fVEQhTw51lKENdNrEqT3,7,4,3,0,2,0,2,0,11,1.5714285714285714,1,0.0,0,3,0,2,4,0,0,2,0,5,6,1
905,12166,x6CSpC8D3vQdEDfFDD93c2HvZ1J8Rtto,RXDvfPUBYFlVdlueBFbLW0mhhAyGEqpt,4,3,2,0,0,0,1,0,6,0.8571428571428571,1,0.0,0,2,0,0,3,0,0,1,0,2,4,1
906,12197,RPansaKc9yPYyKahcqLAJO6a0GoBHglr,SpATywNh6bZuzm8s1ceuBUnMUAeoAHHw,35,50,33,17,19,15,14,0,148,21.142857142857142,5,0.0,5,33,17,19,45,15,0,14,0,74,74,0
907,12212,KXPHZfgM3L9NmmWzrburRZrpNwRct3s8,SpATywNh6bZuzm8s1ceuBUnMUAeoAHHw,6,3,2,0,0,1,5,0,11,1.5714285714285714,1,0.0,0,2,0,0,3,1,0,5,0,2,9,1
908,12299,fa6SZdwIb8QmMO5YcB5PQzrN75peDxq7,G8EPVSXsOYB5YQWZGiz1aVq5Pgr2GrQu,7,4,3,0,1,0,4,0,12,1.7142857142857142,1,0.0,0,3,0,1,4,0,0,4,0,4,8,1
909,12308,CQOn4KWCA0duDCOSP1DQzvXZ3yAfq1zW,SpATywNh6bZuzm8s1ceuBUnMUAeoAHHw,4,7,5,0,0,0,0,0,12,1.7142857142857142,3,0.0,0,5,0,0,7,0,0,0,0,5,7,0
910,12323,dceX0m9075YvlWaEabJwd03DyXl3MtL8,SpATywNh6bZuzm8s1ceuBUnMUAeoAHHw,9,8,4,5,0,0,6,0,23,3.2857142857142856,2,0.0,2,4,5,0,6,0,0,6,0,11,12,0
911,12348,ZhTCqX8GMUcn0a0betuEauHNuCk1aRhm,A3fsA9Zfv1X2fVEQhTw51lKENdNrEqT3,44,18,9,160,0,20,13,0,220,31.428571428571427,4,0.0,2,9,143,0,16,20,17,13,0,154,66,0
912,12371,Dx1ZzKpwFtwNhE9gdaLaohssqGyqrqjD,SpATywNh6bZuzm8s1ceuBUnMUAeoAHHw,19,13,10,13,5,1,1,0,43,6.142857142857143,1,0.0,2,10,10,5,11,1,3,1,0,27,16,0
913,12384,bKVslXuzEQ1pv4c6iV5mVjs6X6avUbmL,RXDvfPUBYFlVdlueBFbLW0mhhAyGEqpt,26,57,30,0,12,81,43,1,224,32.0,8,0.0,2,30,0,12,55,81,0,43,1,44,180,0
914,12409,Io5gLr8QOxaBw8nFReloAXOpt3IlZ5WE,SpATywNh6bZuzm8s1ceuBUnMUAeoAHHw,2,0,0,0,0,0,5,0,5,0.7142857142857143,2,0.0,0,0,0,0,0,0,0,5,0,0,5,0
915,12430,w62eko3BoCGIpZmfYYoFjoaBC9TFzjaB,SpATywNh6bZuzm8s1ceuBUnMUAeoAHHw,19,13,9,7,6,1,4,0,40,5.714285714285714,2,0.0,2,9,7,6,11,1,0,4,0,24,16,1
916,12431,dOkXreE5Co54rqG7YecVg356rhQtEiRH,SpATywNh6bZuzm8s1ceuBUnMUAeoAHHw,5,3,1,0,1,0,1,0,6,0.8571428571428571,1,0.0,0,1,0,1,3,0,0,1,0,2,4,1
917,12448,AQaaG4AcAnObnM2M4NcHCUkX6lEg0Mlu,SpATywNh6bZuzm8s1ceuBUnMUAeoAHHw,32,26,11,23,9,0,11,0,80,11.428571428571429,3,0.0,4,11,22,9,22,0,1,11,0,46,34,1
918,12518,4IkxYjTflPhoHxhEdrFyf3T4ZXNMTaKd,SpATywNh6bZuzm8s1ceuBUnMUAeoAHHw,20,27,13,10,6,0,6,0,62,8.857142857142858,4,0.0,2,13,10,6,25,0,0,6,0,31,31,0
919,12546,LRHDYNgQAsG2UssS8TgaqkiYDbFlVrrj,A3fsA9Zfv1X2fVEQhTw51lKENdNrEqT3,14,7,7,0,6,0,0,0,20,2.857142857142857,1,0.0,0,7,0,6,7,0,0,0,0,13,7,1
920,12557,Vx74c4EnHqTcmxhMcO6kRvadcvYQC7Hl,SpATywNh6bZuzm8s1ceuBUnMUAeoAHHw,14,23,10,0,6,0,4,0,43,6.142857142857143,3,0.0,0,10,0,6,23,0,0,4,0,16,27,0
921,12564,D59LfxtLBEXUXJuXCGYTJcy2S1d5nPYE,SpATywNh6bZuzm8s1ceuBUnMUAeoAHHw,19,23,3,15,2,0,5,0,48,6.857142857142857,3,0.0,6,3,13,2,17,0,2,5,0,24,24,0
922,12566,ph8ToQs4xH6gdMMZGt7KWlSytujO4hy7,bWdj2GDclj5ofokWjzoa5jAwMkxCykd6,12,21,12,0,5,0,6,0,44,6.285714285714286,2,0.0,4,12,0,5,17,0,0,6,0,21,23,0
923,12592,VwUXTBGJaTv5xN1He6TwE1OKxII3IUB4,A3fsA9Zfv1X2fVEQhTw51lKENdNrEqT3,9,10,8,0,2,5,2,0,27,3.857142857142857,1,0.0,0,8,0,2,10,5,0,2,0,10,17,1
924,12598,0MgLdwlRWQ7TpUbl7lDTcNpvvpvRxwZk,SpATywNh6bZuzm8s1ceuBUnMUAeoAHHw,9,9,6,10,1,0,1,0,27,3.857142857142857,1,0.0,2,6,10,1,7,0,0,1,0,19,8,1
925,12628,JaYbgvhgx43SysY9J8DaCR3IcdUzCcUf,SpATywNh6bZuzm8s1ceuBUnMUAeoAHHw,10,10,1,0,1,0,2,0,14,2.0,2,0.0,0,1,0,1,10,0,0,2,0,2,12,0
926,12665,2DNSh2UatQFpodq67CmKbjqpA6AJb7Oi,SpATywNh6bZuzm8s1ceuBUnMUAeoAHHw,21,20,12,7,5,0,7,0,51,7.285714285714286,4,0.0,2,12,7,5,18,0,0,7,0,26,25,0
927,12725,yXkO3eR7yt6I5YPt7SbP4lJC7f4DWsPi,SpATywNh6bZuzm8s1ceuBUnMUAeoAHHw,18,28,3,20,2,0,5,0,58,8.285714285714286,4,0.0,3,3,16,2,25,0,4,5,0,24,34,0
928,12741,yFLanYq8p4sf6NFSB1Td9ag6632plY4t,A3fsA9Zfv1X2fVEQhTw51lKENdNrEqT3,9,4,3,0,2,0,4,0,13,1.8571428571428572,1,0.0,0,3,0,2,4,0,0,4,0,5,8,0
929,12781,xI2qMeJnp6aq2CKhFmXJQYegY0eBgJqh,SpATywNh6bZuzm8s1ceuBUnMUAeoAHHw,5,6,2,0,0,13,6,2,29,4.142857142857143,3,0.0,0,2,0,0,6,13,0,6,2,2,27,0
930,12788,rZSLmwiYX8trzeLsBLeg8r0IN1GBbqOC,A3fsA9Zfv1X2fVEQhTw51lKENdNrEqT3,73,30,14,148,4,0,6,0,202,28.857142857142858,2,0.0,6,14,137,4,24,0,11,6,0,161,41,0
931,12797,0r0opwFyJ4N25MV6ZjVs69MBQP4LTfaz,RXDvfPUBYFlVdlueBFbLW0mhhAyGEqpt,38,20,11,38,7,3,4,0,83,11.857142857142858,2,0.0,7,11,38,7,13,3,0,4,0,63,20,0
932,12838,D1VQybdJv05b8bnQWlTwVLnxuzPr9TGg,SpATywNh6bZuzm8s1ceuBUnMUAeoAHHw,22,21,12,8,7,0,6,0,54,7.714285714285714,2,0.0,2,12,8,7,19,0,0,6,0,29,25,0
933,12861,clcszcRJ03jiyZ5GYQyVZZ7N7YqBvRWN,G8EPVSXsOYB5YQWZGiz1aVq5Pgr2GrQu,11,9,3,16,2,1,4,2,37,5.285714285714286,1,0.0,5,3,14,2,4,1,2,4,2,24,13,1
934,12919,UaSh8dwx8gnofYbXlmpqj9uYDbpJ89pX,SpATywNh6bZuzm8s1ceuBUnMUAeoAHHw,4,8,2,0,0,1,4,0,15,2.142857142857143,3,0.0,0,2,0,0,8,1,0,4,0,2,13,0
935,12922,uqIn0vdfJ1SDJCOeCVEAQPRFBBKQA2eB,A3fsA9Zfv1X2fVEQhTw51lKENdNrEqT3,41,25,13,72,9,0,1,0,120,17.142857142857142,2,0.0,1,13,67,9,24,0,5,1,0,90,30,1
936,12939,BZIh5Ji4WRsl5XFn0vcayrSAt3EwPPq7,SpATywNh6bZuzm8s1ceuBUnMUAeoAHHw,20,40,6,9,6,2,15,1,79,11.285714285714286,4,0.0,2,6,8,6,38,2,1,15,1,22,57,0
937,12941,agXxlcmOoEfRNuHGmntEOJrJqSCOihJk,SpATywNh6bZuzm8s1ceuBUnMUAeoAHHw,18,33,0,7,0,1,7,0,48,6.857142857142857,4,0.0,8,0,7,0,25,1,0,7,0,15,33,1
938,12960,QxcB9RiJu5tiHZOch1DPGex1fIsAotsI,SpATywNh6bZuzm8s1ceuBUnMUAeoAHHw,28,44,1,18,1,1,9,1,75,10.714285714285714,4,0.0,9,1,17,1,35,1,1,9,1,28,47,0
939,12973,7fFZLbLMI7Ucj1mdrBxpY9hCEcczhOLF,RXDvfPUBYFlVdlueBFbLW0mhhAyGEqpt,29,32,2,65,1,0,3,0,103,14.714285714285714,2,0.0,11,2,64,1,21,0,1,3,0,78,25,0
940,12987,d1JMD7qxfNKpLgzBvlpfaUYeKyTI6qbc,RXDvfPUBYFlVdlueBFbLW0mhhAyGEqpt,14,7,6,0,5,0,2,0,20,2.857142857142857,1,0.0,0,6,0,5,7,0,0,2,0,11,9,0
941,13021,rXHS1nVaWODpE4oMoF8GV1PH34kuNjhN,A3fsA9Zfv1X2fVEQhTw51lKENdNrEqT3,26,4,2,90,0,2,6,1,105,15.0,1,0.0,1,2,75,0,3,2,15,6,1,78,27,1
942,13038,Ys5FH0nq7NeLEdwGoDUOp7Sz8iAMAB3d,SpATywNh6bZuzm8s1ceuBUnMUAeoAHHw,7,9,4,0,1,0,1,0,15,2.142857142857143,1,0.0,4,4,0,1,5,0,0,1,0,9,6,1
943,13064,FH8uaUgDtH5I6cjMpNACS7MT4OVRdm6l,SpATywNh6bZuzm8s1ceuBUnMUAeoAHHw,13,13,1,10,0,0,1,0,25,3.5714285714285716,1,0.0,4,1,10,0,9,0,0,1,0,15,10,0
944,13068,Oewk1cgUhxDAPgxI9Y8opSnbFrQ56lFp,G8EPVSXsOYB5YQWZGiz1aVq5Pgr2GrQu,53,37,28,46,20,0,13,0,144,20.571428571428573,4,0.0,3,28,42,20,34,0,4,13,0,93,51,0
945,13096,WkW7xhOBov4cdi1HI8MIcYy2tcL8JIqM,G8EPVSXsOYB5YQWZGiz1aVq5Pgr2GrQu,7,6,2,4,1,0,2,0,15,2.142857142857143,1,0.0,3,2,3,1,3,0,1,2,0,9,6,0
946,13097,jSElHDudYQXAurrUrZvr8PEvqza2483p,SpATywNh6bZuzm8s1ceuBUnMUAeoAHHw,6,15,4,0,4,0,11,0,34,4.857142857142857,2,0.0,0,4,0,4,15,0,0,11,0,8,26,0
947,13169,VD51DafWdYqPb9OUf4DGqW0cSE2mdG9x,RXDvfPUBYFlVdlueBFbLW0mhhAyGEqpt,4,3,2,0,0,0,1,0,6,0.8571428571428571,1,0.0,0,2,0,0,3,0,0,1,0,2,4,0
948,13182,Gur5FuhE9EyV9K1F0qLPk7AenhoY8PBS,A3fsA9Zfv1X2fVEQhTw51lKENdNrEqT3,3,4,0,0,0,0,2,0,6,0.8571428571428571,2,0.0,0,0,0,0,4,0,0,2,0,0,6,0
949,13231,CGCo1ulRSzYrFke9WXpheptgBfQxf2gK,SpATywNh6bZuzm8s1ceuBUnMUAeoAHHw,11,20,9,0,0,1,9,0,39,5.571428571428571,3,0.0,2,9,0,0,18,1,0,9,0,11,28,0
950,13268,eAArxLyCThtu9N3Mv8rQculKbGSa66j9,G8EPVSXsOYB5YQWZGiz1aVq5Pgr2GrQu,38,19,14,68,7,0,10,0,118,16.857142857142858,2,0.0,1,14,59,7,18,0,9,10,0,81,37,0
951,13284,HmCqvdVQxacevQymd3KKpvfG444InuCU,RXDvfPUBYFlVdlueBFbLW0mhhAyGEqpt,11,14,7,0,5,0,3,0,29,4.142857142857143,1,0.0,3,7,0,5,11,0,0,3,0,15,14,0
952,13297,0b8UUNX7vDapSg0uCVOk0glpsbuPbDat,SpATywNh6bZuzm8s1ceuBUnMUAeoAHHw,29,44,24,16,11,37,11,3,146,20.857142857142858,4,0.0,13,24,13,11,31,37,3,11,3,61,85,0
953,13309,1dxQmK9WwlHWuIG7ZTn4PsJ2vflQBDH3,A3fsA9Zfv1X2fVEQhTw51lKENdNrEqT3,5,5,2,0,1,0,2,0,10,1.4285714285714286,2,0.0,0,2,0,1,5,0,0,2,0,3,7,0
954,13318,Xzt2w1aRoJeIAP02oHWxu8IVeFzxqDvF,SpATywNh6bZuzm8s1ceuBUnMUAeoAHHw,8,13,10,0,6,0,3,0,32,4.571428571428571,2,0.0,0,10,0,6,13,0,0,3,0,16,16,0
955,13327,M3xTB6LenTJvMpybZKparVtRZKzrRM1R,SpATywNh6bZuzm8s1ceuBUnMUAeoAHHw,6,7,3,0,0,0,4,0,14,2.0,3,0.0,0,3,0,0,7,0,0,4,0,3,11,0
956,13335,BuvcW1QbEkmICBwJsmVk62irFMyFXFIl,SpATywNh6bZuzm8s1ceuBUnMUAeoAHHw,17,18,9,0,6,0,1,0,34,4.857142857142857,1,0.0,0,9,0,6,18,0,0,1,0,15,19,0
957,13350,ooqIS0ldRRRaqJrrOHVscbkigkM4wbN5,SpATywNh6bZuzm8s1ceuBUnMUAeoAHHw,31,25,21,0,17,0,4,0,67,9.571428571428571,4,0.0,0,21,0,17,25,0,0,4,0,38,29,0
958,13353,Aw7PeIkLW9CDHbPpPSjrFUdtBaUuHUXm,A3fsA9Zfv1X2fVEQhTw51lKENdNrEqT3,22,9,9,0,9,0,17,0,44,6.285714285714286,5,0.0,0,9,0,9,9,0,0,17,0,18,26,0
959,13392,Zp81uMflvqqrfEwxhUzFhFbNFp63e2qq,SpATywNh6bZuzm8s1ceuBUnMUAeoAHHw,16,29,11,12,5,0,2,0,59,8.428571428571429,6,0.0,4,11,11,5,25,0,1,2,0,31,28,0
960,13436,0wXXwNeE6W7NBvQ3k3OMvVCCQezsKKgg,SpATywNh6bZuzm8s1ceuBUnMUAeoAHHw,17,13,7,20,4,0,1,0,45,6.428571428571429,1,0.0,4,7,16,4,9,0,4,1,0,31,14,1
961,13502,Zdseq1rQmkAi5wZl57d3RwjzOxlL3B5I,A3fsA9Zfv1X2fVEQhTw51lKENdNrEqT3,100,56,49,220,43,0,2,0,370,52.857142857142854,4,0.0,3,49,173,43,53,0,47,2,0,268,102,0
962,13503,2YfvPW4RjjB1wuYNlMfzfMUdSCE4Rwzu,SpATywNh6bZuzm8s1ceuBUnMUAeoAHHw,11,31,3,18,0,3,7,0,62,8.857142857142858,2,0.0,14,3,14,0,17,3,4,7,0,31,31,0
963,13513,OsjipUObm67JsyJjOy7xHoa32L8CSYg5,RXDvfPUBYFlVdlueBFbLW0mhhAyGEqpt,62,55,5,80,5,8,6,0,159,22.714285714285715,2,0.0,18,5,79,5,37,8,1,6,0,107,52,0
964,13529,Ge8ZKyoh7v3U8XFFvvntz8tE5dDD1txz,SpATywNh6bZuzm8s1ceuBUnMUAeoAHHw,3,4,2,0,0,0,3,0,9,1.2857142857142858,2,0.0,0,2,0,0,4,0,0,3,0,2,7,1
965,13538,LjMEB9aIUIvEfq4JTf4C9ef9fHbbyj0M,SpATywNh6bZuzm8s1ceuBUnMUAeoAHHw,31,33,10,39,6,2,8,0,98,14.0,5,0.0,8,10,35,6,25,2,4,8,0,59,39,0
966,13562,Du4OhdznDw29gaWDeHXBUWRKyEVAbHaQ,SpATywNh6bZuzm8s1ceuBUnMUAeoAHHw,21,21,11,11,5,0,4,0,52,7.428571428571429,2,0.0,8,11,8,5,13,0,3,4,0,32,20,0
967,13574,BOWTvQlkFu3OONGPj2orMpzJbZOzBXuG,SpATywNh6bZuzm8s1ceuBUnMUAeoAHHw,22,32,5,14,2,0,9,0,62,8.857142857142858,4,0.0,6,5,12,2,26,0,2,9,0,25,37,0
968,13591,thD3JQHh1xpY9SdL9w6TAUhWjJrPsSHi,SpATywNh6bZuzm8s1ceuBUnMUAeoAHHw,34,61,31,30,17,0,6,0,145,20.714285714285715,2,0.0,24,31,27,17,37,0,3,6,0,99,46,0
969,13611,taXwAmoyCNDGaXo8nVRGsDZwnk4if3bF,SpATywNh6bZuzm8s1ceuBUnMUAeoAHHw,9,6,2,12,0,0,4,1,25,3.5714285714285716,1,0.0,3,2,11,0,3,0,1,4,1,16,9,0
970,13617,q1nSg7gMR4fmcENPvRW7b84TFAk5YaYv,SpATywNh6bZuzm8s1ceuBUnMUAeoAHHw,11,9,2,0,2,0,2,0,15,2.142857142857143,2,0.0,0,2,0,2,9,0,0,2,0,4,11,1
971,13645,FOoOtP9CvNldG35bvwpepCilGCCL9n8O,SpATywNh6bZuzm8s1ceuBUnMUAeoAHHw,21,15,11,0,8,0,2,0,36,5.142857142857143,2,0.0,0,11,0,8,15,0,0,2,0,19,17,1
972,13658,BRb6GOIqcgYg1e6c431h8FubF4jTJim3,SpATywNh6bZuzm8s1ceuBUnMUAeoAHHw,15,16,1,9,1,0,3,0,30,4.285714285714286,2,0.0,4,1,8,1,12,0,1,3,0,14,16,1
973,13668,ZFgJH3XPKn6EjDuXV9VLOpKftzENCqEZ,G8EPVSXsOYB5YQWZGiz1aVq5Pgr2GrQu,82,93,48,149,8,0,12,0,310,44.285714285714285,6,0.0,17,48,143,8,76,0,6,12,0,216,94,0
974,13677,ZFgJH3XPKn6EjDuXV9VLOpKftzENCqEZ,RXDvfPUBYFlVdlueBFbLW0mhhAyGEqpt,10,14,11,0,0,3,7,0,35,5.0,4,0.0,0,11,0,0,14,3,0,7,0,11,24,0
975,13695,eosk3dY7502Pbg6Dsnx0qWKWUpRTliXK,SpATywNh6bZuzm8s1ceuBUnMUAeoAHHw,9,18,10,0,0,0,4,0,32,4.571428571428571,3,0.0,0,10,0,0,18,0,0,4,0,10,22,1
976,13752,GUhU3sa7QMussHGi4kspdulqSqF9Ft42,SpATywNh6bZuzm8s1ceuBUnMUAeoAHHw,15,76,2,13,1,0,11,0,103,14.714285714285714,4,0.0,11,2,9,1,65,0,4,11,0,23,80,0
977,13756,zx92A3etlZOmjWi19IMDYlwaWCkvF08z,SpATywNh6bZuzm8s1ceuBUnMUAeoAHHw,5,5,1,0,0,0,1,0,7,1.0,1,0.0,0,1,0,0,5,0,0,1,0,1,6,1
978,13771,I1KwJ6EdCZnEPLfC8Q7yWpIkLOHn7h02,A3fsA9Zfv1X2fVEQhTw51lKENdNrEqT3,47,37,26,128,16,9,12,1,229,32.714285714285715,2,0.0,5,26,104,16,32,9,24,12,1,151,78,1
979,13776,PUFh3BsQaDVIJMDvwsFTqkrgAzvjO9ME,A3fsA9Zfv1X2fVEQhTw51lKENdNrEqT3,3,0,0,0,0,0,3,0,3,0.42857142857142855,1,0.0,0,0,0,0,0,0,0,3,0,0,3,0
980,14546,82UlWF6Fm1gkNum7nNbVw0yOV1BUdNoS,7GRhBDsirIGkRZBtSMEzNTyDr2JQm4xx,17,20,11,6,5,5,3,0,50,7.142857142857143,3,0.0,7,11,5,5,13,5,1,3,0,28,22,1
981,14552,gmqCuQTX0aljJXYwlMbQKWVNQXzJBU7z,7GRhBDsirIGkRZBtSMEzNTyDr2JQm4xx,54,59,32,0,22,1,2,0,116,16.571428571428573,1,0.0,1,32,0,22,58,1,0,2,0,55,61,0
982,14609,Q9kdHcV1kbonm0KnIW9OSERwU5lfVZ8s,7GRhBDsirIGkRZBtSMEzNTyDr2JQm4xx,2,1,1,0,0,0,0,0,2,0.2857142857142857,1,0.0,0,1,0,0,1,0,0,0,0,1,1,1
983,14654,StcQZMEDAMldF4GFQUzkrPFNVNZnPaeq,7GRhBDsirIGkRZBtSMEzNTyDr2JQm4xx,42,109,51,67,41,0,3,0,271,38.714285714285715,2,0.0,51,51,53,41,58,0,14,3,0,196,75,0
984,14816,NJcCHbOJUQpAuhbw958dR9qCvbh6GNk7,7GRhBDsirIGkRZBtSMEzNTyDr2JQm4xx,9,11,1,4,2,0,2,0,20,2.857142857142857,2,0.0,3,1,2,2,8,0,2,2,0,8,12,1
985,14832,wU9dwS3WWOQY9ZgttcIaOxUTFKpzQrwI,5X6FeZozNMgE2VRi3MJYjkkFK8SETtu2,2,0,0,0,0,0,2,0,2,0.2857142857142857,1,0.0,0,0,0,0,0,0,0,2,0,0,2,1
986,14847,1CUoIZB9t7SxaldyOLjOrt0HiuV3YmmT,7GRhBDsirIGkRZBtSMEzNTyDr2JQm4xx,14,32,12,0,3,0,4,0,51,7.285714285714286,2,0.0,11,12,0,3,21,0,0,4,0,26,25,0
987,14914,V3T018M85bBO96dvqXCnq2n6MCjTou0e,5X6FeZozNMgE2VRi3MJYjkkFK8SETtu2,12,25,7,0,7,0,2,0,41,5.857142857142857,6,0.0,10,7,0,7,15,0,0,2,0,24,17,1
988,14931,wo4ToMqIotOBdME6IawWUY9YebACZzlB,5X6FeZozNMgE2VRi3MJYjkkFK8SETtu2,98,223,13,305,20,33,17,1,612,87.42857142857143,13,0.0,140,13,263,20,83,33,42,17,1,436,176,0
989,14977,dIopyk7eN7utmmbDdsk2JIW9Z0tySqPS,5X6FeZozNMgE2VRi3MJYjkkFK8SETtu2,6,10,2,0,1,0,7,0,20,2.857142857142857,5,0.0,0,2,0,1,10,0,0,7,0,3,17,0
990,15002,pjhTiut9oLwyZ0Gl3Ry1rcutvHkAHeum,5X6FeZozNMgE2VRi3MJYjkkFK8SETtu2,9,17,4,0,0,0,3,0,24,3.4285714285714284,1,0.0,4,4,0,0,13,0,0,3,0,8,16,1
991,15020,5WZIqIqzSetVQERyKqK5gvhx5uoDAeQ9,5X6FeZozNMgE2VRi3MJYjkkFK8SETtu2,14,23,9,0,5,0,1,0,38,5.428571428571429,1,0.0,3,9,0,5,20,0,0,1,0,17,21,1
992,15048,YUqXNrT8XQT6xSTrWrerz6EWyspe1b7c,7GRhBDsirIGkRZBtSMEzNTyDr2JQm4xx,40,121,22,76,1,33,23,0,276,39.42857142857143,5,0.0,41,22,63,1,80,33,13,23,0,127,149,0
993,15083,AsBtR21xGFKZ6c2LKvPTdlawgiUBcaPL,7GRhBDsirIGkRZBtSMEzNTyDr2JQm4xx,62,161,53,76,39,4,27,0,360,51.42857142857143,7,0.0,45,53,60,39,116,4,16,27,0,197,163,0
994,15095,MJ0x5dfI1IbDZGrKNdjFdqwl7WJ8lS9F,5X6FeZozNMgE2VRi3MJYjkkFK8SETtu2,27,64,23,14,17,6,10,0,134,19.142857142857142,4,0.0,25,23,10,17,39,6,4,10,0,75,59,0
995,15187,q36eiA77bwwsXGg05ifhgnTFDpR9Ar4V,7GRhBDsirIGkRZBtSMEzNTyDr2JQm4xx,33,50,9,40,15,7,3,0,124,17.714285714285715,1,0.0,26,9,31,15,24,7,9,3,0,81,43,0
996,15240,9PiJFDewOyLmHT48JZWbbQ236haTndT7,7GRhBDsirIGkRZBtSMEzNTyDr2JQm4xx,17,30,14,10,5,0,5,0,64,9.142857142857142,2,0.0,10,14,8,5,20,0,2,5,0,37,27,1
997,15242,CYwEz0VhssUEnyi7GLISc2cCNlhTg5eu,7GRhBDsirIGkRZBtSMEzNTyDr2JQm4xx,26,45,2,56,6,0,5,0,114,16.285714285714285,2,0.0,19,2,46,6,26,0,10,5,0,73,41,1
998,15296,S0OJjF6aof0iTnIX6lUAxekoH3m4w7V0,7GRhBDsirIGkRZBtSMEzNTyDr2JQm4xx,37,63,26,40,22,8,12,0,171,24.428571428571427,7,0.0,27,26,36,22,36,8,4,12,0,111,60,0
999,15361,CrwYq2YvOe70PhTOuriN4QumcrUjBJDI,7GRhBDsirIGkRZBtSMEzNTyDr2JQm4xx,24,52,9,48,2,6,9,0,126,18.0,2,0.0,39,9,36,2,13,6,12,9,0,86,40,0
1000,15367,nnTxxp3z9fcrPPkS4kzYDi6mu4P5bdue,7GRhBDsirIGkRZBtSMEzNTyDr2JQm4xx,6,11,4,0,0,0,4,0,19,2.7142857142857144,3,0.0,0,4,0,0,11,0,0,4,0,4,15,0
1001,15373,sDcc9eMBMovhbCv3mcSbRYupViyMpSXg,5X6FeZozNMgE2VRi3MJYjkkFK8SETtu2,1,0,0,0,0,0,2,0,2,0.2857142857142857,1,0.0,0,0,0,0,0,0,0,2,0,0,2,1
1002,15393,MtAV4nOSlZRilJebONQfKIwpW2brA3ei,5X6FeZozNMgE2VRi3MJYjkkFK8SETtu2,42,235,78,8,18,4,39,1,383,54.714285714285715,14,0.0,88,78,6,18,147,4,2,39,1,190,193,0
1003,15436,OURivxGQBNOdhRVXNUy5pKGguC3x3JGV,7GRhBDsirIGkRZBtSMEzNTyDr2JQm4xx,22,23,11,0,8,1,9,0,52,7.428571428571429,2,0.0,0,11,0,8,23,1,0,9,0,19,33,0
1004,15602,kJJIE2h2w0vYBZNbvF8G6P5lWhPX9ZyA,5X6FeZozNMgE2VRi3MJYjkkFK8SETtu2,35,62,22,62,21,0,12,0,179,25.571428571428573,6,0.0,30,22,56,21,32,0,6,12,0,129,50,1
1005,15633,FjbDR3UaxcNBkb6IH3GDQCUcWtWdh8Qq,5X6FeZozNMgE2VRi3MJYjkkFK8SETtu2,57,72,23,183,15,1,8,0,302,43.142857142857146,5,0.0,36,23,151,15,36,1,32,8,0,225,77,1
1006,15655,jtxvuHBV8ZOgNnNCL1A1WerzR2TVfFNy,5X6FeZozNMgE2VRi3MJYjkkFK8SETtu2,56,54,17,81,3,0,9,0,164,23.428571428571427,4,0.0,29,17,80,3,25,0,1,9,0,129,35,1
1007,15713,UQMPqDnQtELOyig8xWMMs5ktcYwtyCzh,7GRhBDsirIGkRZBtSMEzNTyDr2JQm4xx,28,26,15,0,11,0,3,0,55,7.857142857142857,2,0.0,2,15,0,11,24,0,0,3,0,28,27,0
1008,15730,DTunSgXKeBHwLChUNl9RWnBhBvCOB1OP,5X6FeZozNMgE2VRi3MJYjkkFK8SETtu2,2,0,0,0,0,0,2,0,2,0.2857142857142857,1,0.0,0,0,0,0,0,0,0,2,0,0,2,1
1009,15771,HbdIEiZ1jslj2pBp8czn7lhBbxLYjtpj,7GRhBDsirIGkRZBtSMEzNTyDr2JQm4xx,70,82,27,92,12,0,5,0,218,31.142857142857142,3,0.0,50,27,92,12,32,0,0,5,0,181,37,0
1010,15804,eA8qPXDg9mAIRhOgZfPGHskw4HtvZE6Q,5X6FeZozNMgE2VRi3MJYjkkFK8SETtu2,7,6,2,0,1,0,3,0,12,1.7142857142857142,2,0.0,0,2,0,1,6,0,0,3,0,3,9,1
1011,15809,dSje9mLQSmkfjnddVAmZbSZcEblgwLyE,5X6FeZozNMgE2VRi3MJYjkkFK8SETtu2,7,6,3,0,1,0,8,0,18,2.5714285714285716,3,0.0,0,3,0,1,6,0,0,8,0,4,14,1
1012,15810,WJLMraoon9e2y7OtDk9UrQjU4oqkoa0t,7GRhBDsirIGkRZBtSMEzNTyDr2JQm4xx,20,43,23,6,3,26,11,6,118,16.857142857142858,5,0.0,8,23,3,3,35,26,3,11,6,37,81,0
1013,15814,g7u6ac7DR9jMW4aOouB4W8Gur81b4cDe,7GRhBDsirIGkRZBtSMEzNTyDr2JQm4xx,11,7,5,0,4,0,3,0,19,2.7142857142857144,2,0.0,1,5,0,4,6,0,0,3,0,10,9,0
1014,15892,MgS6WK9esRya9QyP2ZOjbNdLSIL7NuM9,5X6FeZozNMgE2VRi3MJYjkkFK8SETtu2,30,19,5,60,1,0,4,2,91,13.0,1,0.0,13,5,50,1,6,0,10,4,2,69,22,1
1015,15894,CFcaqGvFyaIYHoQBSZafTygNmgOBr9If,5X6FeZozNMgE2VRi3MJYjkkFK8SETtu2,51,69,22,71,26,0,12,0,200,28.571428571428573,6,0.0,36,22,56,26,33,0,15,12,0,140,60,0
1016,15900,MvkVXPKImqjQobZ7zCJXq4GfQ4IthLq9,7GRhBDsirIGkRZBtSMEzNTyDr2JQm4xx,27,42,10,18,12,0,9,0,91,13.0,4,0.0,14,10,18,12,28,0,0,9,0,54,37,0
1017,15912,hJo1MgKiPZFXuH2ko6hqPTd9dbjMQKDO,7GRhBDsirIGkRZBtSMEzNTyDr2JQm4xx,61,92,42,110,40,3,16,0,303,43.285714285714285,4,0.0,43,42,97,40,49,3,13,16,0,222,81,1
1018,15919,oho8eUx0qt2QgQUM9H4Puo64w9V5nVUl,7GRhBDsirIGkRZBtSMEzNTyDr2JQm4xx,46,72,25,32,27,5,8,0,169,24.142857142857142,4,0.0,39,25,28,27,33,5,4,8,0,119,50,1
1019,15922,OHdLWfOkVYVSxh9avWbeG6oGLyuN9vvx,7GRhBDsirIGkRZBtSMEzNTyDr2JQm4xx,20,46,13,30,11,3,2,0,105,15.0,1,0.0,24,13,27,11,22,3,3,2,0,75,30,1
1020,15933,T8EEyGWGKbnympgZPqbMUH0q1ogy6HvR,5X6FeZozNMgE2VRi3MJYjkkFK8SETtu2,2,0,0,0,0,0,2,0,2,0.2857142857142857,2,0.0,0,0,0,0,0,0,0,2,0,0,2,1
1021,15956,wg7c1wZNHnWuQEzOFg3X7UO4UvdvZ0Nl,7GRhBDsirIGkRZBtSMEzNTyDr2JQm4xx,20,16,6,46,3,0,2,0,73,10.428571428571429,1,0.0,5,6,39,3,11,0,7,2,0,53,20,1
1022,15959,KD5stEhIDxW0wB7Mr1YVPQQ5AGRkzqAA,7GRhBDsirIGkRZBtSMEzNTyDr2JQm4xx,19,24,11,8,11,0,4,0,58,8.285714285714286,3,0.0,9,11,6,11,15,0,2,4,0,37,21,1
1023,15966,dWGIj0UEkV1WxMBYGHRsdtDhUsNSq5LC,7GRhBDsirIGkRZBtSMEzNTyDr2JQm4xx,9,9,6,0,4,0,1,0,20,2.857142857142857,1,0.0,2,6,0,4,7,0,0,1,0,12,8,0
1024,15982,yUo0f8mA9XEAtzr6kcSUh5ydpzcuIcml,7GRhBDsirIGkRZBtSMEzNTyDr2JQm4xx,5,7,0,0,0,0,1,0,8,1.1428571428571428,1,0.0,1,0,0,0,6,0,0,1,0,1,7,1
1025,16038,NoaJNfAZAESYC7salsh3Qwaa5hC3sdBk,7GRhBDsirIGkRZBtSMEzNTyDr2JQm4xx,30,61,35,80,3,53,8,1,241,34.42857142857143,3,0.0,18,35,63,3,43,53,17,8,1,119,122,0
1026,16087,SIdEQEXoagJ5WwAcAkPtkVF6pipatiIa,7GRhBDsirIGkRZBtSMEzNTyDr2JQm4xx,28,49,13,6,15,0,4,0,87,12.428571428571429,2,0.0,12,13,5,15,37,0,1,4,0,45,42,0
1027,16130,nPRsjektHdbQkeAf1fIK4JbhrESPbPsA,5X6FeZozNMgE2VRi3MJYjkkFK8SETtu2,1,0,0,0,0,0,1,0,1,0.14285714285714285,1,0.0,0,0,0,0,0,0,0,1,0,0,1,0
1028,16131,cwM32Iyo8DmzSk0EybXLo5ksFWhXG4Da,7GRhBDsirIGkRZBtSMEzNTyDr2JQm4xx,28,53,16,4,19,0,4,0,96,13.714285714285714,3,0.0,31,16,3,19,22,0,1,4,0,69,27,0
1029,16238,4NRUo07WkcrdRLUhlPTipY45aaERRn99,7GRhBDsirIGkRZBtSMEzNTyDr2JQm4xx,27,48,10,14,33,0,3,0,108,15.428571428571429,6,0.0,16,10,7,33,32,0,7,3,0,66,42,0
1030,16378,RjbxXw1YYmiUcedHIl1VrXvYXiS6wbOC,7GRhBDsirIGkRZBtSMEzNTyDr2JQm4xx,60,95,1,149,16,8,12,4,285,40.714285714285715,2,0.0,62,1,130,16,33,8,19,12,4,209,76,0
1031,16415,096xYyhB9kL7G6lT7J9rVrXyGNwUToLF,7GRhBDsirIGkRZBtSMEzNTyDr2JQm4xx,18,33,1,0,0,0,4,0,38,5.428571428571429,2,0.0,14,1,0,0,19,0,0,4,0,15,23,0
1032,16460,KDzfaWgTSBqeMJLFLmFuh4CMLsva9aWu,7GRhBDsirIGkRZBtSMEzNTyDr2JQm4xx,37,52,4,12,13,0,3,0,84,12.0,2,0.0,22,4,9,13,30,0,3,3,0,48,36,0
1033,16484,v1iavhjAgOftyRIIBT7pVhYkpNdcTDpm,7GRhBDsirIGkRZBtSMEzNTyDr2JQm4xx,1,0,0,0,0,0,1,0,1,0.14285714285714285,1,0.0,0,0,0,0,0,0,0,1,0,0,1,1
1034,16541,tDBUBIMhJEJx4Pe5n9oY4eK5G81QRmVq,7GRhBDsirIGkRZBtSMEzNTyDr2JQm4xx,40,67,42,36,45,0,3,0,193,27.571428571428573,5,0.0,21,42,34,45,46,0,2,3,0,142,51,0
1035,16559,WbPhqfwmFYggW432ooC1iHmgUJBCP9Le,7GRhBDsirIGkRZBtSMEzNTyDr2JQm4xx,55,145,60,45,58,22,26,5,361,51.57142857142857,5,0.0,73,60,37,58,72,22,8,26,5,228,133,0
1036,16632,uPNpQwnvEtjDufLcIcScg8qVljQjes1y,7GRhBDsirIGkRZBtSMEzNTyDr2JQm4xx,13,33,1,15,3,0,6,0,58,8.285714285714286,2,0.0,22,1,15,3,11,0,0,6,0,41,17,1
1037,16685,0OpVcmwG6bVPxKzOCpgJ9F6MfBtuGolr,5X6FeZozNMgE2VRi3MJYjkkFK8SETtu2,10,5,4,0,3,0,4,0,16,2.2857142857142856,2,0.0,0,4,0,3,5,0,0,4,0,7,9,1
1038,16696,EshSTNSaPVDLcPEwlm2e07DrZJhzPNHK,7GRhBDsirIGkRZBtSMEzNTyDr2JQm4xx,66,139,59,98,56,7,15,0,374,53.42857142857143,4,0.0,67,59,79,56,72,7,19,15,0,261,113,0
1039,16717,zwtc7XYkGr4Bhsl8UEIZlPO0o9lpzfSZ,5X6FeZozNMgE2VRi3MJYjkkFK8SETtu2,143,188,41,338,63,4,19,0,653,93.28571428571429,10,0.0,123,41,287,63,65,4,51,19,0,514,139,0
1040,16828,FhnsJdRTpIANrPfAv3Fv2vn7QGHPfOsl,7GRhBDsirIGkRZBtSMEzNTyDr2JQm4xx,2,0,0,0,0,0,5,0,5,0.7142857142857143,1,0.0,0,0,0,0,0,0,0,5,0,0,5,0
1041,16873,t8qBiDTvOvYmrxcVIErRuEOf38tywm6t,5X6FeZozNMgE2VRi3MJYjkkFK8SETtu2,41,73,32,64,19,7,15,0,210,30.0,8,0.0,27,32,50,19,46,7,14,15,0,128,82,1
1042,16923,oSfAVLTcGEmcT7y7OMQrYnvkkm78yh0P,7GRhBDsirIGkRZBtSMEzNTyDr2JQm4xx,15,22,9,10,9,2,3,0,55,7.857142857142857,2,0.0,10,9,8,9,12,2,2,3,0,36,19,1
1043,16984,9lksmcPg7FQE2FGQIA9VvWum1Z9DYrHM,5X6FeZozNMgE2VRi3MJYjkkFK8SETtu2,17,23,5,12,6,9,16,1,72,10.285714285714286,4,0.0,11,5,12,6,12,9,0,16,1,34,38,1
1044,17028,HF98YPKzT8oi2j9flZW9kstZcvL3ZimG,7GRhBDsirIGkRZBtSMEzNTyDr2JQm4xx,5,6,3,0,0,0,1,0,10,1.4285714285714286,2,0.0,0,3,0,0,6,0,0,1,0,3,7,0
1045,17049,4i80ssNqIa74pSBDzjYYryTbL6MBe9I9,7GRhBDsirIGkRZBtSMEzNTyDr2JQm4xx,8,12,3,0,4,0,7,0,26,3.7142857142857144,1,0.0,8,3,0,4,4,0,0,7,0,15,11,1
1046,17055,CxUPOQRaQMGLmbOcfniIQOhh24PXLDR6,7GRhBDsirIGkRZBtSMEzNTyDr2JQm4xx,2,10,6,0,0,0,0,0,16,2.2857142857142856,7,0.0,0,6,0,0,10,0,0,0,0,6,10,0
1047,17087,f6TXZbfciBHE4LWM7x8lXiScOGpqV9US,5X6FeZozNMgE2VRi3MJYjkkFK8SETtu2,1,0,0,0,0,0,1,0,1,0.14285714285714285,1,0.0,0,0,0,0,0,0,0,1,0,0,1,1
1048,17104,oxYTAYYaR98reRev5BqLPii4AFJGZbGZ,7GRhBDsirIGkRZBtSMEzNTyDr2JQm4xx,20,43,2,44,9,0,2,0,100,14.285714285714286,2,0.0,27,2,40,9,16,0,4,2,0,78,22,1
1049,17126,jRi5kMZL8gw9VtNxiN9NAzyTyPmFUqYw,5X6FeZozNMgE2VRi3MJYjkkFK8SETtu2,7,3,2,0,2,1,12,4,24,3.4285714285714284,1,0.0,0,2,0,2,3,1,0,12,4,4,20,1
1050,17134,gtKTzkXHwS41ljYVmjlLLf4WyQSkK02q,5X6FeZozNMgE2VRi3MJYjkkFK8SETtu2,19,47,20,26,1,1,10,1,106,15.142857142857142,5,0.0,19,20,21,1,28,1,5,10,1,61,45,0
1051,17164,VJIMgDIUwiPJWjSYlLErL1YmuU1Np82d,5X6FeZozNMgE2VRi3MJYjkkFK8SETtu2,6,5,2,0,1,2,4,0,14,2.0,1,0.0,1,2,0,1,4,2,0,4,0,4,10,1
1052,17196,uqIn0vdfJ1SDJCOeCVEAQPRFBBKQA2eB,5X6FeZozNMgE2VRi3MJYjkkFK8SETtu2,8,12,6,0,1,0,8,0,27,3.857142857142857,3,0.0,0,6,0,1,12,0,0,8,0,7,20,1
1053,17301,cEMxPdpNr0sg7WlHPqAdbLiWdfHH1ZVi,5X6FeZozNMgE2VRi3MJYjkkFK8SETtu2,22,52,14,12,13,3,14,0,108,15.428571428571429,4,0.0,16,14,12,13,36,3,0,14,0,55,53,0
1054,17303,yhSGXw7EnYX7J3WWxRb9piBAfJaOtRLJ,7GRhBDsirIGkRZBtSMEzNTyDr2JQm4xx,34,33,13,32,16,0,1,0,95,13.571428571428571,1,0.0,19,13,30,16,14,0,2,1,0,78,17,1
1055,17332,Dy53HBwqZRiUys0tuL4RoOSu6jKEN99b,7GRhBDsirIGkRZBtSMEzNTyDr2JQm4xx,29,46,1,34,5,4,14,1,105,15.0,4,0.0,19,1,28,5,27,4,6,14,1,53,52,0
1056,17337,Jm4nQ05ndX10jbofbWx6S0r9VXrqia6S,5X6FeZozNMgE2VRi3MJYjkkFK8SETtu2,27,37,18,55,8,0,7,0,125,17.857142857142858,5,0.0,13,18,44,8,24,0,11,7,0,83,42,0
1057,17344,WrpEjmHODRDkmfpIc4iwJ23Oo8WNkTBQ,5X6FeZozNMgE2VRi3MJYjkkFK8SETtu2,6,9,4,0,3,2,4,0,22,3.142857142857143,2,0.0,2,4,0,3,7,2,0,4,0,9,13,1
1058,17388,QRh7ApSBJNbSH61R3OkAQmXanxVzZM0F,7GRhBDsirIGkRZBtSMEzNTyDr2JQm4xx,7,6,5,0,2,0,1,0,14,2.0,1,0.0,0,5,0,2,6,0,0,1,0,7,7,0
1059,17404,XDng1mliVGDk6IontbBqBdoGZnODrUp1,5X6FeZozNMgE2VRi3MJYjkkFK8SETtu2,6,2,0,0,0,1,10,4,17,2.4285714285714284,3,0.0,0,0,0,0,2,1,0,10,4,0,17,1
1060,17429,YxbZAJS4qgRwnWhCIRD2nIZdnFSzg6u2,5X6FeZozNMgE2VRi3MJYjkkFK8SETtu2,5,2,1,0,1,0,3,0,7,1.0,2,0.0,0,1,0,1,2,0,0,3,0,2,5,1
1061,17510,riM9GkB0ajSqpIPlVq4tRzOjk7wJ6NHE,7GRhBDsirIGkRZBtSMEzNTyDr2JQm4xx,24,62,30,40,25,0,13,0,170,24.285714285714285,2,0.0,27,30,34,25,35,0,6,13,0,116,54,0
1062,17586,TwDUv8vbemLEqdAHMCXeJ0dOJyZMBx6V,7GRhBDsirIGkRZBtSMEzNTyDr2JQm4xx,5,4,2,0,0,0,3,0,9,1.2857142857142858,2,0.0,0,2,0,0,4,0,0,3,0,2,7,0
1063,17597,dxt9lWTWbhPZn9mT70zVSi49oFElvqw6,7GRhBDsirIGkRZBtSMEzNTyDr2JQm4xx,10,10,1,6,3,0,0,0,20,2.857142857142857,1,0.0,6,1,3,3,4,0,3,0,0,13,7,1
1064,17608,3vhCoT2dzeVdCpmcedhNzxK4VNLZ2l0r,5X6FeZozNMgE2VRi3MJYjkkFK8SETtu2,2,0,0,0,0,0,4,0,4,0.5714285714285714,2,0.0,0,0,0,0,0,0,0,4,0,0,4,1
1065,17620,5HX4czL6Sp8ee3UX2kWAHqmFW5CMMTjE,7GRhBDsirIGkRZBtSMEzNTyDr2JQm4xx,4,12,6,0,0,0,4,0,22,3.142857142857143,1,0.0,0,6,0,0,12,0,0,4,0,6,16,0
1066,17659,12sfc8OjIBcmkTHeaayvh8umY2ATBMOw,5X6FeZozNMgE2VRi3MJYjkkFK8SETtu2,8,5,3,0,1,0,6,0,15,2.142857142857143,2,0.0,0,3,0,1,5,0,0,6,0,4,11,1
1067,17660,UaSh8dwx8gnofYbXlmpqj9uYDbpJ89pX,7GRhBDsirIGkRZBtSMEzNTyDr2JQm4xx,5,5,0,0,0,0,1,0,6,0.8571428571428571,1,0.0,0,0,0,0,5,0,0,1,0,0,6,0
1068,17707,8hNQWXBoItm3CRzdk0wSJDwYSfUbhUCO,7GRhBDsirIGkRZBtSMEzNTyDr2JQm4xx,6,7,3,0,4,2,1,0,17,2.4285714285714284,1,0.0,3,3,0,4,4,2,0,1,0,10,7,1
1069,17754,jpXIq3stqWScWG27acYJbNKpdTmc6kli,3VkHkmOtom3jM2wCu94xgzzu1d6Dn7or,71,285,115,69,87,76,103,0,735,105.0,21,0.0,122,115,67,87,163,76,2,103,0,391,344,0
1070,17787,LhnkyJkR9hozRi5eOf0ZASlpRXuZDre9,3VkHkmOtom3jM2wCu94xgzzu1d6Dn7or,1,0,0,0,0,0,1,0,1,0.14285714285714285,1,0.0,0,0,0,0,0,0,0,1,0,0,1,1
1071,17823,FsCZ2JlPdTOKccvkXXkGRkEo9MNtfR49,3VkHkmOtom3jM2wCu94xgzzu1d6Dn7or,50,61,49,0,52,0,2,0,164,23.428571428571427,13,0.0,2,49,0,52,59,0,0,2,0,103,61,0
1072,17853,Cx9AvhpaoGF7JJ71AI7APeANc2Vipt9I,3VkHkmOtom3jM2wCu94xgzzu1d6Dn7or,54,205,95,0,60,0,21,0,381,54.42857142857143,13,0.0,7,95,0,60,198,0,0,21,0,162,219,0
1073,17876,Rs4pfmJlaHiSs2fYG1vucMoIlgnMNq35,3VkHkmOtom3jM2wCu94xgzzu1d6Dn7or,82,242,122,70,78,18,41,4,575,82.14285714285714,12,0.0,79,122,63,78,163,18,7,41,4,342,233,1
1074,17887,v6sJocXlJFeoDG1nXrmoTeUih19304GZ,3VkHkmOtom3jM2wCu94xgzzu1d6Dn7or,63,218,118,47,80,32,27,3,525,75.0,16,0.0,58,118,40,80,160,32,7,27,3,296,229,0
1075,17897,PYa4cvEoYgJqptqnFduMFw6qOph7rV1S,3VkHkmOtom3jM2wCu94xgzzu1d6Dn7or,5,4,0,0,1,0,2,0,7,1.0,1,0.0,0,0,0,1,4,0,0,2,0,1,6,1
1076,17928,bvMut7mm0xiNcIyWj0y5IqntcnEKiS1J,3VkHkmOtom3jM2wCu94xgzzu1d6Dn7or,1,0,0,0,0,0,1,0,1,0.14285714285714285,1,0.0,0,0,0,0,0,0,0,1,0,0,1,1
1077,17935,JZ8D07WpMQUIA2O2a3f2Q2gV7h70rqbC,3VkHkmOtom3jM2wCu94xgzzu1d6Dn7or,33,57,17,25,21,13,14,5,152,21.714285714285715,6,0.0,31,17,25,21,26,13,0,14,5,94,58,0
1078,18009,UEfxjgGbCSErczHqdTpEK7y3ob5jn4Gk,3VkHkmOtom3jM2wCu94xgzzu1d6Dn7or,1,0,0,0,0,0,1,0,1,0.14285714285714285,1,0.0,0,0,0,0,0,0,0,1,0,0,1,1
1079,18039,NHPpKvbnrSpxM8e1DORBWJbRCpmrxZw8,3VkHkmOtom3jM2wCu94xgzzu1d6Dn7or,98,368,169,79,72,306,122,7,1123,160.42857142857142,25,0.0,124,169,75,72,244,306,4,122,7,440,683,0
1080,18056,OjOCFzFYMRhmN0dKAwMid2Xaqedb9Byb,3VkHkmOtom3jM2wCu94xgzzu1d6Dn7or,25,21,13,0,10,0,4,0,48,6.857142857142857,3,0.0,0,13,0,10,21,0,0,4,0,23,25,0
1081,18076,d9MkkuCn04Toz7g1JpLdUJWD9xM5braA,3VkHkmOtom3jM2wCu94xgzzu1d6Dn7or,95,435,140,94,134,73,76,3,955,136.42857142857142,20,0.0,209,140,88,134,226,73,6,76,3,571,384,0
1082,18094,tRpWIQFUfZGZNpEuAzKRkssWyAFqJTs5,3VkHkmOtom3jM2wCu94xgzzu1d6Dn7or,68,129,75,24,52,16,40,1,337,48.142857142857146,13,0.0,27,75,24,52,102,16,0,40,1,178,159,0
1083,18115,DdzZ8hxB7LD572mJ80Q8pStHyEce3G8N,3VkHkmOtom3jM2wCu94xgzzu1d6Dn7or,1,0,0,0,0,0,1,0,1,0.14285714285714285,1,0.0,0,0,0,0,0,0,0,1,0,0,1,1
1084,18135,lar47ou1ATEHV2YH4cOI3oy3IuxgsIhT,3VkHkmOtom3jM2wCu94xgzzu1d6Dn7or,16,24,10,15,3,1,2,0,55,7.857142857142857,2,0.0,7,10,15,3,17,1,0,2,0,35,20,1
1085,18143,nrxFiXWjMUWPNdzxTgBy5GRAtL700fYA,3VkHkmOtom3jM2wCu94xgzzu1d6Dn7or,86,276,99,62,51,28,141,0,657,93.85714285714286,25,0.0,109,99,58,51,167,28,4,141,0,317,340,0
1086,18169,oagcmeHMGRWan9rRULVfHrzxIgyIwGhI,3VkHkmOtom3jM2wCu94xgzzu1d6Dn7or,35,60,22,38,22,23,20,8,193,27.571428571428573,5,0.0,34,22,28,22,26,23,10,20,8,106,87,1
1087,18192,aoJgXkaEB6ghw3VtYYCS6SC6JCyweCx9,3VkHkmOtom3jM2wCu94xgzzu1d6Dn7or,65,145,60,55,26,4,16,0,306,43.714285714285715,6,0.0,31,60,54,26,114,4,1,16,0,171,135,1
1088,18205,mgkR734CuGPwkjZusiDKIEITlUrFqk0v,3VkHkmOtom3jM2wCu94xgzzu1d6Dn7or,6,8,5,0,3,1,7,0,24,3.4285714285714284,3,0.0,0,5,0,3,8,1,0,7,0,8,16,1
1089,18212,uGhfznzXOPt7LKNhqHKFI7ETQMarwh4W,3VkHkmOtom3jM2wCu94xgzzu1d6Dn7or,32,85,39,45,22,43,16,4,254,36.285714285714285,6,0.0,32,39,38,22,53,43,7,16,4,131,123,0
1090,18214,fBUstayd9IBoQWzWS7yo0s9kWc5pQmPM,3VkHkmOtom3jM2wCu94xgzzu1d6Dn7or,1,0,0,0,0,0,1,0,1,0.14285714285714285,1,0.0,0,0,0,0,0,0,0,1,0,0,1,1
1091,18220,j5XgrOAxRxENrCOne236prVqUgGjIY7N,3VkHkmOtom3jM2wCu94xgzzu1d6Dn7or,73,143,64,48,52,12,50,5,374,53.42857142857143,8,0.0,55,64,43,52,88,12,5,50,5,214,160,0
1092,18231,w79oIXxJA51xRJ7RWNha0P7ISQqedK5M,3VkHkmOtom3jM2wCu94xgzzu1d6Dn7or,54,77,39,0,29,0,20,0,165,23.571428571428573,9,0.0,6,39,0,29,71,0,0,20,0,74,91,1
1093,18240,OKzPg2IoKpUrxLcbcmTCXAiAOnBotolX,3VkHkmOtom3jM2wCu94xgzzu1d6Dn7or,65,296,64,70,72,115,47,0,664,94.85714285714286,13,0.0,124,64,62,72,172,115,8,47,0,322,342,0
1094,18270,s0mBlRwUxx5kP9aOdegyh1ySJrjQirTH,3VkHkmOtom3jM2wCu94xgzzu1d6Dn7or,30,62,22,14,25,3,2,0,128,18.285714285714285,3,0.0,35,22,12,25,27,3,2,2,0,94,34,1
1095,18289,7w9CunRH9hyQPA1xx2b3RiIHMXEv8N1y,3VkHkmOtom3jM2wCu94xgzzu1d6Dn7or,5,4,1,0,1,0,2,0,8,1.1428571428571428,1,0.0,1,1,0,1,3,0,0,2,0,3,5,1
1096,18310,cuXvmIw1hv6FEoYwQfwDU7O59pSpyB17,3VkHkmOtom3jM2wCu94xgzzu1d6Dn7or,11,22,11,0,0,0,2,0,35,5.0,3,0.0,2,11,0,0,20,0,0,2,0,13,22,1
1097,18382,fwORcHM9hBLMMJD62wvWtWoKD86AwAls,3VkHkmOtom3jM2wCu94xgzzu1d6Dn7or,81,199,56,33,66,3,25,1,383,54.714285714285715,13,0.0,106,56,32,66,93,3,1,25,1,260,123,0
1098,18413,2UIdqPRKpgTkXkubY12P5suWz65Jis6l,3VkHkmOtom3jM2wCu94xgzzu1d6Dn7or,54,214,84,97,0,103,38,9,545,77.85714285714286,18,0.0,105,84,94,0,109,103,3,38,9,283,262,0
1099,18416,s1ZG3pi1BtIXGlTEtKkgdFf84oYE79H2,3VkHkmOtom3jM2wCu94xgzzu1d6Dn7or,2,0,0,0,0,0,4,0,4,0.5714285714285714,1,0.0,0,0,0,0,0,0,0,4,0,0,4,1
1100,18418,WSRqaiZltcPtf2Ni0Fz3XVfyHdHabSkZ,3VkHkmOtom3jM2wCu94xgzzu1d6Dn7or,8,5,3,0,2,0,4,0,14,2.0,2,0.0,0,3,0,2,5,0,0,4,0,5,9,1
1101,18437,fshVdX7gogS9amjUUfvMRuuVgkpjuXnx,3VkHkmOtom3jM2wCu94xgzzu1d6Dn7or,9,10,3,0,0,0,13,2,28,4.0,2,0.0,0,3,0,0,10,0,0,13,2,3,25,1
1102,18440,aA2T9FUjPC32yfraIt7WIwEwoZxlGYcd,3VkHkmOtom3jM2wCu94xgzzu1d6Dn7or,7,13,1,0,0,0,3,0,17,2.4285714285714284,1,0.0,0,1,0,0,13,0,0,3,0,1,16,1
1103,18449,lIdwZfZp6F2QvlXA6VMlrlG2EDx3wbA6,3VkHkmOtom3jM2wCu94xgzzu1d6Dn7or,1,0,0,0,0,0,1,0,1,0.14285714285714285,1,0.0,0,0,0,0,0,0,0,1,0,0,1,1
1104,18467,JFydRlh3r5b6TgtatAKjLqxhaGea1l2v,3VkHkmOtom3jM2wCu94xgzzu1d6Dn7or,61,143,40,30,38,34,24,10,319,45.57142857142857,11,0.0,81,40,30,38,62,34,0,24,10,189,130,1
1105,18475,m9cr9bC1ceLP6JRtqXmb61EDIFHQCdkt,3VkHkmOtom3jM2wCu94xgzzu1d6Dn7or,1,0,0,0,0,0,1,0,1,0.14285714285714285,1,0.0,0,0,0,0,0,0,0,1,0,0,1,1
1106,18476,XtUtchk5ogUiIURmIZQdHpNh2PWn3RnP,3VkHkmOtom3jM2wCu94xgzzu1d6Dn7or,7,7,5,0,2,3,3,0,20,2.857142857142857,1,0.0,0,5,0,2,7,3,0,3,0,7,13,1
1107,18489,IKnWhfStgn6HzF4rCtxpMA6vaE95bkoN,3VkHkmOtom3jM2wCu94xgzzu1d6Dn7or,84,201,81,63,74,44,21,9,493,70.42857142857143,9,0.0,98,81,56,74,103,44,7,21,9,309,184,0
1108,18495,ztJdAnCpBgEgLx5fhRggF88Y3Pxlvyek,3VkHkmOtom3jM2wCu94xgzzu1d6Dn7or,1,0,0,0,0,0,1,0,1,0.14285714285714285,1,0.0,0,0,0,0,0,0,0,1,0,0,1,1
1109,18524,p6hc44NeJi1WiSZUn5CvpCCXiZFi44WN,3VkHkmOtom3jM2wCu94xgzzu1d6Dn7or,5,9,2,0,3,2,5,0,21,3.0,2,0.0,6,2,0,3,3,2,0,5,0,11,10,0
1110,18538,5cBPq51N9I9AzXHlHIBSLnKPdUzCIUfc,3VkHkmOtom3jM2wCu94xgzzu1d6Dn7or,5,3,2,0,2,0,2,0,9,1.2857142857142858,1,0.0,0,2,0,2,3,0,0,2,0,4,5,1
1111,18564,hRh2Y2Uw5YLe8i2fkEP0Vgw7w0oqTBB3,3VkHkmOtom3jM2wCu94xgzzu1d6Dn7or,17,18,10,0,7,0,9,0,44,6.285714285714286,6,0.0,0,10,0,7,18,0,0,9,0,17,27,0
1112,18575,EJPF6XlYz9cFyfNK7rmmfSFxHr2AsPXh,3VkHkmOtom3jM2wCu94xgzzu1d6Dn7or,10,14,4,0,1,3,8,3,33,4.714285714285714,2,0.0,6,4,0,1,8,3,0,8,3,11,22,1
1113,18576,x9eE2t1pkeexbvLs88HZIiFp0JGQqsVU,3VkHkmOtom3jM2wCu94xgzzu1d6Dn7or,53,78,45,6,33,83,26,2,273,39.0,7,0.0,21,45,3,33,57,83,3,26,2,102,171,0
1114,18603,87SYGQjFYUtEWda0pG12bcNker0JGBy3,3VkHkmOtom3jM2wCu94xgzzu1d6Dn7or,59,156,27,34,40,34,29,1,321,45.857142857142854,11,0.0,78,27,33,40,78,34,1,29,1,178,143,1
1115,18606,UMhqMBvNkRDXsJUWPwy4GcSQoSlGBO8t,3VkHkmOtom3jM2wCu94xgzzu1d6Dn7or,9,13,8,0,6,0,9,1,37,5.285714285714286,2,0.0,2,8,0,6,11,0,0,9,1,16,21,0
1116,18622,RnOkMifE6IabhEJlmNQOUk0wV82RqPXX,3VkHkmOtom3jM2wCu94xgzzu1d6Dn7or,18,38,14,6,9,10,10,1,88,12.571428571428571,6,0.0,15,14,6,9,23,10,0,10,1,44,44,1
1117,18647,vgENoZ7IMNHQOATqRlfRe4wFSridKoir,3VkHkmOtom3jM2wCu94xgzzu1d6Dn7or,21,26,12,18,7,9,14,1,87,12.428571428571429,5,0.0,6,12,15,7,20,9,3,14,1,40,47,1
1118,18668,knDHPR8YfOkLpXHV6I75VqEUj60nQPXN,3VkHkmOtom3jM2wCu94xgzzu1d6Dn7or,5,2,1,0,1,0,2,0,6,0.8571428571428571,1,0.0,0,1,0,1,2,0,0,2,0,2,4,1
1119,18695,gBHaHbn79faxGc3HZ5WWWEq0qMpof2nV,3VkHkmOtom3jM2wCu94xgzzu1d6Dn7or,10,22,9,0,4,4,24,1,64,9.142857142857142,4,0.0,7,9,0,4,15,4,0,24,1,20,44,1
1120,18734,JfQVgXDVu1NGs9lcRBOD4w6V7BSaZCc2,3VkHkmOtom3jM2wCu94xgzzu1d6Dn7or,81,204,63,49,74,77,42,1,510,72.85714285714286,7,0.0,114,63,47,74,90,77,2,42,1,298,212,0
1121,18762,5b9C3riGM9XWa3qjobB2XvMXtZIZEhOi,3VkHkmOtom3jM2wCu94xgzzu1d6Dn7or,9,15,8,2,7,0,3,0,35,5.0,2,0.0,4,8,2,7,11,0,0,3,0,21,14,1
1122,18854,PFJhF2sNLYftHHb21pjL43RM5viviTlT,3VkHkmOtom3jM2wCu94xgzzu1d6Dn7or,96,206,67,91,71,40,21,0,496,70.85714285714286,17,0.0,113,67,78,71,93,40,13,21,0,329,167,0
1123,18894,P2xHl8oxJOV4TMoYrxym6L2dPSAdMMJs,3VkHkmOtom3jM2wCu94xgzzu1d6Dn7or,97,300,98,47,105,99,91,9,749,107.0,21,0.0,84,98,43,105,216,99,4,91,9,330,419,0
1124,18920,SvayS3hRjiQUsZJZ3Z80XuRW7pnvNCGH,3VkHkmOtom3jM2wCu94xgzzu1d6Dn7or,2,0,0,0,0,0,5,0,5,0.7142857142857143,2,0.0,0,0,0,0,0,0,0,5,0,0,5,1
1125,18936,O0GD5bq4HX44FjCMV4VF4e6soOzsH9jU,3VkHkmOtom3jM2wCu94xgzzu1d6Dn7or,42,45,20,0,22,1,6,0,94,13.428571428571429,2,0.0,23,20,0,22,22,1,0,6,0,65,29,0
1126,18949,LAYouz4itNZzvPmshvKiqSMh0zjmZcQO,3VkHkmOtom3jM2wCu94xgzzu1d6Dn7or,1,0,0,0,0,0,1,0,1,0.14285714285714285,1,0.0,0,0,0,0,0,0,0,1,0,0,1,1
1127,18964,mUI8TGZDkA6o3xg0ZzjcBPw1a3PiNc4S,3VkHkmOtom3jM2wCu94xgzzu1d6Dn7or,32,49,34,0,17,3,13,1,117,16.714285714285715,7,0.0,0,34,0,17,49,3,0,13,1,51,66,1
1128,19021,NW8TWIfI5QyCDlKS0XzM26mCFAnY0gAl,3VkHkmOtom3jM2wCu94xgzzu1d6Dn7or,62,202,37,98,86,16,17,1,457,65.28571428571429,6,0.0,150,37,87,86,52,16,11,17,1,360,97,0
1129,19029,w1HLpf01ff60tSyrkRwOPpdSlz3uqa1C,3VkHkmOtom3jM2wCu94xgzzu1d6Dn7or,83,290,100,87,60,55,90,7,689,98.42857142857143,15,0.0,72,100,80,60,218,55,7,90,7,312,377,0
1130,19034,3dNtOnVHtGbnIgpNEyiNdWuRrG9P1yCf,3VkHkmOtom3jM2wCu94xgzzu1d6Dn7or,1,0,0,0,0,0,1,0,1,0.14285714285714285,1,0.0,0,0,0,0,0,0,0,1,0,0,1,1
1131,19091,LHYSNVzTYxm5IcNgKgLIwIeMHKVsmlIb,3VkHkmOtom3jM2wCu94xgzzu1d6Dn7or,9,4,3,0,3,0,7,0,17,2.4285714285714284,1,0.0,0,3,0,3,4,0,0,7,0,6,11,1
1132,19094,DN3ijWfAAWPn1I6Iktij5lvXWwKiG3wC,3VkHkmOtom3jM2wCu94xgzzu1d6Dn7or,11,10,8,0,8,0,2,0,28,4.0,2,0.0,0,8,0,8,10,0,0,2,0,16,12,1
1133,19097,WK0Fgs86cA55qEjGdACCPsAyup9yYjBW,3VkHkmOtom3jM2wCu94xgzzu1d6Dn7or,32,51,30,0,22,0,7,0,110,15.714285714285714,7,0.0,2,30,0,22,49,0,0,7,0,54,56,1
1134,19107,FW47VC0lzmys2S4k8Ky52JrXCSFDeyeP,3VkHkmOtom3jM2wCu94xgzzu1d6Dn7or,73,128,46,32,54,31,26,4,321,45.857142857142854,8,0.0,69,46,29,54,59,31,3,26,4,198,123,1
1135,19145,keNewYvbzg2eq90KcSOtX7Zs6BZix0S4,3VkHkmOtom3jM2wCu94xgzzu1d6Dn7or,29,27,17,0,11,0,7,0,62,8.857142857142858,5,0.0,0,17,0,11,27,0,0,7,0,28,34,1
1136,19168,zawgO73Gsv9yYg2M5PPEY7ml7DGDBXeG,3VkHkmOtom3jM2wCu94xgzzu1d6Dn7or,79,205,42,86,89,3,17,0,442,63.142857142857146,10,0.0,147,42,82,89,58,3,4,17,0,360,82,0
1137,19172,uTiNrDEvARQcGfWGjFfdSPVTMmffLSmO,3VkHkmOtom3jM2wCu94xgzzu1d6Dn7or,5,2,1,0,1,0,3,0,7,1.0,2,0.0,0,1,0,1,2,0,0,3,0,2,5,1
1138,19180,iMUfXfktcNKkoRB8LhQL6ubljgtzU5l7,3VkHkmOtom3jM2wCu94xgzzu1d6Dn7or,41,59,29,18,26,5,10,1,148,21.142857142857142,5,0.0,23,29,18,26,36,5,0,10,1,96,52,0
1139,19189,i0UAMwrjj2eXydsjRtQeHBmAMB3Ngwx3,3VkHkmOtom3jM2wCu94xgzzu1d6Dn7or,93,403,96,116,70,56,40,10,791,113.0,19,0.0,142,96,108,70,261,56,8,40,10,416,375,0
1140,19275,wKSiPD3ccCI47tDYWhx56Wd2BJP8ki2L,3VkHkmOtom3jM2wCu94xgzzu1d6Dn7or,64,212,85,60,54,61,29,9,510,72.85714285714286,12,0.0,61,85,58,54,151,61,2,29,9,258,252,0
1141,19306,VeyQb2wjeKBwS5o1xUeVWgY5Rkx9xBBK,3VkHkmOtom3jM2wCu94xgzzu1d6Dn7or,1,0,0,0,0,0,2,0,2,0.2857142857142857,1,0.0,0,0,0,0,0,0,0,2,0,0,2,1
1142,19308,KXJnaxosaVPcYuL44D7XWQrAPgd4UcKI,3VkHkmOtom3jM2wCu94xgzzu1d6Dn7or,1,0,0,0,0,0,1,0,1,0.14285714285714285,1,0.0,0,0,0,0,0,0,0,1,0,0,1,1
1143,19311,g5MFP90eHpeTFJhybJGejVaFL9uzOmxA,3VkHkmOtom3jM2wCu94xgzzu1d6Dn7or,10,15,0,12,3,0,2,0,32,4.571428571428571,1,0.0,6,0,12,3,9,0,0,2,0,21,11,1
1144,19326,oDANnbslKtpJTEtMR0SEpxqs6e5prqji,3VkHkmOtom3jM2wCu94xgzzu1d6Dn7or,1,0,0,0,0,0,1,0,1,0.14285714285714285,1,0.0,0,0,0,0,0,0,0,1,0,0,1,1
1145,19332,MNCx7q5SQrMnv8bXtByddRfIhVZZxjUi,3VkHkmOtom3jM2wCu94xgzzu1d6Dn7or,22,90,11,8,1,10,20,0,140,20.0,9,0.0,14,11,7,1,76,10,1,20,0,33,107,0
1146,19335,6hTHLv2ACZhw5sTOpdEFsUQMXrnQn22A,3VkHkmOtom3jM2wCu94xgzzu1d6Dn7or,61,159,47,39,48,20,38,0,351,50.142857142857146,19,0.0,50,47,36,48,109,20,3,38,0,181,170,0
1147,19336,FxmtjLZTfKrDuIUJj9RfT2CnreuIYYsu,3VkHkmOtom3jM2wCu94xgzzu1d6Dn7or,8,7,4,0,2,25,6,1,45,6.428571428571429,3,0.0,0,4,0,2,7,25,0,6,1,6,39,1
1148,19358,JOddnojV0OZrysgzYsnxzhRLS1r6GCxl,3VkHkmOtom3jM2wCu94xgzzu1d6Dn7or,55,85,41,0,25,3,23,0,177,25.285714285714285,18,0.0,8,41,0,25,77,3,0,23,0,74,103,0
1149,19393,VDLlgOqW7FFpT6uHqFXXlnnZR1JOz0x8,3VkHkmOtom3jM2wCu94xgzzu1d6Dn7or,5,3,2,0,2,0,2,0,9,1.2857142857142858,2,0.0,0,2,0,2,3,0,0,2,0,4,5,1
1150,19395,vPZXChPcICCkmHJapo4eBCyfswBI2wT1,3VkHkmOtom3jM2wCu94xgzzu1d6Dn7or,6,2,1,0,1,0,3,0,7,1.0,1,0.0,0,1,0,1,2,0,0,3,0,2,5,1
1151,19410,oSXgzDEY9r915L5ut60Q5zxaEaVixNX9,3VkHkmOtom3jM2wCu94xgzzu1d6Dn7or,90,164,82,55,38,61,37,1,438,62.57142857142857,23,0.0,51,82,47,38,113,61,8,37,1,218,220,0
1152,19415,Gb5o1t4cOlCs6CgHMjwZyTBBHE9KEmzH,3VkHkmOtom3jM2wCu94xgzzu1d6Dn7or,77,92,51,83,39,2,10,4,281,40.142857142857146,6,0.0,35,51,66,39,57,2,17,10,4,191,90,0
1153,19420,DeBpDi71FBvOLpvPeVZCUQOI7dk3TqCp,3VkHkmOtom3jM2wCu94xgzzu1d6Dn7or,3,8,2,0,0,0,1,0,11,1.5714285714285714,1,0.0,3,2,0,0,5,0,0,1,0,5,6,1
1154,19432,itwm4TVODOBqFpKY29D8QUWf1nvyYrio,3VkHkmOtom3jM2wCu94xgzzu1d6Dn7or,79,212,67,67,66,5,33,0,450,64.28571428571429,7,0.0,94,67,60,66,118,5,7,33,0,287,163,0
1155,19440,5VHsEf8JXNm7KJFeH5RI83NlCJ748PxF,3VkHkmOtom3jM2wCu94xgzzu1d6Dn7or,19,28,4,7,4,0,3,0,46,6.571428571428571,2,0.0,10,4,7,4,18,0,0,3,0,25,21,1
1156,19588,EFioWHTkYv074j9vSFY7qmw2MvFzZ0mo,fbPkOYLVPtPgIt0MxizjfFJov3JbHyAi,14,25,10,6,8,0,2,0,51,7.285714285714286,2,0.0,13,10,4,8,12,0,2,2,0,35,16,0
1157,19591,I91CCtQfetYUPwkEXIvTFBP6tbrp1spN,fbPkOYLVPtPgIt0MxizjfFJov3JbHyAi,5,3,2,0,1,0,2,0,8,1.1428571428571428,2,0.0,0,2,0,1,3,0,0,2,0,3,5,0
1158,19598,rUHwInfwrT2VCsoj7SngGENcoxIrK2aA,fbPkOYLVPtPgIt0MxizjfFJov3JbHyAi,12,22,7,3,6,0,3,0,41,5.857142857142857,1,0.0,11,7,3,6,11,0,0,3,0,27,14,1
1159,19621,P7cWTzqHbKs2w7IhW7Eb0IWuvmS7VHHm,fbPkOYLVPtPgIt0MxizjfFJov3JbHyAi,42,97,35,39,32,35,10,0,248,35.42857142857143,3,0.0,55,35,37,32,42,35,2,10,0,159,89,0
1160,19629,G0JgmTQ55TeK9aeblJVq6TYQNTXqJFIQ,fbPkOYLVPtPgIt0MxizjfFJov3JbHyAi,7,11,6,6,2,0,1,0,26,3.7142857142857144,2,0.0,1,6,5,2,10,0,1,1,0,14,12,1
1161,19646,ggEr2STKTwtSSUdtGCmiPr3DBu3TJ34B,fbPkOYLVPtPgIt0MxizjfFJov3JbHyAi,4,5,2,0,0,3,3,0,13,1.8571428571428572,2,0.0,0,2,0,0,5,3,0,3,0,2,11,1
1162,19698,vTwbvGW3E1IdqF0HV32uMMc0gGolPCvf,fbPkOYLVPtPgIt0MxizjfFJov3JbHyAi,7,4,3,0,2,0,1,0,10,1.4285714285714286,1,0.0,0,3,0,2,4,0,0,1,0,5,5,1
1163,19705,nbIGolByJC5FPssjDvcKL2vGL3vYMGAq,fbPkOYLVPtPgIt0MxizjfFJov3JbHyAi,23,54,19,35,17,0,1,0,126,18.0,2,0.0,27,19,31,17,27,0,4,1,0,94,32,0
1164,19713,IxqtjkNiph0SiGkmwfaH729SQtK50jPu,fbPkOYLVPtPgIt0MxizjfFJov3JbHyAi,11,14,1,0,1,4,7,0,27,3.857142857142857,1,0.0,0,1,0,1,14,4,0,7,0,2,25,1
1165,19714,uuyAyzBNPZJSqNkYTwX3ItAQ7Xcq5lqK,fbPkOYLVPtPgIt0MxizjfFJov3JbHyAi,7,4,3,0,2,0,1,0,10,1.4285714285714286,1,0.0,0,3,0,2,4,0,0,1,0,5,5,1
1166,19719,gl2YVlebVAvCcxsYaIoTwLj5l1IGqntH,fbPkOYLVPtPgIt0MxizjfFJov3JbHyAi,1,0,0,0,0,0,1,0,1,0.14285714285714285,1,0.0,0,0,0,0,0,0,0,1,0,0,1,1
1167,19723,jWMVSdUkBIApMFEIB4X88BTUfxnffWAx,fbPkOYLVPtPgIt0MxizjfFJov3JbHyAi,30,46,25,11,25,16,6,0,129,18.428571428571427,2,0.0,14,25,8,25,32,16,3,6,0,72,57,1
1168,19730,nIvIddlMAmTQagaACOulbZ6PInxlyOy2,fbPkOYLVPtPgIt0MxizjfFJov3JbHyAi,6,6,4,0,1,6,3,0,20,2.857142857142857,2,0.0,0,4,0,1,6,6,0,3,0,5,15,0
1169,19742,c2xUxg7vuhPItQZr96ojei2FNm4xg1X0,fbPkOYLVPtPgIt0MxizjfFJov3JbHyAi,4,4,2,0,0,2,1,0,9,1.2857142857142858,1,0.0,0,2,0,0,4,2,0,1,0,2,7,1
1170,19788,gfuRBmlPKlXNn3u69OCkIXEsqvf1vpRo,fbPkOYLVPtPgIt0MxizjfFJov3JbHyAi,9,8,8,0,8,0,0,0,24,3.4285714285714284,2,0.0,0,8,0,8,8,0,0,0,0,16,8,1
1171,19804,WRgbGIz2wotOKHxhxfqrZ7xS0r15aDGp,fbPkOYLVPtPgIt0MxizjfFJov3JbHyAi,3,1,1,0,1,0,0,0,3,0.42857142857142855,1,0.0,0,1,0,1,1,0,0,0,0,2,1,1
1172,19809,pApGdDVXhze4S6UmutYTLmYS4Jr9ACYb,fbPkOYLVPtPgIt0MxizjfFJov3JbHyAi,5,3,1,0,1,0,1,0,6,0.8571428571428571,1,0.0,0,1,0,1,3,0,0,1,0,2,4,1
1173,19828,35U2BNXuS9D65uTVA2fa3pi1wj26AmH8,fbPkOYLVPtPgIt0MxizjfFJov3JbHyAi,14,17,10,9,4,11,0,0,51,7.285714285714286,2,0.0,6,10,7,4,11,11,2,0,0,27,24,1
1174,19829,XQUx3MwVudtjeHmsju8PhHxsdXW0kluK,fbPkOYLVPtPgIt0MxizjfFJov3JbHyAi,4,2,1,0,0,0,2,0,5,0.7142857142857143,1,0.0,0,1,0,0,2,0,0,2,0,1,4,1
1175,19842,bKIU4h5S6pxVBBvQYicGGZljVmGThQTZ,fbPkOYLVPtPgIt0MxizjfFJov3JbHyAi,8,18,7,0,2,0,1,0,28,4.0,2,0.0,0,7,0,2,18,0,0,1,0,9,19,1
1176,19866,BOBLP6pTmRtpQ8LtVgJyutFMDL3q6xno,fbPkOYLVPtPgIt0MxizjfFJov3JbHyAi,14,23,16,2,11,0,2,0,54,7.714285714285714,4,0.0,5,16,2,11,18,0,0,2,0,34,20,0
1177,19871,vuIldWG0zIZiagbsArdWgNONid3wMi26,fbPkOYLVPtPgIt0MxizjfFJov3JbHyAi,5,4,0,0,1,0,0,0,5,0.7142857142857143,1,0.0,0,0,0,1,4,0,0,0,0,1,4,0
1178,19876,ig6krYSkue3MO5KtEMkAXakLUYviTHgU,fbPkOYLVPtPgIt0MxizjfFJov3JbHyAi,4,2,1,0,0,1,5,0,9,1.2857142857142858,1,0.0,0,1,0,0,2,1,0,5,0,1,8,1
1179,19893,NAeglY8cYFpzQKpSfjAgfrtdD2qzmpB5,fbPkOYLVPtPgIt0MxizjfFJov3JbHyAi,22,35,9,0,7,2,10,0,63,9.0,5,0.0,0,9,0,7,35,2,0,10,0,16,47,0
1180,19897,xdXdQD6d3ouQxPFQHtUqoRivYIjaf4BI,fbPkOYLVPtPgIt0MxizjfFJov3JbHyAi,6,11,3,0,2,1,4,0,21,3.0,2,0.0,4,3,0,2,7,1,0,4,0,9,12,1
1181,19928,97ov4fTuLcUGM3NRcbowYBsVQSUEYP2S,fbPkOYLVPtPgIt0MxizjfFJov3JbHyAi,2,0,0,0,0,0,2,0,2,0.2857142857142857,1,0.0,0,0,0,0,0,0,0,2,0,0,2,1
1182,19932,G2qWD1bGIYovTM2Y7RxiPiKf92aFGc9X,fbPkOYLVPtPgIt0MxizjfFJov3JbHyAi,4,11,7,0,0,5,4,0,27,3.857142857142857,1,0.0,0,7,0,0,11,5,0,4,0,7,20,1
1183,19933,wnXrCFQnu5K77E0TUKHPXLbEZiXu32Gt,fbPkOYLVPtPgIt0MxizjfFJov3JbHyAi,50,53,31,42,18,10,9,4,167,23.857142857142858,2,0.0,15,31,39,18,38,10,3,9,4,103,64,1
1184,19935,wEajQeQse5CzhcFd5XXOtEsUUddZZAU5,fbPkOYLVPtPgIt0MxizjfFJov3JbHyAi,8,13,4,4,3,0,2,0,26,3.7142857142857144,1,0.0,7,4,3,3,6,0,1,2,0,17,9,0
1185,19936,viuKt4GgrX0rYL5EpHoxJbsiC9TblSuk,fbPkOYLVPtPgIt0MxizjfFJov3JbHyAi,5,3,2,0,1,0,2,0,8,1.1428571428571428,1,0.0,0,2,0,1,3,0,0,2,0,3,5,0
1186,19939,7uDVcwukNss0paMtTOJXNPZUXWP9vYuG,fbPkOYLVPtPgIt0MxizjfFJov3JbHyAi,6,6,3,0,1,0,4,0,14,2.0,2,0.0,1,3,0,1,5,0,0,4,0,5,9,1
1187,19949,lulY8D00ct0beDGYE4CRU9KsINnQRaV8,fbPkOYLVPtPgIt0MxizjfFJov3JbHyAi,2,2,1,0,0,0,0,0,3,0.42857142857142855,1,0.0,0,1,0,0,2,0,0,0,0,1,2,0
1188,19955,Y7REnesylqzkGeCcXJqxiJ4B25LlDJnj,fbPkOYLVPtPgIt0MxizjfFJov3JbHyAi,7,6,3,0,2,0,1,0,12,1.7142857142857142,1,0.0,2,3,0,2,4,0,0,1,0,7,5,1
1189,20045,E9MhL5j6EEbGw96uDNwSlEIItUx4QLbq,5Gyp41oLVo7Gg7vF4vpmggWP5MU70QO6,3,3,1,0,0,0,2,0,6,0.8571428571428571,1,0.0,0,1,0,0,3,0,0,2,0,1,5,1
1190,20047,9KW86bF2a8wFmh5J9Lgj6m9lvxGd3Fit,5Gyp41oLVo7Gg7vF4vpmggWP5MU70QO6,4,5,1,0,1,0,2,0,9,1.2857142857142858,2,0.0,0,1,0,1,5,0,0,2,0,2,7,1
1191,20050,6wqQQU6gadL03cIVBtw9j6qVgAZqgFIb,5Gyp41oLVo7Gg7vF4vpmggWP5MU70QO6,5,2,0,0,1,3,2,1,9,1.2857142857142858,1,0.0,0,0,0,1,2,3,0,2,1,1,8,1
1192,20052,H6jZionHr3YO42h6C5yeJWFXGReOpPax,5Gyp41oLVo7Gg7vF4vpmggWP5MU70QO6,8,7,3,2,2,0,1,0,15,2.142857142857143,1,0.0,3,3,1,2,4,0,1,1,0,9,6,1
1193,20054,n9LedJO4KNI3qkoMffxQUCkea0pp4KEu,5Gyp41oLVo7Gg7vF4vpmggWP5MU70QO6,23,58,32,21,12,72,24,3,222,31.714285714285715,3,0.0,13,32,14,12,45,72,7,24,3,71,151,1
1194,20058,glPDR5bdnwYTrc7hgG9ULJKpN3nFLGE0,5Gyp41oLVo7Gg7vF4vpmggWP5MU70QO6,15,18,7,6,8,36,6,1,82,11.714285714285714,1,0.0,8,7,4,8,10,36,2,6,1,27,55,1
1195,20060,zeydZlwGQCxDpstjdEq0NvjUsbpOzoxV,5Gyp41oLVo7Gg7vF4vpmggWP5MU70QO6,19,30,18,17,7,0,7,0,79,11.285714285714286,4,0.0,5,18,11,7,25,0,6,7,0,41,38,1
1196,20062,NhuYdPluEkXTEViyaWYrXRod2NyBRGbN,5Gyp41oLVo7Gg7vF4vpmggWP5MU70QO6,20,46,23,20,8,10,29,20,156,22.285714285714285,6,0.0,9,23,12,8,37,10,8,29,20,52,104,0
1197,20066,jqFOiqbIY6C65IovHqkpdBOJQW013YOC,5Gyp41oLVo7Gg7vF4vpmggWP5MU70QO6,68,244,106,72,60,19,35,2,538,76.85714285714286,9,0.0,108,106,57,60,136,19,15,35,2,331,207,0
1198,20070,WTsp1mZz5EDw1He0xKdOvtBGTKevohcm,5Gyp41oLVo7Gg7vF4vpmggWP5MU70QO6,35,98,45,30,10,325,42,4,554,79.14285714285714,8,0.0,34,45,24,10,64,325,6,42,4,113,441,0
1199,20072,2ThHarEubS0c8gep0BeOFf7xxheqMWnH,5Gyp41oLVo7Gg7vF4vpmggWP5MU70QO6,6,4,3,0,3,0,1,0,11,1.5714285714285714,1,0.0,0,3,0,3,4,0,0,1,0,6,5,1
1200,20077,u0SrW65Zdf0RG2PPgt52qf6MWWYZDmbZ,5Gyp41oLVo7Gg7vF4vpmggWP5MU70QO6,24,30,16,0,15,0,10,0,71,10.142857142857142,6,0.0,6,16,0,15,24,0,0,10,0,37,34,1
1201,20090,ttDgrsiryXoKaT4z5CduzwSDltfHA5Tp,5Gyp41oLVo7Gg7vF4vpmggWP5MU70QO6,40,84,48,26,25,8,36,2,229,32.714285714285715,10,0.0,16,48,20,25,68,8,6,36,2,109,120,1
1202,20093,0rTzX8GTA6AO1xZbOJCS52qGTu8sNNgu,5Gyp41oLVo7Gg7vF4vpmggWP5MU70QO6,29,68,30,19,16,56,18,1,208,29.714285714285715,9,0.0,24,30,13,16,44,56,6,18,1,83,125,0
1203,20096,FuoUpz3CIn6IWgPZcXNRWeCZpBo5bqY6,5Gyp41oLVo7Gg7vF4vpmggWP5MU70QO6,17,43,19,31,0,15,4,0,112,16.0,3,0.0,19,19,23,0,24,15,8,4,0,61,51,0
1204,20109,NXWbrhgwPkB8Vmhv89AlGPamswmxk6M5,5Gyp41oLVo7Gg7vF4vpmggWP5MU70QO6,19,28,14,28,5,5,7,0,87,12.428571428571429,4,0.0,9,14,21,5,19,5,7,7,0,49,38,1
1205,20110,ABbPtVE9vR3q9TnGdVr0jhQS05eL9aJw,5Gyp41oLVo7Gg7vF4vpmggWP5MU70QO6,46,75,53,5,23,12,26,1,195,27.857142857142858,8,0.0,6,53,3,23,69,12,2,26,1,85,110,0
1206,20111,Cs0gFHwyaGk2h4OmFyQ67vt8HPC12M1J,5Gyp41oLVo7Gg7vF4vpmggWP5MU70QO6,1,0,0,0,0,0,1,0,1,0.14285714285714285,1,0.0,0,0,0,0,0,0,0,1,0,0,1,1
1207,20113,m10MnR6QWHgJDgjQEm80sVb0dV6pgu2c,5Gyp41oLVo7Gg7vF4vpmggWP5MU70QO6,15,36,18,1,8,12,15,0,90,12.857142857142858,5,0.0,14,18,1,8,22,12,0,15,0,41,49,1
1208,20121,PLLwziP9q0JVMUdxss7Qy2U6TVcLBTA4,5Gyp41oLVo7Gg7vF4vpmggWP5MU70QO6,4,2,1,0,1,0,1,0,5,0.7142857142857143,1,0.0,0,1,0,1,2,0,0,1,0,2,3,1
1209,20125,JZ0cPuTVmC70maYF6NIorZr3bOTKKvsS,5Gyp41oLVo7Gg7vF4vpmggWP5MU70QO6,13,6,4,8,4,0,2,0,24,3.4285714285714284,1,0.0,2,4,5,4,4,0,3,2,0,15,9,1
1210,20126,rGhtBFyJ1i3JCXgagWhQLBoCku1ClaHD,5Gyp41oLVo7Gg7vF4vpmggWP5MU70QO6,10,9,3,4,2,3,4,1,26,3.7142857142857144,1,0.0,2,3,2,2,7,3,2,4,1,9,17,1
1211,20134,XKxu0UHgcJ5pVHhEtOgLZIsKoredZm21,5Gyp41oLVo7Gg7vF4vpmggWP5MU70QO6,32,32,27,0,17,0,11,0,87,12.428571428571429,3,0.0,0,27,0,17,32,0,0,11,0,44,43,1
1212,20138,Xe157JusuZ3tLSedhGrKKw6nHQceWUNE,5Gyp41oLVo7Gg7vF4vpmggWP5MU70QO6,12,14,8,4,2,0,7,0,35,5.0,5,0.0,4,8,2,2,10,0,2,7,0,16,19,1
1213,20140,a9FDBG85NydYrIgZaH9taLl0qSfEQnKr,5Gyp41oLVo7Gg7vF4vpmggWP5MU70QO6,51,172,81,27,42,40,41,0,403,57.57142857142857,14,0.0,55,81,22,42,117,40,5,41,0,200,203,0
1214,20145,2luV6bj304xCxkSajZrqthGBkjmNgJ7T,5Gyp41oLVo7Gg7vF4vpmggWP5MU70QO6,8,7,3,0,0,0,8,1,19,2.7142857142857144,1,0.0,0,3,0,0,7,0,0,8,1,3,16,1
1215,20151,12tfSRcVHU1LY6VYbYjnNdGrVUGUAhWB,5Gyp41oLVo7Gg7vF4vpmggWP5MU70QO6,44,125,54,70,3,3,48,2,305,43.57142857142857,9,0.0,47,54,53,3,78,3,17,48,2,157,148,0
1216,20152,5pjAdY5K4FfgQPLSzQKwXaKF78ph9a0y,5Gyp41oLVo7Gg7vF4vpmggWP5MU70QO6,7,7,3,0,2,0,2,0,14,2.0,2,0.0,0,3,0,2,7,0,0,2,0,5,9,1
1217,20162,8GMUs7oeRalA74SLd7wfRpddCGtQ5rmL,5Gyp41oLVo7Gg7vF4vpmggWP5MU70QO6,9,8,5,3,1,1,4,0,22,3.142857142857143,1,0.0,1,5,2,1,7,1,1,4,0,9,13,1
1218,20169,p3ufn8QcrZUwabpMSs5v5bV2VxuJbcrm,5Gyp41oLVo7Gg7vF4vpmggWP5MU70QO6,23,15,12,0,8,6,11,2,54,7.714285714285714,2,0.0,1,12,0,8,14,6,0,11,2,21,33,1
1219,20179,8NK3iaPYRi5tDjzHZVNIqLtQMUnR3yyG,5Gyp41oLVo7Gg7vF4vpmggWP5MU70QO6,1,0,0,0,0,0,1,0,1,0.14285714285714285,1,0.0,0,0,0,0,0,0,0,1,0,0,1,1
1220,20180,fpOYviCjfT1tZNuDdpNqrinz1621b7mL,5Gyp41oLVo7Gg7vF4vpmggWP5MU70QO6,12,11,7,0,4,3,15,2,42,6.0,2,0.0,0,7,0,4,11,3,0,15,2,11,31,1
1221,20428,0Tg2flbTUdD7fODqYIfpiJiK0IDdFiOP,3VkHkmOtom3jM2wCu94xgzzu1d6Dn7or,88,243,106,33,78,16,61,3,540,77.14285714285714,15,0.0,53,106,31,78,190,16,2,61,3,268,272,0
1222,20433,oE6DPh3f1KJ1QOJPSf6WuTGufFpaw4RL,3VkHkmOtom3jM2wCu94xgzzu1d6Dn7or,96,196,99,104,81,60,49,1,590,84.28571428571429,14,0.0,60,99,102,81,136,60,2,49,1,342,248,0
1223,20450,mFpiELMd2y5tbkdxs4m8pKS7gXHb7bIO,3VkHkmOtom3jM2wCu94xgzzu1d6Dn7or,8,12,3,5,6,0,2,0,28,4.0,2,0.0,8,3,5,6,4,0,0,2,0,22,6,1
1224,20460,fgqnjAQhSNo0zgtESNlcyk6k5zAbpclp,3VkHkmOtom3jM2wCu94xgzzu1d6Dn7or,66,190,68,94,64,10,44,8,478,68.28571428571429,16,0.0,69,68,87,64,121,10,7,44,8,288,190,0
1225,20467,dJfak1mtGaKcbsyIBZ4I9MHKmQ3nj02t,3VkHkmOtom3jM2wCu94xgzzu1d6Dn7or,15,24,9,0,1,0,6,0,40,5.714285714285714,2,0.0,2,9,0,1,22,0,0,6,0,12,28,0
1226,20469,7ZyJguBzL4oDvx3QuauBv2Vv3pHBPVh3,3VkHkmOtom3jM2wCu94xgzzu1d6Dn7or,9,29,5,6,7,7,12,2,68,9.714285714285714,1,0.0,19,5,5,7,10,7,1,12,2,36,32,0
1227,20484,kWet01DzGE5Z1z6FwJt5yEexIuvkBhsh,3VkHkmOtom3jM2wCu94xgzzu1d6Dn7or,73,109,11,42,56,4,18,1,241,34.42857142857143,4,0.0,43,11,41,56,66,4,1,18,1,151,90,0
1228,20509,51xlIGXGRsE7YMneHTw1mXYuaEFgELF3,5Gyp41oLVo7Gg7vF4vpmggWP5MU70QO6,4,4,2,0,1,0,2,0,9,1.2857142857142858,2,0.0,0,2,0,1,4,0,0,2,0,3,6,1
1229,20538,U7EtjqTqdWkMXU8jPYUzk64V0Mn9cfrB,5Gyp41oLVo7Gg7vF4vpmggWP5MU70QO6,15,60,28,11,10,17,23,1,150,21.428571428571427,7,0.0,7,28,6,10,53,17,5,23,1,51,99,0
1230,20546,GXlRC26Ko0I4QuqEBegfYjNMMHXqEAeI,5Gyp41oLVo7Gg7vF4vpmggWP5MU70QO6,2,0,0,0,0,0,3,0,3,0.42857142857142855,1,0.0,0,0,0,0,0,0,0,3,0,0,3,1
1231,20559,nYqIGil9UmfZ8C9e6NMYoAGcfo6Iw6tC,5Gyp41oLVo7Gg7vF4vpmggWP5MU70QO6,33,75,34,32,8,7,40,0,196,28.0,7,0.0,14,34,24,8,61,7,8,40,0,80,116,1
1232,20560,vCT5TWno1npWLslO7yYTAIaOZBV06mao,5Gyp41oLVo7Gg7vF4vpmggWP5MU70QO6,1,0,0,0,0,0,1,0,1,0.14285714285714285,1,0.0,0,0,0,0,0,0,0,1,0,0,1,1
1233,20586,mQjeD6hN9l04FxDxsU4KpCkNxpaYJUy8,5Gyp41oLVo7Gg7vF4vpmggWP5MU70QO6,23,62,35,18,10,62,18,2,207,29.571428571428573,5,0.0,17,35,9,10,45,62,9,18,2,71,136,0
1234,20659,21xHpbTt9IlCSENitiwjX4lHJpt77SM0,5Gyp41oLVo7Gg7vF4vpmggWP5MU70QO6,8,6,3,0,2,0,3,0,14,2.0,1,0.0,1,3,0,2,5,0,0,3,0,6,8,1
1235,20711,DKHkASaue21Ube0NCtRQv5RAIPQ6lG0B,5Gyp41oLVo7Gg7vF4vpmggWP5MU70QO6,1,0,0,0,0,0,1,0,1,0.14285714285714285,1,0.0,0,0,0,0,0,0,0,1,0,0,1,1
1236,20723,pXnPfAM8ms99bW53JuZdfy5kHRn0Gw3F,5Gyp41oLVo7Gg7vF4vpmggWP5MU70QO6,17,35,21,17,11,0,7,0,91,13.0,4,0.0,12,21,16,11,23,0,1,7,0,60,31,0
1237,20724,Tl0cUD0uaRNrptL4xz9FM8t9vDRkb8l2,5Gyp41oLVo7Gg7vF4vpmggWP5MU70QO6,8,6,2,2,1,0,5,0,16,2.2857142857142856,2,0.0,1,2,1,1,5,0,1,5,0,5,11,1
1238,20731,gpz5P4EnF16Nr0OcO2XnJV1T57UyUmj4,5Gyp41oLVo7Gg7vF4vpmggWP5MU70QO6,9,9,5,0,3,0,7,0,24,3.4285714285714284,4,0.0,1,5,0,3,8,0,0,7,0,9,15,0
1239,20764,1dxQmK9WwlHWuIG7ZTn4PsJ2vflQBDH3,5Gyp41oLVo7Gg7vF4vpmggWP5MU70QO6,43,90,46,21,25,37,31,1,251,35.857142857142854,14,0.0,21,46,15,25,69,37,6,31,1,107,144,0
1240,20767,YJcptsgRBvUQgvUGKpQGU1OPeMTESrpy,5Gyp41oLVo7Gg7vF4vpmggWP5MU70QO6,16,14,7,4,2,8,9,2,46,6.571428571428571,3,0.0,1,7,3,2,13,8,1,9,2,13,33,1
1241,20769,UvSRAfOynZWLLb7HhTXhSBS51EOIrExr,5Gyp41oLVo7Gg7vF4vpmggWP5MU70QO6,2,0,0,0,0,0,2,0,2,0.2857142857142857,1,0.0,0,0,0,0,0,0,0,2,0,0,2,1
1242,20773,ogurveh5dgwQ7omkU0IctcIseCFtiniL,5Gyp41oLVo7Gg7vF4vpmggWP5MU70QO6,13,26,11,11,8,1,3,0,60,8.571428571428571,2,0.0,12,11,6,8,14,1,5,3,0,37,23,1
1243,20776,7wDmO3V391mOKctQPBgeS1ILceV0cgzq,5Gyp41oLVo7Gg7vF4vpmggWP5MU70QO6,4,2,1,0,1,0,1,0,5,0.7142857142857143,1,0.0,0,1,0,1,2,0,0,1,0,2,3,1
1244,20796,51UrGO11oEt7DoFaWRLH7OdH7DSe85mH,5Gyp41oLVo7Gg7vF4vpmggWP5MU70QO6,7,3,2,0,2,0,2,0,9,1.2857142857142858,1,0.0,0,2,0,2,3,0,0,2,0,4,5,1
1245,20831,TzUoSJ3pyMjwCKLIHuVSKLad9h9hLr5U,5Gyp41oLVo7Gg7vF4vpmggWP5MU70QO6,54,98,49,34,28,0,21,0,230,32.857142857142854,13,0.0,27,49,27,28,71,0,7,21,0,131,99,0
1246,20838,IweRnM2AMTe7iVCwVnhk6LnMzajZZKLL,5Gyp41oLVo7Gg7vF4vpmggWP5MU70QO6,44,109,76,2,53,0,1,0,241,34.42857142857143,23,0.0,30,76,1,53,79,0,1,1,0,160,81,0
1247,20858,ANGPkqBejn3faj6KlS1vRWpMG1uR4DOb,5Gyp41oLVo7Gg7vF4vpmggWP5MU70QO6,1,0,0,0,0,0,2,0,2,0.2857142857142857,1,0.0,0,0,0,0,0,0,0,2,0,0,2,1
1248,20903,26uh3OFDkawJXE1lMs10AttJdYkXa36s,5Gyp41oLVo7Gg7vF4vpmggWP5MU70QO6,5,2,1,0,1,0,2,0,6,0.8571428571428571,1,0.0,0,1,0,1,2,0,0,2,0,2,4,1
1249,20908,lROQAiXdM7cGoWUW60LyDcyoBjMP9r3o,5Gyp41oLVo7Gg7vF4vpmggWP5MU70QO6,4,2,0,0,0,0,2,0,4,0.5714285714285714,1,0.0,0,0,0,0,2,0,0,2,0,0,4,0
1250,20918,0EjKvRTxPK4ozZ3L3wWm5nTPbXNczvrz,5Gyp41oLVo7Gg7vF4vpmggWP5MU70QO6,1,0,0,0,0,0,1,0,1,0.14285714285714285,1,0.0,0,0,0,0,0,0,0,1,0,0,1,1
1251,20921,evowo3Yg2sbVP9DdhhK3sw1dGIBBhaou,5Gyp41oLVo7Gg7vF4vpmggWP5MU70QO6,39,198,62,21,43,16,42,6,388,55.42857142857143,10,0.0,46,62,12,43,152,16,9,42,6,163,225,0
1252,20938,yMZU4V5TrrHcMWV44L1puCcwo6hPZFxD,5Gyp41oLVo7Gg7vF4vpmggWP5MU70QO6,5,3,1,0,1,0,3,0,8,1.1428571428571428,2,0.0,0,1,0,1,3,0,0,3,0,2,6,0
1253,20963,iyCT8McW9jtPFTdP663jcMhqs1NPgq1J,5Gyp41oLVo7Gg7vF4vpmggWP5MU70QO6,8,5,3,0,2,0,3,0,13,1.8571428571428572,2,0.0,0,3,0,2,5,0,0,3,0,5,8,1
1254,20985,hMmMWG2mCSPmBVJCfg0hTnXWgrWTXDtT,5Gyp41oLVo7Gg7vF4vpmggWP5MU70QO6,44,66,36,31,23,17,19,5,197,28.142857142857142,8,0.0,15,36,21,23,51,17,10,19,5,95,102,0
1255,20990,sT5kGTmMwotrgA4QrrYAzIJ6RZbnZCaK,5Gyp41oLVo7Gg7vF4vpmggWP5MU70QO6,41,135,60,31,25,18,34,1,304,43.42857142857143,8,0.0,50,60,22,25,85,18,9,34,1,157,147,0
1256,20992,UuK4SgZkmPrFxeH0ZPCRQ63pVXUSe96N,5Gyp41oLVo7Gg7vF4vpmggWP5MU70QO6,2,0,0,0,0,0,4,0,4,0.5714285714285714,3,0.0,0,0,0,0,0,0,0,4,0,0,4,1
1257,20999,28R6iGKChcTZe4wfYq3cZyHjYc957tJu,5Gyp41oLVo7Gg7vF4vpmggWP5MU70QO6,34,70,13,19,25,3,14,3,147,21.0,9,0.0,24,13,13,25,46,3,6,14,3,75,72,1
1258,21015,faupOzOQrYnrhUP3CZcXERH5hL8Q3xd2,5Gyp41oLVo7Gg7vF4vpmggWP5MU70QO6,13,22,12,4,5,6,8,0,57,8.142857142857142,5,0.0,2,12,3,5,20,6,1,8,0,22,35,0
1259,21041,amvjX9kh04RcngZb0v489RHBECZoZJN4,5Gyp41oLVo7Gg7vF4vpmggWP5MU70QO6,7,3,2,0,2,0,2,0,9,1.2857142857142858,1,0.0,0,2,0,2,3,0,0,2,0,4,5,1
1260,21043,EYpj7D3bfN6f1CyEX9whEB1qrBw0LMTz,5Gyp41oLVo7Gg7vF4vpmggWP5MU70QO6,7,6,1,2,0,0,4,0,13,1.8571428571428572,2,0.0,1,1,1,0,5,0,1,4,0,3,10,1
1261,21044,O8WpIn8YZlC9fwaPz6HgwkG3VYK9Pnk2,5Gyp41oLVo7Gg7vF4vpmggWP5MU70QO6,1,0,0,0,0,0,1,0,1,0.14285714285714285,1,0.0,0,0,0,0,0,0,0,1,0,0,1,1
1262,21072,0B7Lg7kBiHggKw9Wk7X0Ew4GVuXGGcvN,5Gyp41oLVo7Gg7vF4vpmggWP5MU70QO6,41,52,39,0,26,5,12,0,134,19.142857142857142,3,0.0,1,39,0,26,51,5,0,12,0,66,68,0
1263,21077,8qZ9lGKM03veKCgxfF78AoJnOHCggeil,5Gyp41oLVo7Gg7vF4vpmggWP5MU70QO6,7,3,2,0,2,0,5,0,12,1.7142857142857142,2,0.0,0,2,0,2,3,0,0,5,0,4,8,1
1264,21116,IXpBNvNyAVnPKtJ6Cz72QOA3m4e9Nil9,5Gyp41oLVo7Gg7vF4vpmggWP5MU70QO6,35,46,24,34,8,7,28,0,147,21.0,7,0.0,18,24,25,8,28,7,9,28,0,75,72,1
1265,21140,1srWC81yOUCAiYINElj2QhPEgKzNg58N,5Gyp41oLVo7Gg7vF4vpmggWP5MU70QO6,1,0,0,0,0,0,1,0,1,0.14285714285714285,1,0.0,0,0,0,0,0,0,0,1,0,0,1,1
1266,21169,2VA4csxIMQCx8OPT1JNIuyOwjieGR5SH,5Gyp41oLVo7Gg7vF4vpmggWP5MU70QO6,17,28,11,2,3,3,14,1,62,8.857142857142858,2,0.0,7,11,1,3,21,3,1,14,1,22,40,0
1267,21174,2jQmSZ0Z3BRjurnjzXdja964kW30vIAB,5Gyp41oLVo7Gg7vF4vpmggWP5MU70QO6,22,40,14,22,6,5,15,1,103,14.714285714285714,4,0.0,8,14,16,6,32,5,6,15,1,44,59,0
1268,21190,fOfAvgjoMJaTnjmbbLT9l8oPlz2vuSSr,5Gyp41oLVo7Gg7vF4vpmggWP5MU70QO6,22,69,37,7,15,0,16,0,144,20.571428571428573,7,0.0,10,37,5,15,59,0,2,16,0,67,77,0
1269,21209,FvdPuMrK3zMhYy78N5suTn8yvFPgw8yC,5Gyp41oLVo7Gg7vF4vpmggWP5MU70QO6,28,85,44,28,13,12,23,5,210,30.0,8,0.0,19,44,21,13,66,12,7,23,5,97,113,0
1270,21240,WWULZRuZ3Saytj4k2VnRR35CKpUbULPd,5Gyp41oLVo7Gg7vF4vpmggWP5MU70QO6,10,9,6,0,3,0,17,12,47,6.714285714285714,5,0.0,0,6,0,3,9,0,0,17,12,9,38,0
1271,21290,9LvgV591BX9GhV6hwDHWjRo6mXxb5lb9,5Gyp41oLVo7Gg7vF4vpmggWP5MU70QO6,13,25,11,4,3,8,12,2,65,9.285714285714286,3,0.0,2,11,4,3,23,8,0,12,2,20,45,1
1272,21314,fkbxkXpN20umRnEu1JAMVCW41OYjb7dl,5Gyp41oLVo7Gg7vF4vpmggWP5MU70QO6,18,34,15,8,5,4,15,2,83,11.857142857142858,2,0.0,10,15,4,5,24,4,4,15,2,34,49,0
1273,21316,NRvPF6FnE2qOoEKQlwRiAGDiz3Y2mfqX,5Gyp41oLVo7Gg7vF4vpmggWP5MU70QO6,7,2,1,0,1,3,7,1,15,2.142857142857143,2,0.0,0,1,0,1,2,3,0,7,1,2,13,0
1274,21322,IZwgoYiQOwzeEoIsJbmj0ULJBVLQ8tDo,5Gyp41oLVo7Gg7vF4vpmggWP5MU70QO6,5,2,1,0,1,0,2,0,6,0.8571428571428571,1,0.0,0,1,0,1,2,0,0,2,0,2,4,1
1275,21459,NH0hsgo5xcqAdosarQoW4RQUZxH32Gzl,7GRhBDsirIGkRZBtSMEzNTyDr2JQm4xx,72,174,59,84,53,0,16,0,386,55.142857142857146,7,0.0,64,59,77,53,110,0,7,16,0,253,133,0
1276,21468,Hj6wuu6IJzCenxWAs1sLyWNMm32YIpDq,7GRhBDsirIGkRZBtSMEzNTyDr2JQm4xx,38,126,42,36,34,11,14,0,263,37.57142857142857,5,0.0,63,42,27,34,63,11,9,14,0,166,97,0
1277,21473,fd2e5NJVnyVwHFHuiTOOM639ZY1uThtn,7GRhBDsirIGkRZBtSMEzNTyDr2JQm4xx,26,45,16,26,12,0,4,0,103,14.714285714285714,4,0.0,20,16,21,12,25,0,5,4,0,69,34,1
1278,21482,lHDkxc2iXUHUUn5UnDpMsfQNxnS3B8Lp,7GRhBDsirIGkRZBtSMEzNTyDr2JQm4xx,41,80,31,34,31,22,8,0,206,29.428571428571427,4,0.0,45,31,18,31,35,22,16,8,0,125,81,0
1279,21485,l3mz2aAslwaCLhkdMrM7sQ5OXLzl6A2r,7GRhBDsirIGkRZBtSMEzNTyDr2JQm4xx,41,90,4,104,18,17,7,1,241,34.42857142857143,6,0.0,48,4,86,18,42,17,18,7,1,156,85,0
1280,21486,6ysaEs6vstKtLjiClow0f4E5UhF658OT,7GRhBDsirIGkRZBtSMEzNTyDr2JQm4xx,7,4,2,0,2,0,2,0,10,1.4285714285714286,2,0.0,0,2,0,2,4,0,0,2,0,4,6,0
1281,21487,ppwn795jM3X8HLmfBGWlJ1RCSK9HLpNe,7GRhBDsirIGkRZBtSMEzNTyDr2JQm4xx,9,14,8,0,0,2,26,2,52,7.428571428571429,1,0.0,0,8,0,0,14,2,0,26,2,8,44,0
1282,21490,zyW9YJBc7dwBcLXqHqpoJivJzWpl85bK,7GRhBDsirIGkRZBtSMEzNTyDr2JQm4xx,1,0,0,0,0,0,1,0,1,0.14285714285714285,1,0.0,0,0,0,0,0,0,0,1,0,0,1,1
1283,21495,B1P5t3Y1Njy7srjQTkBKL4uTp9GuTAn0,7GRhBDsirIGkRZBtSMEzNTyDr2JQm4xx,16,21,6,0,5,7,23,1,63,9.0,1,0.0,12,6,0,5,9,7,0,23,1,23,40,1
1284,21496,z6p7uYa25VIrmVARFxz5koBofuqHB2cM,7GRhBDsirIGkRZBtSMEzNTyDr2JQm4xx,44,65,18,63,21,6,3,0,176,25.142857142857142,3,0.0,40,18,58,21,25,6,5,3,0,137,39,0
1285,21497,NToJOpRtq67cszdyzl1RlLKqGwS5lZl5,7GRhBDsirIGkRZBtSMEzNTyDr2JQm4xx,22,23,8,31,8,0,3,0,73,10.428571428571429,3,0.0,11,8,24,8,12,0,7,3,0,51,22,1
1286,21507,NzH7q1ytDRSu9qNhporAXyxIIUjowT51,7GRhBDsirIGkRZBtSMEzNTyDr2JQm4xx,2,0,0,0,0,0,2,0,2,0.2857142857142857,1,0.0,0,0,0,0,0,0,0,2,0,0,2,1
1287,21514,ZhTCqX8GMUcn0a0betuEauHNuCk1aRhm,7GRhBDsirIGkRZBtSMEzNTyDr2JQm4xx,44,41,22,41,10,42,9,0,165,23.571428571428573,4,0.0,12,22,40,10,29,42,1,9,0,84,81,0
1288,21518,j5n34dhJSAsFAv6KAw4rsAZTfhL07lCD,7GRhBDsirIGkRZBtSMEzNTyDr2JQm4xx,1,0,0,0,0,0,1,0,1,0.14285714285714285,1,0.0,0,0,0,0,0,0,0,1,0,0,1,1
1289,21524,6Ysh3EXeoiNCd1uXxsjEQronkryNKRU5,7GRhBDsirIGkRZBtSMEzNTyDr2JQm4xx,3,2,1,0,0,0,2,0,5,0.7142857142857143,2,0.0,0,1,0,0,2,0,0,2,0,1,4,1
1290,21526,uFrE2nkTnL4ZVSelDABxT39yNh0J04Eo,7GRhBDsirIGkRZBtSMEzNTyDr2JQm4xx,34,64,21,26,13,8,9,0,141,20.142857142857142,4,0.0,20,21,13,13,44,8,13,9,0,67,74,0
1291,21529,Lf0mThPYOrtlCzgRGBCVTPy1hiGUII8h,7GRhBDsirIGkRZBtSMEzNTyDr2JQm4xx,62,218,70,16,37,13,9,0,363,51.857142857142854,4,0.0,136,70,10,37,82,13,6,9,0,253,110,0
1292,21531,GvY4Z1NOjK4oYpeBStbrl7zpe2zlFqoT,7GRhBDsirIGkRZBtSMEzNTyDr2JQm4xx,37,60,21,68,16,0,7,0,172,24.571428571428573,3,0.0,32,21,57,16,28,0,11,7,0,126,46,0
1293,21537,ofcigTTYbE1oojdrdB7FR2yHe6nxdUzR,7GRhBDsirIGkRZBtSMEzNTyDr2JQm4xx,23,24,6,8,14,0,4,0,56,8.0,4,0.0,12,6,7,14,12,0,1,4,0,39,17,0
1294,21540,3YgaCGoD5yLZIY9V7Ynw4SqcteQ0nC6R,7GRhBDsirIGkRZBtSMEzNTyDr2JQm4xx,2,0,0,0,0,0,3,0,3,0.42857142857142855,2,0.0,0,0,0,0,0,0,0,3,0,0,3,1
1295,21541,Fsp9s2U9w9caQohubxxnoFebg7SxRmA1,7GRhBDsirIGkRZBtSMEzNTyDr2JQm4xx,1,0,0,0,0,0,1,0,1,0.14285714285714285,1,0.0,0,0,0,0,0,0,0,1,0,0,1,1
1296,21545,be7952wawx5BhhJ4vIqX6Vxi48lNKbM1,7GRhBDsirIGkRZBtSMEzNTyDr2JQm4xx,7,8,4,0,5,0,2,0,19,2.7142857142857144,2,0.0,2,4,0,5,6,0,0,2,0,11,8,1
1297,21550,F0XF3FxDWOcsU1tKt96v78Q6rC9yCH1T,7GRhBDsirIGkRZBtSMEzNTyDr2JQm4xx,34,61,25,50,24,0,13,0,173,24.714285714285715,4,0.0,29,25,39,24,32,0,11,13,0,117,56,0
1298,21555,QsTytAYV8W14PH6exal9KlcV5tRATGJv,7GRhBDsirIGkRZBtSMEzNTyDr2JQm4xx,5,2,1,0,1,0,3,0,7,1.0,1,0.0,0,1,0,1,2,0,0,3,0,2,5,1
1299,21558,dQBjOw3ZDQ2EPHOdT4W6pRAoF6sniGIc,7GRhBDsirIGkRZBtSMEzNTyDr2JQm4xx,2,1,0,0,0,0,1,0,2,0.2857142857142857,1,0.0,0,0,0,0,1,0,0,1,0,0,2,1
1300,21561,OaI9ma7KxaY6DFxSwgYhrXCPXva2T3pp,7GRhBDsirIGkRZBtSMEzNTyDr2JQm4xx,4,11,6,0,0,0,3,0,20,2.857142857142857,5,0.0,0,6,0,0,11,0,0,3,0,6,14,0
1301,21562,VL0rdkFTRaRvYW02oZ1fEazY0Pyp6eKe,7GRhBDsirIGkRZBtSMEzNTyDr2JQm4xx,5,2,1,0,1,0,2,0,6,0.8571428571428571,1,0.0,0,1,0,1,2,0,0,2,0,2,4,1
1302,21564,w1NKmDhRc1aeBgZmDEyDguSkZ23SdrlX,7GRhBDsirIGkRZBtSMEzNTyDr2JQm4xx,45,72,42,16,45,4,13,1,193,27.571428571428573,5,0.0,24,42,11,45,48,4,5,13,1,122,71,1
1303,21565,ld1EJfSSRlnpkPJAGgD6T5OR8Mi6NnWn,7GRhBDsirIGkRZBtSMEzNTyDr2JQm4xx,41,38,17,36,13,7,1,0,112,16.0,2,0.0,20,17,21,13,18,7,15,1,0,71,41,0
1304,21570,y9BxmAhm0ieCF6b0HaF7gMrGu5BDtZs5,7GRhBDsirIGkRZBtSMEzNTyDr2JQm4xx,51,76,33,14,38,1,19,0,181,25.857142857142858,4,0.0,33,33,11,38,43,1,3,19,0,115,66,0
1305,21618,TzODuX5kuf2iqGNG9vk0uMzeGNqx5LsA,7GRhBDsirIGkRZBtSMEzNTyDr2JQm4xx,41,105,4,15,15,1,20,1,161,23.0,4,0.0,35,4,10,15,70,1,5,20,1,64,97,0
1306,21638,mwc0YjZS72xD4dO6Zk7KmFewdh7PWkAS,7GRhBDsirIGkRZBtSMEzNTyDr2JQm4xx,36,37,17,6,17,2,10,1,90,12.857142857142858,4,0.0,15,17,6,17,22,2,0,10,1,55,35,0
1307,21640,yf6f57VN5vQ3uXtZoopqYTtboGpfts8e,7GRhBDsirIGkRZBtSMEzNTyDr2JQm4xx,30,40,14,51,1,13,7,0,126,18.0,3,0.0,12,14,46,1,28,13,5,7,0,73,53,0
1308,21642,J08eSQ89mAYluVujsdeguHqd32zsFjVm,7GRhBDsirIGkRZBtSMEzNTyDr2JQm4xx,19,46,8,10,11,1,4,1,81,11.571428571428571,1,0.0,17,8,5,11,29,1,5,4,1,41,40,0
1309,21659,D5mwgoAPtfwdsFrdNADBqEJQSy8E0CUi,7GRhBDsirIGkRZBtSMEzNTyDr2JQm4xx,74,117,40,54,32,3,18,0,264,37.714285714285715,5,0.0,70,40,51,32,47,3,3,18,0,193,71,0
1310,21672,c9jABEJQla4i8vH29nKPFM4cx5bWdrLS,7GRhBDsirIGkRZBtSMEzNTyDr2JQm4xx,70,120,46,43,40,0,4,0,253,36.142857142857146,4,0.0,66,46,40,40,54,0,3,4,0,192,61,0
1311,21690,mezQjcBtwPIB1SXkjHJo9kxjc5UIXdOH,7GRhBDsirIGkRZBtSMEzNTyDr2JQm4xx,39,60,20,36,31,4,7,0,158,22.571428571428573,3,0.0,35,20,27,31,25,4,9,7,0,113,45,1
1312,21692,rf43ZHojMqXQ775bmX3nnHgQ62d9XvGK,7GRhBDsirIGkRZBtSMEzNTyDr2JQm4xx,1,0,0,0,0,0,2,0,2,0.2857142857142857,2,0.0,0,0,0,0,0,0,0,2,0,0,2,1
1313,21708,aU6SEeOgxLKetBRDwfHMDunWavvfr54M,7GRhBDsirIGkRZBtSMEzNTyDr2JQm4xx,80,186,85,108,67,72,47,8,573,81.85714285714286,7,0.0,83,85,87,67,103,72,21,47,8,322,251,0
1314,21714,b4VAhvG3MG7lVRCMYGT7EV06rJVZjoZJ,7GRhBDsirIGkRZBtSMEzNTyDr2JQm4xx,4,2,0,0,0,0,2,0,4,0.5714285714285714,1,0.0,0,0,0,0,2,0,0,2,0,0,4,1
1315,21732,u5O8fjjPHRbPw2KPw4c64f7wflYutdNi,7GRhBDsirIGkRZBtSMEzNTyDr2JQm4xx,9,6,2,0,3,0,3,0,14,2.0,1,0.0,3,2,0,3,3,0,0,3,0,8,6,1
1316,21782,Byhwk1UEYpL8TtNadTQnAIVJYIZTg2mz,7GRhBDsirIGkRZBtSMEzNTyDr2JQm4xx,9,5,3,0,2,1,5,0,16,2.2857142857142856,1,0.0,0,3,0,2,5,1,0,5,0,5,11,1
1317,21816,5M2ejSoYrgCHrezYAGX7ObuTLuLA6uzQ,7GRhBDsirIGkRZBtSMEzNTyDr2JQm4xx,7,10,0,0,2,0,4,0,16,2.2857142857142856,1,0.0,4,0,0,2,6,0,0,4,0,6,10,1
1318,21820,GGGVxWw7kUcQH8IveSqLixfu0u0FTfvz,7GRhBDsirIGkRZBtSMEzNTyDr2JQm4xx,10,10,2,0,1,18,9,0,40,5.714285714285714,3,0.0,0,2,0,1,10,18,0,9,0,3,37,1
1319,21844,On1tK59iw06VEP0NRLWC0Rz8UvbQNGmx,7GRhBDsirIGkRZBtSMEzNTyDr2JQm4xx,3,0,0,0,0,1,2,0,3,0.42857142857142855,1,0.0,0,0,0,0,0,1,0,2,0,0,3,0
1320,21868,i7XmXhv20MDc4pSGJ73V7rP8k8qLIKo3,7GRhBDsirIGkRZBtSMEzNTyDr2JQm4xx,1,0,0,0,0,0,1,0,1,0.14285714285714285,1,0.0,0,0,0,0,0,0,0,1,0,0,1,1
1321,21870,3OGm4X1PEnAaZoBoZXt04kXOR4TFtoHS,7GRhBDsirIGkRZBtSMEzNTyDr2JQm4xx,34,51,19,20,25,2,23,1,141,20.142857142857142,5,0.0,30,19,14,25,21,2,6,23,1,88,53,1
1322,21877,x0ypShGgWj2iz8J8F4tgf2ws2WEbIgWB,7GRhBDsirIGkRZBtSMEzNTyDr2JQm4xx,1,0,0,0,0,0,1,0,1,0.14285714285714285,1,0.0,0,0,0,0,0,0,0,1,0,0,1,1
1323,21899,1dqyrMpu9Xi6FGeCi6jMkyQJfHaqDBod,7GRhBDsirIGkRZBtSMEzNTyDr2JQm4xx,7,6,0,0,1,0,2,0,9,1.2857142857142858,1,0.0,2,0,0,1,4,0,0,2,0,3,6,1
1324,21900,LRwPaW9GtyhH2VMWEMsABaY8IaWh4rBR,7GRhBDsirIGkRZBtSMEzNTyDr2JQm4xx,8,11,2,2,3,0,1,0,19,2.7142857142857144,1,0.0,7,2,1,3,4,0,1,1,0,13,6,1
1325,21922,UyrB62TC80PvjIx5mHAqyBQJHo9hnImU,7GRhBDsirIGkRZBtSMEzNTyDr2JQm4xx,7,4,3,0,2,0,1,0,10,1.4285714285714286,1,0.0,0,3,0,2,4,0,0,1,0,5,5,1
1326,21976,MYCZGZUUB6h2kR5SWwXC3erQhe8wj439,7GRhBDsirIGkRZBtSMEzNTyDr2JQm4xx,27,64,28,28,5,5,23,0,153,21.857142857142858,5,0.0,20,28,28,5,44,5,0,23,0,81,72,0
1327,21999,r6bvKJ2a2G72TbQZE3LacWwmKi7rGXEx,7GRhBDsirIGkRZBtSMEzNTyDr2JQm4xx,27,73,11,42,17,6,5,0,154,22.0,2,0.0,39,11,39,17,34,6,3,5,0,106,48,1
1328,22022,wXFfHtwd9smrvhh9NQW7SmEEo1001LDW,7GRhBDsirIGkRZBtSMEzNTyDr2JQm4xx,3,2,1,0,0,0,1,0,4,0.5714285714285714,1,0.0,0,1,0,0,2,0,0,1,0,1,3,1
1329,22062,MuwljKZkWjKmChDtxaHsKSqu30ykavpg,7GRhBDsirIGkRZBtSMEzNTyDr2JQm4xx,60,159,58,34,23,1,17,1,293,41.857142857142854,4,0.0,66,58,32,23,93,1,2,17,1,179,114,0
1330,22066,Bjvrs4inCOWPKrgMojrWIxl2MDJEdLE9,7GRhBDsirIGkRZBtSMEzNTyDr2JQm4xx,10,7,1,0,1,0,2,0,11,1.5714285714285714,1,0.0,0,1,0,1,7,0,0,2,0,2,9,1
1331,22076,6izQCEneEK1X6C1taxn0XENXkSv3cl84,7GRhBDsirIGkRZBtSMEzNTyDr2JQm4xx,1,0,0,0,0,0,3,0,3,0.42857142857142855,2,0.0,0,0,0,0,0,0,0,3,0,0,3,1
1332,22212,ezzV2inIlk654APZ7lOJdt6ubCpUxMCa,7GRhBDsirIGkRZBtSMEzNTyDr2JQm4xx,3,2,1,0,0,1,2,0,6,0.8571428571428571,2,0.0,0,1,0,0,2,1,0,2,0,1,5,0
1333,22268,tixL6jRbFRYTnAeCUMfXKIdV2z5MfmCZ,7GRhBDsirIGkRZBtSMEzNTyDr2JQm4xx,2,2,1,0,0,0,0,0,3,0.42857142857142855,1,0.0,0,1,0,0,2,0,0,0,0,1,2,1
1334,22293,kK7amf4iBPuG10KmyQTgC89PtCcZTAe2,7GRhBDsirIGkRZBtSMEzNTyDr2JQm4xx,10,6,5,0,4,0,26,1,42,6.0,2,0.0,0,5,0,4,6,0,0,26,1,9,33,0
1335,22317,GGioMvSJ2TI5A4koIk2G8ocfb1Yz1YTO,5Gyp41oLVo7Gg7vF4vpmggWP5MU70QO6,1,0,0,0,0,0,1,0,1,0.14285714285714285,1,0.0,0,0,0,0,0,0,0,1,0,0,1,1
1336,22347,smHnG8vpfHIB1FLFCsfWSMXg6fq0twWp,5Gyp41oLVo7Gg7vF4vpmggWP5MU70QO6,20,14,12,7,5,0,4,0,42,6.0,2,0.0,1,12,4,5,13,0,3,4,0,22,20,1
1337,22366,HOykN2uJJue4nk8EOtMAMPwGp1qoBRJT,5Gyp41oLVo7Gg7vF4vpmggWP5MU70QO6,29,46,31,7,10,22,12,0,128,18.285714285714285,4,0.0,8,31,4,10,38,22,3,12,0,53,75,1
1338,22375,lZnDmUFZ3RPpS8WhvoeYbrPZZf5syUz5,5Gyp41oLVo7Gg7vF4vpmggWP5MU70QO6,13,23,5,20,6,21,4,0,79,11.285714285714286,3,0.0,5,5,15,6,18,21,5,4,0,31,48,1
1339,22376,OkJ0lKmMXuQ2MGftQ8Isfw1JciMpapRC,5Gyp41oLVo7Gg7vF4vpmggWP5MU70QO6,12,15,6,0,2,0,12,0,35,5.0,4,0.0,3,6,0,2,12,0,0,12,0,11,24,1
1340,22386,JdJ1SwT93OWgPbpS5GdJzD3RLASaE4SR,5Gyp41oLVo7Gg7vF4vpmggWP5MU70QO6,62,124,62,110,7,15,39,1,358,51.142857142857146,14,0.0,28,62,99,7,96,15,11,39,1,196,162,0
1341,22427,UrENN1zIfJIc4hCxDDWe8c7coKokiTdF,5Gyp41oLVo7Gg7vF4vpmggWP5MU70QO6,45,148,86,64,37,27,12,0,374,53.42857142857143,6,0.0,45,86,57,37,103,27,7,12,0,225,149,0
1342,22439,blQFA8HzhNQeb8MMYJXyJW6sPMdvZQKn,5Gyp41oLVo7Gg7vF4vpmggWP5MU70QO6,15,15,7,7,6,3,6,0,44,6.285714285714286,3,0.0,4,7,5,6,11,3,2,6,0,22,22,1
1343,22453,SRWyybFCyRnJ5WkAnmW9p9zBXOYVWjli,5Gyp41oLVo7Gg7vF4vpmggWP5MU70QO6,9,21,11,0,0,149,20,6,207,29.571428571428573,7,0.0,0,11,0,0,21,149,0,20,6,11,196,1
1344,22474,Ci9K2Hg2fGB1BwuqHBCLFF3JRq0fwfBw,5Gyp41oLVo7Gg7vF4vpmggWP5MU70QO6,11,13,8,0,5,0,3,0,29,4.142857142857143,3,0.0,2,8,0,5,11,0,0,3,0,15,14,1
1345,22497,DVIil2NM7ZWOtqe6rhlMzwEUAb2wuaeh,5Gyp41oLVo7Gg7vF4vpmggWP5MU70QO6,5,0,0,0,0,1,4,1,6,0.8571428571428571,1,0.0,0,0,0,0,0,1,0,4,1,0,6,1
1346,22523,TozaOtIFG8vkGyP2fXfC45I7si7w78eb,5Gyp41oLVo7Gg7vF4vpmggWP5MU70QO6,8,4,2,0,1,4,8,1,20,2.857142857142857,1,0.0,0,2,0,1,4,4,0,8,1,3,17,1
1347,22538,uMEUDlZ1tL8WoZ2EmL0CStSYwA0zOal8,5Gyp41oLVo7Gg7vF4vpmggWP5MU70QO6,10,17,7,6,2,0,2,0,34,4.857142857142857,2,0.0,5,7,5,2,12,0,1,2,0,19,15,1
1348,22547,sEjCSxiV4U3FouTICvcD4zFUuMByUanv,5Gyp41oLVo7Gg7vF4vpmggWP5MU70QO6,7,6,4,0,3,1,1,0,15,2.142857142857143,1,0.0,1,4,0,3,5,1,0,1,0,8,7,1
1349,22549,LWpdQl1kIM7O0RFkPOOWkIIuXkfkptb7,5Gyp41oLVo7Gg7vF4vpmggWP5MU70QO6,10,25,8,2,4,2,4,0,45,6.428571428571429,3,0.0,9,8,1,4,16,2,1,4,0,22,23,1
1350,22555,L4rfrz5IG5CnYOQ8tF1uZUfhIbYnk3pq,5Gyp41oLVo7Gg7vF4vpmggWP5MU70QO6,1,0,0,0,0,0,4,0,4,0.5714285714285714,1,0.0,0,0,0,0,0,0,0,4,0,0,4,1
1351,22572,cTe9j4PdslDnq3xIrpLJR1wCTH6ieU9f,5Gyp41oLVo7Gg7vF4vpmggWP5MU70QO6,9,8,4,0,2,0,6,0,20,2.857142857142857,3,0.0,0,4,0,2,8,0,0,6,0,6,14,1
1352,22582,i0ksX07HnsV5rQlWqOr1uKEuc7yNU24c,5Gyp41oLVo7Gg7vF4vpmggWP5MU70QO6,31,61,37,11,10,9,31,3,162,23.142857142857142,14,0.0,11,37,7,10,50,9,4,31,3,65,97,0
1353,22586,bFBipIvg3ynAbrvo3mXNRP6i8NWVQRYx,5Gyp41oLVo7Gg7vF4vpmggWP5MU70QO6,15,30,17,6,9,15,26,17,120,17.142857142857142,5,0.0,4,17,4,9,26,15,2,26,17,34,86,1
1354,22600,TskFrPtAVOkXDid77obsVFy9LWYFHqHh,5Gyp41oLVo7Gg7vF4vpmggWP5MU70QO6,1,0,0,0,0,0,1,0,1,0.14285714285714285,1,0.0,0,0,0,0,0,0,0,1,0,0,1,1
1355,22603,BlAzg2gVUHCR0etol6wfOtV7A74GKZIx,5Gyp41oLVo7Gg7vF4vpmggWP5MU70QO6,1,0,0,0,0,0,1,0,1,0.14285714285714285,1,0.0,0,0,0,0,0,0,0,1,0,0,1,1
1356,22609,BRuob7UoRxkckZfA2Kz9zU3YGLVQRLrf,5Gyp41oLVo7Gg7vF4vpmggWP5MU70QO6,15,16,7,12,1,0,3,0,39,5.571428571428571,2,0.0,4,7,9,1,12,0,3,3,0,21,18,0
1357,22611,LpKc0q3vwtZx2tbV2GItCPMY7oFOnDvF,5Gyp41oLVo7Gg7vF4vpmggWP5MU70QO6,15,33,19,0,1,5,12,0,70,10.0,7,0.0,5,19,0,1,28,5,0,12,0,25,45,1
1358,22622,AtlXb54YoHc4l0gdtB83pi4Jcr8xBgAB,5Gyp41oLVo7Gg7vF4vpmggWP5MU70QO6,10,10,3,3,4,0,2,0,22,3.142857142857143,1,0.0,6,3,2,4,4,0,1,2,0,15,7,1
1359,22628,8UhW1HcJSpUKetcNndZSyo2w5k5GEb12,5Gyp41oLVo7Gg7vF4vpmggWP5MU70QO6,4,0,0,0,0,8,4,0,12,1.7142857142857142,1,0.0,0,0,0,0,0,8,0,4,0,0,12,1
1360,22640,SXQudUQxotVyHX3jIj58IdonMUWj4z4L,RXDvfPUBYFlVdlueBFbLW0mhhAyGEqpt,17,25,18,8,2,0,6,0,59,8.428571428571429,3,0.0,2,18,7,2,23,0,1,6,0,29,30,0
1361,22651,bPMM8JJVMbo3dHwzrkYwNanOXVlVjIZM,SpATywNh6bZuzm8s1ceuBUnMUAeoAHHw,37,58,36,40,26,0,5,0,165,23.571428571428573,7,0.0,17,36,33,26,41,0,7,5,0,112,53,0
1362,22656,6r68uLeYBa0U5j97XGrLINpoFwwpiU0a,SpATywNh6bZuzm8s1ceuBUnMUAeoAHHw,21,43,0,14,0,0,3,0,60,8.571428571428571,3,0.0,17,0,11,0,26,0,3,3,0,28,32,0
1363,22661,zgbCsvFYb3b53axsu4K7VNjBEGD1Bru2,G8EPVSXsOYB5YQWZGiz1aVq5Pgr2GrQu,25,16,9,78,2,0,5,2,112,16.0,2,0.0,4,9,66,2,12,0,12,5,2,81,31,1
1364,22666,8NZmD5KXyLIfbrDZRanIJvBfumgIsUhW,SpATywNh6bZuzm8s1ceuBUnMUAeoAHHw,9,13,6,0,1,8,8,0,36,5.142857142857143,4,0.0,0,6,0,1,13,8,0,8,0,7,29,0
1365,22688,6aazLDsf7EAZ2t5BIjBNI9Ug5zAk9J2O,SpATywNh6bZuzm8s1ceuBUnMUAeoAHHw,3,2,1,0,0,0,1,0,4,0.5714285714285714,1,0.0,0,1,0,0,2,0,0,1,0,1,3,0
1366,22699,f7tZxTkA0B7yOxMWeydGO2hW0y86mAhD,A3fsA9Zfv1X2fVEQhTw51lKENdNrEqT3,51,69,55,36,24,0,13,0,197,28.142857142857142,5,0.0,4,55,36,24,65,0,0,13,0,119,78,0
1367,22711,TPPsOieQBcwqH8dqABTR3mddQ5gDzlZO,SpATywNh6bZuzm8s1ceuBUnMUAeoAHHw,20,27,13,23,6,0,2,0,71,10.142857142857142,2,0.0,11,13,19,6,16,0,4,2,0,49,22,0
1368,22720,4iz2t15J5bzEPElZVcStT3H8hpTNKJIQ,SpATywNh6bZuzm8s1ceuBUnMUAeoAHHw,2,0,0,0,0,1,1,0,2,0.2857142857142857,1,0.0,0,0,0,0,0,1,0,1,0,0,2,0
1369,22796,NEe9TsP56Xype0U6CLfwX8CaejtfAtDd,SpATywNh6bZuzm8s1ceuBUnMUAeoAHHw,11,21,0,19,0,13,4,0,57,8.142857142857142,2,0.0,8,0,16,0,13,13,3,4,0,24,33,0
1370,22844,TQIRy5vD7Rgv73APMCqQZ7AssMVX3u4N,A3fsA9Zfv1X2fVEQhTw51lKENdNrEqT3,15,8,7,0,6,0,1,0,22,3.142857142857143,1,0.0,0,7,0,6,8,0,0,1,0,13,9,1
1371,22849,Wd5Y51TL4njlLeYHUjz5D9nrsHvDXUZ8,A3fsA9Zfv1X2fVEQhTw51lKENdNrEqT3,53,21,14,144,3,2,8,0,192,27.428571428571427,3,0.0,2,14,122,3,19,2,22,8,0,141,51,0
1372,22855,4J9zAQq4ZlZzXgNIT2zhfBx7kGs24C6D,SpATywNh6bZuzm8s1ceuBUnMUAeoAHHw,5,6,3,0,0,0,2,0,11,1.5714285714285714,2,0.0,1,3,0,0,5,0,0,2,0,4,7,0
1373,22893,fslIhUAreTqu48Va3DJjHuBASqZWV4lb,SpATywNh6bZuzm8s1ceuBUnMUAeoAHHw,11,17,2,0,1,0,3,0,23,3.2857142857142856,2,0.0,0,2,0,1,17,0,0,3,0,3,20,0
1374,22896,kwtDMW6kCF4Dj4cVANDmT2RtqpyiMQZT,A3fsA9Zfv1X2fVEQhTw51lKENdNrEqT3,6,6,0,0,1,0,3,0,10,1.4285714285714286,2,0.0,0,0,0,1,6,0,0,3,0,1,9,0
1375,22962,M6VmJD8JYDR5w6GV5uzAgWpIXM5eanml,G8EPVSXsOYB5YQWZGiz1aVq5Pgr2GrQu,48,183,79,77,36,6,10,0,391,55.857142857142854,4,0.0,5,79,64,36,178,6,13,10,0,184,207,0
1376,22988,mYyzW7j4oHjgvbS0hfWvmpiecRMbZDgq,SpATywNh6bZuzm8s1ceuBUnMUAeoAHHw,6,7,1,2,0,0,1,0,11,1.5714285714285714,1,0.0,0,1,1,0,7,0,1,1,0,2,9,1
1377,22993,WaZjCMCq9zHT0tGjpLu6Y2rc6ox0JLNd,A3fsA9Zfv1X2fVEQhTw51lKENdNrEqT3,5,2,1,0,2,0,2,0,7,1.0,1,0.0,0,1,0,2,2,0,0,2,0,3,4,1
1378,22996,W9f8UmYzSEsFhECsZDg6FwyOA22yb0R3,SpATywNh6bZuzm8s1ceuBUnMUAeoAHHw,44,62,35,13,18,52,25,7,212,30.285714285714285,5,0.0,17,35,13,18,45,52,0,25,7,83,129,0
1379,23014,UInMBEH8f1h2vxXVslRsWyLOTv8ggYq3,bWdj2GDclj5ofokWjzoa5jAwMkxCykd6,10,8,5,0,2,0,4,0,19,2.7142857142857144,1,0.0,0,5,0,2,8,0,0,4,0,7,12,0
1380,23049,I2ghGumCKIaVsnJOGZA0xyJzTnEm5KtW,SpATywNh6bZuzm8s1ceuBUnMUAeoAHHw,4,3,1,0,0,0,1,0,5,0.7142857142857143,1,0.0,0,1,0,0,3,0,0,1,0,1,4,1
1381,23054,aOK5wIKpKN9ikUy2a1FUGeQDEt1AAFa3,G8EPVSXsOYB5YQWZGiz1aVq5Pgr2GrQu,34,23,19,44,11,0,6,1,104,14.857142857142858,3,0.0,0,19,36,11,23,0,8,6,1,66,38,1
1382,23058,Dp9gZlmwGRMU0Crlqtgk7QHM4JW7fsY6,SpATywNh6bZuzm8s1ceuBUnMUAeoAHHw,14,20,3,23,0,0,3,0,49,7.0,2,0.0,11,3,18,0,9,0,5,3,0,32,17,0
1383,23073,gZWf27ETcHz4bBmwZPjiPumw55JZ4IOR,SpATywNh6bZuzm8s1ceuBUnMUAeoAHHw,7,11,2,0,2,0,2,0,17,2.4285714285714284,2,0.0,0,2,0,2,11,0,0,2,0,4,13,0
1384,23084,mjoKY29bSBUSIg1iJCO4z3ZZIabGnClW,SpATywNh6bZuzm8s1ceuBUnMUAeoAHHw,1,0,0,0,0,0,1,0,1,0.14285714285714285,1,0.0,0,0,0,0,0,0,0,1,0,0,1,0
1385,23091,aOhrgEBrLoAbudoZk6lY36jneHxQbWdO,G8EPVSXsOYB5YQWZGiz1aVq5Pgr2GrQu,36,21,4,78,1,2,4,1,111,15.857142857142858,2,0.0,0,4,65,1,21,2,13,4,1,70,41,0
1386,23118,2wKdgTom3CXBb3VapzvEijoKrYgkRC9s,SpATywNh6bZuzm8s1ceuBUnMUAeoAHHw,3,2,0,0,0,0,2,0,4,0.5714285714285714,1,0.0,0,0,0,0,2,0,0,2,0,0,4,0
1387,23140,0Tg2flbTUdD7fODqYIfpiJiK0IDdFiOP,RXDvfPUBYFlVdlueBFbLW0mhhAyGEqpt,29,40,21,13,7,17,6,0,104,14.857142857142858,4,0.0,6,21,12,7,34,17,1,6,0,46,58,0
1388,23145,VO6tFMF3YqIQYaW8tkV9BLtheEJyKKQK,SpATywNh6bZuzm8s1ceuBUnMUAeoAHHw,21,24,18,11,11,0,4,1,69,9.857142857142858,2,0.0,2,18,9,11,22,0,2,4,1,40,29,0
1389,23188,HycevJIm7cBjf1oJ5QCBMMXEBTG8jyRF,RXDvfPUBYFlVdlueBFbLW0mhhAyGEqpt,37,46,35,59,3,6,7,0,156,22.285714285714285,2,0.0,7,35,52,3,39,6,7,7,0,97,59,0
1390,23203,YBZJfjYuKfwb2VLWbDlKIMN1YSYXBGau,A3fsA9Zfv1X2fVEQhTw51lKENdNrEqT3,7,16,4,0,0,0,6,0,26,3.7142857142857144,1,0.0,0,4,0,0,16,0,0,6,0,4,22,1
1391,23255,FfhVetKUzu5KpGrHLPHaynXPJghmm3It,SpATywNh6bZuzm8s1ceuBUnMUAeoAHHw,6,10,3,0,0,0,4,0,17,2.4285714285714284,3,0.0,0,3,0,0,10,0,0,4,0,3,14,0
1392,23259,xqwUV9iQK4erbWJ9fEZ3Fau5k4aAZ9DO,SpATywNh6bZuzm8s1ceuBUnMUAeoAHHw,17,27,11,34,1,8,11,0,92,13.142857142857142,3,0.0,10,11,28,1,17,8,6,11,0,50,42,0
1393,23264,XTgYONXtkRAl3sCFaGFF8e1mU9AMcEwg,SpATywNh6bZuzm8s1ceuBUnMUAeoAHHw,11,8,6,0,3,0,2,0,19,2.7142857142857144,2,0.0,0,6,0,3,8,0,0,2,0,9,10,1
1394,23265,knRZtWEcWI5MFAs7PYIJdk2jdyAY8A24,SpATywNh6bZuzm8s1ceuBUnMUAeoAHHw,3,2,1,0,0,0,1,0,4,0.5714285714285714,1,0.0,0,1,0,0,2,0,0,1,0,1,3,0
1395,23268,XJpmNtat26NZxNAZqQE63m1qpYdHanqw,RXDvfPUBYFlVdlueBFbLW0mhhAyGEqpt,5,7,4,0,0,3,5,3,22,3.142857142857143,1,0.0,0,4,0,0,7,3,0,5,3,4,18,0
1396,23297,3cB0rEpxJxC0jjqfQ9EPT6ntxFajOXrx,A3fsA9Zfv1X2fVEQhTw51lKENdNrEqT3,13,37,16,18,2,0,9,0,82,11.714285714285714,5,0.0,0,16,16,2,37,0,2,9,0,34,48,0
1397,23304,WEwbMamm1WQzZcIYKs7fv3KkFwrZAu4n,SpATywNh6bZuzm8s1ceuBUnMUAeoAHHw,22,25,17,12,10,0,4,0,68,9.714285714285714,2,0.0,4,17,11,10,21,0,1,4,0,42,26,0
1398,23307,S1PbXrIuvwc8AvxDGKhjkWzwRdM8cFN0,SpATywNh6bZuzm8s1ceuBUnMUAeoAHHw,21,29,19,15,0,46,6,1,116,16.571428571428573,2,0.0,4,19,12,0,25,46,3,6,1,35,81,0
1399,23313,TXBaUi0GpvXZWCDXsKlkFWTtfaT87UMz,bWdj2GDclj5ofokWjzoa5jAwMkxCykd6,3,4,2,0,0,0,2,0,8,1.1428571428571428,1,0.0,0,2,0,0,4,0,0,2,0,2,6,1
1400,23358,dob27oJoC3Vd5K1oOuihpbNGBh5pIGaM,SpATywNh6bZuzm8s1ceuBUnMUAeoAHHw,6,8,1,0,1,0,1,0,11,1.5714285714285714,1,0.0,0,1,0,1,8,0,0,1,0,2,9,1
1401,23388,HZWZtPkCTeK90eQ90MHe5cWcAqiVgkGk,bWdj2GDclj5ofokWjzoa5jAwMkxCykd6,6,8,5,4,0,19,2,0,38,5.428571428571429,1,0.0,0,5,2,0,8,19,2,2,0,7,31,0
1402,23390,lfrqXPATBesMooHpdCa9ZnxlXhb59rmp,SpATywNh6bZuzm8s1ceuBUnMUAeoAHHw,1,0,0,0,0,2,0,0,2,0.2857142857142857,1,0.0,0,0,0,0,0,2,0,0,0,0,2,1
1403,23399,QUw5YB8tw6ArwfIF1vjOH2aXsMxDBB6n,SpATywNh6bZuzm8s1ceuBUnMUAeoAHHw,22,26,15,13,8,3,9,0,74,10.571428571428571,4,0.0,2,15,10,8,24,3,3,9,0,35,39,0
1404,23416,1ulA4jhwI0WhLE9MVLjWBxEEeOzdq7WL,SpATywNh6bZuzm8s1ceuBUnMUAeoAHHw,26,44,21,6,9,5,7,0,92,13.142857142857142,4,0.0,16,21,6,9,28,5,0,7,0,52,40,0
1405,23440,lHNqd6KTSO9CrJzRDAqosVITLVN3mMHR,bWdj2GDclj5ofokWjzoa5jAwMkxCykd6,22,28,17,34,4,0,8,0,91,13.0,3,0.0,5,17,32,4,23,0,2,8,0,58,33,1
1406,23452,iEsDxJ2LNGTFl1t0aAKhf24FeoeDy4PX,G8EPVSXsOYB5YQWZGiz1aVq5Pgr2GrQu,13,15,1,28,0,0,1,0,45,6.428571428571429,1,0.0,0,1,26,0,15,0,2,1,0,27,18,1
1407,23477,wctOEAfOfHjaIn2ukTVBg3NDDfP2Pt1c,SpATywNh6bZuzm8s1ceuBUnMUAeoAHHw,16,43,29,0,11,0,11,0,94,13.428571428571429,4,0.0,0,29,0,11,43,0,0,11,0,40,54,0
1408,23490,Id4UmIRRQiLXHoJYSjh5OCO1CRaFgQ2K,SpATywNh6bZuzm8s1ceuBUnMUAeoAHHw,23,40,21,14,7,0,8,1,91,13.0,4,0.0,9,21,11,7,31,0,3,8,1,48,43,1
1409,23510,GIb3glgYrsEfHWtEWPWpwONqwE7RMf6f,A3fsA9Zfv1X2fVEQhTw51lKENdNrEqT3,115,82,64,206,50,16,22,0,440,62.857142857142854,8,0.0,3,64,173,50,79,16,33,22,0,290,150,0
1410,23515,Oqfkhjg6t51PZcyyCwvjWtQ6bDHYceB1,SpATywNh6bZuzm8s1ceuBUnMUAeoAHHw,9,14,8,0,1,0,6,0,29,4.142857142857143,3,0.0,2,8,0,1,12,0,0,6,0,11,18,0
1411,23542,d4mvkfcwFcYKWYB1PuCW432MT8LvqlFh,SpATywNh6bZuzm8s1ceuBUnMUAeoAHHw,20,18,9,14,5,0,4,0,50,7.142857142857143,2,0.0,7,9,14,5,11,0,0,4,0,35,15,1
1412,23552,H0WeKsbXeLHWXz7EV7ygxgCQNCt5DOUD,SpATywNh6bZuzm8s1ceuBUnMUAeoAHHw,28,30,20,20,12,0,6,0,88,12.571428571428571,5,0.0,2,20,17,12,28,0,3,6,0,51,37,0
1413,23573,MwhE2MowwPvamSVFrLUWaatDsrzcIgQY,SpATywNh6bZuzm8s1ceuBUnMUAeoAHHw,19,24,12,18,9,0,2,0,65,9.285714285714286,3,0.0,8,12,18,9,16,0,0,2,0,47,18,0
1414,23640,9uqkwYb5ddQJIw4su6OaF1hwvWEdLp1S,A3fsA9Zfv1X2fVEQhTw51lKENdNrEqT3,23,27,19,16,11,0,4,0,77,11.0,4,0.0,3,19,14,11,24,0,2,4,0,47,30,0
1415,23671,9sTtmQQAXG5XvwtZJPuuRKLnfgaYWfWO,SpATywNh6bZuzm8s1ceuBUnMUAeoAHHw,19,13,7,18,5,0,2,0,45,6.428571428571429,1,0.0,3,7,14,5,10,0,4,2,0,29,16,1
1416,23674,l9KseRU4xYtwOzoILYmGcicF0iiXQqxl,SpATywNh6bZuzm8s1ceuBUnMUAeoAHHw,29,42,21,22,5,9,8,0,107,15.285714285714286,5,0.0,4,21,19,5,38,9,3,8,0,49,58,0
1417,23675,pJj2PU7RZQK2Nwrb96O5DurQcsPoqkDx,bWdj2GDclj5ofokWjzoa5jAwMkxCykd6,7,4,3,0,3,0,2,0,12,1.7142857142857142,1,0.0,0,3,0,3,4,0,0,2,0,6,6,1
1418,23723,aX5o3K4conQ4SoTRN7MBCmGaArjn5YFA,SpATywNh6bZuzm8s1ceuBUnMUAeoAHHw,10,12,6,0,3,0,6,0,27,3.857142857142857,2,0.0,0,6,0,3,12,0,0,6,0,9,18,1
1419,23740,oJ9j9ejTgKixczg3tSE8Sg8DPI7YQpJq,SpATywNh6bZuzm8s1ceuBUnMUAeoAHHw,10,10,3,5,0,0,3,0,21,3.0,2,0.0,4,3,5,0,6,0,0,3,0,12,9,0
1420,23752,oW1SPRE23Cu85GeGZYRmhPcFuXq6dZoG,SpATywNh6bZuzm8s1ceuBUnMUAeoAHHw,9,10,5,8,0,0,2,0,25,3.5714285714285716,1,0.0,4,5,8,0,6,0,0,2,0,17,8,0
1421,23754,atxTINx1wNa0Kz1uw7bW34Z47POxkGeq,SpATywNh6bZuzm8s1ceuBUnMUAeoAHHw,18,23,4,16,3,0,8,0,54,7.714285714285714,4,0.0,4,4,13,3,19,0,3,8,0,24,30,0
1422,23760,6uy0rYsVs6ntSHgwhJ1mwDkW5uKAQxi4,SpATywNh6bZuzm8s1ceuBUnMUAeoAHHw,7,4,3,0,2,0,1,0,10,1.4285714285714286,1,0.0,0,3,0,2,4,0,0,1,0,5,5,1
1423,23789,i1f7BljhTNgVMfGOHZ66OYaR3kNetCAs,SpATywNh6bZuzm8s1ceuBUnMUAeoAHHw,10,17,1,12,0,0,2,0,32,4.571428571428571,2,0.0,5,1,11,0,12,0,1,2,0,17,15,0
1424,23795,bHKiB8yjzvUwkeHE5fxnHNywx47ldJ6B,SpATywNh6bZuzm8s1ceuBUnMUAeoAHHw,16,23,3,12,2,0,2,0,42,6.0,2,0.0,6,3,11,2,17,0,1,2,0,22,20,1
1425,23798,GOPMGFz5xoFESgugOmv6JtNIOPfS0GCX,SpATywNh6bZuzm8s1ceuBUnMUAeoAHHw,15,26,1,19,1,0,5,0,52,7.428571428571429,4,0.0,11,1,17,1,15,0,2,5,0,30,22,0
1426,23874,986WgoFI0AZSDPIvWwBI8MUZveW4E4Xu,RXDvfPUBYFlVdlueBFbLW0mhhAyGEqpt,7,10,5,0,2,0,1,0,18,2.5714285714285716,1,0.0,0,5,0,2,10,0,0,1,0,7,11,0
1427,23893,dkQw8oK3XR4qlNNv9mJoCG5KMSpfLA0u,SpATywNh6bZuzm8s1ceuBUnMUAeoAHHw,18,20,13,19,8,0,1,0,61,8.714285714285714,2,0.0,4,13,16,8,16,0,3,1,0,41,20,1
1428,23920,v5teTtQ61doFtyEryEU1FEZNTQeJUrxX,SpATywNh6bZuzm8s1ceuBUnMUAeoAHHw,17,24,3,15,1,0,6,0,49,7.0,3,0.0,9,3,14,1,15,0,1,6,0,27,22,0
1429,23942,yk8HuNxXIum8r8XDIOHqnAVeWfg9tYo1,A3fsA9Zfv1X2fVEQhTw51lKENdNrEqT3,58,25,19,64,13,0,5,1,127,18.142857142857142,1,0.0,2,19,64,13,23,0,0,5,1,98,29,1
1430,23944,ZKAk08L8Iriz8Uv5UOeqSbrNnzg1rlMz,RXDvfPUBYFlVdlueBFbLW0mhhAyGEqpt,1,0,0,0,0,0,1,0,1,0.14285714285714285,1,0.0,0,0,0,0,0,0,0,1,0,0,1,0
1431,23955,5mJ1itg2cQYRNscuJuLNd4sNUrdim8JB,bWdj2GDclj5ofokWjzoa5jAwMkxCykd6,25,70,34,36,9,8,16,0,173,24.714285714285715,5,0.0,6,34,33,9,64,8,3,16,0,82,91,0
1432,23975,xCPsccPRbQTL93kwam6OPz5i1lU77hqE,SpATywNh6bZuzm8s1ceuBUnMUAeoAHHw,28,30,2,11,1,1,8,1,54,7.714285714285714,3,0.0,0,2,7,1,30,1,4,8,1,10,44,0
1433,23976,PSJftXZeDfoFySmsRqkLgFson1mEyJqX,SpATywNh6bZuzm8s1ceuBUnMUAeoAHHw,23,67,31,35,8,14,30,0,185,26.428571428571427,7,0.0,24,31,29,8,43,14,6,30,0,92,93,0
1434,23982,3W09pasLSoDWuQqGyvECJ7WiykG165j2,RXDvfPUBYFlVdlueBFbLW0mhhAyGEqpt,9,6,3,0,0,3,5,0,17,2.4285714285714284,2,0.0,0,3,0,0,6,3,0,5,0,3,14,1
1435,24019,tML4IQ8jFiP4YuH9NbvzKQFqAdof0qcO,G8EPVSXsOYB5YQWZGiz1aVq5Pgr2GrQu,21,24,4,42,3,0,6,0,79,11.285714285714286,5,0.0,2,4,38,3,22,0,4,6,0,47,32,0
1436,24035,j5UlwBty5MOwHf8rgRJk1hdlEvwivM1k,SpATywNh6bZuzm8s1ceuBUnMUAeoAHHw,3,0,0,0,0,0,3,0,3,0.42857142857142855,1,0.0,0,0,0,0,0,0,0,3,0,0,3,0
1437,24077,1xg9Qkt1ODqUyNotraxCzvVYE0R3XRTq,SpATywNh6bZuzm8s1ceuBUnMUAeoAHHw,8,29,21,0,0,0,8,0,58,8.285714285714286,3,0.0,0,21,0,0,29,0,0,8,0,21,37,0
1438,24097,quAtav6r2isPETtEaXY0Zey5BbVDiT8E,bWdj2GDclj5ofokWjzoa5jAwMkxCykd6,1,0,0,0,0,0,2,0,2,0.2857142857142857,1,0.0,0,0,0,0,0,0,0,2,0,0,2,1
1439,24139,oz1karFupMeBQM5wp1X9Aheb4RKufic7,SpATywNh6bZuzm8s1ceuBUnMUAeoAHHw,19,13,9,12,5,0,2,0,41,5.857142857142857,2,0.0,2,9,11,5,11,0,1,2,0,27,14,0
1440,24142,6zt7VkEpMezYkke6xelTowmnsTySao1Z,SpATywNh6bZuzm8s1ceuBUnMUAeoAHHw,9,6,4,0,3,0,1,0,14,2.0,1,0.0,1,4,0,3,5,0,0,1,0,8,6,1
1441,24146,W41zjpcR5alpzNzSmbyy9bBZYrT6UXxL,RXDvfPUBYFlVdlueBFbLW0mhhAyGEqpt,6,4,3,0,1,0,1,0,9,1.2857142857142858,1,0.0,0,3,0,1,4,0,0,1,0,4,5,1
1442,24149,yEc0qGRUsnGavj0JPbk8pVtWktClrURk,SpATywNh6bZuzm8s1ceuBUnMUAeoAHHw,3,4,2,0,0,0,2,0,8,1.1428571428571428,2,0.0,0,2,0,0,4,0,0,2,0,2,6,0
1443,24150,7mxOgTUP9lSjAUBOPZ9fhNEhVSHMvF2J,bWdj2GDclj5ofokWjzoa5jAwMkxCykd6,37,35,6,89,5,11,6,0,152,21.714285714285715,6,0.0,6,6,76,5,29,11,13,6,0,93,59,0
1444,24191,VVltscgfR96aweHb5nQdD1Q7dsOwuOJz,A3fsA9Zfv1X2fVEQhTw51lKENdNrEqT3,7,9,0,0,0,0,1,0,10,1.4285714285714286,1,0.0,0,0,0,0,9,0,0,1,0,0,10,1
1445,24205,KjugBA6V5bkEA5fAIbJoGnSUlDhZoaIH,SpATywNh6bZuzm8s1ceuBUnMUAeoAHHw,1,0,0,0,0,0,1,0,1,0.14285714285714285,1,0.0,0,0,0,0,0,0,0,1,0,0,1,0
1446,24258,Ne25k1DU4nK81LWo7930HvBFWlFV2ZKt,SpATywNh6bZuzm8s1ceuBUnMUAeoAHHw,14,8,5,14,3,0,3,0,33,4.714285714285714,1,0.0,2,5,13,3,6,0,1,3,0,23,10,0
1447,24283,yZoviGGxgr5NFf9klHeC5PfXfdVd14QP,A3fsA9Zfv1X2fVEQhTw51lKENdNrEqT3,9,13,12,0,3,0,2,0,30,4.285714285714286,1,0.0,0,12,0,3,13,0,0,2,0,15,15,1
1448,24285,Kd69M9W1nim0woqVm1QxfVaSebsYtFIh,RXDvfPUBYFlVdlueBFbLW0mhhAyGEqpt,3,2,1,0,0,0,1,0,4,0.5714285714285714,1,0.0,0,1,0,0,2,0,0,1,0,1,3,1
1449,24313,Evco2d15cNydZMimph5VWFT3j0HfgNP5,SpATywNh6bZuzm8s1ceuBUnMUAeoAHHw,28,35,12,21,5,0,5,2,80,11.428571428571429,4,0.0,7,12,21,5,28,0,0,5,2,45,35,0
1450,24324,W41zjpcR5alpzNzSmbyy9bBZYrT6UXxL,A3fsA9Zfv1X2fVEQhTw51lKENdNrEqT3,13,18,15,0,13,0,2,0,48,6.857142857142857,1,0.0,0,15,0,13,18,0,0,2,0,28,20,1
1451,24375,vx3ISVZde9Js9SAljxLNpat5gkbJKEY2,RXDvfPUBYFlVdlueBFbLW0mhhAyGEqpt,7,3,1,8,1,0,2,0,15,2.142857142857143,1,0.0,1,1,8,1,2,0,0,2,0,11,4,0
1452,24445,mFNGHC6aCmhHmhRXFCDO0uvnGnNYaro0,bWdj2GDclj5ofokWjzoa5jAwMkxCykd6,6,7,4,0,0,0,4,0,15,2.142857142857143,2,0.0,0,4,0,0,7,0,0,4,0,4,11,1
1453,24447,bSOq11L6zS91mDTcR42LcWMRdkU0Htpv,SpATywNh6bZuzm8s1ceuBUnMUAeoAHHw,20,11,9,0,7,0,6,0,33,4.714285714285714,2,0.0,1,9,0,7,10,0,0,6,0,17,16,1
1454,24475,1yAfuEW0CNQiRXnPO0v79LFUyx4hhTWm,bWdj2GDclj5ofokWjzoa5jAwMkxCykd6,4,2,2,0,0,0,5,0,9,1.2857142857142858,2,0.0,0,2,0,0,2,0,0,5,0,2,7,0
1455,24503,VVgqDLLa7j66k9tQU3M7wVOF4BEse4lo,SpATywNh6bZuzm8s1ceuBUnMUAeoAHHw,29,56,19,5,11,0,6,0,97,13.857142857142858,4,0.0,2,19,5,11,54,0,0,6,0,37,60,0
1456,24505,iXoEMwcJ5o4IM7VKZ5pyam9GxPy4olUQ,G8EPVSXsOYB5YQWZGiz1aVq5Pgr2GrQu,1,0,0,0,0,0,1,0,1,0.14285714285714285,1,0.0,0,0,0,0,0,0,0,1,0,0,1,1
1457,24517,iXoEMwcJ5o4IM7VKZ5pyam9GxPy4olUQ,bWdj2GDclj5ofokWjzoa5jAwMkxCykd6,19,70,20,0,3,0,4,0,97,13.857142857142858,1,0.0,3,20,0,3,67,0,0,4,0,26,71,1
1458,24542,GW33fgaq0ndGNQkirzfpXhCeUuV3tuD2,SpATywNh6bZuzm8s1ceuBUnMUAeoAHHw,4,4,2,0,1,0,2,0,9,1.2857142857142858,2,0.0,0,2,0,1,4,0,0,2,0,3,6,0
1459,24551,foJyfq5hSUj3jzVw8TG0nT1wv3hLMMNc,G8EPVSXsOYB5YQWZGiz1aVq5Pgr2GrQu,38,39,3,104,6,0,3,0,155,22.142857142857142,2,0.0,0,3,91,6,39,0,13,3,0,100,55,0
1460,24552,foJyfq5hSUj3jzVw8TG0nT1wv3hLMMNc,SpATywNh6bZuzm8s1ceuBUnMUAeoAHHw,17,28,1,12,3,0,6,0,50,7.142857142857143,4,0.0,2,1,11,3,26,0,1,6,0,17,33,0
1461,24569,VeFENcSXAiXgJQaSjlXiodtIBxgSrzaH,A3fsA9Zfv1X2fVEQhTw51lKENdNrEqT3,4,3,1,0,1,0,0,0,5,0.7142857142857143,1,0.0,0,1,0,1,3,0,0,0,0,2,3,1
1462,24587,f7pgA2Hp0s8DkqzKuvE0Kw8QRuoBh3Zv,RXDvfPUBYFlVdlueBFbLW0mhhAyGEqpt,21,12,5,40,2,0,1,0,60,8.571428571428571,1,0.0,5,5,36,2,7,0,4,1,0,48,12,0
1463,24602,tBWD1VTj6Jcj3AQ0AXY8eZtUzkjmoiNH,SpATywNh6bZuzm8s1ceuBUnMUAeoAHHw,26,55,1,19,1,3,19,2,100,14.285714285714286,7,0.0,8,1,16,1,47,3,3,19,2,26,74,0
1464,24632,zn2X74vvqUQRINz90WjZLsSsFglpYr7o,bWdj2GDclj5ofokWjzoa5jAwMkxCykd6,2,0,0,0,0,0,2,0,2,0.2857142857142857,1,0.0,0,0,0,0,0,0,0,2,0,0,2,1
1465,24639,V8bq19VRjJPQTPqkEHpwumnaTzC0PrkP,SpATywNh6bZuzm8s1ceuBUnMUAeoAHHw,28,39,5,20,3,0,10,0,77,11.0,4,0.0,5,5,17,3,34,0,3,10,0,30,47,0
1466,24640,a34YLXSKFcXb1SBjIduE3dfW4OSAFwK1,A3fsA9Zfv1X2fVEQhTw51lKENdNrEqT3,21,57,32,6,17,47,3,0,162,23.142857142857142,6,0.0,0,32,3,17,57,47,3,3,0,52,110,0
1467,24647,irfHUOmQ9hKgTbYvLuUeHyoDnnmQjKX2,SpATywNh6bZuzm8s1ceuBUnMUAeoAHHw,12,24,0,9,0,0,1,0,34,4.857142857142857,3,0.0,2,0,9,0,22,0,0,1,0,11,23,1
1468,24661,ZgPDgY8Y43cADkyBad03WZKNqaM99vmp,7GRhBDsirIGkRZBtSMEzNTyDr2JQm4xx,41,100,19,23,33,0,13,0,188,26.857142857142858,4,0.0,49,19,18,33,51,0,5,13,0,119,69,0
1469,24671,CujRQEMNAms1MfkSbNZMqIZ2ckRo2DyK,SpATywNh6bZuzm8s1ceuBUnMUAeoAHHw,24,13,12,0,12,0,1,0,38,5.428571428571429,1,0.0,0,12,0,12,13,0,0,1,0,24,14,1
1470,24720,umgqnQJ37y6QmsMhUUaPYa8Ra9JvurY1,RXDvfPUBYFlVdlueBFbLW0mhhAyGEqpt,40,31,2,96,5,10,8,2,154,22.0,2,0.0,13,2,91,5,18,10,5,8,2,111,43,1
1471,24733,hKPStE98N24xDjgawMiipqs6yqyYY1sR,A3fsA9Zfv1X2fVEQhTw51lKENdNrEqT3,25,21,17,0,17,0,4,0,59,8.428571428571429,2,0.0,0,17,0,17,21,0,0,4,0,34,25,1
1472,24744,S6vBzHKpSh31SFGGZmwgKaOH2RvW3RpH,bWdj2GDclj5ofokWjzoa5jAwMkxCykd6,16,22,12,26,7,1,12,1,81,11.571428571428571,1,0.0,3,12,20,7,19,1,6,12,1,42,39,1
1473,24771,zOqvR5SeTZmNwN7GW7m4oZ7a32WZgEDz,RXDvfPUBYFlVdlueBFbLW0mhhAyGEqpt,16,14,0,35,0,15,1,0,65,9.285714285714286,1,0.0,0,0,32,0,14,15,3,1,0,32,33,1
1474,24783,3b2PIBrJ06iLfdDIB9BTmuEwfL5TZfMa,RXDvfPUBYFlVdlueBFbLW0mhhAyGEqpt,5,6,3,0,0,0,2,0,11,1.5714285714285714,2,0.0,0,3,0,0,6,0,0,2,0,3,8,0
1475,24796,8tSKdZ8K9lE8Sg5tXOt7ENrj00lNonld,SpATywNh6bZuzm8s1ceuBUnMUAeoAHHw,12,10,0,12,0,0,2,0,24,3.4285714285714284,1,0.0,2,0,11,0,8,0,1,2,0,13,11,0
1476,24801,L3UNEJ1eeCeR9aybOSGMuUGRsyDaN7a4,bWdj2GDclj5ofokWjzoa5jAwMkxCykd6,6,3,1,0,1,0,3,0,8,1.1428571428571428,1,0.0,0,1,0,1,3,0,0,3,0,2,6,1
1477,24805,KRi80h1uK84snC5HvtQKWlsjwt9i3oa5,SpATywNh6bZuzm8s1ceuBUnMUAeoAHHw,9,7,4,9,1,0,1,0,22,3.142857142857143,1,0.0,2,4,9,1,5,0,0,1,0,16,6,0
1478,24842,jp9FX1owC1BGGjPOS9WG7gx9X0bMCATT,A3fsA9Zfv1X2fVEQhTw51lKENdNrEqT3,12,5,4,0,4,1,6,0,20,2.857142857142857,1,0.0,0,4,0,4,5,1,0,6,0,8,12,1
1479,24853,uk4lJc7hhDXtTbcWelQONZl266ZHWHlG,bWdj2GDclj5ofokWjzoa5jAwMkxCykd6,1,0,0,0,0,0,1,0,1,0.14285714285714285,1,0.0,0,0,0,0,0,0,0,1,0,0,1,1
1480,24866,8UmSY8k6lf4RKxdf5ricL28pLrACJVR9,SpATywNh6bZuzm8s1ceuBUnMUAeoAHHw,34,24,21,12,14,0,5,0,76,10.857142857142858,3,0.0,0,21,11,14,24,0,1,5,0,46,30,0
1481,24868,fyj3r6vk9lK8U7ImkbdH1MthcS6agXn7,SpATywNh6bZuzm8s1ceuBUnMUAeoAHHw,49,68,37,34,17,0,14,0,170,24.285714285714285,6,0.0,12,37,29,17,56,0,5,14,0,95,75,0
1482,24869,uk4lJc7hhDXtTbcWelQONZl266ZHWHlG,SpATywNh6bZuzm8s1ceuBUnMUAeoAHHw,5,2,1,0,1,0,2,0,6,0.8571428571428571,1,0.0,0,1,0,1,2,0,0,2,0,2,4,1
1483,24885,7AeiHdeG7nh46bg2JDAmPWtQ1zuvRpUT,A3fsA9Zfv1X2fVEQhTw51lKENdNrEqT3,10,9,2,0,0,0,3,0,14,2.0,1,0.0,0,2,0,0,9,0,0,3,0,2,12,0
1484,24886,rO1KHHxaPbWq8U3I08PqNPYplaZaPb83,RXDvfPUBYFlVdlueBFbLW0mhhAyGEqpt,44,24,22,0,21,0,3,0,70,10.0,2,0.0,0,22,0,21,24,0,0,3,0,43,27,1
1485,24896,0njFIWivrrj9Fy960ZZzqHbIMRcsR4hZ,5X6FeZozNMgE2VRi3MJYjkkFK8SETtu2,1,0,0,0,0,0,1,0,1,0.14285714285714285,1,0.0,0,0,0,0,0,0,0,1,0,0,1,1
1486,24909,pyd2EL5x8zMZ7LCIvrt0VYq229eSSKrd,SpATywNh6bZuzm8s1ceuBUnMUAeoAHHw,35,39,24,41,14,5,5,1,129,18.428571428571427,3,0.0,14,24,33,14,25,5,8,5,1,85,44,0
1487,24925,I1KwJ6EdCZnEPLfC8Q7yWpIkLOHn7h02,5X6FeZozNMgE2VRi3MJYjkkFK8SETtu2,4,2,1,0,1,0,2,0,6,0.8571428571428571,2,0.0,0,1,0,1,2,0,0,2,0,2,4,1
1488,24929,hCRoH0np1tajD5PHKKgVw7dH4NZJLfD2,A3fsA9Zfv1X2fVEQhTw51lKENdNrEqT3,73,45,38,144,27,32,8,0,294,42.0,8,0.0,2,38,119,27,43,32,25,8,0,186,108,0
1489,24942,DCwFNk2m7QLqdKcTT3u5CdSnRyl5YCHB,SpATywNh6bZuzm8s1ceuBUnMUAeoAHHw,5,3,2,0,0,0,2,0,7,1.0,1,0.0,0,2,0,0,3,0,0,2,0,2,5,1
1490,24945,rodgm0zI0P2ONVMZgr9w2JZEIK5qKGiW,bWdj2GDclj5ofokWjzoa5jAwMkxCykd6,5,2,1,0,1,0,2,0,6,0.8571428571428571,1,0.0,0,1,0,1,2,0,0,2,0,2,4,1
1491,24948,uFNLKo5bqJzWC9QIIX9vS1Tn11aB7Uzj,5X6FeZozNMgE2VRi3MJYjkkFK8SETtu2,16,33,5,6,12,0,19,1,76,10.857142857142858,4,0.0,20,5,6,12,13,0,0,19,1,43,33,1
1492,24952,agvJ7trZCSUWkipgduUE9TqoVxnUX1n1,G8EPVSXsOYB5YQWZGiz1aVq5Pgr2GrQu,83,175,76,34,67,0,17,0,369,52.714285714285715,2,0.0,2,76,31,67,173,0,3,17,0,176,193,1
1493,24968,BkozGGotFoRWvs7kivTQvwwV5JZ8hddc,SpATywNh6bZuzm8s1ceuBUnMUAeoAHHw,25,33,16,10,10,0,11,0,80,11.428571428571429,2,0.0,2,16,8,10,31,0,2,11,0,36,44,1
1494,24974,KKySZH8Vhrdd4z2bRf8FAPkHeGpE3JpX,RXDvfPUBYFlVdlueBFbLW0mhhAyGEqpt,18,22,2,0,0,0,6,0,30,4.285714285714286,3,0.0,0,2,0,0,22,0,0,6,0,2,28,0
1495,24976,KKySZH8Vhrdd4z2bRf8FAPkHeGpE3JpX,G8EPVSXsOYB5YQWZGiz1aVq5Pgr2GrQu,35,58,3,86,0,0,5,0,152,21.714285714285715,2,0.0,9,3,75,0,49,0,11,5,0,87,65,0
1496,24984,p8pFuUg19xWGOlJygMvSlQjonA3l7FUn,A3fsA9Zfv1X2fVEQhTw51lKENdNrEqT3,43,8,4,149,0,0,2,0,163,23.285714285714285,1,0.0,2,4,132,0,6,0,17,2,0,138,25,0
1497,24994,FP4hLkoHHSoDgNvvli0GZn0SfLgLxSLJ,5X6FeZozNMgE2VRi3MJYjkkFK8SETtu2,12,25,2,4,16,0,4,0,51,7.285714285714286,2,0.0,17,2,4,16,8,0,0,4,0,39,12,0
1498,24996,tLK32ryOHeiJecBcFzaTeN36vYEmQ8Nk,SpATywNh6bZuzm8s1ceuBUnMUAeoAHHw,12,8,5,0,3,0,4,0,20,2.857142857142857,1,0.0,0,5,0,3,8,0,0,4,0,8,12,1
1499,25007,KKySZH8Vhrdd4z2bRf8FAPkHeGpE3JpX,bWdj2GDclj5ofokWjzoa5jAwMkxCykd6,31,40,4,22,1,0,9,0,76,10.857142857142858,5,0.0,0,4,21,1,40,0,1,9,0,26,50,0
1500,25013,hei4w2KIPZzLJz63zWPLxls45GdSfJe0,bWdj2GDclj5ofokWjzoa5jAwMkxCykd6,5,4,1,0,2,0,2,0,9,1.2857142857142858,1,0.0,2,1,0,2,2,0,0,2,0,5,4,1
1501,25019,8ibVKkL5UrFgK6JKg8yfjyVvYk238T4p,5X6FeZozNMgE2VRi3MJYjkkFK8SETtu2,5,2,1,0,1,0,2,0,6,0.8571428571428571,1,0.0,0,1,0,1,2,0,0,2,0,2,4,1
1502,25020,XIT3vh7ciDFWTW9rM7KEuC2m7IOiQwcw,5X6FeZozNMgE2VRi3MJYjkkFK8SETtu2,13,12,2,18,4,0,4,0,40,5.714285714285714,3,0.0,7,2,16,4,5,0,2,4,0,29,11,1
1503,25022,DmRnf6emOOeLa4MI9vNggFDmgXu8cRIO,SpATywNh6bZuzm8s1ceuBUnMUAeoAHHw,26,30,14,46,1,35,17,1,144,20.571428571428573,3,0.0,11,14,43,1,19,35,3,17,1,69,75,0
1504,25027,DbZPQKpa8Qt5UWHmHKDItNooYyEfaZ0X,SpATywNh6bZuzm8s1ceuBUnMUAeoAHHw,41,71,41,31,23,1,14,1,182,26.0,5,0.0,22,41,28,23,49,1,3,14,1,114,68,0
1505,25033,BuZcYQWwWDSVZcqno1RGBiY1PDnVqtUZ,G8EPVSXsOYB5YQWZGiz1aVq5Pgr2GrQu,36,90,47,8,0,8,6,0,159,22.714285714285715,1,0.0,0,47,7,0,90,8,1,6,0,54,105,1
1506,25049,zkOr0wwuxAzYftPuxG6iQaCtbl1egkTS,A3fsA9Zfv1X2fVEQhTw51lKENdNrEqT3,40,12,10,60,8,0,5,0,95,13.571428571428571,1,0.0,1,10,53,8,11,0,7,5,0,72,23,0
1507,25066,46mPOafwambmi8gI5RDfSSG6CkqbcJr8,bWdj2GDclj5ofokWjzoa5jAwMkxCykd6,1,0,0,0,0,0,1,0,1,0.14285714285714285,1,0.0,0,0,0,0,0,0,0,1,0,0,1,1
1508,25067,aQ6WrdDe9pTNwVW3vmaMOs1pxy5r3Dxa,A3fsA9Zfv1X2fVEQhTw51lKENdNrEqT3,66,56,33,134,13,16,27,2,281,40.142857142857146,4,0.0,3,33,104,13,53,16,30,27,2,153,128,0
1509,25070,rBTfxwVs2POKvl7kZ0wlpqKQWxNS4JpH,bWdj2GDclj5ofokWjzoa5jAwMkxCykd6,5,2,0,0,0,0,3,0,5,0.7142857142857143,1,0.0,0,0,0,0,2,0,0,3,0,0,5,1
1510,25073,WQKoaWRi4j5EUCfZEZsK4LU6GIHATRae,SpATywNh6bZuzm8s1ceuBUnMUAeoAHHw,34,31,22,24,12,0,8,0,97,13.857142857142858,3,0.0,4,22,18,12,27,0,6,8,0,56,41,1
1511,25076,WQKoaWRi4j5EUCfZEZsK4LU6GIHATRae,A3fsA9Zfv1X2fVEQhTw51lKENdNrEqT3,23,28,20,0,15,4,10,0,77,11.0,3,0.0,0,20,0,15,28,4,0,10,0,35,42,1
1512,25081,8lyMyOM14BBuwJGJJ05LNI486l6zCvt9,G8EPVSXsOYB5YQWZGiz1aVq5Pgr2GrQu,72,117,25,177,14,1,8,0,342,48.857142857142854,6,0.0,0,25,150,14,117,1,27,8,0,189,153,0
1513,25091,vIBcYbs1BLdmaaP30fcE2FS7kB7v7QRn,5X6FeZozNMgE2VRi3MJYjkkFK8SETtu2,12,15,7,0,8,1,5,0,36,5.142857142857143,4,0.0,4,7,0,8,11,1,0,5,0,19,17,1
1514,25093,gI5Z44eMWR6ZJ3av3OUOPDUbSXNUhMWL,G8EPVSXsOYB5YQWZGiz1aVq5Pgr2GrQu,6,27,14,0,10,0,11,0,62,8.857142857142858,3,0.0,6,14,0,10,21,0,0,11,0,30,32,1
1515,25111,XQUx3MwVudtjeHmsju8PhHxsdXW0kluK,SpATywNh6bZuzm8s1ceuBUnMUAeoAHHw,33,60,35,26,18,37,20,0,196,28.0,4,0.0,10,35,24,18,50,37,2,20,0,87,109,0
1516,25134,tyleDimh7zmzFWTVgvg7bgaQaZGfwPk2,A3fsA9Zfv1X2fVEQhTw51lKENdNrEqT3,2,0,0,0,0,0,4,0,4,0.5714285714285714,2,0.0,0,0,0,0,0,0,0,4,0,0,4,0
1517,25168,hn3N1teM21fHZj3Va1VunKpgupbOlN1e,G8EPVSXsOYB5YQWZGiz1aVq5Pgr2GrQu,5,2,1,0,1,0,2,0,6,0.8571428571428571,1,0.0,0,1,0,1,2,0,0,2,0,2,4,1
1518,25179,Wv1aklktHgLr1Kkm3cAKn5mEcTvn8MRQ,SpATywNh6bZuzm8s1ceuBUnMUAeoAHHw,16,25,8,12,4,0,9,2,60,8.571428571428571,2,0.0,13,8,11,4,12,0,1,9,2,36,24,1
1519,25182,hGCwfWh9ySQVbALdmRR0HUMpPic5OOrw,bWdj2GDclj5ofokWjzoa5jAwMkxCykd6,2,0,0,0,0,25,1,0,26,3.7142857142857144,1,0.0,0,0,0,0,0,25,0,1,0,0,26,0
1520,25189,FP4hLkoHHSoDgNvvli0GZn0SfLgLxSLJ,A3fsA9Zfv1X2fVEQhTw51lKENdNrEqT3,9,5,0,0,0,0,4,0,9,1.2857142857142858,1,0.0,0,0,0,0,5,0,0,4,0,0,9,0
1521,25194,evrdwGhLAFWdgr0Clw2EFTM91w358eNP,SpATywNh6bZuzm8s1ceuBUnMUAeoAHHw,20,22,12,9,6,0,4,0,53,7.571428571428571,3,0.0,7,12,8,6,15,0,1,4,0,33,20,0
1522,25210,w6Jq91nutnXM9db4LCqDd346NIYOr0ts,bWdj2GDclj5ofokWjzoa5jAwMkxCykd6,1,0,0,0,0,0,1,0,1,0.14285714285714285,1,0.0,0,0,0,0,0,0,0,1,0,0,1,1
1523,25211,w6Jq91nutnXM9db4LCqDd346NIYOr0ts,RXDvfPUBYFlVdlueBFbLW0mhhAyGEqpt,1,0,0,0,0,0,1,0,1,0.14285714285714285,1,0.0,0,0,0,0,0,0,0,1,0,0,1,1
1524,25212,95whmOrr6ttgAKmA8d5EYFggt87ONgHi,SpATywNh6bZuzm8s1ceuBUnMUAeoAHHw,27,62,5,37,2,7,3,2,118,16.857142857142858,4,0.0,15,5,32,2,47,7,5,3,2,54,64,1
1525,25219,skOScgcMIkYsPXikHjLqvicjdb3rv6St,A3fsA9Zfv1X2fVEQhTw51lKENdNrEqT3,8,12,6,0,2,0,3,0,23,3.2857142857142856,2,0.0,0,6,0,2,12,0,0,3,0,8,15,1
1526,25227,oMeMGN5dWLI9b1NmVln2QTgmonaWkwwr,5X6FeZozNMgE2VRi3MJYjkkFK8SETtu2,2,0,0,0,0,0,2,0,2,0.2857142857142857,1,0.0,0,0,0,0,0,0,0,2,0,0,2,1
1527,25229,CFU5Hcmb88RpDCC1WRy61w8jF98WVrHg,SpATywNh6bZuzm8s1ceuBUnMUAeoAHHw,6,4,0,0,0,0,2,0,6,0.8571428571428571,1,0.0,0,0,0,0,4,0,0,2,0,0,6,0
1528,25235,BgFWtuiCvZoByaUpZ5qN1JDEWuWXlm2n,G8EPVSXsOYB5YQWZGiz1aVq5Pgr2GrQu,15,18,4,20,2,0,1,0,45,6.428571428571429,2,0.0,11,4,12,2,7,0,8,1,0,29,16,1
1529,25245,fwJOSE30dgFjd5HDygnvoRYJwTlCZZHQ,SpATywNh6bZuzm8s1ceuBUnMUAeoAHHw,7,3,2,0,2,0,2,0,9,1.2857142857142858,1,0.0,0,2,0,2,3,0,0,2,0,4,5,1
1530,25249,ycTj3YOXaJ7pHDIwrzbh7koMVXAXAOVY,bWdj2GDclj5ofokWjzoa5jAwMkxCykd6,19,26,18,0,12,1,7,1,65,9.285714285714286,4,0.0,5,18,0,12,21,1,0,7,1,35,30,0
1531,25258,eovSKdG09ZHYTXNtS1zUIy1RfsRsCibs,5X6FeZozNMgE2VRi3MJYjkkFK8SETtu2,1,0,0,0,0,0,1,0,1,0.14285714285714285,1,0.0,0,0,0,0,0,0,0,1,0,0,1,1
1532,25265,9va79rFsgW625mCi6PBHbhUMC5acSS5i,bWdj2GDclj5ofokWjzoa5jAwMkxCykd6,17,20,9,12,8,0,13,0,62,8.857142857142858,4,0.0,8,9,12,8,12,0,0,13,0,37,25,0
1533,25267,5ljcr0UvulJFpE7l8xjXUfhEEvQngZBn,RXDvfPUBYFlVdlueBFbLW0mhhAyGEqpt,17,21,6,18,5,0,11,3,64,9.142857142857142,1,0.0,9,6,13,5,12,0,5,11,3,33,31,1
1534,25277,7f2vx3DQNne1WBDg49zqZf9IbRsj8WIx,SpATywNh6bZuzm8s1ceuBUnMUAeoAHHw,39,96,5,56,2,2,15,3,179,25.571428571428573,3,0.0,16,5,46,2,80,2,10,15,3,69,110,1
1535,25284,6DpgdlGoKRdZ3TeMwKLdUESj04TqApO6,7GRhBDsirIGkRZBtSMEzNTyDr2JQm4xx,4,3,2,0,0,0,1,0,6,0.8571428571428571,1,0.0,0,2,0,0,3,0,0,1,0,2,4,1
1536,25285,8GY6nVtp5b50wDGijkY6exWcSNm7iEKc,A3fsA9Zfv1X2fVEQhTw51lKENdNrEqT3,5,2,1,0,1,0,5,0,9,1.2857142857142858,1,0.0,0,1,0,1,2,0,0,5,0,2,7,0
1537,25287,ETzcC9n39CwhBb4MTbqq1Ng4NqGIoiPj,SpATywNh6bZuzm8s1ceuBUnMUAeoAHHw,5,3,2,0,0,0,2,0,7,1.0,1,0.0,0,2,0,0,3,0,0,2,0,2,5,1
1538,25295,ETzcC9n39CwhBb4MTbqq1Ng4NqGIoiPj,bWdj2GDclj5ofokWjzoa5jAwMkxCykd6,4,2,1,0,0,0,2,0,5,0.7142857142857143,1,0.0,0,1,0,0,2,0,0,2,0,1,4,1
1539,25298,zKmoS7m0B5DOXQCEJhwtu5OAJkpItkzI,SpATywNh6bZuzm8s1ceuBUnMUAeoAHHw,49,40,34,15,20,0,6,0,115,16.428571428571427,4,0.0,0,34,12,20,40,0,3,6,0,66,49,0
1540,25299,NwQCoUHJKyAdqdG7U0utXO1oyZsmr8V3,A3fsA9Zfv1X2fVEQhTw51lKENdNrEqT3,99,89,32,202,17,2,18,0,360,51.42857142857143,7,0.0,3,32,182,17,86,2,20,18,0,234,126,0
1541,25303,mmqs9k1q1N6mK08e9WtlZS9NC3duFHeJ,5X6FeZozNMgE2VRi3MJYjkkFK8SETtu2,1,0,0,0,0,0,1,0,1,0.14285714285714285,1,0.0,0,0,0,0,0,0,0,1,0,0,1,1
1542,25315,skOScgcMIkYsPXikHjLqvicjdb3rv6St,5X6FeZozNMgE2VRi3MJYjkkFK8SETtu2,9,6,4,0,3,0,3,0,16,2.2857142857142856,3,0.0,0,4,0,3,6,0,0,3,0,7,9,1
1543,25327,HEmUYsQ9Ltj0MM8eYqBVagWQusNuFQuQ,RXDvfPUBYFlVdlueBFbLW0mhhAyGEqpt,5,2,1,0,1,0,2,0,6,0.8571428571428571,1,0.0,0,1,0,1,2,0,0,2,0,2,4,1
1544,25330,JQkQWFK6hvLU3dRb6IiKAH09cV6i6Ru3,SpATywNh6bZuzm8s1ceuBUnMUAeoAHHw,32,50,3,29,2,9,13,1,107,15.285714285714286,3,0.0,6,3,27,2,44,9,2,13,1,38,69,0
1545,25338,yMi75Aqo9j8H3qaYVwZOhYhugu84oiGL,bWdj2GDclj5ofokWjzoa5jAwMkxCykd6,1,0,0,0,0,0,1,0,1,0.14285714285714285,1,0.0,0,0,0,0,0,0,0,1,0,0,1,1
1546,25346,247FLfH4Mb594RFNNow4NoO1PsYj55Me,SpATywNh6bZuzm8s1ceuBUnMUAeoAHHw,7,5,2,0,2,0,5,0,14,2.0,2,0.0,0,2,0,2,5,0,0,5,0,4,10,1
1547,25347,gTKsgFH49hdtAMj9c1UQql70fl3l6ILe,SpATywNh6bZuzm8s1ceuBUnMUAeoAHHw,6,3,1,0,1,0,2,0,7,1.0,1,0.0,0,1,0,1,3,0,0,2,0,2,5,1
1548,25352,7R6kP05AQNpQLlS5bavbBVmFBtWsMm7c,5X6FeZozNMgE2VRi3MJYjkkFK8SETtu2,5,4,2,0,1,0,1,0,8,1.1428571428571428,1,0.0,1,2,0,1,3,0,0,1,0,4,4,1
1549,25371,tMJpDv6ZjEPz2ELzUVp4mZTT6G7u49T6,bWdj2GDclj5ofokWjzoa5jAwMkxCykd6,10,10,6,2,3,0,4,0,25,3.5714285714285716,3,0.0,1,6,2,3,9,0,0,4,0,12,13,0
1550,25382,vQWTE7gjUkICJ3AdoTOlEEWV39j5eqPv,5X6FeZozNMgE2VRi3MJYjkkFK8SETtu2,3,2,1,0,0,0,1,0,4,0.5714285714285714,1,0.0,0,1,0,0,2,0,0,1,0,1,3,1
1551,25386,kUY1XcyXvxmSBWMfpg75BTt5q6TEiVc4,bWdj2GDclj5ofokWjzoa5jAwMkxCykd6,9,9,3,0,2,0,7,1,22,3.142857142857143,2,0.0,2,3,0,2,7,0,0,7,1,7,15,0
1552,25391,1aQoKDna73jstuOrupWa9Kq8V3FdvbRU,A3fsA9Zfv1X2fVEQhTw51lKENdNrEqT3,4,3,1,0,0,0,1,0,5,0.7142857142857143,1,0.0,0,1,0,0,3,0,0,1,0,1,4,1
1553,25393,qfUwpJQAdesy8M2BZDMAUMfg4I7ObmXB,7GRhBDsirIGkRZBtSMEzNTyDr2JQm4xx,28,29,1,0,0,0,2,0,32,4.571428571428571,1,0.0,0,1,0,0,29,0,0,2,0,1,31,1
1554,25394,UWfjRAXX4Rb8j29dVudOzocpNXp7nal0,SpATywNh6bZuzm8s1ceuBUnMUAeoAHHw,34,48,0,39,0,12,16,0,115,16.428571428571427,2,0.0,15,0,37,0,33,12,2,16,0,52,63,0
1555,25401,avoglTQYC4DCKpMnGcRw7Ok57lEHfs0W,SpATywNh6bZuzm8s1ceuBUnMUAeoAHHw,6,4,3,0,1,0,4,0,12,1.7142857142857142,2,0.0,0,3,0,1,4,0,0,4,0,4,8,1
1556,25406,Ua8t7GvEqkquREwn5gCoNVwYmIqhqGMw,G8EPVSXsOYB5YQWZGiz1aVq5Pgr2GrQu,112,68,56,169,32,16,14,0,355,50.714285714285715,5,0.0,0,56,144,32,68,16,25,14,0,232,123,0
1557,25407,0mg5UfmflBvw9f6RP57AlBJRO9poj3Bs,RXDvfPUBYFlVdlueBFbLW0mhhAyGEqpt,1,0,0,0,0,0,1,0,1,0.14285714285714285,1,0.0,0,0,0,0,0,0,0,1,0,0,1,1
1558,25409,tvH2SB0L50iCqaXyQDY3u7qaByLbL0rV,RXDvfPUBYFlVdlueBFbLW0mhhAyGEqpt,7,6,1,0,1,0,1,0,9,1.2857142857142858,1,0.0,0,1,0,1,6,0,0,1,0,2,7,1
1559,25410,eLRb35TMSz5mhOV1jFWfgFHXl5MBmODw,SpATywNh6bZuzm8s1ceuBUnMUAeoAHHw,1,0,0,0,0,0,1,0,1,0.14285714285714285,1,0.0,0,0,0,0,0,0,0,1,0,0,1,1
1560,25411,zTKXcgMSZF7JvFUNYP705peyaFADazmR,bWdj2GDclj5ofokWjzoa5jAwMkxCykd6,12,17,9,38,3,2,7,1,77,11.0,2,0.0,6,9,36,3,11,2,2,7,1,54,23,0
1561,25414,JGLccTidDHJDu8gDiATpQDW1eozc4icT,G8EPVSXsOYB5YQWZGiz1aVq5Pgr2GrQu,6,7,3,0,1,0,3,0,14,2.0,1,0.0,0,3,0,1,7,0,0,3,0,4,10,1
1562,25425,uk5y5IHI3VEYZMMQy2ltt6P3PYfAG3X8,SpATywNh6bZuzm8s1ceuBUnMUAeoAHHw,22,18,15,0,10,0,7,0,50,7.142857142857143,2,0.0,0,15,0,10,18,0,0,7,0,25,25,1
1563,25437,fyUgBQuZCcUcBZn2eTOxyQlvAAh4aEgk,5X6FeZozNMgE2VRi3MJYjkkFK8SETtu2,6,2,1,0,0,0,4,1,8,1.1428571428571428,1,0.0,0,1,0,0,2,0,0,4,1,1,7,1
1564,25443,rpvfqHO7dPQYBUZWKnS2wc1t5Qy6pGj6,bWdj2GDclj5ofokWjzoa5jAwMkxCykd6,15,3,0,31,0,28,3,0,65,9.285714285714286,1,0.0,0,0,28,0,3,28,3,3,0,28,37,1
1565,25446,cUmqYT3vXiSNkNfCulTfjg26cA62ehB2,SpATywNh6bZuzm8s1ceuBUnMUAeoAHHw,15,16,6,0,6,0,1,0,29,4.142857142857143,1,0.0,0,6,0,6,16,0,0,1,0,12,17,1
1566,25458,GGeAJfigP0Xcr5t8L5L3jWFB8L2SPoPt,SpATywNh6bZuzm8s1ceuBUnMUAeoAHHw,6,2,1,0,1,0,3,0,7,1.0,1,0.0,0,1,0,1,2,0,0,3,0,2,5,1
1567,25461,TvoBOfhroHgtNwfOxtnATpVOdfdysLPf,SpATywNh6bZuzm8s1ceuBUnMUAeoAHHw,19,20,1,13,2,0,10,1,47,6.714285714285714,1,0.0,9,1,12,2,11,0,1,10,1,24,23,1
1568,25463,tCXa4pMsMXRuliZWNM9so3Odte6UmpYj,RXDvfPUBYFlVdlueBFbLW0mhhAyGEqpt,2,0,0,0,0,3,1,0,4,0.5714285714285714,1,0.0,0,0,0,0,0,3,0,1,0,0,4,1
1569,25465,PxlkoIm8C8IIjQF6yFywl21akC9ROids,A3fsA9Zfv1X2fVEQhTw51lKENdNrEqT3,2,0,0,0,0,0,3,0,3,0.42857142857142855,1,0.0,0,0,0,0,0,0,0,3,0,0,3,1
1570,25471,qfUwpJQAdesy8M2BZDMAUMfg4I7ObmXB,A3fsA9Zfv1X2fVEQhTw51lKENdNrEqT3,6,2,1,0,1,0,3,0,7,1.0,1,0.0,0,1,0,1,2,0,0,3,0,2,5,0
1571,25487,6ybUHpN1mcOdThgiQaLfQfBvlnH7diq3,RXDvfPUBYFlVdlueBFbLW0mhhAyGEqpt,42,36,1,120,5,36,4,19,221,31.571428571428573,2,0.0,13,1,108,5,23,36,12,4,19,127,94,0
1572,25494,mI5nNgUr8qgf317y3rTEFMpgeTfF7Wxj,SpATywNh6bZuzm8s1ceuBUnMUAeoAHHw,4,3,1,0,1,0,3,0,8,1.1428571428571428,1,0.0,0,1,0,1,3,0,0,3,0,2,6,1
1573,25503,XQUx3MwVudtjeHmsju8PhHxsdXW0kluK,G8EPVSXsOYB5YQWZGiz1aVq5Pgr2GrQu,53,83,47,80,21,0,13,0,244,34.857142857142854,2,0.0,21,47,72,21,62,0,8,13,0,161,83,1
1574,25506,KxUR8ZwyS3V9tRQMRPUJfNwham9GOgQR,SpATywNh6bZuzm8s1ceuBUnMUAeoAHHw,18,15,3,9,2,0,9,2,40,5.714285714285714,3,0.0,2,3,8,2,13,0,1,9,2,15,25,1
1575,25507,jNbqtigMn2EmtZpiK0urYvur6p2mGuL2,bWdj2GDclj5ofokWjzoa5jAwMkxCykd6,29,27,18,26,9,5,17,0,102,14.571428571428571,4,0.0,2,18,13,9,25,5,13,17,0,42,60,1
1576,25511,RtpaISGKG8FC1poFd4XAu8898XLnl6EI,SpATywNh6bZuzm8s1ceuBUnMUAeoAHHw,25,61,19,22,5,18,38,2,165,23.571428571428573,7,0.0,17,19,17,5,44,18,5,38,2,58,107,0
1577,25527,qEjaWdK86bYd7lCS9YD68MsK6migCUpH,SpATywNh6bZuzm8s1ceuBUnMUAeoAHHw,17,20,8,13,5,0,4,0,50,7.142857142857143,3,0.0,6,8,10,5,14,0,3,4,0,29,21,0
1578,25543,XgTmtBqLznxfF9SYrnaNPxmtPq6mixPB,SpATywNh6bZuzm8s1ceuBUnMUAeoAHHw,15,17,8,0,4,5,5,0,39,5.571428571428571,2,0.0,2,8,0,4,15,5,0,5,0,14,25,1
1579,25546,rfOApTbQ4xF2665bHZIBhoJqQcTU6i9L,A3fsA9Zfv1X2fVEQhTw51lKENdNrEqT3,35,28,16,54,6,7,12,0,123,17.571428571428573,3,0.0,3,16,49,6,25,7,5,12,0,74,49,1
1580,25550,h2w8VkYmfNNCtKcYCoxPznAcsJxmWEEX,G8EPVSXsOYB5YQWZGiz1aVq5Pgr2GrQu,3,2,0,0,0,0,1,0,3,0.42857142857142855,1,0.0,0,0,0,0,2,0,0,1,0,0,3,1
1581,25552,OL3EuzPtZh7LsYXjzzPmtbrDH2VopR0Y,bWdj2GDclj5ofokWjzoa5jAwMkxCykd6,3,2,1,0,0,7,1,0,11,1.5714285714285714,1,0.0,0,1,0,0,2,7,0,1,0,1,10,0
1582,25557,awWzPHJHqMsVq81riWKDgsPCoY61Vh2P,G8EPVSXsOYB5YQWZGiz1aVq5Pgr2GrQu,21,49,13,14,12,2,14,0,104,14.857142857142858,2,0.0,29,13,11,12,20,2,3,14,0,65,39,0
1583,25569,wALAK8dgjZ2TZgGWVmCaa7YdyCcneRp7,G8EPVSXsOYB5YQWZGiz1aVq5Pgr2GrQu,9,14,1,0,1,1,14,1,32,4.571428571428571,2,0.0,0,1,0,1,14,1,0,14,1,2,30,1
1584,25578,X8AWHZvCEUWZQfbJnH8OYCI17lAwXaHx,SpATywNh6bZuzm8s1ceuBUnMUAeoAHHw,3,0,0,0,0,0,3,0,3,0.42857142857142855,1,0.0,0,0,0,0,0,0,0,3,0,0,3,1
1585,25588,fEjyEDOkalYa6eH46cG6UcR1E7twiXyF,SpATywNh6bZuzm8s1ceuBUnMUAeoAHHw,36,53,24,35,13,77,17,0,219,31.285714285714285,6,0.0,9,24,29,13,44,77,6,17,0,75,144,0
1586,25589,3Oka5GvBd9TakXRvr9D5vxoJEhxwuxJA,SpATywNh6bZuzm8s1ceuBUnMUAeoAHHw,4,4,2,0,0,0,4,0,10,1.4285714285714286,3,0.0,0,2,0,0,4,0,0,4,0,2,8,0
1587,25591,EoNh9d9qcnIUVTAskhVjs6Md9kUsxJde,SpATywNh6bZuzm8s1ceuBUnMUAeoAHHw,50,79,49,22,14,20,31,1,216,30.857142857142858,3,0.0,16,49,21,14,63,20,1,31,1,100,116,0
1588,25603,7D3GwZKw33BY2nf2pXW93DDrNPoqNI5y,SpATywNh6bZuzm8s1ceuBUnMUAeoAHHw,4,2,1,0,1,0,1,0,5,0.7142857142857143,1,0.0,0,1,0,1,2,0,0,1,0,2,3,1
1589,25607,s5bmHBniKJzstjkFlsJcJn6YQEnj7XjP,SpATywNh6bZuzm8s1ceuBUnMUAeoAHHw,19,20,12,13,5,14,7,0,71,10.142857142857142,4,0.0,3,12,11,5,17,14,2,7,0,31,40,0
1590,25635,F1N61tazho7ZYPRPggPaCszBndAmmJFa,SpATywNh6bZuzm8s1ceuBUnMUAeoAHHw,1,0,0,0,0,0,1,0,1,0.14285714285714285,1,0.0,0,0,0,0,0,0,0,1,0,0,1,1
1591,25640,AzvqiXd9z7PBzvgEy7E2cJ7lqAkLcj7V,G8EPVSXsOYB5YQWZGiz1aVq5Pgr2GrQu,47,118,43,8,29,4,7,1,210,30.0,2,0.0,68,43,6,29,50,4,2,7,1,146,64,0
1592,25649,IePFEx0pR5xLGQlWWjU59zR6qxTHOeo0,bWdj2GDclj5ofokWjzoa5jAwMkxCykd6,1,0,0,0,0,0,2,0,2,0.2857142857142857,2,0.0,0,0,0,0,0,0,0,2,0,0,2,0
1593,25655,TOdJr6wpv1Do14qMOudEcAu5ZtPnzG5P,SpATywNh6bZuzm8s1ceuBUnMUAeoAHHw,14,12,0,8,0,0,7,0,27,3.857142857142857,2,0.0,2,0,8,0,10,0,0,7,0,10,17,0
1594,25669,s24Qk0ZpAXR97ldBDtgP8DE6rT8or69U,5X6FeZozNMgE2VRi3MJYjkkFK8SETtu2,1,0,0,0,0,0,1,0,1,0.14285714285714285,1,0.0,0,0,0,0,0,0,0,1,0,0,1,1
1595,25675,wgifE6A0kxnDEjw7myKTY39TRuCgYxaB,A3fsA9Zfv1X2fVEQhTw51lKENdNrEqT3,8,10,1,0,1,0,2,0,14,2.0,1,0.0,1,1,0,1,9,0,0,2,0,3,11,1
1596,25678,8hHM4gMR8PLgcGE0KxgxZ4wD71iRPNWp,RXDvfPUBYFlVdlueBFbLW0mhhAyGEqpt,47,85,30,46,24,0,10,0,195,27.857142857142858,3,0.0,29,30,45,24,56,0,1,10,0,128,67,1
1597,25695,UZwAq0BsEX4YZo6rl8WmMkIdjQj4pFYs,A3fsA9Zfv1X2fVEQhTw51lKENdNrEqT3,2,0,0,0,0,0,2,0,2,0.2857142857142857,1,0.0,0,0,0,0,0,0,0,2,0,0,2,1
1598,25706,udBjfCluZTte9l6GhqqG4v3kEGoKKcxC,SpATywNh6bZuzm8s1ceuBUnMUAeoAHHw,32,88,40,29,7,1,22,0,187,26.714285714285715,4,0.0,39,40,24,7,49,1,5,22,0,110,77,0
1599,25720,v0qndwa3TlbOqgdTUBH2afnl049VDWzU,SpATywNh6bZuzm8s1ceuBUnMUAeoAHHw,34,46,27,20,13,0,9,0,115,16.428571428571427,6,0.0,9,27,18,13,37,0,2,9,0,67,48,0
1600,25733,AHQHegrW1VuEGnFOHlvBpkb4mWL3NKW9,SpATywNh6bZuzm8s1ceuBUnMUAeoAHHw,25,95,39,27,9,31,25,0,226,32.285714285714285,5,0.0,22,39,25,9,73,31,2,25,0,95,131,0
1601,25761,Y3GsHv1t2an649bMll1LdxvN2SIICjxG,SpATywNh6bZuzm8s1ceuBUnMUAeoAHHw,3,4,2,0,0,0,2,0,8,1.1428571428571428,2,0.0,0,2,0,0,4,0,0,2,0,2,6,0
1602,25769,YGm3RWWdh53qv43WofC48V9ZiIjgJjMn,5X6FeZozNMgE2VRi3MJYjkkFK8SETtu2,22,121,36,33,48,0,18,0,256,36.57142857142857,7,0.0,45,36,26,48,76,0,7,18,0,155,101,0
1603,25773,xYLJB56SVkFUOdT5vN3Qq6OYNlnP0Fjc,7GRhBDsirIGkRZBtSMEzNTyDr2JQm4xx,18,17,2,10,1,0,1,0,31,4.428571428571429,2,0.0,1,2,5,1,16,0,5,1,0,9,22,1
1604,25804,E7Frt6tr6owhsgLSRkD2PqDaTSKmNLId,7GRhBDsirIGkRZBtSMEzNTyDr2JQm4xx,5,5,3,0,1,0,2,0,11,1.5714285714285714,1,0.0,1,3,0,1,4,0,0,2,0,5,6,1
1605,25805,qqSaKArI5Op1lhuHFwwbocKm10S49aF1,SpATywNh6bZuzm8s1ceuBUnMUAeoAHHw,1,0,0,0,0,0,1,0,1,0.14285714285714285,1,0.0,0,0,0,0,0,0,0,1,0,0,1,1
1606,25810,UQiycJIWxo787KsYZuzobncCMSKPzxGe,5X6FeZozNMgE2VRi3MJYjkkFK8SETtu2,1,0,0,0,0,0,1,0,1,0.14285714285714285,1,0.0,0,0,0,0,0,0,0,1,0,0,1,1
1607,25814,XfsOspDiOb9wQgSI2MsAsoTalG7mdDaH,A3fsA9Zfv1X2fVEQhTw51lKENdNrEqT3,5,5,1,0,0,0,1,0,7,1.0,1,0.0,0,1,0,0,5,0,0,1,0,1,6,1
1608,25816,lMefkcgNh5NMvOXiUOkNuemhw07vFq2i,SpATywNh6bZuzm8s1ceuBUnMUAeoAHHw,32,51,20,30,9,0,6,0,116,16.571428571428573,3,0.0,26,20,28,9,25,0,2,6,0,83,33,0
1609,25817,vgUJoEnyrwMGcP0OV3aAYopOjqSc90Hb,SpATywNh6bZuzm8s1ceuBUnMUAeoAHHw,1,0,0,0,0,0,1,0,1,0.14285714285714285,1,0.0,0,0,0,0,0,0,0,1,0,0,1,1
1610,25821,bGjAPcjyWibYHQ9W6Dqgwo4LQHZPkLcJ,SpATywNh6bZuzm8s1ceuBUnMUAeoAHHw,5,2,1,0,1,0,2,0,6,0.8571428571428571,1,0.0,0,1,0,1,2,0,0,2,0,2,4,0
1611,25826,mLf710wFmDQbZB0X7jv0DPpqMqjMZwPk,SpATywNh6bZuzm8s1ceuBUnMUAeoAHHw,8,8,3,0,1,1,5,0,18,2.5714285714285716,1,0.0,0,3,0,1,8,1,0,5,0,4,14,1
1612,25841,2h3ZbyGedZ9L0JEpwRsnOZF5HOvOErqj,bWdj2GDclj5ofokWjzoa5jAwMkxCykd6,17,21,10,6,9,0,3,0,49,7.0,2,0.0,1,10,5,9,20,0,1,3,0,25,24,0
1613,25858,OgzxsS34Z691nR1xoz9Qyc7Bh9Mh9a1o,bWdj2GDclj5ofokWjzoa5jAwMkxCykd6,51,50,17,258,15,2,6,1,349,49.857142857142854,5,0.0,20,17,231,15,30,2,27,6,1,283,66,0
1614,25866,pthM90ZamxN8tQ9QKxTMt4KHsxOLgVEd,SpATywNh6bZuzm8s1ceuBUnMUAeoAHHw,42,43,28,45,16,0,17,0,149,21.285714285714285,4,0.0,6,28,41,16,37,0,4,17,0,91,58,0
1615,25900,NRMzH6tZyLT2qk2QIkwNRbUliCMPz2WK,A3fsA9Zfv1X2fVEQhTw51lKENdNrEqT3,3,2,0,0,0,0,1,0,3,0.42857142857142855,1,0.0,0,0,0,0,2,0,0,1,0,0,3,0
1616,25915,iyIAPlnIEma306NSolsaccbjttZIVUuH,SpATywNh6bZuzm8s1ceuBUnMUAeoAHHw,21,25,14,13,5,0,10,0,67,9.571428571428571,5,0.0,5,14,12,5,20,0,1,10,0,36,31,0
1617,25925,C7DPJtUIccHcm7HmAie0ZedGLshK4YlB,5X6FeZozNMgE2VRi3MJYjkkFK8SETtu2,2,0,0,0,0,0,2,0,2,0.2857142857142857,1,0.0,0,0,0,0,0,0,0,2,0,0,2,1
1618,25927,OrVbBbY1FlOrLC1xq9uXlMrFdoBE11eg,SpATywNh6bZuzm8s1ceuBUnMUAeoAHHw,19,18,11,7,6,12,6,0,60,8.571428571428571,3,0.0,2,11,7,6,16,12,0,6,0,26,34,0
1619,25929,4mX2CUhzJC73htcqhEjZH6Xi9XbeT2fH,A3fsA9Zfv1X2fVEQhTw51lKENdNrEqT3,4,2,1,0,1,1,3,0,8,1.1428571428571428,1,0.0,0,1,0,1,2,1,0,3,0,2,6,1
1620,25936,Q0eCH09NIGOawcyrOKgsrxZbMJuOLuiw,A3fsA9Zfv1X2fVEQhTw51lKENdNrEqT3,4,6,3,0,0,0,17,0,26,3.7142857142857144,4,0.0,0,3,0,0,6,0,0,17,0,3,23,0
1621,25939,Krxyy23fZ28ymHlUM9cR68oteYOpMEoc,bWdj2GDclj5ofokWjzoa5jAwMkxCykd6,12,25,1,0,3,1,12,2,44,6.285714285714286,1,0.0,9,1,0,3,16,1,0,12,2,13,31,0
1622,25945,Xl7O5Es6VpkB2PrTgzArkv7OwJ7XzlEg,SpATywNh6bZuzm8s1ceuBUnMUAeoAHHw,40,77,28,37,16,23,19,2,202,28.857142857142858,5,0.0,7,28,32,16,70,23,5,19,2,83,119,0
1623,25951,piSFwoJk8ecTZvpcQFfQWuNzR6UBK2aS,5X6FeZozNMgE2VRi3MJYjkkFK8SETtu2,5,6,0,0,0,1,4,0,11,1.5714285714285714,1,0.0,0,0,0,0,6,1,0,4,0,0,11,1
1624,25956,iHFiZ9SvBVcIu7YGo4eFTUpkfFG44jX7,SpATywNh6bZuzm8s1ceuBUnMUAeoAHHw,4,3,1,0,0,0,1,0,5,0.7142857142857143,1,0.0,0,1,0,0,3,0,0,1,0,1,4,0
1625,25990,Y5AX6ZQ5Ugwn3sD9xwZmBQdLr2GbgKTx,G8EPVSXsOYB5YQWZGiz1aVq5Pgr2GrQu,10,7,2,6,2,3,7,0,27,3.857142857142857,2,0.0,3,2,5,2,4,3,1,7,0,12,15,1
1626,25993,epAPsdfp9ACpY4GkQi5b2cGQoRKMZ8n2,5X6FeZozNMgE2VRi3MJYjkkFK8SETtu2,2,0,0,0,0,0,2,0,2,0.2857142857142857,1,0.0,0,0,0,0,0,0,0,2,0,0,2,1
1627,25996,SZubyOjBBeLTq3a8W8wnSD4ealAJaYwc,SpATywNh6bZuzm8s1ceuBUnMUAeoAHHw,15,22,2,18,2,1,4,0,49,7.0,2,0.0,11,2,15,2,11,1,3,4,0,30,19,1
1628,26009,RADrfrSrqd2D1lhkJRYdtWMv0TybV2Zk,A3fsA9Zfv1X2fVEQhTw51lKENdNrEqT3,4,3,0,0,0,0,1,0,4,0.5714285714285714,1,0.0,0,0,0,0,3,0,0,1,0,0,4,1
1629,26020,Jag1EXQWfAuTRiCgcVLyhRRkdOL9RtSD,A3fsA9Zfv1X2fVEQhTw51lKENdNrEqT3,56,29,27,0,24,0,12,3,95,13.571428571428571,4,0.0,0,27,0,24,29,0,0,12,3,51,44,1
1630,26024,niLMw8MCObO7SSR2V1jNg9WQt5oSjDFJ,7GRhBDsirIGkRZBtSMEzNTyDr2JQm4xx,7,5,2,0,1,1,3,0,12,1.7142857142857142,1,0.0,2,2,0,1,3,1,0,3,0,5,7,1
1631,26028,O0GD5bq4HX44FjCMV4VF4e6soOzsH9jU,SpATywNh6bZuzm8s1ceuBUnMUAeoAHHw,13,21,15,0,11,0,5,0,52,7.428571428571429,4,0.0,3,15,0,11,18,0,0,5,0,29,23,0
1632,26064,bmnzCBeFMMY9XczD2LcVJyXeCKQk1fV4,bWdj2GDclj5ofokWjzoa5jAwMkxCykd6,71,51,31,134,11,177,36,6,446,63.714285714285715,5,0.0,12,31,120,11,39,177,14,36,6,174,272,0
1633,26078,ByDjTuY0oLVzrle7JgW0XGlu5bLAo5Uj,SpATywNh6bZuzm8s1ceuBUnMUAeoAHHw,26,56,2,24,2,5,10,0,99,14.142857142857142,5,0.0,12,2,21,2,44,5,3,10,0,37,62,0
1634,26095,a8dc0CK321Gme12CyOEdOb6nUx65n0O0,G8EPVSXsOYB5YQWZGiz1aVq5Pgr2GrQu,7,3,1,0,1,1,4,0,10,1.4285714285714286,1,0.0,0,1,0,1,3,1,0,4,0,2,8,1
1635,26096,YCRseUDvArFRrEstKkCnaObaGD8ujRKN,SpATywNh6bZuzm8s1ceuBUnMUAeoAHHw,1,0,0,0,0,0,2,0,2,0.2857142857142857,1,0.0,0,0,0,0,0,0,0,2,0,0,2,1
1636,26109,a8dc0CK321Gme12CyOEdOb6nUx65n0O0,A3fsA9Zfv1X2fVEQhTw51lKENdNrEqT3,6,5,2,0,1,0,2,0,10,1.4285714285714286,1,0.0,0,2,0,1,5,0,0,2,0,3,7,1
1637,26113,urk9rrR5tBeZ6421Kpoux7grZg4UgaZm,SpATywNh6bZuzm8s1ceuBUnMUAeoAHHw,1,0,0,0,0,0,1,0,1,0.14285714285714285,1,0.0,0,0,0,0,0,0,0,1,0,0,1,1
1638,26131,bOZulvf2pZbiVc3YTWa6AH2rsP2ovTUK,5X6FeZozNMgE2VRi3MJYjkkFK8SETtu2,22,81,6,31,35,0,1,0,154,22.0,7,0.0,65,6,26,35,16,0,5,1,0,132,22,1
1639,26149,uBTGUyw0foT4aMjENrCp1a840IjnLELO,SpATywNh6bZuzm8s1ceuBUnMUAeoAHHw,29,38,23,39,0,7,10,1,118,16.857142857142858,5,0.0,11,23,32,0,27,7,7,10,1,66,52,0
1640,26151,fZNr9qlThHhgXbezYnWjuEvl2yTJxr3j,SpATywNh6bZuzm8s1ceuBUnMUAeoAHHw,4,2,1,0,1,0,2,0,6,0.8571428571428571,1,0.0,0,1,0,1,2,0,0,2,0,2,4,1
1641,26152,xfB7JXhtbd9UDGft4eYtRwZAYUFQa2nu,SpATywNh6bZuzm8s1ceuBUnMUAeoAHHw,31,42,19,23,9,12,11,2,118,16.857142857142858,3,0.0,15,19,21,9,27,12,2,11,2,64,54,0
1642,26171,aAcGelZbAzE1VNtMYp15u6evXjd8L864,A3fsA9Zfv1X2fVEQhTw51lKENdNrEqT3,12,8,1,0,1,2,11,1,24,3.4285714285714284,2,0.0,0,1,0,1,8,2,0,11,1,2,22,1
1643,26176,c632QS0HPEwiPyoLxgHwOrVRerl5QVSU,SpATywNh6bZuzm8s1ceuBUnMUAeoAHHw,12,6,6,0,6,0,8,0,26,3.7142857142857144,2,0.0,0,6,0,6,6,0,0,8,0,12,14,1
1644,26177,h8RigcaknBAbfxFRHBW4VasAGH2IDwWq,SpATywNh6bZuzm8s1ceuBUnMUAeoAHHw,1,0,0,0,0,0,2,0,2,0.2857142857142857,1,0.0,0,0,0,0,0,0,0,2,0,0,2,1
1645,26189,h8RigcaknBAbfxFRHBW4VasAGH2IDwWq,A3fsA9Zfv1X2fVEQhTw51lKENdNrEqT3,5,2,1,0,1,0,2,0,6,0.8571428571428571,1,0.0,0,1,0,1,2,0,0,2,0,2,4,1
1646,26196,Pp6wRQkPti9Bk2fBcpI0VrxeT3AtZv4c,bWdj2GDclj5ofokWjzoa5jAwMkxCykd6,1,0,0,0,0,0,1,0,1,0.14285714285714285,1,0.0,0,0,0,0,0,0,0,1,0,0,1,1
1647,26200,9KmImulU8dfYAWqjxKwNzHRnkRXTnV2z,A3fsA9Zfv1X2fVEQhTw51lKENdNrEqT3,1,0,0,0,0,0,1,0,1,0.14285714285714285,1,0.0,0,0,0,0,0,0,0,1,0,0,1,1
1648,26201,dQeQGMqD2AfjLt9WMqT1wjR4i8srmTVY,SpATywNh6bZuzm8s1ceuBUnMUAeoAHHw,16,18,11,2,5,1,2,0,39,5.571428571428571,3,0.0,5,11,2,5,13,1,0,2,0,23,16,0
1649,26202,9KmImulU8dfYAWqjxKwNzHRnkRXTnV2z,bWdj2GDclj5ofokWjzoa5jAwMkxCykd6,1,0,0,0,0,0,1,0,1,0.14285714285714285,1,0.0,0,0,0,0,0,0,0,1,0,0,1,1
1650,26214,SB3PBvXY4EEkcNDmtIOX6bpu8RFJOU8W,G8EPVSXsOYB5YQWZGiz1aVq5Pgr2GrQu,4,7,2,0,0,0,1,0,10,1.4285714285714286,1,0.0,4,2,0,0,3,0,0,1,0,6,4,1
1651,26225,mXG0NG89PIYgsz8VTv4xH5Wr0KVwE4Z5,G8EPVSXsOYB5YQWZGiz1aVq5Pgr2GrQu,26,36,0,50,0,12,15,9,122,17.428571428571427,1,0.0,19,0,36,0,17,12,14,15,9,55,67,1
1652,26244,2EOw8IdpJR7gJqo77SwHRhwFw89UUu0T,RXDvfPUBYFlVdlueBFbLW0mhhAyGEqpt,1,0,0,0,0,0,1,0,1,0.14285714285714285,1,0.0,0,0,0,0,0,0,0,1,0,0,1,1
1653,26245,SrYdmWsdLgR34Xuoeb5msz3OavGm9rEt,SpATywNh6bZuzm8s1ceuBUnMUAeoAHHw,25,34,14,0,9,0,2,0,59,8.428571428571429,1,0.0,18,14,0,9,16,0,0,2,0,41,18,0
1654,26266,x0laSvoDXG0a7WULReVXZ8zh05t91jGU,5X6FeZozNMgE2VRi3MJYjkkFK8SETtu2,93,293,127,2,152,0,42,0,616,88.0,5,0.0,114,127,2,152,179,0,0,42,0,395,221,0
1655,26268,tynbQ4TjTy74SqA5UqLPd55W0CYMmxkv,bWdj2GDclj5ofokWjzoa5jAwMkxCykd6,27,41,21,64,4,32,13,1,176,25.142857142857142,4,0.0,10,21,54,4,31,32,10,13,1,89,87,0
1656,26269,yQYMLm30GwIRmqXNc4Jn3nUgA6vXILUA,SpATywNh6bZuzm8s1ceuBUnMUAeoAHHw,18,13,0,31,0,15,26,3,88,12.571428571428571,2,0.0,6,0,26,0,7,15,5,26,3,32,56,1
1657,26275,PSNpE96w64UzqJ7izDn4zKyoyc3uU8P4,SpATywNh6bZuzm8s1ceuBUnMUAeoAHHw,38,79,46,19,22,10,17,3,196,28.0,7,0.0,6,46,17,22,73,10,2,17,3,91,105,0
1658,26300,skOScgcMIkYsPXikHjLqvicjdb3rv6St,G8EPVSXsOYB5YQWZGiz1aVq5Pgr2GrQu,7,6,3,0,2,0,3,0,14,2.0,1,0.0,0,3,0,2,6,0,0,3,0,5,9,1
1659,26313,2GvmVu0Ap1CyxuPiFvFTtv7YJJqNkAe0,5X6FeZozNMgE2VRi3MJYjkkFK8SETtu2,12,15,2,20,4,0,3,0,44,6.285714285714286,1,0.0,7,2,15,4,8,0,5,3,0,28,16,1
1660,26317,Ke04PwAVtaYumEPrCNIyUmIZgpnMElWJ,SpATywNh6bZuzm8s1ceuBUnMUAeoAHHw,10,9,6,4,2,0,1,0,22,3.142857142857143,1,0.0,2,6,4,2,7,0,0,1,0,14,8,1
1661,26328,XkJ6yDVwDuqxrBS1qaJeiIQkhGh99YN5,SpATywNh6bZuzm8s1ceuBUnMUAeoAHHw,62,66,38,37,25,9,14,5,194,27.714285714285715,5,0.0,9,38,32,25,57,9,5,14,5,104,90,0
1662,26331,4iOUNXqQpqxIlccZB4bn3VqeRpS9Wajj,SpATywNh6bZuzm8s1ceuBUnMUAeoAHHw,31,24,12,23,8,2,5,1,75,10.714285714285714,1,0.0,10,12,22,8,14,2,1,5,1,52,23,0
1663,26340,nLSyDmuwtZ9VcSdeL7kW6FG97w0wmm94,SpATywNh6bZuzm8s1ceuBUnMUAeoAHHw,29,42,24,19,9,5,6,0,105,15.0,4,0.0,12,24,15,9,30,5,4,6,0,60,45,0
1664,26353,EHRxEuwJ6W1Usro8hvBy0CGhrazjH6cO,SpATywNh6bZuzm8s1ceuBUnMUAeoAHHw,17,26,20,0,12,0,3,0,61,8.714285714285714,5,0.0,0,20,0,12,26,0,0,3,0,32,29,0
1665,26356,DRiuKqDradfNPZFfU0uOeVbFklDHBL0k,SpATywNh6bZuzm8s1ceuBUnMUAeoAHHw,12,11,9,4,0,0,3,0,27,3.857142857142857,1,0.0,0,9,4,0,11,0,0,3,0,13,14,1
1666,26357,BNkiF9A7J88AJfBxuk7BTxSVookFJYSj,SpATywNh6bZuzm8s1ceuBUnMUAeoAHHw,21,23,1,12,0,9,15,1,61,8.714285714285714,4,0.0,2,1,11,0,21,9,1,15,1,14,47,0
1667,26378,2GvmVu0Ap1CyxuPiFvFTtv7YJJqNkAe0,G8EPVSXsOYB5YQWZGiz1aVq5Pgr2GrQu,37,48,10,78,7,1,9,1,154,22.0,2,0.0,25,10,57,7,23,1,21,9,1,99,55,0
1668,26390,4BpRE14XuCFERPNFltqE4ojcMHw6pKyT,SpATywNh6bZuzm8s1ceuBUnMUAeoAHHw,9,17,11,0,6,0,4,0,38,5.428571428571429,3,0.0,0,11,0,6,17,0,0,4,0,17,21,0
1669,26395,xjWkEdO0xALsCMyXVJLQ76Q1mnSHD20m,A3fsA9Zfv1X2fVEQhTw51lKENdNrEqT3,9,19,5,0,3,2,7,0,36,5.142857142857143,1,0.0,0,5,0,3,19,2,0,7,0,8,28,1
1670,26398,x4ez09GGWUnioTSf6qckx5goNY5giLKq,7GRhBDsirIGkRZBtSMEzNTyDr2JQm4xx,11,11,4,4,2,0,4,0,25,3.5714285714285716,3,0.0,3,4,4,2,8,0,0,4,0,13,12,0
1671,26399,Ke04PwAVtaYumEPrCNIyUmIZgpnMElWJ,A3fsA9Zfv1X2fVEQhTw51lKENdNrEqT3,3,4,2,0,0,0,4,0,10,1.4285714285714286,2,0.0,0,2,0,0,4,0,0,4,0,2,8,1
1672,26400,CHqrwi1Tduj0lJDshmIQF8r1aAWdEqsJ,G8EPVSXsOYB5YQWZGiz1aVq5Pgr2GrQu,16,10,7,0,4,13,8,1,43,6.142857142857143,1,0.0,0,7,0,4,10,13,0,8,1,11,32,0
1673,26417,aX9OEOkANl9FOLFcrZhGuiWv5CPITev8,SpATywNh6bZuzm8s1ceuBUnMUAeoAHHw,5,3,2,0,0,0,2,0,7,1.0,1,0.0,0,2,0,0,3,0,0,2,0,2,5,1
1674,26430,LqtuGUVCKWBEA86X4uy5b4ZjnXPoVVJt,SpATywNh6bZuzm8s1ceuBUnMUAeoAHHw,15,23,1,9,0,0,4,0,37,5.285714285714286,2,0.0,9,1,8,0,14,0,1,4,0,18,19,0
1675,26436,J7iejq5NtsfdHjPTK3MrPhGPRoJN9WrB,A3fsA9Zfv1X2fVEQhTw51lKENdNrEqT3,2,3,2,0,0,0,0,0,5,0.7142857142857143,3,0.0,0,2,0,0,3,0,0,0,0,2,3,0
1676,26453,qIRkU6GTErqHGiePGqqQmQyg81Pc8mmk,SpATywNh6bZuzm8s1ceuBUnMUAeoAHHw,7,11,7,0,1,0,3,0,22,3.142857142857143,1,0.0,0,7,0,1,11,0,0,3,0,8,14,1
1677,26455,FGhnta6Ir68eirXd6aZPRoCB1VjhQYy9,A3fsA9Zfv1X2fVEQhTw51lKENdNrEqT3,11,14,7,0,3,0,7,1,32,4.571428571428571,4,0.0,0,7,0,3,14,0,0,7,1,10,22,0
1678,26460,oNf6qoW6E6dhoPJKSUjvElFlUKN9drLY,SpATywNh6bZuzm8s1ceuBUnMUAeoAHHw,3,2,1,0,0,0,2,0,5,0.7142857142857143,1,0.0,0,1,0,0,2,0,0,2,0,1,4,0
1679,26462,ZiYqSodBOSGv7K3d6XHhuzqRLmTlxa2q,SpATywNh6bZuzm8s1ceuBUnMUAeoAHHw,18,43,1,14,1,6,8,1,74,10.571428571428571,2,0.0,21,1,13,1,22,6,1,8,1,36,38,1
1680,26464,xioMf6frC9P8sc1cIrYLanKwZwDuxRiz,G8EPVSXsOYB5YQWZGiz1aVq5Pgr2GrQu,92,48,33,125,28,0,9,0,243,34.714285714285715,3,0.0,3,33,117,28,45,0,8,9,0,181,62,0
1681,26483,m81Dm6IMFFSE5H719VhdhHcKd9mbfbqm,A3fsA9Zfv1X2fVEQhTw51lKENdNrEqT3,6,11,5,0,1,0,1,0,18,2.5714285714285716,1,0.0,0,5,0,1,11,0,0,1,0,6,12,1
1682,26489,PD0QXI0Ip2PVwJ6kJaKkkINkj7BvGZMC,SpATywNh6bZuzm8s1ceuBUnMUAeoAHHw,18,34,0,17,0,15,19,1,86,12.285714285714286,3,0.0,2,0,14,0,32,15,3,19,1,16,70,0
1683,26497,lHqsd1041AF6CV0C0CnR0FxJTQGWXgTK,SpATywNh6bZuzm8s1ceuBUnMUAeoAHHw,5,3,1,0,1,0,1,0,6,0.8571428571428571,1,0.0,0,1,0,1,3,0,0,1,0,2,4,1
1684,26500,0jMOLkd6bX5LTqVnq5W50RF0alCjmWfd,SpATywNh6bZuzm8s1ceuBUnMUAeoAHHw,21,27,1,20,0,0,1,0,49,7.0,1,0.0,9,1,18,0,18,0,2,1,0,28,21,0
1685,26503,xUMqOX7y0bZjdauks6ek26j7lwAW76BX,SpATywNh6bZuzm8s1ceuBUnMUAeoAHHw,5,2,1,0,1,0,2,0,6,0.8571428571428571,1,0.0,0,1,0,1,2,0,0,2,0,2,4,1
1686,26514,IJmtizRHLdF3WotHNxwRcdFjzienWtJz,bWdj2GDclj5ofokWjzoa5jAwMkxCykd6,5,3,1,0,1,0,4,1,10,1.4285714285714286,1,0.0,2,1,0,1,1,0,0,4,1,4,6,1
1687,26520,fmqTcfWsPpHbIOnWwE9AtT4PG5wWA4CX,5X6FeZozNMgE2VRi3MJYjkkFK8SETtu2,5,2,1,0,1,3,2,0,9,1.2857142857142858,1,0.0,0,1,0,1,2,3,0,2,0,2,7,1
1688,26522,o1ILwYzfDxF68D6Q3HsUqOMp8hVHeeWy,G8EPVSXsOYB5YQWZGiz1aVq5Pgr2GrQu,14,15,0,0,0,0,4,0,19,2.7142857142857144,1,0.0,0,0,0,0,15,0,0,4,0,0,19,1
1689,26528,CiVcRubRqdt8MrzyUg75lzZmUZcaVQVo,SpATywNh6bZuzm8s1ceuBUnMUAeoAHHw,16,31,14,8,5,0,8,0,66,9.428571428571429,4,0.0,2,14,8,5,29,0,0,8,0,29,37,0
1690,26570,yYrk7RmkclaZIv32ppfmidCUMKYlGdCg,bWdj2GDclj5ofokWjzoa5jAwMkxCykd6,10,15,8,30,4,0,2,0,59,8.428571428571429,3,0.0,2,8,28,4,13,0,2,2,0,42,17,1
1691,26572,h5vEAVTb94xGNGjpn4Ohi5mNcXfM0rMl,SpATywNh6bZuzm8s1ceuBUnMUAeoAHHw,20,33,7,5,3,0,25,0,73,10.428571428571429,7,0.0,0,7,4,3,33,0,1,25,0,14,59,0
1692,26574,kSTg1JLYdhltSJsPuKhUcTkKXIqnVUW2,SpATywNh6bZuzm8s1ceuBUnMUAeoAHHw,8,7,1,0,1,0,2,0,11,1.5714285714285714,1,0.0,0,1,0,1,7,0,0,2,0,2,9,1
1693,26579,grJA0XKLUFzvkeUjFTmxhojWDdf12W8r,SpATywNh6bZuzm8s1ceuBUnMUAeoAHHw,7,8,3,0,1,0,3,0,15,2.142857142857143,2,0.0,0,3,0,1,8,0,0,3,0,4,11,1
1694,26590,5pjAdY5K4FfgQPLSzQKwXaKF78ph9a0y,bWdj2GDclj5ofokWjzoa5jAwMkxCykd6,17,13,8,36,0,0,11,0,68,9.714285714285714,5,0.0,0,8,34,0,13,0,2,11,0,42,26,0
1695,26610,xzPjA6KrslcE6S6chFTjdwgsvoAelzjQ,G8EPVSXsOYB5YQWZGiz1aVq5Pgr2GrQu,9,8,5,0,3,0,2,0,18,2.5714285714285716,2,0.0,1,5,0,3,7,0,0,2,0,9,9,0
1696,26614,CCWe4mJj2KV2ATVT9hkI2qJwZfZ9NcW7,SpATywNh6bZuzm8s1ceuBUnMUAeoAHHw,8,21,13,0,0,0,8,0,42,6.0,1,0.0,4,13,0,0,17,0,0,8,0,17,25,1
1697,26617,KPcfuz5VL4gtxrf9oXg3NuCUgo5lfp0J,A3fsA9Zfv1X2fVEQhTw51lKENdNrEqT3,34,24,3,46,2,1,20,3,99,14.142857142857142,4,0.0,0,3,37,2,24,1,9,20,3,42,57,0
1698,26621,COXHYWB9V3DjwUp5GnfoAY9hBjOExGO8,G8EPVSXsOYB5YQWZGiz1aVq5Pgr2GrQu,6,2,1,0,1,0,3,0,7,1.0,1,0.0,0,1,0,1,2,0,0,3,0,2,5,1
1699,26624,bwFkbWIAdNVUMLQhE1w1MjvyFVabaAgW,SpATywNh6bZuzm8s1ceuBUnMUAeoAHHw,14,9,7,0,5,0,2,0,23,3.2857142857142856,2,0.0,0,7,0,5,9,0,0,2,0,12,11,0
1700,26634,rrQbAPV4QBpP2BW10bzZtz96beXLch00,SpATywNh6bZuzm8s1ceuBUnMUAeoAHHw,15,14,9,16,5,0,3,0,47,6.714285714285714,2,0.0,2,9,13,5,12,0,3,3,0,29,18,1
1701,26671,FhVGWSUXUeZGSguiLBd186fsM4sRhpPL,SpATywNh6bZuzm8s1ceuBUnMUAeoAHHw,15,28,1,6,1,0,3,0,39,5.571428571428571,2,0.0,13,1,6,1,15,0,0,3,0,21,18,0
1702,26672,XN0YlXkOOCzzQkjkPHbmHYzBt2kMHbPM,G8EPVSXsOYB5YQWZGiz1aVq5Pgr2GrQu,4,4,0,0,0,0,2,0,6,0.8571428571428571,1,0.0,0,0,0,0,4,0,0,2,0,0,6,0
1703,26693,HAPPxnLUjIhcauBZnnWBFk3JE6gETTxa,A3fsA9Zfv1X2fVEQhTw51lKENdNrEqT3,3,2,1,0,0,0,1,0,4,0.5714285714285714,1,0.0,0,1,0,0,2,0,0,1,0,1,3,1
1704,26705,H612SWXqaaqbDXYCaqpzqRBY7ahAYnN1,bWdj2GDclj5ofokWjzoa5jAwMkxCykd6,5,8,3,0,2,0,2,0,15,2.142857142857143,1,0.0,3,3,0,2,5,0,0,2,0,8,7,1
1705,26720,DsLjooCLnfZ8B5pzT2arifZ6SOAto1Wc,SpATywNh6bZuzm8s1ceuBUnMUAeoAHHw,7,4,3,0,2,0,1,0,10,1.4285714285714286,1,0.0,0,3,0,2,4,0,0,1,0,5,5,1
1706,26738,0eze39ft8OIE7NpGiB8mBqdD6OezSRFT,SpATywNh6bZuzm8s1ceuBUnMUAeoAHHw,47,50,30,22,17,0,8,0,127,18.142857142857142,5,0.0,9,30,22,17,41,0,0,8,0,78,49,0
1707,26750,7J9JIWVCQG1g6yXh3uTVbrSu3pa18Ezn,A3fsA9Zfv1X2fVEQhTw51lKENdNrEqT3,3,0,0,0,0,8,2,0,10,1.4285714285714286,1,0.0,0,0,0,0,0,8,0,2,0,0,10,1
1708,26754,GLksmLIo4jY0swb77XkCz4Oz6WJw9kTq,bWdj2GDclj5ofokWjzoa5jAwMkxCykd6,6,7,2,0,1,0,2,0,12,1.7142857142857142,1,0.0,2,2,0,1,5,0,0,2,0,5,7,1
1709,26763,6gAyvwJKSeHOrljTS7vTc1U71cPBh7nb,RXDvfPUBYFlVdlueBFbLW0mhhAyGEqpt,8,8,2,0,1,0,2,0,13,1.8571428571428572,2,0.0,0,2,0,1,8,0,0,2,0,3,10,0
1710,26770,H7bZ54NuzkB5Nw5q0ZI1nld9qDoHNngL,7GRhBDsirIGkRZBtSMEzNTyDr2JQm4xx,4,3,2,0,0,0,1,0,6,0.8571428571428571,1,0.0,0,2,0,0,3,0,0,1,0,2,4,1
1711,26774,HQOz3dJ2hZ8qbl5l8pp7OKuPIeM9Xh55,G8EPVSXsOYB5YQWZGiz1aVq5Pgr2GrQu,21,16,13,0,5,2,8,1,45,6.428571428571429,2,0.0,0,13,0,5,16,2,0,8,1,18,27,0
1712,26779,vpU7efTPBzR1K6YbX3K8cMsGU56WLfGi,A3fsA9Zfv1X2fVEQhTw51lKENdNrEqT3,9,6,3,0,2,0,10,1,22,3.142857142857143,2,0.0,0,3,0,2,6,0,0,10,1,5,17,0
1713,26785,2A79ZgD8yfQPkgbkUr6CFN0mSZV4jc5i,A3fsA9Zfv1X2fVEQhTw51lKENdNrEqT3,4,0,0,0,0,1,4,0,5,0.7142857142857143,1,0.0,0,0,0,0,0,1,0,4,0,0,5,0
1714,26801,q2xQCstASp96wpspi8iqsuaqJ7gzfsux,SpATywNh6bZuzm8s1ceuBUnMUAeoAHHw,20,21,15,11,5,0,4,0,56,8.0,3,0.0,2,15,9,5,19,0,2,4,0,31,25,0
1715,26805,2RXgNe8oBg9c7SnCiZRXpxd4LaqyoUL3,bWdj2GDclj5ofokWjzoa5jAwMkxCykd6,9,9,3,0,4,0,4,0,20,2.857142857142857,2,0.0,0,3,0,4,9,0,0,4,0,7,13,1
1716,26811,S4x7F2zwGMymIPjPy7YGoWTUwlKzmNvg,SpATywNh6bZuzm8s1ceuBUnMUAeoAHHw,29,56,16,64,2,7,23,3,171,24.428571428571427,5,0.0,30,16,52,2,26,7,12,23,3,100,71,0
1717,26812,8b4CSrjMjmc5Jmqnv833uCnAad4TIcFZ,A3fsA9Zfv1X2fVEQhTw51lKENdNrEqT3,8,13,4,0,3,0,2,0,22,3.142857142857143,2,0.0,1,4,0,3,12,0,0,2,0,8,14,0
1718,26814,6ukzVV282fPHH5seR4Ah1PDJIZzJboQW,A3fsA9Zfv1X2fVEQhTw51lKENdNrEqT3,1,0,0,0,0,0,1,0,1,0.14285714285714285,1,0.0,0,0,0,0,0,0,0,1,0,0,1,1
1719,26816,HCwyZ32TalGxA6ZNHNOB04su4fWSeWBj,A3fsA9Zfv1X2fVEQhTw51lKENdNrEqT3,98,46,29,209,3,0,7,0,294,42.0,6,0.0,8,29,209,3,38,0,0,7,0,249,45,0
1720,26832,8zuZeBODltlYx6gcd6dPnNXLDXb8sH6b,SpATywNh6bZuzm8s1ceuBUnMUAeoAHHw,8,17,11,0,6,0,7,0,41,5.857142857142857,2,0.0,0,11,0,6,17,0,0,7,0,17,24,1
1721,26863,erDgXJOtYMWq3DbmDGyxl8sIhvZ9oKFE,SpATywNh6bZuzm8s1ceuBUnMUAeoAHHw,21,40,16,16,10,6,16,1,105,15.0,6,0.0,2,16,13,10,38,6,3,16,1,41,64,0
1722,26866,VA4ZWPYSTKAyC6xy9lfw5QHXGDYHdJGL,SpATywNh6bZuzm8s1ceuBUnMUAeoAHHw,42,50,33,34,21,1,6,0,145,20.714285714285715,3,0.0,12,33,30,21,38,1,4,6,0,96,49,1
1723,26877,nE23LYiQpabdXkj6YvKSja9sZnHRizmo,bWdj2GDclj5ofokWjzoa5jAwMkxCykd6,1,7,0,0,0,0,0,0,7,1.0,6,0.0,0,0,0,0,7,0,0,0,0,0,7,0
1724,26880,nE23LYiQpabdXkj6YvKSja9sZnHRizmo,5X6FeZozNMgE2VRi3MJYjkkFK8SETtu2,6,21,2,0,3,0,5,0,31,4.428571428571429,16,0.0,2,2,0,3,19,0,0,5,0,7,24,1
1725,26890,cZ2BWDXabTqNlcMYMUyoF2xlKnCvzMeJ,bWdj2GDclj5ofokWjzoa5jAwMkxCykd6,1,0,0,0,0,0,2,0,2,0.2857142857142857,1,0.0,0,0,0,0,0,0,0,2,0,0,2,1
1726,26902,wlMzjZIA65JiQ9JE1VQhTzG17NZZPeo3,SpATywNh6bZuzm8s1ceuBUnMUAeoAHHw,36,185,56,37,27,63,87,3,458,65.42857142857143,8,0.0,30,56,32,27,155,63,5,87,3,145,313,0
1727,26928,0eeJP6MiDq1cOnP8cGxNMZEXCvgY0tHY,SpATywNh6bZuzm8s1ceuBUnMUAeoAHHw,8,13,0,0,1,0,1,0,15,2.142857142857143,1,0.0,0,0,0,1,13,0,0,1,0,1,14,0
1728,26931,luNGlNTmJ26UVXohAPNf4yZNgIUDcpxK,SpATywNh6bZuzm8s1ceuBUnMUAeoAHHw,25,30,23,0,15,0,7,0,75,10.714285714285714,4,0.0,0,23,0,15,30,0,0,7,0,38,37,0
1729,26940,EQUZwbG72sVIvQVavXNV7pB9UhkYp9aI,SpATywNh6bZuzm8s1ceuBUnMUAeoAHHw,22,23,12,16,5,13,8,3,80,11.428571428571429,2,0.0,8,12,12,5,15,13,4,8,3,37,43,0
1730,26955,V44Q36yyz0HxZhlrCwrLJjYwv8UzqoCn,A3fsA9Zfv1X2fVEQhTw51lKENdNrEqT3,3,5,1,0,0,0,4,0,10,1.4285714285714286,2,0.0,0,1,0,0,5,0,0,4,0,1,9,1
1731,26958,d4EaPE0gMoqaRMtJCkrszQ76BkvS719C,SpATywNh6bZuzm8s1ceuBUnMUAeoAHHw,4,3,2,0,0,0,2,0,7,1.0,1,0.0,0,2,0,0,3,0,0,2,0,2,5,1
1732,26967,GXmApUIE1IechykqO3xyhcbVn1kfVOsr,SpATywNh6bZuzm8s1ceuBUnMUAeoAHHw,14,14,5,10,4,0,3,0,36,5.142857142857143,1,0.0,2,5,8,4,12,0,2,3,0,19,17,0
1733,26994,y2Imh6d65IyLlUtE9DWkdIauRQxTWtdJ,A3fsA9Zfv1X2fVEQhTw51lKENdNrEqT3,70,57,47,0,36,7,23,0,170,24.285714285714285,4,0.0,0,47,0,36,57,7,0,23,0,83,87,0
1734,27013,eA8qPXDg9mAIRhOgZfPGHskw4HtvZE6Q,SpATywNh6bZuzm8s1ceuBUnMUAeoAHHw,46,67,16,51,12,0,11,1,158,22.571428571428573,7,0.0,23,16,44,12,44,0,7,11,1,95,63,0
1735,27019,CIg0k418cM4NKEJ0IrZ66fdZQiBikcx7,G8EPVSXsOYB5YQWZGiz1aVq5Pgr2GrQu,107,55,29,278,8,10,17,2,399,57.0,7,0.0,14,29,234,8,41,10,44,17,2,285,114,0
1736,27023,FfwX3K5MhBvPJhxnz8s2MdrQvGuLPTtm,5X6FeZozNMgE2VRi3MJYjkkFK8SETtu2,1,0,0,0,0,0,1,0,1,0.14285714285714285,1,0.0,0,0,0,0,0,0,0,1,0,0,1,1
1737,27026,tLtF2xuv7ODjuOISevnoALqvBz99SIrS,SpATywNh6bZuzm8s1ceuBUnMUAeoAHHw,1,0,0,0,0,2,0,0,2,0.2857142857142857,1,0.0,0,0,0,0,0,2,0,0,0,0,2,1
1738,27034,m7QOSCdmTCzPuCv2XL75peqogyn8U25P,bWdj2GDclj5ofokWjzoa5jAwMkxCykd6,9,6,4,0,4,0,2,0,16,2.2857142857142856,1,0.0,0,4,0,4,6,0,0,2,0,8,8,0
1739,27052,LXvLrceHjGVikX2xowdQrgQUDs2YwMQl,SpATywNh6bZuzm8s1ceuBUnMUAeoAHHw,23,20,1,9,1,0,4,0,35,5.0,2,0.0,2,1,9,1,18,0,0,4,0,13,22,1
1740,27061,FR9oYWe14a3wuL1JJGpMLqnxF1jpkbep,SpATywNh6bZuzm8s1ceuBUnMUAeoAHHw,27,33,4,30,4,3,8,0,82,11.714285714285714,2,0.0,8,4,28,4,25,3,2,8,0,44,38,0
1741,27071,SU4JPqAVSnudVJ4UntK2sIqFBtfi7ORe,SpATywNh6bZuzm8s1ceuBUnMUAeoAHHw,4,2,0,0,0,0,3,0,5,0.7142857142857143,1,0.0,1,0,0,0,1,0,0,3,0,1,4,1
1742,27085,Y1uVq657IWCue4abNsh62IVHKtmwsQHQ,SpATywNh6bZuzm8s1ceuBUnMUAeoAHHw,10,15,10,0,1,0,3,0,29,4.142857142857143,2,0.0,0,10,0,1,15,0,0,3,0,11,18,0
1743,27087,1sf1a7OMEvwky5hvLFD12TaOsmoNw2Qb,G8EPVSXsOYB5YQWZGiz1aVq5Pgr2GrQu,13,23,8,0,2,0,2,0,35,5.0,3,0.0,3,8,0,2,20,0,0,2,0,13,22,0
1744,27094,wamlK8Nx9pa9kXzI19EF5HF3fhJv3sWN,RXDvfPUBYFlVdlueBFbLW0mhhAyGEqpt,2,0,0,0,0,0,3,0,3,0.42857142857142855,1,0.0,0,0,0,0,0,0,0,3,0,0,3,1
1745,27102,HLBZIULiiVTAwZuuOocZdXTuqOHNTspY,SpATywNh6bZuzm8s1ceuBUnMUAeoAHHw,1,0,0,0,0,0,1,0,1,0.14285714285714285,1,0.0,0,0,0,0,0,0,0,1,0,0,1,1
1746,27109,xXksY261TKqU0nrp5V4CHzJJu11xSD4U,bWdj2GDclj5ofokWjzoa5jAwMkxCykd6,1,0,0,0,0,0,1,0,1,0.14285714285714285,1,0.0,0,0,0,0,0,0,0,1,0,0,1,1
1747,27123,ZSKBKnD8wfegggUigWIwrMo7a1rGr9YG,5X6FeZozNMgE2VRi3MJYjkkFK8SETtu2,7,4,1,0,2,2,13,2,24,3.4285714285714284,1,0.0,2,1,0,2,2,2,0,13,2,5,19,1
1748,27131,HmD5U4sIMvfZvpRZtV6LJ4TMT3hqwpU2,A3fsA9Zfv1X2fVEQhTw51lKENdNrEqT3,7,4,2,0,2,0,2,0,10,1.4285714285714286,1,0.0,0,2,0,2,4,0,0,2,0,4,6,1
1749,27140,9zKzyrDc2ZLmZJn8iNzeeCTIcbRbidfo,A3fsA9Zfv1X2fVEQhTw51lKENdNrEqT3,15,32,15,8,3,1,7,0,66,9.428571428571429,4,0.0,2,15,7,3,30,1,1,7,0,27,39,0
1750,27141,O7ag9DJQGMaSoxNY23KuzUgYBMRSrdlt,SpATywNh6bZuzm8s1ceuBUnMUAeoAHHw,1,0,0,0,0,0,1,0,1,0.14285714285714285,1,0.0,0,0,0,0,0,0,0,1,0,0,1,1
1751,27145,5pjAdY5K4FfgQPLSzQKwXaKF78ph9a0y,A3fsA9Zfv1X2fVEQhTw51lKENdNrEqT3,119,54,35,374,8,8,24,0,503,71.85714285714286,3,0.0,8,35,356,8,46,8,18,24,0,407,96,0
1752,27154,zi3yOAhUK1J3AbYoEq9VqjXWOhiWlKvY,SpATywNh6bZuzm8s1ceuBUnMUAeoAHHw,20,38,6,14,4,6,11,0,79,11.285714285714286,8,0.0,5,6,12,4,33,6,2,11,0,27,52,0
1753,27155,FgKGJkcyrlk2UGTZTaDtYvcpTKr0lNLA,SpATywNh6bZuzm8s1ceuBUnMUAeoAHHw,31,42,25,16,11,0,14,1,109,15.571428571428571,3,0.0,5,25,15,11,37,0,1,14,1,56,53,0
1754,27157,KOtvsBXw2AZmXimVVqYMRgAsUlwCmhAG,5X6FeZozNMgE2VRi3MJYjkkFK8SETtu2,10,10,7,0,1,0,8,0,26,3.7142857142857144,2,0.0,0,7,0,1,10,0,0,8,0,8,18,1
1755,27158,ZSKBKnD8wfegggUigWIwrMo7a1rGr9YG,RXDvfPUBYFlVdlueBFbLW0mhhAyGEqpt,1,0,0,0,0,0,1,0,1,0.14285714285714285,1,0.0,0,0,0,0,0,0,0,1,0,0,1,1
1756,27166,5pjAdY5K4FfgQPLSzQKwXaKF78ph9a0y,5X6FeZozNMgE2VRi3MJYjkkFK8SETtu2,7,12,7,0,3,0,12,0,34,4.857142857142857,5,0.0,0,7,0,3,12,0,0,12,0,10,24,0
1757,27171,EUmZ5qzjwgko2PIWEnctkvYh7APnUrX9,G8EPVSXsOYB5YQWZGiz1aVq5Pgr2GrQu,20,55,2,0,2,0,12,0,71,10.142857142857142,2,0.0,0,2,0,2,55,0,0,12,0,4,67,1
1758,27203,0pXQfM8DUmrkstumtDLyuzaICh0xRgGw,SpATywNh6bZuzm8s1ceuBUnMUAeoAHHw,14,12,6,2,4,0,3,0,27,3.857142857142857,3,0.0,0,6,2,4,12,0,0,3,0,12,15,1
1759,27206,5pjAdY5K4FfgQPLSzQKwXaKF78ph9a0y,7GRhBDsirIGkRZBtSMEzNTyDr2JQm4xx,1,0,0,0,0,0,1,0,1,0.14285714285714285,1,0.0,0,0,0,0,0,0,0,1,0,0,1,0
1760,27209,147kfUKOVzUnQEgEhu4oFkvvuFRbAg9Y,bWdj2GDclj5ofokWjzoa5jAwMkxCykd6,1,0,0,0,0,0,1,0,1,0.14285714285714285,1,0.0,0,0,0,0,0,0,0,1,0,0,1,1
1761,27213,S0nQm2eOAlSxKM1RfeGoUgB4GQEZsJ1U,SpATywNh6bZuzm8s1ceuBUnMUAeoAHHw,21,18,10,18,6,0,3,0,55,7.857142857142857,1,0.0,6,10,14,6,12,0,4,3,0,36,19,0
1762,27220,SqRpmgv1gGFKN06wuAdrCbdyqbZyrZkj,bWdj2GDclj5ofokWjzoa5jAwMkxCykd6,3,2,1,0,0,0,1,0,4,0.5714285714285714,1,0.0,0,1,0,0,2,0,0,1,0,1,3,1
1763,27230,uciz4weP1kSziQB1Oe1Psu4CdK1uNqzl,SpATywNh6bZuzm8s1ceuBUnMUAeoAHHw,11,8,4,18,0,4,4,3,41,5.857142857142857,1,0.0,3,4,15,0,5,4,3,4,3,22,19,0
1764,27245,L6Tc39ltUCigrI45L69IfmvrMsjwxFPz,RXDvfPUBYFlVdlueBFbLW0mhhAyGEqpt,8,4,3,0,2,0,3,0,12,1.7142857142857142,2,0.0,0,3,0,2,4,0,0,3,0,5,7,0
1765,27258,jBmjwFnt42Gcx6LwIKpHSMaWZmMpbUSA,bWdj2GDclj5ofokWjzoa5jAwMkxCykd6,9,6,3,0,4,28,9,1,51,7.285714285714286,2,0.0,0,3,0,4,6,28,0,9,1,7,44,0
1766,27262,5YlMIk6eUB42j0JZ5VWqgCtDNQymOsVL,A3fsA9Zfv1X2fVEQhTw51lKENdNrEqT3,1,0,0,0,0,0,1,0,1,0.14285714285714285,1,0.0,0,0,0,0,0,0,0,1,0,0,1,1
1767,27263,X5ugOWLhdmTxo3CYqfXWDVoDsvjcSnkc,SpATywNh6bZuzm8s1ceuBUnMUAeoAHHw,10,19,8,9,0,0,4,0,40,5.714285714285714,2,0.0,7,8,9,0,12,0,0,4,0,24,16,0
1768,27274,RHMCI6WPNb6sodSDz63meesVmYDbjVWv,G8EPVSXsOYB5YQWZGiz1aVq5Pgr2GrQu,1,0,0,0,0,0,1,0,1,0.14285714285714285,1,0.0,0,0,0,0,0,0,0,1,0,0,1,1
1769,27276,RHMCI6WPNb6sodSDz63meesVmYDbjVWv,A3fsA9Zfv1X2fVEQhTw51lKENdNrEqT3,1,0,0,0,0,0,1,0,1,0.14285714285714285,1,0.0,0,0,0,0,0,0,0,1,0,0,1,1
1770,27304,wNwoqC5ObEwtjOwnohUoKsyAr3KoLL2z,SpATywNh6bZuzm8s1ceuBUnMUAeoAHHw,1,0,0,0,0,0,1,0,1,0.14285714285714285,1,0.0,0,0,0,0,0,0,0,1,0,0,1,1
1771,27306,tTMyaWTlizKdT72ief23Wjd2wqSzEHSk,bWdj2GDclj5ofokWjzoa5jAwMkxCykd6,18,10,5,24,2,4,9,0,54,7.714285714285714,4,0.0,0,5,23,2,10,4,1,9,0,30,24,0
1772,27308,tc8ZYWI5FOJIIpcsZ5SRyil7whr7RTIT,5X6FeZozNMgE2VRi3MJYjkkFK8SETtu2,18,59,2,4,3,17,19,3,107,15.285714285714286,8,0.0,11,2,3,3,48,17,1,19,3,19,88,0
1773,27313,rUrD3vOZKxi004QKs8MuR2Ws6PqRB5Bd,SpATywNh6bZuzm8s1ceuBUnMUAeoAHHw,4,3,2,0,0,0,1,0,6,0.8571428571428571,1,0.0,0,2,0,0,3,0,0,1,0,2,4,1
1774,27327,JiMk3YzOg8oAYgApOK7xg1JGgnoRvDfl,SpATywNh6bZuzm8s1ceuBUnMUAeoAHHw,38,76,44,22,17,22,18,0,199,28.428571428571427,5,0.0,16,44,21,17,60,22,1,18,0,98,101,0
1775,27328,nEzidwd1f4tZP3mnFNbL1NYH0VtiIG9o,G8EPVSXsOYB5YQWZGiz1aVq5Pgr2GrQu,9,7,4,0,2,1,13,3,30,4.285714285714286,2,0.0,0,4,0,2,7,1,0,13,3,6,24,0
1776,27367,mvWG8WfFoikkAB9Wg1mtbCZJVje4NMeg,A3fsA9Zfv1X2fVEQhTw51lKENdNrEqT3,1,0,0,0,0,0,1,0,1,0.14285714285714285,1,0.0,0,0,0,0,0,0,0,1,0,0,1,1
1777,27372,9yzTxxapCsl6p0XfgDOC1OZlTO149uIK,RXDvfPUBYFlVdlueBFbLW0mhhAyGEqpt,10,3,3,0,3,0,6,0,15,2.142857142857143,3,0.0,0,3,0,3,3,0,0,6,0,6,9,1
1778,27386,jQaCxlcrIW3B0ti76HtzjtRZOLJHPbzy,RXDvfPUBYFlVdlueBFbLW0mhhAyGEqpt,14,30,16,0,6,25,6,0,83,11.857142857142858,3,0.0,0,16,0,6,30,25,0,6,0,22,61,0
1779,27387,FFlICu8a1PeaY8oKBFESJAT3q6I5h6Xu,SpATywNh6bZuzm8s1ceuBUnMUAeoAHHw,17,17,10,10,5,0,3,0,45,6.428571428571429,2,0.0,2,10,10,5,15,0,0,3,0,27,18,0
1780,27398,Bu2t1TMRCrfGFPr5E4de77vGt2jlo7S7,5X6FeZozNMgE2VRi3MJYjkkFK8SETtu2,8,4,3,0,2,2,4,0,15,2.142857142857143,1,0.0,0,3,0,2,4,2,0,4,0,5,10,1
1781,27402,GDOD5H0bl28RO8whBIu6B8qS2nGsRznY,A3fsA9Zfv1X2fVEQhTw51lKENdNrEqT3,4,3,2,0,0,0,1,0,6,0.8571428571428571,1,0.0,0,2,0,0,3,0,0,1,0,2,4,1
1782,27412,JKpUdoayexmnBaGuLjDe4nN4yf5KTJWi,SpATywNh6bZuzm8s1ceuBUnMUAeoAHHw,29,33,27,0,20,0,5,0,85,12.142857142857142,5,0.0,0,27,0,20,33,0,0,5,0,47,38,0
1783,27418,46ijefZyx5KF4YGCmdayIapXrAG6omzt,SpATywNh6bZuzm8s1ceuBUnMUAeoAHHw,3,5,1,0,0,0,1,0,7,1.0,1,0.0,0,1,0,0,5,0,0,1,0,1,6,0
1784,27445,M5fmtGmpo2DUfH2kBcBzBwkDFjGnGDqf,7GRhBDsirIGkRZBtSMEzNTyDr2JQm4xx,5,3,1,0,1,0,1,0,6,0.8571428571428571,1,0.0,0,1,0,1,3,0,0,1,0,2,4,1
1785,27452,FPlcvm9GCa3b2GpGQce61hkgMN4KDTO8,A3fsA9Zfv1X2fVEQhTw51lKENdNrEqT3,5,5,0,0,0,0,4,0,9,1.2857142857142858,1,0.0,0,0,0,0,5,0,0,4,0,0,9,1
1786,27455,Cm1M3tMD81LVoXf16iZdS1f94DBPqFnf,SpATywNh6bZuzm8s1ceuBUnMUAeoAHHw,19,55,2,0,2,0,2,0,61,8.714285714285714,7,0.0,5,2,0,2,50,0,0,2,0,9,52,0
1787,27457,CYUGDG4GDnccqiwcMR066vcF013j1TMy,RXDvfPUBYFlVdlueBFbLW0mhhAyGEqpt,1,0,0,0,0,0,1,0,1,0.14285714285714285,1,0.0,0,0,0,0,0,0,0,1,0,0,1,1
1788,27460,CYUGDG4GDnccqiwcMR066vcF013j1TMy,bWdj2GDclj5ofokWjzoa5jAwMkxCykd6,1,0,0,0,0,0,2,0,2,0.2857142857142857,1,0.0,0,0,0,0,0,0,0,2,0,0,2,1
1789,27461,CYUGDG4GDnccqiwcMR066vcF013j1TMy,A3fsA9Zfv1X2fVEQhTw51lKENdNrEqT3,1,0,0,0,0,0,1,0,1,0.14285714285714285,1,0.0,0,0,0,0,0,0,0,1,0,0,1,1
1790,27464,XLmXRx6QIJBEWZLK5otMq8wfQNXonT4D,SpATywNh6bZuzm8s1ceuBUnMUAeoAHHw,10,15,0,0,0,0,0,0,15,2.142857142857143,3,0.0,0,0,0,0,15,0,0,0,0,0,15,0
1791,27472,gBjurtkrE1QG05Q5LeiG3aUmftHx9oSc,bWdj2GDclj5ofokWjzoa5jAwMkxCykd6,13,26,9,0,8,0,7,0,50,7.142857142857143,3,0.0,0,9,0,8,26,0,0,7,0,17,33,1
1792,27475,mEMC3mPRFcLDpf0MVM7Pji9FNHa590x9,SpATywNh6bZuzm8s1ceuBUnMUAeoAHHw,4,2,1,0,0,0,2,0,5,0.7142857142857143,1,0.0,0,1,0,0,2,0,0,2,0,1,4,1
1793,27477,pz4WzmrapGULqEk99lfOZVzJbwiC2Cl1,SpATywNh6bZuzm8s1ceuBUnMUAeoAHHw,9,5,0,7,0,0,6,0,18,2.5714285714285716,3,0.0,2,0,7,0,3,0,0,6,0,9,9,0
1794,27508,tMqwmUDBjzV47t93nRMHpK2NbIUU0mEs,SpATywNh6bZuzm8s1ceuBUnMUAeoAHHw,21,32,11,20,5,0,2,0,70,10.0,2,0.0,3,11,18,5,29,0,2,2,0,37,33,1
1795,27517,9CBq37ANJ7gzpAJJLjvNc0D6JKL0q7QE,SpATywNh6bZuzm8s1ceuBUnMUAeoAHHw,32,45,16,23,8,0,6,0,98,14.0,3,0.0,6,16,22,8,39,0,1,6,0,52,46,1
1796,27523,8ga3z0NKN1WQ3YzAZr5NtUzbD9BjtY0C,G8EPVSXsOYB5YQWZGiz1aVq5Pgr2GrQu,39,22,12,81,4,0,8,0,127,18.142857142857142,4,0.0,7,12,73,4,15,0,8,8,0,96,31,0
1797,27524,vO1mfDIydV81bK1AJmTqdzB6pSb2fl5U,bWdj2GDclj5ofokWjzoa5jAwMkxCykd6,7,4,0,0,0,12,17,1,34,4.857142857142857,1,0.0,0,0,0,0,4,12,0,17,1,0,34,0
1798,27532,ok9deTolTxdwywhUtYqsqR9eC1Gb5v44,SpATywNh6bZuzm8s1ceuBUnMUAeoAHHw,27,40,15,33,4,2,11,1,106,15.142857142857142,3,0.0,21,15,28,4,19,2,5,11,1,68,38,0
1799,27541,4LLdV2zTWS697dAsOgAPJZPFwfNnrjt6,A3fsA9Zfv1X2fVEQhTw51lKENdNrEqT3,42,49,33,88,16,3,15,1,205,29.285714285714285,5,0.0,3,33,78,16,46,3,10,15,1,130,75,1
1800,27547,Nt2MuvKq8ehhC9cDQZ9wTGuVcTn0ishD,5X6FeZozNMgE2VRi3MJYjkkFK8SETtu2,9,10,3,0,1,0,6,0,20,2.857142857142857,2,0.0,5,3,0,1,5,0,0,6,0,9,11,0
1801,27548,azOWgfyXQBkztOqJ4AAsFqAk137ZwNDW,SpATywNh6bZuzm8s1ceuBUnMUAeoAHHw,6,9,7,0,0,0,2,0,18,2.5714285714285716,2,0.0,0,7,0,0,9,0,0,2,0,7,11,0
1802,27606,cWykzNKAq5sFQBA059QN4Jx74YGPkfwB,5Gyp41oLVo7Gg7vF4vpmggWP5MU70QO6,38,171,93,102,13,46,41,1,467,66.71428571428571,8,0.0,37,93,80,13,134,46,22,41,1,223,244,1
1803,27619,pOmMyPkqdgoqwjm4uJTo96pDPWn8497v,5Gyp41oLVo7Gg7vF4vpmggWP5MU70QO6,19,28,18,11,10,0,6,0,73,10.428571428571429,5,0.0,5,18,8,10,23,0,3,6,0,41,32,1
1804,27647,h2w2KnlHH0dLj9ah8Ktkr5F5RQhDw3lF,5Gyp41oLVo7Gg7vF4vpmggWP5MU70QO6,13,11,5,0,3,0,5,0,24,3.4285714285714284,1,0.0,2,5,0,3,9,0,0,5,0,10,14,1
1805,27653,68Dxo5Uz0aGDvHTFGMu5vw31QRJ7GnRc,5Gyp41oLVo7Gg7vF4vpmggWP5MU70QO6,2,0,0,0,0,0,2,0,2,0.2857142857142857,1,0.0,0,0,0,0,0,0,0,2,0,0,2,1
1806,27691,EmhLJBUMFxcunqaQdYZAlaquRhoNubHk,5Gyp41oLVo7Gg7vF4vpmggWP5MU70QO6,45,198,106,77,51,33,41,3,509,72.71428571428571,7,0.0,58,106,63,51,140,33,14,41,3,278,231,0
1807,27910,IY29VUWGFHtfrjTNCkqydR2UYXxAmkwM,5Gyp41oLVo7Gg7vF4vpmggWP5MU70QO6,25,62,24,10,13,9,19,3,140,20.0,2,0.0,12,24,5,13,50,9,5,19,3,54,86,1
1808,27912,rV1C0FkMMtpbmabMzq9P6vZBAdXUo30B,5Gyp41oLVo7Gg7vF4vpmggWP5MU70QO6,55,110,49,29,39,4,16,1,248,35.42857142857143,6,0.0,51,49,23,39,59,4,6,16,1,162,86,0
1809,27929,hIXeM0yyb6wIxVNnB5ijRV2LpcYBbrLW,5Gyp41oLVo7Gg7vF4vpmggWP5MU70QO6,8,17,5,0,1,0,4,0,27,3.857142857142857,3,0.0,0,5,0,1,17,0,0,4,0,6,21,1
1810,27931,tMjprEPLBIvFA1wgueSz2eNKPTF9Ywab,5Gyp41oLVo7Gg7vF4vpmggWP5MU70QO6,1,0,0,0,0,0,1,0,1,0.14285714285714285,1,0.0,0,0,0,0,0,0,0,1,0,0,1,1
1811,27935,3dZVfShxC9kemRNKsdGwL5lQ2FKMwdl1,5Gyp41oLVo7Gg7vF4vpmggWP5MU70QO6,16,36,16,8,6,0,10,0,76,10.857142857142858,6,0.0,10,16,4,6,26,0,4,10,0,36,40,1
1812,27982,ZULomXsITwM6vNxcJN8imzU1pyfKn8Cw,5Gyp41oLVo7Gg7vF4vpmggWP5MU70QO6,57,267,164,37,63,32,54,6,623,89.0,14,0.0,67,164,26,63,200,32,11,54,6,320,303,0
1813,27985,NGNG2Ypn5U43gbRiqJUxr2iLJ7uh0fYS,5Gyp41oLVo7Gg7vF4vpmggWP5MU70QO6,15,13,6,0,7,0,5,0,31,4.428571428571429,3,0.0,3,6,0,7,10,0,0,5,0,16,15,0
1814,28002,uHgH8m4GJET0eE5mE8JCyLZD7HEKwM4t,5Gyp41oLVo7Gg7vF4vpmggWP5MU70QO6,1,0,0,0,0,0,1,0,1,0.14285714285714285,1,0.0,0,0,0,0,0,0,0,1,0,0,1,1
1815,28017,Vgv9Vbo4BqJtU7GBUbwfi1DvG0Q1nDxJ,5Gyp41oLVo7Gg7vF4vpmggWP5MU70QO6,17,33,5,9,3,6,15,0,71,10.142857142857142,4,0.0,6,5,8,3,27,6,1,15,0,22,49,0
1816,28023,OHdowkt0lKGMvUmcny07O1EwZDDg5zly,5Gyp41oLVo7Gg7vF4vpmggWP5MU70QO6,1,0,0,0,0,0,1,0,1,0.14285714285714285,1,0.0,0,0,0,0,0,0,0,1,0,0,1,1
1817,28034,JgNllefl6lxMJFs121u0iwNrhgAg4Z2l,5Gyp41oLVo7Gg7vF4vpmggWP5MU70QO6,52,228,124,45,45,79,44,0,565,80.71428571428571,15,0.0,67,124,32,45,161,79,13,44,0,268,297,0
1818,28046,hNJz0qbOhrUgajUkzqSdDbybHkuRglfs,5Gyp41oLVo7Gg7vF4vpmggWP5MU70QO6,11,19,12,2,2,0,7,0,42,6.0,3,0.0,2,12,1,2,17,0,1,7,0,17,25,0
1819,28059,F3YGQxJCx53Ykm07bMYXU5VASdwnVuqU,5Gyp41oLVo7Gg7vF4vpmggWP5MU70QO6,5,7,4,0,2,0,3,0,16,2.2857142857142856,2,0.0,0,4,0,2,7,0,0,3,0,6,10,1
1820,28063,UoQ3qEkl0829bYUdpRZpHbRErQr2wCSM,5Gyp41oLVo7Gg7vF4vpmggWP5MU70QO6,10,10,3,6,2,0,11,0,32,4.571428571428571,2,0.0,7,3,3,2,3,0,3,11,0,15,17,1
1821,28071,xIAiSXUxBKAnRQoPkr2p83UbZxo76sqM,5Gyp41oLVo7Gg7vF4vpmggWP5MU70QO6,1,0,0,0,0,0,1,0,1,0.14285714285714285,1,0.0,0,0,0,0,0,0,0,1,0,0,1,1
1822,28077,MaXB6YBpSNUvXtEuCcY3Jwa8jwvsWVE8,5Gyp41oLVo7Gg7vF4vpmggWP5MU70QO6,7,3,2,0,2,0,2,0,9,1.2857142857142858,1,0.0,0,2,0,2,3,0,0,2,0,4,5,1
1823,28081,BV79vNEzTPlmR22unH2F5S3vLmcSI9HJ,5Gyp41oLVo7Gg7vF4vpmggWP5MU70QO6,14,26,14,3,7,1,14,1,66,9.428571428571429,4,0.0,1,14,2,7,25,1,1,14,1,24,42,0
1824,28089,r3FrxEVNvR9qEi831CCkRSJOpiXnU0FF,5Gyp41oLVo7Gg7vF4vpmggWP5MU70QO6,18,26,12,16,7,0,8,0,69,9.857142857142858,2,0.0,9,12,8,7,17,0,8,8,0,36,33,1
1825,28117,35vL0ALP2ArCVChSKJCitMWjtQl3acP9,5Gyp41oLVo7Gg7vF4vpmggWP5MU70QO6,6,4,1,0,1,0,4,0,10,1.4285714285714286,2,0.0,0,1,0,1,4,0,0,4,0,2,8,1
1826,28120,F0WSLEWTFqAIJPsTVBWVZ6RgMW5ye2Ty,5Gyp41oLVo7Gg7vF4vpmggWP5MU70QO6,1,0,0,0,0,0,1,0,1,0.14285714285714285,1,0.0,0,0,0,0,0,0,0,1,0,0,1,1
1827,28126,NYHJ2hpkQuM6x91lqCpGcKlaiVcQb8tv,5Gyp41oLVo7Gg7vF4vpmggWP5MU70QO6,9,9,2,0,2,0,2,0,15,2.142857142857143,1,0.0,0,2,0,2,9,0,0,2,0,4,11,1
1828,28132,qWUHaBA14wCVQxQ3GlZi8VQT6onaOkYr,5Gyp41oLVo7Gg7vF4vpmggWP5MU70QO6,13,41,1,6,3,0,5,0,56,8.0,2,0.0,7,1,3,3,34,0,3,5,0,14,42,1
1829,28149,umFRjjRou5lxb9SCAQ56IcPskPM6alkQ,5Gyp41oLVo7Gg7vF4vpmggWP5MU70QO6,33,119,62,54,8,6,85,1,335,47.857142857142854,7,0.0,12,62,44,8,107,6,10,85,1,126,209,0
1830,28167,GojuV0la1IgJTICKk09lNC7XjyEWzeax,5Gyp41oLVo7Gg7vF4vpmggWP5MU70QO6,22,36,18,6,6,13,8,0,87,12.428571428571429,3,0.0,13,18,3,6,23,13,3,8,0,40,47,1
1831,28179,Q0RlqkDoye0CFKRgMpSUoXnN9SlonN3k,5Gyp41oLVo7Gg7vF4vpmggWP5MU70QO6,26,33,1,15,12,10,7,0,78,11.142857142857142,4,0.0,11,1,10,12,22,10,5,7,0,34,44,0
1832,28181,RJwnOph0p8T6UAPo7WZFtHqjtt1K7VgK,5Gyp41oLVo7Gg7vF4vpmggWP5MU70QO6,37,91,46,40,14,1,31,0,223,31.857142857142858,11,0.0,13,46,30,14,78,1,10,31,0,103,120,0
1833,28182,Vrqvr8lNbpSjQdsMIu1B8ExqeyPQi6wD,5Gyp41oLVo7Gg7vF4vpmggWP5MU70QO6,6,3,1,0,1,0,2,0,7,1.0,1,0.0,0,1,0,1,3,0,0,2,0,2,5,1
1834,28186,hbiLFwYRNfJ5BzIhONrfQV07bzBd3fcu,5Gyp41oLVo7Gg7vF4vpmggWP5MU70QO6,40,206,106,45,33,19,34,1,444,63.42857142857143,14,0.0,46,106,29,33,160,19,16,34,1,214,230,0
1835,28193,K9nInKsxWeoRDvjfEiycBlskSifL6OWe,5Gyp41oLVo7Gg7vF4vpmggWP5MU70QO6,7,5,3,0,1,1,2,0,12,1.7142857142857142,1,0.0,0,3,0,1,5,1,0,2,0,4,8,1
1836,28198,I4zM9rHEGFO5XPNdII42SPU5yBy5nnDO,5Gyp41oLVo7Gg7vF4vpmggWP5MU70QO6,26,41,25,30,8,5,19,7,135,19.285714285714285,4,0.0,10,25,18,8,31,5,12,19,7,61,74,1
1837,28204,VW1NSXHsRBHsQFDrAdwMVKxbl0FK1kSa,5Gyp41oLVo7Gg7vF4vpmggWP5MU70QO6,25,22,11,14,7,0,6,0,60,8.571428571428571,3,0.0,9,11,7,7,13,0,7,6,0,34,26,0
1838,28214,RxXRKZYpbfKbF79XwFGwONhlZ3CWNuKc,5Gyp41oLVo7Gg7vF4vpmggWP5MU70QO6,1,0,0,0,0,0,1,0,1,0.14285714285714285,1,0.0,0,0,0,0,0,0,0,1,0,0,1,1
1839,28221,RARu5DwVWhsWe4JpwIDGirLcmeGNFIFs,5Gyp41oLVo7Gg7vF4vpmggWP5MU70QO6,22,18,6,72,0,0,5,0,101,14.428571428571429,2,0.0,10,6,61,0,8,0,11,5,0,77,24,1
1840,28228,WELjmgdsP962Pc1teJ96xvofKraKe6qa,5Gyp41oLVo7Gg7vF4vpmggWP5MU70QO6,12,12,6,4,2,29,19,3,75,10.714285714285714,5,0.0,3,6,3,2,9,29,1,19,3,14,61,0
1841,28230,goqhFtKJFc8EIUBDvl7EAlkZyjSW0CkB,5Gyp41oLVo7Gg7vF4vpmggWP5MU70QO6,27,52,28,0,28,0,5,0,113,16.142857142857142,3,0.0,12,28,0,28,40,0,0,5,0,68,45,0
1842,28270,S9WMXu7x4mGtnVsssjOsOIjEB9GwRzBY,5Gyp41oLVo7Gg7vF4vpmggWP5MU70QO6,10,10,7,0,7,6,9,2,41,5.857142857142857,2,0.0,1,7,0,7,9,6,0,9,2,15,26,0
1843,28276,0PfU3KuGh5fUaiigSaVoUh3dHM2dwmbq,5Gyp41oLVo7Gg7vF4vpmggWP5MU70QO6,1,0,0,0,0,0,1,0,1,0.14285714285714285,1,0.0,0,0,0,0,0,0,0,1,0,0,1,1
1844,28300,Sk9AOCT9Pke3AdxAKMgSzcKTQwjFbv8R,5Gyp41oLVo7Gg7vF4vpmggWP5MU70QO6,6,1,1,0,1,0,3,0,6,0.8571428571428571,1,0.0,0,1,0,1,1,0,0,3,0,2,4,1
1845,28317,CEfEi7M9lamzCxAJyDlpYAAxnD3ijzvT,5Gyp41oLVo7Gg7vF4vpmggWP5MU70QO6,9,4,3,0,3,0,2,0,12,1.7142857142857142,1,0.0,0,3,0,3,4,0,0,2,0,6,6,1
1846,28341,QUmY4Qxuc6Lxkcjcv3S35mlSzSQ2SxMI,5Gyp41oLVo7Gg7vF4vpmggWP5MU70QO6,45,158,80,54,32,12,27,2,365,52.142857142857146,15,0.0,52,80,36,32,106,12,18,27,2,200,165,0
1847,28352,bZ35LM6ZK64GRHs2w4e0jSLKpQyNFLAf,5Gyp41oLVo7Gg7vF4vpmggWP5MU70QO6,6,2,1,0,2,0,3,0,8,1.1428571428571428,1,0.0,1,1,0,2,1,0,0,3,0,4,4,1
1848,28365,cHSk2tkmj07D1Si8z7Gc4Xxk3CDu4xnh,5Gyp41oLVo7Gg7vF4vpmggWP5MU70QO6,6,4,2,0,3,0,1,0,10,1.4285714285714286,1,0.0,1,2,0,3,3,0,0,1,0,6,4,1
1849,28366,UYodASsM2kuoVGiMTZuLBu6IW0INt07N,5Gyp41oLVo7Gg7vF4vpmggWP5MU70QO6,40,84,42,28,20,5,19,1,199,28.428571428571427,11,0.0,28,42,23,20,56,5,5,19,1,113,86,0
1850,28373,FkzxKMbMMqgFWfaVd2jKcGrD9SPSB6WC,5Gyp41oLVo7Gg7vF4vpmggWP5MU70QO6,10,9,6,0,4,0,5,0,24,3.4285714285714284,3,0.0,0,6,0,4,9,0,0,5,0,10,14,0
1851,28425,X3X3klM03RXeGUjty93sg2SlkZrg3xpQ,5Gyp41oLVo7Gg7vF4vpmggWP5MU70QO6,17,44,22,14,3,8,10,0,101,14.428571428571429,8,0.0,7,22,9,3,37,8,5,10,0,41,60,0
1852,28431,L5srqSjKk2d49ciW6UpMzrFCE1CKvFWo,5Gyp41oLVo7Gg7vF4vpmggWP5MU70QO6,10,8,4,0,1,2,9,2,26,3.7142857142857144,3,0.0,1,4,0,1,7,2,0,9,2,6,20,1
1853,28446,PUFh3BsQaDVIJMDvwsFTqkrgAzvjO9ME,5Gyp41oLVo7Gg7vF4vpmggWP5MU70QO6,32,82,38,10,17,22,33,2,204,29.142857142857142,11,0.0,12,38,8,17,70,22,2,33,2,75,129,1
1854,28460,plO5KwMn5kVrK7QQxoVeGB2Ku1Irxv2s,5Gyp41oLVo7Gg7vF4vpmggWP5MU70QO6,35,90,40,22,10,37,21,1,221,31.571428571428573,8,0.0,29,40,20,10,61,37,2,21,1,99,122,0
1855,28461,EttKeSyg9r0EcjglXuiRsuMNde5ZPNQV,5Gyp41oLVo7Gg7vF4vpmggWP5MU70QO6,24,63,36,22,11,16,15,0,163,23.285714285714285,9,0.0,12,36,14,11,51,16,8,15,0,73,90,0
1856,28478,YTGgnrEwOUYAUQwflLpD25p77n6Jd78c,5Gyp41oLVo7Gg7vF4vpmggWP5MU70QO6,11,13,7,3,4,0,4,0,31,4.428571428571429,3,0.0,3,7,2,4,10,0,1,4,0,16,15,0
1857,28490,qBuOYvjWXxAt6x3Clq0Mm94iVtXMfRzl,5Gyp41oLVo7Gg7vF4vpmggWP5MU70QO6,9,5,4,0,3,0,2,0,14,2.0,1,0.0,0,4,0,3,5,0,0,2,0,7,7,1
1858,28520,mSZYyfRNnqnDs7qyuaQEMEvx5vC2JS4M,5Gyp41oLVo7Gg7vF4vpmggWP5MU70QO6,6,5,4,0,4,0,1,0,14,2.0,1,0.0,0,4,0,4,5,0,0,1,0,8,6,1
1859,28521,j6ErWPW1uiWtFClFtsuMDI6P4ntwbAdZ,5Gyp41oLVo7Gg7vF4vpmggWP5MU70QO6,14,19,2,6,4,16,2,0,49,7.0,2,0.0,3,2,3,4,16,16,3,2,0,12,37,1
1860,28537,FXyHUn5FK6vjOTbpqXsoSHGWLI84x3qE,5Gyp41oLVo7Gg7vF4vpmggWP5MU70QO6,27,42,23,19,18,0,6,0,108,15.428571428571429,2,0.0,13,23,11,18,29,0,8,6,0,65,43,1
1861,28557,K1pJhtkexIe54pZxjAqUQbAIpHvM5SO6,5Gyp41oLVo7Gg7vF4vpmggWP5MU70QO6,17,18,11,0,5,0,7,1,42,6.0,2,0.0,0,11,0,5,18,0,0,7,1,16,26,1
1862,28569,powqMOenKH0qm70RdpWJkOu71ffX4cZ2,5Gyp41oLVo7Gg7vF4vpmggWP5MU70QO6,5,2,1,0,1,0,2,0,6,0.8571428571428571,1,0.0,0,1,0,1,2,0,0,2,0,2,4,1
1863,28570,N5tl2ONWAOdqInYowuXdxoR0l8SjB2Yi,5Gyp41oLVo7Gg7vF4vpmggWP5MU70QO6,6,8,4,0,1,0,4,0,17,2.4285714285714284,1,0.0,0,4,0,1,8,0,0,4,0,5,12,1
1864,28571,C9gGaOItLlzMqnWPFFyoyUeOqZmZ6BLj,5Gyp41oLVo7Gg7vF4vpmggWP5MU70QO6,11,12,7,2,5,2,3,0,31,4.428571428571429,1,0.0,3,7,1,5,9,2,1,3,0,16,15,1
1865,28579,lYCUe6jDfXsb0c06PHUzEKRKr8ha5nYO,5Gyp41oLVo7Gg7vF4vpmggWP5MU70QO6,21,25,13,6,6,6,11,3,70,10.0,2,0.0,9,13,5,6,16,6,1,11,3,33,37,0
1866,28581,rew0c3O7roxnm8EfAzYQGMCDX1NNxnod,5Gyp41oLVo7Gg7vF4vpmggWP5MU70QO6,19,43,18,0,24,0,2,0,87,12.428571428571429,4,0.0,18,18,0,24,25,0,0,2,0,60,27,1
1867,28592,DmMJESm0HPPuzZsFzUwdEUeMIsKkPmIB,5Gyp41oLVo7Gg7vF4vpmggWP5MU70QO6,26,65,29,28,15,24,12,0,173,24.714285714285715,6,0.0,17,29,18,15,48,24,10,12,0,79,94,1
1868,28598,P1zBFX39hk4RS67q1S3LCCKIITQT24NO,5Gyp41oLVo7Gg7vF4vpmggWP5MU70QO6,6,3,1,0,1,0,5,0,10,1.4285714285714286,2,0.0,0,1,0,1,3,0,0,5,0,2,8,1
1869,28609,Kkk2oty8lHBEgyFYDiZgsO24fUpD8pZQ,5Gyp41oLVo7Gg7vF4vpmggWP5MU70QO6,28,59,29,17,15,1,14,0,135,19.285714285714285,7,0.0,11,29,11,15,48,1,6,14,0,66,69,1
1870,28618,Z13gCiJciUykTdLRTsjNu2GwwR7Nbxp1,5Gyp41oLVo7Gg7vF4vpmggWP5MU70QO6,6,4,2,0,1,0,3,0,10,1.4285714285714286,2,0.0,0,2,0,1,4,0,0,3,0,3,7,1
1871,28639,5h3b7aFxVycJtoVIoQAHNUuIkrkWrRDG,5Gyp41oLVo7Gg7vF4vpmggWP5MU70QO6,31,44,24,10,10,0,10,0,98,14.0,8,0.0,7,24,10,10,37,0,0,10,0,51,47,1
1872,28644,PSnq49NT1XMAnj56MFCY3Tm8aOLD2VrB,5Gyp41oLVo7Gg7vF4vpmggWP5MU70QO6,1,0,0,0,0,0,1,0,1,0.14285714285714285,1,0.0,0,0,0,0,0,0,0,1,0,0,1,1
1873,28656,EvJkscqMA19TxzJafyfC0WBEGMVNjUMY,5Gyp41oLVo7Gg7vF4vpmggWP5MU70QO6,10,6,3,6,3,0,3,0,21,3.0,2,0.0,2,3,3,3,4,0,3,3,0,11,10,1
1874,28669,by4YyBr8Tq0vara5QIoE6KjoE3BZ5ozG,5Gyp41oLVo7Gg7vF4vpmggWP5MU70QO6,11,5,3,2,2,0,5,0,17,2.4285714285714284,1,0.0,1,3,1,2,4,0,1,5,0,7,10,1
1875,28675,nBvjxfottsOCrOycyCAN2ZrAK5pyyTJB,5Gyp41oLVo7Gg7vF4vpmggWP5MU70QO6,1,0,0,0,0,0,1,0,1,0.14285714285714285,1,0.0,0,0,0,0,0,0,0,1,0,0,1,1
1876,28686,dwsRSZLW8XW5JLCc461YQT9Iq8xPIYuB,5Gyp41oLVo7Gg7vF4vpmggWP5MU70QO6,6,3,2,0,1,0,2,0,8,1.1428571428571428,1,0.0,0,2,0,1,3,0,0,2,0,3,5,1
1877,28722,Jg02qgZSWErbjMBLI4Ec4G5s6mLoGXgk,5Gyp41oLVo7Gg7vF4vpmggWP5MU70QO6,6,3,1,0,1,0,2,0,7,1.0,1,0.0,0,1,0,1,3,0,0,2,0,2,5,1
1878,28744,9truuhFe5C1dOpwljnGJpmEuom5JrEfD,5Gyp41oLVo7Gg7vF4vpmggWP5MU70QO6,10,13,9,0,4,10,7,5,48,6.857142857142857,3,0.0,0,9,0,4,13,10,0,7,5,13,35,1
1879,28751,5lEqPu8Wcy0ntbFeV8g26DyNZTHiSuX4,5Gyp41oLVo7Gg7vF4vpmggWP5MU70QO6,25,38,21,15,13,0,5,0,92,13.142857142857142,5,0.0,11,21,10,13,27,0,5,5,0,55,37,1
1880,28771,NpyIJA0xxyDIqIVlOSt1MN2zYTYh79C0,5Gyp41oLVo7Gg7vF4vpmggWP5MU70QO6,10,14,7,4,3,0,2,0,30,4.285714285714286,2,0.0,4,7,2,3,10,0,2,2,0,16,14,1
1881,28823,xIGSAiekQUYr8YO5cwgwCu83bsRi7P5s,5Gyp41oLVo7Gg7vF4vpmggWP5MU70QO6,60,197,99,44,43,174,30,2,589,84.14285714285714,13,0.0,66,99,32,43,131,174,12,30,2,240,349,0
1882,28827,mWv2aD1lbqJSR5LQ8znxXgNEw4RCzno5,5Gyp41oLVo7Gg7vF4vpmggWP5MU70QO6,23,58,20,10,11,0,11,0,110,15.714285714285714,6,0.0,8,20,5,11,50,0,5,11,0,44,66,0
1883,28851,Hz1gD3xapoX9NB1k77xvttI5SLCsWFqX,5Gyp41oLVo7Gg7vF4vpmggWP5MU70QO6,15,22,13,10,6,4,4,0,59,8.428571428571429,1,0.0,5,13,5,6,17,4,5,4,0,29,30,1
1884,28856,Ss1uSs1DdHnQ3SS6zPdNDkPcKK378C4E,5Gyp41oLVo7Gg7vF4vpmggWP5MU70QO6,21,51,20,12,15,3,8,1,110,15.714285714285714,5,0.0,13,20,8,15,38,3,4,8,1,56,54,0
1885,28864,lUmqjiZL8pqPPgjGcmqK6Bx8gf96ZDh9,5Gyp41oLVo7Gg7vF4vpmggWP5MU70QO6,7,3,2,0,2,0,2,0,9,1.2857142857142858,1,0.0,0,2,0,2,3,0,0,2,0,4,5,1
1886,28871,mr6SHndrMUFTgJeI3Xsa4qtu794cguyo,5Gyp41oLVo7Gg7vF4vpmggWP5MU70QO6,3,0,0,0,0,2,2,0,4,0.5714285714285714,1,0.0,0,0,0,0,0,2,0,2,0,0,4,1
1887,28879,WCcz58k4iCjxZhNWgAj7C2bFhYOdHM0V,5Gyp41oLVo7Gg7vF4vpmggWP5MU70QO6,43,102,51,23,33,12,8,1,230,32.857142857142854,4,0.0,33,51,20,33,69,12,3,8,1,137,93,0
1888,28909,XLqOA0uzBEHNqoUS32Oa7pu4rIM9H3dm,5Gyp41oLVo7Gg7vF4vpmggWP5MU70QO6,4,0,0,0,0,0,3,1,4,0.5714285714285714,1,0.0,0,0,0,0,0,0,0,3,1,0,4,1
1889,28918,YFhn0p0B163GXwlC3Qc0b66iIGcGBrIh,5Gyp41oLVo7Gg7vF4vpmggWP5MU70QO6,25,30,17,18,15,0,12,0,92,13.142857142857142,3,0.0,13,17,9,15,17,0,9,12,0,54,38,0
1890,28923,zn2X74vvqUQRINz90WjZLsSsFglpYr7o,5Gyp41oLVo7Gg7vF4vpmggWP5MU70QO6,33,94,37,11,29,13,18,0,202,28.857142857142858,6,0.0,33,37,8,29,61,13,3,18,0,107,95,0
1891,28931,O5vskJ9Repv2jiK8J8yXq85Y8hYEu2dg,5Gyp41oLVo7Gg7vF4vpmggWP5MU70QO6,35,90,16,32,6,27,17,1,189,27.0,9,0.0,20,16,28,6,70,27,4,17,1,70,119,1
1892,28935,AsOtGuZjIIEs9Ge9E033Sbp9VeIeUiUH,5Gyp41oLVo7Gg7vF4vpmggWP5MU70QO6,2,0,0,0,0,0,2,0,2,0.2857142857142857,1,0.0,0,0,0,0,0,0,0,2,0,0,2,0
1893,28970,Qb2VAk3EqflWvF2aBP5imzRDjkUce9e9,5Gyp41oLVo7Gg7vF4vpmggWP5MU70QO6,30,38,10,37,16,0,5,0,106,15.142857142857142,7,0.0,7,10,28,16,31,0,9,5,0,61,45,1
1894,28971,ZRytVQUPgtfhKTh2gHAURcAThGLNgtND,5Gyp41oLVo7Gg7vF4vpmggWP5MU70QO6,11,4,3,0,3,0,4,1,15,2.142857142857143,1,0.0,0,3,0,3,4,0,0,4,1,6,9,1
1895,28978,YwMASqqYJxzRjuKe9JI9rWFNQbTS5tSD,5Gyp41oLVo7Gg7vF4vpmggWP5MU70QO6,17,19,12,8,4,0,4,0,47,6.714285714285714,3,0.0,2,12,7,4,17,0,1,4,0,25,22,1
1896,28994,gYuUT9QMr36TgMwrUR6D9cZmy4gnOehi,5Gyp41oLVo7Gg7vF4vpmggWP5MU70QO6,1,0,0,0,0,0,1,0,1,0.14285714285714285,1,0.0,0,0,0,0,0,0,0,1,0,0,1,1
1897,29004,qjHwo6vj8wB9RjaUFit8YYLku9NQ6yRr,5Gyp41oLVo7Gg7vF4vpmggWP5MU70QO6,6,6,2,0,2,0,3,0,13,1.8571428571428572,1,0.0,0,2,0,2,6,0,0,3,0,4,9,1
1898,29014,YZRgEIqleRNbrmIXR70msHxIqmdQTJEi,5Gyp41oLVo7Gg7vF4vpmggWP5MU70QO6,23,34,19,12,13,4,16,4,102,14.571428571428571,3,0.0,8,19,6,13,26,4,6,16,4,46,56,1
1899,29043,jtsbnKKZ9XPpwCclPqSDCMPCyLbC3Ksj,5Gyp41oLVo7Gg7vF4vpmggWP5MU70QO6,4,2,1,0,0,0,3,0,6,0.8571428571428571,2,0.0,0,1,0,0,2,0,0,3,0,1,5,1
1900,29059,O4E7as3W8jLvygS4k9RX6VKdAkX7GkpR,5Gyp41oLVo7Gg7vF4vpmggWP5MU70QO6,9,3,1,0,1,2,6,1,14,2.0,1,0.0,0,1,0,1,3,2,0,6,1,2,12,1
1901,29067,MYsCU1zkMrWxPhV1b7wSL5LZIo1zGyhU,5Gyp41oLVo7Gg7vF4vpmggWP5MU70QO6,21,30,14,0,16,0,6,0,66,9.428571428571429,5,0.0,5,14,0,16,25,0,0,6,0,35,31,1
1902,29105,2opAUoNSerHZgAopOdFnCtwADJEb5rjv,5Gyp41oLVo7Gg7vF4vpmggWP5MU70QO6,12,20,8,2,7,0,5,0,42,6.0,2,0.0,9,8,1,7,11,0,1,5,0,25,17,1
1903,29106,3yvPMapV0oGhFADehSUOgOal67P5QYOZ,5Gyp41oLVo7Gg7vF4vpmggWP5MU70QO6,8,3,1,0,1,2,6,1,14,2.0,1,0.0,0,1,0,1,3,2,0,6,1,2,12,1
1904,29118,5huQeH1wiIOmABPoRY4ZHf8AKpAeX6tY,5Gyp41oLVo7Gg7vF4vpmggWP5MU70QO6,12,14,9,0,2,5,10,1,41,5.857142857142857,4,0.0,0,9,0,2,14,5,0,10,1,11,30,1
1905,29122,y28h4Mo8cYpNiUreeF5KoyNN24Uz0qpM,5Gyp41oLVo7Gg7vF4vpmggWP5MU70QO6,24,59,29,24,1,0,25,0,138,19.714285714285715,7,0.0,12,29,20,1,47,0,4,25,0,62,76,1
1906,29134,j6yHCOz2971dxJ3D75B738Ui2dTUKwWK,5Gyp41oLVo7Gg7vF4vpmggWP5MU70QO6,1,0,0,0,0,0,1,0,1,0.14285714285714285,1,0.0,0,0,0,0,0,0,0,1,0,0,1,1
1907,29155,TUYpmTNk6Q7u0KzTuM5wULfxBnddBpQa,5Gyp41oLVo7Gg7vF4vpmggWP5MU70QO6,26,70,36,25,5,39,16,8,199,28.428571428571427,6,0.0,22,36,19,5,48,39,6,16,8,82,117,1
1908,29167,3SP9iNDvUt8m67ZMqC5DpQRe6ekkTpsP,5Gyp41oLVo7Gg7vF4vpmggWP5MU70QO6,5,2,1,0,1,0,5,0,9,1.2857142857142858,3,0.0,0,1,0,1,2,0,0,5,0,2,7,0
1909,29173,xJjW1X2F9FnPULUeJMqNeOytdLBSBRfA,5Gyp41oLVo7Gg7vF4vpmggWP5MU70QO6,33,93,49,26,24,42,23,2,259,37.0,10,0.0,16,49,16,24,77,42,10,23,2,105,154,0
1910,29176,z1G7LpYxsjwTZY4hppMJzutv7SFcW56t,5Gyp41oLVo7Gg7vF4vpmggWP5MU70QO6,11,14,5,6,3,0,2,0,30,4.285714285714286,2,0.0,4,5,3,3,10,0,3,2,0,15,15,1
1911,29193,Ff3Eor13TUJQKJ2fXrBcatS19PhaFPUY,5Gyp41oLVo7Gg7vF4vpmggWP5MU70QO6,6,3,2,0,1,0,2,0,8,1.1428571428571428,1,0.0,0,2,0,1,3,0,0,2,0,3,5,1
1912,29198,dT92IjRcuruPiAlpqVUTtu3wNL9IIegT,5Gyp41oLVo7Gg7vF4vpmggWP5MU70QO6,31,78,42,7,28,29,22,2,208,29.714285714285715,9,0.0,22,42,5,28,56,29,2,22,2,97,111,0
1913,29203,Fd76JNXzmmy6WMyqnUG7g2JlGziXBHRa,5Gyp41oLVo7Gg7vF4vpmggWP5MU70QO6,33,48,28,6,16,12,15,2,127,18.142857142857142,3,0.0,6,28,3,16,42,12,3,15,2,53,74,1
1914,29219,3h1FKqVdnDmZ3yTfOEvfGnfVX1CtMfQe,5Gyp41oLVo7Gg7vF4vpmggWP5MU70QO6,4,2,1,0,1,0,1,0,5,0.7142857142857143,1,0.0,0,1,0,1,2,0,0,1,0,2,3,1
1915,29228,j3GJZP6DDST4bxF4BY92UyMmGqZXcisu,5Gyp41oLVo7Gg7vF4vpmggWP5MU70QO6,18,63,30,10,11,8,15,2,139,19.857142857142858,8,0.0,13,30,7,11,50,8,3,15,2,61,78,1
1916,29231,9qSqrvUWqQapebc826sTRi4MoymfAgqm,5Gyp41oLVo7Gg7vF4vpmggWP5MU70QO6,6,5,3,0,1,0,1,0,10,1.4285714285714286,1,0.0,1,3,0,1,4,0,0,1,0,5,5,1
1917,29258,SSYZb9OF5KY8dLa1Ga5Owl0oYrKsZRGn,5Gyp41oLVo7Gg7vF4vpmggWP5MU70QO6,1,0,0,0,0,0,1,0,1,0.14285714285714285,1,0.0,0,0,0,0,0,0,0,1,0,0,1,1
1918,29259,Q7wqVDqz10tk4xe6QnkzI1dJqMLzdK4Z,5Gyp41oLVo7Gg7vF4vpmggWP5MU70QO6,43,136,67,56,46,38,42,2,387,55.285714285714285,9,0.0,52,67,41,46,84,38,15,42,2,206,181,0
1919,29260,qfe1MUR6a62dAgiCJR4API4cCHsYlsVO,5Gyp41oLVo7Gg7vF4vpmggWP5MU70QO6,50,128,72,43,27,19,35,0,324,46.285714285714285,11,0.0,27,72,32,27,101,19,11,35,0,158,166,0
1920,29270,yYvdpBKQCT3mxVBi4HL53T6yMUlPV3lV,5Gyp41oLVo7Gg7vF4vpmggWP5MU70QO6,7,5,2,0,2,0,2,0,11,1.5714285714285714,1,0.0,0,2,0,2,5,0,0,2,0,4,7,1
1921,29282,wxII2lcu70Ngy60gW8YUtG9pAurp2KE2,5Gyp41oLVo7Gg7vF4vpmggWP5MU70QO6,25,41,18,9,10,27,19,1,125,17.857142857142858,3,0.0,15,18,6,10,26,27,3,19,1,49,76,0
1922,29290,KQEanfaExp2HaRRw3kFa1StUZu1Jf6eb,5Gyp41oLVo7Gg7vF4vpmggWP5MU70QO6,7,3,2,0,2,0,3,0,10,1.4285714285714286,1,0.0,0,2,0,2,3,0,0,3,0,4,6,0
1923,29322,clBoQvHF7hj2lt9aMKUGNE4YYTF1KNgv,5Gyp41oLVo7Gg7vF4vpmggWP5MU70QO6,7,2,1,0,1,0,6,1,11,1.5714285714285714,2,0.0,0,1,0,1,2,0,0,6,1,2,9,1
1924,29323,S23VviJLUWhhZxkRbUP6UVbiLqWFCEzq,5Gyp41oLVo7Gg7vF4vpmggWP5MU70QO6,16,54,17,19,0,0,19,0,109,15.571428571428571,7,0.0,11,17,13,0,43,0,6,19,0,41,68,0
1925,29331,CfeENerIdAGepleePWSt0SV88ctt0Tmw,5Gyp41oLVo7Gg7vF4vpmggWP5MU70QO6,36,56,27,33,14,0,10,0,140,20.0,8,0.0,17,27,23,14,39,0,10,10,0,81,59,0
1926,29368,43Wkazohlla5UH9sdItyCzS7QnbvL5qv,5Gyp41oLVo7Gg7vF4vpmggWP5MU70QO6,5,2,1,0,1,0,2,0,6,0.8571428571428571,1,0.0,0,1,0,1,2,0,0,2,0,2,4,1
1927,29370,OGbthebNtjAyVjwwyFFOPyRN8eqkNKOX,5Gyp41oLVo7Gg7vF4vpmggWP5MU70QO6,2,0,0,0,0,0,5,0,5,0.7142857142857143,2,0.0,0,0,0,0,0,0,0,5,0,0,5,1
1928,29371,wEaTyOJwwvOCk7eUttQISK5WPXL7ANNV,5Gyp41oLVo7Gg7vF4vpmggWP5MU70QO6,8,3,2,0,2,3,6,0,16,2.2857142857142856,3,0.0,0,2,0,2,3,3,0,6,0,4,12,1
1929,29380,ebvWYER6Bde0EUcNXXIX0vyTB9ur6Kqi,5Gyp41oLVo7Gg7vF4vpmggWP5MU70QO6,29,86,42,22,18,47,20,2,237,33.857142857142854,5,0.0,25,42,14,18,61,47,8,20,2,99,138,0
1930,29382,bgQsXQVqW7nKiA6XYCj1PJIhNhYmFF2l,5Gyp41oLVo7Gg7vF4vpmggWP5MU70QO6,7,6,3,0,2,0,3,0,14,2.0,2,0.0,0,3,0,2,6,0,0,3,0,5,9,1
1931,29392,oEdWxTxTl1fP4jZhcgcYgWShP81rmHLb,5Gyp41oLVo7Gg7vF4vpmggWP5MU70QO6,35,55,28,36,7,0,7,0,133,19.0,6,0.0,18,28,29,7,37,0,7,7,0,82,51,0
1932,29398,AeCrxYByugIwu4XUBpI0LhoTguBozLAa,5Gyp41oLVo7Gg7vF4vpmggWP5MU70QO6,30,74,39,4,15,2,23,1,158,22.571428571428573,4,0.0,17,39,3,15,57,2,1,23,1,74,84,1
1933,29400,6oCPedN9dJXckwppJuquEbXGJo8RLgKS,5Gyp41oLVo7Gg7vF4vpmggWP5MU70QO6,10,8,3,0,1,1,4,1,18,2.5714285714285716,1,0.0,3,3,0,1,5,1,0,4,1,7,11,1
1934,29411,BdodnRCsey53xS6PtugKwlzojwI7pwLX,5Gyp41oLVo7Gg7vF4vpmggWP5MU70QO6,16,21,9,8,5,2,7,1,53,7.571428571428571,3,0.0,10,9,6,5,11,2,2,7,1,30,23,1
1935,29429,1Q6h3xdVmuuH4K91cf7ebDxMbyWSO6oC,5Gyp41oLVo7Gg7vF4vpmggWP5MU70QO6,3,3,0,0,0,0,1,0,4,0.5714285714285714,1,0.0,0,0,0,0,3,0,0,1,0,0,4,1
1936,29434,7aQ6rvmUrAZhXOumaP4VW6FvjX4qSmMG,5Gyp41oLVo7Gg7vF4vpmggWP5MU70QO6,28,67,28,17,19,9,19,1,160,22.857142857142858,6,0.0,17,28,14,19,50,9,3,19,1,78,82,0
1937,29436,of3rDqGvzfaaTw1dgLkUpAaYyPR92tjG,5Gyp41oLVo7Gg7vF4vpmggWP5MU70QO6,9,6,4,0,3,0,4,0,17,2.4285714285714284,2,0.0,0,4,0,3,6,0,0,4,0,7,10,1
1938,29446,YV392hfECoOmaAZdo0LSEB6pVt8DaTKa,5Gyp41oLVo7Gg7vF4vpmggWP5MU70QO6,11,6,4,0,3,0,5,0,18,2.5714285714285716,2,0.0,0,4,0,3,6,0,0,5,0,7,11,1
1939,29454,bf1vJ4viENhWXEbAPbJbIXhTELHnfeS4,5Gyp41oLVo7Gg7vF4vpmggWP5MU70QO6,1,0,0,0,0,0,1,0,1,0.14285714285714285,1,0.0,0,0,0,0,0,0,0,1,0,0,1,1
1940,29457,4m5GFuE7r7uv3mC9zYjUgCEig5epKquJ,5Gyp41oLVo7Gg7vF4vpmggWP5MU70QO6,28,55,33,35,11,0,17,0,151,21.571428571428573,7,0.0,10,33,25,11,45,0,10,17,0,79,72,0
1941,29460,9kWKUDsV7M3Xl925FSGZmKjgOHYDauwa,5Gyp41oLVo7Gg7vF4vpmggWP5MU70QO6,5,2,1,0,1,0,3,0,7,1.0,1,0.0,0,1,0,1,2,0,0,3,0,2,5,0
1942,29463,StB4aAmvKVcN39RyCivcWuZG1ojX62LP,5Gyp41oLVo7Gg7vF4vpmggWP5MU70QO6,12,7,5,0,4,0,4,1,21,3.0,1,0.0,0,5,0,4,7,0,0,4,1,9,12,1
1943,29479,ComEg5DwSZNvhCGBr5HiWi0eJvqzecfK,5Gyp41oLVo7Gg7vF4vpmggWP5MU70QO6,1,0,0,0,0,0,1,0,1,0.14285714285714285,1,0.0,0,0,0,0,0,0,0,1,0,0,1,1
1944,29486,USLTnsAwagwK2c83KXd1SNEeENnzkTTo,5Gyp41oLVo7Gg7vF4vpmggWP5MU70QO6,10,11,4,0,4,7,7,0,33,4.714285714285714,6,0.0,3,4,0,4,8,7,0,7,0,11,22,0
1945,29495,76h4fJa0WUda9eD251xcu8JxqYQOKc5R,5Gyp41oLVo7Gg7vF4vpmggWP5MU70QO6,1,0,0,0,0,0,2,0,2,0.2857142857142857,2,0.0,0,0,0,0,0,0,0,2,0,0,2,0
1946,29508,2NbXhEsOSF2oLrJt2BdmifqgcsW4T9D5,5Gyp41oLVo7Gg7vF4vpmggWP5MU70QO6,4,6,1,0,0,0,2,0,9,1.2857142857142858,1,0.0,4,1,0,0,2,0,0,2,0,5,4,1
1947,29528,TBC5WTDbcV3aVUUIUvUx97YEiYG5oye2,5Gyp41oLVo7Gg7vF4vpmggWP5MU70QO6,21,50,32,12,6,16,6,0,122,17.428571428571427,4,0.0,9,32,8,6,41,16,4,6,0,55,67,1
1948,29529,l8y9XhqsTWKZM98GIdD9TBmJPA1SlU5G,5Gyp41oLVo7Gg7vF4vpmggWP5MU70QO6,16,26,12,4,8,0,5,0,55,7.857142857142857,2,0.0,11,12,2,8,15,0,2,5,0,33,22,1
1949,29553,G6nlPCsxbn3tVSpDUhIRDWH9MFaFPV4K,5Gyp41oLVo7Gg7vF4vpmggWP5MU70QO6,1,0,0,0,0,0,1,0,1,0.14285714285714285,1,0.0,0,0,0,0,0,0,0,1,0,0,1,1
1950,29561,pLQfsJL46iqa9L7UfI8ODNozilMqoPl0,5Gyp41oLVo7Gg7vF4vpmggWP5MU70QO6,24,48,29,16,16,0,11,2,122,17.428571428571427,5,0.0,12,29,12,16,36,0,4,11,2,69,53,0
1951,29571,KVFLGfkLjESnixIuWE2enCugNN1bDzvq,5Gyp41oLVo7Gg7vF4vpmggWP5MU70QO6,43,132,65,59,23,5,33,2,319,45.57142857142857,10,0.0,36,65,47,23,96,5,12,33,2,171,148,0
1952,29594,TSPlBwReynnjQ2q72CnYFjLp85rX76cJ,5Gyp41oLVo7Gg7vF4vpmggWP5MU70QO6,2,0,0,0,0,0,2,0,2,0.2857142857142857,1,0.0,0,0,0,0,0,0,0,2,0,0,2,1
1953,29603,ERiNRhAcimB8GiumVAtTpcZJjnjuVuqO,3VkHkmOtom3jM2wCu94xgzzu1d6Dn7or,98,383,92,60,94,54,48,3,734,104.85714285714286,11,0.0,169,92,51,94,214,54,9,48,3,406,328,0
1954,29615,uc2JecHkP7BdqwAtRnvlH2Qn6D1UAeHx,3VkHkmOtom3jM2wCu94xgzzu1d6Dn7or,30,79,4,34,33,7,11,1,169,24.142857142857142,3,0.0,57,4,30,33,22,7,4,11,1,124,45,0
1955,29623,QbN1rcT6X70kGcCCu9qHO2zQXGCyhPMc,3VkHkmOtom3jM2wCu94xgzzu1d6Dn7or,71,376,50,54,39,28,69,8,624,89.14285714285714,18,0.0,99,50,49,39,277,28,5,69,8,237,387,0
1956,29640,G14xjTwMWbfsqTNiU3Ie1utHyPegqSvR,3VkHkmOtom3jM2wCu94xgzzu1d6Dn7or,69,146,9,68,57,33,12,0,325,46.42857142857143,8,0.0,52,9,65,57,94,33,3,12,0,183,142,1
1957,29652,ZRcEnEYSSBQbkjzMu7sidjbxasfrmw8l,3VkHkmOtom3jM2wCu94xgzzu1d6Dn7or,57,245,91,53,24,75,72,0,560,80.0,11,0.0,47,91,50,24,198,75,3,72,0,212,348,0
1958,29660,j8pAEG832Dxba9xvdSBnP5qKRrQfOVPx,3VkHkmOtom3jM2wCu94xgzzu1d6Dn7or,88,167,76,68,54,47,40,10,462,66.0,16,0.0,60,76,65,54,107,47,3,40,10,255,207,0
1959,29710,Dj6MZagDLXpRqHs1ziJsdRiKzK9FQr4E,3VkHkmOtom3jM2wCu94xgzzu1d6Dn7or,82,248,112,42,79,22,29,2,534,76.28571428571429,13,0.0,79,112,38,79,169,22,4,29,2,308,226,0
1960,29711,hn5H504xu7pHzMUOVhXt84Zd8pM4hTfO,3VkHkmOtom3jM2wCu94xgzzu1d6Dn7or,64,331,59,83,21,33,51,1,579,82.71428571428571,16,0.0,137,59,83,21,194,33,0,51,1,300,279,0
1961,29753,xXrVRzXnwBPVy7gMaBqKJcUodoANmGAp,3VkHkmOtom3jM2wCu94xgzzu1d6Dn7or,94,221,125,127,85,35,47,2,642,91.71428571428571,9,0.0,69,125,112,85,152,35,15,47,2,391,251,0
1962,29773,MRCD9XxqQVpIexf9EdSwdaoHW691k7OH,3VkHkmOtom3jM2wCu94xgzzu1d6Dn7or,56,199,75,152,0,0,15,0,441,63.0,10,0.0,84,75,139,0,115,0,13,15,0,298,143,0
1963,29779,BMm4TXqDDPzNdjhOhmJHUopJaVFMX2Fi,3VkHkmOtom3jM2wCu94xgzzu1d6Dn7or,37,122,43,45,47,40,30,0,327,46.714285714285715,8,0.0,61,43,39,47,61,40,6,30,0,190,137,0
1964,29831,e3jyk3cEmLPB3vUaF04lE0JygxYvGYSB,3VkHkmOtom3jM2wCu94xgzzu1d6Dn7or,2,0,0,0,0,0,2,0,2,0.2857142857142857,1,0.0,0,0,0,0,0,0,0,2,0,0,2,1
1965,29834,eSLdnCsz2kfsBjZ0LZmqHuo4kYNor6E7,3VkHkmOtom3jM2wCu94xgzzu1d6Dn7or,49,124,16,34,8,31,17,0,230,32.857142857142854,9,0.0,39,16,34,8,85,31,0,17,0,97,133,1
1966,29839,cRaVLabX771mlZBzFVbphmCLcsSt1u7U,3VkHkmOtom3jM2wCu94xgzzu1d6Dn7or,83,380,80,93,46,9,96,3,707,101.0,12,0.0,135,80,87,46,245,9,6,96,3,348,359,1
1967,29859,7cYcOHOEHTj81GR9iJWLLP6E0QCPSEZI,3VkHkmOtom3jM2wCu94xgzzu1d6Dn7or,92,386,56,165,52,21,94,4,778,111.14285714285714,13,0.0,120,56,156,52,266,21,9,94,4,384,394,0
1968,29862,1umo7etGwkx7NcpFxVialzDD37NdyqRT,3VkHkmOtom3jM2wCu94xgzzu1d6Dn7or,44,112,40,79,0,34,22,4,291,41.57142857142857,6,0.0,59,40,75,0,53,34,4,22,4,174,117,0
1969,29901,1LkyopMOf8KZ37c5gNSy63BKRJpsqu4r,3VkHkmOtom3jM2wCu94xgzzu1d6Dn7or,91,356,116,116,128,8,43,0,767,109.57142857142857,8,0.0,210,116,106,128,146,8,10,43,0,560,207,0
1970,29905,J1iCM60eAwVKTPRoP9hdyFlEQf6db3YF,3VkHkmOtom3jM2wCu94xgzzu1d6Dn7or,89,159,45,70,69,3,18,1,365,52.142857142857146,6,0.0,104,45,65,69,55,3,5,18,1,283,82,0
1971,29907,7V4dcaUNsItviw8DzarHDLmlVXnKNzmD,3VkHkmOtom3jM2wCu94xgzzu1d6Dn7or,6,2,2,0,1,0,8,0,13,1.8571428571428572,1,0.0,0,2,0,1,2,0,0,8,0,3,10,1
1972,29931,mRXqdZHYKT0RihxxoCUoovr8vUKN1zpb,3VkHkmOtom3jM2wCu94xgzzu1d6Dn7or,80,390,19,72,23,20,16,5,545,77.85714285714286,8,0.0,157,19,60,23,233,20,12,16,5,259,286,0
1973,29937,kNdT4Mob6J1VkdvqbhmS4aPzbDLqNeYP,3VkHkmOtom3jM2wCu94xgzzu1d6Dn7or,98,277,121,105,88,23,105,1,720,102.85714285714286,22,0.0,86,121,91,88,191,23,14,105,1,386,334,0
1974,29953,wr8WXMW1aPIOlA7JAe7Pc60PLuoPom1V,3VkHkmOtom3jM2wCu94xgzzu1d6Dn7or,30,73,19,19,28,10,21,1,171,24.428571428571427,4,0.0,46,19,18,28,27,10,1,21,1,111,60,1
1975,29989,81MrJTtJ3gigKP7Iz9fJFypIyjsrSPC5,3VkHkmOtom3jM2wCu94xgzzu1d6Dn7or,1,0,0,0,0,0,1,0,1,0.14285714285714285,1,0.0,0,0,0,0,0,0,0,1,0,0,1,1
1976,30002,gD7dR7qYBA1tFY5jHEs9UR01plTA8iId,3VkHkmOtom3jM2wCu94xgzzu1d6Dn7or,73,173,43,88,63,6,18,2,393,56.142857142857146,9,0.0,109,43,76,63,64,6,12,18,2,291,102,0
1977,30005,k7GcrgNM8NrAzS9cqFwxMdS1Vs120F2Y,3VkHkmOtom3jM2wCu94xgzzu1d6Dn7or,63,203,40,66,46,58,31,4,448,64.0,5,0.0,98,40,60,46,105,58,6,31,4,244,204,1
1978,30024,w8ZFhN1TfPEk3lRT4vyoUkNMZOvvywKH,3VkHkmOtom3jM2wCu94xgzzu1d6Dn7or,9,15,5,0,3,4,14,1,42,6.0,1,0.0,6,5,0,3,9,4,0,14,1,14,28,1
1979,30031,e6vc9r1qQ4KcnjRUHEG8vhe39kn3GgXy,3VkHkmOtom3jM2wCu94xgzzu1d6Dn7or,4,2,1,0,1,0,1,0,5,0.7142857142857143,1,0.0,0,1,0,1,2,0,0,1,0,2,3,1
1980,30036,ZRMCnJcNKBuzAyov9v96PceQIVaMcHkt,3VkHkmOtom3jM2wCu94xgzzu1d6Dn7or,6,1,1,0,1,0,5,0,8,1.1428571428571428,1,0.0,0,1,0,1,1,0,0,5,0,2,6,1
1981,30062,bC7hHsLc1Hrq0XtHC39FlQ3EKRZvGnuJ,3VkHkmOtom3jM2wCu94xgzzu1d6Dn7or,65,170,87,112,35,41,33,1,479,68.42857142857143,7,0.0,55,87,97,35,115,41,15,33,1,274,205,0
1982,30077,RzMIvT7jMzqf1FBzeYDC0G8NjaFmpbg8,3VkHkmOtom3jM2wCu94xgzzu1d6Dn7or,74,84,38,60,31,29,21,9,272,38.857142857142854,5,0.0,28,38,52,31,56,29,8,21,9,149,123,0
1983,30121,eCJEYxlte8R6sbqh66Nohv34rvkne1DG,3VkHkmOtom3jM2wCu94xgzzu1d6Dn7or,55,107,56,20,38,38,22,0,281,40.142857142857146,8,0.0,34,56,20,38,73,38,0,22,0,148,133,0
1984,30122,kFzEt3qwJsqHITD5QhkyDtVLrUnmyio7,3VkHkmOtom3jM2wCu94xgzzu1d6Dn7or,1,0,0,0,0,0,1,0,1,0.14285714285714285,1,0.0,0,0,0,0,0,0,0,1,0,0,1,1
1985,30146,ihsYc42XAm1ifDUhRQivHQthyMkuHYKA,3VkHkmOtom3jM2wCu94xgzzu1d6Dn7or,97,156,51,81,61,7,37,10,403,57.57142857142857,5,0.0,84,51,67,61,72,7,14,37,10,263,140,0
1986,30153,IFqWOl32JJm0W3Ap2jxVCpJeXeLJlYDp,3VkHkmOtom3jM2wCu94xgzzu1d6Dn7or,1,0,0,0,0,0,1,0,1,0.14285714285714285,1,0.0,0,0,0,0,0,0,0,1,0,0,1,1
1987,30157,susC0ktJSdFusCIZajPDx4pMj5qgCOcg,3VkHkmOtom3jM2wCu94xgzzu1d6Dn7or,94,212,85,54,55,30,65,1,502,71.71428571428571,22,0.0,89,85,50,55,123,30,4,65,1,279,223,0
1988,30166,8uKfJT3Ferex7gSStlreZzcbQrGyXHDu,3VkHkmOtom3jM2wCu94xgzzu1d6Dn7or,73,165,74,46,60,46,31,2,424,60.57142857142857,14,0.0,67,74,44,60,98,46,2,31,2,245,179,0
1989,30209,ZECsrQDWNf4nPUfo4HpZsLiXc2swEQ6q,3VkHkmOtom3jM2wCu94xgzzu1d6Dn7or,10,24,10,2,8,9,9,0,62,8.857142857142858,3,0.0,10,10,2,8,14,9,0,9,0,30,32,0
1990,30232,NKFrndcZRT8yziegfa31eLoFHGGlUjfW,3VkHkmOtom3jM2wCu94xgzzu1d6Dn7or,5,2,0,0,1,0,6,0,9,1.2857142857142858,1,0.0,0,0,0,1,2,0,0,6,0,1,8,1
1991,30237,f71JJWdw4RL398VAk1Uh1TemaAWJWYXn,3VkHkmOtom3jM2wCu94xgzzu1d6Dn7or,5,8,4,0,1,0,3,0,16,2.2857142857142856,3,0.0,1,4,0,1,7,0,0,3,0,6,10,0
1992,30250,1F8H7rmfvGmKxlm2143vBRoEH3vbZnuH,3VkHkmOtom3jM2wCu94xgzzu1d6Dn7or,8,7,0,0,0,9,10,1,27,3.857142857142857,3,0.0,1,0,0,0,6,9,0,10,1,1,26,1
1993,30266,EzVMqBDdKdZIxkwWCIERgvsBQFIRLYcU,3VkHkmOtom3jM2wCu94xgzzu1d6Dn7or,63,114,39,72,41,3,27,1,297,42.42857142857143,7,0.0,51,39,69,41,63,3,3,27,1,200,97,0
1994,30272,c45tGE4X33f1wuWJww6KL4YDWdrZudFS,3VkHkmOtom3jM2wCu94xgzzu1d6Dn7or,89,410,133,44,89,44,57,2,779,111.28571428571429,18,0.0,150,133,38,89,260,44,6,57,2,410,369,0
1995,30277,pMv1oQj1T6gZE30FoEj4M5Nwt7Fl1qeo,3VkHkmOtom3jM2wCu94xgzzu1d6Dn7or,70,281,100,35,52,70,40,7,585,83.57142857142857,9,0.0,94,100,29,52,187,70,6,40,7,275,310,0
1996,30289,Rdvgrardg53H2oeCgmOt8vFxIUu5nogb,3VkHkmOtom3jM2wCu94xgzzu1d6Dn7or,80,224,74,85,79,23,41,4,530,75.71428571428571,13,0.0,124,74,62,79,100,23,23,41,4,339,191,0
1997,30319,Z2WeYOt69iXKJ7H2QQouqRTK4XZZJKWP,3VkHkmOtom3jM2wCu94xgzzu1d6Dn7or,32,73,20,20,30,10,9,0,162,23.142857142857142,8,0.0,26,20,17,30,47,10,3,9,0,93,69,1
1998,30325,3IgwuZBiVdgdYRQ9ySaEvpMizbjCJFS0,3VkHkmOtom3jM2wCu94xgzzu1d6Dn7or,81,131,48,86,31,37,76,2,411,58.714285714285715,12,0.0,34,48,83,31,97,37,3,76,2,196,215,0
1999,30336,QwzgqwSHCQGBlqpFzwe8sYcM8CZG7iZ9,3VkHkmOtom3jM2wCu94xgzzu1d6Dn7or,32,71,32,16,22,25,16,0,182,26.0,4,0.0,27,32,14,22,44,25,2,16,0,95,87,1
2000,30359,lCdFdlJk7vdaCNir9ichM9R3abkujsQJ,3VkHkmOtom3jM2wCu94xgzzu1d6Dn7or,11,14,5,1,5,4,5,2,36,5.142857142857143,1,0.0,8,5,1,5,6,4,0,5,2,19,17,0
2001,30366,aEIhL4b7R0jCP14Ucbi8EaRq7CzwvPlv,3VkHkmOtom3jM2wCu94xgzzu1d6Dn7or,81,248,95,41,79,108,69,4,644,92.0,12,0.0,113,95,39,79,135,108,2,69,4,326,318,0
2002,30376,pfD3zHiFZnj6cBjjOBS9YbsS1DIwlvbH,3VkHkmOtom3jM2wCu94xgzzu1d6Dn7or,13,42,15,10,7,18,22,0,114,16.285714285714285,4,0.0,10,15,8,7,32,18,2,22,0,40,74,1
2003,30380,aNkyAzI9nPsd5pfu7g1LebeN06BtIXr6,3VkHkmOtom3jM2wCu94xgzzu1d6Dn7or,85,185,100,51,66,44,72,18,536,76.57142857142857,16,0.0,54,100,48,66,131,44,3,72,18,268,268,0
2004,30389,dY4494YE2fVYFC6x5i5x0UProy3lTpSi,3VkHkmOtom3jM2wCu94xgzzu1d6Dn7or,4,2,0,0,0,0,2,0,4,0.5714285714285714,1,0.0,0,0,0,0,2,0,0,2,0,0,4,1
2005,30402,d7CRMAVRgBps84fhYwYVHXr4TrIkJYDp,3VkHkmOtom3jM2wCu94xgzzu1d6Dn7or,78,239,17,81,17,0,25,0,379,54.142857142857146,11,0.0,83,17,77,17,156,0,4,25,0,194,185,0
2006,30406,24UY1ChPkZROri1FK7qbly95xg2qveYr,3VkHkmOtom3jM2wCu94xgzzu1d6Dn7or,1,0,0,0,0,0,1,0,1,0.14285714285714285,1,0.0,0,0,0,0,0,0,0,1,0,0,1,1
2007,30412,gl2YVlebVAvCcxsYaIoTwLj5l1IGqntH,3VkHkmOtom3jM2wCu94xgzzu1d6Dn7or,97,413,103,127,111,98,48,6,906,129.42857142857142,16,0.0,169,103,107,111,244,98,20,48,6,490,416,0
2008,30435,FRmbznbV6x9Ojz1brfaBTFmC2TFyzd4t,3VkHkmOtom3jM2wCu94xgzzu1d6Dn7or,61,141,70,38,63,58,10,1,381,54.42857142857143,8,0.0,54,70,33,63,87,58,5,10,1,220,161,0
2009,30459,N5ZyEwF2fjxmUbb8vyfWMYkhLQ0lBJZV,3VkHkmOtom3jM2wCu94xgzzu1d6Dn7or,7,9,5,0,2,0,9,0,25,3.5714285714285716,4,0.0,0,5,0,2,9,0,0,9,0,7,18,1
2010,30473,hf7YI3B1kTTuvmd2vS9DIoiPGXbrQyBH,3VkHkmOtom3jM2wCu94xgzzu1d6Dn7or,90,190,65,71,68,43,59,1,497,71.0,11,0.0,97,65,59,68,93,43,12,59,1,289,208,0
2011,30475,kHp5QZURLzbWn4koqFYZnQmO0kliz5hb,3VkHkmOtom3jM2wCu94xgzzu1d6Dn7or,80,177,82,39,75,16,43,2,434,62.0,14,0.0,59,82,38,75,118,16,1,43,2,254,180,0
2012,30485,tWy6K2sNXVB2esbGJMyXdZRQGH2Klw9e,3VkHkmOtom3jM2wCu94xgzzu1d6Dn7or,7,6,2,0,1,0,5,0,14,2.0,1,0.0,0,2,0,1,6,0,0,5,0,3,11,1
2013,30546,GW33fgaq0ndGNQkirzfpXhCeUuV3tuD2,3VkHkmOtom3jM2wCu94xgzzu1d6Dn7or,49,149,23,50,47,0,15,0,284,40.57142857142857,4,0.0,114,23,44,47,35,0,6,15,0,228,56,0
2014,30554,AFUJTbEqqgSsqCkUsNrjbPAjZvFwpzeW,3VkHkmOtom3jM2wCu94xgzzu1d6Dn7or,75,293,84,46,51,52,26,0,552,78.85714285714286,14,0.0,101,84,44,51,192,52,2,26,0,280,272,0
2015,30572,scAA3eCOIxJ3zzrtEoo95EWQriP778zG,3VkHkmOtom3jM2wCu94xgzzu1d6Dn7or,5,2,1,0,1,0,4,0,8,1.1428571428571428,1,0.0,0,1,0,1,2,0,0,4,0,2,6,1
2016,30589,4cHW06tF9KqyuTTBOtufVP4zE7Ryeghw,3VkHkmOtom3jM2wCu94xgzzu1d6Dn7or,1,0,0,0,0,0,1,0,1,0.14285714285714285,1,0.0,0,0,0,0,0,0,0,1,0,0,1,1
2017,30597,cGrHiRjztN9fSltHujpfWaaWfYWiidiG,3VkHkmOtom3jM2wCu94xgzzu1d6Dn7or,5,5,2,0,1,0,3,0,11,1.5714285714285714,3,0.0,0,2,0,1,5,0,0,3,0,3,8,1
2018,30619,e2CxwSKYgRRxAYL99ajalycn9caM2cox,3VkHkmOtom3jM2wCu94xgzzu1d6Dn7or,93,320,136,76,83,73,139,5,832,118.85714285714286,12,0.0,88,136,71,83,232,73,5,139,5,378,454,0
2019,30639,kXhNP73v7uspLkRCBOTheP3K82COFCXM,3VkHkmOtom3jM2wCu94xgzzu1d6Dn7or,1,0,0,0,0,0,1,0,1,0.14285714285714285,1,0.0,0,0,0,0,0,0,0,1,0,0,1,1
2020,30650,XDPvGyFLLEYwbNEQik2MM4yiADs5rrYJ,3VkHkmOtom3jM2wCu94xgzzu1d6Dn7or,96,295,123,56,84,76,44,2,680,97.14285714285714,13,0.0,120,123,47,84,175,76,9,44,2,374,306,0
2021,30651,EIH1YpezRj2Lrs71q1s3kjWajWGWK1FM,7GRhBDsirIGkRZBtSMEzNTyDr2JQm4xx,12,10,4,2,4,0,3,0,23,3.2857142857142856,2,0.0,1,4,1,4,9,0,1,3,0,10,13,1
2022,30652,c0SE05tRjiEOaThvWcYxSYbAxboLNaZo,7GRhBDsirIGkRZBtSMEzNTyDr2JQm4xx,10,9,3,0,0,0,15,3,30,4.285714285714286,1,0.0,3,3,0,0,6,0,0,15,3,6,24,0
2023,30655,QWxefOu3r3jtQwuYDDkGQhRP3ua789Nr,7GRhBDsirIGkRZBtSMEzNTyDr2JQm4xx,38,76,36,35,32,3,6,0,188,26.857142857142858,1,0.0,34,36,30,32,42,3,5,6,0,132,56,1
2024,30661,Da2YYkrh9YuRinihWxRQSQhXAdFeKqSb,7GRhBDsirIGkRZBtSMEzNTyDr2JQm4xx,3,2,0,0,0,0,1,0,3,0.42857142857142855,1,0.0,0,0,0,0,2,0,0,1,0,0,3,0
2025,30662,4Y6ySID5iQf80xGHEGKPq13tPSHHOAOF,7GRhBDsirIGkRZBtSMEzNTyDr2JQm4xx,21,40,13,12,9,1,3,0,78,11.142857142857142,3,0.0,8,13,11,9,32,1,1,3,0,41,37,0
2026,30667,bZyhF0wh1Z5xsDdkLXcv5kZpz8OlyTUC,7GRhBDsirIGkRZBtSMEzNTyDr2JQm4xx,2,0,0,0,0,0,4,0,4,0.5714285714285714,2,0.0,0,0,0,0,0,0,0,4,0,0,4,1
2027,30674,LGyJGu5Vh9U7ZSPgCkmfu19mVc6YLiy5,7GRhBDsirIGkRZBtSMEzNTyDr2JQm4xx,1,0,0,0,0,0,1,0,1,0.14285714285714285,1,0.0,0,0,0,0,0,0,0,1,0,0,1,1
2028,30675,I0BSd7K17Qe32CsFChIMhJ2Ad5mDVGH4,7GRhBDsirIGkRZBtSMEzNTyDr2JQm4xx,1,0,0,0,0,0,2,0,2,0.2857142857142857,2,0.0,0,0,0,0,0,0,0,2,0,0,2,0
2029,30678,NJshoJ6m7AZhe0j0U3bDZnUZPFMsGEOR,7GRhBDsirIGkRZBtSMEzNTyDr2JQm4xx,2,0,0,0,0,0,2,0,2,0.2857142857142857,1,0.0,0,0,0,0,0,0,0,2,0,0,2,1
2030,30680,iJTPTm9uth33u1s6dPCN0IdL3eivCytM,7GRhBDsirIGkRZBtSMEzNTyDr2JQm4xx,34,47,17,18,16,3,8,1,110,15.714285714285714,2,0.0,22,17,9,16,25,3,9,8,1,64,46,0
2031,30686,uC8uJ021SOxH9uBG1YrO6FA0gR4l0XFz,7GRhBDsirIGkRZBtSMEzNTyDr2JQm4xx,26,36,14,6,13,0,7,0,76,10.857142857142858,2,0.0,21,14,3,13,15,0,3,7,0,51,25,1
2032,30690,AcpmcKbkGL0wHG2z3MmcGuG9z6KsBEJe,7GRhBDsirIGkRZBtSMEzNTyDr2JQm4xx,47,82,36,88,26,2,16,0,250,35.714285714285715,7,0.0,36,36,76,26,46,2,12,16,0,174,76,0
2033,30691,mhedqQ7gvHm4ctTyPUkSQewU6keGOdwI,7GRhBDsirIGkRZBtSMEzNTyDr2JQm4xx,5,2,1,0,1,0,2,0,6,0.8571428571428571,1,0.0,0,1,0,1,2,0,0,2,0,2,4,0
2034,30694,z3Cn7RWIM1WhSLCs4j2aJNntpjbu5ZKv,7GRhBDsirIGkRZBtSMEzNTyDr2JQm4xx,1,0,0,0,0,0,1,0,1,0.14285714285714285,1,0.0,0,0,0,0,0,0,0,1,0,0,1,1
2035,30695,uqA5Smdw6BACOcL0f2tmxwTTxZXBpZpE,7GRhBDsirIGkRZBtSMEzNTyDr2JQm4xx,9,7,4,0,3,0,1,0,15,2.142857142857143,1,0.0,2,4,0,3,5,0,0,1,0,9,6,1
2036,30696,IN0Z0VnhwV4yFGii2PrIUyIWqHFlYB2G,7GRhBDsirIGkRZBtSMEzNTyDr2JQm4xx,13,31,14,0,11,0,6,0,62,8.857142857142858,1,0.0,2,14,0,11,29,0,0,6,0,27,35,1
2037,30705,QZYzE4vnJ7EgZqC8YhvEUgm5GIQjclUD,7GRhBDsirIGkRZBtSMEzNTyDr2JQm4xx,15,36,8,15,0,0,1,0,60,8.571428571428571,3,0.0,23,8,11,0,13,0,4,1,0,42,18,0
2038,30708,mAAuxtPoEddxQ2jPmf6WwqHOgdvhqrk2,7GRhBDsirIGkRZBtSMEzNTyDr2JQm4xx,44,55,29,28,23,8,20,0,163,23.285714285714285,2,0.0,16,29,15,23,39,8,13,20,0,83,80,0
2039,30713,yIe8CIBbEe5pUDhYQ62d08qwZaeKb97Q,7GRhBDsirIGkRZBtSMEzNTyDr2JQm4xx,18,12,6,0,5,6,12,1,42,6.0,1,0.0,1,6,0,5,11,6,0,12,1,12,30,1
2040,30717,Upqz62cwWKexlUMk4uvP9aosOnbcADgX,7GRhBDsirIGkRZBtSMEzNTyDr2JQm4xx,73,119,8,113,25,1,8,0,274,39.142857142857146,4,0.0,57,8,97,25,62,1,16,8,0,187,87,0
2041,30719,tC06tDcyfiakkQ82nvNuQ9hOr0id1lp4,7GRhBDsirIGkRZBtSMEzNTyDr2JQm4xx,1,0,0,0,0,0,1,0,1,0.14285714285714285,1,0.0,0,0,0,0,0,0,0,1,0,0,1,1
2042,30721,PlTEJVk9UB3szf9krJ2h1eGbVaZh7tmN,7GRhBDsirIGkRZBtSMEzNTyDr2JQm4xx,6,5,0,0,0,0,3,0,8,1.1428571428571428,1,0.0,1,0,0,0,4,0,0,3,0,1,7,1
2043,30722,N0Sos51WanCzoSGKDmMPzQtMlLxY3bFb,7GRhBDsirIGkRZBtSMEzNTyDr2JQm4xx,86,156,55,93,38,7,26,0,375,53.57142857142857,6,0.0,74,55,77,38,82,7,16,26,0,244,131,0
2044,30724,Cdp3gxqrAuRwjOLmDu9YrutxbWvuOM9e,7GRhBDsirIGkRZBtSMEzNTyDr2JQm4xx,28,54,2,0,1,3,14,1,75,10.714285714285714,4,0.0,0,2,0,1,54,3,0,14,1,3,72,0
2045,30728,nvkZualT21HB5Rfz2UHfUefEU1tUi2bn,7GRhBDsirIGkRZBtSMEzNTyDr2JQm4xx,1,0,0,0,0,0,1,0,1,0.14285714285714285,1,0.0,0,0,0,0,0,0,0,1,0,0,1,1
2046,30729,dbYop9S01uTyhYqkpGR8ejdLbOiTT1Mo,7GRhBDsirIGkRZBtSMEzNTyDr2JQm4xx,65,111,34,32,41,0,7,0,225,32.142857142857146,1,0.0,29,34,19,41,82,0,13,7,0,123,102,1
2047,30730,NoqigwhYAB9TtnANg1WMYh4zsRGoOl0D,7GRhBDsirIGkRZBtSMEzNTyDr2JQm4xx,33,57,16,3,25,0,8,0,109,15.571428571428571,3,0.0,33,16,2,25,24,0,1,8,0,76,33,0
2048,30731,WkYiyZ27gM6YIccScp8t28IowVqS3ZFY,7GRhBDsirIGkRZBtSMEzNTyDr2JQm4xx,26,38,16,12,19,0,25,0,110,15.714285714285714,4,0.0,17,16,6,19,21,0,6,25,0,58,52,0
2049,30733,9GVWhCbqivE4bnCr9NW81pWzAvrdhoCR,7GRhBDsirIGkRZBtSMEzNTyDr2JQm4xx,21,22,7,12,7,0,1,0,49,7.0,1,0.0,12,7,6,7,10,0,6,1,0,32,17,1
2050,30735,8ggJCfrYr10gnmbgAYh6GvemUAfmw7Yw,7GRhBDsirIGkRZBtSMEzNTyDr2JQm4xx,5,2,1,0,1,0,2,0,6,0.8571428571428571,1,0.0,0,1,0,1,2,0,0,2,0,2,4,0
2051,30737,MawTy0UaNMzLOBBaurqND3JymILXKOHX,7GRhBDsirIGkRZBtSMEzNTyDr2JQm4xx,6,7,2,0,2,0,1,0,12,1.7142857142857142,1,0.0,1,2,0,2,6,0,0,1,0,5,7,1
2052,30742,m7YQyhtMcEUVm4YEl0ls7E37ljO7KzRy,7GRhBDsirIGkRZBtSMEzNTyDr2JQm4xx,22,38,14,12,11,9,9,0,93,13.285714285714286,3,0.0,11,14,10,11,27,9,2,9,0,46,47,0
2053,30747,tLopTDeUShprCRgfwS3p7Zbir4u3Yxe8,7GRhBDsirIGkRZBtSMEzNTyDr2JQm4xx,6,3,2,0,1,0,2,0,8,1.1428571428571428,1,0.0,0,2,0,1,3,0,0,2,0,3,5,1
2054,30750,yk7hISr9k5KlTllac6P28wE1wuN0cd27,7GRhBDsirIGkRZBtSMEzNTyDr2JQm4xx,27,64,11,28,18,4,5,0,130,18.571428571428573,4,0.0,33,11,23,18,31,4,5,5,0,85,45,0
2055,30755,Uox6u1DdfnsZf4RbnG5MWpVhHzZxTTMJ,7GRhBDsirIGkRZBtSMEzNTyDr2JQm4xx,30,22,13,12,9,0,2,0,58,8.285714285714286,1,0.0,3,13,6,9,19,0,6,2,0,31,27,0
2056,30756,5He5r20lSAk84shJAoxdWcVq0zVfBWNL,7GRhBDsirIGkRZBtSMEzNTyDr2JQm4xx,6,9,4,0,1,9,3,0,26,3.7142857142857144,4,0.0,0,4,0,1,9,9,0,3,0,5,21,0
2057,30774,NItKuQnswT2hTrMboHQ1dYUDjy7jkHKK,5X6FeZozNMgE2VRi3MJYjkkFK8SETtu2,14,29,2,10,6,0,4,0,51,7.285714285714286,3,0.0,15,2,10,6,14,0,0,4,0,33,18,0
2058,30776,YtymNq1ebo5JQ6VlWg3H52cMIU1je3tP,SpATywNh6bZuzm8s1ceuBUnMUAeoAHHw,32,37,29,23,22,0,0,0,111,15.857142857142858,3,0.0,4,29,21,22,33,0,2,0,0,76,35,0
2059,30784,SmONSyS4YgG4Afnv6ZxU81t7p4CQPV5P,SpATywNh6bZuzm8s1ceuBUnMUAeoAHHw,38,70,32,17,18,3,15,1,156,22.285714285714285,3,0.0,9,32,15,18,61,3,2,15,1,74,82,1
2060,30796,LlNl7SWBVAnoKfzeJybnj6blD2Rxs5PY,SpATywNh6bZuzm8s1ceuBUnMUAeoAHHw,3,0,0,0,0,3,2,0,5,0.7142857142857143,1,0.0,0,0,0,0,0,3,0,2,0,0,5,0
2061,30797,S0OJjF6aof0iTnIX6lUAxekoH3m4w7V0,bWdj2GDclj5ofokWjzoa5jAwMkxCykd6,46,36,19,103,6,4,17,0,185,26.428571428571427,3,0.0,6,19,84,6,30,4,19,17,0,115,70,0
2062,30803,Tn7o6GJak1Gmr4wNNrXvcX0HbnjY9Sxn,SpATywNh6bZuzm8s1ceuBUnMUAeoAHHw,22,15,13,3,11,0,1,0,43,6.142857142857143,1,0.0,0,13,3,11,15,0,0,1,0,27,16,1
2063,30809,j9gdcEQiWF4hz17rFxv9vKJSxkrv7Ewo,SpATywNh6bZuzm8s1ceuBUnMUAeoAHHw,10,11,0,10,0,0,3,0,24,3.4285714285714284,2,0.0,2,0,9,0,9,0,1,3,0,11,13,1
2064,30824,VpttOLX6WfGZBZLZt8acfk7430VwqHRi,RXDvfPUBYFlVdlueBFbLW0mhhAyGEqpt,41,80,45,75,23,26,14,0,263,37.57142857142857,5,0.0,19,45,73,23,61,26,2,14,0,160,103,1
2065,30827,pcLKeuvqYxK7totS6nb5Fz5ynJdfYz49,SpATywNh6bZuzm8s1ceuBUnMUAeoAHHw,51,149,48,48,17,21,81,4,368,52.57142857142857,7,0.0,54,48,41,17,95,21,7,81,4,160,208,0
2066,30828,gzQNFFC8T7d59sfgG4kPN8hBQX6lAQIT,SpATywNh6bZuzm8s1ceuBUnMUAeoAHHw,5,4,1,0,1,0,2,0,8,1.1428571428571428,2,0.0,0,1,0,1,4,0,0,2,0,2,6,1
2067,30830,Uj0YzcfvBcWRuM5ooqhtOKSU0RtOgHEO,SpATywNh6bZuzm8s1ceuBUnMUAeoAHHw,18,14,10,4,6,0,3,0,37,5.285714285714286,3,0.0,0,10,4,6,14,0,0,3,0,20,17,0
2068,30839,zxhCxWOnrbJdwphyxiWOTikBBavurNb0,5X6FeZozNMgE2VRi3MJYjkkFK8SETtu2,12,50,11,0,6,0,4,0,71,10.142857142857142,2,0.0,17,11,0,6,33,0,0,4,0,34,37,1
2069,30842,aacyvESmAfP5D5oPQjdLdL2QR8GRVLet,SpATywNh6bZuzm8s1ceuBUnMUAeoAHHw,21,72,47,11,22,6,7,0,165,23.571428571428573,5,0.0,2,47,11,22,70,6,0,7,0,82,83,0
2070,30844,BzAEXi273boWm5fg8ZX5MfzoC5AJdE3M,SpATywNh6bZuzm8s1ceuBUnMUAeoAHHw,3,2,1,0,0,0,1,0,4,0.5714285714285714,1,0.0,0,1,0,0,2,0,0,1,0,1,3,1
2071,30851,dEqFTu442IbDfPtop0GcM4lzz1lxVMo1,7GRhBDsirIGkRZBtSMEzNTyDr2JQm4xx,26,60,19,2,7,3,5,0,96,13.714285714285714,3,0.0,27,19,2,7,33,3,0,5,0,55,41,0
2072,30861,Ip3irZsxFvOeGg8WSppVhJArbPhoH3qm,SpATywNh6bZuzm8s1ceuBUnMUAeoAHHw,26,46,27,14,9,0,6,0,102,14.571428571428571,2,0.0,10,27,14,9,36,0,0,6,0,60,42,0
2073,30862,taSkisHl0G5JCCHJPpf0V6gTIns3xoNL,A3fsA9Zfv1X2fVEQhTw51lKENdNrEqT3,21,16,11,0,9,0,4,0,40,5.714285714285714,3,0.0,0,11,0,9,16,0,0,4,0,20,20,0
2074,30863,fNmGVV6MRGGszmFrd5pppYkCKug9pQqa,A3fsA9Zfv1X2fVEQhTw51lKENdNrEqT3,23,27,1,0,1,0,13,3,45,6.428571428571429,3,0.0,3,1,0,1,24,0,0,13,3,5,40,1
2075,30870,GpbDOMkrqaLXOPkd8jI4TxThJAZPGWSK,SpATywNh6bZuzm8s1ceuBUnMUAeoAHHw,51,48,27,66,17,8,6,1,173,24.714285714285715,2,0.0,17,27,54,17,31,8,12,6,1,115,58,0
2076,30872,XK8ujQ4Km9pom3A1sJ3bhFX2dtNEoQ6O,5X6FeZozNMgE2VRi3MJYjkkFK8SETtu2,6,6,2,0,0,0,1,0,9,1.2857142857142858,1,0.0,0,2,0,0,6,0,0,1,0,2,7,1
2077,30887,1NNWgXZojZkqAeoQhcUz4Xc8qgLXmALC,SpATywNh6bZuzm8s1ceuBUnMUAeoAHHw,34,66,36,19,23,10,5,0,159,22.714285714285715,5,0.0,18,36,17,23,48,10,2,5,0,94,65,0
2078,30889,9MbsP03nqyzNF8ytIM40Tx9W50TUxwHO,SpATywNh6bZuzm8s1ceuBUnMUAeoAHHw,32,66,1,34,1,0,14,1,117,16.714285714285715,5,0.0,10,1,34,1,56,0,0,14,1,46,71,0
2079,30896,f2GMLkjrqGdN19ysxF64zEiQj9fxR4cG,bWdj2GDclj5ofokWjzoa5jAwMkxCykd6,5,2,1,0,1,0,2,0,6,0.8571428571428571,1,0.0,0,1,0,1,2,0,0,2,0,2,4,1
2080,30905,5GkxvaD11peDsZoT8jF1pQZKBzcvYxOV,G8EPVSXsOYB5YQWZGiz1aVq5Pgr2GrQu,73,115,67,102,10,31,35,0,360,51.42857142857143,8,0.0,14,67,88,10,101,31,14,35,0,179,181,0
2081,30907,LKEJY5MvP0gj7M4NL5iRnXDBazXBKsOA,SpATywNh6bZuzm8s1ceuBUnMUAeoAHHw,34,53,25,12,13,16,13,0,132,18.857142857142858,4,0.0,6,25,12,13,47,16,0,13,0,56,76,0
2082,30924,YbDGggh5B2xVgz44wTEzgnuIROY324O4,SpATywNh6bZuzm8s1ceuBUnMUAeoAHHw,34,121,1,78,0,11,36,1,248,35.42857142857143,6,0.0,62,1,66,0,59,11,12,36,1,129,119,0
2083,30928,L1c2j6jR9tcRupSypdmfRKPrdeUCZhtR,RXDvfPUBYFlVdlueBFbLW0mhhAyGEqpt,1,0,0,0,0,0,1,0,1,0.14285714285714285,1,0.0,0,0,0,0,0,0,0,1,0,0,1,1
2084,30948,CfeENerIdAGepleePWSt0SV88ctt0Tmw,G8EPVSXsOYB5YQWZGiz1aVq5Pgr2GrQu,75,105,50,116,26,0,4,0,301,43.0,6,0.0,4,50,103,26,101,0,13,4,0,183,118,0
2085,30959,hjUSUM6roI2mLGkMAqBjE0uxFRBSMYHJ,SpATywNh6bZuzm8s1ceuBUnMUAeoAHHw,34,49,33,16,18,4,8,0,128,18.285714285714285,4,0.0,8,33,14,18,41,4,2,8,0,73,55,0
2086,30979,bgulYsE8ZDlY4E6R94M2yq4x1deQnluX,RXDvfPUBYFlVdlueBFbLW0mhhAyGEqpt,16,22,15,0,11,0,8,0,56,8.0,3,0.0,0,15,0,11,22,0,0,8,0,26,30,1
2087,31007,X1KDcg6FJGcjALhOEz460JY2SzJ27Ewm,5X6FeZozNMgE2VRi3MJYjkkFK8SETtu2,5,0,0,0,0,0,10,1,11,1.5714285714285714,3,0.0,0,0,0,0,0,0,0,10,1,0,11,1
2088,31009,8VZ4j0vteayaxOVXmKK7ecCAJiG2jYcZ,SpATywNh6bZuzm8s1ceuBUnMUAeoAHHw,13,16,10,0,1,5,10,3,45,6.428571428571429,1,0.0,1,10,0,1,15,5,0,10,3,12,33,0
2089,31010,u8YPaORaz1zRBmx3Zp1zm30bQFzwDInM,SpATywNh6bZuzm8s1ceuBUnMUAeoAHHw,22,63,24,13,9,0,6,0,115,16.428571428571427,4,0.0,28,24,12,9,35,0,1,6,0,73,42,0
2090,31020,VahHEq0ILTdfn9bRxTqSs3YUh9h3Bcd2,SpATywNh6bZuzm8s1ceuBUnMUAeoAHHw,2,0,0,0,0,0,4,0,4,0.5714285714285714,2,0.0,0,0,0,0,0,0,0,4,0,0,4,1
2091,31023,nz704tMNuBcgvkxkruhgSzP7htrReWBk,bWdj2GDclj5ofokWjzoa5jAwMkxCykd6,8,2,1,0,1,10,15,2,31,4.428571428571429,3,0.0,0,1,0,1,2,10,0,15,2,2,29,0
2092,31038,Djtv0PgEw9uZSQc7WiXmZsJgnFOxrvrt,5X6FeZozNMgE2VRi3MJYjkkFK8SETtu2,33,110,26,34,15,13,15,0,213,30.428571428571427,7,0.0,32,26,29,15,78,13,5,15,0,102,111,0
2093,31047,068Pcyt4LKcLCAowIhptx8tsMvu1BIce,5X6FeZozNMgE2VRi3MJYjkkFK8SETtu2,4,2,1,0,1,0,2,0,6,0.8571428571428571,1,0.0,0,1,0,1,2,0,0,2,0,2,4,1
2094,31062,CfeENerIdAGepleePWSt0SV88ctt0Tmw,A3fsA9Zfv1X2fVEQhTw51lKENdNrEqT3,2,0,0,0,0,0,2,0,2,0.2857142857142857,1,0.0,0,0,0,0,0,0,0,2,0,0,2,1
2095,31063,CfeENerIdAGepleePWSt0SV88ctt0Tmw,5X6FeZozNMgE2VRi3MJYjkkFK8SETtu2,13,28,11,0,2,0,10,0,51,7.285714285714286,7,0.0,0,11,0,2,28,0,0,10,0,13,38,0
2096,31070,pZnUCZTT1hmIZNtXsfTMlwWSd2NbHrnl,G8EPVSXsOYB5YQWZGiz1aVq5Pgr2GrQu,162,262,109,443,52,158,105,98,1227,175.28571428571428,6,0.0,81,109,365,52,181,158,78,105,98,607,620,0
2097,31071,0806VNqXMD0ICiYkYVKFNvK1rd99RXnA,bWdj2GDclj5ofokWjzoa5jAwMkxCykd6,3,2,0,0,0,7,1,0,10,1.4285714285714286,1,0.0,0,0,0,0,2,7,0,1,0,0,10,0
2098,31089,MxVVcAtMSnLQjlvLOx5XySlZblFVugTc,SpATywNh6bZuzm8s1ceuBUnMUAeoAHHw,16,17,0,12,0,0,3,0,32,4.571428571428571,1,0.0,3,0,11,0,14,0,1,3,0,14,18,0
2099,31093,s6iksgptFmyh2vfiarKdJkiKnp6RLi3f,RXDvfPUBYFlVdlueBFbLW0mhhAyGEqpt,11,6,4,0,2,19,9,13,53,7.571428571428571,4,0.0,0,4,0,2,6,19,0,9,13,6,47,0
2100,31096,KiNZ4HZnWaKiAZlgJPtDGHDEbZsXq7d8,SpATywNh6bZuzm8s1ceuBUnMUAeoAHHw,8,6,4,0,3,0,4,0,17,2.4285714285714284,2,0.0,0,4,0,3,6,0,0,4,0,7,10,1
2101,31099,mACn5SO79gLqNBHvtK2mDgkWhQzN9dYE,SpATywNh6bZuzm8s1ceuBUnMUAeoAHHw,18,32,4,7,2,2,7,0,54,7.714285714285714,3,0.0,0,4,7,2,32,2,0,7,0,13,41,0
2102,31100,yNeIUKhEuJHTBsPD5kABjlBuASduqZHz,SpATywNh6bZuzm8s1ceuBUnMUAeoAHHw,61,166,73,58,36,53,28,0,414,59.142857142857146,5,0.0,68,73,49,36,98,53,9,28,0,226,188,1
2103,31106,NGCjg1L5IFyOkl1pLM5r5gRwzJYb60Ux,SpATywNh6bZuzm8s1ceuBUnMUAeoAHHw,22,38,3,0,2,4,19,5,71,10.142857142857142,4,0.0,0,3,0,2,38,4,0,19,5,5,66,0
2104,31112,NGCjg1L5IFyOkl1pLM5r5gRwzJYb60Ux,A3fsA9Zfv1X2fVEQhTw51lKENdNrEqT3,35,91,1,0,1,0,8,0,101,14.428571428571429,3,0.0,0,1,0,1,91,0,0,8,0,2,99,0
2105,31121,HgnrfajlgigvUB5SIR1gkDXyA5E37dFI,G8EPVSXsOYB5YQWZGiz1aVq5Pgr2GrQu,58,234,55,110,37,12,17,1,466,66.57142857142857,3,0.0,65,55,78,37,169,12,32,17,1,235,231,0
2106,31122,zvONfuJex2FW0S3q02qmyYC9aBQXin0x,bWdj2GDclj5ofokWjzoa5jAwMkxCykd6,4,2,0,0,0,0,3,0,5,0.7142857142857143,2,0.0,0,0,0,0,2,0,0,3,0,0,5,1
2107,31124,zvONfuJex2FW0S3q02qmyYC9aBQXin0x,A3fsA9Zfv1X2fVEQhTw51lKENdNrEqT3,2,0,0,0,0,0,3,0,3,0.42857142857142855,1,0.0,0,0,0,0,0,0,0,3,0,0,3,1
2108,31137,JP79INNRcQzkUx6dZie4v1QvuMQ7OVUy,RXDvfPUBYFlVdlueBFbLW0mhhAyGEqpt,38,197,6,82,15,0,5,0,305,43.57142857142857,3,0.0,36,6,75,15,161,0,7,5,0,132,173,0
2109,31160,FtYS4vQn9nNokBPNd6SFUszLOV2L9gsu,SpATywNh6bZuzm8s1ceuBUnMUAeoAHHw,8,8,3,2,1,0,3,0,17,2.4285714285714284,2,0.0,3,3,2,1,5,0,0,3,0,9,8,0
2110,31169,FtYS4vQn9nNokBPNd6SFUszLOV2L9gsu,5X6FeZozNMgE2VRi3MJYjkkFK8SETtu2,1,0,0,0,0,0,1,0,1,0.14285714285714285,1,0.0,0,0,0,0,0,0,0,1,0,0,1,1
2111,31176,In25hAYYA32yjVT3Fete5XUoGWlQgd5t,G8EPVSXsOYB5YQWZGiz1aVq5Pgr2GrQu,18,17,2,51,0,0,0,0,70,10.0,1,0.0,0,2,48,0,17,0,3,0,0,50,20,0
2112,31187,s6iksgptFmyh2vfiarKdJkiKnp6RLi3f,G8EPVSXsOYB5YQWZGiz1aVq5Pgr2GrQu,11,14,7,0,1,16,12,0,50,7.142857142857143,3,0.0,2,7,0,1,12,16,0,12,0,10,40,0
2113,31199,UQu58ECfm706pzTxKdZuMBkLVofX5BYJ,A3fsA9Zfv1X2fVEQhTw51lKENdNrEqT3,2,0,0,0,0,0,2,0,2,0.2857142857142857,1,0.0,0,0,0,0,0,0,0,2,0,0,2,1
2114,31209,eeYgUeHIQERDYwF1mxwVIZYsVaVSgwlV,5X6FeZozNMgE2VRi3MJYjkkFK8SETtu2,21,77,16,24,10,4,14,1,146,20.857142857142858,7,0.0,31,16,20,10,46,4,4,14,1,77,69,0
2115,31214,s6iksgptFmyh2vfiarKdJkiKnp6RLi3f,bWdj2GDclj5ofokWjzoa5jAwMkxCykd6,4,2,1,0,0,18,3,0,24,3.4285714285714284,2,0.0,0,1,0,0,2,18,0,3,0,1,23,0
2116,31215,5Gf23uaI2ID1BMi2tbrzYBqwuoTD7nj1,G8EPVSXsOYB5YQWZGiz1aVq5Pgr2GrQu,9,11,5,0,3,0,2,0,21,3.0,2,0.0,4,5,0,3,7,0,0,2,0,12,9,0
2117,31216,VvIsuXfKScxQtpB88WTGf8JMf9TTXDon,SpATywNh6bZuzm8s1ceuBUnMUAeoAHHw,23,20,15,11,8,0,3,0,57,8.142857142857142,2,0.0,2,15,11,8,18,0,0,3,0,36,21,0
2118,31225,FHIf7MUGEVUr0CqbuDIIiBw1QO6ZVxVj,SpATywNh6bZuzm8s1ceuBUnMUAeoAHHw,4,0,0,0,0,0,4,2,6,0.8571428571428571,1,0.0,0,0,0,0,0,0,0,4,2,0,6,0
2119,31269,s6iksgptFmyh2vfiarKdJkiKnp6RLi3f,5X6FeZozNMgE2VRi3MJYjkkFK8SETtu2,14,11,7,0,2,5,13,1,39,5.571428571428571,4,0.0,0,7,0,2,11,5,0,13,1,9,30,0
2120,31271,WL2pmxbGb1jmTh21fuUuAtLcak4ndNX3,SpATywNh6bZuzm8s1ceuBUnMUAeoAHHw,6,4,2,0,1,0,2,0,9,1.2857142857142858,1,0.0,0,2,0,1,4,0,0,2,0,3,6,1
2121,31282,U04y5vFf0AfyJVGIOJHlryTyRQEOm5pT,SpATywNh6bZuzm8s1ceuBUnMUAeoAHHw,36,49,26,30,11,4,9,0,129,18.428571428571427,3,0.0,4,26,27,11,45,4,3,9,0,68,61,0
2122,31294,wAJGUOfaMNSu8fVs50XbquwP1qlCP18o,7GRhBDsirIGkRZBtSMEzNTyDr2JQm4xx,67,177,54,79,46,9,10,0,375,53.57142857142857,2,0.0,94,54,62,46,83,9,17,10,0,256,119,0
2123,31301,WWRo2uEUHkdi1Q55mTTl1BhH4Eyiuh4i,SpATywNh6bZuzm8s1ceuBUnMUAeoAHHw,5,2,1,0,1,0,2,0,6,0.8571428571428571,1,0.0,0,1,0,1,2,0,0,2,0,2,4,1
2124,31305,ZfhbKm1xmF6HqwzXYHVP4Uwy6oIJcuUx,SpATywNh6bZuzm8s1ceuBUnMUAeoAHHw,11,16,6,20,0,14,6,1,63,9.0,1,0.0,8,6,17,0,8,14,3,6,1,31,32,0
2125,31314,lk5cMwU2ei6fPMwij7uDCwcTMg6KbTEh,RXDvfPUBYFlVdlueBFbLW0mhhAyGEqpt,51,94,52,0,29,15,33,84,307,43.857142857142854,5,0.0,0,52,0,29,94,15,0,33,84,81,226,0
2126,31315,flpVPPsUWfhNx2m3NGTbdkxp57HITcVF,SpATywNh6bZuzm8s1ceuBUnMUAeoAHHw,36,44,26,37,16,0,15,0,138,19.714285714285715,5,0.0,10,26,29,16,34,0,8,15,0,81,57,0
2127,31322,HgQbl59wfMZ62eOeVscJctviZYi0GAnj,SpATywNh6bZuzm8s1ceuBUnMUAeoAHHw,16,20,16,0,11,0,5,0,52,7.428571428571429,4,0.0,0,16,0,11,20,0,0,5,0,27,25,0
2128,31326,ej54FQqE34ZirP86HxHZ32z2x2VcteZU,SpATywNh6bZuzm8s1ceuBUnMUAeoAHHw,5,2,1,0,0,0,3,0,6,0.8571428571428571,1,0.0,0,1,0,0,2,0,0,3,0,1,5,1
2129,31328,y1hlbSei0fIpjB8ljQWGGvcv5eS6EUAC,A3fsA9Zfv1X2fVEQhTw51lKENdNrEqT3,9,9,5,0,4,0,3,0,21,3.0,3,0.0,0,5,0,4,9,0,0,3,0,9,12,0
2130,31329,ZuXB7SoEgVCDuS66pcJ2jF54Mdbn2Nuz,SpATywNh6bZuzm8s1ceuBUnMUAeoAHHw,11,10,8,0,0,0,1,0,19,2.7142857142857144,2,0.0,0,8,0,0,10,0,0,1,0,8,11,0
2131,31330,y1hlbSei0fIpjB8ljQWGGvcv5eS6EUAC,bWdj2GDclj5ofokWjzoa5jAwMkxCykd6,5,2,1,0,1,0,3,0,7,1.0,2,0.0,0,1,0,1,2,0,0,3,0,2,5,1
2132,31332,i68mZBXUpNDZcfluOcDcrl4JItcNJWzg,5X6FeZozNMgE2VRi3MJYjkkFK8SETtu2,8,8,0,9,2,0,5,0,24,3.4285714285714284,2,0.0,6,0,9,2,2,0,0,5,0,17,7,1
2133,31338,Xm0fBjDbhiZ1hqhhgWghtT86qcZao5Le,SpATywNh6bZuzm8s1ceuBUnMUAeoAHHw,37,33,18,42,13,0,4,0,110,15.714285714285714,3,0.0,11,18,37,13,22,0,5,4,0,79,31,0
2134,31339,Kwwe3mn1o1VyQxfsjLDNj10CJwvv89oe,G8EPVSXsOYB5YQWZGiz1aVq5Pgr2GrQu,7,7,3,0,1,4,4,0,19,2.7142857142857144,1,0.0,2,3,0,1,5,4,0,4,0,6,13,1
2135,31349,RAFVAKoL6cQatcQ8rTN5mIwPhy02koDR,A3fsA9Zfv1X2fVEQhTw51lKENdNrEqT3,39,47,23,76,28,0,9,0,183,26.142857142857142,5,0.0,3,23,63,28,44,0,13,9,0,117,66,0
2136,31358,8kpaF6RjfQ3lij9I92AFwUcHaXEkRwzZ,G8EPVSXsOYB5YQWZGiz1aVq5Pgr2GrQu,6,5,1,0,1,38,6,0,51,7.285714285714286,1,0.0,0,1,0,1,5,38,0,6,0,2,49,0
2137,31363,EshSTNSaPVDLcPEwlm2e07DrZJhzPNHK,A3fsA9Zfv1X2fVEQhTw51lKENdNrEqT3,203,134,108,486,70,10,25,3,836,119.42857142857143,7,0.0,6,108,393,70,128,10,93,25,3,577,259,0
2138,31368,q15es4hix4DJR5zOH0N1aGsdTpjonWNC,SpATywNh6bZuzm8s1ceuBUnMUAeoAHHw,33,51,22,27,11,36,14,0,161,23.0,5,0.0,9,22,24,11,42,36,3,14,0,66,95,0
2139,31372,VirXFJzuzQKL0tqaVG4iBSKiDEeYTINe,A3fsA9Zfv1X2fVEQhTw51lKENdNrEqT3,5,3,1,0,1,0,2,0,7,1.0,2,0.0,0,1,0,1,3,0,0,2,0,2,5,1
2140,31414,StcFIgK5T4YiiLiOpPHFjzohTVz9Jaf7,A3fsA9Zfv1X2fVEQhTw51lKENdNrEqT3,3,3,1,0,1,0,0,0,5,0.7142857142857143,2,0.0,0,1,0,1,3,0,0,0,0,2,3,0
2141,31419,o7pzdRTO1dnxuhf9kxurH0oMz67aa1kw,SpATywNh6bZuzm8s1ceuBUnMUAeoAHHw,22,14,8,11,5,0,2,0,40,5.714285714285714,2,0.0,4,8,11,5,10,0,0,2,0,28,12,1
2142,31446,Sg3DXxUJJ7e58r0b7OHd09yiv7acnFU0,SpATywNh6bZuzm8s1ceuBUnMUAeoAHHw,35,40,26,11,13,36,24,0,150,21.428571428571427,5,0.0,7,26,11,13,33,36,0,24,0,57,93,0
2143,31447,1eGkI0U1fMBa6R6814yg1pK6UpcuLDVs,G8EPVSXsOYB5YQWZGiz1aVq5Pgr2GrQu,2,0,0,0,0,0,2,0,2,0.2857142857142857,1,0.0,0,0,0,0,0,0,0,2,0,0,2,1
2144,31452,ouZJjXOMfv0cgbezRQ2yVqJJVKJPFP9g,SpATywNh6bZuzm8s1ceuBUnMUAeoAHHw,14,29,2,0,2,0,2,0,35,5.0,2,0.0,0,2,0,2,29,0,0,2,0,4,31,1
2145,31455,AX9Hte0A6zp61WUmhFkv1rU3P0cKffFQ,SpATywNh6bZuzm8s1ceuBUnMUAeoAHHw,27,59,10,24,1,10,20,0,124,17.714285714285715,5,0.0,14,10,21,1,45,10,3,20,0,46,78,0
2146,31458,T7p6N91F6KULGtprxI0mhT0EmO9FegFe,A3fsA9Zfv1X2fVEQhTw51lKENdNrEqT3,7,4,2,0,1,0,13,0,20,2.857142857142857,3,0.0,0,2,0,1,4,0,0,13,0,3,17,1
2147,31460,zmunqQU7cdA8pnQFNB1A3xjWmjdxheRC,SpATywNh6bZuzm8s1ceuBUnMUAeoAHHw,1,0,0,0,0,0,1,0,1,0.14285714285714285,1,0.0,0,0,0,0,0,0,0,1,0,0,1,1
2148,31468,CVzATUdOM8Qgz38dXNByctkVtfSnNFbx,SpATywNh6bZuzm8s1ceuBUnMUAeoAHHw,13,12,5,0,2,2,6,1,28,4.0,1,0.0,5,5,0,2,7,2,0,6,1,12,16,1
2149,31479,8jqDD2phXiMGQf0XQi1kVRzLj3TILO0y,bWdj2GDclj5ofokWjzoa5jAwMkxCykd6,15,18,9,120,3,4,5,0,159,22.714285714285715,1,0.0,5,9,116,3,13,4,4,5,0,133,26,1
2150,31486,CTfjOlWW4k8IhTEXOJYJ7bo74K8z07kZ,bWdj2GDclj5ofokWjzoa5jAwMkxCykd6,46,66,29,90,5,1,23,1,215,30.714285714285715,7,0.0,8,29,81,5,58,1,9,23,1,123,92,0
2151,31493,iGNqI0WQkdTRPPMB99MG4DRoKjQuEfCJ,SpATywNh6bZuzm8s1ceuBUnMUAeoAHHw,23,25,14,0,9,0,6,0,54,7.714285714285714,4,0.0,0,14,0,9,25,0,0,6,0,23,31,0
2152,31505,XDDkvG3daqaNFCwfbjOudEVxBaPFdZM4,SpATywNh6bZuzm8s1ceuBUnMUAeoAHHw,32,71,23,36,13,3,10,1,157,22.428571428571427,3,0.0,17,23,30,13,54,3,6,10,1,83,74,0
2153,31508,zc3J3cLI43sSah10iZYvlT8XuC7FiQBt,bWdj2GDclj5ofokWjzoa5jAwMkxCykd6,17,35,15,17,13,1,19,1,101,14.428571428571429,4,0.0,14,15,16,13,21,1,1,19,1,58,43,1
2154,31509,oyStFfS7Y0XvpvDI8JwDIhnFdZZl3Ixl,SpATywNh6bZuzm8s1ceuBUnMUAeoAHHw,15,17,1,14,1,0,5,0,38,5.428571428571429,2,0.0,3,1,13,1,14,0,1,5,0,18,20,0
2155,31513,XBCkMYdRHaBwbyaKg5wVLPpzX1Jqu9p0,7GRhBDsirIGkRZBtSMEzNTyDr2JQm4xx,5,3,1,0,0,0,2,0,6,0.8571428571428571,1,0.0,0,1,0,0,3,0,0,2,0,1,5,1
2156,31521,SQBW44VzMb5zXQWTfzFzAP2RU7qxP2su,bWdj2GDclj5ofokWjzoa5jAwMkxCykd6,6,4,2,12,1,0,0,0,19,2.7142857142857144,2,0.0,1,2,9,1,3,0,3,0,0,13,6,1
2157,31532,oNX40hvUpCseO8BHKhGJvG2jyQpYKQyk,RXDvfPUBYFlVdlueBFbLW0mhhAyGEqpt,30,41,31,24,9,50,4,0,159,22.714285714285715,4,0.0,2,31,23,9,39,50,1,4,0,65,94,0
2158,31540,fenn4oQ5cZO7k0rG5qWqM8q00nrCNGWN,G8EPVSXsOYB5YQWZGiz1aVq5Pgr2GrQu,7,7,0,0,0,0,3,0,10,1.4285714285714286,1,0.0,0,0,0,0,7,0,0,3,0,0,10,0
2159,31548,XXMS71J2H0OH1d5JkGIMcAWAVCkHQnUI,SpATywNh6bZuzm8s1ceuBUnMUAeoAHHw,7,3,2,0,2,0,2,0,9,1.2857142857142858,1,0.0,0,2,0,2,3,0,0,2,0,4,5,1
2160,31554,6QkXIF90lGPt9Vh54FdM4bVGqW5m3GxK,SpATywNh6bZuzm8s1ceuBUnMUAeoAHHw,37,23,19,0,17,0,4,0,63,9.0,3,0.0,0,19,0,17,23,0,0,4,0,36,27,0
2161,31557,H3GbKrAtFVtLEXWNNdFaZDFbuKQIUVPU,SpATywNh6bZuzm8s1ceuBUnMUAeoAHHw,36,56,33,18,15,7,23,0,152,21.714285714285715,7,0.0,12,33,17,15,44,7,1,23,0,77,75,0
2162,31568,c49ANcMlFceMxZBmI2dFNiETx72UlFpt,SpATywNh6bZuzm8s1ceuBUnMUAeoAHHw,27,36,4,18,2,1,8,1,70,10.0,3,0.0,8,4,15,2,28,1,3,8,1,29,41,0
2163,31574,Choi1P390vmtfro1eWMEt9A5jiQ5ooC0,bWdj2GDclj5ofokWjzoa5jAwMkxCykd6,5,2,1,0,1,0,2,0,6,0.8571428571428571,1,0.0,0,1,0,1,2,0,0,2,0,2,4,1
2164,31575,VYkkz2UClMIV09P0Xfa0EEIHkYXDA8gf,SpATywNh6bZuzm8s1ceuBUnMUAeoAHHw,17,23,6,39,0,0,7,0,75,10.714285714285714,2,0.0,16,6,36,0,7,0,3,7,0,58,17,1
2165,31589,xy9Oc1Yxp7TcZqHQEdlB3DAX67hCrIQ7,5X6FeZozNMgE2VRi3MJYjkkFK8SETtu2,14,17,6,2,2,11,5,1,44,6.285714285714286,1,0.0,9,6,2,2,8,11,0,5,1,19,25,1
2166,31601,dJZL2KzG1hAQ7YWpbHZmN7SyeaNVO2V1,A3fsA9Zfv1X2fVEQhTw51lKENdNrEqT3,1,0,0,0,0,0,1,0,1,0.14285714285714285,1,0.0,0,0,0,0,0,0,0,1,0,0,1,1
2167,31610,9T7PMXOMDFXR9WSJvwPim10fNgzjcp6r,SpATywNh6bZuzm8s1ceuBUnMUAeoAHHw,15,26,2,15,0,14,8,2,67,9.571428571428571,2,0.0,10,2,14,0,16,14,1,8,2,26,41,0
2168,31616,fvZ0NGV51VzyC0WSd0PRSRn84KNPjRPi,SpATywNh6bZuzm8s1ceuBUnMUAeoAHHw,27,38,2,24,1,0,9,0,74,10.571428571428571,3,0.0,8,2,24,1,30,0,0,9,0,35,39,0
2169,31630,uqaaAh63woEl1GEmEsDUSC0vwOZYZP0g,G8EPVSXsOYB5YQWZGiz1aVq5Pgr2GrQu,6,3,1,0,1,0,2,0,7,1.0,1,0.0,0,1,0,1,3,0,0,2,0,2,5,1
2170,31631,OcchkIht8b8QIrrapp5dUsDP9GE3Vfdw,SpATywNh6bZuzm8s1ceuBUnMUAeoAHHw,22,28,8,32,5,0,10,0,83,11.857142857142858,1,0.0,10,8,31,5,18,0,1,10,0,54,29,0
2171,31636,8V9pnrkvwK33pI3AiYSlsgxV7TeKgfNZ,G8EPVSXsOYB5YQWZGiz1aVq5Pgr2GrQu,14,11,7,18,1,22,5,0,64,9.142857142857142,1,0.0,1,7,16,1,10,22,2,5,0,25,39,0
2172,31637,5vZRuON34JUuUxkGF08Mu94iTiQzZas4,RXDvfPUBYFlVdlueBFbLW0mhhAyGEqpt,17,14,8,34,6,0,1,0,63,9.0,1,0.0,5,8,29,6,9,0,5,1,0,48,15,0
2173,31650,oqeS1F9HDtp76Uor2JA69VvP8s0An8qD,SpATywNh6bZuzm8s1ceuBUnMUAeoAHHw,22,29,5,4,4,0,7,0,49,7.0,1,0.0,7,5,4,4,22,0,0,7,0,20,29,1
2174,31651,2AWz8OiYqJqT0VYmevCkAuxaVCSl88oB,A3fsA9Zfv1X2fVEQhTw51lKENdNrEqT3,92,115,88,82,68,1,17,0,371,53.0,5,0.0,3,88,72,68,112,1,10,17,0,231,140,0
2175,31668,IujXdG8hMcTQBeZJ4Qbpq8kOlC9VAoqW,SpATywNh6bZuzm8s1ceuBUnMUAeoAHHw,1,0,0,0,0,0,1,0,1,0.14285714285714285,1,0.0,0,0,0,0,0,0,0,1,0,0,1,1
2176,31670,AhvhyySPOhgjxA01IKT267rbfuWUyPz5,SpATywNh6bZuzm8s1ceuBUnMUAeoAHHw,6,2,1,0,1,0,4,0,8,1.1428571428571428,1,0.0,0,1,0,1,2,0,0,4,0,2,6,1
2177,31672,kGJ0kJD3LGzwfPeuS19lVyqb4r7gscqA,SpATywNh6bZuzm8s1ceuBUnMUAeoAHHw,38,52,29,26,18,2,14,2,143,20.428571428571427,6,0.0,14,29,23,18,38,2,3,14,2,84,59,0
2178,31689,GYtjeqMCQ6Dcisx0HKWJVPtkJ5irEqqj,bWdj2GDclj5ofokWjzoa5jAwMkxCykd6,4,6,0,0,0,7,4,0,17,2.4285714285714284,2,0.0,0,0,0,0,6,7,0,4,0,0,17,1
2179,31695,yWhbSfRhq0GQaIid8lmuGTuOjD7iQVVR,SpATywNh6bZuzm8s1ceuBUnMUAeoAHHw,31,74,39,22,13,15,13,0,176,25.142857142857142,5,0.0,22,39,17,13,52,15,5,13,0,91,85,1
2180,31707,oX0xmFM00RD2zpxC8x8yI57WZl7jF3OW,bWdj2GDclj5ofokWjzoa5jAwMkxCykd6,14,18,8,48,9,0,1,0,84,12.0,1,0.0,7,8,43,9,11,0,5,1,0,67,17,0
2181,31718,TJ0V0Q8Q7PU7JaM3K55nOnFdpx29qUfy,SpATywNh6bZuzm8s1ceuBUnMUAeoAHHw,35,40,18,14,10,36,10,6,134,19.142857142857142,4,0.0,8,18,13,10,32,36,1,10,6,49,85,0
2182,31730,a4RYqILKcnu8c617gYSbD0KQIm9DqZnc,SpATywNh6bZuzm8s1ceuBUnMUAeoAHHw,30,32,10,19,5,0,6,0,72,10.285714285714286,2,0.0,4,10,16,5,28,0,3,6,0,35,37,0
2183,31742,Ol0EltSC0dLtmI4Ws0ziQYNZlpSWDTB5,SpATywNh6bZuzm8s1ceuBUnMUAeoAHHw,43,105,11,54,6,0,19,0,195,27.857142857142858,7,0.0,30,11,45,6,75,0,9,19,0,92,103,0
2184,31744,2dBt8xoZ6BLHGNE1IF3iWURIwZGhjEcy,SpATywNh6bZuzm8s1ceuBUnMUAeoAHHw,11,7,2,0,2,2,5,0,18,2.5714285714285716,1,0.0,0,2,0,2,7,2,0,5,0,4,14,1
2185,31756,70Zyu3WQygi3HxuxcZg5BvCVTCfBem3D,SpATywNh6bZuzm8s1ceuBUnMUAeoAHHw,10,17,4,0,4,4,9,0,38,5.428571428571429,3,0.0,4,4,0,4,13,4,0,9,0,12,26,0
2186,31759,tqvV2MwKeLemDHIUsPAVAoV4nZW7CEvr,SpATywNh6bZuzm8s1ceuBUnMUAeoAHHw,7,6,4,0,3,0,2,0,15,2.142857142857143,1,0.0,0,4,0,3,6,0,0,2,0,7,8,0
2187,31770,HFLoTrlo9AoizXsnGd7vPE04tzDGrmOf,SpATywNh6bZuzm8s1ceuBUnMUAeoAHHw,14,86,44,0,19,1,44,2,196,28.0,2,0.0,3,44,0,19,83,1,0,44,2,66,130,1
2188,31775,f13VNamLzXZk1JfiRwsU71KPQBJ3vbOe,SpATywNh6bZuzm8s1ceuBUnMUAeoAHHw,10,10,1,21,0,0,5,0,37,5.285714285714286,2,0.0,7,1,20,0,3,0,1,5,0,28,9,0
2189,31781,vZTsjWYTV0UK9VehnJVovFZUJthKJRiW,A3fsA9Zfv1X2fVEQhTw51lKENdNrEqT3,1,0,0,0,0,0,1,0,1,0.14285714285714285,1,0.0,0,0,0,0,0,0,0,1,0,0,1,1
2190,31784,vKwONyYQku69SspHkUwKQCkSIIF21aUI,RXDvfPUBYFlVdlueBFbLW0mhhAyGEqpt,52,100,63,0,27,83,24,5,302,43.142857142857146,4,0.0,7,63,0,27,93,83,0,24,5,97,205,1
2191,31785,WMHp5hy6JREfQvjE2o6B3Iu0aAWFRyny,SpATywNh6bZuzm8s1ceuBUnMUAeoAHHw,44,69,36,54,14,15,17,3,208,29.714285714285715,4,0.0,16,36,46,14,53,15,8,17,3,112,96,0
2192,31786,BYn6cWVQSMORsIVShYVRAnnkHpLyiUv8,5X6FeZozNMgE2VRi3MJYjkkFK8SETtu2,18,63,20,12,7,28,17,0,147,21.0,12,0.0,15,20,11,7,48,28,1,17,0,53,94,0
2193,31792,ZNcLOAJ2r3H5DqhbGk1CiPtwI7ixaCeK,A3fsA9Zfv1X2fVEQhTw51lKENdNrEqT3,49,27,25,0,23,1,2,0,78,11.142857142857142,2,0.0,0,25,0,23,27,1,0,2,0,48,30,0
2194,31800,w4jUEPZrBRDoTJulTK0CkRpgy77Rfcsr,bWdj2GDclj5ofokWjzoa5jAwMkxCykd6,6,2,1,0,1,0,4,0,8,1.1428571428571428,1,0.0,0,1,0,1,2,0,0,4,0,2,6,1
2195,31801,AXOgFWUEMyDEcBkotXpoXzfY4u6ulWjj,A3fsA9Zfv1X2fVEQhTw51lKENdNrEqT3,5,2,1,0,1,0,5,0,9,1.2857142857142858,2,0.0,0,1,0,1,2,0,0,5,0,2,7,0
2196,31803,AXOgFWUEMyDEcBkotXpoXzfY4u6ulWjj,RXDvfPUBYFlVdlueBFbLW0mhhAyGEqpt,20,27,14,0,6,6,3,0,56,8.0,1,0.0,0,14,0,6,27,6,0,3,0,20,36,0
2197,31815,AXOgFWUEMyDEcBkotXpoXzfY4u6ulWjj,SpATywNh6bZuzm8s1ceuBUnMUAeoAHHw,20,22,13,0,7,1,5,0,48,6.857142857142857,2,0.0,0,13,0,7,22,1,0,5,0,20,28,0
2198,31821,ZZKaYISjwPLd7mjcgaVmNy6TyZg40oVS,A3fsA9Zfv1X2fVEQhTw51lKENdNrEqT3,2,0,0,0,0,0,4,0,4,0.5714285714285714,1,0.0,0,0,0,0,0,0,0,4,0,0,4,1
2199,31827,JOddnojV0OZrysgzYsnxzhRLS1r6GCxl,SpATywNh6bZuzm8s1ceuBUnMUAeoAHHw,9,6,4,0,2,1,6,0,19,2.7142857142857144,2,0.0,0,4,0,2,6,1,0,6,0,6,13,1
2200,31829,861mcqUZ4WyFkrWdyYySCd1kJULdzhG3,SpATywNh6bZuzm8s1ceuBUnMUAeoAHHw,18,33,5,14,4,0,5,0,61,8.714285714285714,3,0.0,8,5,13,4,25,0,1,5,0,30,31,1
2201,31854,wLAgbiz3XWV6Nef8pQe1TlLxUN8CIoJ8,7GRhBDsirIGkRZBtSMEzNTyDr2JQm4xx,70,71,21,75,31,6,2,1,207,29.571428571428573,1,0.0,48,21,61,31,23,6,14,2,1,161,46,1
2202,31859,5Vyfi91fKhjJCc9JZTWeaj3foWCTItaL,SpATywNh6bZuzm8s1ceuBUnMUAeoAHHw,5,2,1,0,1,0,2,0,6,0.8571428571428571,1,0.0,0,1,0,1,2,0,0,2,0,2,4,1
2203,31866,yqRjX5x5mZ97nU5DkAkyboMSXTOKxqGq,RXDvfPUBYFlVdlueBFbLW0mhhAyGEqpt,2,0,0,0,0,0,2,0,2,0.2857142857142857,1,0.0,0,0,0,0,0,0,0,2,0,0,2,1
2204,31868,yqRjX5x5mZ97nU5DkAkyboMSXTOKxqGq,bWdj2GDclj5ofokWjzoa5jAwMkxCykd6,2,0,0,0,0,0,2,0,2,0.2857142857142857,1,0.0,0,0,0,0,0,0,0,2,0,0,2,1
2205,31869,R2cga9JVVM2tXEVs2saYswslfxAU4nMk,SpATywNh6bZuzm8s1ceuBUnMUAeoAHHw,2,0,0,0,0,0,4,0,4,0.5714285714285714,2,0.0,0,0,0,0,0,0,0,4,0,0,4,0
2206,31870,yqRjX5x5mZ97nU5DkAkyboMSXTOKxqGq,5X6FeZozNMgE2VRi3MJYjkkFK8SETtu2,2,0,0,0,0,0,2,0,2,0.2857142857142857,1,0.0,0,0,0,0,0,0,0,2,0,0,2,1
2207,31877,ioaeb7d1U29jI9wsI7DHJ7aiuWWVX3KB,RXDvfPUBYFlVdlueBFbLW0mhhAyGEqpt,100,224,71,136,58,0,13,0,502,71.71428571428571,3,0.0,67,71,131,58,157,0,5,13,0,327,175,0
2208,31896,kvf1WFygeLGKOFkoertca6J9TDxV9fcY,5X6FeZozNMgE2VRi3MJYjkkFK8SETtu2,6,5,2,0,3,0,1,0,11,1.5714285714285714,1,0.0,2,2,0,3,3,0,0,1,0,7,4,1
2209,31909,cAuoC0RFnhWa1rjmwwXTGirOFJWhZ3O6,SpATywNh6bZuzm8s1ceuBUnMUAeoAHHw,5,4,2,6,0,0,2,0,14,2.0,1,0.0,1,2,5,0,3,0,1,2,0,8,6,1
2210,31929,NtoUmtr1rLkqyRgOmRvv7ehcWGsLKb0w,SpATywNh6bZuzm8s1ceuBUnMUAeoAHHw,31,29,16,17,11,1,6,1,81,11.571428571428571,2,0.0,9,16,15,11,20,1,2,6,1,51,30,0
2211,31961,VvPGX7cfFx9biMfbbz3YpB4bcEqLMW9U,RXDvfPUBYFlVdlueBFbLW0mhhAyGEqpt,133,226,138,318,107,8,37,2,836,119.42857142857143,6,0.0,63,138,295,107,163,8,23,37,2,603,233,0
2212,31970,iJvDsYi6zIbeBcBgPSE07utxh6J5vUbE,RXDvfPUBYFlVdlueBFbLW0mhhAyGEqpt,23,26,18,33,13,0,2,0,92,13.142857142857142,2,0.0,7,18,31,13,19,0,2,2,0,69,23,0
2213,31983,EwpbggvNdZkeSTjdG48aEltlJYavm02s,A3fsA9Zfv1X2fVEQhTw51lKENdNrEqT3,3,2,0,0,0,0,1,0,3,0.42857142857142855,1,0.0,0,0,0,0,2,0,0,1,0,0,3,0
2214,31986,XYKAwX2Sl88KhgfkTOpg6K4pRdGN7Orp,bWdj2GDclj5ofokWjzoa5jAwMkxCykd6,1,0,0,0,0,0,1,0,1,0.14285714285714285,1,0.0,0,0,0,0,0,0,0,1,0,0,1,1
2215,31988,XYKAwX2Sl88KhgfkTOpg6K4pRdGN7Orp,A3fsA9Zfv1X2fVEQhTw51lKENdNrEqT3,1,0,0,0,0,0,1,0,1,0.14285714285714285,1,0.0,0,0,0,0,0,0,0,1,0,0,1,0
2216,31993,3c43AAq389Lt9q10QuQnoNoJ0mkHqvxC,5X6FeZozNMgE2VRi3MJYjkkFK8SETtu2,1,0,0,0,0,0,1,0,1,0.14285714285714285,1,0.0,0,0,0,0,0,0,0,1,0,0,1,1
2217,31996,TZQnDQD4c1wLJcg98vkGC4z0YxJAykwb,SpATywNh6bZuzm8s1ceuBUnMUAeoAHHw,36,58,35,9,27,1,6,1,137,19.571428571428573,7,0.0,16,35,8,27,42,1,1,6,1,86,51,0
2218,32011,nx33gkAhBwAtZXIOjPN1LgE3JpCym17w,SpATywNh6bZuzm8s1ceuBUnMUAeoAHHw,1,0,0,0,0,0,1,0,1,0.14285714285714285,1,0.0,0,0,0,0,0,0,0,1,0,0,1,1
2219,32018,eVjO8UzdCxiCnXMJzeHIA4vFZdeRyoGc,SpATywNh6bZuzm8s1ceuBUnMUAeoAHHw,9,10,6,0,4,0,2,0,22,3.142857142857143,1,0.0,0,6,0,4,10,0,0,2,0,10,12,1
2220,32029,tLtF2xuv7ODjuOISevnoALqvBz99SIrS,RXDvfPUBYFlVdlueBFbLW0mhhAyGEqpt,8,8,1,0,0,0,2,0,11,1.5714285714285714,1,0.0,0,1,0,0,8,0,0,2,0,1,10,1
2221,32031,0xrj8jMy7DRmz2206OV6CH0SXBZh0mT4,5X6FeZozNMgE2VRi3MJYjkkFK8SETtu2,10,6,5,0,5,0,1,0,17,2.4285714285714284,1,0.0,0,5,0,5,6,0,0,1,0,10,7,1
2222,32072,oV1ETioZLdwgIeANYoTTe9mpmAow2qIk,A3fsA9Zfv1X2fVEQhTw51lKENdNrEqT3,9,17,9,0,0,34,10,1,71,10.142857142857142,2,0.0,4,9,0,0,13,34,0,10,1,13,58,0
2223,32080,KK88eF8dX9bLCXncq9rSm7T6UVxyajTo,A3fsA9Zfv1X2fVEQhTw51lKENdNrEqT3,7,8,3,0,1,1,25,0,38,5.428571428571429,6,0.0,0,3,0,1,8,1,0,25,0,4,34,0
2224,32083,E4Y6ppfaM7zO2C4oxn78UykFQIZieWjg,5X6FeZozNMgE2VRi3MJYjkkFK8SETtu2,81,339,86,2,120,94,37,5,683,97.57142857142857,7,0.0,111,86,2,120,228,94,0,37,5,319,364,0
2225,32096,c1hkKbuwCfRwqHEOmzJGVU5GV6amXAD9,SpATywNh6bZuzm8s1ceuBUnMUAeoAHHw,5,2,1,0,1,0,2,0,6,0.8571428571428571,1,0.0,0,1,0,1,2,0,0,2,0,2,4,1
2226,32099,aM96vLcGj7eUDPhSS4Er9k1Fdrc63O0N,A3fsA9Zfv1X2fVEQhTw51lKENdNrEqT3,4,2,1,0,0,0,3,0,6,0.8571428571428571,1,0.0,0,1,0,0,2,0,0,3,0,1,5,0
2227,32112,Jf77UYIvUtofHBGpvQMQ0qUfMZBh9rRJ,SpATywNh6bZuzm8s1ceuBUnMUAeoAHHw,9,6,5,0,4,0,1,0,16,2.2857142857142856,1,0.0,0,5,0,4,6,0,0,1,0,9,7,0
2228,32123,xrDGwnLLNa6QlQOfL38MTY3529BaxYjK,RXDvfPUBYFlVdlueBFbLW0mhhAyGEqpt,1,0,0,0,0,0,2,0,2,0.2857142857142857,1,0.0,0,0,0,0,0,0,0,2,0,0,2,0
2229,32124,SWaMMFaEgBIwWimOSjcPRySyg7Gfrl6L,SpATywNh6bZuzm8s1ceuBUnMUAeoAHHw,44,77,40,14,10,9,14,1,165,23.571428571428573,5,0.0,5,40,13,10,72,9,1,14,1,68,97,0
2230,32130,4bLrsVDvLnrTqHqeIpcqQPyvl02eai7n,bWdj2GDclj5ofokWjzoa5jAwMkxCykd6,5,1,1,0,1,0,2,0,5,0.7142857142857143,1,0.0,0,1,0,1,1,0,0,2,0,2,3,1
2231,32135,610PtRFkaYif9s7nz1Kdra5qTHjPTrYT,SpATywNh6bZuzm8s1ceuBUnMUAeoAHHw,5,3,2,0,1,0,1,0,7,1.0,1,0.0,0,2,0,1,3,0,0,1,0,3,4,0
2232,32141,jagu0OJDhWTGFhfCMk0ghqluLpW3kzdC,bWdj2GDclj5ofokWjzoa5jAwMkxCykd6,16,10,6,48,2,0,9,0,75,10.714285714285714,2,0.0,2,6,44,2,8,0,4,9,0,54,21,1
2233,32143,sCdFetzDtW2ZNQiiM1GeVRNkzG4jTYgl,G8EPVSXsOYB5YQWZGiz1aVq5Pgr2GrQu,35,33,11,125,5,1,8,0,183,26.142857142857142,1,0.0,22,11,100,5,11,1,25,8,0,138,45,1
2234,32145,N3xBmXADxLX0BRmRQsoG12CSJL5I0LC3,G8EPVSXsOYB5YQWZGiz1aVq5Pgr2GrQu,30,33,14,22,10,1,15,1,96,13.714285714285714,1,0.0,13,14,12,10,20,1,10,15,1,49,47,0
2235,32146,RoOsK5eOQzFUYZazHGNljblhHu8Erb3v,SpATywNh6bZuzm8s1ceuBUnMUAeoAHHw,7,3,2,0,1,0,5,0,11,1.5714285714285714,2,0.0,0,2,0,1,3,0,0,5,0,3,8,0
2236,32154,JB5wgKgEAIwYsiifcpDf7iv2yPgMBOVA,SpATywNh6bZuzm8s1ceuBUnMUAeoAHHw,7,32,0,0,0,0,2,0,34,4.857142857142857,1,0.0,0,0,0,0,32,0,0,2,0,0,34,0
2237,32159,DyQHVTNiwX6W4PiKOVh8BCoKQr8u7ImW,bWdj2GDclj5ofokWjzoa5jAwMkxCykd6,6,6,0,0,1,0,7,0,14,2.0,1,0.0,3,0,0,1,3,0,0,7,0,4,10,1
2238,32162,kAQFM0dEgOQIxOG9jTMe5puRtNxZZWMN,A3fsA9Zfv1X2fVEQhTw51lKENdNrEqT3,29,13,0,62,0,0,3,0,78,11.142857142857142,2,0.0,1,0,56,0,12,0,6,3,0,57,21,0
2239,32165,xVQ88VrIuIA75ygDlevnROobNkwcFnsc,SpATywNh6bZuzm8s1ceuBUnMUAeoAHHw,14,28,2,4,1,0,4,0,39,5.571428571428571,6,0.0,0,2,4,1,28,0,0,4,0,7,32,0
2240,32172,lucxJ3l1qL4UWLhoBqokWI3CdjYfsM5P,SpATywNh6bZuzm8s1ceuBUnMUAeoAHHw,4,2,1,0,1,0,1,0,5,0.7142857142857143,1,0.0,0,1,0,1,2,0,0,1,0,2,3,1
2241,32181,yz5W8rI4J1brvBsiH8Bk8UlG6rKQV6QY,SpATywNh6bZuzm8s1ceuBUnMUAeoAHHw,7,6,5,0,1,0,1,0,13,1.8571428571428572,1,0.0,0,5,0,1,6,0,0,1,0,6,7,0
2242,32190,rrVpn5gbnZ4HT5tgZUFxCL3VXZPoRN4p,SpATywNh6bZuzm8s1ceuBUnMUAeoAHHw,5,5,2,0,0,0,2,0,9,1.2857142857142858,1,0.0,0,2,0,0,5,0,0,2,0,2,7,0
2243,32198,PzbAAQBdNIO5q0hDkxJETX7v12Y9h0xH,5X6FeZozNMgE2VRi3MJYjkkFK8SETtu2,28,47,8,54,15,3,12,1,140,20.0,6,0.0,20,8,41,15,27,3,13,12,1,84,56,0
2244,32202,B0UcZFdES6LvRDMYG7Y0cM3CxcL70HFE,5X6FeZozNMgE2VRi3MJYjkkFK8SETtu2,33,122,36,36,33,0,18,2,247,35.285714285714285,9,0.0,40,36,34,33,82,0,2,18,2,143,104,0
2245,32204,6DV1XDznpXjLYpZGNyw8WjvrI7FbAcBI,SpATywNh6bZuzm8s1ceuBUnMUAeoAHHw,1,0,0,0,0,0,1,0,1,0.14285714285714285,1,0.0,0,0,0,0,0,0,0,1,0,0,1,1
2246,32206,a1hltiyDilurEIFnwffjQJuCpkjLjysQ,bWdj2GDclj5ofokWjzoa5jAwMkxCykd6,1,0,0,0,0,0,1,0,1,0.14285714285714285,1,0.0,0,0,0,0,0,0,0,1,0,0,1,1
2247,32213,Vk7MZGxGXuacnc2MpD5fuExvo0K32AnZ,5X6FeZozNMgE2VRi3MJYjkkFK8SETtu2,1,0,0,0,0,0,1,0,1,0.14285714285714285,1,0.0,0,0,0,0,0,0,0,1,0,0,1,1
2248,32220,dpAJ54wEPUDHZcYRCRrxvDfIakq9pmaQ,SpATywNh6bZuzm8s1ceuBUnMUAeoAHHw,22,14,8,12,6,0,3,0,43,6.142857142857143,2,0.0,2,8,11,6,12,0,1,3,0,27,16,1
2249,32227,iJftBP3zncmjUCwGWSZ77IUrDb3Dt8rz,RXDvfPUBYFlVdlueBFbLW0mhhAyGEqpt,6,3,1,0,1,0,2,0,7,1.0,1,0.0,0,1,0,1,3,0,0,2,0,2,5,1
2250,32231,1SB9qi7MaxHcbORi1JFl9LLHs6wwG3kU,SpATywNh6bZuzm8s1ceuBUnMUAeoAHHw,37,38,0,39,0,2,9,2,90,12.857142857142858,2,0.0,8,0,35,0,30,2,4,9,2,43,47,0
2251,32235,a2KqV4OdHZk4ucffhIhWG5E1QwAi4iE7,SpATywNh6bZuzm8s1ceuBUnMUAeoAHHw,10,8,2,0,2,0,7,0,19,2.7142857142857144,2,0.0,2,2,0,2,6,0,0,7,0,6,13,0
2252,32248,s54A0hFU7GzRUM0cq0hWJTDlnMIM1TAX,SpATywNh6bZuzm8s1ceuBUnMUAeoAHHw,28,29,19,25,11,0,4,0,88,12.571428571428571,4,0.0,6,19,23,11,23,0,2,4,0,59,29,1
2253,32253,ttxTsF9ExfVKBVMcQbsoZt6AA8x2bWVB,SpATywNh6bZuzm8s1ceuBUnMUAeoAHHw,6,12,2,0,0,17,7,0,38,5.428571428571429,4,0.0,0,2,0,0,12,17,0,7,0,2,36,1
2254,32257,KJtTFVCUZxFPCdrcl94b8VUY3eA2PtX6,5X6FeZozNMgE2VRi3MJYjkkFK8SETtu2,1,0,0,0,0,0,1,0,1,0.14285714285714285,1,0.0,0,0,0,0,0,0,0,1,0,0,1,1
2255,32265,COpqi7PB37yJZ0BYYjHIpqMxiJ4vAe0U,SpATywNh6bZuzm8s1ceuBUnMUAeoAHHw,1,0,0,0,0,0,1,0,1,0.14285714285714285,1,0.0,0,0,0,0,0,0,0,1,0,0,1,1
2256,32266,JfQVgXDVu1NGs9lcRBOD4w6V7BSaZCc2,SpATywNh6bZuzm8s1ceuBUnMUAeoAHHw,29,24,19,12,16,14,4,0,89,12.714285714285714,2,0.0,2,19,11,16,22,14,1,4,0,48,41,1
2257,32278,coj5NqErnlD9ozminSGxVugmS0slNqs1,bWdj2GDclj5ofokWjzoa5jAwMkxCykd6,9,8,1,0,0,1,7,1,18,2.5714285714285716,2,0.0,0,1,0,0,8,1,0,7,1,1,17,1
2258,32289,5getYNIZ2hnUwVH9nwJiD9At1XFs260U,RXDvfPUBYFlVdlueBFbLW0mhhAyGEqpt,42,53,3,94,2,18,9,2,181,25.857142857142858,5,0.0,7,3,87,2,46,18,7,9,2,99,82,0
2259,32298,mXsmDArxUTe9rMFHp3cGPJEx5ACYKD90,RXDvfPUBYFlVdlueBFbLW0mhhAyGEqpt,1,0,0,0,0,0,1,0,1,0.14285714285714285,1,0.0,0,0,0,0,0,0,0,1,0,0,1,1
2260,32327,uC9kT2KA2FrN5E2wnyLKuknCQiL2UjyY,SpATywNh6bZuzm8s1ceuBUnMUAeoAHHw,39,48,1,52,1,14,26,1,143,20.428571428571427,3,0.0,16,1,42,1,32,14,10,26,1,60,83,0
2261,32338,AgNNzeJI1RzulgZ7Mt174twC5BMmXMhy,SpATywNh6bZuzm8s1ceuBUnMUAeoAHHw,1,0,0,0,0,0,1,0,1,0.14285714285714285,1,0.0,0,0,0,0,0,0,0,1,0,0,1,0
2262,32350,4Z7KasuRx9CbJCcpGQot8eWIzFoK9Y6e,G8EPVSXsOYB5YQWZGiz1aVq5Pgr2GrQu,7,9,7,2,3,0,2,0,23,3.2857142857142856,2,0.0,0,7,1,3,9,0,1,2,0,11,12,0
2263,32369,nOWwmMm8RUDfPfoqvXy3xmkIL6qZiu0a,A3fsA9Zfv1X2fVEQhTw51lKENdNrEqT3,1,0,0,0,0,0,2,0,2,0.2857142857142857,1,0.0,0,0,0,0,0,0,0,2,0,0,2,1
2264,32378,dnBboDTKZBSq62soTT8p1zFH5HInmJMi,SpATywNh6bZuzm8s1ceuBUnMUAeoAHHw,41,31,23,34,12,9,5,0,114,16.285714285714285,3,0.0,6,23,34,12,25,9,0,5,0,75,39,0
2265,32387,40BfkvCbbDiXljpQ7TxzzDakjMbYaL3S,SpATywNh6bZuzm8s1ceuBUnMUAeoAHHw,19,21,9,39,0,2,3,0,74,10.571428571428571,2,0.0,11,9,35,0,10,2,4,3,0,55,19,0
2266,32388,zY3LGOKMRR2PDg5R97BZ2yUdZPtM97Yl,SpATywNh6bZuzm8s1ceuBUnMUAeoAHHw,15,15,7,0,4,0,5,0,31,4.428571428571429,2,0.0,0,7,0,4,15,0,0,5,0,11,20,0
2267,32397,nOWwmMm8RUDfPfoqvXy3xmkIL6qZiu0a,RXDvfPUBYFlVdlueBFbLW0mhhAyGEqpt,1,0,0,0,0,0,1,0,1,0.14285714285714285,1,0.0,0,0,0,0,0,0,0,1,0,0,1,1
2268,32404,w7790lyNDi5biQPgaVfIpYKtROrGndED,SpATywNh6bZuzm8s1ceuBUnMUAeoAHHw,24,84,26,14,11,0,20,0,155,22.142857142857142,3,0.0,2,26,12,11,82,0,2,20,0,51,104,1
2269,32414,vQKXRGJivHAUfIMdau8F2EHQ9nob0SwQ,SpATywNh6bZuzm8s1ceuBUnMUAeoAHHw,5,3,1,0,1,2,3,0,10,1.4285714285714286,1,0.0,0,1,0,1,3,2,0,3,0,2,8,0
2270,32418,JWL56Ty5ftfkoPK2UQMZpNAsXYgyc1GR,SpATywNh6bZuzm8s1ceuBUnMUAeoAHHw,6,5,0,0,0,0,10,0,15,2.142857142857143,1,0.0,0,0,0,0,5,0,0,10,0,0,15,1
2271,32423,FW47VC0lzmys2S4k8Ky52JrXCSFDeyeP,A3fsA9Zfv1X2fVEQhTw51lKENdNrEqT3,4,4,2,0,0,0,3,0,9,1.2857142857142858,1,0.0,0,2,0,0,4,0,0,3,0,2,7,1
2272,32428,sgWvC8NRvYtrmKjALzTvn9SNvnbzDMjJ,5X6FeZozNMgE2VRi3MJYjkkFK8SETtu2,7,9,0,6,1,0,2,0,18,2.5714285714285716,1,0.0,4,0,6,1,5,0,0,2,0,11,7,1
2273,32435,QqE2Xjwy9gUzOvFdkDqAwAaNZLBZkxvd,7GRhBDsirIGkRZBtSMEzNTyDr2JQm4xx,21,62,4,14,8,21,11,0,120,17.142857142857142,2,0.0,32,4,13,8,30,21,1,11,0,57,63,1
2274,32437,gGSMkNgPdXpBQgdZzyjzifomyCxFSNyt,A3fsA9Zfv1X2fVEQhTw51lKENdNrEqT3,29,20,11,66,6,0,2,0,105,15.0,3,0.0,5,11,59,6,15,0,7,2,0,81,24,0
2275,32438,ljhELjrE7nbOy1tZAQRzQ0d2zvHLtBFk,SpATywNh6bZuzm8s1ceuBUnMUAeoAHHw,14,13,5,17,3,0,2,0,40,5.714285714285714,2,0.0,4,5,14,3,9,0,3,2,0,26,14,1
2276,32439,sbafJyL5hxYHWbu0cbLBSCFDQh5Oe8Ww,RXDvfPUBYFlVdlueBFbLW0mhhAyGEqpt,13,27,3,24,5,0,3,0,62,8.857142857142858,3,0.0,5,3,21,5,22,0,3,3,0,34,28,0
2277,32440,PFladZHBxKsed81P3VF9JVKRBqF9WnYc,A3fsA9Zfv1X2fVEQhTw51lKENdNrEqT3,3,2,1,0,0,0,1,0,4,0.5714285714285714,1,0.0,0,1,0,0,2,0,0,1,0,1,3,1
2278,32458,0zDhC7Bi6IWixLnOwX1MJzbdTwc3fSoD,SpATywNh6bZuzm8s1ceuBUnMUAeoAHHw,7,3,2,0,2,0,2,0,9,1.2857142857142858,1,0.0,0,2,0,2,3,0,0,2,0,4,5,1
2279,32462,g5xxNUIA9RHROOUKRydh6JdZ7s9weUGi,RXDvfPUBYFlVdlueBFbLW0mhhAyGEqpt,1,0,0,0,0,0,1,0,1,0.14285714285714285,1,0.0,0,0,0,0,0,0,0,1,0,0,1,1
2280,32465,X81ozmfRR6khTijYbF3duBVCPMYOxHia,SpATywNh6bZuzm8s1ceuBUnMUAeoAHHw,30,41,24,38,14,5,11,0,133,19.0,2,0.0,11,24,31,14,30,5,7,11,0,80,53,0
2281,32466,JJro1amtaUogvd4Vkbdsh0DmnqfguR8P,SpATywNh6bZuzm8s1ceuBUnMUAeoAHHw,16,12,5,27,0,0,1,0,45,6.428571428571429,1,0.0,6,5,23,0,6,0,4,1,0,34,11,1
2282,32471,1BEoeS35Ni9RflXqhdHAKpKpQ07oVqkG,SpATywNh6bZuzm8s1ceuBUnMUAeoAHHw,14,17,2,10,1,0,2,0,32,4.571428571428571,1,0.0,2,2,10,1,15,0,0,2,0,15,17,0
2283,32473,c4hCwkmMWlqvj6IYLILNRvCebh0jrQGq,SpATywNh6bZuzm8s1ceuBUnMUAeoAHHw,46,45,43,18,34,0,2,0,142,20.285714285714285,2,0.0,0,43,15,34,45,0,3,2,0,92,50,0
2284,32477,LPul7vNnoWP2lahy0vntgg039NwfmlYY,SpATywNh6bZuzm8s1ceuBUnMUAeoAHHw,25,31,1,20,1,0,7,0,60,8.571428571428571,2,0.0,4,1,15,1,27,0,5,7,0,21,39,0
2285,32483,MauXcYq2z30gm4QmDqcfc1IfWjnRlPwg,SpATywNh6bZuzm8s1ceuBUnMUAeoAHHw,17,42,2,0,2,0,10,0,56,8.0,4,0.0,0,2,0,2,42,0,0,10,0,4,52,0
2286,32499,mGnlknhC56CLUX07J2uvTiiVnxb6XIJ6,A3fsA9Zfv1X2fVEQhTw51lKENdNrEqT3,15,9,7,0,4,5,8,0,33,4.714285714285714,2,0.0,0,7,0,4,9,5,0,8,0,11,22,0
2287,32502,vthDe5chpuGwbDUyc90EI2Y8jHRBb15H,5X6FeZozNMgE2VRi3MJYjkkFK8SETtu2,43,59,25,6,41,0,4,0,135,19.285714285714285,5,0.0,28,25,6,41,31,0,0,4,0,100,35,1
2288,32507,vhSKbWRNOosmCM74JqrukEsGTTYmFc38,SpATywNh6bZuzm8s1ceuBUnMUAeoAHHw,5,2,1,0,1,0,2,0,6,0.8571428571428571,1,0.0,0,1,0,1,2,0,0,2,0,2,4,1
2289,32520,AFUJTbEqqgSsqCkUsNrjbPAjZvFwpzeW,G8EPVSXsOYB5YQWZGiz1aVq5Pgr2GrQu,71,65,27,157,18,0,9,0,276,39.42857142857143,3,0.0,9,27,119,18,56,0,38,9,0,173,103,0
2290,32530,KbfT30uvubax3lKEct6iblV8VhlPaIEn,G8EPVSXsOYB5YQWZGiz1aVq5Pgr2GrQu,41,35,21,78,13,0,5,0,152,21.714285714285715,5,0.0,7,21,65,13,28,0,13,5,0,106,46,0
2291,32532,4PweNxjsOhOMjaZ2FlK8Sbpgnsb73xXB,SpATywNh6bZuzm8s1ceuBUnMUAeoAHHw,11,5,4,0,4,0,3,0,16,2.2857142857142856,1,0.0,0,4,0,4,5,0,0,3,0,8,8,1
2292,32533,iVbKlCBdSTOnwPES1gHCC6kJee3O7Vv2,SpATywNh6bZuzm8s1ceuBUnMUAeoAHHw,1,0,0,0,0,0,2,0,2,0.2857142857142857,1,0.0,0,0,0,0,0,0,0,2,0,0,2,1
2293,32535,msKx0ivmnd2fyZkUe9cuLZiNYOEcdmOY,SpATywNh6bZuzm8s1ceuBUnMUAeoAHHw,17,14,10,17,6,0,3,0,50,7.142857142857143,3,0.0,3,10,15,6,11,0,2,3,0,34,16,1
2294,32536,13AvYdfA6LYkS80MstJgmNNdfNqd80ja,bWdj2GDclj5ofokWjzoa5jAwMkxCykd6,10,5,0,0,0,2,10,1,18,2.5714285714285716,2,0.0,0,0,0,0,5,2,0,10,1,0,18,0
2295,32545,mS5t9CRTu7dLDWlOhRLNtJoqifYvSGih,SpATywNh6bZuzm8s1ceuBUnMUAeoAHHw,15,63,41,13,0,0,17,0,134,19.142857142857142,2,0.0,16,41,11,0,47,0,2,17,0,68,66,0
2296,32547,wkfBzItw0JCH6ZUz2WUZn7ngJ5M4Oksy,SpATywNh6bZuzm8s1ceuBUnMUAeoAHHw,25,56,5,13,2,0,10,0,86,12.285714285714286,7,0.0,11,5,12,2,45,0,1,10,0,30,56,0
2297,32555,g14jBWDuqUHRwpf4jHpBljeNVwCyjgqd,G8EPVSXsOYB5YQWZGiz1aVq5Pgr2GrQu,37,48,25,0,23,0,5,0,101,14.428571428571429,3,0.0,2,25,0,23,46,0,0,5,0,50,51,1
2298,32556,F3xkNuC9E3BV92ndqV8Ep20uYNFiQx8b,RXDvfPUBYFlVdlueBFbLW0mhhAyGEqpt,1,0,0,0,0,0,1,0,1,0.14285714285714285,1,0.0,0,0,0,0,0,0,0,1,0,0,1,1
2299,32563,8UEpALpBHIm1SL5uEKGhNPayCrDss58M,A3fsA9Zfv1X2fVEQhTw51lKENdNrEqT3,10,6,4,0,4,0,3,0,17,2.4285714285714284,1,0.0,0,4,0,4,6,0,0,3,0,8,9,1
2300,32579,rQ8twu2Y4JlbZAVSeNSb6mmUSGGvpIAq,SpATywNh6bZuzm8s1ceuBUnMUAeoAHHw,33,55,18,32,10,0,12,0,127,18.142857142857142,5,0.0,16,18,30,10,39,0,2,12,0,74,53,0
2301,32587,dwKCRrq2cYlFl5YxmnjTpirr5PBMVnOq,RXDvfPUBYFlVdlueBFbLW0mhhAyGEqpt,25,47,31,0,22,0,4,0,104,14.857142857142858,1,0.0,0,31,0,22,47,0,0,4,0,53,51,0
2302,32589,BbSjcbtyrTEKVbvJAaKNJmSTAo0uyQCs,SpATywNh6bZuzm8s1ceuBUnMUAeoAHHw,12,14,4,0,3,1,12,1,35,5.0,1,0.0,0,4,0,3,14,1,0,12,1,7,28,1
2303,32600,jaDaYkvR41YbLhesvf9mW32i93zNzaSK,RXDvfPUBYFlVdlueBFbLW0mhhAyGEqpt,4,7,2,0,0,0,4,0,13,1.8571428571428572,2,0.0,0,2,0,0,7,0,0,4,0,2,11,0
2304,32607,zlC9nEdRrqLSPX386Mctiz9fIdlU29GI,SpATywNh6bZuzm8s1ceuBUnMUAeoAHHw,58,72,46,34,30,2,14,0,198,28.285714285714285,3,0.0,17,46,30,30,55,2,4,14,0,123,75,0
2305,32617,ncKGr6xR4Vhs3wPeU0aqO1sSEow8LN64,SpATywNh6bZuzm8s1ceuBUnMUAeoAHHw,19,28,14,11,7,2,3,0,65,9.285714285714286,2,0.0,7,14,9,7,21,2,2,3,0,37,28,0
2306,32621,rpaUwDDLQ5SNQtDfK9UH7GnL6AP0Q8Ts,SpATywNh6bZuzm8s1ceuBUnMUAeoAHHw,9,6,2,0,3,0,10,1,22,3.142857142857143,1,0.0,0,2,0,3,6,0,0,10,1,5,17,1
2307,32627,2s1w2v8MgoByNGqR51pltJWsiHzHAFZ1,A3fsA9Zfv1X2fVEQhTw51lKENdNrEqT3,1,0,0,0,0,0,1,0,1,0.14285714285714285,1,0.0,0,0,0,0,0,0,0,1,0,0,1,0
2308,32633,KSfQPUyfWWfWDmmi6m3KXcKzxz89wkwt,SpATywNh6bZuzm8s1ceuBUnMUAeoAHHw,22,38,20,7,16,0,5,0,86,12.285714285714286,3,0.0,2,20,7,16,36,0,0,5,0,45,41,0
2309,32634,vjkHj7F0L8pzTZztOfHA8KLslVpjNBKq,G8EPVSXsOYB5YQWZGiz1aVq5Pgr2GrQu,56,20,1,204,1,0,18,6,250,35.714285714285715,2,0.0,6,1,180,1,14,0,24,18,6,188,62,0
2310,32637,E31FYfZk8Go2gNZUtflrVZ8SeSYLm9Rk,bWdj2GDclj5ofokWjzoa5jAwMkxCykd6,4,2,0,0,0,0,4,0,6,0.8571428571428571,1,0.0,0,0,0,0,2,0,0,4,0,0,6,1
2311,32638,EkHNRKsccWzYAV6ML4mvFJOcSzuUNJIQ,bWdj2GDclj5ofokWjzoa5jAwMkxCykd6,2,0,0,0,0,0,4,0,4,0.5714285714285714,2,0.0,0,0,0,0,0,0,0,4,0,0,4,1
2312,32646,AQAJ36M8w2XxIpmKxSmQ7toB8IMFMa8v,SpATywNh6bZuzm8s1ceuBUnMUAeoAHHw,5,2,1,0,1,0,3,0,7,1.0,1,0.0,0,1,0,1,2,0,0,3,0,2,5,1
2313,32650,vhSKbWRNOosmCM74JqrukEsGTTYmFc38,A3fsA9Zfv1X2fVEQhTw51lKENdNrEqT3,1,0,0,0,0,0,1,0,1,0.14285714285714285,1,0.0,0,0,0,0,0,0,0,1,0,0,1,1
2314,32652,nqDX1tmEeTnbqCn9T8Crn5CYQgmIy9Eq,SpATywNh6bZuzm8s1ceuBUnMUAeoAHHw,17,29,17,17,3,3,14,0,83,11.857142857142858,4,0.0,4,17,15,3,25,3,2,14,0,39,44,0
2315,32661,qKc8EuUOlEzXysFMoXghKaieW3HIaePV,SpATywNh6bZuzm8s1ceuBUnMUAeoAHHw,20,69,30,20,0,0,22,0,141,20.142857142857142,7,0.0,12,30,18,0,57,0,2,22,0,60,81,0
2316,32663,RQ7L9CpArhwtUrlKYRf29Ou4YmyW3xpx,A3fsA9Zfv1X2fVEQhTw51lKENdNrEqT3,7,8,4,0,2,0,0,0,14,2.0,1,0.0,0,4,0,2,8,0,0,0,0,6,8,0
2317,32673,bvlRhTMK84NG0AHvWoPSuNz8Lz6khZji,A3fsA9Zfv1X2fVEQhTw51lKENdNrEqT3,2,0,0,0,0,0,6,0,6,0.8571428571428571,1,0.0,0,0,0,0,0,0,0,6,0,0,6,1
2318,32675,S65yhLgjTGwwuDt6C6cjI82AJbGfYIiK,SpATywNh6bZuzm8s1ceuBUnMUAeoAHHw,31,33,19,32,13,0,2,0,99,14.142857142857142,1,0.0,13,19,26,13,20,0,6,2,0,71,28,1
2319,32680,4m1Dg29Y9pbvJRrOBjNRbyWgB17yJl3U,G8EPVSXsOYB5YQWZGiz1aVq5Pgr2GrQu,8,5,2,0,2,0,3,0,12,1.7142857142857142,1,0.0,0,2,0,2,5,0,0,3,0,4,8,0
2320,32681,t6I1fQ9ItZRIjAyoxww7ONpoKNI8Ya9L,SpATywNh6bZuzm8s1ceuBUnMUAeoAHHw,8,5,0,12,0,0,4,0,21,3.0,1,0.0,2,0,11,0,3,0,1,4,0,13,8,0
2321,32686,DE2u0bz0HnoULwJGtrWEHwtLyRyGfjcB,SpATywNh6bZuzm8s1ceuBUnMUAeoAHHw,47,75,48,34,31,16,26,0,230,32.857142857142854,5,0.0,12,48,28,31,63,16,6,26,0,119,111,0
2322,32688,vsH3qB64VOSnSTFhrkJQnHqm8c83psRR,SpATywNh6bZuzm8s1ceuBUnMUAeoAHHw,34,79,22,37,13,34,6,0,191,27.285714285714285,3,0.0,10,22,32,13,69,34,5,6,0,77,114,0
2323,32691,zIxh0JW4JCwiox9jMtpfpkw3WRcYtUgv,SpATywNh6bZuzm8s1ceuBUnMUAeoAHHw,40,89,15,33,11,2,20,1,171,24.428571428571427,2,0.0,15,15,26,11,74,2,7,20,1,67,104,0
2324,32693,NrExtDPytZeckpp4FyIosvaEjFjzywmC,A3fsA9Zfv1X2fVEQhTw51lKENdNrEqT3,25,6,1,84,0,0,5,0,96,13.714285714285714,1,0.0,1,1,79,0,5,0,5,5,0,81,15,1
2325,32695,y8imMYdOt2q2mj8pfo2jTgj4ApcxIHQk,SpATywNh6bZuzm8s1ceuBUnMUAeoAHHw,4,3,0,0,0,0,1,0,4,0.5714285714285714,1,0.0,0,0,0,0,3,0,0,1,0,0,4,0
2326,32704,YKYIjfKiQT6jdADuFkuvypbfW8jlgM1n,SpATywNh6bZuzm8s1ceuBUnMUAeoAHHw,30,26,14,26,9,0,3,0,78,11.142857142857142,2,0.0,10,14,21,9,16,0,5,3,0,54,24,1
2327,32710,HJ2gv3yF0WCJxGH8T6tjLTFYdM4sCizz,RXDvfPUBYFlVdlueBFbLW0mhhAyGEqpt,47,87,58,95,22,2,20,0,284,40.57142857142857,4,0.0,15,58,84,22,72,2,11,20,0,179,105,0
2328,32714,bRoCd7cLhhjZ85w2yZEA6KmzEGTRpVRz,SpATywNh6bZuzm8s1ceuBUnMUAeoAHHw,31,50,5,37,3,7,14,0,116,16.571428571428573,4,0.0,6,5,33,3,44,7,4,14,0,47,69,0
2329,32720,JmCoruZKuYTEfRy2RtllkeekTzFeqi2M,SpATywNh6bZuzm8s1ceuBUnMUAeoAHHw,9,18,6,0,5,1,6,0,36,5.142857142857143,3,0.0,1,6,0,5,17,1,0,6,0,12,24,0
2330,32721,aLRP3ahB5SIcOn5vpM1VPEh9ib2QIioX,A3fsA9Zfv1X2fVEQhTw51lKENdNrEqT3,56,65,33,0,31,0,1,0,130,18.571428571428573,1,0.0,0,33,0,31,65,0,0,1,0,64,66,1
2331,32722,Jd5OP6GIsguRdsq9k3eSYNENmzhPbdGe,A3fsA9Zfv1X2fVEQhTw51lKENdNrEqT3,4,2,1,0,0,0,4,0,7,1.0,2,0.0,0,1,0,0,2,0,0,4,0,1,6,0
2332,32732,L74tKRZpBi1qsh0NM3EwE5D87acCLK8s,A3fsA9Zfv1X2fVEQhTw51lKENdNrEqT3,54,45,25,196,10,0,11,0,287,41.0,3,0.0,3,25,196,10,42,0,0,11,0,234,53,0
2333,32753,Gn3GzN2xweKhiR4C9qIb4ocllZ2lANYz,SpATywNh6bZuzm8s1ceuBUnMUAeoAHHw,9,8,5,0,1,0,4,0,18,2.5714285714285716,2,0.0,0,5,0,1,8,0,0,4,0,6,12,1
2334,32769,vEKYOhRdGZ59kfXY6wTO63YZY4EqPYqX,SpATywNh6bZuzm8s1ceuBUnMUAeoAHHw,17,24,20,0,14,0,4,0,62,8.857142857142858,2,0.0,0,20,0,14,24,0,0,4,0,34,28,0
2335,32777,TW8ndAffUINsh706iQobn31l3IsMOQi5,SpATywNh6bZuzm8s1ceuBUnMUAeoAHHw,50,91,38,30,30,1,28,0,218,31.142857142857142,5,0.0,9,38,28,30,82,1,2,28,0,105,113,0
2336,32781,mPCmohVETKOBEAkMNdnfTJW7kVWg1ArQ,bWdj2GDclj5ofokWjzoa5jAwMkxCykd6,12,25,1,0,1,0,8,0,35,5.0,1,0.0,3,1,0,1,22,0,0,8,0,5,30,1
2337,32826,wCKxyDpTEsiI3UuDi33CaUGYhXjKnrBv,SpATywNh6bZuzm8s1ceuBUnMUAeoAHHw,6,4,2,0,1,0,2,0,9,1.2857142857142858,1,0.0,0,2,0,1,4,0,0,2,0,3,6,0
2338,32837,wZVSpaATIDuE7qW0svZJi84Cpi6PMqWg,SpATywNh6bZuzm8s1ceuBUnMUAeoAHHw,4,2,1,0,0,0,2,0,5,0.7142857142857143,1,0.0,0,1,0,0,2,0,0,2,0,1,4,1
2339,32848,shBFkXtQXH3viJ4rhxwHBPknnWE8q371,SpATywNh6bZuzm8s1ceuBUnMUAeoAHHw,1,0,0,0,0,0,1,0,1,0.14285714285714285,1,0.0,0,0,0,0,0,0,0,1,0,0,1,1
2340,32868,Hk1cgW0d6IHp4JJgdPvorinTv3vI8Eld,A3fsA9Zfv1X2fVEQhTw51lKENdNrEqT3,1,0,0,0,0,0,2,0,2,0.2857142857142857,1,0.0,0,0,0,0,0,0,0,2,0,0,2,1
2341,32872,XEcLEoVa2SWvlFcbbhIECksb9a6XvMec,RXDvfPUBYFlVdlueBFbLW0mhhAyGEqpt,60,49,28,158,19,0,1,0,255,36.42857142857143,1,0.0,20,28,142,19,29,0,16,1,0,209,46,0
2342,32875,096xYyhB9kL7G6lT7J9rVrXyGNwUToLF,RXDvfPUBYFlVdlueBFbLW0mhhAyGEqpt,40,43,33,0,2,5,6,2,91,13.0,1,0.0,7,33,0,2,36,5,0,6,2,42,49,0
2343,32876,YdtHeotp7qxTsE68WXV4PTL8YQlRtZSZ,SpATywNh6bZuzm8s1ceuBUnMUAeoAHHw,10,6,3,0,3,0,6,0,18,2.5714285714285716,2,0.0,0,3,0,3,6,0,0,6,0,6,12,0
2344,32881,y7ML2j3yhLTXFlpVgDfbFQ7iV1QJE8KN,G8EPVSXsOYB5YQWZGiz1aVq5Pgr2GrQu,1,0,0,0,0,0,1,0,1,0.14285714285714285,1,0.0,0,0,0,0,0,0,0,1,0,0,1,1
2345,32884,z2Zz9wVXxnQo0wOtqHQc06HPM9iWXDoN,SpATywNh6bZuzm8s1ceuBUnMUAeoAHHw,26,28,12,20,5,2,16,1,84,12.0,2,0.0,4,12,17,5,24,2,3,16,1,38,46,0
2346,32887,9WVTv7dWHzTCHwCGLSPAioAO2udyHWmu,SpATywNh6bZuzm8s1ceuBUnMUAeoAHHw,36,55,39,23,32,0,15,0,164,23.428571428571427,5,0.0,14,39,19,32,41,0,4,15,0,104,60,0
2347,32895,GCXdwkqD60eGG5W317sN3ZNf27MOQY4U,SpATywNh6bZuzm8s1ceuBUnMUAeoAHHw,7,5,1,0,1,0,2,0,9,1.2857142857142858,1,0.0,0,1,0,1,5,0,0,2,0,2,7,1
2348,32896,p7kSnjO0uUcIRggHewx0HDSWkZbQpZMf,5X6FeZozNMgE2VRi3MJYjkkFK8SETtu2,2,0,0,0,0,0,3,0,3,0.42857142857142855,2,0.0,0,0,0,0,0,0,0,3,0,0,3,0
2349,32902,4vKI2gaXrHATS50fqVyDxXcmRy0MrgJS,5X6FeZozNMgE2VRi3MJYjkkFK8SETtu2,1,0,0,0,0,0,1,0,1,0.14285714285714285,1,0.0,0,0,0,0,0,0,0,1,0,0,1,1
2350,32906,ZE27RADj3bE2oGbL4tXAfIaeVlYNn4oN,SpATywNh6bZuzm8s1ceuBUnMUAeoAHHw,40,65,25,58,7,8,11,1,175,25.0,4,0.0,30,25,51,7,35,8,7,11,1,113,62,0
2351,32912,c4hCwkmMWlqvj6IYLILNRvCebh0jrQGq,bWdj2GDclj5ofokWjzoa5jAwMkxCykd6,4,3,2,0,2,0,2,0,9,1.2857142857142858,1,0.0,0,2,0,2,3,0,0,2,0,4,5,1
2352,32917,dwKCRrq2cYlFl5YxmnjTpirr5PBMVnOq,SpATywNh6bZuzm8s1ceuBUnMUAeoAHHw,5,3,2,0,1,0,1,0,7,1.0,1,0.0,0,2,0,1,3,0,0,1,0,3,4,0
2353,32923,NqKjMSY6eOZQ1uSyzlPrquJVqzjvSO7O,SpATywNh6bZuzm8s1ceuBUnMUAeoAHHw,35,53,25,15,13,10,14,1,131,18.714285714285715,5,0.0,8,25,15,13,45,10,0,14,1,61,70,0
2354,32927,c4hCwkmMWlqvj6IYLILNRvCebh0jrQGq,RXDvfPUBYFlVdlueBFbLW0mhhAyGEqpt,20,15,8,34,6,5,6,1,75,10.714285714285714,1,0.0,2,8,29,6,13,5,5,6,1,45,30,0
2355,32929,OWN7QY4MoQINwciZKacEUOaJkqenbOMp,SpATywNh6bZuzm8s1ceuBUnMUAeoAHHw,16,20,9,15,4,15,8,4,75,10.714285714285714,2,0.0,8,9,13,4,12,15,2,8,4,34,41,0
2356,32936,LWVN5HyIlUP5vqqhXm830bNH0dXW6G7Q,G8EPVSXsOYB5YQWZGiz1aVq5Pgr2GrQu,27,34,15,16,48,4,10,1,128,18.285714285714285,3,0.0,2,15,13,48,32,4,3,10,1,78,50,0
2357,32947,1KCmpfcoDnRnd9ITYAgYi4eQPwc5jiJz,5X6FeZozNMgE2VRi3MJYjkkFK8SETtu2,20,54,14,28,18,0,8,0,122,17.428571428571427,6,0.0,25,14,23,18,29,0,5,8,0,80,42,1
2358,32948,HeUmba4DxhcRtDoTRVT5PFbN9je6Gg4G,SpATywNh6bZuzm8s1ceuBUnMUAeoAHHw,1,0,0,0,0,0,1,0,1,0.14285714285714285,1,0.0,0,0,0,0,0,0,0,1,0,0,1,1
2359,32969,z4c8EBwIn89viFGIwasAjQhkMGV3BTQj,SpATywNh6bZuzm8s1ceuBUnMUAeoAHHw,4,3,2,0,1,0,0,0,6,0.8571428571428571,1,0.0,0,2,0,1,3,0,0,0,0,3,3,0
2360,32971,qUsQUczCM7yxZspK4y0wqEbk7aa4p04H,SpATywNh6bZuzm8s1ceuBUnMUAeoAHHw,1,0,0,0,0,0,1,0,1,0.14285714285714285,1,0.0,0,0,0,0,0,0,0,1,0,0,1,1
2361,33024,P7HoHyQzVXLghYr6m3MYTEIsDQbHfDfp,SpATywNh6bZuzm8s1ceuBUnMUAeoAHHw,24,29,17,10,8,0,10,0,74,10.571428571428571,6,0.0,4,17,10,8,25,0,0,10,0,39,35,0
2362,33033,h7I4MrR4mKnNKblXSAy8wcbhlYTfxUMt,RXDvfPUBYFlVdlueBFbLW0mhhAyGEqpt,6,5,2,0,1,0,2,0,10,1.4285714285714286,2,0.0,0,2,0,1,5,0,0,2,0,3,7,0
2363,33035,fsFhPwlLRADu3y98ioOv5tbQuyaSeyNN,SpATywNh6bZuzm8s1ceuBUnMUAeoAHHw,6,8,2,0,1,0,2,0,13,1.8571428571428572,1,0.0,0,2,0,1,8,0,0,2,0,3,10,0
2364,33064,R4jdTSzPeoexGjkDudtUNf4wM5QqkaKU,5X6FeZozNMgE2VRi3MJYjkkFK8SETtu2,1,0,0,0,0,0,1,0,1,0.14285714285714285,1,0.0,0,0,0,0,0,0,0,1,0,0,1,1
2365,33074,DNPg311dH1sJEozPjhQWBOgx4wvkLFM7,5X6FeZozNMgE2VRi3MJYjkkFK8SETtu2,4,0,0,0,0,1,3,1,5,0.7142857142857143,1,0.0,0,0,0,0,0,1,0,3,1,0,5,0
2366,33080,5ADMlR48WDr3F57JEz4JNbgGytxoga6J,SpATywNh6bZuzm8s1ceuBUnMUAeoAHHw,16,19,5,11,4,0,15,0,54,7.714285714285714,7,0.0,2,5,11,4,17,0,0,15,0,22,32,0
2367,33084,jAeQS6v1suZotlPWHh2m5nRATBxHiHCr,G8EPVSXsOYB5YQWZGiz1aVq5Pgr2GrQu,5,3,1,0,1,0,2,0,7,1.0,1,0.0,0,1,0,1,3,0,0,2,0,2,5,1
2368,33094,nZyLcN4vHeyiwwvW8JQP12ocO8k2uB5o,A3fsA9Zfv1X2fVEQhTw51lKENdNrEqT3,31,74,36,0,3,0,2,0,115,16.428571428571427,1,0.0,0,36,0,3,74,0,0,2,0,39,76,1
2369,33108,ixS1p3tBQwqQrlFRj6LavXiIpA0ocHQj,SpATywNh6bZuzm8s1ceuBUnMUAeoAHHw,20,26,1,18,1,0,2,0,48,6.857142857142857,2,0.0,6,1,15,1,20,0,3,2,0,23,25,1
2370,33123,31YnUQ787pms6asdEq4mYZdG40oJXIcC,SpATywNh6bZuzm8s1ceuBUnMUAeoAHHw,2,0,0,0,0,0,2,0,2,0.2857142857142857,1,0.0,0,0,0,0,0,0,0,2,0,0,2,1
2371,33126,g8FzZPNwpogRDZ96ajFkgFq4Hk5lGots,G8EPVSXsOYB5YQWZGiz1aVq5Pgr2GrQu,1,0,0,0,0,0,2,0,2,0.2857142857142857,2,0.0,0,0,0,0,0,0,0,2,0,0,2,1
2372,33127,FAyJy1gyoIxzJtXvVglyOve11ozvFF4C,SpATywNh6bZuzm8s1ceuBUnMUAeoAHHw,7,6,3,0,2,0,1,0,12,1.7142857142857142,1,0.0,0,3,0,2,6,0,0,1,0,5,7,0
2373,33129,eBy9VnMLJAw0hqJXLuWSECKqPc7yNmPx,5X6FeZozNMgE2VRi3MJYjkkFK8SETtu2,16,15,8,18,1,8,12,2,64,9.142857142857142,4,0.0,3,8,16,1,12,8,2,12,2,28,36,1
2374,33140,Nl6KXQBQ15lo8Bj3xZmtCULVumxrpWOd,RXDvfPUBYFlVdlueBFbLW0mhhAyGEqpt,10,19,0,22,5,39,3,0,88,12.571428571428571,1,0.0,11,0,18,5,8,39,4,3,0,34,54,0
2375,33148,UNB2LODshs2HtKrBL5CYaUedKOvveRXk,SpATywNh6bZuzm8s1ceuBUnMUAeoAHHw,38,21,19,0,18,0,2,0,60,8.571428571428571,1,0.0,0,19,0,18,21,0,0,2,0,37,23,1
2376,33150,vU01Fxors0KlSd7gao1Z0nHesILTHNPI,SpATywNh6bZuzm8s1ceuBUnMUAeoAHHw,30,39,13,3,9,20,21,0,105,15.0,5,0.0,0,13,3,9,39,20,0,21,0,25,80,0
2377,33164,AJYnlahOLAGVXTJrzU8y7gkOQqLtYt6X,SpATywNh6bZuzm8s1ceuBUnMUAeoAHHw,40,36,24,25,15,4,3,0,107,15.285714285714286,2,0.0,10,24,24,15,26,4,1,3,0,73,34,0
2378,33179,79cpMMK2EsbvkowaPozXyQoZKeC4iKuw,A3fsA9Zfv1X2fVEQhTw51lKENdNrEqT3,22,6,2,64,0,0,3,0,75,10.714285714285714,2,0.0,2,2,56,0,4,0,8,3,0,60,15,0
2379,33184,91SMPbwCYEBVQrvddh8BFR950javKvv6,A3fsA9Zfv1X2fVEQhTw51lKENdNrEqT3,9,3,2,0,2,0,11,0,18,2.5714285714285716,2,0.0,0,2,0,2,3,0,0,11,0,4,14,1
2380,33189,prx0F7eWxsl3d2mx5LUgQvJ105nB30Fw,SpATywNh6bZuzm8s1ceuBUnMUAeoAHHw,26,63,9,0,5,0,10,0,87,12.428571428571429,3,0.0,0,9,0,5,63,0,0,10,0,14,73,0
2381,33196,0qazDeX2ArYKUwsbw3YPo5IK1kBs3caI,G8EPVSXsOYB5YQWZGiz1aVq5Pgr2GrQu,6,6,2,0,1,0,2,0,11,1.5714285714285714,1,0.0,0,2,0,1,6,0,0,2,0,3,8,1
2382,33203,6oSvXBiE6hMQm6ur1TzQBxRkuWf4UJ1w,SpATywNh6bZuzm8s1ceuBUnMUAeoAHHw,8,4,3,0,2,0,3,0,12,1.7142857142857142,1,0.0,0,3,0,2,4,0,0,3,0,5,7,0
2383,33215,P8yzAiNhRid702ItHIVI1p5U2WX8liH9,bWdj2GDclj5ofokWjzoa5jAwMkxCykd6,1,0,0,0,0,0,1,0,1,0.14285714285714285,1,0.0,0,0,0,0,0,0,0,1,0,0,1,1
2384,33217,P8yzAiNhRid702ItHIVI1p5U2WX8liH9,A3fsA9Zfv1X2fVEQhTw51lKENdNrEqT3,7,5,1,0,1,0,2,0,9,1.2857142857142858,1,0.0,1,1,0,1,4,0,0,2,0,3,6,1
2385,33224,M5i9wheFDK1paYxXA7PsW9kp3DBbWp4e,bWdj2GDclj5ofokWjzoa5jAwMkxCykd6,12,18,9,46,2,0,2,0,77,11.0,3,0.0,3,9,45,2,15,0,1,2,0,59,18,0
2386,33231,NMS9jGnwr8Vw7CGJJuppEbFTwlpwo7HM,SpATywNh6bZuzm8s1ceuBUnMUAeoAHHw,1,0,0,0,0,0,2,0,2,0.2857142857142857,1,0.0,0,0,0,0,0,0,0,2,0,0,2,1
2387,33241,JidGgSxCfdGzmokg3gMkwGiBLuw5F3te,SpATywNh6bZuzm8s1ceuBUnMUAeoAHHw,18,18,14,0,5,0,4,1,42,6.0,1,0.0,1,14,0,5,17,0,0,4,1,20,22,1
2388,33244,zXK10fuHzjlZN6zXC9UzE5cZssrYVIEu,5X6FeZozNMgE2VRi3MJYjkkFK8SETtu2,6,5,3,0,2,0,3,0,13,1.8571428571428572,2,0.0,0,3,0,2,5,0,0,3,0,5,8,1
2389,33249,tBYNgYMLcaid5WsG2NgVjslnqBmTbXuo,bWdj2GDclj5ofokWjzoa5jAwMkxCykd6,5,6,1,2,0,0,1,0,10,1.4285714285714286,1,0.0,3,1,2,0,3,0,0,1,0,6,4,1
2390,33251,9oofyIqQs4svoCsTL3Pyep7hA30rIFOe,SpATywNh6bZuzm8s1ceuBUnMUAeoAHHw,24,25,11,24,4,2,6,1,73,10.428571428571429,3,0.0,8,11,21,4,17,2,3,6,1,44,29,0
2391,33264,UiTx3V3W2jVsD1DrAmMX7V4GWz7c8Sbi,bWdj2GDclj5ofokWjzoa5jAwMkxCykd6,3,0,0,0,0,1,3,0,4,0.5714285714285714,1,0.0,0,0,0,0,0,1,0,3,0,0,4,1
2392,33266,ANj8LPP4QCqsLHbhaQj263PWrIQ9dqGZ,SpATywNh6bZuzm8s1ceuBUnMUAeoAHHw,13,22,0,21,0,0,3,0,46,6.571428571428571,3,0.0,7,0,16,0,15,0,5,3,0,23,23,0
2393,33270,BFrfDseDfXCBvtTfCsJAy36Ogk6b0Rfx,SpATywNh6bZuzm8s1ceuBUnMUAeoAHHw,22,44,21,0,13,0,6,0,84,12.0,5,0.0,0,21,0,13,44,0,0,6,0,34,50,0
2394,33272,QQyKT0cNRgXjfYZrcyku7Q3OKE07rSzG,A3fsA9Zfv1X2fVEQhTw51lKENdNrEqT3,5,2,1,0,1,0,4,0,8,1.1428571428571428,1,0.0,0,1,0,1,2,0,0,4,0,2,6,1
2395,33282,2OQKy8cwVxfMrqE5RzaRwj0lJIzMo3vb,G8EPVSXsOYB5YQWZGiz1aVq5Pgr2GrQu,1,0,0,0,0,0,1,0,1,0.14285714285714285,1,0.0,0,0,0,0,0,0,0,1,0,0,1,1
2396,33284,jRnFs6XBk6vGxxB24JG9v0Qh3pYfUtLh,RXDvfPUBYFlVdlueBFbLW0mhhAyGEqpt,1,12,0,0,0,0,0,0,12,1.7142857142857142,5,0.0,0,0,0,0,12,0,0,0,0,0,12,0
2397,33286,tZCjR4qvZsX3wLuSLSjR6yRjeUphuVZ9,SpATywNh6bZuzm8s1ceuBUnMUAeoAHHw,3,4,0,0,0,0,1,0,5,0.7142857142857143,2,0.0,0,0,0,0,4,0,0,1,0,0,5,0
2398,33290,0wm7bVyJC7jfhIoeylaV85sHOH5JOhtj,SpATywNh6bZuzm8s1ceuBUnMUAeoAHHw,33,34,24,24,14,2,4,0,102,14.571428571428571,4,0.0,7,24,18,14,27,2,6,4,0,63,39,0
2399,33291,Ly65lkxGurCaK23EMf3qmWsOuD8e8vVr,bWdj2GDclj5ofokWjzoa5jAwMkxCykd6,8,8,4,8,3,0,1,0,24,3.4285714285714284,1,0.0,3,4,7,3,5,0,1,1,0,17,7,1
2400,33298,wjqMTSqGRhad7XTyyuysYYbP0x4J6ulv,bWdj2GDclj5ofokWjzoa5jAwMkxCykd6,13,7,1,10,1,2,11,3,35,5.0,2,0.0,2,1,5,1,5,2,5,11,3,9,26,1
2401,33306,YDKgUItosvh9lrVTHMdJodwxXU47oDDn,SpATywNh6bZuzm8s1ceuBUnMUAeoAHHw,34,59,4,7,4,0,21,8,103,14.714285714285714,4,0.0,10,4,6,4,49,0,1,21,8,24,79,0
2402,33317,udZwvYIs8wt15862s5Y6pk6crVu6xztd,SpATywNh6bZuzm8s1ceuBUnMUAeoAHHw,5,3,2,0,2,0,2,0,9,1.2857142857142858,1,0.0,0,2,0,2,3,0,0,2,0,4,5,1
2403,33322,vIBcYbs1BLdmaaP30fcE2FS7kB7v7QRn,SpATywNh6bZuzm8s1ceuBUnMUAeoAHHw,3,2,1,0,0,0,1,0,4,0.5714285714285714,1,0.0,0,1,0,0,2,0,0,1,0,1,3,1
2404,33331,mJNmN9AbVBmhzBfxSlHeSff1yTyr8w50,SpATywNh6bZuzm8s1ceuBUnMUAeoAHHw,8,24,12,0,6,0,5,0,47,6.714285714285714,4,0.0,0,12,0,6,24,0,0,5,0,18,29,0
2405,33344,096xYyhB9kL7G6lT7J9rVrXyGNwUToLF,A3fsA9Zfv1X2fVEQhTw51lKENdNrEqT3,38,37,32,0,0,0,3,0,72,10.285714285714286,2,0.0,0,32,0,0,37,0,0,3,0,32,40,0
2406,33348,we9tWnySpl1G7k7FqyXPj8wmC2gUYK0W,SpATywNh6bZuzm8s1ceuBUnMUAeoAHHw,3,2,0,0,0,0,1,0,3,0.42857142857142855,1,0.0,0,0,0,0,2,0,0,1,0,0,3,0
2407,33354,0LjNTZG6byvXe7xKDfNEXUTZjqaDOglx,G8EPVSXsOYB5YQWZGiz1aVq5Pgr2GrQu,26,10,6,96,0,0,4,0,116,16.571428571428573,2,0.0,1,6,79,0,9,0,17,4,0,86,30,1
2408,33368,hJo1MgKiPZFXuH2ko6hqPTd9dbjMQKDO,bWdj2GDclj5ofokWjzoa5jAwMkxCykd6,3,10,4,0,0,0,5,0,19,2.7142857142857144,5,0.0,0,4,0,0,10,0,0,5,0,4,15,0
2409,33370,3EwUg208bV0DvnhKptmbGHdmCctMgvT5,SpATywNh6bZuzm8s1ceuBUnMUAeoAHHw,7,12,5,0,1,1,7,1,27,3.857142857142857,2,0.0,0,5,0,1,12,1,0,7,1,6,21,1
2410,33390,wW4GJxMtcZrVSwwTpsg7JhOsvVCWQeUC,A3fsA9Zfv1X2fVEQhTw51lKENdNrEqT3,25,27,25,0,25,0,4,0,81,11.571428571428571,3,0.0,0,25,0,25,27,0,0,4,0,50,31,1
2411,33393,rvGeJBDthuxogYD9iVgKqZ9WWdzkhnrb,G8EPVSXsOYB5YQWZGiz1aVq5Pgr2GrQu,1,0,0,0,0,0,1,0,1,0.14285714285714285,1,0.0,0,0,0,0,0,0,0,1,0,0,1,1
2412,33394,rvGeJBDthuxogYD9iVgKqZ9WWdzkhnrb,RXDvfPUBYFlVdlueBFbLW0mhhAyGEqpt,1,0,0,0,0,0,2,0,2,0.2857142857142857,1,0.0,0,0,0,0,0,0,0,2,0,0,2,1
2413,33404,HYJZRxuL3QhPKaL52ejyF3gmkMGZU1ZH,SpATywNh6bZuzm8s1ceuBUnMUAeoAHHw,4,2,1,0,1,0,1,0,5,0.7142857142857143,1,0.0,0,1,0,1,2,0,0,1,0,2,3,1
2414,33417,dLE8ClT356F8GOTARAp48z5vmhoyi6Jm,SpATywNh6bZuzm8s1ceuBUnMUAeoAHHw,1,0,0,0,0,0,1,0,1,0.14285714285714285,1,0.0,0,0,0,0,0,0,0,1,0,0,1,1
2415,33431,viuKt4GgrX0rYL5EpHoxJbsiC9TblSuk,A3fsA9Zfv1X2fVEQhTw51lKENdNrEqT3,12,17,12,0,7,11,16,0,63,9.0,3,0.0,0,12,0,7,17,11,0,16,0,19,44,0
2416,33443,viuKt4GgrX0rYL5EpHoxJbsiC9TblSuk,bWdj2GDclj5ofokWjzoa5jAwMkxCykd6,11,10,6,0,4,3,6,0,29,4.142857142857143,4,0.0,2,6,0,4,8,3,0,6,0,12,17,0
2417,33445,viuKt4GgrX0rYL5EpHoxJbsiC9TblSuk,5X6FeZozNMgE2VRi3MJYjkkFK8SETtu2,24,36,20,0,7,31,23,1,118,16.857142857142858,8,0.0,6,20,0,7,30,31,0,23,1,33,85,1
2418,33455,7usMWWPRRbqHqTGVe4yfuQMnaM8GH1DT,SpATywNh6bZuzm8s1ceuBUnMUAeoAHHw,21,24,17,1,9,0,9,0,60,8.571428571428571,6,0.0,0,17,1,9,24,0,0,9,0,27,33,0
2419,33467,3gXjYz3VFr0TvsDYUgKtksPt5WrPBmEo,RXDvfPUBYFlVdlueBFbLW0mhhAyGEqpt,13,14,8,0,3,21,9,2,57,8.142857142857142,2,0.0,0,8,0,3,14,21,0,9,2,11,46,0
2420,33469,viuKt4GgrX0rYL5EpHoxJbsiC9TblSuk,G8EPVSXsOYB5YQWZGiz1aVq5Pgr2GrQu,19,30,17,0,7,7,19,0,80,11.428571428571429,5,0.0,6,17,0,7,24,7,0,19,0,30,50,0
2421,33481,viuKt4GgrX0rYL5EpHoxJbsiC9TblSuk,RXDvfPUBYFlVdlueBFbLW0mhhAyGEqpt,4,0,0,0,0,28,11,0,39,5.571428571428571,3,0.0,0,0,0,0,0,28,0,11,0,0,39,0
2422,33488,w30xo3plQsx0SkiDlFlFfUJzRNbhNqJJ,SpATywNh6bZuzm8s1ceuBUnMUAeoAHHw,16,7,4,9,3,0,6,1,30,4.285714285714286,1,0.0,2,4,9,3,5,0,0,6,1,18,12,1
2423,33490,KKySZH8Vhrdd4z2bRf8FAPkHeGpE3JpX,SpATywNh6bZuzm8s1ceuBUnMUAeoAHHw,18,38,1,35,0,0,6,0,80,11.428571428571429,4,0.0,14,1,31,0,24,0,4,6,0,46,34,0
2424,33494,KKySZH8Vhrdd4z2bRf8FAPkHeGpE3JpX,A3fsA9Zfv1X2fVEQhTw51lKENdNrEqT3,13,16,4,0,0,0,7,0,27,3.857142857142857,4,0.0,0,4,0,0,16,0,0,7,0,4,23,0
2425,33496,LES25z3KevamvJJA1mopKcd17ZKutMko,A3fsA9Zfv1X2fVEQhTw51lKENdNrEqT3,2,0,0,0,0,0,2,0,2,0.2857142857142857,1,0.0,0,0,0,0,0,0,0,2,0,0,2,1
2426,33506,R6mWJ0ZeHkZWWi0xlkZZqK7iozuGXemG,7GRhBDsirIGkRZBtSMEzNTyDr2JQm4xx,44,66,23,46,19,19,5,0,178,25.428571428571427,1,0.0,38,23,37,19,28,19,9,5,0,117,61,1
2427,33517,R6mWJ0ZeHkZWWi0xlkZZqK7iozuGXemG,SpATywNh6bZuzm8s1ceuBUnMUAeoAHHw,7,2,2,0,2,0,6,1,13,1.8571428571428572,1,0.0,0,2,0,2,2,0,0,6,1,4,9,1
2428,33521,kOcsNetIsK9HFRaYNeKiWrndfQDPUf2b,7GRhBDsirIGkRZBtSMEzNTyDr2JQm4xx,10,7,6,2,3,0,1,0,19,2.7142857142857144,1,0.0,0,6,1,3,7,0,1,1,0,10,9,1
2429,33529,sYEBB7Cezd6bYcnMjhqBrC5c63jbJN18,SpATywNh6bZuzm8s1ceuBUnMUAeoAHHw,19,20,5,0,4,12,9,2,52,7.428571428571429,3,0.0,0,5,0,4,20,12,0,9,2,9,43,0
2430,33530,aAPaeWN3GBWfW0S1FoCPDVeAcodFtNRR,SpATywNh6bZuzm8s1ceuBUnMUAeoAHHw,1,0,0,0,0,0,2,0,2,0.2857142857142857,2,0.0,0,0,0,0,0,0,0,2,0,0,2,0
2431,33542,5HH0aaaYYEQaS6y1Lay5PLCxlaH9WI7b,A3fsA9Zfv1X2fVEQhTw51lKENdNrEqT3,5,2,1,0,1,0,5,0,9,1.2857142857142858,1,0.0,0,1,0,1,2,0,0,5,0,2,7,1
2432,33554,T2tyjiaDe9s4tWUugE6FZTShWofnfMqo,5X6FeZozNMgE2VRi3MJYjkkFK8SETtu2,30,95,5,46,20,0,20,0,186,26.571428571428573,12,0.0,37,5,43,20,58,0,3,20,0,105,81,1
2433,33555,ALf7rMMKH932l3xWeAFvGNQmKMpEd4tF,SpATywNh6bZuzm8s1ceuBUnMUAeoAHHw,13,16,2,28,0,4,4,0,54,7.714285714285714,1,0.0,6,2,27,0,10,4,1,4,0,35,19,1
2434,33566,xWkSEJurvVs31EV99t5w9EiMtxPaCd2f,5X6FeZozNMgE2VRi3MJYjkkFK8SETtu2,1,0,0,0,0,0,1,0,1,0.14285714285714285,1,0.0,0,0,0,0,0,0,0,1,0,0,1,1
2435,33571,VjR9VP67wJl90FeAkIbcbFMlwY57zr53,SpATywNh6bZuzm8s1ceuBUnMUAeoAHHw,1,0,0,0,0,0,1,0,1,0.14285714285714285,1,0.0,0,0,0,0,0,0,0,1,0,0,1,1
2436,33576,KshwCmsAWd7PYW2Qdxpd0Dd8iC7QTJ5v,SpATywNh6bZuzm8s1ceuBUnMUAeoAHHw,7,11,7,0,6,0,1,0,25,3.5714285714285716,1,0.0,2,7,0,6,9,0,0,1,0,15,10,0
2437,33581,YZSZ4TOtqHUreAioK1x0YBDmIRumwoti,5X6FeZozNMgE2VRi3MJYjkkFK8SETtu2,6,3,1,0,1,0,2,0,7,1.0,1,0.0,0,1,0,1,3,0,0,2,0,2,5,1
2438,33610,6i2sU2iOfHEZCirLcCLqodhgstGeUqVi,SpATywNh6bZuzm8s1ceuBUnMUAeoAHHw,47,59,36,35,22,0,11,1,164,23.428571428571427,3,0.0,13,36,32,22,46,0,3,11,1,103,61,0
2439,33615,RiEm3LuxyewdMDpHDHRR7XJGfum71kSq,SpATywNh6bZuzm8s1ceuBUnMUAeoAHHw,1,0,0,0,0,0,1,0,1,0.14285714285714285,1,0.0,0,0,0,0,0,0,0,1,0,0,1,1
2440,33619,XEN1AZJ1cZ1Qg5cpXKAddUVG2n4aD7ZG,SpATywNh6bZuzm8s1ceuBUnMUAeoAHHw,7,7,0,0,0,0,5,0,12,1.7142857142857142,1,0.0,0,0,0,0,7,0,0,5,0,0,12,1
2441,33638,kGNoIC9AxgB9nCs6frsN1R7EeU5BsStD,SpATywNh6bZuzm8s1ceuBUnMUAeoAHHw,8,5,2,9,0,9,2,0,27,3.857142857142857,1,0.0,2,2,8,0,3,9,1,2,0,12,15,1
2442,33644,eE4DAv5aHElS2DPaTad4VXPjk6A3xvPl,G8EPVSXsOYB5YQWZGiz1aVq5Pgr2GrQu,50,40,31,67,15,0,3,0,156,22.285714285714285,3,0.0,0,31,63,15,40,0,4,3,0,109,47,0
2443,33648,yD8ecTJ7efEF8WUp9kS25bxSOmV2HnI4,A3fsA9Zfv1X2fVEQhTw51lKENdNrEqT3,10,9,0,0,0,0,4,0,13,1.8571428571428572,2,0.0,0,0,0,0,9,0,0,4,0,0,13,1
2444,33674,Ry5r3PlRYtX7RdQht9vGdro0Bt4zHDPw,SpATywNh6bZuzm8s1ceuBUnMUAeoAHHw,37,63,23,39,9,54,32,13,233,33.285714285714285,7,0.0,11,23,36,9,52,54,3,32,13,79,154,0
2445,33676,csMt1h4jwoK6sZ6rEkcutiAH8F6ocCR4,A3fsA9Zfv1X2fVEQhTw51lKENdNrEqT3,4,2,1,0,0,0,2,0,5,0.7142857142857143,1,0.0,0,1,0,0,2,0,0,2,0,1,4,1
2446,33693,DuJi657C7pWyWAohPqQtEFsp3ioofH9U,3VkHkmOtom3jM2wCu94xgzzu1d6Dn7or,30,45,14,30,15,12,8,1,125,17.857142857142858,5,0.0,24,14,24,15,21,12,6,8,1,77,48,1
2447,33700,yV6W6ti9iteibLzORPGN81YSNOwkANex,3VkHkmOtom3jM2wCu94xgzzu1d6Dn7or,62,117,41,84,33,49,18,7,349,49.857142857142854,5,0.0,47,41,80,33,70,49,4,18,7,201,148,0
2448,33752,0dTl0LLZb3MVQ7vvfkoX3uGGuSQCYhar,3VkHkmOtom3jM2wCu94xgzzu1d6Dn7or,14,21,7,5,4,10,17,1,65,9.285714285714286,4,0.0,3,7,5,4,18,10,0,17,1,19,46,1
2449,33760,tE4cEuVnCai6lb5MdLPjaUrc5lKnLVvQ,3VkHkmOtom3jM2wCu94xgzzu1d6Dn7or,1,0,0,0,0,0,1,0,1,0.14285714285714285,1,0.0,0,0,0,0,0,0,0,1,0,0,1,1
2450,33773,J4whR4tkRWNAuZ9757rGCsnluTOT401Y,3VkHkmOtom3jM2wCu94xgzzu1d6Dn7or,37,109,12,30,2,29,23,0,205,29.285714285714285,10,0.0,22,12,27,2,87,29,3,23,0,63,142,1
2451,33785,1trLCbUNcACEunTz0t0oqSGDB2hHghrr,3VkHkmOtom3jM2wCu94xgzzu1d6Dn7or,8,4,2,0,2,0,8,0,16,2.2857142857142856,4,0.0,0,2,0,2,4,0,0,8,0,4,12,1
2452,33786,P40TML0Cj710JXp6r41PtP7rRZ3kVuFi,3VkHkmOtom3jM2wCu94xgzzu1d6Dn7or,18,8,6,0,6,0,5,1,26,3.7142857142857144,1,0.0,0,6,0,6,8,0,0,5,1,12,14,1
2453,33803,aG8ttlucm14QtDBG2VgxntPklOeFs1gE,3VkHkmOtom3jM2wCu94xgzzu1d6Dn7or,6,6,3,0,2,0,7,0,18,2.5714285714285716,3,0.0,0,3,0,2,6,0,0,7,0,5,13,1
2454,33827,JwxDSGDMUrTarMpmqBus8e9KlkFbHAHz,3VkHkmOtom3jM2wCu94xgzzu1d6Dn7or,9,15,4,0,6,1,4,1,31,4.428571428571429,1,0.0,9,4,0,6,6,1,0,4,1,19,12,1
2455,33847,cRQPwEYCK3Iw8dKAOD2ODiUgaKZ6yPed,3VkHkmOtom3jM2wCu94xgzzu1d6Dn7or,92,361,234,66,113,132,116,0,1022,146.0,27,0.0,91,234,57,113,270,132,9,116,0,495,527,0
2456,33872,TOnSUH2TrhmaSVJBIvM0e6QZcFDQqMZg,3VkHkmOtom3jM2wCu94xgzzu1d6Dn7or,98,323,115,82,109,7,41,10,687,98.14285714285714,7,0.0,175,115,76,109,148,7,6,41,10,475,212,0
2457,33897,RdOt9G6BQbLDtyywMd9fuLxHBkYZbtki,3VkHkmOtom3jM2wCu94xgzzu1d6Dn7or,64,165,72,86,51,37,38,3,452,64.57142857142857,8,0.0,67,72,79,51,98,37,7,38,3,269,183,0
2458,33913,1tfsR5YpJJKMYzdzEoMQ5vXhGsyOBHv0,3VkHkmOtom3jM2wCu94xgzzu1d6Dn7or,4,2,1,0,0,0,2,0,5,0.7142857142857143,1,0.0,0,1,0,0,2,0,0,2,0,1,4,1
2459,33933,hKHwB5Ua0oZcH6SWtFD6GIJQ1tetaoy8,3VkHkmOtom3jM2wCu94xgzzu1d6Dn7or,1,0,0,0,0,0,1,0,1,0.14285714285714285,1,0.0,0,0,0,0,0,0,0,1,0,0,1,1
2460,33934,d52ubpamv7QMs8mm7IKIC7ljhLEjmM3C,3VkHkmOtom3jM2wCu94xgzzu1d6Dn7or,33,80,25,0,16,0,15,0,136,19.428571428571427,6,0.0,0,25,0,16,80,0,0,15,0,41,95,1
2461,33935,Q1L6yAmi2pDCMncureBVjhppMB4OEbbX,3VkHkmOtom3jM2wCu94xgzzu1d6Dn7or,6,2,1,0,1,0,4,0,8,1.1428571428571428,1,0.0,0,1,0,1,2,0,0,4,0,2,6,1
2462,33974,42ykOxe70TRWblI6iCj0oJuIEYjcC8gM,3VkHkmOtom3jM2wCu94xgzzu1d6Dn7or,8,6,4,0,2,0,3,0,15,2.142857142857143,1,0.0,0,4,0,2,6,0,0,3,0,6,9,1
2463,33993,TF3UgiPnTRWimxx4aiWwai5XZkwp6qeG,3VkHkmOtom3jM2wCu94xgzzu1d6Dn7or,15,17,1,7,8,15,3,0,51,7.285714285714286,2,0.0,5,1,7,8,12,15,0,3,0,21,30,0
2464,34001,Q7Qbz0qw7RUQ817YEnRs9pRbpqGVwfCR,3VkHkmOtom3jM2wCu94xgzzu1d6Dn7or,17,42,13,0,0,0,4,0,59,8.428571428571429,3,0.0,0,13,0,0,42,0,0,4,0,13,46,1
2465,34004,mZc1V3rQTRH4oqK1zqSjimuZcPwomnsE,3VkHkmOtom3jM2wCu94xgzzu1d6Dn7or,45,90,40,66,0,18,34,1,249,35.57142857142857,8,0.0,32,40,63,0,58,18,3,34,1,135,114,0
2466,34007,ppoYKBfzaZTEyRRZ2EFxbUFzuyYD53DX,3VkHkmOtom3jM2wCu94xgzzu1d6Dn7or,63,97,38,28,26,42,32,2,265,37.857142857142854,6,0.0,38,38,26,26,59,42,2,32,2,128,137,0
2467,34024,OrtyhCDDCP3mJf5PTiCeln3hXQ7NIFcu,3VkHkmOtom3jM2wCu94xgzzu1d6Dn7or,12,34,14,7,9,9,6,0,79,11.285714285714286,3,0.0,11,14,6,9,23,9,1,6,0,40,39,1
2468,34027,XMC2XTYUqeuq7FqObX1ZI9NtOAkZI4qO,3VkHkmOtom3jM2wCu94xgzzu1d6Dn7or,1,0,0,0,0,0,1,0,1,0.14285714285714285,1,0.0,0,0,0,0,0,0,0,1,0,0,1,1
2469,34029,v68e5yKpgFiV39WDLIk3uKnkjuIxy9L1,3VkHkmOtom3jM2wCu94xgzzu1d6Dn7or,5,5,1,0,0,5,5,0,16,2.2857142857142856,1,0.0,3,1,0,0,2,5,0,5,0,4,12,1
2470,34045,Un9abrC617pqXK03UcjNr06Q8BdWn1dw,3VkHkmOtom3jM2wCu94xgzzu1d6Dn7or,4,4,1,0,0,0,2,0,7,1.0,1,0.0,0,1,0,0,4,0,0,2,0,1,6,1
2471,34048,VSqFiZJe6nAI2fcYQtLAxfgBk9qQ2XsB,3VkHkmOtom3jM2wCu94xgzzu1d6Dn7or,21,40,15,6,13,6,10,1,91,13.0,5,0.0,19,15,5,13,21,6,1,10,1,52,39,1
2472,34085,MQo37Q7W53DPZY2uFLJ08Sd1IlxyeeTy,3VkHkmOtom3jM2wCu94xgzzu1d6Dn7or,1,0,0,0,0,0,1,0,1,0.14285714285714285,1,0.0,0,0,0,0,0,0,0,1,0,0,1,1
2473,34101,SSUeBykJVUVNcYfOVb1xjMpw6wv8mrp4,3VkHkmOtom3jM2wCu94xgzzu1d6Dn7or,73,180,76,37,65,51,29,2,440,62.857142857142854,12,0.0,78,76,33,65,102,51,4,29,2,252,188,0
2474,34110,pifsEWGhALZhemzvj5eCBJDGPeKCqQys,3VkHkmOtom3jM2wCu94xgzzu1d6Dn7or,8,8,2,0,2,0,3,0,15,2.142857142857143,1,0.0,3,2,0,2,5,0,0,3,0,7,8,1
2475,34117,MgAVtl0Q9ZOnv69oO68f2as9w9Cw4pmF,3VkHkmOtom3jM2wCu94xgzzu1d6Dn7or,8,3,2,0,2,7,75,2,91,13.0,3,0.0,0,2,0,2,3,7,0,75,2,4,87,1
2476,34142,7caFhJ8HzCwqK1VfCSEo1EsScanrr6KP,3VkHkmOtom3jM2wCu94xgzzu1d6Dn7or,3,0,0,0,0,0,4,0,4,0.5714285714285714,1,0.0,0,0,0,0,0,0,0,4,0,0,4,1
2477,34167,1YxknoiTrSwQgclDlSAh4oMYHRyARhLv,3VkHkmOtom3jM2wCu94xgzzu1d6Dn7or,64,130,48,38,49,1,19,0,285,40.714285714285715,12,0.0,65,48,37,49,65,1,1,19,0,199,86,0
2478,34178,c4K8IuSRoyINLIWfzBS4l7qo5Oy1ef2X,3VkHkmOtom3jM2wCu94xgzzu1d6Dn7or,16,40,12,13,13,0,8,0,86,12.285714285714286,3,0.0,22,12,12,13,18,0,1,8,0,59,27,1
2479,34182,g3902agYIRHzac78MKVZlvljLMXXNpQ7,3VkHkmOtom3jM2wCu94xgzzu1d6Dn7or,86,331,111,114,113,36,36,1,742,106.0,14,0.0,166,111,108,113,165,36,6,36,1,498,244,0
2480,34207,Klx5HdUU5w9K3aSMJI03hrppJHSCa3R7,3VkHkmOtom3jM2wCu94xgzzu1d6Dn7or,4,2,1,0,0,0,2,0,5,0.7142857142857143,1,0.0,0,1,0,0,2,0,0,2,0,1,4,1
2481,34220,xpYNYgZQGa68GsnLqOUXASZMKJZ8lmG8,3VkHkmOtom3jM2wCu94xgzzu1d6Dn7or,6,3,1,0,1,3,6,0,14,2.0,2,0.0,1,1,0,1,2,3,0,6,0,3,11,1
2482,34245,xpAxjSreQEJGjM28FJsQcyiEt1VA8RXl,3VkHkmOtom3jM2wCu94xgzzu1d6Dn7or,91,247,90,131,59,5,25,0,557,79.57142857142857,16,0.0,45,90,120,59,202,5,11,25,0,314,243,0
2483,34261,bFfXTYik4aYWFfWUWdoOiuwD6nQmMZRw,3VkHkmOtom3jM2wCu94xgzzu1d6Dn7or,1,0,0,0,0,0,1,0,1,0.14285714285714285,1,0.0,0,0,0,0,0,0,0,1,0,0,1,1
2484,34265,5IgVvEPNH3bWuZlCdfNUhcppaJrh3aHd,3VkHkmOtom3jM2wCu94xgzzu1d6Dn7or,35,83,38,43,24,47,18,4,257,36.714285714285715,5,0.0,36,38,38,24,47,47,5,18,4,136,121,0
2485,34273,qSJaX4YJW8hRJDxnEVmivIyE1mLAQ8wD,3VkHkmOtom3jM2wCu94xgzzu1d6Dn7or,63,182,8,49,66,3,24,0,332,47.42857142857143,11,0.0,118,8,45,66,64,3,4,24,0,237,95,0
2486,34275,SzVahzwggSsKJrf1VkZbtdOT7lI7iLUB,3VkHkmOtom3jM2wCu94xgzzu1d6Dn7or,1,0,0,0,0,0,1,0,1,0.14285714285714285,1,0.0,0,0,0,0,0,0,0,1,0,0,1,0
2487,34306,xOaR7vHN6JVd3REJVPobis6s2LVrwA3I,3VkHkmOtom3jM2wCu94xgzzu1d6Dn7or,13,24,2,13,6,9,10,2,66,9.428571428571429,3,0.0,13,2,9,6,11,9,4,10,2,30,36,0
2488,34315,SryICrzq5kc50IPvq5WetHevyFYu34oy,3VkHkmOtom3jM2wCu94xgzzu1d6Dn7or,55,111,37,38,44,5,13,1,249,35.57142857142857,7,0.0,56,37,35,44,55,5,3,13,1,172,77,0
2489,34318,ujKaaUNEqqptCLwGF9Jue70qMPvrOLJo,3VkHkmOtom3jM2wCu94xgzzu1d6Dn7or,65,139,71,37,61,29,10,0,347,49.57142857142857,8,0.0,46,71,35,61,93,29,2,10,0,213,134,0
2490,34356,KeLznPI7itN5EyBP1W6I1lcrHKbQfFai,3VkHkmOtom3jM2wCu94xgzzu1d6Dn7or,3,2,1,0,0,0,1,0,4,0.5714285714285714,1,0.0,0,1,0,0,2,0,0,1,0,1,3,0
2491,34357,XwU6wUI3MC8It5xOE3JsHNSE33ZEcZ8a,3VkHkmOtom3jM2wCu94xgzzu1d6Dn7or,1,0,0,0,0,0,1,0,1,0.14285714285714285,1,0.0,0,0,0,0,0,0,0,1,0,0,1,1
2492,34372,HEvbYdzPT1RdOQkeFBGzM5dG2vT688KF,3VkHkmOtom3jM2wCu94xgzzu1d6Dn7or,7,4,1,0,1,6,6,1,19,2.7142857142857144,3,0.0,0,1,0,1,4,6,0,6,1,2,17,1
2493,34425,eLqag6twmL6nT6SLVrpY07QGG3bytKwe,3VkHkmOtom3jM2wCu94xgzzu1d6Dn7or,63,132,67,26,54,19,22,0,320,45.714285714285715,7,0.0,42,67,25,54,90,19,1,22,0,188,132,0
2494,34427,Aewl2bukzaR3iOy5Mq949jen8SFdB5jq,3VkHkmOtom3jM2wCu94xgzzu1d6Dn7or,1,0,0,0,0,0,2,0,2,0.2857142857142857,1,0.0,0,0,0,0,0,0,0,2,0,0,2,1
2495,34456,CAXYMnI26CJKVZLm27KWhrQ5wZxlWBLx,3VkHkmOtom3jM2wCu94xgzzu1d6Dn7or,7,4,2,0,1,0,3,1,11,1.5714285714285714,1,0.0,0,2,0,1,4,0,0,3,1,3,8,0
2496,34457,a9c4te5q0ehojVccJ2P6whngcQZuQQCX,3VkHkmOtom3jM2wCu94xgzzu1d6Dn7or,42,43,24,0,23,5,11,1,107,15.285714285714286,4,0.0,12,24,0,23,31,5,0,11,1,59,48,1
2497,34463,o8HgCfDb4fBDcx1CsrkAibT0nuxbHTlk,3VkHkmOtom3jM2wCu94xgzzu1d6Dn7or,90,395,123,141,75,62,21,2,819,117.0,11,0.0,127,123,121,75,268,62,20,21,2,446,373,0
2498,34488,GleyV2QgGRzVvYTAp5V2b6ZBaZiURmcd,3VkHkmOtom3jM2wCu94xgzzu1d6Dn7or,1,0,0,0,0,0,1,0,1,0.14285714285714285,1,0.0,0,0,0,0,0,0,0,1,0,0,1,1
2499,34492,GvdqbnM3UIaJ0BFHcHdO9ouTWJGUBtrO,3VkHkmOtom3jM2wCu94xgzzu1d6Dn7or,1,0,0,0,0,0,1,0,1,0.14285714285714285,1,0.0,0,0,0,0,0,0,0,1,0,0,1,1
2500,34495,iXEJ1rfu68zDKDu3FiFKj2kPpqtT5dfz,3VkHkmOtom3jM2wCu94xgzzu1d6Dn7or,29,35,16,0,18,1,11,0,81,11.571428571428571,5,0.0,4,16,0,18,31,1,0,11,0,38,43,1
2501,34504,w2YhBdSobFVOK94JfPRbRKRIarjDjij1,3VkHkmOtom3jM2wCu94xgzzu1d6Dn7or,18,23,14,0,11,0,8,1,57,8.142857142857142,4,0.0,0,14,0,11,23,0,0,8,1,25,32,1
2502,34543,anLYgmC8Wl5xU9kyyzDNYloR1lWVeUQv,3VkHkmOtom3jM2wCu94xgzzu1d6Dn7or,9,17,2,0,0,0,13,0,32,4.571428571428571,5,0.0,0,2,0,0,17,0,0,13,0,2,30,1
2503,34578,siw3z9CF4q7PdqdWdVvFDzTmHm8ZHf2L,3VkHkmOtom3jM2wCu94xgzzu1d6Dn7or,9,15,0,0,2,0,1,0,18,2.5714285714285716,1,0.0,0,0,0,2,15,0,0,1,0,2,16,1
2504,34609,lMzjP7MH4M4HD40rmmb72GIa6BNuIxvn,5X6FeZozNMgE2VRi3MJYjkkFK8SETtu2,4,0,0,0,0,2,3,0,5,0.7142857142857143,1,0.0,0,0,0,0,0,2,0,3,0,0,5,1
2505,34615,tEGUB4A2P1CFVrtUpVRZCuET3K7QndSr,5X6FeZozNMgE2VRi3MJYjkkFK8SETtu2,9,5,3,0,2,0,13,0,23,3.2857142857142856,3,0.0,0,3,0,2,5,0,0,13,0,5,18,1
2506,34645,3HOnjRDe3XaKpyhDvtGYWIvTQ5R0B6U5,5X6FeZozNMgE2VRi3MJYjkkFK8SETtu2,26,34,10,16,13,43,17,0,133,19.0,4,0.0,17,10,16,13,17,43,0,17,0,56,77,0
2507,34656,96DCfuOrgGXPJxvBhf7d6yZw2He2dVFd,5X6FeZozNMgE2VRi3MJYjkkFK8SETtu2,45,47,9,103,21,0,4,0,184,26.285714285714285,3,0.0,30,9,90,21,17,0,13,4,0,150,34,0
2508,34719,42bX0uPWOXgBHMwF4wqdnl1Ve6wIHNQe,7GRhBDsirIGkRZBtSMEzNTyDr2JQm4xx,5,5,2,0,1,0,2,0,10,1.4285714285714286,2,0.0,0,2,0,1,5,0,0,2,0,3,7,1
2509,34730,WcgPk0seMETQ32XVB6Y924ThrGFZxSCx,5X6FeZozNMgE2VRi3MJYjkkFK8SETtu2,1,0,0,0,0,0,1,0,1,0.14285714285714285,1,0.0,0,0,0,0,0,0,0,1,0,0,1,1
2510,34800,z3YnX73v2uoVHmuLGzQD2gKKBoJqIQxK,5X6FeZozNMgE2VRi3MJYjkkFK8SETtu2,1,0,0,0,0,0,1,0,1,0.14285714285714285,1,0.0,0,0,0,0,0,0,0,1,0,0,1,1
2511,34826,lLBYRG2vdmBMEjzgv1Hsiz1uNkClKMP0,5X6FeZozNMgE2VRi3MJYjkkFK8SETtu2,1,0,0,0,0,0,1,0,1,0.14285714285714285,1,0.0,0,0,0,0,0,0,0,1,0,0,1,1
2512,34895,TPjv2mgvzs8mtuY7ccAmTpwjgR5agCrX,7GRhBDsirIGkRZBtSMEzNTyDr2JQm4xx,1,0,0,0,0,0,1,0,1,0.14285714285714285,1,0.0,0,0,0,0,0,0,0,1,0,0,1,1
2513,34898,TPjv2mgvzs8mtuY7ccAmTpwjgR5agCrX,5X6FeZozNMgE2VRi3MJYjkkFK8SETtu2,3,0,0,0,0,0,3,0,3,0.42857142857142855,2,0.0,0,0,0,0,0,0,0,3,0,0,3,1
2514,34934,TBQoOvuDjEMUZC2QrWY1HB9UlRprbpL5,5X6FeZozNMgE2VRi3MJYjkkFK8SETtu2,1,0,0,0,0,0,2,0,2,0.2857142857142857,1,0.0,0,0,0,0,0,0,0,2,0,0,2,1
2515,34989,qmZrNo1r3Io6ipmYGSgj6k432hR7Tw4I,5X6FeZozNMgE2VRi3MJYjkkFK8SETtu2,4,4,0,0,0,0,2,0,6,0.8571428571428571,2,0.0,0,0,0,0,4,0,0,2,0,0,6,1
2516,34993,sBJaEGuTXbNCvVTwGa7sLLN4Vc6pwdKX,5X6FeZozNMgE2VRi3MJYjkkFK8SETtu2,27,41,3,0,20,0,4,0,68,9.714285714285714,3,0.0,30,3,0,20,11,0,0,4,0,53,15,0
2517,34995,C4q4gNQYEpjKh7pq1qjN8i3L7uSpUX9d,5X6FeZozNMgE2VRi3MJYjkkFK8SETtu2,102,296,73,74,111,1,20,1,576,82.28571428571429,5,0.0,94,73,61,111,202,1,13,20,1,339,237,0
2518,35001,mnSBt3sRNyrZ7VUOLiaw67uN9cm7o4kN,5X6FeZozNMgE2VRi3MJYjkkFK8SETtu2,1,0,0,0,0,0,1,0,1,0.14285714285714285,1,0.0,0,0,0,0,0,0,0,1,0,0,1,1
2519,35004,QQPVMA2jHWo7dIPXsvoAxaE7MsGRZAyE,5X6FeZozNMgE2VRi3MJYjkkFK8SETtu2,10,10,5,2,5,0,3,0,25,3.5714285714285716,3,0.0,2,5,2,5,8,0,0,3,0,14,11,0
2520,35056,Az35wHR97uuRkRSgT8BjE6DkhH91OHMF,7GRhBDsirIGkRZBtSMEzNTyDr2JQm4xx,1,0,0,0,0,0,1,0,1,0.14285714285714285,1,0.0,0,0,0,0,0,0,0,1,0,0,1,1
2521,35150,AvQhWM9grultmx48matDmWO7LLNb13dd,7GRhBDsirIGkRZBtSMEzNTyDr2JQm4xx,55,51,23,44,20,0,0,0,138,19.714285714285715,3,0.0,24,23,23,20,27,0,21,0,0,90,48,0
2522,35152,VsfU7jeSb2K8k0CBzCZzXJjDlMye1sB1,7GRhBDsirIGkRZBtSMEzNTyDr2JQm4xx,9,14,10,0,1,0,2,0,27,3.857142857142857,1,0.0,2,10,0,1,12,0,0,2,0,13,14,1
2523,35154,6TeNHmnZsy2QqeLuJegGqbjbPJMrX0FT,7GRhBDsirIGkRZBtSMEzNTyDr2JQm4xx,5,2,1,0,1,0,2,0,6,0.8571428571428571,1,0.0,0,1,0,1,2,0,0,2,0,2,4,1
2524,35159,dJJJLtI6F18pblO9KPkBPg9ZKTgQPaQc,7GRhBDsirIGkRZBtSMEzNTyDr2JQm4xx,30,38,1,33,12,0,2,0,86,12.285714285714286,2,0.0,17,1,27,12,21,0,6,2,0,57,29,0
2525,35160,kThSxP6kRJAiUPqrS6DypsJwuP8aoEPr,7GRhBDsirIGkRZBtSMEzNTyDr2JQm4xx,70,110,5,104,19,12,9,0,259,37.0,4,0.0,59,5,77,19,51,12,27,9,0,160,99,0
2526,35167,eU4MPF9R01ru4sQN9giW756pdpNlnW4H,7GRhBDsirIGkRZBtSMEzNTyDr2JQm4xx,3,4,2,0,0,0,2,0,8,1.1428571428571428,2,0.0,0,2,0,0,4,0,0,2,0,2,6,0
2527,35186,U04y5vFf0AfyJVGIOJHlryTyRQEOm5pT,5X6FeZozNMgE2VRi3MJYjkkFK8SETtu2,1,0,0,0,0,0,1,0,1,0.14285714285714285,1,0.0,0,0,0,0,0,0,0,1,0,0,1,0
2528,35215,eHvQ2U78p4YZsMgDMMDOOzYAdsqzih5K,5X6FeZozNMgE2VRi3MJYjkkFK8SETtu2,63,85,27,96,31,0,14,0,253,36.142857142857146,9,0.0,43,27,81,31,42,0,15,14,0,182,71,0
2529,35217,dTAykGxHxBqhi6OOd2NdEVRbLFHmTDWA,3VkHkmOtom3jM2wCu94xgzzu1d6Dn7or,6,4,2,0,2,0,3,0,11,1.5714285714285714,2,0.0,0,2,0,2,4,0,0,3,0,4,7,0
2530,35228,ShVY9aayOUs09f1eB0mroPylkADk2z6V,3VkHkmOtom3jM2wCu94xgzzu1d6Dn7or,13,4,4,0,3,0,9,2,22,3.142857142857143,2,0.0,0,4,0,3,4,0,0,9,2,7,15,1
2531,35229,YoDWB1JrmjjQfwRmPIoZFLCY9OTc0qY0,3VkHkmOtom3jM2wCu94xgzzu1d6Dn7or,28,49,19,21,20,19,10,0,138,19.714285714285715,4,0.0,21,19,21,20,28,19,0,10,0,81,57,1
2532,35230,3osqmyLTd0Yp2c4v5JzVTM7F74YzCdVT,3VkHkmOtom3jM2wCu94xgzzu1d6Dn7or,5,6,0,0,0,0,3,0,9,1.2857142857142858,1,0.0,0,0,0,0,6,0,0,3,0,0,9,1
2533,35231,aH50QjMw20jmR2a1SZ5ABNp5kUNFVZvb,3VkHkmOtom3jM2wCu94xgzzu1d6Dn7or,16,36,17,7,15,23,17,3,118,16.857142857142858,4,0.0,9,17,6,15,27,23,1,17,3,47,71,0
2534,35234,o9XCzfAWmkIZ4BcT96IkBMU2AsqEbNit,3VkHkmOtom3jM2wCu94xgzzu1d6Dn7or,26,126,31,32,20,23,17,0,249,35.57142857142857,7,0.0,56,31,29,20,70,23,3,17,0,136,113,0
2535,35239,tT6Sirn09KWiMo3tT1T33g39PgakkrEp,3VkHkmOtom3jM2wCu94xgzzu1d6Dn7or,79,126,72,45,58,8,30,3,342,48.857142857142854,10,0.0,33,72,41,58,93,8,4,30,3,204,138,0
2536,35241,NXyco71N78GkVfHnZsK8R307XzQzXNS1,3VkHkmOtom3jM2wCu94xgzzu1d6Dn7or,44,37,25,0,23,0,11,14,110,15.714285714285714,3,0.0,0,25,0,23,37,0,0,11,14,48,62,0
2537,35249,4aioHONa4uZzCKqGB12iuN523tylzUg4,3VkHkmOtom3jM2wCu94xgzzu1d6Dn7or,20,41,15,11,13,11,17,2,110,15.714285714285714,4,0.0,19,15,8,13,22,11,3,17,2,55,55,1
2538,35254,YfgudDVIeAr4vxyA9CRnVu6z6irXBYtG,3VkHkmOtom3jM2wCu94xgzzu1d6Dn7or,6,13,0,1,0,0,3,0,17,2.4285714285714284,4,0.0,1,0,1,0,12,0,0,3,0,2,15,1
2539,35257,4NR9J7NrWx9P8bFiOFbZEGtYIezzdGum,3VkHkmOtom3jM2wCu94xgzzu1d6Dn7or,79,175,58,50,78,2,7,4,374,53.42857142857143,4,0.0,109,58,42,78,66,2,8,7,4,287,87,0
2540,35261,ngsfhvUZUNnvQAEsXLmgPW2GFFZa3MUi,3VkHkmOtom3jM2wCu94xgzzu1d6Dn7or,20,30,11,5,12,16,11,0,85,12.142857142857142,3,0.0,9,11,5,12,21,16,0,11,0,37,48,1
2541,35267,tQFg4iseBORT6klS4i4ACWpNPhj1B9fa,3VkHkmOtom3jM2wCu94xgzzu1d6Dn7or,68,214,52,112,69,47,32,12,538,76.85714285714286,9,0.0,139,52,94,69,75,47,18,32,12,354,184,0
2542,35273,5o8Q8umISViuVbGmQVw8WnHF5Hfov9C3,3VkHkmOtom3jM2wCu94xgzzu1d6Dn7or,8,4,3,0,3,0,2,0,12,1.7142857142857142,2,0.0,0,3,0,3,4,0,0,2,0,6,6,1
2543,35275,mcSjHTQSOL9z6LfIHOZuth326lgoEoEd,3VkHkmOtom3jM2wCu94xgzzu1d6Dn7or,97,281,149,58,82,107,76,15,768,109.71428571428571,17,0.0,81,149,51,82,200,107,7,76,15,363,405,0
2544,35277,0NGmnEa8Aw1COy6QcVu1sb3DgBWk4plX,3VkHkmOtom3jM2wCu94xgzzu1d6Dn7or,67,373,83,150,142,24,50,3,825,117.85714285714286,8,0.0,248,83,142,142,125,24,8,50,3,615,210,0
2545,35280,oNf6qoW6E6dhoPJKSUjvElFlUKN9drLY,3VkHkmOtom3jM2wCu94xgzzu1d6Dn7or,80,155,76,52,55,24,62,3,427,61.0,8,0.0,45,76,51,55,110,24,1,62,3,227,200,0
2546,35286,DrwrBJqLuYoEmUm9z0KkD7rguSMjAzWZ,3VkHkmOtom3jM2wCu94xgzzu1d6Dn7or,4,5,1,0,0,0,3,0,9,1.2857142857142858,2,0.0,0,1,0,0,5,0,0,3,0,1,8,1
2547,35287,P4gIdHzF607L8e8VPH3Qb09lxgNZRJFa,3VkHkmOtom3jM2wCu94xgzzu1d6Dn7or,1,0,0,0,0,0,1,0,1,0.14285714285714285,1,0.0,0,0,0,0,0,0,0,1,0,0,1,1
2548,35304,OdutB2jwjn089D8EX2NAa3HnsFlikWQS,3VkHkmOtom3jM2wCu94xgzzu1d6Dn7or,23,39,24,0,13,0,19,0,95,13.571428571428571,10,0.0,0,24,0,13,39,0,0,19,0,37,58,1
2549,35305,N8IkPNWNai85jUxrrS9Z8EKzSnbszoPc,3VkHkmOtom3jM2wCu94xgzzu1d6Dn7or,38,48,19,22,15,19,8,0,131,18.714285714285715,6,0.0,16,19,20,15,32,19,2,8,0,70,61,0
2550,35308,g5cfvDvYqz1BC4LMGanzPaVPPBmwbapa,3VkHkmOtom3jM2wCu94xgzzu1d6Dn7or,88,176,59,64,78,14,27,1,419,59.857142857142854,10,0.0,97,59,58,78,79,14,6,27,1,292,127,0
2551,35312,Cl2kLzysgIaawouYP7ePYzkUue0vbAKM,3VkHkmOtom3jM2wCu94xgzzu1d6Dn7or,25,62,33,11,26,15,14,0,161,23.0,6,0.0,13,33,9,26,49,15,2,14,0,81,80,1
2552,35313,L1tmKgDPd0CzZGUi5x679NwUxuPXvaQW,3VkHkmOtom3jM2wCu94xgzzu1d6Dn7or,32,62,19,36,18,7,15,3,160,22.857142857142858,3,0.0,31,19,29,18,31,7,7,15,3,97,63,1
2553,35314,yc36c48wR0POl6aC6ZETCkJX90G6m6sl,3VkHkmOtom3jM2wCu94xgzzu1d6Dn7or,8,6,3,0,1,1,12,4,27,3.857142857142857,2,0.0,0,3,0,1,6,1,0,12,4,4,23,1
2554,35315,5t5QGGXf5uyIR6qWbr2N0KwpICB31qlV,3VkHkmOtom3jM2wCu94xgzzu1d6Dn7or,19,39,9,13,12,11,32,0,116,16.571428571428573,6,0.0,23,9,11,12,16,11,2,32,0,55,61,1
2555,35316,XzOYwpWjfyeCP837S63vDxFLmus8lP1p,3VkHkmOtom3jM2wCu94xgzzu1d6Dn7or,8,5,1,0,0,0,9,1,16,2.2857142857142856,1,0.0,0,1,0,0,5,0,0,9,1,1,15,1
2556,35320,BCPOhUa2LrfH93ebCE15VbF0VEWEyi7T,3VkHkmOtom3jM2wCu94xgzzu1d6Dn7or,80,146,64,51,59,5,41,0,366,52.285714285714285,10,0.0,56,64,48,59,90,5,3,41,0,227,139,0
2557,35326,LkaPh804PmEVlFyujBcIEugyeaRT3JCb,3VkHkmOtom3jM2wCu94xgzzu1d6Dn7or,1,0,0,0,0,0,1,0,1,0.14285714285714285,1,0.0,0,0,0,0,0,0,0,1,0,0,1,1
2558,35331,1u5RJ3ohzI9I8TYHEG8zy2n2QjuVVCRw,3VkHkmOtom3jM2wCu94xgzzu1d6Dn7or,74,277,86,52,59,24,27,1,526,75.14285714285714,5,0.0,72,86,47,59,205,24,5,27,1,264,262,0
2559,35337,RPQvIQfjeayIRS4PyDyrIytbJ9ZHNktA,3VkHkmOtom3jM2wCu94xgzzu1d6Dn7or,97,245,119,33,83,24,54,1,559,79.85714285714286,12,0.0,83,119,33,83,162,24,0,54,1,318,241,0
2560,35340,3F7yaep2FwWAK3l9S0HNjlUpCGuAAcmV,3VkHkmOtom3jM2wCu94xgzzu1d6Dn7or,19,43,18,7,9,1,25,1,104,14.857142857142858,3,0.0,14,18,7,9,29,1,0,25,1,48,56,1
2561,35346,IV6SMIJFVvUc1UCBOIaNbH0gLmOB3YMb,3VkHkmOtom3jM2wCu94xgzzu1d6Dn7or,55,149,2,41,13,1,26,0,232,33.142857142857146,7,0.0,48,2,37,13,101,1,4,26,0,100,132,0
2562,35350,MMTprU0LIvxVqomHdkVRSYImuPQi51Ne,3VkHkmOtom3jM2wCu94xgzzu1d6Dn7or,60,229,49,41,35,15,41,1,411,58.714285714285715,6,0.0,83,49,38,35,146,15,3,41,1,205,206,0
2563,35351,J5m6FPwEGmu5Gn7wOSGcO1Ej5dLfRCw9,3VkHkmOtom3jM2wCu94xgzzu1d6Dn7or,7,5,3,0,2,0,6,0,16,2.2857142857142856,2,0.0,0,3,0,2,5,0,0,6,0,5,11,1
2564,35353,90w1qbnQuEy9DPjkJdcTy8Ku3weZPxFV,3VkHkmOtom3jM2wCu94xgzzu1d6Dn7or,1,0,0,0,0,0,1,0,1,0.14285714285714285,1,0.0,0,0,0,0,0,0,0,1,0,0,1,1
2565,35354,rxDS79E98XmgSuABxs3b3I1YF80eAjg8,3VkHkmOtom3jM2wCu94xgzzu1d6Dn7or,14,10,6,0,5,0,7,0,28,4.0,1,0.0,0,6,0,5,10,0,0,7,0,11,17,1
2566,35359,6kMrJmwcqFNgfzFT3CJTdPq2HO5oFeTe,3VkHkmOtom3jM2wCu94xgzzu1d6Dn7or,78,399,65,112,62,66,32,3,739,105.57142857142857,12,0.0,189,65,103,62,210,66,9,32,3,419,320,1
2567,35360,T8TKNQciNYxyZa02JNR1WAwQ2Y5qXjum,3VkHkmOtom3jM2wCu94xgzzu1d6Dn7or,63,73,28,24,26,7,27,3,188,26.857142857142858,6,0.0,35,28,24,26,38,7,0,27,3,113,75,0
2568,35361,5EJnob1OMXiBHOO6bo7nkQouLkltGzGu,3VkHkmOtom3jM2wCu94xgzzu1d6Dn7or,1,0,0,0,0,0,2,0,2,0.2857142857142857,1,0.0,0,0,0,0,0,0,0,2,0,0,2,1
2569,35363,omynTyB0op2S6N0LZFfMkyOx2iQXr4PS,3VkHkmOtom3jM2wCu94xgzzu1d6Dn7or,31,32,24,0,19,0,6,0,81,11.571428571428571,4,0.0,0,24,0,19,32,0,0,6,0,43,38,0
2570,35369,YM3x5XH5tmfdGcWwsvjAdikPkIR3zAmm,3VkHkmOtom3jM2wCu94xgzzu1d6Dn7or,65,153,68,90,54,8,37,9,419,59.857142857142854,7,0.0,50,68,85,54,103,8,5,37,9,257,162,0
2571,35383,hBpRVfYtdybPhgj3MfVukeLOAvCcgIw6,3VkHkmOtom3jM2wCu94xgzzu1d6Dn7or,4,2,1,0,0,0,2,0,5,0.7142857142857143,1,0.0,0,1,0,0,2,0,0,2,0,1,4,1
2572,35384,BE4JaFadHavW9r5xCXpj3M456eZAgaG6,3VkHkmOtom3jM2wCu94xgzzu1d6Dn7or,4,2,1,0,1,0,1,0,5,0.7142857142857143,1,0.0,0,1,0,1,2,0,0,1,0,2,3,1
2573,35386,8fvsCrC8dcOje6DxrGntnTxmufYXJCrq,3VkHkmOtom3jM2wCu94xgzzu1d6Dn7or,12,41,12,6,4,26,20,0,109,15.571428571428571,6,0.0,9,12,5,4,32,26,1,20,0,30,79,1
2574,35388,ngy9FDiYXpc4c01p0sFczM8viAh3TUDK,3VkHkmOtom3jM2wCu94xgzzu1d6Dn7or,11,10,6,0,4,1,5,0,26,3.7142857142857144,2,0.0,1,6,0,4,9,1,0,5,0,11,15,1
2575,35390,s1zoJG6TsTv8LP9PRWCYbeiv4OLIivpy,3VkHkmOtom3jM2wCu94xgzzu1d6Dn7or,10,20,11,0,5,0,8,0,44,6.285714285714286,9,0.0,0,11,0,5,20,0,0,8,0,16,28,1
2576,35391,jE0dkbFs2fRzdAygi15t1sbkEYmvUbtw,3VkHkmOtom3jM2wCu94xgzzu1d6Dn7or,6,9,3,0,2,0,3,0,17,2.4285714285714284,2,0.0,2,3,0,2,7,0,0,3,0,7,10,1
2577,35394,GcQtcb2ioSzefdF875SDqaLTsuxZvpji,3VkHkmOtom3jM2wCu94xgzzu1d6Dn7or,56,89,74,0,56,5,21,2,247,35.285714285714285,11,0.0,0,74,0,56,89,5,0,21,2,130,117,0
2578,35397,NZRigOdbBm5L1F5X34hgYO92Vp7JjaX3,3VkHkmOtom3jM2wCu94xgzzu1d6Dn7or,1,0,0,0,0,0,1,0,1,0.14285714285714285,1,0.0,0,0,0,0,0,0,0,1,0,0,1,1
2579,35401,rhjTu7dlupNEg0KoplRLx0VbktemTt3u,3VkHkmOtom3jM2wCu94xgzzu1d6Dn7or,3,0,0,0,0,0,10,0,10,1.4285714285714286,1,0.0,0,0,0,0,0,0,0,10,0,0,10,1
2580,35403,K9KsptRLWOmP5jrMOI7PEiLIqzyruebX,3VkHkmOtom3jM2wCu94xgzzu1d6Dn7or,1,0,0,0,0,0,1,0,1,0.14285714285714285,1,0.0,0,0,0,0,0,0,0,1,0,0,1,1
2581,35408,hUgWBwzoxTCI0ZG2TscrqK8ctEypKa8f,3VkHkmOtom3jM2wCu94xgzzu1d6Dn7or,1,0,0,0,0,0,1,0,1,0.14285714285714285,1,0.0,0,0,0,0,0,0,0,1,0,0,1,1
2582,35483,OsqZuhMeFHyilvCkRc36i3NA1vApj2oc,7GRhBDsirIGkRZBtSMEzNTyDr2JQm4xx,1,0,0,0,0,0,1,0,1,0.14285714285714285,1,0.0,0,0,0,0,0,0,0,1,0,0,1,1
2583,35537,npUiSf7zpmcI1kxZNOdnRuQUK0hLYnSc,7GRhBDsirIGkRZBtSMEzNTyDr2JQm4xx,2,0,0,0,0,0,2,0,2,0.2857142857142857,1,0.0,0,0,0,0,0,0,0,2,0,0,2,1
2584,35558,hJwtwnOzJaTrAeP4eXJAEwz2xbKsgc4M,7GRhBDsirIGkRZBtSMEzNTyDr2JQm4xx,5,0,0,0,0,0,6,0,6,0.8571428571428571,2,0.0,0,0,0,0,0,0,0,6,0,0,6,1
2585,35583,O36QxtTrV6jSigC0QBjRMiqSpx0KHX6w,7GRhBDsirIGkRZBtSMEzNTyDr2JQm4xx,39,61,26,28,32,1,6,0,154,22.0,1,0.0,31,26,21,32,30,1,7,6,0,110,44,0
2586,35585,OmX2SQBCwRoYrHwcrkvse43BtP3hkWEM,7GRhBDsirIGkRZBtSMEzNTyDr2JQm4xx,6,3,1,0,1,0,2,0,7,1.0,1,0.0,0,1,0,1,3,0,0,2,0,2,5,1
2587,35592,WgQR6nrfyl7yDpgHC595JSoog2R9VhVs,7GRhBDsirIGkRZBtSMEzNTyDr2JQm4xx,38,83,33,30,35,4,13,0,198,28.285714285714285,2,0.0,42,33,24,35,41,4,6,13,0,134,64,0
2588,35594,d6aHeIWZcsirh8eDlHrmG2KrUzDWnJuj,7GRhBDsirIGkRZBtSMEzNTyDr2JQm4xx,10,8,7,2,2,0,1,0,20,2.857142857142857,2,0.0,1,7,1,2,7,0,1,1,0,11,9,1
2589,35644,bzlTCtIUcO5BfACSIQwT3PRYSdK0QGTr,7GRhBDsirIGkRZBtSMEzNTyDr2JQm4xx,7,3,2,0,2,0,2,0,9,1.2857142857142858,1,0.0,0,2,0,2,3,0,0,2,0,4,5,1
2590,35646,CCMzevo14iTCqMsIpKsbx331FhP08gFZ,7GRhBDsirIGkRZBtSMEzNTyDr2JQm4xx,25,19,7,22,5,0,2,0,55,7.857142857142857,1,0.0,9,7,12,5,10,0,10,2,0,33,22,1
2591,35660,I7HvXtiH0SNpu1BcvHuR3QJKpkzrbUYb,7GRhBDsirIGkRZBtSMEzNTyDr2JQm4xx,1,0,0,0,0,0,1,0,1,0.14285714285714285,1,0.0,0,0,0,0,0,0,0,1,0,0,1,1
2592,35661,StY7mIcclc0vcUIJFTvL9RrXxdUXnEhh,7GRhBDsirIGkRZBtSMEzNTyDr2JQm4xx,1,0,0,0,0,0,1,0,1,0.14285714285714285,1,0.0,0,0,0,0,0,0,0,1,0,0,1,1
2593,35726,xHZbSROhwP4RRQerUVWvcNTfOGc2DHWf,7GRhBDsirIGkRZBtSMEzNTyDr2JQm4xx,3,2,1,0,0,0,1,0,4,0.5714285714285714,1,0.0,0,1,0,0,2,0,0,1,0,1,3,1
2594,35740,2Exq2qT4UVjm3V3cO5xfnW6aAT6vUwLB,7GRhBDsirIGkRZBtSMEzNTyDr2JQm4xx,11,13,4,0,1,0,9,0,27,3.857142857142857,2,0.0,0,4,0,1,13,0,0,9,0,5,22,1
2595,35753,aXYyJMDvVYwwKBbiO4CB25XlnDBfWYNg,7GRhBDsirIGkRZBtSMEzNTyDr2JQm4xx,35,44,14,43,10,2,1,0,114,16.285714285714285,2,0.0,28,14,38,10,16,2,5,1,0,90,24,0
2596,35806,b9hN1tjIpM67gB8PuwPQ3u561lqo1V2f,7GRhBDsirIGkRZBtSMEzNTyDr2JQm4xx,7,5,4,0,4,0,2,0,15,2.142857142857143,1,0.0,0,4,0,4,5,0,0,2,0,8,7,1
2597,35817,Kneva8tRfI6BhvgFMe4i80mebf2hEQk0,7GRhBDsirIGkRZBtSMEzNTyDr2JQm4xx,3,1,1,0,1,0,0,0,3,0.42857142857142855,1,0.0,0,1,0,1,1,0,0,0,0,2,1,1
2598,35833,Am2zVb1UB0adRGJ5ZAnKfQVWNzOqucZ5,7GRhBDsirIGkRZBtSMEzNTyDr2JQm4xx,5,2,1,0,1,0,4,0,8,1.1428571428571428,2,0.0,0,1,0,1,2,0,0,4,0,2,6,0
2599,35845,klPtoz7fzAXWyNuTpvNOlHO6ALCwtMKk,7GRhBDsirIGkRZBtSMEzNTyDr2JQm4xx,1,0,0,0,0,0,2,0,2,0.2857142857142857,1,0.0,0,0,0,0,0,0,0,2,0,0,2,1
2600,35868,PeCugnCDRTxTqifK7mkc0ffuLTN5EPRT,7GRhBDsirIGkRZBtSMEzNTyDr2JQm4xx,20,31,11,20,0,0,2,0,64,9.142857142857142,1,0.0,11,11,11,0,20,0,9,2,0,33,31,0
2601,35876,tBcWnrptNiGaZgy4k51BltzcKki801j1,7GRhBDsirIGkRZBtSMEzNTyDr2JQm4xx,1,0,0,0,0,0,1,0,1,0.14285714285714285,1,0.0,0,0,0,0,0,0,0,1,0,0,1,1
2602,37600,NHGmMinB9WoQusKCx50F4M4nJF124Ms4,A3fsA9Zfv1X2fVEQhTw51lKENdNrEqT3,2,0,0,0,0,0,2,0,2,0.2857142857142857,1,0.0,0,0,0,0,0,0,0,2,0,0,2,1
2603,37607,NvmmlHTgNmxqyrQU3a9c6oM8kVrIYu3Q,SpATywNh6bZuzm8s1ceuBUnMUAeoAHHw,7,10,6,0,1,0,2,0,19,2.7142857142857144,1,0.0,0,6,0,1,10,0,0,2,0,7,12,1
2604,37618,ABlVlNkPi30ZMlFLrcsAhP5jZW6rJhdZ,A3fsA9Zfv1X2fVEQhTw51lKENdNrEqT3,3,2,1,0,0,0,1,0,4,0.5714285714285714,1,0.0,0,1,0,0,2,0,0,1,0,1,3,1
2605,37621,7ynsHGhJ1N4494Hez57ckblgtBNGbed9,A3fsA9Zfv1X2fVEQhTw51lKENdNrEqT3,3,0,0,0,0,0,6,0,6,0.8571428571428571,1,0.0,0,0,0,0,0,0,0,6,0,0,6,1
2606,37627,61Btwz5kWZaS3OIGnNTMXi3lqbtcLCB7,SpATywNh6bZuzm8s1ceuBUnMUAeoAHHw,5,4,1,0,1,0,1,0,7,1.0,1,0.0,0,1,0,1,4,0,0,1,0,2,5,1
2607,37657,h93nu205LxG6yA79vswKf1FixgIn79rm,G8EPVSXsOYB5YQWZGiz1aVq5Pgr2GrQu,158,94,62,241,46,3,6,1,453,64.71428571428571,2,0.0,29,62,202,46,65,3,39,6,1,339,114,1
2608,37694,umy7brIUz48bN1VUJsZEuHA9by5FINCa,A3fsA9Zfv1X2fVEQhTw51lKENdNrEqT3,6,3,1,0,1,1,3,0,9,1.2857142857142858,1,0.0,0,1,0,1,3,1,0,3,0,2,7,1
2609,37700,bLIF0ETNcg7fjkutu8YBWJptM3zxtu2Z,A3fsA9Zfv1X2fVEQhTw51lKENdNrEqT3,1,0,0,0,0,0,1,0,1,0.14285714285714285,1,0.0,0,0,0,0,0,0,0,1,0,0,1,1
2610,37730,z3YnX73v2uoVHmuLGzQD2gKKBoJqIQxK,bWdj2GDclj5ofokWjzoa5jAwMkxCykd6,16,17,9,22,6,0,1,0,55,7.857142857142857,2,0.0,6,9,16,6,11,0,6,1,0,37,18,0
2611,37744,YGd4irzc5KMR1PH2KdOtbCkghLMZ2dPk,bWdj2GDclj5ofokWjzoa5jAwMkxCykd6,2,0,0,0,0,0,2,0,2,0.2857142857142857,1,0.0,0,0,0,0,0,0,0,2,0,0,2,1
2612,37778,MT2eJtF59AVNdUs7mwFqputROb2HgEm3,A3fsA9Zfv1X2fVEQhTw51lKENdNrEqT3,72,89,32,170,15,0,4,0,310,44.285714285714285,3,0.0,2,32,142,15,87,0,28,4,0,191,119,0
2613,37794,uQjl8NGtIQkRfoe9edBiMgtYYmdkzVXR,A3fsA9Zfv1X2fVEQhTw51lKENdNrEqT3,4,6,3,0,0,0,5,0,14,2.0,3,0.0,0,3,0,0,6,0,0,5,0,3,11,0
2614,37810,NcPdgwZnF0RkLUxC56tG83zG3V3KP94S,SpATywNh6bZuzm8s1ceuBUnMUAeoAHHw,18,11,7,14,4,0,6,1,43,6.142857142857143,1,0.0,4,7,12,4,7,0,2,6,1,27,16,1
2615,37823,2Y3h62Lps0fU6B3C4MXM4YNVNDf25XBr,SpATywNh6bZuzm8s1ceuBUnMUAeoAHHw,21,27,17,18,12,0,5,0,79,11.285714285714286,5,0.0,2,17,15,12,25,0,3,5,0,46,33,0
2616,37842,QeQqhAEpCOGJwaPPp0lj3OsPiBcGFat2,SpATywNh6bZuzm8s1ceuBUnMUAeoAHHw,5,7,0,0,0,0,2,0,9,1.2857142857142858,1,0.0,0,0,0,0,7,0,0,2,0,0,9,0
2617,37851,6ovqVSF3YZ6bnWJaJ7v2dHPROWXVVlFQ,SpATywNh6bZuzm8s1ceuBUnMUAeoAHHw,7,7,0,0,0,0,2,0,9,1.2857142857142858,1,0.0,0,0,0,0,7,0,0,2,0,0,9,1
2618,37900,qZhmmNUvkNXdf3u04DTUQOFEBxxO10p4,SpATywNh6bZuzm8s1ceuBUnMUAeoAHHw,18,15,9,11,6,0,3,0,44,6.285714285714286,2,0.0,2,9,10,6,13,0,1,3,0,27,17,0
2619,37922,j3dtYivg2u73ZbuSWbPPpSBQQec6vBYH,A3fsA9Zfv1X2fVEQhTw51lKENdNrEqT3,5,19,12,0,5,0,7,0,43,6.142857142857143,5,0.0,0,12,0,5,19,0,0,7,0,17,26,0
2620,37940,QmHQ7ayFECnRsgCVpHpJI6yMYR4kf5re,bWdj2GDclj5ofokWjzoa5jAwMkxCykd6,21,9,5,62,1,18,5,0,100,14.285714285714286,1,0.0,2,5,50,1,7,18,12,5,0,58,42,0
2621,37960,bz2uqvuFRCLaJmY4vFLIXrs9g0cTBHJC,A3fsA9Zfv1X2fVEQhTw51lKENdNrEqT3,11,7,6,2,4,0,1,0,20,2.857142857142857,1,0.0,0,6,2,4,7,0,0,1,0,12,8,1
2622,38004,QEbMAkKsvpPGPL1XkTiHjXblquVwKrlD,A3fsA9Zfv1X2fVEQhTw51lKENdNrEqT3,4,2,1,0,0,0,4,0,7,1.0,2,0.0,0,1,0,0,2,0,0,4,0,1,6,1
2623,38068,PmZJAFj6wJkOD163WkhaJjRHdYOMjBZW,SpATywNh6bZuzm8s1ceuBUnMUAeoAHHw,7,5,3,0,1,0,1,0,10,1.4285714285714286,1,0.0,0,3,0,1,5,0,0,1,0,4,6,1
2624,38087,QyvVrWztIgSCCViLyqSM2D5NbMV2fEBm,SpATywNh6bZuzm8s1ceuBUnMUAeoAHHw,13,17,4,5,5,0,7,0,38,5.428571428571429,4,0.0,0,4,5,5,17,0,0,7,0,14,24,0
2625,38144,0Hl4WpPV6z0OC8rO0L3mZy6harAUBUs7,G8EPVSXsOYB5YQWZGiz1aVq5Pgr2GrQu,5,3,1,0,1,0,1,0,6,0.8571428571428571,1,0.0,0,1,0,1,3,0,0,1,0,2,4,1
2626,38147,OHOHfGJUvl8C8rOynV86vKj0FrD2jzFO,SpATywNh6bZuzm8s1ceuBUnMUAeoAHHw,15,18,2,12,1,0,3,0,36,5.142857142857143,2,0.0,4,2,11,1,14,0,1,3,0,18,18,1
2627,38157,tHNSnLtZK1vGs5MVrEoD7S1mcW3GtFm4,SpATywNh6bZuzm8s1ceuBUnMUAeoAHHw,18,24,12,12,5,0,2,0,55,7.857142857142857,1,0.0,2,12,12,5,22,0,0,2,0,31,24,0
2628,38170,vs0vqlNXzuHsqVxOsB15kGfpvGf2pUt3,SpATywNh6bZuzm8s1ceuBUnMUAeoAHHw,6,15,6,0,0,0,1,0,22,3.142857142857143,1,0.0,6,6,0,0,9,0,0,1,0,12,10,0
2629,38187,SX4dmJ5a5AfJLGZkCiiWab293xeIyxbW,SpATywNh6bZuzm8s1ceuBUnMUAeoAHHw,13,20,1,9,0,0,1,0,31,4.428571428571429,1,0.0,2,1,8,0,18,0,1,1,0,11,20,0
2630,38252,S2i0VW7GN0ACeCnuAPN00XONM8w8kvsN,G8EPVSXsOYB5YQWZGiz1aVq5Pgr2GrQu,44,81,36,44,14,1,16,0,192,27.428571428571427,3,0.0,5,36,37,14,76,1,7,16,0,92,100,0
2631,38264,DPr3Hy8387gfJi0Jc3ohxKBzY0mvhH1G,SpATywNh6bZuzm8s1ceuBUnMUAeoAHHw,21,25,12,14,4,0,5,0,60,8.571428571428571,3,0.0,11,12,12,4,14,0,2,5,0,39,21,0
2632,38345,skcEk7TV3jhSAknl5Kr7UawZFeqJNMzy,SpATywNh6bZuzm8s1ceuBUnMUAeoAHHw,5,3,2,0,1,0,1,0,7,1.0,1,0.0,0,2,0,1,3,0,0,1,0,3,4,1
2633,38348,DTsOT0NTIRutfokoKq4yB8bQe3U1fEsD,SpATywNh6bZuzm8s1ceuBUnMUAeoAHHw,9,5,4,0,3,0,1,0,13,1.8571428571428572,1,0.0,0,4,0,3,5,0,0,1,0,7,6,0
2634,38391,MAkHN0TS4uaTPgKLso4eQ3LTCDiU28De,bWdj2GDclj5ofokWjzoa5jAwMkxCykd6,1,2,0,0,0,0,0,0,2,0.2857142857142857,1,0.0,0,0,0,0,2,0,0,0,0,0,2,1
2635,38505,Dy0I4gbpbRtwh6YDRhpgGBLDEGUYJgO6,SpATywNh6bZuzm8s1ceuBUnMUAeoAHHw,9,10,6,0,2,0,1,0,19,2.7142857142857144,1,0.0,0,6,0,2,10,0,0,1,0,8,11,1
2636,38520,WRiHtWJX61VUGyAGQFSHJ3czdrgqxeQW,RXDvfPUBYFlVdlueBFbLW0mhhAyGEqpt,1,0,0,0,0,0,1,0,1,0.14285714285714285,1,0.0,0,0,0,0,0,0,0,1,0,0,1,1
2637,38596,spd8M0wss3Tbv0YQ5WcIllIwTexcZnnW,SpATywNh6bZuzm8s1ceuBUnMUAeoAHHw,6,12,0,0,0,0,3,0,15,2.142857142857143,2,0.0,0,0,0,0,12,0,0,3,0,0,15,0
2638,38621,C800geUBh3GYBhoh4cW6ReKUGj5LAMGi,SpATywNh6bZuzm8s1ceuBUnMUAeoAHHw,22,23,2,7,2,0,8,0,42,6.0,2,0.0,2,2,7,2,21,0,0,8,0,13,29,0
2639,38685,FncubT1DgrtJxWo1YRhPHqwgNARiG5Jv,SpATywNh6bZuzm8s1ceuBUnMUAeoAHHw,16,20,0,18,0,0,1,0,39,5.571428571428571,1,0.0,7,0,18,0,13,0,0,1,0,25,14,0
2640,38757,sEqqQzJgfFwEJ59pjhsH9YLQDd58mQLD,SpATywNh6bZuzm8s1ceuBUnMUAeoAHHw,11,21,1,0,1,0,2,0,25,3.5714285714285716,2,0.0,3,1,0,1,18,0,0,2,0,5,20,1
2641,38769,OygU41dc8lyatpKc4JEBkP0ni21xzfvB,SpATywNh6bZuzm8s1ceuBUnMUAeoAHHw,33,40,21,25,10,0,10,0,106,15.142857142857142,2,0.0,6,21,22,10,34,0,3,10,0,59,47,0
2642,38811,T6EWQ7jVP89JlHzj41KN1gEtGYevpSQM,SpATywNh6bZuzm8s1ceuBUnMUAeoAHHw,38,42,24,53,15,0,3,0,137,19.571428571428573,2,0.0,15,24,44,15,27,0,9,3,0,98,39,0
2643,38912,35Qckp7squ2ifhCEFcVeQZHmfUAJiaXc,SpATywNh6bZuzm8s1ceuBUnMUAeoAHHw,34,24,17,31,11,6,6,1,96,13.714285714285714,1,0.0,5,17,26,11,19,6,5,6,1,59,37,1
2644,38942,VrBnKyI7RjgXozKQXJ2DSbj5Gvev22L0,SpATywNh6bZuzm8s1ceuBUnMUAeoAHHw,3,2,1,0,0,0,1,0,4,0.5714285714285714,1,0.0,0,1,0,0,2,0,0,1,0,1,3,0
2645,38955,BE4JaFadHavW9r5xCXpj3M456eZAgaG6,SpATywNh6bZuzm8s1ceuBUnMUAeoAHHw,5,5,1,0,0,0,2,0,8,1.1428571428571428,1,0.0,0,1,0,0,5,0,0,2,0,1,7,1
2646,39024,KbrQAfHN76lnV5ENpEesywqeBtzfyubO,SpATywNh6bZuzm8s1ceuBUnMUAeoAHHw,11,13,1,0,2,0,1,0,17,2.4285714285714284,1,0.0,4,1,0,2,9,0,0,1,0,7,10,0
2647,39054,blGSSjmsnVQQQrRQxZJTHNQQUXxgUvBL,SpATywNh6bZuzm8s1ceuBUnMUAeoAHHw,13,11,5,0,3,3,10,1,33,4.714285714285714,2,0.0,5,5,0,3,6,3,0,10,1,13,20,0
2648,39057,l21tCwOolR7RD0CZyqRiNHHeEZC1D67K,SpATywNh6bZuzm8s1ceuBUnMUAeoAHHw,4,3,2,0,0,0,1,0,6,0.8571428571428571,1,0.0,0,2,0,0,3,0,0,1,0,2,4,0
2649,39090,fTfrYxb6cRWvjdEVjIZ7skF0s5uk6kd9,SpATywNh6bZuzm8s1ceuBUnMUAeoAHHw,19,28,16,0,9,0,8,0,61,8.714285714285714,4,0.0,0,16,0,9,28,0,0,8,0,25,36,0
2650,39229,rue9XaVrhPMV8jlzLPRPLBsY7dTh1epz,SpATywNh6bZuzm8s1ceuBUnMUAeoAHHw,3,2,1,0,0,0,1,0,4,0.5714285714285714,1,0.0,0,1,0,0,2,0,0,1,0,1,3,1
2651,39241,krVsPdgfe85VvAQ2rdfbpjD89zMbnkR0,SpATywNh6bZuzm8s1ceuBUnMUAeoAHHw,5,3,2,0,1,0,1,0,7,1.0,1,0.0,0,2,0,1,3,0,0,1,0,3,4,1
2652,39246,fv07Mlz09PBHitYybJt9eVrK276xe9YI,SpATywNh6bZuzm8s1ceuBUnMUAeoAHHw,18,15,12,10,6,10,14,0,67,9.571428571428571,3,0.0,3,12,9,6,12,10,1,14,0,30,37,0
2653,39264,7ddOasUgoSwmcHs4lJMhvhalD4IA2urH,SpATywNh6bZuzm8s1ceuBUnMUAeoAHHw,25,89,0,45,0,32,11,1,178,25.428571428571427,2,0.0,48,0,34,0,41,32,11,11,1,82,96,0
2654,39274,2nLjdaVfmxwWCLw5sEI1KKYk7UXViPES,SpATywNh6bZuzm8s1ceuBUnMUAeoAHHw,5,3,1,0,1,0,1,0,6,0.8571428571428571,1,0.0,0,1,0,1,3,0,0,1,0,2,4,0
2655,39312,5taolCXbi4GnZeqgvcKlHbiPurs2tpgr,SpATywNh6bZuzm8s1ceuBUnMUAeoAHHw,18,16,10,14,5,0,4,0,49,7.0,2,0.0,2,10,12,5,14,0,2,4,0,29,20,0
2656,39330,YY7yHizDn0UpGHVq4qoTfbulP3ev5TkC,SpATywNh6bZuzm8s1ceuBUnMUAeoAHHw,16,16,11,6,5,0,4,0,42,6.0,2,0.0,0,11,5,5,16,0,1,4,0,21,21,0
2657,39349,8eqcmJf66b25Hdf1a71yMHA6gdhfVvDC,G8EPVSXsOYB5YQWZGiz1aVq5Pgr2GrQu,5,2,1,0,0,0,5,0,8,1.1428571428571428,1,0.0,0,1,0,0,2,0,0,5,0,1,7,0
2658,39367,SgAa84aajahM2sd2hvCdYRfO014ocPV5,SpATywNh6bZuzm8s1ceuBUnMUAeoAHHw,10,15,9,0,2,0,5,0,31,4.428571428571429,2,0.0,2,9,0,2,13,0,0,5,0,13,18,0
2659,39371,194jqOV6jnj4prH3N2CqRtpc9qi9vfln,A3fsA9Zfv1X2fVEQhTw51lKENdNrEqT3,5,6,0,0,0,0,4,0,10,1.4285714285714286,1,0.0,1,0,0,0,5,0,0,4,0,1,9,1
2660,39377,M0xQooArrVMTCCgk3YkWTaBSUVldkFxi,SpATywNh6bZuzm8s1ceuBUnMUAeoAHHw,31,53,28,14,11,0,13,1,120,17.142857142857142,6,0.0,10,28,14,11,43,0,0,13,1,63,57,0
2661,39407,W7Pzvj7hPa3qVKdWluutDHqjcp3iIpAb,SpATywNh6bZuzm8s1ceuBUnMUAeoAHHw,18,12,8,12,5,0,4,0,41,5.857142857142857,2,0.0,2,8,11,5,10,0,1,4,0,26,15,0
2662,39441,VsLOJ7Xi4SI8kpOP7KF7SoJJkHTp6ASm,SpATywNh6bZuzm8s1ceuBUnMUAeoAHHw,22,21,15,10,9,0,6,0,61,8.714285714285714,2,0.0,2,15,9,9,19,0,1,6,0,35,26,0
2663,39443,WxaYTMCI7yD8mE0osZVkZT9Orbo545LC,G8EPVSXsOYB5YQWZGiz1aVq5Pgr2GrQu,1,0,0,0,0,0,1,0,1,0.14285714285714285,1,0.0,0,0,0,0,0,0,0,1,0,0,1,1
2664,39464,e2VhgSHwCVj2IYcx6wF0yjNoIULwWBq8,A3fsA9Zfv1X2fVEQhTw51lKENdNrEqT3,3,2,1,0,0,0,2,0,5,0.7142857142857143,1,0.0,0,1,0,0,2,0,0,2,0,1,4,1
2665,39486,7UOiW6Ks9JGRUR75AHoSTuRNGYY2xnnm,A3fsA9Zfv1X2fVEQhTw51lKENdNrEqT3,1,0,0,0,0,0,1,0,1,0.14285714285714285,1,0.0,0,0,0,0,0,0,0,1,0,0,1,0
2666,39504,1BLAPxf3lDzwOBM6NeFyerOFp0vZobfY,SpATywNh6bZuzm8s1ceuBUnMUAeoAHHw,17,21,12,2,5,0,3,0,43,6.142857142857143,3,0.0,5,12,2,5,16,0,0,3,0,24,19,0
2667,39567,YC5UG6m05nI4uxDXYqrNEKgzKHSk4oSu,SpATywNh6bZuzm8s1ceuBUnMUAeoAHHw,24,21,12,5,5,8,9,3,63,9.0,3,0.0,5,12,5,5,16,8,0,9,3,27,36,0
2668,39587,X14gKVD1ZKu0qL0NchpqxwhoYSEpz9QI,SpATywNh6bZuzm8s1ceuBUnMUAeoAHHw,10,14,0,6,0,0,7,0,27,3.857142857142857,4,0.0,2,0,6,0,12,0,0,7,0,8,19,0
2669,39608,Z75g2Nz4DcysTkbj3XO50UPDPTuBSclE,A3fsA9Zfv1X2fVEQhTw51lKENdNrEqT3,5,4,0,0,1,0,1,0,6,0.8571428571428571,1,0.0,0,0,0,1,4,0,0,1,0,1,5,1
2670,39620,RERMHDA2gNT2NdhpczhxOdgAsVrkLgnS,SpATywNh6bZuzm8s1ceuBUnMUAeoAHHw,3,2,1,0,0,0,1,0,4,0.5714285714285714,1,0.0,0,1,0,0,2,0,0,1,0,1,3,0
2671,39630,3Aezv8lgcVyIW4Uwgi3KMiL4RZSkwke5,bWdj2GDclj5ofokWjzoa5jAwMkxCykd6,5,8,4,0,0,0,13,0,25,3.5714285714285716,3,0.0,0,4,0,0,8,0,0,13,0,4,21,0
2672,39632,YHL8SFwBUtFpO36pvl6xAPsnC0mLXaOp,G8EPVSXsOYB5YQWZGiz1aVq5Pgr2GrQu,15,24,2,0,2,0,2,0,30,4.285714285714286,2,0.0,0,2,0,2,24,0,0,2,0,4,26,1
2673,39723,wg81hfugF770xMHAXCLP7YJmOhdUJnHl,SpATywNh6bZuzm8s1ceuBUnMUAeoAHHw,8,14,4,0,2,0,4,0,24,3.4285714285714284,3,0.0,0,4,0,2,14,0,0,4,0,6,18,0
2674,39776,OdMr7dE5UlAme9Tp979vREBvY5CV50po,bWdj2GDclj5ofokWjzoa5jAwMkxCykd6,37,37,23,56,18,0,9,0,143,20.428571428571427,3,0.0,9,23,49,18,28,0,7,9,0,99,44,0
2675,39837,HboM24Wk39YTBPWC8WzrZxRqA9rZpUU4,SpATywNh6bZuzm8s1ceuBUnMUAeoAHHw,1,0,0,0,0,0,1,0,1,0.14285714285714285,1,0.0,0,0,0,0,0,0,0,1,0,0,1,1
2676,39858,efn1iuG0ajlfaHaXrPxReUu8GzdIHbZe,SpATywNh6bZuzm8s1ceuBUnMUAeoAHHw,1,0,0,0,0,0,1,0,1,0.14285714285714285,1,0.0,0,0,0,0,0,0,0,1,0,0,1,0
2677,39885,g6UH67YbvJtewLNXQNVZTYui0XC1Hxpo,G8EPVSXsOYB5YQWZGiz1aVq5Pgr2GrQu,35,35,20,72,10,0,3,0,140,20.0,2,0.0,10,20,62,10,25,0,10,3,0,102,38,0
2678,39924,1Lhe3e5bki1E1AUNwq5SspoMJiU5aMmH,RXDvfPUBYFlVdlueBFbLW0mhhAyGEqpt,30,29,18,0,16,0,3,0,66,9.428571428571429,1,0.0,6,18,0,16,23,0,0,3,0,40,26,0
2679,39929,r3yTAtA27zn29k1K73ADGURrMlpR5nC7,RXDvfPUBYFlVdlueBFbLW0mhhAyGEqpt,14,13,10,0,6,0,3,0,32,4.571428571428571,2,0.0,1,10,0,6,12,0,0,3,0,17,15,0
2680,39967,VFl026LXCSxME7l2ZLRhGKmh3R96duCq,SpATywNh6bZuzm8s1ceuBUnMUAeoAHHw,34,48,32,21,16,0,13,0,130,18.571428571428573,7,0.0,6,32,20,16,42,0,1,13,0,74,56,0
2681,40022,SP7CCOQc4gFs6CnOJ8vpnG2qG74ffSCZ,SpATywNh6bZuzm8s1ceuBUnMUAeoAHHw,4,1,0,0,1,0,2,0,4,0.5714285714285714,1,0.0,0,0,0,1,1,0,0,2,0,1,3,0
2682,40027,vpdMGAwpHu1uhd9ckN957NDWXXLtiXYo,bWdj2GDclj5ofokWjzoa5jAwMkxCykd6,5,0,0,0,0,10,9,1,20,2.857142857142857,3,0.0,0,0,0,0,0,10,0,9,1,0,20,1
2683,40039,28PHU9suTM8EqUKsQwsvQ03DzFXi0yDl,A3fsA9Zfv1X2fVEQhTw51lKENdNrEqT3,4,9,5,0,0,0,4,0,18,2.5714285714285716,2,0.0,0,5,0,0,9,0,0,4,0,5,13,0
2684,40054,dlphjzS7Cck7yL7KPK4kXgmYSbBOCuFC,bWdj2GDclj5ofokWjzoa5jAwMkxCykd6,1,0,0,0,0,0,1,0,1,0.14285714285714285,1,0.0,0,0,0,0,0,0,0,1,0,0,1,0
2685,40081,zyMs55MEXcYV6llnecBHL4KGyjGwZwbR,SpATywNh6bZuzm8s1ceuBUnMUAeoAHHw,9,6,0,9,0,0,1,0,16,2.2857142857142856,1,0.0,0,0,9,0,6,0,0,1,0,9,7,0
2686,40101,D2f4XnvAFD8ZIkDvhpGbd6yCstJua9ut,SpATywNh6bZuzm8s1ceuBUnMUAeoAHHw,3,2,0,0,0,0,1,0,3,0.42857142857142855,1,0.0,0,0,0,0,2,0,0,1,0,0,3,1
2687,40137,7Blw5DXu09ENSrwHZywqqUdODuz4CZi6,SpATywNh6bZuzm8s1ceuBUnMUAeoAHHw,20,11,7,14,5,2,8,0,47,6.714285714285714,1,0.0,3,7,12,5,8,2,2,8,0,27,20,0
2688,40154,grc1pAXqdUQaBlZrZyROqjuEtg08nen2,bWdj2GDclj5ofokWjzoa5jAwMkxCykd6,3,2,0,0,0,0,2,0,4,0.5714285714285714,1,0.0,0,0,0,0,2,0,0,2,0,0,4,0
2689,40156,BM23agkLBTvZTkItMt2GtI7Rt9Nmmgof,SpATywNh6bZuzm8s1ceuBUnMUAeoAHHw,10,10,5,0,3,0,1,0,19,2.7142857142857144,1,0.0,0,5,0,3,10,0,0,1,0,8,11,0
2690,40175,m2y02R5W4wE10TMNO80PJL5IOUbHqLJ2,SpATywNh6bZuzm8s1ceuBUnMUAeoAHHw,11,6,5,0,4,0,1,0,16,2.2857142857142856,1,0.0,0,5,0,4,6,0,0,1,0,9,7,0
2691,40188,su19QKj6MYt8IN4q4jbVFtyo4Ew7wkeA,RXDvfPUBYFlVdlueBFbLW0mhhAyGEqpt,8,4,3,0,2,0,3,0,12,1.7142857142857142,1,0.0,0,3,0,2,4,0,0,3,0,5,7,1
2692,40198,w1whp42bLIFDRZ3YUW58J4w8I7T8mTT8,SpATywNh6bZuzm8s1ceuBUnMUAeoAHHw,16,33,6,6,2,1,11,0,59,8.428571428571429,4,0.0,11,6,6,2,22,1,0,11,0,25,34,1
2693,40247,CnndUXNaSJ8w2bb9DGxHOhqjHw4SEo1K,SpATywNh6bZuzm8s1ceuBUnMUAeoAHHw,5,4,3,0,1,0,1,0,9,1.2857142857142858,1,0.0,0,3,0,1,4,0,0,1,0,4,5,0
2694,40257,IRfJ2J3e4oTjcMA6yNpRgLvZtLwyduUa,SpATywNh6bZuzm8s1ceuBUnMUAeoAHHw,22,48,19,9,8,0,15,3,102,14.571428571428571,2,0.0,2,19,9,8,46,0,0,15,3,38,64,0
2695,40278,mMBONcOMl6gC3uzknh0XJLJbk13L2x3D,SpATywNh6bZuzm8s1ceuBUnMUAeoAHHw,25,18,12,12,9,1,1,0,53,7.571428571428571,1,0.0,5,12,12,9,13,1,0,1,0,38,15,1
2696,40327,5vUuq5ZeDCNce4LmvH0naoUjpb3qbNOp,A3fsA9Zfv1X2fVEQhTw51lKENdNrEqT3,8,8,6,0,1,0,2,0,17,2.4285714285714284,1,0.0,0,6,0,1,8,0,0,2,0,7,10,1
2697,40332,JCQSo9f9Aey0YG4wslCCbhR6oOLB0oC6,SpATywNh6bZuzm8s1ceuBUnMUAeoAHHw,19,18,8,10,5,15,3,0,59,8.428571428571429,1,0.0,4,8,10,5,14,15,0,3,0,27,32,0
2698,40354,GFHYWWeeAuj1pePvOmCpIpIQDTy4Q3Iv,RXDvfPUBYFlVdlueBFbLW0mhhAyGEqpt,37,79,67,0,50,11,6,5,218,31.142857142857142,3,0.0,3,67,0,50,76,11,0,6,5,120,98,0
2699,40402,O7GZYzgRa5tZbYrbtpqYuheFfdPZTjLl,bWdj2GDclj5ofokWjzoa5jAwMkxCykd6,5,3,2,0,1,0,2,0,8,1.1428571428571428,2,0.0,0,2,0,1,3,0,0,2,0,3,5,1
2700,40447,y6i20DJpIul6LihHwgZcWxbdAap5GcBP,bWdj2GDclj5ofokWjzoa5jAwMkxCykd6,4,2,1,0,0,2,7,0,12,1.7142857142857142,2,0.0,0,1,0,0,2,2,0,7,0,1,11,1
2701,40469,zynLWMDwDGZGrMFdec4rl1UB2FSg8e8K,A3fsA9Zfv1X2fVEQhTw51lKENdNrEqT3,16,10,8,0,6,2,3,1,30,4.285714285714286,1,0.0,0,8,0,6,10,2,0,3,1,14,16,1
2702,40483,qbRtu1q5PIx1qmhJ9lRn0S3Y5dNcEYWw,G8EPVSXsOYB5YQWZGiz1aVq5Pgr2GrQu,7,5,2,0,1,0,2,0,10,1.4285714285714286,1,0.0,0,2,0,1,5,0,0,2,0,3,7,1
2703,40514,weKRMLBzfxs8ekS11Y9oGFXbhmcomWRF,A3fsA9Zfv1X2fVEQhTw51lKENdNrEqT3,69,27,0,184,0,0,10,0,221,31.571428571428573,1,0.0,5,0,162,0,22,0,22,10,0,167,54,0
2704,40591,izEpfh69zQRV21ZbipmxXr7f4EKcykoG,bWdj2GDclj5ofokWjzoa5jAwMkxCykd6,7,5,1,0,1,1,3,0,11,1.5714285714285714,1,0.0,0,1,0,1,5,1,0,3,0,2,9,1
2705,40608,nD2aR2lBTYEZ05tUWGjogkwgt2d7zeNx,A3fsA9Zfv1X2fVEQhTw51lKENdNrEqT3,7,8,0,0,0,0,1,0,9,1.2857142857142858,1,0.0,0,0,0,0,8,0,0,1,0,0,9,1
2706,40635,BOna3ORacJGhjt4FcGMkKNwkDYsEjcvt,RXDvfPUBYFlVdlueBFbLW0mhhAyGEqpt,3,2,1,0,0,0,1,0,4,0.5714285714285714,1,0.0,0,1,0,0,2,0,0,1,0,1,3,1
2707,40858,dJJJLtI6F18pblO9KPkBPg9ZKTgQPaQc,SpATywNh6bZuzm8s1ceuBUnMUAeoAHHw,15,30,3,12,2,0,6,0,53,7.571428571428571,3,0.0,9,3,11,2,21,0,1,6,0,25,28,0
2708,40861,40L77km5z19sJEVeJ6u4qpa9SAG2ZSIF,SpATywNh6bZuzm8s1ceuBUnMUAeoAHHw,14,14,7,14,0,0,5,0,40,5.714285714285714,2,0.0,5,7,11,0,9,0,3,5,0,23,17,0
2709,40870,8gfCGxZ6lFjZr89RwPF8oXZs1Qn6Pq6X,bWdj2GDclj5ofokWjzoa5jAwMkxCykd6,5,2,2,0,0,0,2,0,6,0.8571428571428571,1,0.0,0,2,0,0,2,0,0,2,0,2,4,1
2710,40875,2ekh2uQneNAGmhQ3c3UciXnUFmuOUWou,SpATywNh6bZuzm8s1ceuBUnMUAeoAHHw,8,7,4,0,2,0,2,0,15,2.142857142857143,3,0.0,0,4,0,2,7,0,0,2,0,6,9,1
2711,40905,aldLXGpzmiip2CUSDhqN8A5UpGMVUHxY,bWdj2GDclj5ofokWjzoa5jAwMkxCykd6,11,7,5,10,2,0,2,0,26,3.7142857142857144,1,0.0,1,5,9,2,6,0,1,2,0,17,9,0
2712,40910,M2AmcvqhvMtUlyRV6vMvvoM2IhrMmAwT,A3fsA9Zfv1X2fVEQhTw51lKENdNrEqT3,35,24,13,46,8,10,2,0,103,14.714285714285714,1,0.0,2,13,46,8,22,10,0,2,0,69,34,1
2713,40994,WmqMKoevd5yMpzwxk3BDNFkg4y1FZjx5,G8EPVSXsOYB5YQWZGiz1aVq5Pgr2GrQu,3,2,1,0,0,0,1,0,4,0.5714285714285714,1,0.0,0,1,0,0,2,0,0,1,0,1,3,1
2714,41018,Htb70W0lnqw4QeBjeePevzE0xRg4O6vF,7GRhBDsirIGkRZBtSMEzNTyDr2JQm4xx,6,8,3,0,1,0,1,0,13,1.8571428571428572,1,0.0,4,3,0,1,4,0,0,1,0,8,5,1
2715,41059,6EuD05bZDV64mgZbOuyYsTbmEWKlO9F2,5X6FeZozNMgE2VRi3MJYjkkFK8SETtu2,4,2,1,0,1,0,4,0,8,1.1428571428571428,4,0.0,0,1,0,1,2,0,0,4,0,2,6,1
2716,41092,BkozGGotFoRWvs7kivTQvwwV5JZ8hddc,5X6FeZozNMgE2VRi3MJYjkkFK8SETtu2,16,19,12,0,3,4,9,0,47,6.714285714285714,3,0.0,0,12,0,3,19,4,0,9,0,15,32,1
2717,41204,LLeDVWTsZ6cKlGvkSg9slNHwG1UoBTzO,5X6FeZozNMgE2VRi3MJYjkkFK8SETtu2,1,0,0,0,0,0,1,0,1,0.14285714285714285,1,0.0,0,0,0,0,0,0,0,1,0,0,1,1
2718,41404,xbPbNw5WluotpcGvfodgid2Z7Rc8OfQr,5X6FeZozNMgE2VRi3MJYjkkFK8SETtu2,1,0,0,0,0,0,1,0,1,0.14285714285714285,1,0.0,0,0,0,0,0,0,0,1,0,0,1,1
2719,41405,wxXsB2E97PklyJnNr2rcYvINOWKCzd23,7GRhBDsirIGkRZBtSMEzNTyDr2JQm4xx,4,3,1,0,1,3,1,0,9,1.2857142857142858,1,0.0,0,1,0,1,3,3,0,1,0,2,7,0
2720,41451,5jvwyA9MThuFQ1JB0z4QxHGot11254OC,5X6FeZozNMgE2VRi3MJYjkkFK8SETtu2,1,0,0,0,0,0,1,0,1,0.14285714285714285,1,0.0,0,0,0,0,0,0,0,1,0,0,1,1
2721,41461,emCY4aIQuto3vHDbWyLccdGfPM1ClSuh,5X6FeZozNMgE2VRi3MJYjkkFK8SETtu2,1,0,0,0,0,0,1,0,1,0.14285714285714285,1,0.0,0,0,0,0,0,0,0,1,0,0,1,1
2722,41463,xg6gozDtJtmbriZIHFk0YIJKhyzF16Dg,5X6FeZozNMgE2VRi3MJYjkkFK8SETtu2,8,13,8,0,3,0,6,0,30,4.285714285714286,2,0.0,0,8,0,3,13,0,0,6,0,11,19,0
2723,41501,0bsBNQsCMEE2O55Mpr8lzwhfGggHG2nb,5X6FeZozNMgE2VRi3MJYjkkFK8SETtu2,25,54,12,23,15,0,15,0,119,17.0,5,0.0,30,12,20,15,24,0,3,15,0,77,42,0
2724,41564,EP1XQRGS4HZOG1hdGzNZdD1HFhJcHpos,5X6FeZozNMgE2VRi3MJYjkkFK8SETtu2,20,25,3,20,3,0,10,0,61,8.714285714285714,5,0.0,12,3,19,3,13,0,1,10,0,37,24,1
2725,41582,CfUHqy5TfjBtRxjNztsGxyFua9jISd0Q,7GRhBDsirIGkRZBtSMEzNTyDr2JQm4xx,9,13,3,4,4,0,1,0,25,3.5714285714285716,1,0.0,8,3,2,4,5,0,2,1,0,17,8,1
2726,41653,nglaToodcU5Q8FzrMWGY4MUCnpZFGaF5,5X6FeZozNMgE2VRi3MJYjkkFK8SETtu2,4,4,0,0,1,0,1,0,6,0.8571428571428571,1,0.0,2,0,0,1,2,0,0,1,0,3,3,1
2727,41660,fY8o8e7SJUdWY1xaUnM6G57PgYadWViL,5X6FeZozNMgE2VRi3MJYjkkFK8SETtu2,1,0,0,0,0,0,1,0,1,0.14285714285714285,1,0.0,0,0,0,0,0,0,0,1,0,0,1,1
2728,41762,FJJqBn1iTJmAbav7Ov5Y4ycyF65fvY1E,7GRhBDsirIGkRZBtSMEzNTyDr2JQm4xx,1,0,0,0,0,0,2,0,2,0.2857142857142857,2,0.0,0,0,0,0,0,0,0,2,0,0,2,0
2729,41807,txRaMeFRdTsCsziGBMMxzL5gSPIB7mbk,7GRhBDsirIGkRZBtSMEzNTyDr2JQm4xx,27,60,28,14,22,21,6,0,151,21.571428571428573,2,0.0,26,28,10,22,34,21,4,6,0,86,65,1
2730,41844,oK1wkJMrtnbx1knb5vStqUw88huLmwS5,5Gyp41oLVo7Gg7vF4vpmggWP5MU70QO6,24,42,26,22,12,5,13,0,120,17.142857142857142,4,0.0,6,26,17,12,36,5,5,13,0,61,59,1
2731,41851,gcway7yukVhkU23YjxQt8J89R78muKel,5Gyp41oLVo7Gg7vF4vpmggWP5MU70QO6,24,34,17,14,9,40,6,1,121,17.285714285714285,3,0.0,6,17,10,9,28,40,4,6,1,42,79,1
2732,41858,uaLxZvxbm1TQQbHyJUmfD5cTdUUQTulO,5Gyp41oLVo7Gg7vF4vpmggWP5MU70QO6,8,4,3,3,1,1,3,0,15,2.142857142857143,1,0.0,0,3,2,1,4,1,1,3,0,6,9,1
2733,41875,3VG32L4W2oc0vDv6hhXZcfEhP3Rb3QH9,5Gyp41oLVo7Gg7vF4vpmggWP5MU70QO6,31,80,46,24,14,20,29,1,214,30.571428571428573,11,0.0,11,46,18,14,69,20,6,29,1,89,125,0
2734,41886,CiSU3A3dnYg9wq3LHFDed0um6sE24Rcy,5Gyp41oLVo7Gg7vF4vpmggWP5MU70QO6,7,8,3,0,1,0,2,0,14,2.0,2,0.0,2,3,0,1,6,0,0,2,0,6,8,0
2735,41909,kGiwkpye34paJt0E8ZP4DxvIGSOY6Bp8,5Gyp41oLVo7Gg7vF4vpmggWP5MU70QO6,2,0,0,0,0,0,2,0,2,0.2857142857142857,1,0.0,0,0,0,0,0,0,0,2,0,0,2,1
2736,41929,VcxKA6fBT5v15CG0tzIGW16yZ7lBAHFR,5Gyp41oLVo7Gg7vF4vpmggWP5MU70QO6,5,2,1,0,1,0,2,0,6,0.8571428571428571,1,0.0,0,1,0,1,2,0,0,2,0,2,4,1
2737,41930,ApFdQQBcLqTLoA4wIvtlnnwFs4FrlVS1,5Gyp41oLVo7Gg7vF4vpmggWP5MU70QO6,4,2,1,0,1,0,2,0,6,0.8571428571428571,2,0.0,0,1,0,1,2,0,0,2,0,2,4,1
2738,41944,GfM0TEq4MIfnphAdOO3PH37OTU8KegxW,5Gyp41oLVo7Gg7vF4vpmggWP5MU70QO6,19,25,11,19,4,3,6,1,69,9.857142857142858,4,0.0,9,11,12,4,16,3,7,6,1,36,33,1
2739,41966,h371iA4AgZEg2RakvkeOsTxClwgDiBHp,5Gyp41oLVo7Gg7vF4vpmggWP5MU70QO6,44,128,77,0,44,0,11,0,260,37.142857142857146,14,0.0,32,77,0,44,96,0,0,11,0,153,107,1
2740,41970,BYn6cWVQSMORsIVShYVRAnnkHpLyiUv8,5Gyp41oLVo7Gg7vF4vpmggWP5MU70QO6,47,249,15,51,22,25,34,0,396,56.57142857142857,16,0.0,52,15,43,22,197,25,8,34,0,132,264,0
2741,41981,35uEyKl4Buh1znVced4nodQ23qT6UkpF,5Gyp41oLVo7Gg7vF4vpmggWP5MU70QO6,39,115,48,37,28,2,13,0,243,34.714285714285715,8,0.0,38,48,26,28,77,2,11,13,0,140,103,0
2742,41986,lsWPPYsqnZVAjvZOYm6DuZ8dMXcHRRkz,5Gyp41oLVo7Gg7vF4vpmggWP5MU70QO6,20,25,13,13,4,27,12,5,99,14.142857142857142,3,0.0,4,13,8,4,21,27,5,12,5,29,70,1
2743,41989,0dTl0LLZb3MVQ7vvfkoX3uGGuSQCYhar,5Gyp41oLVo7Gg7vF4vpmggWP5MU70QO6,10,49,9,13,1,10,3,0,85,12.142857142857142,2,0.0,28,9,8,1,21,10,5,3,0,46,39,1
2744,41995,LAK3kQOhNPU7sNGCw3V3wZRUMmEaRMC4,5Gyp41oLVo7Gg7vF4vpmggWP5MU70QO6,28,57,29,30,11,33,23,6,189,27.0,6,0.0,16,29,18,11,41,33,12,23,6,74,115,1
2745,41998,oiOA4GHiqMEC6R8waIv9r60EFxyZ8MwN,5Gyp41oLVo7Gg7vF4vpmggWP5MU70QO6,1,0,0,0,0,0,1,0,1,0.14285714285714285,1,0.0,0,0,0,0,0,0,0,1,0,0,1,1
2746,42039,O5osNpvARQ134oncM7N5QGhst9sMjRtB,5Gyp41oLVo7Gg7vF4vpmggWP5MU70QO6,73,271,138,91,62,96,66,0,724,103.42857142857143,19,0.0,95,138,77,62,176,96,14,66,0,372,352,0
2747,42082,zGtXuznFoctStZvY1Kwb8pR6kY0dSZq8,5Gyp41oLVo7Gg7vF4vpmggWP5MU70QO6,5,7,3,0,1,0,2,0,13,1.8571428571428572,2,0.0,0,3,0,1,7,0,0,2,0,4,9,1
2748,42117,KoiK3xwBhqPmOEQ0SqGaoljDWNm2J5N4,5Gyp41oLVo7Gg7vF4vpmggWP5MU70QO6,8,3,1,0,1,1,4,0,10,1.4285714285714286,1,0.0,0,1,0,1,3,1,0,4,0,2,8,1
2749,42119,k0IY1JDIlHz8E9FcklcCc7M6vgU6bRMg,5Gyp41oLVo7Gg7vF4vpmggWP5MU70QO6,9,5,3,0,2,0,5,0,15,2.142857142857143,1,0.0,0,3,0,2,5,0,0,5,0,5,10,1
2750,42173,FELnhQR0c7GZZX82ioYJEZsqujOrfyf7,5Gyp41oLVo7Gg7vF4vpmggWP5MU70QO6,55,113,56,77,28,46,49,3,372,53.142857142857146,12,0.0,33,56,53,28,80,46,24,49,3,170,202,0
2751,42221,GcfrlVMG2ru9y4B409IihEpJj1fsWZwu,5Gyp41oLVo7Gg7vF4vpmggWP5MU70QO6,24,39,16,0,18,0,5,0,78,11.142857142857142,2,0.0,15,16,0,18,24,0,0,5,0,49,29,1
2752,42255,vgviVjMVNtT6tD9rdaknQn6H7E6jIs61,5Gyp41oLVo7Gg7vF4vpmggWP5MU70QO6,35,86,49,27,13,49,23,0,247,35.285714285714285,8,0.0,13,49,18,13,73,49,9,23,0,93,154,1
2753,42270,D8J1nI1EMIfxo0mlTd1mZqxYvHDgdtVN,5Gyp41oLVo7Gg7vF4vpmggWP5MU70QO6,1,0,0,0,0,0,1,0,1,0.14285714285714285,1,0.0,0,0,0,0,0,0,0,1,0,0,1,1
2754,42331,ad0B2cwqvECBfF7edrOTXlcMQTbORoHx,5Gyp41oLVo7Gg7vF4vpmggWP5MU70QO6,17,25,15,10,10,0,2,0,62,8.857142857142858,1,0.0,7,15,5,10,18,0,5,2,0,37,25,1
2755,42342,4D9TO74zb0mHkwi6G9vwCLqeflT8BNm5,5Gyp41oLVo7Gg7vF4vpmggWP5MU70QO6,38,76,38,14,25,24,17,0,194,27.714285714285715,6,0.0,27,38,10,25,49,24,4,17,0,100,94,1
2756,42352,qeHXe8DRkB9urr63HS1yAMwTxQkwIbff,5Gyp41oLVo7Gg7vF4vpmggWP5MU70QO6,1,0,0,0,0,0,1,0,1,0.14285714285714285,1,0.0,0,0,0,0,0,0,0,1,0,0,1,1
2757,42366,uSsarL0Xsecsq342KHCnn09W3eM6zSLh,5Gyp41oLVo7Gg7vF4vpmggWP5MU70QO6,13,23,10,6,12,3,3,0,57,8.142857142857142,1,0.0,10,10,3,12,13,3,3,3,0,35,22,1
2758,42367,Kw3ipO3nkJ2O6MLvUuTDqCLl9j8eQ8eR,5Gyp41oLVo7Gg7vF4vpmggWP5MU70QO6,17,28,17,17,0,63,8,0,133,19.0,4,0.0,7,17,12,0,21,63,5,8,0,36,97,1
2759,42375,UMGWwQ03Me0nRWPYI2EwBxPzOF28gAaF,5Gyp41oLVo7Gg7vF4vpmggWP5MU70QO6,1,0,0,0,0,0,1,0,1,0.14285714285714285,1,0.0,0,0,0,0,0,0,0,1,0,0,1,1
2760,42377,V7HQ93K3Oxti8xU7m9LhZ29UQMMdOT2H,5Gyp41oLVo7Gg7vF4vpmggWP5MU70QO6,6,3,2,0,1,0,2,0,8,1.1428571428571428,1,0.0,0,2,0,1,3,0,0,2,0,3,5,1
2761,42395,dJa5Hz9E0NcjdIFPhafeofUNffk7udcb,5Gyp41oLVo7Gg7vF4vpmggWP5MU70QO6,8,26,21,3,17,0,1,0,68,9.714285714285714,12,0.0,1,21,2,17,25,0,1,1,0,41,27,1
2762,42400,GbeaOKMmSDqC1iKIHijNvr7GZSfv6iUN,5Gyp41oLVo7Gg7vF4vpmggWP5MU70QO6,58,233,118,63,62,46,49,5,576,82.28571428571429,19,0.0,67,118,51,62,166,46,12,49,5,298,278,0
2763,42408,G5viWFw6vjc0kZ7aRbev4NG1fp3ajLxi,5Gyp41oLVo7Gg7vF4vpmggWP5MU70QO6,35,123,54,15,20,4,25,1,242,34.57142857142857,8,0.0,29,54,10,20,94,4,5,25,1,113,129,0
2764,42412,TKni4XynpXoISkd4OYGZxkhhQF48YfLJ,5Gyp41oLVo7Gg7vF4vpmggWP5MU70QO6,59,319,110,87,62,63,76,12,729,104.14285714285714,16,0.0,85,110,73,62,234,63,14,76,12,330,399,0
2765,42434,jpXIq3stqWScWG27acYJbNKpdTmc6kli,5Gyp41oLVo7Gg7vF4vpmggWP5MU70QO6,51,127,71,37,25,9,42,0,311,44.42857142857143,10,0.0,38,71,30,25,89,9,7,42,0,164,147,1
2766,42456,MZc1NWeYuOnQeyjxpICNnWFYpBwBXI4z,5Gyp41oLVo7Gg7vF4vpmggWP5MU70QO6,37,96,11,21,28,80,39,1,276,39.42857142857143,14,0.0,20,11,15,28,76,80,6,39,1,74,202,1
2767,42457,w8ymvO72UlYPBd2tG0A8iTEwt4UoIvlZ,5Gyp41oLVo7Gg7vF4vpmggWP5MU70QO6,53,148,82,25,19,72,54,2,402,57.42857142857143,10,0.0,26,82,21,19,122,72,4,54,2,148,254,0
2768,42472,0LlzZQtftf5FgqzUDg0nEE6UvawRFtil,5Gyp41oLVo7Gg7vF4vpmggWP5MU70QO6,1,0,0,0,0,0,2,0,2,0.2857142857142857,2,0.0,0,0,0,0,0,0,0,2,0,0,2,1
2769,42476,erNct1oh0g6Q9OxUYlh6sLY24w7nP582,5Gyp41oLVo7Gg7vF4vpmggWP5MU70QO6,23,24,13,16,10,0,3,0,66,9.428571428571429,3,0.0,6,13,8,10,18,0,8,3,0,37,29,1
2770,42479,wdyLBUXnKZHWy3hjP9iEUMTvoZlBkTI1,5Gyp41oLVo7Gg7vF4vpmggWP5MU70QO6,28,129,58,31,27,10,36,1,292,41.714285714285715,13,0.0,19,58,25,27,110,10,6,36,1,129,163,0
2771,42486,9zKzyrDc2ZLmZJn8iNzeeCTIcbRbidfo,5Gyp41oLVo7Gg7vF4vpmggWP5MU70QO6,1,0,0,0,0,0,1,0,1,0.14285714285714285,1,0.0,0,0,0,0,0,0,0,1,0,0,1,1
2772,42494,D2GOB0YSodwh6v6iFZs08FbkGvuLeJRY,5Gyp41oLVo7Gg7vF4vpmggWP5MU70QO6,14,18,8,0,5,1,5,0,37,5.285714285714286,2,0.0,3,8,0,5,15,1,0,5,0,16,21,0
2773,42497,E6rJgT1B5YorfxfA1yfh0Ek0w6vjtNrL,5Gyp41oLVo7Gg7vF4vpmggWP5MU70QO6,10,5,3,4,2,1,3,0,18,2.5714285714285716,1,0.0,1,3,2,2,4,1,2,3,0,8,10,1
2774,42505,4ZVrwOJI0OZGv0iKNXpa2OrPWHTNPSKw,5Gyp41oLVo7Gg7vF4vpmggWP5MU70QO6,15,12,9,2,5,2,5,0,35,5.0,2,0.0,0,9,1,5,12,2,1,5,0,15,20,1
2775,42612,76MsyfoydlyTteuthkqqJhd4o0zqGEPQ,5Gyp41oLVo7Gg7vF4vpmggWP5MU70QO6,12,10,6,0,5,3,4,0,28,4.0,3,0.0,0,6,0,5,10,3,0,4,0,11,17,1
2776,42624,uQjl8NGtIQkRfoe9edBiMgtYYmdkzVXR,5Gyp41oLVo7Gg7vF4vpmggWP5MU70QO6,35,122,60,21,11,5,23,0,242,34.57142857142857,9,0.0,26,60,15,11,96,5,6,23,0,112,130,1
2777,42665,TFXVbyAsdd8loouVJh53Ci08NPknpb3s,5Gyp41oLVo7Gg7vF4vpmggWP5MU70QO6,12,11,6,0,2,1,6,1,27,3.857142857142857,2,0.0,1,6,0,2,10,1,0,6,1,9,18,1
2778,42668,9H1419fPuuDHWR9HwJ4H1Qz7EYdAWgF5,5Gyp41oLVo7Gg7vF4vpmggWP5MU70QO6,1,0,0,0,0,0,1,0,1,0.14285714285714285,1,0.0,0,0,0,0,0,0,0,1,0,0,1,1
2779,42673,BKMUcOBGaQN1mC31CqWMGNL1FVFpsXK6,5Gyp41oLVo7Gg7vF4vpmggWP5MU70QO6,5,6,3,0,1,0,3,0,13,1.8571428571428572,3,0.0,0,3,0,1,6,0,0,3,0,4,9,1
2780,42725,LJlIg9qp8OR0lcGfKhExv2RRH6wpMrFW,5Gyp41oLVo7Gg7vF4vpmggWP5MU70QO6,24,37,13,4,8,0,15,0,77,11.0,4,0.0,9,13,2,8,28,0,2,15,0,32,45,1
2781,42752,Vqze90OfEzcSxQR4V2mgaBI72yQMkjOI,5Gyp41oLVo7Gg7vF4vpmggWP5MU70QO6,15,13,8,6,4,2,13,2,48,6.857142857142857,1,0.0,1,8,3,4,12,2,3,13,2,16,32,1
2782,42757,KJoE9unyVuT2DeHS57E6xLFn5ZLvwVq9,5Gyp41oLVo7Gg7vF4vpmggWP5MU70QO6,29,48,19,23,8,4,5,0,107,15.285714285714286,2,0.0,22,19,18,8,26,4,5,5,0,67,40,0
2783,42767,ruOt15ngWkrw7KeeBfsTuYT6jUinN1wc,5Gyp41oLVo7Gg7vF4vpmggWP5MU70QO6,8,7,5,0,3,0,3,0,18,2.5714285714285716,2,0.0,0,5,0,3,7,0,0,3,0,8,10,1
2784,42783,PZOAKJpr4tvUdUBjEAo2PyZb1WPiWGKg,5Gyp41oLVo7Gg7vF4vpmggWP5MU70QO6,24,57,31,10,8,6,9,1,122,17.428571428571427,2,0.0,19,31,8,8,38,6,2,9,1,66,56,1
2785,42822,hf7YI3B1kTTuvmd2vS9DIoiPGXbrQyBH,5Gyp41oLVo7Gg7vF4vpmggWP5MU70QO6,31,71,36,21,14,1,16,0,159,22.714285714285715,7,0.0,25,36,15,14,46,1,6,16,0,90,69,1
2786,42823,Gj3E64ugEAQBSvqnqCb1XRhG4lRAaeyl,5Gyp41oLVo7Gg7vF4vpmggWP5MU70QO6,12,13,8,0,3,0,8,0,32,4.571428571428571,2,0.0,0,8,0,3,13,0,0,8,0,11,21,1
2787,42829,llxTRiluZGftr8xJaXSwJljp3xP1zOiw,5Gyp41oLVo7Gg7vF4vpmggWP5MU70QO6,2,0,0,0,0,0,2,0,2,0.2857142857142857,1,0.0,0,0,0,0,0,0,0,2,0,0,2,1
2788,42838,zVdtg8NVS1UKsR7hBTuXsHvQ0Y2M8ZjR,5Gyp41oLVo7Gg7vF4vpmggWP5MU70QO6,54,220,99,62,55,52,48,5,541,77.28571428571429,15,0.0,55,99,44,55,165,52,18,48,5,253,288,0
2789,42862,Cz1MALoI2PsgcnwuxZzMreDeeJQWPhNY,5Gyp41oLVo7Gg7vF4vpmggWP5MU70QO6,1,0,0,0,0,0,1,0,1,0.14285714285714285,1,0.0,0,0,0,0,0,0,0,1,0,0,1,1
2790,42892,MkmHvjSbYbqtqaatv1G3CqgDZI0wlGAK,5Gyp41oLVo7Gg7vF4vpmggWP5MU70QO6,25,84,50,46,19,6,23,8,236,33.714285714285715,8,0.0,11,50,33,19,73,6,13,23,8,113,123,1
2791,42894,4lMCQeDalZibIqNpSbwAQSTC9B54JA0T,5Gyp41oLVo7Gg7vF4vpmggWP5MU70QO6,9,9,3,0,3,0,5,0,20,2.857142857142857,1,0.0,4,3,0,3,5,0,0,5,0,10,10,1
2792,42924,J4UXFQZe2esHAAP8EgxtBhubvEMwPUfX,5Gyp41oLVo7Gg7vF4vpmggWP5MU70QO6,1,0,0,0,0,0,1,0,1,0.14285714285714285,1,0.0,0,0,0,0,0,0,0,1,0,0,1,1
2793,42948,bhtGxozhVNlzdq3dWRuRh5gPdRPZBokV,5Gyp41oLVo7Gg7vF4vpmggWP5MU70QO6,31,66,37,30,12,2,14,0,161,23.0,7,0.0,18,37,20,12,48,2,10,14,0,87,74,0
2794,42961,P7pM2KXNzs4FXZpMC7rALMB2m6SdjKtS,5Gyp41oLVo7Gg7vF4vpmggWP5MU70QO6,1,0,0,0,0,0,1,0,1,0.14285714285714285,1,0.0,0,0,0,0,0,0,0,1,0,0,1,1
2795,42992,FHLCitbEDOO4edZKc13ZGQYp8PFDoEbA,5Gyp41oLVo7Gg7vF4vpmggWP5MU70QO6,11,4,3,0,3,2,6,1,19,2.7142857142857144,2,0.0,1,3,0,3,3,2,0,6,1,7,12,1
2796,42997,iJftBP3zncmjUCwGWSZ77IUrDb3Dt8rz,5Gyp41oLVo7Gg7vF4vpmggWP5MU70QO6,10,6,4,0,3,1,4,0,18,2.5714285714285716,1,0.0,0,4,0,3,6,1,0,4,0,7,11,1
2797,43043,QAguKdvn52pCJKW91rO3BCY8l8ZCAdvQ,5Gyp41oLVo7Gg7vF4vpmggWP5MU70QO6,39,124,58,22,27,19,38,4,292,41.714285714285715,14,0.0,24,58,17,27,100,19,5,38,4,126,166,0
2798,43066,VfXLVSMadpLR6dOrmGK0mfp43tDDaQTe,5Gyp41oLVo7Gg7vF4vpmggWP5MU70QO6,2,0,0,0,0,0,4,0,4,0.5714285714285714,1,0.0,0,0,0,0,0,0,0,4,0,0,4,1
2799,43109,j8vQBepjKMlh4tjkZefoCNI7tigVvraY,5Gyp41oLVo7Gg7vF4vpmggWP5MU70QO6,11,12,6,2,5,0,3,0,28,4.0,1,0.0,5,6,1,5,7,0,1,3,0,17,11,1
2800,43185,5vnywZCHdzItiyRXwxi8AQx0I1FZ74Wh,5Gyp41oLVo7Gg7vF4vpmggWP5MU70QO6,5,3,1,0,1,0,1,0,6,0.8571428571428571,1,0.0,0,1,0,1,3,0,0,1,0,2,4,1
2801,43186,OTADDfXEdjbhqOe8x6BG6zzzmbj4dONF,5Gyp41oLVo7Gg7vF4vpmggWP5MU70QO6,1,0,0,0,0,0,2,0,2,0.2857142857142857,1,0.0,0,0,0,0,0,0,0,2,0,0,2,1
2802,43204,p60my9bd7Og8fU9JTNJwRUF33esyebLh,5Gyp41oLVo7Gg7vF4vpmggWP5MU70QO6,4,2,1,0,1,0,1,0,5,0.7142857142857143,1,0.0,0,1,0,1,2,0,0,1,0,2,3,1
2803,43222,FKUOiQ7mB83YM8up0jg2s7w94Nin9PDr,5Gyp41oLVo7Gg7vF4vpmggWP5MU70QO6,29,78,36,14,17,2,12,0,159,22.714285714285715,4,0.0,30,36,8,17,48,2,6,12,0,91,68,1
2804,43227,00NyFDc4lSZf1P8ucpEoM7aUokrApUCD,5Gyp41oLVo7Gg7vF4vpmggWP5MU70QO6,9,5,2,0,2,1,3,1,14,2.0,1,0.0,0,2,0,2,5,1,0,3,1,4,10,1
2805,43244,97VO9s7PzgyUq9wiAbU39P4Yyn56hGke,5Gyp41oLVo7Gg7vF4vpmggWP5MU70QO6,5,3,1,0,0,0,2,0,6,0.8571428571428571,1,0.0,0,1,0,0,3,0,0,2,0,1,5,1
2806,43253,L6byFv3ZEyrwSeDN11Yz2Yw0YVBxo5al,5Gyp41oLVo7Gg7vF4vpmggWP5MU70QO6,1,0,0,0,0,0,1,0,1,0.14285714285714285,1,0.0,0,0,0,0,0,0,0,1,0,0,1,1
2807,43271,cAjVoc8wOYDE8lScDAhEgvHdzkmg6Oh2,5Gyp41oLVo7Gg7vF4vpmggWP5MU70QO6,1,0,0,0,0,0,1,0,1,0.14285714285714285,1,0.0,0,0,0,0,0,0,0,1,0,0,1,1
2808,43273,wmNYHs69T6CHydhCxfzhydbjA79LMuTD,5Gyp41oLVo7Gg7vF4vpmggWP5MU70QO6,23,47,25,3,12,6,12,1,106,15.142857142857142,6,0.0,9,25,2,12,38,6,1,12,1,48,58,0
2809,43280,7HQI7mn2kOQ2GQbTbRnlEfLi23yvP3iW,5Gyp41oLVo7Gg7vF4vpmggWP5MU70QO6,5,6,2,0,0,0,1,0,9,1.2857142857142858,1,0.0,0,2,0,0,6,0,0,1,0,2,7,1
2810,43298,32oyj5KQNMk4hi2FDjsLzckyX0oTBu94,5Gyp41oLVo7Gg7vF4vpmggWP5MU70QO6,1,0,0,0,0,0,1,0,1,0.14285714285714285,1,0.0,0,0,0,0,0,0,0,1,0,0,1,1
2811,43299,dWHieHYcD5sJPdXBDEU7p6ERE8GLy21y,5Gyp41oLVo7Gg7vF4vpmggWP5MU70QO6,18,15,9,5,4,1,7,1,42,6.0,2,0.0,1,9,3,4,14,1,2,7,1,17,25,1
2812,43304,hGRbVhPfIZgQbsXapr6yYorOesMrDVES,5Gyp41oLVo7Gg7vF4vpmggWP5MU70QO6,7,5,1,0,2,0,3,0,11,1.5714285714285714,1,0.0,1,1,0,2,4,0,0,3,0,4,7,1
2813,43322,QtC4u1cp5XPjpftAYBiUc5gRIvkjYsKW,5Gyp41oLVo7Gg7vF4vpmggWP5MU70QO6,1,0,0,0,0,0,1,0,1,0.14285714285714285,1,0.0,0,0,0,0,0,0,0,1,0,0,1,1
2814,43329,CnhEMnwVEHINgALkGyXSrJuouR8sAbhX,5Gyp41oLVo7Gg7vF4vpmggWP5MU70QO6,1,0,0,0,0,0,1,0,1,0.14285714285714285,1,0.0,0,0,0,0,0,0,0,1,0,0,1,1
2815,43360,43Vu5GdpgaDIO0UCTmo0BcEGYByItL9w,5Gyp41oLVo7Gg7vF4vpmggWP5MU70QO6,1,0,0,0,0,0,1,0,1,0.14285714285714285,1,0.0,0,0,0,0,0,0,0,1,0,0,1,1
2816,43369,8ahxSRQbWy4vPD4cYpRqfvINjHUg6K9P,5Gyp41oLVo7Gg7vF4vpmggWP5MU70QO6,7,3,2,0,2,0,2,0,9,1.2857142857142858,1,0.0,0,2,0,2,3,0,0,2,0,4,5,1
2817,43371,oe42qhXjeEjQuga6r181bRbPriFpqVix,5Gyp41oLVo7Gg7vF4vpmggWP5MU70QO6,9,9,3,8,3,0,3,0,26,3.7142857142857144,1,0.0,4,3,4,3,5,0,4,3,0,14,12,1
2818,43375,IeFJNMkGYtHM1fI1bOxjKNR0xs3f8eOI,5Gyp41oLVo7Gg7vF4vpmggWP5MU70QO6,16,17,10,8,5,0,16,0,56,8.0,9,0.0,4,10,5,5,13,0,3,16,0,24,32,0
2819,43388,j0SxBmQibmRjAaD1ulodQIAoOk5FxRjd,5Gyp41oLVo7Gg7vF4vpmggWP5MU70QO6,9,11,6,0,4,0,5,0,26,3.7142857142857144,5,0.0,0,6,0,4,11,0,0,5,0,10,16,1
2820,43398,o7l3PNeVIF0KFbKUxAraXosVaTUbHolk,3VkHkmOtom3jM2wCu94xgzzu1d6Dn7or,10,12,2,0,0,39,12,0,65,9.285714285714286,5,0.0,0,2,0,0,12,39,0,12,0,2,63,1
2821,43417,D4OCd24hr1vlj5ann2gF8MXtwkygSmZN,3VkHkmOtom3jM2wCu94xgzzu1d6Dn7or,80,141,55,46,52,0,32,0,326,46.57142857142857,9,0.0,66,55,45,52,75,0,1,32,0,218,108,0
2822,43438,uMEUDlZ1tL8WoZ2EmL0CStSYwA0zOal8,3VkHkmOtom3jM2wCu94xgzzu1d6Dn7or,72,166,60,39,40,7,32,2,346,49.42857142857143,13,0.0,64,60,32,40,102,7,7,32,2,196,150,0
2823,43444,Ru7y8duae6LbAc4AWXTCrVmvsCjQD1Id,3VkHkmOtom3jM2wCu94xgzzu1d6Dn7or,30,47,25,0,17,93,21,2,205,29.285714285714285,8,0.0,7,25,0,17,40,93,0,21,2,49,156,0
2824,43445,FogYrI2DBYQJS0Y2CCsXzbRDHnAOEuf5,3VkHkmOtom3jM2wCu94xgzzu1d6Dn7or,1,0,0,0,0,0,1,0,1,0.14285714285714285,1,0.0,0,0,0,0,0,0,0,1,0,0,1,1
2825,43500,nvDU7bHbucx9dxF7Bb2hROl3ydsRR8KW,5Gyp41oLVo7Gg7vF4vpmggWP5MU70QO6,6,7,2,0,3,0,2,0,14,2.0,1,0.0,0,2,0,3,7,0,0,2,0,5,9,1
2826,43535,9jZsAxMdQXvLjxKIorcfAyZ7kTyyk2m3,5Gyp41oLVo7Gg7vF4vpmggWP5MU70QO6,16,14,8,20,6,7,3,0,58,8.285714285714286,2,0.0,4,8,12,6,10,7,8,3,0,30,28,1
2827,43540,0jKQy4qjVAbf7KnmK0z7D4Rd4esbEOKx,5Gyp41oLVo7Gg7vF4vpmggWP5MU70QO6,10,3,2,6,1,2,9,2,25,3.5714285714285716,1,0.0,1,2,5,1,2,2,1,9,2,9,16,1
2828,43545,mmise9ZoT8sOMF3ngv5JfjmucOFyNMhB,5Gyp41oLVo7Gg7vF4vpmggWP5MU70QO6,6,1,1,0,1,0,3,0,6,0.8571428571428571,1,0.0,0,1,0,1,1,0,0,3,0,2,4,1
2829,43547,umQZ2iL6LkRNPUsdvNO54bjSWS7c2PrT,5Gyp41oLVo7Gg7vF4vpmggWP5MU70QO6,47,145,84,47,23,48,44,2,393,56.142857142857146,9,0.0,26,84,37,23,119,48,10,44,2,170,223,0
2830,43569,q1Yhi8ZMaTKIWtjkqcIhA9aMzo2tILs0,5Gyp41oLVo7Gg7vF4vpmggWP5MU70QO6,8,3,2,0,2,2,6,0,15,2.142857142857143,1,0.0,0,2,0,2,3,2,0,6,0,4,11,1
2831,43586,nYDaWGS2eCaz2ctJp9MRoxxHvQjUsB3R,5Gyp41oLVo7Gg7vF4vpmggWP5MU70QO6,6,2,1,0,1,0,5,0,9,1.2857142857142858,1,0.0,0,1,0,1,2,0,0,5,0,2,7,1
2832,43599,rb0bCeAP0PjUKM6QZmb5eDbdcmhSPRHl,5Gyp41oLVo7Gg7vF4vpmggWP5MU70QO6,1,0,0,0,0,0,1,0,1,0.14285714285714285,1,0.0,0,0,0,0,0,0,0,1,0,0,1,1
2833,43636,Djtv0PgEw9uZSQc7WiXmZsJgnFOxrvrt,5Gyp41oLVo7Gg7vF4vpmggWP5MU70QO6,19,51,13,19,8,49,10,1,151,21.571428571428573,5,0.0,11,13,11,8,40,49,8,10,1,43,108,0
2834,43641,ic2lNYBVb2jpZFbLxIr3dTwER79BLmXr,5Gyp41oLVo7Gg7vF4vpmggWP5MU70QO6,5,2,1,0,1,0,3,0,7,1.0,1,0.0,0,1,0,1,2,0,0,3,0,2,5,1
2835,43647,h6BsLrA2Q76qfUqgsVlAbhhJHS6p79uN,5Gyp41oLVo7Gg7vF4vpmggWP5MU70QO6,4,2,1,0,1,0,2,0,6,0.8571428571428571,1,0.0,0,1,0,1,2,0,0,2,0,2,4,1
2836,43649,Z1bGhtGmS6C8OjUf7z2ZCu8g4GygavBf,5Gyp41oLVo7Gg7vF4vpmggWP5MU70QO6,16,91,44,0,11,7,33,6,192,27.428571428571427,5,0.0,35,44,0,11,56,7,0,33,6,90,102,1
2837,43652,t6G2HJgvxm2eWxa54HUBXpV1ffn1iJDl,7GRhBDsirIGkRZBtSMEzNTyDr2JQm4xx,39,41,11,32,11,8,10,0,113,16.142857142857142,2,0.0,13,11,17,11,28,8,15,10,0,52,61,1
2838,43661,12aJ9sgIETRGmRcizwaK1vDrqEhnRGPU,7GRhBDsirIGkRZBtSMEzNTyDr2JQm4xx,4,2,0,0,0,0,6,0,8,1.1428571428571428,2,0.0,0,0,0,0,2,0,0,6,0,0,8,0
2839,43664,crwmDLeslvNKw8pGvXyNPlPr8wNVW5Va,7GRhBDsirIGkRZBtSMEzNTyDr2JQm4xx,4,2,1,0,1,0,1,0,5,0.7142857142857143,1,0.0,0,1,0,1,2,0,0,1,0,2,3,1
2840,43665,NrHk4qmJXuD0TsjkQSnghKpk9ZjGAOyU,7GRhBDsirIGkRZBtSMEzNTyDr2JQm4xx,1,0,0,0,0,0,1,0,1,0.14285714285714285,1,0.0,0,0,0,0,0,0,0,1,0,0,1,1
2841,43668,s78QKjJp2qJWP86SKhU5XdBMn22opRSP,7GRhBDsirIGkRZBtSMEzNTyDr2JQm4xx,21,21,9,0,11,0,3,0,44,6.285714285714286,2,0.0,9,9,0,11,12,0,0,3,0,29,15,0
2842,43670,toFc16b10zKbPH9J9fAvCYQwPikiAuYv,7GRhBDsirIGkRZBtSMEzNTyDr2JQm4xx,1,0,0,0,0,0,2,0,2,0.2857142857142857,1,0.0,0,0,0,0,0,0,0,2,0,0,2,1
2843,43673,Y53vJNK6NsQxTqlgv0AKozWzT5IkWSVb,7GRhBDsirIGkRZBtSMEzNTyDr2JQm4xx,6,5,1,0,0,0,2,0,8,1.1428571428571428,1,0.0,0,1,0,0,5,0,0,2,0,1,7,0
2844,43675,gnTcbZ4BOuQk0BfuzZDpGiEEYJSGOrYu,7GRhBDsirIGkRZBtSMEzNTyDr2JQm4xx,33,54,7,17,13,0,2,0,93,13.285714285714286,1,0.0,31,7,10,13,23,0,7,2,0,61,32,0
2845,43676,1xkoUHkZYS3vEMwGpVsB3i4SGo9SpX8l,7GRhBDsirIGkRZBtSMEzNTyDr2JQm4xx,7,3,2,0,2,0,2,0,9,1.2857142857142858,1,0.0,0,2,0,2,3,0,0,2,0,4,5,1
2846,43678,aVeyGdrz6Ir4LmiLkJqBoRjG1lQ7MsV8,7GRhBDsirIGkRZBtSMEzNTyDr2JQm4xx,6,9,3,0,1,0,2,0,15,2.142857142857143,1,0.0,4,3,0,1,5,0,0,2,0,8,7,1
2847,43680,eakdJaYNzY2KmT602U8CscAjNHHpGkgl,7GRhBDsirIGkRZBtSMEzNTyDr2JQm4xx,6,7,0,0,0,0,3,0,10,1.4285714285714286,1,0.0,1,0,0,0,6,0,0,3,0,1,9,1
2848,43682,aw4yklySZ6X6NR1UQ1UVCI8ad86zeBd9,7GRhBDsirIGkRZBtSMEzNTyDr2JQm4xx,2,0,0,0,0,0,3,0,3,0.42857142857142855,1,0.0,0,0,0,0,0,0,0,3,0,0,3,1
2849,43686,ieZvhJkTCgLXDudCJD5a3Q8XrFF7c982,7GRhBDsirIGkRZBtSMEzNTyDr2JQm4xx,26,55,18,0,15,2,3,1,94,13.428571428571429,1,0.0,34,18,0,15,21,2,0,3,1,67,27,1
2850,43687,A7tHWOZtAjCVDU6Pkr6MtHjmqydOP5Uv,7GRhBDsirIGkRZBtSMEzNTyDr2JQm4xx,1,0,0,0,0,0,1,0,1,0.14285714285714285,1,0.0,0,0,0,0,0,0,0,1,0,0,1,1
2851,43688,xGVjN54MWUnGiNvAvxY0cQuGMCPuQlWa,7GRhBDsirIGkRZBtSMEzNTyDr2JQm4xx,23,50,18,8,12,3,7,0,98,14.0,1,0.0,16,18,5,12,34,3,3,7,0,51,47,1
2852,43690,FpmZG28mfvYxYytrb579vFO9KWSaFKbr,7GRhBDsirIGkRZBtSMEzNTyDr2JQm4xx,1,0,0,0,0,0,1,0,1,0.14285714285714285,1,0.0,0,0,0,0,0,0,0,1,0,0,1,1
2853,43691,0Cj3x86BuVbVsoa8L3TC7owR7C7fzN1u,7GRhBDsirIGkRZBtSMEzNTyDr2JQm4xx,2,0,0,0,0,0,2,0,2,0.2857142857142857,1,0.0,0,0,0,0,0,0,0,2,0,0,2,0
2854,43692,GEz39roWwtdxB5Iy4Eh7CCr3IDWGQuBF,7GRhBDsirIGkRZBtSMEzNTyDr2JQm4xx,1,0,0,0,0,0,2,0,2,0.2857142857142857,1,0.0,0,0,0,0,0,0,0,2,0,0,2,0
2855,43695,z0WA70zlCYNC0D6ukf1TU1erCNwbETr4,7GRhBDsirIGkRZBtSMEzNTyDr2JQm4xx,4,3,0,0,0,0,1,0,4,0.5714285714285714,1,0.0,0,0,0,0,3,0,0,1,0,0,4,1
2856,43703,dGN0aBrc4HEf76OfjPbKhXTbhv3uUUfQ,7GRhBDsirIGkRZBtSMEzNTyDr2JQm4xx,1,0,0,0,0,0,1,0,1,0.14285714285714285,1,0.0,0,0,0,0,0,0,0,1,0,0,1,1
2857,43711,astaomdRwCWRae7GfR14orvLqERJnyWg,7GRhBDsirIGkRZBtSMEzNTyDr2JQm4xx,27,34,18,30,10,1,5,3,101,14.428571428571429,3,0.0,11,18,29,10,23,1,1,5,3,68,33,0
2858,43712,HmWRxxzZH33xiAvl793Co880fq0frlVo,7GRhBDsirIGkRZBtSMEzNTyDr2JQm4xx,60,186,4,30,10,37,16,0,283,40.42857142857143,6,0.0,33,4,15,10,153,37,15,16,0,62,221,0
2859,43715,NhRNk4mLUp7p5Zk6Fq6M7Wts8nU0uXtP,7GRhBDsirIGkRZBtSMEzNTyDr2JQm4xx,2,0,0,0,0,0,2,0,2,0.2857142857142857,1,0.0,0,0,0,0,0,0,0,2,0,0,2,0
2860,43720,Xl1we0e09OJ8ZoVNnU3bW8wK34y6zhWd,7GRhBDsirIGkRZBtSMEzNTyDr2JQm4xx,3,0,0,0,0,0,3,0,3,0.42857142857142855,1,0.0,0,0,0,0,0,0,0,3,0,0,3,1
2861,43722,e1obZM1bAHvfZHkoYcbAKIAxfJj6crMT,7GRhBDsirIGkRZBtSMEzNTyDr2JQm4xx,5,2,1,0,1,0,3,0,7,1.0,1,0.0,0,1,0,1,2,0,0,3,0,2,5,1
2862,43723,oAAfZtvy6SFGuoVCQRrpt3GFY5Q7HK2Q,7GRhBDsirIGkRZBtSMEzNTyDr2JQm4xx,1,0,0,0,0,0,1,0,1,0.14285714285714285,1,0.0,0,0,0,0,0,0,0,1,0,0,1,1
2863,43724,bbBEHMN2ei4wG0H7nW7BSSaBcqs1CEnx,7GRhBDsirIGkRZBtSMEzNTyDr2JQm4xx,13,37,11,0,17,1,10,0,76,10.857142857142858,1,0.0,21,11,0,17,16,1,0,10,0,49,27,1
2864,43725,6QRfbLtBjFn7GPZrNgqut0wbkSDHHl9M,7GRhBDsirIGkRZBtSMEzNTyDr2JQm4xx,17,12,1,60,1,0,1,0,75,10.714285714285714,1,0.0,4,1,55,1,8,0,5,1,0,61,14,1
2865,43729,qeWOInijveNxEnqq9sukLDxMYUdDSaqr,7GRhBDsirIGkRZBtSMEzNTyDr2JQm4xx,16,21,1,9,1,2,6,1,41,5.857142857142857,1,0.0,12,1,6,1,9,2,3,6,1,20,21,0
2866,43730,kBnoFgMnVWJjqzAf1W1HOC08sES7LnRY,7GRhBDsirIGkRZBtSMEzNTyDr2JQm4xx,1,0,0,0,0,0,1,0,1,0.14285714285714285,1,0.0,0,0,0,0,0,0,0,1,0,0,1,0
2867,43743,PX7SKELqfg9GcSxv3pfpJ8wHrnBmDB4L,7GRhBDsirIGkRZBtSMEzNTyDr2JQm4xx,6,3,2,0,2,0,1,0,8,1.1428571428571428,1,0.0,0,2,0,2,3,0,0,1,0,4,4,1
2868,43744,hmZiTeS7MpL9XKSxVzJIvoy7Uwns8WLt,7GRhBDsirIGkRZBtSMEzNTyDr2JQm4xx,13,15,8,4,5,2,11,1,46,6.571428571428571,2,0.0,2,8,3,5,13,2,1,11,1,18,28,0
2869,43745,NIlxh2g7VTAquieuVc9RGErPkOzbSh2Z,7GRhBDsirIGkRZBtSMEzNTyDr2JQm4xx,11,22,6,0,5,0,1,0,34,4.857142857142857,1,0.0,0,6,0,5,22,0,0,1,0,11,23,1
2870,44022,PDXGFyBPYCflMZuvp1Ir4M4S3e0nyboZ,fbPkOYLVPtPgIt0MxizjfFJov3JbHyAi,11,30,6,0,2,0,4,0,42,6.0,3,0.0,3,6,0,2,27,0,0,4,0,11,31,1
2871,44043,s8VWFWImIYSA2JA5l16L3WRLI25ddNXq,fbPkOYLVPtPgIt0MxizjfFJov3JbHyAi,1,0,0,0,0,0,1,0,1,0.14285714285714285,1,0.0,0,0,0,0,0,0,0,1,0,0,1,1
2872,44077,O8WpIn8YZlC9fwaPz6HgwkG3VYK9Pnk2,fbPkOYLVPtPgIt0MxizjfFJov3JbHyAi,5,3,2,0,1,0,1,0,7,1.0,1,0.0,0,2,0,1,3,0,0,1,0,3,4,1
2873,44085,k3g7vGyejcBHPAYTerpXAPXP3aDlXECc,fbPkOYLVPtPgIt0MxizjfFJov3JbHyAi,1,0,0,0,0,0,1,0,1,0.14285714285714285,1,0.0,0,0,0,0,0,0,0,1,0,0,1,1
2874,44101,VwVgSiouEmdKXwssd2MCisWFwFtWB9Im,fbPkOYLVPtPgIt0MxizjfFJov3JbHyAi,6,7,3,0,1,0,2,0,13,1.8571428571428572,1,0.0,0,3,0,1,7,0,0,2,0,4,9,1
2875,44106,futHw5ylJYoore6oNuefdx05Xc1Es6E8,fbPkOYLVPtPgIt0MxizjfFJov3JbHyAi,5,4,3,0,0,0,2,2,11,1.5714285714285714,1,0.0,0,3,0,0,4,0,0,2,2,3,8,1
2876,44117,0MmMvk8S1ad0tMPIPxO3E9ZWoQTH5ohX,fbPkOYLVPtPgIt0MxizjfFJov3JbHyAi,32,29,19,0,15,0,4,0,67,9.571428571428571,1,0.0,3,19,0,15,26,0,0,4,0,37,30,1
2877,44136,BF0qnZaKn6rKWwFuVZZ6evM5Lwl2Cgas,fbPkOYLVPtPgIt0MxizjfFJov3JbHyAi,1,0,0,0,0,0,1,0,1,0.14285714285714285,1,0.0,0,0,0,0,0,0,0,1,0,0,1,1
2878,44178,ZUj8ciewoY1krerme1rA06bZgMQzwUwF,fbPkOYLVPtPgIt0MxizjfFJov3JbHyAi,6,3,2,0,1,0,2,0,8,1.1428571428571428,1,0.0,0,2,0,1,3,0,0,2,0,3,5,0
2879,44194,nkWrffpo6kobU01lUWepcu6aQb60BdxH,fbPkOYLVPtPgIt0MxizjfFJov3JbHyAi,3,4,2,0,0,0,2,0,8,1.1428571428571428,2,0.0,0,2,0,0,4,0,0,2,0,2,6,0
2880,44208,9nBDwXR4PojGZeJgF10uxjH1va7sf1sb,fbPkOYLVPtPgIt0MxizjfFJov3JbHyAi,3,2,1,0,0,0,1,0,4,0.5714285714285714,1,0.0,0,1,0,0,2,0,0,1,0,1,3,1
2881,44228,R1FqqBKIoe5gb1Zm4cRd6C2dKym4oN3J,fbPkOYLVPtPgIt0MxizjfFJov3JbHyAi,6,7,4,0,1,0,1,0,13,1.8571428571428572,1,0.0,0,4,0,1,7,0,0,1,0,5,8,0
2882,44270,GMzSpgZQ6jzVsfHn8W8i83JsYNxnP00b,fbPkOYLVPtPgIt0MxizjfFJov3JbHyAi,14,23,10,0,5,0,3,0,41,5.857142857142857,1,0.0,2,10,0,5,21,0,0,3,0,17,24,1
2883,45309,cvmNQvB8C9tzfr5JL4ScqNRXsUkWS0qq,RXDvfPUBYFlVdlueBFbLW0mhhAyGEqpt,13,46,23,0,1,33,3,4,110,15.714285714285714,1,0.0,2,23,0,1,44,33,0,3,4,26,84,0
2884,45312,JrU3mQXDsHM3JCMrGML8Gsd1f6KKBRz5,RXDvfPUBYFlVdlueBFbLW0mhhAyGEqpt,7,28,0,0,0,0,2,0,30,4.285714285714286,1,0.0,1,0,0,0,27,0,0,2,0,1,29,1
2885,45340,Q57EC9WScoWjECRp7MT77bmBt9oZMVVG,RXDvfPUBYFlVdlueBFbLW0mhhAyGEqpt,23,34,21,8,9,97,40,1,210,30.0,9,0.0,2,21,7,9,32,97,1,40,1,39,171,0
2886,45366,4v506xwnN2gFG9XeSNIeiBlmXImooi1O,RXDvfPUBYFlVdlueBFbLW0mhhAyGEqpt,3,2,0,0,0,0,1,0,3,0.42857142857142855,1,0.0,0,0,0,0,2,0,0,1,0,0,3,0
2887,46389,gGFmJyNMerYTj0kT96HuKIvL9JdTq2vY,RXDvfPUBYFlVdlueBFbLW0mhhAyGEqpt,40,43,25,74,17,20,8,0,187,26.714285714285715,3,0.0,13,25,67,17,30,20,7,8,0,122,65,0
2888,46505,kBNWoa4A4jmNOoJaSAupB8wyNzpsoJAN,fbPkOYLVPtPgIt0MxizjfFJov3JbHyAi,27,27,15,17,8,0,3,0,70,10.0,3,0.0,6,15,13,8,21,0,4,3,0,42,28,0
2889,46511,xeCFX5y6IRjmYKFA9y4Rgt3SG4YPELud,fbPkOYLVPtPgIt0MxizjfFJov3JbHyAi,24,73,26,8,12,10,7,0,136,19.428571428571427,3,0.0,7,26,8,12,66,10,0,7,0,53,83,0
2890,46534,KvCAdo1odeI84idtqyQZyVEKdaH6IDdM,fbPkOYLVPtPgIt0MxizjfFJov3JbHyAi,8,5,3,1,1,0,2,0,12,1.7142857142857142,2,0.0,1,3,1,1,4,0,0,2,0,6,6,1
2891,46549,4ApVgPYGz6bz2SJLoGELpZ6RPnXwOa88,fbPkOYLVPtPgIt0MxizjfFJov3JbHyAi,9,20,6,4,6,3,5,0,44,6.285714285714286,3,0.0,9,6,3,6,11,3,1,5,0,24,20,0
2892,46569,EvnDUDuRuksYPdrCaUQQweT0GY5Najoh,fbPkOYLVPtPgIt0MxizjfFJov3JbHyAi,3,2,1,0,0,0,1,0,4,0.5714285714285714,1,0.0,0,1,0,0,2,0,0,1,0,1,3,1
2893,46580,sn1OZIzg3ZOiyRClBvvQLUKwx6tymOkC,fbPkOYLVPtPgIt0MxizjfFJov3JbHyAi,5,2,1,0,0,2,3,0,8,1.1428571428571428,1,0.0,0,1,0,0,2,2,0,3,0,1,7,1
2894,46588,yfppFvC7mTSlPuhod9GGDRPkzP1HmCAu,fbPkOYLVPtPgIt0MxizjfFJov3JbHyAi,14,11,5,6,4,0,4,0,30,4.285714285714286,2,0.0,3,5,5,4,8,0,1,4,0,17,13,1
2895,46646,2oTvbzieHn2y5oozeOgSnruqE6N0BtR5,5Gyp41oLVo7Gg7vF4vpmggWP5MU70QO6,17,17,12,0,6,30,8,0,73,10.428571428571429,6,0.0,0,12,0,6,17,30,0,8,0,18,55,1
2896,46649,ChPPAGWXLjJOcvxbkBJCrEsWXeInJLVE,5Gyp41oLVo7Gg7vF4vpmggWP5MU70QO6,2,0,0,0,0,0,2,0,2,0.2857142857142857,1,0.0,0,0,0,0,0,0,0,2,0,0,2,1
2897,46652,WlHV3frRLxQmTIY14HccRXj4N1zg8F2y,5Gyp41oLVo7Gg7vF4vpmggWP5MU70QO6,15,23,13,9,5,4,9,0,63,9.0,3,0.0,5,13,5,5,18,4,4,9,0,28,35,1
2898,46688,uyomj5PLSD8MuBnIm3UXNOM2zJB1f3kv,5Gyp41oLVo7Gg7vF4vpmggWP5MU70QO6,1,0,0,0,0,0,3,0,3,0.42857142857142855,1,0.0,0,0,0,0,0,0,0,3,0,0,3,1
2899,46702,A2ltJRV014QmRntZJESj7uXdpJ35f6dG,5Gyp41oLVo7Gg7vF4vpmggWP5MU70QO6,6,4,3,0,3,0,2,0,12,1.7142857142857142,2,0.0,0,3,0,3,4,0,0,2,0,6,6,1
2900,46731,UksrT9uZpkXySHca79ioRcFHJPZnRC7P,5Gyp41oLVo7Gg7vF4vpmggWP5MU70QO6,6,10,0,0,0,0,8,0,18,2.5714285714285716,3,0.0,0,0,0,0,10,0,0,8,0,0,18,1
2901,46746,3vqQLZ6JghUm5esklBRrz7FDiDY28Hou,5Gyp41oLVo7Gg7vF4vpmggWP5MU70QO6,1,0,0,0,0,0,1,0,1,0.14285714285714285,1,0.0,0,0,0,0,0,0,0,1,0,0,1,1
2902,46797,2ohWJM8Yz0bj21lrvUC1zfEo5S0znXME,5Gyp41oLVo7Gg7vF4vpmggWP5MU70QO6,7,3,2,0,2,0,2,0,9,1.2857142857142858,1,0.0,0,2,0,2,3,0,0,2,0,4,5,1
2903,46814,OjGyl0UXyxUIsMjT5wg70EZca2HITJbI,5Gyp41oLVo7Gg7vF4vpmggWP5MU70QO6,7,8,0,2,0,0,1,0,11,1.5714285714285714,1,0.0,3,0,1,0,5,0,1,1,0,4,7,1
2904,46815,qKYtIVDmi6VA6pm5FT1o0wAtundA5Xuz,5Gyp41oLVo7Gg7vF4vpmggWP5MU70QO6,2,0,0,0,0,0,2,0,2,0.2857142857142857,1,0.0,0,0,0,0,0,0,0,2,0,0,2,1
2905,46820,PqjTLf02cAkV5YbASLPzwWc5VEK93PK4,5Gyp41oLVo7Gg7vF4vpmggWP5MU70QO6,1,0,0,0,0,0,1,0,1,0.14285714285714285,1,0.0,0,0,0,0,0,0,0,1,0,0,1,1
2906,46825,udPAdZACFu9qQIos0rVmiiJQKeh3MpdC,5Gyp41oLVo7Gg7vF4vpmggWP5MU70QO6,6,1,1,0,1,0,3,0,6,0.8571428571428571,1,0.0,0,1,0,1,1,0,0,3,0,2,4,1
2907,46841,0dms1IW6FOb0POIRwTHzUSJrRJ5hu0UE,5Gyp41oLVo7Gg7vF4vpmggWP5MU70QO6,4,2,0,0,0,0,3,0,5,0.7142857142857143,2,0.0,0,0,0,0,2,0,0,3,0,0,5,1
2908,46874,IJVC32xhcxjduQ5Gn9dQV405cC7i6x7I,5Gyp41oLVo7Gg7vF4vpmggWP5MU70QO6,1,0,0,0,0,0,2,0,2,0.2857142857142857,2,0.0,0,0,0,0,0,0,0,2,0,0,2,1
2909,46875,rGQTQPCj4MkWBrqDuJjICbRv72TLNOkd,5Gyp41oLVo7Gg7vF4vpmggWP5MU70QO6,35,124,45,31,26,0,8,0,234,33.42857142857143,10,0.0,30,45,23,26,94,0,8,8,0,124,110,1
2910,46880,R23hQIkxpjGDipcAUB8Dm9M15B8oN1UL,5Gyp41oLVo7Gg7vF4vpmggWP5MU70QO6,59,289,100,64,58,62,44,2,619,88.42857142857143,17,0.0,72,100,57,58,217,62,7,44,2,287,332,1
2911,46885,vPWxY9z39Ezw02NfLhJz3CxUkYQ2CwWv,5Gyp41oLVo7Gg7vF4vpmggWP5MU70QO6,11,7,3,0,2,3,6,1,22,3.142857142857143,1,0.0,0,3,0,2,7,3,0,6,1,5,17,1
2912,46895,KkdnagFJtwwq5n9Iuy7rnQaTqa2llFa9,5Gyp41oLVo7Gg7vF4vpmggWP5MU70QO6,1,0,0,0,0,0,1,0,1,0.14285714285714285,1,0.0,0,0,0,0,0,0,0,1,0,0,1,1
2913,46901,Zdg1uIW24XoYJfffRXskUWqO3GRGh1cm,5Gyp41oLVo7Gg7vF4vpmggWP5MU70QO6,1,0,0,0,0,0,1,0,1,0.14285714285714285,1,0.0,0,0,0,0,0,0,0,1,0,0,1,0
2914,46939,6CZ44kCZyXFJv3rUR0UsacGRiDDxYx36,5Gyp41oLVo7Gg7vF4vpmggWP5MU70QO6,11,6,3,0,2,2,5,1,19,2.7142857142857144,1,0.0,0,3,0,2,6,2,0,5,1,5,14,1
2915,46942,fR2E6PlrT89XonVUCw1GWPWZCJzvjBZf,5Gyp41oLVo7Gg7vF4vpmggWP5MU70QO6,11,14,7,0,2,0,7,1,31,4.428571428571429,3,0.0,2,7,0,2,12,0,0,7,1,11,20,1
2916,46946,PzUJiLnP9HZJxQE6JmMTkx1KTzCMtAvI,5Gyp41oLVo7Gg7vF4vpmggWP5MU70QO6,46,129,61,30,49,18,25,1,313,44.714285714285715,11,0.0,38,61,24,49,91,18,6,25,1,172,141,0
2917,47053,7Rn3hb72XefKlNlHmNoLxuG2tiWg1aaJ,5Gyp41oLVo7Gg7vF4vpmggWP5MU70QO6,1,0,0,0,0,0,1,0,1,0.14285714285714285,1,0.0,0,0,0,0,0,0,0,1,0,0,1,1
2918,47086,AN4HmcutTb9ny7T8ABd8AMRexI72L33r,5Gyp41oLVo7Gg7vF4vpmggWP5MU70QO6,5,2,1,0,1,0,2,0,6,0.8571428571428571,1,0.0,0,1,0,1,2,0,0,2,0,2,4,1
2919,47099,kYP6qVgwLllQLSDA9DOLDLy7RCAMCJv3,5Gyp41oLVo7Gg7vF4vpmggWP5MU70QO6,1,0,0,0,0,0,2,0,2,0.2857142857142857,2,0.0,0,0,0,0,0,0,0,2,0,0,2,1
2920,47100,MSu8uokJrqtcfhrphP9QLIIZpwlmW0dM,5Gyp41oLVo7Gg7vF4vpmggWP5MU70QO6,10,3,2,0,2,0,5,1,13,1.8571428571428572,1,0.0,0,2,0,2,3,0,0,5,1,4,9,1
2921,47108,LBiRwhykvYlkPokFukwKE3pfXRl4e4Nw,5Gyp41oLVo7Gg7vF4vpmggWP5MU70QO6,26,56,34,11,13,3,15,0,132,18.857142857142858,7,0.0,8,34,8,13,48,3,3,15,0,63,69,1
2922,47109,7CSUleiRarcLK2kAOLxC7f9jw7tD5CFm,5Gyp41oLVo7Gg7vF4vpmggWP5MU70QO6,2,0,0,0,0,0,2,0,2,0.2857142857142857,1,0.0,0,0,0,0,0,0,0,2,0,0,2,1
2923,47130,EoD3EPwCtMDgR3Yh3AaRps1fXec0M2Cq,5Gyp41oLVo7Gg7vF4vpmggWP5MU70QO6,8,2,1,0,1,6,5,1,16,2.2857142857142856,1,0.0,0,1,0,1,2,6,0,5,1,2,14,1
2924,47161,NKPeepA3hQnHdKRyw33rMh6Zq6nPT7FT,5Gyp41oLVo7Gg7vF4vpmggWP5MU70QO6,7,1,1,0,1,1,4,1,9,1.2857142857142858,1,0.0,0,1,0,1,1,1,0,4,1,2,7,1
2925,47178,2IlOpdUgsPu5FVltj0flScFk4CeI7uHm,5Gyp41oLVo7Gg7vF4vpmggWP5MU70QO6,45,89,50,17,28,0,11,0,195,27.857142857142858,9,0.0,29,50,13,28,60,0,4,11,0,120,75,0
2926,47203,yTX2Jyu87XEx5E4DQx6ATrV6A8yZCtx8,5Gyp41oLVo7Gg7vF4vpmggWP5MU70QO6,13,12,5,4,1,0,6,1,29,4.142857142857143,1,0.0,4,5,2,1,8,0,2,6,1,12,17,1
2927,47216,Ps49WR7JAUr7AYdC7h3mibwaZxBToJ9x,5Gyp41oLVo7Gg7vF4vpmggWP5MU70QO6,5,3,0,0,0,0,2,0,5,0.7142857142857143,1,0.0,0,0,0,0,3,0,0,2,0,0,5,1
2928,47234,lhqDZaoCZ3mGBNgKLZFtbu2ZrL5HMtBO,5Gyp41oLVo7Gg7vF4vpmggWP5MU70QO6,12,11,4,8,2,0,3,0,28,4.0,2,0.0,4,4,4,2,7,0,4,3,0,14,14,1
2929,47260,WPblqwZeU5ajyY3BRhsjT3hZDiujE30u,5Gyp41oLVo7Gg7vF4vpmggWP5MU70QO6,6,5,2,0,1,0,4,0,12,1.7142857142857142,2,0.0,0,2,0,1,5,0,0,4,0,3,9,1
2930,47269,SsiBwdLtgBlftQTMaumuPfeXEp9eUN1X,5Gyp41oLVo7Gg7vF4vpmggWP5MU70QO6,7,2,2,0,2,0,9,0,15,2.142857142857143,1,0.0,0,2,0,2,2,0,0,9,0,4,11,1
2931,47279,3DMxdIMHShIiQg7VSSohBgQL1oCtuKe4,5Gyp41oLVo7Gg7vF4vpmggWP5MU70QO6,1,0,0,0,0,0,1,0,1,0.14285714285714285,1,0.0,0,0,0,0,0,0,0,1,0,0,1,1
2932,47302,MiCMgORFv7zcK9ifQfoTyiXHDYEy0Hya,5Gyp41oLVo7Gg7vF4vpmggWP5MU70QO6,1,0,0,0,0,0,2,0,2,0.2857142857142857,2,0.0,0,0,0,0,0,0,0,2,0,0,2,1
2933,47307,8foblRi4wVKVsqYG54QGJuMyU0kKzfol,5Gyp41oLVo7Gg7vF4vpmggWP5MU70QO6,7,7,3,0,1,0,3,0,14,2.0,2,0.0,0,3,0,1,7,0,0,3,0,4,10,1
2934,47308,13tiSzY0chA1pGgz0ufAF1ovTa0Ig4M9,5Gyp41oLVo7Gg7vF4vpmggWP5MU70QO6,3,0,0,0,0,0,3,0,3,0.42857142857142855,1,0.0,0,0,0,0,0,0,0,3,0,0,3,1
2935,47325,hiXDc0k3aCbg2PlfMmAMtnsGGLI4iZVQ,5Gyp41oLVo7Gg7vF4vpmggWP5MU70QO6,14,26,12,0,3,5,15,7,68,9.714285714285714,2,0.0,10,12,0,3,16,5,0,15,7,25,43,1
2936,47329,aLx6tqFKc1WBqw4OJHQenDKCxxPmguKp,5Gyp41oLVo7Gg7vF4vpmggWP5MU70QO6,15,29,13,24,8,7,14,2,97,13.857142857142858,4,0.0,12,13,16,8,17,7,8,14,2,49,48,1
2937,47332,n6NqKWHbujcWwPsIefeHUye27F23G5Fc,5Gyp41oLVo7Gg7vF4vpmggWP5MU70QO6,5,2,1,0,1,0,3,0,7,1.0,2,0.0,0,1,0,1,2,0,0,3,0,2,5,1
2938,47351,08I7chCQLVbkYM7rzYTgQRCe1Rqknw8j,5Gyp41oLVo7Gg7vF4vpmggWP5MU70QO6,5,2,1,0,1,0,2,0,6,0.8571428571428571,1,0.0,0,1,0,1,2,0,0,2,0,2,4,0
2939,47375,BMzdtRq4jFCbcZn2YgqIrxxJku0U75Jw,5Gyp41oLVo7Gg7vF4vpmggWP5MU70QO6,4,6,2,0,0,0,1,0,9,1.2857142857142858,1,0.0,1,2,0,0,5,0,0,1,0,3,6,1
2940,47388,WiK9tHCI6mpcFaEiJu6yf2bid0YSS9EI,5Gyp41oLVo7Gg7vF4vpmggWP5MU70QO6,9,11,3,0,2,1,8,1,26,3.7142857142857144,2,0.0,1,3,0,2,10,1,0,8,1,6,20,1
2941,47426,MlXPAe2Mde9SLAFh4p1AjIP3gik3uaY9,5Gyp41oLVo7Gg7vF4vpmggWP5MU70QO6,11,10,7,0,2,3,6,1,29,4.142857142857143,1,0.0,0,7,0,2,10,3,0,6,1,9,20,1
2942,47433,tonn5pllkTnaCaGk8YHtyjAEYoGoXUOU,5Gyp41oLVo7Gg7vF4vpmggWP5MU70QO6,14,11,6,4,4,0,3,0,28,4.0,2,0.0,3,6,2,4,8,0,2,3,0,15,13,1
2943,47441,ymtZufbqplidzhGpHtpCiBNDNle3lhjP,5Gyp41oLVo7Gg7vF4vpmggWP5MU70QO6,16,23,12,17,5,40,7,2,106,15.142857142857142,3,0.0,9,12,11,5,14,40,6,7,2,37,69,1
2944,47469,UInMBEH8f1h2vxXVslRsWyLOTv8ggYq3,5Gyp41oLVo7Gg7vF4vpmggWP5MU70QO6,56,148,70,39,39,230,24,3,553,79.0,8,0.0,55,70,25,39,93,230,14,24,3,189,364,0
2945,47471,6Zorv2eopTl8p8w8wdczv6lkz7zHm2Tr,5Gyp41oLVo7Gg7vF4vpmggWP5MU70QO6,6,5,2,0,2,0,1,0,10,1.4285714285714286,1,0.0,0,2,0,2,5,0,0,1,0,4,6,0
2946,47498,13oVrtAIMfOBA6qL5c4deu3cWIzI6x2g,5Gyp41oLVo7Gg7vF4vpmggWP5MU70QO6,1,0,0,0,0,0,1,0,1,0.14285714285714285,1,0.0,0,0,0,0,0,0,0,1,0,0,1,1
2947,47502,Ns3kulnSgUfdqxtVnHTwG91vJk1uWDwd,5Gyp41oLVo7Gg7vF4vpmggWP5MU70QO6,14,15,8,4,4,0,5,0,36,5.142857142857143,4,0.0,1,8,3,4,14,0,1,5,0,16,20,1
2948,47503,fMKM67c14wKHVstEXubAi7fRpdq2638L,5Gyp41oLVo7Gg7vF4vpmggWP5MU70QO6,7,4,2,0,3,0,2,0,11,1.5714285714285714,1,0.0,1,2,0,3,3,0,0,2,0,6,5,1
2949,47531,WjTwXU0UqHfY2vRQjeMISV15DHgkpGUt,5Gyp41oLVo7Gg7vF4vpmggWP5MU70QO6,12,18,6,10,6,2,4,0,46,6.571428571428571,1,0.0,10,6,5,6,8,2,5,4,0,27,19,1
2950,47541,TJlzMjBEw43ixyrT7o78I9Gv7heY2xXr,5Gyp41oLVo7Gg7vF4vpmggWP5MU70QO6,5,2,1,0,1,0,2,0,6,0.8571428571428571,1,0.0,0,1,0,1,2,0,0,2,0,2,4,1
2951,47551,3BYsGgCfnWUgGDTNtmTCAaUReolsgTgX,5Gyp41oLVo7Gg7vF4vpmggWP5MU70QO6,10,9,5,0,1,6,10,2,33,4.714285714285714,1,0.0,3,5,0,1,6,6,0,10,2,9,24,1
2952,47554,7iS5tFy4UHN1pupJYZ89Sj2B4of3T7lL,5Gyp41oLVo7Gg7vF4vpmggWP5MU70QO6,1,0,0,0,0,0,1,0,1,0.14285714285714285,1,0.0,0,0,0,0,0,0,0,1,0,0,1,1
2953,47563,GV3JVe1AsW4CH30RPVR8PwpHghCeZots,5Gyp41oLVo7Gg7vF4vpmggWP5MU70QO6,19,47,16,20,9,19,8,1,120,17.142857142857142,3,0.0,14,16,17,9,33,19,3,8,1,56,64,0
2954,47569,82UlWF6Fm1gkNum7nNbVw0yOV1BUdNoS,5Gyp41oLVo7Gg7vF4vpmggWP5MU70QO6,14,18,7,4,2,9,12,5,57,8.142857142857142,1,0.0,7,7,2,2,11,9,2,12,5,18,39,1
2955,47571,Snd5iINQfQsdqJYb8fCoHFcIa7fWA7ac,5Gyp41oLVo7Gg7vF4vpmggWP5MU70QO6,5,2,1,0,1,0,2,0,6,0.8571428571428571,1,0.0,0,1,0,1,2,0,0,2,0,2,4,1
2956,47587,sv2NeuLE6EuaEeLqlDnQ62bMEYW4pvkK,5Gyp41oLVo7Gg7vF4vpmggWP5MU70QO6,5,2,1,0,1,0,4,0,8,1.1428571428571428,2,0.0,0,1,0,1,2,0,0,4,0,2,6,1
2957,47632,zK5IGnc4ujOFuVSnt7npr6foktv9atH5,5Gyp41oLVo7Gg7vF4vpmggWP5MU70QO6,16,26,17,14,1,16,9,0,83,11.857142857142858,4,0.0,5,17,9,1,21,16,5,9,0,32,51,0
2958,47656,LdJlatZF3iaqoaNuDvuaBBgS6L8Hic6g,5Gyp41oLVo7Gg7vF4vpmggWP5MU70QO6,9,7,4,0,2,0,3,1,17,2.4285714285714284,1,0.0,2,4,0,2,5,0,0,3,1,8,9,1
2959,47662,4YOswl65MZZJx0V3vWOYS4fWFhjsESFM,5Gyp41oLVo7Gg7vF4vpmggWP5MU70QO6,7,3,1,0,1,0,4,0,9,1.2857142857142858,1,0.0,0,1,0,1,3,0,0,4,0,2,7,1
2960,47663,Wd5Y51TL4njlLeYHUjz5D9nrsHvDXUZ8,5Gyp41oLVo7Gg7vF4vpmggWP5MU70QO6,12,16,10,6,6,0,3,0,41,5.857142857142857,3,0.0,3,10,4,6,13,0,2,3,0,23,18,1
2961,47669,zfz1vgUWQGuotO2E94rqVWoT88PRB6Bw,5Gyp41oLVo7Gg7vF4vpmggWP5MU70QO6,19,28,9,12,2,11,8,1,71,10.142857142857142,2,0.0,16,9,10,2,12,11,2,8,1,37,34,1
2962,47680,5j9EQkqR4CZfRV8sku9HLld3NnlBiUj6,7GRhBDsirIGkRZBtSMEzNTyDr2JQm4xx,19,18,9,12,2,0,3,0,44,6.285714285714286,1,0.0,9,9,8,2,9,0,4,3,0,28,16,1
2963,47684,uTUI6KRhmxx7IJnVXjU43YiABIEqPIu0,7GRhBDsirIGkRZBtSMEzNTyDr2JQm4xx,1,0,0,0,0,0,1,0,1,0.14285714285714285,1,0.0,0,0,0,0,0,0,0,1,0,0,1,1
2964,47685,wdto087emiBYs3iOi0TPUdGcY6oYrMuN,7GRhBDsirIGkRZBtSMEzNTyDr2JQm4xx,18,23,4,5,5,0,5,0,42,6.0,2,0.0,9,4,4,5,14,0,1,5,0,22,20,1
2965,47686,O2P3OL1YuWbYShJfJIUxOipsTSIZNEDh,7GRhBDsirIGkRZBtSMEzNTyDr2JQm4xx,1,0,0,0,0,0,1,0,1,0.14285714285714285,1,0.0,0,0,0,0,0,0,0,1,0,0,1,1
2966,47692,95Grptw4kDgsizkydsN3dmZo4P1FRwZY,7GRhBDsirIGkRZBtSMEzNTyDr2JQm4xx,72,160,7,72,30,3,26,0,298,42.57142857142857,5,0.0,74,7,57,30,86,3,15,26,0,168,130,0
2967,47701,YCG7k31JW9D1itnYH0cr5f9GRGUr0mhA,7GRhBDsirIGkRZBtSMEzNTyDr2JQm4xx,4,2,0,0,0,0,2,0,4,0.5714285714285714,1,0.0,0,0,0,0,2,0,0,2,0,0,4,1
2968,47702,puC0Dx9PufKMVxVv15STTWR0hwd8EG3K,7GRhBDsirIGkRZBtSMEzNTyDr2JQm4xx,1,0,0,0,0,0,1,0,1,0.14285714285714285,1,0.0,0,0,0,0,0,0,0,1,0,0,1,1
2969,47703,kRQ28BRN3y8KOf3kwDvz0FCqLY1WqOEG,7GRhBDsirIGkRZBtSMEzNTyDr2JQm4xx,1,0,0,0,0,0,1,0,1,0.14285714285714285,1,0.0,0,0,0,0,0,0,0,1,0,0,1,1
2970,47709,gSg4PIaWl0hBhOgVlpN9o8YrQn4pTOeq,7GRhBDsirIGkRZBtSMEzNTyDr2JQm4xx,1,0,0,0,0,0,1,0,1,0.14285714285714285,1,0.0,0,0,0,0,0,0,0,1,0,0,1,1
2971,47714,WWICY0NkATiqKREzdAqASrAU03XmfBat,7GRhBDsirIGkRZBtSMEzNTyDr2JQm4xx,1,0,0,0,0,0,1,0,1,0.14285714285714285,1,0.0,0,0,0,0,0,0,0,1,0,0,1,1
2972,47717,eiL4sJzBUqNqEAwJXavGTHQchRgg0E9e,7GRhBDsirIGkRZBtSMEzNTyDr2JQm4xx,9,9,1,0,0,0,6,0,16,2.2857142857142856,1,0.0,0,1,0,0,9,0,0,6,0,1,15,1
2973,47718,30aCxwCoAgz4qD7x8ZM6PJzP56H1XgXO,7GRhBDsirIGkRZBtSMEzNTyDr2JQm4xx,1,0,0,0,0,0,1,0,1,0.14285714285714285,1,0.0,0,0,0,0,0,0,0,1,0,0,1,1
2974,47720,ez0SzsgZVxpWE67j4N1f6LtoZWfI9k7n,7GRhBDsirIGkRZBtSMEzNTyDr2JQm4xx,1,0,0,0,0,0,1,0,1,0.14285714285714285,1,0.0,0,0,0,0,0,0,0,1,0,0,1,1
2975,47721,svYzSyhP0bZ3DU8gcol1OFQHTOvBNcYG,7GRhBDsirIGkRZBtSMEzNTyDr2JQm4xx,8,2,1,0,1,0,8,0,12,1.7142857142857142,1,0.0,0,1,0,1,2,0,0,8,0,2,10,1
2976,47725,yO35UgaD8utoCb4qpLRXsAlxVi0i8Hs2,7GRhBDsirIGkRZBtSMEzNTyDr2JQm4xx,13,12,5,8,2,2,1,0,30,4.285714285714286,1,0.0,3,5,4,2,9,2,4,1,0,14,16,1
2977,47729,eIiEaMQHQq16kuhBzHJT0OFud5tAHZrY,7GRhBDsirIGkRZBtSMEzNTyDr2JQm4xx,28,49,16,14,13,4,8,0,104,14.857142857142858,2,0.0,11,16,8,13,38,4,6,8,0,48,56,0
2978,47736,EAHXCpfuJzmzizJcl5we9ofgxUPQx6rn,7GRhBDsirIGkRZBtSMEzNTyDr2JQm4xx,11,7,5,0,4,0,2,0,18,2.5714285714285716,2,0.0,0,5,0,4,7,0,0,2,0,9,9,0
2979,47739,GpxTNWiiHORZrtpaNpqPl31grEf03aBZ,7GRhBDsirIGkRZBtSMEzNTyDr2JQm4xx,27,35,15,24,16,0,3,0,93,13.285714285714286,2,0.0,16,15,14,16,19,0,10,3,0,61,32,1
2980,47741,wbGn50klE5ZPJH3A1kcVq6c3LTgsQOiM,7GRhBDsirIGkRZBtSMEzNTyDr2JQm4xx,10,7,5,0,4,0,6,0,22,3.142857142857143,1,0.0,0,5,0,4,7,0,0,6,0,9,13,1
2981,47781,JelJmDAgdvYMwysu2S8khlhEiSoRMDm3,fbPkOYLVPtPgIt0MxizjfFJov3JbHyAi,24,54,26,21,15,0,6,0,122,17.428571428571427,1,0.0,22,26,21,15,32,0,0,6,0,84,38,0
2982,47782,TGulLRA4GuGoMcQ4GcDFWeudMqmFclIY,fbPkOYLVPtPgIt0MxizjfFJov3JbHyAi,7,4,3,0,2,0,1,0,10,1.4285714285714286,1,0.0,0,3,0,2,4,0,0,1,0,5,5,1
2983,47795,Ve7ldJJUZUHFSKTyCbiFRbXYpCfgkMe0,fbPkOYLVPtPgIt0MxizjfFJov3JbHyAi,5,5,3,0,1,1,2,0,12,1.7142857142857142,1,0.0,0,3,0,1,5,1,0,2,0,4,8,1
2984,47798,ZobeGMKyIBgjnUNms43CrtMrVHf6iI1r,fbPkOYLVPtPgIt0MxizjfFJov3JbHyAi,1,0,0,0,0,0,1,0,1,0.14285714285714285,1,0.0,0,0,0,0,0,0,0,1,0,0,1,1
2985,47811,eIW9M0Trkt0EiuTzN2HuEtF6QnUOm4E9,fbPkOYLVPtPgIt0MxizjfFJov3JbHyAi,13,17,12,13,7,0,2,0,51,7.285714285714286,1,0.0,3,12,13,7,14,0,0,2,0,35,16,1
2986,47813,pzBdNMI6l60tGyYDZDsD8a3IbqJH27O8,fbPkOYLVPtPgIt0MxizjfFJov3JbHyAi,20,22,10,0,10,0,3,0,45,6.428571428571429,2,0.0,2,10,0,10,20,0,0,3,0,22,23,0
2987,47843,IZ5pWpBLzW50MjCCGxCjTz4w6DVz2MU3,fbPkOYLVPtPgIt0MxizjfFJov3JbHyAi,5,5,3,0,0,0,1,0,9,1.2857142857142858,1,0.0,1,3,0,0,4,0,0,1,0,4,5,1
2988,47845,QQOQ1mBFT0hbDG4vhxUnw8WQ7hq3XsN0,fbPkOYLVPtPgIt0MxizjfFJov3JbHyAi,1,0,0,0,0,0,1,0,1,0.14285714285714285,1,0.0,0,0,0,0,0,0,0,1,0,0,1,1
2989,47854,gRdV8TKfYOuiXGGwKnVS8SiUiAxajq1L,fbPkOYLVPtPgIt0MxizjfFJov3JbHyAi,4,2,0,0,0,0,5,0,7,1.0,1,0.0,0,0,0,0,2,0,0,5,0,0,7,1
2990,47899,7x6GR5vcpLicOQJjWWlyJk5P5JNLZFuv,RXDvfPUBYFlVdlueBFbLW0mhhAyGEqpt,33,56,22,48,9,5,9,3,152,21.714285714285715,2,0.0,10,22,40,9,46,5,8,9,3,81,71,1
2991,47903,H938uEDZMr5x6mZr5R8OyAsB16zTacVQ,SpATywNh6bZuzm8s1ceuBUnMUAeoAHHw,10,17,1,0,0,0,4,0,22,3.142857142857143,2,0.0,0,1,0,0,17,0,0,4,0,1,21,1
2992,47931,ExNrdfeKsdYl3xmpiJlCBa13JPKyssuX,A3fsA9Zfv1X2fVEQhTw51lKENdNrEqT3,1,0,0,0,0,0,2,0,2,0.2857142857142857,2,0.0,0,0,0,0,0,0,0,2,0,0,2,0
2993,47944,6u4AKdJzjLLZR1AtlnLDuMzDbZ4kM1Iv,bWdj2GDclj5ofokWjzoa5jAwMkxCykd6,12,17,16,0,12,3,3,0,51,7.285714285714286,4,0.0,0,16,0,12,17,3,0,3,0,28,23,1
2994,47949,9A7NeA8CSGMqqHgIDjiMNeFZF78KMRT6,bWdj2GDclj5ofokWjzoa5jAwMkxCykd6,24,32,6,31,4,2,15,2,92,13.142857142857142,3,0.0,3,6,31,4,29,2,0,15,2,44,48,0
2995,47955,WCBxImuXCQhe4JCGgmUbhM2fHJqNW9fo,bWdj2GDclj5ofokWjzoa5jAwMkxCykd6,14,14,7,0,9,0,3,0,33,4.714285714285714,2,0.0,0,7,0,9,14,0,0,3,0,16,17,1
2996,47959,grSdEhkb3V38lf9YQcXO8O3GBe0inhXx,SpATywNh6bZuzm8s1ceuBUnMUAeoAHHw,1,0,0,0,0,0,1,0,1,0.14285714285714285,1,0.0,0,0,0,0,0,0,0,1,0,0,1,0
2997,47968,4ZKN4qjeNhliROr2sm8vB8zmpPTrlPXO,5X6FeZozNMgE2VRi3MJYjkkFK8SETtu2,1,0,0,0,0,0,1,0,1,0.14285714285714285,1,0.0,0,0,0,0,0,0,0,1,0,0,1,1
2998,47976,HhK8Fr5pAwm4jm0sdGfJEGDMiAvZjcpI,bWdj2GDclj5ofokWjzoa5jAwMkxCykd6,13,17,5,42,5,0,1,0,70,10.0,1,0.0,10,5,41,5,7,0,1,1,0,61,9,1
2999,47982,nC6UOgoIicf8pr79f2rdG7NgUQiopW9Q,SpATywNh6bZuzm8s1ceuBUnMUAeoAHHw,13,15,11,0,6,0,3,0,35,5.0,4,0.0,1,11,0,6,14,0,0,3,0,18,17,0
3000,47984,nC6UOgoIicf8pr79f2rdG7NgUQiopW9Q,bWdj2GDclj5ofokWjzoa5jAwMkxCykd6,12,15,8,0,7,0,2,0,32,4.571428571428571,3,0.0,3,8,0,7,12,0,0,2,0,18,14,0
3001,47991,w37wSK655FONLskeVHZ1T8H2i8llhkAq,SpATywNh6bZuzm8s1ceuBUnMUAeoAHHw,19,37,1,25,0,0,4,0,67,9.571428571428571,3,0.0,9,1,23,0,28,0,2,4,0,33,34,1
3002,47995,UjOHFBm02iem7rlbuAJcfFkUj4JVBikN,RXDvfPUBYFlVdlueBFbLW0mhhAyGEqpt,24,61,3,28,4,8,6,0,110,15.714285714285714,3,0.0,13,3,28,4,48,8,0,6,0,48,62,0
3003,48000,snM8RKlGQmXHQ6OmxlkvPDudAMoZCHyo,SpATywNh6bZuzm8s1ceuBUnMUAeoAHHw,1,0,0,0,0,0,2,0,2,0.2857142857142857,1,0.0,0,0,0,0,0,0,0,2,0,0,2,1
3004,48006,PihBsIILx8UWSnCui7TqzlKGzY1fk9nJ,RXDvfPUBYFlVdlueBFbLW0mhhAyGEqpt,34,29,21,8,15,6,2,0,81,11.571428571428571,3,0.0,0,21,7,15,29,6,1,2,0,43,38,1
3005,48013,VxuboMfJ8lilLCmtY53lGAum5bIt411j,SpATywNh6bZuzm8s1ceuBUnMUAeoAHHw,4,2,1,0,1,0,1,0,5,0.7142857142857143,1,0.0,0,1,0,1,2,0,0,1,0,2,3,1
3006,48023,ZcTwIqiD8HcMijdrvdUAqDGmayt7dewL,SpATywNh6bZuzm8s1ceuBUnMUAeoAHHw,1,0,0,0,0,0,1,0,1,0.14285714285714285,1,0.0,0,0,0,0,0,0,0,1,0,0,1,1
3007,48035,DX4dLCDX6l0Z68Mym7vcnKV6tMlkufOW,RXDvfPUBYFlVdlueBFbLW0mhhAyGEqpt,21,22,13,30,9,0,4,0,78,11.142857142857142,3,0.0,6,13,25,9,16,0,5,4,0,53,25,1
3008,48037,tK5QWvLAN98DDvHjcCO96Vrig3bCPcrd,RXDvfPUBYFlVdlueBFbLW0mhhAyGEqpt,35,74,4,106,21,5,7,0,217,31.0,3,0.0,49,4,100,21,25,5,6,7,0,174,43,0
3009,48061,LUgTh6GVAZUuu6P6ClIsXLbxeQUErBSM,SpATywNh6bZuzm8s1ceuBUnMUAeoAHHw,30,58,15,20,9,0,1,0,103,14.714285714285714,3,0.0,10,15,18,9,48,0,2,1,0,52,51,1
3010,48063,A07oQKntRx8Y5IjXGJ2uy8rCKeA9UHyA,bWdj2GDclj5ofokWjzoa5jAwMkxCykd6,25,36,12,40,9,6,23,4,130,18.571428571428573,3,0.0,8,12,34,9,28,6,6,23,4,63,67,1
3011,48066,waLyzusenGGt78OBjbfLuixQktneXMVQ,SpATywNh6bZuzm8s1ceuBUnMUAeoAHHw,14,24,0,13,0,5,4,0,46,6.571428571428571,1,0.0,9,0,12,0,15,5,1,4,0,21,25,0
3012,48069,S0OJjF6aof0iTnIX6lUAxekoH3m4w7V0,A3fsA9Zfv1X2fVEQhTw51lKENdNrEqT3,46,16,9,148,1,0,7,0,181,25.857142857142858,4,0.0,2,9,114,1,14,0,34,7,0,126,55,0
3013,48082,s13Zj70iGaPJV2HiUyzOXf2g6dcMZpb3,RXDvfPUBYFlVdlueBFbLW0mhhAyGEqpt,48,47,21,61,2,0,3,0,134,19.142857142857142,3,0.0,10,21,61,2,37,0,0,3,0,94,40,0
3014,48088,jQM28yyQ4L2nHSWUJsgj6ijycvLum07J,bWdj2GDclj5ofokWjzoa5jAwMkxCykd6,6,5,4,0,1,0,1,0,11,1.5714285714285714,2,0.0,0,4,0,1,5,0,0,1,0,5,6,1
3015,48089,Yr9in8tqNPW6lzKPGBlYAXmDVewnbDn1,SpATywNh6bZuzm8s1ceuBUnMUAeoAHHw,16,16,10,4,7,0,2,0,39,5.571428571428571,4,0.0,2,10,4,7,14,0,0,2,0,23,16,0
3016,48092,TUbsPVDtB54KSPR2qHUpWUmDnVtGYqAT,SpATywNh6bZuzm8s1ceuBUnMUAeoAHHw,33,43,2,41,2,20,10,1,119,17.0,4,0.0,17,2,40,2,26,20,1,10,1,61,58,0
3017,48101,1Eb3AUIMGLx5ZENvg4qlksXP0nKeP5HA,RXDvfPUBYFlVdlueBFbLW0mhhAyGEqpt,1,0,0,0,0,0,1,0,1,0.14285714285714285,1,0.0,0,0,0,0,0,0,0,1,0,0,1,1
3018,48103,pZnUCZTT1hmIZNtXsfTMlwWSd2NbHrnl,SpATywNh6bZuzm8s1ceuBUnMUAeoAHHw,1,0,0,0,0,0,2,0,2,0.2857142857142857,1,0.0,0,0,0,0,0,0,0,2,0,0,2,0
3019,48118,9pydrkItOvXReb7xWe6yqdMpXhFzfa5K,SpATywNh6bZuzm8s1ceuBUnMUAeoAHHw,14,39,0,14,0,15,1,0,69,9.857142857142858,2,0.0,9,0,12,0,30,15,2,1,0,21,48,0
3020,48135,gtGDHRUZ7LgMlMOjWieE5uKSYCgIoTZ0,G8EPVSXsOYB5YQWZGiz1aVq5Pgr2GrQu,21,16,2,40,1,0,2,0,61,8.714285714285714,1,0.0,0,2,35,1,16,0,5,2,0,38,23,0
3021,48138,f3FFKNKPDIkY4ZzespQ1tkojfbmyOtUb,SpATywNh6bZuzm8s1ceuBUnMUAeoAHHw,18,49,14,13,7,0,13,0,96,13.714285714285714,6,0.0,2,14,12,7,47,0,1,13,0,35,61,0
3022,48139,6hXBi8QXIGsuTrfCDVW9WjrIWoxnhuCE,SpATywNh6bZuzm8s1ceuBUnMUAeoAHHw,1,0,0,0,0,0,1,0,1,0.14285714285714285,1,0.0,0,0,0,0,0,0,0,1,0,0,1,1
3023,48147,pUptOf7uHEM5B1QKtZNA8nWgl2SO1Sbf,RXDvfPUBYFlVdlueBFbLW0mhhAyGEqpt,1,0,0,0,0,0,1,0,1,0.14285714285714285,1,0.0,0,0,0,0,0,0,0,1,0,0,1,1
3024,48148,2zQQnqY1LiZ9lcEXTzcE3zimEdKe8CdV,SpATywNh6bZuzm8s1ceuBUnMUAeoAHHw,19,13,8,11,5,0,3,0,40,5.714285714285714,2,0.0,2,8,11,5,11,0,0,3,0,26,14,0
3025,48179,HCOgsqUBNFumf2cCspNzKWg9hTVzHRVA,SpATywNh6bZuzm8s1ceuBUnMUAeoAHHw,19,18,10,13,6,0,2,0,49,7.0,2,0.0,5,10,10,6,13,0,3,2,0,31,18,1
3026,48182,PEmuWJA7a0s7F0V9aIB9k0qqsQOvzH5e,bWdj2GDclj5ofokWjzoa5jAwMkxCykd6,1,0,0,0,0,0,2,0,2,0.2857142857142857,1,0.0,0,0,0,0,0,0,0,2,0,0,2,1
3027,48187,PEmuWJA7a0s7F0V9aIB9k0qqsQOvzH5e,RXDvfPUBYFlVdlueBFbLW0mhhAyGEqpt,1,0,0,0,0,0,1,0,1,0.14285714285714285,1,0.0,0,0,0,0,0,0,0,1,0,0,1,1
3028,48197,5KWnGsOw1ONkUhC7cQevc5FAKOxsvvUS,SpATywNh6bZuzm8s1ceuBUnMUAeoAHHw,9,8,2,0,2,0,7,0,19,2.7142857142857144,2,0.0,0,2,0,2,8,0,0,7,0,4,15,1
3029,48218,VBP5PzVQEKJYFH0y5ffEek5WfP9EW7uc,A3fsA9Zfv1X2fVEQhTw51lKENdNrEqT3,3,2,1,0,0,0,1,0,4,0.5714285714285714,1,0.0,0,1,0,0,2,0,0,1,0,1,3,1
3030,48223,GfRp1O86gI5zJJh8SIJ1bczUJPWlAqoK,SpATywNh6bZuzm8s1ceuBUnMUAeoAHHw,35,81,20,28,7,18,26,3,183,26.142857142857142,3,0.0,13,20,24,7,68,18,4,26,3,64,119,0
3031,48239,5dHhwSyX3MJPaRvMe9fCcvMfYGdzfWsb,SpATywNh6bZuzm8s1ceuBUnMUAeoAHHw,6,3,1,0,1,0,5,0,10,1.4285714285714286,1,0.0,0,1,0,1,3,0,0,5,0,2,8,1
3032,48248,tKb4BJUWaLSpiOQBxJYXLnmz0KvQQ3eJ,5X6FeZozNMgE2VRi3MJYjkkFK8SETtu2,1,0,0,0,0,0,1,0,1,0.14285714285714285,1,0.0,0,0,0,0,0,0,0,1,0,0,1,1
3033,48255,gLAW4GOuyz8JKg5RO5Sf2rzir65isCiq,G8EPVSXsOYB5YQWZGiz1aVq5Pgr2GrQu,22,28,3,0,3,0,5,0,39,5.571428571428571,3,0.0,3,3,0,3,25,0,0,5,0,9,30,0
3034,48276,mD5ok6d5ptFUQdVqyK8RQXZv5MjdFkGe,SpATywNh6bZuzm8s1ceuBUnMUAeoAHHw,1,0,0,0,0,0,1,0,1,0.14285714285714285,1,0.0,0,0,0,0,0,0,0,1,0,0,1,1
3035,48277,KJnvgR26H5LLeKdyvjJHjjqg4mjHEhgN,A3fsA9Zfv1X2fVEQhTw51lKENdNrEqT3,3,0,0,0,0,0,6,0,6,0.8571428571428571,2,0.0,0,0,0,0,0,0,0,6,0,0,6,1
3036,48285,CQ3xdz8pT9zQNTAl7b68jJZVAWVF2aTL,SpATywNh6bZuzm8s1ceuBUnMUAeoAHHw,11,10,7,0,4,10,3,0,34,4.857142857142857,1,0.0,0,7,0,4,10,10,0,3,0,11,23,1
3037,48303,ibgC3AgPCiKxZzQtLwOtyIa6DJRV6K2p,SpATywNh6bZuzm8s1ceuBUnMUAeoAHHw,33,39,20,25,8,7,18,1,118,16.857142857142858,4,0.0,5,20,19,8,34,7,6,18,1,52,66,0
3038,48304,H5UEKpeYUS8ZwAU1o3ZTuTx8QVBIM5mj,SpATywNh6bZuzm8s1ceuBUnMUAeoAHHw,23,33,0,14,0,0,6,0,53,7.571428571428571,2,0.0,10,0,13,0,23,0,1,6,0,23,30,1
3039,48308,UqMl8IgLVIouo6TVWfUzDQbBX8JDKQrY,SpATywNh6bZuzm8s1ceuBUnMUAeoAHHw,24,42,24,0,9,0,13,0,88,12.571428571428571,6,0.0,0,24,0,9,42,0,0,13,0,33,55,1
3040,48331,IPypHQ0vWks1CSRgViL4tjily46uWZcU,5X6FeZozNMgE2VRi3MJYjkkFK8SETtu2,35,61,17,63,26,0,12,1,180,25.714285714285715,5,0.0,37,17,55,26,24,0,8,12,1,135,45,1
3041,48343,KJnvgR26H5LLeKdyvjJHjjqg4mjHEhgN,bWdj2GDclj5ofokWjzoa5jAwMkxCykd6,10,6,5,8,5,0,7,0,31,4.428571428571429,2,0.0,1,5,7,5,5,0,1,7,0,18,13,0
3042,48354,YUkia24kFQkJdU9Tc0bEfJWS5kFL3fnZ,SpATywNh6bZuzm8s1ceuBUnMUAeoAHHw,16,33,13,9,2,10,18,0,85,12.142857142857142,7,0.0,13,13,7,2,20,10,2,18,0,35,50,0
3043,48364,TMaAbfbbsUXbGWJIhu1feBQgRZO29am6,G8EPVSXsOYB5YQWZGiz1aVq5Pgr2GrQu,45,32,17,92,7,18,25,0,191,27.285714285714285,6,0.0,0,17,75,7,32,18,17,25,0,99,92,0
3044,48366,eQnxTOv5tF733HrH1v8IIfXTQQ20WB86,SpATywNh6bZuzm8s1ceuBUnMUAeoAHHw,13,8,3,14,0,0,15,0,40,5.714285714285714,4,0.0,4,3,13,0,4,0,1,15,0,20,20,0
3045,48367,0go0grncbFJXOjLQCf4vOFXHn6ly84Qw,5X6FeZozNMgE2VRi3MJYjkkFK8SETtu2,1,0,0,0,0,0,1,0,1,0.14285714285714285,1,0.0,0,0,0,0,0,0,0,1,0,0,1,1
3046,48376,nC2ll7aLO2fz5jcwsfKAGs7Lo3GKKv7L,bWdj2GDclj5ofokWjzoa5jAwMkxCykd6,5,2,1,0,1,0,2,0,6,0.8571428571428571,1,0.0,0,1,0,1,2,0,0,2,0,2,4,1
3047,48379,22XSmHMOSRFcop0tg62UCikxC7iAPMOE,SpATywNh6bZuzm8s1ceuBUnMUAeoAHHw,5,2,1,0,1,0,4,0,8,1.1428571428571428,1,0.0,0,1,0,1,2,0,0,4,0,2,6,1
3048,48392,kiVzCvDoEqSB7iO0TU3ERoanC9pEAYCs,bWdj2GDclj5ofokWjzoa5jAwMkxCykd6,2,0,0,0,0,0,2,0,2,0.2857142857142857,1,0.0,0,0,0,0,0,0,0,2,0,0,2,1
3049,48402,VEdQQ1yOFNqPNBrecyFKsnw5QECT7x69,G8EPVSXsOYB5YQWZGiz1aVq5Pgr2GrQu,1,0,0,0,0,0,1,0,1,0.14285714285714285,1,0.0,0,0,0,0,0,0,0,1,0,0,1,1
3050,48450,oWaJx5przpU6lf15eldDAW9VD7f9UZbS,SpATywNh6bZuzm8s1ceuBUnMUAeoAHHw,18,31,22,7,18,17,2,0,97,13.857142857142858,1,0.0,5,22,7,18,26,17,0,2,0,52,45,0
3051,48466,zOGgv8cnkqEW7Y2l6fqZ3IzLqplNhsIx,SpATywNh6bZuzm8s1ceuBUnMUAeoAHHw,10,19,2,1,1,0,4,0,27,3.857142857142857,2,0.0,4,2,1,1,15,0,0,4,0,8,19,1
3052,48480,T2e7T1KVGbCZHkx82TLCiB6K2groJqnl,SpATywNh6bZuzm8s1ceuBUnMUAeoAHHw,20,27,2,19,2,6,4,0,60,8.571428571428571,4,0.0,10,2,16,2,17,6,3,4,0,30,30,1
3053,48494,4FBhmlqlMyaupAUC0WaC8U6eghLWF30B,bWdj2GDclj5ofokWjzoa5jAwMkxCykd6,7,10,1,0,1,0,5,0,17,2.4285714285714284,1,0.0,1,1,0,1,9,0,0,5,0,3,14,1
3054,48498,VEdQQ1yOFNqPNBrecyFKsnw5QECT7x69,SpATywNh6bZuzm8s1ceuBUnMUAeoAHHw,4,3,0,0,0,0,1,0,4,0.5714285714285714,1,0.0,0,0,0,0,3,0,0,1,0,0,4,1
3055,48509,a41llItPMmO7jtwR6NH41lmydyfI26Gz,SpATywNh6bZuzm8s1ceuBUnMUAeoAHHw,15,24,0,17,0,0,3,0,44,6.285714285714286,2,0.0,9,0,14,0,15,0,3,3,0,23,21,0
3056,48515,NCU9xqLhC281ErH7IwNmupIJSyhaNMZW,SpATywNh6bZuzm8s1ceuBUnMUAeoAHHw,6,1,1,0,1,0,7,0,10,1.4285714285714286,3,0.0,0,1,0,1,1,0,0,7,0,2,8,0
3057,48517,GiTrvkD6ePga5lhQV84iWf2qmN99Wgp4,G8EPVSXsOYB5YQWZGiz1aVq5Pgr2GrQu,112,54,41,132,23,0,21,0,271,38.714285714285715,5,0.0,2,41,131,23,52,0,1,21,0,197,74,0
3058,48520,EBgUhfQ9Yh2Xchyg5A4RNjz8pUXCnWl0,SpATywNh6bZuzm8s1ceuBUnMUAeoAHHw,9,21,0,0,0,0,1,0,22,3.142857142857143,1,0.0,0,0,0,0,21,0,0,1,0,0,22,1
3059,48524,aYYkr3EBoQc6U0mONjplTV8V30x3QwMR,SpATywNh6bZuzm8s1ceuBUnMUAeoAHHw,28,43,1,34,1,45,16,2,142,20.285714285714285,2,0.0,6,1,29,1,37,45,5,16,2,37,105,0
3060,48553,TtCmE1Q9YLiHArFHZakykfuIbhdQtny2,5X6FeZozNMgE2VRi3MJYjkkFK8SETtu2,1,0,0,0,0,0,1,0,1,0.14285714285714285,1,0.0,0,0,0,0,0,0,0,1,0,0,1,1
3061,48557,CMxWacrlvHBos1yTh6CX0stfBtIQjdRZ,SpATywNh6bZuzm8s1ceuBUnMUAeoAHHw,38,70,33,28,9,13,14,7,174,24.857142857142858,4,0.0,31,33,23,9,39,13,5,14,7,96,78,0
3062,48572,RvDbqb1jf5bMQYeeBsAiuychmXlXMqZ3,SpATywNh6bZuzm8s1ceuBUnMUAeoAHHw,33,39,26,20,15,36,6,0,142,20.285714285714285,3,0.0,6,26,16,15,33,36,4,6,0,63,79,0
3063,48579,OmRwEqIcEcFH28h4LCCN9RZtwAWWiBmW,SpATywNh6bZuzm8s1ceuBUnMUAeoAHHw,5,20,1,0,1,0,1,0,23,3.2857142857142856,1,0.0,0,1,0,1,20,0,0,1,0,2,21,1
3064,48580,PTsQJZyhlmM5FQqbiEkU0C6Xoz9Oth0N,RXDvfPUBYFlVdlueBFbLW0mhhAyGEqpt,24,33,14,30,10,0,4,0,91,13.0,3,0.0,7,14,27,10,26,0,3,4,0,58,33,0
3065,48581,ZmRlQUxjzuIBTqGZ1TI9p3XDJluy6dCH,SpATywNh6bZuzm8s1ceuBUnMUAeoAHHw,26,49,13,35,9,14,12,0,132,18.857142857142858,3,0.0,11,13,32,9,38,14,3,12,0,65,67,0
3066,48590,Bm1ROY20Td8ahvL40ylWLEiakWpICc5q,SpATywNh6bZuzm8s1ceuBUnMUAeoAHHw,21,22,12,16,6,5,7,1,69,9.857142857142858,4,0.0,4,12,13,6,18,5,3,7,1,35,34,0
3067,48594,WGMloidbPaESMPpwR4FhM5YgenySAIUm,5X6FeZozNMgE2VRi3MJYjkkFK8SETtu2,1,0,0,0,0,0,1,0,1,0.14285714285714285,1,0.0,0,0,0,0,0,0,0,1,0,0,1,1
3068,48596,k3YRNSEUtBfnCzCI2ffYAi1qqoCc9d8W,5X6FeZozNMgE2VRi3MJYjkkFK8SETtu2,4,3,0,0,0,0,1,0,4,0.5714285714285714,1,0.0,0,0,0,0,3,0,0,1,0,0,4,1
3069,48627,SRvotFFDI4c4Tqustgf1LZhg7uROitU6,SpATywNh6bZuzm8s1ceuBUnMUAeoAHHw,21,23,1,44,0,0,4,0,72,10.285714285714286,1,0.0,6,1,36,0,17,0,8,4,0,43,29,1
3070,48629,1ERwpt9wMj2n5z0yrcDeOTKwiq17bpYL,SpATywNh6bZuzm8s1ceuBUnMUAeoAHHw,10,11,8,0,3,2,4,0,28,4.0,2,0.0,0,8,0,3,11,2,0,4,0,11,17,0
3071,48637,rhEIW0I6psA9HvuF18HCB0BDkVKeLeRv,SpATywNh6bZuzm8s1ceuBUnMUAeoAHHw,7,4,3,0,2,0,1,0,10,1.4285714285714286,1,0.0,0,3,0,2,4,0,0,1,0,5,5,1
3072,48647,A5P9jrlzLqQKpA3sVBvwbPCf9CAYmtxw,SpATywNh6bZuzm8s1ceuBUnMUAeoAHHw,19,17,12,16,6,0,5,0,56,8.0,2,0.0,2,12,13,6,15,0,3,5,0,33,23,0
3073,48658,P1CWRZaaMmY4na07vRJf7J16ENwUgRU2,SpATywNh6bZuzm8s1ceuBUnMUAeoAHHw,1,0,0,0,0,0,1,0,1,0.14285714285714285,1,0.0,0,0,0,0,0,0,0,1,0,0,1,1
3074,48677,miskafWCgRGEerOwmFhGeXinZmiVq8Xq,SpATywNh6bZuzm8s1ceuBUnMUAeoAHHw,1,0,0,0,0,1,0,0,1,0.14285714285714285,1,0.0,0,0,0,0,0,1,0,0,0,0,1,0
3075,48680,ugIvWXr0VKdRfQslnLOrtvUMZY9HB5mg,SpATywNh6bZuzm8s1ceuBUnMUAeoAHHw,1,0,0,0,0,0,1,0,1,0.14285714285714285,1,0.0,0,0,0,0,0,0,0,1,0,0,1,1
3076,48710,2wpbmqMFHp4amvfRnEjwZEJ5A6Okr1xC,G8EPVSXsOYB5YQWZGiz1aVq5Pgr2GrQu,9,14,1,6,1,0,1,0,23,3.2857142857142856,1,0.0,1,1,5,1,13,0,1,1,0,8,15,1
3077,48718,5AugieBFEAlTT6fEoe5Ptq1jAvWA2bXj,SpATywNh6bZuzm8s1ceuBUnMUAeoAHHw,1,0,0,0,0,0,1,0,1,0.14285714285714285,1,0.0,0,0,0,0,0,0,0,1,0,0,1,1
3078,48727,2XL6bjSwWRsdF2Id5N4HOR8GedxbL8Tj,SpATywNh6bZuzm8s1ceuBUnMUAeoAHHw,11,19,1,0,1,4,4,0,29,4.142857142857143,2,0.0,0,1,0,1,19,4,0,4,0,2,27,0
3079,48733,mitKAcO5Yq84LGwUL473CFioIDbwQfRi,SpATywNh6bZuzm8s1ceuBUnMUAeoAHHw,13,12,8,9,0,12,7,0,48,6.857142857142857,3,0.0,2,8,9,0,10,12,0,7,0,19,29,0
3080,48739,cyv7VaipsbLsuWJ2HHHulsYIZbB7b4yb,SpATywNh6bZuzm8s1ceuBUnMUAeoAHHw,6,1,1,0,1,3,4,0,10,1.4285714285714286,1,0.0,0,1,0,1,1,3,0,4,0,2,8,1
3081,48743,geHYnGH5sQ7aHnnwLKBvDRjabqJU8jWh,RXDvfPUBYFlVdlueBFbLW0mhhAyGEqpt,3,2,1,0,0,0,1,0,4,0.5714285714285714,1,0.0,0,1,0,0,2,0,0,1,0,1,3,1
3082,48764,oWaJx5przpU6lf15eldDAW9VD7f9UZbS,RXDvfPUBYFlVdlueBFbLW0mhhAyGEqpt,41,55,35,48,19,15,10,1,183,26.142857142857142,4,0.0,9,35,46,19,46,15,2,10,1,109,74,0
3083,48766,xBzkSH4dgUCYZ5BDcyxU9YukAdw2snHB,RXDvfPUBYFlVdlueBFbLW0mhhAyGEqpt,9,5,3,0,1,0,5,0,14,2.0,2,0.0,0,3,0,1,5,0,0,5,0,4,10,1
3084,48767,9A7NeA8CSGMqqHgIDjiMNeFZF78KMRT6,5X6FeZozNMgE2VRi3MJYjkkFK8SETtu2,1,0,0,0,0,0,1,0,1,0.14285714285714285,1,0.0,0,0,0,0,0,0,0,1,0,0,1,1
3085,48788,IN0xY05lGNY1Rxj5WWCYq1C0mF0lQ2fJ,SpATywNh6bZuzm8s1ceuBUnMUAeoAHHw,34,44,15,9,10,87,11,1,177,25.285714285714285,3,0.0,4,15,8,10,40,87,1,11,1,37,140,0
3086,48789,o3OqwnFX0qkBf1G9cTUc5OJ6IQJ9j6yR,G8EPVSXsOYB5YQWZGiz1aVq5Pgr2GrQu,10,8,4,0,0,0,12,1,25,3.5714285714285716,4,0.0,0,4,0,0,8,0,0,12,1,4,21,0
3087,48800,yxV98gfwGW2ulTE4Lsk9ameltFcgsQJw,bWdj2GDclj5ofokWjzoa5jAwMkxCykd6,2,0,0,0,0,0,2,0,2,0.2857142857142857,1,0.0,0,0,0,0,0,0,0,2,0,0,2,1
3088,48803,GkoB2VZz49YRew10AQsiKgGNbvbaRd2W,SpATywNh6bZuzm8s1ceuBUnMUAeoAHHw,14,19,8,0,2,2,13,2,46,6.571428571428571,3,0.0,0,8,0,2,19,2,0,13,2,10,36,0
3089,48804,QtcqxUNiqKC3AtlnzkNFJuPtZbupT07O,SpATywNh6bZuzm8s1ceuBUnMUAeoAHHw,1,0,0,0,0,0,1,0,1,0.14285714285714285,1,0.0,0,0,0,0,0,0,0,1,0,0,1,1
3090,48816,Vn131dD12fh0kapodbBhio0q4dV4IYmG,SpATywNh6bZuzm8s1ceuBUnMUAeoAHHw,13,18,8,14,0,0,4,0,44,6.285714285714286,4,0.0,6,8,13,0,12,0,1,4,0,27,17,0
3091,48838,6CsiBxTkAlMbYFwdBsJIVLhzuq9AycoK,SpATywNh6bZuzm8s1ceuBUnMUAeoAHHw,44,46,23,44,13,0,5,0,131,18.714285714285715,4,0.0,10,23,39,13,36,0,5,5,0,85,46,0
3092,48847,zrYm7VvWMlvZCf7Dgu9kA0S4dPcpd9DE,G8EPVSXsOYB5YQWZGiz1aVq5Pgr2GrQu,5,2,1,0,1,0,2,0,6,0.8571428571428571,1,0.0,0,1,0,1,2,0,0,2,0,2,4,1
3093,48861,0WvPxKqLdXDP6VJDS60sOhS8Syb4RdJF,G8EPVSXsOYB5YQWZGiz1aVq5Pgr2GrQu,23,104,5,0,4,1,29,1,144,20.571428571428573,3,0.0,0,5,0,4,104,1,0,29,1,9,135,1
3094,48864,FBOyoNjotU9K2EWr7Q4DoavjR5C7dSks,SpATywNh6bZuzm8s1ceuBUnMUAeoAHHw,14,16,8,4,6,0,3,0,37,5.285714285714286,1,0.0,0,8,4,6,16,0,0,3,0,18,19,1
3095,48876,Ufo4AkS2vTW82q9Kpcrkrp0gG0Us5zu9,SpATywNh6bZuzm8s1ceuBUnMUAeoAHHw,8,10,2,0,1,0,3,0,16,2.2857142857142856,2,0.0,0,2,0,1,10,0,0,3,0,3,13,0
3096,48885,8abh1wrhouqvPXJGQdSrbDOHdFyzd5U8,SpATywNh6bZuzm8s1ceuBUnMUAeoAHHw,13,17,0,17,0,0,4,0,38,5.428571428571429,1,0.0,7,0,15,0,10,0,2,4,0,22,16,1
3097,48903,TdcZVkuHoNELu59WVF9f7EUYKiYIHP14,A3fsA9Zfv1X2fVEQhTw51lKENdNrEqT3,37,38,22,120,3,0,7,0,190,27.142857142857142,4,0.0,4,22,98,3,34,0,22,7,0,127,63,0
3098,48909,y9wPfGAwhUyEzMcLzeImEmShSOKx49Im,SpATywNh6bZuzm8s1ceuBUnMUAeoAHHw,36,49,0,55,0,5,12,1,122,17.428571428571427,2,0.0,14,0,47,0,35,5,8,12,1,61,61,1
3099,48919,rJ7deFT9ohZCOevrsW5L4Px2yVgiatFT,SpATywNh6bZuzm8s1ceuBUnMUAeoAHHw,1,0,0,0,0,0,1,0,1,0.14285714285714285,1,0.0,0,0,0,0,0,0,0,1,0,0,1,1
3100,48921,rJ7deFT9ohZCOevrsW5L4Px2yVgiatFT,RXDvfPUBYFlVdlueBFbLW0mhhAyGEqpt,1,0,0,0,0,0,1,0,1,0.14285714285714285,1,0.0,0,0,0,0,0,0,0,1,0,0,1,1
3101,48928,TdcZVkuHoNELu59WVF9f7EUYKiYIHP14,bWdj2GDclj5ofokWjzoa5jAwMkxCykd6,19,17,8,46,5,0,5,0,81,11.571428571428571,2,0.0,4,8,43,5,13,0,3,5,0,60,21,0
3102,48953,cPrlzYoTDFDvccHbBKlJUrITep6ieC7X,SpATywNh6bZuzm8s1ceuBUnMUAeoAHHw,24,38,20,0,7,1,15,0,81,11.571428571428571,4,0.0,3,20,0,7,35,1,0,15,0,30,51,0
3103,48954,7Lv6OVvu1nsvUexcKSRks3wnATE3pr1d,G8EPVSXsOYB5YQWZGiz1aVq5Pgr2GrQu,1,0,0,0,0,0,1,0,1,0.14285714285714285,1,0.0,0,0,0,0,0,0,0,1,0,0,1,1
3104,48967,HDhYYZCXbsTJLrhKt1D7fHfh2AMupf0z,SpATywNh6bZuzm8s1ceuBUnMUAeoAHHw,10,10,1,7,1,0,2,0,21,3.0,2,0.0,0,1,6,1,10,0,1,2,0,8,13,0
3105,48972,4IxIKalU9kAsrSpHM9QUN57NRdKohmHA,SpATywNh6bZuzm8s1ceuBUnMUAeoAHHw,13,19,0,15,0,0,3,0,37,5.285714285714286,2,0.0,4,0,11,0,15,0,4,3,0,15,22,0
3106,48983,AsLoTojSuupL42fMfNSRQAF0asRoydgp,SpATywNh6bZuzm8s1ceuBUnMUAeoAHHw,6,4,1,0,1,0,4,0,10,1.4285714285714286,2,0.0,0,1,0,1,4,0,0,4,0,2,8,1
3107,48987,q6JeU48PcDOdiZ368tb3IoCh3BVgnxVp,SpATywNh6bZuzm8s1ceuBUnMUAeoAHHw,1,0,0,0,0,0,1,0,1,0.14285714285714285,1,0.0,0,0,0,0,0,0,0,1,0,0,1,1
3108,48991,aOfddFrct0TUA0MYqpcFv1UssmM1IX2e,SpATywNh6bZuzm8s1ceuBUnMUAeoAHHw,2,0,0,0,0,1,2,0,3,0.42857142857142855,1,0.0,0,0,0,0,0,1,0,2,0,0,3,1
3109,49001,xLRXz6THj9rNHROqVgV4eCcKXyO03jXb,RXDvfPUBYFlVdlueBFbLW0mhhAyGEqpt,7,9,2,3,1,0,1,0,16,2.2857142857142856,1,0.0,0,2,3,1,9,0,0,1,0,6,10,1
3110,49011,1fjO19pGLwHG3depgSJxIFrDpr07UqZK,SpATywNh6bZuzm8s1ceuBUnMUAeoAHHw,20,17,7,16,5,15,7,0,67,9.571428571428571,3,0.0,2,7,13,5,15,15,3,7,0,27,40,0
3111,49017,1fjO19pGLwHG3depgSJxIFrDpr07UqZK,bWdj2GDclj5ofokWjzoa5jAwMkxCykd6,6,5,2,4,0,0,2,0,13,1.8571428571428572,2,0.0,0,2,2,0,5,0,2,2,0,4,9,1
3112,49024,SLljRLEQVmbKytDsyUG54XDlcZasHRnD,SpATywNh6bZuzm8s1ceuBUnMUAeoAHHw,23,35,17,4,5,0,11,0,72,10.285714285714286,2,0.0,0,17,4,5,35,0,0,11,0,26,46,0
3113,49030,Y7KPA6VBo9EdRB7rIro01vqa27fXQzej,SpATywNh6bZuzm8s1ceuBUnMUAeoAHHw,35,97,41,21,13,22,37,11,242,34.57142857142857,4,0.0,42,41,19,13,55,22,2,37,11,115,127,1
3114,49037,1fjO19pGLwHG3depgSJxIFrDpr07UqZK,5X6FeZozNMgE2VRi3MJYjkkFK8SETtu2,1,0,0,0,0,0,1,0,1,0.14285714285714285,1,0.0,0,0,0,0,0,0,0,1,0,0,1,1
3115,49042,MwdKlhOc9OCBjr4GsQbEEwa9uB7OnJQT,SpATywNh6bZuzm8s1ceuBUnMUAeoAHHw,53,88,50,34,35,2,16,1,226,32.285714285714285,4,0.0,25,50,30,35,63,2,4,16,1,140,86,0
3116,49047,PcQbQt2Pubz9h6iRkhILIzmVZ7ajU4yi,SpATywNh6bZuzm8s1ceuBUnMUAeoAHHw,11,11,2,23,0,0,1,0,37,5.285714285714286,3,0.0,6,2,18,0,5,0,5,1,0,26,11,1
3117,49076,WSyXGkhm7NDepRlMA3agJj8k8GLnavsP,SpATywNh6bZuzm8s1ceuBUnMUAeoAHHw,3,2,1,0,0,0,1,0,4,0.5714285714285714,1,0.0,0,1,0,0,2,0,0,1,0,1,3,0
3118,49085,o2VXvGiZdBAPVWYF2ziyS2greQgSpm45,G8EPVSXsOYB5YQWZGiz1aVq5Pgr2GrQu,84,28,18,146,1,0,14,0,207,29.571428571428573,2,0.0,0,18,144,1,28,0,2,14,0,163,44,0
3119,49096,etO9cGvtnbcyDOUow8PWemZvzpbkeWT2,SpATywNh6bZuzm8s1ceuBUnMUAeoAHHw,14,10,8,0,5,0,1,0,24,3.4285714285714284,1,0.0,0,8,0,5,10,0,0,1,0,13,11,0
3120,49098,eCQGRSI1IUOtkZBwaFMsuIa7hX3Csszu,SpATywNh6bZuzm8s1ceuBUnMUAeoAHHw,1,0,0,0,0,0,1,0,1,0.14285714285714285,1,0.0,0,0,0,0,0,0,0,1,0,0,1,1
3121,49104,AFfBbi1fYdYKsFJ8B1KXSG7cPpggG3JD,SpATywNh6bZuzm8s1ceuBUnMUAeoAHHw,15,22,3,4,3,0,5,0,37,5.285714285714286,3,0.0,0,3,4,3,22,0,0,5,0,10,27,0
3122,49124,M7EQ6UxOsXQjbu4WIJCWam7cgbYToC2D,SpATywNh6bZuzm8s1ceuBUnMUAeoAHHw,1,0,0,0,0,0,1,0,1,0.14285714285714285,1,0.0,0,0,0,0,0,0,0,1,0,0,1,1
3123,49129,5VPsupm8AUE2ZBwqUxHjS8zxcSp1Mcls,SpATywNh6bZuzm8s1ceuBUnMUAeoAHHw,8,8,5,0,2,0,4,0,19,2.7142857142857144,2,0.0,0,5,0,2,8,0,0,4,0,7,12,0
3124,49132,gSsRzqNvll8eqcaaEGmB933OlJpuGX1g,G8EPVSXsOYB5YQWZGiz1aVq5Pgr2GrQu,53,46,29,85,20,5,21,1,207,29.571428571428573,5,0.0,5,29,72,20,41,5,13,21,1,126,81,0
3125,49139,cszgTMCcWdEja3BpEwPP5MtLXTMUMJXE,G8EPVSXsOYB5YQWZGiz1aVq5Pgr2GrQu,37,46,17,52,11,0,5,0,131,18.714285714285715,2,0.0,20,17,33,11,26,0,19,5,0,81,50,1
3126,49143,Jt2ZVEP2fRpS6kT1yCei4p4So6yqdxLs,SpATywNh6bZuzm8s1ceuBUnMUAeoAHHw,12,13,9,0,5,0,3,0,30,4.285714285714286,3,0.0,0,9,0,5,13,0,0,3,0,14,16,0
3127,49155,xbEgNPkq7oopGIGH4RYgTrlgPLk46GrG,SpATywNh6bZuzm8s1ceuBUnMUAeoAHHw,24,35,1,19,0,0,8,0,63,9.0,2,0.0,8,1,17,0,27,0,2,8,0,26,37,0
3128,49157,PWKhgtJoYvVLEr2k8pYlCK3lg9ejdXh2,SpATywNh6bZuzm8s1ceuBUnMUAeoAHHw,5,2,1,0,1,0,2,0,6,0.8571428571428571,1,0.0,0,1,0,1,2,0,0,2,0,2,4,1
3129,49174,WjU8VISsquSeFe2LBisgFs90fx26laYI,SpATywNh6bZuzm8s1ceuBUnMUAeoAHHw,33,59,5,45,1,10,12,0,132,18.857142857142858,4,0.0,19,5,41,1,40,10,4,12,0,66,66,0
3130,49188,tg4dRbWUPF4nI55illP72uaDj0KVwE07,SpATywNh6bZuzm8s1ceuBUnMUAeoAHHw,16,56,2,18,1,0,20,3,100,14.285714285714286,2,0.0,5,2,17,1,51,0,1,20,3,25,75,1
3131,49196,FFLpMSWkcYP9u5pfR9jmdACaFpKaDwug,SpATywNh6bZuzm8s1ceuBUnMUAeoAHHw,22,26,17,10,6,0,10,0,69,9.857142857142858,5,0.0,2,17,9,6,24,0,1,10,0,34,35,0
3132,49204,KWhhYcngkyB7QbL1Y9080mTGvLlZLj2v,SpATywNh6bZuzm8s1ceuBUnMUAeoAHHw,3,4,2,0,0,0,3,0,9,1.2857142857142858,2,0.0,0,2,0,0,4,0,0,3,0,2,7,1
3133,49212,l70wRZ2DS0s6LjbT7C4gRoGrF27x9p2H,SpATywNh6bZuzm8s1ceuBUnMUAeoAHHw,21,32,5,11,3,22,10,0,83,11.857142857142858,4,0.0,2,5,9,3,30,22,2,10,0,19,64,0
3134,49224,hU8VTaLYSoElECAB03iz7dXo3kmtsuLn,5X6FeZozNMgE2VRi3MJYjkkFK8SETtu2,9,7,3,0,0,0,12,1,23,3.2857142857142856,3,0.0,0,3,0,0,7,0,0,12,1,3,20,1
3135,49230,nVktdU2hPjrulp1NoJo2DLy3TGZQ0Uld,RXDvfPUBYFlVdlueBFbLW0mhhAyGEqpt,1,0,0,0,0,0,1,0,1,0.14285714285714285,1,0.0,0,0,0,0,0,0,0,1,0,0,1,1
3136,49237,Et66VbQRwkFnF42twZ8Z4ErFWQLehmwC,G8EPVSXsOYB5YQWZGiz1aVq5Pgr2GrQu,7,4,1,0,1,0,2,0,8,1.1428571428571428,1,0.0,0,1,0,1,4,0,0,2,0,2,6,1
3137,49282,Onp8u1IlkiXCdEq7Tg9xltw0KEKQAxrs,RXDvfPUBYFlVdlueBFbLW0mhhAyGEqpt,9,6,3,0,2,0,3,0,14,2.0,2,0.0,0,3,0,2,6,0,0,3,0,5,9,1
3138,49289,r4ayLHscytxOLCupR1DXHmdWyARPuLpA,5X6FeZozNMgE2VRi3MJYjkkFK8SETtu2,18,40,11,14,1,3,12,2,83,11.857142857142858,9,0.0,4,11,12,1,36,3,2,12,2,28,55,1
3139,49313,YQzUeDQQAfJF96X2O80R1owwrQ0VWsFN,SpATywNh6bZuzm8s1ceuBUnMUAeoAHHw,9,7,5,0,2,0,2,0,16,2.2857142857142856,2,0.0,0,5,0,2,7,0,0,2,0,7,9,0
3140,49353,W6MGFBQ1Tov9lOeRQ8QlzHUMCDNEGRDq,SpATywNh6bZuzm8s1ceuBUnMUAeoAHHw,8,10,5,0,2,0,7,0,24,3.4285714285714284,1,0.0,0,5,0,2,10,0,0,7,0,7,17,1
3141,49357,oJ9j9ejTgKixczg3tSE8Sg8DPI7YQpJq,G8EPVSXsOYB5YQWZGiz1aVq5Pgr2GrQu,78,91,42,131,16,5,6,0,291,41.57142857142857,3,0.0,37,42,103,16,54,5,28,6,0,198,93,0
3142,49368,86lwqlBE6tkGHxTUWUK2RErYvHMYsCb4,RXDvfPUBYFlVdlueBFbLW0mhhAyGEqpt,10,8,4,0,3,2,3,0,20,2.857142857142857,1,0.0,0,4,0,3,8,2,0,3,0,7,13,1
3143,49376,endumB3uNuPZEFkf3CSbVDfBrwPiEVSP,A3fsA9Zfv1X2fVEQhTw51lKENdNrEqT3,36,39,27,48,19,1,14,0,148,21.142857142857142,4,0.0,3,27,39,19,36,1,9,14,0,88,60,1
3144,49380,Lco7LdlfaKIY7j4a1DlB6UakSMZTbCc5,5X6FeZozNMgE2VRi3MJYjkkFK8SETtu2,2,0,0,0,0,0,3,0,3,0.42857142857142855,1,0.0,0,0,0,0,0,0,0,3,0,0,3,1
3145,49397,uZVvmJaNXb0GsvOW7SvWgzrpxZ3muXeW,SpATywNh6bZuzm8s1ceuBUnMUAeoAHHw,17,11,8,13,6,0,1,0,39,5.571428571428571,1,0.0,2,8,13,6,9,0,0,1,0,29,10,0
3146,49410,tzUG2qRl7N6mPYRCQUU2RS3J3hIQZLrD,bWdj2GDclj5ofokWjzoa5jAwMkxCykd6,13,31,10,22,8,0,3,0,74,10.571428571428571,3,0.0,11,10,16,8,20,0,6,3,0,45,29,1
3147,49422,0xvOREru4H5eJ6hNO4BlGhEyj2EC6VxN,SpATywNh6bZuzm8s1ceuBUnMUAeoAHHw,1,0,0,0,0,0,1,0,1,0.14285714285714285,1,0.0,0,0,0,0,0,0,0,1,0,0,1,1
3148,49428,HxubVk6qxALTKY86iFsfskUh9kA3f2Wx,SpATywNh6bZuzm8s1ceuBUnMUAeoAHHw,49,104,54,27,20,84,19,1,309,44.142857142857146,5,0.0,24,54,25,20,80,84,2,19,1,123,186,0
3149,49442,MXj6ZGgoAkYjUkY8OaHYQpOdo7dehPJA,SpATywNh6bZuzm8s1ceuBUnMUAeoAHHw,5,2,1,0,1,0,3,0,7,1.0,1,0.0,0,1,0,1,2,0,0,3,0,2,5,1
3150,49457,KdLS3BVh0aFKrdvLPEqJwR9P75VBUiUC,SpATywNh6bZuzm8s1ceuBUnMUAeoAHHw,12,8,4,0,3,0,6,0,21,3.0,1,0.0,0,4,0,3,8,0,0,6,0,7,14,1
3151,49465,AwU9DlMJM6JgTKK1MDMCUEzigNcc7nPC,5X6FeZozNMgE2VRi3MJYjkkFK8SETtu2,8,13,2,0,2,0,8,0,25,3.5714285714285716,2,0.0,4,2,0,2,9,0,0,8,0,8,17,1
3152,49473,VL7NPBJuyzF1uV3nhlsl7JEimjvq8BIB,RXDvfPUBYFlVdlueBFbLW0mhhAyGEqpt,1,0,0,0,0,0,1,0,1,0.14285714285714285,1,0.0,0,0,0,0,0,0,0,1,0,0,1,1
3153,49481,2uoMQOxqyRzmIYFGnyAflqy5t44QW2xE,G8EPVSXsOYB5YQWZGiz1aVq5Pgr2GrQu,26,22,16,0,7,10,11,2,68,9.714285714285714,3,0.0,1,16,0,7,21,10,0,11,2,24,44,0
3154,49488,YOufk89dGH8sqtxV0zNmtG1C5axdPYES,5X6FeZozNMgE2VRi3MJYjkkFK8SETtu2,1,0,0,0,0,0,1,0,1,0.14285714285714285,1,0.0,0,0,0,0,0,0,0,1,0,0,1,1
3155,49489,GXmApUIE1IechykqO3xyhcbVn1kfVOsr,5X6FeZozNMgE2VRi3MJYjkkFK8SETtu2,5,2,1,0,1,0,2,0,6,0.8571428571428571,2,0.0,0,1,0,1,2,0,0,2,0,2,4,1
3156,49491,4WZA45bzzwtSAshCx00ZUSQpyrxBtdvp,SpATywNh6bZuzm8s1ceuBUnMUAeoAHHw,5,4,2,0,1,0,1,0,8,1.1428571428571428,1,0.0,0,2,0,1,4,0,0,1,0,3,5,1
3157,49492,8zWgVyFjldbfjgOVhyVSCY9hVHofzB37,SpATywNh6bZuzm8s1ceuBUnMUAeoAHHw,33,43,25,18,15,6,13,1,121,17.285714285714285,6,0.0,10,25,15,15,33,6,3,13,1,65,56,0
3158,49498,fvKvLXxKUkIMSZtq4vkKhxSOsZi4a1AH,SpATywNh6bZuzm8s1ceuBUnMUAeoAHHw,11,5,4,6,3,0,2,0,20,2.857142857142857,1,0.0,0,4,5,3,5,0,1,2,0,12,8,1
3159,49502,zbDDJL57Eoinf5rQFwxv5qPElJd1fdtI,SpATywNh6bZuzm8s1ceuBUnMUAeoAHHw,2,0,1,0,1,0,0,0,2,0.2857142857142857,1,0.0,0,1,0,1,0,0,0,0,0,2,0,1
3160,49506,ZOJ5QbCRlZ7Fm01C02cxFKL8leZWKfBc,SpATywNh6bZuzm8s1ceuBUnMUAeoAHHw,22,22,11,13,6,0,7,0,59,8.428571428571429,2,0.0,3,11,10,6,19,0,3,7,0,30,29,0
3161,49507,IFqWOl32JJm0W3Ap2jxVCpJeXeLJlYDp,bWdj2GDclj5ofokWjzoa5jAwMkxCykd6,10,4,2,10,0,0,3,0,19,2.7142857142857144,1,0.0,0,2,5,0,4,0,5,3,0,7,12,1
3162,49516,ExNrdfeKsdYl3xmpiJlCBa13JPKyssuX,5X6FeZozNMgE2VRi3MJYjkkFK8SETtu2,6,5,1,0,0,0,9,0,15,2.142857142857143,6,0.0,0,1,0,0,5,0,0,9,0,1,14,0
3163,49640,XRprdFoWtySQSNhPZow4aE4x8DdY6QhU,SpATywNh6bZuzm8s1ceuBUnMUAeoAHHw,1,0,0,0,0,0,2,0,2,0.2857142857142857,2,0.0,0,0,0,0,0,0,0,2,0,0,2,1
3164,49648,30XPDexQK4yFduDczZYYxmxB2MeR5QVB,G8EPVSXsOYB5YQWZGiz1aVq5Pgr2GrQu,4,1,0,0,0,0,3,0,4,0.5714285714285714,1,0.0,0,0,0,0,1,0,0,3,0,0,4,1
3165,49675,vEvuCci9jxTTRH9CGXFnMQL31rdrARkm,RXDvfPUBYFlVdlueBFbLW0mhhAyGEqpt,26,75,35,33,18,3,9,0,173,24.714285714285715,5,0.0,27,35,32,18,48,3,1,9,0,112,61,1
3166,49676,1rh5VRO8SYrfP8Lu1XXtrSs551JhH1SG,SpATywNh6bZuzm8s1ceuBUnMUAeoAHHw,18,16,9,10,6,2,3,0,46,6.571428571428571,2,0.0,4,9,10,6,12,2,0,3,0,29,17,0
3167,49684,RSF86CJJRRqjqcjlLpUNS7gfvntoDbsR,SpATywNh6bZuzm8s1ceuBUnMUAeoAHHw,22,23,11,21,5,0,3,0,63,9.0,2,0.0,4,11,17,5,19,0,4,3,0,37,26,0
3168,49689,M4KtR07p6NuW0Nzc9JWKn4kOJ33eMAHm,G8EPVSXsOYB5YQWZGiz1aVq5Pgr2GrQu,30,29,12,50,7,6,2,0,106,15.142857142857142,2,0.0,14,12,32,7,15,6,18,2,0,65,41,1
3169,49713,3mhHS6HFiNSDTjK0MItggE081qDKfyqL,SpATywNh6bZuzm8s1ceuBUnMUAeoAHHw,35,41,36,0,28,0,6,0,111,15.857142857142858,4,0.0,0,36,0,28,41,0,0,6,0,64,47,0
3170,49723,ZCmXmibJJyKrtc3CWMzzqRPDMvcmZhyR,SpATywNh6bZuzm8s1ceuBUnMUAeoAHHw,23,38,18,20,7,0,10,1,94,13.428571428571429,3,0.0,10,18,17,7,28,0,3,10,1,52,42,1
3171,49730,yf7eKg1R1s9Jrndu3uHIkRPOTsOf9V7F,SpATywNh6bZuzm8s1ceuBUnMUAeoAHHw,31,41,27,20,17,1,3,0,109,15.571428571428571,3,0.0,4,27,19,17,37,1,1,3,0,67,42,0
3172,49733,YIbC1cuJA4PbBVwCZRQOVlAtofCW8hIn,A3fsA9Zfv1X2fVEQhTw51lKENdNrEqT3,3,2,0,0,0,0,1,0,3,0.42857142857142855,1,0.0,0,0,0,0,2,0,0,1,0,0,3,1
3173,49746,pFE82fh5DH8NUVtvV1y83suNQP2lNeAe,RXDvfPUBYFlVdlueBFbLW0mhhAyGEqpt,29,35,0,42,2,0,8,1,88,12.571428571428571,4,0.0,9,0,40,2,26,0,2,8,1,51,37,0
3174,49779,W6MGFBQ1Tov9lOeRQ8QlzHUMCDNEGRDq,A3fsA9Zfv1X2fVEQhTw51lKENdNrEqT3,88,45,31,100,22,0,10,0,208,29.714285714285715,3,0.0,2,31,96,22,43,0,4,10,0,151,57,0
3175,49785,vgCPDvQaJnbjskT5eabUGvowszNYd8hw,bWdj2GDclj5ofokWjzoa5jAwMkxCykd6,1,0,0,0,0,0,1,0,1,0.14285714285714285,1,0.0,0,0,0,0,0,0,0,1,0,0,1,1
3176,49787,ZuPH4O6ElHiBwlm11NvwWK4IBueWaJol,SpATywNh6bZuzm8s1ceuBUnMUAeoAHHw,1,0,0,0,0,0,1,0,1,0.14285714285714285,1,0.0,0,0,0,0,0,0,0,1,0,0,1,1
3177,49796,N8XZVHbpFzVAWZIErWyzhDPvSa6whLzL,SpATywNh6bZuzm8s1ceuBUnMUAeoAHHw,3,0,0,0,0,0,3,0,3,0.42857142857142855,1,0.0,0,0,0,0,0,0,0,3,0,0,3,1
3178,49797,ijnu7LB4FcRJ96Cg1DpU1m8TR26aHP0S,G8EPVSXsOYB5YQWZGiz1aVq5Pgr2GrQu,5,3,0,0,0,0,3,0,6,0.8571428571428571,1,0.0,0,0,0,0,3,0,0,3,0,0,6,1
3179,49814,PLdoU57JNvCjCeLgODtLI3Tukef38LFN,SpATywNh6bZuzm8s1ceuBUnMUAeoAHHw,22,41,2,0,0,0,5,0,48,6.857142857142857,2,0.0,11,2,0,0,30,0,0,5,0,13,35,1
3180,49838,4dC723f2ZXGHBwWoh8xH8B5ftd5Zr0Rn,SpATywNh6bZuzm8s1ceuBUnMUAeoAHHw,5,2,0,0,1,0,2,0,5,0.7142857142857143,1,0.0,0,0,0,1,2,0,0,2,0,1,4,0
3181,49867,ajdXJNtmFj3djCMALYMagt4EstfNGU3t,SpATywNh6bZuzm8s1ceuBUnMUAeoAHHw,24,26,18,9,12,2,9,0,76,10.857142857142858,4,0.0,4,18,8,12,22,2,1,9,0,42,34,0
3182,49875,0Akk5gAtNLhWs93rvoK6BfZzftMu43VT,SpATywNh6bZuzm8s1ceuBUnMUAeoAHHw,34,46,22,29,12,0,7,0,116,16.571428571428573,2,0.0,4,22,27,12,42,0,2,7,0,65,51,0
3183,49878,fvzGqz3wcA15cPFjEfZNgqzkQDubcDYj,SpATywNh6bZuzm8s1ceuBUnMUAeoAHHw,18,59,33,12,0,4,28,0,136,19.428571428571427,6,0.0,12,33,10,0,47,4,2,28,0,55,81,0
3184,49885,v8BycPX41vEGxhnmXhJJeiFe4eT4u7RK,SpATywNh6bZuzm8s1ceuBUnMUAeoAHHw,29,31,22,26,1,0,6,0,86,12.285714285714286,4,0.0,4,22,23,1,27,0,3,6,0,50,36,0
3185,49939,WMFV7sfGiymyypraYicGVqscWxGZ0nHz,SpATywNh6bZuzm8s1ceuBUnMUAeoAHHw,11,18,8,12,5,0,2,0,45,6.428571428571429,2,0.0,2,8,11,5,16,0,1,2,0,26,19,1
3186,49941,C4q4gNQYEpjKh7pq1qjN8i3L7uSpUX9d,RXDvfPUBYFlVdlueBFbLW0mhhAyGEqpt,29,20,16,0,14,0,2,0,52,7.428571428571429,2,0.0,2,16,0,14,18,0,0,2,0,32,20,1
3187,49947,xXjBI1Nf4mgkfSUkf8YjQF9E0XahXwSr,SpATywNh6bZuzm8s1ceuBUnMUAeoAHHw,19,14,8,7,5,0,3,0,37,5.285714285714286,1,0.0,4,8,7,5,10,0,0,3,0,24,13,0
3188,49960,5DZRIacIZU0OycjWEAvqBXR0CzjjwwCH,SpATywNh6bZuzm8s1ceuBUnMUAeoAHHw,15,14,1,11,0,0,4,0,30,4.285714285714286,2,0.0,3,1,11,0,11,0,0,4,0,15,15,0
3189,49980,fFjj8aLqWVfTrDoDqL54VYBbLQmMY3Y1,G8EPVSXsOYB5YQWZGiz1aVq5Pgr2GrQu,6,5,1,0,1,0,1,0,8,1.1428571428571428,1,0.0,1,1,0,1,4,0,0,1,0,3,5,1
3190,49986,cT0XTodWylQtczhaeg1zuAXwbhCqeXWR,SpATywNh6bZuzm8s1ceuBUnMUAeoAHHw,22,45,2,15,1,0,5,0,68,9.714285714285714,5,0.0,2,2,13,1,43,0,2,5,0,18,50,0
3191,50006,IjWCyY0OMptnbDif5zdKxFY839cuvS21,SpATywNh6bZuzm8s1ceuBUnMUAeoAHHw,7,8,1,0,1,0,1,0,11,1.5714285714285714,1,0.0,0,1,0,1,8,0,0,1,0,2,9,0
3192,50014,HNrhRop3OWv7dTM3iJvhfqpVPch4tFDK,SpATywNh6bZuzm8s1ceuBUnMUAeoAHHw,5,2,1,0,1,0,2,0,6,0.8571428571428571,1,0.0,0,1,0,1,2,0,0,2,0,2,4,1
3193,50023,Eu9HoDt3WhECHgcXaERosbI6lMj7Hipb,A3fsA9Zfv1X2fVEQhTw51lKENdNrEqT3,13,6,5,24,2,0,2,0,39,5.571428571428571,1,0.0,0,5,20,2,6,0,4,2,0,27,12,1
3194,50027,tWEnJYIhXMJ03Foo959mubaAJUHZPTw0,SpATywNh6bZuzm8s1ceuBUnMUAeoAHHw,31,112,6,16,1,11,27,1,174,24.857142857142858,8,0.0,9,6,14,1,103,11,2,27,1,30,144,0
3195,50028,9e5dcfJQbPUU8sTcmzE9DWoDPOA9Nhu3,A3fsA9Zfv1X2fVEQhTw51lKENdNrEqT3,7,6,0,0,0,0,1,0,7,1.0,1,0.0,0,0,0,0,6,0,0,1,0,0,7,0
3196,50032,aKjAC5UWlmbeTD1k9n3NGSA3VSvaAKtm,SpATywNh6bZuzm8s1ceuBUnMUAeoAHHw,10,8,6,0,4,0,2,0,20,2.857142857142857,3,0.0,0,6,0,4,8,0,0,2,0,10,10,0
3197,50037,5ARkGJ4p1hrN1paVNwlZ2LmySeAZIjWv,SpATywNh6bZuzm8s1ceuBUnMUAeoAHHw,27,45,20,29,9,0,3,0,106,15.142857142857142,3,0.0,6,20,25,9,39,0,4,3,0,60,46,1
3198,50052,iWQoMguWomITf7gp2KK8eyU3oaGLECcV,SpATywNh6bZuzm8s1ceuBUnMUAeoAHHw,18,22,10,18,5,1,7,1,64,9.142857142857142,2,0.0,7,10,16,5,15,1,2,7,1,38,26,1
3199,50059,knZ4z0qX97n2wyecV68DJHHLXXd3Hlc1,RXDvfPUBYFlVdlueBFbLW0mhhAyGEqpt,6,5,2,0,2,0,1,0,10,1.4285714285714286,1,0.0,0,2,0,2,5,0,0,1,0,4,6,1
3200,50064,IEkq5dNYNtGLgDWnMbZ6LuxRn59Xykyu,SpATywNh6bZuzm8s1ceuBUnMUAeoAHHw,5,2,1,0,1,0,2,0,6,0.8571428571428571,1,0.0,0,1,0,1,2,0,0,2,0,2,4,1
3201,50084,1HlQxNM9nR1hj1jXFLyimiGxZiQUWT8w,RXDvfPUBYFlVdlueBFbLW0mhhAyGEqpt,11,11,1,6,1,0,1,0,20,2.857142857142857,1,0.0,1,1,6,1,10,0,0,1,0,9,11,1
3202,50110,g5r6m0eWuBFo9Ltn4NxasFr3GIgAvV2s,bWdj2GDclj5ofokWjzoa5jAwMkxCykd6,18,5,4,18,2,8,7,0,44,6.285714285714286,1,0.0,0,4,9,2,5,8,9,7,0,15,29,1
3203,50117,BYgO44BLHl6nPQHldrc4xzPg69SE4ic2,G8EPVSXsOYB5YQWZGiz1aVq5Pgr2GrQu,5,5,0,0,0,0,3,0,8,1.1428571428571428,1,0.0,0,0,0,0,5,0,0,3,0,0,8,1
3204,50128,SnkMsvFr6gVfsUh2QCHop5MZKFvnnxEr,SpATywNh6bZuzm8s1ceuBUnMUAeoAHHw,9,14,5,0,2,0,3,0,24,3.4285714285714284,1,0.0,0,5,0,2,14,0,0,3,0,7,17,1
3205,50139,YGwgPZSZDAKlEa7pV7OgIimz6xfMMXoJ,SpATywNh6bZuzm8s1ceuBUnMUAeoAHHw,1,0,0,0,0,0,1,0,1,0.14285714285714285,1,0.0,0,0,0,0,0,0,0,1,0,0,1,1
3206,50152,zXbxnvnaWnD5HsPlG7w2dznmSR3nmFJG,SpATywNh6bZuzm8s1ceuBUnMUAeoAHHw,2,0,0,0,0,0,2,0,2,0.2857142857142857,1,0.0,0,0,0,0,0,0,0,2,0,0,2,1
3207,50157,QxxdakYrISiiDLexNlB0fwU8yeNcfQh4,SpATywNh6bZuzm8s1ceuBUnMUAeoAHHw,28,29,17,12,9,0,7,0,74,10.571428571428571,2,0.0,8,17,11,9,21,0,1,7,0,45,29,1
3208,50159,g8JsC0SKbA6BjX9kM924D9Pd4t0BBto8,5X6FeZozNMgE2VRi3MJYjkkFK8SETtu2,1,0,0,0,0,0,1,0,1,0.14285714285714285,1,0.0,0,0,0,0,0,0,0,1,0,0,1,1
3209,50161,vQxwNbtZgUat9SDZRmE7MEKdvAizpBwk,SpATywNh6bZuzm8s1ceuBUnMUAeoAHHw,23,44,0,16,0,7,9,2,78,11.142857142857142,3,0.0,4,0,16,0,40,7,0,9,2,20,58,0
3210,50162,jO3nw1CIj4lie1rvidttURQZ3baEeNVw,SpATywNh6bZuzm8s1ceuBUnMUAeoAHHw,26,37,17,0,12,0,9,1,76,10.857142857142858,2,0.0,1,17,0,12,36,0,0,9,1,30,46,0
3211,50170,jJ6KwmQPdHVF9SNnawJ7zfgWoExKlRbO,SpATywNh6bZuzm8s1ceuBUnMUAeoAHHw,3,4,2,0,0,0,2,0,8,1.1428571428571428,1,0.0,0,2,0,0,4,0,0,2,0,2,6,1
3212,50173,lVM3D8yPmd62Fdb29hI2YI0VPwlNvI4t,bWdj2GDclj5ofokWjzoa5jAwMkxCykd6,5,0,0,0,0,2,6,1,9,1.2857142857142858,1,0.0,0,0,0,0,0,2,0,6,1,0,9,1
3213,50194,pgQsIllz0tTKnSXyilDnJ4hCvZr8UF8j,5X6FeZozNMgE2VRi3MJYjkkFK8SETtu2,32,103,40,39,34,24,28,4,272,38.857142857142854,5,0.0,49,40,36,34,54,24,3,28,4,159,113,1
3214,50203,8ZgsKNDzCbgk8zoZndfYiYFsfvE0SQgi,SpATywNh6bZuzm8s1ceuBUnMUAeoAHHw,23,34,3,44,1,0,6,0,88,12.571428571428571,3,0.0,14,3,37,1,20,0,7,6,0,55,33,0
3215,50205,MjjHVlUuOHpErRpbxsSv5C4Ujl4db690,SpATywNh6bZuzm8s1ceuBUnMUAeoAHHw,7,8,2,0,2,0,4,0,16,2.2857142857142856,1,0.0,0,2,0,2,8,0,0,4,0,4,12,1
3216,50223,l5LfU8gApOG72AnBkdAbfOLQLwFH7Zo2,SpATywNh6bZuzm8s1ceuBUnMUAeoAHHw,25,27,0,20,0,16,7,0,70,10.0,3,0.0,4,0,15,0,23,16,5,7,0,19,51,0
3217,50225,zjpZPzRIhIAoPRhm9tqA9rD229kEYBUb,bWdj2GDclj5ofokWjzoa5jAwMkxCykd6,1,0,0,0,0,0,1,0,1,0.14285714285714285,1,0.0,0,0,0,0,0,0,0,1,0,0,1,1
3218,50228,5GeMwmyzCXMcMYfcWdKaXbpNNdL8bmPq,RXDvfPUBYFlVdlueBFbLW0mhhAyGEqpt,1,0,0,0,0,0,1,0,1,0.14285714285714285,1,0.0,0,0,0,0,0,0,0,1,0,0,1,1
3219,50253,EiUeiCLNAFHc6aBGPYOKcqWKwt8Zv1wV,SpATywNh6bZuzm8s1ceuBUnMUAeoAHHw,44,50,1,43,0,2,13,1,110,15.714285714285714,3,0.0,13,1,41,0,37,2,2,13,1,55,55,0
3220,50260,o9m1fMq17KjyGUhfLHLXFO5hoKQ5jU6O,5X6FeZozNMgE2VRi3MJYjkkFK8SETtu2,16,36,1,18,0,2,6,0,63,9.0,5,0.0,18,1,17,0,18,2,1,6,0,36,27,1
3221,50274,qK0jTiDwwAEQs0Aa86HdbFtrLUQNPD2L,SpATywNh6bZuzm8s1ceuBUnMUAeoAHHw,5,3,1,0,1,0,2,0,7,1.0,1,0.0,1,1,0,1,2,0,0,2,0,3,4,1
3222,50289,y2Ax6YPEXNFRNUBbavPb4UTazWHX4UeX,SpATywNh6bZuzm8s1ceuBUnMUAeoAHHw,7,3,2,0,2,0,2,0,9,1.2857142857142858,1,0.0,0,2,0,2,3,0,0,2,0,4,5,1
3223,50293,qK0jTiDwwAEQs0Aa86HdbFtrLUQNPD2L,RXDvfPUBYFlVdlueBFbLW0mhhAyGEqpt,8,4,3,0,2,0,2,0,11,1.5714285714285714,1,0.0,0,3,0,2,4,0,0,2,0,5,6,1
3224,50294,mexTVUuTBaMSHWugjgX7gCSwX1B8AubF,SpATywNh6bZuzm8s1ceuBUnMUAeoAHHw,8,16,1,0,1,0,3,0,21,3.0,3,0.0,0,1,0,1,16,0,0,3,0,2,19,0
3225,50320,1OwZz25mXZNgO62URLrpwxju1xtv0yd9,SpATywNh6bZuzm8s1ceuBUnMUAeoAHHw,8,5,3,25,0,0,9,0,42,6.0,5,0.0,2,3,20,0,3,0,5,9,0,25,17,0
3226,50322,jxVbF1puB335S13Sh1SeiyqryzWrY9TH,SpATywNh6bZuzm8s1ceuBUnMUAeoAHHw,14,13,2,19,2,0,5,0,41,5.857142857142857,2,0.0,4,2,19,2,9,0,0,5,0,27,14,1
3227,50352,BS7u1moD4G6tIsp3i8TsGiKk2duVqSQ0,G8EPVSXsOYB5YQWZGiz1aVq5Pgr2GrQu,8,6,3,0,2,0,1,0,12,1.7142857142857142,1,0.0,0,3,0,2,6,0,0,1,0,5,7,1
3228,50361,Gur5FuhE9EyV9K1F0qLPk7AenhoY8PBS,SpATywNh6bZuzm8s1ceuBUnMUAeoAHHw,8,6,0,5,0,0,4,0,15,2.142857142857143,1,0.0,3,0,5,0,3,0,0,4,0,8,7,1
3229,50368,kBV4mR9qFSJedXrCK3UtZoeKEUmuZ9wn,5X6FeZozNMgE2VRi3MJYjkkFK8SETtu2,44,160,14,81,2,69,55,1,382,54.57142857142857,12,0.0,63,14,75,2,97,69,6,55,1,154,228,1
3230,50376,JWtRXomIKoqZYOItc3dpuDZlGcxpfAbC,RXDvfPUBYFlVdlueBFbLW0mhhAyGEqpt,23,50,31,8,22,3,3,0,117,16.714285714285715,2,0.0,0,31,7,22,50,3,1,3,0,60,57,1
3231,50380,Xdag5jOmE7uWC3FmBvgPc5F7lO3QNcPW,bWdj2GDclj5ofokWjzoa5jAwMkxCykd6,29,38,15,58,16,8,10,3,148,21.142857142857142,4,0.0,5,15,45,16,33,8,13,10,3,81,67,0
3232,50383,wcXKTRp3782w7z3pcKy7I4KlcLaVU81W,SpATywNh6bZuzm8s1ceuBUnMUAeoAHHw,9,10,1,0,0,0,2,0,13,1.8571428571428572,2,0.0,0,1,0,0,10,0,0,2,0,1,12,0
3233,50387,gWLNrui4xJ6xOW9BQTEyWRBtLNqndryz,bWdj2GDclj5ofokWjzoa5jAwMkxCykd6,8,15,0,0,1,0,2,0,18,2.5714285714285716,2,0.0,3,0,0,1,12,0,0,2,0,4,14,1
3234,50395,sBhz8U16B7sa3LOSIqulBpvj71xTLTZF,SpATywNh6bZuzm8s1ceuBUnMUAeoAHHw,2,0,0,0,0,0,2,0,2,0.2857142857142857,1,0.0,0,0,0,0,0,0,0,2,0,0,2,1
3235,50401,dk07gP54X69nuCMty25BNGOYSGmkxtJW,SpATywNh6bZuzm8s1ceuBUnMUAeoAHHw,5,2,0,0,0,0,3,0,5,0.7142857142857143,1,0.0,0,0,0,0,2,0,0,3,0,0,5,0
3236,50417,zYT144o5gG83ITHydzc0I4BahBKUTuVY,A3fsA9Zfv1X2fVEQhTw51lKENdNrEqT3,1,2,0,0,0,0,0,0,2,0.2857142857142857,2,0.0,0,0,0,0,2,0,0,0,0,0,2,1
3237,50418,dy5U2Hr6hWmpYZri5b9XY0EijWuyuZjO,RXDvfPUBYFlVdlueBFbLW0mhhAyGEqpt,2,0,0,0,0,0,4,0,4,0.5714285714285714,1,0.0,0,0,0,0,0,0,0,4,0,0,4,1
3238,50422,SnivjdMp3HL6G23yPscSnzZlAD2Rbyt6,bWdj2GDclj5ofokWjzoa5jAwMkxCykd6,28,26,15,56,8,10,4,0,119,17.0,2,0.0,7,15,47,8,19,10,9,4,0,77,42,1
3239,50428,SnivjdMp3HL6G23yPscSnzZlAD2Rbyt6,RXDvfPUBYFlVdlueBFbLW0mhhAyGEqpt,1,0,0,0,0,0,1,0,1,0.14285714285714285,1,0.0,0,0,0,0,0,0,0,1,0,0,1,1
3240,50433,nWc5KHoYFVRoaDcRvamz8phBJoK95aNe,RXDvfPUBYFlVdlueBFbLW0mhhAyGEqpt,1,0,0,0,0,0,1,0,1,0.14285714285714285,1,0.0,0,0,0,0,0,0,0,1,0,0,1,1
3241,50455,9jNN69RJsAFkkuYDPHWQVpfsVwA6mFxd,SpATywNh6bZuzm8s1ceuBUnMUAeoAHHw,35,32,20,33,11,0,7,0,103,14.714285714285714,3,0.0,4,20,29,11,28,0,4,7,0,64,39,0
3242,50460,DRhlp1eJHQqsxjCL0bRD6kkHN20HbJ4w,RXDvfPUBYFlVdlueBFbLW0mhhAyGEqpt,5,5,2,0,1,0,2,0,10,1.4285714285714286,2,0.0,0,2,0,1,5,0,0,2,0,3,7,1
3243,50473,1v6DOxYlkOvOHyU9Jbeb1YuXisY7Ilv8,SpATywNh6bZuzm8s1ceuBUnMUAeoAHHw,31,28,19,16,14,0,4,0,81,11.571428571428571,3,0.0,2,19,14,14,26,0,2,4,0,49,32,0
3244,50481,ZhurkXmgh5sEiUWLyFC6UHrljEG5kXpb,SpATywNh6bZuzm8s1ceuBUnMUAeoAHHw,8,10,8,0,8,0,13,0,39,5.571428571428571,5,0.0,0,8,0,8,10,0,0,13,0,16,23,1
3245,50485,bZVDIvmAMciYIQrrbhRx0jvH9Tiicfyn,SpATywNh6bZuzm8s1ceuBUnMUAeoAHHw,4,5,1,0,0,0,1,0,7,1.0,1,0.0,0,1,0,0,5,0,0,1,0,1,6,0
3246,50495,3kOFsgHC3tWJNSzqIlZ1BKfxh1AIkRy9,SpATywNh6bZuzm8s1ceuBUnMUAeoAHHw,30,33,15,27,7,0,6,0,88,12.571428571428571,3,0.0,11,15,25,7,22,0,2,6,0,58,30,0
3247,50507,vrKNA3eEZxLntZreFchejbQ8UgnPaTUE,SpATywNh6bZuzm8s1ceuBUnMUAeoAHHw,8,9,5,0,2,0,2,0,18,2.5714285714285716,1,0.0,2,5,0,2,7,0,0,2,0,9,9,1
3248,50515,E7wBgQCkgD4tkfXLdP9URnDZqb2ubvF0,A3fsA9Zfv1X2fVEQhTw51lKENdNrEqT3,4,3,1,0,0,0,1,0,5,0.7142857142857143,1,0.0,0,1,0,0,3,0,0,1,0,1,4,0
3249,50526,SKzEklIJtB0H7qSb29ZCLXx6x8polS8t,G8EPVSXsOYB5YQWZGiz1aVq5Pgr2GrQu,25,25,15,42,3,0,4,1,90,12.857142857142858,2,0.0,6,15,35,3,19,0,7,4,1,59,31,1
3250,50527,Aa6HGi2BP5QmpgVAdMlhlYagK8En1mfR,SpATywNh6bZuzm8s1ceuBUnMUAeoAHHw,4,2,1,0,0,0,2,0,5,0.7142857142857143,1,0.0,0,1,0,0,2,0,0,2,0,1,4,1
3251,50553,Q4kMf3oUxyru1mGynxCyO5lsgz8RcH4I,SpATywNh6bZuzm8s1ceuBUnMUAeoAHHw,1,0,0,0,0,0,1,0,1,0.14285714285714285,1,0.0,0,0,0,0,0,0,0,1,0,0,1,1
3252,50557,Xg5Ot8iedBtydMlcszETASpB9uo3tFAr,SpATywNh6bZuzm8s1ceuBUnMUAeoAHHw,7,7,3,0,2,0,3,0,15,2.142857142857143,1,0.0,0,3,0,2,7,0,0,3,0,5,10,1
3253,50559,5cQUnUgkfNnsoqvndDYLsW5vGZdhNEqy,SpATywNh6bZuzm8s1ceuBUnMUAeoAHHw,6,7,4,0,3,0,2,0,16,2.2857142857142856,1,0.0,1,4,0,3,6,0,0,2,0,8,8,1
3254,50568,Ikx8dqw7N29O68oP7rbQGE7AGY4iLNon,SpATywNh6bZuzm8s1ceuBUnMUAeoAHHw,7,8,4,0,2,0,2,0,16,2.2857142857142856,2,0.0,0,4,0,2,8,0,0,2,0,6,10,0
3255,50572,XIlz5QvnlEzidDqYGld3VSh8CaOyBXAa,RXDvfPUBYFlVdlueBFbLW0mhhAyGEqpt,9,9,5,0,4,0,2,0,20,2.857142857142857,2,0.0,0,5,0,4,9,0,0,2,0,9,11,1
3256,50609,THlX4ibtjGYQg6ZUfc8ItvnKMtOly4Xi,SpATywNh6bZuzm8s1ceuBUnMUAeoAHHw,16,29,13,0,5,0,6,0,53,7.571428571428571,4,0.0,0,13,0,5,29,0,0,6,0,18,35,0
3257,50616,U3HS4u1TmUUxbQhrTehko1MNIHz71lIC,SpATywNh6bZuzm8s1ceuBUnMUAeoAHHw,8,8,5,0,3,1,4,0,21,3.0,2,0.0,0,5,0,3,8,1,0,4,0,8,13,1
3258,50632,DeyP5lAVv1H3yXRPzbyis5xLngeggxpO,RXDvfPUBYFlVdlueBFbLW0mhhAyGEqpt,1,0,0,0,0,0,1,0,1,0.14285714285714285,1,0.0,0,0,0,0,0,0,0,1,0,0,1,1
3259,50670,IDqUeKOsakXfpJsNR0qoC3jJJuHYmkPd,SpATywNh6bZuzm8s1ceuBUnMUAeoAHHw,15,27,15,0,0,6,9,2,59,8.428571428571429,2,0.0,0,15,0,0,27,6,0,9,2,15,44,0
3260,50690,IEkq5dNYNtGLgDWnMbZ6LuxRn59Xykyu,G8EPVSXsOYB5YQWZGiz1aVq5Pgr2GrQu,5,2,1,0,1,7,2,0,13,1.8571428571428572,1,0.0,0,1,0,1,2,7,0,2,0,2,11,1
3261,50692,BfoybeaeQZxTt069jPLA4qjwQgNZD97I,G8EPVSXsOYB5YQWZGiz1aVq5Pgr2GrQu,7,9,0,0,0,0,2,0,11,1.5714285714285714,3,0.0,1,0,0,0,8,0,0,2,0,1,10,1
3262,50703,AEOK3hwhmsMNDRL3o1uoaIUrWvSc7heg,SpATywNh6bZuzm8s1ceuBUnMUAeoAHHw,9,14,1,28,0,0,1,0,44,6.285714285714286,1,0.0,5,1,24,0,9,0,4,1,0,30,14,1
3263,50717,iVwNFnYcHwv8JroRNWkaHfHv9TTNdn1b,bWdj2GDclj5ofokWjzoa5jAwMkxCykd6,1,0,0,0,0,0,1,0,1,0.14285714285714285,1,0.0,0,0,0,0,0,0,0,1,0,0,1,1
3264,50730,nllK24cE3wNRvB4jmfti8fXlrXtFYAFv,bWdj2GDclj5ofokWjzoa5jAwMkxCykd6,5,2,1,0,1,0,2,0,6,0.8571428571428571,1,0.0,0,1,0,1,2,0,0,2,0,2,4,1
3265,50736,6EsKULTJVMq3E9IpeZllE0vOQuFiZwCm,SpATywNh6bZuzm8s1ceuBUnMUAeoAHHw,21,19,15,13,5,21,6,0,79,11.285714285714286,2,0.0,3,15,12,5,16,21,1,6,0,35,44,1
3266,50738,9va47BxxunDTlRdlZXe6vZY5WX0faoXZ,G8EPVSXsOYB5YQWZGiz1aVq5Pgr2GrQu,7,5,1,2,0,0,2,0,10,1.4285714285714286,1,0.0,0,1,2,0,5,0,0,2,0,3,7,1
3267,50776,kQmP7eUv8W6zmkJRQJGIL9eNv0mJSlzv,SpATywNh6bZuzm8s1ceuBUnMUAeoAHHw,1,1,0,0,0,0,0,0,1,0.14285714285714285,1,0.0,0,0,0,0,1,0,0,0,0,0,1,1
3268,50777,se9ZVl8DNkiCW8i2nP0p3krrUcQqYC47,bWdj2GDclj5ofokWjzoa5jAwMkxCykd6,20,23,17,14,13,0,4,0,71,10.142857142857142,4,0.0,3,17,11,13,20,0,3,4,0,44,27,0
3269,50789,3URMlJ8WFfbFx3SvBMPqUCA5oJqCky66,RXDvfPUBYFlVdlueBFbLW0mhhAyGEqpt,1,0,0,0,0,0,1,0,1,0.14285714285714285,1,0.0,0,0,0,0,0,0,0,1,0,0,1,1
3270,50792,oidXTGaCUuuF1QPNvhmiPoqhWsTY245r,bWdj2GDclj5ofokWjzoa5jAwMkxCykd6,13,25,5,0,2,5,3,0,40,5.714285714285714,2,0.0,0,5,0,2,25,5,0,3,0,7,33,0
3271,50797,BWuaSpfjjWoQ6suviyDvOJ1XUJLgJBtc,SpATywNh6bZuzm8s1ceuBUnMUAeoAHHw,38,40,24,30,15,110,21,1,241,34.42857142857143,7,0.0,11,24,26,15,29,110,4,21,1,76,165,0
3272,50805,1HrXazG6mMhlQyrWzEYwtGHFWa0bXXko,SpATywNh6bZuzm8s1ceuBUnMUAeoAHHw,16,29,3,14,1,0,4,0,51,7.285714285714286,2,0.0,5,3,11,1,24,0,3,4,0,20,31,0
3273,50808,xm9wUIf1J8EjTNxXT4ffEWzhuySk21YK,RXDvfPUBYFlVdlueBFbLW0mhhAyGEqpt,5,9,6,2,0,0,3,0,20,2.857142857142857,3,0.0,0,6,1,0,9,0,1,3,0,7,13,0
3274,50813,h8n9HekAuyT08sLL5qmdMZ3BdSJVR4QF,5X6FeZozNMgE2VRi3MJYjkkFK8SETtu2,51,103,29,114,23,23,20,1,313,44.714285714285715,6,0.0,45,29,97,23,58,23,17,20,1,194,119,1
3275,50814,tOVeFZbpewRX07F0N4KV6g00WNGootzd,SpATywNh6bZuzm8s1ceuBUnMUAeoAHHw,1,0,0,0,0,0,1,0,1,0.14285714285714285,1,0.0,0,0,0,0,0,0,0,1,0,0,1,1
3276,50841,POGRFFRZzlPiBHiCHXnlCDCb459JTEzc,G8EPVSXsOYB5YQWZGiz1aVq5Pgr2GrQu,9,10,5,0,2,0,2,0,19,2.7142857142857144,2,0.0,0,5,0,2,10,0,0,2,0,7,12,0
3277,50845,IbSlJreCWcsVrBSn5tZXMZ0WT6gAqUtU,5X6FeZozNMgE2VRi3MJYjkkFK8SETtu2,9,24,8,2,2,2,14,0,52,7.428571428571429,8,0.0,2,8,2,2,22,2,0,14,0,14,38,0
3278,50911,hUDYaJSmYdF2ZsjDDhiBi3bEoysqCLEu,5Gyp41oLVo7Gg7vF4vpmggWP5MU70QO6,11,20,9,2,3,0,3,0,37,5.285714285714286,1,0.0,4,9,1,3,16,0,1,3,0,17,20,1
3279,50945,6CncXwdTCC3PBs88iLEcFh0rzR16XLlT,5Gyp41oLVo7Gg7vF4vpmggWP5MU70QO6,1,0,0,0,0,0,2,0,2,0.2857142857142857,1,0.0,0,0,0,0,0,0,0,2,0,0,2,1
3280,50948,vJn8WpxPLI2ms7Nn48ZlxfL8JZRwXqcW,5Gyp41oLVo7Gg7vF4vpmggWP5MU70QO6,10,9,4,2,3,0,1,0,19,2.7142857142857144,1,0.0,3,4,1,3,6,0,1,1,0,11,8,1
3281,50963,BcJnhjzA1hw0WNze9uWUZQ49uBAiBHyH,5Gyp41oLVo7Gg7vF4vpmggWP5MU70QO6,5,2,1,0,1,0,3,0,7,1.0,2,0.0,0,1,0,1,2,0,0,3,0,2,5,1
3282,50970,sAF0rhnS6eTeFnLUiq2Li82i0HPzFiAf,5Gyp41oLVo7Gg7vF4vpmggWP5MU70QO6,26,112,58,56,18,19,26,4,293,41.857142857142854,5,0.0,39,58,32,18,73,19,24,26,4,147,146,1
3283,50985,GUOpxTQnQN8qFAqM8JSE4fCHAUkjbvvx,5Gyp41oLVo7Gg7vF4vpmggWP5MU70QO6,1,0,0,0,0,0,1,0,1,0.14285714285714285,1,0.0,0,0,0,0,0,0,0,1,0,0,1,1
3284,50989,CNJ2KRdKhIzMbOlxj2daOOkuq5TrQAeD,5Gyp41oLVo7Gg7vF4vpmggWP5MU70QO6,8,10,5,6,0,0,2,0,23,3.2857142857142856,2,0.0,4,5,3,0,6,0,3,2,0,12,11,1
3285,51015,yivRzsNns2AFCmmffardHKKzslL7w3NQ,5Gyp41oLVo7Gg7vF4vpmggWP5MU70QO6,11,13,8,4,4,0,3,0,32,4.571428571428571,3,0.0,1,8,2,4,12,0,2,3,0,15,17,1
3286,51023,8lRHXn9xfK8EXcc6tQhHvcH0giqpsudE,5Gyp41oLVo7Gg7vF4vpmggWP5MU70QO6,14,23,15,14,6,9,5,0,72,10.285714285714286,4,0.0,3,15,11,6,20,9,3,5,0,35,37,1
3287,51058,kQcHT9XjbeNVxuKuAz9nk02Q91AkSUCM,5Gyp41oLVo7Gg7vF4vpmggWP5MU70QO6,1,0,0,0,0,0,3,0,3,0.42857142857142855,1,0.0,0,0,0,0,0,0,0,3,0,0,3,1
3288,51062,xeper6lTTTduQkRnWSDeRoAUobRsjfTO,5Gyp41oLVo7Gg7vF4vpmggWP5MU70QO6,29,64,33,51,18,22,17,3,208,29.714285714285715,6,0.0,22,33,41,18,42,22,10,17,3,114,94,1
3289,51075,cSfkIN06kB0BuNVH3RsKbNNnQyc10IUt,5Gyp41oLVo7Gg7vF4vpmggWP5MU70QO6,35,65,32,20,19,37,25,2,200,28.571428571428573,9,0.0,15,32,13,19,50,37,7,25,2,79,121,0
3290,51096,Yrv9TCoIHfGWJRAoHLHbNeO6aiMpq9Rx,5Gyp41oLVo7Gg7vF4vpmggWP5MU70QO6,11,10,4,4,2,0,4,0,24,3.4285714285714284,3,0.0,1,4,2,2,9,0,2,4,0,9,15,1
3291,51135,jE34qxBejGRuNfhNRx8UVFZQqAMqmjmU,5Gyp41oLVo7Gg7vF4vpmggWP5MU70QO6,16,10,6,8,3,0,3,0,30,4.285714285714286,1,0.0,2,6,4,3,8,0,4,3,0,15,15,1
3292,51139,loP5euETO7r8DEDz3s6e4OL8qAADTSwG,5Gyp41oLVo7Gg7vF4vpmggWP5MU70QO6,10,15,7,0,4,0,6,0,32,4.571428571428571,5,0.0,0,7,0,4,15,0,0,6,0,11,21,1
3293,51159,t4iUOcn0QKxh1mWzwjgY3W5LnRpajtii,5Gyp41oLVo7Gg7vF4vpmggWP5MU70QO6,7,8,2,0,2,0,1,0,13,1.8571428571428572,1,0.0,1,2,0,2,7,0,0,1,0,5,8,1
3294,51164,V0DjG27Lu2GKv0f5ALnYugbRwr67Wu8f,5Gyp41oLVo7Gg7vF4vpmggWP5MU70QO6,5,2,0,0,0,0,3,0,5,0.7142857142857143,1,0.0,0,0,0,0,2,0,0,3,0,0,5,1
3295,51170,i67qzouvUD7nINgK6d1xrH4pvufZqbFd,5Gyp41oLVo7Gg7vF4vpmggWP5MU70QO6,39,156,78,46,41,72,26,11,430,61.42857142857143,7,0.0,54,78,37,41,102,72,9,26,11,210,220,0
3296,51179,8bMxud2pJnttNvsNwa7l9gc36Q1hRhIk,5Gyp41oLVo7Gg7vF4vpmggWP5MU70QO6,30,68,42,10,12,2,14,0,148,21.142857142857142,8,0.0,11,42,7,12,57,2,3,14,0,72,76,1
3297,51191,BveIxduzCtuwgGhSUEmYM6hBnFvwdvcp,5Gyp41oLVo7Gg7vF4vpmggWP5MU70QO6,1,0,0,0,0,0,1,0,1,0.14285714285714285,1,0.0,0,0,0,0,0,0,0,1,0,0,1,1
3298,51199,s4TNdVBVykBR8x72RZEnjBx6ebkwwW3k,5Gyp41oLVo7Gg7vF4vpmggWP5MU70QO6,29,33,20,18,9,7,19,6,112,16.0,7,0.0,4,20,11,9,29,7,7,19,6,44,68,1
3299,51225,dtbXtMjPqeEvzoZBFe2y9uSDcjL0lnx2,5Gyp41oLVo7Gg7vF4vpmggWP5MU70QO6,7,3,2,0,2,15,3,0,25,3.5714285714285716,2,0.0,0,2,0,2,3,15,0,3,0,4,21,1
3300,51231,IY3uQ1CpKmZTS6BFPIvXsM2Z8k2q4Ten,5Gyp41oLVo7Gg7vF4vpmggWP5MU70QO6,28,50,26,12,10,0,25,1,124,17.714285714285715,6,0.0,12,26,8,10,38,0,4,25,1,56,68,1
3301,51241,804HYV0yQ92rGjeWWFPgqhXRYq0Itqqm,5Gyp41oLVo7Gg7vF4vpmggWP5MU70QO6,28,77,48,24,24,113,22,1,309,44.142857142857146,9,0.0,11,48,17,24,66,113,7,22,1,100,209,1
3302,51247,Z4MXAD0JKMHJMDcQZ3bvrhAPRhP6Ylsj,5Gyp41oLVo7Gg7vF4vpmggWP5MU70QO6,29,59,15,35,13,21,16,1,160,22.857142857142858,7,0.0,19,15,25,13,40,21,10,16,1,72,88,1
3303,51264,R0yZQm01vPxwB1FHTvnE4ExR78BMpKhv,5Gyp41oLVo7Gg7vF4vpmggWP5MU70QO6,27,35,17,6,19,10,16,5,108,15.428571428571429,6,0.0,16,17,5,19,19,10,1,16,5,57,51,0
3304,51280,qBEmqvLVJKAtiuGEuUMlrWfek26BR553,5Gyp41oLVo7Gg7vF4vpmggWP5MU70QO6,6,3,2,0,1,0,2,0,8,1.1428571428571428,1,0.0,0,2,0,1,3,0,0,2,0,3,5,1
3305,51283,rYNkAKC3XVLpC4bzbGHzILPwRJzsAVQv,5Gyp41oLVo7Gg7vF4vpmggWP5MU70QO6,14,22,9,0,6,1,2,0,40,5.714285714285714,1,0.0,10,9,0,6,12,1,0,2,0,25,15,1
3306,51297,JQRXqEKqYgVt3yLRwyn6A8k5Glf2cOSO,5Gyp41oLVo7Gg7vF4vpmggWP5MU70QO6,3,2,1,0,0,0,2,0,5,0.7142857142857143,1,0.0,0,1,0,0,2,0,0,2,0,1,4,1
3307,51303,Al5ekOcwSYEmIj8FtIvMEyeKBOFRAwO4,5Gyp41oLVo7Gg7vF4vpmggWP5MU70QO6,18,27,15,6,1,3,9,3,64,9.142857142857142,2,0.0,4,15,3,1,23,3,3,9,3,23,41,1
3308,51337,l5LfU8gApOG72AnBkdAbfOLQLwFH7Zo2,5Gyp41oLVo7Gg7vF4vpmggWP5MU70QO6,32,91,33,7,12,23,21,1,188,26.857142857142858,10,0.0,25,33,6,12,66,23,1,21,1,76,112,0
3309,51348,SB5SpH3bmeO3Q4jhsGMmhdtd7LwNbsmt,5Gyp41oLVo7Gg7vF4vpmggWP5MU70QO6,32,48,21,6,22,3,18,12,130,18.571428571428573,4,0.0,19,21,4,22,29,3,2,18,12,66,64,1
3310,51364,bUqcs6NKKHUQx25s7Yo0TWpKwiOnMYKl,5Gyp41oLVo7Gg7vF4vpmggWP5MU70QO6,1,0,0,0,0,0,2,0,2,0.2857142857142857,2,0.0,0,0,0,0,0,0,0,2,0,0,2,1
3311,51365,zK6w0JPDDeUD403WVGuxpKSbry9d8uLr,5Gyp41oLVo7Gg7vF4vpmggWP5MU70QO6,11,15,9,8,4,0,7,0,43,6.142857142857143,1,0.0,4,9,4,4,11,0,4,7,0,21,22,1
3312,51378,Ha83qom95SRdPZQ3GDUlHj6Txt7HaICx,5Gyp41oLVo7Gg7vF4vpmggWP5MU70QO6,5,2,1,0,1,0,3,0,7,1.0,1,0.0,0,1,0,1,2,0,0,3,0,2,5,1
3313,51401,XEg540lTawnkyAL3QhiV5067z0uxHwgk,5Gyp41oLVo7Gg7vF4vpmggWP5MU70QO6,1,0,0,0,0,0,1,0,1,0.14285714285714285,1,0.0,0,0,0,0,0,0,0,1,0,0,1,1
3314,51431,JD10TEfuHqgtsX2PaJg1Dza8TadsNhie,5Gyp41oLVo7Gg7vF4vpmggWP5MU70QO6,8,3,1,0,1,2,9,1,17,2.4285714285714284,3,0.0,0,1,0,1,3,2,0,9,1,2,15,1
3315,51447,wFvodFqghxL7iISMFbYXkYNq6P6eK5gH,5Gyp41oLVo7Gg7vF4vpmggWP5MU70QO6,6,1,1,0,1,7,3,0,13,1.8571428571428572,1,0.0,0,1,0,1,1,7,0,3,0,2,11,1
3316,51463,1TEsUxQgDdO1TalOwwODqO4TXTErPqtQ,5Gyp41oLVo7Gg7vF4vpmggWP5MU70QO6,12,17,4,6,0,2,13,1,43,6.142857142857143,1,0.0,5,4,3,0,12,2,3,13,1,12,31,1
3317,51464,WICtlxmktG02cQ6UoORXrfE9LbHVpnYF,5Gyp41oLVo7Gg7vF4vpmggWP5MU70QO6,1,0,0,0,0,0,1,0,1,0.14285714285714285,1,0.0,0,0,0,0,0,0,0,1,0,0,1,1
3318,51481,BIBYBbrrZACu5lQBVU937ixjRuLu5I81,5Gyp41oLVo7Gg7vF4vpmggWP5MU70QO6,6,3,0,0,0,0,4,0,7,1.0,2,0.0,0,0,0,0,3,0,0,4,0,0,7,1
3319,51483,ASlnVt8E920lbgQCJxblWt3Bu4c4DX5a,5Gyp41oLVo7Gg7vF4vpmggWP5MU70QO6,40,116,5,34,23,34,16,3,231,33.0,6,0.0,25,5,22,23,91,34,12,16,3,75,156,1
3320,51485,LwxIbNwwwIqJzdDONFRGCSNSDsvCOPFx,5Gyp41oLVo7Gg7vF4vpmggWP5MU70QO6,1,0,0,0,0,0,4,0,4,0.5714285714285714,1,0.0,0,0,0,0,0,0,0,4,0,0,4,1
3321,51507,MBCX4v0rM9hS1aHMk7F9d197k8THGWLv,5Gyp41oLVo7Gg7vF4vpmggWP5MU70QO6,24,122,53,11,6,81,21,5,299,42.714285714285715,15,0.0,17,53,7,6,105,81,4,21,5,83,216,0
3322,51552,Dh8qbDxxlKjzZH8rNSVSz50NRROZa0p8,5Gyp41oLVo7Gg7vF4vpmggWP5MU70QO6,7,2,1,0,1,0,6,0,10,1.4285714285714286,1,0.0,0,1,0,1,2,0,0,6,0,2,8,1
3323,51563,WBvLVG145jdU2P71llhBJOxoT4IVQFra,5Gyp41oLVo7Gg7vF4vpmggWP5MU70QO6,15,18,10,6,8,0,4,0,46,6.571428571428571,3,0.0,5,10,3,8,13,0,3,4,0,26,20,1
3324,51570,tsY0YpxAz97OH8J3pGXuWuAcxzg4RYvp,5Gyp41oLVo7Gg7vF4vpmggWP5MU70QO6,14,20,12,0,6,5,9,1,53,7.571428571428571,3,0.0,2,12,0,6,18,5,0,9,1,20,33,0
3325,51575,t59eWzYbxh3bTemgPnwWvkINvX1koffX,5Gyp41oLVo7Gg7vF4vpmggWP5MU70QO6,5,2,1,0,1,0,2,0,6,0.8571428571428571,1,0.0,0,1,0,1,2,0,0,2,0,2,4,1
3326,51588,c7nNfpG3r5ECmvZLmI9s6iYaFduinQF4,5Gyp41oLVo7Gg7vF4vpmggWP5MU70QO6,4,2,1,0,0,0,3,0,6,0.8571428571428571,2,0.0,0,1,0,0,2,0,0,3,0,1,5,1
3327,51595,JrMAzfn8EtSTwcGXcaPgSvYimTCqdIMK,5Gyp41oLVo7Gg7vF4vpmggWP5MU70QO6,6,5,2,0,2,0,1,0,10,1.4285714285714286,1,0.0,0,2,0,2,5,0,0,1,0,4,6,1
3328,51608,xzsFQcCTOKCY5mCIPaCG8t4bl2I0FL3L,5Gyp41oLVo7Gg7vF4vpmggWP5MU70QO6,9,7,3,0,1,7,5,1,24,3.4285714285714284,1,0.0,1,3,0,1,6,7,0,5,1,5,19,1
3329,51610,iYmkUVGHT7OvfSsIIRGv9c31sCISp6uV,5Gyp41oLVo7Gg7vF4vpmggWP5MU70QO6,5,2,1,0,1,0,2,0,6,0.8571428571428571,1,0.0,0,1,0,1,2,0,0,2,0,2,4,0
3330,51617,KRYE8zUhXYbjeLaMR4yeJiqwVIzd4LUl,5Gyp41oLVo7Gg7vF4vpmggWP5MU70QO6,26,85,39,21,5,54,18,2,224,32.0,4,0.0,29,39,11,5,56,54,10,18,2,84,140,0
3331,51619,SOjjKY9wKGLuekw5UPAjpevRHzDodFcf,5Gyp41oLVo7Gg7vF4vpmggWP5MU70QO6,3,0,0,0,0,0,4,0,4,0.5714285714285714,1,0.0,0,0,0,0,0,0,0,4,0,0,4,1
3332,51635,z4RYoRdtpulrjADoXoIsZb2r7hfjRo9d,5Gyp41oLVo7Gg7vF4vpmggWP5MU70QO6,19,48,16,42,6,17,3,0,132,18.857142857142858,2,0.0,22,16,28,6,26,17,14,3,0,72,60,1
3333,51636,oALqCZLHWGwvVuLN82RIMqd1ng0ZjRuQ,5Gyp41oLVo7Gg7vF4vpmggWP5MU70QO6,1,0,0,0,0,0,1,0,1,0.14285714285714285,1,0.0,0,0,0,0,0,0,0,1,0,0,1,1
3334,51653,R2arBlVQ5DlnqBrwRZJfviZdapFQUxuy,5Gyp41oLVo7Gg7vF4vpmggWP5MU70QO6,58,76,45,50,19,7,23,1,221,31.571428571428573,7,0.0,18,45,41,19,58,7,9,23,1,123,98,0
3335,51655,bw9xs0TGdEwI3hCZrkWt8t3o1F7RfTQX,5Gyp41oLVo7Gg7vF4vpmggWP5MU70QO6,1,0,0,0,0,0,1,0,1,0.14285714285714285,1,0.0,0,0,0,0,0,0,0,1,0,0,1,1
3336,51680,tHPSGx00vsFzhzr0zwBlWWarqJT4wPHF,5Gyp41oLVo7Gg7vF4vpmggWP5MU70QO6,10,8,5,0,3,0,2,0,18,2.5714285714285716,2,0.0,1,5,0,3,7,0,0,2,0,9,9,0
3337,51687,CE7qhfQKtb3MqxeuQ8qallIgJXu1qxS5,5Gyp41oLVo7Gg7vF4vpmggWP5MU70QO6,31,110,51,23,9,9,29,4,235,33.57142857142857,5,0.0,33,51,14,9,77,9,9,29,4,107,128,0
3338,51690,qhmgArW8a15UOGQrFTosGi03wE1TjPeN,5Gyp41oLVo7Gg7vF4vpmggWP5MU70QO6,6,2,1,0,1,1,4,1,10,1.4285714285714286,1,0.0,0,1,0,1,2,1,0,4,1,2,8,1
3339,51696,ZKffl4afie5TLzJspqxShk1uv0QDfEMN,5Gyp41oLVo7Gg7vF4vpmggWP5MU70QO6,1,0,0,0,0,0,1,0,1,0.14285714285714285,1,0.0,0,0,0,0,0,0,0,1,0,0,1,1
3340,51701,KtWgTwHTBoytCTItyAbwHKJ3pGHpGdDv,5Gyp41oLVo7Gg7vF4vpmggWP5MU70QO6,1,0,0,0,0,0,1,0,1,0.14285714285714285,1,0.0,0,0,0,0,0,0,0,1,0,0,1,1
3341,51709,eT52ltjmGeDYs5FEiingSEPgC5EAV0W1,5Gyp41oLVo7Gg7vF4vpmggWP5MU70QO6,11,15,5,0,4,0,4,0,28,4.0,3,0.0,2,5,0,4,13,0,0,4,0,11,17,1
3342,51719,vQfYR3RaQe5bKTWc93Z7CoUzAprlVLbv,5Gyp41oLVo7Gg7vF4vpmggWP5MU70QO6,1,0,0,0,0,0,2,0,2,0.2857142857142857,1,0.0,0,0,0,0,0,0,0,2,0,0,2,1
3343,51732,mm4wmOvZtCSS235zGQ4M5AohuMrLoxAj,5Gyp41oLVo7Gg7vF4vpmggWP5MU70QO6,5,2,1,0,1,0,2,0,6,0.8571428571428571,1,0.0,0,1,0,1,2,0,0,2,0,2,4,1
3344,51746,0jee8jeDw5n1CCXRhYOv1ANBEod8h1JO,5Gyp41oLVo7Gg7vF4vpmggWP5MU70QO6,11,13,8,0,3,6,5,0,35,5.0,3,0.0,0,8,0,3,13,6,0,5,0,11,24,1
3345,51756,sJuxpvy6iaiEFXNqwOPDSCbQxADqSatT,5Gyp41oLVo7Gg7vF4vpmggWP5MU70QO6,1,0,0,0,0,0,1,0,1,0.14285714285714285,1,0.0,0,0,0,0,0,0,0,1,0,0,1,1
3346,51780,YGmG6QQHrFEaupwUrD4y2fAiDGnXz2Vs,5Gyp41oLVo7Gg7vF4vpmggWP5MU70QO6,1,0,0,0,0,0,1,0,1,0.14285714285714285,1,0.0,0,0,0,0,0,0,0,1,0,0,1,1
3347,51796,jGUi8ht5KI2NulUOHp46HFjGGsKi7cuc,5Gyp41oLVo7Gg7vF4vpmggWP5MU70QO6,2,0,0,0,0,0,3,0,3,0.42857142857142855,1,0.0,0,0,0,0,0,0,0,3,0,0,3,1
3348,51824,xP7v9orytxca6UvDQFsUNImEq7c1YiZx,5Gyp41oLVo7Gg7vF4vpmggWP5MU70QO6,6,5,1,0,1,0,2,0,9,1.2857142857142858,1,0.0,0,1,0,1,5,0,0,2,0,2,7,1
3349,51825,FwDLTPHw3sTAULAHFxRMaMOKv6yLFX98,5Gyp41oLVo7Gg7vF4vpmggWP5MU70QO6,10,18,5,0,5,0,3,0,31,4.428571428571429,2,0.0,6,5,0,5,12,0,0,3,0,16,15,1
3350,51842,RRTxLpGhKIvltZvSsiZiCAKYiNDjiP9o,5Gyp41oLVo7Gg7vF4vpmggWP5MU70QO6,7,3,2,0,2,0,4,0,11,1.5714285714285714,1,0.0,0,2,0,2,3,0,0,4,0,4,7,1
3351,51885,KKqDJFmpKUd46TAUE6OVnm7gnps6UeUh,5Gyp41oLVo7Gg7vF4vpmggWP5MU70QO6,3,0,0,0,0,0,3,0,3,0.42857142857142855,1,0.0,0,0,0,0,0,0,0,3,0,0,3,1
3352,51887,y8AR5gAVoLBSsXX35MG3ptBTsqGYN5fg,5Gyp41oLVo7Gg7vF4vpmggWP5MU70QO6,6,4,2,0,1,0,3,0,10,1.4285714285714286,1,0.0,0,2,0,1,4,0,0,3,0,3,7,1
3353,51893,cz1ypJ0fK6XmiNBNEoeA46wGs1VufYRf,5Gyp41oLVo7Gg7vF4vpmggWP5MU70QO6,34,98,45,26,23,11,24,3,230,32.857142857142854,5,0.0,36,45,19,23,62,11,7,24,3,123,107,0
3354,51939,C778ENtyLMJLc0Wf4WnEJMSgC28exMmB,5Gyp41oLVo7Gg7vF4vpmggWP5MU70QO6,7,3,2,0,2,0,2,0,9,1.2857142857142858,1,0.0,0,2,0,2,3,0,0,2,0,4,5,1
3355,51966,sGGFeAvfY7lj50ljXiEEQCcyf1h5u7M1,5Gyp41oLVo7Gg7vF4vpmggWP5MU70QO6,9,3,2,0,2,1,5,0,13,1.8571428571428572,1,0.0,0,2,0,2,3,1,0,5,0,4,9,1
3356,51967,qlyUkcKnt4n66zsFTiDZ1H8963znffup,5Gyp41oLVo7Gg7vF4vpmggWP5MU70QO6,1,0,0,0,0,0,1,0,1,0.14285714285714285,1,0.0,0,0,0,0,0,0,0,1,0,0,1,1
3357,51971,bnvm8fnzbQwJ3hRNatRWKMCkORAgyNkF,5Gyp41oLVo7Gg7vF4vpmggWP5MU70QO6,1,0,0,0,0,0,1,0,1,0.14285714285714285,1,0.0,0,0,0,0,0,0,0,1,0,0,1,1
3358,51972,GVGHFr4RjCkEsrUZViSIkcsds0jOH1hH,5Gyp41oLVo7Gg7vF4vpmggWP5MU70QO6,7,3,2,0,2,0,3,0,10,1.4285714285714286,1,0.0,0,2,0,2,3,0,0,3,0,4,6,1
3359,51991,nnwSZfxBmXfZyM59eV74xQk2yLHnc8D6,5Gyp41oLVo7Gg7vF4vpmggWP5MU70QO6,9,8,4,0,3,0,10,2,27,3.857142857142857,1,0.0,2,4,0,3,6,0,0,10,2,9,18,1
3360,51998,6ILZOIG4dpJv6KPosvpXbsZvViQf0aZY,5Gyp41oLVo7Gg7vF4vpmggWP5MU70QO6,1,0,0,0,0,0,1,0,1,0.14285714285714285,1,0.0,0,0,0,0,0,0,0,1,0,0,1,1
3361,52021,UHJFXK17Mvrp909DjyQXn9yqcVzGa7Hj,5Gyp41oLVo7Gg7vF4vpmggWP5MU70QO6,7,5,0,0,0,1,5,1,12,1.7142857142857142,1,0.0,0,0,0,0,5,1,0,5,1,0,12,1
3362,52038,4qIg4pAFpp96AXD2D6RAw2hm8PdGEDpT,5Gyp41oLVo7Gg7vF4vpmggWP5MU70QO6,6,4,1,0,1,0,2,0,8,1.1428571428571428,1,0.0,1,1,0,1,3,0,0,2,0,3,5,1
3363,52047,OnOMADnoNlvN8uVDeVdkjVcjflUdOJKt,5Gyp41oLVo7Gg7vF4vpmggWP5MU70QO6,19,18,7,25,3,0,5,0,58,8.285714285714286,2,0.0,6,7,16,3,12,0,9,5,0,32,26,1
3364,52052,lCGdbW0cq7tu4XgxScfvnDqPzb9JWjM7,5Gyp41oLVo7Gg7vF4vpmggWP5MU70QO6,3,0,0,0,0,0,5,0,5,0.7142857142857143,1,0.0,0,0,0,0,0,0,0,5,0,0,5,1
3365,52067,h7GuboD0ogzGTRqA8dPK90cUumzFsK9u,5Gyp41oLVo7Gg7vF4vpmggWP5MU70QO6,21,27,18,0,11,4,14,0,74,10.571428571428571,5,0.0,3,18,0,11,24,4,0,14,0,32,42,0
3366,52076,QwDettOM8dkwfhtLDwjHbqNUBLBlvPgu,5Gyp41oLVo7Gg7vF4vpmggWP5MU70QO6,11,6,3,0,2,0,5,0,16,2.2857142857142856,2,0.0,0,3,0,2,6,0,0,5,0,5,11,1
3367,52100,VPk4dvtGVkwqbTK9Y9Lrl8Tc3tyEBG7T,5Gyp41oLVo7Gg7vF4vpmggWP5MU70QO6,7,3,2,0,2,0,4,0,11,1.5714285714285714,1,0.0,0,2,0,2,3,0,0,4,0,4,7,1
3368,52138,tsIR2X1ddx5J3izAnImyG9xtupxwxgvv,5Gyp41oLVo7Gg7vF4vpmggWP5MU70QO6,1,0,0,0,0,0,1,0,1,0.14285714285714285,1,0.0,0,0,0,0,0,0,0,1,0,0,1,1
3369,52174,AhqSKxTzIQmvTa7Ncgq37ghFvQ8E1x83,5Gyp41oLVo7Gg7vF4vpmggWP5MU70QO6,8,4,2,0,1,0,10,0,17,2.4285714285714284,1,0.0,1,2,0,1,3,0,0,10,0,4,13,1
3370,52181,6tsK9lf3Seuaf0VSJ30JlPvB4lC5ECMz,5Gyp41oLVo7Gg7vF4vpmggWP5MU70QO6,6,3,1,0,1,0,2,0,7,1.0,1,0.0,0,1,0,1,3,0,0,2,0,2,5,1
3371,52186,CaCsA24Zvpna6ppXx7IuajFHe1iCGRrY,5Gyp41oLVo7Gg7vF4vpmggWP5MU70QO6,5,2,1,0,1,0,2,0,6,0.8571428571428571,1,0.0,0,1,0,1,2,0,0,2,0,2,4,1
3372,52210,scWdlOX3zv7Fw3w52tIrAiCVFn7qfyE0,5Gyp41oLVo7Gg7vF4vpmggWP5MU70QO6,8,4,2,0,2,0,2,0,10,1.4285714285714286,1,0.0,0,2,0,2,4,0,0,2,0,4,6,1
3373,52212,bz1tRAMyCJEZwR74NHea7IOrvcPFJI9o,5Gyp41oLVo7Gg7vF4vpmggWP5MU70QO6,1,0,0,0,0,0,1,0,1,0.14285714285714285,1,0.0,0,0,0,0,0,0,0,1,0,0,1,1
3374,52214,vOFpGbtS5cmjsTXlpKnczAYZvMiym3uV,5Gyp41oLVo7Gg7vF4vpmggWP5MU70QO6,7,3,2,0,2,0,2,0,9,1.2857142857142858,1,0.0,0,2,0,2,3,0,0,2,0,4,5,1
3375,52232,CiXNbYt4GI9npcqJXruK5iMBItV0IGgQ,5Gyp41oLVo7Gg7vF4vpmggWP5MU70QO6,16,26,15,4,6,12,9,0,72,10.285714285714286,5,0.0,2,15,2,6,24,12,2,9,0,25,47,0
3376,52238,6z9bkvAoRaGkuTSa2Ol35EzTHCRsbaKG,5Gyp41oLVo7Gg7vF4vpmggWP5MU70QO6,8,4,3,0,2,0,2,0,11,1.5714285714285714,1,0.0,0,3,0,2,4,0,0,2,0,5,6,1
3377,52246,DpKgvVGd2cJhveb5QdA2tBFVVettqcea,5Gyp41oLVo7Gg7vF4vpmggWP5MU70QO6,6,1,1,0,1,0,3,0,6,0.8571428571428571,1,0.0,0,1,0,1,1,0,0,3,0,2,4,1
3378,52252,ctWJAc5jN66ZRvfBzORGZ2QsqSBM7NJQ,5Gyp41oLVo7Gg7vF4vpmggWP5MU70QO6,2,0,0,0,0,0,2,0,2,0.2857142857142857,1,0.0,0,0,0,0,0,0,0,2,0,0,2,1
3379,52270,MWQlXDJXiker9jzrCCcTEUygIxBWwEe6,5Gyp41oLVo7Gg7vF4vpmggWP5MU70QO6,8,6,4,0,1,0,2,0,13,1.8571428571428572,1,0.0,1,4,0,1,5,0,0,2,0,6,7,1
3380,52272,H0XidwLIsZmWdbCPTFd0bRXdOyGgqqjF,5Gyp41oLVo7Gg7vF4vpmggWP5MU70QO6,2,0,0,0,0,0,4,0,4,0.5714285714285714,3,0.0,0,0,0,0,0,0,0,4,0,0,4,1
3381,52282,oE5sOqI6QsSiA4HdV0v7PWhXjJnY6a47,5Gyp41oLVo7Gg7vF4vpmggWP5MU70QO6,13,16,7,0,1,0,6,0,30,4.285714285714286,2,0.0,6,7,0,1,10,0,0,6,0,14,16,1
3382,52296,RXW97rF0SgW8w5XHhhECCGtvnyiOME4R,5Gyp41oLVo7Gg7vF4vpmggWP5MU70QO6,1,0,0,0,0,0,1,0,1,0.14285714285714285,1,0.0,0,0,0,0,0,0,0,1,0,0,1,1
3383,52305,1Bqfr0hSvH0b41V7S9Rm62rKp4rBDCIO,5Gyp41oLVo7Gg7vF4vpmggWP5MU70QO6,6,3,2,0,1,0,2,0,8,1.1428571428571428,1,0.0,0,2,0,1,3,0,0,2,0,3,5,1
3384,52314,Cb486oaNLCTCEGy9CoTKTUCP9RSvOUoH,5Gyp41oLVo7Gg7vF4vpmggWP5MU70QO6,1,0,0,0,0,0,1,0,1,0.14285714285714285,1,0.0,0,0,0,0,0,0,0,1,0,0,1,1
3385,52338,jGI6ToXYaFr5QpNlhLH2eKWZo5DWdaYD,5Gyp41oLVo7Gg7vF4vpmggWP5MU70QO6,4,7,0,0,0,0,3,0,10,1.4285714285714286,1,0.0,0,0,0,0,7,0,0,3,0,0,10,1
3386,52351,pXZnov33LQzlL1ag3wLXD0iMfUMXESwJ,5Gyp41oLVo7Gg7vF4vpmggWP5MU70QO6,15,24,17,5,9,5,17,1,78,11.142857142857142,4,0.0,6,17,3,9,18,5,2,17,1,35,43,1
3387,52358,rOCB1NPitCjPvv1ez8qWo625TnbV6Fbm,5Gyp41oLVo7Gg7vF4vpmggWP5MU70QO6,3,0,0,0,0,1,2,1,4,0.5714285714285714,1,0.0,0,0,0,0,0,1,0,2,1,0,4,1
3388,52370,3Gs0bXFvc4LLI7AfCF4oB5yzN9Yklpk0,5Gyp41oLVo7Gg7vF4vpmggWP5MU70QO6,10,14,6,0,2,0,5,0,27,3.857142857142857,4,0.0,1,6,0,2,13,0,0,5,0,9,18,1
3389,52374,xFoT6chNWPO8NhaVQB7bIHvYsC8ybg4Z,5Gyp41oLVo7Gg7vF4vpmggWP5MU70QO6,1,0,0,0,0,0,1,0,1,0.14285714285714285,1,0.0,0,0,0,0,0,0,0,1,0,0,1,1
3390,52387,aQ9CnnuCAIRGqHmWnpfeBTUlxegnsP3q,5Gyp41oLVo7Gg7vF4vpmggWP5MU70QO6,13,19,5,0,4,4,16,2,50,7.142857142857143,4,0.0,7,5,0,4,12,4,0,16,2,16,34,0
3391,52388,hdmv0McMoVHMLLrHqFYCXO6Pxxwgsh7q,5Gyp41oLVo7Gg7vF4vpmggWP5MU70QO6,6,3,1,0,2,0,1,0,7,1.0,1,0.0,0,1,0,2,3,0,0,1,0,3,4,1
3392,52389,FKe53Gv2w1Zwg0Iba7RZZwJM9Y2eERSG,5Gyp41oLVo7Gg7vF4vpmggWP5MU70QO6,12,23,7,13,7,0,2,0,52,7.428571428571429,1,0.0,8,7,10,7,15,0,3,2,0,32,20,1
3393,52398,Q0PzQpnPe8SOmoovDUUa2g54jTcYAO1Q,5Gyp41oLVo7Gg7vF4vpmggWP5MU70QO6,9,4,1,0,2,0,4,1,12,1.7142857142857142,1,0.0,0,1,0,2,4,0,0,4,1,3,9,1
3394,52405,XydvMA0BgL1Al10q3L0D2wz1Y6wVb2rC,5X6FeZozNMgE2VRi3MJYjkkFK8SETtu2,54,70,29,0,57,2,7,0,165,23.571428571428573,4,0.0,35,29,0,57,35,2,0,7,0,121,44,1
3395,52627,EbKjJZq8GOECUxJBvCCbIZN8O8RweU4z,5X6FeZozNMgE2VRi3MJYjkkFK8SETtu2,11,18,6,0,14,0,2,0,40,5.714285714285714,2,0.0,10,6,0,14,8,0,0,2,0,30,10,1
3396,52648,PCT9UecTLFgHQMLESQLM3zo2VKyldhOq,7GRhBDsirIGkRZBtSMEzNTyDr2JQm4xx,3,4,2,0,0,0,2,0,8,1.1428571428571428,2,0.0,0,2,0,0,4,0,0,2,0,2,6,0
3397,52668,ub9oOCoL9cGnQSH3zubxNnnsblJY03jm,5X6FeZozNMgE2VRi3MJYjkkFK8SETtu2,5,2,1,0,1,0,2,0,6,0.8571428571428571,1,0.0,0,1,0,1,2,0,0,2,0,2,4,1
3398,52688,0Pyw7HKEB2SM2jK3ml9nk8ciHo5seMMx,5X6FeZozNMgE2VRi3MJYjkkFK8SETtu2,9,7,3,0,2,1,6,1,20,2.857142857142857,1,0.0,0,3,0,2,7,1,0,6,1,5,15,0
3399,52705,Z7RrJYLLbvUuUiPg9CWslVocwxBTUDWy,5X6FeZozNMgE2VRi3MJYjkkFK8SETtu2,1,0,0,0,0,0,1,0,1,0.14285714285714285,1,0.0,0,0,0,0,0,0,0,1,0,0,1,1
3400,52730,8XaoEwTyWeXdGPkk69feFC4MnARlyEPY,7GRhBDsirIGkRZBtSMEzNTyDr2JQm4xx,38,46,4,26,13,5,8,1,103,14.714285714285714,2,0.0,25,4,25,13,21,5,1,8,1,67,36,0
3401,52749,2E5IBJ0dkMcN4wshO47gaNDhROz8v0SJ,5X6FeZozNMgE2VRi3MJYjkkFK8SETtu2,43,40,12,80,20,0,1,0,153,21.857142857142858,1,0.0,26,12,74,20,14,0,6,1,0,132,21,1
3402,52756,hyGNNqxhAyFxbHW9ng6YRyMeUCWAgj0x,5X6FeZozNMgE2VRi3MJYjkkFK8SETtu2,4,2,1,0,1,0,1,0,5,0.7142857142857143,1,0.0,0,1,0,1,2,0,0,1,0,2,3,1
3403,52771,0mg5UfmflBvw9f6RP57AlBJRO9poj3Bs,5X6FeZozNMgE2VRi3MJYjkkFK8SETtu2,19,21,14,26,9,0,5,0,75,10.714285714285714,2,0.0,2,14,21,9,19,0,5,5,0,46,29,1
3404,52876,YLANZPJHmSiI5Lb9P4F0Gshaw8Xy809b,5X6FeZozNMgE2VRi3MJYjkkFK8SETtu2,2,0,0,0,0,0,2,0,2,0.2857142857142857,1,0.0,0,0,0,0,0,0,0,2,0,0,2,1
3405,52886,tuClSbz7p6HhpkAOyf6VUIvd6ariEHmb,5X6FeZozNMgE2VRi3MJYjkkFK8SETtu2,1,0,0,0,0,0,1,0,1,0.14285714285714285,1,0.0,0,0,0,0,0,0,0,1,0,0,1,0
3406,52938,fhjtgu2LR6DQ0FWqUyl3qWg718eD1pm8,5X6FeZozNMgE2VRi3MJYjkkFK8SETtu2,6,5,0,0,0,0,5,0,10,1.4285714285714286,1,0.0,0,0,0,0,5,0,0,5,0,0,10,1
3407,52950,fWZgP0XbRPXR1W1wGS4xEWSR9s0TsZDO,5X6FeZozNMgE2VRi3MJYjkkFK8SETtu2,1,0,0,0,0,0,1,0,1,0.14285714285714285,1,0.0,0,0,0,0,0,0,0,1,0,0,1,1
3408,52952,MfF2UM103u4NW6P3ppuUwg5ByBUcnBZA,7GRhBDsirIGkRZBtSMEzNTyDr2JQm4xx,11,14,7,0,6,0,2,0,29,4.142857142857143,1,0.0,0,7,0,6,14,0,0,2,0,13,16,1
3409,52954,9Jy1wR1kNKfVIlzkWjf6DnrfYfDGnPzT,5X6FeZozNMgE2VRi3MJYjkkFK8SETtu2,9,17,7,0,2,0,8,0,34,4.857142857142857,3,0.0,4,7,0,2,13,0,0,8,0,13,21,1
3410,52969,Qfd5NSQMshaz9tIWhiDXjUxqfga3DDZq,5X6FeZozNMgE2VRi3MJYjkkFK8SETtu2,20,15,2,1,1,0,2,0,21,3.0,1,0.0,0,2,1,1,15,0,0,2,0,4,17,1
3411,53007,0d9QTHxHI38QwsI8Nrfe3h4nIFkKB9wm,7GRhBDsirIGkRZBtSMEzNTyDr2JQm4xx,1,2,0,0,0,0,0,0,2,0.2857142857142857,2,0.0,0,0,0,0,2,0,0,0,0,0,2,0
3412,53011,GZZNq061lXwXR7WgklaRbZ8ItW5pxFQW,5X6FeZozNMgE2VRi3MJYjkkFK8SETtu2,2,0,0,0,0,0,2,0,2,0.2857142857142857,1,0.0,0,0,0,0,0,0,0,2,0,0,2,1
3413,53022,fpL49L4pRoYIOyXEEhNfWE8QrqJt2aKb,5X6FeZozNMgE2VRi3MJYjkkFK8SETtu2,4,2,0,0,0,0,2,0,4,0.5714285714285714,1,0.0,0,0,0,0,2,0,0,2,0,0,4,1
3414,53041,FW02PfU8vx3pzmS7oOXpJualmcvfngs4,SpATywNh6bZuzm8s1ceuBUnMUAeoAHHw,5,8,0,0,0,0,2,0,10,1.4285714285714286,2,0.0,1,0,0,0,7,0,0,2,0,1,9,0
3415,53043,4LLdV2zTWS697dAsOgAPJZPFwfNnrjt6,SpATywNh6bZuzm8s1ceuBUnMUAeoAHHw,18,17,14,0,9,0,3,0,43,6.142857142857143,3,0.0,0,14,0,9,17,0,0,3,0,23,20,0
3416,53074,vwFaMtviPYvvdeDxiexQOh059O9Yefj1,SpATywNh6bZuzm8s1ceuBUnMUAeoAHHw,11,19,0,0,0,0,1,0,20,2.857142857142857,2,0.0,0,0,0,0,19,0,0,1,0,0,20,1
3417,53109,fFw6uRnMpWU4RqpwQO2WZ8GCAi6hyn9t,SpATywNh6bZuzm8s1ceuBUnMUAeoAHHw,1,0,0,0,0,0,1,0,1,0.14285714285714285,1,0.0,0,0,0,0,0,0,0,1,0,0,1,0
3418,53110,ovvuiEhj0QBv4xi11GVjXr8JhlCgaPmd,bWdj2GDclj5ofokWjzoa5jAwMkxCykd6,6,3,3,0,1,0,5,0,12,1.7142857142857142,2,0.0,0,3,0,1,3,0,0,5,0,4,8,0
3419,53157,H8hoxOy1VDjrCqtl8Y1RjEzCSImzfPb1,SpATywNh6bZuzm8s1ceuBUnMUAeoAHHw,7,7,3,0,1,0,1,0,12,1.7142857142857142,1,0.0,0,3,0,1,7,0,0,1,0,4,8,1
3420,53162,4nHfdAZtp0niyFyrjm2L6LhTVPrJBlZM,A3fsA9Zfv1X2fVEQhTw51lKENdNrEqT3,44,47,25,60,15,0,12,0,159,22.714285714285715,3,0.0,2,25,55,15,45,0,5,12,0,97,62,1
3421,53190,cWykzNKAq5sFQBA059QN4Jx74YGPkfwB,SpATywNh6bZuzm8s1ceuBUnMUAeoAHHw,15,17,0,30,0,0,2,0,49,7.0,1,0.0,8,0,28,0,9,0,2,2,0,36,13,0
3422,53199,RfxrjGWEyzBCwnQEmvcmVh3DEMcbhg4m,bWdj2GDclj5ofokWjzoa5jAwMkxCykd6,4,2,1,0,1,0,0,0,4,0.5714285714285714,1,0.0,0,1,0,1,2,0,0,0,0,2,2,1
3423,53233,nOWqKetxGFQ9o73UNfcoh0XyCt3ITawR,SpATywNh6bZuzm8s1ceuBUnMUAeoAHHw,3,4,2,0,0,0,3,0,9,1.2857142857142858,2,0.0,0,2,0,0,4,0,0,3,0,2,7,0
3424,53253,nsNOT1cU6IuLaV7JjnTNsqpFb1YDxqEb,SpATywNh6bZuzm8s1ceuBUnMUAeoAHHw,19,34,18,8,1,10,8,0,79,11.285714285714286,4,0.0,6,18,8,1,28,10,0,8,0,33,46,0
3425,53297,wEZByhPumKHDR8Jv649KZn2fKnoB4Z7a,RXDvfPUBYFlVdlueBFbLW0mhhAyGEqpt,29,38,4,85,3,3,0,0,133,19.0,3,0.0,11,4,80,3,27,3,5,0,0,98,35,0
3426,53355,NiXPZUmEILmWUPwXexYxtHvaIL7QdjCQ,A3fsA9Zfv1X2fVEQhTw51lKENdNrEqT3,3,2,1,0,0,0,1,0,4,0.5714285714285714,1,0.0,0,1,0,0,2,0,0,1,0,1,3,1
3427,53367,qJEf5DGSDkSxZ1JIhipEbBFRbrhnAj1a,SpATywNh6bZuzm8s1ceuBUnMUAeoAHHw,14,32,0,0,1,0,7,0,40,5.714285714285714,2,0.0,0,0,0,1,32,0,0,7,0,1,39,0
3428,53378,5IoXxgwnl1RIJLxkp1FnmYezwVSXlFjr,SpATywNh6bZuzm8s1ceuBUnMUAeoAHHw,47,69,31,59,15,2,12,0,188,26.857142857142858,4,0.0,27,31,46,15,42,2,13,12,0,119,69,0
3429,53487,N3Kcp8HxIitle1dnmjMusLDj62CzfGvL,SpATywNh6bZuzm8s1ceuBUnMUAeoAHHw,5,3,1,0,1,0,1,0,6,0.8571428571428571,1,0.0,0,1,0,1,3,0,0,1,0,2,4,0
3430,53502,MrmZgmDV3fLNPBur1xb2HpNXhTz9Exkt,SpATywNh6bZuzm8s1ceuBUnMUAeoAHHw,9,5,1,16,0,0,2,0,24,3.4285714285714284,1,0.0,2,1,13,0,3,0,3,2,0,16,8,0
3431,53520,MhrFHIexWYn2dilUXh03cpnfpoe9tMBe,SpATywNh6bZuzm8s1ceuBUnMUAeoAHHw,3,2,1,0,0,0,1,0,4,0.5714285714285714,1,0.0,0,1,0,0,2,0,0,1,0,1,3,1
3432,53539,i2lUV72IHqqXWYqLFMWv3y4XGmlq2lXa,SpATywNh6bZuzm8s1ceuBUnMUAeoAHHw,10,9,5,11,0,1,2,0,28,4.0,1,0.0,2,5,10,0,7,1,1,2,0,17,11,0
3433,53584,6ulfbgGgKweBR5jQh3XucxQAX08OMB72,SpATywNh6bZuzm8s1ceuBUnMUAeoAHHw,8,5,1,0,2,0,1,0,9,1.2857142857142858,1,0.0,0,1,0,2,5,0,0,1,0,3,6,0
3434,53678,uqIn0vdfJ1SDJCOeCVEAQPRFBBKQA2eB,bWdj2GDclj5ofokWjzoa5jAwMkxCykd6,8,7,3,4,1,0,1,0,16,2.2857142857142856,1,0.0,1,3,4,1,6,0,0,1,0,9,7,1
3435,53714,Ar22lkOE5FvesxoMKtYhm8Cbv4MUQUYF,RXDvfPUBYFlVdlueBFbLW0mhhAyGEqpt,3,0,0,0,0,0,4,0,4,0.5714285714285714,1,0.0,0,0,0,0,0,0,0,4,0,0,4,1
3436,53750,DHyGbluRYDb9YK4sD54nYIDtRwaCVU4f,SpATywNh6bZuzm8s1ceuBUnMUAeoAHHw,21,29,0,21,0,0,2,0,52,7.428571428571429,1,0.0,7,0,18,0,22,0,3,2,0,25,27,1
3437,53758,Hu906OsUOpYkLeeay2GUzLMtBtAH0201,SpATywNh6bZuzm8s1ceuBUnMUAeoAHHw,10,16,3,0,3,0,4,0,26,3.7142857142857144,2,0.0,0,3,0,3,16,0,0,4,0,6,20,1
3438,53815,zSmc8rKmn3W7ClGZoLsZk5lSBVQHeitz,SpATywNh6bZuzm8s1ceuBUnMUAeoAHHw,6,5,0,0,0,0,5,0,10,1.4285714285714286,2,0.0,0,0,0,0,5,0,0,5,0,0,10,0
3439,53838,QApdmb1PXR97hGOt28aAXkYQiicNqOKw,SpATywNh6bZuzm8s1ceuBUnMUAeoAHHw,16,22,0,12,0,0,5,0,39,5.571428571428571,2,0.0,6,0,11,0,16,0,1,5,0,17,22,0
3440,53858,6Upqh8KDtBiZuS1AWTucTCCkEJCPfX5m,SpATywNh6bZuzm8s1ceuBUnMUAeoAHHw,14,36,4,13,2,22,4,0,81,11.571428571428571,4,0.0,7,4,11,2,29,22,2,4,0,24,57,0
3441,53861,Su9COtUoYOdyYjAUoqvAULKdQODTHr7E,bWdj2GDclj5ofokWjzoa5jAwMkxCykd6,23,12,4,46,2,0,4,0,68,9.714285714285714,4,0.0,2,4,41,2,10,0,5,4,0,49,19,0
3442,53980,f50myi7Wnjd1BWfZdyqaXMcdfMAdeGX9,G8EPVSXsOYB5YQWZGiz1aVq5Pgr2GrQu,22,22,0,24,0,0,7,0,53,7.571428571428571,3,0.0,1,0,24,0,21,0,0,7,0,25,28,0
3443,54001,Gglvz7f1jVuISouyvTJRaLDdezGOZ6EL,SpATywNh6bZuzm8s1ceuBUnMUAeoAHHw,20,16,7,17,6,0,7,0,53,7.571428571428571,1,0.0,2,7,14,6,14,0,3,7,0,29,24,0
3444,54015,Uo49WNvktWkKOAhlqrqOXLXaeoQpAgrc,SpATywNh6bZuzm8s1ceuBUnMUAeoAHHw,13,13,12,0,10,0,1,0,36,5.142857142857143,1,0.0,0,12,0,10,13,0,0,1,0,22,14,1
3445,54018,dyoINQ9hlelfXhGgA7SokU45MaV6r2b8,SpATywNh6bZuzm8s1ceuBUnMUAeoAHHw,21,17,12,16,7,0,3,0,55,7.857142857142857,3,0.0,2,12,13,7,15,0,3,3,0,34,21,0
3446,54026,gw1ywpstRy3gY1kWojp1woauzVM2ZYVr,SpATywNh6bZuzm8s1ceuBUnMUAeoAHHw,20,25,21,10,5,0,2,0,63,9.0,1,0.0,3,21,9,5,22,0,1,2,0,38,25,0
3447,54029,So8gZ8cXseEZ7lXf4idNMqcN46bXtlIA,SpATywNh6bZuzm8s1ceuBUnMUAeoAHHw,22,29,16,14,9,0,6,0,74,10.571428571428571,4,0.0,6,16,11,9,23,0,3,6,0,42,32,0
3448,54071,vYeGcWGAJP4B8Lvbjdr2jkY9NnpHN8xb,SpATywNh6bZuzm8s1ceuBUnMUAeoAHHw,7,8,6,0,2,0,4,0,20,2.857142857142857,1,0.0,0,6,0,2,8,0,0,4,0,8,12,1
3449,54076,33fwsM5EFqk5KwLRS1Hdk3QGBr5jYWOs,SpATywNh6bZuzm8s1ceuBUnMUAeoAHHw,10,6,3,10,1,0,2,0,22,3.142857142857143,1,0.0,2,3,9,1,4,0,1,2,0,15,7,0
3450,54094,Fdt86Xu5OLPdaOgl6M1XDpiJ3zar7SU6,SpATywNh6bZuzm8s1ceuBUnMUAeoAHHw,6,4,3,0,0,0,4,2,13,1.8571428571428572,1,0.0,0,3,0,0,4,0,0,4,2,3,10,0
3451,54121,nVNeaHavpiSEFe567sT2ScRxObLjhEGL,G8EPVSXsOYB5YQWZGiz1aVq5Pgr2GrQu,5,3,2,0,1,0,1,0,7,1.0,1,0.0,0,2,0,1,3,0,0,1,0,3,4,1
3452,54129,qKOvjGeHnXAGhScloNy1qhNnfc1xHZ3T,SpATywNh6bZuzm8s1ceuBUnMUAeoAHHw,10,13,2,0,2,0,2,0,19,2.7142857142857144,1,0.0,3,2,0,2,10,0,0,2,0,7,12,0
3453,54132,PfTpx7WgTJY6IpNokJ2POml34GMs7LTI,bWdj2GDclj5ofokWjzoa5jAwMkxCykd6,24,12,8,34,4,0,3,0,61,8.714285714285714,2,0.0,2,8,34,4,10,0,0,3,0,48,13,0
3454,54134,BtB75B9l8XyH0uPaKeOkkRrm2NqBrtQe,A3fsA9Zfv1X2fVEQhTw51lKENdNrEqT3,9,8,5,0,3,0,2,0,18,2.5714285714285716,1,0.0,0,5,0,3,8,0,0,2,0,8,10,1
3455,54176,i2jPckJdA9hhx8KLohXM0CrojRerYpdv,SpATywNh6bZuzm8s1ceuBUnMUAeoAHHw,19,21,12,15,6,0,2,0,56,8.0,1,0.0,7,12,13,6,14,0,2,2,0,38,18,0
3456,54231,o6TNCL8FasDR1iE3PXeICx9M4vKCc0T1,bWdj2GDclj5ofokWjzoa5jAwMkxCykd6,8,16,11,0,8,0,1,0,36,5.142857142857143,3,0.0,0,11,0,8,16,0,0,1,0,19,17,1
3457,54287,kuiW3Le0WeMGiwxmKgXwp1GfHw3vKMeq,SpATywNh6bZuzm8s1ceuBUnMUAeoAHHw,5,3,2,0,1,0,1,0,7,1.0,1,0.0,0,2,0,1,3,0,0,1,0,3,4,1
3458,54419,H4rucA3Bl92feiIFqEyA7i9inMfODBCx,SpATywNh6bZuzm8s1ceuBUnMUAeoAHHw,4,3,2,0,0,0,1,0,6,0.8571428571428571,1,0.0,0,2,0,0,3,0,0,1,0,2,4,0
3459,54447,6A2JLpLWnCwUlo9pD1HHlgEwNLvzcllv,A3fsA9Zfv1X2fVEQhTw51lKENdNrEqT3,34,26,4,58,2,0,4,0,94,13.428571428571429,2,0.0,1,4,47,2,25,0,11,4,0,54,40,1
3460,54458,w8ymvO72UlYPBd2tG0A8iTEwt4UoIvlZ,A3fsA9Zfv1X2fVEQhTw51lKENdNrEqT3,4,7,3,0,0,0,1,0,11,1.5714285714285714,1,0.0,2,3,0,0,5,0,0,1,0,5,6,1
3461,54467,Ha2E1KX6VBrxAJ0Y64ONsTCt1RbrAdiK,SpATywNh6bZuzm8s1ceuBUnMUAeoAHHw,26,17,15,0,13,0,5,0,50,7.142857142857143,2,0.0,0,15,0,13,17,0,0,5,0,28,22,0
3462,54509,HPaDTzk2xymxbpoa0VdcxdHl3uFfOfZk,bWdj2GDclj5ofokWjzoa5jAwMkxCykd6,1,0,0,0,0,0,1,0,1,0.14285714285714285,1,0.0,0,0,0,0,0,0,0,1,0,0,1,1
3463,54512,x6BtQH70uuLHaxqzHA21U9wmfT0SxzD9,SpATywNh6bZuzm8s1ceuBUnMUAeoAHHw,25,36,2,26,2,3,43,3,115,16.428571428571427,8,0.0,8,2,20,2,28,3,6,43,3,32,83,0
3464,54524,CxUPOQRaQMGLmbOcfniIQOhh24PXLDR6,bWdj2GDclj5ofokWjzoa5jAwMkxCykd6,2,2,2,0,0,0,0,0,4,0.5714285714285714,2,0.0,0,2,0,0,2,0,0,0,0,2,2,0
3465,54586,XMX9ZzyckuT66ALkAoQ1Ndie7Ls8rbRQ,fbPkOYLVPtPgIt0MxizjfFJov3JbHyAi,3,0,0,0,0,0,6,0,6,0.8571428571428571,1,0.0,0,0,0,0,0,0,0,6,0,0,6,1
3466,54587,XwtXdahYBtKn1j9zGxg0PnMltlmGyk2u,fbPkOYLVPtPgIt0MxizjfFJov3JbHyAi,1,0,0,0,0,0,1,0,1,0.14285714285714285,1,0.0,0,0,0,0,0,0,0,1,0,0,1,1
3467,54588,iL3U1k6BvBmHPE9rSR4M1VNouviCTM2t,fbPkOYLVPtPgIt0MxizjfFJov3JbHyAi,4,3,1,0,1,0,2,0,7,1.0,1,0.0,0,1,0,1,3,0,0,2,0,2,5,1
3468,54590,UKq5lhvAp06ZhcbYGirhBoJurTHlyP25,fbPkOYLVPtPgIt0MxizjfFJov3JbHyAi,5,2,1,0,1,0,2,0,6,0.8571428571428571,1,0.0,0,1,0,1,2,0,0,2,0,2,4,1
3469,54591,RPtZCNTAyQipNNl051bobyaDbhugsIOS,fbPkOYLVPtPgIt0MxizjfFJov3JbHyAi,1,0,0,0,0,0,1,0,1,0.14285714285714285,1,0.0,0,0,0,0,0,0,0,1,0,0,1,1
3470,54592,CWFidUgIzgdopV7O6G9SWuzois32YUUt,fbPkOYLVPtPgIt0MxizjfFJov3JbHyAi,1,0,0,0,0,0,1,0,1,0.14285714285714285,1,0.0,0,0,0,0,0,0,0,1,0,0,1,1
3471,54593,S5r0CKOxIwwZ6o4r0E3DEfNq3HUydzP8,fbPkOYLVPtPgIt0MxizjfFJov3JbHyAi,77,120,42,30,61,5,2,0,260,37.142857142857146,2,0.0,76,42,29,61,44,5,1,2,0,208,52,0
3472,54595,jMSxxfftYD0taGWVEUZkcvxpGucC0j8q,fbPkOYLVPtPgIt0MxizjfFJov3JbHyAi,8,4,3,0,2,0,2,0,11,1.5714285714285714,1,0.0,0,3,0,2,4,0,0,2,0,5,6,1
3473,54596,4iIFGSGht2JSMTrJpTy2D2ifltt0fayQ,fbPkOYLVPtPgIt0MxizjfFJov3JbHyAi,5,4,1,0,1,0,1,0,7,1.0,1,0.0,0,1,0,1,4,0,0,1,0,2,5,1
3474,54597,aLRP3ahB5SIcOn5vpM1VPEh9ib2QIioX,fbPkOYLVPtPgIt0MxizjfFJov3JbHyAi,19,34,19,0,10,0,11,0,74,10.571428571428571,2,0.0,0,19,0,10,34,0,0,11,0,29,45,1
3475,54598,mrfe3bnp3SndeE2oXZeqVQsRy8JkXozQ,fbPkOYLVPtPgIt0MxizjfFJov3JbHyAi,1,0,0,0,0,0,1,0,1,0.14285714285714285,1,0.0,0,0,0,0,0,0,0,1,0,0,1,1
3476,54600,3jguyYNURG292EUyxbyVUDYpy7NMnhYE,fbPkOYLVPtPgIt0MxizjfFJov3JbHyAi,2,0,0,0,0,0,3,0,3,0.42857142857142855,1,0.0,0,0,0,0,0,0,0,3,0,0,3,1
3477,54602,hykYMYi1SCeVtZUyKpT75CoPzh8xB9pn,fbPkOYLVPtPgIt0MxizjfFJov3JbHyAi,20,18,8,6,12,0,4,0,48,6.857142857142857,1,0.0,10,8,5,12,8,0,1,4,0,35,13,1
3478,54603,3dZz5nboCyxa8YKpUFHpHSa7N8m8WCDt,fbPkOYLVPtPgIt0MxizjfFJov3JbHyAi,2,0,0,0,0,0,5,0,5,0.7142857142857143,1,0.0,0,0,0,0,0,0,0,5,0,0,5,1
3479,54604,X3X3klM03RXeGUjty93sg2SlkZrg3xpQ,fbPkOYLVPtPgIt0MxizjfFJov3JbHyAi,20,35,20,7,7,0,8,0,77,11.0,2,0.0,8,20,6,7,27,0,1,8,0,41,36,1
3480,54605,68Y0pXhq9Lx2MQo0abFJCRjCfXDaWS2b,fbPkOYLVPtPgIt0MxizjfFJov3JbHyAi,5,4,0,0,0,0,3,0,7,1.0,1,0.0,0,0,0,0,4,0,0,3,0,0,7,1
3481,54606,JKXm7kCLnrEkQn6smb2KejU80afBEA8I,fbPkOYLVPtPgIt0MxizjfFJov3JbHyAi,1,0,0,0,0,0,1,0,1,0.14285714285714285,1,0.0,0,0,0,0,0,0,0,1,0,0,1,1
3482,54607,3ayJeMiC46YUIYHWS9RASqN9Dt7wyONm,fbPkOYLVPtPgIt0MxizjfFJov3JbHyAi,5,0,0,0,0,0,6,1,7,1.0,1,0.0,0,0,0,0,0,0,0,6,1,0,7,1
3483,54608,MrDXcYGCOMj7Og2GASLJ6dZyvLj00XPp,fbPkOYLVPtPgIt0MxizjfFJov3JbHyAi,1,0,0,0,0,0,1,0,1,0.14285714285714285,1,0.0,0,0,0,0,0,0,0,1,0,0,1,1
3484,54610,E4HSnpUkqI5y9XSTBy23MiGSddJydK2h,fbPkOYLVPtPgIt0MxizjfFJov3JbHyAi,5,2,1,0,1,0,2,0,6,0.8571428571428571,1,0.0,0,1,0,1,2,0,0,2,0,2,4,1
3485,54614,4dfnEKxHCmGabkBCiKHt5nKr3H7Bwo1x,fbPkOYLVPtPgIt0MxizjfFJov3JbHyAi,1,0,0,0,0,0,1,0,1,0.14285714285714285,1,0.0,0,0,0,0,0,0,0,1,0,0,1,1
3486,54615,FJLE8ZIB8tn8NP6ctFklhYObRCm7VWUC,fbPkOYLVPtPgIt0MxizjfFJov3JbHyAi,8,9,3,0,2,0,4,0,18,2.5714285714285716,1,0.0,0,3,0,2,9,0,0,4,0,5,13,1
3487,54616,cgTRAnMuMn887xEhHTcg5rpmYHHPoyIP,fbPkOYLVPtPgIt0MxizjfFJov3JbHyAi,6,7,5,0,0,13,2,0,27,3.857142857142857,2,0.0,0,5,0,0,7,13,0,2,0,5,22,0
3488,54617,v4j1wfop6EMQnhgchWfG3Fk2beob6Ah0,fbPkOYLVPtPgIt0MxizjfFJov3JbHyAi,8,2,2,0,2,0,3,0,9,1.2857142857142858,1,0.0,0,2,0,2,2,0,0,3,0,4,5,1
3489,54618,bgBEVIT7lED5jwl9T1xbuywAm7JQXaqp,fbPkOYLVPtPgIt0MxizjfFJov3JbHyAi,7,10,3,0,2,0,6,0,21,3.0,1,0.0,0,3,0,2,10,0,0,6,0,5,16,1
3490,54619,tWw75YIFgGadaRnkyPeGlfSVpk3ysa4L,fbPkOYLVPtPgIt0MxizjfFJov3JbHyAi,1,0,0,0,0,0,1,0,1,0.14285714285714285,1,0.0,0,0,0,0,0,0,0,1,0,0,1,1
3491,54620,z4EDsyht0TzSAKAyhX4LHmg2BH9dRlQd,fbPkOYLVPtPgIt0MxizjfFJov3JbHyAi,3,2,1,0,0,0,2,0,5,0.7142857142857143,1,0.0,0,1,0,0,2,0,0,2,0,1,4,1
3492,54621,NBbu054C30RuH0I4yDic7caWEQZO4bn5,fbPkOYLVPtPgIt0MxizjfFJov3JbHyAi,12,14,4,9,5,0,2,0,34,4.857142857142857,2,0.0,7,4,7,5,7,0,2,2,0,23,11,1
3493,54622,X8MvmBWiv5czlgrpqB1eLRykN3Qwf2jh,fbPkOYLVPtPgIt0MxizjfFJov3JbHyAi,1,0,0,0,0,0,1,0,1,0.14285714285714285,1,0.0,0,0,0,0,0,0,0,1,0,0,1,1
3494,54624,PC4EL6B63vuOYbykrnGpiuWu1FrHfz8b,fbPkOYLVPtPgIt0MxizjfFJov3JbHyAi,6,6,1,0,1,0,2,0,10,1.4285714285714286,1,0.0,1,1,0,1,5,0,0,2,0,3,7,1
3495,54625,OJlmjkvuQW4IsXhvjyjAhhq68S3friGW,fbPkOYLVPtPgIt0MxizjfFJov3JbHyAi,14,21,10,7,7,7,4,1,57,8.142857142857142,2,0.0,9,10,6,7,12,7,1,4,1,32,25,1
3496,54627,oW31TfZT4sMwKphpcFRVlAdMfoQmLRUC,fbPkOYLVPtPgIt0MxizjfFJov3JbHyAi,1,0,0,0,0,0,1,0,1,0.14285714285714285,1,0.0,0,0,0,0,0,0,0,1,0,0,1,1
3497,54628,KaJKU9td3vSh2K6R1qjWlYSN0w1tZztZ,fbPkOYLVPtPgIt0MxizjfFJov3JbHyAi,1,0,0,0,0,0,1,0,1,0.14285714285714285,1,0.0,0,0,0,0,0,0,0,1,0,0,1,1
3498,54629,AkvoyA0ovU8KwnK8lPG0oOHqQo6t4vfK,fbPkOYLVPtPgIt0MxizjfFJov3JbHyAi,15,12,9,0,5,0,5,0,31,4.428571428571429,1,0.0,0,9,0,5,12,0,0,5,0,14,17,1
3499,54630,vzQWE9ulRkQ7hUrO1Cw0UEGI4ALwL8Jg,fbPkOYLVPtPgIt0MxizjfFJov3JbHyAi,5,2,1,0,1,0,2,0,6,0.8571428571428571,1,0.0,0,1,0,1,2,0,0,2,0,2,4,1
3500,54634,jg6mic3A2edNAJQLBV82OtqrTUZvWZsn,fbPkOYLVPtPgIt0MxizjfFJov3JbHyAi,2,0,0,0,0,0,2,0,2,0.2857142857142857,1,0.0,0,0,0,0,0,0,0,2,0,0,2,1
3501,54635,FocgTK7ZKP5rXdprEvR0U5yJcvk72CbF,fbPkOYLVPtPgIt0MxizjfFJov3JbHyAi,1,0,0,0,0,0,1,0,1,0.14285714285714285,1,0.0,0,0,0,0,0,0,0,1,0,0,1,1
3502,54636,pmZbE114x6R9Sm7IX225BSoFooNlDkab,fbPkOYLVPtPgIt0MxizjfFJov3JbHyAi,6,5,3,0,2,0,4,0,14,2.0,1,0.0,0,3,0,2,5,0,0,4,0,5,9,1
3503,54637,MUxj4zhJzjf6cGr6IrakP1EI9h9I48vr,fbPkOYLVPtPgIt0MxizjfFJov3JbHyAi,1,0,0,0,0,0,1,0,1,0.14285714285714285,1,0.0,0,0,0,0,0,0,0,1,0,0,1,1
3504,54639,yS4yakhBHc7NyuksINmBYVCnlqRezW4d,fbPkOYLVPtPgIt0MxizjfFJov3JbHyAi,6,3,1,0,1,1,4,0,10,1.4285714285714286,1,0.0,0,1,0,1,3,1,0,4,0,2,8,1
3505,54641,R6Dq5lnvFvykWq4BZFiSva1xi66sjtTX,fbPkOYLVPtPgIt0MxizjfFJov3JbHyAi,2,0,0,0,0,0,2,0,2,0.2857142857142857,1,0.0,0,0,0,0,0,0,0,2,0,0,2,1
3506,54643,2M96sKmnmm86XkJJ5fWbCFo098WJohWW,fbPkOYLVPtPgIt0MxizjfFJov3JbHyAi,1,0,0,0,0,0,1,0,1,0.14285714285714285,1,0.0,0,0,0,0,0,0,0,1,0,0,1,1
3507,54645,4HsvrccrEIKH8v4O0M12O72D4OeoBTHD,fbPkOYLVPtPgIt0MxizjfFJov3JbHyAi,2,0,0,0,0,0,2,0,2,0.2857142857142857,1,0.0,0,0,0,0,0,0,0,2,0,0,2,1
3508,54646,gLf8tcvfqgbiET6dKZOWAuUewpIVftFZ,fbPkOYLVPtPgIt0MxizjfFJov3JbHyAi,14,21,7,5,8,0,1,0,42,6.0,1,0.0,11,7,5,8,10,0,0,1,0,31,11,0
3509,54648,dPiM2rbWtOtubgVSYCUPyBbIkDj9J9Sy,fbPkOYLVPtPgIt0MxizjfFJov3JbHyAi,7,4,3,0,2,5,6,0,20,2.857142857142857,1,0.0,0,3,0,2,4,5,0,6,0,5,15,1
3510,54652,cs7jyCx1ujF4i5d03WipV8TsS1FQHKcf,fbPkOYLVPtPgIt0MxizjfFJov3JbHyAi,1,0,0,0,0,0,1,0,1,0.14285714285714285,1,0.0,0,0,0,0,0,0,0,1,0,0,1,1
3511,54654,e09uq36QgLuBVK5DERoejsHeMH2uPMRM,fbPkOYLVPtPgIt0MxizjfFJov3JbHyAi,1,0,0,0,0,0,1,0,1,0.14285714285714285,1,0.0,0,0,0,0,0,0,0,1,0,0,1,1
3512,54657,LKcdjugIkIE0PpSCrOwHezIGmXzBNzHJ,fbPkOYLVPtPgIt0MxizjfFJov3JbHyAi,9,4,3,0,3,0,2,0,12,1.7142857142857142,1,0.0,0,3,0,3,4,0,0,2,0,6,6,1
3513,54659,BV79vNEzTPlmR22unH2F5S3vLmcSI9HJ,fbPkOYLVPtPgIt0MxizjfFJov3JbHyAi,10,30,11,2,10,0,6,0,59,8.428571428571429,2,0.0,3,11,2,10,27,0,0,6,0,26,33,1
3514,54660,LG6VIza4JcQFFbXQ1PDBU7m3JeA6BbpC,fbPkOYLVPtPgIt0MxizjfFJov3JbHyAi,7,12,0,0,0,0,2,0,14,2.0,1,0.0,0,0,0,0,12,0,0,2,0,0,14,1
3515,54661,KdWukBGM6ubMnQd8k7slAlzFr5FmMMhw,fbPkOYLVPtPgIt0MxizjfFJov3JbHyAi,8,2,2,0,2,0,8,0,14,2.0,2,0.0,0,2,0,2,2,0,0,8,0,4,10,1
3516,54663,Cdt2szpMU9KahBjpAUW9oXon7wUux9EX,fbPkOYLVPtPgIt0MxizjfFJov3JbHyAi,6,4,1,0,0,0,5,0,10,1.4285714285714286,2,0.0,0,1,0,0,4,0,0,5,0,1,9,1
3517,54668,KEpGXvdRkmZf3PNthZY5jtIyu6Bw3Rlp,SpATywNh6bZuzm8s1ceuBUnMUAeoAHHw,17,11,8,2,5,0,4,0,30,4.285714285714286,2,0.0,0,8,2,5,11,0,0,4,0,15,15,1
3518,54690,goA9z819kccFvSfjnBmFLW5zxeJMJD6F,bWdj2GDclj5ofokWjzoa5jAwMkxCykd6,1,0,0,0,0,0,1,0,1,0.14285714285714285,1,0.0,0,0,0,0,0,0,0,1,0,0,1,1
3519,54700,Oi0KruZLNADobw8iF9nGECGXaaoz8di4,SpATywNh6bZuzm8s1ceuBUnMUAeoAHHw,9,21,1,19,0,17,3,0,61,8.714285714285714,2,0.0,10,1,18,0,11,17,1,3,0,29,32,0
3520,54723,z5Ulo2w0cg5OjY2Cx9aYoywDQvm6hLIF,RXDvfPUBYFlVdlueBFbLW0mhhAyGEqpt,24,26,12,3,11,0,1,0,53,7.571428571428571,2,0.0,0,12,3,11,26,0,0,1,0,26,27,0
3521,54724,XfiCSk5eLAbq9rzQtnLkX2OQTd6M8xFG,bWdj2GDclj5ofokWjzoa5jAwMkxCykd6,11,12,9,2,0,40,13,0,76,10.857142857142858,2,0.0,1,9,1,0,11,40,1,13,0,11,65,0
3522,54731,EBk8CcgfO89MwmYfmQzxphOJxpVE6Uvu,bWdj2GDclj5ofokWjzoa5jAwMkxCykd6,2,0,0,0,0,0,2,0,2,0.2857142857142857,1,0.0,0,0,0,0,0,0,0,2,0,0,2,1
3523,54736,16QzaT3BGZQ3ycViO0KNFfkskSZdjqFw,SpATywNh6bZuzm8s1ceuBUnMUAeoAHHw,20,20,9,11,5,0,5,0,50,7.142857142857143,2,0.0,2,9,8,5,18,0,3,5,0,24,26,0
3524,54739,EBk8CcgfO89MwmYfmQzxphOJxpVE6Uvu,5X6FeZozNMgE2VRi3MJYjkkFK8SETtu2,1,0,0,0,0,0,1,0,1,0.14285714285714285,1,0.0,0,0,0,0,0,0,0,1,0,0,1,1
3525,54761,MfwWTipzPsRtzbyiOZCobMuGSNow3sHg,SpATywNh6bZuzm8s1ceuBUnMUAeoAHHw,9,8,6,0,2,0,2,0,18,2.5714285714285716,2,0.0,0,6,0,2,8,0,0,2,0,8,10,0
3526,54765,WczGVRZMmNzgMggUe3ZQ1bOs2IuTwUWO,5X6FeZozNMgE2VRi3MJYjkkFK8SETtu2,1,0,0,0,0,0,1,0,1,0.14285714285714285,1,0.0,0,0,0,0,0,0,0,1,0,0,1,1
3527,54774,RxdtlMcw4rjm1ZlZfBelJCDeVB6xV1AQ,SpATywNh6bZuzm8s1ceuBUnMUAeoAHHw,16,14,7,19,4,0,2,0,46,6.571428571428571,1,0.0,6,7,18,4,8,0,1,2,0,35,11,1
3528,54792,Q7Wy56y25KB2WjBLql9AoH2Qdj9xO94M,SpATywNh6bZuzm8s1ceuBUnMUAeoAHHw,1,0,0,0,0,0,1,0,1,0.14285714285714285,1,0.0,0,0,0,0,0,0,0,1,0,0,1,1
3529,54800,OseLd0Vj4CawbZPfZRznLZH5tivxQP68,SpATywNh6bZuzm8s1ceuBUnMUAeoAHHw,1,0,0,0,0,0,1,0,1,0.14285714285714285,1,0.0,0,0,0,0,0,0,0,1,0,0,1,1
3530,54807,CyhW9ceUO9NYz6xFgPeXoLjeNitx4OvW,bWdj2GDclj5ofokWjzoa5jAwMkxCykd6,1,0,0,0,0,0,1,0,1,0.14285714285714285,1,0.0,0,0,0,0,0,0,0,1,0,0,1,1
3531,54810,T6JGf7KDvuej9SKYUMtG3FHgkPZQV429,A3fsA9Zfv1X2fVEQhTw51lKENdNrEqT3,67,48,36,0,32,0,3,0,119,17.0,3,0.0,3,36,0,32,45,0,0,3,0,71,48,0
3532,54811,CyhW9ceUO9NYz6xFgPeXoLjeNitx4OvW,A3fsA9Zfv1X2fVEQhTw51lKENdNrEqT3,1,0,0,0,0,0,1,0,1,0.14285714285714285,1,0.0,0,0,0,0,0,0,0,1,0,0,1,1
3533,54819,PkEcTe3rugNe3WrTlhHnV7MduvQXThEB,RXDvfPUBYFlVdlueBFbLW0mhhAyGEqpt,5,16,8,0,0,0,3,0,27,3.857142857142857,2,0.0,4,8,0,0,12,0,0,3,0,12,15,1
3534,54823,NNTbkWufZqd6OEZ4OfeDtmQCNI4vEzJo,A3fsA9Zfv1X2fVEQhTw51lKENdNrEqT3,23,11,10,0,10,0,2,0,33,4.714285714285714,1,0.0,0,10,0,10,11,0,0,2,0,20,13,1
3535,54827,ZwPBK7fW5s99bkJqWGxirmPrZf0cW4rp,A3fsA9Zfv1X2fVEQhTw51lKENdNrEqT3,47,88,41,0,29,1,9,0,168,24.0,4,0.0,0,41,0,29,88,1,0,9,0,70,98,0
3536,54838,mPNkb6VG8jFY8g5rcOoX3iIx4F3q09nE,SpATywNh6bZuzm8s1ceuBUnMUAeoAHHw,2,0,0,0,0,0,2,0,2,0.2857142857142857,1,0.0,0,0,0,0,0,0,0,2,0,0,2,1
3537,54839,2AWz8OiYqJqT0VYmevCkAuxaVCSl88oB,RXDvfPUBYFlVdlueBFbLW0mhhAyGEqpt,2,0,0,0,0,0,2,0,2,0.2857142857142857,1,0.0,0,0,0,0,0,0,0,2,0,0,2,0
3538,54847,PJax8eefw80yapFhrp3A2CEHvokzQQrL,SpATywNh6bZuzm8s1ceuBUnMUAeoAHHw,5,2,1,0,1,0,2,0,6,0.8571428571428571,1,0.0,0,1,0,1,2,0,0,2,0,2,4,1
3539,54869,M1VrwOWjiMnBueo7ci4JBR246P3AJPFN,A3fsA9Zfv1X2fVEQhTw51lKENdNrEqT3,1,0,0,0,0,0,1,0,1,0.14285714285714285,1,0.0,0,0,0,0,0,0,0,1,0,0,1,1
3540,54871,H2pnCC5fUi5Ho09aPqAE97vnlsM8FGBU,bWdj2GDclj5ofokWjzoa5jAwMkxCykd6,4,4,3,0,0,1,1,0,9,1.2857142857142858,1,0.0,0,3,0,0,4,1,0,1,0,3,6,1
3541,54876,tVqiyi20xeAPqMyQ1qSspr9PuF7fr80u,SpATywNh6bZuzm8s1ceuBUnMUAeoAHHw,13,23,10,1,3,2,5,0,44,6.285714285714286,2,0.0,9,10,1,3,14,2,0,5,0,23,21,1
3542,54879,bT6yH99PTuyz3a6ueCehCDHIMjMdNYHB,SpATywNh6bZuzm8s1ceuBUnMUAeoAHHw,3,4,1,0,0,0,2,0,7,1.0,1,0.0,0,1,0,0,4,0,0,2,0,1,6,1
3543,54897,2DBJY0D6vIAPQoXDRvKdizih9jCV7Kvf,SpATywNh6bZuzm8s1ceuBUnMUAeoAHHw,14,13,2,5,1,1,4,0,26,3.7142857142857144,2,0.0,0,2,4,1,13,1,1,4,0,7,19,0
3544,54904,LP0Jcdn3SCKZzldDBUXhHgzQTRBhcAFC,SpATywNh6bZuzm8s1ceuBUnMUAeoAHHw,1,0,0,0,0,0,1,0,1,0.14285714285714285,1,0.0,0,0,0,0,0,0,0,1,0,0,1,1
3545,54911,BY9YLSZcQDQQEQ3MNU6DAt6np51iLH0O,SpATywNh6bZuzm8s1ceuBUnMUAeoAHHw,3,2,0,0,0,0,1,0,3,0.42857142857142855,1,0.0,0,0,0,0,2,0,0,1,0,0,3,1
3546,54928,PrE64zhEuNh83grWL2cXaZZPY2nI1xUf,SpATywNh6bZuzm8s1ceuBUnMUAeoAHHw,1,0,0,0,0,1,0,0,1,0.14285714285714285,1,0.0,0,0,0,0,0,1,0,0,0,0,1,0
3547,54937,o076ufFxYjFcAtg8dPv0W5vwk5oKbSiz,SpATywNh6bZuzm8s1ceuBUnMUAeoAHHw,5,12,7,0,2,0,4,0,25,3.5714285714285716,2,0.0,0,7,0,2,12,0,0,4,0,9,16,1
3548,54938,EoOFKLnEYmufwMQdHqSZZDxomOFT0KCX,SpATywNh6bZuzm8s1ceuBUnMUAeoAHHw,4,5,1,0,0,0,4,0,10,1.4285714285714286,1,0.0,0,1,0,0,5,0,0,4,0,1,9,1
3549,54942,ijpfz5cJPrusRBczJIwOiwlUzdR9aysy,SpATywNh6bZuzm8s1ceuBUnMUAeoAHHw,19,13,9,7,5,0,7,0,41,5.857142857142857,2,0.0,2,9,7,5,11,0,0,7,0,23,18,0
3550,54945,Tx73qWK6TWa0dZ4Atd8qRPel2HBsO6lU,SpATywNh6bZuzm8s1ceuBUnMUAeoAHHw,4,1,0,0,0,0,4,0,5,0.7142857142857143,1,0.0,0,0,0,0,1,0,0,4,0,0,5,1
3551,54951,5ZHw0M7FTk5cO1fK8KsZKsofS7GANtcz,RXDvfPUBYFlVdlueBFbLW0mhhAyGEqpt,1,0,0,0,0,0,1,0,1,0.14285714285714285,1,0.0,0,0,0,0,0,0,0,1,0,0,1,1
3552,54959,7l6N3NrTQYFrf5h1HstsMDlVYWOdk0w2,SpATywNh6bZuzm8s1ceuBUnMUAeoAHHw,7,4,1,0,1,0,4,0,10,1.4285714285714286,1,0.0,0,1,0,1,4,0,0,4,0,2,8,1
3553,54966,sazaFVrhkSRDlyN7NAZCwVsSjFg3v04q,SpATywNh6bZuzm8s1ceuBUnMUAeoAHHw,1,0,0,0,0,0,1,0,1,0.14285714285714285,1,0.0,0,0,0,0,0,0,0,1,0,0,1,1
3554,54973,KIPXc8MOqmnlmMqnIzIeaBqliIw9pS44,A3fsA9Zfv1X2fVEQhTw51lKENdNrEqT3,6,0,0,0,0,0,9,1,10,1.4285714285714286,1,0.0,0,0,0,0,0,0,0,9,1,0,10,1
3555,54974,6G9LhtuC4WRjtVlDXOsvFj9Bvx98BbnJ,bWdj2GDclj5ofokWjzoa5jAwMkxCykd6,8,5,3,0,2,0,9,1,20,2.857142857142857,1,0.0,0,3,0,2,5,0,0,9,1,5,15,1
3556,54989,DUw85TcNpxyZaZKIM1HlHxvgtSm7uwxY,A3fsA9Zfv1X2fVEQhTw51lKENdNrEqT3,1,0,0,0,0,0,1,0,1,0.14285714285714285,1,0.0,0,0,0,0,0,0,0,1,0,0,1,1
3557,54993,sY9TePhZjFIEI666AS8T1sarfUUaa8vk,5X6FeZozNMgE2VRi3MJYjkkFK8SETtu2,1,0,0,0,0,0,1,0,1,0.14285714285714285,1,0.0,0,0,0,0,0,0,0,1,0,0,1,1
3558,54994,sY9TePhZjFIEI666AS8T1sarfUUaa8vk,bWdj2GDclj5ofokWjzoa5jAwMkxCykd6,1,0,0,0,0,0,1,0,1,0.14285714285714285,1,0.0,0,0,0,0,0,0,0,1,0,0,1,1
3559,55018,j2cyViq0dJomWYIOYnP2unh4khXf8CIF,SpATywNh6bZuzm8s1ceuBUnMUAeoAHHw,4,2,0,0,0,0,2,0,4,0.5714285714285714,1,0.0,0,0,0,0,2,0,0,2,0,0,4,0
3560,55022,dChjFm9SF9SHITReJylSFO5QWMAx2ciJ,A3fsA9Zfv1X2fVEQhTw51lKENdNrEqT3,1,0,0,0,0,0,1,0,1,0.14285714285714285,1,0.0,0,0,0,0,0,0,0,1,0,0,1,1
3561,55039,0Au7FrQGJI1dB5PAH0C5RtkL9GE7xsrQ,SpATywNh6bZuzm8s1ceuBUnMUAeoAHHw,9,7,4,0,3,0,1,0,15,2.142857142857143,1,0.0,0,4,0,3,7,0,0,1,0,7,8,1
3562,55045,E0Blx9HE2elltXbYcGSTffe9JEV6Z2iZ,A3fsA9Zfv1X2fVEQhTw51lKENdNrEqT3,72,28,21,144,14,0,13,1,221,31.571428571428573,2,0.0,3,21,121,14,25,0,23,13,1,159,62,0
3563,55051,ZuvVADnqMaprUOeHuBezreM7CKPKteSc,SpATywNh6bZuzm8s1ceuBUnMUAeoAHHw,11,9,3,8,1,0,2,0,23,3.2857142857142856,2,0.0,0,3,8,1,9,0,0,2,0,12,11,0
3564,55058,rPyu4cIbS3LCjrN2mpvx4iaQSTgSq9Ou,A3fsA9Zfv1X2fVEQhTw51lKENdNrEqT3,7,6,0,4,0,0,3,0,13,1.8571428571428572,1,0.0,0,0,4,0,6,0,0,3,0,4,9,0
3565,55082,UbxAJQUpM4nPUifCeu8NjmX0juFyLMFH,SpATywNh6bZuzm8s1ceuBUnMUAeoAHHw,21,20,1,30,0,3,5,0,59,8.428571428571429,2,0.0,4,1,26,0,16,3,4,5,0,31,28,1
3566,55085,Urb6ZsqNoXv3PA7YJFXeq2bBJzv2VAN5,SpATywNh6bZuzm8s1ceuBUnMUAeoAHHw,11,26,0,16,0,0,2,0,44,6.285714285714286,1,0.0,14,0,15,0,12,0,1,2,0,29,15,1
3567,55113,nrfTofFWRzT5axwsEM3PpLmORUpN9eKo,SpATywNh6bZuzm8s1ceuBUnMUAeoAHHw,4,3,2,0,2,0,2,0,9,1.2857142857142858,1,0.0,0,2,0,2,3,0,0,2,0,4,5,1
3568,55115,gNne9bdjxLwaUTIwTm8OmxkhOqWbx1zf,bWdj2GDclj5ofokWjzoa5jAwMkxCykd6,1,0,0,0,0,0,1,0,1,0.14285714285714285,1,0.0,0,0,0,0,0,0,0,1,0,0,1,1
3569,55123,7U7MZiTthIrdSyitYp5jXYVRqrLWtNBu,5X6FeZozNMgE2VRi3MJYjkkFK8SETtu2,9,9,1,0,1,0,4,0,15,2.142857142857143,1,0.0,0,1,0,1,9,0,0,4,0,2,13,1
3570,55135,GaaUSAn7OjFLzHXXBEBVyi3shjmvN0lH,A3fsA9Zfv1X2fVEQhTw51lKENdNrEqT3,6,9,5,0,3,0,1,0,18,2.5714285714285716,1,0.0,0,5,0,3,9,0,0,1,0,8,10,1
3571,55151,xBGnGb4xFBdhBVCY9WqghW7DBVBeUQyg,A3fsA9Zfv1X2fVEQhTw51lKENdNrEqT3,17,14,7,0,4,3,16,4,48,6.857142857142857,2,0.0,0,7,0,4,14,3,0,16,4,11,37,1
3572,55155,AYeDEDyu9LwDiPuNM8LqOlU9NVVRa6au,A3fsA9Zfv1X2fVEQhTw51lKENdNrEqT3,16,35,1,10,1,2,3,0,52,7.428571428571429,1,0.0,2,1,8,1,33,2,2,3,0,12,40,1
3573,55164,ELrr1JfnDsWjEvT48HXDtL9YqiQpfZmF,A3fsA9Zfv1X2fVEQhTw51lKENdNrEqT3,20,13,10,0,9,0,1,0,33,4.714285714285714,1,0.0,1,10,0,9,12,0,0,1,0,20,13,1
3574,55166,gKSJfTKRpPRCZVoRPeT84zeHU3dzpwjK,RXDvfPUBYFlVdlueBFbLW0mhhAyGEqpt,1,0,0,0,0,0,1,0,1,0.14285714285714285,1,0.0,0,0,0,0,0,0,0,1,0,0,1,1
3575,55180,JKdQMqi4dha8K2v4FbAwEfzazmC4IqdJ,SpATywNh6bZuzm8s1ceuBUnMUAeoAHHw,1,0,0,0,0,0,1,0,1,0.14285714285714285,1,0.0,0,0,0,0,0,0,0,1,0,0,1,1
3576,55182,VF14jDCwIzSb92Zq60K5zB8BaUbLT4fN,A3fsA9Zfv1X2fVEQhTw51lKENdNrEqT3,34,21,1,94,1,3,1,0,121,17.285714285714285,1,0.0,5,1,81,1,16,3,13,1,0,88,33,1
3577,55188,bUoqFmbvMs2kDsdZ9ItKtLQ4XhI3NVJ3,bWdj2GDclj5ofokWjzoa5jAwMkxCykd6,4,2,0,0,0,17,2,1,22,3.142857142857143,1,0.0,0,0,0,0,2,17,0,2,1,0,22,0
3578,55190,T71AtVPaJkGSIyo6SH0vxJiIfo9P5xoJ,bWdj2GDclj5ofokWjzoa5jAwMkxCykd6,1,0,0,0,0,0,1,0,1,0.14285714285714285,1,0.0,0,0,0,0,0,0,0,1,0,0,1,0
3579,55191,T71AtVPaJkGSIyo6SH0vxJiIfo9P5xoJ,A3fsA9Zfv1X2fVEQhTw51lKENdNrEqT3,1,0,0,0,0,0,1,0,1,0.14285714285714285,1,0.0,0,0,0,0,0,0,0,1,0,0,1,0
3580,55205,tjOYFkIRp5PgOsGOEKpZq20Cj6O439Op,bWdj2GDclj5ofokWjzoa5jAwMkxCykd6,4,7,2,0,1,0,2,0,12,1.7142857142857142,1,0.0,3,2,0,1,4,0,0,2,0,6,6,1
3581,55211,JcJgQocWkVJNrenjTE31xbqKDeCKKpym,G8EPVSXsOYB5YQWZGiz1aVq5Pgr2GrQu,8,6,5,0,0,0,2,0,13,1.8571428571428572,1,0.0,0,5,0,0,6,0,0,2,0,5,8,1
3582,55214,njTQZJN9KnLBVMzmSgwxd8LilddPxYw5,5X6FeZozNMgE2VRi3MJYjkkFK8SETtu2,5,2,1,0,1,0,2,0,6,0.8571428571428571,1,0.0,0,1,0,1,2,0,0,2,0,2,4,1
3583,55220,nPRsjektHdbQkeAf1fIK4JbhrESPbPsA,RXDvfPUBYFlVdlueBFbLW0mhhAyGEqpt,5,3,1,0,1,0,1,0,6,0.8571428571428571,1,0.0,0,1,0,1,3,0,0,1,0,2,4,1
3584,55230,aoDaUNT8Ab84EPMGNmI2OJb9XhPOK2AW,5X6FeZozNMgE2VRi3MJYjkkFK8SETtu2,2,0,0,0,0,0,3,0,3,0.42857142857142855,1,0.0,0,0,0,0,0,0,0,3,0,0,3,1
3585,55252,SFUf9a1eQYyFSfDqOIKMZYV7yqLnThV1,SpATywNh6bZuzm8s1ceuBUnMUAeoAHHw,35,47,5,28,3,0,6,0,89,12.714285714285714,5,0.0,5,5,27,3,42,0,1,6,0,40,49,0
3586,55258,YJeMkd3jz6x14dPiy98P6Q1CUjEPbHyt,SpATywNh6bZuzm8s1ceuBUnMUAeoAHHw,2,0,0,0,0,0,2,0,2,0.2857142857142857,1,0.0,0,0,0,0,0,0,0,2,0,0,2,1
3587,55266,ynnzmwoHbOAMevzqq5Q1QxkJp0HBCaYR,5X6FeZozNMgE2VRi3MJYjkkFK8SETtu2,2,0,0,0,0,0,2,0,2,0.2857142857142857,1,0.0,0,0,0,0,0,0,0,2,0,0,2,1
3588,55272,AwH7D2KycefughRmQIRA3p8DlN7XohhR,SpATywNh6bZuzm8s1ceuBUnMUAeoAHHw,7,6,4,0,0,0,5,0,15,2.142857142857143,1,0.0,0,4,0,0,6,0,0,5,0,4,11,1
3589,55286,XmfaTDISWF5comI3j0oigEszknbdPhWn,5X6FeZozNMgE2VRi3MJYjkkFK8SETtu2,1,0,0,0,0,0,1,0,1,0.14285714285714285,1,0.0,0,0,0,0,0,0,0,1,0,0,1,1
3590,55298,XmfaTDISWF5comI3j0oigEszknbdPhWn,SpATywNh6bZuzm8s1ceuBUnMUAeoAHHw,1,0,0,0,0,0,1,0,1,0.14285714285714285,1,0.0,0,0,0,0,0,0,0,1,0,0,1,1
3591,55300,XmfaTDISWF5comI3j0oigEszknbdPhWn,bWdj2GDclj5ofokWjzoa5jAwMkxCykd6,1,0,0,0,0,0,1,0,1,0.14285714285714285,1,0.0,0,0,0,0,0,0,0,1,0,0,1,0
3592,55317,eC2ad02aL61OuzveX2kkkz9OFa5jN0xs,SpATywNh6bZuzm8s1ceuBUnMUAeoAHHw,1,0,0,0,0,0,1,0,1,0.14285714285714285,1,0.0,0,0,0,0,0,0,0,1,0,0,1,1
3593,55318,IbBBT7oGA5eW3cwYlSN4uNF6XN76bEJ4,RXDvfPUBYFlVdlueBFbLW0mhhAyGEqpt,1,0,0,0,0,0,1,0,1,0.14285714285714285,1,0.0,0,0,0,0,0,0,0,1,0,0,1,1
3594,55346,7bnGjPq4sg9VhmEEoEqqXHNgeEpEuUDV,SpATywNh6bZuzm8s1ceuBUnMUAeoAHHw,6,6,2,0,1,0,1,0,10,1.4285714285714286,1,0.0,0,2,0,1,6,0,0,1,0,3,7,0
3595,55358,eeotL07J3Y8VeL6DbnIqkm9FhuiNkg7O,SpATywNh6bZuzm8s1ceuBUnMUAeoAHHw,21,15,11,0,7,2,11,1,47,6.714285714285714,3,0.0,0,11,0,7,15,2,0,11,1,18,29,0
3596,55376,avsFLymnsxrXULvKpllQNNUZoqF0bJ35,SpATywNh6bZuzm8s1ceuBUnMUAeoAHHw,18,11,8,12,5,0,1,0,37,5.285714285714286,1,0.0,2,8,10,5,9,0,2,1,0,25,12,0
3597,55402,OHCPSNCvfiPAnB9Qj7bWGHtZV42QZ1Uv,SpATywNh6bZuzm8s1ceuBUnMUAeoAHHw,14,22,5,17,3,1,4,1,53,7.571428571428571,1,0.0,16,5,16,3,6,1,1,4,1,40,13,1
3598,55406,u3Hn1s5XHCNiAXpJABAcauLSB7bNmrfy,bWdj2GDclj5ofokWjzoa5jAwMkxCykd6,3,2,1,0,0,0,1,0,4,0.5714285714285714,1,0.0,0,1,0,0,2,0,0,1,0,1,3,1
3599,55415,uVEyIFBybJdw7i4BVUfdVmm3z7A34ZCY,bWdj2GDclj5ofokWjzoa5jAwMkxCykd6,25,16,13,14,8,6,4,1,62,8.857142857142858,1,0.0,1,13,7,8,15,6,7,4,1,29,33,0
3600,55425,iDV5to1cYevkdTWvpbQHbqC1rLSJxp3m,SpATywNh6bZuzm8s1ceuBUnMUAeoAHHw,30,34,24,13,13,0,5,0,89,12.714285714285714,3,0.0,3,24,12,13,31,0,1,5,0,52,37,0
3601,55436,jhFpPMLGec23OmPqsOtaYaFXaKHweZzI,A3fsA9Zfv1X2fVEQhTw51lKENdNrEqT3,15,11,2,0,2,1,11,1,28,4.0,2,0.0,0,2,0,2,11,1,0,11,1,4,24,1
3602,55448,gACW4eW6IndswRGYovdbuYWVGeoweSw7,5X6FeZozNMgE2VRi3MJYjkkFK8SETtu2,17,32,1,34,17,0,1,0,85,12.142857142857142,1,0.0,26,1,28,17,6,0,6,1,0,72,13,1
3603,55462,zL30XztkWYaGUamoGfokQV3dBHPTpud2,SpATywNh6bZuzm8s1ceuBUnMUAeoAHHw,4,2,0,0,0,0,2,0,4,0.5714285714285714,1,0.0,0,0,0,0,2,0,0,2,0,0,4,1
3604,55468,kYJNxYDAilMvu34mGr6cbIsnQA0irwNN,bWdj2GDclj5ofokWjzoa5jAwMkxCykd6,5,2,1,0,1,0,5,0,9,1.2857142857142858,2,0.0,0,1,0,1,2,0,0,5,0,2,7,0
3605,55475,mDHr8WvVVX9KSvXMqxtLvZ6vP4uuNF6E,SpATywNh6bZuzm8s1ceuBUnMUAeoAHHw,24,34,2,26,1,2,10,3,78,11.142857142857142,1,0.0,8,2,20,1,26,2,6,10,3,31,47,1
3606,55483,C4q4gNQYEpjKh7pq1qjN8i3L7uSpUX9d,A3fsA9Zfv1X2fVEQhTw51lKENdNrEqT3,40,40,4,86,1,0,2,0,133,19.0,2,0.0,1,4,69,1,39,0,17,2,0,75,58,0
3607,55489,vCm3LfZ9M6wOLWnqELTZFsk5hnCTaEbi,SpATywNh6bZuzm8s1ceuBUnMUAeoAHHw,16,21,2,15,0,1,6,1,46,6.571428571428571,2,0.0,4,2,13,0,17,1,2,6,1,19,27,0
3608,55501,8Yib6PEBmIeNqpZ6dKYrUB3VUPCxqdYG,SpATywNh6bZuzm8s1ceuBUnMUAeoAHHw,1,0,0,0,0,0,2,0,2,0.2857142857142857,2,0.0,0,0,0,0,0,0,0,2,0,0,2,1
3609,55505,3DMtg3Ou9e33dDThiO2ndZwS8d6akzB7,RXDvfPUBYFlVdlueBFbLW0mhhAyGEqpt,10,19,1,0,2,0,3,0,25,3.5714285714285716,2,0.0,3,1,0,2,16,0,0,3,0,6,19,0
3610,55511,g1maG24WsPdpEOMuZUsxQc7SlEYHJjT4,SpATywNh6bZuzm8s1ceuBUnMUAeoAHHw,7,7,3,0,3,0,2,0,15,2.142857142857143,1,0.0,0,3,0,3,7,0,0,2,0,6,9,1
3611,55516,lgS8T7X8MPl4rnyyVo63W82KpUI1LtmK,SpATywNh6bZuzm8s1ceuBUnMUAeoAHHw,14,14,7,14,3,0,1,0,39,5.571428571428571,1,0.0,6,7,12,3,8,0,2,1,0,28,11,1
3612,55524,Sle0t5zy0VbRjUdpojBY9wV6zuG12LCM,A3fsA9Zfv1X2fVEQhTw51lKENdNrEqT3,7,4,3,0,2,0,1,0,10,1.4285714285714286,1,0.0,0,3,0,2,4,0,0,1,0,5,5,1
3613,55532,vrKNA3eEZxLntZreFchejbQ8UgnPaTUE,RXDvfPUBYFlVdlueBFbLW0mhhAyGEqpt,89,100,58,126,32,2,6,0,324,46.285714285714285,3,0.0,30,58,121,32,70,2,5,6,0,241,83,1
3614,55537,QN2mu01aS3iQpw1z3TFQyQa0hQWsCjGH,SpATywNh6bZuzm8s1ceuBUnMUAeoAHHw,19,37,15,23,0,4,9,1,89,12.714285714285714,2,0.0,13,15,17,0,24,4,6,9,1,45,44,0
3615,55551,Lk947zUxODvAz9uAzr7LhEhqya4oVnNV,bWdj2GDclj5ofokWjzoa5jAwMkxCykd6,2,0,0,0,0,0,3,0,3,0.42857142857142855,2,0.0,0,0,0,0,0,0,0,3,0,0,3,0
3616,55553,cOOKiwY8YqGykJyWVpEjwjg32qCVI2h5,SpATywNh6bZuzm8s1ceuBUnMUAeoAHHw,17,11,8,12,7,0,3,0,41,5.857142857142857,2,0.0,2,8,12,7,9,0,0,3,0,29,12,0
3617,55556,Pg0gXikYsatKV6C2YLhl2LUFEvJuK423,SpATywNh6bZuzm8s1ceuBUnMUAeoAHHw,5,3,1,0,1,0,2,0,7,1.0,1,0.0,0,1,0,1,3,0,0,2,0,2,5,1
3618,55557,FELnhQR0c7GZZX82ioYJEZsqujOrfyf7,SpATywNh6bZuzm8s1ceuBUnMUAeoAHHw,9,3,2,0,1,4,7,1,18,2.5714285714285716,1,0.0,0,2,0,1,3,4,0,7,1,3,15,1
3619,55573,9MJtonlQxxOCrYvWkEprq1yVcFsrnJFZ,SpATywNh6bZuzm8s1ceuBUnMUAeoAHHw,3,2,0,0,0,0,2,0,4,0.5714285714285714,1,0.0,0,0,0,0,2,0,0,2,0,0,4,1
3620,55584,ZYiV7TFt5Ex9C4qMS4F6xM653Evkxqg5,G8EPVSXsOYB5YQWZGiz1aVq5Pgr2GrQu,1,0,0,0,0,0,1,0,1,0.14285714285714285,1,0.0,0,0,0,0,0,0,0,1,0,0,1,1
3621,55591,9t2KBUQ5GiAw5lDqGOd0BuKNW0LVvTVG,A3fsA9Zfv1X2fVEQhTw51lKENdNrEqT3,5,11,6,0,0,0,5,0,22,3.142857142857143,4,0.0,0,6,0,0,11,0,0,5,0,6,16,0
3622,55593,9t2KBUQ5GiAw5lDqGOd0BuKNW0LVvTVG,bWdj2GDclj5ofokWjzoa5jAwMkxCykd6,20,32,9,18,6,0,7,0,72,10.285714285714286,5,0.0,8,9,16,6,24,0,2,7,0,39,33,0
3623,55604,kUTtwBKG3vzyymERNLukoy5hQ6c4zXj6,G8EPVSXsOYB5YQWZGiz1aVq5Pgr2GrQu,1,0,0,0,0,0,1,0,1,0.14285714285714285,1,0.0,0,0,0,0,0,0,0,1,0,0,1,1
3624,55610,j38sS48yyjSQUQ4EfqmBmZ0QyWUgAHfx,A3fsA9Zfv1X2fVEQhTw51lKENdNrEqT3,11,5,4,0,4,0,2,0,15,2.142857142857143,1,0.0,0,4,0,4,5,0,0,2,0,8,7,1
3625,55641,ykaUPJW4Nc9r2mv4b25QxgdHgIcQ63RQ,5X6FeZozNMgE2VRi3MJYjkkFK8SETtu2,4,3,1,0,0,0,2,0,6,0.8571428571428571,1,0.0,0,1,0,0,3,0,0,2,0,1,5,1
3626,55642,ykaUPJW4Nc9r2mv4b25QxgdHgIcQ63RQ,bWdj2GDclj5ofokWjzoa5jAwMkxCykd6,5,3,1,0,1,0,2,0,7,1.0,1,0.0,0,1,0,1,3,0,0,2,0,2,5,1
3627,55649,4bbbxt4gBliPERhFJsgXSSeGNzE1uNe2,A3fsA9Zfv1X2fVEQhTw51lKENdNrEqT3,2,0,0,0,0,0,2,0,2,0.2857142857142857,1,0.0,0,0,0,0,0,0,0,2,0,0,2,1
3628,55661,KKjjlHFWeLSseHD90tBUbNiE7bxXsPHK,A3fsA9Zfv1X2fVEQhTw51lKENdNrEqT3,2,0,0,0,0,0,3,0,3,0.42857142857142855,1,0.0,0,0,0,0,0,0,0,3,0,0,3,1
3629,55663,GgCLl5NjwqMgkh5JCvkbSguhpqbBPXLG,A3fsA9Zfv1X2fVEQhTw51lKENdNrEqT3,9,6,0,0,0,1,20,2,29,4.142857142857143,3,0.0,0,0,0,0,6,1,0,20,2,0,29,1
3630,55667,8ZhpSkXuKXWxDMEbryu3zVTkh7o5swmt,SpATywNh6bZuzm8s1ceuBUnMUAeoAHHw,11,19,0,21,0,0,6,0,46,6.571428571428571,2,0.0,16,0,19,0,3,0,2,6,0,35,11,1
3631,55670,UEfmPgYtumlIP4ZVBLy50d35T1FxzKJg,bWdj2GDclj5ofokWjzoa5jAwMkxCykd6,3,0,0,0,0,0,4,0,4,0.5714285714285714,1,0.0,0,0,0,0,0,0,0,4,0,0,4,1
3632,55675,Fslz74hcTdRSeV6ABwYgUmV0VJF6YRMZ,SpATywNh6bZuzm8s1ceuBUnMUAeoAHHw,1,0,0,0,0,0,1,0,1,0.14285714285714285,1,0.0,0,0,0,0,0,0,0,1,0,0,1,1
3633,55692,y2EdvoA45jiUkTJcqU8mJ6KiT8yLZUjw,SpATywNh6bZuzm8s1ceuBUnMUAeoAHHw,5,3,0,0,0,0,4,0,7,1.0,1,0.0,0,0,0,0,3,0,0,4,0,0,7,1
3634,55696,jaCcwHYnVHfV5mSQjy3wPbHHjpbiHJ5a,SpATywNh6bZuzm8s1ceuBUnMUAeoAHHw,22,46,25,16,17,0,13,0,117,16.714285714285715,4,0.0,7,25,13,17,39,0,3,13,0,62,55,0
3635,55699,HFO33lcsFKBDjSdg8KE5lGTCABOqytNM,RXDvfPUBYFlVdlueBFbLW0mhhAyGEqpt,35,50,28,71,13,4,6,0,172,24.571428571428573,4,0.0,14,28,57,13,36,4,14,6,0,112,60,0
3636,55700,f4KmYPe7Gd87l00BQWaThQRwVwEhyZVI,SpATywNh6bZuzm8s1ceuBUnMUAeoAHHw,14,23,0,13,0,0,5,0,41,5.857142857142857,3,0.0,6,0,11,0,17,0,2,5,0,17,24,1
3637,55727,1hNSAKFFSNkfntTlfWYg2UegOK7Bt861,SpATywNh6bZuzm8s1ceuBUnMUAeoAHHw,31,43,3,50,2,2,20,0,120,17.142857142857142,4,0.0,11,3,42,2,32,2,8,20,0,58,62,0
3638,55732,n5fmXY7W3OsRId8yMehdsktfc1GCY6un,A3fsA9Zfv1X2fVEQhTw51lKENdNrEqT3,1,0,0,0,0,0,1,0,1,0.14285714285714285,1,0.0,0,0,0,0,0,0,0,1,0,0,1,1
3639,55734,JwzCuKRnJiCboJiRTMovpzJhdCfcNETm,bWdj2GDclj5ofokWjzoa5jAwMkxCykd6,5,3,1,0,1,0,1,0,6,0.8571428571428571,1,0.0,0,1,0,1,3,0,0,1,0,2,4,1
3640,55738,rCrf0hc0QRrKoK9w9R5Z8IvJlhGyjTyy,bWdj2GDclj5ofokWjzoa5jAwMkxCykd6,1,1,0,0,0,0,0,0,1,0.14285714285714285,1,0.0,0,0,0,0,1,0,0,0,0,0,1,1
3641,55754,IEvlNL8VOnMEhZDsUABPXo7LZfwGp4gY,bWdj2GDclj5ofokWjzoa5jAwMkxCykd6,1,0,0,0,0,0,1,0,1,0.14285714285714285,1,0.0,0,0,0,0,0,0,0,1,0,0,1,1
3642,55757,lzpjjiq4oMj4Jrgwrf3vY9lfIBWvCjOT,SpATywNh6bZuzm8s1ceuBUnMUAeoAHHw,1,0,0,0,0,0,1,0,1,0.14285714285714285,1,0.0,0,0,0,0,0,0,0,1,0,0,1,1
3643,55763,invjLFwmOJ5b2g8Hz4dPO4FErak7u41P,RXDvfPUBYFlVdlueBFbLW0mhhAyGEqpt,12,12,1,0,0,0,2,0,15,2.142857142857143,1,0.0,0,1,0,0,12,0,0,2,0,1,14,1
3644,55771,rPyu4cIbS3LCjrN2mpvx4iaQSTgSq9Ou,G8EPVSXsOYB5YQWZGiz1aVq5Pgr2GrQu,21,7,0,70,0,0,6,0,83,11.857142857142858,2,0.0,0,0,54,0,7,0,16,6,0,54,29,0
3645,55772,5Y2cv07dwHIwwxuX55zFfzgqQ22I0Kj7,G8EPVSXsOYB5YQWZGiz1aVq5Pgr2GrQu,1,0,0,0,0,0,1,0,1,0.14285714285714285,1,0.0,0,0,0,0,0,0,0,1,0,0,1,1
3646,55773,mKWCTH01KzkLjFgXaCUEfs0dLu17r2jM,SpATywNh6bZuzm8s1ceuBUnMUAeoAHHw,7,6,4,0,2,0,2,0,14,2.0,2,0.0,0,4,0,2,6,0,0,2,0,6,8,0
3647,55777,aQ6WrdDe9pTNwVW3vmaMOs1pxy5r3Dxa,bWdj2GDclj5ofokWjzoa5jAwMkxCykd6,1,0,0,0,0,0,1,0,1,0.14285714285714285,1,0.0,0,0,0,0,0,0,0,1,0,0,1,0
3648,55780,i5WDkhlf7rrVPmbQxsFTG1gowMYshvKj,bWdj2GDclj5ofokWjzoa5jAwMkxCykd6,6,9,5,0,2,0,1,0,17,2.4285714285714284,1,0.0,1,5,0,2,8,0,0,1,0,8,9,1
3649,55815,BomMRlBByw8amFeVspHb5AR3og0R9z55,bWdj2GDclj5ofokWjzoa5jAwMkxCykd6,2,0,0,0,0,0,2,0,2,0.2857142857142857,1,0.0,0,0,0,0,0,0,0,2,0,0,2,1
3650,55820,LdhLlSD36AR268yKf0v6JE8vG5XYPHSF,SpATywNh6bZuzm8s1ceuBUnMUAeoAHHw,1,0,0,0,0,0,1,0,1,0.14285714285714285,1,0.0,0,0,0,0,0,0,0,1,0,0,1,1
3651,55843,S2i0VW7GN0ACeCnuAPN00XONM8w8kvsN,SpATywNh6bZuzm8s1ceuBUnMUAeoAHHw,42,115,45,46,19,29,27,4,285,40.714285714285715,7,0.0,24,45,37,19,91,29,9,27,4,125,160,0
3652,55846,q7ZtC6SevF8q9PKkXEaBMzUJ37xWhTDz,SpATywNh6bZuzm8s1ceuBUnMUAeoAHHw,19,26,11,10,5,0,0,0,52,7.428571428571429,4,0.0,2,11,10,5,24,0,0,0,0,28,24,1
3653,55854,cWzgbOpkXbzHEONOe0DzF6cxsOBOT2Ck,A3fsA9Zfv1X2fVEQhTw51lKENdNrEqT3,6,3,2,0,1,0,2,0,8,1.1428571428571428,1,0.0,0,2,0,1,3,0,0,2,0,3,5,1
3654,55866,DJyEuOUq1xzS66Zf6PmUg8ngoR0QofLh,SpATywNh6bZuzm8s1ceuBUnMUAeoAHHw,16,9,8,0,8,0,1,0,26,3.7142857142857144,1,0.0,0,8,0,8,9,0,0,1,0,16,10,0
3655,55871,Dpp8XuhtF10egN1qaOT5cqNb9iZXsbP6,bWdj2GDclj5ofokWjzoa5jAwMkxCykd6,4,2,0,0,0,0,3,0,5,0.7142857142857143,1,0.0,0,0,0,0,2,0,0,3,0,0,5,1
3656,55877,GPe5tDvCMFa0yvoGbU7FbSxYbtu5eayz,SpATywNh6bZuzm8s1ceuBUnMUAeoAHHw,21,32,19,16,11,0,12,0,90,12.857142857142858,6,0.0,3,19,13,11,29,0,3,12,0,46,44,0
3657,55882,HPL7SV5UPwGqlgRjicmrgS3BHX5sJveM,SpATywNh6bZuzm8s1ceuBUnMUAeoAHHw,11,5,4,0,4,0,2,0,15,2.142857142857143,1,0.0,0,4,0,4,5,0,0,2,0,8,7,1
3658,55932,nUlI6cjptTLAgli6MFzyKD61AHPa0Ow2,5X6FeZozNMgE2VRi3MJYjkkFK8SETtu2,6,3,2,0,1,0,2,0,8,1.1428571428571428,1,0.0,0,2,0,1,3,0,0,2,0,3,5,1
3659,55936,Uh4whLcptRuZuhdtjFruuYJY4YmOeYlV,SpATywNh6bZuzm8s1ceuBUnMUAeoAHHw,8,7,0,0,0,0,4,0,11,1.5714285714285714,2,0.0,0,0,0,0,7,0,0,4,0,0,11,0
3660,55948,fOZTYKShrDEPywLsvnOq8r6y0esJP04d,G8EPVSXsOYB5YQWZGiz1aVq5Pgr2GrQu,49,86,26,122,18,22,6,0,280,40.0,2,0.0,46,26,98,18,40,22,24,6,0,188,92,0
3661,55953,YtCtmmeHWdDsVBWEFPwN8TpSoaeOXyLN,SpATywNh6bZuzm8s1ceuBUnMUAeoAHHw,9,7,3,0,0,1,9,1,21,3.0,2,0.0,1,3,0,0,6,1,0,9,1,4,17,0
3662,55960,jMs7ADG9ZqrxYx65fsOTRMWpEC2ydubk,G8EPVSXsOYB5YQWZGiz1aVq5Pgr2GrQu,6,2,1,0,1,0,3,0,7,1.0,1,0.0,0,1,0,1,2,0,0,3,0,2,5,1
3663,55968,nUyvnDYHNr07VuH4P7bXoHw66oueIve2,A3fsA9Zfv1X2fVEQhTw51lKENdNrEqT3,5,2,1,0,1,0,3,0,7,1.0,2,0.0,0,1,0,1,2,0,0,3,0,2,5,1
3664,55969,Qs9VQJkriDZBH3FlG0bgTumvMa49MEaO,SpATywNh6bZuzm8s1ceuBUnMUAeoAHHw,7,5,2,0,2,0,2,0,11,1.5714285714285714,1,0.0,0,2,0,2,5,0,0,2,0,4,7,1
3665,55975,DtMnsqy6X2aMCS8gI4UYHBMONV1kA6dl,SpATywNh6bZuzm8s1ceuBUnMUAeoAHHw,15,28,7,13,1,0,10,0,59,8.428571428571429,3,0.0,9,7,11,1,19,0,2,10,0,28,31,0
3666,55988,FOVpUwiKXJnDfM4S62NCDgM0f8GaoUKw,bWdj2GDclj5ofokWjzoa5jAwMkxCykd6,25,9,2,42,0,0,2,0,55,7.857142857142857,2,0.0,0,2,31,0,9,0,11,2,0,33,22,1
3667,55996,vZhbOtXd7TjZcztq33p3Mc4YNdrrQnbd,SpATywNh6bZuzm8s1ceuBUnMUAeoAHHw,5,4,2,0,1,0,1,0,8,1.1428571428571428,1,0.0,1,2,0,1,3,0,0,1,0,4,4,0
3668,56001,7EU7vMf2b4Xv6MdI3zbAqQNQTiRVSvYt,bWdj2GDclj5ofokWjzoa5jAwMkxCykd6,2,0,0,0,0,0,4,0,4,0.5714285714285714,1,0.0,0,0,0,0,0,0,0,4,0,0,4,0
3669,56002,aX8XTxJBQE99ErDnzZHdMXoXH5wjXDSz,SpATywNh6bZuzm8s1ceuBUnMUAeoAHHw,5,3,2,0,1,0,1,0,7,1.0,1,0.0,0,2,0,1,3,0,0,1,0,3,4,1
3670,56008,PzU299qhBRNb9VKeEV5yMlpPdnEheXTy,5X6FeZozNMgE2VRi3MJYjkkFK8SETtu2,1,0,0,0,0,0,1,0,1,0.14285714285714285,1,0.0,0,0,0,0,0,0,0,1,0,0,1,1
3671,56010,hJo1MgKiPZFXuH2ko6hqPTd9dbjMQKDO,A3fsA9Zfv1X2fVEQhTw51lKENdNrEqT3,3,2,1,0,0,0,1,0,4,0.5714285714285714,1,0.0,0,1,0,0,2,0,0,1,0,1,3,0
3672,56032,Y7LsqgQDUbWtXalaq4LkDEQKBlxOaCL3,A3fsA9Zfv1X2fVEQhTw51lKENdNrEqT3,1,0,0,0,0,0,1,0,1,0.14285714285714285,1,0.0,0,0,0,0,0,0,0,1,0,0,1,1
3673,56040,420Gm2AWh0nImDTapBba1KojOp3noScY,SpATywNh6bZuzm8s1ceuBUnMUAeoAHHw,15,20,0,10,0,0,5,0,35,5.0,2,0.0,5,0,10,0,15,0,0,5,0,15,20,0
3674,56054,3bXohZfAfuP5Qk5brSDj9o6O5jB9eHXU,5X6FeZozNMgE2VRi3MJYjkkFK8SETtu2,7,4,2,0,3,0,2,0,11,1.5714285714285714,1,0.0,1,2,0,3,3,0,0,2,0,6,5,1
3675,56070,F0zHnv4QBXCCfC08pj4xRYVtaBbC9hrB,SpATywNh6bZuzm8s1ceuBUnMUAeoAHHw,4,2,1,0,0,0,2,0,5,0.7142857142857143,1,0.0,0,1,0,0,2,0,0,2,0,1,4,1
3676,56088,mSe1A4ptQkbf64uqFepueFInmdXgPhYy,A3fsA9Zfv1X2fVEQhTw51lKENdNrEqT3,48,21,17,72,12,3,16,1,142,20.285714285714285,2,0.0,1,17,63,12,20,3,9,16,1,93,49,1
3677,56100,rW6wdLuDHOXNnhL0u3gR5RZox9WggKAN,SpATywNh6bZuzm8s1ceuBUnMUAeoAHHw,11,16,7,16,4,7,1,0,51,7.285714285714286,1,0.0,8,7,14,4,8,7,2,1,0,33,18,0
3678,56103,h7RW3AuXPtbIdr6MfEtTA3AoeBZHMuDe,SpATywNh6bZuzm8s1ceuBUnMUAeoAHHw,8,6,5,0,1,0,1,0,13,1.8571428571428572,1,0.0,0,5,0,1,6,0,0,1,0,6,7,1
3679,56130,NMP7zcZ1OXsWVHsXwjitPqAEZM0pNqdR,A3fsA9Zfv1X2fVEQhTw51lKENdNrEqT3,27,14,6,58,1,0,6,0,85,12.142857142857142,2,0.0,4,6,54,1,10,0,4,6,0,65,20,1
3680,56136,Ooe9SpvA9vL8fZI7YLdrPaZtM6Unwf0C,SpATywNh6bZuzm8s1ceuBUnMUAeoAHHw,6,4,0,0,1,0,1,0,6,0.8571428571428571,1,0.0,0,0,0,1,4,0,0,1,0,1,5,1
3681,56142,ARgT3lphZ0ZC6ZJYyDs99tgWSQUEKTUQ,SpATywNh6bZuzm8s1ceuBUnMUAeoAHHw,27,47,20,33,10,0,6,0,116,16.571428571428573,2,0.0,8,20,29,10,39,0,4,6,0,67,49,0
3682,56159,PUyc6oo2n07bGLsFd9xq6RBtBr2Hfhy7,bWdj2GDclj5ofokWjzoa5jAwMkxCykd6,1,0,0,0,0,0,1,0,1,0.14285714285714285,1,0.0,0,0,0,0,0,0,0,1,0,0,1,1
3683,56162,n0lYyTCDVJTcalBduFlSaEDaBXfXmLkQ,G8EPVSXsOYB5YQWZGiz1aVq5Pgr2GrQu,15,8,6,0,5,0,10,0,29,4.142857142857143,1,0.0,0,6,0,5,8,0,0,10,0,11,18,1
3684,56177,pgUrKndBHF9gje2enxkGexSpNr299J4Q,SpATywNh6bZuzm8s1ceuBUnMUAeoAHHw,1,0,0,0,0,0,2,0,2,0.2857142857142857,2,0.0,0,0,0,0,0,0,0,2,0,0,2,1
3685,56193,EZA4MRAtJae4wE8uswRBoOap1OUMEftr,5X6FeZozNMgE2VRi3MJYjkkFK8SETtu2,4,3,0,0,0,0,2,0,5,0.7142857142857143,1,0.0,1,0,0,0,2,0,0,2,0,1,4,1
3686,56202,xbYSqp0T7Uu69VoCNyfTCvQcS3HV3UeU,SpATywNh6bZuzm8s1ceuBUnMUAeoAHHw,3,2,1,0,0,0,2,0,5,0.7142857142857143,1,0.0,0,1,0,0,2,0,0,2,0,1,4,1
3687,56205,TjHVysWRiYZK11ScpcMVmYhM1fqHEb9X,A3fsA9Zfv1X2fVEQhTw51lKENdNrEqT3,10,6,5,0,5,0,1,0,17,2.4285714285714284,1,0.0,0,5,0,5,6,0,0,1,0,10,7,1
3688,56211,v2qco953Z21cQ5MzJrZ1eVzwRDnupmBG,5X6FeZozNMgE2VRi3MJYjkkFK8SETtu2,5,3,2,0,2,1,2,0,10,1.4285714285714286,1,0.0,0,2,0,2,3,1,0,2,0,4,6,1
3689,56215,J3FKLxbUlPTor4lyG8lMpHc8oUQEjfcp,SpATywNh6bZuzm8s1ceuBUnMUAeoAHHw,10,7,5,0,3,0,2,0,17,2.4285714285714284,2,0.0,0,5,0,3,7,0,0,2,0,8,9,0
3690,56226,ok15ssTMon44FKUffK29mVEN6xTGU7F9,SpATywNh6bZuzm8s1ceuBUnMUAeoAHHw,4,4,3,0,0,0,1,0,8,1.1428571428571428,1,0.0,0,3,0,0,4,0,0,1,0,3,5,1
3691,56229,TZjkaaGxXeLRW9XAH2HdEXhi5AnCNUXO,A3fsA9Zfv1X2fVEQhTw51lKENdNrEqT3,1,0,0,0,0,0,1,0,1,0.14285714285714285,1,0.0,0,0,0,0,0,0,0,1,0,0,1,1
3692,56243,ggVtZvI2xjx0ksyejZETO0XkCjbToZaz,5X6FeZozNMgE2VRi3MJYjkkFK8SETtu2,5,2,1,0,1,0,2,0,6,0.8571428571428571,1,0.0,0,1,0,1,2,0,0,2,0,2,4,1
3693,56262,pFNUXgPhrHzyB36jYajNTB53rVt1Mtce,A3fsA9Zfv1X2fVEQhTw51lKENdNrEqT3,26,22,6,44,3,2,12,1,90,12.857142857142858,2,0.0,3,6,36,3,19,2,8,12,1,48,42,0
3694,56292,0hayldpMfgwxDpctJQP76sfxg5OJaZQR,bWdj2GDclj5ofokWjzoa5jAwMkxCykd6,4,0,0,0,0,0,4,0,4,0.5714285714285714,1,0.0,0,0,0,0,0,0,0,4,0,0,4,1
3695,56297,99qtmmRFqQo6ZkEaf8SX5eCCPu7FxBw0,SpATywNh6bZuzm8s1ceuBUnMUAeoAHHw,21,34,0,37,0,6,11,0,88,12.571428571428571,2,0.0,11,0,36,0,23,6,1,11,0,47,41,0
3696,56305,6x8Qn3NADOhKwTty3SohsZ5HqvETwfPz,A3fsA9Zfv1X2fVEQhTw51lKENdNrEqT3,42,168,72,0,4,0,4,0,248,35.42857142857143,1,0.0,0,72,0,4,168,0,0,4,0,76,172,1
3697,56307,1GmUBgbH4qyfafNMJ2VdhisOaMrOQzrs,A3fsA9Zfv1X2fVEQhTw51lKENdNrEqT3,1,0,0,0,0,0,1,0,1,0.14285714285714285,1,0.0,0,0,0,0,0,0,0,1,0,0,1,1
3698,56311,O0ctfeDXN3RQlb9YZzp4oH5DaLYaRlEd,A3fsA9Zfv1X2fVEQhTw51lKENdNrEqT3,13,9,6,20,4,0,2,0,41,5.857142857142857,2,0.0,0,6,19,4,9,0,1,2,0,29,12,1
3699,56312,yOmriI6ep4L8AeXfk2CRItQ1EOEJgSeE,SpATywNh6bZuzm8s1ceuBUnMUAeoAHHw,8,15,9,0,7,0,3,0,34,4.857142857142857,1,0.0,0,9,0,7,15,0,0,3,0,16,18,1
3700,56318,VENcGNiuhhY6sNpgOfcZfhLXpuYyEtGh,SpATywNh6bZuzm8s1ceuBUnMUAeoAHHw,2,0,0,0,0,0,2,0,2,0.2857142857142857,1,0.0,0,0,0,0,0,0,0,2,0,0,2,1
3701,56321,YQloiHp4EDEAnQ7UnBm1Re3dyFVVFj8Z,SpATywNh6bZuzm8s1ceuBUnMUAeoAHHw,16,52,0,21,0,1,7,0,81,11.571428571428571,2,0.0,28,0,18,0,24,1,3,7,0,46,35,0
3702,56332,lyFNL8kV6VicGW73AnKGdsGcS116jdQS,A3fsA9Zfv1X2fVEQhTw51lKENdNrEqT3,8,8,0,0,1,0,3,0,12,1.7142857142857142,1,0.0,0,0,0,1,8,0,0,3,0,1,11,0
3703,56348,yHbKBcrGUc65c5y9lhVo9REsfVSZTyxI,5X6FeZozNMgE2VRi3MJYjkkFK8SETtu2,1,0,0,0,0,0,3,0,3,0.42857142857142855,1,0.0,0,0,0,0,0,0,0,3,0,0,3,1
3704,56358,IJWUl0dWQiuiW9w5y2FbSbROivrhPUri,RXDvfPUBYFlVdlueBFbLW0mhhAyGEqpt,2,0,0,0,0,0,3,0,3,0.42857142857142855,1,0.0,0,0,0,0,0,0,0,3,0,0,3,1
3705,56366,CQ9z29HXcNaQxMUuAJ5s2uvH0fLzGYjv,SpATywNh6bZuzm8s1ceuBUnMUAeoAHHw,13,16,5,21,0,0,1,0,43,6.142857142857143,1,0.0,10,5,20,0,6,0,1,1,0,35,8,1
3706,56387,z198xKV3Xh3vq8jATGS5cKDaYaYNm0Ij,SpATywNh6bZuzm8s1ceuBUnMUAeoAHHw,5,3,1,0,1,0,1,0,6,0.8571428571428571,1,0.0,0,1,0,1,3,0,0,1,0,2,4,1
3707,56391,qlLes0SdNspaw8U0NHOyJVADLb1vNlZ2,SpATywNh6bZuzm8s1ceuBUnMUAeoAHHw,1,0,0,0,0,0,1,0,1,0.14285714285714285,1,0.0,0,0,0,0,0,0,0,1,0,0,1,1
3708,56392,YjkBBS3B1bfu7o3vhzRHcMiPertfPIVg,SpATywNh6bZuzm8s1ceuBUnMUAeoAHHw,1,0,0,0,0,0,1,0,1,0.14285714285714285,1,0.0,0,0,0,0,0,0,0,1,0,0,1,0
3709,56395,i5ccs6iw5ZhzXCfBV7j5tGNuPIZR5SkL,5X6FeZozNMgE2VRi3MJYjkkFK8SETtu2,10,13,0,6,0,9,7,0,35,5.0,1,0.0,3,0,5,0,10,9,1,7,0,8,27,1
3710,56398,aGbKep26uuguTzwAUYDcwjqS1RQNroF5,SpATywNh6bZuzm8s1ceuBUnMUAeoAHHw,17,23,3,10,6,0,2,0,44,6.285714285714286,3,0.0,2,3,10,6,21,0,0,2,0,21,23,1
3711,56413,4GCUZawdASarA3TMg6HAfW2kyE7xYxA6,A3fsA9Zfv1X2fVEQhTw51lKENdNrEqT3,2,0,0,0,0,0,2,0,2,0.2857142857142857,1,0.0,0,0,0,0,0,0,0,2,0,0,2,1
3712,56418,1yk3ITtkCTeBgpvC46EyEEfYcyKWD7Qc,SpATywNh6bZuzm8s1ceuBUnMUAeoAHHw,18,15,9,12,6,7,2,0,51,7.285714285714286,3,0.0,4,9,11,6,11,7,1,2,0,30,21,0
3713,56444,bUYPIrKUhpdtG1KH0Y9GXp4xZk1AgdLJ,SpATywNh6bZuzm8s1ceuBUnMUAeoAHHw,47,41,29,34,19,2,8,0,133,19.0,3,0.0,9,29,34,19,32,2,0,8,0,91,42,0
3714,56445,UalIk08w9p6VGqWfZ6drUaQL5GhjEzcw,SpATywNh6bZuzm8s1ceuBUnMUAeoAHHw,30,37,20,13,8,4,5,0,87,12.428571428571429,2,0.0,12,20,13,8,25,4,0,5,0,53,34,1
3715,56451,mNb7LM1EgQY9ZcZGX1ENFwEQJQ6p6qce,SpATywNh6bZuzm8s1ceuBUnMUAeoAHHw,15,12,7,0,6,0,4,0,29,4.142857142857143,3,0.0,0,7,0,6,12,0,0,4,0,13,16,0
3716,56459,IJmtizRHLdF3WotHNxwRcdFjzienWtJz,A3fsA9Zfv1X2fVEQhTw51lKENdNrEqT3,1,0,0,0,0,0,1,0,1,0.14285714285714285,1,0.0,0,0,0,0,0,0,0,1,0,0,1,1
3717,56468,1hZKrwuDlrmzTLBd6Jwp6RaIYtYXhqMF,SpATywNh6bZuzm8s1ceuBUnMUAeoAHHw,19,37,10,20,4,0,5,0,76,10.857142857142858,3,0.0,24,10,18,4,13,0,2,5,0,56,20,0
3718,56473,Y8djJGa5xO2Tk4mEUFLDW9jkITveu6qG,SpATywNh6bZuzm8s1ceuBUnMUAeoAHHw,4,2,0,0,0,0,2,0,4,0.5714285714285714,1,0.0,0,0,0,0,2,0,0,2,0,0,4,1
3719,56477,g5ozjvUCdaFJGkcIZvHKw5OmNcDvdyli,G8EPVSXsOYB5YQWZGiz1aVq5Pgr2GrQu,1,0,0,0,0,0,1,0,1,0.14285714285714285,1,0.0,0,0,0,0,0,0,0,1,0,0,1,1
3720,56483,H2pnCC5fUi5Ho09aPqAE97vnlsM8FGBU,SpATywNh6bZuzm8s1ceuBUnMUAeoAHHw,3,2,0,0,0,0,1,0,3,0.42857142857142855,1,0.0,0,0,0,0,2,0,0,1,0,0,3,0
3721,56485,eDC5FVVahMFWunS9Jkj1FnUpkxAaFQxm,SpATywNh6bZuzm8s1ceuBUnMUAeoAHHw,1,0,0,0,0,0,1,0,1,0.14285714285714285,1,0.0,0,0,0,0,0,0,0,1,0,0,1,1
3722,56490,kqS8BwWN9R1093oeblGkvtCsQJ68Gh0G,SpATywNh6bZuzm8s1ceuBUnMUAeoAHHw,7,12,7,0,1,0,4,0,24,3.4285714285714284,3,0.0,0,7,0,1,12,0,0,4,0,8,16,0
3723,56494,mSe1A4ptQkbf64uqFepueFInmdXgPhYy,SpATywNh6bZuzm8s1ceuBUnMUAeoAHHw,11,10,6,0,0,2,6,0,24,3.4285714285714284,2,0.0,0,6,0,0,10,2,0,6,0,6,18,1
3724,56496,LMrnY95OXOcKLbPJNFk6CNnUTJJC01Mr,SpATywNh6bZuzm8s1ceuBUnMUAeoAHHw,5,3,0,0,0,0,4,0,7,1.0,1,0.0,0,0,0,0,3,0,0,4,0,0,7,1
3725,56499,LMrnY95OXOcKLbPJNFk6CNnUTJJC01Mr,A3fsA9Zfv1X2fVEQhTw51lKENdNrEqT3,1,0,0,0,0,0,1,0,1,0.14285714285714285,1,0.0,0,0,0,0,0,0,0,1,0,0,1,1
3726,56501,AxlfZzXkXnhJLfyjxNARPh8wNlmuerJT,SpATywNh6bZuzm8s1ceuBUnMUAeoAHHw,13,20,5,25,2,1,3,0,56,8.0,2,0.0,10,5,20,2,10,1,5,3,0,37,19,0
3727,56514,57DmCkxeT4CodU6tDrBCDXqGpXQ0D1sF,A3fsA9Zfv1X2fVEQhTw51lKENdNrEqT3,3,4,1,0,0,0,2,0,7,1.0,2,0.0,0,1,0,0,4,0,0,2,0,1,6,0
3728,56520,Q0J8U0u6fxm0Djpm7255SwygxGBxa60v,A3fsA9Zfv1X2fVEQhTw51lKENdNrEqT3,25,4,2,62,1,0,6,0,75,10.714285714285714,2,0.0,2,2,51,1,2,0,11,6,0,56,19,0
3729,56527,3t7GtELm6lLnb8FYC1DTga6GS5ymEox1,bWdj2GDclj5ofokWjzoa5jAwMkxCykd6,2,0,0,0,0,7,2,0,9,1.2857142857142858,2,0.0,0,0,0,0,0,7,0,2,0,0,9,1
3730,56536,v3Nj91qeWhwVYxgQExYL9jO1Rd2uR5bo,SpATywNh6bZuzm8s1ceuBUnMUAeoAHHw,1,0,0,0,0,0,1,0,1,0.14285714285714285,1,0.0,0,0,0,0,0,0,0,1,0,0,1,1
3731,56541,9oxisAfoCqhNdPyxfe8mXe0RtSf4cETJ,bWdj2GDclj5ofokWjzoa5jAwMkxCykd6,7,1,1,0,1,0,4,0,7,1.0,1,0.0,0,1,0,1,1,0,0,4,0,2,5,1
3732,56559,Mr892OMsEEXQ3UZ94sswWXvqkTfFWjMB,SpATywNh6bZuzm8s1ceuBUnMUAeoAHHw,4,3,1,0,0,0,1,0,5,0.7142857142857143,1,0.0,0,1,0,0,3,0,0,1,0,1,4,0
3733,56576,zlC9nEdRrqLSPX386Mctiz9fIdlU29GI,A3fsA9Zfv1X2fVEQhTw51lKENdNrEqT3,12,14,11,0,6,0,4,0,35,5.0,4,0.0,0,11,0,6,14,0,0,4,0,17,18,0
3734,56588,1ek5QqaGzN6P33dWOwYmxFbMxKwWe19o,bWdj2GDclj5ofokWjzoa5jAwMkxCykd6,1,0,0,0,0,0,1,0,1,0.14285714285714285,1,0.0,0,0,0,0,0,0,0,1,0,0,1,1
3735,56590,1ek5QqaGzN6P33dWOwYmxFbMxKwWe19o,A3fsA9Zfv1X2fVEQhTw51lKENdNrEqT3,1,0,0,0,0,0,1,0,1,0.14285714285714285,1,0.0,0,0,0,0,0,0,0,1,0,0,1,1
3736,56597,JEPcJF0TTKl5vK9nCSqR8pH0kXl1lZQb,G8EPVSXsOYB5YQWZGiz1aVq5Pgr2GrQu,6,9,1,0,0,0,3,0,13,1.8571428571428572,1,0.0,3,1,0,0,6,0,0,3,0,4,9,1
3737,56606,YDx22wmqU2QQRuqAsFKiF79xppsDVVtu,SpATywNh6bZuzm8s1ceuBUnMUAeoAHHw,8,13,5,0,1,0,3,0,22,3.142857142857143,1,0.0,0,5,0,1,13,0,0,3,0,6,16,1
3738,56607,ZI1SmXpqFYe45F6w8W5vh7KFZWZHkCX6,SpATywNh6bZuzm8s1ceuBUnMUAeoAHHw,6,4,2,0,1,0,3,0,10,1.4285714285714286,2,0.0,0,2,0,1,4,0,0,3,0,3,7,1
3739,56615,ktKfaRtFOnFJdZMcfSCqSP14OG6TxlMY,SpATywNh6bZuzm8s1ceuBUnMUAeoAHHw,10,15,0,0,0,0,2,0,17,2.4285714285714284,2,0.0,0,0,0,0,15,0,0,2,0,0,17,0
3740,56621,ma8nscMCD0ftKjbxujos5nzHFFtaZMo4,A3fsA9Zfv1X2fVEQhTw51lKENdNrEqT3,59,34,6,194,4,0,11,0,249,35.57142857142857,3,0.0,4,6,163,4,30,0,31,11,0,177,72,0
3741,56632,J4UXFQZe2esHAAP8EgxtBhubvEMwPUfX,SpATywNh6bZuzm8s1ceuBUnMUAeoAHHw,7,11,5,0,1,0,2,0,19,2.7142857142857144,1,0.0,0,5,0,1,11,0,0,2,0,6,13,1
3742,56633,NGQ6HXbhxwBlJxikVxca5noX2u8xI9AV,A3fsA9Zfv1X2fVEQhTw51lKENdNrEqT3,3,3,0,0,0,0,1,0,4,0.5714285714285714,2,0.0,0,0,0,0,3,0,0,1,0,0,4,0
3743,56683,MbewcgzgToNhp9B6eaNSolme5R0M2nkY,A3fsA9Zfv1X2fVEQhTw51lKENdNrEqT3,12,5,1,20,0,0,2,0,28,4.0,1,0.0,2,1,16,0,3,0,4,2,0,19,9,1
3744,56696,ReIy3etnMmZBVQ3CosU4FbzEF29F9nHU,SpATywNh6bZuzm8s1ceuBUnMUAeoAHHw,11,9,3,0,3,0,0,0,15,2.142857142857143,3,0.0,0,3,0,3,9,0,0,0,0,6,9,0
3745,56739,abujBNmSyI9HYgtoO1EXyLGaW1rUTrMR,5X6FeZozNMgE2VRi3MJYjkkFK8SETtu2,6,5,1,0,1,0,3,0,10,1.4285714285714286,2,0.0,0,1,0,1,5,0,0,3,0,2,8,1
3746,56785,70BrIR23BcsI705EZj4LSyr7fHWI0Xjf,SpATywNh6bZuzm8s1ceuBUnMUAeoAHHw,7,4,3,0,2,0,1,0,10,1.4285714285714286,1,0.0,0,3,0,2,4,0,0,1,0,5,5,1
3747,56817,qzripbhm6sAPdZP3rld8n0avyAjcFNv4,G8EPVSXsOYB5YQWZGiz1aVq5Pgr2GrQu,4,2,0,0,0,0,2,0,4,0.5714285714285714,1,0.0,0,0,0,0,2,0,0,2,0,0,4,0
3748,56834,i86rWeuy3cBtKeVeDiyieBp3ovKTOVnd,SpATywNh6bZuzm8s1ceuBUnMUAeoAHHw,14,12,7,0,5,0,15,0,39,5.571428571428571,4,0.0,0,7,0,5,12,0,0,15,0,12,27,1
3749,56846,JQHOsaQcbZuyd8KUhRwPnej9sALKGQEC,SpATywNh6bZuzm8s1ceuBUnMUAeoAHHw,14,35,1,20,0,0,6,0,62,8.857142857142858,3,0.0,21,1,16,0,14,0,4,6,0,38,24,0
3750,56864,y64BqR5f4fJBfwxF4aLt14ViHkvnjGLs,A3fsA9Zfv1X2fVEQhTw51lKENdNrEqT3,3,3,2,0,0,0,0,0,5,0.7142857142857143,1,0.0,0,2,0,0,3,0,0,0,0,2,3,1
3751,56875,T8TKNQciNYxyZa02JNR1WAwQ2Y5qXjum,G8EPVSXsOYB5YQWZGiz1aVq5Pgr2GrQu,3,2,1,0,0,0,1,0,4,0.5714285714285714,1,0.0,0,1,0,0,2,0,0,1,0,1,3,0
3752,56905,bIokry3DgDVeJkqlmb8eSHiuWbIB78ly,5X6FeZozNMgE2VRi3MJYjkkFK8SETtu2,44,112,32,64,27,25,19,2,281,40.142857142857146,4,0.0,46,32,55,27,66,25,9,19,2,160,121,1
3753,56950,kSTVldlILQTC4uvQjFTvUZT6Q6PR2etw,SpATywNh6bZuzm8s1ceuBUnMUAeoAHHw,5,10,1,0,0,0,2,0,13,1.8571428571428572,1,0.0,2,1,0,0,8,0,0,2,0,3,10,0
3754,56956,6iOLSqRTRABETCaDgzA6NufDV3dLbSSl,bWdj2GDclj5ofokWjzoa5jAwMkxCykd6,21,6,4,44,0,8,5,0,67,9.571428571428571,1,0.0,2,4,41,0,4,8,3,5,0,47,20,1
3755,56963,GKzw24uGItaRbrNpOwWtTqnRbaZohHHZ,SpATywNh6bZuzm8s1ceuBUnMUAeoAHHw,3,2,1,0,0,0,1,0,4,0.5714285714285714,1,0.0,0,1,0,0,2,0,0,1,0,1,3,0
3756,57007,ZmVWu5hbUnLsKkFZOEf7HKPqWqXcgH33,5X6FeZozNMgE2VRi3MJYjkkFK8SETtu2,1,0,0,0,0,0,1,0,1,0.14285714285714285,1,0.0,0,0,0,0,0,0,0,1,0,0,1,1
3757,57017,RVthfCRYYRCiFRx3Qkq6vL0caXa3Y6XL,SpATywNh6bZuzm8s1ceuBUnMUAeoAHHw,14,10,6,16,2,0,3,0,37,5.285714285714286,1,0.0,4,6,13,2,6,0,3,3,0,25,12,0
3758,57037,I7IIrHAh1LzzCf8lcvI92o8deFulzAh8,5X6FeZozNMgE2VRi3MJYjkkFK8SETtu2,1,0,0,0,0,0,1,0,1,0.14285714285714285,1,0.0,0,0,0,0,0,0,0,1,0,0,1,1
3759,57039,pJVtkRFEs9CaJKE9rNOcmTvOB8uBPejR,A3fsA9Zfv1X2fVEQhTw51lKENdNrEqT3,4,2,1,0,0,0,2,0,5,0.7142857142857143,1,0.0,0,1,0,0,2,0,0,2,0,1,4,0
3760,57042,7QBdZ8YakikUsDbHJXtRSZV9tfWCg7qW,SpATywNh6bZuzm8s1ceuBUnMUAeoAHHw,10,10,4,15,1,0,1,0,31,4.428571428571429,1,0.0,5,4,13,1,5,0,2,1,0,23,8,0
3761,57116,FeZn6c6vb5R5SPZtACtqOXKJC1inbsZN,SpATywNh6bZuzm8s1ceuBUnMUAeoAHHw,2,1,1,0,0,0,0,0,2,0.2857142857142857,1,0.0,0,1,0,0,1,0,0,0,0,1,1,0
3762,57118,Icz7FevFRJsXLyENa86VfhJuan698xy0,5X6FeZozNMgE2VRi3MJYjkkFK8SETtu2,2,0,0,0,0,0,2,0,2,0.2857142857142857,1,0.0,0,0,0,0,0,0,0,2,0,0,2,1
3763,57161,35E85h2ExBPeTd1VmxNX0GKo8krIMsCP,5X6FeZozNMgE2VRi3MJYjkkFK8SETtu2,10,12,8,0,5,0,3,0,28,4.0,3,0.0,0,8,0,5,12,0,0,3,0,13,15,1
3764,57162,aHtknnRqNt7Y7dvI5B5U8KGn3pFw6RdZ,G8EPVSXsOYB5YQWZGiz1aVq5Pgr2GrQu,14,16,10,16,0,0,3,0,45,6.428571428571429,1,0.0,2,10,15,0,14,0,1,3,0,27,18,1
3765,57190,ZzEeIm98vbP9lRunZYePLW46UyhiVxbR,A3fsA9Zfv1X2fVEQhTw51lKENdNrEqT3,4,3,2,0,0,0,1,0,6,0.8571428571428571,1,0.0,0,2,0,0,3,0,0,1,0,2,4,1
3766,57215,XP5riJnXYg5EQATrHDgwlSDdWk49ZnJK,SpATywNh6bZuzm8s1ceuBUnMUAeoAHHw,15,31,4,0,3,0,3,0,41,5.857142857142857,3,0.0,0,4,0,3,31,0,0,3,0,7,34,1
3767,57247,mAtPYhgVQEdXuexaQz1O6am3axcwvcQv,SpATywNh6bZuzm8s1ceuBUnMUAeoAHHw,4,3,0,0,0,0,1,0,4,0.5714285714285714,1,0.0,0,0,0,0,3,0,0,1,0,0,4,0
3768,57274,a91ewPLjlp1X8KqwrnZISs7xgERRXuh7,SpATywNh6bZuzm8s1ceuBUnMUAeoAHHw,28,77,13,12,2,244,19,3,370,52.857142857142854,5,0.0,3,13,11,2,74,244,1,19,3,29,341,0
3769,57336,7FBwqoodmzhvrGGLuwBjRrxsykocUv8u,A3fsA9Zfv1X2fVEQhTw51lKENdNrEqT3,12,20,14,0,9,0,4,0,47,6.714285714285714,2,0.0,0,14,0,9,20,0,0,4,0,23,24,1
3770,57362,VrrBciftY2IctWxZzgYOD4l9QhmKgryv,SpATywNh6bZuzm8s1ceuBUnMUAeoAHHw,32,37,30,16,25,0,2,0,110,15.714285714285714,2,0.0,4,30,15,25,33,0,1,2,0,74,36,0
3771,57420,xQ0oPcnoBqnptb23qNnWO05KL2jCqFC5,5X6FeZozNMgE2VRi3MJYjkkFK8SETtu2,4,12,3,0,0,0,4,0,19,2.7142857142857144,2,0.0,3,3,0,0,9,0,0,4,0,6,13,1
3772,57421,xVSPiuldrfuaqB5x0wSqqh0RzPMsoNZK,SpATywNh6bZuzm8s1ceuBUnMUAeoAHHw,17,23,20,0,14,0,2,0,59,8.428571428571429,3,0.0,0,20,0,14,23,0,0,2,0,34,25,0
3773,57446,kQIkvivFIxDUKmroLdQlORRiVyNMIh8I,5X6FeZozNMgE2VRi3MJYjkkFK8SETtu2,2,0,0,0,0,0,2,0,2,0.2857142857142857,1,0.0,0,0,0,0,0,0,0,2,0,0,2,1
3774,57462,QLGFenndIPaX8I2vSI7keErJ6m5JCAL7,A3fsA9Zfv1X2fVEQhTw51lKENdNrEqT3,21,14,7,0,6,1,7,0,35,5.0,1,0.0,2,7,0,6,12,1,0,7,0,15,20,1
3775,57477,5OgjW4RBhSCbfYx5XYwPp5mVp3N7l8JT,SpATywNh6bZuzm8s1ceuBUnMUAeoAHHw,26,23,17,17,10,0,1,0,68,9.714285714285714,1,0.0,5,17,16,10,18,0,1,1,0,48,20,1
3776,57561,6aFJz85V1QzDFnu4WDixDzJkjtxtwyZY,5X6FeZozNMgE2VRi3MJYjkkFK8SETtu2,20,48,10,16,29,0,2,0,105,15.0,6,0.0,33,10,16,29,15,0,0,2,0,88,17,1
3777,57568,73lhhrOcE2srJj5BkIzSweWSnQRZBT2o,SpATywNh6bZuzm8s1ceuBUnMUAeoAHHw,13,20,14,9,0,0,3,0,46,6.571428571428571,2,0.0,2,14,8,0,18,0,1,3,0,24,22,1
3778,57656,Y3ZpN8DOQK8YTfD0eUtklxiZfpWuBIeU,SpATywNh6bZuzm8s1ceuBUnMUAeoAHHw,6,6,4,0,2,0,2,0,14,2.0,1,0.0,0,4,0,2,6,0,0,2,0,6,8,0
3779,57662,Py3KfqJj0ayFe0tkBJK6rKEFzXLKIBTS,RXDvfPUBYFlVdlueBFbLW0mhhAyGEqpt,15,22,2,0,2,0,4,0,30,4.285714285714286,2,0.0,0,2,0,2,22,0,0,4,0,4,26,0
3780,57712,p8eEbMqW5LefqN7qPq07exxdOPrIZY20,SpATywNh6bZuzm8s1ceuBUnMUAeoAHHw,5,24,1,0,1,0,4,0,30,4.285714285714286,3,0.0,0,1,0,1,24,0,0,4,0,2,28,1
3781,57735,uhbUne0Zqx7l0LKNWrxxR44WistJmxKI,SpATywNh6bZuzm8s1ceuBUnMUAeoAHHw,4,3,0,0,0,0,1,0,4,0.5714285714285714,1,0.0,0,0,0,0,3,0,0,1,0,0,4,1
3782,57797,bZSiNUbAIuydDBd77IMAJ15Hy6k2A1kT,A3fsA9Zfv1X2fVEQhTw51lKENdNrEqT3,18,15,8,24,5,0,7,0,59,8.428571428571429,1,0.0,3,8,19,5,12,0,5,7,0,35,24,0
3783,57840,97ov4fTuLcUGM3NRcbowYBsVQSUEYP2S,SpATywNh6bZuzm8s1ceuBUnMUAeoAHHw,5,4,3,0,2,0,1,0,10,1.4285714285714286,1,0.0,0,3,0,2,4,0,0,1,0,5,5,0
3784,57865,6R0qSS2YfDD3HGMPKZeKRUJLbFOIEhNG,SpATywNh6bZuzm8s1ceuBUnMUAeoAHHw,13,15,3,0,0,0,11,0,29,4.142857142857143,3,0.0,0,3,0,0,15,0,0,11,0,3,26,0
3785,58064,rtg3Ki4vk14kI9MkEBE0pkOCAO2AnCnU,A3fsA9Zfv1X2fVEQhTw51lKENdNrEqT3,24,12,4,86,0,0,3,0,105,15.0,2,0.0,3,4,72,0,9,0,14,3,0,79,26,0
3786,58102,RPQvIQfjeayIRS4PyDyrIytbJ9ZHNktA,SpATywNh6bZuzm8s1ceuBUnMUAeoAHHw,8,14,9,0,1,0,6,0,30,4.285714285714286,3,0.0,2,9,0,1,12,0,0,6,0,12,18,1
3787,58144,S6sXBOP7ss0lVuaz3ZVr4HFw4oNRFeXC,5X6FeZozNMgE2VRi3MJYjkkFK8SETtu2,8,7,1,0,1,1,7,1,18,2.5714285714285716,1,0.0,0,1,0,1,7,1,0,7,1,2,16,1
3788,58150,7a8ZShKuD962zsBaN4mct9BkYS1KNLrF,SpATywNh6bZuzm8s1ceuBUnMUAeoAHHw,12,11,10,2,4,0,1,0,28,4.0,1,0.0,0,10,2,4,11,0,0,1,0,16,12,0
3789,58186,QxxdakYrISiiDLexNlB0fwU8yeNcfQh4,5X6FeZozNMgE2VRi3MJYjkkFK8SETtu2,1,0,0,0,0,0,1,0,1,0.14285714285714285,1,0.0,0,0,0,0,0,0,0,1,0,0,1,1
3790,58216,nZTn5dZMRyIKKNGuMbIWH6lpWaWoYX62,bWdj2GDclj5ofokWjzoa5jAwMkxCykd6,4,3,1,0,0,0,1,0,5,0.7142857142857143,1,0.0,0,1,0,0,3,0,0,1,0,1,4,1
3791,58271,S8Q8neHdkaiSIrDXkWMhuMhsENfqfEdt,G8EPVSXsOYB5YQWZGiz1aVq5Pgr2GrQu,9,7,6,0,4,0,3,0,20,2.857142857142857,1,0.0,0,6,0,4,7,0,0,3,0,10,10,1
3792,58273,YkzGM7FCSZusATw7cM0Pqx3TXux1w8Gj,SpATywNh6bZuzm8s1ceuBUnMUAeoAHHw,4,3,1,0,0,0,1,0,5,0.7142857142857143,1,0.0,0,1,0,0,3,0,0,1,0,1,4,1
3793,58286,y6i20DJpIul6LihHwgZcWxbdAap5GcBP,A3fsA9Zfv1X2fVEQhTw51lKENdNrEqT3,20,13,1,56,0,7,14,1,92,13.142857142857142,4,0.0,0,1,44,0,13,7,12,14,1,45,47,1
3794,58291,PCPmtsqEtkHe7GooXQswbqyH8cnukgFn,G8EPVSXsOYB5YQWZGiz1aVq5Pgr2GrQu,31,65,24,60,5,0,5,0,159,22.714285714285715,4,0.0,17,24,45,5,48,0,15,5,0,91,68,0
3795,58316,GfppdBt6zqP8G2m8ukjaahHhJ4ewTb0w,SpATywNh6bZuzm8s1ceuBUnMUAeoAHHw,6,5,0,0,1,0,1,0,7,1.0,1,0.0,0,0,0,1,5,0,0,1,0,1,6,0
3796,58328,bwboRgaiFEflIqviFAKUixpzo8aJUZGL,G8EPVSXsOYB5YQWZGiz1aVq5Pgr2GrQu,22,64,4,24,5,0,7,0,104,14.857142857142858,5,0.0,13,4,13,5,51,0,11,7,0,35,69,0
3797,58383,ewcDv7X6I323ciCMJsU4n4MdvO632A9I,bWdj2GDclj5ofokWjzoa5jAwMkxCykd6,11,7,0,18,0,0,1,0,26,3.7142857142857144,1,0.0,1,0,16,0,6,0,2,1,0,17,9,1
3798,58399,Dw8R0agU0UT0CHCyap3lEB834WRdn2Bl,5X6FeZozNMgE2VRi3MJYjkkFK8SETtu2,8,5,4,0,4,0,1,0,14,2.0,1,0.0,0,4,0,4,5,0,0,1,0,8,6,1
3799,58404,RBJm407yEn5NJTf66xkOViV4vHRGXhZs,A3fsA9Zfv1X2fVEQhTw51lKENdNrEqT3,12,15,5,0,3,0,6,0,29,4.142857142857143,2,0.0,0,5,0,3,15,0,0,6,0,8,21,0
3800,58453,fgzbUfrTxXYCuiFYTG1cTemcEJUl36an,A3fsA9Zfv1X2fVEQhTw51lKENdNrEqT3,3,2,0,0,0,0,1,0,3,0.42857142857142855,1,0.0,0,0,0,0,2,0,0,1,0,0,3,1
3801,58459,UO0yW1yQ6dpOPTHCocxgWJWaWMRmXAmV,SpATywNh6bZuzm8s1ceuBUnMUAeoAHHw,8,25,6,0,4,0,8,0,43,6.142857142857143,6,0.0,0,6,0,4,25,0,0,8,0,10,33,0
3802,58544,bpxaFadaQixJuWRVtAAq5miKiBM3zC6u,A3fsA9Zfv1X2fVEQhTw51lKENdNrEqT3,31,16,1,54,1,2,8,1,83,11.857142857142858,1,0.0,3,1,51,1,13,2,3,8,1,56,27,0
3803,58549,PNuCKnyPWCRVxphTjJ1pIquyKu0dURK7,5X6FeZozNMgE2VRi3MJYjkkFK8SETtu2,14,29,7,16,5,0,7,0,64,9.142857142857142,6,0.0,7,7,14,5,22,0,2,7,0,33,31,1
3804,58560,3wojMge418Q4FflCb29r3hem59j6egRX,SpATywNh6bZuzm8s1ceuBUnMUAeoAHHw,7,10,1,0,0,0,1,0,12,1.7142857142857142,1,0.0,3,1,0,0,7,0,0,1,0,4,8,1
3805,58637,2CPNIar2bLO0Nk3gqpw6tYIpylWKP9T0,RXDvfPUBYFlVdlueBFbLW0mhhAyGEqpt,6,3,1,3,1,0,2,0,10,1.4285714285714286,1,0.0,1,1,3,1,2,0,0,2,0,6,4,0
3806,58644,zWZdErlwOQ1yvd6vlyAltL2Balhdc8gj,G8EPVSXsOYB5YQWZGiz1aVq5Pgr2GrQu,36,29,14,72,6,3,4,0,128,18.285714285714285,3,0.0,7,14,61,6,22,3,11,4,0,88,40,0
3807,58651,tdWhb9WfoB7e0A5Gjo7JvSpPeeCoQg77,5X6FeZozNMgE2VRi3MJYjkkFK8SETtu2,2,0,0,0,0,0,2,0,2,0.2857142857142857,1,0.0,0,0,0,0,0,0,0,2,0,0,2,1
3808,58763,HZ8Q7bQ1EwRW8jOabrhMI019qnvyVzyL,G8EPVSXsOYB5YQWZGiz1aVq5Pgr2GrQu,33,44,20,70,11,0,0,0,145,20.714285714285715,3,0.0,13,20,57,11,31,0,13,0,0,101,44,0
3809,58793,mrUvSMVJRVrLlCOcTH6rs5HGHSxrWvwY,5X6FeZozNMgE2VRi3MJYjkkFK8SETtu2,15,17,3,16,6,0,3,0,45,6.428571428571429,3,0.0,10,3,14,6,7,0,2,3,0,33,12,1
3810,58794,1zErz13s8fNQRVaEvkOtvw6bLhr23yB4,SpATywNh6bZuzm8s1ceuBUnMUAeoAHHw,6,4,3,0,1,0,1,0,9,1.2857142857142858,1,0.0,0,3,0,1,4,0,0,1,0,4,5,0
3811,58800,irZDaKqT4KdxcZGgiOHoDpvTtZyUugWP,G8EPVSXsOYB5YQWZGiz1aVq5Pgr2GrQu,13,20,4,0,3,0,4,0,31,4.428571428571429,2,0.0,0,4,0,3,20,0,0,4,0,7,24,0
3812,58804,OUbh6hvaOJDp9RK7kgTBzzPmjzmkYhZF,SpATywNh6bZuzm8s1ceuBUnMUAeoAHHw,13,12,0,16,0,0,3,0,31,4.428571428571429,1,0.0,3,0,13,0,9,0,3,3,0,16,15,0
3813,58812,x2TXADDQJTDLVMnKDb6BhJyWEoYQjlQy,SpATywNh6bZuzm8s1ceuBUnMUAeoAHHw,5,3,1,0,1,0,1,0,6,0.8571428571428571,1,0.0,0,1,0,1,3,0,0,1,0,2,4,1
3814,58818,67rSRaCVWXo14Jy7qMP7vHh2SS3POF3M,G8EPVSXsOYB5YQWZGiz1aVq5Pgr2GrQu,18,23,9,0,7,1,4,0,44,6.285714285714286,3,0.0,0,9,0,7,23,1,0,4,0,16,28,0
3815,58827,3TxSZWzNHIbrfRxUDxTOVx9pjdTX8q1m,5X6FeZozNMgE2VRi3MJYjkkFK8SETtu2,10,11,2,14,0,0,1,0,28,4.0,1,0.0,8,2,13,0,3,0,1,1,0,23,5,1
3816,58849,9UxAqNYuBtvS2ppV37y5D8wZyoNAl3Em,SpATywNh6bZuzm8s1ceuBUnMUAeoAHHw,4,3,2,0,0,0,1,0,6,0.8571428571428571,1,0.0,0,2,0,0,3,0,0,1,0,2,4,1
3817,58855,6K3h9aDeHI9AUqOKTvZxzGkKh6WMc7A3,SpATywNh6bZuzm8s1ceuBUnMUAeoAHHw,13,9,8,0,7,0,1,0,25,3.5714285714285716,1,0.0,0,8,0,7,9,0,0,1,0,15,10,0
3818,58877,Hoitr98hXhrf7xDGgACEFamKhiarA3wg,SpATywNh6bZuzm8s1ceuBUnMUAeoAHHw,22,25,15,16,4,5,7,0,72,10.285714285714286,3,0.0,5,15,13,4,20,5,3,7,0,37,35,0
3819,58893,Oh4qObC7j4dz8QtvEnVVjGNXqScAv0Td,A3fsA9Zfv1X2fVEQhTw51lKENdNrEqT3,2,0,0,0,0,0,3,0,3,0.42857142857142855,1,0.0,0,0,0,0,0,0,0,3,0,0,3,0
3820,58937,BWQpUowEHGBDEzSf23lNUZVBPlEw3Sq1,SpATywNh6bZuzm8s1ceuBUnMUAeoAHHw,4,4,0,0,0,0,1,0,5,0.7142857142857143,1,0.0,0,0,0,0,4,0,0,1,0,0,5,0
3821,58950,whJWNnqELrOvTyaZggRzz2ByxhMecVCf,5X6FeZozNMgE2VRi3MJYjkkFK8SETtu2,3,2,0,0,0,0,2,0,4,0.5714285714285714,1,0.0,0,0,0,0,2,0,0,2,0,0,4,1
3822,58998,yQ30DktO8KD929ApuNMOdNKTtmTpkfc3,5X6FeZozNMgE2VRi3MJYjkkFK8SETtu2,3,0,0,0,0,4,2,0,6,0.8571428571428571,1,0.0,0,0,0,0,0,4,0,2,0,0,6,1
3823,59023,1zErz13s8fNQRVaEvkOtvw6bLhr23yB4,G8EPVSXsOYB5YQWZGiz1aVq5Pgr2GrQu,16,15,9,8,5,1,3,1,42,6.0,1,0.0,5,9,6,5,10,1,2,3,1,25,17,0
3824,59026,yxVlIOgiPy2uO2769tIJMAsvrTHms87z,5X6FeZozNMgE2VRi3MJYjkkFK8SETtu2,2,0,0,0,0,0,2,0,2,0.2857142857142857,1,0.0,0,0,0,0,0,0,0,2,0,0,2,1
3825,59059,WyukafQHQxismOtYiPzoFkAc38hAOB09,SpATywNh6bZuzm8s1ceuBUnMUAeoAHHw,10,13,6,2,2,0,2,0,25,3.5714285714285716,2,0.0,5,6,1,2,8,0,1,2,0,14,11,0
3826,59096,ycTj3YOXaJ7pHDIwrzbh7koMVXAXAOVY,A3fsA9Zfv1X2fVEQhTw51lKENdNrEqT3,1,0,0,0,0,0,1,0,1,0.14285714285714285,1,0.0,0,0,0,0,0,0,0,1,0,0,1,1
3827,59112,SSR2C7GBXM7XyR67GN0wwOxiCuLYjW4G,SpATywNh6bZuzm8s1ceuBUnMUAeoAHHw,6,12,0,0,0,0,6,0,18,2.5714285714285716,2,0.0,0,0,0,0,12,0,0,6,0,0,18,0
3828,59127,B9KqNNxXBxHFUsJnQKQysblL3f8zF7sg,5X6FeZozNMgE2VRi3MJYjkkFK8SETtu2,4,14,6,0,0,0,9,0,29,4.142857142857143,8,0.0,0,6,0,0,14,0,0,9,0,6,23,0
3829,59140,kqS8BwWN9R1093oeblGkvtCsQJ68Gh0G,5X6FeZozNMgE2VRi3MJYjkkFK8SETtu2,7,6,3,0,2,0,3,0,14,2.0,1,0.0,1,3,0,2,5,0,0,3,0,6,8,1
3830,59155,1QXHZAtBZ2KaQglYqYbNwbUn7ThwuB1g,RXDvfPUBYFlVdlueBFbLW0mhhAyGEqpt,4,2,0,0,0,0,2,0,4,0.5714285714285714,1,0.0,0,0,0,0,2,0,0,2,0,0,4,1
3831,59212,VEbRHtoIqckybLHD2s2cXrjpdz3kQuu9,3VkHkmOtom3jM2wCu94xgzzu1d6Dn7or,42,42,8,0,22,1,7,1,81,11.571428571428571,9,0.0,6,8,0,22,36,1,0,7,1,36,45,0
3832,59228,poD9Y0r7TViOtu4Ne3cNJnc5HjxX414e,3VkHkmOtom3jM2wCu94xgzzu1d6Dn7or,21,39,3,14,11,9,9,0,85,12.142857142857142,5,0.0,18,3,13,11,21,9,1,9,0,45,40,1
3833,59247,MEBJlQgBfdioTMjrRwNRUmbBPKNQD24F,3VkHkmOtom3jM2wCu94xgzzu1d6Dn7or,19,40,16,11,13,47,21,39,187,26.714285714285715,3,0.0,15,16,10,13,25,47,1,21,39,54,133,1
3834,59290,85L8uHzEedN356VgQnCHbmew9208lpJw,3VkHkmOtom3jM2wCu94xgzzu1d6Dn7or,2,0,0,0,0,0,2,0,2,0.2857142857142857,1,0.0,0,0,0,0,0,0,0,2,0,0,2,1
3835,59300,V3FWVoDh1BAEjKi9l57CdriT1ZIRxyWZ,3VkHkmOtom3jM2wCu94xgzzu1d6Dn7or,6,6,3,0,2,0,6,0,17,2.4285714285714284,1,0.0,1,3,0,2,5,0,0,6,0,6,11,1
3836,59318,RFW46IpEEo40HQZmVwQOMd3VcTSwzvKz,3VkHkmOtom3jM2wCu94xgzzu1d6Dn7or,61,235,62,112,0,13,44,0,466,66.57142857142857,10,0.0,129,62,108,0,106,13,4,44,0,299,167,0
3837,59324,vApExcFFS0JPmBW9MgVKKwBFHidt1SlY,3VkHkmOtom3jM2wCu94xgzzu1d6Dn7or,41,166,38,66,1,5,12,0,288,41.142857142857146,5,0.0,70,38,66,1,96,5,0,12,0,175,113,1
3838,59332,NizqQaGjtKbKSjIbDqiqnHJildCbDYqn,3VkHkmOtom3jM2wCu94xgzzu1d6Dn7or,61,92,35,43,30,18,14,0,232,33.142857142857146,7,0.0,39,35,40,30,53,18,3,14,0,144,88,0
3839,59345,EFkTkZftT8UKiQGx6m8Gni8w9ocFq7gc,3VkHkmOtom3jM2wCu94xgzzu1d6Dn7or,64,111,55,37,52,8,11,0,274,39.142857142857146,6,0.0,44,55,35,52,67,8,2,11,0,186,88,0
3840,59351,jayUpzhZrhovArxIEdJtENjkmEYhxbYh,3VkHkmOtom3jM2wCu94xgzzu1d6Dn7or,5,2,1,0,1,0,2,0,6,0.8571428571428571,1,0.0,0,1,0,1,2,0,0,2,0,2,4,1
3841,59361,1ITGuQ2R8DpLVa12S7xW3GeCStKCoFln,3VkHkmOtom3jM2wCu94xgzzu1d6Dn7or,26,56,22,6,17,1,7,0,109,15.571428571428571,5,0.0,9,22,6,17,47,1,0,7,0,54,55,1
3842,59377,FixP7IuJ80KsWtzMzcQsJZKOjLxDKZgC,3VkHkmOtom3jM2wCu94xgzzu1d6Dn7or,1,0,0,0,0,0,1,0,1,0.14285714285714285,1,0.0,0,0,0,0,0,0,0,1,0,0,1,1
3843,59400,cCe6xOEVFA542oTGtw9gUWrojQghfhVL,3VkHkmOtom3jM2wCu94xgzzu1d6Dn7or,1,0,0,0,0,0,1,0,1,0.14285714285714285,1,0.0,0,0,0,0,0,0,0,1,0,0,1,1
3844,59438,rE9K06oyERpjKJkpGfIsPBvYwhHDKHpS,3VkHkmOtom3jM2wCu94xgzzu1d6Dn7or,7,2,2,0,2,0,2,0,8,1.1428571428571428,1,0.0,0,2,0,2,2,0,0,2,0,4,4,1
3845,59459,uqV3t3wNYphdy7WkOt07V9fSIpdy9v7v,3VkHkmOtom3jM2wCu94xgzzu1d6Dn7or,43,64,30,12,35,1,6,0,148,21.142857142857142,5,0.0,31,30,10,35,33,1,2,6,0,106,42,0
3846,59468,7C9sedCuDcI0Lupln8IsomQAXFXtukZX,3VkHkmOtom3jM2wCu94xgzzu1d6Dn7or,80,173,54,98,69,0,43,1,438,62.57142857142857,13,0.0,91,54,78,69,82,0,20,43,1,292,146,0
3847,59505,zeUi2UnQZPPF6bRQXw2s8LZ41ZOdqRAa,3VkHkmOtom3jM2wCu94xgzzu1d6Dn7or,95,241,127,32,73,75,43,2,593,84.71428571428571,23,0.0,76,127,30,73,165,75,2,43,2,306,287,0
3848,59506,RO3dHKrKxiT60KjWceTSY3tRkkyA4JcO,3VkHkmOtom3jM2wCu94xgzzu1d6Dn7or,41,55,30,45,16,22,23,0,191,27.285714285714285,9,0.0,11,30,38,16,44,22,7,23,0,95,96,1
3849,59516,LMI1lXDB0wCJqGnBSI17rtPaArmZDSph,3VkHkmOtom3jM2wCu94xgzzu1d6Dn7or,4,3,1,0,1,0,1,0,6,0.8571428571428571,1,0.0,0,1,0,1,3,0,0,1,0,2,4,1
3850,59530,juVbHX0foXtVM2nuXBZsl3U8Jfr3RbwI,3VkHkmOtom3jM2wCu94xgzzu1d6Dn7or,9,8,3,0,2,0,7,1,21,3.0,4,0.0,1,3,0,2,7,0,0,7,1,6,15,1
3851,59572,zn2X74vvqUQRINz90WjZLsSsFglpYr7o,3VkHkmOtom3jM2wCu94xgzzu1d6Dn7or,28,67,25,20,24,23,11,0,170,24.285714285714285,7,0.0,30,25,16,24,37,23,4,11,0,95,75,1
3852,59595,8UhW1HcJSpUKetcNndZSyo2w5k5GEb12,3VkHkmOtom3jM2wCu94xgzzu1d6Dn7or,1,0,0,0,0,0,2,0,2,0.2857142857142857,1,0.0,0,0,0,0,0,0,0,2,0,0,2,0
3853,59616,G4AOaMm0AmjNhZ9C9axrZ0ht7wgkQeIL,3VkHkmOtom3jM2wCu94xgzzu1d6Dn7or,13,15,2,0,4,18,26,3,68,9.714285714285714,3,0.0,3,2,0,4,12,18,0,26,3,9,59,1
3854,59660,qmA1tIdKETbr0fzM0M5nXzq02tLsRnXu,3VkHkmOtom3jM2wCu94xgzzu1d6Dn7or,2,0,0,0,0,0,5,0,5,0.7142857142857143,2,0.0,0,0,0,0,0,0,0,5,0,0,5,1
3855,59672,Ffohn9JNnGJQD2IavzMTS00ubnVtcb2T,3VkHkmOtom3jM2wCu94xgzzu1d6Dn7or,95,224,63,126,91,36,21,3,564,80.57142857142857,11,0.0,128,63,115,91,96,36,11,21,3,397,167,0
3856,59684,BJFktx6XLqraMQHAMGcWHetpDrvPxBxd,3VkHkmOtom3jM2wCu94xgzzu1d6Dn7or,23,14,10,0,9,1,6,4,44,6.285714285714286,2,0.0,0,10,0,9,14,1,0,6,4,19,25,0
3857,59699,ERmr1GfdrAI0qFKxZkfcfxM8oSkRx0Ds,3VkHkmOtom3jM2wCu94xgzzu1d6Dn7or,6,4,1,0,1,2,6,0,14,2.0,1,0.0,1,1,0,1,3,2,0,6,0,3,11,1
3858,59707,ervv8qudQXPt17u1LrtitMJZWYGrVoGN,3VkHkmOtom3jM2wCu94xgzzu1d6Dn7or,1,0,0,0,0,0,1,0,1,0.14285714285714285,1,0.0,0,0,0,0,0,0,0,1,0,0,1,1
3859,59724,1y6m9mPuH7mPBqHvt801n34GaYBVVluZ,3VkHkmOtom3jM2wCu94xgzzu1d6Dn7or,6,5,3,0,2,0,2,0,12,1.7142857142857142,1,0.0,0,3,0,2,5,0,0,2,0,5,7,1
3860,59729,4dfnEKxHCmGabkBCiKHt5nKr3H7Bwo1x,3VkHkmOtom3jM2wCu94xgzzu1d6Dn7or,85,168,60,32,62,11,6,0,339,48.42857142857143,8,0.0,68,60,32,62,100,11,0,6,0,222,117,0
3861,59731,BQ9KAjZKqbg2NifI7C0AAaErNLk2PIaJ,3VkHkmOtom3jM2wCu94xgzzu1d6Dn7or,6,2,1,0,1,0,4,0,8,1.1428571428571428,1,0.0,0,1,0,1,2,0,0,4,0,2,6,1
3862,59733,hqcMEOE1A4JiPcXtM6pROthzRRCVwxKR,3VkHkmOtom3jM2wCu94xgzzu1d6Dn7or,1,0,0,0,0,0,1,0,1,0.14285714285714285,1,0.0,0,0,0,0,0,0,0,1,0,0,1,1
3863,59741,uEijUBLW1L48ks9Yg3X6PWezXlhSNpBG,3VkHkmOtom3jM2wCu94xgzzu1d6Dn7or,23,42,21,24,15,6,26,5,139,19.857142857142858,2,0.0,18,21,20,15,24,6,4,26,5,74,65,1
3864,59752,Qkgoou3r4TgVjNLlv6htzGfkFEYo98Y1,3VkHkmOtom3jM2wCu94xgzzu1d6Dn7or,6,2,1,0,1,0,5,0,9,1.2857142857142858,1,0.0,0,1,0,1,2,0,0,5,0,2,7,1
3865,59759,KwbKBuJJ500i8wZdeFPG8Me42kEDTjsQ,3VkHkmOtom3jM2wCu94xgzzu1d6Dn7or,11,13,1,2,4,3,8,0,31,4.428571428571429,1,0.0,2,1,2,4,11,3,0,8,0,9,22,1
3866,59762,SbxWcDAQO1PnIdll82O1Qa8HqEHuIfT7,3VkHkmOtom3jM2wCu94xgzzu1d6Dn7or,23,26,22,0,14,0,11,0,73,10.428571428571429,3,0.0,0,22,0,14,26,0,0,11,0,36,37,0
3867,59789,nXcUtSl1H5elkR3fcabMsthQk8DiOJnh,3VkHkmOtom3jM2wCu94xgzzu1d6Dn7or,4,2,1,0,1,0,1,0,5,0.7142857142857143,1,0.0,0,1,0,1,2,0,0,1,0,2,3,1
3868,59797,06CPxvQ87tR05bV6rCGnDt3kdtYbJKM4,3VkHkmOtom3jM2wCu94xgzzu1d6Dn7or,11,10,5,4,3,0,3,0,25,3.5714285714285716,2,0.0,1,5,3,3,9,0,1,3,0,12,13,1
3869,59798,w85QVmINOIyrXRzegh8uuBeGTw3K4uG8,3VkHkmOtom3jM2wCu94xgzzu1d6Dn7or,70,150,31,40,44,10,27,2,304,43.42857142857143,14,0.0,61,31,39,44,89,10,1,27,2,175,129,0
3870,59808,YmAogTXGoaSGS2jBtwsCLUVebiwWGuMB,3VkHkmOtom3jM2wCu94xgzzu1d6Dn7or,15,22,4,5,7,2,6,0,46,6.571428571428571,2,0.0,12,4,4,7,10,2,1,6,0,27,19,0
3871,59826,sZ8OcUtlsHSfyDWYiLYzpr2d1BxixQDw,3VkHkmOtom3jM2wCu94xgzzu1d6Dn7or,62,171,46,79,63,16,27,0,402,57.42857142857143,4,0.0,89,46,70,63,82,16,9,27,0,268,134,1
3872,59851,HhPWIb0EGJ5j5q6DzxeKjCcUiZc0LGrO,3VkHkmOtom3jM2wCu94xgzzu1d6Dn7or,55,128,63,0,44,3,30,1,269,38.42857142857143,8,0.0,0,63,0,44,128,3,0,30,1,107,162,0
3873,59875,mlNqp7jcg3ulVLnJQaWtUA357Z110noc,3VkHkmOtom3jM2wCu94xgzzu1d6Dn7or,49,89,36,45,35,7,10,0,222,31.714285714285715,9,0.0,41,36,35,35,48,7,10,10,0,147,75,1
3874,59890,a8UKs1NxAK1Rc6mTIgzTKX0mHyAKUP88,3VkHkmOtom3jM2wCu94xgzzu1d6Dn7or,8,11,3,7,6,3,4,0,34,4.857142857142857,2,0.0,7,3,6,6,4,3,1,4,0,22,12,1
3875,59909,Wdfot5Syam86Zwq2ZnK5uHRtRyOhXClI,3VkHkmOtom3jM2wCu94xgzzu1d6Dn7or,9,28,5,0,4,0,7,0,44,6.285714285714286,3,0.0,1,5,0,4,27,0,0,7,0,10,34,1
3876,59924,fBNwaNNwzcybh8tC3Lc2wBKjJTR5vjRb,3VkHkmOtom3jM2wCu94xgzzu1d6Dn7or,8,5,0,0,2,0,14,7,28,4.0,1,0.0,3,0,0,2,2,0,0,14,7,5,23,1
3877,59959,iajSh65MjBysgZJuIFTLe4Uf4UcvDwPm,3VkHkmOtom3jM2wCu94xgzzu1d6Dn7or,71,166,52,155,21,30,33,1,458,65.42857142857143,10,0.0,96,52,143,21,70,30,12,33,1,312,146,0
3878,59998,mEBjJdKe2aB4znRfVwqZSlDKwqcAUUKv,3VkHkmOtom3jM2wCu94xgzzu1d6Dn7or,70,170,38,67,68,48,38,1,430,61.42857142857143,7,0.0,69,38,66,68,101,48,1,38,1,241,189,0
3879,60003,obFxfGLSP12hWUYqYGw1SR5lINNLUPlg,3VkHkmOtom3jM2wCu94xgzzu1d6Dn7or,17,59,21,16,18,7,21,10,152,21.714285714285715,4,0.0,26,21,11,18,33,7,5,21,10,76,76,0
3880,60016,Bl2GFpVypjnwol9jB8TQQ7qn8MIykZbR,3VkHkmOtom3jM2wCu94xgzzu1d6Dn7or,5,5,1,0,0,0,2,0,8,1.1428571428571428,1,0.0,0,1,0,0,5,0,0,2,0,1,7,1
3881,60035,wAN9qMt86ZcazBUSN9qSPUuop2dLTASV,3VkHkmOtom3jM2wCu94xgzzu1d6Dn7or,8,3,2,0,2,2,6,0,15,2.142857142857143,1,0.0,0,2,0,2,3,2,0,6,0,4,11,1
3882,60071,5tG3vaPrIg0p6kfnNpabCOvGZgklgDfi,5X6FeZozNMgE2VRi3MJYjkkFK8SETtu2,14,10,8,0,5,0,2,0,25,3.5714285714285716,2,0.0,0,8,0,5,10,0,0,2,0,13,12,0
3883,60137,oQhebmIEEDGSQ048AIhyw1aXOl3SgEvP,5X6FeZozNMgE2VRi3MJYjkkFK8SETtu2,7,8,4,1,4,0,5,0,22,3.142857142857143,2,0.0,2,4,1,4,6,0,0,5,0,11,11,0
3884,60168,IJVC32xhcxjduQ5Gn9dQV405cC7i6x7I,5X6FeZozNMgE2VRi3MJYjkkFK8SETtu2,5,3,2,0,2,0,2,0,9,1.2857142857142858,1,0.0,0,2,0,2,3,0,0,2,0,4,5,1
3885,60193,ya3v1iYETjj0QFCSbW4Y8PQXQRFY49xl,7GRhBDsirIGkRZBtSMEzNTyDr2JQm4xx,10,17,5,6,5,5,3,0,41,5.857142857142857,3,0.0,6,5,3,5,11,5,3,3,0,19,22,1
3886,60197,PQI2FfKayBY1gxpt5gRYDDr8V8BaU7zU,5X6FeZozNMgE2VRi3MJYjkkFK8SETtu2,7,8,3,0,1,0,3,0,15,2.142857142857143,2,0.0,1,3,0,1,7,0,0,3,0,5,10,1
3887,60210,wGqhUJlJ3fGYOW2r7IbwNL0CdAR0avoU,7GRhBDsirIGkRZBtSMEzNTyDr2JQm4xx,18,39,14,6,4,1,1,0,65,9.285714285714286,1,0.0,18,14,4,4,21,1,2,1,0,40,25,1
3888,60214,Y3uwxWCm13Ol5xozrT2GPjOPhBlC2kOq,7GRhBDsirIGkRZBtSMEzNTyDr2JQm4xx,17,22,3,46,0,0,3,0,74,10.571428571428571,2,0.0,5,3,38,0,17,0,8,3,0,46,28,1
3889,60241,n2vbSLePtnxy4AVvThroeNvlXpcTMINy,7GRhBDsirIGkRZBtSMEzNTyDr2JQm4xx,14,17,8,0,6,0,3,0,34,4.857142857142857,2,0.0,1,8,0,6,16,0,0,3,0,15,19,0
3890,60266,7L5unYIhab1TebFiFv55Vd3f3JppE4WH,5X6FeZozNMgE2VRi3MJYjkkFK8SETtu2,4,2,1,0,1,0,2,0,6,0.8571428571428571,1,0.0,0,1,0,1,2,0,0,2,0,2,4,1
3891,60388,8Mx72ChYyrYeKtnyPn99FZFTvl5QDtPg,5X6FeZozNMgE2VRi3MJYjkkFK8SETtu2,11,8,6,0,3,6,5,0,28,4.0,2,0.0,0,6,0,3,8,6,0,5,0,9,19,1
3892,60427,r3TtJNrYEPB9JfkbBp23luDTSVLZGHt2,7GRhBDsirIGkRZBtSMEzNTyDr2JQm4xx,3,2,1,0,0,0,5,0,8,1.1428571428571428,4,0.0,0,1,0,0,2,0,0,5,0,1,7,0
3893,60442,76btfIjeEvKDRqZ07unLyzOBWCQVXirv,7GRhBDsirIGkRZBtSMEzNTyDr2JQm4xx,10,15,7,6,2,1,5,0,36,5.142857142857143,2,0.0,3,7,3,2,12,1,3,5,0,15,21,0
3894,60459,IxKN3STMPrToOW2zFDcQPvfmFqbbi8Bw,5X6FeZozNMgE2VRi3MJYjkkFK8SETtu2,1,0,0,0,0,0,1,0,1,0.14285714285714285,1,0.0,0,0,0,0,0,0,0,1,0,0,1,1
3895,60514,p2VhKgs5pW28rABeDCjJR76cxi1YS9XC,5X6FeZozNMgE2VRi3MJYjkkFK8SETtu2,26,32,1,28,11,0,1,0,73,10.428571428571429,1,0.0,26,1,25,11,6,0,3,1,0,63,10,1
3896,60518,r639bFH7kDBWMyuyounNz9zTrG9jbNqa,7GRhBDsirIGkRZBtSMEzNTyDr2JQm4xx,14,32,7,0,3,30,11,0,83,11.857142857142858,3,0.0,0,7,0,3,32,30,0,11,0,10,73,0
3897,60531,Vdzl3X3O6ZP4Npa6oBdNxCc6U3L9nvWo,7GRhBDsirIGkRZBtSMEzNTyDr2JQm4xx,35,109,32,40,31,1,10,0,223,31.857142857142858,5,0.0,50,32,31,31,59,1,9,10,0,144,79,0
3898,60621,oPxUAN8GTpfRQcDdNiJwDsKtCpP4XGLa,5X6FeZozNMgE2VRi3MJYjkkFK8SETtu2,5,2,1,0,1,0,2,0,6,0.8571428571428571,1,0.0,0,1,0,1,2,0,0,2,0,2,4,1
3899,60762,kCGRIKdKYvPuUYrVxn91JXcnBAZClhV5,5Gyp41oLVo7Gg7vF4vpmggWP5MU70QO6,16,32,16,3,6,1,4,0,62,8.857142857142858,2,0.0,12,16,3,6,20,1,0,4,0,37,25,1
3900,60788,JtMmp5BCDQnYE7CMI3NvnX4aRCZsQW9K,5Gyp41oLVo7Gg7vF4vpmggWP5MU70QO6,15,14,8,2,4,11,16,1,56,8.0,2,0.0,0,8,1,4,14,11,1,16,1,13,43,1
3901,60800,KZKp5TYL1EcqL79HaYEbES7V1ylqNKMQ,5Gyp41oLVo7Gg7vF4vpmggWP5MU70QO6,6,14,2,0,2,0,2,0,20,2.857142857142857,1,0.0,2,2,0,2,12,0,0,2,0,6,14,1
3902,60807,sseSPNAdgq0K7ngWvRJ9VjZGxKbBzOHV,5Gyp41oLVo7Gg7vF4vpmggWP5MU70QO6,13,23,10,0,7,50,14,1,105,15.0,5,0.0,8,10,0,7,15,50,0,14,1,25,80,1
3903,60812,7J9JIWVCQG1g6yXh3uTVbrSu3pa18Ezn,5Gyp41oLVo7Gg7vF4vpmggWP5MU70QO6,9,9,4,0,2,6,3,0,24,3.4285714285714284,2,0.0,1,4,0,2,8,6,0,3,0,7,17,1
3904,60821,ZzTSVpCC3NZTmUJDu5qmPWy1kpkkg23B,5Gyp41oLVo7Gg7vF4vpmggWP5MU70QO6,12,16,6,5,4,0,3,0,34,4.857142857142857,2,0.0,6,6,3,4,10,0,2,3,0,19,15,1
3905,60824,EdSyqy374rFTTRmoH6AfOLgRNsPjxdOm,5Gyp41oLVo7Gg7vF4vpmggWP5MU70QO6,12,40,7,17,1,33,5,0,103,14.714285714285714,3,0.0,17,7,12,1,23,33,5,5,0,37,66,0
3906,60836,qZitrXj0xDyiMoVtMqJ0te0xvV2uuGvW,5Gyp41oLVo7Gg7vF4vpmggWP5MU70QO6,10,4,3,0,2,2,5,1,17,2.4285714285714284,1,0.0,0,3,0,2,4,2,0,5,1,5,12,1
3907,60889,GhjwXxw03ma5isc4qZG3VJmb78KCJ9cp,5Gyp41oLVo7Gg7vF4vpmggWP5MU70QO6,8,2,0,0,1,1,5,1,10,1.4285714285714286,1,0.0,0,0,0,1,2,1,0,5,1,1,9,1
3908,60893,q6ImRwYI49QH6rDfPPrjdpug7s8VmM2U,5Gyp41oLVo7Gg7vF4vpmggWP5MU70QO6,3,0,0,0,0,0,7,0,7,1.0,1,0.0,0,0,0,0,0,0,0,7,0,0,7,1
3909,60895,kUV7PkffqTPC2wwIDiSU996TO0hf9cl5,5Gyp41oLVo7Gg7vF4vpmggWP5MU70QO6,4,2,1,0,1,0,1,0,5,0.7142857142857143,1,0.0,0,1,0,1,2,0,0,1,0,2,3,1
3910,60900,ixroUTgMTbZ2v416satSEbB9LtxayGob,5Gyp41oLVo7Gg7vF4vpmggWP5MU70QO6,10,16,6,4,5,3,2,0,36,5.142857142857143,2,0.0,6,6,3,5,10,3,1,2,0,20,16,1
3911,60908,YUajDafaxYTI7N27Q7CLvJUo32157OqV,5Gyp41oLVo7Gg7vF4vpmggWP5MU70QO6,1,0,0,0,0,0,1,0,1,0.14285714285714285,1,0.0,0,0,0,0,0,0,0,1,0,0,1,1
3912,61008,8RsUWVhT21wU3hqZiuarsy4LdzVsaOkQ,5X6FeZozNMgE2VRi3MJYjkkFK8SETtu2,12,7,3,0,6,0,2,0,18,2.5714285714285716,1,0.0,3,3,0,6,4,0,0,2,0,12,6,1
3913,61051,ZqebYSMW1RUIRSXJmMzKs77Liu7pj2zF,5X6FeZozNMgE2VRi3MJYjkkFK8SETtu2,2,0,0,0,0,0,2,0,2,0.2857142857142857,1,0.0,0,0,0,0,0,0,0,2,0,0,2,1
3914,61101,PxY4KTZXiR1nUBRtclSF0b03F1Pqss0m,5X6FeZozNMgE2VRi3MJYjkkFK8SETtu2,9,11,6,2,5,0,5,0,29,4.142857142857143,1,0.0,3,6,2,5,8,0,0,5,0,16,13,1
3915,61115,dOT2svs05paSxmjedHl57q7jZeXZzSd2,5X6FeZozNMgE2VRi3MJYjkkFK8SETtu2,1,0,0,0,0,0,1,0,1,0.14285714285714285,1,0.0,0,0,0,0,0,0,0,1,0,0,1,1
3916,61186,J2puydpByblFRXtlxh6rWFA0oulKsltP,5X6FeZozNMgE2VRi3MJYjkkFK8SETtu2,6,3,1,0,1,0,4,1,10,1.4285714285714286,1,0.0,0,1,0,1,3,0,0,4,1,2,8,1
3917,61243,NVDm1UrviKBwDUtIj2XElADPKVdYouRj,5X6FeZozNMgE2VRi3MJYjkkFK8SETtu2,5,2,1,0,1,0,3,1,8,1.1428571428571428,2,0.0,0,1,0,1,2,0,0,3,1,2,6,1
3918,61267,dGZm4Htdvb1iV3IKfAeIZ2LAhkb1Gbe6,3VkHkmOtom3jM2wCu94xgzzu1d6Dn7or,4,13,3,0,0,0,1,0,17,2.4285714285714284,1,0.0,4,3,0,0,9,0,0,1,0,7,10,1
3919,61269,Xu2Wmr7ChGZ30LhApimfa4W4CAsLZTb4,3VkHkmOtom3jM2wCu94xgzzu1d6Dn7or,30,162,55,46,20,64,50,4,401,57.285714285714285,5,0.0,37,55,39,20,125,64,7,50,4,151,250,1
3920,61270,1SJmhRDD4Bzcm6S9X3GSNxkp9PjEl8e5,3VkHkmOtom3jM2wCu94xgzzu1d6Dn7or,14,7,6,0,6,0,3,0,22,3.142857142857143,1,0.0,0,6,0,6,7,0,0,3,0,12,10,1
3921,61271,QCz7iAgWTglOujTUKSsduDB6Qilzu930,3VkHkmOtom3jM2wCu94xgzzu1d6Dn7or,1,0,0,0,0,0,1,0,1,0.14285714285714285,1,0.0,0,0,0,0,0,0,0,1,0,0,1,1
3922,61275,fZ46j2fohm03QTARbgF90FHd23VNyR7N,3VkHkmOtom3jM2wCu94xgzzu1d6Dn7or,7,4,2,0,1,0,4,0,11,1.5714285714285714,2,0.0,0,2,0,1,4,0,0,4,0,3,8,1
3923,61277,sNixQiqbyoByL0a8WTxXOh0j3W120QrY,3VkHkmOtom3jM2wCu94xgzzu1d6Dn7or,16,36,12,11,14,14,9,0,96,13.714285714285714,3,0.0,19,12,9,14,17,14,2,9,0,54,42,1
3924,61278,Jb4oUgpxqLwX7kTj7ccezvvn1kbsURnR,3VkHkmOtom3jM2wCu94xgzzu1d6Dn7or,5,0,0,0,0,2,6,0,8,1.1428571428571428,1,0.0,0,0,0,0,0,2,0,6,0,0,8,1
3925,61279,N33q0sZm2H4OCladSji4PPu5G3B3tcSM,3VkHkmOtom3jM2wCu94xgzzu1d6Dn7or,96,258,125,99,79,28,113,2,704,100.57142857142857,19,0.0,94,125,90,79,164,28,9,113,2,388,316,0
3926,61285,lMM1JzejQytGyVkIVUZhykrOSAgSFpP7,3VkHkmOtom3jM2wCu94xgzzu1d6Dn7or,7,7,4,0,2,0,5,1,19,2.7142857142857144,2,0.0,0,4,0,2,7,0,0,5,1,6,13,1
3927,61286,55eRUKhAgZ6jAG2QNlk8p8bxI8Mo1ci4,3VkHkmOtom3jM2wCu94xgzzu1d6Dn7or,9,5,3,0,2,1,7,1,19,2.7142857142857144,1,0.0,0,3,0,2,5,1,0,7,1,5,14,1
3928,61291,thNUY2LiLdfoa2GF2Lwhr6spnxSoHgtr,3VkHkmOtom3jM2wCu94xgzzu1d6Dn7or,5,2,1,0,1,1,3,0,8,1.1428571428571428,1,0.0,0,1,0,1,2,1,0,3,0,2,6,1
3929,61295,1YFqbq4eZv4Mhq7JPXkIeiT5gk9dirXn,3VkHkmOtom3jM2wCu94xgzzu1d6Dn7or,4,0,0,0,0,3,3,1,7,1.0,1,0.0,0,0,0,0,0,3,0,3,1,0,7,1
3930,61300,uCa5BufZ9SzdynjpiFKUgTwQrCSkIuTv,3VkHkmOtom3jM2wCu94xgzzu1d6Dn7or,10,13,2,0,1,4,8,1,29,4.142857142857143,3,0.0,3,2,0,1,10,4,0,8,1,6,23,1
3931,61304,aPufBZhx6k52eMylgE3zOO2d01RzR36G,3VkHkmOtom3jM2wCu94xgzzu1d6Dn7or,1,0,0,0,0,0,1,0,1,0.14285714285714285,1,0.0,0,0,0,0,0,0,0,1,0,0,1,1
3932,61307,PLNJfZdR6EYXYVrLGogKUAQMKIHkwEgU,3VkHkmOtom3jM2wCu94xgzzu1d6Dn7or,4,2,1,0,1,0,1,0,5,0.7142857142857143,1,0.0,0,1,0,1,2,0,0,1,0,2,3,1
3933,61310,B7Iubi23XVqzH9vIBYh3kd1Uu97xMgg5,3VkHkmOtom3jM2wCu94xgzzu1d6Dn7or,2,0,0,0,0,0,3,0,3,0.42857142857142855,1,0.0,0,0,0,0,0,0,0,3,0,0,3,1
3934,61313,XZ29aLocCQNX1wXcSW5kg15u9Cwj9LID,3VkHkmOtom3jM2wCu94xgzzu1d6Dn7or,22,32,20,0,13,2,10,6,83,11.857142857142858,4,0.0,0,20,0,13,32,2,0,10,6,33,50,1
3935,61314,zHeujEYh5L6paRQ7acJHcEFwTj5egykX,3VkHkmOtom3jM2wCu94xgzzu1d6Dn7or,58,223,79,109,7,72,15,0,505,72.14285714285714,10,0.0,75,79,101,7,148,72,8,15,0,262,243,0
3936,61315,bXMaalfz1ZqHKnJWw6VXCAoemSeuw45Q,3VkHkmOtom3jM2wCu94xgzzu1d6Dn7or,91,117,63,55,72,2,43,2,354,50.57142857142857,13,0.0,48,63,47,72,69,2,8,43,2,230,124,0
3937,61317,GXpHmORghgiXMAlEcDVGL594XpoUvqlX,3VkHkmOtom3jM2wCu94xgzzu1d6Dn7or,64,125,53,42,44,40,31,0,335,47.857142857142854,6,0.0,50,53,39,44,75,40,3,31,0,186,149,0
3938,61318,Ynti1kEVPZ88eymZgi4Ldsdb7WhG2uKG,3VkHkmOtom3jM2wCu94xgzzu1d6Dn7or,17,40,15,0,9,2,16,1,83,11.857142857142858,7,0.0,0,15,0,9,40,2,0,16,1,24,59,1
3939,61320,UaTXpBQ57ylpYjSfyedXwjRneTYvxLXD,3VkHkmOtom3jM2wCu94xgzzu1d6Dn7or,1,0,0,0,0,0,1,0,1,0.14285714285714285,1,0.0,0,0,0,0,0,0,0,1,0,0,1,1
3940,61321,YY7yHizDn0UpGHVq4qoTfbulP3ev5TkC,3VkHkmOtom3jM2wCu94xgzzu1d6Dn7or,12,17,12,0,7,49,5,0,90,12.857142857142858,3,0.0,0,12,0,7,17,49,0,5,0,19,71,0
3941,61323,KmYofLuc0BaIyeuN3HJy8CuJaHG4AJDb,3VkHkmOtom3jM2wCu94xgzzu1d6Dn7or,4,2,1,0,1,0,1,0,5,0.7142857142857143,1,0.0,0,1,0,1,2,0,0,1,0,2,3,1
3942,61324,pFFSzAIsKlRn4mToKiENn82VvmlAcGfv,3VkHkmOtom3jM2wCu94xgzzu1d6Dn7or,9,5,3,0,4,0,7,0,19,2.7142857142857144,2,0.0,1,3,0,4,4,0,0,7,0,8,11,1
3943,61326,fyaPQSkjahso8DKGgPjDCImFPdJUGCuW,3VkHkmOtom3jM2wCu94xgzzu1d6Dn7or,5,6,1,0,2,0,2,0,11,1.5714285714285714,1,0.0,2,1,0,2,4,0,0,2,0,5,6,1
3944,61329,tSyXllu3VBRd0aW6BYXjiam1fTkDqGu0,3VkHkmOtom3jM2wCu94xgzzu1d6Dn7or,1,0,0,0,0,0,1,0,1,0.14285714285714285,1,0.0,0,0,0,0,0,0,0,1,0,0,1,1
3945,61333,3y0hMQPuZObbo4YGcpFjkRzHS18C7xm9,3VkHkmOtom3jM2wCu94xgzzu1d6Dn7or,1,0,0,0,0,0,2,0,2,0.2857142857142857,2,0.0,0,0,0,0,0,0,0,2,0,0,2,1
3946,61334,LvdumVddfOkiRrgcuYPzC8PJen0ULcog,3VkHkmOtom3jM2wCu94xgzzu1d6Dn7or,7,7,2,0,1,0,4,0,14,2.0,1,0.0,0,2,0,1,7,0,0,4,0,3,11,1
3947,61340,cmBf5dDhylT8akf52vSLbehcwSB094o7,3VkHkmOtom3jM2wCu94xgzzu1d6Dn7or,1,0,0,0,0,0,1,0,1,0.14285714285714285,1,0.0,0,0,0,0,0,0,0,1,0,0,1,1
3948,61342,ge4fVyuuR3ALhxHgeKDRlmkSZoMrgTvY,3VkHkmOtom3jM2wCu94xgzzu1d6Dn7or,6,2,1,0,1,0,3,2,9,1.2857142857142858,1,0.0,0,1,0,1,2,0,0,3,2,2,7,0
3949,61344,RraMsxEKuI5fM01TqMkfBoe68A6ycVzD,3VkHkmOtom3jM2wCu94xgzzu1d6Dn7or,33,81,39,16,41,28,25,3,233,33.285714285714285,5,0.0,36,39,15,41,45,28,1,25,3,131,102,1
3950,61345,EKW68EVipwDnVj4OACaFT183WfWiotRr,3VkHkmOtom3jM2wCu94xgzzu1d6Dn7or,66,324,94,76,90,63,97,27,771,110.14285714285714,13,0.0,182,94,65,90,142,63,11,97,27,431,340,0
3951,61346,cS4j36iYvYOHHK4d6wWz4Cr0lyqpITjd,3VkHkmOtom3jM2wCu94xgzzu1d6Dn7or,11,7,4,0,2,5,7,3,28,4.0,1,0.0,0,4,0,2,7,5,0,7,3,6,22,1
3952,61347,J0gLEwt810bfm4giMRKF4WoOeR9tXk1Z,3VkHkmOtom3jM2wCu94xgzzu1d6Dn7or,5,2,0,0,1,0,3,0,6,0.8571428571428571,2,0.0,0,0,0,1,2,0,0,3,0,1,5,1
3953,61353,7xNBrJLcG8Tw9PPj6SmLjDEzgSVEhwan,3VkHkmOtom3jM2wCu94xgzzu1d6Dn7or,7,3,2,0,2,0,2,0,9,1.2857142857142858,1,0.0,0,2,0,2,3,0,0,2,0,4,5,1
3954,61355,rO1YSAfPCFricBt51eVbZyq3Unb5LsBN,3VkHkmOtom3jM2wCu94xgzzu1d6Dn7or,5,2,1,0,1,0,3,0,7,1.0,1,0.0,0,1,0,1,2,0,0,3,0,2,5,1
3955,61357,9wj9AdMRKthqccyk1ZqPGvCnoYtKZSpQ,3VkHkmOtom3jM2wCu94xgzzu1d6Dn7or,16,38,7,6,18,32,3,0,104,14.857142857142858,1,0.0,30,7,6,18,8,32,0,3,0,61,43,1
3956,61359,C3qCYHZjY0uUjx6apnpRwLyUBwJoN7l6,3VkHkmOtom3jM2wCu94xgzzu1d6Dn7or,6,10,3,6,0,3,2,0,24,3.4285714285714284,1,0.0,4,3,5,0,6,3,1,2,0,12,12,1
3957,61362,eWDW1Ib1s4bTakCzRKbuXJli4ZP8oo7h,3VkHkmOtom3jM2wCu94xgzzu1d6Dn7or,8,13,7,1,2,9,6,0,38,5.428571428571429,2,0.0,1,7,1,2,12,9,0,6,0,11,27,1
3958,61363,B3hat72Gwdsh5VGB4UtT2PVbufh0eUw7,3VkHkmOtom3jM2wCu94xgzzu1d6Dn7or,5,3,1,2,1,0,2,0,9,1.2857142857142858,2,0.0,1,1,2,1,2,0,0,2,0,5,4,1
3959,61364,EmHfiIQoHEo5612aeOXbXefIQiZ9pivk,3VkHkmOtom3jM2wCu94xgzzu1d6Dn7or,8,13,4,3,6,3,3,1,33,4.714285714285714,1,0.0,7,4,3,6,6,3,0,3,1,20,13,1
3960,61365,5J6KvEX4H3vlRE4219qlauCGkc30MlxJ,3VkHkmOtom3jM2wCu94xgzzu1d6Dn7or,12,9,7,0,4,2,10,1,33,4.714285714285714,1,0.0,0,7,0,4,9,2,0,10,1,11,22,1
3961,61366,gTNmoWvWhpJtO6YnFGRmSk32TH4m5N9w,3VkHkmOtom3jM2wCu94xgzzu1d6Dn7or,5,4,1,0,2,0,2,0,9,1.2857142857142858,2,0.0,2,1,0,2,2,0,0,2,0,5,4,1
3962,61368,0lZgJ3Izj3xzJXE4iKqwdlPNZOcb8tfr,3VkHkmOtom3jM2wCu94xgzzu1d6Dn7or,20,14,10,0,8,0,4,0,36,5.142857142857143,1,0.0,1,10,0,8,13,0,0,4,0,19,17,1
3963,61370,KOlXIysOb8VF04tCZjd1kg0II2kb2mYu,3VkHkmOtom3jM2wCu94xgzzu1d6Dn7or,76,217,78,74,65,64,33,1,532,76.0,6,0.0,65,78,59,65,152,64,15,33,1,267,265,1
3964,61371,sZV7O4QepCcao3DEyr879t5mUWopWkVJ,3VkHkmOtom3jM2wCu94xgzzu1d6Dn7or,8,6,4,0,3,0,4,0,17,2.4285714285714284,1,0.0,0,4,0,3,6,0,0,4,0,7,10,1
3965,61373,gY4MmFhIOsF1Wm6XUOhrj2V8aIoxYXRx,3VkHkmOtom3jM2wCu94xgzzu1d6Dn7or,36,35,24,0,23,0,5,0,87,12.428571428571429,2,0.0,6,24,0,23,29,0,0,5,0,53,34,0
3966,61374,lSaDV1sycxZPmpqdOL4s2OzyxDadBcyQ,3VkHkmOtom3jM2wCu94xgzzu1d6Dn7or,28,80,26,29,20,38,12,0,205,29.285714285714285,8,0.0,27,26,25,20,53,38,4,12,0,98,107,1
3967,61376,1gHjCt90HibsGdolYHcLgNSayamL9Lgl,3VkHkmOtom3jM2wCu94xgzzu1d6Dn7or,4,2,1,0,1,0,1,0,5,0.7142857142857143,1,0.0,0,1,0,1,2,0,0,1,0,2,3,1
3968,61377,uBXyCnpgkxfIsstjod3TOmkkKg7d8zYv,3VkHkmOtom3jM2wCu94xgzzu1d6Dn7or,6,8,3,0,1,0,3,0,15,2.142857142857143,2,0.0,0,3,0,1,8,0,0,3,0,4,11,1
3969,61380,YoRqoOzvuzCTaiYWYaAvvKsbRs610g1g,3VkHkmOtom3jM2wCu94xgzzu1d6Dn7or,12,6,4,3,4,0,2,0,19,2.7142857142857144,1,0.0,1,4,3,4,5,0,0,2,0,12,7,1
3970,61381,B6EpScn9lSCPa3RR6ElGV7QvO5jse6Q3,3VkHkmOtom3jM2wCu94xgzzu1d6Dn7or,25,48,28,0,13,0,11,0,100,14.285714285714286,5,0.0,9,28,0,13,39,0,0,11,0,50,50,1
3971,61382,RSXPZ0RYmgpEvoW0QkrQF3dLkoX0vNEm,3VkHkmOtom3jM2wCu94xgzzu1d6Dn7or,1,0,0,0,0,0,2,0,2,0.2857142857142857,1,0.0,0,0,0,0,0,0,0,2,0,0,2,1
3972,61384,8gBenfAUifEb6sBv6EsCyw6oCQrobvm4,3VkHkmOtom3jM2wCu94xgzzu1d6Dn7or,24,32,9,22,13,9,9,0,94,13.428571428571429,3,0.0,18,9,21,13,14,9,1,9,0,61,33,0
3973,61385,xoBl0wW603taJwbMVeNODpDk0IbKa0yR,3VkHkmOtom3jM2wCu94xgzzu1d6Dn7or,25,30,18,12,17,3,10,0,90,12.857142857142858,3,0.0,8,18,11,17,22,3,1,10,0,54,36,1
3974,61386,iADIVtxyoQg4RtIKmWkz3YbJ1msvN2b8,3VkHkmOtom3jM2wCu94xgzzu1d6Dn7or,51,106,30,49,30,30,14,0,259,37.0,7,0.0,55,30,49,30,51,30,0,14,0,164,95,0
3975,61387,FY0TX9L7aPWX7VSeYOlhP1yt2bFTBqsi,3VkHkmOtom3jM2wCu94xgzzu1d6Dn7or,6,2,1,0,1,6,7,1,18,2.5714285714285716,2,0.0,0,1,0,1,2,6,0,7,1,2,16,1
3976,61388,qYPidKifaMFHp3213708Kz4gZcU4t8KS,3VkHkmOtom3jM2wCu94xgzzu1d6Dn7or,2,0,0,0,0,0,2,0,2,0.2857142857142857,1,0.0,0,0,0,0,0,0,0,2,0,0,2,1
3977,61392,ef55znmweQJrijlI0fO1Ekc271nZnV0m,3VkHkmOtom3jM2wCu94xgzzu1d6Dn7or,17,34,19,8,10,5,17,0,93,13.285714285714286,6,0.0,6,19,7,10,28,5,1,17,0,42,51,1
3978,61395,LfxVPkTskllD2jF3lfPEyHkfcPupyhDZ,3VkHkmOtom3jM2wCu94xgzzu1d6Dn7or,61,179,44,44,61,124,66,7,525,75.0,8,0.0,107,44,42,61,72,124,2,66,7,254,271,0
3979,61396,DeelyUHip68Bc1nEcSFah2ZDex256xUw,3VkHkmOtom3jM2wCu94xgzzu1d6Dn7or,6,2,1,0,1,2,5,1,12,1.7142857142857142,1,0.0,0,1,0,1,2,2,0,5,1,2,10,1
3980,61402,W7FXzdnq9Ktue5ZNM3TQmIP7HktmL3kC,3VkHkmOtom3jM2wCu94xgzzu1d6Dn7or,1,0,0,0,0,0,4,0,4,0.5714285714285714,1,0.0,0,0,0,0,0,0,0,4,0,0,4,1
3981,61407,zXW8D0tz2Cbaz6e77hrhozxkcZ5D0GFc,3VkHkmOtom3jM2wCu94xgzzu1d6Dn7or,5,2,1,0,1,0,2,0,6,0.8571428571428571,1,0.0,1,1,0,1,1,0,0,2,0,3,3,0
3982,61411,ohdROxpKfDmnPtJyTyliDaSUWBX4My6k,3VkHkmOtom3jM2wCu94xgzzu1d6Dn7or,38,59,19,29,24,15,8,0,154,22.0,3,0.0,30,19,25,24,29,15,4,8,0,98,56,1
3983,61416,viuKt4GgrX0rYL5EpHoxJbsiC9TblSuk,3VkHkmOtom3jM2wCu94xgzzu1d6Dn7or,8,8,4,0,2,10,25,1,50,7.142857142857143,8,0.0,0,4,0,2,8,10,0,25,1,6,44,0
3984,61418,pwCfOUjALc5NN8I5D9HogP6ntKzjlQLE,3VkHkmOtom3jM2wCu94xgzzu1d6Dn7or,7,3,2,0,2,0,2,0,9,1.2857142857142858,1,0.0,0,2,0,2,3,0,0,2,0,4,5,1
3985,61419,Pn2js00VBj94JFMjcjEse7Ds31Qeyttu,3VkHkmOtom3jM2wCu94xgzzu1d6Dn7or,74,310,122,22,84,15,91,25,669,95.57142857142857,19,0.0,98,122,21,84,212,15,1,91,25,325,344,0
3986,61425,4f5ozMpUJiQzRSDFnW6c4nKslwS1tye5,3VkHkmOtom3jM2wCu94xgzzu1d6Dn7or,16,64,19,15,14,4,19,0,135,19.285714285714285,4,0.0,34,19,12,14,30,4,3,19,0,79,56,0
3987,61426,Sv1TlrCiKjLHso6ovH5ZRk4wqqQPvzdd,3VkHkmOtom3jM2wCu94xgzzu1d6Dn7or,41,194,56,55,0,8,23,2,338,48.285714285714285,10,0.0,82,56,50,0,112,8,5,23,2,188,150,0
3988,61428,eQUEJ6p5loiYpm1ANmHrs30KEjfp1dL6,3VkHkmOtom3jM2wCu94xgzzu1d6Dn7or,13,14,8,0,5,0,6,0,33,4.714285714285714,1,0.0,0,8,0,5,14,0,0,6,0,13,20,0
3989,61429,zR8Wt44Nq9HKrXeqDmWD3gO2XkyhFav0,3VkHkmOtom3jM2wCu94xgzzu1d6Dn7or,15,13,8,6,5,6,14,1,53,7.571428571428571,1,0.0,2,8,5,5,11,6,1,14,1,20,33,1
3990,61433,tndnRnD7XfGiN94qfNeJcN7FgKETHiW0,3VkHkmOtom3jM2wCu94xgzzu1d6Dn7or,77,108,53,39,40,2,23,0,265,37.857142857142854,10,0.0,31,53,35,40,77,2,4,23,0,159,106,0
3991,61446,eMElakxdNwyds7hvAWWqn6yuj6dKI8Ws,3VkHkmOtom3jM2wCu94xgzzu1d6Dn7or,1,0,0,0,0,0,1,0,1,0.14285714285714285,1,0.0,0,0,0,0,0,0,0,1,0,0,1,1
3992,61447,SvUZcSJqn5uviSnLCETv5RXbwMQgArRw,3VkHkmOtom3jM2wCu94xgzzu1d6Dn7or,1,0,0,0,0,0,2,0,2,0.2857142857142857,2,0.0,0,0,0,0,0,0,0,2,0,0,2,1
3993,61448,8ANCOi1p12J3JBmvi0fahJDF8PDtEndE,3VkHkmOtom3jM2wCu94xgzzu1d6Dn7or,1,0,0,0,0,0,1,0,1,0.14285714285714285,1,0.0,0,0,0,0,0,0,0,1,0,0,1,1
3994,61449,zlr5J3lVoCh9O5Oq0mhAPCa6l5p8dJMQ,3VkHkmOtom3jM2wCu94xgzzu1d6Dn7or,1,0,0,0,0,0,1,0,1,0.14285714285714285,1,0.0,0,0,0,0,0,0,0,1,0,0,1,1
3995,61451,1FyiQnekweZ2XeXnccwpWWqNfcnFn7vs,3VkHkmOtom3jM2wCu94xgzzu1d6Dn7or,12,9,7,4,6,0,2,0,28,4.0,1,0.0,1,7,3,6,8,0,1,2,0,17,11,1
3996,61452,fNei7kDieK9E7YoqiBlAHzuDqZQbwUNs,3VkHkmOtom3jM2wCu94xgzzu1d6Dn7or,1,0,0,0,0,0,1,0,1,0.14285714285714285,1,0.0,0,0,0,0,0,0,0,1,0,0,1,1
3997,61455,9A0XvslxdczABblVWK0KCOD4pp55ghXg,3VkHkmOtom3jM2wCu94xgzzu1d6Dn7or,5,2,1,0,1,0,2,1,7,1.0,1,0.0,0,1,0,1,2,0,0,2,1,2,5,1
3998,61457,bnVD3IsHOnhCEVYhUQiRg9PpaxBlbMJ1,3VkHkmOtom3jM2wCu94xgzzu1d6Dn7or,80,118,47,40,39,32,24,1,301,43.0,9,0.0,49,47,37,39,69,32,3,24,1,172,129,0
3999,61459,NlHO5hXiy7TmVTHiRgExH6y7p9gJG1YF,3VkHkmOtom3jM2wCu94xgzzu1d6Dn7or,10,7,6,0,3,0,2,0,18,2.5714285714285716,1,0.0,0,6,0,3,7,0,0,2,0,9,9,1
4000,61461,vYZLFtHzbRZEyiuRAYkPU2TurFaRRb3e,3VkHkmOtom3jM2wCu94xgzzu1d6Dn7or,66,149,45,43,56,36,17,0,346,49.42857142857143,9,0.0,81,45,41,56,68,36,2,17,0,223,123,0
4001,61465,x9Cr4bD2XYNPQezjlTHozwMEvRoII5Sk,3VkHkmOtom3jM2wCu94xgzzu1d6Dn7or,1,0,0,0,0,0,1,0,1,0.14285714285714285,1,0.0,0,0,0,0,0,0,0,1,0,0,1,1
4002,61468,bl2rAEaePA356erajHAXTdRy3MQRHe67,3VkHkmOtom3jM2wCu94xgzzu1d6Dn7or,5,2,1,0,1,0,3,0,7,1.0,1,0.0,0,1,0,1,2,0,0,3,0,2,5,1
4003,61469,6BmZVjLN4nNolB7W1oGMr5uOMLXqdZJQ,3VkHkmOtom3jM2wCu94xgzzu1d6Dn7or,1,0,0,0,0,0,1,0,1,0.14285714285714285,1,0.0,0,0,0,0,0,0,0,1,0,0,1,1
4004,61470,paWCgHpHAyFQT9OUe0ll6zOiopVQPD6e,3VkHkmOtom3jM2wCu94xgzzu1d6Dn7or,1,0,0,0,0,0,2,0,2,0.2857142857142857,1,0.0,0,0,0,0,0,0,0,2,0,0,2,1
4005,61471,VSis3GPLe3g5PXWWtZzI0G79Q5DGCKD1,3VkHkmOtom3jM2wCu94xgzzu1d6Dn7or,6,3,2,0,2,0,1,0,8,1.1428571428571428,1,0.0,0,2,0,2,3,0,0,1,0,4,4,1
4006,61473,KJwbmkoK69ToUHYM3JjYSRGZ65hxphzP,3VkHkmOtom3jM2wCu94xgzzu1d6Dn7or,13,8,7,0,6,0,4,0,25,3.5714285714285716,1,0.0,0,7,0,6,8,0,0,4,0,13,12,1
4007,61474,ZmfdNNznGUKjrKBTFXV9DMVwFsyogQYG,3VkHkmOtom3jM2wCu94xgzzu1d6Dn7or,20,25,16,0,11,0,6,0,58,8.285714285714286,3,0.0,0,16,0,11,25,0,0,6,0,27,31,1
4008,61475,AQn3PPb2JuDtBjYGg9IXD30i1dxGAvNS,3VkHkmOtom3jM2wCu94xgzzu1d6Dn7or,14,61,14,8,17,7,20,2,129,18.428571428571427,4,0.0,36,14,6,17,25,7,2,20,2,73,56,1
4009,61479,BzOVfnUGvTKh9CiG8OwvUOF9UW93jsVA,3VkHkmOtom3jM2wCu94xgzzu1d6Dn7or,4,3,1,0,1,0,1,0,6,0.8571428571428571,1,0.0,1,1,0,1,2,0,0,1,0,3,3,1
4010,61481,3VXSMMHCshIzL95WBx5J3VPEs63QKqBF,3VkHkmOtom3jM2wCu94xgzzu1d6Dn7or,10,42,22,7,11,7,12,9,110,15.714285714285714,3,0.0,10,22,6,11,32,7,1,12,9,49,61,1
4011,61482,VUYRWxIK25dyFla7xdkPw6qN6gZPPejU,3VkHkmOtom3jM2wCu94xgzzu1d6Dn7or,67,159,80,121,56,43,13,0,472,67.42857142857143,5,0.0,54,80,112,56,105,43,9,13,0,302,170,0
4012,61484,8fCBuC51eLJ5RTCB0MFJYHIbTlyqgVN5,3VkHkmOtom3jM2wCu94xgzzu1d6Dn7or,86,307,46,88,102,38,24,1,606,86.57142857142857,6,0.0,172,46,84,102,135,38,4,24,1,404,202,1
4013,61485,yOLHyWyY5w1GXVtNrWqjdKWYXdnSJFEG,3VkHkmOtom3jM2wCu94xgzzu1d6Dn7or,13,17,7,7,5,10,9,0,55,7.857142857142857,2,0.0,5,7,7,5,12,10,0,9,0,24,31,1
4014,61493,yNVxqTDIVLfbY4CIKcL1TfyR4C1WDgZe,3VkHkmOtom3jM2wCu94xgzzu1d6Dn7or,67,208,75,100,31,6,46,1,467,66.71428571428571,11,0.0,54,75,95,31,154,6,5,46,1,255,212,0
4015,61496,gir9E9ZUbwj6bCUNLD2kQmOx1nsVwG4J,3VkHkmOtom3jM2wCu94xgzzu1d6Dn7or,6,6,4,0,1,0,3,0,14,2.0,2,0.0,0,4,0,1,6,0,0,3,0,5,9,1
4016,61497,hOVlGtXDkiKHOf01Bd7mgZZ1xKb8JhRd,3VkHkmOtom3jM2wCu94xgzzu1d6Dn7or,21,43,17,8,18,18,18,0,122,17.428571428571427,3,0.0,20,17,8,18,23,18,0,18,0,63,59,0
4017,61499,fo7ouvtbNwlDgRdiBgqVy1Dhppt33SVk,3VkHkmOtom3jM2wCu94xgzzu1d6Dn7or,17,14,7,0,8,0,1,0,30,4.285714285714286,1,0.0,4,7,0,8,10,0,0,1,0,19,11,1
4018,61507,DHfZKMAezkn3orBA6nrTmayLvgvs1xwo,3VkHkmOtom3jM2wCu94xgzzu1d6Dn7or,10,12,5,0,5,7,11,2,42,6.0,2,0.0,4,5,0,5,8,7,0,11,2,14,28,1
4019,61508,PSNpE96w64UzqJ7izDn4zKyoyc3uU8P4,3VkHkmOtom3jM2wCu94xgzzu1d6Dn7or,19,48,21,0,11,4,10,5,99,14.142857142857142,4,0.0,0,21,0,11,48,4,0,10,5,32,67,1
4020,61509,WnQjfOx2gyRuONOtXTqJRGPXAZeKb0hk,3VkHkmOtom3jM2wCu94xgzzu1d6Dn7or,46,179,6,42,12,6,23,1,269,38.42857142857143,11,0.0,69,6,36,12,110,6,6,23,1,123,146,0
4021,61510,ZSscaSWAxgdRQr0HRr5Ud3cI8gdzS6Tf,3VkHkmOtom3jM2wCu94xgzzu1d6Dn7or,55,112,15,32,42,24,12,0,237,33.857142857142854,6,0.0,43,15,31,42,69,24,1,12,0,131,106,1
4022,61511,qwXoPjhUKPW4mjMQuu0Cra7UJGmweA6l,3VkHkmOtom3jM2wCu94xgzzu1d6Dn7or,7,5,3,0,2,4,4,2,20,2.857142857142857,2,0.0,0,3,0,2,5,4,0,4,2,5,15,1
4023,61512,LQ8TblvoMlGOQu9VCylquJYWHUijd0ne,3VkHkmOtom3jM2wCu94xgzzu1d6Dn7or,6,9,4,0,0,0,4,0,17,2.4285714285714284,3,0.0,0,4,0,0,9,0,0,4,0,4,13,1
4024,61518,ngcKp0ODgyjN9TK21DEb0ectQJN0qS7o,3VkHkmOtom3jM2wCu94xgzzu1d6Dn7or,83,149,54,77,41,0,24,1,346,49.42857142857143,5,0.0,38,54,76,41,111,0,1,24,1,209,137,0
4025,61519,FBTuVfz1jYWkvk1XcAXFgGcmrwdirPiT,3VkHkmOtom3jM2wCu94xgzzu1d6Dn7or,37,27,20,0,17,3,13,1,81,11.571428571428571,3,0.0,3,20,0,17,24,3,0,13,1,40,41,1
4026,61520,Z8E1fWEz0b5y6BD6dlIVX2UJWlqxRpHR,3VkHkmOtom3jM2wCu94xgzzu1d6Dn7or,12,17,5,4,6,6,5,0,43,6.142857142857143,3,0.0,8,5,4,6,9,6,0,5,0,23,20,1
4027,61521,cn2YSKU6p7JeVQ11FhjesODRi4bPnlsB,3VkHkmOtom3jM2wCu94xgzzu1d6Dn7or,22,24,15,5,12,2,3,0,61,8.714285714285714,3,0.0,2,15,5,12,22,2,0,3,0,34,27,1
4028,61523,wwHA7fYVmcTg223vcU6GFcJ6brkYax5H,3VkHkmOtom3jM2wCu94xgzzu1d6Dn7or,6,5,2,0,1,0,5,0,13,1.8571428571428572,1,0.0,0,2,0,1,5,0,0,5,0,3,10,1
4029,61529,2AW6aH0SqKYjpe5J2qxXqfKxHscq7JWf,3VkHkmOtom3jM2wCu94xgzzu1d6Dn7or,34,80,27,29,26,0,11,0,173,24.714285714285715,5,0.0,45,27,29,26,35,0,0,11,0,127,46,1
4030,61530,L1ChD5lPBWD49W1CLcxht18PcZVlJzua,3VkHkmOtom3jM2wCu94xgzzu1d6Dn7or,65,145,53,47,48,41,41,7,382,54.57142857142857,6,0.0,70,53,43,48,75,41,4,41,7,214,168,0
4031,61533,Z9abodGLnoAKUQpj3iaQLs7Q9MTs6Wvr,3VkHkmOtom3jM2wCu94xgzzu1d6Dn7or,68,145,53,43,60,22,43,0,366,52.285714285714285,8,0.0,87,53,34,60,58,22,9,43,0,234,132,0
4032,61534,QlgMlXvog36Jv95J9pxeMiYy3CA0cwLU,3VkHkmOtom3jM2wCu94xgzzu1d6Dn7or,85,237,112,45,79,19,89,0,581,83.0,20,0.0,80,112,41,79,157,19,4,89,0,312,269,0
4033,61539,dhPF0MOUpHT5OZTFAONgRdkH1ZwnZtFz,3VkHkmOtom3jM2wCu94xgzzu1d6Dn7or,7,3,1,0,1,0,14,0,19,2.7142857142857144,2,0.0,0,1,0,1,3,0,0,14,0,2,17,0
4034,61542,zzNKAc7xfesbRQ4blnMrgsBQluZ0zJuQ,3VkHkmOtom3jM2wCu94xgzzu1d6Dn7or,13,23,8,0,7,2,5,0,45,6.428571428571429,3,0.0,8,8,0,7,15,2,0,5,0,23,22,0
4035,61545,uzWunaITmXKEfZHqvJVQKYhKGD41xhQj,3VkHkmOtom3jM2wCu94xgzzu1d6Dn7or,1,0,0,0,0,0,1,0,1,0.14285714285714285,1,0.0,0,0,0,0,0,0,0,1,0,0,1,1
4036,61548,2oqOis9uVkS5zFMz0hufDKmC3fKLmo8y,3VkHkmOtom3jM2wCu94xgzzu1d6Dn7or,1,0,0,0,0,0,2,0,2,0.2857142857142857,2,0.0,0,0,0,0,0,0,0,2,0,0,2,1
4037,61549,p77vjaHaFIiHskX3dumxWC6D5ZNYLne6,3VkHkmOtom3jM2wCu94xgzzu1d6Dn7or,45,157,63,34,64,5,17,4,344,49.142857142857146,9,0.0,84,63,29,64,73,5,5,17,4,240,104,1
4038,61554,ixaZdNaa2ZlUJVQIu27ONqwS5TEcz7ia,3VkHkmOtom3jM2wCu94xgzzu1d6Dn7or,9,11,6,0,1,8,24,2,52,7.428571428571429,2,0.0,0,6,0,1,11,8,0,24,2,7,45,1
4039,61555,uSpti6Yw7qPzPT4S4dLtJ0lPSlE5C6Xf,3VkHkmOtom3jM2wCu94xgzzu1d6Dn7or,71,197,77,101,56,63,44,5,543,77.57142857142857,12,0.0,65,77,93,56,132,63,8,44,5,291,252,0
4040,61556,Ck0jmNMsCRLB2TtPvaiIXguP6hyGiJxH,3VkHkmOtom3jM2wCu94xgzzu1d6Dn7or,23,77,19,20,17,19,11,1,164,23.428571428571427,6,0.0,45,19,16,17,32,19,4,11,1,97,67,1
4041,61558,KPZf9GET341Xk4ORsXzHy6Cn9V1LgPHy,3VkHkmOtom3jM2wCu94xgzzu1d6Dn7or,5,3,1,0,1,0,5,0,10,1.4285714285714286,1,0.0,1,1,0,1,2,0,0,5,0,3,7,1
4042,61562,3ZzhbGHk0AMavVBVS0pUAaZvWnLoQODp,3VkHkmOtom3jM2wCu94xgzzu1d6Dn7or,14,64,22,5,18,14,18,1,142,20.285714285714285,7,0.0,12,22,5,18,52,14,0,18,1,57,85,1
4043,61563,J44vilXvhZO4CMbzk7NQGJgFAdmThuli,3VkHkmOtom3jM2wCu94xgzzu1d6Dn7or,15,14,8,0,5,1,21,2,51,7.285714285714286,2,0.0,0,8,0,5,14,1,0,21,2,13,38,1
4044,61565,5Sdd90y9f6G1O01oh8dNylP38h97ZkQP,3VkHkmOtom3jM2wCu94xgzzu1d6Dn7or,7,4,2,0,1,4,5,0,16,2.2857142857142856,2,0.0,0,2,0,1,4,4,0,5,0,3,13,1
4045,61568,ykaUPJW4Nc9r2mv4b25QxgdHgIcQ63RQ,3VkHkmOtom3jM2wCu94xgzzu1d6Dn7or,4,5,0,0,2,0,2,0,9,1.2857142857142858,1,0.0,3,0,0,2,2,0,0,2,0,5,4,1
4046,61572,mvgecpIuM19IAt1bbE3Mi8BpDwnT3DEI,3VkHkmOtom3jM2wCu94xgzzu1d6Dn7or,9,23,9,2,4,8,11,1,58,8.285714285714286,2,0.0,5,9,2,4,18,8,0,11,1,20,38,1
4047,61578,2DccYKlqpoQf6OVf4P499VuvWPHZoTTu,3VkHkmOtom3jM2wCu94xgzzu1d6Dn7or,5,7,3,0,0,8,5,0,23,3.2857142857142856,4,0.0,0,3,0,0,7,8,0,5,0,3,20,1
4048,61579,ah9PpJgFXG9Fbwd7z8sEIODsCPTfULdy,3VkHkmOtom3jM2wCu94xgzzu1d6Dn7or,4,2,1,0,0,0,2,0,5,0.7142857142857143,1,0.0,0,1,0,0,2,0,0,2,0,1,4,1
4049,61581,DawlCH8NcvFmcnrUGRB8b9wi64nyiEPI,3VkHkmOtom3jM2wCu94xgzzu1d6Dn7or,80,156,59,61,66,9,31,4,386,55.142857142857146,9,0.0,73,59,54,66,83,9,7,31,4,252,134,0
4050,61582,EiO5bky9R1Iqlpv4ItUpPBUgGb1eJItE,3VkHkmOtom3jM2wCu94xgzzu1d6Dn7or,7,4,3,0,3,0,2,0,12,1.7142857142857142,2,0.0,0,3,0,3,4,0,0,2,0,6,6,1
4051,61584,ToBdLREKywPS9utX4VtkzPw40pRNsYiq,3VkHkmOtom3jM2wCu94xgzzu1d6Dn7or,9,9,6,0,4,0,9,1,29,4.142857142857143,2,0.0,0,6,0,4,9,0,0,9,1,10,19,1
4052,61604,X8nI71wgjvVnziT2GohIRTnyUeumIuGT,SpATywNh6bZuzm8s1ceuBUnMUAeoAHHw,28,40,1,19,1,0,3,0,64,9.142857142857142,1,0.0,6,1,17,1,34,0,2,3,0,25,39,0
4053,61609,0RRA0LeDh4nSJ7FMl9qY1fE7T0M4oANR,SpATywNh6bZuzm8s1ceuBUnMUAeoAHHw,19,17,12,13,7,0,4,0,53,7.571428571428571,2,0.0,2,12,12,7,15,0,1,4,0,33,20,0
4054,61610,jB0CpdoFx6mbd8VYrFivcPv6zE00pZ1K,5X6FeZozNMgE2VRi3MJYjkkFK8SETtu2,13,10,1,12,4,0,4,0,31,4.428571428571429,2,0.0,9,1,11,4,1,0,1,4,0,25,6,1
4055,61626,w7supWZd9V8OYuV6GbfYuMkG68T2DAiS,SpATywNh6bZuzm8s1ceuBUnMUAeoAHHw,5,2,1,0,1,0,4,0,8,1.1428571428571428,1,0.0,0,1,0,1,2,0,0,4,0,2,6,0
4056,61631,KI5ihDfSUNAjYVTbGrXe4uplnhTwkLF8,A3fsA9Zfv1X2fVEQhTw51lKENdNrEqT3,35,45,30,0,21,0,13,0,109,15.571428571428571,4,0.0,0,30,0,21,45,0,0,13,0,51,58,1
4057,61634,PyaXrfJadEJJdtWYxd1SSz75aPVyhQhH,SpATywNh6bZuzm8s1ceuBUnMUAeoAHHw,21,28,0,12,0,0,4,0,44,6.285714285714286,2,0.0,8,0,10,0,20,0,2,4,0,18,26,0
4058,61654,LYqZV37zE6nJxDsCo1hT04A5qKWsawBT,SpATywNh6bZuzm8s1ceuBUnMUAeoAHHw,48,80,46,37,32,0,15,0,210,30.0,4,0.0,6,46,33,32,74,0,4,15,0,117,93,0
4059,61656,IMC5v8VADk2BSRQySPnoyeNJYhIEb0n5,SpATywNh6bZuzm8s1ceuBUnMUAeoAHHw,45,35,26,12,21,3,9,0,106,15.142857142857142,2,0.0,2,26,11,21,33,3,1,9,0,60,46,0
4060,61675,gejGa8SAgjHkzsw2hD6p8TKYmXAjocFe,A3fsA9Zfv1X2fVEQhTw51lKENdNrEqT3,46,24,17,68,11,0,8,1,129,18.428571428571427,2,0.0,5,17,57,11,19,0,11,8,1,90,39,1
4061,61686,zRHa8EKlGdYTvX9vjas2PMVSV4pf61jb,bWdj2GDclj5ofokWjzoa5jAwMkxCykd6,5,0,0,0,0,0,5,1,6,0.8571428571428571,1,0.0,0,0,0,0,0,0,0,5,1,0,6,0
4062,61687,Iy2ElCZpRw3zxSRKsJzk7TkINwbfRI7p,bWdj2GDclj5ofokWjzoa5jAwMkxCykd6,6,2,1,0,1,0,3,0,7,1.0,1,0.0,0,1,0,1,2,0,0,3,0,2,5,1
4063,61698,ohrImkqpGgcOH7KX180kLXMmkm87D1S7,A3fsA9Zfv1X2fVEQhTw51lKENdNrEqT3,10,4,0,0,0,3,17,2,26,3.7142857142857144,2,0.0,0,0,0,0,4,3,0,17,2,0,26,0
4064,61701,BYKshB0XEKF6r4IznOvn2k5BErn13iSA,A3fsA9Zfv1X2fVEQhTw51lKENdNrEqT3,1,0,0,0,0,0,1,0,1,0.14285714285714285,1,0.0,0,0,0,0,0,0,0,1,0,0,1,1
4065,61703,1Ccev0ap5uQQlfggUCTp94lkg9qZetYO,SpATywNh6bZuzm8s1ceuBUnMUAeoAHHw,11,10,1,0,1,0,13,0,25,3.5714285714285716,2,0.0,0,1,0,1,10,0,0,13,0,2,23,1
4066,61707,hCcqWAdqv94Wqd11wCByvAvYa7YD0am3,SpATywNh6bZuzm8s1ceuBUnMUAeoAHHw,11,19,11,0,0,0,1,0,31,4.428571428571429,1,0.0,7,11,0,0,12,0,0,1,0,18,13,1
4067,61710,O8jXBTHa2km7hdR2fu64rRfE2lYYjYno,5X6FeZozNMgE2VRi3MJYjkkFK8SETtu2,5,2,1,0,1,1,3,0,8,1.1428571428571428,1,0.0,0,1,0,1,2,1,0,3,0,2,6,1
4068,61713,MYsCU1zkMrWxPhV1b7wSL5LZIo1zGyhU,bWdj2GDclj5ofokWjzoa5jAwMkxCykd6,16,12,9,0,8,0,1,0,30,4.285714285714286,1,0.0,2,9,0,8,10,0,0,1,0,19,11,0
4069,61723,JLHcajAdHD1OYKJrQ84J1iFmbxZ6Hs3q,SpATywNh6bZuzm8s1ceuBUnMUAeoAHHw,1,0,0,0,0,0,1,0,1,0.14285714285714285,1,0.0,0,0,0,0,0,0,0,1,0,0,1,1
4070,61729,lDtS3t8GwsTaLDIL0mQN8CpFBwRABCCR,SpATywNh6bZuzm8s1ceuBUnMUAeoAHHw,48,54,42,16,23,1,15,1,152,21.714285714285715,2,0.0,0,42,14,23,54,1,2,15,1,79,73,0
4071,61732,NcracMTfiaTPMbO6SSDnt9CDc4SnvBs9,SpATywNh6bZuzm8s1ceuBUnMUAeoAHHw,34,28,18,12,12,0,3,0,73,10.428571428571429,2,0.0,7,18,12,12,21,0,0,3,0,49,24,0
4072,61733,gMD3QXq0NP11IqNCLAQviPDQUlnfIgHG,SpATywNh6bZuzm8s1ceuBUnMUAeoAHHw,11,12,4,24,2,9,2,0,53,7.571428571428571,1,0.0,7,4,18,2,5,9,6,2,0,31,22,1
4073,61740,I9yi1jZjIznCPzP5fpMJEhPDMiUaetUu,SpATywNh6bZuzm8s1ceuBUnMUAeoAHHw,4,9,3,0,0,27,9,0,48,6.857142857142857,4,0.0,0,3,0,0,9,27,0,9,0,3,45,0
4074,61741,SA0LQfPIgP3MHhYP2mxz0u46Ceavmq26,SpATywNh6bZuzm8s1ceuBUnMUAeoAHHw,1,0,0,0,0,0,1,0,1,0.14285714285714285,1,0.0,0,0,0,0,0,0,0,1,0,0,1,1
4075,61744,l30g3WB045lPyRkHzrw7l9v0SYLqOMWO,SpATywNh6bZuzm8s1ceuBUnMUAeoAHHw,15,32,12,15,5,6,4,0,74,10.571428571428571,1,0.0,2,12,15,5,30,6,0,4,0,34,40,0
4076,61745,ZQ6y2Bmw7qT9LD8jxMjYzUpaHRmpaQsM,A3fsA9Zfv1X2fVEQhTw51lKENdNrEqT3,3,3,0,0,0,0,1,0,4,0.5714285714285714,2,0.0,0,0,0,0,3,0,0,1,0,0,4,0
4077,61755,lH1Zg2rCl3kv8uXAu0T77rdY9bAtw7jj,5X6FeZozNMgE2VRi3MJYjkkFK8SETtu2,5,2,1,0,1,0,3,0,7,1.0,1,0.0,0,1,0,1,2,0,0,3,0,2,5,1
4078,61756,lH1Zg2rCl3kv8uXAu0T77rdY9bAtw7jj,bWdj2GDclj5ofokWjzoa5jAwMkxCykd6,1,0,0,0,0,0,1,0,1,0.14285714285714285,1,0.0,0,0,0,0,0,0,0,1,0,0,1,1
4079,61759,fx9PEMItfmJUgx5YPFOnYPw9ZcUduuYm,SpATywNh6bZuzm8s1ceuBUnMUAeoAHHw,26,42,4,0,3,0,17,4,70,10.0,1,0.0,0,4,0,3,42,0,0,17,4,7,63,1
4080,61764,LXvzoXwYMI8XUD9YKm4GDUJg3NNw2lJx,SpATywNh6bZuzm8s1ceuBUnMUAeoAHHw,1,0,0,0,0,0,1,0,1,0.14285714285714285,1,0.0,0,0,0,0,0,0,0,1,0,0,1,1
4081,61781,Niuzd4uUgVDA7FmSxhu5zyPye1iamD36,A3fsA9Zfv1X2fVEQhTw51lKENdNrEqT3,48,48,30,66,17,5,40,4,210,30.0,5,0.0,2,30,56,17,46,5,10,40,4,105,105,0
4082,61790,qmqKP6SAEowU2N3tlmffeinW9LdivxOy,SpATywNh6bZuzm8s1ceuBUnMUAeoAHHw,5,3,2,0,2,0,2,0,9,1.2857142857142858,1,0.0,0,2,0,2,3,0,0,2,0,4,5,1
4083,61801,2we3WxltFBT1dd0FjP3YZ8iHf2xpHEei,SpATywNh6bZuzm8s1ceuBUnMUAeoAHHw,21,25,12,7,6,0,6,0,56,8.0,5,0.0,2,12,7,6,23,0,0,6,0,27,29,1
4084,61813,8h7TPToROF0s05SQ5vZMG2ojEeeLcCFW,A3fsA9Zfv1X2fVEQhTw51lKENdNrEqT3,1,0,0,0,0,0,1,0,1,0.14285714285714285,1,0.0,0,0,0,0,0,0,0,1,0,0,1,1
4085,61814,6ewbhsgJh7NTFUpGTc6v0or3nCOYP5Dz,bWdj2GDclj5ofokWjzoa5jAwMkxCykd6,1,0,0,0,0,0,1,0,1,0.14285714285714285,1,0.0,0,0,0,0,0,0,0,1,0,0,1,1
4086,61820,Z9cEVuw4mcpJgmZnx9s7TqG2hjvWE1iq,SpATywNh6bZuzm8s1ceuBUnMUAeoAHHw,9,4,1,0,1,0,5,0,11,1.5714285714285714,1,0.0,0,1,0,1,4,0,0,5,0,2,9,1
4087,61827,Vsgn39xnzwCAHySZDmd4brygEDxODJoX,SpATywNh6bZuzm8s1ceuBUnMUAeoAHHw,14,22,5,11,2,3,3,0,46,6.571428571428571,1,0.0,15,5,10,2,7,3,1,3,0,32,14,1
4088,61831,3anigzzYhfNjapezJCJsh7byfpbHQLWl,bWdj2GDclj5ofokWjzoa5jAwMkxCykd6,1,0,0,0,0,0,1,0,1,0.14285714285714285,1,0.0,0,0,0,0,0,0,0,1,0,0,1,1
4089,61837,2yFrrfFKwmpyH7xPcC8i0UYFZJHtjntf,SpATywNh6bZuzm8s1ceuBUnMUAeoAHHw,17,23,15,17,0,0,7,0,62,8.857142857142858,4,0.0,3,15,14,0,20,0,3,7,0,32,30,0
4090,61849,d075hTME47faaDBbuuQqettSTx0qUOAw,SpATywNh6bZuzm8s1ceuBUnMUAeoAHHw,10,5,1,4,1,0,5,2,18,2.5714285714285716,1,0.0,1,1,3,1,4,0,1,5,2,6,12,0
4091,61851,nK30QtYMul8F2pspph6f3bZqVlAGvF0S,A3fsA9Zfv1X2fVEQhTw51lKENdNrEqT3,11,21,6,0,3,0,6,0,36,5.142857142857143,1,0.0,0,6,0,3,21,0,0,6,0,9,27,1
4092,61890,bY3M6NxBAZjGeFa96h2br6AbSx8krpDK,SpATywNh6bZuzm8s1ceuBUnMUAeoAHHw,20,20,11,2,7,0,3,0,43,6.142857142857143,1,0.0,0,11,2,7,20,0,0,3,0,20,23,0
4093,61910,TNArortVQm3F09odJ2W3xdM27lVc5PiX,SpATywNh6bZuzm8s1ceuBUnMUAeoAHHw,20,26,11,12,10,2,6,0,67,9.571428571428571,1,0.0,5,11,12,10,21,2,0,6,0,38,29,0
4094,61916,XDPvGyFLLEYwbNEQik2MM4yiADs5rrYJ,A3fsA9Zfv1X2fVEQhTw51lKENdNrEqT3,27,37,22,26,14,0,5,0,104,14.857142857142858,3,0.0,2,22,21,14,35,0,5,5,0,59,45,0
4095,61933,ZvGWd8SnJBMBXelpyx7gJSeWR5DJOwTo,SpATywNh6bZuzm8s1ceuBUnMUAeoAHHw,23,25,0,34,0,0,6,0,65,9.285714285714286,3,0.0,12,0,31,0,13,0,3,6,0,43,22,0
4096,61934,8dPQDWD7NMlHSztQh4Fh3dqPVx6xptft,SpATywNh6bZuzm8s1ceuBUnMUAeoAHHw,32,34,14,22,9,0,7,0,86,12.285714285714286,2,0.0,4,14,18,9,30,0,4,7,0,45,41,0
4097,61941,aJMNcTer76nTaYZZR58xtdmLr8BYq1Op,bWdj2GDclj5ofokWjzoa5jAwMkxCykd6,5,4,2,0,0,0,3,1,10,1.4285714285714286,1,0.0,0,2,0,0,4,0,0,3,1,2,8,0
4098,61948,MHUd30s3WtRLChM8IirlGkLsv26fGFJh,bWdj2GDclj5ofokWjzoa5jAwMkxCykd6,3,2,0,0,0,0,1,0,3,0.42857142857142855,1,0.0,0,0,0,0,2,0,0,1,0,0,3,1
4099,61951,01vp16vMBdfdzNflK84lEgGXfBDKyb7S,SpATywNh6bZuzm8s1ceuBUnMUAeoAHHw,3,2,1,0,0,0,2,0,5,0.7142857142857143,1,0.0,0,1,0,0,2,0,0,2,0,1,4,1
4100,61961,za2dBkPPLD9IPRBjooK7GJit2ulI5UgN,5X6FeZozNMgE2VRi3MJYjkkFK8SETtu2,1,0,0,0,0,0,1,0,1,0.14285714285714285,1,0.0,0,0,0,0,0,0,0,1,0,0,1,1
4101,61970,rw1CeO1TCa8fgCdp1zXNf3dRKMz7g6nk,SpATywNh6bZuzm8s1ceuBUnMUAeoAHHw,5,3,2,0,1,0,1,0,7,1.0,1,0.0,0,2,0,1,3,0,0,1,0,3,4,1
4102,61976,ylLJf4W02XCQY6BRCUv9QXbHD8BqRMHC,5X6FeZozNMgE2VRi3MJYjkkFK8SETtu2,1,0,0,0,0,0,3,0,3,0.42857142857142855,1,0.0,0,0,0,0,0,0,0,3,0,0,3,1
4103,61977,XupxNoKQxp2aAQkFy5RiZK4Yl6Wd1tRi,SpATywNh6bZuzm8s1ceuBUnMUAeoAHHw,24,28,2,30,2,0,7,0,69,9.857142857142858,4,0.0,4,2,24,2,24,0,6,7,0,32,37,0
4104,61986,foVkTyqD4PcwEOzU1yZGubmwk25CvIbn,5X6FeZozNMgE2VRi3MJYjkkFK8SETtu2,6,10,4,0,5,0,1,0,20,2.857142857142857,1,0.0,2,4,0,5,8,0,0,1,0,11,9,1
4105,61987,VHRjjAEe4Vcbn4fNxXSJ9BDfSyDWAt6F,SpATywNh6bZuzm8s1ceuBUnMUAeoAHHw,26,28,13,15,9,0,1,0,66,9.428571428571429,1,0.0,4,13,14,9,24,0,1,1,0,40,26,0
4106,61994,pvjfd8HSIoVZ71m9TCBbQlraohrUi2x6,SpATywNh6bZuzm8s1ceuBUnMUAeoAHHw,6,4,1,0,1,0,1,0,7,1.0,1,0.0,0,1,0,1,4,0,0,1,0,2,5,0
4107,62011,vPv7PsanhRceiGshTPXtgrOmcrOEYM8O,SpATywNh6bZuzm8s1ceuBUnMUAeoAHHw,11,12,5,16,3,0,2,0,38,5.428571428571429,2,0.0,4,5,13,3,8,0,3,2,0,25,13,1
4108,62033,63waYBGRyitKxyJxVKV8NWeJFWacnPQr,bWdj2GDclj5ofokWjzoa5jAwMkxCykd6,13,9,7,0,5,0,6,0,27,3.857142857142857,1,0.0,0,7,0,5,9,0,0,6,0,12,15,1
4109,62039,M1wHxfNvMfzb2hOsqqFPB2oGlkH2NCqL,SpATywNh6bZuzm8s1ceuBUnMUAeoAHHw,1,0,0,0,0,0,1,0,1,0.14285714285714285,1,0.0,0,0,0,0,0,0,0,1,0,0,1,1
4110,62051,xFkd6TNWJ8qmIM4trYH57onQcjo5lnU0,SpATywNh6bZuzm8s1ceuBUnMUAeoAHHw,5,5,2,0,1,0,3,0,11,1.5714285714285714,1,0.0,0,2,0,1,5,0,0,3,0,3,8,0
4111,62061,TuJrZ9qQp5b2qpTGGmQsmYcn7kQGqQe7,bWdj2GDclj5ofokWjzoa5jAwMkxCykd6,8,5,1,0,1,4,5,1,17,2.4285714285714284,1,0.0,0,1,0,1,5,4,0,5,1,2,15,1
4112,62067,d7CRMAVRgBps84fhYwYVHXr4TrIkJYDp,SpATywNh6bZuzm8s1ceuBUnMUAeoAHHw,3,2,0,0,0,0,1,0,3,0.42857142857142855,1,0.0,0,0,0,0,2,0,0,1,0,0,3,1
4113,62072,VWEcCKiwp28lQZuBYYNslDL0523gk0Z6,SpATywNh6bZuzm8s1ceuBUnMUAeoAHHw,11,14,12,0,6,0,2,0,34,4.857142857142857,2,0.0,0,12,0,6,14,0,0,2,0,18,16,0
4114,62076,gRHI1NeWW3c6BFrZIrJSlWu9NHDjRltm,A3fsA9Zfv1X2fVEQhTw51lKENdNrEqT3,1,0,0,0,0,0,1,0,1,0.14285714285714285,1,0.0,0,0,0,0,0,0,0,1,0,0,1,1
4115,62091,6AOZlfpjI3ayLpXvguaWVv2FqhQMzw4M,SpATywNh6bZuzm8s1ceuBUnMUAeoAHHw,13,14,4,16,0,4,3,0,41,5.857142857142857,2,0.0,8,4,16,0,6,4,0,3,0,28,13,0
4116,62107,2WHNpOBPMmOzdjUXQIDdX6w5Bhh6AyHU,A3fsA9Zfv1X2fVEQhTw51lKENdNrEqT3,4,2,0,0,0,0,3,0,5,0.7142857142857143,1,0.0,0,0,0,0,2,0,0,3,0,0,5,1
4117,62113,jJEQAKDG1yT0OS9qRBZrNXlEJDxE8Etq,SpATywNh6bZuzm8s1ceuBUnMUAeoAHHw,25,26,1,51,0,8,3,1,90,12.857142857142858,1,0.0,12,1,39,0,14,8,12,3,1,52,38,0
4118,62121,NhPJ9UBOBOBhPPFbQaBatdINFBV0LhGH,bWdj2GDclj5ofokWjzoa5jAwMkxCykd6,6,3,1,0,1,0,2,0,7,1.0,1,0.0,0,1,0,1,3,0,0,2,0,2,5,1
4119,62126,TW1ehLQL40Ikq19OEBxpAsyok2kyaCmk,SpATywNh6bZuzm8s1ceuBUnMUAeoAHHw,2,0,0,0,0,0,3,0,3,0.42857142857142855,1,0.0,0,0,0,0,0,0,0,3,0,0,3,0
4120,62127,mf8NzKqxFvs6BIygtQ5WjltMylvjXbHc,SpATywNh6bZuzm8s1ceuBUnMUAeoAHHw,13,8,6,0,5,1,2,0,22,3.142857142857143,1,0.0,1,6,0,5,7,1,0,2,0,12,10,0
4121,62133,CsUkH6E2FiorKRYwpRBQQof16ywBIfF7,SpATywNh6bZuzm8s1ceuBUnMUAeoAHHw,23,34,18,17,10,0,8,0,87,12.428571428571429,1,0.0,4,18,15,10,30,0,2,8,0,47,40,0
4122,62139,i045qgxm9LaqFzlH53qyz9yZHDVsE7Hd,A3fsA9Zfv1X2fVEQhTw51lKENdNrEqT3,9,5,3,0,2,2,3,0,15,2.142857142857143,1,0.0,1,3,0,2,4,2,0,3,0,6,9,0
4123,62156,W2whDchxLBc7jpJ4UAVUryN7DSrj5pnr,SpATywNh6bZuzm8s1ceuBUnMUAeoAHHw,4,2,1,0,1,0,2,0,6,0.8571428571428571,1,0.0,0,1,0,1,2,0,0,2,0,2,4,0
4124,62161,We0slB08viHgFv6ByLfwdtuQZUg6JG7L,SpATywNh6bZuzm8s1ceuBUnMUAeoAHHw,2,0,0,0,0,0,2,0,2,0.2857142857142857,1,0.0,0,0,0,0,0,0,0,2,0,0,2,1
4125,62171,0qWriw6Ob6vvUwGuar3co0oWxdxDhQfz,SpATywNh6bZuzm8s1ceuBUnMUAeoAHHw,22,37,3,0,3,0,11,0,54,7.714285714285714,3,0.0,0,3,0,3,37,0,0,11,0,6,48,1
4126,62191,iyrbynbgfl6D6KuieOqH3w32Iw2l2I2s,SpATywNh6bZuzm8s1ceuBUnMUAeoAHHw,7,9,2,0,1,1,3,0,16,2.2857142857142856,1,0.0,0,2,0,1,9,1,0,3,0,3,13,0
4127,62201,1OBrER2fhEaO1ssR5JjSNPBTyfOQ6TtL,SpATywNh6bZuzm8s1ceuBUnMUAeoAHHw,1,0,0,0,0,0,1,0,1,0.14285714285714285,1,0.0,0,0,0,0,0,0,0,1,0,0,1,0
4128,62202,rTwB58J1ssafmkoi8YPftYxAHYuyJ7NT,SpATywNh6bZuzm8s1ceuBUnMUAeoAHHw,9,13,5,11,1,0,1,0,31,4.428571428571429,1,0.0,6,5,10,1,7,0,1,1,0,22,9,1
4129,62212,OEQBiRbbo3yEBzKSHcNX9ESBTSUy08ze,bWdj2GDclj5ofokWjzoa5jAwMkxCykd6,1,0,0,0,0,0,1,0,1,0.14285714285714285,1,0.0,0,0,0,0,0,0,0,1,0,0,1,1
4130,62218,FZjjoikxEifQwEx2vf6LYlhg4yyTwbym,bWdj2GDclj5ofokWjzoa5jAwMkxCykd6,9,6,3,0,4,0,6,0,19,2.7142857142857144,1,0.0,2,3,0,4,4,0,0,6,0,9,10,1
4131,62221,8wfthNOb0BPhThSw9kjQe6qRCSNePszj,A3fsA9Zfv1X2fVEQhTw51lKENdNrEqT3,14,8,6,0,5,0,7,1,27,3.857142857142857,1,0.0,0,6,0,5,8,0,0,7,1,11,16,1
4132,62230,ndhDcdDAu6yt6DqeoDQVxePRQtPmMi2n,bWdj2GDclj5ofokWjzoa5jAwMkxCykd6,3,2,0,0,0,0,2,0,4,0.5714285714285714,1,0.0,0,0,0,0,2,0,0,2,0,0,4,0
4133,62233,ndhDcdDAu6yt6DqeoDQVxePRQtPmMi2n,A3fsA9Zfv1X2fVEQhTw51lKENdNrEqT3,2,0,0,0,0,0,2,0,2,0.2857142857142857,1,0.0,0,0,0,0,0,0,0,2,0,0,2,1
4134,62235,2cdJoONM7ugDmkPkQHwnxWZwEOIANTXn,SpATywNh6bZuzm8s1ceuBUnMUAeoAHHw,32,88,43,11,12,0,23,1,178,25.428571428571427,7,0.0,3,43,10,12,85,0,1,23,1,68,110,0
4135,62250,09X3P3tf7uZBb0lMjqIth9ywCuAasY60,bWdj2GDclj5ofokWjzoa5jAwMkxCykd6,11,12,7,0,5,0,5,0,29,4.142857142857143,1,0.0,0,7,0,5,12,0,0,5,0,12,17,1
4136,62252,WqQAkduIaOlq1wWFWXlgkkciS37w9XAD,SpATywNh6bZuzm8s1ceuBUnMUAeoAHHw,5,2,0,0,0,0,3,0,5,0.7142857142857143,1,0.0,0,0,0,0,2,0,0,3,0,0,5,1
4137,62261,0teJ1SJvfM0H0N4uvzYYmDS7MZCwymzl,SpATywNh6bZuzm8s1ceuBUnMUAeoAHHw,4,2,1,0,0,0,4,0,7,1.0,1,0.0,0,1,0,0,2,0,0,4,0,1,6,1
4138,62270,MoUfFGTeyhYQMUSCAFTBt9yT4WYYwdbw,5X6FeZozNMgE2VRi3MJYjkkFK8SETtu2,1,0,0,0,0,0,2,0,2,0.2857142857142857,1,0.0,0,0,0,0,0,0,0,2,0,0,2,1
4139,62273,IuNpIOaZuRBW2mgIKgHs21LDtcpNsfmu,A3fsA9Zfv1X2fVEQhTw51lKENdNrEqT3,2,0,0,0,0,0,2,0,2,0.2857142857142857,1,0.0,0,0,0,0,0,0,0,2,0,0,2,1
4140,62274,MoUfFGTeyhYQMUSCAFTBt9yT4WYYwdbw,A3fsA9Zfv1X2fVEQhTw51lKENdNrEqT3,2,0,0,0,0,0,5,0,5,0.7142857142857143,1,0.0,0,0,0,0,0,0,0,5,0,0,5,1
4141,62285,VlxbZHrbMUNIIDz1p5aud0MZpY7LDewP,SpATywNh6bZuzm8s1ceuBUnMUAeoAHHw,8,3,3,0,3,0,3,0,12,1.7142857142857142,1,0.0,0,3,0,3,3,0,0,3,0,6,6,1
4142,62287,Iqr8rhvnyF52EAaKRHEvXgD2JWX5u592,SpATywNh6bZuzm8s1ceuBUnMUAeoAHHw,1,0,0,0,0,0,1,0,1,0.14285714285714285,1,0.0,0,0,0,0,0,0,0,1,0,0,1,1
4143,62290,FAyKTlOaLRLHiyLG5PXQhYddpdx56j0F,SpATywNh6bZuzm8s1ceuBUnMUAeoAHHw,9,9,4,0,1,1,4,0,19,2.7142857142857144,1,0.0,3,4,0,1,6,1,0,4,0,8,11,0
4144,62298,tgRV4Ph6jBkXuRC2WRimt2dpgifT6OCw,SpATywNh6bZuzm8s1ceuBUnMUAeoAHHw,4,2,1,0,1,0,2,0,6,0.8571428571428571,1,0.0,0,1,0,1,2,0,0,2,0,2,4,1
4145,62305,jFuORSL1URM2oqg9zp9eOfHmKoYyUgBh,SpATywNh6bZuzm8s1ceuBUnMUAeoAHHw,12,9,6,0,4,0,2,0,21,3.0,1,0.0,0,6,0,4,9,0,0,2,0,10,11,1
4146,62308,b4rUjBS7vB8qaoMp858Ib5n66iOTypn7,A3fsA9Zfv1X2fVEQhTw51lKENdNrEqT3,6,4,3,0,3,0,1,0,11,1.5714285714285714,1,0.0,0,3,0,3,4,0,0,1,0,6,5,0
4147,62310,OGbZQlCPOxb4YZ1VHMQPOFrqLYAV6XNt,SpATywNh6bZuzm8s1ceuBUnMUAeoAHHw,9,5,3,0,2,0,4,0,14,2.0,2,0.0,0,3,0,2,5,0,0,4,0,5,9,0
4148,62311,vrSE88LVDCOnrKr9y1AdVXn1Flmm2mPs,SpATywNh6bZuzm8s1ceuBUnMUAeoAHHw,17,17,2,14,2,0,3,0,38,5.428571428571429,2,0.0,6,2,13,2,11,0,1,3,0,23,15,0
4149,62315,rehkhATQUQzsvPUt1FSAdQznlBbIBQCI,A3fsA9Zfv1X2fVEQhTw51lKENdNrEqT3,1,0,0,0,0,0,1,0,1,0.14285714285714285,1,0.0,0,0,0,0,0,0,0,1,0,0,1,1
4150,62321,4aUZNrEysB01BTDaMjEoJUWN7ca7RotB,SpATywNh6bZuzm8s1ceuBUnMUAeoAHHw,7,8,6,0,3,6,2,0,25,3.5714285714285716,1,0.0,0,6,0,3,8,6,0,2,0,9,16,1
4151,62322,4DoyyXDqOMsiMWzvrBTSPT0IBsmDX2A1,SpATywNh6bZuzm8s1ceuBUnMUAeoAHHw,15,20,18,8,16,0,1,0,63,9.0,3,0.0,1,18,6,16,19,0,2,1,0,41,22,0
4152,62327,92bKvTvnwq2jhFMZWZTxnhsEZdpV3NGQ,SpATywNh6bZuzm8s1ceuBUnMUAeoAHHw,2,0,0,0,0,0,2,0,2,0.2857142857142857,1,0.0,0,0,0,0,0,0,0,2,0,0,2,1
4153,62331,FMwKUA8u0BzLarxpeAgKTtl6QSWIGKl8,SpATywNh6bZuzm8s1ceuBUnMUAeoAHHw,1,0,0,0,0,0,1,0,1,0.14285714285714285,1,0.0,0,0,0,0,0,0,0,1,0,0,1,0
4154,62342,Ld3gWjLWB7sts9LKFmrdXWXwm92Xd0Uq,bWdj2GDclj5ofokWjzoa5jAwMkxCykd6,5,2,2,0,2,0,4,0,10,1.4285714285714286,1,0.0,0,2,0,2,2,0,0,4,0,4,6,1
4155,62352,sow5cbVOHzieZ57WdIZ7rxvpXXvB9GoH,A3fsA9Zfv1X2fVEQhTw51lKENdNrEqT3,12,7,6,0,5,0,2,0,20,2.857142857142857,1,0.0,0,6,0,5,7,0,0,2,0,11,9,1
4156,62383,hIFgL0n5x61JjabCFOIHZgZxMVGzmHNh,SpATywNh6bZuzm8s1ceuBUnMUAeoAHHw,41,83,38,26,21,1,7,0,176,25.142857142857142,5,0.0,5,38,23,21,78,1,3,7,0,87,89,0
4157,62392,FLIojen7fff3GhtDNtEDgYWfLgv0g8w4,A3fsA9Zfv1X2fVEQhTw51lKENdNrEqT3,5,2,1,0,0,0,4,0,7,1.0,1,0.0,0,1,0,0,2,0,0,4,0,1,6,1
4158,62394,rhi6DwOdDxPn54oD7Ihjt2rbAzoJjgeO,A3fsA9Zfv1X2fVEQhTw51lKENdNrEqT3,2,0,0,0,0,0,2,0,2,0.2857142857142857,1,0.0,0,0,0,0,0,0,0,2,0,0,2,0
4159,62395,pK6rzyUuCZmhSxLTFQprydajDiiwmTm8,SpATywNh6bZuzm8s1ceuBUnMUAeoAHHw,4,2,1,0,1,0,1,0,5,0.7142857142857143,1,0.0,0,1,0,1,2,0,0,1,0,2,3,1
4160,62408,nWHKYpL7gfGd5o6Yik3SkKS20pn1ocoS,SpATywNh6bZuzm8s1ceuBUnMUAeoAHHw,21,17,5,14,3,0,3,0,42,6.0,2,0.0,4,5,13,3,13,0,1,3,0,25,17,1
4161,62416,xOjhmcafCtLT2q16oVNZpjeZh4FUCy6U,bWdj2GDclj5ofokWjzoa5jAwMkxCykd6,9,13,6,0,4,0,7,0,30,4.285714285714286,2,0.0,3,6,0,4,10,0,0,7,0,13,17,0
4162,62420,d7WW3KTRknYcXaBZVYoIbNodkFYiI6Ik,bWdj2GDclj5ofokWjzoa5jAwMkxCykd6,17,36,10,32,12,13,11,1,115,16.428571428571427,1,0.0,6,10,31,12,30,13,1,11,1,59,56,0
4163,62421,SdcBphx7BESMj1mdAJDqRrAazSDoLz8G,A3fsA9Zfv1X2fVEQhTw51lKENdNrEqT3,7,2,1,0,0,0,8,0,11,1.5714285714285714,2,0.0,0,1,0,0,2,0,0,8,0,1,10,0
4164,62426,5mO7C1dFwundVgxmwj0qAHfPbFKc9GyD,A3fsA9Zfv1X2fVEQhTw51lKENdNrEqT3,1,0,0,0,0,0,2,0,2,0.2857142857142857,1,0.0,0,0,0,0,0,0,0,2,0,0,2,1
4165,62431,s3wtFKugaAKB43ojnhovCpGktGjeVAzu,5X6FeZozNMgE2VRi3MJYjkkFK8SETtu2,13,36,4,4,1,0,8,0,53,7.571428571428571,4,0.0,12,4,4,1,24,0,0,8,0,21,32,1
4166,62438,95gHhLGdlbtW5E72xyxtYlwvSjIG9gAI,5X6FeZozNMgE2VRi3MJYjkkFK8SETtu2,5,2,1,0,1,0,3,0,7,1.0,2,0.0,0,1,0,1,2,0,0,3,0,2,5,1
4167,62440,WmzYkzlMNuHgERGSMthySa2d3K7cWcp2,5X6FeZozNMgE2VRi3MJYjkkFK8SETtu2,7,3,1,0,2,0,2,0,8,1.1428571428571428,1,0.0,0,1,0,2,3,0,0,2,0,3,5,1
4168,62455,TGKKBT4W2L0CWcP0EPRhdqdXdbvVz6Hc,5X6FeZozNMgE2VRi3MJYjkkFK8SETtu2,1,0,0,0,0,0,1,0,1,0.14285714285714285,1,0.0,0,0,0,0,0,0,0,1,0,0,1,1
4169,62466,ggEr2STKTwtSSUdtGCmiPr3DBu3TJ34B,SpATywNh6bZuzm8s1ceuBUnMUAeoAHHw,13,10,0,10,0,0,6,0,26,3.7142857142857144,3,0.0,4,0,10,0,6,0,0,6,0,14,12,1
4170,62510,VKZrA9UHz7VaRJstik2phf1CbUI8Uxym,SpATywNh6bZuzm8s1ceuBUnMUAeoAHHw,1,0,0,0,0,0,2,0,2,0.2857142857142857,1,0.0,0,0,0,0,0,0,0,2,0,0,2,0
4171,62516,l7f4vHvlZkxCYoU9qM63V45bmndBSeZQ,A3fsA9Zfv1X2fVEQhTw51lKENdNrEqT3,7,5,3,6,0,0,2,0,16,2.2857142857142856,1,0.0,0,3,6,0,5,0,0,2,0,9,7,1
4172,62532,VYMfm0tgVS6x4Eosz9NPpRPYpCrgFsMy,SpATywNh6bZuzm8s1ceuBUnMUAeoAHHw,45,89,16,59,9,1,16,0,190,27.142857142857142,3,0.0,13,16,53,9,76,1,6,16,0,91,99,0
4173,62549,u82lBhpDxJIwlZISEntCxj1zgVFdW0vT,bWdj2GDclj5ofokWjzoa5jAwMkxCykd6,1,0,0,0,0,0,1,0,1,0.14285714285714285,1,0.0,0,0,0,0,0,0,0,1,0,0,1,1
4174,62551,u82lBhpDxJIwlZISEntCxj1zgVFdW0vT,5X6FeZozNMgE2VRi3MJYjkkFK8SETtu2,1,0,0,0,0,0,1,0,1,0.14285714285714285,1,0.0,0,0,0,0,0,0,0,1,0,0,1,1
4175,62554,bYD2u7vuN3G54awyDYPdRiZI3O4zw6kx,SpATywNh6bZuzm8s1ceuBUnMUAeoAHHw,37,35,20,26,10,0,11,0,102,14.571428571428571,5,0.0,9,20,24,10,26,0,2,11,0,63,39,0
4176,62571,E96VmAw6m1AOHRckdqiq2ASKbnHBlpAb,SpATywNh6bZuzm8s1ceuBUnMUAeoAHHw,21,34,13,12,5,0,13,0,77,11.0,6,0.0,5,13,10,5,29,0,2,13,0,33,44,0
4177,62572,KSk9vNaHKrnc7mpW0UkB9gnAccFXKZ3t,SpATywNh6bZuzm8s1ceuBUnMUAeoAHHw,7,3,2,0,2,0,2,0,9,1.2857142857142858,1,0.0,0,2,0,2,3,0,0,2,0,4,5,1
4178,62578,Q11HqpDxrpVz5YMzRCx4zOr85dBot8E5,A3fsA9Zfv1X2fVEQhTw51lKENdNrEqT3,18,25,2,0,2,0,5,0,34,4.857142857142857,3,0.0,1,2,0,2,24,0,0,5,0,5,29,0
4179,62586,EHWtzteXxfhRPYJzgfTPSomgv9mCA5Xm,A3fsA9Zfv1X2fVEQhTw51lKENdNrEqT3,5,4,1,0,1,0,3,0,9,1.2857142857142858,1,0.0,0,1,0,1,4,0,0,3,0,2,7,1
4180,62599,TaWtI5u5Mwwhlx2CHWDc1SetqGJdEFl5,5X6FeZozNMgE2VRi3MJYjkkFK8SETtu2,4,2,1,0,1,0,1,0,5,0.7142857142857143,1,0.0,0,1,0,1,2,0,0,1,0,2,3,1
4181,62615,P18honwQPPbELUE86qFIATuZK3YDtjvG,5X6FeZozNMgE2VRi3MJYjkkFK8SETtu2,8,11,4,0,2,0,4,0,21,3.0,4,0.0,0,4,0,2,11,0,0,4,0,6,15,1
4182,62621,CO3sprBt7zms4eyX8oyF4N8qFejqwRFV,A3fsA9Zfv1X2fVEQhTw51lKENdNrEqT3,11,7,6,0,6,0,2,0,21,3.0,1,0.0,0,6,0,6,7,0,0,2,0,12,9,0
4183,62622,uU71zmfnwmq5Imjxap728hWGDmNRuuCF,SpATywNh6bZuzm8s1ceuBUnMUAeoAHHw,10,6,5,0,3,0,2,0,16,2.2857142857142856,2,0.0,0,5,0,3,6,0,0,2,0,8,8,1
4184,62633,zlsPhArkUaQ0CCdgZTO1797WJjiciHBk,SpATywNh6bZuzm8s1ceuBUnMUAeoAHHw,6,16,12,0,3,0,6,0,37,5.285714285714286,4,0.0,1,12,0,3,15,0,0,6,0,16,21,0
4185,62637,7PJjcgOQXwj0M6oz8Sxyd66Tvypm0TFY,SpATywNh6bZuzm8s1ceuBUnMUAeoAHHw,16,13,8,0,6,0,1,0,28,4.0,1,0.0,0,8,0,6,13,0,0,1,0,14,14,0
4186,62639,FQhheXDYqPnNGkMGcpToxersRXUHO59E,5X6FeZozNMgE2VRi3MJYjkkFK8SETtu2,2,0,0,0,0,0,2,0,2,0.2857142857142857,1,0.0,0,0,0,0,0,0,0,2,0,0,2,1
4187,62650,fRwQZvCpdOagdKZsrPTgO4eZ7tbF55Tm,SpATywNh6bZuzm8s1ceuBUnMUAeoAHHw,5,2,1,0,1,0,2,0,6,0.8571428571428571,1,0.0,0,1,0,1,2,0,0,2,0,2,4,1
4188,62651,zVNMq6x92zDzxLFewYkpNWI57ohFqEE9,A3fsA9Zfv1X2fVEQhTw51lKENdNrEqT3,7,3,2,0,2,0,2,0,9,1.2857142857142858,1,0.0,0,2,0,2,3,0,0,2,0,4,5,0
4189,62673,PL1LSMvKwzFrxfWucLcQyZyAiyrnjJPM,SpATywNh6bZuzm8s1ceuBUnMUAeoAHHw,8,10,3,0,3,0,3,0,19,2.7142857142857144,2,0.0,0,3,0,3,10,0,0,3,0,6,13,1
4190,62675,W7aaCFsYNegloRh1IlKOwq22jdh9r52p,5X6FeZozNMgE2VRi3MJYjkkFK8SETtu2,15,13,9,0,6,0,6,0,34,4.857142857142857,3,0.0,0,9,0,6,13,0,0,6,0,15,19,0
4191,62682,1kf9MpHbiCgoPms85eVRLEWBQo2ISdL8,bWdj2GDclj5ofokWjzoa5jAwMkxCykd6,5,2,1,0,1,0,4,0,8,1.1428571428571428,1,0.0,0,1,0,1,2,0,0,4,0,2,6,1
4192,62685,xhufFs72rOwOGZDYtQtHTXdheNyqrUTX,SpATywNh6bZuzm8s1ceuBUnMUAeoAHHw,19,18,12,5,5,0,7,0,47,6.714285714285714,3,0.0,2,12,5,5,16,0,0,7,0,24,23,0
4193,62686,DpXkrIHIAIPNESKyvFah0WhpVT5PHFeL,bWdj2GDclj5ofokWjzoa5jAwMkxCykd6,4,4,2,0,0,0,3,0,9,1.2857142857142858,1,0.0,0,2,0,0,4,0,0,3,0,2,7,1
4194,62730,HwmOe48TnHpxGJFpJY55xag3SIXvxDtW,bWdj2GDclj5ofokWjzoa5jAwMkxCykd6,1,0,0,0,0,0,1,0,1,0.14285714285714285,1,0.0,0,0,0,0,0,0,0,1,0,0,1,1
4195,62737,FHNmlUHjqfGgz0Bf1982fW5CY3mV647H,SpATywNh6bZuzm8s1ceuBUnMUAeoAHHw,15,26,14,21,6,0,6,0,73,10.428571428571429,1,0.0,6,14,17,6,20,0,4,6,0,43,30,0
4196,62738,hkI32MAgHvJ4T3I3Up79daEJ8l4sKHaC,5X6FeZozNMgE2VRi3MJYjkkFK8SETtu2,7,4,1,2,2,0,2,0,11,1.5714285714285714,1,0.0,2,1,2,2,2,0,0,2,0,7,4,1
4197,62739,CaM5OJ40UpPm5AoorpoNghXDZnct2Zfn,SpATywNh6bZuzm8s1ceuBUnMUAeoAHHw,9,15,7,0,3,1,3,0,29,4.142857142857143,2,0.0,2,7,0,3,13,1,0,3,0,12,17,1
4198,62752,GKJr5PPNFb6sbmwmK3Q19sOuk5TaY1oJ,SpATywNh6bZuzm8s1ceuBUnMUAeoAHHw,4,3,1,0,0,0,2,0,6,0.8571428571428571,1,0.0,0,1,0,0,3,0,0,2,0,1,5,1
4199,62756,rn8AvGrYTXmz2EJDIFn9QybnzSd0klef,A3fsA9Zfv1X2fVEQhTw51lKENdNrEqT3,1,0,0,0,0,0,1,0,1,0.14285714285714285,1,0.0,0,0,0,0,0,0,0,1,0,0,1,1
4200,62761,yfEYs1l7yxStwsdpgK6SIUUGtvFFQgxO,5X6FeZozNMgE2VRi3MJYjkkFK8SETtu2,20,46,7,9,23,1,8,4,98,14.0,4,0.0,37,7,9,23,9,1,0,8,4,76,22,1
4201,62764,XsK920toyXvpWwNS6lvZzDVJcrgCTFKd,SpATywNh6bZuzm8s1ceuBUnMUAeoAHHw,12,9,7,0,4,0,1,0,21,3.0,1,0.0,0,7,0,4,9,0,0,1,0,11,10,0
4202,62769,Y3Qq9FqOVwUj6PrB3KNsrLngzeSzadt5,A3fsA9Zfv1X2fVEQhTw51lKENdNrEqT3,1,0,0,0,0,0,1,0,1,0.14285714285714285,1,0.0,0,0,0,0,0,0,0,1,0,0,1,1
4203,62770,TqLkmogP9A8wj7y0peV7PS3deY5AXfKI,5X6FeZozNMgE2VRi3MJYjkkFK8SETtu2,1,0,0,0,0,0,1,0,1,0.14285714285714285,1,0.0,0,0,0,0,0,0,0,1,0,0,1,1
4204,62774,jccfrbjOfPTUO9oDFonSJAjYRAHbe3jz,SpATywNh6bZuzm8s1ceuBUnMUAeoAHHw,8,5,3,0,2,0,6,0,16,2.2857142857142856,1,0.0,0,3,0,2,5,0,0,6,0,5,11,0
4205,62778,w5f3SCso3vkK2wUsopN9cXi6es2y9wa9,SpATywNh6bZuzm8s1ceuBUnMUAeoAHHw,6,3,1,0,0,0,3,1,8,1.1428571428571428,1,0.0,0,1,0,0,3,0,0,3,1,1,7,1
4206,62785,M7hDuaWvzRtPysMPuLiwkaKPgvCGqMeN,bWdj2GDclj5ofokWjzoa5jAwMkxCykd6,8,2,0,0,1,1,8,3,15,2.142857142857143,1,0.0,0,0,0,1,2,1,0,8,3,1,14,1
4207,62805,LJYBef7iIBiSZz8D7KTtMTsdkyd91gnR,A3fsA9Zfv1X2fVEQhTw51lKENdNrEqT3,49,28,21,68,13,0,5,0,135,19.285714285714285,4,0.0,1,21,61,13,27,0,7,5,0,96,39,1
4208,62806,baIBGHksBqEhi8cV6mSaiIUAZMUNWNoH,bWdj2GDclj5ofokWjzoa5jAwMkxCykd6,7,11,6,0,1,2,10,0,30,4.285714285714286,1,0.0,0,6,0,1,11,2,0,10,0,7,23,0
4209,62809,EEgHvStGR7XKoMKoPOCBxkxFHcb7UdMh,SpATywNh6bZuzm8s1ceuBUnMUAeoAHHw,5,13,7,0,0,0,7,0,27,3.857142857142857,4,0.0,0,7,0,0,13,0,0,7,0,7,20,0
4210,62813,reVwvLtud5XxET1iG7iTTQOqQC7njl8h,SpATywNh6bZuzm8s1ceuBUnMUAeoAHHw,46,51,45,2,33,0,8,0,139,19.857142857142858,3,0.0,1,45,2,33,50,0,0,8,0,81,58,0
4211,62819,zn2X74vvqUQRINz90WjZLsSsFglpYr7o,SpATywNh6bZuzm8s1ceuBUnMUAeoAHHw,8,7,6,0,4,0,5,0,22,3.142857142857143,2,0.0,0,6,0,4,7,0,0,5,0,10,12,1
4212,62823,z7VHnpzigmVh7wBxUgytC06GpTDQHeLr,SpATywNh6bZuzm8s1ceuBUnMUAeoAHHw,4,4,3,0,3,0,1,0,11,1.5714285714285714,1,0.0,0,3,0,3,4,0,0,1,0,6,5,0
4213,62837,k4ieA0VLPLUG1GV8FhtBGpWAykZRhHXI,7GRhBDsirIGkRZBtSMEzNTyDr2JQm4xx,3,2,1,0,0,0,1,0,4,0.5714285714285714,1,0.0,0,1,0,0,2,0,0,1,0,1,3,1
4214,62868,Z5Dgq02GJZwP1I2fvmHLkqgiztGyQl0J,SpATywNh6bZuzm8s1ceuBUnMUAeoAHHw,21,16,6,28,0,20,5,4,79,11.285714285714286,1,0.0,8,6,27,0,8,20,1,5,4,41,38,1
4215,62873,lo9vHqgfDG1UEcho8eZgahljlKaQ2l9G,bWdj2GDclj5ofokWjzoa5jAwMkxCykd6,9,3,1,18,1,0,8,0,31,4.428571428571429,1,0.0,1,1,17,1,2,0,1,8,0,20,11,0
4216,62879,YzrG8hkWHsWBnejqfVSQT69MsrfeFNO4,SpATywNh6bZuzm8s1ceuBUnMUAeoAHHw,1,0,0,0,0,0,1,0,1,0.14285714285714285,1,0.0,0,0,0,0,0,0,0,1,0,0,1,1
4217,62882,uNvVk5ZxKLJZf61FQYrSSEMvIvy0EL4b,SpATywNh6bZuzm8s1ceuBUnMUAeoAHHw,11,7,4,0,3,0,2,0,16,2.2857142857142856,2,0.0,0,4,0,3,7,0,0,2,0,7,9,1
4218,62884,gv12mj7TYLo5OX6vjchegr74v64uwg6T,bWdj2GDclj5ofokWjzoa5jAwMkxCykd6,1,0,0,0,0,0,1,0,1,0.14285714285714285,1,0.0,0,0,0,0,0,0,0,1,0,0,1,1
4219,62885,3woJp7iHTbi0jGvMsKVmiaEnMujLv8R8,A3fsA9Zfv1X2fVEQhTw51lKENdNrEqT3,20,27,12,0,8,6,10,1,64,9.142857142857142,2,0.0,0,12,0,8,27,6,0,10,1,20,44,1
4220,62895,A30ldvcZzMcGBRvQ5EfE4QUuIq2OYLGK,SpATywNh6bZuzm8s1ceuBUnMUAeoAHHw,14,15,6,19,3,0,3,0,46,6.571428571428571,1,0.0,6,6,16,3,9,0,3,3,0,31,15,1
4221,62911,KwjYZWNYzBofNYG8mRoeOhYNpisNnTvM,SpATywNh6bZuzm8s1ceuBUnMUAeoAHHw,1,0,0,0,0,0,2,0,2,0.2857142857142857,1,0.0,0,0,0,0,0,0,0,2,0,0,2,1
4222,62913,VnWhM3BeDRhDK8eiBuMGZHGyfJnGv0sM,SpATywNh6bZuzm8s1ceuBUnMUAeoAHHw,28,30,9,25,7,0,9,1,81,11.571428571428571,2,0.0,4,9,21,7,26,0,4,9,1,41,40,1
4223,62915,sOkc0wEXSSLpxtxlqjZObJqg94IyLpuY,5X6FeZozNMgE2VRi3MJYjkkFK8SETtu2,6,8,1,0,0,0,2,0,11,1.5714285714285714,1,0.0,3,1,0,0,5,0,0,2,0,4,7,1
4224,62925,S6pyc72qK2lqlFxsAUiWhEvowKWj4Fmg,SpATywNh6bZuzm8s1ceuBUnMUAeoAHHw,5,2,0,0,1,0,3,0,6,0.8571428571428571,1,0.0,0,0,0,1,2,0,0,3,0,1,5,0
4225,62927,e3zKHlvslzm6unuvuFVFRMmvFxyH5DET,bWdj2GDclj5ofokWjzoa5jAwMkxCykd6,1,0,0,0,0,0,1,0,1,0.14285714285714285,1,0.0,0,0,0,0,0,0,0,1,0,0,1,1
4226,62928,lFMbkCaY0FKfyGbh1VOL30jTZ1USVgB2,A3fsA9Zfv1X2fVEQhTw51lKENdNrEqT3,25,18,14,10,11,0,6,0,59,8.428571428571429,2,0.0,0,14,10,11,18,0,0,6,0,35,24,0
4227,62937,JJDRXXLRU75H8Dx2cuK7Td1V7D7QoKg9,bWdj2GDclj5ofokWjzoa5jAwMkxCykd6,6,12,0,0,1,0,7,0,20,2.857142857142857,2,0.0,3,0,0,1,9,0,0,7,0,4,16,0
4228,62944,NLLJQp9UUSoaM0rH4iw5IExuDzB3QzHc,SpATywNh6bZuzm8s1ceuBUnMUAeoAHHw,1,0,0,0,0,0,1,0,1,0.14285714285714285,1,0.0,0,0,0,0,0,0,0,1,0,0,1,1
4229,62945,psUY0jMEvxZuoP9UKA82E9maLgW6I63x,SpATywNh6bZuzm8s1ceuBUnMUAeoAHHw,12,12,1,0,1,0,3,0,17,2.4285714285714284,1,0.0,0,1,0,1,12,0,0,3,0,2,15,0
4230,62957,iugl3Rn3u1ci3BiC2tfekDHOQsD5QVGj,bWdj2GDclj5ofokWjzoa5jAwMkxCykd6,25,48,33,30,11,0,12,0,134,19.142857142857142,4,0.0,9,33,24,11,39,0,6,12,0,77,57,0
4231,62967,3blAUsZiu4FW1Jp6vOBSuHfrNCEPv1lZ,A3fsA9Zfv1X2fVEQhTw51lKENdNrEqT3,16,31,2,0,1,0,12,0,46,6.571428571428571,3,0.0,0,2,0,1,31,0,0,12,0,3,43,1
4232,62968,jkLf5s9Tdb22fUhtxgRjd7TDlKmc2OGK,5X6FeZozNMgE2VRi3MJYjkkFK8SETtu2,28,30,8,83,13,6,6,2,148,21.142857142857142,3,0.0,19,8,68,13,11,6,15,6,2,108,40,1
4233,62975,fV0W6675p3fpyY1tGNGM2NdIFpKgGWLW,SpATywNh6bZuzm8s1ceuBUnMUAeoAHHw,6,6,4,0,0,3,2,0,15,2.142857142857143,2,0.0,0,4,0,0,6,3,0,2,0,4,11,0
4234,62980,MH2dufcdc5plwSw55pPAPhNOJ4cLMg4S,A3fsA9Zfv1X2fVEQhTw51lKENdNrEqT3,1,0,0,0,0,0,1,0,1,0.14285714285714285,1,0.0,0,0,0,0,0,0,0,1,0,0,1,1
4235,62984,8ObpbvAiGmvYrSKfJWLgd5tWjdqZp8vX,SpATywNh6bZuzm8s1ceuBUnMUAeoAHHw,18,19,9,11,5,1,5,1,51,7.285714285714286,2,0.0,7,9,10,5,12,1,1,5,1,31,20,0
4236,62999,JFnonbrySwtMlSqTfY5pp3MQd3sPiIYz,bWdj2GDclj5ofokWjzoa5jAwMkxCykd6,70,49,24,182,12,45,17,4,333,47.57142857142857,3,0.0,14,24,149,12,35,45,33,17,4,199,134,0
4237,63000,qMIYVG4oQ2FTHHjmoLKypRdKRuC5AfVw,SpATywNh6bZuzm8s1ceuBUnMUAeoAHHw,5,2,1,0,1,3,4,0,11,1.5714285714285714,1,0.0,0,1,0,1,2,3,0,4,0,2,9,1
4238,63012,dNinMzvnUI72XIboKkbVFVTrZjj6iw1l,SpATywNh6bZuzm8s1ceuBUnMUAeoAHHw,1,0,0,0,0,0,1,0,1,0.14285714285714285,1,0.0,0,0,0,0,0,0,0,1,0,0,1,1
4239,63013,GAibePvSMp9STM46ehplfCoY7z7zhgo4,5X6FeZozNMgE2VRi3MJYjkkFK8SETtu2,16,33,2,17,10,0,4,1,67,9.571428571428571,2,0.0,26,2,12,10,7,0,5,4,1,50,17,0
4240,63022,aGKf0W7DbO5pZNcjJ5sGrg9jyzAmLXkB,SpATywNh6bZuzm8s1ceuBUnMUAeoAHHw,7,6,5,0,3,0,2,0,16,2.2857142857142856,1,0.0,0,5,0,3,6,0,0,2,0,8,8,0
4241,63029,uuBww6mp7aLC6vKEZ8cAu2A6VCMt4RtS,A3fsA9Zfv1X2fVEQhTw51lKENdNrEqT3,13,6,4,0,2,0,8,1,21,3.0,2,0.0,0,4,0,2,6,0,0,8,1,6,15,1
4242,63030,6izQCEneEK1X6C1taxn0XENXkSv3cl84,SpATywNh6bZuzm8s1ceuBUnMUAeoAHHw,1,0,0,0,0,0,1,0,1,0.14285714285714285,1,0.0,0,0,0,0,0,0,0,1,0,0,1,1
4243,63040,2YtScMMDlxOx1tCYRwqHIeB1EPIbtkoW,A3fsA9Zfv1X2fVEQhTw51lKENdNrEqT3,16,13,1,0,1,0,12,1,28,4.0,2,0.0,1,1,0,1,12,0,0,12,1,3,25,1
4244,63048,OO2Ag6HEFKkZRtZuzzt1ya8SiL4BLCOC,bWdj2GDclj5ofokWjzoa5jAwMkxCykd6,19,7,5,40,1,0,7,0,60,8.571428571428571,1,0.0,0,5,40,1,7,0,0,7,0,46,14,0
4245,63056,L6bCWveyHz41t3spRecuTvoTMpDuSMwv,SpATywNh6bZuzm8s1ceuBUnMUAeoAHHw,9,7,0,2,0,2,2,0,13,1.8571428571428572,1,0.0,0,0,2,0,7,2,0,2,0,2,11,0
4246,63076,VX0Y1hntiHf9WXSFg6clUWcthaOv0uSF,SpATywNh6bZuzm8s1ceuBUnMUAeoAHHw,3,0,0,0,0,0,3,0,3,0.42857142857142855,1,0.0,0,0,0,0,0,0,0,3,0,0,3,1
4247,63099,WYoMb9pjSPIkNMKnbh6vDtB0LRCn2aRR,bWdj2GDclj5ofokWjzoa5jAwMkxCykd6,4,2,1,0,0,0,2,0,5,0.7142857142857143,1,0.0,0,1,0,0,2,0,0,2,0,1,4,1
4248,63101,ylWFzVpNQAo4ibGT55iIYAAAd3NRBVw1,A3fsA9Zfv1X2fVEQhTw51lKENdNrEqT3,1,0,0,0,0,0,1,0,1,0.14285714285714285,1,0.0,0,0,0,0,0,0,0,1,0,0,1,1
4249,63112,Uii99HGTZ00iRAn85JVms9bIGm6Sf0Gn,5X6FeZozNMgE2VRi3MJYjkkFK8SETtu2,1,0,0,0,0,0,1,0,1,0.14285714285714285,1,0.0,0,0,0,0,0,0,0,1,0,0,1,0
4250,63116,BvCRPlMfMau2kDEBEjyV1l6RJMQy5B5l,SpATywNh6bZuzm8s1ceuBUnMUAeoAHHw,20,26,12,39,0,1,7,0,85,12.142857142857142,2,0.0,12,12,36,0,14,1,3,7,0,60,25,0
4251,63126,8nlNDsWSaxHCvsMKtqhBs81sknEiTCeb,bWdj2GDclj5ofokWjzoa5jAwMkxCykd6,22,17,13,0,10,0,3,0,43,6.142857142857143,3,0.0,1,13,0,10,16,0,0,3,0,24,19,0
4252,63128,5uO2cAopKsWa3VCKCGDarnhTzdurYycs,SpATywNh6bZuzm8s1ceuBUnMUAeoAHHw,17,15,9,9,6,0,3,0,42,6.0,3,0.0,4,9,8,6,11,0,1,3,0,27,15,0
4253,63131,6soSIDwrJrHtOwhrrHwhMkHLJvUycuiD,SpATywNh6bZuzm8s1ceuBUnMUAeoAHHw,5,3,1,0,1,0,1,0,6,0.8571428571428571,1,0.0,0,1,0,1,3,0,0,1,0,2,4,1
4254,63135,qqsKaxuXSxP1f8916mpMwrS7CvZrqfwm,bWdj2GDclj5ofokWjzoa5jAwMkxCykd6,6,6,0,0,0,0,2,0,8,1.1428571428571428,1,0.0,0,0,0,0,6,0,0,2,0,0,8,1
4255,63143,oE1QbspE1VaPia0G9CbmnflG7dN6cZJM,bWdj2GDclj5ofokWjzoa5jAwMkxCykd6,1,0,0,0,0,0,1,0,1,0.14285714285714285,1,0.0,0,0,0,0,0,0,0,1,0,0,1,1
4256,63144,Uf8FY0gZoVytp6K7SsDRXVZeOCL2hDEX,A3fsA9Zfv1X2fVEQhTw51lKENdNrEqT3,5,7,4,0,0,2,3,0,16,2.2857142857142856,2,0.0,0,4,0,0,7,2,0,3,0,4,12,1
4257,63157,6iyCCTAEdDUFtgP0yXcCVROgqrKuAsJY,A3fsA9Zfv1X2fVEQhTw51lKENdNrEqT3,1,0,0,0,0,0,1,0,1,0.14285714285714285,1,0.0,0,0,0,0,0,0,0,1,0,0,1,1
4258,63158,U24ZSbLp0qd6U36m7tKLx7zFvStnoEpw,A3fsA9Zfv1X2fVEQhTw51lKENdNrEqT3,5,5,3,0,1,0,3,0,12,1.7142857142857142,1,0.0,0,3,0,1,5,0,0,3,0,4,8,1
4259,63159,u0QxgU6zGWMbarsYWmtzCygq7j38M60A,5X6FeZozNMgE2VRi3MJYjkkFK8SETtu2,8,4,3,0,2,0,6,0,15,2.142857142857143,1,0.0,0,3,0,2,4,0,0,6,0,5,10,1
4260,63165,lECqbqrkQ3HlfeNWRN0jqJEeRHxVUCOh,A3fsA9Zfv1X2fVEQhTw51lKENdNrEqT3,15,7,7,0,7,0,2,0,23,3.2857142857142856,1,0.0,0,7,0,7,7,0,0,2,0,14,9,1
4261,63215,TyFg3KPXG2hfujUtXeVIkYJiwq6NnB4U,A3fsA9Zfv1X2fVEQhTw51lKENdNrEqT3,2,0,0,0,0,0,2,0,2,0.2857142857142857,1,0.0,0,0,0,0,0,0,0,2,0,0,2,0
4262,63233,MvNnLQma2eBM9bCcMIR159XYSNp8VREs,A3fsA9Zfv1X2fVEQhTw51lKENdNrEqT3,18,17,11,63,6,13,6,0,116,16.571428571428573,4,0.0,0,11,54,6,17,13,9,6,0,71,45,0
4263,63308,nvARqsoei1VE7ACdygyy6zqJeJH2Ns3d,5X6FeZozNMgE2VRi3MJYjkkFK8SETtu2,22,21,3,0,16,0,4,1,45,6.428571428571429,1,0.0,17,3,0,16,4,0,0,4,1,36,9,1
4264,63324,0qbWIMzrwjcZydLWs8mxTmhu7QXiYFSP,A3fsA9Zfv1X2fVEQhTw51lKENdNrEqT3,7,3,2,0,2,0,3,0,10,1.4285714285714286,1,0.0,0,2,0,2,3,0,0,3,0,4,6,1
4265,63328,BkozGGotFoRWvs7kivTQvwwV5JZ8hddc,A3fsA9Zfv1X2fVEQhTw51lKENdNrEqT3,8,9,2,0,2,0,2,0,15,2.142857142857143,2,0.0,0,2,0,2,9,0,0,2,0,4,11,0
4266,63344,pxvZPop6eUfNSRIk3XGIXLwhqmGee9n7,A3fsA9Zfv1X2fVEQhTw51lKENdNrEqT3,11,7,6,0,5,0,3,0,21,3.0,1,0.0,0,6,0,5,7,0,0,3,0,11,10,1
4267,63459,DbJ2fWeAP98RKGycV2m76nmSvYzZUwMu,A3fsA9Zfv1X2fVEQhTw51lKENdNrEqT3,1,0,0,0,0,0,1,0,1,0.14285714285714285,1,0.0,0,0,0,0,0,0,0,1,0,0,1,1
4268,63464,DIQ2cAHWjYXUFJyw27IkZyxU8J2LbFhM,A3fsA9Zfv1X2fVEQhTw51lKENdNrEqT3,7,3,2,0,2,0,4,0,11,1.5714285714285714,1,0.0,0,2,0,2,3,0,0,4,0,4,7,1
4269,63491,d5V0InJeymvV3tMA3RbiAnJILSNsmv66,A3fsA9Zfv1X2fVEQhTw51lKENdNrEqT3,7,3,1,0,1,1,6,0,12,1.7142857142857142,1,0.0,0,1,0,1,3,1,0,6,0,2,10,1
4270,63492,VbEvpztD3t9yxnslq9RFoJwCqkpqqcHm,A3fsA9Zfv1X2fVEQhTw51lKENdNrEqT3,2,0,0,0,0,0,2,0,2,0.2857142857142857,1,0.0,0,0,0,0,0,0,0,2,0,0,2,1
4271,63541,kq2xSgp8UyUnYWtPUU1dLGJ6LLqx20W2,A3fsA9Zfv1X2fVEQhTw51lKENdNrEqT3,9,14,9,2,0,1,9,0,35,5.0,2,0.0,1,9,2,0,13,1,0,9,0,12,23,0
4272,63571,EwaALzeaojV7pPZOsHFx7jzB7xjVDGvQ,A3fsA9Zfv1X2fVEQhTw51lKENdNrEqT3,13,12,4,0,4,0,5,1,26,3.7142857142857144,1,0.0,0,4,0,4,12,0,0,5,1,8,18,1
4273,63579,WaJ13sIQFvbAmwEOGfYhYy9jgF2vI8GT,A3fsA9Zfv1X2fVEQhTw51lKENdNrEqT3,8,6,3,0,1,0,6,1,17,2.4285714285714284,1,0.0,0,3,0,1,6,0,0,6,1,4,13,1
4274,63583,CLsYy7g1hYWHJyj1aROfKK9oTeo5yxJx,7GRhBDsirIGkRZBtSMEzNTyDr2JQm4xx,14,17,3,0,7,0,3,0,30,4.285714285714286,1,0.0,6,3,0,7,11,0,0,3,0,16,14,1
4275,63585,Hv22dFoxkFI4yq44orETwHESFuBEtOPQ,A3fsA9Zfv1X2fVEQhTw51lKENdNrEqT3,2,0,0,0,0,0,2,0,2,0.2857142857142857,1,0.0,0,0,0,0,0,0,0,2,0,0,2,1
4276,63591,qJUbI5BkvqMbHBHrzo94tR25I8rTeAje,A3fsA9Zfv1X2fVEQhTw51lKENdNrEqT3,2,0,0,0,0,0,5,0,5,0.7142857142857143,2,0.0,0,0,0,0,0,0,0,5,0,0,5,1
4277,63593,KNf8lqR4KQcQVf1nb3UW38BlYtlHOqrY,A3fsA9Zfv1X2fVEQhTw51lKENdNrEqT3,5,7,4,0,2,0,0,0,13,1.8571428571428572,1,0.0,0,4,0,2,7,0,0,0,0,6,7,0
4278,63599,UOssUZDJcaoIiaAH8nTbzjrXIWUHSQSA,A3fsA9Zfv1X2fVEQhTw51lKENdNrEqT3,47,19,16,58,11,0,3,0,107,15.285714285714286,1,0.0,1,16,58,11,18,0,0,3,0,86,21,0
4279,63609,1tgzEFnyDV9hzcUXSbdwhJOg2vheOekT,A3fsA9Zfv1X2fVEQhTw51lKENdNrEqT3,5,3,1,0,1,0,2,0,7,1.0,1,0.0,0,1,0,1,3,0,0,2,0,2,5,1
4280,63635,YdulDnem4l1DSLhP0wDFvDj53pxIZEBX,5X6FeZozNMgE2VRi3MJYjkkFK8SETtu2,4,2,0,0,0,0,2,0,4,0.5714285714285714,1,0.0,0,0,0,0,2,0,0,2,0,0,4,1
4281,63661,kNcE6GSdHEQgruLMOEFRn2X0xyKoI8Gk,A3fsA9Zfv1X2fVEQhTw51lKENdNrEqT3,8,3,2,0,2,1,3,1,12,1.7142857142857142,1,0.0,0,2,0,2,3,1,0,3,1,4,8,0
4282,63713,DedOVhQ90meYxq6Misau3AEJ23SFBM8N,A3fsA9Zfv1X2fVEQhTw51lKENdNrEqT3,22,4,3,62,0,0,5,0,74,10.571428571428571,1,0.0,0,3,58,0,4,0,4,5,0,61,13,1
4283,63717,tEGUB4A2P1CFVrtUpVRZCuET3K7QndSr,A3fsA9Zfv1X2fVEQhTw51lKENdNrEqT3,6,2,1,0,1,0,3,0,7,1.0,1,0.0,0,1,0,1,2,0,0,3,0,2,5,1
4284,63719,RPsysYLHG9V8ibC4agPmUkz49odzJ61i,A3fsA9Zfv1X2fVEQhTw51lKENdNrEqT3,62,47,1,136,0,0,5,0,189,27.0,3,0.0,2,1,121,0,45,0,15,5,0,124,65,0
4285,63721,KXPsJNzb3MNK5rxQc94IXJdmXF0ziWwA,A3fsA9Zfv1X2fVEQhTw51lKENdNrEqT3,15,24,11,0,5,0,12,0,52,7.428571428571429,3,0.0,0,11,0,5,24,0,0,12,0,16,36,0
4286,63735,ECsVHkALFzk1X2uOxQI4vWaYz6Q2nfDW,A3fsA9Zfv1X2fVEQhTw51lKENdNrEqT3,1,0,0,0,0,0,1,0,1,0.14285714285714285,1,0.0,0,0,0,0,0,0,0,1,0,0,1,0
4287,63743,CQ7W1bUjrd2ieiBxuOygArXf04qfadoR,A3fsA9Zfv1X2fVEQhTw51lKENdNrEqT3,2,0,0,0,0,0,2,0,2,0.2857142857142857,1,0.0,0,0,0,0,0,0,0,2,0,0,2,1
4288,63766,2oTvbzieHn2y5oozeOgSnruqE6N0BtR5,A3fsA9Zfv1X2fVEQhTw51lKENdNrEqT3,15,10,7,0,5,6,2,0,30,4.285714285714286,1,0.0,1,7,0,5,9,6,0,2,0,13,17,1
4289,63863,cgTUwLEE5PIWea85qZ4m3A5o29rDp7wb,5X6FeZozNMgE2VRi3MJYjkkFK8SETtu2,6,0,0,0,0,1,5,1,7,1.0,1,0.0,0,0,0,0,0,1,0,5,1,0,7,1
4290,63866,T7jegaLU73gmMgJ6osvv16CDGIDooSd3,A3fsA9Zfv1X2fVEQhTw51lKENdNrEqT3,1,0,0,0,0,0,1,0,1,0.14285714285714285,1,0.0,0,0,0,0,0,0,0,1,0,0,1,1
4291,63868,5Dk7QJtqh7ATnN1jDaFE4dN4E1GugvAr,A3fsA9Zfv1X2fVEQhTw51lKENdNrEqT3,13,7,6,0,5,0,1,0,19,2.7142857142857144,1,0.0,0,6,0,5,7,0,0,1,0,11,8,1
4292,63906,bBmyT6TanupXnnAek0TJ3b0HfJIXbuOY,A3fsA9Zfv1X2fVEQhTw51lKENdNrEqT3,2,0,0,0,0,0,4,0,4,0.5714285714285714,1,0.0,0,0,0,0,0,0,0,4,0,0,4,1
4293,63959,QZsedNDdPfnk94fBJk0YmSDWyLPfZv2T,A3fsA9Zfv1X2fVEQhTw51lKENdNrEqT3,1,0,0,0,0,0,1,0,1,0.14285714285714285,1,0.0,0,0,0,0,0,0,0,1,0,0,1,1
4294,63983,53qrF6M0dMx7kKnOiKvVv5yJevXuY3XD,5X6FeZozNMgE2VRi3MJYjkkFK8SETtu2,26,20,6,28,12,0,4,0,70,10.0,2,0.0,12,6,22,12,8,0,6,4,0,52,18,1
4295,64025,VmlXkvuP00sXBlaPmnRadtsHqWz5E4fz,7GRhBDsirIGkRZBtSMEzNTyDr2JQm4xx,37,166,39,44,24,12,8,0,293,41.857142857142854,6,0.0,63,39,30,24,103,12,14,8,0,156,137,0
4296,64036,4dC723f2ZXGHBwWoh8xH8B5ftd5Zr0Rn,A3fsA9Zfv1X2fVEQhTw51lKENdNrEqT3,5,7,1,0,1,0,2,0,11,1.5714285714285714,2,0.0,0,1,0,1,7,0,0,2,0,2,9,1
4297,64050,i0zkZjQmNkaA9MaOL5qmrA42E822EXRd,A3fsA9Zfv1X2fVEQhTw51lKENdNrEqT3,9,16,8,0,4,0,4,0,32,4.571428571428571,1,0.0,2,8,0,4,14,0,0,4,0,14,18,1
4298,64095,RtFjOHQ78yo3bQ6aRAVmoLevb4Ve3GxB,A3fsA9Zfv1X2fVEQhTw51lKENdNrEqT3,1,0,0,0,0,0,1,0,1,0.14285714285714285,1,0.0,0,0,0,0,0,0,0,1,0,0,1,0
4299,64102,kt21fnWwjm6f9DEs5cQgmHF7wEsSCJjC,5X6FeZozNMgE2VRi3MJYjkkFK8SETtu2,4,2,0,0,0,0,3,0,5,0.7142857142857143,1,0.0,0,0,0,0,2,0,0,3,0,0,5,1
4300,64113,EVGpdajso7QxNR24Ui7ldtFyj6uWtpYs,7GRhBDsirIGkRZBtSMEzNTyDr2JQm4xx,11,13,4,2,4,0,1,0,24,3.4285714285714284,1,0.0,4,4,1,4,9,0,1,1,0,13,11,1
4301,64130,8fEd87RyI2bwi77a0f1unb4dfVmT9VZV,5X6FeZozNMgE2VRi3MJYjkkFK8SETtu2,11,12,1,0,0,0,6,1,20,2.857142857142857,1,0.0,0,1,0,0,12,0,0,6,1,1,19,1
4302,64140,Kn2cw1zCeCwQaG81MHzo9gNVv9guOBXK,A3fsA9Zfv1X2fVEQhTw51lKENdNrEqT3,3,0,0,0,0,7,4,0,11,1.5714285714285714,1,0.0,0,0,0,0,0,7,0,4,0,0,11,1
4303,64142,as5VymGJtrKzsVSyPlhaHLjXcgFKhbSH,A3fsA9Zfv1X2fVEQhTw51lKENdNrEqT3,1,0,0,0,0,0,1,0,1,0.14285714285714285,1,0.0,0,0,0,0,0,0,0,1,0,0,1,1
4304,64156,D1WRmyOZhQRwAt1t1iTB3PMrgAYapw75,A3fsA9Zfv1X2fVEQhTw51lKENdNrEqT3,7,3,2,0,2,0,2,0,9,1.2857142857142858,1,0.0,0,2,0,2,3,0,0,2,0,4,5,0
4305,64176,5DIcniD9kRbDupVPBNugV5by0SZHtD2e,5X6FeZozNMgE2VRi3MJYjkkFK8SETtu2,2,0,0,0,0,0,6,0,6,0.8571428571428571,2,0.0,0,0,0,0,0,0,0,6,0,0,6,0
4306,64177,SSM7wEvdZo8FZW0zxJcXGwdA1S6Vbn5Q,A3fsA9Zfv1X2fVEQhTw51lKENdNrEqT3,19,12,9,0,7,0,2,0,30,4.285714285714286,2,0.0,0,9,0,7,12,0,0,2,0,16,14,1
4307,64181,dyoINQ9hlelfXhGgA7SokU45MaV6r2b8,A3fsA9Zfv1X2fVEQhTw51lKENdNrEqT3,2,0,0,0,0,0,2,0,2,0.2857142857142857,1,0.0,0,0,0,0,0,0,0,2,0,0,2,1
4308,64227,vG3M5JLO0gRotnItxOh8CvNNDagvaG8a,3VkHkmOtom3jM2wCu94xgzzu1d6Dn7or,1,0,0,0,0,0,1,0,1,0.14285714285714285,1,0.0,0,0,0,0,0,0,0,1,0,0,1,1
4309,64233,42YCKn2Ek3uQFTd64udo36R8aXuDsTjU,3VkHkmOtom3jM2wCu94xgzzu1d6Dn7or,11,6,4,0,3,0,23,1,37,5.285714285714286,2,0.0,0,4,0,3,6,0,0,23,1,7,30,1
4310,64245,GaqZRaDmjqTJL7sJbhIxHxwz67bGCYvi,3VkHkmOtom3jM2wCu94xgzzu1d6Dn7or,21,57,12,15,11,10,7,0,112,16.0,6,0.0,15,12,12,11,42,10,3,7,0,50,62,1
4311,64261,0k4CvTlW0Ki9TqpnhbL5aydIJGDeyaVi,3VkHkmOtom3jM2wCu94xgzzu1d6Dn7or,1,0,0,0,0,0,1,0,1,0.14285714285714285,1,0.0,0,0,0,0,0,0,0,1,0,0,1,1
4312,64282,5XeGbjtO9ZpHcMDPUljamexTzJj8TT7H,3VkHkmOtom3jM2wCu94xgzzu1d6Dn7or,7,11,2,0,2,0,3,0,18,2.5714285714285716,1,0.0,0,2,0,2,11,0,0,3,0,4,14,1
4313,64307,cYevHiCgyQphB5TqHdaxuD82gdFcsuo3,3VkHkmOtom3jM2wCu94xgzzu1d6Dn7or,9,12,4,0,2,2,11,1,32,4.571428571428571,1,0.0,3,4,0,2,9,2,0,11,1,9,23,1
4314,64312,n2St1YMqHrqzcJGG4eNYjjSajfpOnhDK,3VkHkmOtom3jM2wCu94xgzzu1d6Dn7or,1,0,0,0,0,0,1,0,1,0.14285714285714285,1,0.0,0,0,0,0,0,0,0,1,0,0,1,1
4315,64358,dqSfWCCLLdDoawrlG8LB6YtjPp851gTf,3VkHkmOtom3jM2wCu94xgzzu1d6Dn7or,60,74,36,9,32,2,14,0,167,23.857142857142858,9,0.0,20,36,9,32,54,2,0,14,0,97,70,1
4316,64367,uMq806nlQZ11Soe4JXPvVomaqEq8wpzS,3VkHkmOtom3jM2wCu94xgzzu1d6Dn7or,6,4,2,0,1,0,5,0,12,1.7142857142857142,1,0.0,0,2,0,1,4,0,0,5,0,3,9,1
4317,64410,TvGN18RRCa0ZkjqJAXD9aJ8uRfrq7SIN,3VkHkmOtom3jM2wCu94xgzzu1d6Dn7or,4,2,0,0,0,0,2,0,4,0.5714285714285714,1,0.0,0,0,0,0,2,0,0,2,0,0,4,1
4318,64438,mmsDJElioYpl5eQ7bq0CkG0zfpNNAZR1,3VkHkmOtom3jM2wCu94xgzzu1d6Dn7or,3,3,0,0,0,0,1,0,4,0.5714285714285714,1,0.0,0,0,0,0,3,0,0,1,0,0,4,1
4319,64471,O3F8lLfHLYapLPkEvSdAfSwSBCUUJfWK,3VkHkmOtom3jM2wCu94xgzzu1d6Dn7or,6,4,2,0,1,0,4,0,11,1.5714285714285714,2,0.0,0,2,0,1,4,0,0,4,0,3,8,1
4320,64518,CwmPG2drWGl9ALMZkxrKTV2gZqZEfFHE,3VkHkmOtom3jM2wCu94xgzzu1d6Dn7or,1,0,0,0,0,0,1,0,1,0.14285714285714285,1,0.0,0,0,0,0,0,0,0,1,0,0,1,1
4321,64533,xLuYLWXPTcFb9iRSrRAYjniXRvqBP99N,3VkHkmOtom3jM2wCu94xgzzu1d6Dn7or,1,0,0,0,0,0,1,0,1,0.14285714285714285,1,0.0,0,0,0,0,0,0,0,1,0,0,1,1
4322,64553,mokiIB7Q2Z6eHJ3DGx9f2taiL5liYirz,3VkHkmOtom3jM2wCu94xgzzu1d6Dn7or,81,351,36,89,44,3,64,0,587,83.85714285714286,12,0.0,141,36,80,44,210,3,9,64,0,301,286,0
4323,64560,61HPKOhG7Es91f38AHmMRZoNZFhDszNT,3VkHkmOtom3jM2wCu94xgzzu1d6Dn7or,1,0,0,0,0,0,1,0,1,0.14285714285714285,1,0.0,0,0,0,0,0,0,0,1,0,0,1,1
4324,64567,e6wP3becPmfG6HGdByUW00ZFxRLgAmgY,3VkHkmOtom3jM2wCu94xgzzu1d6Dn7or,3,3,1,0,0,0,2,0,6,0.8571428571428571,1,0.0,0,1,0,0,3,0,0,2,0,1,5,1
4325,64584,QQOQ1mBFT0hbDG4vhxUnw8WQ7hq3XsN0,3VkHkmOtom3jM2wCu94xgzzu1d6Dn7or,10,7,3,0,2,0,5,0,17,2.4285714285714284,3,0.0,0,3,0,2,7,0,0,5,0,5,12,1
4326,64602,BOKQK9bANog8js8ZS6fczS1c2Qck04bm,3VkHkmOtom3jM2wCu94xgzzu1d6Dn7or,2,0,0,0,0,0,2,0,2,0.2857142857142857,1,0.0,0,0,0,0,0,0,0,2,0,0,2,1
4327,64603,qvYnUocR0frsPd3kYwxIbvUGNPr9n1qt,3VkHkmOtom3jM2wCu94xgzzu1d6Dn7or,5,4,1,0,0,0,3,0,8,1.1428571428571428,1,0.0,0,1,0,0,4,0,0,3,0,1,7,1
4328,64615,qKB2XQNbRVqqDMhQPlQh48h20NofWfSV,3VkHkmOtom3jM2wCu94xgzzu1d6Dn7or,1,0,0,0,0,0,1,0,1,0.14285714285714285,1,0.0,0,0,0,0,0,0,0,1,0,0,1,1
4329,64650,gAgemCzJGmixMig6mQD6NWFEvbJXhb78,3VkHkmOtom3jM2wCu94xgzzu1d6Dn7or,68,277,87,62,88,2,33,1,550,78.57142857142857,13,0.0,145,87,58,88,132,2,4,33,1,378,172,0
4330,64662,rEshrXNp0EMe0kgk6a6QvKN0GvvqP09g,3VkHkmOtom3jM2wCu94xgzzu1d6Dn7or,2,0,0,0,0,0,2,0,2,0.2857142857142857,1,0.0,0,0,0,0,0,0,0,2,0,0,2,1
4331,64674,vGQAID39BKk1FvQYReBWX247x3QlYrgz,3VkHkmOtom3jM2wCu94xgzzu1d6Dn7or,62,199,76,99,51,47,28,9,509,72.71428571428571,13,0.0,69,76,95,51,130,47,4,28,9,291,218,0
4332,64713,k0z6RGGewAn8TOLu7gTAfbvZpKAlaO9s,3VkHkmOtom3jM2wCu94xgzzu1d6Dn7or,8,6,3,0,2,0,10,0,21,3.0,2,0.0,0,3,0,2,6,0,0,10,0,5,16,1
4333,64731,v7V5lxZod154cnKdaWzRncJReivDoCGm,3VkHkmOtom3jM2wCu94xgzzu1d6Dn7or,1,0,0,0,0,0,1,0,1,0.14285714285714285,1,0.0,0,0,0,0,0,0,0,1,0,0,1,1
4334,64749,NZrJhxLLoF5Z5OBot3OZHMpZISE3ex3z,3VkHkmOtom3jM2wCu94xgzzu1d6Dn7or,70,118,43,62,57,10,13,3,306,43.714285714285715,6,0.0,62,43,60,57,56,10,2,13,3,222,84,0
4335,64753,shRLUNza7ToIRumUukwmCPdAakP1Z4MR,3VkHkmOtom3jM2wCu94xgzzu1d6Dn7or,8,2,1,0,1,0,6,2,12,1.7142857142857142,2,0.0,0,1,0,1,2,0,0,6,2,2,10,1
4336,64772,c2xUxg7vuhPItQZr96ojei2FNm4xg1X0,3VkHkmOtom3jM2wCu94xgzzu1d6Dn7or,96,202,69,83,74,9,26,6,469,67.0,10,0.0,107,69,79,74,95,9,4,26,6,329,140,0
4337,64784,XYyEyYkiXbQAB5EYzyXMuE8giVn3YEv6,3VkHkmOtom3jM2wCu94xgzzu1d6Dn7or,7,2,2,0,2,0,13,4,23,3.2857142857142856,1,0.0,0,2,0,2,2,0,0,13,4,4,19,0
4338,64812,itxkUZlleVt8P8yDd0VbJBHxtmvlnPtZ,3VkHkmOtom3jM2wCu94xgzzu1d6Dn7or,1,0,0,0,0,0,1,0,1,0.14285714285714285,1,0.0,0,0,0,0,0,0,0,1,0,0,1,1
4339,64827,HUcV9f0KlUI5fr3swBcOW4ndqldbTUfQ,3VkHkmOtom3jM2wCu94xgzzu1d6Dn7or,43,138,50,31,44,1,12,1,277,39.57142857142857,5,0.0,71,50,30,44,67,1,1,12,1,195,82,0
4340,64855,uXENfpJ5grhp1Qr3FBnsuSG3ncYtxO8a,3VkHkmOtom3jM2wCu94xgzzu1d6Dn7or,1,0,0,0,0,0,1,0,1,0.14285714285714285,1,0.0,0,0,0,0,0,0,0,1,0,0,1,1
4341,64859,ZbKU5GVgsZZvDM1IUG4qrpiO477YibB6,3VkHkmOtom3jM2wCu94xgzzu1d6Dn7or,4,2,1,0,1,0,1,0,5,0.7142857142857143,1,0.0,0,1,0,1,2,0,0,1,0,2,3,1
4342,64861,CyxMdLdauH0yjNBg0n7X7c0tmTOyOQoH,3VkHkmOtom3jM2wCu94xgzzu1d6Dn7or,1,0,0,0,0,0,1,0,1,0.14285714285714285,1,0.0,0,0,0,0,0,0,0,1,0,0,1,1
4343,65687,FOKF27675cifNbJRDl4981DQvPoTqlyq,5X6FeZozNMgE2VRi3MJYjkkFK8SETtu2,1,0,0,0,0,0,1,0,1,0.14285714285714285,1,0.0,0,0,0,0,0,0,0,1,0,0,1,1
4344,65705,0PYlPo8KoOqdfXLmHxHfVVjmiH634i57,5X6FeZozNMgE2VRi3MJYjkkFK8SETtu2,50,32,27,0,26,0,2,0,87,12.428571428571429,1,0.0,2,27,0,26,30,0,0,2,0,55,32,1
4345,65732,PWsIUDujlx4s1VHM6RAyjgvMb6HCslXd,5X6FeZozNMgE2VRi3MJYjkkFK8SETtu2,5,2,1,0,1,0,2,0,6,0.8571428571428571,1,0.0,0,1,0,1,2,0,0,2,0,2,4,1
4346,65766,RPnWL5ddEAqNC9HzON3z0LuIcVuEKZPT,5X6FeZozNMgE2VRi3MJYjkkFK8SETtu2,1,0,0,0,0,0,3,0,3,0.42857142857142855,3,0.0,0,0,0,0,0,0,0,3,0,0,3,1
4347,65788,aszS4GIQTgIfNXx5jr5Ct6AzWRVtVT5s,7GRhBDsirIGkRZBtSMEzNTyDr2JQm4xx,69,149,34,94,54,1,0,0,332,47.42857142857143,8,0.0,92,34,75,54,57,1,19,0,0,255,77,1
4348,65794,ee5z0tJLP6Khk8QhqHWb5RZbzlS7e0OS,5X6FeZozNMgE2VRi3MJYjkkFK8SETtu2,1,0,0,0,0,0,1,0,1,0.14285714285714285,1,0.0,0,0,0,0,0,0,0,1,0,0,1,1
4349,65802,60AdiK8bE6l0acvscYCimI00NJzONtxh,7GRhBDsirIGkRZBtSMEzNTyDr2JQm4xx,8,7,1,0,1,0,2,0,11,1.5714285714285714,1,0.0,0,1,0,1,7,0,0,2,0,2,9,1
4350,65860,FWTjpNOuI4RsBkDu0yW01kwOX7KPfCTS,5X6FeZozNMgE2VRi3MJYjkkFK8SETtu2,1,0,0,0,0,0,1,0,1,0.14285714285714285,1,0.0,0,0,0,0,0,0,0,1,0,0,1,1
4351,65875,FIYIY0le6IgAtT64SQdOQ9wlHEZCwQOO,5X6FeZozNMgE2VRi3MJYjkkFK8SETtu2,73,119,2,79,17,7,22,1,247,35.285714285714285,6,0.0,65,2,71,17,54,7,8,22,1,155,92,1
4352,65898,eiLcveXPgb7IWmxyYugGtGV92SFN2oTV,5X6FeZozNMgE2VRi3MJYjkkFK8SETtu2,90,139,0,137,39,0,9,0,324,46.285714285714285,6,0.0,90,0,114,39,49,0,23,9,0,243,81,0
4353,65927,HduQY3IOfXhSoooBb9r0J73pVo2wwi5W,5X6FeZozNMgE2VRi3MJYjkkFK8SETtu2,11,8,5,0,3,0,5,1,22,3.142857142857143,1,0.0,0,5,0,3,8,0,0,5,1,8,14,1
4354,65929,trlHigiDuElPZHAcTtKxGjwa3iTdimGy,5X6FeZozNMgE2VRi3MJYjkkFK8SETtu2,2,0,0,0,0,0,2,0,2,0.2857142857142857,1,0.0,0,0,0,0,0,0,0,2,0,0,2,1
4355,65944,IPs8z12Ih1D0cstuKylzJa6KPypnLd8o,5X6FeZozNMgE2VRi3MJYjkkFK8SETtu2,6,4,1,0,0,0,3,0,8,1.1428571428571428,1,0.0,0,1,0,0,4,0,0,3,0,1,7,1
4356,65976,4Le8TpGtOuf2E9j40zmI7yYIE8EBcwun,5X6FeZozNMgE2VRi3MJYjkkFK8SETtu2,10,12,4,0,2,0,2,0,20,2.857142857142857,2,0.0,2,4,0,2,10,0,0,2,0,8,12,1
4357,66558,z6Xzy59qUrOr9kg6qBkR4Bly4uQ6Qoy2,SpATywNh6bZuzm8s1ceuBUnMUAeoAHHw,6,6,4,0,2,0,2,0,14,2.0,1,0.0,0,4,0,2,6,0,0,2,0,6,8,1
4358,66570,MpNfjrXai4aLf7BfVSQwZSS0DPolU3oZ,RXDvfPUBYFlVdlueBFbLW0mhhAyGEqpt,5,3,2,0,1,0,1,0,7,1.0,1,0.0,0,2,0,1,3,0,0,1,0,3,4,0
4359,66571,2jofclRKNdmEGIMZjR1X3xlqQjjV6yF4,SpATywNh6bZuzm8s1ceuBUnMUAeoAHHw,9,5,4,0,3,0,1,0,13,1.8571428571428572,1,0.0,0,4,0,3,5,0,0,1,0,7,6,0
4360,66581,thNNhxxCA11oJLPqP35etO0M0nOY00HM,G8EPVSXsOYB5YQWZGiz1aVq5Pgr2GrQu,5,3,2,0,1,0,1,0,7,1.0,1,0.0,0,2,0,1,3,0,0,1,0,3,4,1
4361,66606,yceNLUK4FCR6SZUYW0W0TAVYCfKl5jP6,SpATywNh6bZuzm8s1ceuBUnMUAeoAHHw,9,7,0,14,0,0,3,0,24,3.4285714285714284,1,0.0,2,0,13,0,5,0,1,3,0,15,9,1
4362,66633,tuzr7UEFeueCuu7trKtH12YoCRZa4u3J,SpATywNh6bZuzm8s1ceuBUnMUAeoAHHw,7,6,3,0,1,0,2,0,12,1.7142857142857142,1,0.0,0,3,0,1,6,0,0,2,0,4,8,1
4363,66649,Gmz5iMjiwcyTx4KusyWM0rOecmUutZaf,RXDvfPUBYFlVdlueBFbLW0mhhAyGEqpt,112,219,128,198,76,44,53,15,733,104.71428571428571,9,0.0,58,128,182,76,161,44,16,53,15,444,289,0
4364,66901,jsqKkuSbErall5JnaWQXJQsGef5XwKOD,SpATywNh6bZuzm8s1ceuBUnMUAeoAHHw,6,9,5,0,0,0,3,0,17,2.4285714285714284,1,0.0,0,5,0,0,9,0,0,3,0,5,12,1
4365,66973,AtBEE9J055aDlITLvmg36iywfRw9ii2d,SpATywNh6bZuzm8s1ceuBUnMUAeoAHHw,19,19,11,0,8,0,8,0,46,6.571428571428571,2,0.0,0,11,0,8,19,0,0,8,0,19,27,1
4366,66996,vgJBdvzTqJ5MKR9sNPkrlU2Mvr3KdXZ3,SpATywNh6bZuzm8s1ceuBUnMUAeoAHHw,6,6,3,0,2,0,1,0,12,1.7142857142857142,2,0.0,0,3,0,2,6,0,0,1,0,5,7,0
4367,67015,knXx0VSX34ZZdw5j0pCDnRFFDbxG6IJ6,SpATywNh6bZuzm8s1ceuBUnMUAeoAHHw,25,27,18,14,10,0,9,0,78,11.142857142857142,3,0.0,5,18,13,10,22,0,1,9,0,46,32,0
4368,67033,tPYh43YRHAzuf09xESxSKtWvST0aCsjn,SpATywNh6bZuzm8s1ceuBUnMUAeoAHHw,8,6,2,11,0,0,2,0,21,3.0,1,0.0,3,2,10,0,3,0,1,2,0,15,6,0
4369,67034,yZ9FndAKqVsKwZtO1B2JJJblefdbhZ02,SpATywNh6bZuzm8s1ceuBUnMUAeoAHHw,7,3,1,14,0,0,2,0,20,2.857142857142857,1,0.0,2,1,13,0,1,0,1,2,0,16,4,0
4370,67049,caAQbOI1NkkZKVF3oGPK3OdsY0lbDlYb,SpATywNh6bZuzm8s1ceuBUnMUAeoAHHw,3,2,1,0,0,0,1,0,4,0.5714285714285714,1,0.0,0,1,0,0,2,0,0,1,0,1,3,1
4371,67077,wDMKq3Xvq95ERd20zjEMEb0BtCbHx7BM,SpATywNh6bZuzm8s1ceuBUnMUAeoAHHw,10,12,1,12,0,0,10,0,35,5.0,5,0.0,3,1,11,0,9,0,1,10,0,15,20,0
4372,67099,rwVFzRApiQw3vAU5Rpa6do3mD0uc5CXG,SpATywNh6bZuzm8s1ceuBUnMUAeoAHHw,12,11,0,16,0,0,4,0,31,4.428571428571429,1,0.0,3,0,13,0,8,0,3,4,0,16,15,1
4373,67158,07nBIjV5wvxeipK7Zz3uxWH8hv0V5VvH,SpATywNh6bZuzm8s1ceuBUnMUAeoAHHw,21,30,16,9,8,0,5,0,68,9.714285714285714,3,0.0,5,16,8,8,25,0,1,5,0,37,31,0
4374,67266,X0qiYFDfIWOz74gDCjJtjtlJKUHThKgm,SpATywNh6bZuzm8s1ceuBUnMUAeoAHHw,5,4,3,0,0,0,1,0,8,1.1428571428571428,1,0.0,0,3,0,0,4,0,0,1,0,3,5,0
4375,67267,d4AhROqi4DjVmWKfbbbhi19n7hcGPkSg,RXDvfPUBYFlVdlueBFbLW0mhhAyGEqpt,3,6,1,0,0,0,5,0,12,1.7142857142857142,3,0.0,0,1,0,0,6,0,0,5,0,1,11,0
4376,67288,PXVYYQlV1TwZ9b9f7GhoFUXTgABGZcBY,SpATywNh6bZuzm8s1ceuBUnMUAeoAHHw,10,3,3,0,3,0,6,0,15,2.142857142857143,2,0.0,0,3,0,3,3,0,0,6,0,6,9,0
4377,67308,T73fWQC3H2PhmOiodFuHvvahENx7TmZo,SpATywNh6bZuzm8s1ceuBUnMUAeoAHHw,9,5,4,8,2,0,1,0,20,2.857142857142857,1,0.0,1,4,6,2,4,0,2,1,0,13,7,1
4378,67328,HurK028hfari9vlQzhAchljjKEaGMu7l,SpATywNh6bZuzm8s1ceuBUnMUAeoAHHw,20,40,14,19,0,0,3,0,76,10.857142857142858,1,0.0,21,14,18,0,19,0,1,3,0,53,23,1
4379,67427,vS0PO2z5tTpDl1S200qdqNDkFjNmdjxd,G8EPVSXsOYB5YQWZGiz1aVq5Pgr2GrQu,22,16,12,0,10,0,2,0,40,5.714285714285714,2,0.0,0,12,0,10,16,0,0,2,0,22,18,1
4380,67437,H1gNXDemnE2i9lW82GrGfdWk3AATsmHy,SpATywNh6bZuzm8s1ceuBUnMUAeoAHHw,26,32,9,18,6,0,1,0,66,9.428571428571429,1,0.0,11,9,17,6,21,0,1,1,0,43,23,0
4381,67454,7KhKGJPxu4uQKYHNs7O3NjmuTH6NjrVY,bWdj2GDclj5ofokWjzoa5jAwMkxCykd6,1,0,0,0,0,0,3,0,3,0.42857142857142855,2,0.0,0,0,0,0,0,0,0,3,0,0,3,0
4382,67464,uBWT9p90Ea0JVvR5wbRV9EQLPt0ehYR1,SpATywNh6bZuzm8s1ceuBUnMUAeoAHHw,15,31,2,9,1,3,5,0,51,7.285714285714286,2,0.0,11,2,9,1,20,3,0,5,0,23,28,1
4383,67468,lHCmVtLnmElXqFcol1pTzGnaqp21GEs7,RXDvfPUBYFlVdlueBFbLW0mhhAyGEqpt,24,10,10,0,10,0,3,1,34,4.857142857142857,1,0.0,0,10,0,10,10,0,0,3,1,20,14,1
4384,67510,9by6FuLW9p6hAe2x8b5HjrOAjJeqk2av,SpATywNh6bZuzm8s1ceuBUnMUAeoAHHw,34,38,24,23,14,0,5,0,104,14.857142857142858,2,0.0,7,24,18,14,31,0,5,5,0,63,41,0
4385,67566,tYJFbmbzeY9dNgPSZvFhNskxnqvhh3AK,SpATywNh6bZuzm8s1ceuBUnMUAeoAHHw,11,10,8,0,0,0,4,0,22,3.142857142857143,2,0.0,0,8,0,0,10,0,0,4,0,8,14,0
4386,67572,HMOOD0QNsPiJ6FSYOiE4GQjvcEPtEXiW,SpATywNh6bZuzm8s1ceuBUnMUAeoAHHw,10,14,7,0,3,0,1,0,25,3.5714285714285716,1,0.0,0,7,0,3,14,0,0,1,0,10,15,0
4387,67655,tkE1JI2oJkZLA1XOzEZ3Jn8IFDQS4QJ9,G8EPVSXsOYB5YQWZGiz1aVq5Pgr2GrQu,49,53,24,110,8,0,6,0,201,28.714285714285715,2,0.0,25,24,82,8,28,0,28,6,0,139,62,0
4388,67710,zDAtaSKsAJQmmJ6xHQBbAGN68vDebyev,SpATywNh6bZuzm8s1ceuBUnMUAeoAHHw,10,15,0,12,0,0,4,0,31,4.428571428571429,2,0.0,6,0,11,0,9,0,1,4,0,17,14,0
4389,67820,opdILbT2IBFIYJvyIT5NXM7ymKeuMTcM,SpATywNh6bZuzm8s1ceuBUnMUAeoAHHw,49,77,59,29,37,1,16,0,219,31.285714285714285,7,0.0,4,59,28,37,73,1,1,16,0,128,91,0
4390,67853,oseHKim5ugRciFh8lXIQ174blllPPfFO,SpATywNh6bZuzm8s1ceuBUnMUAeoAHHw,27,27,14,0,10,17,6,1,75,10.714285714285714,2,0.0,0,14,0,10,27,17,0,6,1,24,51,0
4391,67867,YJjGstHCH0jRUJlDUc92oNrPq0d0Zijd,SpATywNh6bZuzm8s1ceuBUnMUAeoAHHw,18,12,9,9,6,0,1,0,37,5.285714285714286,1,0.0,2,9,9,6,10,0,0,1,0,26,11,1
4392,67897,yKgKNljfs8EwbfiKqNgGPLaIDdrvaFSp,SpATywNh6bZuzm8s1ceuBUnMUAeoAHHw,3,3,1,0,0,0,2,0,6,0.8571428571428571,1,0.0,0,1,0,0,3,0,0,2,0,1,5,0
4393,67901,8qABUnBBHxxZkfUhEQNUn5NNMSRrqvPC,RXDvfPUBYFlVdlueBFbLW0mhhAyGEqpt,28,22,13,52,0,2,1,0,90,12.857142857142858,1,0.0,7,13,51,0,15,2,1,1,0,71,19,1
4394,67920,gqL1AoJbIkLDCmEi1SGH37fAu1Zdec1f,SpATywNh6bZuzm8s1ceuBUnMUAeoAHHw,3,2,1,0,0,0,1,0,4,0.5714285714285714,1,0.0,0,1,0,0,2,0,0,1,0,1,3,0
4395,67942,PXSCTSolyT6nzbTsv2Nsca26yVAoeW5q,SpATywNh6bZuzm8s1ceuBUnMUAeoAHHw,35,33,15,17,9,3,6,1,84,12.0,2,0.0,13,15,16,9,20,3,1,6,1,53,31,0
4396,68013,CDy3wblikhG2TGdNI3LhbAglknKqeMeq,RXDvfPUBYFlVdlueBFbLW0mhhAyGEqpt,1,0,0,0,0,0,1,0,1,0.14285714285714285,1,0.0,0,0,0,0,0,0,0,1,0,0,1,0
4397,68021,YxdX3NPpzVJ59dpoBODWSD8Noi3lkajj,G8EPVSXsOYB5YQWZGiz1aVq5Pgr2GrQu,54,51,37,94,19,0,6,0,207,29.571428571428573,3,0.0,2,37,72,19,49,0,22,6,0,130,77,0
4398,68055,EBLsXyMzbHjWnC0OjjqcacEXrmUIJvTs,SpATywNh6bZuzm8s1ceuBUnMUAeoAHHw,1,0,0,0,0,0,1,0,1,0.14285714285714285,1,0.0,0,0,0,0,0,0,0,1,0,0,1,1
4399,68088,GIsRCDxWVYGm4So2chhYPzgj7oVxCsSB,RXDvfPUBYFlVdlueBFbLW0mhhAyGEqpt,5,3,1,0,1,0,1,0,6,0.8571428571428571,1,0.0,0,1,0,1,3,0,0,1,0,2,4,1
4400,68118,Z5b3QXG5aJtKMyvjqd5INn7f1wDhqIm4,SpATywNh6bZuzm8s1ceuBUnMUAeoAHHw,5,4,2,0,1,0,1,0,8,1.1428571428571428,1,0.0,0,2,0,1,4,0,0,1,0,3,5,0
4401,68181,wCP7MM6FfvdZx8uOqp7AG8m1oFJcqLHB,SpATywNh6bZuzm8s1ceuBUnMUAeoAHHw,11,8,6,0,4,0,2,0,20,2.857142857142857,1,0.0,0,6,0,4,8,0,0,2,0,10,10,1
4402,68194,3F9rh0xtO3MPjBfGcFPCm9PRbwYuY4I3,SpATywNh6bZuzm8s1ceuBUnMUAeoAHHw,3,2,1,0,0,0,1,0,4,0.5714285714285714,1,0.0,0,1,0,0,2,0,0,1,0,1,3,1
4403,68222,WnGoJ0X05nmmcr9OBuNGFmD5r4EVF1g6,bWdj2GDclj5ofokWjzoa5jAwMkxCykd6,3,6,3,0,0,0,2,0,11,1.5714285714285714,2,0.0,0,3,0,0,6,0,0,2,0,3,8,1
4404,68234,CR4gghlbM9RsvrMmN4aq9I8yiSZncbD8,SpATywNh6bZuzm8s1ceuBUnMUAeoAHHw,35,34,20,14,10,0,6,0,84,12.0,3,0.0,9,20,14,10,25,0,0,6,0,53,31,0
4405,68241,i2PPXz5Z5PB2ZfiVAI64TcWxYgJR1QQ1,RXDvfPUBYFlVdlueBFbLW0mhhAyGEqpt,3,2,0,0,0,0,2,0,4,0.5714285714285714,2,0.0,0,0,0,0,2,0,0,2,0,0,4,1
4406,68252,5N9UtpTd0Iyfm1Amzky3t1R9JrMPidgw,SpATywNh6bZuzm8s1ceuBUnMUAeoAHHw,2,0,0,0,0,0,6,0,6,0.8571428571428571,1,0.0,0,0,0,0,0,0,0,6,0,0,6,0
4407,68258,oL1G89Phk4nduULmJ17br7A4xddcHdc4,RXDvfPUBYFlVdlueBFbLW0mhhAyGEqpt,3,2,1,0,0,0,1,0,4,0.5714285714285714,1,0.0,0,1,0,0,2,0,0,1,0,1,3,0
4408,68263,pbaQcU38LWlEY15kC2Yb0jdLNtMAYhsA,SpATywNh6bZuzm8s1ceuBUnMUAeoAHHw,3,3,1,0,0,0,1,0,5,0.7142857142857143,1,0.0,0,1,0,0,3,0,0,1,0,1,4,0
4409,68273,1qOWHE2SxHYAOzNCTuiHl1kSZUHL0gyU,SpATywNh6bZuzm8s1ceuBUnMUAeoAHHw,39,105,50,19,33,0,23,1,231,33.0,5,0.0,13,50,16,33,92,0,3,23,1,112,119,0
4410,68332,hJo1MgKiPZFXuH2ko6hqPTd9dbjMQKDO,SpATywNh6bZuzm8s1ceuBUnMUAeoAHHw,7,6,4,0,1,0,1,0,12,1.7142857142857142,1,0.0,1,4,0,1,5,0,0,1,0,6,6,0
4411,68349,iADE6TgYebHG0th9GrbiEmbQ3Qc3Go8z,RXDvfPUBYFlVdlueBFbLW0mhhAyGEqpt,10,5,5,0,3,0,3,0,16,2.2857142857142856,1,0.0,0,5,0,3,5,0,0,3,0,8,8,1
4412,68352,clbUGnOQsN7CuaV7idGJ2LVbYN3t8qC3,SpATywNh6bZuzm8s1ceuBUnMUAeoAHHw,13,12,0,9,0,0,1,0,22,3.142857142857143,1,0.0,2,0,8,0,10,0,1,1,0,10,12,0
4413,68363,0F1DhnfuH8hFtOjZ8dWmoNBQat6tI7Te,SpATywNh6bZuzm8s1ceuBUnMUAeoAHHw,9,7,4,0,1,1,8,1,22,3.142857142857143,1,0.0,0,4,0,1,7,1,0,8,1,5,17,1
4414,68364,2FyRSMemMx0WQNXDNdLObUL8ox2VWXod,SpATywNh6bZuzm8s1ceuBUnMUAeoAHHw,22,20,17,0,9,0,5,0,51,7.285714285714286,4,0.0,0,17,0,9,20,0,0,5,0,26,25,1
4415,68379,b4M5OphEGf9HhlcR04bazUL6wKV8uIkU,G8EPVSXsOYB5YQWZGiz1aVq5Pgr2GrQu,37,6,1,97,0,16,2,0,122,17.428571428571427,1,0.0,0,1,96,0,6,16,1,2,0,97,25,1
4416,68398,LNdimqsJkOxQDP9dT4IGwewg9YvH7zfV,SpATywNh6bZuzm8s1ceuBUnMUAeoAHHw,4,3,1,0,0,0,1,0,5,0.7142857142857143,1,0.0,0,1,0,0,3,0,0,1,0,1,4,1
4417,68412,0KxBv7TNEUj27dsp2zMGG4WpBswpgOyf,SpATywNh6bZuzm8s1ceuBUnMUAeoAHHw,3,2,1,0,0,0,1,0,4,0.5714285714285714,1,0.0,0,1,0,0,2,0,0,1,0,1,3,0
4418,68494,yvCmfQ3z3fMLbjXX0h1AIIPVh4np9hhq,SpATywNh6bZuzm8s1ceuBUnMUAeoAHHw,20,33,11,13,5,0,2,0,64,9.142857142857142,1,0.0,20,11,12,5,13,0,1,2,0,48,16,0
4419,68516,6oCDtYWE1YbVTX7pVBS5Cflb4KyRNNI9,SpATywNh6bZuzm8s1ceuBUnMUAeoAHHw,7,5,4,0,4,1,2,1,17,2.4285714285714284,1,0.0,0,4,0,4,5,1,0,2,1,8,9,1
4420,68543,kS5Tu2RHO9HzXMOZp3CUIdzW6Y8prRRh,SpATywNh6bZuzm8s1ceuBUnMUAeoAHHw,26,41,2,26,1,0,4,0,74,10.571428571428571,2,0.0,14,2,24,1,27,0,2,4,0,41,33,1
4421,68563,8fwUYmiU3p577nM1EutDr5QOZIKfzBRc,RXDvfPUBYFlVdlueBFbLW0mhhAyGEqpt,43,66,32,65,21,3,8,4,199,28.428571428571427,5,0.0,23,32,59,21,43,3,6,8,4,135,64,0
4422,68623,F5DvCuAufOHMNW6g3uuO7OUr15Bgdj9y,SpATywNh6bZuzm8s1ceuBUnMUAeoAHHw,18,23,6,9,3,0,4,0,45,6.428571428571429,2,0.0,3,6,9,3,20,0,0,4,0,21,24,0
4423,68686,YRBA7GRiLrrlZjduaK8N9tfqRO36138H,SpATywNh6bZuzm8s1ceuBUnMUAeoAHHw,5,4,2,0,0,0,2,0,8,1.1428571428571428,1,0.0,0,2,0,0,4,0,0,2,0,2,6,0
4424,68690,vsAcPV04LnM01WalbcA4jNxiuu2qNyeQ,SpATywNh6bZuzm8s1ceuBUnMUAeoAHHw,25,52,3,28,1,0,4,0,88,12.571428571428571,6,0.0,20,3,27,1,32,0,1,4,0,51,37,0
4425,68781,THXcc2NGn7OhkfHl1lLehmfkJwTtl0vs,SpATywNh6bZuzm8s1ceuBUnMUAeoAHHw,1,0,0,0,0,0,1,0,1,0.14285714285714285,1,0.0,0,0,0,0,0,0,0,1,0,0,1,1
4426,68831,SmLgezr6vw2mXwO7w10XynKKHaO5xE5n,SpATywNh6bZuzm8s1ceuBUnMUAeoAHHw,4,2,1,0,0,1,4,0,8,1.1428571428571428,1,0.0,0,1,0,0,2,1,0,4,0,1,7,1
4427,68844,EleMlloryvuXR0G9AOtui0gfdXfrUQfc,SpATywNh6bZuzm8s1ceuBUnMUAeoAHHw,4,3,0,0,0,0,2,0,5,0.7142857142857143,1,0.0,0,0,0,0,3,0,0,2,0,0,5,1
4428,68936,FsS49SZqT6XuQy2tX0gejqco4jQwOMN4,SpATywNh6bZuzm8s1ceuBUnMUAeoAHHw,5,4,2,0,1,0,1,0,8,1.1428571428571428,1,0.0,0,2,0,1,4,0,0,1,0,3,5,0
4429,69066,0a6HihupPBi4xpjolN637qOYG6WSN1Gx,SpATywNh6bZuzm8s1ceuBUnMUAeoAHHw,21,52,23,9,13,0,7,0,104,14.857142857142858,2,0.0,20,23,9,13,32,0,0,7,0,65,39,0
4430,69070,g5yKalRrHBvoyNkzpNTa67etQfVwykko,SpATywNh6bZuzm8s1ceuBUnMUAeoAHHw,33,48,30,39,22,3,4,0,146,20.857142857142858,3,0.0,14,30,35,22,34,3,4,4,0,101,45,0
4431,69076,cy1UxkAxcqJswFy9Syqm01bsE17PQcla,SpATywNh6bZuzm8s1ceuBUnMUAeoAHHw,18,25,13,10,4,0,8,0,60,8.571428571428571,4,0.0,4,13,10,4,21,0,0,8,0,31,29,0
4432,69138,C5Rja3fyOmRxfpM2pXQmwA2G5rEfb320,SpATywNh6bZuzm8s1ceuBUnMUAeoAHHw,14,22,0,11,0,0,2,0,35,5.0,1,0.0,3,0,10,0,19,0,1,2,0,13,22,1
4433,69160,Vnhhp2QbBiDiUTTHmXkksXuO8NCNMbjj,A3fsA9Zfv1X2fVEQhTw51lKENdNrEqT3,14,11,7,0,7,0,1,0,26,3.7142857142857144,1,0.0,0,7,0,7,11,0,0,1,0,14,12,1
4434,69179,WX5bge9EFbPypYuObEiSD1Gyvh8Z866G,A3fsA9Zfv1X2fVEQhTw51lKENdNrEqT3,65,35,34,0,31,0,2,0,102,14.571428571428571,1,0.0,0,34,0,31,35,0,0,2,0,65,37,1
4435,69199,CpruMjpYp2wLmRpTC4dJZ8iwMDhltzag,RXDvfPUBYFlVdlueBFbLW0mhhAyGEqpt,9,5,1,11,1,0,1,0,19,2.7142857142857144,1,0.0,1,1,10,1,4,0,1,1,0,13,6,1
4436,69218,YZJnbvfbnhVRirLqDRHGzQv4606Wu6TO,bWdj2GDclj5ofokWjzoa5jAwMkxCykd6,10,10,7,0,3,0,1,0,21,3.0,1,0.0,0,7,0,3,10,0,0,1,0,10,11,1
4437,69224,65ggrHSAXoVCOK75IinKW9i4EJF8EDcN,SpATywNh6bZuzm8s1ceuBUnMUAeoAHHw,1,0,0,0,0,0,1,0,1,0.14285714285714285,1,0.0,0,0,0,0,0,0,0,1,0,0,1,1
4438,69261,Y0yiSfPX9V0A8oNPfdzCuT5yHRuHvSj6,SpATywNh6bZuzm8s1ceuBUnMUAeoAHHw,13,10,6,14,2,0,2,0,34,4.857142857142857,1,0.0,2,6,14,2,8,0,0,2,0,24,10,1
4439,69346,4G8hhK38eDoUtZ2viIFKnYiWqmC4nF56,SpATywNh6bZuzm8s1ceuBUnMUAeoAHHw,4,6,1,0,0,0,1,0,8,1.1428571428571428,1,0.0,0,1,0,0,6,0,0,1,0,1,7,1
4440,69435,vPqhvdjrX3GgCAjq6K96tYCv7DiMTBkh,SpATywNh6bZuzm8s1ceuBUnMUAeoAHHw,15,22,3,7,1,0,4,0,37,5.285714285714286,3,0.0,3,3,7,1,19,0,0,4,0,14,23,0
4441,69444,sfdgnQL9ZJy8iQoJsTh6pz33V1sjsZlD,A3fsA9Zfv1X2fVEQhTw51lKENdNrEqT3,29,23,19,0,17,0,1,0,60,8.571428571428571,1,0.0,0,19,0,17,23,0,0,1,0,36,24,0
4442,69477,FlAkKX6ow9SvOzk0dTWPWgnX5766zY29,G8EPVSXsOYB5YQWZGiz1aVq5Pgr2GrQu,4,4,3,0,0,0,1,0,8,1.1428571428571428,1,0.0,0,3,0,0,4,0,0,1,0,3,5,0
4443,69577,zdQpZzeZtdBJrKxe0kkh4zz1KUaEeB2I,G8EPVSXsOYB5YQWZGiz1aVq5Pgr2GrQu,86,50,42,151,30,0,5,0,278,39.714285714285715,3,0.0,0,42,129,30,50,0,22,5,0,201,77,1
4444,69682,DpqUZKEZpIFvZzvEXk8oaJMRAbEfypNN,A3fsA9Zfv1X2fVEQhTw51lKENdNrEqT3,3,0,0,0,0,0,9,0,9,1.2857142857142858,2,0.0,0,0,0,0,0,0,0,9,0,0,9,1
4445,69708,xcD6YWhnGA2xukGmX4eaYrm6VS9ffz1H,RXDvfPUBYFlVdlueBFbLW0mhhAyGEqpt,13,17,12,0,1,12,3,1,46,6.571428571428571,1,0.0,1,12,0,1,16,12,0,3,1,14,32,0
4446,69726,MJibuyVypmuBs7BncEuo5i3GOsk8IZAX,SpATywNh6bZuzm8s1ceuBUnMUAeoAHHw,5,2,2,0,2,0,0,0,6,0.8571428571428571,1,0.0,0,2,0,2,2,0,0,0,0,4,2,1
4447,69783,Nr4xgaqWlp3GY7Luca1HZwWSVTgxpORh,A3fsA9Zfv1X2fVEQhTw51lKENdNrEqT3,9,4,0,0,0,0,7,1,12,1.7142857142857142,1,0.0,0,0,0,0,4,0,0,7,1,0,12,0
4448,69809,j7794Az14TTh7tEEmhTpADHq4ipGllnd,SpATywNh6bZuzm8s1ceuBUnMUAeoAHHw,10,15,10,0,4,2,7,0,38,5.428571428571429,2,0.0,0,10,0,4,15,2,0,7,0,14,24,0
4449,69847,LyDM0yrwn8zKtQsuxEGqFMxdhffaZNVY,SpATywNh6bZuzm8s1ceuBUnMUAeoAHHw,19,27,1,28,0,0,1,0,57,8.142857142857142,1,0.0,6,1,25,0,21,0,3,1,0,32,25,1
4450,69849,jSFXNgNICT3cTdtFY1qrRx06ncJbHNIL,SpATywNh6bZuzm8s1ceuBUnMUAeoAHHw,25,42,13,19,7,2,5,0,88,12.571428571428571,2,0.0,19,13,16,7,23,2,3,5,0,55,33,0
4451,69856,SBz1G9CPNh7b1YKxwzjWQ2S8H7JkEfYW,SpATywNh6bZuzm8s1ceuBUnMUAeoAHHw,13,19,0,9,0,0,3,0,31,4.428571428571429,1,0.0,2,0,8,0,17,0,1,3,0,10,21,0
4452,69879,T7hyLHRci3AaSKtnxgzZP9PZimkugFag,SpATywNh6bZuzm8s1ceuBUnMUAeoAHHw,8,7,4,0,2,0,1,0,14,2.0,1,0.0,2,4,0,2,5,0,0,1,0,8,6,1
4453,69941,DpqUZKEZpIFvZzvEXk8oaJMRAbEfypNN,SpATywNh6bZuzm8s1ceuBUnMUAeoAHHw,19,22,10,0,10,0,9,0,51,7.285714285714286,2,0.0,4,10,0,10,18,0,0,9,0,24,27,0
4454,69975,xL2GGqHxlfngRtz8ATMPQBFRBvX6HArr,SpATywNh6bZuzm8s1ceuBUnMUAeoAHHw,26,51,0,5,0,0,8,0,64,9.142857142857142,2,0.0,16,0,5,0,35,0,0,8,0,21,43,0
4455,70168,ep3Z6ZNyXyvrIgNVR9OB0zeq4nPzioY7,3VkHkmOtom3jM2wCu94xgzzu1d6Dn7or,18,13,8,0,8,0,1,0,30,4.285714285714286,1,0.0,2,8,0,8,11,0,0,1,0,18,12,1
4456,70169,BIFwVHfEy95UAI6fjUhoMnDY7s4N3DmJ,3VkHkmOtom3jM2wCu94xgzzu1d6Dn7or,4,2,1,0,1,0,1,0,5,0.7142857142857143,2,0.0,0,1,0,1,2,0,0,1,0,2,3,1
4457,70170,Fihr9UrpQ666m8I3iynqbiyrKzTfsyia,3VkHkmOtom3jM2wCu94xgzzu1d6Dn7or,65,125,35,49,48,4,8,0,269,38.42857142857143,5,0.0,68,35,43,48,57,4,6,8,0,194,75,0
4458,70171,9uWO6TD3G9nGO1KlOlU8aXoG5qyfm2Vc,3VkHkmOtom3jM2wCu94xgzzu1d6Dn7or,49,96,38,48,22,24,15,1,244,34.857142857142854,9,0.0,36,38,41,22,60,24,7,15,1,137,107,0
4459,70172,Y9zzxa8aT5mj3vCCOFRszZ8rRbH90TaX,3VkHkmOtom3jM2wCu94xgzzu1d6Dn7or,3,5,1,0,0,0,1,0,7,1.0,2,0.0,0,1,0,0,5,0,0,1,0,1,6,1
4460,70173,DA24ez1cFBoNsRFo2iZZUnyu42Ymeo7y,3VkHkmOtom3jM2wCu94xgzzu1d6Dn7or,31,45,17,16,17,1,13,1,110,15.714285714285714,4,0.0,20,17,14,17,25,1,2,13,1,68,42,1
4461,70174,p0pfWFWA1dQyY3znYKNGTmTkIK6eywNP,3VkHkmOtom3jM2wCu94xgzzu1d6Dn7or,29,90,30,45,26,0,15,0,206,29.428571428571427,5,0.0,24,30,39,26,66,0,6,15,0,119,87,1
4462,70176,swBDY3r3CGAHOlRfYZZxONtreFtoAwWg,3VkHkmOtom3jM2wCu94xgzzu1d6Dn7or,33,57,12,27,25,0,16,1,138,19.714285714285715,4,0.0,42,12,26,25,15,0,1,16,1,105,33,1
4463,70178,mJpaUtqteUxu4VKFz9l1u77hB4BHtjqx,3VkHkmOtom3jM2wCu94xgzzu1d6Dn7or,4,3,1,0,0,0,2,0,6,0.8571428571428571,1,0.0,0,1,0,0,3,0,0,2,0,1,5,1
4464,70179,XuNt1i5t4SR1AjDP4UHvsoux0R9qVf5C,3VkHkmOtom3jM2wCu94xgzzu1d6Dn7or,9,43,14,5,1,8,15,0,86,12.285714285714286,3,0.0,10,14,4,1,33,8,1,15,0,29,57,1
4465,70181,siIDvWusnWDUBUBvTa7iJwnzxgWHcwAD,3VkHkmOtom3jM2wCu94xgzzu1d6Dn7or,11,13,6,4,3,3,8,1,38,5.428571428571429,3,0.0,1,6,3,3,12,3,1,8,1,13,25,1
4466,70197,Dj6SMQBl9KJ8yiS8P2s2KUlJ0yhi0WEY,3VkHkmOtom3jM2wCu94xgzzu1d6Dn7or,21,18,13,1,10,0,6,1,49,7.0,3,0.0,1,13,1,10,17,0,0,6,1,25,24,1
4467,70198,bC5wGeGWcIV679pjGNakGYlcr75e13l6,3VkHkmOtom3jM2wCu94xgzzu1d6Dn7or,34,121,28,49,24,36,22,0,280,40.0,3,0.0,46,28,42,24,75,36,7,22,0,140,140,1
4468,70204,kQtdnNEoRWo2Qg6oC84HRWANAqptJ7GF,3VkHkmOtom3jM2wCu94xgzzu1d6Dn7or,72,182,18,83,41,10,25,0,359,51.285714285714285,13,0.0,96,18,78,41,86,10,5,25,0,233,126,0
4469,70213,sdMJ9yEwKnseKwJKlSTcSmAPBTnKrqGh,3VkHkmOtom3jM2wCu94xgzzu1d6Dn7or,29,89,22,20,21,19,16,0,187,26.714285714285715,5,0.0,43,22,19,21,46,19,1,16,0,105,82,1
4470,70220,gbWAIBjOoSxn1yat60fXAQ95TIrvofyV,3VkHkmOtom3jM2wCu94xgzzu1d6Dn7or,4,2,1,0,1,0,2,0,6,0.8571428571428571,1,0.0,0,1,0,1,2,0,0,2,0,2,4,1
4471,70223,yNygMjDRQbsmQrkdzv6Ni3gEhrA9rC9T,3VkHkmOtom3jM2wCu94xgzzu1d6Dn7or,65,192,49,30,66,23,42,2,404,57.714285714285715,5,0.0,107,49,28,66,85,23,2,42,2,250,154,0
4472,70224,YEbdE61pf0gugV8YlJ3iI35aaxpMiJnI,3VkHkmOtom3jM2wCu94xgzzu1d6Dn7or,3,2,0,0,0,1,2,0,5,0.7142857142857143,1,0.0,0,0,0,0,2,1,0,2,0,0,5,0
4473,70226,8ukiQxCkCDfwUHfKzWmYD4i4dbE3kwEM,3VkHkmOtom3jM2wCu94xgzzu1d6Dn7or,8,17,4,0,1,0,11,0,33,4.714285714285714,1,0.0,0,4,0,1,17,0,0,11,0,5,28,1
4474,70227,loCbBAjJE6LEqCnUdKy3teIi6RVdybxK,3VkHkmOtom3jM2wCu94xgzzu1d6Dn7or,8,3,2,0,2,0,3,0,10,1.4285714285714286,1,0.0,0,2,0,2,3,0,0,3,0,4,6,1
4475,70228,ByKzQI3CgoJubYuohnSCQwycjV52Fk1r,3VkHkmOtom3jM2wCu94xgzzu1d6Dn7or,24,21,17,0,15,0,4,0,57,8.142857142857142,3,0.0,0,17,0,15,21,0,0,4,0,32,25,1
4476,70231,DxVdwjmi6EcYOau7Cr3jh5M2TX3cbxrT,3VkHkmOtom3jM2wCu94xgzzu1d6Dn7or,11,31,18,5,5,4,25,0,88,12.571428571428571,3,0.0,3,18,4,5,28,4,1,25,0,30,58,1
4477,70232,xtLU6YgItl9Yzw20rtIpovJ1JJpqbywC,3VkHkmOtom3jM2wCu94xgzzu1d6Dn7or,6,2,1,0,1,0,5,1,10,1.4285714285714286,1,0.0,0,1,0,1,2,0,0,5,1,2,8,0
4478,70233,8S967Vddj3mqTvUoNDSVumD7L6ahw75c,3VkHkmOtom3jM2wCu94xgzzu1d6Dn7or,18,40,9,6,12,12,17,1,97,13.857142857142858,3,0.0,22,9,6,12,18,12,0,17,1,49,48,1
4479,70236,IVUnZUhXPP7pASqRdLR6xcYo9MU0LT2m,3VkHkmOtom3jM2wCu94xgzzu1d6Dn7or,28,175,50,31,11,13,9,0,289,41.285714285714285,6,0.0,49,50,25,11,126,13,6,9,0,135,154,1
4480,70239,zY9UrfteAhELgKFy5X9J7x3Fmx6jcLg3,3VkHkmOtom3jM2wCu94xgzzu1d6Dn7or,7,5,1,0,1,0,2,0,9,1.2857142857142858,1,0.0,0,1,0,1,5,0,0,2,0,2,7,1
4481,70247,F4iC3qBrSKrshpvFu7yK5q8UUugl757b,3VkHkmOtom3jM2wCu94xgzzu1d6Dn7or,74,249,49,42,30,1,28,0,399,57.0,17,0.0,71,49,41,30,178,1,1,28,0,191,208,0
4482,70249,jx3H6f2miwKbLN02Gt82PEqx2tCxuPiz,3VkHkmOtom3jM2wCu94xgzzu1d6Dn7or,64,100,40,33,36,24,20,0,253,36.142857142857146,8,0.0,42,40,30,36,58,24,3,20,0,148,105,0
4483,70250,Bxz1zTHFCCx9o1kJA9B0Pzm3PnmqKxr5,3VkHkmOtom3jM2wCu94xgzzu1d6Dn7or,5,2,1,0,1,0,3,0,7,1.0,1,0.0,0,1,0,1,2,0,0,3,0,2,5,1
4484,70254,MuMZdME6Q21aYmZZ71oios0YuPvoMKvI,3VkHkmOtom3jM2wCu94xgzzu1d6Dn7or,51,64,44,2,32,8,17,2,169,24.142857142857142,8,0.0,2,44,2,32,62,8,0,17,2,80,89,0
4485,70255,GmHJt2279LUj6P2OGQD6V5Y1W95kmZpl,3VkHkmOtom3jM2wCu94xgzzu1d6Dn7or,9,16,3,15,5,4,4,0,47,6.714285714285714,1,0.0,10,3,10,5,6,4,5,4,0,28,19,1
4486,70256,gi7jUcChDtycblzWHdtqBoSjwB2G74db,3VkHkmOtom3jM2wCu94xgzzu1d6Dn7or,10,9,5,2,4,0,2,0,22,3.142857142857143,1,0.0,2,5,2,4,7,0,0,2,0,13,9,1
4487,70258,9y6zGDBb0JPlOjDopsZLjg4eWMIumAce,3VkHkmOtom3jM2wCu94xgzzu1d6Dn7or,8,10,5,0,2,0,6,0,23,3.2857142857142856,3,0.0,0,5,0,2,10,0,0,6,0,7,16,1
4488,70262,Xci1viGBABzXjikcwwlwGEGBfmePUlzw,3VkHkmOtom3jM2wCu94xgzzu1d6Dn7or,11,13,0,0,4,3,13,1,34,4.857142857142857,1,0.0,3,0,0,4,10,3,0,13,1,7,27,1
4489,70263,Bny5sqtonXj6ygMRx2lKkdupc3MOztaQ,3VkHkmOtom3jM2wCu94xgzzu1d6Dn7or,69,259,14,36,11,3,28,1,352,50.285714285714285,6,0.0,101,14,34,11,158,3,2,28,1,160,192,0
4490,70264,nvbLG7UzZsP47uFiujs10g1dZd2wJ34T,3VkHkmOtom3jM2wCu94xgzzu1d6Dn7or,1,0,0,0,0,0,1,0,1,0.14285714285714285,1,0.0,0,0,0,0,0,0,0,1,0,0,1,1
4491,70268,MC3MMrytePyvhe3UwuGSqjOSe0NFZLlI,3VkHkmOtom3jM2wCu94xgzzu1d6Dn7or,27,67,14,34,28,2,9,0,154,22.0,1,0.0,51,14,34,28,16,2,0,9,0,127,27,1
4492,70271,ZhYYSrMQcxjzRT3UKJSOuTE3HPAvHZFo,3VkHkmOtom3jM2wCu94xgzzu1d6Dn7or,3,5,0,0,0,0,1,0,6,0.8571428571428571,1,0.0,0,0,0,0,5,0,0,1,0,0,6,1
4493,70278,lcZqIkYpGjtScNDLdtqKt3haLc6LMQSH,3VkHkmOtom3jM2wCu94xgzzu1d6Dn7or,13,19,5,0,4,0,2,0,30,4.285714285714286,1,0.0,0,5,0,4,19,0,0,2,0,9,21,0
4494,70281,7wdA0s42aT5UZB7EhROFGpGYTrXW9coN,3VkHkmOtom3jM2wCu94xgzzu1d6Dn7or,3,2,0,0,0,0,1,0,3,0.42857142857142855,1,0.0,0,0,0,0,2,0,0,1,0,0,3,1
4495,70282,P6Fd1IQp59pN6lTEXXlgnsX26ikebpg7,3VkHkmOtom3jM2wCu94xgzzu1d6Dn7or,54,82,42,0,42,0,14,0,180,25.714285714285715,2,0.0,10,42,0,42,72,0,0,14,0,94,86,1
4496,70288,0OQWZBG0W4kepi8nreWMZMMypwSc3KLe,3VkHkmOtom3jM2wCu94xgzzu1d6Dn7or,92,241,108,82,65,94,88,15,693,99.0,18,0.0,79,108,75,65,162,94,7,88,15,327,366,0
4497,70291,Kw3ipO3nkJ2O6MLvUuTDqCLl9j8eQ8eR,3VkHkmOtom3jM2wCu94xgzzu1d6Dn7or,61,137,64,36,0,10,47,1,295,42.142857142857146,10,0.0,45,64,35,0,92,10,1,47,1,144,151,1
4498,70296,MfUQhvI4WmU09qeX5p4ZVxtPSEfQQU3k,3VkHkmOtom3jM2wCu94xgzzu1d6Dn7or,5,2,1,0,1,0,2,0,6,0.8571428571428571,1,0.0,0,1,0,1,2,0,0,2,0,2,4,1
4499,70300,oRJWav0i1xSVu6EZJhTpjUgFr01mfw6c,3VkHkmOtom3jM2wCu94xgzzu1d6Dn7or,7,4,3,0,3,0,3,0,13,1.8571428571428572,2,0.0,0,3,0,3,4,0,0,3,0,6,7,0
4500,70302,vBXqxoWJohV9Wf8XlmfMorfJ7u2A3yGp,3VkHkmOtom3jM2wCu94xgzzu1d6Dn7or,1,0,0,0,0,0,1,0,1,0.14285714285714285,1,0.0,0,0,0,0,0,0,0,1,0,0,1,1
4501,70303,mbCXC3WNWeKxT2srxS0yuaJqyTswmXfo,3VkHkmOtom3jM2wCu94xgzzu1d6Dn7or,28,64,11,20,27,1,4,0,127,18.142857142857142,2,0.0,49,11,18,27,15,1,2,4,0,105,22,1
4502,70309,YaCnDWGCLNcR2DnaQ9u9p8sw7fKEiin2,3VkHkmOtom3jM2wCu94xgzzu1d6Dn7or,5,4,1,0,2,0,2,0,9,1.2857142857142858,1,0.0,2,1,0,2,2,0,0,2,0,5,4,1
4503,70310,KUpvOHsEawSobVanRDD5FA8fMCzoOPMN,3VkHkmOtom3jM2wCu94xgzzu1d6Dn7or,23,43,18,10,16,8,27,1,123,17.571428571428573,2,0.0,22,18,9,16,21,8,1,27,1,65,58,1
4504,70312,6VQ3sGdZ7IDi0XSXtc9z65tW3KI3pMqL,3VkHkmOtom3jM2wCu94xgzzu1d6Dn7or,27,71,15,39,16,25,2,0,168,24.0,2,0.0,32,15,37,16,39,25,2,2,0,100,68,1
4505,70315,ryiQeDye7Wz8n7Dvct1bgEdO7KJyfUCE,3VkHkmOtom3jM2wCu94xgzzu1d6Dn7or,1,0,0,0,0,0,1,0,1,0.14285714285714285,1,0.0,0,0,0,0,0,0,0,1,0,0,1,1
4506,70316,zix9SUJrsLq90i4v6qVnrCaX7daB40Kq,3VkHkmOtom3jM2wCu94xgzzu1d6Dn7or,6,2,1,0,1,12,4,0,20,2.857142857142857,1,0.0,0,1,0,1,2,12,0,4,0,2,18,1
4507,70320,5hHsKD7Y4qwCFGPWR0Qrgi4COj92slri,3VkHkmOtom3jM2wCu94xgzzu1d6Dn7or,4,5,1,0,2,0,1,0,9,1.2857142857142858,1,0.0,3,1,0,2,2,0,0,1,0,6,3,1
4508,70322,HLZWnEeT0vXMhJ5Y39hdve4GY4PxY7G4,3VkHkmOtom3jM2wCu94xgzzu1d6Dn7or,4,4,1,0,2,0,1,0,8,1.1428571428571428,1,0.0,2,1,0,2,2,0,0,1,0,5,3,0
4509,70324,m0ftathRLrGnJCnhmZSV8vDms8QzsQ7P,3VkHkmOtom3jM2wCu94xgzzu1d6Dn7or,58,44,2,73,18,0,3,0,140,20.0,2,0.0,21,2,55,18,23,0,18,3,0,96,44,0
4510,70327,psO6n0Pn0k59iFDyVR97ioYoWwNZ7QsM,3VkHkmOtom3jM2wCu94xgzzu1d6Dn7or,6,3,2,0,2,0,1,0,8,1.1428571428571428,1,0.0,0,2,0,2,3,0,0,1,0,4,4,1
4511,70328,3EzbgHWZ0FxtHgHATDhP7VMkxOCnEE8q,3VkHkmOtom3jM2wCu94xgzzu1d6Dn7or,13,41,25,0,15,0,7,0,88,12.571428571428571,6,0.0,0,25,0,15,41,0,0,7,0,40,48,0
4512,70331,g3G5U2ecjp6P7h6ZZOeiyZmcR6BGiVtX,3VkHkmOtom3jM2wCu94xgzzu1d6Dn7or,1,0,0,0,0,0,1,0,1,0.14285714285714285,1,0.0,0,0,0,0,0,0,0,1,0,0,1,1
4513,70332,hTLHk1bFczWfAXr9QMndt4A9GjkUvCZJ,3VkHkmOtom3jM2wCu94xgzzu1d6Dn7or,1,0,0,0,0,0,1,0,1,0.14285714285714285,1,0.0,0,0,0,0,0,0,0,1,0,0,1,1
4514,70334,bmxQ66AsItv9EBQTswW4vQGNA82BElw3,3VkHkmOtom3jM2wCu94xgzzu1d6Dn7or,19,55,18,0,9,12,19,3,116,16.571428571428573,3,0.0,0,18,0,9,55,12,0,19,3,27,89,1
4515,70336,VKDNE86ItuOpp2oVHDMGR3EPQG95zuXs,3VkHkmOtom3jM2wCu94xgzzu1d6Dn7or,14,33,8,4,4,3,10,2,64,9.142857142857142,3,0.0,13,8,4,4,20,3,0,10,2,29,35,1
4516,70339,1LwHP3062AHKmQwDl3FPlP3B3adaBvx7,3VkHkmOtom3jM2wCu94xgzzu1d6Dn7or,4,7,2,0,3,0,3,0,15,2.142857142857143,3,0.0,3,2,0,3,4,0,0,3,0,8,7,1
4517,70341,ZHPpfCRpNebZJ1nTVopN0Pp2GHKAIGhu,3VkHkmOtom3jM2wCu94xgzzu1d6Dn7or,5,2,1,0,1,0,2,0,6,0.8571428571428571,1,0.0,0,1,0,1,2,0,0,2,0,2,4,1
4518,70342,XpxUE9h3D6JhhexHlslc4WxiJHl4lcVq,3VkHkmOtom3jM2wCu94xgzzu1d6Dn7or,40,52,26,0,18,0,9,0,105,15.0,4,0.0,0,26,0,18,52,0,0,9,0,44,61,1
4519,70348,yrqzO8RwLO4nzk1s3CGqdHrreQE8SqwS,3VkHkmOtom3jM2wCu94xgzzu1d6Dn7or,4,2,1,0,1,0,1,0,5,0.7142857142857143,1,0.0,0,1,0,1,2,0,0,1,0,2,3,1
4520,70355,DrwF2jyRuqsM9TWUaALjnxgaploRRL1G,3VkHkmOtom3jM2wCu94xgzzu1d6Dn7or,4,2,1,0,1,0,1,0,5,0.7142857142857143,1,0.0,0,1,0,1,2,0,0,1,0,2,3,1
4521,70357,A0CAGUq6HZAffziWV2GV4z0WUWMbjcLr,3VkHkmOtom3jM2wCu94xgzzu1d6Dn7or,15,10,1,9,5,3,15,0,43,6.142857142857143,1,0.0,5,1,8,5,5,3,1,15,0,19,24,1
4522,70359,AXWWqNDiRDejTjo5V7yUaMbjtzXKhlP0,3VkHkmOtom3jM2wCu94xgzzu1d6Dn7or,66,161,63,34,44,17,37,3,359,51.285714285714285,8,0.0,53,63,32,44,108,17,2,37,3,192,167,0
4523,70368,4AzWdcwb3SG5chIViRUSkI6mbhUE2J75,fbPkOYLVPtPgIt0MxizjfFJov3JbHyAi,9,6,5,0,4,0,1,0,16,2.2857142857142856,1,0.0,0,5,0,4,6,0,0,1,0,9,7,1
4524,70376,61PsrnqGMh19xjWowe2Lz8ELqYCTUUqE,fbPkOYLVPtPgIt0MxizjfFJov3JbHyAi,21,44,17,15,1,10,12,0,99,14.142857142857142,4,0.0,10,17,15,1,34,10,0,12,0,43,56,0
4525,70412,HJDBhocphGBunDu6wRNi5xUX9mlf7tO8,fbPkOYLVPtPgIt0MxizjfFJov3JbHyAi,20,28,8,35,11,0,2,0,84,12.0,1,0.0,16,8,31,11,12,0,4,2,0,66,18,1
4526,70441,a4heGNfxWtaNpzRnv4l5t37neKjFR36r,fbPkOYLVPtPgIt0MxizjfFJov3JbHyAi,8,10,8,0,6,0,4,0,28,4.0,1,0.0,0,8,0,6,10,0,0,4,0,14,14,1
4527,70495,STkYkZEAJSwprBqpDKOiSfNJUIRyo0Bq,fbPkOYLVPtPgIt0MxizjfFJov3JbHyAi,9,9,6,0,3,0,2,0,20,2.857142857142857,2,0.0,0,6,0,3,9,0,0,2,0,9,11,0
4528,70504,hx5sJ7jwWSrYbv8AAwrwIYlkyA5lh0xw,fbPkOYLVPtPgIt0MxizjfFJov3JbHyAi,6,8,0,0,0,0,2,0,10,1.4285714285714286,1,0.0,0,0,0,0,8,0,0,2,0,0,10,1
4529,70627,VJsbRtMXxy8aqyccEZDzV7pPAGBosBu1,fbPkOYLVPtPgIt0MxizjfFJov3JbHyAi,21,18,11,11,8,0,2,0,50,7.142857142857143,1,0.0,5,11,9,8,13,0,2,2,0,33,17,0
4530,70641,2uadn8x6eG3s1sEJofJgCr35bh3OHGLh,fbPkOYLVPtPgIt0MxizjfFJov3JbHyAi,10,9,5,0,2,0,2,0,18,2.5714285714285716,1,0.0,2,5,0,2,7,0,0,2,0,9,9,1
4531,70651,zPbUIdTRPjnN9GVjy7Vs8SVwjdhRAaUM,fbPkOYLVPtPgIt0MxizjfFJov3JbHyAi,8,10,0,0,0,0,3,0,13,1.8571428571428572,1,0.0,3,0,0,0,7,0,0,3,0,3,10,1
4532,70677,zmlL73g2U1Ek37ZDQ2H6P7dwK1MBsxuX,fbPkOYLVPtPgIt0MxizjfFJov3JbHyAi,4,2,1,0,0,0,3,0,6,0.8571428571428571,1,0.0,0,1,0,0,2,0,0,3,0,1,5,1
4533,70831,o5TpAjMe8TM6a528HMcKqr5zZTFMsmaP,fbPkOYLVPtPgIt0MxizjfFJov3JbHyAi,1,0,0,0,0,0,1,0,1,0.14285714285714285,1,0.0,0,0,0,0,0,0,0,1,0,0,1,1
4534,70861,6IJVUSEMpeG6F6UAW6d6aBbrEWsQ8azq,fbPkOYLVPtPgIt0MxizjfFJov3JbHyAi,11,11,7,0,5,0,3,0,26,3.7142857142857144,1,0.0,0,7,0,5,11,0,0,3,0,12,14,1
4535,70908,B6p5x6qI5IapFaeXO9jhM5m7rqDF4l8p,SpATywNh6bZuzm8s1ceuBUnMUAeoAHHw,18,28,13,13,7,0,4,0,65,9.285714285714286,2,0.0,2,13,10,7,26,0,3,4,0,32,33,0
4536,70964,AtOHbVb7kxzZIoD2M5RWKjBCYCoDUPL6,SpATywNh6bZuzm8s1ceuBUnMUAeoAHHw,13,16,5,14,0,0,4,0,39,5.571428571428571,1,0.0,8,5,11,0,8,0,3,4,0,24,15,0
4537,70965,1NDrkg6Fm6LSwpX18XkWoeP8L4g5eTy0,5X6FeZozNMgE2VRi3MJYjkkFK8SETtu2,23,47,22,39,27,0,4,0,139,19.857142857142858,2,0.0,19,22,31,27,28,0,8,4,0,99,40,1
4538,70969,Ooaq1toVrKJC9KROMnT52Id1rqx2sDam,A3fsA9Zfv1X2fVEQhTw51lKENdNrEqT3,25,11,4,82,0,2,4,0,103,14.714285714285714,2,0.0,1,4,67,0,10,2,15,4,0,72,31,0
4539,71004,Sk4DUKJRImF6lijTnkABuH01jDj9zcnP,5X6FeZozNMgE2VRi3MJYjkkFK8SETtu2,1,0,0,0,0,0,1,0,1,0.14285714285714285,1,0.0,0,0,0,0,0,0,0,1,0,0,1,1
4540,71114,Pb8bKUVAg7ulAlD1hKSRovFicuM9wDrS,5X6FeZozNMgE2VRi3MJYjkkFK8SETtu2,9,4,3,0,3,0,4,1,15,2.142857142857143,1,0.0,0,3,0,3,4,0,0,4,1,6,9,1
4541,71159,yG8wEEmCuC5YTy4CQDGA5I639Z9JzSu0,5X6FeZozNMgE2VRi3MJYjkkFK8SETtu2,5,3,1,0,1,0,2,0,7,1.0,2,0.0,0,1,0,1,3,0,0,2,0,2,5,1
4542,71171,PpZEAa1Mdati01h1lf363alLOjmVtvBB,5X6FeZozNMgE2VRi3MJYjkkFK8SETtu2,5,2,1,0,1,0,2,0,6,0.8571428571428571,1,0.0,0,1,0,1,2,0,0,2,0,2,4,1
4543,71174,axaScF3P7Dmq9RVjqcR7oOXvuGJjIWKx,SpATywNh6bZuzm8s1ceuBUnMUAeoAHHw,19,26,1,5,1,0,5,0,38,5.428571428571429,3,0.0,0,1,5,1,26,0,0,5,0,7,31,0
4544,71183,v6Wfy2XnikKgnCNfehO3TIQzyPp7MzcN,RXDvfPUBYFlVdlueBFbLW0mhhAyGEqpt,1,0,0,0,0,0,1,0,1,0.14285714285714285,1,0.0,0,0,0,0,0,0,0,1,0,0,1,1
4545,71272,CeGIsWlT0KBVS1hQGCUY2KCY4J9xzr3t,SpATywNh6bZuzm8s1ceuBUnMUAeoAHHw,19,19,15,12,7,0,3,0,56,8.0,1,0.0,2,15,11,7,17,0,1,3,0,35,21,1
4546,71567,9gXVEZEqUIEtX73kugMCi6mJh0HupPfO,5X6FeZozNMgE2VRi3MJYjkkFK8SETtu2,2,0,0,0,0,0,2,0,2,0.2857142857142857,1,0.0,0,0,0,0,0,0,0,2,0,0,2,1
4547,71669,k3kcaBPxWWgmPtwRAgC17pKIVVmpYDWX,5X6FeZozNMgE2VRi3MJYjkkFK8SETtu2,1,0,0,0,0,0,1,0,1,0.14285714285714285,1,0.0,0,0,0,0,0,0,0,1,0,0,1,1
4548,71768,gGSMkNgPdXpBQgdZzyjzifomyCxFSNyt,5X6FeZozNMgE2VRi3MJYjkkFK8SETtu2,6,3,1,0,1,0,2,0,7,1.0,1,0.0,0,1,0,1,3,0,0,2,0,2,5,0
4549,71842,ErXNe7efkRl64E8pJRc91VCcYddra1a4,SpATywNh6bZuzm8s1ceuBUnMUAeoAHHw,11,10,4,7,1,5,3,0,30,4.285714285714286,1,0.0,5,4,7,1,5,5,0,3,0,17,13,0
4550,71854,It5GZoF42fMzBpqBoHOwTBOzCr0aB6Mf,SpATywNh6bZuzm8s1ceuBUnMUAeoAHHw,45,43,19,21,11,4,8,1,107,15.285714285714286,1,0.0,8,19,19,11,35,4,2,8,1,57,50,0
4551,71888,sr89KLsFZj5opXIwIPCyClXHTk70EGW9,SpATywNh6bZuzm8s1ceuBUnMUAeoAHHw,8,7,4,0,2,0,1,0,14,2.0,1,0.0,2,4,0,2,5,0,0,1,0,8,6,1
4552,71935,Cg7iNBAj8Tw36V9R4YA417eEEGy00kAz,SpATywNh6bZuzm8s1ceuBUnMUAeoAHHw,7,5,2,17,0,0,1,0,25,3.5714285714285716,1,0.0,2,2,16,0,3,0,1,1,0,20,5,0
4553,71947,HSj7vOMOwXAAtHMXn91NInlCIdQuHAYQ,5X6FeZozNMgE2VRi3MJYjkkFK8SETtu2,7,7,2,0,3,0,2,0,14,2.0,2,0.0,1,2,0,3,6,0,0,2,0,6,8,1
4554,71949,ap47j49GydESvLtt85D5zvr7ZznC8gTV,RXDvfPUBYFlVdlueBFbLW0mhhAyGEqpt,36,41,18,53,16,1,19,3,151,21.571428571428573,1,0.0,3,18,46,16,38,1,7,19,3,83,68,0
4555,71970,51xlIGXGRsE7YMneHTw1mXYuaEFgELF3,A3fsA9Zfv1X2fVEQhTw51lKENdNrEqT3,15,12,9,0,5,0,3,0,29,4.142857142857143,1,0.0,0,9,0,5,12,0,0,3,0,14,15,0
4556,72110,UuK4SgZkmPrFxeH0ZPCRQ63pVXUSe96N,5X6FeZozNMgE2VRi3MJYjkkFK8SETtu2,1,0,0,0,0,0,1,0,1,0.14285714285714285,1,0.0,0,0,0,0,0,0,0,1,0,0,1,1
4557,72179,oJ9j9ejTgKixczg3tSE8Sg8DPI7YQpJq,5X6FeZozNMgE2VRi3MJYjkkFK8SETtu2,6,5,4,0,0,0,1,0,10,1.4285714285714286,1,0.0,0,4,0,0,5,0,0,1,0,4,6,1
4558,72186,hm5fInUESikvdLXUApWeBZ8sQediiiZi,5X6FeZozNMgE2VRi3MJYjkkFK8SETtu2,1,0,0,0,0,0,1,0,1,0.14285714285714285,1,0.0,0,0,0,0,0,0,0,1,0,0,1,1
4559,72195,2XrVfo49pLwaH12euHkVNsz60Xa54j5d,SpATywNh6bZuzm8s1ceuBUnMUAeoAHHw,1,0,0,0,0,0,2,0,2,0.2857142857142857,1,0.0,0,0,0,0,0,0,0,2,0,0,2,1
4560,72196,uiC9EHMxnf2w4h6Qgd2IixJ8SdchRJcU,5X6FeZozNMgE2VRi3MJYjkkFK8SETtu2,1,0,0,0,0,0,2,0,2,0.2857142857142857,2,0.0,0,0,0,0,0,0,0,2,0,0,2,1
4561,72206,2t2mFcXnjCSGOBpya1wSPFZtPiud9I2F,SpATywNh6bZuzm8s1ceuBUnMUAeoAHHw,13,14,0,5,0,0,4,0,23,3.2857142857142856,1,0.0,4,0,5,0,10,0,0,4,0,9,14,0
4562,72250,SozblGZP0jqptTVCGb8oKsTCWZZGfIvg,SpATywNh6bZuzm8s1ceuBUnMUAeoAHHw,23,32,0,25,0,74,14,0,145,20.714285714285715,3,0.0,7,0,21,0,25,74,4,14,0,28,117,0
4563,72357,CRIxBWowFPqH4PKg7CVbbYai7181zWdg,5X6FeZozNMgE2VRi3MJYjkkFK8SETtu2,17,22,6,19,12,0,5,0,64,9.142857142857142,2,0.0,14,6,18,12,8,0,1,5,0,50,14,0
4564,72370,WI9rk8aS11tBAJzjcX0JSIgomYYRQVjW,SpATywNh6bZuzm8s1ceuBUnMUAeoAHHw,18,25,4,0,3,0,5,0,37,5.285714285714286,3,0.0,0,4,0,3,25,0,0,5,0,7,30,0
4565,72375,jpXIq3stqWScWG27acYJbNKpdTmc6kli,bWdj2GDclj5ofokWjzoa5jAwMkxCykd6,3,2,1,0,0,0,1,0,4,0.5714285714285714,1,0.0,0,1,0,0,2,0,0,1,0,1,3,0
4566,72426,B9BCqbSn4dXX7PoOMPBly9mxS1ETXKHH,SpATywNh6bZuzm8s1ceuBUnMUAeoAHHw,14,29,12,12,6,1,3,0,63,9.0,3,0.0,14,12,12,6,15,1,0,3,0,44,19,1
4567,72451,9FaPBbsYKn0C9myyRYf9vYNhns2eJDpD,bWdj2GDclj5ofokWjzoa5jAwMkxCykd6,3,2,1,0,0,0,2,0,5,0.7142857142857143,1,0.0,0,1,0,0,2,0,0,2,0,1,4,0
4568,72465,ypoGZw2r9uT31DVWRK8Ak5IwBPQDf2ZW,A3fsA9Zfv1X2fVEQhTw51lKENdNrEqT3,1,0,0,0,0,0,1,0,1,0.14285714285714285,1,0.0,0,0,0,0,0,0,0,1,0,0,1,1
4569,72468,clbUGnOQsN7CuaV7idGJ2LVbYN3t8qC3,bWdj2GDclj5ofokWjzoa5jAwMkxCykd6,14,12,0,10,0,2,7,1,32,4.571428571428571,1,0.0,2,0,9,0,10,2,1,7,1,11,21,0
4570,72485,H1nbdkC904EOh8jWeVVcV5piaqMVBsli,RXDvfPUBYFlVdlueBFbLW0mhhAyGEqpt,4,2,0,0,0,0,3,0,5,0.7142857142857143,1,0.0,0,0,0,0,2,0,0,3,0,0,5,0
4571,72523,bBon9Fz54W0VEKu51qXuvXYwLHShFyI1,SpATywNh6bZuzm8s1ceuBUnMUAeoAHHw,9,14,9,0,0,1,6,1,31,4.428571428571429,1,0.0,2,9,0,0,12,1,0,6,1,11,20,1
4572,72532,QPoypIc1fBONo2zEXZGrqFPP68plPMOG,A3fsA9Zfv1X2fVEQhTw51lKENdNrEqT3,15,8,1,32,0,0,3,0,44,6.285714285714286,2,0.0,0,1,26,0,8,0,6,3,0,27,17,0
4573,72540,3RFxfyZdyTuIPVV58WHND3p7FoSeVnvd,G8EPVSXsOYB5YQWZGiz1aVq5Pgr2GrQu,18,25,16,0,7,0,5,0,53,7.571428571428571,3,0.0,0,16,0,7,25,0,0,5,0,23,30,1
4574,72588,5fUv2a4WMEi2Bc60cQo0Uzo1I7SufPfI,SpATywNh6bZuzm8s1ceuBUnMUAeoAHHw,28,32,2,25,1,4,8,1,73,10.428571428571429,3,0.0,11,2,21,1,21,4,4,8,1,35,38,0
4575,72596,rPY59o3LLmGBPTPMGcA5vX57KVfmywv5,5X6FeZozNMgE2VRi3MJYjkkFK8SETtu2,1,0,0,0,0,0,1,0,1,0.14285714285714285,1,0.0,0,0,0,0,0,0,0,1,0,0,1,1
4576,72628,NKFAtRqaabgEQPy42hYUIZ9UDec46naf,5X6FeZozNMgE2VRi3MJYjkkFK8SETtu2,15,39,3,23,11,6,4,0,86,12.285714285714286,4,0.0,22,3,21,11,17,6,2,4,0,57,29,1
4577,72636,xOB7vl3l1Tpb0i0cSWni40BfJ5FBclms,bWdj2GDclj5ofokWjzoa5jAwMkxCykd6,1,0,0,0,0,0,1,0,1,0.14285714285714285,1,0.0,0,0,0,0,0,0,0,1,0,0,1,1
4578,72692,H2pnCC5fUi5Ho09aPqAE97vnlsM8FGBU,A3fsA9Zfv1X2fVEQhTw51lKENdNrEqT3,44,8,5,168,0,0,2,0,183,26.142857142857142,1,0.0,2,5,167,0,6,0,1,2,0,174,9,0
4579,72714,FsRtG9gDIPReRoDWnJ4MFLGSrRsEmLDJ,5X6FeZozNMgE2VRi3MJYjkkFK8SETtu2,14,9,4,14,2,3,7,2,41,5.857142857142857,2,0.0,3,4,12,2,6,3,2,7,2,21,20,1
4580,72716,0VjAWG5aLQgXyXeTqTPnha195szz41mH,RXDvfPUBYFlVdlueBFbLW0mhhAyGEqpt,5,5,4,4,0,0,1,0,14,2.0,1,0.0,0,4,4,0,5,0,0,1,0,8,6,1
4581,72717,GWNKqanO7Bwv22F8soWqeHa4Wn2DiLGZ,5X6FeZozNMgE2VRi3MJYjkkFK8SETtu2,10,12,2,10,3,0,1,0,28,4.0,1,0.0,5,2,10,3,7,0,0,1,0,20,8,1
4582,72721,1UwRwlLE0RwxPaY5NbrfjlESNYQllZZa,A3fsA9Zfv1X2fVEQhTw51lKENdNrEqT3,5,8,0,0,0,9,2,0,19,2.7142857142857144,1,0.0,0,0,0,0,8,9,0,2,0,0,19,0
4583,72726,0bJvCDj0GgBeU0HMz26Zp0pAIP7Ku0m6,G8EPVSXsOYB5YQWZGiz1aVq5Pgr2GrQu,11,7,5,0,4,0,1,0,17,2.4285714285714284,1,0.0,1,5,0,4,6,0,0,1,0,10,7,0
4584,72850,QqE2Xjwy9gUzOvFdkDqAwAaNZLBZkxvd,G8EPVSXsOYB5YQWZGiz1aVq5Pgr2GrQu,1,0,0,0,0,0,1,0,1,0.14285714285714285,1,0.0,0,0,0,0,0,0,0,1,0,0,1,1
4585,72885,czhzfQM5hzKsjmfr33GA4a86kqhVxJHf,A3fsA9Zfv1X2fVEQhTw51lKENdNrEqT3,1,0,0,0,0,0,1,0,1,0.14285714285714285,1,0.0,0,0,0,0,0,0,0,1,0,0,1,1
4586,72923,bK25MCIg6ikdYLUuBMScg0aIrIK7DQNQ,5X6FeZozNMgE2VRi3MJYjkkFK8SETtu2,1,0,0,0,0,0,1,0,1,0.14285714285714285,1,0.0,0,0,0,0,0,0,0,1,0,0,1,1
4587,72942,PwGj8ON4yrWpMaoZE0ES8sG2eAqFQNfN,5X6FeZozNMgE2VRi3MJYjkkFK8SETtu2,6,3,2,0,2,0,2,0,9,1.2857142857142858,2,0.0,0,2,0,2,3,0,0,2,0,4,5,1
4588,72951,Ou3iHiBDr7O5XF3iHhMwgAvySH9eHz42,RXDvfPUBYFlVdlueBFbLW0mhhAyGEqpt,35,55,2,108,5,4,10,0,184,26.285714285714285,2,0.0,23,2,99,5,32,4,9,10,0,129,55,1
4589,72964,rN6lunIjAbCWqlUClfGlFjDjxcPvXSQ8,G8EPVSXsOYB5YQWZGiz1aVq5Pgr2GrQu,2,0,0,0,0,0,2,0,2,0.2857142857142857,1,0.0,0,0,0,0,0,0,0,2,0,0,2,1
4590,73009,l569pvTkqA1hwU8mlPA8zjV2SyK4a7w2,SpATywNh6bZuzm8s1ceuBUnMUAeoAHHw,12,20,0,0,0,0,2,0,22,3.142857142857143,2,0.0,0,0,0,0,20,0,0,2,0,0,22,0
4591,73106,OWturuXXamL4qdRmyvXAQUfG96tebkB5,5X6FeZozNMgE2VRi3MJYjkkFK8SETtu2,1,0,0,0,0,0,2,0,2,0.2857142857142857,1,0.0,0,0,0,0,0,0,0,2,0,0,2,1
4592,73113,Liq3zOCCoZeQzrp7SiKverX8kFDQZENr,5X6FeZozNMgE2VRi3MJYjkkFK8SETtu2,5,2,1,0,1,0,6,0,10,1.4285714285714286,1,0.0,0,1,0,1,2,0,0,6,0,2,8,1
4593,73197,Lm6J3qI5iNdtiMvPAGBW8hmcUCVUqmON,3VkHkmOtom3jM2wCu94xgzzu1d6Dn7or,11,11,7,0,5,0,3,0,26,3.7142857142857144,3,0.0,0,7,0,5,11,0,0,3,0,12,14,1
4594,73200,KbVIZwe7S3MOh9dlFVWDZwSpf3zNL2tv,3VkHkmOtom3jM2wCu94xgzzu1d6Dn7or,1,0,0,0,0,0,3,0,3,0.42857142857142855,2,0.0,0,0,0,0,0,0,0,3,0,0,3,1
4595,73208,S5JEpWHgN20ET81VeLmsjVq6FkZoKJg6,3VkHkmOtom3jM2wCu94xgzzu1d6Dn7or,1,0,0,0,0,0,1,0,1,0.14285714285714285,1,0.0,0,0,0,0,0,0,0,1,0,0,1,1
4596,73209,b9118bQqxgqIy1PGFhvP98mfMsVg8dff,3VkHkmOtom3jM2wCu94xgzzu1d6Dn7or,10,8,6,0,4,0,5,0,23,3.2857142857142856,2,0.0,0,6,0,4,8,0,0,5,0,10,13,1
4597,73217,2we3WxltFBT1dd0FjP3YZ8iHf2xpHEei,3VkHkmOtom3jM2wCu94xgzzu1d6Dn7or,87,205,77,31,57,8,24,2,404,57.714285714285715,18,0.0,61,77,29,57,144,8,2,24,2,224,180,0
4598,73220,6S42i3UQWxx5Vy8tElcT4nwPzZzrdR85,3VkHkmOtom3jM2wCu94xgzzu1d6Dn7or,33,101,28,28,16,44,28,0,245,35.0,8,0.0,29,28,23,16,72,44,5,28,0,96,149,1
4599,73221,PKGM0PZA2Jkm4eJkhnQK54JbcGNphgCu,3VkHkmOtom3jM2wCu94xgzzu1d6Dn7or,15,29,6,20,11,0,6,0,72,10.285714285714286,3,0.0,20,6,18,11,9,0,2,6,0,55,17,1
4600,73222,D0RJX8LWpSJiOYT59P1X3r8qNhJsdkkW,3VkHkmOtom3jM2wCu94xgzzu1d6Dn7or,8,11,1,0,3,0,8,0,23,3.2857142857142856,3,0.0,7,1,0,3,4,0,0,8,0,11,12,1
4601,73224,PbtEZmikq1bOEQJ0ub4zxpBJadIsTRw3,3VkHkmOtom3jM2wCu94xgzzu1d6Dn7or,1,0,0,0,0,0,1,0,1,0.14285714285714285,1,0.0,0,0,0,0,0,0,0,1,0,0,1,1
4602,73231,8mJzNtbbhYVCgZPRtpQ3nYyV12q5x7iP,3VkHkmOtom3jM2wCu94xgzzu1d6Dn7or,7,4,2,0,2,0,6,0,14,2.0,1,0.0,0,2,0,2,4,0,0,6,0,4,10,0
4603,73234,nNu7fBxwIxknxpghde4lZ2WkggoZZZqU,3VkHkmOtom3jM2wCu94xgzzu1d6Dn7or,6,5,3,0,1,0,2,0,11,1.5714285714285714,2,0.0,0,3,0,1,5,0,0,2,0,4,7,1
4604,73239,N0De3s0orNACcEd2OVzwpa1d753PsHOL,3VkHkmOtom3jM2wCu94xgzzu1d6Dn7or,5,5,3,0,2,1,2,0,13,1.8571428571428572,2,0.0,0,3,0,2,5,1,0,2,0,5,8,1
4605,73242,xrLVCjvq2WZdMIKT9yLmMgpNoKuooAqk,3VkHkmOtom3jM2wCu94xgzzu1d6Dn7or,4,2,1,0,1,0,1,0,5,0.7142857142857143,1,0.0,0,1,0,1,2,0,0,1,0,2,3,1
4606,73245,FNfRWeqC2pKht5WsSWN1TiZEifuqhSGH,3VkHkmOtom3jM2wCu94xgzzu1d6Dn7or,6,5,3,0,2,0,2,0,12,1.7142857142857142,1,0.0,0,3,0,2,5,0,0,2,0,5,7,1
4607,73251,2Etgf2LdVc2Aplhz3Ti29bA2IzDHwMCl,3VkHkmOtom3jM2wCu94xgzzu1d6Dn7or,7,4,1,0,1,0,9,0,15,2.142857142857143,2,0.0,0,1,0,1,4,0,0,9,0,2,13,1
4608,73253,HB5xN5WvO63fyle8L9OU8KEV5tvW4m0R,3VkHkmOtom3jM2wCu94xgzzu1d6Dn7or,1,0,0,0,0,0,1,0,1,0.14285714285714285,1,0.0,0,0,0,0,0,0,0,1,0,0,1,1
4609,73257,ZMsKvqGPvyoyzO8L6K7CrRjoSN8Ix7BT,3VkHkmOtom3jM2wCu94xgzzu1d6Dn7or,22,65,26,37,0,15,6,9,158,22.571428571428573,5,0.0,29,26,36,0,36,15,1,6,9,91,67,1
4610,73264,lowpjo6E4nS7i7uK8zQgTiMb3jQkTH9B,3VkHkmOtom3jM2wCu94xgzzu1d6Dn7or,31,48,22,17,20,17,8,0,132,18.857142857142858,2,0.0,19,22,17,20,29,17,0,8,0,78,54,1
4611,73272,R4zaFozhL1MuUlv9bsWLOdQlV0cSgMuo,3VkHkmOtom3jM2wCu94xgzzu1d6Dn7or,1,0,0,0,0,0,1,0,1,0.14285714285714285,1,0.0,0,0,0,0,0,0,0,1,0,0,1,1
4612,73274,eM2VlYVwCSxNYbgtqwfFJNqE3ZKGFRHs,3VkHkmOtom3jM2wCu94xgzzu1d6Dn7or,4,2,0,0,1,0,2,0,5,0.7142857142857143,2,0.0,0,0,0,1,2,0,0,2,0,1,4,1
4613,73275,WBWpmfTjwWFYEkWYODOKc6dG21aksLsN,3VkHkmOtom3jM2wCu94xgzzu1d6Dn7or,1,0,0,0,0,0,1,0,1,0.14285714285714285,1,0.0,0,0,0,0,0,0,0,1,0,0,1,1
4614,73286,YNDq95jX1KOzsEMn70Xi3AzeL2bo2v0j,3VkHkmOtom3jM2wCu94xgzzu1d6Dn7or,21,96,45,13,4,20,22,8,208,29.714285714285715,7,0.0,29,45,12,4,67,20,1,22,8,90,118,1
4615,73290,Xc50FKYttTq6KTss24QRE6hOEnatNWn2,3VkHkmOtom3jM2wCu94xgzzu1d6Dn7or,1,0,0,0,0,0,1,0,1,0.14285714285714285,1,0.0,0,0,0,0,0,0,0,1,0,0,1,1
4616,73291,WIgM6nvV9YFBo82xFhtQp6923xmcbs69,3VkHkmOtom3jM2wCu94xgzzu1d6Dn7or,76,388,121,73,64,38,49,4,737,105.28571428571429,16,0.0,140,121,71,64,248,38,2,49,4,396,341,0
4617,73292,ZYuOb7GejOxNmB17SrMGXD1XSycRcwqA,3VkHkmOtom3jM2wCu94xgzzu1d6Dn7or,4,2,1,0,1,0,1,0,5,0.7142857142857143,1,0.0,0,1,0,1,2,0,0,1,0,2,3,1
4618,73305,8HND7pRMGcXENbJtDH640SQuLfMpOGU7,3VkHkmOtom3jM2wCu94xgzzu1d6Dn7or,7,15,4,3,3,9,5,0,39,5.571428571428571,2,0.0,2,4,3,3,13,9,0,5,0,12,27,1
4619,73314,33eeozPiEQNXDhiBOKkMbYxyVM2jD8Xx,3VkHkmOtom3jM2wCu94xgzzu1d6Dn7or,6,5,1,0,1,0,2,0,9,1.2857142857142858,1,0.0,0,1,0,1,5,0,0,2,0,2,7,0
4620,73319,n2r6kyDnsWpbtliBFHcr0YWSTfVt0HhQ,3VkHkmOtom3jM2wCu94xgzzu1d6Dn7or,1,0,0,0,0,0,1,0,1,0.14285714285714285,1,0.0,0,0,0,0,0,0,0,1,0,0,1,1
4621,73323,aw9MeSsEIWZfCoZa5WIkU4GBvdkWhDfh,3VkHkmOtom3jM2wCu94xgzzu1d6Dn7or,11,12,3,2,4,3,6,1,31,4.428571428571429,1,0.0,6,3,2,4,6,3,0,6,1,15,16,1
4622,73326,ew3k1siBazVRlKYAMIZfWGnoLOHfg9SB,3VkHkmOtom3jM2wCu94xgzzu1d6Dn7or,1,0,0,0,0,0,1,0,1,0.14285714285714285,1,0.0,0,0,0,0,0,0,0,1,0,0,1,1
4623,73329,ypKJEOq9RE42Wyx4cHfMNATFPWvLrFfM,3VkHkmOtom3jM2wCu94xgzzu1d6Dn7or,4,3,0,0,2,0,1,0,6,0.8571428571428571,2,0.0,0,0,0,2,3,0,0,1,0,2,4,1
4624,73330,sJThH3sI3ghUBWEkkF5jl318HrGCcG4Q,3VkHkmOtom3jM2wCu94xgzzu1d6Dn7or,1,0,0,0,0,0,1,0,1,0.14285714285714285,1,0.0,0,0,0,0,0,0,0,1,0,0,1,1
4625,73331,d0cUzfZkyBQPnCP3CKMyAuE9ljoEyP7U,3VkHkmOtom3jM2wCu94xgzzu1d6Dn7or,2,0,0,0,0,0,7,0,7,1.0,1,0.0,0,0,0,0,0,0,0,7,0,0,7,1
4626,73336,0nzLNSkxmYEImF1RMACgDuDcQYA8Ty7I,3VkHkmOtom3jM2wCu94xgzzu1d6Dn7or,7,2,1,0,1,0,8,1,13,1.8571428571428572,1,0.0,0,1,0,1,2,0,0,8,1,2,11,0
4627,73338,z4eEpbgnGWvaRZq0NVRTsnBVWbViFEhI,3VkHkmOtom3jM2wCu94xgzzu1d6Dn7or,13,57,16,4,14,8,6,0,105,15.0,2,0.0,32,16,4,14,25,8,0,6,0,66,39,0
4628,73347,H3Qc07G9YgX2wzdRP9apJtdIeiQH3Zm6,3VkHkmOtom3jM2wCu94xgzzu1d6Dn7or,7,3,2,0,2,0,2,0,9,1.2857142857142858,1,0.0,0,2,0,2,3,0,0,2,0,4,5,1
4629,73350,6OFnO0TDkR1wK489Hvzp4brUZCtZaDg6,3VkHkmOtom3jM2wCu94xgzzu1d6Dn7or,6,5,2,0,1,0,2,0,10,1.4285714285714286,1,0.0,1,2,0,1,4,0,0,2,0,4,6,1
4630,73351,OOgcDcjl9MAxdL96TG7mngPkNaGdTZN2,3VkHkmOtom3jM2wCu94xgzzu1d6Dn7or,5,2,1,0,1,0,2,0,6,0.8571428571428571,1,0.0,0,1,0,1,2,0,0,2,0,2,4,1
4631,73365,LQ6QnottBcqSXxkN4WKfnfY5e6SCiNG8,3VkHkmOtom3jM2wCu94xgzzu1d6Dn7or,49,79,36,33,19,60,11,0,238,34.0,3,0.0,24,36,28,19,55,60,5,11,0,107,131,1
4632,73368,CfKWJuXe1mLbJ87shgFKw4nso72JeAvS,3VkHkmOtom3jM2wCu94xgzzu1d6Dn7or,9,9,4,0,1,0,3,0,17,2.4285714285714284,1,0.0,1,4,0,1,8,0,0,3,0,6,11,1
4633,73370,p2EA4v3RuditCgTzshojYPIesin9VTov,3VkHkmOtom3jM2wCu94xgzzu1d6Dn7or,1,0,0,0,0,0,1,0,1,0.14285714285714285,1,0.0,0,0,0,0,0,0,0,1,0,0,1,1
4634,73373,PNltRKReLHuKml6LKXYu0Xf2LLMAke1h,3VkHkmOtom3jM2wCu94xgzzu1d6Dn7or,10,27,3,8,1,5,8,0,52,7.428571428571429,3,0.0,5,3,7,1,22,5,1,8,0,16,36,1
4635,73375,U403WYn6adN6B92pqyV94lVDVY5X6ogV,3VkHkmOtom3jM2wCu94xgzzu1d6Dn7or,6,4,0,0,1,4,4,0,13,1.8571428571428572,2,0.0,0,0,0,1,4,4,0,4,0,1,12,1
4636,73377,2sabJnPZ4PXIGS9Rc16i9z5l9q3qU9rM,3VkHkmOtom3jM2wCu94xgzzu1d6Dn7or,3,1,0,0,0,0,4,0,5,0.7142857142857143,1,0.0,0,0,0,0,1,0,0,4,0,0,5,1
4637,73379,J7W6xcofEG9wJ5LyqIeV5vIUzD2pB5WC,3VkHkmOtom3jM2wCu94xgzzu1d6Dn7or,1,0,0,0,0,0,1,0,1,0.14285714285714285,1,0.0,0,0,0,0,0,0,0,1,0,0,1,1
4638,73381,JBNqk6tHCptThSrUPGNncjudftwyc1Qa,3VkHkmOtom3jM2wCu94xgzzu1d6Dn7or,23,23,9,8,10,7,6,0,63,9.0,1,0.0,12,9,7,10,11,7,1,6,0,38,25,1
4639,73383,UXHhCclAWBH32N4igbYPUq4G6i6kR7iM,3VkHkmOtom3jM2wCu94xgzzu1d6Dn7or,1,0,0,0,0,0,1,0,1,0.14285714285714285,1,0.0,0,0,0,0,0,0,0,1,0,0,1,1
4640,73390,kEwU45XSSuvWpEXuhbk6x6UaLxfQaNpY,3VkHkmOtom3jM2wCu94xgzzu1d6Dn7or,14,41,8,7,16,8,9,0,89,12.714285714285714,1,0.0,30,8,6,16,11,8,1,9,0,60,29,1
4641,73395,jZLnB03LZukvKcwsPqLRnttNusWPzKTZ,3VkHkmOtom3jM2wCu94xgzzu1d6Dn7or,1,0,0,0,0,0,1,0,1,0.14285714285714285,1,0.0,0,0,0,0,0,0,0,1,0,0,1,1
4642,73396,XqsuHAQKifUs35GJxJ1REsoDVf3OuLM6,3VkHkmOtom3jM2wCu94xgzzu1d6Dn7or,8,14,0,0,4,0,1,0,19,2.7142857142857144,1,0.0,3,0,0,4,11,0,0,1,0,7,12,1
4643,73397,POKigF1JShaOhcT7DH0E1Hkp0z55XQt7,3VkHkmOtom3jM2wCu94xgzzu1d6Dn7or,7,3,1,0,1,0,10,1,16,2.2857142857142856,1,0.0,0,1,0,1,3,0,0,10,1,2,14,1
4644,73399,OiuAOUQG29pszkR2iKfcV8sG5Cg92o35,3VkHkmOtom3jM2wCu94xgzzu1d6Dn7or,3,0,0,0,0,0,4,0,4,0.5714285714285714,1,0.0,0,0,0,0,0,0,0,4,0,0,4,1
4645,73402,88eLwCwXXMwwcoLppijnhIqGvr97TfWn,3VkHkmOtom3jM2wCu94xgzzu1d6Dn7or,4,2,1,0,1,0,3,0,7,1.0,1,0.0,0,1,0,1,2,0,0,3,0,2,5,1
4646,73405,hoVo7u7rh07n0uhmHsy18WyqrTVbWA1n,3VkHkmOtom3jM2wCu94xgzzu1d6Dn7or,6,5,3,0,1,2,4,0,15,2.142857142857143,1,0.0,0,3,0,1,5,2,0,4,0,4,11,1
4647,73409,a9zMpUuN718aAcGP1EnMBC7Ro0fc7OKl,3VkHkmOtom3jM2wCu94xgzzu1d6Dn7or,2,0,0,0,0,0,4,0,4,0.5714285714285714,1,0.0,0,0,0,0,0,0,0,4,0,0,4,1
4648,73411,PFDEsyWOjv2IVOUp45n5YkUolkzEQhjf,3VkHkmOtom3jM2wCu94xgzzu1d6Dn7or,11,27,8,2,5,8,11,0,61,8.714285714285714,2,0.0,10,8,2,5,17,8,0,11,0,25,36,1
4649,73414,77F1RO7O8svYgHwWT72gjb22PFV7YHFl,3VkHkmOtom3jM2wCu94xgzzu1d6Dn7or,51,76,43,0,30,0,6,0,155,22.142857142857142,3,0.0,0,43,0,30,76,0,0,6,0,73,82,0
4650,73430,WRFWp197Rw0PrJwMqyaDiKOKO3BhjRAN,3VkHkmOtom3jM2wCu94xgzzu1d6Dn7or,11,27,11,4,7,5,20,2,76,10.857142857142858,3,0.0,9,11,3,7,18,5,1,20,2,30,46,1
4651,73431,G2pgwXLjCYqfE1x9Y8KlRWhczaPYTf1b,3VkHkmOtom3jM2wCu94xgzzu1d6Dn7or,1,0,0,0,0,0,1,0,1,0.14285714285714285,1,0.0,0,0,0,0,0,0,0,1,0,0,1,1
4652,73498,BXEKxoXoxulJe6lVUNmBzkuoxML0RzPQ,fbPkOYLVPtPgIt0MxizjfFJov3JbHyAi,7,3,2,0,2,0,3,0,10,1.4285714285714286,1,0.0,0,2,0,2,3,0,0,3,0,4,6,1
4653,73499,jUIr9wOMURctG2Xi2g3BgjMkOiapnsO1,fbPkOYLVPtPgIt0MxizjfFJov3JbHyAi,28,35,12,23,11,0,4,0,85,12.142857142857142,1,0.0,13,12,19,11,22,0,4,4,0,55,30,0
4654,73500,m7jLYh84m9f53uDPmmpRCKYuGkwpenOB,fbPkOYLVPtPgIt0MxizjfFJov3JbHyAi,4,3,1,0,0,0,2,0,6,0.8571428571428571,1,0.0,0,1,0,0,3,0,0,2,0,1,5,1
4655,73501,s2PAlsYP8d4801r4Nm3R5kEQLZkO3n8P,fbPkOYLVPtPgIt0MxizjfFJov3JbHyAi,7,12,3,0,3,0,9,0,27,3.857142857142857,1,0.0,0,3,0,3,12,0,0,9,0,6,21,1
4656,73503,X4CLNdDMr0iaKybdAdeBwRFlzkg01KOk,fbPkOYLVPtPgIt0MxizjfFJov3JbHyAi,11,13,5,4,4,1,10,1,38,5.428571428571429,2,0.0,5,5,3,4,8,1,1,10,1,17,21,1
4657,73507,DBQ1f2dZLi3kL265Xk9L0uxAjzEo29LF,fbPkOYLVPtPgIt0MxizjfFJov3JbHyAi,7,3,2,0,2,0,2,0,9,1.2857142857142858,1,0.0,0,2,0,2,3,0,0,2,0,4,5,1
4658,73510,nKMPTOF6v1sp7aVmO78zmSRg9f9QXrTf,fbPkOYLVPtPgIt0MxizjfFJov3JbHyAi,7,3,2,0,2,0,2,0,9,1.2857142857142858,1,0.0,0,2,0,2,3,0,0,2,0,4,5,1
4659,73512,EKW68EVipwDnVj4OACaFT183WfWiotRr,fbPkOYLVPtPgIt0MxizjfFJov3JbHyAi,9,22,8,0,9,0,6,0,45,6.428571428571429,2,0.0,8,8,0,9,14,0,0,6,0,25,20,1
4660,73513,vwRRndtOgDNgC1JYZP9PwFq6QjfnEInC,fbPkOYLVPtPgIt0MxizjfFJov3JbHyAi,8,5,4,0,4,2,5,0,20,2.857142857142857,1,0.0,0,4,0,4,5,2,0,5,0,8,12,1
4661,73514,eAreSTsX7Dih2J54vyrFl8ByPnikZNX4,fbPkOYLVPtPgIt0MxizjfFJov3JbHyAi,10,12,7,0,3,28,1,0,51,7.285714285714286,1,0.0,2,7,0,3,10,28,0,1,0,12,39,0
4662,73515,VTfyca7HGDJyi22ZKM6n3Dsdq6SoCZin,fbPkOYLVPtPgIt0MxizjfFJov3JbHyAi,4,2,1,0,0,0,4,0,7,1.0,1,0.0,0,1,0,0,2,0,0,4,0,1,6,1
4663,73517,laUhtb4TTvpYCULEO93ntEWHn8S6WSjL,fbPkOYLVPtPgIt0MxizjfFJov3JbHyAi,2,0,0,0,0,0,5,0,5,0.7142857142857143,1,0.0,0,0,0,0,0,0,0,5,0,0,5,1
4664,73521,tZsZwfZKEwgih9HC8eRqwpFt6sEwssno,fbPkOYLVPtPgIt0MxizjfFJov3JbHyAi,7,9,4,0,3,0,2,0,18,2.5714285714285716,1,0.0,0,4,0,3,9,0,0,2,0,7,11,0
4665,73522,FXBGUXiMXMIDn9Ik7DDYbKq9pN9kTETb,fbPkOYLVPtPgIt0MxizjfFJov3JbHyAi,1,0,0,0,0,0,1,0,1,0.14285714285714285,1,0.0,0,0,0,0,0,0,0,1,0,0,1,1
4666,73523,tL1jjw7cf7YKbbngDtAe9kyoMEQ67AIr,fbPkOYLVPtPgIt0MxizjfFJov3JbHyAi,1,0,0,0,0,0,1,0,1,0.14285714285714285,1,0.0,0,0,0,0,0,0,0,1,0,0,1,1
4667,73524,iZKyUn2tYUQ1sJ0MQmmHDINTc5EMQvaW,fbPkOYLVPtPgIt0MxizjfFJov3JbHyAi,5,3,1,0,1,0,2,0,7,1.0,1,0.0,0,1,0,1,3,0,0,2,0,2,5,1
4668,73527,QWcNKnNsoo8fIdhMS0KLQpCh2c21RSQ4,fbPkOYLVPtPgIt0MxizjfFJov3JbHyAi,7,7,0,6,0,0,3,0,16,2.2857142857142856,1,0.0,1,0,5,0,6,0,1,3,0,6,10,1
4669,73530,v8MmiOrUSSFRN5yML1Gtv18HNGm2mHOy,fbPkOYLVPtPgIt0MxizjfFJov3JbHyAi,6,24,0,0,1,0,5,0,30,4.285714285714286,2,0.0,5,0,0,1,19,0,0,5,0,6,24,1
4670,73531,8FaiBxOZwTPPSCqh3zE727iJIkEkB2sH,fbPkOYLVPtPgIt0MxizjfFJov3JbHyAi,1,0,0,0,0,0,1,0,1,0.14285714285714285,1,0.0,0,0,0,0,0,0,0,1,0,0,1,1
4671,73532,7VsczNppAvXZ8ck0uavEfxlQU3FSAWxI,fbPkOYLVPtPgIt0MxizjfFJov3JbHyAi,10,3,2,0,2,2,8,2,19,2.7142857142857144,1,0.0,0,2,0,2,3,2,0,8,2,4,15,1
4672,73533,8QVzbiM59wokmwQi18hR506gdYJvXMvd,fbPkOYLVPtPgIt0MxizjfFJov3JbHyAi,1,0,0,0,0,0,1,0,1,0.14285714285714285,1,0.0,0,0,0,0,0,0,0,1,0,0,1,1
4673,73534,RrfIBAHL7YP1AFgCuF5PBiTyJdzDN7Zs,fbPkOYLVPtPgIt0MxizjfFJov3JbHyAi,2,0,0,0,0,0,2,0,2,0.2857142857142857,1,0.0,0,0,0,0,0,0,0,2,0,0,2,1
4674,73535,WokDRYxJvEaGKxTY44u78VwJKvy9EFw3,fbPkOYLVPtPgIt0MxizjfFJov3JbHyAi,1,0,0,0,0,0,1,0,1,0.14285714285714285,1,0.0,0,0,0,0,0,0,0,1,0,0,1,1
4675,73537,i4WrJL8oW0eRfAXMn0ZgMZhPoessUNnF,fbPkOYLVPtPgIt0MxizjfFJov3JbHyAi,5,2,1,0,1,0,2,0,6,0.8571428571428571,1,0.0,0,1,0,1,2,0,0,2,0,2,4,1
4676,73538,YbXDR0OWqjazkhydYVY2vq3vuaW6LGOY,fbPkOYLVPtPgIt0MxizjfFJov3JbHyAi,6,6,2,0,2,0,1,0,11,1.5714285714285714,1,0.0,0,2,0,2,6,0,0,1,0,4,7,1
4677,73540,i0UAMwrjj2eXydsjRtQeHBmAMB3Ngwx3,fbPkOYLVPtPgIt0MxizjfFJov3JbHyAi,7,9,3,0,3,0,2,0,17,2.4285714285714284,1,0.0,2,3,0,3,7,0,0,2,0,8,9,1
4678,73541,eVwpauOF6qjJLEmGvNpHpCiI8NiIhc0t,fbPkOYLVPtPgIt0MxizjfFJov3JbHyAi,20,17,11,3,9,53,8,1,102,14.571428571428571,2,0.0,3,11,3,9,14,53,0,8,1,26,76,1
4679,73544,bR1FbD3FkuJiVcTAr5M8EJyKKJMKvGAe,fbPkOYLVPtPgIt0MxizjfFJov3JbHyAi,4,2,1,0,1,0,1,0,5,0.7142857142857143,1,0.0,0,1,0,1,2,0,0,1,0,2,3,1
4680,73547,rpuvJtcoGSYgL65FrFGnvZ4Z1q1X7W9y,fbPkOYLVPtPgIt0MxizjfFJov3JbHyAi,5,2,0,0,0,1,5,1,9,1.2857142857142858,1,0.0,0,0,0,0,2,1,0,5,1,0,9,1
4681,73548,gV4fAWOeRtYhHlLz6So4slTP8BWQUEo3,fbPkOYLVPtPgIt0MxizjfFJov3JbHyAi,7,5,2,0,2,0,2,0,11,1.5714285714285714,1,0.0,0,2,0,2,5,0,0,2,0,4,7,1
4682,73551,tpXvTahACNQY51r2DDxBjRZh56EvpTZe,fbPkOYLVPtPgIt0MxizjfFJov3JbHyAi,8,17,4,0,3,0,4,0,28,4.0,1,0.0,10,4,0,3,7,0,0,4,0,17,11,1
4683,73557,Yzsn36CkmAU2tRNso83yQ89Xcjxcxh0w,3VkHkmOtom3jM2wCu94xgzzu1d6Dn7or,1,0,0,0,0,0,2,0,2,0.2857142857142857,1,0.0,0,0,0,0,0,0,0,2,0,0,2,1
4684,73558,fzGEHOQW3CMmJ4kaYSTYf0w9UbXUQwzz,3VkHkmOtom3jM2wCu94xgzzu1d6Dn7or,6,2,1,0,1,0,5,0,9,1.2857142857142858,1,0.0,0,1,0,1,2,0,0,5,0,2,7,1
4685,73564,YwdsRsHYervYLk48Gr1hWkSfDceYJsi1,3VkHkmOtom3jM2wCu94xgzzu1d6Dn7or,1,0,0,0,0,0,1,0,1,0.14285714285714285,1,0.0,0,0,0,0,0,0,0,1,0,0,1,1
4686,73568,eN3Zet0tDUonovGa1sjqSTY5JzjDSKDq,3VkHkmOtom3jM2wCu94xgzzu1d6Dn7or,1,0,0,0,0,0,2,0,2,0.2857142857142857,1,0.0,0,0,0,0,0,0,0,2,0,0,2,1
4687,73570,QFHxVjsAGU64l3hz86aP74VatqKFjBXV,3VkHkmOtom3jM2wCu94xgzzu1d6Dn7or,1,0,0,0,0,0,1,0,1,0.14285714285714285,1,0.0,0,0,0,0,0,0,0,1,0,0,1,1
4688,73576,DznZsrasCl121bzuiSvVlMZs4RV0IyV5,3VkHkmOtom3jM2wCu94xgzzu1d6Dn7or,7,4,2,0,2,0,3,0,11,1.5714285714285714,2,0.0,1,2,0,2,3,0,0,3,0,5,6,1
4689,73578,ZfbqOFx366o4C78cVKBouX7RxiryNTnP,3VkHkmOtom3jM2wCu94xgzzu1d6Dn7or,6,4,1,0,1,2,3,0,11,1.5714285714285714,1,0.0,1,1,0,1,3,2,0,3,0,3,8,1
4690,73579,S27JhtzYyRNpLDsNSMCoEIRcs2ozc9Ah,3VkHkmOtom3jM2wCu94xgzzu1d6Dn7or,10,11,5,0,4,0,4,0,24,3.4285714285714284,2,0.0,0,5,0,4,11,0,0,4,0,9,15,1
4691,73583,HoSlBbgDrkYdbJ8NcV5YnNuNMzJ22m0Z,3VkHkmOtom3jM2wCu94xgzzu1d6Dn7or,7,2,1,0,1,3,6,0,13,1.8571428571428572,1,0.0,0,1,0,1,2,3,0,6,0,2,11,1
4692,73586,0jTYZbiBUtN5SUb8tVJAxbA0onn41X8V,3VkHkmOtom3jM2wCu94xgzzu1d6Dn7or,36,130,50,34,42,90,22,4,372,53.142857142857146,8,0.0,59,50,29,42,71,90,5,22,4,180,192,1
4693,73587,hvSJqWbsVNQOjwtetsJMg8BhdysZrLgZ,3VkHkmOtom3jM2wCu94xgzzu1d6Dn7or,5,2,1,0,1,0,5,0,9,1.2857142857142858,2,0.0,0,1,0,1,2,0,0,5,0,2,7,1
4694,73591,fqjLnH3OTCihOU2gsb0OSNI1dFNVFkLM,3VkHkmOtom3jM2wCu94xgzzu1d6Dn7or,1,0,0,0,0,0,1,0,1,0.14285714285714285,1,0.0,0,0,0,0,0,0,0,1,0,0,1,1
4695,73593,2kMQkfKYMlhaU4UM5pB8xmNc8uChRuw1,3VkHkmOtom3jM2wCu94xgzzu1d6Dn7or,4,2,1,0,1,0,1,0,5,0.7142857142857143,1,0.0,0,1,0,1,2,0,0,1,0,2,3,1
4696,73595,0UkKiJ9OhWT6zFcmUkOiRpAWLzDgAour,3VkHkmOtom3jM2wCu94xgzzu1d6Dn7or,4,2,1,0,0,0,2,0,5,0.7142857142857143,1,0.0,0,1,0,0,2,0,0,2,0,1,4,1
4697,73597,bAGLARNkQtWbcEXtBHWNuY2QpKiztkKZ,3VkHkmOtom3jM2wCu94xgzzu1d6Dn7or,4,2,0,0,0,0,2,0,4,0.5714285714285714,1,0.0,0,0,0,0,2,0,0,2,0,0,4,1
4698,73600,oASR1hbK6DD6OJfTJCDKLW9l2vPgw7kR,3VkHkmOtom3jM2wCu94xgzzu1d6Dn7or,52,90,42,34,41,4,10,0,221,31.571428571428573,7,0.0,34,42,31,41,56,4,3,10,0,148,73,0
4699,73605,TqVhoyEhTvvU2Hxdt7bwVMSeybZuSUDA,3VkHkmOtom3jM2wCu94xgzzu1d6Dn7or,8,4,1,0,2,0,9,1,17,2.4285714285714284,1,0.0,2,1,0,2,2,0,0,9,1,5,12,1
4700,73607,TRaddyVLpovw0vItvxbFjdLiscv12LDo,3VkHkmOtom3jM2wCu94xgzzu1d6Dn7or,1,0,0,0,0,0,1,0,1,0.14285714285714285,1,0.0,0,0,0,0,0,0,0,1,0,0,1,1
4701,73614,ZOes1wSnhBEEvg5nvcw1hU2VWw7GcGX5,3VkHkmOtom3jM2wCu94xgzzu1d6Dn7or,1,0,0,0,0,0,1,0,1,0.14285714285714285,1,0.0,0,0,0,0,0,0,0,1,0,0,1,1
4702,73624,qxcCVatBg3ma615T1vZP9a3vFceHZOma,3VkHkmOtom3jM2wCu94xgzzu1d6Dn7or,8,6,0,0,2,2,9,1,20,2.857142857142857,1,0.0,2,0,0,2,4,2,0,9,1,4,16,1
4703,73626,levomtYcyu0jXhNQAYAyEq8Zo7sAVLzz,3VkHkmOtom3jM2wCu94xgzzu1d6Dn7or,1,0,0,0,0,0,1,0,1,0.14285714285714285,1,0.0,0,0,0,0,0,0,0,1,0,0,1,1
4704,73627,jllL9C8ZwJmzJRJlHKabdnhUdXuzRtYK,3VkHkmOtom3jM2wCu94xgzzu1d6Dn7or,25,60,28,25,21,13,25,0,172,24.571428571428573,5,0.0,24,28,20,21,36,13,5,25,0,93,79,1
4705,73628,OnRz7QBZqhddyAYZRHKVJ7GgqyS3ZVya,3VkHkmOtom3jM2wCu94xgzzu1d6Dn7or,10,12,4,0,4,10,3,1,34,4.857142857142857,2,0.0,3,4,0,4,9,10,0,3,1,11,23,1
4706,73629,AxjnmzIKgGmkrYUGKQPeh9c8x0m6gyxX,3VkHkmOtom3jM2wCu94xgzzu1d6Dn7or,5,2,1,0,1,0,3,0,7,1.0,1,0.0,0,1,0,1,2,0,0,3,0,2,5,1
4707,73633,gu2GQiSVSAGd0yPDejQCvhAaMLANJqDZ,3VkHkmOtom3jM2wCu94xgzzu1d6Dn7or,4,2,1,0,1,0,1,0,5,0.7142857142857143,1,0.0,0,1,0,1,2,0,0,1,0,2,3,1
4708,73635,tRemMYZPILwjc4AN7PAQTdy7le7m6gBS,3VkHkmOtom3jM2wCu94xgzzu1d6Dn7or,8,6,2,0,2,0,6,1,17,2.4285714285714284,1,0.0,2,2,0,2,4,0,0,6,1,6,11,1
4709,73637,USvxkIKrz0rKsL2Ss0F5K20ol7w9dVqK,3VkHkmOtom3jM2wCu94xgzzu1d6Dn7or,6,4,1,0,2,0,1,0,8,1.1428571428571428,1,0.0,0,1,0,2,4,0,0,1,0,3,5,1
4710,73639,ioGIIvGBcofeTW0x1FXR4tnlONjci6Gc,3VkHkmOtom3jM2wCu94xgzzu1d6Dn7or,56,75,25,55,31,5,11,1,203,29.0,3,0.0,44,25,43,31,31,5,12,11,1,143,60,0
4711,73645,grX5gXClHAQGBsyiB0gWgR5pFtsTwOAy,3VkHkmOtom3jM2wCu94xgzzu1d6Dn7or,11,14,4,7,2,7,14,1,49,7.0,3,0.0,4,4,5,2,10,7,2,14,1,15,34,1
4712,73646,5nRWWgpq05OOATwbRqwqxsA7k9Zu5So4,3VkHkmOtom3jM2wCu94xgzzu1d6Dn7or,10,9,2,0,2,0,10,0,23,3.2857142857142856,5,0.0,0,2,0,2,9,0,0,10,0,4,19,1
4713,73653,OwlSBFN2Y2Jw9zVSj4JyOO1C4mU3Pq74,3VkHkmOtom3jM2wCu94xgzzu1d6Dn7or,1,0,0,0,0,0,2,0,2,0.2857142857142857,1,0.0,0,0,0,0,0,0,0,2,0,0,2,1
4714,73655,GDn0bSNUJ7FW4llVrh1uR3Awm3DznlZj,3VkHkmOtom3jM2wCu94xgzzu1d6Dn7or,8,11,5,0,1,1,6,1,25,3.5714285714285716,1,0.0,3,5,0,1,8,1,0,6,1,9,16,1
4715,73657,oKLMQAZTIOtP37CLM9yXiFLXKHfYljGQ,3VkHkmOtom3jM2wCu94xgzzu1d6Dn7or,4,3,0,0,0,0,2,0,5,0.7142857142857143,1,0.0,0,0,0,0,3,0,0,2,0,0,5,1
4716,73675,3fxWMQqTEtfXx3DdUjBp1Fv5awszMakP,3VkHkmOtom3jM2wCu94xgzzu1d6Dn7or,1,0,0,0,0,0,1,0,1,0.14285714285714285,1,0.0,0,0,0,0,0,0,0,1,0,0,1,1
4717,73680,j1j8kUymAdn1VrqsKmht4D0bf9Tk67Ru,3VkHkmOtom3jM2wCu94xgzzu1d6Dn7or,1,0,0,0,0,0,1,0,1,0.14285714285714285,1,0.0,0,0,0,0,0,0,0,1,0,0,1,1
4718,73683,O5FAv2WJ9y2Iw3ydNqVb8wtG4rpJE8Qp,3VkHkmOtom3jM2wCu94xgzzu1d6Dn7or,7,17,5,0,1,0,10,1,34,4.857142857142857,5,0.0,1,5,0,1,16,0,0,10,1,7,27,1
4719,73688,nX93ZghoVHJD8uU67SJIJwZVR9wM1iWY,3VkHkmOtom3jM2wCu94xgzzu1d6Dn7or,6,2,1,0,1,0,7,0,11,1.5714285714285714,1,0.0,0,1,0,1,2,0,0,7,0,2,9,1
4720,73691,noRaQFZPOfDInGxZhdSk6IgkoFtqEtNn,3VkHkmOtom3jM2wCu94xgzzu1d6Dn7or,52,136,82,84,0,9,28,2,341,48.714285714285715,5,0.0,40,82,81,0,96,9,3,28,2,203,138,1
4721,73697,lVBDM3g8iTGKPEQ3t1UDfl5jfI2Cil4F,3VkHkmOtom3jM2wCu94xgzzu1d6Dn7or,29,106,23,33,35,12,18,0,227,32.42857142857143,4,0.0,71,23,26,35,35,12,7,18,0,155,72,1
4722,73698,UV1snD7DHa55OZjQRgIzYu36CkzlZ6ST,3VkHkmOtom3jM2wCu94xgzzu1d6Dn7or,1,0,0,0,0,0,1,0,1,0.14285714285714285,1,0.0,0,0,0,0,0,0,0,1,0,0,1,1
4723,73705,jaeRBfNSkyTpFxAZieHe5vTAkzlHFDmm,3VkHkmOtom3jM2wCu94xgzzu1d6Dn7or,1,0,0,0,0,0,1,0,1,0.14285714285714285,1,0.0,0,0,0,0,0,0,0,1,0,0,1,1
4724,73706,7BhCQDTKWRWZRyFrvifBoDnXkJRzN5Pt,3VkHkmOtom3jM2wCu94xgzzu1d6Dn7or,9,6,3,0,1,4,8,1,23,3.2857142857142856,3,0.0,0,3,0,1,6,4,0,8,1,4,19,0
4725,73708,SksEDKlyixx27wQZiWmCVYK1viWs7FrA,3VkHkmOtom3jM2wCu94xgzzu1d6Dn7or,9,13,8,0,3,0,6,0,30,4.285714285714286,6,0.0,0,8,0,3,13,0,0,6,0,11,19,0
4726,73714,R2bsNKaCyFNpEJtfIBR7wHhqazhTieVv,3VkHkmOtom3jM2wCu94xgzzu1d6Dn7or,70,104,55,4,43,3,22,2,233,33.285714285714285,13,0.0,9,55,3,43,95,3,1,22,2,110,123,0
4727,73718,XE05vZThEHf17O6FM08AySNf2qZFgNWa,3VkHkmOtom3jM2wCu94xgzzu1d6Dn7or,81,309,24,79,28,2,20,1,463,66.14285714285714,12,0.0,130,24,73,28,179,2,6,20,1,255,208,0
4728,73719,0BKRUeE2TrhxWjSTfZlj7IOKQoZxuJ28,3VkHkmOtom3jM2wCu94xgzzu1d6Dn7or,12,20,5,0,3,5,8,0,41,5.857142857142857,1,0.0,8,5,0,3,12,5,0,8,0,16,25,1
4729,73720,KV4xz4xdX7GojXxeuOHbrKNDm7dYrhhj,3VkHkmOtom3jM2wCu94xgzzu1d6Dn7or,3,0,0,0,0,0,5,0,5,0.7142857142857143,2,0.0,0,0,0,0,0,0,0,5,0,0,5,1
4730,73722,Uf4GWOA8sESCXDRwOHzGljTp0FT7AFg9,3VkHkmOtom3jM2wCu94xgzzu1d6Dn7or,1,0,0,0,0,0,1,0,1,0.14285714285714285,1,0.0,0,0,0,0,0,0,0,1,0,0,1,1
4731,73724,Jz6wD2B02Np9coR4hOXdRVlsstbtLmqi,3VkHkmOtom3jM2wCu94xgzzu1d6Dn7or,1,0,0,0,0,0,1,0,1,0.14285714285714285,1,0.0,0,0,0,0,0,0,0,1,0,0,1,1
4732,73729,ypGCuSMoTu4jFEklb1OmiXvUyZSt3GFy,3VkHkmOtom3jM2wCu94xgzzu1d6Dn7or,10,37,0,1,0,17,8,0,63,9.0,3,0.0,6,0,1,0,31,17,0,8,0,7,56,1
4733,73730,q1QFOwEyQ18luVjxvJy17HxosFEdu2Cn,3VkHkmOtom3jM2wCu94xgzzu1d6Dn7or,57,144,40,69,56,44,2,0,355,50.714285714285715,7,0.0,92,40,64,56,52,44,5,2,0,252,103,0
4734,73731,NeUM2mSh0PreOuQDOFlmpSqC0DHTLWRd,3VkHkmOtom3jM2wCu94xgzzu1d6Dn7or,1,0,0,0,0,0,1,0,1,0.14285714285714285,1,0.0,0,0,0,0,0,0,0,1,0,0,1,1
4735,73732,PtoknOk588UciqjaSaRFarSWUL7CQGqd,3VkHkmOtom3jM2wCu94xgzzu1d6Dn7or,5,4,2,0,2,0,1,0,9,1.2857142857142858,1,0.0,0,2,0,2,4,0,0,1,0,4,5,1
4736,73733,rqqNQl0bghaqvkPV1u2C08foWzi8FdRA,3VkHkmOtom3jM2wCu94xgzzu1d6Dn7or,9,26,4,2,7,3,4,0,46,6.571428571428571,2,0.0,18,4,2,7,8,3,0,4,0,31,15,1
4737,73736,Q0CA1Q4hyAUuIpB1kk41n5xq9eQN0zwO,3VkHkmOtom3jM2wCu94xgzzu1d6Dn7or,1,0,0,0,0,0,1,0,1,0.14285714285714285,1,0.0,0,0,0,0,0,0,0,1,0,0,1,1
4738,73742,ovvuiEhj0QBv4xi11GVjXr8JhlCgaPmd,3VkHkmOtom3jM2wCu94xgzzu1d6Dn7or,60,182,31,109,92,26,24,1,465,66.42857142857143,5,0.0,145,31,102,92,37,26,7,24,1,370,95,0
4739,73744,zA8CqP1kZ0TZq4hxCbq0AkMFv6jDXluo,3VkHkmOtom3jM2wCu94xgzzu1d6Dn7or,5,2,1,0,1,0,3,0,7,1.0,1,0.0,0,1,0,1,2,0,0,3,0,2,5,1
4740,73746,GYoy1HdvsO4mH1bXnkMB7sEyOCz7rANY,3VkHkmOtom3jM2wCu94xgzzu1d6Dn7or,25,87,28,15,29,29,17,4,209,29.857142857142858,5,0.0,40,28,13,29,47,29,2,17,4,110,99,1
4741,73753,VgAtbYSZPQjOfrclLC6CaD7nhsX1iFFP,3VkHkmOtom3jM2wCu94xgzzu1d6Dn7or,1,0,0,0,0,0,1,0,1,0.14285714285714285,1,0.0,0,0,0,0,0,0,0,1,0,0,1,1
4742,73756,VkLxnN54Rw5zM8b687K5ZIPiSzMio4QS,3VkHkmOtom3jM2wCu94xgzzu1d6Dn7or,1,0,0,0,0,0,2,0,2,0.2857142857142857,1,0.0,0,0,0,0,0,0,0,2,0,0,2,1
4743,73763,isREfnusXioFlXK1R4tw2vT4IosRAXVA,3VkHkmOtom3jM2wCu94xgzzu1d6Dn7or,5,8,5,0,3,0,3,0,19,2.7142857142857144,3,0.0,0,5,0,3,8,0,0,3,0,8,11,1
4744,73764,GGioMvSJ2TI5A4koIk2G8ocfb1Yz1YTO,3VkHkmOtom3jM2wCu94xgzzu1d6Dn7or,5,2,1,0,1,0,2,0,6,0.8571428571428571,1,0.0,0,1,0,1,2,0,0,2,0,2,4,1
4745,73765,qTno0LLDbZSn2CC4rZpUMVqkfAX6tLBw,3VkHkmOtom3jM2wCu94xgzzu1d6Dn7or,13,19,9,0,4,1,10,2,45,6.428571428571429,1,0.0,5,9,0,4,14,1,0,10,2,18,27,1
4746,73770,SSlVryVbEN4dMdspRjPAIVHSt473LaJm,3VkHkmOtom3jM2wCu94xgzzu1d6Dn7or,4,5,0,0,0,0,2,0,7,1.0,2,0.0,0,0,0,0,5,0,0,2,0,0,7,1
4747,73771,90DzNf2idxHLgOYBCO0UTQn7scQMBICM,3VkHkmOtom3jM2wCu94xgzzu1d6Dn7or,5,2,1,0,1,0,2,0,6,0.8571428571428571,1,0.0,0,1,0,1,2,0,0,2,0,2,4,1
4748,73772,FbFzxcgOenGEHKMXxCSjDnrIiqrr6PFf,3VkHkmOtom3jM2wCu94xgzzu1d6Dn7or,1,0,0,0,0,0,2,0,2,0.2857142857142857,1,0.0,0,0,0,0,0,0,0,2,0,0,2,1
4749,73782,OqWMSgwiNNMZvnSrR3UUAymPPmQ5DtGr,3VkHkmOtom3jM2wCu94xgzzu1d6Dn7or,78,203,51,81,70,42,16,1,464,66.28571428571429,9,0.0,106,51,72,70,97,42,9,16,1,299,165,0
4750,73783,EChSttZSil8pQFLm0qImYXOhSqXem2dj,3VkHkmOtom3jM2wCu94xgzzu1d6Dn7or,83,187,54,83,71,5,19,3,422,60.285714285714285,7,0.0,116,54,74,71,71,5,9,19,3,315,107,0
4751,73786,Zay6nKuUKOZ7IwZcXRj8E7AQad8zDVUP,3VkHkmOtom3jM2wCu94xgzzu1d6Dn7or,7,3,1,1,0,13,8,0,26,3.7142857142857144,2,0.0,1,1,1,0,2,13,0,8,0,3,23,1
4752,73788,98r1yyZ02P5Yb7DOkeUA6eb8RHK6juvp,3VkHkmOtom3jM2wCu94xgzzu1d6Dn7or,4,0,0,0,0,4,4,0,8,1.1428571428571428,2,0.0,0,0,0,0,0,4,0,4,0,0,8,1
4753,73902,ylROXg8giT8WUi6VCjfxuNTR05tI9pz4,RXDvfPUBYFlVdlueBFbLW0mhhAyGEqpt,8,3,2,0,2,0,3,0,10,1.4285714285714286,1,0.0,0,2,0,2,3,0,0,3,0,4,6,1
4754,73920,Md9y03wRztv9cddm3W0J1vz80OlCJmEe,RXDvfPUBYFlVdlueBFbLW0mhhAyGEqpt,9,6,4,0,2,0,1,0,13,1.8571428571428572,1,0.0,0,4,0,2,6,0,0,1,0,6,7,1
4755,73937,28W5CJrYp73LQgjHivjzAixkCQuqTCh6,A3fsA9Zfv1X2fVEQhTw51lKENdNrEqT3,30,66,51,0,0,0,11,0,128,18.285714285714285,2,0.0,2,51,0,0,64,0,0,11,0,53,75,0
4756,73939,CQZYPowUu7Qz28eSyPodtf1cGcYnxZ3h,SpATywNh6bZuzm8s1ceuBUnMUAeoAHHw,15,32,2,25,2,0,4,0,65,9.285714285714286,2,0.0,17,2,20,2,15,0,5,4,0,41,24,1
4757,73941,vaBnFuKrFzaRvpuQOGO2KMutesPcXn34,SpATywNh6bZuzm8s1ceuBUnMUAeoAHHw,7,6,4,0,2,0,4,0,16,2.2857142857142856,2,0.0,0,4,0,2,6,0,0,4,0,6,10,0
4758,73944,aCpcxbxbjQL3dCtVXBMdBsAJlz21Z4Ca,A3fsA9Zfv1X2fVEQhTw51lKENdNrEqT3,34,25,3,90,3,0,7,0,128,18.285714285714285,1,0.0,6,3,77,3,19,0,13,7,0,89,39,1
4759,73952,wkO5wnAaXL3FXQv1NNUwzDWkbORgDBJo,A3fsA9Zfv1X2fVEQhTw51lKENdNrEqT3,4,3,1,0,0,0,2,0,6,0.8571428571428571,1,0.0,0,1,0,0,3,0,0,2,0,1,5,1
4760,73954,sUy7TGB2Hf96dZU6f73hwUBNPEtOfYuk,A3fsA9Zfv1X2fVEQhTw51lKENdNrEqT3,1,0,0,0,0,0,1,0,1,0.14285714285714285,1,0.0,0,0,0,0,0,0,0,1,0,0,1,1
4761,73971,LizXiJbJqGyJ8h2k4iCO24clMfax3bGH,A3fsA9Zfv1X2fVEQhTw51lKENdNrEqT3,40,26,1,56,0,9,17,1,110,15.714285714285714,1,0.0,1,1,50,0,25,9,6,17,1,52,58,1
4762,73975,YmZgT8JqU8nh2NPc6NVlnnDgPwwbycrT,SpATywNh6bZuzm8s1ceuBUnMUAeoAHHw,12,15,0,21,0,0,2,0,38,5.428571428571429,1,0.0,6,0,18,0,9,0,3,2,0,24,14,0
4763,73976,7mxOgTUP9lSjAUBOPZ9fhNEhVSHMvF2J,A3fsA9Zfv1X2fVEQhTw51lKENdNrEqT3,32,41,3,68,1,10,8,0,131,18.714285714285715,6,0.0,3,3,57,1,38,10,11,8,0,64,67,0
4764,73977,CaAAtghbZXcO6X5eGK5X6sBmcGDS3kOP,A3fsA9Zfv1X2fVEQhTw51lKENdNrEqT3,12,15,10,0,7,0,7,0,39,5.571428571428571,3,0.0,0,10,0,7,15,0,0,7,0,17,22,0
4765,73982,j8DKRXlbBhJ6ifZiglKMxqN6K5Ef7FDx,G8EPVSXsOYB5YQWZGiz1aVq5Pgr2GrQu,1,0,0,0,0,0,1,0,1,0.14285714285714285,1,0.0,0,0,0,0,0,0,0,1,0,0,1,1
4766,73993,Eh45q8Ah1FUCV8WxwA3O4F0KC13LsNiS,SpATywNh6bZuzm8s1ceuBUnMUAeoAHHw,27,33,25,19,13,0,4,0,94,13.428571428571429,3,0.0,6,25,16,13,27,0,3,4,0,60,34,0
4767,73996,scxglJg1rKZaKkFqQzaKvUj0JIYchHXc,A3fsA9Zfv1X2fVEQhTw51lKENdNrEqT3,11,10,4,0,2,2,13,3,34,4.857142857142857,1,0.0,0,4,0,2,10,2,0,13,3,6,28,1
4768,74005,3yqtr1mxJ0CGmkMSFU8VEZ9QxV5XzjUS,SpATywNh6bZuzm8s1ceuBUnMUAeoAHHw,8,7,5,0,4,0,4,0,20,2.857142857142857,1,0.0,0,5,0,4,7,0,0,4,0,9,11,1
4769,74006,obFplu8p0J5bdsesTSoaj6Bc4UGbTB6M,RXDvfPUBYFlVdlueBFbLW0mhhAyGEqpt,1,0,0,0,0,0,1,0,1,0.14285714285714285,1,0.0,0,0,0,0,0,0,0,1,0,0,1,1
4770,74009,obFplu8p0J5bdsesTSoaj6Bc4UGbTB6M,bWdj2GDclj5ofokWjzoa5jAwMkxCykd6,1,0,0,0,0,0,1,0,1,0.14285714285714285,1,0.0,0,0,0,0,0,0,0,1,0,0,1,1
4771,74012,1rnRBDe6QdlyFMXjNKkPkQwNjoqRhDMp,SpATywNh6bZuzm8s1ceuBUnMUAeoAHHw,18,19,9,7,4,0,2,0,41,5.857142857142857,1,0.0,5,9,7,4,14,0,0,2,0,25,16,0
4772,74013,nogA2x0BUvhes20YqJTGpVXi7iEsM9Kl,A3fsA9Zfv1X2fVEQhTw51lKENdNrEqT3,16,20,9,0,7,0,14,0,50,7.142857142857143,1,0.0,0,9,0,7,20,0,0,14,0,16,34,1
4773,74040,CopXShP3zDILDEKJnKili2vT6Sl9AJnD,SpATywNh6bZuzm8s1ceuBUnMUAeoAHHw,1,0,0,0,0,0,1,0,1,0.14285714285714285,1,0.0,0,0,0,0,0,0,0,1,0,0,1,1
4774,74045,vQAS0obh0bWlfi2VaK7gKWVKUzPkWalY,SpATywNh6bZuzm8s1ceuBUnMUAeoAHHw,2,0,0,0,0,0,2,0,2,0.2857142857142857,1,0.0,0,0,0,0,0,0,0,2,0,0,2,1
4775,74046,vQAS0obh0bWlfi2VaK7gKWVKUzPkWalY,bWdj2GDclj5ofokWjzoa5jAwMkxCykd6,2,0,0,0,0,0,2,0,2,0.2857142857142857,1,0.0,0,0,0,0,0,0,0,2,0,0,2,1
4776,74057,O0YmxDboJ63OaHyMfnj8iH9wPr65QNiO,SpATywNh6bZuzm8s1ceuBUnMUAeoAHHw,38,83,5,48,3,3,19,10,171,24.428571428571427,5,0.0,16,5,42,3,67,3,6,19,10,66,105,0
4777,74058,2DWLTxRTemXyf4r3vpMSxxKp5UI9KrMK,SpATywNh6bZuzm8s1ceuBUnMUAeoAHHw,44,38,21,9,12,15,9,2,106,15.142857142857142,2,0.0,14,21,9,12,24,15,0,9,2,56,50,1
4778,74074,ve7Ft3pn5zWGBanwhSnSQvIFg9ZaO7O3,bWdj2GDclj5ofokWjzoa5jAwMkxCykd6,1,0,0,0,0,0,1,0,1,0.14285714285714285,1,0.0,0,0,0,0,0,0,0,1,0,0,1,1
4779,74077,jLtFUJPyfA46FykTUb6QOOwQ7a9wlh6r,SpATywNh6bZuzm8s1ceuBUnMUAeoAHHw,24,19,10,15,7,4,3,1,59,8.428571428571429,3,0.0,2,10,14,7,17,4,1,3,1,33,26,1
4780,74085,cm7tSP8npn8e7q4HdgpiE4ontpb8vvi9,SpATywNh6bZuzm8s1ceuBUnMUAeoAHHw,13,9,4,8,2,0,4,0,27,3.857142857142857,1,0.0,3,4,8,2,6,0,0,4,0,17,10,0
4781,74086,a4naBAZCHNqdVKKeEiKQVvfTN6r4f6eG,bWdj2GDclj5ofokWjzoa5jAwMkxCykd6,24,14,11,9,8,0,1,0,43,6.142857142857143,1,0.0,0,11,8,8,14,0,1,1,0,27,16,1
4782,74090,XX8QqYjq3DDYAwGvSBM9FgSBaZDZXB3w,SpATywNh6bZuzm8s1ceuBUnMUAeoAHHw,1,0,0,0,0,0,1,0,1,0.14285714285714285,1,0.0,0,0,0,0,0,0,0,1,0,0,1,1
4783,74114,OakZIwMalw5UgG2N0rTydClOEPiV8rki,SpATywNh6bZuzm8s1ceuBUnMUAeoAHHw,25,24,10,13,5,0,3,0,55,7.857142857142857,1,0.0,8,10,13,5,16,0,0,3,0,36,19,0
4784,74115,NFrovzSNFaGOKX4ckxlOk5TIATwQWZDv,SpATywNh6bZuzm8s1ceuBUnMUAeoAHHw,36,48,29,54,12,1,11,1,156,22.285714285714285,3,0.0,8,29,45,12,40,1,9,11,1,94,62,0
4785,74116,zqPiN6fngW7il9FbWkBXYXifniNaXNn1,G8EPVSXsOYB5YQWZGiz1aVq5Pgr2GrQu,6,5,2,0,1,0,4,0,12,1.7142857142857142,3,0.0,0,2,0,1,5,0,0,4,0,3,9,1
4786,74121,Ym1ZTRs6QB0e3lMSh4qwLaB0p6ohf0Ak,RXDvfPUBYFlVdlueBFbLW0mhhAyGEqpt,54,137,80,50,37,46,16,0,366,52.285714285714285,4,0.0,34,80,46,37,103,46,4,16,0,197,169,0
4787,74130,Hzo5Ctg10ZQey5IjMeCvl0CH7lPNTM5X,A3fsA9Zfv1X2fVEQhTw51lKENdNrEqT3,55,82,29,0,22,6,31,1,171,24.428571428571427,7,0.0,3,29,0,22,79,6,0,31,1,54,117,0
4788,74143,xDJMkV9mDTaAuE2EG90IC7v4J66eZQpO,A3fsA9Zfv1X2fVEQhTw51lKENdNrEqT3,13,12,1,0,1,0,5,0,19,2.7142857142857144,1,0.0,0,1,0,1,12,0,0,5,0,2,17,1
4789,74148,IlI6WFCOksFJvUDYbo61Mefo3NVc2z35,SpATywNh6bZuzm8s1ceuBUnMUAeoAHHw,19,16,12,0,9,0,4,0,41,5.857142857142857,2,0.0,1,12,0,9,15,0,0,4,0,22,19,1
4790,74161,nDTTL9R9lgX70taGjXWWhpV9HneItz9X,SpATywNh6bZuzm8s1ceuBUnMUAeoAHHw,3,0,0,0,0,0,4,0,4,0.5714285714285714,1,0.0,0,0,0,0,0,0,0,4,0,0,4,1
4791,74179,MSkAqYUm0K8MrH08RV5TknBJ7b8d8KBP,bWdj2GDclj5ofokWjzoa5jAwMkxCykd6,4,0,0,0,0,1,3,0,4,0.5714285714285714,1,0.0,0,0,0,0,0,1,0,3,0,0,4,1
4792,74200,xfB7JXhtbd9UDGft4eYtRwZAYUFQa2nu,A3fsA9Zfv1X2fVEQhTw51lKENdNrEqT3,19,23,15,0,12,1,5,0,56,8.0,2,0.0,1,15,0,12,22,1,0,5,0,28,28,1
4793,74201,9AsHXNkBQvXo8HhSoI7QGvcrwFiTnePm,SpATywNh6bZuzm8s1ceuBUnMUAeoAHHw,13,11,2,4,2,0,6,1,26,3.7142857142857144,1,0.0,0,2,3,2,11,0,1,6,1,7,19,1
4794,74208,8y6epeJrjhugLO51W4a4wQLvEs8JOxqT,5X6FeZozNMgE2VRi3MJYjkkFK8SETtu2,6,4,0,0,0,0,6,0,10,1.4285714285714286,2,0.0,0,0,0,0,4,0,0,6,0,0,10,1
4795,74224,s8rbNwiDb6Ued6nUvpbwuDl2s256fOiD,SpATywNh6bZuzm8s1ceuBUnMUAeoAHHw,23,25,1,29,1,0,1,0,57,8.142857142857142,1,0.0,8,1,22,1,17,0,7,1,0,32,25,1
4796,74235,5KlniVT8DHSXcPiuR6nW6St4F855ogkm,G8EPVSXsOYB5YQWZGiz1aVq5Pgr2GrQu,19,16,2,0,2,0,5,0,25,3.5714285714285716,2,0.0,1,2,0,2,15,0,0,5,0,5,20,0
4797,74236,f0rOHsHG0q3gNFB6DywzqLWndZGHzmin,SpATywNh6bZuzm8s1ceuBUnMUAeoAHHw,1,0,0,0,0,0,1,0,1,0.14285714285714285,1,0.0,0,0,0,0,0,0,0,1,0,0,1,1
4798,74242,eGEAL8qSr92ZD6fgaD9bwbIgjlv0k1By,5X6FeZozNMgE2VRi3MJYjkkFK8SETtu2,15,24,1,24,12,0,2,0,63,9.0,1,0.0,20,1,20,12,4,0,4,2,0,53,10,1
4799,74245,2ZDZeGxlSkOYdQNOELblzmlZJh9Z3y1x,SpATywNh6bZuzm8s1ceuBUnMUAeoAHHw,26,20,15,11,11,0,3,0,60,8.571428571428571,2,0.0,0,15,10,11,20,0,1,3,0,36,24,0
4800,74262,USFNJQ0DS4O3ARJSYADvtg2Aw3GLb3J9,SpATywNh6bZuzm8s1ceuBUnMUAeoAHHw,1,0,0,0,0,0,1,0,1,0.14285714285714285,1,0.0,0,0,0,0,0,0,0,1,0,0,1,1
4801,74268,NFrovzSNFaGOKX4ckxlOk5TIATwQWZDv,RXDvfPUBYFlVdlueBFbLW0mhhAyGEqpt,3,2,1,0,0,0,1,0,4,0.5714285714285714,1,0.0,0,1,0,0,2,0,0,1,0,1,3,1
4802,74272,T7I0bmVpFP7i0YadOfDRSUAzo81IilUz,bWdj2GDclj5ofokWjzoa5jAwMkxCykd6,15,19,7,0,5,0,7,1,39,5.571428571428571,2,0.0,0,7,0,5,19,0,0,7,1,12,27,1
4803,74284,lB6Kl0if51YgTDbpdNoXtX6HKiMZvllY,A3fsA9Zfv1X2fVEQhTw51lKENdNrEqT3,15,10,2,6,1,0,9,0,28,4.0,2,0.0,1,2,5,1,9,0,1,9,0,9,19,1
4804,74287,Yqe9tlKJmwXgMmJk8s60HvnWbYuOSFJG,bWdj2GDclj5ofokWjzoa5jAwMkxCykd6,8,23,9,48,4,8,5,0,97,13.857142857142858,1,0.0,7,9,46,4,16,8,2,5,0,66,31,1
4805,74297,ntJ6fxz21zj1WGCOh981AGug6ZMrS8X6,5X6FeZozNMgE2VRi3MJYjkkFK8SETtu2,11,8,5,0,2,0,6,0,21,3.0,3,0.0,0,5,0,2,8,0,0,6,0,7,14,1
4806,74303,cynSK4pVMg8QkEFbKcs3bJdr6KIkWo0k,A3fsA9Zfv1X2fVEQhTw51lKENdNrEqT3,8,4,1,0,1,0,11,1,18,2.5714285714285716,1,0.0,0,1,0,1,4,0,0,11,1,2,16,1
4807,74304,93Z6q7IrfLjW0jIJMAho4C8mo899qi3t,A3fsA9Zfv1X2fVEQhTw51lKENdNrEqT3,9,6,4,0,3,0,3,0,16,2.2857142857142856,2,0.0,0,4,0,3,6,0,0,3,0,7,9,1
4808,74313,gMa3FGU3wfWVEbrDbTw7qJJxfolE9poa,SpATywNh6bZuzm8s1ceuBUnMUAeoAHHw,1,0,0,0,0,0,1,0,1,0.14285714285714285,1,0.0,0,0,0,0,0,0,0,1,0,0,1,1
4809,74329,vCnaR7A3EMdV2eOQ4pBMh0byIjK5VwLE,SpATywNh6bZuzm8s1ceuBUnMUAeoAHHw,4,5,2,0,0,0,1,0,8,1.1428571428571428,3,0.0,0,2,0,0,5,0,0,1,0,2,6,1
4810,74333,Dc9OIUGhQBh3pdZe3Ppn36a1Oo81Nm8J,RXDvfPUBYFlVdlueBFbLW0mhhAyGEqpt,9,12,2,0,1,0,2,0,17,2.4285714285714284,2,0.0,0,2,0,1,12,0,0,2,0,3,14,1
4811,74338,6W0BpjkpO0dAMGUgwI3l3rChjx6l5wlj,5X6FeZozNMgE2VRi3MJYjkkFK8SETtu2,7,11,1,0,1,0,2,0,15,2.142857142857143,1,0.0,0,1,0,1,11,0,0,2,0,2,13,1
4812,74354,9svIRkOgRyjEbOZMMP92ryMYJokXCyUX,SpATywNh6bZuzm8s1ceuBUnMUAeoAHHw,16,21,12,18,1,2,5,0,59,8.428571428571429,3,0.0,5,12,14,1,16,2,4,5,0,32,27,1
4813,74369,G1FfkddeVeIbkz2kmbhjCGjDdGtyuyp9,SpATywNh6bZuzm8s1ceuBUnMUAeoAHHw,19,24,8,19,5,0,5,1,62,8.857142857142858,1,0.0,12,8,16,5,12,0,3,5,1,41,21,1
4814,74370,s8rbNwiDb6Ued6nUvpbwuDl2s256fOiD,A3fsA9Zfv1X2fVEQhTw51lKENdNrEqT3,9,8,1,0,1,0,1,0,11,1.5714285714285714,1,0.0,0,1,0,1,8,0,0,1,0,2,9,1
4815,74391,CCjaP0a0XOS5DYKLqhLcmuVP0ZMtmJbe,SpATywNh6bZuzm8s1ceuBUnMUAeoAHHw,2,0,0,0,0,0,2,0,2,0.2857142857142857,1,0.0,0,0,0,0,0,0,0,2,0,0,2,0
4816,74397,FzKYBP9DQh3u0w9lQRHJGeubpb75FItD,A3fsA9Zfv1X2fVEQhTw51lKENdNrEqT3,16,8,0,22,0,1,2,0,33,4.714285714285714,1,0.0,0,0,22,0,8,1,0,2,0,22,11,0
4817,74403,kTXF1gPewccB1VIt2bJnfMXFVMCM29nB,SpATywNh6bZuzm8s1ceuBUnMUAeoAHHw,15,15,1,21,0,1,4,2,44,6.285714285714286,1,0.0,4,1,17,0,11,1,4,4,2,22,22,1
4818,74426,JYiXW3dpkzmGlUrad7aUjTowRtDP23eD,5X6FeZozNMgE2VRi3MJYjkkFK8SETtu2,1,0,0,0,0,0,1,0,1,0.14285714285714285,1,0.0,0,0,0,0,0,0,0,1,0,0,1,1
4819,74428,flqVHzaI93P4MJBmTZVjZNaIqqmijscB,G8EPVSXsOYB5YQWZGiz1aVq5Pgr2GrQu,19,37,1,0,1,0,2,0,41,5.857142857142857,1,0.0,0,1,0,1,37,0,0,2,0,2,39,1
4820,74439,I79OMGSY4ZrLgUTAB0cVX1h1GhooCLNo,A3fsA9Zfv1X2fVEQhTw51lKENdNrEqT3,6,2,1,0,1,0,4,1,9,1.2857142857142858,1,0.0,0,1,0,1,2,0,0,4,1,2,7,1
4821,74453,XKfrMCVtqlIZ8enVJyGd7DD1q7PXaYx0,bWdj2GDclj5ofokWjzoa5jAwMkxCykd6,1,0,0,0,0,0,1,0,1,0.14285714285714285,1,0.0,0,0,0,0,0,0,0,1,0,0,1,1
4822,74460,ACadGToRbfVhLuGyd9Wpg2G1uz3esqK0,SpATywNh6bZuzm8s1ceuBUnMUAeoAHHw,6,2,1,0,1,1,3,0,8,1.1428571428571428,1,0.0,0,1,0,1,2,1,0,3,0,2,6,0
4823,74461,z2UutrDxctGBl3XhV09hNxXdsZmqDZvY,A3fsA9Zfv1X2fVEQhTw51lKENdNrEqT3,11,3,2,34,0,0,1,0,40,5.714285714285714,1,0.0,0,2,30,0,3,0,4,1,0,32,8,1
4824,74469,XwG3vcP20DIeZlmf1pcrm3ClOhU48FuI,bWdj2GDclj5ofokWjzoa5jAwMkxCykd6,5,2,1,0,1,0,2,0,6,0.8571428571428571,1,0.0,0,1,0,1,2,0,0,2,0,2,4,1
4825,74483,SP7hg1EWo2mZkHuxZFtI4Vbcyr5vcP4h,SpATywNh6bZuzm8s1ceuBUnMUAeoAHHw,27,22,13,20,6,14,7,0,82,11.714285714285714,4,0.0,5,13,20,6,17,14,0,7,0,44,38,0
4826,74522,ZYGzPhdrKsCQft8z3gUrz2GR31kmqGY8,SpATywNh6bZuzm8s1ceuBUnMUAeoAHHw,3,2,1,0,0,0,2,0,5,0.7142857142857143,1,0.0,0,1,0,0,2,0,0,2,0,1,4,0
4827,74526,qwopEmmu52GEF4KxBC26RpTkcwtY07S9,SpATywNh6bZuzm8s1ceuBUnMUAeoAHHw,11,12,10,0,3,0,2,0,27,3.857142857142857,2,0.0,0,10,0,3,12,0,0,2,0,13,14,0
4828,74532,MV1wf85ScBlo9ArAqT4i8ZoZIKCQgEfs,SpATywNh6bZuzm8s1ceuBUnMUAeoAHHw,6,7,4,0,0,0,5,0,16,2.2857142857142856,2,0.0,0,4,0,0,7,0,0,5,0,4,12,1
4829,74541,HbmZzALzRW0CJmaD07o1oMpvJwGgfjK4,bWdj2GDclj5ofokWjzoa5jAwMkxCykd6,4,4,0,0,0,0,1,0,5,0.7142857142857143,1,0.0,0,0,0,0,4,0,0,1,0,0,5,1
4830,74548,HF98YPKzT8oi2j9flZW9kstZcvL3ZimG,A3fsA9Zfv1X2fVEQhTw51lKENdNrEqT3,7,19,7,0,2,0,4,0,32,4.571428571428571,3,0.0,0,7,0,2,19,0,0,4,0,9,23,1
4831,74585,GyWTABuPpZEqO585EnNTIpM2B2faPYN3,5X6FeZozNMgE2VRi3MJYjkkFK8SETtu2,6,5,2,2,0,0,2,0,11,1.5714285714285714,2,0.0,0,2,2,0,5,0,0,2,0,4,7,1
4832,74598,OTHlyZh4aRihnrH9Vutug3qdQ6q32Nov,SpATywNh6bZuzm8s1ceuBUnMUAeoAHHw,9,4,3,0,3,0,2,0,12,1.7142857142857142,1,0.0,0,3,0,3,4,0,0,2,0,6,6,1
4833,74644,NoceYrOX1tWqokyDfvqtevfQbA2rhFqB,SpATywNh6bZuzm8s1ceuBUnMUAeoAHHw,8,34,23,0,12,3,9,0,81,11.571428571428571,3,0.0,2,23,0,12,32,3,0,9,0,37,44,0
4834,74645,yyQKmUmpVqmqFiYGe484Lz475SV3nfm5,bWdj2GDclj5ofokWjzoa5jAwMkxCykd6,5,3,1,0,1,0,3,0,8,1.1428571428571428,1,0.0,0,1,0,1,3,0,0,3,0,2,6,1
4835,74647,7jwWb0uiBH4HpnQekwYLSZ97fL4vhEw1,SpATywNh6bZuzm8s1ceuBUnMUAeoAHHw,7,7,1,0,0,0,5,1,14,2.0,1,0.0,0,1,0,0,7,0,0,5,1,1,13,1
4836,74649,3x63reHnPUEpxvneROppT18TTVHKvgH3,SpATywNh6bZuzm8s1ceuBUnMUAeoAHHw,43,50,23,34,13,0,7,0,127,18.142857142857142,4,0.0,10,23,29,13,40,0,5,7,0,75,52,0
4837,74655,zd4bqhboWRT9GK0kaDHAAEgCWB98gZCz,A3fsA9Zfv1X2fVEQhTw51lKENdNrEqT3,4,2,1,0,1,0,2,0,6,0.8571428571428571,1,0.0,0,1,0,1,2,0,0,2,0,2,4,1
4838,74667,g6Gud8aJq8WYBVZlhPICi85SNqSTC9hb,SpATywNh6bZuzm8s1ceuBUnMUAeoAHHw,7,5,1,0,1,0,2,0,9,1.2857142857142858,1,0.0,0,1,0,1,5,0,0,2,0,2,7,1
4839,74684,3Mo4KKxt5XsXFl1wmKukaZclKwhABriO,A3fsA9Zfv1X2fVEQhTw51lKENdNrEqT3,4,2,1,0,0,0,2,0,5,0.7142857142857143,1,0.0,0,1,0,0,2,0,0,2,0,1,4,1
4840,74697,RYEl9qV5WolRR4P8IF9M1gxceAzD6Axt,SpATywNh6bZuzm8s1ceuBUnMUAeoAHHw,6,7,4,0,0,0,2,0,13,1.8571428571428572,2,0.0,0,4,0,0,7,0,0,2,0,4,9,1
4841,74699,IZ5pWpBLzW50MjCCGxCjTz4w6DVz2MU3,G8EPVSXsOYB5YQWZGiz1aVq5Pgr2GrQu,1,0,0,0,0,0,1,0,1,0.14285714285714285,1,0.0,0,0,0,0,0,0,0,1,0,0,1,1
4842,74712,ZudgpcrDV2RrJQUR1YBw9q8iUT5VbCHi,RXDvfPUBYFlVdlueBFbLW0mhhAyGEqpt,7,3,2,0,1,0,4,0,10,1.4285714285714286,1,0.0,0,2,0,1,3,0,0,4,0,3,7,0
4843,74721,2cWT2r9kI6XDpveso7mwMhmCGJDMpJ6X,A3fsA9Zfv1X2fVEQhTw51lKENdNrEqT3,1,0,0,0,0,0,1,0,1,0.14285714285714285,1,0.0,0,0,0,0,0,0,0,1,0,0,1,1
4844,74724,2mlxTydWoLZJ5NQWesHHKUelrVUBGoHh,5X6FeZozNMgE2VRi3MJYjkkFK8SETtu2,6,2,1,0,1,0,4,0,8,1.1428571428571428,1,0.0,0,1,0,1,2,0,0,4,0,2,6,1
4845,74737,xMjaHywxqKHoEbgcAEYnpZkLLGRuzCTC,SpATywNh6bZuzm8s1ceuBUnMUAeoAHHw,22,31,16,13,7,0,4,0,71,10.142857142857142,2,0.0,4,16,10,7,27,0,3,4,0,37,34,0
4846,74739,WnGoJ0X05nmmcr9OBuNGFmD5r4EVF1g6,A3fsA9Zfv1X2fVEQhTw51lKENdNrEqT3,6,3,2,0,0,0,4,0,9,1.2857142857142858,1,0.0,0,2,0,0,3,0,0,4,0,2,7,0
4847,74749,usRZSdDsUQfZaciTJTskV4NLSeP1lHRl,A3fsA9Zfv1X2fVEQhTw51lKENdNrEqT3,1,0,0,0,0,0,1,0,1,0.14285714285714285,1,0.0,0,0,0,0,0,0,0,1,0,0,1,1
4848,74761,Z5b3QXG5aJtKMyvjqd5INn7f1wDhqIm4,A3fsA9Zfv1X2fVEQhTw51lKENdNrEqT3,1,0,0,0,0,0,1,0,1,0.14285714285714285,1,0.0,0,0,0,0,0,0,0,1,0,0,1,1
4849,74762,Z5b3QXG5aJtKMyvjqd5INn7f1wDhqIm4,bWdj2GDclj5ofokWjzoa5jAwMkxCykd6,14,22,7,10,5,0,3,0,47,6.714285714285714,2,0.0,3,7,10,5,19,0,0,3,0,25,22,0
4850,74764,ZV0a8d6GAHaQT1yxkoLDTJWbniV7l6vc,5X6FeZozNMgE2VRi3MJYjkkFK8SETtu2,6,1,1,0,1,0,5,0,8,1.1428571428571428,1,0.0,0,1,0,1,1,0,0,5,0,2,6,1
4851,74778,bYD2u7vuN3G54awyDYPdRiZI3O4zw6kx,G8EPVSXsOYB5YQWZGiz1aVq5Pgr2GrQu,8,4,3,0,2,0,2,0,11,1.5714285714285714,1,0.0,0,3,0,2,4,0,0,2,0,5,6,1
4852,74789,x2AGMzmJPCrXZNc7gGF2iADeNGLrtzi4,A3fsA9Zfv1X2fVEQhTw51lKENdNrEqT3,13,11,7,0,6,0,5,0,29,4.142857142857143,2,0.0,0,7,0,6,11,0,0,5,0,13,16,1
4853,74790,s29WON0nEycbuI4M7GDpKZCuvPrDZcLx,G8EPVSXsOYB5YQWZGiz1aVq5Pgr2GrQu,12,4,4,0,4,0,3,0,15,2.142857142857143,1,0.0,0,4,0,4,4,0,0,3,0,8,7,1
4854,74803,rOS1kOMsU3zAy3GVc3zUTuvG3J4hWGN2,SpATywNh6bZuzm8s1ceuBUnMUAeoAHHw,7,2,1,0,1,0,7,1,12,1.7142857142857142,1,0.0,0,1,0,1,2,0,0,7,1,2,10,1
4855,74808,ciYJmrXFDUtWkjoF7Zvs7BQ2J3037Bux,bWdj2GDclj5ofokWjzoa5jAwMkxCykd6,4,2,1,0,1,0,1,0,5,0.7142857142857143,1,0.0,0,1,0,1,2,0,0,1,0,2,3,1
4856,74813,dfEUetbMC28MXxBYUZ94BQFzb5NJzCJ0,SpATywNh6bZuzm8s1ceuBUnMUAeoAHHw,8,2,1,0,1,0,5,1,10,1.4285714285714286,1,0.0,0,1,0,1,2,0,0,5,1,2,8,1
4857,74816,uT14yawTmUCC7G7h6dlovFEDCG0rTxiC,5X6FeZozNMgE2VRi3MJYjkkFK8SETtu2,1,0,0,0,0,0,1,0,1,0.14285714285714285,1,0.0,0,0,0,0,0,0,0,1,0,0,1,1
4858,74822,NY9s8OFouHZCCkZ3OfBNpnQKNG5h9lgn,SpATywNh6bZuzm8s1ceuBUnMUAeoAHHw,6,5,1,0,1,0,2,1,10,1.4285714285714286,1,0.0,0,1,0,1,5,0,0,2,1,2,8,1
4859,74823,h5DbxORjpK7o2YwkPjSoh86dvC8KHNlm,SpATywNh6bZuzm8s1ceuBUnMUAeoAHHw,38,55,22,20,13,0,6,0,116,16.571428571428573,4,0.0,7,22,20,13,48,0,0,6,0,62,54,0
4860,74824,dfEUetbMC28MXxBYUZ94BQFzb5NJzCJ0,A3fsA9Zfv1X2fVEQhTw51lKENdNrEqT3,6,3,2,0,1,0,2,0,8,1.1428571428571428,1,0.0,0,2,0,1,3,0,0,2,0,3,5,1
4861,74840,FvY4K2RN2da3T8MEGlPk2LmHUIxOyg0h,SpATywNh6bZuzm8s1ceuBUnMUAeoAHHw,3,2,1,0,0,0,1,0,4,0.5714285714285714,1,0.0,0,1,0,0,2,0,0,1,0,1,3,0
4862,74855,pTjlgRGlVEY0q8gZSgoQhD2BjMBUQLrl,SpATywNh6bZuzm8s1ceuBUnMUAeoAHHw,11,29,15,0,8,0,4,0,56,8.0,3,0.0,8,15,0,8,21,0,0,4,0,31,25,1
4863,74858,mB36rXDIKgGQROGEKlrDrvsLRYA6xyWr,bWdj2GDclj5ofokWjzoa5jAwMkxCykd6,15,30,16,2,6,11,14,0,79,11.285714285714286,3,0.0,1,16,1,6,29,11,1,14,0,24,55,1
4864,74862,iNVrCH89sJttoddUpv5O2bH5LrAKlFHk,SpATywNh6bZuzm8s1ceuBUnMUAeoAHHw,1,0,0,0,0,0,1,0,1,0.14285714285714285,1,0.0,0,0,0,0,0,0,0,1,0,0,1,1
4865,74868,Ob4gv0EanZge2ZoC1mjpKSlZhrSnoOS3,SpATywNh6bZuzm8s1ceuBUnMUAeoAHHw,30,56,29,46,8,1,8,0,148,21.142857142857142,3,0.0,18,29,42,8,38,1,4,8,0,97,51,0
4866,74883,r3ymEDBeAtjd52LKkH7rXxWW6cBfLEDa,A3fsA9Zfv1X2fVEQhTw51lKENdNrEqT3,5,4,3,0,0,0,1,0,8,1.1428571428571428,1,0.0,0,3,0,0,4,0,0,1,0,3,5,1
4867,74888,hB4yTUnQMne1LtjUUKgpcnhj6jq7S5Co,7GRhBDsirIGkRZBtSMEzNTyDr2JQm4xx,7,4,2,0,2,0,2,0,10,1.4285714285714286,2,0.0,1,2,0,2,3,0,0,2,0,5,5,0
4868,74892,JiMk3YzOg8oAYgApOK7xg1JGgnoRvDfl,A3fsA9Zfv1X2fVEQhTw51lKENdNrEqT3,4,2,1,0,1,0,2,0,6,0.8571428571428571,1,0.0,0,1,0,1,2,0,0,2,0,2,4,1
4869,74897,x29OOChdmJGXK62DnUpwKbwJurqULmnD,5X6FeZozNMgE2VRi3MJYjkkFK8SETtu2,5,5,1,0,2,0,2,0,10,1.4285714285714286,1,0.0,3,1,0,2,2,0,0,2,0,6,4,0
4870,74900,JiMk3YzOg8oAYgApOK7xg1JGgnoRvDfl,bWdj2GDclj5ofokWjzoa5jAwMkxCykd6,4,3,2,0,2,0,1,0,8,1.1428571428571428,1,0.0,0,2,0,2,3,0,0,1,0,4,4,1
4871,74902,x29OOChdmJGXK62DnUpwKbwJurqULmnD,bWdj2GDclj5ofokWjzoa5jAwMkxCykd6,5,3,1,0,1,0,2,0,7,1.0,1,0.0,1,1,0,1,2,0,0,2,0,3,4,1
4872,74911,KXR3u54SykbWYMuF2sF6lcMFs68otiQO,SpATywNh6bZuzm8s1ceuBUnMUAeoAHHw,18,17,11,13,7,0,1,0,49,7.0,2,0.0,2,11,12,7,15,0,1,1,0,32,17,0
4873,74913,uFxbwM61ZWFC5xnxVOlmiGXCTyHmK3HX,bWdj2GDclj5ofokWjzoa5jAwMkxCykd6,5,3,2,0,1,0,1,0,7,1.0,1,0.0,0,2,0,1,3,0,0,1,0,3,4,1
4874,74930,5v8l5BICnEGCGWpQvqxFCJVjz2acEKZl,G8EPVSXsOYB5YQWZGiz1aVq5Pgr2GrQu,9,14,4,0,3,1,4,0,26,3.7142857142857144,1,0.0,3,4,0,3,11,1,0,4,0,10,16,0
4875,74934,knxAJpSFDgjN8jBmnCV7BB7s4fbgoTt1,SpATywNh6bZuzm8s1ceuBUnMUAeoAHHw,24,28,16,15,0,0,9,8,76,10.857142857142858,3,0.0,4,16,14,0,24,0,1,9,8,34,42,0
4876,74943,mOZWwAiWS8RfyGtuX0b9jvrQpdX3BP1X,bWdj2GDclj5ofokWjzoa5jAwMkxCykd6,11,28,2,66,2,0,18,0,116,16.571428571428573,3,0.0,9,2,65,2,19,0,1,18,0,78,38,0
4877,74947,GXo2SYlrCC46fM8KQJ07eqitBWYgaplM,SpATywNh6bZuzm8s1ceuBUnMUAeoAHHw,53,195,57,59,7,10,43,5,376,53.714285714285715,8,0.0,33,57,55,7,162,10,4,43,5,152,224,0
4878,74959,AzcVSEK0IpU0E5IZQu1LwCDywMZBgNAW,SpATywNh6bZuzm8s1ceuBUnMUAeoAHHw,5,2,1,0,1,0,2,0,6,0.8571428571428571,1,0.0,0,1,0,1,2,0,0,2,0,2,4,1
4879,74976,SNVrdMjIVUeHCh0ANatiA4r6Zjv5zuOs,SpATywNh6bZuzm8s1ceuBUnMUAeoAHHw,1,0,0,0,0,0,1,0,1,0.14285714285714285,1,0.0,0,0,0,0,0,0,0,1,0,0,1,1
4880,74979,SNVrdMjIVUeHCh0ANatiA4r6Zjv5zuOs,bWdj2GDclj5ofokWjzoa5jAwMkxCykd6,1,0,0,0,0,0,1,0,1,0.14285714285714285,1,0.0,0,0,0,0,0,0,0,1,0,0,1,1
4881,74980,FjNebfWhfRwodURnqPOMm3ZfKL7caXWJ,SpATywNh6bZuzm8s1ceuBUnMUAeoAHHw,4,0,0,0,0,1,3,0,4,0.5714285714285714,1,0.0,0,0,0,0,0,1,0,3,0,0,4,1
4882,75002,0FC20UDeWvUi5UrOg2NVCepKkW4oulyY,SpATywNh6bZuzm8s1ceuBUnMUAeoAHHw,6,9,5,0,0,3,4,0,21,3.0,1,0.0,2,5,0,0,7,3,0,4,0,7,14,1
4883,75023,NyiU395X6Fy3DZbS0WCSdHXksL7FK9tP,RXDvfPUBYFlVdlueBFbLW0mhhAyGEqpt,5,2,0,0,0,0,5,2,9,1.2857142857142858,2,0.0,0,0,0,0,2,0,0,5,2,0,9,0
4884,75024,e5rwU2LwislVyOTeqeRmKDP4jS4xeeeT,SpATywNh6bZuzm8s1ceuBUnMUAeoAHHw,18,18,13,2,7,0,2,0,42,6.0,1,0.0,1,13,2,7,17,0,0,2,0,23,19,1
4885,75033,9oCGRMqQ5CGhjL72D087jHZSMR83iAkq,SpATywNh6bZuzm8s1ceuBUnMUAeoAHHw,37,44,12,14,11,0,4,0,85,12.142857142857142,3,0.0,5,12,13,11,39,0,1,4,0,41,44,0
4886,75043,oDHEQbFNA2xviYWXNUI5rdNNLqWcTgSk,bWdj2GDclj5ofokWjzoa5jAwMkxCykd6,1,0,0,0,0,0,1,0,1,0.14285714285714285,1,0.0,0,0,0,0,0,0,0,1,0,0,1,1
4887,75093,Wcbtj2ddFRjLWK9tTZ7uzCDmpegrAZ78,A3fsA9Zfv1X2fVEQhTw51lKENdNrEqT3,3,2,1,0,0,0,1,0,4,0.5714285714285714,1,0.0,0,1,0,0,2,0,0,1,0,1,3,0
4888,75099,lnW3snH3Dt7UKPOuS5LuzzO6fmhyVp7F,SpATywNh6bZuzm8s1ceuBUnMUAeoAHHw,5,3,1,0,1,0,1,0,6,0.8571428571428571,1,0.0,0,1,0,1,3,0,0,1,0,2,4,1
4889,75106,wCksXloTMkWRNjUlFs8kEf1uEAKNJm9S,SpATywNh6bZuzm8s1ceuBUnMUAeoAHHw,2,0,0,0,0,0,2,0,2,0.2857142857142857,1,0.0,0,0,0,0,0,0,0,2,0,0,2,1
4890,75108,35ygmhgWZR3Rp3zgk5PM9pjJe8hJeFw2,G8EPVSXsOYB5YQWZGiz1aVq5Pgr2GrQu,1,0,0,0,0,0,1,0,1,0.14285714285714285,1,0.0,0,0,0,0,0,0,0,1,0,0,1,0
4891,75120,H2nT05aeA6Q1zZKHa66kquyct5PT5SXn,SpATywNh6bZuzm8s1ceuBUnMUAeoAHHw,15,22,2,17,1,0,3,0,45,6.428571428571429,3,0.0,2,2,15,1,20,0,2,3,0,20,25,0
4892,75130,zeydZlwGQCxDpstjdEq0NvjUsbpOzoxV,A3fsA9Zfv1X2fVEQhTw51lKENdNrEqT3,25,19,15,0,13,1,13,2,63,9.0,4,0.0,0,15,0,13,19,1,0,13,2,28,35,1
4893,75180,XjoWzgT5svv3QrHsOovsOWAEcNVxKsvq,bWdj2GDclj5ofokWjzoa5jAwMkxCykd6,1,0,0,0,0,0,1,0,1,0.14285714285714285,1,0.0,0,0,0,0,0,0,0,1,0,0,1,1
4894,75187,L9qMLlGWAeAI6zWAZIyJtn0wISNa3dxg,RXDvfPUBYFlVdlueBFbLW0mhhAyGEqpt,3,0,0,0,0,12,2,0,14,2.0,2,0.0,0,0,0,0,0,12,0,2,0,0,14,1
4895,75189,QlvFciinGDGt7csjDmjYPPZqFlKAzfUP,5X6FeZozNMgE2VRi3MJYjkkFK8SETtu2,1,0,0,0,0,0,1,0,1,0.14285714285714285,1,0.0,0,0,0,0,0,0,0,1,0,0,1,1
4896,75201,U3LNfYcdRIeU9qhiaPG7Yg8NuZRGOnSS,bWdj2GDclj5ofokWjzoa5jAwMkxCykd6,1,0,0,0,0,0,1,0,1,0.14285714285714285,1,0.0,0,0,0,0,0,0,0,1,0,0,1,1
4897,75208,EsXr4Om7Vwi1sKSVuaosexmk6LU6FCZi,SpATywNh6bZuzm8s1ceuBUnMUAeoAHHw,15,14,8,8,3,4,5,4,46,6.571428571428571,1,0.0,6,8,8,3,8,4,0,5,4,25,21,0
4898,75212,umgqnQJ37y6QmsMhUUaPYa8Ra9JvurY1,A3fsA9Zfv1X2fVEQhTw51lKENdNrEqT3,6,3,0,0,1,0,2,0,6,0.8571428571428571,1,0.0,0,0,0,1,3,0,0,2,0,1,5,1
4899,75214,pXIGt0PRh4Kb7rmAnRSyrPgJarEYjwPQ,SpATywNh6bZuzm8s1ceuBUnMUAeoAHHw,4,2,1,0,1,0,1,0,5,0.7142857142857143,1,0.0,0,1,0,1,2,0,0,1,0,2,3,1
4900,75216,grxgFxuiaSTlMIk1kWcHwbLAYZVnIvkA,G8EPVSXsOYB5YQWZGiz1aVq5Pgr2GrQu,1,0,0,0,0,0,1,0,1,0.14285714285714285,1,0.0,0,0,0,0,0,0,0,1,0,0,1,1
4901,75224,ZpdK4JyprYJ3RXwz9T54FRcouWhOvm2M,SpATywNh6bZuzm8s1ceuBUnMUAeoAHHw,1,0,0,0,0,0,1,0,1,0.14285714285714285,1,0.0,0,0,0,0,0,0,0,1,0,0,1,0
4902,75226,8VNllEJU5IWGHwzKYxjVrn3uY1FEJx1D,SpATywNh6bZuzm8s1ceuBUnMUAeoAHHw,18,30,10,11,6,2,10,1,70,10.0,1,0.0,18,10,10,6,12,2,1,10,1,44,26,1
4903,75229,roZnXzS2HTclICKkrEV00q4r4cGpS00w,SpATywNh6bZuzm8s1ceuBUnMUAeoAHHw,15,14,6,12,3,3,2,0,40,5.714285714285714,1,0.0,5,6,12,3,9,3,0,2,0,26,14,1
4904,75237,RFr9TyIVEW42bBHoptkHxr0bo57RDi2m,7GRhBDsirIGkRZBtSMEzNTyDr2JQm4xx,37,40,12,42,18,2,3,0,117,16.714285714285715,1,0.0,27,12,36,18,13,2,6,3,0,93,24,1
4905,75239,azgXgRxypRV3MCHuv22g9fm7GCtWHZdX,SpATywNh6bZuzm8s1ceuBUnMUAeoAHHw,3,1,0,0,0,0,3,0,4,0.5714285714285714,1,0.0,0,0,0,0,1,0,0,3,0,0,4,1
4906,75244,pkcnSnJ3oMXJ1Rn021rYtsOpPmKbDGk6,7GRhBDsirIGkRZBtSMEzNTyDr2JQm4xx,23,34,17,14,10,5,2,0,82,11.714285714285714,1,0.0,13,17,7,10,21,5,7,2,0,47,35,1
4907,75258,JJYEr1YA7SClhqsLz61VElUYdghcCxlW,5X6FeZozNMgE2VRi3MJYjkkFK8SETtu2,3,2,0,0,0,0,2,0,4,0.5714285714285714,1,0.0,0,0,0,0,2,0,0,2,0,0,4,1
4908,75269,rlaxlckAFc9FC5RGSAxvTGGClfed4789,bWdj2GDclj5ofokWjzoa5jAwMkxCykd6,1,0,0,0,0,0,2,0,2,0.2857142857142857,1,0.0,0,0,0,0,0,0,0,2,0,0,2,0
4909,75272,YiYJ3RnpzhhfakeMA3KKlM5DPKZuE0U2,bWdj2GDclj5ofokWjzoa5jAwMkxCykd6,2,0,0,0,0,0,2,0,2,0.2857142857142857,1,0.0,0,0,0,0,0,0,0,2,0,0,2,1
4910,75279,t8eDuPU4MsZrMH2MoE1n7JeYLVBJZOGD,5X6FeZozNMgE2VRi3MJYjkkFK8SETtu2,30,21,6,28,6,0,10,1,72,10.285714285714286,3,0.0,12,6,28,6,9,0,0,10,1,52,20,0
4911,75305,tQwNuzxGOUPFYlY5A3ZFrjnMB9Szs2jV,A3fsA9Zfv1X2fVEQhTw51lKENdNrEqT3,1,0,0,0,0,0,1,0,1,0.14285714285714285,1,0.0,0,0,0,0,0,0,0,1,0,0,1,1
4912,75307,80mucTACVCDvIo1wfgGJkZ9oDdziiwCh,SpATywNh6bZuzm8s1ceuBUnMUAeoAHHw,3,2,0,0,0,0,1,0,3,0.42857142857142855,1,0.0,0,0,0,0,2,0,0,1,0,0,3,0
4913,75314,2IlOpdUgsPu5FVltj0flScFk4CeI7uHm,A3fsA9Zfv1X2fVEQhTw51lKENdNrEqT3,46,9,5,86,0,0,4,0,104,14.857142857142858,2,0.0,2,5,85,0,7,0,1,4,0,92,12,1
4914,75325,DcYuNoj7qO6bSoP00ZpC8JGbOHS0FkLq,A3fsA9Zfv1X2fVEQhTw51lKENdNrEqT3,1,0,0,0,0,0,1,0,1,0.14285714285714285,1,0.0,0,0,0,0,0,0,0,1,0,0,1,1
4915,75342,LYUpAsU4h8m8YAaUfY7NTYDa3U4FDtNg,G8EPVSXsOYB5YQWZGiz1aVq5Pgr2GrQu,9,4,3,0,3,0,2,0,12,1.7142857142857142,1,0.0,0,3,0,3,4,0,0,2,0,6,6,1
4916,75343,Z0wLwaqmdxgdDY3I1REtvLcfEmLLHTQn,SpATywNh6bZuzm8s1ceuBUnMUAeoAHHw,1,0,0,0,0,0,1,0,1,0.14285714285714285,1,0.0,0,0,0,0,0,0,0,1,0,0,1,1
4917,75352,gvSShG1YYTmpJLc5fUzYYJybQmPOEusw,RXDvfPUBYFlVdlueBFbLW0mhhAyGEqpt,31,40,19,31,16,4,17,2,129,18.428571428571427,2,0.0,14,19,29,16,26,4,2,17,2,78,51,1
4918,75374,a4lLJZ6TEk4Nk0N3U6P35yYFPwm8oPCu,SpATywNh6bZuzm8s1ceuBUnMUAeoAHHw,5,3,1,0,1,1,4,0,10,1.4285714285714286,1,0.0,0,1,0,1,3,1,0,4,0,2,8,1
4919,75379,MYsCU1zkMrWxPhV1b7wSL5LZIo1zGyhU,A3fsA9Zfv1X2fVEQhTw51lKENdNrEqT3,34,28,27,0,25,0,1,0,81,11.571428571428571,1,0.0,0,27,0,25,28,0,0,1,0,52,29,0
4920,75389,4hm01j0jNhOy0D3MAC90STk6UKDwkBuN,SpATywNh6bZuzm8s1ceuBUnMUAeoAHHw,4,2,0,0,0,0,2,0,4,0.5714285714285714,1,0.0,0,0,0,0,2,0,0,2,0,0,4,1
4921,75394,pbucftaYT0bUhiGeQH3fHhc1yRJzZ1IA,SpATywNh6bZuzm8s1ceuBUnMUAeoAHHw,12,6,5,0,5,0,1,0,17,2.4285714285714284,1,0.0,0,5,0,5,6,0,0,1,0,10,7,0
4922,75399,ZoYGnrXOVzOUx1IBbZEpgAgR6pM1f79T,SpATywNh6bZuzm8s1ceuBUnMUAeoAHHw,8,6,3,0,2,0,4,0,15,2.142857142857143,1,0.0,0,3,0,2,6,0,0,4,0,5,10,1
4923,75401,i93wq7dpRKS8LWX4FM6N5PqvNqUj0cQr,G8EPVSXsOYB5YQWZGiz1aVq5Pgr2GrQu,81,84,46,132,25,62,21,15,385,55.0,4,0.0,22,46,102,25,62,62,30,21,15,195,190,1
4924,75419,B2GQpolo5ouDH0z3sr0heBhmmfs3lRR0,bWdj2GDclj5ofokWjzoa5jAwMkxCykd6,5,2,0,0,0,0,6,0,8,1.1428571428571428,2,0.0,0,0,0,0,2,0,0,6,0,0,8,1
4925,75425,Th6GGIKucyCokdQsUn3aOeloTzqx0Qbo,G8EPVSXsOYB5YQWZGiz1aVq5Pgr2GrQu,20,24,0,0,0,6,3,0,33,4.714285714285714,1,0.0,2,0,0,0,22,6,0,3,0,2,31,1
4926,75426,Ii5I7AVMkxFqBe6GOJtwj479RGiJPW5D,5X6FeZozNMgE2VRi3MJYjkkFK8SETtu2,1,0,0,0,0,0,1,0,1,0.14285714285714285,1,0.0,0,0,0,0,0,0,0,1,0,0,1,1
4927,75433,vF3Wpw7dZ70yAQhvwH59vsIsW43Fy9UR,G8EPVSXsOYB5YQWZGiz1aVq5Pgr2GrQu,2,0,0,0,0,0,3,0,3,0.42857142857142855,1,0.0,0,0,0,0,0,0,0,3,0,0,3,1
4928,75459,5khGTvLU6yjmXaeHpWJGWa1iZGzL5YGz,bWdj2GDclj5ofokWjzoa5jAwMkxCykd6,1,0,0,0,0,0,1,0,1,0.14285714285714285,1,0.0,0,0,0,0,0,0,0,1,0,0,1,1
4929,75460,5khGTvLU6yjmXaeHpWJGWa1iZGzL5YGz,A3fsA9Zfv1X2fVEQhTw51lKENdNrEqT3,1,0,0,0,0,0,1,0,1,0.14285714285714285,1,0.0,0,0,0,0,0,0,0,1,0,0,1,1
4930,75467,SR6E1PEdPOWeoyx0JB3mYrCcyPyQVNur,SpATywNh6bZuzm8s1ceuBUnMUAeoAHHw,1,0,0,0,0,0,1,0,1,0.14285714285714285,1,0.0,0,0,0,0,0,0,0,1,0,0,1,1
4931,75497,EgqHA1OdkjYgdxhtnGhhZnjCGKC8K9Xc,A3fsA9Zfv1X2fVEQhTw51lKENdNrEqT3,4,0,0,0,0,0,6,0,6,0.8571428571428571,1,0.0,0,0,0,0,0,0,0,6,0,0,6,1
4932,75511,MYsCU1zkMrWxPhV1b7wSL5LZIo1zGyhU,RXDvfPUBYFlVdlueBFbLW0mhhAyGEqpt,18,12,9,0,8,0,1,0,30,4.285714285714286,1,0.0,2,9,0,8,10,0,0,1,0,19,11,0
4933,75519,xJjW1X2F9FnPULUeJMqNeOytdLBSBRfA,A3fsA9Zfv1X2fVEQhTw51lKENdNrEqT3,4,2,1,0,1,0,1,0,5,0.7142857142857143,1,0.0,0,1,0,1,2,0,0,1,0,2,3,1
4934,75520,9Ymehs8Guv0M3ykIpbJLNOnh3ut9xb1R,SpATywNh6bZuzm8s1ceuBUnMUAeoAHHw,12,26,9,0,5,0,8,0,48,6.857142857142857,1,0.0,13,9,0,5,13,0,0,8,0,27,21,1
4935,75532,VZpQ5fkZ1BnI92zZZncFhaR85gRVSNv5,bWdj2GDclj5ofokWjzoa5jAwMkxCykd6,1,0,0,0,0,0,1,0,1,0.14285714285714285,1,0.0,0,0,0,0,0,0,0,1,0,0,1,1
4936,75534,YJcptsgRBvUQgvUGKpQGU1OPeMTESrpy,bWdj2GDclj5ofokWjzoa5jAwMkxCykd6,7,7,4,0,2,0,2,0,15,2.142857142857143,1,0.0,1,4,0,2,6,0,0,2,0,7,8,1
4937,75546,r8DGbOGptFcObhXTHK1R95j3RAtmtYI9,SpATywNh6bZuzm8s1ceuBUnMUAeoAHHw,19,26,11,11,3,1,17,0,69,9.857142857142858,1,0.0,13,11,11,3,13,1,0,17,0,38,31,0
4938,75550,Dek55Yy14Wc8ji3EaeNQmJNgORQPfUnO,A3fsA9Zfv1X2fVEQhTw51lKENdNrEqT3,22,23,5,0,3,0,12,1,44,6.285714285714286,3,0.0,0,5,0,3,23,0,0,12,1,8,36,1
4939,75551,VZpQ5fkZ1BnI92zZZncFhaR85gRVSNv5,A3fsA9Zfv1X2fVEQhTw51lKENdNrEqT3,5,2,1,0,1,0,3,0,7,1.0,1,0.0,0,1,0,1,2,0,0,3,0,2,5,1
4940,75564,YJcptsgRBvUQgvUGKpQGU1OPeMTESrpy,A3fsA9Zfv1X2fVEQhTw51lKENdNrEqT3,7,3,2,0,2,0,2,0,9,1.2857142857142858,1,0.0,0,2,0,2,3,0,0,2,0,4,5,1
4941,75568,ZdxHJrP5CNTD1MfH7Z4GYI0JTs7bRCCq,SpATywNh6bZuzm8s1ceuBUnMUAeoAHHw,1,0,0,0,0,0,1,0,1,0.14285714285714285,1,0.0,0,0,0,0,0,0,0,1,0,0,1,1
4942,75569,XYe0CM3N7dYmrf9sLMa4FZv52JAuUnko,SpATywNh6bZuzm8s1ceuBUnMUAeoAHHw,6,4,1,0,1,0,1,0,7,1.0,1,0.0,0,1,0,1,4,0,0,1,0,2,5,1
4943,75587,hcKYo6bLhlANvHE0FxLuR4YY8jocfBwJ,RXDvfPUBYFlVdlueBFbLW0mhhAyGEqpt,1,0,0,0,0,0,2,0,2,0.2857142857142857,1,0.0,0,0,0,0,0,0,0,2,0,0,2,1
4944,75600,Xt4h1KWJBlSDSafJvdbE69LJiRLDiihq,A3fsA9Zfv1X2fVEQhTw51lKENdNrEqT3,7,12,2,0,1,0,3,0,18,2.5714285714285716,3,0.0,3,2,0,1,9,0,0,3,0,6,12,0
4945,75607,2rRO2m2Tts8mA1JnL8szKbbtUjTgDVrv,SpATywNh6bZuzm8s1ceuBUnMUAeoAHHw,1,0,0,0,0,0,1,0,1,0.14285714285714285,1,0.0,0,0,0,0,0,0,0,1,0,0,1,1
4946,75634,d89wuOHpC7Vn9JqPTUxlWcTfbXFz4Jqa,SpATywNh6bZuzm8s1ceuBUnMUAeoAHHw,1,0,0,0,0,0,1,0,1,0.14285714285714285,1,0.0,0,0,0,0,0,0,0,1,0,0,1,1
4947,75636,wVMamfzRvn8ggzqqz7KnBSjMVeEGKAVa,G8EPVSXsOYB5YQWZGiz1aVq5Pgr2GrQu,5,5,1,0,1,0,4,0,11,1.5714285714285714,1,0.0,3,1,0,1,2,0,0,4,0,5,6,1
4948,75642,jZTK26BTfBLHQKFhPE9kcyNEiSpfCkRJ,SpATywNh6bZuzm8s1ceuBUnMUAeoAHHw,20,24,10,17,7,0,7,1,66,9.428571428571429,2,0.0,6,10,15,7,18,0,2,7,1,38,28,0
4949,75653,opGP9S4qTowSY3s74oSvvaEMZTZCaex3,SpATywNh6bZuzm8s1ceuBUnMUAeoAHHw,4,2,0,0,0,1,3,0,6,0.8571428571428571,1,0.0,0,0,0,0,2,1,0,3,0,0,6,1
4950,75657,gdYB2uKieMG440BMMPn1TjGUEdcmZtra,SpATywNh6bZuzm8s1ceuBUnMUAeoAHHw,1,0,0,0,0,0,1,0,1,0.14285714285714285,1,0.0,0,0,0,0,0,0,0,1,0,0,1,1
4951,75662,nBvjxfottsOCrOycyCAN2ZrAK5pyyTJB,SpATywNh6bZuzm8s1ceuBUnMUAeoAHHw,5,2,1,0,1,1,2,0,7,1.0,1,0.0,0,1,0,1,2,1,0,2,0,2,5,0
4952,75672,900ZMEgjiXT78JdNbM02wL3ugTz6vLs2,SpATywNh6bZuzm8s1ceuBUnMUAeoAHHw,5,3,1,0,1,0,2,0,7,1.0,1,0.0,0,1,0,1,3,0,0,2,0,2,5,1
4953,75679,2DRoBN35Fg0xbk0dtkqR4hEGCgR0ym7U,SpATywNh6bZuzm8s1ceuBUnMUAeoAHHw,5,2,1,0,1,0,3,0,7,1.0,1,0.0,0,1,0,1,2,0,0,3,0,2,5,1
4954,75683,2jrpxtUIXsWPIVOxhzZkmXgvu9KlY2UV,5X6FeZozNMgE2VRi3MJYjkkFK8SETtu2,6,5,2,0,1,0,2,0,10,1.4285714285714286,2,0.0,0,2,0,1,5,0,0,2,0,3,7,1
4955,75689,NoiNbgKNGrBKsO5sdYiCtmGZFgGMLv9U,A3fsA9Zfv1X2fVEQhTw51lKENdNrEqT3,1,0,0,0,0,0,1,0,1,0.14285714285714285,1,0.0,0,0,0,0,0,0,0,1,0,0,1,1
4956,75690,BSh5O31gIGvDrYgmsU5wxbvxaTpBXZ4G,A3fsA9Zfv1X2fVEQhTw51lKENdNrEqT3,5,4,1,0,1,0,1,0,7,1.0,1,0.0,0,1,0,1,4,0,0,1,0,2,5,1
4957,75692,42ADuPtX4XbJqCPm754Am2gTrysmHBtZ,5X6FeZozNMgE2VRi3MJYjkkFK8SETtu2,4,2,1,0,0,1,3,1,8,1.1428571428571428,1,0.0,0,1,0,0,2,1,0,3,1,1,7,1
4958,75693,xLSpoVb23knkFiYzprt9lH19YWAHUscy,G8EPVSXsOYB5YQWZGiz1aVq5Pgr2GrQu,4,2,0,0,0,0,12,0,14,2.0,1,0.0,0,0,0,0,2,0,0,12,0,0,14,0
4959,75707,vQt9TYLzgldZ6xZevGT5tZaVh2QbxNnZ,A3fsA9Zfv1X2fVEQhTw51lKENdNrEqT3,1,0,0,0,0,0,1,0,1,0.14285714285714285,1,0.0,0,0,0,0,0,0,0,1,0,0,1,1
4960,75711,ONaGFOFSpTcGmGss3L3s1gXRn5LKjFn3,SpATywNh6bZuzm8s1ceuBUnMUAeoAHHw,5,1,1,0,1,2,2,0,7,1.0,1,0.0,0,1,0,1,1,2,0,2,0,2,5,1
4961,75713,UIuiknFcMQSDDlsjhv6DEHOmlCIlKRjg,5X6FeZozNMgE2VRi3MJYjkkFK8SETtu2,5,3,1,0,0,0,2,0,6,0.8571428571428571,1,0.0,0,1,0,0,3,0,0,2,0,1,5,1
4962,75721,hkOcH5tOuxyPKzObCfNaFgGI6cTMtgMP,SpATywNh6bZuzm8s1ceuBUnMUAeoAHHw,3,2,1,0,0,0,1,0,4,0.5714285714285714,1,0.0,0,1,0,0,2,0,0,1,0,1,3,0
4963,75722,HVhFikY19vIN7YGNsfMyCuWrJd1ba910,bWdj2GDclj5ofokWjzoa5jAwMkxCykd6,2,0,0,0,0,0,2,0,2,0.2857142857142857,1,0.0,0,0,0,0,0,0,0,2,0,0,2,1
4964,75736,bwGV7RxO9uTA6WTvdbogMOQvBlvVU3Dn,A3fsA9Zfv1X2fVEQhTw51lKENdNrEqT3,26,16,12,6,9,0,2,0,45,6.428571428571429,1,0.0,2,12,6,9,14,0,0,2,0,29,16,1
4965,75738,Fzmjh2xG2BFrAdVYbFRtDZxpTYA0nmbP,5X6FeZozNMgE2VRi3MJYjkkFK8SETtu2,4,5,0,0,1,0,2,0,8,1.1428571428571428,1,0.0,1,0,0,1,4,0,0,2,0,2,6,1
4966,75743,2ohWJM8Yz0bj21lrvUC1zfEo5S0znXME,A3fsA9Zfv1X2fVEQhTw51lKENdNrEqT3,4,3,0,0,0,0,3,0,6,0.8571428571428571,1,0.0,0,0,0,0,3,0,0,3,0,0,6,1
4967,75750,pXIGt0PRh4Kb7rmAnRSyrPgJarEYjwPQ,bWdj2GDclj5ofokWjzoa5jAwMkxCykd6,9,18,9,10,4,0,3,0,44,6.285714285714286,1,0.0,3,9,9,4,15,0,1,3,0,25,19,1
4968,75752,0CuRIhBavvQKL5rTT1QWf2kztAfRXZug,A3fsA9Zfv1X2fVEQhTw51lKENdNrEqT3,11,17,9,10,0,0,7,0,43,6.142857142857143,4,0.0,2,9,10,0,15,0,0,7,0,21,22,0
4969,75760,87yFIXn8YjKLNtiBpBtMqW5Rij3yU58s,SpATywNh6bZuzm8s1ceuBUnMUAeoAHHw,5,5,0,0,0,0,5,0,10,1.4285714285714286,1,0.0,0,0,0,0,5,0,0,5,0,0,10,0
4970,75761,Ez2wwRGD5HKrpBiFL1N8vI6Y03Eb7DuE,bWdj2GDclj5ofokWjzoa5jAwMkxCykd6,2,0,0,0,0,0,2,0,2,0.2857142857142857,1,0.0,0,0,0,0,0,0,0,2,0,0,2,1
4971,75767,Ez2wwRGD5HKrpBiFL1N8vI6Y03Eb7DuE,A3fsA9Zfv1X2fVEQhTw51lKENdNrEqT3,2,0,0,0,0,0,4,0,4,0.5714285714285714,1,0.0,0,0,0,0,0,0,0,4,0,0,4,1
4972,75772,nknXXbQsC6Q6nMDyRKc0MDJZg6KtAXBE,G8EPVSXsOYB5YQWZGiz1aVq5Pgr2GrQu,4,4,2,0,0,0,3,0,9,1.2857142857142858,1,0.0,0,2,0,0,4,0,0,3,0,2,7,0
4973,75790,rT1OrFQC18rdvYkTGYqwRgC7eDvihHsc,A3fsA9Zfv1X2fVEQhTw51lKENdNrEqT3,2,0,0,0,0,9,1,0,10,1.4285714285714286,1,0.0,0,0,0,0,0,9,0,1,0,0,10,1
4974,75805,MUIa6qD7GjPbUNaVCnuA1JB2CKlFxAhB,5X6FeZozNMgE2VRi3MJYjkkFK8SETtu2,10,8,6,0,1,0,7,0,22,3.142857142857143,1,0.0,0,6,0,1,8,0,0,7,0,7,15,1
4975,75808,HwVLN1J20SKxglwoAhZ25HfWKhmy2J55,bWdj2GDclj5ofokWjzoa5jAwMkxCykd6,28,13,7,40,1,6,13,2,82,11.714285714285714,1,0.0,4,7,28,1,9,6,12,13,2,40,42,0
4976,75810,5aTSEnkjfpLtMifb6I0aDufPHJiD4Kpv,A3fsA9Zfv1X2fVEQhTw51lKENdNrEqT3,1,0,0,0,0,0,1,0,1,0.14285714285714285,1,0.0,0,0,0,0,0,0,0,1,0,0,1,1
4977,75855,qoVEgoDHTZXl1xk3NNpgXC5ePtcEHLyo,SpATywNh6bZuzm8s1ceuBUnMUAeoAHHw,13,18,10,8,6,0,5,0,47,6.714285714285714,2,0.0,4,10,8,6,14,0,0,5,0,28,19,1
4978,75879,Slk5JcZSYHmDLQZXaNVmcMDmjJ16kBhI,SpATywNh6bZuzm8s1ceuBUnMUAeoAHHw,29,49,17,16,6,0,9,0,97,13.857142857142858,4,0.0,12,17,15,6,37,0,1,9,0,50,47,0
4979,75897,Y89GJdSZUpoYFMgx00SCe6qFoYoXIpUj,RXDvfPUBYFlVdlueBFbLW0mhhAyGEqpt,1,0,0,0,0,0,1,0,1,0.14285714285714285,1,0.0,0,0,0,0,0,0,0,1,0,0,1,1
4980,75926,nZMtHRGCOwkrOLE7E6uKf1YVlLLujKjO,G8EPVSXsOYB5YQWZGiz1aVq5Pgr2GrQu,7,5,1,0,1,0,2,0,9,1.2857142857142858,1,0.0,0,1,0,1,5,0,0,2,0,2,7,1
4981,75947,29wIR2YiGRVbsOT8ievKfVtP4R5px8Qo,5X6FeZozNMgE2VRi3MJYjkkFK8SETtu2,4,3,0,0,0,0,2,0,5,0.7142857142857143,1,0.0,0,0,0,0,3,0,0,2,0,0,5,1
4982,75961,usnYJ8MdQmnJqA1xJ5WyVx49Lm7npBxw,A3fsA9Zfv1X2fVEQhTw51lKENdNrEqT3,2,0,0,0,0,0,6,0,6,0.8571428571428571,1,0.0,0,0,0,0,0,0,0,6,0,0,6,1
4983,75972,QE1GAKkI5XZdeDVvm96I8rxHAhiLrarh,SpATywNh6bZuzm8s1ceuBUnMUAeoAHHw,1,0,0,0,0,0,1,0,1,0.14285714285714285,1,0.0,0,0,0,0,0,0,0,1,0,0,1,1
4984,75997,ye1qNcwLMVEAyXZxda61F8zTpgv5P1cn,bWdj2GDclj5ofokWjzoa5jAwMkxCykd6,25,26,10,114,12,2,8,1,173,24.714285714285715,1,0.0,14,10,111,12,12,2,3,8,1,147,26,1
4985,76003,2gIyQvzCOzwcg12cbPihdITZquwdviac,5X6FeZozNMgE2VRi3MJYjkkFK8SETtu2,4,2,1,0,1,0,1,0,5,0.7142857142857143,1,0.0,0,1,0,1,2,0,0,1,0,2,3,1
4986,76015,03LSJMJGCEPYScMXgYv3wZ9A4zZCWROs,SpATywNh6bZuzm8s1ceuBUnMUAeoAHHw,5,2,1,0,1,0,2,0,6,0.8571428571428571,1,0.0,0,1,0,1,2,0,0,2,0,2,4,1
4987,76025,VWQu1dhnKTy5XjlrKdDTFzN2ON0OJPXW,5X6FeZozNMgE2VRi3MJYjkkFK8SETtu2,1,0,0,0,0,0,1,0,1,0.14285714285714285,1,0.0,0,0,0,0,0,0,0,1,0,0,1,1
4988,76042,EdUEhKqzlcZzUOVd6gkhH4yikmNzaFOo,5X6FeZozNMgE2VRi3MJYjkkFK8SETtu2,2,0,0,0,0,0,3,0,3,0.42857142857142855,2,0.0,0,0,0,0,0,0,0,3,0,0,3,1
4989,76044,Qfr71fBWHfCr6Grcd1acKeeOb47jgXr2,RXDvfPUBYFlVdlueBFbLW0mhhAyGEqpt,7,4,2,0,1,0,2,0,9,1.2857142857142858,1,0.0,0,2,0,1,4,0,0,2,0,3,6,1
4990,76046,VQgE6No0aWl6KJGMl6ENY2W7pdT7Ee3x,SpATywNh6bZuzm8s1ceuBUnMUAeoAHHw,2,0,0,0,0,0,2,0,2,0.2857142857142857,1,0.0,0,0,0,0,0,0,0,2,0,0,2,1
4991,76052,1p0GemwRRphdcYcT1EB1KkjZ05b7lJJE,SpATywNh6bZuzm8s1ceuBUnMUAeoAHHw,1,0,0,0,0,0,1,0,1,0.14285714285714285,1,0.0,0,0,0,0,0,0,0,1,0,0,1,1
4992,76055,qX6GnUFvQV8fhcfo2vDxSk5lUZGpfHG2,SpATywNh6bZuzm8s1ceuBUnMUAeoAHHw,11,10,7,12,0,0,4,0,33,4.714285714285714,3,0.0,0,7,12,0,10,0,0,4,0,19,14,0
4993,76069,po8VsdSuE45R9f8cQhYrAT9xKsA9SY1D,SpATywNh6bZuzm8s1ceuBUnMUAeoAHHw,15,30,2,9,1,0,6,0,48,6.857142857142857,2,0.0,15,2,9,1,15,0,0,6,0,27,21,1
4994,76071,erW7pLi6zCDRwT5XL8FqOQCuc017OfKV,SpATywNh6bZuzm8s1ceuBUnMUAeoAHHw,3,2,1,0,0,0,1,0,4,0.5714285714285714,1,0.0,0,1,0,0,2,0,0,1,0,1,3,1
4995,76076,mMF5Hf2GkWKPKuwtMKnnuMzAQr3x7Iso,bWdj2GDclj5ofokWjzoa5jAwMkxCykd6,4,2,1,0,1,0,1,0,5,0.7142857142857143,1,0.0,0,1,0,1,2,0,0,1,0,2,3,1
4996,76088,wunZtNKxMsk2xAb7WtZTQgu1ulM02qIO,5X6FeZozNMgE2VRi3MJYjkkFK8SETtu2,3,2,1,0,0,0,1,0,4,0.5714285714285714,1,0.0,0,1,0,0,2,0,0,1,0,1,3,1
4997,76089,KwnxSTbiO8w9DjvNhEpJZXf1R621Cpug,A3fsA9Zfv1X2fVEQhTw51lKENdNrEqT3,4,0,0,0,0,1,7,0,8,1.1428571428571428,1,0.0,0,0,0,0,0,1,0,7,0,0,8,1
4998,76091,UcMBbV5apyBn6US03aF0lorBUPxtfuSB,bWdj2GDclj5ofokWjzoa5jAwMkxCykd6,5,4,0,0,0,0,1,0,5,0.7142857142857143,1,0.0,0,0,0,0,4,0,0,1,0,0,5,0
4999,76102,CjgJE17lQhs840ANyRWRY3zbs19fMxRt,SpATywNh6bZuzm8s1ceuBUnMUAeoAHHw,1,0,0,0,0,0,1,0,1,0.14285714285714285,1,0.0,0,0,0,0,0,0,0,1,0,0,1,1
5000,76108,zKXJGJg9DMEB2RAxuThjb4UbLJ2XM2gW,RXDvfPUBYFlVdlueBFbLW0mhhAyGEqpt,8,5,3,12,1,0,1,0,22,3.142857142857143,1,0.0,1,3,10,1,4,0,2,1,0,15,7,1
5001,76111,G5JFEd58i47FiqQxatEMibk5NL9uoQb2,5X6FeZozNMgE2VRi3MJYjkkFK8SETtu2,8,6,1,12,0,0,2,0,21,3.0,1,0.0,3,1,10,0,3,0,2,2,0,14,7,1
5002,76116,P2IHpZFxqRXDLPtwjrmd6pAQXPHckBAL,A3fsA9Zfv1X2fVEQhTw51lKENdNrEqT3,9,5,3,0,3,0,2,0,13,1.8571428571428572,1,0.0,0,3,0,3,5,0,0,2,0,6,7,1
5003,76121,UcMBbV5apyBn6US03aF0lorBUPxtfuSB,SpATywNh6bZuzm8s1ceuBUnMUAeoAHHw,4,3,0,0,0,0,1,0,4,0.5714285714285714,1,0.0,0,0,0,0,3,0,0,1,0,0,4,0
5004,76124,qciW3eHpuKm9iUPQVKuwWV8dfW8XAZ18,SpATywNh6bZuzm8s1ceuBUnMUAeoAHHw,5,2,1,0,1,0,2,0,6,0.8571428571428571,1,0.0,0,1,0,1,2,0,0,2,0,2,4,0
5005,76129,9fxxFfW4aPgoh2CUJjE52T1S8e5tZgpY,5X6FeZozNMgE2VRi3MJYjkkFK8SETtu2,24,56,16,17,11,2,8,1,111,15.857142857142858,2,0.0,24,16,13,11,32,2,4,8,1,64,47,1
5006,76137,clAPSIXt7Z3rqM3rGgd1wQzNC23LcW4e,G8EPVSXsOYB5YQWZGiz1aVq5Pgr2GrQu,1,0,0,0,0,0,1,0,1,0.14285714285714285,1,0.0,0,0,0,0,0,0,0,1,0,0,1,1
5007,76147,w7NaXVqLfb12JtbKUJJpaV8HtqNTI2Pp,RXDvfPUBYFlVdlueBFbLW0mhhAyGEqpt,9,7,5,0,2,0,6,0,20,2.857142857142857,3,0.0,0,5,0,2,7,0,0,6,0,7,13,1
5008,76157,AfNncKo8cCWFvFod2iPlCGZujMUUS876,5X6FeZozNMgE2VRi3MJYjkkFK8SETtu2,5,2,1,0,1,0,2,0,6,0.8571428571428571,1,0.0,0,1,0,1,2,0,0,2,0,2,4,1
5009,76162,1DSdmxxUMWOTHSkExvKthSEqp4DXhX5M,SpATywNh6bZuzm8s1ceuBUnMUAeoAHHw,1,0,0,0,0,0,1,0,1,0.14285714285714285,1,0.0,0,0,0,0,0,0,0,1,0,0,1,1
5010,76169,6RuWsSvS3Ngnjl37PzNAaaGn8Jd9a1lW,A3fsA9Zfv1X2fVEQhTw51lKENdNrEqT3,6,3,1,0,1,0,2,0,7,1.0,1,0.0,0,1,0,1,3,0,0,2,0,2,5,0
5011,76171,yYrk7RmkclaZIv32ppfmidCUMKYlGdCg,A3fsA9Zfv1X2fVEQhTw51lKENdNrEqT3,2,0,0,0,0,0,2,0,2,0.2857142857142857,1,0.0,0,0,0,0,0,0,0,2,0,0,2,1
5012,76175,2mxSfvrV4dprNDPX9sOXqPpvnwSid2Cc,RXDvfPUBYFlVdlueBFbLW0mhhAyGEqpt,8,5,3,0,1,0,2,0,11,1.5714285714285714,1,0.0,0,3,0,1,5,0,0,2,0,4,7,0
5013,76192,eeUPLnGQx37dkxrDcGRSCAvma26w8Yjq,RXDvfPUBYFlVdlueBFbLW0mhhAyGEqpt,2,0,0,0,0,1,1,0,2,0.2857142857142857,1,0.0,0,0,0,0,0,1,0,1,0,0,2,0
5014,76196,QIvWlVh4DGWYNW4pCjLKrTx8CHKBwzBx,A3fsA9Zfv1X2fVEQhTw51lKENdNrEqT3,7,3,1,0,1,0,5,0,10,1.4285714285714286,1,0.0,0,1,0,1,3,0,0,5,0,2,8,1
5015,76221,b3SOFZmts4SmXw5596bSnHzqI34305P2,A3fsA9Zfv1X2fVEQhTw51lKENdNrEqT3,8,7,0,0,0,0,5,0,12,1.7142857142857142,1,0.0,0,0,0,0,7,0,0,5,0,0,12,1
5016,76229,xI7ax9Ka1esjgFn8PpUpxkEbwfVImQEH,SpATywNh6bZuzm8s1ceuBUnMUAeoAHHw,1,0,0,0,0,0,1,0,1,0.14285714285714285,1,0.0,0,0,0,0,0,0,0,1,0,0,1,1
5017,76232,o9SCOAY5nuSxaVorNF1mq3E0AGKQbCox,G8EPVSXsOYB5YQWZGiz1aVq5Pgr2GrQu,39,38,0,0,0,0,2,1,41,5.857142857142857,1,0.0,0,0,0,0,38,0,0,2,1,0,41,1
5018,76234,tBEEN04LrGCBpwUCJaMiCLFgfmCnlUJk,5X6FeZozNMgE2VRi3MJYjkkFK8SETtu2,1,0,0,0,0,0,1,0,1,0.14285714285714285,1,0.0,0,0,0,0,0,0,0,1,0,0,1,1
5019,76235,jByBG50ghoSer5UP92qpkAfDGFpraaH7,SpATywNh6bZuzm8s1ceuBUnMUAeoAHHw,3,2,1,0,0,0,1,0,4,0.5714285714285714,1,0.0,0,1,0,0,2,0,0,1,0,1,3,0
5020,76237,tBEEN04LrGCBpwUCJaMiCLFgfmCnlUJk,A3fsA9Zfv1X2fVEQhTw51lKENdNrEqT3,1,0,0,0,0,0,1,0,1,0.14285714285714285,1,0.0,0,0,0,0,0,0,0,1,0,0,1,1
5021,76243,6RuWsSvS3Ngnjl37PzNAaaGn8Jd9a1lW,5X6FeZozNMgE2VRi3MJYjkkFK8SETtu2,6,8,2,0,3,0,5,0,18,2.5714285714285716,3,0.0,2,2,0,3,6,0,0,5,0,7,11,0
5022,76269,wXBHYtvPptXdCPYqduCnU02Sq8QZUVkp,SpATywNh6bZuzm8s1ceuBUnMUAeoAHHw,16,23,3,0,1,0,6,1,34,4.857142857142857,3,0.0,0,3,0,1,23,0,0,6,1,4,30,1
5023,76270,BCPhbcVTukJPsOtUJJbyOWvpso8GiEV1,5X6FeZozNMgE2VRi3MJYjkkFK8SETtu2,1,0,0,0,0,0,1,0,1,0.14285714285714285,1,0.0,0,0,0,0,0,0,0,1,0,0,1,1
5024,76272,BCPhbcVTukJPsOtUJJbyOWvpso8GiEV1,bWdj2GDclj5ofokWjzoa5jAwMkxCykd6,4,2,0,0,0,0,2,0,4,0.5714285714285714,1,0.0,0,0,0,0,2,0,0,2,0,0,4,1
5025,76287,PouMCXf669TnZYoflZVyLCeWfAZS1SwB,SpATywNh6bZuzm8s1ceuBUnMUAeoAHHw,1,0,0,0,0,0,1,0,1,0.14285714285714285,1,0.0,0,0,0,0,0,0,0,1,0,0,1,1
5026,76295,Slk5JcZSYHmDLQZXaNVmcMDmjJ16kBhI,bWdj2GDclj5ofokWjzoa5jAwMkxCykd6,33,46,19,44,2,1,5,0,117,16.714285714285715,7,0.0,7,19,41,2,39,1,3,5,0,69,48,0
5027,76320,BXL9nH3f6LphZe9b92PH9mstGPVs8XeE,7GRhBDsirIGkRZBtSMEzNTyDr2JQm4xx,9,2,2,0,1,2,6,0,13,1.8571428571428572,1,0.0,0,2,0,1,2,2,0,6,0,3,10,1
5028,76325,R5PVQLHQfRcyGqt0KVpTkwcmfBgB3rs1,7GRhBDsirIGkRZBtSMEzNTyDr2JQm4xx,27,51,12,10,9,2,10,0,94,13.428571428571429,4,0.0,24,12,5,9,27,2,5,10,0,50,44,0
5029,76332,kj5o7wMZl1s4q0cggcmipnm7O7L6g4Ps,7GRhBDsirIGkRZBtSMEzNTyDr2JQm4xx,4,2,1,0,1,0,1,0,5,0.7142857142857143,1,0.0,0,1,0,1,2,0,0,1,0,2,3,1
5030,76335,dSl7zOv7kGW6u17PjzlP5zgwvHOZv7rt,7GRhBDsirIGkRZBtSMEzNTyDr2JQm4xx,6,3,1,0,1,0,2,0,7,1.0,1,0.0,0,1,0,1,3,0,0,2,0,2,5,1
5031,76337,6sGNi05QsObpATkcEQjWHXDNKN41Upok,7GRhBDsirIGkRZBtSMEzNTyDr2JQm4xx,1,0,0,0,0,0,1,0,1,0.14285714285714285,1,0.0,0,0,0,0,0,0,0,1,0,0,1,1
5032,76344,iovbYKZEVn8y0HWLmItml8gjngEc7lb2,7GRhBDsirIGkRZBtSMEzNTyDr2JQm4xx,9,3,2,0,2,0,9,0,16,2.2857142857142856,1,0.0,0,2,0,2,3,0,0,9,0,4,12,0
5033,76349,oIHEiOwjcaMd5CeWZdkq4rXU3yelDWwT,7GRhBDsirIGkRZBtSMEzNTyDr2JQm4xx,42,36,10,34,12,3,12,1,108,15.428571428571429,2,0.0,14,10,19,12,22,3,15,12,1,55,53,0
5034,76354,EC7JgbRpr51TVuV7NLrdIDBFtnNPPSiG,7GRhBDsirIGkRZBtSMEzNTyDr2JQm4xx,1,0,0,0,0,0,1,0,1,0.14285714285714285,1,0.0,0,0,0,0,0,0,0,1,0,0,1,1
5035,76359,jhg3s2dxy9WdrRmT5pz5jPUSUOVpJNeP,7GRhBDsirIGkRZBtSMEzNTyDr2JQm4xx,17,22,10,0,6,0,10,0,48,6.857142857142857,1,0.0,0,10,0,6,22,0,0,10,0,16,32,1
5036,76368,Kcl98h3mNpyExmJuf2coZt58rSEztGxk,7GRhBDsirIGkRZBtSMEzNTyDr2JQm4xx,38,41,20,36,23,0,4,0,124,17.714285714285715,3,0.0,18,20,32,23,23,0,4,4,0,93,31,0
5037,76371,ROmjxRyD0zRa5rrnW4EKeskNImToIKPq,7GRhBDsirIGkRZBtSMEzNTyDr2JQm4xx,2,0,0,0,0,0,2,0,2,0.2857142857142857,1,0.0,0,0,0,0,0,0,0,2,0,0,2,1
5038,76380,r35LdxNTWJfdVQvcp8RZKTAJgxX1nfp9,5Gyp41oLVo7Gg7vF4vpmggWP5MU70QO6,7,4,3,0,2,0,3,0,12,1.7142857142857142,1,0.0,0,3,0,2,4,0,0,3,0,5,7,1
5039,76381,tZiEWSG4ckYuEfMlEJuKYvivoXtHRnol,5Gyp41oLVo7Gg7vF4vpmggWP5MU70QO6,34,44,27,0,13,41,28,4,157,22.428571428571427,9,0.0,8,27,0,13,36,41,0,28,4,48,109,0
5040,76403,F3cHapYVPmy1vgqQH9zl0AmAMhu2Xtco,5Gyp41oLVo7Gg7vF4vpmggWP5MU70QO6,1,0,0,0,0,0,1,0,1,0.14285714285714285,1,0.0,0,0,0,0,0,0,0,1,0,0,1,1
5041,76425,czTQ5ELSy91Dy79vk5MgxZdL9nunJtpb,5Gyp41oLVo7Gg7vF4vpmggWP5MU70QO6,11,15,8,0,3,0,3,0,29,4.142857142857143,3,0.0,0,8,0,3,15,0,0,3,0,11,18,1
5042,76429,0MCpaDlfe0ogU0Bpr8YdZUzqGocNSgue,5Gyp41oLVo7Gg7vF4vpmggWP5MU70QO6,1,0,0,0,0,0,1,0,1,0.14285714285714285,1,0.0,0,0,0,0,0,0,0,1,0,0,1,1
5043,76434,01REfzd0bHyPVP3nfAw98BhXBIGkncM6,5Gyp41oLVo7Gg7vF4vpmggWP5MU70QO6,1,0,0,0,0,0,1,0,1,0.14285714285714285,1,0.0,0,0,0,0,0,0,0,1,0,0,1,1
5044,76436,OcUGJyMjBmkUYRCBKiZMQQTnkl0U1Q1K,5Gyp41oLVo7Gg7vF4vpmggWP5MU70QO6,9,5,3,2,2,0,2,0,14,2.0,2,0.0,1,3,1,2,4,0,1,2,0,7,7,1
5045,76438,dpgaw2nKuBdnbOGRuhwVGCL68MKxXQr7,5Gyp41oLVo7Gg7vF4vpmggWP5MU70QO6,5,3,2,0,0,0,2,0,7,1.0,1,0.0,0,2,0,0,3,0,0,2,0,2,5,1
5046,76447,2rS9ufrltSIJVkQHjlKCjTvqcoR7anzz,5Gyp41oLVo7Gg7vF4vpmggWP5MU70QO6,6,4,3,0,0,0,3,0,10,1.4285714285714286,2,0.0,0,3,0,0,4,0,0,3,0,3,7,1
5047,76451,W38DcguBOORgyx8AQARyx9O00yMNPg6e,5Gyp41oLVo7Gg7vF4vpmggWP5MU70QO6,1,0,0,0,0,0,1,0,1,0.14285714285714285,1,0.0,0,0,0,0,0,0,0,1,0,0,1,1
5048,76453,P7HoHyQzVXLghYr6m3MYTEIsDQbHfDfp,5Gyp41oLVo7Gg7vF4vpmggWP5MU70QO6,10,11,8,0,4,0,7,0,30,4.285714285714286,4,0.0,0,8,0,4,11,0,0,7,0,12,18,1
5049,76464,HZfVkUj1UTn8X6ZLuJMgL4oCnEEXA6p2,5Gyp41oLVo7Gg7vF4vpmggWP5MU70QO6,42,89,39,3,38,4,26,1,200,28.571428571428573,8,0.0,31,39,2,38,58,4,1,26,1,110,90,0
5050,76469,Qi3PLuC7w2Yo9hFgq37MObjY8icnRdc6,5Gyp41oLVo7Gg7vF4vpmggWP5MU70QO6,41,164,68,22,39,68,35,2,398,56.857142857142854,11,0.0,40,68,15,39,124,68,7,35,2,162,236,1
5051,76471,GVRJN4wkoooaXJUVmwnX983A87KsrZPK,5Gyp41oLVo7Gg7vF4vpmggWP5MU70QO6,29,31,18,21,5,9,12,0,96,13.714285714285714,5,0.0,8,18,15,5,23,9,6,12,0,46,50,0
5052,76478,Nh4ykrZCKJQE0joZJf6OOl8TVvMpZEMx,5Gyp41oLVo7Gg7vF4vpmggWP5MU70QO6,1,0,0,0,0,0,1,0,1,0.14285714285714285,1,0.0,0,0,0,0,0,0,0,1,0,0,1,1
5053,76500,oXyTsuSH1YW2a61VoEY0YGjslddJVdhA,5Gyp41oLVo7Gg7vF4vpmggWP5MU70QO6,25,73,44,68,0,0,17,0,202,28.857142857142858,6,0.0,14,44,59,0,59,0,9,17,0,117,85,1
5054,76512,23VoQcTxASSDASFUAvUuymCcwOQv9RSj,5Gyp41oLVo7Gg7vF4vpmggWP5MU70QO6,2,0,0,0,0,0,4,0,4,0.5714285714285714,1,0.0,0,0,0,0,0,0,0,4,0,0,4,1
5055,76525,TLX7LJS0ydCwjKB1WIZECukWF1RMIWp2,5Gyp41oLVo7Gg7vF4vpmggWP5MU70QO6,7,3,2,0,2,0,2,0,9,1.2857142857142858,1,0.0,0,2,0,2,3,0,0,2,0,4,5,1
5056,76530,Blc2cPbaiLlSJOOyzIgyUkjSqEuJ1hID,5Gyp41oLVo7Gg7vF4vpmggWP5MU70QO6,10,15,7,0,2,0,10,1,35,5.0,3,0.0,2,7,0,2,13,0,0,10,1,11,24,0
5057,76538,3LhbWzGmJxAgtRjE8h3SMA5rd0ifwtoR,5Gyp41oLVo7Gg7vF4vpmggWP5MU70QO6,7,3,2,0,2,0,2,0,9,1.2857142857142858,1,0.0,0,2,0,2,3,0,0,2,0,4,5,1
5058,76547,3kmVKNRbGOm4fMFsW3dgnHkHEGKHE1G0,5Gyp41oLVo7Gg7vF4vpmggWP5MU70QO6,41,117,60,9,12,27,16,0,241,34.42857142857143,7,0.0,44,60,6,12,73,27,3,16,0,122,119,0
5059,76588,qdOxhk95r6WmeaG3FUGj8tSBbwNHowPZ,5Gyp41oLVo7Gg7vF4vpmggWP5MU70QO6,2,0,0,0,0,0,2,0,2,0.2857142857142857,1,0.0,0,0,0,0,0,0,0,2,0,0,2,1
5060,76600,zOEgMOav7CUMwRRFWKO0oz29ko7pIf8n,5Gyp41oLVo7Gg7vF4vpmggWP5MU70QO6,20,80,30,8,11,17,12,1,159,22.714285714285715,2,0.0,13,30,4,11,67,17,4,12,1,58,101,1
5061,76602,8yrIKDtnkYcLfERwrXrvcRGxHxbt2Jd3,5Gyp41oLVo7Gg7vF4vpmggWP5MU70QO6,6,16,2,0,0,0,5,0,23,3.2857142857142856,2,0.0,0,2,0,0,16,0,0,5,0,2,21,0
5062,76611,wGXRcY0FS7DP9yn6e6xwYPxjUYuVv96W,5Gyp41oLVo7Gg7vF4vpmggWP5MU70QO6,7,6,4,0,2,0,2,0,14,2.0,1,0.0,0,4,0,2,6,0,0,2,0,6,8,1
5063,76629,dZVJyJJSeeVocn7cMiTOV5aW6B1w5NEB,5Gyp41oLVo7Gg7vF4vpmggWP5MU70QO6,1,0,0,0,0,0,1,0,1,0.14285714285714285,1,0.0,0,0,0,0,0,0,0,1,0,0,1,1
5064,76637,iQ1ZOAneqV9rONJvmuuo7x6SpSQnMfuP,5Gyp41oLVo7Gg7vF4vpmggWP5MU70QO6,8,4,2,0,1,0,8,0,15,2.142857142857143,3,0.0,0,2,0,1,4,0,0,8,0,3,12,0
5065,76657,XcI7uEjIr1DmRehhSSqydR1U47iJlOYT,5Gyp41oLVo7Gg7vF4vpmggWP5MU70QO6,20,38,21,24,2,27,15,0,127,18.142857142857142,8,0.0,7,21,21,2,31,27,3,15,0,51,76,0
5066,76664,5DIZTCmFTMb3LFveBGIs4k3JMiXmUcsw,5Gyp41oLVo7Gg7vF4vpmggWP5MU70QO6,5,1,0,0,1,0,3,0,5,0.7142857142857143,1,0.0,0,0,0,1,1,0,0,3,0,1,4,1
5067,76667,RDr32Woc9myoQw2Xi6L4iYcJgFRmol6W,5Gyp41oLVo7Gg7vF4vpmggWP5MU70QO6,9,5,3,0,2,1,5,1,17,2.4285714285714284,1,0.0,0,3,0,2,5,1,0,5,1,5,12,1
5068,76686,0V5njqYhG6vk5oGbavFWKAqcyUFQti8J,5Gyp41oLVo7Gg7vF4vpmggWP5MU70QO6,9,13,4,0,1,1,11,0,30,4.285714285714286,3,0.0,0,4,0,1,13,1,0,11,0,5,25,1
5069,76690,JOkOOayftI7KyiA2jVmQZXbUOyL5Y1Sp,5Gyp41oLVo7Gg7vF4vpmggWP5MU70QO6,17,25,12,12,7,11,4,0,71,10.142857142857142,1,0.0,7,12,6,7,18,11,6,4,0,32,39,1
5070,76693,hqCEmHevHWO3zOOJGQPPXN8yqCSfkWdM,5Gyp41oLVo7Gg7vF4vpmggWP5MU70QO6,8,9,5,0,4,0,3,0,21,3.0,2,0.0,0,5,0,4,9,0,0,3,0,9,12,1
5071,76706,IN8gEmlASGy70WohZx2nMtKudBlGVvbl,5Gyp41oLVo7Gg7vF4vpmggWP5MU70QO6,7,5,1,0,1,0,2,0,9,1.2857142857142858,1,0.0,0,1,0,1,5,0,0,2,0,2,7,1
5072,76730,K7CgKRgMVffqmfQ4icZywy4tOpnKzbbo,5Gyp41oLVo7Gg7vF4vpmggWP5MU70QO6,26,48,19,24,12,1,17,4,125,17.857142857142858,5,0.0,15,19,15,12,33,1,9,17,4,61,64,1
5073,76761,aQHjMngXqegLudsDYka25fojRIIJUDh0,5Gyp41oLVo7Gg7vF4vpmggWP5MU70QO6,5,1,1,0,1,0,2,0,5,0.7142857142857143,1,0.0,0,1,0,1,1,0,0,2,0,2,3,1
5074,76786,5kiOQEoxCz9L4xn13ZLtWmbzfanKQzAY,5Gyp41oLVo7Gg7vF4vpmggWP5MU70QO6,19,48,12,6,13,11,5,0,95,13.571428571428571,4,0.0,14,12,4,13,34,11,2,5,0,43,52,0
5075,76790,I5rgeNU6h77yZVA7kJlQEH8sZiClxs9R,5Gyp41oLVo7Gg7vF4vpmggWP5MU70QO6,1,0,0,0,0,0,1,0,1,0.14285714285714285,1,0.0,0,0,0,0,0,0,0,1,0,0,1,1
5076,76807,HpN38BOEWC4MTqFjdUgj3lllv5aUQAFF,5Gyp41oLVo7Gg7vF4vpmggWP5MU70QO6,5,2,1,0,1,0,2,0,6,0.8571428571428571,1,0.0,0,1,0,1,2,0,0,2,0,2,4,1
5077,76811,txK1IajTGQpVcQ72n86NIa2loiwGFz8z,5Gyp41oLVo7Gg7vF4vpmggWP5MU70QO6,14,21,14,11,0,0,5,0,51,7.285714285714286,4,0.0,3,14,9,0,18,0,2,5,0,26,25,0
5078,76825,DPgt1nWWpEPCVlM5JMAOCZotwCwXYBrq,5Gyp41oLVo7Gg7vF4vpmggWP5MU70QO6,7,3,2,0,2,0,3,0,10,1.4285714285714286,1,0.0,0,2,0,2,3,0,0,3,0,4,6,1
5079,76828,RfQgAwEjK7W6GIZVrYc3gRVqD6FBHekC,5Gyp41oLVo7Gg7vF4vpmggWP5MU70QO6,65,1193,400,87,171,84,63,3,2001,285.85714285714283,19,0.0,528,400,47,171,665,84,40,63,3,1146,855,1
5080,76836,fmOsSyqJ3MkCLmkBTf9TaKxgCi9OoSQc,5Gyp41oLVo7Gg7vF4vpmggWP5MU70QO6,8,7,5,0,4,0,1,0,17,2.4285714285714284,1,0.0,1,5,0,4,6,0,0,1,0,10,7,1
5081,76837,QQOQ1mBFT0hbDG4vhxUnw8WQ7hq3XsN0,5Gyp41oLVo7Gg7vF4vpmggWP5MU70QO6,4,2,0,0,0,0,2,0,4,0.5714285714285714,1,0.0,0,0,0,0,2,0,0,2,0,0,4,1
5082,76846,bzKtHOPFUaea15sNycgmBf8B2nTVyZo6,5Gyp41oLVo7Gg7vF4vpmggWP5MU70QO6,65,94,51,54,22,4,20,0,245,35.0,10,0.0,29,51,45,22,65,4,9,20,0,147,98,0
5083,76858,Z8E1fWEz0b5y6BD6dlIVX2UJWlqxRpHR,5Gyp41oLVo7Gg7vF4vpmggWP5MU70QO6,28,77,39,35,18,0,14,0,183,26.142857142857142,11,0.0,21,39,29,18,56,0,6,14,0,107,76,1
5084,76861,cYibpCaMUGq0WjgUWfTv0iIvJ7QbFj5E,5Gyp41oLVo7Gg7vF4vpmggWP5MU70QO6,11,3,3,0,3,0,6,1,16,2.2857142857142856,3,0.0,0,3,0,3,3,0,0,6,1,6,10,1
5085,76876,HcXHj2yLx983REjBajdZ52KZySziWl80,5Gyp41oLVo7Gg7vF4vpmggWP5MU70QO6,2,0,0,0,0,0,4,0,4,0.5714285714285714,1,0.0,0,0,0,0,0,0,0,4,0,0,4,1
5086,76881,RcjpucDzUC1iswD9S4CPE7gWCBaAR7b9,5Gyp41oLVo7Gg7vF4vpmggWP5MU70QO6,26,86,35,32,3,16,32,7,211,30.142857142857142,9,0.0,17,35,24,3,69,16,8,32,7,79,132,0
5087,76891,aBjRmwE0qVwVv54guv7sKRAwotzxH80x,5Gyp41oLVo7Gg7vF4vpmggWP5MU70QO6,6,15,9,0,4,0,24,0,52,7.428571428571429,5,0.0,0,9,0,4,15,0,0,24,0,13,39,0
5088,76896,jtxvuHBV8ZOgNnNCL1A1WerzR2TVfFNy,5Gyp41oLVo7Gg7vF4vpmggWP5MU70QO6,47,124,71,132,26,12,16,0,381,54.42857142857143,10,0.0,32,71,115,26,92,12,17,16,0,244,137,0
5089,76908,C0QLYaW6rtZSCQAW7HOPSLZOO4bSdDa7,5Gyp41oLVo7Gg7vF4vpmggWP5MU70QO6,10,15,6,0,3,0,3,0,27,3.857142857142857,3,0.0,2,6,0,3,13,0,0,3,0,11,16,1
5090,76914,ceKKJVPiFWJDEPgwoHma8Ge3V9JM7lTS,5Gyp41oLVo7Gg7vF4vpmggWP5MU70QO6,5,5,2,0,0,0,2,0,9,1.2857142857142858,2,0.0,1,2,0,0,4,0,0,2,0,3,6,1
5091,76919,9Nmjm4BvnbKTQ3ZZwECYdKy9zBNGmQNW,5Gyp41oLVo7Gg7vF4vpmggWP5MU70QO6,1,0,0,0,0,0,1,0,1,0.14285714285714285,1,0.0,0,0,0,0,0,0,0,1,0,0,1,1
5092,76920,b2X2fnB79GNMQdIzmD5l0K2cgWGf5AR4,5Gyp41oLVo7Gg7vF4vpmggWP5MU70QO6,8,4,3,0,2,0,2,0,11,1.5714285714285714,1,0.0,0,3,0,2,4,0,0,2,0,5,6,1
5093,76950,e1Ni97fhQkMnOfSs68693wQS8Fze4UXJ,7GRhBDsirIGkRZBtSMEzNTyDr2JQm4xx,13,11,8,0,5,0,2,0,26,3.7142857142857144,2,0.0,0,8,0,5,11,0,0,2,0,13,13,1
5094,77034,s6iksgptFmyh2vfiarKdJkiKnp6RLi3f,7GRhBDsirIGkRZBtSMEzNTyDr2JQm4xx,18,21,14,0,14,1,2,0,52,7.428571428571429,2,0.0,6,14,0,14,15,1,0,2,0,34,18,0
5095,77179,eoSLO9oJFq2ypi74bXNS4eHCMDLAFDL3,fbPkOYLVPtPgIt0MxizjfFJov3JbHyAi,17,42,25,8,7,7,17,1,107,15.285714285714286,3,0.0,4,25,6,7,38,7,2,17,1,42,65,0
5096,77207,AXWWqNDiRDejTjo5V7yUaMbjtzXKhlP0,fbPkOYLVPtPgIt0MxizjfFJov3JbHyAi,6,3,2,0,0,1,3,0,9,1.2857142857142858,1,0.0,0,2,0,0,3,1,0,3,0,2,7,1
5097,77217,QRNQyo9fRzqgUX2q0vTfj8EzY2qkaaCu,5Gyp41oLVo7Gg7vF4vpmggWP5MU70QO6,19,24,9,22,6,6,10,1,78,11.142857142857142,2,0.0,12,9,17,6,12,6,5,10,1,44,34,1
5098,77225,WV6kBxOjvrRHSlIpkoZong2JAf7M5bhc,5Gyp41oLVo7Gg7vF4vpmggWP5MU70QO6,9,9,4,0,3,0,4,0,20,2.857142857142857,1,0.0,0,4,0,3,9,0,0,4,0,7,13,1
5099,77254,Xj3CWtnTWB4m6gYguTHbfyC0Omwc8AeO,5Gyp41oLVo7Gg7vF4vpmggWP5MU70QO6,11,6,4,0,3,0,6,1,20,2.857142857142857,1,0.0,0,4,0,3,6,0,0,6,1,7,13,1
5100,77264,inR4nWyRwTj5VInI1qBYZxVb5NkAgObN,5Gyp41oLVo7Gg7vF4vpmggWP5MU70QO6,7,3,2,0,2,0,3,0,10,1.4285714285714286,1,0.0,0,2,0,2,3,0,0,3,0,4,6,1
5101,77267,gCxbOVEJ7FeSqOiwKbB6HzPEL3I9x6ca,5Gyp41oLVo7Gg7vF4vpmggWP5MU70QO6,15,17,9,2,2,25,9,0,64,9.142857142857142,2,0.0,5,9,1,2,12,25,1,9,0,17,47,1
5102,77274,cLY0QedPVSDHE0E9NRua57b8raELruZw,5Gyp41oLVo7Gg7vF4vpmggWP5MU70QO6,20,36,3,49,5,0,11,1,105,15.0,5,0.0,7,3,42,5,29,0,7,11,1,57,48,1
5103,77279,1APzoh3KTfIe4NQ3KAf0SKmIs5QtPkYp,fbPkOYLVPtPgIt0MxizjfFJov3JbHyAi,2,0,0,0,0,0,2,0,2,0.2857142857142857,1,0.0,0,0,0,0,0,0,0,2,0,0,2,1
5104,77280,HNOGJwV4rdRhqUou8hYUuOI1xR3yp1lD,fbPkOYLVPtPgIt0MxizjfFJov3JbHyAi,11,4,3,0,3,1,4,1,16,2.2857142857142856,1,0.0,0,3,0,3,4,1,0,4,1,6,10,1
5105,77284,a7Bcg3aa7MqnyDqhPEpyx9fS4SMptY3m,fbPkOYLVPtPgIt0MxizjfFJov3JbHyAi,6,4,1,0,1,0,2,0,8,1.1428571428571428,1,0.0,0,1,0,1,4,0,0,2,0,2,6,1
5106,77286,bmHPkhsao4f2BTxdwnZZHpZIKe38OLFK,fbPkOYLVPtPgIt0MxizjfFJov3JbHyAi,11,24,4,9,9,0,3,0,49,7.0,1,0.0,19,4,9,9,5,0,0,3,0,41,8,0
5107,77290,yjv4fWxgBh3oNe3vGpcEgJYTY3lZDEJ7,fbPkOYLVPtPgIt0MxizjfFJov3JbHyAi,12,12,6,0,3,0,4,0,25,3.5714285714285716,1,0.0,0,6,0,3,12,0,0,4,0,9,16,1
5108,77292,lYs6uTLhEyomcaec07g09oLWhf3wcIzp,fbPkOYLVPtPgIt0MxizjfFJov3JbHyAi,7,3,2,0,2,0,2,0,9,1.2857142857142858,1,0.0,0,2,0,2,3,0,0,2,0,4,5,1
5109,77293,yGzWkCztUWXAvPvFdaROSwu9Gxp9wpii,fbPkOYLVPtPgIt0MxizjfFJov3JbHyAi,41,64,44,52,10,67,10,0,247,35.285714285714285,2,0.0,10,44,47,10,54,67,5,10,0,111,136,0
5110,77295,dHUuZjpItF11lyBzOZmo46k7ssSyfCST,fbPkOYLVPtPgIt0MxizjfFJov3JbHyAi,1,0,0,0,0,0,1,0,1,0.14285714285714285,1,0.0,0,0,0,0,0,0,0,1,0,0,1,1
5111,77296,AoPMS1aocKySHG5G4KmN0kwNsp9QUjuC,fbPkOYLVPtPgIt0MxizjfFJov3JbHyAi,1,0,0,0,0,0,1,0,1,0.14285714285714285,1,0.0,0,0,0,0,0,0,0,1,0,0,1,1
5112,77299,Koz1ZA2l1oXbWFXWhjywfJjDT8YkU22X,fbPkOYLVPtPgIt0MxizjfFJov3JbHyAi,7,4,2,0,2,0,2,0,10,1.4285714285714286,1,0.0,1,2,0,2,3,0,0,2,0,5,5,1
5113,77300,nrvnGbNgEbMCBnDyUIcDWTB4Vb2f0K6G,fbPkOYLVPtPgIt0MxizjfFJov3JbHyAi,7,9,1,8,2,0,2,0,22,3.142857142857143,1,0.0,3,1,6,2,6,0,2,2,0,12,10,1
5114,77304,nknXXbQsC6Q6nMDyRKc0MDJZg6KtAXBE,fbPkOYLVPtPgIt0MxizjfFJov3JbHyAi,7,4,3,0,2,0,1,0,10,1.4285714285714286,1,0.0,0,3,0,2,4,0,0,1,0,5,5,1
5115,77305,gdYB2uKieMG440BMMPn1TjGUEdcmZtra,fbPkOYLVPtPgIt0MxizjfFJov3JbHyAi,6,3,1,0,1,0,2,0,7,1.0,1,0.0,0,1,0,1,3,0,0,2,0,2,5,1
5116,77306,skAMaBabPIaxUxfkPa75q1Xs8j2018uU,fbPkOYLVPtPgIt0MxizjfFJov3JbHyAi,10,9,4,0,3,0,4,0,20,2.857142857142857,1,0.0,4,4,0,3,5,0,0,4,0,11,9,1
5117,77307,ovvuiEhj0QBv4xi11GVjXr8JhlCgaPmd,fbPkOYLVPtPgIt0MxizjfFJov3JbHyAi,1,0,0,0,0,0,1,0,1,0.14285714285714285,1,0.0,0,0,0,0,0,0,0,1,0,0,1,1
5118,77859,FbNQPrTC7bI79XxVFKHE9WIoUItnOpDj,SpATywNh6bZuzm8s1ceuBUnMUAeoAHHw,12,20,5,0,3,0,6,0,34,4.857142857142857,1,0.0,0,5,0,3,20,0,0,6,0,8,26,1
5119,77863,YV0OYizek02yKJ88HEeJHkNjkL20XUDk,SpATywNh6bZuzm8s1ceuBUnMUAeoAHHw,6,17,3,9,0,0,0,0,29,4.142857142857143,2,0.0,13,3,8,0,4,0,1,0,0,24,5,0
5120,77865,mqEWhrPz1lKF0rYKRYPaEdxo5F8aEixX,bWdj2GDclj5ofokWjzoa5jAwMkxCykd6,7,7,0,0,0,4,5,0,16,2.2857142857142856,1,0.0,0,0,0,0,7,4,0,5,0,0,16,0
5121,77895,ywdL3xkp7d2PSjbvnflAvIe7Wp6Q4SRe,bWdj2GDclj5ofokWjzoa5jAwMkxCykd6,19,27,4,46,4,0,10,0,91,13.0,2,0.0,9,4,43,4,18,0,3,10,0,60,31,0
5122,77928,VMdzrbYtGV36FN9W1AkdzkH4XbMSVyDM,5X6FeZozNMgE2VRi3MJYjkkFK8SETtu2,27,46,8,76,12,0,3,0,145,20.714285714285715,3,0.0,33,8,67,12,13,0,9,3,0,120,25,1
5123,77993,c8WJAdYLV71mOx4ZXSglpCNd0dBUR3Om,A3fsA9Zfv1X2fVEQhTw51lKENdNrEqT3,66,37,18,150,11,0,12,0,228,32.57142857142857,6,0.0,3,18,150,11,34,0,0,12,0,182,46,0
5124,78000,fFuKiCeoQQwOgD8VAud2ta198Mbq05KK,bWdj2GDclj5ofokWjzoa5jAwMkxCykd6,5,6,4,2,0,0,2,0,14,2.0,2,0.0,0,4,1,0,6,0,1,2,0,5,9,0
5125,78101,ew5XZC7WSosl0QdXH45kYD3syMSGbOj6,SpATywNh6bZuzm8s1ceuBUnMUAeoAHHw,13,12,7,0,5,0,2,0,26,3.7142857142857144,1,0.0,0,7,0,5,12,0,0,2,0,12,14,1
5126,78152,SozAkRr5kfRi3urQaoczmRXQoW70onBa,RXDvfPUBYFlVdlueBFbLW0mhhAyGEqpt,5,3,1,0,1,0,2,0,7,1.0,1,0.0,0,1,0,1,3,0,0,2,0,2,5,1
5127,78203,xzcwIWfHC78uxpQVEgBvu57PAv3HxSB6,5X6FeZozNMgE2VRi3MJYjkkFK8SETtu2,1,0,0,0,0,0,1,0,1,0.14285714285714285,1,0.0,0,0,0,0,0,0,0,1,0,0,1,1
5128,78207,KxuHPQOdlWxQw9hyxXdRrGHh12yzsPD2,SpATywNh6bZuzm8s1ceuBUnMUAeoAHHw,11,29,0,7,0,0,5,0,41,5.857142857142857,3,0.0,0,0,6,0,29,0,1,5,0,6,35,0
5129,78210,KioHEjkZcVkBeglI1qAOjEpPNoTwM8Q3,5X6FeZozNMgE2VRi3MJYjkkFK8SETtu2,8,14,7,0,3,0,7,0,31,4.428571428571429,1,0.0,0,7,0,3,14,0,0,7,0,10,21,1
5130,78272,wnNKMl9xF7Ymo4g0NZCDRhkVYih1owQr,SpATywNh6bZuzm8s1ceuBUnMUAeoAHHw,17,39,20,21,7,0,2,0,89,12.714285714285714,2,0.0,16,20,18,7,23,0,3,2,0,61,28,1
5131,78273,XE05vZThEHf17O6FM08AySNf2qZFgNWa,SpATywNh6bZuzm8s1ceuBUnMUAeoAHHw,24,19,16,2,11,0,2,0,50,7.142857142857143,1,0.0,1,16,2,11,18,0,0,2,0,30,20,0
5132,78425,z0WA70zlCYNC0D6ukf1TU1erCNwbETr4,SpATywNh6bZuzm8s1ceuBUnMUAeoAHHw,6,3,0,0,0,0,3,0,6,0.8571428571428571,1,0.0,0,0,0,0,3,0,0,3,0,0,6,0
5133,78450,FKaIUzhQjfUDPqxWuQzJXyqHP4qLLgRX,SpATywNh6bZuzm8s1ceuBUnMUAeoAHHw,17,29,1,13,1,6,5,0,55,7.857142857142857,1,0.0,14,1,10,1,15,6,3,5,0,26,29,0
5134,78556,cWykzNKAq5sFQBA059QN4Jx74YGPkfwB,A3fsA9Zfv1X2fVEQhTw51lKENdNrEqT3,3,0,0,0,0,0,9,0,9,1.2857142857142858,1,0.0,0,0,0,0,0,0,0,9,0,0,9,1
5135,78609,kC4wYWc6Emavjmr6JKn4tLm7xkcMHafd,5X6FeZozNMgE2VRi3MJYjkkFK8SETtu2,20,25,10,34,7,0,2,0,78,11.142857142857142,1,0.0,14,10,28,7,11,0,6,2,0,59,19,1
5136,78826,Aig8ARodMBd76Kc3mmaMuAMQomuOW0FH,5X6FeZozNMgE2VRi3MJYjkkFK8SETtu2,4,3,1,0,0,0,2,0,6,0.8571428571428571,1,0.0,0,1,0,0,3,0,0,2,0,1,5,1
5137,78834,Ffohn9JNnGJQD2IavzMTS00ubnVtcb2T,bWdj2GDclj5ofokWjzoa5jAwMkxCykd6,24,18,10,57,3,0,6,0,94,13.428571428571429,3,0.0,2,10,51,3,16,0,6,6,0,66,28,0
5138,78881,toLFcom7KFecBZf6qB124Knuopx8NQmy,SpATywNh6bZuzm8s1ceuBUnMUAeoAHHw,44,67,49,37,22,2,6,0,183,26.142857142857142,2,0.0,14,49,34,22,53,2,3,6,0,119,64,0
5139,78897,E96VmAw6m1AOHRckdqiq2ASKbnHBlpAb,A3fsA9Zfv1X2fVEQhTw51lKENdNrEqT3,3,2,1,0,0,0,1,0,4,0.5714285714285714,1,0.0,0,1,0,0,2,0,0,1,0,1,3,0
5140,78908,tWF4e4DlILxn4rwporSArA8ZE58OsZbt,5X6FeZozNMgE2VRi3MJYjkkFK8SETtu2,5,2,1,0,1,0,2,0,6,0.8571428571428571,1,0.0,0,1,0,1,2,0,0,2,0,2,4,1
5141,78926,E96VmAw6m1AOHRckdqiq2ASKbnHBlpAb,5X6FeZozNMgE2VRi3MJYjkkFK8SETtu2,4,4,2,0,0,0,5,0,11,1.5714285714285714,3,0.0,0,2,0,0,4,0,0,5,0,2,9,1
5142,78972,ef55znmweQJrijlI0fO1Ekc271nZnV0m,SpATywNh6bZuzm8s1ceuBUnMUAeoAHHw,17,30,16,7,3,13,11,0,80,11.428571428571429,3,0.0,7,16,7,3,23,13,0,11,0,33,47,0
5143,78977,w1o1S1rsKOagmFCmrSXvpPsO3fHW3lAq,5X6FeZozNMgE2VRi3MJYjkkFK8SETtu2,6,5,3,0,1,0,2,0,11,1.5714285714285714,2,0.0,0,3,0,1,5,0,0,2,0,4,7,1
5144,78990,bYjPoNbc5ILh7K7s9YR8HLOMNJGN6Ums,bWdj2GDclj5ofokWjzoa5jAwMkxCykd6,6,4,2,0,1,0,1,0,8,1.1428571428571428,1,0.0,0,2,0,1,4,0,0,1,0,3,5,1
5145,79018,Goj0c3E01QAOXfaddEPmncKJ5Y6bAC2m,5X6FeZozNMgE2VRi3MJYjkkFK8SETtu2,1,0,0,0,0,0,1,0,1,0.14285714285714285,1,0.0,0,0,0,0,0,0,0,1,0,0,1,1
5146,79022,twCpzhGO216Hze2mrl4NXCjfHuwTo4Bh,SpATywNh6bZuzm8s1ceuBUnMUAeoAHHw,15,9,6,7,4,0,1,0,27,3.857142857142857,1,0.0,2,6,7,4,7,0,0,1,0,19,8,0
5147,79040,iLTS4ygaMtSYfXaaMTXBF8rpkzMAdIeB,5X6FeZozNMgE2VRi3MJYjkkFK8SETtu2,8,4,1,2,2,2,4,1,16,2.2857142857142856,1,0.0,2,1,2,2,2,2,0,4,1,7,9,1
5148,79061,MoBz0U3Ui9CRWte6snkIzBaarIFflstn,SpATywNh6bZuzm8s1ceuBUnMUAeoAHHw,19,19,9,18,5,0,3,0,54,7.714285714285714,1,0.0,4,9,15,5,15,0,3,3,0,33,21,1
5149,79076,0eMlSFoZScU7zUCIgAM0BWfQh50FQz3i,5X6FeZozNMgE2VRi3MJYjkkFK8SETtu2,29,19,5,58,5,0,1,0,88,12.571428571428571,1,0.0,13,5,53,5,6,0,5,1,0,76,12,1
5150,79169,LwwIfMdYfjJJxHB8Z4Fggv4xXuygh6dE,bWdj2GDclj5ofokWjzoa5jAwMkxCykd6,4,3,0,0,0,0,1,0,4,0.5714285714285714,1,0.0,0,0,0,0,3,0,0,1,0,0,4,0
5151,79170,h774wdF6vIIcl50Js74gckwUtlv9SBGH,SpATywNh6bZuzm8s1ceuBUnMUAeoAHHw,43,63,36,13,11,0,9,1,133,19.0,3,0.0,18,36,13,11,45,0,0,9,1,78,55,0
5152,79172,layckrYedWZgFw7etRwkXZmJxZfLSCWL,RXDvfPUBYFlVdlueBFbLW0mhhAyGEqpt,5,2,1,0,0,0,4,0,7,1.0,1,0.0,0,1,0,0,2,0,0,4,0,1,6,1
5153,79194,0bPKxjIIw0GaiIYeAS2yIr8ZqMELBNL4,5X6FeZozNMgE2VRi3MJYjkkFK8SETtu2,3,2,0,0,0,0,1,0,3,0.42857142857142855,1,0.0,0,0,0,0,2,0,0,1,0,0,3,0
5154,79286,aGY42WVQQtCQKQRks3knIxGWrLxCy60h,5X6FeZozNMgE2VRi3MJYjkkFK8SETtu2,3,2,0,0,0,0,1,0,3,0.42857142857142855,1,0.0,0,0,0,0,2,0,0,1,0,0,3,1
5155,79290,vtrHNbtnxRGyZem1sSOdKIp109fZtSKY,SpATywNh6bZuzm8s1ceuBUnMUAeoAHHw,20,24,12,28,5,0,1,0,70,10.0,1,0.0,10,12,25,5,14,0,3,1,0,52,18,0
5156,79307,3MN9gqffGxZJqVwbda6Nr5mGlWwnaW7z,G8EPVSXsOYB5YQWZGiz1aVq5Pgr2GrQu,7,7,4,0,1,0,2,0,14,2.0,2,0.0,0,4,0,1,7,0,0,2,0,5,9,0
5157,79326,GzwlErGyP5vVrMuPju1CoSG91uAwN5Ll,5X6FeZozNMgE2VRi3MJYjkkFK8SETtu2,21,40,14,22,16,16,15,1,124,17.714285714285715,2,0.0,18,14,17,16,22,16,5,15,1,65,59,1
5158,79332,WQI2O3Oijx2QlB8hE2TltFPDzjM5E22B,5X6FeZozNMgE2VRi3MJYjkkFK8SETtu2,1,0,0,0,0,0,1,0,1,0.14285714285714285,1,0.0,0,0,0,0,0,0,0,1,0,0,1,1
5159,79368,1aQoKDna73jstuOrupWa9Kq8V3FdvbRU,5X6FeZozNMgE2VRi3MJYjkkFK8SETtu2,6,6,1,2,3,0,1,0,13,1.8571428571428572,1,0.0,3,1,2,3,3,0,0,1,0,9,4,1
5160,79378,LgPlpopSU02baX8XsEJO6rWixplusEKm,SpATywNh6bZuzm8s1ceuBUnMUAeoAHHw,15,10,7,10,3,0,1,0,31,4.428571428571429,1,0.0,2,7,10,3,8,0,0,1,0,22,9,0
5161,79392,yUyVc0xcETBdtpqOJUXovZ3QcO5gddPt,SpATywNh6bZuzm8s1ceuBUnMUAeoAHHw,1,0,1,0,0,0,0,0,1,0.14285714285714285,1,0.0,0,1,0,0,0,0,0,0,0,1,0,1
5162,79430,3MN9gqffGxZJqVwbda6Nr5mGlWwnaW7z,SpATywNh6bZuzm8s1ceuBUnMUAeoAHHw,27,50,24,37,7,0,7,0,125,17.857142857142858,2,0.0,14,24,34,7,36,0,3,7,0,79,46,0
5163,79489,qtWe93d8kqRlRaOEECSUVeX06aKzKrra,5X6FeZozNMgE2VRi3MJYjkkFK8SETtu2,7,4,1,0,1,1,4,1,12,1.7142857142857142,1,0.0,0,1,0,1,4,1,0,4,1,2,10,1
5164,79521,7bCBpTD7PhZ8lYzjppG3noO0NI4oSQjz,5X6FeZozNMgE2VRi3MJYjkkFK8SETtu2,5,3,1,0,1,0,2,0,7,1.0,1,0.0,0,1,0,1,3,0,0,2,0,2,5,1
5165,79540,68aPv7D3ZE4JVkIRm8IjOcsEwxcFlwFO,5X6FeZozNMgE2VRi3MJYjkkFK8SETtu2,2,0,0,0,0,0,2,0,2,0.2857142857142857,1,0.0,0,0,0,0,0,0,0,2,0,0,2,1
5166,79550,XfiCSk5eLAbq9rzQtnLkX2OQTd6M8xFG,5X6FeZozNMgE2VRi3MJYjkkFK8SETtu2,17,41,1,21,2,0,2,0,67,9.571428571428571,1,0.0,19,1,21,2,22,0,0,2,0,43,24,1
5167,79554,Ci40ficC1bpaw3mnSB9r8W1A64fHEKTq,5X6FeZozNMgE2VRi3MJYjkkFK8SETtu2,18,18,5,36,3,0,1,0,63,9.0,1,0.0,12,5,28,3,6,0,8,1,0,48,15,1
5168,79568,rZUdPpi92l1qQIS8kuhajEO9kujkZRBg,SpATywNh6bZuzm8s1ceuBUnMUAeoAHHw,20,22,9,23,3,0,3,0,60,8.571428571428571,2,0.0,12,9,21,3,10,0,2,3,0,45,15,1
5169,79582,yMKOk0dVftHnVR1CEiO9scq4ARXi4xK4,A3fsA9Zfv1X2fVEQhTw51lKENdNrEqT3,3,1,1,0,1,0,0,0,3,0.42857142857142855,1,0.0,0,1,0,1,1,0,0,0,0,2,1,0
5170,79586,moK1GdnqoYxhSRCf5a95lgXdVNdzYrjs,5X6FeZozNMgE2VRi3MJYjkkFK8SETtu2,5,5,3,0,1,0,5,0,14,2.0,2,0.0,0,3,0,1,5,0,0,5,0,4,10,1
5171,79606,ZOTpNZ0MPCzhXQVB7FrlPGVckR2bh01V,SpATywNh6bZuzm8s1ceuBUnMUAeoAHHw,24,60,1,36,0,1,9,0,107,15.285714285714286,4,0.0,20,1,33,0,40,1,3,9,0,54,53,0
5172,79651,vQxwNbtZgUat9SDZRmE7MEKdvAizpBwk,5X6FeZozNMgE2VRi3MJYjkkFK8SETtu2,4,3,0,0,0,0,1,0,4,0.5714285714285714,1,0.0,0,0,0,0,3,0,0,1,0,0,4,1
5173,79664,Z8r3kWGF2ZuWSy5TZGg00SEG4qfRh2Ag,5X6FeZozNMgE2VRi3MJYjkkFK8SETtu2,1,0,0,0,0,0,1,0,1,0.14285714285714285,1,0.0,0,0,0,0,0,0,0,1,0,0,1,0
5174,79689,yMKOk0dVftHnVR1CEiO9scq4ARXi4xK4,RXDvfPUBYFlVdlueBFbLW0mhhAyGEqpt,2,0,0,0,0,0,2,0,2,0.2857142857142857,1,0.0,0,0,0,0,0,0,0,2,0,0,2,1
5175,79783,MMo67tZd2HnjPcYw7tUwheGT7fqD2cqI,SpATywNh6bZuzm8s1ceuBUnMUAeoAHHw,20,29,15,14,7,0,3,0,68,9.714285714285714,2,0.0,11,15,13,7,18,0,1,3,0,46,22,0
5176,79797,ziI4sKMlAzhuWPMy9t2U96G01O68Dxyj,A3fsA9Zfv1X2fVEQhTw51lKENdNrEqT3,5,3,1,0,1,0,1,0,6,0.8571428571428571,1,0.0,0,1,0,1,3,0,0,1,0,2,4,0
5177,79813,qMFAmPw34z5IViYTtA1Kkpcn2uEg1WBM,RXDvfPUBYFlVdlueBFbLW0mhhAyGEqpt,8,6,4,0,2,0,1,0,13,1.8571428571428572,1,0.0,0,4,0,2,6,0,0,1,0,6,7,1
5178,79849,g8GfWRB0OxvXROL4NPNW5ZSi8XCvG0Vj,5X6FeZozNMgE2VRi3MJYjkkFK8SETtu2,1,0,0,0,0,0,1,0,1,0.14285714285714285,1,0.0,0,0,0,0,0,0,0,1,0,0,1,1
5179,79887,yonwfYKGqRaxFqA59D8fadwOwcb5hmqL,SpATywNh6bZuzm8s1ceuBUnMUAeoAHHw,17,13,8,11,5,0,1,0,38,5.428571428571429,1,0.0,4,8,10,5,9,0,1,1,0,27,11,1
5180,79947,mvNsYHmLGVvx6RdgKEq4DO6WGtgd6ICk,5X6FeZozNMgE2VRi3MJYjkkFK8SETtu2,2,0,0,0,0,0,2,0,2,0.2857142857142857,1,0.0,0,0,0,0,0,0,0,2,0,0,2,1
5181,79954,U0h9ZcOzwmSa5zXabz3gRq51gj9CVPUf,SpATywNh6bZuzm8s1ceuBUnMUAeoAHHw,21,42,23,12,8,2,17,0,104,14.857142857142858,5,0.0,8,23,11,8,34,2,1,17,0,50,54,0
5182,79973,lxjW2IwfKKnK2DrRSZaIR9GsDl9lxdt8,A3fsA9Zfv1X2fVEQhTw51lKENdNrEqT3,3,2,0,0,0,0,1,0,3,0.42857142857142855,1,0.0,0,0,0,0,2,0,0,1,0,0,3,0
5183,79987,N3hAbbmjAcgnrOfHxCtYgYIWhCN4yU2c,SpATywNh6bZuzm8s1ceuBUnMUAeoAHHw,7,9,4,0,2,0,1,0,16,2.2857142857142856,1,0.0,0,4,0,2,9,0,0,1,0,6,10,1
5184,80003,8MTzNIeHZxoPzUB3QuA9UPwzkLipeLI2,SpATywNh6bZuzm8s1ceuBUnMUAeoAHHw,19,17,13,9,9,0,1,0,49,7.0,1,0.0,3,13,8,9,14,0,1,1,0,33,16,0
5185,80047,QjwQzuiA6TAJjCb0ag4sYfZRjiTOPACp,SpATywNh6bZuzm8s1ceuBUnMUAeoAHHw,12,9,6,0,5,0,1,0,21,3.0,2,0.0,0,6,0,5,9,0,0,1,0,11,10,0
5186,80136,XQFWhrsULMJrGiXoFieAPwx4Rm1ETQ8D,SpATywNh6bZuzm8s1ceuBUnMUAeoAHHw,34,33,19,30,10,0,6,0,98,14.0,4,0.0,10,19,29,10,23,0,1,6,0,68,30,0
5187,80203,TcTuC5hiyHRmVc5qZWpzVJY3ugVLXB30,5X6FeZozNMgE2VRi3MJYjkkFK8SETtu2,2,0,0,0,0,0,3,0,3,0.42857142857142855,1,0.0,0,0,0,0,0,0,0,3,0,0,3,1
5188,80208,A6qBZik0VBfWjUh1l97ldNrUQvZV7VDA,bWdj2GDclj5ofokWjzoa5jAwMkxCykd6,2,0,0,0,0,0,2,0,2,0.2857142857142857,1,0.0,0,0,0,0,0,0,0,2,0,0,2,1
5189,80256,qbxr7nsJKbupU2nnOZ4AXSvMY5DklIDV,SpATywNh6bZuzm8s1ceuBUnMUAeoAHHw,10,10,7,0,4,0,3,0,24,3.4285714285714284,2,0.0,0,7,0,4,10,0,0,3,0,11,13,0
5190,80258,AlLFcyRB5UwpN8dJK67Vqu0OFPpIDrGm,A3fsA9Zfv1X2fVEQhTw51lKENdNrEqT3,13,16,11,0,4,0,5,0,36,5.142857142857143,3,0.0,0,11,0,4,16,0,0,5,0,15,21,0
5191,80323,I90xPqkS9HpEgNxHw8dM4fDCcTPeHknd,5X6FeZozNMgE2VRi3MJYjkkFK8SETtu2,1,0,0,0,0,0,1,0,1,0.14285714285714285,1,0.0,0,0,0,0,0,0,0,1,0,0,1,1
5192,80396,3B3YADugrZ4bBgjxxClgqtVXSh5LmkAW,SpATywNh6bZuzm8s1ceuBUnMUAeoAHHw,8,5,4,0,4,0,1,0,14,2.0,1,0.0,0,4,0,4,5,0,0,1,0,8,6,1
5193,80406,9d6HoNqzGbbCd66bGVck7uPSgkXTez3M,G8EPVSXsOYB5YQWZGiz1aVq5Pgr2GrQu,1,0,0,0,0,0,1,0,1,0.14285714285714285,1,0.0,0,0,0,0,0,0,0,1,0,0,1,1
5194,80437,ef12hM7jr4TcIrwraImsdOigb7ZzGQBR,SpATywNh6bZuzm8s1ceuBUnMUAeoAHHw,4,3,0,0,0,0,1,0,4,0.5714285714285714,1,0.0,0,0,0,0,3,0,0,1,0,0,4,1
5195,80438,Ne25k1DU4nK81LWo7930HvBFWlFV2ZKt,5X6FeZozNMgE2VRi3MJYjkkFK8SETtu2,7,4,2,0,1,0,4,0,11,1.5714285714285714,1,0.0,0,2,0,1,4,0,0,4,0,3,8,1
5196,80512,Of5W8KonUNuLgzthIAJI1wlPDbxM4WvO,5X6FeZozNMgE2VRi3MJYjkkFK8SETtu2,1,0,0,0,0,0,1,0,1,0.14285714285714285,1,0.0,0,0,0,0,0,0,0,1,0,0,1,1
5197,80561,0TYsGSagjtpdvts8BjnEYwbdzO0Cq9cu,bWdj2GDclj5ofokWjzoa5jAwMkxCykd6,8,8,5,0,0,2,11,1,27,3.857142857142857,1,0.0,0,5,0,0,8,2,0,11,1,5,22,1
5198,80567,RDBly29xbybxfRPXjsOP81xd2Sgww6yI,5X6FeZozNMgE2VRi3MJYjkkFK8SETtu2,19,20,9,16,6,0,3,0,54,7.714285714285714,1,0.0,9,9,14,6,11,0,2,3,0,38,16,1
5199,80632,4CBJi9FPwBtDwABbM6tdSqW9vKh1q7Z5,SpATywNh6bZuzm8s1ceuBUnMUAeoAHHw,14,9,7,0,5,0,1,0,22,3.142857142857143,1,0.0,0,7,0,5,9,0,0,1,0,12,10,1
5200,80652,iUoRbwUg4gdzLJukOCZgCgZYdA1FqiAT,5X6FeZozNMgE2VRi3MJYjkkFK8SETtu2,4,0,0,0,0,2,3,3,8,1.1428571428571428,1,0.0,0,0,0,0,0,2,0,3,3,0,8,1
5201,80733,WsI66cX2IVbmlTGQ0zbjJBYm3CRzD6S5,5X6FeZozNMgE2VRi3MJYjkkFK8SETtu2,6,26,1,0,9,0,2,0,38,5.428571428571429,1,0.0,21,1,0,9,5,0,0,2,0,31,7,1
5202,80779,6qgQAmX6y5wh5nEPRINOiKrZNoTl5yfT,bWdj2GDclj5ofokWjzoa5jAwMkxCykd6,20,10,7,18,5,0,4,0,44,6.285714285714286,1,0.0,0,7,9,5,10,0,9,4,0,21,23,1
5203,80799,cJ9a9VybEQZXRFqEMI78WQ8ukmEaaVlE,SpATywNh6bZuzm8s1ceuBUnMUAeoAHHw,5,3,2,0,1,0,1,0,7,1.0,1,0.0,0,2,0,1,3,0,0,1,0,3,4,0
5204,80815,Kv9yM6Ye606xOusGmqGDWX6SW9fdHP2Q,5X6FeZozNMgE2VRi3MJYjkkFK8SETtu2,1,0,0,0,0,0,1,0,1,0.14285714285714285,1,0.0,0,0,0,0,0,0,0,1,0,0,1,1
5205,80834,GMSc5TEkkpgIO0gc1xREEszljcEWZiiA,5X6FeZozNMgE2VRi3MJYjkkFK8SETtu2,1,0,0,0,0,0,1,0,1,0.14285714285714285,1,0.0,0,0,0,0,0,0,0,1,0,0,1,1
5206,80849,2mD1u3b1vLrSJM0DZTrsvLcZVBVwwd27,A3fsA9Zfv1X2fVEQhTw51lKENdNrEqT3,2,0,0,0,0,0,2,0,2,0.2857142857142857,1,0.0,0,0,0,0,0,0,0,2,0,0,2,1
5207,80905,80glaVvHvBUy48oZdvFjTEnT1I1ayEGd,5Gyp41oLVo7Gg7vF4vpmggWP5MU70QO6,11,15,7,0,3,0,7,0,32,4.571428571428571,4,0.0,0,7,0,3,15,0,0,7,0,10,22,0
5208,80907,yGiLrjdZupRhdvMdLZVVcCQ82dMfdHjX,5Gyp41oLVo7Gg7vF4vpmggWP5MU70QO6,9,6,2,2,1,1,4,1,17,2.4285714285714284,1,0.0,3,2,1,1,3,1,1,4,1,7,10,1
5209,80915,5JBXs7Eegffbn9K1DzV3WApq68Z50pHH,5Gyp41oLVo7Gg7vF4vpmggWP5MU70QO6,1,0,0,0,0,0,2,0,2,0.2857142857142857,1,0.0,0,0,0,0,0,0,0,2,0,0,2,1
5210,80918,1siC9HdVMAi0tBMmzySCSyCC7x6QknkV,5Gyp41oLVo7Gg7vF4vpmggWP5MU70QO6,8,5,0,0,0,0,4,0,9,1.2857142857142858,1,0.0,0,0,0,0,5,0,0,4,0,0,9,1
5211,80941,8vEwP3HCYC0jRoIm7rp8JIAcGEcRo4Cr,5Gyp41oLVo7Gg7vF4vpmggWP5MU70QO6,1,0,0,0,0,0,1,0,1,0.14285714285714285,1,0.0,0,0,0,0,0,0,0,1,0,0,1,1
5212,80972,Dz2soaBWrFp2eghae8JCBpfQPKY7BOHW,5Gyp41oLVo7Gg7vF4vpmggWP5MU70QO6,12,15,7,2,1,0,7,1,33,4.714285714285714,2,0.0,0,7,1,1,15,0,1,7,1,9,24,0
5213,80986,6M91U4Jjh1zXyEtnnWfZC11jlFbX18Gl,5Gyp41oLVo7Gg7vF4vpmggWP5MU70QO6,9,5,4,0,1,0,4,0,14,2.0,1,0.0,1,4,0,1,4,0,0,4,0,6,8,1
5214,81008,WuewKMj9rDXfi3Ee2xNKJ0LUPR3KMMWb,5Gyp41oLVo7Gg7vF4vpmggWP5MU70QO6,5,3,2,0,0,0,2,0,7,1.0,1,0.0,0,2,0,0,3,0,0,2,0,2,5,1
5215,81009,UE4ObE6MNUtq2YZs04l4Qpq0RNxbuB1R,5Gyp41oLVo7Gg7vF4vpmggWP5MU70QO6,7,2,1,0,1,0,4,0,8,1.1428571428571428,1,0.0,0,1,0,1,2,0,0,4,0,2,6,1
5216,81015,xYWmnmUWp3IWOaF5fh4qA4e7AK8hEElb,5Gyp41oLVo7Gg7vF4vpmggWP5MU70QO6,9,12,1,0,2,0,4,0,19,2.7142857142857144,3,0.0,1,1,0,2,11,0,0,4,0,4,15,1
5217,81026,FODQFrCQnkGgP5FEgm7xRdwveNuzsX04,5Gyp41oLVo7Gg7vF4vpmggWP5MU70QO6,24,31,13,11,8,0,13,2,78,11.142857142857142,2,0.0,11,13,6,8,20,0,5,13,2,38,40,1
5218,81064,mfwDBD5dIZoX7jNUjK1pdlNpAz8Zfo2D,5Gyp41oLVo7Gg7vF4vpmggWP5MU70QO6,1,0,0,0,0,0,1,0,1,0.14285714285714285,1,0.0,0,0,0,0,0,0,0,1,0,0,1,1
5219,81067,UPL9Lvx89H3gz94r9i5tl5V9zo6NsMCc,5Gyp41oLVo7Gg7vF4vpmggWP5MU70QO6,4,2,1,0,0,0,2,0,5,0.7142857142857143,1,0.0,0,1,0,0,2,0,0,2,0,1,4,1
5220,81070,xa2Rc3QWrEY8yDRVKZtfHO6VJQtIYqqg,5Gyp41oLVo7Gg7vF4vpmggWP5MU70QO6,10,3,2,0,2,0,6,1,14,2.0,1,0.0,0,2,0,2,3,0,0,6,1,4,10,1
5221,81138,Lb7smBlNGKGreCBWna2HqUxFEZPNlPcQ,5Gyp41oLVo7Gg7vF4vpmggWP5MU70QO6,7,5,2,0,2,2,5,1,17,2.4285714285714284,1,0.0,0,2,0,2,5,2,0,5,1,4,13,1
5222,81146,yvUBDN0FiDtWpDpYWBs2NOZYrZvcxRLe,5Gyp41oLVo7Gg7vF4vpmggWP5MU70QO6,1,0,0,0,0,0,1,0,1,0.14285714285714285,1,0.0,0,0,0,0,0,0,0,1,0,0,1,1
5223,81154,1bKMONcV6Mq58szdlIajPdFyqaw4BvrA,5Gyp41oLVo7Gg7vF4vpmggWP5MU70QO6,6,2,1,0,1,0,4,1,9,1.2857142857142858,1,0.0,0,1,0,1,2,0,0,4,1,2,7,0
5224,81192,ECCMGZYVv2K5DCWTqOR5m6ar5eGtvymw,5Gyp41oLVo7Gg7vF4vpmggWP5MU70QO6,7,3,2,0,2,0,4,0,11,1.5714285714285714,1,0.0,0,2,0,2,3,0,0,4,0,4,7,1
5225,81194,xiDptcso6FkIZ5YV6Fs9S7SMsBZpHpkg,5Gyp41oLVo7Gg7vF4vpmggWP5MU70QO6,1,0,0,0,0,0,1,0,1,0.14285714285714285,1,0.0,0,0,0,0,0,0,0,1,0,0,1,1
5226,81198,k1jxHgY5rOXbaWEGpQGKEP3yWvLIIm1P,5Gyp41oLVo7Gg7vF4vpmggWP5MU70QO6,1,0,0,0,0,0,1,0,1,0.14285714285714285,1,0.0,0,0,0,0,0,0,0,1,0,0,1,1
5227,81217,8cMfXpJwi6t06um2KrGHukgzI2aYELtv,5Gyp41oLVo7Gg7vF4vpmggWP5MU70QO6,1,0,0,0,0,0,1,0,1,0.14285714285714285,1,0.0,0,0,0,0,0,0,0,1,0,0,1,1
5228,81237,Rdvgrardg53H2oeCgmOt8vFxIUu5nogb,5Gyp41oLVo7Gg7vF4vpmggWP5MU70QO6,25,51,28,18,11,29,11,0,148,21.142857142857142,5,0.0,13,28,11,11,38,29,7,11,0,63,85,1
5229,81254,MwwlSUI8F4oDpi9LVs3eg06n3iwy8YvF,5Gyp41oLVo7Gg7vF4vpmggWP5MU70QO6,1,0,0,0,0,0,1,0,1,0.14285714285714285,1,0.0,0,0,0,0,0,0,0,1,0,0,1,1
5230,81261,z79FxI6IxKXksSKIwsXSYM1kOlaP8f6r,5Gyp41oLVo7Gg7vF4vpmggWP5MU70QO6,12,22,0,10,0,6,5,1,44,6.285714285714286,1,0.0,7,0,5,0,15,6,5,5,1,12,32,0
5231,81293,IlLRiN73iGMsvGrUTmMGOzIMn2oK4dZp,5Gyp41oLVo7Gg7vF4vpmggWP5MU70QO6,1,0,0,0,0,0,1,0,1,0.14285714285714285,1,0.0,0,0,0,0,0,0,0,1,0,0,1,1
5232,81294,Wa7OAQyjELO0edwgO2a4gSm2jSZTemEI,5Gyp41oLVo7Gg7vF4vpmggWP5MU70QO6,5,0,0,0,0,8,4,0,12,1.7142857142857142,1,0.0,0,0,0,0,0,8,0,4,0,0,12,1
5233,81313,gEqIHfHmAAvBc0rLTB1C7tRehCWFJnIr,5Gyp41oLVo7Gg7vF4vpmggWP5MU70QO6,7,3,2,0,2,0,5,0,12,1.7142857142857142,1,0.0,0,2,0,2,3,0,0,5,0,4,8,1
5234,81328,OJ0LoXMYeoupgtCsqXPKoTXc19jkOfHU,5Gyp41oLVo7Gg7vF4vpmggWP5MU70QO6,11,7,4,0,2,1,5,0,19,2.7142857142857144,1,0.0,0,4,0,2,7,1,0,5,0,6,13,1
5235,81381,zoXigsWBjyJG6OSyWQP4Y5frh0Mc9ncS,5Gyp41oLVo7Gg7vF4vpmggWP5MU70QO6,1,0,0,0,0,0,1,0,1,0.14285714285714285,1,0.0,0,0,0,0,0,0,0,1,0,0,1,1
5236,81382,uAiXtjZln558M2i3rYEEm2XkgYlhSfMT,5Gyp41oLVo7Gg7vF4vpmggWP5MU70QO6,19,29,21,0,14,0,12,0,76,10.857142857142858,4,0.0,2,21,0,14,27,0,0,12,0,37,39,1
5237,81385,KtFm7BUlplqAQ0eEpxvwq82vxj2gfBmJ,5Gyp41oLVo7Gg7vF4vpmggWP5MU70QO6,1,0,0,0,0,0,1,0,1,0.14285714285714285,1,0.0,0,0,0,0,0,0,0,1,0,0,1,1
5238,81397,cT78xvKkV1UFGcRKty0V03Jr4RRPh50F,5Gyp41oLVo7Gg7vF4vpmggWP5MU70QO6,1,0,0,0,0,0,1,0,1,0.14285714285714285,1,0.0,0,0,0,0,0,0,0,1,0,0,1,1
5239,81401,X1KDcg6FJGcjALhOEz460JY2SzJ27Ewm,5Gyp41oLVo7Gg7vF4vpmggWP5MU70QO6,6,8,4,0,0,0,4,1,17,2.4285714285714284,1,0.0,0,4,0,0,8,0,0,4,1,4,13,1
5240,81407,okqN4nBVKRYYrkYonKicKGOmPqVGYjZh,5Gyp41oLVo7Gg7vF4vpmggWP5MU70QO6,43,247,108,69,31,3,52,1,511,73.0,12,0.0,39,108,62,31,208,3,7,52,1,240,271,0
5241,81421,jDvQIlE5Sz6V9SpiJ3fC38kGJJ76UIjp,5Gyp41oLVo7Gg7vF4vpmggWP5MU70QO6,5,2,1,0,1,0,2,0,6,0.8571428571428571,1,0.0,0,1,0,1,2,0,0,2,0,2,4,1
5242,81422,nWwV0iLe6YugeJuwswmouvW60daPn3qh,5Gyp41oLVo7Gg7vF4vpmggWP5MU70QO6,1,0,0,0,0,0,1,0,1,0.14285714285714285,1,0.0,0,0,0,0,0,0,0,1,0,0,1,1
5243,81424,Eb81LwG9GXAYL3HRXZ1DmiHY6DkHKHL1,5Gyp41oLVo7Gg7vF4vpmggWP5MU70QO6,1,0,0,0,0,0,1,0,1,0.14285714285714285,1,0.0,0,0,0,0,0,0,0,1,0,0,1,1
5244,81429,E3uSUPqhCM6qMf5A53Kr8C5Ks2Mqniz2,5Gyp41oLVo7Gg7vF4vpmggWP5MU70QO6,1,0,0,0,0,0,1,0,1,0.14285714285714285,1,0.0,0,0,0,0,0,0,0,1,0,0,1,1
5245,81432,EVcoLcSnWlfmvKyibRqo4bsnirupfeCB,5Gyp41oLVo7Gg7vF4vpmggWP5MU70QO6,10,6,4,0,2,0,3,0,15,2.142857142857143,1,0.0,0,4,0,2,6,0,0,3,0,6,9,1
5246,81437,2obImradCczKWNAiD5PB3T50fxdRnZcY,5Gyp41oLVo7Gg7vF4vpmggWP5MU70QO6,8,5,3,0,3,0,3,0,14,2.0,1,0.0,0,3,0,3,5,0,0,3,0,6,8,1
5247,81456,NpYBYyw1XJ9LuDixdnai46t6pNciyLYs,5Gyp41oLVo7Gg7vF4vpmggWP5MU70QO6,1,0,0,0,0,0,1,0,1,0.14285714285714285,1,0.0,0,0,0,0,0,0,0,1,0,0,1,1
5248,81463,vOgUJ4E49nmsRlQDaaH91xRCySNGI4WL,5Gyp41oLVo7Gg7vF4vpmggWP5MU70QO6,12,27,16,7,8,0,5,0,63,9.0,4,0.0,6,16,4,8,21,0,3,5,0,34,29,1
5249,81464,gTnArh0oPGEOmMh6hJyyS2iZFdCYgCEZ,5Gyp41oLVo7Gg7vF4vpmggWP5MU70QO6,13,16,9,7,5,0,3,0,40,5.714285714285714,4,0.0,4,9,5,5,12,0,2,3,0,23,17,1
5250,81490,awNiHcfaLmIgQygcxufPZke7YT91Tlmy,5Gyp41oLVo7Gg7vF4vpmggWP5MU70QO6,11,9,6,0,5,3,9,1,33,4.714285714285714,3,0.0,1,6,0,5,8,3,0,9,1,12,21,0
5251,81499,3y2XGrXV12phjHWJYa19FG6DINKDjdIB,5Gyp41oLVo7Gg7vF4vpmggWP5MU70QO6,8,5,4,0,2,0,1,0,12,1.7142857142857142,1,0.0,0,4,0,2,5,0,0,1,0,6,6,1
5252,81504,2tXywtJQD2C1dKRzRzUewvgORqwUmXtE,5Gyp41oLVo7Gg7vF4vpmggWP5MU70QO6,17,11,8,6,5,2,8,1,41,5.857142857142857,1,0.0,1,8,3,5,10,2,3,8,1,17,24,1
5253,81505,fZtl6CLGkXt3aozJmivTDUyscSsi3JCf,5Gyp41oLVo7Gg7vF4vpmggWP5MU70QO6,8,5,2,6,1,0,2,0,16,2.2857142857142856,1,0.0,2,2,3,1,3,0,3,2,0,8,8,1
5254,81517,eIz1QdRrhcYteukRLgOlTi2GZdnEpdtj,5Gyp41oLVo7Gg7vF4vpmggWP5MU70QO6,1,0,0,0,0,0,1,0,1,0.14285714285714285,1,0.0,0,0,0,0,0,0,0,1,0,0,1,1
5255,81526,RUhbDEGzuGiozW42x5lFaNzzdgUAuP4z,5Gyp41oLVo7Gg7vF4vpmggWP5MU70QO6,1,0,0,0,0,0,1,0,1,0.14285714285714285,1,0.0,0,0,0,0,0,0,0,1,0,0,1,1
5256,81530,kFJUPP4PT5hRWkkzRpfMGB8B8BwQArn7,5Gyp41oLVo7Gg7vF4vpmggWP5MU70QO6,29,57,31,22,13,89,15,2,229,32.714285714285715,6,0.0,12,31,15,13,45,89,7,15,2,71,158,0
5257,81543,fgaDXA4j6cHk0FnifTSdjVGPTjk5iRju,5Gyp41oLVo7Gg7vF4vpmggWP5MU70QO6,1,0,0,0,0,0,1,0,1,0.14285714285714285,1,0.0,0,0,0,0,0,0,0,1,0,0,1,1
5258,81544,cgBusYXiNBsyile8fKg57RdfoNSHxREd,5Gyp41oLVo7Gg7vF4vpmggWP5MU70QO6,1,0,0,0,0,0,1,0,1,0.14285714285714285,1,0.0,0,0,0,0,0,0,0,1,0,0,1,1
5259,81545,DK0C2OoM9pED5J54cuVFRs3cJYbvw6n8,5Gyp41oLVo7Gg7vF4vpmggWP5MU70QO6,1,0,0,0,0,0,1,0,1,0.14285714285714285,1,0.0,0,0,0,0,0,0,0,1,0,0,1,1
5260,81563,ynpQJ1KNFlwGGjbvB4jjK45fmhFIwSzj,5Gyp41oLVo7Gg7vF4vpmggWP5MU70QO6,7,4,4,0,3,0,6,0,17,2.4285714285714284,2,0.0,0,4,0,3,4,0,0,6,0,7,10,1
5261,81564,wJC86gc3viBGM4vTuYg8647vhYAtlLLc,5Gyp41oLVo7Gg7vF4vpmggWP5MU70QO6,4,2,0,0,0,0,2,0,4,0.5714285714285714,1,0.0,0,0,0,0,2,0,0,2,0,0,4,1
5262,81571,DUVNCAOW5Uq3WAymMRBzIy6a7NnFfgK9,5Gyp41oLVo7Gg7vF4vpmggWP5MU70QO6,1,0,0,0,0,0,1,0,1,0.14285714285714285,1,0.0,0,0,0,0,0,0,0,1,0,0,1,1
5263,81576,Fkf58lC4LlkBK9l03hDS8g86sf3RUqj8,5Gyp41oLVo7Gg7vF4vpmggWP5MU70QO6,8,6,1,4,1,0,4,0,16,2.2857142857142856,1,0.0,2,1,2,1,4,0,2,4,0,6,10,1
5264,81598,Pj9kGggxpq0sMYjSFqPNkAQrvOEBLtbk,5Gyp41oLVo7Gg7vF4vpmggWP5MU70QO6,5,2,1,0,1,0,2,0,6,0.8571428571428571,1,0.0,0,1,0,1,2,0,0,2,0,2,4,1
5265,81617,4NwdwhTCkAbuPHoDkJ6AWQ1Dq7CWTOcu,5Gyp41oLVo7Gg7vF4vpmggWP5MU70QO6,2,0,0,0,0,0,2,0,2,0.2857142857142857,1,0.0,0,0,0,0,0,0,0,2,0,0,2,1
5266,81620,mUWsqZFWrB15z8pLpQnajB2yNWrSRPl9,5Gyp41oLVo7Gg7vF4vpmggWP5MU70QO6,21,13,9,8,6,0,2,0,38,5.428571428571429,1,0.0,3,9,4,6,10,0,4,2,0,22,16,1
5267,81622,hpBcUixqIYN9QJG8vvXqJZQPLWPUvpPA,5Gyp41oLVo7Gg7vF4vpmggWP5MU70QO6,11,15,7,18,2,0,3,0,45,6.428571428571429,2,0.0,6,7,9,2,9,0,9,3,0,24,21,1
5268,81630,Ji6hwggIttTjOJLJJ2Fyx2zSqY8obZY5,5Gyp41oLVo7Gg7vF4vpmggWP5MU70QO6,8,8,1,8,0,0,2,0,19,2.7142857142857144,1,0.0,4,1,4,0,4,0,4,2,0,9,10,1
5269,81637,3SBPXGcoEiRb4Rr22FrPQJdZoEpkDJr2,5Gyp41oLVo7Gg7vF4vpmggWP5MU70QO6,1,0,0,0,0,0,1,0,1,0.14285714285714285,1,0.0,0,0,0,0,0,0,0,1,0,0,1,1
5270,81640,XeXLRKhL1tlAXxElqSJMNggZeP11626N,5Gyp41oLVo7Gg7vF4vpmggWP5MU70QO6,14,24,11,6,4,6,16,2,69,9.857142857142858,1,0.0,5,11,3,4,19,6,3,16,2,23,46,1
5271,81673,FcPFK6OTsUF1j3uNGabdzGTvbY8kcO3D,5Gyp41oLVo7Gg7vF4vpmggWP5MU70QO6,10,10,0,0,0,0,4,1,15,2.142857142857143,1,0.0,1,0,0,0,9,0,0,4,1,1,14,1
5272,81697,JYeCYbK21kYELQ56DJ4mCCCl3DrmUMGD,5Gyp41oLVo7Gg7vF4vpmggWP5MU70QO6,22,82,30,8,13,0,13,0,146,20.857142857142858,15,0.0,25,30,4,13,57,0,4,13,0,72,74,0
5273,81699,ErBXi0pY00kAr7JQ9C5qO39mzbMPIL2X,5Gyp41oLVo7Gg7vF4vpmggWP5MU70QO6,1,0,0,0,0,0,1,0,1,0.14285714285714285,1,0.0,0,0,0,0,0,0,0,1,0,0,1,1
5274,81708,sLdE1XwCqd1M3K3CU3JeR9fAJx9wS4IC,5Gyp41oLVo7Gg7vF4vpmggWP5MU70QO6,19,28,16,0,10,0,13,0,67,9.571428571428571,4,0.0,3,16,0,10,25,0,0,13,0,29,38,1
5275,81712,7iTmBBKChEc8vaDVoNej7Za5TQKoyJKR,5Gyp41oLVo7Gg7vF4vpmggWP5MU70QO6,11,6,5,2,4,0,2,0,19,2.7142857142857144,1,0.0,0,5,1,4,6,0,1,2,0,10,9,1
5276,81722,UepPDDQKRX2gvfyC0cC72CpSt0htccXe,5Gyp41oLVo7Gg7vF4vpmggWP5MU70QO6,1,0,0,0,0,0,1,0,1,0.14285714285714285,1,0.0,0,0,0,0,0,0,0,1,0,0,1,1
5277,81729,NdrXoMMHPfNYZRBXjBmHK3Oxybjvb5JH,5Gyp41oLVo7Gg7vF4vpmggWP5MU70QO6,6,2,1,0,1,0,3,0,7,1.0,1,0.0,0,1,0,1,2,0,0,3,0,2,5,1
5278,81734,9qutpyxUCJIQJHMwAfrHtNX60WWqvl3G,5Gyp41oLVo7Gg7vF4vpmggWP5MU70QO6,7,4,2,0,2,0,3,0,11,1.5714285714285714,1,0.0,0,2,0,2,4,0,0,3,0,4,7,1
5279,81741,rL2Wp2McshMzJOuTaYQQEauhMVr1cn9o,5Gyp41oLVo7Gg7vF4vpmggWP5MU70QO6,4,2,1,0,1,0,1,0,5,0.7142857142857143,1,0.0,0,1,0,1,2,0,0,1,0,2,3,1
5280,81742,9puzLzVlA2TgO5Rh6gzTqoNWo0F9Q1Uf,5Gyp41oLVo7Gg7vF4vpmggWP5MU70QO6,9,14,2,0,2,1,9,1,29,4.142857142857143,2,0.0,6,2,0,2,8,1,0,9,1,10,19,1
5281,81756,W7KujC4k3yZdIHgAhugdfXrOXHL5jGWa,5Gyp41oLVo7Gg7vF4vpmggWP5MU70QO6,9,6,3,0,2,0,2,0,13,1.8571428571428572,1,0.0,0,3,0,2,6,0,0,2,0,5,8,1
5282,81771,HScXm7gr8Ll2wrmo4nR7HrfaRZw9SyE8,5Gyp41oLVo7Gg7vF4vpmggWP5MU70QO6,4,2,1,0,0,0,2,0,5,0.7142857142857143,1,0.0,0,1,0,0,2,0,0,2,0,1,4,1
5283,81778,IJ4NU8caWTuANVpCRSjvfDjTyce4VyLa,5Gyp41oLVo7Gg7vF4vpmggWP5MU70QO6,39,53,28,19,16,11,14,1,142,20.285714285714285,6,0.0,15,28,13,16,38,11,6,14,1,72,70,1
5284,81823,TXNnbjY690dLjW2nCR7nDyfRxXhXZM7x,5Gyp41oLVo7Gg7vF4vpmggWP5MU70QO6,1,0,0,0,0,0,1,0,1,0.14285714285714285,1,0.0,0,0,0,0,0,0,0,1,0,0,1,1
5285,81824,L3WpwWMk3AHS6ogVOti5NMJf0SEPrDvU,5Gyp41oLVo7Gg7vF4vpmggWP5MU70QO6,15,12,8,7,3,0,5,0,35,5.0,2,0.0,1,8,5,3,11,0,2,5,0,17,18,1
5286,81826,5SK8e6Td5yG9MSZHpZBKOgeDEnZoAZ5q,5Gyp41oLVo7Gg7vF4vpmggWP5MU70QO6,6,3,1,0,1,0,2,0,7,1.0,1,0.0,0,1,0,1,3,0,0,2,0,2,5,1
5287,81835,KOvmBcA9s1Xzvf4Ba1b6Jxr1bE5t44Zl,5Gyp41oLVo7Gg7vF4vpmggWP5MU70QO6,1,0,0,0,0,0,1,0,1,0.14285714285714285,1,0.0,0,0,0,0,0,0,0,1,0,0,1,1
5288,81837,RTkGQ4UmTL2ed98p2vxbPQoTurdG2SAC,5Gyp41oLVo7Gg7vF4vpmggWP5MU70QO6,22,56,25,7,9,10,20,0,127,18.142857142857142,9,0.0,15,25,5,9,41,10,2,20,0,54,73,1
5289,81841,InrI4RcRtMCVIAkBJwEbqprSPKTdUwZL,5Gyp41oLVo7Gg7vF4vpmggWP5MU70QO6,9,14,8,0,4,0,5,0,31,4.428571428571429,4,0.0,1,8,0,4,13,0,0,5,0,13,18,0
5290,81844,tnRrFt3zZPitlsQHq3ziTWoyjogTqR1S,5Gyp41oLVo7Gg7vF4vpmggWP5MU70QO6,1,0,0,0,0,0,2,0,2,0.2857142857142857,1,0.0,0,0,0,0,0,0,0,2,0,0,2,1
5291,81845,itwm4TVODOBqFpKY29D8QUWf1nvyYrio,5Gyp41oLVo7Gg7vF4vpmggWP5MU70QO6,1,0,0,0,0,0,1,0,1,0.14285714285714285,1,0.0,0,0,0,0,0,0,0,1,0,0,1,1
5292,81847,FV2QLqrxJnpFV8kh2dMlhF1Q4TPyAwGe,5Gyp41oLVo7Gg7vF4vpmggWP5MU70QO6,4,3,0,0,0,0,2,0,5,0.7142857142857143,1,0.0,0,0,0,0,3,0,0,2,0,0,5,1
5293,81864,Ep4Q95tKnG1eQgBqFXbKyAx3i4zRNHfc,5Gyp41oLVo7Gg7vF4vpmggWP5MU70QO6,35,76,41,29,19,16,11,2,194,27.714285714285715,5,0.0,23,41,19,19,53,16,10,11,2,102,92,0
5294,81883,cNdAhNMBLjPljDxmVI92aVbHrB5aRq30,5Gyp41oLVo7Gg7vF4vpmggWP5MU70QO6,8,6,4,0,3,0,4,0,17,2.4285714285714284,2,0.0,0,4,0,3,6,0,0,4,0,7,10,1
5295,81889,AXOgFWUEMyDEcBkotXpoXzfY4u6ulWjj,5Gyp41oLVo7Gg7vF4vpmggWP5MU70QO6,11,15,6,2,2,0,10,2,37,5.285714285714286,3,0.0,5,6,1,2,10,0,1,10,2,14,23,1
5296,81891,kvbydr7J9toNfajV4DY9FDU8zEAMAVQ1,5Gyp41oLVo7Gg7vF4vpmggWP5MU70QO6,14,19,11,0,5,11,18,2,66,9.428571428571429,2,0.0,3,11,0,5,16,11,0,18,2,19,47,1
5297,81898,xyBsJIxBvJWelISp41iqkjFWa1ZRWDuS,5Gyp41oLVo7Gg7vF4vpmggWP5MU70QO6,1,0,0,0,0,0,1,0,1,0.14285714285714285,1,0.0,0,0,0,0,0,0,0,1,0,0,1,1
5298,81933,2XL3DeJoAlSciNfv1lzOeAVybSPVMeST,5Gyp41oLVo7Gg7vF4vpmggWP5MU70QO6,7,7,2,0,3,0,2,0,14,2.0,1,0.0,1,2,0,3,6,0,0,2,0,6,8,1
5299,81941,p5Zov2RnBbluw06bAF0vsZiD2bb4lHm4,5Gyp41oLVo7Gg7vF4vpmggWP5MU70QO6,5,3,1,0,1,0,3,0,8,1.1428571428571428,1,0.0,0,1,0,1,3,0,0,3,0,2,6,1
5300,81951,JJToVFow5qkZZjCpX43ZJexjuIRhopwC,5Gyp41oLVo7Gg7vF4vpmggWP5MU70QO6,7,2,1,0,1,0,6,0,10,1.4285714285714286,1,0.0,0,1,0,1,2,0,0,6,0,2,8,1
5301,81962,wTTO5UZvOHJ50psl9u7EHqTW3gaK1AzY,5Gyp41oLVo7Gg7vF4vpmggWP5MU70QO6,5,2,1,0,1,0,2,0,6,0.8571428571428571,1,0.0,0,1,0,1,2,0,0,2,0,2,4,1
5302,81966,664aA95SpLjGifl4HhPxBvhnpaUFQ70i,5Gyp41oLVo7Gg7vF4vpmggWP5MU70QO6,13,22,8,2,5,0,5,0,42,6.0,1,0.0,2,8,1,5,20,0,1,5,0,16,26,1
5303,81968,svZr5zFr0ZC9w2UrVxLBYNSQ4Tg5eFZO,5Gyp41oLVo7Gg7vF4vpmggWP5MU70QO6,5,1,0,0,0,1,8,0,10,1.4285714285714286,2,0.0,0,0,0,0,1,1,0,8,0,0,10,1
5304,81969,RWPbtiIjgj4dbd83AeP26tTQo9Ej8m5m,5Gyp41oLVo7Gg7vF4vpmggWP5MU70QO6,29,30,14,53,8,17,21,2,145,20.714285714285715,1,0.0,14,14,41,8,16,17,12,21,2,77,68,1
5305,81975,o3zSSjoMuw2lsjy8BEo2oq83BTgFfSUZ,5Gyp41oLVo7Gg7vF4vpmggWP5MU70QO6,11,14,6,2,6,0,3,0,31,4.428571428571429,1,0.0,6,6,1,6,8,0,1,3,0,19,12,1
5306,81983,M414kNG7PkuOj7PNcBcNihP3YtAnl8Hp,5Gyp41oLVo7Gg7vF4vpmggWP5MU70QO6,3,0,0,0,0,0,3,0,3,0.42857142857142855,1,0.0,0,0,0,0,0,0,0,3,0,0,3,1
5307,81984,5zX31TZPkBQ4nxGKP7lPYFABTGNW6PHa,5Gyp41oLVo7Gg7vF4vpmggWP5MU70QO6,13,17,0,12,1,0,8,0,38,5.428571428571429,2,0.0,7,0,6,1,10,0,6,8,0,14,24,0
5308,81994,1bB5By8ujdlSjP6o6ZLWtPqvKKY6OuER,5Gyp41oLVo7Gg7vF4vpmggWP5MU70QO6,9,15,5,2,6,0,1,0,29,4.142857142857143,1,0.0,9,5,1,6,6,0,1,1,0,21,8,1
5309,81997,qXiwcKMSPAduA1ypbRUmB2QxtrPDn2mK,5Gyp41oLVo7Gg7vF4vpmggWP5MU70QO6,12,13,6,0,4,0,5,0,28,4.0,1,0.0,0,6,0,4,13,0,0,5,0,10,18,1
5310,82007,oJU0HZZ0PaJzfIGtWJOsNrl9Aa1NvCud,5Gyp41oLVo7Gg7vF4vpmggWP5MU70QO6,8,4,3,0,2,0,2,0,11,1.5714285714285714,1,0.0,0,3,0,2,4,0,0,2,0,5,6,1
5311,82013,jLnpoJcCnQK5rZk7KO8X2PwlohODJnXc,5Gyp41oLVo7Gg7vF4vpmggWP5MU70QO6,27,28,15,15,8,1,5,1,73,10.428571428571429,3,0.0,10,15,10,8,18,1,5,5,1,43,30,1
5312,82017,WlQYChhbsWhTEjPZxscP3TwUFCCBGjXl,5Gyp41oLVo7Gg7vF4vpmggWP5MU70QO6,6,4,1,0,0,0,5,2,12,1.7142857142857142,1,0.0,0,1,0,0,4,0,0,5,2,1,11,1
5313,82027,O8MsYQpR4hEy66ifxKhaGCm8wRRh6472,5Gyp41oLVo7Gg7vF4vpmggWP5MU70QO6,2,0,0,0,0,0,2,0,2,0.2857142857142857,1,0.0,0,0,0,0,0,0,0,2,0,0,2,1
5314,82031,MyMqBrbl1dBhRUWrRtNASDGXmSUH1uii,5Gyp41oLVo7Gg7vF4vpmggWP5MU70QO6,5,2,1,0,1,0,2,0,6,0.8571428571428571,1,0.0,0,1,0,1,2,0,0,2,0,2,4,1
5315,82036,ScNR9KK65fU9GIo3aRVLiGsq4AeK70F3,5Gyp41oLVo7Gg7vF4vpmggWP5MU70QO6,17,50,25,14,5,18,14,0,126,18.0,8,0.0,12,25,11,5,38,18,3,14,0,53,73,1
5316,82049,dysLfjeanq4tHamdntfde34XOZUPd7EJ,5Gyp41oLVo7Gg7vF4vpmggWP5MU70QO6,11,11,5,6,4,0,4,0,30,4.285714285714286,2,0.0,3,5,3,4,8,0,3,4,0,15,15,1
5317,82057,Ng3EMafi8VXifl0s5jfFxcYN5zgfdp6i,5Gyp41oLVo7Gg7vF4vpmggWP5MU70QO6,1,0,0,0,0,0,2,0,2,0.2857142857142857,1,0.0,0,0,0,0,0,0,0,2,0,0,2,1
5318,82079,yDGtxNnNQSlh4G0yTVxQ19yHJmDULM8y,5Gyp41oLVo7Gg7vF4vpmggWP5MU70QO6,1,0,0,0,0,0,1,0,1,0.14285714285714285,1,0.0,0,0,0,0,0,0,0,1,0,0,1,1
5319,82097,tedGThhHMqVARfBh6zyzyocTKbTJYJpB,5Gyp41oLVo7Gg7vF4vpmggWP5MU70QO6,5,3,0,0,0,3,21,0,27,3.857142857142857,7,0.0,0,0,0,0,3,3,0,21,0,0,27,1
5320,82110,IWADLwZhlWLo0OXuOChElEmmzDM9dqDV,5Gyp41oLVo7Gg7vF4vpmggWP5MU70QO6,7,4,3,0,2,0,2,0,11,1.5714285714285714,2,0.0,0,3,0,2,4,0,0,2,0,5,6,1
5321,82113,M75L90OOMTV1kEiI3n7vM0ty47YBFna9,5Gyp41oLVo7Gg7vF4vpmggWP5MU70QO6,37,155,64,16,19,44,45,5,348,49.714285714285715,6,0.0,28,64,11,19,127,44,5,45,5,122,226,1
5322,82119,VzR6XMdgKh4ZvcxT2eTU6o4kqKRYIMlT,5Gyp41oLVo7Gg7vF4vpmggWP5MU70QO6,16,28,15,12,7,3,23,16,104,14.857142857142858,7,0.0,5,15,6,7,23,3,6,23,16,33,71,1
5323,82126,BrtDkxIRglqJVY1aYKID2Vb6SWafzpud,5Gyp41oLVo7Gg7vF4vpmggWP5MU70QO6,19,31,16,8,9,12,7,0,83,11.857142857142858,5,0.0,7,16,5,9,24,12,3,7,0,37,46,0
5324,82132,UUZ8BPtKmDd7fu7X5v0nxZ0blsaD4W7o,5Gyp41oLVo7Gg7vF4vpmggWP5MU70QO6,15,23,11,6,5,3,48,3,99,14.142857142857142,5,0.0,1,11,4,5,22,3,2,48,3,21,78,1
5325,82140,m2vHU6I2vHbIjXkP5syq1gW8Xrvw3Ajn,5Gyp41oLVo7Gg7vF4vpmggWP5MU70QO6,14,21,7,2,4,1,5,0,40,5.714285714285714,1,0.0,10,7,1,4,11,1,1,5,0,22,18,1
5326,82156,pvwCMEkEuouZMLykCCdaUt3Holz1rXIP,5Gyp41oLVo7Gg7vF4vpmggWP5MU70QO6,7,3,2,0,2,0,5,0,12,1.7142857142857142,2,0.0,0,2,0,2,3,0,0,5,0,4,8,1
5327,82158,6nLW7vb3UEnUZBkO8BF0tZXFHSpKRYLR,5Gyp41oLVo7Gg7vF4vpmggWP5MU70QO6,7,3,2,0,2,0,2,0,9,1.2857142857142858,1,0.0,0,2,0,2,3,0,0,2,0,4,5,1
5328,82166,XmfaTDISWF5comI3j0oigEszknbdPhWn,5Gyp41oLVo7Gg7vF4vpmggWP5MU70QO6,13,6,5,0,3,0,4,1,19,2.7142857142857144,1,0.0,0,5,0,3,6,0,0,4,1,8,11,1
5329,82170,MY8EEZrNKd2bRcqc2C0ahob3DWC1rh6l,5Gyp41oLVo7Gg7vF4vpmggWP5MU70QO6,5,5,1,0,2,0,1,0,9,1.2857142857142858,1,0.0,2,1,0,2,3,0,0,1,0,5,4,1
5330,82174,ncPZRMbiKY9KkV5EbPeewQlV9WFZuuny,5Gyp41oLVo7Gg7vF4vpmggWP5MU70QO6,14,13,9,0,3,0,8,0,33,4.714285714285714,2,0.0,1,9,0,3,12,0,0,8,0,13,20,1
5331,82193,emp71NVk1KXao3OlLR8agWGAj1IKUQ7Q,5Gyp41oLVo7Gg7vF4vpmggWP5MU70QO6,9,10,7,0,5,0,4,0,26,3.7142857142857144,2,0.0,0,7,0,5,10,0,0,4,0,12,14,1
5332,82198,5AFyzPkHwyTVsfPkttq2r1sY0ki8ht9E,5Gyp41oLVo7Gg7vF4vpmggWP5MU70QO6,5,2,1,0,1,0,3,0,7,1.0,1,0.0,0,1,0,1,2,0,0,3,0,2,5,1
5333,82204,r4LtQoLlaaTrHds7HYAdM3HkMRox2Az0,5Gyp41oLVo7Gg7vF4vpmggWP5MU70QO6,7,8,2,0,1,0,2,0,13,1.8571428571428572,2,0.0,0,2,0,1,8,0,0,2,0,3,10,1
5334,82234,AvrMRFWoCuzDtN7hbx3GuuisUX9dn4mc,5Gyp41oLVo7Gg7vF4vpmggWP5MU70QO6,10,16,7,0,3,1,5,0,32,4.571428571428571,4,0.0,2,7,0,3,14,1,0,5,0,12,20,1
5335,82248,4oUbp13NVHc29DccFhqfdkKKNEywtCeE,5Gyp41oLVo7Gg7vF4vpmggWP5MU70QO6,6,1,1,0,1,0,3,0,6,0.8571428571428571,1,0.0,0,1,0,1,1,0,0,3,0,2,4,1
5336,82252,uJ1omfNa6wThHrODhBq1mtJVihr2Vf9k,5Gyp41oLVo7Gg7vF4vpmggWP5MU70QO6,6,3,1,0,1,0,4,0,9,1.2857142857142858,1,0.0,0,1,0,1,3,0,0,4,0,2,7,0
5337,82261,KpB9pFcFkZGqFLAJyYAoBcRReytXA7a4,5Gyp41oLVo7Gg7vF4vpmggWP5MU70QO6,6,3,2,0,2,0,1,0,8,1.1428571428571428,1,0.0,0,2,0,2,3,0,0,1,0,4,4,1
5338,82265,GKB9h3WVdBElKYEACxUSpjlSvU0bLxUa,5Gyp41oLVo7Gg7vF4vpmggWP5MU70QO6,11,13,6,0,6,0,2,0,27,3.857142857142857,1,0.0,0,6,0,6,13,0,0,2,0,12,15,1
5339,82272,0P2GtMy28JDcPARuexfQD2kqs1CWnSqR,5Gyp41oLVo7Gg7vF4vpmggWP5MU70QO6,7,4,2,0,3,0,3,0,12,1.7142857142857142,2,0.0,1,2,0,3,3,0,0,3,0,6,6,0
5340,82277,O9Pboxj2Omf1Ml9NHOiRahIRShnC75bO,5Gyp41oLVo7Gg7vF4vpmggWP5MU70QO6,1,0,0,0,0,0,2,0,2,0.2857142857142857,1,0.0,0,0,0,0,0,0,0,2,0,0,2,1
5341,82285,bueP8xU7CdiOxIwikFuvLqc6wvzofi5k,5Gyp41oLVo7Gg7vF4vpmggWP5MU70QO6,14,9,6,4,4,3,6,0,32,4.571428571428571,1,0.0,2,6,2,4,7,3,2,6,0,14,18,1
5342,82287,fKIYKEAGjFjOVTaUhIbkE3jtMMjkLesA,5Gyp41oLVo7Gg7vF4vpmggWP5MU70QO6,11,20,6,0,3,1,8,0,38,5.428571428571429,4,0.0,2,6,0,3,18,1,0,8,0,11,27,1
5343,82291,6Syl5iFEMiZhZ3Kx0ufBuMuPfsA0G6FI,5Gyp41oLVo7Gg7vF4vpmggWP5MU70QO6,6,2,1,0,1,0,5,0,9,1.2857142857142858,1,0.0,0,1,0,1,2,0,0,5,0,2,7,1
5344,82321,npaSrrzEzioGRzWdj7UAaA6xDgKQrILa,5X6FeZozNMgE2VRi3MJYjkkFK8SETtu2,4,3,1,0,0,0,2,0,6,0.8571428571428571,1,0.0,0,1,0,0,3,0,0,2,0,1,5,1
5345,82358,GulRMWFcPY5JE8HNbJPRyRdVqJqL2eEA,5X6FeZozNMgE2VRi3MJYjkkFK8SETtu2,13,8,1,22,2,0,2,0,35,5.0,1,0.0,5,1,17,2,3,0,5,2,0,25,10,1
5346,82372,P59zgxkiZZAY4L2oDvB0C7gvcL7QBtyx,5X6FeZozNMgE2VRi3MJYjkkFK8SETtu2,6,19,11,0,3,0,9,0,42,6.0,1,0.0,1,11,0,3,18,0,0,9,0,15,27,0
5347,82391,r6vCAWlYIzTyZ2tN64AHwtfHr1599fdG,7GRhBDsirIGkRZBtSMEzNTyDr2JQm4xx,26,92,4,66,5,1,29,0,197,28.142857142857142,4,0.0,51,4,54,5,41,1,12,29,0,114,83,0
5348,82402,9ZFS4K1NbtsFJNVDZcG24bdRzdU6w1Qj,5X6FeZozNMgE2VRi3MJYjkkFK8SETtu2,2,0,0,0,0,0,3,0,3,0.42857142857142855,2,0.0,0,0,0,0,0,0,0,3,0,0,3,1
5349,82426,AYyigeqx54KlykjSn8XXM8xIAmNPwwgy,5X6FeZozNMgE2VRi3MJYjkkFK8SETtu2,8,9,0,0,0,14,9,0,32,4.571428571428571,1,0.0,2,0,0,0,7,14,0,9,0,2,30,1
5350,82434,5MqtNGumkUVehW5cfaAfZ7nPmHPSTQ7V,5X6FeZozNMgE2VRi3MJYjkkFK8SETtu2,10,8,1,14,1,0,2,0,26,3.7142857142857144,1,0.0,4,1,13,1,4,0,1,2,0,19,7,1
5351,82460,N0lIDzx7ySDqstMupMct3nbriqwOpqNG,5X6FeZozNMgE2VRi3MJYjkkFK8SETtu2,1,0,0,0,0,0,1,0,1,0.14285714285714285,1,0.0,0,0,0,0,0,0,0,1,0,0,1,1
5352,82478,FG49dGsnehbDquxb5MR2UKw7UsmsUWRR,5X6FeZozNMgE2VRi3MJYjkkFK8SETtu2,1,0,0,0,0,0,2,0,2,0.2857142857142857,1,0.0,0,0,0,0,0,0,0,2,0,0,2,1
5353,82490,nCjvWGBuFy5INkXPz8A7SRdydYBldjvQ,5X6FeZozNMgE2VRi3MJYjkkFK8SETtu2,6,10,1,0,1,0,2,0,14,2.0,1,0.0,7,1,0,1,3,0,0,2,0,9,5,1
5354,82501,C90t4OTJKLckQlEHPGqMg6X9e1cv22jh,7GRhBDsirIGkRZBtSMEzNTyDr2JQm4xx,1,0,0,0,0,0,1,0,1,0.14285714285714285,1,0.0,0,0,0,0,0,0,0,1,0,0,1,1
5355,82569,CbshEYIe2wcAzVubCMNTR8AyCYM6IoV7,5X6FeZozNMgE2VRi3MJYjkkFK8SETtu2,8,6,0,0,1,0,3,0,10,1.4285714285714286,1,0.0,2,0,0,1,4,0,0,3,0,3,7,1
5356,82580,99Z3XYkjkHbSSUTlX3TBtdd4he2ej5Yp,5X6FeZozNMgE2VRi3MJYjkkFK8SETtu2,5,2,1,0,1,0,2,0,6,0.8571428571428571,1,0.0,0,1,0,1,2,0,0,2,0,2,4,1
5357,82609,8t2I7RZ6tGpzDNhY5KSmkbKJTicFPhFD,SpATywNh6bZuzm8s1ceuBUnMUAeoAHHw,33,45,26,20,16,0,12,0,119,17.0,5,0.0,14,26,17,16,31,0,3,12,0,73,46,0
5358,82626,1LsKSfuKnKljzcVBDuX88jdA4iNAFPmK,SpATywNh6bZuzm8s1ceuBUnMUAeoAHHw,5,4,2,0,2,0,1,0,9,1.2857142857142858,1,0.0,0,2,0,2,4,0,0,1,0,4,5,0
5359,82642,7IO6p4687fQRowFKh8aP2BRrTBz96sXF,G8EPVSXsOYB5YQWZGiz1aVq5Pgr2GrQu,15,6,5,0,4,3,6,1,25,3.5714285714285716,1,0.0,0,5,0,4,6,3,0,6,1,9,16,0
5360,82654,CSh5hGbaSFu2yCb31iVMOVwKocrH471Q,5X6FeZozNMgE2VRi3MJYjkkFK8SETtu2,17,19,6,20,8,0,6,0,59,8.428571428571429,2,0.0,10,6,18,8,9,0,2,6,0,42,17,1
5361,82722,i0k5iK0fS6RmfXLKfz70zhtGt8sKmdev,G8EPVSXsOYB5YQWZGiz1aVq5Pgr2GrQu,5,6,0,0,0,0,2,0,8,1.1428571428571428,1,0.0,0,0,0,0,6,0,0,2,0,0,8,1
5362,82731,Yoi2x66FMpn68ZsrWcG2qShRXgJS18Rh,G8EPVSXsOYB5YQWZGiz1aVq5Pgr2GrQu,15,17,16,0,7,11,8,0,59,8.428571428571429,1,0.0,0,16,0,7,17,11,0,8,0,23,36,1
5363,82828,PCDzowxElNLixXyfAFPkQqlbkMlIrEa9,RXDvfPUBYFlVdlueBFbLW0mhhAyGEqpt,1,0,0,0,0,0,1,0,1,0.14285714285714285,1,0.0,0,0,0,0,0,0,0,1,0,0,1,1
5364,82832,bNG7kJA3jy4DW8PDzMNAT9OoyHwhutqS,bWdj2GDclj5ofokWjzoa5jAwMkxCykd6,6,5,1,0,1,0,5,0,12,1.7142857142857142,2,0.0,0,1,0,1,5,0,0,5,0,2,10,1
5365,82865,UVY9zxbBVUyhzTA4AJhTZxTOHFZ2duQd,SpATywNh6bZuzm8s1ceuBUnMUAeoAHHw,8,8,2,0,1,0,2,0,13,1.8571428571428572,2,0.0,0,2,0,1,8,0,0,2,0,3,10,1
5366,82897,V05RDMzHe21axAEGmWItNlvN0EepoKmU,5X6FeZozNMgE2VRi3MJYjkkFK8SETtu2,2,0,0,0,0,0,2,0,2,0.2857142857142857,1,0.0,0,0,0,0,0,0,0,2,0,0,2,1
5367,82912,dSKLyWRwDNYp6bnGVfES0oxRsg4F2fbZ,SpATywNh6bZuzm8s1ceuBUnMUAeoAHHw,16,16,2,12,1,0,3,0,34,4.857142857142857,2,0.0,4,2,9,1,12,0,3,3,0,16,18,1
5368,82965,jMzDAkDrCqzTj207GrZXDfLQXbYc8WXP,bWdj2GDclj5ofokWjzoa5jAwMkxCykd6,4,4,2,0,0,10,1,0,17,2.4285714285714284,1,0.0,0,2,0,0,4,10,0,1,0,2,15,0
5369,82997,HKDSRzc7MQzCfJsk49D6xFQK4oFHHvy7,RXDvfPUBYFlVdlueBFbLW0mhhAyGEqpt,3,0,0,0,0,0,6,0,6,0.8571428571428571,2,0.0,0,0,0,0,0,0,0,6,0,0,6,1
5370,83039,2T4Z0Imx9CFpIzAb5WFSfhS9FT4FpZWV,SpATywNh6bZuzm8s1ceuBUnMUAeoAHHw,6,8,4,0,0,0,1,0,13,1.8571428571428572,1,0.0,0,4,0,0,8,0,0,1,0,4,9,1
5371,83107,TBj8ERKtARA6ABLjSlKdebgRJkBjpHod,5X6FeZozNMgE2VRi3MJYjkkFK8SETtu2,10,6,4,0,1,2,9,3,25,3.5714285714285716,1,0.0,0,4,0,1,6,2,0,9,3,5,20,1
5372,83117,TBj8ERKtARA6ABLjSlKdebgRJkBjpHod,RXDvfPUBYFlVdlueBFbLW0mhhAyGEqpt,2,0,0,0,0,0,2,0,2,0.2857142857142857,1,0.0,0,0,0,0,0,0,0,2,0,0,2,1
5373,83137,4QdCY5LBLprzaTySBBQaKyTy9rCkNUT7,5X6FeZozNMgE2VRi3MJYjkkFK8SETtu2,1,0,0,0,0,0,1,0,1,0.14285714285714285,1,0.0,0,0,0,0,0,0,0,1,0,0,1,1
5374,83152,eDH23vVDxXZaCChKrwOZtbVMeyImNCFQ,SpATywNh6bZuzm8s1ceuBUnMUAeoAHHw,6,5,3,0,1,0,1,0,10,1.4285714285714286,1,0.0,0,3,0,1,5,0,0,1,0,4,6,1
5375,83169,8xLHRJYQMKIoYFTLtqTA4nbHlXLKnGUi,SpATywNh6bZuzm8s1ceuBUnMUAeoAHHw,14,28,13,9,5,2,6,0,63,9.0,2,0.0,10,13,8,5,18,2,1,6,0,36,27,0
5376,83196,mJZNVvZltlGUOWmItS7lca1ZZKMYLgfv,5X6FeZozNMgE2VRi3MJYjkkFK8SETtu2,16,16,1,30,1,0,3,0,51,7.285714285714286,2,0.0,9,1,23,1,7,0,7,3,0,34,17,1
5377,83204,jBaD9LGpQhL9ahJeTZMqoOmC2qbpaMeG,5X6FeZozNMgE2VRi3MJYjkkFK8SETtu2,23,27,8,20,12,1,9,1,78,11.142857142857142,3,0.0,14,8,19,12,13,1,1,9,1,53,25,0
5378,83225,PQOxOuUmyRHKBoJFPoN8Q817ShM1EBnU,SpATywNh6bZuzm8s1ceuBUnMUAeoAHHw,4,3,1,0,0,0,1,0,5,0.7142857142857143,1,0.0,0,1,0,0,3,0,0,1,0,1,4,1
5379,83257,kGjYv3fIEEVtPJnIV3ey8jABNxw0G9DP,5X6FeZozNMgE2VRi3MJYjkkFK8SETtu2,3,0,0,0,0,5,2,0,7,1.0,1,0.0,0,0,0,0,0,5,0,2,0,0,7,1
5380,83294,drMAzq4nC1GseQmyuPqctPxioPnjLJpD,bWdj2GDclj5ofokWjzoa5jAwMkxCykd6,5,3,0,0,0,0,3,0,6,0.8571428571428571,1,0.0,0,0,0,0,3,0,0,3,0,0,6,1
5381,83299,DawlCH8NcvFmcnrUGRB8b9wi64nyiEPI,RXDvfPUBYFlVdlueBFbLW0mhhAyGEqpt,1,0,0,0,0,0,1,0,1,0.14285714285714285,1,0.0,0,0,0,0,0,0,0,1,0,0,1,1
5382,83313,6cy8BWaUGaMCAOjojQczbStvsRKYISdK,SpATywNh6bZuzm8s1ceuBUnMUAeoAHHw,27,35,18,16,9,5,6,0,89,12.714285714285714,2,0.0,8,18,16,9,27,5,0,6,0,51,38,0
5383,83394,4Wmd4Th2aTvlEICpolKlrpcWMkbPEV69,RXDvfPUBYFlVdlueBFbLW0mhhAyGEqpt,44,37,14,58,16,10,2,0,137,19.571428571428573,1,0.0,21,14,56,16,16,10,2,2,0,107,30,1
5384,83407,DmtYVZArE2EvS9aiKUqKSMgZGIBgO1QS,RXDvfPUBYFlVdlueBFbLW0mhhAyGEqpt,16,19,10,22,4,0,4,0,59,8.428571428571429,2,0.0,2,10,22,4,17,0,0,4,0,38,21,1
5385,83415,RbskEZqQKwCnVdL6duQzlEj5uu5RNIef,G8EPVSXsOYB5YQWZGiz1aVq5Pgr2GrQu,16,27,12,8,7,7,9,0,70,10.0,1,0.0,11,12,7,7,16,7,1,9,0,37,33,1
5386,83425,Lr6km982apCQSCgmC6f9GQFgHOEktsCy,G8EPVSXsOYB5YQWZGiz1aVq5Pgr2GrQu,1,0,0,0,0,0,1,0,1,0.14285714285714285,1,0.0,0,0,0,0,0,0,0,1,0,0,1,1
5387,83490,XjHYgZsrS0l8TkcDRDNv64IhD09kdX0g,RXDvfPUBYFlVdlueBFbLW0mhhAyGEqpt,1,0,0,0,0,0,1,0,1,0.14285714285714285,1,0.0,0,0,0,0,0,0,0,1,0,0,1,1
5388,83498,XedkRmZw73FBMyT7OPP5ylIVnvaHlAGN,5X6FeZozNMgE2VRi3MJYjkkFK8SETtu2,7,4,3,0,2,0,2,0,11,1.5714285714285714,1,0.0,0,3,0,2,4,0,0,2,0,5,6,1
5389,83520,AIxODBgirdS9q7XBbO7B4LHcFYA0NbGc,bWdj2GDclj5ofokWjzoa5jAwMkxCykd6,6,4,2,0,1,0,4,0,11,1.5714285714285714,1,0.0,0,2,0,1,4,0,0,4,0,3,8,0
5390,83522,A88tFa21T4XqWWIuRG4iPf7ag41L6qpK,5X6FeZozNMgE2VRi3MJYjkkFK8SETtu2,9,4,4,0,2,0,3,0,13,1.8571428571428572,1,0.0,0,4,0,2,4,0,0,3,0,6,7,1
5391,83525,8Rf4S0ug2TWWxQ3mSUdOeqp73t5YEeYH,RXDvfPUBYFlVdlueBFbLW0mhhAyGEqpt,2,0,0,0,0,8,1,0,9,1.2857142857142858,1,0.0,0,0,0,0,0,8,0,1,0,0,9,1
5392,83545,7OnUQoKNPB7YvlLkAtyo2YJK5O7VH0T8,5X6FeZozNMgE2VRi3MJYjkkFK8SETtu2,13,15,2,19,4,3,5,0,48,6.857142857142857,1,0.0,11,2,15,4,4,3,4,5,0,32,16,1
5393,83551,MyYvsUimsdJLREHlZB7pLW11HvGvwatH,5X6FeZozNMgE2VRi3MJYjkkFK8SETtu2,32,72,14,46,22,4,6,1,165,23.571428571428573,4,0.0,28,14,40,22,44,4,6,6,1,104,61,1
5394,83578,t8qBiDTvOvYmrxcVIErRuEOf38tywm6t,A3fsA9Zfv1X2fVEQhTw51lKENdNrEqT3,1,0,0,0,0,0,1,0,1,0.14285714285714285,1,0.0,0,0,0,0,0,0,0,1,0,0,1,1
5395,83589,42WEg9p9HKMRw7DcLiehVP064YBoX0CC,G8EPVSXsOYB5YQWZGiz1aVq5Pgr2GrQu,34,20,15,38,6,0,10,0,89,12.714285714285714,1,0.0,1,15,34,6,19,0,4,10,0,56,33,1
5396,83610,LsCKaHxDojvW6mqkt4YixGtP1AxIvEcR,SpATywNh6bZuzm8s1ceuBUnMUAeoAHHw,11,16,0,8,0,0,3,0,27,3.857142857142857,3,0.0,0,0,6,0,16,0,2,3,0,6,21,0
5397,83638,kUCkMoz2G1vNKPwfWoTyAK0pg5EEdfy3,5X6FeZozNMgE2VRi3MJYjkkFK8SETtu2,1,0,0,0,0,0,1,0,1,0.14285714285714285,1,0.0,0,0,0,0,0,0,0,1,0,0,1,1
5398,83647,5lUjtpVDM24Ky0bHM8HFsUs8uLGNBspP,SpATywNh6bZuzm8s1ceuBUnMUAeoAHHw,1,1,0,0,0,0,0,0,1,0.14285714285714285,1,0.0,0,0,0,0,1,0,0,0,0,0,1,1
5399,83671,neZ18tPUzdX2s40f6yVBysxDUKCDyzmG,5X6FeZozNMgE2VRi3MJYjkkFK8SETtu2,8,13,0,0,7,0,3,0,23,3.2857142857142856,1,0.0,8,0,0,7,5,0,0,3,0,15,8,1
5400,83704,z38xWziicrZeTyki4GmVJQHBKXdJd40R,bWdj2GDclj5ofokWjzoa5jAwMkxCykd6,6,6,2,0,2,0,2,0,12,1.7142857142857142,1,0.0,2,2,0,2,4,0,0,2,0,6,6,1
5401,83727,6uIhQ3yme7QLLxwzkjsfRrOvYJqr7Y3a,5X6FeZozNMgE2VRi3MJYjkkFK8SETtu2,3,2,0,0,0,0,1,0,3,0.42857142857142855,1,0.0,0,0,0,0,2,0,0,1,0,0,3,1
5402,83858,mSQuPHmd8TP05MnBFR4zut82tnd837yj,G8EPVSXsOYB5YQWZGiz1aVq5Pgr2GrQu,6,9,1,0,0,0,1,0,11,1.5714285714285714,1,0.0,3,1,0,0,6,0,0,1,0,4,7,0
5403,83875,3CXEafcVCxECgohc6attm6JVlndHTBVL,SpATywNh6bZuzm8s1ceuBUnMUAeoAHHw,12,27,9,0,5,4,5,2,52,7.428571428571429,1,0.0,0,9,0,5,27,4,0,5,2,14,38,1
5404,83914,OQqjSB4aJTEsbrxgicWfXRK0yZcOBPo4,5X6FeZozNMgE2VRi3MJYjkkFK8SETtu2,1,0,0,0,0,0,1,0,1,0.14285714285714285,1,0.0,0,0,0,0,0,0,0,1,0,0,1,1
5405,83933,bA4tnPZD0UU4XAL3OkL7nUjtkAzbgj9d,bWdj2GDclj5ofokWjzoa5jAwMkxCykd6,10,11,4,0,1,0,3,0,19,2.7142857142857144,2,0.0,0,4,0,1,11,0,0,3,0,5,14,0
5406,83945,8sPH4f87PPg93teytSXDrui8J4UUp19X,5X6FeZozNMgE2VRi3MJYjkkFK8SETtu2,1,0,0,0,0,0,1,0,1,0.14285714285714285,1,0.0,0,0,0,0,0,0,0,1,0,0,1,1
5407,83949,Z89wynkx1rcXHYvlCNExAupGqq9VVjQV,G8EPVSXsOYB5YQWZGiz1aVq5Pgr2GrQu,25,6,5,66,0,3,2,1,83,11.857142857142858,1,0.0,0,5,57,0,6,3,9,2,1,62,21,1
5408,83964,y9rcit987NPY2SaKlR7Ue3Haisfwv9TA,G8EPVSXsOYB5YQWZGiz1aVq5Pgr2GrQu,1,0,0,0,0,0,2,0,2,0.2857142857142857,1,0.0,0,0,0,0,0,0,0,2,0,0,2,1
5409,83967,Free8VIbkuRtDePLl5SkDqBlEPkZtxvH,5X6FeZozNMgE2VRi3MJYjkkFK8SETtu2,1,0,0,0,0,0,1,0,1,0.14285714285714285,1,0.0,0,0,0,0,0,0,0,1,0,0,1,1
5410,83978,19iVDfShKixZpg8xTJAbBZz9CTfyTS2H,A3fsA9Zfv1X2fVEQhTw51lKENdNrEqT3,18,19,9,0,7,0,1,0,36,5.142857142857143,1,0.0,2,9,0,7,17,0,0,1,0,18,18,1
5411,84015,zIxyUmEBKUIbRs852GDKgts0vTx0P8GO,5X6FeZozNMgE2VRi3MJYjkkFK8SETtu2,1,0,0,0,0,0,1,0,1,0.14285714285714285,1,0.0,0,0,0,0,0,0,0,1,0,0,1,1
5412,84029,7u0QfTKQg4itZK9m8foLXkIGwUxxHMsT,RXDvfPUBYFlVdlueBFbLW0mhhAyGEqpt,58,51,36,58,28,3,3,0,179,25.571428571428573,2,0.0,13,36,57,28,38,3,1,3,0,134,45,0
5413,84053,dhO2y8sIijAlPYlXxsHK1aEk6O7FL2Q2,5X6FeZozNMgE2VRi3MJYjkkFK8SETtu2,2,0,0,0,0,0,2,0,2,0.2857142857142857,1,0.0,0,0,0,0,0,0,0,2,0,0,2,1
5414,84085,FN5TAXCOvxkHETvtFGXhthh9OlDi8jNI,5X6FeZozNMgE2VRi3MJYjkkFK8SETtu2,2,0,0,0,0,0,2,0,2,0.2857142857142857,1,0.0,0,0,0,0,0,0,0,2,0,0,2,1
5415,84111,uiC9EHMxnf2w4h6Qgd2IixJ8SdchRJcU,SpATywNh6bZuzm8s1ceuBUnMUAeoAHHw,11,12,6,4,3,0,2,0,27,3.857142857142857,1,0.0,0,6,4,3,12,0,0,2,0,13,14,1
5416,84133,bVLtn3iBc4ibW8xWVzLLM3Hs9gCB0qb7,A3fsA9Zfv1X2fVEQhTw51lKENdNrEqT3,6,3,1,0,0,0,3,0,7,1.0,1,0.0,0,1,0,0,3,0,0,3,0,1,6,1
5417,84165,n1ESpvyobZkFsfrWJhKOuY4URaa1sUc5,SpATywNh6bZuzm8s1ceuBUnMUAeoAHHw,3,2,1,0,0,2,1,0,6,0.8571428571428571,2,0.0,0,1,0,0,2,2,0,1,0,1,5,0
5418,84178,btDL3pREx87iBHbN4DIhDQi5ERLMYVWp,bWdj2GDclj5ofokWjzoa5jAwMkxCykd6,1,0,0,0,0,0,1,0,1,0.14285714285714285,1,0.0,0,0,0,0,0,0,0,1,0,0,1,1
5419,84286,jzGZfbr4RQdn7HQn4oyJMDfKBcS7VFEE,fbPkOYLVPtPgIt0MxizjfFJov3JbHyAi,4,4,0,0,0,0,2,0,6,0.8571428571428571,1,0.0,0,0,0,0,4,0,0,2,0,0,6,1
5420,84580,7dBPQqnhg3HraIZoj8IGy6tqqgLAonOI,SpATywNh6bZuzm8s1ceuBUnMUAeoAHHw,14,19,3,7,0,0,3,0,32,4.571428571428571,3,0.0,5,3,7,0,14,0,0,3,0,15,17,1
5421,84666,hBNiP82EasOgIR36wjHyg8vPIDQi3YO9,bWdj2GDclj5ofokWjzoa5jAwMkxCykd6,5,4,1,0,0,0,6,0,11,1.5714285714285714,1,0.0,0,1,0,0,4,0,0,6,0,1,10,1
5422,84728,GEuM5Jv5mgEiHQoZ7WZazbnkG2fcrd9Y,SpATywNh6bZuzm8s1ceuBUnMUAeoAHHw,15,15,13,0,9,0,4,0,41,5.857142857142857,2,0.0,0,13,0,9,15,0,0,4,0,22,19,0
5423,84779,Yg1xD2SamgKDKmDpRN2e3H3NAX0vGE2e,SpATywNh6bZuzm8s1ceuBUnMUAeoAHHw,12,12,2,12,1,0,3,0,30,4.285714285714286,2,0.0,2,2,10,1,10,0,2,3,0,15,15,1
5424,84843,SgKrscfCtmytbxsrqs57oYYzOpyIlSfF,A3fsA9Zfv1X2fVEQhTw51lKENdNrEqT3,1,0,0,0,0,0,1,0,1,0.14285714285714285,1,0.0,0,0,0,0,0,0,0,1,0,0,1,0
5425,84851,1GaXo8IuKFR6VdEVIYRJbTRl2qOzgbEk,SpATywNh6bZuzm8s1ceuBUnMUAeoAHHw,13,7,6,0,5,0,1,0,19,2.7142857142857144,1,0.0,0,6,0,5,7,0,0,1,0,11,8,1
5426,85254,5AnTWuSZRA41O05i9OVXdtPUlL8FmaJL,SpATywNh6bZuzm8s1ceuBUnMUAeoAHHw,5,5,0,0,0,0,1,0,6,0.8571428571428571,1,0.0,0,0,0,0,5,0,0,1,0,0,6,1
5427,85360,sT9hGAnww95aeGvqwQpJlS3ORhWDT49F,SpATywNh6bZuzm8s1ceuBUnMUAeoAHHw,17,18,4,17,1,0,6,0,46,6.571428571428571,3,0.0,6,4,14,1,12,0,3,6,0,25,21,0
5428,85381,MaYaRLQWCfitDjLO89g6UksqHgmMxPRV,SpATywNh6bZuzm8s1ceuBUnMUAeoAHHw,11,25,1,19,1,0,1,0,47,6.714285714285714,1,0.0,16,1,16,1,9,0,3,1,0,34,13,0
5429,85384,13G00kuKCwdh69q4LTm8Z3EAcWInuO3M,3VkHkmOtom3jM2wCu94xgzzu1d6Dn7or,14,48,27,5,12,21,16,0,129,18.428571428571427,4,0.0,12,27,4,12,36,21,1,16,0,55,74,0
5430,85420,XLTMcH7feYHtvCTPGsBtNd0Km1sdgjIQ,3VkHkmOtom3jM2wCu94xgzzu1d6Dn7or,26,26,18,0,13,25,18,3,103,14.714285714285714,5,0.0,0,18,0,13,26,25,0,18,3,31,72,0
5431,85486,ikX72CHxEGhdeCUCpL9omQYpqM8MqHTI,3VkHkmOtom3jM2wCu94xgzzu1d6Dn7or,11,63,25,4,8,6,34,0,140,20.0,8,0.0,10,25,3,8,53,6,1,34,0,46,94,0
5432,85493,1UiowfZ7uyfZSD6V0fTgYJKnmkDm03gk,3VkHkmOtom3jM2wCu94xgzzu1d6Dn7or,84,139,48,78,52,21,31,0,369,52.714285714285715,9,0.0,71,48,72,52,68,21,6,31,0,243,126,0
5433,85503,YXaF030ton3euPuB53B4LSPXUZjmznML,3VkHkmOtom3jM2wCu94xgzzu1d6Dn7or,11,20,6,0,0,1,11,3,41,5.857142857142857,1,0.0,5,6,0,0,15,1,0,11,3,11,30,1
5434,85562,9tOn7goHN9N7J9eojiuTfPcShVM7kNFp,3VkHkmOtom3jM2wCu94xgzzu1d6Dn7or,27,113,14,0,0,0,9,0,136,19.428571428571427,9,0.0,0,14,0,0,113,0,0,9,0,14,122,1
5435,85572,BefOyg6ykNDc1FataC1t5Raqf6W1A5Yb,3VkHkmOtom3jM2wCu94xgzzu1d6Dn7or,4,2,1,0,0,0,2,0,5,0.7142857142857143,1,0.0,0,1,0,0,2,0,0,2,0,1,4,1
5436,85577,FsRtG9gDIPReRoDWnJ4MFLGSrRsEmLDJ,3VkHkmOtom3jM2wCu94xgzzu1d6Dn7or,80,151,57,93,59,6,21,6,393,56.142857142857146,9,0.0,78,57,86,59,73,6,7,21,6,280,113,0
5437,85592,n42jeLyeDpoJPwT1pkhXRyhzHjUnC2KC,3VkHkmOtom3jM2wCu94xgzzu1d6Dn7or,8,6,1,0,2,4,7,1,21,3.0,1,0.0,2,1,0,2,4,4,0,7,1,5,16,1
5438,85596,rVswAzjMLz5uIPbCwAU1SliCQFpiAqey,3VkHkmOtom3jM2wCu94xgzzu1d6Dn7or,21,16,10,0,9,0,5,0,40,5.714285714285714,2,0.0,0,10,0,9,16,0,0,5,0,19,21,0
5439,85635,rPrdwxrDlJrFMColYZ7kiFx08s7CjBNo,3VkHkmOtom3jM2wCu94xgzzu1d6Dn7or,2,0,0,0,0,0,2,0,2,0.2857142857142857,1,0.0,0,0,0,0,0,0,0,2,0,0,2,1
5440,85642,u82lBhpDxJIwlZISEntCxj1zgVFdW0vT,3VkHkmOtom3jM2wCu94xgzzu1d6Dn7or,1,0,0,0,0,0,1,0,1,0.14285714285714285,1,0.0,0,0,0,0,0,0,0,1,0,0,1,1
5441,85659,fFjMIQfbklZeqfS9aUgse0l8NduTnrt6,3VkHkmOtom3jM2wCu94xgzzu1d6Dn7or,5,6,2,0,0,0,2,0,10,1.4285714285714286,2,0.0,0,2,0,0,6,0,0,2,0,2,8,1
5442,85663,MW4QwctRTPmSxxlsV186y0TFPaRs670c,3VkHkmOtom3jM2wCu94xgzzu1d6Dn7or,1,0,0,0,0,0,1,0,1,0.14285714285714285,1,0.0,0,0,0,0,0,0,0,1,0,0,1,1
5443,85668,HlU1brRw0L84gAhbD8o1bmz657h34FA1,3VkHkmOtom3jM2wCu94xgzzu1d6Dn7or,9,5,0,0,0,0,6,0,11,1.5714285714285714,1,0.0,0,0,0,0,5,0,0,6,0,0,11,0
5444,85676,HK1m8DNsZ7wRvCGkSUvRPlRDv1HLW90b,3VkHkmOtom3jM2wCu94xgzzu1d6Dn7or,3,2,0,0,0,0,1,0,3,0.42857142857142855,1,0.0,0,0,0,0,2,0,0,1,0,0,3,1
5445,85681,cIy3aYPsf2ix38dnJp9RrmaHIory6k1R,3VkHkmOtom3jM2wCu94xgzzu1d6Dn7or,6,4,1,0,1,1,2,0,9,1.2857142857142858,1,0.0,0,1,0,1,4,1,0,2,0,2,7,1
5446,85695,DZTuO7JM8b5ONs3CMIJ4mV8vYzwayKT9,3VkHkmOtom3jM2wCu94xgzzu1d6Dn7or,5,2,1,0,1,1,2,0,7,1.0,1,0.0,0,1,0,1,2,1,0,2,0,2,5,1
5447,85720,KgrGG9kglKcchULRxpqu8ZMQTftFlDgP,3VkHkmOtom3jM2wCu94xgzzu1d6Dn7or,18,18,8,8,6,4,10,2,56,8.0,3,0.0,6,8,8,6,12,4,0,10,2,28,28,1
5448,85725,BoBgrmtQAbGEQdCkYjgMVVWzk508tw3x,3VkHkmOtom3jM2wCu94xgzzu1d6Dn7or,6,6,2,0,1,0,6,0,15,2.142857142857143,2,0.0,0,2,0,1,6,0,0,6,0,3,12,1
5449,85771,ERP6G5WJvBncmE1hQQFmpkycPMeQlLLQ,3VkHkmOtom3jM2wCu94xgzzu1d6Dn7or,9,25,6,0,1,0,1,0,33,4.714285714285714,2,0.0,4,6,0,1,21,0,0,1,0,11,22,1
5450,85797,czTQ5ELSy91Dy79vk5MgxZdL9nunJtpb,3VkHkmOtom3jM2wCu94xgzzu1d6Dn7or,7,3,2,0,2,0,2,0,9,1.2857142857142858,1,0.0,0,2,0,2,3,0,0,2,0,4,5,1
5451,85803,faJFxRjbG3m0AKbC0jLaQQtHVrZKqY1T,3VkHkmOtom3jM2wCu94xgzzu1d6Dn7or,9,11,3,0,1,1,10,1,27,3.857142857142857,2,0.0,0,3,0,1,11,1,0,10,1,4,23,1
5452,85841,OseLd0Vj4CawbZPfZRznLZH5tivxQP68,3VkHkmOtom3jM2wCu94xgzzu1d6Dn7or,73,142,45,69,57,17,26,0,356,50.857142857142854,7,0.0,87,45,67,57,55,17,2,26,0,256,100,1
5453,85842,DUwLHTMFGuVhHLSIqqTRgNrS08sj8j6i,3VkHkmOtom3jM2wCu94xgzzu1d6Dn7or,4,2,1,0,1,0,1,0,5,0.7142857142857143,1,0.0,0,1,0,1,2,0,0,1,0,2,3,1
5454,85851,b68WYpnuysSLqA5Vm5enorAzeKGwIhPy,3VkHkmOtom3jM2wCu94xgzzu1d6Dn7or,1,0,0,0,0,0,2,0,2,0.2857142857142857,1,0.0,0,0,0,0,0,0,0,2,0,0,2,1
5455,85866,v6veVItEgEaf6Hh5YgNhwea7AkkCZ3c0,3VkHkmOtom3jM2wCu94xgzzu1d6Dn7or,63,136,70,31,70,7,25,1,340,48.57142857142857,6,0.0,50,70,30,70,86,7,1,25,1,220,120,0
5456,85907,jok4tEcrobop66tG3KCeJGDlYMQJ4GbL,3VkHkmOtom3jM2wCu94xgzzu1d6Dn7or,77,341,144,67,61,52,82,12,759,108.42857142857143,6,0.0,92,144,65,61,249,52,2,82,12,362,397,0
5457,85983,h7aZWiIcJuKod0GVc86EbGw4w7dN7JZl,3VkHkmOtom3jM2wCu94xgzzu1d6Dn7or,81,172,77,75,58,39,30,0,451,64.42857142857143,7,0.0,48,77,71,58,124,39,4,30,0,254,197,0
5458,86000,6adUsSvPO0BlKLyJ63pGCXpdZbbHOrC1,3VkHkmOtom3jM2wCu94xgzzu1d6Dn7or,10,8,5,3,4,0,4,0,24,3.4285714285714284,1,0.0,2,5,3,4,6,0,0,4,0,14,10,1
5459,86001,lknoqUhBqHjCx4po6r83dmNbz1dDMFhy,3VkHkmOtom3jM2wCu94xgzzu1d6Dn7or,1,0,0,0,0,0,1,0,1,0.14285714285714285,1,0.0,0,0,0,0,0,0,0,1,0,0,1,1
5460,86071,gllevogZGS6BRVDfGGJAldsUWX4xD39r,3VkHkmOtom3jM2wCu94xgzzu1d6Dn7or,1,0,0,0,0,0,1,0,1,0.14285714285714285,1,0.0,0,0,0,0,0,0,0,1,0,0,1,1
5461,86072,6ILYZgVB75HEQ9IFubRRV6u9m1Wcar71,3VkHkmOtom3jM2wCu94xgzzu1d6Dn7or,61,141,47,28,52,37,18,0,323,46.142857142857146,4,0.0,81,47,28,52,60,37,0,18,0,208,115,0
5462,86161,NAYVxjfg7mDZERSfcIfXqiHe5xujNWKz,3VkHkmOtom3jM2wCu94xgzzu1d6Dn7or,2,0,0,0,0,0,3,0,3,0.42857142857142855,1,0.0,0,0,0,0,0,0,0,3,0,0,3,1
5463,86175,kIHsbVR2zzTV3NvaO60gT9C5s18p0XxQ,3VkHkmOtom3jM2wCu94xgzzu1d6Dn7or,25,50,15,26,12,5,9,1,118,16.857142857142858,3,0.0,29,15,21,12,21,5,5,9,1,77,41,0
5464,86178,ICgtAgsydFOa1v88S9dTTLF0BoT0U5Hb,3VkHkmOtom3jM2wCu94xgzzu1d6Dn7or,6,4,1,0,1,0,2,0,8,1.1428571428571428,1,0.0,0,1,0,1,4,0,0,2,0,2,6,1
5465,86208,e1CSwKLgflGiW7QjzYRNEoHjbDEH3F2k,3VkHkmOtom3jM2wCu94xgzzu1d6Dn7or,24,96,4,26,3,7,34,4,174,24.857142857142858,8,0.0,32,4,22,3,64,7,4,34,4,61,113,1
5466,86214,s7rVFkyi6fy4qwqR0x4tgXjSSF6e0Q4g,3VkHkmOtom3jM2wCu94xgzzu1d6Dn7or,16,37,17,5,4,10,20,3,96,13.714285714285714,3,0.0,15,17,5,4,22,10,0,20,3,41,55,0
5467,86257,8f874eWGU5uAHPVWKUx2IReY71ci0kSY,3VkHkmOtom3jM2wCu94xgzzu1d6Dn7or,77,106,52,29,50,1,67,1,306,43.714285714285715,7,0.0,41,52,27,50,65,1,2,67,1,170,136,1
5468,86274,nV86nhQ7hJG7k83qAXvGwRzPT357EJhH,3VkHkmOtom3jM2wCu94xgzzu1d6Dn7or,56,189,66,60,44,14,44,0,417,59.57142857142857,6,0.0,66,66,54,44,123,14,6,44,0,230,187,0
5469,86275,K45ayRpIahZNLgwlcA2lzf9ElmD1cHqp,3VkHkmOtom3jM2wCu94xgzzu1d6Dn7or,10,14,5,3,0,2,5,6,35,5.0,1,0.0,7,5,3,0,7,2,0,5,6,15,20,1
5470,86277,3Fotn6vrZOyU7qEVGnoWfR5Qb28bVPZe,3VkHkmOtom3jM2wCu94xgzzu1d6Dn7or,1,0,0,0,0,0,1,0,1,0.14285714285714285,1,0.0,0,0,0,0,0,0,0,1,0,0,1,1
5471,86280,BizeImMesg1cizlB4zGQZqXbEQSVssmW,3VkHkmOtom3jM2wCu94xgzzu1d6Dn7or,1,0,0,0,0,0,1,0,1,0.14285714285714285,1,0.0,0,0,0,0,0,0,0,1,0,0,1,1
5472,86289,d8M5e4LzHCw29UNYn0tf3jr08TdTpDqU,3VkHkmOtom3jM2wCu94xgzzu1d6Dn7or,1,0,0,0,0,0,1,0,1,0.14285714285714285,1,0.0,0,0,0,0,0,0,0,1,0,0,1,1
5473,86314,hQH8EkY3K9ePEt9jn5ZdKTUudKlRBEnW,3VkHkmOtom3jM2wCu94xgzzu1d6Dn7or,6,5,3,0,2,0,4,0,14,2.0,2,0.0,0,3,0,2,5,0,0,4,0,5,9,1
5474,86377,ar22m4gM6bnNUa1aRM8rqTyJBhSPOBmI,3VkHkmOtom3jM2wCu94xgzzu1d6Dn7or,1,0,0,0,0,0,1,0,1,0.14285714285714285,1,0.0,0,0,0,0,0,0,0,1,0,0,1,0
5475,86381,0SAR9K4qvrSxIkdUOEshHCbisvDXgZs2,3VkHkmOtom3jM2wCu94xgzzu1d6Dn7or,1,0,0,0,0,0,1,0,1,0.14285714285714285,1,0.0,0,0,0,0,0,0,0,1,0,0,1,1
5476,86421,OdiJ027MTGMvZv0Jx8RFUqLQVSPKf0Le,3VkHkmOtom3jM2wCu94xgzzu1d6Dn7or,8,4,2,0,1,1,8,9,25,3.5714285714285716,3,0.0,0,2,0,1,4,1,0,8,9,3,22,1
5477,86439,Y2qzAhcfhmjKefh7VXw2kUO8oGjJyTVE,3VkHkmOtom3jM2wCu94xgzzu1d6Dn7or,11,32,8,4,9,3,12,0,68,9.714285714285714,5,0.0,15,8,3,9,17,3,1,12,0,35,33,1
5478,86533,1wIqcRX58Bpw6RXvGnbxsc6WbPwWGwXd,3VkHkmOtom3jM2wCu94xgzzu1d6Dn7or,92,196,53,34,78,5,26,0,392,56.0,15,0.0,59,53,31,78,137,5,3,26,0,221,171,0
5479,86536,khFWmwKbSLPoLe6xXaOUDOgKsUHYgYeC,3VkHkmOtom3jM2wCu94xgzzu1d6Dn7or,1,0,0,0,0,0,1,0,1,0.14285714285714285,1,0.0,0,0,0,0,0,0,0,1,0,0,1,1
5480,86560,PdxQByxMVopEGTgWt3myeTqPxaRPOrC2,3VkHkmOtom3jM2wCu94xgzzu1d6Dn7or,1,0,0,0,0,0,1,0,1,0.14285714285714285,1,0.0,0,0,0,0,0,0,0,1,0,0,1,1
5481,86592,iNNgCVjnPK0MGKfhlyKj8GoKOMB3W92D,3VkHkmOtom3jM2wCu94xgzzu1d6Dn7or,9,17,2,0,1,1,18,0,39,5.571428571428571,2,0.0,0,2,0,1,17,1,0,18,0,3,36,1
5482,86632,9th1hmunGluj6xZwTGdArB7lPjYPdBbw,3VkHkmOtom3jM2wCu94xgzzu1d6Dn7or,1,0,0,0,0,0,1,0,1,0.14285714285714285,1,0.0,0,0,0,0,0,0,0,1,0,0,1,1
5483,86721,8ILIGGcVTYtJEfEunOA8rlDpD5ITYFNe,3VkHkmOtom3jM2wCu94xgzzu1d6Dn7or,1,0,0,0,0,0,1,0,1,0.14285714285714285,1,0.0,0,0,0,0,0,0,0,1,0,0,1,1
5484,86743,LAV9DZTNpMBa9H7I7DG73I6hrxa0pr3u,3VkHkmOtom3jM2wCu94xgzzu1d6Dn7or,1,0,0,0,0,0,1,0,1,0.14285714285714285,1,0.0,0,0,0,0,0,0,0,1,0,0,1,1
5485,86748,Td8yAwGedsXCvCUvnm0K0TUjk4jXKQt7,3VkHkmOtom3jM2wCu94xgzzu1d6Dn7or,12,23,11,0,9,1,6,0,50,7.142857142857143,2,0.0,6,11,0,9,17,1,0,6,0,26,24,1
5486,86780,oxSbsSgTvgSmA84yFpVeknvhMfpBwdbY,3VkHkmOtom3jM2wCu94xgzzu1d6Dn7or,8,3,2,0,2,0,3,0,10,1.4285714285714286,1,0.0,0,2,0,2,3,0,0,3,0,4,6,0
5487,86855,Ybc642CAm4ubx0xh2F3kNoipp1rEZVzf,3VkHkmOtom3jM2wCu94xgzzu1d6Dn7or,82,191,73,64,69,13,76,3,489,69.85714285714286,15,0.0,92,73,56,69,99,13,8,76,3,290,199,0
5488,86883,Sx6n1bCVIgjBIjUp9Ql4sJc8bEjCGIru,3VkHkmOtom3jM2wCu94xgzzu1d6Dn7or,1,0,0,0,0,0,1,0,1,0.14285714285714285,1,0.0,0,0,0,0,0,0,0,1,0,0,1,1
5489,86909,ycaMgSRQQHtDR1yAvQMlax8o3WWq0O3E,SpATywNh6bZuzm8s1ceuBUnMUAeoAHHw,1,0,0,0,0,0,1,0,1,0.14285714285714285,1,0.0,0,0,0,0,0,0,0,1,0,0,1,1
5490,86912,GfqCozSB56b335uZLl5d2syEloMgMtnE,SpATywNh6bZuzm8s1ceuBUnMUAeoAHHw,24,19,8,50,2,4,10,3,96,13.714285714285714,2,0.0,10,8,42,2,9,4,8,10,3,62,34,0
5491,86916,m9APg30xFaPG98uje3arCJfO5W7zr48c,SpATywNh6bZuzm8s1ceuBUnMUAeoAHHw,1,0,0,0,0,0,1,0,1,0.14285714285714285,1,0.0,0,0,0,0,0,0,0,1,0,0,1,1
5492,86938,rJCRtFYOHadlaWolNt4hiGuOfo8UHBBK,SpATywNh6bZuzm8s1ceuBUnMUAeoAHHw,15,17,8,10,3,0,3,0,41,5.857142857142857,2,0.0,6,8,9,3,11,0,1,3,0,26,15,0
5493,86946,Hvvqp2eQBSWvPQ5p71AaLCkYMkKlVnyN,bWdj2GDclj5ofokWjzoa5jAwMkxCykd6,2,0,0,0,0,0,2,0,2,0.2857142857142857,1,0.0,0,0,0,0,0,0,0,2,0,0,2,1
5494,86951,NWtZfqa5QvMpR8YctnU5Z1G2Mmylu7kF,SpATywNh6bZuzm8s1ceuBUnMUAeoAHHw,1,0,0,0,0,0,2,0,2,0.2857142857142857,1,0.0,0,0,0,0,0,0,0,2,0,0,2,1
5495,86952,OLnlSTOFzG1JYJiPdt4pQRjvFCClSHXl,SpATywNh6bZuzm8s1ceuBUnMUAeoAHHw,6,3,2,0,2,0,1,0,8,1.1428571428571428,2,0.0,0,2,0,2,3,0,0,1,0,4,4,1
5496,86961,f1hGx4vBaHIhL4S79qCy99PHQb78Q3Jf,SpATywNh6bZuzm8s1ceuBUnMUAeoAHHw,5,3,1,0,1,0,2,0,7,1.0,1,0.0,0,1,0,1,3,0,0,2,0,2,5,1
5497,86964,Cq4KSaVkbqHlLqdj1lV0UpERxxxKCyTj,bWdj2GDclj5ofokWjzoa5jAwMkxCykd6,8,3,1,0,1,0,4,1,10,1.4285714285714286,1,0.0,0,1,0,1,3,0,0,4,1,2,8,1
5498,86967,Pvua5hyrKdigZ1ycnO5tmP70GOQQDJjD,RXDvfPUBYFlVdlueBFbLW0mhhAyGEqpt,1,0,0,0,0,0,1,0,1,0.14285714285714285,1,0.0,0,0,0,0,0,0,0,1,0,0,1,1
5499,86974,HB5xN5WvO63fyle8L9OU8KEV5tvW4m0R,SpATywNh6bZuzm8s1ceuBUnMUAeoAHHw,19,12,8,16,5,3,3,0,47,6.714285714285714,2,0.0,2,8,13,5,10,3,3,3,0,28,19,0
5500,86982,sFhXWcZp0e3ojXF41wch1LYksD6BUqWx,SpATywNh6bZuzm8s1ceuBUnMUAeoAHHw,1,0,0,0,0,0,1,0,1,0.14285714285714285,1,0.0,0,0,0,0,0,0,0,1,0,0,1,1
5501,86988,twX4iqCXJtIrZfq1eQVcNh6usPgVLduz,SpATywNh6bZuzm8s1ceuBUnMUAeoAHHw,3,0,0,0,0,0,3,0,3,0.42857142857142855,1,0.0,0,0,0,0,0,0,0,3,0,0,3,1
5502,87042,HaDSWhgDk0wGnojLCgKlWqrHGEOcf3UV,SpATywNh6bZuzm8s1ceuBUnMUAeoAHHw,13,19,6,12,3,0,2,0,42,6.0,2,0.0,9,6,11,3,10,0,1,2,0,29,13,1
5503,87049,1BQpAvqrBw6EmiaIW2MwJ2rv4x4Q2s0V,SpATywNh6bZuzm8s1ceuBUnMUAeoAHHw,3,2,1,0,0,0,1,0,4,0.5714285714285714,1,0.0,0,1,0,0,2,0,0,1,0,1,3,0
5504,87067,z0wmch2gP3COsvtcVA5iWOXrgdxULy0U,SpATywNh6bZuzm8s1ceuBUnMUAeoAHHw,2,0,0,0,0,0,2,0,2,0.2857142857142857,1,0.0,0,0,0,0,0,0,0,2,0,0,2,1
5505,87073,HgrresBBExzRiMszeaiNvsDe9DkhU6l5,SpATywNh6bZuzm8s1ceuBUnMUAeoAHHw,35,46,19,40,7,7,12,1,132,18.857142857142858,2,0.0,11,19,38,7,35,7,2,12,1,75,57,0
5506,87080,Cg300wnMUZ9cUKiSAxwMV9QGJuKTVrUS,SpATywNh6bZuzm8s1ceuBUnMUAeoAHHw,8,8,3,0,2,2,6,1,22,3.142857142857143,1,0.0,1,3,0,2,7,2,0,6,1,6,16,1
5507,87087,ycZcyaRZkRmTmfTyJcaxWvg5l6N3L4CN,SpATywNh6bZuzm8s1ceuBUnMUAeoAHHw,8,7,2,0,0,1,6,1,17,2.4285714285714284,2,0.0,0,2,0,0,7,1,0,6,1,2,15,1
5508,87091,hWJT9cmy3MgW1Ixs5CKqFb4FYhTmELi3,bWdj2GDclj5ofokWjzoa5jAwMkxCykd6,7,4,1,0,1,0,2,0,8,1.1428571428571428,1,0.0,0,1,0,1,4,0,0,2,0,2,6,1
5509,87097,oXrdtiVWJwaWgRFbUXGT1kyEHfFOVjoz,SpATywNh6bZuzm8s1ceuBUnMUAeoAHHw,3,2,0,0,0,0,3,0,5,0.7142857142857143,1,0.0,0,0,0,0,2,0,0,3,0,0,5,1
5510,87106,QUf1ZaSO2gcebvjw5vbR7zGsBmfjKCCs,SpATywNh6bZuzm8s1ceuBUnMUAeoAHHw,9,11,0,0,1,0,2,0,14,2.0,1,0.0,0,0,0,1,11,0,0,2,0,1,13,1
5511,87108,JawriHlY57Ms9asBj5jDP1bA53V2QKjp,5X6FeZozNMgE2VRi3MJYjkkFK8SETtu2,4,3,2,0,2,0,1,0,8,1.1428571428571428,1,0.0,0,2,0,2,3,0,0,1,0,4,4,1
5512,87109,xSRvBNCdhLUrfFyYzicxsnRRkZUYQ9tk,SpATywNh6bZuzm8s1ceuBUnMUAeoAHHw,6,5,0,0,0,0,1,0,6,0.8571428571428571,1,0.0,0,0,0,0,5,0,0,1,0,0,6,1
5513,87110,ePw9vYcz9FHVQfH5E6368oyaxAZ1fT5C,SpATywNh6bZuzm8s1ceuBUnMUAeoAHHw,5,2,1,0,1,0,2,0,6,0.8571428571428571,1,0.0,0,1,0,1,2,0,0,2,0,2,4,1
5514,87119,HW81M2taDDpjfIALyR6RGLxMn7Z51s6I,G8EPVSXsOYB5YQWZGiz1aVq5Pgr2GrQu,6,3,1,0,1,0,2,0,7,1.0,1,0.0,0,1,0,1,3,0,0,2,0,2,5,0
5515,87120,Kpr6ISdqohTmchfzbxziZ98TNPreGKVa,SpATywNh6bZuzm8s1ceuBUnMUAeoAHHw,8,7,5,0,2,0,3,0,17,2.4285714285714284,1,0.0,0,5,0,2,7,0,0,3,0,7,10,1
5516,87122,NFGYUC7dcOkWJh2BiZLJheVSucAvXvpt,A3fsA9Zfv1X2fVEQhTw51lKENdNrEqT3,3,2,0,0,0,0,1,0,3,0.42857142857142855,1,0.0,0,0,0,0,2,0,0,1,0,0,3,1
5517,87147,PHBho9Sc0XQZt8wGEuns5tbDU5eoHa8g,A3fsA9Zfv1X2fVEQhTw51lKENdNrEqT3,10,9,1,0,1,0,7,0,18,2.5714285714285716,3,0.0,2,1,0,1,7,0,0,7,0,4,14,0
5518,87148,gSM3dmsvbnknlOwHg7J6Fy5cRwQWWs6l,SpATywNh6bZuzm8s1ceuBUnMUAeoAHHw,5,2,1,0,1,0,2,0,6,0.8571428571428571,1,0.0,0,1,0,1,2,0,0,2,0,2,4,1
5519,87150,NA5Ew6dRh4PhyiB8DSC6tgsWgUAy9AJv,bWdj2GDclj5ofokWjzoa5jAwMkxCykd6,1,0,0,0,0,0,1,0,1,0.14285714285714285,1,0.0,0,0,0,0,0,0,0,1,0,0,1,1
5520,87155,Qn3OccgDXQpcut9yLA9jXfau6FPbS72n,5X6FeZozNMgE2VRi3MJYjkkFK8SETtu2,1,0,0,0,0,0,2,0,2,0.2857142857142857,2,0.0,0,0,0,0,0,0,0,2,0,0,2,1
5521,87162,RgxmGDfKcBuOKimrAda6q6r1m3kTwJWg,SpATywNh6bZuzm8s1ceuBUnMUAeoAHHw,4,6,0,0,0,0,3,0,9,1.2857142857142858,1,0.0,0,0,0,0,6,0,0,3,0,0,9,1
5522,87169,BYoagvhtaQZvEdBOdm0fSGLXeMikTNAf,SpATywNh6bZuzm8s1ceuBUnMUAeoAHHw,6,4,1,0,1,0,1,0,7,1.0,1,0.0,0,1,0,1,4,0,0,1,0,2,5,1
5523,87187,BPhS68WnBhNHxaKVrJj2k4cMtvSG9MHx,SpATywNh6bZuzm8s1ceuBUnMUAeoAHHw,1,0,0,0,0,0,1,0,1,0.14285714285714285,1,0.0,0,0,0,0,0,0,0,1,0,0,1,1
5524,87190,rs3WOUQ4PSHbNxyhVeLlE6lgdYqGPTef,SpATywNh6bZuzm8s1ceuBUnMUAeoAHHw,6,4,1,0,1,0,3,0,9,1.2857142857142858,1,0.0,0,1,0,1,4,0,0,3,0,2,7,1
5525,87193,BPhS68WnBhNHxaKVrJj2k4cMtvSG9MHx,5X6FeZozNMgE2VRi3MJYjkkFK8SETtu2,1,0,0,0,0,0,1,0,1,0.14285714285714285,1,0.0,0,0,0,0,0,0,0,1,0,0,1,1
5526,87195,BPhS68WnBhNHxaKVrJj2k4cMtvSG9MHx,G8EPVSXsOYB5YQWZGiz1aVq5Pgr2GrQu,1,0,0,0,0,0,1,0,1,0.14285714285714285,1,0.0,0,0,0,0,0,0,0,1,0,0,1,1
5527,87196,BPhS68WnBhNHxaKVrJj2k4cMtvSG9MHx,RXDvfPUBYFlVdlueBFbLW0mhhAyGEqpt,1,0,0,0,0,0,1,0,1,0.14285714285714285,1,0.0,0,0,0,0,0,0,0,1,0,0,1,1
5528,87199,hO4ixki4cn72f2HXil7H5yfXyIpxdfFl,SpATywNh6bZuzm8s1ceuBUnMUAeoAHHw,5,1,1,0,1,0,2,0,5,0.7142857142857143,1,0.0,0,1,0,1,1,0,0,2,0,2,3,0
5529,87209,1YNi2L12jzZ2lTbHZxOoSAJwmZIzVTSP,SpATywNh6bZuzm8s1ceuBUnMUAeoAHHw,6,2,1,0,1,4,4,0,12,1.7142857142857142,1,0.0,0,1,0,1,2,4,0,4,0,2,10,1
5530,87228,7GGviL1oS0U6CdSXgIhlT1cgPoomop6m,SpATywNh6bZuzm8s1ceuBUnMUAeoAHHw,27,19,12,25,8,0,2,0,66,9.428571428571429,1,0.0,4,12,19,8,15,0,6,2,0,43,23,1
5531,87253,sIlNQ89buPUrQbLfzMqM8ZfxnB8BXILp,SpATywNh6bZuzm8s1ceuBUnMUAeoAHHw,6,21,3,0,0,1,9,0,34,4.857142857142857,1,0.0,0,3,0,0,21,1,0,9,0,3,31,1
5532,87258,d1MkRkjya7ojtBlNRk0Ce9ymSIOXU3g7,G8EPVSXsOYB5YQWZGiz1aVq5Pgr2GrQu,1,0,0,0,0,0,1,0,1,0.14285714285714285,1,0.0,0,0,0,0,0,0,0,1,0,0,1,1
5533,87305,cpJrmEUlEL8EDk9AnTJk0fcLeBecnjUz,SpATywNh6bZuzm8s1ceuBUnMUAeoAHHw,5,2,1,0,1,0,2,0,6,0.8571428571428571,1,0.0,0,1,0,1,2,0,0,2,0,2,4,1
5534,87312,4xeLGa5DZRC3bFnuJocw2mMFvfOIivjJ,5X6FeZozNMgE2VRi3MJYjkkFK8SETtu2,2,0,0,0,0,0,2,0,2,0.2857142857142857,1,0.0,0,0,0,0,0,0,0,2,0,0,2,1
5535,87338,Mkzdfm5qkl8qxjNMCVluXUDpdsWNCaHt,SpATywNh6bZuzm8s1ceuBUnMUAeoAHHw,2,0,0,0,0,0,2,0,2,0.2857142857142857,1,0.0,0,0,0,0,0,0,0,2,0,0,2,1
5536,87359,q9ZOahsMglbfxvCwKEpt3AMimCuNhfDY,SpATywNh6bZuzm8s1ceuBUnMUAeoAHHw,7,4,0,0,0,1,7,0,12,1.7142857142857142,1,0.0,0,0,0,0,4,1,0,7,0,0,12,1
5537,87377,qZiJyWjzRGeOBeYRlPJKAXcx37BTtgsI,SpATywNh6bZuzm8s1ceuBUnMUAeoAHHw,7,3,2,0,2,0,2,0,9,1.2857142857142858,1,0.0,0,2,0,2,3,0,0,2,0,4,5,1
5538,87382,YcJ85FZw8rSIHoL8wnrNTEWCJdpKSrze,SpATywNh6bZuzm8s1ceuBUnMUAeoAHHw,1,0,0,0,0,0,1,0,1,0.14285714285714285,1,0.0,0,0,0,0,0,0,0,1,0,0,1,0
5539,87386,o4I4EkmQ48q5biBoHPFY4faNuV3hDMKw,SpATywNh6bZuzm8s1ceuBUnMUAeoAHHw,7,6,3,0,1,0,4,0,14,2.0,2,0.0,0,3,0,1,6,0,0,4,0,4,10,1
5540,87432,jnldJK9jDRdn3Q2rpqpfrVQIfaYWFHYt,SpATywNh6bZuzm8s1ceuBUnMUAeoAHHw,1,0,0,0,0,0,1,0,1,0.14285714285714285,1,0.0,0,0,0,0,0,0,0,1,0,0,1,1
5541,87447,QflUMQYqgKuyQPnCteHvz3LqhJ9AwCga,RXDvfPUBYFlVdlueBFbLW0mhhAyGEqpt,14,20,16,0,8,0,3,0,47,6.714285714285714,1,0.0,2,16,0,8,18,0,0,3,0,26,21,1
5542,87520,pqsPOTJhOrzp1CuSM0L3m4JXPVXPbkqe,SpATywNh6bZuzm8s1ceuBUnMUAeoAHHw,3,2,1,0,0,0,1,0,4,0.5714285714285714,1,0.0,0,1,0,0,2,0,0,1,0,1,3,1
5543,87544,HF98YPKzT8oi2j9flZW9kstZcvL3ZimG,SpATywNh6bZuzm8s1ceuBUnMUAeoAHHw,16,17,7,13,4,0,1,0,42,6.0,1,0.0,4,7,10,4,13,0,3,1,0,25,17,0
5544,87552,VfEelXsd4Sgrcy5E8mk405V2S0XUGtSK,A3fsA9Zfv1X2fVEQhTw51lKENdNrEqT3,6,5,2,0,0,0,7,0,14,2.0,2,0.0,0,2,0,0,5,0,0,7,0,2,12,1
5545,87563,mLnrkBxCMzHzCOgxlcePLHngsSsyrmY0,SpATywNh6bZuzm8s1ceuBUnMUAeoAHHw,11,23,4,0,1,6,20,3,57,8.142857142857142,3,0.0,0,4,0,1,23,6,0,20,3,5,52,0
5546,87569,q1J333rPyzRXtliUpf4POE9QAtj3sr8G,SpATywNh6bZuzm8s1ceuBUnMUAeoAHHw,1,0,0,0,0,0,1,0,1,0.14285714285714285,1,0.0,0,0,0,0,0,0,0,1,0,0,1,1
5547,87588,jNRA434lMAMZjPiQhPmaP5pXlW3ni5X9,5X6FeZozNMgE2VRi3MJYjkkFK8SETtu2,1,0,0,0,0,0,1,0,1,0.14285714285714285,1,0.0,0,0,0,0,0,0,0,1,0,0,1,1
5548,87600,oNGBL76nG6RSI4sSbcZeTjUXGVOoaIIG,RXDvfPUBYFlVdlueBFbLW0mhhAyGEqpt,12,10,8,0,4,0,4,0,26,3.7142857142857144,1,0.0,0,8,0,4,10,0,0,4,0,12,14,1
5549,87607,Y1N757YBcw2pa0f5R2cGYXkdHdVAg7lL,RXDvfPUBYFlVdlueBFbLW0mhhAyGEqpt,14,15,8,0,6,0,1,0,30,4.285714285714286,1,0.0,0,8,0,6,15,0,0,1,0,14,16,1
5550,87645,or5tGmwIQtkxzns3Abayo6pKJnoHWcAG,A3fsA9Zfv1X2fVEQhTw51lKENdNrEqT3,5,3,2,0,1,0,2,0,8,1.1428571428571428,1,0.0,0,2,0,1,3,0,0,2,0,3,5,1
5551,87646,yjHdMjg2Y9TVm5pa02baGNmbc897dEB6,bWdj2GDclj5ofokWjzoa5jAwMkxCykd6,2,0,0,0,0,0,2,0,2,0.2857142857142857,1,0.0,0,0,0,0,0,0,0,2,0,0,2,1
5552,87648,8jZuG0IqleAjOhpsiirCEfBUN87kcxp8,SpATywNh6bZuzm8s1ceuBUnMUAeoAHHw,11,10,2,0,2,0,4,0,18,2.5714285714285716,2,0.0,0,2,0,2,10,0,0,4,0,4,14,1
5553,87649,KCgqr6mS6kq5aoFQfmLbsIxQVUeF53Nr,SpATywNh6bZuzm8s1ceuBUnMUAeoAHHw,10,10,1,8,0,0,2,0,21,3.0,2,0.0,0,1,8,0,10,0,0,2,0,9,12,0
5554,87696,NDhFf7OjltsbVAydOdtaLNasif6YENxb,G8EPVSXsOYB5YQWZGiz1aVq5Pgr2GrQu,11,14,2,0,1,0,4,0,21,3.0,2,0.0,2,2,0,1,12,0,0,4,0,5,16,1
5555,87697,IHheokBZBTn69jMtC3noFZ77MtM0MaWY,bWdj2GDclj5ofokWjzoa5jAwMkxCykd6,8,1,1,0,1,0,11,1,15,2.142857142857143,1,0.0,0,1,0,1,1,0,0,11,1,2,13,1
5556,87709,MN8CvEqGMXYIHmPItRTjpnojpHW8H7Wg,SpATywNh6bZuzm8s1ceuBUnMUAeoAHHw,50,65,33,68,17,1,13,1,198,28.285714285714285,6,0.0,22,33,61,17,43,1,7,13,1,133,65,0
5557,87732,L1FTG9TM6RI5TBCTexQgshQhXhu2oZpJ,RXDvfPUBYFlVdlueBFbLW0mhhAyGEqpt,26,20,12,24,9,0,2,0,67,9.571428571428571,1,0.0,7,12,22,9,13,0,2,2,0,50,17,1
5558,87733,bwOsVB833e5tHrwHSqmXCzs0EZClNPpv,bWdj2GDclj5ofokWjzoa5jAwMkxCykd6,5,5,2,0,2,0,1,0,10,1.4285714285714286,1,0.0,2,2,0,2,3,0,0,1,0,6,4,1
5559,87759,kbnbUyJ6SeYN8u39lgEBCBnZvcNekMlk,bWdj2GDclj5ofokWjzoa5jAwMkxCykd6,6,5,2,0,0,0,4,0,11,1.5714285714285714,1,0.0,0,2,0,0,5,0,0,4,0,2,9,1
5560,87770,yk3MmJnG3pWrtg68UCUE7BF7gkkb0Yf0,5X6FeZozNMgE2VRi3MJYjkkFK8SETtu2,5,5,2,0,0,0,2,0,9,1.2857142857142858,1,0.0,0,2,0,0,5,0,0,2,0,2,7,1
5561,87798,1ahaNbr5YZ3IpOgQelHrM05Cdnz4LKNQ,SpATywNh6bZuzm8s1ceuBUnMUAeoAHHw,16,8,7,13,4,0,1,0,33,4.714285714285714,1,0.0,0,7,12,4,8,0,1,1,0,23,10,0
5562,87820,mXagdU9ktYcsigsUp2GL9G4BfC4p8esK,RXDvfPUBYFlVdlueBFbLW0mhhAyGEqpt,26,41,8,31,3,19,17,4,123,17.571428571428573,2,0.0,11,8,27,3,30,19,4,17,4,49,74,0
5563,87821,1fleh7lPd7aghMITlPRITTq0TKiljgoj,bWdj2GDclj5ofokWjzoa5jAwMkxCykd6,6,2,0,0,0,0,5,0,7,1.0,1,0.0,0,0,0,0,2,0,0,5,0,0,7,1
5564,87826,yGll7cBEK4l513wg08W8WjrXiINZSUwd,SpATywNh6bZuzm8s1ceuBUnMUAeoAHHw,1,0,0,0,0,0,1,0,1,0.14285714285714285,1,0.0,0,0,0,0,0,0,0,1,0,0,1,1
5565,87838,ROBPgs59OGqWvnQJzICs4ISllL7P1b8A,SpATywNh6bZuzm8s1ceuBUnMUAeoAHHw,8,5,3,0,2,0,2,0,12,1.7142857142857142,1,0.0,0,3,0,2,5,0,0,2,0,5,7,0
5566,87864,nWedGV2Cyz7b86zoWjyUJZtraXV6YlYz,SpATywNh6bZuzm8s1ceuBUnMUAeoAHHw,8,16,3,0,1,0,4,0,24,3.4285714285714284,1,0.0,0,3,0,1,16,0,0,4,0,4,20,0
5567,87893,31GQcXjkfbx5hDfwBCiiTLmmlCr7ombE,SpATywNh6bZuzm8s1ceuBUnMUAeoAHHw,2,0,0,0,0,0,3,0,3,0.42857142857142855,1,0.0,0,0,0,0,0,0,0,3,0,0,3,1
5568,87899,hWHQ5t1aaxWeNJstlGoFcPp5rXeKd7fT,SpATywNh6bZuzm8s1ceuBUnMUAeoAHHw,32,51,3,44,1,0,4,0,103,14.714285714285714,2,0.0,10,3,40,1,41,0,4,4,0,54,49,1
5569,87919,NtuSsCWxiM5cZ0UalS4e7aFbcsYH60Br,bWdj2GDclj5ofokWjzoa5jAwMkxCykd6,5,6,1,0,1,0,1,0,9,1.2857142857142858,1,0.0,3,1,0,1,3,0,0,1,0,5,4,0
5570,87920,1uj3lODORrX2PgjuF1fpWy9nhOirDGas,G8EPVSXsOYB5YQWZGiz1aVq5Pgr2GrQu,21,39,12,32,0,2,2,0,87,12.428571428571429,4,0.0,0,12,24,0,39,2,8,2,0,36,51,0
5571,87929,0LERVBlr0s6pvZPTHfS8Y74dmJWxJhcj,5X6FeZozNMgE2VRi3MJYjkkFK8SETtu2,7,5,3,0,2,0,2,0,12,1.7142857142857142,1,0.0,0,3,0,2,5,0,0,2,0,5,7,1
5572,87963,bershY3L5dsrOquW1lgM7Vxvmeies3St,SpATywNh6bZuzm8s1ceuBUnMUAeoAHHw,20,22,1,32,0,0,8,0,63,9.0,3,0.0,9,1,29,0,13,0,3,8,0,39,24,0
5573,87982,MQK4DgM2xSqvXiKh3zV47i5iY5mt4VPL,SpATywNh6bZuzm8s1ceuBUnMUAeoAHHw,27,29,15,19,7,0,2,0,72,10.285714285714286,2,0.0,12,15,19,7,17,0,0,2,0,53,19,1
5574,87987,Ffohn9JNnGJQD2IavzMTS00ubnVtcb2T,SpATywNh6bZuzm8s1ceuBUnMUAeoAHHw,31,24,12,19,8,0,3,0,66,9.428571428571429,2,0.0,4,12,16,8,20,0,3,3,0,40,26,0
5575,88003,0UfP07I2iwfwmlnUahvfksC7lbNr2lOS,5X6FeZozNMgE2VRi3MJYjkkFK8SETtu2,1,0,0,0,0,0,3,0,3,0.42857142857142855,1,0.0,0,0,0,0,0,0,0,3,0,0,3,1
5576,88006,OG4OaugByeIYTjBlsElVfc6WigiZJJly,SpATywNh6bZuzm8s1ceuBUnMUAeoAHHw,5,2,0,0,0,1,5,0,8,1.1428571428571428,1,0.0,0,0,0,0,2,1,0,5,0,0,8,1
5577,88028,yaibiUtZloczLej3tb9ay8a6wfWQy8SZ,SpATywNh6bZuzm8s1ceuBUnMUAeoAHHw,12,6,4,4,2,0,8,0,24,3.4285714285714284,1,0.0,1,4,3,2,5,0,1,8,0,10,14,1
5578,88029,bSaZ1hYnI1zX06sBhHjW0JtYDEAqEuPp,SpATywNh6bZuzm8s1ceuBUnMUAeoAHHw,20,23,0,7,0,0,8,0,38,5.428571428571429,3,0.0,2,0,7,0,21,0,0,8,0,9,29,0
5579,88033,DZjkP3yl2SFuyGy8c50KQgIUMnSURcDF,G8EPVSXsOYB5YQWZGiz1aVq5Pgr2GrQu,1,0,0,0,0,0,1,0,1,0.14285714285714285,1,0.0,0,0,0,0,0,0,0,1,0,0,1,1
5580,88039,pAIEYSSXdgXA2O8eKo5gs0U3YOaGGkK5,SpATywNh6bZuzm8s1ceuBUnMUAeoAHHw,11,6,5,0,4,0,2,0,17,2.4285714285714284,1,0.0,0,5,0,4,6,0,0,2,0,9,8,1
5581,88050,PehZ8w7lhwueNJQVLn4O4a5DjlM7RVHJ,RXDvfPUBYFlVdlueBFbLW0mhhAyGEqpt,6,10,3,0,1,0,3,0,17,2.4285714285714284,1,0.0,0,3,0,1,10,0,0,3,0,4,13,1
5582,88082,yiWok4eQ5hgdJ8eYi2O0qHhy67Y9EA3E,RXDvfPUBYFlVdlueBFbLW0mhhAyGEqpt,5,8,4,0,3,0,1,0,16,2.2857142857142856,1,0.0,0,4,0,3,8,0,0,1,0,7,9,1
5583,88095,dCAqk9uHiS99GMTcJQtThG8XWnwwbp5Q,bWdj2GDclj5ofokWjzoa5jAwMkxCykd6,1,0,0,0,0,0,1,0,1,0.14285714285714285,1,0.0,0,0,0,0,0,0,0,1,0,0,1,1
5584,88105,k7suxdbNozM9PSE6QAla7Jce4gizLApj,5X6FeZozNMgE2VRi3MJYjkkFK8SETtu2,7,3,2,0,2,0,3,0,10,1.4285714285714286,2,0.0,0,2,0,2,3,0,0,3,0,4,6,0
5585,88115,57QNpq0y9acG53aqB6y56Mpy1s4uWqKM,A3fsA9Zfv1X2fVEQhTw51lKENdNrEqT3,5,3,2,0,1,0,1,0,7,1.0,1,0.0,0,2,0,1,3,0,0,1,0,3,4,1
5586,88130,lIEujnO1A2cHxxwjhfcjojfSzxvYc5z2,5X6FeZozNMgE2VRi3MJYjkkFK8SETtu2,2,0,0,0,0,0,2,0,2,0.2857142857142857,1,0.0,0,0,0,0,0,0,0,2,0,0,2,1
5587,88136,Y51MqWhaiGyWdNickwBkKEZ7LC7se5uV,5X6FeZozNMgE2VRi3MJYjkkFK8SETtu2,8,6,2,0,2,0,6,0,16,2.2857142857142856,2,0.0,0,2,0,2,6,0,0,6,0,4,12,0
5588,88138,YWNeUmm3QHgPMigKCfanPsAWkQlT4aAZ,G8EPVSXsOYB5YQWZGiz1aVq5Pgr2GrQu,1,0,0,0,0,0,1,0,1,0.14285714285714285,1,0.0,0,0,0,0,0,0,0,1,0,0,1,1
5589,88139,dclBqf1EWh3Ih224SoyQN0nAKWGjQR6I,SpATywNh6bZuzm8s1ceuBUnMUAeoAHHw,5,6,1,0,1,0,1,0,9,1.2857142857142858,2,0.0,0,1,0,1,6,0,0,1,0,2,7,1
5590,88140,ci0TVQYsVR5jGo6uk57VSejmvHQzKbHq,SpATywNh6bZuzm8s1ceuBUnMUAeoAHHw,14,27,7,14,2,12,2,0,64,9.142857142857142,1,0.0,19,7,13,2,8,12,1,2,0,41,23,1
5591,88144,YWNeUmm3QHgPMigKCfanPsAWkQlT4aAZ,5X6FeZozNMgE2VRi3MJYjkkFK8SETtu2,1,0,0,0,0,0,1,0,1,0.14285714285714285,1,0.0,0,0,0,0,0,0,0,1,0,0,1,1
5592,88145,2UFvx2iVFdUre1OpcD3l0lOVdiHS8S46,SpATywNh6bZuzm8s1ceuBUnMUAeoAHHw,2,0,0,0,0,0,2,0,2,0.2857142857142857,1,0.0,0,0,0,0,0,0,0,2,0,0,2,1
5593,88158,fVHUMs4z7aTjXofyWNn8EBPM3SN6fL56,bWdj2GDclj5ofokWjzoa5jAwMkxCykd6,1,0,0,0,0,0,1,0,1,0.14285714285714285,1,0.0,0,0,0,0,0,0,0,1,0,0,1,1
5594,88164,nn7VGfd1qZ3DMYVVIcQxX76WYR0kOv43,SpATywNh6bZuzm8s1ceuBUnMUAeoAHHw,5,2,1,0,1,0,2,0,6,0.8571428571428571,1,0.0,0,1,0,1,2,0,0,2,0,2,4,1
5595,88184,IErGffEvIhM9v0ckpLiuRUGq95QUDuDa,SpATywNh6bZuzm8s1ceuBUnMUAeoAHHw,1,0,0,0,0,0,1,0,1,0.14285714285714285,1,0.0,0,0,0,0,0,0,0,1,0,0,1,1
5596,88194,mMAeDnJiyPEq1LUCLlMG9ChajUG4lE3B,SpATywNh6bZuzm8s1ceuBUnMUAeoAHHw,14,32,18,0,3,0,14,0,67,9.571428571428571,3,0.0,0,18,0,3,32,0,0,14,0,21,46,1
5597,88196,bnTfu9TwTvosy05oHRjElz0X7ljJOPeF,SpATywNh6bZuzm8s1ceuBUnMUAeoAHHw,7,9,3,0,1,7,3,6,29,4.142857142857143,3,0.0,0,3,0,1,9,7,0,3,6,4,25,1
5598,88209,d1MkRkjya7ojtBlNRk0Ce9ymSIOXU3g7,bWdj2GDclj5ofokWjzoa5jAwMkxCykd6,2,0,0,0,0,0,2,0,2,0.2857142857142857,1,0.0,0,0,0,0,0,0,0,2,0,0,2,1
5599,88219,UFtvGcavohZTrMuIVgrQAHawwTxcdSEE,SpATywNh6bZuzm8s1ceuBUnMUAeoAHHw,28,73,4,10,3,0,13,0,103,14.714285714285714,6,0.0,2,4,10,3,71,0,0,13,0,19,84,0
5600,88221,1at7EJNvpsF17iI0eH6hs4FnRP1Exa0A,RXDvfPUBYFlVdlueBFbLW0mhhAyGEqpt,10,6,4,0,2,0,7,1,20,2.857142857142857,1,0.0,0,4,0,2,6,0,0,7,1,6,14,1
5601,88225,pgpBUza0yx0g5FFeCmRZgahHcLAP1kjI,G8EPVSXsOYB5YQWZGiz1aVq5Pgr2GrQu,1,0,0,0,0,0,1,0,1,0.14285714285714285,1,0.0,0,0,0,0,0,0,0,1,0,0,1,1
5602,88226,yIkD9gy6hoeKl683npvdekS6rJ4gIOSl,5X6FeZozNMgE2VRi3MJYjkkFK8SETtu2,1,0,0,0,0,0,1,0,1,0.14285714285714285,1,0.0,0,0,0,0,0,0,0,1,0,0,1,1
5603,88255,qYM3FuP7P8shrtgZS3R28doqq6ra0j3L,SpATywNh6bZuzm8s1ceuBUnMUAeoAHHw,1,0,0,0,0,0,1,0,1,0.14285714285714285,1,0.0,0,0,0,0,0,0,0,1,0,0,1,1
5604,88263,tTcV8dGcndmFDYceHa4RNtiJpwqrpn9n,5X6FeZozNMgE2VRi3MJYjkkFK8SETtu2,2,0,0,0,0,0,2,0,2,0.2857142857142857,1,0.0,0,0,0,0,0,0,0,2,0,0,2,1
5605,88269,EkFuxvGcdz15iKWA0D48lolAWwrtU4QT,5X6FeZozNMgE2VRi3MJYjkkFK8SETtu2,17,69,2,15,6,0,4,0,96,13.714285714285714,1,0.0,56,2,13,6,13,0,2,4,0,77,19,1
5606,88281,cpRbfaNv5usLp7El18VnnTqxc7iB3VdC,5X6FeZozNMgE2VRi3MJYjkkFK8SETtu2,2,0,0,0,0,0,2,0,2,0.2857142857142857,1,0.0,0,0,0,0,0,0,0,2,0,0,2,1
5607,88357,nN0k7Wn4LOXQIDOTh4XnZiFtrnIJSCyz,5X6FeZozNMgE2VRi3MJYjkkFK8SETtu2,1,0,0,0,0,0,1,0,1,0.14285714285714285,1,0.0,0,0,0,0,0,0,0,1,0,0,1,1
5608,88423,NpspGwuGkPfDI3FL99baAIJnbXMQ702U,5X6FeZozNMgE2VRi3MJYjkkFK8SETtu2,20,20,2,15,7,3,7,1,55,7.857142857142857,1,0.0,13,2,14,7,7,3,1,7,1,36,19,1
5609,88449,j4yVX1564yXgamumis5bPSWiGDO3Zb8c,5X6FeZozNMgE2VRi3MJYjkkFK8SETtu2,1,0,0,0,0,0,1,0,1,0.14285714285714285,1,0.0,0,0,0,0,0,0,0,1,0,0,1,1
5610,88450,VqGcDRkyuJiEMgdAxi8G9cea98s9aNUc,5X6FeZozNMgE2VRi3MJYjkkFK8SETtu2,2,0,0,0,0,0,4,0,4,0.5714285714285714,1,0.0,0,0,0,0,0,0,0,4,0,0,4,1
5611,88472,riM9GkB0ajSqpIPlVq4tRzOjk7wJ6NHE,5X6FeZozNMgE2VRi3MJYjkkFK8SETtu2,9,16,12,0,2,0,5,0,35,5.0,2,0.0,1,12,0,2,15,0,0,5,0,15,20,1
5612,88473,XKAlDCh4DTZwS9HBSFDAaahKYs73ob53,5X6FeZozNMgE2VRi3MJYjkkFK8SETtu2,1,0,0,0,0,0,1,0,1,0.14285714285714285,1,0.0,0,0,0,0,0,0,0,1,0,0,1,1
5613,88485,N2FuIOQxHi4oGMJNbbYINfgS8eLaVkEY,5X6FeZozNMgE2VRi3MJYjkkFK8SETtu2,2,0,0,0,0,0,2,0,2,0.2857142857142857,1,0.0,0,0,0,0,0,0,0,2,0,0,2,1
5614,88543,dorUpp1ODfe9BqxoBX8EUNGD90FW70kn,7GRhBDsirIGkRZBtSMEzNTyDr2JQm4xx,28,22,13,20,8,3,1,0,67,9.571428571428571,1,0.0,8,13,14,8,14,3,6,1,0,43,24,0
5615,88580,qn1djZG7LzKtC8vI6yAVSJrTMAG2OGsj,5X6FeZozNMgE2VRi3MJYjkkFK8SETtu2,6,12,4,0,2,0,2,0,20,2.857142857142857,1,0.0,0,4,0,2,12,0,0,2,0,6,14,1
5616,88600,Elyv0DBesmIDtda22RvPoYHZeyVOycgU,5X6FeZozNMgE2VRi3MJYjkkFK8SETtu2,3,2,0,0,0,0,2,0,4,0.5714285714285714,1,0.0,0,0,0,0,2,0,0,2,0,0,4,1
5617,88613,VVltscgfR96aweHb5nQdD1Q7dsOwuOJz,5X6FeZozNMgE2VRi3MJYjkkFK8SETtu2,24,56,2,26,10,0,6,0,100,14.285714285714286,4,0.0,24,2,23,10,32,0,3,6,0,59,41,1
5618,88618,kPAC602D9DmVqww2TT92vzDLsgdcAg6s,5X6FeZozNMgE2VRi3MJYjkkFK8SETtu2,4,2,1,0,0,0,3,0,6,0.8571428571428571,1,0.0,0,1,0,0,2,0,0,3,0,1,5,1
5619,88628,YKeoakXLvYKQuzmkPlJms5dyRpHXqKSm,5X6FeZozNMgE2VRi3MJYjkkFK8SETtu2,2,0,0,0,0,0,2,0,2,0.2857142857142857,1,0.0,0,0,0,0,0,0,0,2,0,0,2,1
5620,88681,8nT76hrzyl8ZAUdI7W6kfrIzHxI3puKM,5X6FeZozNMgE2VRi3MJYjkkFK8SETtu2,3,2,0,0,0,0,1,0,3,0.42857142857142855,1,0.0,0,0,0,0,2,0,0,1,0,0,3,1
5621,88707,QcFkBpSrsmtN3SQ6KjwS5GaeQqJBdg65,5X6FeZozNMgE2VRi3MJYjkkFK8SETtu2,1,0,0,0,0,0,1,0,1,0.14285714285714285,1,0.0,0,0,0,0,0,0,0,1,0,0,1,1
5622,88714,mZP93anQs7Q6391iFwgUyfSw444ov2HX,5Gyp41oLVo7Gg7vF4vpmggWP5MU70QO6,6,3,1,0,2,4,4,1,15,2.142857142857143,1,0.0,0,1,0,2,3,4,0,4,1,3,12,0
5623,88736,mJZNVvZltlGUOWmItS7lca1ZZKMYLgfv,5Gyp41oLVo7Gg7vF4vpmggWP5MU70QO6,15,22,11,6,4,2,6,1,52,7.428571428571429,3,0.0,5,11,4,4,17,2,2,6,1,24,28,1
5624,88751,qMriGwNUEixgRIrpqeDAVIYWMKZnERwv,5Gyp41oLVo7Gg7vF4vpmggWP5MU70QO6,1,0,0,0,0,0,1,0,1,0.14285714285714285,1,0.0,0,0,0,0,0,0,0,1,0,0,1,1
5625,88760,yT4DZ6P2b1V6Eaa8Kzwtz6qb8BfYt5qf,5Gyp41oLVo7Gg7vF4vpmggWP5MU70QO6,8,17,8,0,3,0,3,0,31,4.428571428571429,2,0.0,4,8,0,3,13,0,0,3,0,15,16,1
5626,88804,u4s0SPiIkynucY7ReF58TL89R2q4zw1x,fbPkOYLVPtPgIt0MxizjfFJov3JbHyAi,1,0,0,0,0,0,1,0,1,0.14285714285714285,1,0.0,0,0,0,0,0,0,0,1,0,0,1,0
5627,88911,lAbZwAYKTyZI7H53JXZYE1DAKQNJGlGJ,3VkHkmOtom3jM2wCu94xgzzu1d6Dn7or,21,29,15,40,0,24,17,6,131,18.714285714285715,2,0.0,8,15,38,0,21,24,2,17,6,61,70,1
5628,88916,LRjqhYtqS9moLoOjiLCiCNZwzxUXJkT1,3VkHkmOtom3jM2wCu94xgzzu1d6Dn7or,1,0,0,0,0,0,1,0,1,0.14285714285714285,1,0.0,0,0,0,0,0,0,0,1,0,0,1,1
5629,88918,ahbaDr1KpVEdYWTC3NSwGl199oLA9pwN,3VkHkmOtom3jM2wCu94xgzzu1d6Dn7or,11,13,5,0,6,0,3,0,27,3.857142857142857,1,0.0,6,5,0,6,7,0,0,3,0,17,10,1
5630,88926,cxzXwKcGrJCPE1BOyefClCLGNk3PxQhW,3VkHkmOtom3jM2wCu94xgzzu1d6Dn7or,1,0,0,0,0,0,1,0,1,0.14285714285714285,1,0.0,0,0,0,0,0,0,0,1,0,0,1,1
5631,88928,e0buQlxlHVWdQd03EOAehldJOI8AeFTm,3VkHkmOtom3jM2wCu94xgzzu1d6Dn7or,6,4,2,0,1,0,4,0,11,1.5714285714285714,2,0.0,0,2,0,1,4,0,0,4,0,3,8,0
5632,88933,J7jJzTgJWf8xIO8N4tK5xh1VQj17hBiy,3VkHkmOtom3jM2wCu94xgzzu1d6Dn7or,5,4,1,0,1,1,3,0,10,1.4285714285714286,2,0.0,1,1,0,1,3,1,0,3,0,3,7,1
5633,88937,ucnh7Je2Ujv5K3Q3wjC5gWq40jwh8dv6,3VkHkmOtom3jM2wCu94xgzzu1d6Dn7or,43,121,50,33,37,9,47,3,300,42.857142857142854,10,0.0,46,50,27,37,75,9,6,47,3,160,140,1
5634,88938,3cllbPYEJp74HYn7HHNMKMzXQxN8axkY,3VkHkmOtom3jM2wCu94xgzzu1d6Dn7or,1,0,0,0,0,0,2,0,2,0.2857142857142857,1,0.0,0,0,0,0,0,0,0,2,0,0,2,1
5635,88943,IXOAd9gzq9ETuEABkvxdbEaJcLrRwGoR,3VkHkmOtom3jM2wCu94xgzzu1d6Dn7or,11,7,5,0,3,1,7,0,23,3.2857142857142856,2,0.0,0,5,0,3,7,1,0,7,0,8,15,1
5636,88946,CNJ2KRdKhIzMbOlxj2daOOkuq5TrQAeD,3VkHkmOtom3jM2wCu94xgzzu1d6Dn7or,1,0,0,0,0,0,1,0,1,0.14285714285714285,1,0.0,0,0,0,0,0,0,0,1,0,0,1,1
5637,88949,tsEZQPaaDFu5srPuDEqunB4WLNGL8KRx,3VkHkmOtom3jM2wCu94xgzzu1d6Dn7or,1,0,0,0,0,0,1,0,1,0.14285714285714285,1,0.0,0,0,0,0,0,0,0,1,0,0,1,1
5638,88950,0BYnjPQBJCyvsMCFPwytdDakvmEAJJxG,3VkHkmOtom3jM2wCu94xgzzu1d6Dn7or,6,3,2,0,2,0,2,0,9,1.2857142857142858,1,0.0,0,2,0,2,3,0,0,2,0,4,5,1
5639,88953,bsalGAvHbAyi2zQkMdMuno7PqVBrE5qV,3VkHkmOtom3jM2wCu94xgzzu1d6Dn7or,8,10,3,2,5,1,2,0,23,3.2857142857142856,1,0.0,6,3,2,5,4,1,0,2,0,16,7,1
5640,88954,iCGz2pRa6uhZJEwypFooqVVulX8MzKD9,3VkHkmOtom3jM2wCu94xgzzu1d6Dn7or,7,2,1,0,1,2,5,1,12,1.7142857142857142,1,0.0,0,1,0,1,2,2,0,5,1,2,10,1
5641,88958,wJViEDKJG9cycqokQxxOomq0g3hb2X0n,3VkHkmOtom3jM2wCu94xgzzu1d6Dn7or,5,2,1,0,1,0,2,0,6,0.8571428571428571,1,0.0,0,1,0,1,2,0,0,2,0,2,4,1
5642,88963,k59Gorliztx6a47jV7pr1ch0V9419jgs,3VkHkmOtom3jM2wCu94xgzzu1d6Dn7or,1,0,0,0,0,0,1,0,1,0.14285714285714285,1,0.0,0,0,0,0,0,0,0,1,0,0,1,1
5643,88966,yWv4f7mENeE5nSNa1Bu7iGvTZVHnqgk4,3VkHkmOtom3jM2wCu94xgzzu1d6Dn7or,1,0,0,0,0,0,1,0,1,0.14285714285714285,1,0.0,0,0,0,0,0,0,0,1,0,0,1,1
5644,88967,IVRKzAf1gWN5ButpaPiczzsxf6iD5MK8,3VkHkmOtom3jM2wCu94xgzzu1d6Dn7or,1,0,0,0,0,0,1,0,1,0.14285714285714285,1,0.0,0,0,0,0,0,0,0,1,0,0,1,1
5645,88970,Z5kwG3PpmYL3QYQb9knyt6ww6ALymSSg,3VkHkmOtom3jM2wCu94xgzzu1d6Dn7or,2,0,0,0,0,0,2,0,2,0.2857142857142857,1,0.0,0,0,0,0,0,0,0,2,0,0,2,1
5646,88972,SbEmlTcBjFBtCEwE1MXDr9Ger6m3C2oy,3VkHkmOtom3jM2wCu94xgzzu1d6Dn7or,8,4,2,0,2,5,6,5,24,3.4285714285714284,1,0.0,1,2,0,2,3,5,0,6,5,5,19,1
5647,88975,YKTpkNPEurHlfGW3A9wA7ZyLfR2cuzGi,3VkHkmOtom3jM2wCu94xgzzu1d6Dn7or,6,6,2,0,3,0,5,0,16,2.2857142857142856,1,0.0,3,2,0,3,3,0,0,5,0,8,8,1
5648,88977,syrttArug8Mpzs9L0IHsvBtATawYF9J2,3VkHkmOtom3jM2wCu94xgzzu1d6Dn7or,1,0,0,0,0,0,1,0,1,0.14285714285714285,1,0.0,0,0,0,0,0,0,0,1,0,0,1,1
5649,88982,3XRkXq805MjluZF5vkfqjwvySDkF3LnT,3VkHkmOtom3jM2wCu94xgzzu1d6Dn7or,1,0,0,0,0,0,1,0,1,0.14285714285714285,1,0.0,0,0,0,0,0,0,0,1,0,0,1,1
5650,88983,mAOdvYAdgQSaOInL6L7xQLXLQkzkpnkw,3VkHkmOtom3jM2wCu94xgzzu1d6Dn7or,7,5,1,0,0,0,10,1,17,2.4285714285714284,1,0.0,2,1,0,0,3,0,0,10,1,3,14,1
5651,88990,Yi43nvK6IYnQZd87bkmm0bmUnr9E8D0n,3VkHkmOtom3jM2wCu94xgzzu1d6Dn7or,6,4,0,0,1,0,5,1,11,1.5714285714285714,1,0.0,2,0,0,1,2,0,0,5,1,3,8,1
5652,88991,BcU9hDrDz2F2xEd3tqF67ZptaAdextzP,3VkHkmOtom3jM2wCu94xgzzu1d6Dn7or,8,5,3,0,2,0,3,0,13,1.8571428571428572,3,0.0,0,3,0,2,5,0,0,3,0,5,8,0
5653,88993,EWcraq8C1ApG4sDi5Wn7JWSKpr9J6BU0,3VkHkmOtom3jM2wCu94xgzzu1d6Dn7or,1,0,0,0,0,0,1,0,1,0.14285714285714285,1,0.0,0,0,0,0,0,0,0,1,0,0,1,1
5654,88997,whspXo2pdzqGQ7uUMsLjiaHYpjkc35JW,3VkHkmOtom3jM2wCu94xgzzu1d6Dn7or,2,0,0,0,0,0,3,0,3,0.42857142857142855,3,0.0,0,0,0,0,0,0,0,3,0,0,3,1
5655,88998,oSabIe7L5topw6hwV4H4ZV0Ug7ZVNxfV,3VkHkmOtom3jM2wCu94xgzzu1d6Dn7or,29,52,32,29,26,10,5,0,154,22.0,5,0.0,19,32,23,26,33,10,6,5,0,100,54,1
5656,89001,SIEvRbNGLrbZ8hQx02PeCIy1TZz00zab,3VkHkmOtom3jM2wCu94xgzzu1d6Dn7or,1,0,0,0,0,0,1,0,1,0.14285714285714285,1,0.0,0,0,0,0,0,0,0,1,0,0,1,1
5657,89002,fjBO4dqI4rE3EVJKn1UzLgI1nZOUL8Es,3VkHkmOtom3jM2wCu94xgzzu1d6Dn7or,48,109,21,65,47,0,4,0,246,35.142857142857146,3,0.0,78,21,61,47,31,0,4,4,0,207,39,1
5658,89004,qOPsL7s2uJzugKawS9Eo8qQaSmIpBiZR,3VkHkmOtom3jM2wCu94xgzzu1d6Dn7or,11,11,4,2,4,7,11,1,40,5.714285714285714,2,0.0,5,4,2,4,6,7,0,11,1,15,25,1
5659,89005,qvZjxZ8rTsJK8V0a0T3CWXSelVOq0QMt,3VkHkmOtom3jM2wCu94xgzzu1d6Dn7or,9,6,3,1,2,3,7,1,23,3.2857142857142856,1,0.0,1,3,1,2,5,3,0,7,1,7,16,1
5660,89007,9Z2Md4wmHivzsbvqY2t7sBwH1lK5dRfK,3VkHkmOtom3jM2wCu94xgzzu1d6Dn7or,1,0,0,0,0,0,1,0,1,0.14285714285714285,1,0.0,0,0,0,0,0,0,0,1,0,0,1,1
5661,89009,onHOYD5uzmnV4nRw3pLXt3LrpUkknNmw,3VkHkmOtom3jM2wCu94xgzzu1d6Dn7or,6,3,1,0,1,0,3,0,8,1.1428571428571428,1,0.0,0,1,0,1,3,0,0,3,0,2,6,1
5662,89012,33wUTO936EWlkY1IHcJLwG62YCATj8r9,3VkHkmOtom3jM2wCu94xgzzu1d6Dn7or,1,0,0,0,0,0,1,0,1,0.14285714285714285,1,0.0,0,0,0,0,0,0,0,1,0,0,1,1
5663,89016,hsmZkFD6JkOYgvPKK5l3oc9eLCdW6vFq,3VkHkmOtom3jM2wCu94xgzzu1d6Dn7or,16,81,34,18,0,3,18,1,155,22.142857142857142,3,0.0,21,34,16,0,60,3,2,18,1,71,84,1
5664,89028,DYAk0IkWbJP7Bx09YkPpEGwRc6m4R8OD,3VkHkmOtom3jM2wCu94xgzzu1d6Dn7or,9,10,6,0,4,0,7,0,27,3.857142857142857,2,0.0,1,6,0,4,9,0,0,7,0,11,16,1
5665,89029,MQHx1pkOQZAuD4wT0ZMwn0mRSo8hfk9w,3VkHkmOtom3jM2wCu94xgzzu1d6Dn7or,1,0,0,0,0,0,1,0,1,0.14285714285714285,1,0.0,0,0,0,0,0,0,0,1,0,0,1,1
5666,89033,w3155Vkw5wpuKOK6WeWXLmPGCsMeqo9R,3VkHkmOtom3jM2wCu94xgzzu1d6Dn7or,8,6,3,0,2,2,5,0,18,2.5714285714285716,1,0.0,0,3,0,2,6,2,0,5,0,5,13,1
5667,89037,ySuxn4nU2lxfW7r2bXGbcO5FnHdn6zbc,3VkHkmOtom3jM2wCu94xgzzu1d6Dn7or,31,42,24,8,26,4,2,2,108,15.428571428571429,5,0.0,5,24,7,26,37,4,1,2,2,62,46,1
5668,89038,wTUcP4QaVXs3YwLG8vhem4UlekekF5G9,3VkHkmOtom3jM2wCu94xgzzu1d6Dn7or,1,0,0,0,0,0,1,0,1,0.14285714285714285,1,0.0,0,0,0,0,0,0,0,1,0,0,1,1
5669,89040,Couihzds0zUwIIYOXQBZ6NzQTceVdsaw,3VkHkmOtom3jM2wCu94xgzzu1d6Dn7or,1,0,0,0,0,0,1,0,1,0.14285714285714285,1,0.0,0,0,0,0,0,0,0,1,0,0,1,1
5670,89044,aeuPzDzM6VGDu5jueA6amTVqN9l5gHX3,3VkHkmOtom3jM2wCu94xgzzu1d6Dn7or,1,0,0,0,0,0,1,0,1,0.14285714285714285,1,0.0,0,0,0,0,0,0,0,1,0,0,1,1
5671,89049,oAQVGhcAt6l7hdLJ4W1QLF4wdWetqcue,3VkHkmOtom3jM2wCu94xgzzu1d6Dn7or,6,2,1,0,1,0,3,1,8,1.1428571428571428,1,0.0,0,1,0,1,2,0,0,3,1,2,6,1
5672,89050,3AAYV9UoVtL9DSFaIEJnVYAjOi2mWhEh,3VkHkmOtom3jM2wCu94xgzzu1d6Dn7or,2,0,0,0,0,0,2,0,2,0.2857142857142857,1,0.0,0,0,0,0,0,0,0,2,0,0,2,1
5673,89053,8WkmluXFyfH2RPkt9XBiIrqOQqieGIYU,3VkHkmOtom3jM2wCu94xgzzu1d6Dn7or,1,0,0,0,0,0,1,0,1,0.14285714285714285,1,0.0,0,0,0,0,0,0,0,1,0,0,1,1
5674,89055,BRzMUg3uRehDmYGai2dXPzJ2vy0ZTdCI,3VkHkmOtom3jM2wCu94xgzzu1d6Dn7or,3,0,0,0,0,0,6,0,6,0.8571428571428571,1,0.0,0,0,0,0,0,0,0,6,0,0,6,1
5675,89065,au3rsNa6vBxNlZHvwJ43U4yHJfexllpD,3VkHkmOtom3jM2wCu94xgzzu1d6Dn7or,21,29,11,18,9,20,4,1,92,13.142857142857142,1,0.0,12,11,17,9,17,20,1,4,1,49,43,1
5676,89067,I01Tigm5affXeT685ZIT6O3ETijHB7PS,3VkHkmOtom3jM2wCu94xgzzu1d6Dn7or,4,5,3,0,3,0,1,0,12,1.7142857142857142,1,0.0,0,3,0,3,5,0,0,1,0,6,6,1
5677,89069,vXCsOFvHAmaiRU9e8CXhjo1ldP3789HQ,3VkHkmOtom3jM2wCu94xgzzu1d6Dn7or,1,0,0,0,0,0,1,0,1,0.14285714285714285,1,0.0,0,0,0,0,0,0,0,1,0,0,1,1
5678,89072,CTMTvI2Uro0EeKNBsJxetU9EJ96AOiT1,3VkHkmOtom3jM2wCu94xgzzu1d6Dn7or,1,0,0,0,0,0,1,0,1,0.14285714285714285,1,0.0,0,0,0,0,0,0,0,1,0,0,1,1
5679,89075,TyZ5vRcbKdK9ylblLwR0MRT1s2uEnY5W,3VkHkmOtom3jM2wCu94xgzzu1d6Dn7or,45,79,16,53,33,9,9,0,199,28.428571428571427,2,0.0,58,16,49,33,21,9,4,9,0,156,43,1
5680,89077,vrNEFmWIhF2qeuPtPLyQm0dWGXF9FQDn,3VkHkmOtom3jM2wCu94xgzzu1d6Dn7or,7,4,2,0,2,0,2,0,10,1.4285714285714286,1,0.0,1,2,0,2,3,0,0,2,0,5,5,1
5681,89082,CRNYHnQXh6HkRHMggPMymqKhyKPDJZeG,3VkHkmOtom3jM2wCu94xgzzu1d6Dn7or,1,0,0,0,0,0,1,0,1,0.14285714285714285,1,0.0,0,0,0,0,0,0,0,1,0,0,1,1
5682,89097,bFW1YBBLTe4uG5eW9TDcVIOcLOaSX5ld,3VkHkmOtom3jM2wCu94xgzzu1d6Dn7or,14,24,12,0,7,0,10,0,53,7.571428571428571,8,0.0,0,12,0,7,24,0,0,10,0,19,34,0
5683,89100,qRgamRc0j9SUXfXdqrrge5Qv1AZECycO,3VkHkmOtom3jM2wCu94xgzzu1d6Dn7or,7,7,3,6,4,1,1,0,22,3.142857142857143,1,0.0,3,3,5,4,4,1,1,1,0,15,7,1
5684,89105,ESEPT0SMuO2dXTmyHCgV7oXscA7W26hK,3VkHkmOtom3jM2wCu94xgzzu1d6Dn7or,26,39,19,18,15,12,4,0,107,15.285714285714286,2,0.0,10,19,15,15,29,12,3,4,0,59,48,1
5685,89108,COJspLkVqHUm3DJ5odOYM2jLEfX5mp8g,3VkHkmOtom3jM2wCu94xgzzu1d6Dn7or,2,0,0,0,0,0,2,0,2,0.2857142857142857,1,0.0,0,0,0,0,0,0,0,2,0,0,2,1
5686,89109,w0u223fmMcj8R0XYvkRYTxBWPO2H34gs,3VkHkmOtom3jM2wCu94xgzzu1d6Dn7or,1,0,0,0,0,0,1,0,1,0.14285714285714285,1,0.0,0,0,0,0,0,0,0,1,0,0,1,1
5687,89113,BtQKKM0BtMpj8x1gmvIXn2yelVCPISxo,3VkHkmOtom3jM2wCu94xgzzu1d6Dn7or,4,2,1,0,1,2,1,0,7,1.0,1,0.0,0,1,0,1,2,2,0,1,0,2,5,1
5688,89114,QlMLVIhM5vSav3NBzoFtmciCM1pZZnLs,3VkHkmOtom3jM2wCu94xgzzu1d6Dn7or,1,0,0,0,0,0,1,0,1,0.14285714285714285,1,0.0,0,0,0,0,0,0,0,1,0,0,1,1
5689,89125,yRXk9t7I0ipJKdRCHLx2PuZNLNNkkXb7,3VkHkmOtom3jM2wCu94xgzzu1d6Dn7or,5,2,1,0,1,0,2,0,6,0.8571428571428571,1,0.0,0,1,0,1,2,0,0,2,0,2,4,1
5690,89128,BIiI4gBnsSkEPDiI0fdE5hMfAdZYws3A,3VkHkmOtom3jM2wCu94xgzzu1d6Dn7or,1,0,0,0,0,0,1,0,1,0.14285714285714285,1,0.0,0,0,0,0,0,0,0,1,0,0,1,1
5691,89130,qT5MUcinTAEJodeIhWYHhFiMFnaXOLX0,3VkHkmOtom3jM2wCu94xgzzu1d6Dn7or,8,21,5,0,2,4,6,1,39,5.571428571428571,4,0.0,2,5,0,2,19,4,0,6,1,9,30,1
5692,89134,M47eI6aml6puJVOQSgAD0Ct9KNVhYdOW,3VkHkmOtom3jM2wCu94xgzzu1d6Dn7or,1,0,0,0,0,0,1,0,1,0.14285714285714285,1,0.0,0,0,0,0,0,0,0,1,0,0,1,1
5693,89139,4Seg1mBzfEEtLCIoQ9Why99R7xBxrcs8,3VkHkmOtom3jM2wCu94xgzzu1d6Dn7or,1,0,0,0,0,0,1,0,1,0.14285714285714285,1,0.0,0,0,0,0,0,0,0,1,0,0,1,1
5694,89140,MJVWMTfGhwvTGXPKgy2Gjzmj7rVHWvF4,3VkHkmOtom3jM2wCu94xgzzu1d6Dn7or,12,12,3,4,3,0,10,1,33,4.714285714285714,2,0.0,6,3,3,3,6,0,1,10,1,15,18,1
5695,89142,OBpRO1sT0AeSc4Ploo60TZgSq8G8qvPg,3VkHkmOtom3jM2wCu94xgzzu1d6Dn7or,6,6,3,0,1,0,4,0,14,2.0,3,0.0,0,3,0,1,6,0,0,4,0,4,10,1
5696,89153,93CdCLAT4bSkQ5pBc61CcOzq22oizzqt,3VkHkmOtom3jM2wCu94xgzzu1d6Dn7or,9,16,0,0,3,0,6,1,26,3.7142857142857144,1,0.0,6,0,0,3,10,0,0,6,1,9,17,1
5697,89564,CywE8FKIbY3F3QxzorcpvAYCApeOH4J5,SpATywNh6bZuzm8s1ceuBUnMUAeoAHHw,5,3,2,0,1,0,1,0,7,1.0,1,0.0,0,2,0,1,3,0,0,1,0,3,4,1
5698,89582,IVRKzAf1gWN5ButpaPiczzsxf6iD5MK8,SpATywNh6bZuzm8s1ceuBUnMUAeoAHHw,19,12,8,11,5,1,5,0,42,6.0,1,0.0,2,8,10,5,10,1,1,5,0,25,17,0
5699,89605,f3LgSSewSBsudoWmIigH2aapqGCxH8CK,SpATywNh6bZuzm8s1ceuBUnMUAeoAHHw,6,5,2,0,1,0,3,0,11,1.5714285714285714,2,0.0,0,2,0,1,5,0,0,3,0,3,8,0
5700,89700,5c8lpFjwt7A1RG96ZJudxhytTaQ1Rdi3,SpATywNh6bZuzm8s1ceuBUnMUAeoAHHw,1,0,0,0,0,0,1,0,1,0.14285714285714285,1,0.0,0,0,0,0,0,0,0,1,0,0,1,1
5701,89718,gJUEUQ7J006sORAArhI6J8FkT7xUEHkB,SpATywNh6bZuzm8s1ceuBUnMUAeoAHHw,12,11,1,12,1,0,3,0,28,4.0,3,0.0,2,1,11,1,9,0,1,3,0,15,13,1
5702,89752,bRDMid9iRGcartTY4OAKAdQRbX2j8Y86,G8EPVSXsOYB5YQWZGiz1aVq5Pgr2GrQu,1,0,0,0,0,0,1,0,1,0.14285714285714285,1,0.0,0,0,0,0,0,0,0,1,0,0,1,1
5703,89764,Ur5YqRaNsaD6KYfRfGA2p4Zmd8kpRITc,SpATywNh6bZuzm8s1ceuBUnMUAeoAHHw,18,15,9,8,5,4,2,0,43,6.142857142857143,2,0.0,4,9,8,5,11,4,0,2,0,26,17,0
5704,89829,sfmDw8Mu24TwJAISRGKb3tkGixPCex4a,SpATywNh6bZuzm8s1ceuBUnMUAeoAHHw,2,0,0,0,0,0,4,0,4,0.5714285714285714,1,0.0,0,0,0,0,0,0,0,4,0,0,4,1
5705,89893,HAAyQYNYY3ULmqhNC56bxv5FSwyMVoqP,SpATywNh6bZuzm8s1ceuBUnMUAeoAHHw,10,13,1,22,0,0,4,0,40,5.714285714285714,1,0.0,5,1,19,0,8,0,3,4,0,25,15,1
5706,89897,HAAyQYNYY3ULmqhNC56bxv5FSwyMVoqP,bWdj2GDclj5ofokWjzoa5jAwMkxCykd6,3,2,1,0,0,0,2,0,5,0.7142857142857143,1,0.0,0,1,0,0,2,0,0,2,0,1,4,1
5707,90041,JaLvdj0QPGLA6QlwJ3N2oF66NiYZ7XSV,bWdj2GDclj5ofokWjzoa5jAwMkxCykd6,3,2,0,0,0,0,1,0,3,0.42857142857142855,1,0.0,0,0,0,0,2,0,0,1,0,0,3,0
5708,90425,lcgsmC4BQDYDnzCO5vs1TCdTPnBbRaGt,SpATywNh6bZuzm8s1ceuBUnMUAeoAHHw,5,6,0,0,0,2,6,1,15,2.142857142857143,1,0.0,0,0,0,0,6,2,0,6,1,0,15,1
5709,90527,HtbY3zzP3Q7syMRtSIgdj2lkZgZynozO,bWdj2GDclj5ofokWjzoa5jAwMkxCykd6,4,1,0,0,0,0,3,0,4,0.5714285714285714,1,0.0,0,0,0,0,1,0,0,3,0,0,4,1
5710,90560,QqAAFsY8kslizUQKd5uhHbFKpFbb6EW2,SpATywNh6bZuzm8s1ceuBUnMUAeoAHHw,5,5,3,0,0,0,2,0,10,1.4285714285714286,1,0.0,0,3,0,0,5,0,0,2,0,3,7,0
5711,90571,i6jKFDXXIDyjle2n9K5Y7L1CTASMdeNx,RXDvfPUBYFlVdlueBFbLW0mhhAyGEqpt,21,35,2,30,1,0,4,0,72,10.285714285714286,3,0.0,5,2,30,1,30,0,0,4,0,38,34,0
5712,90673,yDc9ZpbUycr11xuvu88deR54WnL37yET,SpATywNh6bZuzm8s1ceuBUnMUAeoAHHw,19,33,3,10,2,0,12,0,60,8.571428571428571,5,0.0,4,3,10,2,29,0,0,12,0,19,41,0
5713,90674,bLDIg7orV5sh30oIBmQ342IswZTJ8Q5l,RXDvfPUBYFlVdlueBFbLW0mhhAyGEqpt,40,37,24,38,14,10,8,2,133,19.0,2,0.0,3,24,37,14,34,10,1,8,2,78,55,1
5714,90729,4TzA065DYK6LuKsj03IdWmVVHtLP4pD7,SpATywNh6bZuzm8s1ceuBUnMUAeoAHHw,5,3,1,0,1,0,1,0,6,0.8571428571428571,1,0.0,0,1,0,1,3,0,0,1,0,2,4,1
5715,90799,4LhW0gpz7wD6EZALKqoopL1swej6F6kT,RXDvfPUBYFlVdlueBFbLW0mhhAyGEqpt,2,0,0,0,0,0,2,0,2,0.2857142857142857,1,0.0,0,0,0,0,0,0,0,2,0,0,2,1
5716,90832,Qsw20Q5PeTwiq1PxYe0LRVTTkwenKksO,SpATywNh6bZuzm8s1ceuBUnMUAeoAHHw,8,13,3,0,1,0,2,0,19,2.7142857142857144,2,0.0,1,3,0,1,12,0,0,2,0,5,14,1
5717,90887,GVUw4u2UhYktwQlrJTo9fWmDS2qzWpQC,SpATywNh6bZuzm8s1ceuBUnMUAeoAHHw,8,6,1,0,1,17,2,0,27,3.857142857142857,2,0.0,0,1,0,1,6,17,0,2,0,2,25,0
5718,91105,ZxvROepgS8uZpWYEjrhlsfyND4f2cw2o,SpATywNh6bZuzm8s1ceuBUnMUAeoAHHw,21,15,11,13,5,0,5,0,49,7.0,2,0.0,2,11,10,5,13,0,3,5,0,28,21,0
5719,91173,wdzOHZGShaydEKxmovJEzQ6EMiqynMte,SpATywNh6bZuzm8s1ceuBUnMUAeoAHHw,7,9,7,0,0,0,1,0,17,2.4285714285714284,1,0.0,0,7,0,0,9,0,0,1,0,7,10,1
5720,91370,A8jyl8S1kU5U2ikqJ1w16Eh9QcSPe3kU,bWdj2GDclj5ofokWjzoa5jAwMkxCykd6,2,0,0,0,0,0,2,0,2,0.2857142857142857,1,0.0,0,0,0,0,0,0,0,2,0,0,2,1
5721,91400,mP7T5RBRG5ILBmmKKL1ktjST3p6gGZyD,G8EPVSXsOYB5YQWZGiz1aVq5Pgr2GrQu,10,5,4,0,3,0,2,0,14,2.0,1,0.0,0,4,0,3,5,0,0,2,0,7,7,0
5722,91595,gDaSFJD4b80GGtFaPG7wjh3sxtnlKrIT,SpATywNh6bZuzm8s1ceuBUnMUAeoAHHw,11,12,4,10,1,0,2,0,29,4.142857142857143,2,0.0,2,4,9,1,10,0,1,2,0,16,13,0
5723,91601,gVGEUb9jfMmddRlcGqXsnz4ZV26w6q4e,5Gyp41oLVo7Gg7vF4vpmggWP5MU70QO6,7,5,2,0,2,0,2,0,11,1.5714285714285714,1,0.0,0,2,0,2,5,0,0,2,0,4,7,1
5724,91645,J2I8DrDowD3d9j8QRHclVptgZSLA6vjR,5Gyp41oLVo7Gg7vF4vpmggWP5MU70QO6,10,14,8,0,3,0,5,0,30,4.285714285714286,1,0.0,2,8,0,3,12,0,0,5,0,13,17,1
5725,91661,hcKYo6bLhlANvHE0FxLuR4YY8jocfBwJ,5Gyp41oLVo7Gg7vF4vpmggWP5MU70QO6,15,14,8,2,5,15,8,0,52,7.428571428571429,5,0.0,3,8,1,5,11,15,1,8,0,17,35,0
5726,91663,HROFX90wnUUTHf8ADYZ0Ay2MUzgrMCHp,5Gyp41oLVo7Gg7vF4vpmggWP5MU70QO6,18,52,19,0,8,4,14,3,100,14.285714285714286,5,0.0,8,19,0,8,44,4,0,14,3,35,65,1
5727,91666,Mx5vxHsJbFC6B9oxKIPSrygei6h1xd4S,5Gyp41oLVo7Gg7vF4vpmggWP5MU70QO6,17,10,8,0,7,0,2,0,27,3.857142857142857,1,0.0,0,8,0,7,10,0,0,2,0,15,12,1
5728,91706,A2erycAShix7FV5AzEvRQ1fSxczd3obW,5Gyp41oLVo7Gg7vF4vpmggWP5MU70QO6,1,0,0,0,0,0,2,0,2,0.2857142857142857,1,0.0,0,0,0,0,0,0,0,2,0,0,2,1
5729,91724,cjYWBFQWrsyr2eB3uwe411p7xKBeDGQi,5Gyp41oLVo7Gg7vF4vpmggWP5MU70QO6,14,35,17,6,8,0,9,0,75,10.714285714285714,5,0.0,6,17,3,8,29,0,3,9,0,34,41,1
5730,91729,TqwsfzC7boA0P221nJEBMK29H7weQpBs,5Gyp41oLVo7Gg7vF4vpmggWP5MU70QO6,13,12,6,4,3,0,2,0,27,3.857142857142857,1,0.0,5,6,2,3,7,0,2,2,0,16,11,1
5731,91739,HNaJJS3tKCEoZkM0EWhn7UouJ0Nuy7QX,5Gyp41oLVo7Gg7vF4vpmggWP5MU70QO6,2,0,0,0,0,0,2,0,2,0.2857142857142857,1,0.0,0,0,0,0,0,0,0,2,0,0,2,1
5732,91751,92mMNjk3cJsYjNqhq0S3iwov3yrrBBEr,5Gyp41oLVo7Gg7vF4vpmggWP5MU70QO6,1,0,0,0,0,0,1,0,1,0.14285714285714285,1,0.0,0,0,0,0,0,0,0,1,0,0,1,1
5733,91761,k6RJ44LpfDefc4BqSfb5Ks3bqRLzpbPs,5Gyp41oLVo7Gg7vF4vpmggWP5MU70QO6,30,74,33,19,13,17,20,0,176,25.142857142857142,7,0.0,15,33,16,13,59,17,3,20,0,77,99,0
5734,91762,TauOAk4Cm1OS5dlhtWMBldHEzkBkLYAM,5Gyp41oLVo7Gg7vF4vpmggWP5MU70QO6,1,0,0,0,0,0,1,0,1,0.14285714285714285,1,0.0,0,0,0,0,0,0,0,1,0,0,1,1
5735,91783,DIV0XhnvCWVZ3iA9CwmqKCB9ziYsXVmI,5Gyp41oLVo7Gg7vF4vpmggWP5MU70QO6,1,0,0,0,0,0,1,0,1,0.14285714285714285,1,0.0,0,0,0,0,0,0,0,1,0,0,1,1
5736,91793,uaNRMAeOjjxBTsXCXmPYPOpFNtIjXEn1,5Gyp41oLVo7Gg7vF4vpmggWP5MU70QO6,9,6,4,0,2,0,3,0,15,2.142857142857143,2,0.0,0,4,0,2,6,0,0,3,0,6,9,1
5737,91802,FbZxeKF6OWTvZPlj49JWXpcOzpO2oJVZ,5Gyp41oLVo7Gg7vF4vpmggWP5MU70QO6,1,0,0,0,0,0,1,0,1,0.14285714285714285,1,0.0,0,0,0,0,0,0,0,1,0,0,1,1
5738,91811,I73HdLkKTEEKeKJv8RXl4DK1UPKwGJfY,5Gyp41oLVo7Gg7vF4vpmggWP5MU70QO6,5,3,1,0,1,0,2,0,7,1.0,1,0.0,0,1,0,1,3,0,0,2,0,2,5,1
5739,91862,4wGrpM3AgzCdbAUft0CQKA9hOQd1a3At,5Gyp41oLVo7Gg7vF4vpmggWP5MU70QO6,33,71,34,10,27,0,10,0,152,21.714285714285715,8,0.0,19,34,5,27,52,0,5,10,0,85,67,1
5740,91874,fXFz6g5r2Tp8eWARWPVXqKuqaMAimuJv,5Gyp41oLVo7Gg7vF4vpmggWP5MU70QO6,8,9,3,0,1,0,7,0,20,2.857142857142857,2,0.0,0,3,0,1,9,0,0,7,0,4,16,1
5741,91882,VFH6a2uSMyTTmZ3qJklBQDYdnqCeEjjH,5Gyp41oLVo7Gg7vF4vpmggWP5MU70QO6,13,38,8,32,3,0,7,0,88,12.571428571428571,2,0.0,21,8,19,3,17,0,13,7,0,51,37,1
5742,91912,dKrdiEeAHzNQy0ZEy2dsQ27TKgxltzee,5Gyp41oLVo7Gg7vF4vpmggWP5MU70QO6,8,6,4,0,3,0,3,0,16,2.2857142857142856,2,0.0,0,4,0,3,6,0,0,3,0,7,9,1
5743,91922,aiYWCD5OXvg9JcNa3jHM8Sy0IrqSuC2V,5Gyp41oLVo7Gg7vF4vpmggWP5MU70QO6,1,0,0,0,0,0,1,0,1,0.14285714285714285,1,0.0,0,0,0,0,0,0,0,1,0,0,1,1
5744,91937,dJXifgB0AMWBBZbYLPHtaqOVPxCyllD8,5Gyp41oLVo7Gg7vF4vpmggWP5MU70QO6,5,4,1,0,1,0,4,0,10,1.4285714285714286,3,0.0,0,1,0,1,4,0,0,4,0,2,8,1
5745,91947,I7EV0ilbAmvRztKJjn2PkUA9D3WXsldW,5Gyp41oLVo7Gg7vF4vpmggWP5MU70QO6,11,8,4,0,3,0,4,0,19,2.7142857142857144,1,0.0,0,4,0,3,8,0,0,4,0,7,12,1
5746,91967,KQ2RZXNhuAxg3uK4R6cV2U5rzXHTACPD,5Gyp41oLVo7Gg7vF4vpmggWP5MU70QO6,1,0,0,0,0,0,1,0,1,0.14285714285714285,1,0.0,0,0,0,0,0,0,0,1,0,0,1,1
5747,91970,bo2onan1tteC9PtOvOwWhHvlR04pcJEI,5Gyp41oLVo7Gg7vF4vpmggWP5MU70QO6,8,12,6,0,4,0,2,0,24,3.4285714285714284,2,0.0,2,6,0,4,10,0,0,2,0,12,12,1
5748,92010,WPZzQgsRlhCaDKsgOnJym54JEfCX3TnU,3VkHkmOtom3jM2wCu94xgzzu1d6Dn7or,5,2,1,0,1,0,2,0,6,0.8571428571428571,1,0.0,0,1,0,1,2,0,0,2,0,2,4,1
5749,92012,cSPmiYFpvKp3t31tgpU4uGLNNWxYS8Sr,3VkHkmOtom3jM2wCu94xgzzu1d6Dn7or,32,34,12,29,16,8,14,3,116,16.571428571428573,2,0.0,21,12,23,16,13,8,6,14,3,72,44,1
5750,92068,Nl63P9HfrDHNTioAMibVFsG7C6MOQlQ2,3VkHkmOtom3jM2wCu94xgzzu1d6Dn7or,45,43,28,1,26,1,11,0,110,15.714285714285714,6,0.0,5,28,1,26,38,1,0,11,0,60,50,0
5751,92078,hJRlB5RCNQHBXSIyIrtLiU1lhUWnl90A,3VkHkmOtom3jM2wCu94xgzzu1d6Dn7or,6,2,1,0,1,2,4,0,10,1.4285714285714286,1,0.0,0,1,0,1,2,2,0,4,0,2,8,1
5752,92108,6I9tuEOSJXwqZycCyEbmBi10JKjNjXRW,3VkHkmOtom3jM2wCu94xgzzu1d6Dn7or,10,9,3,0,2,1,7,0,22,3.142857142857143,1,0.0,0,3,0,2,9,1,0,7,0,5,17,1
5753,92120,QP4n9xujRmppLpJuo3p8rivz78xLiQtX,3VkHkmOtom3jM2wCu94xgzzu1d6Dn7or,5,2,1,0,1,0,2,0,6,0.8571428571428571,1,0.0,0,1,0,1,2,0,0,2,0,2,4,1
5754,92128,kAubX3YD1QXDkKfXy6xJth37WDkoxpFR,3VkHkmOtom3jM2wCu94xgzzu1d6Dn7or,3,2,0,0,0,0,1,0,3,0.42857142857142855,1,0.0,0,0,0,0,2,0,0,1,0,0,3,1
5755,92170,WpSQzZEMzHXhSbKvxj22CHOz0onI9HWB,3VkHkmOtom3jM2wCu94xgzzu1d6Dn7or,1,0,0,0,0,0,1,0,1,0.14285714285714285,1,0.0,0,0,0,0,0,0,0,1,0,0,1,1
5756,92191,WRdZfW7d6qfvZ0KKlFJKcTTCpuF0nDdo,3VkHkmOtom3jM2wCu94xgzzu1d6Dn7or,7,3,1,2,1,6,6,1,20,2.857142857142857,1,0.0,1,1,2,1,2,6,0,6,1,5,15,1
5757,92215,spEastQ2pq74IRw5KGXpOxXz1MamusN2,3VkHkmOtom3jM2wCu94xgzzu1d6Dn7or,8,6,4,0,3,1,4,0,18,2.5714285714285716,1,0.0,0,4,0,3,6,1,0,4,0,7,11,1
5758,92221,bO3QplYnoiJbQBpC2OFvvQuB9EFbMhM7,3VkHkmOtom3jM2wCu94xgzzu1d6Dn7or,1,0,0,0,0,0,1,0,1,0.14285714285714285,1,0.0,0,0,0,0,0,0,0,1,0,0,1,1
5759,92243,FBq0wRuiW7sFU9U5SlrcNu9eSvWfhQ7T,3VkHkmOtom3jM2wCu94xgzzu1d6Dn7or,1,0,0,0,0,0,2,0,2,0.2857142857142857,1,0.0,0,0,0,0,0,0,0,2,0,0,2,1
5760,92251,xnocImMu4sTSwPlbzqQFZgdYJiDXl6vB,3VkHkmOtom3jM2wCu94xgzzu1d6Dn7or,1,0,0,0,0,0,1,0,1,0.14285714285714285,1,0.0,0,0,0,0,0,0,0,1,0,0,1,1
5761,92274,cbHdj12cCek43EioPVZBH6uxAj25c968,3VkHkmOtom3jM2wCu94xgzzu1d6Dn7or,1,0,0,0,0,0,1,0,1,0.14285714285714285,1,0.0,0,0,0,0,0,0,0,1,0,0,1,1
5762,92286,xp0hBW5Psq6QHRaJN7EADcRMPTBNSHAV,3VkHkmOtom3jM2wCu94xgzzu1d6Dn7or,1,0,0,0,0,0,1,0,1,0.14285714285714285,1,0.0,0,0,0,0,0,0,0,1,0,0,1,1
5763,92287,nnn8ndc06NDVKjww6SG0wlF2ZDIeYbVG,3VkHkmOtom3jM2wCu94xgzzu1d6Dn7or,5,5,3,0,2,1,2,0,13,1.8571428571428572,1,0.0,0,3,0,2,5,1,0,2,0,5,8,1
5764,92288,fV80aRuu00trDWJ7y1VmEAcQ2xKDaujP,3VkHkmOtom3jM2wCu94xgzzu1d6Dn7or,6,33,3,0,2,0,2,1,41,5.857142857142857,1,0.0,28,3,0,2,5,0,0,2,1,33,8,1
5765,92290,7lzEjeizq2WryXPCFV63iiJ0sRC0XsD5,3VkHkmOtom3jM2wCu94xgzzu1d6Dn7or,10,17,5,6,7,2,5,0,42,6.0,1,0.0,10,5,4,7,7,2,2,5,0,26,16,1
5766,92300,zf9u87lPN0HRwW95dz7D254n8gGdhfJZ,3VkHkmOtom3jM2wCu94xgzzu1d6Dn7or,6,2,1,0,1,0,5,0,9,1.2857142857142858,1,0.0,0,1,0,1,2,0,0,5,0,2,7,1
5767,92304,3Fdh79GcEkqhLYQCWdfTb5pLqpRaTMvj,3VkHkmOtom3jM2wCu94xgzzu1d6Dn7or,5,2,1,0,1,0,2,0,6,0.8571428571428571,1,0.0,0,1,0,1,2,0,0,2,0,2,4,1
5768,92320,TCIVkyJgzJ4isZH6dzhFoSor2ZwJ5sAN,3VkHkmOtom3jM2wCu94xgzzu1d6Dn7or,7,4,2,0,2,0,3,0,11,1.5714285714285714,1,0.0,0,2,0,2,4,0,0,3,0,4,7,1
5769,92331,VL7Ebz6uuz9oVtoQ2k8XC6VxIyML6see,3VkHkmOtom3jM2wCu94xgzzu1d6Dn7or,11,11,6,0,4,0,4,1,26,3.7142857142857144,2,0.0,0,6,0,4,11,0,0,4,1,10,16,1
5770,92347,pqdSiFtkQLWzXU8KtYlOOvolG2arha7e,3VkHkmOtom3jM2wCu94xgzzu1d6Dn7or,5,3,1,0,1,0,2,0,7,1.0,1,0.0,0,1,0,1,3,0,0,2,0,2,5,1
5771,92416,hlgAnCIYIgYVFdaX4Qjp6MaN9qlFQlvr,3VkHkmOtom3jM2wCu94xgzzu1d6Dn7or,1,0,0,0,0,0,1,0,1,0.14285714285714285,1,0.0,0,0,0,0,0,0,0,1,0,0,1,1
5772,92449,dGOauLic5mGz4awYOMaqV5TU8s33lg07,3VkHkmOtom3jM2wCu94xgzzu1d6Dn7or,1,0,0,0,0,0,2,0,2,0.2857142857142857,1,0.0,0,0,0,0,0,0,0,2,0,0,2,1
5773,92475,GKGPPaT6okmnGRZj5HObLtLzADcHdH56,3VkHkmOtom3jM2wCu94xgzzu1d6Dn7or,1,0,0,0,0,0,1,0,1,0.14285714285714285,1,0.0,0,0,0,0,0,0,0,1,0,0,1,1
5774,92483,SjrtXywO2Di9R6tWHHpfBZyHXKmSAuXJ,3VkHkmOtom3jM2wCu94xgzzu1d6Dn7or,2,0,0,0,0,0,2,0,2,0.2857142857142857,1,0.0,0,0,0,0,0,0,0,2,0,0,2,1
5775,92497,OgqpjGMMInWS9PhYsy4mlMX0fhVM7tcA,3VkHkmOtom3jM2wCu94xgzzu1d6Dn7or,1,0,0,0,0,0,3,0,3,0.42857142857142855,2,0.0,0,0,0,0,0,0,0,3,0,0,3,1
5776,92503,Dtlo3c1SvhzZjTgzvtTKEnEOoS01REof,3VkHkmOtom3jM2wCu94xgzzu1d6Dn7or,1,0,0,0,0,0,1,0,1,0.14285714285714285,1,0.0,0,0,0,0,0,0,0,1,0,0,1,1
5777,92515,Sx1lH49w886YuzrvbgrhtfBzgGvqLjqU,3VkHkmOtom3jM2wCu94xgzzu1d6Dn7or,1,0,0,0,0,0,1,0,1,0.14285714285714285,1,0.0,0,0,0,0,0,0,0,1,0,0,1,1
5778,92537,JNlPhJ9z2p7in422NWyeL0sdq9lO0Q3S,3VkHkmOtom3jM2wCu94xgzzu1d6Dn7or,5,2,1,0,1,0,2,0,6,0.8571428571428571,1,0.0,0,1,0,1,2,0,0,2,0,2,4,1
5779,92665,YIsZznU3eBMkUE0b5fanRcoCpMSUdgvE,3VkHkmOtom3jM2wCu94xgzzu1d6Dn7or,47,81,20,63,19,3,18,1,205,29.285714285714285,3,0.0,25,20,56,19,56,3,7,18,1,120,85,1
5780,93151,Co9dycRC3nnJN4rm3WsLzyk3Mwz3zosU,SpATywNh6bZuzm8s1ceuBUnMUAeoAHHw,4,4,0,0,0,0,1,0,5,0.7142857142857143,1,0.0,0,0,0,0,4,0,0,1,0,0,5,1
5781,93444,wfUVHBmDLe0V8vTm9YNAi5Eoe98kipNK,RXDvfPUBYFlVdlueBFbLW0mhhAyGEqpt,13,9,1,0,2,0,2,0,14,2.0,1,0.0,0,1,0,2,9,0,0,2,0,3,11,1
5782,93518,I3RIPLupgcaFBN4TZgx1kwE7cqUmhNGE,SpATywNh6bZuzm8s1ceuBUnMUAeoAHHw,4,2,0,0,0,4,2,0,8,1.1428571428571428,1,0.0,0,0,0,0,2,4,0,2,0,0,8,1
5783,93789,bFxkSwC4B7FuMDmZm2HkHgiHz8QC2hPC,A3fsA9Zfv1X2fVEQhTw51lKENdNrEqT3,19,20,10,0,9,0,1,0,40,5.714285714285714,1,0.0,0,10,0,9,20,0,0,1,0,19,21,1
5784,94083,sTlxlEkJ3MbMUAeSajnaHOGfpyW9hgq1,SpATywNh6bZuzm8s1ceuBUnMUAeoAHHw,28,31,16,15,11,0,2,0,75,10.714285714285714,2,0.0,2,16,13,11,29,0,2,2,0,42,33,0
5785,94154,sEtktPcVAhFQ7PqkOK3agQy8gf3suIv1,SpATywNh6bZuzm8s1ceuBUnMUAeoAHHw,20,29,12,11,8,0,2,0,62,8.857142857142858,2,0.0,3,12,10,8,26,0,1,2,0,33,29,0
5786,94229,dzvyuk189tsgDZIOFuacAzCgRiphRz5M,SpATywNh6bZuzm8s1ceuBUnMUAeoAHHw,11,25,4,12,2,0,6,0,49,7.0,2,0.0,11,4,10,2,14,0,2,6,0,27,22,0
5787,94286,M8C9BDFICk4ida59GU0jjp556zazDEi1,A3fsA9Zfv1X2fVEQhTw51lKENdNrEqT3,4,3,2,0,0,0,1,0,6,0.8571428571428571,1,0.0,0,2,0,0,3,0,0,1,0,2,4,1
5788,94294,M8C9BDFICk4ida59GU0jjp556zazDEi1,bWdj2GDclj5ofokWjzoa5jAwMkxCykd6,4,3,2,0,0,0,1,0,6,0.8571428571428571,1,0.0,0,2,0,0,3,0,0,1,0,2,4,1
5789,94434,D7ijm86N7h5o3w1fsSkZ0iVyhHtcIbis,SpATywNh6bZuzm8s1ceuBUnMUAeoAHHw,15,43,13,23,0,0,4,0,83,11.857142857142858,4,0.0,22,13,20,0,21,0,3,4,0,55,28,0
5790,94530,nfkChXOgZdpVvi08Lznw3yUSxVHRyF8G,3VkHkmOtom3jM2wCu94xgzzu1d6Dn7or,64,47,38,0,30,3,29,4,151,21.571428571428573,6,0.0,0,38,0,30,47,3,0,29,4,68,83,0
5791,94543,qhQ2GK7Lh19jQzzepIjTZe30HhK11qeW,3VkHkmOtom3jM2wCu94xgzzu1d6Dn7or,1,0,0,0,0,0,1,0,1,0.14285714285714285,1,0.0,0,0,0,0,0,0,0,1,0,0,1,1
5792,94565,3i49Sfu7S1sOSKkYGlbdOOFKpde4e9tM,3VkHkmOtom3jM2wCu94xgzzu1d6Dn7or,19,26,12,2,8,12,25,0,85,12.142857142857142,2,0.0,6,12,2,8,20,12,0,25,0,28,57,1
5793,94566,baW5UAz7zlk0CrGbuOvyaGEkL1grJcoL,3VkHkmOtom3jM2wCu94xgzzu1d6Dn7or,1,0,0,0,0,0,1,0,1,0.14285714285714285,1,0.0,0,0,0,0,0,0,0,1,0,0,1,1
5794,94570,54B8rR1nClZlVaRsYfu6B3kewu4GkqDW,3VkHkmOtom3jM2wCu94xgzzu1d6Dn7or,14,9,7,0,6,0,2,0,24,3.4285714285714284,1,0.0,0,7,0,6,9,0,0,2,0,13,11,1
5795,94599,HhvQOu36AUwxS3HBXRWzCwV2HEANGBv6,3VkHkmOtom3jM2wCu94xgzzu1d6Dn7or,70,49,21,113,23,0,5,0,211,30.142857142857142,2,0.0,25,21,90,23,24,0,23,5,0,159,52,0
5796,94642,pHLiBn4di6o0B9uDKRBPn3MLmLjqZutv,3VkHkmOtom3jM2wCu94xgzzu1d6Dn7or,3,0,0,0,0,0,4,0,4,0.5714285714285714,1,0.0,0,0,0,0,0,0,0,4,0,0,4,1
5797,94656,WIHfqmQWQm1dArw6kMtfoKehEOrFfPTO,3VkHkmOtom3jM2wCu94xgzzu1d6Dn7or,7,2,1,0,1,1,5,1,11,1.5714285714285714,1,0.0,0,1,0,1,2,1,0,5,1,2,9,1
5798,94663,8Og7fXsG7tOj0uMvHAUHZQfHOc8ippo0,3VkHkmOtom3jM2wCu94xgzzu1d6Dn7or,7,4,2,0,2,2,4,4,18,2.5714285714285716,2,0.0,1,2,0,2,3,2,0,4,4,5,13,1
5799,94665,B6qgKGhHiyA76qIwFIN676gO020n5rqy,3VkHkmOtom3jM2wCu94xgzzu1d6Dn7or,10,13,6,0,5,0,4,0,28,4.0,1,0.0,0,6,0,5,13,0,0,4,0,11,17,1
5800,94670,0XqA347t1gkcvYkcQgRDcKNiGKlFYnsB,3VkHkmOtom3jM2wCu94xgzzu1d6Dn7or,35,68,56,0,45,0,9,0,178,25.428571428571427,4,0.0,0,56,0,45,68,0,0,9,0,101,77,0
5801,94672,D7NGYdR3TLx6U0EvEqMYenyKGPerYPxa,3VkHkmOtom3jM2wCu94xgzzu1d6Dn7or,5,2,1,0,1,0,2,0,6,0.8571428571428571,1,0.0,0,1,0,1,2,0,0,2,0,2,4,1
5802,94676,z9xgLltXJrOKzy4oJk2CDd0xNs9LAXro,3VkHkmOtom3jM2wCu94xgzzu1d6Dn7or,1,0,0,0,0,0,1,0,1,0.14285714285714285,1,0.0,0,0,0,0,0,0,0,1,0,0,1,1
5803,94692,bZVTm5UIuuu8152Ew15JO85CwYdhp6KF,3VkHkmOtom3jM2wCu94xgzzu1d6Dn7or,2,0,0,0,0,0,2,0,2,0.2857142857142857,1,0.0,0,0,0,0,0,0,0,2,0,0,2,1
5804,94715,6AaaRrtVZvQnfPKLSvNXhOJuVdyCqSNQ,3VkHkmOtom3jM2wCu94xgzzu1d6Dn7or,6,2,1,0,1,0,3,0,7,1.0,1,0.0,0,1,0,1,2,0,0,3,0,2,5,1
5805,94735,3wXI1egBJpCrUunPn32MLTtZtgDMGhKh,3VkHkmOtom3jM2wCu94xgzzu1d6Dn7or,1,0,0,0,0,0,1,0,1,0.14285714285714285,1,0.0,0,0,0,0,0,0,0,1,0,0,1,1
5806,94777,PzU299qhBRNb9VKeEV5yMlpPdnEheXTy,3VkHkmOtom3jM2wCu94xgzzu1d6Dn7or,10,14,0,7,7,1,14,2,45,6.428571428571429,2,0.0,9,0,6,7,5,1,1,14,2,22,23,1
5807,94780,8fcc753U4KzP0JveMl3w4klOTZBrYC4k,3VkHkmOtom3jM2wCu94xgzzu1d6Dn7or,1,0,0,0,0,0,2,0,2,0.2857142857142857,1,0.0,0,0,0,0,0,0,0,2,0,0,2,1
5808,94804,7MaoDLJpOqt0M6I4hg14oULFD6Rytoi3,3VkHkmOtom3jM2wCu94xgzzu1d6Dn7or,42,74,32,0,23,3,19,2,153,21.857142857142858,8,0.0,14,32,0,23,60,3,0,19,2,69,84,0
5809,94810,q23XMOb2cNX1yZmQGKPIPigDTk7VTnyz,3VkHkmOtom3jM2wCu94xgzzu1d6Dn7or,1,0,0,0,0,0,1,0,1,0.14285714285714285,1,0.0,0,0,0,0,0,0,0,1,0,0,1,1
5810,94845,P1bfM85NxrtE5GDV4Jjq3FQWhmzLv4fy,3VkHkmOtom3jM2wCu94xgzzu1d6Dn7or,1,0,0,0,0,0,1,0,1,0.14285714285714285,1,0.0,0,0,0,0,0,0,0,1,0,0,1,1
5811,94851,eMuxdd3vTTXINi1iAtyaa6P9Ch4DsUYV,3VkHkmOtom3jM2wCu94xgzzu1d6Dn7or,5,2,1,0,1,0,2,0,6,0.8571428571428571,1,0.0,0,1,0,1,2,0,0,2,0,2,4,1
5812,94856,IxVmoE7uFZdgEeYPhBSCDKuc6eYwcaFV,3VkHkmOtom3jM2wCu94xgzzu1d6Dn7or,1,0,0,0,0,0,1,0,1,0.14285714285714285,1,0.0,0,0,0,0,0,0,0,1,0,0,1,1
5813,94858,fmgP8cgTB3j7EOhWhcWnndxOl7Z6grS6,3VkHkmOtom3jM2wCu94xgzzu1d6Dn7or,5,4,2,0,1,0,2,0,9,1.2857142857142858,2,0.0,0,2,0,1,4,0,0,2,0,3,6,0
5814,94872,hvDFOGRe7x4dHfuW8ja5EhgXLQCRe0hR,3VkHkmOtom3jM2wCu94xgzzu1d6Dn7or,1,0,0,0,0,0,1,0,1,0.14285714285714285,1,0.0,0,0,0,0,0,0,0,1,0,0,1,1
5815,94878,H1ppPfdCzm6xwZGaIuCSa4lnrECvijtR,3VkHkmOtom3jM2wCu94xgzzu1d6Dn7or,54,68,32,47,1,1,37,1,187,26.714285714285715,7,0.0,24,32,47,1,44,1,0,37,1,104,83,0
5816,94880,aIeu6o3OoeLK7YyVHts5ZIHmmJDB7MPt,3VkHkmOtom3jM2wCu94xgzzu1d6Dn7or,71,70,31,90,24,3,7,0,225,32.142857142857146,5,0.0,28,31,68,24,42,3,22,7,0,151,74,0
5817,94886,lc1i1oMD2ji6PBYWu6KhasAR3ifuxpqe,fbPkOYLVPtPgIt0MxizjfFJov3JbHyAi,15,26,16,8,10,1,8,1,70,10.0,1,0.0,3,16,7,10,23,1,1,8,1,36,34,0
5818,94889,aJb3knGzS3UXIG3UM7Uui7PFLk23KKtl,fbPkOYLVPtPgIt0MxizjfFJov3JbHyAi,1,0,0,0,0,0,1,0,1,0.14285714285714285,1,0.0,0,0,0,0,0,0,0,1,0,0,1,0
5819,94890,qjMvEFFtc35OoxZ9COlL4lHj3v8ojf4T,fbPkOYLVPtPgIt0MxizjfFJov3JbHyAi,5,2,1,0,1,0,2,0,6,0.8571428571428571,1,0.0,0,1,0,1,2,0,0,2,0,2,4,1
5820,94892,nPRsjektHdbQkeAf1fIK4JbhrESPbPsA,fbPkOYLVPtPgIt0MxizjfFJov3JbHyAi,5,2,1,0,1,0,2,0,6,0.8571428571428571,1,0.0,0,1,0,1,2,0,0,2,0,2,4,1
5821,94893,5q237fUeGTg5ovm3b5dN9UB3JKJY3Npd,fbPkOYLVPtPgIt0MxizjfFJov3JbHyAi,10,15,4,0,2,0,2,0,23,3.2857142857142856,1,0.0,0,4,0,2,15,0,0,2,0,6,17,1
5822,94897,ptoBkN66Bt2QtZB1aEXx1ZVYWGKSe4nx,fbPkOYLVPtPgIt0MxizjfFJov3JbHyAi,1,0,0,0,0,0,1,0,1,0.14285714285714285,1,0.0,0,0,0,0,0,0,0,1,0,0,1,1
5823,94899,MPudmBDzcFEF2aagd3l2b1PRQVVyLD4u,fbPkOYLVPtPgIt0MxizjfFJov3JbHyAi,5,2,0,0,1,0,2,0,5,0.7142857142857143,1,0.0,0,0,0,1,2,0,0,2,0,1,4,1
5824,94900,HVP9P5Zd2kxYJRMzpkNocUjuv68uFQwI,fbPkOYLVPtPgIt0MxizjfFJov3JbHyAi,6,3,2,0,2,0,1,0,8,1.1428571428571428,1,0.0,0,2,0,2,3,0,0,1,0,4,4,1
5825,94901,aubBvEAbqX7BozVoIow53sGF2mWzIMIJ,fbPkOYLVPtPgIt0MxizjfFJov3JbHyAi,5,2,1,0,1,0,2,0,6,0.8571428571428571,1,0.0,0,1,0,1,2,0,0,2,0,2,4,0
5826,94902,GHdZtrcnj4BHLMcbKc7PIRtO4HiPI7gx,fbPkOYLVPtPgIt0MxizjfFJov3JbHyAi,12,9,4,0,3,2,9,1,28,4.0,1,0.0,1,4,0,3,8,2,0,9,1,8,20,1
5827,94903,2s1w2v8MgoByNGqR51pltJWsiHzHAFZ1,fbPkOYLVPtPgIt0MxizjfFJov3JbHyAi,1,0,0,0,0,0,1,0,1,0.14285714285714285,1,0.0,0,0,0,0,0,0,0,1,0,0,1,1
5828,94904,zP3de4W3VukAs6WLm1x1S3emx69koHez,fbPkOYLVPtPgIt0MxizjfFJov3JbHyAi,3,2,2,0,2,0,0,0,6,0.8571428571428571,1,0.0,0,2,0,2,2,0,0,0,0,4,2,1
5829,94906,6h2GWoIPk8lzExVz7dA23INnjQamzPiM,fbPkOYLVPtPgIt0MxizjfFJov3JbHyAi,1,0,0,0,0,0,1,0,1,0.14285714285714285,1,0.0,0,0,0,0,0,0,0,1,0,0,1,1
5830,94907,1QDbOw54L9ILqqLZZw1ogQGZSzfmiXb1,fbPkOYLVPtPgIt0MxizjfFJov3JbHyAi,5,2,1,0,1,0,2,0,6,0.8571428571428571,1,0.0,0,1,0,1,2,0,0,2,0,2,4,1
5831,94908,Y0dtU5bUn0PrrnfgvOUCPfb1rktwn4CX,fbPkOYLVPtPgIt0MxizjfFJov3JbHyAi,6,3,1,0,1,0,2,0,7,1.0,1,0.0,0,1,0,1,3,0,0,2,0,2,5,1
5832,94909,jEziRvuSnNpPzYhab0XaMjLlQjk8N2oC,fbPkOYLVPtPgIt0MxizjfFJov3JbHyAi,1,0,0,0,0,0,1,0,1,0.14285714285714285,1,0.0,0,0,0,0,0,0,0,1,0,0,1,1
5833,94910,D2M0lUAbb3NbvYyEfkDkoqJ8mQHTb4db,fbPkOYLVPtPgIt0MxizjfFJov3JbHyAi,1,0,0,0,0,0,1,0,1,0.14285714285714285,1,0.0,0,0,0,0,0,0,0,1,0,0,1,1
5834,94912,xJAu7qb6Tiwmc8LLU0BWAbWEzmc3V9vv,fbPkOYLVPtPgIt0MxizjfFJov3JbHyAi,1,0,0,0,0,0,1,0,1,0.14285714285714285,1,0.0,0,0,0,0,0,0,0,1,0,0,1,1
5835,95219,79nK2Q1unvY6FmBQxEmzZl9QztvJiFFg,5Gyp41oLVo7Gg7vF4vpmggWP5MU70QO6,8,7,6,0,3,0,1,0,17,2.4285714285714284,1,0.0,0,6,0,3,7,0,0,1,0,9,8,1
5836,95236,sytnI5r8frh9Rwv3xWPhxTLCgzt44IsX,5Gyp41oLVo7Gg7vF4vpmggWP5MU70QO6,1,0,0,0,0,0,1,0,1,0.14285714285714285,1,0.0,0,0,0,0,0,0,0,1,0,0,1,1
5837,95262,wOkgiGT4mKEwfHAbFE5zBkC6tvq7dVH0,5Gyp41oLVo7Gg7vF4vpmggWP5MU70QO6,18,36,26,0,5,4,4,0,75,10.714285714285714,2,0.0,0,26,0,5,36,4,0,4,0,31,44,1
5838,95296,sSL46B3jCoU2n0oCLbbMc8KS0XOKM2e8,5Gyp41oLVo7Gg7vF4vpmggWP5MU70QO6,10,8,5,0,4,0,2,0,19,2.7142857142857144,1,0.0,2,5,0,4,6,0,0,2,0,11,8,1
5839,95800,XhN7QGypor4DcMvMWEJ3oRIi5DeJwYDV,SpATywNh6bZuzm8s1ceuBUnMUAeoAHHw,18,20,0,32,0,0,3,0,55,7.857142857142857,1,0.0,10,0,28,0,10,0,4,3,0,38,17,1
5840,95914,rTLMEQB78zn1g6bt6KRypanGZ8QWPbQv,A3fsA9Zfv1X2fVEQhTw51lKENdNrEqT3,15,19,1,18,1,11,4,0,54,7.714285714285714,1,0.0,1,1,13,1,18,11,5,4,0,16,38,0
5841,95946,VSxmvcFHrZIVtNnTaFw0qdfh1Zdl1LMy,SpATywNh6bZuzm8s1ceuBUnMUAeoAHHw,5,6,3,0,0,0,1,0,10,1.4285714285714286,1,0.0,2,3,0,0,4,0,0,1,0,5,5,0
5842,96133,gMMqUNqa2ZYLkCBhPE0t3hx9nA1CQadH,SpATywNh6bZuzm8s1ceuBUnMUAeoAHHw,9,13,7,0,1,0,6,0,27,3.857142857142857,4,0.0,2,7,0,1,11,0,0,6,0,10,17,0
5843,96140,QTgmoEmFx7yveY8D3dDCUQU4BnndurNn,RXDvfPUBYFlVdlueBFbLW0mhhAyGEqpt,12,10,4,10,3,0,2,0,29,4.142857142857143,1,0.0,2,4,10,3,8,0,0,2,0,19,10,0
5844,96145,EpjqZEwurfAejh2DegYmFyOcCfieF5bI,3VkHkmOtom3jM2wCu94xgzzu1d6Dn7or,10,6,5,0,4,0,2,0,17,2.4285714285714284,1,0.0,0,5,0,4,6,0,0,2,0,9,8,1
5845,96152,F9TuVQWNu6ofFAogW7rwyLlFT0z2eQyz,3VkHkmOtom3jM2wCu94xgzzu1d6Dn7or,6,2,1,0,1,0,5,0,9,1.2857142857142858,1,0.0,0,1,0,1,2,0,0,5,0,2,7,1
5846,96153,0KsRcnvH5KwYg9hQpDsfdDezVQYmpNaM,3VkHkmOtom3jM2wCu94xgzzu1d6Dn7or,12,14,4,10,5,0,1,0,34,4.857142857142857,1,0.0,8,4,8,5,6,0,2,1,0,25,9,1
5847,96157,HPunf0IeYEJIqhIcukHL5dSfwWXPJgdK,3VkHkmOtom3jM2wCu94xgzzu1d6Dn7or,7,23,2,5,5,8,4,0,47,6.714285714285714,3,0.0,16,2,4,5,7,8,1,4,0,27,20,1
5848,96161,xScCLVtmeGdEECHRus6S361DX011nviO,3VkHkmOtom3jM2wCu94xgzzu1d6Dn7or,2,0,0,0,0,0,2,0,2,0.2857142857142857,1,0.0,0,0,0,0,0,0,0,2,0,0,2,1
5849,96164,ifLFSwPKPCiTrnURcHdf9bSMBNoQjygW,3VkHkmOtom3jM2wCu94xgzzu1d6Dn7or,1,0,0,0,0,0,1,0,1,0.14285714285714285,1,0.0,0,0,0,0,0,0,0,1,0,0,1,1
5850,96166,vxyHJpAI3o1k0XhGwDw1sJWHtBHM2REM,3VkHkmOtom3jM2wCu94xgzzu1d6Dn7or,1,0,0,0,0,0,1,0,1,0.14285714285714285,1,0.0,0,0,0,0,0,0,0,1,0,0,1,0
5851,96171,Tb7ZmDk2KyMG2qBiHXFKty1zWlhwRH1T,3VkHkmOtom3jM2wCu94xgzzu1d6Dn7or,1,0,0,0,0,0,1,0,1,0.14285714285714285,1,0.0,0,0,0,0,0,0,0,1,0,0,1,1
5852,96173,QGD5Xr8KgGMTyo6VFc8iWuvDWsBcwrxS,3VkHkmOtom3jM2wCu94xgzzu1d6Dn7or,5,2,0,0,1,0,3,0,6,0.8571428571428571,1,0.0,0,0,0,1,2,0,0,3,0,1,5,1
5853,96174,NwBZTCsarBRtTlQQY0VswrANLhW8Le2H,3VkHkmOtom3jM2wCu94xgzzu1d6Dn7or,1,0,0,0,0,0,1,0,1,0.14285714285714285,1,0.0,0,0,0,0,0,0,0,1,0,0,1,1
5854,96176,tUWdsiUp6knC7kU2jL4tyFtEiCURn1SW,3VkHkmOtom3jM2wCu94xgzzu1d6Dn7or,5,2,1,0,1,0,4,0,8,1.1428571428571428,1,0.0,0,1,0,1,2,0,0,4,0,2,6,1
5855,96177,FjMcq9yRoNKJNqdekKiFpBJzde1EqvnP,3VkHkmOtom3jM2wCu94xgzzu1d6Dn7or,24,62,17,14,32,1,10,0,136,19.428571428571427,2,0.0,43,17,11,32,19,1,3,10,0,103,33,1
5856,96183,p0kTR9RrjwCaki8UXW8XKwPOKfeXqB9t,3VkHkmOtom3jM2wCu94xgzzu1d6Dn7or,7,17,5,0,2,0,2,0,26,3.7142857142857144,1,0.0,0,5,0,2,17,0,0,2,0,7,19,1
5857,96187,BuoBAMoQMp8n1QIpTX32C1cd62Qn82L1,3VkHkmOtom3jM2wCu94xgzzu1d6Dn7or,11,11,6,0,2,13,10,1,43,6.142857142857143,1,0.0,0,6,0,2,11,13,0,10,1,8,35,1
5858,96190,oQsM4aPF8H95oLBBQjkyuxP9zhQJyjlM,3VkHkmOtom3jM2wCu94xgzzu1d6Dn7or,4,0,0,0,0,0,5,0,5,0.7142857142857143,1,0.0,0,0,0,0,0,0,0,5,0,0,5,1
5859,96197,HN1X5hWlmOS9Eyiq9T0eFhd60qlqtaGd,3VkHkmOtom3jM2wCu94xgzzu1d6Dn7or,8,2,1,0,1,1,5,1,11,1.5714285714285714,1,0.0,0,1,0,1,2,1,0,5,1,2,9,1
5860,96199,k125nfhPC0c7Tj8cqemBvcT3s17rL1XV,3VkHkmOtom3jM2wCu94xgzzu1d6Dn7or,5,2,1,0,1,0,2,0,6,0.8571428571428571,1,0.0,0,1,0,1,2,0,0,2,0,2,4,1
5861,96209,XxFWC1ndYyndeKPLR0Tthjj3sQQ7nV1V,3VkHkmOtom3jM2wCu94xgzzu1d6Dn7or,5,2,1,0,1,0,3,0,7,1.0,1,0.0,1,1,0,1,1,0,0,3,0,3,4,1
5862,96212,0JURzmiKAgHEm3x2qt8dilXSiBiSlIMu,3VkHkmOtom3jM2wCu94xgzzu1d6Dn7or,1,0,0,0,0,0,2,0,2,0.2857142857142857,1,0.0,0,0,0,0,0,0,0,2,0,0,2,1
5863,96213,jemrZ1weClX8KV7zPk5woJnrTpOh61n0,3VkHkmOtom3jM2wCu94xgzzu1d6Dn7or,5,2,0,0,1,0,3,0,6,0.8571428571428571,1,0.0,0,0,0,1,2,0,0,3,0,1,5,1
5864,96216,enIqpTiaArtw9013z5nXb7q57WWqlRw8,3VkHkmOtom3jM2wCu94xgzzu1d6Dn7or,10,17,8,0,5,3,10,1,44,6.285714285714286,2,0.0,4,8,0,5,13,3,0,10,1,17,27,1
5865,96217,s32ltvD91SqP37xCuPcJTQUji5lNpoIV,3VkHkmOtom3jM2wCu94xgzzu1d6Dn7or,1,0,0,0,0,0,2,0,2,0.2857142857142857,1,0.0,0,0,0,0,0,0,0,2,0,0,2,1
5866,96219,9KIQhXtS8RtIL7nYiRgoTpvfFonnbdyd,3VkHkmOtom3jM2wCu94xgzzu1d6Dn7or,1,0,0,0,0,0,1,0,1,0.14285714285714285,1,0.0,0,0,0,0,0,0,0,1,0,0,1,1
5867,96223,Hd4RuYAWbJNyiFcVDOQm2YknhUCRzDpf,3VkHkmOtom3jM2wCu94xgzzu1d6Dn7or,1,0,0,0,0,0,1,0,1,0.14285714285714285,1,0.0,0,0,0,0,0,0,0,1,0,0,1,1
5868,96230,o36MAZxBelVYcOYv6Q6zU8d38AuIySQf,3VkHkmOtom3jM2wCu94xgzzu1d6Dn7or,19,35,14,16,11,0,3,0,79,11.285714285714286,1,0.0,14,14,13,11,21,0,3,3,0,52,27,1
5869,96234,VVanPUXAmmndxNeDO36jzzp8xTGXseE4,3VkHkmOtom3jM2wCu94xgzzu1d6Dn7or,4,2,1,0,1,2,2,0,8,1.1428571428571428,1,0.0,0,1,0,1,2,2,0,2,0,2,6,1
5870,96241,dqec3C87DYvOwA2QtgWO9A6JF4EynpzQ,3VkHkmOtom3jM2wCu94xgzzu1d6Dn7or,1,0,0,0,0,0,1,0,1,0.14285714285714285,1,0.0,0,0,0,0,0,0,0,1,0,0,1,1
5871,96243,2KYemNc303pEosq37WS18W9XF5RPdrua,3VkHkmOtom3jM2wCu94xgzzu1d6Dn7or,1,0,0,0,0,0,2,0,2,0.2857142857142857,1,0.0,0,0,0,0,0,0,0,2,0,0,2,1
5872,96247,vDcOI9R7bMY6xcvzTxgQszC65IhkS8Gn,3VkHkmOtom3jM2wCu94xgzzu1d6Dn7or,1,0,0,0,0,0,1,0,1,0.14285714285714285,1,0.0,0,0,0,0,0,0,0,1,0,0,1,1
5873,96248,4IuXpm9M2G6R6qZqtV7So8usupBmnRAv,3VkHkmOtom3jM2wCu94xgzzu1d6Dn7or,1,0,0,0,0,0,1,0,1,0.14285714285714285,1,0.0,0,0,0,0,0,0,0,1,0,0,1,1
5874,96250,NGakFmsdjK3lyw04RUw9CrZTM8YOC6oU,3VkHkmOtom3jM2wCu94xgzzu1d6Dn7or,1,0,0,0,0,0,2,0,2,0.2857142857142857,1,0.0,0,0,0,0,0,0,0,2,0,0,2,1
5875,96251,LQFHljzrAsSQnHGzwtY9GERnIvJpaIfZ,3VkHkmOtom3jM2wCu94xgzzu1d6Dn7or,6,6,4,0,0,1,1,0,12,1.7142857142857142,1,0.0,1,4,0,0,5,1,0,1,0,5,7,1
5876,96253,wxo6LeVD85cOB3C5PxOIhJqaQgZNOhP9,3VkHkmOtom3jM2wCu94xgzzu1d6Dn7or,4,2,0,0,0,0,6,0,8,1.1428571428571428,2,0.0,0,0,0,0,2,0,0,6,0,0,8,1
5877,96254,WUClwR7udRuyH0YY9SLxZfL5J9bhMeSZ,3VkHkmOtom3jM2wCu94xgzzu1d6Dn7or,6,2,0,0,1,0,4,1,8,1.1428571428571428,1,0.0,0,0,0,1,2,0,0,4,1,1,7,1
5878,96255,VnvhtlmCzMoaixFjpTOOEG5dQDcoFCrw,3VkHkmOtom3jM2wCu94xgzzu1d6Dn7or,1,0,0,0,0,0,1,0,1,0.14285714285714285,1,0.0,0,0,0,0,0,0,0,1,0,0,1,1
5879,96256,VbInVetDGFepZy5zTdpbn53n6APrskn4,3VkHkmOtom3jM2wCu94xgzzu1d6Dn7or,1,0,0,0,0,0,1,0,1,0.14285714285714285,1,0.0,0,0,0,0,0,0,0,1,0,0,1,1
5880,96258,nd7NWFrPYSuDFf8ksILMMLULZQyKWzkY,3VkHkmOtom3jM2wCu94xgzzu1d6Dn7or,1,0,0,0,0,0,1,0,1,0.14285714285714285,1,0.0,0,0,0,0,0,0,0,1,0,0,1,1
5881,96259,hv4qu378s3aJ0QFqXMOxECZKMBDzDvIa,3VkHkmOtom3jM2wCu94xgzzu1d6Dn7or,1,0,0,0,0,0,1,0,1,0.14285714285714285,1,0.0,0,0,0,0,0,0,0,1,0,0,1,1
5882,96260,4yn2X5ZyYGavHIACThFVdWrFmnpFRB99,3VkHkmOtom3jM2wCu94xgzzu1d6Dn7or,2,0,0,0,0,0,2,0,2,0.2857142857142857,1,0.0,0,0,0,0,0,0,0,2,0,0,2,1
5883,96270,GSkYUOcl4XzYMWSWhE6gXRGQ9kqPeXsi,3VkHkmOtom3jM2wCu94xgzzu1d6Dn7or,32,84,22,21,27,6,11,1,172,24.571428571428573,5,0.0,26,22,19,27,58,6,2,11,1,94,78,1
5884,96273,DIJZt928jSvLUGCtufmBeiAst7HxGgSA,3VkHkmOtom3jM2wCu94xgzzu1d6Dn7or,4,2,1,0,1,0,1,0,5,0.7142857142857143,1,0.0,0,1,0,1,2,0,0,1,0,2,3,1
5885,96276,Lciv47QTZ42EhHhkeATm1doKP6ppFu7V,3VkHkmOtom3jM2wCu94xgzzu1d6Dn7or,6,18,7,0,0,0,3,1,29,4.142857142857143,1,0.0,4,7,0,0,14,0,0,3,1,11,18,1
5886,96280,pC2oj7zUWjwJtppk4Aa8oLGERn6zDZKh,3VkHkmOtom3jM2wCu94xgzzu1d6Dn7or,4,2,0,0,0,0,2,0,4,0.5714285714285714,1,0.0,0,0,0,0,2,0,0,2,0,0,4,1
5887,96283,7FYMj2bFfaTXHKfoaKa59KqAPXY4BWgD,3VkHkmOtom3jM2wCu94xgzzu1d6Dn7or,5,4,2,0,2,0,2,0,10,1.4285714285714286,1,0.0,0,2,0,2,4,0,0,2,0,4,6,1
5888,96289,ZQSZgZ79Y2BI2kLu43mIPc6ox1OLMn3i,3VkHkmOtom3jM2wCu94xgzzu1d6Dn7or,4,0,0,0,0,0,4,2,6,0.8571428571428571,1,0.0,0,0,0,0,0,0,0,4,2,0,6,1
5889,96292,HVLgKKKtcJ5L0yKBrJ8PAnUtQgDtHaQR,3VkHkmOtom3jM2wCu94xgzzu1d6Dn7or,1,0,0,0,0,0,1,0,1,0.14285714285714285,1,0.0,0,0,0,0,0,0,0,1,0,0,1,1
5890,96294,fcuGfbsMcZPq5nDUeSqb2ubFCGZIHmtW,3VkHkmOtom3jM2wCu94xgzzu1d6Dn7or,1,0,0,0,0,0,2,0,2,0.2857142857142857,1,0.0,0,0,0,0,0,0,0,2,0,0,2,1
5891,96296,mrevUEj0qqWnyF0JW6tRN1rAdXv2xb2w,3VkHkmOtom3jM2wCu94xgzzu1d6Dn7or,1,0,0,0,0,0,1,0,1,0.14285714285714285,1,0.0,0,0,0,0,0,0,0,1,0,0,1,1
5892,96298,jiHCZRqZkTsaeaiJrCBkwE60LOZDz9gI,3VkHkmOtom3jM2wCu94xgzzu1d6Dn7or,7,13,0,0,2,0,3,0,18,2.5714285714285716,1,0.0,4,0,0,2,9,0,0,3,0,6,12,1
5893,96299,5KWxvKeP2OgpIZc77LcI9Rh8elyZt0my,3VkHkmOtom3jM2wCu94xgzzu1d6Dn7or,16,23,13,18,9,0,12,0,75,10.714285714285714,1,0.0,7,13,15,9,16,0,3,12,0,44,31,0
5894,96300,TqwsfzC7boA0P221nJEBMK29H7weQpBs,3VkHkmOtom3jM2wCu94xgzzu1d6Dn7or,5,2,1,0,1,0,3,0,7,1.0,1,0.0,0,1,0,1,2,0,0,3,0,2,5,1
5895,96303,ugLwOnoLMnp5lLbvFiuVUtR2inbX7VAT,3VkHkmOtom3jM2wCu94xgzzu1d6Dn7or,7,3,1,0,1,6,6,0,17,2.4285714285714284,1,0.0,1,1,0,1,2,6,0,6,0,3,14,1
5896,96306,i2EWiH0CFlZMNJNVHRgrCnauS8sHdput,3VkHkmOtom3jM2wCu94xgzzu1d6Dn7or,1,0,0,0,0,0,1,0,1,0.14285714285714285,1,0.0,0,0,0,0,0,0,0,1,0,0,1,1
5897,96307,9UHBYD92KFxNzIUjZQKJq8CqZXjf9mef,3VkHkmOtom3jM2wCu94xgzzu1d6Dn7or,96,137,77,65,63,43,34,6,425,60.714285714285715,7,0.0,42,77,62,63,95,43,3,34,6,244,181,0
5898,96309,BuuC3vRfx8lPYpdkNt2eTZulT2ntPSTH,3VkHkmOtom3jM2wCu94xgzzu1d6Dn7or,1,0,0,0,0,0,1,0,1,0.14285714285714285,1,0.0,0,0,0,0,0,0,0,1,0,0,1,1
5899,96311,Wvx341gv8V1C2xMRjBPZaA6fOxorW0PM,3VkHkmOtom3jM2wCu94xgzzu1d6Dn7or,5,2,1,0,1,0,3,0,7,1.0,1,0.0,0,1,0,1,2,0,0,3,0,2,5,1
5900,96315,dz3e3Uyw3EAB6Btb7QoVpBpCs6OCzIuw,3VkHkmOtom3jM2wCu94xgzzu1d6Dn7or,2,0,0,0,0,0,2,0,2,0.2857142857142857,1,0.0,0,0,0,0,0,0,0,2,0,0,2,1
5901,96318,jPQeG3XrSBRtKeFBAHg0JvoXUpHLqvxV,3VkHkmOtom3jM2wCu94xgzzu1d6Dn7or,22,25,11,25,7,12,11,1,92,13.142857142857142,3,0.0,7,11,20,7,18,12,5,11,1,45,47,1
5902,96321,nzf1dZvOOKMtaa1xMnxXB5GkolA267M6,3VkHkmOtom3jM2wCu94xgzzu1d6Dn7or,1,0,0,0,0,0,1,0,1,0.14285714285714285,1,0.0,0,0,0,0,0,0,0,1,0,0,1,1
5903,96322,sY5SceKMJchdbCG2gcUOx5nPMQZzzchQ,3VkHkmOtom3jM2wCu94xgzzu1d6Dn7or,9,4,3,0,3,1,2,0,13,1.8571428571428572,1,0.0,0,3,0,3,4,1,0,2,0,6,7,1
5904,96324,38Y5CIobqNij4aFj76KLUasVvJOAQreZ,3VkHkmOtom3jM2wCu94xgzzu1d6Dn7or,7,4,2,0,2,0,1,0,9,1.2857142857142858,1,0.0,0,2,0,2,4,0,0,1,0,4,5,0
5905,96325,cbr7l5LRDro7CQI0JgaOyUPn8YUM9mv4,3VkHkmOtom3jM2wCu94xgzzu1d6Dn7or,5,2,1,0,1,0,2,0,6,0.8571428571428571,1,0.0,0,1,0,1,2,0,0,2,0,2,4,1
5906,96326,XQ8cWjfBil2LbS40q1iPWrRfwwjzsyVe,3VkHkmOtom3jM2wCu94xgzzu1d6Dn7or,4,6,1,0,2,0,1,0,10,1.4285714285714286,1,0.0,4,1,0,2,2,0,0,1,0,7,3,1
5907,96330,IsCsJjW0xDH4DkKzQKYzHRG4YkMfGi73,3VkHkmOtom3jM2wCu94xgzzu1d6Dn7or,1,0,0,0,0,0,1,0,1,0.14285714285714285,1,0.0,0,0,0,0,0,0,0,1,0,0,1,1
5908,96332,gnDGjS7KmDkjYE8QuMSS8QSW2uwA8L2y,3VkHkmOtom3jM2wCu94xgzzu1d6Dn7or,11,14,5,2,1,6,14,3,45,6.428571428571429,3,0.0,5,5,2,1,9,6,0,14,3,13,32,1
5909,96336,KVFfyYQkCECkqD82goRD9L6cGhnG7Yyt,3VkHkmOtom3jM2wCu94xgzzu1d6Dn7or,6,3,0,0,0,0,4,0,7,1.0,1,0.0,0,0,0,0,3,0,0,4,0,0,7,1
5910,96337,V5BtTNWswVFdas9RLHSBN2Sbe7Es4see,3VkHkmOtom3jM2wCu94xgzzu1d6Dn7or,4,3,1,0,1,0,2,0,7,1.0,1,0.0,1,1,0,1,2,0,0,2,0,3,4,1
5911,96347,va1EzyjrhfrQWrnpm0UcU0zhmwje0Lgb,3VkHkmOtom3jM2wCu94xgzzu1d6Dn7or,5,5,2,0,1,0,2,0,10,1.4285714285714286,1,0.0,1,2,0,1,4,0,0,2,0,4,6,1
5912,96356,FrKCsz7lUcZcU4f2ChSSwOYLHLmQEGxw,3VkHkmOtom3jM2wCu94xgzzu1d6Dn7or,2,0,0,0,0,0,3,0,3,0.42857142857142855,1,0.0,0,0,0,0,0,0,0,3,0,0,3,1
5913,96359,wgSnyXkWmu1gNrkJBMgrRILNAVbfvmPX,3VkHkmOtom3jM2wCu94xgzzu1d6Dn7or,1,0,0,0,0,0,1,0,1,0.14285714285714285,1,0.0,0,0,0,0,0,0,0,1,0,0,1,1
5914,96360,r1v9Rqdep6YVAEXtpRWpkWLslSlgtgyb,3VkHkmOtom3jM2wCu94xgzzu1d6Dn7or,9,19,9,3,2,4,6,0,43,6.142857142857143,4,0.0,3,9,3,2,16,4,0,6,0,17,26,1
5915,96361,hl0OrMfg8qb0yyqeozXaj4TvTbuGpido,3VkHkmOtom3jM2wCu94xgzzu1d6Dn7or,9,13,4,6,6,4,2,0,35,5.0,1,0.0,8,4,5,6,5,4,1,2,0,23,12,1
5916,96367,edy112jDFW9DTLKi2j4yvX37GTSpr4ji,3VkHkmOtom3jM2wCu94xgzzu1d6Dn7or,1,0,0,0,0,0,1,0,1,0.14285714285714285,1,0.0,0,0,0,0,0,0,0,1,0,0,1,1
5917,96369,HD3PNAwAfxdbe7DkvZFjEY40On4EuqxT,3VkHkmOtom3jM2wCu94xgzzu1d6Dn7or,14,30,6,9,12,14,7,0,78,11.142857142857142,2,0.0,20,6,8,12,10,14,1,7,0,46,32,1
5918,96376,djS2tkJzIFUgqNP65BM4kBmvLLZqxLTs,3VkHkmOtom3jM2wCu94xgzzu1d6Dn7or,1,0,0,0,0,0,1,0,1,0.14285714285714285,1,0.0,0,0,0,0,0,0,0,1,0,0,1,1
5919,96379,Vp9lRrKpqmph3iHMmH4MjHMh07OftdBq,3VkHkmOtom3jM2wCu94xgzzu1d6Dn7or,5,4,2,0,1,0,1,0,8,1.1428571428571428,1,0.0,1,2,0,1,3,0,0,1,0,4,4,1
5920,96380,OArwi6O7ZSY2JiImeK6Sw889sg5iYN6Y,3VkHkmOtom3jM2wCu94xgzzu1d6Dn7or,1,0,0,0,0,0,1,0,1,0.14285714285714285,1,0.0,0,0,0,0,0,0,0,1,0,0,1,1
5921,96381,iL9NYNmkyKSSFCPovatPYzIBkey4ylbA,3VkHkmOtom3jM2wCu94xgzzu1d6Dn7or,8,9,1,0,0,8,10,2,30,4.285714285714286,3,0.0,0,1,0,0,9,8,0,10,2,1,29,1
5922,96383,FN0V2FJ9PwsmZe2ZdtFoTzNeftwa8lew,3VkHkmOtom3jM2wCu94xgzzu1d6Dn7or,9,9,4,0,2,0,9,2,26,3.7142857142857144,2,0.0,0,4,0,2,9,0,0,9,2,6,20,1
5923,96388,dMh9VQWRTEnyJkdA9ZgMhWwk39W1YoGN,5Gyp41oLVo7Gg7vF4vpmggWP5MU70QO6,6,7,2,0,0,0,2,0,11,1.5714285714285714,1,0.0,0,2,0,0,7,0,0,2,0,2,9,1
5924,96390,fh4EphLYeMlLWCufiQCSaFg5RdIvqYBV,5Gyp41oLVo7Gg7vF4vpmggWP5MU70QO6,1,0,0,0,0,0,1,0,1,0.14285714285714285,1,0.0,0,0,0,0,0,0,0,1,0,0,1,1
5925,96396,uyCMGQSqEQvYxE6kgiaGm8rp27K2cF85,5Gyp41oLVo7Gg7vF4vpmggWP5MU70QO6,6,7,2,0,1,0,2,0,12,1.7142857142857142,2,0.0,2,2,0,1,5,0,0,2,0,5,7,1
5926,96413,5DRvlJpYdsNcR7W5S4ju0uYQggyV8RF5,5Gyp41oLVo7Gg7vF4vpmggWP5MU70QO6,6,6,3,0,1,0,5,0,15,2.142857142857143,1,0.0,0,3,0,1,6,0,0,5,0,4,11,1
5927,96416,XBSdQamsYfYzRRGJOjuRsFmDekzUw4cN,5Gyp41oLVo7Gg7vF4vpmggWP5MU70QO6,1,0,0,0,0,0,5,0,5,0.7142857142857143,1,0.0,0,0,0,0,0,0,0,5,0,0,5,1
5928,96417,1fnSOOLCTFBv8NWbv5KvTMP3hNiHfhMm,5Gyp41oLVo7Gg7vF4vpmggWP5MU70QO6,1,0,0,0,0,0,1,0,1,0.14285714285714285,1,0.0,0,0,0,0,0,0,0,1,0,0,1,1
5929,96426,9ks3PZ71xYTBAZWZYwlGI227xICme3uh,5Gyp41oLVo7Gg7vF4vpmggWP5MU70QO6,12,16,3,2,2,4,5,4,36,5.142857142857143,1,0.0,11,3,1,2,5,4,1,5,4,17,19,1
5930,96431,gxbFv3w2jQEcMCjTw3OnX3xWd7iwkno0,5Gyp41oLVo7Gg7vF4vpmggWP5MU70QO6,7,4,2,0,2,0,2,0,10,1.4285714285714286,1,0.0,1,2,0,2,3,0,0,2,0,5,5,1
5931,96436,y4LP6KF7rlCesbjS04VFZcr0ymkouqgg,5Gyp41oLVo7Gg7vF4vpmggWP5MU70QO6,7,4,3,0,3,5,2,0,17,2.4285714285714284,1,0.0,0,3,0,3,4,5,0,2,0,6,11,1
5932,96451,S6bQyU4k68cqK5Df4ggJFdi0hXWY7bCC,5Gyp41oLVo7Gg7vF4vpmggWP5MU70QO6,5,2,1,0,1,0,2,0,6,0.8571428571428571,1,0.0,0,1,0,1,2,0,0,2,0,2,4,1
5933,96452,hFUpdiu0hiElLF0SXpu1AulvsOusYwtZ,5Gyp41oLVo7Gg7vF4vpmggWP5MU70QO6,5,2,1,0,1,0,3,0,7,1.0,2,0.0,0,1,0,1,2,0,0,3,0,2,5,1
5934,96456,MTcsFewP5AKdKhm7WCconI2PZnyN3f4Z,5Gyp41oLVo7Gg7vF4vpmggWP5MU70QO6,53,273,150,140,0,146,73,1,783,111.85714285714286,10,0.0,74,150,122,0,199,146,18,73,1,346,437,0
5935,96521,GsNM4TyneJcBYzqDnENCIQOXXKxG2eoA,3VkHkmOtom3jM2wCu94xgzzu1d6Dn7or,1,0,0,0,0,0,1,0,1,0.14285714285714285,1,0.0,0,0,0,0,0,0,0,1,0,0,1,1
5936,96523,qRAJTkZTejCgaeZ2sDW9z6ux0t3hIJMg,3VkHkmOtom3jM2wCu94xgzzu1d6Dn7or,3,0,0,0,0,0,3,0,3,0.42857142857142855,1,0.0,0,0,0,0,0,0,0,3,0,0,3,1
5937,96526,9QIuhIwuEfvjrogqfeXyXDUQ326P7Asr,3VkHkmOtom3jM2wCu94xgzzu1d6Dn7or,2,0,0,0,0,0,3,0,3,0.42857142857142855,1,0.0,0,0,0,0,0,0,0,3,0,0,3,1
5938,96531,lrTVGatgf5mQLoKfT4trphORRE8M2Lmv,3VkHkmOtom3jM2wCu94xgzzu1d6Dn7or,1,0,0,0,0,0,2,0,2,0.2857142857142857,1,0.0,0,0,0,0,0,0,0,2,0,0,2,1
5939,96534,iu8ePW2eHhIFt7cF9xnAgFVNtmK9UR7o,3VkHkmOtom3jM2wCu94xgzzu1d6Dn7or,1,0,0,0,0,0,2,0,2,0.2857142857142857,1,0.0,0,0,0,0,0,0,0,2,0,0,2,1
5940,96535,SeyzjTb3TS9yTnfBxQfVoL7HGCyZcMCL,3VkHkmOtom3jM2wCu94xgzzu1d6Dn7or,1,0,0,0,0,0,2,0,2,0.2857142857142857,1,0.0,0,0,0,0,0,0,0,2,0,0,2,1
5941,96538,Ww89bCEdnDOyx3DV7lSMxZ7xDgYSNYQx,3VkHkmOtom3jM2wCu94xgzzu1d6Dn7or,10,11,5,8,3,2,1,0,30,4.285714285714286,1,0.0,4,5,8,3,7,2,0,1,0,20,10,1
5942,96540,Zr4KLz2ZL4aSF5gVvs5p4LZP1ixAwF6u,3VkHkmOtom3jM2wCu94xgzzu1d6Dn7or,3,0,0,0,0,0,9,0,9,1.2857142857142858,2,0.0,0,0,0,0,0,0,0,9,0,0,9,1
5943,96545,B8YSdLCC0chY0Hi4gF9muFLFGnW5Xq1P,3VkHkmOtom3jM2wCu94xgzzu1d6Dn7or,1,0,0,0,0,0,2,0,2,0.2857142857142857,1,0.0,0,0,0,0,0,0,0,2,0,0,2,1
5944,96547,zO2VhcAdoh7T24EwLrFAZi7hmwyyObxP,3VkHkmOtom3jM2wCu94xgzzu1d6Dn7or,1,0,0,0,0,0,1,0,1,0.14285714285714285,1,0.0,0,0,0,0,0,0,0,1,0,0,1,1
5945,96548,LoEfaid2dOKAK1Vb6WcaGJbgN3PRNGde,3VkHkmOtom3jM2wCu94xgzzu1d6Dn7or,4,3,0,0,0,2,3,0,8,1.1428571428571428,1,0.0,0,0,0,0,3,2,0,3,0,0,8,1
5946,96549,2GpzbExHhNiUBsVX3aGUe0zSsA9C387Y,3VkHkmOtom3jM2wCu94xgzzu1d6Dn7or,1,0,0,0,0,0,1,0,1,0.14285714285714285,1,0.0,0,0,0,0,0,0,0,1,0,0,1,1
5947,96550,ktRWKuIjdpuGKecjIEnR5Rs4zTq2yQBS,3VkHkmOtom3jM2wCu94xgzzu1d6Dn7or,1,0,0,0,0,0,1,0,1,0.14285714285714285,1,0.0,0,0,0,0,0,0,0,1,0,0,1,1
5948,96558,3alUhWh257mQM5A6onXPn87mqMwnY8ws,3VkHkmOtom3jM2wCu94xgzzu1d6Dn7or,8,4,3,0,3,6,10,0,26,3.7142857142857144,1,0.0,0,3,0,3,4,6,0,10,0,6,20,1
5949,96564,8CwT8vsJoNqbQ5sYHbMaosIT6QTdlZQK,3VkHkmOtom3jM2wCu94xgzzu1d6Dn7or,1,0,0,0,0,0,1,0,1,0.14285714285714285,1,0.0,0,0,0,0,0,0,0,1,0,0,1,1
5950,96565,7v36SwdiAdGk2npG7GYc4bVA9RjB8aXw,3VkHkmOtom3jM2wCu94xgzzu1d6Dn7or,1,0,0,0,0,0,1,0,1,0.14285714285714285,1,0.0,0,0,0,0,0,0,0,1,0,0,1,1
5951,96566,teqJGecOr4a6oVYU1O9bgvPkX5ZSKA8N,3VkHkmOtom3jM2wCu94xgzzu1d6Dn7or,8,12,4,0,0,0,10,0,26,3.7142857142857144,5,0.0,0,4,0,0,12,0,0,10,0,4,22,0
5952,96567,eFsmemBDYKCubbpvK6bophBz57DeDjI9,3VkHkmOtom3jM2wCu94xgzzu1d6Dn7or,1,0,0,0,0,0,1,0,1,0.14285714285714285,1,0.0,0,0,0,0,0,0,0,1,0,0,1,1
5953,96568,NXw20imLsAftkOEQqnCfW2uf1rtofEIi,3VkHkmOtom3jM2wCu94xgzzu1d6Dn7or,6,4,2,0,1,1,5,0,13,1.8571428571428572,2,0.0,0,2,0,1,4,1,0,5,0,3,10,1
5954,96569,xd7l7laJViRCqeNwQVN9cYaqt6r2YTd2,3VkHkmOtom3jM2wCu94xgzzu1d6Dn7or,1,0,0,0,0,0,1,0,1,0.14285714285714285,1,0.0,0,0,0,0,0,0,0,1,0,0,1,1
5955,96575,lvrPjshCS0gfAMCRmI8ZLxwWMZI7lhjD,3VkHkmOtom3jM2wCu94xgzzu1d6Dn7or,10,8,4,0,4,0,1,0,17,2.4285714285714284,1,0.0,3,4,0,4,5,0,0,1,0,11,6,1
5956,96577,aqQTf2fLQrJTXefctm75awHMgV3chcLI,3VkHkmOtom3jM2wCu94xgzzu1d6Dn7or,1,0,0,0,0,0,3,0,3,0.42857142857142855,1,0.0,0,0,0,0,0,0,0,3,0,0,3,1
5957,96578,CE7hlTWnMpoldcHVRqlfbEgzp5iUVo4d,3VkHkmOtom3jM2wCu94xgzzu1d6Dn7or,3,0,0,0,0,0,4,0,4,0.5714285714285714,1,0.0,0,0,0,0,0,0,0,4,0,0,4,0
5958,96583,5uoh3HG1nDrMYi2dFveKtERmpEDthN7L,3VkHkmOtom3jM2wCu94xgzzu1d6Dn7or,1,0,0,0,0,0,1,0,1,0.14285714285714285,1,0.0,0,0,0,0,0,0,0,1,0,0,1,1
5959,96585,c9MO50fCrzTuPsgkVZzuZukx5s3e1d2Y,3VkHkmOtom3jM2wCu94xgzzu1d6Dn7or,1,0,0,0,0,0,1,0,1,0.14285714285714285,1,0.0,0,0,0,0,0,0,0,1,0,0,1,1
5960,96586,Jwp0ikLYvBh16g1GJtBqW8Bd54uiA7Uz,3VkHkmOtom3jM2wCu94xgzzu1d6Dn7or,1,0,0,0,0,0,1,0,1,0.14285714285714285,1,0.0,0,0,0,0,0,0,0,1,0,0,1,1
5961,96587,hiNjDCDcv1JzPRBZRj9QRfU9Ul6vxYgf,3VkHkmOtom3jM2wCu94xgzzu1d6Dn7or,3,2,1,0,0,0,2,0,5,0.7142857142857143,1,0.0,0,1,0,0,2,0,0,2,0,1,4,1
5962,96593,7J9JIWVCQG1g6yXh3uTVbrSu3pa18Ezn,3VkHkmOtom3jM2wCu94xgzzu1d6Dn7or,1,0,0,0,0,0,1,0,1,0.14285714285714285,1,0.0,0,0,0,0,0,0,0,1,0,0,1,1
5963,96603,9CnuQIK7YosyuV5lXuwH1YTrUdbaqPIO,3VkHkmOtom3jM2wCu94xgzzu1d6Dn7or,5,7,1,0,1,0,2,0,11,1.5714285714285714,1,0.0,2,1,0,1,5,0,0,2,0,4,7,1
5964,96619,T1h2nTClvb4u9mmdikxybWqwSGostm2v,3VkHkmOtom3jM2wCu94xgzzu1d6Dn7or,1,0,0,0,0,0,1,0,1,0.14285714285714285,1,0.0,0,0,0,0,0,0,0,1,0,0,1,1
5965,96621,NqKjMSY6eOZQ1uSyzlPrquJVqzjvSO7O,3VkHkmOtom3jM2wCu94xgzzu1d6Dn7or,71,171,73,48,61,35,28,1,417,59.57142857142857,12,0.0,71,73,45,61,100,35,3,28,1,250,167,0
5966,96623,DJB5Gl1Ovn2tbiU0joVyu71nUzKvtrAo,3VkHkmOtom3jM2wCu94xgzzu1d6Dn7or,1,0,0,0,0,0,2,0,2,0.2857142857142857,1,0.0,0,0,0,0,0,0,0,2,0,0,2,1
5967,96624,qj7FoMMGmyXc2ttIpiKyiqMFyCbPSMfU,3VkHkmOtom3jM2wCu94xgzzu1d6Dn7or,2,0,0,0,0,18,1,0,19,2.7142857142857144,1,0.0,0,0,0,0,0,18,0,1,0,0,19,0
5968,96627,Fpcn3j59JqdD0go2D9Vju0pFtowXD5t1,3VkHkmOtom3jM2wCu94xgzzu1d6Dn7or,1,0,0,0,0,0,1,0,1,0.14285714285714285,1,0.0,0,0,0,0,0,0,0,1,0,0,1,1
5969,96629,XdPJbYAaOfGSV0DPxyepFBgYITJMqd0Q,3VkHkmOtom3jM2wCu94xgzzu1d6Dn7or,1,0,0,0,0,0,1,0,1,0.14285714285714285,1,0.0,0,0,0,0,0,0,0,1,0,0,1,1
5970,96630,WCDAUZlSmVenqZi8jFXHKvaZIO2xMNrN,3VkHkmOtom3jM2wCu94xgzzu1d6Dn7or,6,5,1,0,0,0,4,1,11,1.5714285714285714,1,0.0,3,1,0,0,2,0,0,4,1,4,7,1
5971,96638,TQ1Tb2cgiG68xs6aUf696l3C3zHYq6fS,3VkHkmOtom3jM2wCu94xgzzu1d6Dn7or,27,83,31,36,25,1,13,0,189,27.0,6,0.0,35,31,30,25,48,1,6,13,0,121,68,0
5972,96644,8wUaJS3OiPlXPEpMaUdmFJpYr0YDMidI,3VkHkmOtom3jM2wCu94xgzzu1d6Dn7or,3,0,0,0,0,2,2,1,5,0.7142857142857143,1,0.0,0,0,0,0,0,2,0,2,1,0,5,1
5973,96650,EWz1Knm7j4qPyfsJuTJMybXhniKlG4fK,3VkHkmOtom3jM2wCu94xgzzu1d6Dn7or,46,79,35,0,33,1,14,1,163,23.285714285714285,5,0.0,31,35,0,33,48,1,0,14,1,99,64,1
5974,96660,K4jFJfgJGqdXK7Z4hAXFjX8nyCsKhSvR,3VkHkmOtom3jM2wCu94xgzzu1d6Dn7or,1,0,0,0,0,0,1,0,1,0.14285714285714285,1,0.0,0,0,0,0,0,0,0,1,0,0,1,1
5975,96665,u3pW4VoOLnKXXznAopRdzC3HjISbRije,bWdj2GDclj5ofokWjzoa5jAwMkxCykd6,9,13,8,0,1,0,9,0,31,4.428571428571429,1,0.0,0,8,0,1,13,0,0,9,0,9,22,1
5976,96690,PNuCKnyPWCRVxphTjJ1pIquyKu0dURK7,RXDvfPUBYFlVdlueBFbLW0mhhAyGEqpt,1,0,0,0,0,0,1,0,1,0.14285714285714285,1,0.0,0,0,0,0,0,0,0,1,0,0,1,1
5977,96694,GklpxWvYTAVCee485ZamCcjaSU51nZj5,SpATywNh6bZuzm8s1ceuBUnMUAeoAHHw,1,0,0,0,0,0,1,0,1,0.14285714285714285,1,0.0,0,0,0,0,0,0,0,1,0,0,1,1
5978,96698,kfq7KT5bB5EYh8pOfijeZyMqCV9XlzvB,RXDvfPUBYFlVdlueBFbLW0mhhAyGEqpt,108,109,77,190,49,22,17,10,474,67.71428571428571,4,0.0,20,77,173,49,89,22,17,17,10,319,155,0
5979,96703,6xGDraSqeqntwVZEzFmkXhdYujPnB4LO,bWdj2GDclj5ofokWjzoa5jAwMkxCykd6,5,2,0,0,0,0,4,0,6,0.8571428571428571,2,0.0,0,0,0,0,2,0,0,4,0,0,6,1
5980,96713,b45zb6rgcFvlQYxgSSxpvRcImBdsbXNp,SpATywNh6bZuzm8s1ceuBUnMUAeoAHHw,5,2,1,0,1,0,2,0,6,0.8571428571428571,1,0.0,0,1,0,1,2,0,0,2,0,2,4,1
5981,96720,nyH7Jx4kN1AdDJdwkZQoUDqYoovHgbk5,SpATywNh6bZuzm8s1ceuBUnMUAeoAHHw,5,3,2,0,1,0,1,0,7,1.0,1,0.0,0,2,0,1,3,0,0,1,0,3,4,1
5982,96722,DbjDF1tOy1lx5nslzqXmkcQc1dR90TPF,bWdj2GDclj5ofokWjzoa5jAwMkxCykd6,17,15,10,0,8,2,10,1,46,6.571428571428571,2,0.0,2,10,0,8,13,2,0,10,1,20,26,1
5983,96733,tMJpDv6ZjEPz2ELzUVp4mZTT6G7u49T6,SpATywNh6bZuzm8s1ceuBUnMUAeoAHHw,4,2,1,0,1,0,1,0,5,0.7142857142857143,1,0.0,0,1,0,1,2,0,0,1,0,2,3,1
5984,96734,fAZJvvaqILemW9qqdyo0ZQidn1S9S3J8,RXDvfPUBYFlVdlueBFbLW0mhhAyGEqpt,18,21,1,58,1,0,3,6,90,12.857142857142858,1,0.0,2,1,54,1,19,0,4,3,6,58,32,1
5985,96740,UOssUZDJcaoIiaAH8nTbzjrXIWUHSQSA,5X6FeZozNMgE2VRi3MJYjkkFK8SETtu2,5,7,3,2,1,0,2,0,15,2.142857142857143,2,0.0,2,3,2,1,5,0,0,2,0,8,7,1
5986,96743,FRLanjUzKW4rWwV5FL1637YVNyKuRrXY,G8EPVSXsOYB5YQWZGiz1aVq5Pgr2GrQu,2,0,0,0,0,0,2,0,2,0.2857142857142857,1,0.0,0,0,0,0,0,0,0,2,0,0,2,1
5987,96764,7ITppmxIJuiv2qwirt1AUPH7whJqqqHK,bWdj2GDclj5ofokWjzoa5jAwMkxCykd6,4,1,0,0,0,0,3,0,4,0.5714285714285714,1,0.0,0,0,0,0,1,0,0,3,0,0,4,1
5988,96776,Q2sM7xUZ5pftXbE3pDquUzMiyNyEc1IS,SpATywNh6bZuzm8s1ceuBUnMUAeoAHHw,9,4,3,0,2,0,3,0,12,1.7142857142857142,1,0.0,0,3,0,2,4,0,0,3,0,5,7,1
5989,96793,sr8A7s2BlClhUz4NJffXtRDNVcz1ockZ,G8EPVSXsOYB5YQWZGiz1aVq5Pgr2GrQu,2,0,0,0,0,0,2,0,2,0.2857142857142857,1,0.0,0,0,0,0,0,0,0,2,0,0,2,1
5990,96802,lk035YDNwEm5whK0h05D7Y9rnoNxjcmm,G8EPVSXsOYB5YQWZGiz1aVq5Pgr2GrQu,5,3,0,0,0,0,5,0,8,1.1428571428571428,1,0.0,0,0,0,0,3,0,0,5,0,0,8,1
5991,96804,ySbpVhOvpB9MuHEn2lEoeA4d5zRYukkl,bWdj2GDclj5ofokWjzoa5jAwMkxCykd6,7,3,2,0,2,0,2,0,9,1.2857142857142858,1,0.0,0,2,0,2,3,0,0,2,0,4,5,1
5992,96805,l5LcQXaXypTaa8UtbYyDr1XartlmUM1X,A3fsA9Zfv1X2fVEQhTw51lKENdNrEqT3,71,16,12,254,9,0,6,0,297,42.42857142857143,1,0.0,3,12,222,9,13,0,32,6,0,246,51,1
5993,96815,VeDeV6aD6kowERv1ygPjE9YEMgMJMOAv,SpATywNh6bZuzm8s1ceuBUnMUAeoAHHw,5,4,0,0,0,1,3,0,8,1.1428571428571428,1,0.0,1,0,0,0,3,1,0,3,0,1,7,0
5994,96818,ULdF32fTmMpV957Ngz6P80D0kuxYFb2A,SpATywNh6bZuzm8s1ceuBUnMUAeoAHHw,19,10,8,7,6,0,11,1,43,6.142857142857143,2,0.0,2,8,7,6,8,0,0,11,1,23,20,0
5995,96830,2RZRnBZq03ynZpoq39fa7eCt5EQoKRyi,SpATywNh6bZuzm8s1ceuBUnMUAeoAHHw,5,3,0,0,0,0,2,0,5,0.7142857142857143,1,0.0,0,0,0,0,3,0,0,2,0,0,5,1
5996,96837,Y0YamNoipgJ1ygcQIdzGiH4SNlabFh17,A3fsA9Zfv1X2fVEQhTw51lKENdNrEqT3,5,2,1,0,1,0,4,0,8,1.1428571428571428,2,0.0,0,1,0,1,2,0,0,4,0,2,6,1
5997,96842,LdBDSA1JN40omRgUCX83gwfcPGCdnUpp,SpATywNh6bZuzm8s1ceuBUnMUAeoAHHw,1,0,0,0,0,0,1,0,1,0.14285714285714285,1,0.0,0,0,0,0,0,0,0,1,0,0,1,0
5998,96846,M8C9BDFICk4ida59GU0jjp556zazDEi1,5X6FeZozNMgE2VRi3MJYjkkFK8SETtu2,5,3,2,0,1,0,1,0,7,1.0,1,0.0,0,2,0,1,3,0,0,1,0,3,4,1
5999,96873,cD5CJQRtTCG0McZYvErqx6oV3tTvutc8,RXDvfPUBYFlVdlueBFbLW0mhhAyGEqpt,1,0,0,0,0,0,1,0,1,0.14285714285714285,1,0.0,0,0,0,0,0,0,0,1,0,0,1,1
6000,96878,em6ahWcMRmenNOPIHJ0IxuoaSlBI3zdC,5X6FeZozNMgE2VRi3MJYjkkFK8SETtu2,5,2,1,0,1,0,2,0,6,0.8571428571428571,1,0.0,0,1,0,1,2,0,0,2,0,2,4,1
6001,96886,DBX65PxBJF0vtcBiyRL7bV1O21H4mRXM,SpATywNh6bZuzm8s1ceuBUnMUAeoAHHw,45,37,22,31,13,2,9,2,116,16.571428571428573,2,0.0,7,22,27,13,30,2,4,9,2,69,47,0
6002,96902,U74IyVXcSeKcVNZXE9AVeORjHrqTX1QT,bWdj2GDclj5ofokWjzoa5jAwMkxCykd6,6,9,0,0,1,0,7,0,17,2.4285714285714284,1,0.0,2,0,0,1,7,0,0,7,0,3,14,1
6003,96922,Pcryla0IgY2rOY0iESPNV3PdGPGcwgwQ,SpATywNh6bZuzm8s1ceuBUnMUAeoAHHw,2,0,0,0,0,0,2,0,2,0.2857142857142857,1,0.0,0,0,0,0,0,0,0,2,0,0,2,1
6004,96932,RdNoFjcCRsxTOOSC7N4ELIdxTaySGrVr,SpATywNh6bZuzm8s1ceuBUnMUAeoAHHw,23,28,15,16,7,0,8,0,74,10.571428571428571,5,0.0,6,15,15,7,22,0,1,8,0,43,31,0
6005,96970,JJDkGcMTxDtJkwoP4HDunO8MvFfCRHjv,G8EPVSXsOYB5YQWZGiz1aVq5Pgr2GrQu,18,15,4,16,4,0,2,0,41,5.857142857142857,1,0.0,10,4,8,4,5,0,8,2,0,26,15,1
6006,96981,lWM0T55BVqig0BJS7dua8PmdCMELT35Y,SpATywNh6bZuzm8s1ceuBUnMUAeoAHHw,22,23,4,0,4,2,11,0,44,6.285714285714286,2,0.0,0,4,0,4,23,2,0,11,0,8,36,0
6007,97016,MSXFOc30HZVbYZtATkSJwT5euFO05BA1,A3fsA9Zfv1X2fVEQhTw51lKENdNrEqT3,1,0,0,0,0,0,1,0,1,0.14285714285714285,1,0.0,0,0,0,0,0,0,0,1,0,0,1,1
6008,97025,Wf4JyezR0jRlT8v2vkx1xi1JNRFq0xEi,G8EPVSXsOYB5YQWZGiz1aVq5Pgr2GrQu,5,2,1,0,1,0,2,0,6,0.8571428571428571,1,0.0,0,1,0,1,2,0,0,2,0,2,4,1
6009,97060,XlT7X7Rn0fLTh36Iz42hC1Epd5u3ukUS,A3fsA9Zfv1X2fVEQhTw51lKENdNrEqT3,2,0,0,0,0,0,3,0,3,0.42857142857142855,1,0.0,0,0,0,0,0,0,0,3,0,0,3,1
6010,97074,DwUUs9JZigOshXSWTSc43CdDGD0UXHS0,A3fsA9Zfv1X2fVEQhTw51lKENdNrEqT3,1,0,0,0,0,0,1,0,1,0.14285714285714285,1,0.0,0,0,0,0,0,0,0,1,0,0,1,1
6011,97117,c8WJAdYLV71mOx4ZXSglpCNd0dBUR3Om,7GRhBDsirIGkRZBtSMEzNTyDr2JQm4xx,21,15,7,20,4,0,3,0,49,7.0,2,0.0,5,7,19,4,10,0,1,3,0,35,14,0
6012,97118,4qkLaALORr1a036cib5fpJjiu97UEMIR,A3fsA9Zfv1X2fVEQhTw51lKENdNrEqT3,3,2,0,0,0,0,1,0,3,0.42857142857142855,1,0.0,0,0,0,0,2,0,0,1,0,0,3,0
6013,97201,XDng1mliVGDk6IontbBqBdoGZnODrUp1,A3fsA9Zfv1X2fVEQhTw51lKENdNrEqT3,4,2,0,0,0,1,7,0,10,1.4285714285714286,1,0.0,0,0,0,0,2,1,0,7,0,0,10,1
6014,97214,9HiOT9GgvrP1q1oAqpQLpBir7zKJrsoX,A3fsA9Zfv1X2fVEQhTw51lKENdNrEqT3,43,47,26,0,16,0,5,0,94,13.428571428571429,2,0.0,0,26,0,16,47,0,0,5,0,42,52,0
6015,97248,NoR9mkFsH1bv284uzLHF1usaPKto2GOu,5X6FeZozNMgE2VRi3MJYjkkFK8SETtu2,5,2,1,0,1,0,2,0,6,0.8571428571428571,1,0.0,0,1,0,1,2,0,0,2,0,2,4,1
6016,97263,7xpmz6LF4dl35fFKZgRU70OZyF8UO4PL,A3fsA9Zfv1X2fVEQhTw51lKENdNrEqT3,6,3,2,0,1,0,2,0,8,1.1428571428571428,1,0.0,0,2,0,1,3,0,0,2,0,3,5,0
6017,97276,4sSRGcSDSLzxYWcglxw7d9PzYXxgOT88,A3fsA9Zfv1X2fVEQhTw51lKENdNrEqT3,1,0,0,0,0,0,1,0,1,0.14285714285714285,1,0.0,0,0,0,0,0,0,0,1,0,0,1,1
6018,97290,6HdK3GMcDECpURp0hr8iCkrI8mDzaH0T,A3fsA9Zfv1X2fVEQhTw51lKENdNrEqT3,4,5,1,0,1,0,1,0,8,1.1428571428571428,1,0.0,1,1,0,1,4,0,0,1,0,3,5,1
6019,97304,yUo0f8mA9XEAtzr6kcSUh5ydpzcuIcml,5X6FeZozNMgE2VRi3MJYjkkFK8SETtu2,9,10,2,0,3,0,3,0,18,2.5714285714285716,1,0.0,5,2,0,3,5,0,0,3,0,10,8,1
6020,97314,CabsQjb2Sd2I3ynTdtsErAG67rLex08f,5X6FeZozNMgE2VRi3MJYjkkFK8SETtu2,22,36,2,27,15,4,5,3,92,13.142857142857142,1,0.0,24,2,22,15,12,4,5,5,3,63,29,0
6021,97321,LCbgvnPLqp4sLOznBVH7hp4sgd755glC,A3fsA9Zfv1X2fVEQhTw51lKENdNrEqT3,1,0,0,0,0,0,1,0,1,0.14285714285714285,1,0.0,0,0,0,0,0,0,0,1,0,0,1,1
6022,97338,6nY1NKnNZjXTuu3STCQuLqvZK441BMSh,A3fsA9Zfv1X2fVEQhTw51lKENdNrEqT3,9,4,3,0,3,0,2,0,12,1.7142857142857142,1,0.0,0,3,0,3,4,0,0,2,0,6,6,1
6023,97383,mCG6A82geHUNInyyr8XpxXWG9opXSIn8,A3fsA9Zfv1X2fVEQhTw51lKENdNrEqT3,2,0,0,0,0,0,2,0,2,0.2857142857142857,1,0.0,0,0,0,0,0,0,0,2,0,0,2,1
6024,97428,92TVODkqWtTMaGGihgBsUR7wsg2cHNWw,A3fsA9Zfv1X2fVEQhTw51lKENdNrEqT3,29,29,23,2,15,39,31,4,143,20.428571428571427,3,0.0,0,23,2,15,29,39,0,31,4,40,103,1
6025,97489,gSg4PIaWl0hBhOgVlpN9o8YrQn4pTOeq,A3fsA9Zfv1X2fVEQhTw51lKENdNrEqT3,3,2,1,0,0,0,1,0,4,0.5714285714285714,1,0.0,0,1,0,0,2,0,0,1,0,1,3,1
6026,97490,gSg4PIaWl0hBhOgVlpN9o8YrQn4pTOeq,5X6FeZozNMgE2VRi3MJYjkkFK8SETtu2,1,0,0,0,0,0,1,0,1,0.14285714285714285,1,0.0,0,0,0,0,0,0,0,1,0,0,1,1
6027,97503,kuZwBvEdgeUtKZ495C2FptBbxEtLtmVH,A3fsA9Zfv1X2fVEQhTw51lKENdNrEqT3,116,86,46,208,27,0,10,0,377,53.857142857142854,4,0.0,3,46,190,27,83,0,18,10,0,266,111,0
6028,97515,pzCTwt0ZOXglZvlGS3lVvI03ZM6KLXP8,A3fsA9Zfv1X2fVEQhTw51lKENdNrEqT3,2,0,0,0,0,0,2,0,2,0.2857142857142857,1,0.0,0,0,0,0,0,0,0,2,0,0,2,1
6029,97542,zanAvKU2mdWyY3mDD8TfWW4Mldy5ZoKh,A3fsA9Zfv1X2fVEQhTw51lKENdNrEqT3,2,0,0,0,0,0,2,0,2,0.2857142857142857,1,0.0,0,0,0,0,0,0,0,2,0,0,2,1
6030,97558,hdh7f9dbamC5OLbnjQIw5ciTwmy2oqSe,5X6FeZozNMgE2VRi3MJYjkkFK8SETtu2,1,0,0,0,0,0,1,0,1,0.14285714285714285,1,0.0,0,0,0,0,0,0,0,1,0,0,1,1
6031,97594,dw4lgaN9P3PyU0MHPWHpyVDf4mzTc9ng,A3fsA9Zfv1X2fVEQhTw51lKENdNrEqT3,5,2,1,0,1,0,2,0,6,0.8571428571428571,1,0.0,0,1,0,1,2,0,0,2,0,2,4,1
6032,97610,s1R28bKWEj15blBL1mUk4SpYHehZMU5V,A3fsA9Zfv1X2fVEQhTw51lKENdNrEqT3,2,0,0,0,0,0,2,0,2,0.2857142857142857,1,0.0,0,0,0,0,0,0,0,2,0,0,2,0
6033,97651,V2x3aryl9UEOOA9YqVFbOW3AEmLe65no,A3fsA9Zfv1X2fVEQhTw51lKENdNrEqT3,1,0,0,0,0,0,1,0,1,0.14285714285714285,1,0.0,0,0,0,0,0,0,0,1,0,0,1,1
6034,97677,ckLHKK3LLJ1ODiI07ljHA4kEITYOAMp6,A3fsA9Zfv1X2fVEQhTw51lKENdNrEqT3,1,0,0,0,0,0,3,0,3,0.42857142857142855,1,0.0,0,0,0,0,0,0,0,3,0,0,3,1
6035,97687,c4t4dDJowOpIlN13FksSkOjvFA7x8JRq,A3fsA9Zfv1X2fVEQhTw51lKENdNrEqT3,1,0,0,0,0,0,1,0,1,0.14285714285714285,1,0.0,0,0,0,0,0,0,0,1,0,0,1,1
6036,97722,bi9mZp6NegzS3n1ijbBhkJh3tVlhmPEB,5X6FeZozNMgE2VRi3MJYjkkFK8SETtu2,23,47,31,0,30,1,10,1,120,17.142857142857142,1,0.0,12,31,0,30,35,1,0,10,1,73,47,1
6037,97750,PlRR5bewxY5s5UPrV9qsB2qkDqRzxPQw,A3fsA9Zfv1X2fVEQhTw51lKENdNrEqT3,7,3,2,0,2,0,2,0,9,1.2857142857142858,1,0.0,0,2,0,2,3,0,0,2,0,4,5,0
6038,97757,0w9tP8TINgzfbBeYFJprB82ry0PjYiWn,5X6FeZozNMgE2VRi3MJYjkkFK8SETtu2,7,7,1,0,2,0,3,0,13,1.8571428571428572,2,0.0,0,1,0,2,7,0,0,3,0,3,10,1
6039,97786,0fNJ0SS62hGz3ZSBrf8T7bV9piGb2j0E,A3fsA9Zfv1X2fVEQhTw51lKENdNrEqT3,1,0,0,0,0,0,1,0,1,0.14285714285714285,1,0.0,0,0,0,0,0,0,0,1,0,0,1,1
6040,97851,IZaYyCVwq1dThwi2oxpAeUsxd0yreRPl,A3fsA9Zfv1X2fVEQhTw51lKENdNrEqT3,9,7,3,0,0,1,7,0,18,2.5714285714285716,1,0.0,0,3,0,0,7,1,0,7,0,3,15,0
6041,97857,MvNnLQma2eBM9bCcMIR159XYSNp8VREs,5X6FeZozNMgE2VRi3MJYjkkFK8SETtu2,2,0,0,0,0,0,3,0,3,0.42857142857142855,1,0.0,0,0,0,0,0,0,0,3,0,0,3,1
6042,97863,hShVfXi5CDkkf6vDlaLmVJ6jHLXUmY8S,A3fsA9Zfv1X2fVEQhTw51lKENdNrEqT3,4,2,0,0,0,0,4,0,6,0.8571428571428571,1,0.0,0,0,0,0,2,0,0,4,0,0,6,1
6043,97868,MUERAHHFAKMlIE27Ma0uSdeN9dFIyDRi,5X6FeZozNMgE2VRi3MJYjkkFK8SETtu2,1,0,0,0,0,0,1,0,1,0.14285714285714285,1,0.0,0,0,0,0,0,0,0,1,0,0,1,1
6044,97877,PJSchCVoi1SmaEdfj33PHnlCFqCBlPgo,A3fsA9Zfv1X2fVEQhTw51lKENdNrEqT3,10,5,4,0,3,0,2,0,14,2.0,1,0.0,0,4,0,3,5,0,0,2,0,7,7,0
6045,97896,R4QfQe4PmvrG0dbyyhP6sFUlip9zHR1c,5X6FeZozNMgE2VRi3MJYjkkFK8SETtu2,16,28,12,4,9,3,5,0,61,8.714285714285714,1,0.0,14,12,4,9,14,3,0,5,0,39,22,1
6046,97931,DH7DKFu2MLGxg6jCvSwsLzCjgZSx5Z86,3VkHkmOtom3jM2wCu94xgzzu1d6Dn7or,1,0,0,0,0,0,1,0,1,0.14285714285714285,1,0.0,0,0,0,0,0,0,0,1,0,0,1,1
6047,97942,Su4rPXbScaVX4fzvhj5AapJGbVpuaceg,3VkHkmOtom3jM2wCu94xgzzu1d6Dn7or,12,23,8,8,10,8,13,0,70,10.0,2,0.0,11,8,6,10,12,8,2,13,0,35,35,1
6048,97961,abHh79QCH3cAl6oc7JOEcMNp91qTsryP,3VkHkmOtom3jM2wCu94xgzzu1d6Dn7or,4,2,1,0,1,0,2,0,6,0.8571428571428571,1,0.0,0,1,0,1,2,0,0,2,0,2,4,1
6049,97962,FXVpQoS8mavqcQRGTmrN03ngBkUOH7AA,3VkHkmOtom3jM2wCu94xgzzu1d6Dn7or,1,0,0,0,0,0,1,0,1,0.14285714285714285,1,0.0,0,0,0,0,0,0,0,1,0,0,1,1
6050,97973,IdbptVxItEcsF1HvcM0Mmm9AW3Imyhv4,3VkHkmOtom3jM2wCu94xgzzu1d6Dn7or,4,2,1,0,1,0,2,0,6,0.8571428571428571,1,0.0,0,1,0,1,2,0,0,2,0,2,4,1
6051,97985,KQj2hgE2ypBs8W61al6mmutfgVYIXLIV,3VkHkmOtom3jM2wCu94xgzzu1d6Dn7or,37,33,20,0,19,3,5,0,80,11.428571428571429,4,0.0,2,20,0,19,31,3,0,5,0,41,39,1
6052,97996,ekFVtCGXV5hw4F7qgGu3EcqujoRSFaUy,3VkHkmOtom3jM2wCu94xgzzu1d6Dn7or,68,135,58,62,53,10,31,0,349,49.857142857142854,4,0.0,57,58,56,53,78,10,6,31,0,224,125,0
6053,98004,F3GLSw15emSxn0kSxBiNH7N0nonK3ccg,3VkHkmOtom3jM2wCu94xgzzu1d6Dn7or,52,132,59,41,53,4,21,1,311,44.42857142857143,9,0.0,47,59,37,53,85,4,4,21,1,196,115,0
6054,98005,iLTYp02qFAAV2qBSc8l9MXAqYasJue82,3VkHkmOtom3jM2wCu94xgzzu1d6Dn7or,21,73,8,17,27,1,8,1,135,19.285714285714285,1,0.0,65,8,13,27,8,1,4,8,1,113,22,1
6055,98041,O6NVBS42QfKnEkcEp9sxd9PQKWghi03h,3VkHkmOtom3jM2wCu94xgzzu1d6Dn7or,5,2,1,0,1,0,2,0,6,0.8571428571428571,1,0.0,0,1,0,1,2,0,0,2,0,2,4,1
6056,98061,HiXatwK463mZWTAoFtPIGdI6o88cs6JU,3VkHkmOtom3jM2wCu94xgzzu1d6Dn7or,4,0,0,0,0,0,6,1,7,1.0,2,0.0,0,0,0,0,0,0,0,6,1,0,7,1
6057,98079,NpsYCkB9qwElqIzB8hvyypgPvRPJPFEs,3VkHkmOtom3jM2wCu94xgzzu1d6Dn7or,1,0,0,0,0,0,1,0,1,0.14285714285714285,1,0.0,0,0,0,0,0,0,0,1,0,0,1,1
6058,98108,xrGttsK9FjNRictE1FckUAFqkfpHfKEh,3VkHkmOtom3jM2wCu94xgzzu1d6Dn7or,5,2,1,0,1,0,2,0,6,0.8571428571428571,2,0.0,0,1,0,1,2,0,0,2,0,2,4,0
6059,98112,kfSRJPL1TGKPwFhYhFu7dFMoFH9Opw3m,3VkHkmOtom3jM2wCu94xgzzu1d6Dn7or,5,4,2,0,2,0,2,0,10,1.4285714285714286,1,0.0,0,2,0,2,4,0,0,2,0,4,6,1
6060,98124,ofKU7RB0CJhUieHQIGlGpj4cWDFTK6Cp,3VkHkmOtom3jM2wCu94xgzzu1d6Dn7or,16,30,3,15,6,0,6,0,60,8.571428571428571,3,0.0,8,3,15,6,22,0,0,6,0,32,28,1
6061,98126,DJ09O49b2a0ZKXkFKbGfN66X8003c5sz,3VkHkmOtom3jM2wCu94xgzzu1d6Dn7or,84,332,142,60,55,28,142,0,759,108.42857142857143,21,0.0,59,142,57,55,273,28,3,142,0,313,446,0
6062,98132,OTtK3oVdmZjTM28AzfshWEpsqiUcaY6A,3VkHkmOtom3jM2wCu94xgzzu1d6Dn7or,5,3,1,0,1,0,1,0,6,0.8571428571428571,1,0.0,0,1,0,1,3,0,0,1,0,2,4,1
6063,98157,n9Ui0WELrqThG18Jlxrr7AX4pRXpl9u1,3VkHkmOtom3jM2wCu94xgzzu1d6Dn7or,9,6,2,0,3,0,2,0,13,1.8571428571428572,1,0.0,0,2,0,3,6,0,0,2,0,5,8,1
6064,98161,svJq0UCXpGBLwUQhJN7jJEKUexhbG6kO,3VkHkmOtom3jM2wCu94xgzzu1d6Dn7or,1,0,0,0,0,0,1,0,1,0.14285714285714285,1,0.0,0,0,0,0,0,0,0,1,0,0,1,1
6065,98163,LPvjHBHzMdJFhBtRez5c8W5vjeymkJ4Y,3VkHkmOtom3jM2wCu94xgzzu1d6Dn7or,21,10,8,0,8,2,4,0,32,4.571428571428571,3,0.0,0,8,0,8,10,2,0,4,0,16,16,1
6066,98168,lUOW63ZIGkmagy3rVXMv25n4vumPKUfs,3VkHkmOtom3jM2wCu94xgzzu1d6Dn7or,75,206,105,70,72,18,38,2,511,73.0,14,0.0,57,105,61,72,149,18,9,38,2,295,216,0
6067,98171,dfdxTZ0k85MRDx2z2M9cbXSWjNPaVqdD,3VkHkmOtom3jM2wCu94xgzzu1d6Dn7or,27,66,28,43,34,1,3,0,175,25.0,1,0.0,33,28,40,34,33,1,3,3,0,135,40,0
6068,98174,3JEt0I9b0JhZhM0RD2D5jI5S8zjjeHFo,3VkHkmOtom3jM2wCu94xgzzu1d6Dn7or,55,87,36,55,21,9,33,8,249,35.57142857142857,8,0.0,35,36,55,21,52,9,0,33,8,147,102,0
6069,98179,QFY0u8BcX8zpFgHdurnyNvsfdg75qGHG,3VkHkmOtom3jM2wCu94xgzzu1d6Dn7or,5,3,2,0,2,0,2,0,9,1.2857142857142858,2,0.0,0,2,0,2,3,0,0,2,0,4,5,1
6070,98198,fWWnaleFjqoRqdH3ZH66iQeRGSeBXDX6,3VkHkmOtom3jM2wCu94xgzzu1d6Dn7or,11,13,1,2,5,4,7,1,33,4.714285714285714,1,0.0,6,1,2,5,7,4,0,7,1,14,19,1
6071,98234,baSoH5iOtjeW8QOvk4jsMg08MFliVLZE,3VkHkmOtom3jM2wCu94xgzzu1d6Dn7or,1,0,0,0,0,0,1,0,1,0.14285714285714285,1,0.0,0,0,0,0,0,0,0,1,0,0,1,1
6072,98263,yNC8T7gdWO96Y2q3tzTQeJUMY0F51xnO,3VkHkmOtom3jM2wCu94xgzzu1d6Dn7or,1,0,0,0,0,0,1,0,1,0.14285714285714285,1,0.0,0,0,0,0,0,0,0,1,0,0,1,0
6073,98273,fUXC3xLfSBf2MlyFHIvuCpzPsd9ArwN8,3VkHkmOtom3jM2wCu94xgzzu1d6Dn7or,1,0,0,0,0,0,1,0,1,0.14285714285714285,1,0.0,0,0,0,0,0,0,0,1,0,0,1,1
6074,98282,syoACpxjYIAbt5Q9DbJe0XoRSZFCMIid,3VkHkmOtom3jM2wCu94xgzzu1d6Dn7or,1,0,0,0,0,0,1,0,1,0.14285714285714285,1,0.0,0,0,0,0,0,0,0,1,0,0,1,1
6075,98298,12oMVExdBsAQTQgYFzO3qgxIkmuiT5Bx,3VkHkmOtom3jM2wCu94xgzzu1d6Dn7or,2,0,0,0,0,0,2,0,2,0.2857142857142857,2,0.0,0,0,0,0,0,0,0,2,0,0,2,0
6076,98300,INOLlVwqw5TvyA71S1bSzF7TuwVv7t6I,3VkHkmOtom3jM2wCu94xgzzu1d6Dn7or,55,120,57,46,48,28,54,2,355,50.714285714285715,7,0.0,51,57,39,48,69,28,7,54,2,195,160,0
6077,98301,D1OZc3K6Vn8pIDyF5hDs13BdGQm44o4J,3VkHkmOtom3jM2wCu94xgzzu1d6Dn7or,1,0,0,0,0,0,1,0,1,0.14285714285714285,1,0.0,0,0,0,0,0,0,0,1,0,0,1,1
6078,98343,M9bfqF0nvJt1IlnydnHJT3twRigs4PVw,3VkHkmOtom3jM2wCu94xgzzu1d6Dn7or,1,0,0,0,0,0,1,0,1,0.14285714285714285,1,0.0,0,0,0,0,0,0,0,1,0,0,1,1
6079,98359,XoDsvRe6R9Ra3m3bjZvXwisFgW37uCyt,3VkHkmOtom3jM2wCu94xgzzu1d6Dn7or,27,49,13,13,21,12,15,1,124,17.714285714285715,2,0.0,34,13,12,21,15,12,1,15,1,80,44,1
6080,98364,yP5aDzTZNqvnJatDbGJMvAzkQQHAJnEq,3VkHkmOtom3jM2wCu94xgzzu1d6Dn7or,34,32,29,0,25,0,3,0,89,12.714285714285714,4,0.0,0,29,0,25,32,0,0,3,0,54,35,1
6081,98392,K0OSl2yDmHYQ9TtZdxy9shErNwx3ga0n,3VkHkmOtom3jM2wCu94xgzzu1d6Dn7or,57,129,19,46,12,1,31,3,241,34.42857142857143,10,0.0,78,19,42,12,51,1,4,31,3,151,90,0
6082,98396,yybWJ0SDHBTVHqp2W9MlgsXiEKhnq5ZK,3VkHkmOtom3jM2wCu94xgzzu1d6Dn7or,1,0,0,0,0,0,1,0,1,0.14285714285714285,1,0.0,0,0,0,0,0,0,0,1,0,0,1,1
6083,98399,kAH6V7JzDoLq5AdXMqvLO78igpFvmPcb,3VkHkmOtom3jM2wCu94xgzzu1d6Dn7or,76,140,45,72,55,6,32,0,350,50.0,7,0.0,80,45,59,55,60,6,13,32,0,239,111,1
6084,98457,hfdZ8fSzTj8jJZaq6vM5x271LYekhHqn,3VkHkmOtom3jM2wCu94xgzzu1d6Dn7or,42,27,21,0,19,0,5,3,75,10.714285714285714,3,0.0,1,21,0,19,26,0,0,5,3,41,34,1
6085,98464,ivAfZ9dFFVTP8vOevev8NwgjV7DAmXVl,3VkHkmOtom3jM2wCu94xgzzu1d6Dn7or,7,9,3,0,3,0,4,0,19,2.7142857142857144,1,0.0,4,3,0,3,5,0,0,4,0,10,9,1
6086,98493,NIy8cNrKgyIVG1jqrgkoRXiAb8eTFOie,3VkHkmOtom3jM2wCu94xgzzu1d6Dn7or,21,53,16,26,17,16,19,2,149,21.285714285714285,2,0.0,27,16,24,17,26,16,2,19,2,84,65,1
6087,98502,PYCd6eKOLWWCug2Fb5EugiwVglo4NNfG,3VkHkmOtom3jM2wCu94xgzzu1d6Dn7or,7,2,2,0,2,0,4,0,10,1.4285714285714286,1,0.0,0,2,0,2,2,0,0,4,0,4,6,1
6088,98513,vQhsm5tD21COEAZuKXUqgoA1GtcgDISI,3VkHkmOtom3jM2wCu94xgzzu1d6Dn7or,7,15,3,0,2,5,3,0,28,4.0,1,0.0,2,3,0,2,13,5,0,3,0,7,21,1
6089,98525,PqaQvxweV5eGBMoHluyfcHT8mUURx05w,3VkHkmOtom3jM2wCu94xgzzu1d6Dn7or,4,4,1,0,2,0,1,0,8,1.1428571428571428,1,0.0,2,1,0,2,2,0,0,1,0,5,3,1
6090,98529,GEnJuBoc4JfLjpvLdKpsVzcpMG2Q9J7E,3VkHkmOtom3jM2wCu94xgzzu1d6Dn7or,24,73,11,30,30,22,25,0,191,27.285714285714285,6,0.0,50,11,26,30,23,22,4,25,0,117,74,1
6091,98532,Nc9p0NDSJdMFoXyGCYKlMLXQtm4qOOTX,3VkHkmOtom3jM2wCu94xgzzu1d6Dn7or,6,9,3,0,0,0,10,0,22,3.142857142857143,2,0.0,1,3,0,0,8,0,0,10,0,4,18,1
6092,98544,Z9zdAxugb9Zp4KyDDbKjBMesWfaV1jbd,3VkHkmOtom3jM2wCu94xgzzu1d6Dn7or,1,0,0,0,0,0,1,0,1,0.14285714285714285,1,0.0,0,0,0,0,0,0,0,1,0,0,1,1
6093,98558,NJ4JsHxTiShzME3OoTaAwV982D1L0qYe,3VkHkmOtom3jM2wCu94xgzzu1d6Dn7or,7,1,1,0,1,0,7,1,11,1.5714285714285714,1,0.0,0,1,0,1,1,0,0,7,1,2,9,1
6094,98574,M04H6w8EedYYL8dzBlYNubNPviTfROgN,3VkHkmOtom3jM2wCu94xgzzu1d6Dn7or,9,4,2,0,1,0,8,1,16,2.2857142857142856,2,0.0,0,2,0,1,4,0,0,8,1,3,13,1
6095,98593,0R9xJ1Ysb1ln5d8A0NbqaetP5LST3PYV,3VkHkmOtom3jM2wCu94xgzzu1d6Dn7or,6,2,1,0,1,0,4,1,9,1.2857142857142858,1,0.0,0,1,0,1,2,0,0,4,1,2,7,1
6096,98594,YbXDR0OWqjazkhydYVY2vq3vuaW6LGOY,3VkHkmOtom3jM2wCu94xgzzu1d6Dn7or,16,19,8,2,4,5,15,6,59,8.428571428571429,3,0.0,2,8,2,4,17,5,0,15,6,16,43,1
6097,98596,FK87Mh9LEgwj1VU4pstPcNLLVrRCTWuM,3VkHkmOtom3jM2wCu94xgzzu1d6Dn7or,6,7,4,0,2,2,7,0,22,3.142857142857143,1,0.0,0,4,0,2,7,2,0,7,0,6,16,1
6098,98610,WauTNyXQDm07IKr6oOotK9PP7wOCBLGL,3VkHkmOtom3jM2wCu94xgzzu1d6Dn7or,11,12,7,0,3,0,8,0,30,4.285714285714286,1,0.0,0,7,0,3,12,0,0,8,0,10,20,1
6099,98611,vCnaR7A3EMdV2eOQ4pBMh0byIjK5VwLE,3VkHkmOtom3jM2wCu94xgzzu1d6Dn7or,1,0,0,0,0,0,2,0,2,0.2857142857142857,2,0.0,0,0,0,0,0,0,0,2,0,0,2,1
6100,98660,CjkpbyAkfq9IEZ4dECDMjQUz889YMW0T,3VkHkmOtom3jM2wCu94xgzzu1d6Dn7or,5,2,1,0,1,4,2,0,10,1.4285714285714286,2,0.0,1,1,0,1,1,4,0,2,0,3,7,1
6101,98683,zK6w0JPDDeUD403WVGuxpKSbry9d8uLr,3VkHkmOtom3jM2wCu94xgzzu1d6Dn7or,1,0,0,0,0,0,1,0,1,0.14285714285714285,1,0.0,0,0,0,0,0,0,0,1,0,0,1,1
6102,98702,HdyIyDlcCFQQgaRjYU1638Ek6DgB899m,3VkHkmOtom3jM2wCu94xgzzu1d6Dn7or,1,0,0,0,0,0,1,0,1,0.14285714285714285,1,0.0,0,0,0,0,0,0,0,1,0,0,1,1
6103,98706,gyzBiYUIth0uJrJ5jqofLffLv4otg9kt,3VkHkmOtom3jM2wCu94xgzzu1d6Dn7or,11,6,4,0,3,0,5,0,18,2.5714285714285716,3,0.0,0,4,0,3,6,0,0,5,0,7,11,1
6104,98727,W8qIdYmrLlNNGLHbIczo12Ny6o42zzQ6,3VkHkmOtom3jM2wCu94xgzzu1d6Dn7or,1,0,0,0,0,0,3,0,3,0.42857142857142855,2,0.0,0,0,0,0,0,0,0,3,0,0,3,1
6105,98728,pQbIHrUkI2ft0gnLvneTDpzQduYYGvpn,3VkHkmOtom3jM2wCu94xgzzu1d6Dn7or,6,4,2,0,1,3,3,0,13,1.8571428571428572,1,0.0,0,2,0,1,4,3,0,3,0,3,10,1
6106,98801,98cD0nIIzlQtn9XgJ5GQHEPFcRF6H0SJ,3VkHkmOtom3jM2wCu94xgzzu1d6Dn7or,4,0,0,0,0,7,3,6,16,2.2857142857142856,1,0.0,0,0,0,0,0,7,0,3,6,0,16,1
6107,98814,b5P6aIah2j5gpMQtJOr9oA1Fmrt673Ev,3VkHkmOtom3jM2wCu94xgzzu1d6Dn7or,1,0,0,0,0,0,2,0,2,0.2857142857142857,1,0.0,0,0,0,0,0,0,0,2,0,0,2,1
6108,98825,HcEVK6JSNpXgsr4SEhprpFsKVHZEZVKm,3VkHkmOtom3jM2wCu94xgzzu1d6Dn7or,1,0,0,0,0,0,1,0,1,0.14285714285714285,1,0.0,0,0,0,0,0,0,0,1,0,0,1,1
6109,98861,KQr8qfRCCQ78DrpyWmyHWiqFZ2EzyK3m,3VkHkmOtom3jM2wCu94xgzzu1d6Dn7or,13,8,5,0,5,9,8,7,42,6.0,2,0.0,0,5,0,5,8,9,0,8,7,10,32,1
6110,98884,eu6zKq8qzWqsJoxjMZQiC4ZsBj3GH9NO,3VkHkmOtom3jM2wCu94xgzzu1d6Dn7or,8,5,3,0,2,6,8,0,24,3.4285714285714284,1,0.0,0,3,0,2,5,6,0,8,0,5,19,1
6111,98886,1bdqW93lrID3dEzePAg75ShXgDY2dgi4,3VkHkmOtom3jM2wCu94xgzzu1d6Dn7or,6,0,0,0,0,0,8,1,9,1.2857142857142858,1,0.0,0,0,0,0,0,0,0,8,1,0,9,1
6112,98889,nduTNjBA0lu6oAy3nBgCpw4zMm9X5e5A,3VkHkmOtom3jM2wCu94xgzzu1d6Dn7or,1,0,0,0,0,0,1,0,1,0.14285714285714285,1,0.0,0,0,0,0,0,0,0,1,0,0,1,1
6113,98898,DpHQO3KmNTyYhc4I0Q72w62csKSCNKTH,3VkHkmOtom3jM2wCu94xgzzu1d6Dn7or,5,6,1,0,0,0,5,0,12,1.7142857142857142,1,0.0,0,1,0,0,6,0,0,5,0,1,11,1
6114,98907,ukGlYmEa0KHeCpCJEgEgxOmqtWR3OurB,3VkHkmOtom3jM2wCu94xgzzu1d6Dn7or,13,40,11,10,1,19,13,2,96,13.714285714285714,2,0.0,7,11,8,1,33,19,2,13,2,27,69,1
6115,98915,GarDXRFXxX5iF1KQFXPHCsoEYMeoE46I,3VkHkmOtom3jM2wCu94xgzzu1d6Dn7or,1,0,0,0,0,0,1,0,1,0.14285714285714285,1,0.0,0,0,0,0,0,0,0,1,0,0,1,1
6116,98920,iB31LIPYOOKdvqRLTA6oqQg1uWKX3cVM,3VkHkmOtom3jM2wCu94xgzzu1d6Dn7or,1,0,0,0,0,0,1,0,1,0.14285714285714285,1,0.0,0,0,0,0,0,0,0,1,0,0,1,1
6117,98934,SFnIK5WBQ1x9v2jhd3whYpbMvj804ymA,3VkHkmOtom3jM2wCu94xgzzu1d6Dn7or,4,2,0,0,0,0,2,0,4,0.5714285714285714,1,0.0,0,0,0,0,2,0,0,2,0,0,4,1
6118,98940,IvSFszPnr18KVZKYGSQ6sSbo1mXQ0RkU,3VkHkmOtom3jM2wCu94xgzzu1d6Dn7or,3,2,1,0,0,0,1,0,4,0.5714285714285714,1,0.0,0,1,0,0,2,0,0,1,0,1,3,1
6119,99029,qg6GOCuPcDwehPMMAEed7GZuAdyiaV9B,bWdj2GDclj5ofokWjzoa5jAwMkxCykd6,8,15,1,18,0,0,7,0,41,5.857142857142857,6,0.0,1,1,15,0,14,0,3,7,0,17,24,0
6120,99181,3gKLDpGjwKizSsdfJ1bxm4OzkmE9SSv0,G8EPVSXsOYB5YQWZGiz1aVq5Pgr2GrQu,5,4,2,0,0,0,4,0,10,1.4285714285714286,1,0.0,0,2,0,0,4,0,0,4,0,2,8,1
6121,99253,8i7cvJkHkgdZTPaFAtgMAW0lWMM44P2s,bWdj2GDclj5ofokWjzoa5jAwMkxCykd6,11,14,5,12,0,0,1,0,32,4.571428571428571,1,0.0,5,5,12,0,9,0,0,1,0,22,10,0
6122,99344,JbEjxQ5AsXJ2R3WBH2hwFnQgUiz9YCm1,RXDvfPUBYFlVdlueBFbLW0mhhAyGEqpt,49,103,20,55,20,13,15,1,227,32.42857142857143,4,0.0,42,20,55,20,61,13,0,15,1,137,90,0
6123,99419,CIojvdkZCguBWuN7246vWmUJ6qBNp7JQ,RXDvfPUBYFlVdlueBFbLW0mhhAyGEqpt,26,32,13,50,14,0,3,0,112,16.0,1,0.0,17,13,49,14,15,0,1,3,0,93,19,1
6124,99632,XcU2XTxeLZ8F89uBFmVFyW4cnWhjcEiA,SpATywNh6bZuzm8s1ceuBUnMUAeoAHHw,7,4,3,0,2,0,1,0,10,1.4285714285714286,1,0.0,0,3,0,2,4,0,0,1,0,5,5,1
6125,99653,2ENDZhPlfPQ7xqwHjrfLuuWg5Duw7ZBj,SpATywNh6bZuzm8s1ceuBUnMUAeoAHHw,19,34,15,9,10,0,4,0,72,10.285714285714286,2,0.0,2,15,9,10,32,0,0,4,0,36,36,0
6126,99752,v8s2hAX8tQgFD6i9MrUt2cuWPYPq3DuN,G8EPVSXsOYB5YQWZGiz1aVq5Pgr2GrQu,15,9,6,22,2,0,2,0,41,5.857142857142857,2,0.0,1,6,20,2,8,0,2,2,0,29,12,0
6127,99839,TdfXOtlNb7Av3MtzwkldFOrTHIZeitdz,SpATywNh6bZuzm8s1ceuBUnMUAeoAHHw,9,8,4,8,2,0,1,0,23,3.2857142857142856,1,0.0,0,4,7,2,8,0,1,1,0,13,10,0
6128,100101,7BLSB26pFgDMSTV4x8nY66FLFZIw20Ig,bWdj2GDclj5ofokWjzoa5jAwMkxCykd6,6,9,1,0,2,0,3,0,15,2.142857142857143,1,0.0,4,1,0,2,5,0,0,3,0,7,8,1
6129,100377,MlHPKmdi90dDdvX24jYoFlYEp8xS4RGn,SpATywNh6bZuzm8s1ceuBUnMUAeoAHHw,12,9,6,0,5,0,1,0,21,3.0,1,0.0,1,6,0,5,8,0,0,1,0,12,9,0
6130,100614,qeHXe8DRkB9urr63HS1yAMwTxQkwIbff,RXDvfPUBYFlVdlueBFbLW0mhhAyGEqpt,1,0,0,0,0,0,1,0,1,0.14285714285714285,1,0.0,0,0,0,0,0,0,0,1,0,0,1,1
6131,100779,Qi3PLuC7w2Yo9hFgq37MObjY8icnRdc6,bWdj2GDclj5ofokWjzoa5jAwMkxCykd6,10,9,4,4,2,0,2,0,21,3.0,2,0.0,1,4,4,2,8,0,0,2,0,11,10,1
6132,100888,JfI1PlGVl9kA0mdAoeqyEmchpJwdwBfa,SpATywNh6bZuzm8s1ceuBUnMUAeoAHHw,5,5,2,0,1,0,1,0,9,1.2857142857142858,1,0.0,0,2,0,1,5,0,0,1,0,3,6,1
6133,100990,CnuwKGLCLbXYnPgy82VEWYA1NOiOhvr0,SpATywNh6bZuzm8s1ceuBUnMUAeoAHHw,7,10,1,0,0,0,4,0,15,2.142857142857143,3,0.0,0,1,0,0,10,0,0,4,0,1,14,0
6134,100997,coZTr10eytnE55me2AxqRWq6qrVXEB7M,SpATywNh6bZuzm8s1ceuBUnMUAeoAHHw,19,21,16,9,11,8,3,0,68,9.714285714285714,2,0.0,2,16,8,11,19,8,1,3,0,37,31,1
6135,101024,WSII4CAtuXXVd816MewodzGLKdBCCfc2,SpATywNh6bZuzm8s1ceuBUnMUAeoAHHw,1,2,0,0,0,0,0,0,2,0.2857142857142857,1,0.0,0,0,0,0,2,0,0,0,0,0,2,0
6136,101075,2edy9dIAe4yrL8yAxHgqsIKKU0nldbta,SpATywNh6bZuzm8s1ceuBUnMUAeoAHHw,6,5,4,0,2,0,1,0,12,1.7142857142857142,1,0.0,0,4,0,2,5,0,0,1,0,6,6,0
6137,101152,7B5rcRMuJ6A1xAdnnIVDusvPjMkwnC77,bWdj2GDclj5ofokWjzoa5jAwMkxCykd6,17,23,9,26,6,0,7,0,71,10.142857142857142,3,0.0,5,9,21,6,18,0,5,7,0,41,30,1
6138,101188,gtKTzkXHwS41ljYVmjlLLf4WyQSkK02q,RXDvfPUBYFlVdlueBFbLW0mhhAyGEqpt,10,10,7,6,0,0,1,0,24,3.4285714285714284,1,0.0,2,7,6,0,8,0,0,1,0,15,9,1
6139,101236,cCvHnoX6St5OTmXQ2AOInGyMnqlmS6DL,SpATywNh6bZuzm8s1ceuBUnMUAeoAHHw,7,4,2,0,1,0,2,0,9,1.2857142857142858,1,0.0,0,2,0,1,4,0,0,2,0,3,6,1
6140,101452,cyHlGmzdd820iXZeJHNijRhHgNUgaRsR,5Gyp41oLVo7Gg7vF4vpmggWP5MU70QO6,15,15,7,8,5,0,3,0,38,5.428571428571429,3,0.0,6,7,4,5,9,0,4,3,0,22,16,1
6141,101456,zrPeuyaXVKnYR1uCd9JL4292EBWbFugp,5Gyp41oLVo7Gg7vF4vpmggWP5MU70QO6,9,5,1,0,1,0,6,1,14,2.0,1,0.0,0,1,0,1,5,0,0,6,1,2,12,1
6142,101465,Bt2D7lmqsxv3cFCET3d4laWzBP0ZnZdv,5Gyp41oLVo7Gg7vF4vpmggWP5MU70QO6,8,5,4,0,3,0,2,0,14,2.0,1,0.0,0,4,0,3,5,0,0,2,0,7,7,1
6143,101467,bPaSH3KfvqKspM1XB21OG1IZ8fF7ldO2,5Gyp41oLVo7Gg7vF4vpmggWP5MU70QO6,9,4,3,0,0,6,8,2,23,3.2857142857142856,1,0.0,0,3,0,0,4,6,0,8,2,3,20,1
6144,101498,pn0U7WqwcrjczUXEzvwACFEkYhXoHWmc,5Gyp41oLVo7Gg7vF4vpmggWP5MU70QO6,1,0,0,0,0,0,1,0,1,0.14285714285714285,1,0.0,0,0,0,0,0,0,0,1,0,0,1,1
6145,101500,1gxs0fwvL2xfwTYgRZccrPKZo7GalF4t,5Gyp41oLVo7Gg7vF4vpmggWP5MU70QO6,6,4,1,0,1,0,2,0,8,1.1428571428571428,1,0.0,0,1,0,1,4,0,0,2,0,2,6,1
6146,101506,ZWnKii7CrzufUGiI6upCzSmttf0gejmY,5Gyp41oLVo7Gg7vF4vpmggWP5MU70QO6,1,0,0,0,0,0,1,0,1,0.14285714285714285,1,0.0,0,0,0,0,0,0,0,1,0,0,1,0
6147,101507,9wopoJ2cGGzuRFqMYS5p5e9NQyyeYnrZ,5Gyp41oLVo7Gg7vF4vpmggWP5MU70QO6,1,0,0,0,0,0,1,0,1,0.14285714285714285,1,0.0,0,0,0,0,0,0,0,1,0,0,1,1
6148,101512,fwhOM3WHOmicuRjMN72AZp4mXhiBMgpc,5Gyp41oLVo7Gg7vF4vpmggWP5MU70QO6,13,19,2,19,3,5,12,3,63,9.0,3,0.0,6,2,12,3,13,5,7,12,3,23,40,1
6149,101514,gJvCNWfsgT56j7y7Un71mXqeZVPhRbg4,5Gyp41oLVo7Gg7vF4vpmggWP5MU70QO6,8,3,0,0,0,2,6,1,12,1.7142857142857142,1,0.0,0,0,0,0,3,2,0,6,1,0,12,1
6150,101518,RL64n4qclvmNyCtbRJIuKrQ8BQgb5LB1,5Gyp41oLVo7Gg7vF4vpmggWP5MU70QO6,7,3,2,0,2,0,3,0,10,1.4285714285714286,2,0.0,0,2,0,2,3,0,0,3,0,4,6,1
6151,101541,KMjIShuxwjyyHXq4vYnxdsaTjtsvpNEc,5Gyp41oLVo7Gg7vF4vpmggWP5MU70QO6,1,0,0,0,0,0,1,0,1,0.14285714285714285,1,0.0,0,0,0,0,0,0,0,1,0,0,1,1
6152,101555,sz7zM1DSp5AQjmznVzMDY1PUixSW7aYf,5Gyp41oLVo7Gg7vF4vpmggWP5MU70QO6,2,0,0,0,0,0,5,0,5,0.7142857142857143,4,0.0,0,0,0,0,0,0,0,5,0,0,5,1
6153,101560,xeSVcZHF8lWMo0zUmOw3Zu2e5bxF0c3b,5Gyp41oLVo7Gg7vF4vpmggWP5MU70QO6,10,6,4,0,3,0,9,0,22,3.142857142857143,2,0.0,0,4,0,3,6,0,0,9,0,7,15,1
6154,101564,wCYurJi36MQ1R9mcfGU9x4rt998XAowy,5Gyp41oLVo7Gg7vF4vpmggWP5MU70QO6,7,13,1,4,1,0,1,0,20,2.857142857142857,1,0.0,4,1,2,1,9,0,2,1,0,8,12,1
6155,101591,BJyRSsWSiezY4yrLm9sDqfWLB4qxlfhl,5Gyp41oLVo7Gg7vF4vpmggWP5MU70QO6,8,4,2,0,1,0,5,0,12,1.7142857142857142,1,0.0,0,2,0,1,4,0,0,5,0,3,9,1
6156,101592,6CNJnhFNmHRhustnp1yAF7y5A4oCDcgB,5Gyp41oLVo7Gg7vF4vpmggWP5MU70QO6,8,7,5,0,2,3,3,0,20,2.857142857142857,2,0.0,0,5,0,2,7,3,0,3,0,7,13,1
6157,101597,04hGIRAwJNhGnbBI3TTn0lNhDIwpoJVc,5Gyp41oLVo7Gg7vF4vpmggWP5MU70QO6,8,5,3,2,2,0,1,0,13,1.8571428571428572,1,0.0,1,3,1,2,4,0,1,1,0,7,6,1
6158,101601,uoB6LjXoO0uEAy8Gm4C48aYCpFXi2nje,5Gyp41oLVo7Gg7vF4vpmggWP5MU70QO6,12,11,5,4,5,0,8,0,33,4.714285714285714,2,0.0,6,5,2,5,5,0,2,8,0,18,15,1
6159,101607,4VSTLb8tmjvrWAcdc1fUYi8rh0FVk7Su,5Gyp41oLVo7Gg7vF4vpmggWP5MU70QO6,1,0,0,0,0,0,1,0,1,0.14285714285714285,1,0.0,0,0,0,0,0,0,0,1,0,0,1,1
6160,101629,QJLw1Q5TwE4X1EdRI7Y8zxzQmZwpmGCu,5Gyp41oLVo7Gg7vF4vpmggWP5MU70QO6,7,3,2,0,2,0,2,0,9,1.2857142857142858,1,0.0,0,2,0,2,3,0,0,2,0,4,5,1
6161,101645,hRVlNOTS6jXxXFoegXsRTavsZxsubLWH,5Gyp41oLVo7Gg7vF4vpmggWP5MU70QO6,9,4,4,0,3,0,3,0,14,2.0,2,0.0,0,4,0,3,4,0,0,3,0,7,7,0
6162,101655,3itNxaQIx1CxzcmIshtAJt0RwR2UMUjE,5Gyp41oLVo7Gg7vF4vpmggWP5MU70QO6,4,2,1,0,0,0,2,0,5,0.7142857142857143,1,0.0,0,1,0,0,2,0,0,2,0,1,4,1
6163,101665,NpWQRg3OAEPQzsdapgtzdDlY7oBIYHtZ,5Gyp41oLVo7Gg7vF4vpmggWP5MU70QO6,1,0,0,0,0,0,1,0,1,0.14285714285714285,1,0.0,0,0,0,0,0,0,0,1,0,0,1,1
6164,101673,sVifRlhP9nBlmdcZTS6jbs286jf9Ait6,5Gyp41oLVo7Gg7vF4vpmggWP5MU70QO6,7,9,1,0,0,1,5,0,16,2.2857142857142856,2,0.0,0,1,0,0,9,1,0,5,0,1,15,1
6165,101679,R2bf9dlDhtEUgfKzXR1GPBa12LhUfZ8W,5Gyp41oLVo7Gg7vF4vpmggWP5MU70QO6,1,0,0,0,0,0,1,0,1,0.14285714285714285,1,0.0,0,0,0,0,0,0,0,1,0,0,1,1
6166,101682,DQt2pn098s49W1ZQVr3TX6g41xJCKLnk,5Gyp41oLVo7Gg7vF4vpmggWP5MU70QO6,20,34,19,21,3,24,14,0,115,16.428571428571427,3,0.0,4,19,16,3,30,24,5,14,0,42,73,0
6167,101687,C89edYjc0egHm9DK0UhG6TICXc3cgfYt,5Gyp41oLVo7Gg7vF4vpmggWP5MU70QO6,2,0,0,0,0,0,2,0,2,0.2857142857142857,1,0.0,0,0,0,0,0,0,0,2,0,0,2,0
6168,101689,pbaqjkvaUNQsMIN40YaHH4YISJL3nrdi,5Gyp41oLVo7Gg7vF4vpmggWP5MU70QO6,19,30,14,7,9,0,9,0,69,9.857142857142858,4,0.0,10,14,5,9,20,0,2,9,0,38,31,1
6169,101727,TQ6dd5H6C14tiFKVOTTVyRFgIGSubl1j,5Gyp41oLVo7Gg7vF4vpmggWP5MU70QO6,1,0,0,0,0,0,1,0,1,0.14285714285714285,1,0.0,0,0,0,0,0,0,0,1,0,0,1,1
6170,101744,bhGqExUGpWPVtLHOBczGOZtP5NSlb2iV,5Gyp41oLVo7Gg7vF4vpmggWP5MU70QO6,1,0,0,0,0,0,1,0,1,0.14285714285714285,1,0.0,0,0,0,0,0,0,0,1,0,0,1,0
6171,101745,0hRwE5vbowYRJTF6rcWCTgSh4yHA34bg,5Gyp41oLVo7Gg7vF4vpmggWP5MU70QO6,31,51,1,23,8,10,15,3,111,15.857142857142858,7,0.0,13,1,16,8,38,10,7,15,3,38,73,1
6172,101748,CWtzx13AibFkLvkg7ivFEzszvepdmZkK,5Gyp41oLVo7Gg7vF4vpmggWP5MU70QO6,2,0,0,0,0,0,2,0,2,0.2857142857142857,1,0.0,0,0,0,0,0,0,0,2,0,0,2,1
6173,101755,3yfQbyJ9pf1yrEL1gur3tzr8XAtUzfm8,5Gyp41oLVo7Gg7vF4vpmggWP5MU70QO6,10,15,8,0,2,13,5,0,43,6.142857142857143,1,0.0,3,8,0,2,12,13,0,5,0,13,30,1
6174,101764,Gj2iWszkWYXSgm6krMUTGIVXgXjnCpdU,5Gyp41oLVo7Gg7vF4vpmggWP5MU70QO6,2,0,0,0,0,0,2,0,2,0.2857142857142857,1,0.0,0,0,0,0,0,0,0,2,0,0,2,1
6175,101767,hi2RRdBggCCfeH7bxNko5GDSFpsH4d7a,5Gyp41oLVo7Gg7vF4vpmggWP5MU70QO6,6,4,2,0,1,2,4,0,13,1.8571428571428572,1,0.0,0,2,0,1,4,2,0,4,0,3,10,1
6176,101771,JfFEDPtTHkbJ97g3bb1XESDWfaaas9bO,5Gyp41oLVo7Gg7vF4vpmggWP5MU70QO6,1,0,0,0,0,0,1,0,1,0.14285714285714285,1,0.0,0,0,0,0,0,0,0,1,0,0,1,1
6177,101797,hvwDkBgYgegt9wVdGid3AcnArAeCqIHd,5Gyp41oLVo7Gg7vF4vpmggWP5MU70QO6,10,11,4,0,4,0,3,0,22,3.142857142857143,2,0.0,0,4,0,4,11,0,0,3,0,8,14,1
6178,101818,HTW0MXRsyGWqdNcPrMPEaXwWOjVd82Bo,5Gyp41oLVo7Gg7vF4vpmggWP5MU70QO6,5,2,1,0,1,0,2,0,6,0.8571428571428571,1,0.0,0,1,0,1,2,0,0,2,0,2,4,1
6179,101830,fZrT5T2XYc9pm3Zx85nVKb18lwTknI1m,5Gyp41oLVo7Gg7vF4vpmggWP5MU70QO6,5,2,1,0,1,0,2,0,6,0.8571428571428571,1,0.0,0,1,0,1,2,0,0,2,0,2,4,1
6180,101840,ew5cf7bpZjN9L5HIpJxjf0mbKDlY7Mli,5Gyp41oLVo7Gg7vF4vpmggWP5MU70QO6,4,2,1,0,1,0,1,0,5,0.7142857142857143,1,0.0,0,1,0,1,2,0,0,1,0,2,3,0
6181,101844,lQyKsLhc77msSpfpFAQdEdwWNrz2sffy,5Gyp41oLVo7Gg7vF4vpmggWP5MU70QO6,18,31,22,4,9,0,8,0,74,10.571428571428571,5,0.0,2,22,2,9,29,0,2,8,0,35,39,0
6182,101848,27cdsuNLSsNdpSImVvDjBjf9ewYI2xCw,5Gyp41oLVo7Gg7vF4vpmggWP5MU70QO6,7,3,2,0,2,0,3,0,10,1.4285714285714286,2,0.0,0,2,0,2,3,0,0,3,0,4,6,1
6183,101850,1AfBYz7PsZIdVlLLLIOlXwXH4cJYR8cq,5Gyp41oLVo7Gg7vF4vpmggWP5MU70QO6,7,3,2,0,2,0,2,0,9,1.2857142857142858,1,0.0,0,2,0,2,3,0,0,2,0,4,5,1
6184,101878,4okppsrdnKYxqs2gLNMiS6gb60QmM8WN,5Gyp41oLVo7Gg7vF4vpmggWP5MU70QO6,6,3,2,0,1,0,4,0,10,1.4285714285714286,2,0.0,0,2,0,1,3,0,0,4,0,3,7,1
6185,101881,ZalaHb2nOUsnNI2p4xQ00VNI9pJY08yk,5Gyp41oLVo7Gg7vF4vpmggWP5MU70QO6,1,0,0,0,0,0,1,0,1,0.14285714285714285,1,0.0,0,0,0,0,0,0,0,1,0,0,1,1
6186,101883,8i0uaFDAsU3DOBshHHoXkpmkG9XUoSYX,5Gyp41oLVo7Gg7vF4vpmggWP5MU70QO6,12,14,4,10,3,0,3,0,34,4.857142857142857,1,0.0,6,4,5,3,8,0,5,3,0,18,16,1
6187,101914,STC9kNvoc8v8oFEpkDJr8SLBeByVv0bI,5Gyp41oLVo7Gg7vF4vpmggWP5MU70QO6,1,0,0,0,0,0,1,0,1,0.14285714285714285,1,0.0,0,0,0,0,0,0,0,1,0,0,1,1
6188,101916,K5e4X2ATT5k1vl1kvQVqsIyRhk1ZY506,5Gyp41oLVo7Gg7vF4vpmggWP5MU70QO6,43,117,76,36,18,47,35,2,331,47.285714285714285,11,0.0,21,76,33,18,96,47,3,35,2,148,183,0
6189,101921,qg7aIxxfHKlqXcXH8Q2TmqUpIJfhnSWV,5Gyp41oLVo7Gg7vF4vpmggWP5MU70QO6,4,0,0,0,0,0,7,0,7,1.0,1,0.0,0,0,0,0,0,0,0,7,0,0,7,1
6190,101929,c4cBsKaeHPIc85bOPe7KYxwPpTPQkGOS,5Gyp41oLVo7Gg7vF4vpmggWP5MU70QO6,8,5,3,0,2,0,4,0,14,2.0,1,0.0,0,3,0,2,5,0,0,4,0,5,9,1
6191,101942,srnnzUkIJr2Uisav8LfnV4SnpbNw9CLp,5Gyp41oLVo7Gg7vF4vpmggWP5MU70QO6,13,19,11,0,2,0,19,0,51,7.285714285714286,6,0.0,1,11,0,2,18,0,0,19,0,14,37,1
6192,101943,nUSBZJtgja7StWJKUoMKeu2Wmlcsct6T,5Gyp41oLVo7Gg7vF4vpmggWP5MU70QO6,4,0,0,0,0,0,4,1,5,0.7142857142857143,2,0.0,0,0,0,0,0,0,0,4,1,0,5,1
6193,101946,X9zb15Nu4pJFCfQgkBigs5ZgWhdpLAGO,5Gyp41oLVo7Gg7vF4vpmggWP5MU70QO6,1,0,0,0,0,0,1,0,1,0.14285714285714285,1,0.0,0,0,0,0,0,0,0,1,0,0,1,1
6194,101947,gYz3DXiXiB2ygQdrSqkvFFqa3NbdbDQD,5Gyp41oLVo7Gg7vF4vpmggWP5MU70QO6,11,9,5,10,3,7,1,0,35,5.0,1,0.0,2,5,5,3,7,7,5,1,0,15,20,1
6195,101951,UnYwehBo2feinTsxQtbrjdcob8LOQRe3,5Gyp41oLVo7Gg7vF4vpmggWP5MU70QO6,1,0,0,0,0,0,1,0,1,0.14285714285714285,1,0.0,0,0,0,0,0,0,0,1,0,0,1,0
6196,101962,GzVsDDvepjc0lLyMS3k9MR0dz8jyV1ca,5Gyp41oLVo7Gg7vF4vpmggWP5MU70QO6,21,82,40,13,20,5,7,0,167,23.857142857142858,12,0.0,9,40,12,20,73,5,1,7,0,81,86,0
6197,101969,ngy9FDiYXpc4c01p0sFczM8viAh3TUDK,5Gyp41oLVo7Gg7vF4vpmggWP5MU70QO6,5,2,1,0,1,0,2,0,6,0.8571428571428571,1,0.0,0,1,0,1,2,0,0,2,0,2,4,1
6198,101980,BP5vZkvTpLRQdxYERPiGbViuRmZcLSEw,5Gyp41oLVo7Gg7vF4vpmggWP5MU70QO6,13,14,7,4,3,5,6,0,39,5.571428571428571,2,0.0,4,7,2,3,10,5,2,6,0,16,23,1
6199,102006,SW8hZER4lRVJxocMEgvR4kXl1NsQnFzy,5Gyp41oLVo7Gg7vF4vpmggWP5MU70QO6,3,0,0,0,0,5,2,0,7,1.0,1,0.0,0,0,0,0,0,5,0,2,0,0,7,1
6200,102010,Cwkpbk9XjaRjxRkXl9T5LLX0pfxG659m,5Gyp41oLVo7Gg7vF4vpmggWP5MU70QO6,27,28,14,10,8,18,7,12,97,13.857142857142858,1,0.0,11,14,5,8,17,18,5,7,12,38,59,1
6201,102022,N26qxxXNzNgtRrCPTTWHycPCg4UmpaBH,5Gyp41oLVo7Gg7vF4vpmggWP5MU70QO6,5,3,1,0,1,0,1,0,6,0.8571428571428571,1,0.0,0,1,0,1,3,0,0,1,0,2,4,1
6202,102055,ANJ7A7TrnpRJsv1mG7Zq08b8gsBzPJqI,5Gyp41oLVo7Gg7vF4vpmggWP5MU70QO6,16,26,14,4,9,0,4,0,57,8.142857142857142,3,0.0,3,14,2,9,23,0,2,4,0,28,29,0
6203,102064,FP4hLkoHHSoDgNvvli0GZn0SfLgLxSLJ,5Gyp41oLVo7Gg7vF4vpmggWP5MU70QO6,13,18,8,0,4,1,5,1,37,5.285714285714286,1,0.0,7,8,0,4,11,1,0,5,1,19,18,1
6204,102071,vamtANIlqxEfssSotq9CBIgt04YnuypF,5Gyp41oLVo7Gg7vF4vpmggWP5MU70QO6,28,35,25,0,13,8,19,3,103,14.714285714285714,5,0.0,1,25,0,13,34,8,0,19,3,39,64,1
6205,102086,hy1o1tFG3MUeKwnpej7pCvF6Qw50OZDs,5Gyp41oLVo7Gg7vF4vpmggWP5MU70QO6,3,0,0,0,0,1,3,0,4,0.5714285714285714,1,0.0,0,0,0,0,0,1,0,3,0,0,4,1
6206,102091,u4schfWJ1mTfhsvkC2Ygk0foJeVZovSx,5Gyp41oLVo7Gg7vF4vpmggWP5MU70QO6,6,3,2,0,2,0,1,0,8,1.1428571428571428,1,0.0,0,2,0,2,3,0,0,1,0,4,4,1
6207,102123,LHuyIYHaN33yTEoBdzkvXzRMGUfJtNER,5Gyp41oLVo7Gg7vF4vpmggWP5MU70QO6,2,0,0,0,0,0,2,0,2,0.2857142857142857,1,0.0,0,0,0,0,0,0,0,2,0,0,2,1
6208,102134,sL5jw3pLWZoRI7avI17oM60mfF67Acgz,5Gyp41oLVo7Gg7vF4vpmggWP5MU70QO6,15,16,8,0,6,26,16,1,73,10.428571428571429,2,0.0,4,8,0,6,12,26,0,16,1,18,55,0
6209,102154,invjLFwmOJ5b2g8Hz4dPO4FErak7u41P,5Gyp41oLVo7Gg7vF4vpmggWP5MU70QO6,27,46,20,14,12,7,8,1,108,15.428571428571429,4,0.0,18,20,7,12,28,7,7,8,1,57,51,0
6210,102155,WjCsc4Ly7MQQaQbBGWJYzwMq4TqEnbSq,5Gyp41oLVo7Gg7vF4vpmggWP5MU70QO6,7,7,0,0,0,0,3,1,11,1.5714285714285714,1,0.0,0,0,0,0,7,0,0,3,1,0,11,1
6211,102163,WlsfaEHV81OmOSz6tpiA5BKWY8BDn0FJ,5Gyp41oLVo7Gg7vF4vpmggWP5MU70QO6,7,3,2,0,2,0,2,0,9,1.2857142857142858,1,0.0,0,2,0,2,3,0,0,2,0,4,5,1
6212,102169,FGewrX4MaiUHx7NVyabzwDjV7PLDRDjt,5Gyp41oLVo7Gg7vF4vpmggWP5MU70QO6,6,3,1,0,1,0,4,0,9,1.2857142857142858,1,0.0,0,1,0,1,3,0,0,4,0,2,7,1
6213,102190,kdWfZaARkb2GKTHY1dNrIxpxXbMmpunp,5Gyp41oLVo7Gg7vF4vpmggWP5MU70QO6,1,0,0,0,0,0,1,0,1,0.14285714285714285,1,0.0,0,0,0,0,0,0,0,1,0,0,1,1
6214,102201,HgZH3VjgoNSGfdNPUYvEYMLEuHiaV4qp,5Gyp41oLVo7Gg7vF4vpmggWP5MU70QO6,17,17,9,6,6,1,10,2,51,7.285714285714286,2,0.0,6,9,3,6,11,1,3,10,2,24,27,1
6215,102215,wmND65rZOV8Cdq3Mq9MmFLy7XUHHSgIW,5Gyp41oLVo7Gg7vF4vpmggWP5MU70QO6,1,0,0,0,0,0,1,0,1,0.14285714285714285,1,0.0,0,0,0,0,0,0,0,1,0,0,1,1
6216,102216,atIOpTw1JfCdMrzLEXG2b3C0gcowmPkz,5Gyp41oLVo7Gg7vF4vpmggWP5MU70QO6,16,30,13,9,5,0,7,0,64,9.142857142857142,3,0.0,7,13,7,5,23,0,2,7,0,32,32,1
6217,102219,VJzTZqcHQdPxdcSTgYflgdTGfDdXSaeh,5Gyp41oLVo7Gg7vF4vpmggWP5MU70QO6,7,3,3,0,3,0,7,1,17,2.4285714285714284,4,0.0,0,3,0,3,3,0,0,7,1,6,11,1
6218,102238,uv7MLyLnrCPPtwLSa3ciSAESDx9fyqLj,5Gyp41oLVo7Gg7vF4vpmggWP5MU70QO6,24,67,31,4,12,4,11,1,130,18.571428571428573,4,0.0,15,31,2,12,52,4,2,11,1,60,70,1
6219,102245,lqZIfyXgEdVIeF9bwEgKmujde3rxC2ID,5Gyp41oLVo7Gg7vF4vpmggWP5MU70QO6,9,9,3,0,1,1,8,2,24,3.4285714285714284,1,0.0,2,3,0,1,7,1,0,8,2,6,18,1
6220,102248,WWhjd2hQrbhidD08sxoeqMUFLgJFtpfq,5Gyp41oLVo7Gg7vF4vpmggWP5MU70QO6,5,2,1,0,1,0,4,0,8,1.1428571428571428,2,0.0,0,1,0,1,2,0,0,4,0,2,6,1
6221,102260,gY4MmFhIOsF1Wm6XUOhrj2V8aIoxYXRx,5Gyp41oLVo7Gg7vF4vpmggWP5MU70QO6,14,15,7,0,6,0,3,0,31,4.428571428571429,2,0.0,3,7,0,6,12,0,0,3,0,16,15,1
6222,102266,RHEMdhoy3TVz84IqO3CiO0ZVmx7sjl4N,5Gyp41oLVo7Gg7vF4vpmggWP5MU70QO6,2,0,0,0,0,0,2,0,2,0.2857142857142857,1,0.0,0,0,0,0,0,0,0,2,0,0,2,1
6223,102799,9ZWuRdJmwsPcVeXfj5eD60nSn6eqt8MO,7GRhBDsirIGkRZBtSMEzNTyDr2JQm4xx,8,2,1,0,1,4,6,0,14,2.0,1,0.0,0,1,0,1,2,4,0,6,0,2,12,1
6224,102807,vTBbaPT6TO6bbvtjEvxDY8u77Dj5cote,7GRhBDsirIGkRZBtSMEzNTyDr2JQm4xx,46,135,49,50,23,2,19,0,278,39.714285714285715,2,0.0,73,49,34,23,62,2,16,19,0,179,99,1
6225,102833,ZJeIfsRIsYEDKYfpXrOW1vPestL4WNer,7GRhBDsirIGkRZBtSMEzNTyDr2JQm4xx,12,9,1,0,1,0,2,0,13,1.8571428571428572,1,0.0,0,1,0,1,9,0,0,2,0,2,11,1
6226,102837,QNU8vTePqclgvI4QsHOj53NeF8gpPvEk,7GRhBDsirIGkRZBtSMEzNTyDr2JQm4xx,1,0,0,0,0,0,1,0,1,0.14285714285714285,1,0.0,0,0,0,0,0,0,0,1,0,0,1,1
6227,102839,HRv57i4EKLnwPHqHSpvdl3J57Q3TYtkt,7GRhBDsirIGkRZBtSMEzNTyDr2JQm4xx,6,2,1,0,1,0,4,0,8,1.1428571428571428,1,0.0,0,1,0,1,2,0,0,4,0,2,6,1
6228,102847,E3FH9dDC5MuAQYulYDcZYXAV78FrDWti,7GRhBDsirIGkRZBtSMEzNTyDr2JQm4xx,4,2,0,0,0,0,3,0,5,0.7142857142857143,1,0.0,0,0,0,0,2,0,0,3,0,0,5,1
6229,102850,bUYPIrKUhpdtG1KH0Y9GXp4xZk1AgdLJ,7GRhBDsirIGkRZBtSMEzNTyDr2JQm4xx,1,0,0,0,0,0,1,0,1,0.14285714285714285,1,0.0,0,0,0,0,0,0,0,1,0,0,1,1
6230,102857,ufz99H6gUISt7XZLJ1TgvDZ6OrpiKTxS,7GRhBDsirIGkRZBtSMEzNTyDr2JQm4xx,1,0,0,0,0,0,2,0,2,0.2857142857142857,2,0.0,0,0,0,0,0,0,0,2,0,0,2,0
6231,102870,WDJ95rBJgKiyFRr65T6n7aAhLfLzYON5,5X6FeZozNMgE2VRi3MJYjkkFK8SETtu2,1,0,0,0,0,0,1,0,1,0.14285714285714285,1,0.0,0,0,0,0,0,0,0,1,0,0,1,1
6232,102871,j91nMgV3K6rtEcjFaPoRw8ZzxTKSNRyI,A3fsA9Zfv1X2fVEQhTw51lKENdNrEqT3,12,7,5,0,3,0,8,1,24,3.4285714285714284,2,0.0,0,5,0,3,7,0,0,8,1,8,16,1
6233,102905,s6iksgptFmyh2vfiarKdJkiKnp6RLi3f,A3fsA9Zfv1X2fVEQhTw51lKENdNrEqT3,14,17,10,0,3,16,18,1,65,9.285714285714286,2,0.0,1,10,0,3,16,16,0,18,1,14,51,0
6234,102971,FVUcdw8gGY0QgNPsAL0lOnlHZYyj7ckt,5X6FeZozNMgE2VRi3MJYjkkFK8SETtu2,10,14,2,12,6,0,1,0,35,5.0,2,0.0,9,2,11,6,5,0,1,1,0,28,7,1
6235,102987,4kjfNdZcdugIVfk27urqgUDiTvuYyakw,5X6FeZozNMgE2VRi3MJYjkkFK8SETtu2,8,3,1,0,1,0,4,0,9,1.2857142857142858,1,0.0,0,1,0,1,3,0,0,4,0,2,7,1
6236,103338,D2lFXeOodglgSTRNVccRvVrNvHlYgfLJ,5X6FeZozNMgE2VRi3MJYjkkFK8SETtu2,1,0,0,0,0,0,1,0,1,0.14285714285714285,1,0.0,0,0,0,0,0,0,0,1,0,0,1,1
6237,103417,0sAOKVns8BSkUL9PacRKzX0uoHgRzVTD,SpATywNh6bZuzm8s1ceuBUnMUAeoAHHw,5,4,2,0,1,0,2,0,9,1.2857142857142858,1,0.0,0,2,0,1,4,0,0,2,0,3,6,1
6238,103445,YR1IgV2TtttHJ35h5NJxgcWKWfmLYszA,SpATywNh6bZuzm8s1ceuBUnMUAeoAHHw,3,1,1,0,1,0,0,0,3,0.42857142857142855,1,0.0,0,1,0,1,1,0,0,0,0,2,1,0
6239,103457,XvNNzv39b8VqKid0q4fV9ms2wVNAdWks,bWdj2GDclj5ofokWjzoa5jAwMkxCykd6,25,31,15,30,0,11,9,2,98,14.0,1,0.0,6,15,29,0,25,11,1,9,2,50,48,0
6240,103479,ZdJ1BYcCBDVkoF1RDWOaW7qs4fUuQvAO,SpATywNh6bZuzm8s1ceuBUnMUAeoAHHw,10,8,4,8,1,0,3,0,24,3.4285714285714284,1,0.0,2,4,8,1,6,0,0,3,0,15,9,0
6241,103645,pGYP47am2d3xk9zOKdaE6fuoOc52iQiA,5X6FeZozNMgE2VRi3MJYjkkFK8SETtu2,31,34,0,96,11,0,5,0,146,20.857142857142858,3,0.0,20,0,81,11,14,0,15,5,0,112,34,1
6242,103661,Z5Gd8RjsJSljoHUoBd3hvIVNy4VKuGq0,SpATywNh6bZuzm8s1ceuBUnMUAeoAHHw,10,10,5,13,0,0,1,0,29,4.142857142857143,1,0.0,2,5,10,0,8,0,3,1,0,17,12,0
6243,103668,p9NcQP74LARrulF6JzGeab5yk6ciJM9V,SpATywNh6bZuzm8s1ceuBUnMUAeoAHHw,5,3,1,0,1,0,1,0,6,0.8571428571428571,1,0.0,0,1,0,1,3,0,0,1,0,2,4,0
6244,103746,rJa06nlcyBimvgL7PoPXhuOUbmR9mddR,SpATywNh6bZuzm8s1ceuBUnMUAeoAHHw,33,37,23,29,17,12,2,0,120,17.142857142857142,3,0.0,11,23,26,17,26,12,3,2,0,77,43,1
6245,103782,8E8MlkBOuzGaVSvo1UqdWtwoQrTmYFYq,5X6FeZozNMgE2VRi3MJYjkkFK8SETtu2,1,0,0,0,0,0,1,0,1,0.14285714285714285,1,0.0,0,0,0,0,0,0,0,1,0,0,1,1
6246,103817,P8HECw7bHyNqGqPTlWbv24tTg1SG6bAf,5X6FeZozNMgE2VRi3MJYjkkFK8SETtu2,4,5,2,0,1,0,2,0,10,1.4285714285714286,2,0.0,1,2,0,1,4,0,0,2,0,4,6,1
6247,103847,i4SeHiwnbIIoq9LoP3weAeDXl7e5RBtg,A3fsA9Zfv1X2fVEQhTw51lKENdNrEqT3,44,12,10,66,9,3,7,1,108,15.428571428571429,1,0.0,1,10,58,9,11,3,8,7,1,78,30,1
6248,103854,V8BBThgMaAUvnyEwHx5s0wvIZmg9ljiC,5X6FeZozNMgE2VRi3MJYjkkFK8SETtu2,6,3,2,0,1,0,5,2,13,1.8571428571428572,1,0.0,0,2,0,1,3,0,0,5,2,3,10,1
6249,103902,Mm22Jz2IKnj929tEi3a7QaQsXH1twtvH,5X6FeZozNMgE2VRi3MJYjkkFK8SETtu2,4,2,1,0,1,0,2,0,6,0.8571428571428571,2,0.0,0,1,0,1,2,0,0,2,0,2,4,1
6250,103930,Txv4UTCXPzwxfIDD6g3LwRLt3kYLBXuk,SpATywNh6bZuzm8s1ceuBUnMUAeoAHHw,18,26,4,5,3,0,4,0,42,6.0,3,0.0,8,4,5,3,18,0,0,4,0,20,22,0
6251,104043,CirrORwAsISzZWaS5RqwkDnMi23d5gz0,5X6FeZozNMgE2VRi3MJYjkkFK8SETtu2,5,2,1,0,1,0,2,0,6,0.8571428571428571,1,0.0,0,1,0,1,2,0,0,2,0,2,4,1
6252,104075,Jeb6HFnTv5BAeG7m0GpNhKDbGECtxEse,RXDvfPUBYFlVdlueBFbLW0mhhAyGEqpt,4,3,1,0,0,0,1,0,5,0.7142857142857143,1,0.0,0,1,0,0,3,0,0,1,0,1,4,1
6253,104265,M2AmcvqhvMtUlyRV6vMvvoM2IhrMmAwT,5X6FeZozNMgE2VRi3MJYjkkFK8SETtu2,11,10,1,12,4,0,1,0,28,4.0,1,0.0,7,1,12,4,3,0,0,1,0,24,4,1
6254,104546,h2uPViUap57On5JUqQ9igq5GDP75Rgzf,SpATywNh6bZuzm8s1ceuBUnMUAeoAHHw,6,6,2,0,0,1,6,1,16,2.2857142857142856,1,0.0,0,2,0,0,6,1,0,6,1,2,14,1
6255,104767,futyrc5ZKHBBJxaxN8pRQj4FOD0yyEl8,RXDvfPUBYFlVdlueBFbLW0mhhAyGEqpt,3,4,2,0,0,0,2,0,8,1.1428571428571428,1,0.0,0,2,0,0,4,0,0,2,0,2,6,1
6256,104879,KLWMzt2lbmi8onKYKX9eWLl5lpM0wx0M,A3fsA9Zfv1X2fVEQhTw51lKENdNrEqT3,29,11,8,46,6,1,6,1,79,11.285714285714286,1,0.0,0,8,39,6,11,1,7,6,1,53,26,1
6257,105262,47V3QOKZAFRfMjY5qh3dGgU05qgUrwzk,SpATywNh6bZuzm8s1ceuBUnMUAeoAHHw,6,4,1,0,1,0,1,0,7,1.0,1,0.0,0,1,0,1,4,0,0,1,0,2,5,0
6258,105347,CvSKLBTIxxGXbtAVP0WUmmB2Wsdsb6DU,SpATywNh6bZuzm8s1ceuBUnMUAeoAHHw,25,33,1,12,3,5,12,1,67,9.571428571428571,1,0.0,9,1,12,3,24,5,0,12,1,25,42,0
6259,105445,LdIFMEp4Gma3xMuOQ2mpp1BJ3jFvB9c2,bWdj2GDclj5ofokWjzoa5jAwMkxCykd6,2,1,1,0,0,0,0,0,2,0.2857142857142857,1,0.0,0,1,0,0,1,0,0,0,0,1,1,0
6260,105471,DIfj5Ba2axfDE4LFDWqKjVBCgesW8XXW,SpATywNh6bZuzm8s1ceuBUnMUAeoAHHw,9,15,5,0,2,0,2,0,24,3.4285714285714284,1,0.0,0,5,0,2,15,0,0,2,0,7,17,1
6261,105615,yt2gjsEupK8sBRyKpoF6RM4kG7zfvxKC,SpATywNh6bZuzm8s1ceuBUnMUAeoAHHw,8,11,6,0,1,0,4,0,22,3.142857142857143,3,0.0,0,6,0,1,11,0,0,4,0,7,15,0
6262,105767,mjObtvp4vmduPSr2e6gxrQuYRjgGF8wF,7GRhBDsirIGkRZBtSMEzNTyDr2JQm4xx,29,31,20,0,12,5,2,0,70,10.0,2,0.0,8,20,0,12,23,5,0,2,0,40,30,0
6263,105834,QcbB4zGNvIA8Hos1EmgULZPHy4JycNs5,5X6FeZozNMgE2VRi3MJYjkkFK8SETtu2,1,0,0,0,0,0,1,0,1,0.14285714285714285,1,0.0,0,0,0,0,0,0,0,1,0,0,1,1
6264,105848,sIyZYSKie5RGu5xNfItLppAaZDEjg9Pu,5X6FeZozNMgE2VRi3MJYjkkFK8SETtu2,5,3,1,0,1,0,1,0,6,0.8571428571428571,1,0.0,0,1,0,1,3,0,0,1,0,2,4,1
6265,105854,woFDw1OEnOkwFSqAm7hIDFxAwHhY3DdP,5X6FeZozNMgE2VRi3MJYjkkFK8SETtu2,16,17,6,10,8,0,4,1,46,6.571428571428571,1,0.0,9,6,10,8,8,0,0,4,1,33,13,1
6266,105865,FmbW6BMW2tvli3L6T9qC97SAIzFg6ww1,5X6FeZozNMgE2VRi3MJYjkkFK8SETtu2,3,2,0,0,0,0,4,0,6,0.8571428571428571,3,0.0,0,0,0,0,2,0,0,4,0,0,6,1
6267,105883,tfxXhrh7iPXKQPNkoHAVsqfq4X6hHi7F,5X6FeZozNMgE2VRi3MJYjkkFK8SETtu2,1,0,0,0,0,0,1,0,1,0.14285714285714285,1,0.0,0,0,0,0,0,0,0,1,0,0,1,1
6268,105971,aldnZSsKcazzeacsfbnsUhMZvWfCzdlz,5X6FeZozNMgE2VRi3MJYjkkFK8SETtu2,1,0,0,0,0,0,1,0,1,0.14285714285714285,1,0.0,0,0,0,0,0,0,0,1,0,0,1,1
6269,106310,cOQ2CLrZnN7CsViDawRXxdnHfqtQ6g10,A3fsA9Zfv1X2fVEQhTw51lKENdNrEqT3,5,2,1,0,1,0,2,0,6,0.8571428571428571,1,0.0,0,1,0,1,2,0,0,2,0,2,4,1
6270,106359,2zZlUBHgcEWZzLbL8iqQ9VWT51LiEQMY,5X6FeZozNMgE2VRi3MJYjkkFK8SETtu2,6,0,0,0,0,1,5,1,7,1.0,1,0.0,0,0,0,0,0,1,0,5,1,0,7,1
6271,106373,DKhf23FUjC3109rVKohZnczA6uCGbVGI,SpATywNh6bZuzm8s1ceuBUnMUAeoAHHw,7,3,2,0,2,0,2,0,9,1.2857142857142858,1,0.0,0,2,0,2,3,0,0,2,0,4,5,1
6272,106388,N5GsiNu3FAKruWsJ810ZCYlr5LGRTZRP,SpATywNh6bZuzm8s1ceuBUnMUAeoAHHw,9,11,7,0,5,0,4,0,27,3.857142857142857,2,0.0,0,7,0,5,11,0,0,4,0,12,15,1
6273,106408,3C0RNflDAI8FmTdsE1mhjUkpDZ4xUri7,SpATywNh6bZuzm8s1ceuBUnMUAeoAHHw,5,3,1,0,1,0,2,0,7,1.0,1,0.0,0,1,0,1,3,0,0,2,0,2,5,1
6274,106422,gOpwYaP0oFM4wK1KEBXUDEJrae3X7fzc,SpATywNh6bZuzm8s1ceuBUnMUAeoAHHw,1,0,0,0,0,0,1,0,1,0.14285714285714285,1,0.0,0,0,0,0,0,0,0,1,0,0,1,1
6275,106434,i6H5zxz2U3b7Stgpyc7yvkBTJYyhoQYo,SpATywNh6bZuzm8s1ceuBUnMUAeoAHHw,5,6,1,0,0,0,3,0,10,1.4285714285714286,2,0.0,0,1,0,0,6,0,0,3,0,1,9,1
6276,106436,8TpCqC4monvJnKND6WblTCWAybHmTNVD,SpATywNh6bZuzm8s1ceuBUnMUAeoAHHw,1,0,0,0,0,0,1,0,1,0.14285714285714285,1,0.0,0,0,0,0,0,0,0,1,0,0,1,1
6277,106437,NyEijNa9dfqUApw5iyHdD9FPGDdLrbLb,SpATywNh6bZuzm8s1ceuBUnMUAeoAHHw,5,2,1,0,1,0,2,0,6,0.8571428571428571,2,0.0,0,1,0,1,2,0,0,2,0,2,4,1
6278,106443,t3vj4r7JOWedUjNWDPc1a4izv1Cmnqwm,RXDvfPUBYFlVdlueBFbLW0mhhAyGEqpt,5,1,1,0,1,0,2,0,5,0.7142857142857143,1,0.0,0,1,0,1,1,0,0,2,0,2,3,1
6279,106446,bazJXiq7ucQvx12BgvEogiLDadc2i22I,RXDvfPUBYFlVdlueBFbLW0mhhAyGEqpt,4,2,0,0,0,4,2,0,8,1.1428571428571428,1,0.0,0,0,0,0,2,4,0,2,0,0,8,1
6280,106460,pdAqVvKgeCIaihAcxhTXOYjPQxxjaa8K,SpATywNh6bZuzm8s1ceuBUnMUAeoAHHw,5,3,1,0,1,0,2,0,7,1.0,1,0.0,0,1,0,1,3,0,0,2,0,2,5,1
6281,106463,pdAqVvKgeCIaihAcxhTXOYjPQxxjaa8K,G8EPVSXsOYB5YQWZGiz1aVq5Pgr2GrQu,7,5,2,0,2,0,2,0,11,1.5714285714285714,1,0.0,0,2,0,2,5,0,0,2,0,4,7,1
6282,106465,MJfBdskwO4D70ierxBCGMKCiw8lrVzMw,SpATywNh6bZuzm8s1ceuBUnMUAeoAHHw,8,4,3,0,3,0,1,0,11,1.5714285714285714,1,0.0,0,3,0,3,4,0,0,1,0,6,5,1
6283,106470,bMarbVnDr4OepC5ZPynjVXhQz0xRB6Ed,SpATywNh6bZuzm8s1ceuBUnMUAeoAHHw,14,16,5,15,3,1,2,0,42,6.0,1,0.0,10,5,12,3,6,1,3,2,0,30,12,0
6284,106472,B0Edo8kqkjTSYODfsszisfXIJvzjLDbd,SpATywNh6bZuzm8s1ceuBUnMUAeoAHHw,1,0,0,0,0,0,1,0,1,0.14285714285714285,1,0.0,0,0,0,0,0,0,0,1,0,0,1,0
6285,106484,bP02cfOIFimMsMVUcFl4uLZksud3wO6q,SpATywNh6bZuzm8s1ceuBUnMUAeoAHHw,1,0,0,0,0,0,1,0,1,0.14285714285714285,1,0.0,0,0,0,0,0,0,0,1,0,0,1,1
6286,106491,bP02cfOIFimMsMVUcFl4uLZksud3wO6q,5X6FeZozNMgE2VRi3MJYjkkFK8SETtu2,1,0,0,0,0,0,1,0,1,0.14285714285714285,1,0.0,0,0,0,0,0,0,0,1,0,0,1,1
6287,106492,C3hAWoS9AbYLxLAAlN0y3d7i9WUss3n3,SpATywNh6bZuzm8s1ceuBUnMUAeoAHHw,3,0,0,0,0,5,3,0,8,1.1428571428571428,1,0.0,0,0,0,0,0,5,0,3,0,0,8,1
6288,106493,bP02cfOIFimMsMVUcFl4uLZksud3wO6q,bWdj2GDclj5ofokWjzoa5jAwMkxCykd6,1,0,0,0,0,0,1,0,1,0.14285714285714285,1,0.0,0,0,0,0,0,0,0,1,0,0,1,1
6289,106495,bP02cfOIFimMsMVUcFl4uLZksud3wO6q,G8EPVSXsOYB5YQWZGiz1aVq5Pgr2GrQu,1,0,0,0,0,0,1,0,1,0.14285714285714285,1,0.0,0,0,0,0,0,0,0,1,0,0,1,1
6290,106498,bP02cfOIFimMsMVUcFl4uLZksud3wO6q,A3fsA9Zfv1X2fVEQhTw51lKENdNrEqT3,1,0,0,0,0,0,1,0,1,0.14285714285714285,1,0.0,0,0,0,0,0,0,0,1,0,0,1,1
6291,106511,op6fYsDSJ7UTrHBvFtSBIo32ykj3vZlc,5X6FeZozNMgE2VRi3MJYjkkFK8SETtu2,8,16,0,2,5,0,11,0,34,4.857142857142857,5,0.0,11,0,2,5,5,0,0,11,0,18,16,1
6292,106518,aWU6GALeCayeG1vo49En0w2vX7HsfHCy,G8EPVSXsOYB5YQWZGiz1aVq5Pgr2GrQu,24,44,14,8,8,1,13,1,89,12.714285714285714,1,0.0,14,14,5,8,30,1,3,13,1,41,48,1
6293,106520,q2ar2IRhg35oX7gtyUjKKpitik3AlI40,A3fsA9Zfv1X2fVEQhTw51lKENdNrEqT3,1,0,0,0,0,0,1,0,1,0.14285714285714285,1,0.0,0,0,0,0,0,0,0,1,0,0,1,1
6294,106522,pCFkPYqdu1teVglAllomSvRRE7DQZT44,RXDvfPUBYFlVdlueBFbLW0mhhAyGEqpt,7,5,1,0,1,0,1,0,8,1.1428571428571428,1,0.0,0,1,0,1,5,0,0,1,0,2,6,1
6295,106523,Cduwd07l9ihp0BpAay0pd2rAkJg37JEO,RXDvfPUBYFlVdlueBFbLW0mhhAyGEqpt,17,20,0,23,1,0,2,0,46,6.571428571428571,1,0.0,3,0,20,1,17,0,3,2,0,24,22,1
6296,106532,bh5BFBK0otMDKfxb8aR6tfITatyirhu2,SpATywNh6bZuzm8s1ceuBUnMUAeoAHHw,4,2,0,0,0,0,2,0,4,0.5714285714285714,1,0.0,0,0,0,0,2,0,0,2,0,0,4,1
6297,106537,HLWfEZgV82l2tUnqCdihA4swo6uB5JmG,SpATywNh6bZuzm8s1ceuBUnMUAeoAHHw,1,0,0,0,0,0,1,0,1,0.14285714285714285,1,0.0,0,0,0,0,0,0,0,1,0,0,1,0
6298,106547,dstTpT2BjfmJxSzmJpU00abOAObDPwAz,SpATywNh6bZuzm8s1ceuBUnMUAeoAHHw,1,0,0,0,0,0,1,0,1,0.14285714285714285,1,0.0,0,0,0,0,0,0,0,1,0,0,1,1
6299,106591,rxfzVJVj4XNymQN7SX1pdLUM549NCrW7,SpATywNh6bZuzm8s1ceuBUnMUAeoAHHw,8,10,7,0,3,5,2,0,27,3.857142857142857,2,0.0,0,7,0,3,10,5,0,2,0,10,17,0
6300,106598,iXoEMwcJ5o4IM7VKZ5pyam9GxPy4olUQ,5X6FeZozNMgE2VRi3MJYjkkFK8SETtu2,6,16,3,0,0,0,3,0,22,3.142857142857143,1,0.0,3,3,0,0,13,0,0,3,0,6,16,1
6301,106606,9fSst0DYScvrsgwHkRdeAWaCTv1iMoKg,SpATywNh6bZuzm8s1ceuBUnMUAeoAHHw,1,0,0,0,0,0,1,0,1,0.14285714285714285,1,0.0,0,0,0,0,0,0,0,1,0,0,1,1
6302,106640,7JpAhJZcu52sQ4zH9lE7ptLjQsjTlady,G8EPVSXsOYB5YQWZGiz1aVq5Pgr2GrQu,9,27,6,0,5,1,10,1,50,7.142857142857143,1,0.0,13,6,0,5,14,1,0,10,1,24,26,0
6303,106643,MyYvsUimsdJLREHlZB7pLW11HvGvwatH,A3fsA9Zfv1X2fVEQhTw51lKENdNrEqT3,3,3,1,0,0,0,1,0,5,0.7142857142857143,1,0.0,0,1,0,0,3,0,0,1,0,1,4,1
6304,106649,dstTpT2BjfmJxSzmJpU00abOAObDPwAz,G8EPVSXsOYB5YQWZGiz1aVq5Pgr2GrQu,1,0,0,0,0,0,1,0,1,0.14285714285714285,1,0.0,0,0,0,0,0,0,0,1,0,0,1,1
6305,106650,GebdA7Vo87ReyKP2A7BXi3CttXQIgfXb,SpATywNh6bZuzm8s1ceuBUnMUAeoAHHw,1,0,0,0,0,0,1,0,1,0.14285714285714285,1,0.0,0,0,0,0,0,0,0,1,0,0,1,1
6306,106655,5r9OEsSFtsP3T0AQQIuWD6ouO08AmGp2,bWdj2GDclj5ofokWjzoa5jAwMkxCykd6,1,0,0,0,0,0,1,0,1,0.14285714285714285,1,0.0,0,0,0,0,0,0,0,1,0,0,1,1
6307,106689,RpVeRO6gAfuIJgHx6Sdcq1K3gg7WWxhi,SpATywNh6bZuzm8s1ceuBUnMUAeoAHHw,42,36,22,32,14,0,3,0,107,15.285714285714286,3,0.0,11,22,29,14,25,0,3,3,0,76,31,1
6308,106698,AuIQbwKCl1rpgmIzQXLySneETBtGUcy9,SpATywNh6bZuzm8s1ceuBUnMUAeoAHHw,4,3,0,0,0,0,1,0,4,0.5714285714285714,1,0.0,0,0,0,0,3,0,0,1,0,0,4,1
6309,106701,bUlVBXqXRojGcrtmo2UOxhIzd8vCtLry,SpATywNh6bZuzm8s1ceuBUnMUAeoAHHw,7,5,3,0,3,0,3,0,14,2.0,2,0.0,0,3,0,3,5,0,0,3,0,6,8,1
6310,106705,Pnj0azS8P7bL4tIbWN5mqjFl1a8tuCEd,bWdj2GDclj5ofokWjzoa5jAwMkxCykd6,8,6,4,0,3,0,3,0,16,2.2857142857142856,1,0.0,0,4,0,3,6,0,0,3,0,7,9,1
6311,106710,2sYGHfb0Gpw1ITIdkhTs2jjyBEZU4HAF,SpATywNh6bZuzm8s1ceuBUnMUAeoAHHw,15,27,0,10,0,0,9,0,46,6.571428571428571,3,0.0,5,0,10,0,22,0,0,9,0,15,31,1
6312,106714,S9GhTyD7qyH3KrCKFhzfEswPlAknGlRK,SpATywNh6bZuzm8s1ceuBUnMUAeoAHHw,9,3,2,0,2,0,4,0,11,1.5714285714285714,1,0.0,0,2,0,2,3,0,0,4,0,4,7,1
6313,106719,eOyjHJuwOD7RIuhNsn2aD5QXKZmvQvMJ,SpATywNh6bZuzm8s1ceuBUnMUAeoAHHw,1,0,0,0,0,0,1,0,1,0.14285714285714285,1,0.0,0,0,0,0,0,0,0,1,0,0,1,1
6314,106722,tYtKY0fbDxdVMqQSQtSw2vWDwWIzdu2T,SpATywNh6bZuzm8s1ceuBUnMUAeoAHHw,6,2,1,0,1,0,4,1,9,1.2857142857142858,1,0.0,0,1,0,1,2,0,0,4,1,2,7,1
6315,106724,LBz8eebDA0q3o7gWfqXlzvsHwwqTUJzd,SpATywNh6bZuzm8s1ceuBUnMUAeoAHHw,15,22,0,10,0,1,4,0,37,5.285714285714286,2,0.0,7,0,9,0,15,1,1,4,0,16,21,0
6316,106733,Cduwd07l9ihp0BpAay0pd2rAkJg37JEO,A3fsA9Zfv1X2fVEQhTw51lKENdNrEqT3,6,7,1,0,1,0,1,0,10,1.4285714285714286,1,0.0,0,1,0,1,7,0,0,1,0,2,8,1
6317,106744,epz8WjfpOXjHx8PqWhAfdNzAuBHZ8Sqp,G8EPVSXsOYB5YQWZGiz1aVq5Pgr2GrQu,6,2,1,0,1,0,3,1,8,1.1428571428571428,1,0.0,0,1,0,1,2,0,0,3,1,2,6,1
6318,106751,YYCI1ivPCDRa3x25VBUTnS1EqXk51k7P,5X6FeZozNMgE2VRi3MJYjkkFK8SETtu2,8,12,5,0,2,3,9,0,31,4.428571428571429,1,0.0,1,5,0,2,11,3,0,9,0,8,23,1
6319,106757,w9XtwyzvRxdlT7TETbqeY2eb4lfxta29,bWdj2GDclj5ofokWjzoa5jAwMkxCykd6,5,3,2,0,2,0,3,0,10,1.4285714285714286,1,0.0,0,2,0,2,3,0,0,3,0,4,6,1
6320,106781,qXQHPbibS0VS8GGMP77leSpbpNyK0HKr,SpATywNh6bZuzm8s1ceuBUnMUAeoAHHw,5,3,2,0,0,0,2,0,7,1.0,1,0.0,0,2,0,0,3,0,0,2,0,2,5,1
6321,106784,wMDkRlLY4isbEoj9TOjvaXeMCQLsBTi8,SpATywNh6bZuzm8s1ceuBUnMUAeoAHHw,6,5,3,0,0,0,3,0,11,1.5714285714285714,1,0.0,0,3,0,0,5,0,0,3,0,3,8,1
6322,106794,F2owRK2SDPW5FCDK4TxmBVHsTtJ44Nxq,5X6FeZozNMgE2VRi3MJYjkkFK8SETtu2,1,0,0,0,0,0,1,0,1,0.14285714285714285,1,0.0,0,0,0,0,0,0,0,1,0,0,1,1
6323,106797,qSqicsHTfA7awftDly8FnFdkrTLfB2If,bWdj2GDclj5ofokWjzoa5jAwMkxCykd6,10,9,1,12,4,0,3,0,29,4.142857142857143,1,0.0,6,1,10,4,3,0,2,3,0,21,8,1
6324,106816,3PvD9OHPY5l8VAGiigtv266oF9uzOqWW,bWdj2GDclj5ofokWjzoa5jAwMkxCykd6,1,0,0,0,0,0,1,0,1,0.14285714285714285,1,0.0,0,0,0,0,0,0,0,1,0,0,1,1
6325,106822,Ahih1LlFS0wdudINocND3lILXT50AxNl,bWdj2GDclj5ofokWjzoa5jAwMkxCykd6,1,0,0,0,0,0,1,0,1,0.14285714285714285,1,0.0,0,0,0,0,0,0,0,1,0,0,1,1
6326,106833,5URiiR96pJ3BGEHKPw9V5T2W795iQ19d,bWdj2GDclj5ofokWjzoa5jAwMkxCykd6,1,0,0,0,0,0,1,0,1,0.14285714285714285,1,0.0,0,0,0,0,0,0,0,1,0,0,1,1
6327,106835,5URiiR96pJ3BGEHKPw9V5T2W795iQ19d,A3fsA9Zfv1X2fVEQhTw51lKENdNrEqT3,1,0,0,0,0,0,1,0,1,0.14285714285714285,1,0.0,0,0,0,0,0,0,0,1,0,0,1,1
6328,106849,UJiJ4PvH4qodyDnURbFXyi5LWwaSKUwb,bWdj2GDclj5ofokWjzoa5jAwMkxCykd6,9,8,2,16,4,0,2,0,32,4.571428571428571,1,0.0,5,2,14,4,3,0,2,2,0,25,7,1
6329,106853,DSkyPIUtT8xxP5Yu1DrvohPZBHHgxJAD,SpATywNh6bZuzm8s1ceuBUnMUAeoAHHw,5,5,3,0,0,0,2,0,10,1.4285714285714286,1,0.0,0,3,0,0,5,0,0,2,0,3,7,1
6330,106858,wwFNSVNavy53ZZLg1TQ0hM4pFCmqfiLF,A3fsA9Zfv1X2fVEQhTw51lKENdNrEqT3,9,5,2,0,0,2,6,1,16,2.2857142857142856,1,0.0,2,2,0,0,3,2,0,6,1,4,12,0
6331,106865,tpRB0Y2odcJ8wbxdjaREs5gktwFdDR2h,bWdj2GDclj5ofokWjzoa5jAwMkxCykd6,1,0,0,0,0,0,2,0,2,0.2857142857142857,1,0.0,0,0,0,0,0,0,0,2,0,0,2,1
6332,106875,fMx92g7Jo1AcMZwPvPIvrvUTeg1dWBrD,RXDvfPUBYFlVdlueBFbLW0mhhAyGEqpt,5,3,2,0,2,0,3,0,10,1.4285714285714286,3,0.0,0,2,0,2,3,0,0,3,0,4,6,1
6333,106888,6zMvATewcq8WRjty9hT4teUCYKhChdQh,bWdj2GDclj5ofokWjzoa5jAwMkxCykd6,2,0,0,0,0,0,4,0,4,0.5714285714285714,1,0.0,0,0,0,0,0,0,0,4,0,0,4,1
6334,106891,qFnZG81HTlpUeqdWqLaQb2RJMVogFUVu,5X6FeZozNMgE2VRi3MJYjkkFK8SETtu2,1,0,0,0,0,0,1,0,1,0.14285714285714285,1,0.0,0,0,0,0,0,0,0,1,0,0,1,1
6335,106906,myNTp931AmSPRA2kl8memATVLQzx4fxs,SpATywNh6bZuzm8s1ceuBUnMUAeoAHHw,7,5,2,7,0,0,1,0,15,2.142857142857143,1,0.0,2,2,7,0,3,0,0,1,0,11,4,1
6336,106915,1Udy3gnh9HMf01YloLJgkopQMoq9kMsz,bWdj2GDclj5ofokWjzoa5jAwMkxCykd6,2,0,0,0,0,0,4,0,4,0.5714285714285714,1,0.0,0,0,0,0,0,0,0,4,0,0,4,1
6337,106920,mx5uNWTFASThXTBo9bW2o4U3G4bTw9Oo,5X6FeZozNMgE2VRi3MJYjkkFK8SETtu2,1,0,0,0,0,0,1,0,1,0.14285714285714285,1,0.0,0,0,0,0,0,0,0,1,0,0,1,1
6338,106929,fW4fbh90nu73Q6G9ndiED1PUrE0wupYF,SpATywNh6bZuzm8s1ceuBUnMUAeoAHHw,4,3,1,0,0,0,2,0,6,0.8571428571428571,1,0.0,0,1,0,0,3,0,0,2,0,1,5,1
6339,106940,NKTsGtocSBmn1p0LL8TfbQ17Oh6XvCt3,SpATywNh6bZuzm8s1ceuBUnMUAeoAHHw,3,14,7,0,0,0,6,0,27,3.857142857142857,4,0.0,0,7,0,0,14,0,0,6,0,7,20,0
6340,106941,pLqg9VEcxR9ds22e3uE9UuC1QIy40paq,RXDvfPUBYFlVdlueBFbLW0mhhAyGEqpt,4,2,1,0,1,0,1,0,5,0.7142857142857143,1,0.0,0,1,0,1,2,0,0,1,0,2,3,1
6341,106950,BxhpecUzZZ9XTMglNesOYipbpJL9rX1j,SpATywNh6bZuzm8s1ceuBUnMUAeoAHHw,6,6,3,0,3,0,4,0,16,2.2857142857142856,1,0.0,0,3,0,3,6,0,0,4,0,6,10,1
6342,106955,wMYwbasBu7kj6nAVyuyEqjGmi3ogAq0E,SpATywNh6bZuzm8s1ceuBUnMUAeoAHHw,5,6,5,0,4,0,1,0,16,2.2857142857142856,1,0.0,0,5,0,4,6,0,0,1,0,9,7,1
6343,106963,3wBD00ypE5ShQJhnUdswEeP7Ynn8tGHZ,bWdj2GDclj5ofokWjzoa5jAwMkxCykd6,8,6,2,0,2,0,4,0,14,2.0,1,0.0,1,2,0,2,5,0,0,4,0,5,9,1
6344,106965,4Dp7LLp7t1gYbdcN4ZxWGwhRKXqsnWGQ,A3fsA9Zfv1X2fVEQhTw51lKENdNrEqT3,7,4,1,0,1,0,2,0,8,1.1428571428571428,1,0.0,0,1,0,1,4,0,0,2,0,2,6,1
6345,106974,DccaKc9Q3a9ni72KWPKrJiivxObiw1S5,SpATywNh6bZuzm8s1ceuBUnMUAeoAHHw,4,2,0,0,0,0,2,0,4,0.5714285714285714,1,0.0,0,0,0,0,2,0,0,2,0,0,4,1
6346,106991,foZomfeiH5mdSFjeB6umSt6lwP9hfSDR,A3fsA9Zfv1X2fVEQhTw51lKENdNrEqT3,4,2,1,0,0,0,2,0,5,0.7142857142857143,1,0.0,0,1,0,0,2,0,0,2,0,1,4,1
6347,106994,foZomfeiH5mdSFjeB6umSt6lwP9hfSDR,bWdj2GDclj5ofokWjzoa5jAwMkxCykd6,5,3,1,0,0,0,4,0,8,1.1428571428571428,2,0.0,0,1,0,0,3,0,0,4,0,1,7,1
6348,106999,7bBbNS8igBUmtAlhgWeyPaLpz7A08m0l,bWdj2GDclj5ofokWjzoa5jAwMkxCykd6,3,2,1,0,0,0,1,0,4,0.5714285714285714,1,0.0,0,1,0,0,2,0,0,1,0,1,3,0
6349,107016,mTHEBQKcpUpIn1qJcpLJBf1JarEh6HTV,G8EPVSXsOYB5YQWZGiz1aVq5Pgr2GrQu,6,8,3,0,1,0,5,0,17,2.4285714285714284,1,0.0,0,3,0,1,8,0,0,5,0,4,13,1
6350,107018,OYWBopBO2n38CA6GRAaDJRfIHV9b0dQs,A3fsA9Zfv1X2fVEQhTw51lKENdNrEqT3,1,0,0,0,0,0,3,0,3,0.42857142857142855,1,0.0,0,0,0,0,0,0,0,3,0,0,3,1
6351,107036,qpd1RINX0ghAugS9ZiQmRvWMQe2xJWfG,SpATywNh6bZuzm8s1ceuBUnMUAeoAHHw,1,0,0,0,0,0,1,0,1,0.14285714285714285,1,0.0,0,0,0,0,0,0,0,1,0,0,1,1
6352,107045,urj2Kr7Ws5qXQZp6biE11Qihh39xd0AE,A3fsA9Zfv1X2fVEQhTw51lKENdNrEqT3,1,0,0,0,0,0,1,0,1,0.14285714285714285,1,0.0,0,0,0,0,0,0,0,1,0,0,1,1
6353,107047,dPcBuI7bI8BiBDvjZ0Pq52a3IzmSdDrl,5X6FeZozNMgE2VRi3MJYjkkFK8SETtu2,1,0,0,0,0,0,1,0,1,0.14285714285714285,1,0.0,0,0,0,0,0,0,0,1,0,0,1,0
6354,107049,i8GOkgWlBQByuCuyYT08OdGCpL2A2Lxa,5X6FeZozNMgE2VRi3MJYjkkFK8SETtu2,1,0,0,0,0,0,1,0,1,0.14285714285714285,1,0.0,0,0,0,0,0,0,0,1,0,0,1,1
6355,107061,7ITppmxIJuiv2qwirt1AUPH7whJqqqHK,A3fsA9Zfv1X2fVEQhTw51lKENdNrEqT3,2,0,0,0,0,0,3,0,3,0.42857142857142855,2,0.0,0,0,0,0,0,0,0,3,0,0,3,1
6356,107071,c3Q7zBkcz9A9C9axYIiO1QysEG1V4UAO,3VkHkmOtom3jM2wCu94xgzzu1d6Dn7or,59,73,30,88,32,3,20,0,246,35.142857142857146,5,0.0,41,30,84,32,32,3,4,20,0,187,59,1
6357,107074,tO0oCacyCP3v3H0cyXZQAxRbRlfHVuYj,3VkHkmOtom3jM2wCu94xgzzu1d6Dn7or,21,10,1,0,9,0,2,0,22,3.142857142857143,1,0.0,0,1,0,9,10,0,0,2,0,10,12,1
6358,107077,NLIh4VJYbGXtPc1CA0F1tPrWSh7ESLKA,3VkHkmOtom3jM2wCu94xgzzu1d6Dn7or,2,1,0,0,0,0,1,0,2,0.2857142857142857,1,0.0,0,0,0,0,1,0,0,1,0,0,2,1
6359,107179,HOPYYoB2QW4Q8fdYSBXkCelzcNC0uPwD,3VkHkmOtom3jM2wCu94xgzzu1d6Dn7or,84,117,49,80,41,4,22,1,314,44.857142857142854,6,0.0,49,49,61,41,68,4,19,22,1,200,114,0
6360,107181,j3X3uTmlcQFLfvZ3dhwIq3KsV5teBSm0,3VkHkmOtom3jM2wCu94xgzzu1d6Dn7or,61,130,40,44,48,1,10,0,273,39.0,4,0.0,79,40,42,48,51,1,2,10,0,209,64,1
6361,107184,EUmZ5qzjwgko2PIWEnctkvYh7APnUrX9,3VkHkmOtom3jM2wCu94xgzzu1d6Dn7or,1,0,0,0,0,0,3,0,3,0.42857142857142855,1,0.0,0,0,0,0,0,0,0,3,0,0,3,1
6362,107274,7XqS4DbRrFLzLhwbdt6cdEB5XXkNUsTP,3VkHkmOtom3jM2wCu94xgzzu1d6Dn7or,30,50,18,41,12,25,21,21,188,26.857142857142858,5,0.0,20,18,32,12,30,25,9,21,21,82,106,0
6363,107285,CFwBanDE4eguHX9lcM62Yx5Bex6437kC,3VkHkmOtom3jM2wCu94xgzzu1d6Dn7or,2,0,0,0,0,2,2,0,4,0.5714285714285714,2,0.0,0,0,0,0,0,2,0,2,0,0,4,1
6364,107296,gX80ZeqkATSWdW6ScKpFgzDJH6XqkBjR,3VkHkmOtom3jM2wCu94xgzzu1d6Dn7or,1,0,0,0,0,0,1,0,1,0.14285714285714285,1,0.0,0,0,0,0,0,0,0,1,0,0,1,1
6365,107300,BcvlWUp5Go3BcZqGRpbDcdFffadBUUWh,3VkHkmOtom3jM2wCu94xgzzu1d6Dn7or,5,2,1,0,1,0,3,0,7,1.0,1,0.0,0,1,0,1,2,0,0,3,0,2,5,1
6366,107344,kC7JLQowN0BSKnzXXKRn5vuXi1nnM0dA,3VkHkmOtom3jM2wCu94xgzzu1d6Dn7or,14,13,7,4,5,5,7,0,41,5.857142857142857,2,0.0,2,7,4,5,11,5,0,7,0,18,23,1
6367,107348,WvvMhmSCzwWr2ITV1gNoJaX8mQF8RD4y,3VkHkmOtom3jM2wCu94xgzzu1d6Dn7or,5,2,1,0,1,0,3,0,7,1.0,2,0.0,0,1,0,1,2,0,0,3,0,2,5,1
6368,107357,ue8WVPLLafIf9IYdVejX2hZXpMQfwSob,3VkHkmOtom3jM2wCu94xgzzu1d6Dn7or,62,63,43,0,38,0,8,0,152,21.714285714285715,5,0.0,0,43,0,38,63,0,0,8,0,81,71,1
6369,107380,Idqx4zHscfaoPaYU2tE8rxUSHQT5ynnI,3VkHkmOtom3jM2wCu94xgzzu1d6Dn7or,1,0,0,0,0,0,1,0,1,0.14285714285714285,1,0.0,0,0,0,0,0,0,0,1,0,0,1,1
6370,107383,v8L5A0JOQdQh027Prn4fpZ6yyGP5io4t,3VkHkmOtom3jM2wCu94xgzzu1d6Dn7or,12,15,6,4,4,3,9,3,44,6.285714285714286,2,0.0,3,6,3,4,12,3,1,9,3,16,28,1
6371,107418,bp0cMJdpppPkJKpUEtMjgtVL3r3SoYZi,3VkHkmOtom3jM2wCu94xgzzu1d6Dn7or,1,0,0,0,0,0,1,0,1,0.14285714285714285,1,0.0,0,0,0,0,0,0,0,1,0,0,1,1
6372,107442,su91jdVM4pixtDMTfbv8iv1xV2Hz5B1x,3VkHkmOtom3jM2wCu94xgzzu1d6Dn7or,12,7,5,0,4,0,3,0,19,2.7142857142857144,1,0.0,0,5,0,4,7,0,0,3,0,9,10,1
6373,107443,LunuTlluI57ma5AiSck9cTLsUyT1ttHO,3VkHkmOtom3jM2wCu94xgzzu1d6Dn7or,5,2,1,0,1,0,2,0,6,0.8571428571428571,2,0.0,0,1,0,1,2,0,0,2,0,2,4,1
6374,107444,MlHPKmdi90dDdvX24jYoFlYEp8xS4RGn,3VkHkmOtom3jM2wCu94xgzzu1d6Dn7or,45,51,38,0,38,4,10,1,142,20.285714285714285,3,0.0,5,38,0,38,46,4,0,10,1,81,61,1
6375,107448,tuIaGc8mk8COngnOlFhw7CCBSQJon7zH,3VkHkmOtom3jM2wCu94xgzzu1d6Dn7or,17,39,8,10,11,4,8,0,80,11.428571428571429,2,0.0,13,8,8,11,26,4,2,8,0,40,40,0
6376,107464,qgfUrfWNLjU5Fv1mJqz90WRpjEvuRyfQ,3VkHkmOtom3jM2wCu94xgzzu1d6Dn7or,11,6,2,0,2,3,11,2,26,3.7142857142857144,1,0.0,0,2,0,2,6,3,0,11,2,4,22,1
6377,107471,pVWw7B1JfJMltEPPBSdY6V7SLZlcwQT0,3VkHkmOtom3jM2wCu94xgzzu1d6Dn7or,3,3,0,0,0,0,2,0,5,0.7142857142857143,1,0.0,0,0,0,0,3,0,0,2,0,0,5,1
6378,107506,LU9kxt8aKnlOn8SnA2EuX2MLajf5Sg2a,3VkHkmOtom3jM2wCu94xgzzu1d6Dn7or,5,3,1,0,1,0,3,1,9,1.2857142857142858,1,0.0,1,1,0,1,2,0,0,3,1,3,6,0
6379,107514,Wi2NuIcnwGjcJsrrE5JIp2Vt2U8MBxIT,3VkHkmOtom3jM2wCu94xgzzu1d6Dn7or,1,0,0,0,0,0,1,0,1,0.14285714285714285,1,0.0,0,0,0,0,0,0,0,1,0,0,1,1
6380,107562,xrJZG7bksK3YFan9RqpK1Mnlfo1oxWW3,3VkHkmOtom3jM2wCu94xgzzu1d6Dn7or,9,6,3,0,3,0,2,0,14,2.0,1,0.0,2,3,0,3,4,0,0,2,0,8,6,1
6381,107567,wnqL4ikirTp3IVDSMdZMrbw4XjnrnSDr,3VkHkmOtom3jM2wCu94xgzzu1d6Dn7or,1,0,0,0,0,0,2,0,2,0.2857142857142857,1,0.0,0,0,0,0,0,0,0,2,0,0,2,1
6382,107582,26GvHHySb58OPdFf8Mk6SNqTx0xFsgpD,3VkHkmOtom3jM2wCu94xgzzu1d6Dn7or,1,0,0,0,0,0,1,0,1,0.14285714285714285,1,0.0,0,0,0,0,0,0,0,1,0,0,1,1
6383,107629,1LoOTEJ1k2erzFX1Zw6heKGcrOnMVMUm,3VkHkmOtom3jM2wCu94xgzzu1d6Dn7or,12,18,8,0,7,0,13,0,46,6.571428571428571,1,0.0,6,8,0,7,12,0,0,13,0,21,25,1
6384,107632,MGyo4o8gjQ6E6wwX0LyAB6OgOTxee8JQ,3VkHkmOtom3jM2wCu94xgzzu1d6Dn7or,1,0,0,0,0,0,1,0,1,0.14285714285714285,1,0.0,0,0,0,0,0,0,0,1,0,0,1,1
6385,107688,5wOEfUc8ZPA9KiGaBfIyB4r8VUpQ2P6o,3VkHkmOtom3jM2wCu94xgzzu1d6Dn7or,7,5,2,0,3,0,3,0,13,1.8571428571428572,1,0.0,2,2,0,3,3,0,0,3,0,7,6,1
6386,107708,vsVhqUYkXGNDzYhAcqJvpgRZQTif8hqp,3VkHkmOtom3jM2wCu94xgzzu1d6Dn7or,5,2,1,0,1,0,2,0,6,0.8571428571428571,1,0.0,0,1,0,1,2,0,0,2,0,2,4,1
6387,107725,HhxyfxX2lkUuwRZ0VagK9INqIhhnjfvw,3VkHkmOtom3jM2wCu94xgzzu1d6Dn7or,4,5,1,0,0,0,2,0,8,1.1428571428571428,1,0.0,1,1,0,0,4,0,0,2,0,2,6,1
6388,107762,kv124loauGKO10jbqYqDYWXnHShlzRO4,3VkHkmOtom3jM2wCu94xgzzu1d6Dn7or,1,0,0,0,0,0,2,0,2,0.2857142857142857,1,0.0,0,0,0,0,0,0,0,2,0,0,2,1
6389,107766,PL62mgrpqPwo8AGEhoMOTQ6sdNxiCVqY,3VkHkmOtom3jM2wCu94xgzzu1d6Dn7or,5,5,1,0,2,0,3,0,11,1.5714285714285714,1,0.0,3,1,0,2,2,0,0,3,0,6,5,0
6390,107819,R9YG0w0hL59ToVl3yhmJRFd19TsubPDW,3VkHkmOtom3jM2wCu94xgzzu1d6Dn7or,1,0,0,0,0,0,1,0,1,0.14285714285714285,1,0.0,0,0,0,0,0,0,0,1,0,0,1,1
6391,107823,xQUW0ZINPCfWBAQh2BnHyNs9eUZ1JA0b,3VkHkmOtom3jM2wCu94xgzzu1d6Dn7or,1,0,0,0,0,0,1,0,1,0.14285714285714285,1,0.0,0,0,0,0,0,0,0,1,0,0,1,1
6392,107841,KfcZ3W9oSoFuM8WY2udTATirwh59JEJW,3VkHkmOtom3jM2wCu94xgzzu1d6Dn7or,14,16,10,0,8,0,4,0,38,5.428571428571429,2,0.0,0,10,0,8,16,0,0,4,0,18,20,1
6393,107856,9le10djZxN9iTNFKqMsYSlchlTVUSxwB,3VkHkmOtom3jM2wCu94xgzzu1d6Dn7or,5,2,1,0,1,0,3,0,7,1.0,1,0.0,0,1,0,1,2,0,0,3,0,2,5,1
6394,107861,ISUXk5sdyyrQMtfiKV2swvwh2PS1r6hM,3VkHkmOtom3jM2wCu94xgzzu1d6Dn7or,1,0,0,0,0,0,1,0,1,0.14285714285714285,1,0.0,0,0,0,0,0,0,0,1,0,0,1,1
6395,107877,GvP8ww4LGRcqaW1DVshTWjelfELX1mSf,3VkHkmOtom3jM2wCu94xgzzu1d6Dn7or,1,0,0,0,0,0,1,0,1,0.14285714285714285,1,0.0,0,0,0,0,0,0,0,1,0,0,1,1
6396,107879,iGeUboxof9bW7NItCpNmoDFMiWymYAGm,3VkHkmOtom3jM2wCu94xgzzu1d6Dn7or,1,0,0,0,0,0,1,0,1,0.14285714285714285,1,0.0,0,0,0,0,0,0,0,1,0,0,1,1
6397,107930,gtkky83CXCTW8iQ6mNLOFHjlf4zvNJmH,3VkHkmOtom3jM2wCu94xgzzu1d6Dn7or,7,4,1,0,2,0,6,4,17,2.4285714285714284,1,0.0,2,1,0,2,2,0,0,6,4,5,12,1
6398,108075,EboqTOLce3Kcnbr13rePsINEM3noHrcD,A3fsA9Zfv1X2fVEQhTw51lKENdNrEqT3,5,5,3,0,0,0,1,0,9,1.2857142857142858,1,0.0,1,3,0,0,4,0,0,1,0,4,5,1
6399,108154,hbTx2HlAPaSfk5EORjF7ocOSpDhWinaD,G8EPVSXsOYB5YQWZGiz1aVq5Pgr2GrQu,51,111,69,124,34,1,17,0,356,50.857142857142854,1,0.0,15,69,101,34,96,1,23,17,0,219,137,0
6400,108235,uGnwUJpu1DKiWsVPpyszxZyMbYFsrVu7,SpATywNh6bZuzm8s1ceuBUnMUAeoAHHw,6,4,3,0,1,0,1,0,9,1.2857142857142858,1,0.0,0,3,0,1,4,0,0,1,0,4,5,0
6401,108697,6HIBebNSnNEoSeekVShzxF3x0IcbgohT,A3fsA9Zfv1X2fVEQhTw51lKENdNrEqT3,6,4,1,0,1,0,1,0,7,1.0,1,0.0,0,1,0,1,4,0,0,1,0,2,5,1
6402,108740,z8PlFZ3kRCGZCtReInG4syWyRUKvCeDo,RXDvfPUBYFlVdlueBFbLW0mhhAyGEqpt,33,28,2,45,3,0,2,0,80,11.428571428571429,2,0.0,11,2,44,3,17,0,1,2,0,60,20,0
6403,108782,KdDp90RfX0ap0e8qJs31e2eGxlYje3er,A3fsA9Zfv1X2fVEQhTw51lKENdNrEqT3,2,8,4,0,0,0,0,0,12,1.7142857142857142,2,0.0,0,4,0,0,8,0,0,0,0,4,8,1
6404,108961,xOpIfUll35xPHM6WEP4Czjw6kk2qoOGO,SpATywNh6bZuzm8s1ceuBUnMUAeoAHHw,3,2,1,0,0,0,1,0,4,0.5714285714285714,1,0.0,0,1,0,0,2,0,0,1,0,1,3,1
6405,109002,qZCURwy8JtTyuwzOv8VNGZdlPKRFUQ4x,A3fsA9Zfv1X2fVEQhTw51lKENdNrEqT3,2,0,0,0,0,0,3,0,3,0.42857142857142855,1,0.0,0,0,0,0,0,0,0,3,0,0,3,1
6406,109074,3Q4BnqdcagQPfwKNQquFMuffhZmA481O,A3fsA9Zfv1X2fVEQhTw51lKENdNrEqT3,6,5,4,0,2,0,1,0,12,1.7142857142857142,1,0.0,0,4,0,2,5,0,0,1,0,6,6,0
6407,109186,5kEshmgSAUGvBEOsnsKU8IViB0lkOwoD,A3fsA9Zfv1X2fVEQhTw51lKENdNrEqT3,2,0,0,0,0,0,2,0,2,0.2857142857142857,1,0.0,0,0,0,0,0,0,0,2,0,0,2,1
6408,109193,SclrH2608f72JlTtkBQ5xWQXCuDyyco3,A3fsA9Zfv1X2fVEQhTw51lKENdNrEqT3,73,20,13,264,4,0,2,0,303,43.285714285714285,1,0.0,3,13,240,4,17,0,24,2,0,260,43,0
6409,109272,BLoa1RvSOgexbSH4hGzCihmBc8pXd0Db,SpATywNh6bZuzm8s1ceuBUnMUAeoAHHw,1,0,0,0,0,0,1,0,1,0.14285714285714285,1,0.0,0,0,0,0,0,0,0,1,0,0,1,1
6410,109454,xvNZbY8RiapNT0qosUHeJFlEtqfPfVcr,SpATywNh6bZuzm8s1ceuBUnMUAeoAHHw,3,2,1,0,0,1,1,0,5,0.7142857142857143,1,0.0,0,1,0,0,2,1,0,1,0,1,4,1
6411,109503,IoDMPccLVuoP1kfQwv1qzxHOaDwHWJ1B,RXDvfPUBYFlVdlueBFbLW0mhhAyGEqpt,21,29,20,3,10,9,3,0,74,10.571428571428571,2,0.0,4,20,3,10,25,9,0,3,0,37,37,1
6412,109555,Cv1aavObJnuABKfipF6OGePzg0BnGPFs,G8EPVSXsOYB5YQWZGiz1aVq5Pgr2GrQu,25,4,4,70,0,0,5,0,83,11.857142857142858,2,0.0,0,4,61,0,4,0,9,5,0,65,18,1
6413,109705,HMYpimZGFgj5IczDutkfjUfnxl45PoHW,A3fsA9Zfv1X2fVEQhTw51lKENdNrEqT3,2,0,0,0,0,14,2,0,16,2.2857142857142856,1,0.0,0,0,0,0,0,14,0,2,0,0,16,1
6414,109821,OEuLxcw6vw5UY038iWtYfZUlieO9mgsq,RXDvfPUBYFlVdlueBFbLW0mhhAyGEqpt,70,57,37,144,18,3,2,0,261,37.285714285714285,2,0.0,17,37,132,18,40,3,12,2,0,204,57,1
6415,109841,008XUUt5rc6hUrg7SHj9oW0rG0FE0dkF,A3fsA9Zfv1X2fVEQhTw51lKENdNrEqT3,59,29,26,180,0,0,2,0,237,33.857142857142854,4,0.0,1,26,147,0,28,0,33,2,0,174,63,0
6416,110053,gaD5Av49rKMTRISUDiGUl6H5FYk7vPMw,G8EPVSXsOYB5YQWZGiz1aVq5Pgr2GrQu,40,24,7,108,6,0,1,0,146,20.857142857142858,1,0.0,16,7,86,6,8,0,22,1,0,115,31,0
6417,110087,TtTC2azhA3pvSmtwPTzGbUN9oyOeRHBv,3VkHkmOtom3jM2wCu94xgzzu1d6Dn7or,63,109,32,63,35,0,5,0,244,34.857142857142854,3,0.0,58,32,60,35,51,0,3,5,0,185,59,0
6418,110094,i91AbpcoiVsM4MtiPDZxirvyVmbhFUip,3VkHkmOtom3jM2wCu94xgzzu1d6Dn7or,6,10,5,0,0,0,6,4,25,3.5714285714285716,2,0.0,0,5,0,0,10,0,0,6,4,5,20,1
6419,110106,8irCUZa4UAKsYYFeHrY9ttb5xgcL2ou7,3VkHkmOtom3jM2wCu94xgzzu1d6Dn7or,11,8,4,0,2,24,12,1,51,7.285714285714286,3,0.0,0,4,0,2,8,24,0,12,1,6,45,0
6420,110127,gh3vlMxFzpJyPcJAc3Sa35bec7vhjiGs,3VkHkmOtom3jM2wCu94xgzzu1d6Dn7or,7,3,2,0,2,0,2,0,9,1.2857142857142858,1,0.0,0,2,0,2,3,0,0,2,0,4,5,1
6421,110153,fS72R3kjN9mNNeiYurwm3Uc8w1dF6aYm,3VkHkmOtom3jM2wCu94xgzzu1d6Dn7or,94,399,126,126,118,145,58,22,994,142.0,22,0.0,225,126,110,118,174,145,16,58,22,579,415,0
6422,110164,EAJX7pYPeyFbc8fdFlq04tVzULACuDzH,3VkHkmOtom3jM2wCu94xgzzu1d6Dn7or,4,2,0,0,0,0,3,0,5,0.7142857142857143,1,0.0,0,0,0,0,2,0,0,3,0,0,5,1
6423,110170,rCXamJ7s0E4WpVnjTj9Ny0mFon0s0b2s,3VkHkmOtom3jM2wCu94xgzzu1d6Dn7or,8,5,3,0,1,2,6,0,17,2.4285714285714284,3,0.0,0,3,0,1,5,2,0,6,0,4,13,0
6424,110177,nknXXbQsC6Q6nMDyRKc0MDJZg6KtAXBE,3VkHkmOtom3jM2wCu94xgzzu1d6Dn7or,11,29,13,4,6,6,12,0,70,10.0,7,0.0,5,13,4,6,24,6,0,12,0,28,42,0
6425,110182,87013PkHpAB228usvI4HKmNxb2mybs5V,3VkHkmOtom3jM2wCu94xgzzu1d6Dn7or,1,0,0,0,0,0,1,0,1,0.14285714285714285,1,0.0,0,0,0,0,0,0,0,1,0,0,1,1
6426,110183,j2Dd0a1l5Qc6RnwSvUw0PSeLYT8b80Nj,3VkHkmOtom3jM2wCu94xgzzu1d6Dn7or,16,23,11,5,10,4,11,0,64,9.142857142857142,3,0.0,8,11,5,10,15,4,0,11,0,34,30,1
6427,110186,jXgMhQKbkiBaFyvNHAIM6AePvnnTFQC0,3VkHkmOtom3jM2wCu94xgzzu1d6Dn7or,14,18,6,24,0,4,3,0,55,7.857142857142857,2,0.0,9,6,23,0,9,4,1,3,0,38,17,1
6428,110189,3iudZystfLNtMUEeNqgADL7gR2YGFlHu,3VkHkmOtom3jM2wCu94xgzzu1d6Dn7or,9,4,3,0,3,0,2,0,12,1.7142857142857142,1,0.0,0,3,0,3,4,0,0,2,0,6,6,1
6429,110191,NO5Xz3DMvF701kgf1hI1ZFFxKMoGSe3T,3VkHkmOtom3jM2wCu94xgzzu1d6Dn7or,1,0,0,0,0,0,1,0,1,0.14285714285714285,1,0.0,0,0,0,0,0,0,0,1,0,0,1,1
6430,110212,yndM0Mmqe4G3WSqDVZ6guxAylWUqTPem,3VkHkmOtom3jM2wCu94xgzzu1d6Dn7or,5,2,1,0,1,0,4,0,8,1.1428571428571428,1,0.0,0,1,0,1,2,0,0,4,0,2,6,1
6431,110222,7ApqvegwR9RncmqiQgmeqYRNwf1naN8H,3VkHkmOtom3jM2wCu94xgzzu1d6Dn7or,1,0,0,0,0,0,1,0,1,0.14285714285714285,1,0.0,0,0,0,0,0,0,0,1,0,0,1,1
6432,110233,ZHxd8TqgIF8DZVKwp0YEIHIiKj4TlTuC,3VkHkmOtom3jM2wCu94xgzzu1d6Dn7or,1,0,0,0,0,0,1,0,1,0.14285714285714285,1,0.0,0,0,0,0,0,0,0,1,0,0,1,1
6433,110297,mSG93IKana8XXZAVtRRCymW2SAgrQS50,3VkHkmOtom3jM2wCu94xgzzu1d6Dn7or,8,6,4,0,4,0,3,0,17,2.4285714285714284,1,0.0,1,4,0,4,5,0,0,3,0,9,8,1
6434,110308,jzTr3LDW83ve5VioJqiTtg9mV6Kn1Sr1,3VkHkmOtom3jM2wCu94xgzzu1d6Dn7or,1,0,0,0,0,0,1,0,1,0.14285714285714285,1,0.0,0,0,0,0,0,0,0,1,0,0,1,1
6435,110312,KkrlMxBokvNpPT9nTD0DxZg6K1J6u4Xr,3VkHkmOtom3jM2wCu94xgzzu1d6Dn7or,1,0,0,0,0,0,1,0,1,0.14285714285714285,1,0.0,0,0,0,0,0,0,0,1,0,0,1,1
6436,110357,MnnYhwyXyzJDgxLaCtkeYz6Haw4CP7sm,3VkHkmOtom3jM2wCu94xgzzu1d6Dn7or,1,0,0,0,0,0,1,0,1,0.14285714285714285,1,0.0,0,0,0,0,0,0,0,1,0,0,1,1
6437,110374,ny721gkgjta5ETYwIQs20w4lCGP0gJwi,3VkHkmOtom3jM2wCu94xgzzu1d6Dn7or,91,353,86,136,95,9,42,1,722,103.14285714285714,4,0.0,170,86,115,95,183,9,21,42,1,466,256,0
6438,110451,CfjKRvCO2vIEYos7lXAFumqsUeYwfePU,3VkHkmOtom3jM2wCu94xgzzu1d6Dn7or,6,2,1,0,1,0,3,0,7,1.0,1,0.0,0,1,0,1,2,0,0,3,0,2,5,1
6439,110577,RvRsXzYULX8CJPXHa5mzL8AcNhscf6wx,3VkHkmOtom3jM2wCu94xgzzu1d6Dn7or,1,0,0,0,0,0,1,0,1,0.14285714285714285,1,0.0,0,0,0,0,0,0,0,1,0,0,1,1
6440,110688,UDlD3p3eo49Q67jkzPz6srqLTM4nCHO8,3VkHkmOtom3jM2wCu94xgzzu1d6Dn7or,2,0,0,0,0,0,2,0,2,0.2857142857142857,1,0.0,0,0,0,0,0,0,0,2,0,0,2,1
6441,110732,MS6IJrovPGBEFYNmUPmeOu0OFDeQqmIx,3VkHkmOtom3jM2wCu94xgzzu1d6Dn7or,1,0,0,0,0,0,1,0,1,0.14285714285714285,1,0.0,0,0,0,0,0,0,0,1,0,0,1,1
6442,110764,HpI5z92WE9TCj3JyfZi0b0yrE9hT84vs,3VkHkmOtom3jM2wCu94xgzzu1d6Dn7or,1,0,0,0,0,0,1,0,1,0.14285714285714285,1,0.0,0,0,0,0,0,0,0,1,0,0,1,1
6443,110785,p311UtUGdUwKmrYHr6K0TG3N9HNIvLDN,3VkHkmOtom3jM2wCu94xgzzu1d6Dn7or,8,7,3,0,2,1,8,0,21,3.0,1,0.0,2,3,0,2,5,1,0,8,0,7,14,1
6444,110829,K0vM4v4lprgkLZgn2YxyCFRJlTM0pFAf,3VkHkmOtom3jM2wCu94xgzzu1d6Dn7or,36,179,46,75,56,42,36,1,435,62.142857142857146,4,0.0,94,46,67,56,85,42,8,36,1,263,172,1
6445,110833,oNX40hvUpCseO8BHKhGJvG2jyQpYKQyk,3VkHkmOtom3jM2wCu94xgzzu1d6Dn7or,1,0,0,0,0,0,1,0,1,0.14285714285714285,1,0.0,0,0,0,0,0,0,0,1,0,0,1,1
6446,110850,6Zw4h1RRXwE1llYOOpSM6nCIHCFPDAX1,3VkHkmOtom3jM2wCu94xgzzu1d6Dn7or,7,5,1,0,1,0,3,0,10,1.4285714285714286,2,0.0,0,1,0,1,5,0,0,3,0,2,8,1
6447,110857,ooEcaiUSlo9CwytpW2T4Oa02YM5UfDcJ,3VkHkmOtom3jM2wCu94xgzzu1d6Dn7or,5,5,3,0,3,0,4,0,15,2.142857142857143,1,0.0,1,3,0,3,4,0,0,4,0,7,8,1
6448,110867,0MqgKoCiBbkOQlILQCSEvVTi8AlhfpfE,3VkHkmOtom3jM2wCu94xgzzu1d6Dn7or,7,3,2,0,1,0,6,0,12,1.7142857142857142,1,0.0,0,2,0,1,3,0,0,6,0,3,9,1
6449,110908,CSldcDH2UXCgzrli1TZwzU7O1XRP6tGR,3VkHkmOtom3jM2wCu94xgzzu1d6Dn7or,4,2,1,0,0,1,2,0,6,0.8571428571428571,1,0.0,0,1,0,0,2,1,0,2,0,1,5,1
6450,110934,gIW1VFFezcONvq2yyTBvVdlT7wXT7HJ0,3VkHkmOtom3jM2wCu94xgzzu1d6Dn7or,1,0,0,0,0,0,1,0,1,0.14285714285714285,1,0.0,0,0,0,0,0,0,0,1,0,0,1,1
6451,110936,6X1wr7GynBQqED8UEDADYfUmXyvxRJTQ,3VkHkmOtom3jM2wCu94xgzzu1d6Dn7or,1,0,0,0,0,0,1,0,1,0.14285714285714285,1,0.0,0,0,0,0,0,0,0,1,0,0,1,1
6452,110997,qZpXWzENd8vPQkANcwupj0acfmacGtsr,3VkHkmOtom3jM2wCu94xgzzu1d6Dn7or,51,26,24,0,25,0,5,0,80,11.428571428571429,1,0.0,0,24,0,25,26,0,0,5,0,49,31,1
6453,111015,arQfCxGonf2cwpjIHxEHKla7HzsDvv25,3VkHkmOtom3jM2wCu94xgzzu1d6Dn7or,1,0,0,0,0,0,1,0,1,0.14285714285714285,1,0.0,0,0,0,0,0,0,0,1,0,0,1,1
6454,111027,rKSBST0Te8Oj86YG9ATJ5n1WsqaVPnYt,3VkHkmOtom3jM2wCu94xgzzu1d6Dn7or,5,2,1,0,1,1,3,0,8,1.1428571428571428,1,0.0,0,1,0,1,2,1,0,3,0,2,6,1
6455,111047,Hsv3SikfSXfiHrnpDP7hs57vBAqVCyW3,3VkHkmOtom3jM2wCu94xgzzu1d6Dn7or,4,2,0,0,0,0,2,0,4,0.5714285714285714,2,0.0,0,0,0,0,2,0,0,2,0,0,4,1
6456,111188,lcOmZtA6Krg5rjWp07W9qAhHzmFjlBmq,3VkHkmOtom3jM2wCu94xgzzu1d6Dn7or,12,14,9,0,4,1,16,0,44,6.285714285714286,2,0.0,0,9,0,4,14,1,0,16,0,13,31,1
6457,111193,ukRefRmBYESKCfUvaHv3IYNgmPPZ33YH,3VkHkmOtom3jM2wCu94xgzzu1d6Dn7or,1,0,0,0,0,0,1,0,1,0.14285714285714285,1,0.0,0,0,0,0,0,0,0,1,0,0,1,1
6458,111332,9nWy1GKxqfTrAeUVolqqnda385xr9lRU,3VkHkmOtom3jM2wCu94xgzzu1d6Dn7or,2,0,0,0,0,0,2,0,2,0.2857142857142857,1,0.0,0,0,0,0,0,0,0,2,0,0,2,1
6459,111334,tsquOdRQXp66gnS29xQRjOmY9wUH5RXe,3VkHkmOtom3jM2wCu94xgzzu1d6Dn7or,1,0,0,0,0,0,1,0,1,0.14285714285714285,1,0.0,0,0,0,0,0,0,0,1,0,0,1,1
6460,111352,lmlSe7ne5kLVEzM7wObkzo8bsMDoN8xr,3VkHkmOtom3jM2wCu94xgzzu1d6Dn7or,1,0,0,0,0,0,1,0,1,0.14285714285714285,1,0.0,0,0,0,0,0,0,0,1,0,0,1,1
6461,111370,PVH5tEGH8GZxJxi2Ll8MBjEy0thVXtCn,3VkHkmOtom3jM2wCu94xgzzu1d6Dn7or,15,20,15,0,6,2,10,0,53,7.571428571428571,1,0.0,0,15,0,6,20,2,0,10,0,21,32,0
6462,111441,ZjjzblWLBhpCB41WVkrtllAfmPXPK6bc,3VkHkmOtom3jM2wCu94xgzzu1d6Dn7or,8,4,1,0,1,0,6,1,13,1.8571428571428572,1,0.0,0,1,0,1,4,0,0,6,1,2,11,1
6463,111473,P3zH2bHQy54kaknfZyFeRJ0FfiXyf86q,3VkHkmOtom3jM2wCu94xgzzu1d6Dn7or,13,12,6,0,5,3,10,1,37,5.285714285714286,1,0.0,3,6,0,5,9,3,0,10,1,14,23,0
6464,111477,AMDM6al5x8sRWdZz2ktXTH398SznbQSe,3VkHkmOtom3jM2wCu94xgzzu1d6Dn7or,1,0,0,0,0,0,1,0,1,0.14285714285714285,1,0.0,0,0,0,0,0,0,0,1,0,0,1,1
6465,111508,pzsUx69X9Xid85hyecE8y9Ou9VDtnPhb,3VkHkmOtom3jM2wCu94xgzzu1d6Dn7or,13,19,7,10,7,1,4,0,48,6.857142857142857,2,0.0,9,7,9,7,10,1,1,4,0,32,16,1
6466,111524,Gdw0OfNNRxeUit8z8trs290TkDB3iLCu,3VkHkmOtom3jM2wCu94xgzzu1d6Dn7or,8,8,5,0,4,1,3,0,21,3.0,1,0.0,0,5,0,4,8,1,0,3,0,9,12,1
6467,111529,VtcqBivUlTKNl0Bc1erobU130cXDS6KE,3VkHkmOtom3jM2wCu94xgzzu1d6Dn7or,62,53,23,27,22,0,8,0,133,19.0,4,0.0,25,23,25,22,28,0,2,8,0,95,38,0
6468,111548,FNVCEUxOa8KJRVtqpHppqwsluCHqZPV0,3VkHkmOtom3jM2wCu94xgzzu1d6Dn7or,1,0,0,0,0,0,1,0,1,0.14285714285714285,1,0.0,0,0,0,0,0,0,0,1,0,0,1,1
6469,111576,Tmbn0NKUx4beAPJhrbC4V92oxhibMjq9,3VkHkmOtom3jM2wCu94xgzzu1d6Dn7or,30,30,17,0,17,0,3,0,67,9.571428571428571,1,0.0,0,17,0,17,30,0,0,3,0,34,33,1
6470,111577,iG5GnBGrbIvw6KizKdyVzTyvZUHTNvH5,3VkHkmOtom3jM2wCu94xgzzu1d6Dn7or,1,0,0,0,0,0,2,0,2,0.2857142857142857,1,0.0,0,0,0,0,0,0,0,2,0,0,2,1
6471,111639,f1qaQjpMgGLuPTyErL1I124VmrWItMHF,3VkHkmOtom3jM2wCu94xgzzu1d6Dn7or,1,0,0,0,0,0,2,0,2,0.2857142857142857,1,0.0,0,0,0,0,0,0,0,2,0,0,2,1
6472,111644,vbghp1PVpZxFaWqasEyQzIEfPKBk8vPh,3VkHkmOtom3jM2wCu94xgzzu1d6Dn7or,1,0,0,0,0,0,1,0,1,0.14285714285714285,1,0.0,0,0,0,0,0,0,0,1,0,0,1,1
6473,111659,Ht8gQquuDWuHnE8TA1lycaHJ8C9MVf20,3VkHkmOtom3jM2wCu94xgzzu1d6Dn7or,61,50,8,0,34,0,9,0,101,14.428571428571429,6,0.0,0,8,0,34,50,0,0,9,0,42,59,0
6474,111707,oDTCQYWkQkQEaFVTuvoUpDp7L9vcbsiB,3VkHkmOtom3jM2wCu94xgzzu1d6Dn7or,7,3,1,0,1,0,8,0,13,1.8571428571428572,1,0.0,0,1,0,1,3,0,0,8,0,2,11,1
6475,111722,hbvRiHicgfl7XhYSimAX7Vhr1jxdVZyC,3VkHkmOtom3jM2wCu94xgzzu1d6Dn7or,14,11,6,0,6,0,1,0,24,3.4285714285714284,1,0.0,0,6,0,6,11,0,0,1,0,12,12,1
6476,111765,NHohBV09H242QDbXlpW5SeArVCRf3EZG,3VkHkmOtom3jM2wCu94xgzzu1d6Dn7or,26,51,14,0,12,0,8,0,85,12.142857142857142,3,0.0,2,14,0,12,49,0,0,8,0,28,57,0
6477,111793,PIK4BwYW6UF5VNk6QwHlj6uqSbAz1VdV,3VkHkmOtom3jM2wCu94xgzzu1d6Dn7or,1,0,0,0,0,0,1,0,1,0.14285714285714285,1,0.0,0,0,0,0,0,0,0,1,0,0,1,1
6478,111812,nBF4tD1vFpwiYJCOxnzt1rMBPoer677d,3VkHkmOtom3jM2wCu94xgzzu1d6Dn7or,18,52,19,9,13,15,12,1,121,17.285714285714285,3,0.0,22,19,7,13,30,15,2,12,1,61,60,0
6479,111818,KWd0W5LFo2aRCM9EB6q9ghMk4KZOMRgX,3VkHkmOtom3jM2wCu94xgzzu1d6Dn7or,8,4,3,0,3,0,5,0,15,2.142857142857143,1,0.0,0,3,0,3,4,0,0,5,0,6,9,1
6480,111837,Pt0ZUDMBwJ6kjWhW14J5JBu0QRWNcMSZ,3VkHkmOtom3jM2wCu94xgzzu1d6Dn7or,8,4,2,0,1,0,5,1,13,1.8571428571428572,1,0.0,0,2,0,1,4,0,0,5,1,3,10,1
6481,111867,G4ndF3jMuKTqtu9uYeLIFsl19xQFpToo,3VkHkmOtom3jM2wCu94xgzzu1d6Dn7or,3,2,0,0,0,0,1,0,3,0.42857142857142855,1,0.0,0,0,0,0,2,0,0,1,0,0,3,1
6482,111879,5fdjSFb0UnHfjLD83iptHyG30XcBntML,3VkHkmOtom3jM2wCu94xgzzu1d6Dn7or,3,2,0,0,0,0,1,0,3,0.42857142857142855,1,0.0,0,0,0,0,2,0,0,1,0,0,3,1
6483,111892,AytMS9By5Hlw48ZNqrCtItQbZYKHh7Q3,3VkHkmOtom3jM2wCu94xgzzu1d6Dn7or,9,18,4,14,3,9,2,0,50,7.142857142857143,1,0.0,7,4,9,3,11,9,5,2,0,23,27,1
6484,111927,3DZEluPiRSphAy398RdO2XX8VKDVzVoK,3VkHkmOtom3jM2wCu94xgzzu1d6Dn7or,16,27,12,15,9,1,5,0,69,9.857142857142858,1,0.0,11,12,12,9,16,1,3,5,0,44,25,1
6485,111928,dMFGb7ZI9NHuXSGQM86qRDKrtK5SOgjQ,3VkHkmOtom3jM2wCu94xgzzu1d6Dn7or,7,3,2,0,2,0,2,0,9,1.2857142857142858,1,0.0,0,2,0,2,3,0,0,2,0,4,5,1
6486,111929,JxVarlBq08OASjpQGibNnUaguOzX31wq,3VkHkmOtom3jM2wCu94xgzzu1d6Dn7or,4,2,1,0,1,0,1,0,5,0.7142857142857143,1,0.0,0,1,0,1,2,0,0,1,0,2,3,1
6487,111933,xozOUk6HJgNqz7jqPBKRd7zYRuT58TEi,3VkHkmOtom3jM2wCu94xgzzu1d6Dn7or,1,0,0,0,0,0,1,0,1,0.14285714285714285,1,0.0,0,0,0,0,0,0,0,1,0,0,1,1
6488,111937,0lZ2gAG5jH1INiMk61cLPbE0aHpRZ1Fo,3VkHkmOtom3jM2wCu94xgzzu1d6Dn7or,1,0,0,0,0,0,1,0,1,0.14285714285714285,1,0.0,0,0,0,0,0,0,0,1,0,0,1,1
6489,111939,ua8xHMwdNZcrAfQNfsd9dNhJSKhizi8U,3VkHkmOtom3jM2wCu94xgzzu1d6Dn7or,4,2,1,0,1,0,1,0,5,0.7142857142857143,1,0.0,0,1,0,1,2,0,0,1,0,2,3,1
6490,111946,9rYfHblkB5nFHGrtpqn8aCCcNIIBs5zT,3VkHkmOtom3jM2wCu94xgzzu1d6Dn7or,11,13,5,0,4,0,2,0,24,3.4285714285714284,1,0.0,1,5,0,4,12,0,0,2,0,10,14,1
6491,111951,7yp7RqyFahdP1GQdWRDVFt7ZLf5G1yWT,3VkHkmOtom3jM2wCu94xgzzu1d6Dn7or,30,52,12,22,24,14,11,1,136,19.428571428571427,2,0.0,39,12,19,24,13,14,3,11,1,94,42,1
6492,111954,yeRsbimDLI4VzVSMeS7rxXsi0BElLbFq,3VkHkmOtom3jM2wCu94xgzzu1d6Dn7or,4,2,1,0,1,0,2,0,6,0.8571428571428571,1,0.0,0,1,0,1,2,0,0,2,0,2,4,1
6493,111963,WW7Yo6PmQhLyd4oqDECwVthtmVns6DPF,3VkHkmOtom3jM2wCu94xgzzu1d6Dn7or,7,14,4,6,1,7,3,0,35,5.0,2,0.0,3,4,5,1,11,7,1,3,0,13,22,1
6494,111964,CrhLQSGEGPJ3AH0hpRJz06hJlud4teh7,3VkHkmOtom3jM2wCu94xgzzu1d6Dn7or,6,2,1,0,1,0,4,0,8,1.1428571428571428,1,0.0,0,1,0,1,2,0,0,4,0,2,6,1
6495,111966,ZUdl8Ggg39iRoGdmF0am1pmKRmXqomrv,3VkHkmOtom3jM2wCu94xgzzu1d6Dn7or,1,0,0,0,0,0,1,0,1,0.14285714285714285,1,0.0,0,0,0,0,0,0,0,1,0,0,1,1
6496,111967,YxMNk2apswQEh8zV5Q50IFWgCD8oo8Ws,3VkHkmOtom3jM2wCu94xgzzu1d6Dn7or,1,0,0,0,0,0,3,0,3,0.42857142857142855,1,0.0,0,0,0,0,0,0,0,3,0,0,3,1
6497,111976,toG3QkJk19CDmq2nM3SKNSGmeAefbNIn,3VkHkmOtom3jM2wCu94xgzzu1d6Dn7or,11,15,0,2,3,6,7,0,33,4.714285714285714,1,0.0,4,0,2,3,11,6,0,7,0,9,24,1
6498,111986,AGD3MBIeqZTxYwDuHS59UCXpZacrTopY,3VkHkmOtom3jM2wCu94xgzzu1d6Dn7or,5,0,0,0,0,0,4,1,5,0.7142857142857143,1,0.0,0,0,0,0,0,0,0,4,1,0,5,1
6499,111988,KaeCX7DoW5htn0YhXrWslGGGeoVPFyiJ,3VkHkmOtom3jM2wCu94xgzzu1d6Dn7or,6,5,2,0,2,0,3,0,12,1.7142857142857142,2,0.0,0,2,0,2,5,0,0,3,0,4,8,1
6500,111990,eT9OhUahWhAeZfHPEbxGN9qGHwvkkQvs,3VkHkmOtom3jM2wCu94xgzzu1d6Dn7or,4,2,1,0,1,0,1,0,5,0.7142857142857143,1,0.0,0,1,0,1,2,0,0,1,0,2,3,1
6501,111994,j2gKYYMcLFwIWIzeiTmjigweYNzNBGo4,3VkHkmOtom3jM2wCu94xgzzu1d6Dn7or,2,0,0,0,0,0,5,0,5,0.7142857142857143,1,0.0,0,0,0,0,0,0,0,5,0,0,5,1
6502,111995,53xb4b3qyj6I63ytkM2e583BKuXLUiaA,3VkHkmOtom3jM2wCu94xgzzu1d6Dn7or,1,0,0,0,0,0,1,0,1,0.14285714285714285,1,0.0,0,0,0,0,0,0,0,1,0,0,1,1
6503,111997,iclIP1jghYCfioY2FqtU5Lc3nRAFn1xN,3VkHkmOtom3jM2wCu94xgzzu1d6Dn7or,4,2,1,0,1,0,1,0,5,0.7142857142857143,1,0.0,0,1,0,1,2,0,0,1,0,2,3,0
6504,112005,YHhKpuvJC4d5Yv14WaZLbr14JVCcikf2,3VkHkmOtom3jM2wCu94xgzzu1d6Dn7or,7,5,2,4,2,1,2,0,16,2.2857142857142856,1,0.0,1,2,3,2,4,1,1,2,0,8,8,1
6505,112007,cYVBkFSdPo0naqk19Kx0uZGlRjFryKuo,3VkHkmOtom3jM2wCu94xgzzu1d6Dn7or,5,4,0,0,2,0,4,0,10,1.4285714285714286,1,0.0,2,0,0,2,2,0,0,4,0,4,6,1
6506,112008,6svB5U4T8Gl5UopI2QlDMRmBtqh4MN4V,3VkHkmOtom3jM2wCu94xgzzu1d6Dn7or,6,4,3,0,3,0,1,0,11,1.5714285714285714,1,0.0,0,3,0,3,4,0,0,1,0,6,5,0
6507,112010,ebYl7COD4e2InprKALscMyYn5VZ3FcRm,3VkHkmOtom3jM2wCu94xgzzu1d6Dn7or,36,107,33,27,46,7,12,1,233,33.285714285714285,4,0.0,66,33,24,46,41,7,3,12,1,169,64,1
6508,112011,3lQBLQevxeH5CcBmmJpYwr3AUKCtRzXF,3VkHkmOtom3jM2wCu94xgzzu1d6Dn7or,10,21,7,6,7,18,2,0,61,8.714285714285714,1,0.0,12,7,5,7,9,18,1,2,0,31,30,1
6509,112014,THL58Oahb12YvJ1YW5saCamuHKc2RTXs,3VkHkmOtom3jM2wCu94xgzzu1d6Dn7or,42,35,26,0,21,0,13,0,95,13.571428571428571,4,0.0,0,26,0,21,35,0,0,13,0,47,48,0
6510,112017,WFycJnPuPLuYOqK1bD1fFD6G4Z2IEQit,3VkHkmOtom3jM2wCu94xgzzu1d6Dn7or,1,0,0,0,0,0,2,0,2,0.2857142857142857,1,0.0,0,0,0,0,0,0,0,2,0,0,2,1
6511,112021,fYVuPS71xJEDv4hsEkks3lym9MZ4TDJV,3VkHkmOtom3jM2wCu94xgzzu1d6Dn7or,6,2,1,0,1,0,6,0,10,1.4285714285714286,1,0.0,0,1,0,1,2,0,0,6,0,2,8,1
6512,112029,8QeNBSoAmfuMMwnfjCjhlHJfHWJb6Z8j,3VkHkmOtom3jM2wCu94xgzzu1d6Dn7or,5,6,3,0,1,0,3,0,13,1.8571428571428572,2,0.0,0,3,0,1,6,0,0,3,0,4,9,1
6513,112032,VeDeV6aD6kowERv1ygPjE9YEMgMJMOAv,3VkHkmOtom3jM2wCu94xgzzu1d6Dn7or,16,36,15,13,10,14,6,0,94,13.428571428571429,2,0.0,11,15,13,10,25,14,0,6,0,49,45,1
6514,112033,yJ5AdpV4Umz0vyCUvOg8esOsmohWDdKi,3VkHkmOtom3jM2wCu94xgzzu1d6Dn7or,5,2,1,0,1,0,2,0,6,0.8571428571428571,1,0.0,0,1,0,1,2,0,0,2,0,2,4,1
6515,112036,BjBet1XrpmufRo3nJSBrADvKxDiooNdd,3VkHkmOtom3jM2wCu94xgzzu1d6Dn7or,1,0,0,0,0,0,1,0,1,0.14285714285714285,1,0.0,0,0,0,0,0,0,0,1,0,0,1,1
6516,112042,78K2WkpPCTZZDuQORBAFkp5eT2Zptciw,3VkHkmOtom3jM2wCu94xgzzu1d6Dn7or,87,308,72,126,60,19,36,0,621,88.71428571428571,10,0.0,123,72,114,60,185,19,12,36,0,369,252,0
6517,112044,oQl0xDZ6pRPXU9L7MUpc2rUtjHufKB7J,3VkHkmOtom3jM2wCu94xgzzu1d6Dn7or,28,85,38,30,14,1,18,0,186,26.571428571428573,7,0.0,28,38,28,14,57,1,2,18,0,108,78,0
6518,112049,ZEQvmWn0Ak2NSUvhNu3WsBnTCcx2wUur,3VkHkmOtom3jM2wCu94xgzzu1d6Dn7or,1,0,0,0,0,0,2,0,2,0.2857142857142857,1,0.0,0,0,0,0,0,0,0,2,0,0,2,1
6519,112050,Ra7sE4wAxUIWpR0t2405LuHyqEioCMqs,3VkHkmOtom3jM2wCu94xgzzu1d6Dn7or,20,32,13,0,11,0,3,0,59,8.428571428571429,1,0.0,0,13,0,11,32,0,0,3,0,24,35,1
6520,112053,6Jl8kTqfFa1rQv3ymDEsunHDEuyu4uCl,3VkHkmOtom3jM2wCu94xgzzu1d6Dn7or,7,7,2,0,1,5,6,0,21,3.0,1,0.0,0,2,0,1,7,5,0,6,0,3,18,1
6521,112054,ibL5MIncSfKj8NGMz1VIWu1lFdMj3iWi,3VkHkmOtom3jM2wCu94xgzzu1d6Dn7or,3,5,0,0,0,0,1,0,6,0.8571428571428571,2,0.0,0,0,0,0,5,0,0,1,0,0,6,0
6522,112076,nF7aAeT70FglKCK63KUkEVk8gbyNehUj,3VkHkmOtom3jM2wCu94xgzzu1d6Dn7or,8,12,4,0,2,1,8,1,28,4.0,4,0.0,1,4,0,2,11,1,0,8,1,7,21,0
6523,112087,YRDulTOgIWgR8cFwTAVhhuxX46WtWav7,3VkHkmOtom3jM2wCu94xgzzu1d6Dn7or,6,5,2,0,2,0,1,0,10,1.4285714285714286,1,0.0,2,2,0,2,3,0,0,1,0,6,4,1
6524,112108,FFDFPK1HNjN0Aa04wodQmENMubJsJXNU,3VkHkmOtom3jM2wCu94xgzzu1d6Dn7or,3,3,1,0,0,0,1,0,5,0.7142857142857143,1,0.0,0,1,0,0,3,0,0,1,0,1,4,1
6525,112116,lXrOH5wPLm23d6wu5X4QSekUdTmIuRYJ,3VkHkmOtom3jM2wCu94xgzzu1d6Dn7or,6,7,2,0,1,0,6,0,16,2.2857142857142856,1,0.0,0,2,0,1,7,0,0,6,0,3,13,1
6526,112159,sMMo4gFgq3RgS4WA6aTyILkePEOc6VJR,3VkHkmOtom3jM2wCu94xgzzu1d6Dn7or,4,3,0,0,0,0,3,0,6,0.8571428571428571,1,0.0,0,0,0,0,3,0,0,3,0,0,6,1
6527,112192,q660sHWwNVPLYlyOFPnKqxZsq0N7tubl,3VkHkmOtom3jM2wCu94xgzzu1d6Dn7or,1,0,0,0,0,0,1,0,1,0.14285714285714285,1,0.0,0,0,0,0,0,0,0,1,0,0,1,1
6528,112196,ZiZkXgxxFkMOEdett3TrVovXNjeMkDCt,3VkHkmOtom3jM2wCu94xgzzu1d6Dn7or,15,17,8,0,7,0,2,0,34,4.857142857142857,1,0.0,0,8,0,7,17,0,0,2,0,15,19,1
6529,112218,QqGEhb9aelEacMmGunNJm1ELEvGaQ2a8,3VkHkmOtom3jM2wCu94xgzzu1d6Dn7or,1,0,0,0,0,0,1,0,1,0.14285714285714285,1,0.0,0,0,0,0,0,0,0,1,0,0,1,1
6530,112224,mpbWhz8yp974O11UFImAPnzjPzgRhhJu,3VkHkmOtom3jM2wCu94xgzzu1d6Dn7or,76,161,39,48,72,14,12,0,346,49.42857142857143,5,0.0,109,39,45,72,52,14,3,12,0,265,81,0
6531,112248,x98CGtCWw95UaH5rhAe7ZjNA6PYDcGv8,3VkHkmOtom3jM2wCu94xgzzu1d6Dn7or,22,100,14,25,8,3,41,0,191,27.285714285714285,4,0.0,22,14,21,8,78,3,4,41,0,65,126,0
6532,112267,oedBUl8bzFPMVSQimVz39gymPfLeWWiZ,3VkHkmOtom3jM2wCu94xgzzu1d6Dn7or,2,0,0,0,0,0,10,0,10,1.4285714285714286,1,0.0,0,0,0,0,0,0,0,10,0,0,10,1
6533,112275,Vgu46RFOhCWtRKgVvFukXU42fM2ek6kD,3VkHkmOtom3jM2wCu94xgzzu1d6Dn7or,5,6,0,0,0,0,2,2,10,1.4285714285714286,1,0.0,2,0,0,0,4,0,0,2,2,2,8,1
6534,112320,02eB8ecCHjqNKo6qHUUGR29f8TPEGh0h,3VkHkmOtom3jM2wCu94xgzzu1d6Dn7or,7,4,2,0,2,0,4,0,12,1.7142857142857142,1,0.0,0,2,0,2,4,0,0,4,0,4,8,1
6535,112322,nxJZuhJjaQY3pxIrLt24GAiKN1UhZHBs,3VkHkmOtom3jM2wCu94xgzzu1d6Dn7or,1,0,0,0,0,0,1,0,1,0.14285714285714285,1,0.0,0,0,0,0,0,0,0,1,0,0,1,1
6536,112336,cq1EcgJkOzsgPApyam8jrBgIihT5dYdk,3VkHkmOtom3jM2wCu94xgzzu1d6Dn7or,1,0,0,0,0,0,1,0,1,0.14285714285714285,1,0.0,0,0,0,0,0,0,0,1,0,0,1,1
6537,112367,6TF5ejz0He9snpKNUlejoFGbQsAtIHw4,5Gyp41oLVo7Gg7vF4vpmggWP5MU70QO6,70,228,95,90,30,123,51,2,619,88.42857142857143,13,0.0,71,95,65,30,157,123,25,51,2,261,358,0
6538,112379,QAV02IL7ajntDdHVirqabwTRIN1Sa6iz,5Gyp41oLVo7Gg7vF4vpmggWP5MU70QO6,57,212,111,34,65,19,51,4,496,70.85714285714286,16,0.0,56,111,26,65,156,19,8,51,4,258,238,0
6539,112408,ANFesR75Jgbaf4kJ69uePCSrh3drP5Gg,5Gyp41oLVo7Gg7vF4vpmggWP5MU70QO6,45,203,28,49,38,105,36,2,461,65.85714285714286,23,0.0,34,28,40,38,169,105,9,36,2,140,321,0
6540,112434,dQeQGMqD2AfjLt9WMqT1wjR4i8srmTVY,5Gyp41oLVo7Gg7vF4vpmggWP5MU70QO6,12,10,5,2,2,0,4,0,23,3.2857142857142856,4,0.0,1,5,1,2,9,0,1,4,0,9,14,1
6541,112437,VlFSAklSaE6MkLq9APNocybzNA8P3gGI,5Gyp41oLVo7Gg7vF4vpmggWP5MU70QO6,29,59,32,19,16,9,15,1,151,21.571428571428573,7,0.0,17,32,12,16,42,9,7,15,1,77,74,1
6542,112445,7RSTSE7CX0EZRW2RDRnKS7CJkHtK7gJx,5Gyp41oLVo7Gg7vF4vpmggWP5MU70QO6,4,2,1,0,0,4,6,0,13,1.8571428571428572,1,0.0,0,1,0,0,2,4,0,6,0,1,12,1
6543,112451,1dkYrsVP9CkJjuyC6VhiBEkMgSrgRGy1,5Gyp41oLVo7Gg7vF4vpmggWP5MU70QO6,15,15,0,12,0,0,6,1,34,4.857142857142857,2,0.0,5,0,6,0,10,0,6,6,1,11,23,1
6544,112463,FeSQQc9CIFMTYLlHcSRbUJqf0NNwxJ2K,5Gyp41oLVo7Gg7vF4vpmggWP5MU70QO6,15,26,14,13,6,0,8,0,67,9.571428571428571,4,0.0,5,14,8,6,21,0,5,8,0,33,34,1
6545,112471,5zyFk8FiLdmnu9WbWgpyC2fkL0q8txqg,5Gyp41oLVo7Gg7vF4vpmggWP5MU70QO6,5,2,1,0,1,0,2,0,6,0.8571428571428571,1,0.0,0,1,0,1,2,0,0,2,0,2,4,1
6546,112489,U2zYL2pX3EUp3326VbwsJLAkNlVZZnCj,5Gyp41oLVo7Gg7vF4vpmggWP5MU70QO6,10,18,9,2,4,0,7,0,40,5.714285714285714,5,0.0,3,9,1,4,15,0,1,7,0,17,23,1
6547,112492,gnjkvYNHASmxrSHftIplHX6Lama9SuHW,5Gyp41oLVo7Gg7vF4vpmggWP5MU70QO6,7,3,2,0,2,0,2,0,9,1.2857142857142858,1,0.0,0,2,0,2,3,0,0,2,0,4,5,1
6548,112495,aufeKSBI3whyrfmkKYIEHMeiZ61NUgYf,5Gyp41oLVo7Gg7vF4vpmggWP5MU70QO6,5,2,1,0,1,0,2,0,6,0.8571428571428571,1,0.0,0,1,0,1,2,0,0,2,0,2,4,1
6549,112498,nQ8zyPaxuBVV0E4EnN5ZsvrgPzjbJntO,5Gyp41oLVo7Gg7vF4vpmggWP5MU70QO6,8,10,6,0,1,0,6,0,23,3.2857142857142856,3,0.0,0,6,0,1,10,0,0,6,0,7,16,1
6550,112515,ILkUjE8LhIAQFlZwnOqsyA4K0QvAbnzA,5Gyp41oLVo7Gg7vF4vpmggWP5MU70QO6,1,0,0,0,0,0,2,0,2,0.2857142857142857,1,0.0,0,0,0,0,0,0,0,2,0,0,2,1
6551,112523,ySy2zYThCkVZr5MjEXuKxq60wfOynxkJ,5Gyp41oLVo7Gg7vF4vpmggWP5MU70QO6,7,5,2,0,1,0,4,0,12,1.7142857142857142,2,0.0,0,2,0,1,5,0,0,4,0,3,9,1
6552,112529,cpPSwRiyzrnBZYcFR4yyg60XVFgQxQi4,5Gyp41oLVo7Gg7vF4vpmggWP5MU70QO6,16,24,17,6,10,3,44,5,109,15.571428571428571,7,0.0,4,17,4,10,20,3,2,44,5,35,74,0
6553,112530,DNAhoSAo2TyzbNbN3nxE9yloBifToEMC,5Gyp41oLVo7Gg7vF4vpmggWP5MU70QO6,1,0,0,0,0,0,1,0,1,0.14285714285714285,1,0.0,0,0,0,0,0,0,0,1,0,0,1,1
6554,112535,KeSzpEWoV0R6xsKMnqGxXoDqNgrDy1ti,5Gyp41oLVo7Gg7vF4vpmggWP5MU70QO6,13,6,5,0,5,0,2,0,18,2.5714285714285716,1,0.0,0,5,0,5,6,0,0,2,0,10,8,1
6555,112544,Qfd5NSQMshaz9tIWhiDXjUxqfga3DDZq,5Gyp41oLVo7Gg7vF4vpmggWP5MU70QO6,30,25,19,0,16,9,11,3,83,11.857142857142858,2,0.0,1,19,0,16,24,9,0,11,3,36,47,1
6556,112561,OT3O39HutXQkPsTvi6rLAq8sPcWlmwof,5Gyp41oLVo7Gg7vF4vpmggWP5MU70QO6,24,88,40,30,9,19,29,2,217,31.0,6,0.0,18,40,20,9,70,19,10,29,2,87,130,0
6557,112573,5f2Vv7UWlj5M1yvVbbBBHVwiDGe0CInr,5Gyp41oLVo7Gg7vF4vpmggWP5MU70QO6,7,6,3,0,3,0,2,0,14,2.0,1,0.0,2,3,0,3,4,0,0,2,0,8,6,1
6558,112587,8fvsCrC8dcOje6DxrGntnTxmufYXJCrq,5Gyp41oLVo7Gg7vF4vpmggWP5MU70QO6,9,14,6,0,3,0,3,0,26,3.7142857142857144,3,0.0,4,6,0,3,10,0,0,3,0,13,13,1
6559,112589,V6eHxf4YFnuStkxXYpZgYV3Sed4O7kw9,5Gyp41oLVo7Gg7vF4vpmggWP5MU70QO6,8,4,2,0,3,1,3,1,14,2.0,1,0.0,1,2,0,3,3,1,0,3,1,6,8,1
6560,112591,CYN3tl2d8PV3r7FRKTn3DmaQTLhkh777,5Gyp41oLVo7Gg7vF4vpmggWP5MU70QO6,16,23,6,12,2,1,6,1,51,7.285714285714286,1,0.0,14,6,6,2,9,1,6,6,1,28,23,0
6561,112595,puCo5YmED6Uq1uR83Fna1joj9SdvQPHR,5Gyp41oLVo7Gg7vF4vpmggWP5MU70QO6,1,0,0,0,0,0,1,0,1,0.14285714285714285,1,0.0,0,0,0,0,0,0,0,1,0,0,1,1
6562,112614,GKKNtfrAHKD2xUEQBz7HLN3kKO9SrWyD,5Gyp41oLVo7Gg7vF4vpmggWP5MU70QO6,1,0,0,0,0,0,1,0,1,0.14285714285714285,1,0.0,0,0,0,0,0,0,0,1,0,0,1,1
6563,112656,51qeivibqjzU02LiU7FPFZmJUBump2P8,5Gyp41oLVo7Gg7vF4vpmggWP5MU70QO6,5,0,0,0,0,1,8,0,9,1.2857142857142858,2,0.0,0,0,0,0,0,1,0,8,0,0,9,1
6564,112662,oQ1m6ynaSjvrLZKayCazlfEosUJu3ieW,5Gyp41oLVo7Gg7vF4vpmggWP5MU70QO6,9,5,3,0,4,13,2,0,27,3.857142857142857,1,0.0,1,3,0,4,4,13,0,2,0,8,19,1
6565,112674,44ijxMUagaLod1iza5FrW1Uqece2jUOc,5Gyp41oLVo7Gg7vF4vpmggWP5MU70QO6,1,0,0,0,0,0,1,0,1,0.14285714285714285,1,0.0,0,0,0,0,0,0,0,1,0,0,1,1
6566,112677,sW1u9EOUYrJApfkaDSoDkISZzFP3ogv6,5Gyp41oLVo7Gg7vF4vpmggWP5MU70QO6,6,3,2,0,2,0,1,0,8,1.1428571428571428,1,0.0,0,2,0,2,3,0,0,1,0,4,4,1
6567,112697,ZmXZsEo2rrliBxnq0XarGwTqKrylhBGN,5Gyp41oLVo7Gg7vF4vpmggWP5MU70QO6,1,0,0,0,0,0,1,0,1,0.14285714285714285,1,0.0,0,0,0,0,0,0,0,1,0,0,1,1
6568,112699,jsoc8YzRzl1dA8hk6IZJ9PMa2b08oMn7,5Gyp41oLVo7Gg7vF4vpmggWP5MU70QO6,13,49,27,4,2,35,22,3,142,20.285714285714285,6,0.0,7,27,4,2,42,35,0,22,3,40,102,0
6569,112703,l01aGQuAgd5VHAVuk21pZMIeJcDQOX6i,5Gyp41oLVo7Gg7vF4vpmggWP5MU70QO6,7,8,3,0,3,0,2,0,16,2.2857142857142856,1,0.0,2,3,0,3,6,0,0,2,0,8,8,1
6570,112706,kd8Q2Ddqd6Nc7nK4UZ0sM8K8LUOgjEo9,5Gyp41oLVo7Gg7vF4vpmggWP5MU70QO6,1,0,0,0,0,0,1,0,1,0.14285714285714285,1,0.0,0,0,0,0,0,0,0,1,0,0,1,1
6571,112711,YY7yHizDn0UpGHVq4qoTfbulP3ev5TkC,5Gyp41oLVo7Gg7vF4vpmggWP5MU70QO6,1,0,0,0,0,0,2,0,2,0.2857142857142857,1,0.0,0,0,0,0,0,0,0,2,0,0,2,1
6572,112729,6w31L0njODaizeDT0XXbujjg7cAV0t69,5Gyp41oLVo7Gg7vF4vpmggWP5MU70QO6,22,51,29,13,11,4,8,1,117,16.714285714285715,4,0.0,16,29,9,11,35,4,4,8,1,65,52,1
6573,112736,4akkAUueIgY5RXpAaqc9EEDjUt2pCs2C,5Gyp41oLVo7Gg7vF4vpmggWP5MU70QO6,5,2,1,0,1,0,2,0,6,0.8571428571428571,1,0.0,0,1,0,1,2,0,0,2,0,2,4,1
6574,112744,p7F9wqiENh8WEIuPUKCaZXtSU8HYgtAG,5Gyp41oLVo7Gg7vF4vpmggWP5MU70QO6,1,0,0,0,0,0,1,0,1,0.14285714285714285,1,0.0,0,0,0,0,0,0,0,1,0,0,1,1
6575,112766,pCfcM2SE8eEiM5EU3JQTfV7HzQcZXFdf,5Gyp41oLVo7Gg7vF4vpmggWP5MU70QO6,12,15,5,4,0,0,11,1,36,5.142857142857143,2,0.0,7,5,2,0,8,0,2,11,1,14,22,1
6576,112767,hbyHCKWmRix8tf3hb9GoVowbX4E7bq4m,5Gyp41oLVo7Gg7vF4vpmggWP5MU70QO6,7,6,3,0,2,0,5,0,16,2.2857142857142856,1,0.0,0,3,0,2,6,0,0,5,0,5,11,1
6577,112780,BgbeTSobCItrrFbAULdDOQ1iv2JVx8uN,5Gyp41oLVo7Gg7vF4vpmggWP5MU70QO6,14,20,0,4,1,1,8,1,35,5.0,1,0.0,8,0,2,1,12,1,2,8,1,11,24,1
6578,112788,UuMORbwrTgxjoSjGOUE1agbW4PPcLBkQ,5Gyp41oLVo7Gg7vF4vpmggWP5MU70QO6,1,0,0,0,0,0,1,0,1,0.14285714285714285,1,0.0,0,0,0,0,0,0,0,1,0,0,1,1
6579,112813,ySNhuN4cMJYw3YunLq5TEcsOAWWfl0O3,5Gyp41oLVo7Gg7vF4vpmggWP5MU70QO6,14,13,6,2,3,0,11,1,36,5.142857142857143,1,0.0,3,6,1,3,10,0,1,11,1,13,23,1
6580,112830,uLNBqDSEmqIWmlqtLwekVjrvGHBhIw9z,5Gyp41oLVo7Gg7vF4vpmggWP5MU70QO6,8,7,3,0,2,0,2,0,14,2.0,1,0.0,2,3,0,2,5,0,0,2,0,7,7,1
6581,112835,e26S3yWE4iC2a5gPCzthjRLKEGyf631u,5Gyp41oLVo7Gg7vF4vpmggWP5MU70QO6,36,103,50,36,29,89,43,8,358,51.142857142857146,5,0.0,37,50,24,29,66,89,12,43,8,140,218,1
6582,112841,xHb1ESzYWClS216SrMiGgpGfuxQDdEps,5Gyp41oLVo7Gg7vF4vpmggWP5MU70QO6,17,37,19,10,8,12,8,1,95,13.571428571428571,3,0.0,2,19,6,8,35,12,4,8,1,35,60,0
6583,112852,qwXoPjhUKPW4mjMQuu0Cra7UJGmweA6l,5Gyp41oLVo7Gg7vF4vpmggWP5MU70QO6,1,0,0,0,0,0,1,0,1,0.14285714285714285,1,0.0,0,0,0,0,0,0,0,1,0,0,1,1
6584,112860,92i6WCDh4pbZko87bg3yoG2KzL63FL3Y,5Gyp41oLVo7Gg7vF4vpmggWP5MU70QO6,15,30,14,0,10,20,16,4,94,13.428571428571429,1,0.0,11,14,0,10,19,20,0,16,4,35,59,1
6585,112867,RUKVb8KJARbyVGqP1jNNqUcwarjb1WYI,5Gyp41oLVo7Gg7vF4vpmggWP5MU70QO6,79,256,86,100,44,113,59,2,660,94.28571428571429,16,0.0,71,86,88,44,185,113,12,59,2,289,371,0
6586,112869,nR6yQ1hW5n2ljHF7U5ltxthBwBA5nCyW,5Gyp41oLVo7Gg7vF4vpmggWP5MU70QO6,13,13,8,12,2,0,4,0,39,5.571428571428571,1,0.0,2,8,6,2,11,0,6,4,0,18,21,1
6587,112874,Uf2yr0QlNUZWe0R6cXLvUSjS71SpRuiX,5Gyp41oLVo7Gg7vF4vpmggWP5MU70QO6,31,61,24,22,29,0,17,0,153,21.857142857142858,4,0.0,30,24,14,29,31,0,8,17,0,97,56,0
6588,112884,7ibPDHAfOQNNdh2QVN08a2m5yntiiyLk,5Gyp41oLVo7Gg7vF4vpmggWP5MU70QO6,9,7,3,0,1,3,4,0,18,2.5714285714285716,1,0.0,2,3,0,1,5,3,0,4,0,6,12,1
6589,112893,djDyVBnfhk7KRdU1C4tpJp1YaOuTd9LV,5Gyp41oLVo7Gg7vF4vpmggWP5MU70QO6,4,2,1,0,1,0,1,0,5,0.7142857142857143,1,0.0,0,1,0,1,2,0,0,1,0,2,3,1
6590,112894,GLKrcnSEAULfCGUeTYXqH0DehboNmRud,5Gyp41oLVo7Gg7vF4vpmggWP5MU70QO6,11,8,5,0,3,4,6,1,27,3.857142857142857,2,0.0,0,5,0,3,8,4,0,6,1,8,19,1
6591,112911,H7N61Yol2XG6wyMnfL2nuTS8QWac9JzQ,5Gyp41oLVo7Gg7vF4vpmggWP5MU70QO6,1,0,0,0,0,0,1,0,1,0.14285714285714285,1,0.0,0,0,0,0,0,0,0,1,0,0,1,1
6592,112928,97wHw7Ax0Tpeo3IOtojYRRxaveg1lUvV,5Gyp41oLVo7Gg7vF4vpmggWP5MU70QO6,16,15,8,8,4,1,2,1,39,5.571428571428571,1,0.0,4,8,4,4,11,1,4,2,1,20,19,1
6593,112952,ylczkA3mhE0JVfBTI7R2Ah2WdZBHZ74W,5Gyp41oLVo7Gg7vF4vpmggWP5MU70QO6,1,0,0,0,0,0,1,0,1,0.14285714285714285,1,0.0,0,0,0,0,0,0,0,1,0,0,1,1
6594,112960,VSXMlLIgs4SMMpav2IXYJyIlOX884gOj,5Gyp41oLVo7Gg7vF4vpmggWP5MU70QO6,1,0,0,0,0,0,2,0,2,0.2857142857142857,2,0.0,0,0,0,0,0,0,0,2,0,0,2,1
6595,112966,7glymc4Wt1TTt6LrLi78VQNF5GV1r6UY,5Gyp41oLVo7Gg7vF4vpmggWP5MU70QO6,28,68,33,12,11,110,69,2,305,43.57142857142857,7,0.0,27,33,8,11,41,110,4,69,2,79,226,0
6596,112978,6gOnMTJMrTUveLgLzoVELk1PZxgQ1kKQ,5Gyp41oLVo7Gg7vF4vpmggWP5MU70QO6,5,2,1,0,1,0,3,0,7,1.0,1,0.0,0,1,0,1,2,0,0,3,0,2,5,1
6597,112985,id1kXtz1h0Ndu1sUboFfRV6umlUL6W8J,5Gyp41oLVo7Gg7vF4vpmggWP5MU70QO6,12,7,3,2,2,4,8,1,27,3.857142857142857,2,0.0,1,3,1,2,6,4,1,8,1,7,20,1
6598,112986,f9q0lXE6jHEaa8DHjM18Quo6WmGR6Sg4,5Gyp41oLVo7Gg7vF4vpmggWP5MU70QO6,1,0,0,0,0,0,1,0,1,0.14285714285714285,1,0.0,0,0,0,0,0,0,0,1,0,0,1,1
6599,112999,RIF5KHeeLRLizFLRWosRqC8xVGz6vS3k,5Gyp41oLVo7Gg7vF4vpmggWP5MU70QO6,1,0,0,0,0,0,1,0,1,0.14285714285714285,1,0.0,0,0,0,0,0,0,0,1,0,0,1,1
6600,113008,STkhY4FDBzqHKYwGLMeALn36Cro74h2w,5Gyp41oLVo7Gg7vF4vpmggWP5MU70QO6,1,0,0,0,0,0,1,0,1,0.14285714285714285,1,0.0,0,0,0,0,0,0,0,1,0,0,1,1
6601,113022,lzXT85O8uHmF2hRbbjG6bXL6iB4nZQbJ,5Gyp41oLVo7Gg7vF4vpmggWP5MU70QO6,7,6,0,0,2,0,4,0,12,1.7142857142857142,2,0.0,0,0,0,2,6,0,0,4,0,2,10,1
6602,113026,nqLRPpborGO3IzbD5YxVONrZGqxfXpwO,5Gyp41oLVo7Gg7vF4vpmggWP5MU70QO6,4,2,1,0,1,0,2,0,6,0.8571428571428571,2,0.0,0,1,0,1,2,0,0,2,0,2,4,1
6603,113031,gOPZ3etUXI0kmJnwEMpCSZNEKAFxy8xg,5Gyp41oLVo7Gg7vF4vpmggWP5MU70QO6,7,3,2,0,2,0,2,0,9,1.2857142857142858,2,0.0,0,2,0,2,3,0,0,2,0,4,5,1
6604,113054,s1N0dNbsWZDqWhBof20h9F9XNjqzGFwU,5Gyp41oLVo7Gg7vF4vpmggWP5MU70QO6,13,9,5,0,4,5,7,1,31,4.428571428571429,3,0.0,1,5,0,4,8,5,0,7,1,10,21,0
6605,113061,P14RsFZwskYIpR5RuUNTAAtw7xsSIRhZ,5Gyp41oLVo7Gg7vF4vpmggWP5MU70QO6,11,7,6,0,4,0,2,0,19,2.7142857142857144,1,0.0,0,6,0,4,7,0,0,2,0,10,9,1
6606,113079,H4rucA3Bl92feiIFqEyA7i9inMfODBCx,5Gyp41oLVo7Gg7vF4vpmggWP5MU70QO6,34,117,59,42,27,50,25,5,325,46.42857142857143,11,0.0,37,59,30,27,80,50,12,25,5,153,172,1
6607,113106,qrcQ2HXUo2OtdaLvPE11MfpxbhBmjbOQ,5Gyp41oLVo7Gg7vF4vpmggWP5MU70QO6,8,4,3,0,2,0,2,0,11,1.5714285714285714,1,0.0,0,3,0,2,4,0,0,2,0,5,6,1
6608,113142,Y31gK8vZGNFE1p0FvJ7aBtAs0fzlqYVf,5Gyp41oLVo7Gg7vF4vpmggWP5MU70QO6,8,4,3,0,2,0,2,0,11,1.5714285714285714,1,0.0,0,3,0,2,4,0,0,2,0,5,6,1
6609,113167,jMSxxfftYD0taGWVEUZkcvxpGucC0j8q,5Gyp41oLVo7Gg7vF4vpmggWP5MU70QO6,7,9,4,0,0,0,3,0,16,2.2857142857142856,1,0.0,0,4,0,0,9,0,0,3,0,4,12,1
6610,113179,9Jd3vMNhp6SyraVetj8QtVOJNQzaAfTi,5Gyp41oLVo7Gg7vF4vpmggWP5MU70QO6,23,48,27,36,7,0,10,0,128,18.285714285714285,4,0.0,9,27,29,7,39,0,7,10,0,72,56,1
6611,113182,lvisrpyGeQckAylDwLBoWaVY1UfLOspu,5Gyp41oLVo7Gg7vF4vpmggWP5MU70QO6,1,0,0,0,0,0,1,0,1,0.14285714285714285,1,0.0,0,0,0,0,0,0,0,1,0,0,1,1
6612,113189,fUZcUE1FRmNuUNTn5Iz8wZHRok3wKZAV,5Gyp41oLVo7Gg7vF4vpmggWP5MU70QO6,10,8,1,2,3,1,4,0,19,2.7142857142857144,1,0.0,3,1,1,3,5,1,1,4,0,8,11,0
6613,113206,6Ricds2xdJuml6Uu7KDw8pScpGwqxOl3,7GRhBDsirIGkRZBtSMEzNTyDr2JQm4xx,29,25,17,0,18,6,2,0,68,9.714285714285714,1,0.0,6,17,0,18,19,6,0,2,0,41,27,0
6614,113225,Ti1mRNlEpadfQjVYDTXYfmLfMF1Sn1O7,7GRhBDsirIGkRZBtSMEzNTyDr2JQm4xx,1,0,0,0,0,0,1,0,1,0.14285714285714285,1,0.0,0,0,0,0,0,0,0,1,0,0,1,1
6615,113226,CozZoSX7AwprtwyJFCAeFUYiCq7OSEAP,7GRhBDsirIGkRZBtSMEzNTyDr2JQm4xx,5,3,1,0,1,0,2,0,7,1.0,1,0.0,0,1,0,1,3,0,0,2,0,2,5,1
6616,113235,nrpTW24MJzbUltV0JUN1fQU4Pmhy2MGS,7GRhBDsirIGkRZBtSMEzNTyDr2JQm4xx,26,44,14,16,11,0,4,0,89,12.714285714285714,1,0.0,19,14,10,11,25,0,6,4,0,54,35,1
6617,113252,qOmxvQ0HKFl7XBqTlqvTjsKLJmmvzb5K,7GRhBDsirIGkRZBtSMEzNTyDr2JQm4xx,2,0,0,0,0,0,4,0,4,0.5714285714285714,1,0.0,0,0,0,0,0,0,0,4,0,0,4,1
6618,113262,H87RUeQNyhaDy48siaXFyvv7ZcvBw8DO,7GRhBDsirIGkRZBtSMEzNTyDr2JQm4xx,6,8,2,0,0,0,3,0,13,1.8571428571428572,2,0.0,0,2,0,0,8,0,0,3,0,2,11,1
6619,113266,SaJRa20OXDY1LCrTPWwAL4qw1OJoFlxd,7GRhBDsirIGkRZBtSMEzNTyDr2JQm4xx,1,0,0,0,0,0,1,0,1,0.14285714285714285,1,0.0,0,0,0,0,0,0,0,1,0,0,1,0
6620,113320,GZo3DRTrJrKQ66RAXkSmxAsw7hv4e5Em,3VkHkmOtom3jM2wCu94xgzzu1d6Dn7or,1,0,0,0,0,0,1,0,1,0.14285714285714285,1,0.0,0,0,0,0,0,0,0,1,0,0,1,1
6621,113356,aZXiEqViR3mJZWuUJRzqAX6Y8grPJzee,3VkHkmOtom3jM2wCu94xgzzu1d6Dn7or,1,0,0,0,0,0,1,0,1,0.14285714285714285,1,0.0,0,0,0,0,0,0,0,1,0,0,1,1
6622,113462,6OR4dT3Nn7HJnm7QL3Pb9sooW2RNywP3,3VkHkmOtom3jM2wCu94xgzzu1d6Dn7or,7,2,1,0,1,1,4,1,10,1.4285714285714286,1,0.0,0,1,0,1,2,1,0,4,1,2,8,1
6623,113500,7BLnGPURyobb1iQ7BErODo6F6LhxSiyD,3VkHkmOtom3jM2wCu94xgzzu1d6Dn7or,1,0,0,0,0,0,1,0,1,0.14285714285714285,1,0.0,0,0,0,0,0,0,0,1,0,0,1,1
6624,113530,zhBulUMBBoq03Uyq0sJ23dOYU92V48SU,3VkHkmOtom3jM2wCu94xgzzu1d6Dn7or,1,0,0,0,0,0,2,0,2,0.2857142857142857,1,0.0,0,0,0,0,0,0,0,2,0,0,2,1
6625,113549,AOy0e5xukkmuYjWQEwT6UCwFma8jpz06,3VkHkmOtom3jM2wCu94xgzzu1d6Dn7or,1,0,0,0,0,0,1,0,1,0.14285714285714285,1,0.0,0,0,0,0,0,0,0,1,0,0,1,1
6626,113591,U7btMcQ825kheRskgLUndnBUWWFj60BC,3VkHkmOtom3jM2wCu94xgzzu1d6Dn7or,4,2,1,0,1,0,2,0,6,0.8571428571428571,1,0.0,0,1,0,1,2,0,0,2,0,2,4,1
6627,113619,LBLEODXfAs2lWDhUZeileXIBJRAYli0D,3VkHkmOtom3jM2wCu94xgzzu1d6Dn7or,1,0,0,0,0,0,1,0,1,0.14285714285714285,1,0.0,0,0,0,0,0,0,0,1,0,0,1,1
6628,113628,etuo6daiaaiJHCZ5OnshEtxiyNmRPrTP,3VkHkmOtom3jM2wCu94xgzzu1d6Dn7or,1,0,0,0,0,0,1,0,1,0.14285714285714285,1,0.0,0,0,0,0,0,0,0,1,0,0,1,1
6629,113632,bKSoZprZeBDowFRoIULA1b2XoCUkEzgH,3VkHkmOtom3jM2wCu94xgzzu1d6Dn7or,63,139,37,116,46,14,24,5,381,54.42857142857143,3,0.0,80,37,107,46,59,14,9,24,5,270,111,1
6630,113639,FM7f8SmryrQv0xQWmeGBOm7E9JzAE7cF,3VkHkmOtom3jM2wCu94xgzzu1d6Dn7or,5,8,5,0,4,4,2,0,23,3.2857142857142856,1,0.0,0,5,0,4,8,4,0,2,0,9,14,0
6631,113667,rHOAxnJnHgkkXAMAFdEP673yAyMeWMLn,3VkHkmOtom3jM2wCu94xgzzu1d6Dn7or,4,2,1,0,1,0,1,0,5,0.7142857142857143,1,0.0,0,1,0,1,2,0,0,1,0,2,3,1
6632,113694,41ih6CMV0Q2tNC5jteIa8qH706Arp4mA,3VkHkmOtom3jM2wCu94xgzzu1d6Dn7or,9,14,2,0,1,1,4,0,22,3.142857142857143,1,0.0,0,2,0,1,14,1,0,4,0,3,19,1
6633,113712,eaeORohb7wCQL9JM2uz3yah8DgLbswAx,3VkHkmOtom3jM2wCu94xgzzu1d6Dn7or,1,0,0,0,0,0,1,0,1,0.14285714285714285,1,0.0,0,0,0,0,0,0,0,1,0,0,1,1
6634,113714,llD0tqUyYHnKGenR1CzxVCYD7wYYCHxa,3VkHkmOtom3jM2wCu94xgzzu1d6Dn7or,6,4,1,0,2,0,7,0,14,2.0,1,0.0,2,1,0,2,2,0,0,7,0,5,9,1
6635,113765,if1RYQQ7Cj29ACdlqQKKzjcriFn3O4s7,3VkHkmOtom3jM2wCu94xgzzu1d6Dn7or,9,4,3,0,2,6,9,5,29,4.142857142857143,1,0.0,0,3,0,2,4,6,0,9,5,5,24,1
6636,113766,g9NnaN8zicHlHIabvjQkRDXqY5W7SH9D,3VkHkmOtom3jM2wCu94xgzzu1d6Dn7or,1,0,0,0,0,0,1,0,1,0.14285714285714285,1,0.0,0,0,0,0,0,0,0,1,0,0,1,1
6637,113825,xUhDcXiX03QQg1jNR3Lksh9CrGcRUkPg,7GRhBDsirIGkRZBtSMEzNTyDr2JQm4xx,2,0,0,0,0,7,1,0,8,1.1428571428571428,1,0.0,0,0,0,0,0,7,0,1,0,0,8,0
6638,113870,iqeO8OrE0ZCrWK6qDgxXq3GlMxXdM9nN,5X6FeZozNMgE2VRi3MJYjkkFK8SETtu2,2,0,0,0,0,0,2,0,2,0.2857142857142857,1,0.0,0,0,0,0,0,0,0,2,0,0,2,1
6639,113935,nDRvdnRCphlivJCuFTuhDKgd5jyHoHuK,7GRhBDsirIGkRZBtSMEzNTyDr2JQm4xx,27,87,33,12,16,0,9,0,157,22.428571428571427,5,0.0,45,33,9,16,42,0,3,9,0,103,54,0
6640,113951,dgFOOUSNfQK8xIrT47Av0Q04bBFeE21W,5X6FeZozNMgE2VRi3MJYjkkFK8SETtu2,5,2,1,0,1,0,3,0,7,1.0,2,0.0,0,1,0,1,2,0,0,3,0,2,5,0
6641,113967,BS42tQ4M7qxE2fbtH53iTeEQofO2Q5YM,5X6FeZozNMgE2VRi3MJYjkkFK8SETtu2,2,0,0,0,0,0,3,0,3,0.42857142857142855,1,0.0,0,0,0,0,0,0,0,3,0,0,3,1
6642,114030,7G7gGwBiR8PZ9BGrK3UBdOy5b5BxYw0z,5X6FeZozNMgE2VRi3MJYjkkFK8SETtu2,1,0,0,0,0,0,1,0,1,0.14285714285714285,1,0.0,0,0,0,0,0,0,0,1,0,0,1,1
6643,114140,nUWkRuhBy34ASlaPMCQ75Oelnn64cfdy,7GRhBDsirIGkRZBtSMEzNTyDr2JQm4xx,29,67,25,14,19,31,6,1,163,23.285714285714285,1,0.0,37,25,7,19,30,31,7,6,1,88,75,0
6644,114179,QZbPGbTnAqz8GS6cm25XcpeiETovvLN6,7GRhBDsirIGkRZBtSMEzNTyDr2JQm4xx,29,67,13,35,15,0,8,0,138,19.714285714285715,2,0.0,28,13,29,15,39,0,6,8,0,85,53,0
6645,114195,KkSinTdG2PbGrJIRATMZos8HES46UawO,5X6FeZozNMgE2VRi3MJYjkkFK8SETtu2,15,34,12,0,9,0,4,0,59,8.428571428571429,4,0.0,6,12,0,9,28,0,0,4,0,27,32,1
6646,114202,BYMia6rYyVXQ3hTTY2SW71awypyGQmbs,5X6FeZozNMgE2VRi3MJYjkkFK8SETtu2,1,0,0,0,0,0,1,0,1,0.14285714285714285,1,0.0,0,0,0,0,0,0,0,1,0,0,1,1
6647,114272,C8zDhaG0vPsQegBtS55u3JZHiYuueFnE,5X6FeZozNMgE2VRi3MJYjkkFK8SETtu2,14,28,1,25,11,0,14,0,79,11.285714285714286,12,0.0,20,1,21,11,8,0,4,14,0,53,26,0
6648,114281,L7NMY402u880Duf2mPDRyP0UpxBO5z2o,5X6FeZozNMgE2VRi3MJYjkkFK8SETtu2,2,0,0,0,0,0,3,0,3,0.42857142857142855,1,0.0,0,0,0,0,0,0,0,3,0,0,3,0
6649,114304,8vfANOlVROv1BVu6W9lu5Apf2MGCVpIn,5X6FeZozNMgE2VRi3MJYjkkFK8SETtu2,76,216,88,0,138,2,24,2,470,67.14285714285714,7,0.0,107,88,0,138,109,2,0,24,2,333,137,0
6650,114458,hu8eak1Xmf8voE8pnxPzkSD2dZP9Sipf,7GRhBDsirIGkRZBtSMEzNTyDr2JQm4xx,2,0,0,0,0,0,3,0,3,0.42857142857142855,1,0.0,0,0,0,0,0,0,0,3,0,0,3,0
6651,114460,gBUQvhjVwGtG2bUGFkuQNt86DA2hmTm5,7GRhBDsirIGkRZBtSMEzNTyDr2JQm4xx,13,6,5,0,2,0,6,0,19,2.7142857142857144,1,0.0,0,5,0,2,6,0,0,6,0,7,12,1
6652,114473,AifTjiD8gsxdxahWngXjdMDduP2s4vuX,5X6FeZozNMgE2VRi3MJYjkkFK8SETtu2,4,3,2,0,0,0,5,0,10,1.4285714285714286,2,0.0,0,2,0,0,3,0,0,5,0,2,8,1
6653,114508,DahdU3m64q9GHbzMvs6TdHVFTDo4asbt,7GRhBDsirIGkRZBtSMEzNTyDr2JQm4xx,13,6,4,6,2,2,17,0,37,5.285714285714286,1,0.0,1,4,5,2,5,2,1,17,0,12,25,0
6654,114521,sbaJoVFlMLyfg1PbRG67GWzU7ygSqHEa,5X6FeZozNMgE2VRi3MJYjkkFK8SETtu2,8,10,2,5,3,0,2,0,22,3.142857142857143,2,0.0,4,2,5,3,6,0,0,2,0,14,8,1
6655,114528,Ykpl4oTagCTFKge3GXTMoB9qSHG2mG7d,5X6FeZozNMgE2VRi3MJYjkkFK8SETtu2,17,13,10,0,6,0,5,0,34,4.857142857142857,3,0.0,0,10,0,6,13,0,0,5,0,16,18,1
6656,114551,dDY6syRWP8OTI4q5NbhQb8dXKkVppYZH,5X6FeZozNMgE2VRi3MJYjkkFK8SETtu2,16,19,1,7,5,0,4,0,36,5.142857142857143,2,0.0,7,1,7,5,12,0,0,4,0,20,16,1
6657,114557,rqwp0DRxlrzViX8K4jHTHKpfYZPPmBwb,5X6FeZozNMgE2VRi3MJYjkkFK8SETtu2,1,0,0,0,0,0,1,0,1,0.14285714285714285,1,0.0,0,0,0,0,0,0,0,1,0,0,1,1
6658,114562,BQSRjVmgixA5nv8k53vKwJ20bVp0NOMd,7GRhBDsirIGkRZBtSMEzNTyDr2JQm4xx,16,17,5,42,0,29,4,0,97,13.857142857142858,1,0.0,8,5,32,0,9,29,10,4,0,45,52,0
6659,114593,TDZqTAe3O03535EQlgLT4WJkveLsaPmx,5X6FeZozNMgE2VRi3MJYjkkFK8SETtu2,127,171,21,283,7,2,32,0,516,73.71428571428571,7,0.0,107,21,240,7,64,2,43,32,0,375,141,0
6660,114609,niCmhuSfQsMKGJA13iBf3xqhHudkRRY5,fbPkOYLVPtPgIt0MxizjfFJov3JbHyAi,1,0,0,0,0,0,1,0,1,0.14285714285714285,1,0.0,0,0,0,0,0,0,0,1,0,0,1,0
6661,114610,TdYcFi1KMH5omMcyptxlDLiiNNaCOGVb,fbPkOYLVPtPgIt0MxizjfFJov3JbHyAi,5,2,1,0,1,0,2,0,6,0.8571428571428571,1,0.0,0,1,0,1,2,0,0,2,0,2,4,1
6662,114611,5x7PJKAlpwjJHVKa6EUCDUMMHmJ1P3I6,fbPkOYLVPtPgIt0MxizjfFJov3JbHyAi,2,0,0,0,0,0,3,0,3,0.42857142857142855,1,0.0,0,0,0,0,0,0,0,3,0,0,3,1
6663,114612,AnYK2hcpzbjzweqfPwn38soHYvfmjroU,fbPkOYLVPtPgIt0MxizjfFJov3JbHyAi,1,0,0,0,0,0,1,0,1,0.14285714285714285,1,0.0,0,0,0,0,0,0,0,1,0,0,1,0
6664,114613,ov7BYx7M6nQf9HtywUVu0CvVUbJ2cMz9,fbPkOYLVPtPgIt0MxizjfFJov3JbHyAi,5,6,5,0,6,0,0,0,17,2.4285714285714284,2,0.0,0,5,0,6,6,0,0,0,0,11,6,1
6665,114614,dwc3sSLydjXkCgUI09xxNoTdGXTiIq3c,fbPkOYLVPtPgIt0MxizjfFJov3JbHyAi,8,5,3,0,2,0,12,0,22,3.142857142857143,1,0.0,0,3,0,2,5,0,0,12,0,5,17,1
6666,114617,uY0DbkhjMuOAkJCfucw0j5EqP7OIItJS,fbPkOYLVPtPgIt0MxizjfFJov3JbHyAi,16,8,5,4,4,2,7,1,31,4.428571428571429,1,0.0,2,5,3,4,6,2,1,7,1,14,17,1
6667,114619,rK6VIj3YtKNLNkhFEFptdAOiC1zWzKSs,fbPkOYLVPtPgIt0MxizjfFJov3JbHyAi,1,0,0,0,0,0,1,0,1,0.14285714285714285,1,0.0,0,0,0,0,0,0,0,1,0,0,1,1
6668,114621,JeQPL0r0OGbw8HdzB8rTDyc7qvYZbjuq,fbPkOYLVPtPgIt0MxizjfFJov3JbHyAi,2,0,0,0,0,0,6,0,6,0.8571428571428571,1,0.0,0,0,0,0,0,0,0,6,0,0,6,1
6669,114622,whDoakw9KuyWQ8M0W7cddKOMydB0d6nf,fbPkOYLVPtPgIt0MxizjfFJov3JbHyAi,11,13,7,0,4,8,3,0,35,5.0,1,0.0,2,7,0,4,11,8,0,3,0,13,22,1
6670,114623,lltPVpQeb3LNlctUlWfa8Q4MhniSz7KE,fbPkOYLVPtPgIt0MxizjfFJov3JbHyAi,1,0,0,0,0,0,1,0,1,0.14285714285714285,1,0.0,0,0,0,0,0,0,0,1,0,0,1,0
6671,114624,LoCOszuIzTSeaWLSvGsGNoO7BQacUJ26,fbPkOYLVPtPgIt0MxizjfFJov3JbHyAi,14,12,7,0,7,0,1,0,27,3.857142857142857,1,0.0,0,7,0,7,12,0,0,1,0,14,13,1
6672,114625,z5b37rtZXpcAYDG2omaxcs76JrGc20dV,fbPkOYLVPtPgIt0MxizjfFJov3JbHyAi,10,10,3,0,5,0,4,0,22,3.142857142857143,1,0.0,6,3,0,5,4,0,0,4,0,14,8,1
6673,114626,6tmxpsRtsjoDY9zXnzo3i4nW1oQa44E2,fbPkOYLVPtPgIt0MxizjfFJov3JbHyAi,7,5,3,0,0,0,4,0,12,1.7142857142857142,1,0.0,1,3,0,0,4,0,0,4,0,4,8,0
6674,114627,uKuE1pqPLKBLlaDHpMsHUJvLz6lxiokY,fbPkOYLVPtPgIt0MxizjfFJov3JbHyAi,17,13,7,0,6,0,2,0,28,4.0,2,0.0,0,7,0,6,13,0,0,2,0,13,15,1
6675,114629,9U8eq2wcLu6mgVxnBD4EHfzYamgCvE9F,fbPkOYLVPtPgIt0MxizjfFJov3JbHyAi,1,0,0,0,0,0,1,0,1,0.14285714285714285,1,0.0,0,0,0,0,0,0,0,1,0,0,1,1
6676,114633,KbfT30uvubax3lKEct6iblV8VhlPaIEn,fbPkOYLVPtPgIt0MxizjfFJov3JbHyAi,1,0,0,0,0,0,1,0,1,0.14285714285714285,1,0.0,0,0,0,0,0,0,0,1,0,0,1,1
6677,114634,5MFqn51ngpNJRILTITSLFdc469nefTuS,fbPkOYLVPtPgIt0MxizjfFJov3JbHyAi,8,4,3,0,1,1,5,1,15,2.142857142857143,1,0.0,0,3,0,1,4,1,0,5,1,4,11,1
6678,114635,J83msrPq5aEXLkbsBsIQs6LqQS1iTroR,fbPkOYLVPtPgIt0MxizjfFJov3JbHyAi,9,4,3,0,3,0,2,0,12,1.7142857142857142,1,0.0,0,3,0,3,4,0,0,2,0,6,6,0
6679,114637,tcp1waH3lybh7mEbOxmBUMGzEZXMKD2w,fbPkOYLVPtPgIt0MxizjfFJov3JbHyAi,3,0,0,0,0,4,2,0,6,0.8571428571428571,1,0.0,0,0,0,0,0,4,0,2,0,0,6,1
6680,114638,se1kyJ0KlduEpFVfhZokiqY2YgGqJGe8,fbPkOYLVPtPgIt0MxizjfFJov3JbHyAi,1,0,0,0,0,0,2,0,2,0.2857142857142857,1,0.0,0,0,0,0,0,0,0,2,0,0,2,1
6681,114639,IXyECojptU5NkfL9RFdtwIRy87m56pw9,fbPkOYLVPtPgIt0MxizjfFJov3JbHyAi,4,2,1,0,0,0,3,0,6,0.8571428571428571,2,0.0,0,1,0,0,2,0,0,3,0,1,5,1
6682,114640,1HR58VcPK4IMS1mKcNg7SfwEfj1z1o5o,fbPkOYLVPtPgIt0MxizjfFJov3JbHyAi,4,5,1,0,0,0,1,0,7,1.0,1,0.0,0,1,0,0,5,0,0,1,0,1,6,1
6683,114642,zHjd9VGEAzcUjGnFtT4ddyUTp3lS93oc,fbPkOYLVPtPgIt0MxizjfFJov3JbHyAi,4,2,0,0,0,0,2,0,4,0.5714285714285714,1,0.0,0,0,0,0,2,0,0,2,0,0,4,1
6684,114643,WfE8YobKj49KJJchFTR0mkLGdZ0KFFcq,fbPkOYLVPtPgIt0MxizjfFJov3JbHyAi,1,0,0,0,0,0,1,0,1,0.14285714285714285,1,0.0,0,0,0,0,0,0,0,1,0,0,1,1
6685,114645,vBRVRWgAePdcgjHkXuejXMzthEVUxEVX,fbPkOYLVPtPgIt0MxizjfFJov3JbHyAi,5,2,1,0,1,3,4,0,11,1.5714285714285714,1,0.0,0,1,0,1,2,3,0,4,0,2,9,1
6686,114647,bEEMkJ0I54PCyK7ibWoXvwgZk08IOlqP,fbPkOYLVPtPgIt0MxizjfFJov3JbHyAi,5,2,1,0,1,0,2,0,6,0.8571428571428571,1,0.0,0,1,0,1,2,0,0,2,0,2,4,0
6687,114649,Y9tBhsfrr3ypg5AH5wcQ2oUkdhoSd6DM,fbPkOYLVPtPgIt0MxizjfFJov3JbHyAi,6,5,2,0,2,0,4,0,13,1.8571428571428572,1,0.0,0,2,0,2,5,0,0,4,0,4,9,1
6688,114651,7x51V9V9eIHFPqiYUnOLpACvWY55pqZF,fbPkOYLVPtPgIt0MxizjfFJov3JbHyAi,1,0,0,0,0,0,1,0,1,0.14285714285714285,1,0.0,0,0,0,0,0,0,0,1,0,0,1,1
6689,114652,wuaIkUodYTr49NZ7BbMPsEdpO0t0C8Nt,fbPkOYLVPtPgIt0MxizjfFJov3JbHyAi,6,6,0,0,0,0,2,0,8,1.1428571428571428,1,0.0,0,0,0,0,6,0,0,2,0,0,8,1
6690,115160,fieyLvxxnJDCWWusdelrijbwpRBWtEpl,3VkHkmOtom3jM2wCu94xgzzu1d6Dn7or,53,107,30,37,31,41,13,0,259,37.0,8,0.0,57,30,35,31,50,41,2,13,0,153,106,1
6691,115173,QvRGOqLSyf5dfsZjPsCzMC3zwxe6tcsy,3VkHkmOtom3jM2wCu94xgzzu1d6Dn7or,76,219,54,54,64,2,35,0,428,61.142857142857146,9,0.0,97,54,49,64,122,2,5,35,0,264,164,0
6692,115174,RovL92vHmNPAy9rTXXm11cTDRwS4wiTZ,3VkHkmOtom3jM2wCu94xgzzu1d6Dn7or,12,12,7,0,5,0,5,0,29,4.142857142857143,2,0.0,0,7,0,5,12,0,0,5,0,12,17,0
6693,115185,P5LB9o4LFc5VzoLgvlYgneakbDE98ytK,3VkHkmOtom3jM2wCu94xgzzu1d6Dn7or,12,17,9,0,5,3,11,5,50,7.142857142857143,1,0.0,3,9,0,5,14,3,0,11,5,17,33,1
6694,115223,OaC3DR2iMODztyfFlezZcG5ZWLBbZoY5,3VkHkmOtom3jM2wCu94xgzzu1d6Dn7or,64,78,23,98,26,20,7,1,253,36.142857142857146,3,0.0,45,23,88,26,33,20,10,7,1,182,71,0
6695,115230,ng6ocRbrVitvQVTJnsnrNknwr1N4z9ik,3VkHkmOtom3jM2wCu94xgzzu1d6Dn7or,31,75,44,0,0,6,25,1,151,21.571428571428573,8,0.0,7,44,0,0,68,6,0,25,1,51,100,0
6696,115289,L7NaJm2W9meokaZSy7jbmVKaCuuQajnz,3VkHkmOtom3jM2wCu94xgzzu1d6Dn7or,87,126,64,56,58,3,43,1,351,50.142857142857146,10,0.0,50,64,48,58,76,3,8,43,1,220,131,0
6697,115310,UOMNuth7w3HbS8GZxzACBwQ58GIkOnsC,3VkHkmOtom3jM2wCu94xgzzu1d6Dn7or,87,222,97,58,75,47,59,1,559,79.85714285714286,11,0.0,71,97,55,75,151,47,3,59,1,298,261,0
6698,115313,YfHmALaAUVJkTXPVPoa3sijNQuWgYS7R,3VkHkmOtom3jM2wCu94xgzzu1d6Dn7or,91,488,101,124,159,42,27,0,941,134.42857142857142,7,0.0,345,101,124,159,143,42,0,27,0,729,212,0
6699,115314,M93tH8gbLG5lH6yh5TZ5PcBqNoDrcmIM,3VkHkmOtom3jM2wCu94xgzzu1d6Dn7or,1,0,0,0,0,0,2,0,2,0.2857142857142857,1,0.0,0,0,0,0,0,0,0,2,0,0,2,1
6700,115454,wxOgTM0U8atO7FTCY8VhNuh0fylTpPFX,3VkHkmOtom3jM2wCu94xgzzu1d6Dn7or,1,0,0,0,0,0,1,0,1,0.14285714285714285,1,0.0,0,0,0,0,0,0,0,1,0,0,1,1
6701,115464,jQGozXgCDEtih8n0QNDjwOxHGubLTjEt,3VkHkmOtom3jM2wCu94xgzzu1d6Dn7or,1,0,0,0,0,0,1,0,1,0.14285714285714285,1,0.0,0,0,0,0,0,0,0,1,0,0,1,1
6702,115473,dnl7OTY17jTVZKBUz2oGzV5ZgMtZUzyw,3VkHkmOtom3jM2wCu94xgzzu1d6Dn7or,1,0,0,0,0,0,1,0,1,0.14285714285714285,1,0.0,0,0,0,0,0,0,0,1,0,0,1,1
6703,115475,TXo0CCOBoSUl3sGr1fGqVDX7GLiPHTPL,3VkHkmOtom3jM2wCu94xgzzu1d6Dn7or,10,50,16,0,1,0,7,0,74,10.571428571428571,4,0.0,8,16,0,1,42,0,0,7,0,25,49,1
6704,115528,Ewi0j7dXy4kTOaWpRDWlB9pPIpAe1PlV,3VkHkmOtom3jM2wCu94xgzzu1d6Dn7or,7,6,4,0,3,0,2,0,15,2.142857142857143,1,0.0,0,4,0,3,6,0,0,2,0,7,8,0
6705,115539,Zxs1RumGHONRCjjtlqlZeQ4V6CgOxVWH,3VkHkmOtom3jM2wCu94xgzzu1d6Dn7or,36,55,24,0,14,3,8,0,104,14.857142857142858,4,0.0,1,24,0,14,54,3,0,8,0,39,65,0
6706,115547,RAMomgZ0L1bKGCOyYy2Aq7TrXqd2gODP,3VkHkmOtom3jM2wCu94xgzzu1d6Dn7or,1,0,0,0,0,0,1,0,1,0.14285714285714285,1,0.0,0,0,0,0,0,0,0,1,0,0,1,1
6707,115554,IjhWPxQ0FPkozhZrQzWjblIBOwZLOTam,3VkHkmOtom3jM2wCu94xgzzu1d6Dn7or,4,3,1,0,1,0,2,0,7,1.0,1,0.0,0,1,0,1,3,0,0,2,0,2,5,1
6708,115571,NaR3qnAVE7AtsDMIfQuAkTqOCgLrJLZR,3VkHkmOtom3jM2wCu94xgzzu1d6Dn7or,8,13,6,7,3,0,6,0,35,5.0,3,0.0,4,6,6,3,9,0,1,6,0,19,16,1
6709,115605,rA6mPEjcnShXmHCoEHgThQ4NwtVmX6Le,3VkHkmOtom3jM2wCu94xgzzu1d6Dn7or,53,221,61,39,34,21,24,0,400,57.142857142857146,9,0.0,80,61,37,34,141,21,2,24,0,212,188,0
6710,115617,nWedGV2Cyz7b86zoWjyUJZtraXV6YlYz,3VkHkmOtom3jM2wCu94xgzzu1d6Dn7or,63,191,85,43,33,22,59,7,440,62.857142857142854,11,0.0,55,85,36,33,136,22,7,59,7,209,231,0
6711,115644,qyZKoOVKnXPt3uf5QoNCxiu3qBc2a5qN,3VkHkmOtom3jM2wCu94xgzzu1d6Dn7or,9,4,3,0,3,0,2,0,12,1.7142857142857142,1,0.0,0,3,0,3,4,0,0,2,0,6,6,1
6712,115675,q5YNxgDFMK1d6eLl2o5B3rP2xueUu1iW,3VkHkmOtom3jM2wCu94xgzzu1d6Dn7or,2,0,0,0,0,0,2,0,2,0.2857142857142857,1,0.0,0,0,0,0,0,0,0,2,0,0,2,1
6713,115678,siN9paTuwgso6C2nIU0pfTpI5zIA7vHg,3VkHkmOtom3jM2wCu94xgzzu1d6Dn7or,64,159,39,73,57,79,21,1,429,61.285714285714285,5,0.0,99,39,70,57,60,79,3,21,1,265,164,0
6714,115688,GgocYHg42QPeXhj3QB7FBVGJqSqHh2yN,3VkHkmOtom3jM2wCu94xgzzu1d6Dn7or,5,4,2,0,0,0,3,0,9,1.2857142857142858,2,0.0,0,2,0,0,4,0,0,3,0,2,7,1
6715,115711,jSWOpyuViewWJZcv27YxPk4V4lgmow6e,3VkHkmOtom3jM2wCu94xgzzu1d6Dn7or,1,0,0,0,0,0,1,0,1,0.14285714285714285,1,0.0,0,0,0,0,0,0,0,1,0,0,1,1
6716,115714,AlSHpBPHRrLS1g39eFf9IIaZAAADponU,3VkHkmOtom3jM2wCu94xgzzu1d6Dn7or,1,0,0,0,0,0,1,0,1,0.14285714285714285,1,0.0,0,0,0,0,0,0,0,1,0,0,1,1
6717,115717,EP1XQRGS4HZOG1hdGzNZdD1HFhJcHpos,3VkHkmOtom3jM2wCu94xgzzu1d6Dn7or,64,126,66,38,43,52,30,4,359,51.285714285714285,9,0.0,39,66,34,43,87,52,4,30,4,182,177,0
6718,115760,va3cVfF38XAjn4LEh6VxTTEdlP5IupZ2,3VkHkmOtom3jM2wCu94xgzzu1d6Dn7or,1,0,0,0,0,0,1,0,1,0.14285714285714285,1,0.0,0,0,0,0,0,0,0,1,0,0,1,1
6719,115764,63cvDQWg2vpRGVS0xYd9KphyyRDSd34N,3VkHkmOtom3jM2wCu94xgzzu1d6Dn7or,30,70,24,33,26,13,16,1,183,26.142857142857142,4,0.0,35,24,27,26,35,13,6,16,1,112,71,1
6720,115766,5EOGhyHOLLtbW0eEa8Dnfl5My4kdYkdc,3VkHkmOtom3jM2wCu94xgzzu1d6Dn7or,27,51,27,4,17,0,15,0,114,16.285714285714285,9,0.0,8,27,4,17,43,0,0,15,0,56,58,1
6721,115767,cnUUxohEmTFV5DSw4q1r5dj1vGWSh7Y1,3VkHkmOtom3jM2wCu94xgzzu1d6Dn7or,12,22,8,0,6,5,10,4,55,7.857142857142857,2,0.0,8,8,0,6,14,5,0,10,4,22,33,1
6722,115807,epcWGQ9GUW4vRbY9walvIeEIlc9Z11Wh,3VkHkmOtom3jM2wCu94xgzzu1d6Dn7or,4,0,0,0,0,0,6,0,6,0.8571428571428571,1,0.0,0,0,0,0,0,0,0,6,0,0,6,1
6723,115913,Th6GGIKucyCokdQsUn3aOeloTzqx0Qbo,3VkHkmOtom3jM2wCu94xgzzu1d6Dn7or,34,40,23,6,18,14,8,0,109,15.571428571428571,3,0.0,5,23,5,18,35,14,1,8,0,51,58,1
6724,115943,YuzFD6BViIQAEul9hFT6qv6dLuFAFbcx,3VkHkmOtom3jM2wCu94xgzzu1d6Dn7or,62,214,49,68,24,21,15,0,391,55.857142857142854,3,0.0,54,49,67,24,160,21,1,15,0,194,197,0
6725,115950,5zqlBxYbrtpFVoicJGaTdh9tPhf25O6l,3VkHkmOtom3jM2wCu94xgzzu1d6Dn7or,1,0,0,0,0,0,1,0,1,0.14285714285714285,1,0.0,0,0,0,0,0,0,0,1,0,0,1,0
6726,115960,gfiPEsWR7f3Ji97wZsTMJFP52I5ZobFs,3VkHkmOtom3jM2wCu94xgzzu1d6Dn7or,78,220,81,33,66,13,93,3,509,72.71428571428571,14,0.0,105,81,30,66,115,13,3,93,3,282,227,0
6727,115978,ARN6lemNodC8v9qPjv26YnbpCElrSWA7,3VkHkmOtom3jM2wCu94xgzzu1d6Dn7or,7,2,2,0,2,0,14,0,20,2.857142857142857,4,0.0,0,2,0,2,2,0,0,14,0,4,16,0
6728,115984,SKAv0beXOQ0EXMa8AzOc39QMzerck7cn,3VkHkmOtom3jM2wCu94xgzzu1d6Dn7or,10,8,4,2,1,2,5,16,38,5.428571428571429,1,0.0,1,4,2,1,7,2,0,5,16,8,30,1
6729,115995,okqN4nBVKRYYrkYonKicKGOmPqVGYjZh,3VkHkmOtom3jM2wCu94xgzzu1d6Dn7or,48,194,88,0,23,89,108,0,502,71.71428571428571,18,0.0,7,88,0,23,187,89,0,108,0,118,384,0
6730,116051,2Vr8sMi8Nmtw7GvPlYj3ww9EzMgjDWh8,3VkHkmOtom3jM2wCu94xgzzu1d6Dn7or,55,384,157,135,0,91,47,3,817,116.71428571428571,15,0.0,127,157,129,0,257,91,6,47,3,413,404,0
6731,116065,q3JtZXXZMqccVupi0pRwWulRNmYHs0DU,3VkHkmOtom3jM2wCu94xgzzu1d6Dn7or,65,204,56,112,70,47,63,0,552,78.85714285714286,13,0.0,121,56,103,70,83,47,9,63,0,350,202,0
6732,116067,6XukKNVATWF9MVOxuIEZEYJF6xf5Cg9L,3VkHkmOtom3jM2wCu94xgzzu1d6Dn7or,4,2,1,0,1,2,1,0,7,1.0,1,0.0,0,1,0,1,2,2,0,1,0,2,5,1
6733,116070,JzTk3xaabrBX5386TjKA3UueO1OK5zNz,3VkHkmOtom3jM2wCu94xgzzu1d6Dn7or,21,26,14,0,8,5,19,4,76,10.857142857142858,2,0.0,0,14,0,8,26,5,0,19,4,22,54,0
6734,116075,VL7NPBJuyzF1uV3nhlsl7JEimjvq8BIB,3VkHkmOtom3jM2wCu94xgzzu1d6Dn7or,1,0,0,0,0,0,1,0,1,0.14285714285714285,1,0.0,0,0,0,0,0,0,0,1,0,0,1,0
6735,116082,9blpGGkQJZFtg7dx6hi9jS54S4JlZMi3,3VkHkmOtom3jM2wCu94xgzzu1d6Dn7or,1,0,0,0,0,0,1,0,1,0.14285714285714285,1,0.0,0,0,0,0,0,0,0,1,0,0,1,1
6736,116153,UgNROyPwf2puAAYe5Yv1ptkL2wZcADTj,3VkHkmOtom3jM2wCu94xgzzu1d6Dn7or,7,7,1,0,2,0,2,0,12,1.7142857142857142,1,0.0,0,1,0,2,7,0,0,2,0,3,9,1
6737,116158,FnqofvxX1Fkh4U7sknKRg4FXxgFJOsei,3VkHkmOtom3jM2wCu94xgzzu1d6Dn7or,1,0,0,0,0,0,1,0,1,0.14285714285714285,1,0.0,0,0,0,0,0,0,0,1,0,0,1,1
6738,116162,7hlZm60MDNLIaepou32eDBEODr724DEp,3VkHkmOtom3jM2wCu94xgzzu1d6Dn7or,1,0,0,0,0,0,2,0,2,0.2857142857142857,1,0.0,0,0,0,0,0,0,0,2,0,0,2,1
6739,116178,CoR4GSkh8XL90hvoWCPPEYiv8I3i4fcv,3VkHkmOtom3jM2wCu94xgzzu1d6Dn7or,4,2,1,0,0,0,2,0,5,0.7142857142857143,1,0.0,0,1,0,0,2,0,0,2,0,1,4,1
6740,116226,0w6TZDemFr3UzefPBzp6wf3wfI9EhHXJ,3VkHkmOtom3jM2wCu94xgzzu1d6Dn7or,21,20,12,24,8,2,7,0,73,10.428571428571429,4,0.0,5,12,20,8,15,2,4,7,0,45,28,0
6741,116229,IZjvzkwq6mW6mk7nIYbEArtjalxzWdW9,3VkHkmOtom3jM2wCu94xgzzu1d6Dn7or,90,118,42,75,35,20,16,0,306,43.714285714285715,4,0.0,50,42,65,35,68,20,10,16,0,192,114,1
6742,116282,8oUoNRigM4DbP8VijtlZv0utnSLvvpbA,3VkHkmOtom3jM2wCu94xgzzu1d6Dn7or,2,0,0,0,0,0,8,0,8,1.1428571428571428,4,0.0,0,0,0,0,0,0,0,8,0,0,8,0
6743,116297,03dVzxLI1AumV0kSjoDxUD9fYstLoIRm,3VkHkmOtom3jM2wCu94xgzzu1d6Dn7or,42,106,55,53,0,29,26,2,271,38.714285714285715,3,0.0,43,55,49,0,63,29,4,26,2,147,124,0
6744,116314,nYSFDE8RCbcZhD46fRSvPHUvA1ahfupi,3VkHkmOtom3jM2wCu94xgzzu1d6Dn7or,1,0,0,0,0,0,3,0,3,0.42857142857142855,1,0.0,0,0,0,0,0,0,0,3,0,0,3,0
6745,116315,D6BGxPd6VwQSrpRVLn8xLb1v6G3wH0MZ,3VkHkmOtom3jM2wCu94xgzzu1d6Dn7or,2,0,0,0,0,0,3,0,3,0.42857142857142855,2,0.0,0,0,0,0,0,0,0,3,0,0,3,1
6746,116392,fq9F4eLKGaYaKqdsBCYkrbRtYIz2HNWS,3VkHkmOtom3jM2wCu94xgzzu1d6Dn7or,15,37,9,15,9,1,6,0,77,11.0,3,0.0,10,9,11,9,27,1,4,6,0,39,38,1
6747,116407,FbdmHwhDtQoDvNNbH5NO4UO0Yhp01nUq,5Gyp41oLVo7Gg7vF4vpmggWP5MU70QO6,30,143,79,4,52,0,29,0,307,43.857142857142854,5,0.0,35,79,2,52,108,0,2,29,0,168,139,0
6748,116408,2AWz8OiYqJqT0VYmevCkAuxaVCSl88oB,5Gyp41oLVo7Gg7vF4vpmggWP5MU70QO6,15,32,18,0,12,1,7,1,71,10.142857142857142,5,0.0,1,18,0,12,31,1,0,7,1,31,40,1
6749,116417,7A1GCwEWpHROkWEfhD1PlzLhzB5NHb1O,5Gyp41oLVo7Gg7vF4vpmggWP5MU70QO6,7,3,2,0,2,0,2,0,9,1.2857142857142858,1,0.0,0,2,0,2,3,0,0,2,0,4,5,1
6750,116465,KogrHROquIJLSXIZqzhYU9Hcb9zVebwT,5Gyp41oLVo7Gg7vF4vpmggWP5MU70QO6,9,11,3,0,3,0,4,0,21,3.0,4,0.0,2,3,0,3,9,0,0,4,0,8,13,1
6751,116485,T760lHQ0RpxOvFjMkGLgsnuQEwsq9PjS,5Gyp41oLVo7Gg7vF4vpmggWP5MU70QO6,1,0,0,0,0,0,1,0,1,0.14285714285714285,1,0.0,0,0,0,0,0,0,0,1,0,0,1,1
6752,116500,2N6o6qJ0czxrbv8wbXwP5oVT4Ra8mOYu,5Gyp41oLVo7Gg7vF4vpmggWP5MU70QO6,1,0,0,0,0,0,4,0,4,0.5714285714285714,2,0.0,0,0,0,0,0,0,0,4,0,0,4,1
6753,116525,UaIcSFKSsXMkLJoEB18mPucIS2F5HMZt,5Gyp41oLVo7Gg7vF4vpmggWP5MU70QO6,29,94,47,25,28,23,17,0,234,33.42857142857143,9,0.0,35,47,18,28,59,23,7,17,0,128,106,0
6754,116563,4mJTMdBQXf0FLkWkpNUKeQduXoe3aC6K,5Gyp41oLVo7Gg7vF4vpmggWP5MU70QO6,5,2,1,0,1,0,4,0,8,1.1428571428571428,1,0.0,0,1,0,1,2,0,0,4,0,2,6,1
6755,116568,cXYqUXWJSTT7g3JkZOD6VVFxaOdV583i,5Gyp41oLVo7Gg7vF4vpmggWP5MU70QO6,34,119,70,5,19,2,39,4,258,36.857142857142854,5,0.0,28,70,4,19,91,2,1,39,4,121,137,1
6756,116579,QowyHsfHFUaEx1YaRDDC0R4vC3JBlmP0,5Gyp41oLVo7Gg7vF4vpmggWP5MU70QO6,9,5,3,0,2,0,3,1,14,2.0,1,0.0,1,3,0,2,4,0,0,3,1,6,8,1
6757,116583,TSwyBREzLotMzg2Iw5PjRsD2LWDfzOVi,5Gyp41oLVo7Gg7vF4vpmggWP5MU70QO6,25,46,24,27,10,34,13,1,155,22.142857142857142,3,0.0,12,24,18,10,34,34,9,13,1,64,91,0
6758,116585,BMt1sMJKW8lUV5XsrUOWqq2qoU33TZEw,5Gyp41oLVo7Gg7vF4vpmggWP5MU70QO6,9,12,6,0,2,0,2,0,22,3.142857142857143,1,0.0,1,6,0,2,11,0,0,2,0,9,13,1
6759,116601,6AFt8yaUkyVNpqQJOaGl7qwUgbH5JqKc,5Gyp41oLVo7Gg7vF4vpmggWP5MU70QO6,18,39,17,8,13,1,8,0,86,12.285714285714286,2,0.0,21,17,4,13,18,1,4,8,0,55,31,1
6760,116618,6TmTcNQyMYVAXbtK6HsQ96Mn7OGENU3z,5Gyp41oLVo7Gg7vF4vpmggWP5MU70QO6,7,4,3,0,3,0,2,0,12,1.7142857142857142,1,0.0,0,3,0,3,4,0,0,2,0,6,6,0
6761,116627,XYBLB5vnJS2TawgpFm2PqudALg5wF8Kg,5Gyp41oLVo7Gg7vF4vpmggWP5MU70QO6,1,0,0,0,0,0,1,0,1,0.14285714285714285,1,0.0,0,0,0,0,0,0,0,1,0,0,1,1
6762,116646,lxKYdDOq1adV5jGN5i0lYRRTeDyNW3Hr,5Gyp41oLVo7Gg7vF4vpmggWP5MU70QO6,46,238,146,49,9,683,62,5,1192,170.28571428571428,21,0.0,50,146,25,9,188,683,24,62,5,230,962,0
6763,116656,IDyO5Qr8w2rNSDKNwQkfLYbF0UjXTHLz,5Gyp41oLVo7Gg7vF4vpmggWP5MU70QO6,19,27,10,16,8,0,4,0,65,9.285714285714286,4,0.0,12,10,8,8,15,0,8,4,0,38,27,0
6764,116690,zJY0yOGJGPWV8ealRZ1xpBJyPwZpwm0y,5Gyp41oLVo7Gg7vF4vpmggWP5MU70QO6,1,0,0,0,0,0,1,0,1,0.14285714285714285,1,0.0,0,0,0,0,0,0,0,1,0,0,1,1
6765,116695,XYKEbaRABcMuBHmMB2I3YkBepzCp0swB,5Gyp41oLVo7Gg7vF4vpmggWP5MU70QO6,36,114,9,22,18,137,20,0,320,45.714285714285715,16,0.0,21,9,19,18,93,137,3,20,0,67,253,0
6766,116700,ULHb24x7E8rtGbCKyM1P4nt2HiX2afa3,5Gyp41oLVo7Gg7vF4vpmggWP5MU70QO6,5,2,1,0,1,0,3,0,7,1.0,1,0.0,0,1,0,1,2,0,0,3,0,2,5,1
6767,116703,WMUAVPy5nfF78EeZwI6Q7YdOMfqjaE1q,5Gyp41oLVo7Gg7vF4vpmggWP5MU70QO6,2,0,0,0,0,0,2,0,2,0.2857142857142857,1,0.0,0,0,0,0,0,0,0,2,0,0,2,1
6768,116711,3ZjYCc5MLjmqQO8I0BbV7xsRs5qoWXrX,5Gyp41oLVo7Gg7vF4vpmggWP5MU70QO6,11,23,12,0,8,0,7,0,50,7.142857142857143,4,0.0,4,12,0,8,19,0,0,7,0,24,26,0
6769,116734,BoXSuGXDZEH8EQNVPHOVOXaNZkjSq3cI,5Gyp41oLVo7Gg7vF4vpmggWP5MU70QO6,1,0,0,0,0,0,1,0,1,0.14285714285714285,1,0.0,0,0,0,0,0,0,0,1,0,0,1,1
6770,116757,BxboaJOjL0lutiA0WAavvZGy50ryt6dU,5Gyp41oLVo7Gg7vF4vpmggWP5MU70QO6,36,54,31,40,9,30,7,0,171,24.428571428571427,5,0.0,15,31,31,9,39,30,9,7,0,86,85,1
6771,116781,kJKPmsgnAo2a0lGHjzSIUIt3KbVa9yEm,5Gyp41oLVo7Gg7vF4vpmggWP5MU70QO6,8,4,2,0,2,0,2,0,10,1.4285714285714286,1,0.0,0,2,0,2,4,0,0,2,0,4,6,0
6772,116802,9TscsuxCtaNqXywaQXQeXHji1tYxcqIS,5Gyp41oLVo7Gg7vF4vpmggWP5MU70QO6,6,5,2,0,0,0,4,0,11,1.5714285714285714,3,0.0,0,2,0,0,5,0,0,4,0,2,9,1
6773,116804,3uU9hzp6POZeWb9TkpjJweQiyjZgKmLY,5Gyp41oLVo7Gg7vF4vpmggWP5MU70QO6,10,28,5,2,1,11,7,0,54,7.714285714285714,2,0.0,9,5,1,1,19,11,1,7,0,16,38,1
6774,116808,vdP2KzIF3CpofXr5k7RfTY3XkM0wS3qY,5Gyp41oLVo7Gg7vF4vpmggWP5MU70QO6,17,40,16,10,7,14,13,3,103,14.714285714285714,4,0.0,9,16,7,7,31,14,3,13,3,39,64,0
6775,116818,0LSuujEhRDqXVIY1bmT0rfkeWeUk8Hxd,5Gyp41oLVo7Gg7vF4vpmggWP5MU70QO6,6,1,1,0,1,0,3,0,6,0.8571428571428571,1,0.0,0,1,0,1,1,0,0,3,0,2,4,1
6776,116833,CJISoHtkGNnkB0CRrvBDw2uUj4sPNv5j,5Gyp41oLVo7Gg7vF4vpmggWP5MU70QO6,2,0,0,0,0,0,2,0,2,0.2857142857142857,1,0.0,0,0,0,0,0,0,0,2,0,0,2,1
6777,116847,c8TFm45r0bfBe26eBlEeUAKDBoTJT9yV,5Gyp41oLVo7Gg7vF4vpmggWP5MU70QO6,41,50,29,1,13,1,11,1,106,15.142857142857142,5,0.0,8,29,1,13,42,1,0,11,1,51,55,1
6778,116848,Xdurokd2SSgNf25hifq07OxoiHEDcyiq,5Gyp41oLVo7Gg7vF4vpmggWP5MU70QO6,5,3,2,0,0,0,2,0,7,1.0,1,0.0,0,2,0,0,3,0,0,2,0,2,5,1
6779,116860,MbB5RCe5n2jb2LHuR2EVxJKj3yTz460S,5Gyp41oLVo7Gg7vF4vpmggWP5MU70QO6,2,0,0,0,0,0,2,0,2,0.2857142857142857,1,0.0,0,0,0,0,0,0,0,2,0,0,2,1
6780,116872,HIaaOq9UrLvo3UC4FIJStVsYhdTvdkJ9,5Gyp41oLVo7Gg7vF4vpmggWP5MU70QO6,3,3,0,0,0,0,1,0,4,0.5714285714285714,1,0.0,0,0,0,0,3,0,0,1,0,0,4,1
6781,116885,RuAmBkKx2yGGe0I63ZT9zLq0egXER5uf,5Gyp41oLVo7Gg7vF4vpmggWP5MU70QO6,1,0,0,0,0,0,1,0,1,0.14285714285714285,1,0.0,0,0,0,0,0,0,0,1,0,0,1,1
6782,116888,Wh8hCdMajmbQYRdk0kC3itffbAwh1ipD,5Gyp41oLVo7Gg7vF4vpmggWP5MU70QO6,8,3,2,0,2,0,4,0,11,1.5714285714285714,1,0.0,0,2,0,2,3,0,0,4,0,4,7,1
6783,116891,xnjBe3q3IPnwGwUqh4nt5DYbmFucWMBn,5Gyp41oLVo7Gg7vF4vpmggWP5MU70QO6,1,0,0,0,0,0,1,0,1,0.14285714285714285,1,0.0,0,0,0,0,0,0,0,1,0,0,1,0
6784,116911,yPANNiQQMnN6yMtp5OhnGyYLdZrKDZ9V,5Gyp41oLVo7Gg7vF4vpmggWP5MU70QO6,7,6,2,0,5,0,3,0,16,2.2857142857142856,1,0.0,3,2,0,5,3,0,0,3,0,10,6,1
6785,116916,8xQNB57dWwxSgB7Cdmu4JTHSbpW9JnZk,5Gyp41oLVo7Gg7vF4vpmggWP5MU70QO6,7,8,4,0,1,0,3,0,16,2.2857142857142856,2,0.0,0,4,0,1,8,0,0,3,0,5,11,1
6786,116919,CWDKRVVm01sfgssULmzIPwx9dbULLbqB,5Gyp41oLVo7Gg7vF4vpmggWP5MU70QO6,51,115,60,65,21,0,19,0,280,40.0,11,0.0,34,60,54,21,81,0,11,19,0,169,111,0
6787,116939,Usfkocwm4lSZYVvNYLfyY0NGVEBUaZqO,5Gyp41oLVo7Gg7vF4vpmggWP5MU70QO6,1,0,0,0,0,0,1,0,1,0.14285714285714285,1,0.0,0,0,0,0,0,0,0,1,0,0,1,1
6788,116947,uRoRagoJb7klyYml2W2nJUADMGnmCLCh,5Gyp41oLVo7Gg7vF4vpmggWP5MU70QO6,1,0,0,0,0,0,1,0,1,0.14285714285714285,1,0.0,0,0,0,0,0,0,0,1,0,0,1,0
6789,116980,I2ghGumCKIaVsnJOGZA0xyJzTnEm5KtW,5Gyp41oLVo7Gg7vF4vpmggWP5MU70QO6,37,69,46,14,11,23,20,8,191,27.285714285714285,10,0.0,8,46,11,11,61,23,3,20,8,76,115,1
6790,117008,2DccYKlqpoQf6OVf4P499VuvWPHZoTTu,5Gyp41oLVo7Gg7vF4vpmggWP5MU70QO6,14,29,11,0,9,0,4,0,53,7.571428571428571,2,0.0,4,11,0,9,25,0,0,4,0,24,29,1
6791,117023,ADL0cXowUMs4wyiAOHKMOrtTHu5tmUqi,5Gyp41oLVo7Gg7vF4vpmggWP5MU70QO6,15,47,19,1,11,9,28,3,118,16.857142857142858,11,0.0,9,19,1,11,38,9,0,28,3,40,78,0
6792,117041,9SuXYl1IjiZODU1TMPwvrrvK6owZlUNe,5Gyp41oLVo7Gg7vF4vpmggWP5MU70QO6,1,0,0,0,0,0,1,0,1,0.14285714285714285,1,0.0,0,0,0,0,0,0,0,1,0,0,1,1
6793,117063,9b2fchNyVZPjqpmxjleqzL9edi9EOH23,5Gyp41oLVo7Gg7vF4vpmggWP5MU70QO6,10,8,3,0,1,2,10,2,26,3.7142857142857144,3,0.0,4,3,0,1,4,2,0,10,2,8,18,1
6794,117065,WUAnxOxSR8pysjIM781IoAjfv22J6fXT,5Gyp41oLVo7Gg7vF4vpmggWP5MU70QO6,1,0,0,0,0,0,1,0,1,0.14285714285714285,1,0.0,0,0,0,0,0,0,0,1,0,0,1,1
6795,117089,QyLVPf4M60EkZ1E7DsOzioCPS0UDQt1T,5Gyp41oLVo7Gg7vF4vpmggWP5MU70QO6,1,0,1,0,0,0,0,0,1,0.14285714285714285,1,0.0,0,1,0,0,0,0,0,0,0,1,0,1
6796,117095,fzJt7cMbQdDsYbjvGumpSBsSoIPDPhLX,5Gyp41oLVo7Gg7vF4vpmggWP5MU70QO6,1,0,0,0,0,0,1,0,1,0.14285714285714285,1,0.0,0,0,0,0,0,0,0,1,0,0,1,1
6797,117107,W5WXdjEPXec3kWgxusS4TQK5qUCtW9Gr,5Gyp41oLVo7Gg7vF4vpmggWP5MU70QO6,8,9,4,0,2,0,5,0,20,2.857142857142857,1,0.0,0,4,0,2,9,0,0,5,0,6,14,1
6798,117121,YkDfLiDseHtCR7dJh5rdSPT60rVAbQA9,5Gyp41oLVo7Gg7vF4vpmggWP5MU70QO6,2,0,0,0,0,0,2,0,2,0.2857142857142857,1,0.0,0,0,0,0,0,0,0,2,0,0,2,1
6799,117123,3sb6dkTzjyaoPHIVxOcX6QurrsU6bA7l,5Gyp41oLVo7Gg7vF4vpmggWP5MU70QO6,1,0,0,0,0,0,1,0,1,0.14285714285714285,1,0.0,0,0,0,0,0,0,0,1,0,0,1,1
6800,117135,3lgijIek2SmmNtHkgDCJTbZxGPkqedht,5Gyp41oLVo7Gg7vF4vpmggWP5MU70QO6,8,4,2,0,1,6,8,0,21,3.0,2,0.0,0,2,0,1,4,6,0,8,0,3,18,1
6801,117138,PHRCx9wyKQjGXWbcIfUScN2q5ez7aVqM,5Gyp41oLVo7Gg7vF4vpmggWP5MU70QO6,10,15,8,0,4,0,4,0,31,4.428571428571429,2,0.0,2,8,0,4,13,0,0,4,0,14,17,1
6802,117156,NbVCWnNRkOvejswZDVYPJBSUeg9KlOhj,5Gyp41oLVo7Gg7vF4vpmggWP5MU70QO6,1,0,0,0,0,0,1,0,1,0.14285714285714285,1,0.0,0,0,0,0,0,0,0,1,0,0,1,1
6803,117165,IhZdPOtOeXyg0OwsQIkD0XHc4IVBLzMp,5Gyp41oLVo7Gg7vF4vpmggWP5MU70QO6,10,6,3,0,3,2,8,0,22,3.142857142857143,3,0.0,1,3,0,3,5,2,0,8,0,7,15,1
6804,117180,bxhBGxneaqGOWkm51njJK4ynLGNp1dFr,5Gyp41oLVo7Gg7vF4vpmggWP5MU70QO6,1,0,0,0,0,0,1,0,1,0.14285714285714285,1,0.0,0,0,0,0,0,0,0,1,0,0,1,1
6805,117185,GNXJ3DgKpOCI8ASwOajRaheU6QheqqG0,5Gyp41oLVo7Gg7vF4vpmggWP5MU70QO6,1,0,0,0,0,0,1,0,1,0.14285714285714285,1,0.0,0,0,0,0,0,0,0,1,0,0,1,1
6806,117222,gSg4PIaWl0hBhOgVlpN9o8YrQn4pTOeq,5Gyp41oLVo7Gg7vF4vpmggWP5MU70QO6,1,0,0,0,0,0,1,0,1,0.14285714285714285,1,0.0,0,0,0,0,0,0,0,1,0,0,1,0
6807,117224,rT1OrFQC18rdvYkTGYqwRgC7eDvihHsc,5Gyp41oLVo7Gg7vF4vpmggWP5MU70QO6,21,37,24,0,12,0,12,0,85,12.142857142857142,8,0.0,1,24,0,12,36,0,0,12,0,37,48,1
6808,117227,8qABUnBBHxxZkfUhEQNUn5NNMSRrqvPC,5Gyp41oLVo7Gg7vF4vpmggWP5MU70QO6,15,42,24,0,0,1,12,2,81,11.571428571428571,1,0.0,15,24,0,0,27,1,0,12,2,39,42,1
6809,117255,VQRCM2WfTOxPVqL1wfHrLv0YRxF7pqR5,5Gyp41oLVo7Gg7vF4vpmggWP5MU70QO6,7,2,2,0,1,0,3,0,8,1.1428571428571428,1,0.0,0,2,0,1,2,0,0,3,0,3,5,1
6810,117262,E9LvqT83AyaleYfbFG9vVblj5qFDj4pH,5Gyp41oLVo7Gg7vF4vpmggWP5MU70QO6,1,0,0,0,0,0,1,0,1,0.14285714285714285,1,0.0,0,0,0,0,0,0,0,1,0,0,1,1
6811,117272,eN3Zet0tDUonovGa1sjqSTY5JzjDSKDq,5Gyp41oLVo7Gg7vF4vpmggWP5MU70QO6,1,0,0,0,0,0,1,0,1,0.14285714285714285,1,0.0,0,0,0,0,0,0,0,1,0,0,1,0
6812,117283,cwi1EqbseaNkWdLsJKfCfX0do77ptlsN,5Gyp41oLVo7Gg7vF4vpmggWP5MU70QO6,5,2,1,0,1,0,2,0,6,0.8571428571428571,1,0.0,0,1,0,1,2,0,0,2,0,2,4,1
6813,117294,qI10Bv6M8yDADmXGFHo8Ci0xEtFKxZnK,5Gyp41oLVo7Gg7vF4vpmggWP5MU70QO6,1,0,0,0,0,0,1,0,1,0.14285714285714285,1,0.0,0,0,0,0,0,0,0,1,0,0,1,1
6814,117306,XDhMhAgbTguQNFGPykY6IJEQSl3DEa3i,5Gyp41oLVo7Gg7vF4vpmggWP5MU70QO6,1,0,0,0,0,0,1,0,1,0.14285714285714285,1,0.0,0,0,0,0,0,0,0,1,0,0,1,1
6815,117307,0TVIMteBCisXYqQmhAVCzijts3EjTj9F,5Gyp41oLVo7Gg7vF4vpmggWP5MU70QO6,14,11,6,2,6,0,8,0,33,4.714285714285714,3,0.0,4,6,1,6,7,0,1,8,0,17,16,0
6816,117312,Ys9Sq9z0Ayx7HAA2bEWIYOIRrgTfYson,5Gyp41oLVo7Gg7vF4vpmggWP5MU70QO6,5,2,1,0,1,0,2,0,6,0.8571428571428571,1,0.0,0,1,0,1,2,0,0,2,0,2,4,1
6817,117313,AOjqu8OTCPaKqT40dsKKHuXenHhl1lM6,5Gyp41oLVo7Gg7vF4vpmggWP5MU70QO6,8,6,4,0,3,0,4,0,17,2.4285714285714284,2,0.0,0,4,0,3,6,0,0,4,0,7,10,1
6818,117319,BvJFDLjt3ftWMc7x9UAbMlTnLGgBI3OG,5Gyp41oLVo7Gg7vF4vpmggWP5MU70QO6,11,20,0,0,0,8,3,0,31,4.428571428571429,2,0.0,0,0,0,0,20,8,0,3,0,0,31,1
6819,117325,UCVAz5InEePYpw1xYZPlWtu2UGJ8pFLc,5Gyp41oLVo7Gg7vF4vpmggWP5MU70QO6,7,2,1,0,1,0,6,2,12,1.7142857142857142,1,0.0,0,1,0,1,2,0,0,6,2,2,10,1
6820,117346,5tL0goZ0bMjNeuGHJZ9VZymSM6PzqaXn,5Gyp41oLVo7Gg7vF4vpmggWP5MU70QO6,1,0,0,0,0,0,2,0,2,0.2857142857142857,2,0.0,0,0,0,0,0,0,0,2,0,0,2,1
6821,117356,BEpwi711y09XyC4DFTNZ8NMJ5PwUJeE1,fbPkOYLVPtPgIt0MxizjfFJov3JbHyAi,24,57,28,16,4,25,19,1,150,21.428571428571427,4,0.0,6,28,14,4,51,25,2,19,1,52,98,0
6822,117394,x61GVEFoUQZEIHnVsxBCw0kitfDOhP0p,fbPkOYLVPtPgIt0MxizjfFJov3JbHyAi,16,17,8,0,6,0,1,0,32,4.571428571428571,1,0.0,7,8,0,6,10,0,0,1,0,21,11,1
6823,117404,C89edYjc0egHm9DK0UhG6TICXc3cgfYt,fbPkOYLVPtPgIt0MxizjfFJov3JbHyAi,4,3,1,0,0,0,1,0,5,0.7142857142857143,1,0.0,0,1,0,0,3,0,0,1,0,1,4,1
6824,117416,no2ug7TKVsupL4LU2a5jY2GhYHkskTdw,fbPkOYLVPtPgIt0MxizjfFJov3JbHyAi,4,4,3,0,0,0,1,0,8,1.1428571428571428,1,0.0,0,3,0,0,4,0,0,1,0,3,5,1
6825,117423,NXEwBXbU6vvce77sujWgRB6LivhFJvRb,fbPkOYLVPtPgIt0MxizjfFJov3JbHyAi,10,9,7,4,6,0,1,0,27,3.857142857142857,1,0.0,1,7,3,6,8,0,1,1,0,17,10,1
6826,117487,UvYdE00Z5Ts8a6wK0WxKxxpGT2cAkrRh,fbPkOYLVPtPgIt0MxizjfFJov3JbHyAi,7,5,3,1,1,0,1,0,11,1.5714285714285714,1,0.0,1,3,1,1,4,0,0,1,0,6,5,0
6827,117509,ydSu1htsBf3RzcwY9UTcwNk58kfOh1CK,SpATywNh6bZuzm8s1ceuBUnMUAeoAHHw,11,20,1,6,0,0,1,0,28,4.0,1,0.0,2,1,5,0,18,0,1,1,0,8,20,0
6828,117536,f07Kut7kBpGHis5iRAbMzHKfd6CS5vLr,A3fsA9Zfv1X2fVEQhTw51lKENdNrEqT3,13,21,15,2,0,63,9,0,110,15.714285714285714,2,0.0,1,15,1,0,20,63,1,9,0,17,93,0
6829,117552,wKSiPD3ccCI47tDYWhx56Wd2BJP8ki2L,SpATywNh6bZuzm8s1ceuBUnMUAeoAHHw,12,14,2,4,2,8,4,0,34,4.857142857142857,3,0.0,0,2,4,2,14,8,0,4,0,8,26,0
6830,117557,Z9nbZek76s4RBuA56w1WtME3e9ClZkaP,SpATywNh6bZuzm8s1ceuBUnMUAeoAHHw,20,14,11,13,8,22,4,2,74,10.571428571428571,1,0.0,2,11,10,8,12,22,3,4,2,31,43,0
6831,117561,ADL0cXowUMs4wyiAOHKMOrtTHu5tmUqi,A3fsA9Zfv1X2fVEQhTw51lKENdNrEqT3,1,0,0,0,0,0,3,0,3,0.42857142857142855,1,0.0,0,0,0,0,0,0,0,3,0,0,3,0
6832,117563,W5xQOH5MemwXn7klqn6rjd1MM4WzuzQi,SpATywNh6bZuzm8s1ceuBUnMUAeoAHHw,18,15,8,10,5,0,1,0,39,5.571428571428571,1,0.0,6,8,9,5,9,0,1,1,0,28,11,0
6833,117564,ADL0cXowUMs4wyiAOHKMOrtTHu5tmUqi,5X6FeZozNMgE2VRi3MJYjkkFK8SETtu2,18,16,7,10,5,2,12,1,53,7.571428571428571,5,0.0,5,7,10,5,11,2,0,12,1,27,26,1
6834,117602,BcsAFxTYYWhC1bNDfK977UfoS17oCWvP,SpATywNh6bZuzm8s1ceuBUnMUAeoAHHw,14,13,0,11,0,2,3,0,29,4.142857142857143,2,0.0,2,0,9,0,11,2,2,3,0,11,18,0
6835,117611,BbvGM92sGSMMIrRMXDFdD1GEnySzXRYT,SpATywNh6bZuzm8s1ceuBUnMUAeoAHHw,11,22,2,0,2,0,4,0,30,4.285714285714286,2,0.0,0,2,0,2,22,0,0,4,0,4,26,0
6836,117616,GLClE8eg40BpWvmEfcSMwSvtSTOkzETn,SpATywNh6bZuzm8s1ceuBUnMUAeoAHHw,19,25,2,25,0,0,4,0,56,8.0,3,0.0,9,2,23,0,16,0,2,4,0,34,22,0
6837,117662,1ujJ0EpnNLNXPSSRc7XEx7I0RReWnlus,SpATywNh6bZuzm8s1ceuBUnMUAeoAHHw,8,7,1,3,0,0,1,0,12,1.7142857142857142,1,0.0,0,1,3,0,7,0,0,1,0,4,8,1
6838,117669,3xN41ERTxK2f1CGWRDLSjBdLqp0aeXRu,SpATywNh6bZuzm8s1ceuBUnMUAeoAHHw,16,22,1,23,1,17,7,2,73,10.428571428571429,2,0.0,8,1,20,1,14,17,3,7,2,30,43,1
6839,117703,70SrKRY1oWl5d62cNgc8OZe8Ra3cen1a,SpATywNh6bZuzm8s1ceuBUnMUAeoAHHw,13,14,0,0,0,0,5,0,19,2.7142857142857144,2,0.0,2,0,0,0,12,0,0,5,0,2,17,0
6840,117730,ZRcEnEYSSBQbkjzMu7sidjbxasfrmw8l,A3fsA9Zfv1X2fVEQhTw51lKENdNrEqT3,32,25,13,72,0,0,4,0,114,16.285714285714285,2,0.0,3,13,63,0,22,0,9,4,0,79,35,0
6841,117776,8EDi9ELIY5NaafGr5ul94OArAKYSlPLk,SpATywNh6bZuzm8s1ceuBUnMUAeoAHHw,13,13,7,14,2,0,6,0,42,6.0,2,0.0,2,7,12,2,11,0,2,6,0,23,19,0
6842,117782,usFuTvFQpKrRjDwn3CiAVcIq4WWtoKl0,RXDvfPUBYFlVdlueBFbLW0mhhAyGEqpt,37,25,17,48,13,6,8,0,117,16.714285714285715,3,0.0,4,17,45,13,21,6,3,8,0,79,38,0
6843,117796,2HxuGhGQGzCNLHdg582isvj2k1uv2pCi,SpATywNh6bZuzm8s1ceuBUnMUAeoAHHw,8,13,1,0,1,1,1,0,17,2.4285714285714284,1,0.0,3,1,0,1,10,1,0,1,0,5,12,0
6844,117838,E6GtLgX3I7VGOpV74LvaV5V5J9ND1jUQ,SpATywNh6bZuzm8s1ceuBUnMUAeoAHHw,6,4,2,0,1,0,1,0,8,1.1428571428571428,1,0.0,0,2,0,1,4,0,0,1,0,3,5,1
6845,117865,57P5UbCfzn8GLpyzVkqMDPp8kp3hFIaz,bWdj2GDclj5ofokWjzoa5jAwMkxCykd6,9,14,3,0,1,0,2,0,20,2.857142857142857,1,0.0,0,3,0,1,14,0,0,2,0,4,16,1
6846,117907,Z3bFvTwttDZ4bCfkqeyPSBE9NPAPKPqN,SpATywNh6bZuzm8s1ceuBUnMUAeoAHHw,7,13,0,0,0,0,1,0,14,2.0,1,0.0,2,0,0,0,11,0,0,1,0,2,12,0
6847,117908,hDWTDNoM8bIQS3Q25EYxxHniqW2wmxDn,5X6FeZozNMgE2VRi3MJYjkkFK8SETtu2,9,19,4,10,3,0,2,0,38,5.428571428571429,1,0.0,7,4,9,3,12,0,1,2,0,23,15,1
6848,117910,QtoTN2OyyTcqe6Us4ENFLFoSg3hJkA40,SpATywNh6bZuzm8s1ceuBUnMUAeoAHHw,18,29,2,19,1,9,10,0,70,10.0,2,0.0,7,2,15,1,22,9,4,10,0,25,45,0
6849,117920,Tsqz3H4jIOz4dWir6zrZDbKSFYTGo0K7,G8EPVSXsOYB5YQWZGiz1aVq5Pgr2GrQu,13,30,2,22,4,1,7,1,67,9.571428571428571,2,0.0,10,2,20,4,20,1,2,7,1,36,31,0
6850,117927,M45J6fNUaggda3LzoFU6r4v9Do7R8HkV,bWdj2GDclj5ofokWjzoa5jAwMkxCykd6,21,55,26,4,9,9,11,0,114,16.285714285714285,4,0.0,15,26,3,9,40,9,1,11,0,53,61,0
6851,117931,2FyRSMemMx0WQNXDNdLObUL8ox2VWXod,G8EPVSXsOYB5YQWZGiz1aVq5Pgr2GrQu,1,0,0,0,0,0,1,0,1,0.14285714285714285,1,0.0,0,0,0,0,0,0,0,1,0,0,1,1
6852,117940,JYCXGTBUXKAgLYAuYSVkBAkWpoJ7TYUE,G8EPVSXsOYB5YQWZGiz1aVq5Pgr2GrQu,11,16,12,0,2,6,7,0,43,6.142857142857143,3,0.0,1,12,0,2,15,6,0,7,0,15,28,0
6853,117946,yXqCA1yQnzskdA15yvjJGzN0ZJtznFpO,RXDvfPUBYFlVdlueBFbLW0mhhAyGEqpt,19,43,6,32,4,0,12,0,97,13.857142857142858,2,0.0,6,6,32,4,37,0,0,12,0,48,49,1
6854,117948,1AlOrbJ2y8dS4ycbJ2sP2OTCfMGEqZ01,SpATywNh6bZuzm8s1ceuBUnMUAeoAHHw,5,12,4,0,3,3,2,0,24,3.4285714285714284,2,0.0,0,4,0,3,12,3,0,2,0,7,17,0
6855,117954,jFYWygr5nLqLhHkXltZRkT0S1zQoLEVR,SpATywNh6bZuzm8s1ceuBUnMUAeoAHHw,19,13,8,12,5,0,2,0,40,5.714285714285714,1,0.0,2,8,11,5,11,0,1,2,0,26,14,0
6856,117963,YMxXtA5A6XX1bdm998q3OXZqnuIpo8I0,5X6FeZozNMgE2VRi3MJYjkkFK8SETtu2,1,0,0,0,0,0,1,0,1,0.14285714285714285,1,0.0,0,0,0,0,0,0,0,1,0,0,1,1
6857,118043,ZfEmNtZnnnOMQU2ZxafVmay1LudDsU5A,bWdj2GDclj5ofokWjzoa5jAwMkxCykd6,5,3,1,0,1,0,1,0,6,0.8571428571428571,1,0.0,0,1,0,1,3,0,0,1,0,2,4,0
6858,118051,PHrtg3UspIdS1qc6Vp5GAq4YFnlF3cc7,G8EPVSXsOYB5YQWZGiz1aVq5Pgr2GrQu,6,7,4,6,3,0,0,0,20,2.857142857142857,2,0.0,3,4,4,3,4,0,2,0,0,14,6,1
6859,118068,pXBqbLwIa6tUreJmexqQxucHgaflXECZ,5X6FeZozNMgE2VRi3MJYjkkFK8SETtu2,2,0,0,0,0,0,2,0,2,0.2857142857142857,1,0.0,0,0,0,0,0,0,0,2,0,0,2,1
6860,118070,nqDX1tmEeTnbqCn9T8Crn5CYQgmIy9Eq,RXDvfPUBYFlVdlueBFbLW0mhhAyGEqpt,9,11,9,0,0,12,4,0,36,5.142857142857143,1,0.0,0,9,0,0,11,12,0,4,0,9,27,0
6861,118101,bwCuicApqXH6S91HqGdXTXLfYA9d5SDK,SpATywNh6bZuzm8s1ceuBUnMUAeoAHHw,13,11,0,0,0,0,2,0,13,1.8571428571428572,1,0.0,0,0,0,0,11,0,0,2,0,0,13,0
6862,118124,11qZqrXXcQbdqet0TC5DW03t5yp66Tzn,SpATywNh6bZuzm8s1ceuBUnMUAeoAHHw,17,10,7,9,5,0,1,0,32,4.571428571428571,1,0.0,2,7,9,5,8,0,0,1,0,23,9,0
6863,118139,MCdk5fbqZJDVd57ZlCNh9qbInGbcl8Me,5X6FeZozNMgE2VRi3MJYjkkFK8SETtu2,18,31,9,14,16,0,9,0,79,11.285714285714286,2,0.0,17,9,13,16,14,0,1,9,0,55,24,1
6864,118145,CUEyHbsjLlbX6I7tsbnNjxFI1v5Lj4iD,SpATywNh6bZuzm8s1ceuBUnMUAeoAHHw,16,37,20,4,12,0,7,0,80,11.428571428571429,2,0.0,0,20,4,12,37,0,0,7,0,36,44,0
6865,118153,UwereIH21fVhvJGOSErkxB1cQ9i013xS,SpATywNh6bZuzm8s1ceuBUnMUAeoAHHw,2,1,1,0,0,0,0,0,2,0.2857142857142857,1,0.0,0,1,0,0,1,0,0,0,0,1,1,0
6866,118165,cQJEH4N9NA86ElT2x4zkE6ToN6rVT4MQ,RXDvfPUBYFlVdlueBFbLW0mhhAyGEqpt,2,1,1,0,0,0,0,0,2,0.2857142857142857,1,0.0,0,1,0,0,1,0,0,0,0,1,1,1
6867,118171,U3R4m4eLMm2lirgI7HLueBKsNpxhFpn9,A3fsA9Zfv1X2fVEQhTw51lKENdNrEqT3,4,4,2,0,0,0,1,0,7,1.0,2,0.0,1,2,0,0,3,0,0,1,0,3,4,0
6868,118178,qAVFbR5cx9X92KNDPDJmLoSTth8nEsRM,RXDvfPUBYFlVdlueBFbLW0mhhAyGEqpt,46,60,33,80,10,30,17,0,230,32.857142857142854,7,0.0,8,33,77,10,52,30,3,17,0,128,102,0
6869,118222,IONYwfWuSLUzRHMHVpaPTPvGauCNosjD,SpATywNh6bZuzm8s1ceuBUnMUAeoAHHw,7,11,3,4,1,0,1,0,20,2.857142857142857,1,0.0,7,3,3,1,4,0,1,1,0,14,6,1
6870,118260,5rpYxIaCTDb4PhszkJWpACOx5VMpNGcQ,A3fsA9Zfv1X2fVEQhTw51lKENdNrEqT3,7,1,1,18,0,0,4,0,24,3.4285714285714284,1,0.0,0,1,15,0,1,0,3,4,0,16,8,1
6871,118265,TEIb1UAPMCR88ygV44aJQSA84qq0H3a7,5X6FeZozNMgE2VRi3MJYjkkFK8SETtu2,7,21,0,11,1,0,5,0,38,5.428571428571429,2,0.0,6,0,9,1,15,0,2,5,0,16,22,0
6872,118336,50cUUtrBaOZeeifZra0Sj4seKRuBEyFS,SpATywNh6bZuzm8s1ceuBUnMUAeoAHHw,6,7,4,0,1,0,0,0,12,1.7142857142857142,4,0.0,0,4,0,1,7,0,0,0,0,5,7,0
6873,118363,FOCCuGaJ7zYTl7CCCo7T3PqrLtxGVeiU,SpATywNh6bZuzm8s1ceuBUnMUAeoAHHw,21,24,15,19,8,0,5,0,71,10.142857142857142,3,0.0,4,15,15,8,20,0,4,5,0,42,29,0
6874,118395,LVTU4qA4F3wWkxH81iGfu4ZuIt77nyhh,A3fsA9Zfv1X2fVEQhTw51lKENdNrEqT3,7,4,1,0,1,0,2,0,8,1.1428571428571428,1,0.0,0,1,0,1,4,0,0,2,0,2,6,0
6875,118484,grhneBVDCBhvBD53OXACTDGfdH3pEWQ2,SpATywNh6bZuzm8s1ceuBUnMUAeoAHHw,14,19,1,12,0,0,2,0,34,4.857142857142857,2,0.0,6,1,11,0,13,0,1,2,0,18,16,0
6876,118502,3LQaIdIg6rrcDyh404eeBez61pVLg6z4,5X6FeZozNMgE2VRi3MJYjkkFK8SETtu2,1,0,0,0,0,0,1,0,1,0.14285714285714285,1,0.0,0,0,0,0,0,0,0,1,0,0,1,1
6877,118510,JfftjOGdDbpgbrupi0Gwr899R0jzXikJ,5X6FeZozNMgE2VRi3MJYjkkFK8SETtu2,4,3,2,0,2,0,2,0,9,1.2857142857142858,1,0.0,0,2,0,2,3,0,0,2,0,4,5,1
6878,118517,AADHk2CnqIXqU54SVoJYYzHXkzsT7VVX,SpATywNh6bZuzm8s1ceuBUnMUAeoAHHw,30,85,44,44,0,11,18,8,210,30.0,3,0.0,27,44,39,0,58,11,5,18,8,110,100,0
6879,118589,r0yZNwEG828V0TMkCl61Reya5Y5HO5aR,bWdj2GDclj5ofokWjzoa5jAwMkxCykd6,6,8,4,0,1,0,2,0,15,2.142857142857143,2,0.0,0,4,0,1,8,0,0,2,0,5,10,0
6880,118592,RiCs84yGV6JCwVfBOhcXa8oCpUMbIJNf,SpATywNh6bZuzm8s1ceuBUnMUAeoAHHw,18,23,1,10,1,12,9,7,63,9.0,4,0.0,2,1,9,1,21,12,1,9,7,13,50,0
6881,118618,TQ8OFVc2xBKvPKyjEssWVNNgqzlZ0PAa,bWdj2GDclj5ofokWjzoa5jAwMkxCykd6,5,12,7,0,0,0,3,0,22,3.142857142857143,3,0.0,1,7,0,0,11,0,0,3,0,8,14,0
6882,118626,sjQQWItXAp5E8ocdOnRRzFCiZKv0PVqn,SpATywNh6bZuzm8s1ceuBUnMUAeoAHHw,14,18,2,11,0,0,2,0,33,4.714285714285714,3,0.0,2,2,11,0,16,0,0,2,0,15,18,0
6883,118633,NuFKQkAxfn2PT3wbGN0i3erkBYbjqkix,A3fsA9Zfv1X2fVEQhTw51lKENdNrEqT3,13,18,2,0,2,0,3,0,25,3.5714285714285716,2,0.0,0,2,0,2,18,0,0,3,0,4,21,0
6884,118634,vbghp1PVpZxFaWqasEyQzIEfPKBk8vPh,5X6FeZozNMgE2VRi3MJYjkkFK8SETtu2,1,0,0,0,0,0,1,0,1,0.14285714285714285,1,0.0,0,0,0,0,0,0,0,1,0,0,1,0
6885,118665,eNgDL8k9xOLyBlZ3UNlseJHly8SfPZZu,A3fsA9Zfv1X2fVEQhTw51lKENdNrEqT3,10,13,8,0,1,0,6,0,28,4.0,5,0.0,0,8,0,1,13,0,0,6,0,9,19,0
6886,118667,oamKaVYtYcTWlWXxR9gjWFZVaqJSv9QD,RXDvfPUBYFlVdlueBFbLW0mhhAyGEqpt,79,156,3,126,30,0,3,0,318,45.42857142857143,2,0.0,89,3,123,30,67,0,3,3,0,245,73,0
6887,118673,NAeglY8cYFpzQKpSfjAgfrtdD2qzmpB5,5X6FeZozNMgE2VRi3MJYjkkFK8SETtu2,5,2,1,0,1,0,3,0,7,1.0,1,0.0,0,1,0,1,2,0,0,3,0,2,5,1
6888,118692,34Xbf7uBGJ4LnJBXPtvvptwjUQQdkYUg,A3fsA9Zfv1X2fVEQhTw51lKENdNrEqT3,35,42,16,72,6,0,8,0,144,20.571428571428573,3,0.0,3,16,63,6,39,0,9,8,0,88,56,0
6889,118713,GzZqgl4giqqW7TCBTX5a2jDyy6Q646Os,SpATywNh6bZuzm8s1ceuBUnMUAeoAHHw,16,17,1,20,0,11,3,1,53,7.571428571428571,1,0.0,5,1,18,0,12,11,2,3,1,24,29,1
6890,118726,l5LfU8gApOG72AnBkdAbfOLQLwFH7Zo2,5X6FeZozNMgE2VRi3MJYjkkFK8SETtu2,7,9,1,2,1,3,2,0,18,2.5714285714285716,1,0.0,5,1,2,1,4,3,0,2,0,9,9,0
6891,118763,5ccVO0DXIbSzn48qO0PlyxYK6uXvmUBC,5X6FeZozNMgE2VRi3MJYjkkFK8SETtu2,1,0,0,0,0,0,1,0,1,0.14285714285714285,1,0.0,0,0,0,0,0,0,0,1,0,0,1,1
6892,118771,lrp5AGJUh69hKuCI5IYUEU19E2beipwd,A3fsA9Zfv1X2fVEQhTw51lKENdNrEqT3,15,23,2,0,1,0,5,0,31,4.428571428571429,6,0.0,0,2,0,1,23,0,0,5,0,3,28,1
6893,118800,AXOBQLaknxwaGBasKpj34YfhU436HR6z,G8EPVSXsOYB5YQWZGiz1aVq5Pgr2GrQu,5,3,2,0,1,0,1,0,7,1.0,1,0.0,0,2,0,1,3,0,0,1,0,3,4,0
6894,118817,tLb8Xi221e5NaJvytwcAD3V04AqBaAZQ,5X6FeZozNMgE2VRi3MJYjkkFK8SETtu2,2,0,0,0,0,0,2,0,2,0.2857142857142857,1,0.0,0,0,0,0,0,0,0,2,0,0,2,1
6895,118829,oYXc35V0j0DGRrciqWRUFfGtnQPnDhaQ,A3fsA9Zfv1X2fVEQhTw51lKENdNrEqT3,5,6,1,0,0,0,1,0,8,1.1428571428571428,1,0.0,0,1,0,0,6,0,0,1,0,1,7,1
6896,118843,eNgDL8k9xOLyBlZ3UNlseJHly8SfPZZu,5X6FeZozNMgE2VRi3MJYjkkFK8SETtu2,1,0,0,0,0,0,2,0,2,0.2857142857142857,2,0.0,0,0,0,0,0,0,0,2,0,0,2,1
6897,118876,eLhnZqVqldawLLuaLdbS0XPiIKiZAief,RXDvfPUBYFlVdlueBFbLW0mhhAyGEqpt,13,13,2,0,0,4,1,0,20,2.857142857142857,1,0.0,0,2,0,0,13,4,0,1,0,2,18,0
6898,118879,wuMhhjy7NxtqcBPxbigACLOqg9Xy71R7,SpATywNh6bZuzm8s1ceuBUnMUAeoAHHw,4,8,3,0,0,0,5,0,16,2.2857142857142856,2,0.0,0,3,0,0,8,0,0,5,0,3,13,0
6899,118913,xUhDcXiX03QQg1jNR3Lksh9CrGcRUkPg,A3fsA9Zfv1X2fVEQhTw51lKENdNrEqT3,39,27,10,106,6,12,6,0,167,23.857142857142858,3,0.0,2,10,91,6,25,12,15,6,0,109,58,0
6900,118926,efygWYkxxUMOGInRZT4qEeuzMRlIpQq6,SpATywNh6bZuzm8s1ceuBUnMUAeoAHHw,23,25,13,7,5,7,10,2,69,9.857142857142858,3,0.0,6,13,6,5,19,7,1,10,2,30,39,0
6901,118931,ZRfFWalEoINhUGe05gZETSGzjQUd6T5n,SpATywNh6bZuzm8s1ceuBUnMUAeoAHHw,5,9,6,0,0,0,2,0,17,2.4285714285714284,2,0.0,0,6,0,0,9,0,0,2,0,6,11,1
6902,118995,UoQ0PEeqIO4n6Ln8avpcjf2ZoIAx1YCQ,A3fsA9Zfv1X2fVEQhTw51lKENdNrEqT3,46,18,17,86,13,0,1,0,135,19.285714285714285,3,0.0,1,17,74,13,17,0,12,1,0,105,30,0
6903,119001,DXaGQeTbJkNEulVow7g1qYtfMHcxt0Bb,SpATywNh6bZuzm8s1ceuBUnMUAeoAHHw,26,53,5,26,3,0,4,1,92,13.142857142857142,4,0.0,8,5,20,3,45,0,6,4,1,36,56,0
6904,119009,c8TFm45r0bfBe26eBlEeUAKDBoTJT9yV,SpATywNh6bZuzm8s1ceuBUnMUAeoAHHw,29,27,15,23,10,0,3,0,78,11.142857142857142,2,0.0,8,15,22,10,19,0,1,3,0,55,23,0
6905,119027,5tL0goZ0bMjNeuGHJZ9VZymSM6PzqaXn,SpATywNh6bZuzm8s1ceuBUnMUAeoAHHw,19,20,14,9,11,0,5,0,59,8.428571428571429,2,0.0,4,14,7,11,16,0,2,5,0,36,23,0
6906,119042,lVwgv61cg8fkhW9rg5b1PIPnuUWxb0Vk,bWdj2GDclj5ofokWjzoa5jAwMkxCykd6,1,0,0,0,0,0,1,0,1,0.14285714285714285,1,0.0,0,0,0,0,0,0,0,1,0,0,1,1
6907,119104,jq4JfpgApzrMRuCNvYDPIsQTWPeEZuhJ,G8EPVSXsOYB5YQWZGiz1aVq5Pgr2GrQu,37,43,21,104,8,1,15,1,193,27.571428571428573,1,0.0,14,21,84,8,29,1,20,15,1,127,66,1
6908,119143,YMxXtA5A6XX1bdm998q3OXZqnuIpo8I0,SpATywNh6bZuzm8s1ceuBUnMUAeoAHHw,9,14,7,0,0,0,2,0,23,3.2857142857142856,2,0.0,0,7,0,0,14,0,0,2,0,7,16,0
6909,119170,kd67Lm5QGeYWxcKJYnacCNFbyj5NIxDh,SpATywNh6bZuzm8s1ceuBUnMUAeoAHHw,9,7,4,16,0,0,1,0,28,4.0,1,0.0,2,4,13,0,5,0,3,1,0,19,9,0
6910,119192,NoA9xueUUthCTfidqnFplOKsMZsY3DHa,SpATywNh6bZuzm8s1ceuBUnMUAeoAHHw,18,21,10,10,5,0,4,0,50,7.142857142857143,2,0.0,6,10,10,5,15,0,0,4,0,31,19,1
6911,119204,okqN4nBVKRYYrkYonKicKGOmPqVGYjZh,G8EPVSXsOYB5YQWZGiz1aVq5Pgr2GrQu,7,5,3,0,1,0,7,0,16,2.2857142857142856,1,0.0,0,3,0,1,5,0,0,7,0,4,12,0
6912,119217,UbE5C1Pto1KvqgPPDmGO0svv7BwAZk15,G8EPVSXsOYB5YQWZGiz1aVq5Pgr2GrQu,5,4,3,0,2,0,1,0,10,1.4285714285714286,1,0.0,0,3,0,2,4,0,0,1,0,5,5,1
6913,119239,okqN4nBVKRYYrkYonKicKGOmPqVGYjZh,bWdj2GDclj5ofokWjzoa5jAwMkxCykd6,4,4,2,0,0,0,6,0,12,1.7142857142857142,1,0.0,0,2,0,0,4,0,0,6,0,2,10,0
6914,119243,q3pPbgY0JhPpTgQfSrEbBAWd7rbmYjI4,SpATywNh6bZuzm8s1ceuBUnMUAeoAHHw,21,52,2,29,1,12,18,0,114,16.285714285714285,6,0.0,11,2,29,1,41,12,0,18,0,43,71,0
6915,119245,7RIgMHzHpMzY7qBXHPj6WiDKK3U9H2Wz,SpATywNh6bZuzm8s1ceuBUnMUAeoAHHw,33,24,18,13,12,0,4,0,71,10.142857142857142,3,0.0,2,18,11,12,22,0,2,4,0,43,28,0
6916,119266,iacqYcgHTn7FZ8NE4roe5kgAUjDF0efr,SpATywNh6bZuzm8s1ceuBUnMUAeoAHHw,18,14,9,16,5,0,3,0,47,6.714285714285714,1,0.0,2,9,13,5,12,0,3,3,0,29,18,0
6917,119294,tdyEqQ928g4zwLz7u1XUELM0nW67gqKU,G8EPVSXsOYB5YQWZGiz1aVq5Pgr2GrQu,14,29,15,0,2,1,5,0,52,7.428571428571429,1,0.0,0,15,0,2,29,1,0,5,0,17,35,1
6918,119305,kLbYKjAePyQg6GOXHiVGeoyhhDvXEfjN,SpATywNh6bZuzm8s1ceuBUnMUAeoAHHw,12,22,2,0,0,1,5,0,30,4.285714285714286,3,0.0,7,2,0,0,15,1,0,5,0,9,21,0
6919,119309,kWr0BhoQMxiu9wSeKhtyX0T1P5JfsERH,SpATywNh6bZuzm8s1ceuBUnMUAeoAHHw,22,25,14,16,5,0,6,0,66,9.428571428571429,2,0.0,6,14,13,5,19,0,3,6,0,38,28,0
6920,119325,grNuFIQJF1sOOkw8RJjaExhlwTJt52uU,SpATywNh6bZuzm8s1ceuBUnMUAeoAHHw,36,72,43,13,16,81,34,0,259,37.0,6,0.0,6,43,12,16,66,81,1,34,0,77,182,0
6921,119330,Xx6t23p3XIha0hNmBziFcHG3GcEwTmQl,SpATywNh6bZuzm8s1ceuBUnMUAeoAHHw,10,11,5,0,2,0,3,0,21,3.0,2,0.0,0,5,0,2,11,0,0,3,0,7,14,0
6922,119372,RwvuGEh3euIR11rktJrGBhzDqcQMkhOC,SpATywNh6bZuzm8s1ceuBUnMUAeoAHHw,20,37,15,9,6,0,6,0,73,10.428571428571429,4,0.0,9,15,8,6,28,0,1,6,0,38,35,0
6923,119413,HNjmezOX8bu6iW67SYkfKBzixQs4v7AY,SpATywNh6bZuzm8s1ceuBUnMUAeoAHHw,4,5,3,0,0,0,2,0,10,1.4285714285714286,2,0.0,0,3,0,0,5,0,0,2,0,3,7,0
6924,119422,8bsgdKFaSfwROHIZCKXm97BMUW4OFzed,SpATywNh6bZuzm8s1ceuBUnMUAeoAHHw,33,38,19,24,10,6,6,0,103,14.714285714285714,2,0.0,4,19,19,10,34,6,5,6,0,52,51,0
6925,119456,72z519PMt8GGBXLvF1FG0oMJuciCSWYJ,RXDvfPUBYFlVdlueBFbLW0mhhAyGEqpt,3,2,1,0,0,0,1,0,4,0.5714285714285714,1,0.0,0,1,0,0,2,0,0,1,0,1,3,1
6926,119461,6ZwHbtvdiS8islxnPJXOOnLtMpvU3IpT,SpATywNh6bZuzm8s1ceuBUnMUAeoAHHw,16,14,9,4,6,0,3,0,36,5.142857142857143,2,0.0,3,9,4,6,11,0,0,3,0,22,14,0
6927,119501,iWlNj0RlfLQkFgeY87o4tMiHnUMI1yTI,G8EPVSXsOYB5YQWZGiz1aVq5Pgr2GrQu,25,26,11,0,10,0,10,0,57,8.142857142857142,3,0.0,0,11,0,10,26,0,0,10,0,21,36,1
6928,119515,0mqsqXT4HPDOQPxpDnEoZEe1KeuUzpQx,SpATywNh6bZuzm8s1ceuBUnMUAeoAHHw,7,5,1,0,1,0,1,0,8,1.1428571428571428,1,0.0,0,1,0,1,5,0,0,1,0,2,6,0
6929,119520,ZQcWT47pZxjNboL0V0inwxjvImMCbKfc,SpATywNh6bZuzm8s1ceuBUnMUAeoAHHw,6,16,4,0,1,0,2,0,23,3.2857142857142856,2,0.0,0,4,0,1,16,0,0,2,0,5,18,0
6930,119547,NHjxa47feJ9sWQnmg6HoO6L78eHIRwnl,RXDvfPUBYFlVdlueBFbLW0mhhAyGEqpt,2,0,0,0,0,0,2,0,2,0.2857142857142857,1,0.0,0,0,0,0,0,0,0,2,0,0,2,1
6931,119570,vuz6r1wL6cSmPMYDw5wsdIxwDVSbQPGA,SpATywNh6bZuzm8s1ceuBUnMUAeoAHHw,5,5,3,0,1,0,1,0,10,1.4285714285714286,1,0.0,0,3,0,1,5,0,0,1,0,4,6,1
6932,119577,ZtIdVQN3EYruDP82MkDXBV4HsWJ99nHc,SpATywNh6bZuzm8s1ceuBUnMUAeoAHHw,20,17,0,4,1,4,6,0,32,4.571428571428571,1,0.0,0,0,4,1,17,4,0,6,0,5,27,1
6933,119601,VW1NSXHsRBHsQFDrAdwMVKxbl0FK1kSa,SpATywNh6bZuzm8s1ceuBUnMUAeoAHHw,12,11,9,0,7,0,1,0,28,4.0,2,0.0,1,9,0,7,10,0,0,1,0,17,11,0
6934,119603,RwVsCYe1en11KhE66sG3vEW9DQBctFlb,SpATywNh6bZuzm8s1ceuBUnMUAeoAHHw,34,51,23,18,16,0,10,0,118,16.857142857142858,3,0.0,4,23,15,16,47,0,3,10,0,58,60,1
6935,119629,nIvIddlMAmTQagaACOulbZ6PInxlyOy2,G8EPVSXsOYB5YQWZGiz1aVq5Pgr2GrQu,5,3,2,0,1,1,1,0,8,1.1428571428571428,1,0.0,0,2,0,1,3,1,0,1,0,3,5,1
6936,119630,nIvIddlMAmTQagaACOulbZ6PInxlyOy2,RXDvfPUBYFlVdlueBFbLW0mhhAyGEqpt,1,0,0,0,0,0,1,0,1,0.14285714285714285,1,0.0,0,0,0,0,0,0,0,1,0,0,1,1
6937,119633,owff2SMFy8taj2Sp3iBe2dPorkqov8kW,SpATywNh6bZuzm8s1ceuBUnMUAeoAHHw,24,23,19,10,16,0,1,0,69,9.857142857142858,5,0.0,3,19,9,16,20,0,1,1,0,47,22,0
6938,119670,zVRAzbnjBCQDkq8v9znUSK3YAm6GKwXz,SpATywNh6bZuzm8s1ceuBUnMUAeoAHHw,3,4,0,0,0,0,1,0,5,0.7142857142857143,1,0.0,0,0,0,0,4,0,0,1,0,0,5,0
6939,119685,OOIu03NBEHePUSUIFa86FGFP5M136EAn,SpATywNh6bZuzm8s1ceuBUnMUAeoAHHw,24,29,16,0,13,0,5,0,63,9.0,3,0.0,0,16,0,13,29,0,0,5,0,29,34,0
6940,119706,4aBimyYkJ2UKqGpkp7oZ1zAX2svcfueq,SpATywNh6bZuzm8s1ceuBUnMUAeoAHHw,5,1,1,0,1,0,2,0,5,0.7142857142857143,2,0.0,0,1,0,1,1,0,0,2,0,2,3,1
6941,119742,PHTS4r6mOEHpVZfm3SzAd9KLg785EPpx,SpATywNh6bZuzm8s1ceuBUnMUAeoAHHw,21,62,28,13,17,20,18,2,160,22.857142857142858,7,0.0,2,28,11,17,60,20,2,18,2,58,102,0
6942,119758,VbCHzxhJd8ennilHHm3zMG389MZjcR4g,SpATywNh6bZuzm8s1ceuBUnMUAeoAHHw,12,21,17,0,8,0,5,0,51,7.285714285714286,4,0.0,0,17,0,8,21,0,0,5,0,25,26,0
6943,119759,eXv6ACzt62C4hMSoDSIQMvmz4LEnGBtm,SpATywNh6bZuzm8s1ceuBUnMUAeoAHHw,10,13,7,0,4,0,4,0,28,4.0,3,0.0,4,7,0,4,9,0,0,4,0,15,13,0
6944,119896,c4MI9OfbyJ0RGX9j0ZiKqfaHb3fSOPCp,SpATywNh6bZuzm8s1ceuBUnMUAeoAHHw,3,2,0,0,0,0,2,0,4,0.5714285714285714,1,0.0,0,0,0,0,2,0,0,2,0,0,4,1
6945,119905,alePu0FhXWTyAf3z1TbtScq1Obpgwyvj,SpATywNh6bZuzm8s1ceuBUnMUAeoAHHw,9,8,0,0,0,0,4,0,12,1.7142857142857142,1,0.0,0,0,0,0,8,0,0,4,0,0,12,0
6946,119923,nrDkIZH2wqEVh6i4pBxcbRBJIMc9s20b,SpATywNh6bZuzm8s1ceuBUnMUAeoAHHw,17,37,1,31,0,0,8,0,77,11.0,5,0.0,7,1,28,0,30,0,3,8,0,36,41,0
6947,119935,4uCHoIviHPzCtwadirbZDGuLNqx4H5qx,SpATywNh6bZuzm8s1ceuBUnMUAeoAHHw,1,0,0,0,0,0,1,0,1,0.14285714285714285,1,0.0,0,0,0,0,0,0,0,1,0,0,1,0
6948,119942,D9eQoamtTDpiMV0b0OdGca728kthGUV3,SpATywNh6bZuzm8s1ceuBUnMUAeoAHHw,11,10,0,18,0,0,2,0,30,4.285714285714286,2,0.0,4,0,18,0,6,0,0,2,0,22,8,0
6949,119974,VLq5RjmauxaFZfPnx2f9r9Dehjw868o9,SpATywNh6bZuzm8s1ceuBUnMUAeoAHHw,7,26,18,0,4,11,6,0,65,9.285714285714286,4,0.0,0,18,0,4,26,11,0,6,0,22,43,0
6950,119983,8ZvgmVWPuU4xKWq9tw3YZdhhMDnHsFgT,SpATywNh6bZuzm8s1ceuBUnMUAeoAHHw,34,30,19,27,12,0,14,0,102,14.571428571428571,5,0.0,4,19,24,12,26,0,3,14,0,59,43,0
6951,120026,ZH0VWJ7XJWogjYH6Qq2Nr4TMh6fe5JGW,SpATywNh6bZuzm8s1ceuBUnMUAeoAHHw,28,88,4,23,0,0,13,0,128,18.285714285714285,5,0.0,12,4,21,0,76,0,2,13,0,37,91,0
6952,120097,5pfeeYLWSB4wCSWnPZbrmiSBS3yXgMsk,bWdj2GDclj5ofokWjzoa5jAwMkxCykd6,3,4,0,0,0,8,1,0,13,1.8571428571428572,1,0.0,0,0,0,0,4,8,0,1,0,0,13,1
6953,120100,JdKnU2sktk6AZyjwyIqgEXYK8OtgPCn2,bWdj2GDclj5ofokWjzoa5jAwMkxCykd6,2,0,0,0,0,2,2,0,4,0.5714285714285714,2,0.0,0,0,0,0,0,2,0,2,0,0,4,0
6954,120111,aGyzysUQgcpficWqTygk8rcuo677dPZU,SpATywNh6bZuzm8s1ceuBUnMUAeoAHHw,10,13,2,0,2,0,2,0,19,2.7142857142857144,1,0.0,1,2,0,2,12,0,0,2,0,5,14,0
6955,120126,c6XaDpje2iQSWpoXkTtf00BW6tACh6Q9,SpATywNh6bZuzm8s1ceuBUnMUAeoAHHw,22,36,20,16,9,16,11,1,109,15.571428571428571,3,0.0,5,20,13,9,31,16,3,11,1,47,62,0
6956,120149,LY15AitabC9VNRy9N91XwsKL39G9Yhym,SpATywNh6bZuzm8s1ceuBUnMUAeoAHHw,13,9,8,0,6,0,1,0,24,3.4285714285714284,1,0.0,0,8,0,6,9,0,0,1,0,14,10,1
6957,120177,83cBV2IXkwoW1nUaa1kxaJ98L3bxFsPn,A3fsA9Zfv1X2fVEQhTw51lKENdNrEqT3,32,34,29,2,1,0,3,0,69,9.857142857142858,4,0.0,0,29,2,1,34,0,0,3,0,32,37,0
6958,120181,yBsDX1Dsw9hy8f2NuaeMfD0tvX413Igw,bWdj2GDclj5ofokWjzoa5jAwMkxCykd6,2,0,0,0,0,3,1,0,4,0.5714285714285714,1,0.0,0,0,0,0,0,3,0,1,0,0,4,0
6959,120251,qY3mO9VSgbSXrTZIckLWUEq4U741QpCT,SpATywNh6bZuzm8s1ceuBUnMUAeoAHHw,17,37,0,29,1,0,5,0,72,10.285714285714286,1,0.0,17,0,25,1,20,0,4,5,0,43,29,0
6960,120457,1La5rp9ZSz9cfpqCRJiC01Rwvuq5VVrf,SpATywNh6bZuzm8s1ceuBUnMUAeoAHHw,8,7,3,12,0,0,3,0,25,3.5714285714285716,1,0.0,2,3,11,0,5,0,1,3,0,16,9,0
6961,120471,I6qoCcohBrCkqxmkans73ezft5aIvcN6,SpATywNh6bZuzm8s1ceuBUnMUAeoAHHw,32,81,17,33,7,2,11,0,151,21.571428571428573,4,0.0,27,17,30,7,54,2,3,11,0,81,70,1
6962,120480,GJdrQdNnhszyte4F0GpLkVjDN5SstsoH,SpATywNh6bZuzm8s1ceuBUnMUAeoAHHw,9,12,2,0,2,0,2,0,18,2.5714285714285716,1,0.0,0,2,0,2,12,0,0,2,0,4,14,0
6963,120505,QZQvnzqgk3ZJQavig3cFuZehXC8CHrPm,bWdj2GDclj5ofokWjzoa5jAwMkxCykd6,5,3,2,0,0,0,3,0,8,1.1428571428571428,1,0.0,0,2,0,0,3,0,0,3,0,2,6,1
6964,120538,kJkXo4nSNqbMETrXDpi6P9tfSt1mYjrM,SpATywNh6bZuzm8s1ceuBUnMUAeoAHHw,11,12,9,0,6,0,7,0,34,4.857142857142857,2,0.0,0,9,0,6,12,0,0,7,0,15,19,1
6965,120547,6T4qq3cdISFF5pyvVKMrcmEINY6BysCY,A3fsA9Zfv1X2fVEQhTw51lKENdNrEqT3,3,4,2,0,0,0,2,0,8,1.1428571428571428,1,0.0,0,2,0,0,4,0,0,2,0,2,6,0
6966,120567,VL7NPBJuyzF1uV3nhlsl7JEimjvq8BIB,SpATywNh6bZuzm8s1ceuBUnMUAeoAHHw,25,31,18,11,10,1,6,0,77,11.0,2,0.0,8,18,9,10,23,1,2,6,0,45,32,0
6967,120571,ZcwgBhx2C5CsYaUWf4YQ2u1SWzTYaxss,A3fsA9Zfv1X2fVEQhTw51lKENdNrEqT3,10,14,11,0,8,0,3,0,36,5.142857142857143,2,0.0,0,11,0,8,14,0,0,3,0,19,17,0
6968,120576,WIgM6nvV9YFBo82xFhtQp6923xmcbs69,SpATywNh6bZuzm8s1ceuBUnMUAeoAHHw,17,24,16,7,10,0,3,0,60,8.571428571428571,3,0.0,5,16,7,10,19,0,0,3,0,38,22,0
6969,120580,tepLda5wSKMdrl1YSxQ7o9ErmWSmjLIs,SpATywNh6bZuzm8s1ceuBUnMUAeoAHHw,25,47,28,11,9,14,25,0,134,19.142857142857142,8,0.0,8,28,10,9,39,14,1,25,0,55,79,0
6970,120621,7rzvmKtANOU8M4posmrNW445K28DcImr,SpATywNh6bZuzm8s1ceuBUnMUAeoAHHw,38,70,2,31,1,2,4,2,112,16.0,3,0.0,10,2,30,1,60,2,1,4,2,43,69,0
6971,120650,AqOYZE1KwO9ElxY4ESIL8wZt1KCX4QiQ,SpATywNh6bZuzm8s1ceuBUnMUAeoAHHw,20,28,11,10,6,0,8,0,63,9.0,2,0.0,2,11,9,6,26,0,1,8,0,28,35,0
6972,120707,YBlpuOz29CjjHYq0RuGLiSzLtjKLdYy2,RXDvfPUBYFlVdlueBFbLW0mhhAyGEqpt,18,14,4,13,3,0,6,0,40,5.714285714285714,4,0.0,0,4,13,3,14,0,0,6,0,20,20,0
6973,120743,es5GTyNQHE6XqsHqRasxkSTkn6q7y8k2,SpATywNh6bZuzm8s1ceuBUnMUAeoAHHw,10,9,3,17,0,6,4,0,39,5.571428571428571,1,0.0,5,3,14,0,4,6,3,4,0,22,17,0
6974,120755,PQyLGsdBWhEy27jacipkmntLAvcsGeQa,SpATywNh6bZuzm8s1ceuBUnMUAeoAHHw,20,23,15,13,9,3,6,0,69,9.857142857142858,2,0.0,6,15,10,9,17,3,3,6,0,40,29,0
6975,120807,KHl8vTLwoQOTsjJg2pVXTnG0Is0a8K1K,SpATywNh6bZuzm8s1ceuBUnMUAeoAHHw,10,5,4,0,3,0,2,1,15,2.142857142857143,1,0.0,0,4,0,3,5,0,0,2,1,7,8,1
6976,120831,JLn36xalC1eIUd4jm6gux9oEgx3gpDxA,SpATywNh6bZuzm8s1ceuBUnMUAeoAHHw,8,16,0,0,0,1,4,1,22,3.142857142857143,2,0.0,0,0,0,0,16,1,0,4,1,0,22,1
6977,120878,edVuZXQuYE4LHUfAzzB1uGhpYsPr0vJx,SpATywNh6bZuzm8s1ceuBUnMUAeoAHHw,34,33,15,27,10,4,7,0,96,13.714285714285714,3,0.0,5,15,21,10,28,4,6,7,0,51,45,0
6978,120896,u5ObOMoHUcvVsOQTGkiv0BRKKcn8v2w8,A3fsA9Zfv1X2fVEQhTw51lKENdNrEqT3,3,2,1,0,0,0,2,0,5,0.7142857142857143,1,0.0,0,1,0,0,2,0,0,2,0,1,4,0
6979,120927,4bcOXBC1lhgwF9Pg3IMx9vJFVwNtFyik,SpATywNh6bZuzm8s1ceuBUnMUAeoAHHw,11,19,0,0,1,0,3,0,23,3.2857142857142856,1,0.0,0,0,0,1,19,0,0,3,0,1,22,1
6980,120936,i0ksX07HnsV5rQlWqOr1uKEuc7yNU24c,A3fsA9Zfv1X2fVEQhTw51lKENdNrEqT3,37,24,14,100,6,6,11,0,161,23.0,4,0.0,6,14,83,6,18,6,17,11,0,109,52,0
6981,120953,HGkuwdB1J817cl9wl529SZa2OTu14HFB,SpATywNh6bZuzm8s1ceuBUnMUAeoAHHw,34,38,27,20,19,0,8,0,112,16.0,3,0.0,7,27,17,19,31,0,3,8,0,70,42,0
6982,120983,Tg9kFmEr6KGEyzeoopWvQ3WCSPhx01lk,SpATywNh6bZuzm8s1ceuBUnMUAeoAHHw,20,14,10,13,5,0,3,0,45,6.428571428571429,2,0.0,2,10,12,5,12,0,1,3,0,29,16,1
6983,120998,y7Z8jSjEija2cXP8zDhgGRVfac5fnMAR,SpATywNh6bZuzm8s1ceuBUnMUAeoAHHw,5,3,1,0,1,0,2,0,7,1.0,2,0.0,0,1,0,1,3,0,0,2,0,2,5,1
6984,121053,npZiJYBXIvuULdTyVSfZOjhsnEdX6i82,SpATywNh6bZuzm8s1ceuBUnMUAeoAHHw,27,32,16,12,10,0,3,0,73,10.428571428571429,3,0.0,14,16,11,10,18,0,1,3,0,51,22,0
6985,121085,hWWjbjEJOX0Ph07p1EJp8Ya48hU8wP5v,SpATywNh6bZuzm8s1ceuBUnMUAeoAHHw,21,45,22,16,11,0,7,0,101,14.428571428571429,5,0.0,4,22,15,11,41,0,1,7,0,52,49,0
6986,121145,atoEVjauO8UqqxbDs90qm3bNJMwCLIt0,SpATywNh6bZuzm8s1ceuBUnMUAeoAHHw,23,17,12,10,10,0,4,0,53,7.571428571428571,2,0.0,4,12,9,10,13,0,1,4,0,35,18,0
6987,121161,Yl3fWDphM6Ifhmu0NrJgclA0dIl02Kms,A3fsA9Zfv1X2fVEQhTw51lKENdNrEqT3,31,11,7,54,4,5,4,0,85,12.142857142857142,2,0.0,2,7,48,4,9,5,6,4,0,61,24,1
6988,121350,OaR2omePx63fXdBiAV1sA954f6IcbIvq,A3fsA9Zfv1X2fVEQhTw51lKENdNrEqT3,42,31,20,40,11,5,10,0,117,16.714285714285715,3,0.0,2,20,39,11,29,5,1,10,0,72,45,0
6989,121419,I6qGclNEImKeNJdvIwY5PrrMknw1zeQu,SpATywNh6bZuzm8s1ceuBUnMUAeoAHHw,7,5,1,0,1,0,1,0,8,1.1428571428571428,1,0.0,0,1,0,1,5,0,0,1,0,2,6,0
6990,121611,bDlowck7PoswtmYozGMoa41g1GVEejKh,RXDvfPUBYFlVdlueBFbLW0mhhAyGEqpt,52,93,65,40,43,19,16,0,276,39.42857142857143,6,0.0,13,65,40,43,80,19,0,16,0,161,115,0
6991,121648,jXl4Q6TFlYw71Bn9dguW333wEk83ysVq,SpATywNh6bZuzm8s1ceuBUnMUAeoAHHw,11,13,1,0,1,0,4,0,19,2.7142857142857144,1,0.0,3,1,0,1,10,0,0,4,0,5,14,1
6992,121662,5HXdL6OatNrhiY174KvxQUp0tpTJ3ory,SpATywNh6bZuzm8s1ceuBUnMUAeoAHHw,9,9,0,0,0,0,2,0,11,1.5714285714285714,1,0.0,0,0,0,0,9,0,0,2,0,0,11,0
6993,121729,ZrDgEyfoUHLa5uf0N0ml9T9xO22FqwKE,SpATywNh6bZuzm8s1ceuBUnMUAeoAHHw,30,52,4,72,1,8,20,1,158,22.571428571428573,5,0.0,19,4,58,1,33,8,14,20,1,82,76,0
6994,121840,A3FGIvcpmP9UeVzECTe66iC9lFbKmHRb,RXDvfPUBYFlVdlueBFbLW0mhhAyGEqpt,5,3,2,2,0,0,1,0,8,1.1428571428571428,1,0.0,0,2,2,0,3,0,0,1,0,4,4,0
6995,121873,nHMoTKw6ss0dSnBzmsq0keGpHH2NjvR7,SpATywNh6bZuzm8s1ceuBUnMUAeoAHHw,18,21,10,17,8,0,0,0,56,8.0,2,0.0,2,10,16,8,19,0,1,0,0,36,20,1
6996,121893,Q8D1GMU9DUO6Nj6ySx5rrvLwl2bu2DGZ,SpATywNh6bZuzm8s1ceuBUnMUAeoAHHw,21,48,14,16,6,17,2,0,103,14.714285714285714,2,0.0,31,14,13,6,17,17,3,2,0,64,39,0
6997,121906,DPTAQ5lGsvjESrb4v1mwHpMaZuqLNytl,SpATywNh6bZuzm8s1ceuBUnMUAeoAHHw,19,17,9,15,5,0,3,0,49,7.0,2,0.0,5,9,12,5,12,0,3,3,0,31,18,0
6998,121961,oW9L7CxP0sDxYCxol70CUfkBpdozjWLb,SpATywNh6bZuzm8s1ceuBUnMUAeoAHHw,7,4,3,0,3,0,2,0,12,1.7142857142857142,1,0.0,0,3,0,3,4,0,0,2,0,6,6,0
6999,122062,Cyazs2KNzeLH7rwO0YD9wLQWGHR2SXrB,A3fsA9Zfv1X2fVEQhTw51lKENdNrEqT3,3,3,0,0,0,0,1,0,4,0.5714285714285714,2,0.0,0,0,0,0,3,0,0,1,0,0,4,1
7000,122074,JbB7hpnQ5hVzqELznLtzJLRyOZ2rdnyH,SpATywNh6bZuzm8s1ceuBUnMUAeoAHHw,3,2,1,0,0,0,1,0,4,0.5714285714285714,1,0.0,0,1,0,0,2,0,0,1,0,1,3,1
7001,122080,2dTQ27kTyKMSAN4dn7cbjnuDmdSbybLJ,SpATywNh6bZuzm8s1ceuBUnMUAeoAHHw,17,9,6,11,4,0,5,0,35,5.0,1,0.0,2,6,11,4,7,0,0,5,0,23,12,0
7002,124650,efygWYkxxUMOGInRZT4qEeuzMRlIpQq6,7GRhBDsirIGkRZBtSMEzNTyDr2JQm4xx,4,4,2,0,0,0,1,0,7,1.0,1,0.0,1,2,0,0,3,0,0,1,0,3,4,0
7003,124666,sL5jw3pLWZoRI7avI17oM60mfF67Acgz,5X6FeZozNMgE2VRi3MJYjkkFK8SETtu2,1,0,0,0,0,0,2,0,2,0.2857142857142857,2,0.0,0,0,0,0,0,0,0,2,0,0,2,1
7004,124702,Xv0DoRVy2WPaq7NGSTl3PflvzGmHzjVJ,7GRhBDsirIGkRZBtSMEzNTyDr2JQm4xx,7,3,3,0,1,0,4,0,11,1.5714285714285714,2,0.0,0,3,0,1,3,0,0,4,0,4,7,0
7005,124735,jlC3YerbEJPhQPclqGgy1CC0ljiFJl8o,5X6FeZozNMgE2VRi3MJYjkkFK8SETtu2,6,2,1,0,1,1,5,0,10,1.4285714285714286,1,0.0,0,1,0,1,2,1,0,5,0,2,8,0
7006,124773,GRrERNARfPmHJJ23nleKGef7ZYXS6qd5,5X6FeZozNMgE2VRi3MJYjkkFK8SETtu2,6,13,6,0,1,0,4,0,24,3.4285714285714284,2,0.0,0,6,0,1,13,0,0,4,0,7,17,1
7007,124836,axvNuGFei1wBoMeftuvLVoxMq7VwfK2Y,5X6FeZozNMgE2VRi3MJYjkkFK8SETtu2,16,26,0,24,8,2,11,2,73,10.428571428571429,2,0.0,21,0,20,8,5,2,4,11,2,49,24,1
7008,124907,dy1kaQWxoXWQcnMIwUbIVvY0VEkR7Bs3,5X6FeZozNMgE2VRi3MJYjkkFK8SETtu2,12,29,0,6,5,0,2,0,42,6.0,1,0.0,14,0,6,5,15,0,0,2,0,25,17,1
7009,124916,mpVn51vIxcFHSSmrFHwBhXrXBYaAZHXF,5X6FeZozNMgE2VRi3MJYjkkFK8SETtu2,11,12,2,0,5,0,7,1,27,3.857142857142857,3,0.0,8,2,0,5,4,0,0,7,1,15,12,1
7010,124926,v5eLUYR1i3YADviojKZNFPbyLtvvjLpV,5X6FeZozNMgE2VRi3MJYjkkFK8SETtu2,2,0,0,0,0,0,2,0,2,0.2857142857142857,1,0.0,0,0,0,0,0,0,0,2,0,0,2,1
7011,124929,h1vlE6V01uCOV61SCqflFhgAa0WJlRTd,5X6FeZozNMgE2VRi3MJYjkkFK8SETtu2,4,5,2,0,2,0,2,0,11,1.5714285714285714,1,0.0,0,2,0,2,5,0,0,2,0,4,7,1
7012,124949,sQym1SSnuvlV9rWhfoiNBuvnxQoSSsrc,7GRhBDsirIGkRZBtSMEzNTyDr2JQm4xx,47,95,35,30,19,11,17,3,210,30.0,3,0.0,23,35,16,19,72,11,14,17,3,93,117,0
7013,124994,MSCPBeMOma5Q14pYmHkWhGqvOSejEmha,5X6FeZozNMgE2VRi3MJYjkkFK8SETtu2,6,2,1,0,1,2,3,0,9,1.2857142857142858,1,0.0,0,1,0,1,2,2,0,3,0,2,7,1
7014,125011,yvD0Nz5opCTF1LRVqbZEAfslgCLS23uR,5X6FeZozNMgE2VRi3MJYjkkFK8SETtu2,1,0,0,0,0,0,1,0,1,0.14285714285714285,1,0.0,0,0,0,0,0,0,0,1,0,0,1,1
7015,125015,wuCb3DAs0UTa3nnL6gSfoBgjTkpbfyNt,7GRhBDsirIGkRZBtSMEzNTyDr2JQm4xx,2,0,0,0,0,0,3,0,3,0.42857142857142855,2,0.0,0,0,0,0,0,0,0,3,0,0,3,0
7016,125056,GjKIGij44vr1LmHxaYp53Ww7DNMH4X51,5X6FeZozNMgE2VRi3MJYjkkFK8SETtu2,1,0,0,0,0,0,1,0,1,0.14285714285714285,1,0.0,0,0,0,0,0,0,0,1,0,0,1,1
7017,125115,nnatF6b6B4eAZHghUjobwQEGoTPTe7ie,5X6FeZozNMgE2VRi3MJYjkkFK8SETtu2,21,53,14,4,4,37,11,0,123,17.571428571428573,8,0.0,3,14,2,4,50,37,2,11,0,23,100,1
7018,125140,IPtj28AIODSKhv67PqVJ25ztTgrx2y8Y,5X6FeZozNMgE2VRi3MJYjkkFK8SETtu2,47,156,25,54,27,1,13,1,277,39.57142857142857,3,0.0,62,25,42,27,94,1,12,13,1,156,121,0
7019,125160,ydJO5TQWFF3ccN5IAMRV8tSf6TzPXb3q,5X6FeZozNMgE2VRi3MJYjkkFK8SETtu2,26,25,20,0,16,1,10,1,73,10.428571428571429,3,0.0,1,20,0,16,24,1,0,10,1,37,36,0
7020,125177,lJUTJBRxdmUZMtpc6Z00drkXv7sphS3I,5X6FeZozNMgE2VRi3MJYjkkFK8SETtu2,1,0,0,0,0,0,1,0,1,0.14285714285714285,1,0.0,0,0,0,0,0,0,0,1,0,0,1,1
7021,125180,MlERBU07RIzNVvfWDAfKEm5wuCRo0zhc,5X6FeZozNMgE2VRi3MJYjkkFK8SETtu2,5,2,1,0,1,0,2,0,6,0.8571428571428571,1,0.0,0,1,0,1,2,0,0,2,0,2,4,1
7022,125181,1PtbOwiaYzdbDKR4jwxYZygX1EDGwXDv,5X6FeZozNMgE2VRi3MJYjkkFK8SETtu2,2,0,0,0,0,0,2,0,2,0.2857142857142857,1,0.0,0,0,0,0,0,0,0,2,0,0,2,1
7023,125200,mHrUva1gb67lEBisDVtTMu9unAmjerQl,5X6FeZozNMgE2VRi3MJYjkkFK8SETtu2,3,1,0,0,0,0,2,0,3,0.42857142857142855,1,0.0,0,0,0,0,1,0,0,2,0,0,3,1
7024,125230,oSabIe7L5topw6hwV4H4ZV0Ug7ZVNxfV,5X6FeZozNMgE2VRi3MJYjkkFK8SETtu2,1,0,0,0,0,0,2,0,2,0.2857142857142857,1,0.0,0,0,0,0,0,0,0,2,0,0,2,1
7025,125428,7tmNprOSiahGzByaY8XiUnCFEIQfWwuf,7GRhBDsirIGkRZBtSMEzNTyDr2JQm4xx,16,41,0,10,6,0,3,0,60,8.571428571428571,2,0.0,25,0,9,6,16,0,1,3,0,40,20,0
7026,125524,v7pdrt6SOAQ5FMXohVYmR0yZQdsegJw7,5X6FeZozNMgE2VRi3MJYjkkFK8SETtu2,13,17,5,10,4,5,21,4,66,9.428571428571429,3,0.0,7,5,9,4,10,5,1,21,4,25,41,1
7027,125535,25EaS6JKE4Hk4CM94OaijCcGTo9ukC8B,5X6FeZozNMgE2VRi3MJYjkkFK8SETtu2,10,17,14,0,1,0,7,1,40,5.714285714285714,2,0.0,0,14,0,1,17,0,0,7,1,15,25,1
7028,125547,QnyfwZyfjleoLWOw3jVeDLlIVv3UkBPV,5X6FeZozNMgE2VRi3MJYjkkFK8SETtu2,8,10,3,0,1,4,4,0,22,3.142857142857143,1,0.0,6,3,0,1,4,4,0,4,0,10,12,1
7029,125585,KN2cc8h9ZKfIgxIX3NczsQQI5NEtrUt5,5X6FeZozNMgE2VRi3MJYjkkFK8SETtu2,23,52,3,0,2,18,14,1,90,12.857142857142858,5,0.0,0,3,0,2,52,18,0,14,1,5,85,0
7030,125611,WTq3F20r9svKD0KV9I01NPhpISpfA3HB,5X6FeZozNMgE2VRi3MJYjkkFK8SETtu2,16,17,7,0,9,0,3,0,36,5.142857142857143,1,0.0,9,7,0,9,8,0,0,3,0,25,11,1
7031,125753,YvYIJVn17sxZcNrdNHi37J2cH2xlqBWH,5X6FeZozNMgE2VRi3MJYjkkFK8SETtu2,1,0,0,0,0,0,1,0,1,0.14285714285714285,1,0.0,0,0,0,0,0,0,0,1,0,0,1,1
7032,125793,xpwei0fjDTwQJLJhl5FjMPXksqpuR5GG,7GRhBDsirIGkRZBtSMEzNTyDr2JQm4xx,24,20,9,24,5,0,9,1,68,9.714285714285714,2,0.0,9,9,23,5,11,0,1,9,1,46,22,0
7033,125812,V0uiGOMmu8omN1SkGAlLskA1ec4HbVnU,5X6FeZozNMgE2VRi3MJYjkkFK8SETtu2,2,0,0,0,0,0,4,0,4,0.5714285714285714,1,0.0,0,0,0,0,0,0,0,4,0,0,4,1
7034,125846,PmtrviA6hBub1PH85YXqVyZgghNsuc4g,5X6FeZozNMgE2VRi3MJYjkkFK8SETtu2,1,0,0,0,0,0,1,0,1,0.14285714285714285,1,0.0,0,0,0,0,0,0,0,1,0,0,1,1
7035,125894,nmlYjXdaqWSjPWm2kQhmjZqjjBKhkQAm,5X6FeZozNMgE2VRi3MJYjkkFK8SETtu2,13,32,10,16,7,0,5,0,70,10.0,4,0.0,9,10,14,7,23,0,2,5,0,40,30,0
7036,125906,hZVR7WDKIq3zqJvcwhd3nm8W6syJwx1x,5X6FeZozNMgE2VRi3MJYjkkFK8SETtu2,2,0,0,0,0,0,2,0,2,0.2857142857142857,1,0.0,0,0,0,0,0,0,0,2,0,0,2,1
7037,125943,AGqTzsgnX6vVGxhMaRoHP08rIDTXwtJC,5X6FeZozNMgE2VRi3MJYjkkFK8SETtu2,1,0,0,0,0,0,2,0,2,0.2857142857142857,2,0.0,0,0,0,0,0,0,0,2,0,0,2,1
7038,125947,T286STFeqJDQxeE6WPssgBKbrMMMWoux,5X6FeZozNMgE2VRi3MJYjkkFK8SETtu2,1,0,0,0,0,0,1,0,1,0.14285714285714285,1,0.0,0,0,0,0,0,0,0,1,0,0,1,1
7039,126028,zuz5zWSULJWik2s9CGpLrSxy1Iohz1Pf,3VkHkmOtom3jM2wCu94xgzzu1d6Dn7or,5,8,1,0,2,0,2,0,13,1.8571428571428572,1,0.0,6,1,0,2,2,0,0,2,0,9,4,1
7040,126038,Wvy7aTjkVfGR2AI5Thyddx9t5OocikeK,3VkHkmOtom3jM2wCu94xgzzu1d6Dn7or,12,16,7,2,5,3,7,0,40,5.714285714285714,2,0.0,4,7,2,5,12,3,0,7,0,18,22,1
7041,126068,Qx6qZWjPDUKeRPCTEgdIrw1kQo1HZ6cS,3VkHkmOtom3jM2wCu94xgzzu1d6Dn7or,6,2,1,0,1,0,3,1,8,1.1428571428571428,1,0.0,0,1,0,1,2,0,0,3,1,2,6,1
7042,126078,XmAzNK7iGixs3BUw8vyslVqvQxna4SOq,3VkHkmOtom3jM2wCu94xgzzu1d6Dn7or,52,192,50,42,48,26,19,17,394,56.285714285714285,8,0.0,67,50,39,48,125,26,3,19,17,204,190,0
7043,126122,znUdeSZWEmqlyIfXyRjGAECXlMyw5OjY,3VkHkmOtom3jM2wCu94xgzzu1d6Dn7or,4,2,1,0,0,0,3,0,6,0.8571428571428571,1,0.0,0,1,0,0,2,0,0,3,0,1,5,1
7044,126126,zhsA5AWZBFuPp3bkPdAFn7TsTLHqu5n7,3VkHkmOtom3jM2wCu94xgzzu1d6Dn7or,1,0,0,0,0,0,1,0,1,0.14285714285714285,1,0.0,0,0,0,0,0,0,0,1,0,0,1,1
7045,126129,pucJsqwQA7WoZPnFXbRNaqe2LORp0GYI,3VkHkmOtom3jM2wCu94xgzzu1d6Dn7or,78,200,69,60,64,97,24,3,517,73.85714285714286,15,0.0,102,69,53,64,98,97,7,24,3,288,229,0
7046,126160,VjL20uhB0vsgG5TsdPT1FRcMljUbA2A1,3VkHkmOtom3jM2wCu94xgzzu1d6Dn7or,12,7,5,3,5,0,4,0,24,3.4285714285714284,1,0.0,2,5,3,5,5,0,0,4,0,15,9,1
7047,126202,lUnwmGFCSXlOUiII3teJ5zEBeBVUD7WB,3VkHkmOtom3jM2wCu94xgzzu1d6Dn7or,11,7,4,0,4,0,5,0,20,2.857142857142857,1,0.0,0,4,0,4,7,0,0,5,0,8,12,1
7048,126218,6RFMdqS7WGODpRlMSRGkPKo918itHm2G,3VkHkmOtom3jM2wCu94xgzzu1d6Dn7or,12,13,5,5,3,15,32,5,78,11.142857142857142,4,0.0,3,5,4,3,10,15,1,32,5,15,63,1
7049,126219,4dtcI1PUeI5oWIETRkEcEio5CmFfMXLK,3VkHkmOtom3jM2wCu94xgzzu1d6Dn7or,1,0,0,0,0,0,1,0,1,0.14285714285714285,1,0.0,0,0,0,0,0,0,0,1,0,0,1,1
7050,126220,ypU3t9MvytSmk7TAfWOFmnh4mr6TtaFt,3VkHkmOtom3jM2wCu94xgzzu1d6Dn7or,1,0,0,0,0,0,1,0,1,0.14285714285714285,1,0.0,0,0,0,0,0,0,0,1,0,0,1,1
7051,126223,zUCvt1Jo98lqHnxp63DwEHYQVaba0Hj8,3VkHkmOtom3jM2wCu94xgzzu1d6Dn7or,8,7,5,0,3,0,9,0,24,3.4285714285714284,1,0.0,0,5,0,3,7,0,0,9,0,8,16,1
7052,126235,6FSZFmVWEFB26reRPWm9j7oObVdlCuAi,3VkHkmOtom3jM2wCu94xgzzu1d6Dn7or,76,146,63,60,52,20,29,9,379,54.142857142857146,10,0.0,57,63,52,52,89,20,8,29,9,224,155,0
7053,126237,9pT6N4se7KH1WHb9dFs199S3yl7jYfAi,3VkHkmOtom3jM2wCu94xgzzu1d6Dn7or,30,86,22,22,38,23,27,3,221,31.571428571428573,3,0.0,53,22,19,38,33,23,3,27,3,132,89,0
7054,126250,fkQDwAL4gdIPRd4aB7Ol9vgxBJ1hw6Rx,3VkHkmOtom3jM2wCu94xgzzu1d6Dn7or,78,185,52,48,65,6,15,2,373,53.285714285714285,7,0.0,110,52,45,65,75,6,3,15,2,272,101,0
7055,126266,z1HsWLWwZrPH9DdqT5jFIKgFzSaNslpx,3VkHkmOtom3jM2wCu94xgzzu1d6Dn7or,24,51,27,8,10,19,14,2,131,18.714285714285715,4,0.0,9,27,6,10,42,19,2,14,2,52,79,1
7056,126267,lvgatvWcTJcoIRcLajVyWwx2yDaci7m3,3VkHkmOtom3jM2wCu94xgzzu1d6Dn7or,1,0,0,0,0,0,1,0,1,0.14285714285714285,1,0.0,0,0,0,0,0,0,0,1,0,0,1,1
7057,126272,NKKgqSSwnJpenRYnE59UQVVdasPdam0Z,3VkHkmOtom3jM2wCu94xgzzu1d6Dn7or,2,0,0,0,0,0,2,0,2,0.2857142857142857,1,0.0,0,0,0,0,0,0,0,2,0,0,2,1
7058,126278,gd3qxCUQPHYg9xbk9czFLqQh5KKHvjVi,3VkHkmOtom3jM2wCu94xgzzu1d6Dn7or,3,0,0,0,0,0,6,0,6,0.8571428571428571,1,0.0,0,0,0,0,0,0,0,6,0,0,6,1
7059,126287,mSKZDzZ8nLtSXSbILUv2gFiVfzyMEj8E,3VkHkmOtom3jM2wCu94xgzzu1d6Dn7or,1,0,0,0,0,0,1,0,1,0.14285714285714285,1,0.0,0,0,0,0,0,0,0,1,0,0,1,1
7060,126288,6LGn0r67LPmDJWxy2EgNkRFWlZEuKQ3F,3VkHkmOtom3jM2wCu94xgzzu1d6Dn7or,1,0,0,0,0,0,1,0,1,0.14285714285714285,1,0.0,0,0,0,0,0,0,0,1,0,0,1,1
7061,126295,VCflSr4QP1G7vByazykiqPCwJcfGGXL3,3VkHkmOtom3jM2wCu94xgzzu1d6Dn7or,5,2,1,0,1,0,3,0,7,1.0,1,0.0,0,1,0,1,2,0,0,3,0,2,5,1
7062,126312,ldP6KYSVrcc8QpjmvGLsrIWx13SOq0iw,3VkHkmOtom3jM2wCu94xgzzu1d6Dn7or,10,23,8,5,6,4,9,0,55,7.857142857142857,3,0.0,9,8,5,6,14,4,0,9,0,28,27,1
7063,126315,9Zk8SoA9HHXiIf1DkPLEkG6RlHRl1ciY,3VkHkmOtom3jM2wCu94xgzzu1d6Dn7or,13,7,6,0,5,3,9,3,33,4.714285714285714,2,0.0,0,6,0,5,7,3,0,9,3,11,22,1
7064,126323,l4QykzFcC41mVGOdUpTYCbuYnqmkZCXe,3VkHkmOtom3jM2wCu94xgzzu1d6Dn7or,27,18,16,0,14,1,7,1,57,8.142857142857142,4,0.0,0,16,0,14,18,1,0,7,1,30,27,1
7065,126332,ethHdMFOR2OQzHLQgGv8NXjeXYMKOEF1,3VkHkmOtom3jM2wCu94xgzzu1d6Dn7or,9,5,2,0,2,3,6,1,19,2.7142857142857144,1,0.0,2,2,0,2,3,3,0,6,1,6,13,1
7066,126383,wHUI8Q6SegxZkCwExAXl4undimdqHK22,3VkHkmOtom3jM2wCu94xgzzu1d6Dn7or,24,26,15,18,9,17,11,0,96,13.714285714285714,3,0.0,6,15,15,9,20,17,3,11,0,45,51,1
7067,126390,UGDkIyb93lIOfXgnofEbeXQUEtyJawN6,3VkHkmOtom3jM2wCu94xgzzu1d6Dn7or,1,0,0,0,0,0,1,0,1,0.14285714285714285,1,0.0,0,0,0,0,0,0,0,1,0,0,1,1
7068,126432,CxdjVRiGSdnkWYlXct3ijBA50Iwgs01Y,3VkHkmOtom3jM2wCu94xgzzu1d6Dn7or,33,53,17,17,20,4,17,0,128,18.285714285714285,3,0.0,22,17,16,20,31,4,1,17,0,75,53,1
7069,126438,6GElgwafDWFNhJQts2kIN5CQZ1KMOLfa,3VkHkmOtom3jM2wCu94xgzzu1d6Dn7or,38,67,21,56,29,1,11,0,185,26.428571428571427,2,0.0,41,21,49,29,26,1,7,11,0,140,45,0
7070,126442,yAlfFIK62QmTvatWaLp7UjMyJRbbz8ld,3VkHkmOtom3jM2wCu94xgzzu1d6Dn7or,5,11,4,5,4,8,1,0,33,4.714285714285714,4,0.0,2,4,4,4,9,8,1,1,0,14,19,1
7071,126455,1ZCd9N2WnPv96p0luhKiPnK2aqn9GWZB,3VkHkmOtom3jM2wCu94xgzzu1d6Dn7or,7,21,2,4,5,1,3,0,36,5.142857142857143,1,0.0,18,2,3,5,3,1,1,3,0,28,8,1
7072,126463,Bk3oyYaru5lQmJNdOTm1m91MudS3u40V,3VkHkmOtom3jM2wCu94xgzzu1d6Dn7or,12,17,4,11,8,17,18,3,78,11.142857142857142,3,0.0,12,4,10,8,5,17,1,18,3,34,44,0
7073,126477,Gj2OXlBFPGaDRaBfe5Zh60wktBkAXNUX,3VkHkmOtom3jM2wCu94xgzzu1d6Dn7or,1,0,0,0,0,0,2,0,2,0.2857142857142857,1,0.0,0,0,0,0,0,0,0,2,0,0,2,1
7074,126517,aGaqi9cnQPCgRc9cproX6qrgPoZwH926,3VkHkmOtom3jM2wCu94xgzzu1d6Dn7or,49,102,55,13,40,25,32,1,268,38.285714285714285,11,0.0,26,55,12,40,76,25,1,32,1,133,135,1
7075,126538,OcchkIht8b8QIrrapp5dUsDP9GE3Vfdw,3VkHkmOtom3jM2wCu94xgzzu1d6Dn7or,17,12,5,14,6,8,30,0,75,10.714285714285714,7,0.0,6,5,13,6,6,8,1,30,0,30,45,1
7076,126568,vqfmFiF7QLn36tSO5BXTsgSuCRtEMXHE,3VkHkmOtom3jM2wCu94xgzzu1d6Dn7or,1,0,0,0,0,0,3,0,3,0.42857142857142855,1,0.0,0,0,0,0,0,0,0,3,0,0,3,1
7077,126574,Pzc5qQ1UDgVe00Q6u9rA78OkekMtRbKr,3VkHkmOtom3jM2wCu94xgzzu1d6Dn7or,6,7,2,0,2,0,4,0,15,2.142857142857143,4,0.0,0,2,0,2,7,0,0,4,0,4,11,0
7078,126615,YxqQc0FBDNSpG3MFOKGx9ekKufVhxrPh,fbPkOYLVPtPgIt0MxizjfFJov3JbHyAi,5,3,1,0,1,0,1,0,6,0.8571428571428571,1,0.0,0,1,0,1,3,0,0,1,0,2,4,1
7079,126650,LD7pbuVHju3VTu9U8udNh6I7JCsw9ECG,fbPkOYLVPtPgIt0MxizjfFJov3JbHyAi,14,19,7,14,9,0,2,0,51,7.285714285714286,1,0.0,10,7,13,9,9,0,1,2,0,39,12,0
7080,126651,ctraTKVJ2JhUCIHyavrJWUiIknGdQbqc,fbPkOYLVPtPgIt0MxizjfFJov3JbHyAi,12,16,9,0,7,0,4,0,36,5.142857142857143,1,0.0,4,9,0,7,12,0,0,4,0,20,16,1
7081,126707,J1iCM60eAwVKTPRoP9hdyFlEQf6db3YF,fbPkOYLVPtPgIt0MxizjfFJov3JbHyAi,9,16,10,0,3,3,5,0,37,5.285714285714286,1,0.0,2,10,0,3,14,3,0,5,0,15,22,1
7082,126710,74SN75RPs9smmLOI0EXp2s3BwIneUL6f,fbPkOYLVPtPgIt0MxizjfFJov3JbHyAi,5,3,2,0,1,0,1,0,7,1.0,1,0.0,0,2,0,1,3,0,0,1,0,3,4,1
7083,126720,ILgj2bRC3L9liHZTpRi1J62GsWMdjm7i,fbPkOYLVPtPgIt0MxizjfFJov3JbHyAi,5,3,2,0,1,0,1,0,7,1.0,1,0.0,0,2,0,1,3,0,0,1,0,3,4,0
7084,126727,okqN4nBVKRYYrkYonKicKGOmPqVGYjZh,fbPkOYLVPtPgIt0MxizjfFJov3JbHyAi,26,46,23,0,20,0,16,0,105,15.0,3,0.0,0,23,0,20,46,0,0,16,0,43,62,0
7085,126735,FXETNH4OzV3fwI4YkwpBpnk1E19ob1X2,fbPkOYLVPtPgIt0MxizjfFJov3JbHyAi,1,0,0,0,0,0,1,0,1,0.14285714285714285,1,0.0,0,0,0,0,0,0,0,1,0,0,1,1
7086,126780,k0j1JTbNvF4wEJZ0EFYHSB55VWnrDKJ0,fbPkOYLVPtPgIt0MxizjfFJov3JbHyAi,7,3,2,0,2,0,2,0,9,1.2857142857142858,1,0.0,0,2,0,2,3,0,0,2,0,4,5,1
7087,126805,tb2OgRXfqTZBzkHrdlQDSZ9zV3ijuuxF,fbPkOYLVPtPgIt0MxizjfFJov3JbHyAi,7,3,2,0,2,0,4,0,11,1.5714285714285714,1,0.0,0,2,0,2,3,0,0,4,0,4,7,1
7088,128989,wGXRcY0FS7DP9yn6e6xwYPxjUYuVv96W,3VkHkmOtom3jM2wCu94xgzzu1d6Dn7or,1,0,0,0,0,0,1,0,1,0.14285714285714285,1,0.0,0,0,0,0,0,0,0,1,0,0,1,1
7089,129026,QHo6eCbZPurDQOD6Hj3LGJQeeCrdfONe,3VkHkmOtom3jM2wCu94xgzzu1d6Dn7or,1,0,0,0,0,0,1,0,1,0.14285714285714285,1,0.0,0,0,0,0,0,0,0,1,0,0,1,1
7090,129028,vqyUfMHVjh3PMmyCVP9rZQOWb16mVmq4,3VkHkmOtom3jM2wCu94xgzzu1d6Dn7or,16,13,7,0,7,0,6,0,33,4.714285714285714,3,0.0,2,7,0,7,11,0,0,6,0,16,17,1
7091,129031,bK5dB6XLLefth27wEbBznMtGWWZKosCZ,3VkHkmOtom3jM2wCu94xgzzu1d6Dn7or,1,0,0,0,0,0,1,0,1,0.14285714285714285,1,0.0,0,0,0,0,0,0,0,1,0,0,1,1
7092,129042,kPX9M8mB8UxEeE9jcVhOS9PqeLggeK4l,3VkHkmOtom3jM2wCu94xgzzu1d6Dn7or,72,158,40,61,60,2,24,1,346,49.42857142857143,4,0.0,102,40,51,60,56,2,10,24,1,253,93,1
7093,129080,O7rTwuedLzkXiP070SRIZMN4LVu1Y5BM,3VkHkmOtom3jM2wCu94xgzzu1d6Dn7or,1,0,0,0,0,0,1,0,1,0.14285714285714285,1,0.0,0,0,0,0,0,0,0,1,0,0,1,1
7094,129081,xrjsm6YfbyxY5UUbMLVIqx1kBBCjFHQg,3VkHkmOtom3jM2wCu94xgzzu1d6Dn7or,4,2,1,0,1,0,2,0,6,0.8571428571428571,1,0.0,0,1,0,1,2,0,0,2,0,2,4,1
7095,129117,viyNPajhAF8K8n3Et7FkffYemVMNr8ED,3VkHkmOtom3jM2wCu94xgzzu1d6Dn7or,1,0,0,0,0,0,1,0,1,0.14285714285714285,1,0.0,0,0,0,0,0,0,0,1,0,0,1,1
7096,129160,yq5rHqpCTagxs6XCaAXxmCSySzn2U3u8,3VkHkmOtom3jM2wCu94xgzzu1d6Dn7or,1,0,0,0,0,0,1,0,1,0.14285714285714285,1,0.0,0,0,0,0,0,0,0,1,0,0,1,1
7097,129197,gQsmNIeCaoVH51itICApF5D0SGicGYzJ,3VkHkmOtom3jM2wCu94xgzzu1d6Dn7or,53,54,35,25,26,3,3,0,146,20.857142857142858,1,0.0,18,35,24,26,36,3,1,3,0,103,43,0
7098,129206,rVj6vxysUjIV1kazIkMsUDn3ShTXOA8U,3VkHkmOtom3jM2wCu94xgzzu1d6Dn7or,3,0,0,0,0,6,4,0,10,1.4285714285714286,1,0.0,0,0,0,0,0,6,0,4,0,0,10,1
7099,129239,3geK90SxF3Ka4Yp1gHRsHpT2bX3beLG8,3VkHkmOtom3jM2wCu94xgzzu1d6Dn7or,1,0,0,0,0,0,1,0,1,0.14285714285714285,1,0.0,0,0,0,0,0,0,0,1,0,0,1,1
7100,129243,BoMrnaRzWiLLbhZUihKQP6MURkcvYuJ9,3VkHkmOtom3jM2wCu94xgzzu1d6Dn7or,6,19,4,0,2,2,12,0,39,5.571428571428571,5,0.0,2,4,0,2,17,2,0,12,0,8,31,1
7101,129266,FxeUJuPs6ysWciAwjmUQ9QK1bVjyL5zJ,3VkHkmOtom3jM2wCu94xgzzu1d6Dn7or,6,1,1,0,1,2,5,1,11,1.5714285714285714,1,0.0,0,1,0,1,1,2,0,5,1,2,9,1
7102,129300,naBWlAaVhKzaB4UxMnusqlKuJq8E34Em,3VkHkmOtom3jM2wCu94xgzzu1d6Dn7or,95,226,54,107,75,3,32,5,502,71.71428571428571,7,0.0,152,54,96,75,74,3,11,32,5,377,125,0
7103,129309,D6kPXsYNeloFJlizvuS8VgDOBs1ZiXV0,3VkHkmOtom3jM2wCu94xgzzu1d6Dn7or,18,40,11,11,14,6,6,0,88,12.571428571428571,1,0.0,24,11,9,14,16,6,2,6,0,58,30,0
7104,129311,M5ernKy5CAGuMQO0T1yqEDMDeBZk6gT2,3VkHkmOtom3jM2wCu94xgzzu1d6Dn7or,1,0,0,0,0,0,2,0,2,0.2857142857142857,1,0.0,0,0,0,0,0,0,0,2,0,0,2,1
7105,129320,5teoqA7yYDJ6iOdf13CnCMC31MsySOLX,3VkHkmOtom3jM2wCu94xgzzu1d6Dn7or,8,5,4,0,4,0,1,0,14,2.0,1,0.0,0,4,0,4,5,0,0,1,0,8,6,1
7106,129321,9QiT7u9riee5JBZugpfAEC3uXfHPsvNT,3VkHkmOtom3jM2wCu94xgzzu1d6Dn7or,1,0,0,0,0,0,1,0,1,0.14285714285714285,1,0.0,0,0,0,0,0,0,0,1,0,0,1,1
7107,129345,vIx47VWIzorbn5U0gEWpmVpzO0I3garP,3VkHkmOtom3jM2wCu94xgzzu1d6Dn7or,6,6,2,0,1,0,3,0,12,1.7142857142857142,2,0.0,1,2,0,1,5,0,0,3,0,4,8,1
7108,129379,N8e8TX5f8OfPjOu3ngCuXkApyUMeZAHw,3VkHkmOtom3jM2wCu94xgzzu1d6Dn7or,7,1,0,0,0,0,7,5,13,1.8571428571428572,1,0.0,0,0,0,0,1,0,0,7,5,0,13,0
7109,129381,Ce9Cu1nB2NnV2nsci12KY71J1CUXvQNG,3VkHkmOtom3jM2wCu94xgzzu1d6Dn7or,1,0,0,0,0,0,4,0,4,0.5714285714285714,1,0.0,0,0,0,0,0,0,0,4,0,0,4,1
7110,129405,pR0rEzd43YPn1ujQN1oHxqL0z3U4G8ju,3VkHkmOtom3jM2wCu94xgzzu1d6Dn7or,1,0,0,0,0,0,1,0,1,0.14285714285714285,1,0.0,0,0,0,0,0,0,0,1,0,0,1,1
7111,129413,1wWTB4HU3MzRinvCDTb5dH3lsMHzazH1,3VkHkmOtom3jM2wCu94xgzzu1d6Dn7or,1,0,0,0,0,0,1,0,1,0.14285714285714285,1,0.0,0,0,0,0,0,0,0,1,0,0,1,1
7112,129414,embL8Tbq5qf21DkWYUrPYi30NHnJIy30,3VkHkmOtom3jM2wCu94xgzzu1d6Dn7or,6,1,1,0,1,0,3,0,6,0.8571428571428571,1,0.0,0,1,0,1,1,0,0,3,0,2,4,1
7113,129425,MG4jUeuE0KPWDpaZzVJcrXNbJRZNdqB2,3VkHkmOtom3jM2wCu94xgzzu1d6Dn7or,6,2,1,0,1,1,4,0,9,1.2857142857142858,2,0.0,0,1,0,1,2,1,0,4,0,2,7,1
7114,129434,vPf12Tl1uQJmLqMumaDi4EdOZY1gQoDQ,3VkHkmOtom3jM2wCu94xgzzu1d6Dn7or,6,3,2,0,2,0,1,0,8,1.1428571428571428,1,0.0,0,2,0,2,3,0,0,1,0,4,4,0
7115,129461,9fKCM48WCwLwvCl1vZ5Sx66ep0GEs87k,3VkHkmOtom3jM2wCu94xgzzu1d6Dn7or,48,99,26,50,17,12,14,1,219,31.285714285714285,4,0.0,29,26,50,17,70,12,0,14,1,122,97,0
7116,129520,cpI0ujfE9qc2VegGvSTGkQAzKjVboyfv,3VkHkmOtom3jM2wCu94xgzzu1d6Dn7or,4,2,1,0,1,0,1,0,5,0.7142857142857143,1,0.0,0,1,0,1,2,0,0,1,0,2,3,1
7117,129536,yXJKQRpuSTzVLxTIIubiutcR6kaMuN28,3VkHkmOtom3jM2wCu94xgzzu1d6Dn7or,1,0,0,0,0,0,1,0,1,0.14285714285714285,1,0.0,0,0,0,0,0,0,0,1,0,0,1,1
7118,129579,rvDRu9XJN8FG6L4Tz1QJEpneNN9bSp3T,5Gyp41oLVo7Gg7vF4vpmggWP5MU70QO6,5,3,1,0,1,0,1,0,6,0.8571428571428571,1,0.0,0,1,0,1,3,0,0,1,0,2,4,1
7119,129580,e69OiaWe3NlAbjDSu6TxenqA8FkyC0Xp,5Gyp41oLVo7Gg7vF4vpmggWP5MU70QO6,1,0,0,0,0,0,1,0,1,0.14285714285714285,1,0.0,0,0,0,0,0,0,0,1,0,0,1,1
7120,129601,CUEyHbsjLlbX6I7tsbnNjxFI1v5Lj4iD,5Gyp41oLVo7Gg7vF4vpmggWP5MU70QO6,12,18,7,6,2,0,6,0,39,5.571428571428571,4,0.0,3,7,3,2,15,0,3,6,0,15,24,1
7121,129640,sgp3n5bawfHVtq2l28nBhsWFsV7axBcX,5Gyp41oLVo7Gg7vF4vpmggWP5MU70QO6,12,8,5,0,2,1,8,2,26,3.7142857142857144,1,0.0,0,5,0,2,8,1,0,8,2,7,19,1
7122,129646,nxYspCMKoh1EgeU8TSzckR1n89C3pksS,5Gyp41oLVo7Gg7vF4vpmggWP5MU70QO6,8,4,1,0,1,0,6,0,12,1.7142857142857142,1,0.0,0,1,0,1,4,0,0,6,0,2,10,1
7123,129650,keJ8U0gke02i1Nqlu5m5DMRYUhjtcs9p,5Gyp41oLVo7Gg7vF4vpmggWP5MU70QO6,1,0,0,0,0,0,2,0,2,0.2857142857142857,1,0.0,0,0,0,0,0,0,0,2,0,0,2,1
7124,129659,VCcF1BG0pb9rDAtZE9QDlEi07JsyAvv0,5Gyp41oLVo7Gg7vF4vpmggWP5MU70QO6,38,85,37,0,39,88,26,11,286,40.857142857142854,2,0.0,41,37,0,39,44,88,0,26,11,117,169,0
7125,129672,5lcsln2CQflX1rHNpVSI4TBAnz24ClGg,5Gyp41oLVo7Gg7vF4vpmggWP5MU70QO6,3,0,0,0,0,0,5,0,5,0.7142857142857143,1,0.0,0,0,0,0,0,0,0,5,0,0,5,1
7126,129683,bzGwSI71FKavx1KKfw4gtgfIAR7xeSGd,5Gyp41oLVo7Gg7vF4vpmggWP5MU70QO6,21,28,14,0,8,0,6,0,56,8.0,2,0.0,0,14,0,8,28,0,0,6,0,22,34,0
7127,129685,OwHNM1X6FZRH3dfyuEBaD26lm0C9uvFE,5Gyp41oLVo7Gg7vF4vpmggWP5MU70QO6,1,0,0,0,0,0,1,0,1,0.14285714285714285,1,0.0,0,0,0,0,0,0,0,1,0,0,1,1
7128,129686,Y6pknKHCVZ8CEuDItfa44feZRRcUGvo5,5Gyp41oLVo7Gg7vF4vpmggWP5MU70QO6,6,5,1,0,1,0,2,0,9,1.2857142857142858,1,0.0,1,1,0,1,4,0,0,2,0,3,6,1
7129,129701,upQj9khHopjCTpqEAvv7wn2wHHft2R6S,5Gyp41oLVo7Gg7vF4vpmggWP5MU70QO6,7,3,2,0,2,0,2,0,9,1.2857142857142858,1,0.0,0,2,0,2,3,0,0,2,0,4,5,1
7130,129702,tLtVcoK2CUjzuLyqPUDfH9vifV5fLtIY,5Gyp41oLVo7Gg7vF4vpmggWP5MU70QO6,1,0,0,0,0,0,1,0,1,0.14285714285714285,1,0.0,0,0,0,0,0,0,0,1,0,0,1,1
7131,129718,c8utHKDVx91Sqo9Xx9dO8KITIcLfHIOU,5Gyp41oLVo7Gg7vF4vpmggWP5MU70QO6,5,3,1,0,1,0,1,0,6,0.8571428571428571,1,0.0,0,1,0,1,3,0,0,1,0,2,4,1
7132,129721,s3QR8H3FuFlDzkn72xcJDtmxJmA3dZA9,5Gyp41oLVo7Gg7vF4vpmggWP5MU70QO6,32,74,44,0,25,0,10,0,153,21.857142857142858,4,0.0,14,44,0,25,60,0,0,10,0,83,70,0
7133,129739,whxWCs3PqUO3lpi8j65TapLCue79ZU0A,5Gyp41oLVo7Gg7vF4vpmggWP5MU70QO6,3,0,0,0,0,0,4,0,4,0.5714285714285714,1,0.0,0,0,0,0,0,0,0,4,0,0,4,1
7134,129792,ci5Gz3lr84RC6CNYVu43me8PGcSphSvT,5Gyp41oLVo7Gg7vF4vpmggWP5MU70QO6,5,2,1,0,1,0,2,0,6,0.8571428571428571,1,0.0,0,1,0,1,2,0,0,2,0,2,4,1
7135,129804,yJTitpr4DIL3cTqxIQWNZFbPmpUPB9xt,5Gyp41oLVo7Gg7vF4vpmggWP5MU70QO6,1,0,0,0,0,0,1,0,1,0.14285714285714285,1,0.0,0,0,0,0,0,0,0,1,0,0,1,1
7136,129809,Dha6i4inJ8jK0OySEa9I85ooFkmSQR0f,5Gyp41oLVo7Gg7vF4vpmggWP5MU70QO6,18,25,13,10,3,7,7,0,65,9.285714285714286,7,0.0,6,13,9,3,19,7,1,7,0,31,34,1
7137,129822,C4q4gNQYEpjKh7pq1qjN8i3L7uSpUX9d,5Gyp41oLVo7Gg7vF4vpmggWP5MU70QO6,55,143,60,60,31,33,34,9,370,52.857142857142854,9,0.0,33,60,48,31,110,33,12,34,9,172,198,0
7138,129840,G6ewnesZkCYCx9FmLoCQuLhuGQlAIKz3,5Gyp41oLVo7Gg7vF4vpmggWP5MU70QO6,1,0,0,0,0,0,1,0,1,0.14285714285714285,1,0.0,0,0,0,0,0,0,0,1,0,0,1,1
7139,129841,N6XqEWJ9H7Pd7b9x8011vf67AyRVG2Hy,5Gyp41oLVo7Gg7vF4vpmggWP5MU70QO6,1,0,0,0,0,0,1,0,1,0.14285714285714285,1,0.0,0,0,0,0,0,0,0,1,0,0,1,1
7140,129871,OZaq72DmJH6bReA6lKvO4XbWYjmwsu42,5Gyp41oLVo7Gg7vF4vpmggWP5MU70QO6,11,24,10,0,5,15,13,2,69,9.857142857142858,6,0.0,2,10,0,5,22,15,0,13,2,17,52,1
7141,129872,MDKhyuLDe5vvBGQ0G0k2B0X5FpLVsFhn,5Gyp41oLVo7Gg7vF4vpmggWP5MU70QO6,8,2,2,0,2,0,3,0,9,1.2857142857142858,1,0.0,0,2,0,2,2,0,0,3,0,4,5,1
7142,129878,1ZxIq2EElt84sjQ7d0VZrg3vpxtlpcZe,5Gyp41oLVo7Gg7vF4vpmggWP5MU70QO6,1,0,0,0,0,0,1,0,1,0.14285714285714285,1,0.0,0,0,0,0,0,0,0,1,0,0,1,1
7143,129879,jTHsduF8LgX3LdRMKkbTJ0XspXdH24wv,5Gyp41oLVo7Gg7vF4vpmggWP5MU70QO6,8,5,3,0,2,0,4,0,14,2.0,4,0.0,0,3,0,2,5,0,0,4,0,5,9,1
7144,129920,inWJABZOHdPSTR3u9DIiF4psiCjCH8yf,5Gyp41oLVo7Gg7vF4vpmggWP5MU70QO6,6,5,2,0,1,0,4,0,12,1.7142857142857142,1,0.0,0,2,0,1,5,0,0,4,0,3,9,0
7145,129947,DhVdg9a1fiPo2TZQbUa7Xi0Xt11ecMm7,5Gyp41oLVo7Gg7vF4vpmggWP5MU70QO6,2,0,0,0,0,0,2,0,2,0.2857142857142857,1,0.0,0,0,0,0,0,0,0,2,0,0,2,1
7146,129949,Mkg3edlcIM5Vrzxuk3dtXhytcqCucfXI,5Gyp41oLVo7Gg7vF4vpmggWP5MU70QO6,5,2,1,0,1,0,3,0,7,1.0,1,0.0,0,1,0,1,2,0,0,3,0,2,5,0
7147,129954,hqh6ySViVHtgDq8aiHphVYPr16SuPhaK,5Gyp41oLVo7Gg7vF4vpmggWP5MU70QO6,21,38,17,18,7,1,9,2,92,13.142857142857142,4,0.0,14,17,14,7,24,1,4,9,2,52,40,0
7148,129966,x1RDUiG4hzdFvWaarIV1g7s3ecNKiDPi,5Gyp41oLVo7Gg7vF4vpmggWP5MU70QO6,12,16,6,0,3,0,4,0,29,4.142857142857143,1,0.0,0,6,0,3,16,0,0,4,0,9,20,0
7149,130026,xsgiGrnZhEwy8oG8TA0vaM6DsmjiZPXl,7GRhBDsirIGkRZBtSMEzNTyDr2JQm4xx,5,2,1,0,1,0,2,0,6,0.8571428571428571,1,0.0,0,1,0,1,2,0,0,2,0,2,4,1
7150,130033,XwOO8ac2656vyYzoHSdxVfStEQa3w4iM,7GRhBDsirIGkRZBtSMEzNTyDr2JQm4xx,10,3,2,0,2,0,12,2,21,3.0,3,0.0,0,2,0,2,3,0,0,12,2,4,17,0
7151,130035,GWG8afsUfRei9CIZYg1Y2sBsF64D5J9k,7GRhBDsirIGkRZBtSMEzNTyDr2JQm4xx,2,0,0,0,0,0,2,0,2,0.2857142857142857,1,0.0,0,0,0,0,0,0,0,2,0,0,2,1
7152,130039,Z5sEt151hX78nE6qWmPF09aVI6QGewvL,7GRhBDsirIGkRZBtSMEzNTyDr2JQm4xx,36,80,4,27,10,1,13,0,135,19.285714285714285,9,0.0,30,4,19,10,50,1,8,13,0,63,72,0
7153,130041,tlBnmsKf0J20KHkh9Qq2FoTYGO7e78wj,7GRhBDsirIGkRZBtSMEzNTyDr2JQm4xx,18,13,5,59,2,0,5,0,84,12.0,2,0.0,8,5,45,2,5,0,14,5,0,60,24,1
7154,130043,XGEZ2G0L3Qev9gwj03jnL3Sj42uCvFKQ,7GRhBDsirIGkRZBtSMEzNTyDr2JQm4xx,1,0,0,0,0,0,1,0,1,0.14285714285714285,1,0.0,0,0,0,0,0,0,0,1,0,0,1,1
7155,130047,jcZzyelmNOUxuY7TWiZZyoS3gSdLYxDW,7GRhBDsirIGkRZBtSMEzNTyDr2JQm4xx,8,5,3,0,2,3,2,0,15,2.142857142857143,1,0.0,2,3,0,2,3,3,0,2,0,7,8,1
7156,130048,YpfDBKk4h7tgq60FuSxK0f3S5bBmXXPo,7GRhBDsirIGkRZBtSMEzNTyDr2JQm4xx,79,210,81,2,103,15,3,0,414,59.142857142857146,5,0.0,122,81,1,103,88,15,1,3,0,307,107,0
7157,130049,OJM4VKDtlO7QCM03o6fe5QYYKek35kXV,7GRhBDsirIGkRZBtSMEzNTyDr2JQm4xx,36,55,22,10,19,2,9,0,117,16.714285714285715,2,0.0,25,22,5,19,30,2,5,9,0,71,46,0
7158,130051,V6I2tWMT4J6OaEfYWYGJXMvy6YbJ0vQk,7GRhBDsirIGkRZBtSMEzNTyDr2JQm4xx,34,36,13,44,0,0,2,0,95,13.571428571428571,3,0.0,13,13,43,0,23,0,1,2,0,69,26,0
7159,130052,zJ1cXp5NsbaO1h7ITMq3mqJ8kisUpMMv,7GRhBDsirIGkRZBtSMEzNTyDr2JQm4xx,41,33,8,80,11,0,0,0,132,18.857142857142858,2,0.0,24,8,71,11,9,0,9,0,0,114,18,1
7160,130053,oov2Lz1eyG9bCCe8SK6HQBH98kSF2SNU,7GRhBDsirIGkRZBtSMEzNTyDr2JQm4xx,4,5,1,0,0,0,2,0,8,1.1428571428571428,2,0.0,0,1,0,0,5,0,0,2,0,1,7,1
7161,130059,1xcKG4Eeqo6PRlQtqz4lRNBDzvKhe7qL,7GRhBDsirIGkRZBtSMEzNTyDr2JQm4xx,30,44,3,20,10,10,15,0,102,14.571428571428571,5,0.0,22,3,10,10,22,10,10,15,0,45,57,0
7162,130074,v1AqHfMoNhUox9GyIOrxftKibIp07zrt,7GRhBDsirIGkRZBtSMEzNTyDr2JQm4xx,8,6,4,0,4,0,1,0,15,2.142857142857143,1,0.0,1,4,0,4,5,0,0,1,0,9,6,1
7163,130095,WT9W6GJEVLixXgoI8DFL9RMlg4D9oeTa,7GRhBDsirIGkRZBtSMEzNTyDr2JQm4xx,23,24,10,16,8,1,7,1,67,9.571428571428571,1,0.0,12,10,8,8,12,1,8,7,1,38,29,1
7164,130113,Ohb4i5oHqjZ8IM21D8Irpch9JeRvSvVx,7GRhBDsirIGkRZBtSMEzNTyDr2JQm4xx,4,3,0,0,0,0,2,0,5,0.7142857142857143,1,0.0,0,0,0,0,3,0,0,2,0,0,5,1
7165,130126,Kt9qeiacR1tBDeKKHUR6O60ehH5pm7C9,7GRhBDsirIGkRZBtSMEzNTyDr2JQm4xx,32,42,2,40,6,1,6,0,97,13.857142857142858,3,0.0,19,2,37,6,23,1,3,6,0,64,33,1
7166,130170,bVkBiR8Ol1DpipPI05IgYIPbLOO6oZNi,7GRhBDsirIGkRZBtSMEzNTyDr2JQm4xx,59,107,29,55,31,54,17,0,293,41.857142857142854,3,0.0,35,29,46,31,72,54,9,17,0,141,152,0
7167,130194,d2YnkO2hmo3aVw6HN5hcBIHWHhDiSjB1,7GRhBDsirIGkRZBtSMEzNTyDr2JQm4xx,11,5,2,6,1,0,5,0,19,2.7142857142857144,1,0.0,2,2,3,1,3,0,3,5,0,8,11,1
7168,130205,D5GqwXfacfySSvxPJ9v7ORjiX9Oa23f1,7GRhBDsirIGkRZBtSMEzNTyDr2JQm4xx,14,12,5,6,4,1,6,0,34,4.857142857142857,2,0.0,4,5,6,4,8,1,0,6,0,19,15,1
7169,130214,k2w7Fl2HRg9SZoDIHFnK8RXCKuBBE2y7,7GRhBDsirIGkRZBtSMEzNTyDr2JQm4xx,9,7,3,4,2,0,5,0,21,3.0,1,0.0,1,3,3,2,6,0,1,5,0,9,12,1
7170,130219,qppbwIX77a7g0SZNFPbNFRfXGteVBkut,7GRhBDsirIGkRZBtSMEzNTyDr2JQm4xx,15,13,1,0,1,0,2,0,17,2.4285714285714284,1,0.0,1,1,0,1,12,0,0,2,0,3,14,1
7171,130228,itycNCCvd4Cws5pdd4hKIkDKI4KaE5Jt,7GRhBDsirIGkRZBtSMEzNTyDr2JQm4xx,1,0,0,0,0,0,1,0,1,0.14285714285714285,1,0.0,0,0,0,0,0,0,0,1,0,0,1,1
7172,130233,5iaVnotpymFcumonl8g2gZO9P5jogtd2,7GRhBDsirIGkRZBtSMEzNTyDr2JQm4xx,3,0,0,0,0,0,4,0,4,0.5714285714285714,1,0.0,0,0,0,0,0,0,0,4,0,0,4,1
7173,130239,ECkqmAuIkv3ncN9wNJby8oOn15qTd9kR,7GRhBDsirIGkRZBtSMEzNTyDr2JQm4xx,1,0,0,0,0,0,2,0,2,0.2857142857142857,2,0.0,0,0,0,0,0,0,0,2,0,0,2,0
7174,130281,Xk0aXqHKuSgZhNiXq8RgJPrtVhmUprw8,7GRhBDsirIGkRZBtSMEzNTyDr2JQm4xx,4,0,0,0,0,0,5,0,5,0.7142857142857143,1,0.0,0,0,0,0,0,0,0,5,0,0,5,1
7175,130308,EzGPRLsUlIo5IP2I72eusCvmoWbZVrJa,7GRhBDsirIGkRZBtSMEzNTyDr2JQm4xx,20,18,10,2,12,0,3,1,46,6.571428571428571,1,0.0,7,10,1,12,11,0,1,3,1,30,16,1
7176,130318,Mms6sMIkW4Omst3uLD38oJJ4C0ZCQcDW,7GRhBDsirIGkRZBtSMEzNTyDr2JQm4xx,9,16,0,0,0,0,3,0,19,2.7142857142857144,1,0.0,0,0,0,0,16,0,0,3,0,0,19,1
7177,130321,gzS6aH9DKKq1TfiY1ctxHgUplSbkMYNf,7GRhBDsirIGkRZBtSMEzNTyDr2JQm4xx,2,0,0,0,0,0,2,0,2,0.2857142857142857,1,0.0,0,0,0,0,0,0,0,2,0,0,2,1
7178,130344,SgAQznFMH2vEpxp7awjlaNSuRoraIyRm,7GRhBDsirIGkRZBtSMEzNTyDr2JQm4xx,5,1,1,0,0,0,3,0,5,0.7142857142857143,1,0.0,0,1,0,0,1,0,0,3,0,1,4,1
7179,130345,v7pdrt6SOAQ5FMXohVYmR0yZQdsegJw7,7GRhBDsirIGkRZBtSMEzNTyDr2JQm4xx,43,77,1,28,6,2,15,0,129,18.428571428571427,2,0.0,39,1,15,6,38,2,13,15,0,61,68,0
7180,130365,eVgT2CbOLxsuiNPb72WZgTO5ceO1TpuV,7GRhBDsirIGkRZBtSMEzNTyDr2JQm4xx,42,50,25,20,19,0,17,1,132,18.857142857142858,5,0.0,16,25,12,19,34,0,8,17,1,72,60,0
7181,130366,vLemTwwt8xP5QLIcPBq52mNmGrvOEG3u,7GRhBDsirIGkRZBtSMEzNTyDr2JQm4xx,5,3,2,0,0,0,2,0,7,1.0,1,0.0,0,2,0,0,3,0,0,2,0,2,5,1
7182,130380,6YiRUK7GTmmYg38edmBU3I2zGY5J1nt6,7GRhBDsirIGkRZBtSMEzNTyDr2JQm4xx,1,0,0,0,0,0,1,0,1,0.14285714285714285,1,0.0,0,0,0,0,0,0,0,1,0,0,1,1
7183,130406,VVltscgfR96aweHb5nQdD1Q7dsOwuOJz,5Gyp41oLVo7Gg7vF4vpmggWP5MU70QO6,13,56,8,8,2,0,11,0,85,12.142857142857142,7,0.0,5,8,6,2,51,0,2,11,0,21,64,1
7184,130430,bilSeR9mObpPcP1PUZ8Is5qUZjsLPMqS,5Gyp41oLVo7Gg7vF4vpmggWP5MU70QO6,20,19,0,13,4,4,6,1,47,6.714285714285714,3,0.0,2,0,8,4,17,4,5,6,1,14,33,1
7185,130431,jImHfNEIObE674KdIbKVj7cCJ4ufqzHJ,5Gyp41oLVo7Gg7vF4vpmggWP5MU70QO6,30,207,101,11,22,653,130,12,1136,162.28571428571428,12,0.0,38,101,10,22,169,653,1,130,12,171,965,1
7186,130481,z5rMlNd1woSStootPqy2Qp5Ts5VQeUHq,5Gyp41oLVo7Gg7vF4vpmggWP5MU70QO6,41,165,40,20,32,18,15,1,291,41.57142857142857,7,0.0,46,40,16,32,119,18,4,15,1,134,157,1
7187,130506,eR5PV0dYbD8ueDcYifFqdqN2AUdg11VW,5Gyp41oLVo7Gg7vF4vpmggWP5MU70QO6,7,7,2,1,1,0,7,0,18,2.5714285714285716,2,0.0,5,2,1,1,2,0,0,7,0,9,9,1
7188,130509,frKeUuwARUyvMz8S597LQJwYmVKBozSX,5Gyp41oLVo7Gg7vF4vpmggWP5MU70QO6,12,8,3,4,2,0,5,0,22,3.142857142857143,2,0.0,2,3,3,2,6,0,1,5,0,10,12,1
7189,130524,h3uJUtBmEvmKgQr2Q8BC6FJ5GRugm894,5Gyp41oLVo7Gg7vF4vpmggWP5MU70QO6,27,44,20,22,10,9,32,1,138,19.714285714285715,7,0.0,22,20,13,10,22,9,9,32,1,65,73,1
7190,130557,YVn9jdODWjYH4ISnssulh0fF4C7UEmSV,5Gyp41oLVo7Gg7vF4vpmggWP5MU70QO6,20,76,37,34,5,17,25,1,195,27.857142857142858,8,0.0,7,37,28,5,69,17,6,25,1,77,118,1
7191,130590,Vl7M6B6ZHcsJwfxY8qrbGK9Mzkw1RYzj,5Gyp41oLVo7Gg7vF4vpmggWP5MU70QO6,21,39,1,15,10,6,9,0,80,11.428571428571429,6,0.0,17,1,11,10,22,6,4,9,0,39,41,1
7192,130592,72Upod5KbmkLZabDythfsA8OtoLEgJE6,5Gyp41oLVo7Gg7vF4vpmggWP5MU70QO6,6,4,2,0,1,0,3,0,10,1.4285714285714286,1,0.0,0,2,0,1,4,0,0,3,0,3,7,1
7193,130601,ENpayG4OENRGG5E8exbUiTYpkyVQE1B4,5Gyp41oLVo7Gg7vF4vpmggWP5MU70QO6,13,23,11,0,6,0,4,0,44,6.285714285714286,2,0.0,6,11,0,6,17,0,0,4,0,23,21,1
7194,130602,tDtQGbIKD1W16PxqdlyEI8G7TTcAazQv,5Gyp41oLVo7Gg7vF4vpmggWP5MU70QO6,35,129,61,31,24,7,50,1,303,43.285714285714285,7,0.0,27,61,22,24,102,7,9,50,1,134,169,1
7195,130619,S0xcmkew9ISn4kX66Vvp2Q83evEecsY7,5Gyp41oLVo7Gg7vF4vpmggWP5MU70QO6,14,23,11,10,3,3,14,4,68,9.714285714285714,1,0.0,6,11,8,3,17,3,2,14,4,28,40,1
7196,130639,pvDccy74bXOMlvEEOXbZuBTpbP3bqi6z,5Gyp41oLVo7Gg7vF4vpmggWP5MU70QO6,15,41,4,10,12,0,11,1,79,11.285714285714286,4,0.0,5,4,7,12,36,0,3,11,1,28,51,0
7197,130655,5LjPqUcQMvx0ZAsBkoGPPYeORJ2JDTt8,5Gyp41oLVo7Gg7vF4vpmggWP5MU70QO6,18,38,20,20,10,12,11,2,113,16.142857142857142,3,0.0,11,20,15,10,27,12,5,11,2,56,57,1
7198,130656,m3T1hUISINGlAKUGxWLh1SWeWS2g3vwW,5Gyp41oLVo7Gg7vF4vpmggWP5MU70QO6,6,5,3,0,2,0,6,0,16,2.2857142857142856,2,0.0,0,3,0,2,5,0,0,6,0,5,11,0
7199,130657,B9yncBKLvS1GgfzwUEshAvwYXATyMrwA,5Gyp41oLVo7Gg7vF4vpmggWP5MU70QO6,5,5,2,0,3,0,2,0,12,1.7142857142857142,2,0.0,0,2,0,3,5,0,0,2,0,5,7,1
7200,130672,uNxXycqvM6TaaSbzDjbWtwKtomL95t5y,5Gyp41oLVo7Gg7vF4vpmggWP5MU70QO6,8,4,2,0,2,0,2,0,10,1.4285714285714286,1,0.0,0,2,0,2,4,0,0,2,0,4,6,1
7201,130683,4wGoSTuzJXBCojeNmaxk9GbR1KaCV7ql,5Gyp41oLVo7Gg7vF4vpmggWP5MU70QO6,53,228,27,78,39,11,49,7,439,62.714285714285715,13,0.0,48,27,55,39,180,11,23,49,7,169,270,0
7202,130684,Xn7qmjNToAa0VyKnSO1kny1HaDOvLlmh,5Gyp41oLVo7Gg7vF4vpmggWP5MU70QO6,10,10,6,0,3,1,12,3,35,5.0,3,0.0,0,6,0,3,10,1,0,12,3,9,26,1
7203,130691,FtmLWfuXgFTxK2NwWBKqImBR5ELSkMfl,5Gyp41oLVo7Gg7vF4vpmggWP5MU70QO6,27,46,18,40,10,4,9,1,128,18.285714285714285,6,0.0,14,18,27,10,32,4,13,9,1,69,59,1
7204,130693,YoRqoOzvuzCTaiYWYaAvvKsbRs610g1g,5Gyp41oLVo7Gg7vF4vpmggWP5MU70QO6,6,3,1,0,2,0,4,0,10,1.4285714285714286,1,0.0,0,1,0,2,3,0,0,4,0,3,7,1
7205,130717,BVAGgEW2EKxBtO91Mx2JXGMuAkZ96aI3,5Gyp41oLVo7Gg7vF4vpmggWP5MU70QO6,23,24,14,6,6,0,6,0,56,8.0,3,0.0,3,14,3,6,21,0,3,6,0,26,30,1
7206,130722,EzZp58qK2EXfSMYVozpDOT2RLEnP7Wyg,5Gyp41oLVo7Gg7vF4vpmggWP5MU70QO6,8,3,2,0,2,0,3,1,11,1.5714285714285714,1,0.0,0,2,0,2,3,0,0,3,1,4,7,1
7207,130723,P7Sqste9zYZatocGsg7sskoMOdPP5Gj1,5Gyp41oLVo7Gg7vF4vpmggWP5MU70QO6,10,14,7,0,4,0,5,0,30,4.285714285714286,2,0.0,1,7,0,4,13,0,0,5,0,12,18,1
7208,130731,7m2wO5YcqDaefqUONLXd7alpzzzbzO2U,5Gyp41oLVo7Gg7vF4vpmggWP5MU70QO6,9,9,3,8,2,0,1,0,23,3.2857142857142856,2,0.0,3,3,5,2,6,0,3,1,0,13,10,1
7209,130740,QcWlQqN59ymnFchBH8yJKMhkaLaoYrxe,5Gyp41oLVo7Gg7vF4vpmggWP5MU70QO6,14,18,10,3,4,1,10,1,47,6.714285714285714,6,0.0,1,10,2,4,17,1,1,10,1,17,30,0
7210,130775,tbSNaNTCXjjk5FJbZQdQoCO9D9WtzbXl,5Gyp41oLVo7Gg7vF4vpmggWP5MU70QO6,31,102,47,13,12,52,25,0,251,35.857142857142854,8,0.0,39,47,10,12,63,52,3,25,0,108,143,0
7211,130777,PYwEpaHAsATpUCq9rLQ9XKcLHyYqMpBU,5Gyp41oLVo7Gg7vF4vpmggWP5MU70QO6,24,61,43,16,21,7,5,0,153,21.857142857142858,10,0.0,10,43,12,21,51,7,4,5,0,86,67,1
7212,130808,tlAKUfcYPe8Fd8ANUeuNTnqfHMJlTvn5,5Gyp41oLVo7Gg7vF4vpmggWP5MU70QO6,32,110,64,18,12,25,38,1,268,38.285714285714285,8,0.0,11,64,12,12,99,25,6,38,1,99,169,1
7213,130812,oGQiEqdGpCsuqJcbVdZnpo24K0PsLrJi,5Gyp41oLVo7Gg7vF4vpmggWP5MU70QO6,10,49,8,0,0,17,13,3,90,12.857142857142858,5,0.0,31,8,0,0,18,17,0,13,3,39,51,1
7214,130818,RqdDZ59hZyptwdavZ7BebY7MyinitbUb,5Gyp41oLVo7Gg7vF4vpmggWP5MU70QO6,8,5,3,0,2,0,4,0,14,2.0,2,0.0,0,3,0,2,5,0,0,4,0,5,9,1
7215,130824,eFYXzugx3CSocMfDr913tnmbbGlpvtVI,5Gyp41oLVo7Gg7vF4vpmggWP5MU70QO6,18,24,9,6,3,2,7,4,55,7.857142857142857,1,0.0,7,9,3,3,17,2,3,7,4,22,33,1
7216,130841,udMhHHYhrWPSXlHAeBMBnxFP5fCV1rfY,5Gyp41oLVo7Gg7vF4vpmggWP5MU70QO6,2,0,0,0,0,0,3,0,3,0.42857142857142855,2,0.0,0,0,0,0,0,0,0,3,0,0,3,1
7217,130846,OGP50ek5EQjpi2zh30ktLm4U34Pswm87,5Gyp41oLVo7Gg7vF4vpmggWP5MU70QO6,14,18,9,18,3,12,7,0,67,9.571428571428571,4,0.0,4,9,11,3,14,12,7,7,0,27,40,1
7218,130861,27KU7J0xhwne5RAwWlMtoP7JA6sMyYoP,5Gyp41oLVo7Gg7vF4vpmggWP5MU70QO6,13,13,6,7,2,0,3,0,31,4.428571428571429,2,0.0,3,6,5,2,10,0,2,3,0,16,15,1
7219,130875,Tp8JPIsnyTxn7ayN9BTTjHy1pMsJa0Vc,5Gyp41oLVo7Gg7vF4vpmggWP5MU70QO6,1,0,0,0,0,0,1,0,1,0.14285714285714285,1,0.0,0,0,0,0,0,0,0,1,0,0,1,1
7220,130883,AzwZEXamtdgLpo6unNtxDELRunLHhXR8,5Gyp41oLVo7Gg7vF4vpmggWP5MU70QO6,18,45,17,18,11,4,15,1,111,15.857142857142858,3,0.0,9,17,14,11,36,4,4,15,1,51,60,1
7221,130896,kYfOIu5uflk2rQ8wLoaBsOg3FtspwBHu,5Gyp41oLVo7Gg7vF4vpmggWP5MU70QO6,4,2,0,0,2,0,3,0,7,1.0,1,0.0,0,0,0,2,2,0,0,3,0,2,5,1
7222,130903,WI9rk8aS11tBAJzjcX0JSIgomYYRQVjW,5Gyp41oLVo7Gg7vF4vpmggWP5MU70QO6,12,8,6,0,4,1,5,1,25,3.5714285714285716,1,0.0,1,6,0,4,7,1,0,5,1,11,14,1
7223,130928,P0jTr6KeEArwoDtyTCyFDVA7APW9Mr2X,5Gyp41oLVo7Gg7vF4vpmggWP5MU70QO6,1,0,0,0,0,0,1,0,1,0.14285714285714285,1,0.0,0,0,0,0,0,0,0,1,0,0,1,1
7224,130943,RuS9pbpGiIPFu0lqA2IZoNwqWqyO5edb,5Gyp41oLVo7Gg7vF4vpmggWP5MU70QO6,23,70,31,0,18,17,22,8,166,23.714285714285715,7,0.0,26,31,0,18,44,17,0,22,8,75,91,1
7225,130958,P3P2f1k41OHmAOZyTHWhlLrinAgXyMwc,5Gyp41oLVo7Gg7vF4vpmggWP5MU70QO6,45,55,29,159,4,14,16,0,277,39.57142857142857,4,0.0,20,29,139,4,35,14,20,16,0,192,85,1
7226,130967,Qnzs7MQvDdrlT4xr5UXbcEcJunB4iJGk,5Gyp41oLVo7Gg7vF4vpmggWP5MU70QO6,5,1,1,0,1,0,3,0,6,0.8571428571428571,1,0.0,0,1,0,1,1,0,0,3,0,2,4,1
7227,130971,VVPQtMkwOc5Rpx6fMA3qUfZufjuUWJdd,5Gyp41oLVo7Gg7vF4vpmggWP5MU70QO6,8,18,0,7,1,0,1,0,27,3.857142857142857,1,0.0,13,0,5,1,5,0,2,1,0,19,8,1
7228,131008,zNnqmF2sQm5pVrk4EjykARlvIbp0hTq0,5Gyp41oLVo7Gg7vF4vpmggWP5MU70QO6,13,26,14,6,4,14,15,0,79,11.285714285714286,3,0.0,6,14,5,4,20,14,1,15,0,29,50,1
7229,131016,rC4Pc8SlsYV1vuCEoQDOK6VUDBUpjTvY,5Gyp41oLVo7Gg7vF4vpmggWP5MU70QO6,4,2,1,0,1,0,2,0,6,0.8571428571428571,1,0.0,0,1,0,1,2,0,0,2,0,2,4,1
7230,131025,g9c2xUyd7tiFCZxNiP08zbr6vrteI2C3,5Gyp41oLVo7Gg7vF4vpmggWP5MU70QO6,18,32,29,0,8,0,10,0,79,11.285714285714286,3,0.0,0,29,0,8,32,0,0,10,0,37,42,1
7231,131032,0QSMkT1dSojdga3gOUuLnnXcPZoPeqgp,5Gyp41oLVo7Gg7vF4vpmggWP5MU70QO6,9,8,6,6,4,0,2,0,26,3.7142857142857144,1,0.0,1,6,3,4,7,0,3,2,0,14,12,1
7232,131066,L2ebvKGgpcX4BC43tbs0EBdlfqS17H7s,5Gyp41oLVo7Gg7vF4vpmggWP5MU70QO6,15,25,11,0,4,4,24,2,70,10.0,3,0.0,2,11,0,4,23,4,0,24,2,17,53,1
7233,131086,LbIxn9M7zi5eJAVKHJk4SUmWIrBjRpyC,5Gyp41oLVo7Gg7vF4vpmggWP5MU70QO6,32,69,44,26,11,11,12,8,181,25.857142857142858,7,0.0,17,44,16,11,52,11,10,12,8,88,93,1
7234,131103,v8EL49Rw5uIBfTnluJIiynUhJSONuHZw,5Gyp41oLVo7Gg7vF4vpmggWP5MU70QO6,19,50,13,8,1,0,8,1,81,11.571428571428571,5,0.0,13,13,5,1,37,0,3,8,1,32,49,1
7235,131121,UG5RbMOVznG8udS8GWsbT5jzf3cvnOYI,5Gyp41oLVo7Gg7vF4vpmggWP5MU70QO6,5,3,2,0,1,0,1,0,7,1.0,1,0.0,0,2,0,1,3,0,0,1,0,3,4,1
7236,131151,bqWpav7ocOhCfb3xc4QgAvBDK5g8BmiZ,5Gyp41oLVo7Gg7vF4vpmggWP5MU70QO6,26,73,34,19,37,21,21,3,208,29.714285714285715,5,0.0,32,34,13,37,41,21,6,21,3,116,92,1
7237,131154,NZr7ZreoMfrfsvmVD8zC4zd8vweniEIo,5Gyp41oLVo7Gg7vF4vpmggWP5MU70QO6,13,23,10,6,4,6,14,0,63,9.0,2,0.0,5,10,4,4,18,6,2,14,0,23,40,1
7238,131161,h4WGgOBVQGLmMIXc7haVdsTOd5L5ucTp,5Gyp41oLVo7Gg7vF4vpmggWP5MU70QO6,4,2,1,0,0,1,2,1,7,1.0,1,0.0,0,1,0,0,2,1,0,2,1,1,6,1
7239,131175,L8lHLh6Mth1S7I3sErP5oDZD885a1BOh,5Gyp41oLVo7Gg7vF4vpmggWP5MU70QO6,26,48,22,9,8,24,19,0,130,18.571428571428573,6,0.0,18,22,7,8,30,24,2,19,0,55,75,1
7240,131185,VAPb5dw6WtnSykbRSlbEIs6DWlruq9Fk,5Gyp41oLVo7Gg7vF4vpmggWP5MU70QO6,1,0,0,0,0,0,1,0,1,0.14285714285714285,1,0.0,0,0,0,0,0,0,0,1,0,0,1,1
7241,131197,1BUzzAo0Z6oAutmyjoxe5eSgUumBRi8v,5Gyp41oLVo7Gg7vF4vpmggWP5MU70QO6,3,2,1,0,0,1,1,0,5,0.7142857142857143,1,0.0,0,1,0,0,2,1,0,1,0,1,4,1
7242,131203,X4C2nx3UVUJgm6ZryQmz9YJ8R87beh5i,5Gyp41oLVo7Gg7vF4vpmggWP5MU70QO6,8,4,2,0,3,0,2,0,11,1.5714285714285714,1,0.0,1,2,0,3,3,0,0,2,0,6,5,1
7243,131207,DD3RB9vWEpLhfNx2699s29qSfhYix0qh,5Gyp41oLVo7Gg7vF4vpmggWP5MU70QO6,8,6,4,0,3,0,3,0,16,2.2857142857142856,1,0.0,0,4,0,3,6,0,0,3,0,7,9,1
7244,131218,uKuE1pqPLKBLlaDHpMsHUJvLz6lxiokY,5Gyp41oLVo7Gg7vF4vpmggWP5MU70QO6,8,20,7,0,2,0,11,0,40,5.714285714285714,6,0.0,0,7,0,2,20,0,0,11,0,9,31,1
7245,131253,Tvd2bCFlWrRCvuUw3oRJ0Jgdh4hPpig5,5Gyp41oLVo7Gg7vF4vpmggWP5MU70QO6,24,31,1,0,12,0,11,2,57,8.142857142857142,3,0.0,1,1,0,12,30,0,0,11,2,14,43,1
7246,131273,SqgJOgaP4pFZ2p8zfRA0U72LErM41cgu,5Gyp41oLVo7Gg7vF4vpmggWP5MU70QO6,10,8,4,0,5,2,7,1,27,3.857142857142857,1,0.0,2,4,0,5,6,2,0,7,1,11,16,1
7247,131274,dWr5zNgWfiFnNbhTePYEGNlYVTa6QiXF,5Gyp41oLVo7Gg7vF4vpmggWP5MU70QO6,25,44,29,17,8,6,21,1,126,18.0,6,0.0,3,29,11,8,41,6,6,21,1,51,75,1
7248,131289,emctPMiDvkxJz5RzkFwPKDxs9Mbgtxhm,5Gyp41oLVo7Gg7vF4vpmggWP5MU70QO6,16,19,1,11,3,5,9,1,49,7.0,3,0.0,6,1,9,3,13,5,2,9,1,19,30,1
7249,131308,YAOH779hblcwv4rEXplae8dobLTCbNL7,5Gyp41oLVo7Gg7vF4vpmggWP5MU70QO6,9,14,3,9,2,0,1,0,29,4.142857142857143,1,0.0,10,3,6,2,4,0,3,1,0,21,8,1
7250,131320,3BitdRzRFgj4ua4IH2jOKy9wxW0orDjs,5Gyp41oLVo7Gg7vF4vpmggWP5MU70QO6,25,40,22,18,11,0,8,0,99,14.142857142857142,5,0.0,11,22,12,11,29,0,6,8,0,56,43,1
7251,131367,wk03KQOcp9ENxMFqWwXTeb33Zq9dBs9v,5Gyp41oLVo7Gg7vF4vpmggWP5MU70QO6,13,28,14,10,9,0,5,0,66,9.428571428571429,2,0.0,10,14,6,9,18,0,4,5,0,39,27,1
7252,131370,uT81Ni5WobE49DtbtOYKsHp3O02xlZuC,5Gyp41oLVo7Gg7vF4vpmggWP5MU70QO6,4,2,1,0,1,0,1,0,5,0.7142857142857143,1,0.0,0,1,0,1,2,0,0,1,0,2,3,1
7253,131383,YCItyuScKutYm9NH0VZVrLSZhJ4BWiOI,5Gyp41oLVo7Gg7vF4vpmggWP5MU70QO6,29,69,34,20,14,3,16,0,156,22.285714285714285,6,0.0,15,34,15,14,54,3,5,16,0,78,78,0
7254,131391,QPoypIc1fBONo2zEXZGrqFPP68plPMOG,5Gyp41oLVo7Gg7vF4vpmggWP5MU70QO6,48,77,36,28,37,1,23,1,203,29.0,6,0.0,28,36,19,37,49,1,9,23,1,120,83,1
7255,131408,bP4doJ33skv60jUwMG3ksI1SOLMo5v6M,5Gyp41oLVo7Gg7vF4vpmggWP5MU70QO6,1,0,0,0,0,0,1,0,1,0.14285714285714285,1,0.0,0,0,0,0,0,0,0,1,0,0,1,1
7256,131419,P0rhRDVe1EcDkj0SvoOB5GNxqem9hFvy,5Gyp41oLVo7Gg7vF4vpmggWP5MU70QO6,14,37,18,18,8,9,9,0,99,14.142857142857142,7,0.0,9,18,13,8,28,9,5,9,0,48,51,0
7257,131429,OJscREFZ2I30mlxoCsbPJEVsdd0F4XgB,5Gyp41oLVo7Gg7vF4vpmggWP5MU70QO6,10,7,5,0,2,2,6,0,22,3.142857142857143,2,0.0,0,5,0,2,7,2,0,6,0,7,15,1
7258,131432,hN36MWe31guSb7pSDaWhTmCCv4ltTr0z,5Gyp41oLVo7Gg7vF4vpmggWP5MU70QO6,6,6,3,0,1,0,4,0,14,2.0,2,0.0,0,3,0,1,6,0,0,4,0,4,10,1
7259,131442,EaDnLkVMEsYfdUTQmjKMTMipeDYtU7tW,5Gyp41oLVo7Gg7vF4vpmggWP5MU70QO6,5,2,1,0,1,0,3,0,7,1.0,2,0.0,0,1,0,1,2,0,0,3,0,2,5,1
7260,131455,H6wVUr01scr0KSyeWOeZJo6Ppyqo4vfx,5Gyp41oLVo7Gg7vF4vpmggWP5MU70QO6,15,15,10,7,7,3,6,0,48,6.857142857142857,2,0.0,2,10,4,7,13,3,3,6,0,23,25,1
7261,131460,JFKX7aipG9ohO3LoTtLaVlpaWRUwxfwA,5Gyp41oLVo7Gg7vF4vpmggWP5MU70QO6,11,10,6,0,2,0,4,0,22,3.142857142857143,3,0.0,1,6,0,2,9,0,0,4,0,9,13,1
7262,131464,DRhlp1eJHQqsxjCL0bRD6kkHN20HbJ4w,5Gyp41oLVo7Gg7vF4vpmggWP5MU70QO6,7,5,3,0,2,0,2,0,12,1.7142857142857142,2,0.0,0,3,0,2,5,0,0,2,0,5,7,1
7263,131483,zvVFDTjz1IMLrQSJ5FVA60EmZ6t1TpeJ,5Gyp41oLVo7Gg7vF4vpmggWP5MU70QO6,6,5,3,0,2,0,3,0,13,1.8571428571428572,1,0.0,0,3,0,2,5,0,0,3,0,5,8,1
7264,131499,x3ZcCHvytIJQEMLj5E05tgfA0i9bCC3E,5Gyp41oLVo7Gg7vF4vpmggWP5MU70QO6,9,7,4,0,2,1,7,1,22,3.142857142857143,2,0.0,0,4,0,2,7,1,0,7,1,6,16,1
7265,131514,s1TeLy1FGEb0X1vS2VTZ5I3G8yYusIJM,5Gyp41oLVo7Gg7vF4vpmggWP5MU70QO6,1,0,0,0,0,0,1,0,1,0.14285714285714285,1,0.0,0,0,0,0,0,0,0,1,0,0,1,0
7266,131521,D9VUUHG8JE4zHfpiuvARnOVEhmtfjBRZ,5Gyp41oLVo7Gg7vF4vpmggWP5MU70QO6,6,3,0,0,2,0,1,0,6,0.8571428571428571,1,0.0,0,0,0,2,3,0,0,1,0,2,4,1
7267,131532,CC63ymfgF4EYO3IIdOkBcne8yDI17q8n,5Gyp41oLVo7Gg7vF4vpmggWP5MU70QO6,12,11,6,0,5,0,4,0,26,3.7142857142857144,2,0.0,0,6,0,5,11,0,0,4,0,11,15,1
7268,131545,2s1w2v8MgoByNGqR51pltJWsiHzHAFZ1,5Gyp41oLVo7Gg7vF4vpmggWP5MU70QO6,13,20,12,5,6,0,4,0,47,6.714285714285714,4,0.0,4,12,3,6,16,0,2,4,0,25,22,1
7269,131548,Q6FiYurGL03EdY7pGI3iMkFDIkxD4zO6,5Gyp41oLVo7Gg7vF4vpmggWP5MU70QO6,15,24,13,6,4,5,15,2,69,9.857142857142858,4,0.0,5,13,4,4,19,5,2,15,2,26,43,1
7270,131555,wXFfHtwd9smrvhh9NQW7SmEEo1001LDW,5Gyp41oLVo7Gg7vF4vpmggWP5MU70QO6,18,41,19,11,9,14,24,3,121,17.285714285714285,10,0.0,9,19,7,9,32,14,4,24,3,44,77,0
7271,131556,PTYhYCx0lXKOfswUXa0bNi4VYNIzIve4,5Gyp41oLVo7Gg7vF4vpmggWP5MU70QO6,10,3,2,0,2,5,6,1,19,2.7142857142857144,1,0.0,0,2,0,2,3,5,0,6,1,4,15,1
7272,131558,IgexhZ9xriCDdGfY04wPYqqhzLtdPh8J,5Gyp41oLVo7Gg7vF4vpmggWP5MU70QO6,24,43,25,4,8,1,9,0,90,12.857142857142858,4,0.0,11,25,3,8,32,1,1,9,0,47,43,1
7273,131579,D8q3p28oNnCDKOIbiGQbgveHVNlF4K29,5Gyp41oLVo7Gg7vF4vpmggWP5MU70QO6,31,79,39,1,23,0,13,0,155,22.142857142857142,6,0.0,22,39,1,23,57,0,0,13,0,85,70,1
7274,131604,wOfyVIJKuk4vmpOTIf49KeZ8OsxoFrNZ,5Gyp41oLVo7Gg7vF4vpmggWP5MU70QO6,9,13,5,1,1,0,5,0,25,3.5714285714285716,3,0.0,3,5,1,1,10,0,0,5,0,10,15,1
7275,131608,xUjsmVq4wk1vW0iAypz5SwAatQZxGZJN,5Gyp41oLVo7Gg7vF4vpmggWP5MU70QO6,9,11,2,8,2,0,1,0,24,3.4285714285714284,1,0.0,3,2,5,2,8,0,3,1,0,12,12,1
7276,131610,BFrfDseDfXCBvtTfCsJAy36Ogk6b0Rfx,5Gyp41oLVo7Gg7vF4vpmggWP5MU70QO6,16,30,19,0,4,0,5,0,58,8.285714285714286,5,0.0,0,19,0,4,30,0,0,5,0,23,35,0
7277,131616,ww05exVvqmTpHRLpMlcyyiyf25IJQarF,5Gyp41oLVo7Gg7vF4vpmggWP5MU70QO6,11,34,22,0,11,0,13,0,80,11.428571428571429,6,0.0,0,22,0,11,34,0,0,13,0,33,47,1
7278,131619,HK63snN9qbxmD5swy0CbmdWWUnBqMpfV,5Gyp41oLVo7Gg7vF4vpmggWP5MU70QO6,12,9,4,5,5,0,5,2,30,4.285714285714286,2,0.0,4,4,3,5,5,0,2,5,2,16,14,1
7279,131634,G461L6IqW9kRppIDUrOTTZPYwnPenSFz,5Gyp41oLVo7Gg7vF4vpmggWP5MU70QO6,19,38,16,9,8,3,14,0,88,12.571428571428571,4,0.0,15,16,7,8,23,3,2,14,0,46,42,1
7280,131646,hefQlDeoTkFAJkCwSIMRgQRBdm5PYiVH,5Gyp41oLVo7Gg7vF4vpmggWP5MU70QO6,1,0,0,0,0,0,3,0,3,0.42857142857142855,2,0.0,0,0,0,0,0,0,0,3,0,0,3,1
7281,131658,KIgAXwSSNMrV9xvvWDPKGpC4t6I5z7W3,5Gyp41oLVo7Gg7vF4vpmggWP5MU70QO6,9,11,2,4,2,0,3,0,22,3.142857142857143,2,0.0,3,2,2,2,8,0,2,3,0,9,13,1
7282,131683,CSh5hGbaSFu2yCb31iVMOVwKocrH471Q,5Gyp41oLVo7Gg7vF4vpmggWP5MU70QO6,12,28,8,0,6,0,9,1,52,7.428571428571429,4,0.0,9,8,0,6,19,0,0,9,1,23,29,1
7283,131704,pgpJvSAjsHKd3kT9nQoOTfo24SVV2VIt,5Gyp41oLVo7Gg7vF4vpmggWP5MU70QO6,15,28,9,0,3,1,9,0,50,7.142857142857143,4,0.0,2,9,0,3,26,1,0,9,0,14,36,1
7284,131717,pzpWAA9mk4uNhMIFCnnenGE5a1mdDNf3,5Gyp41oLVo7Gg7vF4vpmggWP5MU70QO6,31,64,44,37,14,0,15,0,174,24.857142857142858,3,0.0,9,44,25,14,55,0,12,15,0,92,82,1
7285,131768,nWqxqrZieFu5PiKqDCSzyLuUaohKvtIs,5Gyp41oLVo7Gg7vF4vpmggWP5MU70QO6,13,7,5,4,4,0,5,1,26,3.7142857142857144,1,0.0,1,5,2,4,6,0,2,5,1,12,14,1
7286,131772,qKB2XQNbRVqqDMhQPlQh48h20NofWfSV,5Gyp41oLVo7Gg7vF4vpmggWP5MU70QO6,1,0,0,0,0,0,1,0,1,0.14285714285714285,1,0.0,0,0,0,0,0,0,0,1,0,0,1,1
7287,131774,p6SfsKU1ItjlJAGItngkr3XWispWnBPx,5Gyp41oLVo7Gg7vF4vpmggWP5MU70QO6,72,225,112,124,48,47,25,1,582,83.14285714285714,8,0.0,83,112,92,48,142,47,32,25,1,335,247,0
7288,131784,9DudB7SDh1sCxzok7LxIa0mk2N4qIA3p,5Gyp41oLVo7Gg7vF4vpmggWP5MU70QO6,13,16,12,0,8,0,3,0,39,5.571428571428571,2,0.0,0,12,0,8,16,0,0,3,0,20,19,0
7289,131794,odgZyA83xPYS0Ppo5I8WTTJmNdIGI867,5Gyp41oLVo7Gg7vF4vpmggWP5MU70QO6,1,0,0,0,0,0,1,0,1,0.14285714285714285,1,0.0,0,0,0,0,0,0,0,1,0,0,1,1
7290,131826,iDAI1Vho9XZTTivESwKNINgCsnyoVvF9,5Gyp41oLVo7Gg7vF4vpmggWP5MU70QO6,6,4,3,0,1,0,2,0,10,1.4285714285714286,1,0.0,0,3,0,1,4,0,0,2,0,4,6,1
7291,131847,I6LjJf7gac8MetwrPjXxym7t0NixHmVY,5Gyp41oLVo7Gg7vF4vpmggWP5MU70QO6,25,102,42,10,26,28,33,4,245,35.0,6,0.0,23,42,7,26,79,28,3,33,4,98,147,1
7292,131866,6MpBt1ikbHLEMzYvCtOKVw0lV31pnZtK,5Gyp41oLVo7Gg7vF4vpmggWP5MU70QO6,11,29,16,3,9,0,8,0,65,9.285714285714286,5,0.0,2,16,2,9,27,0,1,8,0,29,36,1
7293,131869,KT5lan1W2tpQSImfn2FRNqdsy6GrGc1j,5Gyp41oLVo7Gg7vF4vpmggWP5MU70QO6,10,8,4,0,4,4,10,3,33,4.714285714285714,2,0.0,2,4,0,4,6,4,0,10,3,10,23,1
7294,131874,lfEnOibu2rkQo0inX5gNisoEBgLAfH8d,5Gyp41oLVo7Gg7vF4vpmggWP5MU70QO6,8,4,3,0,3,0,1,0,11,1.5714285714285714,1,0.0,0,3,0,3,4,0,0,1,0,6,5,1
7295,131877,xY7Egq7HpAqbXGGKweN3pllHOWoiO1V5,5Gyp41oLVo7Gg7vF4vpmggWP5MU70QO6,6,3,2,0,1,0,2,0,8,1.1428571428571428,1,0.0,0,2,0,1,3,0,0,2,0,3,5,1
7296,131896,BDftrCCcwc58ghs1NH41Jo6ySFdVhm4G,5Gyp41oLVo7Gg7vF4vpmggWP5MU70QO6,24,49,27,19,6,1,15,0,117,16.714285714285715,5,0.0,6,27,12,6,43,1,7,15,0,51,66,0
7297,131904,RKevUFoWjA4gBXEFiCKb5AP4PJvgxsMD,5Gyp41oLVo7Gg7vF4vpmggWP5MU70QO6,8,6,3,0,3,0,3,0,15,2.142857142857143,2,0.0,2,3,0,3,4,0,0,3,0,8,7,1
7298,131905,fYlMJFRbxFagGbb5ktu9JqLCT7VrJ7D2,5Gyp41oLVo7Gg7vF4vpmggWP5MU70QO6,7,5,4,0,3,0,2,0,14,2.0,1,0.0,0,4,0,3,5,0,0,2,0,7,7,1
7299,131909,GNrTu0wsmzabBYmg0mo2K8b2CbSRTSSW,5Gyp41oLVo7Gg7vF4vpmggWP5MU70QO6,29,85,36,29,10,19,27,0,206,29.428571428571427,8,0.0,27,36,19,10,58,19,10,27,0,92,114,0
7300,131913,upRu9nrHp4NUCGUbqZPoDIFEKbWtFzvh,5Gyp41oLVo7Gg7vF4vpmggWP5MU70QO6,1,0,0,0,0,0,1,0,1,0.14285714285714285,1,0.0,0,0,0,0,0,0,0,1,0,0,1,1
7301,131916,lM0ucDVFeyYkJQk3xrGXENajqWkqmPdx,5Gyp41oLVo7Gg7vF4vpmggWP5MU70QO6,8,3,2,0,1,3,5,0,14,2.0,1,0.0,0,2,0,1,3,3,0,5,0,3,11,1
7302,131929,4NUGABfnQkRS9FoH90Vgnhdha4tRSmOB,5Gyp41oLVo7Gg7vF4vpmggWP5MU70QO6,7,6,4,0,3,0,2,0,15,2.142857142857143,2,0.0,0,4,0,3,6,0,0,2,0,7,8,1
7303,131948,nH0lkFol42tc1HdPy0iz2y4LpmqwxJvr,5Gyp41oLVo7Gg7vF4vpmggWP5MU70QO6,23,60,19,7,4,14,15,5,124,17.714285714285715,5,0.0,10,19,6,4,50,14,1,15,5,39,85,1
7304,131966,AK9AYLB4kIemtKYLZfiWKFUQw90dJSvG,5Gyp41oLVo7Gg7vF4vpmggWP5MU70QO6,1,0,0,0,0,0,1,0,1,0.14285714285714285,1,0.0,0,0,0,0,0,0,0,1,0,0,1,1
7305,131973,WDMP5c2Ubx8vVSFegA0mXeU23cYb0qCY,5Gyp41oLVo7Gg7vF4vpmggWP5MU70QO6,22,21,12,0,9,3,5,1,51,7.285714285714286,2,0.0,2,12,0,9,19,3,0,5,1,23,28,1
7306,131974,eeYgUeHIQERDYwF1mxwVIZYsVaVSgwlV,5Gyp41oLVo7Gg7vF4vpmggWP5MU70QO6,34,151,84,28,15,45,42,1,366,52.285714285714285,8,0.0,25,84,19,15,126,45,9,42,1,143,223,1
7307,131985,UvXzL0vUPrxaxHA5h9pxdKMGm9qnxElT,5Gyp41oLVo7Gg7vF4vpmggWP5MU70QO6,7,5,4,0,3,0,1,0,13,1.8571428571428572,1,0.0,0,4,0,3,5,0,0,1,0,7,6,1
7308,131988,SfvT6FHCLeajKH96s2LkoIO8YQ9sAqIE,5Gyp41oLVo7Gg7vF4vpmggWP5MU70QO6,10,4,4,7,2,0,9,0,26,3.7142857142857144,1,0.0,0,4,4,2,4,0,3,9,0,10,16,1
7309,131999,aPVDb4sNGwKLaY1hfU7JY9uA4JfVNNbx,5Gyp41oLVo7Gg7vF4vpmggWP5MU70QO6,9,3,2,0,2,0,6,1,14,2.0,1,0.0,0,2,0,2,3,0,0,6,1,4,10,1
7310,132016,hFtcfhyjjjBDieZaGgPB0PH2Awp8ntcE,5Gyp41oLVo7Gg7vF4vpmggWP5MU70QO6,4,4,0,0,0,0,3,0,7,1.0,2,0.0,0,0,0,0,4,0,0,3,0,0,7,1
7311,132051,bxybXAkYqJdxWDLSPlh74sjGoIJub8gI,5Gyp41oLVo7Gg7vF4vpmggWP5MU70QO6,20,45,29,15,12,26,21,2,150,21.428571428571427,4,0.0,6,29,11,12,39,26,4,21,2,58,92,1
7312,132072,lcxEu4F2dIRGolbGM8J7dkDro6hPXvBJ,5Gyp41oLVo7Gg7vF4vpmggWP5MU70QO6,10,12,7,0,3,0,6,0,28,4.0,4,0.0,1,7,0,3,11,0,0,6,0,11,17,1
7313,132073,PaukganhsE4s0igvkxOHXQMS87FhGsNK,5Gyp41oLVo7Gg7vF4vpmggWP5MU70QO6,5,3,1,0,1,0,3,0,8,1.1428571428571428,1,0.0,0,1,0,1,3,0,0,3,0,2,6,0
7314,132083,X4KSPkBIdPEeXdEy4Fa5NvixCQZdfNj3,5Gyp41oLVo7Gg7vF4vpmggWP5MU70QO6,9,16,8,0,2,0,7,0,33,4.714285714285714,5,0.0,0,8,0,2,16,0,0,7,0,10,23,1
7315,132085,feNPir78VVJeRswqjlWE2OxH2LDmYPpA,5Gyp41oLVo7Gg7vF4vpmggWP5MU70QO6,4,0,0,0,0,2,3,3,8,1.1428571428571428,1,0.0,0,0,0,0,0,2,0,3,3,0,8,1
7316,132107,EjwuVaTggwTtvS9pkP7PgQgHWsuSl5LH,5Gyp41oLVo7Gg7vF4vpmggWP5MU70QO6,16,23,13,7,8,3,14,2,70,10.0,2,0.0,4,13,6,8,19,3,1,14,2,31,39,1
7317,132119,kAQFM0dEgOQIxOG9jTMe5puRtNxZZWMN,5Gyp41oLVo7Gg7vF4vpmggWP5MU70QO6,14,21,10,14,2,0,2,0,49,7.0,2,0.0,9,10,9,2,12,0,5,2,0,30,19,1
7318,132120,vDpzh3zahVtaOFqzE17Za28Atm0h0iTn,5Gyp41oLVo7Gg7vF4vpmggWP5MU70QO6,5,2,1,0,1,0,3,0,7,1.0,1,0.0,0,1,0,1,2,0,0,3,0,2,5,1
7319,132127,DUlJiICKk2WTix9aZC2LySN8fBhR1R6j,5Gyp41oLVo7Gg7vF4vpmggWP5MU70QO6,7,4,1,0,1,0,3,1,10,1.4285714285714286,1,0.0,0,1,0,1,4,0,0,3,1,2,8,1
7320,132131,Ov1eEIsyiq4NpsQyBb4m5rDEEYvFdikk,5Gyp41oLVo7Gg7vF4vpmggWP5MU70QO6,7,3,2,0,2,0,2,0,9,1.2857142857142858,1,0.0,0,2,0,2,3,0,0,2,0,4,5,1
7321,132159,fA5v1LpeiBHoiljToqVDWTjlSPX5We7J,5Gyp41oLVo7Gg7vF4vpmggWP5MU70QO6,30,37,4,12,5,23,16,1,98,14.0,6,0.0,5,4,8,5,32,23,4,16,1,22,76,1
7322,132189,soWGR1SawLCzN6cibKKzyucjERyiqFtX,5Gyp41oLVo7Gg7vF4vpmggWP5MU70QO6,13,13,8,2,4,0,8,0,35,5.0,1,0.0,1,8,1,4,12,0,1,8,0,14,21,1
7323,132259,NBO0yNvnHWn0H2rwDHJWaDKXLarWBIxP,5Gyp41oLVo7Gg7vF4vpmggWP5MU70QO6,5,1,1,0,1,0,2,0,5,0.7142857142857143,1,0.0,0,1,0,1,1,0,0,2,0,2,3,1
7324,132267,y1wesbVvgs3ixRYIB7nEK595dCq4m0ql,5Gyp41oLVo7Gg7vF4vpmggWP5MU70QO6,14,13,7,10,4,0,5,0,39,5.571428571428571,2,0.0,2,7,6,4,11,0,4,5,0,19,20,1
7325,132293,8f874eWGU5uAHPVWKUx2IReY71ci0kSY,5Gyp41oLVo7Gg7vF4vpmggWP5MU70QO6,39,50,22,11,17,7,19,0,126,18.0,5,0.0,25,22,11,17,25,7,0,19,0,75,51,1
7326,132296,Gymn0DusIH3v58mQ2B78566w329hD5p0,5Gyp41oLVo7Gg7vF4vpmggWP5MU70QO6,1,0,0,0,0,0,1,0,1,0.14285714285714285,1,0.0,0,0,0,0,0,0,0,1,0,0,1,1
7327,132307,13YFV8lBcWdo0oc2jiupTdAnWOuzwYbw,5Gyp41oLVo7Gg7vF4vpmggWP5MU70QO6,21,43,23,4,13,4,12,1,100,14.285714285714286,4,0.0,10,23,2,13,33,4,2,12,1,48,52,1
7328,132320,mwLZNpLHscHAOslKyQsPop6UIX5aSty3,5Gyp41oLVo7Gg7vF4vpmggWP5MU70QO6,9,4,3,0,3,0,2,1,13,1.8571428571428572,1,0.0,0,3,0,3,4,0,0,2,1,6,7,1
7329,132332,boaUpp9caIOmNwHhM4OMeLQDu0K6DUm2,5Gyp41oLVo7Gg7vF4vpmggWP5MU70QO6,8,8,3,5,2,0,3,0,21,3.0,1,0.0,3,3,4,2,5,0,1,3,0,12,9,1
7330,132342,g7OVRMshhiJLWezGVm8ZCxzqx4keijVJ,5Gyp41oLVo7Gg7vF4vpmggWP5MU70QO6,6,6,4,0,3,0,1,0,14,2.0,1,0.0,0,4,0,3,6,0,0,1,0,7,7,1
7331,132346,wIXH3gEY2v8CIGUg8D6sapoHRbIUXs86,5Gyp41oLVo7Gg7vF4vpmggWP5MU70QO6,28,82,42,14,16,173,24,2,353,50.42857142857143,6,0.0,14,42,10,16,68,173,4,24,2,82,271,1
7332,132348,Z0qsyLcA97qhAjqLPteqkusKnVAgvbF3,5Gyp41oLVo7Gg7vF4vpmggWP5MU70QO6,1,0,0,0,0,0,1,0,1,0.14285714285714285,1,0.0,0,0,0,0,0,0,0,1,0,0,1,1
7333,132369,wyABPyRfC1DXsBWN1FdgxSykc7fuCErP,5Gyp41oLVo7Gg7vF4vpmggWP5MU70QO6,8,6,3,0,2,1,6,1,19,2.7142857142857144,1,0.0,0,3,0,2,6,1,0,6,1,5,14,1
7334,132376,PLNAK5eO2jDldFb2P1VVgW3GLNYSW1XE,5Gyp41oLVo7Gg7vF4vpmggWP5MU70QO6,12,14,7,3,4,0,4,0,32,4.571428571428571,2,0.0,4,7,2,4,10,0,1,4,0,17,15,1
7335,132381,COy3W6Fm6ztNo7BoqXC77wJ3dpy0Idid,5Gyp41oLVo7Gg7vF4vpmggWP5MU70QO6,8,12,4,2,1,0,2,0,21,3.0,1,0.0,4,4,1,1,8,0,1,2,0,10,11,1
7336,132384,ihhIt4g3pf3Wao2zD7aziRWPnxuXhNfE,5Gyp41oLVo7Gg7vF4vpmggWP5MU70QO6,34,79,33,30,22,38,9,1,212,30.285714285714285,6,0.0,15,33,20,22,64,38,10,9,1,90,122,0
7337,132414,MoJEcZ3PrCXcO0CYW48XDV0zGeC8vGWI,5Gyp41oLVo7Gg7vF4vpmggWP5MU70QO6,32,113,8,14,7,5,20,2,169,24.142857142857142,7,0.0,21,8,11,7,92,5,3,20,2,47,122,1
7338,132426,XyMejM5OpRE6Mj05vo1mbZJVHgqqS3OY,5Gyp41oLVo7Gg7vF4vpmggWP5MU70QO6,1,0,0,0,0,0,1,0,1,0.14285714285714285,1,0.0,0,0,0,0,0,0,0,1,0,0,1,1
7339,132439,oBAEbwlQUsjw2fhD7RK0N1KBBvDbCzDf,5Gyp41oLVo7Gg7vF4vpmggWP5MU70QO6,8,4,2,0,1,4,10,0,21,3.0,2,0.0,0,2,0,1,4,4,0,10,0,3,18,1
7340,132444,jeDT3XKbaVhjSKMN8tSVhrU0lh7ai1Yw,5Gyp41oLVo7Gg7vF4vpmggWP5MU70QO6,2,0,0,0,0,0,3,0,3,0.42857142857142855,2,0.0,0,0,0,0,0,0,0,3,0,0,3,0
7341,132454,Hmn8w69KzIe3R3h44o7VyFC01BFXwK3X,5Gyp41oLVo7Gg7vF4vpmggWP5MU70QO6,8,2,1,0,1,1,7,1,13,1.8571428571428572,3,0.0,0,1,0,1,2,1,0,7,1,2,11,1
7342,132465,e0buQlxlHVWdQd03EOAehldJOI8AeFTm,5Gyp41oLVo7Gg7vF4vpmggWP5MU70QO6,25,78,41,30,19,5,26,0,199,28.428571428571427,7,0.0,18,41,22,19,60,5,8,26,0,100,99,1
7343,132469,Z5YirzjAdjPmLoyQV4PkNolvIfTj8EgX,5Gyp41oLVo7Gg7vF4vpmggWP5MU70QO6,6,3,2,0,1,1,3,0,10,1.4285714285714286,1,0.0,0,2,0,1,3,1,0,3,0,3,7,1
7344,132478,2CgYcmO1GACt32FxJPjz0SBU8VVHrh2b,5Gyp41oLVo7Gg7vF4vpmggWP5MU70QO6,6,9,4,0,0,0,4,0,17,2.4285714285714284,1,0.0,4,4,0,0,5,0,0,4,0,8,9,1
7345,132480,a6IXAisoGYVGIG3yaQVHn4K8Qt4RkLGp,5Gyp41oLVo7Gg7vF4vpmggWP5MU70QO6,10,15,6,0,2,1,5,0,29,4.142857142857143,3,0.0,2,6,0,2,13,1,0,5,0,10,19,1
7346,132495,I9yi1jZjIznCPzP5fpMJEhPDMiUaetUu,5Gyp41oLVo7Gg7vF4vpmggWP5MU70QO6,7,9,4,0,3,0,1,0,17,2.4285714285714284,1,0.0,0,4,0,3,9,0,0,1,0,7,10,1
7347,132503,G7nmaHMm6kY7xtLIEqr8hTV81gk3z57q,5Gyp41oLVo7Gg7vF4vpmggWP5MU70QO6,1,0,0,0,0,0,1,0,1,0.14285714285714285,1,0.0,0,0,0,0,0,0,0,1,0,0,1,1
7348,132504,xe2wzMhAvNNl4WFLalDysto0z3MkK9cl,5Gyp41oLVo7Gg7vF4vpmggWP5MU70QO6,26,74,5,23,13,64,19,3,201,28.714285714285715,5,0.0,15,5,16,13,59,64,7,19,3,49,152,1
7349,132538,eDSND9aVmxhnZJa0kERwiyCA50eVabzR,5Gyp41oLVo7Gg7vF4vpmggWP5MU70QO6,1,0,0,0,0,0,1,0,1,0.14285714285714285,1,0.0,0,0,0,0,0,0,0,1,0,0,1,1
7350,132555,5OFklK90Prgvd0eqyybyLqlp4DdBRTP2,5Gyp41oLVo7Gg7vF4vpmggWP5MU70QO6,8,12,6,0,3,0,4,0,25,3.5714285714285716,3,0.0,0,6,0,3,12,0,0,4,0,9,16,1
7351,132559,y9wPfGAwhUyEzMcLzeImEmShSOKx49Im,5Gyp41oLVo7Gg7vF4vpmggWP5MU70QO6,11,5,5,0,4,0,10,0,24,3.4285714285714284,2,0.0,0,5,0,4,5,0,0,10,0,9,15,1
7352,132576,3nvYm1DKrH5EOHAw44wBVldk53PpV7TA,5Gyp41oLVo7Gg7vF4vpmggWP5MU70QO6,22,57,33,0,14,13,15,0,132,18.857142857142858,6,0.0,11,33,0,14,46,13,0,15,0,58,74,1
7353,132613,7cXmolpTFQKnmQzgabjXZRbBMU6zPryU,5Gyp41oLVo7Gg7vF4vpmggWP5MU70QO6,17,14,11,3,2,2,5,1,38,5.428571428571429,2,0.0,1,11,2,2,13,2,1,5,1,16,22,1
7354,132632,pdbjkshNkCdKgKlb65eT3NLGorQmQAKA,5Gyp41oLVo7Gg7vF4vpmggWP5MU70QO6,10,9,6,0,4,0,9,0,28,4.0,1,0.0,0,6,0,4,9,0,0,9,0,10,18,1
7355,132640,DKe2GInb7SCNSrksG80cnhQaLYFATj0E,5Gyp41oLVo7Gg7vF4vpmggWP5MU70QO6,1,0,0,0,0,0,1,0,1,0.14285714285714285,1,0.0,0,0,0,0,0,0,0,1,0,0,1,1
7356,132655,9wYwWdPqN0SRbLcrBzTUv3Vt4Ozm2cqW,5Gyp41oLVo7Gg7vF4vpmggWP5MU70QO6,9,8,1,0,3,1,4,1,18,2.5714285714285716,1,0.0,3,1,0,3,5,1,0,4,1,7,11,1
7357,132683,XCEK2se7opoV7sjn5cmHSo7CvzSkKYlL,5Gyp41oLVo7Gg7vF4vpmggWP5MU70QO6,7,4,3,0,3,0,1,0,11,1.5714285714285714,1,0.0,0,3,0,3,4,0,0,1,0,6,5,1
7358,132692,IFqWOl32JJm0W3Ap2jxVCpJeXeLJlYDp,5Gyp41oLVo7Gg7vF4vpmggWP5MU70QO6,12,12,6,3,3,0,5,0,29,4.142857142857143,2,0.0,4,6,2,3,8,0,1,5,0,15,14,1
7359,132704,JXMSZBKSTDpEGXqmHuCDSmsA3kQYV2pH,5Gyp41oLVo7Gg7vF4vpmggWP5MU70QO6,1,0,0,0,0,0,2,0,2,0.2857142857142857,2,0.0,0,0,0,0,0,0,0,2,0,0,2,1
7360,132705,sdrRyi3Bx383RXfkTMsh3u2wuJiBI99C,5Gyp41oLVo7Gg7vF4vpmggWP5MU70QO6,24,43,20,20,8,8,11,0,110,15.714285714285714,5,0.0,11,20,15,8,32,8,5,11,0,54,56,1
7361,132710,EucoLTT3NIODI51xT6HenetUBqP6oyOI,5Gyp41oLVo7Gg7vF4vpmggWP5MU70QO6,6,3,2,0,2,0,1,0,8,1.1428571428571428,1,0.0,0,2,0,2,3,0,0,1,0,4,4,1
7362,132732,BKs08mJzEBABTQ7q2m9CMbq8Ej6GEzZu,5Gyp41oLVo7Gg7vF4vpmggWP5MU70QO6,6,3,2,0,2,0,1,0,8,1.1428571428571428,1,0.0,0,2,0,2,3,0,0,1,0,4,4,1
7363,132745,WbVYlGFTP5qkuVvKMq8XhPYjGas87gaW,5Gyp41oLVo7Gg7vF4vpmggWP5MU70QO6,21,33,16,3,11,0,6,0,69,9.857142857142858,4,0.0,4,16,2,11,29,0,1,6,0,33,36,1
7364,132752,i2raPzmlvNePAOSFdEUwI0BA2bKyQ3vM,5Gyp41oLVo7Gg7vF4vpmggWP5MU70QO6,37,179,70,26,38,1,19,0,333,47.57142857142857,11,0.0,73,70,22,38,106,1,4,19,0,203,130,0
7365,132755,tlJNepTGGOi8ovF7QAiJxRkVTp4zYSeD,5Gyp41oLVo7Gg7vF4vpmggWP5MU70QO6,7,3,2,0,2,0,4,0,11,1.5714285714285714,1,0.0,0,2,0,2,3,0,0,4,0,4,7,1
7366,132759,cwg9sECm21xM465omHALHnZIByL0kCoG,5Gyp41oLVo7Gg7vF4vpmggWP5MU70QO6,19,17,10,13,6,0,2,0,48,6.857142857142857,2,0.0,5,10,11,6,12,0,2,2,0,32,16,0
7367,132770,rzUPX25qXPcUJGYbh6MkxuKJx5sbGl5q,5Gyp41oLVo7Gg7vF4vpmggWP5MU70QO6,10,6,4,1,2,0,4,0,17,2.4285714285714284,1,0.0,1,4,1,2,5,0,0,4,0,8,9,1
7368,132777,RFEAx8yelAgvfPsQekcPEQ1kwjrp5Mon,5Gyp41oLVo7Gg7vF4vpmggWP5MU70QO6,1,0,0,0,0,0,1,0,1,0.14285714285714285,1,0.0,0,0,0,0,0,0,0,1,0,0,1,1
7369,132782,1aSZZjNRIlSk2N1niFK67pvW5hrrFdOk,5Gyp41oLVo7Gg7vF4vpmggWP5MU70QO6,12,18,13,0,3,6,12,2,54,7.714285714285714,1,0.0,0,13,0,3,18,6,0,12,2,16,38,1
7370,132784,TOnSUH2TrhmaSVJBIvM0e6QZcFDQqMZg,5Gyp41oLVo7Gg7vF4vpmggWP5MU70QO6,22,48,28,2,17,30,20,5,150,21.428571428571427,3,0.0,10,28,2,17,38,30,0,20,5,57,93,1
7371,132787,5zmdkrLCsYposTlmADCtPSCtqJszOFSq,5Gyp41oLVo7Gg7vF4vpmggWP5MU70QO6,14,17,11,0,4,0,7,0,39,5.571428571428571,4,0.0,2,11,0,4,15,0,0,7,0,17,22,1
7372,132797,3DXpDmYAbqOTUiKxY44g8SjQwtTkd2rO,5Gyp41oLVo7Gg7vF4vpmggWP5MU70QO6,9,6,5,0,5,0,2,0,18,2.5714285714285716,1,0.0,0,5,0,5,6,0,0,2,0,10,8,1
7373,132806,bfDSQ3vzU9egOngeApVA2Og6CGBoeEWY,5Gyp41oLVo7Gg7vF4vpmggWP5MU70QO6,1,0,0,0,0,0,1,0,1,0.14285714285714285,1,0.0,0,0,0,0,0,0,0,1,0,0,1,1
7374,132831,L9G46vSsgrMITbTbwTD9eVe8PZeEU8Bv,5Gyp41oLVo7Gg7vF4vpmggWP5MU70QO6,8,9,3,0,2,0,3,0,17,2.4285714285714284,2,0.0,0,3,0,2,9,0,0,3,0,5,12,1
7375,132837,KqGkK66L9Z01z5JYoEydzCtObtfYjG7x,5Gyp41oLVo7Gg7vF4vpmggWP5MU70QO6,3,2,0,0,0,0,1,0,3,0.42857142857142855,1,0.0,0,0,0,0,2,0,0,1,0,0,3,1
7376,132842,33YJhO56Hz6X3YkBaXAE8jLXj3hGQz0E,5Gyp41oLVo7Gg7vF4vpmggWP5MU70QO6,5,2,1,0,1,0,2,0,6,0.8571428571428571,1,0.0,0,1,0,1,2,0,0,2,0,2,4,1
7377,132856,gtomiUNdtGtruDBQ9M0mqdd1I3gHFwtw,5Gyp41oLVo7Gg7vF4vpmggWP5MU70QO6,18,14,7,12,4,3,6,1,47,6.714285714285714,1,0.0,6,7,9,4,8,3,3,6,1,26,21,1
7378,132872,dgf9B0BYXZoUUDCON0UDpcT22L2RlQ7g,5Gyp41oLVo7Gg7vF4vpmggWP5MU70QO6,1,0,0,0,0,0,1,0,1,0.14285714285714285,1,0.0,0,0,0,0,0,0,0,1,0,0,1,1
7379,132885,J7OzjvXIyBcNlAU0cMqVwzttWM9JdrwO,5Gyp41oLVo7Gg7vF4vpmggWP5MU70QO6,7,3,2,0,2,0,2,0,9,1.2857142857142858,1,0.0,0,2,0,2,3,0,0,2,0,4,5,1
7380,132913,vVntTx7SVuGrQLeVI9sXms04tE061UAW,5Gyp41oLVo7Gg7vF4vpmggWP5MU70QO6,35,47,4,17,13,6,6,1,94,13.428571428571429,3,0.0,21,4,12,13,26,6,5,6,1,50,44,1
7381,132919,0IX1Oa0Z1GaXCaGzOOt47o06NpYNVkTP,5Gyp41oLVo7Gg7vF4vpmggWP5MU70QO6,9,7,3,2,2,0,2,0,16,2.2857142857142856,1,0.0,3,3,1,2,4,0,1,2,0,9,7,1
7382,132935,Ys5FH0nq7NeLEdwGoDUOp7Sz8iAMAB3d,5Gyp41oLVo7Gg7vF4vpmggWP5MU70QO6,6,3,1,0,1,0,3,0,8,1.1428571428571428,1,0.0,0,1,0,1,3,0,0,3,0,2,6,1
7383,132941,gGPwEyB8WM9RKY8d6MZCxjfZZkbEQNgr,5Gyp41oLVo7Gg7vF4vpmggWP5MU70QO6,14,16,11,0,7,0,9,0,43,6.142857142857143,3,0.0,0,11,0,7,16,0,0,9,0,18,25,1
7384,132982,Pbr5aSJDI6hWVSe2mgnpvht08jTDxoyv,5Gyp41oLVo7Gg7vF4vpmggWP5MU70QO6,5,2,1,0,1,0,3,0,7,1.0,1,0.0,0,1,0,1,2,0,0,3,0,2,5,1
7385,133006,neYnRDZzxRsfSqQHzFDdOdC9LxuGvJCl,5Gyp41oLVo7Gg7vF4vpmggWP5MU70QO6,1,0,0,0,0,0,2,0,2,0.2857142857142857,2,0.0,0,0,0,0,0,0,0,2,0,0,2,1
7386,133017,Zu0u723RoHXT6Cndj96vNOQ1emcUEK1a,5Gyp41oLVo7Gg7vF4vpmggWP5MU70QO6,10,10,4,0,3,0,3,1,21,3.0,1,0.0,2,4,0,3,8,0,0,3,1,9,12,1
7387,133022,ncT8oGxKTMRqVxe3XEF5xOrCySGYuHpk,5Gyp41oLVo7Gg7vF4vpmggWP5MU70QO6,15,22,12,4,6,0,4,0,48,6.857142857142857,3,0.0,7,12,2,6,15,0,2,4,0,27,21,1
7388,133029,70BNVptBNpsHI5UYkAWorZh5hHHXwEl0,5Gyp41oLVo7Gg7vF4vpmggWP5MU70QO6,14,13,6,3,5,0,5,0,32,4.571428571428571,2,0.0,5,6,2,5,8,0,1,5,0,18,14,1
7389,133044,BoMrnaRzWiLLbhZUihKQP6MURkcvYuJ9,5Gyp41oLVo7Gg7vF4vpmggWP5MU70QO6,3,0,0,0,0,1,7,0,8,1.1428571428571428,4,0.0,0,0,0,0,0,1,0,7,0,0,8,1
7390,133046,2AJqZ8dhClk5ETxstQ75PSPxn4v3KOvQ,5Gyp41oLVo7Gg7vF4vpmggWP5MU70QO6,7,2,1,0,2,0,3,0,8,1.1428571428571428,1,0.0,1,1,0,2,1,0,0,3,0,4,4,1
7391,133053,5IM8g7YMOYo5qH7Yu3x31T3JkVOH9iqe,5Gyp41oLVo7Gg7vF4vpmggWP5MU70QO6,20,39,16,1,12,22,12,1,103,14.714285714285714,5,0.0,11,16,1,12,28,22,0,12,1,40,63,1
7392,133070,SXGSrK93LJViX1VmVZVCFkMLdrBoNCvI,5Gyp41oLVo7Gg7vF4vpmggWP5MU70QO6,46,113,45,35,25,41,19,1,279,39.857142857142854,11,0.0,39,45,24,25,74,41,11,19,1,133,146,0
7393,133076,osCj80dZl2wGSeLT3ksGLNRaqvjByuJ9,5Gyp41oLVo7Gg7vF4vpmggWP5MU70QO6,23,37,20,16,11,1,10,1,96,13.714285714285714,6,0.0,10,20,11,11,27,1,5,10,1,52,44,1
7394,133091,96mXDEHAys0u0Plnb32C3zUTsAT5Tkkd,5Gyp41oLVo7Gg7vF4vpmggWP5MU70QO6,1,0,0,0,0,0,1,0,1,0.14285714285714285,1,0.0,0,0,0,0,0,0,0,1,0,0,1,1
7395,133126,duArRwhYpB9eHlRx5aAqkissf3ZxaFK5,5Gyp41oLVo7Gg7vF4vpmggWP5MU70QO6,10,10,7,0,5,0,4,0,26,3.7142857142857144,3,0.0,0,7,0,5,10,0,0,4,0,12,14,1
7396,133145,AzNGxLM19O89VQy66cmgkZxDbMxjrAs3,5Gyp41oLVo7Gg7vF4vpmggWP5MU70QO6,12,18,13,0,7,0,4,0,42,6.0,3,0.0,1,13,0,7,17,0,0,4,0,21,21,1
7397,133183,S4NxvJQGwl4G80TxSJ4cMwHKt8lPSR9p,5Gyp41oLVo7Gg7vF4vpmggWP5MU70QO6,19,34,14,6,3,13,13,4,87,12.428571428571429,4,0.0,7,14,3,3,27,13,3,13,4,27,60,0
7398,133185,lz9DwlpT70vEt7hSzkBDHhnuPOjihC36,5Gyp41oLVo7Gg7vF4vpmggWP5MU70QO6,4,1,1,0,0,0,2,0,4,0.5714285714285714,1,0.0,0,1,0,0,1,0,0,2,0,1,3,1
7399,133186,guIKxJFMsPEjbbc4jx25pWEGKtRIqgdA,5Gyp41oLVo7Gg7vF4vpmggWP5MU70QO6,7,4,2,0,2,0,5,0,13,1.8571428571428572,1,0.0,0,2,0,2,4,0,0,5,0,4,9,1
7400,133189,RQljJaGUuH5OcYT8gaJW7964lbgNyY1n,5Gyp41oLVo7Gg7vF4vpmggWP5MU70QO6,1,0,0,0,0,0,1,0,1,0.14285714285714285,1,0.0,0,0,0,0,0,0,0,1,0,0,1,1
7401,133196,BJqHNXVOuknKXVN8kWe148UD34ryhX5w,5Gyp41oLVo7Gg7vF4vpmggWP5MU70QO6,7,4,3,0,2,0,5,0,14,2.0,1,0.0,0,3,0,2,4,0,0,5,0,5,9,1
7402,133199,s1rtWkZP0wFdJ0WRHT6EwX3hwc8p3Aeo,5Gyp41oLVo7Gg7vF4vpmggWP5MU70QO6,5,2,1,0,1,0,2,0,6,0.8571428571428571,1,0.0,0,1,0,1,2,0,0,2,0,2,4,1
7403,133216,VsOc7LofXdwwVmICgpVVycvv0BQ41l3j,5Gyp41oLVo7Gg7vF4vpmggWP5MU70QO6,6,3,2,0,1,0,3,0,9,1.2857142857142858,1,0.0,0,2,0,1,3,0,0,3,0,3,6,1
7404,133240,1KWD8U2yUGemNG4lzmFiXTuBlY4jZcCK,5Gyp41oLVo7Gg7vF4vpmggWP5MU70QO6,19,31,17,5,10,14,6,0,83,11.857142857142858,3,0.0,10,17,3,10,21,14,2,6,0,40,43,0
7405,133241,a2e4h32rsnosgvoyI4da4dlx7oen7sJh,5Gyp41oLVo7Gg7vF4vpmggWP5MU70QO6,8,6,3,0,2,1,3,0,15,2.142857142857143,1,0.0,0,3,0,2,6,1,0,3,0,5,10,1
7406,133257,PVencLbfncSD8xfkLux19f8VCbg1K15h,5Gyp41oLVo7Gg7vF4vpmggWP5MU70QO6,12,26,3,4,4,0,4,0,41,5.857142857142857,3,0.0,7,3,2,4,19,0,2,4,0,16,25,0
7407,133262,rmqyFhovBvZJEPGr9dvTmnCKigZvYxPu,5Gyp41oLVo7Gg7vF4vpmggWP5MU70QO6,1,0,0,0,0,0,1,0,1,0.14285714285714285,1,0.0,0,0,0,0,0,0,0,1,0,0,1,1
7408,133289,mboXYgGduGMfQoUGFBNUe8XD9mw4Jyzk,5Gyp41oLVo7Gg7vF4vpmggWP5MU70QO6,2,0,0,0,0,0,3,0,3,0.42857142857142855,1,0.0,0,0,0,0,0,0,0,3,0,0,3,1
7409,133300,Vvmg4GFkxtES0j2sr2rm1vhisTqz0hYp,5Gyp41oLVo7Gg7vF4vpmggWP5MU70QO6,11,11,5,0,3,0,4,0,23,3.2857142857142856,2,0.0,0,5,0,3,11,0,0,4,0,8,15,0
7410,133302,7Brc0TESybTvrmuCCvDaRZ4xaX6BgLau,5Gyp41oLVo7Gg7vF4vpmggWP5MU70QO6,12,10,5,7,3,0,3,0,28,4.0,2,0.0,3,5,4,3,7,0,3,3,0,15,13,1
7411,133324,Gur5FuhE9EyV9K1F0qLPk7AenhoY8PBS,5Gyp41oLVo7Gg7vF4vpmggWP5MU70QO6,18,39,20,4,3,6,22,0,94,13.428571428571429,5,0.0,6,20,2,3,33,6,2,22,0,31,63,1
7412,133343,NxkkVgqpWSpGsLHJn72gpt4C1PtUl4UQ,5Gyp41oLVo7Gg7vF4vpmggWP5MU70QO6,26,30,17,0,11,0,9,0,67,9.571428571428571,5,0.0,6,17,0,11,24,0,0,9,0,34,33,1
7413,133376,ecYwOKQaqCwKgwjlBCREC5ekFPF9vGst,5Gyp41oLVo7Gg7vF4vpmggWP5MU70QO6,1,0,0,0,0,0,2,0,2,0.2857142857142857,1,0.0,0,0,0,0,0,0,0,2,0,0,2,1
7414,133383,LSCXX4w5IiPx7aQ4wmkLZzZogMkFC4va,5Gyp41oLVo7Gg7vF4vpmggWP5MU70QO6,5,3,2,0,2,0,2,0,9,1.2857142857142858,1,0.0,0,2,0,2,3,0,0,2,0,4,5,1
7415,133395,vORvIVYHwKmymVFgzFhz48csezUlt7Kh,5Gyp41oLVo7Gg7vF4vpmggWP5MU70QO6,21,17,11,10,5,0,5,0,48,6.857142857142857,3,0.0,2,11,8,5,15,0,2,5,0,26,22,1
7416,133396,5Tx0aoNMgZmEMBl0k1hFtw0VwO1vqb6n,5Gyp41oLVo7Gg7vF4vpmggWP5MU70QO6,6,3,1,0,2,0,2,0,8,1.1428571428571428,1,0.0,0,1,0,2,3,0,0,2,0,3,5,1
7417,133465,mYSYq9VbEBBIvljygNQmWRgpoWM9p7zq,5Gyp41oLVo7Gg7vF4vpmggWP5MU70QO6,1,0,0,0,0,0,1,0,1,0.14285714285714285,1,0.0,0,0,0,0,0,0,0,1,0,0,1,1
7418,133476,Cf7GCeUZzG7WjvUIyGfwv9hfcwXPVq5G,5Gyp41oLVo7Gg7vF4vpmggWP5MU70QO6,15,13,7,14,3,0,3,0,40,5.714285714285714,1,0.0,4,7,9,3,9,0,5,3,0,23,17,1
7419,133482,v14lvx2kJvNWvCMFJ7Bx2ipE0ptO51OZ,5Gyp41oLVo7Gg7vF4vpmggWP5MU70QO6,1,0,0,0,0,0,2,0,2,0.2857142857142857,1,0.0,0,0,0,0,0,0,0,2,0,0,2,1
7420,133488,CpEqJ8Pou1Ow1oK9IZkd7yTmxIxi54B4,5Gyp41oLVo7Gg7vF4vpmggWP5MU70QO6,8,5,2,7,2,0,1,0,17,2.4285714285714284,1,0.0,1,2,5,2,4,0,2,1,0,10,7,1
7421,133492,yesikXRZpFYEGoXWRi2rEHboJsFyCCGG,5Gyp41oLVo7Gg7vF4vpmggWP5MU70QO6,12,15,7,0,7,18,9,0,56,8.0,4,0.0,2,7,0,7,13,18,0,9,0,16,40,1
7422,133497,69S4nSU8gofOvk1eb5h4gjGkayN6QGSb,5Gyp41oLVo7Gg7vF4vpmggWP5MU70QO6,13,22,2,6,8,0,5,0,43,6.142857142857143,2,0.0,8,2,5,8,14,0,1,5,0,23,20,1
7423,133502,y4C09JELGArMkj7EYnAM5VIhmCekYYoO,5Gyp41oLVo7Gg7vF4vpmggWP5MU70QO6,5,6,0,0,0,0,2,0,8,1.1428571428571428,1,0.0,0,0,0,0,6,0,0,2,0,0,8,1
7424,133510,MEAK3CtWNpeCicplOKHcDUkHm4e2Gnat,5Gyp41oLVo7Gg7vF4vpmggWP5MU70QO6,22,53,25,45,11,0,10,0,144,20.571428571428573,6,0.0,13,25,41,11,40,0,4,10,0,90,54,1
7425,133515,VK6VYsFJEy8hhWdKq52KmrJkO3b6jNbn,5Gyp41oLVo7Gg7vF4vpmggWP5MU70QO6,12,21,12,0,5,2,22,1,63,9.0,4,0.0,0,12,0,5,21,2,0,22,1,17,46,1
7426,133543,nr8Ko3wpWj615smFgIrRYqb9Gs4PawZh,5Gyp41oLVo7Gg7vF4vpmggWP5MU70QO6,1,0,0,0,0,0,1,0,1,0.14285714285714285,1,0.0,0,0,0,0,0,0,0,1,0,0,1,1
7427,133546,O4hHufjOTPLz1EGr9R9jzRFriheucazi,5Gyp41oLVo7Gg7vF4vpmggWP5MU70QO6,21,20,11,18,7,3,7,1,67,9.571428571428571,2,0.0,5,11,12,7,15,3,6,7,1,35,32,1
7428,133552,HKmx8shJ58SwVCIOfowOtDw2VVMie4AS,5Gyp41oLVo7Gg7vF4vpmggWP5MU70QO6,12,17,7,0,6,2,11,1,44,6.285714285714286,5,0.0,5,7,0,6,12,2,0,11,1,18,26,1
7429,133583,s3je4DygiZylT7jjrLByLhYZDcCgwIih,5Gyp41oLVo7Gg7vF4vpmggWP5MU70QO6,10,24,12,4,4,0,8,0,52,7.428571428571429,4,0.0,4,12,2,4,20,0,2,8,0,22,30,1
7430,133594,cySIPFLvl5v9LEAz5G5KYs1V5gt4cZXS,5Gyp41oLVo7Gg7vF4vpmggWP5MU70QO6,1,0,0,0,0,0,1,0,1,0.14285714285714285,1,0.0,0,0,0,0,0,0,0,1,0,0,1,1
7431,133610,IXJ5LEr8XgwhXJCbT31mpiUDsiLxwH0g,5Gyp41oLVo7Gg7vF4vpmggWP5MU70QO6,1,0,0,0,0,0,1,0,1,0.14285714285714285,1,0.0,0,0,0,0,0,0,0,1,0,0,1,1
7432,133646,lBljSQvIVCpw7S5SELQHg4JfMSTvCBRe,5Gyp41oLVo7Gg7vF4vpmggWP5MU70QO6,6,7,0,0,0,0,2,0,9,1.2857142857142858,1,0.0,0,0,0,0,7,0,0,2,0,0,9,1
7433,133660,Dgvs4YDwVqKDTJra6xmfhYYyJ0YPsggo,5Gyp41oLVo7Gg7vF4vpmggWP5MU70QO6,11,6,4,0,3,0,3,0,16,2.2857142857142856,1,0.0,1,4,0,3,5,0,0,3,0,8,8,1
7434,133702,ZNBGAlJve4TYJ3FcDlTLBdyuklADldDZ,5Gyp41oLVo7Gg7vF4vpmggWP5MU70QO6,16,28,2,8,6,20,8,0,72,10.285714285714286,3,0.0,5,2,6,6,23,20,2,8,0,19,53,0
7435,133735,P9N4rDQUrFgLSulNcNTOV1uQ40rNPLNy,5Gyp41oLVo7Gg7vF4vpmggWP5MU70QO6,8,8,3,0,2,0,4,0,17,2.4285714285714284,1,0.0,0,3,0,2,8,0,0,4,0,5,12,0
7436,133744,kuzbMxcePL2szeInnouQIyDbUEq9uTMT,5Gyp41oLVo7Gg7vF4vpmggWP5MU70QO6,7,11,7,0,6,0,2,0,26,3.7142857142857144,2,0.0,0,7,0,6,11,0,0,2,0,13,13,1
7437,133771,DRObiunnWxzOw4DFCmzC7BYQDKFtF4cJ,5Gyp41oLVo7Gg7vF4vpmggWP5MU70QO6,9,7,3,4,2,0,2,0,18,2.5714285714285716,1,0.0,3,3,2,2,4,0,2,2,0,10,8,1
7438,133787,4SbF4DhXcYorYYyJ4XmwwPJZFVh1ZUhY,5Gyp41oLVo7Gg7vF4vpmggWP5MU70QO6,13,9,4,16,3,0,5,0,37,5.285714285714286,1,0.0,5,4,10,3,4,0,6,5,0,22,15,1
7439,133803,GSB0EWv7FMXRgg8fUNIQCJ36j91yg7BA,5Gyp41oLVo7Gg7vF4vpmggWP5MU70QO6,28,106,50,26,17,0,25,0,224,32.0,5,0.0,41,50,20,17,65,0,6,25,0,128,96,1
7440,133808,UxYzELvK2KxlL0hD5kxKSPxIBAFCdRLe,5Gyp41oLVo7Gg7vF4vpmggWP5MU70QO6,8,7,1,1,1,1,3,0,14,2.0,2,0.0,1,1,1,1,6,1,0,3,0,4,10,1
7441,133819,YJfKWA2kqHzjYEc66kIYvrpFxvk8Xk9m,5Gyp41oLVo7Gg7vF4vpmggWP5MU70QO6,8,9,4,3,2,0,1,0,19,2.7142857142857144,1,0.0,4,4,2,2,5,0,1,1,0,12,7,1
7442,133825,35tyNa3GqEtWUet4hkv2004bwls7oKD6,5Gyp41oLVo7Gg7vF4vpmggWP5MU70QO6,8,6,4,0,3,0,3,0,16,2.2857142857142856,2,0.0,0,4,0,3,6,0,0,3,0,7,9,1
7443,133827,vha1HcyvkfVseQManTnYSL3gu0khzZZB,5Gyp41oLVo7Gg7vF4vpmggWP5MU70QO6,34,60,30,37,14,17,25,5,188,26.857142857142858,5,0.0,16,30,29,14,44,17,8,25,5,89,99,0
7444,133848,yHOVQ8LEFZiQRD5Quj5Ct86OqEMEwTme,5Gyp41oLVo7Gg7vF4vpmggWP5MU70QO6,1,0,0,0,0,0,1,0,1,0.14285714285714285,1,0.0,0,0,0,0,0,0,0,1,0,0,1,1
7445,133869,vMOdVeqb266f21sYdhxbN4Shplb3TDGL,5Gyp41oLVo7Gg7vF4vpmggWP5MU70QO6,13,23,11,0,4,4,16,4,62,8.857142857142858,1,0.0,1,11,0,4,22,4,0,16,4,16,46,1
7446,133885,JLpYHpRsamf04qcVxCPYwLYYhT8v6H5r,5Gyp41oLVo7Gg7vF4vpmggWP5MU70QO6,7,4,2,0,2,0,2,0,10,1.4285714285714286,1,0.0,0,2,0,2,4,0,0,2,0,4,6,1
7447,133899,K7f4rbkZ4zpJXBwmVkXYyusOfW3d659K,5Gyp41oLVo7Gg7vF4vpmggWP5MU70QO6,1,0,0,0,0,0,1,0,1,0.14285714285714285,1,0.0,0,0,0,0,0,0,0,1,0,0,1,1
7448,133913,9OIml0SV4dEAJAFAwgEIKnYzkcxrQvU3,5Gyp41oLVo7Gg7vF4vpmggWP5MU70QO6,4,4,1,0,0,0,2,0,7,1.0,1,0.0,0,1,0,0,4,0,0,2,0,1,6,1
7449,133929,JZ8D07WpMQUIA2O2a3f2Q2gV7h70rqbC,5Gyp41oLVo7Gg7vF4vpmggWP5MU70QO6,4,2,1,0,1,0,1,0,5,0.7142857142857143,1,0.0,0,1,0,1,2,0,0,1,0,2,3,1
7450,133933,futHw5ylJYoore6oNuefdx05Xc1Es6E8,5Gyp41oLVo7Gg7vF4vpmggWP5MU70QO6,1,0,0,0,0,0,1,0,1,0.14285714285714285,1,0.0,0,0,0,0,0,0,0,1,0,0,1,1
7451,133939,TjArGeWj61CTlQRH6nS7DOeQFdhZwaVR,5Gyp41oLVo7Gg7vF4vpmggWP5MU70QO6,6,3,2,0,2,0,4,0,11,1.5714285714285714,1,0.0,0,2,0,2,3,0,0,4,0,4,7,1
7452,133942,g2zZYnTJ1Pk3cSjsVP5SH4UjJdsbDJv7,5Gyp41oLVo7Gg7vF4vpmggWP5MU70QO6,1,0,0,0,0,0,1,0,1,0.14285714285714285,1,0.0,0,0,0,0,0,0,0,1,0,0,1,1
7453,133954,9EnYFnK7dRrx23JecbRusbUbJedxJQqT,5Gyp41oLVo7Gg7vF4vpmggWP5MU70QO6,24,49,24,26,9,0,13,1,122,17.428571428571427,4,0.0,13,24,21,9,36,0,5,13,1,67,55,0
7454,133966,r70Wv7ehGphM0ksJO1rywGbRYud5AcSJ,5Gyp41oLVo7Gg7vF4vpmggWP5MU70QO6,6,3,2,0,2,0,1,0,8,1.1428571428571428,1,0.0,0,2,0,2,3,0,0,1,0,4,4,1
7455,133998,JjpjetsHT42uLapLy1HEIH9jFdBHozD9,5Gyp41oLVo7Gg7vF4vpmggWP5MU70QO6,1,0,0,0,0,0,1,0,1,0.14285714285714285,1,0.0,0,0,0,0,0,0,0,1,0,0,1,1
7456,134005,ef7qnYFsdVxa96TdDzGizm7tXmxq7QDV,5Gyp41oLVo7Gg7vF4vpmggWP5MU70QO6,7,4,3,0,3,3,5,0,18,2.5714285714285716,1,0.0,0,3,0,3,4,3,0,5,0,6,12,1
7457,134061,a5EgdVQip8RR2HL5bCBPhAmfK1Tiw2TB,5Gyp41oLVo7Gg7vF4vpmggWP5MU70QO6,1,0,0,0,0,0,2,0,2,0.2857142857142857,1,0.0,0,0,0,0,0,0,0,2,0,0,2,1
7458,134063,isREfnusXioFlXK1R4tw2vT4IosRAXVA,5Gyp41oLVo7Gg7vF4vpmggWP5MU70QO6,10,22,10,0,5,1,10,0,48,6.857142857142857,5,0.0,0,10,0,5,22,1,0,10,0,15,33,1
7459,134073,iQzOW09s8hoh4dOTNTFxheAs18Dipz15,5Gyp41oLVo7Gg7vF4vpmggWP5MU70QO6,11,10,5,0,3,6,2,0,26,3.7142857142857144,1,0.0,4,5,0,3,6,6,0,2,0,12,14,1
7460,134089,5RFOQWsY9ZOa18PmIgdopEz8uvDZD4Cc,5Gyp41oLVo7Gg7vF4vpmggWP5MU70QO6,3,0,0,0,0,0,4,0,4,0.5714285714285714,1,0.0,0,0,0,0,0,0,0,4,0,0,4,1
7461,134107,p4aS553VfWGCl0Q8nrggvjySuakRRXPS,5Gyp41oLVo7Gg7vF4vpmggWP5MU70QO6,5,5,2,0,1,0,1,0,9,1.2857142857142858,1,0.0,2,2,0,1,3,0,0,1,0,5,4,1
7462,134110,CGMPF3X0YeZx8JgQgP1MF0k04hmYnEFe,5Gyp41oLVo7Gg7vF4vpmggWP5MU70QO6,7,11,6,0,0,0,7,0,24,3.4285714285714284,1,0.0,2,6,0,0,9,0,0,7,0,8,16,1
7463,134111,sT7d9Rzd07OMXHp343L0wLrLWjqRYw9F,5Gyp41oLVo7Gg7vF4vpmggWP5MU70QO6,6,4,2,0,2,0,3,0,11,1.5714285714285714,1,0.0,0,2,0,2,4,0,0,3,0,4,7,1
7464,134112,QRSg0Qjo8G9M9eRRghKUMjmMUZEnxHCH,5Gyp41oLVo7Gg7vF4vpmggWP5MU70QO6,6,3,0,0,2,0,1,0,6,0.8571428571428571,1,0.0,0,0,0,2,3,0,0,1,0,2,4,1
7465,134121,BrLXDuvoA4KsM1lobMNSSKoqo46bH2gE,5Gyp41oLVo7Gg7vF4vpmggWP5MU70QO6,6,1,1,0,1,0,8,0,11,1.5714285714285714,1,0.0,0,1,0,1,1,0,0,8,0,2,9,1
7466,134123,Ayc6WctI6Dznkhzc1RhvbHOs7QGAiu2D,5Gyp41oLVo7Gg7vF4vpmggWP5MU70QO6,8,5,4,0,4,3,17,10,43,6.142857142857143,2,0.0,0,4,0,4,5,3,0,17,10,8,35,1
7467,134141,vsJnnbOJbRiDeSpDiIwKNu51zxudWq74,5Gyp41oLVo7Gg7vF4vpmggWP5MU70QO6,1,0,0,0,0,0,1,0,1,0.14285714285714285,1,0.0,0,0,0,0,0,0,0,1,0,0,1,1
7468,134153,qy4bKhXqNBlINsljPVNLHwKIsvlS56JE,5Gyp41oLVo7Gg7vF4vpmggWP5MU70QO6,9,15,9,0,3,2,3,0,32,4.571428571428571,3,0.0,2,9,0,3,13,2,0,3,0,14,18,1
7469,134159,ZuaBm8fqMnxcUDIovpFi3BOp4vzgmLMv,5Gyp41oLVo7Gg7vF4vpmggWP5MU70QO6,7,3,2,0,2,0,2,0,9,1.2857142857142858,1,0.0,0,2,0,2,3,0,0,2,0,4,5,1
7470,134163,eZwtgHeQ7iT718LkBUaEsaXSh6hqAR2J,5Gyp41oLVo7Gg7vF4vpmggWP5MU70QO6,44,86,55,39,25,1,15,0,221,31.571428571428573,5,0.0,22,55,30,25,64,1,9,15,0,132,89,1
7471,134176,5uSodITNhVNpn93ZRNQ5nXSTBs8A9EDI,5Gyp41oLVo7Gg7vF4vpmggWP5MU70QO6,3,1,0,0,0,0,3,0,4,0.5714285714285714,1,0.0,0,0,0,0,1,0,0,3,0,0,4,1
7472,134180,2Bk5pVNjcJmG3piHcBPqqQpme5KIQCyZ,5Gyp41oLVo7Gg7vF4vpmggWP5MU70QO6,18,25,3,10,7,6,11,3,65,9.285714285714286,2,0.0,8,3,7,7,17,6,3,11,3,25,40,0
7473,134217,wisu77b2OWghPT42ju4QbBWizBy4Q7oQ,5Gyp41oLVo7Gg7vF4vpmggWP5MU70QO6,5,2,1,0,1,0,3,0,7,1.0,1,0.0,0,1,0,1,2,0,0,3,0,2,5,1
7474,134223,KJSKTGAkJJbQ24c0Aas5HLuEGsIosbw0,5Gyp41oLVo7Gg7vF4vpmggWP5MU70QO6,5,5,2,0,1,0,1,0,9,1.2857142857142858,1,0.0,0,2,0,1,5,0,0,1,0,3,6,1
7475,134224,DIYlLDsIX3rRB00v33V6F050gdzNiYGy,5Gyp41oLVo7Gg7vF4vpmggWP5MU70QO6,12,17,9,10,1,6,8,0,51,7.285714285714286,3,0.0,1,9,9,1,16,6,1,8,0,20,31,0
7476,134229,qvtInMrLBR6bdvEzt6dQtEtd7Pst8guk,5Gyp41oLVo7Gg7vF4vpmggWP5MU70QO6,1,0,0,0,0,0,2,0,2,0.2857142857142857,1,0.0,0,0,0,0,0,0,0,2,0,0,2,1
7477,134243,Ik6D0zrdg6WujAdAQUUV98BKQ3zjot33,5Gyp41oLVo7Gg7vF4vpmggWP5MU70QO6,15,12,7,2,3,1,12,1,38,5.428571428571429,2,0.0,1,7,1,3,11,1,1,12,1,12,26,1
7478,134290,dKK9EC54YmH9aw327UmselD4tlPN3Fh0,5Gyp41oLVo7Gg7vF4vpmggWP5MU70QO6,8,5,3,0,2,0,6,0,16,2.2857142857142856,1,0.0,0,3,0,2,5,0,0,6,0,5,11,1
7479,134296,rVj6vxysUjIV1kazIkMsUDn3ShTXOA8U,5Gyp41oLVo7Gg7vF4vpmggWP5MU70QO6,9,9,5,5,3,0,2,0,24,3.4285714285714284,2,0.0,1,5,3,3,8,0,2,2,0,12,12,1
7480,134309,FjigfNfNTRUOLbUBoCZOEMnxdbNYqSu7,5Gyp41oLVo7Gg7vF4vpmggWP5MU70QO6,1,0,0,0,0,0,1,0,1,0.14285714285714285,1,0.0,0,0,0,0,0,0,0,1,0,0,1,1
7481,134313,uUBnxYTE9UFDvFQurPbYAVjLIr23a3oF,5Gyp41oLVo7Gg7vF4vpmggWP5MU70QO6,11,19,9,0,2,2,12,1,45,6.428571428571429,2,0.0,7,9,0,2,12,2,0,12,1,18,27,1
7482,134317,2Xae5QrypYMLnsnjtSIaxiiTzIgpb1cP,5Gyp41oLVo7Gg7vF4vpmggWP5MU70QO6,22,22,12,16,4,3,12,1,70,10.0,2,0.0,6,12,11,4,16,3,5,12,1,33,37,1
7483,134349,YdelRUsXSmnjTg0Jdl7PsPpHH4xM6sBq,5Gyp41oLVo7Gg7vF4vpmggWP5MU70QO6,1,0,0,0,0,0,1,0,1,0.14285714285714285,1,0.0,0,0,0,0,0,0,0,1,0,0,1,1
7484,134364,lAFgPHTj1eYoojG1m1Fl5TOLDGmxGFGh,5Gyp41oLVo7Gg7vF4vpmggWP5MU70QO6,34,35,27,0,14,5,17,0,98,14.0,4,0.0,2,27,0,14,33,5,0,17,0,43,55,1
7485,134367,zB8sR41xg78eDx4ZwTTw26heGRlLVk6e,5Gyp41oLVo7Gg7vF4vpmggWP5MU70QO6,7,3,2,0,2,0,2,0,9,1.2857142857142858,1,0.0,0,2,0,2,3,0,0,2,0,4,5,1
7486,134371,TP9y9Uxikn9UpXYIOqkrwZMtlujuZAde,5Gyp41oLVo7Gg7vF4vpmggWP5MU70QO6,1,0,0,0,0,0,1,0,1,0.14285714285714285,1,0.0,0,0,0,0,0,0,0,1,0,0,1,1
7487,134388,wMnlqrN8uEDEYbIAwvYIu8Ru2uKGahlk,5Gyp41oLVo7Gg7vF4vpmggWP5MU70QO6,19,32,14,11,7,11,8,1,84,12.0,3,0.0,10,14,8,7,22,11,3,8,1,39,45,1
7488,134394,wmwDf7eIRrKPL0l8cNmMygnEPd5vzoqs,5Gyp41oLVo7Gg7vF4vpmggWP5MU70QO6,11,12,4,0,5,0,6,4,31,4.428571428571429,3,0.0,1,4,0,5,11,0,0,6,4,10,21,1
7489,134431,1HV2FFOPqBW9aoRRKrPAZKUMTyRb8sfE,5Gyp41oLVo7Gg7vF4vpmggWP5MU70QO6,20,49,26,23,14,26,5,0,143,20.428571428571427,2,0.0,17,26,14,14,32,26,9,5,0,71,72,1
7490,134433,MgfuFMRy7QeKL6ytuXJ2JwURDgsSa0RX,5Gyp41oLVo7Gg7vF4vpmggWP5MU70QO6,8,11,2,0,2,1,4,0,20,2.857142857142857,1,0.0,5,2,0,2,6,1,0,4,0,9,11,1
7491,134440,ARjA18eVGGzkTxQWaMMAIZUVRMvVrvTf,5Gyp41oLVo7Gg7vF4vpmggWP5MU70QO6,2,0,0,0,0,0,2,0,2,0.2857142857142857,1,0.0,0,0,0,0,0,0,0,2,0,0,2,1
7492,134442,3bqYNHEttQnrSXCOjNHPi8cuvQEsNCSU,5Gyp41oLVo7Gg7vF4vpmggWP5MU70QO6,2,0,0,0,0,0,2,0,2,0.2857142857142857,1,0.0,0,0,0,0,0,0,0,2,0,0,2,1
7493,134467,eDUQDYzLIlr06g8NVX85hPNIanIljruu,5Gyp41oLVo7Gg7vF4vpmggWP5MU70QO6,3,3,0,0,0,0,3,0,6,0.8571428571428571,1,0.0,0,0,0,0,3,0,0,3,0,0,6,1
7494,134469,fC6pYirhrCOV42Ez3D2U2noD1QExW639,5Gyp41oLVo7Gg7vF4vpmggWP5MU70QO6,14,31,14,0,7,0,3,0,55,7.857142857142857,2,0.0,6,14,0,7,25,0,0,3,0,27,28,1
7495,134501,SgNxAg6Nf1FuCdt6LSsttgVmgLxouQjj,5Gyp41oLVo7Gg7vF4vpmggWP5MU70QO6,1,0,0,0,0,0,1,0,1,0.14285714285714285,1,0.0,0,0,0,0,0,0,0,1,0,0,1,1
7496,134513,pvLp8fJAJaMpP8RFak6evkjwtGvYpGCi,5Gyp41oLVo7Gg7vF4vpmggWP5MU70QO6,6,3,2,0,2,0,1,0,8,1.1428571428571428,1,0.0,0,2,0,2,3,0,0,1,0,4,4,0
7497,134519,sC5OGaEBUw2bubMs0afR4nlVohAmCaTQ,5Gyp41oLVo7Gg7vF4vpmggWP5MU70QO6,10,24,14,4,0,0,1,0,43,6.142857142857143,1,0.0,8,14,3,0,16,0,1,1,0,25,18,1
7498,134533,MLAi45Q3iuhiLIwrpX5bcnMCBSTwL11k,5Gyp41oLVo7Gg7vF4vpmggWP5MU70QO6,4,2,1,0,1,0,1,0,5,0.7142857142857143,1,0.0,0,1,0,1,2,0,0,1,0,2,3,1
7499,134548,FO0v5g6WrFl0t9Z2dbTriCUo6TxSgWka,5Gyp41oLVo7Gg7vF4vpmggWP5MU70QO6,18,41,27,17,7,0,19,1,112,16.0,7,0.0,14,27,11,7,27,0,6,19,1,59,53,1
7500,134559,ksNfAVxRMEES8VLMzIksZIeYctUCSThx,5Gyp41oLVo7Gg7vF4vpmggWP5MU70QO6,29,79,41,39,4,3,14,0,180,25.714285714285715,6,0.0,28,41,27,4,51,3,12,14,0,100,80,1
7501,134563,kh8VE8UOBKbQxAf60fsu5P6AQI3Mg2SI,5Gyp41oLVo7Gg7vF4vpmggWP5MU70QO6,5,2,1,0,1,0,2,0,6,0.8571428571428571,1,0.0,0,1,0,1,2,0,0,2,0,2,4,1
7502,134567,hiNjDCDcv1JzPRBZRj9QRfU9Ul6vxYgf,5Gyp41oLVo7Gg7vF4vpmggWP5MU70QO6,7,15,4,10,0,0,3,0,32,4.571428571428571,1,0.0,6,4,6,0,9,0,4,3,0,16,16,1
7503,134584,RqcoioXsh3XKcIvjfwDLLEg81fRmvmHR,5Gyp41oLVo7Gg7vF4vpmggWP5MU70QO6,17,26,17,11,7,15,8,0,84,12.0,4,0.0,3,17,7,7,23,15,4,8,0,34,50,1
7504,134594,9MoU4mYyLxZGlkWzRJvMH33Asx3kJrUp,5Gyp41oLVo7Gg7vF4vpmggWP5MU70QO6,1,0,0,0,0,0,1,0,1,0.14285714285714285,1,0.0,0,0,0,0,0,0,0,1,0,0,1,1
7505,134633,zKAhrujOiGZfEsROTNpBbZd0Qdis77Bp,5Gyp41oLVo7Gg7vF4vpmggWP5MU70QO6,10,3,2,0,2,1,9,1,18,2.5714285714285716,2,0.0,0,2,0,2,3,1,0,9,1,4,14,1
7506,134650,ddbvtBwQl3kZk0fkpLUfsVJDob0WKbwL,5Gyp41oLVo7Gg7vF4vpmggWP5MU70QO6,29,62,30,4,15,18,19,3,151,21.571428571428573,3,0.0,7,30,3,15,55,18,1,19,3,55,96,0
7507,134659,Oa3Yn1JDw25rNnHn2BNCxgiCAj54mdbE,5Gyp41oLVo7Gg7vF4vpmggWP5MU70QO6,13,15,8,2,2,0,2,0,29,4.142857142857143,1,0.0,1,8,1,2,14,0,1,2,0,12,17,1
7508,134662,gx5FGMroHWzRZAbfuAPz9BaAmYOVh1Wq,5Gyp41oLVo7Gg7vF4vpmggWP5MU70QO6,15,31,9,19,7,13,9,0,88,12.571428571428571,2,0.0,9,9,12,7,22,13,7,9,0,37,51,1
7509,134672,Upcsxs7PutcCAS0HYRGaNIEVa9NRKtxE,5Gyp41oLVo7Gg7vF4vpmggWP5MU70QO6,6,3,1,0,0,0,5,0,9,1.2857142857142858,1,0.0,1,1,0,0,2,0,0,5,0,2,7,1
7510,134675,moMMzrfQ7CU0tpyLDn2Hjh25aplXRW25,5Gyp41oLVo7Gg7vF4vpmggWP5MU70QO6,5,2,1,0,1,0,3,0,7,1.0,1,0.0,0,1,0,1,2,0,0,3,0,2,5,0
7511,134689,HH3HV5HDJ35z2ldQAEIDXBOSBTxLd6O9,5Gyp41oLVo7Gg7vF4vpmggWP5MU70QO6,8,5,4,0,2,0,3,0,14,2.0,2,0.0,0,4,0,2,5,0,0,3,0,6,8,1
7512,134693,kbBgYhAlCKyFUlNYYt4LArBWnUY9UyTM,5Gyp41oLVo7Gg7vF4vpmggWP5MU70QO6,20,27,12,8,16,0,11,1,75,10.714285714285714,5,0.0,10,12,6,16,17,0,2,11,1,44,31,1
7513,134697,Gn1QSm7WrSyhbej7tThohiyBKeBu1xtD,5Gyp41oLVo7Gg7vF4vpmggWP5MU70QO6,4,3,1,0,1,0,1,0,6,0.8571428571428571,1,0.0,0,1,0,1,3,0,0,1,0,2,4,1
7514,134721,WjOFL5fY7PnyGZ70shrhMlWXmSvOiiOF,5Gyp41oLVo7Gg7vF4vpmggWP5MU70QO6,16,17,13,4,8,0,6,0,48,6.857142857142857,3,0.0,0,13,2,8,17,0,2,6,0,23,25,1
7515,134732,WH2y6e5kNFN4KOU417IKr0Asm4FsSjc2,5Gyp41oLVo7Gg7vF4vpmggWP5MU70QO6,1,0,0,0,0,0,1,0,1,0.14285714285714285,1,0.0,0,0,0,0,0,0,0,1,0,0,1,1
7516,134775,w9OodY2DkN07ZOHp6V82rUeA2gts5jzg,5Gyp41oLVo7Gg7vF4vpmggWP5MU70QO6,5,3,1,0,1,0,2,0,7,1.0,1,0.0,1,1,0,1,2,0,0,2,0,3,4,1
7517,134780,SW7bpg7OnUpxZetcs9FXYocyVw4y5DC2,5Gyp41oLVo7Gg7vF4vpmggWP5MU70QO6,1,0,0,0,0,0,1,0,1,0.14285714285714285,1,0.0,0,0,0,0,0,0,0,1,0,0,1,1
7518,134783,UqUa9ycmfLRKCs1W6GNZrMpv4zQCpB0Z,5Gyp41oLVo7Gg7vF4vpmggWP5MU70QO6,4,1,1,0,0,2,2,0,6,0.8571428571428571,1,0.0,0,1,0,0,1,2,0,2,0,1,5,1
7519,134805,83JPfkin3GX4GLKqML2uaHSZ5KvsuJhM,5Gyp41oLVo7Gg7vF4vpmggWP5MU70QO6,7,3,2,0,2,0,2,0,9,1.2857142857142858,1,0.0,0,2,0,2,3,0,0,2,0,4,5,1
7520,134809,c6MvLohhRSOHpXmj2KJIEEUU9Ko3DsAE,5Gyp41oLVo7Gg7vF4vpmggWP5MU70QO6,10,6,3,0,2,0,6,2,19,2.7142857142857144,1,0.0,0,3,0,2,6,0,0,6,2,5,14,1
7521,134815,iNNgCVjnPK0MGKfhlyKj8GoKOMB3W92D,5Gyp41oLVo7Gg7vF4vpmggWP5MU70QO6,14,15,5,11,3,0,2,0,36,5.142857142857143,1,0.0,7,5,9,3,8,0,2,2,0,24,12,1
7522,134827,tPYh43YRHAzuf09xESxSKtWvST0aCsjn,5Gyp41oLVo7Gg7vF4vpmggWP5MU70QO6,6,4,1,0,1,0,2,0,8,1.1428571428571428,2,0.0,1,1,0,1,3,0,0,2,0,3,5,1
7523,134840,XcU2XTxeLZ8F89uBFmVFyW4cnWhjcEiA,5Gyp41oLVo7Gg7vF4vpmggWP5MU70QO6,8,11,5,0,4,0,5,0,25,3.5714285714285716,3,0.0,0,5,0,4,11,0,0,5,0,9,16,1
7524,134844,pYMEq6adAaeFJxcPpdDbnbqDzfuRI1mt,5Gyp41oLVo7Gg7vF4vpmggWP5MU70QO6,2,0,0,0,0,0,2,0,2,0.2857142857142857,1,0.0,0,0,0,0,0,0,0,2,0,0,2,1
7525,134854,KJqUOLVAd1FyK5g7kqbZ8lY5N2SYBafA,5Gyp41oLVo7Gg7vF4vpmggWP5MU70QO6,9,10,5,0,3,0,2,0,20,2.857142857142857,2,0.0,2,5,0,3,8,0,0,2,0,10,10,1
7526,134858,5noipPo5VTPoPCMnJr7wHe0HAODyBacQ,5Gyp41oLVo7Gg7vF4vpmggWP5MU70QO6,3,2,0,0,0,0,1,0,3,0.42857142857142855,1,0.0,0,0,0,0,2,0,0,1,0,0,3,1
7527,134861,N4fyUnhISdHnkeTlPumn2X5ScJFZ9i7p,5Gyp41oLVo7Gg7vF4vpmggWP5MU70QO6,4,2,1,0,1,0,2,0,6,0.8571428571428571,1,0.0,0,1,0,1,2,0,0,2,0,2,4,0
7528,134867,CJsdnbZnXaaflhjI7MJG4OBPTfx5Ftd2,5Gyp41oLVo7Gg7vF4vpmggWP5MU70QO6,19,36,13,0,15,0,5,1,70,10.0,4,0.0,15,13,0,15,21,0,0,5,1,43,27,1
7529,134870,w8QmJ9keTdAkvalvfgb4RcvfzqWsy2d6,5Gyp41oLVo7Gg7vF4vpmggWP5MU70QO6,1,0,0,0,0,0,1,0,1,0.14285714285714285,1,0.0,0,0,0,0,0,0,0,1,0,0,1,1
7530,134873,2p83wyVdSqhGAvxVO3TZHSqVlPrrZUal,5Gyp41oLVo7Gg7vF4vpmggWP5MU70QO6,5,3,1,0,1,0,1,0,6,0.8571428571428571,1,0.0,0,1,0,1,3,0,0,1,0,2,4,1
7531,134878,ii2A13wfEFESJFjBwmeLdddKw9K2NSuJ,5Gyp41oLVo7Gg7vF4vpmggWP5MU70QO6,7,11,6,0,3,0,7,0,27,3.857142857142857,3,0.0,0,6,0,3,11,0,0,7,0,9,18,1
7532,134882,aZ8T0PIqtCkHj0f6n6hIT9Eb58yHz02G,5Gyp41oLVo7Gg7vF4vpmggWP5MU70QO6,24,52,28,14,8,59,18,2,181,25.857142857142858,4,0.0,10,28,12,8,42,59,2,18,2,58,123,1
7533,134884,yrcAK1UDzOveofVcHCH4rjr6H1189vM3,5Gyp41oLVo7Gg7vF4vpmggWP5MU70QO6,1,0,0,0,0,0,1,0,1,0.14285714285714285,1,0.0,0,0,0,0,0,0,0,1,0,0,1,1
7534,134898,D9LfxzYr3RBoIHDv0ptNmGtJFETAdaea,5Gyp41oLVo7Gg7vF4vpmggWP5MU70QO6,18,29,12,14,5,0,6,0,66,9.428571428571429,4,0.0,7,12,12,5,22,0,2,6,0,36,30,1
7535,134909,GfFjXeeiX86hNL5LrfmBqRsIDiX1X26k,SpATywNh6bZuzm8s1ceuBUnMUAeoAHHw,5,7,5,0,1,0,2,0,15,2.142857142857143,1,0.0,0,5,0,1,7,0,0,2,0,6,9,1
7536,135022,f0rWHmI4rV7ssYizy9jzg3UxqKTtG19Y,SpATywNh6bZuzm8s1ceuBUnMUAeoAHHw,13,15,0,18,0,0,10,0,43,6.142857142857143,4,0.0,5,0,15,0,10,0,3,10,0,20,23,0
7537,135025,tedGThhHMqVARfBh6zyzyocTKbTJYJpB,SpATywNh6bZuzm8s1ceuBUnMUAeoAHHw,3,2,1,0,0,1,1,0,5,0.7142857142857143,1,0.0,0,1,0,0,2,1,0,1,0,1,4,1
7538,135026,Cue1j1CEK4ByBYziFbTJAskjanGgrJp6,SpATywNh6bZuzm8s1ceuBUnMUAeoAHHw,21,23,0,34,0,0,5,0,62,8.857142857142858,1,0.0,6,0,34,0,17,0,0,5,0,40,22,0
7539,135065,g9QyBrQkEVh9IC3JA81b7KgVa01DwgUa,SpATywNh6bZuzm8s1ceuBUnMUAeoAHHw,8,5,4,0,2,0,1,0,12,1.7142857142857142,1,0.0,0,4,0,2,5,0,0,1,0,6,6,1
7540,135079,GFArLd1huQSmyLkNR2x5AlhFrFWDXs0N,SpATywNh6bZuzm8s1ceuBUnMUAeoAHHw,2,4,3,0,0,0,0,0,7,1.0,2,0.0,0,3,0,0,4,0,0,0,0,3,4,0
7541,135137,A3FGIvcpmP9UeVzECTe66iC9lFbKmHRb,A3fsA9Zfv1X2fVEQhTw51lKENdNrEqT3,10,7,5,0,3,4,2,0,21,3.0,1,0.0,0,5,0,3,7,4,0,2,0,8,13,1
7542,135172,qLscbApWydA7z1h7Ht7RN2UnF0mvGZpF,RXDvfPUBYFlVdlueBFbLW0mhhAyGEqpt,6,5,1,0,1,0,1,0,8,1.1428571428571428,1,0.0,0,1,0,1,5,0,0,1,0,2,6,1
7543,135234,8JTz84ZDdJm6tvsd7hgyCl1RB6wU6r2e,A3fsA9Zfv1X2fVEQhTw51lKENdNrEqT3,6,3,2,0,1,0,2,0,8,1.1428571428571428,1,0.0,0,2,0,1,3,0,0,2,0,3,5,1
7544,135377,ZfIQYurnR6gJbWxLJ81cU3ZqzX4mpHm0,SpATywNh6bZuzm8s1ceuBUnMUAeoAHHw,13,15,7,0,5,0,2,0,29,4.142857142857143,2,0.0,0,7,0,5,15,0,0,2,0,12,17,0
7545,135390,IGFSjvLtGQCYdnhMcrAQcaIreY53ybWv,bWdj2GDclj5ofokWjzoa5jAwMkxCykd6,24,72,33,55,16,0,7,0,183,26.142857142857142,3,0.0,14,33,49,16,58,0,6,7,0,112,71,0
7546,135459,EXZ81qqSldwR1xdBEwBZ7wmgbTHF86sl,bWdj2GDclj5ofokWjzoa5jAwMkxCykd6,34,29,20,93,15,2,4,1,164,23.428571428571427,1,0.0,4,20,75,15,25,2,18,4,1,114,50,0
7547,135553,HQ9RppyfbU41Pv363qQe8zqkh0OzGsvv,SpATywNh6bZuzm8s1ceuBUnMUAeoAHHw,8,8,3,0,1,0,2,0,14,2.0,1,0.0,0,3,0,1,8,0,0,2,0,4,10,1
7548,135554,nrNRU1bochGfgxXZNdc89zA9KtJYIKVZ,SpATywNh6bZuzm8s1ceuBUnMUAeoAHHw,10,10,5,6,1,0,1,0,23,3.2857142857142856,1,0.0,4,5,6,1,6,0,0,1,0,16,7,0
7549,135590,VYMfm0tgVS6x4Eosz9NPpRPYpCrgFsMy,RXDvfPUBYFlVdlueBFbLW0mhhAyGEqpt,37,84,7,85,7,5,11,0,199,28.428571428571427,4,0.0,25,7,72,7,59,5,13,11,0,111,88,0
7550,135627,p8PDk7PIRcdv8OilLQ1EB9K2d3Uc8Sea,SpATywNh6bZuzm8s1ceuBUnMUAeoAHHw,5,3,2,0,1,0,1,0,7,1.0,2,0.0,0,2,0,1,3,0,0,1,0,3,4,1
7551,135651,8E88mVxxHiSEV3ReMbiLkIuYAxJ6YXeO,A3fsA9Zfv1X2fVEQhTw51lKENdNrEqT3,9,7,5,0,2,0,2,0,16,2.2857142857142856,2,0.0,0,5,0,2,7,0,0,2,0,7,9,0
7552,135709,EvNxwwShcQXgwZllGhuS7z5fGOL08A9A,SpATywNh6bZuzm8s1ceuBUnMUAeoAHHw,17,38,14,0,10,0,3,0,65,9.285714285714286,3,0.0,2,14,0,10,36,0,0,3,0,26,39,0
7553,135713,uw4petWia8mRNE3kHXaUdR4MrfrMeMii,SpATywNh6bZuzm8s1ceuBUnMUAeoAHHw,13,9,6,0,4,0,2,0,21,3.0,2,0.0,0,6,0,4,9,0,0,2,0,10,11,0
7554,135730,H8XaU1gbefHT7MZ45ya2B80ofczKeIUJ,bWdj2GDclj5ofokWjzoa5jAwMkxCykd6,30,26,15,34,7,0,9,0,91,13.0,3,0.0,6,15,25,7,20,0,9,9,0,53,38,0
7555,135840,Pk1zvEWPdVckXHLEawuIZZjckq66QamN,A3fsA9Zfv1X2fVEQhTw51lKENdNrEqT3,6,6,1,0,1,0,1,0,9,1.2857142857142858,2,0.0,0,1,0,1,6,0,0,1,0,2,7,1
7556,135841,Pk1zvEWPdVckXHLEawuIZZjckq66QamN,5X6FeZozNMgE2VRi3MJYjkkFK8SETtu2,13,24,2,0,3,0,10,0,39,5.571428571428571,3,0.0,1,2,0,3,23,0,0,10,0,6,33,1
7557,135843,QGuKTIBC2KLaYpPdOnB4nXCWgxMM1Dog,bWdj2GDclj5ofokWjzoa5jAwMkxCykd6,6,7,4,0,1,0,3,0,15,2.142857142857143,3,0.0,0,4,0,1,7,0,0,3,0,5,10,0
7558,135845,2Xqni7LSMWD8x13lDJQiPucRiXMjxJoU,SpATywNh6bZuzm8s1ceuBUnMUAeoAHHw,44,87,32,52,14,0,9,0,194,27.714285714285715,2,0.0,25,32,43,14,62,0,9,9,0,114,80,0
7559,135849,xn2e8QAPLTKhGQZStwXhUOgjA9bf3xHv,SpATywNh6bZuzm8s1ceuBUnMUAeoAHHw,11,18,1,5,0,6,5,1,36,5.142857142857143,1,0.0,7,1,5,0,11,6,0,5,1,13,23,0
7560,135862,vVomSgkHkyw3sqrRqYKc3zE1eWaa2d4G,A3fsA9Zfv1X2fVEQhTw51lKENdNrEqT3,147,91,74,358,61,88,29,0,701,100.14285714285714,7,0.0,16,74,296,61,75,88,62,29,0,447,254,0
7561,135865,4qEc82DhaeJuxSG1re8zPgEROlFltHL5,SpATywNh6bZuzm8s1ceuBUnMUAeoAHHw,37,57,32,38,23,0,7,0,157,22.428571428571427,5,0.0,15,32,32,23,42,0,6,7,0,102,55,0
7562,135875,24fGHeKkFcKUohpd2rziJRSIJ4SrDKtC,RXDvfPUBYFlVdlueBFbLW0mhhAyGEqpt,9,7,5,0,3,0,2,0,17,2.4285714285714284,1,0.0,1,5,0,3,6,0,0,2,0,9,8,0
7563,135886,gmM0J4w8n6qKhDnAM2MwKDXTUMCCwDIV,SpATywNh6bZuzm8s1ceuBUnMUAeoAHHw,10,13,1,14,0,0,2,0,30,4.285714285714286,1,0.0,8,1,13,0,5,0,1,2,0,22,8,1
7564,135890,L4RizFe7sTSIk0fwYQceBQCkzU4YI9f8,5X6FeZozNMgE2VRi3MJYjkkFK8SETtu2,1,0,0,0,0,0,1,0,1,0.14285714285714285,1,0.0,0,0,0,0,0,0,0,1,0,0,1,1
7565,135894,gMjUjoj7lChD8J5g7c3W6YLbo2nPVjuD,SpATywNh6bZuzm8s1ceuBUnMUAeoAHHw,1,0,0,0,0,0,1,0,1,0.14285714285714285,1,0.0,0,0,0,0,0,0,0,1,0,0,1,1
7566,135902,bjYQe6htagSVxSwarZfLS2CglzR1VJVW,SpATywNh6bZuzm8s1ceuBUnMUAeoAHHw,20,17,7,32,1,5,5,0,67,9.571428571428571,1,0.0,8,7,28,1,9,5,4,5,0,44,23,1
7567,135905,YNfGmODVWZ9Dsat8A5knWQhPiQd6NNVe,5X6FeZozNMgE2VRi3MJYjkkFK8SETtu2,2,0,0,0,0,0,3,0,3,0.42857142857142855,1,0.0,0,0,0,0,0,0,0,3,0,0,3,1
7568,135911,Qb2VAk3EqflWvF2aBP5imzRDjkUce9e9,5X6FeZozNMgE2VRi3MJYjkkFK8SETtu2,7,2,1,0,1,0,10,1,15,2.142857142857143,1,0.0,0,1,0,1,2,0,0,10,1,2,13,1
7569,135917,jThN2fUIAYaL9Gu4llat9u94XkdISlbQ,A3fsA9Zfv1X2fVEQhTw51lKENdNrEqT3,8,6,3,0,1,3,6,1,20,2.857142857142857,1,0.0,0,3,0,1,6,3,0,6,1,4,16,1
7570,135923,xC1fO9XXT3Iratd3KBQhzTB1rjClmcJ6,SpATywNh6bZuzm8s1ceuBUnMUAeoAHHw,1,0,0,0,0,0,1,0,1,0.14285714285714285,1,0.0,0,0,0,0,0,0,0,1,0,0,1,1
7571,135932,lZ2VhV25LolxMF5drRCLEdlcMBg33ClU,SpATywNh6bZuzm8s1ceuBUnMUAeoAHHw,5,2,1,0,1,0,2,0,6,0.8571428571428571,1,0.0,0,1,0,1,2,0,0,2,0,2,4,1
7572,135935,sHOnkDTcrFCU5Jo5xXpxGND4wJy0klei,SpATywNh6bZuzm8s1ceuBUnMUAeoAHHw,6,5,2,0,1,0,3,0,11,1.5714285714285714,2,0.0,0,2,0,1,5,0,0,3,0,3,8,0
7573,135945,XmVfu8b0NT585Rk8rPE03AjpricGuNHv,SpATywNh6bZuzm8s1ceuBUnMUAeoAHHw,2,0,0,0,0,0,3,0,3,0.42857142857142855,1,0.0,0,0,0,0,0,0,0,3,0,0,3,1
7574,135962,sd2HYLRck3MQjoR7Fod62oDtNeNgK3C5,A3fsA9Zfv1X2fVEQhTw51lKENdNrEqT3,7,9,6,0,2,0,3,0,20,2.857142857142857,1,0.0,0,6,0,2,9,0,0,3,0,8,12,1
7575,135964,5IM8g7YMOYo5qH7Yu3x31T3JkVOH9iqe,5X6FeZozNMgE2VRi3MJYjkkFK8SETtu2,3,6,1,0,2,0,1,0,10,1.4285714285714286,3,0.0,4,1,0,2,2,0,0,1,0,7,3,1
7576,135969,QiJcxNGmLOdmB6eeGiBPeeCTz8AUKVVD,A3fsA9Zfv1X2fVEQhTw51lKENdNrEqT3,3,2,0,0,0,0,1,0,3,0.42857142857142855,1,0.0,0,0,0,0,2,0,0,1,0,0,3,1
7577,135979,EUmZ5qzjwgko2PIWEnctkvYh7APnUrX9,RXDvfPUBYFlVdlueBFbLW0mhhAyGEqpt,1,0,0,0,0,0,1,0,1,0.14285714285714285,1,0.0,0,0,0,0,0,0,0,1,0,0,1,1
7578,135990,0GwZKbglv2axpDLt9t1EIlEZPdi9oKMJ,SpATywNh6bZuzm8s1ceuBUnMUAeoAHHw,2,0,0,0,0,0,2,0,2,0.2857142857142857,1,0.0,0,0,0,0,0,0,0,2,0,0,2,1
7579,136004,XpLwBNjV7lkbo9HRLwBFqy6jHSpPfym2,SpATywNh6bZuzm8s1ceuBUnMUAeoAHHw,19,22,14,2,5,0,7,0,50,7.142857142857143,5,0.0,0,14,2,5,22,0,0,7,0,21,29,0
7580,136012,LaO7E37BdY8VqMXTF49jfx8d5McZiaHN,bWdj2GDclj5ofokWjzoa5jAwMkxCykd6,6,6,0,0,1,0,3,0,10,1.4285714285714286,1,0.0,2,0,0,1,4,0,0,3,0,3,7,0
7581,136017,bxVkqjPmTpKkwZ9Y0agYRXY3zPgPsTDB,G8EPVSXsOYB5YQWZGiz1aVq5Pgr2GrQu,18,19,8,18,6,0,13,1,65,9.285714285714286,1,0.0,6,8,11,6,13,0,7,13,1,31,34,1
7582,136019,tsxz81bRlBY4gWUPDrcO93vpZmKMgcU8,5X6FeZozNMgE2VRi3MJYjkkFK8SETtu2,13,13,3,14,4,0,4,0,38,5.428571428571429,1,0.0,9,3,13,4,4,0,1,4,0,29,9,1
7583,136020,OEx9XlzSJPvCfbdzSv0p8sreAOhdWSET,bWdj2GDclj5ofokWjzoa5jAwMkxCykd6,5,3,1,0,0,5,3,0,12,1.7142857142857142,2,0.0,0,1,0,0,3,5,0,3,0,1,11,1
7584,136048,xWwql10Poq2nC5ehRq5ahsRV2QaMLare,SpATywNh6bZuzm8s1ceuBUnMUAeoAHHw,2,0,0,0,0,0,2,0,2,0.2857142857142857,1,0.0,0,0,0,0,0,0,0,2,0,0,2,0
7585,136056,jZ0eoqf68jVZDAR48vBfzauQgdjvrEqJ,G8EPVSXsOYB5YQWZGiz1aVq5Pgr2GrQu,20,44,1,50,0,0,3,0,98,14.0,1,0.0,23,1,31,0,21,0,19,3,0,55,43,1
7586,136074,MTeW6df78qysZ1Jvgm5EKkKFkGm6msW0,5X6FeZozNMgE2VRi3MJYjkkFK8SETtu2,4,2,1,0,0,0,2,0,5,0.7142857142857143,1,0.0,0,1,0,0,2,0,0,2,0,1,4,1
7587,136077,MTeW6df78qysZ1Jvgm5EKkKFkGm6msW0,RXDvfPUBYFlVdlueBFbLW0mhhAyGEqpt,5,0,0,0,0,1,6,1,8,1.1428571428571428,1,0.0,0,0,0,0,0,1,0,6,1,0,8,1
7588,136081,NXeIrAtl4TJPBDinWk0pYLhNqLRjiyXI,5X6FeZozNMgE2VRi3MJYjkkFK8SETtu2,6,3,2,0,1,0,2,0,8,1.1428571428571428,1,0.0,0,2,0,1,3,0,0,2,0,3,5,1
7589,136085,ISRJxWtuG9U7GF6GcMl2UZgUHAWLyOgM,A3fsA9Zfv1X2fVEQhTw51lKENdNrEqT3,10,3,2,0,1,3,11,3,23,3.2857142857142856,3,0.0,0,2,0,1,3,3,0,11,3,3,20,0
7590,136086,ISRJxWtuG9U7GF6GcMl2UZgUHAWLyOgM,bWdj2GDclj5ofokWjzoa5jAwMkxCykd6,12,12,8,0,4,42,8,0,74,10.571428571428571,4,0.0,0,8,0,4,12,42,0,8,0,12,62,0
7591,136095,uXyiNHzEVwnpCSssM0aWRjomS3dwzYaL,SpATywNh6bZuzm8s1ceuBUnMUAeoAHHw,13,20,0,0,0,0,2,0,22,3.142857142857143,1,0.0,3,0,0,0,17,0,0,2,0,3,19,0
7592,136110,4hir3Sv8g9bUyBqCpr3Vgjb1N07LRCPz,A3fsA9Zfv1X2fVEQhTw51lKENdNrEqT3,2,0,0,0,0,0,2,0,2,0.2857142857142857,1,0.0,0,0,0,0,0,0,0,2,0,0,2,1
7593,136114,3exvyw11zltqnBdt86hlE5k5NZvsKC1z,RXDvfPUBYFlVdlueBFbLW0mhhAyGEqpt,4,2,0,0,0,0,2,0,4,0.5714285714285714,1,0.0,0,0,0,0,2,0,0,2,0,0,4,1
7594,136120,tsxz81bRlBY4gWUPDrcO93vpZmKMgcU8,SpATywNh6bZuzm8s1ceuBUnMUAeoAHHw,4,3,2,0,1,0,1,0,7,1.0,1,0.0,0,2,0,1,3,0,0,1,0,3,4,1
7595,136130,666OQYHx8i8d2hinFlAK7dxUOOZcApAj,SpATywNh6bZuzm8s1ceuBUnMUAeoAHHw,1,0,0,0,0,0,1,0,1,0.14285714285714285,1,0.0,0,0,0,0,0,0,0,1,0,0,1,1
7596,136131,b4Feba3LJSWsgarojVs0WLNWDZ1jrcmd,SpATywNh6bZuzm8s1ceuBUnMUAeoAHHw,2,0,0,0,0,0,2,0,2,0.2857142857142857,1,0.0,0,0,0,0,0,0,0,2,0,0,2,1
7597,136136,xO7vYxMID7HxPGLvxbV5LQ1jK9mDso5R,SpATywNh6bZuzm8s1ceuBUnMUAeoAHHw,2,0,0,0,0,0,2,0,2,0.2857142857142857,1,0.0,0,0,0,0,0,0,0,2,0,0,2,1
7598,136148,RP2jV6jjwQkPvCJ29dWOhHWofGNeYm6i,SpATywNh6bZuzm8s1ceuBUnMUAeoAHHw,2,0,0,0,0,0,3,0,3,0.42857142857142855,1,0.0,0,0,0,0,0,0,0,3,0,0,3,1
7599,136150,7aQ6rvmUrAZhXOumaP4VW6FvjX4qSmMG,SpATywNh6bZuzm8s1ceuBUnMUAeoAHHw,4,3,1,0,0,0,1,0,5,0.7142857142857143,1,0.0,0,1,0,0,3,0,0,1,0,1,4,1
7600,136153,UTOVD7URrJRdTcIox1GiNWQleZgjmsMx,SpATywNh6bZuzm8s1ceuBUnMUAeoAHHw,20,52,28,4,16,2,9,0,111,15.857142857142858,3,0.0,3,28,4,16,49,2,0,9,0,51,60,0
7601,136171,k78W30WU6hGeuM4l1VhrFhC8Jch0QJdh,A3fsA9Zfv1X2fVEQhTw51lKENdNrEqT3,19,11,1,30,0,4,8,1,55,7.857142857142857,1,0.0,2,1,27,0,9,4,3,8,1,30,25,1
7602,136180,UqksMVZ1lLvn2u7s6dT9SU5OFeNJnaAy,bWdj2GDclj5ofokWjzoa5jAwMkxCykd6,9,9,4,0,3,0,4,1,21,3.0,2,0.0,0,4,0,3,9,0,0,4,1,7,14,1
7603,136190,6AOP0TbDCcGOu9XhtyzhNlxsPVcDEYNy,bWdj2GDclj5ofokWjzoa5jAwMkxCykd6,7,5,1,0,0,0,2,0,8,1.1428571428571428,1,0.0,0,1,0,0,5,0,0,2,0,1,7,1
7604,136245,Ovk8jBBHwwhBttek79ARCgIpAVxMH1wF,SpATywNh6bZuzm8s1ceuBUnMUAeoAHHw,4,3,1,0,1,0,1,0,6,0.8571428571428571,1,0.0,0,1,0,1,3,0,0,1,0,2,4,0
7605,136249,g53rlFGTNWSVgS4daSHwoJU8msIth7kH,5X6FeZozNMgE2VRi3MJYjkkFK8SETtu2,5,12,2,0,2,0,1,0,17,2.4285714285714284,1,0.0,1,2,0,2,11,0,0,1,0,5,12,1
7606,136257,8uSQsFhnhoJeSVZylwMfyqKR37MO9Qyr,SpATywNh6bZuzm8s1ceuBUnMUAeoAHHw,10,16,7,0,1,18,6,0,48,6.857142857142857,3,0.0,6,7,0,1,10,18,0,6,0,14,34,0
7607,136280,1pbL8yRf5isuKA2AbZrt88AKZzNS9VL8,SpATywNh6bZuzm8s1ceuBUnMUAeoAHHw,3,2,1,0,0,0,1,0,4,0.5714285714285714,1,0.0,0,1,0,0,2,0,0,1,0,1,3,1
7608,136282,no2ug7TKVsupL4LU2a5jY2GhYHkskTdw,SpATywNh6bZuzm8s1ceuBUnMUAeoAHHw,6,6,3,0,2,0,2,0,13,1.8571428571428572,1,0.0,0,3,0,2,6,0,0,2,0,5,8,0
7609,136298,wGXRcY0FS7DP9yn6e6xwYPxjUYuVv96W,SpATywNh6bZuzm8s1ceuBUnMUAeoAHHw,7,3,2,0,2,0,2,0,9,1.2857142857142858,1,0.0,0,2,0,2,3,0,0,2,0,4,5,1
7610,136299,4R8cjmGXnx8F1dFD5UPDPTI5U03hvnfJ,G8EPVSXsOYB5YQWZGiz1aVq5Pgr2GrQu,11,7,6,0,5,0,4,0,22,3.142857142857143,1,0.0,0,6,0,5,7,0,0,4,0,11,11,1
7611,136328,hPJzs2Znzz5zy7cTuvUrQwTmAG1EpX7Y,SpATywNh6bZuzm8s1ceuBUnMUAeoAHHw,1,0,0,0,0,0,1,0,1,0.14285714285714285,1,0.0,0,0,0,0,0,0,0,1,0,0,1,1
7612,136336,QcbB4zGNvIA8Hos1EmgULZPHy4JycNs5,bWdj2GDclj5ofokWjzoa5jAwMkxCykd6,1,0,0,0,0,0,1,0,1,0.14285714285714285,1,0.0,0,0,0,0,0,0,0,1,0,0,1,0
7613,136338,QcbB4zGNvIA8Hos1EmgULZPHy4JycNs5,A3fsA9Zfv1X2fVEQhTw51lKENdNrEqT3,1,0,0,0,0,0,1,0,1,0.14285714285714285,1,0.0,0,0,0,0,0,0,0,1,0,0,1,0
7614,136339,xFOMKgrHGqKyL5uPk9RcNRWczzZxvoeN,SpATywNh6bZuzm8s1ceuBUnMUAeoAHHw,1,0,0,0,0,0,1,0,1,0.14285714285714285,1,0.0,0,0,0,0,0,0,0,1,0,0,1,1
7615,136346,xFOMKgrHGqKyL5uPk9RcNRWczzZxvoeN,5X6FeZozNMgE2VRi3MJYjkkFK8SETtu2,1,0,0,0,0,0,1,0,1,0.14285714285714285,1,0.0,0,0,0,0,0,0,0,1,0,0,1,1
7616,136349,xFOMKgrHGqKyL5uPk9RcNRWczzZxvoeN,bWdj2GDclj5ofokWjzoa5jAwMkxCykd6,1,0,0,0,0,0,1,0,1,0.14285714285714285,1,0.0,0,0,0,0,0,0,0,1,0,0,1,1
7617,136352,xFOMKgrHGqKyL5uPk9RcNRWczzZxvoeN,G8EPVSXsOYB5YQWZGiz1aVq5Pgr2GrQu,1,0,0,0,0,0,1,0,1,0.14285714285714285,1,0.0,0,0,0,0,0,0,0,1,0,0,1,1
7618,136355,xFOMKgrHGqKyL5uPk9RcNRWczzZxvoeN,A3fsA9Zfv1X2fVEQhTw51lKENdNrEqT3,1,0,0,0,0,0,1,0,1,0.14285714285714285,1,0.0,0,0,0,0,0,0,0,1,0,0,1,1
7619,136362,Mw4t3dXzBgtXgl1Dgl3JStk2pBYNem1r,5X6FeZozNMgE2VRi3MJYjkkFK8SETtu2,5,10,1,0,2,0,17,0,30,4.285714285714286,2,0.0,3,1,0,2,7,0,0,17,0,6,24,1
7620,136368,3RPGU51kghTa1yQ8sk1JkQkDTlLpjaeu,A3fsA9Zfv1X2fVEQhTw51lKENdNrEqT3,8,5,1,0,1,0,3,0,10,1.4285714285714286,2,0.0,0,1,0,1,5,0,0,3,0,2,8,1
7621,136382,j9lNHQGLA7OPE7lvH45cTyJTdanzS09h,A3fsA9Zfv1X2fVEQhTw51lKENdNrEqT3,11,5,4,0,4,0,2,0,15,2.142857142857143,1,0.0,0,4,0,4,5,0,0,2,0,8,7,1
7622,136386,FM7LvWy0SQdmiC09CRsUT44n0BqWWa2S,SpATywNh6bZuzm8s1ceuBUnMUAeoAHHw,14,29,11,0,9,0,1,0,50,7.142857142857143,2,0.0,0,11,0,9,29,0,0,1,0,20,30,0
7623,136409,ljhfk5EzYux6UZXtMstOyqxrBX64Rvre,SpATywNh6bZuzm8s1ceuBUnMUAeoAHHw,3,2,0,0,0,0,7,0,9,1.2857142857142858,1,0.0,0,0,0,0,2,0,0,7,0,0,9,0
7624,136410,4veNYFa5yTlgZEZ3CkxGfwseJV8Djm6t,bWdj2GDclj5ofokWjzoa5jAwMkxCykd6,6,6,1,0,0,0,3,0,10,1.4285714285714286,2,0.0,0,1,0,0,6,0,0,3,0,1,9,1
7625,136411,AUmfgp7YjPBzDSEEKYtmp5NT1ZaUbwCu,A3fsA9Zfv1X2fVEQhTw51lKENdNrEqT3,71,74,48,180,29,32,12,1,376,53.714285714285715,5,0.0,4,48,153,29,70,32,27,12,1,234,142,0
7626,136420,8jpbZSOP0aE5k9lcpChp2bvVbSS59iit,SpATywNh6bZuzm8s1ceuBUnMUAeoAHHw,36,30,20,28,15,0,6,1,100,14.285714285714286,2,0.0,7,20,23,15,23,0,5,6,1,65,35,0
7627,136421,hB4yTUnQMne1LtjUUKgpcnhj6jq7S5Co,SpATywNh6bZuzm8s1ceuBUnMUAeoAHHw,32,42,22,10,12,0,7,0,93,13.285714285714286,6,0.0,5,22,10,12,37,0,0,7,0,49,44,0
7628,136422,4veNYFa5yTlgZEZ3CkxGfwseJV8Djm6t,A3fsA9Zfv1X2fVEQhTw51lKENdNrEqT3,41,31,4,82,7,0,7,0,131,18.714285714285715,2,0.0,4,4,70,7,27,0,12,7,0,85,46,0
7629,136425,jM1yIagOMV2CwD8o07UMrVdo7z0hqKJ4,5X6FeZozNMgE2VRi3MJYjkkFK8SETtu2,6,19,10,0,1,4,7,0,41,5.857142857142857,5,0.0,1,10,0,1,18,4,0,7,0,12,29,0
7630,136435,weCw07EYZU6NaXQgOr28J3dXwtDDCJwg,5X6FeZozNMgE2VRi3MJYjkkFK8SETtu2,6,3,2,0,2,0,1,0,8,1.1428571428571428,1,0.0,0,2,0,2,3,0,0,1,0,4,4,1
7631,136438,HyMGoDUSgioYVPglnQqdB8DhnJM0oHcU,A3fsA9Zfv1X2fVEQhTw51lKENdNrEqT3,1,0,0,0,0,0,1,0,1,0.14285714285714285,1,0.0,0,0,0,0,0,0,0,1,0,0,1,1
7632,136440,DVIil2NM7ZWOtqe6rhlMzwEUAb2wuaeh,5X6FeZozNMgE2VRi3MJYjkkFK8SETtu2,1,0,0,0,0,0,1,0,1,0.14285714285714285,1,0.0,0,0,0,0,0,0,0,1,0,0,1,1
7633,136446,weCw07EYZU6NaXQgOr28J3dXwtDDCJwg,RXDvfPUBYFlVdlueBFbLW0mhhAyGEqpt,9,4,3,0,3,0,2,0,12,1.7142857142857142,1,0.0,0,3,0,3,4,0,0,2,0,6,6,1
7634,136461,hZR4MwcYec4g0GoOyJFngJGEyWOySpv2,5X6FeZozNMgE2VRi3MJYjkkFK8SETtu2,7,6,3,4,1,36,16,0,66,9.428571428571429,7,0.0,1,3,3,1,5,36,1,16,0,8,58,0
7635,136466,qXoRddrZtWOuvSZYQLEOpoSpuxUBUiL4,A3fsA9Zfv1X2fVEQhTw51lKENdNrEqT3,1,0,0,0,0,0,1,0,1,0.14285714285714285,1,0.0,0,0,0,0,0,0,0,1,0,0,1,1
7636,136473,uKUfxynVzKG6LprgAyIbTEdFcLOGHJ0Q,SpATywNh6bZuzm8s1ceuBUnMUAeoAHHw,11,13,1,4,1,0,3,0,22,3.142857142857143,2,0.0,0,1,3,1,13,0,1,3,0,5,17,0
7637,136478,TOr969xO1bNpukaioQsMN4lfT6tTyvHI,SpATywNh6bZuzm8s1ceuBUnMUAeoAHHw,37,51,22,16,14,0,16,0,119,17.0,3,0.0,7,22,14,14,44,0,2,16,0,57,62,0
7638,136483,uPKlyTEifU6j6OWoUY390CiDaPPnL9qV,SpATywNh6bZuzm8s1ceuBUnMUAeoAHHw,6,1,1,0,1,0,3,0,6,0.8571428571428571,1,0.0,0,1,0,1,1,0,0,3,0,2,4,1
7639,136485,TgUwmkEhin9XZ6XzvWTyPMnTPIOGlXFZ,SpATywNh6bZuzm8s1ceuBUnMUAeoAHHw,2,0,0,0,0,0,2,0,2,0.2857142857142857,1,0.0,0,0,0,0,0,0,0,2,0,0,2,0
7640,136493,g7heOlGZNASGuqQAq1vtv2tfdSi2ygyQ,SpATywNh6bZuzm8s1ceuBUnMUAeoAHHw,8,2,1,0,1,1,5,1,11,1.5714285714285714,1,0.0,0,1,0,1,2,1,0,5,1,2,9,1
7641,136494,63wtRrFP2u8VxjDoieh7TgM1REKECzZu,SpATywNh6bZuzm8s1ceuBUnMUAeoAHHw,1,0,0,0,0,0,1,0,1,0.14285714285714285,1,0.0,0,0,0,0,0,0,0,1,0,0,1,1
7642,136495,EbKjJZq8GOECUxJBvCCbIZN8O8RweU4z,A3fsA9Zfv1X2fVEQhTw51lKENdNrEqT3,3,3,1,0,0,0,1,0,5,0.7142857142857143,1,0.0,0,1,0,0,3,0,0,1,0,1,4,1
7643,136501,GuXg5t1KOGV3M6CZF2IvtkvJXCDk9jtc,SpATywNh6bZuzm8s1ceuBUnMUAeoAHHw,11,10,1,0,1,1,9,1,23,3.2857142857142856,1,0.0,0,1,0,1,10,1,0,9,1,2,21,1
7644,136513,hZR4MwcYec4g0GoOyJFngJGEyWOySpv2,bWdj2GDclj5ofokWjzoa5jAwMkxCykd6,2,2,1,0,0,9,0,0,12,1.7142857142857142,1,0.0,0,1,0,0,2,9,0,0,0,1,11,0
7645,136522,GmS9IJ1tMx7OD6choQVEGJmTtycHZhqQ,bWdj2GDclj5ofokWjzoa5jAwMkxCykd6,1,0,0,0,0,0,1,0,1,0.14285714285714285,1,0.0,0,0,0,0,0,0,0,1,0,0,1,1
7646,136528,rv34ybrhOrkX6Z4MXzYyRTcPq51q6XCl,SpATywNh6bZuzm8s1ceuBUnMUAeoAHHw,9,21,12,0,6,0,12,0,51,7.285714285714286,2,0.0,0,12,0,6,21,0,0,12,0,18,33,1
7647,136530,hZR4MwcYec4g0GoOyJFngJGEyWOySpv2,G8EPVSXsOYB5YQWZGiz1aVq5Pgr2GrQu,2,2,1,0,0,10,0,0,13,1.8571428571428572,1,0.0,0,1,0,0,2,10,0,0,0,1,12,0
7648,136538,8jpbZSOP0aE5k9lcpChp2bvVbSS59iit,RXDvfPUBYFlVdlueBFbLW0mhhAyGEqpt,1,0,0,0,0,0,1,0,1,0.14285714285714285,1,0.0,0,0,0,0,0,0,0,1,0,0,1,1
7649,136559,6MMO6p1gWBmDJN4eS7QrAi6Zg4mTPljX,G8EPVSXsOYB5YQWZGiz1aVq5Pgr2GrQu,14,30,0,4,1,2,11,0,48,6.857142857142857,4,0.0,10,0,3,1,20,2,1,11,0,14,34,0
7650,136562,UUf7W9nrVz0icOeIhIvztvvypaJKgHhN,SpATywNh6bZuzm8s1ceuBUnMUAeoAHHw,11,8,4,13,1,0,4,0,30,4.285714285714286,3,0.0,2,4,11,1,6,0,2,4,0,18,12,1
7651,136568,JHhY30IKFzw4LWcyrHuTEglWNqRkqdDU,5X6FeZozNMgE2VRi3MJYjkkFK8SETtu2,55,28,11,159,1,0,6,0,205,29.285714285714285,2,0.0,17,11,143,1,11,0,16,6,0,172,33,1
7652,136570,2GOnPZDHl4kPVWWzVJnEzynacGNkygXw,A3fsA9Zfv1X2fVEQhTw51lKENdNrEqT3,11,7,5,0,3,0,4,0,19,2.7142857142857144,1,0.0,0,5,0,3,7,0,0,4,0,8,11,0
7653,136571,fJnj3Gs4y1E0GRQDA0b4nicT5IqNhAL7,A3fsA9Zfv1X2fVEQhTw51lKENdNrEqT3,1,0,0,0,0,0,1,0,1,0.14285714285714285,1,0.0,0,0,0,0,0,0,0,1,0,0,1,1
7654,136576,wmN4PPC7Vh1X3pevAvwrqSI7HI55oZD6,A3fsA9Zfv1X2fVEQhTw51lKENdNrEqT3,28,11,6,50,3,0,9,0,79,11.285714285714286,1,0.0,1,6,46,3,10,0,4,9,0,56,23,1
7655,136591,o0iuVvrYPTZySn5yEHYo73kuRxBFTMxe,SpATywNh6bZuzm8s1ceuBUnMUAeoAHHw,1,0,0,0,0,0,1,0,1,0.14285714285714285,1,0.0,0,0,0,0,0,0,0,1,0,0,1,1
7656,136594,QRtm7L0oKi8rvP2PG9liN1Ys67kuGLCZ,RXDvfPUBYFlVdlueBFbLW0mhhAyGEqpt,1,0,0,0,0,0,1,0,1,0.14285714285714285,1,0.0,0,0,0,0,0,0,0,1,0,0,1,1
7657,136597,iahhmqoMx53j5nO5miK92n3wdWI8ut4z,SpATywNh6bZuzm8s1ceuBUnMUAeoAHHw,7,5,4,0,4,2,5,0,20,2.857142857142857,3,0.0,0,4,0,4,5,2,0,5,0,8,12,0
7658,136610,Cv1aavObJnuABKfipF6OGePzg0BnGPFs,5X6FeZozNMgE2VRi3MJYjkkFK8SETtu2,54,30,10,78,1,0,8,0,127,18.142857142857142,3,0.0,17,10,78,1,13,0,0,8,0,106,21,1
7659,136615,Cv1aavObJnuABKfipF6OGePzg0BnGPFs,RXDvfPUBYFlVdlueBFbLW0mhhAyGEqpt,30,15,8,36,1,0,2,0,62,8.857142857142858,1,0.0,7,8,36,1,8,0,0,2,0,52,10,1
7660,136620,bfFEc23kVgHyKqDcshH2CO7qZiUnZhfQ,bWdj2GDclj5ofokWjzoa5jAwMkxCykd6,7,7,4,0,2,1,1,0,15,2.142857142857143,2,0.0,0,4,0,2,7,1,0,1,0,6,9,1
7661,136643,z408zpaGYl7G62VwJXlIGs5keiUdQ81y,SpATywNh6bZuzm8s1ceuBUnMUAeoAHHw,1,0,0,0,0,0,1,0,1,0.14285714285714285,1,0.0,0,0,0,0,0,0,0,1,0,0,1,1
7662,136647,3Jrj6bKUtFj34BYovmjDUontE8TUY429,SpATywNh6bZuzm8s1ceuBUnMUAeoAHHw,22,26,9,10,6,4,11,1,67,9.571428571428571,2,0.0,10,9,8,6,16,4,2,11,1,33,34,1
7663,136653,LlgrfCdWy7IdZo4zpIOZQ4vT5Xv5Wwbk,5X6FeZozNMgE2VRi3MJYjkkFK8SETtu2,1,0,0,0,0,0,1,0,1,0.14285714285714285,1,0.0,0,0,0,0,0,0,0,1,0,0,1,1
7664,136656,KN2cc8h9ZKfIgxIX3NczsQQI5NEtrUt5,SpATywNh6bZuzm8s1ceuBUnMUAeoAHHw,1,0,0,0,0,0,1,0,1,0.14285714285714285,1,0.0,0,0,0,0,0,0,0,1,0,0,1,0
7665,136669,j54JBLGJIJ4pHZN5w24SsPoFU8DYGtev,SpATywNh6bZuzm8s1ceuBUnMUAeoAHHw,33,46,20,26,16,0,7,0,115,16.428571428571427,3,0.0,9,20,23,16,37,0,3,7,0,68,47,0
7666,136675,uQ8WwfJ7Kl3wLihefH5YIiAfDrgYf8YH,bWdj2GDclj5ofokWjzoa5jAwMkxCykd6,14,21,3,0,4,3,4,0,35,5.0,3,0.0,4,3,0,4,17,3,0,4,0,11,24,1
7667,136676,Qcmt6nwyac7kgzMGN63sluFXEZK788J1,A3fsA9Zfv1X2fVEQhTw51lKENdNrEqT3,1,0,0,0,0,0,1,0,1,0.14285714285714285,1,0.0,0,0,0,0,0,0,0,1,0,0,1,1
7668,136682,ZaYBly9HAeW4dviaZWb57mDYf3bYgYN7,A3fsA9Zfv1X2fVEQhTw51lKENdNrEqT3,9,2,2,0,2,0,8,1,15,2.142857142857143,1,0.0,0,2,0,2,2,0,0,8,1,4,11,1
7669,136683,J3FKLxbUlPTor4lyG8lMpHc8oUQEjfcp,RXDvfPUBYFlVdlueBFbLW0mhhAyGEqpt,18,39,15,0,9,0,12,0,75,10.714285714285714,4,0.0,7,15,0,9,32,0,0,12,0,31,44,0
7670,136686,ukPe6HZ0ITB9hheAlC2b7rfm3linyaBd,5X6FeZozNMgE2VRi3MJYjkkFK8SETtu2,1,0,0,0,0,0,1,0,1,0.14285714285714285,1,0.0,0,0,0,0,0,0,0,1,0,0,1,1
7671,136693,fylXIx1ixG3vXbV9AuGqPT7SpNyyk9u6,5X6FeZozNMgE2VRi3MJYjkkFK8SETtu2,6,7,0,0,0,0,2,0,9,1.2857142857142858,1,0.0,0,0,0,0,7,0,0,2,0,0,9,1
7672,136696,k6RJ44LpfDefc4BqSfb5Ks3bqRLzpbPs,bWdj2GDclj5ofokWjzoa5jAwMkxCykd6,6,3,0,0,0,0,4,0,7,1.0,1,0.0,0,0,0,0,3,0,0,4,0,0,7,1
7673,136697,ZbpLZuhcPXDt8MCBlzIEU31Qmn57Ldle,G8EPVSXsOYB5YQWZGiz1aVq5Pgr2GrQu,75,66,24,222,17,0,2,0,331,47.285714285714285,3,0.0,41,24,178,17,25,0,44,2,0,260,71,0
7674,136700,8rUphvLiXZqbGu38CKKOCcJ5A3GrLiLP,5X6FeZozNMgE2VRi3MJYjkkFK8SETtu2,8,22,7,0,2,0,4,0,35,5.0,2,0.0,0,7,0,2,22,0,0,4,0,9,26,1
7675,136701,0Vr5nGGnd8VQ31kkuDTufqDyRIq6gvkS,RXDvfPUBYFlVdlueBFbLW0mhhAyGEqpt,58,114,45,72,34,1,8,0,274,39.142857142857146,3,0.0,26,45,70,34,88,1,2,8,0,175,99,1
7676,136707,UbbAGEN2mQZMJ0AqNca8pK3Yb0j4mf0a,5X6FeZozNMgE2VRi3MJYjkkFK8SETtu2,1,0,0,0,0,0,2,0,2,0.2857142857142857,1,0.0,0,0,0,0,0,0,0,2,0,0,2,1
7677,136709,gx5zIbRkvVmYAkHaGQMR5zm5BpTwVwIe,A3fsA9Zfv1X2fVEQhTw51lKENdNrEqT3,5,4,0,0,0,0,1,0,5,0.7142857142857143,1,0.0,0,0,0,0,4,0,0,1,0,0,5,0
7678,136712,fnlh0vT4Ypc7FeWWn0jzqbr2uXSv59hi,A3fsA9Zfv1X2fVEQhTw51lKENdNrEqT3,2,0,0,0,0,0,2,0,2,0.2857142857142857,1,0.0,0,0,0,0,0,0,0,2,0,0,2,1
7679,136714,8mWm5xzce8wK28AEpPpWzDCgRcswbNyu,RXDvfPUBYFlVdlueBFbLW0mhhAyGEqpt,12,8,5,0,3,1,5,1,23,3.2857142857142856,1,0.0,2,5,0,3,6,1,0,5,1,10,13,1
7680,136732,SVZqJHiWjzEAtrLc64poVCOKM6DkmsSo,5X6FeZozNMgE2VRi3MJYjkkFK8SETtu2,4,2,0,0,0,0,2,0,4,0.5714285714285714,2,0.0,0,0,0,0,2,0,0,2,0,0,4,1
7681,136738,SsiBwdLtgBlftQTMaumuPfeXEp9eUN1X,A3fsA9Zfv1X2fVEQhTw51lKENdNrEqT3,11,7,5,0,2,0,5,0,19,2.7142857142857144,1,0.0,0,5,0,2,7,0,0,5,0,7,12,1
7682,136749,bmxQ66AsItv9EBQTswW4vQGNA82BElw3,SpATywNh6bZuzm8s1ceuBUnMUAeoAHHw,7,11,5,0,2,0,2,0,20,2.857142857142857,1,0.0,0,5,0,2,11,0,0,2,0,7,13,1
7683,136761,WrTcJrUgklWyxOaBnf20Rowk6qaKbzit,SpATywNh6bZuzm8s1ceuBUnMUAeoAHHw,8,3,2,0,2,0,4,0,11,1.5714285714285714,1,0.0,0,2,0,2,3,0,0,4,0,4,7,1
7684,136784,3gjsZAnS1zBXs93F1SFYpXewdnodPnot,SpATywNh6bZuzm8s1ceuBUnMUAeoAHHw,11,14,7,0,5,4,11,1,42,6.0,2,0.0,0,7,0,5,14,4,0,11,1,12,30,1
7685,136789,78OI7ZWst9j81Ckpf0W24CIpBfLrKIYQ,SpATywNh6bZuzm8s1ceuBUnMUAeoAHHw,1,0,0,0,0,0,1,0,1,0.14285714285714285,1,0.0,0,0,0,0,0,0,0,1,0,0,1,1
7686,136800,8rUphvLiXZqbGu38CKKOCcJ5A3GrLiLP,SpATywNh6bZuzm8s1ceuBUnMUAeoAHHw,4,4,0,0,0,0,2,0,6,0.8571428571428571,1,0.0,1,0,0,0,3,0,0,2,0,1,5,0
7687,136805,WrTcJrUgklWyxOaBnf20Rowk6qaKbzit,RXDvfPUBYFlVdlueBFbLW0mhhAyGEqpt,1,0,0,0,0,0,1,0,1,0.14285714285714285,1,0.0,0,0,0,0,0,0,0,1,0,0,1,1
7688,136808,yBHGUjuGWSAO5vgDHwIPJCcfy3rr5zp9,bWdj2GDclj5ofokWjzoa5jAwMkxCykd6,1,0,0,0,0,0,1,0,1,0.14285714285714285,1,0.0,0,0,0,0,0,0,0,1,0,0,1,0
7689,136823,LKQx76DscP8cMaadDZLCOsushv3ygeRX,A3fsA9Zfv1X2fVEQhTw51lKENdNrEqT3,1,0,0,0,0,0,1,0,1,0.14285714285714285,1,0.0,0,0,0,0,0,0,0,1,0,0,1,0
7690,136845,OmBhuxpgNHza1UgJ4sJoDmhlFXyn8dEO,SpATywNh6bZuzm8s1ceuBUnMUAeoAHHw,15,28,1,15,2,0,5,0,51,7.285714285714286,3,0.0,2,1,12,2,26,0,3,5,0,17,34,0
7691,136893,Oq4muIuPqX11q3v3A24DkHmXbw9NrZW6,SpATywNh6bZuzm8s1ceuBUnMUAeoAHHw,5,3,0,0,0,0,2,0,5,0.7142857142857143,1,0.0,0,0,0,0,3,0,0,2,0,0,5,1
7692,136895,a9TBP79htFPYcv3LD77KH0Nt4oybRXBR,bWdj2GDclj5ofokWjzoa5jAwMkxCykd6,5,4,3,0,0,0,3,2,12,1.7142857142857142,1,0.0,0,3,0,0,4,0,0,3,2,3,9,1
7693,136896,0CZrf1rdgKFCFIVyDqGwyjQ94p1TBewg,SpATywNh6bZuzm8s1ceuBUnMUAeoAHHw,14,15,0,18,0,18,15,1,67,9.571428571428571,3,0.0,4,0,16,0,11,18,2,15,1,20,47,1
7694,136899,24JoyBPXMOnmsLOfMafb36RTU9UCRDoT,SpATywNh6bZuzm8s1ceuBUnMUAeoAHHw,1,0,0,0,0,0,1,0,1,0.14285714285714285,1,0.0,0,0,0,0,0,0,0,1,0,0,1,1
7695,136903,a9TBP79htFPYcv3LD77KH0Nt4oybRXBR,SpATywNh6bZuzm8s1ceuBUnMUAeoAHHw,7,6,5,0,0,0,2,0,13,1.8571428571428572,1,0.0,0,5,0,0,6,0,0,2,0,5,8,1
7696,136925,nWxqZ9qOnSiwmKKTQWD8DHRfGKfO0Peo,SpATywNh6bZuzm8s1ceuBUnMUAeoAHHw,18,18,15,0,7,0,6,0,46,6.571428571428571,2,0.0,0,15,0,7,18,0,0,6,0,22,24,1
7697,136938,efygWYkxxUMOGInRZT4qEeuzMRlIpQq6,G8EPVSXsOYB5YQWZGiz1aVq5Pgr2GrQu,1,0,0,0,0,0,1,0,1,0.14285714285714285,1,0.0,0,0,0,0,0,0,0,1,0,0,1,1
7698,136943,r7oxHVTNN8doW10wgne7GkgxiedysXDT,A3fsA9Zfv1X2fVEQhTw51lKENdNrEqT3,9,7,3,0,2,0,5,0,17,2.4285714285714284,3,0.0,0,3,0,2,7,0,0,5,0,5,12,1
7699,136949,BJcIgaOnWdAOKf7jzUg9DKOlERmjwn2s,SpATywNh6bZuzm8s1ceuBUnMUAeoAHHw,1,0,0,0,0,0,1,0,1,0.14285714285714285,1,0.0,0,0,0,0,0,0,0,1,0,0,1,1
7700,136955,tBidKjiqQ5KFuEaFTLCdOSCSZAqiqEig,RXDvfPUBYFlVdlueBFbLW0mhhAyGEqpt,7,2,2,0,1,0,7,0,12,1.7142857142857142,1,0.0,0,2,0,1,2,0,0,7,0,3,9,1
7701,136961,Cx9UgN9CA3ZQNCspfULD8FGJJpSFtxJF,bWdj2GDclj5ofokWjzoa5jAwMkxCykd6,54,53,34,64,14,0,24,0,189,27.0,6,0.0,6,34,60,14,47,0,4,24,0,114,75,0
7702,136963,BJcIgaOnWdAOKf7jzUg9DKOlERmjwn2s,bWdj2GDclj5ofokWjzoa5jAwMkxCykd6,1,0,0,0,0,0,1,0,1,0.14285714285714285,1,0.0,0,0,0,0,0,0,0,1,0,0,1,1
7703,136966,BJcIgaOnWdAOKf7jzUg9DKOlERmjwn2s,G8EPVSXsOYB5YQWZGiz1aVq5Pgr2GrQu,1,0,0,0,0,0,1,0,1,0.14285714285714285,1,0.0,0,0,0,0,0,0,0,1,0,0,1,1
7704,136967,BJcIgaOnWdAOKf7jzUg9DKOlERmjwn2s,RXDvfPUBYFlVdlueBFbLW0mhhAyGEqpt,1,0,0,0,0,0,1,0,1,0.14285714285714285,1,0.0,0,0,0,0,0,0,0,1,0,0,1,1
7705,136970,BJcIgaOnWdAOKf7jzUg9DKOlERmjwn2s,A3fsA9Zfv1X2fVEQhTw51lKENdNrEqT3,1,0,0,0,0,0,1,0,1,0.14285714285714285,1,0.0,0,0,0,0,0,0,0,1,0,0,1,1
7706,136981,AJ67zJxwtIT663v0SjoBzB1oAmD7q2P6,SpATywNh6bZuzm8s1ceuBUnMUAeoAHHw,4,2,0,0,0,0,3,0,5,0.7142857142857143,1,0.0,0,0,0,0,2,0,0,3,0,0,5,1
7707,136988,9580xqem5skLGzPdMFTPdLPT5HlErJVM,bWdj2GDclj5ofokWjzoa5jAwMkxCykd6,3,0,0,0,0,6,3,0,9,1.2857142857142858,2,0.0,0,0,0,0,0,6,0,3,0,0,9,1
7708,136997,azSMvYaBlxi8sVQgX0j44wgyxslA1ZOv,bWdj2GDclj5ofokWjzoa5jAwMkxCykd6,33,19,8,48,8,44,2,0,129,18.428571428571427,1,0.0,10,8,37,8,9,44,11,2,0,63,66,0
7709,137001,wy2vY5aiYwg0C5zglGAXrG2vaWLSbGC9,A3fsA9Zfv1X2fVEQhTw51lKENdNrEqT3,7,5,1,0,1,0,1,0,8,1.1428571428571428,1,0.0,0,1,0,1,5,0,0,1,0,2,6,1
7710,137007,1vvo0r6a7F7cnmAi2geIjNYeLW8STOBo,bWdj2GDclj5ofokWjzoa5jAwMkxCykd6,24,14,6,41,1,52,9,0,123,17.571428571428573,3,0.0,3,6,38,1,11,52,3,9,0,48,75,0
7711,137015,C7bvV9WgtivYIxdtA0RvlWoiA6KPa8KB,A3fsA9Zfv1X2fVEQhTw51lKENdNrEqT3,7,5,1,0,1,0,1,0,8,1.1428571428571428,1,0.0,0,1,0,1,5,0,0,1,0,2,6,1
7712,137027,qggUO4B0NhIPqMhJwgIAZM8ZaIbpr9nE,A3fsA9Zfv1X2fVEQhTw51lKENdNrEqT3,24,14,11,0,8,0,6,0,39,5.571428571428571,2,0.0,0,11,0,8,14,0,0,6,0,19,20,0
7713,137039,oUtJwYt8sa3kOoE5VCZnryoMeLtLEWT7,SpATywNh6bZuzm8s1ceuBUnMUAeoAHHw,1,0,0,0,0,0,1,0,1,0.14285714285714285,1,0.0,0,0,0,0,0,0,0,1,0,0,1,1
7714,137066,ysgn6TuMNCSCCc3YWRE4ykee40CF0ytw,SpATywNh6bZuzm8s1ceuBUnMUAeoAHHw,15,36,14,32,3,0,7,0,92,13.142857142857142,1,0.0,16,14,23,3,20,0,9,7,0,56,36,0
7715,137075,D5GqwXfacfySSvxPJ9v7ORjiX9Oa23f1,A3fsA9Zfv1X2fVEQhTw51lKENdNrEqT3,10,6,4,0,2,1,7,1,21,3.0,1,0.0,0,4,0,2,6,1,0,7,1,6,15,1
7716,137079,2zPhdAsLsu77lfpQJMqGvZTeUBoWRvYj,A3fsA9Zfv1X2fVEQhTw51lKENdNrEqT3,4,2,1,0,1,0,1,0,5,0.7142857142857143,1,0.0,0,1,0,1,2,0,0,1,0,2,3,1
7717,137088,XEF36i36eMRNZiPBT0BZnH2MwEKG9uoI,5X6FeZozNMgE2VRi3MJYjkkFK8SETtu2,5,2,1,0,1,0,2,0,6,0.8571428571428571,1,0.0,0,1,0,1,2,0,0,2,0,2,4,1
7718,137097,K8iyo1zjmUVYyneIljrW5LXHYSVc2KTu,bWdj2GDclj5ofokWjzoa5jAwMkxCykd6,5,2,1,0,1,0,2,0,6,0.8571428571428571,1,0.0,0,1,0,1,2,0,0,2,0,2,4,1
7719,137106,ysgn6TuMNCSCCc3YWRE4ykee40CF0ytw,G8EPVSXsOYB5YQWZGiz1aVq5Pgr2GrQu,6,5,3,0,2,0,4,0,14,2.0,1,0.0,0,3,0,2,5,0,0,4,0,5,9,1
7720,137109,hTUTGix3tq45IjQs1VC6q6z8vUJkTGrj,SpATywNh6bZuzm8s1ceuBUnMUAeoAHHw,7,1,1,0,1,0,7,1,11,1.5714285714285714,1,0.0,0,1,0,1,1,0,0,7,1,2,9,1
7721,137117,TXBaUi0GpvXZWCDXsKlkFWTtfaT87UMz,A3fsA9Zfv1X2fVEQhTw51lKENdNrEqT3,1,0,0,0,0,0,1,0,1,0.14285714285714285,1,0.0,0,0,0,0,0,0,0,1,0,0,1,1
7722,137125,qrcZVupskPQ3r4i17tFBTVUKSJOS0tny,G8EPVSXsOYB5YQWZGiz1aVq5Pgr2GrQu,33,51,30,14,12,0,10,0,117,16.714285714285715,2,0.0,16,30,13,12,35,0,1,10,0,71,46,1
7723,137126,7R7i7Tl6hQVhHuW9EDKI5hP3KMblyMnQ,bWdj2GDclj5ofokWjzoa5jAwMkxCykd6,14,34,19,0,7,0,8,0,68,9.714285714285714,2,0.0,2,19,0,7,32,0,0,8,0,28,40,0
7724,137138,vJqquhDApWmZKT0O91wuZoyK7VHuuogv,G8EPVSXsOYB5YQWZGiz1aVq5Pgr2GrQu,3,2,1,0,0,0,1,0,4,0.5714285714285714,1,0.0,0,1,0,0,2,0,0,1,0,1,3,1
7725,137143,pvc8Q0fgukpLHQtQV7WyWJtaaZKe5il3,A3fsA9Zfv1X2fVEQhTw51lKENdNrEqT3,14,5,4,16,3,0,2,0,30,4.285714285714286,1,0.0,0,4,14,3,5,0,2,2,0,21,9,1
7726,137147,7Mw4vaDC7DEeScsxjISACITxqLi97SBZ,SpATywNh6bZuzm8s1ceuBUnMUAeoAHHw,4,2,1,0,0,0,4,0,7,1.0,2,0.0,0,1,0,0,2,0,0,4,0,1,6,1
7727,137152,042EgGVh69v5hFZCwLUBrVmkW58yUGoj,A3fsA9Zfv1X2fVEQhTw51lKENdNrEqT3,2,0,0,0,0,0,2,0,2,0.2857142857142857,1,0.0,0,0,0,0,0,0,0,2,0,0,2,1
7728,137160,Vbb39EBG6fQbcqfccG5sxgb8bg7sFwhQ,SpATywNh6bZuzm8s1ceuBUnMUAeoAHHw,44,62,25,52,16,18,14,3,190,27.142857142857142,4,0.0,29,25,43,16,33,18,9,14,3,113,77,0
7729,137187,Jh63Yx7P2KG3mJaB2UxXBx2DtcJ6DTS6,SpATywNh6bZuzm8s1ceuBUnMUAeoAHHw,9,14,2,1,1,0,3,0,21,3.0,1,0.0,3,2,1,1,11,0,0,3,0,7,14,1
7730,137193,PmtrviA6hBub1PH85YXqVyZgghNsuc4g,RXDvfPUBYFlVdlueBFbLW0mhhAyGEqpt,3,2,0,0,0,0,1,0,3,0.42857142857142855,1,0.0,0,0,0,0,2,0,0,1,0,0,3,0
7731,137194,9yxOirOWFARsrkPVEfTkEk3tj0G1eEr7,SpATywNh6bZuzm8s1ceuBUnMUAeoAHHw,33,53,4,42,1,7,14,1,122,17.428571428571427,5,0.0,10,4,37,1,43,7,5,14,1,52,70,0
7732,137201,xHyTBb0oAY3Apc4pTvqPrWVv46063zDF,bWdj2GDclj5ofokWjzoa5jAwMkxCykd6,7,2,1,0,1,7,5,1,17,2.4285714285714284,1,0.0,0,1,0,1,2,7,0,5,1,2,15,1
7733,137211,EWCtjEAyugZmgyZfRj1CnWJoYkKUEbbn,5X6FeZozNMgE2VRi3MJYjkkFK8SETtu2,3,2,0,0,0,0,1,0,3,0.42857142857142855,1,0.0,0,0,0,0,2,0,0,1,0,0,3,1
7734,137212,vbMN1rzhGdmFkomRrJirrfajP9CU9h8U,5X6FeZozNMgE2VRi3MJYjkkFK8SETtu2,1,0,0,0,0,0,1,0,1,0.14285714285714285,1,0.0,0,0,0,0,0,0,0,1,0,0,1,1
7735,137236,8IqLsxST5k0rUat32tSUg01EGRNfd0qi,SpATywNh6bZuzm8s1ceuBUnMUAeoAHHw,6,9,3,0,3,2,3,0,20,2.857142857142857,1,0.0,0,3,0,3,9,2,0,3,0,6,14,1
7736,137239,cSIzFDJuNIbXURUzpnDwj3nKpvAD5jUb,bWdj2GDclj5ofokWjzoa5jAwMkxCykd6,1,0,0,0,0,0,1,0,1,0.14285714285714285,1,0.0,0,0,0,0,0,0,0,1,0,0,1,1
7737,137243,OLEqwRXafj333FNrgBNSnfXgRYdpAvmq,SpATywNh6bZuzm8s1ceuBUnMUAeoAHHw,6,5,2,0,2,0,2,0,11,1.5714285714285714,2,0.0,0,2,0,2,5,0,0,2,0,4,7,0
7738,137244,v8s2hAX8tQgFD6i9MrUt2cuWPYPq3DuN,7GRhBDsirIGkRZBtSMEzNTyDr2JQm4xx,4,3,2,0,0,0,1,0,6,0.8571428571428571,1,0.0,0,2,0,0,3,0,0,1,0,2,4,0
7739,137256,3tUwJI9fq5MBYvk22zmtcZQjmB4I2cFy,SpATywNh6bZuzm8s1ceuBUnMUAeoAHHw,2,0,0,0,0,0,2,0,2,0.2857142857142857,1,0.0,0,0,0,0,0,0,0,2,0,0,2,1
7740,137259,jx3H6f2miwKbLN02Gt82PEqx2tCxuPiz,SpATywNh6bZuzm8s1ceuBUnMUAeoAHHw,12,13,0,15,0,0,5,0,33,4.714285714285714,1,0.0,5,0,15,0,8,0,0,5,0,20,13,0
7741,137277,bAAKqYTvNa29c4TuCorKR61JLnTy6u4P,SpATywNh6bZuzm8s1ceuBUnMUAeoAHHw,17,18,0,0,0,4,4,0,26,3.7142857142857144,2,0.0,0,0,0,0,18,4,0,4,0,0,26,1
7742,137278,mX1EPUwBuVJskkKXxy0ZHAUgsFReCgzo,bWdj2GDclj5ofokWjzoa5jAwMkxCykd6,3,0,0,0,0,4,2,0,6,0.8571428571428571,1,0.0,0,0,0,0,0,4,0,2,0,0,6,1
7743,137294,2AVqf09WA2itMEZz0u7FX3Fi3x3FZzPg,fbPkOYLVPtPgIt0MxizjfFJov3JbHyAi,16,23,16,0,11,0,1,0,51,7.285714285714286,1,0.0,6,16,0,11,17,0,0,1,0,33,18,1
7744,137356,ADL0cXowUMs4wyiAOHKMOrtTHu5tmUqi,fbPkOYLVPtPgIt0MxizjfFJov3JbHyAi,5,4,3,0,1,0,2,0,10,1.4285714285714286,1,0.0,0,3,0,1,4,0,0,2,0,4,6,1
7745,137416,A41hdT15T7mumzDW53QCDXRUsOilvTI0,fbPkOYLVPtPgIt0MxizjfFJov3JbHyAi,5,3,2,0,1,0,1,0,7,1.0,1,0.0,0,2,0,1,3,0,0,1,0,3,4,0
7746,137447,ucnh7Je2Ujv5K3Q3wjC5gWq40jwh8dv6,fbPkOYLVPtPgIt0MxizjfFJov3JbHyAi,6,2,1,0,0,0,4,1,8,1.1428571428571428,1,0.0,0,1,0,0,2,0,0,4,1,1,7,1
7747,137501,23qYgK59sBhKVlqVOyc6Eo1KSrAZuYOK,5Gyp41oLVo7Gg7vF4vpmggWP5MU70QO6,22,63,37,8,12,41,15,5,181,25.857142857142858,6,0.0,5,37,7,12,58,41,1,15,5,61,120,0
7748,137516,VbFV7aXWy1Ed7AF5LEbPtndF4SopBroV,5Gyp41oLVo7Gg7vF4vpmggWP5MU70QO6,7,3,2,0,2,1,2,0,10,1.4285714285714286,1,0.0,0,2,0,2,3,1,0,2,0,4,6,1
7749,137517,WSCktYZqeZlAr4CBsNsYbm97xd94qsUC,5Gyp41oLVo7Gg7vF4vpmggWP5MU70QO6,12,7,4,6,4,0,2,0,23,3.2857142857142856,2,0.0,2,4,3,4,5,0,3,2,0,13,10,1
7750,137535,Rzov4Yy9du1MxHJWr8ZSxSme8NlDvLvV,5Gyp41oLVo7Gg7vF4vpmggWP5MU70QO6,12,8,5,0,5,0,5,0,23,3.2857142857142856,2,0.0,1,5,0,5,7,0,0,5,0,11,12,0
7751,137552,DgxlqcsVCQDYe21h4YRsQPN4DqjKpjtX,5Gyp41oLVo7Gg7vF4vpmggWP5MU70QO6,6,1,1,0,1,0,3,0,6,0.8571428571428571,1,0.0,0,1,0,1,1,0,0,3,0,2,4,1
7752,137553,JYjqQWzRkQGlz0fASDON6Nnhdq6VSXiT,5Gyp41oLVo7Gg7vF4vpmggWP5MU70QO6,7,3,2,0,2,0,2,0,9,1.2857142857142858,1,0.0,0,2,0,2,3,0,0,2,0,4,5,1
7753,137574,58eQNUjs318sjON50Y8nkDIw70NM1q5r,5Gyp41oLVo7Gg7vF4vpmggWP5MU70QO6,5,2,0,0,0,0,3,0,5,0.7142857142857143,1,0.0,0,0,0,0,2,0,0,3,0,0,5,1
7754,137627,RVf6e28k6GsRGb8DN1lRFhzAihWj6uwr,5Gyp41oLVo7Gg7vF4vpmggWP5MU70QO6,10,11,2,0,3,3,8,0,27,3.857142857142857,2,0.0,0,2,0,3,11,3,0,8,0,5,22,1
7755,137673,m7jVXavImQfCN3lFSWDciGDkPXsfDWjY,5Gyp41oLVo7Gg7vF4vpmggWP5MU70QO6,7,5,2,0,2,0,3,0,12,1.7142857142857142,1,0.0,0,2,0,2,5,0,0,3,0,4,8,1
7756,137690,zfdDmTfjfw6TH19X3JvrWruhv3HK3wH5,5Gyp41oLVo7Gg7vF4vpmggWP5MU70QO6,8,11,2,0,2,0,8,0,23,3.2857142857142856,1,0.0,1,2,0,2,10,0,0,8,0,5,18,1
7757,137696,moOuTHX6EPV8dXCWOBnALGJBIKv8mXx0,5Gyp41oLVo7Gg7vF4vpmggWP5MU70QO6,12,11,6,4,4,0,10,0,35,5.0,2,0.0,1,6,2,4,10,0,2,10,0,13,22,1
7758,137702,WGFi654VXLxPTGBrVG8nl9P18l5AogE9,5Gyp41oLVo7Gg7vF4vpmggWP5MU70QO6,1,0,0,0,0,0,1,0,1,0.14285714285714285,1,0.0,0,0,0,0,0,0,0,1,0,0,1,1
7759,137731,68di0dJM35xmTuimhyTkyzCIZ2XRQ9UC,5Gyp41oLVo7Gg7vF4vpmggWP5MU70QO6,1,0,0,0,0,0,1,0,1,0.14285714285714285,1,0.0,0,0,0,0,0,0,0,1,0,0,1,1
7760,137734,UwNh19bGTGX7YEBtcKZFqxDpmh2gUs3A,5Gyp41oLVo7Gg7vF4vpmggWP5MU70QO6,1,0,0,0,0,0,1,0,1,0.14285714285714285,1,0.0,0,0,0,0,0,0,0,1,0,0,1,1
7761,137745,pzWsPfYmJYrT9X6UPf6wVCREiyQ24iPl,5Gyp41oLVo7Gg7vF4vpmggWP5MU70QO6,43,99,42,70,31,30,25,3,300,42.857142857142854,3,0.0,45,42,57,31,54,30,13,25,3,175,125,1
7762,137763,RPs2tKrisA27ObcW2SBs1xNMfhflcdme,5Gyp41oLVo7Gg7vF4vpmggWP5MU70QO6,31,60,36,48,15,24,13,0,196,28.0,7,0.0,15,36,35,15,45,24,13,13,0,101,95,1
7763,137766,x7J1Kb3wAgruXqW9nGWP0GwZa9eKiuoO,5Gyp41oLVo7Gg7vF4vpmggWP5MU70QO6,1,0,0,0,0,0,1,0,1,0.14285714285714285,1,0.0,0,0,0,0,0,0,0,1,0,0,1,1
7764,137783,CJctzi3vaTvn6AdxsKxfRIS0CweUmN8j,5Gyp41oLVo7Gg7vF4vpmggWP5MU70QO6,24,42,18,7,9,1,7,0,84,12.0,4,0.0,16,18,6,9,26,1,1,7,0,49,35,1
7765,137799,xbfHRTwQRbinLUstZARwQhQi9ympHy3t,5Gyp41oLVo7Gg7vF4vpmggWP5MU70QO6,16,30,22,5,4,3,11,0,75,10.714285714285714,7,0.0,0,22,5,4,30,3,0,11,0,31,44,1
7766,137843,8nT76hrzyl8ZAUdI7W6kfrIzHxI3puKM,5Gyp41oLVo7Gg7vF4vpmggWP5MU70QO6,6,1,0,0,0,0,8,2,11,1.5714285714285714,3,0.0,0,0,0,0,1,0,0,8,2,0,11,0
7767,137864,Lcc8QujJbkTuweBtBrKCB15IfiVLUIVq,5Gyp41oLVo7Gg7vF4vpmggWP5MU70QO6,34,64,40,11,21,15,22,1,174,24.857142857142858,5,0.0,7,40,7,21,57,15,4,22,1,75,99,1
7768,137902,g5cfvDvYqz1BC4LMGanzPaVPPBmwbapa,5Gyp41oLVo7Gg7vF4vpmggWP5MU70QO6,1,0,0,0,0,0,2,0,2,0.2857142857142857,2,0.0,0,0,0,0,0,0,0,2,0,0,2,1
7769,137904,TcuUuOMUA0rnssmvuX7CLScapgs7yDzA,5Gyp41oLVo7Gg7vF4vpmggWP5MU70QO6,2,3,1,0,0,0,0,0,4,0.5714285714285714,1,0.0,1,1,0,0,2,0,0,0,0,2,2,1
7770,137914,MuLsknYI07nq0YCcw2chy4suLHjpTMcP,5Gyp41oLVo7Gg7vF4vpmggWP5MU70QO6,1,0,0,0,0,0,2,0,2,0.2857142857142857,1,0.0,0,0,0,0,0,0,0,2,0,0,2,1
7771,137915,BeyfLbwb8pdDQU6WTI5ee3FkxRPRP7B2,5Gyp41oLVo7Gg7vF4vpmggWP5MU70QO6,7,9,4,0,2,0,2,0,17,2.4285714285714284,3,0.0,0,4,0,2,9,0,0,2,0,6,11,1
7772,137928,76Vc8xBrjpIAsCVLOBGpcAye16ciDBR2,5Gyp41oLVo7Gg7vF4vpmggWP5MU70QO6,14,16,12,4,11,0,4,0,47,6.714285714285714,1,0.0,2,12,2,11,14,0,2,4,0,27,20,1
7773,137930,fRdFgfpO9luII5SSFsjpQjNEcDlIPFJO,5Gyp41oLVo7Gg7vF4vpmggWP5MU70QO6,8,5,3,0,2,0,3,0,13,1.8571428571428572,2,0.0,0,3,0,2,5,0,0,3,0,5,8,1
7774,137963,wIfFdxlznXLGjd43eEdFblftB68OmNYA,3VkHkmOtom3jM2wCu94xgzzu1d6Dn7or,23,32,25,0,12,0,16,4,89,12.714285714285714,5,0.0,0,25,0,12,32,0,0,16,4,37,52,0
7775,137978,YnKbQ3SOScGwuCGX3synWY2TyMWLCnkl,3VkHkmOtom3jM2wCu94xgzzu1d6Dn7or,1,0,0,0,0,0,2,0,2,0.2857142857142857,1,0.0,0,0,0,0,0,0,0,2,0,0,2,1
7776,137982,7cyLQzghErKC28Qgc0MBFeY3jCN7OOfs,3VkHkmOtom3jM2wCu94xgzzu1d6Dn7or,1,0,0,0,0,0,1,0,1,0.14285714285714285,1,0.0,0,0,0,0,0,0,0,1,0,0,1,1
7777,137985,NkWR8qAbSP1GErqF95otiqzHZZxmVq5b,3VkHkmOtom3jM2wCu94xgzzu1d6Dn7or,4,2,0,0,0,2,4,0,8,1.1428571428571428,2,0.0,0,0,0,0,2,2,0,4,0,0,8,1
7778,137998,RCdcltNaQLfcoxT7YKTjQxAYUbCmzzKd,3VkHkmOtom3jM2wCu94xgzzu1d6Dn7or,4,2,1,0,1,0,1,0,5,0.7142857142857143,1,0.0,0,1,0,1,2,0,0,1,0,2,3,1
7779,138013,kEcxWGzawejnXckUe9770Kmia80cJVRb,3VkHkmOtom3jM2wCu94xgzzu1d6Dn7or,22,30,27,0,0,3,5,0,65,9.285714285714286,3,0.0,0,27,0,0,30,3,0,5,0,27,38,1
7780,138016,rkeWD62NaMO23zx3rvtVWVhQONUAEfmd,3VkHkmOtom3jM2wCu94xgzzu1d6Dn7or,5,2,1,0,1,0,3,0,7,1.0,1,0.0,0,1,0,1,2,0,0,3,0,2,5,0
7781,138034,6twJb7OM0lVxnHtdQbt8d0K7pBf1n6K0,3VkHkmOtom3jM2wCu94xgzzu1d6Dn7or,8,10,3,3,5,3,2,0,26,3.7142857142857144,1,0.0,6,3,3,5,4,3,0,2,0,17,9,1
7782,138037,pYkHP5x7PpicYIBiYksxqTU4ENpqxiV1,3VkHkmOtom3jM2wCu94xgzzu1d6Dn7or,4,1,0,0,0,0,6,0,7,1.0,1,0.0,0,0,0,0,1,0,0,6,0,0,7,1
7783,138074,avoglTQYC4DCKpMnGcRw7Ok57lEHfs0W,3VkHkmOtom3jM2wCu94xgzzu1d6Dn7or,1,0,0,0,0,0,1,0,1,0.14285714285714285,1,0.0,0,0,0,0,0,0,0,1,0,0,1,0
7784,138099,iQQAx7M2oD5FMqM5kA5zi1nJ6LBPePEx,3VkHkmOtom3jM2wCu94xgzzu1d6Dn7or,1,0,0,0,0,0,1,0,1,0.14285714285714285,1,0.0,0,0,0,0,0,0,0,1,0,0,1,1
7785,138107,3oa1UsUctLMAomvPDApNdL7P3WUJSL0E,3VkHkmOtom3jM2wCu94xgzzu1d6Dn7or,4,3,0,0,0,0,2,0,5,0.7142857142857143,2,0.0,0,0,0,0,3,0,0,2,0,0,5,0
7786,138113,AWCCZmfvTZNSvcBxmsMY0cPZtpbqQAwA,3VkHkmOtom3jM2wCu94xgzzu1d6Dn7or,29,27,17,0,15,0,3,0,62,8.857142857142858,2,0.0,0,17,0,15,27,0,0,3,0,32,30,0
7787,138117,aUexCGYt3oLeKKwXVGR6OlbnwLZ0wFk7,3VkHkmOtom3jM2wCu94xgzzu1d6Dn7or,4,2,1,0,0,0,2,0,5,0.7142857142857143,1,0.0,0,1,0,0,2,0,0,2,0,1,4,1
7788,138134,4qjH6bYJrz1dToj1ZCKGSJUSJ41mF132,3VkHkmOtom3jM2wCu94xgzzu1d6Dn7or,7,5,2,0,2,0,5,0,14,2.0,1,0.0,2,2,0,2,3,0,0,5,0,6,8,1
7789,138150,PiI0KgV0HpzloKv45OCqpvuWRWy6We0f,3VkHkmOtom3jM2wCu94xgzzu1d6Dn7or,1,0,0,0,0,0,1,0,1,0.14285714285714285,1,0.0,0,0,0,0,0,0,0,1,0,0,1,1
7790,138154,yB6WBMTLFGGr2WaSrIYLPpH4djA6zlv6,3VkHkmOtom3jM2wCu94xgzzu1d6Dn7or,1,0,0,0,0,0,1,0,1,0.14285714285714285,1,0.0,0,0,0,0,0,0,0,1,0,0,1,1
7791,138168,K22VFryh5Od9V1LL0eOyTaqPsCNGJ8v3,3VkHkmOtom3jM2wCu94xgzzu1d6Dn7or,1,0,0,0,0,0,1,0,1,0.14285714285714285,1,0.0,0,0,0,0,0,0,0,1,0,0,1,1
7792,138172,jb9pTa916Vn2VeH0D7ExYaf2JyoI9zrO,7GRhBDsirIGkRZBtSMEzNTyDr2JQm4xx,68,211,8,113,11,26,13,0,382,54.57142857142857,4,0.0,118,8,77,11,93,26,36,13,0,214,168,0
7793,138175,mLD9g4ezOv6SvPMWLaj047DaKrptKosJ,7GRhBDsirIGkRZBtSMEzNTyDr2JQm4xx,46,50,20,34,21,4,2,0,131,18.714285714285715,2,0.0,28,20,18,21,22,4,16,2,0,87,44,1
7794,138179,35TfeVSp4flNgxPYk58l34g9vBVr1z8h,7GRhBDsirIGkRZBtSMEzNTyDr2JQm4xx,31,40,1,25,3,0,9,0,78,11.142857142857142,2,0.0,21,1,13,3,19,0,12,9,0,38,40,1
7795,138181,Ya9ImAuYg40ZVitFPXjW5w7btwU9PgQC,7GRhBDsirIGkRZBtSMEzNTyDr2JQm4xx,1,0,0,0,0,0,2,0,2,0.2857142857142857,1,0.0,0,0,0,0,0,0,0,2,0,0,2,1
7796,138182,Q459I6WtHQ4LYscZN5C0n5NrNaEwzARk,7GRhBDsirIGkRZBtSMEzNTyDr2JQm4xx,1,0,0,0,0,0,1,0,1,0.14285714285714285,1,0.0,0,0,0,0,0,0,0,1,0,0,1,1
7797,138199,x29OOChdmJGXK62DnUpwKbwJurqULmnD,7GRhBDsirIGkRZBtSMEzNTyDr2JQm4xx,9,7,5,0,3,0,4,0,19,2.7142857142857144,2,0.0,0,5,0,3,7,0,0,4,0,8,11,0
7798,138201,irIVLRvkXyea4TMdg5wZQ17APoQLOStn,7GRhBDsirIGkRZBtSMEzNTyDr2JQm4xx,5,4,1,0,0,0,3,1,9,1.2857142857142858,1,0.0,0,1,0,0,4,0,0,3,1,1,8,1
7799,138211,6CZNpLhEjhPt0wvOAMcoN0nqY9s1WSWS,7GRhBDsirIGkRZBtSMEzNTyDr2JQm4xx,2,0,0,0,0,0,2,0,2,0.2857142857142857,1,0.0,0,0,0,0,0,0,0,2,0,0,2,0
7800,138213,7kqwVTi8J1vkksyD7DuULlscPDGZl1gf,7GRhBDsirIGkRZBtSMEzNTyDr2JQm4xx,1,0,0,0,0,0,1,0,1,0.14285714285714285,1,0.0,0,0,0,0,0,0,0,1,0,0,1,1
7801,138215,RgBHZtppWNmiRr4zn4KqEhMkv6vEscGZ,7GRhBDsirIGkRZBtSMEzNTyDr2JQm4xx,12,27,15,2,8,4,2,0,58,8.285714285714286,2,0.0,4,15,1,8,23,4,1,2,0,28,30,0
7802,138216,31ylinJXeudea9CV3K99OYNFlev2HboL,7GRhBDsirIGkRZBtSMEzNTyDr2JQm4xx,1,0,0,0,0,0,2,0,2,0.2857142857142857,1,0.0,0,0,0,0,0,0,0,2,0,0,2,1
7803,138217,AufaDc7nEuEUGsIcvsJ4qTP7zAlLmyFt,7GRhBDsirIGkRZBtSMEzNTyDr2JQm4xx,1,0,0,0,0,0,1,0,1,0.14285714285714285,1,0.0,0,0,0,0,0,0,0,1,0,0,1,1
7804,138224,fKMTMHW5HJA5wm0UXPvrkod7JaDoIvWG,7GRhBDsirIGkRZBtSMEzNTyDr2JQm4xx,2,0,0,0,0,0,3,0,3,0.42857142857142855,1,0.0,0,0,0,0,0,0,0,3,0,0,3,0
7805,138228,iIZJjkWNE7IT80tlrFqq6usnQI5kIYfv,7GRhBDsirIGkRZBtSMEzNTyDr2JQm4xx,6,5,0,0,0,0,2,0,7,1.0,1,0.0,0,0,0,0,5,0,0,2,0,0,7,1
7806,138240,JEJrnVrKGVjrX2yiet4Z0AOP8Myw4oGI,SpATywNh6bZuzm8s1ceuBUnMUAeoAHHw,1,0,0,0,0,0,1,0,1,0.14285714285714285,1,0.0,0,0,0,0,0,0,0,1,0,0,1,1
7807,138248,92TVODkqWtTMaGGihgBsUR7wsg2cHNWw,bWdj2GDclj5ofokWjzoa5jAwMkxCykd6,1,0,0,0,0,0,2,0,2,0.2857142857142857,2,0.0,0,0,0,0,0,0,0,2,0,0,2,0
7808,138256,Mm4qww92wRWuqacQYzVAcK0gE3bfzr4C,5X6FeZozNMgE2VRi3MJYjkkFK8SETtu2,9,11,1,0,0,0,10,0,22,3.142857142857143,2,0.0,0,1,0,0,11,0,0,10,0,1,21,1
7809,138264,45E6hpwDMHp9Q3Pt1xT8q04bbowKk87g,7GRhBDsirIGkRZBtSMEzNTyDr2JQm4xx,32,56,17,40,20,1,1,0,135,19.285714285714285,2,0.0,33,17,20,20,23,1,20,1,0,90,45,0
7810,138266,pAkhnLI0s5vboktZycO7Tobv6jbspULh,G8EPVSXsOYB5YQWZGiz1aVq5Pgr2GrQu,9,8,6,0,5,0,1,0,20,2.857142857142857,1,0.0,0,6,0,5,8,0,0,1,0,11,9,0
7811,138275,TltI4tFnIUt2Ilw9fmBmSMvm8ptnCBUB,RXDvfPUBYFlVdlueBFbLW0mhhAyGEqpt,5,2,1,0,1,0,2,0,6,0.8571428571428571,1,0.0,0,1,0,1,2,0,0,2,0,2,4,1
7812,138302,pipMQ1pwWDBMapqBdWoTVq67fUR9oaSj,RXDvfPUBYFlVdlueBFbLW0mhhAyGEqpt,7,4,3,0,1,0,2,0,10,1.4285714285714286,1,0.0,0,3,0,1,4,0,0,2,0,4,6,1
7813,138309,UbhuTMEAqMzZPm1igvnyAuhc02uqoSax,SpATywNh6bZuzm8s1ceuBUnMUAeoAHHw,1,0,0,0,0,0,1,0,1,0.14285714285714285,1,0.0,0,0,0,0,0,0,0,1,0,0,1,1
7814,138313,9w5gHPsgcElW4QuPTdd7Y7NaIc3zL312,5X6FeZozNMgE2VRi3MJYjkkFK8SETtu2,8,5,2,0,2,15,6,1,31,4.428571428571429,4,0.0,0,2,0,2,5,15,0,6,1,4,27,1
7815,138317,r6obx9IpFukvGBmi45WFhJJxXeJI27LQ,bWdj2GDclj5ofokWjzoa5jAwMkxCykd6,2,0,0,0,0,0,3,0,3,0.42857142857142855,1,0.0,0,0,0,0,0,0,0,3,0,0,3,1
7816,138319,yq5rHqpCTagxs6XCaAXxmCSySzn2U3u8,SpATywNh6bZuzm8s1ceuBUnMUAeoAHHw,6,3,2,6,0,0,2,0,13,1.8571428571428572,1,0.0,0,2,5,0,3,0,1,2,0,7,6,1
7817,138321,lVwgv61cg8fkhW9rg5b1PIPnuUWxb0Vk,5X6FeZozNMgE2VRi3MJYjkkFK8SETtu2,1,0,0,0,0,0,1,0,1,0.14285714285714285,1,0.0,0,0,0,0,0,0,0,1,0,0,1,1
7818,138326,t4tnBhQAPqBnCFRCjzr4Y2gSOW7MaWb7,SpATywNh6bZuzm8s1ceuBUnMUAeoAHHw,6,14,7,0,0,7,11,1,40,5.714285714285714,3,0.0,0,7,0,0,14,7,0,11,1,7,33,0
7819,138327,yq5rHqpCTagxs6XCaAXxmCSySzn2U3u8,A3fsA9Zfv1X2fVEQhTw51lKENdNrEqT3,64,9,5,220,0,0,4,0,238,34.0,1,0.0,3,5,192,0,6,0,28,4,0,200,38,1
7820,138330,o3T0K8ec78cQHSHsSLzMA1PbvYi8mwTI,A3fsA9Zfv1X2fVEQhTw51lKENdNrEqT3,64,21,1,188,0,1,5,0,216,30.857142857142858,2,0.0,9,1,167,0,12,1,21,5,0,177,39,1
7821,138335,LEAOHJPHpYdkuGGT4C2KU9sm9M4N9guA,bWdj2GDclj5ofokWjzoa5jAwMkxCykd6,11,17,1,0,1,0,5,0,24,3.4285714285714284,1,0.0,0,1,0,1,17,0,0,5,0,2,22,1
7822,138336,Oi0GqKYhNtMDJ1j5HhgzUgmNLW1tCwni,SpATywNh6bZuzm8s1ceuBUnMUAeoAHHw,29,39,20,3,11,0,4,0,77,11.0,2,0.0,0,20,3,11,39,0,0,4,0,34,43,0
7823,138338,V8TGMBMhFLQdnr9mQNCNr5CucGxVWBvw,RXDvfPUBYFlVdlueBFbLW0mhhAyGEqpt,41,33,28,0,24,5,4,0,94,13.428571428571429,3,0.0,2,28,0,24,31,5,0,4,0,54,40,1
7824,138346,dd7Jtt1fMMutX1RG7iWTpWNKUpGu8Lqf,SpATywNh6bZuzm8s1ceuBUnMUAeoAHHw,25,62,26,26,0,1,4,0,119,17.0,3,0.0,10,26,24,0,52,1,2,4,0,60,59,0
7825,138347,Cw0FoLzIDNyQ045YrBplMRkU4k8BOdoy,SpATywNh6bZuzm8s1ceuBUnMUAeoAHHw,60,54,32,91,18,4,15,0,214,30.571428571428573,2,0.0,16,32,82,18,38,4,9,15,0,148,66,0
7826,138351,drMAzq4nC1GseQmyuPqctPxioPnjLJpD,A3fsA9Zfv1X2fVEQhTw51lKENdNrEqT3,6,9,0,0,0,1,7,1,18,2.5714285714285716,2,0.0,0,0,0,0,9,1,0,7,1,0,18,1
7827,138358,8RGLvfdludl70fdPksu2JYtYCxSVr9FR,SpATywNh6bZuzm8s1ceuBUnMUAeoAHHw,7,9,1,0,1,0,2,0,13,1.8571428571428572,2,0.0,0,1,0,1,9,0,0,2,0,2,11,1
7828,138360,vutd5xOA0I3oZzggjpSPRu322ASlJa8M,5X6FeZozNMgE2VRi3MJYjkkFK8SETtu2,13,28,1,14,7,0,4,0,54,7.714285714285714,2,0.0,17,1,13,7,11,0,1,4,0,38,16,1
7829,138364,PP4UKfn39ZoKLWFw2leT5G41zKS9D3au,SpATywNh6bZuzm8s1ceuBUnMUAeoAHHw,1,0,0,0,0,0,1,0,1,0.14285714285714285,1,0.0,0,0,0,0,0,0,0,1,0,0,1,1
7830,138367,KAW52VBDXCvurEAry0tITiLWjcxVkV8S,SpATywNh6bZuzm8s1ceuBUnMUAeoAHHw,37,33,18,24,11,0,7,0,93,13.285714285714286,3,0.0,4,18,23,11,29,0,1,7,0,56,37,0
7831,138374,KEJJHIMmL4dWZfXMcnnYliutxFAkeezZ,bWdj2GDclj5ofokWjzoa5jAwMkxCykd6,37,18,16,21,14,8,4,0,81,11.571428571428571,2,0.0,1,16,19,14,17,8,2,4,0,50,31,0
7832,138379,NgtHGelgTuQd8iaakUkaIRT8CwQkRy7Z,SpATywNh6bZuzm8s1ceuBUnMUAeoAHHw,34,29,18,20,13,0,2,0,82,11.714285714285714,1,0.0,8,18,20,13,21,0,0,2,0,59,23,1
7833,138391,uBhod65yy67o51lZxzdiIJO4njBJ2VdC,SpATywNh6bZuzm8s1ceuBUnMUAeoAHHw,5,2,1,0,1,0,2,0,6,0.8571428571428571,1,0.0,0,1,0,1,2,0,0,2,0,2,4,0
7834,138393,GuloJL0KPAXccVBFbD64oIsX2EupuwV0,SpATywNh6bZuzm8s1ceuBUnMUAeoAHHw,46,34,26,30,19,0,5,0,114,16.285714285714285,1,0.0,4,26,28,19,30,0,2,5,0,77,37,0
7835,138406,73Lo5aiYTeasg8R5eGVwIsechNk0OHx6,SpATywNh6bZuzm8s1ceuBUnMUAeoAHHw,7,4,3,0,2,0,1,0,10,1.4285714285714286,1,0.0,0,3,0,2,4,0,0,1,0,5,5,1
7836,138409,9BgQxlrJHLSftkwUDKA3hmgF0QPDtIyc,SpATywNh6bZuzm8s1ceuBUnMUAeoAHHw,6,2,0,0,1,0,4,1,8,1.1428571428571428,1,0.0,0,0,0,1,2,0,0,4,1,1,7,1
7837,138420,GGf1UPTxgLShqKb7PDIL9hAwpCBcU4fs,SpATywNh6bZuzm8s1ceuBUnMUAeoAHHw,12,9,7,4,3,0,2,0,25,3.5714285714285716,2,0.0,0,7,4,3,9,0,0,2,0,14,11,1
7838,138429,rXCyIAZUSGx3FRINqiP6ViaZECSgS16z,bWdj2GDclj5ofokWjzoa5jAwMkxCykd6,10,10,0,0,1,0,2,0,13,1.8571428571428572,1,0.0,0,0,0,1,10,0,0,2,0,1,12,1
7839,138431,YTOBF6rM3F1fTkDq9LaNboDjZEu7zsXn,SpATywNh6bZuzm8s1ceuBUnMUAeoAHHw,1,0,0,0,0,0,1,0,1,0.14285714285714285,1,0.0,0,0,0,0,0,0,0,1,0,0,1,1
7840,138446,HbkgIsgEIymNiRyXrJMB9mrDP6ahzsjU,SpATywNh6bZuzm8s1ceuBUnMUAeoAHHw,9,7,2,0,2,0,5,0,16,2.2857142857142856,1,0.0,0,2,0,2,7,0,0,5,0,4,12,0
7841,138463,byZchbfFcja3MPJAUOAqCEjjJyYmAgdz,SpATywNh6bZuzm8s1ceuBUnMUAeoAHHw,41,38,20,21,11,0,4,0,94,13.428571428571429,3,0.0,15,20,19,11,23,0,2,4,0,65,29,0
7842,138464,hFSLp8dP9IaOj1hzVZj5ZXOHY6VYm2m9,bWdj2GDclj5ofokWjzoa5jAwMkxCykd6,2,0,0,0,0,0,2,0,2,0.2857142857142857,1,0.0,0,0,0,0,0,0,0,2,0,0,2,1
7843,138470,F0GZauOZl5SQ5SSX2PLewCWNOAV63pop,RXDvfPUBYFlVdlueBFbLW0mhhAyGEqpt,13,11,4,6,3,1,3,0,28,4.0,2,0.0,2,4,6,3,9,1,0,3,0,15,13,1
7844,138474,LN6esXV3qnIoLg44h6fXbTBvNC9pi5Ym,A3fsA9Zfv1X2fVEQhTw51lKENdNrEqT3,2,0,0,0,0,0,4,0,4,0.5714285714285714,1,0.0,0,0,0,0,0,0,0,4,0,0,4,1
7845,138484,YbQfcgwKrjskWW3wyOzQUUJYzdeHmY82,bWdj2GDclj5ofokWjzoa5jAwMkxCykd6,32,27,22,0,17,0,4,0,70,10.0,1,0.0,2,22,0,17,25,0,0,4,0,41,29,0
7846,138493,mmwy46SxulcFPXdkpDL2rsDLyABm0kYD,G8EPVSXsOYB5YQWZGiz1aVq5Pgr2GrQu,1,0,0,0,0,0,1,0,1,0.14285714285714285,1,0.0,0,0,0,0,0,0,0,1,0,0,1,1
7847,138494,9W7krcQjxHzGneO4ukXmCK8o9LZUjHFG,SpATywNh6bZuzm8s1ceuBUnMUAeoAHHw,1,0,0,0,0,0,1,0,1,0.14285714285714285,1,0.0,0,0,0,0,0,0,0,1,0,0,1,0
7848,138495,phUbJgbIGGa7ctfmqKFL5A4ez8Y8gbBs,SpATywNh6bZuzm8s1ceuBUnMUAeoAHHw,36,32,24,6,17,0,10,0,89,12.714285714285714,4,0.0,0,24,5,17,32,0,1,10,0,46,43,1
7849,138507,MpirycsifxnqK6u8Sn5hIRSvmckHkzCA,SpATywNh6bZuzm8s1ceuBUnMUAeoAHHw,9,11,5,0,1,0,2,0,19,2.7142857142857144,1,0.0,0,5,0,1,11,0,0,2,0,6,13,1
7850,138515,2Vr8sMi8Nmtw7GvPlYj3ww9EzMgjDWh8,SpATywNh6bZuzm8s1ceuBUnMUAeoAHHw,16,52,23,4,15,0,9,0,103,14.714285714285714,5,0.0,2,23,4,15,50,0,0,9,0,44,59,0
7851,138523,BhCvmy8WtOEti83wDjK9xOLWP4oCctij,RXDvfPUBYFlVdlueBFbLW0mhhAyGEqpt,6,5,1,0,1,0,1,0,8,1.1428571428571428,1,0.0,0,1,0,1,5,0,0,1,0,2,6,1
7852,138553,okqN4nBVKRYYrkYonKicKGOmPqVGYjZh,SpATywNh6bZuzm8s1ceuBUnMUAeoAHHw,1,0,0,0,0,0,1,0,1,0.14285714285714285,1,0.0,0,0,0,0,0,0,0,1,0,0,1,0
7853,138559,WNxlasM9yolV5j0jIrxkqf7jn6zMrkGu,SpATywNh6bZuzm8s1ceuBUnMUAeoAHHw,23,34,20,12,9,0,7,0,82,11.714285714285714,5,0.0,8,20,12,9,26,0,0,7,0,49,33,0
7854,138592,GMf4nDF86vAQn7o32sgKeW8Q5bPvplyR,SpATywNh6bZuzm8s1ceuBUnMUAeoAHHw,1,0,0,0,0,0,1,0,1,0.14285714285714285,1,0.0,0,0,0,0,0,0,0,1,0,0,1,1
7855,138596,D6KOlmquo7I0tYjdBYopRvmG8dULoSiy,SpATywNh6bZuzm8s1ceuBUnMUAeoAHHw,1,0,0,0,0,0,1,0,1,0.14285714285714285,1,0.0,0,0,0,0,0,0,0,1,0,0,1,1
7856,138597,S5iRqyOmmXNAeHlaI33tGlS1KWic6aj1,A3fsA9Zfv1X2fVEQhTw51lKENdNrEqT3,7,2,1,0,1,0,6,0,10,1.4285714285714286,1,0.0,0,1,0,1,2,0,0,6,0,2,8,1
7857,138605,0TwmbDZ9MIyhTy6dnWnLvFIAROrnAMuZ,A3fsA9Zfv1X2fVEQhTw51lKENdNrEqT3,11,7,5,0,3,0,2,0,17,2.4285714285714284,1,0.0,0,5,0,3,7,0,0,2,0,8,9,0
7858,138607,XDhMhAgbTguQNFGPykY6IJEQSl3DEa3i,SpATywNh6bZuzm8s1ceuBUnMUAeoAHHw,28,33,15,20,10,1,4,0,83,11.857142857142858,2,0.0,7,15,19,10,26,1,1,4,0,51,32,0
7859,138617,Godw4MPsn7e3CY6DWEArhTuLJcMvjBtb,SpATywNh6bZuzm8s1ceuBUnMUAeoAHHw,26,35,2,0,2,0,3,0,42,6.0,1,0.0,3,2,0,2,32,0,0,3,0,7,35,0
7860,138621,dgFOOUSNfQK8xIrT47Av0Q04bBFeE21W,RXDvfPUBYFlVdlueBFbLW0mhhAyGEqpt,1,0,0,0,0,0,1,0,1,0.14285714285714285,1,0.0,0,0,0,0,0,0,0,1,0,0,1,1
7861,138627,QZoi4xpkEVVH2rbYL53oYFfYungIuUup,7GRhBDsirIGkRZBtSMEzNTyDr2JQm4xx,2,0,0,0,0,0,2,0,2,0.2857142857142857,1,0.0,0,0,0,0,0,0,0,2,0,0,2,1
7862,138628,pobtqs5WzDAQy06CllYnfSilz3k396iM,5X6FeZozNMgE2VRi3MJYjkkFK8SETtu2,5,2,1,0,1,0,3,0,7,1.0,1,0.0,0,1,0,1,2,0,0,3,0,2,5,1
7863,138635,fUQHFT4QEMRSPqJAQlXlvlyNwca9Q0dU,5X6FeZozNMgE2VRi3MJYjkkFK8SETtu2,2,0,0,0,0,0,2,0,2,0.2857142857142857,1,0.0,0,0,0,0,0,0,0,2,0,0,2,1
7864,138636,rQBPx7NxAW8uUENR4ioCffkqkz2l2Zdk,SpATywNh6bZuzm8s1ceuBUnMUAeoAHHw,14,12,2,0,3,0,9,0,26,3.7142857142857144,1,0.0,0,2,0,3,12,0,0,9,0,5,21,0
7865,138668,C9M4L6lmYvlB2RHCf26FkWqXSt1Mshvm,SpATywNh6bZuzm8s1ceuBUnMUAeoAHHw,1,0,0,0,0,0,1,0,1,0.14285714285714285,1,0.0,0,0,0,0,0,0,0,1,0,0,1,1
7866,138669,ocJfmop89q8wSvbacXliS7aVaEtu1fL9,SpATywNh6bZuzm8s1ceuBUnMUAeoAHHw,14,13,6,0,2,0,7,1,29,4.142857142857143,1,0.0,2,6,0,2,11,0,0,7,1,10,19,1
7867,138676,54s32diFNl04mUbmkn3h7tEt4XEhQ65w,SpATywNh6bZuzm8s1ceuBUnMUAeoAHHw,45,63,0,73,0,25,10,0,171,24.428571428571427,3,0.0,11,0,67,0,52,25,6,10,0,78,93,1
7868,138682,LVgGKe8GEjU3xNkkgcLCws2DFML8rckJ,G8EPVSXsOYB5YQWZGiz1aVq5Pgr2GrQu,9,10,3,0,2,0,4,0,19,2.7142857142857144,2,0.0,0,3,0,2,10,0,0,4,0,5,14,1
7869,138683,FjU6QtF6tkFpwGWrgtA1sVqJ0AzkSd7O,SpATywNh6bZuzm8s1ceuBUnMUAeoAHHw,1,0,0,0,0,0,1,0,1,0.14285714285714285,1,0.0,0,0,0,0,0,0,0,1,0,0,1,1
7870,138685,w5dGML1pfjDAMxCnLd2PebUfpsrNLp1J,SpATywNh6bZuzm8s1ceuBUnMUAeoAHHw,8,12,6,0,0,0,12,0,30,4.285714285714286,2,0.0,3,6,0,0,9,0,0,12,0,9,21,1
7871,138692,ixs1CEJxkJS0gIphbPcsPzQNrY8VNX7l,bWdj2GDclj5ofokWjzoa5jAwMkxCykd6,30,39,20,8,13,25,8,1,114,16.285714285714285,2,0.0,3,20,7,13,36,25,1,8,1,43,71,1
7872,138697,hqCEmHevHWO3zOOJGQPPXN8yqCSfkWdM,SpATywNh6bZuzm8s1ceuBUnMUAeoAHHw,11,21,15,0,12,1,2,0,51,7.285714285714286,1,0.0,4,15,0,12,17,1,0,2,0,31,20,1
7873,138706,pbrp10nKU3FSv5db8NaDnlmsVOuCQ4Jk,SpATywNh6bZuzm8s1ceuBUnMUAeoAHHw,1,0,0,0,0,0,1,0,1,0.14285714285714285,1,0.0,0,0,0,0,0,0,0,1,0,0,1,1
7874,138711,2mcFXXl5IuZRP6QuFfHO1XF6KcVjhONf,SpATywNh6bZuzm8s1ceuBUnMUAeoAHHw,16,24,16,6,9,0,5,0,60,8.571428571428571,5,0.0,0,16,5,9,24,0,1,5,0,30,30,0
7875,138716,bWXDTeHwMBrcFvsHEHi16Kcz6vnkKBkc,SpATywNh6bZuzm8s1ceuBUnMUAeoAHHw,1,0,0,0,0,0,1,0,1,0.14285714285714285,1,0.0,0,0,0,0,0,0,0,1,0,0,1,1
7876,138723,nqLRPpborGO3IzbD5YxVONrZGqxfXpwO,SpATywNh6bZuzm8s1ceuBUnMUAeoAHHw,5,2,1,0,1,0,2,0,6,0.8571428571428571,1,0.0,0,1,0,1,2,0,0,2,0,2,4,1
7877,138725,IreR9lbRJ0OvrS5Rrkgo4wb8DgdRtNqY,G8EPVSXsOYB5YQWZGiz1aVq5Pgr2GrQu,7,5,0,0,0,0,3,0,8,1.1428571428571428,1,0.0,0,0,0,0,5,0,0,3,0,0,8,1
7878,138728,kcajSl3XvPJzA8r8jTipqgj4EAGyDqJf,7GRhBDsirIGkRZBtSMEzNTyDr2JQm4xx,1,0,0,0,0,0,1,0,1,0.14285714285714285,1,0.0,0,0,0,0,0,0,0,1,0,0,1,1
7879,138746,IvlJ5Ne8x58imY8N2ImajFJcbQ8NSddM,SpATywNh6bZuzm8s1ceuBUnMUAeoAHHw,7,8,5,0,3,0,4,1,21,3.0,1,0.0,0,5,0,3,8,0,0,4,1,8,13,1
7880,138752,IvlJ5Ne8x58imY8N2ImajFJcbQ8NSddM,G8EPVSXsOYB5YQWZGiz1aVq5Pgr2GrQu,5,2,1,0,1,0,2,0,6,0.8571428571428571,1,0.0,0,1,0,1,2,0,0,2,0,2,4,1
7881,138773,KgI4N8obM77BN2pWGuwW2XEP0R0bVgvd,SpATywNh6bZuzm8s1ceuBUnMUAeoAHHw,1,0,0,0,0,0,1,0,1,0.14285714285714285,1,0.0,0,0,0,0,0,0,0,1,0,0,1,1
7882,138779,hSiX0gsGM42qIOLoQHVi7PexCDmJMGeO,SpATywNh6bZuzm8s1ceuBUnMUAeoAHHw,21,39,20,0,9,1,19,4,92,13.142857142857142,2,0.0,0,20,0,9,39,1,0,19,4,29,63,0
7883,138784,Cht8Ar5rNwhCbXwxQlDDBBiX3UVSTbja,G8EPVSXsOYB5YQWZGiz1aVq5Pgr2GrQu,1,0,0,0,0,0,1,0,1,0.14285714285714285,1,0.0,0,0,0,0,0,0,0,1,0,0,1,1
7884,138787,7hJ2ePjWExHA9UJ56RXVpLrBuHR3eqnW,SpATywNh6bZuzm8s1ceuBUnMUAeoAHHw,5,2,1,0,1,0,3,0,7,1.0,2,0.0,0,1,0,1,2,0,0,3,0,2,5,0
7885,138806,mEHAVnTSPxrqijaXglU7YL6yhhw9zDNh,SpATywNh6bZuzm8s1ceuBUnMUAeoAHHw,5,2,1,0,1,0,2,0,6,0.8571428571428571,1,0.0,0,1,0,1,2,0,0,2,0,2,4,1
7886,138808,wZxGcsfZmDyO3eZaMEp8V4Qxwmu1n6lt,A3fsA9Zfv1X2fVEQhTw51lKENdNrEqT3,82,37,30,164,25,0,8,0,264,37.714285714285715,4,0.0,2,30,128,25,35,0,36,8,0,185,79,0
7887,138810,KarP5JDxaA55wR1ThEFPoGYFsHmbBCZf,SpATywNh6bZuzm8s1ceuBUnMUAeoAHHw,5,3,2,0,1,0,1,0,7,1.0,1,0.0,0,2,0,1,3,0,0,1,0,3,4,1
7888,138833,3dQnEtCSBapAIfvKu6nxUNhPLUtc5bv5,SpATywNh6bZuzm8s1ceuBUnMUAeoAHHw,2,0,0,0,0,0,3,0,3,0.42857142857142855,2,0.0,0,0,0,0,0,0,0,3,0,0,3,1
7889,138841,DZpFukg3Xf0cnebae81BlsdASyy3V2qH,SpATywNh6bZuzm8s1ceuBUnMUAeoAHHw,1,0,0,0,0,0,1,0,1,0.14285714285714285,1,0.0,0,0,0,0,0,0,0,1,0,0,1,1
7890,138860,nZH2h9tRgS1XihszFT0Gsl3zQK5yTzdn,G8EPVSXsOYB5YQWZGiz1aVq5Pgr2GrQu,8,3,1,0,1,0,8,0,13,1.8571428571428572,1,0.0,0,1,0,1,3,0,0,8,0,2,11,1
7891,138864,2YnAwfYuSOt3uEyCQgsGW618p6jbN0IY,SpATywNh6bZuzm8s1ceuBUnMUAeoAHHw,6,3,1,0,1,0,2,0,7,1.0,1,0.0,0,1,0,1,3,0,0,2,0,2,5,1
7892,138866,e26S3yWE4iC2a5gPCzthjRLKEGyf631u,A3fsA9Zfv1X2fVEQhTw51lKENdNrEqT3,1,0,0,0,0,0,1,0,1,0.14285714285714285,1,0.0,0,0,0,0,0,0,0,1,0,0,1,1
7893,138873,lLp4bdT6ycggmaUdjHCcgWeQnh0T1b1d,SpATywNh6bZuzm8s1ceuBUnMUAeoAHHw,7,6,3,0,1,0,2,0,12,1.7142857142857142,2,0.0,0,3,0,1,6,0,0,2,0,4,8,1
7894,138880,VsfU7jeSb2K8k0CBzCZzXJjDlMye1sB1,RXDvfPUBYFlVdlueBFbLW0mhhAyGEqpt,11,8,4,0,1,1,8,1,23,3.2857142857142856,2,0.0,0,4,0,1,8,1,0,8,1,5,18,0
7895,138890,fO1rPCd8LF1QZM5kj2eXZwLqI6uO4Zpz,SpATywNh6bZuzm8s1ceuBUnMUAeoAHHw,6,3,2,0,2,0,1,0,8,1.1428571428571428,1,0.0,0,2,0,2,3,0,0,1,0,4,4,1
7896,138896,kjBA6VJ4qmelOBTnvk6RkA4J30dOR7mL,RXDvfPUBYFlVdlueBFbLW0mhhAyGEqpt,1,0,0,0,0,0,1,0,1,0.14285714285714285,1,0.0,0,0,0,0,0,0,0,1,0,0,1,1
7897,138898,mSs5bB1Rxg3xYWjWjJY9pVTt7WAiMgyu,RXDvfPUBYFlVdlueBFbLW0mhhAyGEqpt,4,2,0,0,0,0,2,0,4,0.5714285714285714,1,0.0,0,0,0,0,2,0,0,2,0,0,4,0
7898,138899,o2SXMMuwkAchmNytI57JyhMVRzDpUVn5,SpATywNh6bZuzm8s1ceuBUnMUAeoAHHw,8,5,4,0,2,0,2,0,13,1.8571428571428572,1,0.0,0,4,0,2,5,0,0,2,0,6,7,1
7899,138907,uzPUKUi7vVAcTKZXvlLeqjC4erxz8WBI,RXDvfPUBYFlVdlueBFbLW0mhhAyGEqpt,1,0,0,0,0,0,1,0,1,0.14285714285714285,1,0.0,0,0,0,0,0,0,0,1,0,0,1,1
7900,138915,hKt77EvNF2V8dULpUFYS5RKu3nxqT9mr,SpATywNh6bZuzm8s1ceuBUnMUAeoAHHw,9,9,3,0,1,0,6,1,20,2.857142857142857,2,0.0,2,3,0,1,7,0,0,6,1,6,14,1
7901,138921,SdmxANaN4VeJNVCXABSOs77O0krJ65nl,SpATywNh6bZuzm8s1ceuBUnMUAeoAHHw,29,29,20,30,11,0,7,0,97,13.857142857142858,2,0.0,3,20,27,11,26,0,3,7,0,61,36,1
7902,138925,EoOFKLnEYmufwMQdHqSZZDxomOFT0KCX,G8EPVSXsOYB5YQWZGiz1aVq5Pgr2GrQu,1,0,0,0,0,0,1,0,1,0.14285714285714285,1,0.0,0,0,0,0,0,0,0,1,0,0,1,1
7903,138929,E140VfvbscDqlcRAWBL1Py2bsKG92tJe,SpATywNh6bZuzm8s1ceuBUnMUAeoAHHw,5,5,1,0,0,0,5,0,11,1.5714285714285714,2,0.0,0,1,0,0,5,0,0,5,0,1,10,0
7904,138932,mSs5bB1Rxg3xYWjWjJY9pVTt7WAiMgyu,5X6FeZozNMgE2VRi3MJYjkkFK8SETtu2,5,0,0,0,0,9,4,1,14,2.0,2,0.0,0,0,0,0,0,9,0,4,1,0,14,1
7905,138940,fO1rPCd8LF1QZM5kj2eXZwLqI6uO4Zpz,bWdj2GDclj5ofokWjzoa5jAwMkxCykd6,6,6,4,2,3,0,2,0,17,2.4285714285714284,1,0.0,1,4,2,3,5,0,0,2,0,10,7,0
7906,138964,A9y7TPUaNly8tUFOq4q4aCFlU3ogHi28,SpATywNh6bZuzm8s1ceuBUnMUAeoAHHw,5,2,1,0,1,0,2,0,6,0.8571428571428571,1,0.0,0,1,0,1,2,0,0,2,0,2,4,1
7907,138979,9Mbi6CksSOlTvzJd1jV7pzorOP4mmF9E,SpATywNh6bZuzm8s1ceuBUnMUAeoAHHw,19,16,10,0,7,0,4,0,37,5.285714285714286,3,0.0,0,10,0,7,16,0,0,4,0,17,20,0
7908,138984,Dxd5J10xLvv5WcPvQgJwM2KUHZjk0MHz,A3fsA9Zfv1X2fVEQhTw51lKENdNrEqT3,11,5,4,0,4,0,2,0,15,2.142857142857143,1,0.0,0,4,0,4,5,0,0,2,0,8,7,1
7909,138998,oho8eUx0qt2QgQUM9H4Puo64w9V5nVUl,bWdj2GDclj5ofokWjzoa5jAwMkxCykd6,25,26,10,60,8,1,14,2,121,17.285714285714285,2,0.0,12,10,56,8,14,1,4,14,2,86,35,1
7910,139001,PLKaanKvHCtHMqtCskLE9sVgrYP9vmXy,SpATywNh6bZuzm8s1ceuBUnMUAeoAHHw,20,24,11,14,6,4,3,0,62,8.857142857142858,3,0.0,9,11,13,6,15,4,1,3,0,39,23,0
7911,139010,JZlzHSkEZVINL2AGduN6dQZUtjTJ410F,SpATywNh6bZuzm8s1ceuBUnMUAeoAHHw,1,0,0,0,0,0,1,0,1,0.14285714285714285,1,0.0,0,0,0,0,0,0,0,1,0,0,1,1
7912,139023,Uxd7sramSgOYbTkMuTemo7Lms4lBJja0,G8EPVSXsOYB5YQWZGiz1aVq5Pgr2GrQu,27,34,23,0,21,0,8,0,86,12.285714285714286,1,0.0,2,23,0,21,32,0,0,8,0,46,40,0
7913,139033,AADHk2CnqIXqU54SVoJYYzHXkzsT7VVX,bWdj2GDclj5ofokWjzoa5jAwMkxCykd6,5,7,4,0,0,0,3,0,14,2.0,2,0.0,0,4,0,0,7,0,0,3,0,4,10,1
7914,139038,l7NRPJc4rUDr4y6zY2SQw5RLUlkDSz6O,SpATywNh6bZuzm8s1ceuBUnMUAeoAHHw,5,2,1,0,1,0,2,0,6,0.8571428571428571,1,0.0,0,1,0,1,2,0,0,2,0,2,4,1
7915,139042,8zAtOSKV7R70cZuke03f42P9Tj2cyqBy,SpATywNh6bZuzm8s1ceuBUnMUAeoAHHw,1,0,0,0,0,0,1,0,1,0.14285714285714285,1,0.0,0,0,0,0,0,0,0,1,0,0,1,1
7916,139083,nVzZqtkPutJNXrjSnq18UP0Fihh22RZh,5X6FeZozNMgE2VRi3MJYjkkFK8SETtu2,2,0,0,0,0,0,2,0,2,0.2857142857142857,1,0.0,0,0,0,0,0,0,0,2,0,0,2,1
7917,139091,FqxZInDGuTXmPgpy2HmrKGvUbRHydqL9,A3fsA9Zfv1X2fVEQhTw51lKENdNrEqT3,19,13,8,24,4,0,3,0,52,7.428571428571429,2,0.0,1,8,17,4,12,0,7,3,0,30,22,1
7918,139100,ufkSOeGuf3AfIrzMjRVDs6ilWKaIwHHV,SpATywNh6bZuzm8s1ceuBUnMUAeoAHHw,36,54,8,40,4,0,14,0,120,17.142857142857142,4,0.0,14,8,37,4,40,0,3,14,0,63,57,1
7919,139110,CbHE8hCSYPvdgYMpDUO4zyKrMGfMTSJS,RXDvfPUBYFlVdlueBFbLW0mhhAyGEqpt,1,0,0,0,0,0,1,0,1,0.14285714285714285,1,0.0,0,0,0,0,0,0,0,1,0,0,1,1
7920,139122,FIYIY0le6IgAtT64SQdOQ9wlHEZCwQOO,bWdj2GDclj5ofokWjzoa5jAwMkxCykd6,1,0,0,0,0,0,2,0,2,0.2857142857142857,1,0.0,0,0,0,0,0,0,0,2,0,0,2,1
7921,139128,QaUj3eOwCavlOK096M7ra3BPeu9HLHwH,SpATywNh6bZuzm8s1ceuBUnMUAeoAHHw,15,14,2,10,2,0,6,0,34,4.857142857142857,3,0.0,2,2,9,2,12,0,1,6,0,15,19,0
7922,139130,EcFLaX7m7PzXKDd48eR92uOnZACA5T7k,SpATywNh6bZuzm8s1ceuBUnMUAeoAHHw,4,2,1,0,0,0,2,0,5,0.7142857142857143,1,0.0,0,1,0,0,2,0,0,2,0,1,4,1
7923,139142,uHDgildzp3tPJLxwWBJTKE08lfp58kYr,SpATywNh6bZuzm8s1ceuBUnMUAeoAHHw,19,13,9,6,7,0,3,0,38,5.428571428571429,2,0.0,0,9,5,7,13,0,1,3,0,21,17,0
7924,139147,8FRW3fq2kTtq4r8tmTLCvi2IiJ0rjp3S,5X6FeZozNMgE2VRi3MJYjkkFK8SETtu2,5,2,1,0,1,0,4,0,8,1.1428571428571428,1,0.0,0,1,0,1,2,0,0,4,0,2,6,1
7925,139152,SsP0xcwMwuo4obRVxCDjDqMOPLlv2HNO,SpATywNh6bZuzm8s1ceuBUnMUAeoAHHw,8,12,9,0,8,0,5,0,34,4.857142857142857,1,0.0,0,9,0,8,12,0,0,5,0,17,17,1
7926,139155,j54JBLGJIJ4pHZN5w24SsPoFU8DYGtev,bWdj2GDclj5ofokWjzoa5jAwMkxCykd6,4,2,1,0,1,0,1,0,5,0.7142857142857143,1,0.0,0,1,0,1,2,0,0,1,0,2,3,1
7927,139165,emLy0wxTS6s6x2ntzW39vmfcR0P0HK07,G8EPVSXsOYB5YQWZGiz1aVq5Pgr2GrQu,10,13,5,8,3,0,1,0,30,4.285714285714286,1,0.0,7,5,5,3,6,0,3,1,0,20,10,1
7928,139166,RilPnDVnlT9lfSJkTtPGJBpYx1VNW6Lv,RXDvfPUBYFlVdlueBFbLW0mhhAyGEqpt,23,14,13,0,9,0,2,0,38,5.428571428571429,1,0.0,0,13,0,9,14,0,0,2,0,22,16,0
7929,139195,O6WL6sxvoPCZnvTLyTPxdXbnpOz3wcJ4,SpATywNh6bZuzm8s1ceuBUnMUAeoAHHw,1,0,0,0,0,0,1,0,1,0.14285714285714285,1,0.0,0,0,0,0,0,0,0,1,0,0,1,0
7930,139207,RIjNzTzWwuMpVu0vcsF9N8cORAAtLFQn,bWdj2GDclj5ofokWjzoa5jAwMkxCykd6,7,6,0,0,2,0,4,0,12,1.7142857142857142,1,0.0,3,0,0,2,3,0,0,4,0,5,7,1
7931,139217,OOIu03NBEHePUSUIFa86FGFP5M136EAn,RXDvfPUBYFlVdlueBFbLW0mhhAyGEqpt,41,34,21,69,16,0,5,0,145,20.714285714285715,3,0.0,7,21,64,16,27,0,5,5,0,108,37,0
7932,139222,St6usTSSgX5U9v7wchuMWqmBKoCcDwN2,bWdj2GDclj5ofokWjzoa5jAwMkxCykd6,7,6,0,20,0,0,1,0,27,3.857142857142857,1,0.0,2,0,20,0,4,0,0,1,0,22,5,1
7933,139230,Az3rIdfQyspbBZOuftkV0XmT1mpRRVMU,G8EPVSXsOYB5YQWZGiz1aVq5Pgr2GrQu,5,2,0,0,0,0,3,0,5,0.7142857142857143,1,0.0,0,0,0,0,2,0,0,3,0,0,5,1
7934,139232,S4NIV7rLz6yEEE3xTS1sucASvuOIiFcC,5X6FeZozNMgE2VRi3MJYjkkFK8SETtu2,1,0,0,0,0,0,1,0,1,0.14285714285714285,1,0.0,0,0,0,0,0,0,0,1,0,0,1,1
7935,139246,3nkAYJy31glMu7RttArFOqU7gmkfxNPM,SpATywNh6bZuzm8s1ceuBUnMUAeoAHHw,7,8,2,14,0,0,4,0,28,4.0,2,0.0,6,2,13,0,2,0,1,4,0,21,7,0
7936,139250,NLUFE7ndaVQ8A2tkIa8xBpPqWZbahAYT,5X6FeZozNMgE2VRi3MJYjkkFK8SETtu2,30,40,15,54,15,9,6,1,140,20.0,2,0.0,22,15,41,15,18,9,13,6,1,93,47,1
7937,139252,AKVd0gnvEJlgz6OnGwqybMUQOVjHL58y,SpATywNh6bZuzm8s1ceuBUnMUAeoAHHw,28,33,25,19,20,0,4,0,101,14.428571428571429,4,0.0,3,25,15,20,30,0,4,4,0,63,38,0
7938,139256,oho8eUx0qt2QgQUM9H4Puo64w9V5nVUl,A3fsA9Zfv1X2fVEQhTw51lKENdNrEqT3,1,0,0,0,0,0,1,0,1,0.14285714285714285,1,0.0,0,0,0,0,0,0,0,1,0,0,1,0
7939,139268,QCD1u7mUCxrAs3C6jTFrAgxI51q3Q7rz,RXDvfPUBYFlVdlueBFbLW0mhhAyGEqpt,1,0,0,0,0,0,1,0,1,0.14285714285714285,1,0.0,0,0,0,0,0,0,0,1,0,0,1,1
7940,139272,izfjE6NG3af26sY3NuLKpzoBmikc8i1O,A3fsA9Zfv1X2fVEQhTw51lKENdNrEqT3,5,2,1,0,1,0,4,0,8,1.1428571428571428,1,0.0,0,1,0,1,2,0,0,4,0,2,6,1
7941,139275,XqfKw12BYBxvQyUszKCvSmcUn4H9qRJJ,bWdj2GDclj5ofokWjzoa5jAwMkxCykd6,5,5,3,0,2,0,2,0,12,1.7142857142857142,2,0.0,0,3,0,2,5,0,0,2,0,5,7,1
7942,139277,S4NIV7rLz6yEEE3xTS1sucASvuOIiFcC,RXDvfPUBYFlVdlueBFbLW0mhhAyGEqpt,1,0,0,0,0,0,1,0,1,0.14285714285714285,1,0.0,0,0,0,0,0,0,0,1,0,0,1,1
7943,139285,XqfKw12BYBxvQyUszKCvSmcUn4H9qRJJ,A3fsA9Zfv1X2fVEQhTw51lKENdNrEqT3,9,14,9,0,2,0,5,0,30,4.285714285714286,2,0.0,1,9,0,2,13,0,0,5,0,12,18,1
7944,139294,Gei04etgXyrCJnYW4R2aEBjKo3aqgVnG,SpATywNh6bZuzm8s1ceuBUnMUAeoAHHw,5,2,1,0,1,0,2,0,6,0.8571428571428571,1,0.0,0,1,0,1,2,0,0,2,0,2,4,1
7945,139322,AAAvWauitKfXD0xRpNsfpOKQu223kCXG,A3fsA9Zfv1X2fVEQhTw51lKENdNrEqT3,3,2,1,0,0,0,2,0,5,0.7142857142857143,2,0.0,0,1,0,0,2,0,0,2,0,1,4,1
7946,139324,hT3A3NhtOhvHOWKsgHNINVDyTB0qBxh1,SpATywNh6bZuzm8s1ceuBUnMUAeoAHHw,5,2,1,0,1,0,2,0,6,0.8571428571428571,1,0.0,0,1,0,1,2,0,0,2,0,2,4,0
7947,139331,jIQxdn4syEISmeL05XWgww3FZktzs7MC,SpATywNh6bZuzm8s1ceuBUnMUAeoAHHw,35,38,24,42,12,2,7,0,125,17.857142857142858,5,0.0,8,24,40,12,30,2,2,7,0,84,41,0
7948,139332,IAgEmatHzKUXARhFStPcCuJqOEJArzMq,SpATywNh6bZuzm8s1ceuBUnMUAeoAHHw,30,49,26,20,13,12,8,0,128,18.285714285714285,2,0.0,15,26,18,13,34,12,2,8,0,72,56,0
7949,139336,6rH08L3lN0NWDbzJa4w6QS7ZCcNaTo1u,SpATywNh6bZuzm8s1ceuBUnMUAeoAHHw,42,52,24,44,13,0,3,0,136,19.428571428571427,3,0.0,24,24,38,13,28,0,6,3,0,99,37,0
7950,139340,DqEghpE9KPv2P7lR2sFssI7iqD8k80gK,5X6FeZozNMgE2VRi3MJYjkkFK8SETtu2,1,0,0,0,0,0,1,0,1,0.14285714285714285,1,0.0,0,0,0,0,0,0,0,1,0,0,1,1
7951,139342,iO8wfk9CJpGr60f1tg17Yoor3BIrLyLv,bWdj2GDclj5ofokWjzoa5jAwMkxCykd6,1,0,0,0,0,0,1,0,1,0.14285714285714285,1,0.0,0,0,0,0,0,0,0,1,0,0,1,1
7952,139348,A72Fa3XS93rMwEK1aHoBEvc3t9L2XsxB,SpATywNh6bZuzm8s1ceuBUnMUAeoAHHw,2,0,0,0,0,0,3,0,3,0.42857142857142855,1,0.0,0,0,0,0,0,0,0,3,0,0,3,1
7953,139356,mLuDEu9s65x5hAW4ThAGLYVNud4kQVNC,RXDvfPUBYFlVdlueBFbLW0mhhAyGEqpt,18,31,17,21,11,0,4,0,84,12.0,1,0.0,7,17,19,11,24,0,2,4,0,54,30,0
7954,139358,Zi07wsUlv6JaA1UnVePCC5W9D6L8zwtC,G8EPVSXsOYB5YQWZGiz1aVq5Pgr2GrQu,1,0,0,0,0,0,1,0,1,0.14285714285714285,1,0.0,0,0,0,0,0,0,0,1,0,0,1,1
7955,139365,zidBG8DYrB5FUPcHiIjJwJg81Cz0xkbI,RXDvfPUBYFlVdlueBFbLW0mhhAyGEqpt,5,4,0,0,0,0,3,1,8,1.1428571428571428,1,0.0,0,0,0,0,4,0,0,3,1,0,8,0
7956,139369,aXYyJMDvVYwwKBbiO4CB25XlnDBfWYNg,A3fsA9Zfv1X2fVEQhTw51lKENdNrEqT3,4,3,2,0,0,0,1,0,6,0.8571428571428571,1,0.0,0,2,0,0,3,0,0,1,0,2,4,1
7957,139371,LHMz4Z1aIT7X203UBFQJGAdpl2c2Pnqz,SpATywNh6bZuzm8s1ceuBUnMUAeoAHHw,3,2,0,0,0,0,2,0,4,0.5714285714285714,1,0.0,0,0,0,0,2,0,0,2,0,0,4,0
7958,139379,xM4BoPjpAZOnLWP1jIeLJ07UUf6rY0Bo,G8EPVSXsOYB5YQWZGiz1aVq5Pgr2GrQu,4,3,1,0,0,0,2,0,6,0.8571428571428571,2,0.0,0,1,0,0,3,0,0,2,0,1,5,1
7959,139380,LIoGzJO9iWdcU74H9UnplKXzxcDk8cHj,SpATywNh6bZuzm8s1ceuBUnMUAeoAHHw,8,7,2,0,2,0,2,0,13,1.8571428571428572,2,0.0,0,2,0,2,7,0,0,2,0,4,9,0
7960,139395,zTl9sraD9wqiuzOUBuj4ORVo1KvzZJQZ,SpATywNh6bZuzm8s1ceuBUnMUAeoAHHw,7,5,1,0,1,1,4,0,12,1.7142857142857142,1,0.0,1,1,0,1,4,1,0,4,0,3,9,1
7961,139397,GJU8L7zpC13yJeUsnL1O83fEI4FTEcNw,SpATywNh6bZuzm8s1ceuBUnMUAeoAHHw,2,0,0,0,0,0,4,0,4,0.5714285714285714,2,0.0,0,0,0,0,0,0,0,4,0,0,4,0
7962,139404,fgEJIqkp4SMlTSJ7SAm1OLRW7sHHzj7J,RXDvfPUBYFlVdlueBFbLW0mhhAyGEqpt,26,27,15,48,8,0,1,0,99,14.142857142857142,1,0.0,7,15,48,8,20,0,0,1,0,78,21,0
7963,139419,UnYWhkEUM28aufKl6iE422jz3645yuzl,RXDvfPUBYFlVdlueBFbLW0mhhAyGEqpt,41,47,5,58,3,0,14,6,133,19.0,2,0.0,7,5,56,3,40,0,2,14,6,71,62,0
7964,139436,YOvd9uht0tZm889aIFQH8jd68xtH7inE,bWdj2GDclj5ofokWjzoa5jAwMkxCykd6,17,21,9,16,9,0,3,0,58,8.285714285714286,2,0.0,10,9,14,9,11,0,2,3,0,42,16,0
7965,139462,uyV5v8i6DnVDO3WtU4s2nn4PGzjM1DJi,RXDvfPUBYFlVdlueBFbLW0mhhAyGEqpt,1,0,0,0,0,0,1,0,1,0.14285714285714285,1,0.0,0,0,0,0,0,0,0,1,0,0,1,1
7966,139467,d40G6C9cb6Xi6RVyNy2Bmtx1OxVs6H6W,bWdj2GDclj5ofokWjzoa5jAwMkxCykd6,2,0,0,0,0,0,2,0,2,0.2857142857142857,1,0.0,0,0,0,0,0,0,0,2,0,0,2,1
7967,139506,n7YwcJxwfuUXRRrR0Y0hk0nqog6FrsWi,SpATywNh6bZuzm8s1ceuBUnMUAeoAHHw,2,0,0,0,0,0,2,0,2,0.2857142857142857,1,0.0,0,0,0,0,0,0,0,2,0,0,2,1
7968,139509,CX2agbMAxnGpDXHjpSp2SGL5oAXroQo8,bWdj2GDclj5ofokWjzoa5jAwMkxCykd6,6,5,2,0,1,0,7,0,15,2.142857142857143,1,0.0,1,2,0,1,4,0,0,7,0,4,11,1
7969,139517,4CoGSxhhHWTO7EDjl5nO5mW4CLM3ADy3,G8EPVSXsOYB5YQWZGiz1aVq5Pgr2GrQu,6,5,1,4,1,2,2,0,15,2.142857142857143,1,0.0,3,1,3,1,2,2,1,2,0,8,7,1
7970,139530,CtxTw5QfyzMFgeuUDk7xEyh7qXDCcYsK,SpATywNh6bZuzm8s1ceuBUnMUAeoAHHw,36,21,18,0,16,0,6,0,61,8.714285714285714,3,0.0,0,18,0,16,21,0,0,6,0,34,27,0
7971,139535,S33lH053HmB7Cz0IWipiL27cwx1QXBWr,SpATywNh6bZuzm8s1ceuBUnMUAeoAHHw,16,28,2,7,1,0,6,0,44,6.285714285714286,2,0.0,0,2,6,1,28,0,1,6,0,9,35,0
7972,139542,Xv0DoRVy2WPaq7NGSTl3PflvzGmHzjVJ,5X6FeZozNMgE2VRi3MJYjkkFK8SETtu2,1,0,0,0,0,0,1,0,1,0.14285714285714285,1,0.0,0,0,0,0,0,0,0,1,0,0,1,1
7973,139554,8iImyyS3GD4CMDnaLhe4nYGG4OYOw3ov,bWdj2GDclj5ofokWjzoa5jAwMkxCykd6,2,0,0,0,0,0,2,0,2,0.2857142857142857,1,0.0,0,0,0,0,0,0,0,2,0,0,2,1
7974,139558,G8fLPL9uAaHZvdz6ZdYfgDC2jOIdMG4b,SpATywNh6bZuzm8s1ceuBUnMUAeoAHHw,1,0,0,0,0,0,1,0,1,0.14285714285714285,1,0.0,0,0,0,0,0,0,0,1,0,0,1,1
7975,139580,cvmDTGaAfjrnwgN0V8fkhCZ7nO1t5O8G,G8EPVSXsOYB5YQWZGiz1aVq5Pgr2GrQu,6,6,1,0,2,0,2,0,11,1.5714285714285714,1,0.0,3,1,0,2,3,0,0,2,0,6,5,1
7976,139583,7DHotsyQCKbl4ztV48mHeF13yzgtZs4m,SpATywNh6bZuzm8s1ceuBUnMUAeoAHHw,1,0,0,0,0,0,1,0,1,0.14285714285714285,1,0.0,0,0,0,0,0,0,0,1,0,0,1,1
7977,139588,hWYN1KMRf8YD8e96RxZErJ2xkz7NvTte,A3fsA9Zfv1X2fVEQhTw51lKENdNrEqT3,7,0,0,0,0,1,12,1,14,2.0,1,0.0,0,0,0,0,0,1,0,12,1,0,14,1
7978,139614,rrw2WJkAL0R5jcfwKMTsm56jlh9a5ial,G8EPVSXsOYB5YQWZGiz1aVq5Pgr2GrQu,5,3,2,0,2,0,2,0,9,1.2857142857142858,1,0.0,0,2,0,2,3,0,0,2,0,4,5,1
7979,139617,NHjxa47feJ9sWQnmg6HoO6L78eHIRwnl,5X6FeZozNMgE2VRi3MJYjkkFK8SETtu2,1,0,0,0,0,0,1,0,1,0.14285714285714285,1,0.0,0,0,0,0,0,0,0,1,0,0,1,0
7980,139651,lbuK5gzlmtjdJwaA3m8yvkycLwxfJOpy,SpATywNh6bZuzm8s1ceuBUnMUAeoAHHw,19,36,14,13,7,0,3,0,73,10.428571428571429,2,0.0,9,14,12,7,27,0,1,3,0,42,31,0
7981,139653,fpQ0ez3rb7sqHqcoB5Q6L9iCWdGA4aex,SpATywNh6bZuzm8s1ceuBUnMUAeoAHHw,1,0,0,0,0,0,1,0,1,0.14285714285714285,1,0.0,0,0,0,0,0,0,0,1,0,0,1,1
7982,139659,rrw2WJkAL0R5jcfwKMTsm56jlh9a5ial,A3fsA9Zfv1X2fVEQhTw51lKENdNrEqT3,7,11,2,0,1,0,10,0,24,3.4285714285714284,2,0.0,0,2,0,1,11,0,0,10,0,3,21,1
7983,139662,SY4uzYHWkMA1yShUbP5621gRVjO4W9UX,SpATywNh6bZuzm8s1ceuBUnMUAeoAHHw,12,6,5,0,4,0,2,0,17,2.4285714285714284,1,0.0,0,5,0,4,6,0,0,2,0,9,8,1
7984,139665,LUIzAJFVL2bM2iV5yPmJrJDybpB7HbwU,bWdj2GDclj5ofokWjzoa5jAwMkxCykd6,16,28,1,0,1,0,3,0,33,4.714285714285714,2,0.0,0,1,0,1,28,0,0,3,0,2,31,1
7985,139666,OiCP77rDGj7m0OeIgoy8NyAC1iklb2Wq,A3fsA9Zfv1X2fVEQhTw51lKENdNrEqT3,3,2,1,0,0,0,1,0,4,0.5714285714285714,1,0.0,0,1,0,0,2,0,0,1,0,1,3,1
7986,139673,VVgqDLLa7j66k9tQU3M7wVOF4BEse4lo,A3fsA9Zfv1X2fVEQhTw51lKENdNrEqT3,1,0,0,0,0,0,1,0,1,0.14285714285714285,1,0.0,0,0,0,0,0,0,0,1,0,0,1,1
7987,139694,hShVfXi5CDkkf6vDlaLmVJ6jHLXUmY8S,SpATywNh6bZuzm8s1ceuBUnMUAeoAHHw,6,4,2,0,1,1,3,0,11,1.5714285714285714,1,0.0,0,2,0,1,4,1,0,3,0,3,8,1
7988,139702,bDbKEMrZzcFQTQT7Qrji0QYF25s6ADsY,5X6FeZozNMgE2VRi3MJYjkkFK8SETtu2,1,0,0,0,0,0,1,0,1,0.14285714285714285,1,0.0,0,0,0,0,0,0,0,1,0,0,1,1
7989,139731,3Jrj6bKUtFj34BYovmjDUontE8TUY429,3VkHkmOtom3jM2wCu94xgzzu1d6Dn7or,1,0,0,0,0,0,1,0,1,0.14285714285714285,1,0.0,0,0,0,0,0,0,0,1,0,0,1,1
7990,139738,OnGeUrzcVBncOK9oiyCK2Q06jpa9wwtU,3VkHkmOtom3jM2wCu94xgzzu1d6Dn7or,1,0,0,0,0,0,1,0,1,0.14285714285714285,1,0.0,0,0,0,0,0,0,0,1,0,0,1,1
7991,139755,4mVyAHk6nJWY1aYACG2ghxNyXqOb7rRH,3VkHkmOtom3jM2wCu94xgzzu1d6Dn7or,1,0,0,0,0,0,1,0,1,0.14285714285714285,1,0.0,0,0,0,0,0,0,0,1,0,0,1,0
7992,139756,zVf2fbD3OAyHoecoptMpgRjWQvGBAzlW,3VkHkmOtom3jM2wCu94xgzzu1d6Dn7or,21,144,55,33,0,62,27,8,329,47.0,4,0.0,35,55,32,0,109,62,1,27,8,122,207,1
7993,139763,2RSFVpVVzDPG0pENjLm6YEyKA12b0b4R,3VkHkmOtom3jM2wCu94xgzzu1d6Dn7or,1,0,0,0,0,0,1,0,1,0.14285714285714285,1,0.0,0,0,0,0,0,0,0,1,0,0,1,1
7994,139782,pGKgkIWDcbsahpf36tFo1CJT2p9hUlYG,3VkHkmOtom3jM2wCu94xgzzu1d6Dn7or,1,0,0,0,0,0,1,0,1,0.14285714285714285,1,0.0,0,0,0,0,0,0,0,1,0,0,1,1
7995,139790,LkcNwIfD9AQcECvPKNRo6NYZBfTeqSea,3VkHkmOtom3jM2wCu94xgzzu1d6Dn7or,20,16,14,0,14,0,37,2,83,11.857142857142858,2,0.0,0,14,0,14,16,0,0,37,2,28,55,1
7996,139791,3Zng3LF8UaCQUhGfuDnz21zu1Mkn8oec,3VkHkmOtom3jM2wCu94xgzzu1d6Dn7or,94,255,100,60,91,19,44,4,573,81.85714285714286,10,0.0,116,100,56,91,139,19,4,44,4,363,210,0
7997,139797,Ib5HAhdZpZuw7ejnKfyxEV3fBWn2phbN,3VkHkmOtom3jM2wCu94xgzzu1d6Dn7or,1,0,0,0,0,0,1,0,1,0.14285714285714285,1,0.0,0,0,0,0,0,0,0,1,0,0,1,1
7998,139809,ZKc55uDFhhCUdxKRVXUYkGlPolPbYDgo,3VkHkmOtom3jM2wCu94xgzzu1d6Dn7or,11,4,3,0,2,6,6,1,22,3.142857142857143,1,0.0,0,3,0,2,4,6,0,6,1,5,17,1
7999,139813,A1rAxc1wvorqZ7Wpim4MjIknl60MdvF1,3VkHkmOtom3jM2wCu94xgzzu1d6Dn7or,4,3,1,0,1,0,1,0,6,0.8571428571428571,1,0.0,1,1,0,1,2,0,0,1,0,3,3,1
8000,139814,eVxlZAXx1ABaY992tgMSrWXi4e9YKziP,3VkHkmOtom3jM2wCu94xgzzu1d6Dn7or,11,35,9,2,14,4,18,0,82,11.714285714285714,3,0.0,20,9,2,14,15,4,0,18,0,45,37,1
8001,139818,HpF0UZEery954r2Wy0wJFt4xXtp25FUM,3VkHkmOtom3jM2wCu94xgzzu1d6Dn7or,30,68,23,23,25,18,15,2,174,24.857142857142858,6,0.0,35,23,20,25,33,18,3,15,2,103,71,1
8002,139833,KA5h5czFk68VoEgzUY80WD480p5Rvsbz,3VkHkmOtom3jM2wCu94xgzzu1d6Dn7or,4,4,0,0,0,0,2,0,6,0.8571428571428571,1,0.0,2,0,0,0,2,0,0,2,0,2,4,1
8003,139843,JCuWcaGCu6lFvDIz9NbN1LQ2JL2iB31e,3VkHkmOtom3jM2wCu94xgzzu1d6Dn7or,6,7,2,0,0,0,4,0,13,1.8571428571428572,2,0.0,1,2,0,0,6,0,0,4,0,3,10,1
8004,139849,auNWijCxVrad57WqY6P30feFdigjhjzZ,3VkHkmOtom3jM2wCu94xgzzu1d6Dn7or,8,4,2,0,2,0,2,0,10,1.4285714285714286,1,0.0,0,2,0,2,4,0,0,2,0,4,6,1
8005,139854,axblY4rn2CPgjAwzBfbbXleDAK5uGDmQ,3VkHkmOtom3jM2wCu94xgzzu1d6Dn7or,8,6,4,0,4,0,3,0,17,2.4285714285714284,1,0.0,2,4,0,4,4,0,0,3,0,10,7,1
8006,139864,hB89Q2sgxzgPKiSqNP9qA0G3CtEv3RVA,3VkHkmOtom3jM2wCu94xgzzu1d6Dn7or,5,5,3,0,2,0,3,0,13,1.8571428571428572,1,0.0,0,3,0,2,5,0,0,3,0,5,8,1
8007,139865,LDZwy5zCY34V3PhuvUwq1WLCZ2XKFncb,3VkHkmOtom3jM2wCu94xgzzu1d6Dn7or,6,6,2,0,3,2,9,0,22,3.142857142857143,1,0.0,2,2,0,3,4,2,0,9,0,7,15,1
8008,139868,lsxgm2IBPEWgYIUtXADaUExIJ5QnoNKC,3VkHkmOtom3jM2wCu94xgzzu1d6Dn7or,8,12,7,0,0,0,1,0,20,2.857142857142857,1,0.0,0,7,0,0,12,0,0,1,0,7,13,1
8009,139870,cXGNVbaSGbcTRRdWFoRN70Rg4SniEolO,3VkHkmOtom3jM2wCu94xgzzu1d6Dn7or,17,43,17,7,11,12,15,0,105,15.0,3,0.0,17,17,6,11,26,12,1,15,0,51,54,1
8010,139882,mUrv5nyEATwaFjJtzCivF2vi0xW8oHdn,3VkHkmOtom3jM2wCu94xgzzu1d6Dn7or,23,35,16,23,15,2,2,0,93,13.285714285714286,3,0.0,14,16,17,15,21,2,6,2,0,62,31,1
8011,139890,6PusrGKQHsCpCjXEorRwIAKdI3yZerO7,3VkHkmOtom3jM2wCu94xgzzu1d6Dn7or,1,0,0,0,0,0,1,0,1,0.14285714285714285,1,0.0,0,0,0,0,0,0,0,1,0,0,1,1
8012,139893,DEBk8bTqc8UvXWoysh3hshBMHr9yuJPk,3VkHkmOtom3jM2wCu94xgzzu1d6Dn7or,68,191,85,43,60,30,27,3,439,62.714285714285715,14,0.0,72,85,42,60,119,30,1,27,3,259,180,0
8013,139907,XYr54DnYnYf3KEqTg2BYiHKXF3QdVRtB,3VkHkmOtom3jM2wCu94xgzzu1d6Dn7or,9,4,3,0,3,0,2,0,12,1.7142857142857142,1,0.0,0,3,0,3,4,0,0,2,0,6,6,1
8014,139910,H6aVkKkXOQXduiOaAvGFvpQo6aKIezV3,3VkHkmOtom3jM2wCu94xgzzu1d6Dn7or,80,164,60,61,50,31,31,4,401,57.285714285714285,9,0.0,56,60,57,50,108,31,4,31,4,223,178,0
8015,139921,zrKRk265OLBkV6Oc81RVajvBqlX0lvOG,3VkHkmOtom3jM2wCu94xgzzu1d6Dn7or,1,0,0,0,0,0,1,0,1,0.14285714285714285,1,0.0,0,0,0,0,0,0,0,1,0,0,1,1
8016,139951,ppBsN7y5vmDt7R3QrUF73vfYphAgu58q,3VkHkmOtom3jM2wCu94xgzzu1d6Dn7or,1,0,0,0,0,0,1,0,1,0.14285714285714285,1,0.0,0,0,0,0,0,0,0,1,0,0,1,1
8017,139959,C4KlGFER1YlHMtKQcExiXEE4aKaD0tn6,3VkHkmOtom3jM2wCu94xgzzu1d6Dn7or,2,0,0,0,0,0,2,0,2,0.2857142857142857,1,0.0,0,0,0,0,0,0,0,2,0,0,2,1
8018,139990,rPjVddy7wXfZ2brJmjkgv7pdL7sJ7UCw,3VkHkmOtom3jM2wCu94xgzzu1d6Dn7or,20,69,39,0,12,0,15,2,137,19.571428571428573,7,0.0,0,39,0,12,69,0,0,15,2,51,86,0
8019,139991,0gibTItQAcu7GiaxYIHVLpnqkpIcuR30,3VkHkmOtom3jM2wCu94xgzzu1d6Dn7or,9,5,5,0,0,0,3,0,13,1.8571428571428572,1,0.0,0,5,0,0,5,0,0,3,0,5,8,1
8020,140001,MavjFefH4SOjoXYnsOcQcdhNCSL7FlvY,3VkHkmOtom3jM2wCu94xgzzu1d6Dn7or,1,0,0,0,0,0,4,0,4,0.5714285714285714,3,0.0,0,0,0,0,0,0,0,4,0,0,4,1
8021,140018,qCAmkptIYE0gl0mPzjDyJJItff4aq5fy,3VkHkmOtom3jM2wCu94xgzzu1d6Dn7or,8,8,3,0,2,1,6,1,21,3.0,1,0.0,1,3,0,2,7,1,0,6,1,6,15,1
8022,140052,bP4PnFhF8rWV4oUOVCJCEUN38pc56N1l,3VkHkmOtom3jM2wCu94xgzzu1d6Dn7or,4,0,0,0,0,4,3,3,10,1.4285714285714286,2,0.0,0,0,0,0,0,4,0,3,3,0,10,0
8023,140056,sBcxk0mGJlFkd4WvpVtecNmqZIBzoHn2,3VkHkmOtom3jM2wCu94xgzzu1d6Dn7or,1,0,0,0,0,0,3,0,3,0.42857142857142855,1,0.0,0,0,0,0,0,0,0,3,0,0,3,1
8024,140111,IEz09p8uVqrNsb9NFfclugzgkCqh5nUn,5X6FeZozNMgE2VRi3MJYjkkFK8SETtu2,55,48,9,94,22,0,2,0,175,25.0,1,0.0,36,9,79,22,12,0,15,2,0,146,29,1
8025,140123,P7X0JLDF7H4Sgmj4O7MpRz6ca0ndbc9Q,5X6FeZozNMgE2VRi3MJYjkkFK8SETtu2,1,0,0,0,0,0,1,0,1,0.14285714285714285,1,0.0,0,0,0,0,0,0,0,1,0,0,1,1
8026,140213,usnj2XaWdnmusZczBB9Vbk759oOFMaOM,5X6FeZozNMgE2VRi3MJYjkkFK8SETtu2,2,10,0,0,0,0,10,0,20,2.857142857142857,4,0.0,0,0,0,0,10,0,0,10,0,0,20,1
8027,140231,FOCCuGaJ7zYTl7CCCo7T3PqrLtxGVeiU,5X6FeZozNMgE2VRi3MJYjkkFK8SETtu2,13,16,6,2,6,0,4,0,34,4.857142857142857,3,0.0,5,6,2,6,11,0,0,4,0,19,15,1
8028,140261,Q981NTq529R8G7YkogVE9XU6kPHMJTKu,5X6FeZozNMgE2VRi3MJYjkkFK8SETtu2,1,0,0,0,0,0,1,0,1,0.14285714285714285,1,0.0,0,0,0,0,0,0,0,1,0,0,1,1
8029,140264,QhJu71wKas1S5H0wZxCSNuscbyYbzhPp,5X6FeZozNMgE2VRi3MJYjkkFK8SETtu2,12,10,1,0,5,0,5,1,22,3.142857142857143,1,0.0,5,1,0,5,5,0,0,5,1,11,11,1
8030,140282,xcD6YWhnGA2xukGmX4eaYrm6VS9ffz1H,7GRhBDsirIGkRZBtSMEzNTyDr2JQm4xx,40,141,5,50,20,11,18,5,250,35.714285714285715,2,0.0,72,5,44,20,69,11,6,18,5,141,109,0
8031,140284,j6kcxmKxOQajIGRYDGpkTlGlZyghzMDl,5X6FeZozNMgE2VRi3MJYjkkFK8SETtu2,19,28,11,0,8,3,8,1,59,8.428571428571429,1,0.0,14,11,0,8,14,3,0,8,1,33,26,1
8032,140286,lmTzsZ1dVt4Xl8uCpslvBuFKl656ogFZ,5X6FeZozNMgE2VRi3MJYjkkFK8SETtu2,4,3,1,0,0,0,3,0,7,1.0,1,0.0,0,1,0,0,3,0,0,3,0,1,6,1
8033,140296,v0bjy2OSIQbTrvwUcnNYuv9Kj8xgAI1w,5X6FeZozNMgE2VRi3MJYjkkFK8SETtu2,4,2,0,0,0,0,4,0,6,0.8571428571428571,1,0.0,0,0,0,0,2,0,0,4,0,0,6,0
8034,140323,su8pPW4fByR0aUGBHBqcvvXPYCeAukSy,5X6FeZozNMgE2VRi3MJYjkkFK8SETtu2,25,48,12,12,13,5,8,0,98,14.0,3,0.0,24,12,12,13,24,5,0,8,0,61,37,0
8035,140331,EkpYyl5FvOIbAuPgHjdTptqbWAlVTTOe,5X6FeZozNMgE2VRi3MJYjkkFK8SETtu2,3,3,0,0,0,0,1,0,4,0.5714285714285714,1,0.0,0,0,0,0,3,0,0,1,0,0,4,1
8036,140358,XawXAsPAfBtlXBQzpKPcgk3ZhHAMJWNJ,7GRhBDsirIGkRZBtSMEzNTyDr2JQm4xx,31,36,14,45,16,0,3,0,114,16.285714285714285,2,0.0,21,14,39,16,15,0,6,3,0,90,24,1
8037,140364,RlksremLnZnegphNH2LaChOFTKkvCYuy,3VkHkmOtom3jM2wCu94xgzzu1d6Dn7or,1,0,0,0,0,0,1,0,1,0.14285714285714285,1,0.0,0,0,0,0,0,0,0,1,0,0,1,1
8038,140365,NB98JVtAv4s5E59EqEW6wDqm2WK5JUUN,3VkHkmOtom3jM2wCu94xgzzu1d6Dn7or,1,0,0,0,0,0,1,0,1,0.14285714285714285,1,0.0,0,0,0,0,0,0,0,1,0,0,1,1
8039,140370,ENIZ2L4MS1QlXu0BPdR9HqNOcSsZY7Ja,3VkHkmOtom3jM2wCu94xgzzu1d6Dn7or,1,0,0,0,0,0,1,0,1,0.14285714285714285,1,0.0,0,0,0,0,0,0,0,1,0,0,1,1
8040,140373,72XvwjxD8EvhX6fS9PSKcDV5sn1GxGDW,3VkHkmOtom3jM2wCu94xgzzu1d6Dn7or,1,0,0,0,0,0,1,0,1,0.14285714285714285,1,0.0,0,0,0,0,0,0,0,1,0,0,1,1
8041,140375,3DDW3Kgkt9lXJYvqDRuWGsfnRB8OjtGj,3VkHkmOtom3jM2wCu94xgzzu1d6Dn7or,9,5,4,0,3,2,9,1,24,3.4285714285714284,1,0.0,0,4,0,3,5,2,0,9,1,7,17,1
8042,140379,ZLYQsgr2iqvuCHs4JabG76V0rA5NRHN8,3VkHkmOtom3jM2wCu94xgzzu1d6Dn7or,14,17,9,0,9,1,3,0,39,5.571428571428571,1,0.0,0,9,0,9,17,1,0,3,0,18,21,1
8043,140381,9i8xsrw5nELlhgK7M2SPkQhTBKk2LB57,3VkHkmOtom3jM2wCu94xgzzu1d6Dn7or,26,33,13,19,10,14,3,0,92,13.142857142857142,3,0.0,13,13,17,10,20,14,2,3,0,53,39,1
8044,140387,SVwfCRY50hd9Fz0klab9XqT7QROcyhqY,3VkHkmOtom3jM2wCu94xgzzu1d6Dn7or,7,3,2,0,2,0,3,0,10,1.4285714285714286,1,0.0,0,2,0,2,3,0,0,3,0,4,6,1
8045,140390,izk8FGIuiNvH8lGG6nSF42zAQ72sY0Rq,3VkHkmOtom3jM2wCu94xgzzu1d6Dn7or,7,2,1,0,1,0,4,0,8,1.1428571428571428,1,0.0,0,1,0,1,2,0,0,4,0,2,6,1
8046,140393,slPSzcmuyMkhnrFZA6no3eGjyYYXnPVu,3VkHkmOtom3jM2wCu94xgzzu1d6Dn7or,4,3,1,0,1,4,2,0,11,1.5714285714285714,1,0.0,1,1,0,1,2,4,0,2,0,3,8,1
8047,140396,imxsKASoFyEFfbdentz1PAdwXF5L7k4s,3VkHkmOtom3jM2wCu94xgzzu1d6Dn7or,8,16,8,0,0,1,7,0,32,4.571428571428571,1,0.0,6,8,0,0,10,1,0,7,0,14,18,1
8048,140399,y7S6xhVXmXM0sU8Ve84oSvHKoWoG3N0e,3VkHkmOtom3jM2wCu94xgzzu1d6Dn7or,1,0,0,0,0,0,1,0,1,0.14285714285714285,1,0.0,0,0,0,0,0,0,0,1,0,0,1,1
8049,140405,jROOT2Cdh6avmNzUsyyyqrcbrDgJvWnY,3VkHkmOtom3jM2wCu94xgzzu1d6Dn7or,2,0,0,0,0,0,3,0,3,0.42857142857142855,2,0.0,0,0,0,0,0,0,0,3,0,0,3,1
8050,140408,D9LHDvhRktzandnhVnnKHDzcmS5ePgPp,3VkHkmOtom3jM2wCu94xgzzu1d6Dn7or,3,0,0,0,0,0,5,0,5,0.7142857142857143,1,0.0,0,0,0,0,0,0,0,5,0,0,5,1
8051,140409,iENi6w0QSJgqltqaCJ1A9qJOl3YUFZjB,3VkHkmOtom3jM2wCu94xgzzu1d6Dn7or,7,4,1,2,2,1,5,0,15,2.142857142857143,1,0.0,3,1,2,2,1,1,0,5,0,8,7,1
8052,140410,LxRDCP5Eq1P5wgmm87iPryUauJcZKIXs,3VkHkmOtom3jM2wCu94xgzzu1d6Dn7or,6,6,4,0,3,0,4,0,17,2.4285714285714284,1,0.0,0,4,0,3,6,0,0,4,0,7,10,1
8053,140413,VReX5u1i4gBRRFZaND4cgaHsptX1uAo2,3VkHkmOtom3jM2wCu94xgzzu1d6Dn7or,1,0,0,0,0,0,1,0,1,0.14285714285714285,1,0.0,0,0,0,0,0,0,0,1,0,0,1,1
8054,140415,cAt3kAq8A4nBNACWncm3aidYAQ1d8bbM,3VkHkmOtom3jM2wCu94xgzzu1d6Dn7or,4,1,1,0,0,0,3,0,5,0.7142857142857143,2,0.0,0,1,0,0,1,0,0,3,0,1,4,1
8055,140417,tX42cnMKf7McktYgW8VipQijsaArmDfp,3VkHkmOtom3jM2wCu94xgzzu1d6Dn7or,2,0,0,0,0,0,3,0,3,0.42857142857142855,1,0.0,0,0,0,0,0,0,0,3,0,0,3,1
8056,140418,gF5GHRga1xoLyKseUD8WhYIkTsxq7Q4v,3VkHkmOtom3jM2wCu94xgzzu1d6Dn7or,4,3,1,0,1,0,1,0,6,0.8571428571428571,1,0.0,1,1,0,1,2,0,0,1,0,3,3,1
8057,140420,0TbyUQxto8KKblNBjDQHPvdRtd1afpbW,3VkHkmOtom3jM2wCu94xgzzu1d6Dn7or,62,99,49,33,34,0,52,2,269,38.42857142857143,7,0.0,34,49,28,34,65,0,5,52,2,145,124,1
8058,140421,XkTNIh3vMVj2jAbMrbN7RZ4Jdx93xaiN,3VkHkmOtom3jM2wCu94xgzzu1d6Dn7or,5,3,0,0,0,0,5,1,9,1.2857142857142858,1,0.0,0,0,0,0,3,0,0,5,1,0,9,1
8059,140422,ayYwkVVyQzBhEdDijb7wioBgii6fAdFU,3VkHkmOtom3jM2wCu94xgzzu1d6Dn7or,28,67,33,13,22,22,14,0,171,24.428571428571427,2,0.0,29,33,12,22,38,22,1,14,0,96,75,0
8060,140427,umFRjjRou5lxb9SCAQ56IcPskPM6alkQ,3VkHkmOtom3jM2wCu94xgzzu1d6Dn7or,1,0,0,0,0,0,2,0,2,0.2857142857142857,2,0.0,0,0,0,0,0,0,0,2,0,0,2,0
8061,140428,HwprieYTjztd5VfZmCNFVBpTmvUmX5k0,3VkHkmOtom3jM2wCu94xgzzu1d6Dn7or,1,0,0,0,0,0,1,0,1,0.14285714285714285,1,0.0,0,0,0,0,0,0,0,1,0,0,1,1
8062,140430,ZkLDwb0oDs9fI898QcbMSCUPXt3MKl6y,3VkHkmOtom3jM2wCu94xgzzu1d6Dn7or,2,0,0,0,0,0,2,0,2,0.2857142857142857,1,0.0,0,0,0,0,0,0,0,2,0,0,2,1
8063,140432,cDw5Bih4aop3TeganFm5TP9bhOPGFGLY,3VkHkmOtom3jM2wCu94xgzzu1d6Dn7or,1,0,0,0,0,0,1,0,1,0.14285714285714285,1,0.0,0,0,0,0,0,0,0,1,0,0,1,1
8064,140435,xoyGA896PloO5EamnN9cHqF5GWwqzweS,3VkHkmOtom3jM2wCu94xgzzu1d6Dn7or,16,60,15,18,8,18,11,1,131,18.714285714285715,3,0.0,24,15,15,8,36,18,3,11,1,62,69,1
8065,140436,SM6cK5Cg2fEwre0wlT2sdrjGVJ8kdb3v,3VkHkmOtom3jM2wCu94xgzzu1d6Dn7or,9,7,3,0,0,0,13,2,25,3.5714285714285716,1,0.0,0,3,0,0,7,0,0,13,2,3,22,1
8066,140448,XnMRErhNsyt8ltc2CUas03WmPc2QKewJ,3VkHkmOtom3jM2wCu94xgzzu1d6Dn7or,6,2,0,0,0,1,11,1,15,2.142857142857143,1,0.0,0,0,0,0,2,1,0,11,1,0,15,1
8067,140449,p3DAVhqt31EYG8DAAYyA1pGMEdryuq5o,3VkHkmOtom3jM2wCu94xgzzu1d6Dn7or,8,2,1,0,1,3,7,1,15,2.142857142857143,1,0.0,0,1,0,1,2,3,0,7,1,2,13,1
8068,140459,IHvMg7Tadd9sFYx7mselBuYbwseapx3S,3VkHkmOtom3jM2wCu94xgzzu1d6Dn7or,1,0,0,0,0,0,1,0,1,0.14285714285714285,1,0.0,0,0,0,0,0,0,0,1,0,0,1,1
8069,140462,UY47Qvvj5GzzK75Hy3vx6CLdDrrD8mYX,3VkHkmOtom3jM2wCu94xgzzu1d6Dn7or,1,0,0,0,0,0,1,0,1,0.14285714285714285,1,0.0,0,0,0,0,0,0,0,1,0,0,1,1
8070,140465,yrVhoyF1ElfgK9I88jo92akJfvXA5L1B,3VkHkmOtom3jM2wCu94xgzzu1d6Dn7or,6,2,1,0,1,0,4,2,10,1.4285714285714286,1,0.0,0,1,0,1,2,0,0,4,2,2,8,1
8071,140517,Kwa203KDglCHHPWD00CQDRByzdexFKi1,7GRhBDsirIGkRZBtSMEzNTyDr2JQm4xx,1,0,0,0,0,0,1,0,1,0.14285714285714285,1,0.0,0,0,0,0,0,0,0,1,0,0,1,1
8072,140544,kdV5KOjKsWVFrLFSEW8Gh60grROKpU4O,7GRhBDsirIGkRZBtSMEzNTyDr2JQm4xx,1,0,0,0,0,0,1,0,1,0.14285714285714285,1,0.0,0,0,0,0,0,0,0,1,0,0,1,1
8073,140546,d5sj03eapUjVHG148jWqtnH3hcfDnVNW,7GRhBDsirIGkRZBtSMEzNTyDr2JQm4xx,1,0,0,0,0,0,1,0,1,0.14285714285714285,1,0.0,0,0,0,0,0,0,0,1,0,0,1,0
8074,140569,qLy5db5coyBML38ejBnFxz6JIzL7tCZq,7GRhBDsirIGkRZBtSMEzNTyDr2JQm4xx,4,0,0,0,0,0,4,0,4,0.5714285714285714,1,0.0,0,0,0,0,0,0,0,4,0,0,4,1
8075,140573,HdEsiFKzBi0FBJgauJnK9KKUc3iGfMCp,7GRhBDsirIGkRZBtSMEzNTyDr2JQm4xx,1,0,0,0,0,0,1,0,1,0.14285714285714285,1,0.0,0,0,0,0,0,0,0,1,0,0,1,1
8076,140592,fIUtty8H8VUNQ4tIszobjBNqpEeTsLt0,7GRhBDsirIGkRZBtSMEzNTyDr2JQm4xx,5,2,1,0,1,0,2,0,6,0.8571428571428571,1,0.0,0,1,0,1,2,0,0,2,0,2,4,0
8077,140604,GyWTABuPpZEqO585EnNTIpM2B2faPYN3,7GRhBDsirIGkRZBtSMEzNTyDr2JQm4xx,5,3,1,0,1,1,1,0,7,1.0,1,0.0,0,1,0,1,3,1,0,1,0,2,5,1
8078,140617,jxqH1Y0Ll1dSqJHW2X4uLUdvrbgDj0Cd,7GRhBDsirIGkRZBtSMEzNTyDr2JQm4xx,5,3,2,0,1,0,1,0,7,1.0,1,0.0,0,2,0,1,3,0,0,1,0,3,4,1
8079,140621,wy22AmUswVy7G8MnQOBBXFE3h9ovD8hW,7GRhBDsirIGkRZBtSMEzNTyDr2JQm4xx,1,0,0,0,0,0,1,0,1,0.14285714285714285,1,0.0,0,0,0,0,0,0,0,1,0,0,1,1
8080,140630,TYNUH36wQX48EZFChTHsXflAW5aqSPOs,7GRhBDsirIGkRZBtSMEzNTyDr2JQm4xx,1,0,0,0,0,0,1,0,1,0.14285714285714285,1,0.0,0,0,0,0,0,0,0,1,0,0,1,1
8081,140633,FM9F7roZRXjjLVpKJMa3bf9FDgpJfg8g,7GRhBDsirIGkRZBtSMEzNTyDr2JQm4xx,3,0,0,0,0,0,3,0,3,0.42857142857142855,1,0.0,0,0,0,0,0,0,0,3,0,0,3,1
8082,140636,2lTrV3r5iXOtPSrHMTWqISMwiAr82ziw,7GRhBDsirIGkRZBtSMEzNTyDr2JQm4xx,5,3,2,0,1,0,1,0,7,1.0,1,0.0,0,2,0,1,3,0,0,1,0,3,4,1
8083,140638,yWz2TsI3P3NeaKv8ZdOPSvyfXMqCWYbY,7GRhBDsirIGkRZBtSMEzNTyDr2JQm4xx,3,2,1,0,0,0,1,0,4,0.5714285714285714,1,0.0,0,1,0,0,2,0,0,1,0,1,3,1
8084,140644,pphlOy25ER1zV5iLb44eAIBmMhXAx725,7GRhBDsirIGkRZBtSMEzNTyDr2JQm4xx,1,0,0,0,0,0,1,0,1,0.14285714285714285,1,0.0,0,0,0,0,0,0,0,1,0,0,1,1
8085,140659,nW3nuCeVT2zzpIYCkcsoDFQTZ20yLIbg,7GRhBDsirIGkRZBtSMEzNTyDr2JQm4xx,8,6,0,0,1,0,4,1,12,1.7142857142857142,1,0.0,2,0,0,1,4,0,0,4,1,3,9,1
8086,140660,w8Pvw8WQP7Chw590vs3wc2RvlZ6Vvee0,7GRhBDsirIGkRZBtSMEzNTyDr2JQm4xx,24,21,2,18,1,0,3,0,45,6.428571428571429,3,0.0,2,2,9,1,19,0,9,3,0,14,31,0
8087,140667,yq9vHLk2LjPpNFyoMkV6FPLMiEC0nSyT,7GRhBDsirIGkRZBtSMEzNTyDr2JQm4xx,5,5,3,0,1,0,1,0,10,1.4285714285714286,1,0.0,1,3,0,1,4,0,0,1,0,5,5,1
8088,140676,TjxIzgKfqaY2A9zC1ctzzg8kJ4qt9ZS4,7GRhBDsirIGkRZBtSMEzNTyDr2JQm4xx,2,0,0,0,0,0,2,0,2,0.2857142857142857,1,0.0,0,0,0,0,0,0,0,2,0,0,2,1
8089,142574,O5yE35etOfpaMEJAOdIhiLm6o0DonEdv,5Gyp41oLVo7Gg7vF4vpmggWP5MU70QO6,9,30,9,0,0,1,7,0,47,6.714285714285714,1,0.0,8,9,0,0,22,1,0,7,0,17,30,1
8090,142576,rfWnSBHvE8yh3Tywx8mmVWeQrMCvchJc,5Gyp41oLVo7Gg7vF4vpmggWP5MU70QO6,15,24,14,15,9,0,6,0,68,9.714285714285714,2,0.0,7,14,10,9,17,0,5,6,0,40,28,1
8091,142578,PmtrviA6hBub1PH85YXqVyZgghNsuc4g,5Gyp41oLVo7Gg7vF4vpmggWP5MU70QO6,7,4,1,0,2,0,3,0,10,1.4285714285714286,2,0.0,1,1,0,2,3,0,0,3,0,4,6,1
8092,142582,uFAwXIcuVZUrzooQS3i05Ojiq5CkITl5,5Gyp41oLVo7Gg7vF4vpmggWP5MU70QO6,10,6,3,1,3,0,3,0,16,2.2857142857142856,1,0.0,2,3,1,3,4,0,0,3,0,9,7,0
8093,142586,j7bASIUMnf4CT11rRWorZg0FZhBTc03O,5Gyp41oLVo7Gg7vF4vpmggWP5MU70QO6,40,124,44,31,25,70,43,2,339,48.42857142857143,9,0.0,26,44,21,25,98,70,10,43,2,116,223,0
8094,142593,BaZtBX3UXp9aB7tEo3OUb5is15oBn3PP,5Gyp41oLVo7Gg7vF4vpmggWP5MU70QO6,18,24,8,26,5,1,9,1,74,10.571428571428571,1,0.0,14,8,18,5,10,1,8,9,1,45,29,1
8095,142595,H98Hl4y5LLB5tkiYORr7T1bKGvHA1hhn,5Gyp41oLVo7Gg7vF4vpmggWP5MU70QO6,8,17,8,0,0,0,7,0,32,4.571428571428571,3,0.0,0,8,0,0,17,0,0,7,0,8,24,1
8096,142597,64n92jE3wjhkzrUuaoAofS3KCIIoaMCe,5Gyp41oLVo7Gg7vF4vpmggWP5MU70QO6,15,12,8,0,5,1,7,1,34,4.857142857142857,2,0.0,0,8,0,5,12,1,0,7,1,13,21,1
8097,142598,flg6LuX2lo5kBneWTJPNzduxEddLhdQs,5Gyp41oLVo7Gg7vF4vpmggWP5MU70QO6,9,15,6,0,6,0,4,0,31,4.428571428571429,2,0.0,5,6,0,6,10,0,0,4,0,17,14,1
8098,142603,mXPxrsF57oO38yN9LzzHebHuhPQ79Etc,5Gyp41oLVo7Gg7vF4vpmggWP5MU70QO6,4,2,1,0,1,0,1,0,5,0.7142857142857143,1,0.0,0,1,0,1,2,0,0,1,0,2,3,1
8099,142608,2V1Q8xWPDqxMQ0PN3fgI9M2Bd7PiUfwc,5Gyp41oLVo7Gg7vF4vpmggWP5MU70QO6,31,134,30,25,14,31,37,0,271,38.714285714285715,10,0.0,44,30,15,14,90,31,10,37,0,103,168,1
8100,142620,GvoTsyIjaRWmnn2HYhInekPHBmhC8xW6,5Gyp41oLVo7Gg7vF4vpmggWP5MU70QO6,6,3,2,0,1,0,2,0,8,1.1428571428571428,1,0.0,0,2,0,1,3,0,0,2,0,3,5,1
8101,142626,t1rBPktICnweh1oj25VAsk0qY4bnF5gj,5Gyp41oLVo7Gg7vF4vpmggWP5MU70QO6,16,35,17,5,5,8,14,2,86,12.285714285714286,3,0.0,10,17,3,5,25,8,2,14,2,35,51,1
8102,142627,bzmxtcJxTZaQstaThaOLNe3q3vt8huBb,5Gyp41oLVo7Gg7vF4vpmggWP5MU70QO6,9,11,7,0,4,0,6,0,28,4.0,1,0.0,0,7,0,4,11,0,0,6,0,11,17,1
8103,142631,LGP5T3wCnpPmjUQtkBXMiMfa5aEzHypm,5Gyp41oLVo7Gg7vF4vpmggWP5MU70QO6,10,18,5,2,5,0,2,0,32,4.571428571428571,1,0.0,8,5,1,5,10,0,1,2,0,19,13,1
8104,142633,IcRcmfd0Ewe0HA0CWiqOBOh4Xg0NgKk2,5Gyp41oLVo7Gg7vF4vpmggWP5MU70QO6,7,4,0,0,0,1,11,1,17,2.4285714285714284,1,0.0,0,0,0,0,4,1,0,11,1,0,17,1
8105,142636,KHfJKluR4nAXY9ajkRhOmddDvD3PKXvN,5Gyp41oLVo7Gg7vF4vpmggWP5MU70QO6,12,15,10,0,4,0,5,0,34,4.857142857142857,2,0.0,2,10,0,4,13,0,0,5,0,16,18,1
8106,142638,YK93a5SKUh9rXdkIcxUKSHL7xQd5iQ0n,5Gyp41oLVo7Gg7vF4vpmggWP5MU70QO6,4,3,0,0,0,0,1,0,4,0.5714285714285714,1,0.0,0,0,0,0,3,0,0,1,0,0,4,1
8107,142640,k6VE25IacC5A5bOtFadAjL3Xm1pymwJc,5Gyp41oLVo7Gg7vF4vpmggWP5MU70QO6,11,35,4,0,0,27,17,5,88,12.571428571428571,1,0.0,4,4,0,0,31,27,0,17,5,8,80,1
8108,142641,ppvrg0GpVdMJ9ddQ6kjPpUNwltJ5sR5M,5Gyp41oLVo7Gg7vF4vpmggWP5MU70QO6,4,2,1,0,1,0,1,0,5,0.7142857142857143,1,0.0,0,1,0,1,2,0,0,1,0,2,3,1
8109,142644,fB3DyOy7bKYSKuxXRQXJzFHF37cWFGQ5,5Gyp41oLVo7Gg7vF4vpmggWP5MU70QO6,6,1,1,0,1,0,6,0,9,1.2857142857142858,1,0.0,0,1,0,1,1,0,0,6,0,2,7,1
8110,142646,sfqvF95To7i1ThhKyLc0mACXepDNEYL4,5Gyp41oLVo7Gg7vF4vpmggWP5MU70QO6,7,6,3,0,2,0,3,0,14,2.0,1,0.0,0,3,0,2,6,0,0,3,0,5,9,1
8111,142647,nYs1sbg1xDvHBSjwMJsmfzLojMFX3FXF,5Gyp41oLVo7Gg7vF4vpmggWP5MU70QO6,7,5,2,0,2,1,5,1,16,2.2857142857142856,1,0.0,1,2,0,2,4,1,0,5,1,5,11,1
8112,142649,dmS1uSIt3rluUyxfvsaENZe28gYYDvht,5Gyp41oLVo7Gg7vF4vpmggWP5MU70QO6,4,3,1,0,1,0,2,0,7,1.0,1,0.0,0,1,0,1,3,0,0,2,0,2,5,1
8113,142651,dpHLF21uvMbokNNTJHdbSyHoiwNjC5Qc,5Gyp41oLVo7Gg7vF4vpmggWP5MU70QO6,8,6,4,0,3,0,3,0,16,2.2857142857142856,1,0.0,0,4,0,3,6,0,0,3,0,7,9,1
8114,142653,0LwDHFmAVNrLRObswUadijdXXF0SPVCN,5Gyp41oLVo7Gg7vF4vpmggWP5MU70QO6,1,0,0,0,0,0,2,0,2,0.2857142857142857,1,0.0,0,0,0,0,0,0,0,2,0,0,2,1
8115,142657,Qe9YJgJ8XzQGeKrwp0Jj4cvm7JZeGtag,5Gyp41oLVo7Gg7vF4vpmggWP5MU70QO6,26,29,16,40,6,5,9,0,105,15.0,3,0.0,5,16,31,6,24,5,9,9,0,58,47,1
8116,142659,8pUP3PC2D5o62fUt3uU0gxVoyZnQmoiT,5Gyp41oLVo7Gg7vF4vpmggWP5MU70QO6,10,5,4,0,4,0,1,0,14,2.0,1,0.0,0,4,0,4,5,0,0,1,0,8,6,1
8117,142660,IEfUasRNK7F4OXmh9ZRgY5RLlk7j6VcY,5Gyp41oLVo7Gg7vF4vpmggWP5MU70QO6,7,6,4,0,3,0,2,0,15,2.142857142857143,2,0.0,0,4,0,3,6,0,0,2,0,7,8,0
8118,142662,Crk1vy7eBi1Xl2Uarp8ep82lR1YagTJM,5Gyp41oLVo7Gg7vF4vpmggWP5MU70QO6,12,42,9,3,0,1,8,0,63,9.0,1,0.0,7,9,2,0,35,1,1,8,0,18,45,1
8119,142664,L8p6pEudWnyObOwuFgS2uvmaDIutjOXt,5Gyp41oLVo7Gg7vF4vpmggWP5MU70QO6,5,3,2,0,2,0,2,0,9,1.2857142857142858,1,0.0,0,2,0,2,3,0,0,2,0,4,5,1
8120,142666,uZgEpWXy2F5yap0vusNOagcr5ERWbtuv,5Gyp41oLVo7Gg7vF4vpmggWP5MU70QO6,1,0,0,0,0,0,1,0,1,0.14285714285714285,1,0.0,0,0,0,0,0,0,0,1,0,0,1,1
8121,142668,NuHXRw8LsHOzEf8UzxgphWPT1nN9lpjp,5Gyp41oLVo7Gg7vF4vpmggWP5MU70QO6,10,5,4,0,4,0,1,0,14,2.0,1,0.0,0,4,0,4,5,0,0,1,0,8,6,1
8122,142669,gTPCI6huAUuiP7nPIsLqRx5IrfMPTn4w,5Gyp41oLVo7Gg7vF4vpmggWP5MU70QO6,10,5,3,0,2,5,5,3,23,3.2857142857142856,1,0.0,0,3,0,2,5,5,0,5,3,5,18,1
8123,142670,WIrTjpVCzz7XcODBSnhpv1IaMIHCXUkV,5Gyp41oLVo7Gg7vF4vpmggWP5MU70QO6,6,4,2,0,2,0,1,0,9,1.2857142857142858,1,0.0,1,2,0,2,3,0,0,1,0,5,4,1
8124,142677,c8WJAdYLV71mOx4ZXSglpCNd0dBUR3Om,5Gyp41oLVo7Gg7vF4vpmggWP5MU70QO6,4,2,1,0,1,0,1,0,5,0.7142857142857143,1,0.0,0,1,0,1,2,0,0,1,0,2,3,1
8125,142682,sCyMhRrGl3ADQMkJt03FjWLj6QvMIH5j,5Gyp41oLVo7Gg7vF4vpmggWP5MU70QO6,14,16,7,12,3,0,1,0,39,5.571428571428571,1,0.0,5,7,9,3,11,0,3,1,0,24,15,1
8126,142684,bkpX3X63wjQnlz6DxzQQEHE4mDg6F4fK,5Gyp41oLVo7Gg7vF4vpmggWP5MU70QO6,13,7,5,2,3,0,3,1,21,3.0,1,0.0,1,5,1,3,6,0,1,3,1,10,11,1
8127,142685,ALJrdfxhuEJKAJDKiZZsQHg5OqngoK94,5Gyp41oLVo7Gg7vF4vpmggWP5MU70QO6,6,4,1,0,1,0,2,0,8,1.1428571428571428,1,0.0,0,1,0,1,4,0,0,2,0,2,6,1
8128,142686,OqZf3fP0SX8loEXLDfHJedTy0cDaEAtU,5Gyp41oLVo7Gg7vF4vpmggWP5MU70QO6,9,3,2,0,2,2,4,1,14,2.0,1,0.0,0,2,0,2,3,2,0,4,1,4,10,1
8129,142691,CHZU2xxyCnP9nRERNMfZvqrPWpUYtrOe,5Gyp41oLVo7Gg7vF4vpmggWP5MU70QO6,8,13,5,0,5,0,4,0,27,3.857142857142857,2,0.0,2,5,0,5,11,0,0,4,0,12,15,1
8130,142694,zz36zJCSJsYqPJvDq6cIEQUfbW5SvzyM,5Gyp41oLVo7Gg7vF4vpmggWP5MU70QO6,9,3,2,0,2,0,5,1,13,1.8571428571428572,1,0.0,0,2,0,2,3,0,0,5,1,4,9,1
8131,142697,Ss0RSYchYhP0t3zTLYiGe5TYwAwk16bi,5Gyp41oLVo7Gg7vF4vpmggWP5MU70QO6,5,1,1,0,1,1,4,0,8,1.1428571428571428,1,0.0,0,1,0,1,1,1,0,4,0,2,6,1
8132,142699,XDPvGyFLLEYwbNEQik2MM4yiADs5rrYJ,5Gyp41oLVo7Gg7vF4vpmggWP5MU70QO6,17,40,16,20,14,0,8,0,98,14.0,4,0.0,16,16,13,14,24,0,7,8,0,59,39,1
8133,142700,jvPaH5IzRaoEL7vH3sZhzdSWAjz8Y84y,5Gyp41oLVo7Gg7vF4vpmggWP5MU70QO6,11,26,11,12,0,1,4,0,54,7.714285714285714,1,0.0,7,11,8,0,19,1,4,4,0,26,28,1
8134,142701,HhvQOu36AUwxS3HBXRWzCwV2HEANGBv6,5Gyp41oLVo7Gg7vF4vpmggWP5MU70QO6,22,19,8,50,0,0,7,0,84,12.0,2,0.0,11,8,39,0,8,0,11,7,0,58,26,1
8135,142702,xc941KV31IdfcQUaf6U9BbTDKPbt0s2i,5Gyp41oLVo7Gg7vF4vpmggWP5MU70QO6,5,4,2,0,1,0,1,0,8,1.1428571428571428,1,0.0,0,2,0,1,4,0,0,1,0,3,5,1
8136,142704,gpH2Monf32bCBbR9eOiusBymAeQmysVf,5Gyp41oLVo7Gg7vF4vpmggWP5MU70QO6,12,21,5,8,3,0,14,0,51,7.285714285714286,2,0.0,9,5,6,3,12,0,2,14,0,23,28,1
8137,142705,5wfiCJMdbkN7MkoUGvo3cfz8jV3jCktA,5Gyp41oLVo7Gg7vF4vpmggWP5MU70QO6,8,4,3,0,2,0,2,0,11,1.5714285714285714,1,0.0,0,3,0,2,4,0,0,2,0,5,6,1
8138,142707,uactsyQE35ggqrf8jGo8BD22JXCOvko5,5Gyp41oLVo7Gg7vF4vpmggWP5MU70QO6,9,16,6,10,4,0,2,0,38,5.428571428571429,1,0.0,5,6,7,4,11,0,3,2,0,22,16,0
8139,142709,QRq9SneqdOEdNrPCbzGfNOJsUrpMzzSX,5Gyp41oLVo7Gg7vF4vpmggWP5MU70QO6,10,10,3,0,1,2,5,0,21,3.0,1,0.0,0,3,0,1,10,2,0,5,0,4,17,1
8140,142710,dSuuhuijJZPTkTnHpEnWdbOsESCF7Ilu,5Gyp41oLVo7Gg7vF4vpmggWP5MU70QO6,6,4,2,0,1,0,1,0,8,1.1428571428571428,1,0.0,0,2,0,1,4,0,0,1,0,3,5,1
8141,142715,aTM8g4rbVmgmqSlbdFoile3z2S6Tt4FV,5Gyp41oLVo7Gg7vF4vpmggWP5MU70QO6,5,5,2,0,1,0,1,0,9,1.2857142857142858,1,0.0,2,2,0,1,3,0,0,1,0,5,4,1
8142,142717,Vq01Qe9ezKRBh4OctFgKtJTVZAI04MYh,5Gyp41oLVo7Gg7vF4vpmggWP5MU70QO6,20,18,9,8,5,6,17,0,63,9.0,3,0.0,7,9,6,5,11,6,2,17,0,27,36,1
8143,142718,S8UBDpVVq71qFIkAG8NIrDJCPw9bOJC9,5Gyp41oLVo7Gg7vF4vpmggWP5MU70QO6,30,33,18,8,12,2,9,1,83,11.857142857142858,5,0.0,8,18,6,12,25,2,2,9,1,44,39,0
8144,142721,MVweobqKO6VRipppxOBKuMyARMMpjzND,5Gyp41oLVo7Gg7vF4vpmggWP5MU70QO6,6,5,3,0,2,0,3,0,13,1.8571428571428572,1,0.0,0,3,0,2,5,0,0,3,0,5,8,1
8145,142724,Efy5POBnAHZiNqoN59CVRlkZH9Pz7rCY,5Gyp41oLVo7Gg7vF4vpmggWP5MU70QO6,10,6,3,3,2,1,4,0,19,2.7142857142857144,1,0.0,3,3,2,2,3,1,1,4,0,10,9,1
8146,142727,J92sYRLsoMdDD2Az5iaVe0NUZaKjSMyZ,5Gyp41oLVo7Gg7vF4vpmggWP5MU70QO6,6,3,2,0,2,0,3,0,10,1.4285714285714286,1,0.0,0,2,0,2,3,0,0,3,0,4,6,1
8147,142733,TcRKIMJqRfdjM97Y7fCXlsxmWnhndgv2,5Gyp41oLVo7Gg7vF4vpmggWP5MU70QO6,4,7,3,0,0,0,1,0,11,1.5714285714285714,1,0.0,2,3,0,0,5,0,0,1,0,5,6,1
8148,142734,PDl4enofGH9bhdY5M64G2uXNLw0R8XVT,5Gyp41oLVo7Gg7vF4vpmggWP5MU70QO6,19,20,9,12,6,8,5,1,61,8.714285714285714,2,0.0,8,9,8,6,12,8,4,5,1,31,30,1
8149,142735,MKo7OYMhbYLjj1dv71j15SfNzO14s5yL,5Gyp41oLVo7Gg7vF4vpmggWP5MU70QO6,9,9,4,0,2,2,14,2,33,4.714285714285714,3,0.0,0,4,0,2,9,2,0,14,2,6,27,1
8150,142738,GzdkdndaIrm7p0iy7XY8ZrMeUOKthJaf,5Gyp41oLVo7Gg7vF4vpmggWP5MU70QO6,5,2,1,0,1,0,2,0,6,0.8571428571428571,1,0.0,0,1,0,1,2,0,0,2,0,2,4,1
8151,142741,jFYWygr5nLqLhHkXltZRkT0S1zQoLEVR,5Gyp41oLVo7Gg7vF4vpmggWP5MU70QO6,10,15,7,0,4,0,8,0,34,4.857142857142857,1,0.0,4,7,0,4,11,0,0,8,0,15,19,1
8152,142744,8ywFLY0dric1Gqf9TeDpbNAAWX5EK1Et,5Gyp41oLVo7Gg7vF4vpmggWP5MU70QO6,27,45,19,24,4,0,13,1,106,15.142857142857142,4,0.0,20,19,17,4,25,0,7,13,1,60,46,1
8153,142747,1ecyEsbpVIEWGslkFzQmwDlIWRkggyyT,5Gyp41oLVo7Gg7vF4vpmggWP5MU70QO6,6,4,2,0,2,0,1,0,9,1.2857142857142858,1,0.0,0,2,0,2,4,0,0,1,0,4,5,1
8154,142749,AOLanxdaj25VHPpIoAr4JHOLnbRwmUeC,5Gyp41oLVo7Gg7vF4vpmggWP5MU70QO6,15,25,14,0,4,25,24,1,93,13.285714285714286,3,0.0,1,14,0,4,24,25,0,24,1,19,74,1
8155,142750,Os1M69LV2IV3cvo61TLi4oBx4zb5NgjR,5Gyp41oLVo7Gg7vF4vpmggWP5MU70QO6,6,4,3,0,3,0,1,0,11,1.5714285714285714,1,0.0,0,3,0,3,4,0,0,1,0,6,5,1
8156,142755,JijbcO7wMC3H8jX3AIAMeKa5y6Yx30jd,5Gyp41oLVo7Gg7vF4vpmggWP5MU70QO6,15,23,11,0,1,7,8,1,51,7.285714285714286,3,0.0,4,11,0,1,19,7,0,8,1,16,35,1
8157,142758,yrhM0f9eUaBZaXRFDDEWObfycFYGq3Vg,5Gyp41oLVo7Gg7vF4vpmggWP5MU70QO6,4,2,1,0,1,0,1,0,5,0.7142857142857143,1,0.0,0,1,0,1,2,0,0,1,0,2,3,1
8158,142760,UAggpZPNL1hZ0kLwEDSUplsT3ghk1d6y,5Gyp41oLVo7Gg7vF4vpmggWP5MU70QO6,13,11,4,3,3,1,4,1,27,3.857142857142857,2,0.0,4,4,2,3,7,1,1,4,1,13,14,1
8159,142762,B47i3EzhxUZkTowzEjHth2XT13SO0c2c,5Gyp41oLVo7Gg7vF4vpmggWP5MU70QO6,9,10,4,0,4,0,2,0,20,2.857142857142857,2,0.0,4,4,0,4,6,0,0,2,0,12,8,1
8160,142764,as39QGy2Taol6QjOlHPo3H1pEHHUWJAb,5Gyp41oLVo7Gg7vF4vpmggWP5MU70QO6,13,14,5,10,3,2,4,3,41,5.857142857142857,1,0.0,4,5,7,3,10,2,3,4,3,19,22,1
8161,142770,0ZCmmgRqSZJZrAmOpx3kfkWQLZuDtvzs,5Gyp41oLVo7Gg7vF4vpmggWP5MU70QO6,6,3,1,0,0,10,4,1,19,2.7142857142857144,1,0.0,0,1,0,0,3,10,0,4,1,1,18,1
8162,142773,C9nwYY5vil88Qp4KSoVNYtbqZjoJ3YE9,5Gyp41oLVo7Gg7vF4vpmggWP5MU70QO6,17,33,15,0,7,11,11,2,79,11.285714285714286,1,0.0,3,15,0,7,30,11,0,11,2,25,54,0
8163,142774,9k3wgqD1eLHF7SKMxPzLDLpWfBNrOuvD,5Gyp41oLVo7Gg7vF4vpmggWP5MU70QO6,6,7,3,0,2,0,1,0,13,1.8571428571428572,1,0.0,1,3,0,2,6,0,0,1,0,6,7,1
8164,142779,U9fRwgomIJaGo9IN517YcyMvUgckUdad,5Gyp41oLVo7Gg7vF4vpmggWP5MU70QO6,4,3,2,0,0,0,1,0,6,0.8571428571428571,1,0.0,0,2,0,0,3,0,0,1,0,2,4,1
8165,142782,ATZroMPn5aj5E55u4Qf7bbAE17kAj4Ek,5Gyp41oLVo7Gg7vF4vpmggWP5MU70QO6,11,9,6,2,4,0,2,0,23,3.2857142857142856,1,0.0,1,6,1,4,8,0,1,2,0,12,11,0
8166,142786,qQXHaDv5XCxR4Th7bsEbu6dhUGiULo1i,5Gyp41oLVo7Gg7vF4vpmggWP5MU70QO6,9,9,6,0,4,0,4,0,23,3.2857142857142856,2,0.0,0,6,0,4,9,0,0,4,0,10,13,1
8167,142787,FeXF4CdXo9VnZHL5ropZVBUAaN6Jph36,5Gyp41oLVo7Gg7vF4vpmggWP5MU70QO6,4,2,1,0,1,0,1,0,5,0.7142857142857143,1,0.0,0,1,0,1,2,0,0,1,0,2,3,1
8168,142788,ISQViQMMbYMxUymj0UzcgKDBKu1RpFFM,5Gyp41oLVo7Gg7vF4vpmggWP5MU70QO6,13,17,7,10,4,0,3,0,41,5.857142857142857,3,0.0,6,7,6,4,11,0,4,3,0,23,18,0
8169,142790,3WVNf1jvl5kky7gDcuyuchNBzYM1t9Ux,5Gyp41oLVo7Gg7vF4vpmggWP5MU70QO6,28,67,32,19,26,0,32,0,176,25.142857142857142,8,0.0,32,32,14,26,35,0,5,32,0,104,72,1
8170,142791,xxrOGCGHttgspdn3oyUYezbmYdy3uvTL,5Gyp41oLVo7Gg7vF4vpmggWP5MU70QO6,5,2,1,0,1,0,2,0,6,0.8571428571428571,1,0.0,0,1,0,1,2,0,0,2,0,2,4,1
8171,142793,zMKsMOqXrTxUx07QbehwPdsXhKg2VMjk,5Gyp41oLVo7Gg7vF4vpmggWP5MU70QO6,19,34,5,0,11,0,6,0,56,8.0,2,0.0,9,5,0,11,25,0,0,6,0,25,31,1
8172,142794,hMpjQWUM9HC9Xyo28mzOKcAfAW0WtZ6L,5Gyp41oLVo7Gg7vF4vpmggWP5MU70QO6,7,5,2,0,2,0,3,0,12,1.7142857142857142,1,0.0,0,2,0,2,5,0,0,3,0,4,8,1
8173,142795,M8C9BDFICk4ida59GU0jjp556zazDEi1,5Gyp41oLVo7Gg7vF4vpmggWP5MU70QO6,9,12,4,0,3,0,6,0,25,3.5714285714285716,3,0.0,1,4,0,3,11,0,0,6,0,8,17,1
8174,142801,3ZzhbGHk0AMavVBVS0pUAaZvWnLoQODp,5Gyp41oLVo7Gg7vF4vpmggWP5MU70QO6,7,9,2,0,2,0,3,0,16,2.2857142857142856,2,0.0,0,2,0,2,9,0,0,3,0,4,12,1
8175,142802,38KASKYfDNVp59SAe2YkbN8MkYWzQ9xL,5Gyp41oLVo7Gg7vF4vpmggWP5MU70QO6,13,8,4,0,4,0,12,0,28,4.0,2,0.0,3,4,0,4,5,0,0,12,0,11,17,1
8176,142803,Nqpr56I7BC3ItaUSHAdAOInyCMxfFx8M,5Gyp41oLVo7Gg7vF4vpmggWP5MU70QO6,2,0,0,0,0,0,2,0,2,0.2857142857142857,1,0.0,0,0,0,0,0,0,0,2,0,0,2,1
8177,142807,UyGxbLGpzWj9nUt4zlv3JQ4QXzLJV2bP,5Gyp41oLVo7Gg7vF4vpmggWP5MU70QO6,9,7,3,3,2,0,1,0,16,2.2857142857142856,1,0.0,3,3,2,2,4,0,1,1,0,10,6,1
8178,142808,MW8Y3n3B2StCbZQXTLnrtO8wwOpI9WF8,5Gyp41oLVo7Gg7vF4vpmggWP5MU70QO6,12,10,5,0,4,11,5,1,36,5.142857142857143,1,0.0,3,5,0,4,7,11,0,5,1,12,24,1
8179,142812,bNNfoay22NeH9BCitqHR3TXn5OQQC6UY,5Gyp41oLVo7Gg7vF4vpmggWP5MU70QO6,19,20,8,8,6,2,7,1,52,7.428571428571429,1,0.0,10,8,5,6,10,2,3,7,1,29,23,1
8180,142813,B7F3lTeILE76KsZtWoqyvqR22YUe8YeJ,5Gyp41oLVo7Gg7vF4vpmggWP5MU70QO6,5,2,1,0,1,0,3,0,7,1.0,1,0.0,0,1,0,1,2,0,0,3,0,2,5,1
8181,142824,IF3MFybGElafhX7jbbDfSBov8mktXBWH,5Gyp41oLVo7Gg7vF4vpmggWP5MU70QO6,10,10,4,3,2,0,7,0,26,3.7142857142857144,1,0.0,5,4,2,2,5,0,1,7,0,13,13,1
8182,142828,VG95oODwNEkjCI3szesfLNqRNyP4cVEb,5Gyp41oLVo7Gg7vF4vpmggWP5MU70QO6,14,17,0,18,2,0,4,0,41,5.857142857142857,4,0.0,3,0,12,2,14,0,6,4,0,17,24,0
8183,142830,8hq02goyJj4fNhknuQanzJ3MeLr8HN04,5Gyp41oLVo7Gg7vF4vpmggWP5MU70QO6,5,2,1,0,1,0,3,0,7,1.0,2,0.0,0,1,0,1,2,0,0,3,0,2,5,1
8184,142833,8JlRR0J0RUyxysqoH6sZLq5xVrlZWRp1,5Gyp41oLVo7Gg7vF4vpmggWP5MU70QO6,7,9,2,5,1,0,2,0,19,2.7142857142857144,1,0.0,6,2,3,1,3,0,2,2,0,12,7,1
8185,142834,nI2lsokWUEO6650kzyzTT0eGvDlAlyHa,5Gyp41oLVo7Gg7vF4vpmggWP5MU70QO6,7,5,3,0,2,0,1,0,11,1.5714285714285714,1,0.0,0,3,0,2,5,0,0,1,0,5,6,1
8186,142835,caAgMtwKkAQFiS6DHpWiCegc918t4IRr,5Gyp41oLVo7Gg7vF4vpmggWP5MU70QO6,8,16,11,2,1,0,3,0,33,4.714285714285714,2,0.0,1,11,1,1,15,0,1,3,0,14,19,1
8187,142837,RUAH37bGyuBeXQjBS6NwapgrBGkrBGTv,5Gyp41oLVo7Gg7vF4vpmggWP5MU70QO6,13,12,5,2,5,2,6,1,33,4.714285714285714,1,0.0,5,5,1,5,7,2,1,6,1,16,17,1
8188,142839,pMaElq6QfFkzEK9UpuWlI5Z36ojw0yzC,5Gyp41oLVo7Gg7vF4vpmggWP5MU70QO6,10,10,2,13,3,0,1,0,29,4.142857142857143,1,0.0,6,2,9,3,4,0,4,1,0,20,9,1
8189,142841,r7EcjZitzTY8Tailt2jIOrxuI3cJdJPM,5Gyp41oLVo7Gg7vF4vpmggWP5MU70QO6,10,16,8,0,2,1,4,0,31,4.428571428571429,1,0.0,0,8,0,2,16,1,0,4,0,10,21,1
8190,142842,Myt16IMVzxwRTOZLb6UMMq0vewiso7Vm,5Gyp41oLVo7Gg7vF4vpmggWP5MU70QO6,1,0,0,0,0,0,1,0,1,0.14285714285714285,1,0.0,0,0,0,0,0,0,0,1,0,0,1,1
8191,142844,bgBEVIT7lED5jwl9T1xbuywAm7JQXaqp,5Gyp41oLVo7Gg7vF4vpmggWP5MU70QO6,6,3,0,0,2,0,1,0,6,0.8571428571428571,1,0.0,0,0,0,2,3,0,0,1,0,2,4,1
8192,142847,rLOm82ZYOyQDfpgqtJlmBnLMVDmBeDjH,5Gyp41oLVo7Gg7vF4vpmggWP5MU70QO6,8,5,3,0,2,0,5,1,16,2.2857142857142856,2,0.0,0,3,0,2,5,0,0,5,1,5,11,1
8193,142848,KNZBV0Gkhm2LFK5DvbdYNqZKr7lI7OII,5Gyp41oLVo7Gg7vF4vpmggWP5MU70QO6,6,3,2,0,2,0,1,0,8,1.1428571428571428,1,0.0,0,2,0,2,3,0,0,1,0,4,4,1
8194,142849,G8UuvQJgC9RedtA6dEqqEDxZX9cP7O2N,5Gyp41oLVo7Gg7vF4vpmggWP5MU70QO6,15,32,12,16,10,3,5,0,78,11.142857142857142,2,0.0,12,12,11,10,20,3,5,5,0,45,33,1
8195,142850,6ZT2wBcC2W2UO1T7QWFqFW30I0k8Ws5P,5Gyp41oLVo7Gg7vF4vpmggWP5MU70QO6,5,5,4,0,0,0,5,0,14,2.0,2,0.0,0,4,0,0,5,0,0,5,0,4,10,1
8196,142854,lqWDQbrIKDwpIQudqD9IJI01BXWfaIuR,5Gyp41oLVo7Gg7vF4vpmggWP5MU70QO6,10,12,3,0,4,2,2,0,23,3.2857142857142856,1,0.0,4,3,0,4,8,2,0,2,0,11,12,1
8197,142865,gGlGKQGgPdzw79rnBTsHW2kQh2pkhlVW,5Gyp41oLVo7Gg7vF4vpmggWP5MU70QO6,6,3,2,0,2,0,2,0,9,1.2857142857142858,2,0.0,0,2,0,2,3,0,0,2,0,4,5,1
8198,142872,pmCkVIwVheDfGvtgMxp3hRlMszaozL1q,5Gyp41oLVo7Gg7vF4vpmggWP5MU70QO6,6,10,2,0,0,0,2,0,14,2.0,2,0.0,1,2,0,0,9,0,0,2,0,3,11,1
8199,142874,L0BCRsOFVFux7H1DqTlmsPHtynyE6PWh,5Gyp41oLVo7Gg7vF4vpmggWP5MU70QO6,4,2,1,0,1,0,1,0,5,0.7142857142857143,1,0.0,0,1,0,1,2,0,0,1,0,2,3,1
8200,142876,ZWuMpyI0ifOpLKV6A0au7a8XxkBSjmW8,5Gyp41oLVo7Gg7vF4vpmggWP5MU70QO6,7,3,2,0,2,0,2,0,9,1.2857142857142858,1,0.0,0,2,0,2,3,0,0,2,0,4,5,1
8201,142878,wPSiEPK9Fi84VB7By341ddDHJUpDgRi3,5Gyp41oLVo7Gg7vF4vpmggWP5MU70QO6,8,6,4,0,3,0,2,0,15,2.142857142857143,1,0.0,0,4,0,3,6,0,0,2,0,7,8,1
8202,142879,p0fw4v0FzqDHoIprXWv2PhAw9MEKisrS,5Gyp41oLVo7Gg7vF4vpmggWP5MU70QO6,4,2,1,0,0,87,11,0,101,14.428571428571429,5,0.0,0,1,0,0,2,87,0,11,0,1,100,0
8203,142881,6lxqO6gucEPo0iFbRZ4Psmditgm2GZdr,5Gyp41oLVo7Gg7vF4vpmggWP5MU70QO6,9,14,9,0,0,0,5,0,28,4.0,2,0.0,1,9,0,0,13,0,0,5,0,10,18,1
8204,142883,j8UeSZFNUzzfzk2DFBytx4Rkr6FApV94,5Gyp41oLVo7Gg7vF4vpmggWP5MU70QO6,8,6,4,0,3,0,4,0,17,2.4285714285714284,1,0.0,0,4,0,3,6,0,0,4,0,7,10,1
8205,142892,suiW3DnmY7IjzxYGHIbP9XZX1wmuymDO,5Gyp41oLVo7Gg7vF4vpmggWP5MU70QO6,12,16,9,4,5,3,5,1,43,6.142857142857143,2,0.0,3,9,3,5,13,3,1,5,1,20,23,1
8206,142905,KsA8ooBzwXieh7lKUkWn3INwNv7tnXGE,5Gyp41oLVo7Gg7vF4vpmggWP5MU70QO6,11,23,9,0,4,17,9,0,62,8.857142857142858,2,0.0,0,9,0,4,23,17,0,9,0,13,49,1
8207,142915,xqJQGPcuFpaDvsnvTKjqo4rGu7icAOJH,5Gyp41oLVo7Gg7vF4vpmggWP5MU70QO6,7,4,3,0,3,0,3,0,13,1.8571428571428572,1,0.0,0,3,0,3,4,0,0,3,0,6,7,1
8208,142916,OGWTywqD3YlVP7vYo3Y0izf1JAFxQTll,5Gyp41oLVo7Gg7vF4vpmggWP5MU70QO6,33,45,24,17,13,8,15,3,125,17.857142857142858,6,0.0,16,24,12,13,29,8,5,15,3,65,60,1
8209,142927,SNU33gChMp1lTvMCw8gcdFroNytSgZDI,5Gyp41oLVo7Gg7vF4vpmggWP5MU70QO6,10,5,2,0,1,1,9,3,21,3.0,2,0.0,0,2,0,1,5,1,0,9,3,3,18,1
8210,142930,cnIZtD2TkFxg65gflPFMb4t2kmxrdp9X,5Gyp41oLVo7Gg7vF4vpmggWP5MU70QO6,1,0,0,0,0,0,1,0,1,0.14285714285714285,1,0.0,0,0,0,0,0,0,0,1,0,0,1,1
8211,142932,pfDFnPhEzJOaJRRGHUyMyZvpV64BRVF5,5Gyp41oLVo7Gg7vF4vpmggWP5MU70QO6,15,34,3,3,1,26,9,1,77,11.0,2,0.0,4,3,2,1,30,26,1,9,1,10,67,0
8212,142935,FM9F7roZRXjjLVpKJMa3bf9FDgpJfg8g,5Gyp41oLVo7Gg7vF4vpmggWP5MU70QO6,9,9,6,0,4,1,3,0,23,3.2857142857142856,2,0.0,1,6,0,4,8,1,0,3,0,11,12,1
8213,142949,5b7vUXmWhN89ZGFsAOK97Z2P0dkwpDxp,5Gyp41oLVo7Gg7vF4vpmggWP5MU70QO6,6,2,1,0,1,2,4,0,10,1.4285714285714286,1,0.0,0,1,0,1,2,2,0,4,0,2,8,1
8214,142967,g6loW2VoON94gkUidTjl3Rc73OlFLAiK,5Gyp41oLVo7Gg7vF4vpmggWP5MU70QO6,17,18,8,4,5,18,10,1,64,9.142857142857142,2,0.0,4,8,2,5,14,18,2,10,1,19,45,1
8215,142975,7qsaEci0HIhmesmJa8LcxLiADi1nROZ7,5Gyp41oLVo7Gg7vF4vpmggWP5MU70QO6,14,22,10,10,6,0,3,0,51,7.285714285714286,3,0.0,6,10,7,6,16,0,3,3,0,29,22,1
8216,142984,BH0g3wVCilU6qeEv507COxWXunEVyQCt,5Gyp41oLVo7Gg7vF4vpmggWP5MU70QO6,14,36,13,0,4,0,7,0,60,8.571428571428571,5,0.0,9,13,0,4,27,0,0,7,0,26,34,1
8217,142987,MvjFU26ODt0ILsX9Hjqccm6mRkn5hHAE,5Gyp41oLVo7Gg7vF4vpmggWP5MU70QO6,1,0,0,0,0,0,1,0,1,0.14285714285714285,1,0.0,0,0,0,0,0,0,0,1,0,0,1,1
8218,142991,Dp3MToYleLMspzHaSQGdnKc9ndk6SXb6,5Gyp41oLVo7Gg7vF4vpmggWP5MU70QO6,10,21,6,2,2,0,7,0,38,5.428571428571429,4,0.0,5,6,1,2,16,0,1,7,0,14,24,1
8219,142994,un94uG6qteutb9C79ekNZ3A4PBcceSuD,5Gyp41oLVo7Gg7vF4vpmggWP5MU70QO6,1,0,0,0,0,0,2,0,2,0.2857142857142857,1,0.0,0,0,0,0,0,0,0,2,0,0,2,1
8220,143001,6s7Fztpt96rPS7sygATaH1vhQWiiu6TM,5Gyp41oLVo7Gg7vF4vpmggWP5MU70QO6,5,3,2,0,2,0,3,0,10,1.4285714285714286,1,0.0,0,2,0,2,3,0,0,3,0,4,6,1
8221,143009,SDnmOhyhUqRdpMYDOgOHLbgShn3XKHMw,5Gyp41oLVo7Gg7vF4vpmggWP5MU70QO6,6,3,2,0,2,0,1,0,8,1.1428571428571428,1,0.0,0,2,0,2,3,0,0,1,0,4,4,1
8222,143011,m19Z5qXkBWG6glBh43LnAgq9wHnncSxM,5Gyp41oLVo7Gg7vF4vpmggWP5MU70QO6,9,9,1,0,2,0,1,0,13,1.8571428571428572,1,0.0,3,1,0,2,6,0,0,1,0,6,7,1
8223,143012,lCjHVTs2UO2dfUph2RAs3RCnw4I8AAnn,5Gyp41oLVo7Gg7vF4vpmggWP5MU70QO6,1,0,0,0,0,0,1,0,1,0.14285714285714285,1,0.0,0,0,0,0,0,0,0,1,0,0,1,1
8224,143023,Dpj1ute7yeokptEET2ZfYuubDiXNwLXm,5Gyp41oLVo7Gg7vF4vpmggWP5MU70QO6,14,23,12,0,7,9,12,1,64,9.142857142857142,3,0.0,1,12,0,7,22,9,0,12,1,20,44,1
8225,143027,2fqSxqAVilSfIg4sQ6fD6J1JY6ZshTCe,5Gyp41oLVo7Gg7vF4vpmggWP5MU70QO6,8,2,2,0,2,2,4,3,15,2.142857142857143,1,0.0,0,2,0,2,2,2,0,4,3,4,11,1
8226,143028,YHgJ6X0orrZrcgeXM2oJnYKidrTwftvX,5Gyp41oLVo7Gg7vF4vpmggWP5MU70QO6,15,39,18,5,2,27,9,1,101,14.428571428571429,3,0.0,5,18,3,2,34,27,2,9,1,28,73,1
8227,143031,3KjnZ3S4S95rwgXw0mLP4J41XhNDBesp,5Gyp41oLVo7Gg7vF4vpmggWP5MU70QO6,3,5,2,0,0,2,1,0,10,1.4285714285714286,1,0.0,0,2,0,0,5,2,0,1,0,2,8,1
8228,143032,yiX0lNiEyuJnsK7G0Hy1jjUqzZwKTcF0,5Gyp41oLVo7Gg7vF4vpmggWP5MU70QO6,9,8,0,0,2,0,6,0,16,2.2857142857142856,3,0.0,0,0,0,2,8,0,0,6,0,2,14,1
8229,143036,DRIsdfmYpSxbWwFUHIOIzf4BRoke0ZZE,5Gyp41oLVo7Gg7vF4vpmggWP5MU70QO6,17,26,12,9,6,10,8,1,72,10.285714285714286,2,0.0,10,12,7,6,16,10,2,8,1,35,37,1
8230,143041,JQXwg5oDrXSY89Ir81YvGqw3RQTrtmLb,5Gyp41oLVo7Gg7vF4vpmggWP5MU70QO6,12,33,10,0,11,3,10,1,68,9.714285714285714,3,0.0,6,10,0,11,27,3,0,10,1,27,41,1
8231,143061,XuaSoIyzQwXQTlS6fvGcmzTRqL1S8Nnj,5Gyp41oLVo7Gg7vF4vpmggWP5MU70QO6,17,18,11,11,8,2,7,1,58,8.285714285714286,1,0.0,3,11,8,8,15,2,3,7,1,30,28,1
8232,143063,b7ewJdm3mar5i6uoQA5ZMhd1hcPb1nbE,5Gyp41oLVo7Gg7vF4vpmggWP5MU70QO6,9,3,2,0,2,0,6,0,13,1.8571428571428572,1,0.0,0,2,0,2,3,0,0,6,0,4,9,1
8233,143071,TIVivi0oFusM7y9wcn0UQtXgRbbsyKFg,5Gyp41oLVo7Gg7vF4vpmggWP5MU70QO6,9,4,3,0,3,1,2,0,13,1.8571428571428572,1,0.0,0,3,0,3,4,1,0,2,0,6,7,1
8234,143075,do1Z4vmEY3IfXSZbYlXlN4QavaoSDH7E,5Gyp41oLVo7Gg7vF4vpmggWP5MU70QO6,4,2,1,0,1,0,1,0,5,0.7142857142857143,1,0.0,0,1,0,1,2,0,0,1,0,2,3,1
8235,143080,pvSD567ywc6ozL5cSGngcmAAsEaD239g,5Gyp41oLVo7Gg7vF4vpmggWP5MU70QO6,8,5,3,0,2,0,3,0,13,1.8571428571428572,1,0.0,0,3,0,2,5,0,0,3,0,5,8,1
8236,143082,5VrubMohFJRs2uBLHqjjujzimTw2JUmG,5Gyp41oLVo7Gg7vF4vpmggWP5MU70QO6,9,5,3,0,2,0,4,0,14,2.0,1,0.0,0,3,0,2,5,0,0,4,0,5,9,1
8237,143086,rEvKP9b6qegELe0wgljw2rw7nsonmRLv,5Gyp41oLVo7Gg7vF4vpmggWP5MU70QO6,6,4,3,0,3,5,2,0,17,2.4285714285714284,1,0.0,0,3,0,3,4,5,0,2,0,6,11,1
8238,143087,gVKYwt7a5YfFnHCVbaJMFEr2HRbS5Dys,5Gyp41oLVo7Gg7vF4vpmggWP5MU70QO6,5,1,1,0,1,0,2,0,5,0.7142857142857143,1,0.0,0,1,0,1,1,0,0,2,0,2,3,1
8239,143094,KdYI01F9Xc7qTt82weazWGHtHsUvxDB7,5Gyp41oLVo7Gg7vF4vpmggWP5MU70QO6,28,100,65,30,8,137,44,6,390,55.714285714285715,7,0.0,13,65,24,8,87,137,6,44,6,110,280,1
8240,143098,DPe55xPITU47YaO3l7sFO9C6BhqHfcWz,5Gyp41oLVo7Gg7vF4vpmggWP5MU70QO6,9,9,3,11,2,0,1,0,26,3.7142857142857144,1,0.0,5,3,7,2,4,0,4,1,0,17,9,1
8241,143105,MgtK46EfcHVMVAxIq7hS5UFlePotashl,5Gyp41oLVo7Gg7vF4vpmggWP5MU70QO6,5,4,3,0,1,0,2,0,10,1.4285714285714286,2,0.0,0,3,0,1,4,0,0,2,0,4,6,1
8242,143116,9OJN8dVuGmNkppZgs9QV6MNMRzqLs9aB,5Gyp41oLVo7Gg7vF4vpmggWP5MU70QO6,21,35,16,5,13,6,13,1,89,12.714285714285714,2,0.0,13,16,3,13,22,6,2,13,1,45,44,1
8243,143125,AxLMXe4mhxK1wpAy63LabW5ekOJueEXq,5Gyp41oLVo7Gg7vF4vpmggWP5MU70QO6,1,0,0,0,0,0,2,0,2,0.2857142857142857,1,0.0,0,0,0,0,0,0,0,2,0,0,2,1
8244,143128,qC7z0hkyxIqr1VA8jwfHLMApVzGohUEr,5Gyp41oLVo7Gg7vF4vpmggWP5MU70QO6,17,13,6,4,6,17,4,1,51,7.285714285714286,1,0.0,4,6,2,6,9,17,2,4,1,18,33,1
8245,143129,iNaNVKPSNQcQDAXEsk3oID2h2qCn4Blu,5Gyp41oLVo7Gg7vF4vpmggWP5MU70QO6,20,29,15,15,7,6,8,0,80,11.428571428571429,3,0.0,7,15,10,7,22,6,5,8,0,39,41,1
8246,143131,bhmI4wUi4dYE8RHNnBf6ZaTcRPmT22ih,5Gyp41oLVo7Gg7vF4vpmggWP5MU70QO6,7,5,3,0,2,4,2,0,16,2.2857142857142856,2,0.0,0,3,0,2,5,4,0,2,0,5,11,1
8247,143132,MIuFMHu4QqmngBMuxZXIQYGoRPab86df,5Gyp41oLVo7Gg7vF4vpmggWP5MU70QO6,6,2,1,0,1,5,3,0,12,1.7142857142857142,2,0.0,0,1,0,1,2,5,0,3,0,2,10,1
8248,143135,BPWa0SjleiqllaywZCKubwGSdtmQ6n1j,5Gyp41oLVo7Gg7vF4vpmggWP5MU70QO6,10,4,3,0,2,1,4,1,15,2.142857142857143,1,0.0,0,3,0,2,4,1,0,4,1,5,10,0
8249,143136,xaRe3CQMiQ8ZbXtCbysZy6CuK7CM1LuZ,5Gyp41oLVo7Gg7vF4vpmggWP5MU70QO6,17,22,14,0,5,1,12,0,54,7.714285714285714,4,0.0,0,14,0,5,22,1,0,12,0,19,35,1
8250,143137,k3ESPEouELka4zGY7vPbxqjbeg15ztGg,5Gyp41oLVo7Gg7vF4vpmggWP5MU70QO6,2,0,0,0,0,0,2,0,2,0.2857142857142857,1,0.0,0,0,0,0,0,0,0,2,0,0,2,1
8251,143141,Ne9g2jvBNvHBd7CLIx87kYELPmw8ecmQ,5Gyp41oLVo7Gg7vF4vpmggWP5MU70QO6,1,0,0,0,0,0,1,0,1,0.14285714285714285,1,0.0,0,0,0,0,0,0,0,1,0,0,1,1
8252,143142,mWsuj8DW13tbV72OzJtb95DEj9IR58xK,5Gyp41oLVo7Gg7vF4vpmggWP5MU70QO6,25,62,32,37,0,22,11,2,166,23.714285714285715,2,0.0,22,32,24,0,40,22,13,11,2,78,88,1
8253,143150,o4osOJvgQ93Ymu9ZCa30DQTnm2Hl0dnw,5Gyp41oLVo7Gg7vF4vpmggWP5MU70QO6,9,6,3,2,3,0,1,0,15,2.142857142857143,1,0.0,2,3,1,3,4,0,1,1,0,9,6,1
8254,143156,e1CSwKLgflGiW7QjzYRNEoHjbDEH3F2k,5Gyp41oLVo7Gg7vF4vpmggWP5MU70QO6,7,6,4,0,2,0,1,0,13,1.8571428571428572,1,0.0,1,4,0,2,5,0,0,1,0,7,6,1
8255,143158,gACW4eW6IndswRGYovdbuYWVGeoweSw7,5Gyp41oLVo7Gg7vF4vpmggWP5MU70QO6,7,6,4,0,3,0,2,0,15,2.142857142857143,2,0.0,0,4,0,3,6,0,0,2,0,7,8,1
8256,143159,KQYI71SI6FLFL334CmUIcZdj9iEl8sIP,5Gyp41oLVo7Gg7vF4vpmggWP5MU70QO6,8,3,2,0,2,1,4,1,13,1.8571428571428572,1,0.0,0,2,0,2,3,1,0,4,1,4,9,1
8257,143162,FNNkYJBcgO6TAypEWaG77LaITnunLt0h,5Gyp41oLVo7Gg7vF4vpmggWP5MU70QO6,5,6,3,0,3,0,4,0,16,2.2857142857142856,2,0.0,0,3,0,3,6,0,0,4,0,6,10,1
8258,143163,FinP9VOv1FLjqjsGPeYAQ4N1be1w2MaA,5Gyp41oLVo7Gg7vF4vpmggWP5MU70QO6,6,3,2,0,2,0,1,0,8,1.1428571428571428,1,0.0,0,2,0,2,3,0,0,1,0,4,4,0
8259,143167,n71gQ4Qv60Nh3YO1KMa8VvSFJjnagfeK,5Gyp41oLVo7Gg7vF4vpmggWP5MU70QO6,17,28,10,9,6,0,11,2,66,9.428571428571429,3,0.0,7,10,6,6,21,0,3,11,2,29,37,1
8260,143169,RFUaC76ud2WlPM67fqme1nijMfLoBAhZ,5Gyp41oLVo7Gg7vF4vpmggWP5MU70QO6,11,16,8,0,3,8,6,0,41,5.857142857142857,3,0.0,1,8,0,3,15,8,0,6,0,12,29,1
8261,143170,Xrg8uTG8xcwYWrI9nvpuvAMovoPGgJm6,5Gyp41oLVo7Gg7vF4vpmggWP5MU70QO6,21,39,18,0,16,16,17,2,108,15.428571428571429,5,0.0,13,18,0,16,26,16,0,17,2,47,61,1
8262,143186,Jo7MgvP2yvxgxeh3IzpiPyl5ecjaSE54,5Gyp41oLVo7Gg7vF4vpmggWP5MU70QO6,10,17,12,0,0,2,10,1,42,6.0,1,0.0,4,12,0,0,13,2,0,10,1,16,26,1
8263,143189,nhgQOFSJq5AGoImDBS3vpfkFxQeI95h6,5Gyp41oLVo7Gg7vF4vpmggWP5MU70QO6,6,3,1,0,1,0,4,0,9,1.2857142857142858,1,0.0,2,1,0,1,1,0,0,4,0,4,5,1
8264,143191,igGKVn9hnrrkFHCdS1VW8OE1QaCagHjl,5Gyp41oLVo7Gg7vF4vpmggWP5MU70QO6,9,14,6,2,2,5,2,0,31,4.428571428571429,1,0.0,6,6,1,2,8,5,1,2,0,15,16,1
8265,143193,KDeaSgZ6wTHm30JcQgLQFVdVYbxH0KHc,5Gyp41oLVo7Gg7vF4vpmggWP5MU70QO6,5,2,0,0,1,0,2,0,5,0.7142857142857143,1,0.0,0,0,0,1,2,0,0,2,0,1,4,1
8266,143195,ZuzQyeRHP6ylyX1kz2ZCSK5JTnFY7jgw,5Gyp41oLVo7Gg7vF4vpmggWP5MU70QO6,8,9,5,0,2,0,8,0,24,3.4285714285714284,3,0.0,0,5,0,2,9,0,0,8,0,7,17,1
8267,143202,rSfDnEZb6MyQWJXH3EUiEdy4QB5YcYIT,5Gyp41oLVo7Gg7vF4vpmggWP5MU70QO6,13,19,2,8,3,1,5,1,39,5.571428571428571,2,0.0,8,2,6,3,11,1,2,5,1,19,20,1
8268,143207,6TbaXLQH43LhwCQqxfDoHT2dkIqoIZiA,5Gyp41oLVo7Gg7vF4vpmggWP5MU70QO6,5,2,1,0,1,0,3,0,7,1.0,1,0.0,0,1,0,1,2,0,0,3,0,2,5,1
8269,143210,q19r0zRKq7Kj0yuHwlucxw9Qfz0p8wj4,5Gyp41oLVo7Gg7vF4vpmggWP5MU70QO6,10,8,3,0,5,1,4,3,24,3.4285714285714284,2,0.0,3,3,0,5,5,1,0,4,3,11,13,1
8270,143217,I91CCtQfetYUPwkEXIvTFBP6tbrp1spN,5Gyp41oLVo7Gg7vF4vpmggWP5MU70QO6,5,0,0,0,0,1,5,1,7,1.0,1,0.0,0,0,0,0,0,1,0,5,1,0,7,1
8271,143220,zop3YH9KYZDCX1f11SNUdASXvNJ8iRxo,5Gyp41oLVo7Gg7vF4vpmggWP5MU70QO6,16,20,8,26,2,1,11,1,69,9.857142857142858,4,0.0,9,8,21,2,11,1,5,11,1,40,29,1
8272,143222,BkCm44eyCVgiloopsbEDQiCYUYpXhFhh,5Gyp41oLVo7Gg7vF4vpmggWP5MU70QO6,1,0,0,0,0,0,1,0,1,0.14285714285714285,1,0.0,0,0,0,0,0,0,0,1,0,0,1,1
8273,143223,bABhSukD4jvNJV7pWKllTDyiMRnwm2FE,5Gyp41oLVo7Gg7vF4vpmggWP5MU70QO6,7,4,3,0,2,0,1,0,10,1.4285714285714286,1,0.0,0,3,0,2,4,0,0,1,0,5,5,1
8274,143228,b9SPkVIIqTyWdNmHLqb2i5EFW3ZlPY6f,5Gyp41oLVo7Gg7vF4vpmggWP5MU70QO6,6,5,3,0,2,0,3,0,13,1.8571428571428572,2,0.0,0,3,0,2,5,0,0,3,0,5,8,1
8275,143230,EVKTxmdXvqH9f0V4XuFLHjVRnnUWi9xh,5Gyp41oLVo7Gg7vF4vpmggWP5MU70QO6,5,3,1,0,1,0,1,0,6,0.8571428571428571,1,0.0,0,1,0,1,3,0,0,1,0,2,4,1
8276,143232,XMiI0KwF5fhEpV0sZdwn5oRV5TdRMBIA,5Gyp41oLVo7Gg7vF4vpmggWP5MU70QO6,1,0,0,0,0,0,1,0,1,0.14285714285714285,1,0.0,0,0,0,0,0,0,0,1,0,0,1,1
8277,143238,GiWhb0QNRLQ5Tf1KkKsrbfKJpHMBwk1v,5Gyp41oLVo7Gg7vF4vpmggWP5MU70QO6,8,3,3,0,2,1,3,0,12,1.7142857142857142,1,0.0,0,3,0,2,3,1,0,3,0,5,7,1
8278,143240,ll3V03b2wof8nPyeyz9vdroyCyymz3Oc,5Gyp41oLVo7Gg7vF4vpmggWP5MU70QO6,13,20,6,23,3,0,4,0,56,8.0,2,0.0,11,6,14,3,9,0,9,4,0,34,22,1
8279,143243,pRKlNyr7aXvrIlMSBQ4BrpxDuTk5IyTG,5Gyp41oLVo7Gg7vF4vpmggWP5MU70QO6,7,5,3,0,1,0,7,0,16,2.2857142857142856,2,0.0,0,3,0,1,5,0,0,7,0,4,12,1
8280,143246,YxEAEqB4R6GTRBWDvga1GWE0URAxGc6U,5Gyp41oLVo7Gg7vF4vpmggWP5MU70QO6,9,20,12,0,0,0,6,0,38,5.428571428571429,6,0.0,2,12,0,0,18,0,0,6,0,14,24,1
8281,143247,lnwcZZk4BoCpUHQGJaYy0V8i6237rzzn,5Gyp41oLVo7Gg7vF4vpmggWP5MU70QO6,10,14,5,6,4,0,1,0,30,4.285714285714286,1,0.0,8,5,4,4,6,0,2,1,0,21,9,1
8282,143249,rwFmQoyHOvEHdWgjpm2nmsyB1JSa6M1i,5Gyp41oLVo7Gg7vF4vpmggWP5MU70QO6,1,0,0,0,0,0,1,0,1,0.14285714285714285,1,0.0,0,0,0,0,0,0,0,1,0,0,1,1
8283,143253,SneJ0NYk7aqDC5qkSniBWVl1uaTDa5aK,5Gyp41oLVo7Gg7vF4vpmggWP5MU70QO6,19,16,9,20,5,7,6,1,64,9.142857142857142,1,0.0,6,9,16,5,10,7,4,6,1,36,28,1
8284,143255,rb8svWOVmV3WiCo1KHfqDPOhTEw2h6Ly,5Gyp41oLVo7Gg7vF4vpmggWP5MU70QO6,7,9,4,0,1,0,4,0,18,2.5714285714285716,2,0.0,0,4,0,1,9,0,0,4,0,5,13,1
8285,143270,MfPI39sufXLCYqLL798nCefcxWtCKM9I,5Gyp41oLVo7Gg7vF4vpmggWP5MU70QO6,5,2,1,0,1,0,2,0,6,0.8571428571428571,1,0.0,0,1,0,1,2,0,0,2,0,2,4,1
8286,143271,q2xQCstASp96wpspi8iqsuaqJ7gzfsux,5Gyp41oLVo7Gg7vF4vpmggWP5MU70QO6,11,9,4,12,0,0,1,0,26,3.7142857142857144,1,0.0,3,4,9,0,6,0,3,1,0,16,10,1
8287,143273,Zkoaalg5gR5VRpuQYCw0O6lY2zjL7QUk,5Gyp41oLVo7Gg7vF4vpmggWP5MU70QO6,6,3,3,0,2,0,2,0,10,1.4285714285714286,1,0.0,0,3,0,2,3,0,0,2,0,5,5,1
8288,143274,cEJWzD9dGTS2EAlcBmSG0h9GwpdVCcKs,5Gyp41oLVo7Gg7vF4vpmggWP5MU70QO6,14,20,10,8,7,10,12,1,68,9.714285714285714,1,0.0,10,10,5,7,10,10,3,12,1,32,36,1
8289,143289,Do8hbesbT6OBtmo3AMshqQTnDUWGEYzY,5Gyp41oLVo7Gg7vF4vpmggWP5MU70QO6,11,17,9,5,5,8,7,0,51,7.285714285714286,3,0.0,4,9,3,5,13,8,2,7,0,21,30,1
8290,143293,KeJ2Uvhd6Kdyp7EsZknmz1m41xlCNZ2d,5Gyp41oLVo7Gg7vF4vpmggWP5MU70QO6,4,2,0,0,1,0,2,0,5,0.7142857142857143,1,0.0,0,0,0,1,2,0,0,2,0,1,4,1
8291,143297,MCi65wdv0LbmAT0IkqfYGVJG2oSDQ0M5,5Gyp41oLVo7Gg7vF4vpmggWP5MU70QO6,11,8,4,0,3,0,5,0,20,2.857142857142857,2,0.0,1,4,0,3,7,0,0,5,0,8,12,1
8292,143298,j8HMNSvqsRTZYEHc4rRzkD2YAQLorjQF,5Gyp41oLVo7Gg7vF4vpmggWP5MU70QO6,5,6,3,0,1,0,3,0,13,1.8571428571428572,3,0.0,0,3,0,1,6,0,0,3,0,4,9,1
8293,143300,oSjFmNzquetC0sVtfmLtjT8TDy2BmlHN,5Gyp41oLVo7Gg7vF4vpmggWP5MU70QO6,12,20,8,0,5,4,9,1,47,6.714285714285714,4,0.0,4,8,0,5,16,4,0,9,1,17,30,1
8294,143301,sOVkx7jjk0gU5YuQasoQUBg1lLSDWgd7,5Gyp41oLVo7Gg7vF4vpmggWP5MU70QO6,7,5,3,0,3,12,5,0,28,4.0,1,0.0,0,3,0,3,5,12,0,5,0,6,22,1
8295,143304,ZuK89GHN4bqTYIiZNVMqTHhEUKl9OagO,5Gyp41oLVo7Gg7vF4vpmggWP5MU70QO6,15,19,11,2,4,1,10,1,48,6.857142857142857,2,0.0,4,11,1,4,15,1,1,10,1,20,28,1
8296,143310,Srzx9DkAQVhPqTB5VQGPf5BuKlWhqg6D,5Gyp41oLVo7Gg7vF4vpmggWP5MU70QO6,10,7,4,8,3,0,1,0,23,3.2857142857142856,1,0.0,2,4,6,3,5,0,2,1,0,15,8,1
8297,143313,RU275VOgQR3hXH7M7a8ifKkCevQFU0OB,5Gyp41oLVo7Gg7vF4vpmggWP5MU70QO6,19,37,13,33,5,11,4,0,103,14.714285714285714,5,0.0,19,13,27,5,18,11,6,4,0,64,39,1
8298,143327,BCsXMTXMkLglsocuyOC8JkAlV0urSlKL,5Gyp41oLVo7Gg7vF4vpmggWP5MU70QO6,1,0,0,0,0,0,2,0,2,0.2857142857142857,1,0.0,0,0,0,0,0,0,0,2,0,0,2,1
8299,143331,TOGouapafKnIxFk4WgVAiDrJCoEswpDO,5Gyp41oLVo7Gg7vF4vpmggWP5MU70QO6,14,21,12,3,4,0,8,0,48,6.857142857142857,3,0.0,2,12,2,4,19,0,1,8,0,20,28,1
8300,143332,G4oYYTqga05amYF2WyoajbCZn7qaA015,5Gyp41oLVo7Gg7vF4vpmggWP5MU70QO6,4,2,1,0,1,0,1,0,5,0.7142857142857143,1,0.0,0,1,0,1,2,0,0,1,0,2,3,0
8301,143333,RSvPQSF8RarDsP4aI3ftScWWjvINqjc5,5Gyp41oLVo7Gg7vF4vpmggWP5MU70QO6,19,20,12,21,7,11,1,0,72,10.285714285714286,4,0.0,5,12,15,7,15,11,6,1,0,39,33,0
8302,143348,4FpBAFbkTW74GTZijuH1arPakK1chUuB,5Gyp41oLVo7Gg7vF4vpmggWP5MU70QO6,10,9,5,3,2,0,3,0,22,3.142857142857143,2,0.0,1,5,2,2,8,0,1,3,0,10,12,1
8303,143352,afxPPujIq38QOJZWzKAUwDfPhgssooFj,5Gyp41oLVo7Gg7vF4vpmggWP5MU70QO6,14,13,8,0,2,1,5,1,30,4.285714285714286,1,0.0,3,8,0,2,10,1,0,5,1,13,17,1
8304,143358,qguXCGauBLRxB42arUsmMf4qY2P6nLSI,5Gyp41oLVo7Gg7vF4vpmggWP5MU70QO6,7,29,11,0,1,11,1,0,53,7.571428571428571,1,0.0,3,11,0,1,26,11,0,1,0,15,38,1
8305,143365,vGcLxIxx9hPQmjm92Kj3O9RHGwvxcHnD,5Gyp41oLVo7Gg7vF4vpmggWP5MU70QO6,5,3,1,0,1,0,1,0,6,0.8571428571428571,1,0.0,0,1,0,1,3,0,0,1,0,2,4,1
8306,143373,94TaJxTGa6mk96QWRsvTPAlZKuIwFWgW,5Gyp41oLVo7Gg7vF4vpmggWP5MU70QO6,6,4,3,0,2,0,3,0,12,1.7142857142857142,2,0.0,0,3,0,2,4,0,0,3,0,5,7,1
8307,143379,XNOL59MqQcKgU2TbdVogAc500SlZ5TMF,5Gyp41oLVo7Gg7vF4vpmggWP5MU70QO6,12,11,5,2,3,1,5,1,28,4.0,1,0.0,5,5,1,3,6,1,1,5,1,14,14,1
8308,143385,ExaahXOdmDkG9h6C6IWQiCEgqVTIynrC,5Gyp41oLVo7Gg7vF4vpmggWP5MU70QO6,23,58,20,32,12,23,11,2,158,22.571428571428573,3,0.0,16,20,23,12,42,23,9,11,2,71,87,1
8309,143386,YvC95tMRyMsPtnV4Slqh3o5qWPTRuglH,5Gyp41oLVo7Gg7vF4vpmggWP5MU70QO6,2,0,0,0,0,0,3,0,3,0.42857142857142855,1,0.0,0,0,0,0,0,0,0,3,0,0,3,1
8310,143387,BMMb4uocaM6eiWDVgy8d5o4GBcNjaw64,5Gyp41oLVo7Gg7vF4vpmggWP5MU70QO6,9,5,2,5,1,0,2,0,15,2.142857142857143,1,0.0,1,2,3,1,4,0,2,2,0,7,8,1
8311,143388,DjgwD62xw4j6X1coWv63B21KAYnYeIjl,5Gyp41oLVo7Gg7vF4vpmggWP5MU70QO6,10,3,2,0,2,1,11,0,19,2.7142857142857144,2,0.0,0,2,0,2,3,1,0,11,0,4,15,1
8312,143398,yBRQxjQxDogEAqCykYWmOYDonWjRgkgU,5Gyp41oLVo7Gg7vF4vpmggWP5MU70QO6,23,31,18,13,11,9,5,0,87,12.428571428571429,3,0.0,7,18,9,11,24,9,4,5,0,45,42,1
8313,143399,NMciPbdIeB9uIZwCMcw6mXU2i3BtnB5v,5Gyp41oLVo7Gg7vF4vpmggWP5MU70QO6,6,4,3,0,2,0,1,0,10,1.4285714285714286,1,0.0,0,3,0,2,4,0,0,1,0,5,5,1
8314,143402,jrrPGAGvqCY4RzoZv6xNS5Oy0eqBPv6a,5Gyp41oLVo7Gg7vF4vpmggWP5MU70QO6,9,7,4,0,2,2,4,0,19,2.7142857142857144,1,0.0,0,4,0,2,7,2,0,4,0,6,13,1
8315,143407,CfSlJrmN1EB0CEB1WxXzFR3OkgiWGjng,5Gyp41oLVo7Gg7vF4vpmggWP5MU70QO6,6,2,1,0,1,0,4,0,8,1.1428571428571428,1,0.0,0,1,0,1,2,0,0,4,0,2,6,1
8316,143421,m56xLBiglZRYuDGduwjGoqOggwDDVCSs,5Gyp41oLVo7Gg7vF4vpmggWP5MU70QO6,10,11,6,0,3,0,3,0,23,3.2857142857142856,2,0.0,2,6,0,3,9,0,0,3,0,11,12,1
8317,143426,bSilfLBZdynq5nBBUkXoRk3OZyrStUPG,5Gyp41oLVo7Gg7vF4vpmggWP5MU70QO6,11,12,3,0,2,0,7,0,24,3.4285714285714284,2,0.0,1,3,0,2,11,0,0,7,0,6,18,1
8318,143429,eMkeOhzQLpxe3t7i8Nqij0jVxwAl4Ukd,5Gyp41oLVo7Gg7vF4vpmggWP5MU70QO6,8,4,3,0,2,0,9,1,19,2.7142857142857144,1,0.0,0,3,0,2,4,0,0,9,1,5,14,1
8319,143430,25vk7TvXQBJyp4rmBUz0jP6klf8GkyI0,5Gyp41oLVo7Gg7vF4vpmggWP5MU70QO6,10,15,6,6,3,0,3,0,33,4.714285714285714,2,0.0,3,6,4,3,12,0,2,3,0,16,17,1
8320,143439,7BMABdHPfKbAuFunFMP8IJnOb1JXGtd2,5Gyp41oLVo7Gg7vF4vpmggWP5MU70QO6,6,3,2,0,2,0,1,0,8,1.1428571428571428,1,0.0,0,2,0,2,3,0,0,1,0,4,4,1
8321,143441,NFwkvwlecWBzcgNCOvBMTCkkUA7P9cK8,5Gyp41oLVo7Gg7vF4vpmggWP5MU70QO6,14,13,8,2,5,7,3,0,38,5.428571428571429,2,0.0,0,8,1,5,13,7,1,3,0,14,24,1
8322,143443,DlJ9FnLAg8KLlOcJpKGz0ybaZuj1qVBp,5Gyp41oLVo7Gg7vF4vpmggWP5MU70QO6,5,3,1,0,1,0,1,0,6,0.8571428571428571,1,0.0,0,1,0,1,3,0,0,1,0,2,4,1
8323,143448,oJ33i7feUDdmWItlK0CBqa7RDgE1Pw5q,5Gyp41oLVo7Gg7vF4vpmggWP5MU70QO6,8,19,12,0,7,0,5,0,43,6.142857142857143,3,0.0,1,12,0,7,18,0,0,5,0,20,23,1
8324,143462,G0y998PBz3ExjEmB0ZTxVJ62JVKsEgPS,5Gyp41oLVo7Gg7vF4vpmggWP5MU70QO6,13,20,9,0,6,0,3,0,38,5.428571428571429,2,0.0,6,9,0,6,14,0,0,3,0,21,17,1
8325,143469,w8rep73swbwnVZBmuaUtSx1urGRd9SFt,5Gyp41oLVo7Gg7vF4vpmggWP5MU70QO6,9,6,4,0,3,0,6,1,20,2.857142857142857,1,0.0,0,4,0,3,6,0,0,6,1,7,13,1
8326,143473,ntA6YQWe5fxYDVE2cXKSrH7F2lF2TfcV,5Gyp41oLVo7Gg7vF4vpmggWP5MU70QO6,16,28,19,9,9,13,3,0,81,11.571428571428571,3,0.0,4,19,6,9,24,13,3,3,0,38,43,1
8327,143478,eLQqW2JOLUxobMgymK6OqjXFKQCr78ec,5Gyp41oLVo7Gg7vF4vpmggWP5MU70QO6,1,0,0,0,0,0,1,0,1,0.14285714285714285,1,0.0,0,0,0,0,0,0,0,1,0,0,1,1
8328,143483,lpIlNFXqycXbQQddlt9RaXJPBJNqHIww,5Gyp41oLVo7Gg7vF4vpmggWP5MU70QO6,4,2,1,0,1,0,2,0,6,0.8571428571428571,1,0.0,0,1,0,1,2,0,0,2,0,2,4,1
8329,143486,OYWBopBO2n38CA6GRAaDJRfIHV9b0dQs,5Gyp41oLVo7Gg7vF4vpmggWP5MU70QO6,26,41,22,17,7,22,15,7,131,18.714285714285715,3,0.0,14,22,10,7,27,22,7,15,7,53,78,1
8330,143487,Bha7QMGmONKAqxvqVmMzYDzgn03rupB9,5Gyp41oLVo7Gg7vF4vpmggWP5MU70QO6,11,17,9,2,6,2,10,0,46,6.571428571428571,2,0.0,4,9,1,6,13,2,1,10,0,20,26,0
8331,143493,Ooe9SpvA9vL8fZI7YLdrPaZtM6Unwf0C,5Gyp41oLVo7Gg7vF4vpmggWP5MU70QO6,8,5,1,0,2,0,4,0,12,1.7142857142857142,2,0.0,0,1,0,2,5,0,0,4,0,3,9,1
8332,143494,Ip3irZsxFvOeGg8WSppVhJArbPhoH3qm,5Gyp41oLVo7Gg7vF4vpmggWP5MU70QO6,7,4,2,0,2,0,1,0,9,1.2857142857142858,1,0.0,0,2,0,2,4,0,0,1,0,4,5,1
8333,143495,j79CPp6e09l3A1MeqgSV5ajYlxbk9Ixy,5Gyp41oLVo7Gg7vF4vpmggWP5MU70QO6,7,23,7,0,0,0,4,0,34,4.857142857142857,3,0.0,0,7,0,0,23,0,0,4,0,7,27,1
8334,143499,cWoy5QWZfuqmIk8DYz59g7gA3SWqJuxp,5Gyp41oLVo7Gg7vF4vpmggWP5MU70QO6,9,8,3,3,2,1,2,0,19,2.7142857142857144,1,0.0,3,3,2,2,5,1,1,2,0,10,9,1
8335,143505,dvmUEJYzbcSyy3vJBwmbV1q6GkcgXkyo,5Gyp41oLVo7Gg7vF4vpmggWP5MU70QO6,1,0,0,0,0,0,1,0,1,0.14285714285714285,1,0.0,0,0,0,0,0,0,0,1,0,0,1,1
8336,143506,y31hLJookNfhewMV4zJieB9drJ6uJOM8,5Gyp41oLVo7Gg7vF4vpmggWP5MU70QO6,4,3,2,0,2,0,1,0,8,1.1428571428571428,1,0.0,0,2,0,2,3,0,0,1,0,4,4,1
8337,143512,FXVpQoS8mavqcQRGTmrN03ngBkUOH7AA,5Gyp41oLVo7Gg7vF4vpmggWP5MU70QO6,11,25,8,19,3,12,16,0,83,11.857142857142858,4,0.0,14,8,13,3,11,12,6,16,0,38,45,1
8338,143514,uLMNzHudktr2AZyuuPvX47miD1HKSZey,5Gyp41oLVo7Gg7vF4vpmggWP5MU70QO6,7,3,2,0,2,0,2,1,10,1.4285714285714286,1,0.0,0,2,0,2,3,0,0,2,1,4,6,1
8339,143518,exZQCwNpb5GlUZp9D9aXiDpNVUddiSXX,5Gyp41oLVo7Gg7vF4vpmggWP5MU70QO6,2,0,0,0,0,0,2,0,2,0.2857142857142857,1,0.0,0,0,0,0,0,0,0,2,0,0,2,1
8340,143519,hA5iAFa3mduviu6W1NXrCwxPt2uneIZZ,5Gyp41oLVo7Gg7vF4vpmggWP5MU70QO6,1,0,0,0,0,0,1,0,1,0.14285714285714285,1,0.0,0,0,0,0,0,0,0,1,0,0,1,1
8341,143524,JGhL9OPc6cmN3pd3UPdgTkDHdCrRxIq9,5Gyp41oLVo7Gg7vF4vpmggWP5MU70QO6,5,2,1,0,1,0,3,0,7,1.0,1,0.0,0,1,0,1,2,0,0,3,0,2,5,1
8342,143529,tswNF0dP53SwO8GrnkKo6hfFh502X3nQ,5Gyp41oLVo7Gg7vF4vpmggWP5MU70QO6,7,4,2,0,1,5,8,0,20,2.857142857142857,1,0.0,0,2,0,1,4,5,0,8,0,3,17,1
8343,143530,AsKItWOk6yONkGOduP0vUaGEDxnOlUCN,5Gyp41oLVo7Gg7vF4vpmggWP5MU70QO6,1,0,0,0,0,0,1,0,1,0.14285714285714285,1,0.0,0,0,0,0,0,0,0,1,0,0,1,1
8344,143532,DKvwWgsnzXTxLcvnyFd3ScosQnv8YPop,5Gyp41oLVo7Gg7vF4vpmggWP5MU70QO6,7,11,4,0,1,3,3,0,22,3.142857142857143,1,0.0,0,4,0,1,11,3,0,3,0,5,17,1
8345,143541,FZWt1vapJFvo3kXFvlr3Pcq5dqSsXIdl,5Gyp41oLVo7Gg7vF4vpmggWP5MU70QO6,16,29,17,2,4,8,15,1,76,10.857142857142858,4,0.0,4,17,1,4,25,8,1,15,1,26,50,1
8346,143550,T6EWQ7jVP89JlHzj41KN1gEtGYevpSQM,5Gyp41oLVo7Gg7vF4vpmggWP5MU70QO6,1,0,0,0,0,0,1,0,1,0.14285714285714285,1,0.0,0,0,0,0,0,0,0,1,0,0,1,1
8347,143551,1u5RJ3ohzI9I8TYHEG8zy2n2QjuVVCRw,5Gyp41oLVo7Gg7vF4vpmggWP5MU70QO6,17,41,22,0,6,1,12,0,82,11.714285714285714,7,0.0,8,22,0,6,33,1,0,12,0,36,46,0
8348,143553,7qDBI7pI0SQ1bfBBjf175GzJeqNA6CgO,5Gyp41oLVo7Gg7vF4vpmggWP5MU70QO6,10,11,9,0,3,0,3,0,26,3.7142857142857144,2,0.0,0,9,0,3,11,0,0,3,0,12,14,0
8349,143565,fMkV32K36nG6sEguObUImrUVGuVnClMZ,5Gyp41oLVo7Gg7vF4vpmggWP5MU70QO6,6,6,4,2,1,0,1,0,14,2.0,1,0.0,1,4,1,1,5,0,1,1,0,7,7,1
8350,143568,pMv1oQj1T6gZE30FoEj4M5Nwt7Fl1qeo,5Gyp41oLVo7Gg7vF4vpmggWP5MU70QO6,1,0,0,0,0,0,1,0,1,0.14285714285714285,1,0.0,0,0,0,0,0,0,0,1,0,0,1,1
8351,143570,ejWSFSNW1jOTCFDROUQkAUS6uY6mX6CR,5Gyp41oLVo7Gg7vF4vpmggWP5MU70QO6,6,7,0,0,0,0,3,0,10,1.4285714285714286,1,0.0,0,0,0,0,7,0,0,3,0,0,10,1
8352,143573,W4egQ0tAp72v44pF53MInCDaTEirYMVh,5Gyp41oLVo7Gg7vF4vpmggWP5MU70QO6,1,0,0,0,0,0,1,0,1,0.14285714285714285,1,0.0,0,0,0,0,0,0,0,1,0,0,1,1
8353,143607,3iJrlZJEv2h7DgWBpz6wZtSXPXEy6IAY,bWdj2GDclj5ofokWjzoa5jAwMkxCykd6,2,1,0,0,0,0,1,0,2,0.2857142857142857,1,0.0,0,0,0,0,1,0,0,1,0,0,2,1
8354,143631,GNXZVEHsVeYck60C0KBPWHG0mMcY0UQQ,SpATywNh6bZuzm8s1ceuBUnMUAeoAHHw,24,18,15,5,11,0,0,0,49,7.0,3,0.0,0,15,5,11,18,0,0,0,0,31,18,0
8355,143867,Pnezq6slEV4CIBxIFIPqhlGLNILa8T8M,SpATywNh6bZuzm8s1ceuBUnMUAeoAHHw,30,38,17,18,9,0,8,0,90,12.857142857142858,2,0.0,4,17,17,9,34,0,1,8,0,47,43,0
8356,143887,SKJH5bhXUHUXBV3YRjTcw0Oe5kVFAmnw,SpATywNh6bZuzm8s1ceuBUnMUAeoAHHw,14,24,7,14,0,10,3,4,62,8.857142857142858,1,0.0,13,7,12,0,11,10,2,3,4,32,30,1
8357,143897,BhOp2rSiJ2q2zT4ZZzNtPz6Fovfll5Yb,SpATywNh6bZuzm8s1ceuBUnMUAeoAHHw,4,4,2,0,0,0,1,0,7,1.0,1,0.0,1,2,0,0,3,0,0,1,0,3,4,1
8358,143900,NWUbBzN3rFqJYQQKuHujeEDgr8fxabPr,SpATywNh6bZuzm8s1ceuBUnMUAeoAHHw,15,19,2,17,1,0,4,0,43,6.142857142857143,2,0.0,2,2,13,1,17,0,4,4,0,18,25,0
8359,143908,nwFT4lnmg30fCvHRB6tbALo9FpcanuLx,SpATywNh6bZuzm8s1ceuBUnMUAeoAHHw,10,6,5,0,3,0,1,0,15,2.142857142857143,1,0.0,0,5,0,3,6,0,0,1,0,8,7,0
8360,143909,nwFT4lnmg30fCvHRB6tbALo9FpcanuLx,A3fsA9Zfv1X2fVEQhTw51lKENdNrEqT3,24,18,15,0,12,0,4,0,49,7.0,2,0.0,0,15,0,12,18,0,0,4,0,27,22,1
8361,143959,qE4hwNlGPGhoA6O5q5uX2JQSuwb75VXN,SpATywNh6bZuzm8s1ceuBUnMUAeoAHHw,4,4,2,0,0,0,1,0,7,1.0,1,0.0,1,2,0,0,3,0,0,1,0,3,4,1
8362,143971,nVB1o73xluQXZjoI2dUYHGxbCDG8qiCL,SpATywNh6bZuzm8s1ceuBUnMUAeoAHHw,6,3,2,0,1,0,7,0,13,1.8571428571428572,3,0.0,0,2,0,1,3,0,0,7,0,3,10,0
8363,144006,BNzSA1bHraXMmngTyyc8aHsRdjDVh5h7,bWdj2GDclj5ofokWjzoa5jAwMkxCykd6,3,2,0,0,0,0,2,0,4,0.5714285714285714,1,0.0,0,0,0,0,2,0,0,2,0,0,4,1
8364,144068,lWBDQVwIQrjtFGVOoBxPlW4CU3O2tpal,bWdj2GDclj5ofokWjzoa5jAwMkxCykd6,52,29,16,86,7,8,7,1,154,22.0,1,0.0,12,16,70,7,17,8,16,7,1,105,49,0
8365,144093,xOQ7AnZhBVXWatzUYsH22obdE4ihFc1J,bWdj2GDclj5ofokWjzoa5jAwMkxCykd6,2,1,1,0,0,0,0,0,2,0.2857142857142857,1,0.0,0,1,0,0,1,0,0,0,0,1,1,1
8366,144104,8wj2Kr145taRtViYKZRdPMwAZeP9BDRs,A3fsA9Zfv1X2fVEQhTw51lKENdNrEqT3,14,52,2,0,2,0,4,0,60,8.571428571428571,1,0.0,0,2,0,2,52,0,0,4,0,4,56,1
8367,144112,A41hdT15T7mumzDW53QCDXRUsOilvTI0,A3fsA9Zfv1X2fVEQhTw51lKENdNrEqT3,3,2,0,0,0,0,1,0,3,0.42857142857142855,1,0.0,0,0,0,0,2,0,0,1,0,0,3,0
8368,144223,lnkkWGyIr1b44KiKgAFL6qVeebRfNJt3,SpATywNh6bZuzm8s1ceuBUnMUAeoAHHw,1,0,0,0,0,0,1,0,1,0.14285714285714285,1,0.0,0,0,0,0,0,0,0,1,0,0,1,1
8369,144325,IKQYwh1PoPanPyuEqIIRzDtzc0tOUD2x,SpATywNh6bZuzm8s1ceuBUnMUAeoAHHw,23,27,1,28,1,0,1,0,58,8.285714285714286,1,0.0,10,1,28,1,17,0,0,1,0,40,18,0
8370,144357,Ie7mkAUCVVaLYxvosre748ADQJqirOJg,SpATywNh6bZuzm8s1ceuBUnMUAeoAHHw,6,3,1,0,1,0,2,0,7,1.0,1,0.0,0,1,0,1,3,0,0,2,0,2,5,1
8371,144425,cDfX3cMJgUCBkullLQDAvI97VlFeM2Mm,SpATywNh6bZuzm8s1ceuBUnMUAeoAHHw,1,0,0,0,0,0,1,0,1,0.14285714285714285,1,0.0,0,0,0,0,0,0,0,1,0,0,1,1
8372,144578,OUsTbnD6QZatQvggR5YjMxWOH6TYQEkw,SpATywNh6bZuzm8s1ceuBUnMUAeoAHHw,5,3,1,0,1,0,1,0,6,0.8571428571428571,1,0.0,0,1,0,1,3,0,0,1,0,2,4,1
8373,144604,5ehf4EFN8WhDbvmb2WvfZwpaBD0cj1oj,A3fsA9Zfv1X2fVEQhTw51lKENdNrEqT3,6,3,1,0,1,0,3,0,8,1.1428571428571428,1,0.0,0,1,0,1,3,0,0,3,0,2,6,1
8374,144667,uk1SKekwkpaHXYRLjN8ZintRuJ2tncOb,SpATywNh6bZuzm8s1ceuBUnMUAeoAHHw,51,64,19,22,12,0,2,0,119,17.0,3,0.0,17,19,22,12,47,0,0,2,0,70,49,0
8375,144709,Edq6Echk8wEs8ShX5RBw5c8Yx8ANHVje,RXDvfPUBYFlVdlueBFbLW0mhhAyGEqpt,3,2,1,0,0,0,1,0,4,0.5714285714285714,1,0.0,0,1,0,0,2,0,0,1,0,1,3,1
8376,144758,iEsrSdCjyin4iFARTXOj17FWObSkkW7Y,A3fsA9Zfv1X2fVEQhTw51lKENdNrEqT3,9,8,0,0,0,0,2,0,10,1.4285714285714286,1,0.0,0,0,0,0,8,0,0,2,0,0,10,1
8377,144793,Q4yECXO7W1LpqtiMAu4zBn3zpNL7asTt,RXDvfPUBYFlVdlueBFbLW0mhhAyGEqpt,27,32,6,34,5,0,6,0,83,11.857142857142858,4,0.0,5,6,33,5,27,0,1,6,0,49,34,1
8378,145137,yCZXjIGq001xO7v4MWCrl9HykbxmZHu1,SpATywNh6bZuzm8s1ceuBUnMUAeoAHHw,13,20,10,20,0,0,5,0,55,7.857142857142857,3,0.0,6,10,17,0,14,0,3,5,0,33,22,0
8379,145155,BohRHH2vBIgnEZGZjM3WnHwJbVFmITRG,bWdj2GDclj5ofokWjzoa5jAwMkxCykd6,7,5,1,0,1,0,3,0,10,1.4285714285714286,1,0.0,0,1,0,1,5,0,0,3,0,2,8,1
8380,145183,l5XRpi9H4fQ2XUHeEPRXRHL6Y4BckIOB,bWdj2GDclj5ofokWjzoa5jAwMkxCykd6,3,1,1,0,1,0,0,0,3,0.42857142857142855,2,0.0,0,1,0,1,1,0,0,0,0,2,1,1
8381,145359,KF5OPToc2HXGCGomze0nhcEx5XKSQ0eb,bWdj2GDclj5ofokWjzoa5jAwMkxCykd6,5,3,1,0,1,0,2,0,7,1.0,1,0.0,0,1,0,1,3,0,0,2,0,2,5,1
8382,145473,UNqMz63UOiLuXMnJzd7YWyfD3qIuNdaK,A3fsA9Zfv1X2fVEQhTw51lKENdNrEqT3,16,7,7,0,6,0,2,0,22,3.142857142857143,1,0.0,0,7,0,6,7,0,0,2,0,13,9,1
8383,145546,OUbrW18OgibVb4I41eHFiFhkobpgjEP2,5X6FeZozNMgE2VRi3MJYjkkFK8SETtu2,67,112,36,0,64,0,19,0,231,33.0,8,0.0,50,36,0,64,62,0,0,19,0,150,81,0
8384,145656,MhPFQAgWNzlZ6Teq1DlKr26Z8E6wW1AP,5X6FeZozNMgE2VRi3MJYjkkFK8SETtu2,5,2,1,0,1,0,2,0,6,0.8571428571428571,1,0.0,0,1,0,1,2,0,0,2,0,2,4,1
8385,145662,SBDjqcJAy98nKfERlylEgYbif3PemxS8,5X6FeZozNMgE2VRi3MJYjkkFK8SETtu2,4,3,1,0,0,0,3,0,7,1.0,2,0.0,0,1,0,0,3,0,0,3,0,1,6,1
8386,145721,pxgIaZZAbkQ5oFydUV3lLrUkd7x4pWT5,5X6FeZozNMgE2VRi3MJYjkkFK8SETtu2,5,2,0,0,0,0,12,1,15,2.142857142857143,4,0.0,0,0,0,0,2,0,0,12,1,0,15,1
8387,145730,yB2j2tPO2DVKCBBdsLv8a1lbHtfWINMh,5X6FeZozNMgE2VRi3MJYjkkFK8SETtu2,1,0,0,0,0,0,2,0,2,0.2857142857142857,1,0.0,0,0,0,0,0,0,0,2,0,0,2,1
8388,145756,tFAmYxyKHBwgE3PLGd3A2TrV0pERnGhA,5X6FeZozNMgE2VRi3MJYjkkFK8SETtu2,1,0,0,0,0,0,1,0,1,0.14285714285714285,1,0.0,0,0,0,0,0,0,0,1,0,0,1,1
8389,145764,IL2QJO9D8DzgZ0CQ8CMzPpcGTIPKd3bR,5X6FeZozNMgE2VRi3MJYjkkFK8SETtu2,1,0,0,0,0,0,1,0,1,0.14285714285714285,1,0.0,0,0,0,0,0,0,0,1,0,0,1,1
8390,145783,lfRqSKrZDdqhfB8Fp83G9pBOvFDy0kAs,5X6FeZozNMgE2VRi3MJYjkkFK8SETtu2,4,3,1,0,1,0,4,0,9,1.2857142857142858,2,0.0,0,1,0,1,3,0,0,4,0,2,7,0
8391,145818,N6ImAosJzAVWR7oHFfpVfe8E1VJdiGsb,5X6FeZozNMgE2VRi3MJYjkkFK8SETtu2,5,0,0,0,0,0,6,1,7,1.0,1,0.0,0,0,0,0,0,0,0,6,1,0,7,1
8392,145967,S7Q03OvsYAC6WJ82BtJjyFFd4ZbHVwsc,5X6FeZozNMgE2VRi3MJYjkkFK8SETtu2,4,2,1,0,1,0,1,0,5,0.7142857142857143,1,0.0,0,1,0,1,2,0,0,1,0,2,3,1
8393,145972,mKd3zvTJo9oK9No6ynOqanGANGXWRpQi,5X6FeZozNMgE2VRi3MJYjkkFK8SETtu2,1,0,0,0,0,0,1,0,1,0.14285714285714285,1,0.0,0,0,0,0,0,0,0,1,0,0,1,1
8394,146040,W7w7kukRb5fyeDJG4hJEoYfw8z4oB9h4,3VkHkmOtom3jM2wCu94xgzzu1d6Dn7or,1,0,0,0,0,0,2,0,2,0.2857142857142857,1,0.0,0,0,0,0,0,0,0,2,0,0,2,1
8395,146061,2cuuFNfohxs6RAvZ8iFNkg7NwDHCUV7q,3VkHkmOtom3jM2wCu94xgzzu1d6Dn7or,6,4,2,0,1,0,3,0,10,1.4285714285714286,1,0.0,0,2,0,1,4,0,0,3,0,3,7,1
8396,146067,mEM8A2kmVuHC4sV6scGcy1odYGPgKuNu,3VkHkmOtom3jM2wCu94xgzzu1d6Dn7or,7,22,4,4,8,12,5,0,55,7.857142857142857,1,0.0,14,4,3,8,8,12,1,5,0,29,26,1
8397,146076,G7iw8Ow2rKfIJGgfBaIsUdrogzfflfzZ,3VkHkmOtom3jM2wCu94xgzzu1d6Dn7or,9,4,2,4,2,4,4,1,21,3.0,1,0.0,1,2,3,2,3,4,1,4,1,8,13,0
8398,146092,Kb9FWY0PsicXQgmzcMWxDWQGO7HlnhVG,3VkHkmOtom3jM2wCu94xgzzu1d6Dn7or,1,0,0,0,0,0,1,0,1,0.14285714285714285,1,0.0,0,0,0,0,0,0,0,1,0,0,1,1
8399,146124,KNNNASIFe9S4SmZEB0V1HUsimvNnV07D,3VkHkmOtom3jM2wCu94xgzzu1d6Dn7or,1,0,0,0,0,0,1,0,1,0.14285714285714285,1,0.0,0,0,0,0,0,0,0,1,0,0,1,1
8400,146151,JyOwpTqxlZyOZXFXAlv3kcbVV4zSYrRf,3VkHkmOtom3jM2wCu94xgzzu1d6Dn7or,63,49,43,0,31,0,8,0,131,18.714285714285715,1,0.0,0,43,0,31,49,0,0,8,0,74,57,1
8401,146156,HQX8GqAOKadmMWeHvhaF2p1OxKS3RM1p,3VkHkmOtom3jM2wCu94xgzzu1d6Dn7or,1,0,0,0,0,0,1,0,1,0.14285714285714285,1,0.0,0,0,0,0,0,0,0,1,0,0,1,1
8402,146168,dhfR4wGmOusRZWUPfjGh9lEKBfvvwgMt,3VkHkmOtom3jM2wCu94xgzzu1d6Dn7or,3,3,1,0,0,0,1,0,5,0.7142857142857143,1,0.0,0,1,0,0,3,0,0,1,0,1,4,1
8403,146175,cp3YBtv3LBPQsC9KSWwASci6TDzE2JIe,3VkHkmOtom3jM2wCu94xgzzu1d6Dn7or,9,7,4,0,3,4,15,1,34,4.857142857142857,1,0.0,1,4,0,3,6,4,0,15,1,8,26,0
8404,146238,uBtyLiWsbGp5ayAjbKWHJUEBC32rdTAZ,3VkHkmOtom3jM2wCu94xgzzu1d6Dn7or,1,0,0,0,0,0,1,0,1,0.14285714285714285,1,0.0,0,0,0,0,0,0,0,1,0,0,1,1
8405,146247,hq2dtaLjlwQ3cWU40bwr3Yz49cPq72t0,3VkHkmOtom3jM2wCu94xgzzu1d6Dn7or,1,0,0,0,0,0,1,0,1,0.14285714285714285,1,0.0,0,0,0,0,0,0,0,1,0,0,1,1
8406,146255,D6qj8t4GpKIMJAhLDD9jVxzUKaC5jI3i,3VkHkmOtom3jM2wCu94xgzzu1d6Dn7or,1,0,0,0,0,0,1,0,1,0.14285714285714285,1,0.0,0,0,0,0,0,0,0,1,0,0,1,1
8407,146264,tedGThhHMqVARfBh6zyzyocTKbTJYJpB,3VkHkmOtom3jM2wCu94xgzzu1d6Dn7or,13,13,7,0,5,7,9,0,41,5.857142857142857,5,0.0,1,7,0,5,12,7,0,9,0,13,28,0
8408,146267,qRGD5V0PdKSE2CFS7KLfMNLwdcSPFFnk,3VkHkmOtom3jM2wCu94xgzzu1d6Dn7or,93,217,141,128,72,26,21,2,607,86.71428571428571,10,0.0,46,141,120,72,171,26,8,21,2,379,228,0
8409,146275,nWnbhwHC6PAr74R8YCMXr6P4cjLNmd8R,3VkHkmOtom3jM2wCu94xgzzu1d6Dn7or,1,0,0,0,0,0,1,0,1,0.14285714285714285,1,0.0,0,0,0,0,0,0,0,1,0,0,1,1
8410,146290,O1c2CdbmcokDMtE3wXdu8jRs8pHCPANC,3VkHkmOtom3jM2wCu94xgzzu1d6Dn7or,1,0,0,0,0,0,1,0,1,0.14285714285714285,1,0.0,0,0,0,0,0,0,0,1,0,0,1,1
8411,146340,B6r6xBRcq9KnEwfJjEXKyZmquNqAin1X,3VkHkmOtom3jM2wCu94xgzzu1d6Dn7or,2,0,0,0,0,0,2,0,2,0.2857142857142857,1,0.0,0,0,0,0,0,0,0,2,0,0,2,1
8412,146344,2jiAw07SSoTp1cSsnG5DFrNlB8ZMTyTU,3VkHkmOtom3jM2wCu94xgzzu1d6Dn7or,2,0,0,0,0,0,2,0,2,0.2857142857142857,1,0.0,0,0,0,0,0,0,0,2,0,0,2,1
8413,146421,XPiIClmT9wmfbXtRommDRylOKqnUiWUh,3VkHkmOtom3jM2wCu94xgzzu1d6Dn7or,1,0,0,0,0,0,1,0,1,0.14285714285714285,1,0.0,0,0,0,0,0,0,0,1,0,0,1,1
8414,146436,5nsHG8ICnkRR2COH9CWk24a5jN4hps4A,3VkHkmOtom3jM2wCu94xgzzu1d6Dn7or,1,0,0,0,0,0,1,0,1,0.14285714285714285,1,0.0,0,0,0,0,0,0,0,1,0,0,1,1
8415,146438,InrSVF06p54GdJVp4rx5fFLgKthLjcPL,3VkHkmOtom3jM2wCu94xgzzu1d6Dn7or,1,0,0,0,0,0,1,0,1,0.14285714285714285,1,0.0,0,0,0,0,0,0,0,1,0,0,1,1
8416,146447,xZe5DWH0zyw28K4d6bC5DtWJN9b7w3SQ,3VkHkmOtom3jM2wCu94xgzzu1d6Dn7or,4,2,0,0,0,0,3,0,5,0.7142857142857143,2,0.0,0,0,0,0,2,0,0,3,0,0,5,0
8417,146463,W1dSTT9OrjhPeTl1UkP5xTii4aGqoMdD,3VkHkmOtom3jM2wCu94xgzzu1d6Dn7or,12,5,4,0,4,3,6,1,23,3.2857142857142856,1,0.0,0,4,0,4,5,3,0,6,1,8,15,1
8418,146467,mRaBEX7ZDfkFg6XYznVptg421BJGPS3w,3VkHkmOtom3jM2wCu94xgzzu1d6Dn7or,15,13,9,0,8,0,4,0,34,4.857142857142857,1,0.0,3,9,0,8,10,0,0,4,0,20,14,1
8419,146468,qqPYpd4V7fk70e4jFmsmBaSrfw8MV5oj,3VkHkmOtom3jM2wCu94xgzzu1d6Dn7or,10,11,5,0,1,0,9,1,27,3.857142857142857,1,0.0,3,5,0,1,8,0,0,9,1,9,18,1
8420,146479,TMdWz6KdPeUNjOfe2e47rXJreHutuNaG,3VkHkmOtom3jM2wCu94xgzzu1d6Dn7or,1,0,0,0,0,0,1,0,1,0.14285714285714285,1,0.0,0,0,0,0,0,0,0,1,0,0,1,0
8421,146523,QX4EKNbQ37sGymaBxyT9Ir3XbHOte346,3VkHkmOtom3jM2wCu94xgzzu1d6Dn7or,1,0,0,0,0,0,1,0,1,0.14285714285714285,1,0.0,0,0,0,0,0,0,0,1,0,0,1,1
8422,146550,W19NNaEb3YniuIHuoxhT6ig1vLTkLr1C,3VkHkmOtom3jM2wCu94xgzzu1d6Dn7or,7,3,1,0,1,5,6,1,17,2.4285714285714284,1,0.0,1,1,0,1,2,5,0,6,1,3,14,1
8423,146555,gqNraF3wWOQlSmRusk4t8x2p5vnofR8Z,3VkHkmOtom3jM2wCu94xgzzu1d6Dn7or,9,6,3,0,0,1,8,1,19,2.7142857142857144,1,0.0,0,3,0,0,6,1,0,8,1,3,16,1
8424,146556,Cub6N4R0eA9LTVmbHFyEMOSQZzjgSk0k,3VkHkmOtom3jM2wCu94xgzzu1d6Dn7or,1,0,0,0,0,0,1,0,1,0.14285714285714285,1,0.0,0,0,0,0,0,0,0,1,0,0,1,1
8425,146560,w0ZedS6yzDUKJT3yGrp9CDoxetDDlx17,3VkHkmOtom3jM2wCu94xgzzu1d6Dn7or,1,0,0,0,0,0,1,0,1,0.14285714285714285,1,0.0,0,0,0,0,0,0,0,1,0,0,1,1
8426,146568,ANC0sI5rGZOptNQXEXeynoEKn2Bpk1PU,3VkHkmOtom3jM2wCu94xgzzu1d6Dn7or,4,3,1,0,1,0,1,0,6,0.8571428571428571,1,0.0,1,1,0,1,2,0,0,1,0,3,3,1
8427,146587,bsCqmtAqNaQCj21SXSVvraawvK1Xs7lq,7GRhBDsirIGkRZBtSMEzNTyDr2JQm4xx,28,23,13,85,1,0,2,0,124,17.714285714285715,1,0.0,9,13,73,1,14,0,12,2,0,96,28,1
8428,146593,dnF4V3J1QcZ16kz7ecUJEPAkM9rOV7wb,7GRhBDsirIGkRZBtSMEzNTyDr2JQm4xx,15,15,1,0,1,3,9,1,30,4.285714285714286,1,0.0,5,1,0,1,10,3,0,9,1,7,23,1
8429,146594,dzZvmhMBCZUS7A4bdHQZaWrZNWx9wlnR,7GRhBDsirIGkRZBtSMEzNTyDr2JQm4xx,1,0,0,0,0,0,1,0,1,0.14285714285714285,1,0.0,0,0,0,0,0,0,0,1,0,0,1,1
8430,146595,8RnmMwVYLkHQpIdFveSYXWCrUhHSKLGY,7GRhBDsirIGkRZBtSMEzNTyDr2JQm4xx,6,4,2,0,1,0,6,0,13,1.8571428571428572,1,0.0,0,2,0,1,4,0,0,6,0,3,10,0
8431,146597,hZ1mlUhiSpFjS9yt4BS7Q5R6oePk7XBR,7GRhBDsirIGkRZBtSMEzNTyDr2JQm4xx,9,3,2,4,2,0,4,0,15,2.142857142857143,1,0.0,1,2,4,2,2,0,0,4,0,9,6,1
8432,146600,71W7HhcDinTUP0zgE4rLxxkJdz6hC2Hz,7GRhBDsirIGkRZBtSMEzNTyDr2JQm4xx,6,3,1,0,1,0,3,0,8,1.1428571428571428,1,0.0,1,1,0,1,2,0,0,3,0,3,5,1
8433,146601,9hgjLw4OD5u1XjZx0s9EMRnEguVXBlYy,7GRhBDsirIGkRZBtSMEzNTyDr2JQm4xx,5,4,1,0,1,0,1,0,7,1.0,1,0.0,0,1,0,1,4,0,0,1,0,2,5,1
8434,146604,ZsPJdwoEQb8InRLejOPcuY6swJrV6oQ3,7GRhBDsirIGkRZBtSMEzNTyDr2JQm4xx,13,13,8,2,5,0,8,0,36,5.142857142857143,1,0.0,1,8,1,5,12,0,1,8,0,15,21,0
8435,146606,NYjjMR7l6NyIwfJbId13oZriDSjO5w76,7GRhBDsirIGkRZBtSMEzNTyDr2JQm4xx,1,0,0,0,0,0,1,0,1,0.14285714285714285,1,0.0,0,0,0,0,0,0,0,1,0,0,1,1
8436,146611,l5helk32hI4ETTN4VOrcFpTlNH3wMw1m,7GRhBDsirIGkRZBtSMEzNTyDr2JQm4xx,1,0,0,0,0,0,1,0,1,0.14285714285714285,1,0.0,0,0,0,0,0,0,0,1,0,0,1,1
8437,146614,nYSFDE8RCbcZhD46fRSvPHUvA1ahfupi,7GRhBDsirIGkRZBtSMEzNTyDr2JQm4xx,1,0,0,0,0,0,1,0,1,0.14285714285714285,1,0.0,0,0,0,0,0,0,0,1,0,0,1,1
8438,146615,rmeg7X4GVDaLpVKMtXig1xBKyxmbOLNP,7GRhBDsirIGkRZBtSMEzNTyDr2JQm4xx,1,0,0,0,0,0,2,0,2,0.2857142857142857,1,0.0,0,0,0,0,0,0,0,2,0,0,2,0
8439,146620,Ie7mkAUCVVaLYxvosre748ADQJqirOJg,7GRhBDsirIGkRZBtSMEzNTyDr2JQm4xx,8,5,1,0,1,0,2,0,9,1.2857142857142858,1,0.0,0,1,0,1,5,0,0,2,0,2,7,0
8440,146623,0wC4PI4jS8ky1aVZrvOcvqnDnLi9NA2C,7GRhBDsirIGkRZBtSMEzNTyDr2JQm4xx,6,3,2,0,1,0,2,0,8,1.1428571428571428,1,0.0,0,2,0,1,3,0,0,2,0,3,5,1
8441,146624,YZyIrMXjSXhxrboobatJpuyyjWv0Oyj3,7GRhBDsirIGkRZBtSMEzNTyDr2JQm4xx,6,3,2,0,2,5,2,0,14,2.0,1,0.0,0,2,0,2,3,5,0,2,0,4,10,1
8442,146625,7MQqMUzAoBFEcqTatVu5Epa9H5xTJ6XT,7GRhBDsirIGkRZBtSMEzNTyDr2JQm4xx,7,3,2,0,2,0,2,0,9,1.2857142857142858,1,0.0,0,2,0,2,3,0,0,2,0,4,5,1
8443,146628,tXuRcAFaFByvXNxKsim61bqHMbW9oqtL,7GRhBDsirIGkRZBtSMEzNTyDr2JQm4xx,1,0,0,0,0,0,1,0,1,0.14285714285714285,1,0.0,0,0,0,0,0,0,0,1,0,0,1,1
8444,146629,8oJyzVb7BFYqXnIt8AZYBXv4pJ9iKX3G,7GRhBDsirIGkRZBtSMEzNTyDr2JQm4xx,2,0,0,0,0,0,2,0,2,0.2857142857142857,1,0.0,0,0,0,0,0,0,0,2,0,0,2,1
8445,146631,tVeEOWzSe7CPIDaNGoR1pPsk6HdeV1KT,7GRhBDsirIGkRZBtSMEzNTyDr2JQm4xx,5,3,1,0,1,0,1,0,6,0.8571428571428571,1,0.0,0,1,0,1,3,0,0,1,0,2,4,1
8446,146637,dY86ZxPBqjSMgAFRimg8dBRyb7lxvpAc,7GRhBDsirIGkRZBtSMEzNTyDr2JQm4xx,7,6,2,0,2,0,2,0,12,1.7142857142857142,1,0.0,0,2,0,2,6,0,0,2,0,4,8,1
8447,146644,bUoqFmbvMs2kDsdZ9ItKtLQ4XhI3NVJ3,7GRhBDsirIGkRZBtSMEzNTyDr2JQm4xx,4,0,0,0,0,0,4,1,5,0.7142857142857143,1,0.0,0,0,0,0,0,0,0,4,1,0,5,1
8448,146645,Izb8o21mmgCymJU96D1xtmXn2EAii5B9,7GRhBDsirIGkRZBtSMEzNTyDr2JQm4xx,2,0,0,0,0,0,2,0,2,0.2857142857142857,1,0.0,0,0,0,0,0,0,0,2,0,0,2,1
8449,146812,XagDu4hkCzepqbjuDS4lv6tXrIbANJ7d,3VkHkmOtom3jM2wCu94xgzzu1d6Dn7or,2,0,0,0,0,0,2,0,2,0.2857142857142857,1,0.0,0,0,0,0,0,0,0,2,0,0,2,1
8450,146813,aUc1hVYkIr3Bi8ayWwGmSU1k3jUQaTvk,3VkHkmOtom3jM2wCu94xgzzu1d6Dn7or,1,0,0,0,0,0,1,0,1,0.14285714285714285,1,0.0,0,0,0,0,0,0,0,1,0,0,1,1
8451,146819,N8lQ6CLzYLC3ZV1TIYvwSWjVTWycwKRr,3VkHkmOtom3jM2wCu94xgzzu1d6Dn7or,2,0,0,0,0,0,3,0,3,0.42857142857142855,2,0.0,0,0,0,0,0,0,0,3,0,0,3,1
8452,146821,vqyeWA2we44qvUIUFbVF8qhKfl0zvOXp,3VkHkmOtom3jM2wCu94xgzzu1d6Dn7or,49,34,16,15,16,0,4,0,85,12.142857142857142,3,0.0,15,16,15,16,19,0,0,4,0,62,23,1
8453,146823,8VkeQ6vW7DtspliemGGIOjJjjMTn28pE,3VkHkmOtom3jM2wCu94xgzzu1d6Dn7or,1,0,0,0,0,0,1,0,1,0.14285714285714285,1,0.0,0,0,0,0,0,0,0,1,0,0,1,1
8454,146824,jjOAKjtYOBkL8yZNAsflMgsU9RfSym9D,3VkHkmOtom3jM2wCu94xgzzu1d6Dn7or,5,10,3,0,3,0,3,0,19,2.7142857142857144,2,0.0,2,3,0,3,8,0,0,3,0,8,11,1
8455,146825,Tp2D7V75NteN6dQFehs9hNMrJBRpkxPX,3VkHkmOtom3jM2wCu94xgzzu1d6Dn7or,25,70,17,16,28,1,10,0,142,20.285714285714285,5,0.0,31,17,14,28,39,1,2,10,0,90,52,1
8456,146830,ctoPdFOBJpg0nTxrKk5e7epPXQMxn4iX,3VkHkmOtom3jM2wCu94xgzzu1d6Dn7or,12,11,3,0,4,2,8,1,29,4.142857142857143,2,0.0,0,3,0,4,11,2,0,8,1,7,22,1
8457,146833,V2iUVnY3CSvMzlrZ0MyTxlkeJjQz5mpT,3VkHkmOtom3jM2wCu94xgzzu1d6Dn7or,1,0,0,0,0,0,1,0,1,0.14285714285714285,1,0.0,0,0,0,0,0,0,0,1,0,0,1,1
8458,146835,VKiBSqrYzJuFe5S2BZbuXH48FUC79Gtr,3VkHkmOtom3jM2wCu94xgzzu1d6Dn7or,1,0,0,0,0,0,1,0,1,0.14285714285714285,1,0.0,0,0,0,0,0,0,0,1,0,0,1,1
8459,146839,YtCuvR5UYZ8LxqORGQ1uRsqkW1gtkDSJ,3VkHkmOtom3jM2wCu94xgzzu1d6Dn7or,14,15,6,2,6,3,20,1,53,7.571428571428571,2,0.0,6,6,2,6,9,3,0,20,1,20,33,1
8460,146846,An7AClehL7KKsUMywV24moWRw87BMWvj,3VkHkmOtom3jM2wCu94xgzzu1d6Dn7or,1,0,0,0,0,0,2,0,2,0.2857142857142857,1,0.0,0,0,0,0,0,0,0,2,0,0,2,1
8461,146855,1nspOxKjeqkzbhkH0i88IGU57XOmdJC9,3VkHkmOtom3jM2wCu94xgzzu1d6Dn7or,1,0,0,0,0,0,1,0,1,0.14285714285714285,1,0.0,0,0,0,0,0,0,0,1,0,0,1,1
8462,146856,BSqSPuPzdThO0IEloLvzaEvo8wlsTmWV,3VkHkmOtom3jM2wCu94xgzzu1d6Dn7or,1,0,0,0,0,0,1,0,1,0.14285714285714285,1,0.0,0,0,0,0,0,0,0,1,0,0,1,1
8463,146858,zP3de4W3VukAs6WLm1x1S3emx69koHez,3VkHkmOtom3jM2wCu94xgzzu1d6Dn7or,15,9,7,0,6,0,10,0,32,4.571428571428571,2,0.0,0,7,0,6,9,0,0,10,0,13,19,1
8464,146866,DEmzKJKEa87bk5Nj3kLKZfbzlMFWSTyw,3VkHkmOtom3jM2wCu94xgzzu1d6Dn7or,6,2,1,0,1,0,4,0,8,1.1428571428571428,1,0.0,0,1,0,1,2,0,0,4,0,2,6,0
8465,146867,8YR0tcT3D8d0JlIytw4LxKfYYQekJyvj,3VkHkmOtom3jM2wCu94xgzzu1d6Dn7or,6,8,3,0,0,0,4,0,15,2.142857142857143,1,0.0,0,3,0,0,8,0,0,4,0,3,12,1
8466,146869,kgifad5hWbJa54UiSAdJkYmaxfCMApM0,3VkHkmOtom3jM2wCu94xgzzu1d6Dn7or,18,16,8,1,7,3,6,0,41,5.857142857142857,2,0.0,5,8,1,7,11,3,0,6,0,21,20,1
8467,146873,snoVfOu7m3uQyb0rtN2hVEbVR2VoIt0E,3VkHkmOtom3jM2wCu94xgzzu1d6Dn7or,4,3,1,0,1,0,3,0,8,1.1428571428571428,1,0.0,0,1,0,1,3,0,0,3,0,2,6,1
8468,146878,cvqWICHAvT6CaBGvYZUWhvOAiDb9j0Me,3VkHkmOtom3jM2wCu94xgzzu1d6Dn7or,1,0,0,0,0,0,1,0,1,0.14285714285714285,1,0.0,0,0,0,0,0,0,0,1,0,0,1,1
8469,146881,h3aXpApcY8jToOsnJLXRcKr3ekv98gLc,3VkHkmOtom3jM2wCu94xgzzu1d6Dn7or,15,65,18,11,17,12,18,1,142,20.285714285714285,4,0.0,34,18,10,17,31,12,1,18,1,79,63,1
8470,146882,c1uYia723nClxDKNu9rmnYCUymt3ImcO,3VkHkmOtom3jM2wCu94xgzzu1d6Dn7or,8,3,2,0,2,0,3,0,10,1.4285714285714286,1,0.0,0,2,0,2,3,0,0,3,0,4,6,1
8471,146884,0EaAPD8sDKYTUVUuY5hfwfTg95KpJwaS,3VkHkmOtom3jM2wCu94xgzzu1d6Dn7or,4,2,1,0,0,0,3,0,6,0.8571428571428571,1,0.0,0,1,0,0,2,0,0,3,0,1,5,1
8472,146885,OZTh4ep7z08AOS3ZsuCu3y1D1zR5lDdF,3VkHkmOtom3jM2wCu94xgzzu1d6Dn7or,1,0,0,0,0,0,2,0,2,0.2857142857142857,1,0.0,0,0,0,0,0,0,0,2,0,0,2,1
8473,146886,RpeDfJx5VsHPwt60dv6agumhYI1jfzKU,3VkHkmOtom3jM2wCu94xgzzu1d6Dn7or,1,0,0,0,0,0,1,0,1,0.14285714285714285,1,0.0,0,0,0,0,0,0,0,1,0,0,1,1
8474,146889,Z9XzWzse1KPDWCqWuVan0KrksXlGEkQ7,3VkHkmOtom3jM2wCu94xgzzu1d6Dn7or,4,4,1,0,0,0,1,0,6,0.8571428571428571,1,0.0,0,1,0,0,4,0,0,1,0,1,5,1
8475,146900,UrENN1zIfJIc4hCxDDWe8c7coKokiTdF,3VkHkmOtom3jM2wCu94xgzzu1d6Dn7or,12,22,7,0,5,14,7,1,56,8.0,2,0.0,12,7,0,5,10,14,0,7,1,24,32,1
8476,147112,sL5jw3pLWZoRI7avI17oM60mfF67Acgz,G8EPVSXsOYB5YQWZGiz1aVq5Pgr2GrQu,1,0,0,0,0,0,1,0,1,0.14285714285714285,1,0.0,0,0,0,0,0,0,0,1,0,0,1,0
8477,147711,Z96ghDF2SEO6eJyjMUuyfBwUaW4sni8D,G8EPVSXsOYB5YQWZGiz1aVq5Pgr2GrQu,5,4,2,0,1,0,2,0,9,1.2857142857142858,1,0.0,0,2,0,1,4,0,0,2,0,3,6,1
8478,147761,6lr9avMLLLHkFmJUiXzIeIFidbBgUCxs,fbPkOYLVPtPgIt0MxizjfFJov3JbHyAi,9,10,5,0,3,0,2,0,20,2.857142857142857,1,0.0,0,5,0,3,10,0,0,2,0,8,12,1
8479,147821,vwPF6VT57NbHM7qmKbjBBFqRnUSU14SJ,5Gyp41oLVo7Gg7vF4vpmggWP5MU70QO6,6,12,1,0,1,0,3,0,17,2.4285714285714284,1,0.0,4,1,0,1,8,0,0,3,0,6,11,1
8480,147848,mcSjHTQSOL9z6LfIHOZuth326lgoEoEd,5Gyp41oLVo7Gg7vF4vpmggWP5MU70QO6,1,0,0,0,0,0,1,0,1,0.14285714285714285,1,0.0,0,0,0,0,0,0,0,1,0,0,1,1
8481,147861,r7ZNKfyPfaB5iuFN7dBvabbfUQsnLLIa,5Gyp41oLVo7Gg7vF4vpmggWP5MU70QO6,7,5,3,0,2,0,2,0,12,1.7142857142857142,1,0.0,0,3,0,2,5,0,0,2,0,5,7,1
8482,147862,hNGJlyUB2P1CG5JnrmgJCmY3fcQNspAh,5Gyp41oLVo7Gg7vF4vpmggWP5MU70QO6,1,0,0,0,0,0,1,0,1,0.14285714285714285,1,0.0,0,0,0,0,0,0,0,1,0,0,1,1
8483,147864,cYSbDpXSgB0u0usGKf1fSijPCnFEetgi,5Gyp41oLVo7Gg7vF4vpmggWP5MU70QO6,7,3,2,0,2,0,3,0,10,1.4285714285714286,2,0.0,0,2,0,2,3,0,0,3,0,4,6,1
8484,147897,GEeTuFvLbFBqRdEaOrJebonF0k4gv8Hl,5Gyp41oLVo7Gg7vF4vpmggWP5MU70QO6,7,4,2,0,1,0,2,0,9,1.2857142857142858,1,0.0,0,2,0,1,4,0,0,2,0,3,6,1
8485,147914,LFilEku9rIeW4NBW6GdXkxreRXuabrx6,5Gyp41oLVo7Gg7vF4vpmggWP5MU70QO6,1,0,0,0,0,0,1,0,1,0.14285714285714285,1,0.0,0,0,0,0,0,0,0,1,0,0,1,1
8486,147940,2jLM7Yi5RJYMPqOXOcapsjfy9JxX4cwG,5Gyp41oLVo7Gg7vF4vpmggWP5MU70QO6,1,0,0,0,0,0,1,0,1,0.14285714285714285,1,0.0,0,0,0,0,0,0,0,1,0,0,1,1
8487,147953,lgIEHykE0pF9d9IoqRRn9VtJnlpY5HJm,5Gyp41oLVo7Gg7vF4vpmggWP5MU70QO6,12,10,6,0,5,0,3,0,24,3.4285714285714284,2,0.0,1,6,0,5,9,0,0,3,0,12,12,1
8488,147977,4IEJgFckVDYyK0TdJX6AWQo7iRJxKRjO,5Gyp41oLVo7Gg7vF4vpmggWP5MU70QO6,4,2,1,0,1,0,1,0,5,0.7142857142857143,1,0.0,0,1,0,1,2,0,0,1,0,2,3,0
8489,147980,AHKBTPZSPkJAg7haUc3x41qrONIJZttH,5Gyp41oLVo7Gg7vF4vpmggWP5MU70QO6,7,3,2,0,2,0,2,0,9,1.2857142857142858,1,0.0,0,2,0,2,3,0,0,2,0,4,5,1
8490,147995,Kk4qLSQ2AxVjTd7A6tnZX4CxeQDvcBV6,5Gyp41oLVo7Gg7vF4vpmggWP5MU70QO6,1,0,0,0,0,0,1,0,1,0.14285714285714285,1,0.0,0,0,0,0,0,0,0,1,0,0,1,1
8491,147996,bfBxNQMcuVNW7LDD2R5yMC1xIByfnHXU,5Gyp41oLVo7Gg7vF4vpmggWP5MU70QO6,12,14,8,4,6,12,13,0,57,8.142857142857142,2,0.0,6,8,3,6,8,12,1,13,0,23,34,1
8492,148016,liVcNKuy8NKldEWBSMczxU7EXyV6T6hK,5Gyp41oLVo7Gg7vF4vpmggWP5MU70QO6,9,11,4,0,1,0,2,0,18,2.5714285714285716,1,0.0,0,4,0,1,11,0,0,2,0,5,13,1
8493,148018,kLbYKjAePyQg6GOXHiVGeoyhhDvXEfjN,5Gyp41oLVo7Gg7vF4vpmggWP5MU70QO6,8,10,5,0,4,9,6,0,34,4.857142857142857,2,0.0,1,5,0,4,9,9,0,6,0,10,24,1
8494,148045,EhHrinjt1AkEWC09AFZwBuP61S5NJgjn,5Gyp41oLVo7Gg7vF4vpmggWP5MU70QO6,5,3,2,0,1,0,2,0,8,1.1428571428571428,1,0.0,0,2,0,1,3,0,0,2,0,3,5,1
8495,148058,ZWfn9Qrexzw0TlKEc4xN96rrMrARFmjm,5Gyp41oLVo7Gg7vF4vpmggWP5MU70QO6,15,52,21,19,3,22,11,1,129,18.428571428571427,5,0.0,17,21,13,3,35,22,6,11,1,54,75,1
8496,148074,hAI9XjsP1LdynF1kDeMzEsHlT2S6mHfF,5Gyp41oLVo7Gg7vF4vpmggWP5MU70QO6,5,3,2,0,0,0,2,0,7,1.0,1,0.0,0,2,0,0,3,0,0,2,0,2,5,1
8497,148095,S6eQGQp3K76RS5VMtIsaLuIm5UHtwYF7,5Gyp41oLVo7Gg7vF4vpmggWP5MU70QO6,5,3,0,0,0,0,2,0,5,0.7142857142857143,1,0.0,0,0,0,0,3,0,0,2,0,0,5,1
8498,148101,VIOyemRRFrXWntjMeQE5BIDDfZKrmIOJ,5Gyp41oLVo7Gg7vF4vpmggWP5MU70QO6,16,19,7,34,1,0,3,0,64,9.142857142857142,2,0.0,9,7,30,1,10,0,4,3,0,47,17,1
8499,148145,9wg9m774iuq3pR6rOrvscc7iujIj3xXq,5Gyp41oLVo7Gg7vF4vpmggWP5MU70QO6,9,5,4,0,2,4,6,1,22,3.142857142857143,2,0.0,0,4,0,2,5,4,0,6,1,6,16,1
8500,148149,EfDeDofZCstYQkNYYHKFaYZxqK08b71W,5Gyp41oLVo7Gg7vF4vpmggWP5MU70QO6,10,10,4,2,2,0,3,0,21,3.0,1,0.0,3,4,1,2,7,0,1,3,0,10,11,1
8501,148185,nxuexUreiYSzpSapqT3MF6tzgH9I1i5D,5Gyp41oLVo7Gg7vF4vpmggWP5MU70QO6,1,0,0,0,0,0,1,0,1,0.14285714285714285,1,0.0,0,0,0,0,0,0,0,1,0,0,1,1
8502,148210,r0ZdlKlEsmKZY094aSTCPxTKx82Pv4jZ,5Gyp41oLVo7Gg7vF4vpmggWP5MU70QO6,1,0,0,0,0,0,2,0,2,0.2857142857142857,2,0.0,0,0,0,0,0,0,0,2,0,0,2,1
8503,148219,fdTsFUNyxhV3QSWRE8RUmvDPSdhQdl21,5Gyp41oLVo7Gg7vF4vpmggWP5MU70QO6,1,0,0,0,0,0,2,0,2,0.2857142857142857,1,0.0,0,0,0,0,0,0,0,2,0,0,2,1
8504,148228,oNZ3DXCkk7XW6inyhpsoUnmkrA33Svnv,5Gyp41oLVo7Gg7vF4vpmggWP5MU70QO6,1,0,0,0,0,0,1,0,1,0.14285714285714285,1,0.0,0,0,0,0,0,0,0,1,0,0,1,1
8505,148237,bABqZWLgkTHxk42Q4d3YNsSf4EbJAvcM,5Gyp41oLVo7Gg7vF4vpmggWP5MU70QO6,1,0,0,0,0,0,1,0,1,0.14285714285714285,1,0.0,0,0,0,0,0,0,0,1,0,0,1,1
8506,148249,9vLumExx1xl0nhuk7uTK1p4k831n5pUZ,5Gyp41oLVo7Gg7vF4vpmggWP5MU70QO6,5,5,2,0,0,0,2,0,9,1.2857142857142858,2,0.0,0,2,0,0,5,0,0,2,0,2,7,1
8507,148270,N8VKFfYaHOHH283pnOeVqQHkFc9l2CFJ,5Gyp41oLVo7Gg7vF4vpmggWP5MU70QO6,8,11,7,0,2,0,5,0,25,3.5714285714285716,4,0.0,0,7,0,2,11,0,0,5,0,9,16,1
8508,148282,JaeJlL8VWrTrl4h8J5ZbrhqwTWf0YYii,5Gyp41oLVo7Gg7vF4vpmggWP5MU70QO6,1,0,0,0,0,0,1,0,1,0.14285714285714285,1,0.0,0,0,0,0,0,0,0,1,0,0,1,1
8509,148299,eE1Ts31Y4vQL30WuFQSepkqre5sjHOf7,7GRhBDsirIGkRZBtSMEzNTyDr2JQm4xx,1,0,0,0,0,0,1,0,1,0.14285714285714285,1,0.0,0,0,0,0,0,0,0,1,0,0,1,1
8510,148301,elqCSd4eO0A49ONvuqE5ggawcusF9OMd,7GRhBDsirIGkRZBtSMEzNTyDr2JQm4xx,2,0,0,0,0,0,3,0,3,0.42857142857142855,1,0.0,0,0,0,0,0,0,0,3,0,0,3,1
8511,148304,6KxCV7VkkZIrRaqYpSYY89Ir7cXH4xtD,7GRhBDsirIGkRZBtSMEzNTyDr2JQm4xx,2,0,0,0,0,0,2,0,2,0.2857142857142857,1,0.0,0,0,0,0,0,0,0,2,0,0,2,1
8512,148315,jjzQh09Stl6cVXi1ZQo3Pv6tq0jdTVVF,7GRhBDsirIGkRZBtSMEzNTyDr2JQm4xx,15,9,6,0,7,0,4,0,26,3.7142857142857144,1,0.0,2,6,0,7,7,0,0,4,0,15,11,1
8513,148322,F0RLgmYiXL15kHHj9b0Z5YMHlqPfXUde,7GRhBDsirIGkRZBtSMEzNTyDr2JQm4xx,2,0,0,0,0,0,2,0,2,0.2857142857142857,1,0.0,0,0,0,0,0,0,0,2,0,0,2,1
8514,148327,gTiKF0u9RAj0oY7KbpTkxLnUSHlbIBy0,7GRhBDsirIGkRZBtSMEzNTyDr2JQm4xx,6,4,2,0,1,0,3,0,10,1.4285714285714286,1,0.0,0,2,0,1,4,0,0,3,0,3,7,0
8515,148334,7gxdF7npc77h7z0KnU9ezGYqtBJqY4fQ,7GRhBDsirIGkRZBtSMEzNTyDr2JQm4xx,5,3,2,0,1,0,1,0,7,1.0,1,0.0,0,2,0,1,3,0,0,1,0,3,4,0
8516,148335,o5YWOidjiSfpyoPVxXwOOyp6YMlu6cLI,7GRhBDsirIGkRZBtSMEzNTyDr2JQm4xx,8,2,2,0,2,0,3,0,9,1.2857142857142858,1,0.0,0,2,0,2,2,0,0,3,0,4,5,1
8517,148336,TeZXUSutbsmNXdzi2NrkH6J9hvtArj9z,7GRhBDsirIGkRZBtSMEzNTyDr2JQm4xx,1,0,0,0,0,0,1,0,1,0.14285714285714285,1,0.0,0,0,0,0,0,0,0,1,0,0,1,1
8518,148338,WAcTGSdYMLZyVm3rvDYowMxo60tUby3f,7GRhBDsirIGkRZBtSMEzNTyDr2JQm4xx,5,2,0,0,0,0,3,0,5,0.7142857142857143,1,0.0,0,0,0,0,2,0,0,3,0,0,5,0
8519,148343,N1Llejjvx4rBl0rzI2QI7SJmJJvL8DQz,7GRhBDsirIGkRZBtSMEzNTyDr2JQm4xx,8,6,1,0,1,0,2,0,10,1.4285714285714286,1,0.0,0,1,0,1,6,0,0,2,0,2,8,0
8520,148345,e12yxd6uz73QWrdry5pnSZL6kz47BqeT,7GRhBDsirIGkRZBtSMEzNTyDr2JQm4xx,1,0,0,0,0,0,1,0,1,0.14285714285714285,1,0.0,0,0,0,0,0,0,0,1,0,0,1,1
8521,148352,jHtmhjYvIQCrHvgDxRflQ5IxXJSVFYuQ,fbPkOYLVPtPgIt0MxizjfFJov3JbHyAi,5,4,2,0,0,0,1,0,7,1.0,1,0.0,0,2,0,0,4,0,0,1,0,2,5,1
8522,148386,3J1rNe3uRvedZitqeCdyMGosrBYsQChl,fbPkOYLVPtPgIt0MxizjfFJov3JbHyAi,43,69,39,1,27,0,14,0,150,21.428571428571427,4,0.0,15,39,1,27,54,0,0,14,0,82,68,0
8523,148454,te56qI7gFuKkLlkl183DRyiCJEOrbcwN,G8EPVSXsOYB5YQWZGiz1aVq5Pgr2GrQu,5,2,2,0,1,0,2,0,7,1.0,1,0.0,0,2,0,1,2,0,0,2,0,3,4,1
8524,148471,kvxGydllm6BLbdP0nm9jaxgMVk1FHTYp,bWdj2GDclj5ofokWjzoa5jAwMkxCykd6,3,0,1,0,0,6,2,0,9,1.2857142857142858,1,0.0,0,1,0,0,0,6,0,2,0,1,8,1
8525,148501,4Tr4zS1WTYozCucBhtide31lwvTCWT44,SpATywNh6bZuzm8s1ceuBUnMUAeoAHHw,18,18,1,0,1,0,6,0,26,3.7142857142857144,1,0.0,0,1,0,1,18,0,0,6,0,2,24,0
8526,148536,uUMzdUTmgEhjr2EnA8XtLfriryCG2TOf,SpATywNh6bZuzm8s1ceuBUnMUAeoAHHw,14,14,0,7,0,4,5,0,30,4.285714285714286,2,0.0,2,0,7,0,12,4,0,5,0,9,21,0
8527,148537,Wz31P9oU8oqAKC2lD9NdSTmdPqPDYHDG,SpATywNh6bZuzm8s1ceuBUnMUAeoAHHw,13,13,7,0,5,0,3,0,28,4.0,1,0.0,0,7,0,5,13,0,0,3,0,12,16,0
8528,148582,57XEpd7q9eLjUEqADz7df27SQD70MfYe,bWdj2GDclj5ofokWjzoa5jAwMkxCykd6,1,0,0,0,0,0,1,0,1,0.14285714285714285,1,0.0,0,0,0,0,0,0,0,1,0,0,1,1
8529,148587,LIH6u87VTR1542727Uc42mhP2iK5GaFP,SpATywNh6bZuzm8s1ceuBUnMUAeoAHHw,42,115,4,66,5,73,16,6,285,40.714285714285715,4,0.0,30,4,55,5,85,73,11,16,6,94,191,0
8530,148636,YGIT86NvFI4VgCaWYbdXDpMicnXWdkpA,SpATywNh6bZuzm8s1ceuBUnMUAeoAHHw,6,3,0,0,0,1,4,0,8,1.1428571428571428,1,0.0,0,0,0,0,3,1,0,4,0,0,8,1
8531,148664,8kDMxN2jxnl0uIdlggQjT6QmHT7F6WvQ,bWdj2GDclj5ofokWjzoa5jAwMkxCykd6,7,7,0,0,1,0,6,0,14,2.0,1,0.0,2,0,0,1,5,0,0,6,0,3,11,0
8532,148675,yIj21E2mCqn2XcQ0nicOfMS257aUaO89,SpATywNh6bZuzm8s1ceuBUnMUAeoAHHw,4,2,1,0,0,0,2,0,5,0.7142857142857143,1,0.0,0,1,0,0,2,0,0,2,0,1,4,1
8533,148693,X87AkROV0ttGnQ3ululsZr5YLOH5E6sv,SpATywNh6bZuzm8s1ceuBUnMUAeoAHHw,7,5,0,0,0,0,4,1,10,1.4285714285714286,1,0.0,0,0,0,0,5,0,0,4,1,0,10,1
8534,148694,XydvMA0BgL1Al10q3L0D2wz1Y6wVb2rC,bWdj2GDclj5ofokWjzoa5jAwMkxCykd6,8,9,7,0,3,0,2,0,21,3.0,2,0.0,0,7,0,3,9,0,0,2,0,10,11,0
8535,148703,8QMdlZxyKAn04Pw5BIZ4rThXz4ELvpac,5X6FeZozNMgE2VRi3MJYjkkFK8SETtu2,3,2,1,0,0,0,1,0,4,0.5714285714285714,1,0.0,0,1,0,0,2,0,0,1,0,1,3,1
8536,148706,uhhlffPGiUyqHwKWs4eYUM0KXbbqijwF,A3fsA9Zfv1X2fVEQhTw51lKENdNrEqT3,50,29,19,74,12,0,13,0,147,21.0,3,0.0,1,19,70,12,28,0,4,13,0,102,45,1
8537,148719,N3OsF9jMX2xD2050jaDhIqxda4oH2JqK,SpATywNh6bZuzm8s1ceuBUnMUAeoAHHw,6,1,1,0,1,0,4,0,7,1.0,1,0.0,0,1,0,1,1,0,0,4,0,2,5,1
8538,148727,ztmaclrddFYSGIsZoWSUrGCZBLNiuvyf,A3fsA9Zfv1X2fVEQhTw51lKENdNrEqT3,7,7,2,0,2,0,3,0,14,2.0,2,0.0,0,2,0,2,7,0,0,3,0,4,10,1
8539,148759,wPfoqCyL8nnMnw3aXjeD5ZCbRsGcflJj,5X6FeZozNMgE2VRi3MJYjkkFK8SETtu2,8,2,1,0,1,1,6,1,12,1.7142857142857142,1,0.0,0,1,0,1,2,1,0,6,1,2,10,1
8540,148764,H8ezTdcT6g0YnTiYoF3JufrrIki7TyuK,SpATywNh6bZuzm8s1ceuBUnMUAeoAHHw,1,0,0,0,0,0,1,0,1,0.14285714285714285,1,0.0,0,0,0,0,0,0,0,1,0,0,1,1
8541,148771,TzODuX5kuf2iqGNG9vk0uMzeGNqx5LsA,5X6FeZozNMgE2VRi3MJYjkkFK8SETtu2,1,0,0,0,0,0,1,0,1,0.14285714285714285,1,0.0,0,0,0,0,0,0,0,1,0,0,1,1
8542,148774,IUpZNQQ76AoR385Wqa8vebjq7ArbhJTb,SpATywNh6bZuzm8s1ceuBUnMUAeoAHHw,2,0,0,0,0,0,3,0,3,0.42857142857142855,1,0.0,0,0,0,0,0,0,0,3,0,0,3,1
8543,148775,ekMrVrkv40HZdLDo9tqIMgEIyZWOta2b,SpATywNh6bZuzm8s1ceuBUnMUAeoAHHw,2,0,0,0,0,0,4,0,4,0.5714285714285714,1,0.0,0,0,0,0,0,0,0,4,0,0,4,1
8544,148782,aEQ5RWk2htbuTN4mvNYSDzvWipN5MIrs,SpATywNh6bZuzm8s1ceuBUnMUAeoAHHw,4,3,2,0,0,0,1,0,6,0.8571428571428571,1,0.0,0,2,0,0,3,0,0,1,0,2,4,1
8545,148830,9Se0fuNtnF0aDoUMyiU1YG9IfxiIm4MD,SpATywNh6bZuzm8s1ceuBUnMUAeoAHHw,4,6,1,0,0,1,2,0,10,1.4285714285714286,1,0.0,0,1,0,0,6,1,0,2,0,1,9,1
8546,148843,El7h5k9dEnkCTNiRD6ocpDGK1aq9r5Q4,SpATywNh6bZuzm8s1ceuBUnMUAeoAHHw,26,29,0,49,1,8,7,4,98,14.0,2,0.0,8,0,44,1,21,8,5,7,4,53,45,1
8547,148850,PBxGz02oVqhnVrBe7XS94DBCYm6qdsBz,5X6FeZozNMgE2VRi3MJYjkkFK8SETtu2,6,9,1,0,1,1,5,1,18,2.5714285714285716,2,0.0,4,1,0,1,5,1,0,5,1,6,12,1
8548,148853,GMzSpgZQ6jzVsfHn8W8i83JsYNxnP00b,SpATywNh6bZuzm8s1ceuBUnMUAeoAHHw,7,7,4,0,1,3,3,0,18,2.5714285714285716,2,0.0,1,4,0,1,6,3,0,3,0,6,12,0
8549,148855,i7oHLg2mT287Keuj3rMh6YGhkeP2LXJu,SpATywNh6bZuzm8s1ceuBUnMUAeoAHHw,8,8,3,8,0,0,2,0,21,3.0,1,0.0,2,3,8,0,6,0,0,2,0,13,8,0
8550,148860,19rBJNWc3TdUmLpZx1LViNSUBx0S4WJI,RXDvfPUBYFlVdlueBFbLW0mhhAyGEqpt,42,107,3,94,4,21,10,2,241,34.42857142857143,4,0.0,18,3,78,4,89,21,16,10,2,103,138,0
8551,148862,tokl4cbgqenBB3p80DKDbEkMdt5UNKcq,bWdj2GDclj5ofokWjzoa5jAwMkxCykd6,1,0,0,0,0,0,1,0,1,0.14285714285714285,1,0.0,0,0,0,0,0,0,0,1,0,0,1,1
8552,148866,GMzSpgZQ6jzVsfHn8W8i83JsYNxnP00b,5X6FeZozNMgE2VRi3MJYjkkFK8SETtu2,7,19,6,0,6,0,7,0,38,5.428571428571429,5,0.0,10,6,0,6,9,0,0,7,0,22,16,0
8553,148872,qVcmGkb48Jwwh6kGDe1CyZ7Dz9mYTEB0,5X6FeZozNMgE2VRi3MJYjkkFK8SETtu2,18,42,10,25,17,6,14,1,115,16.428571428571427,2,0.0,29,10,21,17,13,6,4,14,1,77,38,1
8554,148887,3ZefMxrbuS4ZPh42woxBoX8qAAYX0xUm,SpATywNh6bZuzm8s1ceuBUnMUAeoAHHw,24,36,21,0,9,0,7,0,73,10.428571428571429,4,0.0,0,21,0,9,36,0,0,7,0,30,43,1
8555,148889,FfcTObRCiOI4G2Wr1mPTKVvYF2y6uaxX,SpATywNh6bZuzm8s1ceuBUnMUAeoAHHw,46,50,29,12,16,3,16,1,127,18.142857142857142,4,0.0,13,29,9,16,37,3,3,16,1,67,60,0
8556,148891,NeX5WIvNO61tAJ0N6KZLQNKDzSgefHyw,SpATywNh6bZuzm8s1ceuBUnMUAeoAHHw,9,4,3,0,3,0,2,0,12,1.7142857142857142,1,0.0,0,3,0,3,4,0,0,2,0,6,6,1
8557,148898,dmiS38puwcnYb2MLpVYDLXrff1rXPclk,SpATywNh6bZuzm8s1ceuBUnMUAeoAHHw,16,10,8,0,7,0,3,0,28,4.0,2,0.0,0,8,0,7,10,0,0,3,0,15,13,1
8558,148904,xIxATd7wQJbG534PldlbQAAGp3iomo3s,SpATywNh6bZuzm8s1ceuBUnMUAeoAHHw,20,24,11,12,5,0,4,0,56,8.0,2,0.0,5,11,11,5,19,0,1,4,0,32,24,1
8559,148914,LbPeDWFrn9j3yYrmiVi11XwmZSkXkuCH,RXDvfPUBYFlVdlueBFbLW0mhhAyGEqpt,7,1,1,0,1,0,4,0,7,1.0,1,0.0,0,1,0,1,1,0,0,4,0,2,5,1
8560,148932,f0CZWgfk8f6S4ovPwdy7Xv8E5izRkjyc,5X6FeZozNMgE2VRi3MJYjkkFK8SETtu2,14,24,1,16,5,0,6,0,52,7.428571428571429,3,0.0,11,1,14,5,13,0,2,6,0,31,21,1
8561,148949,KVBhg9xLiQ9g29dG7acnqU2JhAhcB1WP,SpATywNh6bZuzm8s1ceuBUnMUAeoAHHw,3,2,1,0,0,4,3,0,10,1.4285714285714286,1,0.0,0,1,0,0,2,4,0,3,0,1,9,1
8562,148953,KVBhg9xLiQ9g29dG7acnqU2JhAhcB1WP,bWdj2GDclj5ofokWjzoa5jAwMkxCykd6,2,0,0,0,0,1,1,0,2,0.2857142857142857,1,0.0,0,0,0,0,0,1,0,1,0,0,2,1
8563,148956,ryiQYyVYMdwKFXJfIVJiBqI3D0XwNLw1,5X6FeZozNMgE2VRi3MJYjkkFK8SETtu2,1,0,0,0,0,0,1,0,1,0.14285714285714285,1,0.0,0,0,0,0,0,0,0,1,0,0,1,1
8564,148972,nCi2pdM7sw91EDGAoZtmNoRGljKaB4FL,SpATywNh6bZuzm8s1ceuBUnMUAeoAHHw,31,36,25,25,14,0,5,0,105,15.0,2,0.0,4,25,23,14,32,0,2,5,0,66,39,0
8565,148990,20I5SaS0igQRUVi5mJhXJNLvLOuP8SMJ,RXDvfPUBYFlVdlueBFbLW0mhhAyGEqpt,1,0,0,0,0,0,1,0,1,0.14285714285714285,1,0.0,0,0,0,0,0,0,0,1,0,0,1,1
8566,149000,Yb0bWnMJwOMhFqTdED4i9VTc62YQyUpV,SpATywNh6bZuzm8s1ceuBUnMUAeoAHHw,1,0,0,0,0,0,1,0,1,0.14285714285714285,1,0.0,0,0,0,0,0,0,0,1,0,0,1,1
8567,149016,BXEKxoXoxulJe6lVUNmBzkuoxML0RzPQ,SpATywNh6bZuzm8s1ceuBUnMUAeoAHHw,21,34,1,1,1,0,1,0,38,5.428571428571429,1,0.0,2,1,1,1,32,0,0,1,0,5,33,1
8568,149024,7FIeNTQkn5xTpBcMu7fzrbX3yIgG7ERg,SpATywNh6bZuzm8s1ceuBUnMUAeoAHHw,16,16,16,0,15,0,8,0,55,7.857142857142857,5,0.0,0,16,0,15,16,0,0,8,0,31,24,0
8569,149027,3aZ1iGazVEuu24IRiWpZVTgWZ6Q7Vofo,SpATywNh6bZuzm8s1ceuBUnMUAeoAHHw,22,32,17,37,0,2,3,0,91,13.0,2,0.0,13,17,31,0,19,2,6,3,0,61,30,1
8570,149033,SfdcNKoJXbzDoiv0d6m3J1MnlTZjsesZ,SpATywNh6bZuzm8s1ceuBUnMUAeoAHHw,7,11,1,0,1,0,2,0,15,2.142857142857143,2,0.0,2,1,0,1,9,0,0,2,0,4,11,1
8571,149052,SFeCvEaCETQJeu3FFmauW0GXxvNsOKkb,bWdj2GDclj5ofokWjzoa5jAwMkxCykd6,14,19,6,42,3,2,8,0,80,11.428571428571429,2,0.0,3,6,41,3,16,2,1,8,0,53,27,1
8572,149057,M2hSpM7Q5cwse5dwZYryzZEZOolQRWV5,5X6FeZozNMgE2VRi3MJYjkkFK8SETtu2,10,10,4,0,7,0,3,0,24,3.4285714285714284,1,0.0,4,4,0,7,6,0,0,3,0,15,9,1
8573,149084,s3jLTFp9Aa0FyGIk76qh9bCcU2OTAS9C,SpATywNh6bZuzm8s1ceuBUnMUAeoAHHw,6,4,2,0,1,0,2,0,9,1.2857142857142858,1,0.0,1,2,0,1,3,0,0,2,0,4,5,0
8574,149087,SneRH8JK6KCMhHOEHp7Zi9NRJB5DLBI8,SpATywNh6bZuzm8s1ceuBUnMUAeoAHHw,10,17,1,12,1,0,1,0,32,4.571428571428571,1,0.0,7,1,10,1,10,0,2,1,0,19,13,1
8575,149100,L6Z8ewPMlWVkLltZWo9qRrYBvHNEsyN9,SpATywNh6bZuzm8s1ceuBUnMUAeoAHHw,10,8,1,0,1,0,2,0,12,1.7142857142857142,1,0.0,0,1,0,1,8,0,0,2,0,2,10,0
8576,149107,VBqVRYvmHSTJrZSLtOkPGmPd4zMnmfIN,G8EPVSXsOYB5YQWZGiz1aVq5Pgr2GrQu,1,0,0,0,0,0,1,0,1,0.14285714285714285,1,0.0,0,0,0,0,0,0,0,1,0,0,1,1
8577,149109,5is3QPvmCTb2wCYPovTArJero2U5eHRU,SpATywNh6bZuzm8s1ceuBUnMUAeoAHHw,12,15,7,17,0,0,2,0,41,5.857142857142857,2,0.0,6,7,14,0,9,0,3,2,0,27,14,0
8578,149136,lEJmKdFXtAaM5CwkVi4nzr2tROq80rBD,SpATywNh6bZuzm8s1ceuBUnMUAeoAHHw,13,12,1,10,1,0,1,0,25,3.5714285714285716,1,0.0,2,1,9,1,10,0,1,1,0,13,12,1
8579,149141,1Px8mT6Y4qLxWKg6f0R4TCxt82IPdFCu,5X6FeZozNMgE2VRi3MJYjkkFK8SETtu2,6,4,2,0,1,0,3,0,10,1.4285714285714286,1,0.0,0,2,0,1,4,0,0,3,0,3,7,1
8580,149147,CttUHIFDXoWTFOldpxfPnv8kQdVn6WXf,SpATywNh6bZuzm8s1ceuBUnMUAeoAHHw,34,27,21,0,16,13,9,1,87,12.428571428571429,1,0.0,0,21,0,16,27,13,0,9,1,37,50,1
8581,149168,g1J6BQ7EhQE8jfd7gZPRzLZeukbRbkuA,SpATywNh6bZuzm8s1ceuBUnMUAeoAHHw,40,49,31,41,15,28,7,0,171,24.428571428571427,2,0.0,10,31,35,15,39,28,6,7,0,91,80,0
8582,149170,Ne6uLEjSnwCkPDzKncZNflLBYo8N5PJH,SpATywNh6bZuzm8s1ceuBUnMUAeoAHHw,1,0,0,0,0,0,1,0,1,0.14285714285714285,1,0.0,0,0,0,0,0,0,0,1,0,0,1,1
8583,149181,k9qkAQfy4XeOmkerjzzETP2NbMFDwdHY,bWdj2GDclj5ofokWjzoa5jAwMkxCykd6,1,0,0,0,0,0,1,0,1,0.14285714285714285,1,0.0,0,0,0,0,0,0,0,1,0,0,1,1
8584,149200,WNMY3WRE1kSjqqBi1gkUrP92tDh9JpnU,5X6FeZozNMgE2VRi3MJYjkkFK8SETtu2,18,15,6,16,10,0,2,0,49,7.0,1,0.0,8,6,14,10,7,0,2,2,0,38,11,1
8585,149220,PFMimFJA39XFKECXR8jGss6ZeLs5bQDv,G8EPVSXsOYB5YQWZGiz1aVq5Pgr2GrQu,5,11,5,0,2,0,2,0,20,2.857142857142857,1,0.0,0,5,0,2,11,0,0,2,0,7,13,0
8586,149251,nK3rDT3I0HOsKd8MAJyaw5mnBzHCmQCb,SpATywNh6bZuzm8s1ceuBUnMUAeoAHHw,12,26,0,24,0,0,2,0,52,7.428571428571429,1,0.0,4,0,21,0,22,0,3,2,0,25,27,1
8587,149272,NdGT0aUaY1CUUJSOG5FJEMeCynmm9MTf,SpATywNh6bZuzm8s1ceuBUnMUAeoAHHw,1,0,0,0,0,0,1,0,1,0.14285714285714285,1,0.0,0,0,0,0,0,0,0,1,0,0,1,1
8588,149278,xYR4QT7D1Ir7IcXwoJG6glCObnq7r3cB,SpATywNh6bZuzm8s1ceuBUnMUAeoAHHw,14,24,17,0,11,6,8,0,66,9.428571428571429,3,0.0,0,17,0,11,24,6,0,8,0,28,38,0
8589,149281,SSmzTwHw2pJ3n53tqYFDDB8Zh2JeAHoz,SpATywNh6bZuzm8s1ceuBUnMUAeoAHHw,23,24,12,17,5,0,9,1,68,9.714285714285714,2,0.0,8,12,16,5,16,0,1,9,1,41,27,1
8590,149287,XqrZf8R9BrkWGkETcqhxlHJsow5TwWGG,SpATywNh6bZuzm8s1ceuBUnMUAeoAHHw,8,11,5,0,4,0,1,0,21,3.0,1,0.0,4,5,0,4,7,0,0,1,0,13,8,1
8591,149310,BzvsdR9I1rO5avcH9pAAdWx2ykx9DGYJ,SpATywNh6bZuzm8s1ceuBUnMUAeoAHHw,5,2,1,0,1,0,2,0,6,0.8571428571428571,1,0.0,0,1,0,1,2,0,0,2,0,2,4,1
8592,149325,clBoQvHF7hj2lt9aMKUGNE4YYTF1KNgv,5X6FeZozNMgE2VRi3MJYjkkFK8SETtu2,5,5,3,0,1,0,1,0,10,1.4285714285714286,1,0.0,0,3,0,1,5,0,0,1,0,4,6,1
8593,149332,9d8tCYKPfh5NHPKNlwRKmrZh3Cuf1Ls2,SpATywNh6bZuzm8s1ceuBUnMUAeoAHHw,26,70,30,15,9,2,15,2,143,20.428571428571427,6,0.0,3,30,12,9,67,2,3,15,2,54,89,0
8594,149337,w0fdzIIE8x2qbpek78nlo1eBbvbnmDpR,5X6FeZozNMgE2VRi3MJYjkkFK8SETtu2,1,0,0,0,0,0,1,0,1,0.14285714285714285,1,0.0,0,0,0,0,0,0,0,1,0,0,1,1
8595,149359,C5JjdaA2TpnbGFuMIjvBUyS5u6COBRuh,RXDvfPUBYFlVdlueBFbLW0mhhAyGEqpt,1,0,0,0,0,0,1,0,1,0.14285714285714285,1,0.0,0,0,0,0,0,0,0,1,0,0,1,1
8596,149362,5xmqtrbfbOcPs8SegyLeUDYY1VS45Di7,SpATywNh6bZuzm8s1ceuBUnMUAeoAHHw,7,2,0,0,0,0,6,1,9,1.2857142857142858,1,0.0,0,0,0,0,2,0,0,6,1,0,9,1
8597,149369,HbdIEiZ1jslj2pBp8czn7lhBbxLYjtpj,bWdj2GDclj5ofokWjzoa5jAwMkxCykd6,8,4,2,4,2,0,2,0,14,2.0,1,0.0,1,2,4,2,3,0,0,2,0,9,5,1
8598,149374,sTlxlEkJ3MbMUAeSajnaHOGfpyW9hgq1,5X6FeZozNMgE2VRi3MJYjkkFK8SETtu2,5,3,1,0,1,0,3,0,8,1.1428571428571428,2,0.0,0,1,0,1,3,0,0,3,0,2,6,1
8599,149375,Vh7yX7EtLuJVk9a93lhHFszTGZCV3lfy,G8EPVSXsOYB5YQWZGiz1aVq5Pgr2GrQu,1,0,0,0,0,0,1,0,1,0.14285714285714285,1,0.0,0,0,0,0,0,0,0,1,0,0,1,1
8600,149387,DqNAxwTcrk055KEf1va6hv0cFfrqGSiY,5X6FeZozNMgE2VRi3MJYjkkFK8SETtu2,2,0,0,0,0,0,2,0,2,0.2857142857142857,1,0.0,0,0,0,0,0,0,0,2,0,0,2,1
8601,149403,rA6mPEjcnShXmHCoEHgThQ4NwtVmX6Le,SpATywNh6bZuzm8s1ceuBUnMUAeoAHHw,16,15,11,2,6,0,6,0,40,5.714285714285714,3,0.0,0,11,2,6,15,0,0,6,0,19,21,1
8602,149415,Yg66KIeW6HpW8A6McI69z4EhaoNPdMGp,SpATywNh6bZuzm8s1ceuBUnMUAeoAHHw,11,13,1,15,0,1,2,0,32,4.571428571428571,1,0.0,6,1,13,0,7,1,2,2,0,20,12,1
8603,149416,PFJhF2sNLYftHHb21pjL43RM5viviTlT,SpATywNh6bZuzm8s1ceuBUnMUAeoAHHw,28,34,19,7,15,0,2,0,77,11.0,2,0.0,2,19,7,15,32,0,0,2,0,43,34,0
8604,149423,Pdvh6UTK9FXuCE4WVrV5Y121aJBdVbkt,RXDvfPUBYFlVdlueBFbLW0mhhAyGEqpt,16,37,21,0,6,41,7,0,112,16.0,3,0.0,7,21,0,6,30,41,0,7,0,34,78,0
8605,149431,I45Q3yivyiRN2kHVhbV8bUCfrXvtpUvU,SpATywNh6bZuzm8s1ceuBUnMUAeoAHHw,7,4,1,0,1,0,2,0,8,1.1428571428571428,1,0.0,0,1,0,1,4,0,0,2,0,2,6,0
8606,149442,x0VzAeYdlywtGLqE1HF68qQMYZTLfsw9,RXDvfPUBYFlVdlueBFbLW0mhhAyGEqpt,1,0,0,0,0,0,1,0,1,0.14285714285714285,1,0.0,0,0,0,0,0,0,0,1,0,0,1,1
8607,149449,RthO8kTkOrnZ3vUDn574hHyfG3vroBt1,RXDvfPUBYFlVdlueBFbLW0mhhAyGEqpt,46,70,43,43,27,6,8,0,197,28.142857142857142,4,0.0,22,43,35,27,48,6,8,8,0,127,70,0
8608,149451,MxG2Ev7XiiMWM1pXw5Ve1ZD2Aymhanp7,G8EPVSXsOYB5YQWZGiz1aVq5Pgr2GrQu,1,0,0,0,0,0,1,0,1,0.14285714285714285,1,0.0,0,0,0,0,0,0,0,1,0,0,1,1
8609,149456,bw2aO24aZZlJC7FupBFz9UeLH8ZisJZV,bWdj2GDclj5ofokWjzoa5jAwMkxCykd6,1,0,0,0,0,0,1,0,1,0.14285714285714285,1,0.0,0,0,0,0,0,0,0,1,0,0,1,1
8610,149492,Ev6KS9MaK9gTGqPDnT9PUK5kybHZnCjh,RXDvfPUBYFlVdlueBFbLW0mhhAyGEqpt,18,18,7,0,6,1,3,0,35,5.0,1,0.0,0,7,0,6,18,1,0,3,0,13,22,1
8611,149496,ll005HPG7ZaR3qtTeRKa2vtc0cIY9x5g,SpATywNh6bZuzm8s1ceuBUnMUAeoAHHw,1,0,0,0,0,0,1,0,1,0.14285714285714285,1,0.0,0,0,0,0,0,0,0,1,0,0,1,1
8612,149525,HPkALZZsSIxF1Lb5N1jgVgi94EMe9pvG,SpATywNh6bZuzm8s1ceuBUnMUAeoAHHw,9,9,2,19,0,0,3,0,33,4.714285714285714,1,0.0,7,2,16,0,2,0,3,3,0,25,8,1
8613,149526,CW7Zlsz0NoDYd7q0tu1Krgi9b7wpQUwQ,bWdj2GDclj5ofokWjzoa5jAwMkxCykd6,24,36,15,0,12,37,5,0,105,15.0,2,0.0,2,15,0,12,34,37,0,5,0,29,76,0
8614,149534,M6hmghWj9c26PhfYNN6D8AlzAKngSx0i,SpATywNh6bZuzm8s1ceuBUnMUAeoAHHw,11,8,6,0,4,0,3,0,21,3.0,3,0.0,0,6,0,4,8,0,0,3,0,10,11,0
8615,149536,HjhpW9eEgpgE58Xb0OPgU4Zbnp9D0GcO,SpATywNh6bZuzm8s1ceuBUnMUAeoAHHw,4,2,1,0,1,0,1,0,5,0.7142857142857143,1,0.0,0,1,0,1,2,0,0,1,0,2,3,1
8616,149554,0aomsNaDMmIRvMUNvKVIFXzFDfLWKysB,5X6FeZozNMgE2VRi3MJYjkkFK8SETtu2,5,5,2,0,2,0,3,0,12,1.7142857142857142,1,0.0,0,2,0,2,5,0,0,3,0,4,8,1
8617,149558,z5ywFg739wUMUKifaVGawZHvuIjyjgqA,SpATywNh6bZuzm8s1ceuBUnMUAeoAHHw,1,0,0,0,0,0,1,0,1,0.14285714285714285,1,0.0,0,0,0,0,0,0,0,1,0,0,1,0
8618,149561,TrByXrngJFQBlFEAy6ff6mNvizdClNy5,G8EPVSXsOYB5YQWZGiz1aVq5Pgr2GrQu,1,0,0,0,0,0,1,0,1,0.14285714285714285,1,0.0,0,0,0,0,0,0,0,1,0,0,1,1
8619,149582,7404CggR60r0Jai2AiihoTIyQA4fQf7E,SpATywNh6bZuzm8s1ceuBUnMUAeoAHHw,27,36,17,2,11,14,5,0,85,12.142857142857142,2,0.0,2,17,2,11,34,14,0,5,0,32,53,0
8620,149612,dhNL51CrFkHxhMt1kiIq7Iu6BdYInJEB,RXDvfPUBYFlVdlueBFbLW0mhhAyGEqpt,11,12,2,4,1,3,2,0,24,3.4285714285714284,1,0.0,0,2,3,1,12,3,1,2,0,6,18,1
8621,149621,C5vYoxVhGjVcDS1VlSbcj49VaHI9Xyqh,G8EPVSXsOYB5YQWZGiz1aVq5Pgr2GrQu,26,57,22,82,6,0,4,0,171,24.428571428571427,2,0.0,31,22,57,6,26,0,25,4,0,116,55,0
8622,149663,zwfKDhPDJMb4V7XkEzph01CVUguniguo,bWdj2GDclj5ofokWjzoa5jAwMkxCykd6,1,0,0,0,0,0,1,0,1,0.14285714285714285,1,0.0,0,0,0,0,0,0,0,1,0,0,1,1
8623,149696,MqwnRwvGOsrvVA4Qz9wyqfLYN5id1NHE,5X6FeZozNMgE2VRi3MJYjkkFK8SETtu2,1,0,0,0,0,0,1,0,1,0.14285714285714285,1,0.0,0,0,0,0,0,0,0,1,0,0,1,1
8624,149743,E7Frt6tr6owhsgLSRkD2PqDaTSKmNLId,RXDvfPUBYFlVdlueBFbLW0mhhAyGEqpt,1,0,0,0,0,0,1,0,1,0.14285714285714285,1,0.0,0,0,0,0,0,0,0,1,0,0,1,1
8625,149761,QRKDYncXtzqUo7eYzl5ZNiNJ63G2lU5V,5X6FeZozNMgE2VRi3MJYjkkFK8SETtu2,4,9,1,5,2,0,1,0,18,2.5714285714285716,1,0.0,4,1,4,2,5,0,1,1,0,11,7,1
8626,149764,nKMPTOF6v1sp7aVmO78zmSRg9f9QXrTf,bWdj2GDclj5ofokWjzoa5jAwMkxCykd6,11,17,12,0,8,0,4,0,41,5.857142857142857,3,0.0,1,12,0,8,16,0,0,4,0,21,20,0
8627,149765,Q1kCLLQ1BtcGOGkbHuLMJ0kDU10M0QTF,bWdj2GDclj5ofokWjzoa5jAwMkxCykd6,1,0,0,0,0,0,1,0,1,0.14285714285714285,1,0.0,0,0,0,0,0,0,0,1,0,0,1,1
8628,149766,Q1kCLLQ1BtcGOGkbHuLMJ0kDU10M0QTF,5X6FeZozNMgE2VRi3MJYjkkFK8SETtu2,1,0,0,0,0,0,1,0,1,0.14285714285714285,1,0.0,0,0,0,0,0,0,0,1,0,0,1,1
8629,149769,9D6xPhMl6a6uIrJy4YEJKWzjU7r4dYlS,SpATywNh6bZuzm8s1ceuBUnMUAeoAHHw,31,32,2,52,1,1,3,0,91,13.0,2,0.0,10,2,43,1,22,1,9,3,0,56,35,0
8630,149798,xdSWJOkklt1feMPe59TTfCkpvZpm9Xg2,bWdj2GDclj5ofokWjzoa5jAwMkxCykd6,1,0,0,0,0,0,1,0,1,0.14285714285714285,1,0.0,0,0,0,0,0,0,0,1,0,0,1,1
8631,149815,wGN3pCdk72KFTm52vXIRH474TFtQqduI,5X6FeZozNMgE2VRi3MJYjkkFK8SETtu2,1,0,0,0,0,0,1,0,1,0.14285714285714285,1,0.0,0,0,0,0,0,0,0,1,0,0,1,1
8632,149821,j7cR8MulZ7sIljFq9IIvuWVX0W2fGIFM,SpATywNh6bZuzm8s1ceuBUnMUAeoAHHw,5,4,3,0,2,0,1,0,10,1.4285714285714286,1,0.0,0,3,0,2,4,0,0,1,0,5,5,0
8633,149825,H2B0ZVh2RYo5LjimmBQ15UDjcAOL7h2y,bWdj2GDclj5ofokWjzoa5jAwMkxCykd6,1,0,0,0,0,0,1,0,1,0.14285714285714285,1,0.0,0,0,0,0,0,0,0,1,0,0,1,1
8634,149848,C8zDhaG0vPsQegBtS55u3JZHiYuueFnE,RXDvfPUBYFlVdlueBFbLW0mhhAyGEqpt,1,0,0,0,0,0,1,0,1,0.14285714285714285,1,0.0,0,0,0,0,0,0,0,1,0,0,1,1
8635,149850,WDMP5c2Ubx8vVSFegA0mXeU23cYb0qCY,5X6FeZozNMgE2VRi3MJYjkkFK8SETtu2,11,12,1,0,2,0,4,0,19,2.7142857142857144,2,0.0,2,1,0,2,10,0,0,4,0,5,14,1
8636,149868,LdPn5darYz0CtMZoZhN9Ts9NtxqTUSCW,G8EPVSXsOYB5YQWZGiz1aVq5Pgr2GrQu,7,1,1,0,1,1,5,1,10,1.4285714285714286,1,0.0,0,1,0,1,1,1,0,5,1,2,8,1
8637,149870,SBz1G9CPNh7b1YKxwzjWQ2S8H7JkEfYW,G8EPVSXsOYB5YQWZGiz1aVq5Pgr2GrQu,1,0,0,0,0,0,1,0,1,0.14285714285714285,1,0.0,0,0,0,0,0,0,0,1,0,0,1,1
8638,149880,0qIOrR65l5zNKz33fvwR4iUAwdU1mo6q,5X6FeZozNMgE2VRi3MJYjkkFK8SETtu2,1,0,0,0,0,0,1,0,1,0.14285714285714285,1,0.0,0,0,0,0,0,0,0,1,0,0,1,0
8639,149884,Z95Ku89uNGg04oFkXKdLR1VrvyAEL044,SpATywNh6bZuzm8s1ceuBUnMUAeoAHHw,20,18,0,26,0,9,4,1,58,8.285714285714286,1,0.0,6,0,24,0,12,9,2,4,1,30,28,0
8640,149893,h2B1FNld0JpBpcquk0mIhlA42aMWBy5C,G8EPVSXsOYB5YQWZGiz1aVq5Pgr2GrQu,1,0,0,0,0,0,2,0,2,0.2857142857142857,1,0.0,0,0,0,0,0,0,0,2,0,0,2,1
8641,149928,BRoMr6vuNj25y7f6Ps9m5C5BvYm4Gx6P,bWdj2GDclj5ofokWjzoa5jAwMkxCykd6,5,3,1,0,1,0,3,0,8,1.1428571428571428,1,0.0,0,1,0,1,3,0,0,3,0,2,6,1
8642,149938,zEQiQScIpc1hSOgBtA0a2snrDFq0NA2H,SpATywNh6bZuzm8s1ceuBUnMUAeoAHHw,15,10,4,24,1,9,8,0,56,8.0,2,0.0,6,4,21,1,4,9,3,8,0,32,24,1
8643,149976,6gWNl8crhOxwgA0Ij5LzJgWFSYDFCzaS,G8EPVSXsOYB5YQWZGiz1aVq5Pgr2GrQu,1,0,0,0,0,0,1,0,1,0.14285714285714285,1,0.0,0,0,0,0,0,0,0,1,0,0,1,1
8644,149984,0Qr6LYqQ87hJQw0Vk4piVrMBdlzeBLMC,SpATywNh6bZuzm8s1ceuBUnMUAeoAHHw,5,2,1,0,1,0,2,0,6,0.8571428571428571,1,0.0,0,1,0,1,2,0,0,2,0,2,4,1
8645,149994,VazJRpUfnmR6XNAcZmdWx2mIb59m7oil,SpATywNh6bZuzm8s1ceuBUnMUAeoAHHw,5,8,0,0,0,0,2,0,10,1.4285714285714286,1,0.0,2,0,0,0,6,0,0,2,0,2,8,1
8646,150003,VKJjUOOe4hHNRYTnf34iUAPfHZJRzDEL,SpATywNh6bZuzm8s1ceuBUnMUAeoAHHw,1,0,0,0,0,0,1,0,1,0.14285714285714285,1,0.0,0,0,0,0,0,0,0,1,0,0,1,1
8647,150005,D5IkCYseUCO88GE1B1rMaRAAZyqCPk5T,SpATywNh6bZuzm8s1ceuBUnMUAeoAHHw,11,21,9,16,1,0,11,0,58,8.285714285714286,3,0.0,6,9,14,1,15,0,2,11,0,30,28,0
8648,150011,YZSZ4TOtqHUreAioK1x0YBDmIRumwoti,RXDvfPUBYFlVdlueBFbLW0mhhAyGEqpt,14,9,6,22,0,0,2,0,39,5.571428571428571,1,0.0,2,6,20,0,7,0,2,2,0,28,11,1
8649,150022,xlQaV1k3cIE4ajIy7pLBjRvlUya2da9J,SpATywNh6bZuzm8s1ceuBUnMUAeoAHHw,1,0,0,0,0,0,1,0,1,0.14285714285714285,1,0.0,0,0,0,0,0,0,0,1,0,0,1,1
8650,150027,rlxEJaX8MPFosGD2TJpTUsaXJqED2SzG,SpATywNh6bZuzm8s1ceuBUnMUAeoAHHw,1,0,0,0,0,0,1,0,1,0.14285714285714285,1,0.0,0,0,0,0,0,0,0,1,0,0,1,1
8651,150034,dU7DqQeRV0VJw1owh3rH0rASxy6mSG05,RXDvfPUBYFlVdlueBFbLW0mhhAyGEqpt,3,2,0,0,0,0,1,0,3,0.42857142857142855,1,0.0,0,0,0,0,2,0,0,1,0,0,3,1
8652,150066,kFq2dX2idryINNQb9BQiBNQL0jaWL2j5,A3fsA9Zfv1X2fVEQhTw51lKENdNrEqT3,13,8,5,0,4,0,2,0,19,2.7142857142857144,1,0.0,0,5,0,4,8,0,0,2,0,9,10,1
8653,150069,FWX9YkLyj47mhurdCZuuv2217ViDfzCr,bWdj2GDclj5ofokWjzoa5jAwMkxCykd6,2,0,0,0,0,0,3,0,3,0.42857142857142855,1,0.0,0,0,0,0,0,0,0,3,0,0,3,1
8654,150094,SQ9o8jmVxrsXDCSp6tUg4ljuZWybDROh,SpATywNh6bZuzm8s1ceuBUnMUAeoAHHw,4,2,1,0,1,0,1,0,5,0.7142857142857143,1,0.0,0,1,0,1,2,0,0,1,0,2,3,1
8655,150105,G2qtWwR1edRN2N5qfu1AgRch8m00Htg9,SpATywNh6bZuzm8s1ceuBUnMUAeoAHHw,18,15,7,9,5,0,2,0,38,5.428571428571429,2,0.0,2,7,8,5,13,0,1,2,0,22,16,1
8656,150112,kvTHl55PsMKRRknO7mk3MdHzvNMAhKWW,G8EPVSXsOYB5YQWZGiz1aVq5Pgr2GrQu,73,108,40,231,0,6,24,0,409,58.42857142857143,4,0.0,56,40,172,0,52,6,59,24,0,268,141,0
8657,150117,hRgjZS8yzI2W3b7txu2qLb9XapYY2R7B,SpATywNh6bZuzm8s1ceuBUnMUAeoAHHw,1,0,0,0,0,0,2,0,2,0.2857142857142857,2,0.0,0,0,0,0,0,0,0,2,0,0,2,1
8658,150122,TRBNObHWjWIJybiaNzbPzTRx9rqmfcI5,5Gyp41oLVo7Gg7vF4vpmggWP5MU70QO6,4,1,0,0,0,0,4,0,5,0.7142857142857143,1,0.0,0,0,0,0,1,0,0,4,0,0,5,1
8659,150141,vHiRvEU4iKG66pgKVJkoG6qQeXm9Pv8Z,5Gyp41oLVo7Gg7vF4vpmggWP5MU70QO6,7,3,2,0,2,0,3,0,10,1.4285714285714286,3,0.0,0,2,0,2,3,0,0,3,0,4,6,0
8660,150159,u9t7L5ADqPlElboUfvRm6YfZ1n226qPR,5Gyp41oLVo7Gg7vF4vpmggWP5MU70QO6,1,0,0,0,0,0,1,0,1,0.14285714285714285,1,0.0,0,0,0,0,0,0,0,1,0,0,1,1
8661,150165,ojAJidCORLagMUkoeibYALlr3Dd119Eb,5Gyp41oLVo7Gg7vF4vpmggWP5MU70QO6,1,0,0,0,0,0,2,0,2,0.2857142857142857,2,0.0,0,0,0,0,0,0,0,2,0,0,2,1
8662,150170,cParK6VylJM5zDPedDQJj1iHaLQmTUkO,5Gyp41oLVo7Gg7vF4vpmggWP5MU70QO6,5,2,1,0,1,0,2,0,6,0.8571428571428571,2,0.0,0,1,0,1,2,0,0,2,0,2,4,1
8663,150218,Oqfkhjg6t51PZcyyCwvjWtQ6bDHYceB1,5Gyp41oLVo7Gg7vF4vpmggWP5MU70QO6,14,13,8,0,4,4,6,2,37,5.285714285714286,1,0.0,2,8,0,4,11,4,0,6,2,14,23,1
8664,150227,PbgdUFB40mRi05voFmqaPWh8FWsQSZBC,5Gyp41oLVo7Gg7vF4vpmggWP5MU70QO6,7,3,2,2,1,0,2,0,10,1.4285714285714286,1,0.0,0,2,1,1,3,0,1,2,0,4,6,1
8665,150234,hU8N8VVEHrSIWqoQgU73zqdMqJqog2Kf,5Gyp41oLVo7Gg7vF4vpmggWP5MU70QO6,6,4,2,0,1,0,3,0,10,1.4285714285714286,2,0.0,0,2,0,1,4,0,0,3,0,3,7,1
8666,150238,xlQaV1k3cIE4ajIy7pLBjRvlUya2da9J,5Gyp41oLVo7Gg7vF4vpmggWP5MU70QO6,1,0,0,0,0,0,1,0,1,0.14285714285714285,1,0.0,0,0,0,0,0,0,0,1,0,0,1,1
8667,150240,IBQysHUoQXmLOs1Zq1ObfjjQgLUHbetv,5Gyp41oLVo7Gg7vF4vpmggWP5MU70QO6,9,15,5,0,1,0,14,1,36,5.142857142857143,2,0.0,0,5,0,1,15,0,0,14,1,6,30,1
8668,150259,pBAt7KM50uZ5CSaZdFcjJhWNyJU1a49b,5Gyp41oLVo7Gg7vF4vpmggWP5MU70QO6,1,0,0,0,0,0,2,0,2,0.2857142857142857,1,0.0,0,0,0,0,0,0,0,2,0,0,2,1
8669,150289,6MtNOoE4DT84neYSq4FacOIfH9AJawPv,5Gyp41oLVo7Gg7vF4vpmggWP5MU70QO6,5,2,1,0,1,0,4,0,8,1.1428571428571428,1,0.0,0,1,0,1,2,0,0,4,0,2,6,1
8670,150305,6LSxEzHekfBjzdBuVJRrkvGn3CBVWXBO,5Gyp41oLVo7Gg7vF4vpmggWP5MU70QO6,12,14,7,0,3,4,8,1,37,5.285714285714286,3,0.0,0,7,0,3,14,4,0,8,1,10,27,1
8671,150336,ounIJVGj3D0OEROlO3D5y4OClv9XSROt,5Gyp41oLVo7Gg7vF4vpmggWP5MU70QO6,12,14,7,2,3,2,6,1,35,5.0,2,0.0,3,7,1,3,11,2,1,6,1,14,21,1
8672,150346,8uxWfB8oDdu0sXPUJZJL94EyUXC56QcI,5Gyp41oLVo7Gg7vF4vpmggWP5MU70QO6,11,11,5,0,2,0,4,0,22,3.142857142857143,1,0.0,2,5,0,2,9,0,0,4,0,9,13,0
8673,150369,AsCRvwtleeGS6D6WD7MD0zpcijqiUpJg,5Gyp41oLVo7Gg7vF4vpmggWP5MU70QO6,7,12,4,0,1,23,8,1,49,7.0,4,0.0,0,4,0,1,12,23,0,8,1,5,44,1
8674,150378,m7LPs49nHZUcvz2esAX8UbdKFZVSnWet,5Gyp41oLVo7Gg7vF4vpmggWP5MU70QO6,10,11,5,2,2,1,3,0,24,3.4285714285714284,3,0.0,1,5,1,2,10,1,1,3,0,9,15,1
8675,150384,9T6sJuPiEkwFHn4VyREnKyR6Ni1hFol4,5Gyp41oLVo7Gg7vF4vpmggWP5MU70QO6,9,6,1,0,0,1,6,1,15,2.142857142857143,1,0.0,0,1,0,0,6,1,0,6,1,1,14,1
8676,150407,YRvoydpc37Vpysmtw8O9rzowfgsZu7lO,5Gyp41oLVo7Gg7vF4vpmggWP5MU70QO6,8,5,3,0,2,0,2,0,12,1.7142857142857142,1,0.0,1,3,0,2,4,0,0,2,0,6,6,1
8677,150445,Q2lItPo8BYO6wobNvEQvbxDBBHBQ9kpC,5Gyp41oLVo7Gg7vF4vpmggWP5MU70QO6,1,0,0,0,0,0,1,0,1,0.14285714285714285,1,0.0,0,0,0,0,0,0,0,1,0,0,1,1
8678,150448,M4ZErUfwHYj5OXVgTBrfDNh3oNvQb92M,5Gyp41oLVo7Gg7vF4vpmggWP5MU70QO6,14,23,9,0,7,1,16,1,57,8.142857142857142,2,0.0,7,9,0,7,16,1,0,16,1,23,34,1
8679,150494,73RkwvOyVW3UHI251B2fOqBc8HlBGm1T,5Gyp41oLVo7Gg7vF4vpmggWP5MU70QO6,1,0,0,0,0,0,1,0,1,0.14285714285714285,1,0.0,0,0,0,0,0,0,0,1,0,0,1,1
8680,150509,QbtYUbBGIlNsSyTF9a1cqHwNS423I4zq,5Gyp41oLVo7Gg7vF4vpmggWP5MU70QO6,7,4,2,0,1,0,3,0,10,1.4285714285714286,2,0.0,0,2,0,1,4,0,0,3,0,3,7,1
8681,150512,C8siiCYreGRtwXrrqTKm8G2sId3UVfIz,5Gyp41oLVo7Gg7vF4vpmggWP5MU70QO6,7,3,2,0,2,0,2,0,9,1.2857142857142858,1,0.0,0,2,0,2,3,0,0,2,0,4,5,1
8682,150524,fJzMxSRB3WKUuLuE0D3bPFKYkkxD2yF6,5Gyp41oLVo7Gg7vF4vpmggWP5MU70QO6,5,2,1,0,1,0,2,0,6,0.8571428571428571,1,0.0,0,1,0,1,2,0,0,2,0,2,4,1
8683,150541,Ear5cTswifRZVshIanxSafkKiBm15Bfw,5Gyp41oLVo7Gg7vF4vpmggWP5MU70QO6,8,6,4,0,3,3,3,0,19,2.7142857142857144,2,0.0,0,4,0,3,6,3,0,3,0,7,12,1
8684,150544,XoXjEl7H7ZQGZLpYuhcIjuNQzpghD8Gl,5Gyp41oLVo7Gg7vF4vpmggWP5MU70QO6,1,0,0,0,0,0,1,0,1,0.14285714285714285,1,0.0,0,0,0,0,0,0,0,1,0,0,1,1
8685,150587,I97ZkJq1xt7pItpDNG8lgAeSX27lyLIB,5Gyp41oLVo7Gg7vF4vpmggWP5MU70QO6,1,0,0,0,0,0,1,0,1,0.14285714285714285,1,0.0,0,0,0,0,0,0,0,1,0,0,1,1
8686,150598,ZlXHJfoZMD5PykRnqIfcXnGutzqj3HS4,5Gyp41oLVo7Gg7vF4vpmggWP5MU70QO6,6,5,2,0,0,0,3,0,10,1.4285714285714286,2,0.0,0,2,0,0,5,0,0,3,0,2,8,1
8687,150637,oK8MXqkNHg6R0zgjZMn5TIW5ujaCXo9P,5Gyp41oLVo7Gg7vF4vpmggWP5MU70QO6,9,5,4,0,3,0,1,0,13,1.8571428571428572,1,0.0,0,4,0,3,5,0,0,1,0,7,6,1
8688,150646,hQQKu1XLTkk3Z1qm4WNBWkjmc5yKmP4O,5Gyp41oLVo7Gg7vF4vpmggWP5MU70QO6,7,6,2,0,2,0,2,0,12,1.7142857142857142,2,0.0,3,2,0,2,3,0,0,2,0,7,5,1
8689,150650,naxKR41ibDRek43Y5XpbLNi2FZgIDzJx,5Gyp41oLVo7Gg7vF4vpmggWP5MU70QO6,1,0,0,0,0,0,1,0,1,0.14285714285714285,1,0.0,0,0,0,0,0,0,0,1,0,0,1,1
8690,150652,YhAiXC8zlbufbcQ4dz0bTgKxFmv60Ja7,5Gyp41oLVo7Gg7vF4vpmggWP5MU70QO6,1,0,0,0,0,0,1,0,1,0.14285714285714285,1,0.0,0,0,0,0,0,0,0,1,0,0,1,1
8691,150656,hjIy2H4nj9jJ4fRj6OOsBlq6scMJN14Z,5Gyp41oLVo7Gg7vF4vpmggWP5MU70QO6,5,2,1,0,1,0,2,0,6,0.8571428571428571,1,0.0,0,1,0,1,2,0,0,2,0,2,4,1
8692,150660,wTVoO7ik0Mrv1QANtDwL7WrVwrAPOmpI,5Gyp41oLVo7Gg7vF4vpmggWP5MU70QO6,5,2,1,0,1,0,2,0,6,0.8571428571428571,1,0.0,0,1,0,1,2,0,0,2,0,2,4,1
8693,150674,zxNHBsmZ7DplWkpoX0woIpaENodcvDoT,5Gyp41oLVo7Gg7vF4vpmggWP5MU70QO6,2,0,0,0,0,0,2,0,2,0.2857142857142857,1,0.0,0,0,0,0,0,0,0,2,0,0,2,1
8694,150702,mbwwdEuMHREswI2AlXkMk45wqGiM3Wfu,5Gyp41oLVo7Gg7vF4vpmggWP5MU70QO6,6,2,1,0,1,0,3,1,8,1.1428571428571428,1,0.0,0,1,0,1,2,0,0,3,1,2,6,1
8695,150705,bXo13OaSVSZVdc3p9j9yvsI2MVmJRSiI,5Gyp41oLVo7Gg7vF4vpmggWP5MU70QO6,9,6,4,2,2,0,2,0,16,2.2857142857142856,1,0.0,1,4,1,2,5,0,1,2,0,8,8,1
8696,150734,6D9tNiLYL0h3Qh7QJGbRexG5UNsHPfh9,5Gyp41oLVo7Gg7vF4vpmggWP5MU70QO6,7,5,2,0,0,0,4,0,11,1.5714285714285714,1,0.0,0,2,0,0,5,0,0,4,0,2,9,1
8697,150742,JT1KLYqogflJatgOFWcpvS2M0BVTy9fT,5Gyp41oLVo7Gg7vF4vpmggWP5MU70QO6,1,0,0,0,0,0,1,0,1,0.14285714285714285,1,0.0,0,0,0,0,0,0,0,1,0,0,1,1
8698,150749,Z9MT3znePHqRtluyjqfGhwSG9lSs3uQe,5Gyp41oLVo7Gg7vF4vpmggWP5MU70QO6,6,2,1,0,1,0,3,0,7,1.0,1,0.0,0,1,0,1,2,0,0,3,0,2,5,1
8699,150757,FCG6YWuKaaz2zD1Uj2uT7JnTQhXHO8IA,5Gyp41oLVo7Gg7vF4vpmggWP5MU70QO6,1,0,0,0,0,0,1,0,1,0.14285714285714285,1,0.0,0,0,0,0,0,0,0,1,0,0,1,1
8700,150770,xJPU1inHXZ7edp2ELm8jFSIERF7GmDJa,5Gyp41oLVo7Gg7vF4vpmggWP5MU70QO6,1,0,0,0,0,0,1,0,1,0.14285714285714285,1,0.0,0,0,0,0,0,0,0,1,0,0,1,1
8701,150793,xGc3CvpmhP8QhiMIjVwsr77PvLypuJv1,5Gyp41oLVo7Gg7vF4vpmggWP5MU70QO6,6,4,3,0,3,0,2,0,12,1.7142857142857142,2,0.0,0,3,0,3,4,0,0,2,0,6,6,0
8702,150801,XLTSdKQeT3pb8W8DFBEWLQtEuZ5Vg9BF,5Gyp41oLVo7Gg7vF4vpmggWP5MU70QO6,6,4,2,0,1,0,3,0,10,1.4285714285714286,1,0.0,0,2,0,1,4,0,0,3,0,3,7,1
8703,150805,eAArxLyCThtu9N3Mv8rQculKbGSa66j9,5Gyp41oLVo7Gg7vF4vpmggWP5MU70QO6,1,0,0,0,0,0,1,0,1,0.14285714285714285,1,0.0,0,0,0,0,0,0,0,1,0,0,1,0
8704,150809,ozMzx95utaM6t0vWRUNZm19Q7oZfoujc,5Gyp41oLVo7Gg7vF4vpmggWP5MU70QO6,8,7,4,0,4,6,4,0,25,3.5714285714285716,1,0.0,1,4,0,4,6,6,0,4,0,9,16,1
8705,150812,E5MJZ8cVeLx5MNrppgSH419w5vJk7BV3,5Gyp41oLVo7Gg7vF4vpmggWP5MU70QO6,7,9,5,0,0,1,10,1,26,3.7142857142857144,3,0.0,1,5,0,0,8,1,0,10,1,6,20,1
8706,150834,4FSpxyFHWNPCO3VKgofAroygyZ2dAjfA,5Gyp41oLVo7Gg7vF4vpmggWP5MU70QO6,8,5,3,4,1,0,2,0,15,2.142857142857143,1,0.0,1,3,2,1,4,0,2,2,0,7,8,1
8707,150837,BcMya4rKMXEm8PNyZTAmOJyexYS6hlD9,5Gyp41oLVo7Gg7vF4vpmggWP5MU70QO6,1,0,0,0,0,0,1,0,1,0.14285714285714285,1,0.0,0,0,0,0,0,0,0,1,0,0,1,1
8708,150851,I0b0CtUQszlJ9piQ6aa7rx3ZTzdFEAMU,5Gyp41oLVo7Gg7vF4vpmggWP5MU70QO6,1,0,0,0,0,0,1,0,1,0.14285714285714285,1,0.0,0,0,0,0,0,0,0,1,0,0,1,1
8709,150859,HbfcxoEnjbnvh5Ba03UuGWAFpvOKtWbG,5Gyp41oLVo7Gg7vF4vpmggWP5MU70QO6,5,2,1,0,1,0,2,0,6,0.8571428571428571,1,0.0,0,1,0,1,2,0,0,2,0,2,4,1
8710,150889,PDJ5YLnuZaNj8cBZG1e2jb8NgKqeCz9q,5Gyp41oLVo7Gg7vF4vpmggWP5MU70QO6,10,7,3,0,4,0,2,0,16,2.2857142857142856,1,0.0,1,3,0,4,6,0,0,2,0,8,8,1
8711,150892,wFgvsPZQfTe43ahpGQxOtYpPA6mMKhw9,5Gyp41oLVo7Gg7vF4vpmggWP5MU70QO6,1,0,0,0,0,0,1,0,1,0.14285714285714285,1,0.0,0,0,0,0,0,0,0,1,0,0,1,1
8712,150900,3N5sXtJHk0S0MyzqJoRxaXFTELV1xCPn,5Gyp41oLVo7Gg7vF4vpmggWP5MU70QO6,2,0,0,0,0,0,2,0,2,0.2857142857142857,1,0.0,0,0,0,0,0,0,0,2,0,0,2,1
8713,150901,yCaliTyLawz9hD9gW2I8AmOOpqQxHz55,5Gyp41oLVo7Gg7vF4vpmggWP5MU70QO6,1,0,0,0,0,0,1,0,1,0.14285714285714285,1,0.0,0,0,0,0,0,0,0,1,0,0,1,1
8714,150918,PFS1tuIfRtU18K7PccBDMoq3Gsd5HBEc,5Gyp41oLVo7Gg7vF4vpmggWP5MU70QO6,1,0,0,0,0,0,1,0,1,0.14285714285714285,1,0.0,0,0,0,0,0,0,0,1,0,0,1,1
8715,150935,uoLP1IuLLWOUXnvrQb8tFCvhd6fERrCM,5Gyp41oLVo7Gg7vF4vpmggWP5MU70QO6,7,3,2,0,2,0,2,0,9,1.2857142857142858,1,0.0,0,2,0,2,3,0,0,2,0,4,5,1
8716,150940,m9tv0IeMj9CV2J0VEBDncZxDLDKZ5gBY,5Gyp41oLVo7Gg7vF4vpmggWP5MU70QO6,8,7,3,0,2,6,4,0,22,3.142857142857143,1,0.0,0,3,0,2,7,6,0,4,0,5,17,1
8717,150942,BtUSjqKrhPvRDopuX3NRI7Fb7WfFlULw,5Gyp41oLVo7Gg7vF4vpmggWP5MU70QO6,1,0,0,0,0,0,1,0,1,0.14285714285714285,1,0.0,0,0,0,0,0,0,0,1,0,0,1,1
8718,150952,J0agIiDPDsO7EgNBs76RsZQyZ6XLl2nX,5Gyp41oLVo7Gg7vF4vpmggWP5MU70QO6,1,0,0,0,0,0,1,0,1,0.14285714285714285,1,0.0,0,0,0,0,0,0,0,1,0,0,1,0
8719,150974,xLggdOYVuVd1fIIjw7WQvlgt6RgJEHij,5Gyp41oLVo7Gg7vF4vpmggWP5MU70QO6,5,2,1,0,1,0,2,0,6,0.8571428571428571,1,0.0,0,1,0,1,2,0,0,2,0,2,4,1
8720,150989,q0NJUxHMJLDeMKw16TmcVP4uYG4F0aIp,5Gyp41oLVo7Gg7vF4vpmggWP5MU70QO6,8,7,3,0,2,0,2,0,14,2.0,1,0.0,1,3,0,2,6,0,0,2,0,6,8,1
8721,150998,LYzYyf5ekuqUYXgYvm7fMfxJTfQmHHsI,5Gyp41oLVo7Gg7vF4vpmggWP5MU70QO6,3,0,0,0,0,0,5,0,5,0.7142857142857143,1,0.0,0,0,0,0,0,0,0,5,0,0,5,1
8722,151003,fB67G1QnjAF1nyJgxD5AAGinUNf5WvmI,5Gyp41oLVo7Gg7vF4vpmggWP5MU70QO6,8,22,0,0,4,0,4,0,30,4.285714285714286,1,0.0,9,0,0,4,13,0,0,4,0,13,17,1
8723,151035,Ma8Y6R8O5fnjHuA9SPo0MefKBe3j2968,5Gyp41oLVo7Gg7vF4vpmggWP5MU70QO6,4,2,0,0,0,0,3,0,5,0.7142857142857143,1,0.0,0,0,0,0,2,0,0,3,0,0,5,1
8724,151038,Fl4jIGQ8ffw2cSzVWGpGPBUNLDruFr99,5Gyp41oLVo7Gg7vF4vpmggWP5MU70QO6,1,0,0,0,0,0,3,0,3,0.42857142857142855,1,0.0,0,0,0,0,0,0,0,3,0,0,3,1
8725,151078,mvq6LTOHbvs5NukuzHDhNx6V4S7m8iJL,5Gyp41oLVo7Gg7vF4vpmggWP5MU70QO6,1,0,0,0,0,0,1,0,1,0.14285714285714285,1,0.0,0,0,0,0,0,0,0,1,0,0,1,1
8726,151084,2Wbpl8eSK90XFueeERqAaymoCfhK5Qkn,5Gyp41oLVo7Gg7vF4vpmggWP5MU70QO6,6,3,2,0,2,0,1,0,8,1.1428571428571428,1,0.0,0,2,0,2,3,0,0,1,0,4,4,1
8727,151087,7bsuvzVp0P34SLnobMPoETPRtIq3WvzP,5Gyp41oLVo7Gg7vF4vpmggWP5MU70QO6,18,21,10,1,5,18,18,2,75,10.714285714285714,1,0.0,5,10,1,5,16,18,0,18,2,21,54,1
8728,151090,bMfqJh0a1bGWrPSVl7sbbOnpybflF7eg,5Gyp41oLVo7Gg7vF4vpmggWP5MU70QO6,8,5,2,0,2,0,4,0,13,1.8571428571428572,2,0.0,0,2,0,2,5,0,0,4,0,4,9,1
8729,151094,tuhGi1oeg1PgtdLeBtHv6xmUelT6HYFY,5Gyp41oLVo7Gg7vF4vpmggWP5MU70QO6,21,52,20,21,7,12,12,2,126,18.0,1,0.0,27,20,15,7,25,12,6,12,2,69,57,1
8730,151128,GN5gQNFJDFdC9kETtKfVvAPxPOJUtgn1,5Gyp41oLVo7Gg7vF4vpmggWP5MU70QO6,7,7,2,0,2,0,2,0,13,1.8571428571428572,1,0.0,0,2,0,2,7,0,0,2,0,4,9,1
8731,151162,tRpsBmszN2GKJQ5Nw00w7MILm5RfCZWU,5Gyp41oLVo7Gg7vF4vpmggWP5MU70QO6,7,4,3,0,2,0,1,0,10,1.4285714285714286,1,0.0,0,3,0,2,4,0,0,1,0,5,5,1
8732,151179,eriNxzF5MJlwuGXsLjvkj8eJHFzarWtA,5Gyp41oLVo7Gg7vF4vpmggWP5MU70QO6,31,60,38,4,22,1,16,1,142,20.285714285714285,3,0.0,3,38,3,22,57,1,1,16,1,66,76,0
8733,151188,bzt9F7dE3QSyc99YmNCJSPBUUrAEZHrz,5Gyp41oLVo7Gg7vF4vpmggWP5MU70QO6,3,2,1,0,0,0,1,0,4,0.5714285714285714,1,0.0,0,1,0,0,2,0,0,1,0,1,3,1
8734,151199,m86kw79XbXLYY6QkjilycJRjjgKPxNcQ,5Gyp41oLVo7Gg7vF4vpmggWP5MU70QO6,5,2,1,0,1,0,2,0,6,0.8571428571428571,1,0.0,1,1,0,1,1,0,0,2,0,3,3,1
8735,151223,bLreCdAEY4M3FFqqRGQ9kLZjTYBSKbwL,5Gyp41oLVo7Gg7vF4vpmggWP5MU70QO6,7,3,2,0,2,0,2,0,9,1.2857142857142858,1,0.0,0,2,0,2,3,0,0,2,0,4,5,1
8736,151230,7jNUWYjbHo3nUZfu7saNwLxIufvdLe1s,5Gyp41oLVo7Gg7vF4vpmggWP5MU70QO6,1,0,0,0,0,0,1,0,1,0.14285714285714285,1,0.0,0,0,0,0,0,0,0,1,0,0,1,1
8737,151234,3x63reHnPUEpxvneROppT18TTVHKvgH3,5Gyp41oLVo7Gg7vF4vpmggWP5MU70QO6,17,28,11,7,13,0,4,1,64,9.142857142857142,2,0.0,11,11,5,13,17,0,2,4,1,40,24,1
8738,151244,VPCWV7vv7mSXLXdyKv2YQuYNd5q5tnVr,5Gyp41oLVo7Gg7vF4vpmggWP5MU70QO6,6,6,2,0,1,0,8,0,17,2.4285714285714284,1,0.0,0,2,0,1,6,0,0,8,0,3,14,0
8739,151253,Wsm1V4cfzELCIOcUH2wqmAYWXqkRELSb,5Gyp41oLVo7Gg7vF4vpmggWP5MU70QO6,1,0,0,0,0,0,1,0,1,0.14285714285714285,1,0.0,0,0,0,0,0,0,0,1,0,0,1,1
8740,151267,hutehqqFsHkTDVYtn3UPDM1X1MaRXFfq,5Gyp41oLVo7Gg7vF4vpmggWP5MU70QO6,5,2,1,0,1,1,2,1,8,1.1428571428571428,1,0.0,0,1,0,1,2,1,0,2,1,2,6,1
8741,151279,HfYUlZx1414CF0vVzzckHc3Zl0Q1sP07,5Gyp41oLVo7Gg7vF4vpmggWP5MU70QO6,6,1,1,0,1,0,4,0,7,1.0,2,0.0,0,1,0,1,1,0,0,4,0,2,5,1
8742,151292,I7S3rirnByKcuYHarusIwlT2GOLphfpj,5Gyp41oLVo7Gg7vF4vpmggWP5MU70QO6,6,5,0,0,0,0,3,0,8,1.1428571428571428,1,0.0,0,0,0,0,5,0,0,3,0,0,8,1
8743,151307,HvKDZIgtTrTVPi7sgcFSCpQYAlS5Fw2P,5Gyp41oLVo7Gg7vF4vpmggWP5MU70QO6,6,3,2,0,2,0,2,0,9,1.2857142857142858,1,0.0,0,2,0,2,3,0,0,2,0,4,5,1
8744,151320,LccNeIfK8nW5n5kUCDP0tvJVwpBeyYvE,5Gyp41oLVo7Gg7vF4vpmggWP5MU70QO6,1,0,0,0,0,0,1,0,1,0.14285714285714285,1,0.0,0,0,0,0,0,0,0,1,0,0,1,1
8745,151330,TKZgNsJlgM9z2jU0Un36JpUX1NEfLj9f,5Gyp41oLVo7Gg7vF4vpmggWP5MU70QO6,8,7,4,0,2,3,4,0,20,2.857142857142857,3,0.0,0,4,0,2,7,3,0,4,0,6,14,1
8746,151352,Hh7gmGE0gxxFDGZgOYpIIb1ZT5fDGBgk,5Gyp41oLVo7Gg7vF4vpmggWP5MU70QO6,1,0,0,0,0,0,1,0,1,0.14285714285714285,1,0.0,0,0,0,0,0,0,0,1,0,0,1,0
8747,151358,UPyXn56GTiamHniIOeD79gmXdLiowzXH,5Gyp41oLVo7Gg7vF4vpmggWP5MU70QO6,1,0,0,0,0,0,1,0,1,0.14285714285714285,1,0.0,0,0,0,0,0,0,0,1,0,0,1,1
8748,151371,rmlZ7x6O4i4xKnqcPnFuEHPQ5kp2xB2g,5Gyp41oLVo7Gg7vF4vpmggWP5MU70QO6,15,19,6,29,2,3,12,3,74,10.571428571428571,1,0.0,12,6,21,2,7,3,8,12,3,41,33,1
8749,151373,PUmV9uRuFVROTlnbrxJwOENyVx54i3f7,5Gyp41oLVo7Gg7vF4vpmggWP5MU70QO6,7,3,2,0,2,0,2,0,9,1.2857142857142858,1,0.0,0,2,0,2,3,0,0,2,0,4,5,1
8750,151376,ESZbkcdVULrci8JLWRpfJDPEFHTO8Ce0,5Gyp41oLVo7Gg7vF4vpmggWP5MU70QO6,7,1,1,0,1,0,4,0,7,1.0,1,0.0,0,1,0,1,1,0,0,4,0,2,5,1
8751,151397,G3JkrC91hydeYLKmvsrmbi6QdG0TgmMU,5Gyp41oLVo7Gg7vF4vpmggWP5MU70QO6,10,2,2,0,2,1,9,1,17,2.4285714285714284,1,0.0,0,2,0,2,2,1,0,9,1,4,13,1
8752,151406,OAovxCY5AcOhvhBf2zZgSZWneuufIS5b,5Gyp41oLVo7Gg7vF4vpmggWP5MU70QO6,5,4,2,0,1,0,2,0,9,1.2857142857142858,2,0.0,0,2,0,1,4,0,0,2,0,3,6,1
8753,151414,RCdcltNaQLfcoxT7YKTjQxAYUbCmzzKd,5Gyp41oLVo7Gg7vF4vpmggWP5MU70QO6,6,7,3,0,2,0,5,0,17,2.4285714285714284,3,0.0,0,3,0,2,7,0,0,5,0,5,12,0
8754,151426,OqqHplJQj7uH9fg7jI2Ikj5dp2hHyb4U,5Gyp41oLVo7Gg7vF4vpmggWP5MU70QO6,15,23,7,30,3,13,7,1,84,12.0,1,0.0,14,7,24,3,9,13,6,7,1,48,36,1
8755,151434,r7oEwOybiZG5UQZ1QZ0AiTrJNKaNvs7r,5Gyp41oLVo7Gg7vF4vpmggWP5MU70QO6,1,0,0,0,0,0,2,0,2,0.2857142857142857,1,0.0,0,0,0,0,0,0,0,2,0,0,2,1
8756,151440,xnV7sxoOD25FPwZ7ZFAn8tAdwhJiicZK,5Gyp41oLVo7Gg7vF4vpmggWP5MU70QO6,7,5,2,0,1,0,6,0,14,2.0,2,0.0,0,2,0,1,5,0,0,6,0,3,11,1
8757,151443,dNgxUPyBXng4Hn7f7H5Q5a2hxaMrrYLl,5Gyp41oLVo7Gg7vF4vpmggWP5MU70QO6,5,6,0,0,0,0,4,0,10,1.4285714285714286,1,0.0,0,0,0,0,6,0,0,4,0,0,10,1
8758,151451,UIrNobVAbeP9pBiCTAyjWT0vxEb24tGY,5Gyp41oLVo7Gg7vF4vpmggWP5MU70QO6,15,17,9,14,6,0,8,0,54,7.714285714285714,1,0.0,6,9,9,6,11,0,5,8,0,30,24,1
8759,151488,uoMVAH3rqvuHTrwiSe2SewRx9Bpc9srI,5Gyp41oLVo7Gg7vF4vpmggWP5MU70QO6,1,0,0,0,0,0,1,0,1,0.14285714285714285,1,0.0,0,0,0,0,0,0,0,1,0,0,1,1
8760,151489,2K1Z8MHkxSfa3IoXQMOOkvPRYry0VFvS,5Gyp41oLVo7Gg7vF4vpmggWP5MU70QO6,6,2,1,0,1,0,3,0,7,1.0,2,0.0,0,1,0,1,2,0,0,3,0,2,5,1
8761,151493,YPjZmyKjQkTrFwew3ILyyCKC6JN7YvY6,5Gyp41oLVo7Gg7vF4vpmggWP5MU70QO6,5,2,1,0,1,0,3,0,7,1.0,1,0.0,0,1,0,1,2,0,0,3,0,2,5,1
8762,151515,xLsstPG4sh6BOKWjwGwQnQICDDoIsKTd,5Gyp41oLVo7Gg7vF4vpmggWP5MU70QO6,12,11,6,0,3,0,4,0,24,3.4285714285714284,3,0.0,0,6,0,3,11,0,0,4,0,9,15,0
8763,151522,l49Uwtjoh75ZqUzcGjRfE9XtSg6Z1AGt,5Gyp41oLVo7Gg7vF4vpmggWP5MU70QO6,10,6,3,0,2,0,6,1,18,2.5714285714285716,1,0.0,2,3,0,2,4,0,0,6,1,7,11,1
8764,151538,pR0rEzd43YPn1ujQN1oHxqL0z3U4G8ju,5Gyp41oLVo7Gg7vF4vpmggWP5MU70QO6,2,0,0,0,0,0,2,0,2,0.2857142857142857,1,0.0,0,0,0,0,0,0,0,2,0,0,2,1
8765,151548,gNTGzjcOmHTKgzmUa0veV0Pk7aaKxz1N,5Gyp41oLVo7Gg7vF4vpmggWP5MU70QO6,6,9,2,0,3,0,1,0,15,2.142857142857143,1,0.0,2,2,0,3,7,0,0,1,0,7,8,1
8766,151580,Nzwv6Dxi9vrWIBjDR2tlTcPdhkCBGjfn,5Gyp41oLVo7Gg7vF4vpmggWP5MU70QO6,5,3,1,0,1,0,7,0,12,1.7142857142857142,1,0.0,1,1,0,1,2,0,0,7,0,3,9,1
8767,151592,hsJU1V7A4FsBfqrLbVEjA8WHyh23x6My,5Gyp41oLVo7Gg7vF4vpmggWP5MU70QO6,6,4,3,0,3,0,1,0,11,1.5714285714285714,1,0.0,0,3,0,3,4,0,0,1,0,6,5,1
8768,151596,TzoVeR6jxsM11FbzWcSJJwiHvbw0Vsix,5Gyp41oLVo7Gg7vF4vpmggWP5MU70QO6,6,3,0,0,2,0,6,9,20,2.857142857142857,1,0.0,0,0,0,2,3,0,0,6,9,2,18,1
8769,151598,lHz8g2aWVjKPT0qlJ69PaMkh1gnb9fpG,5Gyp41oLVo7Gg7vF4vpmggWP5MU70QO6,8,10,5,0,2,3,6,0,26,3.7142857142857144,1,0.0,2,5,0,2,8,3,0,6,0,9,17,1
8770,151634,VBKLySr69l31PijlEB7BTJk2zu02CGoB,5Gyp41oLVo7Gg7vF4vpmggWP5MU70QO6,4,4,0,0,0,0,2,0,6,0.8571428571428571,2,0.0,0,0,0,0,4,0,0,2,0,0,6,1
8771,151656,PIClOJA6j5sUehEuGxHwIeSy1ij4bGue,5Gyp41oLVo7Gg7vF4vpmggWP5MU70QO6,8,2,2,0,2,0,4,0,10,1.4285714285714286,2,0.0,0,2,0,2,2,0,0,4,0,4,6,1
8772,151678,iB94FmRZcyFJht4SeU2JKlyJEQJg6zKL,5Gyp41oLVo7Gg7vF4vpmggWP5MU70QO6,10,5,3,4,2,2,3,0,19,2.7142857142857144,1,0.0,1,3,3,2,4,2,1,3,0,9,10,1
8773,151684,TRW1xx4Nk9zW31jMDe5ae1YBst6a2yFQ,5Gyp41oLVo7Gg7vF4vpmggWP5MU70QO6,6,3,2,0,2,0,1,0,8,1.1428571428571428,1,0.0,0,2,0,2,3,0,0,1,0,4,4,1
8774,151695,6pq8MXYf9FGRuIYUMUOQpp4FppiElIYr,5Gyp41oLVo7Gg7vF4vpmggWP5MU70QO6,5,3,1,0,1,0,2,0,7,1.0,1,0.0,0,1,0,1,3,0,0,2,0,2,5,1
8775,151703,KVC7h242x0PZCn7VJTYGsUtQjLXoKjKz,5Gyp41oLVo7Gg7vF4vpmggWP5MU70QO6,7,4,1,0,1,0,7,0,13,1.8571428571428572,2,0.0,0,1,0,1,4,0,0,7,0,2,11,1
8776,151709,OWNvUZSL7GgHRtQ93QCtolaAfBVqHh0d,5Gyp41oLVo7Gg7vF4vpmggWP5MU70QO6,5,4,2,0,1,0,2,0,9,1.2857142857142858,2,0.0,0,2,0,1,4,0,0,2,0,3,6,1
8777,151719,0EjCkQ9M6hgPHEq5GsObVKxB1tOo7vu7,5Gyp41oLVo7Gg7vF4vpmggWP5MU70QO6,5,2,1,0,1,0,3,1,8,1.1428571428571428,1,0.0,0,1,0,1,2,0,0,3,1,2,6,1
8778,151732,cWKmRi1tl61WJPbunii5uuuTocwPJJxm,5Gyp41oLVo7Gg7vF4vpmggWP5MU70QO6,8,10,4,3,2,0,1,0,20,2.857142857142857,1,0.0,4,4,2,2,6,0,1,1,0,12,8,1
8779,151736,MeEaJBPHOhvJedyLYbLqfHjYqs2UmsHw,5Gyp41oLVo7Gg7vF4vpmggWP5MU70QO6,12,18,7,8,3,0,2,0,38,5.428571428571429,3,0.0,6,7,5,3,12,0,3,2,0,21,17,1
8780,151759,N8YavScnynmN17xwRDaWr06pi0Njsdwq,5Gyp41oLVo7Gg7vF4vpmggWP5MU70QO6,15,17,9,0,5,0,7,0,38,5.428571428571429,3,0.0,0,9,0,5,17,0,0,7,0,14,24,1
8781,151817,KfoZ69zTNu1FkbuybYuVyLqWQTXsDAu5,5Gyp41oLVo7Gg7vF4vpmggWP5MU70QO6,24,57,30,30,12,37,23,6,195,27.857142857142858,2,0.0,9,30,21,12,48,37,9,23,6,72,123,0
8782,151831,2FPCJ9l6CyULWDMJ7I3XgGilh8se7rpF,5Gyp41oLVo7Gg7vF4vpmggWP5MU70QO6,5,2,1,0,1,0,2,0,6,0.8571428571428571,1,0.0,0,1,0,1,2,0,0,2,0,2,4,1
8783,151841,96rI6chLVrZXlvSRGcYlcVVN1yH7CeLn,5Gyp41oLVo7Gg7vF4vpmggWP5MU70QO6,10,9,3,0,1,0,5,0,18,2.5714285714285716,1,0.0,0,3,0,1,9,0,0,5,0,4,14,1
8784,151843,xA4aRzfOsZxYOYwTl2YiACpOGfDUqBdK,5Gyp41oLVo7Gg7vF4vpmggWP5MU70QO6,4,2,1,0,1,0,1,0,5,0.7142857142857143,1,0.0,0,1,0,1,2,0,0,1,0,2,3,1
8785,151868,IH1GHsZkw6pd0ET9R0AxS98ZlpHOijrz,5Gyp41oLVo7Gg7vF4vpmggWP5MU70QO6,5,4,3,0,1,0,1,0,9,1.2857142857142858,1,0.0,0,3,0,1,4,0,0,1,0,4,5,1
8786,151883,X78n2HoCUAiF9oMLfhP6UzCbg1d845Fc,5Gyp41oLVo7Gg7vF4vpmggWP5MU70QO6,4,4,1,0,0,0,4,0,9,1.2857142857142858,1,0.0,0,1,0,0,4,0,0,4,0,1,8,1
8787,151885,SatTXnx8kRcL6R9GMVodkDdfLaTcz43o,5Gyp41oLVo7Gg7vF4vpmggWP5MU70QO6,9,3,0,0,2,5,4,1,15,2.142857142857143,1,0.0,0,0,0,2,3,5,0,4,1,2,13,1
8788,151916,CwyOL3RMOVLomxrxyN9D4jPa9R0iWrS5,5Gyp41oLVo7Gg7vF4vpmggWP5MU70QO6,7,3,2,0,2,0,2,0,9,1.2857142857142858,1,0.0,0,2,0,2,3,0,0,2,0,4,5,1
8789,151924,076qzRBzR2zoTFPTpDElhPZwWu7C9KFj,5Gyp41oLVo7Gg7vF4vpmggWP5MU70QO6,5,2,1,0,1,0,2,0,6,0.8571428571428571,1,0.0,0,1,0,1,2,0,0,2,0,2,4,1
8790,151941,jCJUFuYu6GiUETXHF64p0zXYK72Mujfp,5Gyp41oLVo7Gg7vF4vpmggWP5MU70QO6,6,3,2,0,2,0,1,0,8,1.1428571428571428,1,0.0,0,2,0,2,3,0,0,1,0,4,4,1
8791,151946,7dLPegA4nKNLVosIhQODby7r7kJfh6oT,5Gyp41oLVo7Gg7vF4vpmggWP5MU70QO6,7,3,2,0,2,0,5,0,12,1.7142857142857142,1,0.0,0,2,0,2,3,0,0,5,0,4,8,1
8792,151965,30OTrxxbLTvIBMGCHkejc2VBCNgO8W5g,5Gyp41oLVo7Gg7vF4vpmggWP5MU70QO6,1,0,0,0,0,0,1,0,1,0.14285714285714285,1,0.0,0,0,0,0,0,0,0,1,0,0,1,1
8793,151974,blaKT90TeOTAa2RsAkTxWQqeLxEi93Qu,5Gyp41oLVo7Gg7vF4vpmggWP5MU70QO6,8,4,0,0,4,0,3,0,11,1.5714285714285714,1,0.0,2,0,0,4,2,0,0,3,0,6,5,1
8794,151981,C5INU4vEMoZCKeZLh5aelqFa9vdxDX8v,5Gyp41oLVo7Gg7vF4vpmggWP5MU70QO6,1,0,0,0,0,0,1,0,1,0.14285714285714285,1,0.0,0,0,0,0,0,0,0,1,0,0,1,1
8795,151990,OiROY8remVwcW5HPFwHuu5bKwEILqKWi,5Gyp41oLVo7Gg7vF4vpmggWP5MU70QO6,4,2,1,0,1,0,2,0,6,0.8571428571428571,2,0.0,0,1,0,1,2,0,0,2,0,2,4,1
8796,151996,6qKlxn8nCsHY0aHiNsGMyAiNmdUjrEo2,5Gyp41oLVo7Gg7vF4vpmggWP5MU70QO6,4,2,1,0,1,0,1,0,5,0.7142857142857143,1,0.0,0,1,0,1,2,0,0,1,0,2,3,1
8797,151997,utLNCqYllw6MM0LigvprePILK1WVTbt6,5Gyp41oLVo7Gg7vF4vpmggWP5MU70QO6,7,2,2,0,2,0,2,0,8,1.1428571428571428,1,0.0,0,2,0,2,2,0,0,2,0,4,4,1
8798,152009,ugg2wjUMXHuBgknMy9mAhjjiioWQfh8W,5Gyp41oLVo7Gg7vF4vpmggWP5MU70QO6,13,8,4,0,4,0,17,0,33,4.714285714285714,2,0.0,2,4,0,4,6,0,0,17,0,10,23,1
8799,152011,2eLTV9KmB3UnAhEXXI78r75iehfTvtic,5Gyp41oLVo7Gg7vF4vpmggWP5MU70QO6,11,12,7,0,2,0,3,0,24,3.4285714285714284,1,0.0,2,7,0,2,10,0,0,3,0,11,13,1
8800,152018,0EjPW445CKgaymeQ2qj6yLWLiAttBpmv,5Gyp41oLVo7Gg7vF4vpmggWP5MU70QO6,2,0,0,0,0,0,3,0,3,0.42857142857142855,1,0.0,0,0,0,0,0,0,0,3,0,0,3,1
8801,152038,ONghHwhwAX2IyqpHHX698rW0VH9BRcsu,5Gyp41oLVo7Gg7vF4vpmggWP5MU70QO6,10,9,4,0,4,0,5,0,22,3.142857142857143,2,0.0,3,4,0,4,6,0,0,5,0,11,11,1
8802,152039,8CEJhib8SusSPBX6mLFbg3l2buN3uo4C,5Gyp41oLVo7Gg7vF4vpmggWP5MU70QO6,7,3,2,0,2,0,2,0,9,1.2857142857142858,1,0.0,0,2,0,2,3,0,0,2,0,4,5,1
8803,152046,xtshUC69TVdVKcM1M70T2Bi1LpuNKwMG,5Gyp41oLVo7Gg7vF4vpmggWP5MU70QO6,5,2,1,0,1,0,2,0,6,0.8571428571428571,1,0.0,0,1,0,1,2,0,0,2,0,2,4,1
8804,152049,6pPM8viRBsZ5riApK3StH7gctEnt9yOW,5Gyp41oLVo7Gg7vF4vpmggWP5MU70QO6,6,4,1,0,0,0,3,0,8,1.1428571428571428,1,0.0,0,1,0,0,4,0,0,3,0,1,7,1
8805,152052,omogDjehriHed7WOB06lowOCzWJT5HFG,5Gyp41oLVo7Gg7vF4vpmggWP5MU70QO6,11,11,4,0,5,1,6,1,28,4.0,3,0.0,4,4,0,5,7,1,0,6,1,13,15,1
8806,152054,f1SJwjxXune3pk3OX8O5QJBrdKVLp9My,5Gyp41oLVo7Gg7vF4vpmggWP5MU70QO6,6,5,3,0,2,1,3,0,14,2.0,1,0.0,0,3,0,2,5,1,0,3,0,5,9,1
8807,152077,hvjeWwkeBVWsCuQiAiwgXKaku9nMJg9s,5Gyp41oLVo7Gg7vF4vpmggWP5MU70QO6,8,4,2,0,1,0,7,1,15,2.142857142857143,1,0.0,0,2,0,1,4,0,0,7,1,3,12,1
8808,152082,huJ4RGS1d7VtRcmbsICWMWQhw8jgo9HW,5Gyp41oLVo7Gg7vF4vpmggWP5MU70QO6,3,2,1,0,0,0,1,0,4,0.5714285714285714,1,0.0,0,1,0,0,2,0,0,1,0,1,3,1
8809,152128,lsROVrQeyHSAuyukaA0G0zN8QO9HqyH4,5Gyp41oLVo7Gg7vF4vpmggWP5MU70QO6,11,12,4,9,2,0,1,0,28,4.0,1,0.0,6,4,6,2,6,0,3,1,0,18,10,1
8810,152137,Qx9UDZ9u4rlicMPhOyre1Uzu81os2EuR,5Gyp41oLVo7Gg7vF4vpmggWP5MU70QO6,11,5,4,0,4,0,2,0,15,2.142857142857143,1,0.0,0,4,0,4,5,0,0,2,0,8,7,1
8811,152148,Zmu4feWExffgJhdo86JIkh5yM6yOEV9y,5Gyp41oLVo7Gg7vF4vpmggWP5MU70QO6,10,3,3,2,2,1,3,1,15,2.142857142857143,1,0.0,0,3,1,2,3,1,1,3,1,6,9,1
8812,152202,kU22DGnuGpDa4awKp7Oe0zbcu4isBbHL,5Gyp41oLVo7Gg7vF4vpmggWP5MU70QO6,5,5,1,0,4,0,2,0,12,1.7142857142857142,1,0.0,0,1,0,4,5,0,0,2,0,5,7,1
8813,152227,bGSf4Dv41LrPDFgbxGTmHZXMfhKccKJy,5Gyp41oLVo7Gg7vF4vpmggWP5MU70QO6,1,0,0,0,0,0,1,0,1,0.14285714285714285,1,0.0,0,0,0,0,0,0,0,1,0,0,1,1
8814,152229,RZ5wQWccvFAvYnggcAEAEGFxSPpaYGdj,5Gyp41oLVo7Gg7vF4vpmggWP5MU70QO6,1,0,0,0,0,0,1,0,1,0.14285714285714285,1,0.0,0,0,0,0,0,0,0,1,0,0,1,1
8815,152230,57qzgJAwfROYPxzSOrsA3G5DLHP95ajU,5Gyp41oLVo7Gg7vF4vpmggWP5MU70QO6,4,2,1,0,1,0,2,0,6,0.8571428571428571,1,0.0,0,1,0,1,2,0,0,2,0,2,4,0
8816,152269,kYCiC9sjJhVea0nSa72pTn7A2eOhjLmI,5Gyp41oLVo7Gg7vF4vpmggWP5MU70QO6,11,13,8,8,4,0,4,0,37,5.285714285714286,4,0.0,1,8,4,4,12,0,4,4,0,17,20,0
8817,152271,vNZLW4Mhl5fYWyn37Qu07nmCjWe7nwBC,5Gyp41oLVo7Gg7vF4vpmggWP5MU70QO6,5,3,0,0,0,0,3,1,7,1.0,1,0.0,0,0,0,0,3,0,0,3,1,0,7,1
8818,152294,lmaQ7sjb790aXLd2hgtVOpl4vHcpNivc,5Gyp41oLVo7Gg7vF4vpmggWP5MU70QO6,10,5,3,0,3,1,5,0,17,2.4285714285714284,1,0.0,1,3,0,3,4,1,0,5,0,7,10,1
8819,152295,Uf1qigQqXVxNALjpI0OUPGkslBlud9Ut,5Gyp41oLVo7Gg7vF4vpmggWP5MU70QO6,15,12,9,0,4,0,2,0,27,3.857142857142857,2,0.0,0,9,0,4,12,0,0,2,0,13,14,0
8820,152322,5vUuq5ZeDCNce4LmvH0naoUjpb3qbNOp,5Gyp41oLVo7Gg7vF4vpmggWP5MU70QO6,2,0,0,0,0,0,4,0,4,0.5714285714285714,2,0.0,0,0,0,0,0,0,0,4,0,0,4,1
8821,152338,l3yPbqlYTfWOgaxqaqE6scvK7rLOR7cQ,5Gyp41oLVo7Gg7vF4vpmggWP5MU70QO6,9,10,3,0,3,0,3,1,20,2.857142857142857,1,0.0,0,3,0,3,10,0,0,3,1,6,14,1
8822,152380,D7fF4POaHjzdqVaKTgpTS73i9DkdFXd4,5Gyp41oLVo7Gg7vF4vpmggWP5MU70QO6,15,23,14,14,5,10,8,0,74,10.571428571428571,2,0.0,6,14,9,5,17,10,5,8,0,34,40,1
8823,152385,1nu2wF0Wb8q5X2YUWZC6BMd7XRS5JE6T,5Gyp41oLVo7Gg7vF4vpmggWP5MU70QO6,6,3,2,0,0,1,5,1,12,1.7142857142857142,1,0.0,0,2,0,0,3,1,0,5,1,2,10,1
8824,152392,EP1XQRGS4HZOG1hdGzNZdD1HFhJcHpos,5Gyp41oLVo7Gg7vF4vpmggWP5MU70QO6,10,10,5,0,2,2,3,0,22,3.142857142857143,2,0.0,1,5,0,2,9,2,0,3,0,8,14,1
8825,152393,w79oIXxJA51xRJ7RWNha0P7ISQqedK5M,5Gyp41oLVo7Gg7vF4vpmggWP5MU70QO6,6,4,3,0,3,0,1,0,11,1.5714285714285714,1,0.0,0,3,0,3,4,0,0,1,0,6,5,1
8826,152396,vD39RgDh9o9HorljV8AcLJc0rny8tMWn,5Gyp41oLVo7Gg7vF4vpmggWP5MU70QO6,1,0,0,0,0,0,1,0,1,0.14285714285714285,1,0.0,0,0,0,0,0,0,0,1,0,0,1,1
8827,152421,gkQFQmICZ0u4XigX9mjHpGoN6sbIP3K4,5Gyp41oLVo7Gg7vF4vpmggWP5MU70QO6,12,21,12,6,6,2,3,0,50,7.142857142857143,2,0.0,2,12,3,6,19,2,3,3,0,23,27,1
8828,152432,PRlac1sh0f4uW8rEARh8qc5dcv1ibeHq,5Gyp41oLVo7Gg7vF4vpmggWP5MU70QO6,5,2,1,0,1,0,2,0,6,0.8571428571428571,1,0.0,0,1,0,1,2,0,0,2,0,2,4,1
8829,152456,fn4MGeBxmuVod8SI7mfp3VQUaoNd59EU,5Gyp41oLVo7Gg7vF4vpmggWP5MU70QO6,15,10,5,11,3,0,3,0,32,4.571428571428571,2,0.0,2,5,7,3,8,0,4,3,0,17,15,1
8830,152470,zOr0niRplBKfkwpPHNykN96u1FhzegfK,5Gyp41oLVo7Gg7vF4vpmggWP5MU70QO6,1,0,0,0,0,0,1,0,1,0.14285714285714285,1,0.0,0,0,0,0,0,0,0,1,0,0,1,1
8831,152475,K22VFryh5Od9V1LL0eOyTaqPsCNGJ8v3,5Gyp41oLVo7Gg7vF4vpmggWP5MU70QO6,8,4,3,0,3,0,7,0,17,2.4285714285714284,2,0.0,0,3,0,3,4,0,0,7,0,6,11,1
8832,152476,0d9QTHxHI38QwsI8Nrfe3h4nIFkKB9wm,5Gyp41oLVo7Gg7vF4vpmggWP5MU70QO6,4,2,1,0,1,0,1,0,5,0.7142857142857143,1,0.0,0,1,0,1,2,0,0,1,0,2,3,1
8833,152494,BospP3Bm2EgHpdgaaoSLxMneaaDyM8fo,5Gyp41oLVo7Gg7vF4vpmggWP5MU70QO6,7,3,2,0,2,2,2,0,11,1.5714285714285714,1,0.0,0,2,0,2,3,2,0,2,0,4,7,1
8834,152498,iXEJ1rfu68zDKDu3FiFKj2kPpqtT5dfz,5Gyp41oLVo7Gg7vF4vpmggWP5MU70QO6,7,3,1,0,2,0,2,0,8,1.1428571428571428,1,0.0,0,1,0,2,3,0,0,2,0,3,5,1
8835,152500,eiGGLBymM1p4bVlwpT4sWkdz6AcVphJo,5Gyp41oLVo7Gg7vF4vpmggWP5MU70QO6,10,12,5,5,3,5,6,0,36,5.142857142857143,3,0.0,4,5,3,3,8,5,2,6,0,15,21,1
8836,152506,FsN3EYiAfRxm9msVQNiGujMlmaZjdiLV,5Gyp41oLVo7Gg7vF4vpmggWP5MU70QO6,4,2,1,0,1,0,1,0,5,0.7142857142857143,1,0.0,0,1,0,1,2,0,0,1,0,2,3,1
8837,152537,aCfqKpyizkWVRtIyUI2vsWY2Cb09yHMB,5Gyp41oLVo7Gg7vF4vpmggWP5MU70QO6,18,100,36,0,1,0,28,1,166,23.714285714285715,4,0.0,12,36,0,1,88,0,0,28,1,49,117,1
8838,152555,PwLbv5h5IP5F0KdwgVJoDfAiwMZsoA8P,5Gyp41oLVo7Gg7vF4vpmggWP5MU70QO6,16,16,9,9,5,0,6,7,52,7.428571428571429,2,0.0,5,9,6,5,11,0,3,6,7,25,27,1
8839,152569,O9vCDs3Q32DEJ6GAN31HsZu74WF9oFYW,5Gyp41oLVo7Gg7vF4vpmggWP5MU70QO6,6,3,1,0,1,0,2,0,7,1.0,1,0.0,0,1,0,1,3,0,0,2,0,2,5,1
8840,152610,0IfdWa7sUumEN6EHXjLqFdgP3I3lCMu6,5Gyp41oLVo7Gg7vF4vpmggWP5MU70QO6,14,14,6,5,4,0,6,1,36,5.142857142857143,2,0.0,5,6,3,4,9,0,2,6,1,18,18,1
8841,152642,isHlzTZhxk4cqf66hkvwTqXlkBml3duZ,5Gyp41oLVo7Gg7vF4vpmggWP5MU70QO6,1,0,0,0,0,0,3,0,3,0.42857142857142855,1,0.0,0,0,0,0,0,0,0,3,0,0,3,1
8842,152650,5SYMX62EU0fTgauNduABVoLxd6a2qPFl,5Gyp41oLVo7Gg7vF4vpmggWP5MU70QO6,8,13,6,0,2,0,3,0,24,3.4285714285714284,2,0.0,0,6,0,2,13,0,0,3,0,8,16,1
8843,152655,HHRmRRTDc1HXofbADbdvq38XiSbmjOI2,5Gyp41oLVo7Gg7vF4vpmggWP5MU70QO6,1,0,0,0,0,0,1,0,1,0.14285714285714285,1,0.0,0,0,0,0,0,0,0,1,0,0,1,1
8844,152662,8Bh4X8x9tbx01mYXJaqcIoTEqUCbSq2f,5Gyp41oLVo7Gg7vF4vpmggWP5MU70QO6,5,2,1,0,1,0,2,0,6,0.8571428571428571,1,0.0,0,1,0,1,2,0,0,2,0,2,4,1
8845,152671,rDBZw8ApsiHlrc5StlvYPE9A5f0mUyOy,5Gyp41oLVo7Gg7vF4vpmggWP5MU70QO6,10,8,4,0,3,0,4,0,19,2.7142857142857144,1,0.0,0,4,0,3,8,0,0,4,0,7,12,1
8846,152687,9lKad9GgZ33IQc9EXgqQ1nba8j7bVZdv,5Gyp41oLVo7Gg7vF4vpmggWP5MU70QO6,11,7,4,0,2,2,7,1,23,3.2857142857142856,1,0.0,2,4,0,2,5,2,0,7,1,8,15,1
8847,152689,CWfEuozBd4liyBTvOMVgNSWJo0S8l1jG,5Gyp41oLVo7Gg7vF4vpmggWP5MU70QO6,5,4,1,0,0,0,1,0,6,0.8571428571428571,1,0.0,0,1,0,0,4,0,0,1,0,1,5,1
8848,152702,lDkAOe2pGUkP1ca3JwSWBVJoUdsiFRPV,5Gyp41oLVo7Gg7vF4vpmggWP5MU70QO6,1,0,0,0,0,0,1,0,1,0.14285714285714285,1,0.0,0,0,0,0,0,0,0,1,0,0,1,1
8849,152710,KBmTf7WYCa0svgFNepaA95qTJIR6E1ZO,5Gyp41oLVo7Gg7vF4vpmggWP5MU70QO6,4,2,0,0,1,0,3,0,6,0.8571428571428571,1,0.0,0,0,0,1,2,0,0,3,0,1,5,1
8850,152711,ckifcd5IEMKJyn2lfnSGbBrmlVdPcyOj,5Gyp41oLVo7Gg7vF4vpmggWP5MU70QO6,9,7,3,0,4,6,6,0,26,3.7142857142857144,1,0.0,1,3,0,4,6,6,0,6,0,8,18,1
8851,152717,Ni5bteM7WARzZAwwtJCSBEmehpeOn2OA,5Gyp41oLVo7Gg7vF4vpmggWP5MU70QO6,7,3,2,0,2,0,2,0,9,1.2857142857142858,1,0.0,0,2,0,2,3,0,0,2,0,4,5,1
8852,152721,ZX4lhV9dWj1P8mNqKyeqbe9dmDE0K15a,5Gyp41oLVo7Gg7vF4vpmggWP5MU70QO6,10,6,3,0,3,0,3,0,15,2.142857142857143,1,0.0,2,3,0,3,4,0,0,3,0,8,7,1
8853,152726,OFOEYOS8uxGx97U32kdz0XyRq1O1PMD0,5Gyp41oLVo7Gg7vF4vpmggWP5MU70QO6,6,3,2,0,2,0,1,0,8,1.1428571428571428,1,0.0,0,2,0,2,3,0,0,1,0,4,4,1
8854,152736,JPhJwvyrN7DZQhMFX7BMe7XmlxjsWqk8,5Gyp41oLVo7Gg7vF4vpmggWP5MU70QO6,6,4,2,0,2,0,1,0,9,1.2857142857142858,1,0.0,1,2,0,2,3,0,0,1,0,5,4,1
8855,152748,e3uqzENACxEsDe0WATOVvMr7tkVC768H,5Gyp41oLVo7Gg7vF4vpmggWP5MU70QO6,5,1,1,0,1,0,4,0,7,1.0,1,0.0,0,1,0,1,1,0,0,4,0,2,5,1
8856,152750,pwCPzTmHoSwZ6HrF3cLVOb8UqBlJpBBW,5Gyp41oLVo7Gg7vF4vpmggWP5MU70QO6,6,4,2,0,1,0,3,0,10,1.4285714285714286,1,0.0,0,2,0,1,4,0,0,3,0,3,7,1
8857,152753,cgDKSNH45Mrl03dZiqmVtDWiojulUNN5,5Gyp41oLVo7Gg7vF4vpmggWP5MU70QO6,4,2,1,0,1,0,1,0,5,0.7142857142857143,1,0.0,0,1,0,1,2,0,0,1,0,2,3,1
8858,152771,bJOyNfQql7s0NySd8xPqJe0iH1TSF4ku,5Gyp41oLVo7Gg7vF4vpmggWP5MU70QO6,9,5,3,0,4,0,1,0,13,1.8571428571428572,1,0.0,1,3,0,4,4,0,0,1,0,8,5,1
8859,152773,duVRqnj8JL1j8ogNbpoeMnkfG8VUSgFg,5Gyp41oLVo7Gg7vF4vpmggWP5MU70QO6,13,20,8,2,3,3,8,1,45,6.428571428571429,2,0.0,9,8,1,3,11,3,1,8,1,21,24,1
8860,152782,iP3M15TChtZoTU2W8weDGMA2fr7tnTCt,5Gyp41oLVo7Gg7vF4vpmggWP5MU70QO6,5,6,0,0,0,0,2,0,8,1.1428571428571428,1,0.0,0,0,0,0,6,0,0,2,0,0,8,1
8861,152791,iMqHiXfdYvPMULl8VYyOXwJF8trdBBXq,5Gyp41oLVo7Gg7vF4vpmggWP5MU70QO6,15,31,22,14,7,10,11,1,96,13.714285714285714,4,0.0,3,22,10,7,28,10,4,11,1,42,54,1
8862,152809,JfTOfcf15FK7jTKVpQgFx9rCClmYQ1Py,5Gyp41oLVo7Gg7vF4vpmggWP5MU70QO6,8,6,4,0,3,0,3,0,16,2.2857142857142856,2,0.0,0,4,0,3,6,0,0,3,0,7,9,1
8863,152813,3zvHKS6M4U1m424fRhI52J9JeELqakS5,5Gyp41oLVo7Gg7vF4vpmggWP5MU70QO6,11,13,1,2,3,0,6,3,28,4.0,3,0.0,1,1,1,3,12,0,1,6,3,6,22,0
8864,152826,JaY583iEzhUh1H375yAqlbYi0f6zdDLM,5Gyp41oLVo7Gg7vF4vpmggWP5MU70QO6,1,0,0,0,0,0,1,0,1,0.14285714285714285,1,0.0,0,0,0,0,0,0,0,1,0,0,1,1
8865,152831,EcVZjhzxCfpLfl9VfLyd7XBDTTX4afqq,5Gyp41oLVo7Gg7vF4vpmggWP5MU70QO6,22,55,22,26,17,2,15,1,138,19.714285714285715,3,0.0,23,22,17,17,32,2,9,15,1,79,59,1
8866,152855,GPbq86k98Rz9tUbijEEopIymy9u0Fcyf,7GRhBDsirIGkRZBtSMEzNTyDr2JQm4xx,1,0,0,0,0,0,1,0,1,0.14285714285714285,1,0.0,0,0,0,0,0,0,0,1,0,0,1,1
8867,152887,MDFjVXgtYzZVyK4QPMD7X2zkYyaEYCUs,5X6FeZozNMgE2VRi3MJYjkkFK8SETtu2,2,0,0,0,0,0,3,0,3,0.42857142857142855,1,0.0,0,0,0,0,0,0,0,3,0,0,3,1
8868,152897,Ora02944NsUtAGSKWplRuKmq6bV7dPd0,5X6FeZozNMgE2VRi3MJYjkkFK8SETtu2,5,4,0,0,0,0,3,0,7,1.0,1,0.0,0,0,0,0,4,0,0,3,0,0,7,1
8869,152963,1qA8a5iVvPnhwEF9sRv1kIfsUyLQnW2P,5X6FeZozNMgE2VRi3MJYjkkFK8SETtu2,1,0,0,0,0,0,1,0,1,0.14285714285714285,1,0.0,0,0,0,0,0,0,0,1,0,0,1,1
8870,153108,BfoIsQXdmfYhoAzytmfllMYGIk5v6NxW,5X6FeZozNMgE2VRi3MJYjkkFK8SETtu2,6,2,1,0,1,0,6,0,10,1.4285714285714286,3,0.0,0,1,0,1,2,0,0,6,0,2,8,1
8871,153171,UGYGSfRkJhOkgkdlCI6YSCshpNvwBF31,5X6FeZozNMgE2VRi3MJYjkkFK8SETtu2,5,2,1,0,1,0,2,0,6,0.8571428571428571,1,0.0,0,1,0,1,2,0,0,2,0,2,4,1
8872,153173,HuLHCkffx7NTEjFGXpjyYhc55925sZcQ,5X6FeZozNMgE2VRi3MJYjkkFK8SETtu2,13,7,6,0,5,0,1,0,19,2.7142857142857144,1,0.0,0,6,0,5,7,0,0,1,0,11,8,1
8873,153201,HycevJIm7cBjf1oJ5QCBMMXEBTG8jyRF,5X6FeZozNMgE2VRi3MJYjkkFK8SETtu2,1,0,0,0,0,0,1,0,1,0.14285714285714285,1,0.0,0,0,0,0,0,0,0,1,0,0,1,1
8874,153597,6eigRKdKORgy46hn8ZqOQWxZJBzNbSVK,SpATywNh6bZuzm8s1ceuBUnMUAeoAHHw,8,8,1,22,0,0,1,0,32,4.571428571428571,1,0.0,4,1,19,0,4,0,3,1,0,24,8,0
8875,153627,Cx9UgN9CA3ZQNCspfULD8FGJJpSFtxJF,A3fsA9Zfv1X2fVEQhTw51lKENdNrEqT3,35,24,20,0,14,0,9,0,67,9.571428571428571,2,0.0,0,20,0,14,24,0,0,9,0,34,33,1
8876,153670,9CQfIvDiQz4gDArSnTXOgxNKUwJW75pD,G8EPVSXsOYB5YQWZGiz1aVq5Pgr2GrQu,31,48,17,32,10,0,12,0,119,17.0,3,0.0,21,17,22,10,27,0,10,12,0,70,49,1
8877,153990,wUS4QMZENKgcJOovrFGfoZniw3fDJWWg,SpATywNh6bZuzm8s1ceuBUnMUAeoAHHw,8,6,3,14,0,0,1,0,24,3.4285714285714284,1,0.0,2,3,12,0,4,0,2,1,0,17,7,0
8878,154200,ADL0cXowUMs4wyiAOHKMOrtTHu5tmUqi,bWdj2GDclj5ofokWjzoa5jAwMkxCykd6,1,0,0,0,0,0,1,0,1,0.14285714285714285,1,0.0,0,0,0,0,0,0,0,1,0,0,1,1
8879,154205,VkP2FMJkYtjRnWEjWjvJiNyMgDQRBrMl,SpATywNh6bZuzm8s1ceuBUnMUAeoAHHw,2,0,0,0,0,0,2,0,2,0.2857142857142857,1,0.0,0,0,0,0,0,0,0,2,0,0,2,1
8880,154211,RcsMEES0IQ1NHP2Ss1VxXk92ez6mhLug,bWdj2GDclj5ofokWjzoa5jAwMkxCykd6,4,3,1,0,0,0,3,0,7,1.0,1,0.0,0,1,0,0,3,0,0,3,0,1,6,1
8881,154221,1L7XwCOwn8nIJFjaEmGoI47SzrXbe8CM,SpATywNh6bZuzm8s1ceuBUnMUAeoAHHw,20,29,5,18,3,0,12,0,67,9.571428571428571,2,0.0,3,5,14,3,26,0,4,12,0,25,42,0
8882,154223,BMt1sMJKW8lUV5XsrUOWqq2qoU33TZEw,SpATywNh6bZuzm8s1ceuBUnMUAeoAHHw,5,2,1,0,1,0,3,0,7,1.0,2,0.0,0,1,0,1,2,0,0,3,0,2,5,0
8883,154228,VJhm6I36LQr0FmcUOAokoIcRg6PaQgVK,5X6FeZozNMgE2VRi3MJYjkkFK8SETtu2,11,10,4,16,1,0,1,0,32,4.571428571428571,1,0.0,5,4,13,1,5,0,3,1,0,23,9,1
8884,154231,K0hgN6EPFKAMVeEw5GxRK0vYsf24AoLe,SpATywNh6bZuzm8s1ceuBUnMUAeoAHHw,9,10,1,0,1,0,2,0,14,2.0,1,0.0,0,1,0,1,10,0,0,2,0,2,12,1
8885,154246,doq0SIEfuXLh3rhMgIRl48ziIEgIAsIt,bWdj2GDclj5ofokWjzoa5jAwMkxCykd6,2,0,0,0,0,0,5,0,5,0.7142857142857143,1,0.0,0,0,0,0,0,0,0,5,0,0,5,1
8886,154247,P6B9efDEJGlP1ORO2WrplfGvOXQTSwgH,SpATywNh6bZuzm8s1ceuBUnMUAeoAHHw,8,5,0,10,0,0,3,0,18,2.5714285714285716,1,0.0,2,0,9,0,3,0,1,3,0,11,7,1
8887,154249,vMZukU2eTrxJbVM8jQ4bYVexnS3K2zdf,RXDvfPUBYFlVdlueBFbLW0mhhAyGEqpt,1,0,0,0,0,0,1,0,1,0.14285714285714285,1,0.0,0,0,0,0,0,0,0,1,0,0,1,1
8888,154250,vMZukU2eTrxJbVM8jQ4bYVexnS3K2zdf,A3fsA9Zfv1X2fVEQhTw51lKENdNrEqT3,1,0,0,0,0,0,1,0,1,0.14285714285714285,1,0.0,0,0,0,0,0,0,0,1,0,0,1,1
8889,154251,oq792xm7gmyCP2WQE7GtJSHRmKgIoEc3,A3fsA9Zfv1X2fVEQhTw51lKENdNrEqT3,8,4,2,0,2,0,4,0,12,1.7142857142857142,1,0.0,0,2,0,2,4,0,0,4,0,4,8,1
8890,154265,lHNqd6KTSO9CrJzRDAqosVITLVN3mMHR,A3fsA9Zfv1X2fVEQhTw51lKENdNrEqT3,4,2,1,0,1,0,2,0,6,0.8571428571428571,1,0.0,0,1,0,1,2,0,0,2,0,2,4,1
8891,154301,Q95csmmf8N84WQQSbOMc5rN6dm3wzDuG,SpATywNh6bZuzm8s1ceuBUnMUAeoAHHw,13,40,1,9,0,0,2,0,52,7.428571428571429,1,0.0,1,1,7,0,39,0,2,2,0,9,43,0
8892,154312,j5n34dhJSAsFAv6KAw4rsAZTfhL07lCD,SpATywNh6bZuzm8s1ceuBUnMUAeoAHHw,2,0,0,0,0,0,4,0,4,0.5714285714285714,1,0.0,0,0,0,0,0,0,0,4,0,0,4,0
8893,154323,8wj2Kr145taRtViYKZRdPMwAZeP9BDRs,bWdj2GDclj5ofokWjzoa5jAwMkxCykd6,7,22,0,0,0,0,2,0,24,3.4285714285714284,1,0.0,0,0,0,0,22,0,0,2,0,0,24,1
8894,154333,bwcAzG6YdKhEVab04avTnWUikImaTY8v,RXDvfPUBYFlVdlueBFbLW0mhhAyGEqpt,1,0,0,0,0,0,1,0,1,0.14285714285714285,1,0.0,0,0,0,0,0,0,0,1,0,0,1,1
8895,154334,bwcAzG6YdKhEVab04avTnWUikImaTY8v,A3fsA9Zfv1X2fVEQhTw51lKENdNrEqT3,9,2,1,0,1,1,18,2,25,3.5714285714285716,1,0.0,0,1,0,1,2,1,0,18,2,2,23,1
8896,154354,4WoTXmD4gNpFhGlNTy7sFsNpyMYm6Dkz,RXDvfPUBYFlVdlueBFbLW0mhhAyGEqpt,6,2,1,0,1,0,3,0,7,1.0,1,0.0,0,1,0,1,2,0,0,3,0,2,5,1
8897,154362,borLfwQKnWQDaKpJWf2eYB7K9O0eDbfg,SpATywNh6bZuzm8s1ceuBUnMUAeoAHHw,7,5,2,0,1,0,2,0,10,1.4285714285714286,1,0.0,0,2,0,1,5,0,0,2,0,3,7,1
8898,154366,3qfZ2A9FxIJejbK8qk5S90EK3qjlCNkC,bWdj2GDclj5ofokWjzoa5jAwMkxCykd6,2,0,0,0,0,0,2,0,2,0.2857142857142857,1,0.0,0,0,0,0,0,0,0,2,0,0,2,1
8899,154378,0bzBCQH8D9DXq9uXmykneuVKZUsPAEIB,A3fsA9Zfv1X2fVEQhTw51lKENdNrEqT3,1,0,0,0,0,0,1,0,1,0.14285714285714285,1,0.0,0,0,0,0,0,0,0,1,0,0,1,1
8900,154388,yn2Ij88V2wSgGFNHE75cImAmp292E61N,bWdj2GDclj5ofokWjzoa5jAwMkxCykd6,4,2,1,0,1,0,1,0,5,0.7142857142857143,1,0.0,0,1,0,1,2,0,0,1,0,2,3,1
8901,154403,Mh44KtMgRmYCujGM63SxGn0CwanNqhA0,SpATywNh6bZuzm8s1ceuBUnMUAeoAHHw,8,6,3,0,2,0,4,0,15,2.142857142857143,1,0.0,0,3,0,2,6,0,0,4,0,5,10,1
8902,154407,sL5jw3pLWZoRI7avI17oM60mfF67Acgz,SpATywNh6bZuzm8s1ceuBUnMUAeoAHHw,1,0,0,0,0,0,1,0,1,0.14285714285714285,1,0.0,0,0,0,0,0,0,0,1,0,0,1,0
8903,154411,olQfS2P1K3wp42EzSupsJTTzmMQfpa8x,bWdj2GDclj5ofokWjzoa5jAwMkxCykd6,1,0,0,0,0,0,1,0,1,0.14285714285714285,1,0.0,0,0,0,0,0,0,0,1,0,0,1,1
8904,154416,sL5jw3pLWZoRI7avI17oM60mfF67Acgz,A3fsA9Zfv1X2fVEQhTw51lKENdNrEqT3,1,0,0,0,0,0,1,0,1,0.14285714285714285,1,0.0,0,0,0,0,0,0,0,1,0,0,1,0
8905,154417,J7xI7D1ZLw62w7Lpu84mgS9dLOc8YAMh,SpATywNh6bZuzm8s1ceuBUnMUAeoAHHw,5,2,1,0,1,0,2,0,6,0.8571428571428571,1,0.0,0,1,0,1,2,0,0,2,0,2,4,1
8906,154428,Xbjcs0h4iqswHrts5r1qniR6WxCj6WXz,SpATywNh6bZuzm8s1ceuBUnMUAeoAHHw,6,3,1,0,1,0,2,0,7,1.0,1,0.0,0,1,0,1,3,0,0,2,0,2,5,1
8907,154442,1w3T4A4bbOqj5R90btAgoZLx68QfKlnC,SpATywNh6bZuzm8s1ceuBUnMUAeoAHHw,1,0,0,0,0,0,1,0,1,0.14285714285714285,1,0.0,0,0,0,0,0,0,0,1,0,0,1,1
8908,154444,3YtkDWwirpMDJnuKbd3WSxL09KJDQLqD,SpATywNh6bZuzm8s1ceuBUnMUAeoAHHw,7,3,2,0,2,0,2,0,9,1.2857142857142858,1,0.0,0,2,0,2,3,0,0,2,0,4,5,1
8909,154459,EbUgzFZQuqMLq3Ycl8KSraeAAdFrDcJ5,SpATywNh6bZuzm8s1ceuBUnMUAeoAHHw,1,0,0,0,0,0,1,0,1,0.14285714285714285,1,0.0,0,0,0,0,0,0,0,1,0,0,1,1
8910,154460,OEx9XlzSJPvCfbdzSv0p8sreAOhdWSET,5X6FeZozNMgE2VRi3MJYjkkFK8SETtu2,1,0,0,0,0,0,1,0,1,0.14285714285714285,1,0.0,0,0,0,0,0,0,0,1,0,0,1,1
8911,154469,bI0Q5X85yfYg1Yc91nn45oYI5ITZRXL9,SpATywNh6bZuzm8s1ceuBUnMUAeoAHHw,5,7,3,0,0,0,2,0,12,1.7142857142857142,1,0.0,0,3,0,0,7,0,0,2,0,3,9,1
8912,154475,wMQxNrryGKgbGXsy17gJPlh2fJdDvt8s,7GRhBDsirIGkRZBtSMEzNTyDr2JQm4xx,9,7,4,0,3,0,2,0,16,2.2857142857142856,1,0.0,2,4,0,3,5,0,0,2,0,9,7,1
8913,154478,JCNZU9htEer2NbGrICdyG89BFjfxR5oQ,SpATywNh6bZuzm8s1ceuBUnMUAeoAHHw,36,26,15,32,10,0,2,0,85,12.142857142857142,1,0.0,10,15,29,10,16,0,3,2,0,64,21,0
8914,154521,BFTedJpOGn9f3lzS2daZGbUvWzaKCeH4,RXDvfPUBYFlVdlueBFbLW0mhhAyGEqpt,1,0,0,0,0,0,1,0,1,0.14285714285714285,1,0.0,0,0,0,0,0,0,0,1,0,0,1,1
8915,154524,lmBC1dNZwqemvW2IDczAxkPjOIjaeRwM,A3fsA9Zfv1X2fVEQhTw51lKENdNrEqT3,1,0,0,0,0,0,1,0,1,0.14285714285714285,1,0.0,0,0,0,0,0,0,0,1,0,0,1,1
8916,154539,xZKocCFxH13wvUu4XlTWKN88QVCTtFi0,bWdj2GDclj5ofokWjzoa5jAwMkxCykd6,11,13,7,0,3,1,13,0,37,5.285714285714286,1,0.0,0,7,0,3,13,1,0,13,0,10,27,1
8917,154544,4Zj3rSr4SVLur34IbcdhBk6xi5qGX4FT,SpATywNh6bZuzm8s1ceuBUnMUAeoAHHw,1,0,0,0,0,0,1,0,1,0.14285714285714285,1,0.0,0,0,0,0,0,0,0,1,0,0,1,1
8918,154551,REu6I5HKZ7L3HGMQ4JYIwxBklFnvOom7,A3fsA9Zfv1X2fVEQhTw51lKENdNrEqT3,2,0,0,0,0,0,4,0,4,0.5714285714285714,1,0.0,0,0,0,0,0,0,0,4,0,0,4,1
8919,154560,KXPsJNzb3MNK5rxQc94IXJdmXF0ziWwA,bWdj2GDclj5ofokWjzoa5jAwMkxCykd6,7,4,2,0,1,0,3,0,10,1.4285714285714286,1,0.0,0,2,0,1,4,0,0,3,0,3,7,0
8920,154565,hUoOQP103jtoSjE8huNXPy5FlXS050j3,5X6FeZozNMgE2VRi3MJYjkkFK8SETtu2,1,0,0,0,0,0,1,0,1,0.14285714285714285,1,0.0,0,0,0,0,0,0,0,1,0,0,1,1
8921,154566,hUoOQP103jtoSjE8huNXPy5FlXS050j3,A3fsA9Zfv1X2fVEQhTw51lKENdNrEqT3,1,0,0,0,0,0,1,0,1,0.14285714285714285,1,0.0,0,0,0,0,0,0,0,1,0,0,1,1
8922,154584,CpJFUzNBBad8gxGQfFWcVCTdakqtlRdi,SpATywNh6bZuzm8s1ceuBUnMUAeoAHHw,1,0,0,0,0,0,1,0,1,0.14285714285714285,1,0.0,0,0,0,0,0,0,0,1,0,0,1,0
8923,154590,ssvdsBgwcBaykgmvf8ppxZPzAKCun6bj,RXDvfPUBYFlVdlueBFbLW0mhhAyGEqpt,1,0,0,0,0,0,1,0,1,0.14285714285714285,1,0.0,0,0,0,0,0,0,0,1,0,0,1,1
8924,154591,vso8N8C6SGS9FKZBYRQzzSzH6hqVT7IH,A3fsA9Zfv1X2fVEQhTw51lKENdNrEqT3,2,0,0,0,0,0,2,0,2,0.2857142857142857,1,0.0,0,0,0,0,0,0,0,2,0,0,2,1
8925,154598,LKQRwZ0wiIjNtxj2rwmRK6v48vwGtrYE,A3fsA9Zfv1X2fVEQhTw51lKENdNrEqT3,1,0,0,0,0,0,1,0,1,0.14285714285714285,1,0.0,0,0,0,0,0,0,0,1,0,0,1,1
8926,154604,YSnKbrlImP4pvrhieOIt3sEPDgO5Vl1a,5X6FeZozNMgE2VRi3MJYjkkFK8SETtu2,3,3,0,0,0,0,2,0,5,0.7142857142857143,1,0.0,0,0,0,0,3,0,0,2,0,0,5,1
8927,154641,0nScgbbn10u6m6AtEv5NZACOHoXfwiE1,A3fsA9Zfv1X2fVEQhTw51lKENdNrEqT3,5,2,1,0,1,0,2,0,6,0.8571428571428571,1,0.0,0,1,0,1,2,0,0,2,0,2,4,1
8928,154643,78awNsb2gv1BNI14errPUoSJXoVpCdJH,5X6FeZozNMgE2VRi3MJYjkkFK8SETtu2,4,2,1,0,1,0,1,0,5,0.7142857142857143,1,0.0,0,1,0,1,2,0,0,1,0,2,3,1
8929,154644,efygWYkxxUMOGInRZT4qEeuzMRlIpQq6,5X6FeZozNMgE2VRi3MJYjkkFK8SETtu2,9,19,5,0,11,0,3,0,38,5.428571428571429,1,0.0,12,5,0,11,7,0,0,3,0,28,10,1
8930,154665,wmND65rZOV8Cdq3Mq9MmFLy7XUHHSgIW,RXDvfPUBYFlVdlueBFbLW0mhhAyGEqpt,3,2,1,0,0,0,2,0,5,0.7142857142857143,1,0.0,0,1,0,0,2,0,0,2,0,1,4,1
8931,154667,kXKedIAlLk4nnLOObHVKEfusEbZyfe2f,SpATywNh6bZuzm8s1ceuBUnMUAeoAHHw,14,17,10,17,5,1,1,0,51,7.285714285714286,1,0.0,4,10,16,5,13,1,1,1,0,35,16,1
8932,154669,HrLh8JEm4n69pNmCXCEexqU3Iv3PlzAM,5X6FeZozNMgE2VRi3MJYjkkFK8SETtu2,8,3,1,0,1,0,13,2,20,2.857142857142857,1,0.0,1,1,0,1,2,0,0,13,2,3,17,1
8933,154683,MHJvZPnhmnZTjSPJQtFU0MT0vplye5Bv,G8EPVSXsOYB5YQWZGiz1aVq5Pgr2GrQu,5,2,1,0,1,0,2,0,6,0.8571428571428571,1,0.0,0,1,0,1,2,0,0,2,0,2,4,1
8934,154684,ZnPDiA6jmqQOIbODvVYNoIgZSaO1dso9,bWdj2GDclj5ofokWjzoa5jAwMkxCykd6,7,3,1,6,0,0,2,0,12,1.7142857142857142,1,0.0,0,1,5,0,3,0,1,2,0,6,6,1
8935,154688,O5KBwdPnEkmA9netVr9aGipw3OlgkQS8,SpATywNh6bZuzm8s1ceuBUnMUAeoAHHw,4,3,1,0,1,0,1,0,6,0.8571428571428571,1,0.0,0,1,0,1,3,0,0,1,0,2,4,0
8936,154697,baJe2qLGs3Ip92Th7HUsdUzkULF4fldq,SpATywNh6bZuzm8s1ceuBUnMUAeoAHHw,5,4,1,0,1,0,2,0,8,1.1428571428571428,1,0.0,0,1,0,1,4,0,0,2,0,2,6,1
8937,154702,51qEFZOUTGpCzgn45qQPhHW3j42BvDye,SpATywNh6bZuzm8s1ceuBUnMUAeoAHHw,1,0,0,0,0,0,1,0,1,0.14285714285714285,1,0.0,0,0,0,0,0,0,0,1,0,0,1,1
8938,154704,Egdy45SajGfwa36GhPAOZxJnoTDau3yk,bWdj2GDclj5ofokWjzoa5jAwMkxCykd6,6,4,1,0,0,0,2,0,7,1.0,1,0.0,0,1,0,0,4,0,0,2,0,1,6,1
8939,154710,DpmftUmsDQQIOqNkNnczWDyK6dR9ueCw,SpATywNh6bZuzm8s1ceuBUnMUAeoAHHw,2,0,0,0,0,0,3,0,3,0.42857142857142855,1,0.0,0,0,0,0,0,0,0,3,0,0,3,1
8940,154719,bQS9TypVeSJHdaY7Zz5SfbkFkeJ7Xy7P,G8EPVSXsOYB5YQWZGiz1aVq5Pgr2GrQu,6,4,1,0,1,0,2,0,8,1.1428571428571428,1,0.0,0,1,0,1,4,0,0,2,0,2,6,1
8941,154728,QTkjMZ2x2XpQJLg858rH1nCjMIxPq1Ot,A3fsA9Zfv1X2fVEQhTw51lKENdNrEqT3,2,0,0,0,0,0,2,0,2,0.2857142857142857,1,0.0,0,0,0,0,0,0,0,2,0,0,2,1
8942,154733,x6NoW0QQVYu5T8LkblNNdQuYhCF6tniR,bWdj2GDclj5ofokWjzoa5jAwMkxCykd6,2,0,0,0,0,0,3,0,3,0.42857142857142855,1,0.0,0,0,0,0,0,0,0,3,0,0,3,1
8943,154753,lX00Qx4mrcf92rmBX6j1aDrAydficDZP,RXDvfPUBYFlVdlueBFbLW0mhhAyGEqpt,1,0,0,0,0,0,1,0,1,0.14285714285714285,1,0.0,0,0,0,0,0,0,0,1,0,0,1,1
8944,154762,9g6cYAmFbDY0CjADcdMWUoQ4H4YvgLXQ,A3fsA9Zfv1X2fVEQhTw51lKENdNrEqT3,1,0,0,0,0,0,1,0,1,0.14285714285714285,1,0.0,0,0,0,0,0,0,0,1,0,0,1,1
8945,154764,BPDxtvSmkKR4nTdKjes8gGxzoOprTkK2,SpATywNh6bZuzm8s1ceuBUnMUAeoAHHw,6,4,3,0,1,0,1,0,9,1.2857142857142858,1,0.0,0,3,0,1,4,0,0,1,0,4,5,1
8946,154766,wwBHIx7ffu8zUvCJvQINAS5LfS3Nmyh1,SpATywNh6bZuzm8s1ceuBUnMUAeoAHHw,1,0,0,0,0,0,1,0,1,0.14285714285714285,1,0.0,0,0,0,0,0,0,0,1,0,0,1,1
8947,154775,Q3zkClKdiEJIkoKspwBuSNOwYXuxalAX,A3fsA9Zfv1X2fVEQhTw51lKENdNrEqT3,1,0,0,0,0,0,1,0,1,0.14285714285714285,1,0.0,0,0,0,0,0,0,0,1,0,0,1,1
8948,154789,bWTCgLlWI05nNVcVRoVSZYxP5KtyHgRM,5X6FeZozNMgE2VRi3MJYjkkFK8SETtu2,1,0,0,0,0,0,1,0,1,0.14285714285714285,1,0.0,0,0,0,0,0,0,0,1,0,0,1,1
8949,154792,bWTCgLlWI05nNVcVRoVSZYxP5KtyHgRM,G8EPVSXsOYB5YQWZGiz1aVq5Pgr2GrQu,1,0,0,0,0,0,1,0,1,0.14285714285714285,1,0.0,0,0,0,0,0,0,0,1,0,0,1,1
8950,154808,qk3k8D6g4BBZslMQhuZKH29auh1oUGgB,SpATywNh6bZuzm8s1ceuBUnMUAeoAHHw,13,17,8,23,0,2,2,0,52,7.428571428571429,1,0.0,7,8,21,0,10,2,2,2,0,36,16,0
8951,154832,RZF5krqbIaFqIutwBTONAy0kqy0VOuUh,A3fsA9Zfv1X2fVEQhTw51lKENdNrEqT3,5,4,0,0,0,0,9,0,13,1.8571428571428572,1,0.0,0,0,0,0,4,0,0,9,0,0,13,1
8952,154840,RZF5krqbIaFqIutwBTONAy0kqy0VOuUh,bWdj2GDclj5ofokWjzoa5jAwMkxCykd6,2,0,0,0,0,0,4,0,4,0.5714285714285714,1,0.0,0,0,0,0,0,0,0,4,0,0,4,1
8953,154846,Ife7vY8hAB8t9rfmTwXK28czbepIbFsG,G8EPVSXsOYB5YQWZGiz1aVq5Pgr2GrQu,1,0,0,0,0,0,1,0,1,0.14285714285714285,1,0.0,0,0,0,0,0,0,0,1,0,0,1,1
8954,154863,dbJ3S8TbbYbIZ5r4bCB0isavbQKpwDdZ,A3fsA9Zfv1X2fVEQhTw51lKENdNrEqT3,10,7,5,0,4,0,2,0,18,2.5714285714285716,1,0.0,1,5,0,4,6,0,0,2,0,10,8,0
8955,154865,I1340YsGXK2BIG96XRWppOvFniqpKDu7,SpATywNh6bZuzm8s1ceuBUnMUAeoAHHw,4,3,1,0,0,0,2,0,6,0.8571428571428571,1,0.0,0,1,0,0,3,0,0,2,0,1,5,1
8956,154870,jfVLsvKFkaWqAxR3s7Wt4wSauciS7FpV,SpATywNh6bZuzm8s1ceuBUnMUAeoAHHw,6,5,0,0,0,0,1,0,6,0.8571428571428571,1,0.0,0,0,0,0,5,0,0,1,0,0,6,1
8957,154895,qZCURwy8JtTyuwzOv8VNGZdlPKRFUQ4x,SpATywNh6bZuzm8s1ceuBUnMUAeoAHHw,6,5,1,0,0,0,5,0,11,1.5714285714285714,2,0.0,0,1,0,0,5,0,0,5,0,1,10,0
8958,154907,8pbex9YW7IEj2SIgZ25rRD3x0PLaEriE,A3fsA9Zfv1X2fVEQhTw51lKENdNrEqT3,1,0,0,0,0,0,1,0,1,0.14285714285714285,1,0.0,0,0,0,0,0,0,0,1,0,0,1,1
8959,154912,NqtJWYw7DQZw2JWGP131p1dqc9m7i7vh,RXDvfPUBYFlVdlueBFbLW0mhhAyGEqpt,45,34,15,107,14,1,2,0,173,24.714285714285715,1,0.0,18,15,98,14,16,1,9,2,0,145,28,0
8960,154913,j9DMqIZkavMsFdWoxVo3EuIrdKBeRzf9,RXDvfPUBYFlVdlueBFbLW0mhhAyGEqpt,62,47,31,58,22,6,6,0,170,24.285714285714285,2,0.0,11,31,58,22,36,6,0,6,0,122,48,1
8961,154940,MxhxHMlOpo3bTyeulVXY5tLPOxuKgX9g,RXDvfPUBYFlVdlueBFbLW0mhhAyGEqpt,5,6,1,0,0,0,2,0,9,1.2857142857142858,2,0.0,0,1,0,0,6,0,0,2,0,1,8,1
8962,154941,fPjkzYppwTWkalkc9Php6lYeEO8LNcjO,G8EPVSXsOYB5YQWZGiz1aVq5Pgr2GrQu,5,2,1,0,1,0,2,0,6,0.8571428571428571,1,0.0,0,1,0,1,2,0,0,2,0,2,4,1
8963,154942,ZzGpC0eNIcIIxJZ248D7OmNflJvxxp85,5X6FeZozNMgE2VRi3MJYjkkFK8SETtu2,1,0,0,0,0,0,1,0,1,0.14285714285714285,1,0.0,0,0,0,0,0,0,0,1,0,0,1,1
8964,154977,ek29LkWtDxA0v7lJYLGDshBZKC6XqZUG,bWdj2GDclj5ofokWjzoa5jAwMkxCykd6,2,0,0,0,0,0,2,0,2,0.2857142857142857,1,0.0,0,0,0,0,0,0,0,2,0,0,2,1
8965,154980,m9i2Su10H7rTersut82vK6JunWbBEwmT,bWdj2GDclj5ofokWjzoa5jAwMkxCykd6,4,2,0,0,0,0,2,0,4,0.5714285714285714,1,0.0,0,0,0,0,2,0,0,2,0,0,4,1
8966,154984,ek29LkWtDxA0v7lJYLGDshBZKC6XqZUG,A3fsA9Zfv1X2fVEQhTw51lKENdNrEqT3,7,3,2,0,2,0,2,0,9,1.2857142857142858,1,0.0,0,2,0,2,3,0,0,2,0,4,5,1
8967,154994,goiRqBTuj08U0GnNk0C4bEGsdFhlNKfO,SpATywNh6bZuzm8s1ceuBUnMUAeoAHHw,1,0,0,0,0,0,1,0,1,0.14285714285714285,1,0.0,0,0,0,0,0,0,0,1,0,0,1,1
8968,155004,jAL7XyDmeuhiQajqPFo22fTlsGcBQwVk,SpATywNh6bZuzm8s1ceuBUnMUAeoAHHw,14,18,8,15,0,0,9,0,50,7.142857142857143,2,0.0,3,8,14,0,15,0,1,9,0,25,25,0
8969,155015,j1APsmZGLFH2gSdJ48obb2yQGO5jtDpT,A3fsA9Zfv1X2fVEQhTw51lKENdNrEqT3,26,15,12,0,11,0,6,0,44,6.285714285714286,1,0.0,0,12,0,11,15,0,0,6,0,23,21,1
8970,155019,5T1VvKaGWS2hZ5BZhBGk8NjgRaaz6DhR,5X6FeZozNMgE2VRi3MJYjkkFK8SETtu2,5,6,1,0,0,0,2,0,9,1.2857142857142858,1,0.0,0,1,0,0,6,0,0,2,0,1,8,1
8971,155027,PexOV0LWT1fDCzyfhjsaD6ViAyGfZwtP,SpATywNh6bZuzm8s1ceuBUnMUAeoAHHw,15,17,0,12,0,0,5,1,35,5.0,1,0.0,2,0,11,0,15,0,1,5,1,13,22,1
8972,155032,QhTOy4xyyUtTSkonbjsd0Qe7t71cRAgW,5X6FeZozNMgE2VRi3MJYjkkFK8SETtu2,5,2,1,0,1,0,2,0,6,0.8571428571428571,1,0.0,0,1,0,1,2,0,0,2,0,2,4,1
8973,155076,m7LPs49nHZUcvz2esAX8UbdKFZVSnWet,A3fsA9Zfv1X2fVEQhTw51lKENdNrEqT3,8,4,2,0,2,0,4,0,12,1.7142857142857142,1,0.0,0,2,0,2,4,0,0,4,0,4,8,1
8974,155086,0a6XgcasA9uTwm3tHxuEmdygchIIdwyp,SpATywNh6bZuzm8s1ceuBUnMUAeoAHHw,11,8,1,17,0,0,2,0,28,4.0,1,0.0,2,1,14,0,6,0,3,2,0,17,11,1
8975,155089,VdNVtOVHu3uq36SFu7mu40diveL7bnVd,5X6FeZozNMgE2VRi3MJYjkkFK8SETtu2,2,0,0,0,0,3,1,0,4,0.5714285714285714,1,0.0,0,0,0,0,0,3,0,1,0,0,4,1
8976,155095,LVgGKe8GEjU3xNkkgcLCws2DFML8rckJ,A3fsA9Zfv1X2fVEQhTw51lKENdNrEqT3,2,0,0,0,0,0,2,0,2,0.2857142857142857,1,0.0,0,0,0,0,0,0,0,2,0,0,2,1
8977,155101,JbB7hpnQ5hVzqELznLtzJLRyOZ2rdnyH,A3fsA9Zfv1X2fVEQhTw51lKENdNrEqT3,3,2,1,0,0,0,1,0,4,0.5714285714285714,1,0.0,0,1,0,0,2,0,0,1,0,1,3,1
8978,155116,gFlxrmDkVSVGn1QoqvuvED5jcjjyxp3w,A3fsA9Zfv1X2fVEQhTw51lKENdNrEqT3,12,7,5,0,5,0,1,0,18,2.5714285714285716,1,0.0,1,5,0,5,6,0,0,1,0,11,7,1
8979,155137,v2qco953Z21cQ5MzJrZ1eVzwRDnupmBG,A3fsA9Zfv1X2fVEQhTw51lKENdNrEqT3,1,0,0,0,0,0,1,0,1,0.14285714285714285,1,0.0,0,0,0,0,0,0,0,1,0,0,1,1
8980,155141,PUySp8Qi7ahosRvBWR6xsbTAmeC3pRdT,SpATywNh6bZuzm8s1ceuBUnMUAeoAHHw,9,5,4,0,3,0,1,0,13,1.8571428571428572,1,0.0,0,4,0,3,5,0,0,1,0,7,6,0
8981,155145,wjhz373pmxMxtWLbVSRdPzWp2Q3TigoZ,SpATywNh6bZuzm8s1ceuBUnMUAeoAHHw,1,0,0,0,0,0,1,0,1,0.14285714285714285,1,0.0,0,0,0,0,0,0,0,1,0,0,1,1
8982,155171,nnZu4w9Qwc4nNKT0fLzc9WXoz4HdLggH,SpATywNh6bZuzm8s1ceuBUnMUAeoAHHw,3,0,0,0,0,0,3,0,3,0.42857142857142855,1,0.0,0,0,0,0,0,0,0,3,0,0,3,1
8983,155176,2h9OXmdAT6bB7n7KOPBoiXeNjQhlOCR5,SpATywNh6bZuzm8s1ceuBUnMUAeoAHHw,1,0,0,0,0,0,1,0,1,0.14285714285714285,1,0.0,0,0,0,0,0,0,0,1,0,0,1,1
8984,155178,DH7Hc1PL02MQVFEY0L3pJVvxe76LbPlH,SpATywNh6bZuzm8s1ceuBUnMUAeoAHHw,2,0,0,0,0,0,2,0,2,0.2857142857142857,1,0.0,0,0,0,0,0,0,0,2,0,0,2,1
8985,155185,11GhYVig00IPn7lSasEKzVfjBwtsXP8u,5X6FeZozNMgE2VRi3MJYjkkFK8SETtu2,2,0,0,0,0,0,2,0,2,0.2857142857142857,1,0.0,0,0,0,0,0,0,0,2,0,0,2,1
8986,155189,YNuPTGQy9mt9Y3HmbbpFFMvKSZhUusVu,bWdj2GDclj5ofokWjzoa5jAwMkxCykd6,1,0,0,0,0,0,1,0,1,0.14285714285714285,1,0.0,0,0,0,0,0,0,0,1,0,0,1,1
8987,155198,lmPRzPwyLk4LZriJ4YYlBQcJ6H90U7J3,SpATywNh6bZuzm8s1ceuBUnMUAeoAHHw,1,0,0,0,0,0,1,0,1,0.14285714285714285,1,0.0,0,0,0,0,0,0,0,1,0,0,1,1
8988,155262,B1DHRbN7OgYmrICROsReSgvpNCm4AE9D,A3fsA9Zfv1X2fVEQhTw51lKENdNrEqT3,1,0,0,0,0,0,1,0,1,0.14285714285714285,1,0.0,0,0,0,0,0,0,0,1,0,0,1,1
8989,155271,BQtG7mwMFIK7eTxl5OIdt4PhyPzprQ2h,SpATywNh6bZuzm8s1ceuBUnMUAeoAHHw,2,0,0,0,0,0,2,0,2,0.2857142857142857,1,0.0,0,0,0,0,0,0,0,2,0,0,2,1
8990,155288,0aNsJYUr3bQMcRtgUvbI1dETfhSFeYEi,5X6FeZozNMgE2VRi3MJYjkkFK8SETtu2,5,4,2,0,1,0,1,0,8,1.1428571428571428,1,0.0,0,2,0,1,4,0,0,1,0,3,5,1
8991,155301,PlXazMadzuvOEbxiBFMxdXqBjCYsxLnr,G8EPVSXsOYB5YQWZGiz1aVq5Pgr2GrQu,9,13,1,4,2,0,4,2,26,3.7142857142857144,1,0.0,8,1,4,2,5,0,0,4,2,15,11,1
8992,155304,Mc1x8qc2ag2ssiz0qfYSRk8wfa0Gy5Kt,RXDvfPUBYFlVdlueBFbLW0mhhAyGEqpt,2,0,0,0,0,0,2,0,2,0.2857142857142857,1,0.0,0,0,0,0,0,0,0,2,0,0,2,1
8993,155313,qCt5ANSKPqeu8yA2D88Oh4sjJN8qIxHb,SpATywNh6bZuzm8s1ceuBUnMUAeoAHHw,4,3,1,0,0,0,2,0,6,0.8571428571428571,1,0.0,0,1,0,0,3,0,0,2,0,1,5,1
8994,155317,2DvkJl9UVozMaO0xGaO2ndEJOUw63HiE,A3fsA9Zfv1X2fVEQhTw51lKENdNrEqT3,6,4,3,0,1,0,1,0,9,1.2857142857142858,1,0.0,0,3,0,1,4,0,0,1,0,4,5,1
8995,155332,4EUcos24EvmQADqilrZaeka59sr4Z1yr,G8EPVSXsOYB5YQWZGiz1aVq5Pgr2GrQu,1,0,0,0,0,0,1,0,1,0.14285714285714285,1,0.0,0,0,0,0,0,0,0,1,0,0,1,1
8996,155333,4EUcos24EvmQADqilrZaeka59sr4Z1yr,A3fsA9Zfv1X2fVEQhTw51lKENdNrEqT3,1,0,0,0,0,0,1,0,1,0.14285714285714285,1,0.0,0,0,0,0,0,0,0,1,0,0,1,1
8997,155339,HCAOiU8xAVMVIqXLxXu2zf6ngFo1SrS9,SpATywNh6bZuzm8s1ceuBUnMUAeoAHHw,13,10,1,24,0,0,2,0,37,5.285714285714286,1,0.0,4,1,21,0,6,0,3,2,0,26,11,1
8998,155340,kESUWYZhNdCYchDMD2BhJwQOrXwcqWDK,SpATywNh6bZuzm8s1ceuBUnMUAeoAHHw,5,4,2,0,1,0,2,0,9,1.2857142857142858,1,0.0,0,2,0,1,4,0,0,2,0,3,6,1
8999,155348,MTVSM1YvrsLrM15cX6nefZv7wPGqQR1y,bWdj2GDclj5ofokWjzoa5jAwMkxCykd6,1,0,0,0,0,0,1,0,1,0.14285714285714285,1,0.0,0,0,0,0,0,0,0,1,0,0,1,1
9000,155351,yQFJbwjipZPuCNg0BGBhkstFCLA1Phw4,RXDvfPUBYFlVdlueBFbLW0mhhAyGEqpt,1,0,0,0,0,0,1,0,1,0.14285714285714285,1,0.0,0,0,0,0,0,0,0,1,0,0,1,1
9001,155359,EZg27UOE3C8Imuu3swXTGejJA3xd7Feg,SpATywNh6bZuzm8s1ceuBUnMUAeoAHHw,7,3,2,0,2,0,4,0,11,1.5714285714285714,1,0.0,0,2,0,2,3,0,0,4,0,4,7,1
9002,155368,LSvU72CFq1TrHd9SCZOiKQ0qcV2oa2Ok,5X6FeZozNMgE2VRi3MJYjkkFK8SETtu2,14,32,9,16,5,0,6,0,68,9.714285714285714,3,0.0,13,9,14,5,19,0,2,6,0,41,27,1
9003,155372,Iet2Dgawpa0Ak4mecoEMAcFitulCRVfT,A3fsA9Zfv1X2fVEQhTw51lKENdNrEqT3,1,0,0,0,0,0,1,0,1,0.14285714285714285,1,0.0,0,0,0,0,0,0,0,1,0,0,1,1
9004,155374,0B7Lg7kBiHggKw9Wk7X0Ew4GVuXGGcvN,bWdj2GDclj5ofokWjzoa5jAwMkxCykd6,4,3,1,0,1,0,2,0,7,1.0,1,0.0,0,1,0,1,3,0,0,2,0,2,5,1
9005,155378,QZoi4xpkEVVH2rbYL53oYFfYungIuUup,A3fsA9Zfv1X2fVEQhTw51lKENdNrEqT3,28,19,13,0,10,3,9,1,55,7.857142857142857,3,0.0,2,13,0,10,17,3,0,9,1,25,30,1
9006,155388,p4jDcAmq3BCmPDrihi5iwS37tcic5dv0,SpATywNh6bZuzm8s1ceuBUnMUAeoAHHw,8,6,4,0,2,0,5,0,17,2.4285714285714284,1,0.0,0,4,0,2,6,0,0,5,0,6,11,1
9007,155394,CgAG6B49eGwrDT53ilR8A7Csv8j3BICz,SpATywNh6bZuzm8s1ceuBUnMUAeoAHHw,3,3,0,0,0,0,3,0,6,0.8571428571428571,1,0.0,0,0,0,0,3,0,0,3,0,0,6,1
9008,155404,qwhxcjW9iIMBAQoGSWDtst34AFkcFQoV,RXDvfPUBYFlVdlueBFbLW0mhhAyGEqpt,16,24,13,10,4,22,12,0,85,12.142857142857142,3,0.0,1,13,9,4,23,22,1,12,0,27,58,0
9009,155406,i4POwlixDERLlMr6WsVDkGXvvyY9RG7A,SpATywNh6bZuzm8s1ceuBUnMUAeoAHHw,33,60,3,45,2,8,5,0,123,17.571428571428573,4,0.0,21,3,43,2,39,8,2,5,0,69,54,0
9010,155581,2ZRBFnStzt5cjrck9eS6oYGoTRuicZMh,G8EPVSXsOYB5YQWZGiz1aVq5Pgr2GrQu,3,1,1,0,1,0,0,0,3,0.42857142857142855,1,0.0,0,1,0,1,1,0,0,0,0,2,1,1
9011,155616,k0sbAnWIfD9ltAd5PyrJMhpQMWff3kVq,SpATywNh6bZuzm8s1ceuBUnMUAeoAHHw,1,2,0,0,0,0,0,0,2,0.2857142857142857,1,0.0,0,0,0,0,2,0,0,0,0,0,2,1
9012,155672,wjS8ie6ACTxewSCQo7zpBy0tu4z4RYPD,5X6FeZozNMgE2VRi3MJYjkkFK8SETtu2,1,0,0,0,0,0,1,0,1,0.14285714285714285,1,0.0,0,0,0,0,0,0,0,1,0,0,1,1
9013,155760,JBAytsWAbTeV6GWhSZsHWNpJgF2JgbBV,5X6FeZozNMgE2VRi3MJYjkkFK8SETtu2,1,0,0,0,0,0,1,0,1,0.14285714285714285,1,0.0,0,0,0,0,0,0,0,1,0,0,1,1
9014,155904,mbBmZOvWFQnr2jr80Xest0JLKlAyyOuX,A3fsA9Zfv1X2fVEQhTw51lKENdNrEqT3,11,9,6,0,2,1,6,1,25,3.5714285714285716,1,0.0,0,6,0,2,9,1,0,6,1,8,17,1
9015,155965,i6hU5SR8XgkqdPxlmxtV7dYt9PZfaBTn,5X6FeZozNMgE2VRi3MJYjkkFK8SETtu2,8,7,3,0,2,0,2,0,14,2.0,1,0.0,0,3,0,2,7,0,0,2,0,5,9,1
9016,155994,xSvCHzbSKemMKYEdGEAC5YZv1OdVf9nN,A3fsA9Zfv1X2fVEQhTw51lKENdNrEqT3,1,0,0,0,0,0,2,0,2,0.2857142857142857,1,0.0,0,0,0,0,0,0,0,2,0,0,2,1
9017,156096,VPJtyjlRgoD1Uh96mtOqMndW9SwTakqy,bWdj2GDclj5ofokWjzoa5jAwMkxCykd6,10,11,2,4,0,2,5,1,25,3.5714285714285716,1,0.0,3,2,4,0,8,2,0,5,1,9,16,0
9018,156107,UTQI3stNnZIKednJcKCTrHPD5NsTO42m,5X6FeZozNMgE2VRi3MJYjkkFK8SETtu2,10,4,3,0,3,0,4,0,14,2.0,1,0.0,0,3,0,3,4,0,0,4,0,6,8,1
9019,156131,AxvvX1cOvgvh5SLc8LDUicNhxVuDl8Ea,5X6FeZozNMgE2VRi3MJYjkkFK8SETtu2,1,0,0,0,0,0,2,0,2,0.2857142857142857,2,0.0,0,0,0,0,0,0,0,2,0,0,2,1
9020,156179,sGlMvtHnoZ3VKCRj86vjviJ0RxBg0FOx,SpATywNh6bZuzm8s1ceuBUnMUAeoAHHw,16,17,0,18,0,0,2,0,37,5.285714285714286,1,0.0,3,0,16,0,14,0,2,2,0,19,18,0
9021,156309,u9zCfF0AEyeJ0Gy01Mk2XfY0UT4XckvE,5X6FeZozNMgE2VRi3MJYjkkFK8SETtu2,1,0,0,0,0,0,1,0,1,0.14285714285714285,1,0.0,0,0,0,0,0,0,0,1,0,0,1,1
9022,156339,4j0oreGLK5cXhR86icYUGacmhPp1TTs2,5X6FeZozNMgE2VRi3MJYjkkFK8SETtu2,1,0,0,0,0,0,1,0,1,0.14285714285714285,1,0.0,0,0,0,0,0,0,0,1,0,0,1,1
9023,156467,TqZSbKLYcFD5gfQ0wHk9V7SVlkqO9WOv,5X6FeZozNMgE2VRi3MJYjkkFK8SETtu2,6,0,0,0,0,0,10,1,11,1.5714285714285714,1,0.0,0,0,0,0,0,0,0,10,1,0,11,1
9024,156488,1MYBio9DblM2ma2YQCVmpn2rr8cupAiN,5X6FeZozNMgE2VRi3MJYjkkFK8SETtu2,1,0,0,0,0,0,2,0,2,0.2857142857142857,1,0.0,0,0,0,0,0,0,0,2,0,0,2,1
9025,156596,OLSxCkluLildKVrVnzRIsj47tt9tVHj9,5X6FeZozNMgE2VRi3MJYjkkFK8SETtu2,1,0,0,0,0,0,1,0,1,0.14285714285714285,1,0.0,0,0,0,0,0,0,0,1,0,0,1,1
9026,156629,mDHr8WvVVX9KSvXMqxtLvZ6vP4uuNF6E,5X6FeZozNMgE2VRi3MJYjkkFK8SETtu2,6,6,1,0,2,0,1,0,10,1.4285714285714286,2,0.0,1,1,0,2,5,0,0,1,0,4,6,1
9027,156848,3DOywPe0JHdRdmtWhQwYFlAgvwXRAQOv,3VkHkmOtom3jM2wCu94xgzzu1d6Dn7or,7,3,1,0,1,0,6,0,11,1.5714285714285714,1,0.0,1,1,0,1,2,0,0,6,0,3,8,1
9028,156850,oQBpblElSoO3Vqvvh9Xdd3HeDB6VZdai,3VkHkmOtom3jM2wCu94xgzzu1d6Dn7or,8,2,1,0,1,1,6,1,12,1.7142857142857142,1,0.0,0,1,0,1,2,1,0,6,1,2,10,1
9029,156858,1sESD9iEkXgTa0jiav7WBnyoYdcyYkDH,3VkHkmOtom3jM2wCu94xgzzu1d6Dn7or,6,4,1,0,1,1,2,0,9,1.2857142857142858,1,0.0,0,1,0,1,4,1,0,2,0,2,7,1
9030,156859,E4407AoESgmy6Z5RqocCNXptPIkGCKrE,3VkHkmOtom3jM2wCu94xgzzu1d6Dn7or,1,0,0,0,0,0,1,0,1,0.14285714285714285,1,0.0,0,0,0,0,0,0,0,1,0,0,1,1
9031,156879,jvG6RW3X6AqmQihQCB2pzHMKYR6AGED3,3VkHkmOtom3jM2wCu94xgzzu1d6Dn7or,23,84,25,29,15,18,10,0,181,25.857142857142858,3,0.0,25,25,27,15,59,18,2,10,0,92,89,0
9032,156899,0bzZbZHkLNuxUgyCO7kphg8pZrwxOXX5,3VkHkmOtom3jM2wCu94xgzzu1d6Dn7or,7,2,2,0,2,2,4,1,13,1.8571428571428572,1,0.0,0,2,0,2,2,2,0,4,1,4,9,1
9033,156906,ecyMKEwCol1CsOTtEjA0TmA0ug5yhLgo,3VkHkmOtom3jM2wCu94xgzzu1d6Dn7or,8,19,5,0,6,0,2,0,32,4.571428571428571,1,0.0,11,5,0,6,8,0,0,2,0,22,10,1
9034,156918,6kObL26hEJOoKwl5cvMnefprVRNzNLL1,3VkHkmOtom3jM2wCu94xgzzu1d6Dn7or,6,1,1,0,1,0,3,0,6,0.8571428571428571,1,0.0,0,1,0,1,1,0,0,3,0,2,4,1
9035,156936,6l5rNdJjVuOCdIyZv4RcOHzbywv2VcJk,3VkHkmOtom3jM2wCu94xgzzu1d6Dn7or,5,2,1,0,1,0,4,0,8,1.1428571428571428,2,0.0,0,1,0,1,2,0,0,4,0,2,6,1
9036,156947,CIR8CBPpjAuojVkyBWHWMOBRWnHtRU0H,3VkHkmOtom3jM2wCu94xgzzu1d6Dn7or,2,0,0,0,0,0,2,0,2,0.2857142857142857,1,0.0,0,0,0,0,0,0,0,2,0,0,2,1
9037,156976,8MJZPDEqC0FEpOK9sDbC1L41oI4iMwLw,3VkHkmOtom3jM2wCu94xgzzu1d6Dn7or,1,0,0,0,0,0,1,0,1,0.14285714285714285,1,0.0,0,0,0,0,0,0,0,1,0,0,1,1
9038,156989,45yfbnarXLY6Jtgynu1Xeg2zt9QQstcT,3VkHkmOtom3jM2wCu94xgzzu1d6Dn7or,1,0,0,0,0,0,1,0,1,0.14285714285714285,1,0.0,0,0,0,0,0,0,0,1,0,0,1,1
9039,156998,xSPI4pqueci7OIkuI9BEhClCsXyXQY9x,3VkHkmOtom3jM2wCu94xgzzu1d6Dn7or,3,0,0,0,0,0,3,0,3,0.42857142857142855,1,0.0,0,0,0,0,0,0,0,3,0,0,3,1
9040,157004,GCmVg4GQ7sTGsEQ8hxY6xROLCOMlMxWn,3VkHkmOtom3jM2wCu94xgzzu1d6Dn7or,11,13,6,0,4,0,3,0,26,3.7142857142857144,2,0.0,0,6,0,4,13,0,0,3,0,10,16,1
9041,157018,2tcuR2KxaK8WRZGfM6udlEdiV4BPFQkF,3VkHkmOtom3jM2wCu94xgzzu1d6Dn7or,4,2,1,0,0,0,2,1,6,0.8571428571428571,1,0.0,0,1,0,0,2,0,0,2,1,1,5,1
9042,157030,YAxKO80zPAjKGAsN0aDL5bYrUlrGkHcw,3VkHkmOtom3jM2wCu94xgzzu1d6Dn7or,1,0,0,0,0,0,2,0,2,0.2857142857142857,1,0.0,0,0,0,0,0,0,0,2,0,0,2,1
9043,157043,UgTMaOmXzZisJLVjoZZhQnLG7nLc3m9R,3VkHkmOtom3jM2wCu94xgzzu1d6Dn7or,5,1,1,0,1,0,2,0,5,0.7142857142857143,1,0.0,0,1,0,1,1,0,0,2,0,2,3,1
9044,157046,2Ueq99WOxFkvLjKvdAbi1TRY9isnfhGR,3VkHkmOtom3jM2wCu94xgzzu1d6Dn7or,1,0,0,0,0,0,1,0,1,0.14285714285714285,1,0.0,0,0,0,0,0,0,0,1,0,0,1,1
9045,157049,TUNzhMk7KYKLZ5t96SpbfpiSfMKW1lgg,3VkHkmOtom3jM2wCu94xgzzu1d6Dn7or,7,4,1,0,1,0,4,0,10,1.4285714285714286,2,0.0,0,1,0,1,4,0,0,4,0,2,8,0
9046,157088,unIZPWGEs4SMmqxgQqmO7WzQDtIXBNkL,3VkHkmOtom3jM2wCu94xgzzu1d6Dn7or,6,6,3,0,2,0,3,0,14,2.0,2,0.0,0,3,0,2,6,0,0,3,0,5,9,0
9047,157102,DPluFJfFEDLWsyQ8WcWPeyz0ccI0HVP0,3VkHkmOtom3jM2wCu94xgzzu1d6Dn7or,1,0,0,0,0,0,1,0,1,0.14285714285714285,1,0.0,0,0,0,0,0,0,0,1,0,0,1,1
9048,157126,Vn7oh8Zmlq5Mb29RmziqYla5AQoDWGby,3VkHkmOtom3jM2wCu94xgzzu1d6Dn7or,1,0,0,0,0,0,1,0,1,0.14285714285714285,1,0.0,0,0,0,0,0,0,0,1,0,0,1,1
9049,157128,AzzlZTan85NtpWN7Tw6er163M4eAWMcs,3VkHkmOtom3jM2wCu94xgzzu1d6Dn7or,1,0,0,0,0,0,4,0,4,0.5714285714285714,2,0.0,0,0,0,0,0,0,0,4,0,0,4,1
9050,157134,HEH8dbj1GoIbvkDQ9wJJ8yflgce0drSA,3VkHkmOtom3jM2wCu94xgzzu1d6Dn7or,1,0,0,0,0,0,1,0,1,0.14285714285714285,1,0.0,0,0,0,0,0,0,0,1,0,0,1,1
9051,157140,IE2fQ2gvms7KbELbWuciIFHxKaviUlJy,3VkHkmOtom3jM2wCu94xgzzu1d6Dn7or,6,2,1,0,1,0,3,1,8,1.1428571428571428,1,0.0,0,1,0,1,2,0,0,3,1,2,6,1
9052,157148,9yxgaT1T5BgEz11zZsh86J9ewAfn0TIj,3VkHkmOtom3jM2wCu94xgzzu1d6Dn7or,6,3,1,0,2,0,6,0,12,1.7142857142857142,1,0.0,2,1,0,2,1,0,0,6,0,5,7,1
9053,157149,cU8GrdhaRhAqB82AuZWKIL5LDmG7psnJ,3VkHkmOtom3jM2wCu94xgzzu1d6Dn7or,2,0,0,0,0,10,1,0,11,1.5714285714285714,1,0.0,0,0,0,0,0,10,0,1,0,0,11,1
9054,157163,8phz9AYz0BvRx5nlymKhm4uf6SL2rKlM,3VkHkmOtom3jM2wCu94xgzzu1d6Dn7or,1,0,0,0,0,0,1,0,1,0.14285714285714285,1,0.0,0,0,0,0,0,0,0,1,0,0,1,1
9055,157216,Bjd7KT9uiITTUGwvPeEVfIbMoFjGLRXD,5X6FeZozNMgE2VRi3MJYjkkFK8SETtu2,18,20,3,26,8,2,3,1,63,9.0,1,0.0,17,3,20,8,3,2,6,3,1,48,15,1
9056,157226,h6N9SyV6dQj6If7QxGp31IQ94XXyWUIO,5X6FeZozNMgE2VRi3MJYjkkFK8SETtu2,5,2,0,0,0,0,4,0,6,0.8571428571428571,1,0.0,0,0,0,0,2,0,0,4,0,0,6,1
9057,157244,hrE2wqQITNDujGOu31qZ9nVLSRudlDFi,7GRhBDsirIGkRZBtSMEzNTyDr2JQm4xx,29,48,9,8,58,9,2,0,134,19.142857142857142,1,0.0,18,9,6,58,30,9,2,2,0,91,43,0
9058,157354,5ehf4EFN8WhDbvmb2WvfZwpaBD0cj1oj,5X6FeZozNMgE2VRi3MJYjkkFK8SETtu2,6,3,1,0,1,0,2,0,7,1.0,1,0.0,0,1,0,1,3,0,0,2,0,2,5,1
9059,157422,9FaPBbsYKn0C9myyRYf9vYNhns2eJDpD,5X6FeZozNMgE2VRi3MJYjkkFK8SETtu2,3,3,1,0,0,0,2,0,6,0.8571428571428571,1,0.0,0,1,0,0,3,0,0,2,0,1,5,1
9060,157423,DBiaK9DSvH9MwTDzoUhyasBgiPY2wQB4,5X6FeZozNMgE2VRi3MJYjkkFK8SETtu2,1,0,0,0,0,0,1,0,1,0.14285714285714285,1,0.0,0,0,0,0,0,0,0,1,0,0,1,1
9061,157434,IZiNyXwRBQbk0M6blWUnLJQIqlWZxamb,5X6FeZozNMgE2VRi3MJYjkkFK8SETtu2,14,12,8,0,6,0,1,0,27,3.857142857142857,1,0.0,0,8,0,6,12,0,0,1,0,14,13,1
9062,157441,cOx2ivO0cjd2S3OxGikx2UdSMlRcgy0Q,5X6FeZozNMgE2VRi3MJYjkkFK8SETtu2,1,0,0,0,0,0,1,0,1,0.14285714285714285,1,0.0,0,0,0,0,0,0,0,1,0,0,1,1
9063,157463,v5ZclElew7ejFho1P7oX3s4a7TxNLCyF,5X6FeZozNMgE2VRi3MJYjkkFK8SETtu2,1,0,0,0,0,0,1,0,1,0.14285714285714285,1,0.0,0,0,0,0,0,0,0,1,0,0,1,1
9064,157547,knSbNmB3B4D7WDjxqoR5ogJCHbYuCvFK,5X6FeZozNMgE2VRi3MJYjkkFK8SETtu2,1,0,0,0,0,0,2,0,2,0.2857142857142857,1,0.0,0,0,0,0,0,0,0,2,0,0,2,1
9065,157561,HD18aUeI83TGpCqkfevoF6pzoLyLfF7f,5X6FeZozNMgE2VRi3MJYjkkFK8SETtu2,8,5,4,0,4,0,1,0,14,2.0,2,0.0,0,4,0,4,5,0,0,1,0,8,6,1
9066,157567,ECbTw58nDutHihiUsnPXkHt9qTO2jtWr,5X6FeZozNMgE2VRi3MJYjkkFK8SETtu2,1,0,0,0,0,0,1,0,1,0.14285714285714285,1,0.0,0,0,0,0,0,0,0,1,0,0,1,1
9067,157614,LpKc0q3vwtZx2tbV2GItCPMY7oFOnDvF,5X6FeZozNMgE2VRi3MJYjkkFK8SETtu2,10,17,7,0,0,8,2,0,34,4.857142857142857,1,0.0,9,7,0,0,8,8,0,2,0,16,18,1
9068,157632,BHVI7hOZl1DwvVUvB9py5Yfc5VOm18uV,5Gyp41oLVo7Gg7vF4vpmggWP5MU70QO6,12,8,4,3,3,1,4,2,25,3.5714285714285716,3,0.0,2,4,2,3,6,1,1,4,2,11,14,1
9069,157635,b9K9pq41f7QaJ15GpQHgFYfB4YcHSKuj,5Gyp41oLVo7Gg7vF4vpmggWP5MU70QO6,12,11,6,7,3,2,5,1,35,5.0,2,0.0,3,6,5,3,8,2,2,5,1,17,18,1
9070,157642,e4mytzLJHmGiSnWVJseSD624dEoLq3Sh,5Gyp41oLVo7Gg7vF4vpmggWP5MU70QO6,7,6,0,0,3,0,2,0,11,1.5714285714285714,3,0.0,0,0,0,3,6,0,0,2,0,3,8,1
9071,157649,8YR0tcT3D8d0JlIytw4LxKfYYQekJyvj,5Gyp41oLVo7Gg7vF4vpmggWP5MU70QO6,6,4,2,0,2,0,1,0,9,1.2857142857142858,1,0.0,0,2,0,2,4,0,0,1,0,4,5,1
9072,157664,zXaIFCKxfdY9z9fVBcdJ9CKQhYz4fcsP,5Gyp41oLVo7Gg7vF4vpmggWP5MU70QO6,13,14,6,7,1,17,10,0,55,7.857142857142857,1,0.0,5,6,4,1,9,17,3,10,0,16,39,1
9073,157677,J9op6VmaAPI3mRg3zaq4XvDsesER8r08,5Gyp41oLVo7Gg7vF4vpmggWP5MU70QO6,3,0,0,0,0,0,3,0,3,0.42857142857142855,1,0.0,0,0,0,0,0,0,0,3,0,0,3,1
9074,157680,mEHAVnTSPxrqijaXglU7YL6yhhw9zDNh,5Gyp41oLVo7Gg7vF4vpmggWP5MU70QO6,3,2,1,0,0,0,1,0,4,0.5714285714285714,1,0.0,0,1,0,0,2,0,0,1,0,1,3,1
9075,157684,bupF78TICGiaq6b1Vsb3JvHLuPgK0vHR,5Gyp41oLVo7Gg7vF4vpmggWP5MU70QO6,5,2,1,0,1,6,4,0,14,2.0,1,0.0,0,1,0,1,2,6,0,4,0,2,12,1
9076,157687,ggEy8RvbTCh4JSUdb7xJ6pw5CVRursGj,5Gyp41oLVo7Gg7vF4vpmggWP5MU70QO6,11,11,6,0,4,13,15,1,50,7.142857142857143,3,0.0,0,6,0,4,11,13,0,15,1,10,40,1
9077,157689,kYy5EHsDUpLzMmIwn2uBsPfas2cjBUTm,5Gyp41oLVo7Gg7vF4vpmggWP5MU70QO6,7,4,3,2,1,0,2,0,12,1.7142857142857142,1,0.0,0,3,2,1,4,0,0,2,0,6,6,1
9078,157704,FmxYCqadwk8A3bSxqqiVTuWZIX7DqlxE,5Gyp41oLVo7Gg7vF4vpmggWP5MU70QO6,6,8,0,0,0,0,1,0,9,1.2857142857142858,1,0.0,0,0,0,0,8,0,0,1,0,0,9,1
9079,157705,ov3rFO0SWh2vtYBGPTxN35QJKYJzF6Rm,5Gyp41oLVo7Gg7vF4vpmggWP5MU70QO6,8,4,3,0,2,0,2,0,11,1.5714285714285714,1,0.0,0,3,0,2,4,0,0,2,0,5,6,1
9080,157708,4Nbx3b827QgbSwlChql19z0Neh3M3aRD,5Gyp41oLVo7Gg7vF4vpmggWP5MU70QO6,14,17,9,0,4,1,15,1,47,6.714285714285714,4,0.0,1,9,0,4,16,1,0,15,1,14,33,1
9081,157716,DelEAapcZRepqLkOzx1OfRUs9n7ZC2tB,5Gyp41oLVo7Gg7vF4vpmggWP5MU70QO6,5,7,4,0,0,0,2,0,13,1.8571428571428572,2,0.0,0,4,0,0,7,0,0,2,0,4,9,1
9082,157721,kAv65kdRhACG1cGYJPQ3UUN1jnjQbw30,5Gyp41oLVo7Gg7vF4vpmggWP5MU70QO6,6,3,2,0,2,0,1,0,8,1.1428571428571428,1,0.0,0,2,0,2,3,0,0,1,0,4,4,1
9083,157725,TuJrZ9qQp5b2qpTGGmQsmYcn7kQGqQe7,5Gyp41oLVo7Gg7vF4vpmggWP5MU70QO6,12,7,4,0,2,4,13,1,31,4.428571428571429,1,0.0,1,4,0,2,6,4,0,13,1,7,24,1
9084,157733,YC4hsBd06ZXn7dhTBoDlcdcvMFwoDU9J,5Gyp41oLVo7Gg7vF4vpmggWP5MU70QO6,1,0,0,0,0,0,1,0,1,0.14285714285714285,1,0.0,0,0,0,0,0,0,0,1,0,0,1,1
9085,157744,tbHK6wGgpSOKq5xS4Q6iKGoMVFXVb1up,5Gyp41oLVo7Gg7vF4vpmggWP5MU70QO6,5,2,1,0,1,1,4,1,10,1.4285714285714286,1,0.0,0,1,0,1,2,1,0,4,1,2,8,1
9086,157748,okVg9Xp1vC7Go36hSISNctuRi91rDjBa,5Gyp41oLVo7Gg7vF4vpmggWP5MU70QO6,1,0,0,0,0,0,1,0,1,0.14285714285714285,1,0.0,0,0,0,0,0,0,0,1,0,0,1,1
9087,157766,4VatEksX4g9JbVdH7nK8z1dcoLKQFuf1,5Gyp41oLVo7Gg7vF4vpmggWP5MU70QO6,7,3,2,0,2,0,3,0,10,1.4285714285714286,2,0.0,0,2,0,2,3,0,0,3,0,4,6,1
9088,157774,J59qmd35qLZG6cBcMkq86dcL05FYYlzn,5Gyp41oLVo7Gg7vF4vpmggWP5MU70QO6,6,4,2,0,1,0,4,0,11,1.5714285714285714,1,0.0,0,2,0,1,4,0,0,4,0,3,8,1
9089,157797,AimhZ5CMd3cWY2DlhFQJu8yaAkNoh3Dt,5Gyp41oLVo7Gg7vF4vpmggWP5MU70QO6,5,2,1,0,1,0,2,0,6,0.8571428571428571,1,0.0,0,1,0,1,2,0,0,2,0,2,4,1
9090,157809,sKM09JboTzop9XVHOkRwt7eh2M7KwmLM,5Gyp41oLVo7Gg7vF4vpmggWP5MU70QO6,1,0,0,0,0,0,1,0,1,0.14285714285714285,1,0.0,0,0,0,0,0,0,0,1,0,0,1,1
9091,157813,iahpkAlCoeyIcu10FEddjQTJ1RfU7hmc,5Gyp41oLVo7Gg7vF4vpmggWP5MU70QO6,1,0,0,0,0,0,1,0,1,0.14285714285714285,1,0.0,0,0,0,0,0,0,0,1,0,0,1,1
9092,157823,d1PB4qSSQBrllOXpAbPL3ermVaLJMq8w,5Gyp41oLVo7Gg7vF4vpmggWP5MU70QO6,11,20,13,5,4,0,7,1,50,7.142857142857143,2,0.0,1,13,3,4,19,0,2,7,1,21,29,1
9093,157825,tWBara106Yb76ojRSsVDGXcZTx6mFZQp,5Gyp41oLVo7Gg7vF4vpmggWP5MU70QO6,15,26,14,0,4,3,12,1,60,8.571428571428571,4,0.0,6,14,0,4,20,3,0,12,1,24,36,1
9094,157834,Oiijrt01HwezoanXSGLPQDRMfxgyzCrB,5Gyp41oLVo7Gg7vF4vpmggWP5MU70QO6,13,16,9,2,6,0,5,0,38,5.428571428571429,3,0.0,4,9,1,6,12,0,1,5,0,20,18,1
9095,157844,fP3JH1rakMmApdJ9kHO0r7cUhQDWLHT9,5Gyp41oLVo7Gg7vF4vpmggWP5MU70QO6,5,2,1,0,1,0,4,0,8,1.1428571428571428,1,0.0,0,1,0,1,2,0,0,4,0,2,6,1
9096,157848,apsgaZdkBse4QA8p5DlU0N1hwDlYFwlq,5Gyp41oLVo7Gg7vF4vpmggWP5MU70QO6,4,2,1,0,1,0,1,0,5,0.7142857142857143,1,0.0,0,1,0,1,2,0,0,1,0,2,3,1
9097,157879,hZtYMC0K38gXqBKrTDOxWf2kSwG06wA4,5Gyp41oLVo7Gg7vF4vpmggWP5MU70QO6,1,0,0,0,0,0,1,0,1,0.14285714285714285,1,0.0,0,0,0,0,0,0,0,1,0,0,1,1
9098,157880,O6XTfrmBXPHHKFN07CLCPWqyMP9NsQuf,5Gyp41oLVo7Gg7vF4vpmggWP5MU70QO6,7,4,2,0,1,0,4,0,11,1.5714285714285714,2,0.0,0,2,0,1,4,0,0,4,0,3,8,1
9099,157881,cQingcIr6b1ihV5kJhN5qPmtxp0KcxRT,5Gyp41oLVo7Gg7vF4vpmggWP5MU70QO6,4,2,1,0,1,0,1,0,5,0.7142857142857143,1,0.0,0,1,0,1,2,0,0,1,0,2,3,1
9100,157908,uAys1rabaSRG9ZlJG9TTFZxVEMEfDyRx,5Gyp41oLVo7Gg7vF4vpmggWP5MU70QO6,11,9,4,5,2,10,4,1,35,5.0,2,0.0,3,4,3,2,6,10,2,4,1,12,23,1
9101,157914,KEOiu4CQ5ywd8Pj18j9arhzSkJFxftlo,5Gyp41oLVo7Gg7vF4vpmggWP5MU70QO6,10,10,4,0,3,0,4,0,21,3.0,1,0.0,0,4,0,3,10,0,0,4,0,7,14,1
9102,157919,16nqpcDiyA6t4Yxn8gwQJ18qqQObgDiE,5Gyp41oLVo7Gg7vF4vpmggWP5MU70QO6,13,32,11,5,9,4,9,1,71,10.142857142857142,3,0.0,15,11,3,9,17,4,2,9,1,38,33,1
9103,157929,4Y77BzghNGgdSw2ZmEg0ICv6ndSkqSaa,5Gyp41oLVo7Gg7vF4vpmggWP5MU70QO6,1,0,0,0,0,0,2,0,2,0.2857142857142857,2,0.0,0,0,0,0,0,0,0,2,0,0,2,1
9104,157931,9w6D7jmIL0dPlWxoQU6UeaATKkwWl1pB,5Gyp41oLVo7Gg7vF4vpmggWP5MU70QO6,4,2,1,0,1,0,1,0,5,0.7142857142857143,1,0.0,0,1,0,1,2,0,0,1,0,2,3,1
9105,157941,afQkAxUvdLu532EqkP2BO2E822Re7HYk,5Gyp41oLVo7Gg7vF4vpmggWP5MU70QO6,10,12,8,0,2,0,6,0,28,4.0,3,0.0,0,8,0,2,12,0,0,6,0,10,18,1
9106,157949,TPDzBQ9rpNjeqli3KFaktTuUnc3ZEdFK,5Gyp41oLVo7Gg7vF4vpmggWP5MU70QO6,5,5,0,0,2,11,2,0,20,2.857142857142857,2,0.0,0,0,0,2,5,11,0,2,0,2,18,1
9107,157955,nRqoHIzNlBQT35aDwOmcapQeGMx0uV89,5Gyp41oLVo7Gg7vF4vpmggWP5MU70QO6,19,19,5,20,4,0,4,0,52,7.428571428571429,1,0.0,6,5,16,4,13,0,4,4,0,31,21,1
9108,157964,fhAX1Pecxh11KxhbFWCogtFJtJo6WZ97,5Gyp41oLVo7Gg7vF4vpmggWP5MU70QO6,3,0,0,0,0,0,5,0,5,0.7142857142857143,1,0.0,0,0,0,0,0,0,0,5,0,0,5,1
9109,157977,8HJiZoOTUArj8ouKObToEc9cbZd1p0Hh,5Gyp41oLVo7Gg7vF4vpmggWP5MU70QO6,13,22,7,6,8,0,6,0,49,7.0,3,0.0,10,7,5,8,12,0,1,6,0,30,19,1
9110,157983,gEZmhmelZ5ZF9BWTd9v2drvTc7xbVgWw,5Gyp41oLVo7Gg7vF4vpmggWP5MU70QO6,8,7,3,3,2,0,2,0,17,2.4285714285714284,1,0.0,3,3,2,2,4,0,1,2,0,10,7,1
9111,157984,7b6JC6PB4wrSLqIqGZaL6Y3UW5eVh0fp,5Gyp41oLVo7Gg7vF4vpmggWP5MU70QO6,18,38,19,7,6,27,8,0,105,15.0,3,0.0,9,19,4,6,29,27,3,8,0,38,67,1
9112,157986,Fagg3gyXrN4D8JqYlwX5flyuRv3gjkDW,5Gyp41oLVo7Gg7vF4vpmggWP5MU70QO6,5,5,3,0,2,0,3,0,13,1.8571428571428572,2,0.0,0,3,0,2,5,0,0,3,0,5,8,1
9113,157994,aJGGfOGJukSWlKFU5E1xCsbgsuwcp8Ll,5Gyp41oLVo7Gg7vF4vpmggWP5MU70QO6,7,6,3,0,2,0,2,0,13,1.8571428571428572,2,0.0,0,3,0,2,6,0,0,2,0,5,8,1
9114,158000,a1svP3KabnWtKyguhrrFt1OpGsti3I8K,5Gyp41oLVo7Gg7vF4vpmggWP5MU70QO6,13,14,9,0,6,0,8,0,37,5.285714285714286,2,0.0,2,9,0,6,12,0,0,8,0,17,20,1
9115,158011,iF0kA8I0vlcx5ATIU1VJWq0mDEgJRsUa,5Gyp41oLVo7Gg7vF4vpmggWP5MU70QO6,14,9,7,0,4,0,2,0,22,3.142857142857143,1,0.0,1,7,0,4,8,0,0,2,0,12,10,1
9116,158025,POGRFFRZzlPiBHiCHXnlCDCb459JTEzc,5Gyp41oLVo7Gg7vF4vpmggWP5MU70QO6,16,39,20,23,11,0,3,0,96,13.714285714285714,2,0.0,14,20,18,11,25,0,5,3,0,63,33,0
9117,158041,tMPZYG0DCvDSDEuO4KsQAdk0iwwmXKYt,5Gyp41oLVo7Gg7vF4vpmggWP5MU70QO6,8,5,4,0,1,1,8,2,21,3.0,2,0.0,0,4,0,1,5,1,0,8,2,5,16,1
9118,158043,RZPRe4XeIuwxw9CRRpKNRhZim4M7Y9vn,5Gyp41oLVo7Gg7vF4vpmggWP5MU70QO6,1,0,0,0,0,0,1,0,1,0.14285714285714285,1,0.0,0,0,0,0,0,0,0,1,0,0,1,1
9119,158047,E98B6VnsSgdhlvIT1b5qEE2jpZCrqTUr,5Gyp41oLVo7Gg7vF4vpmggWP5MU70QO6,7,3,2,0,2,0,2,0,9,1.2857142857142858,1,0.0,0,2,0,2,3,0,0,2,0,4,5,0
9120,158061,kCtKqphdIaaMaYiK2fd3FEPmUrXltDWR,5Gyp41oLVo7Gg7vF4vpmggWP5MU70QO6,7,1,1,0,1,7,5,1,16,2.2857142857142856,1,0.0,0,1,0,1,1,7,0,5,1,2,14,1
9121,158078,bLpYLG8DNCzVH3Ke9fLYhx9K744IifF0,5Gyp41oLVo7Gg7vF4vpmggWP5MU70QO6,4,2,1,0,1,0,1,0,5,0.7142857142857143,1,0.0,0,1,0,1,2,0,0,1,0,2,3,1
9122,158100,4avQmOrJuAzF46A93q5wyJBzd0GjayGm,5Gyp41oLVo7Gg7vF4vpmggWP5MU70QO6,5,1,1,0,1,0,2,0,5,0.7142857142857143,1,0.0,0,1,0,1,1,0,0,2,0,2,3,1
9123,158135,kCgmIS6JJhPuUOfuXsMwr39cI30MSyLb,5Gyp41oLVo7Gg7vF4vpmggWP5MU70QO6,13,18,8,2,4,0,3,0,35,5.0,2,0.0,4,8,1,4,14,0,1,3,0,17,18,1
9124,158153,esIpnxD65xUDDSaabDUGo5kswqkVqxR9,5Gyp41oLVo7Gg7vF4vpmggWP5MU70QO6,6,5,2,0,1,0,2,0,10,1.4285714285714286,2,0.0,0,2,0,1,5,0,0,2,0,3,7,1
9125,158164,uNWPqSX4UadZDpxwxprdlCLM0lIsWAjR,5Gyp41oLVo7Gg7vF4vpmggWP5MU70QO6,8,7,2,0,2,0,8,0,19,2.7142857142857144,2,0.0,0,2,0,2,7,0,0,8,0,4,15,1
9126,158172,Jv08t8fpcawyaZCw9f0bMJgjS8SuUKfb,5Gyp41oLVo7Gg7vF4vpmggWP5MU70QO6,1,0,0,0,0,0,1,0,1,0.14285714285714285,1,0.0,0,0,0,0,0,0,0,1,0,0,1,1
9127,158173,3cllbPYEJp74HYn7HHNMKMzXQxN8axkY,5Gyp41oLVo7Gg7vF4vpmggWP5MU70QO6,8,12,3,0,5,0,2,0,22,3.142857142857143,2,0.0,6,3,0,5,6,0,0,2,0,14,8,1
9128,158175,mvWG8WfFoikkAB9Wg1mtbCZJVje4NMeg,5Gyp41oLVo7Gg7vF4vpmggWP5MU70QO6,1,0,0,0,0,0,1,0,1,0.14285714285714285,1,0.0,0,0,0,0,0,0,0,1,0,0,1,0
9129,158182,IendqOMjPHM6PkjZNjaNDvRL7G48SMcS,5Gyp41oLVo7Gg7vF4vpmggWP5MU70QO6,18,22,11,7,5,2,8,2,57,8.142857142857142,1,0.0,7,11,6,5,15,2,1,8,2,29,28,1
9130,158183,vgPKjVSOWfFrIw9s3qyaLhpjQw13QENQ,5Gyp41oLVo7Gg7vF4vpmggWP5MU70QO6,11,15,7,4,4,0,2,0,32,4.571428571428571,2,0.0,4,7,2,4,11,0,2,2,0,17,15,1
9131,158188,xiHLAVx1lOeJhtdb9rNdxGApg3TIwPUZ,5Gyp41oLVo7Gg7vF4vpmggWP5MU70QO6,5,5,3,0,2,0,2,0,12,1.7142857142857142,2,0.0,0,3,0,2,5,0,0,2,0,5,7,1
9132,158189,jWibrywbdVGwrhQqgWdfjz3eC0hZq3Hp,5Gyp41oLVo7Gg7vF4vpmggWP5MU70QO6,5,2,1,0,1,0,2,0,6,0.8571428571428571,1,0.0,0,1,0,1,2,0,0,2,0,2,4,1
9133,158204,e5StAiQU2dGDqXL2MV912xoW6lsblG4i,5Gyp41oLVo7Gg7vF4vpmggWP5MU70QO6,14,15,8,1,4,12,7,3,50,7.142857142857143,2,0.0,4,8,1,4,11,12,0,7,3,17,33,1
9134,158206,YxV1DfMhtzoTbuIPgqeQiq3VUSpK0BqG,5Gyp41oLVo7Gg7vF4vpmggWP5MU70QO6,1,0,0,0,0,0,1,0,1,0.14285714285714285,1,0.0,0,0,0,0,0,0,0,1,0,0,1,1
9135,158209,Y9YzwTET1OUYhHsLt97DLY5Tl5O9atqy,5Gyp41oLVo7Gg7vF4vpmggWP5MU70QO6,8,7,3,0,2,0,3,0,15,2.142857142857143,3,0.0,1,3,0,2,6,0,0,3,0,6,9,1
9136,158214,R2fgEp6ZGIiEqrX6MpszWpZdnD6L8t0H,5Gyp41oLVo7Gg7vF4vpmggWP5MU70QO6,8,9,5,0,2,0,4,0,20,2.857142857142857,2,0.0,1,5,0,2,8,0,0,4,0,8,12,1
9137,158219,meMtAHW3ZOkonYX5TnwkdJmYGSglaFar,5Gyp41oLVo7Gg7vF4vpmggWP5MU70QO6,21,41,18,7,14,9,7,0,96,13.714285714285714,3,0.0,18,18,5,14,23,9,2,7,0,55,41,1
9138,158225,rT3zpA0g6rjJ1jZXfn6mCIcHmMcmU756,5Gyp41oLVo7Gg7vF4vpmggWP5MU70QO6,1,0,0,0,0,0,1,0,1,0.14285714285714285,1,0.0,0,0,0,0,0,0,0,1,0,0,1,1
9139,158245,FduuspqSLcDtrdIO2h0zRGA11CETecNX,5Gyp41oLVo7Gg7vF4vpmggWP5MU70QO6,1,0,0,0,0,0,1,0,1,0.14285714285714285,1,0.0,0,0,0,0,0,0,0,1,0,0,1,1
9140,158258,tBAHp8zjHfnlAwUDiyYlyw5unRg5QNVk,5Gyp41oLVo7Gg7vF4vpmggWP5MU70QO6,1,0,0,0,0,0,3,0,3,0.42857142857142855,1,0.0,0,0,0,0,0,0,0,3,0,0,3,1
9141,158260,h8BXRBzyL3fC2J31O1ozQ0OSoOmsk0kY,5Gyp41oLVo7Gg7vF4vpmggWP5MU70QO6,1,0,0,0,0,0,1,0,1,0.14285714285714285,1,0.0,0,0,0,0,0,0,0,1,0,0,1,1
9142,158265,bKTHB44I9NA1AlCs4T2fPG1UUI9vB5QD,5Gyp41oLVo7Gg7vF4vpmggWP5MU70QO6,14,23,12,8,7,1,2,0,53,7.571428571428571,1,0.0,9,12,7,7,14,1,1,2,0,35,18,1
9143,158269,MT0QR6jpBlQbjVhcPxF0XxHi7Yc3Nyuf,5Gyp41oLVo7Gg7vF4vpmggWP5MU70QO6,1,0,0,0,0,0,1,0,1,0.14285714285714285,1,0.0,0,0,0,0,0,0,0,1,0,0,1,1
9144,158271,TKFKCVKwvrOanp4kCnDFaQK6BpP2dGlY,5Gyp41oLVo7Gg7vF4vpmggWP5MU70QO6,14,13,7,10,3,24,4,1,62,8.857142857142858,1,0.0,3,7,7,3,10,24,3,4,1,20,42,1
9145,158278,bPrEBQILvyBjp3odJGGZ7KxlAV5Gu9sz,5Gyp41oLVo7Gg7vF4vpmggWP5MU70QO6,1,0,0,0,0,0,1,0,1,0.14285714285714285,1,0.0,0,0,0,0,0,0,0,1,0,0,1,1
9146,158298,IXrLVJjodB615NE3nTgPKqPt8WaHKw26,5Gyp41oLVo7Gg7vF4vpmggWP5MU70QO6,8,7,3,7,1,0,1,0,19,2.7142857142857144,1,0.0,3,3,4,1,4,0,3,1,0,11,8,1
9147,158302,RIny2MW6RqEP7xhtFxJv3B1aXVgJY8Kb,5Gyp41oLVo7Gg7vF4vpmggWP5MU70QO6,9,3,3,0,2,1,3,0,12,1.7142857142857142,1,0.0,0,3,0,2,3,1,0,3,0,5,7,1
9148,158307,dYbZNYxO0nAgHa5V5N8JCn1RF7JGyv4D,5Gyp41oLVo7Gg7vF4vpmggWP5MU70QO6,5,2,1,0,0,0,3,0,6,0.8571428571428571,1,0.0,0,1,0,0,2,0,0,3,0,1,5,1
9149,158315,vEqCVQMEkFA9jAkToxTDdY0fNSaSUQ9D,5Gyp41oLVo7Gg7vF4vpmggWP5MU70QO6,7,7,4,4,0,0,3,0,18,2.5714285714285716,2,0.0,1,4,3,0,6,0,1,3,0,8,10,1
9150,158319,D1N0ONIJFdYniASKJjZ0ujwEVr50txl7,5Gyp41oLVo7Gg7vF4vpmggWP5MU70QO6,16,30,13,2,5,1,6,1,58,8.285714285714286,1,0.0,8,13,1,5,22,1,1,6,1,27,31,1
9151,158327,mPvXVlGo9bSTwMgpTYZ4iSSEx1nYBz0y,5Gyp41oLVo7Gg7vF4vpmggWP5MU70QO6,10,11,5,0,5,4,4,1,30,4.285714285714286,1,0.0,4,5,0,5,7,4,0,4,1,14,16,1
9152,158334,X2GdbfrOlCpRv8wMx5HzvbudX41aMYE8,5Gyp41oLVo7Gg7vF4vpmggWP5MU70QO6,6,3,1,0,1,0,2,0,7,1.0,1,0.0,0,1,0,1,3,0,0,2,0,2,5,1
9153,158366,ICjb9YpLQQYBLFzFmkyCMZI5LNU5C4Fb,5Gyp41oLVo7Gg7vF4vpmggWP5MU70QO6,5,2,0,0,0,0,3,0,5,0.7142857142857143,1,0.0,0,0,0,0,2,0,0,3,0,0,5,1
9154,158368,jgTQGQ00AW13KIzXKnXpxkMCJOtGM2ZD,5Gyp41oLVo7Gg7vF4vpmggWP5MU70QO6,1,0,0,0,0,0,1,0,1,0.14285714285714285,1,0.0,0,0,0,0,0,0,0,1,0,0,1,1
9155,158371,fObaRfbtHaNloqqusul6bmMsSWbuzvXC,5Gyp41oLVo7Gg7vF4vpmggWP5MU70QO6,4,3,1,0,0,2,2,0,8,1.1428571428571428,1,0.0,0,1,0,0,3,2,0,2,0,1,7,1
9156,158392,NZRigOdbBm5L1F5X34hgYO92Vp7JjaX3,5Gyp41oLVo7Gg7vF4vpmggWP5MU70QO6,11,15,0,5,0,2,6,1,29,4.142857142857143,3,0.0,0,0,4,0,15,2,1,6,1,4,25,1
9157,158397,latsXX2CZqBxsak0y2yj9qi2bgjzhjJg,5Gyp41oLVo7Gg7vF4vpmggWP5MU70QO6,6,4,1,2,0,0,7,0,14,2.0,4,0.0,3,1,1,0,1,0,1,7,0,5,9,1
9158,158428,VPcKjCFv5uj1KHy6ikFvFUjZnehBQnkG,5Gyp41oLVo7Gg7vF4vpmggWP5MU70QO6,1,0,0,0,0,0,1,0,1,0.14285714285714285,1,0.0,0,0,0,0,0,0,0,1,0,0,1,1
9159,158446,j7fxdaSY4VkaXgXfrlAoPQl6rG0QNxwy,5Gyp41oLVo7Gg7vF4vpmggWP5MU70QO6,11,6,3,0,2,7,10,1,29,4.142857142857143,1,0.0,0,3,0,2,6,7,0,10,1,5,24,1
9160,158448,1lJkwHSG2PGCCRTCX9irDtb1w49OiLJh,5Gyp41oLVo7Gg7vF4vpmggWP5MU70QO6,11,10,3,6,4,0,2,0,25,3.5714285714285716,1,0.0,5,3,4,4,5,0,2,2,0,16,9,1
9161,158449,aKtqxPEfMnVhEPAMX3aHrnYTfbYN9i8f,5Gyp41oLVo7Gg7vF4vpmggWP5MU70QO6,6,7,1,0,2,0,1,0,11,1.5714285714285714,1,0.0,4,1,0,2,3,0,0,1,0,7,4,1
9162,158451,1syK9UG7Y4VPCyZBn9Q2mdOHpXjUfHgM,5Gyp41oLVo7Gg7vF4vpmggWP5MU70QO6,8,8,5,0,3,0,2,0,18,2.5714285714285716,1,0.0,0,5,0,3,8,0,0,2,0,8,10,1
9163,158465,iGwzujU2fvfaIrqdvBqmTILGKXNCvtST,5Gyp41oLVo7Gg7vF4vpmggWP5MU70QO6,4,3,2,0,2,0,2,0,9,1.2857142857142858,1,0.0,0,2,0,2,3,0,0,2,0,4,5,1
9164,158471,pQnR1td8vlxsKseVpfzZVvCBdR2iP4U6,5Gyp41oLVo7Gg7vF4vpmggWP5MU70QO6,12,11,6,0,5,0,4,0,26,3.7142857142857144,2,0.0,3,6,0,5,8,0,0,4,0,14,12,0
9165,158475,tU7GYHVcqvPAhXeEzR3nSmazmN6x1pBo,5Gyp41oLVo7Gg7vF4vpmggWP5MU70QO6,14,9,6,0,3,1,8,1,28,4.0,1,0.0,2,6,0,3,7,1,0,8,1,11,17,1
9166,158482,HMY5UQZiJ6ibeUNVihGwzdWGFcnwmp2R,5Gyp41oLVo7Gg7vF4vpmggWP5MU70QO6,1,0,0,0,0,0,1,0,1,0.14285714285714285,1,0.0,0,0,0,0,0,0,0,1,0,0,1,0
9167,158499,cjeJHDkfxPviww43UjeYlqmXXhxoPUfS,5Gyp41oLVo7Gg7vF4vpmggWP5MU70QO6,14,26,14,7,5,0,6,0,58,8.285714285714286,2,0.0,7,14,5,5,19,0,2,6,0,31,27,1
9168,158503,GhKn6zUEcIeiQ84zL2foYnGEKfw1oGjR,5Gyp41oLVo7Gg7vF4vpmggWP5MU70QO6,5,2,1,0,1,0,2,0,6,0.8571428571428571,1,0.0,0,1,0,1,2,0,0,2,0,2,4,1
9169,158518,VaAMzeJRo1p0krJhWA06tbTQQnzM9iwl,5Gyp41oLVo7Gg7vF4vpmggWP5MU70QO6,5,5,2,0,2,0,1,0,10,1.4285714285714286,1,0.0,0,2,0,2,5,0,0,1,0,4,6,1
9170,158532,XGiXK0tbneDlArbNNTMSAdB0dlmDCbAa,5Gyp41oLVo7Gg7vF4vpmggWP5MU70QO6,4,2,1,0,1,0,1,0,5,0.7142857142857143,1,0.0,0,1,0,1,2,0,0,1,0,2,3,1
9171,158548,LUNvU0WN1ejHZl1ho5KHC757d4vEnJq2,5Gyp41oLVo7Gg7vF4vpmggWP5MU70QO6,1,0,0,0,0,0,1,0,1,0.14285714285714285,1,0.0,0,0,0,0,0,0,0,1,0,0,1,1
9172,158550,N3yVimC4aRoIqkJhHmANqT86FYt5td7u,5Gyp41oLVo7Gg7vF4vpmggWP5MU70QO6,7,3,2,0,2,1,2,0,10,1.4285714285714286,1,0.0,0,2,0,2,3,1,0,2,0,4,6,1
9173,158562,o5YWOidjiSfpyoPVxXwOOyp6YMlu6cLI,5Gyp41oLVo7Gg7vF4vpmggWP5MU70QO6,10,8,5,0,6,0,14,0,33,4.714285714285714,3,0.0,3,5,0,6,5,0,0,14,0,14,19,0
9174,158590,kf0lhHnugT1vtE41zPkmCTmOp2QZF7bf,5Gyp41oLVo7Gg7vF4vpmggWP5MU70QO6,1,0,0,0,0,0,1,0,1,0.14285714285714285,1,0.0,0,0,0,0,0,0,0,1,0,0,1,1
9175,158591,VXBTEalT0R9120bnGfzjxPXNZh5Vbgmq,5Gyp41oLVo7Gg7vF4vpmggWP5MU70QO6,6,1,1,0,1,3,4,0,10,1.4285714285714286,1,0.0,0,1,0,1,1,3,0,4,0,2,8,1
9176,158594,67ART2vkl2t74M325EVjIJhRx1ejvS40,5Gyp41oLVo7Gg7vF4vpmggWP5MU70QO6,5,3,0,0,1,0,1,0,5,0.7142857142857143,1,0.0,0,0,0,1,3,0,0,1,0,1,4,1
9177,158626,0mg5UfmflBvw9f6RP57AlBJRO9poj3Bs,5Gyp41oLVo7Gg7vF4vpmggWP5MU70QO6,10,12,6,10,5,0,1,0,34,4.857142857142857,3,0.0,4,6,8,5,8,0,2,1,0,23,11,1
9178,158630,99faj0kcVuT7kHv9nA0d6tnRL3ttmjCW,5Gyp41oLVo7Gg7vF4vpmggWP5MU70QO6,13,15,5,6,3,10,12,3,54,7.714285714285714,1,0.0,6,5,4,3,9,10,2,12,3,18,36,1
9179,158636,hs5j7ZRJAVz8N5EC1FkbvoiXWPD8IL3z,5Gyp41oLVo7Gg7vF4vpmggWP5MU70QO6,12,10,4,0,4,0,4,0,22,3.142857142857143,2,0.0,1,4,0,4,9,0,0,4,0,9,13,1
9180,158639,BVhlqa9pkjc6pOJk0LRKjvBb1yF4UDBq,5Gyp41oLVo7Gg7vF4vpmggWP5MU70QO6,8,7,3,5,2,0,1,0,18,2.5714285714285716,1,0.0,1,3,4,2,6,0,1,1,0,10,8,1
9181,158640,3mV71SeXD3qDtzaWL89u9LU777oDMbT1,5Gyp41oLVo7Gg7vF4vpmggWP5MU70QO6,7,4,2,0,3,0,1,0,10,1.4285714285714286,1,0.0,1,2,0,3,3,0,0,1,0,6,4,1
9182,158647,3oFdgEmlxQicwDGRxacbBjJfGG2f7Sm0,5Gyp41oLVo7Gg7vF4vpmggWP5MU70QO6,1,0,0,0,0,0,1,0,1,0.14285714285714285,1,0.0,0,0,0,0,0,0,0,1,0,0,1,1
9183,158648,6LaYV30mJA6DDxEWjdfiMe6PHSVBFoww,5Gyp41oLVo7Gg7vF4vpmggWP5MU70QO6,1,0,0,0,0,0,1,0,1,0.14285714285714285,1,0.0,0,0,0,0,0,0,0,1,0,0,1,1
9184,158655,mxIDhIfkfZRmyKvgS40aefoFvvMqvCbq,5Gyp41oLVo7Gg7vF4vpmggWP5MU70QO6,7,3,2,0,2,0,2,0,9,1.2857142857142858,1,0.0,0,2,0,2,3,0,0,2,0,4,5,1
9185,158657,JERgMmFADxaPxEUdcYHhaMN4ZwNAyErv,5Gyp41oLVo7Gg7vF4vpmggWP5MU70QO6,8,7,4,0,3,12,2,0,28,4.0,3,0.0,1,4,0,3,6,12,0,2,0,8,20,0
9186,158668,NXySuzojhc1I0F7FiD9yLOqmBISmCQMB,5Gyp41oLVo7Gg7vF4vpmggWP5MU70QO6,1,0,0,0,0,0,1,0,1,0.14285714285714285,1,0.0,0,0,0,0,0,0,0,1,0,0,1,1
9187,158673,LaK1JduURkjj2lyFeEeEE5FM3J5L76tw,5Gyp41oLVo7Gg7vF4vpmggWP5MU70QO6,11,7,6,0,2,0,6,0,21,3.0,1,0.0,0,6,0,2,7,0,0,6,0,8,13,1
9188,158678,curm7DJyoZd1VeR71yWbpk0F1NDxBCrb,5Gyp41oLVo7Gg7vF4vpmggWP5MU70QO6,3,0,0,0,0,0,2,1,3,0.42857142857142855,1,0.0,0,0,0,0,0,0,0,2,1,0,3,1
9189,158695,DSSmckcZEOaCq2Uyy2Q5soLDN4iq3zmj,5Gyp41oLVo7Gg7vF4vpmggWP5MU70QO6,1,0,0,0,0,0,1,0,1,0.14285714285714285,1,0.0,0,0,0,0,0,0,0,1,0,0,1,1
9190,158707,blAP8wVtw28JBPhy4b1uSGqPMok7iJQm,5Gyp41oLVo7Gg7vF4vpmggWP5MU70QO6,15,16,8,7,3,7,7,1,49,7.0,1,0.0,6,8,4,3,10,7,3,7,1,21,28,1
9191,158710,WMzC7kjJJNCQ87Hj1SoFAZe7rj5HHPPM,5Gyp41oLVo7Gg7vF4vpmggWP5MU70QO6,1,0,0,0,0,0,1,0,1,0.14285714285714285,1,0.0,0,0,0,0,0,0,0,1,0,0,1,1
9192,158712,U5tkSGsuOdb2NICMgmncfIQF9sXcaWQo,5Gyp41oLVo7Gg7vF4vpmggWP5MU70QO6,1,0,0,0,0,0,1,0,1,0.14285714285714285,1,0.0,0,0,0,0,0,0,0,1,0,0,1,1
9193,158730,FYx6GSMXxl2y0jnssFnEJ9FCCIx9jizb,5Gyp41oLVo7Gg7vF4vpmggWP5MU70QO6,7,5,2,3,1,0,2,0,13,1.8571428571428572,1,0.0,3,2,2,1,2,0,1,2,0,8,5,1
9194,158741,accsGsynbzT9uxup2dTgGKxq1XsrGccD,5Gyp41oLVo7Gg7vF4vpmggWP5MU70QO6,5,3,0,0,0,1,2,1,7,1.0,1,0.0,0,0,0,0,3,1,0,2,1,0,7,1
9195,158743,UtpZFkJuvwL79mpOvm9h0KMX43ak3HFN,5Gyp41oLVo7Gg7vF4vpmggWP5MU70QO6,13,12,8,3,5,2,2,0,32,4.571428571428571,1,0.0,2,8,2,5,10,2,1,2,0,17,15,1
9196,158754,X0mwoxg874EbVxrlqwujNOOtlWsV2BZT,5Gyp41oLVo7Gg7vF4vpmggWP5MU70QO6,1,0,0,0,0,0,1,0,1,0.14285714285714285,1,0.0,0,0,0,0,0,0,0,1,0,0,1,1
9197,158776,WxvV8906xHzUZ8rq9etrY9Z1AOFyKSuT,5Gyp41oLVo7Gg7vF4vpmggWP5MU70QO6,14,11,4,3,3,2,7,1,31,4.428571428571429,1,0.0,6,4,2,3,5,2,1,7,1,15,16,1
9198,158783,vgN66F9Psm9Sxn9XT8nXYF0PS9BmAZED,5Gyp41oLVo7Gg7vF4vpmggWP5MU70QO6,1,0,0,0,0,0,2,0,2,0.2857142857142857,1,0.0,0,0,0,0,0,0,0,2,0,0,2,1
9199,158789,QXdd4a8KUTENAhNG79XpK4nmy1a07jeZ,5Gyp41oLVo7Gg7vF4vpmggWP5MU70QO6,1,0,0,0,0,0,1,0,1,0.14285714285714285,1,0.0,0,0,0,0,0,0,0,1,0,0,1,1
9200,158791,rGMEgQUkx4ST8bcPlJudg4FrbwvvvQJI,5Gyp41oLVo7Gg7vF4vpmggWP5MU70QO6,6,7,3,0,3,4,2,0,19,2.7142857142857144,2,0.0,1,3,0,3,6,4,0,2,0,7,12,1
9201,158814,VQIYnKO2473Bm22Gvh9VUHJtN81C8R1U,5Gyp41oLVo7Gg7vF4vpmggWP5MU70QO6,1,0,0,0,0,0,1,0,1,0.14285714285714285,1,0.0,0,0,0,0,0,0,0,1,0,0,1,1
9202,158826,QOuPgB8Uq3vJXh3zZBsjHkUOKOuZTKi8,5Gyp41oLVo7Gg7vF4vpmggWP5MU70QO6,4,2,1,0,1,0,2,0,6,0.8571428571428571,1,0.0,0,1,0,1,2,0,0,2,0,2,4,1
9203,158828,l2ByLqWzNHTFUGbglB0LunZR7pyhyPYC,5Gyp41oLVo7Gg7vF4vpmggWP5MU70QO6,4,0,0,0,0,3,3,0,6,0.8571428571428571,1,0.0,0,0,0,0,0,3,0,3,0,0,6,1
9204,158838,8cOlXXCu1kqO1hQan6tXksLaEW2dHkep,5Gyp41oLVo7Gg7vF4vpmggWP5MU70QO6,2,0,0,0,0,0,2,0,2,0.2857142857142857,2,0.0,0,0,0,0,0,0,0,2,0,0,2,1
9205,158844,MXomTGoseq9wn0Aqsho7Zdv6GaZ97tyh,5Gyp41oLVo7Gg7vF4vpmggWP5MU70QO6,5,4,2,0,1,0,2,0,9,1.2857142857142858,2,0.0,0,2,0,1,4,0,0,2,0,3,6,1
9206,158846,U3LGmFCOR4N6RHfV58LImyY8zsM7dVCO,5Gyp41oLVo7Gg7vF4vpmggWP5MU70QO6,21,33,14,11,12,0,4,0,74,10.571428571428571,4,0.0,10,14,8,12,23,0,3,4,0,44,30,1
9207,158849,hsaEJHgxwdJ8kMXFbLBAZN911WXVYvlZ,5Gyp41oLVo7Gg7vF4vpmggWP5MU70QO6,1,0,0,0,0,0,2,0,2,0.2857142857142857,2,0.0,0,0,0,0,0,0,0,2,0,0,2,1
9208,158861,NWP6ZOPeJjqRYoRHKneJjRxHdYMJ5lE2,5Gyp41oLVo7Gg7vF4vpmggWP5MU70QO6,1,0,0,0,0,0,1,0,1,0.14285714285714285,1,0.0,0,0,0,0,0,0,0,1,0,0,1,1
9209,158870,OWSRbTsro9ti37TwJJKCZuCImpFAWRwD,5Gyp41oLVo7Gg7vF4vpmggWP5MU70QO6,11,10,5,0,6,0,4,0,25,3.5714285714285716,2,0.0,2,5,0,6,8,0,0,4,0,13,12,1
9210,158878,ckJ0RkYemmBif8oGKbwb3NyOiUntCAqy,5Gyp41oLVo7Gg7vF4vpmggWP5MU70QO6,8,3,2,3,1,0,3,0,12,1.7142857142857142,1,0.0,1,2,2,1,2,0,1,3,0,6,6,1
9211,158885,ysT116AH0RAvrhgY1lcceDaQox5uWZBY,5Gyp41oLVo7Gg7vF4vpmggWP5MU70QO6,11,16,4,2,3,0,2,0,27,3.857142857142857,2,0.0,9,4,1,3,7,0,1,2,0,17,10,1
9212,158895,qFgmf2eWenRKI7RhiC0TqfbCuuuMuyte,5Gyp41oLVo7Gg7vF4vpmggWP5MU70QO6,8,6,0,3,1,0,3,0,13,1.8571428571428572,1,0.0,3,0,2,1,3,0,1,3,0,6,7,1
9213,158917,i8awVzU04ciSrvVwgkzWUNZdKmI93ibt,5Gyp41oLVo7Gg7vF4vpmggWP5MU70QO6,1,0,0,0,0,0,1,0,1,0.14285714285714285,1,0.0,0,0,0,0,0,0,0,1,0,0,1,1
9214,158930,g9o8p9s62M8GfoXopST7UXpfG3HNkigg,5Gyp41oLVo7Gg7vF4vpmggWP5MU70QO6,10,11,4,0,5,0,2,0,22,3.142857142857143,2,0.0,5,4,0,5,6,0,0,2,0,14,8,1
9215,158935,QVQfEfVeeb06g03UbNMBczsOzsyST5bd,5Gyp41oLVo7Gg7vF4vpmggWP5MU70QO6,6,3,1,0,0,0,5,0,9,1.2857142857142858,1,0.0,0,1,0,0,3,0,0,5,0,1,8,1
9216,158944,mdgoC0NXnOy13qU6nfb5wwenc30x0YGj,5Gyp41oLVo7Gg7vF4vpmggWP5MU70QO6,36,45,17,82,1,0,10,0,155,22.142857142857142,4,0.0,24,17,64,1,21,0,18,10,0,106,49,0
9217,158948,jQGozXgCDEtih8n0QNDjwOxHGubLTjEt,5Gyp41oLVo7Gg7vF4vpmggWP5MU70QO6,21,60,23,7,0,13,11,2,116,16.571428571428573,6,0.0,12,23,6,0,48,13,1,11,2,41,75,1
9218,158954,9WhaE5N2XNUEN1LCjhiVifbADUz45LGY,5Gyp41oLVo7Gg7vF4vpmggWP5MU70QO6,1,0,0,0,0,0,1,0,1,0.14285714285714285,1,0.0,0,0,0,0,0,0,0,1,0,0,1,1
9219,158963,U5AVDljh153RMBqEeJz3uJoBcMeMiYU5,5Gyp41oLVo7Gg7vF4vpmggWP5MU70QO6,5,2,1,0,1,0,3,0,7,1.0,1,0.0,0,1,0,1,2,0,0,3,0,2,5,1
9220,158972,VgqtLD6MfoPupojpPQ1cprPeqz3iEXGs,5Gyp41oLVo7Gg7vF4vpmggWP5MU70QO6,7,3,2,1,0,0,8,0,14,2.0,2,0.0,1,2,1,0,2,0,0,8,0,4,10,1
9221,159000,pFuosLkfepKjMBmx8O2Ec2TV2AOueKhk,5Gyp41oLVo7Gg7vF4vpmggWP5MU70QO6,1,0,0,0,0,0,1,0,1,0.14285714285714285,1,0.0,0,0,0,0,0,0,0,1,0,0,1,1
9222,159023,QuWcIwHbQGr3JemjCJ3sqFodY7dYEjCA,5Gyp41oLVo7Gg7vF4vpmggWP5MU70QO6,9,6,4,0,3,0,4,1,18,2.5714285714285716,1,0.0,0,4,0,3,6,0,0,4,1,7,11,1
9223,159062,KtSnhyXFi6bevwD38L0oZAkqxHVX0Rkl,5Gyp41oLVo7Gg7vF4vpmggWP5MU70QO6,11,7,4,2,2,9,9,6,39,5.571428571428571,1,0.0,1,4,1,2,6,9,1,9,6,8,31,1
9224,159066,5rJzUauE9ryyUD651U4q6g9NlbcQ3byr,5Gyp41oLVo7Gg7vF4vpmggWP5MU70QO6,9,12,5,3,2,0,2,0,24,3.4285714285714284,1,0.0,4,5,2,2,8,0,1,2,0,13,11,1
9225,159067,29lVEZFZAjCojpdMgxYvJN3otXj3PLWe,5Gyp41oLVo7Gg7vF4vpmggWP5MU70QO6,10,19,7,10,1,14,2,0,53,7.571428571428571,1,0.0,7,7,6,1,12,14,4,2,0,21,32,1
9226,159077,d4XXuJnMGWTN1dlwfFP2TLeVQbGEL5nV,5Gyp41oLVo7Gg7vF4vpmggWP5MU70QO6,1,0,0,0,0,0,1,0,1,0.14285714285714285,1,0.0,0,0,0,0,0,0,0,1,0,0,1,1
9227,159095,967P3nBM3EV9TdOVicGWkXEefW3fOsPT,5Gyp41oLVo7Gg7vF4vpmggWP5MU70QO6,1,0,0,0,0,0,1,0,1,0.14285714285714285,1,0.0,0,0,0,0,0,0,0,1,0,0,1,1
9228,159113,Hbftg5rbgdpHCJBfcLzthEBIMS9IG9KN,5Gyp41oLVo7Gg7vF4vpmggWP5MU70QO6,4,3,0,0,0,2,2,0,7,1.0,1,0.0,0,0,0,0,3,2,0,2,0,0,7,1
9229,159129,X3SAXegdLn475KkijByoM5BR9n74pQSC,5Gyp41oLVo7Gg7vF4vpmggWP5MU70QO6,6,4,2,0,1,0,3,1,11,1.5714285714285714,1,0.0,0,2,0,1,4,0,0,3,1,3,8,1
9230,159138,vG3M5JLO0gRotnItxOh8CvNNDagvaG8a,5Gyp41oLVo7Gg7vF4vpmggWP5MU70QO6,6,3,2,0,2,2,1,0,10,1.4285714285714286,1,0.0,0,2,0,2,3,2,0,1,0,4,6,1
9231,159140,3NzpVqr104XA43YTAM8shxzlfnDxKz19,5Gyp41oLVo7Gg7vF4vpmggWP5MU70QO6,4,2,0,0,1,0,4,0,7,1.0,1,0.0,0,0,0,1,2,0,0,4,0,1,6,1
9232,159152,Noa68GvfyEA47DCtuZAZ77yxgZfEUUFu,5Gyp41oLVo7Gg7vF4vpmggWP5MU70QO6,5,3,1,0,1,0,2,0,7,1.0,1,0.0,0,1,0,1,3,0,0,2,0,2,5,1
9233,159173,urVw10ZOKTw1O1zHFnsutUzT6EcZdTal,5Gyp41oLVo7Gg7vF4vpmggWP5MU70QO6,10,14,5,0,4,0,4,0,27,3.857142857142857,1,0.0,3,5,0,4,11,0,0,4,0,12,15,1
9234,159181,QRNZCYPVLmCISEPDuklXJvVOWAcJbKvm,5Gyp41oLVo7Gg7vF4vpmggWP5MU70QO6,1,0,0,0,0,0,1,0,1,0.14285714285714285,1,0.0,0,0,0,0,0,0,0,1,0,0,1,1
9235,159188,QCg3b9fGCe5yEcGGE9opNGK1SexzbVNd,5Gyp41oLVo7Gg7vF4vpmggWP5MU70QO6,4,3,2,0,0,0,2,0,7,1.0,1,0.0,0,2,0,0,3,0,0,2,0,2,5,1
9236,159189,fIJG5tNQwz0BZT33WXfZyUjrmdrvWWdQ,5Gyp41oLVo7Gg7vF4vpmggWP5MU70QO6,1,0,0,0,0,0,1,0,1,0.14285714285714285,1,0.0,0,0,0,0,0,0,0,1,0,0,1,1
9237,159232,xVu6NAX59MOmpApYDfs9WPe7YPPVhsFD,5Gyp41oLVo7Gg7vF4vpmggWP5MU70QO6,7,3,2,0,2,0,2,0,9,1.2857142857142858,1,0.0,0,2,0,2,3,0,0,2,0,4,5,1
9238,159242,YHvNkCivjRHH8EGu64ewmhgCCSxDxlLo,5Gyp41oLVo7Gg7vF4vpmggWP5MU70QO6,1,0,0,0,0,0,1,0,1,0.14285714285714285,1,0.0,0,0,0,0,0,0,0,1,0,0,1,1
9239,159245,2WzexY9OFeSixTrWc6uIGFmWjEnf6pcG,5Gyp41oLVo7Gg7vF4vpmggWP5MU70QO6,7,5,3,0,2,0,5,0,15,2.142857142857143,1,0.0,1,3,0,2,4,0,0,5,0,6,9,1
9240,159246,1ZH3IzOKvwfAvTNs2hBivrhkbs1U4aYk,5Gyp41oLVo7Gg7vF4vpmggWP5MU70QO6,4,5,2,0,0,0,1,0,8,1.1428571428571428,1,0.0,2,2,0,0,3,0,0,1,0,4,4,1
9241,159260,Hivv7BiBIp2lJJMsXCfOLJSRzfV9PZBW,5Gyp41oLVo7Gg7vF4vpmggWP5MU70QO6,9,6,4,0,3,0,4,0,17,2.4285714285714284,1,0.0,1,4,0,3,5,0,0,4,0,8,9,1
9242,159268,wNrMk5m00WQRXqvjv11kHeMVGGYxeJKx,5Gyp41oLVo7Gg7vF4vpmggWP5MU70QO6,6,3,2,0,2,0,1,0,8,1.1428571428571428,1,0.0,0,2,0,2,3,0,0,1,0,4,4,1
9243,159283,ChM4xDWfsNc1gxX7Rr8rWn3LIMVmB93b,5Gyp41oLVo7Gg7vF4vpmggWP5MU70QO6,4,2,1,0,1,0,2,0,6,0.8571428571428571,1,0.0,0,1,0,1,2,0,0,2,0,2,4,1
9244,159299,5wKzDgoaRUDR7JnVq8Rlsqj2aBlh0arD,5Gyp41oLVo7Gg7vF4vpmggWP5MU70QO6,1,0,0,0,0,0,1,0,1,0.14285714285714285,1,0.0,0,0,0,0,0,0,0,1,0,0,1,1
9245,159307,nYSFDE8RCbcZhD46fRSvPHUvA1ahfupi,5Gyp41oLVo7Gg7vF4vpmggWP5MU70QO6,16,27,16,0,7,0,7,0,57,8.142857142857142,4,0.0,0,16,0,7,27,0,0,7,0,23,34,1
9246,159310,2hSq1bkVvTSVSDFgRzwQhvmkM4fwiFNB,5Gyp41oLVo7Gg7vF4vpmggWP5MU70QO6,5,3,1,0,1,0,3,0,8,1.1428571428571428,1,0.0,0,1,0,1,3,0,0,3,0,2,6,1
9247,159313,2LtYZOjxB2pNkaXT76uGWds8mjls10j1,5Gyp41oLVo7Gg7vF4vpmggWP5MU70QO6,9,7,3,2,2,0,2,0,16,2.2857142857142856,2,0.0,3,3,1,2,4,0,1,2,0,9,7,1
9248,159336,cylVpn6BHNf8kPweB7o4j0HSX2fVNwi5,5Gyp41oLVo7Gg7vF4vpmggWP5MU70QO6,1,0,0,0,0,0,1,0,1,0.14285714285714285,1,0.0,0,0,0,0,0,0,0,1,0,0,1,1
9249,159362,vhOo9Hucfrf0SGFbToD9FkXxIs8rxeEc,5Gyp41oLVo7Gg7vF4vpmggWP5MU70QO6,5,2,1,0,1,0,2,0,6,0.8571428571428571,1,0.0,0,1,0,1,2,0,0,2,0,2,4,1
9250,159363,DopiUmKHL5PYH4L9s4SOnc9o6UExYgCw,5Gyp41oLVo7Gg7vF4vpmggWP5MU70QO6,5,2,1,0,1,0,3,0,7,1.0,1,0.0,0,1,0,1,2,0,0,3,0,2,5,1
9251,159389,eJj5JseFYNst7BY37oSEoHmO6OuUF5RV,5Gyp41oLVo7Gg7vF4vpmggWP5MU70QO6,9,11,5,0,3,0,1,0,20,2.857142857142857,1,0.0,0,5,0,3,11,0,0,1,0,8,12,1
9252,159430,PyeKdLyIaTDrn5HSeSXlpLU3ndq8YFOb,5Gyp41oLVo7Gg7vF4vpmggWP5MU70QO6,10,8,5,0,3,0,2,0,18,2.5714285714285716,1,0.0,2,5,0,3,6,0,0,2,0,10,8,1
9253,159467,TYR1iv9nm6adrwA9qvDB8QeOl5MRonVb,5Gyp41oLVo7Gg7vF4vpmggWP5MU70QO6,3,3,1,0,0,0,1,0,5,0.7142857142857143,1,0.0,0,1,0,0,3,0,0,1,0,1,4,1
9254,159472,HiGZLdeZRYtIjPAzubAbGiFih6ux0sb7,5Gyp41oLVo7Gg7vF4vpmggWP5MU70QO6,6,5,2,0,2,0,1,0,10,1.4285714285714286,1,0.0,0,2,0,2,5,0,0,1,0,4,6,1
9255,159502,B43CklOat00y9Wg2Il14gb5uOzGmEKhV,5Gyp41oLVo7Gg7vF4vpmggWP5MU70QO6,8,5,3,0,2,0,2,0,12,1.7142857142857142,1,0.0,0,3,0,2,5,0,0,2,0,5,7,1
9256,159520,jyaiZRchqKabVkvpbZb23UrKdvMdU3nb,5Gyp41oLVo7Gg7vF4vpmggWP5MU70QO6,3,3,1,0,0,0,1,0,5,0.7142857142857143,1,0.0,0,1,0,0,3,0,0,1,0,1,4,1
9257,159525,unG4C0Ae6YJ39WbV1xtmGVvK7bPgQLG7,5Gyp41oLVo7Gg7vF4vpmggWP5MU70QO6,4,2,1,0,1,0,2,0,6,0.8571428571428571,1,0.0,0,1,0,1,2,0,0,2,0,2,4,0
9258,159541,zQuoYbxMGLzlCOnlKPSBbmIjoqCIUWrm,5Gyp41oLVo7Gg7vF4vpmggWP5MU70QO6,11,5,4,0,3,3,5,0,20,2.857142857142857,1,0.0,0,4,0,3,5,3,0,5,0,7,13,1
9259,159576,Zir9lHWQ9bVexbJ0KzuWALSFFwHLNkKC,5Gyp41oLVo7Gg7vF4vpmggWP5MU70QO6,9,8,4,0,4,0,4,0,20,2.857142857142857,2,0.0,2,4,0,4,6,0,0,4,0,10,10,1
9260,159612,w3155Vkw5wpuKOK6WeWXLmPGCsMeqo9R,5Gyp41oLVo7Gg7vF4vpmggWP5MU70QO6,9,6,2,0,5,1,4,1,19,2.7142857142857144,1,0.0,3,2,0,5,3,1,0,4,1,10,9,1
9261,159632,ct83Qv94t9TQPl3Un0msY2hQIEvMuagv,5Gyp41oLVo7Gg7vF4vpmggWP5MU70QO6,8,6,4,0,2,0,4,0,16,2.2857142857142856,1,0.0,1,4,0,2,5,0,0,4,0,7,9,1
9262,159639,15WVuDgxppV6WeAB10xXsEAXeOmHb2uY,5Gyp41oLVo7Gg7vF4vpmggWP5MU70QO6,9,4,3,0,2,0,5,0,14,2.0,1,0.0,0,3,0,2,4,0,0,5,0,5,9,1
9263,159641,cfgpXsy2XrwK0vXt98s9wG0gOlB9vQtp,5Gyp41oLVo7Gg7vF4vpmggWP5MU70QO6,7,14,4,0,2,0,1,0,21,3.0,1,0.0,0,4,0,2,14,0,0,1,0,6,15,1
9264,159670,yTR25TcJUEADShe175bgEmLpP7tfblHz,5Gyp41oLVo7Gg7vF4vpmggWP5MU70QO6,1,0,0,0,0,0,1,0,1,0.14285714285714285,1,0.0,0,0,0,0,0,0,0,1,0,0,1,1
9265,159672,VDLlgOqW7FFpT6uHqFXXlnnZR1JOz0x8,5Gyp41oLVo7Gg7vF4vpmggWP5MU70QO6,7,5,2,0,2,0,2,0,11,1.5714285714285714,1,0.0,0,2,0,2,5,0,0,2,0,4,7,1
9266,159679,y33eMbXY1VlbmqKcmxbgktxjSAbFBdW9,5Gyp41oLVo7Gg7vF4vpmggWP5MU70QO6,4,3,1,0,2,0,3,0,9,1.2857142857142858,1,0.0,0,1,0,2,3,0,0,3,0,3,6,1
9267,159687,yjfB9txE0BWOZJoQv13P8CrvW2TkHsmS,5Gyp41oLVo7Gg7vF4vpmggWP5MU70QO6,7,7,4,0,2,0,7,0,20,2.857142857142857,3,0.0,0,4,0,2,7,0,0,7,0,6,14,1
9268,159688,AzzlZTan85NtpWN7Tw6er163M4eAWMcs,5Gyp41oLVo7Gg7vF4vpmggWP5MU70QO6,1,0,0,0,0,0,1,0,1,0.14285714285714285,1,0.0,0,0,0,0,0,0,0,1,0,0,1,1
9269,159695,ett4RSqrxzIV8EYuhd1Xe4BYirxYbVDx,5Gyp41oLVo7Gg7vF4vpmggWP5MU70QO6,7,4,3,0,3,2,2,0,14,2.0,1,0.0,0,3,0,3,4,2,0,2,0,6,8,1
9270,159708,u4BkBK8HWmjRZPrK4zcxe58fHdGGfFNp,5Gyp41oLVo7Gg7vF4vpmggWP5MU70QO6,7,3,2,0,2,0,2,0,9,1.2857142857142858,1,0.0,0,2,0,2,3,0,0,2,0,4,5,1
9271,159716,c89GCI4T9UcMbWU1kL7agsdCDAa4AkWS,5Gyp41oLVo7Gg7vF4vpmggWP5MU70QO6,8,5,3,0,2,0,3,0,13,1.8571428571428572,1,0.0,0,3,0,2,5,0,0,3,0,5,8,1
9272,159719,HBFgStpuQalhsLiCWI2Sn4sRFT5nvY4k,5Gyp41oLVo7Gg7vF4vpmggWP5MU70QO6,1,0,0,0,0,0,1,0,1,0.14285714285714285,1,0.0,0,0,0,0,0,0,0,1,0,0,1,1
9273,159722,TSstpRXnNkTPjLUvEsYaaDQsqpwgAdqr,5Gyp41oLVo7Gg7vF4vpmggWP5MU70QO6,8,2,1,0,1,1,5,1,11,1.5714285714285714,1,0.0,0,1,0,1,2,1,0,5,1,2,9,1
9274,159730,kuvvE2inYNYJSuXFQV1lIziKGSL6TqjZ,5Gyp41oLVo7Gg7vF4vpmggWP5MU70QO6,1,0,0,0,0,0,1,0,1,0.14285714285714285,1,0.0,0,0,0,0,0,0,0,1,0,0,1,1
9275,159740,7iVjX5slboUIidbmRRQjBPOKlP8TGLsY,5Gyp41oLVo7Gg7vF4vpmggWP5MU70QO6,1,0,0,0,0,0,1,0,1,0.14285714285714285,1,0.0,0,0,0,0,0,0,0,1,0,0,1,1
9276,159749,IqGyAMGyf3a5Zz7YiOGhpP1rd6TlLb1Z,5Gyp41oLVo7Gg7vF4vpmggWP5MU70QO6,1,0,0,0,0,0,1,0,1,0.14285714285714285,1,0.0,0,0,0,0,0,0,0,1,0,0,1,1
9277,159763,X033fyIoYJw0V0oiVitDJiomc3Zn6SXp,5Gyp41oLVo7Gg7vF4vpmggWP5MU70QO6,1,0,0,0,0,0,1,0,1,0.14285714285714285,1,0.0,0,0,0,0,0,0,0,1,0,0,1,1
9278,159806,zcTiccZJd2MTPFUSrtaiC1AfTUMC6Noi,5Gyp41oLVo7Gg7vF4vpmggWP5MU70QO6,1,0,0,0,0,0,1,0,1,0.14285714285714285,1,0.0,0,0,0,0,0,0,0,1,0,0,1,1
9279,159819,VHC0cJ6sdoxMeOTeT3TNsv8Qapi5L5BP,5Gyp41oLVo7Gg7vF4vpmggWP5MU70QO6,11,14,5,10,3,0,3,0,35,5.0,2,0.0,4,5,6,3,10,0,4,3,0,18,17,1
9280,159830,Qn4oQ1lJoD4ucx7ZxtRp3oFmTZaTCpvg,5Gyp41oLVo7Gg7vF4vpmggWP5MU70QO6,6,9,0,0,0,0,3,0,12,1.7142857142857142,1,0.0,0,0,0,0,9,0,0,3,0,0,12,1
9281,159832,auRdcj2vNiPfP2I5Om077ELvYeYb3Zl1,5Gyp41oLVo7Gg7vF4vpmggWP5MU70QO6,10,5,4,0,2,1,5,1,18,2.5714285714285716,2,0.0,0,4,0,2,5,1,0,5,1,6,12,1
9282,159842,QnAJxZKWmT5HVK2wsvkPfuBWQdcX78Rd,5Gyp41oLVo7Gg7vF4vpmggWP5MU70QO6,1,0,0,0,0,0,1,0,1,0.14285714285714285,1,0.0,0,0,0,0,0,0,0,1,0,0,1,0
9283,159867,jVVIXc6QhfFVc9Q2rtxQWruXQ4o0HCjv,5Gyp41oLVo7Gg7vF4vpmggWP5MU70QO6,1,0,0,0,0,0,1,0,1,0.14285714285714285,1,0.0,0,0,0,0,0,0,0,1,0,0,1,1
9284,159871,Uh4whLcptRuZuhdtjFruuYJY4YmOeYlV,5Gyp41oLVo7Gg7vF4vpmggWP5MU70QO6,14,19,8,4,7,0,5,0,43,6.142857142857143,3,0.0,7,8,3,7,12,0,1,5,0,25,18,1
9285,159874,bPD0WmDhx9OSgfXrv45xct1pk2tKsQXo,5Gyp41oLVo7Gg7vF4vpmggWP5MU70QO6,15,39,14,8,2,0,4,0,67,9.571428571428571,2,0.0,7,14,5,2,32,0,3,4,0,28,39,1
9286,159877,S6bRDWt0mg6bcMdrXi5pSSeTKgbfILwL,5Gyp41oLVo7Gg7vF4vpmggWP5MU70QO6,7,2,1,0,1,2,4,1,11,1.5714285714285714,1,0.0,0,1,0,1,2,2,0,4,1,2,9,1
9287,159880,An4Cs2oUOz8lYcIplHFLdygweoh5kMIV,5Gyp41oLVo7Gg7vF4vpmggWP5MU70QO6,15,21,9,0,12,32,4,0,78,11.142857142857142,1,0.0,10,9,0,12,11,32,0,4,0,31,47,1
9288,159907,vn6QiPL2hNfbQVlbP4Lnj04J2ZQusfUk,5Gyp41oLVo7Gg7vF4vpmggWP5MU70QO6,1,0,0,0,0,0,1,0,1,0.14285714285714285,1,0.0,0,0,0,0,0,0,0,1,0,0,1,1
9289,159925,h6oAjCi4h1GDTBi9n1s3EpArbdJGicBR,5Gyp41oLVo7Gg7vF4vpmggWP5MU70QO6,17,24,10,20,3,1,4,0,62,8.857142857142858,2,0.0,9,10,12,3,15,1,8,4,0,34,28,1
9290,159927,xWhdBnWFeXY9jZr3thhJIHBv8kNZjPAL,5Gyp41oLVo7Gg7vF4vpmggWP5MU70QO6,6,1,1,0,1,0,5,0,8,1.1428571428571428,1,0.0,0,1,0,1,1,0,0,5,0,2,6,1
9291,159944,GYPXhcvZqACuBKl71xTfXCfLOrfVfM3E,5Gyp41oLVo7Gg7vF4vpmggWP5MU70QO6,12,12,7,4,4,7,3,0,37,5.285714285714286,1,0.0,1,7,3,4,11,7,1,3,0,15,22,1
9292,159946,M4qxCm572dyAklYyW6rlwVA2xGuuy2h9,5Gyp41oLVo7Gg7vF4vpmggWP5MU70QO6,7,5,3,0,2,0,1,0,11,1.5714285714285714,1,0.0,0,3,0,2,5,0,0,1,0,5,6,1
9293,159998,1LSeBBzhGFTI9Y8bdsnswnbTVi1ldS97,5Gyp41oLVo7Gg7vF4vpmggWP5MU70QO6,6,3,2,0,2,1,1,0,9,1.2857142857142858,1,0.0,0,2,0,2,3,1,0,1,0,4,5,1
9294,160000,xZ3oCC931fdVSB0J29saeHfF5mIZlue8,5Gyp41oLVo7Gg7vF4vpmggWP5MU70QO6,5,2,1,0,1,0,2,0,6,0.8571428571428571,1,0.0,0,1,0,1,2,0,0,2,0,2,4,1
9295,160028,WmED4bMmNp41bkJ3snn9To3WokKLctdK,5Gyp41oLVo7Gg7vF4vpmggWP5MU70QO6,8,7,3,0,3,0,3,0,16,2.2857142857142856,1,0.0,3,3,0,3,4,0,0,3,0,9,7,1
9296,160030,1YrURc2g9Q9Bah4F5ddMZdbHdZCZkgqC,5Gyp41oLVo7Gg7vF4vpmggWP5MU70QO6,7,4,3,0,3,0,2,0,12,1.7142857142857142,1,0.0,0,3,0,3,4,0,0,2,0,6,6,1
9297,160033,dXqdfo9M4XFoTTNnKOGmnhmMz5oAXnEP,5Gyp41oLVo7Gg7vF4vpmggWP5MU70QO6,9,6,3,3,2,0,1,0,15,2.142857142857143,1,0.0,2,3,2,2,4,0,1,1,0,9,6,1
9298,160040,wcKFpvP8o06tSEqk6ISQICB28mahw0xB,5Gyp41oLVo7Gg7vF4vpmggWP5MU70QO6,7,5,2,0,1,0,2,1,11,1.5714285714285714,1,0.0,0,2,0,1,5,0,0,2,1,3,8,1
9299,160080,6itHejzsvHKM0bxFx1r8d8uHB1MGvhbh,5Gyp41oLVo7Gg7vF4vpmggWP5MU70QO6,9,7,1,3,2,0,2,0,15,2.142857142857143,1,0.0,3,1,2,2,4,0,1,2,0,8,7,1
9300,160084,xvBPiGwgzZvXW90yqsEGOxNtxynylEmQ,5Gyp41oLVo7Gg7vF4vpmggWP5MU70QO6,3,0,0,0,0,1,3,1,5,0.7142857142857143,1,0.0,0,0,0,0,0,1,0,3,1,0,5,1
9301,160085,bGVVh5mMYkn1gHW6CnpRuYzXwIcX6sC6,5Gyp41oLVo7Gg7vF4vpmggWP5MU70QO6,5,3,1,0,1,0,1,0,6,0.8571428571428571,1,0.0,0,1,0,1,3,0,0,1,0,2,4,1
9302,160094,WFLWEfQrQsuFMQB4h1DfinKxHOxaJgRw,5Gyp41oLVo7Gg7vF4vpmggWP5MU70QO6,8,5,2,0,1,2,4,0,14,2.0,1,0.0,0,2,0,1,5,2,0,4,0,3,11,0
9303,160099,Jqa9RxDwsQCM63qe4gzUBufHE7ckfXFv,5Gyp41oLVo7Gg7vF4vpmggWP5MU70QO6,17,37,8,11,2,0,7,0,65,9.285714285714286,2,0.0,9,8,8,2,28,0,3,7,0,27,38,1
9304,160119,aeg75UgFRA8ym4ySf49NGJnbhXGbV1bx,5Gyp41oLVo7Gg7vF4vpmggWP5MU70QO6,12,11,7,0,5,0,16,0,39,5.571428571428571,1,0.0,4,7,0,5,7,0,0,16,0,16,23,1
9305,160126,bR9OXRJ2475h6p8Gd2lf8xedbdOrDfAy,5Gyp41oLVo7Gg7vF4vpmggWP5MU70QO6,15,16,8,0,9,0,5,0,38,5.428571428571429,2,0.0,6,8,0,9,10,0,0,5,0,23,15,1
9306,160134,s2DHezS6V0fqgsBvlp59eRuwZhHpM8Vx,5Gyp41oLVo7Gg7vF4vpmggWP5MU70QO6,1,0,0,0,0,0,1,0,1,0.14285714285714285,1,0.0,0,0,0,0,0,0,0,1,0,0,1,1
9307,160142,peutEeFLpwHZll4NroVaoI7vEprCs9oo,5Gyp41oLVo7Gg7vF4vpmggWP5MU70QO6,13,9,5,2,3,4,8,2,33,4.714285714285714,1,0.0,1,5,1,3,8,4,1,8,2,10,23,1
9308,160144,lPlWLKHahAxwmGJE6cQVHruqHSF8nu1m,5Gyp41oLVo7Gg7vF4vpmggWP5MU70QO6,5,0,0,0,0,1,5,1,7,1.0,1,0.0,0,0,0,0,0,1,0,5,1,0,7,1
9309,160160,Glw0sdVKar4BTl3SUj2bFb23uoyJwJeN,5Gyp41oLVo7Gg7vF4vpmggWP5MU70QO6,4,2,1,0,1,0,1,0,5,0.7142857142857143,1,0.0,0,1,0,1,2,0,0,1,0,2,3,1
9310,160166,JC0KMNlyTwpwgjaVWIKSR5kWCFTPgBul,5Gyp41oLVo7Gg7vF4vpmggWP5MU70QO6,8,8,6,0,4,0,2,0,20,2.857142857142857,1,0.0,0,6,0,4,8,0,0,2,0,10,10,0
9311,160183,WCBxImuXCQhe4JCGgmUbhM2fHJqNW9fo,5Gyp41oLVo7Gg7vF4vpmggWP5MU70QO6,6,5,2,0,2,0,1,0,10,1.4285714285714286,1,0.0,0,2,0,2,5,0,0,1,0,4,6,1
9312,160221,j6j4FSCwiwqQXzEZJqluv2QvpitGuWOQ,5Gyp41oLVo7Gg7vF4vpmggWP5MU70QO6,2,0,0,0,0,0,2,0,2,0.2857142857142857,1,0.0,0,0,0,0,0,0,0,2,0,0,2,1
9313,160227,iakVJOwUlF2W3X06c03NXVlYoccvTl6G,5Gyp41oLVo7Gg7vF4vpmggWP5MU70QO6,13,17,8,5,2,1,11,0,44,6.285714285714286,2,0.0,3,8,3,2,14,1,2,11,0,16,28,1
9314,160254,OpC5sap2tAysVI4r8GHKcirTisziT9Sd,5Gyp41oLVo7Gg7vF4vpmggWP5MU70QO6,1,0,0,0,0,0,1,0,1,0.14285714285714285,1,0.0,0,0,0,0,0,0,0,1,0,0,1,1
9315,160256,yn2Ij88V2wSgGFNHE75cImAmp292E61N,5Gyp41oLVo7Gg7vF4vpmggWP5MU70QO6,8,10,4,0,3,0,1,0,18,2.5714285714285716,1,0.0,5,4,0,3,5,0,0,1,0,12,6,1
9316,160265,3liXI2TaHzRGVElpagKe3CCayjM1hCfU,5Gyp41oLVo7Gg7vF4vpmggWP5MU70QO6,1,0,0,0,0,0,1,0,1,0.14285714285714285,1,0.0,0,0,0,0,0,0,0,1,0,0,1,1
9317,160275,cMkZHhqT3aqaoU0tTxCIcH41Ep4BUBXX,5Gyp41oLVo7Gg7vF4vpmggWP5MU70QO6,11,8,5,0,3,5,9,1,31,4.428571428571429,1,0.0,0,5,0,3,8,5,0,9,1,8,23,1
9318,160284,yXIAbgjR7S4042oicRyG8kfTX0pG8yI5,5Gyp41oLVo7Gg7vF4vpmggWP5MU70QO6,6,7,0,0,0,0,2,0,9,1.2857142857142858,1,0.0,1,0,0,0,6,0,0,2,0,1,8,1
9319,160287,DlOlCACdDW2AnBt69t6IZa6KA7zxGy5D,5Gyp41oLVo7Gg7vF4vpmggWP5MU70QO6,1,0,0,0,0,0,1,0,1,0.14285714285714285,1,0.0,0,0,0,0,0,0,0,1,0,0,1,1
9320,160291,9vCHgKuY10o5HPF3YCSUYO4TU52wqZHL,5Gyp41oLVo7Gg7vF4vpmggWP5MU70QO6,7,1,0,0,1,0,9,2,13,1.8571428571428572,2,0.0,0,0,0,1,1,0,0,9,2,1,12,0
9321,160295,C8zDhaG0vPsQegBtS55u3JZHiYuueFnE,5Gyp41oLVo7Gg7vF4vpmggWP5MU70QO6,7,4,3,0,3,0,2,0,12,1.7142857142857142,1,0.0,0,3,0,3,4,0,0,2,0,6,6,1
9322,160311,0dBn4alo7QBTd62VD5XO0yNMbQ5QN2OQ,7GRhBDsirIGkRZBtSMEzNTyDr2JQm4xx,4,3,2,0,0,0,1,0,6,0.8571428571428571,1,0.0,0,2,0,0,3,0,0,1,0,2,4,1
9323,160314,bYyTnDMNQRdh2PC2RrU7V8pT6TWKO7Eq,5X6FeZozNMgE2VRi3MJYjkkFK8SETtu2,7,5,2,0,3,0,2,0,12,1.7142857142857142,1,0.0,2,2,0,3,3,0,0,2,0,7,5,1
9324,160329,vXDFPMCmOrOiDmbI0WjUFcVHHrjWOFJG,5X6FeZozNMgE2VRi3MJYjkkFK8SETtu2,1,0,0,0,0,0,2,0,2,0.2857142857142857,1,0.0,0,0,0,0,0,0,0,2,0,0,2,1
9325,160344,HIaaOq9UrLvo3UC4FIJStVsYhdTvdkJ9,5X6FeZozNMgE2VRi3MJYjkkFK8SETtu2,1,0,0,0,0,0,1,0,1,0.14285714285714285,1,0.0,0,0,0,0,0,0,0,1,0,0,1,1
9326,160390,8QWoRkYbUDz1r9tDz8JHpEYuquw4PH6N,5X6FeZozNMgE2VRi3MJYjkkFK8SETtu2,5,2,1,0,1,0,2,0,6,0.8571428571428571,1,0.0,0,1,0,1,2,0,0,2,0,2,4,1
9327,160398,WAC7RGZ1uYeT92igfYiLgTnHWPEtN2IA,5X6FeZozNMgE2VRi3MJYjkkFK8SETtu2,5,2,1,0,1,0,3,0,7,1.0,2,0.0,0,1,0,1,2,0,0,3,0,2,5,1
9328,160462,dCmeuLqbJmbADgjGxqkGRl3NTRmieZ1v,5X6FeZozNMgE2VRi3MJYjkkFK8SETtu2,30,36,14,21,19,0,2,0,92,13.142857142857142,1,0.0,21,14,20,19,15,0,1,2,0,74,18,1
9329,160476,hD4u7K20MkeesFqmBh9Esq7QUUZdGCv9,7GRhBDsirIGkRZBtSMEzNTyDr2JQm4xx,1,0,0,0,0,0,1,0,1,0.14285714285714285,1,0.0,0,0,0,0,0,0,0,1,0,0,1,1
9330,160485,ITkxDxE80MnM3R1P6Tny4qeXU1QIqBHa,5X6FeZozNMgE2VRi3MJYjkkFK8SETtu2,1,0,0,0,0,0,1,0,1,0.14285714285714285,1,0.0,0,0,0,0,0,0,0,1,0,0,1,1
9331,160490,CCgnS551kIRskNkrEIX6IfculoW0n8YO,5X6FeZozNMgE2VRi3MJYjkkFK8SETtu2,1,0,0,0,0,0,2,0,2,0.2857142857142857,2,0.0,0,0,0,0,0,0,0,2,0,0,2,1
9332,160496,jgJwseE0WxsNWZcNzhtAucTIUehcAJZy,5X6FeZozNMgE2VRi3MJYjkkFK8SETtu2,5,4,1,0,0,0,3,0,8,1.1428571428571428,1,0.0,0,1,0,0,4,0,0,3,0,1,7,1
9333,160548,eBSvxL0R8Q3voWeT1zBNYoMs227j8TN1,3VkHkmOtom3jM2wCu94xgzzu1d6Dn7or,16,24,10,23,0,2,3,0,62,8.857142857142858,2,0.0,10,10,23,0,14,2,0,3,0,43,19,1
9334,160550,wdxdPEvE36xfIB9lBB6iyJ74SRM2Pv8t,3VkHkmOtom3jM2wCu94xgzzu1d6Dn7or,4,9,3,0,3,4,1,0,20,2.857142857142857,1,0.0,5,3,0,3,4,4,0,1,0,11,9,1
9335,160554,8RsUWVhT21wU3hqZiuarsy4LdzVsaOkQ,3VkHkmOtom3jM2wCu94xgzzu1d6Dn7or,1,0,0,0,0,0,2,0,2,0.2857142857142857,1,0.0,0,0,0,0,0,0,0,2,0,0,2,1
9336,160555,Ta0cFZTRj95kjDl5GmHXWM25lW5JIkJf,3VkHkmOtom3jM2wCu94xgzzu1d6Dn7or,9,17,6,5,8,3,1,0,40,5.714285714285714,1,0.0,10,6,4,8,7,3,1,1,0,28,12,1
9337,160556,DY2up4tKnGeREyFMKlTR0yPpnZHUGeIJ,3VkHkmOtom3jM2wCu94xgzzu1d6Dn7or,1,0,0,0,0,0,2,0,2,0.2857142857142857,1,0.0,0,0,0,0,0,0,0,2,0,0,2,1
9338,160558,JdJ1SwT93OWgPbpS5GdJzD3RLASaE4SR,3VkHkmOtom3jM2wCu94xgzzu1d6Dn7or,1,0,0,0,0,0,1,0,1,0.14285714285714285,1,0.0,0,0,0,0,0,0,0,1,0,0,1,1
9339,160563,twGKEN7pLmrCddVKPrE08enGUkhaSMrX,3VkHkmOtom3jM2wCu94xgzzu1d6Dn7or,37,70,32,32,27,1,11,1,174,24.857142857142858,3,0.0,21,32,27,27,49,1,5,11,1,107,67,1
9340,160564,vI8IuaWn8GFY4xjhYpIM4bR2WseIJjMM,3VkHkmOtom3jM2wCu94xgzzu1d6Dn7or,5,2,1,0,1,0,2,0,6,0.8571428571428571,1,0.0,0,1,0,1,2,0,0,2,0,2,4,1
9341,160568,AbKYfqEQXjUR8gnQxcdgXaNxS2Ot8STL,3VkHkmOtom3jM2wCu94xgzzu1d6Dn7or,7,9,1,0,1,4,3,0,18,2.5714285714285716,1,0.0,0,1,0,1,9,4,0,3,0,2,16,1
9342,160569,su9V3cj7GzV7BMJTODtLyGaeGX7THzN8,3VkHkmOtom3jM2wCu94xgzzu1d6Dn7or,2,0,0,0,0,0,2,0,2,0.2857142857142857,1,0.0,0,0,0,0,0,0,0,2,0,0,2,1
9343,160575,nnLgUswwSxDZI0WAANeV7kiVkBqo2rYn,3VkHkmOtom3jM2wCu94xgzzu1d6Dn7or,17,48,17,20,17,16,10,0,128,18.285714285714285,4,0.0,26,17,17,17,22,16,3,10,0,77,51,1
9344,160578,5hFoF7Ey3CgzVLMi9mWcRI4lYZT69VON,3VkHkmOtom3jM2wCu94xgzzu1d6Dn7or,5,2,1,0,1,0,3,0,7,1.0,1,0.0,0,1,0,1,2,0,0,3,0,2,5,1
9345,160580,vyPFUWYot0zlmxw218nG9m2URrYdTITu,3VkHkmOtom3jM2wCu94xgzzu1d6Dn7or,1,0,0,0,0,0,1,0,1,0.14285714285714285,1,0.0,0,0,0,0,0,0,0,1,0,0,1,1
9346,160582,4zFYvh8Dra1dWDjTOlCuluSkB8UaHBGB,3VkHkmOtom3jM2wCu94xgzzu1d6Dn7or,14,17,10,0,8,1,4,1,41,5.857142857142857,1,0.0,3,10,0,8,14,1,0,4,1,21,20,1
9347,160590,umlPagtObd1nFSATZImSkHZJqZul544q,3VkHkmOtom3jM2wCu94xgzzu1d6Dn7or,11,14,7,0,4,0,6,0,31,4.428571428571429,3,0.0,0,7,0,4,14,0,0,6,0,11,20,1
9348,160591,Ha7c5VaWgAphltuYxnvX199Tjc0NFLTm,3VkHkmOtom3jM2wCu94xgzzu1d6Dn7or,2,0,0,0,0,0,2,0,2,0.2857142857142857,1,0.0,0,0,0,0,0,0,0,2,0,0,2,1
9349,160592,DaotIZvqRq8CbS1IYHQYwRpTWvK0ecmj,3VkHkmOtom3jM2wCu94xgzzu1d6Dn7or,1,0,0,0,0,0,3,0,3,0.42857142857142855,1,0.0,0,0,0,0,0,0,0,3,0,0,3,1
9350,160593,c8TFm45r0bfBe26eBlEeUAKDBoTJT9yV,3VkHkmOtom3jM2wCu94xgzzu1d6Dn7or,1,0,0,0,0,0,1,0,1,0.14285714285714285,1,0.0,0,0,0,0,0,0,0,1,0,0,1,1
9351,160602,bIkNtsuWOvgS5QK0U8Mmyvgqbj0FVVWQ,3VkHkmOtom3jM2wCu94xgzzu1d6Dn7or,13,12,10,0,0,0,5,2,29,4.142857142857143,2,0.0,0,10,0,0,12,0,0,5,2,10,19,1
9352,160604,7PMXBADuwo8nUSllCdBsa2nUjpHivQgP,3VkHkmOtom3jM2wCu94xgzzu1d6Dn7or,9,3,2,0,2,1,7,1,16,2.2857142857142856,1,0.0,0,2,0,2,3,1,0,7,1,4,12,1
9353,160605,kYEJXXhL2nVmzsq7ryJcoFk6ijuUWEJ8,3VkHkmOtom3jM2wCu94xgzzu1d6Dn7or,1,0,0,0,0,0,1,0,1,0.14285714285714285,1,0.0,0,0,0,0,0,0,0,1,0,0,1,1
9354,160607,sBUc6zD5dwvlQamygCFhDETRbipp92Uf,3VkHkmOtom3jM2wCu94xgzzu1d6Dn7or,13,32,13,0,6,23,49,8,131,18.714285714285715,1,0.0,9,13,0,6,23,23,0,49,8,28,103,1
9355,160609,unzM2fr5FICf2pkciDBx8ML6d1ZFN8Ox,3VkHkmOtom3jM2wCu94xgzzu1d6Dn7or,12,14,8,3,5,20,12,2,64,9.142857142857142,2,0.0,2,8,3,5,12,20,0,12,2,18,46,1
9356,160610,r2kL34j9XTVTdF5cCzQAeF8rL4nDRK5t,3VkHkmOtom3jM2wCu94xgzzu1d6Dn7or,22,62,25,9,22,12,21,0,151,21.571428571428573,8,0.0,25,25,9,22,37,12,0,21,0,81,70,1
9357,160612,BYlCbfakv0JnNg2h1Npd6R0qOoZSzfR7,3VkHkmOtom3jM2wCu94xgzzu1d6Dn7or,1,0,0,0,0,0,1,0,1,0.14285714285714285,1,0.0,0,0,0,0,0,0,0,1,0,0,1,1
9358,160613,mSbHXGd7wu84Kztv806n2JOoCUP5FmbE,3VkHkmOtom3jM2wCu94xgzzu1d6Dn7or,1,0,0,0,0,0,1,0,1,0.14285714285714285,1,0.0,0,0,0,0,0,0,0,1,0,0,1,1
9359,160615,3HC1D1DG8BjKUNFZlgm7gcIQVOGrzi6J,3VkHkmOtom3jM2wCu94xgzzu1d6Dn7or,9,6,2,0,2,0,2,0,12,1.7142857142857142,1,0.0,0,2,0,2,6,0,0,2,0,4,8,1
9360,160618,kn6Hs13Qj2B81fZC4tvAYTue2uxrpuDz,3VkHkmOtom3jM2wCu94xgzzu1d6Dn7or,16,28,11,0,8,0,3,0,50,7.142857142857143,2,0.0,2,11,0,8,26,0,0,3,0,21,29,0
9361,160622,TIMqx2gcwCCJ6ynyo9tGcvUWY9qctKOg,3VkHkmOtom3jM2wCu94xgzzu1d6Dn7or,23,42,11,23,1,5,11,0,93,13.285714285714286,2,0.0,10,11,18,1,32,5,5,11,0,40,53,1
9362,160627,xvcKkkK5JV17xBJf26r9BZRnVlqNQ6F6,3VkHkmOtom3jM2wCu94xgzzu1d6Dn7or,6,2,1,0,1,2,4,0,10,1.4285714285714286,1,0.0,0,1,0,1,2,2,0,4,0,2,8,1
9363,160628,UyX7nNmF6wGhy0d7beXB2sIT5I4J2s3C,3VkHkmOtom3jM2wCu94xgzzu1d6Dn7or,6,6,2,0,3,0,4,0,15,2.142857142857143,2,0.0,0,2,0,3,6,0,0,4,0,5,10,0
9364,160632,YGBQrGfSypROjlaNALEXgn4JBHmgIbfe,3VkHkmOtom3jM2wCu94xgzzu1d6Dn7or,4,2,1,0,1,0,1,0,5,0.7142857142857143,1,0.0,0,1,0,1,2,0,0,1,0,2,3,1
9365,160636,kIwVgOwXVLkGIsqKT00ytpZlpUgyryAe,3VkHkmOtom3jM2wCu94xgzzu1d6Dn7or,1,0,0,0,0,0,1,0,1,0.14285714285714285,1,0.0,0,0,0,0,0,0,0,1,0,0,1,1
9366,160638,sNGcbUmFY6aztxE4Hv7JlrqOIaAeV0nL,3VkHkmOtom3jM2wCu94xgzzu1d6Dn7or,5,4,1,0,0,0,3,0,8,1.1428571428571428,1,0.0,0,1,0,0,4,0,0,3,0,1,7,1
9367,160639,UijNr3To2coP0HvSNlidJgYuMGopc2MU,3VkHkmOtom3jM2wCu94xgzzu1d6Dn7or,1,0,0,0,0,0,1,0,1,0.14285714285714285,1,0.0,0,0,0,0,0,0,0,1,0,0,1,1
9368,160640,WR8Ujwo8LuGUeKfDuRC6pVq5SGQhaUdB,3VkHkmOtom3jM2wCu94xgzzu1d6Dn7or,1,0,0,0,0,0,1,0,1,0.14285714285714285,1,0.0,0,0,0,0,0,0,0,1,0,0,1,0
9369,160641,tClD64M9R0FogweD3PzbznlW4I247oJ0,3VkHkmOtom3jM2wCu94xgzzu1d6Dn7or,4,2,0,0,1,0,1,0,4,0.5714285714285714,1,0.0,0,0,0,1,2,0,0,1,0,1,3,1
9370,160646,V6XdC6tC3vHWuI4yJEyiTS9H06BrdWKA,3VkHkmOtom3jM2wCu94xgzzu1d6Dn7or,1,0,0,0,0,0,1,0,1,0.14285714285714285,1,0.0,0,0,0,0,0,0,0,1,0,0,1,1
9371,160650,TX6WaheSubX4Jh5OPfhz8yucBohGOx3b,3VkHkmOtom3jM2wCu94xgzzu1d6Dn7or,6,3,1,0,1,1,3,1,10,1.4285714285714286,1,0.0,0,1,0,1,3,1,0,3,1,2,8,1
9372,160663,SH3THvT9ATqMny80GD63EuK5GGnf8XMU,3VkHkmOtom3jM2wCu94xgzzu1d6Dn7or,10,16,2,8,1,3,7,1,38,5.428571428571429,2,0.0,7,2,6,1,9,3,2,7,1,16,22,1
9373,160673,c6XaDpje2iQSWpoXkTtf00BW6tACh6Q9,3VkHkmOtom3jM2wCu94xgzzu1d6Dn7or,7,3,2,0,2,2,6,1,16,2.2857142857142856,2,0.0,0,2,0,2,3,2,0,6,1,4,12,1
9374,160678,08OTJovI4mN1P4AUjCgqGCGzY3HAu3jj,A3fsA9Zfv1X2fVEQhTw51lKENdNrEqT3,9,6,3,0,0,1,10,2,22,3.142857142857143,1,0.0,2,3,0,0,4,1,0,10,2,5,17,1
9375,160689,maRYQr4yWNxVM9p4XKMWLQDUgjnfGEOV,SpATywNh6bZuzm8s1ceuBUnMUAeoAHHw,9,7,2,0,2,0,3,0,14,2.0,2,0.0,0,2,0,2,7,0,0,3,0,4,10,1
9376,160695,jVMhwZeU5vDgj3wVrGtqm4E7AFHhfK0R,bWdj2GDclj5ofokWjzoa5jAwMkxCykd6,5,9,2,0,3,0,2,0,16,2.2857142857142856,1,0.0,3,2,0,3,6,0,0,2,0,8,8,1
9377,160700,Y4UU3fLGxizfdyHNAtldrHung8ggH7YH,SpATywNh6bZuzm8s1ceuBUnMUAeoAHHw,2,0,0,0,0,0,2,0,2,0.2857142857142857,1,0.0,0,0,0,0,0,0,0,2,0,0,2,0
9378,160744,ulShWa7eRXZVcz2EYwR44GuwsfoLQCba,SpATywNh6bZuzm8s1ceuBUnMUAeoAHHw,1,0,0,0,0,0,1,0,1,0.14285714285714285,1,0.0,0,0,0,0,0,0,0,1,0,0,1,1
9379,160760,3qxjUYnIYNKewMm8FEnsaaY7IZkJWvME,A3fsA9Zfv1X2fVEQhTw51lKENdNrEqT3,1,0,0,0,0,0,1,0,1,0.14285714285714285,1,0.0,0,0,0,0,0,0,0,1,0,0,1,1
9380,160762,JqVdWoQHyNqeUwMTtrPuJeUxrm3Ef7QH,SpATywNh6bZuzm8s1ceuBUnMUAeoAHHw,16,24,9,0,6,0,6,0,45,6.428571428571429,1,0.0,0,9,0,6,24,0,0,6,0,15,30,1
9381,160772,wcY75Km16WlFjiueDkOBUhqeNxcDUZEC,SpATywNh6bZuzm8s1ceuBUnMUAeoAHHw,5,2,1,0,1,0,2,0,6,0.8571428571428571,1,0.0,0,1,0,1,2,0,0,2,0,2,4,1
9382,160775,ZgNdO7hyoQRmg00lVh0JR0YxTL2sBLXr,SpATywNh6bZuzm8s1ceuBUnMUAeoAHHw,20,22,6,31,6,0,34,0,99,14.142857142857142,4,0.0,6,6,28,6,16,0,3,34,0,46,53,0
9383,160779,ayXSJHlkjoyFUB4Y9YHZnlOXt35wvwwu,5X6FeZozNMgE2VRi3MJYjkkFK8SETtu2,1,0,0,0,0,0,1,0,1,0.14285714285714285,1,0.0,0,0,0,0,0,0,0,1,0,0,1,1
9384,160799,EUJXMkzFSEo17STajcXmmFEGLLejuzHK,SpATywNh6bZuzm8s1ceuBUnMUAeoAHHw,7,9,5,0,2,2,2,0,20,2.857142857142857,1,0.0,0,5,0,2,9,2,0,2,0,7,13,1
9385,160813,YrKW89w90qznhQzq68o8LzP2wDxTZoQ7,SpATywNh6bZuzm8s1ceuBUnMUAeoAHHw,1,0,0,0,0,0,1,0,1,0.14285714285714285,1,0.0,0,0,0,0,0,0,0,1,0,0,1,1
9386,160814,MYCZGZUUB6h2kR5SWwXC3erQhe8wj439,A3fsA9Zfv1X2fVEQhTw51lKENdNrEqT3,4,3,1,0,1,0,2,0,7,1.0,1,0.0,0,1,0,1,3,0,0,2,0,2,5,0
9387,160831,ycYabaRFVayOcZp1HtLrl0En4pTKGtZt,5X6FeZozNMgE2VRi3MJYjkkFK8SETtu2,1,0,0,0,0,0,1,0,1,0.14285714285714285,1,0.0,0,0,0,0,0,0,0,1,0,0,1,1
9388,160833,ycYabaRFVayOcZp1HtLrl0En4pTKGtZt,bWdj2GDclj5ofokWjzoa5jAwMkxCykd6,1,0,0,0,0,0,1,0,1,0.14285714285714285,1,0.0,0,0,0,0,0,0,0,1,0,0,1,1
9389,160837,3f8TEYsxw8fTx61szmPewZsIJHdQMPuP,SpATywNh6bZuzm8s1ceuBUnMUAeoAHHw,38,44,29,19,13,0,8,1,114,16.285714285714285,1,0.0,6,29,18,13,38,0,1,8,1,66,48,0
9390,160848,gbm2CIpey5BIwuF4GxSVVzkrIqxOpVxg,5X6FeZozNMgE2VRi3MJYjkkFK8SETtu2,1,0,0,0,0,0,1,0,1,0.14285714285714285,1,0.0,0,0,0,0,0,0,0,1,0,0,1,1
9391,160854,PWnc2bfhRdIfnUvCUBXCzFhD501NoXOI,SpATywNh6bZuzm8s1ceuBUnMUAeoAHHw,1,0,0,0,0,0,2,0,2,0.2857142857142857,1,0.0,0,0,0,0,0,0,0,2,0,0,2,1
9392,160875,3brvPLG28YLDueYV1AJHr2UrCWHsXO6w,SpATywNh6bZuzm8s1ceuBUnMUAeoAHHw,1,0,0,0,0,0,1,0,1,0.14285714285714285,1,0.0,0,0,0,0,0,0,0,1,0,0,1,1
9393,160885,gD8Q5HJC6S9Ahio3YuKn2MokdLQZr6bN,5X6FeZozNMgE2VRi3MJYjkkFK8SETtu2,10,5,3,0,2,2,11,1,24,3.4285714285714284,3,0.0,0,3,0,2,5,2,0,11,1,5,19,1
9394,160893,D0kyC5FJUDgGdAHjRh4Zvl046XDRRxWf,5X6FeZozNMgE2VRi3MJYjkkFK8SETtu2,2,0,0,0,0,0,2,0,2,0.2857142857142857,1,0.0,0,0,0,0,0,0,0,2,0,0,2,1
9395,160896,QorrHnxXo6JAqrXzWymDFHVcsHjUyyen,SpATywNh6bZuzm8s1ceuBUnMUAeoAHHw,1,0,0,0,0,0,1,0,1,0.14285714285714285,1,0.0,0,0,0,0,0,0,0,1,0,0,1,1
9396,160900,pwfJpYbVX39CeSzvJ7qw09YbBPUS5HaZ,SpATywNh6bZuzm8s1ceuBUnMUAeoAHHw,5,1,1,0,1,0,2,0,5,0.7142857142857143,1,0.0,0,1,0,1,1,0,0,2,0,2,3,1
9397,160906,Tld0Cp8nhQFMldHTc4wNbAWPalDRQyks,SpATywNh6bZuzm8s1ceuBUnMUAeoAHHw,52,78,50,20,38,5,8,3,202,28.857142857142858,3,0.0,6,50,17,38,72,5,3,8,3,111,91,0
9398,160911,UtNvwiEIu7iQRo2Po9FxglHJbAYaDW68,A3fsA9Zfv1X2fVEQhTw51lKENdNrEqT3,2,0,0,0,0,0,2,0,2,0.2857142857142857,1,0.0,0,0,0,0,0,0,0,2,0,0,2,1
9399,160912,RLZmn6mGPjHwRDtRmi28Ublb23MmEBlO,SpATywNh6bZuzm8s1ceuBUnMUAeoAHHw,8,8,1,0,1,2,4,0,16,2.2857142857142856,1,0.0,0,1,0,1,8,2,0,4,0,2,14,1
9400,160932,OAT2DaBS2qqaVHQUCn9wipcvqj5Upvl2,A3fsA9Zfv1X2fVEQhTw51lKENdNrEqT3,1,0,0,0,0,0,1,0,1,0.14285714285714285,1,0.0,0,0,0,0,0,0,0,1,0,0,1,1
9401,160948,ioaeb7d1U29jI9wsI7DHJ7aiuWWVX3KB,SpATywNh6bZuzm8s1ceuBUnMUAeoAHHw,1,0,0,0,0,0,1,0,1,0.14285714285714285,1,0.0,0,0,0,0,0,0,0,1,0,0,1,1
9402,160953,qF5FUAIl9vj6sKJZzYBK4dYgOrKuXUyJ,bWdj2GDclj5ofokWjzoa5jAwMkxCykd6,1,0,0,0,0,0,1,0,1,0.14285714285714285,1,0.0,0,0,0,0,0,0,0,1,0,0,1,1
9403,160963,W4swLEiF6xa4CU1Ee5z4jQMNXyEDiyxR,SpATywNh6bZuzm8s1ceuBUnMUAeoAHHw,9,10,5,0,3,0,4,0,22,3.142857142857143,1,0.0,0,5,0,3,10,0,0,4,0,8,14,1
9404,160966,MbuXqf7C13S68Qf0iCIWEHpPecEoxyR2,bWdj2GDclj5ofokWjzoa5jAwMkxCykd6,6,4,2,0,1,0,1,0,8,1.1428571428571428,1,0.0,0,2,0,1,4,0,0,1,0,3,5,1
9405,160971,GzsM7mUybvaWblQFpF1LhbuoVXQUHvXC,SpATywNh6bZuzm8s1ceuBUnMUAeoAHHw,6,3,1,0,1,0,2,0,7,1.0,1,0.0,0,1,0,1,3,0,0,2,0,2,5,1
9406,160976,vGz6lC8qPi2eLnEFPzWw51wpCxsgPBs3,SpATywNh6bZuzm8s1ceuBUnMUAeoAHHw,6,2,1,0,1,0,3,0,7,1.0,1,0.0,1,1,0,1,1,0,0,3,0,3,4,1
9407,160982,GqCGIGFGFhTKfbwDU3SVdL9uLBEMMF8w,SpATywNh6bZuzm8s1ceuBUnMUAeoAHHw,9,23,7,0,2,0,3,0,35,5.0,1,0.0,0,7,0,2,23,0,0,3,0,9,26,0
9408,160988,DJKl3Qg8a347WT9VIamdSjXAowCvpC9t,SpATywNh6bZuzm8s1ceuBUnMUAeoAHHw,36,22,17,14,13,0,6,1,73,10.428571428571429,2,0.0,3,17,13,13,19,0,1,6,1,46,27,1
9409,160998,NDPKqXKOmpAXA3c3gsKRZCfXFZLtbtM8,A3fsA9Zfv1X2fVEQhTw51lKENdNrEqT3,6,2,1,0,1,0,4,0,8,1.1428571428571428,2,0.0,0,1,0,1,2,0,0,4,0,2,6,1
9410,161027,CetRT5zy2dJHyaPU2zMnW0reXnT8Dv2y,bWdj2GDclj5ofokWjzoa5jAwMkxCykd6,10,17,9,0,4,0,9,1,40,5.714285714285714,1,0.0,0,9,0,4,17,0,0,9,1,13,27,0
9411,161032,IFE6qWbdZl6uYZhohe6KYJqe5ZPXYuuR,SpATywNh6bZuzm8s1ceuBUnMUAeoAHHw,5,2,1,0,1,0,2,0,6,0.8571428571428571,1,0.0,0,1,0,1,2,0,0,2,0,2,4,1
9412,161034,Am4KYOUcnhkB8aqlcwil5l2ZNhMiS2yt,SpATywNh6bZuzm8s1ceuBUnMUAeoAHHw,5,4,3,0,3,0,3,0,13,1.8571428571428572,2,0.0,0,3,0,3,4,0,0,3,0,6,7,1
9413,161044,MvxZ4LrwMNK4bX2id6mJDwMa1OsD3cXN,SpATywNh6bZuzm8s1ceuBUnMUAeoAHHw,2,0,0,0,0,0,2,0,2,0.2857142857142857,1,0.0,0,0,0,0,0,0,0,2,0,0,2,0
9414,161076,BbvGM92sGSMMIrRMXDFdD1GEnySzXRYT,A3fsA9Zfv1X2fVEQhTw51lKENdNrEqT3,5,7,2,0,1,0,2,0,12,1.7142857142857142,2,0.0,0,2,0,1,7,0,0,2,0,3,9,0
9415,161079,JDFQZtkjaBhYZM0MLFNIDJC3MmDM3j4N,SpATywNh6bZuzm8s1ceuBUnMUAeoAHHw,9,5,3,0,3,0,2,0,13,1.8571428571428572,1,0.0,1,3,0,3,4,0,0,2,0,7,6,0
9416,161105,LqKnbXKS585SEKpwP1WxJYJOgqsH3tlg,SpATywNh6bZuzm8s1ceuBUnMUAeoAHHw,6,2,1,0,1,0,3,0,7,1.0,1,0.0,0,1,0,1,2,0,0,3,0,2,5,1
9417,161117,UAE7k3whY8BUnHHgiIeFo6Rzc8eEYhRN,bWdj2GDclj5ofokWjzoa5jAwMkxCykd6,1,0,0,0,0,0,1,0,1,0.14285714285714285,1,0.0,0,0,0,0,0,0,0,1,0,0,1,1
9418,161140,194jqOV6jnj4prH3N2CqRtpc9qi9vfln,bWdj2GDclj5ofokWjzoa5jAwMkxCykd6,8,7,1,0,2,1,9,1,21,3.0,1,0.0,2,1,0,2,5,1,0,9,1,5,16,1
9419,161162,OsVH6GaCH0fFhbcpJ8VTZdDPBSjPAjjC,bWdj2GDclj5ofokWjzoa5jAwMkxCykd6,5,2,1,0,1,0,2,0,6,0.8571428571428571,1,0.0,0,1,0,1,2,0,0,2,0,2,4,1
9420,161163,uDnJLAi73zveRN4zlXZiPfuCVzPc0SnS,SpATywNh6bZuzm8s1ceuBUnMUAeoAHHw,16,15,10,0,5,8,14,7,59,8.428571428571429,1,0.0,0,10,0,5,15,8,0,14,7,15,44,0
9421,161167,zwULmFeRowgNxt1Wa0GovPX5gRTGXecE,SpATywNh6bZuzm8s1ceuBUnMUAeoAHHw,5,2,1,0,1,0,2,0,6,0.8571428571428571,1,0.0,0,1,0,1,2,0,0,2,0,2,4,0
9422,161176,iFmthN4O8PvK0KN8KGxvlHIavkzlrfwZ,5X6FeZozNMgE2VRi3MJYjkkFK8SETtu2,1,0,0,0,0,0,1,0,1,0.14285714285714285,1,0.0,0,0,0,0,0,0,0,1,0,0,1,1
9423,161178,7xpmz6LF4dl35fFKZgRU70OZyF8UO4PL,5X6FeZozNMgE2VRi3MJYjkkFK8SETtu2,8,7,3,0,2,0,2,0,14,2.0,1,0.0,0,3,0,2,7,0,0,2,0,5,9,1
9424,161186,5BE6mWnwPv7tHKPQBwq1Lu0ezQBICw4i,SpATywNh6bZuzm8s1ceuBUnMUAeoAHHw,6,9,6,0,0,0,4,0,19,2.7142857142857144,2,0.0,0,6,0,0,9,0,0,4,0,6,13,1
9425,161193,FKqGzWb3VsmU7jpYPJbCVaVAzRrOMrbY,A3fsA9Zfv1X2fVEQhTw51lKENdNrEqT3,5,2,1,0,1,0,2,0,6,0.8571428571428571,1,0.0,0,1,0,1,2,0,0,2,0,2,4,1
9426,161197,coZTr10eytnE55me2AxqRWq6qrVXEB7M,5X6FeZozNMgE2VRi3MJYjkkFK8SETtu2,23,39,21,18,20,0,7,0,105,15.0,3,0.0,13,21,17,20,26,0,1,7,0,71,34,1
9427,161202,Bz9DFXP5IfsdY1GquZ326aHTKHeY7tPX,A3fsA9Zfv1X2fVEQhTw51lKENdNrEqT3,7,3,1,0,1,1,4,1,11,1.5714285714285714,1,0.0,0,1,0,1,3,1,0,4,1,2,9,1
9428,161210,fkUbRiFpn0phnbHLf3l8N7hPSHaKlqPT,SpATywNh6bZuzm8s1ceuBUnMUAeoAHHw,1,0,0,0,0,0,1,0,1,0.14285714285714285,1,0.0,0,0,0,0,0,0,0,1,0,0,1,0
9429,161214,RPO64II9N8Vv1clUea5ir9miWSludB2S,SpATywNh6bZuzm8s1ceuBUnMUAeoAHHw,10,7,2,12,0,5,4,0,30,4.285714285714286,1,0.0,2,2,10,0,5,5,2,4,0,14,16,0
9430,161228,vlXDkJyZcNlW4DjqMuBZT0NEzx7fdVMZ,SpATywNh6bZuzm8s1ceuBUnMUAeoAHHw,7,5,0,0,0,0,4,0,9,1.2857142857142858,1,0.0,0,0,0,0,5,0,0,4,0,0,9,1
9431,161233,AiZBCpHbXnyOWKg8HynBZIF9HQ0QhVjR,SpATywNh6bZuzm8s1ceuBUnMUAeoAHHw,6,1,1,0,1,0,3,0,6,0.8571428571428571,1,0.0,0,1,0,1,1,0,0,3,0,2,4,1
9432,161235,9OJ5A7uGdzNYawJUDofemHIUlKea4Sz4,bWdj2GDclj5ofokWjzoa5jAwMkxCykd6,1,0,0,0,0,0,1,0,1,0.14285714285714285,1,0.0,0,0,0,0,0,0,0,1,0,0,1,1
9433,161241,ClKwabqP8QQ4V4BPHK5zBEKrYzP6TxXZ,SpATywNh6bZuzm8s1ceuBUnMUAeoAHHw,1,0,0,0,0,0,1,0,1,0.14285714285714285,1,0.0,0,0,0,0,0,0,0,1,0,0,1,1
9434,161246,B5jlZpEDxUNGCe4UQsaYbJ99Z8y5d2lN,A3fsA9Zfv1X2fVEQhTw51lKENdNrEqT3,30,17,14,0,12,0,6,0,49,7.0,2,0.0,0,14,0,12,17,0,0,6,0,26,23,0
9435,161251,d8nG3CRjdRKOgHNCQ97Y2ebOYVCkXw4D,bWdj2GDclj5ofokWjzoa5jAwMkxCykd6,1,0,0,0,0,0,1,0,1,0.14285714285714285,1,0.0,0,0,0,0,0,0,0,1,0,0,1,1
9436,161252,cjIjalOkynRvNiMkIirdnL3eRD5dBGGC,A3fsA9Zfv1X2fVEQhTw51lKENdNrEqT3,5,2,1,0,1,0,3,0,7,1.0,1,0.0,0,1,0,1,2,0,0,3,0,2,5,1
9437,161272,Azsuwdl5atG1kex3bL6Sp3cE2kQP65dh,5X6FeZozNMgE2VRi3MJYjkkFK8SETtu2,2,0,0,0,0,0,2,0,2,0.2857142857142857,1,0.0,0,0,0,0,0,0,0,2,0,0,2,1
9438,161273,vuVnTFCBfdzSvUffWnstx1XETLzOHwWp,SpATywNh6bZuzm8s1ceuBUnMUAeoAHHw,34,37,27,33,16,1,4,0,118,16.857142857142858,1,0.0,7,27,30,16,30,1,3,4,0,80,38,0
9439,161286,ZfEmNtZnnnOMQU2ZxafVmay1LudDsU5A,A3fsA9Zfv1X2fVEQhTw51lKENdNrEqT3,6,5,0,0,0,0,1,0,6,0.8571428571428571,1,0.0,0,0,0,0,5,0,0,1,0,0,6,1
9440,161302,UwPa8KNwh7Sk253EeLtMmDO2eQSxh5Ah,5X6FeZozNMgE2VRi3MJYjkkFK8SETtu2,3,0,0,0,0,0,3,0,3,0.42857142857142855,1,0.0,0,0,0,0,0,0,0,3,0,0,3,1
9441,161309,c45tGE4X33f1wuWJww6KL4YDWdrZudFS,SpATywNh6bZuzm8s1ceuBUnMUAeoAHHw,1,0,0,0,0,0,1,0,1,0.14285714285714285,1,0.0,0,0,0,0,0,0,0,1,0,0,1,1
9442,161315,cT4LJPe0XxOcIidQWBVnNsALPzrk3WFu,A3fsA9Zfv1X2fVEQhTw51lKENdNrEqT3,2,0,0,0,0,0,4,0,4,0.5714285714285714,1,0.0,0,0,0,0,0,0,0,4,0,0,4,1
9443,161320,ic5l4x1XKbzNP4iiyqvz1kk9aIQYNWYg,SpATywNh6bZuzm8s1ceuBUnMUAeoAHHw,15,16,5,24,0,0,3,0,48,6.857142857142857,1,0.0,7,5,24,0,9,0,0,3,0,36,12,1
9444,161329,GDHvw72iSHIz6VwsSteleP4praXBxk8h,A3fsA9Zfv1X2fVEQhTw51lKENdNrEqT3,1,0,0,0,0,0,2,0,2,0.2857142857142857,1,0.0,0,0,0,0,0,0,0,2,0,0,2,1
9445,161334,5dwhOYeq6DRSGIBZohMlMunxrKsjka7v,bWdj2GDclj5ofokWjzoa5jAwMkxCykd6,5,10,7,0,5,1,2,0,25,3.5714285714285716,1,0.0,0,7,0,5,10,1,0,2,0,12,13,1
9446,161340,r2fvnP5HQ65QQyLJ7ftCWFPVDeKlz5Bf,SpATywNh6bZuzm8s1ceuBUnMUAeoAHHw,19,25,6,13,4,2,6,3,59,8.428571428571429,1,0.0,8,6,10,4,17,2,3,6,3,28,31,1
9447,161344,qVXQ5twJYvpmkyoNBZEpQT0hJrzlvtzo,A3fsA9Zfv1X2fVEQhTw51lKENdNrEqT3,6,5,2,0,1,0,5,0,13,1.8571428571428572,1,0.0,0,2,0,1,5,0,0,5,0,3,10,1
9448,161354,8mGbGwW0kqMWmEPWmvTNX7d3rQGPeEB8,SpATywNh6bZuzm8s1ceuBUnMUAeoAHHw,30,28,14,6,12,0,1,0,61,8.714285714285714,1,0.0,0,14,5,12,28,0,1,1,0,31,30,0
9449,161357,rNE6Mu311rQY458X8XtgRw0hCP6H0U1S,bWdj2GDclj5ofokWjzoa5jAwMkxCykd6,5,3,1,0,1,0,2,0,7,1.0,1,0.0,0,1,0,1,3,0,0,2,0,2,5,1
9450,161363,XtB8OQxKTJMzAyetXDHpSCOE9CGXWhJc,SpATywNh6bZuzm8s1ceuBUnMUAeoAHHw,5,2,0,0,0,1,5,0,8,1.1428571428571428,1,0.0,0,0,0,0,2,1,0,5,0,0,8,1
9451,161367,vkVcAL32x89gCUbijn0COpSie0zSVcTg,bWdj2GDclj5ofokWjzoa5jAwMkxCykd6,3,0,0,0,0,0,3,0,3,0.42857142857142855,1,0.0,0,0,0,0,0,0,0,3,0,0,3,0
9452,161376,KV34bsRuo2sXW3PLX4hZvmgrR9GRM7T6,5X6FeZozNMgE2VRi3MJYjkkFK8SETtu2,5,2,1,0,1,0,3,0,7,1.0,1,0.0,0,1,0,1,2,0,0,3,0,2,5,1
9453,161386,adfbW7xBPY784GRXAIq3fInFogIbD6ro,SpATywNh6bZuzm8s1ceuBUnMUAeoAHHw,24,33,19,13,0,0,4,0,69,9.857142857142858,2,0.0,4,19,12,0,29,0,1,4,0,35,34,0
9454,161387,eiRHLVhBf0olv6rTPAoGgaOAwfeRlIDL,SpATywNh6bZuzm8s1ceuBUnMUAeoAHHw,1,0,0,0,0,0,1,0,1,0.14285714285714285,1,0.0,0,0,0,0,0,0,0,1,0,0,1,1
9455,161390,NMciPbdIeB9uIZwCMcw6mXU2i3BtnB5v,A3fsA9Zfv1X2fVEQhTw51lKENdNrEqT3,12,6,5,0,5,0,1,0,17,2.4285714285714284,1,0.0,0,5,0,5,6,0,0,1,0,10,7,1
9456,161398,unkieT2T5FX60wyYAIsaTG56kPfWLfWp,SpATywNh6bZuzm8s1ceuBUnMUAeoAHHw,4,2,1,0,1,0,1,0,5,0.7142857142857143,1,0.0,0,1,0,1,2,0,0,1,0,2,3,0
9457,161414,uqHSgHtPqI0pLXHTpUBns1eF4e9jsvt1,SpATywNh6bZuzm8s1ceuBUnMUAeoAHHw,5,2,1,0,1,0,5,0,9,1.2857142857142858,1,0.0,0,1,0,1,2,0,0,5,0,2,7,1
9458,161417,Oxmoejo3hSWTZiTWOnJwuUCK8VDHRfg9,A3fsA9Zfv1X2fVEQhTw51lKENdNrEqT3,2,0,0,0,0,0,2,0,2,0.2857142857142857,1,0.0,0,0,0,0,0,0,0,2,0,0,2,1
9459,161421,WP2ym6laNmJWuc1dFKEHBcyv5Oxzzjqp,A3fsA9Zfv1X2fVEQhTw51lKENdNrEqT3,8,4,2,0,2,0,4,0,12,1.7142857142857142,1,0.0,0,2,0,2,4,0,0,4,0,4,8,1
9460,161422,xIo4n5tt7YUC0wGdrIg4QgxF1OMrY5DB,SpATywNh6bZuzm8s1ceuBUnMUAeoAHHw,7,3,2,0,2,0,2,0,9,1.2857142857142858,1,0.0,0,2,0,2,3,0,0,2,0,4,5,1
9461,161427,YwMASqqYJxzRjuKe9JI9rWFNQbTS5tSD,5X6FeZozNMgE2VRi3MJYjkkFK8SETtu2,2,0,0,0,0,0,2,0,2,0.2857142857142857,1,0.0,0,0,0,0,0,0,0,2,0,0,2,1
9462,161429,YwMASqqYJxzRjuKe9JI9rWFNQbTS5tSD,A3fsA9Zfv1X2fVEQhTw51lKENdNrEqT3,4,2,1,0,0,0,5,0,8,1.1428571428571428,1,0.0,0,1,0,0,2,0,0,5,0,1,7,1
9463,161432,7Y5C8uyNuEClb8hOu715XyJadaHTCp61,SpATywNh6bZuzm8s1ceuBUnMUAeoAHHw,10,10,0,0,0,2,6,2,20,2.857142857142857,1,0.0,0,0,0,0,10,2,0,6,2,0,20,1
9464,161443,CfUHqy5TfjBtRxjNztsGxyFua9jISd0Q,SpATywNh6bZuzm8s1ceuBUnMUAeoAHHw,1,0,0,0,0,0,1,0,1,0.14285714285714285,1,0.0,0,0,0,0,0,0,0,1,0,0,1,0
9465,161447,zx7r7me6FiVbbABDOlQkLj20mb4SMp5e,bWdj2GDclj5ofokWjzoa5jAwMkxCykd6,7,2,1,0,1,0,4,0,8,1.1428571428571428,1,0.0,0,1,0,1,2,0,0,4,0,2,6,1
9466,161465,QwzgqwSHCQGBlqpFzwe8sYcM8CZG7iZ9,SpATywNh6bZuzm8s1ceuBUnMUAeoAHHw,4,9,1,0,0,0,2,0,12,1.7142857142857142,2,0.0,0,1,0,0,9,0,0,2,0,1,11,1
9467,161482,yBMHADlfH84svjxYAPJHefy94rOxozvf,A3fsA9Zfv1X2fVEQhTw51lKENdNrEqT3,6,3,2,0,1,0,2,0,8,1.1428571428571428,1,0.0,0,2,0,1,3,0,0,2,0,3,5,1
9468,161496,FakJ1HnIHb157ubEfS1cl0AV2JD4N08k,SpATywNh6bZuzm8s1ceuBUnMUAeoAHHw,15,17,5,10,3,0,3,0,38,5.428571428571429,1,0.0,2,5,9,3,15,0,1,3,0,19,19,0
9469,161501,ztlNh3618sIHrGoj9bVbBw9E0ZrHkNpd,bWdj2GDclj5ofokWjzoa5jAwMkxCykd6,1,0,0,0,0,0,1,0,1,0.14285714285714285,1,0.0,0,0,0,0,0,0,0,1,0,0,1,1
9470,161505,IGWRz8xQdPwjKqBNKTjONoXgcj0XdulM,A3fsA9Zfv1X2fVEQhTw51lKENdNrEqT3,7,2,1,0,1,0,8,0,12,1.7142857142857142,3,0.0,1,1,0,1,1,0,0,8,0,3,9,0
9471,161528,4TaJuNI7ILCokDHtRq2KU7kBpdPPodLL,SpATywNh6bZuzm8s1ceuBUnMUAeoAHHw,5,2,1,0,1,0,2,0,6,0.8571428571428571,1,0.0,0,1,0,1,2,0,0,2,0,2,4,0
9472,161539,rEX169KR1uPOXxOd63dC71tgeR3NoRN8,SpATywNh6bZuzm8s1ceuBUnMUAeoAHHw,1,0,0,0,0,0,1,0,1,0.14285714285714285,1,0.0,0,0,0,0,0,0,0,1,0,0,1,1
9473,161551,j6udTPKi1ZJjvturgRQnFv50v6HTvf83,bWdj2GDclj5ofokWjzoa5jAwMkxCykd6,1,0,0,0,0,0,1,0,1,0.14285714285714285,1,0.0,0,0,0,0,0,0,0,1,0,0,1,1
9474,161555,tPgSJ4wzFz4lJ86dWZJQnEehGB8O0lXp,SpATywNh6bZuzm8s1ceuBUnMUAeoAHHw,6,5,2,0,0,0,3,0,10,1.4285714285714286,1,0.0,2,2,0,0,3,0,0,3,0,4,6,1
9475,161556,xFJ4FqhPrDZtiK7YNN9cG7wcwWnghLn1,bWdj2GDclj5ofokWjzoa5jAwMkxCykd6,1,0,0,0,0,0,1,0,1,0.14285714285714285,1,0.0,0,0,0,0,0,0,0,1,0,0,1,1
9476,161574,N70KXoq5ZzjUfXX93vdYF9bSRDAdFuPe,SpATywNh6bZuzm8s1ceuBUnMUAeoAHHw,2,0,0,0,0,0,4,0,4,0.5714285714285714,1,0.0,0,0,0,0,0,0,0,4,0,0,4,0
9477,161591,Khe9KlmSoSTsax6cgkl9d8UgiAE6YdMj,A3fsA9Zfv1X2fVEQhTw51lKENdNrEqT3,8,6,3,0,1,0,4,0,14,2.0,1,0.0,1,3,0,1,5,0,0,4,0,5,9,1
9478,161600,oz6Hu9tzPP7XCtmtbbzc5Jfq0UCKNXl3,SpATywNh6bZuzm8s1ceuBUnMUAeoAHHw,5,2,1,0,1,0,2,0,6,0.8571428571428571,1,0.0,0,1,0,1,2,0,0,2,0,2,4,1
9479,161634,rm52Ts2OWqvT4Vv3xYPH49SI4hdPJFK7,A3fsA9Zfv1X2fVEQhTw51lKENdNrEqT3,8,9,4,0,2,0,2,0,17,2.4285714285714284,1,0.0,0,4,0,2,9,0,0,2,0,6,11,0
9480,161635,LWWGMAVHUf3PF6BlKef9Rc6itscQOf6h,SpATywNh6bZuzm8s1ceuBUnMUAeoAHHw,2,0,0,0,0,0,2,0,2,0.2857142857142857,1,0.0,0,0,0,0,0,0,0,2,0,0,2,0
9481,161636,4Uch8gV3zXJTiJlx4pumO9oYPkK7ZxIn,SpATywNh6bZuzm8s1ceuBUnMUAeoAHHw,10,12,1,0,1,0,1,0,15,2.142857142857143,1,0.0,0,1,0,1,12,0,0,1,0,2,13,0
9482,161638,gYbj41sQR2TGb4wIl3ifG5wEnRLxOAau,SpATywNh6bZuzm8s1ceuBUnMUAeoAHHw,2,0,0,0,0,0,2,0,2,0.2857142857142857,1,0.0,0,0,0,0,0,0,0,2,0,0,2,1
9483,161639,QZoi4xpkEVVH2rbYL53oYFfYungIuUup,5X6FeZozNMgE2VRi3MJYjkkFK8SETtu2,1,0,0,0,0,0,1,0,1,0.14285714285714285,1,0.0,0,0,0,0,0,0,0,1,0,0,1,1
9484,161653,oSXN7qCh7a4VZeybHFMwMNkk4Bbemi4m,A3fsA9Zfv1X2fVEQhTw51lKENdNrEqT3,8,2,1,0,1,0,6,1,11,1.5714285714285714,1,0.0,0,1,0,1,2,0,0,6,1,2,9,1
9485,161659,MjdRbWesvhmbtKRkEDgkVTz7Gw1rgmgQ,SpATywNh6bZuzm8s1ceuBUnMUAeoAHHw,31,28,11,26,9,0,3,0,77,11.0,1,0.0,5,11,24,9,23,0,2,3,0,49,28,0
9486,161669,ww05exVvqmTpHRLpMlcyyiyf25IJQarF,SpATywNh6bZuzm8s1ceuBUnMUAeoAHHw,1,0,0,0,0,0,1,0,1,0.14285714285714285,1,0.0,0,0,0,0,0,0,0,1,0,0,1,1
9487,161693,5UJZmEar1AX3gQXOzkh3MnQcYdErI17M,A3fsA9Zfv1X2fVEQhTw51lKENdNrEqT3,4,2,1,0,1,0,1,0,5,0.7142857142857143,1,0.0,0,1,0,1,2,0,0,1,0,2,3,1
9488,161712,t6oiAnEEEikYJIMTq7MRNsGJSWW6NrOH,5X6FeZozNMgE2VRi3MJYjkkFK8SETtu2,5,1,1,0,1,0,3,0,6,0.8571428571428571,1,0.0,0,1,0,1,1,0,0,3,0,2,4,1
9489,161786,eP5N1v22IPemudSlwCB0Ny9hISuL6JNI,A3fsA9Zfv1X2fVEQhTw51lKENdNrEqT3,5,3,1,0,0,0,5,0,9,1.2857142857142858,1,0.0,0,1,0,0,3,0,0,5,0,1,8,0
9490,161788,gygDS63yTosGUEHtiJyQxAu1JinA0G6n,5X6FeZozNMgE2VRi3MJYjkkFK8SETtu2,5,3,1,0,1,0,4,0,9,1.2857142857142858,1,0.0,0,1,0,1,3,0,0,4,0,2,7,1
9491,161790,yGPmCGGKSj19cj9m7eHc6GAPG84cOL7F,A3fsA9Zfv1X2fVEQhTw51lKENdNrEqT3,8,4,3,0,2,0,2,0,11,1.5714285714285714,2,0.0,0,3,0,2,4,0,0,2,0,5,6,1
9492,161797,iLSmgijjawkZ4gpTay6CThOQq0O9r9QD,A3fsA9Zfv1X2fVEQhTw51lKENdNrEqT3,6,3,2,0,2,0,1,0,8,1.1428571428571428,1,0.0,0,2,0,2,3,0,0,1,0,4,4,1
9493,161799,c4jAIERCX1qBZDNXx6SmHB55hKphsx81,A3fsA9Zfv1X2fVEQhTw51lKENdNrEqT3,103,17,8,272,2,0,2,0,301,43.0,1,0.0,5,8,271,2,12,0,1,2,0,286,15,1
9494,161833,CNf41AhEnfCudvGgCmj1b21pvkGa3fVj,A3fsA9Zfv1X2fVEQhTw51lKENdNrEqT3,1,0,0,0,0,0,2,0,2,0.2857142857142857,1,0.0,0,0,0,0,0,0,0,2,0,0,2,1
9495,161850,VeFENcSXAiXgJQaSjlXiodtIBxgSrzaH,5X6FeZozNMgE2VRi3MJYjkkFK8SETtu2,5,2,1,0,1,0,2,0,6,0.8571428571428571,1,0.0,0,1,0,1,2,0,0,2,0,2,4,0
9496,161865,ZFgJH3XPKn6EjDuXV9VLOpKftzENCqEZ,A3fsA9Zfv1X2fVEQhTw51lKENdNrEqT3,1,0,0,0,0,0,1,0,1,0.14285714285714285,1,0.0,0,0,0,0,0,0,0,1,0,0,1,0
9497,161962,wuCb3DAs0UTa3nnL6gSfoBgjTkpbfyNt,A3fsA9Zfv1X2fVEQhTw51lKENdNrEqT3,1,0,0,0,0,0,1,0,1,0.14285714285714285,1,0.0,0,0,0,0,0,0,0,1,0,0,1,0
9498,161991,okqN4nBVKRYYrkYonKicKGOmPqVGYjZh,A3fsA9Zfv1X2fVEQhTw51lKENdNrEqT3,10,25,12,0,0,0,10,0,47,6.714285714285714,1,0.0,0,12,0,0,25,0,0,10,0,12,35,0
9499,162040,ljX4THfec0iaVpl2l8F599zDiKVqZpK6,A3fsA9Zfv1X2fVEQhTw51lKENdNrEqT3,2,0,0,0,0,0,4,0,4,0.5714285714285714,1,0.0,0,0,0,0,0,0,0,4,0,0,4,1
9500,162080,FsMHOscTVODbpYdAffAhuuXsQ63LCkVz,5X6FeZozNMgE2VRi3MJYjkkFK8SETtu2,7,5,1,4,2,0,2,0,14,2.0,1,0.0,2,1,3,2,3,0,1,2,0,8,6,1
9501,162117,oBhK6ZD6VFllj6i4Noya3bCJzaI8iNet,A3fsA9Zfv1X2fVEQhTw51lKENdNrEqT3,1,0,0,0,0,0,1,0,1,0.14285714285714285,1,0.0,0,0,0,0,0,0,0,1,0,0,1,1
9502,162124,pSzhuUpWpfZJPijy3Bgn04mmCNcKuKcZ,A3fsA9Zfv1X2fVEQhTw51lKENdNrEqT3,2,0,0,0,0,0,2,0,2,0.2857142857142857,1,0.0,0,0,0,0,0,0,0,2,0,0,2,0
9503,162133,d2uTyoX8GsJTijOZ2YwLrQ9V4yvysuAD,A3fsA9Zfv1X2fVEQhTw51lKENdNrEqT3,1,0,0,0,0,0,1,0,1,0.14285714285714285,1,0.0,0,0,0,0,0,0,0,1,0,0,1,1
9504,162142,LY9nTJ3l87DIdhCcp8BvVsM9WvKuQkhN,A3fsA9Zfv1X2fVEQhTw51lKENdNrEqT3,1,0,0,0,0,0,1,0,1,0.14285714285714285,1,0.0,0,0,0,0,0,0,0,1,0,0,1,1
9505,162144,3vT4zJ39DstZlKPcmpcZTRrY5vbUxYe0,5X6FeZozNMgE2VRi3MJYjkkFK8SETtu2,27,26,6,23,17,0,4,0,76,10.857142857142858,1,0.0,19,6,18,17,7,0,5,4,0,60,16,1
9506,162150,bqpZwouZwQ5xHmLGiTtvVWcQOPxhka8z,A3fsA9Zfv1X2fVEQhTw51lKENdNrEqT3,1,0,0,0,0,0,1,0,1,0.14285714285714285,1,0.0,0,0,0,0,0,0,0,1,0,0,1,1
9507,162168,o69BaNn8nNwkn0WRwXTNaYgGrUvOyxv9,A3fsA9Zfv1X2fVEQhTw51lKENdNrEqT3,5,2,1,0,1,0,2,0,6,0.8571428571428571,1,0.0,0,1,0,1,2,0,0,2,0,2,4,1
9508,162190,t6ztTYDVbVNMRBeH7Gb2WlLivAtzAzp1,A3fsA9Zfv1X2fVEQhTw51lKENdNrEqT3,1,0,0,0,0,0,2,0,2,0.2857142857142857,1,0.0,0,0,0,0,0,0,0,2,0,0,2,1
9509,162193,4RiemE5r88jWq9gaL0lVYzjeUhWq3sNP,5X6FeZozNMgE2VRi3MJYjkkFK8SETtu2,1,0,0,0,0,0,1,0,1,0.14285714285714285,1,0.0,0,0,0,0,0,0,0,1,0,0,1,1
9510,162228,9FHojamNYxBNrQ6PYQ6fNVNJw4Al6wFf,A3fsA9Zfv1X2fVEQhTw51lKENdNrEqT3,2,0,0,0,0,0,2,0,2,0.2857142857142857,1,0.0,0,0,0,0,0,0,0,2,0,0,2,1
9511,162230,jimulXvpj9ggyKpMhPHOONMmf8Jnmqkr,A3fsA9Zfv1X2fVEQhTw51lKENdNrEqT3,1,0,0,0,0,0,1,0,1,0.14285714285714285,1,0.0,0,0,0,0,0,0,0,1,0,0,1,1
9512,162272,CXpq1UcG0elhHuiCZeD2FXcwR7rCcPqM,A3fsA9Zfv1X2fVEQhTw51lKENdNrEqT3,1,0,0,0,0,0,3,0,3,0.42857142857142855,1,0.0,0,0,0,0,0,0,0,3,0,0,3,1
9513,162277,0D6hqHK4bxIFi4VUAoCI5xw3MhWFUe8Q,A3fsA9Zfv1X2fVEQhTw51lKENdNrEqT3,4,2,0,0,0,0,2,0,4,0.5714285714285714,2,0.0,0,0,0,0,2,0,0,2,0,0,4,1
9514,162296,y9BxmAhm0ieCF6b0HaF7gMrGu5BDtZs5,A3fsA9Zfv1X2fVEQhTw51lKENdNrEqT3,5,3,1,0,1,0,2,0,7,1.0,1,0.0,0,1,0,1,3,0,0,2,0,2,5,1
9515,162311,gmqCuQTX0aljJXYwlMbQKWVNQXzJBU7z,A3fsA9Zfv1X2fVEQhTw51lKENdNrEqT3,2,0,0,0,0,0,2,0,2,0.2857142857142857,1,0.0,0,0,0,0,0,0,0,2,0,0,2,1
9516,162337,0nFyUZaDVH1PSi5FtCjV36vvFavCp4ho,A3fsA9Zfv1X2fVEQhTw51lKENdNrEqT3,13,7,6,2,5,0,2,0,22,3.142857142857143,1,0.0,0,6,2,5,7,0,0,2,0,13,9,0
9517,162339,vr7UNhViMDdJF7B4rxUsG86xKgSPETfh,A3fsA9Zfv1X2fVEQhTw51lKENdNrEqT3,2,0,0,0,0,0,4,0,4,0.5714285714285714,1,0.0,0,0,0,0,0,0,0,4,0,0,4,0
9518,162369,1YVvREjW4GG7vGtDdZTgfavzuWoJyEQ1,5X6FeZozNMgE2VRi3MJYjkkFK8SETtu2,1,0,0,0,0,0,1,0,1,0.14285714285714285,1,0.0,0,0,0,0,0,0,0,1,0,0,1,1
9519,162378,uOV3GBCPhULZPBZnCwKgG0YBOJnOfVml,3VkHkmOtom3jM2wCu94xgzzu1d6Dn7or,7,3,2,0,2,0,2,0,9,1.2857142857142858,1,0.0,0,2,0,2,3,0,0,2,0,4,5,1
9520,162385,SgKrhpJALurepOABWGyRDMg2VKaiEXGw,3VkHkmOtom3jM2wCu94xgzzu1d6Dn7or,1,0,0,0,0,0,2,0,2,0.2857142857142857,1,0.0,0,0,0,0,0,0,0,2,0,0,2,1
9521,162387,u6UCPJeMEh5WJztDUwvAuENbXAf4tGi5,3VkHkmOtom3jM2wCu94xgzzu1d6Dn7or,5,2,1,0,1,0,2,0,6,0.8571428571428571,1,0.0,0,1,0,1,2,0,0,2,0,2,4,1
9522,162410,diOjRyJTE5fcnt28dWvk5tAqd4L0ApRl,3VkHkmOtom3jM2wCu94xgzzu1d6Dn7or,1,0,0,0,0,0,1,0,1,0.14285714285714285,1,0.0,0,0,0,0,0,0,0,1,0,0,1,1
9523,162429,CanH85coLijOUn4q3pdFOsHu83jlCEIK,3VkHkmOtom3jM2wCu94xgzzu1d6Dn7or,5,2,1,0,1,0,2,0,6,0.8571428571428571,1,0.0,0,1,0,1,2,0,0,2,0,2,4,1
9524,162434,xd0lwkEB3jsQMwhsGMBi7U480TqLt7kG,3VkHkmOtom3jM2wCu94xgzzu1d6Dn7or,3,0,0,0,0,0,3,1,4,0.5714285714285714,1,0.0,0,0,0,0,0,0,0,3,1,0,4,1
9525,162448,2i6mfSeYIJuVvHSJlIbgdshMI8YRpVao,3VkHkmOtom3jM2wCu94xgzzu1d6Dn7or,2,0,0,0,0,0,3,0,3,0.42857142857142855,1,0.0,0,0,0,0,0,0,0,3,0,0,3,1
9526,162465,4wXrBdzSw8jxJgXxPDlRDHjWz9op89qK,3VkHkmOtom3jM2wCu94xgzzu1d6Dn7or,1,0,0,0,0,0,1,0,1,0.14285714285714285,1,0.0,0,0,0,0,0,0,0,1,0,0,1,1
9527,162470,sEjCSxiV4U3FouTICvcD4zFUuMByUanv,3VkHkmOtom3jM2wCu94xgzzu1d6Dn7or,1,0,0,0,0,0,1,0,1,0.14285714285714285,1,0.0,0,0,0,0,0,0,0,1,0,0,1,1
9528,162477,WGacPM6qZFCWGlZ0G4KuqZ9fCoWNwA7p,3VkHkmOtom3jM2wCu94xgzzu1d6Dn7or,8,6,1,0,2,1,5,1,16,2.2857142857142856,1,0.0,1,1,0,2,5,1,0,5,1,4,12,1
9529,162501,fFPhCaxB3mxzV0UdDbvnXIgDUrhjU2Bc,3VkHkmOtom3jM2wCu94xgzzu1d6Dn7or,6,7,1,0,1,0,4,0,13,1.8571428571428572,2,0.0,2,1,0,1,5,0,0,4,0,4,9,1
9530,162509,pB0FiLfIyBa7HD5W1vjx0uRVNEM62PCY,3VkHkmOtom3jM2wCu94xgzzu1d6Dn7or,5,6,1,0,2,3,3,0,15,2.142857142857143,2,0.0,1,1,0,2,5,3,0,3,0,4,11,1
9531,162518,iRO6vDma14A8G1ldmHvBCjBm026HQCox,3VkHkmOtom3jM2wCu94xgzzu1d6Dn7or,5,9,3,0,1,0,1,0,14,2.0,1,0.0,0,3,0,1,9,0,0,1,0,4,10,1
9532,162529,zzh7OhB1yuFx7KNMW6cKx1t3e2ezVcvZ,3VkHkmOtom3jM2wCu94xgzzu1d6Dn7or,7,11,0,0,3,0,4,0,18,2.5714285714285716,1,0.0,0,0,0,3,11,0,0,4,0,3,15,1
9533,162531,Aw00VvkW9rmqasUs0q7ZSvy1Gg7Z6ebd,3VkHkmOtom3jM2wCu94xgzzu1d6Dn7or,1,0,0,0,0,0,1,0,1,0.14285714285714285,1,0.0,0,0,0,0,0,0,0,1,0,0,1,1
9534,162553,2Y3h62Lps0fU6B3C4MXM4YNVNDf25XBr,3VkHkmOtom3jM2wCu94xgzzu1d6Dn7or,1,0,0,0,0,0,1,0,1,0.14285714285714285,1,0.0,0,0,0,0,0,0,0,1,0,0,1,1
9535,162554,ci2ik5flSMTiMTZcnxXAKT9yXYBEPMmU,3VkHkmOtom3jM2wCu94xgzzu1d6Dn7or,2,0,0,0,0,0,2,0,2,0.2857142857142857,1,0.0,0,0,0,0,0,0,0,2,0,0,2,1
9536,162600,qOyslTiakZd1Jt0NRefFu3YFDZVo5cgp,3VkHkmOtom3jM2wCu94xgzzu1d6Dn7or,1,0,0,0,0,0,1,0,1,0.14285714285714285,1,0.0,0,0,0,0,0,0,0,1,0,0,1,1
9537,162611,JQU9lWLQJmOjD6zJfnfdXPo0FGrEYCG2,3VkHkmOtom3jM2wCu94xgzzu1d6Dn7or,8,2,1,0,1,4,8,2,18,2.5714285714285716,1,0.0,0,1,0,1,2,4,0,8,2,2,16,1
9538,162626,ZEwv3NBFks1XktlhlOtqVFJ0Zf9N8CgP,3VkHkmOtom3jM2wCu94xgzzu1d6Dn7or,1,0,0,0,0,0,1,0,1,0.14285714285714285,1,0.0,0,0,0,0,0,0,0,1,0,0,1,1
9539,162647,bKnFyTIy0p7ANwTaSX7Db0o0G6jk2VUf,3VkHkmOtom3jM2wCu94xgzzu1d6Dn7or,5,4,2,0,2,0,3,0,11,1.5714285714285714,1,0.0,1,2,0,2,3,0,0,3,0,5,6,1
9540,162648,Nc3ZZeizgzMQ7ljgRcfUdDiH0EOAXMpI,fbPkOYLVPtPgIt0MxizjfFJov3JbHyAi,5,3,2,0,1,0,1,0,7,1.0,1,0.0,0,2,0,1,3,0,0,1,0,3,4,1
9541,162718,lFYUqaC8DDbyzlpsvaLNmtptRSgKf6hQ,5Gyp41oLVo7Gg7vF4vpmggWP5MU70QO6,14,27,11,4,8,0,6,0,56,8.0,1,0.0,6,11,2,8,21,0,2,6,0,27,29,1
9542,162722,nlSetL9gA8PdgMyBwWPmXIZKvL389Wvz,5Gyp41oLVo7Gg7vF4vpmggWP5MU70QO6,8,8,3,0,2,0,10,0,23,3.2857142857142856,1,0.0,0,3,0,2,8,0,0,10,0,5,18,1
9543,162731,zOpl1QLMdi3RN3ezftwBd305gEk9qlj4,5Gyp41oLVo7Gg7vF4vpmggWP5MU70QO6,7,3,2,0,2,0,3,0,10,1.4285714285714286,1,0.0,0,2,0,2,3,0,0,3,0,4,6,1
9544,162735,9QTkMOaMHVfS6J8nswauls4qIiVW28S7,5Gyp41oLVo7Gg7vF4vpmggWP5MU70QO6,6,2,1,0,1,0,6,1,11,1.5714285714285714,2,0.0,0,1,0,1,2,0,0,6,1,2,9,1
9545,162737,xVCW9o5KqxAPnPVb1aenUpUZ6QWvEQCo,5Gyp41oLVo7Gg7vF4vpmggWP5MU70QO6,7,2,1,0,1,5,4,0,13,1.8571428571428572,1,0.0,0,1,0,1,2,5,0,4,0,2,11,1
9546,162746,dpsnO2nFdLg9XmGy3JleJNGIQPzaFF4U,5Gyp41oLVo7Gg7vF4vpmggWP5MU70QO6,4,2,0,0,0,0,3,0,5,0.7142857142857143,1,0.0,0,0,0,0,2,0,0,3,0,0,5,1
9547,162748,qJ6pGAhU9YH3dWsgEUqoanPcdcAk0sbr,5Gyp41oLVo7Gg7vF4vpmggWP5MU70QO6,8,6,4,0,3,0,5,0,18,2.5714285714285716,1,0.0,0,4,0,3,6,0,0,5,0,7,11,1
9548,162757,97rKVY7VtULS5cSVVXRfvKL2xj2p2K2g,5Gyp41oLVo7Gg7vF4vpmggWP5MU70QO6,10,6,2,0,1,1,8,1,19,2.7142857142857144,1,0.0,1,2,0,1,5,1,0,8,1,4,15,1
9549,162783,YvHnKE6OimroKzuRehZQSn9RJI3E9BpN,5Gyp41oLVo7Gg7vF4vpmggWP5MU70QO6,5,3,1,0,1,0,2,0,7,1.0,1,0.0,0,1,0,1,3,0,0,2,0,2,5,1
9550,162794,OysKzR1UEVPCXl0wSCjn9V0QgLV5NmCX,5Gyp41oLVo7Gg7vF4vpmggWP5MU70QO6,8,6,3,0,1,0,5,1,16,2.2857142857142856,1,0.0,0,3,0,1,6,0,0,5,1,4,12,1
9551,162800,K8tVmp5wiFryD3jk9LqI5fYSc6Xw95fz,5Gyp41oLVo7Gg7vF4vpmggWP5MU70QO6,1,0,0,0,0,0,1,0,1,0.14285714285714285,1,0.0,0,0,0,0,0,0,0,1,0,0,1,1
9552,162820,ChzLHYLLy0NerR7PrLzbpfdlhEVUipcm,5Gyp41oLVo7Gg7vF4vpmggWP5MU70QO6,9,3,2,0,2,0,4,0,11,1.5714285714285714,1,0.0,0,2,0,2,3,0,0,4,0,4,7,1
9553,162827,qAm5iTgVCKBmprSEwabFbnK8oXs3FFjT,5Gyp41oLVo7Gg7vF4vpmggWP5MU70QO6,1,0,0,0,0,0,1,0,1,0.14285714285714285,1,0.0,0,0,0,0,0,0,0,1,0,0,1,1
9554,162830,V5n4KmrCt6qTaNCHvn8AZsixldOhtrqM,5Gyp41oLVo7Gg7vF4vpmggWP5MU70QO6,8,9,6,0,4,0,5,0,24,3.4285714285714284,3,0.0,0,6,0,4,9,0,0,5,0,10,14,1
9555,162843,DUnTFXJLyJskCQxxzcdjCS794PUvsnpf,5Gyp41oLVo7Gg7vF4vpmggWP5MU70QO6,9,10,5,0,5,0,4,0,24,3.4285714285714284,1,0.0,2,5,0,5,8,0,0,4,0,12,12,1
9556,162857,jpeaz6SjEWnSbarewJDpBrwhKD14EETZ,5Gyp41oLVo7Gg7vF4vpmggWP5MU70QO6,7,3,2,0,2,1,2,0,10,1.4285714285714286,1,0.0,0,2,0,2,3,1,0,2,0,4,6,1
9557,162892,ghDdCHMpenNSgQDj8zPLL5gQmRbVZb3W,5Gyp41oLVo7Gg7vF4vpmggWP5MU70QO6,12,10,5,3,2,0,6,1,27,3.857142857142857,2,0.0,3,5,2,2,7,0,1,6,1,12,15,1
9558,162894,yI6TnEdeRXOHoLYUJXYNBvoqqL23yrRt,5Gyp41oLVo7Gg7vF4vpmggWP5MU70QO6,1,0,0,0,0,0,1,0,1,0.14285714285714285,1,0.0,0,0,0,0,0,0,0,1,0,0,1,1
9559,162925,CfIEXK3xglklk8przSjO3ca2uY3X9RYV,5Gyp41oLVo7Gg7vF4vpmggWP5MU70QO6,11,6,5,0,5,0,2,0,18,2.5714285714285716,1,0.0,0,5,0,5,6,0,0,2,0,10,8,1
9560,162932,vdRCC0h1jyX5w0Fdkdj4bKRro4Amx6xH,5Gyp41oLVo7Gg7vF4vpmggWP5MU70QO6,6,2,1,0,1,0,3,0,7,1.0,1,0.0,0,1,0,1,2,0,0,3,0,2,5,1
9561,162933,dRlbPCu3UtdgQ7UtujQP87Y5bL1jXTJw,5Gyp41oLVo7Gg7vF4vpmggWP5MU70QO6,1,0,0,0,0,0,1,0,1,0.14285714285714285,1,0.0,0,0,0,0,0,0,0,1,0,0,1,1
9562,162936,f7neqK5VAQO37ru5uhidAaG8lJCjXCKS,5Gyp41oLVo7Gg7vF4vpmggWP5MU70QO6,1,0,0,0,0,0,1,0,1,0.14285714285714285,1,0.0,0,0,0,0,0,0,0,1,0,0,1,1
9563,162940,W10A8T2jCGdEgLVGHe6uM3Tii0X2ffH8,5Gyp41oLVo7Gg7vF4vpmggWP5MU70QO6,7,3,2,0,2,0,2,0,9,1.2857142857142858,1,0.0,0,2,0,2,3,0,0,2,0,4,5,1
9564,162950,5zW5PyiJVNvMfg9iMsdCsoLMsm2pszwe,5Gyp41oLVo7Gg7vF4vpmggWP5MU70QO6,1,0,0,0,0,0,1,0,1,0.14285714285714285,1,0.0,0,0,0,0,0,0,0,1,0,0,1,1
9565,163126,jcZzyelmNOUxuY7TWiZZyoS3gSdLYxDW,5X6FeZozNMgE2VRi3MJYjkkFK8SETtu2,2,0,0,0,0,0,3,0,3,0.42857142857142855,1,0.0,0,0,0,0,0,0,0,3,0,0,3,1
9566,163131,MyVMQFGo6UgMVH1DFRBNDeO95qBhMkx2,5X6FeZozNMgE2VRi3MJYjkkFK8SETtu2,1,0,0,0,0,0,1,0,1,0.14285714285714285,1,0.0,0,0,0,0,0,0,0,1,0,0,1,1
9567,163140,yRnajANt7LOq4B1hOGSgC8hdBn0DyFi6,5X6FeZozNMgE2VRi3MJYjkkFK8SETtu2,1,0,0,0,0,0,2,0,2,0.2857142857142857,1,0.0,0,0,0,0,0,0,0,2,0,0,2,1
9568,163164,OnCJ5oUOuIvHHhQxtwxg0lrLrlAmNpUv,5X6FeZozNMgE2VRi3MJYjkkFK8SETtu2,19,29,1,16,5,1,5,0,57,8.142857142857142,2,0.0,13,1,15,5,16,1,1,5,0,34,23,1
9569,163213,qPinNnuwG11dRyXbHR9eoc8JbfTOf2YH,5X6FeZozNMgE2VRi3MJYjkkFK8SETtu2,1,0,0,0,0,0,2,0,2,0.2857142857142857,1,0.0,0,0,0,0,0,0,0,2,0,0,2,1
9570,163774,MByqWSIhrOuR5hLDV5SDwmnefy1Zfii8,SpATywNh6bZuzm8s1ceuBUnMUAeoAHHw,5,5,1,0,0,0,1,0,7,1.0,1,0.0,1,1,0,0,4,0,0,1,0,2,5,1
9571,163934,5NIrDL6VpBxdJ6CyWDkvlKDqSlFChzvA,SpATywNh6bZuzm8s1ceuBUnMUAeoAHHw,16,11,9,4,6,0,1,0,31,4.428571428571429,1,0.0,0,9,4,6,11,0,0,1,0,19,12,0
9572,163982,cikSh880jtc26b154AaVhDiV1L6H6F3g,SpATywNh6bZuzm8s1ceuBUnMUAeoAHHw,20,22,13,11,9,0,2,0,57,8.142857142857142,1,0.0,8,13,11,9,14,0,0,2,0,41,16,0
9573,164024,s5CJLvNaNPk4PiGqc6NTFvObROYB0OQQ,SpATywNh6bZuzm8s1ceuBUnMUAeoAHHw,1,0,0,0,0,0,1,0,1,0.14285714285714285,1,0.0,0,0,0,0,0,0,0,1,0,0,1,0
9574,164032,zQ5BnttGrAYjfbNnxAVeHGUEjC3wWZZU,SpATywNh6bZuzm8s1ceuBUnMUAeoAHHw,12,6,5,7,3,0,2,0,23,3.2857142857142856,1,0.0,0,5,6,3,6,0,1,2,0,14,9,0
9575,164266,JHhY30IKFzw4LWcyrHuTEglWNqRkqdDU,G8EPVSXsOYB5YQWZGiz1aVq5Pgr2GrQu,31,5,5,88,0,0,2,0,100,14.285714285714286,1,0.0,0,5,76,0,5,0,12,2,0,81,19,1
9576,164669,Ib8KHMHKfyTwrkbnwsSOuVq4nV1vOamx,bWdj2GDclj5ofokWjzoa5jAwMkxCykd6,3,2,1,0,0,0,1,0,4,0.5714285714285714,1,0.0,0,1,0,0,2,0,0,1,0,1,3,1
9577,164820,opdILbT2IBFIYJvyIT5NXM7ymKeuMTcM,bWdj2GDclj5ofokWjzoa5jAwMkxCykd6,1,0,0,0,0,0,1,0,1,0.14285714285714285,1,0.0,0,0,0,0,0,0,0,1,0,0,1,1
9578,164933,oz2lIvXgN1G19jRJoPetgndSl9b9808T,bWdj2GDclj5ofokWjzoa5jAwMkxCykd6,5,7,3,0,2,0,1,0,13,1.8571428571428572,1,0.0,2,3,0,2,5,0,0,1,0,7,6,1
9579,164999,muJ6MIRhOdDL6SrbHsZ7Ks5a50Iz9AeC,G8EPVSXsOYB5YQWZGiz1aVq5Pgr2GrQu,28,36,16,0,13,0,7,0,72,10.285714285714286,1,0.0,0,16,0,13,36,0,0,7,0,29,43,0
9580,165087,M4k2b8losoqUFktWiKn58aOnUoYhQVU3,A3fsA9Zfv1X2fVEQhTw51lKENdNrEqT3,2,0,0,0,0,0,2,0,2,0.2857142857142857,1,0.0,0,0,0,0,0,0,0,2,0,0,2,0
9581,165102,8IsnQQnfLzKrobCqyqui1F07ZqYQDg46,G8EPVSXsOYB5YQWZGiz1aVq5Pgr2GrQu,5,3,1,0,1,0,1,0,6,0.8571428571428571,1,0.0,0,1,0,1,3,0,0,1,0,2,4,1
9582,165183,oBIU2QyRoi1Laa10XMgxHQ2fgzYMbfW0,RXDvfPUBYFlVdlueBFbLW0mhhAyGEqpt,6,3,2,0,1,0,3,0,9,1.2857142857142858,1,0.0,0,2,0,1,3,0,0,3,0,3,6,1
9583,165376,yR0NraAWygNs5cts7Fvc0zvbt2sGOVtI,SpATywNh6bZuzm8s1ceuBUnMUAeoAHHw,14,7,6,0,5,0,2,0,20,2.857142857142857,1,0.0,0,6,0,5,7,0,0,2,0,11,9,1
9584,165738,rHhFTy1MHghalNQn9kKgxeI72dfIAI1Z,SpATywNh6bZuzm8s1ceuBUnMUAeoAHHw,35,46,0,41,0,17,13,2,119,17.0,1,0.0,13,0,36,0,33,17,5,13,2,49,70,0
9585,165762,6WkOKMKB5P2APoB7vbWWLXwAR3emifoG,A3fsA9Zfv1X2fVEQhTw51lKENdNrEqT3,4,2,1,0,0,0,2,0,5,0.7142857142857143,1,0.0,0,1,0,0,2,0,0,2,0,1,4,1
9586,165828,HJsFc87NFCDg5yRkkakXIT7nSH8XGxhF,3VkHkmOtom3jM2wCu94xgzzu1d6Dn7or,5,7,1,2,3,1,2,0,16,2.2857142857142856,1,0.0,5,1,2,3,2,1,0,2,0,11,5,1
9587,165835,scXnpGCF4DjXznxAKg71nYuRNUGXBYFN,3VkHkmOtom3jM2wCu94xgzzu1d6Dn7or,8,4,2,0,1,3,7,1,18,2.5714285714285716,1,0.0,0,2,0,1,4,3,0,7,1,3,15,1
9588,165836,Ne6brb2UYCH1YzQNJgL9sEkqnfN8PyF2,3VkHkmOtom3jM2wCu94xgzzu1d6Dn7or,5,2,1,0,1,0,2,0,6,0.8571428571428571,1,0.0,0,1,0,1,2,0,0,2,0,2,4,1
9589,165842,qpS6wb9uNTGVCgcwuCy8SzUwVyxXXF3H,3VkHkmOtom3jM2wCu94xgzzu1d6Dn7or,4,0,0,0,0,0,5,5,10,1.4285714285714286,2,0.0,0,0,0,0,0,0,0,5,5,0,10,1
9590,165849,ur6otp02L4PjsOJUEuj3EyXPhlHA15vm,3VkHkmOtom3jM2wCu94xgzzu1d6Dn7or,11,9,4,0,3,0,5,1,22,3.142857142857143,1,0.0,0,4,0,3,9,0,0,5,1,7,15,1
9591,165850,4aZT7iDmzz1ZA3Xi3FdFLegy7WbquyGH,3VkHkmOtom3jM2wCu94xgzzu1d6Dn7or,9,13,5,6,6,3,3,0,36,5.142857142857143,1,0.0,6,5,5,6,7,3,1,3,0,22,14,1
9592,165851,L8GepxGnZH9aQkkBlOp07iXjAUHLfNwr,3VkHkmOtom3jM2wCu94xgzzu1d6Dn7or,32,70,13,24,28,23,21,1,180,25.714285714285715,3,0.0,52,13,20,28,18,23,4,21,1,113,67,1
9593,165854,2oHi0xAwpU9rO0gdJkKqphbQcbEZ8anJ,3VkHkmOtom3jM2wCu94xgzzu1d6Dn7or,6,8,3,5,0,1,3,0,20,2.857142857142857,1,0.0,3,3,5,0,5,1,0,3,0,11,9,1
9594,165859,ne28zQQU7Tf8QiWSefnQ5dt27DfxaD8u,3VkHkmOtom3jM2wCu94xgzzu1d6Dn7or,2,0,0,0,0,0,3,0,3,0.42857142857142855,1,0.0,0,0,0,0,0,0,0,3,0,0,3,1
9595,165863,VVeFIhEvBtfe6VEs5n9mjvOb5qzGsf3B,3VkHkmOtom3jM2wCu94xgzzu1d6Dn7or,17,10,8,0,8,0,2,0,28,4.0,1,0.0,0,8,0,8,10,0,0,2,0,16,12,1
9596,165867,LFDmoNuImvyTX1w7R8m5PoVy8NtQSHTv,3VkHkmOtom3jM2wCu94xgzzu1d6Dn7or,5,2,1,0,1,0,2,0,6,0.8571428571428571,1,0.0,0,1,0,1,2,0,0,2,0,2,4,1
9597,165868,YSosgGRdY3GsluD1ZsgtqlAxXh5hZvxN,3VkHkmOtom3jM2wCu94xgzzu1d6Dn7or,5,2,1,0,1,0,3,0,7,1.0,1,0.0,0,1,0,1,2,0,0,3,0,2,5,1
9598,165869,H33pWhAKBmNqSFMSH8ndKQLrzOJYOscK,3VkHkmOtom3jM2wCu94xgzzu1d6Dn7or,11,17,8,12,7,0,5,0,49,7.0,1,0.0,5,8,9,7,12,0,3,5,0,29,20,1
9599,165872,vUcUGgyXHqLsb7h4n9fC89fi5JA9Umuj,3VkHkmOtom3jM2wCu94xgzzu1d6Dn7or,5,3,1,0,1,0,4,0,9,1.2857142857142858,2,0.0,0,1,0,1,3,0,0,4,0,2,7,1
9600,165873,gNJl55vDmpOKZnXzMeerC7XmAKIxq3n7,3VkHkmOtom3jM2wCu94xgzzu1d6Dn7or,5,2,0,0,0,0,3,0,5,0.7142857142857143,1,0.0,0,0,0,0,2,0,0,3,0,0,5,1
9601,165876,81TO5Y7JfDnyj2pNSZt7lBWBv0V271Pw,3VkHkmOtom3jM2wCu94xgzzu1d6Dn7or,5,2,1,0,1,0,2,0,6,0.8571428571428571,1,0.0,0,1,0,1,2,0,0,2,0,2,4,1
9602,165879,V2ci9KgtZ1q49NCXtKq8kCFPu0MV7kSx,3VkHkmOtom3jM2wCu94xgzzu1d6Dn7or,17,82,20,16,19,20,14,1,172,24.571428571428573,1,0.0,37,20,14,19,45,20,2,14,1,90,82,1
9603,165881,cWxwU28azibnDhRCdHe1upvu1jB34yGl,3VkHkmOtom3jM2wCu94xgzzu1d6Dn7or,5,2,0,0,1,0,4,0,7,1.0,1,0.0,0,0,0,1,2,0,0,4,0,1,6,1
9604,165885,xYfupN0QhuD5qeauSxlH6zzcZWFDwz2t,3VkHkmOtom3jM2wCu94xgzzu1d6Dn7or,4,0,0,0,0,1,8,0,9,1.2857142857142858,1,0.0,0,0,0,0,0,1,0,8,0,0,9,1
9605,165886,C94z3WWDcKWwvRiPZfri807udMluMNGM,3VkHkmOtom3jM2wCu94xgzzu1d6Dn7or,5,4,1,0,1,0,2,0,8,1.1428571428571428,1,0.0,2,1,0,1,2,0,0,2,0,4,4,1
9606,165889,lGARUusLq5vJ42G3PYCkjR61ReGU6X2A,3VkHkmOtom3jM2wCu94xgzzu1d6Dn7or,1,0,0,0,0,0,2,0,2,0.2857142857142857,1,0.0,0,0,0,0,0,0,0,2,0,0,2,1
9607,165890,QTHrclzp4UenGXgfGLVh4rdVGMe32BR2,3VkHkmOtom3jM2wCu94xgzzu1d6Dn7or,1,0,0,0,0,0,1,0,1,0.14285714285714285,1,0.0,0,0,0,0,0,0,0,1,0,0,1,1
9608,165894,nENIWKoNUkUWNfPzRSSO3B9znbsB8RDC,3VkHkmOtom3jM2wCu94xgzzu1d6Dn7or,1,0,0,0,0,0,1,0,1,0.14285714285714285,1,0.0,0,0,0,0,0,0,0,1,0,0,1,1
9609,165896,vN6thurDqmKL38ReBRWW6noXXKc2gjvG,3VkHkmOtom3jM2wCu94xgzzu1d6Dn7or,1,0,0,0,0,0,1,0,1,0.14285714285714285,1,0.0,0,0,0,0,0,0,0,1,0,0,1,1
9610,165898,akhpCIhs4QDwPZmMFVJzKLZYSTieJLuY,3VkHkmOtom3jM2wCu94xgzzu1d6Dn7or,4,4,2,0,0,0,2,0,8,1.1428571428571428,1,0.0,0,2,0,0,4,0,0,2,0,2,6,1
9611,165905,AYmIyfrL2B0FoP3BGfmuiCSDj3HmGe7k,3VkHkmOtom3jM2wCu94xgzzu1d6Dn7or,5,2,1,0,1,0,2,0,6,0.8571428571428571,1,0.0,0,1,0,1,2,0,0,2,0,2,4,1
9612,165908,W5GzZWf3RMdsUdwwScphnOauhikBFz9e,3VkHkmOtom3jM2wCu94xgzzu1d6Dn7or,5,2,1,0,1,0,3,0,7,1.0,1,0.0,0,1,0,1,2,0,0,3,0,2,5,1
9613,165910,ThCRB1MJgGWsbnx3pwElV5x318Rjjfam,3VkHkmOtom3jM2wCu94xgzzu1d6Dn7or,8,5,2,3,2,11,12,1,36,5.142857142857143,1,0.0,2,2,3,2,3,11,0,12,1,9,27,1
9614,165911,OdVV14h77xHPkWuABVGCbihUGAXK9ZCH,3VkHkmOtom3jM2wCu94xgzzu1d6Dn7or,1,0,0,0,0,0,1,0,1,0.14285714285714285,1,0.0,0,0,0,0,0,0,0,1,0,0,1,1
9615,165917,j3c6K94i9dgmcXc2NErAuVxnWFJZj8tT,3VkHkmOtom3jM2wCu94xgzzu1d6Dn7or,1,0,0,0,0,0,1,0,1,0.14285714285714285,1,0.0,0,0,0,0,0,0,0,1,0,0,1,1
9616,165921,WFMHWRweXwiWpUWxRMl8OMA5DB0GUNtv,3VkHkmOtom3jM2wCu94xgzzu1d6Dn7or,3,2,0,0,0,0,2,0,4,0.5714285714285714,1,0.0,0,0,0,0,2,0,0,2,0,0,4,1
9617,165922,qal9tEID3y1vYsBIv69vQRjnAVCAr7bG,3VkHkmOtom3jM2wCu94xgzzu1d6Dn7or,4,2,1,0,1,0,2,0,6,0.8571428571428571,2,0.0,0,1,0,1,2,0,0,2,0,2,4,1
9618,166042,fTFCMd76UjKBUrosPwesoa2JcVylSbm0,fbPkOYLVPtPgIt0MxizjfFJov3JbHyAi,1,3,0,0,0,0,0,0,3,0.42857142857142855,1,0.0,1,0,0,0,2,0,0,0,0,1,2,1
9619,166078,TJ7CV32O4GjDDzJFZO7c0xw8OlGRWvRD,fbPkOYLVPtPgIt0MxizjfFJov3JbHyAi,5,2,1,0,1,0,3,0,7,1.0,1,0.0,0,1,0,1,2,0,0,3,0,2,5,1
9620,166079,LA4t1deFlCblJM9N6fBAbaIwYjVRMO2R,fbPkOYLVPtPgIt0MxizjfFJov3JbHyAi,7,5,4,0,2,0,2,0,13,1.8571428571428572,1,0.0,0,4,0,2,5,0,0,2,0,6,7,1
9621,166081,Q7Lww1kbMQad2WXChnd9KWxucmXe04CU,fbPkOYLVPtPgIt0MxizjfFJov3JbHyAi,81,66,37,29,24,11,9,1,177,25.285714285714285,2,0.0,22,37,27,24,44,11,2,9,1,110,67,1
9622,166082,3BgG8HlWQ0SR0oNUBGA5GcFVqx1VBIse,fbPkOYLVPtPgIt0MxizjfFJov3JbHyAi,12,19,7,6,8,0,3,0,43,6.142857142857143,1,0.0,4,7,4,8,15,0,2,3,0,23,20,1
9623,166083,uRfXubMeyVWXKFxPyKQCZ45cC46rUIuh,fbPkOYLVPtPgIt0MxizjfFJov3JbHyAi,1,0,0,0,0,0,1,0,1,0.14285714285714285,1,0.0,0,0,0,0,0,0,0,1,0,0,1,1
9624,166084,niHjNQJblOPbPbrg09uvwwpljTObAHSz,fbPkOYLVPtPgIt0MxizjfFJov3JbHyAi,7,2,1,0,1,0,5,1,10,1.4285714285714286,1,0.0,0,1,0,1,2,0,0,5,1,2,8,1
9625,166085,hne1Z7uPNxHKtOSgT2rxpmt4dGtlsF3d,fbPkOYLVPtPgIt0MxizjfFJov3JbHyAi,7,6,2,0,3,0,2,0,13,1.8571428571428572,1,0.0,2,2,0,3,4,0,0,2,0,7,6,1
9626,166087,uPNpQwnvEtjDufLcIcScg8qVljQjes1y,fbPkOYLVPtPgIt0MxizjfFJov3JbHyAi,5,4,3,0,1,0,2,0,10,1.4285714285714286,2,0.0,0,3,0,1,4,0,0,2,0,4,6,1
9627,166088,uCXsL4wx2V39dXm8Sw1MQn2iWfWjGwcq,fbPkOYLVPtPgIt0MxizjfFJov3JbHyAi,7,5,2,0,1,0,3,0,11,1.5714285714285714,1,0.0,0,2,0,1,5,0,0,3,0,3,8,1
9628,166090,g5pprVZU2PNABNs3JzKVJKMKGrPFXIk3,fbPkOYLVPtPgIt0MxizjfFJov3JbHyAi,7,2,1,0,1,3,5,1,13,1.8571428571428572,1,0.0,0,1,0,1,2,3,0,5,1,2,11,1
9629,166093,t6mTw4N76Mem065myGcGY8Fhohbwba7Q,fbPkOYLVPtPgIt0MxizjfFJov3JbHyAi,1,0,0,0,0,0,1,0,1,0.14285714285714285,1,0.0,0,0,0,0,0,0,0,1,0,0,1,1
9630,166097,vuVnTFCBfdzSvUffWnstx1XETLzOHwWp,fbPkOYLVPtPgIt0MxizjfFJov3JbHyAi,1,0,0,0,0,0,1,0,1,0.14285714285714285,1,0.0,0,0,0,0,0,0,0,1,0,0,1,1
9631,166098,FGCLu23qz5rUrelYuCtqPnMTqZtXAAMw,fbPkOYLVPtPgIt0MxizjfFJov3JbHyAi,1,0,0,0,0,0,1,0,1,0.14285714285714285,1,0.0,0,0,0,0,0,0,0,1,0,0,1,1
9632,166099,MWE377O2Li2ZFTgbdfnJVTVnbBfqy4jA,fbPkOYLVPtPgIt0MxizjfFJov3JbHyAi,1,0,0,0,0,0,1,0,1,0.14285714285714285,1,0.0,0,0,0,0,0,0,0,1,0,0,1,1
9633,166101,ccJAb1xsBFlxk4bnyUyZWEcDFKaDRrrN,fbPkOYLVPtPgIt0MxizjfFJov3JbHyAi,1,0,0,0,0,0,1,0,1,0.14285714285714285,1,0.0,0,0,0,0,0,0,0,1,0,0,1,1
9634,166102,IA27Knz0RQBhba167ySTdEbnqRZ3B4AP,fbPkOYLVPtPgIt0MxizjfFJov3JbHyAi,1,0,0,0,0,0,1,0,1,0.14285714285714285,1,0.0,0,0,0,0,0,0,0,1,0,0,1,1
9635,166103,qMFAmPw34z5IViYTtA1Kkpcn2uEg1WBM,fbPkOYLVPtPgIt0MxizjfFJov3JbHyAi,13,16,11,5,8,0,3,0,43,6.142857142857143,2,0.0,2,11,4,8,14,0,1,3,0,25,18,1
9636,166104,iPrzdF2eVEdRHCiD9WvkMRf87gtIEGMk,fbPkOYLVPtPgIt0MxizjfFJov3JbHyAi,3,0,0,0,0,0,5,0,5,0.7142857142857143,1,0.0,0,0,0,0,0,0,0,5,0,0,5,1
9637,166105,bjBPkmWjYG1t3drl5gryiSwz5yQdVwAZ,fbPkOYLVPtPgIt0MxizjfFJov3JbHyAi,1,0,0,0,0,0,1,0,1,0.14285714285714285,1,0.0,0,0,0,0,0,0,0,1,0,0,1,1
9638,166106,hndVkXjnMlUx6Wx46vZ4lU1lCLK80xXY,fbPkOYLVPtPgIt0MxizjfFJov3JbHyAi,1,0,0,0,0,0,1,0,1,0.14285714285714285,1,0.0,0,0,0,0,0,0,0,1,0,0,1,1
9639,166294,kayFAsNlLJHsRlX0XZpPHYGvL0bJckz3,5X6FeZozNMgE2VRi3MJYjkkFK8SETtu2,3,0,0,0,0,0,3,0,3,0.42857142857142855,1,0.0,0,0,0,0,0,0,0,3,0,0,3,1
9640,166296,0OgHQAVhQz83ex7oEMaYHMGoui5vuRU7,5X6FeZozNMgE2VRi3MJYjkkFK8SETtu2,6,4,1,0,1,0,7,0,13,1.8571428571428572,2,0.0,2,1,0,1,2,0,0,7,0,4,9,1
9641,166323,9xFxSbbQUc3N03I1VXFxrUyAcv76iE10,5X6FeZozNMgE2VRi3MJYjkkFK8SETtu2,6,4,2,0,1,0,4,0,11,1.5714285714285714,2,0.0,0,2,0,1,4,0,0,4,0,3,8,1
9642,166482,L7V90oxKH6hMT4ofGnoics5L5B12YDEc,5X6FeZozNMgE2VRi3MJYjkkFK8SETtu2,7,3,2,0,2,0,2,0,9,1.2857142857142858,1,0.0,0,2,0,2,3,0,0,2,0,4,5,1
9643,166860,oJHnnpnFBdflow5PBV5uje04XEG79lqu,A3fsA9Zfv1X2fVEQhTw51lKENdNrEqT3,5,4,0,0,0,0,1,0,5,0.7142857142857143,1,0.0,0,0,0,0,4,0,0,1,0,0,5,0
9644,166873,PDNsiMyTk72mYrcSTgVVhe2c68BJ17Ar,bWdj2GDclj5ofokWjzoa5jAwMkxCykd6,14,8,7,0,6,1,6,1,29,4.142857142857143,1,0.0,0,7,0,6,8,1,0,6,1,13,16,1
9645,166924,S2Kd9VGJ7wj54OKeEh5Yf8NI7V1Tw4JO,5X6FeZozNMgE2VRi3MJYjkkFK8SETtu2,5,2,1,0,1,0,2,0,6,0.8571428571428571,1,0.0,0,1,0,1,2,0,0,2,0,2,4,1
9646,166970,LkEFlCqQYkjvIKgJmv3NaW67JKbg7cls,5X6FeZozNMgE2VRi3MJYjkkFK8SETtu2,1,0,0,0,0,0,2,0,2,0.2857142857142857,1,0.0,0,0,0,0,0,0,0,2,0,0,2,1
9647,167105,pGwYJRrX7MfzhhSwNLSQAMurehSIgkJ9,5X6FeZozNMgE2VRi3MJYjkkFK8SETtu2,4,2,1,0,1,0,1,0,5,0.7142857142857143,1,0.0,0,1,0,1,2,0,0,1,0,2,3,1
9648,167126,b4AoytcALKo93jkUt1ENhVQij09dmis3,5X6FeZozNMgE2VRi3MJYjkkFK8SETtu2,6,7,2,0,1,0,1,0,11,1.5714285714285714,1,0.0,0,2,0,1,7,0,0,1,0,3,8,1
9649,167228,3wg8Fx16VgJsTbW93ZS5qb0oY4bANqoR,A3fsA9Zfv1X2fVEQhTw51lKENdNrEqT3,5,5,2,0,0,0,3,0,10,1.4285714285714286,1,0.0,0,2,0,0,5,0,0,3,0,2,8,1
9650,167229,gzXWUmBbfvFR7PGGJvrwCH6citOFTVWD,5X6FeZozNMgE2VRi3MJYjkkFK8SETtu2,1,0,0,0,0,0,1,0,1,0.14285714285714285,1,0.0,0,0,0,0,0,0,0,1,0,0,1,1
9651,167274,dU7DqQeRV0VJw1owh3rH0rASxy6mSG05,5X6FeZozNMgE2VRi3MJYjkkFK8SETtu2,1,0,0,0,0,0,1,0,1,0.14285714285714285,1,0.0,0,0,0,0,0,0,0,1,0,0,1,1
9652,167277,mYprTaruBDuUvLXNdxUEBezQgZtrye7I,5X6FeZozNMgE2VRi3MJYjkkFK8SETtu2,5,3,2,0,2,0,4,0,11,1.5714285714285714,1,0.0,0,2,0,2,3,0,0,4,0,4,7,1
9653,167312,8MuGb55gUM18pukCITXgZoTSobqXs9G4,5X6FeZozNMgE2VRi3MJYjkkFK8SETtu2,2,0,0,0,0,0,4,0,4,0.5714285714285714,3,0.0,0,0,0,0,0,0,0,4,0,0,4,1
9654,167431,Yq1D9nN2WOKWLjCOIlbnWTVJWZSUTem6,5X6FeZozNMgE2VRi3MJYjkkFK8SETtu2,6,5,3,0,2,0,3,0,13,1.8571428571428572,1,0.0,0,3,0,2,5,0,0,3,0,5,8,1
9655,167464,XTOZBwO5vG1hcHef4AbuiTP7iSg27hS9,5X6FeZozNMgE2VRi3MJYjkkFK8SETtu2,2,0,0,0,0,0,2,0,2,0.2857142857142857,1,0.0,0,0,0,0,0,0,0,2,0,0,2,1
9656,167562,MtRhvdyfNAmKhL1ceR2tOMUJmXukJ2x3,5X6FeZozNMgE2VRi3MJYjkkFK8SETtu2,7,40,7,0,11,0,5,0,63,9.0,2,0.0,31,7,0,11,9,0,0,5,0,49,14,1
9657,167659,ySL3N6leUYq4FJsPfm5psrr8vOc4j4V7,5X6FeZozNMgE2VRi3MJYjkkFK8SETtu2,14,12,4,16,3,1,9,1,46,6.571428571428571,1,0.0,5,4,13,3,7,1,3,9,1,25,21,1
9658,167734,KTO4rcwcNqZCBYJ04kXZU7uzHTeP1Eer,A3fsA9Zfv1X2fVEQhTw51lKENdNrEqT3,28,7,4,68,0,0,3,0,82,11.714285714285714,1,0.0,2,4,59,0,5,0,9,3,0,65,17,1
9659,167745,wTfd2gVG5QduDxubL2XCUf2GyqSTHM2h,5X6FeZozNMgE2VRi3MJYjkkFK8SETtu2,1,0,0,0,0,0,1,0,1,0.14285714285714285,1,0.0,0,0,0,0,0,0,0,1,0,0,1,1
9660,167771,dv5Xzy3RizPqbGvGIMXlJIDl0kMrBVlb,5X6FeZozNMgE2VRi3MJYjkkFK8SETtu2,4,2,1,0,0,0,2,0,5,0.7142857142857143,1,0.0,0,1,0,0,2,0,0,2,0,1,4,1
9661,167781,HhHFHVl0FdyFAQQ7F70xD2HQyGMqv85Q,G8EPVSXsOYB5YQWZGiz1aVq5Pgr2GrQu,23,19,2,0,0,0,12,1,34,4.857142857142857,2,0.0,0,2,0,0,19,0,0,12,1,2,32,1
9662,167830,9d73It9dbU3oxDfTI8oeXV5S5dv2fy6Z,3VkHkmOtom3jM2wCu94xgzzu1d6Dn7or,1,0,0,0,0,0,2,0,2,0.2857142857142857,1,0.0,0,0,0,0,0,0,0,2,0,0,2,1
9663,167833,6Wxu7ROOUIUrDpts0GNT0b9BdXqvS8rN,3VkHkmOtom3jM2wCu94xgzzu1d6Dn7or,11,8,6,0,4,0,2,0,20,2.857142857142857,2,0.0,0,6,0,4,8,0,0,2,0,10,10,1
9664,167836,H2SI8xiP6AfGLtLXDoA9AXn8QdorX1Ui,3VkHkmOtom3jM2wCu94xgzzu1d6Dn7or,3,0,0,0,0,2,6,0,8,1.1428571428571428,1,0.0,0,0,0,0,0,2,0,6,0,0,8,1
9665,167837,EJfyGdJ9yd6yxlMqB9gc1CbaKkAoFcAP,3VkHkmOtom3jM2wCu94xgzzu1d6Dn7or,1,0,0,0,0,0,1,0,1,0.14285714285714285,1,0.0,0,0,0,0,0,0,0,1,0,0,1,1
9666,167838,BBxAjBZ6FgoUiaQ5bz1Iv3FndLCl7M0a,3VkHkmOtom3jM2wCu94xgzzu1d6Dn7or,8,5,3,0,0,1,6,0,15,2.142857142857143,1,0.0,0,3,0,0,5,1,0,6,0,3,12,1
9667,167843,EhIHkuSHqi99btgO8zXl3qd7FaPXyt4O,3VkHkmOtom3jM2wCu94xgzzu1d6Dn7or,8,10,4,0,2,0,4,0,20,2.857142857142857,3,0.0,0,4,0,2,10,0,0,4,0,6,14,1
9668,167844,jg1izKcLOCQQccVtb0xwXEbSh8NkGjGq,3VkHkmOtom3jM2wCu94xgzzu1d6Dn7or,1,0,0,0,0,0,1,0,1,0.14285714285714285,1,0.0,0,0,0,0,0,0,0,1,0,0,1,1
9669,167846,Mz4tCq48F8Vo6f66hsgQjWbSQTLdHbUu,3VkHkmOtom3jM2wCu94xgzzu1d6Dn7or,5,6,1,0,1,0,1,0,9,1.2857142857142858,1,0.0,0,1,0,1,6,0,0,1,0,2,7,1
9670,167850,05eYd6nVS80B4zVtMeSuzaTtmBSCZOK3,3VkHkmOtom3jM2wCu94xgzzu1d6Dn7or,5,4,1,0,1,1,2,0,9,1.2857142857142858,1,0.0,1,1,0,1,3,1,0,2,0,3,6,1
9671,167856,cTRvr9OwCf92tEyWCswhS4evpjr692re,3VkHkmOtom3jM2wCu94xgzzu1d6Dn7or,7,9,3,0,2,0,5,0,19,2.7142857142857144,2,0.0,1,3,0,2,8,0,0,5,0,6,13,1
9672,167858,04lCRShTAc7quEzrn2ou8mv2nCigZbgp,3VkHkmOtom3jM2wCu94xgzzu1d6Dn7or,6,5,3,0,2,0,5,0,15,2.142857142857143,1,0.0,0,3,0,2,5,0,0,5,0,5,10,1
9673,167864,TOaINpcBLCJfZ2I2QbCp4abwufWoQUhj,3VkHkmOtom3jM2wCu94xgzzu1d6Dn7or,18,23,8,14,9,6,8,0,68,9.714285714285714,1,0.0,10,8,12,9,13,6,2,8,0,39,29,1
9674,167870,YoD5TStKk1uJ5sTkRhrgG9ZhOoogdtvY,3VkHkmOtom3jM2wCu94xgzzu1d6Dn7or,15,8,6,0,6,0,2,0,22,3.142857142857143,1,0.0,1,6,0,6,7,0,0,2,0,13,9,1
9675,167873,SZqQgJTwnT4DdAmdFLsmCSu8pOi8l278,3VkHkmOtom3jM2wCu94xgzzu1d6Dn7or,1,0,0,0,0,0,2,0,2,0.2857142857142857,1,0.0,0,0,0,0,0,0,0,2,0,0,2,1
9676,167876,cXWvF2D7w4W534TQNivVGR20evKWHdmC,3VkHkmOtom3jM2wCu94xgzzu1d6Dn7or,2,0,0,0,0,0,2,0,2,0.2857142857142857,1,0.0,0,0,0,0,0,0,0,2,0,0,2,1
9677,167877,nz7SdGwmWTnUgJHbI5SHYAxdoSxPn3v9,3VkHkmOtom3jM2wCu94xgzzu1d6Dn7or,2,0,0,0,0,0,3,0,3,0.42857142857142855,1,0.0,0,0,0,0,0,0,0,3,0,0,3,1
9678,167885,w0MOevkqL7TIdK3soXlSk0InhRt5D2OI,3VkHkmOtom3jM2wCu94xgzzu1d6Dn7or,4,10,0,0,1,1,1,0,13,1.8571428571428572,1,0.0,5,0,0,1,5,1,0,1,0,6,7,1
9679,167886,T6EWQ7jVP89JlHzj41KN1gEtGYevpSQM,3VkHkmOtom3jM2wCu94xgzzu1d6Dn7or,1,0,0,0,0,0,1,0,1,0.14285714285714285,1,0.0,0,0,0,0,0,0,0,1,0,0,1,1
9680,167889,rwhwaTH9sh2CIA4lrAOreMZ4DcHbdGSX,3VkHkmOtom3jM2wCu94xgzzu1d6Dn7or,4,3,1,0,1,0,1,0,6,0.8571428571428571,1,0.0,0,1,0,1,3,0,0,1,0,2,4,1
9681,167897,TbUheYwTeREPT5Z3hVrDk5WemURCeERw,3VkHkmOtom3jM2wCu94xgzzu1d6Dn7or,1,0,0,0,0,0,1,0,1,0.14285714285714285,1,0.0,0,0,0,0,0,0,0,1,0,0,1,1
9682,167900,wuhaNytEMshRvZHy4v0wfMQMUoUf2C0I,3VkHkmOtom3jM2wCu94xgzzu1d6Dn7or,1,0,0,0,0,0,1,0,1,0.14285714285714285,1,0.0,0,0,0,0,0,0,0,1,0,0,1,1
9683,167906,BsUjBDhdyUXYaK2TdnMst3sGgcJsTcFj,3VkHkmOtom3jM2wCu94xgzzu1d6Dn7or,17,64,25,16,0,22,8,1,136,19.428571428571427,1,0.0,21,25,15,0,43,22,1,8,1,61,75,1
9684,167911,QYfu0Yy3chzMh9N27M3NdjRKbhRbX6KZ,3VkHkmOtom3jM2wCu94xgzzu1d6Dn7or,15,15,7,6,8,2,21,1,60,8.571428571428571,2,0.0,6,7,5,8,9,2,1,21,1,26,34,1
9685,167912,y5qGGV7k07NOQfMigLDYbjv0jILDYgkC,3VkHkmOtom3jM2wCu94xgzzu1d6Dn7or,12,12,7,0,7,0,3,0,29,4.142857142857143,2,0.0,2,7,0,7,10,0,0,3,0,16,13,1
9686,167917,I4MqqOGxKO8aJcsCgOUnBSAMs2KCIFJB,3VkHkmOtom3jM2wCu94xgzzu1d6Dn7or,6,17,4,0,4,0,2,0,27,3.857142857142857,1,0.0,7,4,0,4,10,0,0,2,0,15,12,1
9687,167918,OhHmRP3AJk4AhYrz2RzDrm3BTMGEusSV,3VkHkmOtom3jM2wCu94xgzzu1d6Dn7or,5,2,1,0,1,0,2,0,6,0.8571428571428571,1,0.0,0,1,0,1,2,0,0,2,0,2,4,1
9688,167921,bBDozteTX4D4ORk9XFCupn0FLtyYS5su,3VkHkmOtom3jM2wCu94xgzzu1d6Dn7or,2,0,0,0,0,0,3,0,3,0.42857142857142855,1,0.0,0,0,0,0,0,0,0,3,0,0,3,1
9689,167925,B1tG9d6vAm1cRb4gczt46vEuvymg0cAG,3VkHkmOtom3jM2wCu94xgzzu1d6Dn7or,1,0,0,0,0,0,1,0,1,0.14285714285714285,1,0.0,0,0,0,0,0,0,0,1,0,0,1,1
9690,167929,0lqOZSX7cmSd4rlWa8O2CvuGbKanDhKJ,3VkHkmOtom3jM2wCu94xgzzu1d6Dn7or,1,0,0,0,0,0,1,0,1,0.14285714285714285,1,0.0,0,0,0,0,0,0,0,1,0,0,1,1
9691,167933,UiS73jMKlU4Br8R1hIRvjExZc4uRiQjd,3VkHkmOtom3jM2wCu94xgzzu1d6Dn7or,1,0,0,0,0,0,1,0,1,0.14285714285714285,1,0.0,0,0,0,0,0,0,0,1,0,0,1,1
9692,167946,9X8ssnk1S6QNY201gYXI4DoJg7mLdbbk,3VkHkmOtom3jM2wCu94xgzzu1d6Dn7or,11,17,8,0,4,0,7,0,36,5.142857142857143,3,0.0,3,8,0,4,14,0,0,7,0,15,21,1
9693,167951,zX8EipUM7J0ifhENZyJ19KxHpsJKH6Ul,3VkHkmOtom3jM2wCu94xgzzu1d6Dn7or,2,0,0,0,0,0,5,0,5,0.7142857142857143,1,0.0,0,0,0,0,0,0,0,5,0,0,5,1
9694,168003,y1x8e9Sqq47SjNlkaBvMyt0S6tF2mWwv,fbPkOYLVPtPgIt0MxizjfFJov3JbHyAi,4,3,1,0,1,0,1,0,6,0.8571428571428571,1,0.0,0,1,0,1,3,0,0,1,0,2,4,1
9695,168004,nK13dP33HOsCMcudkGT9g2i4LS1y6QrD,fbPkOYLVPtPgIt0MxizjfFJov3JbHyAi,9,6,4,0,2,0,3,0,15,2.142857142857143,1,0.0,0,4,0,2,6,0,0,3,0,6,9,1
9696,168005,XpdwIP2CAxCi5EEwdtYqsnWn1GswP4MJ,fbPkOYLVPtPgIt0MxizjfFJov3JbHyAi,25,23,15,26,10,0,3,0,77,11.0,2,0.0,6,15,25,10,17,0,1,3,0,56,21,1
9697,168006,a8QEUUyZeFybf89xc7mwLuT0kKVfakw4,fbPkOYLVPtPgIt0MxizjfFJov3JbHyAi,1,0,0,0,0,0,1,0,1,0.14285714285714285,1,0.0,0,0,0,0,0,0,0,1,0,0,1,1
9698,168007,cFg7b49sFJZmDzd2wumcUexf3Q4M4csm,fbPkOYLVPtPgIt0MxizjfFJov3JbHyAi,5,2,1,0,1,0,2,0,6,0.8571428571428571,1,0.0,0,1,0,1,2,0,0,2,0,2,4,1
9699,168008,Es60P2jDBCO8AUpFrcBtniYYzniYIciC,fbPkOYLVPtPgIt0MxizjfFJov3JbHyAi,8,9,5,0,4,5,2,0,25,3.5714285714285716,1,0.0,0,5,0,4,9,5,0,2,0,9,16,1
9700,168009,HzIanfTE4wgwHrp1kwNpPTkpGpp6pHZj,fbPkOYLVPtPgIt0MxizjfFJov3JbHyAi,1,0,0,0,0,0,1,0,1,0.14285714285714285,1,0.0,0,0,0,0,0,0,0,1,0,0,1,1
9701,168010,dHobMPF85CwLnL5PBGltrpvI7vF4buSv,fbPkOYLVPtPgIt0MxizjfFJov3JbHyAi,1,0,0,0,0,0,1,0,1,0.14285714285714285,1,0.0,0,0,0,0,0,0,0,1,0,0,1,1
9702,168011,4cJUuVTAIhyyuSqreV0gX0h7VcUA6TDH,fbPkOYLVPtPgIt0MxizjfFJov3JbHyAi,1,0,0,0,0,0,2,0,2,0.2857142857142857,2,0.0,0,0,0,0,0,0,0,2,0,0,2,1
9703,168012,z2mvsBsVSR04tXPZpruVlEbUTspLhDcg,fbPkOYLVPtPgIt0MxizjfFJov3JbHyAi,16,15,6,12,7,0,8,1,49,7.0,1,0.0,7,6,8,7,8,0,4,8,1,28,21,1
9704,168013,nYSFDE8RCbcZhD46fRSvPHUvA1ahfupi,fbPkOYLVPtPgIt0MxizjfFJov3JbHyAi,7,3,2,0,2,0,2,0,9,1.2857142857142858,1,0.0,0,2,0,2,3,0,0,2,0,4,5,0
9705,168014,4mlUaTkpZXC4iECGR0SaagnPGaT0J0Vl,fbPkOYLVPtPgIt0MxizjfFJov3JbHyAi,8,14,5,0,5,0,4,0,28,4.0,1,0.0,5,5,0,5,9,0,0,4,0,15,13,1
9706,168016,Xdurokd2SSgNf25hifq07OxoiHEDcyiq,fbPkOYLVPtPgIt0MxizjfFJov3JbHyAi,7,2,1,0,0,0,7,1,11,1.5714285714285714,1,0.0,0,1,0,0,2,0,0,7,1,1,10,1
9707,168017,HOg8IFud3YOeqibycclJf11M4k8RWkqi,fbPkOYLVPtPgIt0MxizjfFJov3JbHyAi,2,0,0,0,0,0,2,0,2,0.2857142857142857,1,0.0,0,0,0,0,0,0,0,2,0,0,2,1
9708,168018,VXagNOkZu5u5I8qpPT9MJuCTffG8dhWL,fbPkOYLVPtPgIt0MxizjfFJov3JbHyAi,12,6,4,0,2,5,6,1,24,3.4285714285714284,1,0.0,0,4,0,2,6,5,0,6,1,6,18,1
9709,168022,lmNEyMpBiUCXqFMVYwQrEECYmQuekARf,fbPkOYLVPtPgIt0MxizjfFJov3JbHyAi,7,4,1,0,1,0,9,0,15,2.142857142857143,2,0.0,0,1,0,1,4,0,0,9,0,2,13,1
9710,168024,IgtxjUuJpTq8y2IFrRLOetFo0KHctvB1,fbPkOYLVPtPgIt0MxizjfFJov3JbHyAi,1,0,0,0,0,0,1,0,1,0.14285714285714285,1,0.0,0,0,0,0,0,0,0,1,0,0,1,1
9711,168025,t0lnsmteGxhchvfn5egpM8riZQppmKLf,fbPkOYLVPtPgIt0MxizjfFJov3JbHyAi,11,22,4,8,11,0,2,0,47,6.714285714285714,1,0.0,17,4,6,11,5,0,2,2,0,38,9,1
9712,168026,2viub6InFwMLthqb8hJjmGF9NgF8w6Xs,fbPkOYLVPtPgIt0MxizjfFJov3JbHyAi,1,0,0,0,0,0,2,0,2,0.2857142857142857,1,0.0,0,0,0,0,0,0,0,2,0,0,2,1
9713,168027,JmbMCXw3MrYzCKQfBJj8oDR9fKlwh8X1,fbPkOYLVPtPgIt0MxizjfFJov3JbHyAi,6,3,1,0,1,0,2,0,7,1.0,1,0.0,0,1,0,1,3,0,0,2,0,2,5,1
9714,168029,hdKqkkWKrDzbKE9btGChBqiCfsTwp68E,fbPkOYLVPtPgIt0MxizjfFJov3JbHyAi,3,0,0,0,0,0,3,0,3,0.42857142857142855,1,0.0,0,0,0,0,0,0,0,3,0,0,3,0
9715,168030,TDBIQnqVyutxiXfwsNyCSusIbuDGxAUR,fbPkOYLVPtPgIt0MxizjfFJov3JbHyAi,18,28,11,15,5,0,4,0,63,9.0,1,0.0,11,11,12,5,17,0,3,4,0,39,24,1
9716,168033,OquQs3UlUuQySKKaB7T4hGbXWUMNQkYa,fbPkOYLVPtPgIt0MxizjfFJov3JbHyAi,1,0,0,0,0,0,1,0,1,0.14285714285714285,1,0.0,0,0,0,0,0,0,0,1,0,0,1,1
9717,168037,yBA6ehs866IQnEEGqpirUYIaPzkZZLJ6,3VkHkmOtom3jM2wCu94xgzzu1d6Dn7or,5,0,0,0,0,0,5,1,6,0.8571428571428571,1,0.0,0,0,0,0,0,0,0,5,1,0,6,1
9718,168046,iv81Q81guaacxQhe1lswOCJQhpTUkWGC,3VkHkmOtom3jM2wCu94xgzzu1d6Dn7or,6,1,1,0,1,0,3,0,6,0.8571428571428571,1,0.0,0,1,0,1,1,0,0,3,0,2,4,1
9719,168047,W204KyzLRJNYs8mmnLeuVypzQYU0ofDZ,3VkHkmOtom3jM2wCu94xgzzu1d6Dn7or,4,3,1,0,0,0,3,0,7,1.0,1,0.0,0,1,0,0,3,0,0,3,0,1,6,1
9720,168048,dhwdX4XTrnywKgn5lEC6WNcR4fGKk4cG,3VkHkmOtom3jM2wCu94xgzzu1d6Dn7or,7,4,2,0,1,0,4,0,11,1.5714285714285714,1,0.0,0,2,0,1,4,0,0,4,0,3,8,1
9721,168058,tQOAN9y1JNiE2HSkTuq37TMkk9NkfGoI,3VkHkmOtom3jM2wCu94xgzzu1d6Dn7or,3,2,1,0,0,0,2,0,5,0.7142857142857143,1,0.0,0,1,0,0,2,0,0,2,0,1,4,1
9722,168062,xBiO9124vyKa32Mt0b9RCRnNOHBsxMrI,3VkHkmOtom3jM2wCu94xgzzu1d6Dn7or,7,3,1,0,1,9,5,1,20,2.857142857142857,1,0.0,0,1,0,1,3,9,0,5,1,2,18,1
9723,168063,yQSxaM62MKQt9Zo5qHSYFAN1KQP78OWK,3VkHkmOtom3jM2wCu94xgzzu1d6Dn7or,4,4,1,0,1,0,2,0,8,1.1428571428571428,1,0.0,1,1,0,1,3,0,0,2,0,3,5,1
9724,168064,8r1wO8douiG9wPFG7rg5WG5F0cpQdW2l,3VkHkmOtom3jM2wCu94xgzzu1d6Dn7or,1,0,0,0,0,0,5,0,5,0.7142857142857143,1,0.0,0,0,0,0,0,0,0,5,0,0,5,1
9725,168070,rEOQ3Awf5wtqfh22N4NGB0n7ep7F1Fxc,3VkHkmOtom3jM2wCu94xgzzu1d6Dn7or,13,15,4,5,4,6,6,1,41,5.857142857142857,1,0.0,6,4,5,4,9,6,0,6,1,19,22,1
9726,168073,qxM3np03v0HLILLQ0O4ivkrRKIURuEyI,3VkHkmOtom3jM2wCu94xgzzu1d6Dn7or,1,0,0,0,0,0,1,0,1,0.14285714285714285,1,0.0,0,0,0,0,0,0,0,1,0,0,1,0
9727,168075,C06Ud48QDIYOx7TH16k0jctmZ3ytNfUL,3VkHkmOtom3jM2wCu94xgzzu1d6Dn7or,3,2,1,0,0,1,2,0,6,0.8571428571428571,1,0.0,0,1,0,0,2,1,0,2,0,1,5,1
9728,168081,X8G5fdVVuPNoIiQKh4Ql7xFEGqHtVJdj,3VkHkmOtom3jM2wCu94xgzzu1d6Dn7or,9,6,3,0,2,1,5,1,18,2.5714285714285716,1,0.0,1,3,0,2,5,1,0,5,1,6,12,1
9729,168083,eRwAFWCpqN9m5JKZkkSIBHjyWcmU0NBC,3VkHkmOtom3jM2wCu94xgzzu1d6Dn7or,8,4,2,0,2,0,6,0,14,2.0,1,0.0,1,2,0,2,3,0,0,6,0,5,9,1
9730,168084,gja6YDDPL23ymxplMJ54bjIUaxr2GJww,3VkHkmOtom3jM2wCu94xgzzu1d6Dn7or,1,0,0,0,0,0,1,0,1,0.14285714285714285,1,0.0,0,0,0,0,0,0,0,1,0,0,1,1
9731,168086,vIZn10kjlyTUVoHhXIJOQucbfcLECr3W,3VkHkmOtom3jM2wCu94xgzzu1d6Dn7or,1,0,0,0,0,0,1,0,1,0.14285714285714285,1,0.0,0,0,0,0,0,0,0,1,0,0,1,1
9732,168090,bEF1Fjv4hCvZiIgEMiMXXPgFMz45YnrU,3VkHkmOtom3jM2wCu94xgzzu1d6Dn7or,1,0,0,0,0,0,1,0,1,0.14285714285714285,1,0.0,0,0,0,0,0,0,0,1,0,0,1,1
9733,168093,zwovE2UaujWuziUcUkYkqCQmn4CoHvRg,3VkHkmOtom3jM2wCu94xgzzu1d6Dn7or,5,15,3,0,1,0,5,0,24,3.4285714285714284,3,0.0,6,3,0,1,9,0,0,5,0,10,14,0
9734,168095,FR5tV9pEC96uXG4YgIIydXwP3bvsMqeW,3VkHkmOtom3jM2wCu94xgzzu1d6Dn7or,1,0,0,0,0,0,1,0,1,0.14285714285714285,1,0.0,0,0,0,0,0,0,0,1,0,0,1,1
9735,168097,3rhZjtaGSRI9L4woS8aldfdcClzzHTms,3VkHkmOtom3jM2wCu94xgzzu1d6Dn7or,17,35,11,9,10,10,14,1,90,12.857142857142858,1,0.0,16,11,7,10,19,10,2,14,1,44,46,1
9736,168098,YFhxdgCv825lGNZgMqxJBBxsVK16uCWj,3VkHkmOtom3jM2wCu94xgzzu1d6Dn7or,1,0,0,0,0,0,1,0,1,0.14285714285714285,1,0.0,0,0,0,0,0,0,0,1,0,0,1,1
9737,168100,DBSkznK5g5GyJVMJBIMHvO8oMI18vDSt,3VkHkmOtom3jM2wCu94xgzzu1d6Dn7or,6,4,2,0,1,2,3,0,12,1.7142857142857142,1,0.0,0,2,0,1,4,2,0,3,0,3,9,1
9738,168107,Ox6nN4HiRipUWxmVCBCPlVELFdZUFRfc,3VkHkmOtom3jM2wCu94xgzzu1d6Dn7or,1,0,0,0,0,0,2,0,2,0.2857142857142857,1,0.0,0,0,0,0,0,0,0,2,0,0,2,1
9739,168110,6sGUhPoisOkT2lXHT8neZ8zYn2yneVpQ,3VkHkmOtom3jM2wCu94xgzzu1d6Dn7or,16,23,9,16,10,4,13,4,79,11.285714285714286,2,0.0,12,9,12,10,11,4,4,13,4,43,36,1
9740,168115,BCBD5gR7OPhkrIrwv07fYZ8qI8lOiKfh,3VkHkmOtom3jM2wCu94xgzzu1d6Dn7or,5,3,1,0,1,0,2,0,7,1.0,1,0.0,1,1,0,1,2,0,0,2,0,3,4,1
9741,168120,MjvRR6RwQrwPwA7GzMV5Yj7dhQX7Hhlc,3VkHkmOtom3jM2wCu94xgzzu1d6Dn7or,7,5,3,0,1,0,6,0,15,2.142857142857143,1,0.0,0,3,0,1,5,0,0,6,0,4,11,1
9742,168121,6dTqxIFVnVmNgJwbnUg7wwmRvmNmw63p,3VkHkmOtom3jM2wCu94xgzzu1d6Dn7or,1,0,0,0,0,0,3,0,3,0.42857142857142855,2,0.0,0,0,0,0,0,0,0,3,0,0,3,1
9743,168132,IgexhZ9xriCDdGfY04wPYqqhzLtdPh8J,3VkHkmOtom3jM2wCu94xgzzu1d6Dn7or,4,2,1,0,1,0,1,0,5,0.7142857142857143,1,0.0,0,1,0,1,2,0,0,1,0,2,3,1
9744,168134,89QHMWhXsxXRliuaCUUwCtuK3CRrIyHu,3VkHkmOtom3jM2wCu94xgzzu1d6Dn7or,4,3,0,0,1,0,1,0,5,0.7142857142857143,1,0.0,0,0,0,1,3,0,0,1,0,1,4,1
9745,168136,HjEi0gkLp3inXyNF6Iip7gKrjiv5W7sn,3VkHkmOtom3jM2wCu94xgzzu1d6Dn7or,4,2,1,0,1,0,1,0,5,0.7142857142857143,1,0.0,0,1,0,1,2,0,0,1,0,2,3,1
9746,168137,GmLvsHRNVBLlsqFG2X5F2zo5DCtQqyMZ,3VkHkmOtom3jM2wCu94xgzzu1d6Dn7or,28,36,23,33,16,18,5,0,131,18.714285714285715,1,0.0,9,23,25,16,27,18,8,5,0,73,58,1
9747,168139,shc7uF4KqbgQOwuvfxvtyeDkoT0qwCL8,3VkHkmOtom3jM2wCu94xgzzu1d6Dn7or,5,5,2,0,1,2,2,0,12,1.7142857142857142,1,0.0,0,2,0,1,5,2,0,2,0,3,9,1
9748,168143,PKw8c6ORRRQTFuJkbH1BpRyfxkDFNvqA,3VkHkmOtom3jM2wCu94xgzzu1d6Dn7or,3,0,0,0,0,0,6,0,6,0.8571428571428571,1,0.0,0,0,0,0,0,0,0,6,0,0,6,1
9749,168148,O52kxKMXNR07VQE3q6LCLzHeQQgosJva,3VkHkmOtom3jM2wCu94xgzzu1d6Dn7or,5,3,2,0,2,0,2,0,9,1.2857142857142858,1,0.0,0,2,0,2,3,0,0,2,0,4,5,1
9750,168149,luBkIXZ29F78l8NfQh7jHzsnHIHWT9U3,3VkHkmOtom3jM2wCu94xgzzu1d6Dn7or,1,0,0,0,0,0,1,0,1,0.14285714285714285,1,0.0,0,0,0,0,0,0,0,1,0,0,1,1
9751,168150,9OIaKMciRYSBKojjJkSVxRY14rxnAGm9,3VkHkmOtom3jM2wCu94xgzzu1d6Dn7or,1,0,0,0,0,0,1,0,1,0.14285714285714285,1,0.0,0,0,0,0,0,0,0,1,0,0,1,1
9752,168153,klAUBDLmli7j7KhjhK35fgAxH41JA6QX,3VkHkmOtom3jM2wCu94xgzzu1d6Dn7or,1,0,0,0,0,0,1,0,1,0.14285714285714285,1,0.0,0,0,0,0,0,0,0,1,0,0,1,1
9753,168155,ARdFSWQ1GxaNn6PBNKVf6I4toWBTAKik,3VkHkmOtom3jM2wCu94xgzzu1d6Dn7or,6,4,1,0,1,1,3,0,10,1.4285714285714286,1,0.0,0,1,0,1,4,1,0,3,0,2,8,1
9754,168173,DOqW7ZgNB5RF5NBR6Owtbo9ht5tRzQN0,3VkHkmOtom3jM2wCu94xgzzu1d6Dn7or,1,0,0,0,0,0,1,0,1,0.14285714285714285,1,0.0,0,0,0,0,0,0,0,1,0,0,1,1
9755,169705,Qty87BeKrf3ZgzVA2PT9rBe28vADAPbJ,fbPkOYLVPtPgIt0MxizjfFJov3JbHyAi,1,0,0,0,0,0,1,0,1,0.14285714285714285,1,0.0,0,0,0,0,0,0,0,1,0,0,1,1
9756,169706,fOakfJTYCPFebY0FybXtYL6idxxEyzTF,fbPkOYLVPtPgIt0MxizjfFJov3JbHyAi,1,0,0,0,0,0,1,0,1,0.14285714285714285,1,0.0,0,0,0,0,0,0,0,1,0,0,1,1
9757,169707,nLrM8vScjpmrQXQxsgmVq01jtpvffZ5f,fbPkOYLVPtPgIt0MxizjfFJov3JbHyAi,15,14,10,0,10,16,22,4,76,10.857142857142858,2,0.0,4,10,0,10,10,16,0,22,4,24,52,1
9758,169708,vjQXzrFvLaQwZyfHQ9fXD06sgIXRTXIb,fbPkOYLVPtPgIt0MxizjfFJov3JbHyAi,7,3,3,0,0,2,5,0,13,1.8571428571428572,1,0.0,0,3,0,0,3,2,0,5,0,3,10,1
9759,169710,bJL1sGEdg6Wyh9EeL6PIHUn7Crptl1QG,fbPkOYLVPtPgIt0MxizjfFJov3JbHyAi,1,0,0,0,0,0,1,0,1,0.14285714285714285,1,0.0,0,0,0,0,0,0,0,1,0,0,1,1
9760,169713,pyfZ41TFTxhSHzDt2S7t9VZz1MMWuxRA,fbPkOYLVPtPgIt0MxizjfFJov3JbHyAi,5,2,1,0,1,0,6,0,10,1.4285714285714286,1,0.0,0,1,0,1,2,0,0,6,0,2,8,1
9761,169714,PRN4T27S0Ed1KQDhQvjLLGSSAs9PlL8U,fbPkOYLVPtPgIt0MxizjfFJov3JbHyAi,5,0,0,0,0,2,5,1,8,1.1428571428571428,1,0.0,0,0,0,0,0,2,0,5,1,0,8,1
9762,169716,sFNhRUf2M3OzBPb8K2dNpryYFfLRe3zg,fbPkOYLVPtPgIt0MxizjfFJov3JbHyAi,1,0,0,0,0,0,1,0,1,0.14285714285714285,1,0.0,0,0,0,0,0,0,0,1,0,0,1,1
9763,169720,dMZ9S55l3tq5M3A71U0KoWxXWAhXsFH4,fbPkOYLVPtPgIt0MxizjfFJov3JbHyAi,5,2,1,0,1,0,2,0,6,0.8571428571428571,1,0.0,0,1,0,1,2,0,0,2,0,2,4,1
9764,169724,e3UIGG7UQFKXGRFOxu4N5schAIY0VK0V,fbPkOYLVPtPgIt0MxizjfFJov3JbHyAi,16,8,7,0,7,0,1,0,23,3.2857142857142856,1,0.0,0,7,0,7,8,0,0,1,0,14,9,1
9765,169725,udxFfabXtaVUvVlT3wEleIvfDBGe9yE2,fbPkOYLVPtPgIt0MxizjfFJov3JbHyAi,3,2,1,0,0,0,1,0,4,0.5714285714285714,1,0.0,0,1,0,0,2,0,0,1,0,1,3,1
9766,169726,Jz6wD2B02Np9coR4hOXdRVlsstbtLmqi,fbPkOYLVPtPgIt0MxizjfFJov3JbHyAi,1,0,0,0,0,0,1,0,1,0.14285714285714285,1,0.0,0,0,0,0,0,0,0,1,0,0,1,1
9767,169727,C3Pi5p6u9Sqfn49wxkMeoM5LROfgAWhp,fbPkOYLVPtPgIt0MxizjfFJov3JbHyAi,1,0,0,0,0,0,1,0,1,0.14285714285714285,1,0.0,0,0,0,0,0,0,0,1,0,0,1,1
9768,169728,HNHPAxeVn8lGduUI2P4q9tnmqhZb68Gj,fbPkOYLVPtPgIt0MxizjfFJov3JbHyAi,1,0,0,0,0,0,1,0,1,0.14285714285714285,1,0.0,0,0,0,0,0,0,0,1,0,0,1,1
9769,169730,DU0dRtEpZksA4ySXAez5UVn9g5rHoTAA,fbPkOYLVPtPgIt0MxizjfFJov3JbHyAi,7,4,2,0,2,0,3,0,11,1.5714285714285714,1,0.0,0,2,0,2,4,0,0,3,0,4,7,1
9770,169731,yOmriI6ep4L8AeXfk2CRItQ1EOEJgSeE,fbPkOYLVPtPgIt0MxizjfFJov3JbHyAi,7,4,3,0,3,0,2,0,12,1.7142857142857142,1,0.0,0,3,0,3,4,0,0,2,0,6,6,1
9771,169744,OvyzBsMeHykQgpohtqeEozx2gUjeaz4W,SpATywNh6bZuzm8s1ceuBUnMUAeoAHHw,1,0,0,0,0,0,1,0,1,0.14285714285714285,1,0.0,0,0,0,0,0,0,0,1,0,0,1,1
9772,169748,y2Rnds9c7epbZfY5NmTcovxVs1C2E7IV,bWdj2GDclj5ofokWjzoa5jAwMkxCykd6,8,8,5,0,3,0,7,0,23,3.2857142857142856,1,0.0,0,5,0,3,8,0,0,7,0,8,15,1
9773,169756,nq8bR2L0RLlBhmbma1mjdqiNKrD7Hg6k,SpATywNh6bZuzm8s1ceuBUnMUAeoAHHw,13,5,4,0,4,0,4,1,18,2.5714285714285716,1,0.0,0,4,0,4,5,0,0,4,1,8,10,1
9774,169772,l1rg3D8Gp1lv7dbBBYKvzTS3OZ5DRjWH,A3fsA9Zfv1X2fVEQhTw51lKENdNrEqT3,6,11,3,0,1,0,2,0,17,2.4285714285714284,2,0.0,0,3,0,1,11,0,0,2,0,4,13,1
9775,169794,cylVpn6BHNf8kPweB7o4j0HSX2fVNwi5,A3fsA9Zfv1X2fVEQhTw51lKENdNrEqT3,4,2,1,0,0,0,2,0,5,0.7142857142857143,1,0.0,0,1,0,0,2,0,0,2,0,1,4,1
9776,169795,FccHEWO9KmdNPDXhN4XXwGkY9yUcoH8v,SpATywNh6bZuzm8s1ceuBUnMUAeoAHHw,5,4,2,0,1,0,1,0,8,1.1428571428571428,1,0.0,1,2,0,1,3,0,0,1,0,4,4,1
9777,169809,nq8bR2L0RLlBhmbma1mjdqiNKrD7Hg6k,A3fsA9Zfv1X2fVEQhTw51lKENdNrEqT3,1,0,0,0,0,0,1,0,1,0.14285714285714285,1,0.0,0,0,0,0,0,0,0,1,0,0,1,1
9778,169829,6GeExq2Om9NgCQlFWmX6OmXCDvqcKYNs,SpATywNh6bZuzm8s1ceuBUnMUAeoAHHw,1,0,0,0,0,0,1,0,1,0.14285714285714285,1,0.0,0,0,0,0,0,0,0,1,0,0,1,1
9779,169875,lHbmOzIWgsm3PCeLav5Cu1g7w64ZHBaT,A3fsA9Zfv1X2fVEQhTw51lKENdNrEqT3,2,0,0,0,0,0,2,0,2,0.2857142857142857,1,0.0,0,0,0,0,0,0,0,2,0,0,2,1
9780,169881,WuM67GwQW9M3d1mnuGHuvAdo907S9qb5,RXDvfPUBYFlVdlueBFbLW0mhhAyGEqpt,1,0,0,0,0,0,1,0,1,0.14285714285714285,1,0.0,0,0,0,0,0,0,0,1,0,0,1,1
9781,169883,9d8tCYKPfh5NHPKNlwRKmrZh3Cuf1Ls2,5X6FeZozNMgE2VRi3MJYjkkFK8SETtu2,5,2,1,0,1,0,2,0,6,0.8571428571428571,1,0.0,0,1,0,1,2,0,0,2,0,2,4,1
9782,169914,EX4mN8VqjmDrg8vjZaJJar6Z7qHJihO0,SpATywNh6bZuzm8s1ceuBUnMUAeoAHHw,34,35,23,27,13,0,8,0,106,15.142857142857142,2,0.0,6,23,26,13,29,0,1,8,0,68,38,0
9783,169917,yFXHvM6fTTugrF5MDphTCRW2RH58bXB8,SpATywNh6bZuzm8s1ceuBUnMUAeoAHHw,1,0,0,0,0,0,1,0,1,0.14285714285714285,1,0.0,0,0,0,0,0,0,0,1,0,0,1,1
9784,169931,pNxzaJ7czZs2paRXphWc0CFfqptKuUuk,SpATywNh6bZuzm8s1ceuBUnMUAeoAHHw,2,0,0,0,0,0,2,0,2,0.2857142857142857,1,0.0,0,0,0,0,0,0,0,2,0,0,2,1
9785,169937,0pwRthAyOuKJqUTbZQ5B9PuHR9GODfUb,bWdj2GDclj5ofokWjzoa5jAwMkxCykd6,2,0,0,0,0,0,2,0,2,0.2857142857142857,1,0.0,0,0,0,0,0,0,0,2,0,0,2,1
9786,169938,Im85u8aENweba95uFnFOR6zdQWFnfDOq,SpATywNh6bZuzm8s1ceuBUnMUAeoAHHw,12,20,12,0,9,0,5,0,46,6.571428571428571,2,0.0,0,12,0,9,20,0,0,5,0,21,25,0
9787,169940,psOlazQpS8qVFhUihS96dMxKvzvfbEdG,SpATywNh6bZuzm8s1ceuBUnMUAeoAHHw,1,0,0,0,0,0,1,0,1,0.14285714285714285,1,0.0,0,0,0,0,0,0,0,1,0,0,1,1
9788,169955,ZQcqpVyhrZVshH7yyuAn3ze3B9JEoNBU,SpATywNh6bZuzm8s1ceuBUnMUAeoAHHw,1,0,0,0,0,0,1,0,1,0.14285714285714285,1,0.0,0,0,0,0,0,0,0,1,0,0,1,1
9789,169959,YiYJ3RnpzhhfakeMA3KKlM5DPKZuE0U2,A3fsA9Zfv1X2fVEQhTw51lKENdNrEqT3,2,0,0,0,0,0,2,0,2,0.2857142857142857,1,0.0,0,0,0,0,0,0,0,2,0,0,2,1
9790,169970,8TgDXDhPJbH42a4mgSX8yE2cBRK4rk9E,A3fsA9Zfv1X2fVEQhTw51lKENdNrEqT3,8,11,4,0,2,0,1,0,18,2.5714285714285716,1,0.0,0,4,0,2,11,0,0,1,0,6,12,1
9791,169972,nd6FN1uteQdMlgn7WFsm0cYOCn3qlNSp,5X6FeZozNMgE2VRi3MJYjkkFK8SETtu2,8,14,7,0,0,0,2,0,23,3.2857142857142856,1,0.0,2,7,0,0,12,0,0,2,0,9,14,1
9792,169973,CaAAtghbZXcO6X5eGK5X6sBmcGDS3kOP,SpATywNh6bZuzm8s1ceuBUnMUAeoAHHw,6,3,2,0,1,0,2,0,8,1.1428571428571428,1,0.0,0,2,0,1,3,0,0,2,0,3,5,0
9793,169974,ENwYZFktafF6DBkaetRsi3gHPfNB3tq4,A3fsA9Zfv1X2fVEQhTw51lKENdNrEqT3,9,5,0,0,0,1,14,1,21,3.0,1,0.0,0,0,0,0,5,1,0,14,1,0,21,1
9794,169975,ENwYZFktafF6DBkaetRsi3gHPfNB3tq4,SpATywNh6bZuzm8s1ceuBUnMUAeoAHHw,1,0,0,0,0,0,1,0,1,0.14285714285714285,1,0.0,0,0,0,0,0,0,0,1,0,0,1,1
9795,169983,0HWrPPCNu1lUYotaev8lq3oZQkQoCkpc,SpATywNh6bZuzm8s1ceuBUnMUAeoAHHw,9,14,1,0,0,0,3,0,18,2.5714285714285716,2,0.0,5,1,0,0,9,0,0,3,0,6,12,1
9796,169991,nd6FN1uteQdMlgn7WFsm0cYOCn3qlNSp,RXDvfPUBYFlVdlueBFbLW0mhhAyGEqpt,1,0,0,0,0,0,1,0,1,0.14285714285714285,1,0.0,0,0,0,0,0,0,0,1,0,0,1,1
9797,169992,efMhgnP3jiriRpyWL0XFnZyh43mtSTkz,A3fsA9Zfv1X2fVEQhTw51lKENdNrEqT3,8,5,4,0,4,0,2,0,15,2.142857142857143,1,0.0,0,4,0,4,5,0,0,2,0,8,7,1
9798,170003,DcKXSEeQ89ZeT8g7MRCe0oPVKpSmR5Hy,SpATywNh6bZuzm8s1ceuBUnMUAeoAHHw,9,8,4,0,3,0,3,0,18,2.5714285714285716,1,0.0,0,4,0,3,8,0,0,3,0,7,11,1
9799,170009,c1BXmJNemroOPh6WUefTBD28s2WzSNwi,bWdj2GDclj5ofokWjzoa5jAwMkxCykd6,1,0,0,0,0,0,1,0,1,0.14285714285714285,1,0.0,0,0,0,0,0,0,0,1,0,0,1,1
9800,170012,qNeNwZ0RiirpZr2svt3nSu4cMQA6rxfD,SpATywNh6bZuzm8s1ceuBUnMUAeoAHHw,1,0,0,0,0,0,1,0,1,0.14285714285714285,1,0.0,0,0,0,0,0,0,0,1,0,0,1,1
9801,170022,nVB1o73xluQXZjoI2dUYHGxbCDG8qiCL,bWdj2GDclj5ofokWjzoa5jAwMkxCykd6,1,0,0,0,0,0,2,0,2,0.2857142857142857,2,0.0,0,0,0,0,0,0,0,2,0,0,2,1
9802,170025,nVB1o73xluQXZjoI2dUYHGxbCDG8qiCL,G8EPVSXsOYB5YQWZGiz1aVq5Pgr2GrQu,1,0,0,0,0,0,2,0,2,0.2857142857142857,2,0.0,0,0,0,0,0,0,0,2,0,0,2,1
9803,170032,GlWFWKrBQhsgqjbmoDsRUa17h8chqAsd,G8EPVSXsOYB5YQWZGiz1aVq5Pgr2GrQu,7,4,3,0,2,0,1,0,10,1.4285714285714286,1,0.0,0,3,0,2,4,0,0,1,0,5,5,1
9804,170036,qzripbhm6sAPdZP3rld8n0avyAjcFNv4,SpATywNh6bZuzm8s1ceuBUnMUAeoAHHw,33,60,0,39,0,3,12,1,115,16.428571428571427,1,0.0,15,0,36,0,45,3,3,12,1,51,64,0
9805,170044,lfES8Qg22nHD1A4W64dBxO7ocyuixyz5,A3fsA9Zfv1X2fVEQhTw51lKENdNrEqT3,4,4,0,0,0,0,2,0,6,0.8571428571428571,1,0.0,0,0,0,0,4,0,0,2,0,0,6,1
9806,170048,doHdEOs0q82jLy28L6Hfv3zDwo9QjYO3,RXDvfPUBYFlVdlueBFbLW0mhhAyGEqpt,37,19,10,94,3,0,3,0,129,18.428571428571427,1,0.0,8,10,84,3,11,0,10,3,0,105,24,1
9807,170052,0BZoLcfKf9byPVgIWe4JIdaHfKcl2a1l,SpATywNh6bZuzm8s1ceuBUnMUAeoAHHw,4,3,1,0,0,1,3,0,8,1.1428571428571428,1,0.0,0,1,0,0,3,1,0,3,0,1,7,1
9808,170067,eID9376EiTPMkaHLktJPJzqn752gqP8g,SpATywNh6bZuzm8s1ceuBUnMUAeoAHHw,1,0,0,0,0,0,1,0,1,0.14285714285714285,1,0.0,0,0,0,0,0,0,0,1,0,0,1,1
9809,170074,kVKn79Dzw2HLlceEVegtxNVWxEZTMxtD,SpATywNh6bZuzm8s1ceuBUnMUAeoAHHw,1,0,0,0,0,0,1,0,1,0.14285714285714285,1,0.0,0,0,0,0,0,0,0,1,0,0,1,1
9810,170099,eswvbpHhxCUZC3kUIoEHkNpn6ukXHFpo,bWdj2GDclj5ofokWjzoa5jAwMkxCykd6,9,4,2,0,1,1,6,1,15,2.142857142857143,1,0.0,0,2,0,1,4,1,0,6,1,3,12,1
9811,170112,eswvbpHhxCUZC3kUIoEHkNpn6ukXHFpo,A3fsA9Zfv1X2fVEQhTw51lKENdNrEqT3,1,0,0,0,0,0,1,0,1,0.14285714285714285,1,0.0,0,0,0,0,0,0,0,1,0,0,1,1
9812,170118,OqGnqzQVMnpIm866A4pewjS1mh1kb791,SpATywNh6bZuzm8s1ceuBUnMUAeoAHHw,12,7,5,0,4,0,2,0,18,2.5714285714285716,1,0.0,0,5,0,4,7,0,0,2,0,9,9,1
9813,170119,cnn74KELZnn17sK4hLaiUHoOBX1WWhRX,SpATywNh6bZuzm8s1ceuBUnMUAeoAHHw,5,2,1,0,1,0,2,0,6,0.8571428571428571,1,0.0,0,1,0,1,2,0,0,2,0,2,4,1
9814,170123,qzE4xRGg4xgP1uXuFdpBCVtFm7DMRWEv,RXDvfPUBYFlVdlueBFbLW0mhhAyGEqpt,1,0,0,0,0,0,1,0,1,0.14285714285714285,1,0.0,0,0,0,0,0,0,0,1,0,0,1,1
9815,170139,pX6AUa5JIwjW9c9ABN9fhrsE8rh9KfQD,A3fsA9Zfv1X2fVEQhTw51lKENdNrEqT3,3,2,0,0,0,0,2,0,4,0.5714285714285714,1,0.0,0,0,0,0,2,0,0,2,0,0,4,1
9816,170144,9usGYeWOVibHFz0rEL6E7CP6Ct5S1DH0,SpATywNh6bZuzm8s1ceuBUnMUAeoAHHw,21,35,11,26,6,19,6,1,104,14.857142857142858,1,0.0,21,11,21,6,14,19,5,6,1,59,45,0
9817,170185,xsymAvmYlqD9inxrUoE03K3fiSLIg6Ue,G8EPVSXsOYB5YQWZGiz1aVq5Pgr2GrQu,12,4,3,10,1,0,3,0,21,3.0,1,0.0,0,3,10,1,4,0,0,3,0,14,7,1
9818,170191,jmLTCTXsN9WLVzoZhDc3zVaQMsxr0zEd,SpATywNh6bZuzm8s1ceuBUnMUAeoAHHw,2,0,0,0,0,0,2,0,2,0.2857142857142857,1,0.0,0,0,0,0,0,0,0,2,0,0,2,1
9819,170195,4EXVYteC2ptv9b4cBjlMiXkbTqF5aUrJ,bWdj2GDclj5ofokWjzoa5jAwMkxCykd6,8,17,9,0,7,0,6,0,39,5.571428571428571,2,0.0,0,9,0,7,17,0,0,6,0,16,23,0
9820,170199,xn7AAZAQcVYNGAzyVQ0EYGs1M3dKXdIP,5X6FeZozNMgE2VRi3MJYjkkFK8SETtu2,1,0,0,0,0,0,1,0,1,0.14285714285714285,1,0.0,0,0,0,0,0,0,0,1,0,0,1,1
9821,170205,mKHQM9iW9olu6z2WamdxK7ySH3UwX3JX,A3fsA9Zfv1X2fVEQhTw51lKENdNrEqT3,8,6,3,0,3,0,1,0,13,1.8571428571428572,1,0.0,0,3,0,3,6,0,0,1,0,6,7,1
9822,170206,mKHQM9iW9olu6z2WamdxK7ySH3UwX3JX,bWdj2GDclj5ofokWjzoa5jAwMkxCykd6,4,3,2,0,2,0,2,0,9,1.2857142857142858,1,0.0,0,2,0,2,3,0,0,2,0,4,5,1
9823,170210,aTjvPI2iFI189YCZUCxZxvdMjy8al9W5,bWdj2GDclj5ofokWjzoa5jAwMkxCykd6,6,3,1,0,1,3,3,1,12,1.7142857142857142,1,0.0,0,1,0,1,3,3,0,3,1,2,10,1
9824,170214,HRAHfkJWDcqgd2I7oG554GqTRMzsGK4Y,SpATywNh6bZuzm8s1ceuBUnMUAeoAHHw,6,4,3,0,3,0,1,0,11,1.5714285714285714,1,0.0,0,3,0,3,4,0,0,1,0,6,5,1
9825,170217,YlkBfY3JYnCVTegjhYYLbUIucjxFlohz,SpATywNh6bZuzm8s1ceuBUnMUAeoAHHw,4,6,2,0,2,0,1,0,11,1.5714285714285714,1,0.0,0,2,0,2,6,0,0,1,0,4,7,1
9826,170232,b2YuB9tGGneJ6gHz59BSLslOC7EMmDny,5X6FeZozNMgE2VRi3MJYjkkFK8SETtu2,2,0,0,0,0,0,2,0,2,0.2857142857142857,1,0.0,0,0,0,0,0,0,0,2,0,0,2,1
9827,170237,2rkVSHJoohi3dFRGQS0yfCMFa6MXi3Zo,G8EPVSXsOYB5YQWZGiz1aVq5Pgr2GrQu,5,2,1,0,1,0,2,0,6,0.8571428571428571,1,0.0,0,1,0,1,2,0,0,2,0,2,4,0
9828,170245,VXBTEalT0R9120bnGfzjxPXNZh5Vbgmq,SpATywNh6bZuzm8s1ceuBUnMUAeoAHHw,7,6,3,0,3,4,2,0,18,2.5714285714285716,1,0.0,1,3,0,3,5,4,0,2,0,7,11,1
9829,170250,7jkKKf5Pb7FrtJ3WnuF11G7ePioUPJm3,bWdj2GDclj5ofokWjzoa5jAwMkxCykd6,9,7,3,8,2,0,1,0,21,3.0,1,0.0,2,3,7,2,5,0,1,1,0,14,7,1
9830,170256,swwz7JrCk6SSVzLZGIACLItBCrSwx9u5,G8EPVSXsOYB5YQWZGiz1aVq5Pgr2GrQu,5,2,1,0,1,1,2,0,7,1.0,1,0.0,0,1,0,1,2,1,0,2,0,2,5,1
9831,170257,UYAHgDyJ2Tcd8fTB7PMLIt7CemKCJ2QW,SpATywNh6bZuzm8s1ceuBUnMUAeoAHHw,5,3,1,0,1,0,1,0,6,0.8571428571428571,1,0.0,0,1,0,1,3,0,0,1,0,2,4,0
9832,170261,UtDl3V8DNRzEFcwy9KRNynJ2PmttEbfZ,A3fsA9Zfv1X2fVEQhTw51lKENdNrEqT3,1,0,0,0,0,0,1,0,1,0.14285714285714285,1,0.0,0,0,0,0,0,0,0,1,0,0,1,1
9833,170262,RHsk3gHUm8VEfb9FwEFf8vBDNKZZ0LWe,bWdj2GDclj5ofokWjzoa5jAwMkxCykd6,6,6,3,0,2,0,2,0,13,1.8571428571428572,2,0.0,0,3,0,2,6,0,0,2,0,5,8,0
9834,170267,fsa5eUp1FAxhAJPW5saWrncHzv3fRgY9,G8EPVSXsOYB5YQWZGiz1aVq5Pgr2GrQu,5,3,1,0,1,0,2,0,7,1.0,1,0.0,0,1,0,1,3,0,0,2,0,2,5,1
9835,170270,iLrqT1cSiRqHGveKnknegGGgRshrAyXQ,5X6FeZozNMgE2VRi3MJYjkkFK8SETtu2,1,0,0,0,0,0,1,0,1,0.14285714285714285,1,0.0,0,0,0,0,0,0,0,1,0,0,1,1
9836,170280,NCBu044YJ6cJynCHYXs0OvCxWHZI0vpq,G8EPVSXsOYB5YQWZGiz1aVq5Pgr2GrQu,26,27,1,42,1,0,6,0,77,11.0,1,0.0,10,1,30,1,17,0,12,6,0,42,35,1
9837,170284,3RtHMyLQOrBsDYp6yo5VYdmS72cr3PBJ,bWdj2GDclj5ofokWjzoa5jAwMkxCykd6,1,0,0,0,0,0,1,0,1,0.14285714285714285,1,0.0,0,0,0,0,0,0,0,1,0,0,1,1
9838,170285,o56PfLr9PVlnT6N93Wz2ZLd3CTVky6be,5X6FeZozNMgE2VRi3MJYjkkFK8SETtu2,2,0,0,0,0,0,2,0,2,0.2857142857142857,1,0.0,0,0,0,0,0,0,0,2,0,0,2,1
9839,170289,X5lHw1AxbbdtGtMwcFokHHx0DhgrLuga,A3fsA9Zfv1X2fVEQhTw51lKENdNrEqT3,7,4,1,0,1,0,4,0,10,1.4285714285714286,1,0.0,0,1,0,1,4,0,0,4,0,2,8,1
9840,170292,Er5Dx1VYZA5KPMIiofLN6XXsRVBHZC9O,bWdj2GDclj5ofokWjzoa5jAwMkxCykd6,4,6,0,0,2,0,3,0,11,1.5714285714285714,1,0.0,4,0,0,2,2,0,0,3,0,6,5,1
9841,170296,wRbgPPUvYB6ZlrnmYszdH1VnMwMSKbo2,5X6FeZozNMgE2VRi3MJYjkkFK8SETtu2,7,14,4,0,3,1,3,0,25,3.5714285714285716,1,0.0,5,4,0,3,9,1,0,3,0,12,13,1
9842,170303,iUkHDNKZ4bOUlO8vGO6PBLpFErxQEC8i,G8EPVSXsOYB5YQWZGiz1aVq5Pgr2GrQu,11,8,3,0,3,2,12,1,29,4.142857142857143,2,0.0,4,3,0,3,4,2,0,12,1,10,19,1
9843,170306,Wx7ETkleaL3Fyykpu37NhlN4Ie0dZ7pu,SpATywNh6bZuzm8s1ceuBUnMUAeoAHHw,16,12,5,14,2,1,7,1,42,6.0,1,0.0,5,5,13,2,7,1,1,7,1,25,17,1
9844,170325,uQxbjtHxFoHot71DeFcBUm8Aql3Ydxlf,A3fsA9Zfv1X2fVEQhTw51lKENdNrEqT3,1,0,0,0,0,0,1,0,1,0.14285714285714285,1,0.0,0,0,0,0,0,0,0,1,0,0,1,1
9845,170328,rH2Cjv1VlyMXQ27h94dZK6rpepTfi6AT,G8EPVSXsOYB5YQWZGiz1aVq5Pgr2GrQu,6,4,1,0,1,0,3,0,9,1.2857142857142858,1,0.0,0,1,0,1,4,0,0,3,0,2,7,0
9846,170331,KPslRN2YAOypBl73zfwv2LjX4ZpoUZbN,SpATywNh6bZuzm8s1ceuBUnMUAeoAHHw,1,0,0,0,0,0,1,0,1,0.14285714285714285,1,0.0,0,0,0,0,0,0,0,1,0,0,1,1
9847,170335,FhVGWSUXUeZGSguiLBd186fsM4sRhpPL,5X6FeZozNMgE2VRi3MJYjkkFK8SETtu2,1,0,0,0,0,0,1,0,1,0.14285714285714285,1,0.0,0,0,0,0,0,0,0,1,0,0,1,1
9848,170336,evowo3Yg2sbVP9DdhhK3sw1dGIBBhaou,5X6FeZozNMgE2VRi3MJYjkkFK8SETtu2,4,2,1,0,0,0,3,0,6,0.8571428571428571,1,0.0,0,1,0,0,2,0,0,3,0,1,5,0
9849,170338,psMTfW7QvxtgOLRP4q0lNv6630lUr3rk,bWdj2GDclj5ofokWjzoa5jAwMkxCykd6,1,0,0,0,0,0,1,0,1,0.14285714285714285,1,0.0,0,0,0,0,0,0,0,1,0,0,1,1
9850,170340,psMTfW7QvxtgOLRP4q0lNv6630lUr3rk,G8EPVSXsOYB5YQWZGiz1aVq5Pgr2GrQu,1,0,0,0,0,0,2,0,2,0.2857142857142857,1,0.0,0,0,0,0,0,0,0,2,0,0,2,1
9851,170354,ung1DnQyYgd0tfz7mAKTwJrrm5UPHWt1,5X6FeZozNMgE2VRi3MJYjkkFK8SETtu2,1,0,0,0,0,0,1,0,1,0.14285714285714285,1,0.0,0,0,0,0,0,0,0,1,0,0,1,1
9852,170355,ung1DnQyYgd0tfz7mAKTwJrrm5UPHWt1,bWdj2GDclj5ofokWjzoa5jAwMkxCykd6,1,0,0,0,0,0,1,0,1,0.14285714285714285,1,0.0,0,0,0,0,0,0,0,1,0,0,1,1
9853,170358,vaWLVKWyrsUzDV0qs20ZUq8M3VNW01Uk,5X6FeZozNMgE2VRi3MJYjkkFK8SETtu2,1,0,0,0,0,0,1,0,1,0.14285714285714285,1,0.0,0,0,0,0,0,0,0,1,0,0,1,1
9854,170366,6pDumvu8BZSGMSLuGPFtyDgiupPPSlqU,SpATywNh6bZuzm8s1ceuBUnMUAeoAHHw,2,0,0,0,0,0,2,0,2,0.2857142857142857,1,0.0,0,0,0,0,0,0,0,2,0,0,2,1
9855,170368,6pDumvu8BZSGMSLuGPFtyDgiupPPSlqU,A3fsA9Zfv1X2fVEQhTw51lKENdNrEqT3,1,0,0,0,0,0,1,0,1,0.14285714285714285,1,0.0,0,0,0,0,0,0,0,1,0,0,1,1
9856,170378,Wx7ETkleaL3Fyykpu37NhlN4Ie0dZ7pu,5X6FeZozNMgE2VRi3MJYjkkFK8SETtu2,1,0,0,0,0,0,1,0,1,0.14285714285714285,1,0.0,0,0,0,0,0,0,0,1,0,0,1,1
9857,170397,fW4fbh90nu73Q6G9ndiED1PUrE0wupYF,A3fsA9Zfv1X2fVEQhTw51lKENdNrEqT3,2,0,0,0,0,0,2,0,2,0.2857142857142857,1,0.0,0,0,0,0,0,0,0,2,0,0,2,1
9858,170400,qlV7NVEcCnAsxKC17kpoGCtCEpV1bUS5,A3fsA9Zfv1X2fVEQhTw51lKENdNrEqT3,2,0,0,0,0,0,4,0,4,0.5714285714285714,1,0.0,0,0,0,0,0,0,0,4,0,0,4,1
9859,170402,XE3LSwpMCRZZGzcKtnVar50VzWsD5gVI,SpATywNh6bZuzm8s1ceuBUnMUAeoAHHw,12,18,3,0,4,0,6,0,31,4.428571428571429,2,0.0,0,3,0,4,18,0,0,6,0,7,24,1
9860,170403,TY1XSpzUxZYHUqU0tQYtstvuwKCsGYpR,SpATywNh6bZuzm8s1ceuBUnMUAeoAHHw,4,3,1,0,0,0,1,0,5,0.7142857142857143,1,0.0,0,1,0,0,3,0,0,1,0,1,4,1
9861,170411,QUAD8F1Sq1DKmhs6zkaRy7xSaSvEw9YZ,A3fsA9Zfv1X2fVEQhTw51lKENdNrEqT3,1,0,0,0,0,0,1,0,1,0.14285714285714285,1,0.0,0,0,0,0,0,0,0,1,0,0,1,1
9862,170412,Z6SakRvyvh7ZuaV4DHEE1b3QLOpPcfOm,SpATywNh6bZuzm8s1ceuBUnMUAeoAHHw,11,10,0,10,0,0,1,0,21,3.0,1,0.0,2,0,10,0,8,0,0,1,0,12,9,0
9863,170422,VvP04bcu30Fnz43GLgwdKHeQEInNAaGy,5X6FeZozNMgE2VRi3MJYjkkFK8SETtu2,1,0,0,0,0,0,1,0,1,0.14285714285714285,1,0.0,0,0,0,0,0,0,0,1,0,0,1,1
9864,170425,iKgnPLhvVQse7oL8jh4sOm9046t6sK9B,bWdj2GDclj5ofokWjzoa5jAwMkxCykd6,5,3,1,6,0,0,2,0,12,1.7142857142857142,1,0.0,1,1,6,0,2,0,0,2,0,8,4,1
9865,170426,2e7MDrs8EueOP7qJPm2dG8jdhtuWqNSF,5X6FeZozNMgE2VRi3MJYjkkFK8SETtu2,2,0,0,0,0,0,2,0,2,0.2857142857142857,1,0.0,0,0,0,0,0,0,0,2,0,0,2,1
9866,170430,ilUzpPaeFISeGNY7Nt0DehBLL3wxQX0O,SpATywNh6bZuzm8s1ceuBUnMUAeoAHHw,1,0,0,0,0,0,1,0,1,0.14285714285714285,1,0.0,0,0,0,0,0,0,0,1,0,0,1,1
9867,170433,CDy3wblikhG2TGdNI3LhbAglknKqeMeq,bWdj2GDclj5ofokWjzoa5jAwMkxCykd6,1,0,0,0,0,0,1,0,1,0.14285714285714285,1,0.0,0,0,0,0,0,0,0,1,0,0,1,1
9868,170434,CDy3wblikhG2TGdNI3LhbAglknKqeMeq,G8EPVSXsOYB5YQWZGiz1aVq5Pgr2GrQu,1,0,0,0,0,0,1,0,1,0.14285714285714285,1,0.0,0,0,0,0,0,0,0,1,0,0,1,0
9869,170458,DIfj5Ba2axfDE4LFDWqKjVBCgesW8XXW,A3fsA9Zfv1X2fVEQhTw51lKENdNrEqT3,10,18,5,0,3,0,4,0,30,4.285714285714286,2,0.0,0,5,0,3,18,0,0,4,0,8,22,1
9870,170462,dPRqQnPaOK2cLqC8FD45Cje7upJIkPFz,RXDvfPUBYFlVdlueBFbLW0mhhAyGEqpt,11,20,1,0,1,3,3,1,29,4.142857142857143,1,0.0,0,1,0,1,20,3,0,3,1,2,27,1
9871,170467,m8tZWvMesr1zQS0esJJogsiMlXHxe2Cd,RXDvfPUBYFlVdlueBFbLW0mhhAyGEqpt,1,0,0,0,0,0,1,0,1,0.14285714285714285,1,0.0,0,0,0,0,0,0,0,1,0,0,1,1
9872,170469,m8tZWvMesr1zQS0esJJogsiMlXHxe2Cd,A3fsA9Zfv1X2fVEQhTw51lKENdNrEqT3,1,0,0,0,0,0,1,0,1,0.14285714285714285,1,0.0,0,0,0,0,0,0,0,1,0,0,1,1
9873,170477,ClkySnys8q9iZwwIB1GHdIZUIZTYWQzy,SpATywNh6bZuzm8s1ceuBUnMUAeoAHHw,6,1,1,0,1,0,3,0,6,0.8571428571428571,1,0.0,0,1,0,1,1,0,0,3,0,2,4,1
9874,170481,QUAD8F1Sq1DKmhs6zkaRy7xSaSvEw9YZ,5X6FeZozNMgE2VRi3MJYjkkFK8SETtu2,6,5,0,4,1,0,4,2,16,2.2857142857142856,1,0.0,2,0,3,1,3,0,1,4,2,6,10,1
9875,170492,2H6KbsPWrpdsyjI0g4q0nnMN85W6it1n,RXDvfPUBYFlVdlueBFbLW0mhhAyGEqpt,1,0,0,0,0,0,1,0,1,0.14285714285714285,1,0.0,0,0,0,0,0,0,0,1,0,0,1,0
9876,170497,rujAdcRYDNcOdNAYamPPJcVCyaKAIiLP,SpATywNh6bZuzm8s1ceuBUnMUAeoAHHw,10,8,3,0,2,1,5,1,20,2.857142857142857,1,0.0,0,3,0,2,8,1,0,5,1,5,15,1
9877,170498,yjSLpu9rXQ5LHtGm8PnDgnJW6R5BYmgU,5X6FeZozNMgE2VRi3MJYjkkFK8SETtu2,1,0,0,0,0,0,1,0,1,0.14285714285714285,1,0.0,0,0,0,0,0,0,0,1,0,0,1,1
9878,170506,o4osOJvgQ93Ymu9ZCa30DQTnm2Hl0dnw,5X6FeZozNMgE2VRi3MJYjkkFK8SETtu2,4,3,1,0,0,0,2,0,6,0.8571428571428571,1,0.0,0,1,0,0,3,0,0,2,0,1,5,1
9879,170507,e7CJKTxK2fHzkKAqxRbF4w3Yx9Cc3hBw,SpATywNh6bZuzm8s1ceuBUnMUAeoAHHw,13,24,0,13,1,3,9,1,51,7.285714285714286,1,0.0,13,0,13,1,11,3,0,9,1,27,24,1
9880,170512,M66RbMOSrj4328MjTEjMdJ6THFVBTtut,SpATywNh6bZuzm8s1ceuBUnMUAeoAHHw,2,0,0,0,0,0,2,0,2,0.2857142857142857,1,0.0,0,0,0,0,0,0,0,2,0,0,2,1
9881,170516,ElX5Sy8TuzS1PFSnkh4VB3EIzoERGXU4,SpATywNh6bZuzm8s1ceuBUnMUAeoAHHw,1,0,0,0,0,0,1,0,1,0.14285714285714285,1,0.0,0,0,0,0,0,0,0,1,0,0,1,1
9882,170525,24VtpSEyjNziAqnGWNWJJAL3omRP6Ck7,SpATywNh6bZuzm8s1ceuBUnMUAeoAHHw,3,3,0,0,0,0,1,0,4,0.5714285714285714,1,0.0,0,0,0,0,3,0,0,1,0,0,4,1
9883,170536,AYoYqmMVts3Jos5MlcHwS4c0GaWIO0qr,A3fsA9Zfv1X2fVEQhTw51lKENdNrEqT3,5,0,0,0,0,0,6,0,6,0.8571428571428571,1,0.0,0,0,0,0,0,0,0,6,0,0,6,1
9884,170538,iw2Z0CZWwaxm4RYS9eYs4psAOivvGaBR,SpATywNh6bZuzm8s1ceuBUnMUAeoAHHw,6,3,1,0,1,0,2,0,7,1.0,1,0.0,0,1,0,1,3,0,0,2,0,2,5,1
9885,170554,NA7DOpQvJZlbMekjhpkQkPqGIPJQL8nu,bWdj2GDclj5ofokWjzoa5jAwMkxCykd6,1,0,0,0,0,0,1,0,1,0.14285714285714285,1,0.0,0,0,0,0,0,0,0,1,0,0,1,1
9886,170559,PwLIj6o8z5EIVeMRrdzlGP97RUwQ6OQA,A3fsA9Zfv1X2fVEQhTw51lKENdNrEqT3,5,2,1,0,1,0,3,0,7,1.0,1,0.0,0,1,0,1,2,0,0,3,0,2,5,1
9887,170569,67ART2vkl2t74M325EVjIJhRx1ejvS40,5X6FeZozNMgE2VRi3MJYjkkFK8SETtu2,4,2,1,0,1,0,1,0,5,0.7142857142857143,1,0.0,0,1,0,1,2,0,0,1,0,2,3,1
9888,170572,lyUyYIfExuGOGDXTlbgjuS96P5Iv4Fw9,SpATywNh6bZuzm8s1ceuBUnMUAeoAHHw,12,16,5,0,1,0,4,0,26,3.7142857142857144,1,0.0,2,5,0,1,14,0,0,4,0,8,18,1
9889,170577,rIjZ3i5ppcr4GwVYuKGWcaMRKqUdWp8Z,SpATywNh6bZuzm8s1ceuBUnMUAeoAHHw,7,3,2,0,2,0,2,0,9,1.2857142857142858,1,0.0,0,2,0,2,3,0,0,2,0,4,5,1
9890,170590,0TVIMteBCisXYqQmhAVCzijts3EjTj9F,5X6FeZozNMgE2VRi3MJYjkkFK8SETtu2,8,4,1,6,2,0,3,1,17,2.4285714285714284,1,0.0,3,1,5,2,1,0,1,3,1,11,6,1
9891,170593,WNMY3WRE1kSjqqBi1gkUrP92tDh9JpnU,A3fsA9Zfv1X2fVEQhTw51lKENdNrEqT3,7,4,3,0,3,0,3,0,13,1.8571428571428572,1,0.0,0,3,0,3,4,0,0,3,0,6,7,1
9892,170600,9fVN74CosCSsezn8P3MpQSVmSGkY5xCm,SpATywNh6bZuzm8s1ceuBUnMUAeoAHHw,7,6,1,0,0,3,4,0,14,2.0,1,0.0,0,1,0,0,6,3,0,4,0,1,13,1
9893,170602,MH8MIbGRBOcwRh7o5KLXTJghF8Lfi17k,5X6FeZozNMgE2VRi3MJYjkkFK8SETtu2,12,15,2,6,3,2,8,1,37,5.285714285714286,1,0.0,6,2,6,3,9,2,0,8,1,17,20,1
9894,170603,Yg9hgHRSCdpITsjHOmkyqEwp1aNMC9ra,SpATywNh6bZuzm8s1ceuBUnMUAeoAHHw,1,0,0,0,0,0,1,0,1,0.14285714285714285,1,0.0,0,0,0,0,0,0,0,1,0,0,1,1
9895,170630,BkFKNCSuaFkJKkL8VqeRPxKqLfFGSUAo,5X6FeZozNMgE2VRi3MJYjkkFK8SETtu2,7,3,2,0,2,0,2,0,9,1.2857142857142858,1,0.0,0,2,0,2,3,0,0,2,0,4,5,1
9896,170634,yNeIUKhEuJHTBsPD5kABjlBuASduqZHz,bWdj2GDclj5ofokWjzoa5jAwMkxCykd6,8,6,4,0,2,0,3,0,15,2.142857142857143,1,0.0,0,4,0,2,6,0,0,3,0,6,9,1
9897,170655,o51Y4SLAGY9EUpnbYlzlny2aYMXKv66D,SpATywNh6bZuzm8s1ceuBUnMUAeoAHHw,2,0,0,0,0,0,2,0,2,0.2857142857142857,1,0.0,0,0,0,0,0,0,0,2,0,0,2,1
9898,170665,BzOMHXhy39ViSG5m80jlFY2Dylr0IW9h,RXDvfPUBYFlVdlueBFbLW0mhhAyGEqpt,1,0,0,0,0,0,1,0,1,0.14285714285714285,1,0.0,0,0,0,0,0,0,0,1,0,0,1,1
9899,170669,uxpPi5YjzalklY0lH8OBSyWxa4yOJr6b,bWdj2GDclj5ofokWjzoa5jAwMkxCykd6,1,0,0,0,0,0,1,0,1,0.14285714285714285,1,0.0,0,0,0,0,0,0,0,1,0,0,1,1
9900,170681,cJJis1Eo88AzCRowxVa7rzvY4ZLonXwZ,A3fsA9Zfv1X2fVEQhTw51lKENdNrEqT3,6,2,0,0,0,5,9,1,17,2.4285714285714284,1,0.0,0,0,0,0,2,5,0,9,1,0,17,1
9901,170691,Hm7TJQq1vAhYsYwItY96s4Me02Vfs6zP,RXDvfPUBYFlVdlueBFbLW0mhhAyGEqpt,9,10,0,0,0,0,7,0,17,2.4285714285714284,1,0.0,0,0,0,0,10,0,0,7,0,0,17,1
9902,170698,ZouOLIcJ3Tj5ZIpKyHpqXZhY7RgZvMZA,SpATywNh6bZuzm8s1ceuBUnMUAeoAHHw,6,3,1,0,1,0,2,0,7,1.0,1,0.0,0,1,0,1,3,0,0,2,0,2,5,1
9903,170699,vJzksHQIgTjsZcFPkhlyJTG6u9xDgpeq,5X6FeZozNMgE2VRi3MJYjkkFK8SETtu2,1,0,0,0,0,0,1,0,1,0.14285714285714285,1,0.0,0,0,0,0,0,0,0,1,0,0,1,1
9904,170708,T24fR7tLfvFk1dDcUZ1sfKSW4mn6QkuF,7GRhBDsirIGkRZBtSMEzNTyDr2JQm4xx,4,0,0,0,0,0,4,1,5,0.7142857142857143,1,0.0,0,0,0,0,0,0,0,4,1,0,5,1
9905,170712,MOumV4gnnC04de5uAKnQrbg5Oxg7krQz,7GRhBDsirIGkRZBtSMEzNTyDr2JQm4xx,1,0,0,0,0,0,1,0,1,0.14285714285714285,1,0.0,0,0,0,0,0,0,0,1,0,0,1,1
9906,170717,vgU7HjSSKESb53rYK6QCA7euO8AD5F4F,7GRhBDsirIGkRZBtSMEzNTyDr2JQm4xx,2,0,0,0,0,0,2,0,2,0.2857142857142857,1,0.0,0,0,0,0,0,0,0,2,0,0,2,1
9907,170721,7l0SAmotFhhGX3L1NZSrUuyNyYqkAHiK,7GRhBDsirIGkRZBtSMEzNTyDr2JQm4xx,1,0,0,0,0,0,1,0,1,0.14285714285714285,1,0.0,0,0,0,0,0,0,0,1,0,0,1,1
9908,170722,3AZPazkjjeT8Y1N7eVF61WlLjHIsm9tf,7GRhBDsirIGkRZBtSMEzNTyDr2JQm4xx,1,0,0,0,0,0,1,0,1,0.14285714285714285,1,0.0,0,0,0,0,0,0,0,1,0,0,1,1
9909,170731,wfEV62Pm9Lmqm4ea1Gm09tOY6g7FO2lH,7GRhBDsirIGkRZBtSMEzNTyDr2JQm4xx,2,0,0,0,0,0,2,0,2,0.2857142857142857,1,0.0,0,0,0,0,0,0,0,2,0,0,2,0
9910,170736,tRgtCcxMmOOOAHwv6NjcGkY1uP7qTVjb,7GRhBDsirIGkRZBtSMEzNTyDr2JQm4xx,1,0,0,0,0,0,1,0,1,0.14285714285714285,1,0.0,0,0,0,0,0,0,0,1,0,0,1,1
9911,170740,v6v1hayEEXofBruMyo9TZ2ggXeu5UD3T,7GRhBDsirIGkRZBtSMEzNTyDr2JQm4xx,1,0,0,0,0,0,1,0,1,0.14285714285714285,1,0.0,0,0,0,0,0,0,0,1,0,0,1,1
9912,170741,6wr6dBOxcvGA1j07rybem8uoLQOkR2xX,7GRhBDsirIGkRZBtSMEzNTyDr2JQm4xx,10,11,9,0,7,0,4,0,31,4.428571428571429,1,0.0,0,9,0,7,11,0,0,4,0,16,15,1
9913,170743,L2BBredG3CUlz8Grd7ibENxWG096di5u,7GRhBDsirIGkRZBtSMEzNTyDr2JQm4xx,3,0,0,0,0,0,3,0,3,0.42857142857142855,1,0.0,0,0,0,0,0,0,0,3,0,0,3,1
9914,170745,zAEo1mbhu0cLq63pob9NdFw47a0nIS3j,7GRhBDsirIGkRZBtSMEzNTyDr2JQm4xx,4,0,0,0,0,1,3,0,4,0.5714285714285714,1,0.0,0,0,0,0,0,1,0,3,0,0,4,1
9915,170751,NZIKCwZrLpCubV1To1IkAO0xVGXouuGz,7GRhBDsirIGkRZBtSMEzNTyDr2JQm4xx,1,0,0,0,0,0,1,0,1,0.14285714285714285,1,0.0,0,0,0,0,0,0,0,1,0,0,1,1
9916,170755,3s8l6Oo3c1fXiiE9X1tB8PxtDiwQqFs1,7GRhBDsirIGkRZBtSMEzNTyDr2JQm4xx,1,0,0,0,0,0,1,0,1,0.14285714285714285,1,0.0,0,0,0,0,0,0,0,1,0,0,1,1
9917,170760,yau38b5UXLNmzsSxrtZsXYfKt6l52ZSP,7GRhBDsirIGkRZBtSMEzNTyDr2JQm4xx,5,4,2,0,2,0,4,0,12,1.7142857142857142,1,0.0,0,2,0,2,4,0,0,4,0,4,8,1
9918,170765,BMIB6E91kmKyP88uGea4mN2MFpt4XLzp,5Gyp41oLVo7Gg7vF4vpmggWP5MU70QO6,6,3,1,0,1,0,6,0,11,1.5714285714285714,1,0.0,0,1,0,1,3,0,0,6,0,2,9,1
9919,170771,p4TvboUbx4FA7g7XUInoNWnGsmXFv56Y,5Gyp41oLVo7Gg7vF4vpmggWP5MU70QO6,1,0,0,0,0,0,2,0,2,0.2857142857142857,1,0.0,0,0,0,0,0,0,0,2,0,0,2,1
9920,170775,cfkf9Jwx7uWwwcBeVbchoLTRlD1rMmEz,5Gyp41oLVo7Gg7vF4vpmggWP5MU70QO6,4,3,1,0,1,0,1,0,6,0.8571428571428571,1,0.0,0,1,0,1,3,0,0,1,0,2,4,1
9921,170781,eRiW1rLnl4Qab6ywCt3YY5W8VtRqftP8,5Gyp41oLVo7Gg7vF4vpmggWP5MU70QO6,1,0,0,0,0,0,1,0,1,0.14285714285714285,1,0.0,0,0,0,0,0,0,0,1,0,0,1,1
9922,170784,UynNO0WxP0l7zqIo8Pjz2oz0nyu9QGkO,5Gyp41oLVo7Gg7vF4vpmggWP5MU70QO6,8,5,1,0,3,0,3,1,13,1.8571428571428572,1,0.0,2,1,0,3,3,0,0,3,1,6,7,1
9923,170785,eT9OhUahWhAeZfHPEbxGN9qGHwvkkQvs,5Gyp41oLVo7Gg7vF4vpmggWP5MU70QO6,1,0,0,0,0,0,1,0,1,0.14285714285714285,1,0.0,0,0,0,0,0,0,0,1,0,0,1,1
9924,170791,L0Nlz1jizXmJnw798XjZ6Ux26duL0HVo,5Gyp41oLVo7Gg7vF4vpmggWP5MU70QO6,6,4,2,0,1,0,3,0,10,1.4285714285714286,1,0.0,0,2,0,1,4,0,0,3,0,3,7,1
9925,170803,C869rqapV6yDWHSEwWrISTYhrx1OX9El,5Gyp41oLVo7Gg7vF4vpmggWP5MU70QO6,1,0,0,0,0,0,1,0,1,0.14285714285714285,1,0.0,0,0,0,0,0,0,0,1,0,0,1,1
9926,170807,hc3dSrci35Dy3FgQbfVD88Ol0CqYSCR2,5Gyp41oLVo7Gg7vF4vpmggWP5MU70QO6,11,11,1,6,3,0,2,0,23,3.2857142857142856,1,0.0,3,1,4,3,8,0,2,2,0,11,12,1
9927,170869,tHCozFCW7DNfZaJgecFLiDg68dSXh8ov,5Gyp41oLVo7Gg7vF4vpmggWP5MU70QO6,3,0,0,0,0,1,3,0,4,0.5714285714285714,1,0.0,0,0,0,0,0,1,0,3,0,0,4,1
9928,170882,j6HeRAsU4WuPEEEDUyCOznbm2Lpajkq3,5Gyp41oLVo7Gg7vF4vpmggWP5MU70QO6,1,0,0,0,0,0,1,0,1,0.14285714285714285,1,0.0,0,0,0,0,0,0,0,1,0,0,1,1
9929,170901,Yk6MmpUW28r4Uq8l3GnoMSWdv4jJs4LT,5Gyp41oLVo7Gg7vF4vpmggWP5MU70QO6,1,0,0,0,0,0,1,0,1,0.14285714285714285,1,0.0,0,0,0,0,0,0,0,1,0,0,1,1
9930,170915,NTdWlLSimx7GyW5yR8OxrZ4z4iFhcpVa,5Gyp41oLVo7Gg7vF4vpmggWP5MU70QO6,3,0,0,0,0,0,7,0,7,1.0,2,0.0,0,0,0,0,0,0,0,7,0,0,7,1
9931,170916,LRbWwyXhZPTAEjCqXqBiUY3zpucwFnJU,5Gyp41oLVo7Gg7vF4vpmggWP5MU70QO6,14,7,6,2,4,0,3,0,22,3.142857142857143,1,0.0,0,6,1,4,7,0,1,3,0,11,11,1
9932,170923,5j9EQkqR4CZfRV8sku9HLld3NnlBiUj6,5Gyp41oLVo7Gg7vF4vpmggWP5MU70QO6,5,1,1,0,0,0,3,0,5,0.7142857142857143,1,0.0,0,1,0,0,1,0,0,3,0,1,4,1
9933,170930,827VZ0CzsfF9ZeGQVo5aa4aZucptPdlC,5Gyp41oLVo7Gg7vF4vpmggWP5MU70QO6,4,2,1,0,1,0,3,0,7,1.0,1,0.0,0,1,0,1,2,0,0,3,0,2,5,1
9934,170931,G3goDZZ2o1vGeIpYovlANIGzxlyY4qqb,5Gyp41oLVo7Gg7vF4vpmggWP5MU70QO6,6,5,0,0,0,0,4,0,9,1.2857142857142858,1,0.0,0,0,0,0,5,0,0,4,0,0,9,1
9935,170936,taWxuJJEcneO1cGlCIbqiVREl8xjxX6Y,5Gyp41oLVo7Gg7vF4vpmggWP5MU70QO6,9,11,2,9,2,0,2,0,26,3.7142857142857144,1,0.0,5,2,5,2,6,0,4,2,0,14,12,1
9936,170937,aNviqaUsa8tjM9b6nMwh7ketdx2tdX99,5Gyp41oLVo7Gg7vF4vpmggWP5MU70QO6,1,0,0,0,0,0,1,0,1,0.14285714285714285,1,0.0,0,0,0,0,0,0,0,1,0,0,1,1
9937,170959,rQsFYzutvg9uveyvYwDFb5eVD15msCTa,5Gyp41oLVo7Gg7vF4vpmggWP5MU70QO6,1,0,0,0,0,0,1,0,1,0.14285714285714285,1,0.0,0,0,0,0,0,0,0,1,0,0,1,1
9938,171003,3CDy2SDum4kZFSNpibLk6Z5qeQ6EBDAC,5Gyp41oLVo7Gg7vF4vpmggWP5MU70QO6,1,0,0,0,0,0,1,0,1,0.14285714285714285,1,0.0,0,0,0,0,0,0,0,1,0,0,1,1
9939,171009,Z94hXsSNjGhWZCps7Ojjt5LXq9lu8p6b,5Gyp41oLVo7Gg7vF4vpmggWP5MU70QO6,4,2,1,0,1,1,1,0,6,0.8571428571428571,1,0.0,0,1,0,1,2,1,0,1,0,2,4,1
9940,171011,bLcbvKDRM6lji8wmeDJkPOBB2b9eyXBH,5Gyp41oLVo7Gg7vF4vpmggWP5MU70QO6,24,30,13,23,12,0,3,0,81,11.571428571428571,2,0.0,12,13,18,12,18,0,5,3,0,55,26,1
9941,171022,s0NbpPWS5IfVPx4eIbu1aTZt1wrsgXjI,5Gyp41oLVo7Gg7vF4vpmggWP5MU70QO6,1,0,0,0,0,0,1,0,1,0.14285714285714285,1,0.0,0,0,0,0,0,0,0,1,0,0,1,1
9942,171028,bnRbBUe4PkB0syLrQhPtKseWIhmvrSXx,5Gyp41oLVo7Gg7vF4vpmggWP5MU70QO6,5,3,2,0,1,0,2,0,8,1.1428571428571428,1,0.0,0,2,0,1,3,0,0,2,0,3,5,1
9943,171040,yyGBOhHbxMfX8BmR51wetDPOc6VNAvkc,5Gyp41oLVo7Gg7vF4vpmggWP5MU70QO6,4,2,1,0,1,0,1,0,5,0.7142857142857143,1,0.0,0,1,0,1,2,0,0,1,0,2,3,1
9944,171046,hs8vsSC20AJis83syUtViS2CCOVGp4Ud,5Gyp41oLVo7Gg7vF4vpmggWP5MU70QO6,13,34,24,10,12,3,7,0,90,12.857142857142858,4,0.0,5,24,8,12,29,3,2,7,0,49,41,0
9945,171065,7LvYUTiLkSebmokg9rczNx6BFI3AKTvk,5Gyp41oLVo7Gg7vF4vpmggWP5MU70QO6,6,5,3,0,2,0,4,0,14,2.0,2,0.0,0,3,0,2,5,0,0,4,0,5,9,1
9946,171095,SbhlOYaVvrkli2oKR3zLMXUUMLmLA3uq,5Gyp41oLVo7Gg7vF4vpmggWP5MU70QO6,10,6,2,0,5,0,2,0,15,2.142857142857143,1,0.0,3,2,0,5,3,0,0,2,0,10,5,1
9947,171096,ni3nXbs7dtyAlyweFOqGHdQNp2mMhFwt,5Gyp41oLVo7Gg7vF4vpmggWP5MU70QO6,21,35,15,20,8,10,9,1,98,14.0,1,0.0,15,15,14,8,20,10,6,9,1,52,46,1
9948,171121,DjMX7azMu4IpY69OrQdIh3IGz92j1lxo,5Gyp41oLVo7Gg7vF4vpmggWP5MU70QO6,8,2,2,0,1,3,5,3,16,2.2857142857142856,1,0.0,0,2,0,1,2,3,0,5,3,3,13,1
9949,171137,Rdy0CfUudmhWbIZliyDoiy2Dx48DROrp,5Gyp41oLVo7Gg7vF4vpmggWP5MU70QO6,8,6,4,2,3,0,1,0,16,2.2857142857142856,1,0.0,1,4,1,3,5,0,1,1,0,9,7,1
9950,171157,9URbBMbYW0bGrqgN35My2oF5c5hnglz3,5Gyp41oLVo7Gg7vF4vpmggWP5MU70QO6,17,15,8,0,7,0,4,0,34,4.857142857142857,2,0.0,3,8,0,7,12,0,0,4,0,18,16,1
9951,171160,UTQBVZwwRuN7bMqGkwJeqpNJF2PPrsFV,5Gyp41oLVo7Gg7vF4vpmggWP5MU70QO6,17,27,13,21,10,9,5,0,85,12.142857142857142,3,0.0,9,13,13,10,18,9,8,5,0,45,40,1
9952,171177,no2ug7TKVsupL4LU2a5jY2GhYHkskTdw,5Gyp41oLVo7Gg7vF4vpmggWP5MU70QO6,1,0,0,0,0,0,1,0,1,0.14285714285714285,1,0.0,0,0,0,0,0,0,0,1,0,0,1,1
9953,171178,NuWa1wNN62sioyREqwjInndithPqIOD8,5Gyp41oLVo7Gg7vF4vpmggWP5MU70QO6,10,13,9,0,7,0,2,0,31,4.428571428571429,2,0.0,2,9,0,7,11,0,0,2,0,18,13,1
9954,171189,eFyHUXeItRdU1K0bXmgVXfPmw1ZUD7pD,5Gyp41oLVo7Gg7vF4vpmggWP5MU70QO6,2,0,0,0,0,1,1,0,2,0.2857142857142857,1,0.0,0,0,0,0,0,1,0,1,0,0,2,1
9955,171193,qGK1tc93dD45zv8dcvRi536upoDHrRB7,5Gyp41oLVo7Gg7vF4vpmggWP5MU70QO6,14,8,7,0,6,0,2,0,23,3.2857142857142856,1,0.0,0,7,0,6,8,0,0,2,0,13,10,1
9956,171207,sPeU2djYNxHt1uDOGgBQyrpsbiWrJaDT,5Gyp41oLVo7Gg7vF4vpmggWP5MU70QO6,6,1,1,0,1,0,6,0,9,1.2857142857142858,1,0.0,0,1,0,1,1,0,0,6,0,2,7,1
9957,171215,vQxwNbtZgUat9SDZRmE7MEKdvAizpBwk,5Gyp41oLVo7Gg7vF4vpmggWP5MU70QO6,12,18,6,9,4,0,1,0,38,5.428571428571429,1,0.0,10,6,6,4,8,0,3,1,0,26,12,1
9958,171219,DP5pgERMZWRSN5a5SkQU3UnPeMBW2C59,5Gyp41oLVo7Gg7vF4vpmggWP5MU70QO6,5,2,1,0,1,0,3,0,7,1.0,2,0.0,0,1,0,1,2,0,0,3,0,2,5,1
9959,171260,abycdjSvUJMf23ooe01pNyMBFOcEZ7y0,5Gyp41oLVo7Gg7vF4vpmggWP5MU70QO6,4,2,1,0,1,0,1,0,5,0.7142857142857143,1,0.0,0,1,0,1,2,0,0,1,0,2,3,1
9960,171267,kfF2Z2lGAIzpstHoILdRDWLQUgS5KmZW,5Gyp41oLVo7Gg7vF4vpmggWP5MU70QO6,5,1,1,0,1,0,2,0,5,0.7142857142857143,1,0.0,0,1,0,1,1,0,0,2,0,2,3,1
9961,171280,xjK36HJFPi8iEkTq1KMrB8c6lE6mZK4D,5Gyp41oLVo7Gg7vF4vpmggWP5MU70QO6,6,5,2,0,2,0,2,0,11,1.5714285714285714,1,0.0,0,2,0,2,5,0,0,2,0,4,7,1
9962,171283,ocrybaLaQmK6tkKYPThp5V4sWJ2JBAoj,5Gyp41oLVo7Gg7vF4vpmggWP5MU70QO6,8,3,2,0,1,0,4,0,10,1.4285714285714286,1,0.0,0,2,0,1,3,0,0,4,0,3,7,1
9963,171289,KmDevCA0Fd1b8hBvX2cQviMAVGGzUN4h,5Gyp41oLVo7Gg7vF4vpmggWP5MU70QO6,8,4,2,0,2,0,7,0,15,2.142857142857143,1,0.0,0,2,0,2,4,0,0,7,0,4,11,1
9964,171307,avUYMdaaaXWvY0rHrFeagZk5hxdyWCx7,5Gyp41oLVo7Gg7vF4vpmggWP5MU70QO6,20,20,11,2,8,3,7,0,51,7.285714285714286,2,0.0,4,11,1,8,16,3,1,7,0,24,27,1
9965,171318,7ee06WiF4bXJHzzIAwVSoqVatXFhyov9,5Gyp41oLVo7Gg7vF4vpmggWP5MU70QO6,4,2,1,0,1,0,2,0,6,0.8571428571428571,1,0.0,0,1,0,1,2,0,0,2,0,2,4,1
9966,171326,pY7eBIYQnNrRDqMqusFhdWhyjWW02r9S,5Gyp41oLVo7Gg7vF4vpmggWP5MU70QO6,9,12,0,0,0,0,8,3,23,3.2857142857142856,1,0.0,2,0,0,0,10,0,0,8,3,2,21,1
9967,171333,v1rqQmEjSAVxogtdzkPThPbJaR6b0Gnq,5Gyp41oLVo7Gg7vF4vpmggWP5MU70QO6,7,3,2,0,2,0,2,0,9,1.2857142857142858,1,0.0,0,2,0,2,3,0,0,2,0,4,5,1
9968,171340,GMzSpgZQ6jzVsfHn8W8i83JsYNxnP00b,5Gyp41oLVo7Gg7vF4vpmggWP5MU70QO6,13,39,18,4,1,1,13,0,76,10.857142857142858,3,0.0,7,18,3,1,32,1,1,13,0,29,47,1
9969,171354,JArfhUdQiCDJUGGF1GUzH6iybvkKVezF,5Gyp41oLVo7Gg7vF4vpmggWP5MU70QO6,3,0,0,0,0,3,2,0,5,0.7142857142857143,1,0.0,0,0,0,0,0,3,0,2,0,0,5,1
9970,171363,trgMDAY9uIKniIj7MNKMFlYvq2puOBqS,5Gyp41oLVo7Gg7vF4vpmggWP5MU70QO6,28,41,22,18,9,3,7,0,100,14.285714285714286,3,0.0,14,22,13,9,27,3,5,7,0,58,42,1
9971,171387,iQUKcnL77lKYF7iiJiwEDvheVVvDz9HU,5Gyp41oLVo7Gg7vF4vpmggWP5MU70QO6,4,2,1,0,1,0,2,0,6,0.8571428571428571,1,0.0,0,1,0,1,2,0,0,2,0,2,4,1
9972,171395,aXJ6fzZZAhXxp1C0craLTVKLc0N7EkCB,5Gyp41oLVo7Gg7vF4vpmggWP5MU70QO6,1,0,0,0,0,0,1,0,1,0.14285714285714285,1,0.0,0,0,0,0,0,0,0,1,0,0,1,1
9973,171406,XNiJFsPS4pWS29Iwww7aTDuzD3ZtCIBA,5Gyp41oLVo7Gg7vF4vpmggWP5MU70QO6,9,5,2,4,2,0,2,0,15,2.142857142857143,1,0.0,1,2,3,2,4,0,1,2,0,8,7,1
9974,171408,HtjEbvgOOBBVriL8HmozgEGA6fnYXsGi,5Gyp41oLVo7Gg7vF4vpmggWP5MU70QO6,1,0,0,0,0,0,1,0,1,0.14285714285714285,1,0.0,0,0,0,0,0,0,0,1,0,0,1,1
9975,171416,LFHy42gGUY0ra7u86Eijp2ZrHEmwJejY,5Gyp41oLVo7Gg7vF4vpmggWP5MU70QO6,1,0,0,0,0,0,1,0,1,0.14285714285714285,1,0.0,0,0,0,0,0,0,0,1,0,0,1,1
9976,171424,LdTABddaoG9xBYcPuQ1k6qsARenE47fZ,5Gyp41oLVo7Gg7vF4vpmggWP5MU70QO6,5,2,1,0,1,0,2,0,6,0.8571428571428571,1,0.0,0,1,0,1,2,0,0,2,0,2,4,1
9977,171444,EOtg7SeGapdjcfmgZb6gcgTDKiiO1H0w,5Gyp41oLVo7Gg7vF4vpmggWP5MU70QO6,6,2,2,0,0,0,3,0,7,1.0,1,0.0,0,2,0,0,2,0,0,3,0,2,5,1
9978,171460,erekz3vGKNrk60zKOdRickSTuufbMf9j,5Gyp41oLVo7Gg7vF4vpmggWP5MU70QO6,7,2,1,0,1,0,4,1,9,1.2857142857142858,1,0.0,0,1,0,1,2,0,0,4,1,2,7,1
9979,171468,rQHZugBVJiSclJ7S9BzroTFpeTd0gpCq,5Gyp41oLVo7Gg7vF4vpmggWP5MU70QO6,6,3,2,0,2,0,1,0,8,1.1428571428571428,1,0.0,0,2,0,2,3,0,0,1,0,4,4,1
9980,171480,a0LIICaoiHuLSU4stcBsZb8wt2BRDZvP,5Gyp41oLVo7Gg7vF4vpmggWP5MU70QO6,1,0,0,0,0,0,1,0,1,0.14285714285714285,1,0.0,0,0,0,0,0,0,0,1,0,0,1,1
9981,171499,NGQ6HXbhxwBlJxikVxca5noX2u8xI9AV,5Gyp41oLVo7Gg7vF4vpmggWP5MU70QO6,13,28,0,4,2,2,6,0,42,6.0,1,0.0,6,0,3,2,22,2,1,6,0,11,31,1
9982,171502,syRXQgZ68k4Lu6fGAyDxMb2MzSTLmk5X,5Gyp41oLVo7Gg7vF4vpmggWP5MU70QO6,6,7,3,0,1,0,2,0,13,1.8571428571428572,2,0.0,2,3,0,1,5,0,0,2,0,6,7,1
9983,171507,KvPxlUI4LixXy5PjTz37hzmMB0UPrljM,5Gyp41oLVo7Gg7vF4vpmggWP5MU70QO6,4,2,1,0,1,0,2,0,6,0.8571428571428571,1,0.0,0,1,0,1,2,0,0,2,0,2,4,1
9984,171545,yKg6Gy57ErBEhKmfgsVWKCnvQy3s0q3B,5Gyp41oLVo7Gg7vF4vpmggWP5MU70QO6,7,6,2,0,4,0,1,0,13,1.8571428571428572,1,0.0,3,2,0,4,3,0,0,1,0,9,4,1
9985,171548,VG6lME1wYQEAWT3RMObNaXwuAoVt3ojn,5Gyp41oLVo7Gg7vF4vpmggWP5MU70QO6,3,3,1,0,0,0,1,0,5,0.7142857142857143,1,0.0,0,1,0,0,3,0,0,1,0,1,4,1
9986,171556,ta1c0rHn1PLWJ22QrYmkbMjTzbZREroJ,5Gyp41oLVo7Gg7vF4vpmggWP5MU70QO6,7,6,3,0,2,0,2,0,13,1.8571428571428572,1,0.0,1,3,0,2,5,0,0,2,0,6,7,1
9987,171605,rPtP72DMEyNlpUomeqVVqrg44j30SIpW,5Gyp41oLVo7Gg7vF4vpmggWP5MU70QO6,9,5,3,0,1,0,5,0,14,2.0,2,0.0,0,3,0,1,5,0,0,5,0,4,10,1
9988,171606,meIJ5fWFXqkx5qH8JeWlAp9Z7hg5xZ9c,5Gyp41oLVo7Gg7vF4vpmggWP5MU70QO6,8,4,2,0,1,4,7,1,19,2.7142857142857144,1,0.0,0,2,0,1,4,4,0,7,1,3,16,1
9989,171608,HoR3vqXgbzj6tIBJ3biNSM9ngz6njRvX,5Gyp41oLVo7Gg7vF4vpmggWP5MU70QO6,10,6,4,0,4,0,4,0,18,2.5714285714285716,1,0.0,1,4,0,4,5,0,0,4,0,9,9,1
9990,171630,9Wx1wvfBU3tliMSpRcfAd6me8ZV4kjBX,5Gyp41oLVo7Gg7vF4vpmggWP5MU70QO6,6,2,1,0,1,0,3,0,7,1.0,1,0.0,0,1,0,1,2,0,0,3,0,2,5,1
9991,171634,9sWl1POptoLbF2x8NBawVIAksiyrPUSp,5Gyp41oLVo7Gg7vF4vpmggWP5MU70QO6,8,7,4,0,2,0,3,0,16,2.2857142857142856,1,0.0,0,4,0,2,7,0,0,3,0,6,10,1
9992,171674,2WVyaq5BHzTwZ8qnlD9DMzt5ERVZhrZj,5Gyp41oLVo7Gg7vF4vpmggWP5MU70QO6,1,0,0,0,0,0,1,0,1,0.14285714285714285,1,0.0,0,0,0,0,0,0,0,1,0,0,1,1
9993,171689,BiREs4YxU1vt2gu7sZkVBaymqql0vWGE,5Gyp41oLVo7Gg7vF4vpmggWP5MU70QO6,6,11,0,0,1,0,2,0,14,2.0,1,0.0,1,0,0,1,10,0,0,2,0,2,12,1
9994,171708,rG8IAsvC5z6AKaPGHhUGX7vqxRs7JWXy,5Gyp41oLVo7Gg7vF4vpmggWP5MU70QO6,5,1,1,0,1,0,2,0,5,0.7142857142857143,1,0.0,0,1,0,1,1,0,0,2,0,2,3,0
9995,171710,sLGaPfom5sNxoC8eYlrQX0cxaol8qNJq,5Gyp41oLVo7Gg7vF4vpmggWP5MU70QO6,3,2,0,0,0,0,1,0,3,0.42857142857142855,1,0.0,0,0,0,0,2,0,0,1,0,0,3,1
9996,171718,lVSG902cLe1CW73E0Hoc4xiT416HaV83,5Gyp41oLVo7Gg7vF4vpmggWP5MU70QO6,15,28,14,0,6,0,6,0,54,7.714285714285714,2,0.0,5,14,0,6,23,0,0,6,0,25,29,1
9997,171725,b3nI48MewVFUxM8jH50bPwNToxR3d2Xc,5Gyp41oLVo7Gg7vF4vpmggWP5MU70QO6,1,0,0,0,0,0,1,0,1,0.14285714285714285,1,0.0,0,0,0,0,0,0,0,1,0,0,1,1
9998,171728,jjxQxNuEbbhaS9MitVf0jBmN5zgdr6CO,5Gyp41oLVo7Gg7vF4vpmggWP5MU70QO6,1,0,0,0,0,0,2,0,2,0.2857142857142857,1,0.0,0,0,0,0,0,0,0,2,0,0,2,1
9999,171729,6MSYodwGYcwd9yRZIV9mZL7DhjFIlsBW,5Gyp41oLVo7Gg7vF4vpmggWP5MU70QO6,8,7,3,0,2,0,2,0,14,2.0,1,0.0,3,3,0,2,4,0,0,2,0,8,6,1
10000,171741,gAdtqRV2WTq9brK7JyARtVKycCReXSnK,5Gyp41oLVo7Gg7vF4vpmggWP5MU70QO6,8,16,9,0,0,0,5,0,30,4.285714285714286,2,0.0,7,9,0,0,9,0,0,5,0,16,14,1
10001,171755,3twxJJAOjVM4q3xTctfONpi3ytR09f2J,5Gyp41oLVo7Gg7vF4vpmggWP5MU70QO6,6,1,1,0,1,0,3,0,6,0.8571428571428571,1,0.0,0,1,0,1,1,0,0,3,0,2,4,1
10002,171757,DBDJsHu8m0mygajWSHGxgRt9n3Rmx9gx,5Gyp41oLVo7Gg7vF4vpmggWP5MU70QO6,16,20,16,0,6,0,8,0,50,7.142857142857143,2,0.0,0,16,0,6,20,0,0,8,0,22,28,1
10003,171774,VxFnPnt5rim5O8RtDlF7wSXMJRGsfRAY,5Gyp41oLVo7Gg7vF4vpmggWP5MU70QO6,5,2,1,0,1,0,3,0,7,1.0,1,0.0,0,1,0,1,2,0,0,3,0,2,5,1
10004,171814,2LHnW0IJwerL0URh9evHYpYX9y6FKsRc,5Gyp41oLVo7Gg7vF4vpmggWP5MU70QO6,18,15,6,6,5,2,7,1,42,6.0,3,0.0,4,6,4,5,11,2,2,7,1,19,23,1
10005,171823,z6zy2HEFUX1BqomXd3UFqWumh4qIFZPI,5Gyp41oLVo7Gg7vF4vpmggWP5MU70QO6,7,3,2,0,2,0,2,0,9,1.2857142857142858,1,0.0,0,2,0,2,3,0,0,2,0,4,5,1
10006,171824,awwh8BVpi9HaABaIyISpNOMgFy0X4GpH,5Gyp41oLVo7Gg7vF4vpmggWP5MU70QO6,6,5,0,0,0,9,2,0,16,2.2857142857142856,1,0.0,0,0,0,0,5,9,0,2,0,0,16,1
10007,171825,S8G6hxeFaGb8kBCTRNlN7IM5e1Mut23r,5Gyp41oLVo7Gg7vF4vpmggWP5MU70QO6,1,0,0,0,0,0,1,0,1,0.14285714285714285,1,0.0,0,0,0,0,0,0,0,1,0,0,1,1
10008,171844,RJW2y0gnZZP4Xx4orJbqrG7gRq8Qm9cV,5Gyp41oLVo7Gg7vF4vpmggWP5MU70QO6,8,11,6,0,3,0,6,0,26,3.7142857142857144,1,0.0,1,6,0,3,10,0,0,6,0,10,16,1
10009,171867,QweACcbiHHHCzgWrkXlP6tkpsdwE8OVo,5Gyp41oLVo7Gg7vF4vpmggWP5MU70QO6,6,6,3,0,2,0,3,0,14,2.0,1,0.0,0,3,0,2,6,0,0,3,0,5,9,1
10010,171921,DuATnvBmuC2fZ2ZU7jnqtlU3mz3sdckv,5Gyp41oLVo7Gg7vF4vpmggWP5MU70QO6,4,2,1,0,1,0,1,0,5,0.7142857142857143,1,0.0,0,1,0,1,2,0,0,1,0,2,3,1
10011,171922,okyoisoOO6wvnkb7PnvdYaNSdWtxEaB3,5Gyp41oLVo7Gg7vF4vpmggWP5MU70QO6,7,8,1,0,2,0,3,0,14,2.0,1,0.0,0,1,0,2,8,0,0,3,0,3,11,1
10012,171924,BH0sucFBGAVdL6PteB266LGj7gAODQdC,5Gyp41oLVo7Gg7vF4vpmggWP5MU70QO6,1,0,0,0,0,0,1,0,1,0.14285714285714285,1,0.0,0,0,0,0,0,0,0,1,0,0,1,1
10013,171943,wIX6Xm6W1PLbNsugFVhL4SUuV61h0VdL,5Gyp41oLVo7Gg7vF4vpmggWP5MU70QO6,18,16,13,0,7,10,2,1,49,7.0,1,0.0,1,13,0,7,15,10,0,2,1,21,28,1
10014,171948,slLayrgewQwI4ovDGVB7kVUP7oY6JbhG,5Gyp41oLVo7Gg7vF4vpmggWP5MU70QO6,20,32,16,15,3,7,14,5,92,13.142857142857142,1,0.0,9,16,11,3,23,7,4,14,5,39,53,1
10015,171949,pItq3bFxeu5w71VK8K1sPKwhEUiyoKaP,5Gyp41oLVo7Gg7vF4vpmggWP5MU70QO6,6,3,2,0,1,0,2,0,8,1.1428571428571428,1,0.0,0,2,0,1,3,0,0,2,0,3,5,1
10016,171975,2tlXbRsdeTZKctb2koJVcptDiwymcPny,5Gyp41oLVo7Gg7vF4vpmggWP5MU70QO6,11,8,6,0,4,0,4,1,23,3.2857142857142856,2,0.0,0,6,0,4,8,0,0,4,1,10,13,1
10017,171976,CDTPeilgCkfrS3rzAW5jO0MF05nzaCsc,5Gyp41oLVo7Gg7vF4vpmggWP5MU70QO6,9,6,3,0,2,4,5,1,21,3.0,1,0.0,0,3,0,2,6,4,0,5,1,5,16,1
10018,171992,li1RAuplYdJUb6MArmDyNCuCLN26Dq80,5Gyp41oLVo7Gg7vF4vpmggWP5MU70QO6,4,2,1,0,1,0,1,0,5,0.7142857142857143,1,0.0,0,1,0,1,2,0,0,1,0,2,3,1
10019,171993,Mh9NICTvL9zw9pa45HSgcXaVDdrGiixJ,5Gyp41oLVo7Gg7vF4vpmggWP5MU70QO6,5,1,1,0,1,0,2,0,5,0.7142857142857143,1,0.0,0,1,0,1,1,0,0,2,0,2,3,1
10020,171995,OTsrWlpB4HEsglCviXcYcVMf94EGwyap,5Gyp41oLVo7Gg7vF4vpmggWP5MU70QO6,4,3,0,0,1,0,2,0,6,0.8571428571428571,1,0.0,0,0,0,1,3,0,0,2,0,1,5,1
10021,172036,zZWPxlDYqF21YiirhZBZVP7fDkVIwo9C,5Gyp41oLVo7Gg7vF4vpmggWP5MU70QO6,4,5,1,0,0,0,1,0,7,1.0,1,0.0,0,1,0,0,5,0,0,1,0,1,6,1
10022,172046,219ZtkRovyFfuoCR6XGJofrvIluZkPPk,5Gyp41oLVo7Gg7vF4vpmggWP5MU70QO6,10,6,3,3,2,4,5,0,23,3.2857142857142856,1,0.0,3,3,2,2,3,4,1,5,0,10,13,1
10023,172052,jK4Ev0LljQS9dRmYWftmSBJQGeKXxMDQ,5Gyp41oLVo7Gg7vF4vpmggWP5MU70QO6,12,22,0,7,0,0,4,0,33,4.714285714285714,2,0.0,4,0,4,0,18,0,3,4,0,8,25,1
10024,172054,D3Ec64UjlioWBq9s6QHemsTVoIO83t3S,5Gyp41oLVo7Gg7vF4vpmggWP5MU70QO6,4,5,0,0,0,0,1,0,6,0.8571428571428571,1,0.0,0,0,0,0,5,0,0,1,0,0,6,1
10025,172060,MeEpYOfbvivW6ZzcHgNKGn0HRaJkwsZQ,5Gyp41oLVo7Gg7vF4vpmggWP5MU70QO6,12,12,5,0,4,0,5,0,26,3.7142857142857144,2,0.0,2,5,0,4,10,0,0,5,0,11,15,1
10026,172119,nPRsjektHdbQkeAf1fIK4JbhrESPbPsA,5Gyp41oLVo7Gg7vF4vpmggWP5MU70QO6,14,13,8,2,6,6,4,0,39,5.571428571428571,3,0.0,2,8,1,6,11,6,1,4,0,17,22,0
10027,172122,syMQAAbvPWf5dOGGKWR7dlKKtLdoqo8z,5Gyp41oLVo7Gg7vF4vpmggWP5MU70QO6,5,3,1,0,1,0,1,0,6,0.8571428571428571,1,0.0,0,1,0,1,3,0,0,1,0,2,4,1
10028,172123,gUo5HnisULurDMKaeZ751PCJ1d0iYJyW,5Gyp41oLVo7Gg7vF4vpmggWP5MU70QO6,6,4,1,0,1,0,3,0,9,1.2857142857142858,1,0.0,1,1,0,1,3,0,0,3,0,3,6,1
10029,172128,41eAyCcalJFuAGeA9PeN6EH0etDrJoiS,5Gyp41oLVo7Gg7vF4vpmggWP5MU70QO6,5,9,0,0,0,0,1,0,10,1.4285714285714286,1,0.0,0,0,0,0,9,0,0,1,0,0,10,1
10030,172137,M9KnY1dyuXUV8pcf2nvnRDy7cXHn2kvf,5Gyp41oLVo7Gg7vF4vpmggWP5MU70QO6,13,8,6,0,4,0,6,1,25,3.5714285714285716,1,0.0,0,6,0,4,8,0,0,6,1,10,15,1
10031,172138,WEiHMXq6jANjNt27M5plCf4GscmfAQEf,5Gyp41oLVo7Gg7vF4vpmggWP5MU70QO6,4,3,2,0,0,0,2,0,7,1.0,1,0.0,0,2,0,0,3,0,0,2,0,2,5,1
10032,172175,5qtgeGza9DOaiOnRZufO1t8FYYMM6Mqa,5Gyp41oLVo7Gg7vF4vpmggWP5MU70QO6,1,0,0,0,0,0,2,0,2,0.2857142857142857,1,0.0,0,0,0,0,0,0,0,2,0,0,2,1
10033,172177,JXpFP7Prtzdu0WxRqDqJnTSpnHZKGOLi,5Gyp41oLVo7Gg7vF4vpmggWP5MU70QO6,6,6,3,0,0,1,7,0,17,2.4285714285714284,1,0.0,2,3,0,0,4,1,0,7,0,5,12,1
10034,172188,QXrh4ypkD1QaQAhOuKUOU3kPN6cXVdim,5Gyp41oLVo7Gg7vF4vpmggWP5MU70QO6,16,29,10,0,6,1,11,1,58,8.285714285714286,3,0.0,6,10,0,6,23,1,0,11,1,22,36,1
10035,172189,TgFKV48AUBfCO7r29pTXMZQaHoUdoobZ,5Gyp41oLVo7Gg7vF4vpmggWP5MU70QO6,6,2,1,0,1,0,3,0,7,1.0,1,0.0,0,1,0,1,2,0,0,3,0,2,5,1
10036,172193,4oVGmoGj6DjY5PLg7lM26G3AhR4k3Pm1,5Gyp41oLVo7Gg7vF4vpmggWP5MU70QO6,8,8,5,0,3,0,3,0,19,2.7142857142857144,1,0.0,0,5,0,3,8,0,0,3,0,8,11,1
10037,172233,P8oQ6jrr9sX5ql0sb1GKfSCdC6kiV5yB,5Gyp41oLVo7Gg7vF4vpmggWP5MU70QO6,5,0,0,0,0,0,6,1,7,1.0,1,0.0,0,0,0,0,0,0,0,6,1,0,7,1
10038,172243,gIXV45WkMOjKV6SvlgkVrQlYJRphcrVX,5Gyp41oLVo7Gg7vF4vpmggWP5MU70QO6,5,2,1,0,1,0,2,0,6,0.8571428571428571,1,0.0,0,1,0,1,2,0,0,2,0,2,4,0
10039,172265,CNGYybwj0lTeNQHTl7ZDNIxBHTW6Ensw,5Gyp41oLVo7Gg7vF4vpmggWP5MU70QO6,17,47,26,10,7,4,11,0,105,15.0,2,0.0,13,26,7,7,34,4,3,11,0,53,52,1
10040,172316,88KqNXt49dXQV1iTpH5dKGaXzbVtpY63,5Gyp41oLVo7Gg7vF4vpmggWP5MU70QO6,6,3,2,0,2,0,1,0,8,1.1428571428571428,1,0.0,0,2,0,2,3,0,0,1,0,4,4,1
10041,172320,uD4C9Dhce33zUj6KChwo5RM2vwq3ylcX,5Gyp41oLVo7Gg7vF4vpmggWP5MU70QO6,12,14,8,10,5,6,4,0,47,6.714285714285714,1,0.0,4,8,5,5,10,6,5,4,0,22,25,1
10042,172333,nQLHtvOO0tgGcyKecHvEbBCN8GxgUKXs,5Gyp41oLVo7Gg7vF4vpmggWP5MU70QO6,3,0,0,0,0,0,3,0,3,0.42857142857142855,1,0.0,0,0,0,0,0,0,0,3,0,0,3,1
10043,172343,9DAdKEpHAkUW9tgS718BKvE0nrO7Nhn1,5Gyp41oLVo7Gg7vF4vpmggWP5MU70QO6,24,36,22,0,7,2,16,2,85,12.142857142857142,2,0.0,9,22,0,7,27,2,0,16,2,38,47,1
10044,172347,vmX7frUqL7WeBo3nSAfXYcds7j6dtCCt,5Gyp41oLVo7Gg7vF4vpmggWP5MU70QO6,8,12,4,6,1,0,1,0,24,3.4285714285714284,1,0.0,5,4,3,1,7,0,3,1,0,13,11,1
10045,172353,lRLeqHvYMAoLJKA3aRJuFMxDlpshFZWk,5Gyp41oLVo7Gg7vF4vpmggWP5MU70QO6,9,7,3,2,2,0,2,0,16,2.2857142857142856,1,0.0,1,3,1,2,6,0,1,2,0,7,9,1
10046,172359,SiX02WTa9I1YhsFH9ZdyWriSf8qHIfRQ,5Gyp41oLVo7Gg7vF4vpmggWP5MU70QO6,1,0,0,0,0,0,1,0,1,0.14285714285714285,1,0.0,0,0,0,0,0,0,0,1,0,0,1,1
10047,172376,hqZMegguIBZDS3b0BCwsYFCd4lh9Opy1,5Gyp41oLVo7Gg7vF4vpmggWP5MU70QO6,2,0,0,0,0,0,2,0,2,0.2857142857142857,1,0.0,0,0,0,0,0,0,0,2,0,0,2,1
10048,172382,GtuEelYfNaXxzKOllxbFfafnobOPHIGx,5Gyp41oLVo7Gg7vF4vpmggWP5MU70QO6,7,3,2,0,2,2,2,0,11,1.5714285714285714,1,0.0,0,2,0,2,3,2,0,2,0,4,7,1
10049,172386,XaVaW7zhIkqyN67l1zhcGn8fROLFDNOd,5Gyp41oLVo7Gg7vF4vpmggWP5MU70QO6,13,8,3,10,2,6,5,1,35,5.0,1,0.0,4,3,5,2,4,6,5,5,1,14,21,1
10050,172394,pzFcwZgNrjnx8TfYkiyd9LxaCq2EbrQ8,5Gyp41oLVo7Gg7vF4vpmggWP5MU70QO6,1,0,0,0,0,0,1,0,1,0.14285714285714285,1,0.0,0,0,0,0,0,0,0,1,0,0,1,1
10051,172395,6HZMw8LFd0LgW9tH20x46NBpQ9z7xjs8,5Gyp41oLVo7Gg7vF4vpmggWP5MU70QO6,7,3,2,0,2,0,2,0,9,1.2857142857142858,1,0.0,0,2,0,2,3,0,0,2,0,4,5,1
10052,172399,JyT1UtVlJquq8THK76yjuEbLoY5pkuIB,5Gyp41oLVo7Gg7vF4vpmggWP5MU70QO6,9,7,3,0,4,0,3,0,17,2.4285714285714284,1,0.0,2,3,0,4,5,0,0,3,0,9,8,1
10053,172409,6mOQPHYetbEhBA0tIxsajGc8MOtDRaKo,5Gyp41oLVo7Gg7vF4vpmggWP5MU70QO6,5,2,1,0,1,0,2,0,6,0.8571428571428571,1,0.0,0,1,0,1,2,0,0,2,0,2,4,1
10054,172418,xJMOdATTMorSYDF6CzmTAxofDY32PFm8,5Gyp41oLVo7Gg7vF4vpmggWP5MU70QO6,20,15,9,12,6,0,8,1,51,7.285714285714286,2,0.0,4,9,6,6,11,0,6,8,1,25,26,1
10055,172419,hXZgc5Oc8L3KNvO8ElQE29RF6Exzr76M,5Gyp41oLVo7Gg7vF4vpmggWP5MU70QO6,1,0,0,0,0,0,1,0,1,0.14285714285714285,1,0.0,0,0,0,0,0,0,0,1,0,0,1,1
10056,172422,tAvyfP1C8BhgApDQ1Bw2zxQFiC5YHjrZ,5Gyp41oLVo7Gg7vF4vpmggWP5MU70QO6,5,3,1,0,1,0,1,0,6,0.8571428571428571,1,0.0,0,1,0,1,3,0,0,1,0,2,4,1
10057,172423,tRDAXSjCZAZhK7cnVXkigKhGQk8DLkR5,5Gyp41oLVo7Gg7vF4vpmggWP5MU70QO6,4,3,0,0,0,0,2,0,5,0.7142857142857143,1,0.0,0,0,0,0,3,0,0,2,0,0,5,1
10058,172428,WMyzbme4IPMhK5z5T3Uh6kkzSEUZ7eVu,5Gyp41oLVo7Gg7vF4vpmggWP5MU70QO6,28,27,16,0,15,4,14,4,80,11.428571428571429,1,0.0,8,16,0,15,19,4,0,14,4,39,41,1
10059,172454,fGIeAB7IRJCHxzCo8u4GLaPKxQfHeCdi,5Gyp41oLVo7Gg7vF4vpmggWP5MU70QO6,14,21,11,2,5,1,20,0,60,8.571428571428571,2,0.0,3,11,1,5,18,1,1,20,0,20,40,0
10060,172465,gUiPsIaxYlgBsivuNjPHoDnnrtdL7Cbn,5Gyp41oLVo7Gg7vF4vpmggWP5MU70QO6,8,5,3,0,2,0,3,0,13,1.8571428571428572,1,0.0,0,3,0,2,5,0,0,3,0,5,8,1
10061,172474,1Gv11nS0XCuxdjw8VOmeY5aEETIaIhPq,5Gyp41oLVo7Gg7vF4vpmggWP5MU70QO6,7,4,2,0,3,0,2,0,11,1.5714285714285714,2,0.0,1,2,0,3,3,0,0,2,0,6,5,1
10062,172478,7veRLmOXH6Z7w92gomETN6VvuGcgVtpo,5Gyp41oLVo7Gg7vF4vpmggWP5MU70QO6,7,3,2,0,2,0,2,0,9,1.2857142857142858,1,0.0,0,2,0,2,3,0,0,2,0,4,5,1
10063,172493,OmGw3VG1Kot9ZVAXXHzYH5KLDTxt3KBb,5Gyp41oLVo7Gg7vF4vpmggWP5MU70QO6,5,2,1,0,1,0,2,0,6,0.8571428571428571,1,0.0,0,1,0,1,2,0,0,2,0,2,4,1
10064,172498,6qNWXHct28SXsoCVlzpIHJGmH1udkMRZ,5Gyp41oLVo7Gg7vF4vpmggWP5MU70QO6,12,8,6,0,4,1,7,1,27,3.857142857142857,1,0.0,0,6,0,4,8,1,0,7,1,10,17,1
10065,172515,VrGl46tWb2FJndejFSg5rEj10FD1RSZJ,5Gyp41oLVo7Gg7vF4vpmggWP5MU70QO6,5,2,1,0,1,0,2,0,6,0.8571428571428571,1,0.0,0,1,0,1,2,0,0,2,0,2,4,1
10066,172524,tE5507lMe2f0i5SPUDGg3oFlG9cJ7zGD,5Gyp41oLVo7Gg7vF4vpmggWP5MU70QO6,2,0,0,0,0,0,2,0,2,0.2857142857142857,1,0.0,0,0,0,0,0,0,0,2,0,0,2,1
10067,172526,24L7xvhKlknyF3TFtffk5NsoEEPTVTdN,5Gyp41oLVo7Gg7vF4vpmggWP5MU70QO6,1,0,0,0,0,0,1,0,1,0.14285714285714285,1,0.0,0,0,0,0,0,0,0,1,0,0,1,1
10068,172545,CHHf2P071V6Zt83z3XymyniYuus5PKOR,5Gyp41oLVo7Gg7vF4vpmggWP5MU70QO6,5,2,1,0,1,0,2,0,6,0.8571428571428571,1,0.0,0,1,0,1,2,0,0,2,0,2,4,1
10069,172547,JX4YgGT3KVfxdSZfyB08qYqlgwP14Voi,5Gyp41oLVo7Gg7vF4vpmggWP5MU70QO6,8,2,2,0,2,0,7,0,13,1.8571428571428572,2,0.0,0,2,0,2,2,0,0,7,0,4,9,1
10070,172706,ExYCcuGVzDNcCtA4rQqosA267qlGxHih,7GRhBDsirIGkRZBtSMEzNTyDr2JQm4xx,1,0,0,0,0,0,1,0,1,0.14285714285714285,1,0.0,0,0,0,0,0,0,0,1,0,0,1,1
10071,172761,sL5jw3pLWZoRI7avI17oM60mfF67Acgz,fbPkOYLVPtPgIt0MxizjfFJov3JbHyAi,1,0,0,0,0,0,1,0,1,0.14285714285714285,1,0.0,0,0,0,0,0,0,0,1,0,0,1,0
10072,172762,wbFZf0vBGr8ZagqGAnXAxrCWXPqmHozC,fbPkOYLVPtPgIt0MxizjfFJov3JbHyAi,2,0,0,0,0,0,2,0,2,0.2857142857142857,1,0.0,0,0,0,0,0,0,0,2,0,0,2,0
10073,172765,FCKT6MkDLYtXjU09PIKyFBtLX8xJDhrf,fbPkOYLVPtPgIt0MxizjfFJov3JbHyAi,7,8,3,0,3,0,3,0,17,2.4285714285714284,1,0.0,2,3,0,3,6,0,0,3,0,8,9,1
10074,172767,fJdUKH8czX92V7yfMeG7e087z1xbQDMc,fbPkOYLVPtPgIt0MxizjfFJov3JbHyAi,8,4,2,8,2,0,3,0,19,2.7142857142857144,1,0.0,1,2,6,2,3,0,2,3,0,11,8,0
10075,172768,fxBTxCWQMcuL1ujf7SabjHZ1ZIFJ9pkF,fbPkOYLVPtPgIt0MxizjfFJov3JbHyAi,9,3,2,0,2,4,5,1,17,2.4285714285714284,1,0.0,0,2,0,2,3,4,0,5,1,4,13,0
10076,172769,FhtwGNNoWtYYBXhYRu77jAPRU1UPxpBL,fbPkOYLVPtPgIt0MxizjfFJov3JbHyAi,6,2,1,0,1,1,6,0,11,1.5714285714285714,1,0.0,0,1,0,1,2,1,0,6,0,2,9,1
10077,172771,KE5lO6aSQLCwVE0O69z4EJfWuRdL7m4s,fbPkOYLVPtPgIt0MxizjfFJov3JbHyAi,4,3,0,0,0,0,2,0,5,0.7142857142857143,1,0.0,0,0,0,0,3,0,0,2,0,0,5,1
10078,172772,LtzhMvffdYGC90eIPWCLXgtedBYYH9fM,fbPkOYLVPtPgIt0MxizjfFJov3JbHyAi,9,10,6,0,4,0,4,0,24,3.4285714285714284,1,0.0,0,6,0,4,10,0,0,4,0,10,14,1
10079,172774,gB5HWH0mOh0kDVOfQI64mBbfnIbkstH2,fbPkOYLVPtPgIt0MxizjfFJov3JbHyAi,1,0,0,0,0,0,2,0,2,0.2857142857142857,1,0.0,0,0,0,0,0,0,0,2,0,0,2,1
10080,172777,auNkHGu4Rt8vZQ9zNGbUczKKhC4c3uzs,fbPkOYLVPtPgIt0MxizjfFJov3JbHyAi,2,0,0,0,0,0,3,0,3,0.42857142857142855,1,0.0,0,0,0,0,0,0,0,3,0,0,3,1
10081,172778,u9U6O6GxVn6L6EV5GIFg6G5cI8qZfIM1,fbPkOYLVPtPgIt0MxizjfFJov3JbHyAi,10,14,6,10,7,0,1,0,38,5.428571428571429,1,0.0,7,6,7,7,7,0,3,1,0,27,11,1
10082,172782,hBqYoPWGXo4KdSE3ypv2nDXmsYrpwKgj,fbPkOYLVPtPgIt0MxizjfFJov3JbHyAi,1,0,0,0,0,0,1,0,1,0.14285714285714285,1,0.0,0,0,0,0,0,0,0,1,0,0,1,1
10083,172785,C87lmiSHSHpPfjMHbWD8ZXVnLweVELbL,fbPkOYLVPtPgIt0MxizjfFJov3JbHyAi,7,5,4,0,4,0,2,0,15,2.142857142857143,1,0.0,0,4,0,4,5,0,0,2,0,8,7,0
10084,172786,W2QJpo3u65dH7Vg4ELU4fWWnd2h7zvJo,fbPkOYLVPtPgIt0MxizjfFJov3JbHyAi,7,3,2,0,2,0,2,0,9,1.2857142857142858,1,0.0,0,2,0,2,3,0,0,2,0,4,5,1
10085,172788,AdGrDPzRCdhLnxw2bXPrqz4KpvoO53Dv,fbPkOYLVPtPgIt0MxizjfFJov3JbHyAi,1,0,0,0,0,0,1,0,1,0.14285714285714285,1,0.0,0,0,0,0,0,0,0,1,0,0,1,1
10086,173137,jV4bQZTO8NhEnxumKD5qHxnk6auhtohn,SpATywNh6bZuzm8s1ceuBUnMUAeoAHHw,13,18,10,17,2,0,4,0,51,7.285714285714286,1,0.0,4,10,14,2,14,0,3,4,0,30,21,0
10087,173196,Onur1k8BbMmdXS69pUJADE01Ed10y0pN,5X6FeZozNMgE2VRi3MJYjkkFK8SETtu2,14,14,3,16,9,0,5,0,47,6.714285714285714,1,0.0,10,3,13,9,4,0,3,5,0,35,12,1
10088,173197,zqUAGRJeRsAIzVzBuppa7Q4T67s4AWlA,5X6FeZozNMgE2VRi3MJYjkkFK8SETtu2,10,5,3,0,1,7,10,1,27,3.857142857142857,1,0.0,0,3,0,1,5,7,0,10,1,4,23,1
10089,173247,WLAmx1xu6Oqj4DvlomeHAJXvMyktUiPG,SpATywNh6bZuzm8s1ceuBUnMUAeoAHHw,14,30,0,5,0,0,5,0,40,5.714285714285714,2,0.0,2,0,5,0,28,0,0,5,0,7,33,0
10090,173261,0S6LD77Xb8NCAw50mR3BuCC8qj8MNTO7,SpATywNh6bZuzm8s1ceuBUnMUAeoAHHw,5,4,0,0,0,0,1,0,5,0.7142857142857143,1,0.0,0,0,0,0,4,0,0,1,0,0,5,1
10091,173338,l1rg3D8Gp1lv7dbBBYKvzTS3OZ5DRjWH,5X6FeZozNMgE2VRi3MJYjkkFK8SETtu2,7,3,2,0,2,0,2,0,9,1.2857142857142858,1,0.0,0,2,0,2,3,0,0,2,0,4,5,1
10092,173377,yXswtM5JLeFOmbJVeZSujYIJ6Bw6uTnK,5X6FeZozNMgE2VRi3MJYjkkFK8SETtu2,1,0,0,0,0,0,1,0,1,0.14285714285714285,1,0.0,0,0,0,0,0,0,0,1,0,0,1,1
10093,173385,6zkfkzRggPwWg3UZoQWcyxzfEM8AGlOj,5X6FeZozNMgE2VRi3MJYjkkFK8SETtu2,1,0,0,0,0,0,1,0,1,0.14285714285714285,1,0.0,0,0,0,0,0,0,0,1,0,0,1,1
10094,173505,SZ5q3TqDiWq8s23sHXWpsG5po2IH5JPk,5X6FeZozNMgE2VRi3MJYjkkFK8SETtu2,18,20,5,20,10,0,2,0,57,8.142857142857142,2,0.0,13,5,18,10,7,0,2,2,0,46,11,1
10095,173713,egPy9UABAfgaiori25BYfS5YDOglEmVj,5X6FeZozNMgE2VRi3MJYjkkFK8SETtu2,1,0,0,0,0,0,1,0,1,0.14285714285714285,1,0.0,0,0,0,0,0,0,0,1,0,0,1,1
10096,173819,wGfXRYqHkdAo1fVEEY9NvW8qy6M9m0mI,5X6FeZozNMgE2VRi3MJYjkkFK8SETtu2,1,0,0,0,0,0,1,0,1,0.14285714285714285,1,0.0,0,0,0,0,0,0,0,1,0,0,1,1
10097,173851,quIYM1jY47tlZKkC1EmJRDFcBV4a3Pzy,5X6FeZozNMgE2VRi3MJYjkkFK8SETtu2,1,0,0,0,0,0,2,0,2,0.2857142857142857,1,0.0,0,0,0,0,0,0,0,2,0,0,2,1
10098,173962,wLc4w0avBex1xIgZCkms6IVr5BNBkA7D,5X6FeZozNMgE2VRi3MJYjkkFK8SETtu2,1,0,0,0,0,0,1,0,1,0.14285714285714285,1,0.0,0,0,0,0,0,0,0,1,0,0,1,1
10099,173964,my33FPQMSZttKqR0p8zRP2Bz5eCFTYNb,5X6FeZozNMgE2VRi3MJYjkkFK8SETtu2,4,2,0,0,0,0,2,1,5,0.7142857142857143,1,0.0,0,0,0,0,2,0,0,2,1,0,5,1
10100,174023,qCRa9Z4oZ6HdXxtc9b3V1X8DNEfTKusC,SpATywNh6bZuzm8s1ceuBUnMUAeoAHHw,4,5,0,0,0,0,1,0,6,0.8571428571428571,1,0.0,0,0,0,0,5,0,0,1,0,0,6,1
10101,174033,5meVJnfzVUZ3TsgkTSkPAZOA5DSRKfSE,G8EPVSXsOYB5YQWZGiz1aVq5Pgr2GrQu,4,4,0,0,0,0,1,0,5,0.7142857142857143,1,0.0,0,0,0,0,4,0,0,1,0,0,5,1
10102,174062,LV2ZqzgejnQSlgBX64qrhkASE0YDX4Nk,5X6FeZozNMgE2VRi3MJYjkkFK8SETtu2,4,2,1,0,1,0,1,0,5,0.7142857142857143,1,0.0,0,1,0,1,2,0,0,1,0,2,3,1
10103,174086,Q3T5Pj9Os86NEqSmgUZNRoi8BUkSoDlj,5X6FeZozNMgE2VRi3MJYjkkFK8SETtu2,4,3,1,0,1,0,1,0,6,0.8571428571428571,1,0.0,0,1,0,1,3,0,0,1,0,2,4,1
10104,174094,YbJnM4aRUVyy4lj5U7KoiyOh79gNSdfq,5X6FeZozNMgE2VRi3MJYjkkFK8SETtu2,1,0,0,0,0,0,1,0,1,0.14285714285714285,1,0.0,0,0,0,0,0,0,0,1,0,0,1,1
10105,174129,uqlgX8A7SUtqJk3Mbczq0KHvMYCvfzG2,5X6FeZozNMgE2VRi3MJYjkkFK8SETtu2,2,0,0,0,0,0,2,0,2,0.2857142857142857,1,0.0,0,0,0,0,0,0,0,2,0,0,2,1
10106,174150,kj5o7wMZl1s4q0cggcmipnm7O7L6g4Ps,5X6FeZozNMgE2VRi3MJYjkkFK8SETtu2,2,0,0,0,0,0,2,0,2,0.2857142857142857,1,0.0,0,0,0,0,0,0,0,2,0,0,2,0
10107,174161,P6kyYSEKKZ0iHfKyFCH0qmij523H8pkT,5X6FeZozNMgE2VRi3MJYjkkFK8SETtu2,4,2,0,0,0,0,3,0,5,0.7142857142857143,2,0.0,0,0,0,0,2,0,0,3,0,0,5,1
10108,174199,M4qxCm572dyAklYyW6rlwVA2xGuuy2h9,5X6FeZozNMgE2VRi3MJYjkkFK8SETtu2,1,0,0,0,0,0,1,0,1,0.14285714285714285,1,0.0,0,0,0,0,0,0,0,1,0,0,1,1
10109,174214,VDwK5GjNxjIBIFJ8IiUz3hJdb2yL61fP,5X6FeZozNMgE2VRi3MJYjkkFK8SETtu2,2,0,0,0,0,0,3,0,3,0.42857142857142855,1,0.0,0,0,0,0,0,0,0,3,0,0,3,1
10110,174284,Z6SakRvyvh7ZuaV4DHEE1b3QLOpPcfOm,5X6FeZozNMgE2VRi3MJYjkkFK8SETtu2,5,4,0,0,0,0,1,0,5,0.7142857142857143,1,0.0,0,0,0,0,4,0,0,1,0,0,5,1
10111,174307,8cEAUyffHekiZonoKVizh2shGTTIPP8A,5X6FeZozNMgE2VRi3MJYjkkFK8SETtu2,6,14,2,2,4,0,3,0,25,3.5714285714285716,1,0.0,4,2,2,4,10,0,0,3,0,12,13,1
10112,174326,J3VXT3AGxePcqOmM7ZzWzkqh6USRsZv2,5X6FeZozNMgE2VRi3MJYjkkFK8SETtu2,1,0,0,0,0,0,2,0,2,0.2857142857142857,1,0.0,0,0,0,0,0,0,0,2,0,0,2,1
10113,174335,apRBg875HDkrVuiXCnSpAny1kVq4teuC,5X6FeZozNMgE2VRi3MJYjkkFK8SETtu2,1,0,0,0,0,0,1,0,1,0.14285714285714285,1,0.0,0,0,0,0,0,0,0,1,0,0,1,1
10114,174360,NiXPZUmEILmWUPwXexYxtHvaIL7QdjCQ,5X6FeZozNMgE2VRi3MJYjkkFK8SETtu2,1,0,0,0,0,0,1,0,1,0.14285714285714285,1,0.0,0,0,0,0,0,0,0,1,0,0,1,1
10115,174477,2qErfPJEK7aTW1rziy33w8EhOiv9QEBF,5X6FeZozNMgE2VRi3MJYjkkFK8SETtu2,1,0,0,0,0,0,1,0,1,0.14285714285714285,1,0.0,0,0,0,0,0,0,0,1,0,0,1,1
10116,174509,VsE2LeE7ywjA9zrP4rgjvGL9Xd85duLx,5X6FeZozNMgE2VRi3MJYjkkFK8SETtu2,1,0,0,0,0,0,1,0,1,0.14285714285714285,1,0.0,0,0,0,0,0,0,0,1,0,0,1,1
10117,174517,w9Tvfxwew7B8bZZNiNcsObnxcSHkChnX,5X6FeZozNMgE2VRi3MJYjkkFK8SETtu2,1,0,0,0,0,0,1,0,1,0.14285714285714285,1,0.0,0,0,0,0,0,0,0,1,0,0,1,1
10118,174567,GvWLI1Mjpde6Jh0s8HrsDR9KjfiyAndZ,5X6FeZozNMgE2VRi3MJYjkkFK8SETtu2,8,3,2,0,2,0,3,0,10,1.4285714285714286,1,0.0,0,2,0,2,3,0,0,3,0,4,6,1
10119,174640,kxEogtMmiGCs5fUFOyuDzAyzgV6L921E,5X6FeZozNMgE2VRi3MJYjkkFK8SETtu2,6,6,1,4,1,0,2,0,14,2.0,1,0.0,2,1,3,1,4,0,1,2,0,7,7,1
10120,174722,ynJJFwajTtaKh2c9i2j2wRxuEmNuGHmW,SpATywNh6bZuzm8s1ceuBUnMUAeoAHHw,6,6,0,0,0,0,1,0,7,1.0,1,0.0,0,0,0,0,6,0,0,1,0,0,7,1
10121,174886,JsUvqozri9AItThk54BBjEwYIqDey9JK,5X6FeZozNMgE2VRi3MJYjkkFK8SETtu2,1,0,0,0,0,0,2,0,2,0.2857142857142857,1,0.0,0,0,0,0,0,0,0,2,0,0,2,1
10122,174919,MkluYfJDefHhcRPY3QsRGiWxg2BDcm18,5X6FeZozNMgE2VRi3MJYjkkFK8SETtu2,1,0,0,0,0,0,1,0,1,0.14285714285714285,1,0.0,0,0,0,0,0,0,0,1,0,0,1,1
10123,174954,z8k124y3f3RHISxJ0rlxzPOIGBXwWCJd,5X6FeZozNMgE2VRi3MJYjkkFK8SETtu2,5,4,3,0,1,0,2,0,10,1.4285714285714286,1,0.0,0,3,0,1,4,0,0,2,0,4,6,1
10124,174975,ZzaZO5citAcoeYBQ4xnco2bMgq0deP0c,5X6FeZozNMgE2VRi3MJYjkkFK8SETtu2,10,17,0,4,1,7,14,2,45,6.428571428571429,2,0.0,2,0,3,1,15,7,1,14,2,6,39,1
10125,175094,8udxV2CUMzjrYKDDJj8ojQtJ8oHj3KH6,SpATywNh6bZuzm8s1ceuBUnMUAeoAHHw,1,0,0,0,0,0,1,0,1,0.14285714285714285,1,0.0,0,0,0,0,0,0,0,1,0,0,1,1
10126,175116,cKCzrCCCXe9nkBgWepq9AEXje7SITRTz,5X6FeZozNMgE2VRi3MJYjkkFK8SETtu2,1,0,0,0,0,0,1,0,1,0.14285714285714285,1,0.0,0,0,0,0,0,0,0,1,0,0,1,1
10127,175304,SZHxM16r0lTBVocJi0Li5OQAgxZ4K7jz,5X6FeZozNMgE2VRi3MJYjkkFK8SETtu2,1,0,0,0,0,0,1,0,1,0.14285714285714285,1,0.0,0,0,0,0,0,0,0,1,0,0,1,1
10128,175553,u63nhWQlMjNxplBlLZJLvDLqiAG5Ii9t,5Gyp41oLVo7Gg7vF4vpmggWP5MU70QO6,2,0,0,0,0,0,2,0,2,0.2857142857142857,1,0.0,0,0,0,0,0,0,0,2,0,0,2,1
10129,175555,t36XNyttEGYEbruJSYQeLq0WrBQsRaPU,5Gyp41oLVo7Gg7vF4vpmggWP5MU70QO6,11,7,3,0,3,0,4,1,18,2.5714285714285716,1,0.0,0,3,0,3,7,0,0,4,1,6,12,1
10130,175563,UFDFWUfRjajJSLhSI9UXvyAfHFYjQony,5Gyp41oLVo7Gg7vF4vpmggWP5MU70QO6,1,0,0,0,0,0,1,0,1,0.14285714285714285,1,0.0,0,0,0,0,0,0,0,1,0,0,1,1
10131,175565,xqBPSJ2eEWnWMWegTkFOclmNnVQwOvHX,5Gyp41oLVo7Gg7vF4vpmggWP5MU70QO6,7,3,2,0,2,0,2,0,9,1.2857142857142858,1,0.0,0,2,0,2,3,0,0,2,0,4,5,1
10132,175566,Elx2cQbVo6qKFXoh3EPlogaaktsTt9KM,5Gyp41oLVo7Gg7vF4vpmggWP5MU70QO6,11,9,4,0,3,1,8,1,26,3.7142857142857144,2,0.0,0,4,0,3,9,1,0,8,1,7,19,1
10133,175600,84UIkLYsQU8mKKaif9FyRob9BPLE2tXb,5Gyp41oLVo7Gg7vF4vpmggWP5MU70QO6,4,2,0,0,0,0,2,0,4,0.5714285714285714,1,0.0,0,0,0,0,2,0,0,2,0,0,4,1
10134,175611,oZMcISGXpf39Ki0OFyNrpBR0qwxKGL5O,5Gyp41oLVo7Gg7vF4vpmggWP5MU70QO6,9,9,3,0,1,0,4,0,17,2.4285714285714284,1,0.0,1,3,0,1,8,0,0,4,0,5,12,1
10135,175662,GpVALwWCULScAJNB9JPTpTgcXMDeMnis,5Gyp41oLVo7Gg7vF4vpmggWP5MU70QO6,9,10,5,0,3,0,4,0,22,3.142857142857143,2,0.0,0,5,0,3,10,0,0,4,0,8,14,1
10136,175665,Dq9IlPGakCKNnQEyVCyfmnYzKLFM3IiV,5Gyp41oLVo7Gg7vF4vpmggWP5MU70QO6,1,0,0,0,0,0,2,0,2,0.2857142857142857,1,0.0,0,0,0,0,0,0,0,2,0,0,2,1
10137,175689,kRiA8zJGRlNfHAF5JnuCp6g9v3Wlutb2,5Gyp41oLVo7Gg7vF4vpmggWP5MU70QO6,1,0,0,0,0,0,1,0,1,0.14285714285714285,1,0.0,0,0,0,0,0,0,0,1,0,0,1,1
10138,175703,1BPGbYKUavDbuG831TPn7gRkKOJIPHCj,5Gyp41oLVo7Gg7vF4vpmggWP5MU70QO6,23,38,18,8,6,3,12,1,86,12.285714285714286,1,0.0,15,18,6,6,23,3,2,12,1,45,41,1
10139,175735,2lzDh3x2KSIEgtLiSmTTTSbzuEstP81K,5Gyp41oLVo7Gg7vF4vpmggWP5MU70QO6,16,19,13,2,0,0,10,1,45,6.428571428571429,2,0.0,1,13,1,0,18,0,1,10,1,15,30,1
10140,175745,zVoKsR8MYsX1JulbW88TK7RKDnCpGIy6,5Gyp41oLVo7Gg7vF4vpmggWP5MU70QO6,20,26,10,9,6,2,4,0,57,8.142857142857142,1,0.0,14,10,7,6,12,2,2,4,0,37,20,1
10141,175856,FISJwOKDHl5L2bwPnRQrQvOIdUTZaN4Z,5Gyp41oLVo7Gg7vF4vpmggWP5MU70QO6,1,0,0,0,0,0,2,0,2,0.2857142857142857,1,0.0,0,0,0,0,0,0,0,2,0,0,2,1
10142,175865,TdYIfwLy6LbeyFMhhypR34oXRcMJhweg,5Gyp41oLVo7Gg7vF4vpmggWP5MU70QO6,8,7,4,0,2,0,2,0,15,2.142857142857143,1,0.0,0,4,0,2,7,0,0,2,0,6,9,1
10143,175879,DirzEgelosWZwAQMMiGy5whzyBBW4Ilk,5Gyp41oLVo7Gg7vF4vpmggWP5MU70QO6,1,0,0,0,0,0,1,0,1,0.14285714285714285,1,0.0,0,0,0,0,0,0,0,1,0,0,1,1
10144,175894,Ai6ToSZgR58w4Ua3zULXQkKe6hfDFbXY,5Gyp41oLVo7Gg7vF4vpmggWP5MU70QO6,1,0,0,0,0,0,1,0,1,0.14285714285714285,1,0.0,0,0,0,0,0,0,0,1,0,0,1,1
10145,175910,KifohttwILmFFF2lY14tsLQ0dfmGpZ3P,5Gyp41oLVo7Gg7vF4vpmggWP5MU70QO6,6,3,2,0,2,0,1,0,8,1.1428571428571428,1,0.0,0,2,0,2,3,0,0,1,0,4,4,1
10146,175920,nk68g4BF2bKYXOULXwqYqKWNlKeo6jEg,5Gyp41oLVo7Gg7vF4vpmggWP5MU70QO6,1,0,0,0,0,0,2,0,2,0.2857142857142857,1,0.0,0,0,0,0,0,0,0,2,0,0,2,1
10147,175921,vUteL5SylYbfSOWO5XzZKIOWa2vtUv73,5Gyp41oLVo7Gg7vF4vpmggWP5MU70QO6,7,3,2,0,2,0,2,0,9,1.2857142857142858,1,0.0,0,2,0,2,3,0,0,2,0,4,5,1
10148,175929,piqwp35xaKMhWL3tWUGgxOuWXOgGDGgO,5Gyp41oLVo7Gg7vF4vpmggWP5MU70QO6,12,7,4,4,2,2,3,0,22,3.142857142857143,1,0.0,1,4,2,2,6,2,2,3,0,9,13,1
10149,175949,FUDQ2uOsJiUsmFwGJcOX1bvtM6hlWBXm,5Gyp41oLVo7Gg7vF4vpmggWP5MU70QO6,9,11,3,2,2,0,2,0,20,2.857142857142857,1,0.0,7,3,1,2,4,0,1,2,0,13,7,1
10150,175959,uqYPsXyywpvPKb8LH9eDPGyl21TTxdxh,5Gyp41oLVo7Gg7vF4vpmggWP5MU70QO6,13,7,5,2,4,0,2,0,20,2.857142857142857,1,0.0,1,5,1,4,6,0,1,2,0,11,9,1
10151,175965,7ftZsfya8jQVLBDKFpvbaYjGSV8eGRSV,5Gyp41oLVo7Gg7vF4vpmggWP5MU70QO6,13,19,10,10,10,0,8,0,57,8.142857142857142,1,0.0,9,10,5,10,10,0,5,8,0,34,23,1
10152,175971,fMHcKCwHRfgj0TyGDe4Zs5DZmJ5yP7f9,5Gyp41oLVo7Gg7vF4vpmggWP5MU70QO6,1,0,0,0,0,0,1,0,1,0.14285714285714285,1,0.0,0,0,0,0,0,0,0,1,0,0,1,1
10153,175980,hic3fl8NTkEwcv4fRIZX50Bq1GBvotTD,5Gyp41oLVo7Gg7vF4vpmggWP5MU70QO6,7,5,2,4,1,1,2,0,15,2.142857142857143,1,0.0,2,2,2,1,3,1,2,2,0,7,8,1
10154,175988,f7b9jaYG3ZonTVVmrdcHmJXqtDuk4uDp,5Gyp41oLVo7Gg7vF4vpmggWP5MU70QO6,7,2,1,0,1,0,4,1,9,1.2857142857142858,1,0.0,0,1,0,1,2,0,0,4,1,2,7,1
10155,176007,ObXxMfJGKfWbFMKlTyZ8lXepPKFlmf7O,5Gyp41oLVo7Gg7vF4vpmggWP5MU70QO6,5,2,1,0,1,0,2,0,6,0.8571428571428571,1,0.0,0,1,0,1,2,0,0,2,0,2,4,1
10156,176009,MeeIYx8PG9U4eJ0fUaEgwUUwBfjTnwBv,5Gyp41oLVo7Gg7vF4vpmggWP5MU70QO6,11,10,8,0,2,0,3,0,23,3.2857142857142856,1,0.0,0,8,0,2,10,0,0,3,0,10,13,1
10157,176016,JeHbCqSsKDyNUBLGsI70pczdTjZOM443,5Gyp41oLVo7Gg7vF4vpmggWP5MU70QO6,7,2,1,0,1,0,4,0,8,1.1428571428571428,1,0.0,0,1,0,1,2,0,0,4,0,2,6,1
10158,176023,uhPNW6SwFQxv8jldkzl8dc8KVG6lDQod,5Gyp41oLVo7Gg7vF4vpmggWP5MU70QO6,5,2,1,0,1,0,3,0,7,1.0,1,0.0,0,1,0,1,2,0,0,3,0,2,5,1
10159,176027,tGx5xdPMJB2mV7gvzfJo4bTZYHo6S1ZI,5Gyp41oLVo7Gg7vF4vpmggWP5MU70QO6,11,6,4,2,3,0,2,0,17,2.4285714285714284,1,0.0,1,4,1,3,5,0,1,2,0,9,8,1
10160,176044,eITC0QO78ckIa0Ac0qBdRA2zdXlT6nZi,5Gyp41oLVo7Gg7vF4vpmggWP5MU70QO6,5,2,1,0,1,0,2,0,6,0.8571428571428571,1,0.0,0,1,0,1,2,0,0,2,0,2,4,1
10161,176054,ARNT70yvoerfF5OniVgYjOOtVO7gcR5y,5Gyp41oLVo7Gg7vF4vpmggWP5MU70QO6,1,0,0,0,0,0,1,0,1,0.14285714285714285,1,0.0,0,0,0,0,0,0,0,1,0,0,1,1
10162,176073,YIP2lGlyHeizVemmX7CB6G13iA5LoUV3,5Gyp41oLVo7Gg7vF4vpmggWP5MU70QO6,9,8,3,4,2,0,2,0,19,2.7142857142857144,1,0.0,4,3,2,2,4,0,2,2,0,11,8,1
10163,176077,JDfKwfMlyOCQxbeSyKM0fmiRtEFW5UHc,5Gyp41oLVo7Gg7vF4vpmggWP5MU70QO6,8,2,1,0,1,1,4,1,10,1.4285714285714286,1,0.0,0,1,0,1,2,1,0,4,1,2,8,1
10164,176086,BNdeN6WqA0qmlaX8IHq825gY7kHHeXPc,5Gyp41oLVo7Gg7vF4vpmggWP5MU70QO6,2,0,0,0,0,0,3,0,3,0.42857142857142855,1,0.0,0,0,0,0,0,0,0,3,0,0,3,1
10165,176112,TSdMB1S3lGhWMmxrdoDVqx8G8xAeKzm9,5Gyp41oLVo7Gg7vF4vpmggWP5MU70QO6,1,0,0,0,0,0,1,0,1,0.14285714285714285,1,0.0,0,0,0,0,0,0,0,1,0,0,1,1
10166,176114,QqNuARzccJUP5HNszzjljOhC9t53eZLk,5Gyp41oLVo7Gg7vF4vpmggWP5MU70QO6,1,0,0,0,0,0,1,0,1,0.14285714285714285,1,0.0,0,0,0,0,0,0,0,1,0,0,1,1
10167,176115,KxgFkXTLAf6Esdw8ag0xHMwGvafkSsCu,5Gyp41oLVo7Gg7vF4vpmggWP5MU70QO6,19,37,15,4,5,46,8,1,116,16.571428571428573,2,0.0,19,15,2,5,18,46,2,8,1,41,75,1
10168,176116,Yuou5IoOdRhjyu5VfIiPne8pzEI4yygt,5Gyp41oLVo7Gg7vF4vpmggWP5MU70QO6,11,9,5,8,0,0,1,0,23,3.2857142857142856,1,0.0,2,5,4,0,7,0,4,1,0,11,12,1
10169,176118,4ikqBBENxt3XhhKUpHGd9SDdjESU1vaO,5Gyp41oLVo7Gg7vF4vpmggWP5MU70QO6,7,3,2,0,2,0,2,0,9,1.2857142857142858,1,0.0,0,2,0,2,3,0,0,2,0,4,5,1
10170,176120,Y1357XabbIWDk01qXtntUOG4FlBDlqWy,5Gyp41oLVo7Gg7vF4vpmggWP5MU70QO6,7,8,2,0,2,0,2,0,14,2.0,1,0.0,0,2,0,2,8,0,0,2,0,4,10,1
10171,176129,IUpvJjgbl643UyF8wULi6B9PKWsV1bsS,5Gyp41oLVo7Gg7vF4vpmggWP5MU70QO6,1,0,0,0,0,0,1,0,1,0.14285714285714285,1,0.0,0,0,0,0,0,0,0,1,0,0,1,1
10172,176135,ZNuOJrCmdbDVwu3316Ns9Xri9mbtOMWp,5Gyp41oLVo7Gg7vF4vpmggWP5MU70QO6,5,3,2,0,2,0,2,0,9,1.2857142857142858,1,0.0,0,2,0,2,3,0,0,2,0,4,5,1
10173,176145,QpBSoSHEl70d7uw9VTolCRX2aYHvdQhX,5Gyp41oLVo7Gg7vF4vpmggWP5MU70QO6,6,1,1,0,1,0,3,0,6,0.8571428571428571,1,0.0,0,1,0,1,1,0,0,3,0,2,4,1
10174,176157,PA5zAI3bEQFeUnwe26PAqLrwJiTm4n2R,5Gyp41oLVo7Gg7vF4vpmggWP5MU70QO6,7,3,2,0,2,0,2,0,9,1.2857142857142858,1,0.0,0,2,0,2,3,0,0,2,0,4,5,1
10175,176161,bvP4VCG0pJjjp00r4CnxF8cuUwkLgH8e,5Gyp41oLVo7Gg7vF4vpmggWP5MU70QO6,12,13,9,0,6,0,15,1,44,6.285714285714286,1,0.0,1,9,0,6,12,0,0,15,1,16,28,1
10176,176169,OD1pqN8En0iNd52vQpaf4DwGLH3W4dof,5Gyp41oLVo7Gg7vF4vpmggWP5MU70QO6,1,0,0,0,0,0,1,0,1,0.14285714285714285,1,0.0,0,0,0,0,0,0,0,1,0,0,1,1
10177,176200,Ti2zUJe9qo9j9ZVP2UEVL9JeUdPOwIHM,5Gyp41oLVo7Gg7vF4vpmggWP5MU70QO6,6,9,6,0,0,0,5,0,20,2.857142857142857,2,0.0,0,6,0,0,9,0,0,5,0,6,14,1
10178,176205,B9aAlpTuKxaBHsrj0RG7kG5QNsYaYsmO,5Gyp41oLVo7Gg7vF4vpmggWP5MU70QO6,1,0,0,0,0,0,1,0,1,0.14285714285714285,1,0.0,0,0,0,0,0,0,0,1,0,0,1,1
10179,176218,c36CHPtUoc6fhEM1NLUSEGc0nqpTev6R,5Gyp41oLVo7Gg7vF4vpmggWP5MU70QO6,7,8,3,0,2,0,1,0,14,2.0,1,0.0,4,3,0,2,4,0,0,1,0,9,5,1
10180,176222,ofGS7KcwxKqmQcoDRP05KNd2lhdqc9OE,5Gyp41oLVo7Gg7vF4vpmggWP5MU70QO6,1,0,0,0,0,0,1,0,1,0.14285714285714285,1,0.0,0,0,0,0,0,0,0,1,0,0,1,1
10181,176230,YUmxw8AhlWaai9qANEKU5JbPFgVk9vKH,5Gyp41oLVo7Gg7vF4vpmggWP5MU70QO6,11,6,3,0,2,0,7,1,19,2.7142857142857144,1,0.0,0,3,0,2,6,0,0,7,1,5,14,1
10182,176236,C3Nk44OWnVsGKuPAx3enIkGku6jeLMIK,5Gyp41oLVo7Gg7vF4vpmggWP5MU70QO6,8,5,3,0,2,0,5,0,15,2.142857142857143,1,0.0,1,3,0,2,4,0,0,5,0,6,9,1
10183,176241,1Dv9y96t10oMZnHhDwrSFZDGRviHNlQf,5Gyp41oLVo7Gg7vF4vpmggWP5MU70QO6,1,0,0,0,0,0,1,0,1,0.14285714285714285,1,0.0,0,0,0,0,0,0,0,1,0,0,1,1
10184,176249,6CMvLh5h5srjVxFWpa9kBiwASsXtHal6,5Gyp41oLVo7Gg7vF4vpmggWP5MU70QO6,4,0,0,0,0,0,5,0,5,0.7142857142857143,1,0.0,0,0,0,0,0,0,0,5,0,0,5,1
10185,176282,G1j3OGbuafsHwZiTquDW8gM0iwcLwj0G,5Gyp41oLVo7Gg7vF4vpmggWP5MU70QO6,1,0,0,0,0,0,2,0,2,0.2857142857142857,1,0.0,0,0,0,0,0,0,0,2,0,0,2,1
10186,176285,upy0zKGQc2Dip5roDfd59XzFwjq2PFEV,5Gyp41oLVo7Gg7vF4vpmggWP5MU70QO6,12,7,4,0,4,6,7,1,29,4.142857142857143,1,0.0,1,4,0,4,6,6,0,7,1,9,20,1
10187,176299,U7XY4QqPO741JpunN73CGK6UMtcgDAi5,5Gyp41oLVo7Gg7vF4vpmggWP5MU70QO6,6,2,1,0,1,1,3,1,9,1.2857142857142858,1,0.0,0,1,0,1,2,1,0,3,1,2,7,1
10188,176300,3UfuCzggNTWXUiVNEYOfqQVufvyqj7kD,5Gyp41oLVo7Gg7vF4vpmggWP5MU70QO6,2,0,0,0,0,0,2,0,2,0.2857142857142857,1,0.0,0,0,0,0,0,0,0,2,0,0,2,1
10189,176306,9vNcgQ5TccJLdeNEo73apzpETn36fL0B,5Gyp41oLVo7Gg7vF4vpmggWP5MU70QO6,7,10,0,0,0,1,14,1,26,3.7142857142857144,1,0.0,0,0,0,0,10,1,0,14,1,0,26,1
10190,176307,czKChsqaxfwVoznY2WnWYH2vLIXb6X34,5Gyp41oLVo7Gg7vF4vpmggWP5MU70QO6,11,12,9,2,6,0,3,0,32,4.571428571428571,1,0.0,2,9,1,6,10,0,1,3,0,18,14,1
10191,176331,dl8GqF7Bxl75akw7CrLpwkZF8TE7q4rA,5Gyp41oLVo7Gg7vF4vpmggWP5MU70QO6,1,0,0,0,0,0,2,0,2,0.2857142857142857,1,0.0,0,0,0,0,0,0,0,2,0,0,2,1
10192,176405,b9mxLoVADmerKv5HkkvTTWu7wHJ0K2g8,5X6FeZozNMgE2VRi3MJYjkkFK8SETtu2,4,2,1,0,1,0,1,0,5,0.7142857142857143,1,0.0,0,1,0,1,2,0,0,1,0,2,3,1
10193,176411,f8gEnkOWvMQIzCDEd46i00q4dVKvWUZK,5X6FeZozNMgE2VRi3MJYjkkFK8SETtu2,14,15,1,0,1,5,12,1,35,5.0,2,0.0,4,1,0,1,11,5,0,12,1,6,29,1
10194,176418,LniFNdPaciUOqrTfSPwpZs6KRBHeztca,5X6FeZozNMgE2VRi3MJYjkkFK8SETtu2,2,0,0,0,0,0,2,0,2,0.2857142857142857,1,0.0,0,0,0,0,0,0,0,2,0,0,2,1
10195,176445,KKRopoEnIcVLemmRWp2ZZPu1vshGAf1i,5X6FeZozNMgE2VRi3MJYjkkFK8SETtu2,2,0,0,0,0,0,2,0,2,0.2857142857142857,1,0.0,0,0,0,0,0,0,0,2,0,0,2,1
10196,176460,oaoj9be4jW2Hot8wYgYrzLRvB0RU4KYy,5X6FeZozNMgE2VRi3MJYjkkFK8SETtu2,5,4,2,0,1,0,3,0,10,1.4285714285714286,2,0.0,0,2,0,1,4,0,0,3,0,3,7,0
10197,176490,pKAeHHDfjWeWKboBDETcUDHa7kpDQYOp,5X6FeZozNMgE2VRi3MJYjkkFK8SETtu2,15,21,1,6,2,0,6,0,36,5.142857142857143,3,0.0,11,1,6,2,10,0,0,6,0,20,16,1
10198,176508,7g0rMHEyd47fjq4g3xpElNL7nIAjgCwY,5X6FeZozNMgE2VRi3MJYjkkFK8SETtu2,1,0,0,0,0,0,1,0,1,0.14285714285714285,1,0.0,0,0,0,0,0,0,0,1,0,0,1,1
10199,176534,AsKItWOk6yONkGOduP0vUaGEDxnOlUCN,5X6FeZozNMgE2VRi3MJYjkkFK8SETtu2,1,0,0,0,0,0,1,0,1,0.14285714285714285,1,0.0,0,0,0,0,0,0,0,1,0,0,1,1
10200,176600,UBShSm8Kqv0e1GzfDduGhtOotQp2uiza,RXDvfPUBYFlVdlueBFbLW0mhhAyGEqpt,43,39,16,144,7,7,6,0,219,31.285714285714285,2,0.0,13,16,138,7,26,7,6,6,0,174,45,1
10201,176611,c2DvyNdtfr8znslTLKffqC7HmPDiSWw0,RXDvfPUBYFlVdlueBFbLW0mhhAyGEqpt,1,0,0,0,0,0,1,0,1,0.14285714285714285,1,0.0,0,0,0,0,0,0,0,1,0,0,1,1
10202,176686,7VmmzXV3A639hzlpZwrx655FqwOsl8uh,RXDvfPUBYFlVdlueBFbLW0mhhAyGEqpt,9,6,0,0,0,0,5,0,11,1.5714285714285714,1,0.0,0,0,0,0,6,0,0,5,0,0,11,1
10203,176707,9wUPj3RdoqjpRwRmAYUumO6JhXkTAipi,5X6FeZozNMgE2VRi3MJYjkkFK8SETtu2,2,0,0,0,0,0,2,0,2,0.2857142857142857,1,0.0,0,0,0,0,0,0,0,2,0,0,2,1
10204,176724,v4iDqbLy28xt3m4stWuGbxYJ7PMtC6St,G8EPVSXsOYB5YQWZGiz1aVq5Pgr2GrQu,1,0,0,0,0,0,1,0,1,0.14285714285714285,1,0.0,0,0,0,0,0,0,0,1,0,0,1,1
10205,176732,6ifSGyv1OJBX59YUfupEGQzaFg12QLcw,5X6FeZozNMgE2VRi3MJYjkkFK8SETtu2,9,9,7,0,5,0,2,0,23,3.2857142857142856,1,0.0,0,7,0,5,9,0,0,2,0,12,11,1
10206,176733,FzKYBP9DQh3u0w9lQRHJGeubpb75FItD,5X6FeZozNMgE2VRi3MJYjkkFK8SETtu2,5,8,0,0,1,0,1,0,10,1.4285714285714286,1,0.0,3,0,0,1,5,0,0,1,0,4,6,1
10207,176872,tD2t0ZHpAx0YjQwAL8UEB0neif6SIb4V,5X6FeZozNMgE2VRi3MJYjkkFK8SETtu2,1,0,0,0,0,0,1,0,1,0.14285714285714285,1,0.0,0,0,0,0,0,0,0,1,0,0,1,1
10208,176874,wHUsnhrtPSuwmobUglnvlK4BO3Mgdhur,5X6FeZozNMgE2VRi3MJYjkkFK8SETtu2,7,4,1,0,1,0,3,0,9,1.2857142857142858,1,0.0,0,1,0,1,4,0,0,3,0,2,7,1
10209,176897,wjicnAF12JyAapuh15sdon1diUWswaFA,RXDvfPUBYFlVdlueBFbLW0mhhAyGEqpt,6,3,1,0,1,0,2,0,7,1.0,1,0.0,0,1,0,1,3,0,0,2,0,2,5,1
10210,176900,buIoev2zkFP4DoRl01FTndVJ4fGwCvR1,5X6FeZozNMgE2VRi3MJYjkkFK8SETtu2,5,3,1,0,1,0,2,0,7,1.0,1,0.0,0,1,0,1,3,0,0,2,0,2,5,1
10211,176946,bgwwZSIxTFRvIry4LocWcmZ15RQwBsJD,5X6FeZozNMgE2VRi3MJYjkkFK8SETtu2,4,2,1,0,0,0,2,0,5,0.7142857142857143,1,0.0,0,1,0,0,2,0,0,2,0,1,4,1
10212,177004,kaNpWuIxNLxZkDfmjMzrYRVzuOgwIf0o,G8EPVSXsOYB5YQWZGiz1aVq5Pgr2GrQu,1,0,0,0,0,0,1,0,1,0.14285714285714285,1,0.0,0,0,0,0,0,0,0,1,0,0,1,1
10213,177116,Eaa30ereqeYtcFzjnswlE9j5n8XVdiuw,RXDvfPUBYFlVdlueBFbLW0mhhAyGEqpt,1,0,0,0,0,0,1,0,1,0.14285714285714285,1,0.0,0,0,0,0,0,0,0,1,0,0,1,1
10214,177120,6cITiMTgl3oJ2Te8Gyo0QosHV4ODB0Uw,RXDvfPUBYFlVdlueBFbLW0mhhAyGEqpt,27,26,19,0,12,6,6,0,69,9.857142857142858,1,0.0,0,19,0,12,26,6,0,6,0,31,38,0
10215,177126,v0rc6s78QYYUfWFSx1cNskOtUuDahOBd,5X6FeZozNMgE2VRi3MJYjkkFK8SETtu2,1,0,0,0,0,0,1,0,1,0.14285714285714285,1,0.0,0,0,0,0,0,0,0,1,0,0,1,1
10216,177129,v0rc6s78QYYUfWFSx1cNskOtUuDahOBd,RXDvfPUBYFlVdlueBFbLW0mhhAyGEqpt,8,2,1,0,1,0,5,1,10,1.4285714285714286,1,0.0,0,1,0,1,2,0,0,5,1,2,8,1
10217,177136,sN7SpMjN00gTdmZynEw6AXtweTyZtD7L,5X6FeZozNMgE2VRi3MJYjkkFK8SETtu2,13,20,4,4,9,1,8,1,47,6.714285714285714,2,0.0,14,4,4,9,6,1,0,8,1,31,16,1
10218,177148,eT9OhUahWhAeZfHPEbxGN9qGHwvkkQvs,RXDvfPUBYFlVdlueBFbLW0mhhAyGEqpt,1,0,0,0,0,0,1,0,1,0.14285714285714285,1,0.0,0,0,0,0,0,0,0,1,0,0,1,1
10219,177170,eT9OhUahWhAeZfHPEbxGN9qGHwvkkQvs,5X6FeZozNMgE2VRi3MJYjkkFK8SETtu2,1,0,0,0,0,0,1,0,1,0.14285714285714285,1,0.0,0,0,0,0,0,0,0,1,0,0,1,1
10220,177179,nURvxLXCCRcUx0rr21CCKt2pPqq3RcJ7,G8EPVSXsOYB5YQWZGiz1aVq5Pgr2GrQu,1,0,0,0,0,0,1,0,1,0.14285714285714285,1,0.0,0,0,0,0,0,0,0,1,0,0,1,1
10221,177247,QVAnyKdi4bfbM8lryBslY25kPK1liRUQ,5X6FeZozNMgE2VRi3MJYjkkFK8SETtu2,22,22,5,54,0,0,2,0,83,11.857142857142858,1,0.0,11,5,41,0,11,0,13,2,0,57,26,1
10222,177312,Vnz3YQtaGP9Lud4eJsx4REuNf7a7Z6K7,A3fsA9Zfv1X2fVEQhTw51lKENdNrEqT3,2,0,0,0,0,0,2,0,2,0.2857142857142857,1,0.0,0,0,0,0,0,0,0,2,0,0,2,1
10223,177399,uhkDcin3PArnCPqTjpaPDSIZjLR3fQYS,5X6FeZozNMgE2VRi3MJYjkkFK8SETtu2,1,0,0,0,0,0,1,0,1,0.14285714285714285,1,0.0,0,0,0,0,0,0,0,1,0,0,1,1
10224,177414,cRvonGDWMKfxHYP6TdkGqL61F16M4yAA,5X6FeZozNMgE2VRi3MJYjkkFK8SETtu2,8,5,0,0,0,9,6,1,21,3.0,1,0.0,0,0,0,0,5,9,0,6,1,0,21,1
10225,177420,3oOqBk0mNUyJOixMnwNMAtDLNYAAzxVe,5X6FeZozNMgE2VRi3MJYjkkFK8SETtu2,1,0,0,0,0,0,1,0,1,0.14285714285714285,1,0.0,0,0,0,0,0,0,0,1,0,0,1,0
10226,177488,5om6eRMcHP5gmynnbtix8k5kZKtSYX2Y,5X6FeZozNMgE2VRi3MJYjkkFK8SETtu2,1,0,0,0,0,0,1,0,1,0.14285714285714285,1,0.0,0,0,0,0,0,0,0,1,0,0,1,1
10227,177500,UtuMMiTcYdEIPqLGUrTySvaHfGG20tSq,RXDvfPUBYFlVdlueBFbLW0mhhAyGEqpt,1,0,0,0,0,0,1,0,1,0.14285714285714285,1,0.0,0,0,0,0,0,0,0,1,0,0,1,1
10228,178229,ezHVlzRFOuQzT7lSAjSS77hd9tkWn143,3VkHkmOtom3jM2wCu94xgzzu1d6Dn7or,6,3,1,0,1,0,7,0,12,1.7142857142857142,2,0.0,0,1,0,1,3,0,0,7,0,2,10,1
10229,178236,QwzZyncxIP0xpmvrqq9TI7WpBlSuxEsG,3VkHkmOtom3jM2wCu94xgzzu1d6Dn7or,23,41,16,25,12,12,9,1,116,16.571428571428573,2,0.0,8,16,25,12,33,12,0,9,1,61,55,0
10230,178250,PnK3sHjmp9iurby249pq2KvdttYdQKRW,3VkHkmOtom3jM2wCu94xgzzu1d6Dn7or,1,0,0,0,0,0,1,0,1,0.14285714285714285,1,0.0,0,0,0,0,0,0,0,1,0,0,1,1
10231,178274,1PPzZtvE84TH0okLI8t2giD8i25ahpAC,3VkHkmOtom3jM2wCu94xgzzu1d6Dn7or,6,6,3,0,2,0,2,0,13,1.8571428571428572,1,0.0,2,3,0,2,4,0,0,2,0,7,6,1
10232,178330,b1bRMHIApI9jEpz9P7GuojfUgQMKWP9j,3VkHkmOtom3jM2wCu94xgzzu1d6Dn7or,2,0,0,0,0,0,2,0,2,0.2857142857142857,1,0.0,0,0,0,0,0,0,0,2,0,0,2,1
10233,178334,IKBMW4bSkZ4npwOLOl6WJvZEC1iJEL0t,3VkHkmOtom3jM2wCu94xgzzu1d6Dn7or,9,12,5,0,2,0,1,0,20,2.857142857142857,1,0.0,0,5,0,2,12,0,0,1,0,7,13,1
10234,178340,pEtE3Ipf5t4eY8pKkWwLU9yVmJ1macsG,3VkHkmOtom3jM2wCu94xgzzu1d6Dn7or,41,25,21,0,19,0,7,0,72,10.285714285714286,1,0.0,2,21,0,19,23,0,0,7,0,42,30,1
10235,178352,l24ZwtZ809AvtfPOBjCx2HR4aIhDh45V,3VkHkmOtom3jM2wCu94xgzzu1d6Dn7or,1,0,0,0,0,0,1,0,1,0.14285714285714285,1,0.0,0,0,0,0,0,0,0,1,0,0,1,1
10236,178358,AHCSKPmMNEp9VCnrK1PhazxxaN3PTMex,3VkHkmOtom3jM2wCu94xgzzu1d6Dn7or,5,2,1,0,1,0,2,0,6,0.8571428571428571,2,0.0,0,1,0,1,2,0,0,2,0,2,4,1
10237,178361,lbGQIf1S4RIAk470qNloj5exAOH8Hzu2,3VkHkmOtom3jM2wCu94xgzzu1d6Dn7or,1,0,0,0,0,0,1,0,1,0.14285714285714285,1,0.0,0,0,0,0,0,0,0,1,0,0,1,1
10238,178362,bVc5z7ElsCF7gBlVpAN8Nel6M2Y4UpvO,3VkHkmOtom3jM2wCu94xgzzu1d6Dn7or,1,0,0,0,0,0,1,0,1,0.14285714285714285,1,0.0,0,0,0,0,0,0,0,1,0,0,1,1
10239,178382,J5hTpY1e0eer2IGKDWV5nQcxG5rxKFBt,3VkHkmOtom3jM2wCu94xgzzu1d6Dn7or,12,15,3,8,7,22,7,2,64,9.142857142857142,1,0.0,12,3,6,7,3,22,2,7,2,28,36,1
10240,178391,4jiJ0Jol3B1rJ1uebX4eYHcs9BXBbwSL,3VkHkmOtom3jM2wCu94xgzzu1d6Dn7or,5,3,1,0,0,0,3,0,7,1.0,1,0.0,0,1,0,0,3,0,0,3,0,1,6,1
10241,178393,lDxZrY8xnIav3logF53riVDPRGJ1Gd4Z,3VkHkmOtom3jM2wCu94xgzzu1d6Dn7or,14,8,0,0,7,0,3,0,18,2.5714285714285716,2,0.0,0,0,0,7,8,0,0,3,0,7,11,1
10242,178402,RYmi8ZUtWHOBIR4F8jaoqCqY5vCozh2d,3VkHkmOtom3jM2wCu94xgzzu1d6Dn7or,7,2,1,0,1,0,7,1,12,1.7142857142857142,1,0.0,0,1,0,1,2,0,0,7,1,2,10,1
10243,178410,AfmhIxUMCvJIyQbfn8Qovo5eFNjT4F31,3VkHkmOtom3jM2wCu94xgzzu1d6Dn7or,5,6,1,0,2,1,3,0,13,1.8571428571428572,1,0.0,4,1,0,2,2,1,0,3,0,7,6,1
10244,178414,EqRBdyyXr63lLREwOULob6g26cIydQEU,3VkHkmOtom3jM2wCu94xgzzu1d6Dn7or,1,0,0,0,0,0,1,0,1,0.14285714285714285,1,0.0,0,0,0,0,0,0,0,1,0,0,1,1
10245,178476,5FKNtYsTkByroijTHxSZ2wThgqvXV2F5,3VkHkmOtom3jM2wCu94xgzzu1d6Dn7or,1,0,0,0,0,0,1,0,1,0.14285714285714285,1,0.0,0,0,0,0,0,0,0,1,0,0,1,1
10246,178510,kHTHDNs3AT2qXCtVIr1HORujPqoZzBvC,3VkHkmOtom3jM2wCu94xgzzu1d6Dn7or,1,0,0,0,0,0,1,0,1,0.14285714285714285,1,0.0,0,0,0,0,0,0,0,1,0,0,1,1
10247,178517,YWXRs30LfGeBUUdtbLCSDxfSvS9eXAoE,3VkHkmOtom3jM2wCu94xgzzu1d6Dn7or,1,0,0,0,0,0,1,0,1,0.14285714285714285,1,0.0,0,0,0,0,0,0,0,1,0,0,1,1
10248,178562,Xm0fBjDbhiZ1hqhhgWghtT86qcZao5Le,3VkHkmOtom3jM2wCu94xgzzu1d6Dn7or,2,0,0,0,0,0,6,0,6,0.8571428571428571,1,0.0,0,0,0,0,0,0,0,6,0,0,6,1
10249,178565,WbNaxYlp2khAUuwNRYpsWq2TzeuC7aeM,3VkHkmOtom3jM2wCu94xgzzu1d6Dn7or,1,0,0,0,0,0,1,0,1,0.14285714285714285,1,0.0,0,0,0,0,0,0,0,1,0,0,1,1
10250,178584,4cRZxyVNjv13lU3nu2aK2rwyndExVCGa,3VkHkmOtom3jM2wCu94xgzzu1d6Dn7or,1,0,0,0,0,0,1,0,1,0.14285714285714285,1,0.0,0,0,0,0,0,0,0,1,0,0,1,1
10251,178587,qqziGUkyP0c1UHlUr0NUyhQGDrHZcvM8,3VkHkmOtom3jM2wCu94xgzzu1d6Dn7or,1,0,0,0,0,0,1,0,1,0.14285714285714285,1,0.0,0,0,0,0,0,0,0,1,0,0,1,1
10252,178632,R31xuWG2WIcg7UurtGcD2HSlFHOzOAAM,3VkHkmOtom3jM2wCu94xgzzu1d6Dn7or,1,0,0,0,0,0,2,0,2,0.2857142857142857,1,0.0,0,0,0,0,0,0,0,2,0,0,2,1
10253,178662,4gV9HtunfmOYFa4Y5vDKnozL8KtQZEr8,3VkHkmOtom3jM2wCu94xgzzu1d6Dn7or,1,0,0,0,0,0,1,0,1,0.14285714285714285,1,0.0,0,0,0,0,0,0,0,1,0,0,1,1
10254,178707,cRRRs3d58C19e8J7eY2CMLXg3VRv45Sc,3VkHkmOtom3jM2wCu94xgzzu1d6Dn7or,8,8,3,0,3,0,3,0,17,2.4285714285714284,1,0.0,4,3,0,3,4,0,0,3,0,10,7,1
10255,178711,cRIBlSgBUu5wnHayYLXYGXCywSveNH4q,3VkHkmOtom3jM2wCu94xgzzu1d6Dn7or,7,5,3,0,2,0,5,0,15,2.142857142857143,2,0.0,1,3,0,2,4,0,0,5,0,6,9,1
10256,178742,07vmWpDBCHouqhHbgDjMrw8KyXCN8Jrf,3VkHkmOtom3jM2wCu94xgzzu1d6Dn7or,1,0,0,0,0,0,1,0,1,0.14285714285714285,1,0.0,0,0,0,0,0,0,0,1,0,0,1,1
10257,178778,JTRQvfGtRc9gBfTBY7Oabdk1HOKCCyLc,3VkHkmOtom3jM2wCu94xgzzu1d6Dn7or,1,0,0,0,0,0,1,0,1,0.14285714285714285,1,0.0,0,0,0,0,0,0,0,1,0,0,1,1
10258,178875,CLnxWdrXfHcQbh2wYX7hvr8ePMiTxXWb,3VkHkmOtom3jM2wCu94xgzzu1d6Dn7or,5,2,1,0,1,0,4,0,8,1.1428571428571428,1,0.0,0,1,0,1,2,0,0,4,0,2,6,1
10259,178886,NjJdvoaEm2slzoNjLhqS1xsYViIZpyCY,3VkHkmOtom3jM2wCu94xgzzu1d6Dn7or,1,0,0,0,0,0,1,0,1,0.14285714285714285,1,0.0,0,0,0,0,0,0,0,1,0,0,1,1
10260,178894,4IEUBrnVsXQgXXrlX6hPh5y9QYArGc5Z,3VkHkmOtom3jM2wCu94xgzzu1d6Dn7or,1,0,0,0,0,0,1,0,1,0.14285714285714285,1,0.0,0,0,0,0,0,0,0,1,0,0,1,1
10261,178902,QKFoY6VnyEPdqy4FjBYvw98ymmZAxzgO,3VkHkmOtom3jM2wCu94xgzzu1d6Dn7or,3,0,0,0,0,0,5,0,5,0.7142857142857143,1,0.0,0,0,0,0,0,0,0,5,0,0,5,1
10262,178990,vX3W9boyH9FnYaGERf0Y2U2q4fFQbOYH,3VkHkmOtom3jM2wCu94xgzzu1d6Dn7or,1,0,0,0,0,0,1,0,1,0.14285714285714285,1,0.0,0,0,0,0,0,0,0,1,0,0,1,1
10263,179038,BY9wj7roiUxcr0Kghn3nJYs8OUKxCCE2,3VkHkmOtom3jM2wCu94xgzzu1d6Dn7or,1,0,0,0,0,0,1,0,1,0.14285714285714285,1,0.0,0,0,0,0,0,0,0,1,0,0,1,1
10264,179055,FKroAYBvJIjpEDPtuLwEtwENqpzITIVV,3VkHkmOtom3jM2wCu94xgzzu1d6Dn7or,1,0,0,0,0,0,1,0,1,0.14285714285714285,1,0.0,0,0,0,0,0,0,0,1,0,0,1,1
10265,179080,LnNj9zDI8D38ixGOYTIjTH2iF5m36v9S,SpATywNh6bZuzm8s1ceuBUnMUAeoAHHw,1,0,0,0,0,0,1,0,1,0.14285714285714285,1,0.0,0,0,0,0,0,0,0,1,0,0,1,1
10266,179123,NG8wapOLRHPSImjU3DJtnljSG53kZjbZ,bWdj2GDclj5ofokWjzoa5jAwMkxCykd6,3,2,0,0,0,0,2,0,4,0.5714285714285714,1,0.0,0,0,0,0,2,0,0,2,0,0,4,1
10267,179129,rqwp0DRxlrzViX8K4jHTHKpfYZPPmBwb,bWdj2GDclj5ofokWjzoa5jAwMkxCykd6,1,0,0,0,0,0,1,0,1,0.14285714285714285,1,0.0,0,0,0,0,0,0,0,1,0,0,1,1
10268,179137,UDKXRlOwpBxfqLf5s4hL0AzxKxNspgpQ,SpATywNh6bZuzm8s1ceuBUnMUAeoAHHw,1,0,0,0,0,0,1,0,1,0.14285714285714285,1,0.0,0,0,0,0,0,0,0,1,0,0,1,1
10269,179165,ZXiVpybmbL623ANTNPEN3D1nQoaNJaX5,SpATywNh6bZuzm8s1ceuBUnMUAeoAHHw,7,5,0,0,0,1,5,1,12,1.7142857142857142,1,0.0,0,0,0,0,5,1,0,5,1,0,12,1
10270,179172,jvjehhIuix2k8Sj0y3VS2J5KBY57pmmY,RXDvfPUBYFlVdlueBFbLW0mhhAyGEqpt,1,0,0,0,0,0,1,0,1,0.14285714285714285,1,0.0,0,0,0,0,0,0,0,1,0,0,1,1
10271,179173,hlGvzZYaSt1Ra6ylrXWIlb8wt3nPgT2T,SpATywNh6bZuzm8s1ceuBUnMUAeoAHHw,13,12,4,14,0,1,7,1,39,5.571428571428571,1,0.0,6,4,13,0,6,1,1,7,1,23,16,1
10272,179184,cexaEjGIqIaJg5IJprEieaXGoFvFkGAk,5X6FeZozNMgE2VRi3MJYjkkFK8SETtu2,5,0,0,0,0,1,6,3,10,1.4285714285714286,1,0.0,0,0,0,0,0,1,0,6,3,0,10,1
10273,179227,vzM6dR7Mfcsfahv9r0OzvETIp9xJjGU6,SpATywNh6bZuzm8s1ceuBUnMUAeoAHHw,6,2,1,0,1,0,4,0,8,1.1428571428571428,1,0.0,0,1,0,1,2,0,0,4,0,2,6,1
10274,179272,XydvMA0BgL1Al10q3L0D2wz1Y6wVb2rC,RXDvfPUBYFlVdlueBFbLW0mhhAyGEqpt,1,0,0,0,0,0,1,0,1,0.14285714285714285,1,0.0,0,0,0,0,0,0,0,1,0,0,1,1
10275,179280,zeHCiMpomPiZgVEBNBLYszozi2RaN6ma,SpATywNh6bZuzm8s1ceuBUnMUAeoAHHw,5,3,1,0,1,0,1,0,6,0.8571428571428571,1,0.0,0,1,0,1,3,0,0,1,0,2,4,0
10276,179318,0islXLiLHhX22socdAlKCtW1OjyrNJz9,SpATywNh6bZuzm8s1ceuBUnMUAeoAHHw,6,4,2,0,1,0,10,0,17,2.4285714285714284,1,0.0,0,2,0,1,4,0,0,10,0,3,14,1
10277,179319,GhuuDV969q2f6oJQGMqn8YHqFqopG9W1,SpATywNh6bZuzm8s1ceuBUnMUAeoAHHw,5,2,1,0,1,0,2,0,6,0.8571428571428571,1,0.0,0,1,0,1,2,0,0,2,0,2,4,1
10278,179322,3gZowHU6Qw1N8nldPT0HUl8W4s6TSDEP,SpATywNh6bZuzm8s1ceuBUnMUAeoAHHw,4,2,0,0,0,0,2,0,4,0.5714285714285714,1,0.0,0,0,0,0,2,0,0,2,0,0,4,1
10279,179323,LIH6u87VTR1542727Uc42mhP2iK5GaFP,bWdj2GDclj5ofokWjzoa5jAwMkxCykd6,1,0,0,0,0,0,1,0,1,0.14285714285714285,1,0.0,0,0,0,0,0,0,0,1,0,0,1,1
10280,179330,G49NvH4tF8kgsPAfy46cXzQCrSoZyFSP,G8EPVSXsOYB5YQWZGiz1aVq5Pgr2GrQu,1,0,0,0,0,0,1,0,1,0.14285714285714285,1,0.0,0,0,0,0,0,0,0,1,0,0,1,1
10281,179335,fsbWFTARUAWxV5m5bgwU1csJ885PYNRf,SpATywNh6bZuzm8s1ceuBUnMUAeoAHHw,2,0,0,0,0,0,2,0,2,0.2857142857142857,1,0.0,0,0,0,0,0,0,0,2,0,0,2,1
10282,179355,dwLERcgUF5e8qc6KTeQUy7jzLbnbnojj,SpATywNh6bZuzm8s1ceuBUnMUAeoAHHw,8,2,1,0,1,1,6,1,12,1.7142857142857142,1,0.0,0,1,0,1,2,1,0,6,1,2,10,1
10283,179359,RNNuxsM5xlYyyu9stwQmqEuw1Q1FUKuB,5X6FeZozNMgE2VRi3MJYjkkFK8SETtu2,2,0,0,0,0,0,2,0,2,0.2857142857142857,1,0.0,0,0,0,0,0,0,0,2,0,0,2,1
10284,179361,dwLERcgUF5e8qc6KTeQUy7jzLbnbnojj,RXDvfPUBYFlVdlueBFbLW0mhhAyGEqpt,42,26,12,102,8,0,2,0,150,21.428571428571427,1,0.0,7,12,87,8,19,0,15,2,0,114,36,1
10285,179377,RNNuxsM5xlYyyu9stwQmqEuw1Q1FUKuB,bWdj2GDclj5ofokWjzoa5jAwMkxCykd6,2,0,0,0,0,0,2,0,2,0.2857142857142857,1,0.0,0,0,0,0,0,0,0,2,0,0,2,1
10286,179379,4s7Pp1HkR1BKGnSREpCdC6xzkb7JZ7RX,bWdj2GDclj5ofokWjzoa5jAwMkxCykd6,2,0,0,0,0,0,3,0,3,0.42857142857142855,1,0.0,0,0,0,0,0,0,0,3,0,0,3,1
10287,179382,VOe0SGWkdLEdxTO6yJwM7kycDEogtQzR,5X6FeZozNMgE2VRi3MJYjkkFK8SETtu2,6,5,1,2,2,0,1,0,11,1.5714285714285714,1,0.0,2,1,2,2,3,0,0,1,0,7,4,1
10288,179418,1Oa212bncJhKWORThypZLwmAIisj5Woa,SpATywNh6bZuzm8s1ceuBUnMUAeoAHHw,1,0,0,0,0,0,1,0,1,0.14285714285714285,1,0.0,0,0,0,0,0,0,0,1,0,0,1,1
10289,179422,0KUBjckzhPh04pcpref906kWaVGOckIo,SpATywNh6bZuzm8s1ceuBUnMUAeoAHHw,7,5,2,0,2,0,2,0,11,1.5714285714285714,1,0.0,0,2,0,2,5,0,0,2,0,4,7,1
10290,179424,RyFLXBVd2U304JMB6ECFi9FilOybDHpw,SpATywNh6bZuzm8s1ceuBUnMUAeoAHHw,5,3,1,0,1,0,1,0,6,0.8571428571428571,1,0.0,0,1,0,1,3,0,0,1,0,2,4,1
10291,179447,sRKFcCOCmJuLZB6RUcOH6aSVKmD3A5OQ,SpATywNh6bZuzm8s1ceuBUnMUAeoAHHw,7,3,2,0,2,0,3,0,10,1.4285714285714286,1,0.0,0,2,0,2,3,0,0,3,0,4,6,1
10292,179452,04bV6MteCOqCB3W0Xq2uorQqe6jWZZSf,SpATywNh6bZuzm8s1ceuBUnMUAeoAHHw,4,2,1,0,1,0,1,0,5,0.7142857142857143,1,0.0,0,1,0,1,2,0,0,1,0,2,3,0
10293,179467,gfiVbZ2BB4wAsOOx7YUS5pKBeDSlW3Qg,SpATywNh6bZuzm8s1ceuBUnMUAeoAHHw,5,0,0,0,0,0,5,1,6,0.8571428571428571,1,0.0,0,0,0,0,0,0,0,5,1,0,6,1
10294,179468,gfiVbZ2BB4wAsOOx7YUS5pKBeDSlW3Qg,RXDvfPUBYFlVdlueBFbLW0mhhAyGEqpt,1,0,0,0,0,0,1,0,1,0.14285714285714285,1,0.0,0,0,0,0,0,0,0,1,0,0,1,1
10295,179498,20eWtdYsYJ2HaokCydmTS0vY6S0PepZS,A3fsA9Zfv1X2fVEQhTw51lKENdNrEqT3,4,2,1,0,0,0,2,0,5,0.7142857142857143,1,0.0,0,1,0,0,2,0,0,2,0,1,4,1
10296,179510,LV8vfa5IckYORVtz7AuYJolbeaAdw5WB,SpATywNh6bZuzm8s1ceuBUnMUAeoAHHw,1,0,0,0,0,0,1,0,1,0.14285714285714285,1,0.0,0,0,0,0,0,0,0,1,0,0,1,1
10297,179521,T0qN0JA4KSVLyWchoneodkFuY7QtkdHK,SpATywNh6bZuzm8s1ceuBUnMUAeoAHHw,5,2,1,0,1,2,2,0,8,1.1428571428571428,1,0.0,0,1,0,1,2,2,0,2,0,2,6,1
10298,179527,umNShE6BhRkvuedzRR9bZ3NEa4fzMweQ,SpATywNh6bZuzm8s1ceuBUnMUAeoAHHw,33,48,3,50,0,0,13,4,118,16.857142857142858,3,0.0,18,3,43,0,30,0,7,13,4,64,54,0
10299,179532,VGzBOOGK69MtqzfKnchssFLwlA0NETTZ,SpATywNh6bZuzm8s1ceuBUnMUAeoAHHw,7,6,0,0,0,0,2,0,8,1.1428571428571428,1,0.0,0,0,0,0,6,0,0,2,0,0,8,1
10300,179577,muJ6MIRhOdDL6SrbHsZ7Ks5a50Iz9AeC,SpATywNh6bZuzm8s1ceuBUnMUAeoAHHw,1,0,0,0,0,0,1,0,1,0.14285714285714285,1,0.0,0,0,0,0,0,0,0,1,0,0,1,1
10301,179610,WKp6oqFCmHpy9TibUqeeOeiX66KXDV5H,SpATywNh6bZuzm8s1ceuBUnMUAeoAHHw,2,0,0,0,0,0,2,0,2,0.2857142857142857,1,0.0,0,0,0,0,0,0,0,2,0,0,2,1
10302,179631,D7BohbL4R10ASgdgNGVTkq1ZlvH2JxrO,SpATywNh6bZuzm8s1ceuBUnMUAeoAHHw,24,27,15,14,10,0,3,0,69,9.857142857142858,1,0.0,8,15,12,10,19,0,2,3,0,45,24,1
10303,179637,MPAnuaCP5m41FvcY5EtWO5xZtCgim3qR,SpATywNh6bZuzm8s1ceuBUnMUAeoAHHw,8,2,2,0,2,0,3,0,9,1.2857142857142858,1,0.0,0,2,0,2,2,0,0,3,0,4,5,1
10304,179640,uUoI8qvE7LwSvUsyrJpLnIqVgu65FLrs,SpATywNh6bZuzm8s1ceuBUnMUAeoAHHw,1,0,0,0,0,0,1,0,1,0.14285714285714285,1,0.0,0,0,0,0,0,0,0,1,0,0,1,1
10305,179658,dqcX0OjTkTaHlc8tqIzvM5g6YMEUMdkh,RXDvfPUBYFlVdlueBFbLW0mhhAyGEqpt,4,5,0,0,0,0,1,0,6,0.8571428571428571,1,0.0,0,0,0,0,5,0,0,1,0,0,6,0
10306,179679,9t2KBUQ5GiAw5lDqGOd0BuKNW0LVvTVG,SpATywNh6bZuzm8s1ceuBUnMUAeoAHHw,1,0,0,0,0,0,1,0,1,0.14285714285714285,1,0.0,0,0,0,0,0,0,0,1,0,0,1,1
10307,179710,G9HEtDFISznPdvvS77nz7FwZcc6S4CjD,bWdj2GDclj5ofokWjzoa5jAwMkxCykd6,7,7,1,0,0,0,7,0,15,2.142857142857143,1,0.0,0,1,0,0,7,0,0,7,0,1,14,1
10308,179715,gHRMftxFMfKG8FHWISkllbscPcwviNm3,RXDvfPUBYFlVdlueBFbLW0mhhAyGEqpt,2,0,0,0,0,0,2,0,2,0.2857142857142857,1,0.0,0,0,0,0,0,0,0,2,0,0,2,1
10309,179722,StcFIgK5T4YiiLiOpPHFjzohTVz9Jaf7,bWdj2GDclj5ofokWjzoa5jAwMkxCykd6,1,0,0,0,0,0,3,0,3,0.42857142857142855,1,0.0,0,0,0,0,0,0,0,3,0,0,3,1
10310,179730,Z5RnWlIN5rBQfUP7H7AAcjJydHOZvELo,SpATywNh6bZuzm8s1ceuBUnMUAeoAHHw,1,0,0,0,0,0,1,0,1,0.14285714285714285,1,0.0,0,0,0,0,0,0,0,1,0,0,1,1
10311,179732,GnMMDgMkehWbrroCw3WzwugiIkCP2y33,G8EPVSXsOYB5YQWZGiz1aVq5Pgr2GrQu,17,9,8,0,7,0,3,0,27,3.857142857142857,1,0.0,1,8,0,7,8,0,0,3,0,16,11,1
10312,179738,ou8C5n696YF7JZz3ylnGubjoPMMs2Cdd,SpATywNh6bZuzm8s1ceuBUnMUAeoAHHw,5,2,1,0,1,0,2,0,6,0.8571428571428571,1,0.0,0,1,0,1,2,0,0,2,0,2,4,1
10313,179739,yYsW32kCOP4EgbR8poMa9E3lg8DNZAYh,SpATywNh6bZuzm8s1ceuBUnMUAeoAHHw,5,4,3,0,3,0,2,0,12,1.7142857142857142,1,0.0,0,3,0,3,4,0,0,2,0,6,6,1
10314,179740,UExHTYefDNhQrmzfTlJ57LWgxRr48ahn,SpATywNh6bZuzm8s1ceuBUnMUAeoAHHw,4,2,1,0,0,0,2,0,5,0.7142857142857143,1,0.0,0,1,0,0,2,0,0,2,0,1,4,1
10315,179747,ibKckGpxyTPeplIlvvXTpemBsBqeMrxb,RXDvfPUBYFlVdlueBFbLW0mhhAyGEqpt,1,0,0,0,0,0,1,0,1,0.14285714285714285,1,0.0,0,0,0,0,0,0,0,1,0,0,1,1
10316,179749,rUnq7n3p21gBavp6PXoOme6EEG94pTxK,SpATywNh6bZuzm8s1ceuBUnMUAeoAHHw,14,22,6,56,0,0,1,0,85,12.142857142857142,1,0.0,10,6,51,0,12,0,5,1,0,67,18,0
10317,179759,py4BWZSO6h9zrErp57605lt6Inpkg97z,SpATywNh6bZuzm8s1ceuBUnMUAeoAHHw,15,11,7,6,4,0,4,0,32,4.571428571428571,1,0.0,0,7,5,4,11,0,1,4,0,16,16,1
10318,179760,zRPZs2UwyfSKTy0m6wUSjuruRFQuFAvo,SpATywNh6bZuzm8s1ceuBUnMUAeoAHHw,1,0,0,0,0,0,1,0,1,0.14285714285714285,1,0.0,0,0,0,0,0,0,0,1,0,0,1,1
10319,179768,wUp74pHXepx3D052YhA66zL4rpbyPwEw,SpATywNh6bZuzm8s1ceuBUnMUAeoAHHw,1,0,0,0,0,0,1,0,1,0.14285714285714285,1,0.0,0,0,0,0,0,0,0,1,0,0,1,1
10320,179772,StY7mIcclc0vcUIJFTvL9RrXxdUXnEhh,SpATywNh6bZuzm8s1ceuBUnMUAeoAHHw,5,3,2,0,1,0,1,0,7,1.0,1,0.0,0,2,0,1,3,0,0,1,0,3,4,1
10321,179788,y0PkAopIdLmRFrkWC9eBHvWT77KfVWMh,5X6FeZozNMgE2VRi3MJYjkkFK8SETtu2,4,5,2,0,2,0,1,0,10,1.4285714285714286,1,0.0,0,2,0,2,5,0,0,1,0,4,6,1
10322,179790,nCUsluT33ylMTcWUlwgSWpj3Fjvf5kmG,SpATywNh6bZuzm8s1ceuBUnMUAeoAHHw,13,11,2,14,2,0,3,0,32,4.571428571428571,1,0.0,3,2,13,2,8,0,1,3,0,20,12,1
10323,179796,LUHGaACicOxP60rKS6F2rMGy8wMmqt9J,SpATywNh6bZuzm8s1ceuBUnMUAeoAHHw,45,45,28,29,15,1,6,1,125,17.857142857142858,2,0.0,11,28,27,15,34,1,2,6,1,81,44,1
10324,179802,fIbdXFPoTOYlPmaY1ETJ8qg0oyUmhp0g,bWdj2GDclj5ofokWjzoa5jAwMkxCykd6,6,9,1,0,1,0,3,0,14,2.0,1,0.0,2,1,0,1,7,0,0,3,0,4,10,1
10325,179808,HsX3fJNWGaAzb4ulAc4fybIoBP3jGVkR,bWdj2GDclj5ofokWjzoa5jAwMkxCykd6,6,7,1,0,0,0,2,0,10,1.4285714285714286,1,0.0,0,1,0,0,7,0,0,2,0,1,9,1
10326,179836,2sZGSeEPKMgpuspPc9ln3wAme2MWPynt,SpATywNh6bZuzm8s1ceuBUnMUAeoAHHw,2,0,0,0,0,0,2,0,2,0.2857142857142857,1,0.0,0,0,0,0,0,0,0,2,0,0,2,0
10327,179848,SIdEQEXoagJ5WwAcAkPtkVF6pipatiIa,SpATywNh6bZuzm8s1ceuBUnMUAeoAHHw,2,0,0,0,0,0,2,0,2,0.2857142857142857,1,0.0,0,0,0,0,0,0,0,2,0,0,2,1
10328,179870,DpSmnBHbyFDLOFghrV5uBi4M7NaSskUd,SpATywNh6bZuzm8s1ceuBUnMUAeoAHHw,13,11,7,4,5,0,4,0,31,4.428571428571429,1,0.0,0,7,3,5,11,0,1,4,0,15,16,1
10329,179884,UA8vU3s92g3lXc62U363PEO0xor6Mpeg,G8EPVSXsOYB5YQWZGiz1aVq5Pgr2GrQu,5,3,2,0,2,0,2,0,9,1.2857142857142858,1,0.0,0,2,0,2,3,0,0,2,0,4,5,1
10330,179899,lgHJmgh0JeYUwi0Y6M7QxPhO8toY9Xg7,SpATywNh6bZuzm8s1ceuBUnMUAeoAHHw,1,0,0,0,0,0,1,0,1,0.14285714285714285,1,0.0,0,0,0,0,0,0,0,1,0,0,1,1
10331,179910,tJDZI9sjRcU2ZrvrdL12AwFT0OmQXIcr,bWdj2GDclj5ofokWjzoa5jAwMkxCykd6,4,2,0,0,0,0,3,0,5,0.7142857142857143,1,0.0,0,0,0,0,2,0,0,3,0,0,5,1
10332,179913,15cHwrxDyXZ6rDjVRfGF8OQ7r5yWb8ur,SpATywNh6bZuzm8s1ceuBUnMUAeoAHHw,3,2,0,0,0,0,1,0,3,0.42857142857142855,1,0.0,0,0,0,0,2,0,0,1,0,0,3,1
10333,179941,31aB1n1dsQQ1ksrWlX8ZehnLm4yKoPC4,5X6FeZozNMgE2VRi3MJYjkkFK8SETtu2,1,0,0,0,0,0,1,0,1,0.14285714285714285,1,0.0,0,0,0,0,0,0,0,1,0,0,1,1
10334,179964,kBRyBoLw6Gxor2uVTrfB8UIBwxA0kVDV,SpATywNh6bZuzm8s1ceuBUnMUAeoAHHw,7,3,1,0,1,0,3,1,9,1.2857142857142858,1,0.0,0,1,0,1,3,0,0,3,1,2,7,1
10335,179973,N6jiL08wKuyQozkHSfkNoEAfnuGKH5Qp,SpATywNh6bZuzm8s1ceuBUnMUAeoAHHw,7,3,2,0,2,0,2,0,9,1.2857142857142858,1,0.0,0,2,0,2,3,0,0,2,0,4,5,1
10336,179977,SAZRKAldhv9NmeRo6l8G7XnPsnj9TVyU,bWdj2GDclj5ofokWjzoa5jAwMkxCykd6,1,0,0,0,0,0,1,0,1,0.14285714285714285,1,0.0,0,0,0,0,0,0,0,1,0,0,1,1
10337,179981,Xtc1j8RLTUZtmkbiSrt0BVY7ytq2hcRJ,SpATywNh6bZuzm8s1ceuBUnMUAeoAHHw,9,7,4,0,2,0,5,2,20,2.857142857142857,1,0.0,0,4,0,2,7,0,0,5,2,6,14,0
10338,179991,KBhbBOOlfBaI1URRHPSqS2ouhtSJhGfa,bWdj2GDclj5ofokWjzoa5jAwMkxCykd6,1,0,0,0,0,0,1,0,1,0.14285714285714285,1,0.0,0,0,0,0,0,0,0,1,0,0,1,1
10339,179994,kkWliMEtXfeGRYXIWo90e4jrKop2uE5Q,SpATywNh6bZuzm8s1ceuBUnMUAeoAHHw,1,0,0,0,0,0,1,0,1,0.14285714285714285,1,0.0,0,0,0,0,0,0,0,1,0,0,1,1
10340,180001,YjhQk8uVemmfeRSs3KEPEdsRtGRrPcBq,bWdj2GDclj5ofokWjzoa5jAwMkxCykd6,6,1,1,0,1,0,3,0,6,0.8571428571428571,1,0.0,0,1,0,1,1,0,0,3,0,2,4,1
10341,180006,5I4Sxxub5eHlZ4uVi2doKTMQ77gD08Kz,SpATywNh6bZuzm8s1ceuBUnMUAeoAHHw,8,8,3,0,2,0,1,0,14,2.0,1,0.0,0,3,0,2,8,0,0,1,0,5,9,1
10342,180025,KdOpYQwRTjGuX2z1c0SW0st7uOc9iGrk,bWdj2GDclj5ofokWjzoa5jAwMkxCykd6,5,2,1,0,1,0,3,0,7,1.0,1,0.0,0,1,0,1,2,0,0,3,0,2,5,1
10343,180032,J1e23PBxkWxN7oYAdQnQR8wOCx3aE0nY,bWdj2GDclj5ofokWjzoa5jAwMkxCykd6,4,4,0,0,0,0,1,0,5,0.7142857142857143,1,0.0,0,0,0,0,4,0,0,1,0,0,5,1
10344,180033,koNIIdoqi1yUhLIZAXp5I3Fl17qrPzNm,bWdj2GDclj5ofokWjzoa5jAwMkxCykd6,10,19,0,0,0,0,5,0,24,3.4285714285714284,2,0.0,2,0,0,0,17,0,0,5,0,2,22,1
10345,180043,IB6QwGjfRbp7aWxgSMpIkngT9FviLi1Z,bWdj2GDclj5ofokWjzoa5jAwMkxCykd6,4,2,1,0,1,0,1,0,5,0.7142857142857143,1,0.0,0,1,0,1,2,0,0,1,0,2,3,1
10346,180057,OOg0gQ2ai1NwRlHZA0Zq8uTWsOhkr7nF,5X6FeZozNMgE2VRi3MJYjkkFK8SETtu2,1,0,0,0,0,0,1,0,1,0.14285714285714285,1,0.0,0,0,0,0,0,0,0,1,0,0,1,1
10347,180076,WIulMAW8PLfyLvnliYk0w4Xs9IJHKZPS,5X6FeZozNMgE2VRi3MJYjkkFK8SETtu2,2,0,0,0,0,0,2,0,2,0.2857142857142857,1,0.0,0,0,0,0,0,0,0,2,0,0,2,1
10348,180084,DUhu6EGjxxReF9rQTWACLB6Oy9ZYNZxx,5X6FeZozNMgE2VRi3MJYjkkFK8SETtu2,5,4,0,2,1,0,1,0,8,1.1428571428571428,1,0.0,2,0,2,1,2,0,0,1,0,5,3,1
10349,180097,ro7esQOrjhfB2rfylabVOl2AnjhmuScB,5X6FeZozNMgE2VRi3MJYjkkFK8SETtu2,1,0,0,0,0,0,1,0,1,0.14285714285714285,1,0.0,0,0,0,0,0,0,0,1,0,0,1,1
10350,180122,xVBMhEHJSTLajguh18QYS971lwiV8tfV,5X6FeZozNMgE2VRi3MJYjkkFK8SETtu2,4,2,1,0,1,0,1,0,5,0.7142857142857143,1,0.0,0,1,0,1,2,0,0,1,0,2,3,1
10351,180182,QdOtDwNG9PGHroeB3tediNZNcdQgQDXk,5X6FeZozNMgE2VRi3MJYjkkFK8SETtu2,1,0,0,0,0,0,1,0,1,0.14285714285714285,1,0.0,0,0,0,0,0,0,0,1,0,0,1,1
10352,180202,6UuKdeqLBbfnVSLJBlFN5V4JFg0Y4C8c,5X6FeZozNMgE2VRi3MJYjkkFK8SETtu2,9,6,1,0,1,0,2,0,10,1.4285714285714286,1,0.0,0,1,0,1,6,0,0,2,0,2,8,1
10353,180227,rwhsU89MHhRjCVedmQCQbkrGP4GrGepX,5X6FeZozNMgE2VRi3MJYjkkFK8SETtu2,1,0,0,0,0,0,1,0,1,0.14285714285714285,1,0.0,0,0,0,0,0,0,0,1,0,0,1,1
10354,180309,kqgX5Ug7HO5XpWYua7IC9pl2O6MimRva,5X6FeZozNMgE2VRi3MJYjkkFK8SETtu2,1,0,0,0,0,0,1,0,1,0.14285714285714285,1,0.0,0,0,0,0,0,0,0,1,0,0,1,1
10355,180320,INlSsgBu6U1GHD7zxA6m0Q3NWFMKIwpX,5X6FeZozNMgE2VRi3MJYjkkFK8SETtu2,2,0,0,0,0,0,2,0,2,0.2857142857142857,1,0.0,0,0,0,0,0,0,0,2,0,0,2,1
10356,180351,tp4Mrz7JS1onCkKXq1pdOKwHVwV5hzbU,5Gyp41oLVo7Gg7vF4vpmggWP5MU70QO6,4,2,0,0,0,0,2,0,4,0.5714285714285714,1,0.0,0,0,0,0,2,0,0,2,0,0,4,1
10357,180356,fO1rPCd8LF1QZM5kj2eXZwLqI6uO4Zpz,5Gyp41oLVo7Gg7vF4vpmggWP5MU70QO6,11,12,6,0,5,2,1,0,26,3.7142857142857144,1,0.0,5,6,0,5,7,2,0,1,0,16,10,1
10358,180357,aQrIiMSdJ4Cx08U2JeN1D9CI5on0xJMc,5Gyp41oLVo7Gg7vF4vpmggWP5MU70QO6,13,9,5,2,4,3,8,2,33,4.714285714285714,1,0.0,3,5,1,4,6,3,1,8,2,13,20,1
10359,180367,5C1B8xoccZDOMkayPzyUSDJHMCFmbuub,5Gyp41oLVo7Gg7vF4vpmggWP5MU70QO6,1,0,0,0,0,0,1,0,1,0.14285714285714285,1,0.0,0,0,0,0,0,0,0,1,0,0,1,1
10360,180370,TbfzHSMi751rc6U2st0sdW9XdcdcS06v,5Gyp41oLVo7Gg7vF4vpmggWP5MU70QO6,1,0,0,0,0,0,1,0,1,0.14285714285714285,1,0.0,0,0,0,0,0,0,0,1,0,0,1,1
10361,180381,DY4iozZtsj9dCnx4tB6KOsdcWdSVlbqu,5Gyp41oLVo7Gg7vF4vpmggWP5MU70QO6,9,5,3,0,2,3,5,0,18,2.5714285714285716,1,0.0,0,3,0,2,5,3,0,5,0,5,13,1
10362,180388,FWpC051cwqJBH79oqOdfblqN4GlR0u3G,5Gyp41oLVo7Gg7vF4vpmggWP5MU70QO6,5,2,1,0,1,0,2,0,6,0.8571428571428571,1,0.0,0,1,0,1,2,0,0,2,0,2,4,1
10363,180389,j9e3g7ZyA66aMiKukjK0Q8b6mzRu2oKh,5Gyp41oLVo7Gg7vF4vpmggWP5MU70QO6,7,8,5,0,4,4,2,0,23,3.2857142857142856,2,0.0,1,5,0,4,7,4,0,2,0,10,13,1
10364,180394,Ocr7rcGCOIoMBzVduVIm38Gcy1SGj09f,5Gyp41oLVo7Gg7vF4vpmggWP5MU70QO6,1,0,0,0,0,0,1,0,1,0.14285714285714285,1,0.0,0,0,0,0,0,0,0,1,0,0,1,1
10365,180413,8beXvUQwy6T37M9XUfaSlCZgjy9mS9a6,5Gyp41oLVo7Gg7vF4vpmggWP5MU70QO6,4,2,1,0,1,0,1,0,5,0.7142857142857143,1,0.0,0,1,0,1,2,0,0,1,0,2,3,1
10366,180417,U11KhdeSf7Ds7XggaiHnRtu6k7OIQmFC,5Gyp41oLVo7Gg7vF4vpmggWP5MU70QO6,4,5,2,0,0,0,2,0,9,1.2857142857142858,1,0.0,0,2,0,0,5,0,0,2,0,2,7,1
10367,180432,g6NmbWZaZC1YFf57IakO7t7xyqNpTARi,5Gyp41oLVo7Gg7vF4vpmggWP5MU70QO6,6,5,3,0,2,0,4,0,14,2.0,1,0.0,0,3,0,2,5,0,0,4,0,5,9,1
10368,180455,h3qyFO9IWffBeJRM5753bmVRlRirhzYN,5Gyp41oLVo7Gg7vF4vpmggWP5MU70QO6,6,15,7,0,0,3,3,0,28,4.0,1,0.0,0,7,0,0,15,3,0,3,0,7,21,1
10369,180469,8JDldMZVqmRyPhatl5NeaAXs4tXpkPku,5Gyp41oLVo7Gg7vF4vpmggWP5MU70QO6,8,8,3,0,2,0,9,0,22,3.142857142857143,1,0.0,0,3,0,2,8,0,0,9,0,5,17,1
10370,180493,gCd8Sd2RfmBz4ehaj6OBr1FA66u5N9dL,5Gyp41oLVo7Gg7vF4vpmggWP5MU70QO6,6,4,3,0,3,0,2,0,12,1.7142857142857142,1,0.0,0,3,0,3,4,0,0,2,0,6,6,1
10371,180504,FlAkKX6ow9SvOzk0dTWPWgnX5766zY29,5Gyp41oLVo7Gg7vF4vpmggWP5MU70QO6,17,30,15,15,3,0,3,0,66,9.428571428571429,2,0.0,10,15,9,3,20,0,6,3,0,37,29,0
10372,180518,895zoMD6mJwAHj4xfJ9SzevRra7tIeSP,5Gyp41oLVo7Gg7vF4vpmggWP5MU70QO6,6,9,4,0,0,0,2,0,15,2.142857142857143,1,0.0,0,4,0,0,9,0,0,2,0,4,11,1
10373,180522,zteMaJUiElneTG34paE93BZJbhi3Rzxw,5Gyp41oLVo7Gg7vF4vpmggWP5MU70QO6,5,3,1,0,1,0,4,0,9,1.2857142857142858,1,0.0,0,1,0,1,3,0,0,4,0,2,7,1
10374,180524,TIUmJyHLor4PJa4xcm8B1AkzAjgdynnH,5Gyp41oLVo7Gg7vF4vpmggWP5MU70QO6,15,13,6,14,6,5,5,1,50,7.142857142857143,1,0.0,6,6,9,6,7,5,5,5,1,27,23,1
10375,180530,byVNYMbOKXgyBxjBXAalnLjImdLXpgcX,5Gyp41oLVo7Gg7vF4vpmggWP5MU70QO6,4,3,1,0,0,0,6,0,10,1.4285714285714286,1,0.0,0,1,0,0,3,0,0,6,0,1,9,1
10376,180534,p8PDk7PIRcdv8OilLQ1EB9K2d3Uc8Sea,5Gyp41oLVo7Gg7vF4vpmggWP5MU70QO6,9,8,5,0,3,3,1,0,20,2.857142857142857,1,0.0,1,5,0,3,7,3,0,1,0,9,11,1
10377,180541,cRarmD0JG6RFnUZBoJIOdL5LbJ0FnKyk,5Gyp41oLVo7Gg7vF4vpmggWP5MU70QO6,2,0,0,0,0,0,3,0,3,0.42857142857142855,1,0.0,0,0,0,0,0,0,0,3,0,0,3,1
10378,180548,TEUPsGpO9PYEGoOOgGbRc3Q1ojqnng5o,5Gyp41oLVo7Gg7vF4vpmggWP5MU70QO6,1,0,0,0,0,0,2,0,2,0.2857142857142857,1,0.0,0,0,0,0,0,0,0,2,0,0,2,1
10379,180558,XEEElZ9lGvnixcTo6LiEFeFhd6iOx31I,5Gyp41oLVo7Gg7vF4vpmggWP5MU70QO6,5,3,2,0,0,0,6,0,11,1.5714285714285714,1,0.0,0,2,0,0,3,0,0,6,0,2,9,1
10380,180566,NVfQmiRmQ7nMqb7gqpui9U3Yc3gRlVEf,5Gyp41oLVo7Gg7vF4vpmggWP5MU70QO6,2,0,0,0,0,0,2,0,2,0.2857142857142857,1,0.0,0,0,0,0,0,0,0,2,0,0,2,1
10381,180592,GoxoEoUBOnm9t13caQFS2BivjJWPa71N,5Gyp41oLVo7Gg7vF4vpmggWP5MU70QO6,5,4,3,0,0,0,2,0,9,1.2857142857142858,1,0.0,0,3,0,0,4,0,0,2,0,3,6,1
10382,180629,u6YQGD67yzQraOCkQvpFkxe73vsSHBNh,5Gyp41oLVo7Gg7vF4vpmggWP5MU70QO6,8,6,4,0,3,0,3,0,16,2.2857142857142856,2,0.0,0,4,0,3,6,0,0,3,0,7,9,1
10383,180630,ntaprRh8kUd9YrMf6LEtRxqjBXx2Ps6Z,5Gyp41oLVo7Gg7vF4vpmggWP5MU70QO6,10,14,4,3,1,3,3,1,29,4.142857142857143,1,0.0,6,4,2,1,8,3,1,3,1,13,16,1
10384,180645,c4edZCmVfCbIilQg1CO06CjrvxXU9k3D,5Gyp41oLVo7Gg7vF4vpmggWP5MU70QO6,7,3,1,0,1,0,3,0,8,1.1428571428571428,1,0.0,0,1,0,1,3,0,0,3,0,2,6,1
10385,180656,g4IxwWffjsVchGKzA6WMMgRATibGukbl,5Gyp41oLVo7Gg7vF4vpmggWP5MU70QO6,13,10,5,0,5,0,2,0,22,3.142857142857143,1,0.0,4,5,0,5,6,0,0,2,0,14,8,1
10386,180669,aoALWSwPGNR6JIi50OG1GPp6QCiv6mBJ,5Gyp41oLVo7Gg7vF4vpmggWP5MU70QO6,5,2,1,0,1,0,3,0,7,1.0,1,0.0,0,1,0,1,2,0,0,3,0,2,5,1
10387,180673,Z1oVQRPANEnSckPXHT5gs075XuDbxwoH,5Gyp41oLVo7Gg7vF4vpmggWP5MU70QO6,9,14,5,4,2,1,4,0,30,4.285714285714286,1,0.0,1,5,3,2,13,1,1,4,0,11,19,1
10388,180678,N5ZyEwF2fjxmUbb8vyfWMYkhLQ0lBJZV,5Gyp41oLVo7Gg7vF4vpmggWP5MU70QO6,7,6,4,0,3,0,2,0,15,2.142857142857143,1,0.0,0,4,0,3,6,0,0,2,0,7,8,1
10389,180696,1qJTnAtgoTxKrXBLTRNXvpxOoUQnV1EH,5Gyp41oLVo7Gg7vF4vpmggWP5MU70QO6,5,2,1,0,1,3,4,0,11,1.5714285714285714,1,0.0,0,1,0,1,2,3,0,4,0,2,9,1
10390,180729,etZ9xN6Q98IeK8IbSrz3jPFppkZ7vZ62,5Gyp41oLVo7Gg7vF4vpmggWP5MU70QO6,7,6,2,0,2,0,2,0,12,1.7142857142857142,1,0.0,0,2,0,2,6,0,0,2,0,4,8,1
10391,180731,CTWGk58qaudsZSjuVt8Mw9PiKEOsQrxl,5Gyp41oLVo7Gg7vF4vpmggWP5MU70QO6,7,3,2,0,2,0,4,0,11,1.5714285714285714,1,0.0,1,2,0,2,2,0,0,4,0,5,6,1
10392,180735,eqUPkQyn4QKAsHkY6lMCzO5B6Uokx68t,5Gyp41oLVo7Gg7vF4vpmggWP5MU70QO6,3,2,1,0,0,0,1,0,4,0.5714285714285714,1,0.0,0,1,0,0,2,0,0,1,0,1,3,1
10393,180758,Xl8Tem8G8sPah3KAWnbWgv7GNqLZqPFw,5Gyp41oLVo7Gg7vF4vpmggWP5MU70QO6,1,0,0,0,0,0,2,0,2,0.2857142857142857,2,0.0,0,0,0,0,0,0,0,2,0,0,2,1
10394,180768,NC1pdSztpfJLgz1bqVoe5aonviJWe881,5Gyp41oLVo7Gg7vF4vpmggWP5MU70QO6,10,4,2,0,3,0,4,1,14,2.0,1,0.0,1,2,0,3,3,0,0,4,1,6,8,1
10395,180770,ju99oQO0X1snt47cenVSQ4xCWEZAimpG,5Gyp41oLVo7Gg7vF4vpmggWP5MU70QO6,1,0,0,0,0,0,1,0,1,0.14285714285714285,1,0.0,0,0,0,0,0,0,0,1,0,0,1,1
10396,180777,YaXaylbU0z2Ca8zoDx7xLpIEnmW32t84,5Gyp41oLVo7Gg7vF4vpmggWP5MU70QO6,4,0,0,0,0,0,3,1,4,0.5714285714285714,1,0.0,0,0,0,0,0,0,0,3,1,0,4,1
10397,180779,hCSV0kQ0N4T0nXWbclCByP1bLO3jf6Ol,5Gyp41oLVo7Gg7vF4vpmggWP5MU70QO6,11,9,4,5,3,0,3,0,24,3.4285714285714284,2,0.0,2,4,4,3,7,0,1,3,0,13,11,1
10398,180803,vN8kLwMD6SZ5PJYomafeYZdQAazsAsXN,5Gyp41oLVo7Gg7vF4vpmggWP5MU70QO6,1,0,0,0,0,0,1,0,1,0.14285714285714285,1,0.0,0,0,0,0,0,0,0,1,0,0,1,1
10399,180807,u0wxbghmFH2m9FbuFqinbhDUTVmw5e5v,5Gyp41oLVo7Gg7vF4vpmggWP5MU70QO6,2,0,0,0,0,4,1,0,5,0.7142857142857143,1,0.0,0,0,0,0,0,4,0,1,0,0,5,1
10400,180810,wkSwKLvgUmQfzacgilpZAQqvEzLlK9QG,5Gyp41oLVo7Gg7vF4vpmggWP5MU70QO6,1,0,0,0,0,0,1,0,1,0.14285714285714285,1,0.0,0,0,0,0,0,0,0,1,0,0,1,1
10401,180813,lCtRrSIfbNpcK7UHbOtWkZFXQeDuZqwn,5Gyp41oLVo7Gg7vF4vpmggWP5MU70QO6,8,6,3,4,2,0,2,0,17,2.4285714285714284,1,0.0,2,3,4,2,4,0,0,2,0,11,6,1
10402,180840,ijLy6KGq8gHYoyHeqbPHpZ4K6Py1rOui,5Gyp41oLVo7Gg7vF4vpmggWP5MU70QO6,6,3,2,0,1,0,2,0,8,1.1428571428571428,1,0.0,0,2,0,1,3,0,0,2,0,3,5,1
10403,180849,qd4omQG06oI6JyqK8YD1O61SwDe5NQ5J,5Gyp41oLVo7Gg7vF4vpmggWP5MU70QO6,2,0,0,0,0,0,2,0,2,0.2857142857142857,1,0.0,0,0,0,0,0,0,0,2,0,0,2,1
10404,180856,3NEUW6DB5c0uoj1FU0o2TX1sHyRcNdFs,5Gyp41oLVo7Gg7vF4vpmggWP5MU70QO6,7,7,3,0,1,0,3,0,14,2.0,1,0.0,1,3,0,1,6,0,0,3,0,5,9,1
10405,180862,iQa5DqYpqgpqWEY6AT2tJeHiK4XcjzGC,5Gyp41oLVo7Gg7vF4vpmggWP5MU70QO6,9,3,2,0,2,2,4,1,14,2.0,1,0.0,0,2,0,2,3,2,0,4,1,4,10,1
10406,180863,mNZVzyA4iyjUigfGjI4hVzzhXbEdPLdi,5Gyp41oLVo7Gg7vF4vpmggWP5MU70QO6,17,26,15,31,8,0,2,0,82,11.714285714285714,2,0.0,2,15,28,8,24,0,3,2,0,53,29,1
10407,180865,3n55YeHkad5zhsNnBeNXedOp2axGsKDz,5Gyp41oLVo7Gg7vF4vpmggWP5MU70QO6,1,0,0,0,0,0,2,0,2,0.2857142857142857,1,0.0,0,0,0,0,0,0,0,2,0,0,2,1
10408,180867,w5OdJoQZNGUVPiCQDXg0Vd0yo9ewUzmW,5Gyp41oLVo7Gg7vF4vpmggWP5MU70QO6,1,0,0,0,0,0,1,0,1,0.14285714285714285,1,0.0,0,0,0,0,0,0,0,1,0,0,1,1
10409,180881,FDgN6xJX7bDKL36N4IdkQGuWj4yThyjj,5Gyp41oLVo7Gg7vF4vpmggWP5MU70QO6,17,17,8,32,3,0,2,0,62,8.857142857142858,1,0.0,8,8,18,3,9,0,14,2,0,37,25,1
10410,180895,tfToLXBRnnlI6p2zq5iIYC9cW9wdoiPI,5Gyp41oLVo7Gg7vF4vpmggWP5MU70QO6,10,7,1,5,2,0,2,0,17,2.4285714285714284,1,0.0,2,1,3,2,5,0,2,2,0,8,9,1
10411,180898,QzEubPuC198UlvWJh0Tzfty18VwMGjPT,5Gyp41oLVo7Gg7vF4vpmggWP5MU70QO6,2,0,0,0,0,0,3,0,3,0.42857142857142855,1,0.0,0,0,0,0,0,0,0,3,0,0,3,1
10412,180900,baiZ413ok0IFv0hmfRXQcXcSJcWbY9Ym,5Gyp41oLVo7Gg7vF4vpmggWP5MU70QO6,5,2,1,0,1,0,2,0,6,0.8571428571428571,1,0.0,0,1,0,1,2,0,0,2,0,2,4,1
10413,180929,lMCzq9KABU4ZObAQpOfUyaYRWBCtViow,5Gyp41oLVo7Gg7vF4vpmggWP5MU70QO6,1,0,0,0,0,0,1,0,1,0.14285714285714285,1,0.0,0,0,0,0,0,0,0,1,0,0,1,1
10414,180935,MJ2SrqscjryYmTj3MCP6nb18o12yNggY,5Gyp41oLVo7Gg7vF4vpmggWP5MU70QO6,10,7,5,0,2,0,3,0,17,2.4285714285714284,1,0.0,0,5,0,2,7,0,0,3,0,7,10,1
10415,180940,oNVrIUp8rZjEp4WjUiFDIztbFFXtAjUK,5Gyp41oLVo7Gg7vF4vpmggWP5MU70QO6,8,5,3,0,2,0,4,0,14,2.0,2,0.0,0,3,0,2,5,0,0,4,0,5,9,1
10416,180945,e8Y4G90611rG6C14GJNj4shj65JVFISl,5Gyp41oLVo7Gg7vF4vpmggWP5MU70QO6,11,22,10,4,3,0,3,0,42,6.0,2,0.0,5,10,3,3,17,0,1,3,0,21,21,1
10417,180947,vBNj0d0nOCwf15RmbhYipHJn9TIcLqh0,5Gyp41oLVo7Gg7vF4vpmggWP5MU70QO6,1,0,0,0,0,0,1,0,1,0.14285714285714285,1,0.0,0,0,0,0,0,0,0,1,0,0,1,1
10418,180957,f6KkxzzSUmz9USWn2Re2RVELecsuFWbR,5Gyp41oLVo7Gg7vF4vpmggWP5MU70QO6,7,3,2,0,2,0,2,0,9,1.2857142857142858,1,0.0,0,2,0,2,3,0,0,2,0,4,5,1
10419,180973,UqmipTh7NynpaU8jm3r56rLAxgsmSU7I,5Gyp41oLVo7Gg7vF4vpmggWP5MU70QO6,13,24,9,7,9,3,2,0,54,7.714285714285714,2,0.0,12,9,5,9,12,3,2,2,0,35,19,1
10420,180979,YjEaFn5LTfYqjxB6JXUvw4Xb9oLhK631,5Gyp41oLVo7Gg7vF4vpmggWP5MU70QO6,7,6,3,0,2,0,3,0,14,2.0,2,0.0,0,3,0,2,6,0,0,3,0,5,9,1
10421,181010,4j4dS9OHUFGIF8km7oWh3y3j9t8sZ8Ej,5Gyp41oLVo7Gg7vF4vpmggWP5MU70QO6,1,0,0,0,0,0,3,0,3,0.42857142857142855,1,0.0,0,0,0,0,0,0,0,3,0,0,3,1
10422,181014,INyKsxPEFjMfoLoLKZbvDSb4QuapRIcM,5Gyp41oLVo7Gg7vF4vpmggWP5MU70QO6,5,2,1,0,1,0,2,0,6,0.8571428571428571,1,0.0,0,1,0,1,2,0,0,2,0,2,4,1
10423,181025,EA9ScIShElqrnJomZiYBwy227hiQMtOE,5Gyp41oLVo7Gg7vF4vpmggWP5MU70QO6,1,0,0,0,0,0,1,0,1,0.14285714285714285,1,0.0,0,0,0,0,0,0,0,1,0,0,1,1
10424,181049,MOaCjbrS1EASwr9LSifxu0C07WLv1XY8,5Gyp41oLVo7Gg7vF4vpmggWP5MU70QO6,6,5,3,0,3,0,1,0,12,1.7142857142857142,1,0.0,0,3,0,3,5,0,0,1,0,6,6,1
10425,181079,onAfOMsvg39dfSg2G3wfuBHMXF5hH87v,5Gyp41oLVo7Gg7vF4vpmggWP5MU70QO6,5,2,0,0,1,0,4,0,7,1.0,1,0.0,0,0,0,1,2,0,0,4,0,1,6,1
10426,181080,eyibvWPEESD34KffnoHQq6JdNuxCZpXy,5Gyp41oLVo7Gg7vF4vpmggWP5MU70QO6,8,4,3,0,3,0,1,0,11,1.5714285714285714,1,0.0,0,3,0,3,4,0,0,1,0,6,5,1
10427,181085,xEei8XHE92q0Z3XDw2dIdGFY4nbn0Qrf,5Gyp41oLVo7Gg7vF4vpmggWP5MU70QO6,4,3,1,0,0,0,1,0,5,0.7142857142857143,1,0.0,0,1,0,0,3,0,0,1,0,1,4,1
10428,181098,ivxBGUbA7UT7tzED0gKK31cJU8Lv97zd,5Gyp41oLVo7Gg7vF4vpmggWP5MU70QO6,3,2,0,0,0,2,1,0,5,0.7142857142857143,1,0.0,0,0,0,0,2,2,0,1,0,0,5,1
10429,181108,4kNrQYk71rt8ctOVkj0oxu4D43yO7ZQl,5Gyp41oLVo7Gg7vF4vpmggWP5MU70QO6,4,0,0,0,0,0,4,1,5,0.7142857142857143,1,0.0,0,0,0,0,0,0,0,4,1,0,5,1
10430,181113,R1UPXMkdkC5m6bNBQEp17ibdHEF0NiXL,5Gyp41oLVo7Gg7vF4vpmggWP5MU70QO6,10,11,4,10,2,1,8,1,37,5.285714285714286,2,0.0,6,4,8,2,5,1,2,8,1,20,17,1
10431,181120,h6WL9yy6oqssZuhnzDdRSTzfGvEAdOoD,5Gyp41oLVo7Gg7vF4vpmggWP5MU70QO6,1,0,0,0,0,0,1,0,1,0.14285714285714285,1,0.0,0,0,0,0,0,0,0,1,0,0,1,1
10432,181122,DavhuddfOncVkOSScyUap05C7vGz8ges,5Gyp41oLVo7Gg7vF4vpmggWP5MU70QO6,8,5,2,0,1,0,7,2,17,2.4285714285714284,1,0.0,0,2,0,1,5,0,0,7,2,3,14,1
10433,181134,sUWUdA4gFPmP8rdf2ttGN205I2GtCQUM,5Gyp41oLVo7Gg7vF4vpmggWP5MU70QO6,1,0,0,0,0,0,1,0,1,0.14285714285714285,1,0.0,0,0,0,0,0,0,0,1,0,0,1,1
10434,181156,ruiD7M8W9bfM7IoM9icA8ze1GC7rLz7I,5Gyp41oLVo7Gg7vF4vpmggWP5MU70QO6,10,4,2,0,3,0,4,1,14,2.0,1,0.0,1,2,0,3,3,0,0,4,1,6,8,1
10435,181161,erSfmhLG4RlFeRsFEI5yZ5rLqt6tmSeS,5Gyp41oLVo7Gg7vF4vpmggWP5MU70QO6,4,2,1,0,1,0,1,0,5,0.7142857142857143,1,0.0,0,1,0,1,2,0,0,1,0,2,3,1
10436,181166,8gHZyaAa1aVMzIfQafkIyPuWQWfP7F1H,5Gyp41oLVo7Gg7vF4vpmggWP5MU70QO6,13,12,7,2,2,5,9,0,37,5.285714285714286,2,0.0,3,7,1,2,9,5,1,9,0,13,24,1
10437,181171,dhfR4wGmOusRZWUPfjGh9lEKBfvvwgMt,5Gyp41oLVo7Gg7vF4vpmggWP5MU70QO6,6,13,6,0,0,0,1,0,20,2.857142857142857,1,0.0,0,6,0,0,13,0,0,1,0,6,14,1
10438,181172,cKzX1yMeujpajeoP7XLXoMfkqVSh2N9o,5Gyp41oLVo7Gg7vF4vpmggWP5MU70QO6,5,2,1,0,1,0,2,0,6,0.8571428571428571,1,0.0,0,1,0,1,2,0,0,2,0,2,4,1
10439,181196,9bFvPhgoAiKVhf5OQzMZPiwIYftMmTrt,5Gyp41oLVo7Gg7vF4vpmggWP5MU70QO6,2,0,0,0,0,0,2,0,2,0.2857142857142857,1,0.0,0,0,0,0,0,0,0,2,0,0,2,1
10440,181213,rNPw2npFBG0yowcddnm9yNTNtVAZ2hhI,5Gyp41oLVo7Gg7vF4vpmggWP5MU70QO6,1,0,0,0,0,0,1,0,1,0.14285714285714285,1,0.0,0,0,0,0,0,0,0,1,0,0,1,1
10441,181236,1s66T8nC5Brh1WC0avoq9zfAYFmC2cy6,5Gyp41oLVo7Gg7vF4vpmggWP5MU70QO6,6,3,1,0,1,0,6,1,12,1.7142857142857142,1,0.0,1,1,0,1,2,0,0,6,1,3,9,1
10442,181242,CsPknC052wniB1MWNqxmElIo3E5g7l5u,5Gyp41oLVo7Gg7vF4vpmggWP5MU70QO6,5,2,1,0,1,0,2,0,6,0.8571428571428571,1,0.0,0,1,0,1,2,0,0,2,0,2,4,0
10443,181256,dtV2v0hrzgCDVZIuGtCKMKHtiLO2K2lj,5Gyp41oLVo7Gg7vF4vpmggWP5MU70QO6,24,31,15,24,4,1,7,0,82,11.714285714285714,2,0.0,12,15,15,4,19,1,9,7,0,46,36,1
10444,181266,jbfQf8j93qEc8QCxEb0dikXBABlkLrcO,5Gyp41oLVo7Gg7vF4vpmggWP5MU70QO6,4,2,0,0,0,0,4,0,6,0.8571428571428571,1,0.0,0,0,0,0,2,0,0,4,0,0,6,1
10445,181287,bpH9144QxaCP0IuOtJ1htZxY18SoeZkY,5Gyp41oLVo7Gg7vF4vpmggWP5MU70QO6,19,51,20,22,4,3,21,0,121,17.285714285714285,3,0.0,16,20,12,4,35,3,10,21,0,52,69,1
10446,181292,KTxArcU1dHlBSUXs7fRS5tqgeW3QGDVE,5Gyp41oLVo7Gg7vF4vpmggWP5MU70QO6,6,6,1,0,2,1,9,0,19,2.7142857142857144,1,0.0,2,1,0,2,4,1,0,9,0,5,14,1
10447,181293,eYFvYtnVKexSt1Uofy5VGyG9dl1PPAA5,5Gyp41oLVo7Gg7vF4vpmggWP5MU70QO6,9,11,4,3,2,0,1,0,21,3.0,1,0.0,4,4,2,2,7,0,1,1,0,12,9,1
10448,181294,bapf8jpo49GBPQQLhNaP8gArutfX97HO,5Gyp41oLVo7Gg7vF4vpmggWP5MU70QO6,6,6,4,0,1,0,4,1,16,2.2857142857142856,2,0.0,0,4,0,1,6,0,0,4,1,5,11,1
10449,181296,MM0HdGNNpR1lvzEnJBWtFROUtMetYXEg,5Gyp41oLVo7Gg7vF4vpmggWP5MU70QO6,10,5,3,0,2,0,5,1,16,2.2857142857142856,1,0.0,0,3,0,2,5,0,0,5,1,5,11,1
10450,181297,Y2nyPAJyvQ0i6cjbIjZFGOeLk60o9uIg,5Gyp41oLVo7Gg7vF4vpmggWP5MU70QO6,2,0,0,0,0,0,2,0,2,0.2857142857142857,1,0.0,0,0,0,0,0,0,0,2,0,0,2,1
10451,181312,we3JRvtMBQN4lhCJbcBPcxhz7bBBOP3O,5Gyp41oLVo7Gg7vF4vpmggWP5MU70QO6,8,7,0,6,0,0,1,0,14,2.0,1,0.0,0,0,4,0,7,0,2,1,0,4,10,1
10452,181323,0DMSkP31HrkDHBcqvRvQ9Ihr0hx9jYbu,5Gyp41oLVo7Gg7vF4vpmggWP5MU70QO6,7,3,2,0,2,1,3,0,11,1.5714285714285714,1,0.0,0,2,0,2,3,1,0,3,0,4,7,1
10453,181325,HcTSf3sdH9eMcyLU8Gl5AhCTe7KqX4pZ,5Gyp41oLVo7Gg7vF4vpmggWP5MU70QO6,7,8,3,1,1,0,2,0,15,2.142857142857143,2,0.0,2,3,1,1,6,0,0,2,0,7,8,1
10454,181341,SIokyE6JBQNU8m9geSEV0RNjiRe80iZE,5Gyp41oLVo7Gg7vF4vpmggWP5MU70QO6,1,0,0,0,0,0,2,0,2,0.2857142857142857,1,0.0,0,0,0,0,0,0,0,2,0,0,2,1
10455,181345,BjBet1XrpmufRo3nJSBrADvKxDiooNdd,5Gyp41oLVo7Gg7vF4vpmggWP5MU70QO6,1,0,0,0,0,0,1,0,1,0.14285714285714285,1,0.0,0,0,0,0,0,0,0,1,0,0,1,1
10456,181348,GfVwnPyRA7dcSbbIg96mjGdzO73sm11f,5Gyp41oLVo7Gg7vF4vpmggWP5MU70QO6,9,4,1,0,3,0,2,0,10,1.4285714285714286,1,0.0,0,1,0,3,4,0,0,2,0,4,6,1
10457,181363,DXz5mdXrIRuIZ0YXlfzSEvISumQDbm6K,5Gyp41oLVo7Gg7vF4vpmggWP5MU70QO6,5,1,1,0,0,0,5,0,7,1.0,1,0.0,0,1,0,0,1,0,0,5,0,1,6,1
10458,181369,Fo6UXh70ymQtEThJZOzOeH8iNb2MhPJ5,5Gyp41oLVo7Gg7vF4vpmggWP5MU70QO6,13,22,7,4,5,1,4,0,43,6.142857142857143,1,0.0,7,7,2,5,15,1,2,4,0,21,22,1
10459,181394,K6PK8VrzDGjO5ZlkYcRj1Z7SSxo8biOv,5Gyp41oLVo7Gg7vF4vpmggWP5MU70QO6,1,0,0,0,0,0,1,0,1,0.14285714285714285,1,0.0,0,0,0,0,0,0,0,1,0,0,1,1
10460,181397,pSXhm10LQrKWhBodVl5wDf3hGiwH3QOg,5Gyp41oLVo7Gg7vF4vpmggWP5MU70QO6,10,3,2,0,2,0,5,1,13,1.8571428571428572,1,0.0,0,2,0,2,3,0,0,5,1,4,9,1
10461,181400,OIjfrBdtsUvzBnLBAUPi1OLB0nX3QIjX,5Gyp41oLVo7Gg7vF4vpmggWP5MU70QO6,2,0,0,0,0,0,3,0,3,0.42857142857142855,1,0.0,0,0,0,0,0,0,0,3,0,0,3,1
10462,181415,v8jebqrHoVA1JPsuez8pD6IYGdg1Q8yX,5Gyp41oLVo7Gg7vF4vpmggWP5MU70QO6,1,0,0,0,0,0,1,0,1,0.14285714285714285,1,0.0,0,0,0,0,0,0,0,1,0,0,1,1
10463,181441,GT9XZ0eTe8qlg7WeLH7sdHIAlgtnFb8R,5Gyp41oLVo7Gg7vF4vpmggWP5MU70QO6,5,3,1,0,1,0,4,0,9,1.2857142857142858,1,0.0,0,1,0,1,3,0,0,4,0,2,7,1
10464,181442,6j8gZnIOiqrL87utkOxjl50x7Em7cDIm,5Gyp41oLVo7Gg7vF4vpmggWP5MU70QO6,2,0,0,0,0,0,2,0,2,0.2857142857142857,1,0.0,0,0,0,0,0,0,0,2,0,0,2,1
10465,181445,Zk0LslXntRQS58DQnyI3iRGhuocimbNA,5Gyp41oLVo7Gg7vF4vpmggWP5MU70QO6,7,3,2,0,2,1,2,0,10,1.4285714285714286,1,0.0,0,2,0,2,3,1,0,2,0,4,6,1
10466,181454,U3R4m4eLMm2lirgI7HLueBKsNpxhFpn9,5Gyp41oLVo7Gg7vF4vpmggWP5MU70QO6,11,11,7,1,4,0,2,0,25,3.5714285714285716,1,0.0,3,7,1,4,8,0,0,2,0,15,10,1
10467,181463,QSjwCTbJk06PRzmUJhyjhjHmzO6JT8fY,5Gyp41oLVo7Gg7vF4vpmggWP5MU70QO6,11,10,5,2,4,0,1,0,22,3.142857142857143,1,0.0,4,5,1,4,6,0,1,1,0,14,8,1
10468,181468,hnZeNQ4kr8O7YfkdIrZm33I6quuSD4sz,5Gyp41oLVo7Gg7vF4vpmggWP5MU70QO6,11,12,6,0,2,0,4,1,25,3.5714285714285716,1,0.0,0,6,0,2,12,0,0,4,1,8,17,1
10469,181474,y8AdDSbHENRUD5ii0AuyONW5YY98sBlv,5Gyp41oLVo7Gg7vF4vpmggWP5MU70QO6,17,16,7,0,7,2,4,0,36,5.142857142857143,1,0.0,3,7,0,7,13,2,0,4,0,17,19,0
10470,181477,5Sdd90y9f6G1O01oh8dNylP38h97ZkQP,5Gyp41oLVo7Gg7vF4vpmggWP5MU70QO6,8,5,3,0,2,2,2,0,14,2.0,1,0.0,0,3,0,2,5,2,0,2,0,5,9,1
10471,181482,fR5V33zcezmxPgghUktnecG1qNdYVShX,5Gyp41oLVo7Gg7vF4vpmggWP5MU70QO6,5,2,1,0,1,0,2,0,6,0.8571428571428571,1,0.0,0,1,0,1,2,0,0,2,0,2,4,1
10472,181483,QKIhrVBj8aJ2zvxQ51GQM3LX3gexKGZH,5Gyp41oLVo7Gg7vF4vpmggWP5MU70QO6,2,0,0,0,0,0,2,0,2,0.2857142857142857,1,0.0,0,0,0,0,0,0,0,2,0,0,2,1
10473,181488,F5DFfMrxkv1wogCZI6eeGu3qtvMXCudW,5Gyp41oLVo7Gg7vF4vpmggWP5MU70QO6,1,0,0,0,0,0,1,0,1,0.14285714285714285,1,0.0,0,0,0,0,0,0,0,1,0,0,1,1
10474,181490,XOxCWYMm47dwluDpR4uJchgPIaTZUbIk,5Gyp41oLVo7Gg7vF4vpmggWP5MU70QO6,5,2,1,0,1,0,3,0,7,1.0,1,0.0,0,1,0,1,2,0,0,3,0,2,5,1
10475,181503,bhhFIxvevjWYG5LoQYs3AHzKEI0d78fi,5Gyp41oLVo7Gg7vF4vpmggWP5MU70QO6,1,0,0,0,0,0,1,0,1,0.14285714285714285,1,0.0,0,0,0,0,0,0,0,1,0,0,1,1
10476,181520,HEqgGFXylFDP70VGbbq4OKqIIVcnbN6Z,5Gyp41oLVo7Gg7vF4vpmggWP5MU70QO6,20,19,11,13,4,0,1,0,48,6.857142857142857,1,0.0,7,11,8,4,12,0,5,1,0,30,18,1
10477,181534,OpwckdWsEER4l1OJBpcnh3NU2xxoNmjO,5Gyp41oLVo7Gg7vF4vpmggWP5MU70QO6,7,6,5,0,1,0,3,0,15,2.142857142857143,1,0.0,0,5,0,1,6,0,0,3,0,6,9,1
10478,181542,qi7KVNmfKsK3oeS3bRCbOTnPSHK2PSHI,5Gyp41oLVo7Gg7vF4vpmggWP5MU70QO6,7,3,3,0,2,0,3,0,11,1.5714285714285714,1,0.0,0,3,0,2,3,0,0,3,0,5,6,1
10479,181554,RD1kdutFDkiIgUjnQBr2q67R2pCh5GjV,5Gyp41oLVo7Gg7vF4vpmggWP5MU70QO6,10,40,7,0,0,2,8,1,58,8.285714285714286,1,0.0,9,7,0,0,31,2,0,8,1,16,42,1
10480,181577,CxOXTyrVHjSzlA5Fh7HK8tgZgwTPMS3P,5Gyp41oLVo7Gg7vF4vpmggWP5MU70QO6,8,5,4,0,2,5,1,0,17,2.4285714285714284,1,0.0,0,4,0,2,5,5,0,1,0,6,11,1
10481,181604,f7GgnG1EhEYfpTzWdSUpG5mBEhzDlaP6,5Gyp41oLVo7Gg7vF4vpmggWP5MU70QO6,1,0,0,0,0,0,1,0,1,0.14285714285714285,1,0.0,0,0,0,0,0,0,0,1,0,0,1,1
10482,181624,RGYHsRxOSpzGYlOiCyaLeKfeM737nY9S,5Gyp41oLVo7Gg7vF4vpmggWP5MU70QO6,15,17,7,7,3,15,2,0,51,7.285714285714286,1,0.0,6,7,5,3,11,15,2,2,0,21,30,1
10483,181662,NDtcgqo3IqvWktjMfoAkMVK3iMVUj48d,5Gyp41oLVo7Gg7vF4vpmggWP5MU70QO6,13,10,5,5,5,9,5,1,40,5.714285714285714,1,0.0,3,5,4,5,7,9,1,5,1,17,23,1
10484,181667,4LzpC48UjugivGpxDptKLNf1uPCLHda2,5Gyp41oLVo7Gg7vF4vpmggWP5MU70QO6,7,2,1,0,1,21,4,0,29,4.142857142857143,1,0.0,0,1,0,1,2,21,0,4,0,2,27,1
10485,181676,DugKJlrAldkrss433t1vbMjeUQoSebNi,5Gyp41oLVo7Gg7vF4vpmggWP5MU70QO6,4,2,0,0,0,0,2,0,4,0.5714285714285714,2,0.0,0,0,0,0,2,0,0,2,0,0,4,1
10486,181680,bGjzMxOC88rUacNGu6kshAaxdH2zKDK7,5Gyp41oLVo7Gg7vF4vpmggWP5MU70QO6,3,1,0,0,0,0,2,0,3,0.42857142857142855,1,0.0,0,0,0,0,1,0,0,2,0,0,3,1
10487,181746,31lvFKODE2ecliZIHSs4rY4kq62euP4j,5Gyp41oLVo7Gg7vF4vpmggWP5MU70QO6,1,0,0,0,0,0,1,0,1,0.14285714285714285,1,0.0,0,0,0,0,0,0,0,1,0,0,1,1
10488,181765,NtWIu4J0HPOWOANC7ZYns4tsHx1TBJoi,5Gyp41oLVo7Gg7vF4vpmggWP5MU70QO6,5,2,1,0,1,0,2,0,6,0.8571428571428571,1,0.0,0,1,0,1,2,0,0,2,0,2,4,1
10489,181766,49rI5FrlP6bc7Hj3wufdevcQSNKjMKGt,5Gyp41oLVo7Gg7vF4vpmggWP5MU70QO6,16,14,11,0,5,0,4,0,34,4.857142857142857,1,0.0,0,11,0,5,14,0,0,4,0,16,18,1
10490,181770,h2lZPyPsXFExtQUKuL9gmZH1Tuf0BNHB,5Gyp41oLVo7Gg7vF4vpmggWP5MU70QO6,10,13,5,4,3,0,9,0,34,4.857142857142857,2,0.0,6,5,3,3,7,0,1,9,0,17,17,1
10491,181772,2ponQ8n7XN1NDar2kbkmiBemIHnSb6vV,5Gyp41oLVo7Gg7vF4vpmggWP5MU70QO6,6,7,3,0,3,0,1,0,14,2.0,2,0.0,0,3,0,3,7,0,0,1,0,6,8,1
10492,181774,Px1AwKbsjfO7MpLQSICMQMUSA8mNB6no,5Gyp41oLVo7Gg7vF4vpmggWP5MU70QO6,1,0,0,0,0,0,1,0,1,0.14285714285714285,1,0.0,0,0,0,0,0,0,0,1,0,0,1,1
10493,181790,sCKziRJTsOYc4lQfYxPq4wO4jIyYAbxE,5Gyp41oLVo7Gg7vF4vpmggWP5MU70QO6,3,3,1,0,0,0,1,0,5,0.7142857142857143,1,0.0,0,1,0,0,3,0,0,1,0,1,4,1
10494,181825,OKWA86BtkBHcNmHrCmPkMazWWaLGK4gl,5Gyp41oLVo7Gg7vF4vpmggWP5MU70QO6,1,0,0,0,0,0,1,0,1,0.14285714285714285,1,0.0,0,0,0,0,0,0,0,1,0,0,1,1
10495,181830,3t5FakhMXfR4IP8lNBq0c8POHlJOVCmu,5Gyp41oLVo7Gg7vF4vpmggWP5MU70QO6,3,0,0,0,0,1,2,0,3,0.42857142857142855,1,0.0,0,0,0,0,0,1,0,2,0,0,3,1
10496,181850,wnJ5tl9XXv3IeSQ2Cgh7iWVddGChOZ9x,5Gyp41oLVo7Gg7vF4vpmggWP5MU70QO6,6,1,1,0,1,0,4,1,8,1.1428571428571428,1,0.0,0,1,0,1,1,0,0,4,1,2,6,1
10497,181861,Q4NluUWiFaKkxFoBlSsNbkiwOR0VhjEq,5Gyp41oLVo7Gg7vF4vpmggWP5MU70QO6,2,0,0,0,0,0,3,0,3,0.42857142857142855,1,0.0,0,0,0,0,0,0,0,3,0,0,3,1
10498,181863,locU5icaqDOAfRtQOWd1XmQK2Y9k0byx,5Gyp41oLVo7Gg7vF4vpmggWP5MU70QO6,7,4,2,0,3,0,1,0,10,1.4285714285714286,1,0.0,1,2,0,3,3,0,0,1,0,6,4,1
10499,181867,MxUguHhWb2452TUVztjIAFfN9PKMm5iH,5Gyp41oLVo7Gg7vF4vpmggWP5MU70QO6,11,6,4,2,3,0,2,0,17,2.4285714285714284,1,0.0,1,4,1,3,5,0,1,2,0,9,8,1
10500,181885,MawTy0UaNMzLOBBaurqND3JymILXKOHX,5Gyp41oLVo7Gg7vF4vpmggWP5MU70QO6,15,14,9,10,1,0,4,0,38,5.428571428571429,1,0.0,0,9,6,1,14,0,4,4,0,16,22,1
10501,181886,2oHi0xAwpU9rO0gdJkKqphbQcbEZ8anJ,5Gyp41oLVo7Gg7vF4vpmggWP5MU70QO6,8,10,5,10,0,0,4,0,29,4.142857142857143,1,0.0,4,5,9,0,6,0,1,4,0,18,11,1
10502,181890,pmuU4bWjVJ0lq4P8L4015gBgZrLIZM8p,5Gyp41oLVo7Gg7vF4vpmggWP5MU70QO6,6,5,4,0,1,0,1,0,11,1.5714285714285714,1,0.0,0,4,0,1,5,0,0,1,0,5,6,1
10503,181904,W45vVnuMw5fBAycI8BoUEsnE5dwQvAy8,5Gyp41oLVo7Gg7vF4vpmggWP5MU70QO6,6,3,2,0,2,0,1,0,8,1.1428571428571428,1,0.0,0,2,0,2,3,0,0,1,0,4,4,1
10504,181921,LNYrn6xB3rBElpbQNSOCHM0VLOJzqt6i,5Gyp41oLVo7Gg7vF4vpmggWP5MU70QO6,9,5,3,0,2,7,6,0,23,3.2857142857142856,1,0.0,0,3,0,2,5,7,0,6,0,5,18,1
10505,181933,rwzmhiQOlMw9FlgdSOddl4jBOOu67wjg,5Gyp41oLVo7Gg7vF4vpmggWP5MU70QO6,2,0,0,0,0,0,2,0,2,0.2857142857142857,1,0.0,0,0,0,0,0,0,0,2,0,0,2,1
10506,181954,L3hcz7iHh1j4JsmPAhDddHFBFjWN9SzP,5Gyp41oLVo7Gg7vF4vpmggWP5MU70QO6,4,2,1,0,1,0,2,0,6,0.8571428571428571,1,0.0,0,1,0,1,2,0,0,2,0,2,4,1
10507,181957,Ov9SdOcJjrPsko4RxSRp3diSYNiMCffC,5Gyp41oLVo7Gg7vF4vpmggWP5MU70QO6,7,4,2,0,3,0,1,0,10,1.4285714285714286,1,0.0,1,2,0,3,3,0,0,1,0,6,4,1
10508,181966,FbSHedxpIyx1zxNDmX3MtyNonypZQZwK,5Gyp41oLVo7Gg7vF4vpmggWP5MU70QO6,8,6,3,2,1,0,1,0,13,1.8571428571428572,1,0.0,0,3,1,1,6,0,1,1,0,5,8,1
10509,181971,NmYREsaZDERhdTllo0PKFjYlurn0TTI7,5Gyp41oLVo7Gg7vF4vpmggWP5MU70QO6,9,6,3,1,2,0,2,0,14,2.0,1,0.0,2,3,1,2,4,0,0,2,0,8,6,1
10510,182000,JQ0cmdrRVrmZvsr4jAL1KLBXht7wZGtP,5Gyp41oLVo7Gg7vF4vpmggWP5MU70QO6,4,2,1,0,1,0,1,0,5,0.7142857142857143,1,0.0,0,1,0,1,2,0,0,1,0,2,3,1
10511,182006,9A1ZQrzcYlbBSb63MFLqCvCueyg4FsvP,5Gyp41oLVo7Gg7vF4vpmggWP5MU70QO6,7,8,5,0,5,0,2,0,20,2.857142857142857,1,0.0,0,5,0,5,8,0,0,2,0,10,10,1
10512,182011,3KCb4A6amo38Fw6QE756HJn80s8Q1p3u,5Gyp41oLVo7Gg7vF4vpmggWP5MU70QO6,4,2,1,0,1,0,1,0,5,0.7142857142857143,1,0.0,0,1,0,1,2,0,0,1,0,2,3,1
10513,182024,3DiWYAOQjeDtnJZGK8fOdLVqW8Lh6lud,5Gyp41oLVo7Gg7vF4vpmggWP5MU70QO6,2,0,0,0,0,0,4,0,4,0.5714285714285714,1,0.0,0,0,0,0,0,0,0,4,0,0,4,1
10514,182025,nZgMoXQTdwr6mRJaOu9BQK0OQtDdo4la,5Gyp41oLVo7Gg7vF4vpmggWP5MU70QO6,1,0,0,0,0,0,1,0,1,0.14285714285714285,1,0.0,0,0,0,0,0,0,0,1,0,0,1,1
10515,182034,1Z2YS4fNWnbcxpYbnETbTnCL868s8T08,5Gyp41oLVo7Gg7vF4vpmggWP5MU70QO6,8,12,4,0,0,0,2,0,18,2.5714285714285716,1,0.0,0,4,0,0,12,0,0,2,0,4,14,1
10516,182035,7KhKqa63HvVJWSmCO4rE8rP2X8uu5f5I,5Gyp41oLVo7Gg7vF4vpmggWP5MU70QO6,10,11,5,0,4,0,4,0,24,3.4285714285714284,1,0.0,2,5,0,4,9,0,0,4,0,11,13,1
10517,182041,BEoFn5nxSaJGR2KKBSxScQ6BAoe2WAvX,5Gyp41oLVo7Gg7vF4vpmggWP5MU70QO6,2,0,0,0,0,0,2,0,2,0.2857142857142857,1,0.0,0,0,0,0,0,0,0,2,0,0,2,1
10518,182082,V4j9PrCfYtbqCIwmvlNG7xBA7kUHsqZK,5Gyp41oLVo7Gg7vF4vpmggWP5MU70QO6,8,3,0,0,1,0,6,1,11,1.5714285714285714,1,0.0,0,0,0,1,3,0,0,6,1,1,10,1
10519,182083,ki90RZB6Cz17YNoTCBLraq3nBz0Lom7L,5Gyp41oLVo7Gg7vF4vpmggWP5MU70QO6,4,2,1,0,1,0,1,0,5,0.7142857142857143,1,0.0,0,1,0,1,2,0,0,1,0,2,3,1
10520,182096,BvffxX46vpsrzdz3BgWM6oxkgoUuLeGW,5Gyp41oLVo7Gg7vF4vpmggWP5MU70QO6,5,1,1,0,0,1,5,0,8,1.1428571428571428,2,0.0,0,1,0,0,1,1,0,5,0,1,7,1
10521,182100,kJMtZ1ZRFiok4Mw6PIf0eVr6xCFOhu4o,5Gyp41oLVo7Gg7vF4vpmggWP5MU70QO6,1,0,0,0,0,0,2,0,2,0.2857142857142857,1,0.0,0,0,0,0,0,0,0,2,0,0,2,1
10522,182153,LYRECt7UvWAQo3p4ZaUgaxhi8hvbxrUh,fbPkOYLVPtPgIt0MxizjfFJov3JbHyAi,1,0,0,0,0,0,1,0,1,0.14285714285714285,1,0.0,0,0,0,0,0,0,0,1,0,0,1,1
10523,182187,H117GF1k3O9osnwLz3rAg4mYmWstuXU0,3VkHkmOtom3jM2wCu94xgzzu1d6Dn7or,1,0,0,0,0,0,2,0,2,0.2857142857142857,1,0.0,0,0,0,0,0,0,0,2,0,0,2,1
10524,182190,00Kx3J9CRlctJfArDSkdtP8hRdqPFwLf,3VkHkmOtom3jM2wCu94xgzzu1d6Dn7or,1,0,0,0,0,0,1,0,1,0.14285714285714285,1,0.0,0,0,0,0,0,0,0,1,0,0,1,1
10525,182192,GrWRHoB3VWocBjREEumvkOBXvz3lJGxv,3VkHkmOtom3jM2wCu94xgzzu1d6Dn7or,1,0,0,0,0,0,1,0,1,0.14285714285714285,1,0.0,0,0,0,0,0,0,0,1,0,0,1,1
10526,182196,IdmjEEjxaIwYtwaiihXQw24cCOzGMcRI,3VkHkmOtom3jM2wCu94xgzzu1d6Dn7or,5,7,2,0,2,0,2,0,13,1.8571428571428572,1,0.0,4,2,0,2,3,0,0,2,0,8,5,1
10527,182197,CH7rIEiCYJderq7iXskzAGjPNDy8sGGS,3VkHkmOtom3jM2wCu94xgzzu1d6Dn7or,4,2,1,0,1,0,1,0,5,0.7142857142857143,1,0.0,0,1,0,1,2,0,0,1,0,2,3,1
10528,182200,wewT1LcIg9ROwSNoAw0lFo4wxE5uZciO,3VkHkmOtom3jM2wCu94xgzzu1d6Dn7or,9,5,3,4,3,2,9,0,26,3.7142857142857144,1,0.0,2,3,3,3,3,2,1,9,0,11,15,0
10529,182202,KLtToUXPfDnf997XzXyNb6H8vh7LaC9m,3VkHkmOtom3jM2wCu94xgzzu1d6Dn7or,2,0,0,0,0,0,2,0,2,0.2857142857142857,1,0.0,0,0,0,0,0,0,0,2,0,0,2,1
10530,182206,uQtAgJj2Of7B50CCIIAF0x5swLURLwJX,3VkHkmOtom3jM2wCu94xgzzu1d6Dn7or,1,0,0,0,0,0,2,0,2,0.2857142857142857,1,0.0,0,0,0,0,0,0,0,2,0,0,2,1
10531,182208,uMRvOWo3sNjmemkFxMacb4QbfvnWRpMb,3VkHkmOtom3jM2wCu94xgzzu1d6Dn7or,6,1,1,0,0,2,5,1,10,1.4285714285714286,1,0.0,0,1,0,0,1,2,0,5,1,1,9,1
10532,182215,kPSxZZ94rBA1L72EwaJLctu2Ik0HW0q7,3VkHkmOtom3jM2wCu94xgzzu1d6Dn7or,3,2,0,0,0,1,1,0,4,0.5714285714285714,1,0.0,0,0,0,0,2,1,0,1,0,0,4,1
10533,182240,W2db1kjWC1U4zDuCRrsZQTSQpohcCfeK,3VkHkmOtom3jM2wCu94xgzzu1d6Dn7or,5,2,1,0,1,0,2,0,6,0.8571428571428571,1,0.0,0,1,0,1,2,0,0,2,0,2,4,1
10534,182247,emlaLAdmzzEGMpifkpl9WpOOIevlnDOM,3VkHkmOtom3jM2wCu94xgzzu1d6Dn7or,36,24,11,42,11,0,3,0,91,13.0,2,0.0,10,11,32,11,14,0,10,3,0,64,27,1
10535,182250,fNqfDDObJjv6kYtYOM5CvmS2PsuLl3sf,3VkHkmOtom3jM2wCu94xgzzu1d6Dn7or,4,2,0,0,0,0,4,0,6,0.8571428571428571,1,0.0,0,0,0,0,2,0,0,4,0,0,6,1
10536,182254,XStD3S8KQ8bJ4cdsAZYlRFdU3WnvmVed,3VkHkmOtom3jM2wCu94xgzzu1d6Dn7or,1,0,0,0,0,0,1,0,1,0.14285714285714285,1,0.0,0,0,0,0,0,0,0,1,0,0,1,1
10537,182264,20W3KdJ6RNWG2FvhyTnQB2r6IXpufM92,3VkHkmOtom3jM2wCu94xgzzu1d6Dn7or,10,9,5,0,4,0,10,6,34,4.857142857142857,1,0.0,2,5,0,4,7,0,0,10,6,11,23,1
10538,182266,d5N36ltJLuexchMmFNrBfpp3LZsF74JT,3VkHkmOtom3jM2wCu94xgzzu1d6Dn7or,1,0,0,0,0,0,1,0,1,0.14285714285714285,1,0.0,0,0,0,0,0,0,0,1,0,0,1,1
10539,182268,g2zZYnTJ1Pk3cSjsVP5SH4UjJdsbDJv7,3VkHkmOtom3jM2wCu94xgzzu1d6Dn7or,1,0,0,0,0,0,1,0,1,0.14285714285714285,1,0.0,0,0,0,0,0,0,0,1,0,0,1,0
10540,182278,AQ6M5BJYsVJFiSEOtWrHSzMJEU0hwvMR,3VkHkmOtom3jM2wCu94xgzzu1d6Dn7or,7,2,1,0,1,2,16,0,22,3.142857142857143,1,0.0,0,1,0,1,2,2,0,16,0,2,20,1
10541,182279,Yy2T8AQun3h4tOt3dyFcuzCw5XOF0cCp,3VkHkmOtom3jM2wCu94xgzzu1d6Dn7or,4,5,0,0,0,0,3,1,9,1.2857142857142858,2,0.0,0,0,0,0,5,0,0,3,1,0,9,1
10542,182280,FvwBnZjfO1ihX1Ognm9XYc2VlKDdgQWa,3VkHkmOtom3jM2wCu94xgzzu1d6Dn7or,4,3,1,0,1,0,1,0,6,0.8571428571428571,1,0.0,0,1,0,1,3,0,0,1,0,2,4,1
10543,182285,DjLk0aa0OIt3R9DUjosJRHAu7bqj2BBW,3VkHkmOtom3jM2wCu94xgzzu1d6Dn7or,5,4,1,0,0,1,3,0,9,1.2857142857142858,1,0.0,2,1,0,0,2,1,0,3,0,3,6,1
10544,184210,7bvRPEYYTDBXOreNFj9y4lO2i874OSqr,5Gyp41oLVo7Gg7vF4vpmggWP5MU70QO6,7,6,3,0,4,0,2,0,15,2.142857142857143,1,0.0,2,3,0,4,4,0,0,2,0,9,6,1
10545,184219,nRLTavEl1bXxEwhFINnyKEh9SYy7D5ak,5Gyp41oLVo7Gg7vF4vpmggWP5MU70QO6,1,0,0,0,0,0,1,0,1,0.14285714285714285,1,0.0,0,0,0,0,0,0,0,1,0,0,1,1
10546,184226,iZ7oRof6XG94oKpKDEWLYsJz0T3reAxj,5Gyp41oLVo7Gg7vF4vpmggWP5MU70QO6,16,17,8,0,7,0,7,0,39,5.571428571428571,3,0.0,4,8,0,7,13,0,0,7,0,19,20,1
10547,184235,qlzaQ9z7TvE1mLftjvyiINQnnHC8FPLg,5Gyp41oLVo7Gg7vF4vpmggWP5MU70QO6,12,16,6,6,3,0,2,0,33,4.714285714285714,1,0.0,9,6,3,3,7,0,3,2,0,21,12,1
10548,184239,p7E5WenzaLCPubjqWttrcLkeJXAFmBEE,5Gyp41oLVo7Gg7vF4vpmggWP5MU70QO6,30,47,22,4,17,1,10,1,102,14.571428571428571,3,0.0,13,22,2,17,34,1,2,10,1,54,48,1
10549,184248,5EA5jBdNRAYMCxVAAIbQ9BEkwXmNW6e8,5Gyp41oLVo7Gg7vF4vpmggWP5MU70QO6,6,1,1,0,1,0,3,0,6,0.8571428571428571,1,0.0,0,1,0,1,1,0,0,3,0,2,4,1
10550,184253,HwQlDqQYrfHrBUx2SSkCNQ3Dej1xgfkf,5Gyp41oLVo7Gg7vF4vpmggWP5MU70QO6,2,0,0,0,0,0,2,0,2,0.2857142857142857,1,0.0,0,0,0,0,0,0,0,2,0,0,2,1
10551,184261,6k3nF0wSBDpE8ld5di4cKFHOiA6X24CO,5Gyp41oLVo7Gg7vF4vpmggWP5MU70QO6,14,36,2,10,1,1,14,1,65,9.285714285714286,1,0.0,12,2,5,1,24,1,5,14,1,20,45,1
10552,184263,kljbMpKSiyf0BGkQTUWVZEQjOuteaXYS,5Gyp41oLVo7Gg7vF4vpmggWP5MU70QO6,1,0,0,0,0,0,1,0,1,0.14285714285714285,1,0.0,0,0,0,0,0,0,0,1,0,0,1,1
10553,184268,VckH4WJ96SSx6wIhwSpi3Xlnloun2d0o,5Gyp41oLVo7Gg7vF4vpmggWP5MU70QO6,8,1,1,0,1,2,7,1,13,1.8571428571428572,1,0.0,0,1,0,1,1,2,0,7,1,2,11,1
10554,184271,PlmrtTR7uQeuggKkwRFHO3eqd7sy7ewH,5Gyp41oLVo7Gg7vF4vpmggWP5MU70QO6,5,0,0,0,0,0,6,1,7,1.0,1,0.0,0,0,0,0,0,0,0,6,1,0,7,1
10555,184282,Pa6q3GURVMOLQ4UwIHvezCuS8k4QUsk2,5Gyp41oLVo7Gg7vF4vpmggWP5MU70QO6,6,3,1,0,1,0,2,0,7,1.0,1,0.0,0,1,0,1,3,0,0,2,0,2,5,1
10556,184287,DA1oHIB5igyhRc983tgLidUmLqZEjW60,5Gyp41oLVo7Gg7vF4vpmggWP5MU70QO6,7,3,2,0,2,1,3,0,11,1.5714285714285714,1,0.0,0,2,0,2,3,1,0,3,0,4,7,1
10557,184293,SV0dVmzZ9aNkkaStnkvyjzO8rS13Hmyj,5Gyp41oLVo7Gg7vF4vpmggWP5MU70QO6,1,0,0,0,0,0,1,0,1,0.14285714285714285,1,0.0,0,0,0,0,0,0,0,1,0,0,1,1
10558,184300,M9QVnbr7cTEOdDrjV7tSlms6MFtjz4TS,5Gyp41oLVo7Gg7vF4vpmggWP5MU70QO6,1,0,0,0,0,0,1,0,1,0.14285714285714285,1,0.0,0,0,0,0,0,0,0,1,0,0,1,1
10559,184314,XmbLwxmQRLXz9T2ULgWW6uwVskMK6ds2,5Gyp41oLVo7Gg7vF4vpmggWP5MU70QO6,8,5,3,0,2,0,2,0,12,1.7142857142857142,1,0.0,1,3,0,2,4,0,0,2,0,6,6,1
10560,184336,sJGJVFEmmILnCJO6pOFT54G9IGYlntDf,5Gyp41oLVo7Gg7vF4vpmggWP5MU70QO6,9,7,4,0,3,0,4,0,18,2.5714285714285716,1,0.0,0,4,0,3,7,0,0,4,0,7,11,1
10561,184346,dNX4sxsHS3PyeepKusHD7nMAg2KIqXVR,5Gyp41oLVo7Gg7vF4vpmggWP5MU70QO6,1,0,0,0,0,0,1,0,1,0.14285714285714285,1,0.0,0,0,0,0,0,0,0,1,0,0,1,1
10562,184361,jtCtHXWOBSTdlKr2tdadcDS8tG5gL3Cm,5Gyp41oLVo7Gg7vF4vpmggWP5MU70QO6,9,5,3,2,2,1,3,0,16,2.2857142857142856,1,0.0,1,3,1,2,4,1,1,3,0,7,9,1
10563,184363,sMXQ0lkwphZtOVOIVFSXKBg9Mbshvueh,5Gyp41oLVo7Gg7vF4vpmggWP5MU70QO6,1,0,0,0,0,0,1,0,1,0.14285714285714285,1,0.0,0,0,0,0,0,0,0,1,0,0,1,1
10564,184366,p4aeChS8V6sdii1fWMpHqOr9sw3fUVpL,5Gyp41oLVo7Gg7vF4vpmggWP5MU70QO6,13,13,6,2,3,0,7,1,32,4.571428571428571,1,0.0,4,6,1,3,9,0,1,7,1,14,18,1
10565,184394,kD8T4ioGqK698fH7TafuUEANu5M3X5ow,5Gyp41oLVo7Gg7vF4vpmggWP5MU70QO6,6,1,1,0,0,0,6,0,8,1.1428571428571428,1,0.0,0,1,0,0,1,0,0,6,0,1,7,1
10566,184400,fNOKspiygoNPyc9Zya8bx8zgsbzNMYEl,5Gyp41oLVo7Gg7vF4vpmggWP5MU70QO6,6,5,2,0,1,0,2,0,10,1.4285714285714286,1,0.0,1,2,0,1,4,0,0,2,0,4,6,1
10567,184413,3rKo42EDqTNzb1FHWny9vqyq3QGKHWYi,3VkHkmOtom3jM2wCu94xgzzu1d6Dn7or,1,0,0,0,0,0,2,0,2,0.2857142857142857,1,0.0,0,0,0,0,0,0,0,2,0,0,2,1
10568,184414,guLH9RbgvmZyGJHxVlHaGdPm3YO3PNP3,3VkHkmOtom3jM2wCu94xgzzu1d6Dn7or,1,0,0,0,0,0,1,0,1,0.14285714285714285,1,0.0,0,0,0,0,0,0,0,1,0,0,1,1
10569,184420,Uf5uqVmgXOGUVyzUwqRVeif27urJpV9D,3VkHkmOtom3jM2wCu94xgzzu1d6Dn7or,1,0,0,0,0,0,2,0,2,0.2857142857142857,1,0.0,0,0,0,0,0,0,0,2,0,0,2,1
10570,184425,GPYLW7Qeuhldo4zJYdA9fPSL7bxzMkqH,3VkHkmOtom3jM2wCu94xgzzu1d6Dn7or,12,25,13,0,2,0,10,2,52,7.428571428571429,1,0.0,1,13,0,2,24,0,0,10,2,16,36,1
10571,184444,SXvBkPRiDf0mOsIrim49rPjWxu2nZJ38,3VkHkmOtom3jM2wCu94xgzzu1d6Dn7or,1,0,0,0,0,0,1,0,1,0.14285714285714285,1,0.0,0,0,0,0,0,0,0,1,0,0,1,1
10572,184483,dmhkL35doRyRiXlb3XuDnJlpO05GLvg1,3VkHkmOtom3jM2wCu94xgzzu1d6Dn7or,1,0,0,0,0,0,1,0,1,0.14285714285714285,1,0.0,0,0,0,0,0,0,0,1,0,0,1,1
10573,184488,obivpgNgj6Uz2dRJhIgqdDGHGOMzyFaS,3VkHkmOtom3jM2wCu94xgzzu1d6Dn7or,1,0,0,0,0,0,1,0,1,0.14285714285714285,1,0.0,0,0,0,0,0,0,0,1,0,0,1,1
10574,184497,QyJU33UpOIhHeH2JlPisscvkAnmS8XIo,3VkHkmOtom3jM2wCu94xgzzu1d6Dn7or,1,0,0,0,0,0,1,0,1,0.14285714285714285,1,0.0,0,0,0,0,0,0,0,1,0,0,1,1
10575,184503,J8NkUmSvsrLHkKNXPhFg7o0pG3K7Aywh,3VkHkmOtom3jM2wCu94xgzzu1d6Dn7or,27,51,11,30,23,20,7,1,143,20.428571428571427,1,0.0,37,11,27,23,14,20,3,7,1,98,45,1
10576,184551,Wpgt21OSEq4dKkRxDfadQJL5vA48tiTa,3VkHkmOtom3jM2wCu94xgzzu1d6Dn7or,1,0,0,0,0,0,1,0,1,0.14285714285714285,1,0.0,0,0,0,0,0,0,0,1,0,0,1,1
10577,184561,ozNhkkamO29sRihJesqDynSkMc9IakXW,3VkHkmOtom3jM2wCu94xgzzu1d6Dn7or,1,0,0,0,0,0,2,0,2,0.2857142857142857,1,0.0,0,0,0,0,0,0,0,2,0,0,2,1
10578,184584,gVURM5KTzMzvAobuwS47q0liMn7aNDRj,3VkHkmOtom3jM2wCu94xgzzu1d6Dn7or,2,0,0,0,0,0,2,0,2,0.2857142857142857,1,0.0,0,0,0,0,0,0,0,2,0,0,2,1
10579,184589,FHy8g1cEh82PEcyEfOIdRe9C7Etj43yh,3VkHkmOtom3jM2wCu94xgzzu1d6Dn7or,4,0,0,0,0,0,4,0,4,0.5714285714285714,1,0.0,0,0,0,0,0,0,0,4,0,0,4,1
10580,184593,JE4RM1E1GtVC1JJ9Kdz0YYh3efeu94DE,3VkHkmOtom3jM2wCu94xgzzu1d6Dn7or,1,0,0,0,0,0,1,0,1,0.14285714285714285,1,0.0,0,0,0,0,0,0,0,1,0,0,1,1
10581,184599,Y5vbMeMNGfsVjyyEe13ZzpM37CaJrsxM,3VkHkmOtom3jM2wCu94xgzzu1d6Dn7or,14,11,5,0,5,1,23,0,45,6.428571428571429,1,0.0,4,5,0,5,7,1,0,23,0,14,31,1
10582,184602,ssWxad5FsRCaOzAncjBPd10wMjCodzee,3VkHkmOtom3jM2wCu94xgzzu1d6Dn7or,1,0,0,0,0,0,1,0,1,0.14285714285714285,1,0.0,0,0,0,0,0,0,0,1,0,0,1,1
10583,184631,nEdLTHDRzkhr5Ltp2hTJhuuwf36aLCXo,3VkHkmOtom3jM2wCu94xgzzu1d6Dn7or,1,0,0,0,0,0,1,0,1,0.14285714285714285,1,0.0,0,0,0,0,0,0,0,1,0,0,1,1
10584,184635,gqrHNH5DBG72cqSpAcse3l1mSsO9h8ID,3VkHkmOtom3jM2wCu94xgzzu1d6Dn7or,1,0,0,0,0,0,1,0,1,0.14285714285714285,1,0.0,0,0,0,0,0,0,0,1,0,0,1,1
10585,184648,TiN4z0dSpp09iMKqN066qAoKwqCoLlNB,3VkHkmOtom3jM2wCu94xgzzu1d6Dn7or,4,3,2,0,2,0,1,0,8,1.1428571428571428,1,0.0,0,2,0,2,3,0,0,1,0,4,4,1
10586,184657,NBGFp0gUGl7pGZsh0AwbN5ZSq40YlIJ2,3VkHkmOtom3jM2wCu94xgzzu1d6Dn7or,1,0,0,0,0,0,2,0,2,0.2857142857142857,1,0.0,0,0,0,0,0,0,0,2,0,0,2,1
10587,184658,EbMElu3ne7Vb3OjNBzMAyF7HKKBmGMQc,3VkHkmOtom3jM2wCu94xgzzu1d6Dn7or,1,0,0,0,0,0,1,0,1,0.14285714285714285,1,0.0,0,0,0,0,0,0,0,1,0,0,1,1
10588,184660,l9VF7PxUTdTjw9PoeZ8vuGbnxVikaOqm,3VkHkmOtom3jM2wCu94xgzzu1d6Dn7or,3,0,0,0,0,0,4,0,4,0.5714285714285714,1,0.0,0,0,0,0,0,0,0,4,0,0,4,1
10589,184676,hjTlTldX3nv2rdUD7FZwX9ixWL4HYfi0,3VkHkmOtom3jM2wCu94xgzzu1d6Dn7or,7,5,2,0,2,0,2,0,11,1.5714285714285714,1,0.0,0,2,0,2,5,0,0,2,0,4,7,1
10590,184684,DLwvun835EDsVNPiO5RWf5L2mqvJqG24,3VkHkmOtom3jM2wCu94xgzzu1d6Dn7or,1,0,0,0,0,0,2,0,2,0.2857142857142857,1,0.0,0,0,0,0,0,0,0,2,0,0,2,1
10591,184696,K8wSMcFk6kWIslENfngvILH7dw4LUtxA,3VkHkmOtom3jM2wCu94xgzzu1d6Dn7or,1,0,0,0,0,0,1,0,1,0.14285714285714285,1,0.0,0,0,0,0,0,0,0,1,0,0,1,1
10592,184721,FsN3EYiAfRxm9msVQNiGujMlmaZjdiLV,3VkHkmOtom3jM2wCu94xgzzu1d6Dn7or,1,0,0,0,0,0,1,0,1,0.14285714285714285,1,0.0,0,0,0,0,0,0,0,1,0,0,1,1
10593,184733,gk4vmSGzuoTlRCezpW4fwbH64RLSSSIP,3VkHkmOtom3jM2wCu94xgzzu1d6Dn7or,5,2,1,0,1,0,3,0,7,1.0,1,0.0,0,1,0,1,2,0,0,3,0,2,5,1
10594,184760,cKMSHNo94s836f7j8aPXbepJtLJaszYV,3VkHkmOtom3jM2wCu94xgzzu1d6Dn7or,8,6,3,0,2,0,7,0,18,2.5714285714285716,1,0.0,0,3,0,2,6,0,0,7,0,5,13,1
10595,184787,uSToVUcl7sIuWsbjUGg0o72Kpa98eG8A,3VkHkmOtom3jM2wCu94xgzzu1d6Dn7or,1,0,0,0,0,0,1,0,1,0.14285714285714285,1,0.0,0,0,0,0,0,0,0,1,0,0,1,1
10596,184818,ATMWI1P8iLpd6GJhDJ5fN7MDX7N1RYWE,3VkHkmOtom3jM2wCu94xgzzu1d6Dn7or,1,0,0,0,0,0,1,0,1,0.14285714285714285,1,0.0,0,0,0,0,0,0,0,1,0,0,1,1
10597,185751,MbewcgzgToNhp9B6eaNSolme5R0M2nkY,SpATywNh6bZuzm8s1ceuBUnMUAeoAHHw,17,23,2,0,2,0,3,0,30,4.285714285714286,2,0.0,1,2,0,2,22,0,0,3,0,5,25,1
10598,185934,YisM8PtG7Ux1VoDWsMxvoOKtYDxnQIkB,SpATywNh6bZuzm8s1ceuBUnMUAeoAHHw,3,2,0,0,0,0,1,0,3,0.42857142857142855,1,0.0,0,0,0,0,2,0,0,1,0,0,3,0
10599,186771,EEukb1HtBZxlb0jW8bNwwOHInCYodyW7,SpATywNh6bZuzm8s1ceuBUnMUAeoAHHw,14,34,25,8,5,1,5,0,78,11.142857142857142,1,0.0,5,25,6,5,29,1,2,5,0,41,37,1
10600,186911,DSucldosbIjEAZZwdtdITu0zXAY3IdvD,3VkHkmOtom3jM2wCu94xgzzu1d6Dn7or,17,21,15,0,11,3,21,0,71,10.142857142857142,1,0.0,0,15,0,11,21,3,0,21,0,26,45,1
10601,186924,jF1NUJsBmFXEwkk4UXwN1TfFpCBG6pWD,3VkHkmOtom3jM2wCu94xgzzu1d6Dn7or,1,0,0,0,0,0,1,0,1,0.14285714285714285,1,0.0,0,0,0,0,0,0,0,1,0,0,1,1
10602,186933,fGpbVdlJo5xTjNN6Spc1hhlZUu4OOr7T,3VkHkmOtom3jM2wCu94xgzzu1d6Dn7or,1,0,0,0,0,0,1,0,1,0.14285714285714285,1,0.0,0,0,0,0,0,0,0,1,0,0,1,1
10603,186939,dJg2msyls77AnAm6uajII4KKm8Q8hwC1,3VkHkmOtom3jM2wCu94xgzzu1d6Dn7or,15,20,11,0,10,0,1,0,42,6.0,1,0.0,0,11,0,10,20,0,0,1,0,21,21,1
10604,186944,uiK7hO9pSLrjHQHuySUntwzbR3KU4xGx,3VkHkmOtom3jM2wCu94xgzzu1d6Dn7or,1,0,0,0,0,0,1,0,1,0.14285714285714285,1,0.0,0,0,0,0,0,0,0,1,0,0,1,1
10605,186947,PebrX2202jwFfmxAzdqi3Y0wuv5AlaH5,3VkHkmOtom3jM2wCu94xgzzu1d6Dn7or,2,0,0,0,0,0,3,0,3,0.42857142857142855,2,0.0,0,0,0,0,0,0,0,3,0,0,3,1
10606,186953,F7U9ZHucyu3CV9XHiYJsvH9QXbAT1goG,3VkHkmOtom3jM2wCu94xgzzu1d6Dn7or,5,2,1,0,1,0,3,1,8,1.1428571428571428,1,0.0,0,1,0,1,2,0,0,3,1,2,6,1
10607,186975,rBLgB4SXURK0P1ThVuiQp95AEMKWyvye,3VkHkmOtom3jM2wCu94xgzzu1d6Dn7or,8,2,1,0,1,1,7,2,14,2.0,1,0.0,0,1,0,1,2,1,0,7,2,2,12,0
10608,186992,xjV01NLdh6HESD02zKRZtvjxAfS0TO1x,3VkHkmOtom3jM2wCu94xgzzu1d6Dn7or,8,16,5,2,4,4,2,0,33,4.714285714285714,1,0.0,5,5,2,4,11,4,0,2,0,16,17,1
10609,186999,4DPKOQvuGxYOwlUItONudt9tR0jntQqh,3VkHkmOtom3jM2wCu94xgzzu1d6Dn7or,9,11,3,0,4,0,4,1,23,3.2857142857142856,1,0.0,2,3,0,4,9,0,0,4,1,9,14,1
10610,187013,lBDP0bEGdpXmY1IAvAuALKqFWFlEuPft,3VkHkmOtom3jM2wCu94xgzzu1d6Dn7or,8,4,1,0,1,4,6,3,19,2.7142857142857144,1,0.0,2,1,0,1,2,4,0,6,3,4,15,1
10611,187038,hwI4zqIHvHYPcmQMWVn6dAzcvw5VYKKk,3VkHkmOtom3jM2wCu94xgzzu1d6Dn7or,6,3,1,0,1,1,3,0,9,1.2857142857142858,1,0.0,1,1,0,1,2,1,0,3,0,3,6,1
10612,187045,xaaVsAZ1tR0yEpnQXOKlyxITxN3yh1kD,3VkHkmOtom3jM2wCu94xgzzu1d6Dn7or,4,3,0,0,1,0,5,0,9,1.2857142857142858,2,0.0,1,0,0,1,2,0,0,5,0,2,7,1
10613,187048,Bt0YrpvyveynQfxqkzppqbivsu9tYRaK,3VkHkmOtom3jM2wCu94xgzzu1d6Dn7or,1,0,0,0,0,0,2,0,2,0.2857142857142857,1,0.0,0,0,0,0,0,0,0,2,0,0,2,1
10614,187085,9BFsMQpEVVEqni5ItC1BH9wyokJ4Dl09,3VkHkmOtom3jM2wCu94xgzzu1d6Dn7or,5,5,1,0,0,0,2,0,8,1.1428571428571428,1,0.0,0,1,0,0,5,0,0,2,0,1,7,1
10615,187086,IsTK1MTmWtJuEb82hlXsEZ9eWGGnrqPP,3VkHkmOtom3jM2wCu94xgzzu1d6Dn7or,8,4,3,0,3,0,1,0,11,1.5714285714285714,1,0.0,0,3,0,3,4,0,0,1,0,6,5,1
10616,187088,dlrLIaHXxLuhaK6Dcn0tRGWiM9T19Je3,fbPkOYLVPtPgIt0MxizjfFJov3JbHyAi,6,1,1,0,1,0,3,0,6,0.8571428571428571,1,0.0,0,1,0,1,1,0,0,3,0,2,4,1
10617,187089,0PYlPo8KoOqdfXLmHxHfVVjmiH634i57,fbPkOYLVPtPgIt0MxizjfFJov3JbHyAi,7,3,2,0,2,0,2,0,9,1.2857142857142858,1,0.0,0,2,0,2,3,0,0,2,0,4,5,1
10618,187091,3vC1Avk4MweE6jXdINlfOGwslm7K8miO,fbPkOYLVPtPgIt0MxizjfFJov3JbHyAi,7,3,2,0,2,0,2,0,9,1.2857142857142858,1,0.0,0,2,0,2,3,0,0,2,0,4,5,1
10619,187092,mSXZKJ9e3RCTXopgrFUphpxYgeKp7tlG,fbPkOYLVPtPgIt0MxizjfFJov3JbHyAi,1,0,0,0,0,0,1,0,1,0.14285714285714285,1,0.0,0,0,0,0,0,0,0,1,0,0,1,1
10620,187094,zo3yZSyHQrlqYmJhQx7AWyW8ZBQsx6F5,fbPkOYLVPtPgIt0MxizjfFJov3JbHyAi,1,0,0,0,0,0,1,0,1,0.14285714285714285,1,0.0,0,0,0,0,0,0,0,1,0,0,1,1
10621,187095,7xpmz6LF4dl35fFKZgRU70OZyF8UO4PL,fbPkOYLVPtPgIt0MxizjfFJov3JbHyAi,6,3,2,0,1,0,2,0,8,1.1428571428571428,1,0.0,0,2,0,1,3,0,0,2,0,3,5,1
10622,187098,MVuALw1hJaDtoRSVB68VHL3OEaRsecjE,fbPkOYLVPtPgIt0MxizjfFJov3JbHyAi,8,11,5,8,4,0,1,0,29,4.142857142857143,1,0.0,5,5,6,4,6,0,2,1,0,20,9,1
10623,187100,ppz7CTomjBYQivsr2Dps2PCVRxiD3toN,fbPkOYLVPtPgIt0MxizjfFJov3JbHyAi,1,0,0,0,0,0,1,0,1,0.14285714285714285,1,0.0,0,0,0,0,0,0,0,1,0,0,1,1
10624,187103,ci4gAhZjL2J1kqejbfqEWVVtNgzi36ci,fbPkOYLVPtPgIt0MxizjfFJov3JbHyAi,7,3,2,0,2,0,2,0,9,1.2857142857142858,1,0.0,0,2,0,2,3,0,0,2,0,4,5,1
10625,187104,8WCPZ0bdo5iAWbinwSHd3k1oEK1AHcY6,fbPkOYLVPtPgIt0MxizjfFJov3JbHyAi,1,0,0,0,0,0,1,0,1,0.14285714285714285,1,0.0,0,0,0,0,0,0,0,1,0,0,1,1
10626,187106,L7FfTijl2sEUvCwVWIgdimuCtnJPQB7o,fbPkOYLVPtPgIt0MxizjfFJov3JbHyAi,1,0,0,0,0,0,1,0,1,0.14285714285714285,1,0.0,0,0,0,0,0,0,0,1,0,0,1,1
10627,187108,QOT87ocOuYR2IkmbA3Jyt7pzS8Zs3r2N,fbPkOYLVPtPgIt0MxizjfFJov3JbHyAi,7,6,2,0,2,0,2,0,12,1.7142857142857142,1,0.0,0,2,0,2,6,0,0,2,0,4,8,1
10628,187109,16PZ49GbIBVUoHcK3YWyanucVtonkvq4,fbPkOYLVPtPgIt0MxizjfFJov3JbHyAi,9,6,3,0,2,0,3,0,14,2.0,1,0.0,0,3,0,2,6,0,0,3,0,5,9,1
10629,187110,jQSZrKmukoAGdD1PsGnzsjQnImWdBkqA,fbPkOYLVPtPgIt0MxizjfFJov3JbHyAi,1,0,0,0,0,0,1,0,1,0.14285714285714285,1,0.0,0,0,0,0,0,0,0,1,0,0,1,1
10630,187112,dFTO62uxJHhM2iAeGlKRqSu3846MAtFy,fbPkOYLVPtPgIt0MxizjfFJov3JbHyAi,8,3,2,0,2,3,4,1,15,2.142857142857143,1,0.0,0,2,0,2,3,3,0,4,1,4,11,1
10631,187113,wM5JLG2HTiWJkjaOdIJgInNEHRkSWEDE,fbPkOYLVPtPgIt0MxizjfFJov3JbHyAi,1,0,0,0,0,0,1,0,1,0.14285714285714285,1,0.0,0,0,0,0,0,0,0,1,0,0,1,1
10632,187114,76MsyfoydlyTteuthkqqJhd4o0zqGEPQ,fbPkOYLVPtPgIt0MxizjfFJov3JbHyAi,11,5,4,0,4,0,2,0,15,2.142857142857143,1,0.0,0,4,0,4,5,0,0,2,0,8,7,1
10633,187116,xWNeZUxK8O1kDFvZ0AuZhSKlQ5A39qVr,fbPkOYLVPtPgIt0MxizjfFJov3JbHyAi,1,0,0,0,0,0,1,0,1,0.14285714285714285,1,0.0,0,0,0,0,0,0,0,1,0,0,1,1
10634,187231,KJwbmkoK69ToUHYM3JjYSRGZ65hxphzP,5Gyp41oLVo7Gg7vF4vpmggWP5MU70QO6,6,15,5,0,5,0,1,0,26,3.7142857142857144,1,0.0,0,5,0,5,15,0,0,1,0,10,16,1
10635,187232,cpyogiH7iAig2tMBY5aMQqlSTPCuODq7,5Gyp41oLVo7Gg7vF4vpmggWP5MU70QO6,7,3,2,0,2,0,2,0,9,1.2857142857142858,1,0.0,0,2,0,2,3,0,0,2,0,4,5,1
10636,187238,mGx5ueYQbTbgHY4lfn4jky6mRF7BpJuC,5Gyp41oLVo7Gg7vF4vpmggWP5MU70QO6,1,0,0,0,0,0,1,0,1,0.14285714285714285,1,0.0,0,0,0,0,0,0,0,1,0,0,1,1
10637,187255,AYgSOcnFNUHC4diuBJjhyxFnwGUvydQl,5Gyp41oLVo7Gg7vF4vpmggWP5MU70QO6,1,0,0,0,0,0,1,0,1,0.14285714285714285,1,0.0,0,0,0,0,0,0,0,1,0,0,1,1
10638,187269,n8DEwkzP5bvWTXGQ64ESsgmVoOQcLiKY,5Gyp41oLVo7Gg7vF4vpmggWP5MU70QO6,2,0,0,0,0,0,2,0,2,0.2857142857142857,1,0.0,0,0,0,0,0,0,0,2,0,0,2,1
10639,187289,aukYmO1PjDXsRHpCoYmvSUWYr6Do2QD4,5Gyp41oLVo7Gg7vF4vpmggWP5MU70QO6,1,0,0,0,0,0,2,0,2,0.2857142857142857,1,0.0,0,0,0,0,0,0,0,2,0,0,2,1
10640,187291,MGwCqijPbaECMqR3yBjzMHorAlNOqpXl,5Gyp41oLVo7Gg7vF4vpmggWP5MU70QO6,6,9,7,0,5,15,2,0,38,5.428571428571429,1,0.0,0,7,0,5,9,15,0,2,0,12,26,1
10641,187306,wscwqYf0HkLQPekvnhjR1IJCpLp4XWUe,5Gyp41oLVo7Gg7vF4vpmggWP5MU70QO6,4,2,1,0,1,0,1,0,5,0.7142857142857143,1,0.0,0,1,0,1,2,0,0,1,0,2,3,1
10642,187314,CxsOXh77ynK0lYpDFMGaSL5u6H4vThav,5Gyp41oLVo7Gg7vF4vpmggWP5MU70QO6,5,2,1,0,1,0,2,0,6,0.8571428571428571,1,0.0,0,1,0,1,2,0,0,2,0,2,4,1
10643,187360,YJTmWhg5FwFTBT5yuc8gKsTYE4eaZsY2,5Gyp41oLVo7Gg7vF4vpmggWP5MU70QO6,4,6,1,0,0,0,3,0,10,1.4285714285714286,1,0.0,0,1,0,0,6,0,0,3,0,1,9,1
10644,187370,ZtyTiYj4XdBQnDVICLgwhjMvgpLcUhVS,5Gyp41oLVo7Gg7vF4vpmggWP5MU70QO6,4,2,1,0,1,0,2,0,6,0.8571428571428571,1,0.0,0,1,0,1,2,0,0,2,0,2,4,1
10645,187376,JiewyvYAWlx6gexGik4A5LBXwd7S9X37,5Gyp41oLVo7Gg7vF4vpmggWP5MU70QO6,13,16,3,6,4,0,4,1,34,4.857142857142857,1,0.0,12,3,4,4,4,0,2,4,1,23,11,1
10646,187384,wbFZf0vBGr8ZagqGAnXAxrCWXPqmHozC,5Gyp41oLVo7Gg7vF4vpmggWP5MU70QO6,1,0,0,0,0,0,1,0,1,0.14285714285714285,1,0.0,0,0,0,0,0,0,0,1,0,0,1,1
10647,187390,qpV3C2IZjB1ICwVxeuRFosLbHBid3MJt,5Gyp41oLVo7Gg7vF4vpmggWP5MU70QO6,8,5,3,0,2,0,2,0,12,1.7142857142857142,1,0.0,0,3,0,2,5,0,0,2,0,5,7,1
10648,187421,L1kFTmJDYdpvLc1u6vNcQOn7WLruDpe4,5Gyp41oLVo7Gg7vF4vpmggWP5MU70QO6,4,2,1,0,0,0,2,0,5,0.7142857142857143,1,0.0,0,1,0,0,2,0,0,2,0,1,4,1
10649,187478,D37iLuxt7loQPCePakfmH7GyiB5PvEMk,5Gyp41oLVo7Gg7vF4vpmggWP5MU70QO6,15,25,17,4,3,6,5,0,60,8.571428571428571,1,0.0,4,17,3,3,21,6,1,5,0,27,33,1
10650,187518,b8GI8HzrIl76DGCDw7gwPAfcEuU8gpR5,5Gyp41oLVo7Gg7vF4vpmggWP5MU70QO6,15,19,10,13,4,0,7,0,53,7.571428571428571,1,0.0,4,10,8,4,15,0,5,7,0,26,27,1
10651,187566,wHcO2fuUG30bVlNh2ZpgS5end7Q0W9wU,5Gyp41oLVo7Gg7vF4vpmggWP5MU70QO6,9,4,2,0,1,3,12,1,23,3.2857142857142856,1,0.0,0,2,0,1,4,3,0,12,1,3,20,1
10652,187590,fAp6p9W5rBTQuc3sOQQCK7Lh0pMEnj25,5Gyp41oLVo7Gg7vF4vpmggWP5MU70QO6,13,18,6,0,2,3,8,3,40,5.714285714285714,1,0.0,6,6,0,2,12,3,0,8,3,14,26,1
10653,187591,7Ob4OdeTAKRjQIsUAjssorAsOJaATqXN,5Gyp41oLVo7Gg7vF4vpmggWP5MU70QO6,3,0,0,0,0,0,2,4,6,0.8571428571428571,1,0.0,0,0,0,0,0,0,0,2,4,0,6,1
10654,187597,2qf82Y9baG4R7G8jAYpX9QVmsoyMWhqM,5Gyp41oLVo7Gg7vF4vpmggWP5MU70QO6,6,4,1,0,1,0,3,0,9,1.2857142857142858,1,0.0,0,1,0,1,4,0,0,3,0,2,7,1
10655,187625,Yn25TdLihKYIhyqihvGKu5O4o0bg8SXf,5Gyp41oLVo7Gg7vF4vpmggWP5MU70QO6,7,9,7,0,4,2,10,0,32,4.571428571428571,1,0.0,1,7,0,4,8,2,0,10,0,12,20,1
10656,187632,jJ6H4AGAMcrNyFUtHZ1FlFW8U3hHk9nZ,5Gyp41oLVo7Gg7vF4vpmggWP5MU70QO6,9,7,6,0,3,0,1,0,17,2.4285714285714284,1,0.0,0,6,0,3,7,0,0,1,0,9,8,1
10657,187648,m69B3SgSNcQxtCVoVKKSTOsElUiPbA7t,5Gyp41oLVo7Gg7vF4vpmggWP5MU70QO6,7,3,2,0,2,0,2,0,9,1.2857142857142858,1,0.0,0,2,0,2,3,0,0,2,0,4,5,1
10658,187689,Vu8rN942EwDIOj6iE8IDqvSFXpvGHO9R,5Gyp41oLVo7Gg7vF4vpmggWP5MU70QO6,8,10,5,0,3,0,1,0,19,2.7142857142857144,1,0.0,1,5,0,3,9,0,0,1,0,9,10,1
10659,187721,A0tg4c2oPOVLeO6yZJyRHHatmQr15tSo,5Gyp41oLVo7Gg7vF4vpmggWP5MU70QO6,6,3,2,0,2,0,2,0,9,1.2857142857142858,1,0.0,0,2,0,2,3,0,0,2,0,4,5,1
10660,187722,Z0uiIYjGckCu2uGtFnfk8o06v7Tfu06G,5Gyp41oLVo7Gg7vF4vpmggWP5MU70QO6,6,3,2,0,2,0,1,0,8,1.1428571428571428,1,0.0,0,2,0,2,3,0,0,1,0,4,4,1
10661,187730,XJaKcnkVBI8QunjtQU1MWgScpeVJwWB6,5Gyp41oLVo7Gg7vF4vpmggWP5MU70QO6,9,3,2,0,2,1,4,2,14,2.0,1,0.0,0,2,0,2,3,1,0,4,2,4,10,1
10662,187733,DH3ZDXYOwtm04l7SNlQzyy1uucBnB8el,5Gyp41oLVo7Gg7vF4vpmggWP5MU70QO6,8,6,3,0,2,0,3,0,14,2.0,1,0.0,0,3,0,2,6,0,0,3,0,5,9,1
10663,187735,xwG9GgMrPHgbqqrlvclpGJMpSPdOCjxQ,5Gyp41oLVo7Gg7vF4vpmggWP5MU70QO6,6,3,2,0,2,0,1,0,8,1.1428571428571428,1,0.0,0,2,0,2,3,0,0,1,0,4,4,1
10664,187751,Lnx9qfv9cteMJOlTSwfPI0L1Rjj11T9w,5Gyp41oLVo7Gg7vF4vpmggWP5MU70QO6,10,4,3,0,1,1,6,1,16,2.2857142857142856,1,0.0,0,3,0,1,4,1,0,6,1,4,12,1
10665,187833,9C49qYuvWX3CN7ZTjfCbwdzudgRd6ieI,5Gyp41oLVo7Gg7vF4vpmggWP5MU70QO6,6,8,0,0,0,0,5,0,13,1.8571428571428572,1,0.0,0,0,0,0,8,0,0,5,0,0,13,1
10666,187835,gL404ct0FTiEYon95m5egQXV5s5d3s3Y,5Gyp41oLVo7Gg7vF4vpmggWP5MU70QO6,5,3,1,0,1,0,2,0,7,1.0,1,0.0,0,1,0,1,3,0,0,2,0,2,5,1
10667,187843,A7KWNeLQkkndNIvCdhWgxPt56qJVEywp,5Gyp41oLVo7Gg7vF4vpmggWP5MU70QO6,8,10,5,0,3,0,2,0,20,2.857142857142857,2,0.0,2,5,0,3,8,0,0,2,0,10,10,1
10668,187852,0QlfOSFSvXIm9wHvaQfBOp6BwFpoSBou,5Gyp41oLVo7Gg7vF4vpmggWP5MU70QO6,12,23,5,8,5,0,3,0,44,6.285714285714286,1,0.0,16,5,6,5,7,0,2,3,0,32,12,1
10669,187875,VA4zvww75eVbokKUKFIBvjVtRxGAek2a,5Gyp41oLVo7Gg7vF4vpmggWP5MU70QO6,4,2,1,0,0,0,3,0,6,0.8571428571428571,1,0.0,0,1,0,0,2,0,0,3,0,1,5,1
10670,187893,NgTcbg2BOp0SJ6ucVtVWMLnsvviNigX7,5Gyp41oLVo7Gg7vF4vpmggWP5MU70QO6,9,5,3,0,2,0,3,0,13,1.8571428571428572,1,0.0,0,3,0,2,5,0,0,3,0,5,8,1
10671,187908,8Ma3J2qVEQVCcL3JIoc5G5tjVC70Nx7G,5Gyp41oLVo7Gg7vF4vpmggWP5MU70QO6,21,27,20,5,6,0,3,0,61,8.714285714285714,1,0.0,2,20,3,6,25,0,2,3,0,31,30,1
10672,187913,UUDwBia6o7bnGLf9MCmceg8dt7257Z2a,5Gyp41oLVo7Gg7vF4vpmggWP5MU70QO6,8,5,4,0,0,3,5,1,18,2.5714285714285716,1,0.0,0,4,0,0,5,3,0,5,1,4,14,1
10673,187914,so04UHX42q6jI3lvj3RNVSKJ1VPEH1YP,5Gyp41oLVo7Gg7vF4vpmggWP5MU70QO6,7,3,1,0,2,0,2,0,8,1.1428571428571428,1,0.0,0,1,0,2,3,0,0,2,0,3,5,1
10674,187920,BaYEpyheB5ZN21YYOcUe0rcGnn05lteQ,5Gyp41oLVo7Gg7vF4vpmggWP5MU70QO6,7,4,3,0,2,2,4,0,15,2.142857142857143,1,0.0,0,3,0,2,4,2,0,4,0,5,10,1
10675,187925,lOvvmFbzX3GW24KMAjnXYdwjfcs6WtDl,5Gyp41oLVo7Gg7vF4vpmggWP5MU70QO6,5,2,1,0,1,0,2,0,6,0.8571428571428571,1,0.0,0,1,0,1,2,0,0,2,0,2,4,1
10676,187927,eaviSfmTEk7j37CYqNru3JuRLaAg9VOq,5Gyp41oLVo7Gg7vF4vpmggWP5MU70QO6,6,3,1,0,1,0,3,0,8,1.1428571428571428,1,0.0,1,1,0,1,2,0,0,3,0,3,5,1
10677,187947,uC4WyLpnX5udb1qEUo6mTPhWKzgo83JG,5Gyp41oLVo7Gg7vF4vpmggWP5MU70QO6,1,0,0,0,0,0,2,0,2,0.2857142857142857,1,0.0,0,0,0,0,0,0,0,2,0,0,2,1
10678,187959,YzQntxJ8wtP7KLHQ3esVRl4P3zocy5DG,5Gyp41oLVo7Gg7vF4vpmggWP5MU70QO6,6,5,2,0,2,0,1,0,10,1.4285714285714286,1,0.0,0,2,0,2,5,0,0,1,0,4,6,1
10679,187962,FrgiKI2DEjcm1ldLQtou80RQjRrNaEh9,5Gyp41oLVo7Gg7vF4vpmggWP5MU70QO6,1,0,0,0,0,0,1,0,1,0.14285714285714285,1,0.0,0,0,0,0,0,0,0,1,0,0,1,1
10680,187965,oqwbVEh25hqeZE0Y1kcexH4o8WqmSMNn,5Gyp41oLVo7Gg7vF4vpmggWP5MU70QO6,10,4,2,0,2,5,7,1,21,3.0,1,0.0,0,2,0,2,4,5,0,7,1,4,17,1
10681,187969,Cz8YbZuqlAMA0OaKE0FXfm6tP2nm0keQ,5Gyp41oLVo7Gg7vF4vpmggWP5MU70QO6,8,7,3,0,3,0,1,0,14,2.0,1,0.0,2,3,0,3,5,0,0,1,0,8,6,1
10682,188000,kkPme6dGu7ofLWXsqZkyk5UoyeSjozi6,5Gyp41oLVo7Gg7vF4vpmggWP5MU70QO6,7,5,3,2,2,0,1,0,13,1.8571428571428572,1,0.0,1,3,2,2,4,0,0,1,0,8,5,1
10683,188005,nfS51TNe96GHqM8nL22JKxwIAMwvuxmZ,5Gyp41oLVo7Gg7vF4vpmggWP5MU70QO6,8,6,4,0,3,0,2,0,15,2.142857142857143,1,0.0,0,4,0,3,6,0,0,2,0,7,8,1
10684,188008,EbhEKkK0InsrxKv61aHGTKOc8r6D96CH,5Gyp41oLVo7Gg7vF4vpmggWP5MU70QO6,1,0,0,0,0,0,1,0,1,0.14285714285714285,1,0.0,0,0,0,0,0,0,0,1,0,0,1,1
10685,188010,VsWvOsMJHOlgRBhYoEhQA9GwOYbOPlS0,5Gyp41oLVo7Gg7vF4vpmggWP5MU70QO6,6,1,1,0,1,0,6,0,9,1.2857142857142858,1,0.0,0,1,0,1,1,0,0,6,0,2,7,1
10686,188024,SnQ7aGMt4uZlQyXCfPxKQ3wQgsI8Vuwo,5Gyp41oLVo7Gg7vF4vpmggWP5MU70QO6,1,0,0,0,0,0,1,0,1,0.14285714285714285,1,0.0,0,0,0,0,0,0,0,1,0,0,1,1
10687,188030,UQ4tDNYBiwtltirE3VXKma6eYKFWIZ1n,5Gyp41oLVo7Gg7vF4vpmggWP5MU70QO6,1,0,0,0,0,0,1,0,1,0.14285714285714285,1,0.0,0,0,0,0,0,0,0,1,0,0,1,1
10688,188047,apRBg875HDkrVuiXCnSpAny1kVq4teuC,5Gyp41oLVo7Gg7vF4vpmggWP5MU70QO6,12,17,7,9,8,4,1,0,46,6.571428571428571,1,0.0,8,7,6,8,9,4,3,1,0,29,17,1
10689,188070,5VCrfPcIKKrhaZCO9tkwq4PGRy2D1TeR,5Gyp41oLVo7Gg7vF4vpmggWP5MU70QO6,6,5,2,0,2,0,2,0,11,1.5714285714285714,1,0.0,0,2,0,2,5,0,0,2,0,4,7,1
10690,188474,T2bqEEIIeGnaI1g4yvbhFPGfktTUZc7r,A3fsA9Zfv1X2fVEQhTw51lKENdNrEqT3,7,10,3,0,3,0,1,0,17,2.4285714285714284,1,0.0,0,3,0,3,10,0,0,1,0,6,11,1
10691,188658,U04y5vFf0AfyJVGIOJHlryTyRQEOm5pT,3VkHkmOtom3jM2wCu94xgzzu1d6Dn7or,1,0,0,0,0,0,1,0,1,0.14285714285714285,1,0.0,0,0,0,0,0,0,0,1,0,0,1,1
10692,188659,lA9ihWWB9sZPFslDp6NhYp0arqpvKh8B,3VkHkmOtom3jM2wCu94xgzzu1d6Dn7or,4,5,0,0,0,0,1,0,6,0.8571428571428571,1,0.0,2,0,0,0,3,0,0,1,0,2,4,1
10693,188662,YbX8fApIBY3HjcLkuDXiUFNKK8oYzceC,3VkHkmOtom3jM2wCu94xgzzu1d6Dn7or,1,0,0,0,0,0,1,0,1,0.14285714285714285,1,0.0,0,0,0,0,0,0,0,1,0,0,1,1
10694,188663,TDl0DtlpN9qej21HjowMH1oiSRLXpU6M,3VkHkmOtom3jM2wCu94xgzzu1d6Dn7or,6,4,0,0,2,0,5,0,11,1.5714285714285714,1,0.0,2,0,0,2,2,0,0,5,0,4,7,1
10695,188669,qTGt3BzwYixjdIMVT6SnF4YbX0lYzCYz,3VkHkmOtom3jM2wCu94xgzzu1d6Dn7or,3,5,1,0,1,0,6,0,13,1.8571428571428572,1,0.0,3,1,0,1,2,0,0,6,0,5,8,1
10696,188670,Q95dTGCZ4ON6KcY8VYaWLipwcRku4Hrg,3VkHkmOtom3jM2wCu94xgzzu1d6Dn7or,1,0,0,0,0,0,1,0,1,0.14285714285714285,1,0.0,0,0,0,0,0,0,0,1,0,0,1,1
10697,188671,AH5OII9dyx9wT5bjdsXGXLQb3KdAdGBY,3VkHkmOtom3jM2wCu94xgzzu1d6Dn7or,4,2,1,0,0,0,3,0,6,0.8571428571428571,1,0.0,0,1,0,0,2,0,0,3,0,1,5,1
10698,188674,maUV1iJW72ILo25uuQHC815ZOBBugLVZ,3VkHkmOtom3jM2wCu94xgzzu1d6Dn7or,4,2,0,0,0,0,2,0,4,0.5714285714285714,1,0.0,0,0,0,0,2,0,0,2,0,0,4,1
10699,188684,CDMI3gQZrAOAZ9Cf4jB5NzA4daPYwjjn,3VkHkmOtom3jM2wCu94xgzzu1d6Dn7or,1,0,0,0,0,0,2,0,2,0.2857142857142857,1,0.0,0,0,0,0,0,0,0,2,0,0,2,1
10700,188690,ewVdenI3ii0QbKb1HvtCMFMP3xCwXPuR,3VkHkmOtom3jM2wCu94xgzzu1d6Dn7or,1,0,0,0,0,0,1,0,1,0.14285714285714285,1,0.0,0,0,0,0,0,0,0,1,0,0,1,1
10701,188692,ixikujvy7OPcGlarThFYWGJcfxiAOSqS,3VkHkmOtom3jM2wCu94xgzzu1d6Dn7or,1,0,0,0,0,0,2,0,2,0.2857142857142857,1,0.0,0,0,0,0,0,0,0,2,0,0,2,1
10702,188693,bFgdU5ETBjM1cv0pmCZmJ30mob6TFCew,3VkHkmOtom3jM2wCu94xgzzu1d6Dn7or,9,13,7,0,4,0,6,0,30,4.285714285714286,1,0.0,0,7,0,4,13,0,0,6,0,11,19,1
10703,188697,pRqPfndktB0iaklPeO3kM9dkkXvJ959B,3VkHkmOtom3jM2wCu94xgzzu1d6Dn7or,1,0,0,0,0,0,1,0,1,0.14285714285714285,1,0.0,0,0,0,0,0,0,0,1,0,0,1,1
10704,188699,5edwsV0rSaO4canq9PmROjVSvIBXaKee,3VkHkmOtom3jM2wCu94xgzzu1d6Dn7or,1,0,0,0,0,0,1,0,1,0.14285714285714285,1,0.0,0,0,0,0,0,0,0,1,0,0,1,1
10705,188700,WJYwHq4MAYpsoxlwld5JmekuEAGtYGxu,3VkHkmOtom3jM2wCu94xgzzu1d6Dn7or,1,0,0,0,0,0,2,0,2,0.2857142857142857,1,0.0,0,0,0,0,0,0,0,2,0,0,2,1
10706,188702,xmBwVbexO2tnK60XF9lhQfssrvUu3EtO,3VkHkmOtom3jM2wCu94xgzzu1d6Dn7or,6,5,3,0,2,0,4,0,14,2.0,1,0.0,0,3,0,2,5,0,0,4,0,5,9,1
10707,188709,gtYDHbXt8R8azkka5kzFsHNwA23A5Hue,3VkHkmOtom3jM2wCu94xgzzu1d6Dn7or,1,0,0,0,0,0,1,0,1,0.14285714285714285,1,0.0,0,0,0,0,0,0,0,1,0,0,1,1
10708,188712,iUkvPv1ADKDFpfINSYIVgOb29QzsFRBv,3VkHkmOtom3jM2wCu94xgzzu1d6Dn7or,18,31,7,24,14,0,7,0,83,11.857142857142858,1,0.0,21,7,18,14,10,0,6,7,0,60,23,1
10709,188713,8VR49myeLl2TVo6pia0O1Ii3XbA9L3S6,3VkHkmOtom3jM2wCu94xgzzu1d6Dn7or,5,4,1,0,2,0,4,0,11,1.5714285714285714,1,0.0,2,1,0,2,2,0,0,4,0,5,6,1
10710,188716,hyhyxhn6qO7nii28PZygBx2DF5Qsnp6b,3VkHkmOtom3jM2wCu94xgzzu1d6Dn7or,15,9,4,12,4,8,2,0,39,5.571428571428571,1,0.0,4,4,11,4,5,8,1,2,0,23,16,1
10711,188717,wqhKrkgXxSAE1Oo3bDIzJT0VXIkqfpG9,3VkHkmOtom3jM2wCu94xgzzu1d6Dn7or,12,25,8,0,1,0,3,0,37,5.285714285714286,1,0.0,0,8,0,1,25,0,0,3,0,9,28,1
10712,188718,QCtfk6tJp7XadjCmtspnvCx7BG9wX5iQ,3VkHkmOtom3jM2wCu94xgzzu1d6Dn7or,6,3,1,0,1,0,9,0,14,2.0,1,0.0,0,1,0,1,3,0,0,9,0,2,12,1
10713,188735,FjtBUAcSkmEqPuMvORlAdNbLQkFsZ2Me,3VkHkmOtom3jM2wCu94xgzzu1d6Dn7or,7,3,1,0,1,0,4,0,9,1.2857142857142858,1,0.0,0,1,0,1,3,0,0,4,0,2,7,1
10714,188736,FUNaelmEa8QQPf1OIStRzYhYYYcyBWNB,3VkHkmOtom3jM2wCu94xgzzu1d6Dn7or,5,2,1,0,1,2,3,1,10,1.4285714285714286,1,0.0,0,1,0,1,2,2,0,3,1,2,8,1
10715,188737,8eK95Lg506H8Frd5DObFf3X5x2dCpTfm,3VkHkmOtom3jM2wCu94xgzzu1d6Dn7or,4,0,0,0,0,1,4,0,5,0.7142857142857143,1,0.0,0,0,0,0,0,1,0,4,0,0,5,1
10716,188747,P70z46uTprZB6z9xVYakXpbukwH7QSkJ,3VkHkmOtom3jM2wCu94xgzzu1d6Dn7or,1,0,0,0,0,0,1,0,1,0.14285714285714285,1,0.0,0,0,0,0,0,0,0,1,0,0,1,1
10717,188750,3tNyA4m16KDqsjcEf4fmjId48Ck65Ay4,3VkHkmOtom3jM2wCu94xgzzu1d6Dn7or,6,5,1,0,2,1,4,1,14,2.0,1,0.0,3,1,0,2,2,1,0,4,1,6,8,1
10718,188756,1hqyThhgIBj0NPMIw4GgUFPsh3dbajdS,3VkHkmOtom3jM2wCu94xgzzu1d6Dn7or,4,2,0,0,1,0,2,0,5,0.7142857142857143,1,0.0,0,0,0,1,2,0,0,2,0,1,4,1
10719,188771,kiLantJiDD44Gb4DDiHa8ctBpYIzNNAl,3VkHkmOtom3jM2wCu94xgzzu1d6Dn7or,1,0,0,0,0,0,2,0,2,0.2857142857142857,1,0.0,0,0,0,0,0,0,0,2,0,0,2,1
10720,188773,GzhPw6gTnuScsMgYuKpeOkfi3m9h7huh,3VkHkmOtom3jM2wCu94xgzzu1d6Dn7or,5,5,2,0,1,0,1,0,9,1.2857142857142858,1,0.0,1,2,0,1,4,0,0,1,0,4,5,1
10721,188776,TK6SHaGDpnyylXHTHrardGGrkWmvQsTG,3VkHkmOtom3jM2wCu94xgzzu1d6Dn7or,7,10,1,0,3,0,2,0,16,2.2857142857142856,1,0.0,0,1,0,3,10,0,0,2,0,4,12,0
10722,188780,Y1hqvH5mAYCdJ0RanCFQwHELZ8kEMEoZ,3VkHkmOtom3jM2wCu94xgzzu1d6Dn7or,1,0,0,0,0,0,1,0,1,0.14285714285714285,1,0.0,0,0,0,0,0,0,0,1,0,0,1,1
10723,188784,rk7MHXhy1HPCViBZ6MqwyHtRLc8mzSRs,3VkHkmOtom3jM2wCu94xgzzu1d6Dn7or,1,0,0,0,0,0,1,0,1,0.14285714285714285,1,0.0,0,0,0,0,0,0,0,1,0,0,1,1
10724,188786,GejrrsPDZacC7IIHMiNBKPgA2uPkulOL,3VkHkmOtom3jM2wCu94xgzzu1d6Dn7or,9,7,2,0,1,1,6,1,18,2.5714285714285716,1,0.0,0,2,0,1,7,1,0,6,1,3,15,1
10725,188789,9zAvIiOTmvwKs5zxDeEGh8xAnj14bMeF,3VkHkmOtom3jM2wCu94xgzzu1d6Dn7or,1,0,0,0,0,0,1,0,1,0.14285714285714285,1,0.0,0,0,0,0,0,0,0,1,0,0,1,1
10726,188791,Wr1EXlwEXZiira3WnrRuVlAZx6ae2UAD,3VkHkmOtom3jM2wCu94xgzzu1d6Dn7or,1,0,0,0,0,0,1,0,1,0.14285714285714285,1,0.0,0,0,0,0,0,0,0,1,0,0,1,1
10727,188796,2IusVSXuZh4ZKixkvvHxyr0x3bM376uT,3VkHkmOtom3jM2wCu94xgzzu1d6Dn7or,1,0,0,0,0,0,1,0,1,0.14285714285714285,1,0.0,0,0,0,0,0,0,0,1,0,0,1,0
10728,188808,NxkMyb1cXhu1RYGIQNAxwZAikxqtRklq,3VkHkmOtom3jM2wCu94xgzzu1d6Dn7or,1,0,0,0,0,0,1,0,1,0.14285714285714285,1,0.0,0,0,0,0,0,0,0,1,0,0,1,1
10729,188843,kmmPSxfhDvRRsDMBheqQFyCMhadkfnef,3VkHkmOtom3jM2wCu94xgzzu1d6Dn7or,1,0,0,0,0,0,1,0,1,0.14285714285714285,1,0.0,0,0,0,0,0,0,0,1,0,0,1,1
10730,188846,I9NL1qTyNfYke8oVwpgv4jZGLSOUwslQ,3VkHkmOtom3jM2wCu94xgzzu1d6Dn7or,1,0,0,0,0,0,1,0,1,0.14285714285714285,1,0.0,0,0,0,0,0,0,0,1,0,0,1,1
10731,188848,Tg9D6IEYNp5BbQ6nAfMOrpQsvaqAV0MU,3VkHkmOtom3jM2wCu94xgzzu1d6Dn7or,4,0,0,0,0,0,3,1,4,0.5714285714285714,1,0.0,0,0,0,0,0,0,0,3,1,0,4,1
10732,188854,7uK5Har2uSZGi9UmezTQ7z0vCs9kGDqJ,3VkHkmOtom3jM2wCu94xgzzu1d6Dn7or,1,0,0,0,0,0,2,0,2,0.2857142857142857,1,0.0,0,0,0,0,0,0,0,2,0,0,2,1
10733,188856,ocD5tMKpDBpYAujAVOgSyUvYv4F4fBmF,3VkHkmOtom3jM2wCu94xgzzu1d6Dn7or,12,21,9,4,7,9,7,1,58,8.285714285714286,2,0.0,8,9,3,7,13,9,1,7,1,27,31,1
10734,188862,IE8AjAMlWpfjXARbWdFfyqNaL0ceGdBs,3VkHkmOtom3jM2wCu94xgzzu1d6Dn7or,1,0,0,0,0,0,1,0,1,0.14285714285714285,1,0.0,0,0,0,0,0,0,0,1,0,0,1,1
10735,188864,NwLvlhItYMV0SldaK6inuNUTu4UFaNjp,3VkHkmOtom3jM2wCu94xgzzu1d6Dn7or,5,2,1,0,1,0,2,0,6,0.8571428571428571,1,0.0,0,1,0,1,2,0,0,2,0,2,4,1
10736,188866,ZTQFYZ2qfDfJQnXGAjW1tyVkHwwdfrmt,3VkHkmOtom3jM2wCu94xgzzu1d6Dn7or,1,0,0,0,0,0,1,0,1,0.14285714285714285,1,0.0,0,0,0,0,0,0,0,1,0,0,1,1
10737,188868,TPDzBQ9rpNjeqli3KFaktTuUnc3ZEdFK,3VkHkmOtom3jM2wCu94xgzzu1d6Dn7or,4,2,1,0,1,0,1,0,5,0.7142857142857143,1,0.0,0,1,0,1,2,0,0,1,0,2,3,1
10738,188871,PHRCx9wyKQjGXWbcIfUScN2q5ez7aVqM,3VkHkmOtom3jM2wCu94xgzzu1d6Dn7or,1,0,0,0,0,0,1,0,1,0.14285714285714285,1,0.0,0,0,0,0,0,0,0,1,0,0,1,1
10739,188873,0Ho4vKPWk3aCMeULKW8jkgKGEXLCR83X,3VkHkmOtom3jM2wCu94xgzzu1d6Dn7or,5,2,1,0,1,0,2,0,6,0.8571428571428571,1,0.0,0,1,0,1,2,0,0,2,0,2,4,1
10740,188877,L39ZdOzVu52b5Nu8u3TuFdomCuDfGlbZ,3VkHkmOtom3jM2wCu94xgzzu1d6Dn7or,9,7,3,0,3,0,2,0,15,2.142857142857143,1,0.0,2,3,0,3,5,0,0,2,0,8,7,1
10741,188878,6qgQAmX6y5wh5nEPRINOiKrZNoTl5yfT,3VkHkmOtom3jM2wCu94xgzzu1d6Dn7or,1,0,0,0,0,0,1,0,1,0.14285714285714285,1,0.0,0,0,0,0,0,0,0,1,0,0,1,1
10742,188880,aA47iNtja2lxoPqFPeHjI7xjYuTmvZjx,3VkHkmOtom3jM2wCu94xgzzu1d6Dn7or,1,0,0,0,0,0,1,0,1,0.14285714285714285,1,0.0,0,0,0,0,0,0,0,1,0,0,1,1
10743,188887,LZWxRbSVnJks5Wtu1M9SRcKFdZS2Pp2o,3VkHkmOtom3jM2wCu94xgzzu1d6Dn7or,1,0,0,0,0,0,1,0,1,0.14285714285714285,1,0.0,0,0,0,0,0,0,0,1,0,0,1,1
10744,188890,ccdfzEdXZgPdB5mpBlvBCguNi5BkPXMi,3VkHkmOtom3jM2wCu94xgzzu1d6Dn7or,9,7,4,0,2,8,3,0,24,3.4285714285714284,1,0.0,1,4,0,2,6,8,0,3,0,7,17,1
10745,188891,OIunh5VlGgmCbVp6rN8NSUpYr9NyGfUf,3VkHkmOtom3jM2wCu94xgzzu1d6Dn7or,1,0,0,0,0,0,1,0,1,0.14285714285714285,1,0.0,0,0,0,0,0,0,0,1,0,0,1,0
10746,188899,lU4swRWZzQKDfCqcF0HkIyAX3M2hMPQF,3VkHkmOtom3jM2wCu94xgzzu1d6Dn7or,2,0,0,0,0,0,2,0,2,0.2857142857142857,1,0.0,0,0,0,0,0,0,0,2,0,0,2,1
10747,188910,E1vVq4GaJ0dO831LRQCFcnkLKgtBE5XJ,3VkHkmOtom3jM2wCu94xgzzu1d6Dn7or,2,0,0,0,0,0,2,0,2,0.2857142857142857,1,0.0,0,0,0,0,0,0,0,2,0,0,2,1
10748,188913,4QSKoi2COLIjISXuWMSgkhYU8OcqVVuy,3VkHkmOtom3jM2wCu94xgzzu1d6Dn7or,3,3,1,0,0,0,6,0,10,1.4285714285714286,1,0.0,0,1,0,0,3,0,0,6,0,1,9,1
10749,188917,doOojwvBSNQrqfeYLOA8pkMINq9DmhqX,5X6FeZozNMgE2VRi3MJYjkkFK8SETtu2,1,0,0,0,0,0,1,0,1,0.14285714285714285,1,0.0,0,0,0,0,0,0,0,1,0,0,1,1
10750,188918,doOojwvBSNQrqfeYLOA8pkMINq9DmhqX,RXDvfPUBYFlVdlueBFbLW0mhhAyGEqpt,1,0,0,0,0,0,1,0,1,0.14285714285714285,1,0.0,0,0,0,0,0,0,0,1,0,0,1,1
10751,188932,DIOAcfUrnrGa4rVzHobRXugj8Ae2jnwK,bWdj2GDclj5ofokWjzoa5jAwMkxCykd6,5,4,1,0,2,0,2,0,9,1.2857142857142858,1,0.0,2,1,0,2,2,0,0,2,0,5,4,0
10752,188937,7gxdF7npc77h7z0KnU9ezGYqtBJqY4fQ,A3fsA9Zfv1X2fVEQhTw51lKENdNrEqT3,1,0,0,0,0,0,1,0,1,0.14285714285714285,1,0.0,0,0,0,0,0,0,0,1,0,0,1,1
10753,188944,Tmy0knxeygbhIfsuJMAS7EjBeIcY7GaB,A3fsA9Zfv1X2fVEQhTw51lKENdNrEqT3,3,2,0,0,0,0,3,0,5,0.7142857142857143,1,0.0,0,0,0,0,2,0,0,3,0,0,5,1
10754,188960,E1o2CPDPeSdQCdvUSK4fkT1XzYkNbbaY,SpATywNh6bZuzm8s1ceuBUnMUAeoAHHw,2,0,0,0,0,0,2,0,2,0.2857142857142857,1,0.0,0,0,0,0,0,0,0,2,0,0,2,1
10755,188961,hlny1PkYo5JEvtbsehOwAyHgv8hye7Vl,bWdj2GDclj5ofokWjzoa5jAwMkxCykd6,4,2,0,0,0,0,4,0,6,0.8571428571428571,1,0.0,0,0,0,0,2,0,0,4,0,0,6,1
10756,188991,UldIL1DzDiptbquy1FtLVqZpU6749Jps,SpATywNh6bZuzm8s1ceuBUnMUAeoAHHw,6,5,3,0,2,0,4,0,14,2.0,2,0.0,0,3,0,2,5,0,0,4,0,5,9,1
10757,188992,wF8DXQdJZv7SZk0nNMRMmcJSgvwpikPR,SpATywNh6bZuzm8s1ceuBUnMUAeoAHHw,3,0,0,0,0,0,3,0,3,0.42857142857142855,1,0.0,0,0,0,0,0,0,0,3,0,0,3,1
10758,189021,RD7hAPb87KYVt93NagDP9Vw7cbq8a6oo,SpATywNh6bZuzm8s1ceuBUnMUAeoAHHw,1,0,0,0,0,0,1,0,1,0.14285714285714285,1,0.0,0,0,0,0,0,0,0,1,0,0,1,1
10759,189022,dNDtzNDGaiacaPHAhGrCyaE0sMH9f5eO,5X6FeZozNMgE2VRi3MJYjkkFK8SETtu2,1,0,0,0,0,0,1,0,1,0.14285714285714285,1,0.0,0,0,0,0,0,0,0,1,0,0,1,1
10760,189030,UcAhBIdVZpMELDlnTcMm9mzDJ1F9Jhg3,RXDvfPUBYFlVdlueBFbLW0mhhAyGEqpt,1,0,0,0,0,0,1,0,1,0.14285714285714285,1,0.0,0,0,0,0,0,0,0,1,0,0,1,1
10761,189048,Lp5Kgg0UtKKwgMnuvlj6sxMiDk9RfZyw,SpATywNh6bZuzm8s1ceuBUnMUAeoAHHw,1,0,0,0,0,0,1,0,1,0.14285714285714285,1,0.0,0,0,0,0,0,0,0,1,0,0,1,1
10762,189057,RZ4LxTkpwGNONWAKNmKhQJBPp4s3H9LB,SpATywNh6bZuzm8s1ceuBUnMUAeoAHHw,1,0,0,0,0,0,2,0,2,0.2857142857142857,1,0.0,0,0,0,0,0,0,0,2,0,0,2,1
10763,189059,RZ4LxTkpwGNONWAKNmKhQJBPp4s3H9LB,G8EPVSXsOYB5YQWZGiz1aVq5Pgr2GrQu,1,0,0,0,0,0,1,0,1,0.14285714285714285,1,0.0,0,0,0,0,0,0,0,1,0,0,1,1
10764,189068,w4jrHVLBGTqYOkQddpvWOsqpbetHaY5D,SpATywNh6bZuzm8s1ceuBUnMUAeoAHHw,17,31,11,18,3,3,4,1,71,10.142857142857142,1,0.0,17,11,15,3,14,3,3,4,1,46,25,0
10765,189070,iXex8IZetCn6l6qnHu5qXE8ueYaXwfDT,SpATywNh6bZuzm8s1ceuBUnMUAeoAHHw,1,0,0,0,0,0,1,0,1,0.14285714285714285,1,0.0,0,0,0,0,0,0,0,1,0,0,1,1
10766,189081,i2raPzmlvNePAOSFdEUwI0BA2bKyQ3vM,A3fsA9Zfv1X2fVEQhTw51lKENdNrEqT3,45,13,7,174,0,0,3,0,197,28.142857142857142,1,0.0,2,7,151,0,11,0,23,3,0,160,37,1
10767,189083,TGFFusA6seimZvuMuvWcJqzDXcH10rby,SpATywNh6bZuzm8s1ceuBUnMUAeoAHHw,24,16,14,0,10,1,7,2,50,7.142857142857143,1,0.0,0,14,0,10,16,1,0,7,2,24,26,1
10768,189093,LZLwXQHuXL4mxhIKYMQYutE6DkMc7FB0,G8EPVSXsOYB5YQWZGiz1aVq5Pgr2GrQu,1,0,0,0,0,0,1,0,1,0.14285714285714285,1,0.0,0,0,0,0,0,0,0,1,0,0,1,1
10769,189096,FlKWU01LZ7CxmzTHmaREVNn6EnjYEnig,SpATywNh6bZuzm8s1ceuBUnMUAeoAHHw,1,0,0,0,0,0,1,0,1,0.14285714285714285,1,0.0,0,0,0,0,0,0,0,1,0,0,1,1
10770,189124,Lhw5SXb7o8NhgmbHuWdhAe4GSQCD0WgZ,bWdj2GDclj5ofokWjzoa5jAwMkxCykd6,7,9,0,0,1,0,2,0,12,1.7142857142857142,1,0.0,0,0,0,1,9,0,0,2,0,1,11,1
10771,189133,uP2tPeEXyIbipoH4RC0lBXHlrPC5xpiE,SpATywNh6bZuzm8s1ceuBUnMUAeoAHHw,6,5,1,0,0,0,2,0,8,1.1428571428571428,1,0.0,0,1,0,0,5,0,0,2,0,1,7,1
10772,189137,NQvU0JScNWPY4La90o9jpHJwL7CcZjuw,RXDvfPUBYFlVdlueBFbLW0mhhAyGEqpt,5,0,0,0,0,1,4,1,6,0.8571428571428571,1,0.0,0,0,0,0,0,1,0,4,1,0,6,1
10773,189138,jiFzFGisDkK72ZBTna8wrY4pq5bLzUOt,SpATywNh6bZuzm8s1ceuBUnMUAeoAHHw,5,8,5,0,1,0,2,0,16,2.2857142857142856,1,0.0,0,5,0,1,8,0,0,2,0,6,10,1
10774,189147,eC4StSuQwImpW962lXYQQlRlP4Dxmsjm,A3fsA9Zfv1X2fVEQhTw51lKENdNrEqT3,2,0,0,0,0,0,2,0,2,0.2857142857142857,1,0.0,0,0,0,0,0,0,0,2,0,0,2,0
10775,189151,6FXn59U6t58D3ljh3ZK4Ravf0jwIveLf,bWdj2GDclj5ofokWjzoa5jAwMkxCykd6,8,13,3,0,2,0,1,0,19,2.7142857142857144,1,0.0,0,3,0,2,13,0,0,1,0,5,14,1
10776,189152,JhlGtzUmqgxqrvs0UEO7cjs9C9vvWlPf,SpATywNh6bZuzm8s1ceuBUnMUAeoAHHw,1,0,0,0,0,0,1,0,1,0.14285714285714285,1,0.0,0,0,0,0,0,0,0,1,0,0,1,0
10777,189153,8AUT1icptxlMHWWQGJy6i9O3KcDsBVE5,G8EPVSXsOYB5YQWZGiz1aVq5Pgr2GrQu,74,58,28,109,23,0,3,0,221,31.571428571428573,2,0.0,30,28,88,23,28,0,21,3,0,169,52,0
10778,189159,XqrZf8R9BrkWGkETcqhxlHJsow5TwWGG,bWdj2GDclj5ofokWjzoa5jAwMkxCykd6,7,4,3,0,2,0,1,0,10,1.4285714285714286,1,0.0,0,3,0,2,4,0,0,1,0,5,5,1
10779,189167,GT5aiFfWe6FLX4vRoPpBADiVr8AYj3lG,SpATywNh6bZuzm8s1ceuBUnMUAeoAHHw,1,0,0,0,0,0,1,0,1,0.14285714285714285,1,0.0,0,0,0,0,0,0,0,1,0,0,1,1
10780,189179,fhmvUcJO8Ug3wTcL8U8JPRrppB0ExD83,G8EPVSXsOYB5YQWZGiz1aVq5Pgr2GrQu,6,4,1,0,1,0,2,0,8,1.1428571428571428,1,0.0,0,1,0,1,4,0,0,2,0,2,6,1
10781,189183,3pKzHjxu581a25exRFFvTyg6nDHF6pVH,G8EPVSXsOYB5YQWZGiz1aVq5Pgr2GrQu,5,2,1,0,1,0,3,0,7,1.0,1,0.0,0,1,0,1,2,0,0,3,0,2,5,1
10782,189189,Qan5qFXAXs8GLcj3GbJmOFAYcVVfTLN4,SpATywNh6bZuzm8s1ceuBUnMUAeoAHHw,9,7,1,0,1,0,2,0,11,1.5714285714285714,1,0.0,0,1,0,1,7,0,0,2,0,2,9,1
10783,189193,GKKsdi3H8EmA2d4Vl6453q5sS4zL8ZEv,RXDvfPUBYFlVdlueBFbLW0mhhAyGEqpt,7,3,2,0,2,0,2,0,9,1.2857142857142858,1,0.0,0,2,0,2,3,0,0,2,0,4,5,1
10784,189198,2CBeSl2j3Y4DT097M7qZQeQSj2yig4c8,SpATywNh6bZuzm8s1ceuBUnMUAeoAHHw,8,8,3,0,2,0,6,0,19,2.7142857142857144,1,0.0,0,3,0,2,8,0,0,6,0,5,14,1
10785,189209,TTnPkHUxPUscUooIZlsVnvEUa4a7xQQH,SpATywNh6bZuzm8s1ceuBUnMUAeoAHHw,2,0,0,0,0,0,3,0,3,0.42857142857142855,1,0.0,0,0,0,0,0,0,0,3,0,0,3,1
10786,189255,YSyQ9QbkilbrIosblzvYwH8g0OB4sSVb,bWdj2GDclj5ofokWjzoa5jAwMkxCykd6,16,11,1,0,1,0,6,1,20,2.857142857142857,1,0.0,0,1,0,1,11,0,0,6,1,2,18,1
10787,189256,lEJmKdFXtAaM5CwkVi4nzr2tROq80rBD,bWdj2GDclj5ofokWjzoa5jAwMkxCykd6,6,9,1,46,2,0,1,0,59,8.428571428571429,1,0.0,5,1,45,2,4,0,1,1,0,53,6,1
10788,189257,fdOB5V1ofn0Ctryb3b7icaPyCY3tS2rV,SpATywNh6bZuzm8s1ceuBUnMUAeoAHHw,4,2,1,0,1,0,1,0,5,0.7142857142857143,1,0.0,0,1,0,1,2,0,0,1,0,2,3,1
10789,189264,cao0jYvVpb9HkTA7b0NC6lvxt4dMGzpm,A3fsA9Zfv1X2fVEQhTw51lKENdNrEqT3,17,13,8,0,6,0,11,0,38,5.428571428571429,2,0.0,1,8,0,6,12,0,0,11,0,15,23,1
10790,189269,srp7eYfIztlS63KDp3UJ1QwZZ188jsNh,SpATywNh6bZuzm8s1ceuBUnMUAeoAHHw,6,2,0,0,0,3,5,0,10,1.4285714285714286,1,0.0,0,0,0,0,2,3,0,5,0,0,10,1
10791,189272,9W6HDa8nbr3i4rkBKbOa5qCJz73HRO2D,A3fsA9Zfv1X2fVEQhTw51lKENdNrEqT3,4,2,1,0,1,0,1,0,5,0.7142857142857143,1,0.0,0,1,0,1,2,0,0,1,0,2,3,1
10792,189282,lw3pe4dKU0kPw4Y2UXHyUqbmb0p06DXW,SpATywNh6bZuzm8s1ceuBUnMUAeoAHHw,4,2,1,0,1,0,1,0,5,0.7142857142857143,1,0.0,0,1,0,1,2,0,0,1,0,2,3,1
10793,189295,BGaRkNhUtySrIq3Ibu2N2S12ZKzZSFdD,SpATywNh6bZuzm8s1ceuBUnMUAeoAHHw,5,2,1,0,1,0,2,0,6,0.8571428571428571,1,0.0,0,1,0,1,2,0,0,2,0,2,4,1
10794,189299,soWKaGVgrPjOXMRfIoHKxglGk54YWoon,RXDvfPUBYFlVdlueBFbLW0mhhAyGEqpt,1,0,0,0,0,0,1,0,1,0.14285714285714285,1,0.0,0,0,0,0,0,0,0,1,0,0,1,1
10795,189301,4D9TO74zb0mHkwi6G9vwCLqeflT8BNm5,bWdj2GDclj5ofokWjzoa5jAwMkxCykd6,8,18,0,0,0,0,1,0,19,2.7142857142857144,1,0.0,7,0,0,0,11,0,0,1,0,7,12,1
10796,189302,sGH3S02gC7Px6nzjUSoCiiPBEx45gkHA,SpATywNh6bZuzm8s1ceuBUnMUAeoAHHw,13,30,9,21,1,1,7,0,69,9.857142857142858,1,0.0,19,9,17,1,11,1,4,7,0,46,23,1
10797,189303,okDiJdSYCcnmEiNK57MM0U050xDu2fc0,A3fsA9Zfv1X2fVEQhTw51lKENdNrEqT3,1,0,0,0,0,0,1,0,1,0.14285714285714285,1,0.0,0,0,0,0,0,0,0,1,0,0,1,1
10798,189331,vDpJXmGOtozpqHHs0yai7muX5WPA1Mg5,A3fsA9Zfv1X2fVEQhTw51lKENdNrEqT3,13,7,6,6,4,0,2,0,25,3.5714285714285716,1,0.0,0,6,4,4,7,0,2,2,0,14,11,1
10799,189356,iNXUknYcsccIKS8GgjuItiXxtSErv2BI,bWdj2GDclj5ofokWjzoa5jAwMkxCykd6,6,6,2,0,2,0,5,0,15,2.142857142857143,1,0.0,0,2,0,2,6,0,0,5,0,4,11,1
10800,189357,RAEoz0HlK4aZohECXgoEPPvL3W03Haej,SpATywNh6bZuzm8s1ceuBUnMUAeoAHHw,1,0,0,0,0,0,1,0,1,0.14285714285714285,1,0.0,0,0,0,0,0,0,0,1,0,0,1,1
10801,189364,iNXUknYcsccIKS8GgjuItiXxtSErv2BI,RXDvfPUBYFlVdlueBFbLW0mhhAyGEqpt,1,0,0,0,0,0,1,0,1,0.14285714285714285,1,0.0,0,0,0,0,0,0,0,1,0,0,1,1
10802,189374,iNXUknYcsccIKS8GgjuItiXxtSErv2BI,A3fsA9Zfv1X2fVEQhTw51lKENdNrEqT3,1,0,0,0,0,0,1,0,1,0.14285714285714285,1,0.0,0,0,0,0,0,0,0,1,0,0,1,1
10803,189379,2d9iCsNXUdh58GWuwVHGi4VtNSaIFub5,G8EPVSXsOYB5YQWZGiz1aVq5Pgr2GrQu,1,0,0,0,0,0,2,0,2,0.2857142857142857,1,0.0,0,0,0,0,0,0,0,2,0,0,2,1
10804,189382,GIjz77vNbkIBUivZosRAJlNv9Kc41Lqw,A3fsA9Zfv1X2fVEQhTw51lKENdNrEqT3,4,4,0,0,0,0,2,0,6,0.8571428571428571,1,0.0,0,0,0,0,4,0,0,2,0,0,6,1
10805,189389,M3Xa5IFPEZiaLK2rAjKqcPYFncjR6IsA,A3fsA9Zfv1X2fVEQhTw51lKENdNrEqT3,1,0,0,0,0,0,1,0,1,0.14285714285714285,1,0.0,0,0,0,0,0,0,0,1,0,0,1,1
10806,189406,7QBOr8vQNdmqK12PreYCHK2joGfp7eda,A3fsA9Zfv1X2fVEQhTw51lKENdNrEqT3,36,37,1,0,1,0,1,0,40,5.714285714285714,1,0.0,0,1,0,1,37,0,0,1,0,2,38,1
10807,189412,B8lBbNEso7Bw3KF9oTlYX1eUGmqw99RL,SpATywNh6bZuzm8s1ceuBUnMUAeoAHHw,5,4,3,0,1,0,2,0,10,1.4285714285714286,1,0.0,0,3,0,1,4,0,0,2,0,4,6,1
10808,189420,H5JmWivBEuiQyOyWOrYCNU3Be4rFy6dH,bWdj2GDclj5ofokWjzoa5jAwMkxCykd6,5,2,1,0,1,0,2,0,6,0.8571428571428571,1,0.0,0,1,0,1,2,0,0,2,0,2,4,1
10809,189421,KVrBjT53dn0E9ztl4DzvpfQ0jHMUCFns,bWdj2GDclj5ofokWjzoa5jAwMkxCykd6,2,0,0,0,0,0,2,0,2,0.2857142857142857,1,0.0,0,0,0,0,0,0,0,2,0,0,2,1
10810,189422,4eCXtsyyVYc5CpMFlWbFuHxZ1fq9frpo,A3fsA9Zfv1X2fVEQhTw51lKENdNrEqT3,4,3,0,0,0,0,1,0,4,0.5714285714285714,1,0.0,0,0,0,0,3,0,0,1,0,0,4,1
10811,189425,6F1lKjGTd159lFhX2roWh19Brj0u4Zbh,bWdj2GDclj5ofokWjzoa5jAwMkxCykd6,1,0,0,0,0,0,1,0,1,0.14285714285714285,1,0.0,0,0,0,0,0,0,0,1,0,0,1,1
10812,189432,0SOdii1K37CAmTEfgyjcBvcmanyXJ8Ed,bWdj2GDclj5ofokWjzoa5jAwMkxCykd6,6,6,3,0,2,5,3,0,19,2.7142857142857144,1,0.0,0,3,0,2,6,5,0,3,0,5,14,0
10813,189434,3ySaApz28mPh4l3lvXUNwK9cjrEIv7NY,SpATywNh6bZuzm8s1ceuBUnMUAeoAHHw,5,2,1,0,1,0,2,0,6,0.8571428571428571,1,0.0,0,1,0,1,2,0,0,2,0,2,4,1
10814,189459,Vjuc4lOMRBvwiori3ErzIlcfC6jawhKl,bWdj2GDclj5ofokWjzoa5jAwMkxCykd6,5,2,1,0,1,0,3,0,7,1.0,1,0.0,0,1,0,1,2,0,0,3,0,2,5,1
10815,189467,4NRVrPg8fVeenBKvYSGTgbBS0wBpQ172,bWdj2GDclj5ofokWjzoa5jAwMkxCykd6,7,3,1,0,2,0,5,0,11,1.5714285714285714,1,0.0,0,1,0,2,3,0,0,5,0,3,8,1
10816,189479,DlLiMWF3t2ouoZLQ2DOZ0noh9g1ImEr6,A3fsA9Zfv1X2fVEQhTw51lKENdNrEqT3,2,0,0,0,0,0,2,0,2,0.2857142857142857,1,0.0,0,0,0,0,0,0,0,2,0,0,2,1
10817,189487,WMNPStbIUatPzq8T7oCOrTnIBPdRdXbh,A3fsA9Zfv1X2fVEQhTw51lKENdNrEqT3,13,5,4,0,4,1,5,1,20,2.857142857142857,1,0.0,0,4,0,4,5,1,0,5,1,8,12,1
10818,189491,19rBJNWc3TdUmLpZx1LViNSUBx0S4WJI,G8EPVSXsOYB5YQWZGiz1aVq5Pgr2GrQu,1,0,0,0,0,0,1,0,1,0.14285714285714285,1,0.0,0,0,0,0,0,0,0,1,0,0,1,1
10819,189492,19rBJNWc3TdUmLpZx1LViNSUBx0S4WJI,SpATywNh6bZuzm8s1ceuBUnMUAeoAHHw,1,0,0,0,0,0,1,0,1,0.14285714285714285,1,0.0,0,0,0,0,0,0,0,1,0,0,1,1
10820,189497,0HWrPPCNu1lUYotaev8lq3oZQkQoCkpc,5X6FeZozNMgE2VRi3MJYjkkFK8SETtu2,1,0,0,0,0,0,1,0,1,0.14285714285714285,1,0.0,0,0,0,0,0,0,0,1,0,0,1,1
10821,189500,woGl9MRnmPfGzBULiB07cKZ8FQbJyr1m,5X6FeZozNMgE2VRi3MJYjkkFK8SETtu2,3,2,1,0,0,0,1,0,4,0.5714285714285714,1,0.0,0,1,0,0,2,0,0,1,0,1,3,1
10822,189532,BqQvzvKumSuXZDEF5Fpfkr95tleas1E0,5X6FeZozNMgE2VRi3MJYjkkFK8SETtu2,1,0,0,0,0,0,1,0,1,0.14285714285714285,1,0.0,0,0,0,0,0,0,0,1,0,0,1,1
10823,189592,0zVXofbZyvquPNH3umVfQBB1jCjNa4CK,5X6FeZozNMgE2VRi3MJYjkkFK8SETtu2,3,5,0,0,2,0,1,0,8,1.1428571428571428,1,0.0,3,0,0,2,2,0,0,1,0,5,3,1
10824,189595,gnDGjS7KmDkjYE8QuMSS8QSW2uwA8L2y,SpATywNh6bZuzm8s1ceuBUnMUAeoAHHw,2,0,0,0,0,0,2,0,2,0.2857142857142857,1,0.0,0,0,0,0,0,0,0,2,0,0,2,1
10825,189609,RQw2G6rRJVyLfkJOWxOXKBvD6FtN7kgk,SpATywNh6bZuzm8s1ceuBUnMUAeoAHHw,15,12,5,14,4,0,2,0,37,5.285714285714286,1,0.0,6,5,14,4,6,0,0,2,0,29,8,1
10826,189632,LA49WpJ5ryi73XGSlYt9JjYZ4H7Zw5cU,A3fsA9Zfv1X2fVEQhTw51lKENdNrEqT3,5,2,1,0,1,0,2,0,6,0.8571428571428571,1,0.0,0,1,0,1,2,0,0,2,0,2,4,1
10827,189654,cGJK6WUVRz0lufneVSDgso7nE70DShof,A3fsA9Zfv1X2fVEQhTw51lKENdNrEqT3,7,4,1,0,1,0,2,0,8,1.1428571428571428,1,0.0,0,1,0,1,4,0,0,2,0,2,6,1
10828,189670,lbgTV2YMskSv2TX4EXpaazpMVWfsftEV,5X6FeZozNMgE2VRi3MJYjkkFK8SETtu2,1,0,0,0,0,0,1,0,1,0.14285714285714285,1,0.0,0,0,0,0,0,0,0,1,0,0,1,1
10829,189676,lbgTV2YMskSv2TX4EXpaazpMVWfsftEV,A3fsA9Zfv1X2fVEQhTw51lKENdNrEqT3,1,0,0,0,0,0,1,0,1,0.14285714285714285,1,0.0,0,0,0,0,0,0,0,1,0,0,1,1
10830,189707,aK3nMtEDxGhnhy1C4yOyjUdvZihlJeoh,5X6FeZozNMgE2VRi3MJYjkkFK8SETtu2,1,0,0,0,0,0,1,0,1,0.14285714285714285,1,0.0,0,0,0,0,0,0,0,1,0,0,1,1
10831,189764,WIulMAW8PLfyLvnliYk0w4Xs9IJHKZPS,A3fsA9Zfv1X2fVEQhTw51lKENdNrEqT3,3,2,1,0,0,0,2,0,5,0.7142857142857143,1,0.0,0,1,0,0,2,0,0,2,0,1,4,1
10832,189769,ePLNZPT7XvGhj7aq3pFVjN8dQAsiG3MM,A3fsA9Zfv1X2fVEQhTw51lKENdNrEqT3,2,0,0,0,0,0,2,0,2,0.2857142857142857,1,0.0,0,0,0,0,0,0,0,2,0,0,2,1
10833,189792,tr8E6i6LhPPOpsyObFM4xo1Myl86ILao,A3fsA9Zfv1X2fVEQhTw51lKENdNrEqT3,1,0,0,0,0,0,2,0,2,0.2857142857142857,1,0.0,0,0,0,0,0,0,0,2,0,0,2,1
10834,189826,KEk12K18LvElqA3IQG2ElnZLz0pGsTjq,5X6FeZozNMgE2VRi3MJYjkkFK8SETtu2,7,2,1,0,1,0,5,1,10,1.4285714285714286,1,0.0,0,1,0,1,2,0,0,5,1,2,8,1
10835,189833,KKg2SEYEtAkOTNFOSVRP4B0sBYB2AxaX,A3fsA9Zfv1X2fVEQhTw51lKENdNrEqT3,2,0,0,0,0,0,2,0,2,0.2857142857142857,1,0.0,0,0,0,0,0,0,0,2,0,0,2,1
10836,189864,bcTZMZYhsyC9adGaewxs0JBBtqf2gnyH,A3fsA9Zfv1X2fVEQhTw51lKENdNrEqT3,1,0,0,0,0,0,2,0,2,0.2857142857142857,1,0.0,0,0,0,0,0,0,0,2,0,0,2,1
10837,189888,DoaK2UVwvFXvAUAGvwGn2NA7BHsJAQZU,5X6FeZozNMgE2VRi3MJYjkkFK8SETtu2,9,14,1,0,4,0,3,0,22,3.142857142857143,1,0.0,11,1,0,4,3,0,0,3,0,16,6,1
10838,189906,DoaK2UVwvFXvAUAGvwGn2NA7BHsJAQZU,A3fsA9Zfv1X2fVEQhTw51lKENdNrEqT3,6,5,1,0,1,0,1,0,8,1.1428571428571428,1,0.0,0,1,0,1,5,0,0,1,0,2,6,0
10839,189943,7SqBNF8tWHSVbvlzM0EEAveq7vc9hOK8,5X6FeZozNMgE2VRi3MJYjkkFK8SETtu2,1,0,0,0,0,0,1,0,1,0.14285714285714285,1,0.0,0,0,0,0,0,0,0,1,0,0,1,1
10840,189988,tMNGYXIFQLxoZULQtNFAcBIfN5Bk8aTB,5X6FeZozNMgE2VRi3MJYjkkFK8SETtu2,13,34,3,0,7,0,4,1,49,7.0,1,0.0,22,3,0,7,12,0,0,4,1,32,17,1
10841,190002,ssd9DBMazioObXDaMrlUaff0ISIOtfor,5X6FeZozNMgE2VRi3MJYjkkFK8SETtu2,1,0,0,0,0,0,1,0,1,0.14285714285714285,1,0.0,0,0,0,0,0,0,0,1,0,0,1,1
10842,190102,AFgfNSPXxfZS0fJBrV7ZCry6ugLF8Vil,5X6FeZozNMgE2VRi3MJYjkkFK8SETtu2,1,0,0,0,0,0,1,0,1,0.14285714285714285,1,0.0,0,0,0,0,0,0,0,1,0,0,1,1
10843,190113,52eWD8FszxThY7ZZwdN5O4pas8m2gOZa,A3fsA9Zfv1X2fVEQhTw51lKENdNrEqT3,2,0,0,0,0,0,2,0,2,0.2857142857142857,1,0.0,0,0,0,0,0,0,0,2,0,0,2,0
10844,190150,md7xbvlSHLf3epPtrSenVRhvJISfWAAm,5X6FeZozNMgE2VRi3MJYjkkFK8SETtu2,9,6,1,7,3,0,1,0,18,2.5714285714285716,1,0.0,4,1,7,3,2,0,0,1,0,15,3,1
10845,190257,zvFl2xbV1FDOZwlXYqwJEiTk3EJ0H3Ku,3VkHkmOtom3jM2wCu94xgzzu1d6Dn7or,10,36,5,7,7,7,5,0,67,9.571428571428571,2,0.0,18,5,6,7,18,7,1,5,0,36,31,0
10846,190258,y8AdDSbHENRUD5ii0AuyONW5YY98sBlv,3VkHkmOtom3jM2wCu94xgzzu1d6Dn7or,2,0,0,0,0,0,2,0,2,0.2857142857142857,1,0.0,0,0,0,0,0,0,0,2,0,0,2,1
10847,190284,dw8tMVklgTZK6yDEDAM53OLtjt74HfnR,3VkHkmOtom3jM2wCu94xgzzu1d6Dn7or,4,2,1,0,1,0,2,0,6,0.8571428571428571,1,0.0,0,1,0,1,2,0,0,2,0,2,4,1
10848,190297,dNTZaahqzSBVnWMfb53XFlPZEDPY7jN3,3VkHkmOtom3jM2wCu94xgzzu1d6Dn7or,1,0,0,0,0,0,1,0,1,0.14285714285714285,1,0.0,0,0,0,0,0,0,0,1,0,0,1,1
10849,190326,MChVXa58KVwLwh1inhjdLaJbhU8LqtVW,3VkHkmOtom3jM2wCu94xgzzu1d6Dn7or,5,2,1,0,1,0,2,0,6,0.8571428571428571,1,0.0,0,1,0,1,2,0,0,2,0,2,4,1
10850,190332,6qyOu6a23ro8NiGec29aclYqyemAuAC1,3VkHkmOtom3jM2wCu94xgzzu1d6Dn7or,1,0,0,0,0,0,1,0,1,0.14285714285714285,1,0.0,0,0,0,0,0,0,0,1,0,0,1,1
10851,190333,MbwtI5alasJpU6rlek0scYnNjeDrIyEk,3VkHkmOtom3jM2wCu94xgzzu1d6Dn7or,5,5,0,0,0,1,5,0,11,1.5714285714285714,1,0.0,0,0,0,0,5,1,0,5,0,0,11,1
10852,190342,qIpGIJgJ2NoD1KhKkHYicu6I3IkoWWHY,3VkHkmOtom3jM2wCu94xgzzu1d6Dn7or,12,18,5,6,4,5,5,0,43,6.142857142857143,1,0.0,7,5,5,4,11,5,1,5,0,21,22,1
10853,190345,VbUCl4iA8O7xDz2e4nkyMMNjUwdwgHqn,3VkHkmOtom3jM2wCu94xgzzu1d6Dn7or,2,0,0,0,0,0,2,0,2,0.2857142857142857,1,0.0,0,0,0,0,0,0,0,2,0,0,2,1
10854,190370,2DweV3nINIltWC9fnAUkPKGXug65CERV,3VkHkmOtom3jM2wCu94xgzzu1d6Dn7or,5,5,2,0,1,0,1,0,9,1.2857142857142858,1,0.0,0,2,0,1,5,0,0,1,0,3,6,1
10855,190417,JxL0beXmco8r7lmteTLi8F2omNHEl2Ca,3VkHkmOtom3jM2wCu94xgzzu1d6Dn7or,1,0,0,0,0,0,1,0,1,0.14285714285714285,1,0.0,0,0,0,0,0,0,0,1,0,0,1,1
10856,190418,R2SrWNn6mywF5ut4DLl2r23knmfOF8gl,3VkHkmOtom3jM2wCu94xgzzu1d6Dn7or,7,3,2,0,2,0,2,0,9,1.2857142857142858,1,0.0,0,2,0,2,3,0,0,2,0,4,5,1
10857,190424,H683tMkQp6lFNh1xHTfMz81b5h1W7bC1,3VkHkmOtom3jM2wCu94xgzzu1d6Dn7or,1,0,0,0,0,0,1,0,1,0.14285714285714285,1,0.0,0,0,0,0,0,0,0,1,0,0,1,1
10858,190430,loPOLtsDP2ydmPK7rtuitDNSeKzIMLm2,3VkHkmOtom3jM2wCu94xgzzu1d6Dn7or,4,1,0,0,0,0,3,0,4,0.5714285714285714,1,0.0,0,0,0,0,1,0,0,3,0,0,4,1
10859,190435,QJnyVFXd0gewIQHEbdl6ZVpX79Gmgasm,3VkHkmOtom3jM2wCu94xgzzu1d6Dn7or,44,99,46,0,27,0,16,1,189,27.0,4,0.0,32,46,0,27,67,0,0,16,1,105,84,1
10860,190445,0LXJzqROabJZv3y6yW15E1KiOEkZJTqc,3VkHkmOtom3jM2wCu94xgzzu1d6Dn7or,1,0,0,0,0,0,1,0,1,0.14285714285714285,1,0.0,0,0,0,0,0,0,0,1,0,0,1,1
10861,190456,c0a5kgsgAaSlwSloByZTtqyb6w7GEpak,3VkHkmOtom3jM2wCu94xgzzu1d6Dn7or,6,10,5,0,1,0,3,0,19,2.7142857142857144,1,0.0,3,5,0,1,7,0,0,3,0,9,10,1
10862,190480,62BMeX44VT70sf5SmXhoPpud5koFI3Y8,3VkHkmOtom3jM2wCu94xgzzu1d6Dn7or,1,0,0,0,0,0,2,0,2,0.2857142857142857,1,0.0,0,0,0,0,0,0,0,2,0,0,2,1
10863,190490,xcQasYYe4RsxBoKdrpzhKbDwJF62kZfD,3VkHkmOtom3jM2wCu94xgzzu1d6Dn7or,9,13,4,0,3,0,8,3,31,4.428571428571429,1,0.0,4,4,0,3,9,0,0,8,3,11,20,1
10864,190496,apI7ugJ7I4oLyRGiE161nPDFka4wT5xj,3VkHkmOtom3jM2wCu94xgzzu1d6Dn7or,1,0,0,0,0,0,1,0,1,0.14285714285714285,1,0.0,0,0,0,0,0,0,0,1,0,0,1,1
10865,190510,DGlEyZ0IT4AVA28J85yTcLFtD1UWpsA2,3VkHkmOtom3jM2wCu94xgzzu1d6Dn7or,1,0,0,0,0,0,1,0,1,0.14285714285714285,1,0.0,0,0,0,0,0,0,0,1,0,0,1,1
10866,190516,AqFTP9I95DGAQHiCZtkhxV5lY98NglUH,3VkHkmOtom3jM2wCu94xgzzu1d6Dn7or,9,5,3,0,3,0,4,1,16,2.2857142857142856,1,0.0,1,3,0,3,4,0,0,4,1,7,9,1
10867,190572,LJtcyB32ET1GtKC2SiNyWCb0ttB0fxR3,3VkHkmOtom3jM2wCu94xgzzu1d6Dn7or,7,3,2,0,2,0,3,0,10,1.4285714285714286,1,0.0,0,2,0,2,3,0,0,3,0,4,6,1
10868,190573,WYMTvSSRESaPrlMQXdF4tHfJAYTGFy2A,3VkHkmOtom3jM2wCu94xgzzu1d6Dn7or,2,0,0,0,0,0,2,0,2,0.2857142857142857,1,0.0,0,0,0,0,0,0,0,2,0,0,2,1
10869,190576,k512uodHIm7vMzP162z7tWUxDo7wSSdV,3VkHkmOtom3jM2wCu94xgzzu1d6Dn7or,5,2,1,0,1,0,4,0,8,1.1428571428571428,1,0.0,0,1,0,1,2,0,0,4,0,2,6,1
10870,190583,O8CiMquiVqY3DsyFgTSidDZpnZqdb7Xw,3VkHkmOtom3jM2wCu94xgzzu1d6Dn7or,6,10,1,4,4,1,3,0,23,3.2857142857142856,1,0.0,8,1,3,4,2,1,1,3,0,16,7,1
10871,190611,Y3qAEqzdKJewEkb06n8n2BrJMQzX9urI,3VkHkmOtom3jM2wCu94xgzzu1d6Dn7or,11,5,4,0,4,0,2,0,15,2.142857142857143,1,0.0,0,4,0,4,5,0,0,2,0,8,7,1
10872,190612,jeG7y0hvrnn7zXO893BycRsX9A48NzFD,3VkHkmOtom3jM2wCu94xgzzu1d6Dn7or,1,0,0,0,0,0,1,0,1,0.14285714285714285,1,0.0,0,0,0,0,0,0,0,1,0,0,1,1
10873,190617,KeUmbPeTRA1tmaXd5yuyowyu7cYy5FFN,3VkHkmOtom3jM2wCu94xgzzu1d6Dn7or,1,0,0,0,0,0,1,0,1,0.14285714285714285,1,0.0,0,0,0,0,0,0,0,1,0,0,1,1
10874,190623,tOrDJhbY0ZFR5K4cuMyBpfcNgbvhflbB,3VkHkmOtom3jM2wCu94xgzzu1d6Dn7or,10,16,5,0,4,0,6,0,31,4.428571428571429,1,0.0,5,5,0,4,11,0,0,6,0,14,17,1
10875,190639,Xs00fMQ3BnlIPKFHWCmFrk4I1ISaB7lE,3VkHkmOtom3jM2wCu94xgzzu1d6Dn7or,4,5,1,0,1,0,2,0,9,1.2857142857142858,1,0.0,3,1,0,1,2,0,0,2,0,5,4,1
10876,190642,7hekvV8SH4NkArxoIuWJ5d0sFbDCsYHf,3VkHkmOtom3jM2wCu94xgzzu1d6Dn7or,4,2,1,0,1,0,1,0,5,0.7142857142857143,1,0.0,0,1,0,1,2,0,0,1,0,2,3,1
10877,190656,vs46hPMjy0xWIeJb83l7XTvnDGw8VihI,3VkHkmOtom3jM2wCu94xgzzu1d6Dn7or,1,0,0,0,0,0,1,0,1,0.14285714285714285,1,0.0,0,0,0,0,0,0,0,1,0,0,1,1
10878,190668,bXtEPDfsfKZsqSp6hSciQQ8xxWbvrnfw,3VkHkmOtom3jM2wCu94xgzzu1d6Dn7or,1,0,0,0,0,0,1,0,1,0.14285714285714285,1,0.0,0,0,0,0,0,0,0,1,0,0,1,1
10879,190678,M3IgJFMjL43O6e0cctabP91ddooPQjMV,3VkHkmOtom3jM2wCu94xgzzu1d6Dn7or,7,3,2,0,2,0,3,0,10,1.4285714285714286,2,0.0,0,2,0,2,3,0,0,3,0,4,6,1
10880,190703,BPA9qiiC8H1g3hvpNyl77OvcydP8kn0Y,3VkHkmOtom3jM2wCu94xgzzu1d6Dn7or,1,0,0,0,0,0,1,0,1,0.14285714285714285,1,0.0,0,0,0,0,0,0,0,1,0,0,1,1
10881,190709,x8IFjwCPBRlQP9uuBa1tGX8WpsXCLtes,3VkHkmOtom3jM2wCu94xgzzu1d6Dn7or,5,2,1,0,1,0,2,0,6,0.8571428571428571,1,0.0,0,1,0,1,2,0,0,2,0,2,4,1
10882,192608,AtRokE4GDbrwUzcYfXIbPzAJVRCFfH2F,5Gyp41oLVo7Gg7vF4vpmggWP5MU70QO6,6,1,0,0,0,0,4,1,6,0.8571428571428571,1,0.0,0,0,0,0,1,0,0,4,1,0,6,1
10883,192611,hR3J4g4CWV0kw2ppP2PV2tproNTGcv00,5Gyp41oLVo7Gg7vF4vpmggWP5MU70QO6,1,0,0,0,0,0,1,0,1,0.14285714285714285,1,0.0,0,0,0,0,0,0,0,1,0,0,1,1
10884,192618,Hdpd6bzDCatISjYMgNGeGrNyuK5a6mdg,5Gyp41oLVo7Gg7vF4vpmggWP5MU70QO6,15,8,5,0,4,3,9,1,30,4.285714285714286,1,0.0,0,5,0,4,8,3,0,9,1,9,21,1
10885,192621,6rn8acWWEVJB1wj5sL8CHB7CjvoRuE9n,5Gyp41oLVo7Gg7vF4vpmggWP5MU70QO6,8,3,2,0,2,0,5,1,13,1.8571428571428572,1,0.0,0,2,0,2,3,0,0,5,1,4,9,0
10886,192635,QqE2Xjwy9gUzOvFdkDqAwAaNZLBZkxvd,5Gyp41oLVo7Gg7vF4vpmggWP5MU70QO6,9,5,4,2,1,0,3,0,15,2.142857142857143,1,0.0,0,4,1,1,5,0,1,3,0,6,9,0
10887,192653,WWuaVOQg6HhBy3ZFrwNxYOemRizkw0Iz,5Gyp41oLVo7Gg7vF4vpmggWP5MU70QO6,1,0,0,0,0,0,1,0,1,0.14285714285714285,1,0.0,0,0,0,0,0,0,0,1,0,0,1,1
10888,192669,yD8ecTJ7efEF8WUp9kS25bxSOmV2HnI4,5Gyp41oLVo7Gg7vF4vpmggWP5MU70QO6,6,4,2,0,1,0,3,0,10,1.4285714285714286,2,0.0,0,2,0,1,4,0,0,3,0,3,7,1
10889,192672,TM2Fpf08RSPSZPzEL6NnBreog7ZJPXLB,5Gyp41oLVo7Gg7vF4vpmggWP5MU70QO6,1,0,0,0,0,0,1,0,1,0.14285714285714285,1,0.0,0,0,0,0,0,0,0,1,0,0,1,1
10890,192685,qKfZusm0R8jxltESvgi15dswdw73Gjlp,5Gyp41oLVo7Gg7vF4vpmggWP5MU70QO6,5,2,0,0,0,0,6,0,8,1.1428571428571428,1,0.0,0,0,0,0,2,0,0,6,0,0,8,1
10891,192687,BaBxjEn3TWZ4ftqH98jukKacUK8Z3SVk,5Gyp41oLVo7Gg7vF4vpmggWP5MU70QO6,15,9,7,4,5,0,4,1,30,4.285714285714286,1,0.0,1,7,2,5,8,0,2,4,1,15,15,0
10892,192689,H0MJ7AKLplt2875eLTSZVcXjiXyvHgre,5Gyp41oLVo7Gg7vF4vpmggWP5MU70QO6,7,3,2,0,2,0,2,0,9,1.2857142857142858,1,0.0,0,2,0,2,3,0,0,2,0,4,5,1
10893,192698,dpqC9YadgyW7gCDeIWoSIw8EG62mjzEg,5Gyp41oLVo7Gg7vF4vpmggWP5MU70QO6,10,14,6,4,3,1,2,0,30,4.285714285714286,1,0.0,5,6,2,3,9,1,2,2,0,16,14,1
10894,192700,8cEAUyffHekiZonoKVizh2shGTTIPP8A,5Gyp41oLVo7Gg7vF4vpmggWP5MU70QO6,5,2,1,0,1,0,2,0,6,0.8571428571428571,1,0.0,0,1,0,1,2,0,0,2,0,2,4,1
10895,192703,5h0eNQUncseSZepOFk4gJvoXA1BGcdoJ,5Gyp41oLVo7Gg7vF4vpmggWP5MU70QO6,1,0,0,0,0,0,1,0,1,0.14285714285714285,1,0.0,0,0,0,0,0,0,0,1,0,0,1,1
10896,192705,dxoTIhhPXBvqzWGLltH0slJdxsuyggjI,5Gyp41oLVo7Gg7vF4vpmggWP5MU70QO6,12,5,4,0,3,1,7,1,21,3.0,1,0.0,0,4,0,3,5,1,0,7,1,7,14,1
10897,192712,Smn1MChtzRnNQ2E4yTX9A4LeqmiYYAht,5Gyp41oLVo7Gg7vF4vpmggWP5MU70QO6,13,20,12,0,4,3,2,0,41,5.857142857142857,2,0.0,3,12,0,4,17,3,0,2,0,19,22,0
10898,192728,2Jf50aD58DLzicIOj7SRGccbiA42og4q,5Gyp41oLVo7Gg7vF4vpmggWP5MU70QO6,1,0,0,0,0,0,1,0,1,0.14285714285714285,1,0.0,0,0,0,0,0,0,0,1,0,0,1,1
10899,192735,YdnCtrLP9GUJwqLsBYf5xSwhPg8uPY72,5Gyp41oLVo7Gg7vF4vpmggWP5MU70QO6,2,0,0,0,0,0,2,0,2,0.2857142857142857,1,0.0,0,0,0,0,0,0,0,2,0,0,2,1
10900,192739,a1GIHlsXZFLe52epzSYGPqZ9rbdKGCBc,5Gyp41oLVo7Gg7vF4vpmggWP5MU70QO6,1,0,0,0,0,0,1,0,1,0.14285714285714285,1,0.0,0,0,0,0,0,0,0,1,0,0,1,1
10901,192743,uPHW5wVLJNc5tDPULVOENFWqjj5oTiX0,5Gyp41oLVo7Gg7vF4vpmggWP5MU70QO6,7,3,2,0,2,0,2,0,9,1.2857142857142858,1,0.0,0,2,0,2,3,0,0,2,0,4,5,1
10902,192745,PFladZHBxKsed81P3VF9JVKRBqF9WnYc,5Gyp41oLVo7Gg7vF4vpmggWP5MU70QO6,4,2,1,0,1,0,1,0,5,0.7142857142857143,1,0.0,0,1,0,1,2,0,0,1,0,2,3,1
10903,192758,mSuKGDVu6gs94ljVjWxUojLXXzI5hNOJ,5Gyp41oLVo7Gg7vF4vpmggWP5MU70QO6,27,24,12,13,7,0,3,0,59,8.428571428571429,2,0.0,8,12,8,7,16,0,5,3,0,35,24,1
10904,192759,Lea0U9bXVEWulrpNxb4hDrvkTD6jg3Lj,5Gyp41oLVo7Gg7vF4vpmggWP5MU70QO6,1,0,0,0,0,0,1,0,1,0.14285714285714285,1,0.0,0,0,0,0,0,0,0,1,0,0,1,1
10905,192760,j2usIry8ZvUv4bPkmxlIEr6D1gomHwky,5Gyp41oLVo7Gg7vF4vpmggWP5MU70QO6,9,3,3,0,2,0,4,0,12,1.7142857142857142,1,0.0,0,3,0,2,3,0,0,4,0,5,7,1
10906,192767,XyCz9sIvXJKdwW6DgXAsYNle3ywHbak8,5Gyp41oLVo7Gg7vF4vpmggWP5MU70QO6,7,5,3,0,3,2,2,0,15,2.142857142857143,1,0.0,0,3,0,3,5,2,0,2,0,6,9,1
10907,192773,GkPLpUCCpkc2alGCrZy2giSAHb58J7uB,5Gyp41oLVo7Gg7vF4vpmggWP5MU70QO6,1,0,0,0,0,0,1,0,1,0.14285714285714285,1,0.0,0,0,0,0,0,0,0,1,0,0,1,1
10908,192778,gfBqAJTwMxnGPgiW2oi2HY9LjOcodQEb,5Gyp41oLVo7Gg7vF4vpmggWP5MU70QO6,9,10,3,2,1,0,4,0,20,2.857142857142857,2,0.0,3,3,1,1,7,0,1,4,0,8,12,1
10909,192789,XK5ibrlt4r927TMtcgDDQkno4bFkmpOe,5Gyp41oLVo7Gg7vF4vpmggWP5MU70QO6,8,4,3,0,2,0,3,0,12,1.7142857142857142,1,0.0,0,3,0,2,4,0,0,3,0,5,7,1
10910,192801,VoCeELY2B10ZxPnycmfwdy7Iipalm81O,5Gyp41oLVo7Gg7vF4vpmggWP5MU70QO6,31,64,35,14,20,4,6,2,145,20.714285714285715,2,0.0,20,35,7,20,44,4,7,6,2,82,63,1
10911,192809,TDZqTAe3O03535EQlgLT4WJkveLsaPmx,5Gyp41oLVo7Gg7vF4vpmggWP5MU70QO6,1,0,0,0,0,0,1,0,1,0.14285714285714285,1,0.0,0,0,0,0,0,0,0,1,0,0,1,1
10912,192813,uk7zjDjpWmKoLR9S44KNj1ZRmbxgLrs3,5Gyp41oLVo7Gg7vF4vpmggWP5MU70QO6,1,0,0,0,0,0,1,0,1,0.14285714285714285,1,0.0,0,0,0,0,0,0,0,1,0,0,1,1
10913,192819,bGF8cbH8BJ9hFpv4F5nJ920V3rhyfd17,5Gyp41oLVo7Gg7vF4vpmggWP5MU70QO6,1,0,0,0,0,0,1,0,1,0.14285714285714285,1,0.0,0,0,0,0,0,0,0,1,0,0,1,1
10914,192827,k3mZz4gOE5kxngWJdlg5ZkSuFCPjQxmM,5Gyp41oLVo7Gg7vF4vpmggWP5MU70QO6,7,3,2,0,1,1,3,0,10,1.4285714285714286,1,0.0,1,2,0,1,2,1,0,3,0,4,6,1
10915,192841,R1hDC0cia7W4HzRH6KVPETOXYR9pY6fa,5Gyp41oLVo7Gg7vF4vpmggWP5MU70QO6,15,12,6,4,2,1,6,1,32,4.571428571428571,1,0.0,5,6,2,2,7,1,2,6,1,15,17,1
10916,192847,r9GPeMSp8ArkFnDWYZc9RWiHGAvx3pnQ,5Gyp41oLVo7Gg7vF4vpmggWP5MU70QO6,8,4,2,0,2,0,2,0,10,1.4285714285714286,1,0.0,0,2,0,2,4,0,0,2,0,4,6,1
10917,192860,pOasjcwsDcPzSLMZe3AyFjlAlgIAU2Vb,5Gyp41oLVo7Gg7vF4vpmggWP5MU70QO6,7,3,2,0,2,0,2,0,9,1.2857142857142858,1,0.0,0,2,0,2,3,0,0,2,0,4,5,1
10918,192861,f3sQizxMrZs3wFlm48Xbvnvm8a8gj3sD,5Gyp41oLVo7Gg7vF4vpmggWP5MU70QO6,1,0,0,0,0,0,1,0,1,0.14285714285714285,1,0.0,0,0,0,0,0,0,0,1,0,0,1,1
10919,192908,yiOczBli0rC8Wbolg7ti038mY6lEjUw2,5Gyp41oLVo7Gg7vF4vpmggWP5MU70QO6,7,2,1,0,1,0,5,0,9,1.2857142857142858,1,0.0,0,1,0,1,2,0,0,5,0,2,7,1
10920,192914,WTBW2I80UCafy13vO1xmvJy7d87UvlCP,5Gyp41oLVo7Gg7vF4vpmggWP5MU70QO6,13,11,7,0,4,0,10,0,32,4.571428571428571,1,0.0,0,7,0,4,11,0,0,10,0,11,21,1
10921,192915,YNemkS5dqknHOwehYprPYVkMaqYUO4yA,5Gyp41oLVo7Gg7vF4vpmggWP5MU70QO6,2,0,0,0,0,0,2,0,2,0.2857142857142857,1,0.0,0,0,0,0,0,0,0,2,0,0,2,1
10922,192928,0w8w9MF5tkQU4k0FklIWTLSzbCs1BbZq,5Gyp41oLVo7Gg7vF4vpmggWP5MU70QO6,6,3,1,0,1,2,2,0,9,1.2857142857142858,1,0.0,0,1,0,1,3,2,0,2,0,2,7,1
10923,192953,7lHUJOfOLogRPjLmWkj5y0cgqgu81QwU,5Gyp41oLVo7Gg7vF4vpmggWP5MU70QO6,5,2,0,0,1,0,2,0,5,0.7142857142857143,1,0.0,0,0,0,1,2,0,0,2,0,1,4,1
10924,192959,vcvYL1EZ3hhS8Gh2fPMFYiG1tqg8IKqj,5Gyp41oLVo7Gg7vF4vpmggWP5MU70QO6,10,4,3,0,3,0,7,1,18,2.5714285714285716,1,0.0,0,3,0,3,4,0,0,7,1,6,12,1
10925,192969,dtWMunkwGsNaaLF3lUUY2CJ5PD5WpamE,5Gyp41oLVo7Gg7vF4vpmggWP5MU70QO6,1,0,0,0,0,0,1,0,1,0.14285714285714285,1,0.0,0,0,0,0,0,0,0,1,0,0,1,1
10926,192974,UKBd2uWp6PbjrF0GpeV8V02oqrWC2EWf,5Gyp41oLVo7Gg7vF4vpmggWP5MU70QO6,1,0,0,0,0,0,1,0,1,0.14285714285714285,1,0.0,0,0,0,0,0,0,0,1,0,0,1,1
10927,192990,mpIXHW5sILjjHOwn1u3NkBPJs6lkxDFU,5Gyp41oLVo7Gg7vF4vpmggWP5MU70QO6,1,0,0,0,0,0,2,0,2,0.2857142857142857,1,0.0,0,0,0,0,0,0,0,2,0,0,2,1
10928,192992,1WyvYbGYcrBNj0UGmeuwJim5C3F4cN0m,5Gyp41oLVo7Gg7vF4vpmggWP5MU70QO6,1,0,0,0,0,0,1,0,1,0.14285714285714285,1,0.0,0,0,0,0,0,0,0,1,0,0,1,1
10929,192999,f3YcaJisiu4LNXF8c0nltyQqDOirQ4G3,5Gyp41oLVo7Gg7vF4vpmggWP5MU70QO6,1,0,0,0,0,0,1,0,1,0.14285714285714285,1,0.0,0,0,0,0,0,0,0,1,0,0,1,1
10930,193002,YPkNnlZCzgNSMkr7FjmvOjfpED2o7pKl,5Gyp41oLVo7Gg7vF4vpmggWP5MU70QO6,10,10,4,0,3,4,6,1,28,4.0,1,0.0,0,4,0,3,10,4,0,6,1,7,21,1
10931,193011,xMsPJWz0XQaXvtzEWSRadnhqGEGgxzXP,5Gyp41oLVo7Gg7vF4vpmggWP5MU70QO6,1,0,0,0,0,0,1,0,1,0.14285714285714285,1,0.0,0,0,0,0,0,0,0,1,0,0,1,1
10932,193019,zdzq2oGGblOk5DNSyuiTttgeRbYjL1G9,5Gyp41oLVo7Gg7vF4vpmggWP5MU70QO6,4,0,0,0,0,0,5,0,5,0.7142857142857143,1,0.0,0,0,0,0,0,0,0,5,0,0,5,1
10933,193394,7zYK7nycfEobBL6khQbiClw4A0srgSFs,7GRhBDsirIGkRZBtSMEzNTyDr2JQm4xx,4,4,1,0,0,0,2,0,7,1.0,1,0.0,0,1,0,0,4,0,0,2,0,1,6,1
10934,193399,4KdAT7M1VmdgpSbZAwhIRRtGiw5j0Hwv,7GRhBDsirIGkRZBtSMEzNTyDr2JQm4xx,9,4,3,0,3,0,2,0,12,1.7142857142857142,1,0.0,0,3,0,3,4,0,0,2,0,6,6,1
10935,193415,GAlVju2FoaeKDXk3BG43v2DrV3UNel1E,7GRhBDsirIGkRZBtSMEzNTyDr2JQm4xx,1,0,0,0,0,0,2,0,2,0.2857142857142857,1,0.0,0,0,0,0,0,0,0,2,0,0,2,1
10936,193417,C3Ny6KS3sMtxeuVMnHyYboSejjiB2Wof,7GRhBDsirIGkRZBtSMEzNTyDr2JQm4xx,2,0,0,0,0,0,3,0,3,0.42857142857142855,1,0.0,0,0,0,0,0,0,0,3,0,0,3,1
10937,193419,IKspHwTheoQBPhrwL8GRQAw1d4UBmXld,7GRhBDsirIGkRZBtSMEzNTyDr2JQm4xx,2,0,0,0,0,0,2,0,2,0.2857142857142857,1,0.0,0,0,0,0,0,0,0,2,0,0,2,0
10938,193430,6W0BpjkpO0dAMGUgwI3l3rChjx6l5wlj,7GRhBDsirIGkRZBtSMEzNTyDr2JQm4xx,1,0,0,0,0,0,1,0,1,0.14285714285714285,1,0.0,0,0,0,0,0,0,0,1,0,0,1,1
10939,193441,VARzQVmDzWyeZVMza6XcRnhR9idMVp9n,7GRhBDsirIGkRZBtSMEzNTyDr2JQm4xx,4,2,1,0,0,2,4,0,9,1.2857142857142858,1,0.0,0,1,0,0,2,2,0,4,0,1,8,1
10940,193468,5UJZmEar1AX3gQXOzkh3MnQcYdErI17M,5X6FeZozNMgE2VRi3MJYjkkFK8SETtu2,15,19,6,15,11,0,1,0,52,7.428571428571429,1,0.0,12,6,14,11,7,0,1,1,0,43,9,1
10941,193519,wpXUynmsiSu4GN2ibkxsqCGp9o4mfy5I,5X6FeZozNMgE2VRi3MJYjkkFK8SETtu2,1,0,0,0,0,0,1,0,1,0.14285714285714285,1,0.0,0,0,0,0,0,0,0,1,0,0,1,1
10942,193542,YTHmQoXSzCJ72wYyD4eBzLYK257HXF0x,5X6FeZozNMgE2VRi3MJYjkkFK8SETtu2,1,0,0,0,0,0,1,0,1,0.14285714285714285,1,0.0,0,0,0,0,0,0,0,1,0,0,1,1
10943,193633,zynLWMDwDGZGrMFdec4rl1UB2FSg8e8K,5X6FeZozNMgE2VRi3MJYjkkFK8SETtu2,9,6,3,3,4,0,1,0,17,2.4285714285714284,1,0.0,2,3,3,4,4,0,0,1,0,12,5,1
10944,193676,ICjb9YpLQQYBLFzFmkyCMZI5LNU5C4Fb,5X6FeZozNMgE2VRi3MJYjkkFK8SETtu2,6,2,1,0,1,0,3,0,7,1.0,1,0.0,0,1,0,1,2,0,0,3,0,2,5,1
10945,193698,VwBmQMjyoGFc84WCvHOjmFbeW8jbYRgl,5X6FeZozNMgE2VRi3MJYjkkFK8SETtu2,1,0,0,0,0,0,1,0,1,0.14285714285714285,1,0.0,0,0,0,0,0,0,0,1,0,0,1,1
10946,193736,sHXZP4MEjEMzkkOQfvmTepwt8uTqOiyM,5X6FeZozNMgE2VRi3MJYjkkFK8SETtu2,1,0,0,0,0,0,1,0,1,0.14285714285714285,1,0.0,0,0,0,0,0,0,0,1,0,0,1,1
10947,193802,S0VKX97GoNIs4ZIwm8h0PYaT3QLarXum,5X6FeZozNMgE2VRi3MJYjkkFK8SETtu2,8,2,1,0,1,1,10,4,19,2.7142857142857144,1,0.0,0,1,0,1,2,1,0,10,4,2,17,1
10948,193874,ZMuuMhmwz4rPRJ3j5NrhL1ac0b3nmBXc,5X6FeZozNMgE2VRi3MJYjkkFK8SETtu2,1,0,0,0,0,0,1,0,1,0.14285714285714285,1,0.0,0,0,0,0,0,0,0,1,0,0,1,1
10949,194107,usAyN6L7XALOHwgB1OAbVS6qtnhLfW64,5X6FeZozNMgE2VRi3MJYjkkFK8SETtu2,8,3,2,0,2,5,4,0,16,2.2857142857142856,1,0.0,0,2,0,2,3,5,0,4,0,4,12,1
10950,194158,D9eQoamtTDpiMV0b0OdGca728kthGUV3,G8EPVSXsOYB5YQWZGiz1aVq5Pgr2GrQu,25,4,0,90,0,0,1,0,95,13.571428571428571,1,0.0,0,0,77,0,4,0,13,1,0,77,18,0
10951,194318,y2Bn8Fz28yytP2MIRmHuQaPFEsenFCug,5X6FeZozNMgE2VRi3MJYjkkFK8SETtu2,1,0,0,0,0,0,1,0,1,0.14285714285714285,1,0.0,0,0,0,0,0,0,0,1,0,0,1,1
10952,194393,sTUCiynpym0OYmwd4HYbIIN7BbIAdZsH,5X6FeZozNMgE2VRi3MJYjkkFK8SETtu2,2,0,0,0,0,0,2,0,2,0.2857142857142857,1,0.0,0,0,0,0,0,0,0,2,0,0,2,1
10953,194431,1ZMf7BMPt4L0ACovltRnIwtfAQfbX0Vc,5X6FeZozNMgE2VRi3MJYjkkFK8SETtu2,1,0,0,0,0,0,1,0,1,0.14285714285714285,1,0.0,0,0,0,0,0,0,0,1,0,0,1,1
10954,195578,K7h76kiU4XN1zBV50oc4eRwwsA0rbRLb,5X6FeZozNMgE2VRi3MJYjkkFK8SETtu2,2,0,0,0,0,0,5,0,5,0.7142857142857143,1,0.0,0,0,0,0,0,0,0,5,0,0,5,1
10955,195592,hLB5PUIgFnlLvby1vFNFDJpG89oERQ28,5X6FeZozNMgE2VRi3MJYjkkFK8SETtu2,2,0,0,0,0,0,2,0,2,0.2857142857142857,1,0.0,0,0,0,0,0,0,0,2,0,0,2,1
10956,195601,fJHDc0QLJ0UKI9btxXZoKpZDigsPyCSM,5X6FeZozNMgE2VRi3MJYjkkFK8SETtu2,1,0,0,0,0,0,1,0,1,0.14285714285714285,1,0.0,0,0,0,0,0,0,0,1,0,0,1,1
10957,195627,nZa0Tm4oTt6ndXCyLFJJCwzGAKd2GkTC,5X6FeZozNMgE2VRi3MJYjkkFK8SETtu2,1,0,0,0,0,0,2,0,2,0.2857142857142857,1,0.0,0,0,0,0,0,0,0,2,0,0,2,1
10958,195706,C800geUBh3GYBhoh4cW6ReKUGj5LAMGi,5X6FeZozNMgE2VRi3MJYjkkFK8SETtu2,1,0,0,0,0,0,1,0,1,0.14285714285714285,1,0.0,0,0,0,0,0,0,0,1,0,0,1,1
10959,196254,VAITXrV1amXe1GhhhwMShh0VTtJzy2Yz,SpATywNh6bZuzm8s1ceuBUnMUAeoAHHw,17,42,1,0,1,0,2,0,46,6.571428571428571,1,0.0,0,1,0,1,42,0,0,2,0,2,44,1
10960,196272,SkecSbZBHKAGo2USROV1WAUf7HvtwuAI,SpATywNh6bZuzm8s1ceuBUnMUAeoAHHw,5,2,1,0,1,0,2,0,6,0.8571428571428571,1,0.0,0,1,0,1,2,0,0,2,0,2,4,1
10961,196273,9rDNIkTtvzF2FwoEIMtwAGkbMy9wjMFp,SpATywNh6bZuzm8s1ceuBUnMUAeoAHHw,1,0,0,0,0,0,1,0,1,0.14285714285714285,1,0.0,0,0,0,0,0,0,0,1,0,0,1,1
10962,196275,d15d0BZarFoBM80SRBgMSmWHMJCUlMK7,SpATywNh6bZuzm8s1ceuBUnMUAeoAHHw,5,1,0,0,1,0,3,0,5,0.7142857142857143,1,0.0,0,0,0,1,1,0,0,3,0,1,4,1
10963,196292,80qMwN2dfd5sERfBYHnuRbrvVaQ5Bk6G,bWdj2GDclj5ofokWjzoa5jAwMkxCykd6,1,0,0,0,0,0,1,0,1,0.14285714285714285,1,0.0,0,0,0,0,0,0,0,1,0,0,1,1
10964,196302,mWxcyMOCNLHJcixnZgZnYBd0dGZ8Df9s,SpATywNh6bZuzm8s1ceuBUnMUAeoAHHw,1,0,0,0,0,0,1,0,1,0.14285714285714285,1,0.0,0,0,0,0,0,0,0,1,0,0,1,1
10965,196325,nnYyB1E87FLd4EjVxJp25lmShfOxTs9x,SpATywNh6bZuzm8s1ceuBUnMUAeoAHHw,6,3,2,0,0,1,4,0,10,1.4285714285714286,1,0.0,0,2,0,0,3,1,0,4,0,2,8,1
10966,196326,Px3JrKmZd41gHkStDjeO27gVhyG6H9Jg,SpATywNh6bZuzm8s1ceuBUnMUAeoAHHw,15,31,12,12,1,0,2,0,58,8.285714285714286,1,0.0,12,12,12,1,19,0,0,2,0,37,21,1
10967,196332,hmQiOXi0OWvn5v2X2zEXr7r54TZskX5l,SpATywNh6bZuzm8s1ceuBUnMUAeoAHHw,5,2,1,0,1,0,2,0,6,0.8571428571428571,1,0.0,0,1,0,1,2,0,0,2,0,2,4,1
10968,196335,BXEKxoXoxulJe6lVUNmBzkuoxML0RzPQ,5X6FeZozNMgE2VRi3MJYjkkFK8SETtu2,1,0,0,0,0,0,1,0,1,0.14285714285714285,1,0.0,0,0,0,0,0,0,0,1,0,0,1,1
10969,196339,BXEKxoXoxulJe6lVUNmBzkuoxML0RzPQ,A3fsA9Zfv1X2fVEQhTw51lKENdNrEqT3,1,0,0,0,0,0,1,0,1,0.14285714285714285,1,0.0,0,0,0,0,0,0,0,1,0,0,1,1
10970,196348,9bpHf7Xj8OcUe4lMVYF5vOWYuwtloOIm,RXDvfPUBYFlVdlueBFbLW0mhhAyGEqpt,1,0,0,0,0,0,1,0,1,0.14285714285714285,1,0.0,0,0,0,0,0,0,0,1,0,0,1,1
10971,196350,lpSvQcQeloogGly9iaYnTUD0jXzht8xx,5X6FeZozNMgE2VRi3MJYjkkFK8SETtu2,8,13,9,0,1,1,6,0,30,4.285714285714286,1,0.0,0,9,0,1,13,1,0,6,0,10,20,1
10972,196360,EHb1g6rHAZsPWF8Gnr1xievV0vdAYt5Q,SpATywNh6bZuzm8s1ceuBUnMUAeoAHHw,14,13,1,0,1,0,2,0,17,2.4285714285714284,1,0.0,0,1,0,1,13,0,0,2,0,2,15,1
10973,196393,iJS4NO25TGJOkDkxwNThNbes0mRasAmQ,A3fsA9Zfv1X2fVEQhTw51lKENdNrEqT3,1,0,0,0,0,0,1,0,1,0.14285714285714285,1,0.0,0,0,0,0,0,0,0,1,0,0,1,1
10974,196425,RGCu1EjFajhpC8KngGiUHu3Aqmv6gwWd,G8EPVSXsOYB5YQWZGiz1aVq5Pgr2GrQu,4,0,0,0,0,0,6,1,7,1.0,1,0.0,0,0,0,0,0,0,0,6,1,0,7,1
10975,196434,qjVw5zdLNaHgDeIlRwuWiy2ktW0DybEV,RXDvfPUBYFlVdlueBFbLW0mhhAyGEqpt,5,2,1,0,1,0,2,0,6,0.8571428571428571,1,0.0,0,1,0,1,2,0,0,2,0,2,4,1
10976,196439,28zXrKQkPDF9YmLfOHrMy7Vkui9nCxRv,5X6FeZozNMgE2VRi3MJYjkkFK8SETtu2,5,0,0,0,0,0,6,1,7,1.0,1,0.0,0,0,0,0,0,0,0,6,1,0,7,1
10977,196441,omC1WQtxbGZUepbncMFIw7Iiq9lxKzdi,bWdj2GDclj5ofokWjzoa5jAwMkxCykd6,3,0,0,0,0,1,3,0,4,0.5714285714285714,1,0.0,0,0,0,0,0,1,0,3,0,0,4,1
10978,196475,XUIrRPCoeh3iLjZyoN7eqA99XDN4JBLH,A3fsA9Zfv1X2fVEQhTw51lKENdNrEqT3,1,0,0,0,0,0,1,0,1,0.14285714285714285,1,0.0,0,0,0,0,0,0,0,1,0,0,1,1
10979,196477,rVZTDDebI0kfxFTSroMAOzS2gGepwkHN,bWdj2GDclj5ofokWjzoa5jAwMkxCykd6,10,8,4,0,4,0,4,0,20,2.857142857142857,1,0.0,2,4,0,4,6,0,0,4,0,10,10,1
10980,196483,Oy0e7VrQWmT0KhQMBb1cQhS7OxdYueSs,SpATywNh6bZuzm8s1ceuBUnMUAeoAHHw,4,2,1,0,0,0,2,0,5,0.7142857142857143,1,0.0,0,1,0,0,2,0,0,2,0,1,4,1
10981,196487,so04UHX42q6jI3lvj3RNVSKJ1VPEH1YP,A3fsA9Zfv1X2fVEQhTw51lKENdNrEqT3,4,2,1,0,1,0,1,0,5,0.7142857142857143,1,0.0,0,1,0,1,2,0,0,1,0,2,3,1
10982,196498,UbPUJOqoO4HGgoQ4ctjETQ7ZwstvMoKV,SpATywNh6bZuzm8s1ceuBUnMUAeoAHHw,6,4,3,0,2,0,1,0,10,1.4285714285714286,1,0.0,0,3,0,2,4,0,0,1,0,5,5,1
10983,196504,f1i57ujvjE56HLLEyVKCTNhM7MGsdKXA,A3fsA9Zfv1X2fVEQhTw51lKENdNrEqT3,1,0,0,0,0,0,2,0,2,0.2857142857142857,1,0.0,0,0,0,0,0,0,0,2,0,0,2,1
10984,196521,sReE8PQxSu0jT8e2E2QnbI2BpiyFk2CX,G8EPVSXsOYB5YQWZGiz1aVq5Pgr2GrQu,13,16,4,18,0,0,2,0,40,5.714285714285714,1,0.0,11,4,11,0,5,0,7,2,0,26,14,1
10985,196531,QtoTN2OyyTcqe6Us4ENFLFoSg3hJkA40,G8EPVSXsOYB5YQWZGiz1aVq5Pgr2GrQu,1,0,0,0,0,0,1,0,1,0.14285714285714285,1,0.0,0,0,0,0,0,0,0,1,0,0,1,1
10986,196546,N1KM8ReNRnVme4r9NBubBSBJnD37tVCM,G8EPVSXsOYB5YQWZGiz1aVq5Pgr2GrQu,11,16,7,8,5,0,2,0,38,5.428571428571429,1,0.0,8,7,5,5,8,0,3,2,0,25,13,0
10987,196555,5IwzZuDN6Y4Qf5xqrDhtpG2TdC7SCWw3,SpATywNh6bZuzm8s1ceuBUnMUAeoAHHw,1,0,0,0,0,0,1,0,1,0.14285714285714285,1,0.0,0,0,0,0,0,0,0,1,0,0,1,1
10988,196583,LvtYQA0DoCvGQV35U4WWLrSMicEWVifD,SpATywNh6bZuzm8s1ceuBUnMUAeoAHHw,1,0,0,0,0,0,1,0,1,0.14285714285714285,1,0.0,0,0,0,0,0,0,0,1,0,0,1,1
10989,196587,zqPiN6fngW7il9FbWkBXYXifniNaXNn1,SpATywNh6bZuzm8s1ceuBUnMUAeoAHHw,7,8,4,0,2,0,3,0,17,2.4285714285714284,1,0.0,0,4,0,2,8,0,0,3,0,6,11,1
10990,196592,3vnu5JUiIQfwcWSSeAtE6dAgHCr6iqRo,5X6FeZozNMgE2VRi3MJYjkkFK8SETtu2,1,0,0,0,0,0,1,0,1,0.14285714285714285,1,0.0,0,0,0,0,0,0,0,1,0,0,1,1
10991,196604,ajdXJNtmFj3djCMALYMagt4EstfNGU3t,5X6FeZozNMgE2VRi3MJYjkkFK8SETtu2,12,9,7,0,3,0,4,0,23,3.2857142857142856,1,0.0,0,7,0,3,9,0,0,4,0,10,13,1
10992,196615,NMXa9Wia2ySruqcJB2iC203fj7cABa4b,SpATywNh6bZuzm8s1ceuBUnMUAeoAHHw,1,0,0,0,0,0,1,0,1,0.14285714285714285,1,0.0,0,0,0,0,0,0,0,1,0,0,1,1
10993,196622,dHF0lmwAWj90dNkEJgjhA3G1B2pjJava,A3fsA9Zfv1X2fVEQhTw51lKENdNrEqT3,8,4,2,0,2,0,2,0,10,1.4285714285714286,1,0.0,0,2,0,2,4,0,0,2,0,4,6,1
10994,196631,i0ksX07HnsV5rQlWqOr1uKEuc7yNU24c,RXDvfPUBYFlVdlueBFbLW0mhhAyGEqpt,1,0,0,0,0,0,1,0,1,0.14285714285714285,1,0.0,0,0,0,0,0,0,0,1,0,0,1,1
10995,196645,woycXT46N9ci40pABOFUjbx9WrsYsrpN,A3fsA9Zfv1X2fVEQhTw51lKENdNrEqT3,3,0,0,0,0,0,3,0,3,0.42857142857142855,1,0.0,0,0,0,0,0,0,0,3,0,0,3,1
10996,196650,Aw5ghdSq194D0D6BaNF7QrXufOcqe5oy,bWdj2GDclj5ofokWjzoa5jAwMkxCykd6,5,2,1,0,1,0,2,0,6,0.8571428571428571,1,0.0,0,1,0,1,2,0,0,2,0,2,4,1
10997,196651,nji88FV6SjKXwBtBz9eoNmfsHCT6XfjA,bWdj2GDclj5ofokWjzoa5jAwMkxCykd6,1,0,0,0,0,0,1,0,1,0.14285714285714285,1,0.0,0,0,0,0,0,0,0,1,0,0,1,1
10998,196652,nji88FV6SjKXwBtBz9eoNmfsHCT6XfjA,A3fsA9Zfv1X2fVEQhTw51lKENdNrEqT3,1,0,0,0,0,0,1,0,1,0.14285714285714285,1,0.0,0,0,0,0,0,0,0,1,0,0,1,1
10999,196663,KDcZpMgh43fWN3yQZLS7ca0RsmMFrFC9,5X6FeZozNMgE2VRi3MJYjkkFK8SETtu2,1,0,0,0,0,0,1,0,1,0.14285714285714285,1,0.0,0,0,0,0,0,0,0,1,0,0,1,1
11000,196665,GuGxPlH8kwap04Ulm0KrrLW9Bhs1eaZe,A3fsA9Zfv1X2fVEQhTw51lKENdNrEqT3,1,0,0,0,0,0,1,0,1,0.14285714285714285,1,0.0,0,0,0,0,0,0,0,1,0,0,1,1
11001,196674,m2vHU6I2vHbIjXkP5syq1gW8Xrvw3Ajn,SpATywNh6bZuzm8s1ceuBUnMUAeoAHHw,6,2,1,0,1,0,3,0,7,1.0,1,0.0,0,1,0,1,2,0,0,3,0,2,5,1
11002,196682,XqMsMG5vyizsvnugMyb3JLunooayeKD3,bWdj2GDclj5ofokWjzoa5jAwMkxCykd6,13,12,4,0,2,0,9,0,27,3.857142857142857,1,0.0,0,4,0,2,12,0,0,9,0,6,21,1
11003,196689,plzzrHT4KCGyPPQGvIdYTvuIq5SPXcu1,bWdj2GDclj5ofokWjzoa5jAwMkxCykd6,4,2,1,0,0,1,3,0,7,1.0,1,0.0,0,1,0,0,2,1,0,3,0,1,6,1
11004,196690,plzzrHT4KCGyPPQGvIdYTvuIq5SPXcu1,A3fsA9Zfv1X2fVEQhTw51lKENdNrEqT3,4,0,0,0,0,0,6,0,6,0.8571428571428571,1,0.0,0,0,0,0,0,0,0,6,0,0,6,1
11005,196696,BDdKHYPp1edgylVPYUBHaWJ6W3VobGdR,5X6FeZozNMgE2VRi3MJYjkkFK8SETtu2,7,16,0,3,6,0,1,0,26,3.7142857142857144,1,0.0,9,0,3,6,7,0,0,1,0,18,8,1
11006,196720,1O7FJIVzsP72uhSpA353FJO0czrlF5YS,bWdj2GDclj5ofokWjzoa5jAwMkxCykd6,3,2,1,0,0,0,2,0,5,0.7142857142857143,1,0.0,0,1,0,0,2,0,0,2,0,1,4,0
11007,196722,D9eNXjxmMhHjCOCB5mVDJmuvO7XywQVj,SpATywNh6bZuzm8s1ceuBUnMUAeoAHHw,3,0,0,0,0,0,2,1,3,0.42857142857142855,1,0.0,0,0,0,0,0,0,0,2,1,0,3,1
11008,196730,ZIU1mdORhQRTpEoPB7YiPLPLKUVNr5Px,SpATywNh6bZuzm8s1ceuBUnMUAeoAHHw,7,4,3,0,2,2,1,0,12,1.7142857142857142,1,0.0,0,3,0,2,4,2,0,1,0,5,7,1
11009,196732,H7DsC4hQdgygkNoyg6qvYR8wETuHnTTe,5X6FeZozNMgE2VRi3MJYjkkFK8SETtu2,3,2,0,0,0,0,1,0,3,0.42857142857142855,1,0.0,0,0,0,0,2,0,0,1,0,0,3,1
11010,196739,afz8pGlhhupRQaDBQjwT8rGM1G2Ff6JT,5X6FeZozNMgE2VRi3MJYjkkFK8SETtu2,6,3,2,0,2,0,1,0,8,1.1428571428571428,1,0.0,0,2,0,2,3,0,0,1,0,4,4,1
11011,196749,QYjw7Y4e4Czbt9G691x4dA9fq3fXHjUR,5X6FeZozNMgE2VRi3MJYjkkFK8SETtu2,10,4,3,0,2,1,9,1,20,2.857142857142857,1,0.0,0,3,0,2,4,1,0,9,1,5,15,1
11012,196755,GTB6EmFhGWrB5YoAF5RdJLLan0vjwhuE,bWdj2GDclj5ofokWjzoa5jAwMkxCykd6,7,3,1,4,1,0,7,11,27,3.857142857142857,1,0.0,1,1,3,1,2,0,1,7,11,6,21,1
11013,196756,hu8eak1Xmf8voE8pnxPzkSD2dZP9Sipf,5X6FeZozNMgE2VRi3MJYjkkFK8SETtu2,3,0,0,0,0,0,5,0,5,0.7142857142857143,1,0.0,0,0,0,0,0,0,0,5,0,0,5,1
11014,196762,KbfT30uvubax3lKEct6iblV8VhlPaIEn,SpATywNh6bZuzm8s1ceuBUnMUAeoAHHw,4,2,1,0,1,0,1,0,5,0.7142857142857143,1,0.0,0,1,0,1,2,0,0,1,0,2,3,1
11015,196763,RKOYrOIIwzYbTMl5NOqZn88YOfnvZ0ak,G8EPVSXsOYB5YQWZGiz1aVq5Pgr2GrQu,6,3,1,0,1,0,2,0,7,1.0,1,0.0,0,1,0,1,3,0,0,2,0,2,5,1
11016,196767,NYagfMVvA1FDdZ7PZwzv8OVDbZ0jsy8R,RXDvfPUBYFlVdlueBFbLW0mhhAyGEqpt,1,0,0,0,0,0,0,1,1,0.14285714285714285,1,0.0,0,0,0,0,0,0,0,0,1,0,1,1
11017,196775,RKzSwI9z6iPxP2o2bYXnPOLiApfWBeuC,SpATywNh6bZuzm8s1ceuBUnMUAeoAHHw,1,0,0,0,0,0,1,0,1,0.14285714285714285,1,0.0,0,0,0,0,0,0,0,1,0,0,1,1
11018,196779,RKzSwI9z6iPxP2o2bYXnPOLiApfWBeuC,A3fsA9Zfv1X2fVEQhTw51lKENdNrEqT3,1,0,0,0,0,0,1,0,1,0.14285714285714285,1,0.0,0,0,0,0,0,0,0,1,0,0,1,1
11019,196781,RKzSwI9z6iPxP2o2bYXnPOLiApfWBeuC,bWdj2GDclj5ofokWjzoa5jAwMkxCykd6,1,0,0,0,0,0,2,0,2,0.2857142857142857,1,0.0,0,0,0,0,0,0,0,2,0,0,2,0
11020,196784,v9C3VnGUCCaLq89LQlmpKAcUn8zTHjde,SpATywNh6bZuzm8s1ceuBUnMUAeoAHHw,8,6,1,0,1,1,3,0,12,1.7142857142857142,1,0.0,0,1,0,1,6,1,0,3,0,2,10,1
11021,196790,2G14apRBdF9cbdNniI1m92cw2effevIo,RXDvfPUBYFlVdlueBFbLW0mhhAyGEqpt,1,0,0,0,0,0,1,0,1,0.14285714285714285,1,0.0,0,0,0,0,0,0,0,1,0,0,1,1
11022,196797,TCIVkyJgzJ4isZH6dzhFoSor2ZwJ5sAN,G8EPVSXsOYB5YQWZGiz1aVq5Pgr2GrQu,9,10,0,2,0,14,2,0,28,4.0,1,0.0,3,0,2,0,7,14,0,2,0,5,23,1
11023,196800,2G14apRBdF9cbdNniI1m92cw2effevIo,G8EPVSXsOYB5YQWZGiz1aVq5Pgr2GrQu,2,0,0,0,0,0,2,0,2,0.2857142857142857,1,0.0,0,0,0,0,0,0,0,2,0,0,2,1
11024,196821,9okn7MlPqrl75GLYfq7rYcsuwwHBKJq1,G8EPVSXsOYB5YQWZGiz1aVq5Pgr2GrQu,5,2,1,0,1,1,2,0,7,1.0,1,0.0,0,1,0,1,2,1,0,2,0,2,5,1
11025,196822,RthO8kTkOrnZ3vUDn574hHyfG3vroBt1,A3fsA9Zfv1X2fVEQhTw51lKENdNrEqT3,1,0,0,0,0,0,1,0,1,0.14285714285714285,1,0.0,0,0,0,0,0,0,0,1,0,0,1,1
11026,196828,hVUqnhGvvkIbg28LhhceS15GaKTK2ldt,SpATywNh6bZuzm8s1ceuBUnMUAeoAHHw,4,2,1,0,1,0,1,0,5,0.7142857142857143,1,0.0,0,1,0,1,2,0,0,1,0,2,3,1
11027,196831,CO9EgyX80USh1QMChwKJwPNFG9kSbsUu,RXDvfPUBYFlVdlueBFbLW0mhhAyGEqpt,1,0,0,0,0,0,1,0,1,0.14285714285714285,1,0.0,0,0,0,0,0,0,0,1,0,0,1,1
11028,196850,lCyf3TRKW0i3K1mBgKz23OONMdCWqNsI,5X6FeZozNMgE2VRi3MJYjkkFK8SETtu2,1,0,0,0,0,0,1,0,1,0.14285714285714285,1,0.0,0,0,0,0,0,0,0,1,0,0,1,1
11029,196857,mW9cT3ovqDXR30FBGWFZjKmJaCzLtUDP,bWdj2GDclj5ofokWjzoa5jAwMkxCykd6,2,0,0,0,0,0,3,0,3,0.42857142857142855,1,0.0,0,0,0,0,0,0,0,3,0,0,3,0
11030,196863,MruaUYvcSXx9bIm3phiSDO7IWZezThw6,bWdj2GDclj5ofokWjzoa5jAwMkxCykd6,5,2,1,0,1,0,2,0,6,0.8571428571428571,1,0.0,0,1,0,1,2,0,0,2,0,2,4,1
11031,196869,K1c5rfeyrGKixNSI1YrnOAmNH7wjwFVd,bWdj2GDclj5ofokWjzoa5jAwMkxCykd6,5,2,1,0,1,0,2,0,6,0.8571428571428571,1,0.0,0,1,0,1,2,0,0,2,0,2,4,1
11032,196872,K1c5rfeyrGKixNSI1YrnOAmNH7wjwFVd,A3fsA9Zfv1X2fVEQhTw51lKENdNrEqT3,9,15,2,0,2,0,4,0,23,3.2857142857142856,1,0.0,0,2,0,2,15,0,0,4,0,4,19,1
11033,196885,esy4b6bETmasLl5DFctrDy15ZWYpffCf,A3fsA9Zfv1X2fVEQhTw51lKENdNrEqT3,2,0,0,0,0,0,3,0,3,0.42857142857142855,1,0.0,0,0,0,0,0,0,0,3,0,0,3,1
11034,196900,T1QrT5UOeU1ksTt3tDnyZ3XgowFwBlaD,SpATywNh6bZuzm8s1ceuBUnMUAeoAHHw,1,0,0,0,0,0,1,0,1,0.14285714285714285,1,0.0,0,0,0,0,0,0,0,1,0,0,1,1
11035,196905,rPGMKO3AhLxN6LWflYbraX7SC5U9X2nK,A3fsA9Zfv1X2fVEQhTw51lKENdNrEqT3,1,0,0,0,0,0,1,0,1,0.14285714285714285,1,0.0,0,0,0,0,0,0,0,1,0,0,1,1
11036,196910,TZebVQukvsBcYdOQxixaRTPhQSwDEkVv,SpATywNh6bZuzm8s1ceuBUnMUAeoAHHw,5,2,1,0,1,0,2,0,6,0.8571428571428571,1,0.0,0,1,0,1,2,0,0,2,0,2,4,1
11037,196932,KlM5BQr0R5RQxLKf8vKCD5vECsgcwVG1,SpATywNh6bZuzm8s1ceuBUnMUAeoAHHw,6,3,1,0,1,0,2,0,7,1.0,1,0.0,0,1,0,1,3,0,0,2,0,2,5,1
11038,196937,eWkJrAlAUQLWG3dtEpMXROzgiD3a1MDK,5X6FeZozNMgE2VRi3MJYjkkFK8SETtu2,1,0,0,0,0,0,1,0,1,0.14285714285714285,1,0.0,0,0,0,0,0,0,0,1,0,0,1,1
11039,196945,qREvGviufJ3VVxNkA2MjB1npr7InnyIq,SpATywNh6bZuzm8s1ceuBUnMUAeoAHHw,1,0,0,0,0,0,1,0,1,0.14285714285714285,1,0.0,0,0,0,0,0,0,0,1,0,0,1,1
11040,196963,ySbpVhOvpB9MuHEn2lEoeA4d5zRYukkl,A3fsA9Zfv1X2fVEQhTw51lKENdNrEqT3,7,3,2,0,2,0,4,0,11,1.5714285714285714,1,0.0,0,2,0,2,3,0,0,4,0,4,7,1
11041,196969,kKBIfyZmN22zBj263eKBa0SA1U5xYMsR,bWdj2GDclj5ofokWjzoa5jAwMkxCykd6,1,0,0,0,0,0,1,0,1,0.14285714285714285,1,0.0,0,0,0,0,0,0,0,1,0,0,1,1
11042,196970,kKBIfyZmN22zBj263eKBa0SA1U5xYMsR,G8EPVSXsOYB5YQWZGiz1aVq5Pgr2GrQu,1,0,0,0,0,0,1,0,1,0.14285714285714285,1,0.0,0,0,0,0,0,0,0,1,0,0,1,1
11043,196983,9AWK7WPV1FK8oZYjbtTZUeHBBeoqLZWS,SpATywNh6bZuzm8s1ceuBUnMUAeoAHHw,1,0,0,0,0,0,1,0,1,0.14285714285714285,1,0.0,0,0,0,0,0,0,0,1,0,0,1,1
11044,196990,XMX9ZzyckuT66ALkAoQ1Ndie7Ls8rbRQ,SpATywNh6bZuzm8s1ceuBUnMUAeoAHHw,15,34,0,0,0,1,6,0,41,5.857142857142857,1,0.0,7,0,0,0,27,1,0,6,0,7,34,0
11045,196998,cao0jYvVpb9HkTA7b0NC6lvxt4dMGzpm,bWdj2GDclj5ofokWjzoa5jAwMkxCykd6,5,2,1,0,1,0,4,0,8,1.1428571428571428,1,0.0,0,1,0,1,2,0,0,4,0,2,6,1
11046,196999,MmSspWh9UIrPZvHRrkVV6uR2B7UAVFMg,A3fsA9Zfv1X2fVEQhTw51lKENdNrEqT3,1,0,0,0,0,0,1,0,1,0.14285714285714285,1,0.0,0,0,0,0,0,0,0,1,0,0,1,1
11047,197003,zX8EipUM7J0ifhENZyJ19KxHpsJKH6Ul,SpATywNh6bZuzm8s1ceuBUnMUAeoAHHw,5,2,1,0,1,0,2,0,6,0.8571428571428571,1,0.0,0,1,0,1,2,0,0,2,0,2,4,1
11048,197008,9Nmjm4BvnbKTQ3ZZwECYdKy9zBNGmQNW,A3fsA9Zfv1X2fVEQhTw51lKENdNrEqT3,1,0,0,0,0,0,1,0,1,0.14285714285714285,1,0.0,0,0,0,0,0,0,0,1,0,0,1,1
11049,197026,vVomSgkHkyw3sqrRqYKc3zE1eWaa2d4G,bWdj2GDclj5ofokWjzoa5jAwMkxCykd6,1,0,0,0,0,0,1,0,1,0.14285714285714285,1,0.0,0,0,0,0,0,0,0,1,0,0,1,1
11050,197029,ZZowuz4uVcnPKwLl2HwtR5fDkL6SykXx,3VkHkmOtom3jM2wCu94xgzzu1d6Dn7or,1,0,0,0,0,0,2,0,2,0.2857142857142857,1,0.0,0,0,0,0,0,0,0,2,0,0,2,1
11051,197046,thHEMa1JeqvmtFrpKqNkntC9EjRmasdH,3VkHkmOtom3jM2wCu94xgzzu1d6Dn7or,1,0,0,0,0,0,1,0,1,0.14285714285714285,1,0.0,0,0,0,0,0,0,0,1,0,0,1,1
11052,197053,Fzj0WxgQZtpi1yL9FPl2GLIeADVOERZd,3VkHkmOtom3jM2wCu94xgzzu1d6Dn7or,5,1,1,0,1,0,3,0,6,0.8571428571428571,1,0.0,0,1,0,1,1,0,0,3,0,2,4,1
11053,197060,WEqUhplW7x1SpLabVjNcI5M4HsCYjumg,3VkHkmOtom3jM2wCu94xgzzu1d6Dn7or,5,2,1,0,1,0,3,2,9,1.2857142857142858,1,0.0,0,1,0,1,2,0,0,3,2,2,7,1
11054,197064,o4jpUfYyugisNuTxStBdnlkGLqss1oz3,3VkHkmOtom3jM2wCu94xgzzu1d6Dn7or,4,2,1,0,1,0,1,0,5,0.7142857142857143,1,0.0,0,1,0,1,2,0,0,1,0,2,3,1
11055,197078,yROHdgEfg5YBunrCMGTpfbdQSjLMPtZM,3VkHkmOtom3jM2wCu94xgzzu1d6Dn7or,2,0,0,0,0,0,5,0,5,0.7142857142857143,1,0.0,0,0,0,0,0,0,0,5,0,0,5,1
11056,197090,2Iz7IRN2SG7NxQwSbdZl0a3sYpcN4Mke,3VkHkmOtom3jM2wCu94xgzzu1d6Dn7or,1,0,0,0,0,0,1,0,1,0.14285714285714285,1,0.0,0,0,0,0,0,0,0,1,0,0,1,1
11057,197092,9B8XNdnBVjU3W5PKErol0e502ujFe9zl,3VkHkmOtom3jM2wCu94xgzzu1d6Dn7or,5,2,1,0,1,0,2,0,6,0.8571428571428571,1,0.0,0,1,0,1,2,0,0,2,0,2,4,1
11058,197120,TdfPQ8Zwlmkv9r9eYq7hz64CoB8G0Fbz,3VkHkmOtom3jM2wCu94xgzzu1d6Dn7or,1,0,0,0,0,0,2,0,2,0.2857142857142857,1,0.0,0,0,0,0,0,0,0,2,0,0,2,1
11059,197135,ic6pjUfgxHe0ndQH7kHuGrLDFqrjZins,3VkHkmOtom3jM2wCu94xgzzu1d6Dn7or,1,0,0,0,0,0,1,0,1,0.14285714285714285,1,0.0,0,0,0,0,0,0,0,1,0,0,1,1
11060,197143,29FuwqBM9NfSWGkyXxZzrOCmx4AYpimY,3VkHkmOtom3jM2wCu94xgzzu1d6Dn7or,4,2,0,0,0,0,4,0,6,0.8571428571428571,2,0.0,0,0,0,0,2,0,0,4,0,0,6,1
11061,197146,WZGplmadmmEtELNPBvysdSm2qcRPQpTm,3VkHkmOtom3jM2wCu94xgzzu1d6Dn7or,1,0,0,0,0,0,1,0,1,0.14285714285714285,1,0.0,0,0,0,0,0,0,0,1,0,0,1,1
11062,197149,em9AtvWzZLkApDA4BdTwYHl7faCKZlUR,3VkHkmOtom3jM2wCu94xgzzu1d6Dn7or,23,18,18,0,0,0,4,0,40,5.714285714285714,1,0.0,0,18,0,0,18,0,0,4,0,18,22,1
11063,197178,R0yZQm01vPxwB1FHTvnE4ExR78BMpKhv,3VkHkmOtom3jM2wCu94xgzzu1d6Dn7or,5,1,1,0,1,0,5,0,8,1.1428571428571428,2,0.0,0,1,0,1,1,0,0,5,0,2,6,0
11064,197186,Ei3c2hqo9KkGhrTsh0pMPLmhpqSfM9Hw,3VkHkmOtom3jM2wCu94xgzzu1d6Dn7or,14,8,3,3,4,5,6,2,31,4.428571428571429,1,0.0,4,3,3,4,4,5,0,6,2,14,17,1
11065,197191,U52HCRlROLk7AsGf0ggclVGz2aYoTy09,3VkHkmOtom3jM2wCu94xgzzu1d6Dn7or,1,0,0,0,0,0,1,0,1,0.14285714285714285,1,0.0,0,0,0,0,0,0,0,1,0,0,1,1
11066,197204,b42x9fEviD2KrosQFgO4BDKrSzPFH9d9,3VkHkmOtom3jM2wCu94xgzzu1d6Dn7or,1,0,0,0,0,0,1,0,1,0.14285714285714285,1,0.0,0,0,0,0,0,0,0,1,0,0,1,1
11067,197225,hKgVqil7KBLHJURLHxVOtikdxysMZkIE,3VkHkmOtom3jM2wCu94xgzzu1d6Dn7or,9,6,3,1,2,0,3,0,15,2.142857142857143,1,0.0,1,3,1,2,5,0,0,3,0,7,8,1
11068,197234,xJCbRVaklom2k9BJ5bRzeCNVTGSyTSLq,3VkHkmOtom3jM2wCu94xgzzu1d6Dn7or,6,6,2,0,2,0,4,0,14,2.0,1,0.0,3,2,0,2,3,0,0,4,0,7,7,1
11069,197268,11WnYceVEuF19QogoEk6NeEMEKIyHta5,3VkHkmOtom3jM2wCu94xgzzu1d6Dn7or,4,3,1,0,1,0,3,0,8,1.1428571428571428,1,0.0,1,1,0,1,2,0,0,3,0,3,5,1
11070,197295,ERlWzeifdR1dZrApgDfsJLPQsR6BHmoR,3VkHkmOtom3jM2wCu94xgzzu1d6Dn7or,1,0,0,0,0,0,1,0,1,0.14285714285714285,1,0.0,0,0,0,0,0,0,0,1,0,0,1,1
11071,197351,KejvQXsC1Zw5WydUIFGrx4U67cLxgUCe,3VkHkmOtom3jM2wCu94xgzzu1d6Dn7or,4,2,1,0,1,0,1,0,5,0.7142857142857143,1,0.0,0,1,0,1,2,0,0,1,0,2,3,1
11072,197358,G9yEvP6FyZQ0TxOmqnRQjmWB8smt21jf,3VkHkmOtom3jM2wCu94xgzzu1d6Dn7or,2,0,0,0,0,0,2,0,2,0.2857142857142857,1,0.0,0,0,0,0,0,0,0,2,0,0,2,1
11073,197382,0hGRrhLCwhSNOstg5hZotkXuqdc5VejE,3VkHkmOtom3jM2wCu94xgzzu1d6Dn7or,7,2,1,0,1,1,7,1,13,1.8571428571428572,1,0.0,0,1,0,1,2,1,0,7,1,2,11,1
11074,197425,Hk8WDWn2QvcOQpks5Fx9WW8sZlnc2HgG,3VkHkmOtom3jM2wCu94xgzzu1d6Dn7or,6,3,1,0,2,0,3,0,9,1.2857142857142858,1,0.0,2,1,0,2,1,0,0,3,0,5,4,1
11075,197433,x8tyR94GbfRfS5lV029Kd0oRdnTeKZWB,3VkHkmOtom3jM2wCu94xgzzu1d6Dn7or,1,0,0,0,0,0,1,0,1,0.14285714285714285,1,0.0,0,0,0,0,0,0,0,1,0,0,1,0
11076,197438,aEs6MQWBV7GUXtIMoKT7PrftJrGVv5ZK,3VkHkmOtom3jM2wCu94xgzzu1d6Dn7or,1,0,0,0,0,0,1,0,1,0.14285714285714285,1,0.0,0,0,0,0,0,0,0,1,0,0,1,1
11077,197469,9UzLImPuSID0ZgW5UVZbILenHfrw26tU,3VkHkmOtom3jM2wCu94xgzzu1d6Dn7or,4,3,1,0,1,0,1,0,6,0.8571428571428571,1,0.0,1,1,0,1,2,0,0,1,0,3,3,1
11078,197485,PwBUlHo08QPxo8Ok2Pwey6PpKeJz63fH,3VkHkmOtom3jM2wCu94xgzzu1d6Dn7or,1,0,0,0,0,0,1,0,1,0.14285714285714285,1,0.0,0,0,0,0,0,0,0,1,0,0,1,1
11079,197513,D2f4XnvAFD8ZIkDvhpGbd6yCstJua9ut,3VkHkmOtom3jM2wCu94xgzzu1d6Dn7or,8,4,2,0,2,0,2,0,10,1.4285714285714286,1,0.0,0,2,0,2,4,0,0,2,0,4,6,0
11080,197522,nrqhmTevBllzRr8nrNjnpvdMDs7GQKjC,3VkHkmOtom3jM2wCu94xgzzu1d6Dn7or,2,0,0,0,0,0,2,0,2,0.2857142857142857,1,0.0,0,0,0,0,0,0,0,2,0,0,2,1
11081,197534,0a3gK0IKIMFMFguGHQqyaQCMfYXZtO1D,3VkHkmOtom3jM2wCu94xgzzu1d6Dn7or,1,0,0,0,0,0,2,0,2,0.2857142857142857,1,0.0,0,0,0,0,0,0,0,2,0,0,2,1
11082,199082,MDp7DOIvKcLxQwYa7iYETsW6UM7XLKe9,3VkHkmOtom3jM2wCu94xgzzu1d6Dn7or,5,2,1,0,1,0,2,0,6,0.8571428571428571,1,0.0,0,1,0,1,2,0,0,2,0,2,4,0
11083,199097,c6Lk0MnCUGXZQ5o6l8UnHA0XawHnWKca,3VkHkmOtom3jM2wCu94xgzzu1d6Dn7or,1,0,0,0,0,0,1,0,1,0.14285714285714285,1,0.0,0,0,0,0,0,0,0,1,0,0,1,1
11084,199099,D2mqYQzmwXfHmkcpG9YcM985v42dZT5i,3VkHkmOtom3jM2wCu94xgzzu1d6Dn7or,1,0,0,0,0,0,1,0,1,0.14285714285714285,1,0.0,0,0,0,0,0,0,0,1,0,0,1,1
11085,199101,SMdSH6gTeMo8uypLu3FkgYnM2y7eiJMa,3VkHkmOtom3jM2wCu94xgzzu1d6Dn7or,1,0,0,0,0,0,1,0,1,0.14285714285714285,1,0.0,0,0,0,0,0,0,0,1,0,0,1,1
11086,199109,sMynuMhoZTpmWI7JIgM7Zcgv9Nw77yWq,3VkHkmOtom3jM2wCu94xgzzu1d6Dn7or,1,0,0,0,0,0,1,0,1,0.14285714285714285,1,0.0,0,0,0,0,0,0,0,1,0,0,1,1
11087,199111,CY8h7ccBxsJwojp3CaWp3n3pn8ZSTU6a,3VkHkmOtom3jM2wCu94xgzzu1d6Dn7or,5,1,1,0,0,0,5,1,8,1.1428571428571428,1,0.0,0,1,0,0,1,0,0,5,1,1,7,1
11088,199128,YvOc6FqXZMoL0NWYKBDQjwnxonb9FCcf,3VkHkmOtom3jM2wCu94xgzzu1d6Dn7or,1,0,0,0,0,0,1,0,1,0.14285714285714285,1,0.0,0,0,0,0,0,0,0,1,0,0,1,1
11089,199149,O5yzVszMpi9v4YHXoTUnhN19xXR2rb7W,3VkHkmOtom3jM2wCu94xgzzu1d6Dn7or,7,5,4,0,3,0,1,0,13,1.8571428571428572,1,0.0,0,4,0,3,5,0,0,1,0,7,6,1
11090,199177,3LqcIJ5JlXmNniowWV3r1JhnVHNprKQu,3VkHkmOtom3jM2wCu94xgzzu1d6Dn7or,1,0,0,0,0,0,1,0,1,0.14285714285714285,1,0.0,0,0,0,0,0,0,0,1,0,0,1,1
11091,199183,YeSAuHvfgQOhQ4rsBpMBzhc3ZqH7Cx4C,3VkHkmOtom3jM2wCu94xgzzu1d6Dn7or,1,0,0,0,0,0,1,0,1,0.14285714285714285,1,0.0,0,0,0,0,0,0,0,1,0,0,1,1
11092,199192,UWFxLgpn2YLwf0avOCRSvUoV4a2OKFgp,3VkHkmOtom3jM2wCu94xgzzu1d6Dn7or,1,0,0,0,0,0,1,0,1,0.14285714285714285,1,0.0,0,0,0,0,0,0,0,1,0,0,1,1
11093,199193,mEOByHnZF9nPOug98IZyXHx5UUcj0wRG,3VkHkmOtom3jM2wCu94xgzzu1d6Dn7or,1,0,0,0,0,0,1,0,1,0.14285714285714285,1,0.0,0,0,0,0,0,0,0,1,0,0,1,1
11094,199232,heT0yS9sPU51G510IWGk7buTH2YGxkfD,3VkHkmOtom3jM2wCu94xgzzu1d6Dn7or,8,7,4,0,2,1,6,0,20,2.857142857142857,1,0.0,0,4,0,2,7,1,0,6,0,6,14,1
11095,199233,quZIfUvhbgq4XxK5fzctoX77uKRPby0l,3VkHkmOtom3jM2wCu94xgzzu1d6Dn7or,1,0,0,0,0,0,1,0,1,0.14285714285714285,1,0.0,0,0,0,0,0,0,0,1,0,0,1,1
11096,199234,idaNfMnrfdnV5wsQBlzuXwo9SkbzRiqc,3VkHkmOtom3jM2wCu94xgzzu1d6Dn7or,3,2,0,0,0,0,1,0,3,0.42857142857142855,1,0.0,0,0,0,0,2,0,0,1,0,0,3,1
11097,199235,D0vNNvzUXljarIsbaxIO0pFzGpvX9UB3,3VkHkmOtom3jM2wCu94xgzzu1d6Dn7or,1,0,0,0,0,0,1,0,1,0.14285714285714285,1,0.0,0,0,0,0,0,0,0,1,0,0,1,1
11098,199237,Wq5GM9gkMECiU2lxgJ5JOL0av6dT4jvb,3VkHkmOtom3jM2wCu94xgzzu1d6Dn7or,8,7,4,0,3,4,13,1,32,4.571428571428571,1,0.0,1,4,0,3,6,4,0,13,1,8,24,1
11099,199238,9frMePaupEGpnF4HdG7VG4qzCQRn3q5K,3VkHkmOtom3jM2wCu94xgzzu1d6Dn7or,5,2,1,0,1,0,2,2,8,1.1428571428571428,1,0.0,0,1,0,1,2,0,0,2,2,2,6,1
11100,199242,OGWTywqD3YlVP7vYo3Y0izf1JAFxQTll,3VkHkmOtom3jM2wCu94xgzzu1d6Dn7or,1,0,0,0,0,0,1,0,1,0.14285714285714285,1,0.0,0,0,0,0,0,0,0,1,0,0,1,1
11101,199244,L7yS593GwnTtaqImYFPvT6H7t25RyL69,3VkHkmOtom3jM2wCu94xgzzu1d6Dn7or,3,0,0,0,0,0,3,0,3,0.42857142857142855,1,0.0,0,0,0,0,0,0,0,3,0,0,3,1
11102,199245,XCaTFMFkUKCIQiZyvdm8DS9Cwg64hJrs,3VkHkmOtom3jM2wCu94xgzzu1d6Dn7or,6,7,3,0,2,0,4,0,16,2.2857142857142856,1,0.0,2,3,0,2,5,0,0,4,0,7,9,1
11103,199250,nw1HkZWZyhKotur4BMCRyESTL2YNYqjX,3VkHkmOtom3jM2wCu94xgzzu1d6Dn7or,10,8,0,2,3,2,9,1,25,3.5714285714285716,1,0.0,3,0,2,3,5,2,0,9,1,8,17,1
11104,199255,PGj1B7s4Yw1PBLMA6crSiWk0Zk66XU5n,3VkHkmOtom3jM2wCu94xgzzu1d6Dn7or,1,0,0,0,0,0,1,0,1,0.14285714285714285,1,0.0,0,0,0,0,0,0,0,1,0,0,1,1
11105,199256,pXzRndBCWQe1quNNkdgxDsGJhh4GeWS1,3VkHkmOtom3jM2wCu94xgzzu1d6Dn7or,4,7,2,0,3,1,1,0,14,2.0,1,0.0,4,2,0,3,3,1,0,1,0,9,5,1
11106,199259,ViHCQzPRd8xjHcyhoqQACLFm37RiqHC0,3VkHkmOtom3jM2wCu94xgzzu1d6Dn7or,5,3,2,0,1,0,2,0,8,1.1428571428571428,1,0.0,0,2,0,1,3,0,0,2,0,3,5,1
11107,199261,R16KAJbfGGFUn1cMcmpx31ZsldcTlSwP,3VkHkmOtom3jM2wCu94xgzzu1d6Dn7or,1,0,0,0,0,0,1,0,1,0.14285714285714285,1,0.0,0,0,0,0,0,0,0,1,0,0,1,1
11108,199264,FALCit9nnWsURM3iEkGUle8YXOvnt8ti,3VkHkmOtom3jM2wCu94xgzzu1d6Dn7or,1,0,0,0,0,0,1,0,1,0.14285714285714285,1,0.0,0,0,0,0,0,0,0,1,0,0,1,1
11109,199266,rctQAs50XkWV8tImkcwqO3JdbiB1Af0a,3VkHkmOtom3jM2wCu94xgzzu1d6Dn7or,5,2,1,0,1,0,2,0,6,0.8571428571428571,1,0.0,0,1,0,1,2,0,0,2,0,2,4,1
11110,199267,GKwHWGmSvV2pJwT2TgYCkTV7PBLeVyfn,3VkHkmOtom3jM2wCu94xgzzu1d6Dn7or,1,0,0,0,0,0,1,0,1,0.14285714285714285,1,0.0,0,0,0,0,0,0,0,1,0,0,1,1
11111,199271,owp26vkEpLoWsYtRcACCQkruNiSrsbFi,3VkHkmOtom3jM2wCu94xgzzu1d6Dn7or,6,3,2,0,2,0,1,0,8,1.1428571428571428,1,0.0,0,2,0,2,3,0,0,1,0,4,4,1
11112,199273,FA6bKtSEtTCRuOxXtEQwLrTLjnmRCxNG,3VkHkmOtom3jM2wCu94xgzzu1d6Dn7or,1,0,0,0,0,0,1,0,1,0.14285714285714285,1,0.0,0,0,0,0,0,0,0,1,0,0,1,1
11113,199283,mwQt0mxNtgenG4gvb4TlKF1a0rGjgcRZ,3VkHkmOtom3jM2wCu94xgzzu1d6Dn7or,12,76,5,13,12,1,1,0,108,15.428571428571429,1,0.0,46,5,12,12,30,1,1,1,0,75,33,1
11114,199285,HPQAOqe01qpRbHX0lYk1eZACdCkgs8jm,3VkHkmOtom3jM2wCu94xgzzu1d6Dn7or,4,3,1,0,1,0,2,0,7,1.0,1,0.0,1,1,0,1,2,0,0,2,0,3,4,1
11115,199286,iZMRgCC40ecdaIMzrqbtGezxBw2R1223,3VkHkmOtom3jM2wCu94xgzzu1d6Dn7or,4,7,1,0,2,0,1,0,11,1.5714285714285714,1,0.0,3,1,0,2,4,0,0,1,0,6,5,1
11116,199288,Owu7m6Y7WCzGIld8o5eihV0mlwoPEFiq,3VkHkmOtom3jM2wCu94xgzzu1d6Dn7or,6,3,1,4,1,1,2,0,12,1.7142857142857142,1,0.0,1,1,3,1,2,1,1,2,0,6,6,1
11117,199291,CmldrbZ19rS0kZKCSttlmLmxZ5JRCugc,3VkHkmOtom3jM2wCu94xgzzu1d6Dn7or,8,6,2,0,2,0,3,0,13,1.8571428571428572,1,0.0,0,2,0,2,6,0,0,3,0,4,9,1
11118,199292,J3vRJtjr6jwORuHeHZ8zCMyiz1FlmuLj,3VkHkmOtom3jM2wCu94xgzzu1d6Dn7or,5,9,3,0,0,2,3,1,18,2.5714285714285716,1,0.0,0,3,0,0,9,2,0,3,1,3,15,1
11119,199294,LVEod3KU7qteTZ7JZ6vJlksrsdaBotfu,3VkHkmOtom3jM2wCu94xgzzu1d6Dn7or,9,9,4,2,5,1,1,0,22,3.142857142857143,1,0.0,4,4,2,5,5,1,0,1,0,15,7,1
11120,199296,Ii6R7Up398zJqqiQxvfbGdpgK5XPOsKH,3VkHkmOtom3jM2wCu94xgzzu1d6Dn7or,1,0,0,0,0,0,1,0,1,0.14285714285714285,1,0.0,0,0,0,0,0,0,0,1,0,0,1,1
11121,199297,ZxX2gWe9Tsn0HHjfeYqd09FZpjQimtqE,3VkHkmOtom3jM2wCu94xgzzu1d6Dn7or,7,10,4,0,2,1,1,0,18,2.5714285714285716,1,0.0,1,4,0,2,9,1,0,1,0,7,11,1
11122,199300,tD46LDb7FV9clFS7zVlaEduBHsQLKqKP,3VkHkmOtom3jM2wCu94xgzzu1d6Dn7or,4,2,1,0,1,0,1,0,5,0.7142857142857143,1,0.0,0,1,0,1,2,0,0,1,0,2,3,1
11123,199302,xf5PP38VyLUgi7xAbHiquAfrLrCJRmZb,3VkHkmOtom3jM2wCu94xgzzu1d6Dn7or,2,0,0,0,0,0,4,0,4,0.5714285714285714,1,0.0,0,0,0,0,0,0,0,4,0,0,4,1
11124,199318,ZvAjwj1tcN1kBkuJeOXNTN5AkioJ63Mn,3VkHkmOtom3jM2wCu94xgzzu1d6Dn7or,9,6,3,0,1,0,12,1,23,3.2857142857142856,1,0.0,0,3,0,1,6,0,0,12,1,4,19,1
11125,199348,NjOJlHONswcoqqrScXTNSE9VQ70COEUu,3VkHkmOtom3jM2wCu94xgzzu1d6Dn7or,3,0,0,0,0,0,3,0,3,0.42857142857142855,1,0.0,0,0,0,0,0,0,0,3,0,0,3,1
11126,199349,ho2pjRkOUvSFvOH0eDUkqXB8JZFLfrCQ,3VkHkmOtom3jM2wCu94xgzzu1d6Dn7or,8,13,5,0,1,0,10,1,30,4.285714285714286,1,0.0,0,5,0,1,13,0,0,10,1,6,24,1
11127,199379,ZbIkYpB9TNj3p0s8LGpk23E3tkrT0Csv,3VkHkmOtom3jM2wCu94xgzzu1d6Dn7or,9,7,3,0,2,2,5,1,20,2.857142857142857,1,0.0,2,3,0,2,5,2,0,5,1,7,13,1
11128,199382,51cj9dTWcB2YrIOxHeQIeROKythB7StW,3VkHkmOtom3jM2wCu94xgzzu1d6Dn7or,1,0,0,0,0,0,1,0,1,0.14285714285714285,1,0.0,0,0,0,0,0,0,0,1,0,0,1,1
11129,199385,ik0xMPFwPk7Hp9Z1nWhE3kXp0C9XX2JI,3VkHkmOtom3jM2wCu94xgzzu1d6Dn7or,1,0,0,0,0,0,1,0,1,0.14285714285714285,1,0.0,0,0,0,0,0,0,0,1,0,0,1,1
11130,199388,XHbLeQS7SuzlwKQYTfIjSivKqKgoNdUd,3VkHkmOtom3jM2wCu94xgzzu1d6Dn7or,5,2,1,0,1,0,4,0,8,1.1428571428571428,1,0.0,0,1,0,1,2,0,0,4,0,2,6,1
11131,199396,VPKFayk1a3k3k8GVZ9cHnlyYOYnFLDbo,3VkHkmOtom3jM2wCu94xgzzu1d6Dn7or,1,0,0,0,0,0,1,0,1,0.14285714285714285,1,0.0,0,0,0,0,0,0,0,1,0,0,1,1
11132,199409,Z0RcAq8Lz8Tge9yALRp5sOKSW4Q9g8kz,3VkHkmOtom3jM2wCu94xgzzu1d6Dn7or,4,4,0,0,2,0,1,0,7,1.0,1,0.0,2,0,0,2,2,0,0,1,0,4,3,1
11133,199417,XqqTtwtZ8esH2ShRf0zzxW6HefKyd53W,3VkHkmOtom3jM2wCu94xgzzu1d6Dn7or,2,0,0,0,0,0,5,0,5,0.7142857142857143,1,0.0,0,0,0,0,0,0,0,5,0,0,5,1
11134,199433,VQwvObbbEsoQKGDAeVk1Jrtbpp6CI9u4,3VkHkmOtom3jM2wCu94xgzzu1d6Dn7or,1,0,0,0,0,0,1,0,1,0.14285714285714285,1,0.0,0,0,0,0,0,0,0,1,0,0,1,1
11135,199438,KovRcxrWLNFYVBPtBqFI3vlUuYrufR0Z,3VkHkmOtom3jM2wCu94xgzzu1d6Dn7or,4,2,1,0,1,0,1,0,5,0.7142857142857143,1,0.0,0,1,0,1,2,0,0,1,0,2,3,1
11136,199455,WK11XP7TUkyoldC0WOFH2UB992OA9hur,3VkHkmOtom3jM2wCu94xgzzu1d6Dn7or,7,5,3,0,2,2,4,1,17,2.4285714285714284,1,0.0,0,3,0,2,5,2,0,4,1,5,12,1
11137,199458,EpFhCzt5fuMlGaCvzJfjDXMXbXrQWtig,3VkHkmOtom3jM2wCu94xgzzu1d6Dn7or,6,4,1,0,2,0,6,0,13,1.8571428571428572,1,0.0,2,1,0,2,2,0,0,6,0,5,8,1
11138,199477,bm8Dbz1QQHqZM2ELT3sFAfBn0ahr4krY,3VkHkmOtom3jM2wCu94xgzzu1d6Dn7or,1,0,0,0,0,0,1,0,1,0.14285714285714285,1,0.0,0,0,0,0,0,0,0,1,0,0,1,1
11139,199500,t9Gvguu2Ai390f3CGcABFs61SKAyGgVA,5Gyp41oLVo7Gg7vF4vpmggWP5MU70QO6,5,1,1,0,1,0,2,0,5,0.7142857142857143,1,0.0,0,1,0,1,1,0,0,2,0,2,3,1
11140,199504,4RiemE5r88jWq9gaL0lVYzjeUhWq3sNP,5Gyp41oLVo7Gg7vF4vpmggWP5MU70QO6,8,2,2,0,2,0,3,0,9,1.2857142857142858,1,0.0,0,2,0,2,2,0,0,3,0,4,5,1
11141,199507,SL64UzpB7mMbNHUSlMD5sHgnAqUAgKbx,5Gyp41oLVo7Gg7vF4vpmggWP5MU70QO6,1,0,0,0,0,0,1,0,1,0.14285714285714285,1,0.0,0,0,0,0,0,0,0,1,0,0,1,1
11142,199513,o4elzktEK9p16tV09uIOTDR5KrpuPNMl,5Gyp41oLVo7Gg7vF4vpmggWP5MU70QO6,1,0,0,0,0,0,1,0,1,0.14285714285714285,1,0.0,0,0,0,0,0,0,0,1,0,0,1,1
11143,199533,TmcXoxCT48jZhYzJE3XlHytbzJ2TbpDY,5Gyp41oLVo7Gg7vF4vpmggWP5MU70QO6,10,13,9,4,0,0,9,0,35,5.0,1,0.0,3,9,2,0,10,0,2,9,0,14,21,1
11144,199545,6NFz33fKVon4f4sOjYdlPKOQ1V49PvQc,5Gyp41oLVo7Gg7vF4vpmggWP5MU70QO6,7,3,2,0,2,0,2,0,9,1.2857142857142858,1,0.0,0,2,0,2,3,0,0,2,0,4,5,1
11145,199556,9qRvgqss6kKFETpsAzp6CdIovsa4fKh5,5Gyp41oLVo7Gg7vF4vpmggWP5MU70QO6,1,0,0,0,0,0,1,0,1,0.14285714285714285,1,0.0,0,0,0,0,0,0,0,1,0,0,1,1
11146,199558,LTNkaPp4W4SY7K4OnD4wGhfve8kd0iqv,5Gyp41oLVo7Gg7vF4vpmggWP5MU70QO6,19,29,14,0,12,1,13,1,70,10.0,1,0.0,8,14,0,12,21,1,0,13,1,34,36,1
11147,199572,t5SLXVnYNYK6h15znYBWovYFldQ8hVQb,5Gyp41oLVo7Gg7vF4vpmggWP5MU70QO6,4,3,1,0,1,0,1,0,6,0.8571428571428571,1,0.0,0,1,0,1,3,0,0,1,0,2,4,1
11148,199588,6Qk8wCR0cykyu4cNDO7szKzXCcdM3dA4,5Gyp41oLVo7Gg7vF4vpmggWP5MU70QO6,5,4,2,0,1,0,3,0,10,1.4285714285714286,1,0.0,0,2,0,1,4,0,0,3,0,3,7,1
11149,199596,kvmtYWzTMPDcSeRrV3gjQPSQDQP6i5nz,5Gyp41oLVo7Gg7vF4vpmggWP5MU70QO6,11,8,6,0,4,0,3,0,21,3.0,1,0.0,1,6,0,4,7,0,0,3,0,11,10,1
11150,199617,WYF6gnZ4xRpre5Df26WMDKWFofwrAPRG,5Gyp41oLVo7Gg7vF4vpmggWP5MU70QO6,1,0,0,0,0,0,1,0,1,0.14285714285714285,1,0.0,0,0,0,0,0,0,0,1,0,0,1,1
11151,199629,uZO5PhedIimEU4NDxccoQOJRW5LJmuW8,5Gyp41oLVo7Gg7vF4vpmggWP5MU70QO6,5,2,1,0,1,0,2,0,6,0.8571428571428571,1,0.0,0,1,0,1,2,0,0,2,0,2,4,1
11152,199660,4p7pAUI1XYsqegAZiBvgomxVZdl3wyjA,5Gyp41oLVo7Gg7vF4vpmggWP5MU70QO6,7,5,1,0,1,0,4,0,11,1.5714285714285714,1,0.0,0,1,0,1,5,0,0,4,0,2,9,1
11153,199663,Ml60GNShoNs2pvt0lXoBEyALZNRb4RrW,5Gyp41oLVo7Gg7vF4vpmggWP5MU70QO6,1,0,0,0,0,0,1,0,1,0.14285714285714285,1,0.0,0,0,0,0,0,0,0,1,0,0,1,1
11154,199691,78awNsb2gv1BNI14errPUoSJXoVpCdJH,5Gyp41oLVo7Gg7vF4vpmggWP5MU70QO6,5,1,1,0,1,0,2,0,5,0.7142857142857143,1,0.0,0,1,0,1,1,0,0,2,0,2,3,1
11155,199702,Xlu2qT74x5h2jgxC7XMmLvWcDpKJdFTo,5Gyp41oLVo7Gg7vF4vpmggWP5MU70QO6,1,0,0,0,0,0,1,0,1,0.14285714285714285,1,0.0,0,0,0,0,0,0,0,1,0,0,1,1
11156,199719,ufk8FCBpI5vYfstuZlggO1Y28eb7bImN,5Gyp41oLVo7Gg7vF4vpmggWP5MU70QO6,7,3,2,0,2,0,2,0,9,1.2857142857142858,1,0.0,0,2,0,2,3,0,0,2,0,4,5,1
11157,199738,CFUx7WKUxHEsW0H7zKcUairzxQEPJJ9t,5Gyp41oLVo7Gg7vF4vpmggWP5MU70QO6,1,0,0,0,0,0,1,0,1,0.14285714285714285,1,0.0,0,0,0,0,0,0,0,1,0,0,1,1
11158,199752,01tPVj9GhpLYaFfBODjF6HKJRtUeoeRD,5Gyp41oLVo7Gg7vF4vpmggWP5MU70QO6,8,7,4,0,5,0,2,0,18,2.5714285714285716,1,0.0,1,4,0,5,6,0,0,2,0,10,8,1
11159,199773,VtALT7PCDyJDsdPo6puj2SULDyuNrsZ2,5Gyp41oLVo7Gg7vF4vpmggWP5MU70QO6,1,0,0,0,0,0,1,0,1,0.14285714285714285,1,0.0,0,0,0,0,0,0,0,1,0,0,1,1
11160,199780,QoZkGYnpYNMmElyQszMTfInxv7WtXYlp,5Gyp41oLVo7Gg7vF4vpmggWP5MU70QO6,6,3,1,0,1,0,2,0,7,1.0,1,0.0,0,1,0,1,3,0,0,2,0,2,5,1
11161,199781,0lNj4wOPU5aLVoC1NJRAY6ITZrtT0j79,5Gyp41oLVo7Gg7vF4vpmggWP5MU70QO6,3,0,0,0,0,0,3,0,3,0.42857142857142855,1,0.0,0,0,0,0,0,0,0,3,0,0,3,1
11162,199788,pwdsR2guw7jGBDVAdaksGODr7uJoy6bJ,5Gyp41oLVo7Gg7vF4vpmggWP5MU70QO6,7,7,2,0,2,3,3,1,18,2.5714285714285716,1,0.0,4,2,0,2,3,3,0,3,1,8,10,1
11163,199789,6n0F9Fc2AE4Y8ya0XBqCqVk34NAxOjFe,5Gyp41oLVo7Gg7vF4vpmggWP5MU70QO6,7,6,1,0,1,0,2,0,10,1.4285714285714286,1,0.0,0,1,0,1,6,0,0,2,0,2,8,1
11164,199795,p4N5T6ghxdMOFXG3asenPRANHZgM9jg5,5Gyp41oLVo7Gg7vF4vpmggWP5MU70QO6,2,0,0,0,0,0,2,0,2,0.2857142857142857,1,0.0,0,0,0,0,0,0,0,2,0,0,2,1
11165,199807,NHGmMinB9WoQusKCx50F4M4nJF124Ms4,5Gyp41oLVo7Gg7vF4vpmggWP5MU70QO6,7,3,3,0,2,0,2,0,10,1.4285714285714286,1,0.0,0,3,0,2,3,0,0,2,0,5,5,1
11166,199812,XE68NKSR0NgsUmxAP8OC135kqBLzzb9D,5Gyp41oLVo7Gg7vF4vpmggWP5MU70QO6,7,4,3,0,3,0,2,0,12,1.7142857142857142,1,0.0,0,3,0,3,4,0,0,2,0,6,6,1
11167,199823,orm5m8NPSgOnZgNd4Q6MIMwBtdbdV8s8,5Gyp41oLVo7Gg7vF4vpmggWP5MU70QO6,1,0,0,0,0,0,1,0,1,0.14285714285714285,1,0.0,0,0,0,0,0,0,0,1,0,0,1,1
11168,199824,YLA48gUHn1Dc2R5xXAOe8bpBqZ5RWVW4,5Gyp41oLVo7Gg7vF4vpmggWP5MU70QO6,2,1,0,0,0,0,1,0,2,0.2857142857142857,1,0.0,0,0,0,0,1,0,0,1,0,0,2,1
11169,199846,SgAa84aajahM2sd2hvCdYRfO014ocPV5,5Gyp41oLVo7Gg7vF4vpmggWP5MU70QO6,6,4,2,0,2,0,2,0,10,1.4285714285714286,1,0.0,0,2,0,2,4,0,0,2,0,4,6,1
11170,199868,uMav2T5lYpadzN2W5cHO5Dgm0OCXqQcd,5Gyp41oLVo7Gg7vF4vpmggWP5MU70QO6,7,1,1,0,1,1,4,1,9,1.2857142857142858,1,0.0,0,1,0,1,1,1,0,4,1,2,7,1
11171,199888,w6wOsUixK1NR3DxQ6OAwLtGPzWjW0RT5,5Gyp41oLVo7Gg7vF4vpmggWP5MU70QO6,5,2,1,0,1,0,2,0,6,0.8571428571428571,1,0.0,0,1,0,1,2,0,0,2,0,2,4,1
11172,199916,7YimjZuYz1aFS1ixr3OljmqX6zHZZJdP,5Gyp41oLVo7Gg7vF4vpmggWP5MU70QO6,10,6,4,0,3,0,3,0,16,2.2857142857142856,1,0.0,0,4,0,3,6,0,0,3,0,7,9,1
11173,199917,9xXPu4XrxUEQD4kiDWTsMvTkTFxGkYzI,5Gyp41oLVo7Gg7vF4vpmggWP5MU70QO6,8,2,1,0,1,7,6,1,18,2.5714285714285716,1,0.0,0,1,0,1,2,7,0,6,1,2,16,1
11174,199942,LGZMukYq1H8wyuvk1p8UwJXL5xcvPKMm,5Gyp41oLVo7Gg7vF4vpmggWP5MU70QO6,1,0,0,0,0,0,1,0,1,0.14285714285714285,1,0.0,0,0,0,0,0,0,0,1,0,0,1,1
11175,199944,GkJR3TNQR5bDjgiA7ByPHRWSb3vgtDKO,5Gyp41oLVo7Gg7vF4vpmggWP5MU70QO6,1,0,0,0,0,0,1,0,1,0.14285714285714285,1,0.0,0,0,0,0,0,0,0,1,0,0,1,1
11176,199951,i5M9T8TAb1vyeNb72SH3VcSoeMeKzcTe,5Gyp41oLVo7Gg7vF4vpmggWP5MU70QO6,7,9,3,0,0,1,6,1,20,2.857142857142857,1,0.0,4,3,0,0,5,1,0,6,1,7,13,1
11177,199974,zbVrmGy9kpOt2q8xeIclHo9H8afE2cMh,5Gyp41oLVo7Gg7vF4vpmggWP5MU70QO6,22,45,16,27,7,4,11,0,110,15.714285714285714,2,0.0,14,16,15,7,31,4,12,11,0,52,58,1
11178,199984,cIZHxVEY0KMW5jNfevk6tD1l0twzy792,5Gyp41oLVo7Gg7vF4vpmggWP5MU70QO6,1,0,0,0,0,0,1,0,1,0.14285714285714285,1,0.0,0,0,0,0,0,0,0,1,0,0,1,1
11179,199987,aosFpeLMqBiLLcyUKYcbUuWGCjQbFGiD,5Gyp41oLVo7Gg7vF4vpmggWP5MU70QO6,6,3,2,0,2,0,1,0,8,1.1428571428571428,1,0.0,0,2,0,2,3,0,0,1,0,4,4,1
11180,199988,YWXRs30LfGeBUUdtbLCSDxfSvS9eXAoE,5Gyp41oLVo7Gg7vF4vpmggWP5MU70QO6,1,0,0,0,0,0,1,0,1,0.14285714285714285,1,0.0,0,0,0,0,0,0,0,1,0,0,1,1
11181,200010,bpb79QcMnqEiK7pdyDV2FpbHALODyYBK,5Gyp41oLVo7Gg7vF4vpmggWP5MU70QO6,5,2,1,0,1,0,2,0,6,0.8571428571428571,1,0.0,0,1,0,1,2,0,0,2,0,2,4,1
11182,200019,qkrz4xqDsOIKpgHmkwAPZKnMJeJkGh5u,5Gyp41oLVo7Gg7vF4vpmggWP5MU70QO6,1,0,0,0,0,0,2,0,2,0.2857142857142857,1,0.0,0,0,0,0,0,0,0,2,0,0,2,1
11183,200061,m9hBCbCGqWnTHkomkJRkDEF5Rs7431xS,5Gyp41oLVo7Gg7vF4vpmggWP5MU70QO6,6,3,2,0,1,0,2,0,8,1.1428571428571428,1,0.0,0,2,0,1,3,0,0,2,0,3,5,1
11184,200082,vbTgITzq6jZRj0oUV5gFotgOlwSXnjML,5Gyp41oLVo7Gg7vF4vpmggWP5MU70QO6,1,0,0,0,0,0,1,0,1,0.14285714285714285,1,0.0,0,0,0,0,0,0,0,1,0,0,1,1
11185,200110,eRNQUxT50UHdqbKWWfRjAd8yBYQxBOWR,5Gyp41oLVo7Gg7vF4vpmggWP5MU70QO6,1,0,0,0,0,0,1,0,1,0.14285714285714285,1,0.0,0,0,0,0,0,0,0,1,0,0,1,1
11186,200113,5gIOl4VVMqHfJKBD7MIuXVUZFf8N8fHp,5Gyp41oLVo7Gg7vF4vpmggWP5MU70QO6,7,8,3,0,1,0,4,0,16,2.2857142857142856,1,0.0,0,3,0,1,8,0,0,4,0,4,12,1
11187,200129,D9sfxkCYKuMIPdl3RlcDud6AoT19593x,5Gyp41oLVo7Gg7vF4vpmggWP5MU70QO6,8,2,2,0,1,0,4,0,9,1.2857142857142858,1,0.0,0,2,0,1,2,0,0,4,0,3,6,1
11188,200135,t4CFQYAfhtGm7YidMVtJaWh5UIAFkdUL,5Gyp41oLVo7Gg7vF4vpmggWP5MU70QO6,6,4,2,0,2,0,1,0,9,1.2857142857142858,1,0.0,0,2,0,2,4,0,0,1,0,4,5,1
11189,200149,tMkwIpO7ZKCsu2OGBTSLe31c2jqzYinJ,5Gyp41oLVo7Gg7vF4vpmggWP5MU70QO6,1,0,0,0,0,0,1,0,1,0.14285714285714285,1,0.0,0,0,0,0,0,0,0,1,0,0,1,1
11190,200163,bNjBiMsX33gdPcYQXoqSFOjUJgLcFbHE,fbPkOYLVPtPgIt0MxizjfFJov3JbHyAi,4,0,0,0,0,0,4,1,5,0.7142857142857143,1,0.0,0,0,0,0,0,0,0,4,1,0,5,1
11191,200184,Ue5cow6t4KF20pqucY8OJ5GlmvhnVJez,fbPkOYLVPtPgIt0MxizjfFJov3JbHyAi,1,0,0,0,0,0,1,0,1,0.14285714285714285,1,0.0,0,0,0,0,0,0,0,1,0,0,1,1
11192,200185,8WJKmjHpUZK5OxShg0TbHn2M6D7oIMfb,fbPkOYLVPtPgIt0MxizjfFJov3JbHyAi,1,0,0,0,0,0,1,0,1,0.14285714285714285,1,0.0,0,0,0,0,0,0,0,1,0,0,1,1
11193,200186,Gihs79xPOl1Mw60wZHHvlRDExkwTizeS,fbPkOYLVPtPgIt0MxizjfFJov3JbHyAi,1,0,0,0,0,0,1,0,1,0.14285714285714285,1,0.0,0,0,0,0,0,0,0,1,0,0,1,1
11194,200188,vBH0dHu4NmOj62y1ASafcuCscurKeDfE,fbPkOYLVPtPgIt0MxizjfFJov3JbHyAi,8,3,2,0,2,5,4,0,16,2.2857142857142856,1,0.0,0,2,0,2,3,5,0,4,0,4,12,1
11195,200189,IjfLv0ELgzYvkhMJtEEnngYxIv6R7Pp9,fbPkOYLVPtPgIt0MxizjfFJov3JbHyAi,6,2,1,0,1,0,3,0,7,1.0,1,0.0,0,1,0,1,2,0,0,3,0,2,5,1
11196,200191,eVBudonm9LHQus01HY2DPSy51yaVu1Ef,fbPkOYLVPtPgIt0MxizjfFJov3JbHyAi,7,4,2,0,2,0,4,0,12,1.7142857142857142,1,0.0,1,2,0,2,3,0,0,4,0,5,7,1
11197,200192,rgJ72otfhXY7oBVDdxB02Qogw63Ky7IK,fbPkOYLVPtPgIt0MxizjfFJov3JbHyAi,9,8,3,0,1,5,12,1,30,4.285714285714286,1,0.0,2,3,0,1,6,5,0,12,1,6,24,1
11198,200193,YaP2AuckukEZITP3IVvIt6Z8ci6RHew7,fbPkOYLVPtPgIt0MxizjfFJov3JbHyAi,6,7,3,0,2,0,4,0,16,2.2857142857142856,1,0.0,0,3,0,2,7,0,0,4,0,5,11,1
11199,200194,SC4osWBdol7GBH5uXCMUl6bcwZHPFUg5,fbPkOYLVPtPgIt0MxizjfFJov3JbHyAi,4,3,2,0,0,0,1,0,6,0.8571428571428571,1,0.0,0,2,0,0,3,0,0,1,0,2,4,1
11200,200198,71hGYkw2Gq02SC91zhSD2oXzHC2DaTWy,fbPkOYLVPtPgIt0MxizjfFJov3JbHyAi,6,2,1,0,1,2,3,1,10,1.4285714285714286,1,0.0,0,1,0,1,2,2,0,3,1,2,8,0
11201,200199,yNC8T7gdWO96Y2q3tzTQeJUMY0F51xnO,fbPkOYLVPtPgIt0MxizjfFJov3JbHyAi,4,2,0,0,0,0,2,0,4,0.5714285714285714,1,0.0,0,0,0,0,2,0,0,2,0,0,4,1
11202,200201,UjuEtRsjqzZUPoZRstdypYoVba7fqqz2,fbPkOYLVPtPgIt0MxizjfFJov3JbHyAi,1,0,0,0,0,0,1,0,1,0.14285714285714285,1,0.0,0,0,0,0,0,0,0,1,0,0,1,1
11203,200202,vG8XNGwZrUgilL0e4qiRKZWEfkDfD3oN,fbPkOYLVPtPgIt0MxizjfFJov3JbHyAi,1,0,0,0,0,0,1,0,1,0.14285714285714285,1,0.0,0,0,0,0,0,0,0,1,0,0,1,1
11204,200211,3cnrMFTNVdxeAntVpE4in3WqfgjUqSxl,5Gyp41oLVo7Gg7vF4vpmggWP5MU70QO6,3,0,0,0,0,0,3,0,3,0.42857142857142855,1,0.0,0,0,0,0,0,0,0,3,0,0,3,1
11205,200252,Ktw4zhSf7Wd8RujcJrq9R6zJYYz9aaXP,5Gyp41oLVo7Gg7vF4vpmggWP5MU70QO6,16,11,8,2,6,0,4,0,31,4.428571428571429,1,0.0,1,8,1,6,10,0,1,4,0,16,15,1
11206,200255,gEejwPFTytiAGdASkrbtLMHig0Q6esg4,5Gyp41oLVo7Gg7vF4vpmggWP5MU70QO6,12,10,6,0,2,6,9,2,35,5.0,1,0.0,0,6,0,2,10,6,0,9,2,8,27,1
11207,200274,ELJa8A81VOfiqD4Bg0Px962sx2WBYvb0,5Gyp41oLVo7Gg7vF4vpmggWP5MU70QO6,6,3,2,0,2,0,1,0,8,1.1428571428571428,1,0.0,0,2,0,2,3,0,0,1,0,4,4,1
11208,200277,tv7cYpYVSeOM2iwwUtv8upqaYBqILo2o,5Gyp41oLVo7Gg7vF4vpmggWP5MU70QO6,1,0,0,0,0,0,1,0,1,0.14285714285714285,1,0.0,0,0,0,0,0,0,0,1,0,0,1,1
11209,200279,o9uh3QfQeuOpEmCNnuDCmUwYmEbvIcHf,5Gyp41oLVo7Gg7vF4vpmggWP5MU70QO6,3,2,1,0,0,0,1,0,4,0.5714285714285714,1,0.0,0,1,0,0,2,0,0,1,0,1,3,1
11210,200290,nH6yoa7qb6QqJNzKj6PiD6a9jZn3yJfX,5Gyp41oLVo7Gg7vF4vpmggWP5MU70QO6,1,0,0,0,0,0,1,0,1,0.14285714285714285,1,0.0,0,0,0,0,0,0,0,1,0,0,1,1
11211,200332,aQ75JNLXDKBHcA4utiTYh0zB4CWJRKKL,5Gyp41oLVo7Gg7vF4vpmggWP5MU70QO6,1,0,0,0,0,0,1,0,1,0.14285714285714285,1,0.0,0,0,0,0,0,0,0,1,0,0,1,1
11212,200347,ppqE75IH6R0l4QuLkT31ZlDESsrHarIu,5Gyp41oLVo7Gg7vF4vpmggWP5MU70QO6,4,2,1,0,1,0,1,0,5,0.7142857142857143,1,0.0,0,1,0,1,2,0,0,1,0,2,3,1
11213,200349,xwzSNCBVwP1nh6QJnkmgm26Rb34x32EB,5Gyp41oLVo7Gg7vF4vpmggWP5MU70QO6,6,5,2,0,1,0,3,0,11,1.5714285714285714,1,0.0,0,2,0,1,5,0,0,3,0,3,8,1
11214,200426,4Dp7LLp7t1gYbdcN4ZxWGwhRKXqsnWGQ,5Gyp41oLVo7Gg7vF4vpmggWP5MU70QO6,5,3,1,0,1,0,2,0,7,1.0,1,0.0,0,1,0,1,3,0,0,2,0,2,5,0
11215,200433,CXDFvBGg10x2RDdl5BC09Fv76dN9FJm7,5Gyp41oLVo7Gg7vF4vpmggWP5MU70QO6,1,0,0,0,0,0,1,0,1,0.14285714285714285,1,0.0,0,0,0,0,0,0,0,1,0,0,1,1
11216,200490,emcnHMjxxgkRj9af1NUqizehRFaPmw2q,5Gyp41oLVo7Gg7vF4vpmggWP5MU70QO6,9,10,4,0,3,0,1,0,18,2.5714285714285716,1,0.0,5,4,0,3,5,0,0,1,0,12,6,1
11217,200507,3C0RNflDAI8FmTdsE1mhjUkpDZ4xUri7,5Gyp41oLVo7Gg7vF4vpmggWP5MU70QO6,17,23,12,8,1,5,11,1,61,8.714285714285714,1,0.0,6,12,6,1,17,5,2,11,1,25,36,1
11218,200513,mhBMXLJxEXMw4vJPtGhHPAjT49QRStZx,5Gyp41oLVo7Gg7vF4vpmggWP5MU70QO6,6,4,3,0,3,0,3,0,13,1.8571428571428572,1,0.0,0,3,0,3,4,0,0,3,0,6,7,1
11219,200514,aZAiWgHdC9uFqUTIQMHTVIPp3kq4rrxn,5Gyp41oLVo7Gg7vF4vpmggWP5MU70QO6,6,3,1,0,2,0,1,0,7,1.0,1,0.0,0,1,0,2,3,0,0,1,0,3,4,1
11220,200520,nha5ZKtXNHbSXPEQ5LMNVji34sdiUf9F,5Gyp41oLVo7Gg7vF4vpmggWP5MU70QO6,4,2,1,0,0,0,2,0,5,0.7142857142857143,1,0.0,0,1,0,0,2,0,0,2,0,1,4,1
11221,200525,Nh5O2pUrRzVk0GcyP9XE6lIyNm5IcpCa,5Gyp41oLVo7Gg7vF4vpmggWP5MU70QO6,2,0,0,0,0,0,2,0,2,0.2857142857142857,1,0.0,0,0,0,0,0,0,0,2,0,0,2,1
11222,200533,7ho1Tg0rPKs5S3R4MH5byApVMAoQWEXh,5Gyp41oLVo7Gg7vF4vpmggWP5MU70QO6,9,3,2,0,2,9,4,1,21,3.0,1,0.0,0,2,0,2,3,9,0,4,1,4,17,1
11223,200546,YLLq9nLffaF9TP2dJ2OpMZwhKv5cSnoB,5Gyp41oLVo7Gg7vF4vpmggWP5MU70QO6,6,2,1,0,1,0,4,0,8,1.1428571428571428,1,0.0,0,1,0,1,2,0,0,4,0,2,6,1
11224,200551,CEvYRnACKahkbonOgacXt7pALaNftiKp,5Gyp41oLVo7Gg7vF4vpmggWP5MU70QO6,4,3,0,0,0,0,2,0,5,0.7142857142857143,1,0.0,0,0,0,0,3,0,0,2,0,0,5,1
11225,200561,9YSGzfO7GL2BruPlhTICs0MSCuTmoYij,5Gyp41oLVo7Gg7vF4vpmggWP5MU70QO6,4,3,2,0,2,0,4,0,11,1.5714285714285714,1,0.0,0,2,0,2,3,0,0,4,0,4,7,1
11226,200590,wyv1iE5T6UZ7MmVeuRNtYmCx3UEBYVPH,5Gyp41oLVo7Gg7vF4vpmggWP5MU70QO6,2,0,0,0,0,0,2,0,2,0.2857142857142857,1,0.0,0,0,0,0,0,0,0,2,0,0,2,0
11227,200621,5dyDRUBTyWyNpCqBUThrUzCpraBPJLoP,5Gyp41oLVo7Gg7vF4vpmggWP5MU70QO6,4,2,0,0,0,0,2,0,4,0.5714285714285714,1,0.0,0,0,0,0,2,0,0,2,0,0,4,1
11228,200626,O80qwjwmPYyt37x5I83BP0nxbxfQGTvO,5Gyp41oLVo7Gg7vF4vpmggWP5MU70QO6,3,3,0,0,0,0,1,0,4,0.5714285714285714,1,0.0,0,0,0,0,3,0,0,1,0,0,4,1
11229,200627,gZSP3OXpEbKxvyj0ivbYZOkQ4gs23L7f,5Gyp41oLVo7Gg7vF4vpmggWP5MU70QO6,1,0,0,0,0,0,1,0,1,0.14285714285714285,1,0.0,0,0,0,0,0,0,0,1,0,0,1,1
11230,200635,zwzhI7xKJqbLX8Cn6JAtyj5eUdJBzFCm,5Gyp41oLVo7Gg7vF4vpmggWP5MU70QO6,1,0,0,0,0,0,1,0,1,0.14285714285714285,1,0.0,0,0,0,0,0,0,0,1,0,0,1,1
11231,200636,BZvEZ94lfgGngpJK1X6949ki1lFxWwFY,5Gyp41oLVo7Gg7vF4vpmggWP5MU70QO6,7,4,2,0,1,0,4,0,11,1.5714285714285714,1,0.0,0,2,0,1,4,0,0,4,0,3,8,1
11232,200640,QsfvQSR2bWYlIufdhtoipEOSHfKt9MYV,5Gyp41oLVo7Gg7vF4vpmggWP5MU70QO6,1,0,0,0,0,0,1,0,1,0.14285714285714285,1,0.0,0,0,0,0,0,0,0,1,0,0,1,1
11233,200649,iq2s6XEtLNjMdyc7MReRkWOgf3bnXnky,5Gyp41oLVo7Gg7vF4vpmggWP5MU70QO6,1,0,0,0,0,0,1,0,1,0.14285714285714285,1,0.0,0,0,0,0,0,0,0,1,0,0,1,1
11234,200674,Zshvnpi3gKHls4tWYAhrHjPdqOWE9eAq,5Gyp41oLVo7Gg7vF4vpmggWP5MU70QO6,12,7,7,0,4,1,5,0,24,3.4285714285714284,1,0.0,0,7,0,4,7,1,0,5,0,11,13,1
11235,200687,iysEaAaeQU9ULnAIVWQxyonskhHfsgrB,5Gyp41oLVo7Gg7vF4vpmggWP5MU70QO6,9,6,3,0,2,9,3,6,29,4.142857142857143,1,0.0,0,3,0,2,6,9,0,3,6,5,24,0
11236,200689,4sdPJJwZWD6zWSEwfAoFOiiNSkkT5tdF,5Gyp41oLVo7Gg7vF4vpmggWP5MU70QO6,4,2,1,0,1,0,1,0,5,0.7142857142857143,1,0.0,0,1,0,1,2,0,0,1,0,2,3,1
11237,200694,PdNNEF1w9pZVUItoPwkFXStEApUp40kt,5Gyp41oLVo7Gg7vF4vpmggWP5MU70QO6,7,10,5,0,1,0,1,0,17,2.4285714285714284,1,0.0,0,5,0,1,10,0,0,1,0,6,11,1
11238,200710,Kv2QTX8Bp145P6ep9Nk8x89BSyjg1SDC,5Gyp41oLVo7Gg7vF4vpmggWP5MU70QO6,1,0,0,0,0,0,1,0,1,0.14285714285714285,1,0.0,0,0,0,0,0,0,0,1,0,0,1,1
11239,200717,BfyHpsFcf5SdJtDDEokJ2DaJODuDhRyN,5Gyp41oLVo7Gg7vF4vpmggWP5MU70QO6,7,3,2,0,2,0,2,0,9,1.2857142857142858,1,0.0,0,2,0,2,3,0,0,2,0,4,5,1
11240,200758,Y9sDwuA6ol1NiBJ2RVhVaMLZPZz4ipOb,5Gyp41oLVo7Gg7vF4vpmggWP5MU70QO6,6,3,2,0,2,1,1,0,9,1.2857142857142858,1,0.0,0,2,0,2,3,1,0,1,0,4,5,1
11241,200775,nyIo9LsksiFrMb7XxTgx773xWcDAIiQQ,5Gyp41oLVo7Gg7vF4vpmggWP5MU70QO6,9,5,2,0,4,0,2,0,13,1.8571428571428572,1,0.0,0,2,0,4,5,0,0,2,0,6,7,1
11242,200780,VuTuBAJiGcrrbSkaUxqWxt1xbqL8a3NS,7GRhBDsirIGkRZBtSMEzNTyDr2JQm4xx,3,4,0,0,0,0,1,0,5,0.7142857142857143,1,0.0,2,0,0,0,2,0,0,1,0,2,3,0
11243,200781,Kw92JTRLSCQpjDbdykKr2UkGn8EcDD30,7GRhBDsirIGkRZBtSMEzNTyDr2JQm4xx,8,7,1,0,0,0,1,0,9,1.2857142857142858,1,0.0,0,1,0,0,7,0,0,1,0,1,8,1
11244,200786,QgtS4pwTfCcnUet7wEFIaa3mI34JWeze,7GRhBDsirIGkRZBtSMEzNTyDr2JQm4xx,1,0,0,0,0,0,1,0,1,0.14285714285714285,1,0.0,0,0,0,0,0,0,0,1,0,0,1,1
11245,200791,m32hK7SShSI6GU8twpfqx1DswVGk0Vpq,7GRhBDsirIGkRZBtSMEzNTyDr2JQm4xx,1,0,0,0,0,0,1,0,1,0.14285714285714285,1,0.0,0,0,0,0,0,0,0,1,0,0,1,0
11246,200795,S91PWx0V5j7dyuZWAavjt1byiE0NQ5Ta,7GRhBDsirIGkRZBtSMEzNTyDr2JQm4xx,2,0,0,0,0,0,2,0,2,0.2857142857142857,1,0.0,0,0,0,0,0,0,0,2,0,0,2,1
11247,200826,ejQ6gPILOqZQAfakVpcpBhnipDtNVKba,7GRhBDsirIGkRZBtSMEzNTyDr2JQm4xx,2,0,0,0,0,0,2,0,2,0.2857142857142857,1,0.0,0,0,0,0,0,0,0,2,0,0,2,1
