,enrollment_id,username,course_id,no_of_objects2,bno_access2,bno_pageclose2,bno_problem2,bno_video2,bno_discussion2,bno_navigate2,bno_wiki2,bno_total2,bno_avg2,no_of_active_days2,time_consumption2,browser_access2,browser_pageclose2,browser_problem2,browser_video2,server_access2,server_discussion2,server_problem2,server_navigate2,server_wiki2,bno_browser2,bno_server2,label
0,3,1qXC7Fjbwp66GPQc6pHLfEuO8WKozxG4,7GRhBDsirIGkRZBtSMEzNTyDr2JQm4xx,36,27,12,41,4,0,4,0,88,12.571428571428571,3,-2097946.0,12,12,41,4,15,0,0,4,0,69,19,0
1,5,p1Mp7WkVfzUijX0peVQKSHbgd5pXyl4c,7GRhBDsirIGkRZBtSMEzNTyDr2JQm4xx,42,90,41,67,34,15,9,0,256,36.57142857142857,4,0.0,43,41,53,34,47,15,14,9,0,171,85,0
2,7,I1KwJ6EdCZnEPLfC8Q7yWpIkLOHn7h02,7GRhBDsirIGkRZBtSMEzNTyDr2JQm4xx,17,49,14,14,9,18,3,0,107,15.285714285714286,2,0.0,30,14,11,9,19,18,3,3,0,64,43,1
3,22,dPBUV0FPFjTZZK079rPAeq0WXhW4DUkF,7GRhBDsirIGkRZBtSMEzNTyDr2JQm4xx,49,66,38,64,36,0,1,0,205,29.285714285714285,2,0.0,26,38,56,36,40,0,8,1,0,156,49,1
4,45,5Tz6BGN7p1lkmdoopAY1Z5ufYTrUsi9E,7GRhBDsirIGkRZBtSMEzNTyDr2JQm4xx,34,55,20,35,18,8,9,0,145,20.714285714285715,3,0.0,30,20,33,18,25,8,2,9,0,101,44,0
5,49,2oTvbzieHn2y5oozeOgSnruqE6N0BtR5,7GRhBDsirIGkRZBtSMEzNTyDr2JQm4xx,58,105,49,42,15,373,32,0,616,88.0,7,0.0,29,49,21,15,76,373,21,32,0,114,502,0
6,50,LnNj9zDI8D38ixGOYTIjTH2iF5m36v9S,7GRhBDsirIGkRZBtSMEzNTyDr2JQm4xx,14,29,15,22,0,0,3,0,69,9.857142857142858,3,0.0,11,15,20,0,18,0,2,3,0,46,23,1
7,58,l9KseRU4xYtwOzoILYmGcicF0iiXQqxl,7GRhBDsirIGkRZBtSMEzNTyDr2JQm4xx,35,73,33,58,8,21,18,0,211,30.142857142857142,5,0.0,15,33,54,8,58,21,4,18,0,110,101,0
8,96,KXi2lu4GlKmrO1lJTLg3t4l701rvNXNZ,7GRhBDsirIGkRZBtSMEzNTyDr2JQm4xx,20,26,8,26,7,1,3,0,71,10.142857142857142,2,0.0,15,8,22,7,11,1,4,3,0,52,19,1
9,134,Q5TmTVdy8nnH2vTL73s67ZseaCMO3k91,7GRhBDsirIGkRZBtSMEzNTyDr2JQm4xx,26,16,6,22,5,0,8,0,57,8.142857142857142,1,0.0,8,6,22,5,8,0,0,8,0,41,16,1
10,141,CB4JYroUtmiKv572P6g4vrvJCi6Pzr9h,7GRhBDsirIGkRZBtSMEzNTyDr2JQm4xx,33,54,21,48,12,2,13,0,150,21.428571428571427,1,0.0,32,21,42,12,22,2,6,13,0,107,43,1
11,192,hCxbmPBmjgsEuMY36HnZH4x3BwWFnCUn,7GRhBDsirIGkRZBtSMEzNTyDr2JQm4xx,3,0,0,0,0,0,15,0,15,2.142857142857143,4,0.0,0,0,0,0,0,0,0,15,0,0,15,0
12,199,OEQBiRbbo3yEBzKSHcNX9ESBTSUy08ze,7GRhBDsirIGkRZBtSMEzNTyDr2JQm4xx,38,81,27,67,18,108,8,0,309,44.142857142857146,1,0.0,50,27,56,18,31,108,11,8,0,151,158,0
13,219,088SASUPOVYUGhoEly8vlrkGvRBJoNwp,7GRhBDsirIGkRZBtSMEzNTyDr2JQm4xx,34,260,92,105,2,83,43,4,589,84.14285714285714,6,0.0,124,92,88,2,136,83,17,43,4,306,283,0
14,248,BTWrAWjg41jpM1wlPsS1mmQbZAFIvx2o,7GRhBDsirIGkRZBtSMEzNTyDr2JQm4xx,2,0,0,0,0,0,4,0,4,0.5714285714285714,1,0.0,0,0,0,0,0,0,0,4,0,0,4,1
15,255,O6WL6sxvoPCZnvTLyTPxdXbnpOz3wcJ4,7GRhBDsirIGkRZBtSMEzNTyDr2JQm4xx,21,46,17,10,8,0,7,0,88,12.571428571428571,2,0.0,8,17,9,8,38,0,1,7,0,42,46,0
16,284,L9qMLlGWAeAI6zWAZIyJtn0wISNa3dxg,7GRhBDsirIGkRZBtSMEzNTyDr2JQm4xx,91,99,34,0,54,75,22,0,284,40.57142857142857,6,0.0,44,34,0,54,55,75,0,22,0,132,152,0
17,320,2zijdtZPcsrYvyvmgApN5PnCXULBsIBX,7GRhBDsirIGkRZBtSMEzNTyDr2JQm4xx,1,0,0,0,0,0,1,0,1,0.14285714285714285,1,0.0,0,0,0,0,0,0,0,1,0,0,1,1
18,373,XUkSDdNHWcdano4aRGWpLSTI2IF8D1IH,7GRhBDsirIGkRZBtSMEzNTyDr2JQm4xx,48,139,55,68,3,50,32,3,350,50.0,6,0.0,37,55,59,3,102,50,9,32,3,154,196,0
19,433,PEDnL2c66c2DN92O9BTVM9D6p19gGbT6,7GRhBDsirIGkRZBtSMEzNTyDr2JQm4xx,26,52,21,22,10,4,9,0,118,16.857142857142858,6,0.0,29,21,20,10,23,4,2,9,0,80,38,0
20,493,xNkIHhqS8GZXIqyoWwwS3ZeYfSmUsNJo,7GRhBDsirIGkRZBtSMEzNTyDr2JQm4xx,7,11,3,0,1,0,1,0,16,2.2857142857142856,1,0.0,0,3,0,1,11,0,0,1,0,4,12,0
21,555,tiLrccMjeOBHHBLooSoPfc0IKYtAsyXK,7GRhBDsirIGkRZBtSMEzNTyDr2JQm4xx,2,0,0,0,0,0,3,0,3,0.42857142857142855,2,0.0,0,0,0,0,0,0,0,3,0,0,3,1
22,630,BbZEGv8zMCuD8c0LXrenf9W1lGSlVd04,7GRhBDsirIGkRZBtSMEzNTyDr2JQm4xx,10,39,5,0,0,0,9,0,53,7.571428571428571,1,0.0,0,5,0,0,39,0,0,9,0,5,48,1
23,777,bLIF0ETNcg7fjkutu8YBWJptM3zxtu2Z,7GRhBDsirIGkRZBtSMEzNTyDr2JQm4xx,36,60,30,47,27,1,19,0,184,26.285714285714285,3,0.0,28,30,42,27,32,1,5,19,0,127,57,0
24,780,anqtRE1JbVfWjk9aVYgpNXBcTCoFe9WO,7GRhBDsirIGkRZBtSMEzNTyDr2JQm4xx,12,23,13,8,5,0,6,0,55,7.857142857142857,4,0.0,2,13,7,5,21,0,1,6,0,27,28,1
25,796,6gLqDWyaI2NtlxSWPzL6286Swi1mEUeL,7GRhBDsirIGkRZBtSMEzNTyDr2JQm4xx,2,0,0,0,0,0,2,0,2,0.2857142857142857,1,0.0,0,0,0,0,0,0,0,2,0,0,2,1
26,833,TOPojNiMH24da1PoGtHTHtr3v40hc02S,7GRhBDsirIGkRZBtSMEzNTyDr2JQm4xx,10,7,0,19,0,0,6,0,32,4.571428571428571,1,0.0,3,0,16,0,4,0,3,6,0,19,13,1
27,845,bY5BU72AucM53Ivc1aSf6rn9i7DKfcQZ,7GRhBDsirIGkRZBtSMEzNTyDr2JQm4xx,1,0,0,0,0,0,1,0,1,0.14285714285714285,1,0.0,0,0,0,0,0,0,0,1,0,0,1,1
28,884,c3CVim2QZeSVk1wACFUHDmf9ZjEIwtuP,7GRhBDsirIGkRZBtSMEzNTyDr2JQm4xx,32,46,17,54,9,0,7,0,133,19.0,1,0.0,29,17,47,9,17,0,7,7,0,102,31,0
29,936,Z4uUjFPFbGNbmcg4E2opeBQCoO0nQyZe,7GRhBDsirIGkRZBtSMEzNTyDr2JQm4xx,6,27,12,0,0,1,8,0,48,6.857142857142857,4,0.0,5,12,0,0,22,1,0,8,0,17,31,1
30,937,uQjl8NGtIQkRfoe9edBiMgtYYmdkzVXR,7GRhBDsirIGkRZBtSMEzNTyDr2JQm4xx,34,78,25,62,11,6,7,0,189,27.0,5,0.0,32,25,53,11,46,6,9,7,0,121,68,0
31,956,SIuVkNKTY2J1cPfs6wUSNXAjh8XyxgwI,7GRhBDsirIGkRZBtSMEzNTyDr2JQm4xx,1,0,0,0,0,0,1,0,1,0.14285714285714285,1,0.0,0,0,0,0,0,0,0,1,0,0,1,1
32,966,uVv1ioGVvP0A5CGQgSQhVTbH75lJRG4O,7GRhBDsirIGkRZBtSMEzNTyDr2JQm4xx,6,3,1,0,1,1,4,1,11,1.5714285714285714,2,0.0,0,1,0,1,3,1,0,4,1,2,9,1
33,991,HvUs11HJgqndKBOynrg9yliToxZs6PoS,7GRhBDsirIGkRZBtSMEzNTyDr2JQm4xx,20,26,12,0,10,0,3,0,51,7.285714285714286,1,0.0,6,12,0,10,20,0,0,3,0,28,23,0
34,999,sGrMSEzmd0nQ8tazrPYbRhLOuMlMN34w,7GRhBDsirIGkRZBtSMEzNTyDr2JQm4xx,5,4,2,0,0,0,5,0,11,1.5714285714285714,1,0.0,1,2,0,0,3,0,0,5,0,3,8,1
35,1030,uDdfaOyae5qLVYC8BQlj5xLhiV3is9wS,7GRhBDsirIGkRZBtSMEzNTyDr2JQm4xx,41,107,62,0,64,71,13,0,317,45.285714285714285,5,0.0,38,62,0,64,69,71,0,13,0,164,153,0
36,1052,db3m19q36pgCYtTdKoL3kV4Ubidysmpw,7GRhBDsirIGkRZBtSMEzNTyDr2JQm4xx,1,0,0,0,0,0,1,0,1,0.14285714285714285,1,0.0,0,0,0,0,0,0,0,1,0,0,1,1
37,1090,9ct6Fth9rRpjZJrFIHs9xOnW9W5hBHw6,7GRhBDsirIGkRZBtSMEzNTyDr2JQm4xx,27,51,19,75,3,3,5,0,156,22.285714285714285,1,0.0,27,19,66,3,24,3,9,5,0,115,41,1
38,1134,Q3zkClKdiEJIkoKspwBuSNOwYXuxalAX,7GRhBDsirIGkRZBtSMEzNTyDr2JQm4xx,32,46,15,16,10,6,14,0,107,15.285714285714286,3,0.0,22,15,16,10,24,6,0,14,0,63,44,1
39,1147,gCxbOVEJ7FeSqOiwKbB6HzPEL3I9x6ca,7GRhBDsirIGkRZBtSMEzNTyDr2JQm4xx,69,113,48,127,22,48,18,1,377,53.857142857142854,5,0.0,53,48,103,22,60,48,24,18,1,226,151,0
40,1206,ymJGsoe3Y9XwSfD9UhxMG8gRl87RdPUe,7GRhBDsirIGkRZBtSMEzNTyDr2JQm4xx,31,45,16,32,9,1,4,0,107,15.285714285714286,3,0.0,23,16,27,9,22,1,5,4,0,75,32,1
41,1223,o7MfiO1X5Ui1AYG08PXFhTcXSShcuNhK,7GRhBDsirIGkRZBtSMEzNTyDr2JQm4xx,26,17,13,32,11,0,4,0,77,11.0,2,0.0,3,13,28,11,14,0,4,4,0,55,22,0
42,1227,RuOAeaUVW53IP9AqfP0jxaXbNkmd7lKN,7GRhBDsirIGkRZBtSMEzNTyDr2JQm4xx,22,25,1,24,3,0,5,0,58,8.285714285714286,2,0.0,16,1,22,3,9,0,2,5,0,42,16,0
43,1252,mZIaM3Lmux7GERtSm258BKPOSUYFlwyy,7GRhBDsirIGkRZBtSMEzNTyDr2JQm4xx,30,61,15,41,15,0,7,0,139,19.857142857142858,5,0.0,22,15,36,15,39,0,5,7,0,88,51,0
44,1255,jB9rh6QoUWlta1KDWb4mdWzYIut8deHu,7GRhBDsirIGkRZBtSMEzNTyDr2JQm4xx,6,3,1,0,1,0,2,0,7,1.0,1,0.0,0,1,0,1,3,0,0,2,0,2,5,1
45,1260,beV03mdN2n7VoZwDqBMCKGETqOChXWUx,7GRhBDsirIGkRZBtSMEzNTyDr2JQm4xx,19,59,14,6,15,5,4,0,103,14.714285714285714,2,0.0,17,14,6,15,42,5,0,4,0,52,51,0
46,1269,RSJQ68OFisJaYDiRNDqeLSdLFyonAIP1,7GRhBDsirIGkRZBtSMEzNTyDr2JQm4xx,4,3,1,0,0,0,2,0,6,0.8571428571428571,1,0.0,0,1,0,0,3,0,0,2,0,1,5,1
47,1289,zlsPhArkUaQ0CCdgZTO1797WJjiciHBk,7GRhBDsirIGkRZBtSMEzNTyDr2JQm4xx,28,88,25,20,27,8,5,0,173,24.714285714285715,3,0.0,27,25,18,27,61,8,2,5,0,97,76,0
48,1315,kNG9cn23NW62SZcqQSqyW9wMtO0GajdN,7GRhBDsirIGkRZBtSMEzNTyDr2JQm4xx,20,24,8,36,11,2,1,0,82,11.714285714285714,2,0.0,14,8,33,11,10,2,3,1,0,66,16,0
49,1345,eyksoE4AUoKYBpwx782vtNzuK4dwKRY9,7GRhBDsirIGkRZBtSMEzNTyDr2JQm4xx,10,15,4,0,2,1,6,1,29,4.142857142857143,1,0.0,9,4,0,2,6,1,0,6,1,15,14,1
50,1381,8W0dKFntzVy5gs8nAvO6lyUGOY4SLHwO,7GRhBDsirIGkRZBtSMEzNTyDr2JQm4xx,4,2,0,0,0,0,2,0,4,0.5714285714285714,1,0.0,0,0,0,0,2,0,0,2,0,0,4,1
51,1429,YbP52dGau1RB8H6599HdGbUKOVHWxxw1,7GRhBDsirIGkRZBtSMEzNTyDr2JQm4xx,39,77,31,31,21,13,5,0,178,25.428571428571427,2,0.0,33,31,31,21,44,13,0,5,0,116,62,0
52,1450,q88579uTDrz7tsNTbZoL3mbWXAP4ClqK,7GRhBDsirIGkRZBtSMEzNTyDr2JQm4xx,28,54,20,38,4,14,10,6,146,20.857142857142858,3,0.0,29,20,33,4,25,14,5,10,6,86,60,0
53,1472,Qc7qhDYnMQ0se5itn8lyxOFjZ1zzyfhE,7GRhBDsirIGkRZBtSMEzNTyDr2JQm4xx,33,80,23,62,15,9,19,1,209,29.857142857142858,3,0.0,27,23,51,15,53,9,11,19,1,116,93,0
54,1491,lCyf3TRKW0i3K1mBgKz23OONMdCWqNsI,7GRhBDsirIGkRZBtSMEzNTyDr2JQm4xx,11,24,1,4,2,0,5,0,36,5.142857142857143,1,0.0,15,1,3,2,9,0,1,5,0,21,15,0
55,1502,1rAHmNrxrqnzHEQFMlydmQ968LsZW0oG,7GRhBDsirIGkRZBtSMEzNTyDr2JQm4xx,28,60,19,29,7,4,4,0,123,17.571428571428573,2,0.0,37,19,27,7,23,4,2,4,0,90,33,0
56,1529,DT600yQDJaU6nnkoEQdVx5gZnWz5FfNY,7GRhBDsirIGkRZBtSMEzNTyDr2JQm4xx,25,107,2,40,9,2,11,0,171,24.428571428571427,2,0.0,46,2,35,9,61,2,5,11,0,92,79,0
57,1541,Ydg0lHV8igjCQUoXTu9LI2axWzXgXWvH,7GRhBDsirIGkRZBtSMEzNTyDr2JQm4xx,5,2,1,0,0,0,3,0,6,0.8571428571428571,1,0.0,0,1,0,0,2,0,0,3,0,1,5,1
58,1576,d9rEzZ3v1PmiMyudpVDJ4ystf1RU9dCH,7GRhBDsirIGkRZBtSMEzNTyDr2JQm4xx,4,2,1,0,0,0,2,0,5,0.7142857142857143,1,0.0,0,1,0,0,2,0,0,2,0,1,4,1
59,1593,rLQXRKLwDTvBugA3fH8VUxASy31pAAsE,7GRhBDsirIGkRZBtSMEzNTyDr2JQm4xx,39,130,37,84,16,21,5,0,293,41.857142857142854,4,0.0,84,37,67,16,46,21,17,5,0,204,89,1
60,1594,argwyep7vMTLtgODtMQ0gxLXJNoq9csR,7GRhBDsirIGkRZBtSMEzNTyDr2JQm4xx,25,67,11,42,5,0,10,0,135,19.285714285714285,4,0.0,31,11,35,5,36,0,7,10,0,82,53,1
61,1616,Bi4hHmeTLwTbUCScu9tC6ZZN7frLUhVP,7GRhBDsirIGkRZBtSMEzNTyDr2JQm4xx,6,4,2,0,2,0,1,0,9,1.2857142857142858,1,0.0,0,2,0,2,4,0,0,1,0,4,5,0
62,1630,BN8wlDCfm46NLUt2P4jjdpJvase6IJc9,7GRhBDsirIGkRZBtSMEzNTyDr2JQm4xx,21,56,15,15,5,15,5,0,111,15.857142857142858,3,0.0,27,15,14,5,29,15,1,5,0,61,50,1
63,1651,iR2FNNwwVPECfrAWwxLxHcw8art5BqJj,7GRhBDsirIGkRZBtSMEzNTyDr2JQm4xx,28,22,9,38,11,0,2,0,82,11.714285714285714,1,0.0,10,9,36,11,12,0,2,2,0,66,16,0
64,1685,rAPaguNT0tnoFK76JileqLEbVcmAD9at,7GRhBDsirIGkRZBtSMEzNTyDr2JQm4xx,1,0,0,0,0,0,1,0,1,0.14285714285714285,1,0.0,0,0,0,0,0,0,0,1,0,0,1,1
65,1697,LdIFMEp4Gma3xMuOQ2mpp1BJ3jFvB9c2,7GRhBDsirIGkRZBtSMEzNTyDr2JQm4xx,13,19,8,10,3,0,2,0,42,6.0,1,0.0,5,8,8,3,14,0,2,2,0,24,18,0
66,1708,PVIjAE0m0OeJAYOHc5gIjzktRijtXdS4,7GRhBDsirIGkRZBtSMEzNTyDr2JQm4xx,20,21,8,29,10,0,2,0,70,10.0,1,0.0,11,8,24,10,10,0,5,2,0,53,17,1
67,1724,yXGb0Kuxvr3gyMDMjDKW3Llv1qZCYjSd,7GRhBDsirIGkRZBtSMEzNTyDr2JQm4xx,1,0,0,0,0,0,1,0,1,0.14285714285714285,1,0.0,0,0,0,0,0,0,0,1,0,0,1,1
68,1728,B6EpScn9lSCPa3RR6ElGV7QvO5jse6Q3,7GRhBDsirIGkRZBtSMEzNTyDr2JQm4xx,1,0,0,0,0,0,1,0,1,0.14285714285714285,1,0.0,0,0,0,0,0,0,0,1,0,0,1,1
69,1755,qLrXKwo0jPQz47eKqKRnMiywjqEMxYd1,7GRhBDsirIGkRZBtSMEzNTyDr2JQm4xx,2,0,0,0,0,0,2,0,2,0.2857142857142857,1,0.0,0,0,0,0,0,0,0,2,0,0,2,0
70,1756,wc32nzp9MMjroUa1gifXyCPIfYwLXy9J,7GRhBDsirIGkRZBtSMEzNTyDr2JQm4xx,5,8,4,0,3,0,1,0,16,2.2857142857142856,4,0.0,0,4,0,3,8,0,0,1,0,7,9,1
71,1788,ZsmdkNcVTPviDi6RDTzc0nnIspFki9Ld,7GRhBDsirIGkRZBtSMEzNTyDr2JQm4xx,17,20,5,14,4,0,5,0,48,6.857142857142857,3,0.0,12,5,13,4,8,0,1,5,0,34,14,0
72,1801,wy2vY5aiYwg0C5zglGAXrG2vaWLSbGC9,fbPkOYLVPtPgIt0MxizjfFJov3JbHyAi,7,3,2,0,2,0,2,0,9,1.2857142857142858,1,0.0,0,2,0,2,3,0,0,2,0,4,5,1
73,1803,MlHPKmdi90dDdvX24jYoFlYEp8xS4RGn,fbPkOYLVPtPgIt0MxizjfFJov3JbHyAi,4,0,0,0,0,0,4,0,4,0.5714285714285714,1,0.0,0,0,0,0,0,0,0,4,0,0,4,1
74,1804,qRMvc4T53dkwmyfrgm76E5HygPUZo2vr,fbPkOYLVPtPgIt0MxizjfFJov3JbHyAi,22,60,29,17,16,41,19,0,182,26.0,7,0.0,15,29,14,16,45,41,3,19,0,74,108,0
75,1807,tvXgoUvFgvHT9SyDah6Ue0bK2mvIbZdy,fbPkOYLVPtPgIt0MxizjfFJov3JbHyAi,33,57,36,31,11,27,12,0,174,24.857142857142858,4,0.0,14,36,23,11,43,27,8,12,0,84,90,0
76,1815,EZXku3HiM8iDGMBMsO2RMLHj3AEpHhBq,fbPkOYLVPtPgIt0MxizjfFJov3JbHyAi,7,13,3,0,3,0,1,0,20,2.857142857142857,1,0.0,3,3,0,3,10,0,0,1,0,9,11,0
77,1817,bXMaalfz1ZqHKnJWw6VXCAoemSeuw45Q,fbPkOYLVPtPgIt0MxizjfFJov3JbHyAi,2,0,0,0,0,0,2,0,2,0.2857142857142857,1,0.0,0,0,0,0,0,0,0,2,0,0,2,0
78,1818,pIBqJuNsqTHvkyItKwWF6wLVRjCC6EZu,fbPkOYLVPtPgIt0MxizjfFJov3JbHyAi,8,10,5,0,2,0,2,0,19,2.7142857142857144,1,0.0,2,5,0,2,8,0,0,2,0,9,10,1
79,1821,dovSPYooNHmzLLH97Ddy4FG7Uxhw5XJl,fbPkOYLVPtPgIt0MxizjfFJov3JbHyAi,5,4,2,0,1,0,1,0,8,1.1428571428571428,1,0.0,0,2,0,1,4,0,0,1,0,3,5,1
80,1822,v1Dw0XqubI6wLrO1l5puralkQ2Aofi2j,fbPkOYLVPtPgIt0MxizjfFJov3JbHyAi,28,46,21,26,10,76,26,8,213,30.428571428571427,5,0.0,14,21,20,10,32,76,6,26,8,65,148,0
81,1826,5BwluL2iwK0HgKhM8FgXFAWZQHsXkB8V,fbPkOYLVPtPgIt0MxizjfFJov3JbHyAi,36,55,10,24,8,39,23,3,162,23.142857142857142,5,0.0,14,10,23,8,41,39,1,23,3,55,107,0
82,1827,tfcv93vJo2GySad9H44VOkIGpLaZ6vJT,fbPkOYLVPtPgIt0MxizjfFJov3JbHyAi,17,31,14,15,8,7,9,0,84,12.0,2,0.0,12,14,11,8,19,7,4,9,0,45,39,0
83,1832,IIfD9UPHJEG512IBEQGZwkZbr6HRQ12X,fbPkOYLVPtPgIt0MxizjfFJov3JbHyAi,9,2,2,0,2,6,12,0,24,3.4285714285714284,2,0.0,0,2,0,2,2,6,0,12,0,4,20,1
84,1844,FSrU0Uh74oBwrZKS577R74m2Rk2Lst8A,fbPkOYLVPtPgIt0MxizjfFJov3JbHyAi,12,11,9,0,7,0,9,0,36,5.142857142857143,1,0.0,0,9,0,7,11,0,0,9,0,16,20,1
85,1845,oaoj9be4jW2Hot8wYgYrzLRvB0RU4KYy,fbPkOYLVPtPgIt0MxizjfFJov3JbHyAi,3,7,3,0,0,0,2,0,12,1.7142857142857142,2,0.0,0,3,0,0,7,0,0,2,0,3,9,0
86,1856,ScOtpH9Zf7UmvFfXBxi9XtXFmhGO9CpS,fbPkOYLVPtPgIt0MxizjfFJov3JbHyAi,23,36,19,20,9,30,18,1,133,19.0,4,0.0,5,19,18,9,31,30,2,18,1,51,82,0
87,1859,renLevNnf6MkkqeGAoBcuGxp4Cuebb9X,fbPkOYLVPtPgIt0MxizjfFJov3JbHyAi,17,28,15,13,9,17,20,2,104,14.857142857142858,3,0.0,6,15,10,9,22,17,3,20,2,40,64,0
88,1861,wHW6M4zJx3WQvnkWxa8NK7bA13uSffjE,fbPkOYLVPtPgIt0MxizjfFJov3JbHyAi,37,143,87,19,40,72,23,5,389,55.57142857142857,6,0.0,36,87,17,40,107,72,2,23,5,180,209,0
89,1862,w85QVmINOIyrXRzegh8uuBeGTw3K4uG8,fbPkOYLVPtPgIt0MxizjfFJov3JbHyAi,1,0,0,0,0,0,1,0,1,0.14285714285714285,1,0.0,0,0,0,0,0,0,0,1,0,0,1,0
90,1863,2HxHgYZUxjcTVAkRZXALZPpAKp12AIkW,fbPkOYLVPtPgIt0MxizjfFJov3JbHyAi,24,29,11,2,10,0,3,0,55,7.857142857142857,3,0.0,5,11,1,10,24,0,1,3,0,27,28,1
91,1878,0UPVw8ecIiIpfGXqAIUJXTbKxiiOJqXC,fbPkOYLVPtPgIt0MxizjfFJov3JbHyAi,12,17,8,4,6,4,3,0,42,6.0,2,0.0,2,8,3,6,15,4,1,3,0,19,23,1
92,1880,DSWjfYVjIvEWi0MzNQ04NT3mnhbcHkJI,fbPkOYLVPtPgIt0MxizjfFJov3JbHyAi,18,9,8,0,7,0,2,0,26,3.7142857142857144,1,0.0,0,8,0,7,9,0,0,2,0,15,11,0
93,1891,s6iksgptFmyh2vfiarKdJkiKnp6RLi3f,fbPkOYLVPtPgIt0MxizjfFJov3JbHyAi,8,5,1,0,1,23,4,0,34,4.857142857142857,2,0.0,0,1,0,1,5,23,0,4,0,2,32,0
94,1894,Vc4rFh1HQZiO6qLgOrealEeiZYYPbmOY,fbPkOYLVPtPgIt0MxizjfFJov3JbHyAi,35,61,28,42,12,28,8,0,179,25.571428571428573,5,0.0,11,28,35,12,50,28,7,8,0,86,93,0
95,1899,CXDFvBGg10x2RDdl5BC09Fv76dN9FJm7,fbPkOYLVPtPgIt0MxizjfFJov3JbHyAi,24,42,12,22,10,14,10,0,110,15.714285714285714,2,0.0,15,12,22,10,27,14,0,10,0,59,51,0
96,1903,TkQQvYTOoXkFjbJKIO2v3OeQa3imG4fA,fbPkOYLVPtPgIt0MxizjfFJov3JbHyAi,26,58,26,12,16,76,24,1,213,30.428571428571427,5,0.0,25,26,10,16,33,76,2,24,1,77,136,0
97,1910,CtgLRd04Cnda49EWlN19NulXjkuBNDXd,fbPkOYLVPtPgIt0MxizjfFJov3JbHyAi,21,24,9,16,9,9,2,0,69,9.857142857142858,1,0.0,13,9,14,9,11,9,2,2,0,45,24,0
98,1922,ddq0oVEKEWGKWnbGS4cfbzVZj0yFimxw,fbPkOYLVPtPgIt0MxizjfFJov3JbHyAi,28,23,19,10,15,0,5,0,72,10.285714285714286,2,0.0,2,19,7,15,21,0,3,5,0,43,29,0
99,1923,UgNr6maIjrTPAjpLAvEGxJ6P02hrpr0j,fbPkOYLVPtPgIt0MxizjfFJov3JbHyAi,24,53,21,18,16,6,7,0,121,17.285714285714285,5,0.0,11,21,17,16,42,6,1,7,0,65,56,0
100,1931,gUUf0vmNg6gEFqYol91VXQX0Cn6Mly3v,fbPkOYLVPtPgIt0MxizjfFJov3JbHyAi,29,77,58,9,36,60,0,0,240,34.285714285714285,5,0.0,13,58,9,36,64,60,0,0,0,116,124,0
101,1933,mNLR1O6gqXF6Zqi4uIf130gITni9gN1A,fbPkOYLVPtPgIt0MxizjfFJov3JbHyAi,41,70,38,17,17,18,15,2,177,25.285714285714285,5,0.0,13,38,17,17,57,18,0,15,2,85,92,0
102,1936,YLLq9nLffaF9TP2dJ2OpMZwhKv5cSnoB,fbPkOYLVPtPgIt0MxizjfFJov3JbHyAi,13,16,7,2,6,2,1,0,34,4.857142857142857,1,0.0,5,7,2,6,11,2,0,1,0,20,14,1
103,1940,a7VEIs7rhyootOFOxpi9zJBtM0N2POJ5,fbPkOYLVPtPgIt0MxizjfFJov3JbHyAi,4,2,1,0,1,0,1,0,5,0.7142857142857143,1,0.0,0,1,0,1,2,0,0,1,0,2,3,1
104,1943,S1MqxZA8wNnn30FSBfJ8uK4pTicj2Ko9,fbPkOYLVPtPgIt0MxizjfFJov3JbHyAi,12,26,17,2,3,14,10,2,74,10.571428571428571,4,0.0,1,17,2,3,25,14,0,10,2,23,51,0
105,1945,KM3IAf1A23ZYRH7BjTN3a6rzUKD52rd8,fbPkOYLVPtPgIt0MxizjfFJov3JbHyAi,4,2,1,0,0,0,3,0,6,0.8571428571428571,1,0.0,0,1,0,0,2,0,0,3,0,1,5,1
106,1951,dq3iqibSI5OSwCbWRZv7tfgbiuLwOgjh,fbPkOYLVPtPgIt0MxizjfFJov3JbHyAi,12,11,5,0,3,0,1,0,20,2.857142857142857,1,0.0,0,5,0,3,11,0,0,1,0,8,12,0
107,3986,lri3Bm6mGdJ1wEpJO4c8fcTdLtxpvXa6,fbPkOYLVPtPgIt0MxizjfFJov3JbHyAi,30,89,26,27,12,42,19,1,216,30.857142857142858,3,0.0,30,26,25,12,59,42,2,19,1,93,123,0
108,3989,WQvAdilRxsksKqQWzKEILUwddYnT927z,fbPkOYLVPtPgIt0MxizjfFJov3JbHyAi,6,10,3,0,2,0,3,0,18,2.5714285714285716,1,0.0,0,3,0,2,10,0,0,3,0,5,13,1
109,3993,LBiRwhykvYlkPokFukwKE3pfXRl4e4Nw,fbPkOYLVPtPgIt0MxizjfFJov3JbHyAi,4,7,4,0,0,0,2,0,13,1.8571428571428572,1,0.0,0,4,0,0,7,0,0,2,0,4,9,1
110,3994,CAJTHZgER1cUEaMoS6UrUkuHNZZbsU9M,fbPkOYLVPtPgIt0MxizjfFJov3JbHyAi,20,23,10,23,8,8,1,0,73,10.428571428571429,1,0.0,10,10,19,8,13,8,4,1,0,47,26,1
111,3999,4IkxYjTflPhoHxhEdrFyf3T4ZXNMTaKd,fbPkOYLVPtPgIt0MxizjfFJov3JbHyAi,11,20,11,2,3,0,5,0,41,5.857142857142857,1,0.0,5,11,2,3,15,0,0,5,0,21,20,0
112,4001,NKzNFHK6LaJqjMec69ZX5HfBigF4yyJV,fbPkOYLVPtPgIt0MxizjfFJov3JbHyAi,2,0,0,0,0,9,1,0,10,1.4285714285714286,1,0.0,0,0,0,0,0,9,0,1,0,0,10,1
113,4006,McVFksjsd7gqjfpNdRYswxB6Ly7zMDUI,fbPkOYLVPtPgIt0MxizjfFJov3JbHyAi,9,9,5,4,2,20,11,1,52,7.428571428571429,1,0.0,2,5,2,2,7,20,2,11,1,11,41,1
114,4016,0OQWZBG0W4kepi8nreWMZMMypwSc3KLe,fbPkOYLVPtPgIt0MxizjfFJov3JbHyAi,27,43,26,16,12,29,5,0,131,18.714285714285715,3,0.0,13,26,14,12,30,29,2,5,0,65,66,0
115,4019,dFrBZuKOTxv7Ek84BAuACScgZVHLiPRz,fbPkOYLVPtPgIt0MxizjfFJov3JbHyAi,25,76,43,15,24,36,10,0,204,29.142857142857142,3,0.0,15,43,12,24,61,36,3,10,0,94,110,0
116,4021,2txyeJeVHewFPGKztIs7LVNsRtu62SIj,fbPkOYLVPtPgIt0MxizjfFJov3JbHyAi,9,8,4,10,2,0,2,0,26,3.7142857142857144,2,0.0,2,4,9,2,6,0,1,2,0,17,9,0
117,4024,UInMBEH8f1h2vxXVslRsWyLOTv8ggYq3,fbPkOYLVPtPgIt0MxizjfFJov3JbHyAi,38,43,24,0,15,43,7,0,132,18.857142857142858,3,0.0,8,24,0,15,35,43,0,7,0,47,85,0
118,4028,BJaK31XM4DCMgldXltRIhwlSVt79ImvN,fbPkOYLVPtPgIt0MxizjfFJov3JbHyAi,1,0,0,0,0,0,1,0,1,0.14285714285714285,1,0.0,0,0,0,0,0,0,0,1,0,0,1,1
119,4031,l5LfU8gApOG72AnBkdAbfOLQLwFH7Zo2,fbPkOYLVPtPgIt0MxizjfFJov3JbHyAi,5,5,1,0,0,6,3,0,15,2.142857142857143,2,0.0,0,1,0,0,5,6,0,3,0,1,14,0
120,4042,03I1lWZt67ECKkJOIVeqAmBCKjZopH4v,fbPkOYLVPtPgIt0MxizjfFJov3JbHyAi,6,4,3,0,1,0,2,0,10,1.4285714285714286,2,0.0,0,3,0,1,4,0,0,2,0,4,6,1
121,4054,hOv5RKQK1RGRxpJJGcW0k2cA3RwQ8Rk5,fbPkOYLVPtPgIt0MxizjfFJov3JbHyAi,7,6,4,0,1,5,2,0,18,2.5714285714285716,1,0.0,1,4,0,1,5,5,0,2,0,6,12,1
122,4062,GfQva8AQrZlwGbvyDGDInKzkvq0dln6l,fbPkOYLVPtPgIt0MxizjfFJov3JbHyAi,5,3,2,0,1,0,1,0,7,1.0,1,0.0,0,2,0,1,3,0,0,1,0,3,4,1
123,4064,IhporhjBpD87E7pLhYtc9YRC8PipZyt6,fbPkOYLVPtPgIt0MxizjfFJov3JbHyAi,6,6,3,0,1,0,4,0,14,2.0,2,0.0,1,3,0,1,5,0,0,4,0,5,9,1
124,4070,bUizg9a7xaQ9xo39EDPwubco3asipi0e,fbPkOYLVPtPgIt0MxizjfFJov3JbHyAi,23,11,10,0,8,0,6,1,36,5.142857142857143,1,0.0,0,10,0,8,11,0,0,6,1,18,18,1
125,4071,HH3HV5HDJ35z2ldQAEIDXBOSBTxLd6O9,fbPkOYLVPtPgIt0MxizjfFJov3JbHyAi,22,23,16,12,6,13,9,0,79,11.285714285714286,3,0.0,4,16,10,6,19,13,2,9,0,36,43,1
126,4072,kHp5QZURLzbWn4koqFYZnQmO0kliz5hb,fbPkOYLVPtPgIt0MxizjfFJov3JbHyAi,25,36,22,9,7,24,10,1,109,15.571428571428571,5,0.0,7,22,8,7,29,24,1,10,1,44,65,0
127,4077,reYWWuBxz5Nnxq3jAGjfGe1NyMEEto5R,fbPkOYLVPtPgIt0MxizjfFJov3JbHyAi,7,7,2,0,0,4,7,8,28,4.0,2,0.0,0,2,0,0,7,4,0,7,8,2,26,1
128,4083,5tD3trtPQ6jzqFRimP1PMPhgvFtRmfA4,fbPkOYLVPtPgIt0MxizjfFJov3JbHyAi,10,50,1,5,3,0,6,0,65,9.285714285714286,3,0.0,10,1,4,3,40,0,1,6,0,18,47,1
129,4095,ijFjDmHOLiyu54Ko0v4roRDWdDCIX5i1,fbPkOYLVPtPgIt0MxizjfFJov3JbHyAi,30,37,24,3,17,0,6,0,87,12.428571428571429,5,0.0,6,24,3,17,31,0,0,6,0,50,37,0
130,4105,VJ15PTmNAjfB6ipRCoKMs7aSjJuraSNv,fbPkOYLVPtPgIt0MxizjfFJov3JbHyAi,15,20,10,4,2,7,2,0,45,6.428571428571429,2,0.0,2,10,4,2,18,7,0,2,0,18,27,1
131,4114,XqcIbo9pkzTiouZzC4CsMH0T57ZrJT7c,fbPkOYLVPtPgIt0MxizjfFJov3JbHyAi,8,7,3,11,2,0,1,0,24,3.4285714285714284,1,0.0,3,3,8,2,4,0,3,1,0,16,8,1
132,4122,Uo5Is5U7melZAv7xg2Req57LK7O8TGT8,fbPkOYLVPtPgIt0MxizjfFJov3JbHyAi,17,14,9,0,4,0,4,1,32,4.571428571428571,1,0.0,0,9,0,4,14,0,0,4,1,13,19,1
133,4124,gml56PidNECJRV7FxBwKkFjPhRALq3yM,fbPkOYLVPtPgIt0MxizjfFJov3JbHyAi,7,3,2,0,1,0,6,0,12,1.7142857142857142,1,0.0,0,2,0,1,3,0,0,6,0,3,9,1
134,4126,u4TNxfYOFL4kSz0gq3emLn9aOKma8Z0X,fbPkOYLVPtPgIt0MxizjfFJov3JbHyAi,7,3,3,3,0,0,0,0,9,1.2857142857142858,2,0.0,0,3,3,0,3,0,0,0,0,6,3,1
135,4127,iMXZvpdXIEwupZ3KLZs1wDk19TeUIZDi,fbPkOYLVPtPgIt0MxizjfFJov3JbHyAi,6,10,7,0,0,29,4,0,50,7.142857142857143,1,0.0,0,7,0,0,10,29,0,4,0,7,43,1
136,4129,Xl7O5Es6VpkB2PrTgzArkv7OwJ7XzlEg,fbPkOYLVPtPgIt0MxizjfFJov3JbHyAi,13,19,3,0,3,3,9,1,38,5.428571428571429,2,0.0,2,3,0,3,17,3,0,9,1,8,30,1
137,4133,sT9hGAnww95aeGvqwQpJlS3ORhWDT49F,fbPkOYLVPtPgIt0MxizjfFJov3JbHyAi,40,46,23,22,16,6,10,0,123,17.571428571428573,4,0.0,19,23,20,16,27,6,2,10,0,78,45,0
138,4136,WfTazznjeVMuts1c6fhfvqWuaprKs7C3,fbPkOYLVPtPgIt0MxizjfFJov3JbHyAi,19,14,11,0,8,8,7,2,50,7.142857142857143,2,0.0,0,11,0,8,14,8,0,7,2,19,31,1
139,4137,Z9qi5pq1C1bndfjP0mrTCfL8YAf6Qiv7,fbPkOYLVPtPgIt0MxizjfFJov3JbHyAi,10,10,5,0,2,0,5,1,23,3.2857142857142856,1,0.0,0,5,0,2,10,0,0,5,1,7,16,0
140,4143,9sFMHkQmozo76x80tFTC9ms1LtFpAvDD,fbPkOYLVPtPgIt0MxizjfFJov3JbHyAi,26,39,12,35,18,19,9,0,132,18.857142857142858,3,0.0,25,12,26,18,14,19,9,9,0,81,51,0
141,4148,V2KAeU5M9aZ71MSOJMPq9O99rHGzmKaR,fbPkOYLVPtPgIt0MxizjfFJov3JbHyAi,5,10,3,0,2,0,1,0,16,2.2857142857142856,2,0.0,0,3,0,2,10,0,0,1,0,5,11,1
142,4155,82WiuHoB3dVqYkf2UKsu9ogC0IsQQnqa,fbPkOYLVPtPgIt0MxizjfFJov3JbHyAi,10,41,11,1,4,3,7,0,67,9.571428571428571,3,0.0,9,11,1,4,32,3,0,7,0,25,42,1
143,4163,PBd2c59pI8ZCJwc4iQjHYNeQj4K3oGvT,fbPkOYLVPtPgIt0MxizjfFJov3JbHyAi,7,5,3,0,2,0,1,0,11,1.5714285714285714,1,0.0,0,3,0,2,5,0,0,1,0,5,6,1
144,4171,uHgH8m4GJET0eE5mE8JCyLZD7HEKwM4t,SpATywNh6bZuzm8s1ceuBUnMUAeoAHHw,14,30,12,9,2,13,12,0,78,11.142857142857142,4,0.0,9,12,8,2,21,13,1,12,0,31,47,0
145,4182,HgeZmyLysCZF827lPwLNCfqcskKVvNDd,SpATywNh6bZuzm8s1ceuBUnMUAeoAHHw,4,3,1,0,0,0,2,0,6,0.8571428571428571,1,0.0,0,1,0,0,3,0,0,2,0,1,5,0
146,4218,EReWp6ilgaQY61GGX2jAkIc5IQisheJq,SpATywNh6bZuzm8s1ceuBUnMUAeoAHHw,8,8,4,0,3,0,3,0,18,2.5714285714285716,2,0.0,0,4,0,3,8,0,0,3,0,7,11,1
147,4237,SVFfJJhaWd2RlHPtvg5SWBRGj8N0paMQ,SpATywNh6bZuzm8s1ceuBUnMUAeoAHHw,14,17,1,20,0,0,5,0,43,6.142857142857143,2,0.0,8,1,17,0,9,0,3,5,0,26,17,0
148,4238,hevZgCUVQAVwtaivzco7bLaVpTOAAfiG,SpATywNh6bZuzm8s1ceuBUnMUAeoAHHw,26,31,17,18,10,1,7,0,84,12.0,2,0.0,9,17,15,10,22,1,3,7,0,51,33,0
149,4243,83p9ejSELsW1j5wNlAyUXF2YWFL8Z8tc,A3fsA9Zfv1X2fVEQhTw51lKENdNrEqT3,66,32,16,118,13,1,12,0,192,27.428571428571427,3,0.0,2,16,112,13,30,1,6,12,0,143,49,0
150,4247,0NGZq9HZW5KOrSfzSGGipuN20pCRDMWu,G8EPVSXsOYB5YQWZGiz1aVq5Pgr2GrQu,14,25,12,3,9,11,3,0,63,9.0,1,0.0,12,12,3,9,13,11,0,3,0,36,27,0
151,4250,DHUv7XpIZcPp2QYGNmTXjhgg7Zq4BpJ7,SpATywNh6bZuzm8s1ceuBUnMUAeoAHHw,16,12,9,2,6,0,4,0,33,4.714285714285714,2,0.0,1,9,2,6,11,0,0,4,0,18,15,1
152,4254,J5PQMceXoOVyN05md7NqKfAhSfcgJgVJ,SpATywNh6bZuzm8s1ceuBUnMUAeoAHHw,13,24,1,18,0,31,5,0,79,11.285714285714286,3,0.0,10,1,15,0,14,31,3,5,0,26,53,0
153,4268,nYFWhKbFKiXgZ193lmJEmg3xQ65UNrPv,SpATywNh6bZuzm8s1ceuBUnMUAeoAHHw,10,10,4,6,1,0,1,0,22,3.142857142857143,2,0.0,4,4,6,1,6,0,0,1,0,15,7,1
154,4278,iVNWfvqx80bYGUpxbD5kOVH2Fugs6QtQ,SpATywNh6bZuzm8s1ceuBUnMUAeoAHHw,18,23,15,6,9,2,3,0,58,8.285714285714286,1,0.0,4,15,6,9,19,2,0,3,0,34,24,0
155,4286,i9UIJe9BPLqUSVYMtAIMhpSeBf6cbruQ,SpATywNh6bZuzm8s1ceuBUnMUAeoAHHw,15,21,9,11,4,0,5,0,50,7.142857142857143,2,0.0,8,9,11,4,13,0,0,5,0,32,18,0
156,4291,UTQBVZwwRuN7bMqGkwJeqpNJF2PPrsFV,A3fsA9Zfv1X2fVEQhTw51lKENdNrEqT3,18,12,9,0,8,0,2,0,31,4.428571428571429,1,0.0,0,9,0,8,12,0,0,2,0,17,14,0
157,4292,5IOZn10arhSe83Sz47oGoyNxbAFXZkA2,SpATywNh6bZuzm8s1ceuBUnMUAeoAHHw,8,23,7,0,2,5,6,0,43,6.142857142857143,3,0.0,2,7,0,2,21,5,0,6,0,11,32,1
158,4313,l80sDXQh6tFmRSRsJvWJgP55drvQUfT2,SpATywNh6bZuzm8s1ceuBUnMUAeoAHHw,16,25,10,14,6,0,4,0,59,8.428571428571429,2,0.0,11,10,13,6,14,0,1,4,0,40,19,1
159,4327,glS180WZt8C6hB13WP6NUijid7zN96cg,SpATywNh6bZuzm8s1ceuBUnMUAeoAHHw,20,36,13,22,1,0,4,0,76,10.857142857142858,3,0.0,18,13,20,1,18,0,2,4,0,52,24,0
160,4342,gqe5NXbZbf5uXY0rPviLeIFOMpQyekdp,G8EPVSXsOYB5YQWZGiz1aVq5Pgr2GrQu,24,31,2,30,3,16,10,0,92,13.142857142857142,3,0.0,0,2,26,3,31,16,4,10,0,31,61,1
161,4352,3OBHdoV61de7ICMrnWAXr689Eb2AyuN0,SpATywNh6bZuzm8s1ceuBUnMUAeoAHHw,19,18,7,20,5,2,6,0,58,8.285714285714286,2,0.0,7,7,16,5,11,2,4,6,0,35,23,0
162,4361,jygZDxdNc5vnyQVPVME6xQbLWCY2Zptq,SpATywNh6bZuzm8s1ceuBUnMUAeoAHHw,6,9,5,0,5,0,5,0,24,3.4285714285714284,1,0.0,0,5,0,5,9,0,0,5,0,10,14,1
163,4395,C6xrhZPOmVH2gCVNP26gSSPka2CcwgB5,SpATywNh6bZuzm8s1ceuBUnMUAeoAHHw,12,9,4,6,1,0,6,0,26,3.7142857142857144,2,0.0,4,4,6,1,5,0,0,6,0,15,11,1
164,4396,5c5BMuD35oybcLij9FEBpLM3FZXJ5QAD,G8EPVSXsOYB5YQWZGiz1aVq5Pgr2GrQu,35,85,4,25,0,23,15,6,158,22.571428571428573,3,0.0,4,4,22,0,81,23,3,15,6,30,128,0
165,4406,U0MChqulsymiJYCtbj873TXGFuXiZDFk,SpATywNh6bZuzm8s1ceuBUnMUAeoAHHw,18,18,14,6,8,0,5,0,51,7.285714285714286,3,0.0,2,14,6,8,16,0,0,5,0,30,21,0
166,4430,sWkTuB7KUS6C7uaxH84rlQvKN8aRF9JC,bWdj2GDclj5ofokWjzoa5jAwMkxCykd6,6,4,2,0,1,0,6,0,13,1.8571428571428572,2,0.0,0,2,0,1,4,0,0,6,0,3,10,1
167,4435,bN6JhUz4s97Xsh7eq2ZH1ilTMaKJDuUF,bWdj2GDclj5ofokWjzoa5jAwMkxCykd6,25,59,16,75,1,13,14,1,179,25.571428571428573,4,0.0,8,16,65,1,51,13,10,14,1,90,89,0
168,4440,ZhTCqX8GMUcn0a0betuEauHNuCk1aRhm,bWdj2GDclj5ofokWjzoa5jAwMkxCykd6,25,65,23,74,9,65,13,0,249,35.57142857142857,3,0.0,9,23,64,9,56,65,10,13,0,105,144,0
169,4453,4sZlPbPnBCwNHbrOUXcVAiPkTKHriJTV,SpATywNh6bZuzm8s1ceuBUnMUAeoAHHw,16,26,1,17,0,5,11,1,61,8.714285714285714,3,0.0,6,1,16,0,20,5,1,11,1,23,38,0
170,4454,lMy0A59BRo4770ALzvOjsBS5HJkCRV78,bWdj2GDclj5ofokWjzoa5jAwMkxCykd6,22,37,0,56,0,15,18,0,126,18.0,4,0.0,4,0,49,0,33,15,7,18,0,53,73,1
171,4481,XjrP1VAGwJCwkRm4KgImIkZYNjnvGQN9,RXDvfPUBYFlVdlueBFbLW0mhhAyGEqpt,31,87,33,48,23,28,57,23,299,42.714285714285715,7,0.0,18,33,42,23,69,28,6,57,23,116,183,0
172,4498,dxoTIhhPXBvqzWGLltH0slJdxsuyggjI,G8EPVSXsOYB5YQWZGiz1aVq5Pgr2GrQu,36,26,20,0,15,19,10,0,90,12.857142857142858,4,0.0,1,20,0,15,25,19,0,10,0,36,54,0
173,4499,2ZP4iw9joeRPfEuWLWQQFnKchFtuqx5l,SpATywNh6bZuzm8s1ceuBUnMUAeoAHHw,3,0,1,0,0,0,2,0,3,0.42857142857142855,1,0.0,0,1,0,0,0,0,0,2,0,1,2,0
174,4506,j1jdy8OF5VQw4rqSYOkbK2pQplvvvz37,G8EPVSXsOYB5YQWZGiz1aVq5Pgr2GrQu,29,38,2,52,0,40,31,0,163,23.285714285714285,7,0.0,0,2,44,0,38,40,8,31,0,46,117,0
175,4507,HuDaXYBstQFpbEGg5tkyPhxLKzB3hVSB,SpATywNh6bZuzm8s1ceuBUnMUAeoAHHw,19,58,27,24,6,17,25,0,157,22.428571428571427,7,0.0,16,27,18,6,42,17,6,25,0,67,90,0
176,4524,j1jdy8OF5VQw4rqSYOkbK2pQplvvvz37,bWdj2GDclj5ofokWjzoa5jAwMkxCykd6,24,32,2,59,0,6,19,0,118,16.857142857142858,6,0.0,2,2,46,0,30,6,13,19,0,50,68,1
177,4548,kla9cpzzaIqMfwRx5dULfeceoZisiJXJ,SpATywNh6bZuzm8s1ceuBUnMUAeoAHHw,23,58,18,17,9,31,32,4,169,24.142857142857142,5,0.0,26,18,14,9,32,31,3,32,4,67,102,0
178,4571,PUW0i4IuafllkJEtV0GCqmTDeLHkDmH3,bWdj2GDclj5ofokWjzoa5jAwMkxCykd6,25,36,8,64,4,65,18,2,197,28.142857142857142,5,0.0,4,8,50,4,32,65,14,18,2,66,131,0
179,4585,HqsJVGNbokPBStWiDvKZXbvoLlDHixpp,SpATywNh6bZuzm8s1ceuBUnMUAeoAHHw,22,31,3,24,1,0,7,0,66,9.428571428571429,1,0.0,14,3,21,1,17,0,3,7,0,39,27,0
180,4598,izDb8XjXh0aaLsv56xtUKjGq4nGYtog4,G8EPVSXsOYB5YQWZGiz1aVq5Pgr2GrQu,48,119,64,48,23,49,47,12,362,51.714285714285715,3,0.0,34,64,24,23,85,49,24,47,12,145,217,0
181,4610,sZNhT3IqtfFMwMod3w0cGQK1HKvrIFwI,SpATywNh6bZuzm8s1ceuBUnMUAeoAHHw,16,8,6,4,5,0,3,0,26,3.7142857142857144,1,0.0,0,6,4,5,8,0,0,3,0,15,11,1
182,4613,aVE6FAaI67jjqObdfL3BkKQUvDsOp43M,SpATywNh6bZuzm8s1ceuBUnMUAeoAHHw,29,53,37,14,14,36,26,1,181,25.857142857142858,2,0.0,7,37,12,14,46,36,2,26,1,70,111,0
183,4614,D77mYRAEHVmHmrch91cWflZwkGfWXMn3,SpATywNh6bZuzm8s1ceuBUnMUAeoAHHw,16,33,6,0,5,0,8,0,52,7.428571428571429,4,0.0,0,6,0,5,33,0,0,8,0,11,41,1
184,4625,qRy2DimM9SNsqYvrYrrnIw2oQKcYB3wP,SpATywNh6bZuzm8s1ceuBUnMUAeoAHHw,21,33,1,27,1,0,6,0,68,9.714285714285714,4,0.0,8,1,23,1,25,0,4,6,0,33,35,0
185,4641,8oxFWBumsNA4SJ0CIJujNkjFW8ZzMgtQ,SpATywNh6bZuzm8s1ceuBUnMUAeoAHHw,5,2,0,0,0,10,8,0,20,2.857142857142857,1,0.0,0,0,0,0,2,10,0,8,0,0,20,0
186,4647,MKlpymF14KtyI236a0RjVjNdDlFXwHJE,SpATywNh6bZuzm8s1ceuBUnMUAeoAHHw,18,34,5,10,2,40,9,1,101,14.428571428571429,4,0.0,4,5,10,2,30,40,0,9,1,21,80,0
187,4652,D1N0ONIJFdYniASKJjZ0ujwEVr50txl7,A3fsA9Zfv1X2fVEQhTw51lKENdNrEqT3,8,7,5,0,5,0,2,0,19,2.7142857142857144,1,0.0,0,5,0,5,7,0,0,2,0,10,9,1
188,4664,kMN5uYNaj23K9PVTrdyiL9iDB1lCye57,SpATywNh6bZuzm8s1ceuBUnMUAeoAHHw,7,8,4,0,1,4,3,0,20,2.857142857142857,2,0.0,0,4,0,1,8,4,0,3,0,5,15,0
189,4667,hjlIy32j2vlgUCGRsMhZTr5gQN9bE8Ko,A3fsA9Zfv1X2fVEQhTw51lKENdNrEqT3,3,3,1,0,0,0,1,0,5,0.7142857142857143,1,0.0,0,1,0,0,3,0,0,1,0,1,4,1
190,4713,2d73pTPKGJeE59DtbgirchSdsN0c5ZX8,G8EPVSXsOYB5YQWZGiz1aVq5Pgr2GrQu,18,16,13,0,3,0,4,0,36,5.142857142857143,3,0.0,1,13,0,3,15,0,0,4,0,17,19,1
191,4717,pYVXRlnQ0YvWKNjc7FEDAmE4Ai0Z428V,SpATywNh6bZuzm8s1ceuBUnMUAeoAHHw,10,7,3,13,3,2,2,0,30,4.285714285714286,1,0.0,2,3,11,3,5,2,2,2,0,19,11,1
192,4728,pteLC5OQ4se3k1DPDEwaYOBtzSkv9plY,A3fsA9Zfv1X2fVEQhTw51lKENdNrEqT3,8,6,2,0,2,0,5,0,15,2.142857142857143,2,0.0,0,2,0,2,6,0,0,5,0,4,11,1
193,4731,LgFsEu5TARkqPf6cgrTX0NqpOzewq5Lk,SpATywNh6bZuzm8s1ceuBUnMUAeoAHHw,27,23,13,23,7,2,6,1,75,10.714285714285714,2,0.0,6,13,20,7,17,2,3,6,1,46,29,0
194,4747,2YrfQZgyUPdiZGXhplgKBSkvHochAfw6,SpATywNh6bZuzm8s1ceuBUnMUAeoAHHw,19,47,19,29,5,0,10,0,110,15.714285714285714,3,0.0,9,19,22,5,38,0,7,10,0,55,55,0
195,4767,OLNUzQUHvlNsi2WFlH5eEyaieqKXrEz7,SpATywNh6bZuzm8s1ceuBUnMUAeoAHHw,4,3,1,0,0,0,1,0,5,0.7142857142857143,1,0.0,0,1,0,0,3,0,0,1,0,1,4,1
196,4774,urHq1UPtLFVLJW8r9uUffDflKlN7AYRL,SpATywNh6bZuzm8s1ceuBUnMUAeoAHHw,19,23,8,15,4,0,6,0,56,8.0,3,0.0,9,8,12,4,14,0,3,6,0,33,23,0
197,4801,uvl7kPB3Po3jrDtnQvCsunCWcJhdeQPU,A3fsA9Zfv1X2fVEQhTw51lKENdNrEqT3,50,48,27,103,17,0,15,1,211,30.142857142857142,4,0.0,4,27,88,17,44,0,15,15,1,136,75,1
198,4802,aI2WbSCktVyijPTHCbgAdpzpfdnFGcq9,RXDvfPUBYFlVdlueBFbLW0mhhAyGEqpt,34,59,30,0,12,0,27,2,130,18.571428571428573,5,0.0,4,30,0,12,55,0,0,27,2,46,84,0
199,4806,iGjPcJm3i62KsWTQKhrsxcQv7n97iair,G8EPVSXsOYB5YQWZGiz1aVq5Pgr2GrQu,105,125,10,287,5,86,16,1,530,75.71428571428571,6,0.0,56,10,193,5,69,86,94,16,1,264,266,0
200,4827,yNygMjDRQbsmQrkdzv6Ni3gEhrA9rC9T,SpATywNh6bZuzm8s1ceuBUnMUAeoAHHw,3,4,2,0,0,0,3,0,9,1.2857142857142858,1,0.0,0,2,0,0,4,0,0,3,0,2,7,0
201,4852,bvRAS0uJ0Teq8mZcNb9rxcXigDj59DTa,RXDvfPUBYFlVdlueBFbLW0mhhAyGEqpt,5,7,4,0,0,0,2,0,13,1.8571428571428572,1,0.0,0,4,0,0,7,0,0,2,0,4,9,0
202,4903,jJEQAKDG1yT0OS9qRBZrNXlEJDxE8Etq,A3fsA9Zfv1X2fVEQhTw51lKENdNrEqT3,20,27,9,30,0,44,18,0,128,18.285714285714285,6,0.0,3,9,27,0,24,44,3,18,0,39,89,0
203,4907,24hyIKTWvGbDpRNiVA2hNdG9ApRuVKWS,SpATywNh6bZuzm8s1ceuBUnMUAeoAHHw,21,16,10,6,6,8,5,0,51,7.285714285714286,4,0.0,4,10,6,6,12,8,0,5,0,26,25,0
204,4919,QDpN8D19Mr8RZumTONWpZNlCWcHCCTbH,bWdj2GDclj5ofokWjzoa5jAwMkxCykd6,14,24,2,44,2,14,8,0,94,13.428571428571429,4,0.0,5,2,42,2,19,14,2,8,0,51,43,1
205,4927,WYPfgLKE9VINcT4gmCjKg6KY4hGmzmxN,SpATywNh6bZuzm8s1ceuBUnMUAeoAHHw,22,27,14,12,5,3,6,0,67,9.571428571428571,2,0.0,8,14,10,5,19,3,2,6,0,37,30,0
206,4931,eiL4sJzBUqNqEAwJXavGTHQchRgg0E9e,G8EPVSXsOYB5YQWZGiz1aVq5Pgr2GrQu,32,28,3,77,1,8,10,1,128,18.285714285714285,3,0.0,0,3,63,1,28,8,14,10,1,67,61,0
207,4934,RkupeBiDJM8eQAHegSIZXnYfypYMPCFs,SpATywNh6bZuzm8s1ceuBUnMUAeoAHHw,6,6,3,3,0,0,1,0,13,1.8571428571428572,1,0.0,1,3,3,0,5,0,0,1,0,7,6,0
208,4937,aZcgamrUxwqX7Nt2qxeI2ZGGKhcvbWIt,SpATywNh6bZuzm8s1ceuBUnMUAeoAHHw,13,24,1,5,1,0,14,0,45,6.428571428571429,4,0.0,4,1,5,1,20,0,0,14,0,11,34,0
209,4948,D8SfZbudbfX5pEFjOEna12FQCnvrJwde,SpATywNh6bZuzm8s1ceuBUnMUAeoAHHw,3,3,1,0,0,0,3,0,7,1.0,1,0.0,0,1,0,0,3,0,0,3,0,1,6,1
210,4956,w9jybkX7jENxFw2ZN48ruQIJfCGfUCTe,A3fsA9Zfv1X2fVEQhTw51lKENdNrEqT3,56,58,1,226,1,0,4,0,290,41.42857142857143,3,0.0,8,1,183,1,50,0,43,4,0,193,97,1
211,4967,W4dUmcINvn4EmYk22ZRR3EuEX8WaEqL8,A3fsA9Zfv1X2fVEQhTw51lKENdNrEqT3,9,6,4,0,2,0,3,0,15,2.142857142857143,1,0.0,0,4,0,2,6,0,0,3,0,6,9,1
212,4982,3ZzNkdWgGb47Go07PRKPf0XZ6jjhVCB4,A3fsA9Zfv1X2fVEQhTw51lKENdNrEqT3,21,12,9,28,4,10,7,0,70,10.0,3,0.0,0,9,22,4,12,10,6,7,0,35,35,0
213,4989,WxVM9kOqNmenlQy1YKMo3yVYKYKkewCz,A3fsA9Zfv1X2fVEQhTw51lKENdNrEqT3,70,35,24,170,12,22,20,0,283,40.42857142857143,4,0.0,6,24,133,12,29,22,37,20,0,175,108,0
214,5009,lgip049r6Eu24ga2SPdixKHu4ShoVkOP,SpATywNh6bZuzm8s1ceuBUnMUAeoAHHw,17,10,6,12,3,0,4,0,35,5.0,1,0.0,2,6,11,3,8,0,1,4,0,22,13,0
215,5042,QP1Im9jEj4yDlujZ0cdksBwzi1qoq6uz,A3fsA9Zfv1X2fVEQhTw51lKENdNrEqT3,14,11,9,0,8,0,7,1,36,5.142857142857143,2,0.0,0,9,0,8,11,0,0,7,1,17,19,1
216,5058,UJNew1tDOTKAwtlVI7Xin0dzgnQGk4oE,SpATywNh6bZuzm8s1ceuBUnMUAeoAHHw,23,51,20,38,3,14,7,0,133,19.0,2,0.0,25,20,34,3,26,14,4,7,0,82,51,0
217,5084,kMzMJEHy7fAHiNUZU0um3I2BsPC7gMll,bWdj2GDclj5ofokWjzoa5jAwMkxCykd6,25,35,27,77,16,14,17,0,186,26.571428571428573,6,0.0,2,27,61,16,33,14,16,17,0,106,80,0
218,5092,EiO5bky9R1Iqlpv4ItUpPBUgGb1eJItE,A3fsA9Zfv1X2fVEQhTw51lKENdNrEqT3,12,39,3,0,2,29,18,0,91,13.0,4,0.0,0,3,0,2,39,29,0,18,0,5,86,1
219,5112,eXHbDnPXGOepjGY8R1QdCMeSWp9NDZZc,SpATywNh6bZuzm8s1ceuBUnMUAeoAHHw,27,54,24,19,6,4,3,0,110,15.714285714285714,1,0.0,16,24,17,6,38,4,2,3,0,63,47,0
220,5114,3SWDgl41jXPWPBCB5sVpNEwmW9L3MerS,SpATywNh6bZuzm8s1ceuBUnMUAeoAHHw,16,16,11,12,8,0,1,0,48,6.857142857142857,2,0.0,2,11,10,8,14,0,2,1,0,31,17,0
221,5136,35QP8hkG1fMgJT5B2mWO7L1K5UDzKccP,SpATywNh6bZuzm8s1ceuBUnMUAeoAHHw,1,0,0,0,0,0,6,0,6,0.8571428571428571,2,0.0,0,0,0,0,0,0,0,6,0,0,6,1
222,5148,uN992cfJ2NJqNQmns1XgyEcZyWUiJR0U,SpATywNh6bZuzm8s1ceuBUnMUAeoAHHw,16,25,2,9,1,2,5,1,45,6.428571428571429,2,0.0,4,2,9,1,21,2,0,5,1,16,29,0
223,5163,nOBQYWrG3xrA9IeoO0kkFbpfztBbno3g,A3fsA9Zfv1X2fVEQhTw51lKENdNrEqT3,10,5,3,0,3,0,3,0,14,2.0,1,0.0,0,3,0,3,5,0,0,3,0,6,8,1
224,5168,UWuyaaoLwLnyFDmtW8yT3lff7bHBBBqe,SpATywNh6bZuzm8s1ceuBUnMUAeoAHHw,19,48,3,16,3,6,14,6,96,13.714285714285714,5,0.0,8,3,16,3,40,6,0,14,6,30,66,0
225,5205,VhlYBZ7MZgP2ChzlwqizJv2MimYYdGta,SpATywNh6bZuzm8s1ceuBUnMUAeoAHHw,24,28,16,15,9,0,10,4,82,11.714285714285714,3,0.0,2,16,15,9,26,0,0,10,4,42,40,1
226,5249,TCQ7j55cp3iQY2crxSrod75YneerL94o,SpATywNh6bZuzm8s1ceuBUnMUAeoAHHw,16,13,7,12,4,0,4,0,40,5.714285714285714,2,0.0,4,7,12,4,9,0,0,4,0,27,13,1
227,5284,QqE2Xjwy9gUzOvFdkDqAwAaNZLBZkxvd,RXDvfPUBYFlVdlueBFbLW0mhhAyGEqpt,31,183,9,0,7,115,59,1,374,53.42857142857143,7,0.0,10,9,0,7,173,115,0,59,1,26,348,0
228,5290,4xEpIgR9alQqM4xeSug69KmBmO9gpD69,A3fsA9Zfv1X2fVEQhTw51lKENdNrEqT3,15,32,16,0,9,14,12,0,83,11.857142857142858,2,0.0,1,16,0,9,31,14,0,12,0,26,57,0
229,5311,SFbTZDEo0JTOG7VHfxeJz2kz3qSzlHq4,SpATywNh6bZuzm8s1ceuBUnMUAeoAHHw,13,19,1,21,0,0,1,0,42,6.0,1,0.0,8,1,18,0,11,0,3,1,0,27,15,0
230,5316,0tT4cQq52T8bu4irQ9KewNXtlD33hVZo,SpATywNh6bZuzm8s1ceuBUnMUAeoAHHw,3,2,1,0,0,0,1,0,4,0.5714285714285714,1,0.0,0,1,0,0,2,0,0,1,0,1,3,0
231,5337,a6f3gPi6axX0cfBnUGVliBDQrPx92l1r,bWdj2GDclj5ofokWjzoa5jAwMkxCykd6,23,68,35,103,20,0,11,0,237,33.857142857142854,5,0.0,20,35,86,20,48,0,17,11,0,161,76,1
232,5368,dXV6CXhMuL2MovsaBcVnWuwVAfDnBy3D,A3fsA9Zfv1X2fVEQhTw51lKENdNrEqT3,10,8,0,0,0,0,6,0,14,2.0,2,0.0,0,0,0,0,8,0,0,6,0,0,14,1
233,5369,AcgDUm5SSEb0zgM8tYKiOFvTewc0KRAc,SpATywNh6bZuzm8s1ceuBUnMUAeoAHHw,6,4,3,0,1,0,1,0,9,1.2857142857142858,1,0.0,0,3,0,1,4,0,0,1,0,4,5,0
234,5416,nds56JS5tgInTRshD1ZJkwXi4oW5Ln7a,RXDvfPUBYFlVdlueBFbLW0mhhAyGEqpt,45,66,40,70,14,21,19,0,230,32.857142857142854,7,0.0,8,40,65,14,58,21,5,19,0,127,103,0
235,5431,VnkZQ14wQqfipOllRb5zJLKqrvJ7kfcr,A3fsA9Zfv1X2fVEQhTw51lKENdNrEqT3,1,0,0,0,0,0,2,0,2,0.2857142857142857,2,0.0,0,0,0,0,0,0,0,2,0,0,2,1
236,5435,90Sn7UxaiRTmCSrIbSNevcUMokJI9XYS,A3fsA9Zfv1X2fVEQhTw51lKENdNrEqT3,4,3,0,0,0,0,1,0,4,0.5714285714285714,1,0.0,0,0,0,0,3,0,0,1,0,0,4,1
237,5439,vUerya30clLdh9EQX34ayPT3Cr8C7lb8,A3fsA9Zfv1X2fVEQhTw51lKENdNrEqT3,6,7,0,0,0,0,3,0,10,1.4285714285714286,1,0.0,0,0,0,0,7,0,0,3,0,0,10,1
238,5470,acVvGaaH1iVFQOYF94V9THpGPkF7EIj3,SpATywNh6bZuzm8s1ceuBUnMUAeoAHHw,3,2,1,0,0,0,1,0,4,0.5714285714285714,1,0.0,0,1,0,0,2,0,0,1,0,1,3,0
239,5471,ZWj0iRzT4HOMV032BfEyYj9IEk1Rdo03,SpATywNh6bZuzm8s1ceuBUnMUAeoAHHw,25,104,1,41,0,64,18,3,231,33.0,2,0.0,48,1,34,0,56,64,7,18,3,83,148,0
240,5482,lfAQ0nsHdkBDoIcTW4jXyPy4wOsVYtMB,RXDvfPUBYFlVdlueBFbLW0mhhAyGEqpt,23,18,9,22,4,1,13,3,70,10.0,2,0.0,6,9,20,4,12,1,2,13,3,39,31,1
241,5484,DjQWiwlbqq88H7QziTtErXo3yBTqRc6U,A3fsA9Zfv1X2fVEQhTw51lKENdNrEqT3,5,5,3,0,0,0,2,0,10,1.4285714285714286,3,0.0,0,3,0,0,5,0,0,2,0,3,7,1
242,5495,xsW19PmjvHmfOgtSCjdxnkpzOWqbKfLn,SpATywNh6bZuzm8s1ceuBUnMUAeoAHHw,18,38,19,16,7,5,11,0,96,13.714285714285714,3,0.0,13,19,15,7,25,5,1,11,0,54,42,0
243,5519,BsWy5ImeTPQvYgOCRPYHOm3gBOyZfxYj,SpATywNh6bZuzm8s1ceuBUnMUAeoAHHw,8,9,5,0,4,0,3,0,21,3.0,2,0.0,0,5,0,4,9,0,0,3,0,9,12,0
244,5523,njb10SfHXKB30cApzPJzWBcqA8VQx0HA,SpATywNh6bZuzm8s1ceuBUnMUAeoAHHw,2,0,0,0,0,0,2,0,2,0.2857142857142857,1,0.0,0,0,0,0,0,0,0,2,0,0,2,1
245,5621,3rCZba8eKP7jaFsDjNb32WoGn9BjnrjN,A3fsA9Zfv1X2fVEQhTw51lKENdNrEqT3,38,44,21,86,13,35,11,0,210,30.0,4,0.0,7,21,68,13,37,35,18,11,0,109,101,1
246,5642,IAvuP4GGmvnNj3Zisz3jDfo3mSmXiJSb,A3fsA9Zfv1X2fVEQhTw51lKENdNrEqT3,17,51,1,0,1,0,6,0,59,8.428571428571429,3,0.0,0,1,0,1,51,0,0,6,0,2,57,1
247,5644,J388HMX5pYHjqXdA7jEUkFec6orRQtIq,A3fsA9Zfv1X2fVEQhTw51lKENdNrEqT3,8,10,6,0,1,0,2,0,19,2.7142857142857144,1,0.0,0,6,0,1,10,0,0,2,0,7,12,0
248,5660,CZZkgDgsqVR6ftNFrTmx0jPpBHh2f3Zo,SpATywNh6bZuzm8s1ceuBUnMUAeoAHHw,17,57,6,14,1,37,20,0,135,19.285714285714285,6,0.0,7,6,14,1,50,37,0,20,0,28,107,0
249,5663,1QA0SqfAW0hFBv6FjoAHgHRHfBlvLSPL,A3fsA9Zfv1X2fVEQhTw51lKENdNrEqT3,4,2,0,0,0,0,3,0,5,0.7142857142857143,2,0.0,0,0,0,0,2,0,0,3,0,0,5,1
250,5671,HbDaABEakQmE8DQEoFoIphu2SH13rFRy,A3fsA9Zfv1X2fVEQhTw51lKENdNrEqT3,41,21,16,78,12,0,4,0,131,18.714285714285715,4,0.0,1,16,67,12,20,0,11,4,0,96,35,1
251,5672,HbDaABEakQmE8DQEoFoIphu2SH13rFRy,bWdj2GDclj5ofokWjzoa5jAwMkxCykd6,4,2,1,0,1,0,2,0,6,0.8571428571428571,2,0.0,0,1,0,1,2,0,0,2,0,2,4,1
252,5675,HbDaABEakQmE8DQEoFoIphu2SH13rFRy,RXDvfPUBYFlVdlueBFbLW0mhhAyGEqpt,1,0,0,0,0,0,1,0,1,0.14285714285714285,1,0.0,0,0,0,0,0,0,0,1,0,0,1,1
253,5705,TwYAYdYU7yn5FjnP72W4DEwE8N7Dqkqq,bWdj2GDclj5ofokWjzoa5jAwMkxCykd6,5,4,0,0,0,1,3,0,8,1.1428571428571428,1,0.0,0,0,0,0,4,1,0,3,0,0,8,1
254,5743,57qzgJAwfROYPxzSOrsA3G5DLHP95ajU,RXDvfPUBYFlVdlueBFbLW0mhhAyGEqpt,36,38,31,0,19,0,8,0,96,13.714285714285714,2,0.0,2,31,0,19,36,0,0,8,0,52,44,0
255,5746,seRgjh60dHSex83x3yaP07EkHkNZ3zq1,SpATywNh6bZuzm8s1ceuBUnMUAeoAHHw,13,22,8,22,1,11,7,1,72,10.285714285714286,2,0.0,11,8,19,1,11,11,3,7,1,39,33,0
256,5781,D2S5bjWjmtwLivqx7n7FZWso5Kd6We5x,bWdj2GDclj5ofokWjzoa5jAwMkxCykd6,14,7,0,51,0,0,1,0,59,8.428571428571429,1,0.0,2,0,43,0,5,0,8,1,0,45,14,0
257,5785,Llzpy0Dk1LPSE6nBLZ8vNVNgQXCzGpc1,SpATywNh6bZuzm8s1ceuBUnMUAeoAHHw,29,34,19,26,9,0,10,2,100,14.285714285714286,2,0.0,6,19,22,9,28,0,4,10,2,56,44,1
258,5788,zysr84QD6b78mLaezXoryEdhH6kH14EQ,SpATywNh6bZuzm8s1ceuBUnMUAeoAHHw,3,2,1,0,0,0,2,0,5,0.7142857142857143,1,0.0,0,1,0,0,2,0,0,2,0,1,4,0
259,5792,GIb3glgYrsEfHWtEWPWpwONqwE7RMf6f,bWdj2GDclj5ofokWjzoa5jAwMkxCykd6,25,45,23,50,5,21,17,0,161,23.0,5,0.0,5,23,47,5,40,21,3,17,0,80,81,0
260,5802,8tzllCaQFf5FO2XcYgqoYiMGBjUwujYx,A3fsA9Zfv1X2fVEQhTw51lKENdNrEqT3,5,3,0,0,0,0,4,0,7,1.0,1,0.0,0,0,0,0,3,0,0,4,0,0,7,1
261,5803,sD3rDh1CtXsAdfDDyFRBf917K7ELQzHQ,SpATywNh6bZuzm8s1ceuBUnMUAeoAHHw,4,7,0,0,0,0,7,0,14,2.0,2,0.0,0,0,0,0,7,0,0,7,0,0,14,0
262,5805,VUYRWxIK25dyFla7xdkPw6qN6gZPPejU,SpATywNh6bZuzm8s1ceuBUnMUAeoAHHw,3,3,1,0,0,0,1,0,5,0.7142857142857143,1,0.0,0,1,0,0,3,0,0,1,0,1,4,0
263,5822,yXIAbgjR7S4042oicRyG8kfTX0pG8yI5,SpATywNh6bZuzm8s1ceuBUnMUAeoAHHw,6,8,0,0,0,0,2,0,10,1.4285714285714286,1,0.0,2,0,0,0,6,0,0,2,0,2,8,0
264,5826,zTf8XOQnwWWl1KDwh9NJmoY9QiDPt6oU,SpATywNh6bZuzm8s1ceuBUnMUAeoAHHw,16,27,18,16,6,0,6,0,73,10.428571428571429,4,0.0,5,18,16,6,22,0,0,6,0,45,28,0
265,5827,IXG6Mrr8VTjEEQIqeVi1KlyYwZ2T4ziy,A3fsA9Zfv1X2fVEQhTw51lKENdNrEqT3,4,2,1,0,1,0,1,0,5,0.7142857142857143,1,0.0,0,1,0,1,2,0,0,1,0,2,3,0
266,5865,Ojf2FGMPjkgcQ8cOS7KSlXqYowZOsPoh,A3fsA9Zfv1X2fVEQhTw51lKENdNrEqT3,1,0,0,0,0,0,1,0,1,0.14285714285714285,1,0.0,0,0,0,0,0,0,0,1,0,0,1,0
267,5890,8c2gk77rfHeG4kEZpifVHT547X2ayTNE,RXDvfPUBYFlVdlueBFbLW0mhhAyGEqpt,2,0,0,0,0,0,3,0,3,0.42857142857142855,2,0.0,0,0,0,0,0,0,0,3,0,0,3,0
268,5892,1YxknoiTrSwQgclDlSAh4oMYHRyARhLv,SpATywNh6bZuzm8s1ceuBUnMUAeoAHHw,4,5,3,0,0,0,4,0,12,1.7142857142857142,3,0.0,0,3,0,0,5,0,0,4,0,3,9,0
269,5927,vYyC3PI9WOfKd54xBrxSVvrhn62CQxzz,SpATywNh6bZuzm8s1ceuBUnMUAeoAHHw,7,8,5,0,2,0,2,0,17,2.4285714285714284,2,0.0,0,5,0,2,8,0,0,2,0,7,10,1
270,5934,hdKqkkWKrDzbKE9btGChBqiCfsTwp68E,A3fsA9Zfv1X2fVEQhTw51lKENdNrEqT3,4,6,1,0,0,30,12,0,49,7.0,5,0.0,0,1,0,0,6,30,0,12,0,1,48,0
271,6018,cJcuhtji0eqLhfXtnFSDlw6v5huTlvOS,SpATywNh6bZuzm8s1ceuBUnMUAeoAHHw,25,37,1,28,1,5,8,1,81,11.571428571428571,4,0.0,13,1,22,1,24,5,6,8,1,37,44,0
272,6031,H2B0ZVh2RYo5LjimmBQ15UDjcAOL7h2y,A3fsA9Zfv1X2fVEQhTw51lKENdNrEqT3,7,1,1,0,1,0,6,1,10,1.4285714285714286,1,0.0,0,1,0,1,1,0,0,6,1,2,8,1
273,6048,hf7YI3B1kTTuvmd2vS9DIoiPGXbrQyBH,SpATywNh6bZuzm8s1ceuBUnMUAeoAHHw,14,17,3,8,2,42,12,0,84,12.0,3,0.0,5,3,7,2,12,42,1,12,0,17,67,0
274,6058,KrIVcXIiCdwRGUI4WguKXHPsvZChbtIb,A3fsA9Zfv1X2fVEQhTw51lKENdNrEqT3,30,26,19,84,10,31,7,0,177,25.285714285714285,2,0.0,1,19,64,10,25,31,20,7,0,94,83,0
275,6059,RDBly29xbybxfRPXjsOP81xd2Sgww6yI,bWdj2GDclj5ofokWjzoa5jAwMkxCykd6,6,5,2,0,2,0,6,0,15,2.142857142857143,2,0.0,0,2,0,2,5,0,0,6,0,4,11,1
276,6069,imazrFpyX68kLUAydat119Z5XKshja9y,SpATywNh6bZuzm8s1ceuBUnMUAeoAHHw,24,28,18,26,6,0,7,0,85,12.142857142857142,5,0.0,4,18,25,6,24,0,1,7,0,53,32,0
277,6086,ZL7VsgZBlKFfi6BGNSyN1gGJros1L9ra,SpATywNh6bZuzm8s1ceuBUnMUAeoAHHw,3,2,0,0,0,18,1,0,21,3.0,1,0.0,0,0,0,0,2,18,0,1,0,0,21,1
278,6087,uUWoPLkJSFKbD6KppcebOwMXezopCcLj,SpATywNh6bZuzm8s1ceuBUnMUAeoAHHw,13,42,0,19,0,0,7,0,68,9.714285714285714,1,0.0,15,0,16,0,27,0,3,7,0,31,37,0
279,6203,qwOn6svjZUr6PbEPbdgCynJcocJs2Tff,SpATywNh6bZuzm8s1ceuBUnMUAeoAHHw,19,15,10,8,6,5,3,1,48,6.857142857142857,1,0.0,3,10,8,6,12,5,0,3,1,27,21,0
280,6217,xVu6NAX59MOmpApYDfs9WPe7YPPVhsFD,A3fsA9Zfv1X2fVEQhTw51lKENdNrEqT3,36,26,1,50,1,5,9,1,93,13.285714285714286,2,0.0,1,1,43,1,25,5,7,9,1,46,47,1
281,6222,2CJPniJdzPQB2xVD7usFld4N6998DubA,SpATywNh6bZuzm8s1ceuBUnMUAeoAHHw,23,36,18,22,7,10,10,0,103,14.714285714285714,2,0.0,13,18,18,7,23,10,4,10,0,56,47,0
282,6235,ywdL3xkp7d2PSjbvnflAvIe7Wp6Q4SRe,A3fsA9Zfv1X2fVEQhTw51lKENdNrEqT3,31,11,5,78,3,0,9,0,106,15.142857142857142,3,0.0,1,5,76,3,10,0,2,9,0,85,21,0
283,6241,JOowoFboUWVsMh86KvKaqn28cyqJccLu,SpATywNh6bZuzm8s1ceuBUnMUAeoAHHw,12,18,1,18,0,0,3,0,40,5.714285714285714,2,0.0,7,1,16,0,11,0,2,3,0,24,16,1
284,6251,xHZbSROhwP4RRQerUVWvcNTfOGc2DHWf,A3fsA9Zfv1X2fVEQhTw51lKENdNrEqT3,29,45,15,131,3,40,16,0,250,35.714285714285715,7,0.0,3,15,99,3,42,40,32,16,0,120,130,0
285,6297,IBlNXwDR3MmRt5PBvnP44ynAugPBAbiq,A3fsA9Zfv1X2fVEQhTw51lKENdNrEqT3,4,5,2,0,0,0,2,0,9,1.2857142857142858,2,0.0,0,2,0,0,5,0,0,2,0,2,7,1
286,6301,4NUGABfnQkRS9FoH90Vgnhdha4tRSmOB,A3fsA9Zfv1X2fVEQhTw51lKENdNrEqT3,31,28,17,58,5,0,6,0,114,16.285714285714285,4,0.0,5,17,47,5,23,0,11,6,0,74,40,0
287,6310,K0OSl2yDmHYQ9TtZdxy9shErNwx3ga0n,SpATywNh6bZuzm8s1ceuBUnMUAeoAHHw,5,5,2,0,1,0,1,0,9,1.2857142857142858,1,0.0,2,2,0,1,3,0,0,1,0,5,4,1
288,6322,2IvFgMw0NfaiiFt35dmyYrQHt1TRMHZA,SpATywNh6bZuzm8s1ceuBUnMUAeoAHHw,19,30,12,14,5,9,15,1,86,12.285714285714286,2,0.0,10,12,13,5,20,9,1,15,1,40,46,0
289,6360,S6vBzHKpSh31SFGGZmwgKaOH2RvW3RpH,A3fsA9Zfv1X2fVEQhTw51lKENdNrEqT3,10,10,8,0,7,0,3,0,28,4.0,3,0.0,0,8,0,7,10,0,0,3,0,15,13,0
290,6361,8nT76hrzyl8ZAUdI7W6kfrIzHxI3puKM,A3fsA9Zfv1X2fVEQhTw51lKENdNrEqT3,51,24,0,132,0,0,7,0,163,23.285714285714285,2,0.0,2,0,130,0,22,0,2,7,0,132,31,0
291,6386,sgU8bYbkNg27HLTOfRzwWIg1HmjCd9Xd,SpATywNh6bZuzm8s1ceuBUnMUAeoAHHw,16,22,0,20,0,1,11,2,56,8.0,3,0.0,6,0,17,0,16,1,3,11,2,23,33,0
292,6391,VWT0erf4AD2BzAGMlVwaBcrhUFyVXGW3,SpATywNh6bZuzm8s1ceuBUnMUAeoAHHw,15,26,1,12,0,0,5,2,46,6.571428571428571,2,0.0,9,1,12,0,17,0,0,5,2,22,24,0
293,6396,mXsmDArxUTe9rMFHp3cGPJEx5ACYKD90,SpATywNh6bZuzm8s1ceuBUnMUAeoAHHw,28,57,23,35,8,21,6,0,150,21.428571428571427,3,0.0,26,23,30,8,31,21,5,6,0,87,63,0
294,6407,y7mamutAMELy79Bgdj0zOeVjiQ071oNX,SpATywNh6bZuzm8s1ceuBUnMUAeoAHHw,22,39,12,21,4,0,5,0,81,11.571428571428571,3,0.0,20,12,18,4,19,0,3,5,0,54,27,0
295,6427,vuqnfFRpmwKE9RdxK6XJMNF9m6H6VyTM,RXDvfPUBYFlVdlueBFbLW0mhhAyGEqpt,38,53,35,64,13,32,9,0,206,29.428571428571427,4,0.0,12,35,59,13,41,32,5,9,0,119,87,0
296,6473,QYNtwRXZGk0TiZU9fvvZmyYTg9wzmVe8,bWdj2GDclj5ofokWjzoa5jAwMkxCykd6,29,83,2,77,0,234,87,3,486,69.42857142857143,7,0.0,12,2,61,0,71,234,16,87,3,75,411,0
297,6475,4NUGABfnQkRS9FoH90Vgnhdha4tRSmOB,SpATywNh6bZuzm8s1ceuBUnMUAeoAHHw,3,4,2,0,0,0,3,0,9,1.2857142857142858,3,0.0,0,2,0,0,4,0,0,3,0,2,7,0
298,6476,5l7JbkjmfBonHdF7CbCa3GMejToAwTQZ,SpATywNh6bZuzm8s1ceuBUnMUAeoAHHw,9,10,3,8,0,4,2,0,27,3.857142857142857,1,0.0,6,3,8,0,4,4,0,2,0,17,10,1
299,6480,fFnDSL1hWADv25SE5UTFI35tGRTcYBEF,SpATywNh6bZuzm8s1ceuBUnMUAeoAHHw,7,4,1,0,1,0,2,0,8,1.1428571428571428,1,0.0,0,1,0,1,4,0,0,2,0,2,6,0
300,6490,CozZoSX7AwprtwyJFCAeFUYiCq7OSEAP,G8EPVSXsOYB5YQWZGiz1aVq5Pgr2GrQu,3,3,0,0,0,0,1,0,4,0.5714285714285714,1,0.0,0,0,0,0,3,0,0,1,0,0,4,0
301,6494,w1o1S1rsKOagmFCmrSXvpPsO3fHW3lAq,A3fsA9Zfv1X2fVEQhTw51lKENdNrEqT3,19,15,11,32,3,4,4,0,69,9.857142857142858,2,0.0,0,11,25,3,15,4,7,4,0,39,30,1
302,6497,QYNtwRXZGk0TiZU9fvvZmyYTg9wzmVe8,A3fsA9Zfv1X2fVEQhTw51lKENdNrEqT3,31,50,0,92,0,275,85,1,503,71.85714285714286,7,0.0,3,0,73,0,47,275,19,85,1,76,427,0
303,6502,MFUbiMqXEmfaBzK7hirtX5aBXDvqfQ39,RXDvfPUBYFlVdlueBFbLW0mhhAyGEqpt,15,17,11,0,3,2,8,1,42,6.0,1,0.0,2,11,0,3,15,2,0,8,1,16,26,0
304,6527,iYw8kPkvjn3xb3wtZEyAytTepRhqUlKj,SpATywNh6bZuzm8s1ceuBUnMUAeoAHHw,14,16,4,12,2,0,2,0,36,5.142857142857143,2,0.0,2,4,12,2,14,0,0,2,0,20,16,0
305,6542,wSw0H7eAN6dfAeYMaWU4nG5bgtRJyFlj,SpATywNh6bZuzm8s1ceuBUnMUAeoAHHw,13,19,0,10,0,0,2,0,31,4.428571428571429,2,0.0,3,0,9,0,16,0,1,2,0,12,19,0
306,6547,6U06x0rZdU2wXE04MeChX934BjpYCGYO,A3fsA9Zfv1X2fVEQhTw51lKENdNrEqT3,32,19,9,64,3,15,6,1,117,16.714285714285715,2,0.0,6,9,55,3,13,15,9,6,1,73,44,0
307,6551,uiGGvm5bzelA6YjURZYgSYljUTVOBIB1,A3fsA9Zfv1X2fVEQhTw51lKENdNrEqT3,2,0,0,0,0,0,2,0,2,0.2857142857142857,1,0.0,0,0,0,0,0,0,0,2,0,0,2,1
308,6556,xeRiyg2Y5ZgvqPGiWyjXk0hLMBeGkeoJ,RXDvfPUBYFlVdlueBFbLW0mhhAyGEqpt,10,11,7,0,4,0,3,0,25,3.5714285714285716,3,0.0,2,7,0,4,9,0,0,3,0,13,12,0
309,6562,KnR9Rn7adHv02cUeYZsmQrRux2GhqbgV,SpATywNh6bZuzm8s1ceuBUnMUAeoAHHw,17,11,9,0,7,0,2,0,29,4.142857142857143,2,0.0,0,9,0,7,11,0,0,2,0,16,13,1
310,6563,5zX31TZPkBQ4nxGKP7lPYFABTGNW6PHa,A3fsA9Zfv1X2fVEQhTw51lKENdNrEqT3,39,33,21,122,7,57,22,1,263,37.57142857142857,6,0.0,4,21,95,7,29,57,27,22,1,127,136,1
311,6576,X1EwqmDy4MdORdVb79oGgVGVtNlVZgX3,A3fsA9Zfv1X2fVEQhTw51lKENdNrEqT3,6,0,0,0,0,0,6,1,7,1.0,1,0.0,0,0,0,0,0,0,0,6,1,0,7,1
312,6579,FxyjnTbjAUnINdJgNqjfUflUXLEYBAKC,SpATywNh6bZuzm8s1ceuBUnMUAeoAHHw,13,21,3,6,0,2,2,0,34,4.857142857142857,2,0.0,6,3,6,0,15,2,0,2,0,15,19,0
313,6606,vqNQHlaqBAqN0Ghl4wYJYkeoe3u1AJkM,SpATywNh6bZuzm8s1ceuBUnMUAeoAHHw,4,2,1,0,1,0,5,0,9,1.2857142857142858,1,0.0,0,1,0,1,2,0,0,5,0,2,7,1
314,6619,TgtZeZ58ebuFniTgQX061K6ibFhvtBpU,SpATywNh6bZuzm8s1ceuBUnMUAeoAHHw,17,22,11,12,6,0,3,0,54,7.714285714285714,3,0.0,2,11,12,6,20,0,0,3,0,31,23,0
315,6633,hu8eak1Xmf8voE8pnxPzkSD2dZP9Sipf,SpATywNh6bZuzm8s1ceuBUnMUAeoAHHw,12,11,1,6,1,2,12,0,33,4.714285714285714,2,0.0,5,1,6,1,6,2,0,12,0,13,20,0
316,6635,xKsPjk1jm2BE3h1iJlr6XUhvP4lcDdRk,RXDvfPUBYFlVdlueBFbLW0mhhAyGEqpt,26,26,15,47,10,4,5,0,107,15.285714285714286,2,0.0,7,15,44,10,19,4,3,5,0,76,31,0
317,6645,jzhfcjSJMALhuWl4kOoGHRTc9xbTfPXO,SpATywNh6bZuzm8s1ceuBUnMUAeoAHHw,10,15,0,0,0,0,2,0,17,2.4285714285714284,2,0.0,0,0,0,0,15,0,0,2,0,0,17,0
318,6646,JV1BgG1khCT6s4RU5oY7ZOSmwW31Qjbp,SpATywNh6bZuzm8s1ceuBUnMUAeoAHHw,20,23,12,15,4,11,9,1,75,10.714285714285714,2,0.0,2,12,12,4,21,11,3,9,1,30,45,0
319,6651,imazrFpyX68kLUAydat119Z5XKshja9y,G8EPVSXsOYB5YQWZGiz1aVq5Pgr2GrQu,5,5,3,0,0,0,2,0,10,1.4285714285714286,1,0.0,0,3,0,0,5,0,0,2,0,3,7,1
320,6654,WIULTFMTHtU9DH0SABu7cidImBPYBDLB,SpATywNh6bZuzm8s1ceuBUnMUAeoAHHw,28,36,6,28,5,0,14,1,90,12.857142857142858,2,0.0,5,6,26,5,31,0,2,14,1,42,48,1
321,6664,7nQB7cjVdr2HijR82OoX1oMRPa42JjfY,bWdj2GDclj5ofokWjzoa5jAwMkxCykd6,25,23,15,54,4,15,8,0,119,17.0,3,0.0,2,15,49,4,21,15,5,8,0,70,49,0
322,6666,MFUbiMqXEmfaBzK7hirtX5aBXDvqfQ39,A3fsA9Zfv1X2fVEQhTw51lKENdNrEqT3,11,6,5,0,5,0,2,0,18,2.5714285714285716,2,0.0,0,5,0,5,6,0,0,2,0,10,8,1
323,6682,hl9NS7ZQVsxPwew9lFoMcbw555xXfA7K,SpATywNh6bZuzm8s1ceuBUnMUAeoAHHw,17,17,8,14,4,0,2,0,45,6.428571428571429,1,0.0,7,8,11,4,10,0,3,2,0,30,15,1
324,6712,7FUJzRatex45Tiw3cL91Uz5fZD5gpQMy,A3fsA9Zfv1X2fVEQhTw51lKENdNrEqT3,2,0,0,0,0,0,3,0,3,0.42857142857142855,1,0.0,0,0,0,0,0,0,0,3,0,0,3,1
325,6721,5EbadEY64E8d6mWCOGPXe4HNciATivZW,SpATywNh6bZuzm8s1ceuBUnMUAeoAHHw,15,17,9,4,5,0,1,0,36,5.142857142857143,1,0.0,7,9,4,5,10,0,0,1,0,25,11,0
326,6722,r5hJNp3FkX6JOBVI5bSeTBPneDl7PaKl,A3fsA9Zfv1X2fVEQhTw51lKENdNrEqT3,9,7,0,0,0,4,18,2,31,4.428571428571429,2,0.0,0,0,0,0,7,4,0,18,2,0,31,1
327,6723,e12uQn96OlYfknMdqSXCXdImglIj4IRR,A3fsA9Zfv1X2fVEQhTw51lKENdNrEqT3,16,32,20,0,3,95,26,1,177,25.285714285714285,7,0.0,3,20,0,3,29,95,0,26,1,26,151,0
328,6725,2LSIOP9EwUlEUMR84kNdXwxCTBof59AV,SpATywNh6bZuzm8s1ceuBUnMUAeoAHHw,13,13,8,0,4,0,4,0,29,4.142857142857143,3,0.0,0,8,0,4,13,0,0,4,0,12,17,0
329,6734,XxYK4zbyqtm9UELp1oR6gZVKRAER78zL,A3fsA9Zfv1X2fVEQhTw51lKENdNrEqT3,3,2,1,0,0,0,1,0,4,0.5714285714285714,1,0.0,0,1,0,0,2,0,0,1,0,1,3,1
330,6739,D5mwgoAPtfwdsFrdNADBqEJQSy8E0CUi,SpATywNh6bZuzm8s1ceuBUnMUAeoAHHw,17,37,24,8,7,0,13,0,89,12.714285714285714,3,0.0,5,24,8,7,32,0,0,13,0,44,45,0
331,6740,YkHlvsvfON124uz3tNHCqQavCTgfzIIn,SpATywNh6bZuzm8s1ceuBUnMUAeoAHHw,16,16,6,13,3,0,7,2,47,6.714285714285714,1,0.0,5,6,11,3,11,0,2,7,2,25,22,1
332,6741,uOAgQLQslSL4cABC9ZqhaeK1XrisqlGh,SpATywNh6bZuzm8s1ceuBUnMUAeoAHHw,7,6,4,0,2,0,4,0,16,2.2857142857142856,1,0.0,0,4,0,2,6,0,0,4,0,6,10,0
333,6761,DTS3O3ZujmzMefQXzAvfnTTqItcbsW8A,SpATywNh6bZuzm8s1ceuBUnMUAeoAHHw,15,23,0,12,0,38,5,2,80,11.428571428571429,2,0.0,6,0,10,0,17,38,2,5,2,16,64,0
334,6778,lVgq3gYt1tDiZq5EPAUcQ3qHGrMei1Rm,SpATywNh6bZuzm8s1ceuBUnMUAeoAHHw,26,38,25,30,9,15,27,10,154,22.0,3,0.0,8,25,25,9,30,15,5,27,10,67,87,0
335,6781,eWIsTbhL2p3ztTyrIxD7wf9RK1qPkZuf,SpATywNh6bZuzm8s1ceuBUnMUAeoAHHw,19,22,17,6,0,21,9,2,77,11.0,3,0.0,0,17,6,0,22,21,0,9,2,23,54,0
336,6783,hjSv3nB1dzB315OJ0MdIWlJoWmd5FDgm,bWdj2GDclj5ofokWjzoa5jAwMkxCykd6,9,21,6,60,5,4,10,0,106,15.142857142857142,1,0.0,11,6,58,5,10,4,2,10,0,80,26,1
337,6790,QZbPGbTnAqz8GS6cm25XcpeiETovvLN6,A3fsA9Zfv1X2fVEQhTw51lKENdNrEqT3,1,0,0,0,0,0,1,0,1,0.14285714285714285,1,0.0,0,0,0,0,0,0,0,1,0,0,1,1
338,6794,Yh46fozwerObqlP4OOrKTS69VvjT8dK1,A3fsA9Zfv1X2fVEQhTw51lKENdNrEqT3,3,2,1,0,0,0,2,0,5,0.7142857142857143,2,0.0,0,1,0,0,2,0,0,2,0,1,4,1
339,6823,DeZ9eduD0lM3aHUAAOCnUrOhgp8jUmje,SpATywNh6bZuzm8s1ceuBUnMUAeoAHHw,11,22,1,4,0,0,6,0,33,4.714285714285714,2,0.0,7,1,3,0,15,0,1,6,0,11,22,0
340,6862,JtMmp5BCDQnYE7CMI3NvnX4aRCZsQW9K,A3fsA9Zfv1X2fVEQhTw51lKENdNrEqT3,22,57,28,0,8,56,31,0,180,25.714285714285715,5,0.0,12,28,0,8,45,56,0,31,0,48,132,0
341,6878,7fC3V6ivG07wUIMOmiYFzSlyjWvbYnYf,SpATywNh6bZuzm8s1ceuBUnMUAeoAHHw,11,11,0,14,0,0,2,0,27,3.857142857142857,1,0.0,3,0,13,0,8,0,1,2,0,16,11,0
342,6895,z69L6knExrBf5gtr9B70Dgt3D9Xtp8CH,A3fsA9Zfv1X2fVEQhTw51lKENdNrEqT3,33,22,13,146,7,0,3,0,191,27.285714285714285,1,0.0,6,13,126,7,16,0,20,3,0,152,39,1
343,6896,WVOs4Pi3ll5FpomkXlRuIpcugHN3f0rV,SpATywNh6bZuzm8s1ceuBUnMUAeoAHHw,17,37,15,12,7,0,7,0,78,11.142857142857142,3,0.0,12,15,12,7,25,0,0,7,0,46,32,0
344,6907,CjvViMn5KClGeXFftICAvm8SWkvn3LHW,A3fsA9Zfv1X2fVEQhTw51lKENdNrEqT3,29,8,6,72,4,5,2,0,97,13.857142857142858,1,0.0,1,6,64,4,7,5,8,2,0,75,22,1
345,6920,V29AZJRcvBxCayax5I99yuRivRNPAZjj,A3fsA9Zfv1X2fVEQhTw51lKENdNrEqT3,6,8,5,0,1,0,4,0,18,2.5714285714285716,2,0.0,0,5,0,1,8,0,0,4,0,6,12,0
346,6934,nsZMAREUaN1W79W768VHLU7EdYuf3Qrp,G8EPVSXsOYB5YQWZGiz1aVq5Pgr2GrQu,44,40,6,89,7,33,15,0,190,27.142857142857142,5,0.0,1,6,62,7,39,33,27,15,0,76,114,0
347,6944,cG2zraudtV44kPzel5abcAzgwVOUaAs4,A3fsA9Zfv1X2fVEQhTw51lKENdNrEqT3,7,8,0,6,0,0,3,0,17,2.4285714285714284,1,0.0,1,0,5,0,7,0,1,3,0,6,11,1
348,6972,ySy2zYThCkVZr5MjEXuKxq60wfOynxkJ,RXDvfPUBYFlVdlueBFbLW0mhhAyGEqpt,21,29,0,30,3,0,3,0,65,9.285714285714286,1,0.0,8,0,29,3,21,0,1,3,0,40,25,0
349,6977,EO1ssFp8oIj0TSE3bDdD8GeuhxRs5RVg,SpATywNh6bZuzm8s1ceuBUnMUAeoAHHw,16,34,6,17,3,0,12,0,72,10.285714285714286,4,0.0,6,6,16,3,28,0,1,12,0,31,41,0
350,6986,7fC3V6ivG07wUIMOmiYFzSlyjWvbYnYf,bWdj2GDclj5ofokWjzoa5jAwMkxCykd6,28,21,0,100,0,0,8,0,129,18.428571428571427,3,0.0,2,0,81,0,19,0,19,8,0,83,46,0
351,6996,Ah63NhKhS4EP98tjvGlVfvoLlBn6V6BJ,A3fsA9Zfv1X2fVEQhTw51lKENdNrEqT3,12,7,4,0,2,1,12,1,27,3.857142857142857,1,0.0,0,4,0,2,7,1,0,12,1,6,21,1
352,7009,oBSB2zh7bYN4yELh7x5ItqnxR463BvKC,bWdj2GDclj5ofokWjzoa5jAwMkxCykd6,28,119,37,104,31,2,15,0,308,44.0,5,0.0,34,37,90,31,85,2,14,15,0,192,116,0
353,7033,hplRuUXyLFhHcMqMJcb12YjqquTYp3Qw,A3fsA9Zfv1X2fVEQhTw51lKENdNrEqT3,43,38,17,80,11,0,5,0,151,21.571428571428573,3,0.0,5,17,64,11,33,0,16,5,0,97,54,0
354,7037,1pusTPLSLF5m0UuZqZkNpGlAq8VrQ1KA,SpATywNh6bZuzm8s1ceuBUnMUAeoAHHw,1,0,0,0,0,0,1,0,1,0.14285714285714285,1,0.0,0,0,0,0,0,0,0,1,0,0,1,0
355,7045,Qo4EYwRduG0qocv3scjgK3zQnLtIvid1,SpATywNh6bZuzm8s1ceuBUnMUAeoAHHw,16,65,6,0,4,0,31,5,111,15.857142857142858,3,0.0,0,6,0,4,65,0,0,31,5,10,101,0
356,7080,KqUCRL8ws5CG5PQvlspSHJpgFexIO4Jl,SpATywNh6bZuzm8s1ceuBUnMUAeoAHHw,13,40,1,16,0,0,0,0,57,8.142857142857142,1,0.0,12,1,14,0,28,0,2,0,0,27,30,0
357,7117,RHl3DsvAX7TisJ7qBptmgrrtDAQvH7mr,A3fsA9Zfv1X2fVEQhTw51lKENdNrEqT3,18,33,15,6,5,5,18,0,82,11.714285714285714,4,0.0,4,15,5,5,29,5,1,18,0,29,53,0
358,7124,DRhlp1eJHQqsxjCL0bRD6kkHN20HbJ4w,SpATywNh6bZuzm8s1ceuBUnMUAeoAHHw,16,11,7,12,4,0,2,0,36,5.142857142857143,2,0.0,2,7,11,4,9,0,1,2,0,24,12,0
359,7129,mgwquciozkhcF0WnEEHOJYDb1rZHthNN,A3fsA9Zfv1X2fVEQhTw51lKENdNrEqT3,5,4,0,0,0,0,3,0,7,1.0,1,0.0,0,0,0,0,4,0,0,3,0,0,7,1
360,7137,rT1OrFQC18rdvYkTGYqwRgC7eDvihHsc,bWdj2GDclj5ofokWjzoa5jAwMkxCykd6,5,4,2,0,0,92,17,2,117,16.714285714285715,7,0.0,0,2,0,0,4,92,0,17,2,2,115,0
361,7142,YE22fRNdaFtk3nhWfjSOMHWERX5O7Ymi,A3fsA9Zfv1X2fVEQhTw51lKENdNrEqT3,59,29,4,82,3,0,8,0,126,18.0,2,0.0,3,4,79,3,26,0,3,8,0,89,37,0
362,7171,QzVwezWUOBpl33EMiprsTWQNwkGzpYUZ,A3fsA9Zfv1X2fVEQhTw51lKENdNrEqT3,7,4,2,0,2,0,4,0,12,1.7142857142857142,2,0.0,1,2,0,2,3,0,0,4,0,5,7,0
363,7179,3HOnjRDe3XaKpyhDvtGYWIvTQ5R0B6U5,RXDvfPUBYFlVdlueBFbLW0mhhAyGEqpt,15,12,8,0,4,1,10,0,35,5.0,2,0.0,1,8,0,4,11,1,0,10,0,13,22,1
364,7181,29zlPnPFaHRpKhWmQq4cQrKoDn0GEyMA,SpATywNh6bZuzm8s1ceuBUnMUAeoAHHw,3,2,1,0,0,0,1,0,4,0.5714285714285714,1,0.0,0,1,0,0,2,0,0,1,0,1,3,1
365,7197,yiOlNWWu3p4vJ73FHFCmMYCNgzMDTrne,A3fsA9Zfv1X2fVEQhTw51lKENdNrEqT3,3,2,1,0,0,0,3,0,6,0.8571428571428571,2,0.0,0,1,0,0,2,0,0,3,0,1,5,1
366,7222,7abxlkdMiNWAIk78NzVnHWo2fZI6eMvl,SpATywNh6bZuzm8s1ceuBUnMUAeoAHHw,23,15,11,0,7,33,12,1,79,11.285714285714286,2,0.0,2,11,0,7,13,33,0,12,1,20,59,1
367,7229,iZlqOil8HuQgM9wIdCp3EDJlfdWSJRmO,SpATywNh6bZuzm8s1ceuBUnMUAeoAHHw,24,37,1,33,1,30,8,5,115,16.428571428571427,4,0.0,8,1,29,1,29,30,4,8,5,39,76,0
368,7232,Kv9yM6Ye606xOusGmqGDWX6SW9fdHP2Q,A3fsA9Zfv1X2fVEQhTw51lKENdNrEqT3,1,0,0,0,0,0,1,0,1,0.14285714285714285,1,0.0,0,0,0,0,0,0,0,1,0,0,1,1
369,7240,HJ4qDtw6u2JHJE7qmEDgWJOzWUYAv4mG,A3fsA9Zfv1X2fVEQhTw51lKENdNrEqT3,18,14,11,48,4,12,5,0,94,13.428571428571429,4,0.0,0,11,41,4,14,12,7,5,0,56,38,0
370,7256,D1NRZnTG0gvNQpfa2XPRkdGhYZVx3Bz8,RXDvfPUBYFlVdlueBFbLW0mhhAyGEqpt,37,56,43,59,23,10,6,0,197,28.142857142857142,3,0.0,8,43,51,23,48,10,8,6,0,125,72,0
371,7274,YZ1MgmwJiUridNKhbKx061bAjGk955T1,G8EPVSXsOYB5YQWZGiz1aVq5Pgr2GrQu,36,82,5,58,3,16,16,4,184,26.285714285714285,5,0.0,4,5,51,3,78,16,7,16,4,63,121,0
372,7296,ObMYjZj16p1bGCa8nmaBIv8cDUPUXE5o,SpATywNh6bZuzm8s1ceuBUnMUAeoAHHw,21,43,1,22,1,13,10,3,93,13.285714285714286,2,0.0,11,1,18,1,32,13,4,10,3,31,62,0
373,7297,bAkMyE6uCR0gc04pERZmDJrGVqJ4Z2Yi,G8EPVSXsOYB5YQWZGiz1aVq5Pgr2GrQu,56,55,13,84,12,12,4,0,180,25.714285714285715,3,0.0,29,13,56,12,26,12,28,4,0,110,70,0
374,7298,VSEOcWZYpZiKC2PUmidzj4VqbBnc3GAo,bWdj2GDclj5ofokWjzoa5jAwMkxCykd6,26,27,17,77,7,0,47,0,175,25.0,7,0.0,6,17,67,7,21,0,10,47,0,97,78,0
375,7303,Yby0It9Tj4ASosIcvg72qeavqJKBNZLT,A3fsA9Zfv1X2fVEQhTw51lKENdNrEqT3,2,0,0,0,0,0,2,0,2,0.2857142857142857,1,0.0,0,0,0,0,0,0,0,2,0,0,2,1
376,7328,83p9ejSELsW1j5wNlAyUXF2YWFL8Z8tc,bWdj2GDclj5ofokWjzoa5jAwMkxCykd6,38,51,17,190,10,0,7,0,275,39.285714285714285,4,0.0,16,17,174,10,35,0,16,7,0,217,58,0
377,7344,B9KqNNxXBxHFUsJnQKQysblL3f8zF7sg,A3fsA9Zfv1X2fVEQhTw51lKENdNrEqT3,9,27,1,0,0,7,8,0,43,6.142857142857143,5,0.0,4,1,0,0,23,7,0,8,0,5,38,0
378,7372,32uJBAomTJQIXKZnCX4K7PYoVfESGbct,A3fsA9Zfv1X2fVEQhTw51lKENdNrEqT3,44,19,2,122,0,0,2,0,145,20.714285714285715,3,0.0,2,2,101,0,17,0,21,2,0,105,40,1
379,7391,7L5unYIhab1TebFiFv55Vd3f3JppE4WH,A3fsA9Zfv1X2fVEQhTw51lKENdNrEqT3,4,2,1,0,1,0,2,0,6,0.8571428571428571,1,0.0,0,1,0,1,2,0,0,2,0,2,4,0
380,7422,WKdxdVcCk0v6q8w6qEVoDAEpoNH9nq1b,A3fsA9Zfv1X2fVEQhTw51lKENdNrEqT3,3,2,1,0,0,0,2,0,5,0.7142857142857143,1,0.0,0,1,0,0,2,0,0,2,0,1,4,1
381,7428,dTkPxaFmNowU6Qk7fnasqvgAevZOuRY9,RXDvfPUBYFlVdlueBFbLW0mhhAyGEqpt,43,17,10,78,7,9,4,0,125,17.857142857142858,2,0.0,7,10,77,7,10,9,1,4,0,101,24,1
382,7439,yK7fQWYLG0RsBbgokh3BoTMU9oScdsOd,bWdj2GDclj5ofokWjzoa5jAwMkxCykd6,4,3,2,0,2,0,1,0,8,1.1428571428571428,1,0.0,0,2,0,2,3,0,0,1,0,4,4,1
383,7440,5TRqp5WlxU778HZGbnj0S6xLTaRfUJxG,SpATywNh6bZuzm8s1ceuBUnMUAeoAHHw,14,15,1,2,1,3,5,1,28,4.0,2,0.0,1,1,2,1,14,3,0,5,1,5,23,0
384,7463,zdqliI4eCBGH6nGv4KKIRZFL1YFXBytK,SpATywNh6bZuzm8s1ceuBUnMUAeoAHHw,19,19,12,16,4,40,8,0,99,14.142857142857142,2,0.0,3,12,15,4,16,40,1,8,0,34,65,0
385,7464,lFMYqumkG36iLJm9YwVpbzadzxUvswUa,bWdj2GDclj5ofokWjzoa5jAwMkxCykd6,1,0,0,0,0,0,1,0,1,0.14285714285714285,1,0.0,0,0,0,0,0,0,0,1,0,0,1,1
386,7466,lFMYqumkG36iLJm9YwVpbzadzxUvswUa,SpATywNh6bZuzm8s1ceuBUnMUAeoAHHw,4,1,1,0,0,0,2,0,4,0.5714285714285714,1,0.0,0,1,0,0,1,0,0,2,0,1,3,0
387,7475,vRHTfFGO3STxLwMRkIw1geBTPnARvg2o,SpATywNh6bZuzm8s1ceuBUnMUAeoAHHw,1,0,1,0,0,0,0,0,1,0.14285714285714285,1,0.0,0,1,0,0,0,0,0,0,0,1,0,0
388,7491,uUSTKM8g1hIskJbYHh1UiIQ6epHTSTNR,RXDvfPUBYFlVdlueBFbLW0mhhAyGEqpt,24,32,17,58,13,2,4,0,126,18.0,2,0.0,12,17,53,13,20,2,5,4,0,95,31,0
389,7496,6qVy3H4VOdeTnu4v49EIcz51mS5B3gWH,SpATywNh6bZuzm8s1ceuBUnMUAeoAHHw,15,24,14,10,0,38,12,1,99,14.142857142857142,5,0.0,4,14,8,0,20,38,2,12,1,26,73,0
390,7503,0PrF4PViZdaRQhbt6FYXwLbcetJ8RnwC,A3fsA9Zfv1X2fVEQhTw51lKENdNrEqT3,5,5,0,0,0,0,2,0,7,1.0,1,0.0,0,0,0,0,5,0,0,2,0,0,7,0
391,7504,NH2DAS5rCP8HjIcwHAZxDBAjUjjdHeyM,SpATywNh6bZuzm8s1ceuBUnMUAeoAHHw,29,24,19,18,9,29,17,0,116,16.571428571428573,2,0.0,5,19,17,9,19,29,1,17,0,50,66,0
392,7521,a3StgABPgimfVHzW1FR4usG9kIA0tZV5,bWdj2GDclj5ofokWjzoa5jAwMkxCykd6,7,16,0,4,1,0,3,0,24,3.4285714285714284,2,0.0,5,0,4,1,11,0,0,3,0,10,14,1
393,7535,8a9f5zlAzg00IZpxpFpd0Yys1Z1UDN82,RXDvfPUBYFlVdlueBFbLW0mhhAyGEqpt,38,72,46,31,23,2,9,0,183,26.142857142857142,3,0.0,1,46,27,23,71,2,4,9,0,97,86,1
394,7539,p6HxMfZynarvwZflE5DcOWxdvhYhrFbF,G8EPVSXsOYB5YQWZGiz1aVq5Pgr2GrQu,6,2,1,0,1,0,3,0,7,1.0,1,0.0,0,1,0,1,2,0,0,3,0,2,5,1
395,7540,oRVMh8MBvWswMrCZYZVSC4ANhRghr3SC,RXDvfPUBYFlVdlueBFbLW0mhhAyGEqpt,8,8,4,0,2,0,3,0,17,2.4285714285714284,2,0.0,0,4,0,2,8,0,0,3,0,6,11,1
396,7550,EGswqlieknT0DkOMjaOEPr1kJjoddSSw,G8EPVSXsOYB5YQWZGiz1aVq5Pgr2GrQu,8,16,2,0,2,12,6,1,39,5.571428571428571,3,0.0,0,2,0,2,16,12,0,6,1,4,35,0
397,7552,ljmWZCzWPqv1RXsn1q2wpsQtrnA1zct2,SpATywNh6bZuzm8s1ceuBUnMUAeoAHHw,18,26,15,12,5,6,4,0,68,9.714285714285714,1,0.0,6,15,11,5,20,6,1,4,0,37,31,0
398,7562,606SeIKBIFg9vt3BinDbRysHBP3GLEGI,bWdj2GDclj5ofokWjzoa5jAwMkxCykd6,11,10,2,0,3,7,11,2,35,5.0,1,0.0,2,2,0,3,8,7,0,11,2,7,28,1
399,7571,hPtqAQmVA3C7MVQi98nPJLfZYLyZ86Qe,SpATywNh6bZuzm8s1ceuBUnMUAeoAHHw,2,0,1,0,1,0,0,0,2,0.2857142857142857,1,0.0,0,1,0,1,0,0,0,0,0,2,0,1
400,7579,7KQcIrOp3KoypOTvziMED7rHtDH1CXtE,SpATywNh6bZuzm8s1ceuBUnMUAeoAHHw,12,11,0,18,0,0,5,0,34,4.857142857142857,1,0.0,3,0,15,0,8,0,3,5,0,18,16,1
401,7581,QoKkWqCz9JSPf2G2l4XrJl2BfFSq9X9B,RXDvfPUBYFlVdlueBFbLW0mhhAyGEqpt,8,10,1,0,0,13,3,0,27,3.857142857142857,1,0.0,1,1,0,0,9,13,0,3,0,2,25,0
402,7628,hRBUrY0Ipi1X9aVKI1Gcp4xJWynJPCa6,SpATywNh6bZuzm8s1ceuBUnMUAeoAHHw,16,12,7,14,5,0,1,0,39,5.571428571428571,2,0.0,2,7,13,5,10,0,1,1,0,27,12,0
403,7632,YpYAswD6xdR70kiD53LA7ygDBkdDLMQF,SpATywNh6bZuzm8s1ceuBUnMUAeoAHHw,11,13,6,2,3,4,2,0,30,4.285714285714286,2,0.0,1,6,2,3,12,4,0,2,0,12,18,1
404,7633,11ljuSLdnPtPyfemLE7b9qn6qXcmssv1,SpATywNh6bZuzm8s1ceuBUnMUAeoAHHw,10,17,7,24,0,8,7,0,63,9.0,4,0.0,6,7,18,0,11,8,6,7,0,31,32,1
405,7634,I4noBaz6GyRD2PZe6j4LCRYlVDmmxoLh,SpATywNh6bZuzm8s1ceuBUnMUAeoAHHw,12,17,2,1,0,1,8,1,30,4.285714285714286,1,0.0,2,2,1,0,15,1,0,8,1,5,25,1
406,7642,WZSiXPjEuCIRtzYUNEK3DyAuPVNMLJ4a,SpATywNh6bZuzm8s1ceuBUnMUAeoAHHw,15,15,7,29,4,8,4,0,67,9.571428571428571,1,0.0,6,7,24,4,9,8,5,4,0,41,26,1
407,7647,ylrXVJAuag501sD5FTvKV7DusuU60h41,SpATywNh6bZuzm8s1ceuBUnMUAeoAHHw,5,2,0,0,1,0,3,0,6,0.8571428571428571,1,0.0,0,0,0,1,2,0,0,3,0,1,5,1
408,7652,PQ7ibn4CoD7R92qj9CnBXvU4YpUOqVHi,SpATywNh6bZuzm8s1ceuBUnMUAeoAHHw,22,36,24,12,9,0,17,1,99,14.142857142857142,3,0.0,12,24,12,9,24,0,0,17,1,57,42,0
409,7653,v9Jp2iBPSFTVxP8FrUe1odwfz8Hd1wS3,RXDvfPUBYFlVdlueBFbLW0mhhAyGEqpt,27,24,16,30,8,7,7,0,92,13.142857142857142,2,0.0,5,16,26,8,19,7,4,7,0,55,37,0
410,7675,LiEDHNjd9tDT7NPtKiOjuDJtkaP8cSxY,bWdj2GDclj5ofokWjzoa5jAwMkxCykd6,9,5,4,0,2,20,4,0,35,5.0,1,0.0,0,4,0,2,5,20,0,4,0,6,29,0
411,7679,GjmRL85Fx59ASzosh0kQzycWTmRCzek4,SpATywNh6bZuzm8s1ceuBUnMUAeoAHHw,10,25,0,17,0,0,2,0,44,6.285714285714286,1,0.0,18,0,16,0,7,0,1,2,0,34,10,1
412,7702,ulNRkVxxtx7SLWYKYYIDWhAGHHFqHWWG,SpATywNh6bZuzm8s1ceuBUnMUAeoAHHw,16,23,11,13,3,0,10,0,60,8.571428571428571,3,0.0,6,11,12,3,17,0,1,10,0,32,28,0
413,7707,Om7TmUpRVXmKCq1XRkQCdyE9M7r8n9tE,SpATywNh6bZuzm8s1ceuBUnMUAeoAHHw,11,20,0,14,0,4,6,1,45,6.428571428571429,1,0.0,7,0,14,0,13,4,0,6,1,21,24,0
414,7711,U4GXlaQk4qQjr2K7P59OKvXX0vv1Pxee,SpATywNh6bZuzm8s1ceuBUnMUAeoAHHw,4,5,2,0,0,0,2,0,9,1.2857142857142858,2,0.0,0,2,0,0,5,0,0,2,0,2,7,0
415,7713,0W4XScVx81tfxJ0Qr09mHB39FqA62JyS,SpATywNh6bZuzm8s1ceuBUnMUAeoAHHw,4,2,1,0,0,0,2,0,5,0.7142857142857143,1,0.0,0,1,0,0,2,0,0,2,0,1,4,1
416,7716,yG9o9nU1hVydCMiwULHDO2ptGPwb3jNJ,SpATywNh6bZuzm8s1ceuBUnMUAeoAHHw,13,13,8,6,2,0,3,0,32,4.571428571428571,3,0.0,2,8,6,2,11,0,0,3,0,18,14,1
417,7721,MAlRgKpZXlP3WrMKjRw2YskqEALVtCKw,SpATywNh6bZuzm8s1ceuBUnMUAeoAHHw,11,10,0,11,0,0,3,0,24,3.4285714285714284,1,0.0,2,0,11,0,8,0,0,3,0,13,11,0
418,7727,h5vEAVTb94xGNGjpn4Ohi5mNcXfM0rMl,RXDvfPUBYFlVdlueBFbLW0mhhAyGEqpt,9,10,1,6,1,0,4,0,22,3.142857142857143,1,0.0,2,1,6,1,8,0,0,4,0,10,12,1
419,7742,zu1WAijSG0F2wy5x45xxD1w2SrPWGtuK,RXDvfPUBYFlVdlueBFbLW0mhhAyGEqpt,28,38,4,16,3,19,25,4,109,15.571428571428571,2,0.0,8,4,14,3,30,19,2,25,4,29,80,0
420,7748,cXt4yzdeLQWJ2a8N3WCCOFlxmV6sHALc,bWdj2GDclj5ofokWjzoa5jAwMkxCykd6,27,32,13,182,10,0,2,0,239,34.142857142857146,2,0.0,16,13,173,10,16,0,9,2,0,212,27,1
421,7752,nIJT2WzxvFmAAdv0mMRGLvQiPT819gU3,SpATywNh6bZuzm8s1ceuBUnMUAeoAHHw,17,42,8,16,6,6,20,0,98,14.0,3,0.0,10,8,13,6,32,6,3,20,0,37,61,0
422,7753,kzQ1HmHoPnIhyiOH3J5g0gxiDZh4kW6J,RXDvfPUBYFlVdlueBFbLW0mhhAyGEqpt,67,51,31,129,21,2,28,0,262,37.42857142857143,3,0.0,16,31,116,21,35,2,13,28,0,184,78,1
423,7762,2Sqmg51RWZnvGf1B4BEysn1wJm7yLaQl,G8EPVSXsOYB5YQWZGiz1aVq5Pgr2GrQu,28,25,6,48,2,0,5,0,86,12.285714285714286,2,0.0,0,6,48,2,25,0,0,5,0,56,30,0
424,7769,QV7Z9LfpjzP9d797QCfKxmoOjdo08shd,SpATywNh6bZuzm8s1ceuBUnMUAeoAHHw,18,16,11,8,7,9,2,0,53,7.571428571428571,2,0.0,2,11,8,7,14,9,0,2,0,28,25,0
425,7770,4dVGo2nGpdhjYgYbTYmjlligu2kflHn7,RXDvfPUBYFlVdlueBFbLW0mhhAyGEqpt,29,56,21,53,5,0,10,0,145,20.714285714285715,1,0.0,5,21,50,5,51,0,3,10,0,81,64,1
426,7782,EJ52dc9s4CYydLeBR3nGlXxXka6Fltqj,A3fsA9Zfv1X2fVEQhTw51lKENdNrEqT3,6,3,1,0,1,0,2,0,7,1.0,1,0.0,0,1,0,1,3,0,0,2,0,2,5,0
427,7784,Y96AzEZtgYGN39EPdmAzdYPvLhv1Tzsf,SpATywNh6bZuzm8s1ceuBUnMUAeoAHHw,16,9,6,15,4,8,3,0,45,6.428571428571429,2,0.0,2,6,13,4,7,8,2,3,0,25,20,0
428,7787,b87ksD29UBdF2YCxTtUOCsx5OJsZrMS6,SpATywNh6bZuzm8s1ceuBUnMUAeoAHHw,6,5,0,0,0,0,1,0,6,0.8571428571428571,1,0.0,0,0,0,0,5,0,0,1,0,0,6,1
429,7808,xG6pQFBC9YTxYi6joCJjOh2c6LkI7Trq,SpATywNh6bZuzm8s1ceuBUnMUAeoAHHw,5,2,1,0,1,0,2,0,6,0.8571428571428571,1,0.0,0,1,0,1,2,0,0,2,0,2,4,1
430,7816,rbxp4ygAJiuJravRmpeSgvTRbWslY8KE,G8EPVSXsOYB5YQWZGiz1aVq5Pgr2GrQu,42,42,14,102,9,1,8,1,177,25.285714285714285,2,0.0,25,14,75,9,17,1,27,8,1,123,54,1
431,7817,KLERBlLR5to2IuMEV6VaweaoU18ID2Ks,SpATywNh6bZuzm8s1ceuBUnMUAeoAHHw,12,16,7,11,3,0,3,0,40,5.714285714285714,1,0.0,5,7,10,3,11,0,1,3,0,25,15,1
432,7818,LMGbvXS3ZBgtTcKCRLMcqBHrfADBxwXe,SpATywNh6bZuzm8s1ceuBUnMUAeoAHHw,18,22,12,6,6,0,6,0,52,7.428571428571429,4,0.0,2,12,6,6,20,0,0,6,0,26,26,0
433,7819,hHscGHEjmeiL8NswOTKn3P6KxplprGQ7,SpATywNh6bZuzm8s1ceuBUnMUAeoAHHw,4,3,2,0,0,0,1,0,6,0.8571428571428571,1,0.0,0,2,0,0,3,0,0,1,0,2,4,1
434,7832,RNgrmqPicYezsE4BsF8Au4WfPdSMWP6C,G8EPVSXsOYB5YQWZGiz1aVq5Pgr2GrQu,12,13,7,0,1,2,13,1,37,5.285714285714286,2,0.0,2,7,0,1,11,2,0,13,1,10,27,1
435,7835,3iSbhZU0XFdJUgUA6Ry01TQ9T4nPzP7c,SpATywNh6bZuzm8s1ceuBUnMUAeoAHHw,6,4,1,0,1,0,1,0,7,1.0,1,0.0,0,1,0,1,4,0,0,1,0,2,5,1
436,7838,S10grfxrn0tXcuL6DSaVTf7wyvXspCvq,SpATywNh6bZuzm8s1ceuBUnMUAeoAHHw,5,6,0,0,0,9,6,0,21,3.0,1,0.0,0,0,0,0,6,9,0,6,0,0,21,0
437,7839,WYNpj52NyIePFOfUouGRXkQmACPQnP2J,SpATywNh6bZuzm8s1ceuBUnMUAeoAHHw,21,100,49,17,9,202,49,6,432,61.714285714285715,5,0.0,5,49,15,9,95,202,2,49,6,78,354,0
438,7855,FOHqSST3UlMcK0PZ2G62CXA809f8BW7i,bWdj2GDclj5ofokWjzoa5jAwMkxCykd6,5,2,1,0,1,0,2,0,6,0.8571428571428571,1,0.0,0,1,0,1,2,0,0,2,0,2,4,1
439,7857,Z6YQS36VdHJFF4DkVSTcUgmOIdlOITNE,SpATywNh6bZuzm8s1ceuBUnMUAeoAHHw,18,15,9,18,4,1,2,0,49,7.0,2,0.0,6,9,15,4,9,1,3,2,0,34,15,0
440,7858,Ak0ru019Ynz1X1qhUbDFCskGZavLrHBc,SpATywNh6bZuzm8s1ceuBUnMUAeoAHHw,30,71,36,33,16,24,10,2,192,27.428571428571427,2,0.0,27,36,31,16,44,24,2,10,2,110,82,0
441,7860,rWA9BhwEXXwDdj5p5FXRqP1JA3HaX1US,SpATywNh6bZuzm8s1ceuBUnMUAeoAHHw,28,43,22,31,13,2,3,0,114,16.285714285714285,2,0.0,17,22,28,13,26,2,3,3,0,80,34,1
442,7863,bDqqR2hng29QNjexgLbMGRH4AJBfyli8,SpATywNh6bZuzm8s1ceuBUnMUAeoAHHw,10,8,7,6,2,0,1,0,24,3.4285714285714284,1,0.0,0,7,5,2,8,0,1,1,0,14,10,1
443,7868,ptvDGcVFI5vzF4lBwRLTADNrenNp2tF2,SpATywNh6bZuzm8s1ceuBUnMUAeoAHHw,16,20,4,9,1,0,11,0,45,6.428571428571429,2,0.0,3,4,8,1,17,0,1,11,0,16,29,0
444,7870,sj7wQJWVAxmId67LlkoaFzAmqWKmeC7I,SpATywNh6bZuzm8s1ceuBUnMUAeoAHHw,21,135,8,8,4,119,67,1,342,48.857142857142854,6,0.0,25,8,8,4,110,119,0,67,1,45,297,0
445,7882,0zObXmoXHP7rszDYuu8m5842mUKzCfEP,G8EPVSXsOYB5YQWZGiz1aVq5Pgr2GrQu,12,16,1,38,0,0,3,0,58,8.285714285714286,1,0.0,2,1,33,0,14,0,5,3,0,36,22,1
446,7883,JiNN6rHoPfwH1fuAk6q9tmTGqAFVjob4,SpATywNh6bZuzm8s1ceuBUnMUAeoAHHw,6,2,1,0,0,0,5,1,9,1.2857142857142858,1,0.0,0,1,0,0,2,0,0,5,1,1,8,0
447,7909,fbuy5iqzFkLuifp42uT7tvssNinDwhQ9,G8EPVSXsOYB5YQWZGiz1aVq5Pgr2GrQu,19,12,5,0,5,0,5,0,27,3.857142857142857,1,0.0,2,5,0,5,10,0,0,5,0,12,15,1
448,7923,pJUI0Hs11rZxgXk3r1clZCyuDCtGsbvH,SpATywNh6bZuzm8s1ceuBUnMUAeoAHHw,20,27,13,16,5,0,5,1,67,9.571428571428571,2,0.0,10,13,14,5,17,0,2,5,1,42,25,1
449,7933,dEPUxcdyZTnKUVP0o2JXv6VWX3ETnwmr,SpATywNh6bZuzm8s1ceuBUnMUAeoAHHw,18,40,15,29,0,10,14,1,109,15.571428571428571,2,0.0,23,15,23,0,17,10,6,14,1,61,48,1
450,7937,ywdL3xkp7d2PSjbvnflAvIe7Wp6Q4SRe,SpATywNh6bZuzm8s1ceuBUnMUAeoAHHw,18,44,14,14,5,0,6,0,83,11.857142857142858,2,0.0,18,14,13,5,26,0,1,6,0,50,33,0
451,7942,JNo2rLqKe6aBGDwGzu8tXd13uOC5tEnq,bWdj2GDclj5ofokWjzoa5jAwMkxCykd6,5,4,2,0,0,0,4,0,10,1.4285714285714286,1,0.0,2,2,0,0,2,0,0,4,0,4,6,0
452,7949,FnY3or5QaQRvUAAgyu53eYBfcMnduugT,SpATywNh6bZuzm8s1ceuBUnMUAeoAHHw,13,22,1,8,0,0,6,0,37,5.285714285714286,2,0.0,4,1,8,0,18,0,0,6,0,13,24,0
453,7952,CI12SZIYH2QOfgaDvq8F4VKXwDinb334,SpATywNh6bZuzm8s1ceuBUnMUAeoAHHw,24,34,18,21,6,1,5,1,86,12.285714285714286,3,0.0,11,18,19,6,23,1,2,5,1,54,32,0
454,7954,WzyWOzB7f8AVbQvaWeU3O4gxEwZ13sIC,RXDvfPUBYFlVdlueBFbLW0mhhAyGEqpt,5,5,3,0,1,0,2,0,11,1.5714285714285714,2,0.0,0,3,0,1,5,0,0,2,0,4,7,0
455,7956,ljmWZCzWPqv1RXsn1q2wpsQtrnA1zct2,G8EPVSXsOYB5YQWZGiz1aVq5Pgr2GrQu,34,19,12,122,8,9,4,0,174,24.857142857142858,1,0.0,5,12,93,8,14,9,29,4,0,118,56,1
456,7962,mtW8rWxW2XwZIB5TM8b8gUVmE4UACp0R,SpATywNh6bZuzm8s1ceuBUnMUAeoAHHw,11,10,6,8,2,0,3,0,29,4.142857142857143,2,0.0,2,6,8,2,8,0,0,3,0,18,11,0
457,7967,Wyji6pvgj7unEJ4mD7FWwu0Sma8fUdv4,SpATywNh6bZuzm8s1ceuBUnMUAeoAHHw,24,41,27,15,14,19,14,2,132,18.857142857142858,1,0.0,9,27,15,14,32,19,0,14,2,65,67,0
458,7970,2mdoNlBiXpgUVSmoihAheHl3NISmi738,SpATywNh6bZuzm8s1ceuBUnMUAeoAHHw,3,0,0,0,0,14,2,0,16,2.2857142857142856,1,0.0,0,0,0,0,0,14,0,2,0,0,16,1
459,7973,SUqHrTqjE8jHVpASqCaMjjR6iZ17k2Gq,SpATywNh6bZuzm8s1ceuBUnMUAeoAHHw,17,21,10,24,4,0,3,0,62,8.857142857142858,2,0.0,8,10,21,4,13,0,3,3,0,43,19,0
460,7975,EwJz8sdPLnTPbvCqxQKV7YueKEdP0wYf,SpATywNh6bZuzm8s1ceuBUnMUAeoAHHw,9,5,4,0,3,0,1,0,13,1.8571428571428572,1,0.0,0,4,0,3,5,0,0,1,0,7,6,0
461,7999,j55CnsxXtuPHDTIgqOvx7oExU3RRtQ4I,SpATywNh6bZuzm8s1ceuBUnMUAeoAHHw,31,37,18,31,7,11,23,1,128,18.285714285714285,4,0.0,12,18,29,7,25,11,2,23,1,66,62,1
462,8000,YiNeIrEOhZYEzsuuN5nQKcsVr5To2nDU,SpATywNh6bZuzm8s1ceuBUnMUAeoAHHw,17,16,8,18,4,0,8,0,54,7.714285714285714,2,0.0,8,8,15,4,8,0,3,8,0,35,19,0
463,8001,DI3YZyhWTKxhZZnQuVUpGne2QEEoyvnw,SpATywNh6bZuzm8s1ceuBUnMUAeoAHHw,32,52,23,32,13,1,15,18,154,22.0,3,0.0,24,23,30,13,28,1,2,15,18,90,64,0
464,8016,0wTvjguYOmHTRx6CgVlID5lRmd6At3zN,RXDvfPUBYFlVdlueBFbLW0mhhAyGEqpt,7,3,2,0,2,1,2,0,10,1.4285714285714286,1,0.0,0,2,0,2,3,1,0,2,0,4,6,0
465,8026,KtSnhyXFi6bevwD38L0oZAkqxHVX0Rkl,RXDvfPUBYFlVdlueBFbLW0mhhAyGEqpt,14,29,1,12,2,0,0,0,44,6.285714285714286,1,0.0,5,1,12,2,24,0,0,0,0,20,24,1
466,8029,cuDL2ISAKT9SiekAD9CQynXiu9fQTVyV,G8EPVSXsOYB5YQWZGiz1aVq5Pgr2GrQu,30,21,6,70,3,0,12,0,112,16.0,5,0.0,0,6,60,3,21,0,10,12,0,69,43,0
467,8031,Ra8GzsxOGVkAaMFXN2T6V1Y5fgtJJH5X,SpATywNh6bZuzm8s1ceuBUnMUAeoAHHw,10,25,0,9,0,0,2,0,36,5.142857142857143,2,0.0,6,0,8,0,19,0,1,2,0,14,22,0
468,8051,HZ6Si9PJ3YYyrZuVsVHlXbrETWWPILa2,SpATywNh6bZuzm8s1ceuBUnMUAeoAHHw,17,14,6,20,4,0,5,0,49,7.0,1,0.0,4,6,17,4,10,0,3,5,0,31,18,1
469,8059,W8K4VS8rPvnPTNUJrqgtS2FKH93KmR91,bWdj2GDclj5ofokWjzoa5jAwMkxCykd6,40,55,26,251,16,5,10,1,364,52.0,3,0.0,6,26,228,16,49,5,23,10,1,276,88,1
470,8061,eDdFtfGTTqvukOdpQCeNfhpEnZacRMyL,SpATywNh6bZuzm8s1ceuBUnMUAeoAHHw,15,8,5,8,4,0,2,0,27,3.857142857142857,1,0.0,2,5,7,4,6,0,1,2,0,18,9,0
471,8070,Hk1cgW0d6IHp4JJgdPvorinTv3vI8Eld,bWdj2GDclj5ofokWjzoa5jAwMkxCykd6,2,0,0,0,0,0,2,0,2,0.2857142857142857,1,0.0,0,0,0,0,0,0,0,2,0,0,2,1
472,8078,nD2aR2lBTYEZ05tUWGjogkwgt2d7zeNx,bWdj2GDclj5ofokWjzoa5jAwMkxCykd6,8,13,1,8,0,0,1,0,23,3.2857142857142856,1,0.0,0,1,7,0,13,0,1,1,0,8,15,1
473,8106,MyaVABM4nYDk4vd54igotJktuGSzZ2QZ,SpATywNh6bZuzm8s1ceuBUnMUAeoAHHw,4,2,0,0,0,0,2,0,4,0.5714285714285714,1,0.0,0,0,0,0,2,0,0,2,0,0,4,1
474,8124,aFQfsfvTRloUF4eJLXlE0V3FUzRLFNv8,RXDvfPUBYFlVdlueBFbLW0mhhAyGEqpt,7,4,3,0,1,0,3,0,11,1.5714285714285714,1,0.0,0,3,0,1,4,0,0,3,0,4,7,1
475,8131,0chnDCxU68X7ybwDimwVoWcTfCUDrb8j,SpATywNh6bZuzm8s1ceuBUnMUAeoAHHw,10,8,6,0,3,1,4,1,23,3.2857142857142856,1,0.0,0,6,0,3,8,1,0,4,1,9,14,1
476,8150,0QzhB266MffxtP4NW9xGCK2aFIanQJEL,SpATywNh6bZuzm8s1ceuBUnMUAeoAHHw,4,5,3,0,0,2,2,0,12,1.7142857142857142,1,0.0,0,3,0,0,5,2,0,2,0,3,9,1
477,8155,S6HVmLPlerZStE1FmYWcP13FOlr0Ldio,SpATywNh6bZuzm8s1ceuBUnMUAeoAHHw,15,16,1,9,0,0,15,2,43,6.142857142857143,4,0.0,2,1,8,0,14,0,1,15,2,11,32,1
478,8159,rLDZGBeZrRdOkLUUwzLb6ezyjai8N3vb,G8EPVSXsOYB5YQWZGiz1aVq5Pgr2GrQu,9,3,2,0,1,2,8,0,16,2.2857142857142856,1,0.0,0,2,0,1,3,2,0,8,0,3,13,1
479,8164,OvIrFDXnTf7lPGXHN37tKh2m9dXSHGJK,RXDvfPUBYFlVdlueBFbLW0mhhAyGEqpt,13,12,8,6,2,53,11,8,100,14.285714285714286,3,0.0,1,8,6,2,11,53,0,11,8,17,83,0
480,8167,4OFy9ZLb1svxpVgXkgI60wOGeiU4V4oA,SpATywNh6bZuzm8s1ceuBUnMUAeoAHHw,5,8,2,0,0,1,4,0,15,2.142857142857143,1,0.0,0,2,0,0,8,1,0,4,0,2,13,1
481,8171,Agc8I1aREEPfi2PqA7NK0aenTcuvE1HC,SpATywNh6bZuzm8s1ceuBUnMUAeoAHHw,19,16,12,11,8,3,5,2,57,8.142857142857142,1,0.0,2,12,10,8,14,3,1,5,2,32,25,0
482,8174,ZFeBOOLKgUUTF7XgzMMbqDAJmFSviC7K,SpATywNh6bZuzm8s1ceuBUnMUAeoAHHw,29,32,17,26,12,0,11,0,98,14.0,2,0.0,12,17,24,12,20,0,2,11,0,65,33,0
483,8183,FFyynYy7wGQKjNauntgybGuFHItz8juf,G8EPVSXsOYB5YQWZGiz1aVq5Pgr2GrQu,34,37,18,91,13,0,4,0,163,23.285714285714285,2,0.0,3,18,77,13,34,0,14,4,0,111,52,0
484,8190,yFLanYq8p4sf6NFSB1Td9ag6632plY4t,bWdj2GDclj5ofokWjzoa5jAwMkxCykd6,15,15,9,0,4,0,4,0,32,4.571428571428571,2,0.0,4,9,0,4,11,0,0,4,0,17,15,1
485,8193,95EnvGi27MT4ra7RQ8eLxKyAZNUVPzZY,G8EPVSXsOYB5YQWZGiz1aVq5Pgr2GrQu,4,0,0,0,0,0,5,0,5,0.7142857142857143,1,0.0,0,0,0,0,0,0,0,5,0,0,5,1
486,8194,I2GJVZ7RHpZycmvh6r4mj8R0Y34OZpBl,SpATywNh6bZuzm8s1ceuBUnMUAeoAHHw,13,12,1,16,1,0,1,0,31,4.428571428571429,1,0.0,2,1,13,1,10,0,3,1,0,17,14,1
487,8200,myPDU4mr5TIDvQCh3WcoSxbhe6fCunPv,SpATywNh6bZuzm8s1ceuBUnMUAeoAHHw,15,24,10,13,6,0,2,0,55,7.857142857142857,2,0.0,4,10,11,6,20,0,2,2,0,31,24,0
488,8216,PR09vSIT2XyOVxXQjGmEX911FaSVIYTE,SpATywNh6bZuzm8s1ceuBUnMUAeoAHHw,3,4,2,0,0,0,2,0,8,1.1428571428571428,2,0.0,0,2,0,0,4,0,0,2,0,2,6,1
489,8223,nx1z63DgmeEAxW8gQgEbpcNs34kbRne4,bWdj2GDclj5ofokWjzoa5jAwMkxCykd6,2,0,0,0,0,0,5,0,5,0.7142857142857143,2,0.0,0,0,0,0,0,0,0,5,0,0,5,1
490,8224,5u57vWlYBlYDQJhbIpJzLY4ZLMAv0Mtf,SpATywNh6bZuzm8s1ceuBUnMUAeoAHHw,16,13,5,14,4,0,4,0,40,5.714285714285714,1,0.0,4,5,13,4,9,0,1,4,0,26,14,1
491,8234,1IMOvf9v1bRH0tUTRkiIkzGe833lnAgf,SpATywNh6bZuzm8s1ceuBUnMUAeoAHHw,16,12,7,12,4,0,2,0,37,5.285714285714286,1,0.0,2,7,9,4,10,0,3,2,0,22,15,1
492,8235,gNTGzjcOmHTKgzmUa0veV0Pk7aaKxz1N,SpATywNh6bZuzm8s1ceuBUnMUAeoAHHw,15,27,3,28,0,12,3,0,73,10.428571428571429,1,0.0,14,3,23,0,13,12,5,3,0,40,33,0
493,8241,EV3yvBrX41XoJgzc87hp5TvHhhtAvyFn,SpATywNh6bZuzm8s1ceuBUnMUAeoAHHw,26,38,19,28,8,0,8,0,101,14.428571428571429,3,0.0,8,19,26,8,30,0,2,8,0,61,40,1
494,8242,3mL78JhEm154Hwp0XQW8ZVuzbvUw5uCk,SpATywNh6bZuzm8s1ceuBUnMUAeoAHHw,14,22,15,0,9,0,3,0,49,7.0,2,0.0,2,15,0,9,20,0,0,3,0,26,23,0
495,8252,HKDSRzc7MQzCfJsk49D6xFQK4oFHHvy7,SpATywNh6bZuzm8s1ceuBUnMUAeoAHHw,21,59,0,38,0,7,32,1,137,19.571428571428573,5,0.0,28,0,32,0,31,7,6,32,1,60,77,0
496,8258,JTNAXWhf5PjT17BvIH89SNZsmQ5O87y8,SpATywNh6bZuzm8s1ceuBUnMUAeoAHHw,17,22,7,21,4,0,2,0,56,8.0,1,0.0,14,7,21,4,8,0,0,2,0,46,10,1
497,8259,DVIil2NM7ZWOtqe6rhlMzwEUAb2wuaeh,bWdj2GDclj5ofokWjzoa5jAwMkxCykd6,16,29,17,46,10,7,6,0,115,16.428571428571427,3,0.0,8,17,46,10,21,7,0,6,0,81,34,0
498,8260,DVIil2NM7ZWOtqe6rhlMzwEUAb2wuaeh,A3fsA9Zfv1X2fVEQhTw51lKENdNrEqT3,38,54,35,32,11,8,9,0,149,21.285714285714285,3,0.0,4,35,32,11,50,8,0,9,0,82,67,0
499,8271,Bf5XnSmEHpp62KAmmEq9Qh5nAQvits8I,SpATywNh6bZuzm8s1ceuBUnMUAeoAHHw,14,20,12,7,6,6,2,0,53,7.571428571428571,2,0.0,9,12,7,6,11,6,0,2,0,34,19,1
500,8274,wcD7BoyQ6hUK2AqYmriY7H2V7sWuy6kP,G8EPVSXsOYB5YQWZGiz1aVq5Pgr2GrQu,6,2,0,0,0,1,6,1,10,1.4285714285714286,1,0.0,0,0,0,0,2,1,0,6,1,0,10,1
501,8275,GHabqgRgi0KXSBTYXxIc3mcQESEOp0QM,SpATywNh6bZuzm8s1ceuBUnMUAeoAHHw,4,2,1,0,0,20,9,0,32,4.571428571428571,2,0.0,0,1,0,0,2,20,0,9,0,1,31,0
502,8276,V7y3ErWDx79HQwDxdGqBqCI3nEwG2a9C,SpATywNh6bZuzm8s1ceuBUnMUAeoAHHw,5,4,0,0,0,0,1,0,5,0.7142857142857143,1,0.0,0,0,0,0,4,0,0,1,0,0,5,0
503,8280,41Lg2hcbw0N9iuSjhrPTYqB7aTnux5zG,SpATywNh6bZuzm8s1ceuBUnMUAeoAHHw,16,19,8,10,4,0,4,0,45,6.428571428571429,3,0.0,2,8,10,4,17,0,0,4,0,24,21,0
504,8306,cpsVaqCE0ju1HgyRTcGi2lL27KFxQlQV,G8EPVSXsOYB5YQWZGiz1aVq5Pgr2GrQu,13,38,2,0,2,33,16,0,91,13.0,3,0.0,0,2,0,2,38,33,0,16,0,4,87,1
505,8319,VzKWDpKk4q6OejBxKl56odCKiGjlmGba,SpATywNh6bZuzm8s1ceuBUnMUAeoAHHw,7,3,2,0,2,0,2,0,9,1.2857142857142858,1,0.0,0,2,0,2,3,0,0,2,0,4,5,1
506,8327,Rxx8uEqY3FOt7Egy2EEEwihJJCyVsQKy,G8EPVSXsOYB5YQWZGiz1aVq5Pgr2GrQu,65,59,20,89,12,12,11,0,203,29.0,3,0.0,33,20,61,12,26,12,28,11,0,126,77,0
507,8330,RPoQoiLJoTfoUXTEomWL6iW4S8GRhX7J,SpATywNh6bZuzm8s1ceuBUnMUAeoAHHw,1,3,0,0,0,0,0,0,3,0.42857142857142855,2,0.0,0,0,0,0,3,0,0,0,0,0,3,0
508,8335,2tvGCUYYinrGZmVDaUEHPItUSSMqiKmY,SpATywNh6bZuzm8s1ceuBUnMUAeoAHHw,17,29,18,14,8,0,5,0,74,10.571428571428571,3,0.0,5,18,13,8,24,0,1,5,0,44,30,0
509,8337,SP1OGXx7XA1zodabwHSZpThCzaY2Fjl2,SpATywNh6bZuzm8s1ceuBUnMUAeoAHHw,13,15,1,16,1,0,3,0,36,5.142857142857143,2,0.0,2,1,15,1,13,0,1,3,0,19,17,0
510,8347,jMKMopo0fDIDt1YMaxiGrP1SNRt3VtFz,SpATywNh6bZuzm8s1ceuBUnMUAeoAHHw,16,24,11,14,6,3,4,0,62,8.857142857142858,1,0.0,11,11,13,6,13,3,1,4,0,41,21,0
511,8359,xI8Nr9tpm5UYMfkPTEK7ZnHqHm9s1zwr,SpATywNh6bZuzm8s1ceuBUnMUAeoAHHw,5,5,0,0,0,0,1,0,6,0.8571428571428571,1,0.0,0,0,0,0,5,0,0,1,0,0,6,1
512,8372,Ja8xgxpUQSylPcWwfGyX1RUCUJ6MhJqT,SpATywNh6bZuzm8s1ceuBUnMUAeoAHHw,6,3,1,0,1,0,2,0,7,1.0,1,0.0,0,1,0,1,3,0,0,2,0,2,5,0
513,8374,eA2IVnHLbAPJoKRWHDe6zYszLSF4Gt3f,SpATywNh6bZuzm8s1ceuBUnMUAeoAHHw,5,2,1,0,1,1,2,0,7,1.0,1,0.0,0,1,0,1,2,1,0,2,0,2,5,1
514,8386,UkUsH963uedhLI1tDU35ug9sCdholLWP,SpATywNh6bZuzm8s1ceuBUnMUAeoAHHw,1,0,0,0,0,0,1,0,1,0.14285714285714285,1,0.0,0,0,0,0,0,0,0,1,0,0,1,1
515,8389,NngMZQTGAdrhmbSK51CUolNQSpFXDhiO,SpATywNh6bZuzm8s1ceuBUnMUAeoAHHw,17,20,13,10,7,0,2,0,52,7.428571428571429,1,0.0,5,13,9,7,15,0,1,2,0,34,18,0
516,8391,tF8i4h1a2Nm3JCN3xA7kONOWBOERcJ4Q,SpATywNh6bZuzm8s1ceuBUnMUAeoAHHw,16,13,8,24,4,0,2,0,51,7.285714285714286,1,0.0,4,8,19,4,9,0,5,2,0,35,16,0
517,8393,4sCPuVlkq4rBRlBYNyTR5EDg94co1oy4,bWdj2GDclj5ofokWjzoa5jAwMkxCykd6,5,3,1,0,0,0,3,0,7,1.0,1,0.0,0,1,0,0,3,0,0,3,0,1,6,0
518,8400,LutlROyPHhGEkAfetUikskFihdvWMQNQ,SpATywNh6bZuzm8s1ceuBUnMUAeoAHHw,7,2,1,0,1,0,5,0,9,1.2857142857142858,2,0.0,0,1,0,1,2,0,0,5,0,2,7,1
519,8405,kWUbu8oK1dFJKpHhiF15MwcSzNzv8GaS,bWdj2GDclj5ofokWjzoa5jAwMkxCykd6,3,2,1,0,0,0,1,0,4,0.5714285714285714,1,0.0,0,1,0,0,2,0,0,1,0,1,3,0
520,8431,7CBtPeICctNtzQffl1jHApp4Y7WIYc5w,SpATywNh6bZuzm8s1ceuBUnMUAeoAHHw,7,6,5,0,2,0,2,0,15,2.142857142857143,1,0.0,0,5,0,2,6,0,0,2,0,7,8,1
521,8435,j1jdy8OF5VQw4rqSYOkbK2pQplvvvz37,A3fsA9Zfv1X2fVEQhTw51lKENdNrEqT3,19,33,4,22,2,4,21,0,86,12.285714285714286,5,0.0,0,4,20,2,33,4,2,21,0,26,60,0
522,8437,12tfSRcVHU1LY6VYbYjnNdGrVUGUAhWB,SpATywNh6bZuzm8s1ceuBUnMUAeoAHHw,16,13,9,6,4,0,2,0,34,4.857142857142857,2,0.0,2,9,6,4,11,0,0,2,0,21,13,0
523,8446,oDnQYjxji4p3XVFJMOGI9NvIvASqoqC1,A3fsA9Zfv1X2fVEQhTw51lKENdNrEqT3,19,8,7,34,4,0,9,0,62,8.857142857142858,4,0.0,0,7,28,4,8,0,6,9,0,39,23,1
524,8447,gok0oMg5xY1pC9HgrOtGpZy6NUwXLxlf,SpATywNh6bZuzm8s1ceuBUnMUAeoAHHw,9,16,0,6,0,0,5,0,27,3.857142857142857,2,0.0,2,0,5,0,14,0,1,5,0,7,20,1
525,8456,Ve3uiMw5Q81FgfkGuxFl4mQAXBScEtc6,G8EPVSXsOYB5YQWZGiz1aVq5Pgr2GrQu,3,0,0,0,0,0,5,0,5,0.7142857142857143,1,0.0,0,0,0,0,0,0,0,5,0,0,5,1
526,8461,tH916xRbn4bSZXJ6Z57PlnTAPQfz04PX,SpATywNh6bZuzm8s1ceuBUnMUAeoAHHw,20,18,11,2,5,0,6,0,42,6.0,3,0.0,1,11,2,5,17,0,0,6,0,19,23,0
527,8473,wfFQgTOVxHIMKx1Ficu9NrZPRH0gMksQ,bWdj2GDclj5ofokWjzoa5jAwMkxCykd6,3,3,0,0,0,0,1,0,4,0.5714285714285714,1,0.0,0,0,0,0,3,0,0,1,0,0,4,1
528,8476,iUNH7SHIFk6NFV7H1Nzzf4QPKBlc8jre,SpATywNh6bZuzm8s1ceuBUnMUAeoAHHw,9,5,4,0,4,0,2,0,15,2.142857142857143,1,0.0,0,4,0,4,5,0,0,2,0,8,7,1
529,8486,BeZnyZhcScrHr8WAPYtxUxDjMPiK7yK1,SpATywNh6bZuzm8s1ceuBUnMUAeoAHHw,12,16,10,0,6,0,5,0,37,5.285714285714286,3,0.0,0,10,0,6,16,0,0,5,0,16,21,0
530,8492,ttr9a170CwLt0wxJRJXz9h6pCGNxEiGM,SpATywNh6bZuzm8s1ceuBUnMUAeoAHHw,1,6,0,0,0,0,0,0,6,0.8571428571428571,3,0.0,0,0,0,0,6,0,0,0,0,0,6,1
531,8494,gir9E9ZUbwj6bCUNLD2kQmOx1nsVwG4J,SpATywNh6bZuzm8s1ceuBUnMUAeoAHHw,14,19,10,0,6,4,4,1,44,6.285714285714286,1,0.0,0,10,0,6,19,4,0,4,1,16,28,1
532,8503,PtXR7nBc6ugMebaEp6mKjp0TYO5kZtvE,SpATywNh6bZuzm8s1ceuBUnMUAeoAHHw,20,42,21,18,10,3,6,0,100,14.285714285714286,5,0.0,14,21,16,10,28,3,2,6,0,61,39,0
533,8511,FjbDR3UaxcNBkb6IH3GDQCUcWtWdh8Qq,A3fsA9Zfv1X2fVEQhTw51lKENdNrEqT3,7,5,3,6,1,0,1,0,16,2.2857142857142856,1,0.0,1,3,4,1,4,0,2,1,0,9,7,1
534,8519,doRePDFWyZgA5bRcL7NARsAGKc9EfIRX,SpATywNh6bZuzm8s1ceuBUnMUAeoAHHw,1,0,0,0,0,0,1,0,1,0.14285714285714285,1,0.0,0,0,0,0,0,0,0,1,0,0,1,1
535,8534,sYJH30p3sjRgvjLciMuuEKpuHxukMGmh,bWdj2GDclj5ofokWjzoa5jAwMkxCykd6,13,13,4,12,4,2,11,2,48,6.857142857142857,2,0.0,5,4,10,4,8,2,2,11,2,23,25,1
536,8539,ApFdQQBcLqTLoA4wIvtlnnwFs4FrlVS1,A3fsA9Zfv1X2fVEQhTw51lKENdNrEqT3,33,14,10,84,5,0,12,0,125,17.857142857142858,3,0.0,2,10,72,5,12,0,12,12,0,89,36,0
537,8542,DALf49Q7nGCtSxipmkha0WYpWi5x67si,SpATywNh6bZuzm8s1ceuBUnMUAeoAHHw,15,19,3,20,3,0,4,0,49,7.0,1,0.0,5,3,16,3,14,0,4,4,0,27,22,1
538,8554,R2LGboNcUADM1LGFGgPuEpT43AraZJb1,SpATywNh6bZuzm8s1ceuBUnMUAeoAHHw,2,0,0,0,0,0,2,0,2,0.2857142857142857,1,0.0,0,0,0,0,0,0,0,2,0,0,2,1
539,8562,2YohZ5UKGzy1qUgVAShosLdhgm3pfvsR,RXDvfPUBYFlVdlueBFbLW0mhhAyGEqpt,5,3,1,0,1,0,1,0,6,0.8571428571428571,1,0.0,0,1,0,1,3,0,0,1,0,2,4,1
540,8576,HHsJECDPslzJS0fyoCEbSGrnL1evzSJb,SpATywNh6bZuzm8s1ceuBUnMUAeoAHHw,3,2,0,0,0,0,1,0,3,0.42857142857142855,1,0.0,0,0,0,0,2,0,0,1,0,0,3,0
541,8578,ctoSfpAfvm3av2aqkT0D3Yq8icDxZKCx,SpATywNh6bZuzm8s1ceuBUnMUAeoAHHw,6,7,2,0,2,0,3,0,14,2.0,2,0.0,1,2,0,2,6,0,0,3,0,5,9,1
542,8579,5SaN6rc1Jws1AbkuHmPyLN82qDTc23Xp,SpATywNh6bZuzm8s1ceuBUnMUAeoAHHw,4,3,0,0,0,0,1,0,4,0.5714285714285714,1,0.0,0,0,0,0,3,0,0,1,0,0,4,1
543,8580,NbSKhx4CxJyTkjcYgC3wEU9PLylFddj5,SpATywNh6bZuzm8s1ceuBUnMUAeoAHHw,21,30,0,25,3,33,6,0,97,13.857142857142858,3,0.0,12,0,22,3,18,33,3,6,0,37,60,0
544,8589,QiGOPB8shOtQ5nbvOvvOxzT1SShMMuAf,SpATywNh6bZuzm8s1ceuBUnMUAeoAHHw,17,17,6,22,4,5,4,0,58,8.285714285714286,1,0.0,6,6,19,4,11,5,3,4,0,35,23,0
545,8590,tQHFI5lya7DKbCzO4oTkHd2600sh8kNe,G8EPVSXsOYB5YQWZGiz1aVq5Pgr2GrQu,20,20,7,38,5,0,3,0,73,10.428571428571429,2,0.0,9,7,30,5,11,0,8,3,0,51,22,1
546,8603,NDWoO09mCIeS4HdBeNYH7dNkyhIv3eXv,SpATywNh6bZuzm8s1ceuBUnMUAeoAHHw,23,28,1,23,0,14,6,2,74,10.571428571428571,1,0.0,8,1,21,0,20,14,2,6,2,30,44,1
547,8610,YPO9VbNOFh7KZMXyxOJMSk1iTNwVpJOe,SpATywNh6bZuzm8s1ceuBUnMUAeoAHHw,11,12,0,12,0,0,6,0,30,4.285714285714286,1,0.0,6,0,11,0,6,0,1,6,0,17,13,0
548,8617,ls4yyZ7MYyWiEmQ5nJV5QAmKdBgFaV8n,G8EPVSXsOYB5YQWZGiz1aVq5Pgr2GrQu,32,72,25,56,8,0,10,0,171,24.428571428571427,2,0.0,45,25,36,8,27,0,20,10,0,114,57,1
549,8626,yq8YyMugEpZrcWzhPtzidXoqQsPJ81ZJ,G8EPVSXsOYB5YQWZGiz1aVq5Pgr2GrQu,1,0,0,0,0,0,1,0,1,0.14285714285714285,1,0.0,0,0,0,0,0,0,0,1,0,0,1,1
550,8635,jH123vWnpYTVLfmuSyled9Oau0AYvcx6,G8EPVSXsOYB5YQWZGiz1aVq5Pgr2GrQu,6,3,1,0,1,0,2,0,7,1.0,1,0.0,0,1,0,1,3,0,0,2,0,2,5,1
551,8637,YeutUTPU1KeBL2Vd5ZhxL2fFNQ8D7NVG,SpATywNh6bZuzm8s1ceuBUnMUAeoAHHw,5,2,1,0,0,1,4,0,8,1.1428571428571428,1,0.0,0,1,0,0,2,1,0,4,0,1,7,1
552,8638,kXndrjnvT5RUWACXG428KqXdIpBxsEit,A3fsA9Zfv1X2fVEQhTw51lKENdNrEqT3,1,0,0,0,0,0,1,0,1,0.14285714285714285,1,0.0,0,0,0,0,0,0,0,1,0,0,1,1
553,8639,xqboiFlp42vyY93nDStsbVWBCL5sgIRH,SpATywNh6bZuzm8s1ceuBUnMUAeoAHHw,5,2,1,0,1,0,4,0,8,1.1428571428571428,1,0.0,0,1,0,1,2,0,0,4,0,2,6,1
554,8644,4PVAcJZJLiNhJa8rMcHaqBMuPaZIl5Nm,SpATywNh6bZuzm8s1ceuBUnMUAeoAHHw,16,10,6,13,5,0,2,0,36,5.142857142857143,1,0.0,2,6,12,5,8,0,1,2,0,25,11,1
555,8647,pZDK7WA5fQeGMPFsats2GLmFnZbZQ7ed,SpATywNh6bZuzm8s1ceuBUnMUAeoAHHw,11,26,12,4,3,0,5,0,50,7.142857142857143,3,0.0,5,12,4,3,21,0,0,5,0,24,26,1
556,8654,nquBmikiqPFYvs17N894M5iUc88scoVO,SpATywNh6bZuzm8s1ceuBUnMUAeoAHHw,12,21,1,18,0,13,4,0,57,8.142857142857142,1,0.0,2,1,15,0,19,13,3,4,0,18,39,0
557,8661,CxzZVyClE1BEgH3USSirqOtKD3HSH7vg,SpATywNh6bZuzm8s1ceuBUnMUAeoAHHw,13,13,7,12,3,0,2,0,37,5.285714285714286,1,0.0,2,7,11,3,11,0,1,2,0,23,14,1
558,8679,kyUPY0MEVeZNvkmrQxOn0CHNXLZiD03b,A3fsA9Zfv1X2fVEQhTw51lKENdNrEqT3,7,21,1,0,0,10,5,0,37,5.285714285714286,2,0.0,3,1,0,0,18,10,0,5,0,4,33,1
559,8691,ESjXyWS3x5wlkZHp5KISOO9gy5mDNyIG,SpATywNh6bZuzm8s1ceuBUnMUAeoAHHw,6,18,8,0,3,0,7,0,36,5.142857142857143,3,0.0,2,8,0,3,16,0,0,7,0,13,23,1
560,8700,je9A6l6tP7wnbFhNJD7vbbHTYhqshuqB,G8EPVSXsOYB5YQWZGiz1aVq5Pgr2GrQu,12,41,18,8,3,0,4,0,74,10.571428571428571,6,0.0,4,18,6,3,37,0,2,4,0,31,43,0
561,8701,kxC3AAELak9RRmJoG2dzH7rfP0Xyo0FH,SpATywNh6bZuzm8s1ceuBUnMUAeoAHHw,10,8,6,0,4,0,1,0,19,2.7142857142857144,1,0.0,0,6,0,4,8,0,0,1,0,10,9,1
562,8706,4G8PB07c1AYOLDoNxj95BoxFXM7YCCci,SpATywNh6bZuzm8s1ceuBUnMUAeoAHHw,3,2,0,0,0,0,1,0,3,0.42857142857142855,1,0.0,0,0,0,0,2,0,0,1,0,0,3,1
563,8708,nzGzo6fW6QPE9hjoabI90qrzv3llY1Fg,G8EPVSXsOYB5YQWZGiz1aVq5Pgr2GrQu,12,17,6,0,3,0,5,0,31,4.428571428571429,2,0.0,2,6,0,3,15,0,0,5,0,11,20,1
564,8711,MQxVHrLqN67CEKfOyyeFlttLUKuqvrcv,RXDvfPUBYFlVdlueBFbLW0mhhAyGEqpt,1,0,0,0,0,0,1,0,1,0.14285714285714285,1,0.0,0,0,0,0,0,0,0,1,0,0,1,0
565,8730,JoruyAOmEeM1qjcSEWRUjLvQUHpNPZGp,RXDvfPUBYFlVdlueBFbLW0mhhAyGEqpt,37,76,1,73,4,38,14,5,211,30.142857142857142,3,0.0,14,1,61,4,62,38,12,14,5,80,131,1
566,8735,WNT8mFhPmDPRuQT8JLsnindelSr1MnST,SpATywNh6bZuzm8s1ceuBUnMUAeoAHHw,17,13,8,21,4,11,3,0,60,8.571428571428571,1,0.0,4,8,17,4,9,11,4,3,0,33,27,1
567,8747,WuOqx5J7nUG7M0CzOeQJHpDiW7DgSS7B,SpATywNh6bZuzm8s1ceuBUnMUAeoAHHw,16,31,1,24,1,2,3,0,62,8.857142857142858,1,0.0,15,1,20,1,16,2,4,3,0,37,25,1
568,8758,NCbFqYNTEfc5vPQvAyBwDtnbS3ENYJY7,bWdj2GDclj5ofokWjzoa5jAwMkxCykd6,5,3,1,0,1,0,1,0,6,0.8571428571428571,1,0.0,0,1,0,1,3,0,0,1,0,2,4,1
569,8761,7ye3FQXc4XBmC7UwnNQWxsWGDnaNcvG6,SpATywNh6bZuzm8s1ceuBUnMUAeoAHHw,22,27,0,34,0,3,4,1,69,9.857142857142858,1,0.0,5,0,29,0,22,3,5,4,1,34,35,1
570,8791,E2VKNfvaS8HbcvRZooqcq8161JUOvad2,RXDvfPUBYFlVdlueBFbLW0mhhAyGEqpt,3,2,1,0,0,0,1,0,4,0.5714285714285714,1,0.0,0,1,0,0,2,0,0,1,0,1,3,1
571,8793,Ga4lr67F0RIjyUetWH1EgQ3xzSHDnViF,bWdj2GDclj5ofokWjzoa5jAwMkxCykd6,8,7,5,4,0,0,1,0,17,2.4285714285714284,1,0.0,0,5,4,0,7,0,0,1,0,9,8,0
572,8794,br8lmEhz6IHlXV0QfsU4Spi9BczfMT8x,SpATywNh6bZuzm8s1ceuBUnMUAeoAHHw,11,15,7,15,0,0,1,0,38,5.428571428571429,1,0.0,7,7,14,0,8,0,1,1,0,28,10,0
573,8803,RFvs5NuNtACNU2U9ElWUm5Jw7rHjvZwP,SpATywNh6bZuzm8s1ceuBUnMUAeoAHHw,6,5,4,0,2,0,1,0,12,1.7142857142857142,1,0.0,0,4,0,2,5,0,0,1,0,6,6,1
574,8809,ivdkzhYPhrTUKnU1xY68Yfp2rdDhgD3h,SpATywNh6bZuzm8s1ceuBUnMUAeoAHHw,4,3,2,0,0,0,1,0,6,0.8571428571428571,1,0.0,0,2,0,0,3,0,0,1,0,2,4,0
575,8814,8IuzZOXaXVUql9pLZtNuJIyLoDJ8ZL4V,SpATywNh6bZuzm8s1ceuBUnMUAeoAHHw,15,23,8,6,3,0,4,0,44,6.285714285714286,3,0.0,4,8,6,3,19,0,0,4,0,21,23,0
576,8852,1sf1a7OMEvwky5hvLFD12TaOsmoNw2Qb,SpATywNh6bZuzm8s1ceuBUnMUAeoAHHw,14,21,9,12,3,0,3,0,48,6.857142857142857,2,0.0,2,9,12,3,19,0,0,3,0,26,22,0
577,8860,IwB6SmnBZExRlnmOtkIDRkNteqe5iWyf,SpATywNh6bZuzm8s1ceuBUnMUAeoAHHw,1,0,0,0,0,0,1,0,1,0.14285714285714285,1,0.0,0,0,0,0,0,0,0,1,0,0,1,1
578,8865,Up0SfqXbbz6NGY2S4ku6GM2FOwYrzCdN,SpATywNh6bZuzm8s1ceuBUnMUAeoAHHw,1,0,0,0,0,0,1,0,1,0.14285714285714285,1,0.0,0,0,0,0,0,0,0,1,0,0,1,1
579,8870,ZNWyxGsQnaw3e5XPyIUr5rwKsBrD0VQe,G8EPVSXsOYB5YQWZGiz1aVq5Pgr2GrQu,8,21,1,0,2,0,4,0,28,4.0,1,0.0,8,1,0,2,13,0,0,4,0,11,17,0
580,8900,fY0uxi2rFKNgoTYTvIZdgXrk3XKUTjS3,SpATywNh6bZuzm8s1ceuBUnMUAeoAHHw,14,20,5,13,3,0,2,0,43,6.142857142857143,1,0.0,4,5,13,3,16,0,0,2,0,25,18,0
581,8904,0QFADiD6IvsCiGKcRzsLQbDvaZGh6BVG,SpATywNh6bZuzm8s1ceuBUnMUAeoAHHw,8,7,1,0,1,0,1,0,10,1.4285714285714286,1,0.0,0,1,0,1,7,0,0,1,0,2,8,0
582,8917,5vUuq5ZeDCNce4LmvH0naoUjpb3qbNOp,SpATywNh6bZuzm8s1ceuBUnMUAeoAHHw,3,2,1,0,0,0,1,0,4,0.5714285714285714,1,0.0,0,1,0,0,2,0,0,1,0,1,3,1
583,8925,PenDUeO0eoR8hyLVdfPN6H7q2FnTGMus,A3fsA9Zfv1X2fVEQhTw51lKENdNrEqT3,10,12,6,0,1,9,11,0,39,5.571428571428571,2,0.0,0,6,0,1,12,9,0,11,0,7,32,0
584,8929,1oBn81XXDSWJtnCZIRPmhZcBWe7qP0iB,RXDvfPUBYFlVdlueBFbLW0mhhAyGEqpt,23,25,20,16,8,0,6,0,75,10.714285714285714,3,0.0,2,20,15,8,23,0,1,6,0,45,30,1
585,8934,H3CmwGihecRb7lZltIA7orKjensSqIgF,RXDvfPUBYFlVdlueBFbLW0mhhAyGEqpt,3,1,1,0,1,0,0,0,3,0.42857142857142855,1,0.0,0,1,0,1,1,0,0,0,0,2,1,1
586,8935,pYasYOOyUapjKdoqnDhFpArs52eNDPLb,SpATywNh6bZuzm8s1ceuBUnMUAeoAHHw,13,8,5,16,3,0,2,0,34,4.857142857142857,2,0.0,2,5,14,3,6,0,2,2,0,24,10,0
587,8945,Iupcx1vHh7MTin0aJweHjQkwiErp9HHL,SpATywNh6bZuzm8s1ceuBUnMUAeoAHHw,5,2,1,0,1,0,2,0,6,0.8571428571428571,1,0.0,0,1,0,1,2,0,0,2,0,2,4,1
588,8956,JtMmp5BCDQnYE7CMI3NvnX4aRCZsQW9K,bWdj2GDclj5ofokWjzoa5jAwMkxCykd6,11,13,7,0,5,0,11,0,36,5.142857142857143,5,0.0,4,7,0,5,9,0,0,11,0,16,20,0
589,8966,qFpdcx3mtZSSE0KVCMsIlMdOIeoOzyoo,SpATywNh6bZuzm8s1ceuBUnMUAeoAHHw,11,14,5,0,1,0,6,0,26,3.7142857142857144,4,0.0,0,5,0,1,14,0,0,6,0,6,20,0
590,8971,p04QzukP32kpPk8EGoBhDUGJJQqJUoNz,SpATywNh6bZuzm8s1ceuBUnMUAeoAHHw,22,44,4,16,2,24,18,5,113,16.142857142857142,3,0.0,12,4,16,2,32,24,0,18,5,34,79,0
591,8990,d50bzrDUj3g2Xiqt1t5CNiAegqkJwLeY,SpATywNh6bZuzm8s1ceuBUnMUAeoAHHw,15,19,2,0,2,1,7,1,32,4.571428571428571,1,0.0,5,2,0,2,14,1,0,7,1,9,23,1
592,8991,N16QHS59cTDWe3hpSKjuHvn5eRO4wcEE,SpATywNh6bZuzm8s1ceuBUnMUAeoAHHw,7,6,3,0,2,0,3,0,14,2.0,1,0.0,0,3,0,2,6,0,0,3,0,5,9,1
593,9002,L534Da3JB50xKXQoTXrCa1H5GVkKxZyU,SpATywNh6bZuzm8s1ceuBUnMUAeoAHHw,8,5,2,0,2,0,4,0,13,1.8571428571428572,1,0.0,0,2,0,2,5,0,0,4,0,4,9,1
594,9011,sNZ43ghPU2QwNk3cu7wYztVZWvmkGmKL,SpATywNh6bZuzm8s1ceuBUnMUAeoAHHw,18,18,11,25,1,3,3,0,61,8.714285714285714,2,0.0,5,11,24,1,13,3,1,3,0,41,20,0
595,9017,a5tgLYkHndhh8Yb10TacQs9Vi34mi45u,RXDvfPUBYFlVdlueBFbLW0mhhAyGEqpt,14,10,6,1,3,1,8,1,30,4.285714285714286,1,0.0,3,6,1,3,7,1,0,8,1,13,17,0
596,9018,pVooF8yxRpciMTpPCaLN6jM2lWrWpauA,SpATywNh6bZuzm8s1ceuBUnMUAeoAHHw,7,4,2,0,0,2,7,1,16,2.2857142857142856,1,0.0,1,2,0,0,3,2,0,7,1,3,13,1
597,9023,K7xeVolEtXE0AogXgMn5GEzQ96UioEwW,SpATywNh6bZuzm8s1ceuBUnMUAeoAHHw,16,16,8,0,8,0,1,0,33,4.714285714285714,1,0.0,4,8,0,8,12,0,0,1,0,20,13,1
598,9031,L534Da3JB50xKXQoTXrCa1H5GVkKxZyU,bWdj2GDclj5ofokWjzoa5jAwMkxCykd6,5,2,1,0,1,0,2,0,6,0.8571428571428571,1,0.0,0,1,0,1,2,0,0,2,0,2,4,1
599,9040,AoGNGJBevj5UJJAo0rhBglhkcP4W6WBy,bWdj2GDclj5ofokWjzoa5jAwMkxCykd6,1,0,0,0,0,0,1,0,1,0.14285714285714285,1,0.0,0,0,0,0,0,0,0,1,0,0,1,1
600,9041,L534Da3JB50xKXQoTXrCa1H5GVkKxZyU,RXDvfPUBYFlVdlueBFbLW0mhhAyGEqpt,5,2,1,0,1,0,2,0,6,0.8571428571428571,1,0.0,0,1,0,1,2,0,0,2,0,2,4,1
601,9048,8IYoAw78mc8ysNlcBgXt630ETnnEuaUM,SpATywNh6bZuzm8s1ceuBUnMUAeoAHHw,8,13,0,18,0,0,6,0,37,5.285714285714286,1,0.0,8,0,17,0,5,0,1,6,0,25,12,0
602,9056,WJoD89Bo9NFFK86vx66y3rksOk6ixc2b,SpATywNh6bZuzm8s1ceuBUnMUAeoAHHw,21,30,19,0,11,0,9,0,69,9.857142857142858,2,0.0,2,19,0,11,28,0,0,9,0,32,37,1
603,9064,J782awhmjhWAohIOvWifbZTNvhSxGcmf,RXDvfPUBYFlVdlueBFbLW0mhhAyGEqpt,12,23,18,0,11,0,3,0,55,7.857142857142857,2,0.0,2,18,0,11,21,0,0,3,0,31,24,1
604,9065,6Dq4LTGgUzJAJPwYkedRMadSEQwnkyG3,SpATywNh6bZuzm8s1ceuBUnMUAeoAHHw,6,10,5,0,0,0,3,0,18,2.5714285714285716,1,0.0,0,5,0,0,10,0,0,3,0,5,13,1
605,9072,xBNDEDD7fMER9fNR4W15k6QiKRrdBf4x,G8EPVSXsOYB5YQWZGiz1aVq5Pgr2GrQu,51,64,2,116,3,1,10,1,197,28.142857142857142,2,0.0,37,2,81,3,27,1,35,10,1,123,74,1
606,9079,Cb1aR5BeXGrDewkPGGzseNCh6yBNhS9Z,G8EPVSXsOYB5YQWZGiz1aVq5Pgr2GrQu,1,0,0,0,0,0,1,0,1,0.14285714285714285,1,0.0,0,0,0,0,0,0,0,1,0,0,1,1
607,9085,q78BjeBORwDIcVH7lRGRd3WfImLmduN4,G8EPVSXsOYB5YQWZGiz1aVq5Pgr2GrQu,18,9,8,0,8,0,3,0,28,4.0,1,0.0,0,8,0,8,9,0,0,3,0,16,12,1
608,9100,0K6JPqiivQzicxY4EV4nqMLCL3a08A97,bWdj2GDclj5ofokWjzoa5jAwMkxCykd6,7,2,1,0,1,0,7,0,11,1.5714285714285714,1,0.0,0,1,0,1,2,0,0,7,0,2,9,0
609,9112,XDPvGyFLLEYwbNEQik2MM4yiADs5rrYJ,bWdj2GDclj5ofokWjzoa5jAwMkxCykd6,9,7,4,0,3,0,2,0,16,2.2857142857142856,1,0.0,1,4,0,3,6,0,0,2,0,8,8,0
610,9124,0mJoMFAp6vm88Kg6ltLw74tsdf8pNH48,SpATywNh6bZuzm8s1ceuBUnMUAeoAHHw,8,6,2,0,2,0,2,0,12,1.7142857142857142,1,0.0,0,2,0,2,6,0,0,2,0,4,8,0
611,9125,8NRsKZ3hMeinWXhN3qtntd7OTP25jyWY,bWdj2GDclj5ofokWjzoa5jAwMkxCykd6,13,13,6,14,5,0,2,0,40,5.714285714285714,1,0.0,3,6,14,5,10,0,0,2,0,28,12,1
612,9128,bZSiNUbAIuydDBd77IMAJ15Hy6k2A1kT,bWdj2GDclj5ofokWjzoa5jAwMkxCykd6,11,17,10,30,3,6,7,1,74,10.571428571428571,2,0.0,1,10,28,3,16,6,2,7,1,42,32,1
613,9129,x8EozFE9amTkjsgRipu221C7Pejcw9dl,RXDvfPUBYFlVdlueBFbLW0mhhAyGEqpt,18,25,0,0,0,3,15,1,44,6.285714285714286,3,0.0,0,0,0,0,25,3,0,15,1,0,44,1
614,9132,AkJ8njZZaMlqYX3miC2oUBlMGg9ZSm2E,SpATywNh6bZuzm8s1ceuBUnMUAeoAHHw,14,13,0,16,0,0,3,0,32,4.571428571428571,1,0.0,5,0,15,0,8,0,1,3,0,20,12,1
615,9145,RFW46IpEEo40HQZmVwQOMd3VcTSwzvKz,SpATywNh6bZuzm8s1ceuBUnMUAeoAHHw,14,23,13,8,3,0,6,0,53,7.571428571428571,2,0.0,6,13,8,3,17,0,0,6,0,30,23,0
616,9147,FTc6jHk7ojdVaEQtsGdTEiSOrQxUe2mX,SpATywNh6bZuzm8s1ceuBUnMUAeoAHHw,7,6,1,0,1,0,1,0,9,1.2857142857142858,1,0.0,0,1,0,1,6,0,0,1,0,2,7,0
617,9148,9DysAmMC3i4TW1eruWnww7wyDSDGRjXp,bWdj2GDclj5ofokWjzoa5jAwMkxCykd6,9,17,11,0,6,0,7,0,41,5.857142857142857,2,0.0,0,11,0,6,17,0,0,7,0,17,24,1
618,9158,DbhhTMdVqWIBI3VwdAesh5LxfMFeyK5c,SpATywNh6bZuzm8s1ceuBUnMUAeoAHHw,7,3,2,0,2,0,2,0,9,1.2857142857142858,1,0.0,0,2,0,2,3,0,0,2,0,4,5,1
619,9163,Hv1gke8Z6oPKIjxv7227ovS4ZRFTrLpp,bWdj2GDclj5ofokWjzoa5jAwMkxCykd6,4,2,1,0,1,0,1,0,5,0.7142857142857143,1,0.0,0,1,0,1,2,0,0,1,0,2,3,1
620,9165,fnvAURpBgndjkYxbDVVMCKsNQuRUMiGS,SpATywNh6bZuzm8s1ceuBUnMUAeoAHHw,10,22,11,0,5,0,5,0,43,6.142857142857143,2,0.0,0,11,0,5,22,0,0,5,0,16,27,0
621,9171,9cDsgjqaFerwqRiPgBxIO3HH5FKzzgdj,RXDvfPUBYFlVdlueBFbLW0mhhAyGEqpt,28,22,19,0,16,2,2,0,61,8.714285714285714,1,0.0,2,19,0,16,20,2,0,2,0,37,24,1
622,9202,TnBvipzpsoJKVSP9HO76PUA5bg5zcHA5,SpATywNh6bZuzm8s1ceuBUnMUAeoAHHw,1,0,0,0,0,0,1,0,1,0.14285714285714285,1,0.0,0,0,0,0,0,0,0,1,0,0,1,1
623,9214,cw1zp7V2E9LtJgGgHmRoYt6oelCovAzM,bWdj2GDclj5ofokWjzoa5jAwMkxCykd6,6,3,2,0,1,0,3,0,9,1.2857142857142858,1,0.0,0,2,0,1,3,0,0,3,0,3,6,1
624,9217,ZWsQt8qxIk0ozpqBcSOvnGxYevyvwXWW,SpATywNh6bZuzm8s1ceuBUnMUAeoAHHw,4,4,0,0,0,0,1,0,5,0.7142857142857143,1,0.0,0,0,0,0,4,0,0,1,0,0,5,1
625,9218,llxTRiluZGftr8xJaXSwJljp3xP1zOiw,SpATywNh6bZuzm8s1ceuBUnMUAeoAHHw,6,3,2,0,2,0,1,0,8,1.1428571428571428,1,0.0,0,2,0,2,3,0,0,1,0,4,4,1
626,9223,DHqQemLc6gAFLZmIcghnnHYSJ9DiwwJJ,G8EPVSXsOYB5YQWZGiz1aVq5Pgr2GrQu,4,2,0,0,0,0,2,0,4,0.5714285714285714,1,0.0,0,0,0,0,2,0,0,2,0,0,4,1
627,9225,bBiJ7ASlGThY8sK9BrJtoHZicOYFZngs,SpATywNh6bZuzm8s1ceuBUnMUAeoAHHw,5,4,0,0,0,0,1,0,5,0.7142857142857143,1,0.0,0,0,0,0,4,0,0,1,0,0,5,1
628,9249,0px3bu53b0JtWfgR2HZboUVCWvKPFWbh,SpATywNh6bZuzm8s1ceuBUnMUAeoAHHw,16,32,0,27,0,2,9,1,71,10.142857142857142,4,0.0,16,0,21,0,16,2,6,9,1,37,34,1
629,9252,9YWFnwknNOzyIUIKR7l51R7vKAyWFRtw,SpATywNh6bZuzm8s1ceuBUnMUAeoAHHw,11,9,6,0,6,1,2,0,24,3.4285714285714284,1,0.0,1,6,0,6,8,1,0,2,0,13,11,1
630,9256,tfcOvcMIVTpughZ66Us0P1WhX9cxijTo,SpATywNh6bZuzm8s1ceuBUnMUAeoAHHw,19,16,11,6,6,2,9,0,50,7.142857142857143,3,0.0,2,11,6,6,14,2,0,9,0,25,25,1
631,9261,QC8X6HHWWr8l8BhOv6dcxn8F38OGn4O4,bWdj2GDclj5ofokWjzoa5jAwMkxCykd6,3,4,2,0,0,0,3,0,9,1.2857142857142858,1,0.0,0,2,0,0,4,0,0,3,0,2,7,1
632,9263,cgHFcM0rIMOzMpGf6lXZssDwXCb8l7YM,SpATywNh6bZuzm8s1ceuBUnMUAeoAHHw,18,14,10,6,6,170,15,3,224,32.0,4,0.0,0,10,5,6,14,170,1,15,3,21,203,0
633,9266,9Gijx5H37DPofktlpBMoMZTbguUDFGMv,SpATywNh6bZuzm8s1ceuBUnMUAeoAHHw,17,19,11,6,4,2,5,0,47,6.714285714285714,3,0.0,4,11,6,4,15,2,0,5,0,25,22,0
634,9280,S33pdehUgQXmm7BALY2AI5GkXomITIjp,SpATywNh6bZuzm8s1ceuBUnMUAeoAHHw,10,10,6,0,2,5,13,8,44,6.285714285714286,1,0.0,0,6,0,2,10,5,0,13,8,8,36,1
635,9284,nmePotX0raTb5EFn0d2G6sYKXgcl2u96,SpATywNh6bZuzm8s1ceuBUnMUAeoAHHw,17,10,7,10,4,5,3,0,39,5.571428571428571,1,0.0,2,7,9,4,8,5,1,3,0,22,17,1
636,9300,V2BC6P9m08ZwtWifNk1sABHW864l2OQe,SpATywNh6bZuzm8s1ceuBUnMUAeoAHHw,7,4,3,0,2,0,1,0,10,1.4285714285714286,1,0.0,0,3,0,2,4,0,0,1,0,5,5,0
637,9319,7KQcIrOp3KoypOTvziMED7rHtDH1CXtE,bWdj2GDclj5ofokWjzoa5jAwMkxCykd6,11,17,1,34,3,0,1,0,56,8.0,1,0.0,9,1,29,3,8,0,5,1,0,42,14,1
638,9326,cw1zp7V2E9LtJgGgHmRoYt6oelCovAzM,A3fsA9Zfv1X2fVEQhTw51lKENdNrEqT3,1,0,0,0,0,0,2,0,2,0.2857142857142857,2,0.0,0,0,0,0,0,0,0,2,0,0,2,0
639,9331,U5AVDljh153RMBqEeJz3uJoBcMeMiYU5,RXDvfPUBYFlVdlueBFbLW0mhhAyGEqpt,3,2,1,0,1,0,0,0,4,0.5714285714285714,2,0.0,0,1,0,1,2,0,0,0,0,2,2,0
640,9337,6W9L2N1NV5yWuM4zWKiNN7jncCdBZXs0,SpATywNh6bZuzm8s1ceuBUnMUAeoAHHw,7,9,1,0,1,0,2,0,13,1.8571428571428572,1,0.0,0,1,0,1,9,0,0,2,0,2,11,1
641,9348,yh14zaFitCUTgvBPqRXiaZ6cUijtktL4,SpATywNh6bZuzm8s1ceuBUnMUAeoAHHw,10,8,4,0,4,0,3,0,19,2.7142857142857144,2,0.0,0,4,0,4,8,0,0,3,0,8,11,1
642,9359,aR6DmUHNNFHdBeCRliKxXxLUoIhOd6AH,SpATywNh6bZuzm8s1ceuBUnMUAeoAHHw,22,32,11,8,4,6,9,0,70,10.0,5,0.0,2,11,7,4,30,6,1,9,0,24,46,1
643,9361,8Eqf4bSicFmRziRU1kFgF89C5yGB8WDX,A3fsA9Zfv1X2fVEQhTw51lKENdNrEqT3,3,4,1,0,0,0,3,0,8,1.1428571428571428,2,0.0,0,1,0,0,4,0,0,3,0,1,7,0
644,9368,gGSMkNgPdXpBQgdZzyjzifomyCxFSNyt,RXDvfPUBYFlVdlueBFbLW0mhhAyGEqpt,45,71,29,89,17,1,6,0,213,30.428571428571427,2,0.0,11,29,80,17,60,1,9,6,0,137,76,1
645,9373,y94TMklf7UHNxvOoBChAR2OERrGRdiJq,G8EPVSXsOYB5YQWZGiz1aVq5Pgr2GrQu,21,20,6,18,4,0,8,0,56,8.0,2,0.0,9,6,12,4,11,0,6,8,0,31,25,0
646,9385,8fvsCrC8dcOje6DxrGntnTxmufYXJCrq,RXDvfPUBYFlVdlueBFbLW0mhhAyGEqpt,6,4,3,0,1,0,4,0,12,1.7142857142857142,2,0.0,0,3,0,1,4,0,0,4,0,4,8,1
647,9388,67TNJl3Pfj4UvDY0EpzZyKupN8wfhq1l,SpATywNh6bZuzm8s1ceuBUnMUAeoAHHw,4,2,1,0,0,0,2,0,5,0.7142857142857143,1,0.0,0,1,0,0,2,0,0,2,0,1,4,1
648,9407,iY3PnTi5AY3h01aMZ0ccsJOuRXfKtImU,SpATywNh6bZuzm8s1ceuBUnMUAeoAHHw,30,57,25,24,10,4,8,0,128,18.285714285714285,3,0.0,22,25,24,10,35,4,0,8,0,81,47,0
649,9412,ZoicU1K1NYxoyDJQjMEMlarFqaZkNBQL,SpATywNh6bZuzm8s1ceuBUnMUAeoAHHw,9,9,1,0,1,0,2,0,13,1.8571428571428572,1,0.0,0,1,0,1,9,0,0,2,0,2,11,0
650,9413,7LCuPqBIUzStV6rbjpGGsRhhNGaAe94J,G8EPVSXsOYB5YQWZGiz1aVq5Pgr2GrQu,5,2,1,0,1,0,2,0,6,0.8571428571428571,1,0.0,0,1,0,1,2,0,0,2,0,2,4,1
651,9421,mVo6pZlclrtmbfR2GbQ4wq8gZuK7O36S,SpATywNh6bZuzm8s1ceuBUnMUAeoAHHw,20,30,19,12,9,2,2,0,74,10.571428571428571,3,0.0,7,19,9,9,23,2,3,2,0,44,30,0
652,9443,mt466qDcj0vZCLdMYFtb42Vnaf84dHao,SpATywNh6bZuzm8s1ceuBUnMUAeoAHHw,18,34,20,12,7,0,14,0,87,12.428571428571429,5,0.0,7,20,9,7,27,0,3,14,0,43,44,1
653,9451,3tkFTpynSNaQLF6kINch4bQXEK1IrheG,SpATywNh6bZuzm8s1ceuBUnMUAeoAHHw,7,6,4,0,1,0,2,0,13,1.8571428571428572,2,0.0,0,4,0,1,6,0,0,2,0,5,8,0
654,9461,L22HEShRU3FqNfdzTYdzEWxS4vfndGJu,SpATywNh6bZuzm8s1ceuBUnMUAeoAHHw,13,16,0,14,0,9,9,1,49,7.0,3,0.0,7,0,13,0,9,9,1,9,1,20,29,0
655,9496,lzjn3SIRVbYq5ZVBPCRXRd4xV1z1jylE,SpATywNh6bZuzm8s1ceuBUnMUAeoAHHw,17,22,8,28,5,8,5,0,76,10.857142857142858,3,0.0,9,8,23,5,13,8,5,5,0,45,31,0
656,9498,tNcQJSYfIwP0RRLCMvpsyr5j06z8N8iO,G8EPVSXsOYB5YQWZGiz1aVq5Pgr2GrQu,3,2,1,0,0,0,1,0,4,0.5714285714285714,1,0.0,0,1,0,0,2,0,0,1,0,1,3,0
657,9513,onGGlsMh4Ah4OxYC5tqGXHHp3fKlLcL2,RXDvfPUBYFlVdlueBFbLW0mhhAyGEqpt,17,11,8,0,7,0,1,0,27,3.857142857142857,1,0.0,0,8,0,7,11,0,0,1,0,15,12,1
658,9515,FK87Mh9LEgwj1VU4pstPcNLLVrRCTWuM,SpATywNh6bZuzm8s1ceuBUnMUAeoAHHw,20,37,26,15,10,14,8,2,112,16.0,2,0.0,5,26,15,10,32,14,0,8,2,56,56,0
659,9524,qLAmicSwiz2res8NbViiztvss1lFMGpj,SpATywNh6bZuzm8s1ceuBUnMUAeoAHHw,4,4,1,0,0,0,1,0,6,0.8571428571428571,1,0.0,0,1,0,0,4,0,0,1,0,1,5,1
660,9527,zdZzILDgH724BR2ZZqHskjwJPcqfxq36,SpATywNh6bZuzm8s1ceuBUnMUAeoAHHw,1,0,0,0,0,0,1,0,1,0.14285714285714285,1,0.0,0,0,0,0,0,0,0,1,0,0,1,1
661,9531,KwyWbYzWCyNQryHYqWYU5PuARebCENlh,SpATywNh6bZuzm8s1ceuBUnMUAeoAHHw,12,12,7,0,5,0,3,0,27,3.857142857142857,2,0.0,2,7,0,5,10,0,0,3,0,14,13,0
662,9554,qLhvnFj4NLk8zjpoDXsgy2yaKup2la0b,SpATywNh6bZuzm8s1ceuBUnMUAeoAHHw,8,9,3,0,2,0,1,0,15,2.142857142857143,1,0.0,0,3,0,2,9,0,0,1,0,5,10,1
663,9561,CS0wlcwiXBGjNBCCxbQaVvPkChe2nnOH,SpATywNh6bZuzm8s1ceuBUnMUAeoAHHw,4,2,1,0,1,0,1,0,5,0.7142857142857143,1,0.0,0,1,0,1,2,0,0,1,0,2,3,1
664,9562,ELMHLkq0bytqwO03zO0z2h1fRq8v5uwM,RXDvfPUBYFlVdlueBFbLW0mhhAyGEqpt,6,7,0,0,0,0,2,0,9,1.2857142857142858,1,0.0,0,0,0,0,7,0,0,2,0,0,9,0
665,9570,kRNs7iQ9Dcre5KLj8rtojE3fVWuqCtop,SpATywNh6bZuzm8s1ceuBUnMUAeoAHHw,24,31,3,26,0,2,14,2,78,11.142857142857142,2,0.0,11,3,25,0,20,2,1,14,2,39,39,0
666,9576,8L1ZpuGtJGJkgFF34DS0HYPQNaVRqmzv,G8EPVSXsOYB5YQWZGiz1aVq5Pgr2GrQu,7,1,1,0,1,1,5,1,10,1.4285714285714286,1,0.0,0,1,0,1,1,1,0,5,1,2,8,1
667,9583,InTDVHpDSVoZu5vOSvueBLdJOgZb9Qu8,bWdj2GDclj5ofokWjzoa5jAwMkxCykd6,10,8,4,12,3,0,4,0,31,4.428571428571429,1,0.0,2,4,10,3,6,0,2,4,0,19,12,0
668,9596,8fvsCrC8dcOje6DxrGntnTxmufYXJCrq,G8EPVSXsOYB5YQWZGiz1aVq5Pgr2GrQu,2,0,0,0,0,0,3,0,3,0.42857142857142855,2,0.0,0,0,0,0,0,0,0,3,0,0,3,1
669,9597,op6fYsDSJ7UTrHBvFtSBIo32ykj3vZlc,SpATywNh6bZuzm8s1ceuBUnMUAeoAHHw,13,21,7,10,2,0,13,0,53,7.571428571428571,4,0.0,2,7,9,2,19,0,1,13,0,20,33,0
670,9602,op6fYsDSJ7UTrHBvFtSBIo32ykj3vZlc,bWdj2GDclj5ofokWjzoa5jAwMkxCykd6,4,2,1,0,0,0,4,0,7,1.0,2,0.0,1,1,0,0,1,0,0,4,0,2,5,1
671,9626,foCA7ZrrJkil1q7yKxvukoHCZEz5fz8N,bWdj2GDclj5ofokWjzoa5jAwMkxCykd6,9,15,0,18,1,0,5,0,39,5.571428571428571,2,0.0,6,0,17,1,9,0,1,5,0,24,15,0
672,9629,RMdVVE71rvbt2Qm5k09H4IClAre95rfd,SpATywNh6bZuzm8s1ceuBUnMUAeoAHHw,7,2,1,0,1,1,5,1,11,1.5714285714285714,1,0.0,0,1,0,1,2,1,0,5,1,2,9,1
673,9631,ZkR2H9b56Jhek553JSEuRtj1fnuwaa03,SpATywNh6bZuzm8s1ceuBUnMUAeoAHHw,1,0,0,0,0,0,1,0,1,0.14285714285714285,1,0.0,0,0,0,0,0,0,0,1,0,0,1,1
674,9646,op6fYsDSJ7UTrHBvFtSBIo32ykj3vZlc,G8EPVSXsOYB5YQWZGiz1aVq5Pgr2GrQu,1,0,0,0,0,0,1,0,1,0.14285714285714285,1,0.0,0,0,0,0,0,0,0,1,0,0,1,1
675,9647,bPCZpicN2hhnN8uELNOuVf328EONwoA2,SpATywNh6bZuzm8s1ceuBUnMUAeoAHHw,14,43,15,4,3,1,9,1,76,10.857142857142858,3,0.0,23,15,4,3,20,1,0,9,1,45,31,1
676,9649,EH4LxHwYpFQLq5kesgWPY21JUpYpymba,SpATywNh6bZuzm8s1ceuBUnMUAeoAHHw,1,0,0,0,0,0,1,0,1,0.14285714285714285,1,0.0,0,0,0,0,0,0,0,1,0,0,1,1
677,9662,tRu7kc3B7i0xOP4FswhcDsdZx5KznD0T,SpATywNh6bZuzm8s1ceuBUnMUAeoAHHw,6,8,1,0,1,0,1,0,11,1.5714285714285714,1,0.0,0,1,0,1,8,0,0,1,0,2,9,0
678,9673,Bi4hHmeTLwTbUCScu9tC6ZZN7frLUhVP,bWdj2GDclj5ofokWjzoa5jAwMkxCykd6,24,21,12,56,5,0,7,0,101,14.428571428571429,1,0.0,4,12,53,5,17,0,3,7,0,74,27,0
679,9684,LdhLlSD36AR268yKf0v6JE8vG5XYPHSF,RXDvfPUBYFlVdlueBFbLW0mhhAyGEqpt,29,47,26,51,14,2,8,2,150,21.428571428571427,2,0.0,14,26,47,14,33,2,4,8,2,101,49,0
680,9707,5GS5OD1cmKWecEPymf3UVauvWYXb9WHE,SpATywNh6bZuzm8s1ceuBUnMUAeoAHHw,3,2,1,0,0,0,2,0,5,0.7142857142857143,1,0.0,0,1,0,0,2,0,0,2,0,1,4,0
681,9713,KFNYz6Dhe7c7sjFmDdHR2V6Cj3vv7anD,SpATywNh6bZuzm8s1ceuBUnMUAeoAHHw,27,20,10,28,5,0,14,1,78,11.142857142857142,2,0.0,8,10,24,5,12,0,4,14,1,47,31,1
682,9719,STRzNG5Wp366HphlQVfWFRMC5QrerXCb,SpATywNh6bZuzm8s1ceuBUnMUAeoAHHw,23,51,16,10,11,0,3,0,91,13.0,2,0.0,2,16,10,11,49,0,0,3,0,39,52,0
683,9735,gL9bGH4cIhlV7ZeZxNKPKl7YRjV9LvBk,bWdj2GDclj5ofokWjzoa5jAwMkxCykd6,7,5,2,94,1,0,3,0,105,15.0,1,0.0,1,2,92,1,4,0,2,3,0,96,9,1
684,9745,ITkxDxE80MnM3R1P6Tny4qeXU1QIqBHa,bWdj2GDclj5ofokWjzoa5jAwMkxCykd6,9,9,7,0,1,9,2,0,28,4.0,1,0.0,0,7,0,1,9,9,0,2,0,8,20,1
685,9754,UhHoLs8knx0jlEPi8SMFvlBmI0lPgR6y,SpATywNh6bZuzm8s1ceuBUnMUAeoAHHw,10,9,1,0,1,0,4,0,15,2.142857142857143,3,0.0,0,1,0,1,9,0,0,4,0,2,13,1
686,9770,Z719Tc3zuVfTrBRe6VKkZp0coC11gNCc,SpATywNh6bZuzm8s1ceuBUnMUAeoAHHw,3,2,1,0,1,0,0,0,4,0.5714285714285714,2,0.0,0,1,0,1,2,0,0,0,0,2,2,1
687,9785,gm1mCfFqKN0eTkg2YXDowzQf6xnuANVZ,SpATywNh6bZuzm8s1ceuBUnMUAeoAHHw,9,13,0,12,0,0,3,0,28,4.0,1,0.0,8,0,12,0,5,0,0,3,0,20,8,1
688,9786,LcO86mxxL8cZOPJBDybTSOoI4LZ5qE2M,SpATywNh6bZuzm8s1ceuBUnMUAeoAHHw,12,17,13,0,9,0,2,0,41,5.857142857142857,2,0.0,0,13,0,9,17,0,0,2,0,22,19,0
689,9787,EYniy2nQGNpFME0mRi8PdZNA2QjnXIxY,RXDvfPUBYFlVdlueBFbLW0mhhAyGEqpt,25,32,0,29,3,5,1,0,70,10.0,1,0.0,12,0,29,3,20,5,0,1,0,44,26,0
690,9792,M7EQ6UxOsXQjbu4WIJCWam7cgbYToC2D,bWdj2GDclj5ofokWjzoa5jAwMkxCykd6,1,0,0,0,0,0,1,0,1,0.14285714285714285,1,0.0,0,0,0,0,0,0,0,1,0,0,1,1
691,9799,oIeIfwhQt9r1G6uZ62W7p7DLvDQ1KzcN,SpATywNh6bZuzm8s1ceuBUnMUAeoAHHw,4,0,0,0,0,0,4,1,5,0.7142857142857143,1,0.0,0,0,0,0,0,0,0,4,1,0,5,0
692,9806,q0a8XSQyj8ok2HbWv28MubA9x20SFg4i,SpATywNh6bZuzm8s1ceuBUnMUAeoAHHw,20,24,4,12,5,0,19,0,64,9.142857142857142,4,0.0,2,4,10,5,22,0,2,19,0,21,43,0
693,9820,aHRdc7lsBBp8F9aMkgntONfsLpIf0i6y,SpATywNh6bZuzm8s1ceuBUnMUAeoAHHw,28,33,16,37,8,0,9,0,103,14.714285714285714,3,0.0,12,16,35,8,21,0,2,9,0,71,32,0
694,9833,31jhVyZsYwM3i4SgxR1MFYrhxZjgzlJ8,SpATywNh6bZuzm8s1ceuBUnMUAeoAHHw,16,18,11,18,6,0,2,0,55,7.857142857142857,2,0.0,5,11,15,6,13,0,3,2,0,37,18,0
695,9834,SVcpJb6gXZcQDuOEWDQYFqv2P86R1Xaj,A3fsA9Zfv1X2fVEQhTw51lKENdNrEqT3,14,6,5,0,3,4,7,1,26,3.7142857142857144,1,0.0,0,5,0,3,6,4,0,7,1,8,18,1
696,9835,a9OOTcAZgZGDa68djsRaJXsHoRuNVOvz,SpATywNh6bZuzm8s1ceuBUnMUAeoAHHw,16,22,15,16,7,39,6,0,105,15.0,4,0.0,6,15,13,7,16,39,3,6,0,41,64,1
697,9836,nknXXbQsC6Q6nMDyRKc0MDJZg6KtAXBE,SpATywNh6bZuzm8s1ceuBUnMUAeoAHHw,19,32,17,8,5,0,3,0,65,9.285714285714286,2,0.0,10,17,8,5,22,0,0,3,0,40,25,0
698,9842,MVF65xcT9c1o85EvDPizEzpYwxjeii1v,SpATywNh6bZuzm8s1ceuBUnMUAeoAHHw,15,26,4,16,0,0,6,0,52,7.428571428571429,3,0.0,3,4,14,0,23,0,2,6,0,21,31,1
699,9857,qDhyxHmDfIFLWQlPUBxWy3YNuv335dWU,SpATywNh6bZuzm8s1ceuBUnMUAeoAHHw,3,2,1,0,0,0,1,0,4,0.5714285714285714,1,0.0,0,1,0,0,2,0,0,1,0,1,3,0
700,9866,0KmXUOal7sGDR9cJbaeaj8aaBpdVW5sk,bWdj2GDclj5ofokWjzoa5jAwMkxCykd6,3,2,0,0,0,0,1,0,3,0.42857142857142855,1,0.0,0,0,0,0,2,0,0,1,0,0,3,1
701,9867,Cv6IwnmHzYzI7Znom4eT6Rs7brgvVn5U,SpATywNh6bZuzm8s1ceuBUnMUAeoAHHw,4,4,1,0,0,0,1,0,6,0.8571428571428571,1,0.0,0,1,0,0,4,0,0,1,0,1,5,1
702,9874,mZIaM3Lmux7GERtSm258BKPOSUYFlwyy,SpATywNh6bZuzm8s1ceuBUnMUAeoAHHw,16,21,9,14,4,0,4,0,52,7.428571428571429,3,0.0,4,9,13,4,17,0,1,4,0,30,22,0
703,9878,iw5QtMAk2wyMi9Kh4hTv1WAFOj2rnxVj,SpATywNh6bZuzm8s1ceuBUnMUAeoAHHw,2,1,1,0,0,0,0,0,2,0.2857142857142857,1,0.0,0,1,0,0,1,0,0,0,0,1,1,0
704,9894,MarhO8rhsTXcbFpvat4mcEiSQvbAftxM,SpATywNh6bZuzm8s1ceuBUnMUAeoAHHw,2,0,0,0,0,0,2,0,2,0.2857142857142857,2,0.0,0,0,0,0,0,0,0,2,0,0,2,1
705,9896,47Lhswr4ZfAxhCMxQ5kAgIIaZKdQ7ZYE,SpATywNh6bZuzm8s1ceuBUnMUAeoAHHw,10,13,3,14,0,5,2,0,37,5.285714285714286,1,0.0,5,3,11,0,8,5,3,2,0,19,18,0
706,9903,wHRp5VFhSRE1ez0DDg63jhbDbNE6ujgu,bWdj2GDclj5ofokWjzoa5jAwMkxCykd6,1,0,0,0,0,0,1,0,1,0.14285714285714285,1,0.0,0,0,0,0,0,0,0,1,0,0,1,1
707,9910,FUkw8gvbqykqbH4tdSuG6VwP03f4pQvB,SpATywNh6bZuzm8s1ceuBUnMUAeoAHHw,17,19,14,8,8,0,3,0,52,7.428571428571429,3,0.0,2,14,8,8,17,0,0,3,0,32,20,0
708,9911,Jd5OP6GIsguRdsq9k3eSYNENmzhPbdGe,bWdj2GDclj5ofokWjzoa5jAwMkxCykd6,5,4,2,0,0,0,5,0,11,1.5714285714285714,2,0.0,0,2,0,0,4,0,0,5,0,2,9,1
709,9916,CJe4pjtrcC0FOMy3krEkccqFJZO0Cqq4,RXDvfPUBYFlVdlueBFbLW0mhhAyGEqpt,13,7,6,22,0,21,8,7,71,10.142857142857142,2,0.0,0,6,17,0,7,21,5,8,7,23,48,1
710,9919,YwojqO58bCgaotjJoOTtpKH2oiEFOZyB,SpATywNh6bZuzm8s1ceuBUnMUAeoAHHw,7,6,5,0,4,0,1,0,16,2.2857142857142856,1,0.0,0,5,0,4,6,0,0,1,0,9,7,1
711,9921,Mv7oSGs75OaCjYLhHCNmqqrqaAjjO5gs,RXDvfPUBYFlVdlueBFbLW0mhhAyGEqpt,38,77,7,93,5,11,21,1,215,30.714285714285715,3,0.0,22,7,84,5,55,11,9,21,1,118,97,1
712,9926,TgheOgj9khTgshxaHKtqDHWb3smGHeUA,SpATywNh6bZuzm8s1ceuBUnMUAeoAHHw,12,11,1,15,0,0,1,0,28,4.0,1,0.0,3,1,13,0,8,0,2,1,0,17,11,1
713,9944,IUn6MADAjAYkGlJisA1WiDvCeNlJd5Xd,G8EPVSXsOYB5YQWZGiz1aVq5Pgr2GrQu,9,16,8,9,5,0,1,0,39,5.571428571428571,4,0.0,2,8,9,5,14,0,0,1,0,24,15,1
714,9945,5NIu7B9o5GAsLAdx3xyl9xnxkK6Z7Hn1,SpATywNh6bZuzm8s1ceuBUnMUAeoAHHw,1,0,0,0,0,0,1,0,1,0.14285714285714285,1,0.0,0,0,0,0,0,0,0,1,0,0,1,1
715,9965,XL8OObjZsaGHAKex6gNHyGuTbyi42iwz,SpATywNh6bZuzm8s1ceuBUnMUAeoAHHw,6,8,0,0,0,7,3,5,23,3.2857142857142856,1,0.0,0,0,0,0,8,7,0,3,5,0,23,1
716,9973,pqAmXCZ0vs0c5YNrZSPIZNZIkmuJCMBN,RXDvfPUBYFlVdlueBFbLW0mhhAyGEqpt,27,26,17,44,9,31,7,4,138,19.714285714285715,3,0.0,5,17,42,9,21,31,2,7,4,73,65,0
717,9986,hM3OejyZim6cDpiFQsjtqNuKMzh1dYaY,SpATywNh6bZuzm8s1ceuBUnMUAeoAHHw,7,4,0,6,0,0,2,0,12,1.7142857142857142,1,0.0,0,0,5,0,4,0,1,2,0,5,7,1
718,9989,GVRJN4wkoooaXJUVmwnX983A87KsrZPK,A3fsA9Zfv1X2fVEQhTw51lKENdNrEqT3,28,16,9,64,5,10,5,0,109,15.571428571428571,2,0.0,4,9,54,5,12,10,10,5,0,72,37,0
719,9993,oThgY0TV97t9DlLv4WWVQ93RXTQBQvf5,SpATywNh6bZuzm8s1ceuBUnMUAeoAHHw,1,0,0,0,0,0,2,0,2,0.2857142857142857,1,0.0,0,0,0,0,0,0,0,2,0,0,2,1
720,10001,vsk33lNJbFXN2L68Y5R9TSkfONwNMOQ8,SpATywNh6bZuzm8s1ceuBUnMUAeoAHHw,14,24,8,12,2,6,4,0,56,8.0,2,0.0,9,8,11,2,15,6,1,4,0,30,26,0
721,10002,HjIrUt1Ax8b3fBkdKQupL2gDMbKYgLrZ,bWdj2GDclj5ofokWjzoa5jAwMkxCykd6,5,5,3,0,2,0,2,0,12,1.7142857142857142,2,0.0,0,3,0,2,5,0,0,2,0,5,7,1
722,10011,gGIYUaDzHtuVAdLHD7FaG5z9ih7s8ZFV,SpATywNh6bZuzm8s1ceuBUnMUAeoAHHw,6,1,1,0,1,0,3,1,7,1.0,1,0.0,0,1,0,1,1,0,0,3,1,2,5,1
723,10012,vqSgORDp5PsEpveQVJoPh4dnJvR6AQkK,RXDvfPUBYFlVdlueBFbLW0mhhAyGEqpt,22,29,16,22,9,30,6,0,112,16.0,3,0.0,6,16,21,9,23,30,1,6,0,52,60,0
724,10013,NYNmhRIaW3AmhvVQt7ReXvH6yAc7z73U,RXDvfPUBYFlVdlueBFbLW0mhhAyGEqpt,5,0,0,0,0,30,6,1,37,5.285714285714286,2,0.0,0,0,0,0,0,30,0,6,1,0,37,1
725,10021,oX8Y4icCGan10HVW1mtOWEP3pxrvK1WZ,RXDvfPUBYFlVdlueBFbLW0mhhAyGEqpt,22,19,11,26,6,66,3,0,131,18.714285714285715,2,0.0,4,11,26,6,15,66,0,3,0,47,84,0
726,10029,sdNkCaSqYSgtx1tSTEHqB38WFlBnpR89,SpATywNh6bZuzm8s1ceuBUnMUAeoAHHw,16,17,11,5,6,0,5,0,44,6.285714285714286,1,0.0,4,11,4,6,13,0,1,5,0,25,19,1
727,10036,M0OuzdgM82B7CvwoM2EBQihSEuKyfCoB,G8EPVSXsOYB5YQWZGiz1aVq5Pgr2GrQu,16,7,1,26,1,3,16,0,54,7.714285714285714,2,0.0,0,1,22,1,7,3,4,16,0,24,30,1
728,10042,RCWIrGGQZDVLNIofIMbc1GdSrqA961jg,RXDvfPUBYFlVdlueBFbLW0mhhAyGEqpt,11,20,11,4,1,105,4,0,145,20.714285714285715,2,0.0,1,11,3,1,19,105,1,4,0,16,129,1
729,10044,Wigd4PnyDnjfDcFOxsTBcEnXo7kl9GSg,bWdj2GDclj5ofokWjzoa5jAwMkxCykd6,9,11,5,0,1,0,3,0,20,2.857142857142857,1,0.0,2,5,0,1,9,0,0,3,0,8,12,1
730,10048,X8GmwqDtWUFSMSOGWtivlDRmblWXusTi,SpATywNh6bZuzm8s1ceuBUnMUAeoAHHw,1,0,0,0,0,0,1,0,1,0.14285714285714285,1,0.0,0,0,0,0,0,0,0,1,0,0,1,0
731,10065,GV5J9MUmZdHez5d6vsAQtSAbOI4jKQlj,bWdj2GDclj5ofokWjzoa5jAwMkxCykd6,13,17,10,0,4,5,8,1,45,6.428571428571429,2,0.0,1,10,0,4,16,5,0,8,1,15,30,0
732,10067,IkfMHDVbFGQIQxWjHsEqTwjNnrBCaA7O,SpATywNh6bZuzm8s1ceuBUnMUAeoAHHw,18,37,18,12,5,7,9,0,88,12.571428571428571,5,0.0,3,18,12,5,34,7,0,9,0,38,50,0
733,10070,FkxhG6zHFqigfK7M5JQhv4MT6lPE3kxN,RXDvfPUBYFlVdlueBFbLW0mhhAyGEqpt,26,24,17,47,9,3,11,14,125,17.857142857142858,3,0.0,1,17,41,9,23,3,6,11,14,68,57,0
734,10071,ivII4h55QUeXOce5qbbvWPv1IAJ1FXtO,SpATywNh6bZuzm8s1ceuBUnMUAeoAHHw,17,22,1,18,0,0,8,0,49,7.0,1,0.0,7,1,17,0,15,0,1,8,0,25,24,1
735,10073,3VQVtsFphnOA3h1KWYRcAEMgfViLsPnF,A3fsA9Zfv1X2fVEQhTw51lKENdNrEqT3,12,22,0,0,3,0,1,0,26,3.7142857142857144,1,0.0,5,0,0,3,17,0,0,1,0,8,18,1
736,10075,EdSyqy374rFTTRmoH6AfOLgRNsPjxdOm,bWdj2GDclj5ofokWjzoa5jAwMkxCykd6,5,3,2,0,1,0,1,0,7,1.0,1,0.0,0,2,0,1,3,0,0,1,0,3,4,1
737,10081,2LiXT3Fppj80YAOl6K8p0HtAK0LHy6KG,SpATywNh6bZuzm8s1ceuBUnMUAeoAHHw,27,35,24,22,13,6,9,0,109,15.571428571428571,2,0.0,7,24,22,13,28,6,0,9,0,66,43,0
738,10095,JQVJEgOcL8lOPq9QqGxWJ7NUVC20wQ1o,SpATywNh6bZuzm8s1ceuBUnMUAeoAHHw,15,13,8,0,7,2,5,0,35,5.0,2,0.0,2,8,0,7,11,2,0,5,0,17,18,0
739,10112,D1iAkJgGLDV90w339eOp4Bqd5z6wvBY6,bWdj2GDclj5ofokWjzoa5jAwMkxCykd6,1,0,0,0,0,0,1,0,1,0.14285714285714285,1,0.0,0,0,0,0,0,0,0,1,0,0,1,1
740,10119,8IVnhzyRJrPiaCjSSJli9bG8p44dgy3T,SpATywNh6bZuzm8s1ceuBUnMUAeoAHHw,7,5,2,0,2,0,3,0,12,1.7142857142857142,1,0.0,1,2,0,2,4,0,0,3,0,5,7,1
741,10120,9Dm5yt1s5sm1v7MbrzCfMpw138AkercO,RXDvfPUBYFlVdlueBFbLW0mhhAyGEqpt,1,0,0,0,0,0,1,0,1,0.14285714285714285,1,0.0,0,0,0,0,0,0,0,1,0,0,1,0
742,10122,NiXPZUmEILmWUPwXexYxtHvaIL7QdjCQ,RXDvfPUBYFlVdlueBFbLW0mhhAyGEqpt,22,30,19,30,0,20,5,0,104,14.857142857142858,3,0.0,6,19,29,0,24,20,1,5,0,54,50,0
743,10130,u3iTsADy3VjWLwiWIPabdGKGPi8ZLAbJ,SpATywNh6bZuzm8s1ceuBUnMUAeoAHHw,8,9,2,0,1,0,4,0,16,2.2857142857142856,2,0.0,0,2,0,1,9,0,0,4,0,3,13,0
744,10137,CUHsvexAAfaCEMKsM3644JTxXL5DgSss,bWdj2GDclj5ofokWjzoa5jAwMkxCykd6,4,2,1,0,1,0,1,0,5,0.7142857142857143,1,0.0,0,1,0,1,2,0,0,1,0,2,3,1
745,10147,ng7eSUGwAsEpodxFM2MoBV45uXU9cRkh,SpATywNh6bZuzm8s1ceuBUnMUAeoAHHw,1,0,0,0,0,0,2,0,2,0.2857142857142857,1,0.0,0,0,0,0,0,0,0,2,0,0,2,1
746,10161,n4cJEUTWqAxTpul10x8ZDTmIRIbytL0a,SpATywNh6bZuzm8s1ceuBUnMUAeoAHHw,18,32,12,20,5,0,4,0,73,10.428571428571429,3,0.0,12,12,18,5,20,0,2,4,0,47,26,1
747,10165,PzZ2nmySEoPT9qSsl3Z3wqf8hhgEC7RR,bWdj2GDclj5ofokWjzoa5jAwMkxCykd6,8,10,1,0,2,0,3,1,17,2.4285714285714284,2,0.0,3,1,0,2,7,0,0,3,1,6,11,1
748,10171,IceoOG9Um0Dwn1hM2FcjjE3CJhGCpTrp,SpATywNh6bZuzm8s1ceuBUnMUAeoAHHw,1,0,0,0,0,0,1,0,1,0.14285714285714285,1,0.0,0,0,0,0,0,0,0,1,0,0,1,1
749,10193,T6JL6sNT8M40gVvb059fgHfBQIftQwIF,SpATywNh6bZuzm8s1ceuBUnMUAeoAHHw,14,28,12,8,0,0,7,0,55,7.857142857142857,3,0.0,11,12,8,0,17,0,0,7,0,31,24,1
750,10200,Sb9hMB1NLdfMmS0ToFmgrY6MZEZ6TYgo,SpATywNh6bZuzm8s1ceuBUnMUAeoAHHw,19,30,14,16,6,0,3,0,69,9.857142857142858,2,0.0,13,14,13,6,17,0,3,3,0,46,23,0
751,10202,BiB7jdHiaAHugRlYDLxmiYyQzifAAliU,SpATywNh6bZuzm8s1ceuBUnMUAeoAHHw,6,17,9,0,2,0,3,0,31,4.428571428571429,2,0.0,0,9,0,2,17,0,0,3,0,11,20,1
752,10204,nJbKKV1iJX5hAlKTzoiNMNIkB5aNJcfW,G8EPVSXsOYB5YQWZGiz1aVq5Pgr2GrQu,27,23,16,12,7,1,10,3,72,10.285714285714286,1,0.0,0,16,11,7,23,1,1,10,3,34,38,0
753,10207,Qf6P6bxCyzplkdXIQa3YsHmpzfUnMGYL,SpATywNh6bZuzm8s1ceuBUnMUAeoAHHw,5,6,2,0,0,0,2,0,10,1.4285714285714286,1,0.0,3,2,0,0,3,0,0,2,0,5,5,0
754,10210,qVH2miiWM8Lf3bY2iypzRXLuMojA4gKB,SpATywNh6bZuzm8s1ceuBUnMUAeoAHHw,14,8,7,0,5,3,3,1,27,3.857142857142857,1,0.0,0,7,0,5,8,3,0,3,1,12,15,1
755,10212,IKkLcanOfBFv8w6vw2fYzBwzbCJQZq5m,SpATywNh6bZuzm8s1ceuBUnMUAeoAHHw,11,9,5,0,3,6,2,1,26,3.7142857142857144,1,0.0,0,5,0,3,9,6,0,2,1,8,18,0
756,10214,X71Zy6g4fufrJXrIbNfXtlVdtViubQUc,G8EPVSXsOYB5YQWZGiz1aVq5Pgr2GrQu,5,6,1,0,3,0,2,0,12,1.7142857142857142,1,0.0,3,1,0,3,3,0,0,2,0,7,5,1
757,10218,JN0hu6OtICcRlrPNS3Zt5hNT8ffEQP2J,bWdj2GDclj5ofokWjzoa5jAwMkxCykd6,12,29,12,0,5,1,12,1,60,8.571428571428571,2,0.0,2,12,0,5,27,1,0,12,1,19,41,1
758,10227,SnivjdMp3HL6G23yPscSnzZlAD2Rbyt6,A3fsA9Zfv1X2fVEQhTw51lKENdNrEqT3,24,8,3,58,1,0,1,0,71,10.142857142857142,1,0.0,3,3,53,1,5,0,5,1,0,60,11,0
759,10230,X9IfBkBBoI1jhyhTI5cK6hEB3eMT1rI2,SpATywNh6bZuzm8s1ceuBUnMUAeoAHHw,14,27,16,9,0,4,6,0,62,8.857142857142858,2,0.0,8,16,9,0,19,4,0,6,0,33,29,0
760,10232,zXzBBpTV9epJ0NK0fVVhqGAiB4MQXdB4,SpATywNh6bZuzm8s1ceuBUnMUAeoAHHw,19,12,7,8,4,8,4,1,44,6.285714285714286,1,0.0,4,7,8,4,8,8,0,4,1,23,21,0
761,10236,zMsdFc2bNoJ6urVmU6g31AhzZMFpCEEM,SpATywNh6bZuzm8s1ceuBUnMUAeoAHHw,11,7,1,19,1,0,2,1,31,4.428571428571429,1,0.0,2,1,16,1,5,0,3,2,1,20,11,1
762,10244,5gwirWhcaVB1Z2yy4RRslODx7MsCrRca,SpATywNh6bZuzm8s1ceuBUnMUAeoAHHw,18,22,12,14,7,0,3,1,59,8.428571428571429,1,0.0,8,12,13,7,14,0,1,3,1,40,19,0
763,10250,GhXXCYV4l3r313zlwGPyJpPeGLc4qMAC,bWdj2GDclj5ofokWjzoa5jAwMkxCykd6,8,3,2,0,2,0,3,0,10,1.4285714285714286,1,0.0,0,2,0,2,3,0,0,3,0,4,6,1
764,10263,Gy6MuuTSUxAvObvL74Ev0uen9bQJO61p,SpATywNh6bZuzm8s1ceuBUnMUAeoAHHw,5,1,1,0,1,0,2,0,5,0.7142857142857143,1,0.0,0,1,0,1,1,0,0,2,0,2,3,1
765,10271,1kFTVSLESXiimtERcEyClh5CUMgpZbSa,SpATywNh6bZuzm8s1ceuBUnMUAeoAHHw,7,5,3,0,2,0,2,0,12,1.7142857142857142,1,0.0,0,3,0,2,5,0,0,2,0,5,7,0
766,10276,6pYrzEgLAB7Gx24u5Kn0l64uyJLXY41J,SpATywNh6bZuzm8s1ceuBUnMUAeoAHHw,3,0,0,0,0,0,9,0,9,1.2857142857142858,3,0.0,0,0,0,0,0,0,0,9,0,0,9,0
767,10280,dtlGqEkxytgl4rvxvygVAnxqgcqdYicp,SpATywNh6bZuzm8s1ceuBUnMUAeoAHHw,17,25,7,13,4,0,5,0,54,7.714285714285714,4,0.0,5,7,12,4,20,0,1,5,0,28,26,0
768,10289,83H2FVc0DUlyPpMlZsbpGsFQRMFc6fan,SpATywNh6bZuzm8s1ceuBUnMUAeoAHHw,15,14,12,6,6,0,3,0,41,5.857142857142857,1,0.0,0,12,5,6,14,0,1,3,0,23,18,0
769,10307,ZBhV1m5APkbtG3EQZyk5pMZqkJsFLe6t,SpATywNh6bZuzm8s1ceuBUnMUAeoAHHw,8,22,13,0,8,1,9,0,53,7.571428571428571,2,0.0,1,13,0,8,21,1,0,9,0,22,31,1
770,10310,nTUP3gEuwVy2Io3TzQXGmuh9VvJxgHk3,bWdj2GDclj5ofokWjzoa5jAwMkxCykd6,5,3,2,0,1,0,1,0,7,1.0,1,0.0,0,2,0,1,3,0,0,1,0,3,4,1
771,10328,GSkYUOcl4XzYMWSWhE6gXRGQ9kqPeXsi,SpATywNh6bZuzm8s1ceuBUnMUAeoAHHw,18,12,9,16,5,0,3,0,45,6.428571428571429,1,0.0,2,9,14,5,10,0,2,3,0,30,15,0
772,10340,afCicX2FGCc7YS72xtNmCsPkAgJ0p3xk,SpATywNh6bZuzm8s1ceuBUnMUAeoAHHw,5,2,0,0,0,0,7,0,9,1.2857142857142858,1,0.0,0,0,0,0,2,0,0,7,0,0,9,1
773,10342,snAYYuMQqGAkhlZMfAgAWobAumSD4u2s,SpATywNh6bZuzm8s1ceuBUnMUAeoAHHw,8,5,3,0,2,0,3,0,13,1.8571428571428572,1,0.0,0,3,0,2,5,0,0,3,0,5,8,1
774,10358,Nzrw7pk0OZ13UV7zfdLy7gEMwvTA7qqG,SpATywNh6bZuzm8s1ceuBUnMUAeoAHHw,21,44,24,15,7,76,25,2,193,27.571428571428573,7,0.0,4,24,15,7,40,76,0,25,2,50,143,0
775,10365,xg8dkQPzve0MzcpgxvEsbKyY4VwKrxAC,SpATywNh6bZuzm8s1ceuBUnMUAeoAHHw,11,26,0,0,0,0,2,0,28,4.0,1,0.0,3,0,0,0,23,0,0,2,0,3,25,1
776,10380,ziZWaDkSdnYYFQL9rVa6Bhv9eL7a9wWX,SpATywNh6bZuzm8s1ceuBUnMUAeoAHHw,14,16,3,21,2,2,10,0,54,7.714285714285714,2,0.0,5,3,17,2,11,2,4,10,0,27,27,0
777,10382,wONMmUHIYwPBmEB9lgpOY3KCldKiuZFl,SpATywNh6bZuzm8s1ceuBUnMUAeoAHHw,4,2,1,0,0,0,3,0,6,0.8571428571428571,2,0.0,0,1,0,0,2,0,0,3,0,1,5,0
778,10383,1wBdrtLehQQJkXlNE5BI48cxv9PbJtLD,bWdj2GDclj5ofokWjzoa5jAwMkxCykd6,1,0,0,0,0,0,1,0,1,0.14285714285714285,1,0.0,0,0,0,0,0,0,0,1,0,0,1,1
779,10388,SaHrUfZXnTghdXjrd2g1gBsj8aUTXhNX,SpATywNh6bZuzm8s1ceuBUnMUAeoAHHw,15,12,4,9,2,0,3,0,30,4.285714285714286,1,0.0,4,4,9,2,8,0,0,3,0,19,11,0
780,10395,HYP3Q558qDipVvMi5tV4os7veHPJBNBQ,bWdj2GDclj5ofokWjzoa5jAwMkxCykd6,8,13,6,0,2,0,6,0,27,3.857142857142857,3,0.0,0,6,0,2,13,0,0,6,0,8,19,0
781,10403,VgIpHnZLrMLRtvQcwLJvvhrvLtLKds8Y,SpATywNh6bZuzm8s1ceuBUnMUAeoAHHw,18,27,2,6,2,0,8,0,45,6.428571428571429,2,0.0,1,2,5,2,26,0,1,8,0,10,35,1
782,10407,xLsstPG4sh6BOKWjwGwQnQICDDoIsKTd,SpATywNh6bZuzm8s1ceuBUnMUAeoAHHw,15,24,15,0,7,0,6,0,52,7.428571428571429,4,0.0,2,15,0,7,22,0,0,6,0,24,28,0
783,10416,9jZsAxMdQXvLjxKIorcfAyZ7kTyyk2m3,bWdj2GDclj5ofokWjzoa5jAwMkxCykd6,5,4,2,0,1,0,1,0,8,1.1428571428571428,1,0.0,0,2,0,1,4,0,0,1,0,3,5,1
784,10422,Eu9HoDt3WhECHgcXaERosbI6lMj7Hipb,RXDvfPUBYFlVdlueBFbLW0mhhAyGEqpt,39,43,30,32,20,22,7,0,154,22.0,4,0.0,8,30,30,20,35,22,2,7,0,88,66,0
785,10423,0bGsOnbsTfgtcrUHSL9Ba6RYBtQEiaAR,SpATywNh6bZuzm8s1ceuBUnMUAeoAHHw,4,2,1,0,1,0,1,0,5,0.7142857142857143,1,0.0,0,1,0,1,2,0,0,1,0,2,3,1
786,10427,Daw06K1PSOXldo19kBgHP5sewulb7Vu5,SpATywNh6bZuzm8s1ceuBUnMUAeoAHHw,15,26,1,9,0,0,4,0,40,5.714285714285714,3,0.0,2,1,9,0,24,0,0,4,0,12,28,1
787,10441,KRLjLXKoKEagD4g49Zuzvz0geq7JPqfn,bWdj2GDclj5ofokWjzoa5jAwMkxCykd6,5,3,2,0,1,0,1,0,7,1.0,1,0.0,0,2,0,1,3,0,0,1,0,3,4,0
788,10462,PERCKVrZOUZ9ZmdU3J0Mwd1TZrMvK8yc,RXDvfPUBYFlVdlueBFbLW0mhhAyGEqpt,15,22,12,0,12,0,1,0,47,6.714285714285714,1,0.0,6,12,0,12,16,0,0,1,0,30,17,0
789,10481,4baDuWDcygh3I7gf3DfgmuPMN0Tyoi19,SpATywNh6bZuzm8s1ceuBUnMUAeoAHHw,19,27,7,12,2,0,10,0,58,8.285714285714286,4,0.0,6,7,9,2,21,0,3,10,0,24,34,0
790,10489,VC1Fuf9dV49znO9PkMawj1ZQqMcKHAjm,SpATywNh6bZuzm8s1ceuBUnMUAeoAHHw,14,17,1,18,0,4,6,0,46,6.571428571428571,3,0.0,8,1,15,0,9,4,3,6,0,24,22,0
791,10502,vx1j5ZdbVcqMnaq8fewmENptts2XnB9X,SpATywNh6bZuzm8s1ceuBUnMUAeoAHHw,23,20,9,8,5,6,5,0,53,7.571428571428571,1,0.0,1,9,7,5,19,6,1,5,0,22,31,0
792,10509,gtq5s5jDEXDrRLbMZLZJIjHVD4oTJM3K,SpATywNh6bZuzm8s1ceuBUnMUAeoAHHw,19,24,1,14,1,1,8,1,50,7.142857142857143,1,0.0,7,1,11,1,17,1,3,8,1,20,30,1
793,10510,Dz5Gcjm5wFySM7nVbkILZVfr9rOqjoD4,bWdj2GDclj5ofokWjzoa5jAwMkxCykd6,1,0,0,0,0,0,1,0,1,0.14285714285714285,1,0.0,0,0,0,0,0,0,0,1,0,0,1,1
794,10518,rzGwtyhvOohTorRAFSpekt9j8KJVn1Nq,SpATywNh6bZuzm8s1ceuBUnMUAeoAHHw,27,39,17,34,7,2,14,0,113,16.142857142857142,3,0.0,15,17,31,7,24,2,3,14,0,70,43,0
795,10522,6rHs7FPoWFgbGCrOeJU6CnRQs9oaZ934,SpATywNh6bZuzm8s1ceuBUnMUAeoAHHw,1,0,0,0,0,0,1,0,1,0.14285714285714285,1,0.0,0,0,0,0,0,0,0,1,0,0,1,0
796,10523,jUBhH6RhAb1JtOUdjtvZ9A8khJilFTTv,RXDvfPUBYFlVdlueBFbLW0mhhAyGEqpt,9,14,4,0,1,4,8,0,31,4.428571428571429,1,0.0,9,4,0,1,5,4,0,8,0,14,17,1
797,10527,VYMfm0tgVS6x4Eosz9NPpRPYpCrgFsMy,A3fsA9Zfv1X2fVEQhTw51lKENdNrEqT3,45,33,24,141,17,0,11,0,226,32.285714285714285,5,0.0,3,24,133,17,30,0,8,11,0,177,49,0
798,10528,WubsiWqf9HrcjL91VrCtUc1j3k8esFc2,G8EPVSXsOYB5YQWZGiz1aVq5Pgr2GrQu,4,2,0,0,0,0,2,0,4,0.5714285714285714,1,0.0,0,0,0,0,2,0,0,2,0,0,4,1
799,10535,TyLciGh9B6yO4eY9EZiNs3MwXyb1sWVv,SpATywNh6bZuzm8s1ceuBUnMUAeoAHHw,5,3,1,0,1,0,1,0,6,0.8571428571428571,1,0.0,0,1,0,1,3,0,0,1,0,2,4,1
800,10540,Cwlc0kvvLoKXxEuXNQkjFRo818TDMpZS,SpATywNh6bZuzm8s1ceuBUnMUAeoAHHw,19,25,10,14,4,16,5,4,78,11.142857142857142,2,0.0,10,10,14,4,15,16,0,5,4,38,40,0
801,10542,r2u5KF0HWbXOmPd8SinNo3Ik67swOdP7,SpATywNh6bZuzm8s1ceuBUnMUAeoAHHw,16,23,14,6,9,1,8,0,61,8.714285714285714,2,0.0,7,14,6,9,16,1,0,8,0,36,25,0
802,10555,QqE2Xjwy9gUzOvFdkDqAwAaNZLBZkxvd,bWdj2GDclj5ofokWjzoa5jAwMkxCykd6,6,4,1,0,1,0,6,0,12,1.7142857142857142,3,0.0,0,1,0,1,4,0,0,6,0,2,10,0
803,10558,Cvs414mYH2FKto3axCpDhfQljawQ5dk9,SpATywNh6bZuzm8s1ceuBUnMUAeoAHHw,16,27,15,15,4,0,7,0,68,9.714285714285714,3,0.0,4,15,15,4,23,0,0,7,0,38,30,0
804,10567,WubsiWqf9HrcjL91VrCtUc1j3k8esFc2,SpATywNh6bZuzm8s1ceuBUnMUAeoAHHw,1,0,0,0,0,0,2,0,2,0.2857142857142857,2,0.0,0,0,0,0,0,0,0,2,0,0,2,1
805,10580,m1V3ygdnufe369wleiOQ11JelGyARbAF,SpATywNh6bZuzm8s1ceuBUnMUAeoAHHw,20,23,14,16,8,2,9,0,72,10.285714285714286,2,0.0,5,14,13,8,18,2,3,9,0,40,32,1
806,10591,wbbNGhodAmSlYSg7ZSWYtWMdb0rjLgRw,G8EPVSXsOYB5YQWZGiz1aVq5Pgr2GrQu,26,12,6,36,2,0,4,0,60,8.571428571428571,1,0.0,0,6,35,2,12,0,1,4,0,43,17,0
807,10604,UKrQdzHwNJRJK7ZoTzKsoWlrkEbsQk7X,G8EPVSXsOYB5YQWZGiz1aVq5Pgr2GrQu,17,14,10,0,6,11,10,0,51,7.285714285714286,2,0.0,0,10,0,6,14,11,0,10,0,16,35,1
808,10606,BOBLP6pTmRtpQ8LtVgJyutFMDL3q6xno,SpATywNh6bZuzm8s1ceuBUnMUAeoAHHw,17,21,14,8,4,0,4,0,51,7.285714285714286,4,0.0,2,14,8,4,19,0,0,4,0,28,23,0
809,10608,a3StgABPgimfVHzW1FR4usG9kIA0tZV5,SpATywNh6bZuzm8s1ceuBUnMUAeoAHHw,14,44,0,14,0,2,5,0,65,9.285714285714286,3,0.0,5,0,11,0,39,2,3,5,0,16,49,0
810,10609,VYMfm0tgVS6x4Eosz9NPpRPYpCrgFsMy,bWdj2GDclj5ofokWjzoa5jAwMkxCykd6,35,49,25,198,12,17,11,0,312,44.57142857142857,3,0.0,14,25,177,12,35,17,21,11,0,228,84,1
811,10619,CGB0PTeWY2VA2Nk2INJOsdD7IvpzgObV,G8EPVSXsOYB5YQWZGiz1aVq5Pgr2GrQu,5,4,2,0,1,0,1,0,8,1.1428571428571428,1,0.0,0,2,0,1,4,0,0,1,0,3,5,1
812,10620,uhhVn2X7KTVJ0ZZ7uUwG1hMZv4TidRQj,SpATywNh6bZuzm8s1ceuBUnMUAeoAHHw,5,2,1,0,1,0,2,0,6,0.8571428571428571,1,0.0,0,1,0,1,2,0,0,2,0,2,4,1
813,10623,dzaUNwKZy91BtYj96fOhuSgIlp9lXQDU,SpATywNh6bZuzm8s1ceuBUnMUAeoAHHw,3,2,1,0,0,0,1,0,4,0.5714285714285714,1,0.0,0,1,0,0,2,0,0,1,0,1,3,0
814,10634,OUOJlObKrXM0JmEUq0o8KzZHzr8jy9dn,bWdj2GDclj5ofokWjzoa5jAwMkxCykd6,1,0,0,0,0,0,1,0,1,0.14285714285714285,1,0.0,0,0,0,0,0,0,0,1,0,0,1,0
815,10637,uzPUKUi7vVAcTKZXvlLeqjC4erxz8WBI,bWdj2GDclj5ofokWjzoa5jAwMkxCykd6,8,12,8,0,7,6,0,0,33,4.714285714285714,3,0.0,0,8,0,7,12,6,0,0,0,15,18,0
816,10642,OnuqqUI42ulcOdv07J5FWiuL2V3DVzCo,RXDvfPUBYFlVdlueBFbLW0mhhAyGEqpt,6,4,3,0,1,0,1,0,9,1.2857142857142858,1,0.0,0,3,0,1,4,0,0,1,0,4,5,1
817,10647,JqgIGUKaljto8rJQxV18FonxG0JqVkY4,SpATywNh6bZuzm8s1ceuBUnMUAeoAHHw,4,5,1,0,0,0,1,0,7,1.0,1,0.0,0,1,0,0,5,0,0,1,0,1,6,1
818,10655,39GYbZ8lJRbKZppnA1dQGPRJvzLTR46Q,SpATywNh6bZuzm8s1ceuBUnMUAeoAHHw,4,3,2,0,1,0,0,0,6,0.8571428571428571,1,0.0,0,2,0,1,3,0,0,0,0,3,3,0
819,10666,9G8Z3eYe0C9cQmNRrnywgJDzRVO9yiAU,SpATywNh6bZuzm8s1ceuBUnMUAeoAHHw,10,7,4,0,3,0,2,0,16,2.2857142857142856,1,0.0,0,4,0,3,7,0,0,2,0,7,9,1
820,10667,gvBW2L5p7TFF6lkwpHMNMz6nt7oEVYk1,SpATywNh6bZuzm8s1ceuBUnMUAeoAHHw,5,8,3,0,0,0,3,0,14,2.0,1,0.0,3,3,0,0,5,0,0,3,0,6,8,0
821,10670,vUBx8sjBPXrETcrwHSfZ0pSQFIH0HPOl,SpATywNh6bZuzm8s1ceuBUnMUAeoAHHw,8,6,3,0,2,0,6,0,17,2.4285714285714284,1,0.0,0,3,0,2,6,0,0,6,0,5,12,1
822,10676,Bv9FSXvHlE6wLC4E4yrAKqe3BQhrrtfx,SpATywNh6bZuzm8s1ceuBUnMUAeoAHHw,12,22,1,14,0,0,1,0,38,5.428571428571429,1,0.0,7,1,11,0,15,0,3,1,0,19,19,0
823,10677,e3VhXxfZ0vOxuCz75HZxH5mLRjbeafOC,A3fsA9Zfv1X2fVEQhTw51lKENdNrEqT3,7,3,2,0,1,1,4,0,11,1.5714285714285714,1,0.0,0,2,0,1,3,1,0,4,0,3,8,1
824,10692,rTYF0meww41Jaf1ZhSKn71dF6UobIHyn,SpATywNh6bZuzm8s1ceuBUnMUAeoAHHw,14,39,2,8,0,4,14,0,67,9.571428571428571,4,0.0,2,2,8,0,37,4,0,14,0,12,55,0
825,10693,ZAehH9zLr3mvrD0qfr21tfeJdYtTkUHf,SpATywNh6bZuzm8s1ceuBUnMUAeoAHHw,12,9,2,0,2,1,8,1,23,3.2857142857142856,2,0.0,0,2,0,2,9,1,0,8,1,4,19,1
826,10700,jX1wtG8uym7vm2Ny85W79HCXnEeqhUm4,bWdj2GDclj5ofokWjzoa5jAwMkxCykd6,18,19,8,22,1,15,6,0,71,10.142857142857142,2,0.0,6,8,14,1,13,15,8,6,0,29,42,0
827,10701,01A7cnd3gvCIwCcMkE5K8qeHnbk9l92w,SpATywNh6bZuzm8s1ceuBUnMUAeoAHHw,7,4,1,0,1,0,3,0,9,1.2857142857142858,1,0.0,0,1,0,1,4,0,0,3,0,2,7,1
828,10712,IaSb2U7ef1Fkefm60uQQgWhKloK1Rfe8,SpATywNh6bZuzm8s1ceuBUnMUAeoAHHw,20,19,11,22,5,0,7,0,64,9.142857142857142,3,0.0,4,11,20,5,15,0,2,7,0,40,24,0
829,10725,TgheOgj9khTgshxaHKtqDHWb3smGHeUA,G8EPVSXsOYB5YQWZGiz1aVq5Pgr2GrQu,2,0,0,0,0,0,2,0,2,0.2857142857142857,1,0.0,0,0,0,0,0,0,0,2,0,0,2,1
830,10743,98UEGByxiN7tned6NDQeKfQDq4HCSGvQ,SpATywNh6bZuzm8s1ceuBUnMUAeoAHHw,18,23,12,9,6,0,2,0,52,7.428571428571429,2,0.0,7,12,9,6,16,0,0,2,0,34,18,0
831,10746,FQskTqGJU9GeC9XfemJd5Qp19XhmSu0D,SpATywNh6bZuzm8s1ceuBUnMUAeoAHHw,1,0,0,0,0,0,1,0,1,0.14285714285714285,1,0.0,0,0,0,0,0,0,0,1,0,0,1,1
832,10747,348VAoiXzNIM3yBiHWYaT9jpmJfwDK3a,SpATywNh6bZuzm8s1ceuBUnMUAeoAHHw,24,14,9,31,7,0,1,0,62,8.857142857142858,1,0.0,4,9,27,7,10,0,4,1,0,47,15,1
833,10758,JjZeMsAmsZa7SQS0vTrtExRB1lmjwAQ2,SpATywNh6bZuzm8s1ceuBUnMUAeoAHHw,5,4,1,0,1,0,1,0,7,1.0,1,0.0,0,1,0,1,4,0,0,1,0,2,5,0
834,10760,Y2f2dC6l8KkgqmCmVNjopMQFUan6brSz,G8EPVSXsOYB5YQWZGiz1aVq5Pgr2GrQu,5,5,3,0,2,0,2,0,12,1.7142857142857142,2,0.0,0,3,0,2,5,0,0,2,0,5,7,1
835,10761,Grmueh4kYgLYo2kInw23ZHrSQJbjli7D,SpATywNh6bZuzm8s1ceuBUnMUAeoAHHw,6,4,2,0,1,0,1,0,8,1.1428571428571428,1,0.0,0,2,0,1,4,0,0,1,0,3,5,0
836,10763,tby14fMJpDIjTBkK50rauZ0P5DHnQphs,SpATywNh6bZuzm8s1ceuBUnMUAeoAHHw,7,5,3,0,1,0,2,0,11,1.5714285714285714,1,0.0,0,3,0,1,5,0,0,2,0,4,7,1
837,10774,QmKLhFuFtodx97KXUUkaok1RXKwJOs6p,SpATywNh6bZuzm8s1ceuBUnMUAeoAHHw,11,11,7,0,2,0,11,0,31,4.428571428571429,3,0.0,0,7,0,2,11,0,0,11,0,9,22,0
838,10780,4rsvMJ6Q6FXQkVitKsbveKESjOLTvSkd,bWdj2GDclj5ofokWjzoa5jAwMkxCykd6,5,2,1,0,1,0,3,0,7,1.0,2,0.0,0,1,0,1,2,0,0,3,0,2,5,1
839,10784,4fg1E2X2Iqab02UjKHSaN93jLrNDtbK1,SpATywNh6bZuzm8s1ceuBUnMUAeoAHHw,5,2,0,0,0,0,3,0,5,0.7142857142857143,1,0.0,0,0,0,0,2,0,0,3,0,0,5,1
840,10798,8gqnQBccwF9lDaMHj8oF8zZMqUrUX7OJ,SpATywNh6bZuzm8s1ceuBUnMUAeoAHHw,6,2,0,0,0,0,4,0,6,0.8571428571428571,1,0.0,0,0,0,0,2,0,0,4,0,0,6,1
841,10799,4wGoSTuzJXBCojeNmaxk9GbR1KaCV7ql,G8EPVSXsOYB5YQWZGiz1aVq5Pgr2GrQu,15,10,1,12,1,0,1,0,25,3.5714285714285716,1,0.0,0,1,11,1,10,0,1,1,0,13,12,0
842,10802,7jkKKf5Pb7FrtJ3WnuF11G7ePioUPJm3,SpATywNh6bZuzm8s1ceuBUnMUAeoAHHw,20,30,22,12,11,0,4,0,79,11.285714285714286,3,0.0,4,22,12,11,26,0,0,4,0,49,30,0
843,10805,mJAgtJKHxy28GsPIeuAEUCIOXmHzCywF,SpATywNh6bZuzm8s1ceuBUnMUAeoAHHw,21,80,45,8,10,107,41,1,292,41.714285714285715,5,0.0,5,45,7,10,75,107,1,41,1,67,225,0
844,10820,2DRl1D33z6i9gsgW5IB0KBdkJJ1Zsu7a,SpATywNh6bZuzm8s1ceuBUnMUAeoAHHw,8,6,2,12,0,1,3,0,24,3.4285714285714284,1,0.0,4,2,12,0,2,1,0,3,0,18,6,1
845,10821,NXEwBXbU6vvce77sujWgRB6LivhFJvRb,SpATywNh6bZuzm8s1ceuBUnMUAeoAHHw,8,8,5,0,2,0,4,0,19,2.7142857142857144,1,0.0,0,5,0,2,8,0,0,4,0,7,12,0
846,10825,7WuJYJfQSGYpjK1VOCbNTWx56QRfHZwF,SpATywNh6bZuzm8s1ceuBUnMUAeoAHHw,12,18,8,0,2,2,11,2,43,6.142857142857143,1,0.0,5,8,0,2,13,2,0,11,2,15,28,1
847,10832,W73xMu8SLqBdMS90qjmpE3wGeT86YnLl,SpATywNh6bZuzm8s1ceuBUnMUAeoAHHw,1,0,0,0,0,0,1,0,1,0.14285714285714285,1,0.0,0,0,0,0,0,0,0,1,0,0,1,1
848,10850,O4Go02y0WzYwbHIZc8uk50WjYKUP2Q4Y,G8EPVSXsOYB5YQWZGiz1aVq5Pgr2GrQu,5,8,1,0,2,0,2,0,13,1.8571428571428572,1,0.0,4,1,0,2,4,0,0,2,0,7,6,1
849,10863,SE8wOQdHqwRS7ESACXcTxQAuYFlgu1Py,SpATywNh6bZuzm8s1ceuBUnMUAeoAHHw,12,33,18,10,0,13,1,0,75,10.714285714285714,3,0.0,12,18,7,0,21,13,3,1,0,37,38,1
850,10867,n6zGNJI1hLWYjlMIVXYesa3jTXjLwizj,SpATywNh6bZuzm8s1ceuBUnMUAeoAHHw,18,30,15,12,3,0,8,0,68,9.714285714285714,2,0.0,11,15,10,3,19,0,2,8,0,39,29,0
851,10868,d9cbpiPwBULo3iFfJzjTidseoxKi3AEA,SpATywNh6bZuzm8s1ceuBUnMUAeoAHHw,17,28,1,15,0,0,3,0,47,6.714285714285714,2,0.0,7,1,14,0,21,0,1,3,0,22,25,0
852,10873,YLA48gUHn1Dc2R5xXAOe8bpBqZ5RWVW4,A3fsA9Zfv1X2fVEQhTw51lKENdNrEqT3,1,0,0,0,0,0,1,0,1,0.14285714285714285,1,0.0,0,0,0,0,0,0,0,1,0,0,1,1
853,10881,31ZWCwEsmLt26QDeYIg9aUSXrbkhFpxl,SpATywNh6bZuzm8s1ceuBUnMUAeoAHHw,8,3,3,0,2,1,2,0,11,1.5714285714285714,1,0.0,0,3,0,2,3,1,0,2,0,5,6,0
854,10883,FRmbznbV6x9Ojz1brfaBTFmC2TFyzd4t,SpATywNh6bZuzm8s1ceuBUnMUAeoAHHw,6,2,1,0,1,0,3,0,7,1.0,1,0.0,0,1,0,1,2,0,0,3,0,2,5,1
855,10889,QYLtTejmIZrOzfj0rdDVGzAjECmBavYx,A3fsA9Zfv1X2fVEQhTw51lKENdNrEqT3,1,0,0,0,0,0,1,0,1,0.14285714285714285,1,0.0,0,0,0,0,0,0,0,1,0,0,1,1
856,10902,wGtQdpTL13GOtTQAxkeOO6rmRR5kG8Nt,G8EPVSXsOYB5YQWZGiz1aVq5Pgr2GrQu,16,17,1,15,1,3,5,0,42,6.0,1,0.0,6,1,9,1,11,3,6,5,0,17,25,1
857,10903,896KUUFdpc0Ig8weMXOkWbw7cjXtmIVV,SpATywNh6bZuzm8s1ceuBUnMUAeoAHHw,16,11,4,20,2,0,13,1,51,7.285714285714286,4,0.0,4,4,19,2,7,0,1,13,1,29,22,0
858,10907,90tR2Jy52lv1kJ6TwJ9Jqo5P6u0CqT0E,SpATywNh6bZuzm8s1ceuBUnMUAeoAHHw,11,9,8,0,5,0,1,0,23,3.2857142857142856,1,0.0,0,8,0,5,9,0,0,1,0,13,10,0
859,10959,DgZ8el6keJUnUjxjYHQCrfhij2kpBixa,SpATywNh6bZuzm8s1ceuBUnMUAeoAHHw,1,0,0,0,0,0,1,0,1,0.14285714285714285,1,0.0,0,0,0,0,0,0,0,1,0,0,1,1
860,10960,0LuT01kLiLvn9XWvvtK0UMLQOoqN4d0O,SpATywNh6bZuzm8s1ceuBUnMUAeoAHHw,7,3,2,0,2,0,2,0,9,1.2857142857142858,1,0.0,0,2,0,2,3,0,0,2,0,4,5,1
861,10961,1N6nOsYXnkatuA8YMolfRAv0tQpjn2uG,SpATywNh6bZuzm8s1ceuBUnMUAeoAHHw,4,3,2,0,0,0,1,0,6,0.8571428571428571,1,0.0,0,2,0,0,3,0,0,1,0,2,4,0
862,10965,Vc1baHxuYCOF9wXqOziB65UR0NyB8LSm,bWdj2GDclj5ofokWjzoa5jAwMkxCykd6,10,6,0,44,0,2,2,0,54,7.714285714285714,1,0.0,2,0,42,0,4,2,2,2,0,44,10,1
863,10966,DmvuE1XVhhp2s0ZR7GTfZK1NmSM6wJmI,SpATywNh6bZuzm8s1ceuBUnMUAeoAHHw,18,19,8,14,4,2,7,1,55,7.857142857142857,1,0.0,9,8,12,4,10,2,2,7,1,33,22,1
864,10970,IdRsdksEKIk9aXKOiGRUkjb7QPozokDa,SpATywNh6bZuzm8s1ceuBUnMUAeoAHHw,17,38,2,17,0,0,5,0,62,8.857142857142858,4,0.0,7,2,14,0,31,0,3,5,0,23,39,0
865,10977,2VCaGNRfRGGtWxoLqznZdBtjcnH6XG28,SpATywNh6bZuzm8s1ceuBUnMUAeoAHHw,6,5,1,0,1,0,3,0,10,1.4285714285714286,2,0.0,0,1,0,1,5,0,0,3,0,2,8,1
866,10981,gFIubR5L7uAqsUwFMmCtpUtAJn2LXJti,SpATywNh6bZuzm8s1ceuBUnMUAeoAHHw,2,2,1,0,0,0,0,0,3,0.42857142857142855,1,0.0,0,1,0,0,2,0,0,0,0,1,2,1
867,10986,MN4wOgynUY4QcRaraCB5Ym52vNjUttfc,SpATywNh6bZuzm8s1ceuBUnMUAeoAHHw,28,35,20,37,13,9,5,0,119,17.0,2,0.0,11,20,31,13,24,9,6,5,0,75,44,0
868,10992,EaV63ns250Za7MNTuadlc0JeYoVcm5bM,SpATywNh6bZuzm8s1ceuBUnMUAeoAHHw,17,16,5,13,3,0,4,0,41,5.857142857142857,2,0.0,7,5,13,3,9,0,0,4,0,28,13,0
869,11000,zyIWmJjaz36PnMZpAzR2HEZCUbJWe8iQ,bWdj2GDclj5ofokWjzoa5jAwMkxCykd6,36,36,14,93,9,0,5,0,157,22.428571428571427,3,0.0,16,14,89,9,20,0,4,5,0,128,29,1
870,11007,o6ABKk2KTrZIkABXncviG8GWvJhMxPWI,bWdj2GDclj5ofokWjzoa5jAwMkxCykd6,2,0,0,0,0,0,3,0,3,0.42857142857142855,1,0.0,0,0,0,0,0,0,0,3,0,0,3,1
871,11009,V9WdcffWyPz5HIrf6AUJoXYLZsZmovZs,bWdj2GDclj5ofokWjzoa5jAwMkxCykd6,8,5,2,0,2,0,6,0,15,2.142857142857143,1,0.0,0,2,0,2,5,0,0,6,0,4,11,1
872,11018,bjG4XBkL5oSJA9TxyrmgPKXKYOTfiWVp,bWdj2GDclj5ofokWjzoa5jAwMkxCykd6,3,4,1,0,0,0,2,0,7,1.0,1,0.0,0,1,0,0,4,0,0,2,0,1,6,0
873,11039,uukZZIB0DkTcJFX9Kfm5gzAJiaQWt3jq,SpATywNh6bZuzm8s1ceuBUnMUAeoAHHw,12,8,6,0,4,0,2,0,20,2.857142857142857,2,0.0,0,6,0,4,8,0,0,2,0,10,10,1
874,11063,RlHRJAiYu3Nfz7DEuzJcJRZJq4vbOfQu,SpATywNh6bZuzm8s1ceuBUnMUAeoAHHw,1,0,0,0,0,0,4,0,4,0.5714285714285714,2,0.0,0,0,0,0,0,0,0,4,0,0,4,0
875,11072,48y8P1mBttkP3u0gtvk3ydvAiO35KU2g,SpATywNh6bZuzm8s1ceuBUnMUAeoAHHw,5,5,4,0,3,0,1,0,13,1.8571428571428572,2,0.0,0,4,0,3,5,0,0,1,0,7,6,0
876,11095,ALXyvdc776DMhlVyaaoPo6cQhevpwTYD,SpATywNh6bZuzm8s1ceuBUnMUAeoAHHw,16,31,5,11,2,0,10,0,59,8.428571428571429,4,0.0,11,5,11,2,20,0,0,10,0,29,30,0
877,11096,vogj6DdqvLTkNOGuPksobO32JsQUkuqr,SpATywNh6bZuzm8s1ceuBUnMUAeoAHHw,13,33,5,22,0,5,1,0,66,9.428571428571429,4,0.0,14,5,19,0,19,5,3,1,0,38,28,0
878,11098,R5MIWOdfQPF58rt5zIICrbN58FLsYSLK,SpATywNh6bZuzm8s1ceuBUnMUAeoAHHw,11,14,9,0,7,0,2,0,32,4.571428571428571,2,0.0,0,9,0,7,14,0,0,2,0,16,16,0
879,11099,EfuhWoaB1h47xaBVO37JU7S7sIj3K77V,SpATywNh6bZuzm8s1ceuBUnMUAeoAHHw,15,28,1,16,1,0,6,0,52,7.428571428571429,3,0.0,3,1,14,1,25,0,2,6,0,19,33,0
880,11100,qRCFXu9SKQXvPlpvjvNkgxm9VD5k2SNq,G8EPVSXsOYB5YQWZGiz1aVq5Pgr2GrQu,6,9,3,0,1,0,3,0,16,2.2857142857142856,3,0.0,0,3,0,1,9,0,0,3,0,4,12,1
881,11102,WCS011LuLB85y1yYsddT54kQDph1Fl5i,SpATywNh6bZuzm8s1ceuBUnMUAeoAHHw,11,5,4,0,4,0,2,0,15,2.142857142857143,1,0.0,0,4,0,4,5,0,0,2,0,8,7,1
882,11108,kfRiZgRVbY5ABTVoI4HG09f2IgSZ5p9y,SpATywNh6bZuzm8s1ceuBUnMUAeoAHHw,1,0,0,0,0,0,1,0,1,0.14285714285714285,1,0.0,0,0,0,0,0,0,0,1,0,0,1,1
883,11110,fNM6a78gna3DBlYrxiSuwL1HfiXFBx1X,SpATywNh6bZuzm8s1ceuBUnMUAeoAHHw,4,2,1,0,1,0,1,0,5,0.7142857142857143,1,0.0,0,1,0,1,2,0,0,1,0,2,3,1
884,11117,yBKClM5or0v37bBK9shMFXqtoOJsEOKi,SpATywNh6bZuzm8s1ceuBUnMUAeoAHHw,17,29,12,11,5,0,3,0,60,8.571428571428571,2,0.0,6,12,11,5,23,0,0,3,0,34,26,0
885,11118,8G3TIfWeYnotKEBloHzMAvSj0jab6YCE,SpATywNh6bZuzm8s1ceuBUnMUAeoAHHw,10,20,2,0,2,0,5,0,29,4.142857142857143,2,0.0,3,2,0,2,17,0,0,5,0,7,22,0
886,11132,2YJ5Tv1YViB4JNiKZeHEEz6eSF3MN6um,bWdj2GDclj5ofokWjzoa5jAwMkxCykd6,1,0,0,0,0,0,1,0,1,0.14285714285714285,1,0.0,0,0,0,0,0,0,0,1,0,0,1,1
887,11133,CdI8eHwhOFOmT1gRfkQHwobJyLn2OtRJ,SpATywNh6bZuzm8s1ceuBUnMUAeoAHHw,4,3,0,0,0,0,1,0,4,0.5714285714285714,1,0.0,0,0,0,0,3,0,0,1,0,0,4,1
888,11140,kQ63n93d5CTXewyEhcoySFeLgYStuYpO,SpATywNh6bZuzm8s1ceuBUnMUAeoAHHw,16,14,9,16,3,4,5,0,51,7.285714285714286,3,0.0,2,9,14,3,12,4,2,5,0,28,23,0
889,11145,UnV0HDk59T6cuzi8hS829ZOjCdT0CRoB,SpATywNh6bZuzm8s1ceuBUnMUAeoAHHw,4,3,1,0,0,0,1,0,5,0.7142857142857143,1,0.0,0,1,0,0,3,0,0,1,0,1,4,0
890,11152,SuK945tkxadINDtal1yRSiV9QKse6fnl,G8EPVSXsOYB5YQWZGiz1aVq5Pgr2GrQu,6,7,2,4,0,0,2,0,15,2.142857142857143,1,0.0,2,2,2,0,5,0,2,2,0,6,9,0
891,11153,h8eBexpHr95TQpIPdJzX4ggtrj3rthKs,SpATywNh6bZuzm8s1ceuBUnMUAeoAHHw,21,21,12,10,5,2,5,0,55,7.857142857142857,4,0.0,5,12,9,5,16,2,1,5,0,31,24,0
892,11156,HIC4ktOJbqbNeF2uNjLeMCsJ9XcoLJFS,SpATywNh6bZuzm8s1ceuBUnMUAeoAHHw,3,2,0,0,0,0,2,0,4,0.5714285714285714,1,0.0,0,0,0,0,2,0,0,2,0,0,4,1
893,11199,G5krO16D3cyvAnQXVywA0e0QfvmDKyJE,SpATywNh6bZuzm8s1ceuBUnMUAeoAHHw,4,6,1,0,0,0,1,0,8,1.1428571428571428,1,0.0,1,1,0,0,5,0,0,1,0,2,6,1
894,11218,ESIDCh7JUpjIHOXvPcQBcrSs3Att83qK,SpATywNh6bZuzm8s1ceuBUnMUAeoAHHw,14,49,0,6,0,6,25,0,86,12.285714285714286,4,0.0,0,0,6,0,49,6,0,25,0,6,80,0
895,11231,FpAFHYP26eZqx6Z5sDhKdTJPTBgbDKt4,SpATywNh6bZuzm8s1ceuBUnMUAeoAHHw,21,27,15,18,4,23,13,2,102,14.571428571428571,5,0.0,7,15,15,4,20,23,3,13,2,41,61,0
896,11232,wmD7RtZPHqOfpVEXsJ4kv2jVIQOymIt7,G8EPVSXsOYB5YQWZGiz1aVq5Pgr2GrQu,14,10,5,2,3,5,7,1,33,4.714285714285714,1,0.0,3,5,1,3,7,5,1,7,1,12,21,1
897,11266,VhukMS7IeX7XDUBwwZYzbVsz6P6yEHKX,RXDvfPUBYFlVdlueBFbLW0mhhAyGEqpt,1,0,0,0,0,0,1,0,1,0.14285714285714285,1,0.0,0,0,0,0,0,0,0,1,0,0,1,1
898,11267,Zp4vK4oqe1AwFnnOJdy7Uz1AWwNAcdOt,SpATywNh6bZuzm8s1ceuBUnMUAeoAHHw,22,21,13,11,9,0,3,0,57,8.142857142857142,2,0.0,4,13,10,9,17,0,1,3,0,36,21,1
899,11277,fOGAjxxxpsDuk08vAdjWtxgrvUhA2ic8,SpATywNh6bZuzm8s1ceuBUnMUAeoAHHw,12,21,0,22,0,25,3,0,71,10.142857142857142,1,0.0,11,0,17,0,10,25,5,3,0,28,43,1
900,11307,1dxQmK9WwlHWuIG7ZTn4PsJ2vflQBDH3,SpATywNh6bZuzm8s1ceuBUnMUAeoAHHw,14,20,2,6,0,1,2,0,31,4.428571428571429,2,0.0,6,2,6,0,14,1,0,2,0,14,17,0
901,11316,dw8UeboqdsSC29cEE9urly5h5PKlFfq8,SpATywNh6bZuzm8s1ceuBUnMUAeoAHHw,2,0,0,0,0,0,3,0,3,0.42857142857142855,2,0.0,0,0,0,0,0,0,0,3,0,0,3,1
902,11325,urVw10ZOKTw1O1zHFnsutUzT6EcZdTal,SpATywNh6bZuzm8s1ceuBUnMUAeoAHHw,18,12,8,12,4,0,3,1,40,5.714285714285714,2,0.0,2,8,12,4,10,0,0,3,1,26,14,0
903,11336,dEamTHPv2n4UBaBMMzaMVTBu34nRHB8p,SpATywNh6bZuzm8s1ceuBUnMUAeoAHHw,5,0,0,0,0,4,5,1,10,1.4285714285714286,1,0.0,0,0,0,0,0,4,0,5,1,0,10,1
904,11341,mJAgtJKHxy28GsPIeuAEUCIOXmHzCywF,bWdj2GDclj5ofokWjzoa5jAwMkxCykd6,11,33,18,20,6,1,16,0,94,13.428571428571429,4,0.0,3,18,19,6,30,1,1,16,0,46,48,0
905,11350,OfMabADNCpK7MfQ7IaqBsUw8RvPeHL0S,G8EPVSXsOYB5YQWZGiz1aVq5Pgr2GrQu,1,0,0,0,0,0,1,0,1,0.14285714285714285,1,0.0,0,0,0,0,0,0,0,1,0,0,1,1
906,11353,8OeiQbuEbEG2DSTpkZJyuKzc1PTNg0ge,SpATywNh6bZuzm8s1ceuBUnMUAeoAHHw,5,3,1,0,1,0,1,0,6,0.8571428571428571,1,0.0,0,1,0,1,3,0,0,1,0,2,4,1
907,11366,GsMuFjXWxUh2UrLHKPEnIwFvWlVxAcB7,SpATywNh6bZuzm8s1ceuBUnMUAeoAHHw,6,3,2,0,2,0,1,0,8,1.1428571428571428,1,0.0,0,2,0,2,3,0,0,1,0,4,4,0
908,11367,zEiNHlokNuJTLVoV4Hy4kJd9kzaIjztD,SpATywNh6bZuzm8s1ceuBUnMUAeoAHHw,30,38,18,20,9,1,7,0,93,13.285714285714286,5,0.0,6,18,16,9,32,1,4,7,0,49,44,0
909,11369,7KNecsubFdywoFPLyTu2kgv5VbQekjao,SpATywNh6bZuzm8s1ceuBUnMUAeoAHHw,13,20,1,11,0,3,3,0,38,5.428571428571429,1,0.0,9,1,11,0,11,3,0,3,0,21,17,1
910,11382,GDyZ2LKwtCChKfTbObuzefDdka9nIeiE,G8EPVSXsOYB5YQWZGiz1aVq5Pgr2GrQu,1,0,0,0,0,0,1,0,1,0.14285714285714285,1,0.0,0,0,0,0,0,0,0,1,0,0,1,1
911,11384,U8CJ4eMAocRPzH9a3a2MJhXfikEQ51WM,bWdj2GDclj5ofokWjzoa5jAwMkxCykd6,5,2,1,0,1,0,2,0,6,0.8571428571428571,1,0.0,0,1,0,1,2,0,0,2,0,2,4,1
912,11385,KKGY1xUUxKUn4nPRs2VmwvVd6JuyBBfA,SpATywNh6bZuzm8s1ceuBUnMUAeoAHHw,3,0,0,0,0,0,2,3,5,0.7142857142857143,1,0.0,0,0,0,0,0,0,0,2,3,0,5,1
913,11387,8xe55v4hJPUrl0YZIl8G73vP4j2l4PsW,SpATywNh6bZuzm8s1ceuBUnMUAeoAHHw,15,16,3,12,1,0,2,0,34,4.857142857142857,1,0.0,6,3,10,1,10,0,2,2,0,20,14,0
914,11393,D1fgtFfIsG1EcZQzDGeiCx6sI7k5ShWV,G8EPVSXsOYB5YQWZGiz1aVq5Pgr2GrQu,11,6,1,0,1,9,9,2,28,4.0,1,0.0,0,1,0,1,6,9,0,9,2,2,26,1
915,11396,rYSxun4NgQnH8EYwHicH82Z91cblITe8,RXDvfPUBYFlVdlueBFbLW0mhhAyGEqpt,1,0,0,0,0,0,1,0,1,0.14285714285714285,1,0.0,0,0,0,0,0,0,0,1,0,0,1,1
916,11406,rYSxun4NgQnH8EYwHicH82Z91cblITe8,G8EPVSXsOYB5YQWZGiz1aVq5Pgr2GrQu,1,0,0,0,0,0,1,0,1,0.14285714285714285,1,0.0,0,0,0,0,0,0,0,1,0,0,1,1
917,11407,HYCkyEJhW9QtzilmanJKsxRLSBi9UGoV,RXDvfPUBYFlVdlueBFbLW0mhhAyGEqpt,1,0,0,0,0,0,1,0,1,0.14285714285714285,1,0.0,0,0,0,0,0,0,0,1,0,0,1,1
918,11418,Km3IX0L3OZADSpnXU3tgLmBjn4mYhfRJ,SpATywNh6bZuzm8s1ceuBUnMUAeoAHHw,23,41,0,35,0,14,16,1,107,15.285714285714286,2,0.0,11,0,34,0,30,14,1,16,1,45,62,0
919,11430,7KNecsubFdywoFPLyTu2kgv5VbQekjao,RXDvfPUBYFlVdlueBFbLW0mhhAyGEqpt,1,0,0,0,0,0,1,0,1,0.14285714285714285,1,0.0,0,0,0,0,0,0,0,1,0,0,1,1
920,11442,Sz8jNgPmKJ1IbqEEVQqTtQlVUDGarqh2,A3fsA9Zfv1X2fVEQhTw51lKENdNrEqT3,13,13,9,0,6,0,5,0,33,4.714285714285714,3,0.0,0,9,0,6,13,0,0,5,0,15,18,0
921,11448,tLAxgBhXx0zpE8fWNnwggaJx5LeHI2h1,RXDvfPUBYFlVdlueBFbLW0mhhAyGEqpt,42,51,23,122,8,0,3,0,207,29.571428571428573,2,0.0,9,23,113,8,42,0,9,3,0,153,54,1
922,11450,HnptwVrdWLkMWuHezQcYS6A0pyVov5BG,SpATywNh6bZuzm8s1ceuBUnMUAeoAHHw,21,24,16,27,6,9,12,5,99,14.142857142857142,4,0.0,4,16,22,6,20,9,5,12,5,48,51,0
923,11454,G5viWFw6vjc0kZ7aRbev4NG1fp3ajLxi,A3fsA9Zfv1X2fVEQhTw51lKENdNrEqT3,15,9,7,0,6,0,1,0,23,3.2857142857142856,2,0.0,0,7,0,6,9,0,0,1,0,13,10,1
924,11455,5ObfmFiTeuGjRWtYuJy4iGiMBZ3jgU0e,SpATywNh6bZuzm8s1ceuBUnMUAeoAHHw,13,18,8,16,5,0,1,0,48,6.857142857142857,2,0.0,8,8,14,5,10,0,2,1,0,35,13,1
925,11456,CWDKRVVm01sfgssULmzIPwx9dbULLbqB,A3fsA9Zfv1X2fVEQhTw51lKENdNrEqT3,31,16,13,78,11,12,3,0,133,19.0,2,0.0,1,13,67,11,15,12,11,3,0,92,41,0
926,11461,cW0TF0QgesgeR4yvyFNeSG2Tsy7pGtpm,A3fsA9Zfv1X2fVEQhTw51lKENdNrEqT3,41,51,0,84,0,9,16,1,161,23.0,2,0.0,4,0,65,0,47,9,19,16,1,69,92,1
927,11472,mN4qYBgpy4Qxh2rSlBkY5ZDyLEZtAHu9,RXDvfPUBYFlVdlueBFbLW0mhhAyGEqpt,10,6,4,10,2,0,1,0,23,3.2857142857142856,1,0.0,1,4,9,2,5,0,1,1,0,16,7,1
928,11483,fG7nauhHd6Hp0Y6uPPSQifF45RcZ5wiO,SpATywNh6bZuzm8s1ceuBUnMUAeoAHHw,7,5,1,0,0,0,2,0,8,1.1428571428571428,1,0.0,0,1,0,0,5,0,0,2,0,1,7,1
929,11490,mDEirND7nLzt2vy8e34SZhdfEbglxCWs,SpATywNh6bZuzm8s1ceuBUnMUAeoAHHw,18,53,9,12,4,0,6,0,84,12.0,3,0.0,17,9,9,4,36,0,3,6,0,39,45,0
930,11494,nBVpguvJeCUz3AWDoX9CCNT2qyeZb33T,G8EPVSXsOYB5YQWZGiz1aVq5Pgr2GrQu,4,4,1,0,0,0,1,0,6,0.8571428571428571,2,0.0,0,1,0,0,4,0,0,1,0,1,5,0
931,11511,zNxhmmLWnSaIABuhKypYetmsDg2VcOK8,SpATywNh6bZuzm8s1ceuBUnMUAeoAHHw,12,11,5,11,4,0,0,0,31,4.428571428571429,2,0.0,4,5,11,4,7,0,0,0,0,24,7,1
932,11516,aSlIMkfly6xTMJCGTWDQcnFZjajcWM6y,RXDvfPUBYFlVdlueBFbLW0mhhAyGEqpt,9,16,2,0,2,0,1,0,21,3.0,3,0.0,0,2,0,2,16,0,0,1,0,4,17,0
933,11541,vIBcYbs1BLdmaaP30fcE2FS7kB7v7QRn,A3fsA9Zfv1X2fVEQhTw51lKENdNrEqT3,5,9,5,0,0,0,8,0,22,3.142857142857143,4,0.0,0,5,0,0,9,0,0,8,0,5,17,1
934,11546,9PS6Icub6VXkyVUcoskrzajETE7Qoarh,SpATywNh6bZuzm8s1ceuBUnMUAeoAHHw,14,16,11,0,5,0,3,0,35,5.0,1,0.0,2,11,0,5,14,0,0,3,0,18,17,0
935,11556,pplAmbuLk2c8g7K4eYBlhKFfYSpZgbNo,SpATywNh6bZuzm8s1ceuBUnMUAeoAHHw,8,8,0,0,0,0,2,0,10,1.4285714285714286,1,0.0,2,0,0,0,6,0,0,2,0,2,8,0
936,11557,mtYhUCuiqvMc7E9n6ZRYWej43jynHbMu,SpATywNh6bZuzm8s1ceuBUnMUAeoAHHw,11,6,5,7,3,0,2,0,23,3.2857142857142856,1,0.0,0,5,6,3,6,0,1,2,0,14,9,1
937,11564,ZPbUovw1YoDeaWUVrbGEj5A5WdIXTYjf,SpATywNh6bZuzm8s1ceuBUnMUAeoAHHw,8,9,5,0,2,0,1,0,17,2.4285714285714284,1,0.0,0,5,0,2,9,0,0,1,0,7,10,1
938,11568,l1IK9ZY8MbRv8UoeCkxEH7P4W2dtATGX,SpATywNh6bZuzm8s1ceuBUnMUAeoAHHw,14,13,2,14,1,0,2,0,32,4.571428571428571,2,0.0,2,2,14,1,11,0,0,2,0,19,13,0
939,11574,ypwDBeQLkxtWilMLhemtoXkZG88PSCik,SpATywNh6bZuzm8s1ceuBUnMUAeoAHHw,13,50,21,0,0,0,4,0,75,10.714285714285714,5,0.0,12,21,0,0,38,0,0,4,0,33,42,0
940,11576,GKKNtfrAHKD2xUEQBz7HLN3kKO9SrWyD,SpATywNh6bZuzm8s1ceuBUnMUAeoAHHw,6,6,3,0,0,0,2,0,11,1.5714285714285714,1,0.0,2,3,0,0,4,0,0,2,0,5,6,0
941,11579,MgYx3sTen8piVhQ0ZPLZ6p6e7rh59bPE,SpATywNh6bZuzm8s1ceuBUnMUAeoAHHw,11,18,0,8,0,0,7,0,33,4.714285714285714,2,0.0,5,0,7,0,13,0,1,7,0,12,21,1
942,11581,PXjkYsNMSYVKdz07qjMtS6mMBWIuSmKF,bWdj2GDclj5ofokWjzoa5jAwMkxCykd6,6,8,0,0,0,1,7,2,18,2.5714285714285716,2,0.0,0,0,0,0,8,1,0,7,2,0,18,1
943,11586,GIK69AVoFAXQo5stVHHEqOqo5xlrkSOx,SpATywNh6bZuzm8s1ceuBUnMUAeoAHHw,14,21,0,7,0,12,12,0,52,7.428571428571429,4,0.0,1,0,5,0,20,12,2,12,0,6,46,0
944,11591,nlq4r6xc3rTUqTwcYhL6wudXdN6RIE52,A3fsA9Zfv1X2fVEQhTw51lKENdNrEqT3,11,10,7,0,3,0,3,0,23,3.2857142857142856,2,0.0,0,7,0,3,10,0,0,3,0,10,13,0
945,11593,wmwDf7eIRrKPL0l8cNmMygnEPd5vzoqs,SpATywNh6bZuzm8s1ceuBUnMUAeoAHHw,22,53,3,14,2,1,6,0,79,11.285714285714286,4,0.0,20,3,14,2,33,1,0,6,0,39,40,0
946,11596,2AeMxbMeXomHZjSsEj2bsr8PzPP1Dh6q,bWdj2GDclj5ofokWjzoa5jAwMkxCykd6,16,46,21,32,5,12,21,2,139,19.857142857142858,2,0.0,12,21,30,5,34,12,2,21,2,68,71,1
947,11599,GD5KzWMBHDnHVJHzVFtf3u7bIC7XYtJH,SpATywNh6bZuzm8s1ceuBUnMUAeoAHHw,17,33,1,14,0,1,14,1,64,9.142857142857142,3,0.0,4,1,11,0,29,1,3,14,1,16,48,0
948,11600,IroEtJPlvjKfczRi5laeb2DQegyNKOWM,SpATywNh6bZuzm8s1ceuBUnMUAeoAHHw,15,20,11,10,4,6,2,0,53,7.571428571428571,1,0.0,6,11,8,4,14,6,2,2,0,29,24,0
949,11603,wrdkNhe8GmpsjdZUr22H6zTi43mdouZW,SpATywNh6bZuzm8s1ceuBUnMUAeoAHHw,23,36,2,26,2,0,6,0,72,10.285714285714286,1,0.0,5,2,23,2,31,0,3,6,0,32,40,1
950,11606,nNXCDU7pCvXdQPycxWESwEGIIRWvHKWv,A3fsA9Zfv1X2fVEQhTw51lKENdNrEqT3,1,0,0,0,0,0,1,0,1,0.14285714285714285,1,0.0,0,0,0,0,0,0,0,1,0,0,1,1
951,11607,nNXCDU7pCvXdQPycxWESwEGIIRWvHKWv,bWdj2GDclj5ofokWjzoa5jAwMkxCykd6,6,13,3,0,2,14,3,1,36,5.142857142857143,1,0.0,0,3,0,2,13,14,0,3,1,5,31,1
952,11609,lk3lGbNCFxoPG1OVILbfGp3s2wN91K2M,SpATywNh6bZuzm8s1ceuBUnMUAeoAHHw,3,3,0,0,0,0,1,0,4,0.5714285714285714,1,0.0,0,0,0,0,3,0,0,1,0,0,4,1
953,11624,Kw83ufYGIFIihz0PdiaJro4hz0pKGozQ,SpATywNh6bZuzm8s1ceuBUnMUAeoAHHw,11,8,0,10,0,0,2,0,20,2.857142857142857,2,0.0,2,0,8,0,6,0,2,2,0,10,10,1
954,11628,BHczT02DEALJmy7zbrGU6QbzLcOGM0Lz,SpATywNh6bZuzm8s1ceuBUnMUAeoAHHw,11,19,1,0,3,0,2,0,25,3.5714285714285716,2,0.0,0,1,0,3,19,0,0,2,0,4,21,0
955,11630,MR4k3wv95Ttq1fQaT9W4WgxrPezl0N4j,SpATywNh6bZuzm8s1ceuBUnMUAeoAHHw,5,3,1,0,1,0,4,0,9,1.2857142857142858,1,0.0,0,1,0,1,3,0,0,4,0,2,7,1
956,11637,glYOnGBygagQ3d4VwvOcHKnCEWLKXuzk,SpATywNh6bZuzm8s1ceuBUnMUAeoAHHw,23,95,6,28,1,0,19,0,149,21.285714285714285,4,0.0,38,6,26,1,57,0,2,19,0,71,78,0
957,11641,WHRYwHaNw8C182lJomkvSukjZ7e91Upo,SpATywNh6bZuzm8s1ceuBUnMUAeoAHHw,30,38,24,25,9,26,11,2,135,19.285714285714285,2,0.0,10,24,19,9,28,26,6,11,2,62,73,1
958,11650,ilWzYGLWBh9DSc1MV8g2C4Go5wDNgUHX,SpATywNh6bZuzm8s1ceuBUnMUAeoAHHw,11,13,7,14,0,0,1,0,35,5.0,2,0.0,4,7,12,0,9,0,2,1,0,23,12,0
959,11651,tnLfm9tutF6YoqDXNIONCmii1aynBy80,G8EPVSXsOYB5YQWZGiz1aVq5Pgr2GrQu,9,18,9,0,0,0,7,0,34,4.857142857142857,3,0.0,0,9,0,0,18,0,0,7,0,9,25,0
960,11653,WHRYwHaNw8C182lJomkvSukjZ7e91Upo,G8EPVSXsOYB5YQWZGiz1aVq5Pgr2GrQu,53,58,18,108,10,19,11,2,226,32.285714285714285,2,0.0,32,18,74,10,26,19,34,11,2,134,92,1
961,11668,3D1G3v8o9ZJD4YifQcvj5oZ6l4EKMMc3,SpATywNh6bZuzm8s1ceuBUnMUAeoAHHw,31,42,12,24,7,13,13,0,111,15.857142857142858,4,0.0,16,12,24,7,26,13,0,13,0,59,52,0
962,11670,LJnHkVr961LFlbm7Gjo7zRYOv6MZ6dE5,bWdj2GDclj5ofokWjzoa5jAwMkxCykd6,6,4,2,0,1,0,4,0,11,1.5714285714285714,1,0.0,0,2,0,1,4,0,0,4,0,3,8,1
963,11682,VLIaJAnZiJEAdolQsQ0bq4zJoZaIUmTN,SpATywNh6bZuzm8s1ceuBUnMUAeoAHHw,7,5,1,0,1,0,8,0,15,2.142857142857143,2,0.0,0,1,0,1,5,0,0,8,0,2,13,1
964,11688,QyLVPf4M60EkZ1E7DsOzioCPS0UDQt1T,SpATywNh6bZuzm8s1ceuBUnMUAeoAHHw,12,17,1,12,1,2,8,0,41,5.857142857142857,3,0.0,0,1,10,1,17,2,2,8,0,12,29,1
965,11692,relWJA0qYE5Pue4C6aAwg584OGIxhwwx,A3fsA9Zfv1X2fVEQhTw51lKENdNrEqT3,1,0,0,0,0,0,2,0,2,0.2857142857142857,2,0.0,0,0,0,0,0,0,0,2,0,0,2,1
966,11698,kVkYStq5954wY9YqVoootgnbo59g0CLi,SpATywNh6bZuzm8s1ceuBUnMUAeoAHHw,4,2,0,0,0,0,2,0,4,0.5714285714285714,1,0.0,0,0,0,0,2,0,0,2,0,0,4,1
967,11699,fJdUKH8czX92V7yfMeG7e087z1xbQDMc,SpATywNh6bZuzm8s1ceuBUnMUAeoAHHw,19,11,8,6,4,2,5,0,36,5.142857142857143,1,0.0,2,8,6,4,9,2,0,5,0,20,16,0
968,11704,DVIil2NM7ZWOtqe6rhlMzwEUAb2wuaeh,SpATywNh6bZuzm8s1ceuBUnMUAeoAHHw,7,17,7,0,2,3,3,0,32,4.571428571428571,2,0.0,0,7,0,2,17,3,0,3,0,9,23,1
969,11719,cr12tMBqYKzLJbEmIsyFvFLKAg0DiCbM,SpATywNh6bZuzm8s1ceuBUnMUAeoAHHw,18,29,11,10,7,0,4,0,61,8.714285714285714,3,0.0,3,11,9,7,26,0,1,4,0,30,31,0
970,11732,6L205IIarnrBFjrCXSXMQhtSJJ5O5hiQ,SpATywNh6bZuzm8s1ceuBUnMUAeoAHHw,28,75,39,26,19,0,7,8,174,24.857142857142858,2,0.0,19,39,21,19,56,0,5,7,8,98,76,0
971,11737,vn3szbx80pQPfVJU7Et6YnUzTgKJ2evQ,A3fsA9Zfv1X2fVEQhTw51lKENdNrEqT3,2,0,1,0,1,0,0,0,2,0.2857142857142857,1,0.0,0,1,0,1,0,0,0,0,0,2,0,1
972,11743,relWJA0qYE5Pue4C6aAwg584OGIxhwwx,SpATywNh6bZuzm8s1ceuBUnMUAeoAHHw,1,0,0,0,0,0,1,0,1,0.14285714285714285,1,0.0,0,0,0,0,0,0,0,1,0,0,1,1
973,11765,CF9EOBndFkwfNq6XdrlnJGwplvjOhGZh,SpATywNh6bZuzm8s1ceuBUnMUAeoAHHw,22,62,4,31,0,23,13,0,133,19.0,2,0.0,25,4,29,0,37,23,2,13,0,58,75,0
974,11773,gxkoHTlKe7FVuciB5TU7TNQLS1IuXLYY,SpATywNh6bZuzm8s1ceuBUnMUAeoAHHw,14,16,0,14,0,11,5,0,46,6.571428571428571,3,0.0,6,0,13,0,10,11,1,5,0,19,27,1
975,11782,twnWF0mfZYHjmoqBvUs9g7jWpDxNR6WV,SpATywNh6bZuzm8s1ceuBUnMUAeoAHHw,12,21,7,6,0,17,10,1,62,8.857142857142858,2,0.0,13,7,6,0,8,17,0,10,1,26,36,1
976,11795,iQzwToywLVi52lg7X1CKAqUmrJweCbY4,A3fsA9Zfv1X2fVEQhTw51lKENdNrEqT3,2,0,0,0,0,0,4,0,4,0.5714285714285714,1,0.0,0,0,0,0,0,0,0,4,0,0,4,1
977,11796,5Pn4uvjsBWdhF0lVc4LtU6HIHnySgqaU,SpATywNh6bZuzm8s1ceuBUnMUAeoAHHw,1,0,0,0,0,0,1,0,1,0.14285714285714285,1,0.0,0,0,0,0,0,0,0,1,0,0,1,1
978,11797,ejIJpZTu0P4rcWcZmBKl6OiURGceVpiA,SpATywNh6bZuzm8s1ceuBUnMUAeoAHHw,27,32,14,13,7,1,7,0,74,10.571428571428571,4,0.0,6,14,13,7,26,1,0,7,0,40,34,0
979,11803,jpgFrFPODuxdIxVKUbbelvbFMPtUp7jo,SpATywNh6bZuzm8s1ceuBUnMUAeoAHHw,20,19,10,6,5,25,10,1,76,10.857142857142858,3,0.0,4,10,6,5,15,25,0,10,1,25,51,0
980,11822,neCsLgPwvO3NM22QUF7ePoDh9jooDB1R,G8EPVSXsOYB5YQWZGiz1aVq5Pgr2GrQu,12,19,3,0,2,0,4,0,28,4.0,3,0.0,2,3,0,2,17,0,0,4,0,7,21,0
981,11830,OJNek1dgn6lYb4ldZM3hUDbtlOcoRdmG,SpATywNh6bZuzm8s1ceuBUnMUAeoAHHw,14,11,7,11,5,0,3,0,37,5.285714285714286,2,0.0,2,7,10,5,9,0,1,3,0,24,13,0
982,11866,0Ycdp4l6pgMwD7gJz4jynSnW5FA5aOcj,RXDvfPUBYFlVdlueBFbLW0mhhAyGEqpt,18,31,19,0,11,1,11,3,76,10.857142857142858,1,0.0,6,19,0,11,25,1,0,11,3,36,40,0
983,11868,grkG64gC1ukbqi3lu9n1P24tGPzF2BzQ,SpATywNh6bZuzm8s1ceuBUnMUAeoAHHw,26,59,37,12,18,20,19,0,165,23.571428571428573,6,0.0,10,37,10,18,49,20,2,19,0,75,90,0
984,11873,CLsYy7g1hYWHJyj1aROfKK9oTeo5yxJx,SpATywNh6bZuzm8s1ceuBUnMUAeoAHHw,24,31,13,27,4,8,13,1,97,13.857142857142858,4,0.0,11,13,24,4,20,8,3,13,1,52,45,0
985,11875,s1zoJG6TsTv8LP9PRWCYbeiv4OLIivpy,SpATywNh6bZuzm8s1ceuBUnMUAeoAHHw,21,21,14,0,10,0,5,0,50,7.142857142857143,4,0.0,0,14,0,10,21,0,0,5,0,24,26,0
986,11882,x5ZyS8ChPKTwgxrKWhGeApVsRxKYNf86,SpATywNh6bZuzm8s1ceuBUnMUAeoAHHw,18,27,0,12,1,2,10,0,52,7.428571428571429,2,0.0,14,0,9,1,13,2,3,10,0,24,28,1
987,11885,5Yc9dIv7921c7z5p5LW8t3x8iddn1yRC,SpATywNh6bZuzm8s1ceuBUnMUAeoAHHw,21,56,13,18,6,0,13,0,106,15.142857142857142,2,0.0,7,13,17,6,49,0,1,13,0,43,63,1
988,11891,BeyfLbwb8pdDQU6WTI5ee3FkxRPRP7B2,A3fsA9Zfv1X2fVEQhTw51lKENdNrEqT3,5,3,2,0,1,0,3,0,9,1.2857142857142858,1,0.0,0,2,0,1,3,0,0,3,0,3,6,1
989,11898,pSPFAE8vJ6UClRkBsZEyTga6sVysOokX,SpATywNh6bZuzm8s1ceuBUnMUAeoAHHw,1,0,0,0,0,0,1,0,1,0.14285714285714285,1,0.0,0,0,0,0,0,0,0,1,0,0,1,1
990,11909,Hh6CQ9eQF89j5a5Oi2NUf2uAs2DZd4QT,A3fsA9Zfv1X2fVEQhTw51lKENdNrEqT3,34,45,27,76,8,55,15,0,226,32.285714285714285,5,0.0,2,27,60,8,43,55,16,15,0,97,129,1
991,11912,5FSqkpRO54sosmyXXDdXixBIUlxd8QNQ,SpATywNh6bZuzm8s1ceuBUnMUAeoAHHw,11,9,6,0,4,0,2,0,21,3.0,2,0.0,0,6,0,4,9,0,0,2,0,10,11,0
992,11928,syrttArug8Mpzs9L0IHsvBtATawYF9J2,A3fsA9Zfv1X2fVEQhTw51lKENdNrEqT3,48,22,11,116,1,1,12,0,163,23.285714285714285,4,0.0,4,11,101,1,18,1,15,12,0,117,46,0
993,11933,OmF4aFe06TkjIpsTgGpQ4vBzMWi2jjQV,bWdj2GDclj5ofokWjzoa5jAwMkxCykd6,25,12,7,72,2,0,11,0,104,14.857142857142858,2,0.0,2,7,59,2,10,0,13,11,0,70,34,0
994,11955,oyFfPK6y9oPPwQR5mbsXW98FJaEnU88b,SpATywNh6bZuzm8s1ceuBUnMUAeoAHHw,1,0,0,0,0,0,1,0,1,0.14285714285714285,1,0.0,0,0,0,0,0,0,0,1,0,0,1,1
995,11958,HG2MGN3erjLUr4zPCv4UJukzIqIJPVZ2,SpATywNh6bZuzm8s1ceuBUnMUAeoAHHw,9,14,7,0,3,14,3,0,41,5.857142857142857,1,0.0,4,7,0,3,10,14,0,3,0,14,27,1
996,11969,RhMByUF03fgdIuaHANL6m20mbMakGgJs,SpATywNh6bZuzm8s1ceuBUnMUAeoAHHw,15,30,16,0,6,0,3,0,55,7.857142857142857,1,0.0,5,16,0,6,25,0,0,3,0,27,28,0
997,11975,MAjx1xtQvL5ZiofHx4xuO3WtfmkLHjqM,SpATywNh6bZuzm8s1ceuBUnMUAeoAHHw,8,4,3,0,2,0,2,0,11,1.5714285714285714,1,0.0,0,3,0,2,4,0,0,2,0,5,6,1
998,11981,FZjjoikxEifQwEx2vf6LYlhg4yyTwbym,A3fsA9Zfv1X2fVEQhTw51lKENdNrEqT3,19,19,10,0,5,7,17,0,58,8.285714285714286,4,0.0,1,10,0,5,18,7,0,17,0,16,42,1
999,11982,BA5BMBRmhCtFQyjTLAMMLlVS5ABrW2hi,SpATywNh6bZuzm8s1ceuBUnMUAeoAHHw,10,15,4,14,1,0,2,0,36,5.142857142857143,1,0.0,5,4,11,1,10,0,3,2,0,21,15,0
1000,11998,NHPpKvbnrSpxM8e1DORBWJbRCpmrxZw8,SpATywNh6bZuzm8s1ceuBUnMUAeoAHHw,18,19,12,14,6,2,5,0,58,8.285714285714286,3,0.0,6,12,11,6,13,2,3,5,0,35,23,0
1001,12000,tncBhgwJEnaybUdK2e3UQ2PdOl85hyHm,SpATywNh6bZuzm8s1ceuBUnMUAeoAHHw,19,35,12,22,4,13,5,0,91,13.0,2,0.0,19,12,19,4,16,13,3,5,0,54,37,0
1002,12016,matrDCCbXVpxlcX50EwFfEaLRW1d7v0q,SpATywNh6bZuzm8s1ceuBUnMUAeoAHHw,5,4,3,0,1,0,1,0,9,1.2857142857142858,1,0.0,0,3,0,1,4,0,0,1,0,4,5,1
1003,12019,UaSh8dwx8gnofYbXlmpqj9uYDbpJ89pX,bWdj2GDclj5ofokWjzoa5jAwMkxCykd6,6,11,2,0,1,32,10,0,56,8.0,3,0.0,0,2,0,1,11,32,0,10,0,3,53,0
1004,12022,wHhHCETlsngCbxRgyphDRhWNDaw9hkb5,bWdj2GDclj5ofokWjzoa5jAwMkxCykd6,7,18,1,30,2,0,1,0,52,7.428571428571429,1,0.0,13,1,29,2,5,0,1,1,0,45,7,1
1005,12028,TnWxqbrMUttPbRmFwVduGXC6tM50wXNs,G8EPVSXsOYB5YQWZGiz1aVq5Pgr2GrQu,16,6,5,16,2,0,5,1,35,5.0,1,0.0,0,5,13,2,6,0,3,5,1,20,15,1
1006,12029,yj09XjzxRqPWNB0AOEufH55lHRijrBGr,A3fsA9Zfv1X2fVEQhTw51lKENdNrEqT3,11,7,3,0,3,0,6,0,19,2.7142857142857144,1,0.0,0,3,0,3,7,0,0,6,0,6,13,1
1007,12051,ECki0IXplihhOXFtHwNEOZv3lgdNQeLX,bWdj2GDclj5ofokWjzoa5jAwMkxCykd6,8,7,4,0,2,1,7,1,22,3.142857142857143,2,0.0,0,4,0,2,7,1,0,7,1,6,16,1
1008,12052,g3902agYIRHzac78MKVZlvljLMXXNpQ7,SpATywNh6bZuzm8s1ceuBUnMUAeoAHHw,19,17,11,15,5,1,8,0,57,8.142857142857142,3,0.0,2,11,15,5,15,1,0,8,0,33,24,0
1009,12058,iPBAJ9CVDCVYdsrujNIhJfrUSnaDCIHG,bWdj2GDclj5ofokWjzoa5jAwMkxCykd6,6,6,2,0,2,0,4,0,14,2.0,2,0.0,1,2,0,2,5,0,0,4,0,5,9,1
1010,12071,aeavxOLfuZgcJqnNwarxFiMVjjeJZrPA,SpATywNh6bZuzm8s1ceuBUnMUAeoAHHw,5,3,1,0,1,0,2,0,7,1.0,1,0.0,0,1,0,1,3,0,0,2,0,2,5,1
1011,12079,ZpZGRrq9otivAzXqSjL90NMLUImGmxsg,SpATywNh6bZuzm8s1ceuBUnMUAeoAHHw,6,7,1,0,0,0,2,0,10,1.4285714285714286,2,0.0,0,1,0,0,7,0,0,2,0,1,9,1
1012,12082,QWRabGXxCqME5Lkb4IAANkZxIcelEiGP,bWdj2GDclj5ofokWjzoa5jAwMkxCykd6,1,0,0,0,0,0,2,0,2,0.2857142857142857,1,0.0,0,0,0,0,0,0,0,2,0,0,2,1
1013,12083,U0kf3qSBRgyWv3qqGgGYInyPjg6gK9O9,RXDvfPUBYFlVdlueBFbLW0mhhAyGEqpt,1,0,0,0,0,0,1,0,1,0.14285714285714285,1,0.0,0,0,0,0,0,0,0,1,0,0,1,1
1014,12088,7yMNJWNsXgPHWgF0rje4LKKgdLbyOw5Y,A3fsA9Zfv1X2fVEQhTw51lKENdNrEqT3,4,3,2,0,0,0,1,0,6,0.8571428571428571,1,0.0,0,2,0,0,3,0,0,1,0,2,4,1
1015,12097,LclkEDGY7WCR76zraNkzkcQywMJivp2l,SpATywNh6bZuzm8s1ceuBUnMUAeoAHHw,31,85,27,42,18,6,12,1,191,27.285714285714285,2,0.0,24,27,36,18,61,6,6,12,1,105,86,1
1016,12100,tCXa4pMsMXRuliZWNM9so3Odte6UmpYj,A3fsA9Zfv1X2fVEQhTw51lKENdNrEqT3,1,0,0,0,0,0,1,0,1,0.14285714285714285,1,0.0,0,0,0,0,0,0,0,1,0,0,1,1
1017,12111,1GWkEwQ90VRdtDsFxjla0MbrnOSbAEId,RXDvfPUBYFlVdlueBFbLW0mhhAyGEqpt,4,2,0,0,0,0,2,0,4,0.5714285714285714,1,0.0,0,0,0,0,2,0,0,2,0,0,4,1
1018,12119,x0VzAeYdlywtGLqE1HF68qQMYZTLfsw9,A3fsA9Zfv1X2fVEQhTw51lKENdNrEqT3,51,27,17,124,6,6,8,0,188,26.857142857142858,3,0.0,4,17,114,6,23,6,10,8,0,141,47,1
1019,12126,32uJBAomTJQIXKZnCX4K7PYoVfESGbct,RXDvfPUBYFlVdlueBFbLW0mhhAyGEqpt,51,58,28,94,17,0,3,0,200,28.571428571428573,2,0.0,21,28,85,17,37,0,9,3,0,151,49,1
1020,12127,HElrq1eSGzBafUMUdvN7RCubKET34OTX,SpATywNh6bZuzm8s1ceuBUnMUAeoAHHw,1,0,0,0,0,0,1,0,1,0.14285714285714285,1,0.0,0,0,0,0,0,0,0,1,0,0,1,1
1021,12137,jkbAnCxwl3OIEg7uH62X9N4RjNwDvZxg,SpATywNh6bZuzm8s1ceuBUnMUAeoAHHw,19,18,10,0,6,0,4,0,38,5.428571428571429,3,0.0,5,10,0,6,13,0,0,4,0,21,17,1
1022,12139,i8WIZSEgsoHBi5QZhvayPbZQldL0txWw,A3fsA9Zfv1X2fVEQhTw51lKENdNrEqT3,7,3,2,0,2,0,3,0,10,1.4285714285714286,1,0.0,0,2,0,2,3,0,0,3,0,4,6,1
1023,12144,4JPTMOEW3QvxnvFVxcqBPUVqTDTMZIow,SpATywNh6bZuzm8s1ceuBUnMUAeoAHHw,1,0,0,0,0,0,2,0,2,0.2857142857142857,1,0.0,0,0,0,0,0,0,0,2,0,0,2,1
1024,12166,x6CSpC8D3vQdEDfFDD93c2HvZ1J8Rtto,RXDvfPUBYFlVdlueBFbLW0mhhAyGEqpt,66,85,56,124,21,31,9,0,326,46.57142857142857,2,0.0,20,56,112,21,65,31,12,9,0,209,117,1
1025,12171,eAArxLyCThtu9N3Mv8rQculKbGSa66j9,SpATywNh6bZuzm8s1ceuBUnMUAeoAHHw,5,3,2,0,0,0,2,0,7,1.0,1,0.0,0,2,0,0,3,0,0,2,0,2,5,1
1026,12182,rdSWxFhXxAq7LLsaFRDkga5HDqBXvg9z,bWdj2GDclj5ofokWjzoa5jAwMkxCykd6,2,0,0,0,0,0,2,0,2,0.2857142857142857,1,0.0,0,0,0,0,0,0,0,2,0,0,2,1
1027,12193,ajHCgh5jQq7dgoaNHY1H5hSSSFewTHW9,A3fsA9Zfv1X2fVEQhTw51lKENdNrEqT3,2,0,0,0,0,0,2,0,2,0.2857142857142857,1,0.0,0,0,0,0,0,0,0,2,0,0,2,1
1028,12197,RPansaKc9yPYyKahcqLAJO6a0GoBHglr,SpATywNh6bZuzm8s1ceuBUnMUAeoAHHw,17,28,18,9,12,0,4,0,71,10.142857142857142,2,0.0,5,18,9,12,23,0,0,4,0,44,27,0
1029,12202,rdSWxFhXxAq7LLsaFRDkga5HDqBXvg9z,A3fsA9Zfv1X2fVEQhTw51lKENdNrEqT3,7,5,1,0,1,0,2,0,9,1.2857142857142858,1,0.0,0,1,0,1,5,0,0,2,0,2,7,1
1030,12212,KXPHZfgM3L9NmmWzrburRZrpNwRct3s8,SpATywNh6bZuzm8s1ceuBUnMUAeoAHHw,31,49,21,43,8,12,18,2,153,21.857142857142858,4,0.0,22,21,37,8,27,12,6,18,2,88,65,1
1031,12220,9b4Qm8eSvDuZev1N90TcJBdVRXi0Jx1k,SpATywNh6bZuzm8s1ceuBUnMUAeoAHHw,13,11,2,18,1,0,1,0,33,4.714285714285714,1,0.0,2,2,15,1,9,0,3,1,0,20,13,1
1032,12255,lCVPDaggOlwGJsnAJvi5aMCj1weM2Pue,SpATywNh6bZuzm8s1ceuBUnMUAeoAHHw,6,3,2,0,2,0,1,0,8,1.1428571428571428,1,0.0,0,2,0,2,3,0,0,1,0,4,4,1
1033,12257,Htb70W0lnqw4QeBjeePevzE0xRg4O6vF,A3fsA9Zfv1X2fVEQhTw51lKENdNrEqT3,12,11,10,0,0,1,4,0,26,3.7142857142857144,1,0.0,0,10,0,0,11,1,0,4,0,10,16,1
1034,12258,Htb70W0lnqw4QeBjeePevzE0xRg4O6vF,bWdj2GDclj5ofokWjzoa5jAwMkxCykd6,1,0,0,0,0,0,2,0,2,0.2857142857142857,1,0.0,0,0,0,0,0,0,0,2,0,0,2,1
1035,12270,mccn7oMsSoLGVTk06xkhM1ICp7gdLXuk,SpATywNh6bZuzm8s1ceuBUnMUAeoAHHw,5,4,3,0,1,0,1,0,9,1.2857142857142858,1,0.0,0,3,0,1,4,0,0,1,0,4,5,1
1036,12276,lCVPDaggOlwGJsnAJvi5aMCj1weM2Pue,A3fsA9Zfv1X2fVEQhTw51lKENdNrEqT3,4,2,1,0,1,0,1,0,5,0.7142857142857143,1,0.0,0,1,0,1,2,0,0,1,0,2,3,1
1037,12281,lCVPDaggOlwGJsnAJvi5aMCj1weM2Pue,bWdj2GDclj5ofokWjzoa5jAwMkxCykd6,6,6,1,0,1,0,2,0,10,1.4285714285714286,1,0.0,0,1,0,1,6,0,0,2,0,2,8,1
1038,12289,j3c6K94i9dgmcXc2NErAuVxnWFJZj8tT,bWdj2GDclj5ofokWjzoa5jAwMkxCykd6,6,4,3,0,2,0,1,0,10,1.4285714285714286,1,0.0,0,3,0,2,4,0,0,1,0,5,5,1
1039,12299,fa6SZdwIb8QmMO5YcB5PQzrN75peDxq7,G8EPVSXsOYB5YQWZGiz1aVq5Pgr2GrQu,5,3,2,0,1,0,1,0,7,1.0,1,0.0,0,2,0,1,3,0,0,1,0,3,4,1
1040,12301,OeLBIzS0gNQ56euxy5b66gAZMzQCGE7n,bWdj2GDclj5ofokWjzoa5jAwMkxCykd6,1,0,0,0,0,0,1,0,1,0.14285714285714285,1,0.0,0,0,0,0,0,0,0,1,0,0,1,1
1041,12308,CQOn4KWCA0duDCOSP1DQzvXZ3yAfq1zW,SpATywNh6bZuzm8s1ceuBUnMUAeoAHHw,19,29,17,13,7,27,2,0,95,13.571428571428571,3,0.0,8,17,13,7,21,27,0,2,0,45,50,0
1042,12317,niLMw8MCObO7SSR2V1jNg9WQt5oSjDFJ,A3fsA9Zfv1X2fVEQhTw51lKENdNrEqT3,7,4,3,0,2,0,1,0,10,1.4285714285714286,1,0.0,0,3,0,2,4,0,0,1,0,5,5,1
1043,12320,niLMw8MCObO7SSR2V1jNg9WQt5oSjDFJ,SpATywNh6bZuzm8s1ceuBUnMUAeoAHHw,3,4,2,0,0,0,2,0,8,1.1428571428571428,2,0.0,0,2,0,0,4,0,0,2,0,2,6,1
1044,12321,g3902agYIRHzac78MKVZlvljLMXXNpQ7,A3fsA9Zfv1X2fVEQhTw51lKENdNrEqT3,6,6,3,0,0,1,10,1,21,3.0,3,0.0,0,3,0,0,6,1,0,10,1,3,18,1
1045,12323,dceX0m9075YvlWaEabJwd03DyXl3MtL8,SpATywNh6bZuzm8s1ceuBUnMUAeoAHHw,9,14,4,8,0,0,1,0,27,3.857142857142857,1,0.0,8,4,8,0,6,0,0,1,0,20,7,0
1046,12328,lCVPDaggOlwGJsnAJvi5aMCj1weM2Pue,RXDvfPUBYFlVdlueBFbLW0mhhAyGEqpt,7,5,4,0,1,0,1,0,11,1.5714285714285714,1,0.0,0,4,0,1,5,0,0,1,0,5,6,1
1047,12332,ncwdVeNEm9rMUWWKD40nNQFCSGSrd8Qu,SpATywNh6bZuzm8s1ceuBUnMUAeoAHHw,1,0,0,0,0,0,1,0,1,0.14285714285714285,1,0.0,0,0,0,0,0,0,0,1,0,0,1,1
1048,12333,8V1FCzMo3zMKQW1ts44FS8gSim8xyz9W,G8EPVSXsOYB5YQWZGiz1aVq5Pgr2GrQu,4,2,1,0,1,0,1,0,5,0.7142857142857143,1,0.0,0,1,0,1,2,0,0,1,0,2,3,1
1049,12348,ZhTCqX8GMUcn0a0betuEauHNuCk1aRhm,A3fsA9Zfv1X2fVEQhTw51lKENdNrEqT3,29,18,9,70,2,17,6,0,122,17.428571428571427,3,0.0,4,9,61,2,14,17,9,6,0,76,46,0
1050,12351,f5nUM7X4snZl1Dwk9DyOLQ7PstRe3yG1,SpATywNh6bZuzm8s1ceuBUnMUAeoAHHw,5,3,2,0,1,0,1,0,7,1.0,1,0.0,0,2,0,1,3,0,0,1,0,3,4,1
1051,12371,Dx1ZzKpwFtwNhE9gdaLaohssqGyqrqjD,SpATywNh6bZuzm8s1ceuBUnMUAeoAHHw,21,33,15,14,4,9,10,1,86,12.285714285714286,3,0.0,7,15,11,4,26,9,3,10,1,37,49,0
1052,12384,bKVslXuzEQ1pv4c6iV5mVjs6X6avUbmL,RXDvfPUBYFlVdlueBFbLW0mhhAyGEqpt,21,104,44,2,6,260,66,8,490,70.0,4,0.0,1,44,1,6,103,260,1,66,8,52,438,0
1053,12386,Ak5p1JsyLmT4pGKGNb849PzZbmvFekml,SpATywNh6bZuzm8s1ceuBUnMUAeoAHHw,11,15,4,12,2,0,2,0,35,5.0,1,0.0,10,4,11,2,5,0,1,2,0,27,8,1
1054,12389,DNxlKJNm5ao3DSObllNvFwn0RJUn50Hh,SpATywNh6bZuzm8s1ceuBUnMUAeoAHHw,1,0,0,0,0,0,1,0,1,0.14285714285714285,1,0.0,0,0,0,0,0,0,0,1,0,0,1,1
1055,12402,3z0hX7DEeFfsgBAb2GCqLtG7EloWzN4g,bWdj2GDclj5ofokWjzoa5jAwMkxCykd6,4,2,1,0,0,0,2,0,5,0.7142857142857143,1,0.0,0,1,0,0,2,0,0,2,0,1,4,1
1056,12409,Io5gLr8QOxaBw8nFReloAXOpt3IlZ5WE,SpATywNh6bZuzm8s1ceuBUnMUAeoAHHw,3,2,0,0,0,0,2,0,4,0.5714285714285714,2,0.0,0,0,0,0,2,0,0,2,0,0,4,0
1057,12415,9xXPu4XrxUEQD4kiDWTsMvTkTFxGkYzI,A3fsA9Zfv1X2fVEQhTw51lKENdNrEqT3,44,34,17,64,11,0,3,0,129,18.428571428571427,3,0.0,3,17,55,11,31,0,9,3,0,86,43,1
1058,12430,w62eko3BoCGIpZmfYYoFjoaBC9TFzjaB,SpATywNh6bZuzm8s1ceuBUnMUAeoAHHw,32,34,18,30,9,33,19,1,144,20.571428571428573,4,0.0,9,18,25,9,25,33,5,19,1,61,83,1
1059,12431,dOkXreE5Co54rqG7YecVg356rhQtEiRH,SpATywNh6bZuzm8s1ceuBUnMUAeoAHHw,3,2,1,0,0,0,2,0,5,0.7142857142857143,1,0.0,0,1,0,0,2,0,0,2,0,1,4,1
1060,12440,48vx3qHAZvBzdWBXsxihTari5aBTmUGi,SpATywNh6bZuzm8s1ceuBUnMUAeoAHHw,16,12,6,0,4,2,12,2,38,5.428571428571429,1,0.0,0,6,0,4,12,2,0,12,2,10,28,1
1061,12448,AQaaG4AcAnObnM2M4NcHCUkX6lEg0Mlu,SpATywNh6bZuzm8s1ceuBUnMUAeoAHHw,30,33,16,33,8,6,15,1,112,16.0,2,0.0,12,16,29,8,21,6,4,15,1,65,47,1
1062,12473,Jn3Y3EwJczNHkfzTGUpSSJOFpEETB0cw,A3fsA9Zfv1X2fVEQhTw51lKENdNrEqT3,2,0,0,0,0,0,4,0,4,0.5714285714285714,2,0.0,0,0,0,0,0,0,0,4,0,0,4,1
1063,12484,yEuZmA9AbYZaWqEfxA4FratjPoewKT3C,bWdj2GDclj5ofokWjzoa5jAwMkxCykd6,10,14,7,0,6,4,11,2,44,6.285714285714286,2,0.0,4,7,0,6,10,4,0,11,2,17,27,1
1064,12488,UkVp32qxLqsEWmDdG99xhNvtg1mVGbkd,SpATywNh6bZuzm8s1ceuBUnMUAeoAHHw,10,14,8,0,1,2,7,0,32,4.571428571428571,1,0.0,0,8,0,1,14,2,0,7,0,9,23,1
1065,12513,Jn3Y3EwJczNHkfzTGUpSSJOFpEETB0cw,SpATywNh6bZuzm8s1ceuBUnMUAeoAHHw,13,16,5,0,5,0,5,0,31,4.428571428571429,2,0.0,0,5,0,5,16,0,0,5,0,10,21,1
1066,12517,VfrUmEAx0ZYYX6kUXFzpxLwtafRhi7qR,SpATywNh6bZuzm8s1ceuBUnMUAeoAHHw,5,2,1,0,1,0,2,0,6,0.8571428571428571,1,0.0,0,1,0,1,2,0,0,2,0,2,4,1
1067,12518,4IkxYjTflPhoHxhEdrFyf3T4ZXNMTaKd,SpATywNh6bZuzm8s1ceuBUnMUAeoAHHw,27,46,20,26,7,0,4,0,103,14.714285714285714,3,0.0,10,20,25,7,36,0,1,4,0,62,41,0
1068,12521,jCbueeMsegjPu59bj6eGJyYcDxtIb05e,bWdj2GDclj5ofokWjzoa5jAwMkxCykd6,7,4,1,4,1,0,3,0,13,1.8571428571428572,1,0.0,2,1,3,1,2,0,1,3,0,7,6,1
1069,12536,XKtSJUu70kLs3jRiKFAR2MlWI70CZUcv,G8EPVSXsOYB5YQWZGiz1aVq5Pgr2GrQu,22,25,1,0,1,0,5,0,32,4.571428571428571,1,0.0,0,1,0,1,25,0,0,5,0,2,30,0
1070,12540,nlq4r6xc3rTUqTwcYhL6wudXdN6RIE52,bWdj2GDclj5ofokWjzoa5jAwMkxCykd6,12,8,7,0,7,0,1,0,23,3.2857142857142856,1,0.0,0,7,0,7,8,0,0,1,0,14,9,1
1071,12546,LRHDYNgQAsG2UssS8TgaqkiYDbFlVrrj,A3fsA9Zfv1X2fVEQhTw51lKENdNrEqT3,17,12,11,0,9,3,3,1,39,5.571428571428571,1,0.0,0,11,0,9,12,3,0,3,1,20,19,1
1072,12547,IImOhpbuTNHI88DulkMnjvsH7H0HMncx,SpATywNh6bZuzm8s1ceuBUnMUAeoAHHw,4,2,1,0,1,0,1,0,5,0.7142857142857143,1,0.0,0,1,0,1,2,0,0,1,0,2,3,1
1073,12556,InTDVHpDSVoZu5vOSvueBLdJOgZb9Qu8,A3fsA9Zfv1X2fVEQhTw51lKENdNrEqT3,8,5,3,0,1,7,4,0,20,2.857142857142857,1,0.0,0,3,0,1,5,7,0,4,0,4,16,1
1074,12557,Vx74c4EnHqTcmxhMcO6kRvadcvYQC7Hl,SpATywNh6bZuzm8s1ceuBUnMUAeoAHHw,12,14,6,0,4,0,4,0,28,4.0,3,0.0,0,6,0,4,14,0,0,4,0,10,18,0
1075,12564,D59LfxtLBEXUXJuXCGYTJcy2S1d5nPYE,SpATywNh6bZuzm8s1ceuBUnMUAeoAHHw,18,21,2,13,1,0,4,0,41,5.857142857142857,3,0.0,4,2,12,1,17,0,1,4,0,19,22,0
1076,12566,ph8ToQs4xH6gdMMZGt7KWlSytujO4hy7,bWdj2GDclj5ofokWjzoa5jAwMkxCykd6,15,32,16,14,7,0,9,0,78,11.142857142857142,3,0.0,6,16,13,7,26,0,1,9,0,42,36,0
1077,12590,g8m22R7W0Wo8v9RXY0TMbj5qf5RFgvht,A3fsA9Zfv1X2fVEQhTw51lKENdNrEqT3,4,4,2,0,0,0,6,0,12,1.7142857142857142,2,0.0,0,2,0,0,4,0,0,6,0,2,10,1
1078,12592,VwUXTBGJaTv5xN1He6TwE1OKxII3IUB4,A3fsA9Zfv1X2fVEQhTw51lKENdNrEqT3,17,13,9,0,5,2,16,2,47,6.714285714285714,2,0.0,1,9,0,5,12,2,0,16,2,15,32,1
1079,12598,0MgLdwlRWQ7TpUbl7lDTcNpvvpvRxwZk,SpATywNh6bZuzm8s1ceuBUnMUAeoAHHw,12,9,6,2,4,0,3,0,24,3.4285714285714284,2,0.0,1,6,2,4,8,0,0,3,0,13,11,1
1080,12602,8g5cBj0Gjzli28QiIdgpvFAz2836fyoV,A3fsA9Zfv1X2fVEQhTw51lKENdNrEqT3,6,3,2,0,1,0,2,0,8,1.1428571428571428,1,0.0,0,2,0,1,3,0,0,2,0,3,5,1
1081,12628,JaYbgvhgx43SysY9J8DaCR3IcdUzCcUf,SpATywNh6bZuzm8s1ceuBUnMUAeoAHHw,8,9,0,0,0,0,2,0,11,1.5714285714285714,2,0.0,0,0,0,0,9,0,0,2,0,0,11,0
1082,12643,8DlfU1bgriTJuUO8vI8x268Lnn7yRdfp,bWdj2GDclj5ofokWjzoa5jAwMkxCykd6,5,2,1,0,1,3,4,0,11,1.5714285714285714,2,0.0,0,1,0,1,2,3,0,4,0,2,9,1
1083,12665,2DNSh2UatQFpodq67CmKbjqpA6AJb7Oi,SpATywNh6bZuzm8s1ceuBUnMUAeoAHHw,16,14,6,8,4,0,2,0,34,4.857142857142857,1,0.0,6,6,8,4,8,0,0,2,0,24,10,0
1084,12671,UcbTdkZF8IIJuBiyaeVa5dJ5AMKloTWJ,A3fsA9Zfv1X2fVEQhTw51lKENdNrEqT3,1,0,0,0,0,0,1,0,1,0.14285714285714285,1,0.0,0,0,0,0,0,0,0,1,0,0,1,1
1085,12676,NGkJealfvLzyvMkO29aSPohtdMh2i3ow,SpATywNh6bZuzm8s1ceuBUnMUAeoAHHw,18,21,13,6,7,1,2,0,50,7.142857142857143,2,0.0,6,13,6,7,15,1,0,2,0,32,18,1
1086,12678,v8Csqzh937f2Vg9ZqHM3p8LLheZjBof3,SpATywNh6bZuzm8s1ceuBUnMUAeoAHHw,13,15,2,0,1,0,2,0,20,2.857142857142857,1,0.0,3,2,0,1,12,0,0,2,0,6,14,0
1087,12691,nUlI6cjptTLAgli6MFzyKD61AHPa0Ow2,SpATywNh6bZuzm8s1ceuBUnMUAeoAHHw,7,4,3,0,2,0,1,0,10,1.4285714285714286,1,0.0,0,3,0,2,4,0,0,1,0,5,5,1
1088,12694,EelXsFqmLbbOgu7NMVlCz136fL2FTkZO,G8EPVSXsOYB5YQWZGiz1aVq5Pgr2GrQu,9,16,9,0,5,0,3,0,33,4.714285714285714,3,0.0,0,9,0,5,16,0,0,3,0,14,19,1
1089,12702,piMSzq394zCurmILy54TdIfNK5vFDgeH,SpATywNh6bZuzm8s1ceuBUnMUAeoAHHw,8,6,3,0,0,1,7,1,18,2.5714285714285716,1,0.0,0,3,0,0,6,1,0,7,1,3,15,1
1090,12717,pXqbqKhLN9u2vMm4aIB5JwL5PRPhZDCp,A3fsA9Zfv1X2fVEQhTw51lKENdNrEqT3,2,0,0,0,0,0,2,0,2,0.2857142857142857,1,0.0,0,0,0,0,0,0,0,2,0,0,2,0
1091,12725,yXkO3eR7yt6I5YPt7SbP4lJC7f4DWsPi,SpATywNh6bZuzm8s1ceuBUnMUAeoAHHw,12,23,4,0,2,0,4,0,33,4.714285714285714,2,0.0,0,4,0,2,23,0,0,4,0,6,27,0
1092,12741,yFLanYq8p4sf6NFSB1Td9ag6632plY4t,A3fsA9Zfv1X2fVEQhTw51lKENdNrEqT3,5,7,5,0,2,0,3,0,17,2.4285714285714284,2,0.0,0,5,0,2,7,0,0,3,0,7,10,0
1093,12743,qWbrTjg87QoJMjqclpcgpkGIkTTfGYPg,SpATywNh6bZuzm8s1ceuBUnMUAeoAHHw,1,0,0,0,0,0,1,0,1,0.14285714285714285,1,0.0,0,0,0,0,0,0,0,1,0,0,1,1
1094,12762,u82lBhpDxJIwlZISEntCxj1zgVFdW0vT,A3fsA9Zfv1X2fVEQhTw51lKENdNrEqT3,1,0,0,0,0,0,2,0,2,0.2857142857142857,1,0.0,0,0,0,0,0,0,0,2,0,0,2,1
1095,12781,xI2qMeJnp6aq2CKhFmXJQYegY0eBgJqh,SpATywNh6bZuzm8s1ceuBUnMUAeoAHHw,10,33,9,1,3,0,3,0,49,7.0,4,0.0,17,9,1,3,16,0,0,3,0,30,19,0
1096,12786,rZSLmwiYX8trzeLsBLeg8r0IN1GBbqOC,RXDvfPUBYFlVdlueBFbLW0mhhAyGEqpt,1,0,0,0,0,0,1,0,1,0.14285714285714285,1,0.0,0,0,0,0,0,0,0,1,0,0,1,1
1097,12788,rZSLmwiYX8trzeLsBLeg8r0IN1GBbqOC,A3fsA9Zfv1X2fVEQhTw51lKENdNrEqT3,50,20,11,104,3,0,14,0,152,21.714285714285715,3,0.0,3,11,92,3,17,0,12,14,0,109,43,0
1098,12797,0r0opwFyJ4N25MV6ZjVs69MBQP4LTfaz,RXDvfPUBYFlVdlueBFbLW0mhhAyGEqpt,1,0,0,0,0,0,1,0,1,0.14285714285714285,1,0.0,0,0,0,0,0,0,0,1,0,0,1,0
1099,12798,SZOXOmDilP1KR3OJXHpIlLf61tEoqX1S,SpATywNh6bZuzm8s1ceuBUnMUAeoAHHw,12,20,0,17,0,2,1,0,40,5.714285714285714,1,0.0,8,0,15,0,12,2,2,1,0,23,17,1
1100,12801,N5iDERl36Pe29yDG8gDe9a99dYgqwB7y,bWdj2GDclj5ofokWjzoa5jAwMkxCykd6,12,4,3,32,0,0,2,0,41,5.857142857142857,1,0.0,0,3,25,0,4,0,7,2,0,28,13,1
1101,12802,n2H1RsIyXGWShdCbCzwLRVNV0gBoMcRI,bWdj2GDclj5ofokWjzoa5jAwMkxCykd6,2,0,0,0,0,0,4,0,4,0.5714285714285714,2,0.0,0,0,0,0,0,0,0,4,0,0,4,1
1102,12803,P0uW8e7uWJsgVO5MWg1krlEvXljM181Y,A3fsA9Zfv1X2fVEQhTw51lKENdNrEqT3,2,0,0,0,0,0,2,0,2,0.2857142857142857,1,0.0,0,0,0,0,0,0,0,2,0,0,2,1
1103,12817,n2H1RsIyXGWShdCbCzwLRVNV0gBoMcRI,A3fsA9Zfv1X2fVEQhTw51lKENdNrEqT3,2,0,0,0,0,0,3,0,3,0.42857142857142855,2,0.0,0,0,0,0,0,0,0,3,0,0,3,1
1104,12830,L0KQTTHes3X5LPSdqQrdBMVgea19D6tJ,SpATywNh6bZuzm8s1ceuBUnMUAeoAHHw,26,50,26,14,11,0,7,0,108,15.428571428571429,5,0.0,7,26,14,11,43,0,0,7,0,58,50,1
1105,12838,D1VQybdJv05b8bnQWlTwVLnxuzPr9TGg,SpATywNh6bZuzm8s1ceuBUnMUAeoAHHw,17,17,8,19,4,0,1,0,49,7.0,1,0.0,6,8,16,4,11,0,3,1,0,34,15,0
1106,12850,cVHCYdG6eoXKQe55dLZbvLgwBGbWam7p,SpATywNh6bZuzm8s1ceuBUnMUAeoAHHw,10,12,0,0,0,1,15,1,29,4.142857142857143,2,0.0,2,0,0,0,10,1,0,15,1,2,27,1
1107,12861,clcszcRJ03jiyZ5GYQyVZZ7N7YqBvRWN,G8EPVSXsOYB5YQWZGiz1aVq5Pgr2GrQu,8,12,9,0,5,1,3,0,30,4.285714285714286,1,0.0,0,9,0,5,12,1,0,3,0,14,16,1
1108,12876,birimXAhV5T8auACU6PoAgdoddyc5gxF,SpATywNh6bZuzm8s1ceuBUnMUAeoAHHw,20,16,8,16,4,6,5,1,56,8.0,1,0.0,6,8,15,4,10,6,1,5,1,33,23,1
1109,12878,nxXaLxK1WzKt8vz8gfQ7mw2jj0DmsYuz,SpATywNh6bZuzm8s1ceuBUnMUAeoAHHw,15,19,0,16,0,1,17,2,55,7.857142857142857,4,0.0,4,0,13,0,15,1,3,17,2,17,38,0
1110,12886,jitS86VYMmQkiBJMhbTP5ghyPiIbWGe4,SpATywNh6bZuzm8s1ceuBUnMUAeoAHHw,7,13,1,0,0,4,3,1,22,3.142857142857143,1,0.0,2,1,0,0,11,4,0,3,1,3,19,1
1111,12898,P0uW8e7uWJsgVO5MWg1krlEvXljM181Y,RXDvfPUBYFlVdlueBFbLW0mhhAyGEqpt,2,0,0,0,0,0,2,0,2,0.2857142857142857,1,0.0,0,0,0,0,0,0,0,2,0,0,2,1
1112,12911,qAfzRWdcV29MrGV4Q3OpnDw6sMEqxrsX,SpATywNh6bZuzm8s1ceuBUnMUAeoAHHw,6,4,0,0,0,0,3,0,7,1.0,1,0.0,0,0,0,0,4,0,0,3,0,0,7,1
1113,12919,UaSh8dwx8gnofYbXlmpqj9uYDbpJ89pX,SpATywNh6bZuzm8s1ceuBUnMUAeoAHHw,8,12,1,0,0,66,10,0,89,12.714285714285714,2,0.0,2,1,0,0,10,66,0,10,0,3,86,0
1114,12920,C7qRsA5jr1OEmJhfxUyc4ekgHn4q4XXi,SpATywNh6bZuzm8s1ceuBUnMUAeoAHHw,4,23,2,0,0,0,3,0,28,4.0,3,0.0,0,2,0,0,23,0,0,3,0,2,26,1
1115,12922,uqIn0vdfJ1SDJCOeCVEAQPRFBBKQA2eB,A3fsA9Zfv1X2fVEQhTw51lKENdNrEqT3,29,15,8,62,3,0,4,0,92,13.142857142857142,3,0.0,1,8,57,3,14,0,5,4,0,69,23,1
1116,12939,BZIh5Ji4WRsl5XFn0vcayrSAt3EwPPq7,SpATywNh6bZuzm8s1ceuBUnMUAeoAHHw,25,39,1,33,1,1,13,2,90,12.857142857142858,3,0.0,14,1,28,1,25,1,5,13,2,44,46,0
1117,12941,agXxlcmOoEfRNuHGmntEOJrJqSCOihJk,SpATywNh6bZuzm8s1ceuBUnMUAeoAHHw,10,13,0,4,0,0,2,0,19,2.7142857142857144,2,0.0,3,0,4,0,10,0,0,2,0,7,12,1
1118,12960,QxcB9RiJu5tiHZOch1DPGex1fIsAotsI,SpATywNh6bZuzm8s1ceuBUnMUAeoAHHw,16,29,3,9,2,5,8,0,56,8.0,4,0.0,8,3,9,2,21,5,0,8,0,22,34,0
1119,12970,GR6VeteR9GEbfhgsQCuQ7IOGLVIdLf6Q,SpATywNh6bZuzm8s1ceuBUnMUAeoAHHw,10,20,1,2,0,0,4,0,27,3.857142857142857,3,0.0,1,1,2,0,19,0,0,4,0,4,23,0
1120,12973,7fFZLbLMI7Ucj1mdrBxpY9hCEcczhOLF,RXDvfPUBYFlVdlueBFbLW0mhhAyGEqpt,18,23,4,28,0,2,4,0,61,8.714285714285714,4,0.0,6,4,28,0,17,2,0,4,0,38,23,0
1121,12987,d1JMD7qxfNKpLgzBvlpfaUYeKyTI6qbc,RXDvfPUBYFlVdlueBFbLW0mhhAyGEqpt,11,6,4,0,3,0,3,0,16,2.2857142857142856,1,0.0,0,4,0,3,6,0,0,3,0,7,9,0
1122,12998,MM2B2653YFHORo361rzambfOSuqgdvxU,SpATywNh6bZuzm8s1ceuBUnMUAeoAHHw,15,20,11,6,3,0,4,0,44,6.285714285714286,3,0.0,4,11,6,3,16,0,0,4,0,24,20,1
1123,13002,qBuOYvjWXxAt6x3Clq0Mm94iVtXMfRzl,A3fsA9Zfv1X2fVEQhTw51lKENdNrEqT3,38,15,12,60,11,2,5,1,106,15.142857142857142,1,0.0,2,12,49,11,13,2,11,5,1,74,32,1
1124,13021,rXHS1nVaWODpE4oMoF8GV1PH34kuNjhN,A3fsA9Zfv1X2fVEQhTw51lKENdNrEqT3,50,34,23,68,13,6,14,0,158,22.571428571428573,3,0.0,3,23,63,13,31,6,5,14,0,102,56,1
1125,13024,gdBVlnD2M7V6ljn8vJvT9NnajpxXqL1v,SpATywNh6bZuzm8s1ceuBUnMUAeoAHHw,28,35,14,18,9,1,6,0,83,11.857142857142858,3,0.0,14,14,15,9,21,1,3,6,0,52,31,1
1126,13026,nE3rPlTTHJqOdfeqGlvnz4cddsiodod7,SpATywNh6bZuzm8s1ceuBUnMUAeoAHHw,4,2,0,0,0,0,2,0,4,0.5714285714285714,1,0.0,0,0,0,0,2,0,0,2,0,0,4,0
1127,13038,Ys5FH0nq7NeLEdwGoDUOp7Sz8iAMAB3d,SpATywNh6bZuzm8s1ceuBUnMUAeoAHHw,18,76,22,5,5,0,10,0,118,16.857142857142858,3,0.0,5,22,4,5,71,0,1,10,0,36,82,1
1128,13049,8nRie7othcdG0O4zmQQo2Wo4gx8ixPWA,SpATywNh6bZuzm8s1ceuBUnMUAeoAHHw,8,3,0,0,0,1,6,1,11,1.5714285714285714,1,0.0,0,0,0,0,3,1,0,6,1,0,11,1
1129,13064,FH8uaUgDtH5I6cjMpNACS7MT4OVRdm6l,SpATywNh6bZuzm8s1ceuBUnMUAeoAHHw,14,12,2,18,1,0,3,0,36,5.142857142857143,2,0.0,3,2,15,1,9,0,3,3,0,21,15,0
1130,13068,Oewk1cgUhxDAPgxI9Y8opSnbFrQ56lFp,G8EPVSXsOYB5YQWZGiz1aVq5Pgr2GrQu,4,2,1,0,0,0,3,0,6,0.8571428571428571,1,0.0,0,1,0,0,2,0,0,3,0,1,5,0
1131,13079,UnqeeEn98S2A9CknpatcyHPMxgZC4vhi,bWdj2GDclj5ofokWjzoa5jAwMkxCykd6,12,17,10,56,0,2,9,0,94,13.428571428571429,2,0.0,4,10,53,0,13,2,3,9,0,67,27,1
1132,13084,iKiK6wMQ7FsUhBHmZmA4WSvuLlgoIAIT,SpATywNh6bZuzm8s1ceuBUnMUAeoAHHw,17,14,8,6,4,0,2,0,34,4.857142857142857,1,0.0,4,8,6,4,10,0,0,2,0,22,12,1
1133,13087,JuiV77lwSiyunloCdIxpEqZLnyAIWuGF,SpATywNh6bZuzm8s1ceuBUnMUAeoAHHw,15,38,2,13,1,6,7,0,67,9.571428571428571,2,0.0,13,2,11,1,25,6,2,7,0,27,40,1
1134,13093,X0UQZEMetzdnutZa926McNof6mCEs6hL,bWdj2GDclj5ofokWjzoa5jAwMkxCykd6,19,13,2,220,4,12,8,1,260,37.142857142857146,3,0.0,3,2,214,4,10,12,6,8,1,223,37,0
1135,13096,WkW7xhOBov4cdi1HI8MIcYy2tcL8JIqM,G8EPVSXsOYB5YQWZGiz1aVq5Pgr2GrQu,5,2,2,0,1,0,5,0,10,1.4285714285714286,2,0.0,0,2,0,1,2,0,0,5,0,3,7,0
1136,13097,jSElHDudYQXAurrUrZvr8PEvqza2483p,SpATywNh6bZuzm8s1ceuBUnMUAeoAHHw,3,4,0,0,0,0,3,0,7,1.0,1,0.0,0,0,0,0,4,0,0,3,0,0,7,0
1137,13118,VSdgqyGl0eURAhfgbcwFZu4zgDm6da40,A3fsA9Zfv1X2fVEQhTw51lKENdNrEqT3,7,8,0,0,0,0,7,0,15,2.142857142857143,1,0.0,0,0,0,0,8,0,0,7,0,0,15,1
1138,13123,DER7joh3KQKE4dEofQirnM23uWHXKmaD,SpATywNh6bZuzm8s1ceuBUnMUAeoAHHw,2,0,0,0,0,0,2,0,2,0.2857142857142857,1,0.0,0,0,0,0,0,0,0,2,0,0,2,1
1139,13126,zEeuqWNlBTdOCPxX0tLPUzZrt62Jaced,SpATywNh6bZuzm8s1ceuBUnMUAeoAHHw,19,32,2,19,2,0,10,0,65,9.285714285714286,1,0.0,14,2,17,2,18,0,2,10,0,35,30,1
1140,13150,5LHFGZp52JmCecbZlM5IR7cocsBDm2vK,A3fsA9Zfv1X2fVEQhTw51lKENdNrEqT3,1,0,0,0,0,0,2,0,2,0.2857142857142857,1,0.0,0,0,0,0,0,0,0,2,0,0,2,1
1141,13160,i9EYjpibuPRn90FUwaEumbd5PTkZZAqq,SpATywNh6bZuzm8s1ceuBUnMUAeoAHHw,1,0,0,0,0,0,1,0,1,0.14285714285714285,1,0.0,0,0,0,0,0,0,0,1,0,0,1,1
1142,13162,PLNAK5eO2jDldFb2P1VVgW3GLNYSW1XE,A3fsA9Zfv1X2fVEQhTw51lKENdNrEqT3,58,25,1,128,0,20,10,1,185,26.428571428571427,3,0.0,3,1,112,0,22,20,16,10,1,116,69,1
1143,13167,c1zDCPDnvv0eep80ND9h9tNicqqWeY8x,SpATywNh6bZuzm8s1ceuBUnMUAeoAHHw,4,2,1,0,1,0,1,0,5,0.7142857142857143,1,0.0,0,1,0,1,2,0,0,1,0,2,3,1
1144,13169,VD51DafWdYqPb9OUf4DGqW0cSE2mdG9x,RXDvfPUBYFlVdlueBFbLW0mhhAyGEqpt,44,42,25,75,12,14,12,0,180,25.714285714285715,4,0.0,12,25,70,12,30,14,5,12,0,119,61,0
1145,13171,Xz4KwNrqILWO256erDoEJKlZ22fLi17K,bWdj2GDclj5ofokWjzoa5jAwMkxCykd6,4,3,0,0,0,0,2,0,5,0.7142857142857143,1,0.0,0,0,0,0,3,0,0,2,0,0,5,1
1146,13182,Gur5FuhE9EyV9K1F0qLPk7AenhoY8PBS,A3fsA9Zfv1X2fVEQhTw51lKENdNrEqT3,9,9,0,0,0,0,7,0,16,2.2857142857142856,2,0.0,0,0,0,0,9,0,0,7,0,0,16,0
1147,13202,Oyq7ji1m15xuxwPKjm7Gg05YiNCQEcyW,A3fsA9Zfv1X2fVEQhTw51lKENdNrEqT3,4,2,1,0,1,0,1,0,5,0.7142857142857143,1,0.0,0,1,0,1,2,0,0,1,0,2,3,1
1148,13205,t0soD7aQ6w7DGyhmXz7wyAfUbtBWT4NA,SpATywNh6bZuzm8s1ceuBUnMUAeoAHHw,6,7,2,0,1,0,3,1,14,2.0,1,0.0,4,2,0,1,3,0,0,3,1,7,7,1
1149,13213,fvcf8Mss4D9M5Dkk5Dn5T9NiTapwZ9dB,A3fsA9Zfv1X2fVEQhTw51lKENdNrEqT3,33,11,6,80,5,0,6,0,108,15.428571428571429,1,0.0,4,6,65,5,7,0,15,6,0,80,28,1
1150,13215,YKsQbxqCbn9zYlM8hXkeyvve9j97h5Fs,SpATywNh6bZuzm8s1ceuBUnMUAeoAHHw,5,2,1,0,1,0,2,0,6,0.8571428571428571,1,0.0,0,1,0,1,2,0,0,2,0,2,4,1
1151,13231,CGCo1ulRSzYrFke9WXpheptgBfQxf2gK,SpATywNh6bZuzm8s1ceuBUnMUAeoAHHw,5,3,2,0,1,0,1,0,7,1.0,1,0.0,0,2,0,1,3,0,0,1,0,3,4,0
1152,13243,D3y4ChHgB3o0JcWw3QbeyrPnD6ZSD4me,SpATywNh6bZuzm8s1ceuBUnMUAeoAHHw,4,0,0,0,0,8,4,1,13,1.8571428571428572,1,0.0,0,0,0,0,0,8,0,4,1,0,13,1
1153,13268,eAArxLyCThtu9N3Mv8rQculKbGSa66j9,G8EPVSXsOYB5YQWZGiz1aVq5Pgr2GrQu,109,96,34,297,22,26,20,0,495,70.71428571428571,2,0.0,60,34,214,22,36,26,83,20,0,330,165,0
1154,13270,ffLXxfgMU4yir9uI5fIkKo2iZzEw2Lpz,SpATywNh6bZuzm8s1ceuBUnMUAeoAHHw,16,12,9,0,5,4,6,0,36,5.142857142857143,3,0.0,0,9,0,5,12,4,0,6,0,14,22,1
1155,13278,XwU61hOxlE8cqDut2rPIgRseTsxZ07jG,SpATywNh6bZuzm8s1ceuBUnMUAeoAHHw,24,81,12,40,1,8,9,0,151,21.571428571428573,3,0.0,58,12,36,1,23,8,4,9,0,107,44,0
1156,13284,HmCqvdVQxacevQymd3KKpvfG444InuCU,RXDvfPUBYFlVdlueBFbLW0mhhAyGEqpt,25,25,18,62,0,0,1,0,106,15.142857142857142,1,0.0,6,18,61,0,19,0,1,1,0,85,21,0
1157,13294,kI6cheDOBy9s4ZYk6wZ8CKNoQdId12d9,SpATywNh6bZuzm8s1ceuBUnMUAeoAHHw,11,8,4,0,2,2,12,5,33,4.714285714285714,1,0.0,0,4,0,2,8,2,0,12,5,6,27,1
1158,13297,0b8UUNX7vDapSg0uCVOk0glpsbuPbDat,SpATywNh6bZuzm8s1ceuBUnMUAeoAHHw,20,33,15,18,7,18,8,1,100,14.285714285714286,5,0.0,10,15,15,7,23,18,3,8,1,47,53,0
1159,13305,QIQR6VwK3cpUKM5lDzadEKeQATM23w8z,RXDvfPUBYFlVdlueBFbLW0mhhAyGEqpt,1,0,0,0,0,0,1,0,1,0.14285714285714285,1,0.0,0,0,0,0,0,0,0,1,0,0,1,1
1160,13309,1dxQmK9WwlHWuIG7ZTn4PsJ2vflQBDH3,A3fsA9Zfv1X2fVEQhTw51lKENdNrEqT3,13,8,2,16,1,0,4,0,31,4.428571428571429,2,0.0,0,2,12,1,8,0,4,4,0,15,16,0
1161,13312,9aWGLeAVHncegHPXAP1qMMyzvcIDPZKu,A3fsA9Zfv1X2fVEQhTw51lKENdNrEqT3,42,24,20,164,0,6,12,1,227,32.42857142857143,2,0.0,1,20,132,0,23,6,32,12,1,153,74,1
1162,13318,Xzt2w1aRoJeIAP02oHWxu8IVeFzxqDvF,SpATywNh6bZuzm8s1ceuBUnMUAeoAHHw,30,93,29,49,22,9,17,3,222,31.714285714285715,3,0.0,16,29,40,22,77,9,9,17,3,107,115,0
1163,13324,NuZwpz0U4SxzLHddLsrKCkHdkj5yyqPt,A3fsA9Zfv1X2fVEQhTw51lKENdNrEqT3,21,25,2,22,0,0,6,1,56,8.0,2,0.0,2,2,19,0,23,0,3,6,1,23,33,1
1164,13327,M3xTB6LenTJvMpybZKparVtRZKzrRM1R,SpATywNh6bZuzm8s1ceuBUnMUAeoAHHw,28,78,32,20,8,108,39,3,288,41.142857142857146,3,0.0,21,32,19,8,57,108,1,39,3,80,208,0
1165,13335,BuvcW1QbEkmICBwJsmVk62irFMyFXFIl,SpATywNh6bZuzm8s1ceuBUnMUAeoAHHw,6,4,2,0,1,0,2,0,9,1.2857142857142858,1,0.0,0,2,0,1,4,0,0,2,0,3,6,0
1166,13350,ooqIS0ldRRRaqJrrOHVscbkigkM4wbN5,SpATywNh6bZuzm8s1ceuBUnMUAeoAHHw,15,17,14,0,10,0,5,0,46,6.571428571428571,3,0.0,0,14,0,10,17,0,0,5,0,24,22,0
1167,13353,Aw7PeIkLW9CDHbPpPSjrFUdtBaUuHUXm,A3fsA9Zfv1X2fVEQhTw51lKENdNrEqT3,30,12,9,68,4,2,15,0,110,15.714285714285714,3,0.0,2,9,57,4,10,2,11,15,0,72,38,0
1168,13357,sFfdfS73lXtMTUaBLpEd17ZzknvXcxlF,G8EPVSXsOYB5YQWZGiz1aVq5Pgr2GrQu,5,3,1,0,1,0,2,0,7,1.0,1,0.0,0,1,0,1,3,0,0,2,0,2,5,1
1169,13389,suNtRVoL26o1uoSjCtTBYoEROkIKHNRV,SpATywNh6bZuzm8s1ceuBUnMUAeoAHHw,13,14,1,6,0,10,3,0,34,4.857142857142857,1,0.0,4,1,6,0,10,10,0,3,0,11,23,0
1170,13392,Zp81uMflvqqrfEwxhUzFhFbNFp63e2qq,SpATywNh6bZuzm8s1ceuBUnMUAeoAHHw,14,39,2,18,1,0,6,0,66,9.428571428571429,2,0.0,5,2,15,1,34,0,3,6,0,23,43,0
1171,13395,eq0kQUYo3qpAoZ9JUGvTejR7TbE9dl0n,A3fsA9Zfv1X2fVEQhTw51lKENdNrEqT3,1,0,0,0,0,0,2,0,2,0.2857142857142857,1,0.0,0,0,0,0,0,0,0,2,0,0,2,1
1172,13417,P6cCvRjvbpDjgLjSjFoCoaUi3J3jrMaV,bWdj2GDclj5ofokWjzoa5jAwMkxCykd6,11,12,0,26,1,0,4,0,43,6.142857142857143,2,0.0,6,0,23,1,6,0,3,4,0,30,13,1
1173,13419,zFUDj5TvEjIvvTLimj5EmmmOcToptA99,bWdj2GDclj5ofokWjzoa5jAwMkxCykd6,5,2,1,0,1,0,2,0,6,0.8571428571428571,1,0.0,0,1,0,1,2,0,0,2,0,2,4,1
1174,13426,PfZH4Yubwsve9DvShzAvHjayDN16nhpN,RXDvfPUBYFlVdlueBFbLW0mhhAyGEqpt,2,0,0,0,0,0,2,0,2,0.2857142857142857,1,0.0,0,0,0,0,0,0,0,2,0,0,2,1
1175,13434,xzjKh0on5UQxslbqX3WgWTiQPFL3pvFu,A3fsA9Zfv1X2fVEQhTw51lKENdNrEqT3,9,7,5,0,3,0,3,0,18,2.5714285714285716,2,0.0,0,5,0,3,7,0,0,3,0,8,10,1
1176,13436,0wXXwNeE6W7NBvQ3k3OMvVCCQezsKKgg,SpATywNh6bZuzm8s1ceuBUnMUAeoAHHw,24,43,19,22,14,0,3,0,101,14.428571428571429,2,0.0,6,19,19,14,37,0,3,3,0,58,43,1
1177,13442,Q459I6WtHQ4LYscZN5C0n5NrNaEwzARk,A3fsA9Zfv1X2fVEQhTw51lKENdNrEqT3,1,0,0,0,0,0,1,0,1,0.14285714285714285,1,0.0,0,0,0,0,0,0,0,1,0,0,1,0
1178,13466,G9zssYsMiy0OM7PcLiakkEdvgznZi21h,bWdj2GDclj5ofokWjzoa5jAwMkxCykd6,10,7,4,22,2,0,2,0,37,5.285714285714286,2,0.0,1,4,18,2,6,0,4,2,0,25,12,1
1179,13468,LSqC7qdkRAhbSsajNxT5pt4NlUyn2gsl,SpATywNh6bZuzm8s1ceuBUnMUAeoAHHw,6,5,4,0,4,0,1,0,14,2.0,1,0.0,0,4,0,4,5,0,0,1,0,8,6,1
1180,13488,3szdu9Q6Oikq1zf8fBs2hQUGk7dqskOy,SpATywNh6bZuzm8s1ceuBUnMUAeoAHHw,13,11,2,14,2,0,4,0,33,4.714285714285714,1,0.0,3,2,13,2,8,0,1,4,0,20,13,1
1181,13502,Zdseq1rQmkAi5wZl57d3RwjzOxlL3B5I,A3fsA9Zfv1X2fVEQhTw51lKENdNrEqT3,10,12,6,0,0,0,8,1,27,3.857142857142857,3,0.0,0,6,0,0,12,0,0,8,1,6,21,0
1182,13503,2YfvPW4RjjB1wuYNlMfzfMUdSCE4Rwzu,SpATywNh6bZuzm8s1ceuBUnMUAeoAHHw,5,2,0,0,0,8,3,1,14,2.0,1,0.0,0,0,0,0,2,8,0,3,1,0,14,0
1183,13513,OsjipUObm67JsyJjOy7xHoa32L8CSYg5,RXDvfPUBYFlVdlueBFbLW0mhhAyGEqpt,7,5,1,0,1,0,2,0,9,1.2857142857142858,1,0.0,0,1,0,1,5,0,0,2,0,2,7,0
1184,13514,XDXCn0FDh32qCzKi52Qo5wbWma8m1QWg,SpATywNh6bZuzm8s1ceuBUnMUAeoAHHw,2,0,0,0,0,0,2,0,2,0.2857142857142857,1,0.0,0,0,0,0,0,0,0,2,0,0,2,1
1185,13529,Ge8ZKyoh7v3U8XFFvvntz8tE5dDD1txz,SpATywNh6bZuzm8s1ceuBUnMUAeoAHHw,4,4,3,0,0,0,2,0,9,1.2857142857142858,1,0.0,0,3,0,0,4,0,0,2,0,3,6,1
1186,13538,LjMEB9aIUIvEfq4JTf4C9ef9fHbbyj0M,SpATywNh6bZuzm8s1ceuBUnMUAeoAHHw,20,35,15,21,8,8,8,0,95,13.571428571428571,4,0.0,15,15,18,8,20,8,3,8,0,56,39,0
1187,13539,UCcQjKn5wSzQ8Z7Gu1uECZPrSwuRD4I9,SpATywNh6bZuzm8s1ceuBUnMUAeoAHHw,4,3,1,0,1,0,3,0,8,1.1428571428571428,1,0.0,0,1,0,1,3,0,0,3,0,2,6,1
1188,13541,dQ6ARJIxCHLlztvK37NHQ0C1ttipx0zg,SpATywNh6bZuzm8s1ceuBUnMUAeoAHHw,5,3,2,0,1,0,1,0,7,1.0,1,0.0,0,2,0,1,3,0,0,1,0,3,4,0
1189,13561,i6CSuJ6asUrdPRp5edOkSDBKGwbyCy2y,bWdj2GDclj5ofokWjzoa5jAwMkxCykd6,3,0,0,0,0,1,4,0,5,0.7142857142857143,1,0.0,0,0,0,0,0,1,0,4,0,0,5,1
1190,13562,Du4OhdznDw29gaWDeHXBUWRKyEVAbHaQ,SpATywNh6bZuzm8s1ceuBUnMUAeoAHHw,19,26,12,12,4,0,11,0,65,9.285714285714286,3,0.0,10,12,9,4,16,0,3,11,0,35,30,0
1191,13568,r0yAsNzYkqEPYi6zNhQfzuueDjmcyFRr,G8EPVSXsOYB5YQWZGiz1aVq5Pgr2GrQu,85,80,52,142,19,0,14,1,308,44.0,2,0.0,25,52,115,19,55,0,27,14,1,211,97,1
1192,13571,QFQlbn421RXpUzVVaKhkxpBlvQfTJy18,SpATywNh6bZuzm8s1ceuBUnMUAeoAHHw,29,48,23,40,9,0,10,0,130,18.571428571428573,4,0.0,19,23,34,9,29,0,6,10,0,85,45,0
1193,13574,BOWTvQlkFu3OONGPj2orMpzJbZOzBXuG,SpATywNh6bZuzm8s1ceuBUnMUAeoAHHw,14,17,1,18,0,0,6,0,42,6.0,2,0.0,4,1,15,0,13,0,3,6,0,20,22,0
1194,13577,r9n2Z7iYkL5tKegLJwMIOxTHQqxopYp0,SpATywNh6bZuzm8s1ceuBUnMUAeoAHHw,10,8,5,0,3,0,2,0,18,2.5714285714285716,3,0.0,0,5,0,3,8,0,0,2,0,8,10,1
1195,13591,thD3JQHh1xpY9SdL9w6TAUhWjJrPsSHi,SpATywNh6bZuzm8s1ceuBUnMUAeoAHHw,18,42,15,21,6,7,13,1,105,15.0,2,0.0,19,15,18,6,23,7,3,13,1,58,47,0
1196,13596,SuKlsA6xoxq9JGrANP30LMW7qjrc07fy,bWdj2GDclj5ofokWjzoa5jAwMkxCykd6,10,8,5,6,1,0,1,0,21,3.0,1,0.0,2,5,5,1,6,0,1,1,0,13,8,1
1197,13603,2YfvPW4RjjB1wuYNlMfzfMUdSCE4Rwzu,RXDvfPUBYFlVdlueBFbLW0mhhAyGEqpt,5,7,0,0,0,6,3,0,16,2.2857142857142856,1,0.0,0,0,0,0,7,6,0,3,0,0,16,0
1198,13611,taXwAmoyCNDGaXo8nVRGsDZwnk4if3bF,SpATywNh6bZuzm8s1ceuBUnMUAeoAHHw,14,34,7,8,0,0,4,0,53,7.571428571428571,2,0.0,16,7,7,0,18,0,1,4,0,30,23,0
1199,13615,SFczaSY6Hc3uft6fwzUwvxTQx8AOyArS,G8EPVSXsOYB5YQWZGiz1aVq5Pgr2GrQu,14,46,1,18,8,5,7,1,86,12.285714285714286,1,0.0,30,1,13,8,16,5,5,7,1,52,34,1
1200,13617,q1nSg7gMR4fmcENPvRW7b84TFAk5YaYv,SpATywNh6bZuzm8s1ceuBUnMUAeoAHHw,25,70,1,27,1,17,21,2,139,19.857142857142858,4,0.0,20,1,23,1,50,17,4,21,2,45,94,1
1201,13619,q1nSg7gMR4fmcENPvRW7b84TFAk5YaYv,bWdj2GDclj5ofokWjzoa5jAwMkxCykd6,1,0,0,0,0,0,1,0,1,0.14285714285714285,1,0.0,0,0,0,0,0,0,0,1,0,0,1,1
1202,13625,Df1QcOycdzVWQv3hsgRFSNdSZglUPcB7,SpATywNh6bZuzm8s1ceuBUnMUAeoAHHw,1,0,0,0,0,0,2,0,2,0.2857142857142857,1,0.0,0,0,0,0,0,0,0,2,0,0,2,1
1203,13627,Df1QcOycdzVWQv3hsgRFSNdSZglUPcB7,G8EPVSXsOYB5YQWZGiz1aVq5Pgr2GrQu,1,0,0,0,0,0,1,0,1,0.14285714285714285,1,0.0,0,0,0,0,0,0,0,1,0,0,1,1
1204,13635,ePpfrPKFmuYE4CHcpunEZ73b0FxyOz0q,A3fsA9Zfv1X2fVEQhTw51lKENdNrEqT3,30,13,8,52,3,0,12,0,88,12.571428571428571,2,0.0,1,8,48,3,12,0,4,12,0,60,28,1
1205,13639,6ZFGnTjh94PbXkR7sbTLWokikXbcLQlV,A3fsA9Zfv1X2fVEQhTw51lKENdNrEqT3,11,10,4,8,0,0,11,0,33,4.714285714285714,1,0.0,1,4,8,0,9,0,0,11,0,13,20,0
1206,13643,kF8fYPSPVuf77u2d6KdtH12htaNTxyrR,SpATywNh6bZuzm8s1ceuBUnMUAeoAHHw,5,3,1,0,1,0,1,0,6,0.8571428571428571,1,0.0,0,1,0,1,3,0,0,1,0,2,4,1
1207,13645,FOoOtP9CvNldG35bvwpepCilGCCL9n8O,SpATywNh6bZuzm8s1ceuBUnMUAeoAHHw,24,43,26,15,15,0,16,0,115,16.428571428571427,4,0.0,3,26,13,15,40,0,2,16,0,57,58,1
1208,13646,2gMbFqhNbghdA4J5huVDcJIix3xmMqms,SpATywNh6bZuzm8s1ceuBUnMUAeoAHHw,19,18,12,11,7,0,6,0,54,7.714285714285714,3,0.0,3,12,10,7,15,0,1,6,0,32,22,1
1209,13655,5LtufKrJgtzGXPllU5SjGTHr8eJRp7wi,SpATywNh6bZuzm8s1ceuBUnMUAeoAHHw,9,4,3,0,3,0,2,0,12,1.7142857142857142,1,0.0,0,3,0,3,4,0,0,2,0,6,6,1
1210,13658,BRb6GOIqcgYg1e6c431h8FubF4jTJim3,SpATywNh6bZuzm8s1ceuBUnMUAeoAHHw,18,21,3,14,2,0,5,0,45,6.428571428571429,2,0.0,6,3,11,2,15,0,3,5,0,22,23,1
1211,13663,oNStIislotbuK2XCCskaFe8CInb3EbrY,bWdj2GDclj5ofokWjzoa5jAwMkxCykd6,3,3,0,0,0,0,1,0,4,0.5714285714285714,1,0.0,1,0,0,0,2,0,0,1,0,1,3,1
1212,13666,Y0LHIPeN84CX2pJB37p6sblq4PhQo9k4,SpATywNh6bZuzm8s1ceuBUnMUAeoAHHw,21,25,3,30,2,0,5,0,65,9.285714285714286,3,0.0,7,3,29,2,18,0,1,5,0,41,24,1
1213,13668,ZFgJH3XPKn6EjDuXV9VLOpKftzENCqEZ,G8EPVSXsOYB5YQWZGiz1aVq5Pgr2GrQu,25,33,17,16,6,15,12,1,100,14.285714285714286,4,0.0,8,17,11,6,25,15,5,12,1,42,58,0
1214,13677,ZFgJH3XPKn6EjDuXV9VLOpKftzENCqEZ,RXDvfPUBYFlVdlueBFbLW0mhhAyGEqpt,32,46,32,27,8,20,13,0,146,20.857142857142858,3,0.0,7,32,27,8,39,20,0,13,0,74,72,0
1215,13688,1TRHxgoibI9N1jVfz15wdiz3VF8KLiZV,G8EPVSXsOYB5YQWZGiz1aVq5Pgr2GrQu,8,5,4,0,4,0,2,0,15,2.142857142857143,1,0.0,0,4,0,4,5,0,0,2,0,8,7,1
1216,13690,XkKS323fFxBVezQ5JyIgzxHDxEKEwwEf,bWdj2GDclj5ofokWjzoa5jAwMkxCykd6,10,12,4,14,3,0,2,0,35,5.0,1,0.0,4,4,14,3,8,0,0,2,0,25,10,1
1217,13692,dB9soxJVmgwXZSiR7r7fYfCigeYZx4rK,SpATywNh6bZuzm8s1ceuBUnMUAeoAHHw,8,6,4,0,3,1,3,0,17,2.4285714285714284,2,0.0,0,4,0,3,6,1,0,3,0,7,10,1
1218,13695,eosk3dY7502Pbg6Dsnx0qWKWUpRTliXK,SpATywNh6bZuzm8s1ceuBUnMUAeoAHHw,14,23,4,12,2,0,4,0,45,6.428571428571429,3,0.0,5,4,9,2,18,0,3,4,0,20,25,1
1219,13722,MFpshextOJLHhySF4C6u9eWxWZPDeRiA,SpATywNh6bZuzm8s1ceuBUnMUAeoAHHw,5,3,1,0,1,0,5,0,10,1.4285714285714286,3,0.0,1,1,0,1,2,0,0,5,0,3,7,1
1220,13725,r0yAsNzYkqEPYi6zNhQfzuueDjmcyFRr,A3fsA9Zfv1X2fVEQhTw51lKENdNrEqT3,2,0,0,0,0,0,3,0,3,0.42857142857142855,1,0.0,0,0,0,0,0,0,0,3,0,0,3,1
1221,13746,QNA44zjiZdozxT5YpeINlRZRlMKPMkhp,A3fsA9Zfv1X2fVEQhTw51lKENdNrEqT3,21,20,17,0,17,0,1,0,55,7.857142857142857,2,0.0,0,17,0,17,20,0,0,1,0,34,21,1
1222,13752,GUhU3sa7QMussHGi4kspdulqSqF9Ft42,SpATywNh6bZuzm8s1ceuBUnMUAeoAHHw,14,14,1,14,0,0,3,0,32,4.571428571428571,2,0.0,3,1,11,0,11,0,3,3,0,15,17,0
1223,13756,zx92A3etlZOmjWi19IMDYlwaWCkvF08z,SpATywNh6bZuzm8s1ceuBUnMUAeoAHHw,6,5,1,0,1,0,1,0,8,1.1428571428571428,1,0.0,0,1,0,1,5,0,0,1,0,2,6,1
1224,13765,rtYqtRTnqUXb6diSp0MKjdA0eLt2BJ3X,A3fsA9Zfv1X2fVEQhTw51lKENdNrEqT3,1,0,0,0,0,0,4,0,4,0.5714285714285714,3,0.0,0,0,0,0,0,0,0,4,0,0,4,1
1225,13770,73akjB4xSPosxH1enrEsMGxNVgbw9q8A,SpATywNh6bZuzm8s1ceuBUnMUAeoAHHw,18,32,16,6,11,2,1,0,68,9.714285714285714,2,0.0,0,16,5,11,32,2,1,1,0,32,36,1
1226,13771,I1KwJ6EdCZnEPLfC8Q7yWpIkLOHn7h02,A3fsA9Zfv1X2fVEQhTw51lKENdNrEqT3,25,37,21,46,7,0,10,0,121,17.285714285714285,4,0.0,3,21,39,7,34,0,7,10,0,70,51,1
1227,13776,PUFh3BsQaDVIJMDvwsFTqkrgAzvjO9ME,A3fsA9Zfv1X2fVEQhTw51lKENdNrEqT3,1,0,0,0,0,0,1,0,1,0.14285714285714285,1,0.0,0,0,0,0,0,0,0,1,0,0,1,0
1228,13783,LnPF2pHnhCMvVEpluujjfPcHsgc8Fmmk,bWdj2GDclj5ofokWjzoa5jAwMkxCykd6,1,0,0,0,0,0,1,0,1,0.14285714285714285,1,0.0,0,0,0,0,0,0,0,1,0,0,1,1
1229,13793,1Uc6kG05PFkTNzxuWvIFBwjY8EtNBPxQ,A3fsA9Zfv1X2fVEQhTw51lKENdNrEqT3,2,0,0,0,0,0,5,0,5,0.7142857142857143,2,0.0,0,0,0,0,0,0,0,5,0,0,5,1
1230,14546,82UlWF6Fm1gkNum7nNbVw0yOV1BUdNoS,7GRhBDsirIGkRZBtSMEzNTyDr2JQm4xx,30,69,22,48,13,21,5,0,178,25.428571428571427,3,0.0,41,22,40,13,28,21,8,5,0,116,62,1
1231,14552,gmqCuQTX0aljJXYwlMbQKWVNQXzJBU7z,7GRhBDsirIGkRZBtSMEzNTyDr2JQm4xx,11,9,6,0,2,19,16,1,53,7.571428571428571,4,0.0,0,6,0,2,9,19,0,16,1,8,45,0
1232,14609,Q9kdHcV1kbonm0KnIW9OSERwU5lfVZ8s,7GRhBDsirIGkRZBtSMEzNTyDr2JQm4xx,41,146,26,68,24,19,4,0,287,41.0,6,0.0,72,26,55,24,74,19,13,4,0,177,110,1
1233,14627,wXa3VpbKMQY5nmCqd1pDfzVK4mBWfzPA,7GRhBDsirIGkRZBtSMEzNTyDr2JQm4xx,5,3,1,0,0,6,5,1,16,2.2857142857142856,1,0.0,0,1,0,0,3,6,0,5,1,1,15,1
1234,14654,StcQZMEDAMldF4GFQUzkrPFNVNZnPaeq,7GRhBDsirIGkRZBtSMEzNTyDr2JQm4xx,16,31,13,12,13,30,4,0,103,14.714285714285714,2,0.0,15,13,9,13,16,30,3,4,0,50,53,0
1235,14715,WuM67GwQW9M3d1mnuGHuvAdo907S9qb5,7GRhBDsirIGkRZBtSMEzNTyDr2JQm4xx,1,0,0,0,0,0,1,0,1,0.14285714285714285,1,0.0,0,0,0,0,0,0,0,1,0,0,1,1
1236,14729,vfwAUxRdOnC4hT5Ba9e9XvBRXfww6oyg,7GRhBDsirIGkRZBtSMEzNTyDr2JQm4xx,12,7,5,0,2,0,8,1,23,3.2857142857142856,2,0.0,0,5,0,2,7,0,0,8,1,7,16,1
1237,14738,QqvzSns2WWHJJpRBF1DJin1UI4cHoJM0,7GRhBDsirIGkRZBtSMEzNTyDr2JQm4xx,53,95,24,78,27,3,14,1,242,34.57142857142857,3,0.0,51,24,69,27,44,3,9,14,1,171,71,1
1238,14744,fznl9GLBUcCuiLFhCkHOSxn8Xeb6YOkl,7GRhBDsirIGkRZBtSMEzNTyDr2JQm4xx,17,28,13,14,16,13,5,0,89,12.714285714285714,2,0.0,15,13,11,16,13,13,3,5,0,55,34,1
1239,14778,SxA4qsG4oQiVsK58JS1BnBCuBa1rQRmi,7GRhBDsirIGkRZBtSMEzNTyDr2JQm4xx,11,9,5,6,3,0,2,0,25,3.5714285714285716,2,0.0,2,5,5,3,7,0,1,2,0,15,10,1
1240,14816,NJcCHbOJUQpAuhbw958dR9qCvbh6GNk7,7GRhBDsirIGkRZBtSMEzNTyDr2JQm4xx,43,82,27,53,28,0,12,0,202,28.857142857142858,2,0.0,42,27,49,28,40,0,4,12,0,146,56,1
1241,14827,qxbESUsL0xgJYJDfjiKdrZA2VpHvSkr3,7GRhBDsirIGkRZBtSMEzNTyDr2JQm4xx,11,22,7,9,4,1,2,0,45,6.428571428571429,1,0.0,13,7,8,4,9,1,1,2,0,32,13,1
1242,14847,1CUoIZB9t7SxaldyOLjOrt0HiuV3YmmT,7GRhBDsirIGkRZBtSMEzNTyDr2JQm4xx,5,5,2,0,0,0,3,0,10,1.4285714285714286,1,0.0,2,2,0,0,3,0,0,3,0,4,6,0
1243,14900,iG30XkTMNSFjufmkcMfMeTLCQkIO89rL,7GRhBDsirIGkRZBtSMEzNTyDr2JQm4xx,2,0,0,0,0,0,3,0,3,0.42857142857142855,1,0.0,0,0,0,0,0,0,0,3,0,0,3,1
1244,14920,tLb8Xi221e5NaJvytwcAD3V04AqBaAZQ,7GRhBDsirIGkRZBtSMEzNTyDr2JQm4xx,25,31,11,18,12,0,6,0,78,11.142857142857142,1,0.0,16,11,17,12,15,0,1,6,0,56,22,1
1245,15048,YUqXNrT8XQT6xSTrWrerz6EWyspe1b7c,7GRhBDsirIGkRZBtSMEzNTyDr2JQm4xx,63,147,37,149,29,10,9,0,381,54.42857142857143,4,0.0,91,37,132,29,56,10,17,9,0,289,92,0
1246,15051,KXPsJNzb3MNK5rxQc94IXJdmXF0ziWwA,7GRhBDsirIGkRZBtSMEzNTyDr2JQm4xx,1,0,0,0,0,0,1,0,1,0.14285714285714285,1,0.0,0,0,0,0,0,0,0,1,0,0,1,1
1247,15066,6vCR5MIMPnf9UWKZznVOJS5OTo4Gr7Hd,7GRhBDsirIGkRZBtSMEzNTyDr2JQm4xx,31,76,13,42,13,14,2,0,160,22.857142857142858,1,0.0,43,13,38,13,33,14,4,2,0,107,53,1
1248,15082,0ogceMBqbMfusFqG89X9sBzEnUGema9q,7GRhBDsirIGkRZBtSMEzNTyDr2JQm4xx,10,7,5,0,5,0,3,0,20,2.857142857142857,2,0.0,0,5,0,5,7,0,0,3,0,10,10,1
1249,15083,AsBtR21xGFKZ6c2LKvPTdlawgiUBcaPL,7GRhBDsirIGkRZBtSMEzNTyDr2JQm4xx,22,44,23,15,21,1,3,0,107,15.285714285714286,1,0.0,17,23,12,21,27,1,3,3,0,73,34,0
1250,15187,q36eiA77bwwsXGg05ifhgnTFDpR9Ar4V,7GRhBDsirIGkRZBtSMEzNTyDr2JQm4xx,66,168,49,139,39,7,12,0,414,59.142857142857146,2,0.0,99,49,120,39,69,7,19,12,0,307,107,0
1251,15202,ePpfrPKFmuYE4CHcpunEZ73b0FxyOz0q,7GRhBDsirIGkRZBtSMEzNTyDr2JQm4xx,30,40,13,82,9,0,2,0,146,20.857142857142858,2,0.0,20,13,72,9,20,0,10,2,0,114,32,1
1252,15240,9PiJFDewOyLmHT48JZWbbQ236haTndT7,7GRhBDsirIGkRZBtSMEzNTyDr2JQm4xx,30,87,28,19,22,7,18,2,183,26.142857142857142,4,0.0,43,28,19,22,44,7,0,18,2,112,71,1
1253,15242,CYwEz0VhssUEnyi7GLISc2cCNlhTg5eu,7GRhBDsirIGkRZBtSMEzNTyDr2JQm4xx,31,39,1,59,8,0,6,0,113,16.142857142857142,3,0.0,23,1,52,8,16,0,7,6,0,84,29,1
1254,15273,zx92A3etlZOmjWi19IMDYlwaWCkvF08z,7GRhBDsirIGkRZBtSMEzNTyDr2JQm4xx,27,81,0,43,8,17,1,0,150,21.428571428571427,1,0.0,37,0,41,8,44,17,2,1,0,86,64,1
1255,15296,S0OJjF6aof0iTnIX6lUAxekoH3m4w7V0,7GRhBDsirIGkRZBtSMEzNTyDr2JQm4xx,40,126,37,99,17,70,12,0,361,51.57142857142857,5,0.0,82,37,81,17,44,70,18,12,0,217,144,0
1256,15339,C6xrhZPOmVH2gCVNP26gSSPka2CcwgB5,7GRhBDsirIGkRZBtSMEzNTyDr2JQm4xx,30,39,13,28,14,3,9,0,106,15.142857142857142,3,0.0,25,13,26,14,14,3,2,9,0,78,28,1
1257,15361,CrwYq2YvOe70PhTOuriN4QumcrUjBJDI,7GRhBDsirIGkRZBtSMEzNTyDr2JQm4xx,50,150,34,87,13,14,14,0,312,44.57142857142857,3,0.0,98,34,79,13,52,14,8,14,0,224,88,0
1258,15365,sDcc9eMBMovhbCv3mcSbRYupViyMpSXg,7GRhBDsirIGkRZBtSMEzNTyDr2JQm4xx,1,0,0,0,0,0,2,0,2,0.2857142857142857,1,0.0,0,0,0,0,0,0,0,2,0,0,2,1
1259,15367,nnTxxp3z9fcrPPkS4kzYDi6mu4P5bdue,7GRhBDsirIGkRZBtSMEzNTyDr2JQm4xx,40,71,23,92,19,14,11,0,230,32.857142857142854,4,0.0,41,23,80,19,30,14,12,11,0,163,67,0
1260,15401,9iGaqBGS5kkoXjLd87hUL2eIJMVUVKfU,7GRhBDsirIGkRZBtSMEzNTyDr2JQm4xx,3,2,1,0,0,0,3,0,6,0.8571428571428571,1,0.0,0,1,0,0,2,0,0,3,0,1,5,0
1261,15436,OURivxGQBNOdhRVXNUy5pKGguC3x3JGV,7GRhBDsirIGkRZBtSMEzNTyDr2JQm4xx,22,49,13,20,15,1,11,0,109,15.571428571428571,2,0.0,17,13,17,15,32,1,3,11,0,62,47,0
1262,15491,iKE2AmvagEBVkqWumD0qyaUU8HShKvRo,7GRhBDsirIGkRZBtSMEzNTyDr2JQm4xx,1,0,0,0,0,0,1,0,1,0.14285714285714285,1,0.0,0,0,0,0,0,0,0,1,0,0,1,0
1263,15563,VVltscgfR96aweHb5nQdD1Q7dsOwuOJz,7GRhBDsirIGkRZBtSMEzNTyDr2JQm4xx,22,30,1,29,4,2,1,0,67,9.571428571428571,1,0.0,15,1,27,4,15,2,2,1,0,47,20,0
1264,15641,xY5IUgrYconprXri0F5cssyTAsVeuYqD,7GRhBDsirIGkRZBtSMEzNTyDr2JQm4xx,4,9,4,0,0,0,1,0,14,2.0,1,0.0,3,4,0,0,6,0,0,1,0,7,7,1
1265,15694,ls88dNG7SGcb3wsgc3lZQCJwuuAQTKkF,7GRhBDsirIGkRZBtSMEzNTyDr2JQm4xx,3,2,0,0,0,0,1,0,3,0.42857142857142855,1,0.0,0,0,0,0,2,0,0,1,0,0,3,1
1266,15700,p8pFuUg19xWGOlJygMvSlQjonA3l7FUn,7GRhBDsirIGkRZBtSMEzNTyDr2JQm4xx,1,0,0,0,0,0,1,0,1,0.14285714285714285,1,0.0,0,0,0,0,0,0,0,1,0,0,1,1
1267,15713,UQMPqDnQtELOyig8xWMMs5ktcYwtyCzh,7GRhBDsirIGkRZBtSMEzNTyDr2JQm4xx,17,16,8,0,8,1,4,0,37,5.285714285714286,2,0.0,0,8,0,8,16,1,0,4,0,16,21,0
1268,15716,W2ohBuN5JfRDGloM0s99vkGQJHKKrtyK,7GRhBDsirIGkRZBtSMEzNTyDr2JQm4xx,4,3,1,0,0,0,1,0,5,0.7142857142857143,1,0.0,0,1,0,0,3,0,0,1,0,1,4,1
1269,15771,HbdIEiZ1jslj2pBp8czn7lhBbxLYjtpj,7GRhBDsirIGkRZBtSMEzNTyDr2JQm4xx,34,26,9,42,7,0,2,0,86,12.285714285714286,1,0.0,16,9,42,7,10,0,0,2,0,74,12,0
1270,15810,WJLMraoon9e2y7OtDk9UrQjU4oqkoa0t,7GRhBDsirIGkRZBtSMEzNTyDr2JQm4xx,39,70,42,43,39,17,13,5,229,32.714285714285715,4,0.0,16,42,37,39,54,17,6,13,5,134,95,0
1271,15814,g7u6ac7DR9jMW4aOouB4W8Gur81b4cDe,7GRhBDsirIGkRZBtSMEzNTyDr2JQm4xx,52,64,23,63,23,0,16,2,191,27.285714285714285,3,0.0,39,23,49,23,25,0,14,16,2,134,57,0
1272,15876,rrw2WJkAL0R5jcfwKMTsm56jlh9a5ial,7GRhBDsirIGkRZBtSMEzNTyDr2JQm4xx,33,73,1,55,5,9,10,0,153,21.857142857142858,3,0.0,22,1,48,5,51,9,7,10,0,76,77,1
1273,15878,468cxTIslgaJVBCubZgOneiS2rtqRqqz,7GRhBDsirIGkRZBtSMEzNTyDr2JQm4xx,7,7,1,0,1,0,1,0,10,1.4285714285714286,1,0.0,0,1,0,1,7,0,0,1,0,2,8,1
1274,15881,W8K4VS8rPvnPTNUJrqgtS2FKH93KmR91,7GRhBDsirIGkRZBtSMEzNTyDr2JQm4xx,56,150,46,73,28,3,10,0,310,44.285714285714285,4,0.0,52,46,69,28,98,3,4,10,0,195,115,1
1275,15900,MvkVXPKImqjQobZ7zCJXq4GfQ4IthLq9,7GRhBDsirIGkRZBtSMEzNTyDr2JQm4xx,35,50,13,41,11,0,7,0,122,17.428571428571427,5,0.0,17,13,41,11,33,0,0,7,0,82,40,0
1276,15906,3c8IXjLzAuM9vKLwVwPhkOijPLPnFRJ2,7GRhBDsirIGkRZBtSMEzNTyDr2JQm4xx,1,0,0,0,0,0,1,0,1,0.14285714285714285,1,0.0,0,0,0,0,0,0,0,1,0,0,1,1
1277,15912,hJo1MgKiPZFXuH2ko6hqPTd9dbjMQKDO,7GRhBDsirIGkRZBtSMEzNTyDr2JQm4xx,5,5,3,0,1,0,2,0,11,1.5714285714285714,2,0.0,0,3,0,1,5,0,0,2,0,4,7,1
1278,15919,oho8eUx0qt2QgQUM9H4Puo64w9V5nVUl,7GRhBDsirIGkRZBtSMEzNTyDr2JQm4xx,38,49,18,41,21,0,7,0,136,19.428571428571427,3,0.0,25,18,40,21,24,0,1,7,0,104,32,1
1279,15922,OHdLWfOkVYVSxh9avWbeG6oGLyuN9vvx,7GRhBDsirIGkRZBtSMEzNTyDr2JQm4xx,37,63,20,50,14,19,10,0,176,25.142857142857142,3,0.0,29,20,46,14,34,19,4,10,0,109,67,1
1280,15924,pXzK9E1YOZkyyLlXWv7EKpRMBTF7x1zF,7GRhBDsirIGkRZBtSMEzNTyDr2JQm4xx,1,0,0,0,0,0,1,0,1,0.14285714285714285,1,0.0,0,0,0,0,0,0,0,1,0,0,1,1
1281,15944,i4Ja5POFcbWsTXzyspWne0P4gq0Sndm7,7GRhBDsirIGkRZBtSMEzNTyDr2JQm4xx,29,55,21,27,9,0,10,0,122,17.428571428571427,2,0.0,30,21,22,9,25,0,5,10,0,82,40,1
1282,15947,JvcRsdOfDUJrxbmOeabeYf6ul7MDwm6b,7GRhBDsirIGkRZBtSMEzNTyDr2JQm4xx,22,25,7,19,6,0,3,0,60,8.571428571428571,3,0.0,14,7,17,6,11,0,2,3,0,44,16,1
1283,15956,wg7c1wZNHnWuQEzOFg3X7UO4UvdvZ0Nl,7GRhBDsirIGkRZBtSMEzNTyDr2JQm4xx,22,25,8,94,3,0,3,0,133,19.0,2,0.0,9,8,84,3,16,0,10,3,0,104,29,1
1284,15959,KD5stEhIDxW0wB7Mr1YVPQQ5AGRkzqAA,7GRhBDsirIGkRZBtSMEzNTyDr2JQm4xx,30,40,16,20,14,1,3,0,94,13.428571428571429,2,0.0,21,16,17,14,19,1,3,3,0,68,26,1
1285,15966,dWGIj0UEkV1WxMBYGHRsdtDhUsNSq5LC,7GRhBDsirIGkRZBtSMEzNTyDr2JQm4xx,13,29,13,2,10,0,3,0,57,8.142857142857142,3,0.0,13,13,2,10,16,0,0,3,0,38,19,0
1286,15982,yUo0f8mA9XEAtzr6kcSUh5ydpzcuIcml,7GRhBDsirIGkRZBtSMEzNTyDr2JQm4xx,32,47,16,38,9,5,19,0,134,19.142857142857142,2,0.0,20,16,34,9,27,5,4,19,0,79,55,1
1287,15987,6zXGZtvwHnFZCYFcS3Xzk5yrVH7CXdoJ,7GRhBDsirIGkRZBtSMEzNTyDr2JQm4xx,1,0,0,0,0,0,1,0,1,0.14285714285714285,1,0.0,0,0,0,0,0,0,0,1,0,0,1,1
1288,16020,ywdL3xkp7d2PSjbvnflAvIe7Wp6Q4SRe,7GRhBDsirIGkRZBtSMEzNTyDr2JQm4xx,24,68,15,42,14,0,9,0,148,21.142857142857142,3,0.0,31,15,41,14,37,0,1,9,0,101,47,1
1289,16029,aWq626ehQk5Iuuwzds6iAgtzgkimu1j2,7GRhBDsirIGkRZBtSMEzNTyDr2JQm4xx,30,42,13,65,21,1,2,0,144,20.571428571428573,2,0.0,27,13,57,21,15,1,8,2,0,118,26,1
1290,16038,NoaJNfAZAESYC7salsh3Qwaa5hC3sdBk,7GRhBDsirIGkRZBtSMEzNTyDr2JQm4xx,28,56,14,56,7,18,3,0,154,22.0,1,0.0,38,14,47,7,18,18,9,3,0,106,48,0
1291,16081,Z9zd5ft7NWbOfEUxKVShKB2Y1F3jXBm8,7GRhBDsirIGkRZBtSMEzNTyDr2JQm4xx,12,10,6,2,3,0,7,0,28,4.0,1,0.0,1,6,2,3,9,0,0,7,0,12,16,1
1292,16087,SIdEQEXoagJ5WwAcAkPtkVF6pipatiIa,7GRhBDsirIGkRZBtSMEzNTyDr2JQm4xx,31,112,35,22,18,0,7,0,194,27.714285714285715,2,0.0,29,35,17,18,83,0,5,7,0,99,95,0
1293,16091,DWloCId6fkO6Ms5BXhdCfDhm96dIK6F3,7GRhBDsirIGkRZBtSMEzNTyDr2JQm4xx,1,0,0,0,0,0,1,0,1,0.14285714285714285,1,0.0,0,0,0,0,0,0,0,1,0,0,1,1
1294,16131,cwM32Iyo8DmzSk0EybXLo5ksFWhXG4Da,7GRhBDsirIGkRZBtSMEzNTyDr2JQm4xx,5,2,1,0,1,0,2,0,6,0.8571428571428571,1,0.0,0,1,0,1,2,0,0,2,0,2,4,0
1295,16134,JmlFAaRVuCFkmr6g7GLFJYPWWHADo3Vp,7GRhBDsirIGkRZBtSMEzNTyDr2JQm4xx,1,0,0,0,0,0,1,0,1,0.14285714285714285,1,0.0,0,0,0,0,0,0,0,1,0,0,1,1
1296,16168,DLDhUvvvfnnYFJuV65Zt2yaS0jPJgvzq,7GRhBDsirIGkRZBtSMEzNTyDr2JQm4xx,35,84,0,80,1,0,11,0,176,25.142857142857142,4,0.0,28,0,67,1,56,0,13,11,0,96,80,1
1297,16238,4NRUo07WkcrdRLUhlPTipY45aaERRn99,7GRhBDsirIGkRZBtSMEzNTyDr2JQm4xx,2,0,0,0,0,0,2,0,2,0.2857142857142857,1,0.0,0,0,0,0,0,0,0,2,0,0,2,0
1298,16285,W8p8vrZuo5elf0zj1Aez8mTMlTcetQ7p,7GRhBDsirIGkRZBtSMEzNTyDr2JQm4xx,6,4,2,0,1,0,2,0,9,1.2857142857142858,1,0.0,0,2,0,1,4,0,0,2,0,3,6,1
1299,16289,moK1GdnqoYxhSRCf5a95lgXdVNdzYrjs,7GRhBDsirIGkRZBtSMEzNTyDr2JQm4xx,25,78,9,26,12,0,16,0,141,20.142857142857142,3,0.0,21,9,25,12,57,0,1,16,0,67,74,1
1300,16303,2WHNpOBPMmOzdjUXQIDdX6w5Bhh6AyHU,7GRhBDsirIGkRZBtSMEzNTyDr2JQm4xx,7,11,5,0,2,0,3,0,21,3.0,1,0.0,4,5,0,2,7,0,0,3,0,11,10,0
1301,16378,RjbxXw1YYmiUcedHIl1VrXvYXiS6wbOC,7GRhBDsirIGkRZBtSMEzNTyDr2JQm4xx,17,16,2,9,3,0,18,2,50,7.142857142857143,3,0.0,4,2,8,3,12,0,1,18,2,17,33,0
1302,16415,096xYyhB9kL7G6lT7J9rVrXyGNwUToLF,7GRhBDsirIGkRZBtSMEzNTyDr2JQm4xx,4,4,2,0,0,0,4,0,10,1.4285714285714286,2,0.0,0,2,0,0,4,0,0,4,0,2,8,0
1303,16460,KDzfaWgTSBqeMJLFLmFuh4CMLsva9aWu,7GRhBDsirIGkRZBtSMEzNTyDr2JQm4xx,26,67,0,66,1,0,9,0,143,20.428571428571427,4,0.0,18,0,56,1,49,0,10,9,0,75,68,0
1304,16484,v1iavhjAgOftyRIIBT7pVhYkpNdcTDpm,7GRhBDsirIGkRZBtSMEzNTyDr2JQm4xx,12,11,5,0,2,1,6,1,26,3.7142857142857144,2,0.0,4,5,0,2,7,1,0,6,1,11,15,1
1305,16518,VFg2AN5zsuWpHyPwDEXIcAxQpNCPCOo7,7GRhBDsirIGkRZBtSMEzNTyDr2JQm4xx,30,77,26,36,16,19,18,0,192,27.428571428571427,3,0.0,25,26,30,16,52,19,6,18,0,97,95,1
1306,16541,tDBUBIMhJEJx4Pe5n9oY4eK5G81QRmVq,7GRhBDsirIGkRZBtSMEzNTyDr2JQm4xx,35,97,2,118,9,4,4,0,234,33.42857142857143,3,0.0,42,2,107,9,55,4,11,4,0,160,74,0
1307,16559,WbPhqfwmFYggW432ooC1iHmgUJBCP9Le,7GRhBDsirIGkRZBtSMEzNTyDr2JQm4xx,38,77,33,71,27,15,17,0,240,34.285714285714285,4,0.0,37,33,61,27,40,15,10,17,0,158,82,0
1308,16582,BxR5XM6DXnDlyXChlQFtgsFNvTkRDfGo,7GRhBDsirIGkRZBtSMEzNTyDr2JQm4xx,5,4,1,0,0,0,2,0,7,1.0,1,0.0,1,1,0,0,3,0,0,2,0,2,5,1
1309,16632,uPNpQwnvEtjDufLcIcScg8qVljQjes1y,7GRhBDsirIGkRZBtSMEzNTyDr2JQm4xx,27,44,12,34,8,0,6,0,104,14.857142857142858,2,0.0,21,12,32,8,23,0,2,6,0,73,31,1
1310,16696,EshSTNSaPVDLcPEwlm2e07DrZJhzPNHK,7GRhBDsirIGkRZBtSMEzNTyDr2JQm4xx,40,82,25,78,17,19,12,0,233,33.285714285714285,2,0.0,51,25,63,17,31,19,15,12,0,156,77,0
1311,16712,5nwrdJlhASYfMmSpU3deRRqUrd3ZpMIS,7GRhBDsirIGkRZBtSMEzNTyDr2JQm4xx,3,2,1,0,0,0,2,0,5,0.7142857142857143,1,0.0,0,1,0,0,2,0,0,2,0,1,4,1
1312,16787,ntbB11ay7TxjZmHHl7KvM6m0h5FtxAHR,7GRhBDsirIGkRZBtSMEzNTyDr2JQm4xx,9,8,4,0,5,1,6,1,25,3.5714285714285716,1,0.0,3,4,0,5,5,1,0,6,1,12,13,1
1313,16828,FhnsJdRTpIANrPfAv3Fv2vn7QGHPfOsl,7GRhBDsirIGkRZBtSMEzNTyDr2JQm4xx,13,24,11,0,2,4,7,0,48,6.857142857142857,2,0.0,4,11,0,2,20,4,0,7,0,17,31,0
1314,16923,oSfAVLTcGEmcT7y7OMQrYnvkkm78yh0P,7GRhBDsirIGkRZBtSMEzNTyDr2JQm4xx,37,65,19,124,19,23,1,0,251,35.857142857142854,2,0.0,44,19,106,19,21,23,18,1,0,188,63,1
1315,16957,5fUv2a4WMEi2Bc60cQo0Uzo1I7SufPfI,7GRhBDsirIGkRZBtSMEzNTyDr2JQm4xx,9,14,1,8,2,2,1,0,28,4.0,2,0.0,3,1,7,2,11,2,1,1,0,13,15,1
1316,16978,9gZpfuq1OK1diJdWcNoIpwo7QJUSplIt,7GRhBDsirIGkRZBtSMEzNTyDr2JQm4xx,22,59,28,20,13,0,4,0,124,17.714285714285715,2,0.0,28,28,17,13,31,0,3,4,0,86,38,1
1317,16979,hdKqkkWKrDzbKE9btGChBqiCfsTwp68E,7GRhBDsirIGkRZBtSMEzNTyDr2JQm4xx,13,7,5,0,0,26,16,2,56,8.0,2,0.0,0,5,0,0,7,26,0,16,2,5,51,1
1318,16989,76mZXn9JCyY7Mb7TWPGPGPMVCvSrLgze,7GRhBDsirIGkRZBtSMEzNTyDr2JQm4xx,39,74,18,68,27,1,8,1,197,28.142857142857142,2,0.0,44,18,63,27,30,1,5,8,1,152,45,1
1319,16999,Jb792VQeMGhUz59LQDa5JysSU082aNRs,7GRhBDsirIGkRZBtSMEzNTyDr2JQm4xx,1,0,1,0,0,0,0,0,1,0.14285714285714285,1,0.0,0,1,0,0,0,0,0,0,0,1,0,0
1320,17028,HF98YPKzT8oi2j9flZW9kstZcvL3ZimG,7GRhBDsirIGkRZBtSMEzNTyDr2JQm4xx,8,15,1,6,1,0,2,0,25,3.5714285714285716,1,0.0,3,1,5,1,12,0,1,2,0,10,15,0
1321,17049,4i80ssNqIa74pSBDzjYYryTbL6MBe9I9,7GRhBDsirIGkRZBtSMEzNTyDr2JQm4xx,47,102,30,80,33,24,13,0,282,40.285714285714285,3,0.0,69,30,66,33,33,24,14,13,0,198,84,1
1322,17055,CxUPOQRaQMGLmbOcfniIQOhh24PXLDR6,7GRhBDsirIGkRZBtSMEzNTyDr2JQm4xx,8,16,7,4,2,3,0,0,32,4.571428571428571,5,0.0,2,7,3,2,14,3,1,0,0,14,18,0
1323,17104,oxYTAYYaR98reRev5BqLPii4AFJGZbGZ,7GRhBDsirIGkRZBtSMEzNTyDr2JQm4xx,10,10,4,8,4,0,2,0,28,4.0,1,0.0,2,4,7,4,8,0,1,2,0,17,11,1
1324,17166,aJMNcTer76nTaYZZR58xtdmLr8BYq1Op,7GRhBDsirIGkRZBtSMEzNTyDr2JQm4xx,1,0,0,0,0,0,1,0,1,0.14285714285714285,1,0.0,0,0,0,0,0,0,0,1,0,0,1,1
1325,17267,5nhjk1VnZY8a3OWnkRujRs0BorgiAKUm,7GRhBDsirIGkRZBtSMEzNTyDr2JQm4xx,19,30,0,76,0,5,2,0,113,16.142857142857142,1,0.0,16,0,70,0,14,5,6,2,0,86,27,1
1326,17303,yhSGXw7EnYX7J3WWxRb9piBAfJaOtRLJ,7GRhBDsirIGkRZBtSMEzNTyDr2JQm4xx,26,42,16,94,0,0,4,0,156,22.285714285714285,3,0.0,22,16,82,0,20,0,12,4,0,120,36,1
1327,17332,Dy53HBwqZRiUys0tuL4RoOSu6jKEN99b,7GRhBDsirIGkRZBtSMEzNTyDr2JQm4xx,29,27,3,32,6,0,9,0,77,11.0,2,0.0,14,3,30,6,13,0,2,9,0,53,24,0
1328,17340,TilPXsBtUeInJte9nDlpbC1Ot52Vr9xD,7GRhBDsirIGkRZBtSMEzNTyDr2JQm4xx,6,8,1,0,1,0,3,0,13,1.8571428571428572,1,0.0,0,1,0,1,8,0,0,3,0,2,11,1
1329,17350,3WLDG20nmrHcXqgUBcbAgxTDjIgQgeWc,7GRhBDsirIGkRZBtSMEzNTyDr2JQm4xx,1,0,0,0,0,0,1,0,1,0.14285714285714285,1,0.0,0,0,0,0,0,0,0,1,0,0,1,1
1330,17382,B9q7BVaj4oZ0WT5JELnStUq4yahYsvGS,7GRhBDsirIGkRZBtSMEzNTyDr2JQm4xx,26,79,12,26,17,4,5,0,143,20.428571428571427,4,0.0,33,12,24,17,46,4,2,5,0,86,57,1
1331,17388,QRh7ApSBJNbSH61R3OkAQmXanxVzZM0F,7GRhBDsirIGkRZBtSMEzNTyDr2JQm4xx,20,39,19,30,16,2,2,0,108,15.428571428571429,2,0.0,18,19,26,16,21,2,4,2,0,79,29,0
1332,17389,Qj89AM8R8CzDfUmyoFjU0iKz1g513ZXt,7GRhBDsirIGkRZBtSMEzNTyDr2JQm4xx,46,158,68,138,20,440,64,6,894,127.71428571428571,7,0.0,48,68,116,20,110,440,22,64,6,252,642,1
1333,17419,RALsNmDC4TIWwMjDij2qj4Bbd4iRP5eW,7GRhBDsirIGkRZBtSMEzNTyDr2JQm4xx,5,2,1,0,1,0,2,0,6,0.8571428571428571,1,0.0,0,1,0,1,2,0,0,2,0,2,4,1
1334,17459,1Ueye4RWWjvz8urTBfWMjk9mmqk3rMDD,7GRhBDsirIGkRZBtSMEzNTyDr2JQm4xx,35,59,23,28,21,13,8,0,152,21.714285714285715,3,0.0,34,23,28,21,25,13,0,8,0,106,46,1
1335,17510,riM9GkB0ajSqpIPlVq4tRzOjk7wJ6NHE,7GRhBDsirIGkRZBtSMEzNTyDr2JQm4xx,35,47,21,47,19,0,6,0,140,20.0,3,0.0,23,21,44,19,24,0,3,6,0,107,33,0
1336,17535,0j1auVPH81fVETuSCGy4JUgrdNva23MX,7GRhBDsirIGkRZBtSMEzNTyDr2JQm4xx,10,10,3,0,2,1,5,0,21,3.0,1,0.0,0,3,0,2,10,1,0,5,0,5,16,1
1337,17536,5EqHj7Yiq3ymf3kXC9ShF9mwG40Y7dpr,7GRhBDsirIGkRZBtSMEzNTyDr2JQm4xx,6,7,1,0,1,0,2,0,11,1.5714285714285714,1,0.0,0,1,0,1,7,0,0,2,0,2,9,1
1338,17540,FAO2ZdiHLpuwiCcIDpRl8MBgRMyFcfQ2,7GRhBDsirIGkRZBtSMEzNTyDr2JQm4xx,7,6,2,0,1,1,3,0,13,1.8571428571428572,2,0.0,0,2,0,1,6,1,0,3,0,3,10,1
1339,17586,TwDUv8vbemLEqdAHMCXeJ0dOJyZMBx6V,7GRhBDsirIGkRZBtSMEzNTyDr2JQm4xx,29,64,18,34,6,5,5,0,132,18.857142857142858,2,0.0,28,18,30,6,36,5,4,5,0,82,50,0
1340,17592,87HjW3xlExsdfk3WF0s7d71nmAzoFuKE,7GRhBDsirIGkRZBtSMEzNTyDr2JQm4xx,2,0,0,0,0,0,2,0,2,0.2857142857142857,1,0.0,0,0,0,0,0,0,0,2,0,0,2,1
1341,17595,3vhCoT2dzeVdCpmcedhNzxK4VNLZ2l0r,7GRhBDsirIGkRZBtSMEzNTyDr2JQm4xx,9,5,1,0,1,0,7,1,15,2.142857142857143,2,0.0,0,1,0,1,5,0,0,7,1,2,13,1
1342,17597,dxt9lWTWbhPZn9mT70zVSi49oFElvqw6,7GRhBDsirIGkRZBtSMEzNTyDr2JQm4xx,2,1,0,0,0,0,1,0,2,0.2857142857142857,1,0.0,0,0,0,0,1,0,0,1,0,0,2,1
1343,17612,XarBLnhwPhERC9Lork4s2tIiSLNqD9KT,7GRhBDsirIGkRZBtSMEzNTyDr2JQm4xx,1,0,0,0,0,0,1,0,1,0.14285714285714285,1,0.0,0,0,0,0,0,0,0,1,0,0,1,1
1344,17620,5HX4czL6Sp8ee3UX2kWAHqmFW5CMMTjE,7GRhBDsirIGkRZBtSMEzNTyDr2JQm4xx,41,131,38,64,21,1,8,0,263,37.57142857142857,4,0.0,44,38,58,21,87,1,6,8,0,161,102,0
1345,17626,uol5rXltLKrhjm5SMrTU5qkZcMAMKTe6,7GRhBDsirIGkRZBtSMEzNTyDr2JQm4xx,43,75,34,80,26,22,6,0,243,34.714285714285715,3,0.0,36,34,68,26,39,22,12,6,0,164,79,1
1346,17647,f0IqI5DBlXdS6eUmVFeyauyA8dq5ftiC,7GRhBDsirIGkRZBtSMEzNTyDr2JQm4xx,23,38,19,2,10,8,6,0,83,11.857142857142858,1,0.0,5,19,2,10,33,8,0,6,0,36,47,1
1347,17652,dW2So4dhz8sFwZQzndBoTpsFa69MFo0q,7GRhBDsirIGkRZBtSMEzNTyDr2JQm4xx,1,0,0,0,0,0,1,0,1,0.14285714285714285,1,0.0,0,0,0,0,0,0,0,1,0,0,1,1
1348,17660,UaSh8dwx8gnofYbXlmpqj9uYDbpJ89pX,7GRhBDsirIGkRZBtSMEzNTyDr2JQm4xx,6,7,1,0,2,0,4,0,14,2.0,2,0.0,2,1,0,2,5,0,0,4,0,5,9,0
1349,17677,7VmmzXV3A639hzlpZwrx655FqwOsl8uh,7GRhBDsirIGkRZBtSMEzNTyDr2JQm4xx,4,3,0,0,0,0,1,0,4,0.5714285714285714,1,0.0,0,0,0,0,3,0,0,1,0,0,4,1
1350,17692,xndkXq03AGanha0Zu6RBymqlwrjUbtA1,7GRhBDsirIGkRZBtSMEzNTyDr2JQm4xx,10,5,2,6,3,0,5,0,21,3.0,2,0.0,2,2,6,3,3,0,0,5,0,13,8,1
1351,17706,WJVoKPfDDccrIbPzaP1iqdrTUwOdTQpf,7GRhBDsirIGkRZBtSMEzNTyDr2JQm4xx,22,41,11,0,11,0,1,0,64,9.142857142857142,1,0.0,17,11,0,11,24,0,0,1,0,39,25,1
1352,17707,8hNQWXBoItm3CRzdk0wSJDwYSfUbhUCO,7GRhBDsirIGkRZBtSMEzNTyDr2JQm4xx,29,46,9,34,10,0,2,0,101,14.428571428571429,2,0.0,25,9,30,10,21,0,4,2,0,74,27,1
1353,19579,mK2PenVNfwXeBJzi7mP3HzWchd5fxecA,fbPkOYLVPtPgIt0MxizjfFJov3JbHyAi,1,0,0,0,0,0,1,0,1,0.14285714285714285,1,0.0,0,0,0,0,0,0,0,1,0,0,1,1
1354,19580,3W09pasLSoDWuQqGyvECJ7WiykG165j2,fbPkOYLVPtPgIt0MxizjfFJov3JbHyAi,6,7,3,0,0,6,3,0,19,2.7142857142857144,1,0.0,1,3,0,0,6,6,0,3,0,4,15,1
1355,19586,z5Htt0utseDft2JjH8T5zYokNhpAiHNE,fbPkOYLVPtPgIt0MxizjfFJov3JbHyAi,6,21,0,0,4,0,2,0,27,3.857142857142857,1,0.0,11,0,0,4,10,0,0,2,0,15,12,0
1356,19588,EFioWHTkYv074j9vSFY7qmw2MvFzZ0mo,fbPkOYLVPtPgIt0MxizjfFJov3JbHyAi,24,45,21,16,12,55,15,0,164,23.428571428571427,6,0.0,14,21,14,12,31,55,2,15,0,61,103,0
1357,19589,SgWqRh3XmeJpz6RfUb8yXu2ZkH0AleuJ,fbPkOYLVPtPgIt0MxizjfFJov3JbHyAi,6,5,1,0,0,0,2,0,8,1.1428571428571428,1,0.0,1,1,0,0,4,0,0,2,0,2,6,1
1358,19591,I91CCtQfetYUPwkEXIvTFBP6tbrp1spN,fbPkOYLVPtPgIt0MxizjfFJov3JbHyAi,3,6,3,0,0,0,3,0,12,1.7142857142857142,3,0.0,0,3,0,0,6,0,0,3,0,3,9,0
1359,19598,rUHwInfwrT2VCsoj7SngGENcoxIrK2aA,fbPkOYLVPtPgIt0MxizjfFJov3JbHyAi,13,21,7,8,6,0,4,0,46,6.571428571428571,2,0.0,9,7,7,6,12,0,1,4,0,29,17,1
1360,19616,kyJzGSg3elXhPrIWM8rkZuAZv6RhnLQu,fbPkOYLVPtPgIt0MxizjfFJov3JbHyAi,12,24,17,4,6,22,0,0,73,10.428571428571429,2,0.0,1,17,3,6,23,22,1,0,0,27,46,1
1361,19621,P7cWTzqHbKs2w7IhW7Eb0IWuvmS7VHHm,fbPkOYLVPtPgIt0MxizjfFJov3JbHyAi,36,66,24,20,28,16,2,0,156,22.285714285714285,1,0.0,40,24,17,28,26,16,3,2,0,109,47,0
1362,19622,qGzhVjTxktnI3gvlHnV7uXSPz6cASHXn,fbPkOYLVPtPgIt0MxizjfFJov3JbHyAi,4,3,0,0,0,0,2,0,5,0.7142857142857143,2,0.0,0,0,0,0,3,0,0,2,0,0,5,1
1363,19624,2we3WxltFBT1dd0FjP3YZ8iHf2xpHEei,fbPkOYLVPtPgIt0MxizjfFJov3JbHyAi,4,2,1,0,0,0,2,0,5,0.7142857142857143,1,0.0,0,1,0,0,2,0,0,2,0,1,4,1
1364,19626,HnvxqugChFN5yjBU90JTvP996KYT36S0,fbPkOYLVPtPgIt0MxizjfFJov3JbHyAi,15,43,22,3,6,43,15,2,134,19.142857142857142,3,0.0,12,22,3,6,31,43,0,15,2,43,91,1
1365,19629,G0JgmTQ55TeK9aeblJVq6TYQNTXqJFIQ,fbPkOYLVPtPgIt0MxizjfFJov3JbHyAi,6,5,2,4,2,0,0,0,13,1.8571428571428572,1,0.0,1,2,4,2,4,0,0,0,0,9,4,1
1366,19631,8skbDsuebvai4ARav7dTtpvek1eLVeds,fbPkOYLVPtPgIt0MxizjfFJov3JbHyAi,10,12,6,0,5,4,7,1,35,5.0,3,0.0,0,6,0,5,12,4,0,7,1,11,24,1
1367,19636,cFawqBd5fJtkKlCTemtngl3kfpxBO2Oy,fbPkOYLVPtPgIt0MxizjfFJov3JbHyAi,9,8,3,10,3,0,1,0,25,3.5714285714285716,1,0.0,4,3,7,3,4,0,3,1,0,17,8,1
1368,19641,GoCzFgZtKHP9v4b0WP4lIjCorcS7Jt3F,fbPkOYLVPtPgIt0MxizjfFJov3JbHyAi,3,3,3,0,0,2,0,0,8,1.1428571428571428,1,0.0,0,3,0,0,3,2,0,0,0,3,5,1
1369,19646,ggEr2STKTwtSSUdtGCmiPr3DBu3TJ34B,fbPkOYLVPtPgIt0MxizjfFJov3JbHyAi,40,73,27,19,29,28,7,0,183,26.142857142857142,3,0.0,39,27,19,29,34,28,0,7,0,114,69,1
1370,19650,9Q3q5ak3WAEiXRLChbacNd3Hje0Wa6sd,fbPkOYLVPtPgIt0MxizjfFJov3JbHyAi,18,45,15,12,12,23,9,0,116,16.571428571428573,2,0.0,23,15,9,12,22,23,3,9,0,59,57,1
1371,19655,9e5dcfJQbPUU8sTcmzE9DWoDPOA9Nhu3,fbPkOYLVPtPgIt0MxizjfFJov3JbHyAi,5,4,2,0,1,0,1,0,8,1.1428571428571428,1,0.0,0,2,0,1,4,0,0,1,0,3,5,1
1372,19656,gsUbcjiJXGVEzC0HsE7H7oNZQUP3vN7h,fbPkOYLVPtPgIt0MxizjfFJov3JbHyAi,21,36,16,14,10,27,7,0,110,15.714285714285714,3,0.0,13,16,11,10,23,27,3,7,0,50,60,1
1373,19667,U04y5vFf0AfyJVGIOJHlryTyRQEOm5pT,fbPkOYLVPtPgIt0MxizjfFJov3JbHyAi,16,15,8,10,5,0,1,0,39,5.571428571428571,2,0.0,3,8,8,5,12,0,2,1,0,24,15,1
1374,19674,ohSArIWJFOjWcw1iipOBHaELVY4dEsuk,fbPkOYLVPtPgIt0MxizjfFJov3JbHyAi,8,4,3,0,1,9,4,4,25,3.5714285714285716,1,0.0,0,3,0,1,4,9,0,4,4,4,21,1
1375,19689,PwY3L0IvWcNAAWE8QgIO3juuVesQg6xr,fbPkOYLVPtPgIt0MxizjfFJov3JbHyAi,1,0,0,0,0,0,1,0,1,0.14285714285714285,1,0.0,0,0,0,0,0,0,0,1,0,0,1,1
1376,19692,KkdnagFJtwwq5n9Iuy7rnQaTqa2llFa9,fbPkOYLVPtPgIt0MxizjfFJov3JbHyAi,3,2,1,0,0,0,1,0,4,0.5714285714285714,1,0.0,0,1,0,0,2,0,0,1,0,1,3,1
1377,19695,3SP9iNDvUt8m67ZMqC5DpQRe6ekkTpsP,fbPkOYLVPtPgIt0MxizjfFJov3JbHyAi,8,4,3,0,2,0,2,0,11,1.5714285714285714,1,0.0,0,3,0,2,4,0,0,2,0,5,6,0
1378,19702,p4yxCxiqzIMRoAwoOyGnN7P9RZxypnFm,fbPkOYLVPtPgIt0MxizjfFJov3JbHyAi,17,19,9,6,8,6,5,1,54,7.714285714285714,1,0.0,9,9,6,8,10,6,0,5,1,32,22,1
1379,19705,nbIGolByJC5FPssjDvcKL2vGL3vYMGAq,fbPkOYLVPtPgIt0MxizjfFJov3JbHyAi,11,13,6,0,2,3,6,0,30,4.285714285714286,2,0.0,2,6,0,2,11,3,0,6,0,10,20,0
1380,19714,uuyAyzBNPZJSqNkYTwX3ItAQ7Xcq5lqK,fbPkOYLVPtPgIt0MxizjfFJov3JbHyAi,5,3,2,0,1,0,1,0,7,1.0,1,0.0,0,2,0,1,3,0,0,1,0,3,4,1
1381,19719,gl2YVlebVAvCcxsYaIoTwLj5l1IGqntH,fbPkOYLVPtPgIt0MxizjfFJov3JbHyAi,5,3,2,0,1,0,1,0,7,1.0,1,0.0,0,2,0,1,3,0,0,1,0,3,4,1
1382,19722,YchS7FPUUCrsbeC0RlrXHuAg4O0pgdnY,fbPkOYLVPtPgIt0MxizjfFJov3JbHyAi,3,2,1,0,0,0,1,0,4,0.5714285714285714,1,0.0,0,1,0,0,2,0,0,1,0,1,3,1
1383,19723,jWMVSdUkBIApMFEIB4X88BTUfxnffWAx,fbPkOYLVPtPgIt0MxizjfFJov3JbHyAi,10,13,10,3,8,0,2,0,36,5.142857142857143,2,0.0,1,10,2,8,12,0,1,2,0,21,15,1
1384,19726,LhzU5apxkgFguqzaBs2la7gJhoIHnun9,fbPkOYLVPtPgIt0MxizjfFJov3JbHyAi,5,2,1,0,1,0,5,0,9,1.2857142857142858,2,0.0,0,1,0,1,2,0,0,5,0,2,7,1
1385,19730,nIvIddlMAmTQagaACOulbZ6PInxlyOy2,fbPkOYLVPtPgIt0MxizjfFJov3JbHyAi,26,29,17,18,10,0,2,0,76,10.857142857142858,1,0.0,9,17,18,10,20,0,0,2,0,54,22,0
1386,19731,RLvJ5u6m28hhUO44ztK3P01H4ZTIxGoD,fbPkOYLVPtPgIt0MxizjfFJov3JbHyAi,6,6,2,0,2,0,1,0,11,1.5714285714285714,1,0.0,2,2,0,2,4,0,0,1,0,6,5,1
1387,19732,z0Q6ONK9gZ6rOpbD6TitX6FkYPuixcug,fbPkOYLVPtPgIt0MxizjfFJov3JbHyAi,41,119,39,31,17,30,22,4,262,37.42857142857143,7,0.0,26,39,26,17,93,30,5,22,4,108,154,1
1388,19733,D83ozkIhUBEzx10ZBkDPuuGHLXGFtU0D,fbPkOYLVPtPgIt0MxizjfFJov3JbHyAi,1,0,0,0,0,0,1,0,1,0.14285714285714285,1,0.0,0,0,0,0,0,0,0,1,0,0,1,1
1389,19735,KcSCnS83JgHtWEXfmBorkn1UBZpKO1nN,fbPkOYLVPtPgIt0MxizjfFJov3JbHyAi,2,0,0,0,0,0,2,0,2,0.2857142857142857,1,0.0,0,0,0,0,0,0,0,2,0,0,2,1
1390,19738,Bt0YrpvyveynQfxqkzppqbivsu9tYRaK,fbPkOYLVPtPgIt0MxizjfFJov3JbHyAi,12,7,6,0,5,0,1,0,19,2.7142857142857144,1,0.0,0,6,0,5,7,0,0,1,0,11,8,0
1391,19742,c2xUxg7vuhPItQZr96ojei2FNm4xg1X0,fbPkOYLVPtPgIt0MxizjfFJov3JbHyAi,40,60,24,17,24,29,11,2,167,23.857142857142858,5,0.0,29,24,17,24,31,29,0,11,2,94,73,1
1392,19743,EUZk7LUBeSnU7Li4WmLt7uKxhlLiKOYq,fbPkOYLVPtPgIt0MxizjfFJov3JbHyAi,11,29,14,0,6,0,15,1,65,9.285714285714286,2,0.0,0,14,0,6,29,0,0,15,1,20,45,1
1393,19744,k2JSp3bkSnFCXfzGP6sNaxUIyLpM06TA,fbPkOYLVPtPgIt0MxizjfFJov3JbHyAi,1,0,0,0,0,0,1,0,1,0.14285714285714285,1,0.0,0,0,0,0,0,0,0,1,0,0,1,1
1394,19745,Y5j2JtsMt3y0lrKil9FIBv8kmvrOLA4X,fbPkOYLVPtPgIt0MxizjfFJov3JbHyAi,7,5,3,0,2,0,4,0,14,2.0,1,0.0,0,3,0,2,5,0,0,4,0,5,9,1
1395,19746,teqJGecOr4a6oVYU1O9bgvPkX5ZSKA8N,fbPkOYLVPtPgIt0MxizjfFJov3JbHyAi,5,2,1,0,1,0,4,0,8,1.1428571428571428,1,0.0,0,1,0,1,2,0,0,4,0,2,6,1
1396,19748,P9CRp0z2n5HfPA3EY25pk86UB1hpP0VE,fbPkOYLVPtPgIt0MxizjfFJov3JbHyAi,5,5,3,0,0,1,4,0,13,1.8571428571428572,1,0.0,0,3,0,0,5,1,0,4,0,3,10,1
1397,19752,97yjJniO9qlZAjgn3gm4HXnkbwnHzt9O,fbPkOYLVPtPgIt0MxizjfFJov3JbHyAi,1,0,0,0,0,0,1,0,1,0.14285714285714285,1,0.0,0,0,0,0,0,0,0,1,0,0,1,1
1398,19753,4xhrCYKdzHUQrqW9iIr0KOeWujKeYIus,fbPkOYLVPtPgIt0MxizjfFJov3JbHyAi,4,2,0,0,0,0,3,0,5,0.7142857142857143,1,0.0,0,0,0,0,2,0,0,3,0,0,5,1
1399,19754,6K3h9aDeHI9AUqOKTvZxzGkKh6WMc7A3,fbPkOYLVPtPgIt0MxizjfFJov3JbHyAi,7,3,2,0,2,0,2,0,9,1.2857142857142858,1,0.0,0,2,0,2,3,0,0,2,0,4,5,1
1400,19757,hbUthRcRktel8CTk5FJE2GFw0tsGaPJX,fbPkOYLVPtPgIt0MxizjfFJov3JbHyAi,1,0,0,0,0,0,1,0,1,0.14285714285714285,1,0.0,0,0,0,0,0,0,0,1,0,0,1,1
1401,19758,ipOqQyQpg3SQQaHklGxEISyDZxdmtba9,fbPkOYLVPtPgIt0MxizjfFJov3JbHyAi,3,0,0,0,0,0,5,0,5,0.7142857142857143,1,0.0,0,0,0,0,0,0,0,5,0,0,5,1
1402,19759,K2Gev6RW8VKqmC4C4H0XJFrGZeT1JyyW,fbPkOYLVPtPgIt0MxizjfFJov3JbHyAi,9,3,2,0,2,0,4,1,12,1.7142857142857142,1,0.0,0,2,0,2,3,0,0,4,1,4,8,1
1403,19762,haOtWLq8R5iBRxrylu7qsQb4IXuRIQaN,fbPkOYLVPtPgIt0MxizjfFJov3JbHyAi,19,33,15,24,0,0,6,0,78,11.142857142857142,2,0.0,14,15,22,0,19,0,2,6,0,51,27,1
1404,19763,E3VAWhRWNv6BjTckpQB4VpqgHIOmEPoD,fbPkOYLVPtPgIt0MxizjfFJov3JbHyAi,7,3,2,0,2,0,2,0,9,1.2857142857142858,1,0.0,0,2,0,2,3,0,0,2,0,4,5,1
1405,19766,02KikDpeL3BkT1uIl0J4sjaa91Wls8ih,fbPkOYLVPtPgIt0MxizjfFJov3JbHyAi,14,8,5,5,5,0,5,0,28,4.0,1,0.0,3,5,4,5,5,0,1,5,0,17,11,1
1406,19767,GKKNtfrAHKD2xUEQBz7HLN3kKO9SrWyD,fbPkOYLVPtPgIt0MxizjfFJov3JbHyAi,19,32,17,1,3,8,19,3,83,11.857142857142858,4,0.0,8,17,1,3,24,8,0,19,3,29,54,1
1407,19768,Why02UcIH8ZdjwIJwPOElrNVNSec4in6,fbPkOYLVPtPgIt0MxizjfFJov3JbHyAi,9,8,4,0,4,0,4,0,20,2.857142857142857,1,0.0,2,4,0,4,6,0,0,4,0,10,10,1
1408,19769,bgBhXSh8X6pD8mAGuk3zRCZBNqTSqnHJ,fbPkOYLVPtPgIt0MxizjfFJov3JbHyAi,13,23,12,8,9,3,3,0,58,8.285714285714286,3,0.0,7,12,6,9,16,3,2,3,0,34,24,1
1409,19771,9lFnGVb4ngjyCBpAPFF4Py9FZpYTRwoJ,fbPkOYLVPtPgIt0MxizjfFJov3JbHyAi,5,2,1,0,1,0,2,0,6,0.8571428571428571,1,0.0,0,1,0,1,2,0,0,2,0,2,4,1
1410,19776,CfeENerIdAGepleePWSt0SV88ctt0Tmw,fbPkOYLVPtPgIt0MxizjfFJov3JbHyAi,26,22,14,0,11,0,5,0,52,7.428571428571429,3,0.0,1,14,0,11,21,0,0,5,0,26,26,1
1411,19777,yUDnZwj7Yxaj86CQGKHCPnaBfq9O3vcc,fbPkOYLVPtPgIt0MxizjfFJov3JbHyAi,5,2,1,0,1,0,3,0,7,1.0,2,0.0,0,1,0,1,2,0,0,3,0,2,5,1
1412,19779,0nqj6iIWmYxLKHezCs5xwlB8hzJ9Rg2d,fbPkOYLVPtPgIt0MxizjfFJov3JbHyAi,5,5,2,0,1,0,1,0,9,1.2857142857142858,1,0.0,0,2,0,1,5,0,0,1,0,3,6,1
1413,19780,nG5SIna2Yr2MumgRI14CLkOHNh2U0rkm,fbPkOYLVPtPgIt0MxizjfFJov3JbHyAi,7,4,2,0,1,0,3,0,10,1.4285714285714286,1,0.0,0,2,0,1,4,0,0,3,0,3,7,1
1414,19781,Jv08t8fpcawyaZCw9f0bMJgjS8SuUKfb,fbPkOYLVPtPgIt0MxizjfFJov3JbHyAi,3,2,1,0,0,0,2,0,5,0.7142857142857143,1,0.0,0,1,0,0,2,0,0,2,0,1,4,1
1415,19782,UstweopmwuJ2fqnPYowNY0vr3lDWnNEA,fbPkOYLVPtPgIt0MxizjfFJov3JbHyAi,16,24,15,0,10,2,22,1,74,10.571428571428571,3,0.0,2,15,0,10,22,2,0,22,1,27,47,1
1416,19783,LzhmzME7EkyHXpFVu0EENS6JHqvsJLtH,fbPkOYLVPtPgIt0MxizjfFJov3JbHyAi,27,55,27,16,21,6,7,0,132,18.857142857142858,2,0.0,21,27,14,21,34,6,2,7,0,83,49,1
1417,19785,UhCNSbJxDa9CkR9faEu7q44yTurX7YJH,fbPkOYLVPtPgIt0MxizjfFJov3JbHyAi,5,2,1,0,1,0,3,0,7,1.0,1,0.0,0,1,0,1,2,0,0,3,0,2,5,1
1418,19788,gfuRBmlPKlXNn3u69OCkIXEsqvf1vpRo,fbPkOYLVPtPgIt0MxizjfFJov3JbHyAi,11,8,6,0,6,0,2,0,22,3.142857142857143,3,0.0,0,6,0,6,8,0,0,2,0,12,10,1
1419,19789,Ao05SPEEQv1WpXaKhWVTBjeRlniH33AQ,fbPkOYLVPtPgIt0MxizjfFJov3JbHyAi,9,10,2,2,3,0,3,1,21,3.0,1,0.0,2,2,2,3,8,0,0,3,1,9,12,1
1420,19790,9v5FBlkT08VgqPArpwPYDVOHzgkK8DmA,fbPkOYLVPtPgIt0MxizjfFJov3JbHyAi,12,20,8,4,6,6,8,0,52,7.428571428571429,3,0.0,3,8,4,6,17,6,0,8,0,21,31,1
1421,19791,GAIOcbnQvA9qhvhMc6r6zhVuhoFpfQD2,fbPkOYLVPtPgIt0MxizjfFJov3JbHyAi,4,2,0,0,0,0,2,0,4,0.5714285714285714,1,0.0,0,0,0,0,2,0,0,2,0,0,4,1
1422,19793,NiwhcToNaizZtNhA7c6Q1ZKoUp33LASc,fbPkOYLVPtPgIt0MxizjfFJov3JbHyAi,16,28,13,7,9,1,10,0,68,9.714285714285714,4,0.0,7,13,7,9,21,1,0,10,0,36,32,1
1423,19794,i2J6g1YHP6evnvsQatEoUV6Lz662N8Pt,fbPkOYLVPtPgIt0MxizjfFJov3JbHyAi,22,55,10,15,5,0,9,0,94,13.428571428571429,3,0.0,10,10,11,5,45,0,4,9,0,36,58,1
1424,19795,AtTEb2VyFEMuCpu9E7TOV4gAVRLFEpvg,fbPkOYLVPtPgIt0MxizjfFJov3JbHyAi,3,0,0,0,0,4,4,0,8,1.1428571428571428,1,0.0,0,0,0,0,0,4,0,4,0,0,8,1
1425,19798,ghh1dIrprkTKfllDMPy4cIkYxENWN3hG,fbPkOYLVPtPgIt0MxizjfFJov3JbHyAi,9,10,5,7,6,0,1,0,29,4.142857142857143,1,0.0,4,5,5,6,6,0,2,1,0,20,9,1
1426,19799,HmPFRf4HaEfqanP8jptbixb101SDWsz7,fbPkOYLVPtPgIt0MxizjfFJov3JbHyAi,1,0,0,0,0,0,1,0,1,0.14285714285714285,1,0.0,0,0,0,0,0,0,0,1,0,0,1,1
1427,19800,qmuiZWmGa2h5jyuvdl0AMpjDHyWxmqus,fbPkOYLVPtPgIt0MxizjfFJov3JbHyAi,6,3,2,0,2,13,1,0,21,3.0,1,0.0,0,2,0,2,3,13,0,1,0,4,17,1
1428,19803,DAe94MkHTdcPmdhTmwEa78RpI8unH7VU,fbPkOYLVPtPgIt0MxizjfFJov3JbHyAi,1,0,0,0,0,0,1,0,1,0.14285714285714285,1,0.0,0,0,0,0,0,0,0,1,0,0,1,1
1429,19829,XQUx3MwVudtjeHmsju8PhHxsdXW0kluK,fbPkOYLVPtPgIt0MxizjfFJov3JbHyAi,12,16,5,4,7,0,5,0,37,5.285714285714286,1,0.0,9,5,4,7,7,0,0,5,0,25,12,1
1430,19842,bKIU4h5S6pxVBBvQYicGGZljVmGThQTZ,fbPkOYLVPtPgIt0MxizjfFJov3JbHyAi,13,29,9,10,13,2,12,5,80,11.428571428571429,3,0.0,13,9,6,13,16,2,4,12,5,41,39,1
1431,19861,kMADhIGduPqSkYFwoAlaAOq4Z3kg8su8,fbPkOYLVPtPgIt0MxizjfFJov3JbHyAi,10,11,8,0,5,0,5,0,29,4.142857142857143,2,0.0,0,8,0,5,11,0,0,5,0,13,16,0
1432,19866,BOBLP6pTmRtpQ8LtVgJyutFMDL3q6xno,fbPkOYLVPtPgIt0MxizjfFJov3JbHyAi,29,40,21,16,15,9,8,1,110,15.714285714285714,6,0.0,14,21,14,15,26,9,2,8,1,64,46,0
1433,19872,foOeNx7QB7iDsgeA0D657sokODh0QEAw,fbPkOYLVPtPgIt0MxizjfFJov3JbHyAi,8,7,2,0,2,0,3,0,14,2.0,2,0.0,0,2,0,2,7,0,0,3,0,4,10,1
1434,19884,NqKjMSY6eOZQ1uSyzlPrquJVqzjvSO7O,fbPkOYLVPtPgIt0MxizjfFJov3JbHyAi,34,47,31,2,26,7,8,1,122,17.428571428571427,3,0.0,10,31,2,26,37,7,0,8,1,69,53,1
1435,19893,NAeglY8cYFpzQKpSfjAgfrtdD2qzmpB5,fbPkOYLVPtPgIt0MxizjfFJov3JbHyAi,21,32,8,0,4,36,9,0,89,12.714285714285714,3,0.0,1,8,0,4,31,36,0,9,0,13,76,0
1436,19934,GyWTABuPpZEqO585EnNTIpM2B2faPYN3,fbPkOYLVPtPgIt0MxizjfFJov3JbHyAi,7,4,3,0,2,0,1,0,10,1.4285714285714286,1,0.0,0,3,0,2,4,0,0,1,0,5,5,1
1437,19935,wEajQeQse5CzhcFd5XXOtEsUUddZZAU5,fbPkOYLVPtPgIt0MxizjfFJov3JbHyAi,4,3,2,0,2,0,1,0,8,1.1428571428571428,1,0.0,0,2,0,2,3,0,0,1,0,4,4,0
1438,19936,viuKt4GgrX0rYL5EpHoxJbsiC9TblSuk,fbPkOYLVPtPgIt0MxizjfFJov3JbHyAi,23,36,24,0,12,12,7,0,91,13.0,4,0.0,2,24,0,12,34,12,0,7,0,38,53,0
1439,19942,je9A6l6tP7wnbFhNJD7vbbHTYhqshuqB,fbPkOYLVPtPgIt0MxizjfFJov3JbHyAi,24,46,20,11,7,9,12,1,106,15.142857142857142,3,0.0,7,20,8,7,39,9,3,12,1,42,64,1
1440,21459,NH0hsgo5xcqAdosarQoW4RQUZxH32Gzl,7GRhBDsirIGkRZBtSMEzNTyDr2JQm4xx,41,70,32,61,22,1,6,0,192,27.428571428571427,2,0.0,29,32,56,22,41,1,5,6,0,139,53,0
1441,21473,fd2e5NJVnyVwHFHuiTOOM639ZY1uThtn,7GRhBDsirIGkRZBtSMEzNTyDr2JQm4xx,58,149,37,80,30,38,12,0,346,49.42857142857143,4,0.0,96,37,65,30,53,38,15,12,0,228,118,1
1442,21485,l3mz2aAslwaCLhkdMrM7sQ5OXLzl6A2r,7GRhBDsirIGkRZBtSMEzNTyDr2JQm4xx,38,66,4,82,15,3,6,0,176,25.142857142857142,2,0.0,36,4,75,15,30,3,7,6,0,130,46,0
1443,21496,z6p7uYa25VIrmVARFxz5koBofuqHB2cM,7GRhBDsirIGkRZBtSMEzNTyDr2JQm4xx,2,0,0,0,0,0,2,0,2,0.2857142857142857,1,0.0,0,0,0,0,0,0,0,2,0,0,2,0
1444,21497,NToJOpRtq67cszdyzl1RlLKqGwS5lZl5,7GRhBDsirIGkRZBtSMEzNTyDr2JQm4xx,3,2,0,0,0,0,1,0,3,0.42857142857142855,1,0.0,0,0,0,0,2,0,0,1,0,0,3,1
1445,21514,ZhTCqX8GMUcn0a0betuEauHNuCk1aRhm,7GRhBDsirIGkRZBtSMEzNTyDr2JQm4xx,28,24,12,40,4,20,7,0,107,15.285714285714286,1,0.0,7,12,37,4,17,20,3,7,0,60,47,0
1446,21524,6Ysh3EXeoiNCd1uXxsjEQronkryNKRU5,7GRhBDsirIGkRZBtSMEzNTyDr2JQm4xx,43,113,53,58,19,5,21,0,269,38.42857142857143,4,0.0,37,53,49,19,76,5,9,21,0,158,111,1
1447,21529,Lf0mThPYOrtlCzgRGBCVTPy1hiGUII8h,7GRhBDsirIGkRZBtSMEzNTyDr2JQm4xx,8,7,5,0,0,0,7,0,19,2.7142857142857144,3,0.0,0,5,0,0,7,0,0,7,0,5,14,0
1448,21531,GvY4Z1NOjK4oYpeBStbrl7zpe2zlFqoT,7GRhBDsirIGkRZBtSMEzNTyDr2JQm4xx,31,62,24,52,15,1,4,0,158,22.571428571428573,2,0.0,29,24,43,15,33,1,9,4,0,111,47,0
1449,21545,be7952wawx5BhhJ4vIqX6Vxi48lNKbM1,7GRhBDsirIGkRZBtSMEzNTyDr2JQm4xx,2,1,1,0,0,0,0,0,2,0.2857142857142857,1,0.0,0,1,0,0,1,0,0,0,0,1,1,1
1450,21558,dQBjOw3ZDQ2EPHOdT4W6pRAoF6sniGIc,7GRhBDsirIGkRZBtSMEzNTyDr2JQm4xx,41,57,26,65,14,4,18,1,185,26.428571428571427,2,0.0,27,26,58,14,30,4,7,18,1,125,60,1
1451,21570,y9BxmAhm0ieCF6b0HaF7gMrGu5BDtZs5,7GRhBDsirIGkRZBtSMEzNTyDr2JQm4xx,59,214,88,99,63,2,32,0,498,71.14285714285714,3,0.0,110,88,81,63,104,2,18,32,0,342,156,0
1452,21638,mwc0YjZS72xD4dO6Zk7KmFewdh7PWkAS,7GRhBDsirIGkRZBtSMEzNTyDr2JQm4xx,27,89,25,33,30,2,3,0,182,26.0,4,0.0,59,25,32,30,30,2,1,3,0,146,36,0
1453,21659,D5mwgoAPtfwdsFrdNADBqEJQSy8E0CUi,7GRhBDsirIGkRZBtSMEzNTyDr2JQm4xx,38,55,24,63,22,0,20,0,184,26.285714285714285,4,0.0,24,24,57,22,31,0,6,20,0,127,57,0
1454,21690,mezQjcBtwPIB1SXkjHJo9kxjc5UIXdOH,7GRhBDsirIGkRZBtSMEzNTyDr2JQm4xx,29,45,20,36,18,0,3,0,122,17.428571428571427,2,0.0,21,20,30,18,24,0,6,3,0,89,33,1
1455,21708,aU6SEeOgxLKetBRDwfHMDunWavvfr54M,7GRhBDsirIGkRZBtSMEzNTyDr2JQm4xx,7,11,1,0,0,0,4,0,16,2.2857142857142856,2,0.0,0,1,0,0,11,0,0,4,0,1,15,0
1456,21820,GGGVxWw7kUcQH8IveSqLixfu0u0FTfvz,7GRhBDsirIGkRZBtSMEzNTyDr2JQm4xx,6,2,0,0,0,1,6,0,9,1.2857142857142858,1,0.0,0,0,0,0,2,1,0,6,0,0,9,1
1457,21870,3OGm4X1PEnAaZoBoZXt04kXOR4TFtoHS,7GRhBDsirIGkRZBtSMEzNTyDr2JQm4xx,9,5,2,11,3,1,3,0,25,3.5714285714285716,1,0.0,3,2,10,3,2,1,1,3,0,18,7,1
1458,21922,UyrB62TC80PvjIx5mHAqyBQJHo9hnImU,7GRhBDsirIGkRZBtSMEzNTyDr2JQm4xx,2,0,0,0,0,0,3,0,3,0.42857142857142855,1,0.0,0,0,0,0,0,0,0,3,0,0,3,1
1459,21976,MYCZGZUUB6h2kR5SWwXC3erQhe8wj439,7GRhBDsirIGkRZBtSMEzNTyDr2JQm4xx,3,2,1,0,0,0,2,0,5,0.7142857142857143,1,0.0,0,1,0,0,2,0,0,2,0,1,4,0
1460,21999,r6bvKJ2a2G72TbQZE3LacWwmKi7rGXEx,7GRhBDsirIGkRZBtSMEzNTyDr2JQm4xx,30,78,24,31,9,19,18,3,182,26.0,3,0.0,34,24,28,9,44,19,3,18,3,95,87,1
1461,22022,wXFfHtwd9smrvhh9NQW7SmEEo1001LDW,7GRhBDsirIGkRZBtSMEzNTyDr2JQm4xx,11,7,4,2,4,0,1,0,18,2.5714285714285716,1,0.0,2,4,2,4,5,0,0,1,0,12,6,1
1462,22062,MuwljKZkWjKmChDtxaHsKSqu30ykavpg,7GRhBDsirIGkRZBtSMEzNTyDr2JQm4xx,48,128,39,44,19,3,10,2,245,35.0,5,0.0,52,39,41,19,76,3,3,10,2,151,94,0
1463,22212,ezzV2inIlk654APZ7lOJdt6ubCpUxMCa,7GRhBDsirIGkRZBtSMEzNTyDr2JQm4xx,33,96,3,70,10,59,11,1,250,35.714285714285715,4,0.0,41,3,56,10,55,59,14,11,1,110,140,0
1464,22268,tixL6jRbFRYTnAeCUMfXKIdV2z5MfmCZ,7GRhBDsirIGkRZBtSMEzNTyDr2JQm4xx,32,23,20,14,14,0,9,0,80,11.428571428571429,1,0.0,1,20,11,14,22,0,3,9,0,46,34,1
1465,22640,SXQudUQxotVyHX3jIj58IdonMUWj4z4L,RXDvfPUBYFlVdlueBFbLW0mhhAyGEqpt,11,12,8,0,0,0,3,0,23,3.2857142857142856,2,0.0,0,8,0,0,12,0,0,3,0,8,15,0
1466,22647,ytmo5vQStkDdkr7G8Cx66kM5tANiVYa8,G8EPVSXsOYB5YQWZGiz1aVq5Pgr2GrQu,14,12,9,0,7,0,1,0,29,4.142857142857143,2,0.0,2,9,0,7,10,0,0,1,0,18,11,1
1467,22651,bPMM8JJVMbo3dHwzrkYwNanOXVlVjIZM,SpATywNh6bZuzm8s1ceuBUnMUAeoAHHw,15,13,13,0,12,0,1,0,39,5.571428571428571,3,0.0,0,13,0,12,13,0,0,1,0,25,14,0
1468,22655,DVzw8nYpE4lnf8MkHHhtHMESTcnd5SSm,A3fsA9Zfv1X2fVEQhTw51lKENdNrEqT3,7,3,2,0,2,0,4,0,11,1.5714285714285714,2,0.0,0,2,0,2,3,0,0,4,0,4,7,1
1469,22656,6r68uLeYBa0U5j97XGrLINpoFwwpiU0a,SpATywNh6bZuzm8s1ceuBUnMUAeoAHHw,16,52,2,5,1,0,6,0,66,9.428571428571429,4,0.0,13,2,5,1,39,0,0,6,0,21,45,0
1470,22658,3SER276qaao5TSZqnt0y9TkdmkGTUUcO,A3fsA9Zfv1X2fVEQhTw51lKENdNrEqT3,42,15,13,62,11,0,2,0,103,14.714285714285714,1,0.0,1,13,54,11,14,0,8,2,0,79,24,1
1471,22661,zgbCsvFYb3b53axsu4K7VNjBEGD1Bru2,G8EPVSXsOYB5YQWZGiz1aVq5Pgr2GrQu,30,94,3,26,3,49,19,3,197,28.142857142857142,2,0.0,12,3,22,3,82,49,4,19,3,40,157,1
1472,22663,v8EL49Rw5uIBfTnluJIiynUhJSONuHZw,A3fsA9Zfv1X2fVEQhTw51lKENdNrEqT3,24,7,2,38,0,0,1,0,48,6.857142857142857,2,0.0,2,2,38,0,5,0,0,1,0,42,6,1
1473,22666,8NZmD5KXyLIfbrDZRanIJvBfumgIsUhW,SpATywNh6bZuzm8s1ceuBUnMUAeoAHHw,10,19,6,8,1,0,4,0,38,5.428571428571429,3,0.0,7,6,7,1,12,0,1,4,0,21,17,0
1474,22672,xtQFPkqe4Pp8hbaCpifaLA8aJ90k2oDs,SpATywNh6bZuzm8s1ceuBUnMUAeoAHHw,20,67,1,12,2,0,4,0,86,12.285714285714286,4,0.0,22,1,9,2,45,0,3,4,0,34,52,0
1475,22675,FZWt1vapJFvo3kXFvlr3Pcq5dqSsXIdl,A3fsA9Zfv1X2fVEQhTw51lKENdNrEqT3,18,19,13,0,7,0,10,0,49,7.0,2,0.0,0,13,0,7,19,0,0,10,0,20,29,1
1476,22688,6aazLDsf7EAZ2t5BIjBNI9Ug5zAk9J2O,SpATywNh6bZuzm8s1ceuBUnMUAeoAHHw,29,29,15,20,6,5,7,0,82,11.714285714285714,2,0.0,4,15,18,6,25,5,2,7,0,43,39,0
1477,22699,f7tZxTkA0B7yOxMWeydGO2hW0y86mAhD,A3fsA9Zfv1X2fVEQhTw51lKENdNrEqT3,33,29,1,52,0,5,5,0,92,13.142857142857142,2,0.0,3,1,52,0,26,5,0,5,0,56,36,0
1478,22705,JoQg2qlyTB6aPyv163qnZSLUAy3J9zXZ,bWdj2GDclj5ofokWjzoa5jAwMkxCykd6,9,12,5,6,4,0,2,0,29,4.142857142857143,2,0.0,5,5,6,4,7,0,0,2,0,20,9,1
1479,22706,JoQg2qlyTB6aPyv163qnZSLUAy3J9zXZ,A3fsA9Zfv1X2fVEQhTw51lKENdNrEqT3,5,4,2,0,0,0,2,0,8,1.1428571428571428,2,0.0,0,2,0,0,4,0,0,2,0,2,6,1
1480,22711,TPPsOieQBcwqH8dqABTR3mddQ5gDzlZO,SpATywNh6bZuzm8s1ceuBUnMUAeoAHHw,27,34,14,41,8,0,9,0,106,15.142857142857142,2,0.0,18,14,35,8,16,0,6,9,0,75,31,0
1481,22720,4iz2t15J5bzEPElZVcStT3H8hpTNKJIQ,SpATywNh6bZuzm8s1ceuBUnMUAeoAHHw,13,19,7,14,0,2,3,0,45,6.428571428571429,2,0.0,7,7,12,0,12,2,2,3,0,26,19,0
1482,22733,IQ4ladQoM2x2909mlbY9xWKwXIcK6uEd,A3fsA9Zfv1X2fVEQhTw51lKENdNrEqT3,4,1,1,0,0,0,2,0,4,0.5714285714285714,1,0.0,0,1,0,0,1,0,0,2,0,1,3,0
1483,22737,Os09VRrdiO6C7gqaf1B7u0gzmL7FIPJg,SpATywNh6bZuzm8s1ceuBUnMUAeoAHHw,11,43,10,14,0,0,2,0,69,9.857142857142858,1,0.0,31,10,13,0,12,0,1,2,0,54,15,1
1484,22760,xQ0oPcnoBqnptb23qNnWO05KL2jCqFC5,SpATywNh6bZuzm8s1ceuBUnMUAeoAHHw,3,3,0,0,0,0,1,0,4,0.5714285714285714,2,0.0,0,0,0,0,3,0,0,1,0,0,4,1
1485,22779,Di3I8NyVIkGc06HLMDBeTqdX1iL5ZolI,A3fsA9Zfv1X2fVEQhTw51lKENdNrEqT3,6,0,0,0,0,4,12,0,16,2.2857142857142856,1,0.0,0,0,0,0,0,4,0,12,0,0,16,1
1486,22786,6TmTcNQyMYVAXbtK6HsQ96Mn7OGENU3z,bWdj2GDclj5ofokWjzoa5jAwMkxCykd6,4,2,1,0,0,0,2,0,5,0.7142857142857143,1,0.0,0,1,0,0,2,0,0,2,0,1,4,1
1487,22796,NEe9TsP56Xype0U6CLfwX8CaejtfAtDd,SpATywNh6bZuzm8s1ceuBUnMUAeoAHHw,17,46,2,21,0,2,16,1,88,12.571428571428571,2,0.0,20,2,18,0,26,2,3,16,1,40,48,0
1488,22805,6TmTcNQyMYVAXbtK6HsQ96Mn7OGENU3z,A3fsA9Zfv1X2fVEQhTw51lKENdNrEqT3,7,6,1,0,1,0,1,0,9,1.2857142857142858,1,0.0,0,1,0,1,6,0,0,1,0,2,7,1
1489,22822,jt6cAnJpqYCiS3Lj5wNBvifs8WZJznlF,A3fsA9Zfv1X2fVEQhTw51lKENdNrEqT3,9,4,3,0,3,0,3,0,13,1.8571428571428572,1,0.0,0,3,0,3,4,0,0,3,0,6,7,1
1490,22825,pgtfwPx3gBWk0s41FLIY8xNKvQvpnNYF,SpATywNh6bZuzm8s1ceuBUnMUAeoAHHw,25,41,1,25,2,9,13,1,92,13.142857142857142,1,0.0,12,1,19,2,29,9,6,13,1,34,58,0
1491,22828,pgtfwPx3gBWk0s41FLIY8xNKvQvpnNYF,A3fsA9Zfv1X2fVEQhTw51lKENdNrEqT3,10,5,1,0,1,2,10,2,21,3.0,3,0.0,0,1,0,1,5,2,0,10,2,2,19,1
1492,22844,TQIRy5vD7Rgv73APMCqQZ7AssMVX3u4N,A3fsA9Zfv1X2fVEQhTw51lKENdNrEqT3,22,12,10,0,8,0,5,0,35,5.0,3,0.0,0,10,0,8,12,0,0,5,0,18,17,1
1493,22847,uKSoXEJNhPBaLwogtj5AI2INbh67Hhkx,G8EPVSXsOYB5YQWZGiz1aVq5Pgr2GrQu,7,9,0,0,1,0,2,0,12,1.7142857142857142,1,0.0,2,0,0,1,7,0,0,2,0,3,9,1
1494,22849,Wd5Y51TL4njlLeYHUjz5D9nrsHvDXUZ8,A3fsA9Zfv1X2fVEQhTw51lKENdNrEqT3,61,21,15,112,9,3,13,1,174,24.857142857142858,2,0.0,2,15,102,9,19,3,10,13,1,128,46,0
1495,22855,4J9zAQq4ZlZzXgNIT2zhfBx7kGs24C6D,SpATywNh6bZuzm8s1ceuBUnMUAeoAHHw,30,31,16,26,8,21,16,0,118,16.857142857142858,5,0.0,10,16,25,8,21,21,1,16,0,59,59,0
1496,22858,xOeteuxexg2mP8NxgmLBWH8qhXnVfLfh,A3fsA9Zfv1X2fVEQhTw51lKENdNrEqT3,1,0,0,0,0,0,1,0,1,0.14285714285714285,1,0.0,0,0,0,0,0,0,0,1,0,0,1,1
1497,22867,ec87BaRQsrP5IAuQEXYeAFWoVPURyRtj,SpATywNh6bZuzm8s1ceuBUnMUAeoAHHw,18,19,9,11,5,0,4,0,48,6.857142857142857,1,0.0,6,9,10,5,13,0,1,4,0,30,18,0
1498,22882,53VGMeycKD8ekdZB7srikqwK1dcTbnwu,bWdj2GDclj5ofokWjzoa5jAwMkxCykd6,10,12,6,2,3,0,4,0,27,3.857142857142857,2,0.0,2,6,2,3,10,0,0,4,0,13,14,1
1499,22889,VXeEmbu1PPBvvH7wFjnGFaE2yqIFKByx,G8EPVSXsOYB5YQWZGiz1aVq5Pgr2GrQu,13,27,1,0,2,1,6,0,37,5.285714285714286,2,0.0,4,1,0,2,23,1,0,6,0,7,30,1
1500,22891,tnLfm9tutF6YoqDXNIONCmii1aynBy80,SpATywNh6bZuzm8s1ceuBUnMUAeoAHHw,17,30,13,14,3,4,10,0,74,10.571428571428571,3,0.0,4,13,11,3,26,4,3,10,0,31,43,0
1501,22893,fslIhUAreTqu48Va3DJjHuBASqZWV4lb,SpATywNh6bZuzm8s1ceuBUnMUAeoAHHw,9,10,0,3,0,0,2,0,15,2.142857142857143,1,0.0,0,0,3,0,10,0,0,2,0,3,12,0
1502,22896,kwtDMW6kCF4Dj4cVANDmT2RtqpyiMQZT,A3fsA9Zfv1X2fVEQhTw51lKENdNrEqT3,32,80,39,96,17,0,16,0,248,35.42857142857143,4,0.0,1,39,75,17,79,0,21,16,0,132,116,0
1503,22909,za2dBkPPLD9IPRBjooK7GJit2ulI5UgN,SpATywNh6bZuzm8s1ceuBUnMUAeoAHHw,12,14,5,18,0,9,5,1,52,7.428571428571429,2,0.0,7,5,15,0,7,9,3,5,1,27,25,0
1504,22916,dLoTMfurIDgppPqjn68MhR8oLIGjxbCC,A3fsA9Zfv1X2fVEQhTw51lKENdNrEqT3,12,26,13,0,5,0,9,1,54,7.714285714285714,4,0.0,0,13,0,5,26,0,0,9,1,18,36,1
1505,22917,faHDojVqWXLiB8t0I6HX2vfFaDqeEAWd,G8EPVSXsOYB5YQWZGiz1aVq5Pgr2GrQu,26,45,3,64,1,0,4,0,117,16.714285714285715,3,0.0,18,3,46,1,27,0,18,4,0,68,49,1
1506,22923,CbShtPgX8EbSEeSUeGV654dzDIai2s5c,G8EPVSXsOYB5YQWZGiz1aVq5Pgr2GrQu,4,8,0,0,1,0,1,0,10,1.4285714285714286,1,0.0,5,0,0,1,3,0,0,1,0,6,4,1
1507,22930,HrbizO8RcI1YFSo093sl97C3MRm3iZSm,SpATywNh6bZuzm8s1ceuBUnMUAeoAHHw,10,7,1,0,1,3,4,0,16,2.2857142857142856,2,0.0,0,1,0,1,7,3,0,4,0,2,14,1
1508,22939,za2dBkPPLD9IPRBjooK7GJit2ulI5UgN,A3fsA9Zfv1X2fVEQhTw51lKENdNrEqT3,12,8,4,0,3,0,5,0,20,2.857142857142857,2,0.0,0,4,0,3,8,0,0,5,0,7,13,1
1509,22960,G7eyYYWDjRzjfvQepcwnefZtLIHlQINA,SpATywNh6bZuzm8s1ceuBUnMUAeoAHHw,16,14,8,12,5,0,2,0,41,5.857142857142857,2,0.0,4,8,12,5,10,0,0,2,0,29,12,1
1510,22962,M6VmJD8JYDR5w6GV5uzAgWpIXM5eanml,G8EPVSXsOYB5YQWZGiz1aVq5Pgr2GrQu,86,124,66,130,34,15,8,1,378,54.0,1,0.0,49,66,97,34,75,15,33,8,1,246,132,0
1511,22969,dT92IjRcuruPiAlpqVUTtu3wNL9IIegT,A3fsA9Zfv1X2fVEQhTw51lKENdNrEqT3,12,14,4,0,1,0,4,0,23,3.2857142857142856,1,0.0,0,4,0,1,14,0,0,4,0,5,18,1
1512,22970,dT92IjRcuruPiAlpqVUTtu3wNL9IIegT,bWdj2GDclj5ofokWjzoa5jAwMkxCykd6,29,33,11,62,7,42,9,1,165,23.571428571428573,4,0.0,3,11,51,7,30,42,11,9,1,72,93,1
1513,22988,mYyzW7j4oHjgvbS0hfWvmpiecRMbZDgq,SpATywNh6bZuzm8s1ceuBUnMUAeoAHHw,14,15,7,27,3,0,2,0,54,7.714285714285714,1,0.0,6,7,21,3,9,0,6,2,0,37,17,1
1514,22993,WaZjCMCq9zHT0tGjpLu6Y2rc6ox0JLNd,A3fsA9Zfv1X2fVEQhTw51lKENdNrEqT3,17,13,10,0,9,0,11,0,43,6.142857142857143,1,0.0,0,10,0,9,13,0,0,11,0,19,24,1
1515,22996,W9f8UmYzSEsFhECsZDg6FwyOA22yb0R3,SpATywNh6bZuzm8s1ceuBUnMUAeoAHHw,18,26,16,24,6,49,8,0,129,18.428571428571427,4,0.0,4,16,20,6,22,49,4,8,0,46,83,0
1516,23002,QgNI0yI2W8R4yAAyuaSrYw2RL1D6EBzF,A3fsA9Zfv1X2fVEQhTw51lKENdNrEqT3,5,2,1,0,1,0,2,0,6,0.8571428571428571,1,0.0,0,1,0,1,2,0,0,2,0,2,4,1
1517,23006,UInMBEH8f1h2vxXVslRsWyLOTv8ggYq3,A3fsA9Zfv1X2fVEQhTw51lKENdNrEqT3,34,27,14,90,3,48,16,0,198,28.285714285714285,4,0.0,3,14,73,3,24,48,17,16,0,93,105,1
1518,23014,UInMBEH8f1h2vxXVslRsWyLOTv8ggYq3,bWdj2GDclj5ofokWjzoa5jAwMkxCykd6,13,15,9,12,0,55,11,1,103,14.714285714285714,5,0.0,1,9,12,0,14,55,0,11,1,22,81,0
1519,23049,I2ghGumCKIaVsnJOGZA0xyJzTnEm5KtW,SpATywNh6bZuzm8s1ceuBUnMUAeoAHHw,18,20,11,21,4,8,3,0,67,9.571428571428571,3,0.0,5,11,18,4,15,8,3,3,0,38,29,1
1520,23054,aOK5wIKpKN9ikUy2a1FUGeQDEt1AAFa3,G8EPVSXsOYB5YQWZGiz1aVq5Pgr2GrQu,11,10,7,0,1,0,6,0,24,3.4285714285714284,3,0.0,0,7,0,1,10,0,0,6,0,8,16,1
1521,23058,Dp9gZlmwGRMU0Crlqtgk7QHM4JW7fsY6,SpATywNh6bZuzm8s1ceuBUnMUAeoAHHw,9,9,0,12,0,0,1,0,22,3.142857142857143,1,0.0,5,0,9,0,4,0,3,1,0,14,8,0
1522,23061,PzUJiLnP9HZJxQE6JmMTkx1KTzCMtAvI,bWdj2GDclj5ofokWjzoa5jAwMkxCykd6,8,7,4,0,1,0,6,0,18,2.5714285714285716,1,0.0,0,4,0,1,7,0,0,6,0,5,13,1
1523,23063,mekJnkZy13R9odlyEHUcID5pf1ROn3NK,bWdj2GDclj5ofokWjzoa5jAwMkxCykd6,1,0,0,0,0,0,1,0,1,0.14285714285714285,1,0.0,0,0,0,0,0,0,0,1,0,0,1,1
1524,23066,wKKdkZJ3MevUShYy00jn3yNZpY2kcdrV,bWdj2GDclj5ofokWjzoa5jAwMkxCykd6,7,4,2,0,0,1,8,1,16,2.2857142857142856,2,0.0,0,2,0,0,4,1,0,8,1,2,14,1
1525,23068,mekJnkZy13R9odlyEHUcID5pf1ROn3NK,A3fsA9Zfv1X2fVEQhTw51lKENdNrEqT3,2,0,0,0,0,0,2,0,2,0.2857142857142857,1,0.0,0,0,0,0,0,0,0,2,0,0,2,1
1526,23073,gZWf27ETcHz4bBmwZPjiPumw55JZ4IOR,SpATywNh6bZuzm8s1ceuBUnMUAeoAHHw,28,43,0,38,3,67,9,1,161,23.0,2,0.0,22,0,34,3,21,67,4,9,1,59,102,0
1527,23084,mjoKY29bSBUSIg1iJCO4z3ZZIabGnClW,SpATywNh6bZuzm8s1ceuBUnMUAeoAHHw,16,25,8,24,4,28,1,0,90,12.857142857142858,1,0.0,10,8,18,4,15,28,6,1,0,40,50,0
1528,23091,aOhrgEBrLoAbudoZk6lY36jneHxQbWdO,G8EPVSXsOYB5YQWZGiz1aVq5Pgr2GrQu,6,5,2,0,0,0,3,1,11,1.5714285714285714,1,0.0,0,2,0,0,5,0,0,3,1,2,9,0
1529,23118,2wKdgTom3CXBb3VapzvEijoKrYgkRC9s,SpATywNh6bZuzm8s1ceuBUnMUAeoAHHw,25,31,26,8,14,13,17,3,112,16.0,1,0.0,0,26,8,14,31,13,0,17,3,48,64,0
1530,23130,hGDnsprgLmlBuNCzDAhbMdsa7xgZW8Z4,A3fsA9Zfv1X2fVEQhTw51lKENdNrEqT3,50,16,8,136,2,21,14,0,197,28.142857142857142,2,0.0,2,8,113,2,14,21,23,14,0,125,72,1
1531,23135,Emt7DBFLBFlleaJw0CDWZkbz2fh9bCe8,SpATywNh6bZuzm8s1ceuBUnMUAeoAHHw,15,11,8,0,5,0,6,0,30,4.285714285714286,1,0.0,0,8,0,5,11,0,0,6,0,13,17,1
1532,23137,adDGX99l1n1iBt8AmYVD4kO1enVdrmvn,SpATywNh6bZuzm8s1ceuBUnMUAeoAHHw,20,20,12,24,4,0,5,0,65,9.285714285714286,3,0.0,5,12,24,4,15,0,0,5,0,45,20,1
1533,23140,0Tg2flbTUdD7fODqYIfpiJiK0IDdFiOP,RXDvfPUBYFlVdlueBFbLW0mhhAyGEqpt,60,61,27,76,18,39,5,7,233,33.285714285714285,5,0.0,21,27,75,18,40,39,1,5,7,141,92,0
1534,23145,VO6tFMF3YqIQYaW8tkV9BLtheEJyKKQK,SpATywNh6bZuzm8s1ceuBUnMUAeoAHHw,18,15,10,12,6,1,4,0,48,6.857142857142857,2,0.0,3,10,10,6,12,1,2,4,0,29,19,0
1535,23174,dpHLF21uvMbokNNTJHdbSyHoiwNjC5Qc,RXDvfPUBYFlVdlueBFbLW0mhhAyGEqpt,7,5,3,0,2,3,1,0,14,2.0,1,0.0,0,3,0,2,5,3,0,1,0,5,9,1
1536,23181,PwNax3W8g4wFzRQCUhWcP9EnmZeticjo,SpATywNh6bZuzm8s1ceuBUnMUAeoAHHw,26,25,12,12,8,1,1,0,59,8.428571428571429,2,0.0,12,12,12,8,13,1,0,1,0,44,15,1
1537,23182,CBLeEN4LtKF8I3pqDKXGm8PyJoErUnYX,A3fsA9Zfv1X2fVEQhTw51lKENdNrEqT3,10,9,1,0,1,1,3,0,15,2.142857142857143,1,0.0,0,1,0,1,9,1,0,3,0,2,13,1
1538,23186,jOKGDo32k5y1tQ1HBtDhmlq3GlvnMuW4,A3fsA9Zfv1X2fVEQhTw51lKENdNrEqT3,9,7,5,0,3,0,4,0,19,2.7142857142857144,2,0.0,0,5,0,3,7,0,0,4,0,8,11,1
1539,23188,HycevJIm7cBjf1oJ5QCBMMXEBTG8jyRF,RXDvfPUBYFlVdlueBFbLW0mhhAyGEqpt,28,49,31,31,4,37,25,1,178,25.428571428571427,4,0.0,10,31,29,4,39,37,2,25,1,74,104,0
1540,23189,ClKPcHfoSfkiUFto4BTBZmMJfgBwADCv,bWdj2GDclj5ofokWjzoa5jAwMkxCykd6,4,2,1,0,1,0,1,0,5,0.7142857142857143,1,0.0,0,1,0,1,2,0,0,1,0,2,3,1
1541,23203,YBZJfjYuKfwb2VLWbDlKIMN1YSYXBGau,A3fsA9Zfv1X2fVEQhTw51lKENdNrEqT3,10,7,5,0,3,1,2,0,18,2.5714285714285716,1,0.0,0,5,0,3,7,1,0,2,0,8,10,1
1542,23216,BdGjvuZcr0pZwpTvi8kd6szBp0GhSFRx,bWdj2GDclj5ofokWjzoa5jAwMkxCykd6,10,10,6,0,5,0,5,0,26,3.7142857142857144,1,0.0,2,6,0,5,8,0,0,5,0,13,13,1
1543,23229,AjE14bAFpRvd1b44PmMUpBPn2loehR8N,SpATywNh6bZuzm8s1ceuBUnMUAeoAHHw,14,16,2,15,3,0,4,0,40,5.714285714285714,1,0.0,4,2,14,3,12,0,1,4,0,23,17,1
1544,23230,qJSVGIIBKQpzllCeTCwG3pgdEZIo3QRz,A3fsA9Zfv1X2fVEQhTw51lKENdNrEqT3,8,4,1,4,0,0,8,0,17,2.4285714285714284,2,0.0,0,1,3,0,4,0,1,8,0,4,13,1
1545,23241,wmmgynPgGzw7ypLLU9vcdxog9SI7Juul,RXDvfPUBYFlVdlueBFbLW0mhhAyGEqpt,3,2,1,0,0,0,1,0,4,0.5714285714285714,1,0.0,0,1,0,0,2,0,0,1,0,1,3,1
1546,23254,3rBX9dOAFMfNlnyfBe9F26nbNxp33Uvk,G8EPVSXsOYB5YQWZGiz1aVq5Pgr2GrQu,20,21,7,0,6,1,13,1,49,7.0,3,0.0,0,7,0,6,21,1,0,13,1,13,36,1
1547,23255,FfhVetKUzu5KpGrHLPHaynXPJghmm3It,SpATywNh6bZuzm8s1ceuBUnMUAeoAHHw,20,21,1,17,2,0,2,0,43,6.142857142857143,1,0.0,6,1,16,2,15,0,1,2,0,25,18,0
1548,23259,xqwUV9iQK4erbWJ9fEZ3Fau5k4aAZ9DO,SpATywNh6bZuzm8s1ceuBUnMUAeoAHHw,9,13,6,18,0,0,6,0,43,6.142857142857143,2,0.0,4,6,15,0,9,0,3,6,0,25,18,0
1549,23263,tnLfm9tutF6YoqDXNIONCmii1aynBy80,A3fsA9Zfv1X2fVEQhTw51lKENdNrEqT3,3,2,1,0,0,0,1,0,4,0.5714285714285714,1,0.0,0,1,0,0,2,0,0,1,0,1,3,1
1550,23264,XTgYONXtkRAl3sCFaGFF8e1mU9AMcEwg,SpATywNh6bZuzm8s1ceuBUnMUAeoAHHw,11,10,7,0,5,0,5,0,27,3.857142857142857,2,0.0,0,7,0,5,10,0,0,5,0,12,15,1
1551,23265,knRZtWEcWI5MFAs7PYIJdk2jdyAY8A24,SpATywNh6bZuzm8s1ceuBUnMUAeoAHHw,15,19,6,8,3,0,4,0,40,5.714285714285714,1,0.0,9,6,8,3,10,0,0,4,0,26,14,0
1552,23268,XJpmNtat26NZxNAZqQE63m1qpYdHanqw,RXDvfPUBYFlVdlueBFbLW0mhhAyGEqpt,65,60,34,88,23,7,2,0,214,30.571428571428573,1,0.0,15,34,82,23,45,7,6,2,0,154,60,0
1553,23281,peL7W7HsPQXwJW8IfNPUpznrjT13FLeH,SpATywNh6bZuzm8s1ceuBUnMUAeoAHHw,4,3,0,0,0,0,4,0,7,1.0,1,0.0,0,0,0,0,3,0,0,4,0,0,7,1
1554,23288,pLQfsJL46iqa9L7UfI8ODNozilMqoPl0,A3fsA9Zfv1X2fVEQhTw51lKENdNrEqT3,7,4,3,0,2,0,2,0,11,1.5714285714285714,1,0.0,0,3,0,2,4,0,0,2,0,5,6,1
1555,23297,3cB0rEpxJxC0jjqfQ9EPT6ntxFajOXrx,A3fsA9Zfv1X2fVEQhTw51lKENdNrEqT3,45,45,29,176,6,0,7,0,263,37.57142857142857,3,0.0,7,29,151,6,38,0,25,7,0,193,70,0
1556,23304,WEwbMamm1WQzZcIYKs7fv3KkFwrZAu4n,SpATywNh6bZuzm8s1ceuBUnMUAeoAHHw,17,23,13,15,6,4,5,0,66,9.428571428571429,2,0.0,6,13,15,6,17,4,0,5,0,40,26,0
1557,23307,S1PbXrIuvwc8AvxDGKhjkWzwRdM8cFN0,SpATywNh6bZuzm8s1ceuBUnMUAeoAHHw,13,13,8,6,0,0,2,0,29,4.142857142857143,2,0.0,2,8,6,0,11,0,0,2,0,16,13,0
1558,23308,P0KoQHPz5chEfkMzzCMKKbnUkwSC15gh,G8EPVSXsOYB5YQWZGiz1aVq5Pgr2GrQu,1,0,0,0,0,0,1,0,1,0.14285714285714285,1,0.0,0,0,0,0,0,0,0,1,0,0,1,1
1559,23311,fE7crtUj4hDSQo6ITE7OJYFi4AN2F95M,A3fsA9Zfv1X2fVEQhTw51lKENdNrEqT3,38,25,13,92,8,2,5,0,145,20.714285714285715,1,0.0,1,13,75,8,24,2,17,5,0,97,48,1
1560,23313,TXBaUi0GpvXZWCDXsKlkFWTtfaT87UMz,bWdj2GDclj5ofokWjzoa5jAwMkxCykd6,3,2,1,0,0,0,1,0,4,0.5714285714285714,1,0.0,0,1,0,0,2,0,0,1,0,1,3,1
1561,23341,1cMpA6zMPA0affI3yASPkTig9lUEcx1e,G8EPVSXsOYB5YQWZGiz1aVq5Pgr2GrQu,7,11,6,0,1,63,10,0,91,13.0,3,0.0,0,6,0,1,11,63,0,10,0,7,84,1
1562,23358,dob27oJoC3Vd5K1oOuihpbNGBh5pIGaM,SpATywNh6bZuzm8s1ceuBUnMUAeoAHHw,4,4,1,0,0,0,1,0,6,0.8571428571428571,1,0.0,0,1,0,0,4,0,0,1,0,1,5,1
1563,23388,HZWZtPkCTeK90eQ90MHe5cWcAqiVgkGk,bWdj2GDclj5ofokWjzoa5jAwMkxCykd6,11,7,4,50,2,3,5,0,71,10.142857142857142,1,0.0,1,4,48,2,6,3,2,5,0,55,16,0
1564,23390,lfrqXPATBesMooHpdCa9ZnxlXhb59rmp,SpATywNh6bZuzm8s1ceuBUnMUAeoAHHw,17,49,36,0,13,0,6,0,104,14.857142857142858,2,0.0,5,36,0,13,44,0,0,6,0,54,50,1
1565,23399,QUw5YB8tw6ArwfIF1vjOH2aXsMxDBB6n,SpATywNh6bZuzm8s1ceuBUnMUAeoAHHw,9,9,5,0,3,0,4,0,21,3.0,2,0.0,0,5,0,3,9,0,0,4,0,8,13,0
1566,23405,3AFvyqpOB7zyiycGY1NpbFOUZUj9K9Bb,SpATywNh6bZuzm8s1ceuBUnMUAeoAHHw,16,11,7,6,3,0,2,0,29,4.142857142857143,1,0.0,2,7,6,3,9,0,0,2,0,18,11,1
1567,23416,1ulA4jhwI0WhLE9MVLjWBxEEeOzdq7WL,SpATywNh6bZuzm8s1ceuBUnMUAeoAHHw,1,0,0,0,0,0,1,0,1,0.14285714285714285,1,0.0,0,0,0,0,0,0,0,1,0,0,1,0
1568,23440,lHNqd6KTSO9CrJzRDAqosVITLVN3mMHR,bWdj2GDclj5ofokWjzoa5jAwMkxCykd6,37,29,18,208,8,0,7,0,270,38.57142857142857,2,0.0,7,18,194,8,22,0,14,7,0,227,43,1
1569,23450,RKjVof9Yhxeyyya4gtkZu1fqgIbPHIOB,A3fsA9Zfv1X2fVEQhTw51lKENdNrEqT3,17,16,10,0,5,14,17,5,67,9.571428571428571,4,0.0,1,10,0,5,15,14,0,17,5,16,51,0
1570,23452,iEsDxJ2LNGTFl1t0aAKhf24FeoeDy4PX,G8EPVSXsOYB5YQWZGiz1aVq5Pgr2GrQu,5,4,0,0,1,0,1,0,6,0.8571428571428571,1,0.0,0,0,0,1,4,0,0,1,0,1,5,1
1571,23457,wLAgbiz3XWV6Nef8pQe1TlLxUN8CIoJ8,G8EPVSXsOYB5YQWZGiz1aVq5Pgr2GrQu,1,0,0,0,0,0,1,0,1,0.14285714285714285,1,0.0,0,0,0,0,0,0,0,1,0,0,1,1
1572,23477,wctOEAfOfHjaIn2ukTVBg3NDDfP2Pt1c,SpATywNh6bZuzm8s1ceuBUnMUAeoAHHw,15,25,14,10,3,0,6,0,58,8.285714285714286,3,0.0,4,14,9,3,21,0,1,6,0,30,28,0
1573,23490,Id4UmIRRQiLXHoJYSjh5OCO1CRaFgQ2K,SpATywNh6bZuzm8s1ceuBUnMUAeoAHHw,19,26,11,14,6,4,6,0,67,9.571428571428571,2,0.0,8,11,11,6,18,4,3,6,0,36,31,1
1574,23510,GIb3glgYrsEfHWtEWPWpwONqwE7RMf6f,A3fsA9Zfv1X2fVEQhTw51lKENdNrEqT3,43,31,18,112,6,0,13,0,180,25.714285714285715,3,0.0,3,18,101,6,28,0,11,13,0,128,52,0
1575,23515,Oqfkhjg6t51PZcyyCwvjWtQ6bDHYceB1,SpATywNh6bZuzm8s1ceuBUnMUAeoAHHw,19,46,28,12,9,18,6,0,119,17.0,4,0.0,11,28,10,9,35,18,2,6,0,58,61,0
1576,23516,PzbAAQBdNIO5q0hDkxJETX7v12Y9h0xH,SpATywNh6bZuzm8s1ceuBUnMUAeoAHHw,7,6,1,0,1,0,3,0,11,1.5714285714285714,1,0.0,0,1,0,1,6,0,0,3,0,2,9,0
1577,23519,DsdEYwXt7PO92K8VROCVVtUqrprzaIo4,A3fsA9Zfv1X2fVEQhTw51lKENdNrEqT3,46,26,17,88,10,1,24,1,167,23.857142857142858,2,0.0,2,17,71,10,24,1,17,24,1,100,67,1
1578,23542,d4mvkfcwFcYKWYB1PuCW432MT8LvqlFh,SpATywNh6bZuzm8s1ceuBUnMUAeoAHHw,27,33,20,38,11,0,7,0,109,15.571428571428571,3,0.0,10,20,36,11,23,0,2,7,0,77,32,1
1579,23552,H0WeKsbXeLHWXz7EV7ygxgCQNCt5DOUD,SpATywNh6bZuzm8s1ceuBUnMUAeoAHHw,17,25,14,23,6,0,3,0,71,10.142857142857142,3,0.0,4,14,19,6,21,0,4,3,0,43,28,0
1580,23554,bVCYDQX7pJxff6OyJX4M9s17AtFlpk5i,SpATywNh6bZuzm8s1ceuBUnMUAeoAHHw,10,18,12,0,7,0,6,0,43,6.142857142857143,2,0.0,0,12,0,7,18,0,0,6,0,19,24,1
1581,23573,MwhE2MowwPvamSVFrLUWaatDsrzcIgQY,SpATywNh6bZuzm8s1ceuBUnMUAeoAHHw,5,2,1,0,1,3,2,0,9,1.2857142857142858,1,0.0,0,1,0,1,2,3,0,2,0,2,7,0
1582,23585,NRdQjU0MJFdxtbDqiTrBcJcd064egve1,SpATywNh6bZuzm8s1ceuBUnMUAeoAHHw,12,21,12,6,0,3,10,0,52,7.428571428571429,1,0.0,5,12,5,0,16,3,1,10,0,22,30,1
1583,23588,DHUv7XpIZcPp2QYGNmTXjhgg7Zq4BpJ7,RXDvfPUBYFlVdlueBFbLW0mhhAyGEqpt,1,0,0,0,0,0,1,0,1,0.14285714285714285,1,0.0,0,0,0,0,0,0,0,1,0,0,1,1
1584,23595,0EotlIgKGd3opCDMhDC2aBqeeKmFST46,A3fsA9Zfv1X2fVEQhTw51lKENdNrEqT3,2,0,0,0,0,0,4,0,4,0.5714285714285714,1,0.0,0,0,0,0,0,0,0,4,0,0,4,1
1585,23596,DdGVDKNQwSkPIQKeE1XouOkZR5kVZ7SK,SpATywNh6bZuzm8s1ceuBUnMUAeoAHHw,19,27,7,14,3,0,6,0,57,8.142857142857142,2,0.0,8,7,11,3,19,0,3,6,0,29,28,1
1586,23597,lLz9WbehghUNLRABDjzrIp7BjBkWjoW9,SpATywNh6bZuzm8s1ceuBUnMUAeoAHHw,6,5,2,0,1,0,2,0,10,1.4285714285714286,1,0.0,0,2,0,1,5,0,0,2,0,3,7,1
1587,23603,0wJhtCWK60WPCeRF62m8T80DtNpWhRrg,SpATywNh6bZuzm8s1ceuBUnMUAeoAHHw,26,34,16,32,5,0,7,1,95,13.571428571428571,2,0.0,14,16,28,5,20,0,4,7,1,63,32,0
1588,23633,o6ILANWxUGmdLZhlBol9mZCEolnG5bhy,SpATywNh6bZuzm8s1ceuBUnMUAeoAHHw,14,13,10,0,5,3,5,0,36,5.142857142857143,4,0.0,0,10,0,5,13,3,0,5,0,15,21,1
1589,23639,tMPZYG0DCvDSDEuO4KsQAdk0iwwmXKYt,A3fsA9Zfv1X2fVEQhTw51lKENdNrEqT3,6,6,3,0,0,0,2,0,11,1.5714285714285714,2,0.0,0,3,0,0,6,0,0,2,0,3,8,0
1590,23640,9uqkwYb5ddQJIw4su6OaF1hwvWEdLp1S,A3fsA9Zfv1X2fVEQhTw51lKENdNrEqT3,29,29,19,0,13,0,6,0,67,9.571428571428571,4,0.0,0,19,0,13,29,0,0,6,0,32,35,0
1591,23647,3rCZba8eKP7jaFsDjNb32WoGn9BjnrjN,bWdj2GDclj5ofokWjzoa5jAwMkxCykd6,1,0,0,0,0,0,1,0,1,0.14285714285714285,1,0.0,0,0,0,0,0,0,0,1,0,0,1,1
1592,23671,9sTtmQQAXG5XvwtZJPuuRKLnfgaYWfWO,SpATywNh6bZuzm8s1ceuBUnMUAeoAHHw,21,23,9,26,4,0,2,0,64,9.142857142857142,1,0.0,13,9,24,4,10,0,2,2,0,50,14,1
1593,23674,l9KseRU4xYtwOzoILYmGcicF0iiXQqxl,SpATywNh6bZuzm8s1ceuBUnMUAeoAHHw,20,24,11,10,4,16,10,1,76,10.857142857142858,3,0.0,5,11,8,4,19,16,2,10,1,28,48,0
1594,23675,pJj2PU7RZQK2Nwrb96O5DurQcsPoqkDx,bWdj2GDclj5ofokWjzoa5jAwMkxCykd6,1,0,0,0,0,0,2,0,2,0.2857142857142857,1,0.0,0,0,0,0,0,0,0,2,0,0,2,1
1595,23692,zJ99WhK6aN6yEmbpXd5cJuqKo0p9kPsD,RXDvfPUBYFlVdlueBFbLW0mhhAyGEqpt,59,41,22,78,16,2,14,1,174,24.857142857142858,3,0.0,16,22,74,16,25,2,4,14,1,128,46,1
1596,23710,3iJrlZJEv2h7DgWBpz6wZtSXPXEy6IAY,A3fsA9Zfv1X2fVEQhTw51lKENdNrEqT3,9,10,6,0,4,0,4,0,24,3.4285714285714284,3,0.0,0,6,0,4,10,0,0,4,0,10,14,0
1597,23711,POOwrt9teJiwgIKzPgqwiwhGp5kUKv01,SpATywNh6bZuzm8s1ceuBUnMUAeoAHHw,15,15,10,12,6,3,1,0,47,6.714285714285714,1,0.0,2,10,10,6,13,3,2,1,0,28,19,0
1598,23716,epEhe5zjAdMHelSWe8cywAVR1iLucvwI,SpATywNh6bZuzm8s1ceuBUnMUAeoAHHw,4,2,0,0,0,0,2,0,4,0.5714285714285714,1,0.0,0,0,0,0,2,0,0,2,0,0,4,1
1599,23723,aX5o3K4conQ4SoTRN7MBCmGaArjn5YFA,SpATywNh6bZuzm8s1ceuBUnMUAeoAHHw,5,2,1,0,1,0,3,0,7,1.0,1,0.0,0,1,0,1,2,0,0,3,0,2,5,1
1600,23725,wNbKFPX6oYsfVEr8buyWthBblPuPZGxv,SpATywNh6bZuzm8s1ceuBUnMUAeoAHHw,1,0,0,0,0,0,1,0,1,0.14285714285714285,1,0.0,0,0,0,0,0,0,0,1,0,0,1,1
1601,23740,oJ9j9ejTgKixczg3tSE8Sg8DPI7YQpJq,SpATywNh6bZuzm8s1ceuBUnMUAeoAHHw,17,21,11,6,2,0,6,0,46,6.571428571428571,2,0.0,8,11,6,2,13,0,0,6,0,27,19,0
1602,23745,Ot8esbQhlnTNYRjqPJ5gBbiW6Aw8bpdE,G8EPVSXsOYB5YQWZGiz1aVq5Pgr2GrQu,1,0,0,0,0,0,1,0,1,0.14285714285714285,1,0.0,0,0,0,0,0,0,0,1,0,0,1,1
1603,23752,oW1SPRE23Cu85GeGZYRmhPcFuXq6dZoG,SpATywNh6bZuzm8s1ceuBUnMUAeoAHHw,27,46,23,15,10,3,13,0,110,15.714285714285714,3,0.0,16,23,14,10,30,3,1,13,0,63,47,0
1604,23754,atxTINx1wNa0Kz1uw7bW34Z47POxkGeq,SpATywNh6bZuzm8s1ceuBUnMUAeoAHHw,21,42,8,14,7,3,33,0,107,15.285714285714286,5,0.0,2,8,13,7,40,3,1,33,0,30,77,0
1605,23760,6uy0rYsVs6ntSHgwhJ1mwDkW5uKAQxi4,SpATywNh6bZuzm8s1ceuBUnMUAeoAHHw,12,23,12,0,4,0,5,0,44,6.285714285714286,3,0.0,0,12,0,4,23,0,0,5,0,16,28,1
1606,23771,zG5wQdjarSEp1xTKP5FU2TvutBYexg1v,bWdj2GDclj5ofokWjzoa5jAwMkxCykd6,6,12,0,0,0,0,4,0,16,2.2857142857142856,1,0.0,1,0,0,0,11,0,0,4,0,1,15,1
1607,23773,35E85h2ExBPeTd1VmxNX0GKo8krIMsCP,SpATywNh6bZuzm8s1ceuBUnMUAeoAHHw,17,30,10,11,5,0,2,0,58,8.285714285714286,2,0.0,18,10,11,5,12,0,0,2,0,44,14,1
1608,23789,i1f7BljhTNgVMfGOHZ66OYaR3kNetCAs,SpATywNh6bZuzm8s1ceuBUnMUAeoAHHw,8,12,0,14,0,5,2,0,33,4.714285714285714,2,0.0,5,0,14,0,7,5,0,2,0,19,14,0
1609,23795,bHKiB8yjzvUwkeHE5fxnHNywx47ldJ6B,SpATywNh6bZuzm8s1ceuBUnMUAeoAHHw,15,26,2,12,2,0,4,0,46,6.571428571428571,3,0.0,5,2,10,2,21,0,2,4,0,19,27,1
1610,23798,GOPMGFz5xoFESgugOmv6JtNIOPfS0GCX,SpATywNh6bZuzm8s1ceuBUnMUAeoAHHw,6,7,1,0,1,0,5,0,14,2.0,2,0.0,0,1,0,1,7,0,0,5,0,2,12,0
1611,23806,uxWndEUVVRQyohhChNH7OrcMXH2VCOhT,SpATywNh6bZuzm8s1ceuBUnMUAeoAHHw,10,11,2,0,1,0,2,0,16,2.2857142857142856,2,0.0,0,2,0,1,11,0,0,2,0,3,13,1
1612,23812,6GriNnzq8xnsLEV5ztRmUAFnPPewwL0q,A3fsA9Zfv1X2fVEQhTw51lKENdNrEqT3,29,16,8,64,0,0,6,0,94,13.428571428571429,3,0.0,3,8,56,0,13,0,8,6,0,67,27,1
1613,23836,83Gotur1nDdhzZnnscpduWQ3wLNBDtA6,SpATywNh6bZuzm8s1ceuBUnMUAeoAHHw,12,15,1,22,0,0,3,0,41,5.857142857142857,1,0.0,8,1,18,0,7,0,4,3,0,27,14,1
1614,23840,FBu5R2eGEtl9EDw0VwXtH1t5i2ELpdqI,SpATywNh6bZuzm8s1ceuBUnMUAeoAHHw,6,7,2,0,0,0,5,0,14,2.0,1,0.0,0,2,0,0,7,0,0,5,0,2,12,1
1615,23841,7Vj4ziukCVrVZvt93RQ91d2zl9J3pERE,SpATywNh6bZuzm8s1ceuBUnMUAeoAHHw,17,22,13,6,5,0,6,0,52,7.428571428571429,2,0.0,5,13,5,5,17,0,1,6,0,28,24,1
1616,23852,dFrBZuKOTxv7Ek84BAuACScgZVHLiPRz,SpATywNh6bZuzm8s1ceuBUnMUAeoAHHw,4,3,0,0,0,0,2,0,5,0.7142857142857143,1,0.0,0,0,0,0,3,0,0,2,0,0,5,1
1617,23855,4okppsrdnKYxqs2gLNMiS6gb60QmM8WN,RXDvfPUBYFlVdlueBFbLW0mhhAyGEqpt,21,23,16,46,1,0,7,6,99,14.142857142857142,3,0.0,4,16,40,1,19,0,6,7,6,61,38,1
1618,23857,840TvauCMn8hUpsV90vm3IXVVzLXLwLs,A3fsA9Zfv1X2fVEQhTw51lKENdNrEqT3,35,43,1,80,0,0,3,0,127,18.142857142857142,2,0.0,6,1,70,0,37,0,10,3,0,77,50,1
1619,23862,YxEAEqB4R6GTRBWDvga1GWE0URAxGc6U,A3fsA9Zfv1X2fVEQhTw51lKENdNrEqT3,6,5,4,0,0,0,1,0,10,1.4285714285714286,1,0.0,0,4,0,0,5,0,0,1,0,4,6,1
1620,23863,3Ta0rfBtrbiqFMIpcV3b3USyW2ELEZd2,bWdj2GDclj5ofokWjzoa5jAwMkxCykd6,13,22,2,6,5,9,12,2,58,8.285714285714286,2,0.0,5,2,5,5,17,9,1,12,2,17,41,1
1621,23872,7iw4UiR57uyLjfIdpxq0wONlaNvYfNiV,SpATywNh6bZuzm8s1ceuBUnMUAeoAHHw,1,0,0,0,0,0,1,0,1,0.14285714285714285,1,0.0,0,0,0,0,0,0,0,1,0,0,1,1
1622,23874,986WgoFI0AZSDPIvWwBI8MUZveW4E4Xu,RXDvfPUBYFlVdlueBFbLW0mhhAyGEqpt,14,30,15,0,7,0,4,0,56,8.0,3,0.0,0,15,0,7,30,0,0,4,0,22,34,0
1623,23891,FBu5R2eGEtl9EDw0VwXtH1t5i2ELpdqI,A3fsA9Zfv1X2fVEQhTw51lKENdNrEqT3,4,4,2,0,0,0,3,0,9,1.2857142857142858,1,0.0,0,2,0,0,4,0,0,3,0,2,7,1
1624,23893,dkQw8oK3XR4qlNNv9mJoCG5KMSpfLA0u,SpATywNh6bZuzm8s1ceuBUnMUAeoAHHw,29,20,12,31,7,9,7,1,87,12.428571428571429,2,0.0,6,12,28,7,14,9,3,7,1,53,34,1
1625,23895,g7nx8KecXhqsIkJIviLtJahoCAcu06DW,SpATywNh6bZuzm8s1ceuBUnMUAeoAHHw,2,0,0,0,0,0,2,0,2,0.2857142857142857,1,0.0,0,0,0,0,0,0,0,2,0,0,2,1
1626,23901,4dLqJDBbl4XgAFoagStv97aI3aHRciy5,SpATywNh6bZuzm8s1ceuBUnMUAeoAHHw,5,3,2,0,1,0,1,0,7,1.0,1,0.0,0,2,0,1,3,0,0,1,0,3,4,1
1627,23909,B7s9DHPpvHggi4c4m5C7RuYNMMAUXQfR,SpATywNh6bZuzm8s1ceuBUnMUAeoAHHw,8,10,6,0,5,0,4,0,25,3.5714285714285716,1,0.0,0,6,0,5,10,0,0,4,0,11,14,1
1628,23920,v5teTtQ61doFtyEryEU1FEZNTQeJUrxX,SpATywNh6bZuzm8s1ceuBUnMUAeoAHHw,15,24,2,12,0,0,5,0,43,6.142857142857143,2,0.0,10,2,12,0,14,0,0,5,0,24,19,0
1629,23926,haBS6HInfRwWNu7SJCbVrmAnlh8blC7U,SpATywNh6bZuzm8s1ceuBUnMUAeoAHHw,1,0,0,0,0,0,1,0,1,0.14285714285714285,1,0.0,0,0,0,0,0,0,0,1,0,0,1,1
1630,23942,yk8HuNxXIum8r8XDIOHqnAVeWfg9tYo1,A3fsA9Zfv1X2fVEQhTw51lKENdNrEqT3,7,5,4,0,1,0,5,0,15,2.142857142857143,2,0.0,0,4,0,1,5,0,0,5,0,5,10,1
1631,23944,ZKAk08L8Iriz8Uv5UOeqSbrNnzg1rlMz,RXDvfPUBYFlVdlueBFbLW0mhhAyGEqpt,8,4,3,0,2,0,2,0,11,1.5714285714285714,1,0.0,0,3,0,2,4,0,0,2,0,5,6,0
1632,23955,5mJ1itg2cQYRNscuJuLNd4sNUrdim8JB,bWdj2GDclj5ofokWjzoa5jAwMkxCykd6,15,19,8,10,3,0,7,2,49,7.0,1,0.0,4,8,8,3,15,0,2,7,2,23,26,0
1633,23975,xCPsccPRbQTL93kwam6OPz5i1lU77hqE,SpATywNh6bZuzm8s1ceuBUnMUAeoAHHw,19,16,0,6,0,3,8,0,33,4.714285714285714,2,0.0,1,0,6,0,15,3,0,8,0,7,26,0
1634,23976,PSJftXZeDfoFySmsRqkLgFson1mEyJqX,SpATywNh6bZuzm8s1ceuBUnMUAeoAHHw,21,35,14,20,5,21,20,1,116,16.571428571428573,4,0.0,18,14,17,5,17,21,3,20,1,54,62,0
1635,23982,3W09pasLSoDWuQqGyvECJ7WiykG165j2,RXDvfPUBYFlVdlueBFbLW0mhhAyGEqpt,10,10,6,0,3,0,2,0,21,3.0,2,0.0,1,6,0,3,9,0,0,2,0,10,11,1
1636,23985,T23nrSnpQ3vWpr6CtL4ZskVcSM0KOOu0,A3fsA9Zfv1X2fVEQhTw51lKENdNrEqT3,13,7,6,0,6,0,3,0,22,3.142857142857143,1,0.0,0,6,0,6,7,0,0,3,0,12,10,1
1637,24006,FrLEzodgON5rcdCDFBdqJa5CoY6xgWo9,G8EPVSXsOYB5YQWZGiz1aVq5Pgr2GrQu,2,0,0,0,0,1,1,0,2,0.2857142857142857,1,0.0,0,0,0,0,0,1,0,1,0,0,2,1
1638,24015,op8q14GHWgkmIf6XOfnEOFm5IfQDADrc,SpATywNh6bZuzm8s1ceuBUnMUAeoAHHw,4,2,1,0,1,0,1,0,5,0.7142857142857143,1,0.0,0,1,0,1,2,0,0,1,0,2,3,1
1639,24019,tML4IQ8jFiP4YuH9NbvzKQFqAdof0qcO,G8EPVSXsOYB5YQWZGiz1aVq5Pgr2GrQu,55,67,1,144,1,25,13,0,251,35.857142857142854,5,0.0,11,1,117,1,56,25,27,13,0,130,121,0
1640,24035,j5UlwBty5MOwHf8rgRJk1hdlEvwivM1k,SpATywNh6bZuzm8s1ceuBUnMUAeoAHHw,21,52,29,15,9,6,30,0,141,20.142857142857142,6,0.0,7,29,15,9,45,6,0,30,0,60,81,0
1641,24036,tx5OjuBvtxXu3JLfhVRvs5pDkriVKuCZ,SpATywNh6bZuzm8s1ceuBUnMUAeoAHHw,2,0,0,0,0,0,2,0,2,0.2857142857142857,1,0.0,0,0,0,0,0,0,0,2,0,0,2,1
1642,24046,5C3sCk6rXQc2OvYtSBZh5PoYxtIPWyJ2,SpATywNh6bZuzm8s1ceuBUnMUAeoAHHw,5,4,4,0,0,0,2,0,10,1.4285714285714286,1,0.0,0,4,0,0,4,0,0,2,0,4,6,1
1643,24050,vJOEMmX7SHj3LcECHogPAykr3CpSjcOR,SpATywNh6bZuzm8s1ceuBUnMUAeoAHHw,9,7,5,0,4,0,2,0,18,2.5714285714285716,1,0.0,0,5,0,4,7,0,0,2,0,9,9,0
1644,24053,eosk3dY7502Pbg6Dsnx0qWKWUpRTliXK,A3fsA9Zfv1X2fVEQhTw51lKENdNrEqT3,28,18,2,78,0,0,10,0,108,15.428571428571429,5,0.0,2,2,77,0,16,0,1,10,0,81,27,1
1645,24065,DTTxrR88jPl5bCCaxQVsf8wzpnk1CzMM,bWdj2GDclj5ofokWjzoa5jAwMkxCykd6,3,0,0,0,0,0,3,0,3,0.42857142857142855,1,0.0,0,0,0,0,0,0,0,3,0,0,3,1
1646,24066,kXKIMNlMdItv4EM1IWayIAvXYTB44MoC,RXDvfPUBYFlVdlueBFbLW0mhhAyGEqpt,6,5,1,0,1,0,6,0,13,1.8571428571428572,1,0.0,0,1,0,1,5,0,0,6,0,2,11,1
1647,24068,lUdpqcwQn1Cq8H3mwfWcSvZsVHMY64gd,SpATywNh6bZuzm8s1ceuBUnMUAeoAHHw,14,14,3,17,2,0,4,0,40,5.714285714285714,2,0.0,2,3,14,2,12,0,3,4,0,21,19,1
1648,24070,DTTxrR88jPl5bCCaxQVsf8wzpnk1CzMM,A3fsA9Zfv1X2fVEQhTw51lKENdNrEqT3,7,2,0,0,0,0,7,0,9,1.2857142857142858,1,0.0,0,0,0,0,2,0,0,7,0,0,9,1
1649,24077,1xg9Qkt1ODqUyNotraxCzvVYE0R3XRTq,SpATywNh6bZuzm8s1ceuBUnMUAeoAHHw,5,12,5,0,0,0,7,0,24,3.4285714285714284,3,0.0,0,5,0,0,12,0,0,7,0,5,19,0
1650,24088,M8ZBCZwMuabH0ACZboTe8kVgLwQBa43E,SpATywNh6bZuzm8s1ceuBUnMUAeoAHHw,7,9,2,0,2,0,2,0,15,2.142857142857143,1,0.0,0,2,0,2,9,0,0,2,0,4,11,1
1651,24095,gIOMjsdC7cxqbaSIU1FRFPikduEMi8Cf,A3fsA9Zfv1X2fVEQhTw51lKENdNrEqT3,1,0,0,0,0,0,1,0,1,0.14285714285714285,1,0.0,0,0,0,0,0,0,0,1,0,0,1,1
1652,24097,quAtav6r2isPETtEaXY0Zey5BbVDiT8E,bWdj2GDclj5ofokWjzoa5jAwMkxCykd6,11,12,4,160,4,0,4,2,186,26.571428571428573,1,0.0,6,4,149,4,6,0,11,4,2,163,23,1
1653,24104,vhdI0CMIgkIrtFphutHmT5NtC4th9ah8,G8EPVSXsOYB5YQWZGiz1aVq5Pgr2GrQu,19,29,15,20,6,8,9,2,89,12.714285714285714,1,0.0,11,15,13,6,18,8,7,9,2,45,44,1
1654,24105,CARvKOUSVZPjSOb5Yfv5PAWmTBO0zJGw,SpATywNh6bZuzm8s1ceuBUnMUAeoAHHw,11,10,5,0,2,0,25,2,44,6.285714285714286,1,0.0,0,5,0,2,10,0,0,25,2,7,37,1
1655,24107,GCaUOiguxLs9b5sngb0RwjOWSkIZZOW6,RXDvfPUBYFlVdlueBFbLW0mhhAyGEqpt,1,0,0,0,0,0,2,0,2,0.2857142857142857,1,0.0,0,0,0,0,0,0,0,2,0,0,2,1
1656,24113,dMrgH440WCDAs3UnYGenYjtBiGOLNMI7,G8EPVSXsOYB5YQWZGiz1aVq5Pgr2GrQu,10,10,1,14,0,0,5,1,31,4.428571428571429,1,0.0,0,1,12,0,10,0,2,5,1,13,18,1
1657,24117,qQwIO2VZC7PFj9cTI7x2EoRtRcwJFk5y,A3fsA9Zfv1X2fVEQhTw51lKENdNrEqT3,8,8,1,0,1,5,3,0,18,2.5714285714285716,1,0.0,0,1,0,1,8,5,0,3,0,2,16,1
1658,24130,PweHbRIHs8SwjKQfEtpqIQuZBXBDcuDm,SpATywNh6bZuzm8s1ceuBUnMUAeoAHHw,19,17,9,16,4,0,4,0,50,7.142857142857143,2,0.0,5,9,15,4,12,0,1,4,0,33,17,1
1659,24139,oz1karFupMeBQM5wp1X9Aheb4RKufic7,SpATywNh6bZuzm8s1ceuBUnMUAeoAHHw,17,19,12,20,4,2,5,0,62,8.857142857142858,4,0.0,2,12,17,4,17,2,3,5,0,35,27,0
1660,24140,68BjCXfBFqeZ01fFx1csrFmvef5xs0w2,SpATywNh6bZuzm8s1ceuBUnMUAeoAHHw,10,7,5,0,3,0,3,0,18,2.5714285714285716,2,0.0,0,5,0,3,7,0,0,3,0,8,10,1
1661,24142,6zt7VkEpMezYkke6xelTowmnsTySao1Z,SpATywNh6bZuzm8s1ceuBUnMUAeoAHHw,17,12,7,8,5,9,2,0,43,6.142857142857143,2,0.0,3,7,7,5,9,9,1,2,0,22,21,1
1662,24146,W41zjpcR5alpzNzSmbyy9bBZYrT6UXxL,RXDvfPUBYFlVdlueBFbLW0mhhAyGEqpt,26,22,19,0,14,0,7,0,62,8.857142857142858,2,0.0,1,19,0,14,21,0,0,7,0,34,28,1
1663,24149,yEc0qGRUsnGavj0JPbk8pVtWktClrURk,SpATywNh6bZuzm8s1ceuBUnMUAeoAHHw,23,32,14,22,4,5,9,0,86,12.285714285714286,3,0.0,13,14,17,4,19,5,5,9,0,48,38,0
1664,24150,7mxOgTUP9lSjAUBOPZ9fhNEhVSHMvF2J,bWdj2GDclj5ofokWjzoa5jAwMkxCykd6,4,7,3,0,0,0,1,0,11,1.5714285714285714,1,0.0,3,3,0,0,4,0,0,1,0,6,5,0
1665,24154,WTCEOd5LeoB3M6qdd6wv5K0UJQNEdjBy,bWdj2GDclj5ofokWjzoa5jAwMkxCykd6,1,0,0,0,0,0,1,0,1,0.14285714285714285,1,0.0,0,0,0,0,0,0,0,1,0,0,1,1
1666,24161,ZRTZW05J88lidJZzll8LtXVXzVI1deNg,SpATywNh6bZuzm8s1ceuBUnMUAeoAHHw,5,6,0,0,0,0,3,0,9,1.2857142857142858,1,0.0,0,0,0,0,6,0,0,3,0,0,9,1
1667,24172,s4TNdVBVykBR8x72RZEnjBx6ebkwwW3k,A3fsA9Zfv1X2fVEQhTw51lKENdNrEqT3,16,10,9,0,9,0,1,0,29,4.142857142857143,1,0.0,0,9,0,9,10,0,0,1,0,18,11,1
1668,24179,gEzMd6gbgpZIm67NWd6vqHpEEo3Eo4i8,RXDvfPUBYFlVdlueBFbLW0mhhAyGEqpt,1,0,0,0,0,0,1,0,1,0.14285714285714285,1,0.0,0,0,0,0,0,0,0,1,0,0,1,1
1669,24187,GlAlbUSi7bTkQeCE1bsVWDk5GBPq0ZBP,bWdj2GDclj5ofokWjzoa5jAwMkxCykd6,6,7,4,0,1,0,5,0,17,2.4285714285714284,2,0.0,0,4,0,1,7,0,0,5,0,5,12,1
1670,24188,6my3HLUJsR66IUqoTOpOu4zu43YWvDxI,A3fsA9Zfv1X2fVEQhTw51lKENdNrEqT3,10,16,4,0,1,0,9,0,30,4.285714285714286,2,0.0,2,4,0,1,14,0,0,9,0,7,23,1
1671,24191,VVltscgfR96aweHb5nQdD1Q7dsOwuOJz,A3fsA9Zfv1X2fVEQhTw51lKENdNrEqT3,33,24,0,48,0,0,5,0,77,11.0,2,0.0,1,0,45,0,23,0,3,5,0,46,31,1
1672,24205,KjugBA6V5bkEA5fAIbJoGnSUlDhZoaIH,SpATywNh6bZuzm8s1ceuBUnMUAeoAHHw,16,36,17,0,7,5,6,0,71,10.142857142857142,2,0.0,2,17,0,7,34,5,0,6,0,26,45,0
1673,24210,LpAsllakvdmHNKkTbI74k56UY22DACic,SpATywNh6bZuzm8s1ceuBUnMUAeoAHHw,4,2,1,0,1,0,2,0,6,0.8571428571428571,1,0.0,0,1,0,1,2,0,0,2,0,2,4,1
1674,24228,Kawdpya8bnbVtCe5VJbkVPFzmayWdtI6,SpATywNh6bZuzm8s1ceuBUnMUAeoAHHw,1,0,0,0,0,0,1,0,1,0.14285714285714285,1,0.0,0,0,0,0,0,0,0,1,0,0,1,1
1675,24250,UPb6839zer74dQL1gRcC95mBDcZeCZUO,bWdj2GDclj5ofokWjzoa5jAwMkxCykd6,4,2,1,0,1,0,1,0,5,0.7142857142857143,1,0.0,0,1,0,1,2,0,0,1,0,2,3,1
1676,24255,SvdoxHaqv4If8vTEQE4Ye6pIzdBuUEi9,G8EPVSXsOYB5YQWZGiz1aVq5Pgr2GrQu,9,10,6,0,4,0,3,0,23,3.2857142857142856,1,0.0,4,6,0,4,6,0,0,3,0,14,9,1
1677,24257,L8lHLh6Mth1S7I3sErP5oDZD885a1BOh,A3fsA9Zfv1X2fVEQhTw51lKENdNrEqT3,24,5,2,75,0,0,3,0,85,12.142857142857142,1,0.0,2,2,70,0,3,0,5,3,0,74,11,1
1678,24258,Ne25k1DU4nK81LWo7930HvBFWlFV2ZKt,SpATywNh6bZuzm8s1ceuBUnMUAeoAHHw,20,22,12,27,7,0,5,0,73,10.428571428571429,4,0.0,7,12,26,7,15,0,1,5,0,52,21,0
1679,24260,RxUvz1VnE0RHae7wTLOzUprYmci0pJ08,bWdj2GDclj5ofokWjzoa5jAwMkxCykd6,6,2,1,0,1,0,4,1,9,1.2857142857142858,1,0.0,0,1,0,1,2,0,0,4,1,2,7,1
1680,24283,yZoviGGxgr5NFf9klHeC5PfXfdVd14QP,A3fsA9Zfv1X2fVEQhTw51lKENdNrEqT3,6,5,4,0,1,0,3,0,13,1.8571428571428572,1,0.0,0,4,0,1,5,0,0,3,0,5,8,1
1681,24285,Kd69M9W1nim0woqVm1QxfVaSebsYtFIh,RXDvfPUBYFlVdlueBFbLW0mhhAyGEqpt,4,12,4,0,0,0,4,0,20,2.857142857142857,3,0.0,0,4,0,0,12,0,0,4,0,4,16,1
1682,24289,oMQSjsmH1aRsG8joAcNWi5ozsWLu10HK,bWdj2GDclj5ofokWjzoa5jAwMkxCykd6,5,2,1,0,1,0,2,0,6,0.8571428571428571,1,0.0,0,1,0,1,2,0,0,2,0,2,4,1
1683,24290,Ms0MC4W5moiGJLWP7iE3FImeH9CHN4KT,A3fsA9Zfv1X2fVEQhTw51lKENdNrEqT3,2,0,0,0,0,0,2,0,2,0.2857142857142857,1,0.0,0,0,0,0,0,0,0,2,0,0,2,0
1684,24294,j1LAePLDyUZgKcurnBhMK9q8whbJ98ja,SpATywNh6bZuzm8s1ceuBUnMUAeoAHHw,4,2,0,0,0,0,2,0,4,0.5714285714285714,1,0.0,0,0,0,0,2,0,0,2,0,0,4,1
1685,24302,ew0XpK44UZ9NkpDlIMehLaSdbqgabj65,SpATywNh6bZuzm8s1ceuBUnMUAeoAHHw,4,2,1,0,1,0,2,0,6,0.8571428571428571,1,0.0,0,1,0,1,2,0,0,2,0,2,4,1
1686,24313,Evco2d15cNydZMimph5VWFT3j0HfgNP5,SpATywNh6bZuzm8s1ceuBUnMUAeoAHHw,22,24,16,6,10,0,4,0,60,8.571428571428571,3,0.0,5,16,6,10,19,0,0,4,0,37,23,0
1687,24324,W41zjpcR5alpzNzSmbyy9bBZYrT6UXxL,A3fsA9Zfv1X2fVEQhTw51lKENdNrEqT3,12,8,5,0,5,0,3,0,21,3.0,1,0.0,0,5,0,5,8,0,0,3,0,10,11,1
1688,24351,iugl3Rn3u1ci3BiC2tfekDHOQsD5QVGj,A3fsA9Zfv1X2fVEQhTw51lKENdNrEqT3,4,6,3,0,0,0,2,0,11,1.5714285714285714,2,0.0,1,3,0,0,5,0,0,2,0,4,7,1
1689,24356,jb05o2Us6b6SE2vZsRGcabjWWbS3vGCF,SpATywNh6bZuzm8s1ceuBUnMUAeoAHHw,1,0,0,0,0,0,2,0,2,0.2857142857142857,1,0.0,0,0,0,0,0,0,0,2,0,0,2,1
1690,24359,WdQwb0B6ZnAdvXskBHP8stZHsjNTkrqQ,SpATywNh6bZuzm8s1ceuBUnMUAeoAHHw,10,11,5,9,1,0,8,0,34,4.857142857142857,1,0.0,1,5,7,1,10,0,2,8,0,14,20,1
1691,24369,dWVj5G83xAxBDmPzLgLHfDC3pxyIk4K1,SpATywNh6bZuzm8s1ceuBUnMUAeoAHHw,1,0,0,0,0,0,3,0,3,0.42857142857142855,1,0.0,0,0,0,0,0,0,0,3,0,0,3,1
1692,24371,1RLhIao7wKT4YvgWBYzjLBBf7hozJmqb,SpATywNh6bZuzm8s1ceuBUnMUAeoAHHw,6,2,0,0,0,1,4,1,8,1.1428571428571428,1,0.0,0,0,0,0,2,1,0,4,1,0,8,1
1693,24375,vx3ISVZde9Js9SAljxLNpat5gkbJKEY2,RXDvfPUBYFlVdlueBFbLW0mhhAyGEqpt,20,24,9,14,3,2,12,2,66,9.428571428571429,2,0.0,6,9,13,3,18,2,1,12,2,31,35,0
1694,24384,j1jdy8OF5VQw4rqSYOkbK2pQplvvvz37,SpATywNh6bZuzm8s1ceuBUnMUAeoAHHw,1,0,0,0,0,0,1,0,1,0.14285714285714285,1,0.0,0,0,0,0,0,0,0,1,0,0,1,1
1695,24391,5tGNQxzw9lFd1DSnmxNCdWwVZfTyj1IB,bWdj2GDclj5ofokWjzoa5jAwMkxCykd6,9,12,7,12,2,0,3,0,36,5.142857142857143,3,0.0,1,7,12,2,11,0,0,3,0,22,14,1
1696,24396,WdQwb0B6ZnAdvXskBHP8stZHsjNTkrqQ,A3fsA9Zfv1X2fVEQhTw51lKENdNrEqT3,10,4,1,0,1,0,7,2,15,2.142857142857143,1,0.0,0,1,0,1,4,0,0,7,2,2,13,1
1697,24397,2ZTBzb1Y4dwuOwNiUUSWB6SyHlRXxNso,SpATywNh6bZuzm8s1ceuBUnMUAeoAHHw,17,25,11,12,5,0,2,0,55,7.857142857142857,3,0.0,5,11,12,5,20,0,0,2,0,33,22,1
1698,24418,a3VUGRBh4vIHU6nTy2I0Dl5D5S8VvzQM,SpATywNh6bZuzm8s1ceuBUnMUAeoAHHw,7,3,2,0,2,0,2,0,9,1.2857142857142858,1,0.0,0,2,0,2,3,0,0,2,0,4,5,1
1699,24431,ADFd6U5gb8MuQY2di0urTV7aR0h11Ir1,RXDvfPUBYFlVdlueBFbLW0mhhAyGEqpt,2,0,0,0,0,0,2,0,2,0.2857142857142857,1,0.0,0,0,0,0,0,0,0,2,0,0,2,1
1700,24432,ADFd6U5gb8MuQY2di0urTV7aR0h11Ir1,A3fsA9Zfv1X2fVEQhTw51lKENdNrEqT3,2,0,0,0,0,0,2,0,2,0.2857142857142857,1,0.0,0,0,0,0,0,0,0,2,0,0,2,1
1701,24445,mFNGHC6aCmhHmhRXFCDO0uvnGnNYaro0,bWdj2GDclj5ofokWjzoa5jAwMkxCykd6,14,17,12,14,6,8,7,0,64,9.142857142857142,2,0.0,2,12,12,6,15,8,2,7,0,32,32,1
1702,24447,bSOq11L6zS91mDTcR42LcWMRdkU0Htpv,SpATywNh6bZuzm8s1ceuBUnMUAeoAHHw,4,2,1,0,1,0,1,0,5,0.7142857142857143,1,0.0,0,1,0,1,2,0,0,1,0,2,3,1
1703,24456,AOtTiaeDNx4G2J0NpAHDjb596RxqAAI3,SpATywNh6bZuzm8s1ceuBUnMUAeoAHHw,11,5,4,0,2,2,6,1,20,2.857142857142857,1,0.0,0,4,0,2,5,2,0,6,1,6,14,1
1704,24475,1yAfuEW0CNQiRXnPO0v79LFUyx4hhTWm,bWdj2GDclj5ofokWjzoa5jAwMkxCykd6,6,2,1,0,1,0,5,0,9,1.2857142857142858,1,0.0,0,1,0,1,2,0,0,5,0,2,7,0
1705,24503,VVgqDLLa7j66k9tQU3M7wVOF4BEse4lo,SpATywNh6bZuzm8s1ceuBUnMUAeoAHHw,5,10,4,0,2,0,4,0,20,2.857142857142857,3,0.0,0,4,0,2,10,0,0,4,0,6,14,0
1706,24505,iXoEMwcJ5o4IM7VKZ5pyam9GxPy4olUQ,G8EPVSXsOYB5YQWZGiz1aVq5Pgr2GrQu,4,3,1,0,0,0,3,0,7,1.0,1,0.0,0,1,0,0,3,0,0,3,0,1,6,1
1707,24517,iXoEMwcJ5o4IM7VKZ5pyam9GxPy4olUQ,bWdj2GDclj5ofokWjzoa5jAwMkxCykd6,1,0,0,0,0,0,2,0,2,0.2857142857142857,1,0.0,0,0,0,0,0,0,0,2,0,0,2,1
1708,24536,tE3Bwjiismxnblg3Eq9l6K3IoXQaklnD,bWdj2GDclj5ofokWjzoa5jAwMkxCykd6,1,0,0,0,0,0,1,0,1,0.14285714285714285,1,0.0,0,0,0,0,0,0,0,1,0,0,1,1
1709,24539,tE3Bwjiismxnblg3Eq9l6K3IoXQaklnD,SpATywNh6bZuzm8s1ceuBUnMUAeoAHHw,11,12,1,0,1,0,3,0,17,2.4285714285714284,1,0.0,3,1,0,1,9,0,0,3,0,5,12,1
1710,24542,GW33fgaq0ndGNQkirzfpXhCeUuV3tuD2,SpATywNh6bZuzm8s1ceuBUnMUAeoAHHw,17,25,11,15,4,3,10,1,69,9.857142857142858,2,0.0,9,11,15,4,16,3,0,10,1,39,30,0
1711,24550,qr1Y8xuPrcpdzScNHYsirGXqasfUdOVa,SpATywNh6bZuzm8s1ceuBUnMUAeoAHHw,7,5,4,0,3,0,1,0,13,1.8571428571428572,1,0.0,0,4,0,3,5,0,0,1,0,7,6,1
1712,24551,foJyfq5hSUj3jzVw8TG0nT1wv3hLMMNc,G8EPVSXsOYB5YQWZGiz1aVq5Pgr2GrQu,5,4,3,0,0,0,1,0,8,1.1428571428571428,2,0.0,0,3,0,0,4,0,0,1,0,3,5,0
1713,24552,foJyfq5hSUj3jzVw8TG0nT1wv3hLMMNc,SpATywNh6bZuzm8s1ceuBUnMUAeoAHHw,13,20,2,12,0,0,2,0,36,5.142857142857143,1,0.0,3,2,12,0,17,0,0,2,0,17,19,0
1714,24569,VeFENcSXAiXgJQaSjlXiodtIBxgSrzaH,A3fsA9Zfv1X2fVEQhTw51lKENdNrEqT3,8,8,3,0,1,0,6,0,18,2.5714285714285716,3,0.0,0,3,0,1,8,0,0,6,0,4,14,1
1715,24572,QDaW6SyhKIOYnUckUXKfy6A7QKIp9Kb8,A3fsA9Zfv1X2fVEQhTw51lKENdNrEqT3,6,0,0,0,0,1,5,0,6,0.8571428571428571,1,0.0,0,0,0,0,0,1,0,5,0,0,6,1
1716,24587,f7pgA2Hp0s8DkqzKuvE0Kw8QRuoBh3Zv,RXDvfPUBYFlVdlueBFbLW0mhhAyGEqpt,24,41,23,38,16,9,2,0,129,18.428571428571427,1,0.0,13,23,33,16,28,9,5,2,0,85,44,0
1717,24601,rhJzZeMBkfw1Q75cLyvgh9HzDvUXe9cc,SpATywNh6bZuzm8s1ceuBUnMUAeoAHHw,3,3,0,0,0,0,2,0,5,0.7142857142857143,1,0.0,0,0,0,0,3,0,0,2,0,0,5,1
1718,24602,tBWD1VTj6Jcj3AQ0AXY8eZtUzkjmoiNH,SpATywNh6bZuzm8s1ceuBUnMUAeoAHHw,7,7,3,0,1,0,1,0,12,1.7142857142857142,1,0.0,0,3,0,1,7,0,0,1,0,4,8,0
1719,24608,S5LJKm1sQOy9mdQmh7HP7gCjw7krEMbq,A3fsA9Zfv1X2fVEQhTw51lKENdNrEqT3,13,6,3,0,3,0,8,0,20,2.857142857142857,3,0.0,0,3,0,3,6,0,0,8,0,6,14,1
1720,24632,zn2X74vvqUQRINz90WjZLsSsFglpYr7o,bWdj2GDclj5ofokWjzoa5jAwMkxCykd6,2,0,0,0,0,0,2,0,2,0.2857142857142857,1,0.0,0,0,0,0,0,0,0,2,0,0,2,1
1721,24661,ZgPDgY8Y43cADkyBad03WZKNqaM99vmp,7GRhBDsirIGkRZBtSMEzNTyDr2JQm4xx,13,39,1,8,2,3,8,0,61,8.714285714285714,1,0.0,18,1,7,2,21,3,1,8,0,28,33,0
1722,24744,S6vBzHKpSh31SFGGZmwgKaOH2RvW3RpH,bWdj2GDclj5ofokWjzoa5jAwMkxCykd6,11,21,13,0,6,0,18,0,58,8.285714285714286,3,0.0,0,13,0,6,21,0,0,18,0,19,39,1
1723,24834,NsnGWsRio9JsRS5X1oYgeBjF7tc8iDdA,7GRhBDsirIGkRZBtSMEzNTyDr2JQm4xx,10,14,7,8,6,0,2,0,37,5.285714285714286,2,0.0,2,7,7,6,12,0,1,2,0,22,15,1
1724,24901,paRtaUir7BROwVpnw69gcE7HkkiPuHFt,7GRhBDsirIGkRZBtSMEzNTyDr2JQm4xx,6,1,1,0,1,0,3,0,6,0.8571428571428571,1,0.0,0,1,0,1,1,0,0,3,0,2,4,1
1725,24929,hCRoH0np1tajD5PHKKgVw7dH4NZJLfD2,A3fsA9Zfv1X2fVEQhTw51lKENdNrEqT3,25,20,15,0,10,8,20,7,80,11.428571428571429,4,0.0,0,15,0,10,20,8,0,20,7,25,55,0
1726,24942,DCwFNk2m7QLqdKcTT3u5CdSnRyl5YCHB,SpATywNh6bZuzm8s1ceuBUnMUAeoAHHw,1,0,0,0,0,0,1,0,1,0.14285714285714285,1,0.0,0,0,0,0,0,0,0,1,0,0,1,1
1727,24996,tLK32ryOHeiJecBcFzaTeN36vYEmQ8Nk,SpATywNh6bZuzm8s1ceuBUnMUAeoAHHw,20,15,8,24,4,7,5,2,65,9.285714285714286,1,0.0,5,8,20,4,10,7,4,5,2,37,28,1
1728,25049,zkOr0wwuxAzYftPuxG6iQaCtbl1egkTS,A3fsA9Zfv1X2fVEQhTw51lKENdNrEqT3,32,16,10,62,3,7,13,2,113,16.142857142857142,3,0.0,1,10,55,3,15,7,7,13,2,69,44,0
1729,25073,WQKoaWRi4j5EUCfZEZsK4LU6GIHATRae,SpATywNh6bZuzm8s1ceuBUnMUAeoAHHw,5,3,2,0,1,0,1,0,7,1.0,1,0.0,0,2,0,1,3,0,0,1,0,3,4,1
1730,25096,i7qRP2nhuaIR2tcQnQvT86ViNtPopbnz,7GRhBDsirIGkRZBtSMEzNTyDr2JQm4xx,7,4,2,0,0,0,5,0,11,1.5714285714285714,1,0.0,0,2,0,0,4,0,0,5,0,2,9,1
1731,25182,hGCwfWh9ySQVbALdmRR0HUMpPic5OOrw,bWdj2GDclj5ofokWjzoa5jAwMkxCykd6,7,2,1,0,1,0,5,0,9,1.2857142857142858,1,0.0,1,1,0,1,1,0,0,5,0,3,6,0
1732,25219,skOScgcMIkYsPXikHjLqvicjdb3rv6St,A3fsA9Zfv1X2fVEQhTw51lKENdNrEqT3,5,2,1,0,1,0,2,0,6,0.8571428571428571,1,0.0,0,1,0,1,2,0,0,2,0,2,4,1
1733,25235,BgFWtuiCvZoByaUpZ5qN1JDEWuWXlm2n,G8EPVSXsOYB5YQWZGiz1aVq5Pgr2GrQu,28,38,13,58,2,1,11,1,124,17.714285714285715,1,0.0,17,13,39,2,21,1,19,11,1,71,53,1
1734,25265,9va79rFsgW625mCi6PBHbhUMC5acSS5i,bWdj2GDclj5ofokWjzoa5jAwMkxCykd6,25,24,10,129,10,0,7,2,182,26.0,1,0.0,12,10,121,10,12,0,8,7,2,153,29,0
1735,25295,ETzcC9n39CwhBb4MTbqq1Ng4NqGIoiPj,bWdj2GDclj5ofokWjzoa5jAwMkxCykd6,5,3,1,0,1,0,1,0,6,0.8571428571428571,1,0.0,0,1,0,1,3,0,0,1,0,2,4,1
1736,25371,tMJpDv6ZjEPz2ELzUVp4mZTT6G7u49T6,bWdj2GDclj5ofokWjzoa5jAwMkxCykd6,2,0,0,0,0,0,2,0,2,0.2857142857142857,1,0.0,0,0,0,0,0,0,0,2,0,0,2,0
1737,25391,1aQoKDna73jstuOrupWa9Kq8V3FdvbRU,A3fsA9Zfv1X2fVEQhTw51lKENdNrEqT3,1,0,0,0,0,0,1,0,1,0.14285714285714285,1,0.0,0,0,0,0,0,0,0,1,0,0,1,1
1738,25406,Ua8t7GvEqkquREwn5gCoNVwYmIqhqGMw,G8EPVSXsOYB5YQWZGiz1aVq5Pgr2GrQu,9,9,6,2,2,0,0,0,19,2.7142857142857144,1,0.0,1,6,1,2,8,0,1,0,0,10,9,0
1739,25409,tvH2SB0L50iCqaXyQDY3u7qaByLbL0rV,RXDvfPUBYFlVdlueBFbLW0mhhAyGEqpt,1,0,0,0,0,0,1,0,1,0.14285714285714285,1,0.0,0,0,0,0,0,0,0,1,0,0,1,1
1740,25482,M3Xa5IFPEZiaLK2rAjKqcPYFncjR6IsA,7GRhBDsirIGkRZBtSMEzNTyDr2JQm4xx,5,4,3,0,0,0,1,0,8,1.1428571428571428,1,0.0,0,3,0,0,4,0,0,1,0,3,5,1
1741,25511,RtpaISGKG8FC1poFd4XAu8898XLnl6EI,SpATywNh6bZuzm8s1ceuBUnMUAeoAHHw,22,36,15,16,6,10,14,1,98,14.0,2,0.0,8,15,14,6,28,10,2,14,1,43,55,0
1742,25589,3Oka5GvBd9TakXRvr9D5vxoJEhxwuxJA,SpATywNh6bZuzm8s1ceuBUnMUAeoAHHw,18,19,12,12,4,0,9,0,56,8.0,4,0.0,3,12,12,4,16,0,0,9,0,31,25,0
1743,25678,8hHM4gMR8PLgcGE0KxgxZ4wD71iRPNWp,RXDvfPUBYFlVdlueBFbLW0mhhAyGEqpt,48,29,12,58,8,0,4,1,112,16.0,1,0.0,8,12,56,8,21,0,2,4,1,84,28,1
1744,25706,udBjfCluZTte9l6GhqqG4v3kEGoKKcxC,SpATywNh6bZuzm8s1ceuBUnMUAeoAHHw,3,2,1,0,0,0,1,0,4,0.5714285714285714,1,0.0,0,1,0,0,2,0,0,1,0,1,3,0
1745,25720,v0qndwa3TlbOqgdTUBH2afnl049VDWzU,SpATywNh6bZuzm8s1ceuBUnMUAeoAHHw,3,2,1,0,0,0,1,0,4,0.5714285714285714,1,0.0,0,1,0,0,2,0,0,1,0,1,3,0
1746,25773,xYLJB56SVkFUOdT5vN3Qq6OYNlnP0Fjc,7GRhBDsirIGkRZBtSMEzNTyDr2JQm4xx,33,104,30,36,18,0,10,0,198,28.285714285714285,4,0.0,7,30,33,18,97,0,3,10,0,88,110,1
1747,25900,NRMzH6tZyLT2qk2QIkwNRbUliCMPz2WK,A3fsA9Zfv1X2fVEQhTw51lKENdNrEqT3,5,3,2,0,1,0,1,0,7,1.0,1,0.0,0,2,0,1,3,0,0,1,0,3,4,0
1748,25939,Krxyy23fZ28ymHlUM9cR68oteYOpMEoc,bWdj2GDclj5ofokWjzoa5jAwMkxCykd6,4,3,1,0,0,0,1,0,5,0.7142857142857143,1,0.0,0,1,0,0,3,0,0,1,0,1,4,0
1749,25945,Xl7O5Es6VpkB2PrTgzArkv7OwJ7XzlEg,SpATywNh6bZuzm8s1ceuBUnMUAeoAHHw,1,0,0,0,0,0,1,0,1,0.14285714285714285,1,0.0,0,0,0,0,0,0,0,1,0,0,1,0
1750,25956,iHFiZ9SvBVcIu7YGo4eFTUpkfFG44jX7,SpATywNh6bZuzm8s1ceuBUnMUAeoAHHw,10,25,8,0,5,0,3,0,41,5.857142857142857,2,0.0,0,8,0,5,25,0,0,3,0,13,28,0
1751,25959,E31WqWw5nCEWlSKgmhsOSj5j4T79ypCl,7GRhBDsirIGkRZBtSMEzNTyDr2JQm4xx,5,7,3,0,0,0,2,0,12,1.7142857142857142,2,0.0,1,3,0,0,6,0,0,2,0,4,8,1
1752,26009,RADrfrSrqd2D1lhkJRYdtWMv0TybV2Zk,A3fsA9Zfv1X2fVEQhTw51lKENdNrEqT3,8,7,2,0,2,0,2,0,13,1.8571428571428572,1,0.0,0,2,0,2,7,0,0,2,0,4,9,1
1753,26078,ByDjTuY0oLVzrle7JgW0XGlu5bLAo5Uj,SpATywNh6bZuzm8s1ceuBUnMUAeoAHHw,15,19,0,21,0,0,5,0,45,6.428571428571429,1,0.0,7,0,18,0,12,0,3,5,0,25,20,0
1754,26153,WDOhUt18DNMCYDEG35QkOfLroSJB0yOR,7GRhBDsirIGkRZBtSMEzNTyDr2JQm4xx,31,43,11,78,7,2,7,0,148,21.142857142857142,3,0.0,30,11,66,7,13,2,12,7,0,114,34,0
1755,26214,SB3PBvXY4EEkcNDmtIOX6bpu8RFJOU8W,G8EPVSXsOYB5YQWZGiz1aVq5Pgr2GrQu,16,15,4,20,0,0,2,0,41,5.857142857142857,1,0.0,10,4,10,0,5,0,10,2,0,24,17,1
1756,26268,tynbQ4TjTy74SqA5UqLPd55W0CYMmxkv,bWdj2GDclj5ofokWjzoa5jAwMkxCykd6,20,14,11,90,3,0,3,0,121,17.285714285714285,1,0.0,1,11,73,3,13,0,17,3,0,88,33,0
1757,26300,skOScgcMIkYsPXikHjLqvicjdb3rv6St,G8EPVSXsOYB5YQWZGiz1aVq5Pgr2GrQu,5,3,1,0,1,1,6,0,12,1.7142857142857142,1,0.0,0,1,0,1,3,1,0,6,0,2,10,1
1758,26317,Ke04PwAVtaYumEPrCNIyUmIZgpnMElWJ,SpATywNh6bZuzm8s1ceuBUnMUAeoAHHw,12,9,8,4,2,0,1,0,24,3.4285714285714284,1,0.0,0,8,4,2,9,0,0,1,0,14,10,1
1759,26390,4BpRE14XuCFERPNFltqE4ojcMHw6pKyT,SpATywNh6bZuzm8s1ceuBUnMUAeoAHHw,17,21,12,10,6,0,3,0,52,7.428571428571429,1,0.0,7,12,9,6,14,0,1,3,0,34,18,0
1760,26398,x4ez09GGWUnioTSf6qckx5goNY5giLKq,7GRhBDsirIGkRZBtSMEzNTyDr2JQm4xx,6,5,4,0,2,0,2,0,13,1.8571428571428572,1,0.0,0,4,0,2,5,0,0,2,0,6,7,0
1761,26436,J7iejq5NtsfdHjPTK3MrPhGPRoJN9WrB,A3fsA9Zfv1X2fVEQhTw51lKENdNrEqT3,56,33,24,84,15,2,16,1,175,25.0,2,0.0,3,24,81,15,30,2,3,16,1,123,52,0
1762,26453,qIRkU6GTErqHGiePGqqQmQyg81Pc8mmk,SpATywNh6bZuzm8s1ceuBUnMUAeoAHHw,23,15,14,10,9,11,1,0,60,8.571428571428571,1,0.0,0,14,9,9,15,11,1,1,0,32,28,1
1763,26460,oNf6qoW6E6dhoPJKSUjvElFlUKN9drLY,SpATywNh6bZuzm8s1ceuBUnMUAeoAHHw,10,13,5,12,0,0,3,0,33,4.714285714285714,1,0.0,6,5,12,0,7,0,0,3,0,23,10,0
1764,26464,xioMf6frC9P8sc1cIrYLanKwZwDuxRiz,G8EPVSXsOYB5YQWZGiz1aVq5Pgr2GrQu,1,0,0,0,0,0,1,0,1,0.14285714285714285,1,0.0,0,0,0,0,0,0,0,1,0,0,1,0
1765,26497,lHqsd1041AF6CV0C0CnR0FxJTQGWXgTK,SpATywNh6bZuzm8s1ceuBUnMUAeoAHHw,3,2,1,0,0,0,1,0,4,0.5714285714285714,1,0.0,0,1,0,0,2,0,0,1,0,1,3,1
1766,26500,0jMOLkd6bX5LTqVnq5W50RF0alCjmWfd,SpATywNh6bZuzm8s1ceuBUnMUAeoAHHw,10,12,1,12,0,0,1,0,26,3.7142857142857144,1,0.0,6,1,11,0,6,0,1,1,0,18,8,0
1767,26528,CiVcRubRqdt8MrzyUg75lzZmUZcaVQVo,SpATywNh6bZuzm8s1ceuBUnMUAeoAHHw,10,14,9,4,1,0,2,0,30,4.285714285714286,1,0.0,2,9,2,1,12,0,2,2,0,14,16,0
1768,26574,kSTg1JLYdhltSJsPuKhUcTkKXIqnVUW2,SpATywNh6bZuzm8s1ceuBUnMUAeoAHHw,14,21,1,10,0,0,2,0,34,4.857142857142857,1,0.0,3,1,10,0,18,0,0,2,0,14,20,1
1769,26610,xzPjA6KrslcE6S6chFTjdwgsvoAelzjQ,G8EPVSXsOYB5YQWZGiz1aVq5Pgr2GrQu,26,13,5,68,3,0,2,0,91,13.0,1,0.0,6,5,54,3,7,0,14,2,0,68,23,0
1770,26640,RbUxQb46RHLKt8MRdcRI6KFNQeGEWd4E,7GRhBDsirIGkRZBtSMEzNTyDr2JQm4xx,11,22,13,12,1,12,3,0,63,9.0,1,0.0,5,13,9,1,17,12,3,3,0,28,35,1
1771,26672,XN0YlXkOOCzzQkjkPHbmHYzBt2kMHbPM,G8EPVSXsOYB5YQWZGiz1aVq5Pgr2GrQu,18,25,1,10,1,0,6,0,43,6.142857142857143,1,0.0,4,1,6,1,21,0,4,6,0,12,31,0
1772,26720,DsLjooCLnfZ8B5pzT2arifZ6SOAto1Wc,SpATywNh6bZuzm8s1ceuBUnMUAeoAHHw,8,4,2,0,2,0,3,1,12,1.7142857142857142,1,0.0,0,2,0,2,4,0,0,3,1,4,8,1
1773,26750,7J9JIWVCQG1g6yXh3uTVbrSu3pa18Ezn,A3fsA9Zfv1X2fVEQhTw51lKENdNrEqT3,14,8,6,0,4,3,7,0,28,4.0,1,0.0,0,6,0,4,8,3,0,7,0,10,18,1
1774,26754,GLksmLIo4jY0swb77XkCz4Oz6WJw9kTq,bWdj2GDclj5ofokWjzoa5jAwMkxCykd6,8,6,2,42,3,0,1,0,54,7.714285714285714,1,0.0,3,2,40,3,3,0,2,1,0,48,6,1
1775,26763,6gAyvwJKSeHOrljTS7vTc1U71cPBh7nb,RXDvfPUBYFlVdlueBFbLW0mhhAyGEqpt,22,18,7,39,5,0,1,0,70,10.0,1,0.0,10,7,34,5,8,0,5,1,0,56,14,0
1776,26770,H7bZ54NuzkB5Nw5q0ZI1nld9qDoHNngL,7GRhBDsirIGkRZBtSMEzNTyDr2JQm4xx,1,0,0,0,0,0,1,0,1,0.14285714285714285,1,0.0,0,0,0,0,0,0,0,1,0,0,1,1
1777,26801,q2xQCstASp96wpspi8iqsuaqJ7gzfsux,SpATywNh6bZuzm8s1ceuBUnMUAeoAHHw,11,12,5,12,0,0,2,0,31,4.428571428571429,2,0.0,3,5,10,0,9,0,2,2,0,18,13,0
1778,26823,oidXTGaCUuuF1QPNvhmiPoqhWsTY245r,7GRhBDsirIGkRZBtSMEzNTyDr2JQm4xx,13,12,8,0,4,0,2,0,26,3.7142857142857144,1,0.0,3,8,0,4,9,0,0,2,0,15,11,1
1779,26863,erDgXJOtYMWq3DbmDGyxl8sIhvZ9oKFE,SpATywNh6bZuzm8s1ceuBUnMUAeoAHHw,11,18,0,6,0,1,3,1,29,4.142857142857143,1,0.0,4,0,5,0,14,1,1,3,1,9,20,0
1780,26902,wlMzjZIA65JiQ9JE1VQhTzG17NZZPeo3,SpATywNh6bZuzm8s1ceuBUnMUAeoAHHw,15,31,11,16,0,50,13,0,121,17.285714285714285,4,0.0,4,11,16,0,27,50,0,13,0,31,90,0
1781,26907,sTDzO3bjgLIIYNoWgHN2HiaPZw68DTyo,7GRhBDsirIGkRZBtSMEzNTyDr2JQm4xx,3,2,0,0,0,0,2,0,4,0.5714285714285714,2,0.0,0,0,0,0,2,0,0,2,0,0,4,0
1782,26931,luNGlNTmJ26UVXohAPNf4yZNgIUDcpxK,SpATywNh6bZuzm8s1ceuBUnMUAeoAHHw,12,8,6,0,4,0,2,0,20,2.857142857142857,2,0.0,0,6,0,4,8,0,0,2,0,10,10,0
1783,26940,EQUZwbG72sVIvQVavXNV7pB9UhkYp9aI,SpATywNh6bZuzm8s1ceuBUnMUAeoAHHw,32,42,19,30,8,72,11,2,184,26.285714285714285,2,0.0,15,19,26,8,27,72,4,11,2,68,116,0
1784,27087,1sf1a7OMEvwky5hvLFD12TaOsmoNw2Qb,G8EPVSXsOYB5YQWZGiz1aVq5Pgr2GrQu,29,17,7,122,1,0,1,0,148,21.142857142857142,1,0.0,6,7,103,1,11,0,19,1,0,117,31,0
1785,27154,zi3yOAhUK1J3AbYoEq9VqjXWOhiWlKvY,SpATywNh6bZuzm8s1ceuBUnMUAeoAHHw,15,24,2,13,1,10,3,0,53,7.571428571428571,2,0.0,7,2,11,1,17,10,2,3,0,21,32,0
1786,27206,5pjAdY5K4FfgQPLSzQKwXaKF78ph9a0y,7GRhBDsirIGkRZBtSMEzNTyDr2JQm4xx,1,0,0,0,0,0,1,0,1,0.14285714285714285,1,0.0,0,0,0,0,0,0,0,1,0,0,1,0
1787,27213,S0nQm2eOAlSxKM1RfeGoUgB4GQEZsJ1U,SpATywNh6bZuzm8s1ceuBUnMUAeoAHHw,17,20,8,13,4,2,7,0,54,7.714285714285714,1,0.0,4,8,13,4,16,2,0,7,0,29,25,0
1788,27220,SqRpmgv1gGFKN06wuAdrCbdyqbZyrZkj,bWdj2GDclj5ofokWjzoa5jAwMkxCykd6,5,4,1,0,0,0,3,0,8,1.1428571428571428,1,0.0,0,1,0,0,4,0,0,3,0,1,7,1
1789,27263,X5ugOWLhdmTxo3CYqfXWDVoDsvjcSnkc,SpATywNh6bZuzm8s1ceuBUnMUAeoAHHw,10,13,4,16,0,0,5,0,38,5.428571428571429,2,0.0,4,4,13,0,9,0,3,5,0,21,17,0
1790,27386,jQaCxlcrIW3B0ti76HtzjtRZOLJHPbzy,RXDvfPUBYFlVdlueBFbLW0mhhAyGEqpt,10,15,8,0,2,56,6,1,88,12.571428571428571,2,0.0,0,8,0,2,15,56,0,6,1,10,78,0
1791,27387,FFlICu8a1PeaY8oKBFESJAT3q6I5h6Xu,SpATywNh6bZuzm8s1ceuBUnMUAeoAHHw,13,11,6,6,3,0,2,0,28,4.0,2,0.0,2,6,6,3,9,0,0,2,0,17,11,0
1792,27402,GDOD5H0bl28RO8whBIu6B8qS2nGsRznY,A3fsA9Zfv1X2fVEQhTw51lKENdNrEqT3,1,0,0,0,0,0,1,0,1,0.14285714285714285,1,0.0,0,0,0,0,0,0,0,1,0,0,1,1
1793,27418,46ijefZyx5KF4YGCmdayIapXrAG6omzt,SpATywNh6bZuzm8s1ceuBUnMUAeoAHHw,8,5,2,6,0,0,2,0,15,2.142857142857143,2,0.0,2,2,6,0,3,0,0,2,0,10,5,0
1794,27448,h5vEAVTb94xGNGjpn4Ohi5mNcXfM0rMl,7GRhBDsirIGkRZBtSMEzNTyDr2JQm4xx,7,4,1,0,1,0,2,0,8,1.1428571428571428,1,0.0,0,1,0,1,4,0,0,2,0,2,6,1
1795,27464,XLmXRx6QIJBEWZLK5otMq8wfQNXonT4D,SpATywNh6bZuzm8s1ceuBUnMUAeoAHHw,4,4,2,0,0,0,0,0,6,0.8571428571428571,2,0.0,0,2,0,0,4,0,0,0,0,2,4,0
1796,27477,pz4WzmrapGULqEk99lfOZVzJbwiC2Cl1,SpATywNh6bZuzm8s1ceuBUnMUAeoAHHw,9,9,0,6,0,8,2,0,25,3.5714285714285716,1,0.0,2,0,6,0,7,8,0,2,0,8,17,0
1797,27478,dgp1qm7PjXoVV4MjyzuvWetQrJ3T9kos,7GRhBDsirIGkRZBtSMEzNTyDr2JQm4xx,5,4,3,0,2,1,1,0,11,1.5714285714285714,1,0.0,0,3,0,2,4,1,0,1,0,5,6,1
1798,27517,9CBq37ANJ7gzpAJJLjvNc0D6JKL0q7QE,SpATywNh6bZuzm8s1ceuBUnMUAeoAHHw,28,31,16,32,10,7,3,0,99,14.142857142857142,1,0.0,13,16,31,10,18,7,1,3,0,70,29,1
1799,27523,8ga3z0NKN1WQ3YzAZr5NtUzbD9BjtY0C,G8EPVSXsOYB5YQWZGiz1aVq5Pgr2GrQu,27,22,9,38,4,0,6,0,79,11.285714285714286,2,0.0,10,9,27,4,12,0,11,6,0,50,29,0
1800,27541,4LLdV2zTWS697dAsOgAPJZPFwfNnrjt6,A3fsA9Zfv1X2fVEQhTw51lKENdNrEqT3,30,17,13,60,4,0,3,0,97,13.857142857142858,2,0.0,1,13,51,4,16,0,9,3,0,69,28,1
1801,30652,c0SE05tRjiEOaThvWcYxSYbAxboLNaZo,7GRhBDsirIGkRZBtSMEzNTyDr2JQm4xx,7,2,1,0,0,0,5,0,8,1.1428571428571428,1,0.0,0,1,0,0,2,0,0,5,0,1,7,0
1802,30662,4Y6ySID5iQf80xGHEGKPq13tPSHHOAOF,7GRhBDsirIGkRZBtSMEzNTyDr2JQm4xx,53,130,37,70,19,4,6,0,266,38.0,3,0.0,32,37,54,19,98,4,16,6,0,142,124,0
1803,30690,AcpmcKbkGL0wHG2z3MmcGuG9z6KsBEJe,7GRhBDsirIGkRZBtSMEzNTyDr2JQm4xx,6,5,3,0,1,1,1,0,11,1.5714285714285714,2,0.0,1,3,0,1,4,1,0,1,0,5,6,0
1804,30717,Upqz62cwWKexlUMk4uvP9aosOnbcADgX,7GRhBDsirIGkRZBtSMEzNTyDr2JQm4xx,1,0,0,0,0,0,1,0,1,0.14285714285714285,1,0.0,0,0,0,0,0,0,0,1,0,0,1,0
1805,30722,N0Sos51WanCzoSGKDmMPzQtMlLxY3bFb,7GRhBDsirIGkRZBtSMEzNTyDr2JQm4xx,37,131,49,69,15,33,29,2,328,46.857142857142854,4,0.0,60,49,60,15,71,33,9,29,2,184,144,0
1806,30724,Cdp3gxqrAuRwjOLmDu9YrutxbWvuOM9e,7GRhBDsirIGkRZBtSMEzNTyDr2JQm4xx,1,0,0,0,0,0,1,0,1,0.14285714285714285,1,0.0,0,0,0,0,0,0,0,1,0,0,1,0
1807,30733,9GVWhCbqivE4bnCr9NW81pWzAvrdhoCR,7GRhBDsirIGkRZBtSMEzNTyDr2JQm4xx,2,0,0,0,0,0,2,0,2,0.2857142857142857,1,0.0,0,0,0,0,0,0,0,2,0,0,2,1
1808,30742,m7YQyhtMcEUVm4YEl0ls7E37ljO7KzRy,7GRhBDsirIGkRZBtSMEzNTyDr2JQm4xx,17,60,25,24,6,37,6,0,158,22.571428571428573,3,0.0,23,25,21,6,37,37,3,6,0,75,83,0
1809,30750,yk7hISr9k5KlTllac6P28wE1wuN0cd27,7GRhBDsirIGkRZBtSMEzNTyDr2JQm4xx,7,4,1,0,1,0,2,0,8,1.1428571428571428,1,0.0,0,1,0,1,4,0,0,2,0,2,6,0
1810,30756,5He5r20lSAk84shJAoxdWcVq0zVfBWNL,7GRhBDsirIGkRZBtSMEzNTyDr2JQm4xx,12,19,8,0,2,17,8,0,54,7.714285714285714,1,0.0,3,8,0,2,16,17,0,8,0,13,41,0
1811,30797,S0OJjF6aof0iTnIX6lUAxekoH3m4w7V0,bWdj2GDclj5ofokWjzoa5jAwMkxCykd6,24,24,12,46,2,0,6,0,90,12.857142857142858,2,0.0,2,12,45,2,22,0,1,6,0,61,29,0
1812,30824,VpttOLX6WfGZBZLZt8acfk7430VwqHRi,RXDvfPUBYFlVdlueBFbLW0mhhAyGEqpt,15,13,1,7,0,4,2,0,27,3.857142857142857,1,0.0,0,1,5,0,13,4,2,2,0,6,21,1
1813,30851,dEqFTu442IbDfPtop0GcM4lzz1lxVMo1,7GRhBDsirIGkRZBtSMEzNTyDr2JQm4xx,8,14,4,4,3,0,0,0,25,3.5714285714285716,4,0.0,2,4,4,3,12,0,0,0,0,13,12,0
1814,30861,Ip3irZsxFvOeGg8WSppVhJArbPhoH3qm,SpATywNh6bZuzm8s1ceuBUnMUAeoAHHw,20,33,12,16,3,7,13,3,87,12.428571428571429,1,0.0,17,12,14,3,16,7,2,13,3,46,41,0
1815,30871,3IgwuZBiVdgdYRQ9ySaEvpMizbjCJFS0,7GRhBDsirIGkRZBtSMEzNTyDr2JQm4xx,36,54,16,50,12,28,11,0,171,24.428571428571427,2,0.0,31,16,39,12,23,28,11,11,0,98,73,1
1816,30887,1NNWgXZojZkqAeoQhcUz4Xc8qgLXmALC,SpATywNh6bZuzm8s1ceuBUnMUAeoAHHw,29,122,60,22,34,16,5,0,259,37.0,7,0.0,42,60,22,34,80,16,0,5,0,158,101,0
1817,30889,9MbsP03nqyzNF8ytIM40Tx9W50TUxwHO,SpATywNh6bZuzm8s1ceuBUnMUAeoAHHw,10,19,0,0,0,0,1,0,20,2.857142857142857,1,0.0,0,0,0,0,19,0,0,1,0,0,20,0
1818,30905,5GkxvaD11peDsZoT8jF1pQZKBzcvYxOV,G8EPVSXsOYB5YQWZGiz1aVq5Pgr2GrQu,15,15,5,16,0,0,2,1,39,5.571428571428571,1,0.0,9,5,9,0,6,0,7,2,1,23,16,0
1819,30907,LKEJY5MvP0gj7M4NL5iRnXDBazXBKsOA,SpATywNh6bZuzm8s1ceuBUnMUAeoAHHw,19,35,14,8,4,28,15,0,104,14.857142857142858,5,0.0,7,14,7,4,28,28,1,15,0,32,72,0
1820,30948,CfeENerIdAGepleePWSt0SV88ctt0Tmw,G8EPVSXsOYB5YQWZGiz1aVq5Pgr2GrQu,5,3,2,0,1,0,2,0,8,1.1428571428571428,1,0.0,0,2,0,1,3,0,0,2,0,3,5,0
1821,30959,hjUSUM6roI2mLGkMAqBjE0uxFRBSMYHJ,SpATywNh6bZuzm8s1ceuBUnMUAeoAHHw,20,32,27,12,18,0,5,0,94,13.428571428571429,2,0.0,2,27,9,18,30,0,3,5,0,56,38,0
1822,31010,u8YPaORaz1zRBmx3Zp1zm30bQFzwDInM,SpATywNh6bZuzm8s1ceuBUnMUAeoAHHw,3,2,0,0,0,3,1,0,6,0.8571428571428571,1,0.0,0,0,0,0,2,3,0,1,0,0,6,0
1823,31062,CfeENerIdAGepleePWSt0SV88ctt0Tmw,A3fsA9Zfv1X2fVEQhTw51lKENdNrEqT3,1,0,0,0,0,0,1,0,1,0.14285714285714285,1,0.0,0,0,0,0,0,0,0,1,0,0,1,1
1824,31080,6U2xPMo27MRkbrPflG5WrvgHD37CuMpR,7GRhBDsirIGkRZBtSMEzNTyDr2JQm4xx,5,3,2,0,1,0,1,0,7,1.0,1,0.0,0,2,0,1,3,0,0,1,0,3,4,1
1825,31089,MxVVcAtMSnLQjlvLOx5XySlZblFVugTc,SpATywNh6bZuzm8s1ceuBUnMUAeoAHHw,8,9,1,0,0,0,4,0,14,2.0,1,0.0,0,1,0,0,9,0,0,4,0,1,13,0
1826,31100,yNeIUKhEuJHTBsPD5kABjlBuASduqZHz,SpATywNh6bZuzm8s1ceuBUnMUAeoAHHw,6,3,2,0,1,0,2,0,8,1.1428571428571428,1,0.0,0,2,0,1,3,0,0,2,0,3,5,1
1827,31137,JP79INNRcQzkUx6dZie4v1QvuMQ7OVUy,RXDvfPUBYFlVdlueBFbLW0mhhAyGEqpt,39,102,0,92,3,26,1,0,224,32.0,1,0.0,15,0,87,3,87,26,5,1,0,105,119,0
1828,31215,5Gf23uaI2ID1BMi2tbrzYBqwuoTD7nj1,G8EPVSXsOYB5YQWZGiz1aVq5Pgr2GrQu,59,66,30,56,23,3,11,1,190,27.142857142857142,2,0.0,30,30,50,23,36,3,6,11,1,133,57,0
1829,31282,U04y5vFf0AfyJVGIOJHlryTyRQEOm5pT,SpATywNh6bZuzm8s1ceuBUnMUAeoAHHw,10,13,1,6,0,0,1,0,21,3.0,1,0.0,3,1,5,0,10,0,1,1,0,9,12,0
1830,31294,wAJGUOfaMNSu8fVs50XbquwP1qlCP18o,7GRhBDsirIGkRZBtSMEzNTyDr2JQm4xx,18,77,27,26,3,118,15,1,267,38.142857142857146,5,0.0,39,27,14,3,38,118,12,15,1,83,184,0
1831,31315,flpVPPsUWfhNx2m3NGTbdkxp57HITcVF,SpATywNh6bZuzm8s1ceuBUnMUAeoAHHw,25,33,17,23,8,1,7,1,90,12.857142857142858,2,0.0,13,17,18,8,20,1,5,7,1,56,34,0
1832,31322,HgQbl59wfMZ62eOeVscJctviZYi0GAnj,SpATywNh6bZuzm8s1ceuBUnMUAeoAHHw,6,8,3,0,0,0,1,0,12,1.7142857142857142,1,0.0,3,3,0,0,5,0,0,1,0,6,6,0
1833,31349,RAFVAKoL6cQatcQ8rTN5mIwPhy02koDR,A3fsA9Zfv1X2fVEQhTw51lKENdNrEqT3,36,28,14,88,9,0,2,0,141,20.142857142857142,1,0.0,3,14,77,9,25,0,11,2,0,103,38,0
1834,31368,q15es4hix4DJR5zOH0N1aGsdTpjonWNC,SpATywNh6bZuzm8s1ceuBUnMUAeoAHHw,17,32,6,12,1,32,17,2,102,14.571428571428571,5,0.0,4,6,12,1,28,32,0,17,2,23,79,0
1835,31414,StcFIgK5T4YiiLiOpPHFjzohTVz9Jaf7,A3fsA9Zfv1X2fVEQhTw51lKENdNrEqT3,26,17,6,74,2,0,2,0,101,14.428571428571429,4,0.0,2,6,56,2,15,0,18,2,0,66,35,0
1836,31419,o7pzdRTO1dnxuhf9kxurH0oMz67aa1kw,SpATywNh6bZuzm8s1ceuBUnMUAeoAHHw,3,2,1,4,0,0,0,0,7,1.0,1,0.0,1,1,4,0,1,0,0,0,0,6,1,1
1837,31521,SQBW44VzMb5zXQWTfzFzAP2RU7qxP2su,bWdj2GDclj5ofokWjzoa5jAwMkxCykd6,28,32,20,144,12,0,5,0,213,30.428571428571427,4,0.0,7,20,131,12,25,0,13,5,0,170,43,1
1838,31532,oNX40hvUpCseO8BHKhGJvG2jyQpYKQyk,RXDvfPUBYFlVdlueBFbLW0mhhAyGEqpt,47,82,29,80,14,11,15,2,233,33.285714285714285,2,0.0,10,29,77,14,72,11,3,15,2,130,103,0
1839,31557,H3GbKrAtFVtLEXWNNdFaZDFbuKQIUVPU,SpATywNh6bZuzm8s1ceuBUnMUAeoAHHw,22,18,12,9,6,0,14,0,59,8.428571428571429,3,0.0,2,12,9,6,16,0,0,14,0,29,30,0
1840,31568,c49ANcMlFceMxZBmI2dFNiETx72UlFpt,SpATywNh6bZuzm8s1ceuBUnMUAeoAHHw,14,15,0,15,0,0,3,0,33,4.714285714285714,1,0.0,6,0,14,0,9,0,1,3,0,20,13,0
1841,31636,8V9pnrkvwK33pI3AiYSlsgxV7TeKgfNZ,G8EPVSXsOYB5YQWZGiz1aVq5Pgr2GrQu,73,123,32,114,15,78,11,4,377,53.857142857142854,5,0.0,62,32,69,15,61,78,45,11,4,178,199,0
1842,31637,5vZRuON34JUuUxkGF08Mu94iTiQzZas4,RXDvfPUBYFlVdlueBFbLW0mhhAyGEqpt,5,2,1,0,0,0,4,0,7,1.0,1,0.0,0,1,0,0,2,0,0,4,0,1,6,0
1843,31695,yWhbSfRhq0GQaIid8lmuGTuOjD7iQVVR,SpATywNh6bZuzm8s1ceuBUnMUAeoAHHw,12,21,2,12,1,4,3,0,43,6.142857142857143,2,0.0,7,2,9,1,14,4,3,3,0,19,24,1
1844,31730,a4RYqILKcnu8c617gYSbD0KQIm9DqZnc,SpATywNh6bZuzm8s1ceuBUnMUAeoAHHw,17,19,7,14,4,0,3,0,47,6.714285714285714,2,0.0,3,7,13,4,16,0,1,3,0,27,20,0
1845,31827,JOddnojV0OZrysgzYsnxzhRLS1r6GCxl,SpATywNh6bZuzm8s1ceuBUnMUAeoAHHw,3,2,1,0,0,0,1,0,4,0.5714285714285714,1,0.0,0,1,0,0,2,0,0,1,0,1,3,1
1846,31854,wLAgbiz3XWV6Nef8pQe1TlLxUN8CIoJ8,7GRhBDsirIGkRZBtSMEzNTyDr2JQm4xx,34,30,8,56,13,0,1,0,108,15.428571428571429,1,0.0,21,8,51,13,9,0,5,1,0,93,15,1
1847,31869,R2cga9JVVM2tXEVs2saYswslfxAU4nMk,SpATywNh6bZuzm8s1ceuBUnMUAeoAHHw,17,10,7,6,4,0,4,0,31,4.428571428571429,2,0.0,2,7,6,4,8,0,0,4,0,19,12,0
1848,31996,TZQnDQD4c1wLJcg98vkGC4z0YxJAykwb,SpATywNh6bZuzm8s1ceuBUnMUAeoAHHw,4,4,3,0,2,0,0,0,9,1.2857142857142858,1,0.0,0,3,0,2,4,0,0,0,0,5,4,0
1849,32112,Jf77UYIvUtofHBGpvQMQ0qUfMZBh9rRJ,SpATywNh6bZuzm8s1ceuBUnMUAeoAHHw,27,26,15,33,7,0,3,0,84,12.0,3,0.0,8,15,31,7,18,0,2,3,0,61,23,0
1850,32135,610PtRFkaYif9s7nz1Kdra5qTHjPTrYT,SpATywNh6bZuzm8s1ceuBUnMUAeoAHHw,16,12,8,14,6,0,2,0,42,6.0,1,0.0,2,8,13,6,10,0,1,2,0,29,13,0
1851,32141,jagu0OJDhWTGFhfCMk0ghqluLpW3kzdC,bWdj2GDclj5ofokWjzoa5jAwMkxCykd6,2,0,0,0,0,0,3,0,3,0.42857142857142855,1,0.0,0,0,0,0,0,0,0,3,0,0,3,1
1852,32162,kAQFM0dEgOQIxOG9jTMe5puRtNxZZWMN,A3fsA9Zfv1X2fVEQhTw51lKENdNrEqT3,25,14,0,94,0,0,1,0,109,15.571428571428571,2,0.0,1,0,82,0,13,0,12,1,0,83,26,0
1853,32165,xVQ88VrIuIA75ygDlevnROobNkwcFnsc,SpATywNh6bZuzm8s1ceuBUnMUAeoAHHw,12,15,0,9,0,7,4,0,35,5.0,1,0.0,0,0,8,0,15,7,1,4,0,8,27,0
1854,32220,dpAJ54wEPUDHZcYRCRrxvDfIakq9pmaQ,SpATywNh6bZuzm8s1ceuBUnMUAeoAHHw,11,12,1,12,0,0,1,0,26,3.7142857142857144,1,0.0,4,1,12,0,8,0,0,1,0,17,9,1
1855,32281,SSlieJULaqRb1C7jSzOwyPvbJnH3adQv,7GRhBDsirIGkRZBtSMEzNTyDr2JQm4xx,32,34,4,113,7,6,4,0,168,24.0,3,0.0,15,4,99,7,19,6,14,4,0,125,43,1
1856,32289,5getYNIZ2hnUwVH9nwJiD9At1XFs260U,RXDvfPUBYFlVdlueBFbLW0mhhAyGEqpt,25,42,4,36,2,0,1,0,85,12.142857142857142,1,0.0,15,4,32,2,27,0,4,1,0,53,32,0
1857,32378,dnBboDTKZBSq62soTT8p1zFH5HInmJMi,SpATywNh6bZuzm8s1ceuBUnMUAeoAHHw,4,2,1,0,0,0,2,0,5,0.7142857142857143,1,0.0,0,1,0,0,2,0,0,2,0,1,4,0
1858,32387,40BfkvCbbDiXljpQ7TxzzDakjMbYaL3S,SpATywNh6bZuzm8s1ceuBUnMUAeoAHHw,8,8,3,16,0,0,1,0,28,4.0,2,0.0,3,3,14,0,5,0,2,1,0,20,8,0
1859,32404,w7790lyNDi5biQPgaVfIpYKtROrGndED,SpATywNh6bZuzm8s1ceuBUnMUAeoAHHw,20,58,17,12,4,0,8,0,99,14.142857142857142,2,0.0,9,17,12,4,49,0,0,8,0,42,57,1
1860,32435,QqE2Xjwy9gUzOvFdkDqAwAaNZLBZkxvd,7GRhBDsirIGkRZBtSMEzNTyDr2JQm4xx,13,17,1,0,1,3,6,0,28,4.0,2,0.0,8,1,0,1,9,3,0,6,0,10,18,1
1861,32437,gGSMkNgPdXpBQgdZzyjzifomyCxFSNyt,A3fsA9Zfv1X2fVEQhTw51lKENdNrEqT3,4,5,2,0,0,0,5,0,12,1.7142857142857142,1,0.0,0,2,0,0,5,0,0,5,0,2,10,0
1862,32477,LPul7vNnoWP2lahy0vntgg039NwfmlYY,SpATywNh6bZuzm8s1ceuBUnMUAeoAHHw,3,2,0,0,0,0,1,0,3,0.42857142857142855,1,0.0,0,0,0,0,2,0,0,1,0,0,3,0
1863,32483,MauXcYq2z30gm4QmDqcfc1IfWjnRlPwg,SpATywNh6bZuzm8s1ceuBUnMUAeoAHHw,7,11,0,0,0,0,1,0,12,1.7142857142857142,1,0.0,0,0,0,0,11,0,0,1,0,0,12,0
1864,32520,AFUJTbEqqgSsqCkUsNrjbPAjZvFwpzeW,G8EPVSXsOYB5YQWZGiz1aVq5Pgr2GrQu,77,73,17,166,7,0,4,0,267,38.142857142857146,1,0.0,44,17,109,7,29,0,57,4,0,177,90,0
1865,32579,rQ8twu2Y4JlbZAVSeNSb6mmUSGGvpIAq,SpATywNh6bZuzm8s1ceuBUnMUAeoAHHw,13,14,3,16,0,3,5,0,41,5.857142857142857,1,0.0,2,3,14,0,12,3,2,5,0,19,22,0
1866,32600,jaDaYkvR41YbLhesvf9mW32i93zNzaSK,RXDvfPUBYFlVdlueBFbLW0mhhAyGEqpt,3,4,2,0,0,0,2,0,8,1.1428571428571428,2,0.0,0,2,0,0,4,0,0,2,0,2,6,0
1867,32617,ncKGr6xR4Vhs3wPeU0aqO1sSEow8LN64,SpATywNh6bZuzm8s1ceuBUnMUAeoAHHw,14,20,1,13,0,5,8,1,48,6.857142857142857,1,0.0,7,1,12,0,13,5,1,8,1,20,28,0
1868,32633,KSfQPUyfWWfWDmmi6m3KXcKzxz89wkwt,SpATywNh6bZuzm8s1ceuBUnMUAeoAHHw,17,10,7,6,5,0,1,0,29,4.142857142857143,1,0.0,2,7,6,5,8,0,0,1,0,20,9,0
1869,32661,qKc8EuUOlEzXysFMoXghKaieW3HIaePV,SpATywNh6bZuzm8s1ceuBUnMUAeoAHHw,6,3,2,0,1,0,2,0,8,1.1428571428571428,1,0.0,0,2,0,1,3,0,0,2,0,3,5,0
1870,32663,RQ7L9CpArhwtUrlKYRf29Ou4YmyW3xpx,A3fsA9Zfv1X2fVEQhTw51lKENdNrEqT3,15,16,9,0,6,0,6,0,37,5.285714285714286,1,0.0,0,9,0,6,16,0,0,6,0,15,22,0
1871,32688,vsH3qB64VOSnSTFhrkJQnHqm8c83psRR,SpATywNh6bZuzm8s1ceuBUnMUAeoAHHw,17,23,9,16,4,2,2,0,56,8.0,2,0.0,4,9,15,4,19,2,1,2,0,32,24,0
1872,32693,NrExtDPytZeckpp4FyIosvaEjFjzywmC,A3fsA9Zfv1X2fVEQhTw51lKENdNrEqT3,1,0,0,0,0,0,2,0,2,0.2857142857142857,1,0.0,0,0,0,0,0,0,0,2,0,0,2,1
1873,32732,L74tKRZpBi1qsh0NM3EwE5D87acCLK8s,A3fsA9Zfv1X2fVEQhTw51lKENdNrEqT3,30,15,8,96,2,1,13,0,135,19.285714285714285,6,0.0,1,8,96,2,14,1,0,13,0,107,28,0
1874,32746,mXsmDArxUTe9rMFHp3cGPJEx5ACYKD90,7GRhBDsirIGkRZBtSMEzNTyDr2JQm4xx,20,27,12,27,6,5,3,0,80,11.428571428571429,2,0.0,12,12,23,6,15,5,4,3,0,53,27,1
1875,32753,Gn3GzN2xweKhiR4C9qIb4ocllZ2lANYz,SpATywNh6bZuzm8s1ceuBUnMUAeoAHHw,7,7,5,0,3,0,2,0,17,2.4285714285714284,1,0.0,0,5,0,3,7,0,0,2,0,8,9,1
1876,32769,vEKYOhRdGZ59kfXY6wTO63YZY4EqPYqX,SpATywNh6bZuzm8s1ceuBUnMUAeoAHHw,11,10,7,0,4,0,2,0,23,3.2857142857142856,1,0.0,0,7,0,4,10,0,0,2,0,11,12,0
1877,32872,XEcLEoVa2SWvlFcbbhIECksb9a6XvMec,RXDvfPUBYFlVdlueBFbLW0mhhAyGEqpt,6,3,2,0,1,0,2,0,8,1.1428571428571428,1,0.0,0,2,0,1,3,0,0,2,0,3,5,0
1878,32887,9WVTv7dWHzTCHwCGLSPAioAO2udyHWmu,SpATywNh6bZuzm8s1ceuBUnMUAeoAHHw,2,0,0,0,0,0,2,0,2,0.2857142857142857,1,0.0,0,0,0,0,0,0,0,2,0,0,2,0
1879,32923,NqKjMSY6eOZQ1uSyzlPrquJVqzjvSO7O,SpATywNh6bZuzm8s1ceuBUnMUAeoAHHw,12,19,9,12,0,0,1,0,41,5.857142857142857,1,0.0,4,9,12,0,15,0,0,1,0,25,16,0
1880,32969,z4c8EBwIn89viFGIwasAjQhkMGV3BTQj,SpATywNh6bZuzm8s1ceuBUnMUAeoAHHw,14,22,15,14,11,0,0,0,62,8.857142857142858,2,0.0,7,15,10,11,15,0,4,0,0,43,19,0
1881,32983,BtS3BvehCjq4QaGPbzrC7JIugP6OKoPy,7GRhBDsirIGkRZBtSMEzNTyDr2JQm4xx,10,14,8,6,6,6,3,0,43,6.142857142857143,3,0.0,2,8,5,6,12,6,1,3,0,21,22,1
1882,33071,S4x7F2zwGMymIPjPy7YGoWTUwlKzmNvg,7GRhBDsirIGkRZBtSMEzNTyDr2JQm4xx,19,22,8,18,3,6,26,3,86,12.285714285714286,3,0.0,2,8,15,3,20,6,3,26,3,28,58,1
1883,33080,5ADMlR48WDr3F57JEz4JNbgGytxoga6J,SpATywNh6bZuzm8s1ceuBUnMUAeoAHHw,6,1,1,0,1,0,6,0,9,1.2857142857142858,2,0.0,0,1,0,1,1,0,0,6,0,2,7,0
1884,33150,vU01Fxors0KlSd7gao1Z0nHesILTHNPI,SpATywNh6bZuzm8s1ceuBUnMUAeoAHHw,16,10,7,4,4,5,9,0,39,5.571428571428571,3,0.0,0,7,4,4,10,5,0,9,0,15,24,0
1885,33169,FPQSXji4bDip0jB4obm0vWFPXClGuSyC,7GRhBDsirIGkRZBtSMEzNTyDr2JQm4xx,21,28,13,26,10,1,6,0,84,12.0,5,0.0,11,13,21,10,17,1,5,6,0,55,29,0
1886,33179,79cpMMK2EsbvkowaPozXyQoZKeC4iKuw,A3fsA9Zfv1X2fVEQhTw51lKENdNrEqT3,5,2,1,0,1,0,5,0,9,1.2857142857142858,2,0.0,0,1,0,1,2,0,0,5,0,2,7,0
1887,33203,6oSvXBiE6hMQm6ur1TzQBxRkuWf4UJ1w,SpATywNh6bZuzm8s1ceuBUnMUAeoAHHw,20,43,21,13,6,2,9,0,94,13.428571428571429,3,0.0,8,21,10,6,35,2,3,9,0,45,49,0
1888,33266,ANj8LPP4QCqsLHbhaQj263PWrIQ9dqGZ,SpATywNh6bZuzm8s1ceuBUnMUAeoAHHw,11,18,0,15,0,0,3,1,37,5.285714285714286,1,0.0,8,0,12,0,10,0,3,3,1,20,17,0
1889,33270,BFrfDseDfXCBvtTfCsJAy36Ogk6b0Rfx,SpATywNh6bZuzm8s1ceuBUnMUAeoAHHw,11,15,8,0,5,0,2,0,30,4.285714285714286,2,0.0,0,8,0,5,15,0,0,2,0,13,17,0
1890,33272,QQyKT0cNRgXjfYZrcyku7Q3OKE07rSzG,A3fsA9Zfv1X2fVEQhTw51lKENdNrEqT3,1,0,0,0,0,0,1,0,1,0.14285714285714285,1,0.0,0,0,0,0,0,0,0,1,0,0,1,1
1891,33284,jRnFs6XBk6vGxxB24JG9v0Qh3pYfUtLh,RXDvfPUBYFlVdlueBFbLW0mhhAyGEqpt,11,16,6,14,4,2,0,0,42,6.0,1,0.0,2,6,12,4,14,2,2,0,0,24,18,0
1892,33290,0wm7bVyJC7jfhIoeylaV85sHOH5JOhtj,SpATywNh6bZuzm8s1ceuBUnMUAeoAHHw,19,30,13,12,8,7,5,1,76,10.857142857142858,2,0.0,7,13,9,8,23,7,3,5,1,37,39,0
1893,33322,vIBcYbs1BLdmaaP30fcE2FS7kB7v7QRn,SpATywNh6bZuzm8s1ceuBUnMUAeoAHHw,3,2,1,0,0,0,1,0,4,0.5714285714285714,1,0.0,0,1,0,0,2,0,0,1,0,1,3,1
1894,33331,mJNmN9AbVBmhzBfxSlHeSff1yTyr8w50,SpATywNh6bZuzm8s1ceuBUnMUAeoAHHw,14,34,11,0,7,6,18,0,76,10.857142857142858,4,0.0,0,11,0,7,34,6,0,18,0,18,58,0
1895,33443,viuKt4GgrX0rYL5EpHoxJbsiC9TblSuk,bWdj2GDclj5ofokWjzoa5jAwMkxCykd6,8,6,4,0,2,0,3,0,15,2.142857142857143,1,0.0,0,4,0,2,6,0,0,3,0,6,9,0
1896,33469,viuKt4GgrX0rYL5EpHoxJbsiC9TblSuk,G8EPVSXsOYB5YQWZGiz1aVq5Pgr2GrQu,11,19,13,0,1,3,7,0,43,6.142857142857143,2,0.0,0,13,0,1,19,3,0,7,0,14,29,0
1897,33481,viuKt4GgrX0rYL5EpHoxJbsiC9TblSuk,RXDvfPUBYFlVdlueBFbLW0mhhAyGEqpt,20,63,34,0,6,0,13,0,116,16.571428571428573,2,0.0,6,34,0,6,57,0,0,13,0,46,70,0
1898,33576,KshwCmsAWd7PYW2Qdxpd0Dd8iC7QTJ5v,SpATywNh6bZuzm8s1ceuBUnMUAeoAHHw,11,10,4,0,3,0,2,0,19,2.7142857142857144,2,0.0,0,4,0,3,10,0,0,2,0,7,12,0
1899,33644,eE4DAv5aHElS2DPaTad4VXPjk6A3xvPl,G8EPVSXsOYB5YQWZGiz1aVq5Pgr2GrQu,69,51,35,128,22,0,6,0,242,34.57142857142857,3,0.0,5,35,115,22,46,0,13,6,0,177,65,0
1900,34738,4en36s6M5dWiGXaOz7Ao485PkasQppcC,7GRhBDsirIGkRZBtSMEzNTyDr2JQm4xx,1,0,0,0,0,0,1,0,1,0.14285714285714285,1,0.0,0,0,0,0,0,0,0,1,0,0,1,1
1901,35152,VsfU7jeSb2K8k0CBzCZzXJjDlMye1sB1,7GRhBDsirIGkRZBtSMEzNTyDr2JQm4xx,5,6,5,0,0,1,1,0,13,1.8571428571428572,1,0.0,0,5,0,0,6,1,0,1,0,5,8,1
1902,35156,WDMP5c2Ubx8vVSFegA0mXeU23cYb0qCY,7GRhBDsirIGkRZBtSMEzNTyDr2JQm4xx,27,37,2,32,5,4,2,0,82,11.714285714285714,3,0.0,18,2,30,5,19,4,2,2,0,55,27,1
1903,35159,dJJJLtI6F18pblO9KPkBPg9ZKTgQPaQc,7GRhBDsirIGkRZBtSMEzNTyDr2JQm4xx,7,8,0,2,1,1,1,0,13,1.8571428571428572,1,0.0,2,0,2,1,6,1,0,1,0,5,8,0
1904,35167,eU4MPF9R01ru4sQN9giW756pdpNlnW4H,7GRhBDsirIGkRZBtSMEzNTyDr2JQm4xx,3,2,1,0,0,0,1,0,4,0.5714285714285714,1,0.0,0,1,0,0,2,0,0,1,0,1,3,0
1905,35583,O36QxtTrV6jSigC0QBjRMiqSpx0KHX6w,7GRhBDsirIGkRZBtSMEzNTyDr2JQm4xx,21,41,15,51,5,4,3,0,119,17.0,1,0.0,23,15,43,5,18,4,8,3,0,86,33,0
1906,35592,WgQR6nrfyl7yDpgHC595JSoog2R9VhVs,7GRhBDsirIGkRZBtSMEzNTyDr2JQm4xx,39,92,43,80,22,3,9,0,249,35.57142857142857,7,0.0,33,43,61,22,59,3,19,9,0,159,90,0
1907,35726,xHZbSROhwP4RRQerUVWvcNTfOGc2DHWf,7GRhBDsirIGkRZBtSMEzNTyDr2JQm4xx,31,104,37,44,17,10,26,0,238,34.0,7,0.0,24,37,37,17,80,10,7,26,0,115,123,1
1908,35753,aXYyJMDvVYwwKBbiO4CB25XlnDBfWYNg,7GRhBDsirIGkRZBtSMEzNTyDr2JQm4xx,12,17,5,18,0,3,0,0,43,6.142857142857143,1,0.0,11,5,15,0,6,3,3,0,0,31,12,0
1909,35817,Kneva8tRfI6BhvgFMe4i80mebf2hEQk0,7GRhBDsirIGkRZBtSMEzNTyDr2JQm4xx,3,1,1,0,1,0,0,0,3,0.42857142857142855,1,0.0,0,1,0,1,1,0,0,0,0,2,1,1
1910,37600,NHGmMinB9WoQusKCx50F4M4nJF124Ms4,A3fsA9Zfv1X2fVEQhTw51lKENdNrEqT3,3,2,1,0,0,0,1,0,4,0.5714285714285714,1,0.0,0,1,0,0,2,0,0,1,0,1,3,1
1911,37607,NvmmlHTgNmxqyrQU3a9c6oM8kVrIYu3Q,SpATywNh6bZuzm8s1ceuBUnMUAeoAHHw,10,11,6,0,5,0,2,0,24,3.4285714285714284,2,0.0,0,6,0,5,11,0,0,2,0,11,13,1
1912,37627,61Btwz5kWZaS3OIGnNTMXi3lqbtcLCB7,SpATywNh6bZuzm8s1ceuBUnMUAeoAHHw,16,30,6,11,2,0,9,0,58,8.285714285714286,4,0.0,4,6,11,2,26,0,0,9,0,23,35,1
1913,37628,9S5uoFAiVHVF4D2DNR23wCkbQZ8LhtES,RXDvfPUBYFlVdlueBFbLW0mhhAyGEqpt,19,26,8,24,7,0,5,0,70,10.0,3,0.0,9,8,22,7,17,0,2,5,0,46,24,0
1914,37686,UkQJwGAwu2oSVR7bdUsiWWEqFzH2qHlf,SpATywNh6bZuzm8s1ceuBUnMUAeoAHHw,22,31,4,34,1,0,4,0,74,10.571428571428571,2,0.0,9,4,29,1,22,0,5,4,0,43,31,0
1915,37730,z3YnX73v2uoVHmuLGzQD2gKKBoJqIQxK,bWdj2GDclj5ofokWjzoa5jAwMkxCykd6,29,56,33,118,20,1,14,1,243,34.714285714285715,3,0.0,12,33,106,20,44,1,12,14,1,171,72,0
1916,37750,GpHiOkm3UY3R1sigoD8RZsfbPyCjOvL2,bWdj2GDclj5ofokWjzoa5jAwMkxCykd6,10,18,9,0,7,0,11,1,46,6.571428571428571,4,0.0,0,9,0,7,18,0,0,11,1,16,30,1
1917,37778,MT2eJtF59AVNdUs7mwFqputROb2HgEm3,A3fsA9Zfv1X2fVEQhTw51lKENdNrEqT3,29,9,6,86,3,0,2,0,106,15.142857142857142,2,0.0,1,6,70,3,8,0,16,2,0,80,26,0
1918,37794,uQjl8NGtIQkRfoe9edBiMgtYYmdkzVXR,A3fsA9Zfv1X2fVEQhTw51lKENdNrEqT3,26,39,19,52,7,8,19,1,145,20.714285714285715,3,0.0,2,19,42,7,37,8,10,19,1,70,75,0
1919,37809,eEE69ZWSNrdmveqNEUHZYk60iG9wpaEc,SpATywNh6bZuzm8s1ceuBUnMUAeoAHHw,5,4,2,0,1,0,1,0,8,1.1428571428571428,1,0.0,0,2,0,1,4,0,0,1,0,3,5,1
1920,37823,2Y3h62Lps0fU6B3C4MXM4YNVNDf25XBr,SpATywNh6bZuzm8s1ceuBUnMUAeoAHHw,4,3,1,0,0,0,1,0,5,0.7142857142857143,1,0.0,0,1,0,0,3,0,0,1,0,1,4,0
1921,37827,C2tzR0PThnHl9xmZylE5Te8es3KNWViY,bWdj2GDclj5ofokWjzoa5jAwMkxCykd6,7,12,0,0,1,1,3,0,17,2.4285714285714284,3,0.0,0,0,0,1,12,1,0,3,0,1,16,1
1922,37900,qZhmmNUvkNXdf3u04DTUQOFEBxxO10p4,SpATywNh6bZuzm8s1ceuBUnMUAeoAHHw,18,32,12,12,4,0,7,0,67,9.571428571428571,4,0.0,8,12,12,4,24,0,0,7,0,36,31,0
1923,37902,fHWbyI7D8dlYSwaHNTLNlsq8suMt5t3C,SpATywNh6bZuzm8s1ceuBUnMUAeoAHHw,13,15,0,14,0,0,7,0,36,5.142857142857143,2,0.0,2,0,13,0,13,0,1,7,0,15,21,1
1924,37917,zov347eGa3QeB2nEEXWZhFIKLoCmgiMD,SpATywNh6bZuzm8s1ceuBUnMUAeoAHHw,6,6,0,0,0,0,4,0,10,1.4285714285714286,1,0.0,0,0,0,0,6,0,0,4,0,0,10,0
1925,37922,j3dtYivg2u73ZbuSWbPPpSBQQec6vBYH,A3fsA9Zfv1X2fVEQhTw51lKENdNrEqT3,1,0,0,0,0,0,1,0,1,0.14285714285714285,1,0.0,0,0,0,0,0,0,0,1,0,0,1,0
1926,37940,QmHQ7ayFECnRsgCVpHpJI6yMYR4kf5re,bWdj2GDclj5ofokWjzoa5jAwMkxCykd6,6,8,6,0,0,0,2,0,16,2.2857142857142856,1,0.0,0,6,0,0,8,0,0,2,0,6,10,0
1927,37973,k0lvFNaTVHTtB1XHBZ8229ej4v1r4rPk,bWdj2GDclj5ofokWjzoa5jAwMkxCykd6,6,4,0,0,0,0,5,0,9,1.2857142857142858,1,0.0,0,0,0,0,4,0,0,5,0,0,9,0
1928,38004,QEbMAkKsvpPGPL1XkTiHjXblquVwKrlD,A3fsA9Zfv1X2fVEQhTw51lKENdNrEqT3,1,0,0,0,0,0,1,0,1,0.14285714285714285,1,0.0,0,0,0,0,0,0,0,1,0,0,1,1
1929,38144,0Hl4WpPV6z0OC8rO0L3mZy6harAUBUs7,G8EPVSXsOYB5YQWZGiz1aVq5Pgr2GrQu,36,27,2,96,1,2,14,1,143,20.428571428571427,3,0.0,7,2,85,1,20,2,11,14,1,95,48,1
1930,38157,tHNSnLtZK1vGs5MVrEoD7S1mcW3GtFm4,SpATywNh6bZuzm8s1ceuBUnMUAeoAHHw,5,4,2,0,1,0,1,0,8,1.1428571428571428,1,0.0,0,2,0,1,4,0,0,1,0,3,5,0
1931,38170,vs0vqlNXzuHsqVxOsB15kGfpvGf2pUt3,SpATywNh6bZuzm8s1ceuBUnMUAeoAHHw,10,18,9,12,1,0,3,0,43,6.142857142857143,3,0.0,5,9,12,1,13,0,0,3,0,27,16,0
1932,38187,SX4dmJ5a5AfJLGZkCiiWab293xeIyxbW,SpATywNh6bZuzm8s1ceuBUnMUAeoAHHw,20,26,3,10,2,0,4,1,46,6.571428571428571,3,0.0,2,3,9,2,24,0,1,4,1,16,30,0
1933,38206,kKH4olslIcMX5RimtmBANWk2T6CuD4cI,G8EPVSXsOYB5YQWZGiz1aVq5Pgr2GrQu,11,7,4,55,2,0,0,0,68,9.714285714285714,1,0.0,1,4,46,2,6,0,9,0,0,53,15,1
1934,38252,S2i0VW7GN0ACeCnuAPN00XONM8w8kvsN,G8EPVSXsOYB5YQWZGiz1aVq5Pgr2GrQu,61,57,26,121,0,10,9,2,225,32.142857142857146,3,0.0,27,26,85,0,30,10,36,9,2,138,87,0
1935,38264,DPr3Hy8387gfJi0Jc3ohxKBzY0mvhH1G,SpATywNh6bZuzm8s1ceuBUnMUAeoAHHw,11,13,5,13,0,24,5,0,60,8.571428571428571,2,0.0,6,5,13,0,7,24,0,5,0,24,36,0
1936,38269,gzTBwYPoQwnODJJ2vedsUKp2EoGao5Fz,bWdj2GDclj5ofokWjzoa5jAwMkxCykd6,2,0,0,0,0,0,2,0,2,0.2857142857142857,1,0.0,0,0,0,0,0,0,0,2,0,0,2,1
1937,38514,88mqKZu0uTbuMx2E6ZRqhvo4tmoL4qfn,SpATywNh6bZuzm8s1ceuBUnMUAeoAHHw,5,3,1,0,1,0,1,0,6,0.8571428571428571,1,0.0,0,1,0,1,3,0,0,1,0,2,4,1
1938,38550,Xq1kPqflDNgXwQ2pEniNYUjMpkVzPp1m,A3fsA9Zfv1X2fVEQhTw51lKENdNrEqT3,23,6,3,50,1,0,2,0,62,8.857142857142858,2,0.0,1,3,48,1,5,0,2,2,0,53,9,1
1939,38554,tajSblOKlQlXdpIXIOLLEJCHn56vIOfT,bWdj2GDclj5ofokWjzoa5jAwMkxCykd6,7,10,0,0,0,28,7,0,45,6.428571428571429,2,0.0,1,0,0,0,9,28,0,7,0,1,44,1
1940,38556,rajcXZ0kL5d9yXQIc9HHtBEyfRs8vn2R,G8EPVSXsOYB5YQWZGiz1aVq5Pgr2GrQu,3,2,0,0,0,0,1,0,3,0.42857142857142855,1,0.0,0,0,0,0,2,0,0,1,0,0,3,1
1941,38676,aWfbena9lEo41V5W87oDDgjvcz4pLKtN,SpATywNh6bZuzm8s1ceuBUnMUAeoAHHw,15,15,6,11,4,0,1,0,37,5.285714285714286,1,0.0,8,6,11,4,7,0,0,1,0,29,8,0
1942,38679,5LOlerEFHf0UNcpvuhvEHGBh6ERlMDur,G8EPVSXsOYB5YQWZGiz1aVq5Pgr2GrQu,9,5,3,0,1,0,5,0,14,2.0,2,0.0,0,3,0,1,5,0,0,5,0,4,10,0
1943,38687,RfCEa3pRuKLOxQiUZgZZMFg3JntXDg1m,SpATywNh6bZuzm8s1ceuBUnMUAeoAHHw,3,2,1,0,0,0,1,0,4,0.5714285714285714,1,0.0,0,1,0,0,2,0,0,1,0,1,3,0
1944,38692,ktbF3sxXQk0MrToCOKFGvH2bCmfBVgYK,G8EPVSXsOYB5YQWZGiz1aVq5Pgr2GrQu,5,5,2,0,1,0,2,0,10,1.4285714285714286,1,0.0,0,2,0,1,5,0,0,2,0,3,7,0
1945,38708,QWAnJ98MRtHXbl78XXr3UpScat4E7MnZ,SpATywNh6bZuzm8s1ceuBUnMUAeoAHHw,1,0,0,0,0,0,1,0,1,0.14285714285714285,1,0.0,0,0,0,0,0,0,0,1,0,0,1,0
1946,38769,OygU41dc8lyatpKc4JEBkP0ni21xzfvB,SpATywNh6bZuzm8s1ceuBUnMUAeoAHHw,1,0,0,0,0,0,1,0,1,0.14285714285714285,1,0.0,0,0,0,0,0,0,0,1,0,0,1,0
1947,38860,aSq9IJ4ZfLUbnD7QSBT8oeA7EtoTrGal,bWdj2GDclj5ofokWjzoa5jAwMkxCykd6,13,10,7,0,7,0,1,0,25,3.5714285714285716,1,0.0,0,7,0,7,10,0,0,1,0,14,11,1
1948,38954,hWagcbwGHP337RS0iBSta7Eh6v3OAnlN,SpATywNh6bZuzm8s1ceuBUnMUAeoAHHw,1,0,0,0,0,0,1,0,1,0.14285714285714285,1,0.0,0,0,0,0,0,0,0,1,0,0,1,1
1949,38960,csUQD8kl5B2qOhCgBpUdVV3uOWaYGbyH,A3fsA9Zfv1X2fVEQhTw51lKENdNrEqT3,15,17,0,0,0,1,5,0,23,3.2857142857142856,1,0.0,1,0,0,0,16,1,0,5,0,1,22,1
1950,38984,Np3UGgyqJRbdjHAs6eqMYNuWuEJ67rAv,bWdj2GDclj5ofokWjzoa5jAwMkxCykd6,18,18,9,52,3,0,2,0,84,12.0,2,0.0,3,9,49,3,15,0,3,2,0,64,20,1
1951,38995,7nUtazUwwSnnXJpIKdQBJGpXV6Po42DQ,A3fsA9Zfv1X2fVEQhTw51lKENdNrEqT3,3,0,0,0,0,0,11,0,11,1.5714285714285714,1,0.0,0,0,0,0,0,0,0,11,0,0,11,1
1952,39050,St7zx5CuqYmo3cCQEAdzvR5kNp3mDM9y,SpATywNh6bZuzm8s1ceuBUnMUAeoAHHw,12,7,4,8,2,4,2,0,27,3.857142857142857,1,0.0,2,4,7,2,5,4,1,2,0,15,12,0
1953,39057,l21tCwOolR7RD0CZyqRiNHHeEZC1D67K,SpATywNh6bZuzm8s1ceuBUnMUAeoAHHw,4,3,2,0,0,0,1,0,6,0.8571428571428571,1,0.0,0,2,0,0,3,0,0,1,0,2,4,0
1954,39060,T4lMOZ9NGQ0RS4ue5IeZuDcW1ySIGZ9u,A3fsA9Zfv1X2fVEQhTw51lKENdNrEqT3,8,7,5,0,3,0,2,0,17,2.4285714285714284,1,0.0,0,5,0,3,7,0,0,2,0,8,9,1
1955,39076,76j1Dib3EpIIxYpQXxI6VKhD3TOXoxhS,SpATywNh6bZuzm8s1ceuBUnMUAeoAHHw,5,3,1,0,1,0,1,0,6,0.8571428571428571,1,0.0,0,1,0,1,3,0,0,1,0,2,4,1
1956,39090,fTfrYxb6cRWvjdEVjIZ7skF0s5uk6kd9,SpATywNh6bZuzm8s1ceuBUnMUAeoAHHw,17,21,9,28,4,0,2,0,64,9.142857142857142,1,0.0,4,9,27,4,17,0,1,2,0,44,20,0
1957,39113,VvziK1FrzCcoikfRc0daxkE7fq3iFq0v,SpATywNh6bZuzm8s1ceuBUnMUAeoAHHw,16,18,9,13,5,0,1,0,46,6.571428571428571,1,0.0,8,9,12,5,10,0,1,1,0,34,12,0
1958,39131,uJIh67cllxQLgAhipzdDZMEunDbuBxvF,RXDvfPUBYFlVdlueBFbLW0mhhAyGEqpt,4,2,1,0,0,0,3,0,6,0.8571428571428571,1,0.0,0,1,0,0,2,0,0,3,0,1,5,0
1959,39182,VIwJtaSOWWljnDL02ObzIxH4JeVU0QQ1,bWdj2GDclj5ofokWjzoa5jAwMkxCykd6,1,0,0,0,0,0,1,0,1,0.14285714285714285,1,0.0,0,0,0,0,0,0,0,1,0,0,1,1
1960,39216,qsBNE43NxZycap30DuQDyNDzs5hGI95w,SpATywNh6bZuzm8s1ceuBUnMUAeoAHHw,12,10,8,2,4,0,2,0,26,3.7142857142857144,1,0.0,0,8,2,4,10,0,0,2,0,14,12,1
1961,39243,gpyXT5iZHN1onXoVstOXZoiFizXraIkU,SpATywNh6bZuzm8s1ceuBUnMUAeoAHHw,1,0,0,0,0,0,1,0,1,0.14285714285714285,1,0.0,0,0,0,0,0,0,0,1,0,0,1,1
1962,39246,fv07Mlz09PBHitYybJt9eVrK276xe9YI,SpATywNh6bZuzm8s1ceuBUnMUAeoAHHw,12,5,3,14,2,0,8,0,32,4.571428571428571,2,0.0,2,3,11,2,3,0,3,8,0,18,14,0
1963,39301,ezp80xTAgodAGV4fsnNivfTneJn97tLE,RXDvfPUBYFlVdlueBFbLW0mhhAyGEqpt,24,19,11,34,8,2,1,0,75,10.714285714285714,1,0.0,4,11,31,8,15,2,3,1,0,54,21,0
1964,39330,YY7yHizDn0UpGHVq4qoTfbulP3ev5TkC,SpATywNh6bZuzm8s1ceuBUnMUAeoAHHw,19,12,11,0,8,4,4,0,39,5.571428571428571,1,0.0,0,11,0,8,12,4,0,4,0,19,20,0
1965,39349,8eqcmJf66b25Hdf1a71yMHA6gdhfVvDC,G8EPVSXsOYB5YQWZGiz1aVq5Pgr2GrQu,5,2,1,0,0,12,5,2,22,3.142857142857143,2,0.0,0,1,0,0,2,12,0,5,2,1,21,0
1966,39377,M0xQooArrVMTCCgk3YkWTaBSUVldkFxi,SpATywNh6bZuzm8s1ceuBUnMUAeoAHHw,15,16,9,14,3,16,9,0,67,9.571428571428571,2,0.0,2,9,14,3,14,16,0,9,0,28,39,0
1967,39407,W7Pzvj7hPa3qVKdWluutDHqjcp3iIpAb,SpATywNh6bZuzm8s1ceuBUnMUAeoAHHw,15,28,13,18,8,1,1,0,69,9.857142857142858,2,0.0,13,13,16,8,15,1,2,1,0,50,19,0
1968,39430,IAvuP4GGmvnNj3Zisz3jDfo3mSmXiJSb,bWdj2GDclj5ofokWjzoa5jAwMkxCykd6,1,0,0,0,0,0,3,0,3,0.42857142857142855,2,0.0,0,0,0,0,0,0,0,3,0,0,3,0
1969,39441,VsLOJ7Xi4SI8kpOP7KF7SoJJkHTp6ASm,SpATywNh6bZuzm8s1ceuBUnMUAeoAHHw,18,17,11,15,8,0,5,0,56,8.0,2,0.0,4,11,14,8,13,0,1,5,0,37,19,0
1970,39485,O9c4mZKt6PM5RxUHcRjnRJOfvI41UF2p,SpATywNh6bZuzm8s1ceuBUnMUAeoAHHw,16,20,8,10,4,0,2,0,44,6.285714285714286,1,0.0,11,8,8,4,9,0,2,2,0,31,13,0
1971,39526,3Aezv8lgcVyIW4Uwgi3KMiL4RZSkwke5,A3fsA9Zfv1X2fVEQhTw51lKENdNrEqT3,8,8,5,0,1,0,2,0,16,2.2857142857142856,1,0.0,1,5,0,1,7,0,0,2,0,7,9,1
1972,39527,BZSYb0PJXmPcTlknqBAAi8E9uLmy4IRE,SpATywNh6bZuzm8s1ceuBUnMUAeoAHHw,10,10,7,6,0,0,1,0,24,3.4285714285714284,1,0.0,0,7,6,0,10,0,0,1,0,13,11,1
1973,39537,xg8lJQFNYZJBLJxL1TK1I5KNSxuhMUEI,bWdj2GDclj5ofokWjzoa5jAwMkxCykd6,3,2,1,0,0,0,1,0,4,0.5714285714285714,1,0.0,0,1,0,0,2,0,0,1,0,1,3,1
1974,39560,tfLWXkHQA3FBV54C2lvq1caDx4Pi6QwO,SpATywNh6bZuzm8s1ceuBUnMUAeoAHHw,17,18,9,12,5,0,1,0,45,6.428571428571429,2,0.0,2,9,12,5,16,0,0,1,0,28,17,0
1975,39567,YC5UG6m05nI4uxDXYqrNEKgzKHSk4oSu,SpATywNh6bZuzm8s1ceuBUnMUAeoAHHw,5,4,2,0,0,0,1,0,7,1.0,1,0.0,0,2,0,0,4,0,0,1,0,2,5,0
1976,39587,X14gKVD1ZKu0qL0NchpqxwhoYSEpz9QI,SpATywNh6bZuzm8s1ceuBUnMUAeoAHHw,8,10,2,0,1,0,3,0,16,2.2857142857142856,3,0.0,0,2,0,1,10,0,0,3,0,3,13,0
1977,39630,3Aezv8lgcVyIW4Uwgi3KMiL4RZSkwke5,bWdj2GDclj5ofokWjzoa5jAwMkxCykd6,7,13,8,0,2,0,4,0,27,3.857142857142857,3,0.0,0,8,0,2,13,0,0,4,0,10,17,0
1978,39649,BfV7UiYzJLw6WeEm3hlQsMK4WHcSosq4,A3fsA9Zfv1X2fVEQhTw51lKENdNrEqT3,49,27,24,94,21,0,3,0,169,24.142857142857142,2,0.0,1,24,75,21,26,0,19,3,0,121,48,1
1979,39652,6FzXe5nPWUHRxntREHsQRnp7x1pxuhUz,bWdj2GDclj5ofokWjzoa5jAwMkxCykd6,14,29,11,44,4,8,5,1,102,14.571428571428571,1,0.0,10,11,43,4,19,8,1,5,1,68,34,1
1980,39676,jsiVqpEsXq0sluinZw5ff1hSi6FTnuod,SpATywNh6bZuzm8s1ceuBUnMUAeoAHHw,4,2,1,0,1,0,2,0,6,0.8571428571428571,1,0.0,0,1,0,1,2,0,0,2,0,2,4,1
1981,39723,wg81hfugF770xMHAXCLP7YJmOhdUJnHl,SpATywNh6bZuzm8s1ceuBUnMUAeoAHHw,19,29,10,12,6,4,7,1,69,9.857142857142858,3,0.0,3,10,9,6,26,4,3,7,1,28,41,0
1982,39776,OdMr7dE5UlAme9Tp979vREBvY5CV50po,bWdj2GDclj5ofokWjzoa5jAwMkxCykd6,21,7,5,48,3,0,2,0,65,9.285714285714286,1,0.0,1,5,45,3,6,0,3,2,0,54,11,0
1983,39828,ke8J6J68PMmqZ8rK8FCDUgXlLZQpLLZW,A3fsA9Zfv1X2fVEQhTw51lKENdNrEqT3,9,4,3,0,0,0,6,1,14,2.0,2,0.0,0,3,0,0,4,0,0,6,1,3,11,1
1984,39919,C6gazwyl7EiFD8XZj9L3YaSfbatiTDEE,bWdj2GDclj5ofokWjzoa5jAwMkxCykd6,6,4,3,0,1,0,1,0,9,1.2857142857142858,1,0.0,0,3,0,1,4,0,0,1,0,4,5,0
1985,39924,1Lhe3e5bki1E1AUNwq5SspoMJiU5aMmH,RXDvfPUBYFlVdlueBFbLW0mhhAyGEqpt,39,37,25,59,20,0,2,0,143,20.428571428571427,1,0.0,10,25,53,20,27,0,6,2,0,108,35,0
1986,39925,muBWBBbWzkNF6Dzg57EIx35WmD2zp0yP,SpATywNh6bZuzm8s1ceuBUnMUAeoAHHw,6,4,1,0,1,0,1,0,7,1.0,1,0.0,0,1,0,1,4,0,0,1,0,2,5,0
1987,39938,RVwnUs0luG0pmL3ADXHeT8MpQNWgZj3Z,RXDvfPUBYFlVdlueBFbLW0mhhAyGEqpt,2,2,2,0,0,0,0,0,4,0.5714285714285714,1,0.0,0,2,0,0,2,0,0,0,0,2,2,1
1988,39956,CHAwTqWzS9gyj5Ro2Bvsw8FCNCA8dW6W,RXDvfPUBYFlVdlueBFbLW0mhhAyGEqpt,2,0,0,0,0,0,3,0,3,0.42857142857142855,1,0.0,0,0,0,0,0,0,0,3,0,0,3,1
1989,39967,VFl026LXCSxME7l2ZLRhGKmh3R96duCq,SpATywNh6bZuzm8s1ceuBUnMUAeoAHHw,19,42,24,10,14,3,12,1,106,15.142857142857142,3,0.0,5,24,10,14,37,3,0,12,1,53,53,0
1990,39989,dhMm94sLRibUWA6YOpXlMLxyaR3sl4a9,A3fsA9Zfv1X2fVEQhTw51lKENdNrEqT3,11,24,1,0,1,0,5,0,31,4.428571428571429,3,0.0,0,1,0,1,24,0,0,5,0,2,29,0
1991,40039,28PHU9suTM8EqUKsQwsvQ03DzFXi0yDl,A3fsA9Zfv1X2fVEQhTw51lKENdNrEqT3,45,20,15,54,10,1,12,1,113,16.142857142857142,3,0.0,2,15,46,10,18,1,8,12,1,73,40,0
1992,40054,dlphjzS7Cck7yL7KPK4kXgmYSbBOCuFC,bWdj2GDclj5ofokWjzoa5jAwMkxCykd6,9,7,4,28,1,5,6,2,53,7.571428571428571,1,0.0,1,4,28,1,6,5,0,6,2,34,19,0
1993,40104,FUMcFXXfXADMgcSzTyKSabMQ45EVJp0n,A3fsA9Zfv1X2fVEQhTw51lKENdNrEqT3,1,0,0,0,0,0,1,0,1,0.14285714285714285,1,0.0,0,0,0,0,0,0,0,1,0,0,1,1
1994,40137,7Blw5DXu09ENSrwHZywqqUdODuz4CZi6,SpATywNh6bZuzm8s1ceuBUnMUAeoAHHw,16,17,8,6,6,0,3,0,40,5.714285714285714,1,0.0,6,8,6,6,11,0,0,3,0,26,14,0
1995,40149,iUzEPtD1F6CCo8jGkTMMkDMICh5ACqJB,SpATywNh6bZuzm8s1ceuBUnMUAeoAHHw,5,2,1,0,0,0,4,0,7,1.0,1,0.0,0,1,0,0,2,0,0,4,0,1,6,1
1996,40156,BM23agkLBTvZTkItMt2GtI7Rt9Nmmgof,SpATywNh6bZuzm8s1ceuBUnMUAeoAHHw,12,12,6,0,4,0,2,0,24,3.4285714285714284,2,0.0,0,6,0,4,12,0,0,2,0,10,14,0
1997,40164,Ml8yd2wTtJsMaa32cmbKtb7cTpIqIKz4,SpATywNh6bZuzm8s1ceuBUnMUAeoAHHw,9,7,4,0,2,0,4,0,17,2.4285714285714284,1,0.0,0,4,0,2,7,0,0,4,0,6,11,1
1998,40184,p2NSaI2ihMq1kpyPoZO7VVEhFNMs1UZl,bWdj2GDclj5ofokWjzoa5jAwMkxCykd6,8,8,3,10,1,0,1,0,23,3.2857142857142856,1,0.0,4,3,9,1,4,0,1,1,0,17,6,1
1999,40198,w1whp42bLIFDRZ3YUW58J4w8I7T8mTT8,SpATywNh6bZuzm8s1ceuBUnMUAeoAHHw,4,10,1,0,0,0,1,0,12,1.7142857142857142,1,0.0,7,1,0,0,3,0,0,1,0,8,4,1
2000,40257,IRfJ2J3e4oTjcMA6yNpRgLvZtLwyduUa,SpATywNh6bZuzm8s1ceuBUnMUAeoAHHw,19,57,22,8,14,5,16,0,122,17.428571428571427,3,0.0,4,22,7,14,53,5,1,16,0,47,75,0
2001,40282,CSh5hGbaSFu2yCb31iVMOVwKocrH471Q,A3fsA9Zfv1X2fVEQhTw51lKENdNrEqT3,44,21,14,80,10,0,6,0,131,18.714285714285715,2,0.0,1,14,61,10,20,0,19,6,0,86,45,1
2002,40319,wg81hfugF770xMHAXCLP7YJmOhdUJnHl,A3fsA9Zfv1X2fVEQhTw51lKENdNrEqT3,1,0,0,0,0,0,1,0,1,0.14285714285714285,1,0.0,0,0,0,0,0,0,0,1,0,0,1,0
2003,40332,JCQSo9f9Aey0YG4wslCCbhR6oOLB0oC6,SpATywNh6bZuzm8s1ceuBUnMUAeoAHHw,20,22,13,6,4,5,8,1,59,8.428571428571429,1,0.0,2,13,6,4,20,5,0,8,1,25,34,0
2004,40402,O7GZYzgRa5tZbYrbtpqYuheFfdPZTjLl,bWdj2GDclj5ofokWjzoa5jAwMkxCykd6,5,4,3,0,1,0,1,0,9,1.2857142857142858,1,0.0,0,3,0,1,4,0,0,1,0,4,5,1
2005,40413,0Cx8S0i9vAPm7jZ8jXLUkrYp9xGpIHIS,SpATywNh6bZuzm8s1ceuBUnMUAeoAHHw,4,2,1,0,0,4,2,2,11,1.5714285714285714,1,0.0,0,1,0,0,2,4,0,2,2,1,10,1
2006,40423,8jqDD2phXiMGQf0XQi1kVRzLj3TILO0y,RXDvfPUBYFlVdlueBFbLW0mhhAyGEqpt,5,4,2,0,0,0,3,0,9,1.2857142857142858,1,0.0,1,2,0,0,3,0,0,3,0,3,6,1
2007,40467,bNBhDpviOcrLuVFG9Qda6S7fiYJ6jIvc,SpATywNh6bZuzm8s1ceuBUnMUAeoAHHw,5,4,4,0,2,0,0,0,10,1.4285714285714286,1,0.0,0,4,0,2,4,0,0,0,0,6,4,1
2008,40470,nc7wDS7f7s8kprAeqMfrtjmYyoRdpJ65,bWdj2GDclj5ofokWjzoa5jAwMkxCykd6,4,2,1,0,0,0,2,0,5,0.7142857142857143,1,0.0,0,1,0,0,2,0,0,2,0,1,4,1
2009,40483,qbRtu1q5PIx1qmhJ9lRn0S3Y5dNcEYWw,G8EPVSXsOYB5YQWZGiz1aVq5Pgr2GrQu,14,8,2,18,1,0,5,0,34,4.857142857142857,1,0.0,0,2,14,1,8,0,4,5,0,17,17,1
2010,40514,weKRMLBzfxs8ekS11Y9oGFXbhmcomWRF,A3fsA9Zfv1X2fVEQhTw51lKENdNrEqT3,30,14,7,68,3,0,4,0,96,13.714285714285714,1,0.0,4,7,63,3,10,0,5,4,0,77,19,0
2011,40525,Su94NLhpMEwzyTwfu3GGXYbQEbtpeLin,G8EPVSXsOYB5YQWZGiz1aVq5Pgr2GrQu,10,12,1,0,1,0,1,0,15,2.142857142857143,1,0.0,0,1,0,1,12,0,0,1,0,2,13,1
2012,40576,V2LBVc8iZdDnuXsiI9Sw06zIg4OqT9B6,SpATywNh6bZuzm8s1ceuBUnMUAeoAHHw,5,4,2,0,0,0,2,0,8,1.1428571428571428,1,0.0,0,2,0,0,4,0,0,2,0,2,6,1
2013,40583,EVKTxmdXvqH9f0V4XuFLHjVRnnUWi9xh,A3fsA9Zfv1X2fVEQhTw51lKENdNrEqT3,4,11,7,0,0,0,6,0,24,3.4285714285714284,4,0.0,0,7,0,0,11,0,0,6,0,7,17,1
2014,40591,izEpfh69zQRV21ZbipmxXr7f4EKcykoG,bWdj2GDclj5ofokWjzoa5jAwMkxCykd6,1,0,0,0,0,0,1,0,1,0.14285714285714285,1,0.0,0,0,0,0,0,0,0,1,0,0,1,1
2015,40608,nD2aR2lBTYEZ05tUWGjogkwgt2d7zeNx,A3fsA9Zfv1X2fVEQhTw51lKENdNrEqT3,21,22,1,56,1,0,1,0,81,11.571428571428571,1,0.0,0,1,48,1,22,0,8,1,0,50,31,1
2016,40622,FUMcFXXfXADMgcSzTyKSabMQ45EVJp0n,bWdj2GDclj5ofokWjzoa5jAwMkxCykd6,8,7,6,0,4,0,1,0,18,2.5714285714285716,1,0.0,0,6,0,4,7,0,0,1,0,10,8,0
2017,40635,BOna3ORacJGhjt4FcGMkKNwkDYsEjcvt,RXDvfPUBYFlVdlueBFbLW0mhhAyGEqpt,12,12,7,0,2,1,8,2,32,4.571428571428571,2,0.0,0,7,0,2,12,1,0,8,2,9,23,1
2018,40818,0wm7bVyJC7jfhIoeylaV85sHOH5JOhtj,RXDvfPUBYFlVdlueBFbLW0mhhAyGEqpt,1,0,0,0,0,0,1,0,1,0.14285714285714285,1,0.0,0,0,0,0,0,0,0,1,0,0,1,1
2019,40830,WVkWa16sSufUj4kk1L49kzGtRQMQkIJr,SpATywNh6bZuzm8s1ceuBUnMUAeoAHHw,5,7,1,0,1,0,3,0,12,1.7142857142857142,1,0.0,0,1,0,1,7,0,0,3,0,2,10,1
2020,40858,dJJJLtI6F18pblO9KPkBPg9ZKTgQPaQc,SpATywNh6bZuzm8s1ceuBUnMUAeoAHHw,6,6,1,0,0,0,1,0,8,1.1428571428571428,1,0.0,1,1,0,0,5,0,0,1,0,2,6,0
2021,40861,40L77km5z19sJEVeJ6u4qpa9SAG2ZSIF,SpATywNh6bZuzm8s1ceuBUnMUAeoAHHw,11,11,6,11,0,0,2,0,30,4.285714285714286,1,0.0,4,6,9,0,7,0,2,2,0,19,11,0
2022,40870,8gfCGxZ6lFjZr89RwPF8oXZs1Qn6Pq6X,bWdj2GDclj5ofokWjzoa5jAwMkxCykd6,2,0,0,0,0,0,3,0,3,0.42857142857142855,1,0.0,0,0,0,0,0,0,0,3,0,0,3,1
2023,40873,EjYujgGigN4Oo3US4ixRA3bL0nJn2PDZ,SpATywNh6bZuzm8s1ceuBUnMUAeoAHHw,12,11,0,18,0,0,2,0,31,4.428571428571429,2,0.0,2,0,16,0,9,0,2,2,0,18,13,1
2024,40875,2ekh2uQneNAGmhQ3c3UciXnUFmuOUWou,SpATywNh6bZuzm8s1ceuBUnMUAeoAHHw,21,13,11,15,8,0,2,0,49,7.0,1,0.0,2,11,13,8,11,0,2,2,0,34,15,1
2025,40905,aldLXGpzmiip2CUSDhqN8A5UpGMVUHxY,bWdj2GDclj5ofokWjzoa5jAwMkxCykd6,9,9,6,0,0,0,4,0,19,2.7142857142857144,2,0.0,1,6,0,0,8,0,0,4,0,7,12,0
2026,40910,M2AmcvqhvMtUlyRV6vMvvoM2IhrMmAwT,A3fsA9Zfv1X2fVEQhTw51lKENdNrEqT3,68,24,19,86,13,33,8,1,184,26.285714285714285,1,0.0,2,19,86,13,22,33,0,8,1,120,64,1
2027,40959,kKw20KeSl1t7Pslb9OutpFfK6qbHmAq8,bWdj2GDclj5ofokWjzoa5jAwMkxCykd6,8,10,2,0,0,0,9,1,22,3.142857142857143,1,0.0,4,2,0,0,6,0,0,9,1,6,16,1
2028,40994,WmqMKoevd5yMpzwxk3BDNFkg4y1FZjx5,G8EPVSXsOYB5YQWZGiz1aVq5Pgr2GrQu,11,14,2,0,2,0,4,0,22,3.142857142857143,3,0.0,1,2,0,2,13,0,0,4,0,5,17,1
2029,40998,syzcMhy375dEj89fdUtXti8MXg1a8bSN,7GRhBDsirIGkRZBtSMEzNTyDr2JQm4xx,23,38,12,54,0,0,15,0,119,17.0,2,0.0,16,12,52,0,22,0,2,15,0,80,39,1
2030,41012,9GQBKn8LG5mdPSwy8AFUPaG4NSLWjEYt,7GRhBDsirIGkRZBtSMEzNTyDr2JQm4xx,9,15,5,0,0,0,12,2,34,4.857142857142857,2,0.0,3,5,0,0,12,0,0,12,2,8,26,1
2031,41018,Htb70W0lnqw4QeBjeePevzE0xRg4O6vF,7GRhBDsirIGkRZBtSMEzNTyDr2JQm4xx,1,0,0,0,0,0,1,0,1,0.14285714285714285,1,0.0,0,0,0,0,0,0,0,1,0,0,1,1
2032,41023,8Ht2Zmfn81Gwb093X2QMQmBGW6qi8rRd,7GRhBDsirIGkRZBtSMEzNTyDr2JQm4xx,5,5,3,0,1,0,2,0,11,1.5714285714285714,2,0.0,0,3,0,1,5,0,0,2,0,4,7,1
2033,41066,wb00XyLFbUrmycITZ6LeGF1mEqSeoH2s,7GRhBDsirIGkRZBtSMEzNTyDr2JQm4xx,7,6,1,12,0,0,2,0,21,3.0,1,0.0,3,1,10,0,3,0,2,2,0,14,7,1
2034,41082,DVIil2NM7ZWOtqe6rhlMzwEUAb2wuaeh,7GRhBDsirIGkRZBtSMEzNTyDr2JQm4xx,5,9,3,0,0,0,2,0,14,2.0,1,0.0,3,3,0,0,6,0,0,2,0,6,8,0
2035,41111,LZT7nbUFDfOvhG31ggWghVXoB5daajKc,7GRhBDsirIGkRZBtSMEzNTyDr2JQm4xx,6,9,3,0,0,2,2,0,16,2.2857142857142856,1,0.0,3,3,0,0,6,2,0,2,0,6,10,1
2036,41157,k3YRNSEUtBfnCzCI2ffYAi1qqoCc9d8W,7GRhBDsirIGkRZBtSMEzNTyDr2JQm4xx,5,5,1,0,0,0,2,0,8,1.1428571428571428,1,0.0,0,1,0,0,5,0,0,2,0,1,7,1
2037,41289,I1VndljUSmkFLMl8yI2zESYAyPlBzjwo,7GRhBDsirIGkRZBtSMEzNTyDr2JQm4xx,10,13,7,0,2,0,1,0,23,3.2857142857142856,1,0.0,4,7,0,2,9,0,0,1,0,13,10,1
2038,41300,qJQBhMSxZNb9FZGkj9PyIWzMqhMNvrJp,7GRhBDsirIGkRZBtSMEzNTyDr2JQm4xx,26,41,5,28,6,0,10,0,90,12.857142857142858,4,0.0,16,5,26,6,25,0,2,10,0,53,37,0
2039,41366,Ns35aao5T8wUPwIDoTDfhRc8L852Neqp,7GRhBDsirIGkRZBtSMEzNTyDr2JQm4xx,20,30,10,0,10,2,7,1,60,8.571428571428571,1,0.0,18,10,0,10,12,2,0,7,1,38,22,0
2040,41377,PoxO0NKuyAvBdyfzZW09NxNtHwzofyd3,7GRhBDsirIGkRZBtSMEzNTyDr2JQm4xx,5,2,1,0,1,0,2,0,6,0.8571428571428571,1,0.0,0,1,0,1,2,0,0,2,0,2,4,1
2041,41405,wxXsB2E97PklyJnNr2rcYvINOWKCzd23,7GRhBDsirIGkRZBtSMEzNTyDr2JQm4xx,1,0,0,0,0,0,1,0,1,0.14285714285714285,1,0.0,0,0,0,0,0,0,0,1,0,0,1,0
2042,41483,KqlAQr8NRKwI0MhjiYskyr4iy4QPJQrZ,7GRhBDsirIGkRZBtSMEzNTyDr2JQm4xx,4,2,1,0,0,0,2,0,5,0.7142857142857143,1,0.0,0,1,0,0,2,0,0,2,0,1,4,1
2043,41485,xg6gozDtJtmbriZIHFk0YIJKhyzF16Dg,7GRhBDsirIGkRZBtSMEzNTyDr2JQm4xx,2,0,0,0,0,0,2,0,2,0.2857142857142857,1,0.0,0,0,0,0,0,0,0,2,0,0,2,1
2044,41495,w1eCZn6FuUz5n8CxQTkysG8zjugCkTfX,7GRhBDsirIGkRZBtSMEzNTyDr2JQm4xx,1,0,0,0,0,0,1,0,1,0.14285714285714285,1,0.0,0,0,0,0,0,0,0,1,0,0,1,1
2045,41514,TDsFMiW3NmfZzVauB4oMkOZiSJ5XLe6I,7GRhBDsirIGkRZBtSMEzNTyDr2JQm4xx,19,27,7,58,2,0,5,0,99,14.142857142857142,2,0.0,17,7,52,2,10,0,6,5,0,78,21,1
2046,41521,m7HNFlUhYzKWxgjrmFGLTIf1VbbNLm66,7GRhBDsirIGkRZBtSMEzNTyDr2JQm4xx,1,0,0,0,0,0,1,0,1,0.14285714285714285,1,0.0,0,0,0,0,0,0,0,1,0,0,1,1
2047,41533,8zcddBOPFYuIEkUZpmoApSiBFpQCKBLf,7GRhBDsirIGkRZBtSMEzNTyDr2JQm4xx,1,0,0,0,0,0,1,0,1,0.14285714285714285,1,0.0,0,0,0,0,0,0,0,1,0,0,1,1
2048,41551,SmViYwWTWrMXjcjjHVYvpvTHTeWvqg4X,7GRhBDsirIGkRZBtSMEzNTyDr2JQm4xx,7,3,1,0,1,0,3,0,8,1.1428571428571428,1,0.0,0,1,0,1,3,0,0,3,0,2,6,1
2049,41577,8niPfp9xqHHlhtnR3IY1QWUasjj0zQpl,7GRhBDsirIGkRZBtSMEzNTyDr2JQm4xx,5,2,1,0,1,0,2,0,6,0.8571428571428571,1,0.0,0,1,0,1,2,0,0,2,0,2,4,1
2050,41582,CfUHqy5TfjBtRxjNztsGxyFua9jISd0Q,7GRhBDsirIGkRZBtSMEzNTyDr2JQm4xx,13,21,10,9,6,0,2,0,48,6.857142857142857,2,0.0,9,10,8,6,12,0,1,2,0,33,15,1
2051,41618,ZqebYSMW1RUIRSXJmMzKs77Liu7pj2zF,7GRhBDsirIGkRZBtSMEzNTyDr2JQm4xx,33,34,32,0,24,4,6,1,101,14.428571428571429,2,0.0,0,32,0,24,34,4,0,6,1,56,45,1
2052,41697,CQ8MKRcyoRQu9uvYz8G86ILjGgWWbOQv,7GRhBDsirIGkRZBtSMEzNTyDr2JQm4xx,5,5,2,0,0,0,3,0,10,1.4285714285714286,1,0.0,0,2,0,0,5,0,0,3,0,2,8,1
2053,41753,5QHXCSGlBOGq7ih6SlrH28hNQCROqU2d,7GRhBDsirIGkRZBtSMEzNTyDr2JQm4xx,2,0,0,0,0,0,3,0,3,0.42857142857142855,2,0.0,0,0,0,0,0,0,0,3,0,0,3,1
2054,41762,FJJqBn1iTJmAbav7Ov5Y4ycyF65fvY1E,7GRhBDsirIGkRZBtSMEzNTyDr2JQm4xx,1,0,0,0,0,0,1,0,1,0.14285714285714285,1,0.0,0,0,0,0,0,0,0,1,0,0,1,0
2055,41792,UNnwy1ZgbFYM2Kztvg7tp4bM94xWe0nF,7GRhBDsirIGkRZBtSMEzNTyDr2JQm4xx,1,0,0,0,0,0,1,0,1,0.14285714285714285,1,0.0,0,0,0,0,0,0,0,1,0,0,1,1
2056,41795,F71ZfnryHCMhVExpC2gJVpDSfOwRuiHf,7GRhBDsirIGkRZBtSMEzNTyDr2JQm4xx,6,1,1,0,1,0,5,0,8,1.1428571428571428,1,0.0,0,1,0,1,1,0,0,5,0,2,6,1
2057,41801,3SP9iNDvUt8m67ZMqC5DpQRe6ekkTpsP,7GRhBDsirIGkRZBtSMEzNTyDr2JQm4xx,1,0,0,0,0,0,1,0,1,0.14285714285714285,1,0.0,0,0,0,0,0,0,0,1,0,0,1,1
2058,41807,txRaMeFRdTsCsziGBMMxzL5gSPIB7mbk,7GRhBDsirIGkRZBtSMEzNTyDr2JQm4xx,38,82,23,42,12,16,5,1,181,25.857142857142858,2,0.0,43,23,41,12,39,16,1,5,1,119,62,1
2059,41815,NYjtfRvfVgjdP93necZvZvYS7zFHrEkH,7GRhBDsirIGkRZBtSMEzNTyDr2JQm4xx,6,2,1,0,1,0,4,0,8,1.1428571428571428,1,0.0,0,1,0,1,2,0,0,4,0,2,6,1
2060,43665,NrHk4qmJXuD0TsjkQSnghKpk9ZjGAOyU,7GRhBDsirIGkRZBtSMEzNTyDr2JQm4xx,30,19,17,0,11,0,3,0,50,7.142857142857143,1,0.0,0,17,0,11,19,0,0,3,0,28,22,1
2061,43673,Y53vJNK6NsQxTqlgv0AKozWzT5IkWSVb,7GRhBDsirIGkRZBtSMEzNTyDr2JQm4xx,5,5,3,0,0,0,3,0,11,1.5714285714285714,2,0.0,0,3,0,0,5,0,0,3,0,3,8,0
2062,43994,hWE8YlXrkle820sTOY1UXpm2QbX0rLTx,fbPkOYLVPtPgIt0MxizjfFJov3JbHyAi,3,2,1,0,0,0,1,0,4,0.5714285714285714,1,0.0,0,1,0,0,2,0,0,1,0,1,3,1
2063,44005,J8NkUmSvsrLHkKNXPhFg7o0pG3K7Aywh,fbPkOYLVPtPgIt0MxizjfFJov3JbHyAi,5,5,2,0,2,0,1,0,10,1.4285714285714286,1,0.0,2,2,0,2,3,0,0,1,0,6,4,0
2064,44006,hjUSUM6roI2mLGkMAqBjE0uxFRBSMYHJ,fbPkOYLVPtPgIt0MxizjfFJov3JbHyAi,1,0,0,0,0,0,1,0,1,0.14285714285714285,1,0.0,0,0,0,0,0,0,0,1,0,0,1,1
2065,44018,qKfZusm0R8jxltESvgi15dswdw73Gjlp,fbPkOYLVPtPgIt0MxizjfFJov3JbHyAi,6,6,0,0,0,0,1,0,7,1.0,1,0.0,0,0,0,0,6,0,0,1,0,0,7,1
2066,44022,PDXGFyBPYCflMZuvp1Ir4M4S3e0nyboZ,fbPkOYLVPtPgIt0MxizjfFJov3JbHyAi,10,36,22,0,3,56,19,0,136,19.428571428571427,5,0.0,0,22,0,3,36,56,0,19,0,25,111,1
2067,44031,wg3Aluyuv2BxZCQwpp08tOXwIGHtBXla,fbPkOYLVPtPgIt0MxizjfFJov3JbHyAi,4,2,1,0,1,0,1,0,5,0.7142857142857143,1,0.0,1,1,0,1,1,0,0,1,0,3,2,1
2068,44051,AmoWrYr0vE5hXRkVUs4W3twtpkRI6UWn,fbPkOYLVPtPgIt0MxizjfFJov3JbHyAi,5,3,2,0,1,0,1,0,7,1.0,1,0.0,0,2,0,1,3,0,0,1,0,3,4,1
2069,44059,VCAUk6CdtYtSQUkeIHqrUkYmOmbAoytN,fbPkOYLVPtPgIt0MxizjfFJov3JbHyAi,9,6,6,0,6,0,0,0,18,2.5714285714285716,1,0.0,0,6,0,6,6,0,0,0,0,12,6,1
2070,44077,O8WpIn8YZlC9fwaPz6HgwkG3VYK9Pnk2,fbPkOYLVPtPgIt0MxizjfFJov3JbHyAi,37,36,24,34,12,13,8,1,128,18.285714285714285,1,0.0,8,24,28,12,28,13,6,8,1,72,56,1
2071,44082,YzWgrkJXzobheYWSTdIFQuZL9QRQEEwo,fbPkOYLVPtPgIt0MxizjfFJov3JbHyAi,5,3,0,0,0,2,2,0,7,1.0,1,0.0,0,0,0,0,3,2,0,2,0,0,7,1
2072,44089,No6TsyszmhFBqFzsKXtnzkYT0Jt4BFGw,fbPkOYLVPtPgIt0MxizjfFJov3JbHyAi,19,37,18,7,14,32,7,7,122,17.428571428571427,2,0.0,13,18,7,14,24,32,0,7,7,52,70,0
2073,44094,Y5EybULOrY5dAmMMQWE7bK5wg4bsR2Lr,fbPkOYLVPtPgIt0MxizjfFJov3JbHyAi,4,5,2,0,0,0,2,0,9,1.2857142857142858,1,0.0,0,2,0,0,5,0,0,2,0,2,7,1
2074,44100,ANJ7A7TrnpRJsv1mG7Zq08b8gsBzPJqI,fbPkOYLVPtPgIt0MxizjfFJov3JbHyAi,3,4,2,0,0,0,1,0,7,1.0,1,0.0,0,2,0,0,4,0,0,1,0,2,5,1
2075,44106,futHw5ylJYoore6oNuefdx05Xc1Es6E8,fbPkOYLVPtPgIt0MxizjfFJov3JbHyAi,17,36,13,4,9,0,3,0,65,9.285714285714286,3,0.0,7,13,4,9,29,0,0,3,0,33,32,1
2076,44114,Hnsg2RdEy94EzQKO2WfhQn1bhDkIZpuP,fbPkOYLVPtPgIt0MxizjfFJov3JbHyAi,5,5,3,0,0,0,1,0,9,1.2857142857142858,1,0.0,1,3,0,0,4,0,0,1,0,4,5,1
2077,44138,3xpaESbMVIacFbBBinGWFh7uTUaRebCC,fbPkOYLVPtPgIt0MxizjfFJov3JbHyAi,4,3,2,0,0,0,1,0,6,0.8571428571428571,1,0.0,0,2,0,0,3,0,0,1,0,2,4,1
2078,44142,VT4lg4rYLuaybdJw72lJCTs81gBgRRBg,fbPkOYLVPtPgIt0MxizjfFJov3JbHyAi,9,29,15,4,9,23,5,0,85,12.142857142857142,4,0.0,8,15,3,9,21,23,1,5,0,35,50,1
2079,44149,W7N7he2GGE1A2J3fJvsUdwOZI9P4besV,fbPkOYLVPtPgIt0MxizjfFJov3JbHyAi,14,28,7,3,8,0,2,0,48,6.857142857142857,1,0.0,12,7,3,8,16,0,0,2,0,30,18,1
2080,44158,KBAguIZfF7JFxQgNwhhTOV2JtOxu7CHH,fbPkOYLVPtPgIt0MxizjfFJov3JbHyAi,6,5,3,0,2,0,3,0,13,1.8571428571428572,1,0.0,1,3,0,2,4,0,0,3,0,6,7,1
2081,44174,kr9MhAzeae0UKmOp6QSbcSIPAfRDBwyS,fbPkOYLVPtPgIt0MxizjfFJov3JbHyAi,1,0,0,0,0,0,1,0,1,0.14285714285714285,1,0.0,0,0,0,0,0,0,0,1,0,0,1,1
2082,44181,ZPamISIdPsbqsq6aVqRDFzUi3IlRadjg,fbPkOYLVPtPgIt0MxizjfFJov3JbHyAi,4,3,0,0,0,4,2,0,9,1.2857142857142858,1,0.0,0,0,0,0,3,4,0,2,0,0,9,1
2083,44184,UsLFN9dzLo3sTXf5tfNoi18KyZHWYRsB,fbPkOYLVPtPgIt0MxizjfFJov3JbHyAi,22,32,14,16,17,5,2,0,86,12.285714285714286,1,0.0,17,14,13,17,15,5,3,2,0,61,25,1
2084,44186,mJ5BZ6EJA3wLg8jbGMObtpjRK8yspzI5,fbPkOYLVPtPgIt0MxizjfFJov3JbHyAi,18,15,7,12,5,15,4,0,58,8.285714285714286,1,0.0,6,7,10,5,9,15,2,4,0,28,30,1
2085,44194,nkWrffpo6kobU01lUWepcu6aQb60BdxH,fbPkOYLVPtPgIt0MxizjfFJov3JbHyAi,23,20,12,8,7,10,2,0,59,8.428571428571429,2,0.0,5,12,7,7,15,10,1,2,0,31,28,0
2086,44202,UvmsOyeKqNqdnoWuF67HYRoCd5vZCTT3,fbPkOYLVPtPgIt0MxizjfFJov3JbHyAi,4,2,0,0,0,0,5,0,7,1.0,1,0.0,0,0,0,0,2,0,0,5,0,0,7,1
2087,44236,jagu0OJDhWTGFhfCMk0ghqluLpW3kzdC,fbPkOYLVPtPgIt0MxizjfFJov3JbHyAi,13,18,11,10,7,15,10,0,71,10.142857142857142,2,0.0,2,11,8,7,16,15,2,10,0,28,43,0
2088,44244,g2zZYnTJ1Pk3cSjsVP5SH4UjJdsbDJv7,fbPkOYLVPtPgIt0MxizjfFJov3JbHyAi,28,32,18,22,13,11,8,1,105,15.0,2,0.0,10,18,17,13,22,11,5,8,1,58,47,0
2089,44256,bJOkL9U6IOy2ICy3FtWSfPLY5BHrDaNn,fbPkOYLVPtPgIt0MxizjfFJov3JbHyAi,3,2,1,0,0,0,1,0,4,0.5714285714285714,1,0.0,0,1,0,0,2,0,0,1,0,1,3,1
2090,44260,fTY7PbFNeV0B3b5XiSuBQtOgneGDS4iZ,fbPkOYLVPtPgIt0MxizjfFJov3JbHyAi,8,4,3,0,2,0,2,0,11,1.5714285714285714,1,0.0,0,3,0,2,4,0,0,2,0,5,6,1
2091,44274,2qxdbGcKrOShnqwnQiXgdDAFvYPhSM6o,fbPkOYLVPtPgIt0MxizjfFJov3JbHyAi,7,4,3,0,2,0,2,0,11,1.5714285714285714,1,0.0,0,3,0,2,4,0,0,2,0,5,6,1
2092,44280,gIksIEwmEEV0Pn8wMtaqnzuIMor23skp,fbPkOYLVPtPgIt0MxizjfFJov3JbHyAi,11,8,4,2,2,14,6,1,37,5.285714285714286,1,0.0,3,4,2,2,5,14,0,6,1,11,26,1
2093,45309,cvmNQvB8C9tzfr5JL4ScqNRXsUkWS0qq,RXDvfPUBYFlVdlueBFbLW0mhhAyGEqpt,27,38,31,38,4,39,14,0,164,23.428571428571427,2,0.0,4,31,30,4,34,39,8,14,0,69,95,0
2094,45340,Q57EC9WScoWjECRp7MT77bmBt9oZMVVG,RXDvfPUBYFlVdlueBFbLW0mhhAyGEqpt,6,3,2,0,0,61,13,2,81,11.571428571428571,5,0.0,0,2,0,0,3,61,0,13,2,2,79,0
2095,46481,HBy8mPchGFgKjPi1BR1hdK1ryzkGe4Eu,fbPkOYLVPtPgIt0MxizjfFJov3JbHyAi,2,0,0,0,0,0,2,0,2,0.2857142857142857,1,0.0,0,0,0,0,0,0,0,2,0,0,2,1
2096,46482,QvWjJCxM4Z5YXutHnyToIP2emrXnT27F,fbPkOYLVPtPgIt0MxizjfFJov3JbHyAi,8,2,1,0,1,1,5,1,11,1.5714285714285714,1,0.0,0,1,0,1,2,1,0,5,1,2,9,1
2097,46483,TZ1qqjK0a5Zztn1Eld8NcfyMD8SKYxjC,fbPkOYLVPtPgIt0MxizjfFJov3JbHyAi,8,2,1,0,1,1,18,3,26,3.7142857142857144,1,0.0,0,1,0,1,2,1,0,18,3,2,24,1
2098,46484,acna1oLISW5GtLdHgEb3HFIk5PnI1WRA,fbPkOYLVPtPgIt0MxizjfFJov3JbHyAi,1,0,0,0,0,0,1,0,1,0.14285714285714285,1,0.0,0,0,0,0,0,0,0,1,0,0,1,1
2099,46485,n0aD0wlRo2epwn74jquTDUFpiwWF99mc,fbPkOYLVPtPgIt0MxizjfFJov3JbHyAi,3,2,0,0,0,0,2,0,4,0.5714285714285714,1,0.0,0,0,0,0,2,0,0,2,0,0,4,0
2100,46487,0cQOAQZYor1XBUr8oohVdZF8cKrNp08W,fbPkOYLVPtPgIt0MxizjfFJov3JbHyAi,25,36,15,22,9,1,11,0,94,13.428571428571429,4,0.0,10,15,17,9,26,1,5,11,0,51,43,1
2101,46489,vjcoSDgY9JiBCtsViMhHCl6KGCk2TvE5,fbPkOYLVPtPgIt0MxizjfFJov3JbHyAi,7,3,2,0,2,0,2,0,9,1.2857142857142858,1,0.0,0,2,0,2,3,0,0,2,0,4,5,1
2102,46492,A5Ha5kMAE8LgDZc3iTs32MwLDsMXRqMa,fbPkOYLVPtPgIt0MxizjfFJov3JbHyAi,16,16,9,20,0,0,3,0,48,6.857142857142857,1,0.0,6,9,20,0,10,0,0,3,0,35,13,1
2103,46494,JedhrXCQn7XYerN8pX6fyNhWwODWvnUf,fbPkOYLVPtPgIt0MxizjfFJov3JbHyAi,10,16,3,8,7,0,4,0,38,5.428571428571429,1,0.0,12,3,5,7,4,0,3,4,0,27,11,0
2104,46496,TvKzeZn2ihjFdDt7bera0RviFXCeKKB6,fbPkOYLVPtPgIt0MxizjfFJov3JbHyAi,5,2,1,0,1,0,4,0,8,1.1428571428571428,1,0.0,0,1,0,1,2,0,0,4,0,2,6,1
2105,46498,jSp9qlCQEKpc4PsUPHVOngS2TFfQ6jwl,fbPkOYLVPtPgIt0MxizjfFJov3JbHyAi,3,1,0,0,0,0,2,0,3,0.42857142857142855,1,0.0,0,0,0,0,1,0,0,2,0,0,3,1
2106,46500,Kkk2oty8lHBEgyFYDiZgsO24fUpD8pZQ,fbPkOYLVPtPgIt0MxizjfFJov3JbHyAi,9,5,3,4,3,0,1,0,16,2.2857142857142856,1,0.0,1,3,3,3,4,0,1,1,0,10,6,1
2107,46501,rIwy3FDbkCxSl3lJMcDBmeUqV54svIRx,fbPkOYLVPtPgIt0MxizjfFJov3JbHyAi,8,9,5,0,4,0,5,0,23,3.2857142857142856,1,0.0,0,5,0,4,9,0,0,5,0,9,14,1
2108,46503,DPR39VXlEgPnSvHJlcrFWVjZyCJYvn9R,fbPkOYLVPtPgIt0MxizjfFJov3JbHyAi,2,0,0,0,0,0,5,0,5,0.7142857142857143,1,0.0,0,0,0,0,0,0,0,5,0,0,5,1
2109,46504,CpsMjwcxvfkSN0hyQGRgXRt6dQZxAjwb,fbPkOYLVPtPgIt0MxizjfFJov3JbHyAi,11,7,4,0,5,0,5,1,22,3.142857142857143,1,0.0,2,4,0,5,5,0,0,5,1,11,11,1
2110,46505,kBNWoa4A4jmNOoJaSAupB8wyNzpsoJAN,fbPkOYLVPtPgIt0MxizjfFJov3JbHyAi,45,82,28,27,25,1,17,3,183,26.142857142857142,4,0.0,32,28,24,25,50,1,3,17,3,109,74,0
2111,46511,xeCFX5y6IRjmYKFA9y4Rgt3SG4YPELud,fbPkOYLVPtPgIt0MxizjfFJov3JbHyAi,45,201,66,15,27,47,25,0,381,54.42857142857143,4,0.0,19,66,15,27,182,47,0,25,0,127,254,0
2112,46512,a8mEu8FF4lDfLSb2ZwttyDGOOQsEW3CZ,fbPkOYLVPtPgIt0MxizjfFJov3JbHyAi,9,7,3,0,3,0,6,0,19,2.7142857142857144,1,0.0,2,3,0,3,5,0,0,6,0,8,11,1
2113,46513,EiO5bky9R1Iqlpv4ItUpPBUgGb1eJItE,fbPkOYLVPtPgIt0MxizjfFJov3JbHyAi,1,0,0,0,0,0,1,0,1,0.14285714285714285,1,0.0,0,0,0,0,0,0,0,1,0,0,1,1
2114,46514,wQDLnIhQRiBlJ7OOKtAQT7egktqnXxWd,fbPkOYLVPtPgIt0MxizjfFJov3JbHyAi,13,9,6,0,5,18,11,1,50,7.142857142857143,1,0.0,0,6,0,5,9,18,0,11,1,11,39,1
2115,46515,ZalaHb2nOUsnNI2p4xQ00VNI9pJY08yk,fbPkOYLVPtPgIt0MxizjfFJov3JbHyAi,2,0,0,0,0,0,2,0,2,0.2857142857142857,1,0.0,0,0,0,0,0,0,0,2,0,0,2,1
2116,46516,WvBcJWjHUn0OSdcSOrveOYpPP7iy97HT,fbPkOYLVPtPgIt0MxizjfFJov3JbHyAi,3,0,0,0,0,0,7,0,7,1.0,1,0.0,0,0,0,0,0,0,0,7,0,0,7,1
2117,46517,MN4wOgynUY4QcRaraCB5Ym52vNjUttfc,fbPkOYLVPtPgIt0MxizjfFJov3JbHyAi,5,0,0,0,0,1,4,1,6,0.8571428571428571,1,0.0,0,0,0,0,0,1,0,4,1,0,6,1
2118,46518,zNp29QwJYW19LnSbsZ5BdQrNdzMHpz2F,fbPkOYLVPtPgIt0MxizjfFJov3JbHyAi,25,37,18,10,12,13,3,0,93,13.285714285714286,2,0.0,12,18,9,12,25,13,1,3,0,51,42,1
2119,46519,q0GqO7mYZSUjsbmDGsoT5N4ppqd8vOBB,fbPkOYLVPtPgIt0MxizjfFJov3JbHyAi,7,4,2,0,2,0,4,0,12,1.7142857142857142,1,0.0,0,2,0,2,4,0,0,4,0,4,8,1
2120,46520,SK3evWrWxCZl0iqN8sbmSNUdgxEYSLSK,fbPkOYLVPtPgIt0MxizjfFJov3JbHyAi,2,0,0,0,0,0,2,0,2,0.2857142857142857,1,0.0,0,0,0,0,0,0,0,2,0,0,2,1
2121,46522,EfURFHip4N6v2zuhSrNJ2KVVAM4Td3mY,fbPkOYLVPtPgIt0MxizjfFJov3JbHyAi,11,11,4,0,4,0,1,0,20,2.857142857142857,1,0.0,0,4,0,4,11,0,0,1,0,8,12,1
2122,46523,UD5FqfNicjboiN32GGPYtIcMIUIxLZOX,fbPkOYLVPtPgIt0MxizjfFJov3JbHyAi,6,4,3,0,3,0,1,0,11,1.5714285714285714,1,0.0,0,3,0,3,4,0,0,1,0,6,5,1
2123,46524,2QBIivovfBXOULGvBnn18Q4kSGQH3yTO,fbPkOYLVPtPgIt0MxizjfFJov3JbHyAi,7,2,1,0,1,0,4,0,8,1.1428571428571428,1,0.0,0,1,0,1,2,0,0,4,0,2,6,1
2124,46526,LTrIeWW4Gi4Y09oaKB1naUI4GII0UZAi,fbPkOYLVPtPgIt0MxizjfFJov3JbHyAi,4,3,0,0,0,0,5,0,8,1.1428571428571428,1,0.0,0,0,0,0,3,0,0,5,0,0,8,1
2125,46527,8JTz84ZDdJm6tvsd7hgyCl1RB6wU6r2e,fbPkOYLVPtPgIt0MxizjfFJov3JbHyAi,11,21,9,4,8,3,9,1,55,7.857142857142857,2,0.0,8,9,3,8,13,3,1,9,1,28,27,1
2126,46529,HQVRezU89umSvdjmOYF3nS0qPRPvMBxw,fbPkOYLVPtPgIt0MxizjfFJov3JbHyAi,8,5,2,0,3,0,3,0,13,1.8571428571428572,1,0.0,3,2,0,3,2,0,0,3,0,8,5,1
2127,46530,TBXYAxwexaNd47Tj9eT3p3QhXiwNSKj3,fbPkOYLVPtPgIt0MxizjfFJov3JbHyAi,1,0,0,0,0,0,1,0,1,0.14285714285714285,1,0.0,0,0,0,0,0,0,0,1,0,0,1,1
2128,46531,KbMG2R5hi7lV4ttClunSqF2UarKF8FNZ,fbPkOYLVPtPgIt0MxizjfFJov3JbHyAi,29,46,4,4,11,48,29,2,144,20.571428571428573,5,0.0,7,4,4,11,39,48,0,29,2,26,118,1
2129,46533,pRxI77wBFvTUHzDy8YsNcKJFbpdAZGNh,fbPkOYLVPtPgIt0MxizjfFJov3JbHyAi,15,9,5,0,4,3,7,1,29,4.142857142857143,2,0.0,0,5,0,4,9,3,0,7,1,9,20,1
2130,46534,KvCAdo1odeI84idtqyQZyVEKdaH6IDdM,fbPkOYLVPtPgIt0MxizjfFJov3JbHyAi,37,123,65,24,19,126,27,2,386,55.142857142857146,6,0.0,13,65,23,19,110,126,1,27,2,120,266,1
2131,46536,8HQsMOkKLewVMfte6VD2DYuU0urKWHXv,fbPkOYLVPtPgIt0MxizjfFJov3JbHyAi,12,26,9,4,9,6,15,1,70,10.0,3,0.0,11,9,4,9,15,6,0,15,1,33,37,0
2132,46540,25lc3om6HRn7SihjBlQbrBSLSUySLWnG,fbPkOYLVPtPgIt0MxizjfFJov3JbHyAi,7,3,2,0,2,0,2,0,9,1.2857142857142858,1,0.0,0,2,0,2,3,0,0,2,0,4,5,1
2133,46541,StTC3qGjYN4V41LymnTzXQRS0bQSlPrF,fbPkOYLVPtPgIt0MxizjfFJov3JbHyAi,7,4,2,0,2,0,2,0,10,1.4285714285714286,1,0.0,1,2,0,2,3,0,0,2,0,5,5,1
2134,46543,xBRGHAvkTfDDok4cH7N9aC7OMTMv6n3O,fbPkOYLVPtPgIt0MxizjfFJov3JbHyAi,7,5,4,0,3,0,4,0,16,2.2857142857142856,1,0.0,0,4,0,3,5,0,0,4,0,7,9,1
2135,46544,DAHT3MY5s8ge8Fy97bhkuUzIKyk1q8L2,fbPkOYLVPtPgIt0MxizjfFJov3JbHyAi,9,6,2,2,3,1,5,0,19,2.7142857142857144,1,0.0,3,2,2,3,3,1,0,5,0,10,9,1
2136,46547,GHqW2sFZULw6xLeFQhSQm5IW9wmBIZnH,fbPkOYLVPtPgIt0MxizjfFJov3JbHyAi,5,3,0,0,0,0,4,0,7,1.0,1,0.0,0,0,0,0,3,0,0,4,0,0,7,1
2137,46549,4ApVgPYGz6bz2SJLoGELpZ6RPnXwOa88,fbPkOYLVPtPgIt0MxizjfFJov3JbHyAi,33,74,32,25,16,13,15,0,175,25.0,6,0.0,24,32,21,16,50,13,4,15,0,93,82,0
2138,46550,F9UZi4Eyme7smBBGI6b8l0B0Zh1VRQUD,fbPkOYLVPtPgIt0MxizjfFJov3JbHyAi,10,6,3,0,2,1,13,1,26,3.7142857142857144,2,0.0,1,3,0,2,5,1,0,13,1,6,20,1
2139,46552,K3nS4VcLIzBgqPQsAsjEIOPChH8gvdgH,fbPkOYLVPtPgIt0MxizjfFJov3JbHyAi,8,2,1,0,1,2,8,1,15,2.142857142857143,1,0.0,0,1,0,1,2,2,0,8,1,2,13,1
2140,46555,QPiUGBr4vUjXTmo4VUV66g7hHPK0zcgj,fbPkOYLVPtPgIt0MxizjfFJov3JbHyAi,7,3,1,0,2,0,2,0,8,1.1428571428571428,1,0.0,0,1,0,2,3,0,0,2,0,3,5,1
2141,46556,VnuUyTHNwHr2LPEpDCNFEvbJ7YyA2Dtr,fbPkOYLVPtPgIt0MxizjfFJov3JbHyAi,7,2,1,0,1,0,6,1,11,1.5714285714285714,1,0.0,0,1,0,1,2,0,0,6,1,2,9,1
2142,46557,uoS96wNFUwtq7HfaPY02QxMEsIwJzjv6,fbPkOYLVPtPgIt0MxizjfFJov3JbHyAi,12,34,2,0,2,7,5,0,50,7.142857142857143,4,0.0,2,2,0,2,32,7,0,5,0,6,44,1
2143,46558,wgVuc0GdXqkgwRE7sGVxY1lchlcFK9wg,fbPkOYLVPtPgIt0MxizjfFJov3JbHyAi,3,0,0,0,0,0,5,0,5,0.7142857142857143,1,0.0,0,0,0,0,0,0,0,5,0,0,5,1
2144,46559,jl7dXdzz09XmO4Xe8w2lkGI7U7DzbG09,fbPkOYLVPtPgIt0MxizjfFJov3JbHyAi,8,6,4,0,3,0,3,0,16,2.2857142857142856,1,0.0,0,4,0,3,6,0,0,3,0,7,9,1
2145,46560,9giAVCaBxbNk2UdLbnYeVpzaUfG3nD03,fbPkOYLVPtPgIt0MxizjfFJov3JbHyAi,23,42,16,19,12,4,21,1,115,16.428571428571427,2,0.0,16,16,14,12,26,4,5,21,1,58,57,1
2146,46561,7ZyJguBzL4oDvx3QuauBv2Vv3pHBPVh3,fbPkOYLVPtPgIt0MxizjfFJov3JbHyAi,9,8,5,0,5,0,2,0,20,2.857142857142857,1,0.0,0,5,0,5,8,0,0,2,0,10,10,1
2147,46562,rCajReBu2KQJPlVlrrQZIZvrYAp8h9Yy,fbPkOYLVPtPgIt0MxizjfFJov3JbHyAi,2,0,0,0,0,0,2,0,2,0.2857142857142857,1,0.0,0,0,0,0,0,0,0,2,0,0,2,1
2148,46564,W7FXzdnq9Ktue5ZNM3TQmIP7HktmL3kC,fbPkOYLVPtPgIt0MxizjfFJov3JbHyAi,1,0,0,0,0,0,1,0,1,0.14285714285714285,1,0.0,0,0,0,0,0,0,0,1,0,0,1,1
2149,46565,wFCoKk3O7Yg710logPyDwMV7EivrZQCR,fbPkOYLVPtPgIt0MxizjfFJov3JbHyAi,1,0,0,0,0,0,1,0,1,0.14285714285714285,1,0.0,0,0,0,0,0,0,0,1,0,0,1,1
2150,46566,jFdhdjmfzOKKtloREabrCYP6a5dr6kJ3,fbPkOYLVPtPgIt0MxizjfFJov3JbHyAi,10,5,2,0,3,1,13,1,25,3.5714285714285716,1,0.0,2,2,0,3,3,1,0,13,1,7,18,1
2151,46567,UPecCjx5RBL6BceSov5rJLAaDoiPXUhg,fbPkOYLVPtPgIt0MxizjfFJov3JbHyAi,9,5,3,0,2,0,10,1,21,3.0,2,0.0,0,3,0,2,5,0,0,10,1,5,16,1
2152,46568,a9pvo8cVBjTHxQYvCPfHB4tPGRdFjAui,fbPkOYLVPtPgIt0MxizjfFJov3JbHyAi,13,8,5,0,4,2,13,1,33,4.714285714285714,1,0.0,0,5,0,4,8,2,0,13,1,9,24,1
2153,46569,EvnDUDuRuksYPdrCaUQQweT0GY5Najoh,fbPkOYLVPtPgIt0MxizjfFJov3JbHyAi,5,2,1,0,1,0,2,0,6,0.8571428571428571,1,0.0,0,1,0,1,2,0,0,2,0,2,4,1
2154,46570,1w8EW76qmBSgQ2s8Jb4yoPsNX01KUcoD,fbPkOYLVPtPgIt0MxizjfFJov3JbHyAi,10,3,2,0,2,1,7,1,16,2.2857142857142856,1,0.0,0,2,0,2,3,1,0,7,1,4,12,1
2155,46571,ZKAk08L8Iriz8Uv5UOeqSbrNnzg1rlMz,fbPkOYLVPtPgIt0MxizjfFJov3JbHyAi,9,5,4,0,2,0,5,0,16,2.2857142857142856,1,0.0,0,4,0,2,5,0,0,5,0,6,10,1
2156,46573,IvhEQ40qNYap5nunxQhwiW2fnAok3TLS,fbPkOYLVPtPgIt0MxizjfFJov3JbHyAi,2,0,0,0,0,12,1,0,13,1.8571428571428572,1,0.0,0,0,0,0,0,12,0,1,0,0,13,0
2157,46574,mZc1V3rQTRH4oqK1zqSjimuZcPwomnsE,fbPkOYLVPtPgIt0MxizjfFJov3JbHyAi,5,7,4,0,0,14,2,0,27,3.857142857142857,1,0.0,2,4,0,0,5,14,0,2,0,6,21,1
2158,46576,a8wX3Bl3kW6KFXwHZ6A5CPXKLBX1p4MZ,fbPkOYLVPtPgIt0MxizjfFJov3JbHyAi,2,0,0,0,0,0,3,0,3,0.42857142857142855,1,0.0,0,0,0,0,0,0,0,3,0,0,3,1
2159,46577,Edq6Echk8wEs8ShX5RBw5c8Yx8ANHVje,fbPkOYLVPtPgIt0MxizjfFJov3JbHyAi,1,0,0,0,0,0,1,0,1,0.14285714285714285,1,0.0,0,0,0,0,0,0,0,1,0,0,1,1
2160,46578,xpD8zL0kPAHItDUStTwEIkWWrm8dDFmA,fbPkOYLVPtPgIt0MxizjfFJov3JbHyAi,10,6,3,0,2,3,5,1,20,2.857142857142857,1,0.0,0,3,0,2,6,3,0,5,1,5,15,1
2161,46579,LWBASHvZlE9V0DOIMqscGs93ncFzXARw,fbPkOYLVPtPgIt0MxizjfFJov3JbHyAi,8,9,4,0,3,0,3,0,19,2.7142857142857144,1,0.0,2,4,0,3,7,0,0,3,0,9,10,1
2162,46580,sn1OZIzg3ZOiyRClBvvQLUKwx6tymOkC,fbPkOYLVPtPgIt0MxizjfFJov3JbHyAi,25,25,9,12,13,0,4,1,64,9.142857142857142,1,0.0,15,9,11,13,10,0,1,4,1,48,16,1
2163,46581,sw536JzryZ42F137fkltWvrIc3QLRo3o,fbPkOYLVPtPgIt0MxizjfFJov3JbHyAi,8,3,2,0,0,1,6,1,13,1.8571428571428572,1,0.0,0,2,0,0,3,1,0,6,1,2,11,1
2164,46582,Ikjjxpfg5ascMIjhTuGW8BkxPihDwWmv,fbPkOYLVPtPgIt0MxizjfFJov3JbHyAi,13,13,10,0,7,0,0,0,30,4.285714285714286,1,0.0,0,10,0,7,13,0,0,0,0,17,13,1
2165,46585,1fz7RS94t8nuoMroWFq8B06N4IWtq90I,fbPkOYLVPtPgIt0MxizjfFJov3JbHyAi,2,0,0,0,0,0,2,0,2,0.2857142857142857,1,0.0,0,0,0,0,0,0,0,2,0,0,2,1
2166,46587,lDJqver3AFFUyXISNdqvZpmq6OeWVl0r,fbPkOYLVPtPgIt0MxizjfFJov3JbHyAi,10,9,4,2,3,0,2,0,20,2.857142857142857,2,0.0,2,4,2,3,7,0,0,2,0,11,9,1
2167,46588,yfppFvC7mTSlPuhod9GGDRPkzP1HmCAu,fbPkOYLVPtPgIt0MxizjfFJov3JbHyAi,6,5,2,0,1,0,3,0,11,1.5714285714285714,2,0.0,0,2,0,1,5,0,0,3,0,3,8,1
2168,46589,Q8UiR0g4rvfffexhCwFYjhzrBs6RScJA,fbPkOYLVPtPgIt0MxizjfFJov3JbHyAi,8,4,3,0,2,8,6,0,23,3.2857142857142856,1,0.0,0,3,0,2,4,8,0,6,0,5,18,1
2169,46590,DeMkq0IaxnRQrXCQHQpz60sFvrsX1jLn,fbPkOYLVPtPgIt0MxizjfFJov3JbHyAi,15,10,6,0,6,13,11,1,47,6.714285714285714,1,0.0,2,6,0,6,8,13,0,11,1,14,33,1
2170,46593,xanxsjSeaVNFCeWQJAicKck5SsVFdK55,fbPkOYLVPtPgIt0MxizjfFJov3JbHyAi,13,6,5,0,5,0,3,0,19,2.7142857142857144,1,0.0,0,5,0,5,6,0,0,3,0,10,9,1
2171,47680,5j9EQkqR4CZfRV8sku9HLld3NnlBiUj6,7GRhBDsirIGkRZBtSMEzNTyDr2JQm4xx,14,15,3,22,2,0,3,0,45,6.428571428571429,1,0.0,11,3,19,2,4,0,3,3,0,35,10,1
2172,47756,L0FSy0eDJB0vLjpSsrNVX0T1aJD3NXFR,fbPkOYLVPtPgIt0MxizjfFJov3JbHyAi,9,11,5,4,4,0,7,0,31,4.428571428571429,1,0.0,5,5,4,4,6,0,0,7,0,18,13,1
2173,47781,JelJmDAgdvYMwysu2S8khlhEiSoRMDm3,fbPkOYLVPtPgIt0MxizjfFJov3JbHyAi,5,4,3,0,0,5,2,0,14,2.0,1,0.0,0,3,0,0,4,5,0,2,0,3,11,0
2174,47798,ZobeGMKyIBgjnUNms43CrtMrVHf6iI1r,fbPkOYLVPtPgIt0MxizjfFJov3JbHyAi,3,2,1,0,0,0,1,0,4,0.5714285714285714,1,0.0,0,1,0,0,2,0,0,1,0,1,3,1
2175,47803,93FWPuXY2azQQwZQWS80tdORRpOo60jj,fbPkOYLVPtPgIt0MxizjfFJov3JbHyAi,10,6,6,0,5,0,0,0,17,2.4285714285714284,1,0.0,0,6,0,5,6,0,0,0,0,11,6,1
2176,47807,JQWlZ9S0smBFDMGfgqcpt4ewgfL5yur6,fbPkOYLVPtPgIt0MxizjfFJov3JbHyAi,7,6,3,0,1,1,4,0,15,2.142857142857143,1,0.0,1,3,0,1,5,1,0,4,0,5,10,1
2177,47811,eIW9M0Trkt0EiuTzN2HuEtF6QnUOm4E9,fbPkOYLVPtPgIt0MxizjfFJov3JbHyAi,13,20,11,7,7,0,2,0,47,6.714285714285714,1,0.0,7,11,7,7,13,0,0,2,0,32,15,1
2178,47813,pzBdNMI6l60tGyYDZDsD8a3IbqJH27O8,fbPkOYLVPtPgIt0MxizjfFJov3JbHyAi,12,21,4,0,1,0,7,0,33,4.714285714285714,3,0.0,0,4,0,1,21,0,0,7,0,5,28,0
2179,47814,1gTDkM1DmoNiWAXMcO7Ry3TBKifByJrA,fbPkOYLVPtPgIt0MxizjfFJov3JbHyAi,5,3,2,0,0,0,2,0,7,1.0,1,0.0,0,2,0,0,3,0,0,2,0,2,5,1
2180,47815,R32OpsvoWT0fJOVOqVFkJPGA6xEYJoku,fbPkOYLVPtPgIt0MxizjfFJov3JbHyAi,5,0,0,0,0,2,5,1,8,1.1428571428571428,1,0.0,0,0,0,0,0,2,0,5,1,0,8,1
2181,47819,JSeJszCXASTiAymchwd8Mbxb0d9xvaME,fbPkOYLVPtPgIt0MxizjfFJov3JbHyAi,4,2,1,0,1,0,1,0,5,0.7142857142857143,1,0.0,0,1,0,1,2,0,0,1,0,2,3,1
2182,47821,GYAhe7QkBFzfyQOufZzJyKbMW1Ol7QR2,fbPkOYLVPtPgIt0MxizjfFJov3JbHyAi,1,0,0,0,0,0,1,0,1,0.14285714285714285,1,0.0,0,0,0,0,0,0,0,1,0,0,1,1
2183,47823,9uK9gXYJyTZNtNSUCINqfEFUfFE2z8C1,fbPkOYLVPtPgIt0MxizjfFJov3JbHyAi,2,0,0,0,0,0,2,0,2,0.2857142857142857,1,0.0,0,0,0,0,0,0,0,2,0,0,2,1
2184,47825,FosOn7Nym18de58uciRhhONZG69DSOHR,fbPkOYLVPtPgIt0MxizjfFJov3JbHyAi,1,0,0,0,0,0,1,0,1,0.14285714285714285,1,0.0,0,0,0,0,0,0,0,1,0,0,1,1
2185,47827,QXhJhqRI2RKlJx1bX2NHrvRhjNHoTmov,fbPkOYLVPtPgIt0MxizjfFJov3JbHyAi,7,5,3,0,2,0,2,0,12,1.7142857142857142,1,0.0,0,3,0,2,5,0,0,2,0,5,7,1
2186,47829,XHEZtfDZPcYKEJdadg7oTWoKvKH8Zuar,fbPkOYLVPtPgIt0MxizjfFJov3JbHyAi,2,0,0,0,0,0,2,0,2,0.2857142857142857,1,0.0,0,0,0,0,0,0,0,2,0,0,2,1
2187,47830,2yx2qSv17vABrVR2NSjoUhZ8khDHzM1p,fbPkOYLVPtPgIt0MxizjfFJov3JbHyAi,6,7,1,0,1,0,3,0,12,1.7142857142857142,2,0.0,0,1,0,1,7,0,0,3,0,2,10,1
2188,47831,YpdehTzQsSqz1ddMB0XGW2Y6lcmHTYFK,fbPkOYLVPtPgIt0MxizjfFJov3JbHyAi,6,4,2,0,0,0,4,0,10,1.4285714285714286,1,0.0,0,2,0,0,4,0,0,4,0,2,8,1
2189,47832,uzyKB6l5IMjDSYdYxLudAhgrFzD2VyDw,fbPkOYLVPtPgIt0MxizjfFJov3JbHyAi,8,6,4,0,3,1,4,0,18,2.5714285714285716,1,0.0,0,4,0,3,6,1,0,4,0,7,11,1
2190,47833,16veA4geT2xKUlqWBL48Fcqf8WTsVJtc,fbPkOYLVPtPgIt0MxizjfFJov3JbHyAi,1,0,0,0,0,0,1,0,1,0.14285714285714285,1,0.0,0,0,0,0,0,0,0,1,0,0,1,1
2191,47834,ONghHwhwAX2IyqpHHX698rW0VH9BRcsu,fbPkOYLVPtPgIt0MxizjfFJov3JbHyAi,7,4,2,0,3,0,3,0,12,1.7142857142857142,1,0.0,2,2,0,3,2,0,0,3,0,7,5,1
2192,47835,bPKFcVQkxVd0TAh9nUEtyZP7EFWzhnRn,fbPkOYLVPtPgIt0MxizjfFJov3JbHyAi,9,8,6,0,5,0,5,0,24,3.4285714285714284,1,0.0,0,6,0,5,8,0,0,5,0,11,13,1
2193,47836,SvayS3hRjiQUsZJZ3Z80XuRW7pnvNCGH,fbPkOYLVPtPgIt0MxizjfFJov3JbHyAi,25,54,24,9,14,4,8,0,113,16.142857142857142,2,0.0,16,24,8,14,38,4,1,8,0,62,51,1
2194,47837,pwbQ0rznhIurRxyuVQAFAxt3Zer8oDir,fbPkOYLVPtPgIt0MxizjfFJov3JbHyAi,4,3,2,0,2,0,3,0,10,1.4285714285714286,1,0.0,0,2,0,2,3,0,0,3,0,4,6,1
2195,47840,BNU2wGZhV5dmPLymeUzZGTZPF40H3QyF,fbPkOYLVPtPgIt0MxizjfFJov3JbHyAi,7,3,2,0,2,0,2,0,9,1.2857142857142858,1,0.0,0,2,0,2,3,0,0,2,0,4,5,1
2196,47841,HIbKGQJ8yDbPhmqDqsEHxHEydttgfsQA,fbPkOYLVPtPgIt0MxizjfFJov3JbHyAi,7,3,2,0,2,0,2,0,9,1.2857142857142858,1,0.0,0,2,0,2,3,0,0,2,0,4,5,1
2197,47842,oQIbxVPhPOzQp4tRk0swq8bc74m862Je,fbPkOYLVPtPgIt0MxizjfFJov3JbHyAi,6,13,1,0,1,0,3,0,18,2.5714285714285716,1,0.0,3,1,0,1,10,0,0,3,0,5,13,1
2198,47843,IZ5pWpBLzW50MjCCGxCjTz4w6DVz2MU3,fbPkOYLVPtPgIt0MxizjfFJov3JbHyAi,6,6,4,0,1,0,1,0,12,1.7142857142857142,1,0.0,0,4,0,1,6,0,0,1,0,5,7,1
2199,47844,P4gIdHzF607L8e8VPH3Qb09lxgNZRJFa,fbPkOYLVPtPgIt0MxizjfFJov3JbHyAi,10,9,7,0,5,0,4,0,25,3.5714285714285716,2,0.0,0,7,0,5,9,0,0,4,0,12,13,1
2200,47845,QQOQ1mBFT0hbDG4vhxUnw8WQ7hq3XsN0,fbPkOYLVPtPgIt0MxizjfFJov3JbHyAi,6,3,2,0,2,0,1,0,8,1.1428571428571428,1,0.0,0,2,0,2,3,0,0,1,0,4,4,1
2201,47847,Bat1lO5dwlkuBIiIqyEjLCmla1w2SsRg,fbPkOYLVPtPgIt0MxizjfFJov3JbHyAi,1,0,0,0,0,0,1,0,1,0.14285714285714285,1,0.0,0,0,0,0,0,0,0,1,0,0,1,1
2202,47849,hjbzzLF0uZqUL22zLBiQhzq51chcw6mb,fbPkOYLVPtPgIt0MxizjfFJov3JbHyAi,18,19,11,5,8,6,5,0,54,7.714285714285714,1,0.0,6,11,4,8,13,6,1,5,0,29,25,1
2203,47851,kLsZKBC25zLVIospdIdcGhrxzfP125JG,fbPkOYLVPtPgIt0MxizjfFJov3JbHyAi,11,6,5,0,5,0,6,0,22,3.142857142857143,1,0.0,0,5,0,5,6,0,0,6,0,10,12,1
2204,47852,RfgbqJEazOp1Rb866WYVJPYz91jABFLG,fbPkOYLVPtPgIt0MxizjfFJov3JbHyAi,15,7,6,0,6,1,4,1,25,3.5714285714285716,1,0.0,0,6,0,6,7,1,0,4,1,12,13,1
2205,47854,gRdV8TKfYOuiXGGwKnVS8SiUiAxajq1L,fbPkOYLVPtPgIt0MxizjfFJov3JbHyAi,12,24,10,4,10,2,6,0,56,8.0,2,0.0,7,10,4,10,17,2,0,6,0,31,25,1
2206,47855,II1eOimMlUCajOv1GRuK8VabiA0lRWyy,fbPkOYLVPtPgIt0MxizjfFJov3JbHyAi,5,2,1,0,1,0,5,0,9,1.2857142857142858,1,0.0,0,1,0,1,2,0,0,5,0,2,7,1
2207,47856,82BkQjqJpTLnL5kDgBNneTIQ8dLAyaMt,fbPkOYLVPtPgIt0MxizjfFJov3JbHyAi,4,3,1,0,0,0,1,0,5,0.7142857142857143,1,0.0,0,1,0,0,3,0,0,1,0,1,4,1
2208,47857,r7L6HOKA435eaor9jfOstdB35ZN19tsN,fbPkOYLVPtPgIt0MxizjfFJov3JbHyAi,5,4,3,0,3,0,2,0,12,1.7142857142857142,1,0.0,0,3,0,3,4,0,0,2,0,6,6,1
2209,47858,4uvFeDWIZ6bzoupIa1lCMrJxU4bo03vY,fbPkOYLVPtPgIt0MxizjfFJov3JbHyAi,21,25,10,13,12,1,5,1,67,9.571428571428571,2,0.0,13,10,10,12,12,1,3,5,1,45,22,1
2210,47859,HlsUiRcEZx95oGsZBkao06lPbfTneh9d,fbPkOYLVPtPgIt0MxizjfFJov3JbHyAi,1,0,0,0,0,0,1,0,1,0.14285714285714285,1,0.0,0,0,0,0,0,0,0,1,0,0,1,1
2211,47860,3Fj747AfeK8Iy9OuiJhJRPDmQRCh2lEF,fbPkOYLVPtPgIt0MxizjfFJov3JbHyAi,7,11,6,0,6,1,2,0,26,3.7142857142857144,2,0.0,2,6,0,6,9,1,0,2,0,14,12,1
2212,47931,ExNrdfeKsdYl3xmpiJlCBa13JPKyssuX,A3fsA9Zfv1X2fVEQhTw51lKENdNrEqT3,16,29,2,0,2,0,14,0,47,6.714285714285714,5,0.0,0,2,0,2,29,0,0,14,0,4,43,0
2213,47955,WCBxImuXCQhe4JCGgmUbhM2fHJqNW9fo,bWdj2GDclj5ofokWjzoa5jAwMkxCykd6,15,17,8,0,43,0,3,0,71,10.142857142857142,2,0.0,1,8,0,43,16,0,0,3,0,52,19,1
2214,47959,grSdEhkb3V38lf9YQcXO8O3GBe0inhXx,SpATywNh6bZuzm8s1ceuBUnMUAeoAHHw,22,53,0,17,0,2,10,0,82,11.714285714285714,2,0.0,13,0,17,0,40,2,0,10,0,30,52,0
2215,47976,HhK8Fr5pAwm4jm0sdGfJEGDMiAvZjcpI,bWdj2GDclj5ofokWjzoa5jAwMkxCykd6,6,1,1,0,1,0,3,0,6,0.8571428571428571,1,0.0,0,1,0,1,1,0,0,3,0,2,4,1
2216,47995,UjOHFBm02iem7rlbuAJcfFkUj4JVBikN,RXDvfPUBYFlVdlueBFbLW0mhhAyGEqpt,14,15,2,20,2,3,4,0,46,6.571428571428571,1,0.0,3,2,19,2,12,3,1,4,0,26,20,0
2217,48035,DX4dLCDX6l0Z68Mym7vcnKV6tMlkufOW,RXDvfPUBYFlVdlueBFbLW0mhhAyGEqpt,23,25,14,18,7,1,5,0,70,10.0,1,0.0,7,14,17,7,18,1,1,5,0,45,25,1
2218,48037,tK5QWvLAN98DDvHjcCO96Vrig3bCPcrd,RXDvfPUBYFlVdlueBFbLW0mhhAyGEqpt,15,27,2,6,0,10,6,1,52,7.428571428571429,1,0.0,0,2,3,0,27,10,3,6,1,5,47,0
2219,48069,S0OJjF6aof0iTnIX6lUAxekoH3m4w7V0,A3fsA9Zfv1X2fVEQhTw51lKENdNrEqT3,62,27,15,132,8,34,12,2,230,32.857142857142854,2,0.0,2,15,115,8,25,34,17,12,2,140,90,0
2220,48082,s13Zj70iGaPJV2HiUyzOXf2g6dcMZpb3,RXDvfPUBYFlVdlueBFbLW0mhhAyGEqpt,44,38,16,46,14,23,4,0,141,20.142857142857142,2,0.0,8,16,46,14,30,23,0,4,0,84,57,0
2221,48118,9pydrkItOvXReb7xWe6yqdMpXhFzfa5K,SpATywNh6bZuzm8s1ceuBUnMUAeoAHHw,19,34,13,20,4,22,7,0,100,14.285714285714286,2,0.0,8,13,16,4,26,22,4,7,0,41,59,0
2222,48135,gtGDHRUZ7LgMlMOjWieE5uKSYCgIoTZ0,G8EPVSXsOYB5YQWZGiz1aVq5Pgr2GrQu,5,5,2,0,1,0,2,0,10,1.4285714285714286,2,0.0,0,2,0,1,5,0,0,2,0,3,7,0
2223,48138,f3FFKNKPDIkY4ZzespQ1tkojfbmyOtUb,SpATywNh6bZuzm8s1ceuBUnMUAeoAHHw,23,48,24,14,13,0,8,0,107,15.285714285714286,4,0.0,7,24,13,13,41,0,1,8,0,57,50,0
2224,48148,2zQQnqY1LiZ9lcEXTzcE3zimEdKe8CdV,SpATywNh6bZuzm8s1ceuBUnMUAeoAHHw,20,19,13,11,6,8,6,1,64,9.142857142857142,1,0.0,4,13,11,6,15,8,0,6,1,34,30,0
2225,48179,HCOgsqUBNFumf2cCspNzKWg9hTVzHRVA,SpATywNh6bZuzm8s1ceuBUnMUAeoAHHw,29,23,14,20,10,3,11,3,84,12.0,3,0.0,9,14,16,10,14,3,4,11,3,49,35,1
2226,48218,VBP5PzVQEKJYFH0y5ffEek5WfP9EW7uc,A3fsA9Zfv1X2fVEQhTw51lKENdNrEqT3,4,9,5,0,0,0,5,0,19,2.7142857142857144,4,0.0,0,5,0,0,9,0,0,5,0,5,14,1
2227,48223,GfRp1O86gI5zJJh8SIJ1bczUJPWlAqoK,SpATywNh6bZuzm8s1ceuBUnMUAeoAHHw,19,27,0,34,0,0,10,1,72,10.285714285714286,1,0.0,8,0,29,0,19,0,5,10,1,37,35,0
2228,48255,gLAW4GOuyz8JKg5RO5Sf2rzir65isCiq,G8EPVSXsOYB5YQWZGiz1aVq5Pgr2GrQu,19,21,15,0,10,2,9,2,59,8.428571428571429,1,0.0,0,15,0,10,21,2,0,9,2,25,34,0
2229,48268,EhHrinjt1AkEWC09AFZwBuP61S5NJgjn,A3fsA9Zfv1X2fVEQhTw51lKENdNrEqT3,3,2,2,0,0,0,1,0,5,0.7142857142857143,1,0.0,0,2,0,0,2,0,0,1,0,2,3,1
2230,48277,KJnvgR26H5LLeKdyvjJHjjqg4mjHEhgN,A3fsA9Zfv1X2fVEQhTw51lKENdNrEqT3,29,9,8,60,4,0,2,0,83,11.857142857142858,1,0.0,1,8,52,4,8,0,8,2,0,65,18,1
2231,48303,ibgC3AgPCiKxZzQtLwOtyIa6DJRV6K2p,SpATywNh6bZuzm8s1ceuBUnMUAeoAHHw,12,21,9,19,0,40,13,2,104,14.857142857142858,4,0.0,6,9,16,0,15,40,3,13,2,31,73,0
2232,48304,H5UEKpeYUS8ZwAU1o3ZTuTx8QVBIM5mj,SpATywNh6bZuzm8s1ceuBUnMUAeoAHHw,13,12,0,6,0,0,2,0,20,2.857142857142857,1,0.0,2,0,6,0,10,0,0,2,0,8,12,1
2233,48343,KJnvgR26H5LLeKdyvjJHjjqg4mjHEhgN,bWdj2GDclj5ofokWjzoa5jAwMkxCykd6,10,10,4,14,4,4,5,0,41,5.857142857142857,1,0.0,3,4,12,4,7,4,2,5,0,23,18,0
2234,48354,YUkia24kFQkJdU9Tc0bEfJWS5kFL3fnZ,SpATywNh6bZuzm8s1ceuBUnMUAeoAHHw,14,19,5,12,3,17,18,0,74,10.571428571428571,5,0.0,7,5,9,3,12,17,3,18,0,24,50,0
2235,48366,eQnxTOv5tF733HrH1v8IIfXTQQ20WB86,SpATywNh6bZuzm8s1ceuBUnMUAeoAHHw,11,9,4,6,1,0,9,0,29,4.142857142857143,3,0.0,2,4,6,1,7,0,0,9,0,13,16,0
2236,48410,fKzNFTbPePkMpMq31aLHMmVifATbrx2C,A3fsA9Zfv1X2fVEQhTw51lKENdNrEqT3,7,3,2,0,1,1,4,1,12,1.7142857142857142,1,0.0,0,2,0,1,3,1,0,4,1,3,9,1
2237,48466,zOGgv8cnkqEW7Y2l6fqZ3IzLqplNhsIx,SpATywNh6bZuzm8s1ceuBUnMUAeoAHHw,6,5,0,0,0,0,2,1,8,1.1428571428571428,1,0.0,0,0,0,0,5,0,0,2,1,0,8,1
2238,48509,a41llItPMmO7jtwR6NH41lmydyfI26Gz,SpATywNh6bZuzm8s1ceuBUnMUAeoAHHw,17,46,2,18,2,4,9,3,84,12.0,1,0.0,20,2,15,2,26,4,3,9,3,39,45,0
2239,48524,aYYkr3EBoQc6U0mONjplTV8V30x3QwMR,SpATywNh6bZuzm8s1ceuBUnMUAeoAHHw,11,47,14,0,5,1,23,1,91,13.0,2,0.0,0,14,0,5,47,1,0,23,1,19,72,0
2240,48629,1ERwpt9wMj2n5z0yrcDeOTKwiq17bpYL,SpATywNh6bZuzm8s1ceuBUnMUAeoAHHw,8,6,5,0,3,0,1,0,15,2.142857142857143,1,0.0,0,5,0,3,6,0,0,1,0,8,7,0
2241,48647,A5P9jrlzLqQKpA3sVBvwbPCf9CAYmtxw,SpATywNh6bZuzm8s1ceuBUnMUAeoAHHw,16,17,8,16,5,5,1,0,52,7.428571428571429,1,0.0,4,8,14,5,13,5,2,1,0,31,21,0
2242,48733,mitKAcO5Yq84LGwUL473CFioIDbwQfRi,SpATywNh6bZuzm8s1ceuBUnMUAeoAHHw,14,19,12,12,0,0,10,0,53,7.571428571428571,3,0.0,3,12,12,0,16,0,0,10,0,27,26,0
2243,48803,GkoB2VZz49YRew10AQsiKgGNbvbaRd2W,SpATywNh6bZuzm8s1ceuBUnMUAeoAHHw,13,23,10,0,3,1,8,0,45,6.428571428571429,2,0.0,0,10,0,3,23,1,0,8,0,13,32,0
2244,48816,Vn131dD12fh0kapodbBhio0q4dV4IYmG,SpATywNh6bZuzm8s1ceuBUnMUAeoAHHw,8,6,3,8,0,0,1,0,18,2.5714285714285716,1,0.0,2,3,8,0,4,0,0,1,0,13,5,0
2245,48847,zrYm7VvWMlvZCf7Dgu9kA0S4dPcpd9DE,G8EPVSXsOYB5YQWZGiz1aVq5Pgr2GrQu,1,0,0,0,0,0,1,0,1,0.14285714285714285,1,0.0,0,0,0,0,0,0,0,1,0,0,1,1
2246,48881,n7yQ1FvfAXqDnBpszfIUjZkrvw3J2aJC,A3fsA9Zfv1X2fVEQhTw51lKENdNrEqT3,2,0,0,0,0,0,2,0,2,0.2857142857142857,1,0.0,0,0,0,0,0,0,0,2,0,0,2,1
2247,48953,cPrlzYoTDFDvccHbBKlJUrITep6ieC7X,SpATywNh6bZuzm8s1ceuBUnMUAeoAHHw,24,25,15,33,6,0,3,0,82,11.714285714285714,1,0.0,7,15,30,6,18,0,3,3,0,58,24,0
2248,48991,aOfddFrct0TUA0MYqpcFv1UssmM1IX2e,SpATywNh6bZuzm8s1ceuBUnMUAeoAHHw,28,49,17,37,12,0,8,0,123,17.571428571428573,2,0.0,31,17,32,12,18,0,5,8,0,92,31,1
2249,49011,1fjO19pGLwHG3depgSJxIFrDpr07UqZK,SpATywNh6bZuzm8s1ceuBUnMUAeoAHHw,14,43,18,16,3,0,8,0,88,12.571428571428571,2,0.0,11,18,14,3,32,0,2,8,0,46,42,0
2250,49017,1fjO19pGLwHG3depgSJxIFrDpr07UqZK,bWdj2GDclj5ofokWjzoa5jAwMkxCykd6,3,2,1,0,0,0,2,0,5,0.7142857142857143,1,0.0,0,1,0,0,2,0,0,2,0,1,4,1
2251,49076,WSyXGkhm7NDepRlMA3agJj8k8GLnavsP,SpATywNh6bZuzm8s1ceuBUnMUAeoAHHw,13,10,6,7,4,0,2,0,29,4.142857142857143,1,0.0,1,6,6,4,9,0,1,2,0,17,12,0
2252,49096,etO9cGvtnbcyDOUow8PWemZvzpbkeWT2,SpATywNh6bZuzm8s1ceuBUnMUAeoAHHw,8,9,4,0,2,0,4,0,19,2.7142857142857144,3,0.0,0,4,0,2,9,0,0,4,0,6,13,0
2253,49129,5VPsupm8AUE2ZBwqUxHjS8zxcSp1Mcls,SpATywNh6bZuzm8s1ceuBUnMUAeoAHHw,18,14,7,23,4,18,3,0,69,9.857142857142858,1,0.0,6,7,19,4,8,18,4,3,0,36,33,0
2254,49132,gSsRzqNvll8eqcaaEGmB933OlJpuGX1g,G8EPVSXsOYB5YQWZGiz1aVq5Pgr2GrQu,9,8,2,16,3,0,4,0,33,4.714285714285714,2,0.0,4,2,13,3,4,0,3,4,0,22,11,0
2255,49143,Jt2ZVEP2fRpS6kT1yCei4p4So6yqdxLs,SpATywNh6bZuzm8s1ceuBUnMUAeoAHHw,29,34,15,32,7,5,10,4,107,15.285714285714286,2,0.0,14,15,30,7,20,5,2,10,4,66,41,0
2256,49212,l70wRZ2DS0s6LjbT7C4gRoGrF27x9p2H,SpATywNh6bZuzm8s1ceuBUnMUAeoAHHw,10,13,0,8,0,10,5,0,36,5.142857142857143,3,0.0,4,0,8,0,9,10,0,5,0,12,24,0
2257,49353,W6MGFBQ1Tov9lOeRQ8QlzHUMCDNEGRDq,SpATywNh6bZuzm8s1ceuBUnMUAeoAHHw,14,8,5,6,4,0,1,0,24,3.4285714285714284,1,0.0,2,5,6,4,6,0,0,1,0,17,7,1
2258,49397,uZVvmJaNXb0GsvOW7SvWgzrpxZ3muXeW,SpATywNh6bZuzm8s1ceuBUnMUAeoAHHw,16,14,7,17,4,9,7,1,59,8.428571428571429,2,0.0,4,7,16,4,10,9,1,7,1,31,28,0
2259,49492,8zWgVyFjldbfjgOVhyVSCY9hVHofzB37,SpATywNh6bZuzm8s1ceuBUnMUAeoAHHw,24,38,5,16,3,1,7,1,71,10.142857142857142,5,0.0,9,5,16,3,29,1,0,7,1,33,38,0
2260,49593,tLAxgBhXx0zpE8fWNnwggaJx5LeHI2h1,A3fsA9Zfv1X2fVEQhTw51lKENdNrEqT3,28,15,7,86,4,0,2,0,114,16.285714285714285,2,0.0,1,7,73,4,14,0,13,2,0,85,29,1
2261,49675,vEvuCci9jxTTRH9CGXFnMQL31rdrARkm,RXDvfPUBYFlVdlueBFbLW0mhhAyGEqpt,8,11,7,0,2,0,6,0,26,3.7142857142857144,2,0.0,0,7,0,2,11,0,0,6,0,9,17,1
2262,49779,W6MGFBQ1Tov9lOeRQ8QlzHUMCDNEGRDq,A3fsA9Zfv1X2fVEQhTw51lKENdNrEqT3,23,6,3,52,0,0,1,0,62,8.857142857142858,1,0.0,2,3,49,0,4,0,3,1,0,54,8,0
2263,49885,v8BycPX41vEGxhnmXhJJeiFe4eT4u7RK,SpATywNh6bZuzm8s1ceuBUnMUAeoAHHw,12,9,6,11,0,0,2,0,28,4.0,1,0.0,2,6,10,0,7,0,1,2,0,18,10,0
2264,49980,fFjj8aLqWVfTrDoDqL54VYBbLQmMY3Y1,G8EPVSXsOYB5YQWZGiz1aVq5Pgr2GrQu,2,0,0,0,0,0,3,0,3,0.42857142857142855,1,0.0,0,0,0,0,0,0,0,3,0,0,3,1
2265,49981,Q0d1WItnRJvnzlnn5VcAU6GMGN4rfbYJ,A3fsA9Zfv1X2fVEQhTw51lKENdNrEqT3,5,4,2,0,0,0,8,0,14,2.0,1,0.0,0,2,0,0,4,0,0,8,0,2,12,1
2266,49986,cT0XTodWylQtczhaeg1zuAXwbhCqeXWR,SpATywNh6bZuzm8s1ceuBUnMUAeoAHHw,7,6,0,1,0,0,1,0,8,1.1428571428571428,1,0.0,0,0,1,0,6,0,0,1,0,1,7,0
2267,50006,IjWCyY0OMptnbDif5zdKxFY839cuvS21,SpATywNh6bZuzm8s1ceuBUnMUAeoAHHw,11,13,1,7,0,0,2,0,23,3.2857142857142856,1,0.0,0,1,7,0,13,0,0,2,0,8,15,0
2268,50023,Eu9HoDt3WhECHgcXaERosbI6lMj7Hipb,A3fsA9Zfv1X2fVEQhTw51lKENdNrEqT3,27,23,18,0,13,0,4,0,58,8.285714285714286,2,0.0,0,18,0,13,23,0,0,4,0,31,27,1
2269,50027,tWEnJYIhXMJ03Foo959mubaAJUHZPTw0,SpATywNh6bZuzm8s1ceuBUnMUAeoAHHw,24,73,1,48,0,50,15,3,190,27.142857142857142,3,0.0,15,1,41,0,58,50,7,15,3,57,133,0
2270,50037,5ARkGJ4p1hrN1paVNwlZ2LmySeAZIjWv,SpATywNh6bZuzm8s1ceuBUnMUAeoAHHw,7,7,4,0,2,0,3,0,16,2.2857142857142856,1,0.0,0,4,0,2,7,0,0,3,0,6,10,1
2271,50084,1HlQxNM9nR1hj1jXFLyimiGxZiQUWT8w,RXDvfPUBYFlVdlueBFbLW0mhhAyGEqpt,14,22,7,14,12,0,1,0,56,8.0,1,0.0,10,7,12,12,12,0,2,1,0,41,15,1
2272,50161,vQxwNbtZgUat9SDZRmE7MEKdvAizpBwk,SpATywNh6bZuzm8s1ceuBUnMUAeoAHHw,19,31,0,17,0,2,3,0,53,7.571428571428571,1,0.0,6,0,17,0,25,2,0,3,0,23,30,0
2273,50203,8ZgsKNDzCbgk8zoZndfYiYFsfvE0SQgi,SpATywNh6bZuzm8s1ceuBUnMUAeoAHHw,16,27,3,19,2,0,7,0,58,8.285714285714286,3,0.0,10,3,16,2,17,0,3,7,0,31,27,0
2274,50223,l5LfU8gApOG72AnBkdAbfOLQLwFH7Zo2,SpATywNh6bZuzm8s1ceuBUnMUAeoAHHw,15,24,2,14,0,11,6,0,57,8.142857142857142,2,0.0,4,2,11,0,20,11,3,6,0,17,40,0
2275,50294,mexTVUuTBaMSHWugjgX7gCSwX1B8AubF,SpATywNh6bZuzm8s1ceuBUnMUAeoAHHw,5,8,0,0,0,0,2,0,10,1.4285714285714286,1,0.0,0,0,0,0,8,0,0,2,0,0,10,0
2276,50361,Gur5FuhE9EyV9K1F0qLPk7AenhoY8PBS,SpATywNh6bZuzm8s1ceuBUnMUAeoAHHw,12,11,0,12,0,32,12,3,70,10.0,1,0.0,3,0,9,0,8,32,3,12,3,12,58,1
2277,50380,Xdag5jOmE7uWC3FmBvgPc5F7lO3QNcPW,bWdj2GDclj5ofokWjzoa5jAwMkxCykd6,3,2,1,0,0,0,1,0,4,0.5714285714285714,1,0.0,0,1,0,0,2,0,0,1,0,1,3,0
2278,50383,wcXKTRp3782w7z3pcKy7I4KlcLaVU81W,SpATywNh6bZuzm8s1ceuBUnMUAeoAHHw,10,10,1,0,1,0,2,0,14,2.0,1,0.0,0,1,0,1,10,0,0,2,0,2,12,0
2279,50422,SnivjdMp3HL6G23yPscSnzZlAD2Rbyt6,bWdj2GDclj5ofokWjzoa5jAwMkxCykd6,9,20,9,8,8,0,3,0,48,6.857142857142857,3,0.0,8,9,7,8,12,0,1,3,0,32,16,1
2280,50455,9jNN69RJsAFkkuYDPHWQVpfsVwA6mFxd,SpATywNh6bZuzm8s1ceuBUnMUAeoAHHw,17,20,13,32,0,0,2,0,67,9.571428571428571,1,0.0,4,13,29,0,16,0,3,2,0,46,21,0
2281,50460,DRhlp1eJHQqsxjCL0bRD6kkHN20HbJ4w,RXDvfPUBYFlVdlueBFbLW0mhhAyGEqpt,14,7,5,12,4,0,1,0,29,4.142857142857143,2,0.0,1,5,12,4,6,0,0,1,0,22,7,1
2282,50485,bZVDIvmAMciYIQrrbhRx0jvH9Tiicfyn,SpATywNh6bZuzm8s1ceuBUnMUAeoAHHw,14,23,0,14,0,0,5,0,42,6.0,1,0.0,5,0,13,0,18,0,1,5,0,18,24,0
2283,50609,THlX4ibtjGYQg6ZUfc8ItvnKMtOly4Xi,SpATywNh6bZuzm8s1ceuBUnMUAeoAHHw,21,28,14,0,9,1,8,0,60,8.571428571428571,2,0.0,0,14,0,9,28,1,0,8,0,23,37,0
2284,50632,DeyP5lAVv1H3yXRPzbyis5xLngeggxpO,RXDvfPUBYFlVdlueBFbLW0mhhAyGEqpt,4,3,1,0,0,0,2,0,6,0.8571428571428571,1,0.0,0,1,0,0,3,0,0,2,0,1,5,1
2285,50692,BfoybeaeQZxTt069jPLA4qjwQgNZD97I,G8EPVSXsOYB5YQWZGiz1aVq5Pgr2GrQu,17,22,0,10,0,18,13,2,65,9.285714285714286,1,0.0,6,0,5,0,16,18,5,13,2,11,54,1
2286,50777,se9ZVl8DNkiCW8i2nP0p3krrUcQqYC47,bWdj2GDclj5ofokWjzoa5jAwMkxCykd6,6,7,4,0,0,4,5,1,21,3.0,2,0.0,0,4,0,0,7,4,0,5,1,4,17,0
2287,50797,BWuaSpfjjWoQ6suviyDvOJ1XUJLgJBtc,SpATywNh6bZuzm8s1ceuBUnMUAeoAHHw,32,32,16,36,10,47,15,3,159,22.714285714285715,4,0.0,12,16,30,10,20,47,6,15,3,68,91,0
2288,50805,1HrXazG6mMhlQyrWzEYwtGHFWa0bXXko,SpATywNh6bZuzm8s1ceuBUnMUAeoAHHw,1,0,0,0,0,0,1,0,1,0.14285714285714285,1,0.0,0,0,0,0,0,0,0,1,0,0,1,0
2289,50808,xm9wUIf1J8EjTNxXT4ffEWzhuySk21YK,RXDvfPUBYFlVdlueBFbLW0mhhAyGEqpt,11,18,9,18,5,2,3,1,56,8.0,1,0.0,1,9,16,5,17,2,2,3,1,31,25,0
2290,50841,POGRFFRZzlPiBHiCHXnlCDCb459JTEzc,G8EPVSXsOYB5YQWZGiz1aVq5Pgr2GrQu,9,12,1,6,1,3,4,0,27,3.857142857142857,2,0.0,2,1,5,1,10,3,1,4,0,9,18,0
2291,52414,LwOwoJdIBH6qSphf2Y21IIrVgEcOPNno,7GRhBDsirIGkRZBtSMEzNTyDr2JQm4xx,8,4,1,0,0,3,11,0,19,2.7142857142857144,1,0.0,0,1,0,0,4,3,0,11,0,1,18,1
2292,52418,AWLXkSqW4e7SbhduVpZ7fOXghxuuP6q1,7GRhBDsirIGkRZBtSMEzNTyDr2JQm4xx,35,45,15,54,16,0,5,0,135,19.285714285714285,2,0.0,27,15,47,16,18,0,7,5,0,105,30,1
2293,52525,7tM0glf5iOjFrrOx11jEjeXPWGg1qnPf,7GRhBDsirIGkRZBtSMEzNTyDr2JQm4xx,4,7,2,0,0,0,3,0,12,1.7142857142857142,2,0.0,2,2,0,0,5,0,0,3,0,4,8,1
2294,52527,3EXQpH44dmXe1KuNCn9IRB8zLxVzdC0Z,7GRhBDsirIGkRZBtSMEzNTyDr2JQm4xx,1,0,0,0,0,0,1,0,1,0.14285714285714285,1,0.0,0,0,0,0,0,0,0,1,0,0,1,1
2295,52564,KFkM2LdM6U7FLDyErp7vnT4e1T4YjeOt,7GRhBDsirIGkRZBtSMEzNTyDr2JQm4xx,1,0,0,0,0,0,1,0,1,0.14285714285714285,1,0.0,0,0,0,0,0,0,0,1,0,0,1,1
2296,52609,pf5bjcn02zW6F9NEdRWcVWa4U5P6G0ff,7GRhBDsirIGkRZBtSMEzNTyDr2JQm4xx,16,11,1,24,0,0,3,0,39,5.571428571428571,2,0.0,0,1,21,0,11,0,3,3,0,22,17,1
2297,52629,N1ze97FAwTuBZx89GGh4oyy7kZndQ2aO,7GRhBDsirIGkRZBtSMEzNTyDr2JQm4xx,1,0,0,0,0,0,1,0,1,0.14285714285714285,1,0.0,0,0,0,0,0,0,0,1,0,0,1,1
2298,52648,PCT9UecTLFgHQMLESQLM3zo2VKyldhOq,7GRhBDsirIGkRZBtSMEzNTyDr2JQm4xx,31,44,1,109,6,3,3,0,166,23.714285714285715,1,0.0,26,1,98,6,18,3,11,3,0,131,35,0
2299,52708,qZCURwy8JtTyuwzOv8VNGZdlPKRFUQ4x,7GRhBDsirIGkRZBtSMEzNTyDr2JQm4xx,6,4,1,0,1,2,3,0,11,1.5714285714285714,1,0.0,0,1,0,1,4,2,0,3,0,2,9,1
2300,52730,8XaoEwTyWeXdGPkk69feFC4MnARlyEPY,7GRhBDsirIGkRZBtSMEzNTyDr2JQm4xx,4,2,1,0,0,0,4,0,7,1.0,1,0.0,0,1,0,0,2,0,0,4,0,1,6,0
2301,52753,SwHZgUxPjIeMthkMeeVpPfNadNOmRqaT,7GRhBDsirIGkRZBtSMEzNTyDr2JQm4xx,9,3,2,0,3,0,2,0,10,1.4285714285714286,1,0.0,0,2,0,3,3,0,0,2,0,5,5,1
2302,52762,yoBRTcR2cnNdwxBl8X3b5dAnEe5pLM8o,7GRhBDsirIGkRZBtSMEzNTyDr2JQm4xx,27,59,15,24,16,0,3,0,117,16.714285714285715,1,0.0,22,15,21,16,37,0,3,3,0,74,43,1
2303,52767,oegjA7ZBrBlZ5Cd9WyrHTpKnm4129pWq,7GRhBDsirIGkRZBtSMEzNTyDr2JQm4xx,3,3,1,0,0,0,1,0,5,0.7142857142857143,1,0.0,0,1,0,0,3,0,0,1,0,1,4,0
2304,52794,ZI5bmLXRjGY30yDOOtLk3SjipijnEDdH,7GRhBDsirIGkRZBtSMEzNTyDr2JQm4xx,40,105,33,56,16,2,8,0,220,31.428571428571427,3,0.0,41,33,47,16,64,2,9,8,0,137,83,1
2305,52796,5PAJAhGm6mrmRya9bVA0TVEjvyxWSpHH,7GRhBDsirIGkRZBtSMEzNTyDr2JQm4xx,1,0,0,0,0,0,1,0,1,0.14285714285714285,1,0.0,0,0,0,0,0,0,0,1,0,0,1,1
2306,52797,JIMEFE3LdWAEpCV2LFwTCYSPjTS7eSnb,7GRhBDsirIGkRZBtSMEzNTyDr2JQm4xx,1,0,0,0,0,0,2,0,2,0.2857142857142857,1,0.0,0,0,0,0,0,0,0,2,0,0,2,1
2307,52822,kXa3f0Vj2v6uxMPIg14PPBVn8OhOZ096,7GRhBDsirIGkRZBtSMEzNTyDr2JQm4xx,2,0,0,0,0,0,2,0,2,0.2857142857142857,1,0.0,0,0,0,0,0,0,0,2,0,0,2,1
2308,52863,3AQcLF4401vlSQmnRaDEtc72D2nXEfx6,7GRhBDsirIGkRZBtSMEzNTyDr2JQm4xx,2,0,0,0,0,0,2,0,2,0.2857142857142857,1,0.0,0,0,0,0,0,0,0,2,0,0,2,1
2309,52951,ZFZTZbiKHOXenp1TWxEkC4SRLbwYuUkm,7GRhBDsirIGkRZBtSMEzNTyDr2JQm4xx,2,0,0,0,0,0,2,0,2,0.2857142857142857,1,0.0,0,0,0,0,0,0,0,2,0,0,2,1
2310,52952,MfF2UM103u4NW6P3ppuUwg5ByBUcnBZA,7GRhBDsirIGkRZBtSMEzNTyDr2JQm4xx,1,0,0,0,0,0,1,0,1,0.14285714285714285,1,0.0,0,0,0,0,0,0,0,1,0,0,1,1
2311,52976,IiVkIz2ymD5LAyFMLUAoz4dlLCufsOLN,7GRhBDsirIGkRZBtSMEzNTyDr2JQm4xx,1,0,0,0,0,0,1,0,1,0.14285714285714285,1,0.0,0,0,0,0,0,0,0,1,0,0,1,0
2312,52994,KogrHROquIJLSXIZqzhYU9Hcb9zVebwT,7GRhBDsirIGkRZBtSMEzNTyDr2JQm4xx,18,25,4,24,7,0,1,0,61,8.714285714285714,1,0.0,10,4,22,7,15,0,2,1,0,43,18,1
2313,53007,0d9QTHxHI38QwsI8Nrfe3h4nIFkKB9wm,7GRhBDsirIGkRZBtSMEzNTyDr2JQm4xx,67,110,40,114,28,10,6,0,308,44.0,4,0.0,44,40,100,28,66,10,14,6,0,212,96,0
2314,53015,zKm7XBlAnX1kvqmnbBunuJ0zgW910NPD,7GRhBDsirIGkRZBtSMEzNTyDr2JQm4xx,2,0,0,0,0,0,2,0,2,0.2857142857142857,1,0.0,0,0,0,0,0,0,0,2,0,0,2,1
2315,53030,KR1JBNTPMvAMQwZ6jsgCry7qScNUELlI,7GRhBDsirIGkRZBtSMEzNTyDr2JQm4xx,1,0,0,0,0,0,1,0,1,0.14285714285714285,1,0.0,0,0,0,0,0,0,0,1,0,0,1,1
2316,53034,TCECwaNYQUDA9PVYFYURPe0mJR7V4JvI,SpATywNh6bZuzm8s1ceuBUnMUAeoAHHw,5,2,1,0,1,0,3,0,7,1.0,2,0.0,0,1,0,1,2,0,0,3,0,2,5,0
2317,53041,FW02PfU8vx3pzmS7oOXpJualmcvfngs4,SpATywNh6bZuzm8s1ceuBUnMUAeoAHHw,23,90,3,27,3,0,14,0,137,19.571428571428573,3,0.0,33,3,23,3,57,0,4,14,0,62,75,0
2318,53043,4LLdV2zTWS697dAsOgAPJZPFwfNnrjt6,SpATywNh6bZuzm8s1ceuBUnMUAeoAHHw,16,11,8,4,6,0,3,0,32,4.571428571428571,2,0.0,2,8,4,6,9,0,0,3,0,20,12,0
2319,53050,dy8SjTNGjfrg38FBIbengGqlbDgTOAri,bWdj2GDclj5ofokWjzoa5jAwMkxCykd6,7,3,2,0,2,0,2,0,9,1.2857142857142858,1,0.0,0,2,0,2,3,0,0,2,0,4,5,1
2320,53055,1EHzEIUJa67W0jqPggV7KDaLGgi5Qkxp,SpATywNh6bZuzm8s1ceuBUnMUAeoAHHw,18,17,9,11,6,1,0,0,44,6.285714285714286,1,0.0,8,9,11,6,9,1,0,0,0,34,10,1
2321,53074,vwFaMtviPYvvdeDxiexQOh059O9Yefj1,SpATywNh6bZuzm8s1ceuBUnMUAeoAHHw,15,68,6,0,8,1,8,0,91,13.0,3,0.0,6,6,0,8,62,1,0,8,0,20,71,1
2322,53087,Bos3zEEnAcYzPXQktMkJJ0ak5mhGWCAf,A3fsA9Zfv1X2fVEQhTw51lKENdNrEqT3,31,15,8,42,3,0,3,0,71,10.142857142857142,2,0.0,1,8,41,3,14,0,1,3,0,53,18,1
2323,53099,l5zm2dyq1Lp4ch4ILKl8mqNj892nMhsW,A3fsA9Zfv1X2fVEQhTw51lKENdNrEqT3,13,15,10,0,2,2,13,1,43,6.142857142857143,2,0.0,0,10,0,2,15,2,0,13,1,12,31,1
2324,53104,f3SUvLtMnVyEZPEDJVhRMSC5cEFasHSH,G8EPVSXsOYB5YQWZGiz1aVq5Pgr2GrQu,14,16,10,2,3,1,7,1,40,5.714285714285714,2,0.0,4,10,1,3,12,1,1,7,1,18,22,1
2325,53109,fFw6uRnMpWU4RqpwQO2WZ8GCAi6hyn9t,SpATywNh6bZuzm8s1ceuBUnMUAeoAHHw,19,20,11,9,7,0,3,0,50,7.142857142857143,2,0.0,5,11,9,7,15,0,0,3,0,32,18,0
2326,53110,ovvuiEhj0QBv4xi11GVjXr8JhlCgaPmd,bWdj2GDclj5ofokWjzoa5jAwMkxCykd6,35,47,18,288,7,17,29,0,406,58.0,3,0.0,16,18,264,7,31,17,24,29,0,305,101,0
2327,53122,OOC2fhf6AkZDpDsl3NCh3irgmTTqQt8y,G8EPVSXsOYB5YQWZGiz1aVq5Pgr2GrQu,3,0,0,0,0,1,2,0,3,0.42857142857142855,1,0.0,0,0,0,0,0,1,0,2,0,0,3,1
2328,53138,SSeq3zqfD5kMUB9gUKp0rdzGfihYMJi7,A3fsA9Zfv1X2fVEQhTw51lKENdNrEqT3,1,0,0,0,0,0,1,0,1,0.14285714285714285,1,0.0,0,0,0,0,0,0,0,1,0,0,1,1
2329,53142,AjsS25Vcjgm2GGcNjE7GPEmmTU7snmJA,SpATywNh6bZuzm8s1ceuBUnMUAeoAHHw,12,13,5,14,2,5,2,0,41,5.857142857142857,1,0.0,6,5,13,2,7,5,1,2,0,26,15,0
2330,53149,fkwxmynqKl1E9zGnE59tFxhsiBODuFhR,SpATywNh6bZuzm8s1ceuBUnMUAeoAHHw,6,3,1,0,1,0,2,0,7,1.0,1,0.0,0,1,0,1,3,0,0,2,0,2,5,1
2331,53157,H8hoxOy1VDjrCqtl8Y1RjEzCSImzfPb1,SpATywNh6bZuzm8s1ceuBUnMUAeoAHHw,20,21,9,15,5,9,3,3,65,9.285714285714286,2,0.0,9,9,13,5,12,9,2,3,3,36,29,1
2332,53160,PPZEwof9f8rZx0lcTpURHpbkLB2YY5hH,A3fsA9Zfv1X2fVEQhTw51lKENdNrEqT3,6,5,3,0,1,0,4,0,13,1.8571428571428572,1,0.0,0,3,0,1,5,0,0,4,0,4,9,1
2333,53162,4nHfdAZtp0niyFyrjm2L6LhTVPrJBlZM,A3fsA9Zfv1X2fVEQhTw51lKENdNrEqT3,32,15,8,82,3,5,15,0,128,18.285714285714285,4,0.0,2,8,73,3,13,5,9,15,0,86,42,1
2334,53178,kgME9COu6f9ljQ8FhJeUQLVyeGDbkeLG,SpATywNh6bZuzm8s1ceuBUnMUAeoAHHw,15,15,1,24,0,0,4,0,44,6.285714285714286,2,0.0,6,1,21,0,9,0,3,4,0,28,16,1
2335,53190,cWykzNKAq5sFQBA059QN4Jx74YGPkfwB,SpATywNh6bZuzm8s1ceuBUnMUAeoAHHw,5,7,0,0,0,0,5,0,12,1.7142857142857142,2,0.0,0,0,0,0,7,0,0,5,0,0,12,0
2336,53199,RfxrjGWEyzBCwnQEmvcmVh3DEMcbhg4m,bWdj2GDclj5ofokWjzoa5jAwMkxCykd6,8,9,6,0,5,0,4,0,24,3.4285714285714284,2,0.0,0,6,0,5,9,0,0,4,0,11,13,1
2337,53220,5TX7mZmksEi56P8MasqobWPGE5NBw2IQ,A3fsA9Zfv1X2fVEQhTw51lKENdNrEqT3,10,8,7,0,6,0,2,0,23,3.2857142857142856,1,0.0,0,7,0,6,8,0,0,2,0,13,10,1
2338,53233,nOWqKetxGFQ9o73UNfcoh0XyCt3ITawR,SpATywNh6bZuzm8s1ceuBUnMUAeoAHHw,17,27,8,14,4,0,3,0,56,8.0,2,0.0,6,8,12,4,21,0,2,3,0,30,26,0
2339,53242,XHTKaBKRPxCmq5MPcwRRZlQAa68hU6KT,RXDvfPUBYFlVdlueBFbLW0mhhAyGEqpt,15,7,3,31,2,1,3,0,47,6.714285714285714,1,0.0,3,3,28,2,4,1,3,3,0,36,11,1
2340,53244,cW2Xkl8EMUT4ygDkm6LqHv4BqvkNTIWA,SpATywNh6bZuzm8s1ceuBUnMUAeoAHHw,9,3,2,0,2,1,5,0,13,1.8571428571428572,1,0.0,0,2,0,2,3,1,0,5,0,4,9,1
2341,53245,2Bc3e8bWl6DTvfTPBZCyShFFG8OApkva,G8EPVSXsOYB5YQWZGiz1aVq5Pgr2GrQu,9,8,4,0,2,5,3,0,22,3.142857142857143,2,0.0,0,4,0,2,8,5,0,3,0,6,16,1
2342,53253,nsNOT1cU6IuLaV7JjnTNsqpFb1YDxqEb,SpATywNh6bZuzm8s1ceuBUnMUAeoAHHw,9,23,10,0,2,0,4,0,39,5.571428571428571,4,0.0,3,10,0,2,20,0,0,4,0,15,24,0
2343,53264,cWykzNKAq5sFQBA059QN4Jx74YGPkfwB,bWdj2GDclj5ofokWjzoa5jAwMkxCykd6,7,6,1,0,1,0,3,0,11,1.5714285714285714,2,0.0,0,1,0,1,6,0,0,3,0,2,9,0
2344,53267,alOTnyZzhm1w471FhEQsPMZXRjsY4Vw8,SpATywNh6bZuzm8s1ceuBUnMUAeoAHHw,14,14,6,13,3,0,3,0,39,5.571428571428571,1,0.0,7,6,10,3,7,0,3,3,0,26,13,1
2345,53274,OfEWzuzCYpLy1DIkUzWxNoBbzCb9peT6,SpATywNh6bZuzm8s1ceuBUnMUAeoAHHw,6,4,1,0,0,0,6,0,11,1.5714285714285714,1,0.0,0,1,0,0,4,0,0,6,0,1,10,0
2346,53297,wEZByhPumKHDR8Jv649KZn2fKnoB4Z7a,RXDvfPUBYFlVdlueBFbLW0mhhAyGEqpt,59,83,2,168,4,6,5,1,269,38.42857142857143,2,0.0,23,2,161,4,60,6,7,5,1,190,79,0
2347,53298,TL33IPw9u5rF9KFoVrfFEZ81kglnbuR1,bWdj2GDclj5ofokWjzoa5jAwMkxCykd6,1,0,0,0,0,0,1,0,1,0.14285714285714285,1,0.0,0,0,0,0,0,0,0,1,0,0,1,1
2348,53302,yo1PAd1hBwimD9OOoxvyi6mwQC5bfK9g,A3fsA9Zfv1X2fVEQhTw51lKENdNrEqT3,1,0,0,0,0,0,1,0,1,0.14285714285714285,1,0.0,0,0,0,0,0,0,0,1,0,0,1,1
2349,53311,aPkMT9tuTlJ66PtOLGr8kUMmFmOPUdkZ,SpATywNh6bZuzm8s1ceuBUnMUAeoAHHw,7,4,3,0,2,0,1,0,10,1.4285714285714286,1,0.0,0,3,0,2,4,0,0,1,0,5,5,1
2350,53317,yEniPsoZW8Rgn4eOpAbvQhjj6pD8iwKc,A3fsA9Zfv1X2fVEQhTw51lKENdNrEqT3,1,0,0,0,0,0,1,0,1,0.14285714285714285,1,0.0,0,0,0,0,0,0,0,1,0,0,1,1
2351,53331,hibDkoksqk55U27uWSImoVEarIMKhRU6,SpATywNh6bZuzm8s1ceuBUnMUAeoAHHw,1,0,0,0,0,0,1,0,1,0.14285714285714285,1,0.0,0,0,0,0,0,0,0,1,0,0,1,1
2352,53344,zDAtaSKsAJQmmJ6xHQBbAGN68vDebyev,bWdj2GDclj5ofokWjzoa5jAwMkxCykd6,4,4,0,0,0,0,1,0,5,0.7142857142857143,1,0.0,1,0,0,0,3,0,0,1,0,1,4,0
2353,53345,FtZzEliHSUjgpcn9CYNSke7IZriM02xT,SpATywNh6bZuzm8s1ceuBUnMUAeoAHHw,20,19,14,18,6,3,3,0,63,9.0,2,0.0,2,14,15,6,17,3,3,3,0,37,26,1
2354,53355,NiXPZUmEILmWUPwXexYxtHvaIL7QdjCQ,A3fsA9Zfv1X2fVEQhTw51lKENdNrEqT3,6,3,2,0,0,0,5,0,10,1.4285714285714286,1,0.0,0,2,0,0,3,0,0,5,0,2,8,1
2355,53363,kMMGkT5aXtXvkc2Ht1vStIyRGPA6Fe7z,G8EPVSXsOYB5YQWZGiz1aVq5Pgr2GrQu,17,14,10,0,7,0,8,1,40,5.714285714285714,2,0.0,2,10,0,7,12,0,0,8,1,19,21,1
2356,53367,qJEf5DGSDkSxZ1JIhipEbBFRbrhnAj1a,SpATywNh6bZuzm8s1ceuBUnMUAeoAHHw,27,62,23,32,13,0,7,0,137,19.571428571428573,2,0.0,30,23,31,13,32,0,1,7,0,97,40,0
2357,53375,Wz9l8snB7xy02KowUlwVZlKvIqcEcSjS,SpATywNh6bZuzm8s1ceuBUnMUAeoAHHw,20,25,1,16,0,0,2,0,44,6.285714285714286,1,0.0,10,1,16,0,15,0,0,2,0,27,17,1
2358,53378,5IoXxgwnl1RIJLxkp1FnmYezwVSXlFjr,SpATywNh6bZuzm8s1ceuBUnMUAeoAHHw,3,2,1,0,0,0,1,0,4,0.5714285714285714,1,0.0,0,1,0,0,2,0,0,1,0,1,3,0
2359,53388,b8RIifGIgaKQKUnIb1k2djgWvbjJC3hc,A3fsA9Zfv1X2fVEQhTw51lKENdNrEqT3,1,0,0,0,0,0,1,0,1,0.14285714285714285,1,0.0,0,0,0,0,0,0,0,1,0,0,1,1
2360,53468,rLYXv7hKF9TmAtWbjwlsT53xTtV0g4r6,A3fsA9Zfv1X2fVEQhTw51lKENdNrEqT3,13,6,3,0,2,0,10,2,23,3.2857142857142856,1,0.0,0,3,0,2,6,0,0,10,2,5,18,0
2361,53487,N3Kcp8HxIitle1dnmjMusLDj62CzfGvL,SpATywNh6bZuzm8s1ceuBUnMUAeoAHHw,10,25,3,0,4,22,9,0,63,9.0,5,0.0,1,3,0,4,24,22,0,9,0,8,55,0
2362,53488,OnFhgQq4yBEqO4X7tLyRDBVhde68jGdf,RXDvfPUBYFlVdlueBFbLW0mhhAyGEqpt,51,44,26,97,12,38,17,3,237,33.857142857142854,1,0.0,13,26,87,12,31,38,10,17,3,138,99,0
2363,53489,griMTqEKR37PeprCrLd3ng7H5lhHXROa,G8EPVSXsOYB5YQWZGiz1aVq5Pgr2GrQu,6,0,0,0,0,1,6,1,8,1.1428571428571428,1,0.0,0,0,0,0,0,1,0,6,1,0,8,1
2364,53491,DJenb7iikHj085JzrOjjcdsjyfa241f7,RXDvfPUBYFlVdlueBFbLW0mhhAyGEqpt,2,0,0,0,0,0,2,0,2,0.2857142857142857,1,0.0,0,0,0,0,0,0,0,2,0,0,2,1
2365,53502,MrmZgmDV3fLNPBur1xb2HpNXhTz9Exkt,SpATywNh6bZuzm8s1ceuBUnMUAeoAHHw,11,12,2,14,2,0,5,0,35,5.0,2,0.0,4,2,13,2,8,0,1,5,0,21,14,0
2366,53508,PJ44wkPMp1IThxNmQ1GXtcqK19ORMpJF,A3fsA9Zfv1X2fVEQhTw51lKENdNrEqT3,2,0,0,0,0,0,2,0,2,0.2857142857142857,1,0.0,0,0,0,0,0,0,0,2,0,0,2,1
2367,53520,MhrFHIexWYn2dilUXh03cpnfpoe9tMBe,SpATywNh6bZuzm8s1ceuBUnMUAeoAHHw,16,24,8,18,4,1,3,0,58,8.285714285714286,3,0.0,15,8,15,4,9,1,3,3,0,42,16,1
2368,53539,i2lUV72IHqqXWYqLFMWv3y4XGmlq2lXa,SpATywNh6bZuzm8s1ceuBUnMUAeoAHHw,18,20,10,12,5,0,5,0,52,7.428571428571429,2,0.0,2,10,12,5,18,0,0,5,0,29,23,0
2369,53549,luffaRyMH17lmf9lXIITCUvmvLstdhJF,RXDvfPUBYFlVdlueBFbLW0mhhAyGEqpt,8,9,1,0,1,0,2,0,13,1.8571428571428572,1,0.0,0,1,0,1,9,0,0,2,0,2,11,1
2370,53555,gb9jOdGxS4Zwvh3LQboE7LmvRCw5TLz9,SpATywNh6bZuzm8s1ceuBUnMUAeoAHHw,15,21,0,15,0,0,6,0,42,6.0,1,0.0,8,0,14,0,13,0,1,6,0,22,20,1
2371,53562,KhZJrlhAYzlNSzHg9PDkxBUGTDjg8IXY,SpATywNh6bZuzm8s1ceuBUnMUAeoAHHw,10,10,1,7,0,0,1,0,19,2.7142857142857144,1,0.0,2,1,7,0,8,0,0,1,0,10,9,1
2372,53578,aEf8iYWPFredkFvIYIscqnDLIOz4fHRM,RXDvfPUBYFlVdlueBFbLW0mhhAyGEqpt,4,6,0,0,0,0,1,0,7,1.0,1,0.0,0,0,0,0,6,0,0,1,0,0,7,1
2373,53584,6ulfbgGgKweBR5jQh3XucxQAX08OMB72,SpATywNh6bZuzm8s1ceuBUnMUAeoAHHw,11,8,1,0,1,0,2,0,12,1.7142857142857142,1,0.0,0,1,0,1,8,0,0,2,0,2,10,0
2374,53597,dL8suqa4DXYE6Q2rD72jJySCosptOAyu,SpATywNh6bZuzm8s1ceuBUnMUAeoAHHw,9,21,10,0,8,0,9,0,48,6.857142857142857,2,0.0,3,10,0,8,18,0,0,9,0,21,27,0
2375,53603,4Eyygyv4Uek4GSzjnDMCkiuVf4JBrAxc,SpATywNh6bZuzm8s1ceuBUnMUAeoAHHw,11,15,0,12,0,4,6,0,37,5.285714285714286,2,0.0,6,0,12,0,9,4,0,6,0,18,19,1
2376,53622,N07QLGV4GMHH6HuHURctAIeJ4ePasSlF,SpATywNh6bZuzm8s1ceuBUnMUAeoAHHw,2,0,0,0,0,0,2,0,2,0.2857142857142857,1,0.0,0,0,0,0,0,0,0,2,0,0,2,1
2377,53625,WJVoKPfDDccrIbPzaP1iqdrTUwOdTQpf,A3fsA9Zfv1X2fVEQhTw51lKENdNrEqT3,5,4,2,0,1,0,1,0,8,1.1428571428571428,1,0.0,0,2,0,1,4,0,0,1,0,3,5,1
2378,53651,TXNnbjY690dLjW2nCR7nDyfRxXhXZM7x,A3fsA9Zfv1X2fVEQhTw51lKENdNrEqT3,5,8,0,0,0,0,2,0,10,1.4285714285714286,1,0.0,0,0,0,0,8,0,0,2,0,0,10,1
2379,53678,uqIn0vdfJ1SDJCOeCVEAQPRFBBKQA2eB,bWdj2GDclj5ofokWjzoa5jAwMkxCykd6,26,12,6,75,4,9,4,1,111,15.857142857142858,2,0.0,2,6,70,4,10,9,5,4,1,82,29,1
2380,53706,xQeTj9CLDdVhlEixqachfO1hdSy3qexC,SpATywNh6bZuzm8s1ceuBUnMUAeoAHHw,6,9,1,16,0,0,0,0,26,3.7142857142857144,1,0.0,6,1,16,0,3,0,0,0,0,23,3,1
2381,53713,RluI9XQtU4oZmhgM6DxuPP3K5fCr0lBq,SpATywNh6bZuzm8s1ceuBUnMUAeoAHHw,17,13,10,5,6,0,2,0,36,5.142857142857143,2,0.0,0,10,5,6,13,0,0,2,0,21,15,1
2382,53714,Ar22lkOE5FvesxoMKtYhm8Cbv4MUQUYF,RXDvfPUBYFlVdlueBFbLW0mhhAyGEqpt,12,23,0,6,0,1,5,0,35,5.0,2,0.0,3,0,6,0,20,1,0,5,0,9,26,1
2383,53720,eeYgUeHIQERDYwF1mxwVIZYsVaVSgwlV,A3fsA9Zfv1X2fVEQhTw51lKENdNrEqT3,18,15,9,40,1,4,6,0,75,10.714285714285714,3,0.0,0,9,33,1,15,4,7,6,0,43,32,1
2384,53727,krkfIMLel7iDn2mta14hX7PO3xGpidTe,bWdj2GDclj5ofokWjzoa5jAwMkxCykd6,4,6,0,0,0,0,3,0,9,1.2857142857142858,2,0.0,0,0,0,0,6,0,0,3,0,0,9,1
2385,53733,1OspHY7rOajB01D4WOGZGtONpUzR26jm,bWdj2GDclj5ofokWjzoa5jAwMkxCykd6,1,0,0,0,0,0,1,0,1,0.14285714285714285,1,0.0,0,0,0,0,0,0,0,1,0,0,1,1
2386,53750,DHyGbluRYDb9YK4sD54nYIDtRwaCVU4f,SpATywNh6bZuzm8s1ceuBUnMUAeoAHHw,9,14,1,0,0,0,2,0,17,2.4285714285714284,2,0.0,0,1,0,0,14,0,0,2,0,1,16,1
2387,53758,Hu906OsUOpYkLeeay2GUzLMtBtAH0201,SpATywNh6bZuzm8s1ceuBUnMUAeoAHHw,11,13,1,0,1,0,7,0,22,3.142857142857143,3,0.0,0,1,0,1,13,0,0,7,0,2,20,1
2388,53765,tsMYMsnBDSMWs12MBfqVxxI4flEFKsqY,SpATywNh6bZuzm8s1ceuBUnMUAeoAHHw,6,2,1,0,1,0,3,0,7,1.0,1,0.0,0,1,0,1,2,0,0,3,0,2,5,1
2389,53767,7pxuwoHJlBJIgCUu1Em6p1jZ4AOgWd02,SpATywNh6bZuzm8s1ceuBUnMUAeoAHHw,1,0,0,0,0,0,1,0,1,0.14285714285714285,1,0.0,0,0,0,0,0,0,0,1,0,0,1,1
2390,53775,10a3aPUuiEikOQBzdtiLA8dXlMBNaCqq,SpATywNh6bZuzm8s1ceuBUnMUAeoAHHw,1,0,0,0,0,0,1,0,1,0.14285714285714285,1,0.0,0,0,0,0,0,0,0,1,0,0,1,1
2391,53790,F6SQlqazEZ0w5BjMwjWgS37WY6aKoLpg,SpATywNh6bZuzm8s1ceuBUnMUAeoAHHw,25,42,1,21,1,31,16,1,113,16.142857142857142,1,0.0,10,1,20,1,32,31,1,16,1,32,81,1
2392,53800,j69quqIKpcCSzqXo9ZsaY7H1y4DglvlA,SpATywNh6bZuzm8s1ceuBUnMUAeoAHHw,5,2,1,0,1,1,2,0,7,1.0,1,0.0,0,1,0,1,2,1,0,2,0,2,5,1
2393,53801,JVippbCdijsZvDTgzyPclP2OizOfI7bg,SpATywNh6bZuzm8s1ceuBUnMUAeoAHHw,17,14,7,12,4,1,3,0,41,5.857142857142857,1,0.0,2,7,10,4,12,1,2,3,0,23,18,1
2394,53811,VMIa4tT0g1D8FcJ7AhOiLBIndESbZgIA,A3fsA9Zfv1X2fVEQhTw51lKENdNrEqT3,1,0,0,0,0,0,1,0,1,0.14285714285714285,1,0.0,0,0,0,0,0,0,0,1,0,0,1,1
2395,53813,JfKuoH41ocsNDmphdAQOIFuKNZWqJJwf,SpATywNh6bZuzm8s1ceuBUnMUAeoAHHw,11,10,5,15,0,9,3,0,42,6.0,1,0.0,2,5,14,0,8,9,1,3,0,21,21,1
2396,53815,zSmc8rKmn3W7ClGZoLsZk5lSBVQHeitz,SpATywNh6bZuzm8s1ceuBUnMUAeoAHHw,17,23,1,10,1,0,20,0,55,7.857142857142857,4,0.0,2,1,8,1,21,0,2,20,0,12,43,0
2397,53828,anpgTlAzqtcn1vI43094PZ2LMGoPXQz9,SpATywNh6bZuzm8s1ceuBUnMUAeoAHHw,8,9,4,0,1,12,7,0,33,4.714285714285714,2,0.0,3,4,0,1,6,12,0,7,0,8,25,1
2398,53838,QApdmb1PXR97hGOt28aAXkYQiicNqOKw,SpATywNh6bZuzm8s1ceuBUnMUAeoAHHw,21,30,1,28,1,0,10,1,71,10.142857142857142,2,0.0,7,1,26,1,23,0,2,10,1,35,36,0
2399,53842,tN95ymRxU88OqvEeFVj1h9MemYWUdm2H,A3fsA9Zfv1X2fVEQhTw51lKENdNrEqT3,18,9,8,0,8,0,1,0,26,3.7142857142857144,1,0.0,0,8,0,8,9,0,0,1,0,16,10,1
2400,53849,gSVGAbR6ZoNLN4J93dYtc3hGFE6M7IrZ,SpATywNh6bZuzm8s1ceuBUnMUAeoAHHw,5,2,0,0,0,0,3,0,5,0.7142857142857143,1,0.0,0,0,0,0,2,0,0,3,0,0,5,1
2401,53858,6Upqh8KDtBiZuS1AWTucTCCkEJCPfX5m,SpATywNh6bZuzm8s1ceuBUnMUAeoAHHw,16,41,1,15,1,138,9,0,205,29.285714285714285,3,0.0,16,1,13,1,25,138,2,9,0,31,174,0
2402,53861,Su9COtUoYOdyYjAUoqvAULKdQODTHr7E,bWdj2GDclj5ofokWjzoa5jAwMkxCykd6,26,45,23,140,3,16,21,3,251,35.857142857142854,2,0.0,8,23,133,3,37,16,7,21,3,167,84,0
2403,53875,wgifE6A0kxnDEjw7myKTY39TRuCgYxaB,bWdj2GDclj5ofokWjzoa5jAwMkxCykd6,5,3,2,0,1,0,1,0,7,1.0,1,0.0,0,2,0,1,3,0,0,1,0,3,4,1
2404,53877,cLYelk5eLuqZus5jIOPS82VsEcbwjlHd,SpATywNh6bZuzm8s1ceuBUnMUAeoAHHw,17,26,13,6,8,0,4,0,57,8.142857142857142,1,0.0,8,13,6,8,18,0,0,4,0,35,22,1
2405,53881,nEyHrNWAhCJiBBDbSB6IHu4lz50w5Dy6,A3fsA9Zfv1X2fVEQhTw51lKENdNrEqT3,4,4,2,0,0,0,2,0,8,1.1428571428571428,1,0.0,0,2,0,0,4,0,0,2,0,2,6,1
2406,53895,Y0j1i2gPpBKnJTyvOTxYtV3JtU8UpMcv,SpATywNh6bZuzm8s1ceuBUnMUAeoAHHw,12,17,5,13,0,0,7,3,45,6.428571428571429,1,0.0,4,5,12,0,13,0,1,7,3,21,24,1
2407,53904,SjgqKMmF4tqpvhmgO66D1TdoOxgqcy2V,RXDvfPUBYFlVdlueBFbLW0mhhAyGEqpt,23,32,11,31,9,0,5,0,88,12.571428571428571,2,0.0,11,11,31,9,21,0,0,5,0,62,26,0
2408,53906,nCx7ByTflBYRKyE0yen5MKylk9XOx9rV,A3fsA9Zfv1X2fVEQhTw51lKENdNrEqT3,10,18,9,0,4,0,2,0,33,4.714285714285714,1,0.0,1,9,0,4,17,0,0,2,0,14,19,1
2409,53913,a2z9RsxlqGCqsHimTXs86MGbzWTI57AJ,SpATywNh6bZuzm8s1ceuBUnMUAeoAHHw,11,9,6,5,4,1,2,0,27,3.857142857142857,1,0.0,2,6,4,4,7,1,1,2,0,16,11,1
2410,53917,4S03noH7cjIbR4dHJ5qcypZRCrtfcYb6,bWdj2GDclj5ofokWjzoa5jAwMkxCykd6,1,1,0,0,0,0,0,0,1,0.14285714285714285,1,0.0,0,0,0,0,1,0,0,0,0,0,1,1
2411,53923,hiq4p9Wpf1ENeqXLCQsPukhDTDL2bNA2,RXDvfPUBYFlVdlueBFbLW0mhhAyGEqpt,10,5,3,8,2,4,2,0,24,3.4285714285714284,1,0.0,1,3,8,2,4,4,0,2,0,14,10,0
2412,53939,JUQwyjRts4o299yp6PZYUiNur6LnV5UN,SpATywNh6bZuzm8s1ceuBUnMUAeoAHHw,7,5,1,0,1,0,2,0,9,1.2857142857142858,1,0.0,0,1,0,1,5,0,0,2,0,2,7,1
2413,53947,cL4725Y58Cl01IjeOv5CCdtpjNF0EqJp,SpATywNh6bZuzm8s1ceuBUnMUAeoAHHw,10,9,6,0,3,3,2,0,23,3.2857142857142856,2,0.0,0,6,0,3,9,3,0,2,0,9,14,1
2414,53958,wcSIko8HPcmbs4cOPlImi3EyazICOLlR,bWdj2GDclj5ofokWjzoa5jAwMkxCykd6,2,0,0,0,0,0,9,0,9,1.2857142857142858,4,0.0,0,0,0,0,0,0,0,9,0,0,9,1
2415,53962,HH3HV5HDJ35z2ldQAEIDXBOSBTxLd6O9,bWdj2GDclj5ofokWjzoa5jAwMkxCykd6,9,4,2,0,1,1,9,1,18,2.5714285714285716,2,0.0,0,2,0,1,4,1,0,9,1,3,15,1
2416,53968,561j5AofjwKlXet6wIEWLTESu761wNuJ,SpATywNh6bZuzm8s1ceuBUnMUAeoAHHw,10,12,6,0,3,9,6,1,37,5.285714285714286,1,0.0,0,6,0,3,12,9,0,6,1,9,28,1
2417,53980,f50myi7Wnjd1BWfZdyqaXMcdfMAdeGX9,G8EPVSXsOYB5YQWZGiz1aVq5Pgr2GrQu,32,29,0,69,1,0,12,0,111,15.857142857142858,6,0.0,11,0,56,1,18,0,13,12,0,68,43,0
2418,53983,R48KCTeb8uSJLAUTCApWBwkMVREjjMDW,A3fsA9Zfv1X2fVEQhTw51lKENdNrEqT3,24,5,3,87,0,2,8,1,106,15.142857142857142,1,0.0,1,3,71,0,4,2,16,8,1,75,31,1
2419,53992,srF76iHf3IXwkM0p0daLjk1LYx1sO9QO,A3fsA9Zfv1X2fVEQhTw51lKENdNrEqT3,43,69,4,68,5,1,16,1,164,23.428571428571427,2,0.0,7,4,59,5,62,1,9,16,1,75,89,1
2420,54001,Gglvz7f1jVuISouyvTJRaLDdezGOZ6EL,SpATywNh6bZuzm8s1ceuBUnMUAeoAHHw,18,22,9,14,4,0,5,0,54,7.714285714285714,2,0.0,3,9,13,4,19,0,1,5,0,29,25,0
2421,54002,FHrj4N2SCEsxza13qmFjgJkCjs8BkrF3,bWdj2GDclj5ofokWjzoa5jAwMkxCykd6,15,22,14,40,5,17,15,2,115,16.428571428571427,1,0.0,3,14,37,5,19,17,3,15,2,59,56,1
2422,54009,U2oiAxypJX3TTENRYPio3LHOtQ2XmXGS,SpATywNh6bZuzm8s1ceuBUnMUAeoAHHw,14,13,8,0,3,0,2,0,26,3.7142857142857144,1,0.0,0,8,0,3,13,0,0,2,0,11,15,0
2423,54015,Uo49WNvktWkKOAhlqrqOXLXaeoQpAgrc,SpATywNh6bZuzm8s1ceuBUnMUAeoAHHw,14,17,2,15,2,0,2,0,38,5.428571428571429,2,0.0,8,2,14,2,9,0,1,2,0,26,12,1
2424,54018,dyoINQ9hlelfXhGgA7SokU45MaV6r2b8,SpATywNh6bZuzm8s1ceuBUnMUAeoAHHw,28,20,12,26,7,2,3,0,70,10.0,2,0.0,5,12,21,7,15,2,5,3,0,45,25,0
2425,54023,n7yQ1FvfAXqDnBpszfIUjZkrvw3J2aJC,bWdj2GDclj5ofokWjzoa5jAwMkxCykd6,2,0,0,0,0,0,2,0,2,0.2857142857142857,1,0.0,0,0,0,0,0,0,0,2,0,0,2,1
2426,54026,gw1ywpstRy3gY1kWojp1woauzVM2ZYVr,SpATywNh6bZuzm8s1ceuBUnMUAeoAHHw,14,19,13,0,7,0,4,0,43,6.142857142857143,2,0.0,0,13,0,7,19,0,0,4,0,20,23,0
2427,54027,0S1IMyqlmBJaUdNY6QqTX948M0Vx0tcJ,SpATywNh6bZuzm8s1ceuBUnMUAeoAHHw,13,18,6,0,3,0,3,0,30,4.285714285714286,2,0.0,0,6,0,3,18,0,0,3,0,9,21,1
2428,54029,So8gZ8cXseEZ7lXf4idNMqcN46bXtlIA,SpATywNh6bZuzm8s1ceuBUnMUAeoAHHw,7,4,2,2,0,3,3,0,14,2.0,2,0.0,0,2,2,0,4,3,0,3,0,4,10,0
2429,54048,pXLwXf6zUsqL9SOfZNShdqFixygLJrWR,SpATywNh6bZuzm8s1ceuBUnMUAeoAHHw,7,4,2,0,2,0,2,0,10,1.4285714285714286,1,0.0,1,2,0,2,3,0,0,2,0,5,5,1
2430,54056,HLuhLxGFPt6I9n1CokhbKviDPHHdGO60,G8EPVSXsOYB5YQWZGiz1aVq5Pgr2GrQu,4,2,0,0,0,0,2,0,4,0.5714285714285714,1,0.0,0,0,0,0,2,0,0,2,0,0,4,1
2431,54062,1zcBOliKKVXK419jHsqjZGpz654bIAn5,RXDvfPUBYFlVdlueBFbLW0mhhAyGEqpt,10,7,4,8,2,5,1,0,27,3.857142857142857,1,0.0,2,4,8,2,5,5,0,1,0,16,11,1
2432,54071,vYeGcWGAJP4B8Lvbjdr2jkY9NnpHN8xb,SpATywNh6bZuzm8s1ceuBUnMUAeoAHHw,18,16,11,6,5,0,9,0,47,6.714285714285714,3,0.0,2,11,6,5,14,0,0,9,0,24,23,1
2433,54076,33fwsM5EFqk5KwLRS1Hdk3QGBr5jYWOs,SpATywNh6bZuzm8s1ceuBUnMUAeoAHHw,16,11,7,8,3,5,6,0,40,5.714285714285714,3,0.0,2,7,8,3,9,5,0,6,0,20,20,0
2434,54078,mzJ0trk582dssKvdbvvSr3OyxZiFuQ3P,bWdj2GDclj5ofokWjzoa5jAwMkxCykd6,5,4,2,0,1,0,1,0,8,1.1428571428571428,1,0.0,0,2,0,1,4,0,0,1,0,3,5,1
2435,54079,pJOjDRWW7Xh5i12ZiWoQnz8dZuNP8rXl,SpATywNh6bZuzm8s1ceuBUnMUAeoAHHw,11,18,8,0,5,2,1,0,34,4.857142857142857,1,0.0,2,8,0,5,16,2,0,1,0,15,19,1
2436,54082,4LX6gYDKcYMBLDa9yuezfCQG1GKo9eu8,SpATywNh6bZuzm8s1ceuBUnMUAeoAHHw,5,8,0,0,0,0,7,0,15,2.142857142857143,1,0.0,0,0,0,0,8,0,0,7,0,0,15,1
2437,54083,QYVRHTpooyTkzSbIywJ7ri5o4t73Xwty,RXDvfPUBYFlVdlueBFbLW0mhhAyGEqpt,1,0,0,0,0,0,1,0,1,0.14285714285714285,1,0.0,0,0,0,0,0,0,0,1,0,0,1,1
2438,54085,BQCssLSYZBRoNs0A82WS0r6vRVhdQKvg,SpATywNh6bZuzm8s1ceuBUnMUAeoAHHw,9,6,4,0,2,0,3,0,15,2.142857142857143,1,0.0,0,4,0,2,6,0,0,3,0,6,9,1
2439,54088,7Xq01ZEcLJ8EiJEfAlByyafLSPE4vuef,SpATywNh6bZuzm8s1ceuBUnMUAeoAHHw,5,3,2,0,0,0,2,0,7,1.0,1,0.0,0,2,0,0,3,0,0,2,0,2,5,1
2440,54094,Fdt86Xu5OLPdaOgl6M1XDpiJ3zar7SU6,SpATywNh6bZuzm8s1ceuBUnMUAeoAHHw,15,18,1,19,0,0,7,2,47,6.714285714285714,2,0.0,7,1,15,0,11,0,4,7,2,23,24,0
2441,54103,uEA5Un9wAGiDxjEkoYiTUGhoxCFEEvwr,SpATywNh6bZuzm8s1ceuBUnMUAeoAHHw,1,0,0,0,0,0,1,0,1,0.14285714285714285,1,0.0,0,0,0,0,0,0,0,1,0,0,1,1
2442,54113,Dpj1ute7yeokptEET2ZfYuubDiXNwLXm,A3fsA9Zfv1X2fVEQhTw51lKENdNrEqT3,7,4,3,0,2,0,1,0,10,1.4285714285714286,1,0.0,0,3,0,2,4,0,0,1,0,5,5,1
2443,54121,nVNeaHavpiSEFe567sT2ScRxObLjhEGL,G8EPVSXsOYB5YQWZGiz1aVq5Pgr2GrQu,22,13,8,104,1,1,4,0,131,18.714285714285715,2,0.0,0,8,89,1,13,1,15,4,0,98,33,1
2444,54123,b5xbU8SGcZEvpqzyP6Qk6welzZOUxOvx,A3fsA9Zfv1X2fVEQhTw51lKENdNrEqT3,6,4,1,0,1,0,1,0,7,1.0,1,0.0,0,1,0,1,4,0,0,1,0,2,5,1
2445,54129,qKOvjGeHnXAGhScloNy1qhNnfc1xHZ3T,SpATywNh6bZuzm8s1ceuBUnMUAeoAHHw,15,50,1,12,1,16,9,0,89,12.714285714285714,3,0.0,12,1,9,1,38,16,3,9,0,23,66,0
2446,54132,PfTpx7WgTJY6IpNokJ2POml34GMs7LTI,bWdj2GDclj5ofokWjzoa5jAwMkxCykd6,23,7,4,40,2,0,5,0,58,8.285714285714286,1,0.0,2,4,37,2,5,0,3,5,0,45,13,0
2447,54133,jU9n6p1KRt3F2eM3pIcFgt7azc85bbxP,SpATywNh6bZuzm8s1ceuBUnMUAeoAHHw,11,8,6,0,4,0,4,0,22,3.142857142857143,2,0.0,0,6,0,4,8,0,0,4,0,10,12,1
2448,54134,BtB75B9l8XyH0uPaKeOkkRrm2NqBrtQe,A3fsA9Zfv1X2fVEQhTw51lKENdNrEqT3,1,0,0,0,0,0,1,0,1,0.14285714285714285,1,0.0,0,0,0,0,0,0,0,1,0,0,1,1
2449,54137,kdSq236IYQMsCu2OjWxBROoAPTYOBg4Z,A3fsA9Zfv1X2fVEQhTw51lKENdNrEqT3,1,0,0,0,0,0,1,0,1,0.14285714285714285,1,0.0,0,0,0,0,0,0,0,1,0,0,1,1
2450,54138,cZ43eywkms9yBmvkdibtxlcZqrcdFmmE,SpATywNh6bZuzm8s1ceuBUnMUAeoAHHw,5,3,2,0,0,0,2,0,7,1.0,1,0.0,0,2,0,0,3,0,0,2,0,2,5,1
2451,54140,2Bc3e8bWl6DTvfTPBZCyShFFG8OApkva,A3fsA9Zfv1X2fVEQhTw51lKENdNrEqT3,6,6,3,0,1,0,1,0,11,1.5714285714285714,1,0.0,0,3,0,1,6,0,0,1,0,4,7,1
2452,54144,oEOiBLMr97GK8O9ympHG9NMLQODJ0Xam,bWdj2GDclj5ofokWjzoa5jAwMkxCykd6,1,0,0,0,0,0,1,0,1,0.14285714285714285,1,0.0,0,0,0,0,0,0,0,1,0,0,1,1
2453,54145,uL6960SAwN5kJgcsaw9m5ztApNeZFO95,A3fsA9Zfv1X2fVEQhTw51lKENdNrEqT3,36,20,15,56,8,0,7,0,106,15.142857142857142,1,0.0,2,15,50,8,18,0,6,7,0,75,31,1
2454,54149,oEOiBLMr97GK8O9ympHG9NMLQODJ0Xam,SpATywNh6bZuzm8s1ceuBUnMUAeoAHHw,1,0,0,0,0,0,1,0,1,0.14285714285714285,1,0.0,0,0,0,0,0,0,0,1,0,0,1,1
2455,54153,1rAHmNrxrqnzHEQFMlydmQ968LsZW0oG,A3fsA9Zfv1X2fVEQhTw51lKENdNrEqT3,16,12,9,0,5,0,4,0,30,4.285714285714286,2,0.0,0,9,0,5,12,0,0,4,0,14,16,1
2456,54176,i2jPckJdA9hhx8KLohXM0CrojRerYpdv,SpATywNh6bZuzm8s1ceuBUnMUAeoAHHw,20,30,15,24,6,2,6,0,83,11.857142857142858,2,0.0,10,15,18,6,20,2,6,6,0,49,34,0
2457,54185,0fPKzumQAfSwGfxF7d6bvXWcsMGpFXOP,SpATywNh6bZuzm8s1ceuBUnMUAeoAHHw,30,42,17,28,9,5,7,2,110,15.714285714285714,4,0.0,7,17,26,9,35,5,2,7,2,59,51,0
2458,54199,yhj9ME5eIWuvrbwWqT7KNKtjeY6yuvxW,A3fsA9Zfv1X2fVEQhTw51lKENdNrEqT3,4,0,0,0,0,1,4,2,7,1.0,1,0.0,0,0,0,0,0,1,0,4,2,0,7,1
2459,54226,l3sfUHhSnAdS6GAthlSM3lKuUCRdk9CZ,A3fsA9Zfv1X2fVEQhTw51lKENdNrEqT3,17,11,6,62,0,0,3,0,82,11.714285714285714,1,0.0,2,6,48,0,9,0,14,3,0,56,26,1
2460,54231,o6TNCL8FasDR1iE3PXeICx9M4vKCc0T1,bWdj2GDclj5ofokWjzoa5jAwMkxCykd6,6,1,1,0,1,0,5,0,8,1.1428571428571428,2,0.0,0,1,0,1,1,0,0,5,0,2,6,1
2461,54233,o6TNCL8FasDR1iE3PXeICx9M4vKCc0T1,A3fsA9Zfv1X2fVEQhTw51lKENdNrEqT3,1,0,0,0,0,0,1,0,1,0.14285714285714285,1,0.0,0,0,0,0,0,0,0,1,0,0,1,1
2462,54238,V9HQPxlLSz0QiOl8p8UTUo6CstrlztcH,SpATywNh6bZuzm8s1ceuBUnMUAeoAHHw,4,2,0,0,0,0,2,0,4,0.5714285714285714,1,0.0,0,0,0,0,2,0,0,2,0,0,4,1
2463,54285,Io3VzTK6sP3a0ZVRKkRhFNz8A2ULjris,bWdj2GDclj5ofokWjzoa5jAwMkxCykd6,2,0,0,0,0,0,3,0,3,0.42857142857142855,1,0.0,0,0,0,0,0,0,0,3,0,0,3,1
2464,54287,kuiW3Le0WeMGiwxmKgXwp1GfHw3vKMeq,SpATywNh6bZuzm8s1ceuBUnMUAeoAHHw,2,1,1,0,0,0,0,0,2,0.2857142857142857,1,0.0,0,1,0,0,1,0,0,0,0,1,1,1
2465,54306,pQnR1td8vlxsKseVpfzZVvCBdR2iP4U6,A3fsA9Zfv1X2fVEQhTw51lKENdNrEqT3,4,2,1,0,0,0,5,0,8,1.1428571428571428,1,0.0,0,1,0,0,2,0,0,5,0,1,7,0
2466,54312,np300nKbgkFp0EFcdJyIdPu3KUkiYdwY,G8EPVSXsOYB5YQWZGiz1aVq5Pgr2GrQu,6,4,1,0,1,0,2,0,8,1.1428571428571428,1,0.0,0,1,0,1,4,0,0,2,0,2,6,1
2467,54316,64OeQzK990rz5QNrMOQujVxWZWc38bZL,SpATywNh6bZuzm8s1ceuBUnMUAeoAHHw,17,11,7,11,4,0,3,0,36,5.142857142857143,2,0.0,2,7,11,4,9,0,0,3,0,24,12,1
2468,54321,qgHNkIIeFGRC3Bav4KufUnqlMzkDetSU,bWdj2GDclj5ofokWjzoa5jAwMkxCykd6,5,4,2,0,0,0,1,0,7,1.0,1,0.0,0,2,0,0,4,0,0,1,0,2,5,0
2469,54341,bJm6vpekKjS0vCZZW0loTWMZ3NWdcX0T,SpATywNh6bZuzm8s1ceuBUnMUAeoAHHw,1,0,0,0,0,0,1,0,1,0.14285714285714285,1,0.0,0,0,0,0,0,0,0,1,0,0,1,1
2470,54344,M7Vbw5q1oL32IfEMSI9AM5uHCUMDFHmm,bWdj2GDclj5ofokWjzoa5jAwMkxCykd6,1,0,0,0,0,0,1,0,1,0.14285714285714285,1,0.0,0,0,0,0,0,0,0,1,0,0,1,1
2471,54345,7P3XgLwfwlFBQozc5Gty8UBmzZ1wk3nf,bWdj2GDclj5ofokWjzoa5jAwMkxCykd6,3,5,1,0,1,0,1,0,8,1.1428571428571428,1,0.0,3,1,0,1,2,0,0,1,0,5,3,1
2472,54352,pQnR1td8vlxsKseVpfzZVvCBdR2iP4U6,RXDvfPUBYFlVdlueBFbLW0mhhAyGEqpt,5,2,1,0,1,0,2,0,6,0.8571428571428571,1,0.0,0,1,0,1,2,0,0,2,0,2,4,1
2473,54378,wykDdjB45pC3zZUNNLpkNXDJGEatsGFp,SpATywNh6bZuzm8s1ceuBUnMUAeoAHHw,1,0,0,0,0,0,1,0,1,0.14285714285714285,1,0.0,0,0,0,0,0,0,0,1,0,0,1,1
2474,54389,Dpj1ute7yeokptEET2ZfYuubDiXNwLXm,SpATywNh6bZuzm8s1ceuBUnMUAeoAHHw,9,6,4,0,3,0,1,0,14,2.0,1,0.0,0,4,0,3,6,0,0,1,0,7,7,1
2475,54391,6GW7T2KXNaFy6SJDNV3BLn1vYIvac4zq,bWdj2GDclj5ofokWjzoa5jAwMkxCykd6,1,0,0,0,0,0,1,0,1,0.14285714285714285,1,0.0,0,0,0,0,0,0,0,1,0,0,1,1
2476,54398,lg3JWapmXZgNYOt38qBO2QsZMUBFS5SJ,G8EPVSXsOYB5YQWZGiz1aVq5Pgr2GrQu,72,74,26,170,19,9,6,1,305,43.57142857142857,2,0.0,43,26,128,19,31,9,42,6,1,216,89,0
2477,54399,6GW7T2KXNaFy6SJDNV3BLn1vYIvac4zq,A3fsA9Zfv1X2fVEQhTw51lKENdNrEqT3,21,16,12,0,11,0,1,0,40,5.714285714285714,1,0.0,1,12,0,11,15,0,0,1,0,24,16,1
2478,54411,UZrNs5yPvW1ZVC8d6wdut2Js7XUvysRH,SpATywNh6bZuzm8s1ceuBUnMUAeoAHHw,16,9,7,13,4,12,3,1,49,7.0,2,0.0,2,7,13,4,7,12,0,3,1,26,23,1
2479,54419,H4rucA3Bl92feiIFqEyA7i9inMfODBCx,SpATywNh6bZuzm8s1ceuBUnMUAeoAHHw,4,2,0,0,0,0,3,0,5,0.7142857142857143,1,0.0,0,0,0,0,2,0,0,3,0,0,5,0
2480,54447,6A2JLpLWnCwUlo9pD1HHlgEwNLvzcllv,A3fsA9Zfv1X2fVEQhTw51lKENdNrEqT3,16,14,9,12,4,0,3,0,42,6.0,2,0.0,1,9,10,4,13,0,2,3,0,24,18,1
2481,54458,w8ymvO72UlYPBd2tG0A8iTEwt4UoIvlZ,A3fsA9Zfv1X2fVEQhTw51lKENdNrEqT3,40,26,18,50,12,0,4,0,110,15.714285714285714,2,0.0,3,18,50,12,23,0,0,4,0,83,27,1
2482,54467,Ha2E1KX6VBrxAJ0Y64ONsTCt1RbrAdiK,SpATywNh6bZuzm8s1ceuBUnMUAeoAHHw,8,5,4,0,2,0,1,0,12,1.7142857142857142,1,0.0,0,4,0,2,5,0,0,1,0,6,6,0
2483,54485,bbBKqbJ74sqbqRiQHsLpyapFJxr2Z728,SpATywNh6bZuzm8s1ceuBUnMUAeoAHHw,12,27,8,13,2,0,1,0,51,7.285714285714286,1,0.0,18,8,11,2,9,0,2,1,0,39,12,1
2484,54509,HPaDTzk2xymxbpoa0VdcxdHl3uFfOfZk,bWdj2GDclj5ofokWjzoa5jAwMkxCykd6,5,0,0,0,0,1,10,1,12,1.7142857142857142,2,0.0,0,0,0,0,0,1,0,10,1,0,12,1
2485,54512,x6BtQH70uuLHaxqzHA21U9wmfT0SxzD9,SpATywNh6bZuzm8s1ceuBUnMUAeoAHHw,20,22,6,12,4,21,17,2,84,12.0,4,0.0,8,6,10,4,14,21,2,17,2,28,56,0
2486,54514,Xq1kPqflDNgXwQ2pEniNYUjMpkVzPp1m,bWdj2GDclj5ofokWjzoa5jAwMkxCykd6,5,8,3,0,0,0,2,0,13,1.8571428571428572,2,0.0,0,3,0,0,8,0,0,2,0,3,10,1
2487,54516,bYSbXmkovrv6ucz58VC2SSCMvEjrNo7x,SpATywNh6bZuzm8s1ceuBUnMUAeoAHHw,1,0,0,0,0,0,1,0,1,0.14285714285714285,1,0.0,0,0,0,0,0,0,0,1,0,0,1,1
2488,54518,CE7hlTWnMpoldcHVRqlfbEgzp5iUVo4d,SpATywNh6bZuzm8s1ceuBUnMUAeoAHHw,13,15,7,0,3,0,2,0,27,3.857142857142857,1,0.0,7,7,0,3,8,0,0,2,0,17,10,0
2489,54524,CxUPOQRaQMGLmbOcfniIQOhh24PXLDR6,bWdj2GDclj5ofokWjzoa5jAwMkxCykd6,2,1,1,0,0,0,0,0,2,0.2857142857142857,1,0.0,0,1,0,0,1,0,0,0,0,1,1,0
2490,54528,MXVve1Eg6sXSXHh1Skrb0tjPJ9Wtb0M7,SpATywNh6bZuzm8s1ceuBUnMUAeoAHHw,2,0,0,0,0,0,3,0,3,0.42857142857142855,1,0.0,0,0,0,0,0,0,0,3,0,0,3,1
2491,54544,CF0PQ9PBY5Y16Xk8e9CdQNNLQnwOLSsu,bWdj2GDclj5ofokWjzoa5jAwMkxCykd6,7,9,1,0,2,0,4,0,16,2.2857142857142856,1,0.0,3,1,0,2,6,0,0,4,0,6,10,1
2492,54554,7kbuqNU54d8d11QmdSpTGAMhLhmSDka1,SpATywNh6bZuzm8s1ceuBUnMUAeoAHHw,9,6,2,2,0,0,5,0,15,2.142857142857143,1,0.0,1,2,2,0,5,0,0,5,0,5,10,1
2493,54555,7kbuqNU54d8d11QmdSpTGAMhLhmSDka1,G8EPVSXsOYB5YQWZGiz1aVq5Pgr2GrQu,13,13,4,0,2,0,5,0,24,3.4285714285714284,1,0.0,6,4,0,2,7,0,0,5,0,12,12,1
2494,54558,jtxvuHBV8ZOgNnNCL1A1WerzR2TVfFNy,RXDvfPUBYFlVdlueBFbLW0mhhAyGEqpt,30,30,20,43,5,0,5,0,103,14.714285714285714,2,0.0,4,20,42,5,26,0,1,5,0,71,32,1
2495,54568,fUMqQuy71n3a3vBlGt3GhPdNsIerKaNG,SpATywNh6bZuzm8s1ceuBUnMUAeoAHHw,8,9,7,0,0,0,1,0,17,2.4285714285714284,1,0.0,1,7,0,0,8,0,0,1,0,8,9,1
2496,54581,MF9uYxE1fYdj67HROuwgGArAcww4zZp4,bWdj2GDclj5ofokWjzoa5jAwMkxCykd6,1,0,0,0,0,0,1,0,1,0.14285714285714285,1,0.0,0,0,0,0,0,0,0,1,0,0,1,1
2497,54595,jMSxxfftYD0taGWVEUZkcvxpGucC0j8q,fbPkOYLVPtPgIt0MxizjfFJov3JbHyAi,4,5,3,0,0,0,1,0,9,1.2857142857142858,1,0.0,0,3,0,0,5,0,0,1,0,3,6,1
2498,54616,cgTRAnMuMn887xEhHTcg5rpmYHHPoyIP,fbPkOYLVPtPgIt0MxizjfFJov3JbHyAi,22,41,16,13,14,13,3,0,100,14.285714285714286,2,0.0,22,16,13,14,19,13,0,3,0,65,35,0
2499,54723,z5Ulo2w0cg5OjY2Cx9aYoywDQvm6hLIF,RXDvfPUBYFlVdlueBFbLW0mhhAyGEqpt,9,7,7,0,3,0,0,0,17,2.4285714285714284,2,0.0,0,7,0,3,7,0,0,0,0,10,7,0
2500,54724,XfiCSk5eLAbq9rzQtnLkX2OQTd6M8xFG,bWdj2GDclj5ofokWjzoa5jAwMkxCykd6,23,30,20,20,11,0,15,0,96,13.714285714285714,3,0.0,4,20,20,11,26,0,0,15,0,55,41,0
2501,54823,NNTbkWufZqd6OEZ4OfeDtmQCNI4vEzJo,A3fsA9Zfv1X2fVEQhTw51lKENdNrEqT3,2,0,0,0,0,0,2,0,2,0.2857142857142857,1,0.0,0,0,0,0,0,0,0,2,0,0,2,1
2502,54871,H2pnCC5fUi5Ho09aPqAE97vnlsM8FGBU,bWdj2GDclj5ofokWjzoa5jAwMkxCykd6,8,5,3,6,2,0,1,0,17,2.4285714285714284,1,0.0,0,3,6,2,5,0,0,1,0,11,6,1
2503,54876,tVqiyi20xeAPqMyQ1qSspr9PuF7fr80u,SpATywNh6bZuzm8s1ceuBUnMUAeoAHHw,9,6,4,0,3,1,4,0,18,2.5714285714285716,1,0.0,0,4,0,3,6,1,0,4,0,7,11,1
2504,54879,bT6yH99PTuyz3a6ueCehCDHIMjMdNYHB,SpATywNh6bZuzm8s1ceuBUnMUAeoAHHw,6,4,3,0,1,0,1,0,9,1.2857142857142858,1,0.0,0,3,0,1,4,0,0,1,0,4,5,1
2505,54937,o076ufFxYjFcAtg8dPv0W5vwk5oKbSiz,SpATywNh6bZuzm8s1ceuBUnMUAeoAHHw,6,4,3,0,1,0,1,0,9,1.2857142857142858,1,0.0,0,3,0,1,4,0,0,1,0,4,5,1
2506,54942,ijpfz5cJPrusRBczJIwOiwlUzdR9aysy,SpATywNh6bZuzm8s1ceuBUnMUAeoAHHw,1,0,0,0,0,0,1,0,1,0.14285714285714285,1,0.0,0,0,0,0,0,0,0,1,0,0,1,0
2507,54973,KIPXc8MOqmnlmMqnIzIeaBqliIw9pS44,A3fsA9Zfv1X2fVEQhTw51lKENdNrEqT3,13,13,9,0,5,0,4,0,31,4.428571428571429,2,0.0,0,9,0,5,13,0,0,4,0,14,17,1
2508,54989,DUw85TcNpxyZaZKIM1HlHxvgtSm7uwxY,A3fsA9Zfv1X2fVEQhTw51lKENdNrEqT3,1,0,0,0,0,0,1,0,1,0.14285714285714285,1,0.0,0,0,0,0,0,0,0,1,0,0,1,1
2509,55039,0Au7FrQGJI1dB5PAH0C5RtkL9GE7xsrQ,SpATywNh6bZuzm8s1ceuBUnMUAeoAHHw,4,2,0,0,0,0,3,0,5,0.7142857142857143,2,0.0,0,0,0,0,2,0,0,3,0,0,5,1
2510,55346,7bnGjPq4sg9VhmEEoEqqXHNgeEpEuUDV,SpATywNh6bZuzm8s1ceuBUnMUAeoAHHw,5,4,2,0,1,0,1,0,8,1.1428571428571428,1,0.0,0,2,0,1,4,0,0,1,0,3,5,0
2511,55358,eeotL07J3Y8VeL6DbnIqkm9FhuiNkg7O,SpATywNh6bZuzm8s1ceuBUnMUAeoAHHw,19,19,10,0,6,2,6,1,44,6.285714285714286,2,0.0,7,10,0,6,12,2,0,6,1,23,21,0
2512,55483,C4q4gNQYEpjKh7pq1qjN8i3L7uSpUX9d,A3fsA9Zfv1X2fVEQhTw51lKENdNrEqT3,3,2,1,0,0,0,2,0,5,0.7142857142857143,1,0.0,0,1,0,0,2,0,0,2,0,1,4,0
2513,55511,g1maG24WsPdpEOMuZUsxQc7SlEYHJjT4,SpATywNh6bZuzm8s1ceuBUnMUAeoAHHw,12,21,10,0,4,0,4,0,39,5.571428571428571,1,0.0,6,10,0,4,15,0,0,4,0,20,19,1
2514,55516,lgS8T7X8MPl4rnyyVo63W82KpUI1LtmK,SpATywNh6bZuzm8s1ceuBUnMUAeoAHHw,4,2,1,0,0,0,2,0,5,0.7142857142857143,1,0.0,0,1,0,0,2,0,0,2,0,1,4,1
2515,55557,FELnhQR0c7GZZX82ioYJEZsqujOrfyf7,SpATywNh6bZuzm8s1ceuBUnMUAeoAHHw,3,2,1,0,0,2,2,0,7,1.0,1,0.0,0,1,0,0,2,2,0,2,0,1,6,1
2516,55593,9t2KBUQ5GiAw5lDqGOd0BuKNW0LVvTVG,bWdj2GDclj5ofokWjzoa5jAwMkxCykd6,15,26,16,24,3,12,4,0,85,12.142857142857142,1,0.0,3,16,21,3,23,12,3,4,0,43,42,0
2517,55667,8ZhpSkXuKXWxDMEbryu3zVTkh7o5swmt,SpATywNh6bZuzm8s1ceuBUnMUAeoAHHw,8,5,0,6,0,5,5,0,21,3.0,1,0.0,2,0,6,0,3,5,0,5,0,8,13,1
2518,55699,HFO33lcsFKBDjSdg8KE5lGTCABOqytNM,RXDvfPUBYFlVdlueBFbLW0mhhAyGEqpt,37,45,12,108,17,1,2,0,185,26.428571428571427,1,0.0,31,12,92,17,14,1,16,2,0,152,33,0
2519,55734,JwzCuKRnJiCboJiRTMovpzJhdCfcNETm,bWdj2GDclj5ofokWjzoa5jAwMkxCykd6,4,2,0,0,0,0,2,0,4,0.5714285714285714,1,0.0,0,0,0,0,2,0,0,2,0,0,4,1
2520,55773,mKWCTH01KzkLjFgXaCUEfs0dLu17r2jM,SpATywNh6bZuzm8s1ceuBUnMUAeoAHHw,3,2,1,0,0,0,1,0,4,0.5714285714285714,1,0.0,0,1,0,0,2,0,0,1,0,1,3,0
2521,55780,i5WDkhlf7rrVPmbQxsFTG1gowMYshvKj,bWdj2GDclj5ofokWjzoa5jAwMkxCykd6,7,8,3,0,2,2,2,0,17,2.4285714285714284,1,0.0,4,3,0,2,4,2,0,2,0,9,8,1
2522,55865,ZEHkvN1JnR5aRFAd5UGefALeV7OHXWFP,7GRhBDsirIGkRZBtSMEzNTyDr2JQm4xx,15,38,16,12,0,10,7,1,84,12.0,1,0.0,15,16,11,0,23,10,1,7,1,42,42,1
2523,55877,GPe5tDvCMFa0yvoGbU7FbSxYbtu5eayz,SpATywNh6bZuzm8s1ceuBUnMUAeoAHHw,8,7,4,0,2,0,2,0,15,2.142857142857143,2,0.0,0,4,0,2,7,0,0,2,0,6,9,0
2524,55948,fOZTYKShrDEPywLsvnOq8r6y0esJP04d,G8EPVSXsOYB5YQWZGiz1aVq5Pgr2GrQu,33,36,19,40,9,34,10,1,149,21.285714285714285,2,0.0,12,19,33,9,24,34,7,10,1,73,76,0
2525,56002,aX8XTxJBQE99ErDnzZHdMXoXH5wjXDSz,SpATywNh6bZuzm8s1ceuBUnMUAeoAHHw,6,5,3,0,1,0,3,0,12,1.7142857142857142,1,0.0,0,3,0,1,5,0,0,3,0,4,8,1
2526,56010,hJo1MgKiPZFXuH2ko6hqPTd9dbjMQKDO,A3fsA9Zfv1X2fVEQhTw51lKENdNrEqT3,3,2,0,0,0,0,1,0,3,0.42857142857142855,1,0.0,0,0,0,0,2,0,0,1,0,0,3,0
2527,56040,420Gm2AWh0nImDTapBba1KojOp3noScY,SpATywNh6bZuzm8s1ceuBUnMUAeoAHHw,16,16,1,18,1,0,4,0,40,5.714285714285714,2,0.0,2,1,15,1,14,0,3,4,0,19,21,0
2528,56202,xbYSqp0T7Uu69VoCNyfTCvQcS3HV3UeU,SpATywNh6bZuzm8s1ceuBUnMUAeoAHHw,4,3,2,0,0,0,1,0,6,0.8571428571428571,1,0.0,0,2,0,0,3,0,0,1,0,2,4,1
2529,56215,J3FKLxbUlPTor4lyG8lMpHc8oUQEjfcp,SpATywNh6bZuzm8s1ceuBUnMUAeoAHHw,2,0,0,0,0,0,2,0,2,0.2857142857142857,1,0.0,0,0,0,0,0,0,0,2,0,0,2,0
2530,56307,1GmUBgbH4qyfafNMJ2VdhisOaMrOQzrs,A3fsA9Zfv1X2fVEQhTw51lKENdNrEqT3,2,0,0,0,0,0,2,0,2,0.2857142857142857,1,0.0,0,0,0,0,0,0,0,2,0,0,2,1
2531,56321,YQloiHp4EDEAnQ7UnBm1Re3dyFVVFj8Z,SpATywNh6bZuzm8s1ceuBUnMUAeoAHHw,3,4,1,0,0,0,2,0,7,1.0,1,0.0,0,1,0,0,4,0,0,2,0,1,6,0
2532,56333,CwAitLaYuWheNSIoTgEZfJ56lAJf0HG8,7GRhBDsirIGkRZBtSMEzNTyDr2JQm4xx,14,13,4,18,3,0,1,0,39,5.571428571428571,1,0.0,10,4,16,3,3,0,2,1,0,33,6,1
2533,56398,aGbKep26uuguTzwAUYDcwjqS1RQNroF5,SpATywNh6bZuzm8s1ceuBUnMUAeoAHHw,16,14,6,14,4,0,3,0,41,5.857142857142857,2,0.0,4,6,14,4,10,0,0,3,0,28,13,1
2534,56418,1yk3ITtkCTeBgpvC46EyEEfYcyKWD7Qc,SpATywNh6bZuzm8s1ceuBUnMUAeoAHHw,20,11,8,12,4,1,4,1,41,5.857142857142857,1,0.0,2,8,11,4,9,1,1,4,1,25,16,0
2535,56477,g5ozjvUCdaFJGkcIZvHKw5OmNcDvdyli,G8EPVSXsOYB5YQWZGiz1aVq5Pgr2GrQu,9,11,3,12,1,0,2,0,29,4.142857142857143,1,0.0,6,3,7,1,5,0,5,2,0,17,12,1
2536,56490,kqS8BwWN9R1093oeblGkvtCsQJ68Gh0G,SpATywNh6bZuzm8s1ceuBUnMUAeoAHHw,18,28,12,16,5,0,6,0,67,9.571428571428571,4,0.0,5,12,14,5,23,0,2,6,0,36,31,0
2537,56501,AxlfZzXkXnhJLfyjxNARPh8wNlmuerJT,SpATywNh6bZuzm8s1ceuBUnMUAeoAHHw,6,6,2,0,1,0,4,0,13,1.8571428571428572,1,0.0,0,2,0,1,6,0,0,4,0,3,10,0
2538,56514,57DmCkxeT4CodU6tDrBCDXqGpXQ0D1sF,A3fsA9Zfv1X2fVEQhTw51lKENdNrEqT3,52,58,2,168,0,13,2,0,243,34.714285714285715,1,0.0,5,2,136,0,53,13,32,2,0,143,100,0
2539,56615,ktKfaRtFOnFJdZMcfSCqSP14OG6TxlMY,SpATywNh6bZuzm8s1ceuBUnMUAeoAHHw,13,22,0,14,0,0,3,0,39,5.571428571428571,2,0.0,4,0,14,0,18,0,0,3,0,18,21,0
2540,56725,Bxz1zTHFCCx9o1kJA9B0Pzm3PnmqKxr5,SpATywNh6bZuzm8s1ceuBUnMUAeoAHHw,4,5,5,0,1,0,0,0,11,1.5714285714285714,3,0.0,0,5,0,1,5,0,0,0,0,6,5,1
2541,56736,csg0yBjjrshmLGGyq6UVgiiqMZP9T0vI,A3fsA9Zfv1X2fVEQhTw51lKENdNrEqT3,2,0,0,0,0,0,2,0,2,0.2857142857142857,1,0.0,0,0,0,0,0,0,0,2,0,0,2,1
2542,56791,1G2HPMj7bCJEDZxxbF8ae2kPQCHvH8vB,bWdj2GDclj5ofokWjzoa5jAwMkxCykd6,10,13,8,0,3,1,12,8,45,6.428571428571429,1,0.0,0,8,0,3,13,1,0,12,8,11,34,1
2543,56864,y64BqR5f4fJBfwxF4aLt14ViHkvnjGLs,A3fsA9Zfv1X2fVEQhTw51lKENdNrEqT3,15,17,8,0,4,0,11,0,40,5.714285714285714,2,0.0,0,8,0,4,17,0,0,11,0,12,28,1
2544,56956,6iOLSqRTRABETCaDgzA6NufDV3dLbSSl,bWdj2GDclj5ofokWjzoa5jAwMkxCykd6,33,23,15,102,7,9,16,0,172,24.571428571428573,3,0.0,5,15,89,7,18,9,13,16,0,116,56,1
2545,57017,RVthfCRYYRCiFRx3Qkq6vL0caXa3Y6XL,SpATywNh6bZuzm8s1ceuBUnMUAeoAHHw,13,10,2,28,0,2,13,1,56,8.0,1,0.0,8,2,26,0,2,2,2,13,1,36,20,0
2546,57051,I7IIrHAh1LzzCf8lcvI92o8deFulzAh8,A3fsA9Zfv1X2fVEQhTw51lKENdNrEqT3,1,0,0,0,0,0,1,0,1,0.14285714285714285,1,0.0,0,0,0,0,0,0,0,1,0,0,1,1
2547,57116,FeZn6c6vb5R5SPZtACtqOXKJC1inbsZN,SpATywNh6bZuzm8s1ceuBUnMUAeoAHHw,21,21,2,20,3,1,6,0,53,7.571428571428571,2,0.0,4,2,16,3,17,1,4,6,0,25,28,0
2548,57193,v6sJocXlJFeoDG1nXrmoTeUih19304GZ,SpATywNh6bZuzm8s1ceuBUnMUAeoAHHw,5,3,1,0,1,0,1,0,6,0.8571428571428571,1,0.0,0,1,0,1,3,0,0,1,0,2,4,1
2549,57213,iSYj2oDe5RyCcvKGOIlJlpq8H0342az5,SpATywNh6bZuzm8s1ceuBUnMUAeoAHHw,15,12,10,5,9,1,10,1,48,6.857142857142857,1,0.0,1,10,4,9,11,1,1,10,1,24,24,1
2550,57274,a91ewPLjlp1X8KqwrnZISs7xgERRXuh7,SpATywNh6bZuzm8s1ceuBUnMUAeoAHHw,12,23,15,0,4,0,5,0,47,6.714285714285714,2,0.0,0,15,0,4,23,0,0,5,0,19,28,0
2551,57289,JfftjOGdDbpgbrupi0Gwr899R0jzXikJ,SpATywNh6bZuzm8s1ceuBUnMUAeoAHHw,18,32,14,5,4,0,10,0,65,9.285714285714286,4,0.0,7,14,5,4,25,0,0,10,0,30,35,0
2552,57310,amNosdi6Uiilljdy8esSBA3F29NKPLUW,A3fsA9Zfv1X2fVEQhTw51lKENdNrEqT3,7,7,4,0,0,0,8,0,19,2.7142857142857144,2,0.0,0,4,0,0,7,0,0,8,0,4,15,1
2553,57362,VrrBciftY2IctWxZzgYOD4l9QhmKgryv,SpATywNh6bZuzm8s1ceuBUnMUAeoAHHw,27,29,20,18,10,1,5,0,83,11.857142857142858,3,0.0,5,20,16,10,24,1,2,5,0,51,32,0
2554,57385,XJf8gYhDJm1hrkVJvLQ4HKEnvPd3mIMq,SpATywNh6bZuzm8s1ceuBUnMUAeoAHHw,11,9,0,9,0,0,1,0,19,2.7142857142857144,1,0.0,2,0,9,0,7,0,0,1,0,11,8,0
2555,57477,5OgjW4RBhSCbfYx5XYwPp5mVp3N7l8JT,SpATywNh6bZuzm8s1ceuBUnMUAeoAHHw,4,3,2,0,0,0,1,0,6,0.8571428571428571,1,0.0,0,2,0,0,3,0,0,1,0,2,4,1
2556,57617,NVzsLV2hJQHxCBnLyaDpT9HrhRSWUOfa,RXDvfPUBYFlVdlueBFbLW0mhhAyGEqpt,21,13,1,32,0,0,4,1,51,7.285714285714286,1,0.0,4,1,30,0,9,0,2,4,1,35,16,1
2557,57636,D5gDQ8hFb4klemeBiodWmMPe9KIvqw9O,A3fsA9Zfv1X2fVEQhTw51lKENdNrEqT3,18,23,1,12,0,0,1,0,37,5.285714285714286,1,0.0,1,1,9,0,22,0,3,1,0,11,26,1
2558,57656,Y3ZpN8DOQK8YTfD0eUtklxiZfpWuBIeU,SpATywNh6bZuzm8s1ceuBUnMUAeoAHHw,21,18,9,12,5,2,5,0,51,7.285714285714286,1,0.0,7,9,12,5,11,2,0,5,0,33,18,0
2559,58064,rtg3Ki4vk14kI9MkEBE0pkOCAO2AnCnU,A3fsA9Zfv1X2fVEQhTw51lKENdNrEqT3,64,38,27,160,14,0,12,1,252,36.0,2,0.0,3,27,132,14,35,0,28,12,1,176,76,0
2560,58102,RPQvIQfjeayIRS4PyDyrIytbJ9ZHNktA,SpATywNh6bZuzm8s1ceuBUnMUAeoAHHw,18,27,15,6,4,2,5,0,59,8.428571428571429,3,0.0,7,15,6,4,20,2,0,5,0,32,27,1
2561,58112,Bf025FfgNrlcqN8gYGnmBAhjBy0v5Xmo,A3fsA9Zfv1X2fVEQhTw51lKENdNrEqT3,6,4,2,0,1,0,4,0,11,1.5714285714285714,1,0.0,0,2,0,1,4,0,0,4,0,3,8,1
2562,58153,5IgfYzsKnLRjBd3YVdiUAOaMV18WR5D2,SpATywNh6bZuzm8s1ceuBUnMUAeoAHHw,1,0,0,0,0,0,2,0,2,0.2857142857142857,1,0.0,0,0,0,0,0,0,0,2,0,0,2,1
2563,58286,y6i20DJpIul6LihHwgZcWxbdAap5GcBP,A3fsA9Zfv1X2fVEQhTw51lKENdNrEqT3,3,2,1,0,0,0,1,0,4,0.5714285714285714,1,0.0,0,1,0,0,2,0,0,1,0,1,3,1
2564,58359,czKChsqaxfwVoznY2WnWYH2vLIXb6X34,bWdj2GDclj5ofokWjzoa5jAwMkxCykd6,15,15,10,2,9,1,2,0,39,5.571428571428571,1,0.0,3,10,2,9,12,1,0,2,0,24,15,1
2565,58403,Xn2ydtleLSG85TyAEd0OMkY2BfH9jhfO,SpATywNh6bZuzm8s1ceuBUnMUAeoAHHw,27,40,2,36,4,52,13,1,148,21.142857142857142,2,0.0,12,2,30,4,28,52,6,13,1,48,100,0
2566,58453,fgzbUfrTxXYCuiFYTG1cTemcEJUl36an,A3fsA9Zfv1X2fVEQhTw51lKENdNrEqT3,4,3,1,0,0,0,1,0,5,0.7142857142857143,1,0.0,0,1,0,0,3,0,0,1,0,1,4,1
2567,58544,bpxaFadaQixJuWRVtAAq5miKiBM3zC6u,A3fsA9Zfv1X2fVEQhTw51lKENdNrEqT3,7,10,0,0,0,0,8,0,18,2.5714285714285716,4,0.0,0,0,0,0,10,0,0,8,0,0,18,0
2568,58560,3wojMge418Q4FflCb29r3hem59j6egRX,SpATywNh6bZuzm8s1ceuBUnMUAeoAHHw,15,18,0,0,0,1,5,0,24,3.4285714285714284,1,0.0,6,0,0,0,12,1,0,5,0,6,18,1
2569,58582,o0M6SOlciWGWtqkYLASaq6tS76D18V6N,SpATywNh6bZuzm8s1ceuBUnMUAeoAHHw,17,23,9,18,4,13,4,0,71,10.142857142857142,1,0.0,9,9,15,4,14,13,3,4,0,37,34,0
2570,58644,zWZdErlwOQ1yvd6vlyAltL2Balhdc8gj,G8EPVSXsOYB5YQWZGiz1aVq5Pgr2GrQu,3,4,2,0,0,2,3,0,11,1.5714285714285714,1,0.0,0,2,0,0,4,2,0,3,0,2,9,0
2571,58794,1zErz13s8fNQRVaEvkOtvw6bLhr23yB4,SpATywNh6bZuzm8s1ceuBUnMUAeoAHHw,7,6,2,18,0,0,1,0,27,3.857142857142857,1,0.0,3,2,15,0,3,0,3,1,0,20,7,0
2572,58800,irZDaKqT4KdxcZGgiOHoDpvTtZyUugWP,G8EPVSXsOYB5YQWZGiz1aVq5Pgr2GrQu,5,5,1,0,0,0,1,0,7,1.0,1,0.0,0,1,0,0,5,0,0,1,0,1,6,0
2573,58804,OUbh6hvaOJDp9RK7kgTBzzPmjzmkYhZF,SpATywNh6bZuzm8s1ceuBUnMUAeoAHHw,15,14,0,12,0,10,7,2,45,6.428571428571429,1,0.0,2,0,12,0,12,10,0,7,2,14,31,0
2574,58812,x2TXADDQJTDLVMnKDb6BhJyWEoYQjlQy,SpATywNh6bZuzm8s1ceuBUnMUAeoAHHw,14,20,0,12,0,2,3,0,37,5.285714285714286,2,0.0,8,0,9,0,12,2,3,3,0,17,20,1
2575,58855,6K3h9aDeHI9AUqOKTvZxzGkKh6WMc7A3,SpATywNh6bZuzm8s1ceuBUnMUAeoAHHw,15,8,7,0,6,0,2,0,23,3.2857142857142856,1,0.0,0,7,0,6,8,0,0,2,0,13,10,0
2576,58877,Hoitr98hXhrf7xDGgACEFamKhiarA3wg,SpATywNh6bZuzm8s1ceuBUnMUAeoAHHw,17,13,9,16,4,8,1,0,51,7.285714285714286,1,0.0,2,9,14,4,11,8,2,1,0,29,22,0
2577,58937,BWQpUowEHGBDEzSf23lNUZVBPlEw3Sq1,SpATywNh6bZuzm8s1ceuBUnMUAeoAHHw,3,2,1,0,0,0,1,0,4,0.5714285714285714,1,0.0,0,1,0,0,2,0,0,1,0,1,3,0
2578,59059,WyukafQHQxismOtYiPzoFkAc38hAOB09,SpATywNh6bZuzm8s1ceuBUnMUAeoAHHw,30,73,32,29,13,15,7,0,169,24.142857142857142,3,0.0,34,32,26,13,39,15,3,7,0,105,64,0
2579,59112,SSR2C7GBXM7XyR67GN0wwOxiCuLYjW4G,SpATywNh6bZuzm8s1ceuBUnMUAeoAHHw,8,13,2,0,2,0,1,0,18,2.5714285714285716,1,0.0,4,2,0,2,9,0,0,1,0,8,10,0
2580,59133,kqS8BwWN9R1093oeblGkvtCsQJ68Gh0G,A3fsA9Zfv1X2fVEQhTw51lKENdNrEqT3,5,3,2,0,1,0,1,0,7,1.0,1,0.0,0,2,0,1,3,0,0,1,0,3,4,1
2581,59172,jImHfNEIObE674KdIbKVj7cCJ4ufqzHJ,SpATywNh6bZuzm8s1ceuBUnMUAeoAHHw,3,2,1,0,0,0,1,0,4,0.5714285714285714,1,0.0,0,1,0,0,2,0,0,1,0,1,3,0
2582,60074,Vve0UwhmiGWZN8bT2t4sC82sMWi2ZyY8,7GRhBDsirIGkRZBtSMEzNTyDr2JQm4xx,1,0,0,0,0,0,1,0,1,0.14285714285714285,1,0.0,0,0,0,0,0,0,0,1,0,0,1,1
2583,60210,wGqhUJlJ3fGYOW2r7IbwNL0CdAR0avoU,7GRhBDsirIGkRZBtSMEzNTyDr2JQm4xx,37,109,38,111,30,20,4,0,312,44.57142857142857,3,0.0,64,38,88,30,45,20,23,4,0,220,92,1
2584,60214,Y3uwxWCm13Ol5xozrT2GPjOPhBlC2kOq,7GRhBDsirIGkRZBtSMEzNTyDr2JQm4xx,34,47,6,106,1,0,3,0,163,23.285714285714285,2,0.0,16,6,97,1,31,0,9,3,0,120,43,1
2585,60264,iSrdvAXagFyTWuVpDzl1vXqwXkCyI8Nx,7GRhBDsirIGkRZBtSMEzNTyDr2JQm4xx,2,0,0,0,0,0,3,0,3,0.42857142857142855,1,0.0,0,0,0,0,0,0,0,3,0,0,3,1
2586,60427,r3TtJNrYEPB9JfkbBp23luDTSVLZGHt2,7GRhBDsirIGkRZBtSMEzNTyDr2JQm4xx,39,133,8,37,17,22,21,0,238,34.0,7,0.0,55,8,29,17,78,22,8,21,0,109,129,0
2587,60442,76btfIjeEvKDRqZ07unLyzOBWCQVXirv,7GRhBDsirIGkRZBtSMEzNTyDr2JQm4xx,4,2,1,0,1,0,1,0,5,0.7142857142857143,1,0.0,0,1,0,1,2,0,0,1,0,2,3,0
2588,60518,r639bFH7kDBWMyuyounNz9zTrG9jbNqa,7GRhBDsirIGkRZBtSMEzNTyDr2JQm4xx,16,19,9,8,6,28,17,2,89,12.714285714285714,1,0.0,3,9,6,6,16,28,2,17,2,24,65,0
2589,60531,Vdzl3X3O6ZP4Npa6oBdNxCc6U3L9nvWo,7GRhBDsirIGkRZBtSMEzNTyDr2JQm4xx,34,61,21,35,15,4,4,0,140,20.0,1,0.0,37,21,31,15,24,4,4,4,0,104,36,0
2590,61039,RzKvPu4qwYnkKioYxIJem5I7hV4q5Zey,7GRhBDsirIGkRZBtSMEzNTyDr2JQm4xx,2,0,0,0,0,0,2,0,2,0.2857142857142857,1,0.0,0,0,0,0,0,0,0,2,0,0,2,0
2591,61087,GDHvw72iSHIz6VwsSteleP4praXBxk8h,7GRhBDsirIGkRZBtSMEzNTyDr2JQm4xx,13,19,0,6,4,16,1,0,46,6.571428571428571,1,0.0,10,0,5,4,9,16,1,1,0,19,27,1
2592,61604,X8nI71wgjvVnziT2GohIRTnyUeumIuGT,SpATywNh6bZuzm8s1ceuBUnMUAeoAHHw,2,0,0,0,0,0,2,0,2,0.2857142857142857,1,0.0,0,0,0,0,0,0,0,2,0,0,2,0
2593,61634,PyaXrfJadEJJdtWYxd1SSz75aPVyhQhH,SpATywNh6bZuzm8s1ceuBUnMUAeoAHHw,16,23,0,21,0,14,11,4,73,10.428571428571429,1,0.0,12,0,18,0,11,14,3,11,4,30,43,0
2594,61638,lLutp8H3vKf6Z8olMEwVlKswK040AY6M,7GRhBDsirIGkRZBtSMEzNTyDr2JQm4xx,30,68,27,62,14,0,9,0,180,25.714285714285715,3,0.0,34,27,56,14,34,0,6,9,0,131,49,1
2595,61713,MYsCU1zkMrWxPhV1b7wSL5LZIo1zGyhU,bWdj2GDclj5ofokWjzoa5jAwMkxCykd6,8,9,4,0,2,0,2,0,17,2.4285714285714284,1,0.0,2,4,0,2,7,0,0,2,0,8,9,0
2596,61732,NcracMTfiaTPMbO6SSDnt9CDc4SnvBs9,SpATywNh6bZuzm8s1ceuBUnMUAeoAHHw,29,23,14,18,6,44,7,0,112,16.0,1,0.0,5,14,17,6,18,44,1,7,0,42,70,0
2597,61740,I9yi1jZjIznCPzP5fpMJEhPDMiUaetUu,SpATywNh6bZuzm8s1ceuBUnMUAeoAHHw,4,3,2,0,0,0,1,0,6,0.8571428571428571,1,0.0,0,2,0,0,3,0,0,1,0,2,4,0
2598,61837,2yFrrfFKwmpyH7xPcC8i0UYFZJHtjntf,SpATywNh6bZuzm8s1ceuBUnMUAeoAHHw,9,9,6,0,1,0,6,1,23,3.2857142857142856,2,0.0,0,6,0,1,9,0,0,6,1,7,16,0
2599,61934,8dPQDWD7NMlHSztQh4Fh3dqPVx6xptft,SpATywNh6bZuzm8s1ceuBUnMUAeoAHHw,18,17,6,14,4,0,4,1,46,6.571428571428571,1,0.0,2,6,11,4,15,0,3,4,1,23,23,0
2600,61948,MHUd30s3WtRLChM8IirlGkLsv26fGFJh,bWdj2GDclj5ofokWjzoa5jAwMkxCykd6,7,7,5,2,0,0,2,0,16,2.2857142857142856,1,0.0,0,5,2,0,7,0,0,2,0,7,9,1
2601,61977,XupxNoKQxp2aAQkFy5RiZK4Yl6Wd1tRi,SpATywNh6bZuzm8s1ceuBUnMUAeoAHHw,6,6,2,0,1,0,1,0,10,1.4285714285714286,1,0.0,0,2,0,1,6,0,0,1,0,3,7,0
2602,61994,pvjfd8HSIoVZ71m9TCBbQlraohrUi2x6,SpATywNh6bZuzm8s1ceuBUnMUAeoAHHw,14,14,1,17,0,0,2,0,34,4.857142857142857,1,0.0,1,1,14,0,13,0,3,2,0,16,18,0
2603,62051,xFkd6TNWJ8qmIM4trYH57onQcjo5lnU0,SpATywNh6bZuzm8s1ceuBUnMUAeoAHHw,8,9,2,4,0,0,2,0,17,2.4285714285714284,2,0.0,1,2,4,0,8,0,0,2,0,7,10,0
2604,62091,6AOZlfpjI3ayLpXvguaWVv2FqhQMzw4M,SpATywNh6bZuzm8s1ceuBUnMUAeoAHHw,10,9,5,14,0,0,2,0,30,4.285714285714286,1,0.0,2,5,13,0,7,0,1,2,0,20,10,0
2605,62133,CsUkH6E2FiorKRYwpRBQQof16ywBIfF7,SpATywNh6bZuzm8s1ceuBUnMUAeoAHHw,18,27,12,17,3,0,5,0,64,9.142857142857142,1,0.0,9,12,16,3,18,0,1,5,0,40,24,0
2606,62161,We0slB08viHgFv6ByLfwdtuQZUg6JG7L,SpATywNh6bZuzm8s1ceuBUnMUAeoAHHw,2,0,0,0,0,0,2,0,2,0.2857142857142857,1,0.0,0,0,0,0,0,0,0,2,0,0,2,1
2607,62235,2cdJoONM7ugDmkPkQHwnxWZwEOIANTXn,SpATywNh6bZuzm8s1ceuBUnMUAeoAHHw,18,28,16,4,5,62,9,1,125,17.857142857142858,2,0.0,0,16,4,5,28,62,0,9,1,25,100,0
2608,62466,ggEr2STKTwtSSUdtGCmiPr3DBu3TJ34B,SpATywNh6bZuzm8s1ceuBUnMUAeoAHHw,9,8,3,6,0,0,1,0,18,2.5714285714285716,1,0.0,2,3,6,0,6,0,0,1,0,11,7,1
2609,62685,xhufFs72rOwOGZDYtQtHTXdheNyqrUTX,SpATywNh6bZuzm8s1ceuBUnMUAeoAHHw,18,18,13,17,6,0,5,0,59,8.428571428571429,2,0.0,2,13,15,6,16,0,2,5,0,36,23,0
2610,62764,XsK920toyXvpWwNS6lvZzDVJcrgCTFKd,SpATywNh6bZuzm8s1ceuBUnMUAeoAHHw,16,13,8,10,5,0,3,0,39,5.571428571428571,1,0.0,2,8,10,5,11,0,0,3,0,25,14,0
2611,62809,EEgHvStGR7XKoMKoPOCBxkxFHcb7UdMh,SpATywNh6bZuzm8s1ceuBUnMUAeoAHHw,3,4,2,0,0,0,3,0,9,1.2857142857142858,2,0.0,0,2,0,0,4,0,0,3,0,2,7,0
2612,62819,zn2X74vvqUQRINz90WjZLsSsFglpYr7o,SpATywNh6bZuzm8s1ceuBUnMUAeoAHHw,2,0,0,0,0,0,2,0,2,0.2857142857142857,1,0.0,0,0,0,0,0,0,0,2,0,0,2,1
2613,62837,k4ieA0VLPLUG1GV8FhtBGpWAykZRhHXI,7GRhBDsirIGkRZBtSMEzNTyDr2JQm4xx,12,13,6,32,1,0,1,0,53,7.571428571428571,2,0.0,7,6,30,1,6,0,2,1,0,44,9,1
2614,62911,KwjYZWNYzBofNYG8mRoeOhYNpisNnTvM,SpATywNh6bZuzm8s1ceuBUnMUAeoAHHw,6,3,2,0,2,0,1,0,8,1.1428571428571428,1,0.0,0,2,0,2,3,0,0,1,0,4,4,1
2615,62957,iugl3Rn3u1ci3BiC2tfekDHOQsD5QVGj,bWdj2GDclj5ofokWjzoa5jAwMkxCykd6,14,28,14,15,3,0,6,0,66,9.428571428571429,1,0.0,7,14,12,3,21,0,3,6,0,36,30,0
2616,62975,fV0W6675p3fpyY1tGNGM2NdIFpKgGWLW,SpATywNh6bZuzm8s1ceuBUnMUAeoAHHw,12,10,7,8,0,7,2,0,34,4.857142857142857,1,0.0,2,7,7,0,8,7,1,2,0,16,18,0
2617,63048,OO2Ag6HEFKkZRtZuzzt1ya8SiL4BLCOC,bWdj2GDclj5ofokWjzoa5jAwMkxCykd6,9,15,7,0,4,0,6,0,32,4.571428571428571,1,0.0,3,7,0,4,12,0,0,6,0,14,18,0
2618,63108,rtYqtRTnqUXb6diSp0MKjdA0eLt2BJ3X,7GRhBDsirIGkRZBtSMEzNTyDr2JQm4xx,7,6,3,10,0,0,1,0,20,2.857142857142857,1,0.0,2,3,9,0,4,0,1,1,0,14,6,1
2619,63116,BvCRPlMfMau2kDEBEjyV1l6RJMQy5B5l,SpATywNh6bZuzm8s1ceuBUnMUAeoAHHw,14,25,6,11,0,3,12,1,58,8.285714285714286,1,0.0,8,6,10,0,17,3,1,12,1,24,34,0
2620,63126,8nlNDsWSaxHCvsMKtqhBs81sknEiTCeb,bWdj2GDclj5ofokWjzoa5jAwMkxCykd6,10,13,8,0,2,5,4,0,32,4.571428571428571,3,0.0,0,8,0,2,13,5,0,4,0,10,22,0
2621,63128,5uO2cAopKsWa3VCKCGDarnhTzdurYycs,SpATywNh6bZuzm8s1ceuBUnMUAeoAHHw,14,14,9,11,5,0,2,0,41,5.857142857142857,1,0.0,2,9,10,5,12,0,1,2,0,26,15,0
2622,63198,JUAvN6CchqwicZ9lfSkTbwue3bPu0qhC,7GRhBDsirIGkRZBtSMEzNTyDr2JQm4xx,27,76,37,6,36,1,7,2,165,23.571428571428573,1,0.0,25,37,6,36,51,1,0,7,2,104,61,0
2623,63233,MvNnLQma2eBM9bCcMIR159XYSNp8VREs,A3fsA9Zfv1X2fVEQhTw51lKENdNrEqT3,1,0,0,0,0,0,3,0,3,0.42857142857142855,1,0.0,0,0,0,0,0,0,0,3,0,0,3,0
2624,63255,7u0QfTKQg4itZK9m8foLXkIGwUxxHMsT,7GRhBDsirIGkRZBtSMEzNTyDr2JQm4xx,17,18,7,6,7,0,3,0,41,5.857142857142857,2,0.0,9,7,6,7,9,0,0,3,0,29,12,0
2625,63257,A1X8BnmDZU7GoDnOEZBjlNXiBeexxBQy,7GRhBDsirIGkRZBtSMEzNTyDr2JQm4xx,1,0,0,0,0,0,1,0,1,0.14285714285714285,1,0.0,0,0,0,0,0,0,0,1,0,0,1,1
2626,63296,qMFAmPw34z5IViYTtA1Kkpcn2uEg1WBM,7GRhBDsirIGkRZBtSMEzNTyDr2JQm4xx,1,0,0,0,0,0,1,0,1,0.14285714285714285,1,0.0,0,0,0,0,0,0,0,1,0,0,1,1
2627,63346,fOHPhMpeg8x93fPCuBnyT2XMX6wTKqV5,7GRhBDsirIGkRZBtSMEzNTyDr2JQm4xx,4,4,1,0,0,0,3,0,8,1.1428571428571428,1,0.0,0,1,0,0,4,0,0,3,0,1,7,1
2628,63384,oT95jnCrOomgCStV09kTjQxruOcKiBza,7GRhBDsirIGkRZBtSMEzNTyDr2JQm4xx,1,0,0,0,0,0,2,0,2,0.2857142857142857,2,0.0,0,0,0,0,0,0,0,2,0,0,2,1
2629,63415,BkWsoOcHNs2015z3Qrz6HVGKHPIIV4xg,7GRhBDsirIGkRZBtSMEzNTyDr2JQm4xx,1,0,0,0,0,0,1,0,1,0.14285714285714285,1,0.0,0,0,0,0,0,0,0,1,0,0,1,1
2630,63441,zga7Ud0Vk6NOYChIx78X5xKIKbxIADsx,7GRhBDsirIGkRZBtSMEzNTyDr2JQm4xx,2,0,0,0,0,0,2,0,2,0.2857142857142857,1,0.0,0,0,0,0,0,0,0,2,0,0,2,1
2631,63493,NRZzsjM7f5dJSFvndgYyTX54NocUI1PS,7GRhBDsirIGkRZBtSMEzNTyDr2JQm4xx,26,29,13,18,10,3,4,0,77,11.0,1,0.0,14,13,14,10,15,3,4,4,0,51,26,1
2632,63498,5P9Jg9PB0Bpdf0i8vhVF4X9FZYYuI2qy,7GRhBDsirIGkRZBtSMEzNTyDr2JQm4xx,8,4,4,0,3,0,5,0,16,2.2857142857142856,1,0.0,0,4,0,3,4,0,0,5,0,7,9,1
2633,63504,Bf025FfgNrlcqN8gYGnmBAhjBy0v5Xmo,7GRhBDsirIGkRZBtSMEzNTyDr2JQm4xx,7,8,4,0,2,0,1,0,15,2.142857142857143,1,0.0,0,4,0,2,8,0,0,1,0,6,9,1
2634,63534,XNb7KU6KeHuNJzclGX2ePynnmu8yxV3v,7GRhBDsirIGkRZBtSMEzNTyDr2JQm4xx,1,0,0,0,0,0,1,0,1,0.14285714285714285,1,0.0,0,0,0,0,0,0,0,1,0,0,1,1
2635,63571,EwaALzeaojV7pPZOsHFx7jzB7xjVDGvQ,A3fsA9Zfv1X2fVEQhTw51lKENdNrEqT3,8,9,1,0,1,0,2,0,13,1.8571428571428572,1,0.0,0,1,0,1,9,0,0,2,0,2,11,1
2636,63577,WofGn4IWpKZgx8XqCdK2PR8vwgQ2CXSv,7GRhBDsirIGkRZBtSMEzNTyDr2JQm4xx,4,2,1,0,1,0,1,0,5,0.7142857142857143,1,0.0,0,1,0,1,2,0,0,1,0,2,3,0
2637,63583,CLsYy7g1hYWHJyj1aROfKK9oTeo5yxJx,7GRhBDsirIGkRZBtSMEzNTyDr2JQm4xx,33,32,15,40,11,31,6,0,135,19.285714285714285,1,0.0,13,15,33,11,19,31,7,6,0,72,63,1
2638,63644,abujBNmSyI9HYgtoO1EXyLGaW1rUTrMR,7GRhBDsirIGkRZBtSMEzNTyDr2JQm4xx,10,5,1,0,1,1,11,1,20,2.857142857142857,1,0.0,0,1,0,1,5,1,0,11,1,2,18,1
2639,63662,JFaXJp13wvkCeQQDDH7gpaTiCpXvjbvf,7GRhBDsirIGkRZBtSMEzNTyDr2JQm4xx,10,17,4,0,2,0,3,0,26,3.7142857142857144,1,0.0,3,4,0,2,14,0,0,3,0,9,17,1
2640,63710,Ga4lr67F0RIjyUetWH1EgQ3xzSHDnViF,7GRhBDsirIGkRZBtSMEzNTyDr2JQm4xx,10,7,3,13,2,0,1,0,26,3.7142857142857144,1,0.0,2,3,12,2,5,0,1,1,0,19,7,1
2641,63719,RPsysYLHG9V8ibC4agPmUkz49odzJ61i,A3fsA9Zfv1X2fVEQhTw51lKENdNrEqT3,29,15,1,84,0,0,6,0,106,15.142857142857142,3,0.0,1,1,77,0,14,0,7,6,0,79,27,0
2642,63730,ZxSt3TZtQO3EpuEM7vETaMfS20LEVHky,7GRhBDsirIGkRZBtSMEzNTyDr2JQm4xx,1,0,0,0,0,0,1,0,1,0.14285714285714285,1,0.0,0,0,0,0,0,0,0,1,0,0,1,1
2643,63750,0wm7bVyJC7jfhIoeylaV85sHOH5JOhtj,7GRhBDsirIGkRZBtSMEzNTyDr2JQm4xx,1,0,0,0,0,0,1,0,1,0.14285714285714285,1,0.0,0,0,0,0,0,0,0,1,0,0,1,1
2644,63800,pwyQw70rdHu06KaDwuJu2ks1YZiiVKHU,7GRhBDsirIGkRZBtSMEzNTyDr2JQm4xx,5,2,1,0,1,0,2,0,6,0.8571428571428571,1,0.0,0,1,0,1,2,0,0,2,0,2,4,1
2645,63914,Yt9n1K8qzV8RLiOcWgNVrYW5xiZerljd,7GRhBDsirIGkRZBtSMEzNTyDr2JQm4xx,17,26,2,14,5,0,2,0,49,7.0,1,0.0,14,2,14,5,12,0,0,2,0,35,14,1
2646,63933,K9G4dlm9tLRMMK1kov6MCkkTMks8NOCf,7GRhBDsirIGkRZBtSMEzNTyDr2JQm4xx,1,0,0,0,0,0,1,0,1,0.14285714285714285,1,0.0,0,0,0,0,0,0,0,1,0,0,1,1
2647,63934,QXR5sUbv4S12yRWxM4AzFUAlm7Vhd4VU,7GRhBDsirIGkRZBtSMEzNTyDr2JQm4xx,2,0,0,0,0,0,2,0,2,0.2857142857142857,1,0.0,0,0,0,0,0,0,0,2,0,0,2,1
2648,63977,OVG8I98WuYVhtwF4PGQiRQJNGKoIW18s,7GRhBDsirIGkRZBtSMEzNTyDr2JQm4xx,9,5,3,0,3,0,2,0,13,1.8571428571428572,1,0.0,0,3,0,3,5,0,0,2,0,6,7,0
2649,63996,kaNpWuIxNLxZkDfmjMzrYRVzuOgwIf0o,7GRhBDsirIGkRZBtSMEzNTyDr2JQm4xx,1,0,0,0,0,0,1,0,1,0.14285714285714285,1,0.0,0,0,0,0,0,0,0,1,0,0,1,1
2650,64025,VmlXkvuP00sXBlaPmnRadtsHqWz5E4fz,7GRhBDsirIGkRZBtSMEzNTyDr2JQm4xx,41,198,39,86,17,30,15,0,385,55.0,5,0.0,114,39,69,17,84,30,17,15,0,239,146,0
2651,64113,EVGpdajso7QxNR24Ui7ldtFyj6uWtpYs,7GRhBDsirIGkRZBtSMEzNTyDr2JQm4xx,31,53,12,65,11,0,4,0,145,20.714285714285715,2,0.0,26,12,58,11,27,0,7,4,0,107,38,1
2652,64116,sQpA2SuskRigo277vTUjZ4C84cF8DuDE,7GRhBDsirIGkRZBtSMEzNTyDr2JQm4xx,3,2,1,0,0,0,1,0,4,0.5714285714285714,1,0.0,0,1,0,0,2,0,0,1,0,1,3,0
2653,64124,pseKOpRPBJlgz4ycJmBeuSlXa5DHSZxH,7GRhBDsirIGkRZBtSMEzNTyDr2JQm4xx,4,2,1,0,1,5,1,0,10,1.4285714285714286,1,0.0,0,1,0,1,2,5,0,1,0,2,8,1
2654,64139,oKHRSMo3yDALM11wXRuypZuoIWmshJLG,7GRhBDsirIGkRZBtSMEzNTyDr2JQm4xx,2,0,0,0,0,0,2,0,2,0.2857142857142857,1,0.0,0,0,0,0,0,0,0,2,0,0,2,1
2655,64142,as5VymGJtrKzsVSyPlhaHLjXcgFKhbSH,A3fsA9Zfv1X2fVEQhTw51lKENdNrEqT3,18,11,8,0,6,6,9,1,41,5.857142857142857,2,0.0,0,8,0,6,11,6,0,9,1,14,27,1
2656,64169,Z5Gd8RjsJSljoHUoBd3hvIVNy4VKuGq0,7GRhBDsirIGkRZBtSMEzNTyDr2JQm4xx,12,29,7,10,0,2,5,0,53,7.571428571428571,3,0.0,7,7,9,0,22,2,1,5,0,23,30,1
2657,64170,XPA1Jv5NXHfUcU7CMUA4EKvCqSxl1bO3,7GRhBDsirIGkRZBtSMEzNTyDr2JQm4xx,4,2,1,0,1,0,1,0,5,0.7142857142857143,1,0.0,0,1,0,1,2,0,0,1,0,2,3,1
2658,66546,DTbJ7KB3uMFcpk8W3n4kvUeKqSYyolkW,SpATywNh6bZuzm8s1ceuBUnMUAeoAHHw,7,5,3,0,1,0,3,0,12,1.7142857142857142,1,0.0,0,3,0,1,5,0,0,3,0,4,8,1
2659,66551,fkrSqTHnPEweVdPiAW6RgeMJZWZWaXQt,G8EPVSXsOYB5YQWZGiz1aVq5Pgr2GrQu,4,0,0,0,0,3,3,0,6,0.8571428571428571,1,0.0,0,0,0,0,0,3,0,3,0,0,6,0
2660,66555,fdzq5tofwv4sAm3YqrsC6AMOnGl1oPA0,RXDvfPUBYFlVdlueBFbLW0mhhAyGEqpt,1,0,0,0,0,0,1,0,1,0.14285714285714285,1,0.0,0,0,0,0,0,0,0,1,0,0,1,1
2661,66558,z6Xzy59qUrOr9kg6qBkR4Bly4uQ6Qoy2,SpATywNh6bZuzm8s1ceuBUnMUAeoAHHw,7,6,3,0,2,0,1,0,12,1.7142857142857142,1,0.0,0,3,0,2,6,0,0,1,0,5,7,1
2662,66570,MpNfjrXai4aLf7BfVSQwZSS0DPolU3oZ,RXDvfPUBYFlVdlueBFbLW0mhhAyGEqpt,10,16,8,0,5,0,3,0,32,4.571428571428571,2,0.0,1,8,0,5,15,0,0,3,0,14,18,0
2663,66594,Jkvg2vrMG0bsI6gC4CJJwz6mYReBwqyD,bWdj2GDclj5ofokWjzoa5jAwMkxCykd6,6,3,2,0,1,0,2,0,8,1.1428571428571428,1,0.0,0,2,0,1,3,0,0,2,0,3,5,1
2664,66724,cWGbfR2Lw2D62YH4zDUtSEtnjy8NlUpm,SpATywNh6bZuzm8s1ceuBUnMUAeoAHHw,16,16,6,12,4,0,3,0,41,5.857142857142857,1,0.0,4,6,10,4,12,0,2,3,0,24,17,1
2665,66817,to6uzLarCrneiGy62nJuyfDuz8bCYwik,G8EPVSXsOYB5YQWZGiz1aVq5Pgr2GrQu,33,29,13,65,7,0,6,0,120,17.142857142857142,2,0.0,12,13,52,7,17,0,13,6,0,84,36,1
2666,66856,9Bmxb2kRkvmXtKdf1iC2KsdGSl1k4oD2,G8EPVSXsOYB5YQWZGiz1aVq5Pgr2GrQu,1,0,0,0,0,0,1,0,1,0.14285714285714285,1,0.0,0,0,0,0,0,0,0,1,0,0,1,1
2667,66882,RUyO8vGMdp7jhM6g17yji5ANjGox4I7a,G8EPVSXsOYB5YQWZGiz1aVq5Pgr2GrQu,5,7,5,0,4,0,1,0,17,2.4285714285714284,1,0.0,0,5,0,4,7,0,0,1,0,9,8,1
2668,66958,VNn0ZSteI0TUWATSfv7oNQMdpP8UUblh,SpATywNh6bZuzm8s1ceuBUnMUAeoAHHw,17,28,9,10,5,0,2,0,54,7.714285714285714,1,0.0,11,9,10,5,17,0,0,2,0,35,19,1
2669,67012,Id4UmIRRQiLXHoJYSjh5OCO1CRaFgQ2K,RXDvfPUBYFlVdlueBFbLW0mhhAyGEqpt,10,9,6,0,3,0,1,0,19,2.7142857142857144,1,0.0,0,6,0,3,9,0,0,1,0,9,10,1
2670,67033,tPYh43YRHAzuf09xESxSKtWvST0aCsjn,SpATywNh6bZuzm8s1ceuBUnMUAeoAHHw,9,8,4,6,0,0,3,0,21,3.0,2,0.0,2,4,6,0,6,0,0,3,0,12,9,0
2671,67034,yZ9FndAKqVsKwZtO1B2JJJblefdbhZ02,SpATywNh6bZuzm8s1ceuBUnMUAeoAHHw,7,3,1,16,0,0,5,0,25,3.5714285714285716,2,0.0,2,1,14,0,1,0,2,5,0,17,8,0
2672,67077,wDMKq3Xvq95ERd20zjEMEb0BtCbHx7BM,SpATywNh6bZuzm8s1ceuBUnMUAeoAHHw,14,20,8,14,2,0,8,1,53,7.571428571428571,5,0.0,2,8,14,2,18,0,0,8,1,26,27,0
2673,67080,CgsguvEs0KUN3Abw9Qjh5ZZT0chwXUSw,SpATywNh6bZuzm8s1ceuBUnMUAeoAHHw,5,6,1,0,1,0,1,0,9,1.2857142857142858,1,0.0,0,1,0,1,6,0,0,1,0,2,7,0
2674,67099,rwVFzRApiQw3vAU5Rpa6do3mD0uc5CXG,SpATywNh6bZuzm8s1ceuBUnMUAeoAHHw,12,12,0,14,0,0,3,0,29,4.142857142857143,1,0.0,2,0,13,0,10,0,1,3,0,15,14,1
2675,67111,KOlp6BtLHFtxPjNN0KYQVjD6WvIwSYtA,SpATywNh6bZuzm8s1ceuBUnMUAeoAHHw,14,28,1,11,0,0,5,0,45,6.428571428571429,1,0.0,5,1,11,0,23,0,0,5,0,17,28,0
2676,67133,iU8sg5PBq7mTADvs0COG4jXH4nM6hq2B,SpATywNh6bZuzm8s1ceuBUnMUAeoAHHw,18,11,7,7,4,10,9,0,48,6.857142857142857,2,0.0,2,7,7,4,9,10,0,9,0,20,28,1
2677,67158,07nBIjV5wvxeipK7Zz3uxWH8hv0V5VvH,SpATywNh6bZuzm8s1ceuBUnMUAeoAHHw,23,22,13,9,7,0,2,0,53,7.571428571428571,1,0.0,8,13,9,7,14,0,0,2,0,37,16,0
2678,67195,MPLO46zeqSAmGFkKKuWvnx6pcJItRavU,SpATywNh6bZuzm8s1ceuBUnMUAeoAHHw,19,45,15,18,5,0,4,0,87,12.428571428571429,1,0.0,26,15,15,5,19,0,3,4,0,61,26,0
2679,67220,5UJZmEar1AX3gQXOzkh3MnQcYdErI17M,SpATywNh6bZuzm8s1ceuBUnMUAeoAHHw,17,23,8,12,4,2,2,0,51,7.285714285714286,2,0.0,12,8,10,4,11,2,2,2,0,34,17,1
2680,67224,AszzZcQ3DzjVCWiO17ucpHFrMmRC8MRV,SpATywNh6bZuzm8s1ceuBUnMUAeoAHHw,5,5,3,0,2,0,1,0,11,1.5714285714285714,1,0.0,0,3,0,2,5,0,0,1,0,5,6,0
2681,67266,X0qiYFDfIWOz74gDCjJtjtlJKUHThKgm,SpATywNh6bZuzm8s1ceuBUnMUAeoAHHw,10,8,5,0,3,0,2,0,18,2.5714285714285716,1,0.0,2,5,0,3,6,0,0,2,0,10,8,0
2682,67267,d4AhROqi4DjVmWKfbbbhi19n7hcGPkSg,RXDvfPUBYFlVdlueBFbLW0mhhAyGEqpt,37,31,0,134,1,6,4,0,176,25.142857142857142,3,0.0,9,0,106,1,22,6,28,4,0,116,60,0
2683,67348,GQMirxB5y3FtUmix76KGcpTxWntGgKiV,RXDvfPUBYFlVdlueBFbLW0mhhAyGEqpt,8,6,4,0,3,0,1,0,14,2.0,1,0.0,0,4,0,3,6,0,0,1,0,7,7,1
2684,67424,kuV8TXv5cFVPIWK37fDR8nnl0vrHyjjA,RXDvfPUBYFlVdlueBFbLW0mhhAyGEqpt,21,23,2,33,1,0,2,0,61,8.714285714285714,1,0.0,4,2,31,1,19,0,2,2,0,38,23,0
2685,67435,gK0C2Qn10uFCDrXyxIuukzeUErx51I1a,SpATywNh6bZuzm8s1ceuBUnMUAeoAHHw,13,15,0,15,0,0,3,0,33,4.714285714285714,1,0.0,6,0,15,0,9,0,0,3,0,21,12,0
2686,67464,uBWT9p90Ea0JVvR5wbRV9EQLPt0ehYR1,SpATywNh6bZuzm8s1ceuBUnMUAeoAHHw,14,15,1,8,1,0,4,0,29,4.142857142857143,1,0.0,2,1,8,1,13,0,0,4,0,12,17,1
2687,67466,6yy5YFhebeCVEWPcZqK4jg9qO8ru1OT4,SpATywNh6bZuzm8s1ceuBUnMUAeoAHHw,5,3,1,0,1,1,1,0,7,1.0,1,0.0,0,1,0,1,3,1,0,1,0,2,5,1
2688,67566,tYJFbmbzeY9dNgPSZvFhNskxnqvhh3AK,SpATywNh6bZuzm8s1ceuBUnMUAeoAHHw,7,12,0,0,0,0,2,0,14,2.0,1,0.0,0,0,0,0,12,0,0,2,0,0,14,0
2689,67579,JsUpucQyiTLV5gDB7KrgqzRdiUsoUyeZ,bWdj2GDclj5ofokWjzoa5jAwMkxCykd6,1,0,0,0,0,0,1,0,1,0.14285714285714285,1,0.0,0,0,0,0,0,0,0,1,0,0,1,1
2690,67588,KgPlJUOxzo6K50clHm6VhLAZdTWxAeXA,SpATywNh6bZuzm8s1ceuBUnMUAeoAHHw,5,3,2,0,1,0,1,0,7,1.0,1,0.0,0,2,0,1,3,0,0,1,0,3,4,1
2691,67616,GkpBYL5A7XxQyiiOJwD69PHsUVDvMfPz,SpATywNh6bZuzm8s1ceuBUnMUAeoAHHw,5,4,3,0,1,0,1,0,9,1.2857142857142858,1,0.0,0,3,0,1,4,0,0,1,0,4,5,0
2692,67655,tkE1JI2oJkZLA1XOzEZ3Jn8IFDQS4QJ9,G8EPVSXsOYB5YQWZGiz1aVq5Pgr2GrQu,30,30,8,53,3,2,3,0,99,14.142857142857142,1,0.0,20,8,39,3,10,2,14,3,0,70,29,0
2693,67710,zDAtaSKsAJQmmJ6xHQBbAGN68vDebyev,SpATywNh6bZuzm8s1ceuBUnMUAeoAHHw,1,0,0,0,0,0,1,0,1,0.14285714285714285,1,0.0,0,0,0,0,0,0,0,1,0,0,1,0
2694,67781,bavq9pAJWJ3ks5oNWHTGf2k9koDwXsAH,RXDvfPUBYFlVdlueBFbLW0mhhAyGEqpt,1,0,0,0,0,0,1,0,1,0.14285714285714285,1,0.0,0,0,0,0,0,0,0,1,0,0,1,1
2695,67820,opdILbT2IBFIYJvyIT5NXM7ymKeuMTcM,SpATywNh6bZuzm8s1ceuBUnMUAeoAHHw,25,41,30,17,12,25,10,1,136,19.428571428571427,2,0.0,6,30,14,12,35,25,3,10,1,62,74,0
2696,67853,oseHKim5ugRciFh8lXIQ174blllPPfFO,SpATywNh6bZuzm8s1ceuBUnMUAeoAHHw,19,39,18,18,4,17,13,4,113,16.142857142857142,2,0.0,3,18,15,4,36,17,3,13,4,40,73,0
2697,67876,yTPe4A1Cw5qKDjYpFW5H73VItf0UPFbm,SpATywNh6bZuzm8s1ceuBUnMUAeoAHHw,5,5,2,0,1,0,1,0,9,1.2857142857142858,1,0.0,0,2,0,1,5,0,0,1,0,3,6,1
2698,67901,8qABUnBBHxxZkfUhEQNUn5NNMSRrqvPC,RXDvfPUBYFlVdlueBFbLW0mhhAyGEqpt,17,14,8,24,0,0,1,0,47,6.714285714285714,1,0.0,4,8,24,0,10,0,0,1,0,36,11,1
2699,67942,PXSCTSolyT6nzbTsv2Nsca26yVAoeW5q,SpATywNh6bZuzm8s1ceuBUnMUAeoAHHw,12,8,6,0,4,0,1,0,19,2.7142857142857144,1,0.0,1,6,0,4,7,0,0,1,0,11,8,0
2700,67943,jR4AfVlqsecU2OD2EAAPnmIP3mzjfI1q,bWdj2GDclj5ofokWjzoa5jAwMkxCykd6,5,5,3,0,2,0,3,0,13,1.8571428571428572,2,0.0,0,3,0,2,5,0,0,3,0,5,8,1
2701,67960,up9RsivyokQDdIY9XjceWgPIaWSXiHeb,SpATywNh6bZuzm8s1ceuBUnMUAeoAHHw,11,37,1,0,1,8,9,1,57,8.142857142857142,1,0.0,0,1,0,1,37,8,0,9,1,2,55,1
2702,68017,Ea76prVlgHXbifiTXOy9yoJBa7oRFv41,SpATywNh6bZuzm8s1ceuBUnMUAeoAHHw,7,6,1,0,1,0,1,0,9,1.2857142857142858,1,0.0,1,1,0,1,5,0,0,1,0,3,6,1
2703,68021,YxdX3NPpzVJ59dpoBODWSD8Noi3lkajj,G8EPVSXsOYB5YQWZGiz1aVq5Pgr2GrQu,13,9,6,0,4,2,6,8,35,5.0,2,0.0,0,6,0,4,9,2,0,6,8,10,25,0
2704,68061,Y0xpzPU1KVTtj1ZRV6oETnVQafrG6Rxw,G8EPVSXsOYB5YQWZGiz1aVq5Pgr2GrQu,2,0,0,0,0,0,2,0,2,0.2857142857142857,1,0.0,0,0,0,0,0,0,0,2,0,0,2,1
2705,68088,GIsRCDxWVYGm4So2chhYPzgj7oVxCsSB,RXDvfPUBYFlVdlueBFbLW0mhhAyGEqpt,5,3,1,0,1,0,1,0,6,0.8571428571428571,1,0.0,0,1,0,1,3,0,0,1,0,2,4,1
2706,68110,aIu8QzWjQFPb4qaDfl0P1tztYuItpL4R,RXDvfPUBYFlVdlueBFbLW0mhhAyGEqpt,3,2,1,0,0,0,1,0,4,0.5714285714285714,1,0.0,0,1,0,0,2,0,0,1,0,1,3,1
2707,68159,8PUTYY5GxR5hJrTB9VGuf6OwgmQYLlz6,SpATywNh6bZuzm8s1ceuBUnMUAeoAHHw,3,2,1,0,0,0,1,0,4,0.5714285714285714,1,0.0,0,1,0,0,2,0,0,1,0,1,3,1
2708,68181,wCP7MM6FfvdZx8uOqp7AG8m1oFJcqLHB,SpATywNh6bZuzm8s1ceuBUnMUAeoAHHw,9,15,8,0,1,0,3,0,27,3.857142857142857,2,0.0,3,8,0,1,12,0,0,3,0,12,15,1
2709,68194,3F9rh0xtO3MPjBfGcFPCm9PRbwYuY4I3,SpATywNh6bZuzm8s1ceuBUnMUAeoAHHw,10,18,1,0,1,0,3,0,23,3.2857142857142856,2,0.0,0,1,0,1,18,0,0,3,0,2,21,1
2710,68241,i2PPXz5Z5PB2ZfiVAI64TcWxYgJR1QQ1,RXDvfPUBYFlVdlueBFbLW0mhhAyGEqpt,3,2,1,0,0,0,1,0,4,0.5714285714285714,1,0.0,0,1,0,0,2,0,0,1,0,1,3,1
2711,68263,pbaQcU38LWlEY15kC2Yb0jdLNtMAYhsA,SpATywNh6bZuzm8s1ceuBUnMUAeoAHHw,8,28,18,0,6,0,2,0,54,7.714285714285714,2,0.0,4,18,0,6,24,0,0,2,0,28,26,0
2712,68273,1qOWHE2SxHYAOzNCTuiHl1kSZUHL0gyU,SpATywNh6bZuzm8s1ceuBUnMUAeoAHHw,20,41,18,10,7,0,12,1,89,12.714285714285714,1,0.0,9,18,8,7,32,0,2,12,1,42,47,0
2713,68296,b1g4AWG6A2zG5plnQY4paLSHRFnrgObC,G8EPVSXsOYB5YQWZGiz1aVq5Pgr2GrQu,2,1,1,0,0,0,0,0,2,0.2857142857142857,1,0.0,0,1,0,0,1,0,0,0,0,1,1,1
2714,68332,hJo1MgKiPZFXuH2ko6hqPTd9dbjMQKDO,SpATywNh6bZuzm8s1ceuBUnMUAeoAHHw,3,2,0,0,0,0,1,0,3,0.42857142857142855,1,0.0,0,0,0,0,2,0,0,1,0,0,3,0
2715,68352,clbUGnOQsN7CuaV7idGJ2LVbYN3t8qC3,SpATywNh6bZuzm8s1ceuBUnMUAeoAHHw,2,1,0,0,0,0,1,0,2,0.2857142857142857,1,0.0,0,0,0,0,1,0,0,1,0,0,2,0
2716,68364,2FyRSMemMx0WQNXDNdLObUL8ox2VWXod,SpATywNh6bZuzm8s1ceuBUnMUAeoAHHw,23,30,20,14,13,0,3,0,80,11.428571428571429,2,0.0,2,20,13,13,28,0,1,3,0,48,32,1
2717,68379,b4M5OphEGf9HhlcR04bazUL6wKV8uIkU,G8EPVSXsOYB5YQWZGiz1aVq5Pgr2GrQu,30,46,3,60,0,28,5,0,142,20.285714285714285,2,0.0,1,3,52,0,45,28,8,5,0,56,86,1
2718,68412,0KxBv7TNEUj27dsp2zMGG4WpBswpgOyf,SpATywNh6bZuzm8s1ceuBUnMUAeoAHHw,4,4,3,0,0,0,2,0,9,1.2857142857142858,1,0.0,0,3,0,0,4,0,0,2,0,3,6,0
2719,68439,6H5tZYvQXUXA5x38gvAZ0WgqLjIkqn3b,SpATywNh6bZuzm8s1ceuBUnMUAeoAHHw,3,2,1,0,0,0,1,0,4,0.5714285714285714,1,0.0,0,1,0,0,2,0,0,1,0,1,3,1
2720,68494,yvCmfQ3z3fMLbjXX0h1AIIPVh4np9hhq,SpATywNh6bZuzm8s1ceuBUnMUAeoAHHw,18,20,12,19,5,0,7,0,63,9.0,2,0.0,5,12,17,5,15,0,2,7,0,39,24,0
2721,68496,SI82MK5h5zRoUuXAAtKY5ltobDSBBXh9,bWdj2GDclj5ofokWjzoa5jAwMkxCykd6,20,28,15,62,8,0,9,1,123,17.571428571428573,1,0.0,9,15,58,8,19,0,4,9,1,90,33,1
2722,68563,8fwUYmiU3p577nM1EutDr5QOZIKfzBRc,RXDvfPUBYFlVdlueBFbLW0mhhAyGEqpt,28,42,25,42,9,29,13,3,163,23.285714285714285,4,0.0,6,25,39,9,36,29,3,13,3,79,84,0
2723,68623,F5DvCuAufOHMNW6g3uuO7OUr15Bgdj9y,SpATywNh6bZuzm8s1ceuBUnMUAeoAHHw,13,21,0,14,0,2,4,0,41,5.857142857142857,2,0.0,7,0,12,0,14,2,2,4,0,19,22,0
2724,68675,ZBFATksKEZIW0yZpEc4DInpubrEeq3eS,SpATywNh6bZuzm8s1ceuBUnMUAeoAHHw,4,3,2,0,1,0,0,0,6,0.8571428571428571,1,0.0,0,2,0,1,3,0,0,0,0,3,3,1
2725,68686,YRBA7GRiLrrlZjduaK8N9tfqRO36138H,SpATywNh6bZuzm8s1ceuBUnMUAeoAHHw,11,16,8,18,1,0,3,0,46,6.571428571428571,2,0.0,2,8,17,1,14,0,1,3,0,28,18,0
2726,68690,vsAcPV04LnM01WalbcA4jNxiuu2qNyeQ,SpATywNh6bZuzm8s1ceuBUnMUAeoAHHw,13,20,1,15,0,9,3,0,48,6.857142857142857,3,0.0,6,1,15,0,14,9,0,3,0,22,26,0
2727,68694,SPA2zjP6CEFeNMb3HCTy4jT9WpFTBDct,SpATywNh6bZuzm8s1ceuBUnMUAeoAHHw,17,20,7,18,4,0,2,0,51,7.285714285714286,1,0.0,3,7,17,4,17,0,1,2,0,31,20,1
2728,68715,naqtjO9tZgTvMaAs9wVFgT7OrPAljiOn,bWdj2GDclj5ofokWjzoa5jAwMkxCykd6,1,0,0,0,0,0,1,0,1,0.14285714285714285,1,0.0,0,0,0,0,0,0,0,1,0,0,1,1
2729,68744,Gt9BtVmn4m8oLlyiIlUegGAp2m9g8UFD,SpATywNh6bZuzm8s1ceuBUnMUAeoAHHw,6,4,3,0,1,0,2,0,10,1.4285714285714286,1,0.0,0,3,0,1,4,0,0,2,0,4,6,1
2730,68831,SmLgezr6vw2mXwO7w10XynKKHaO5xE5n,SpATywNh6bZuzm8s1ceuBUnMUAeoAHHw,16,17,7,8,4,3,5,1,45,6.428571428571429,1,0.0,3,7,8,4,14,3,0,5,1,22,23,1
2731,68843,B2BG30LLtuU2kSL0uylbi1RWlBzZcLDB,SpATywNh6bZuzm8s1ceuBUnMUAeoAHHw,7,4,2,0,2,0,2,0,10,1.4285714285714286,1,0.0,0,2,0,2,4,0,0,2,0,4,6,1
2732,68844,EleMlloryvuXR0G9AOtui0gfdXfrUQfc,SpATywNh6bZuzm8s1ceuBUnMUAeoAHHw,6,6,0,0,0,0,8,2,16,2.2857142857142856,1,0.0,0,0,0,0,6,0,0,8,2,0,16,1
2733,68868,FvJCcTNYroCUcSPHSotcunzGZyPy4Qi0,SpATywNh6bZuzm8s1ceuBUnMUAeoAHHw,1,0,0,0,0,0,1,0,1,0.14285714285714285,1,0.0,0,0,0,0,0,0,0,1,0,0,1,1
2734,68880,abcXzTNrOBL75IbG8Oh34uJmizkY4tz5,SpATywNh6bZuzm8s1ceuBUnMUAeoAHHw,5,2,0,0,0,0,5,3,10,1.4285714285714286,1,0.0,0,0,0,0,2,0,0,5,3,0,10,1
2735,68881,8cN2OVniTirjZQCsN0ZQrtldoXZmf2q1,SpATywNh6bZuzm8s1ceuBUnMUAeoAHHw,1,0,0,0,0,0,1,0,1,0.14285714285714285,1,0.0,0,0,0,0,0,0,0,1,0,0,1,1
2736,68888,de81RIzfVtIgQfKrUlwLBazhrka9zYFQ,RXDvfPUBYFlVdlueBFbLW0mhhAyGEqpt,29,15,9,50,5,2,1,0,82,11.714285714285714,1,0.0,5,9,50,5,10,2,0,1,0,69,13,1
2737,68902,ZNvFH7xCRnWt4senPXcU6KKoaNuuuPfc,SpATywNh6bZuzm8s1ceuBUnMUAeoAHHw,15,13,9,8,4,8,6,1,49,7.0,1,0.0,1,9,7,4,12,8,1,6,1,21,28,1
2738,68909,dgs5q517os0QP00EQ3rFo0TcrFNCs1kW,RXDvfPUBYFlVdlueBFbLW0mhhAyGEqpt,18,15,7,22,3,0,1,0,48,6.857142857142857,1,0.0,3,7,18,3,12,0,4,1,0,31,17,1
2739,68924,ekbuMTLYQMuR0OvEI2LJUhDBg5Hzduc2,SpATywNh6bZuzm8s1ceuBUnMUAeoAHHw,13,12,7,6,3,4,3,0,35,5.0,1,0.0,0,7,5,3,12,4,1,3,0,15,20,1
2740,68932,yDiB1gdGW97IDQmCuLOgxDpZ8bOAbVfO,SpATywNh6bZuzm8s1ceuBUnMUAeoAHHw,10,3,3,0,3,0,3,0,12,1.7142857142857142,1,0.0,0,3,0,3,3,0,0,3,0,6,6,1
2741,68936,FsS49SZqT6XuQy2tX0gejqco4jQwOMN4,SpATywNh6bZuzm8s1ceuBUnMUAeoAHHw,26,27,15,21,7,0,1,0,71,10.142857142857142,1,0.0,11,15,17,7,16,0,4,1,0,50,21,0
2742,68939,qUJHOEJOIUq6GHsEj06xYmT7rQa6YMuP,SpATywNh6bZuzm8s1ceuBUnMUAeoAHHw,7,4,3,0,2,0,1,0,10,1.4285714285714286,1,0.0,0,3,0,2,4,0,0,1,0,5,5,1
2743,68944,iLiEQfwv1SBVYie6f2UeSo0gjqwSPq60,SpATywNh6bZuzm8s1ceuBUnMUAeoAHHw,2,1,1,0,0,0,0,0,2,0.2857142857142857,1,0.0,0,1,0,0,1,0,0,0,0,1,1,1
2744,68957,03OlEjthtH7bdIcwtrFwO8IymW2gZt4t,SpATywNh6bZuzm8s1ceuBUnMUAeoAHHw,5,6,2,0,1,0,2,0,11,1.5714285714285714,1,0.0,0,2,0,1,6,0,0,2,0,3,8,0
2745,68961,Ivwf4DZ9PeaEe6riRbe3YhY3mU61V7Rv,SpATywNh6bZuzm8s1ceuBUnMUAeoAHHw,8,6,3,0,2,0,2,0,13,1.8571428571428572,1,0.0,1,3,0,2,5,0,0,2,0,6,7,1
2746,68965,wyjPcrAJWPhHnDHJIjk8dYEEg9jaoLeO,A3fsA9Zfv1X2fVEQhTw51lKENdNrEqT3,1,0,0,0,0,0,1,0,1,0.14285714285714285,1,0.0,0,0,0,0,0,0,0,1,0,0,1,1
2747,68982,jvjNqoblvibp0tKoaV1BTGpJ4j9v7r5a,SpATywNh6bZuzm8s1ceuBUnMUAeoAHHw,5,7,2,0,1,0,2,0,12,1.7142857142857142,1,0.0,3,2,0,1,4,0,0,2,0,6,6,0
2748,68983,drUu3tyovHqnF7EAaPHayHDYbWMe2Od6,SpATywNh6bZuzm8s1ceuBUnMUAeoAHHw,1,0,0,0,0,0,1,0,1,0.14285714285714285,1,0.0,0,0,0,0,0,0,0,1,0,0,1,1
2749,68985,xHLXHkY22B9ev5t6W5YAgehgj6yjfueC,bWdj2GDclj5ofokWjzoa5jAwMkxCykd6,2,0,0,0,0,0,3,0,3,0.42857142857142855,1,0.0,0,0,0,0,0,0,0,3,0,0,3,1
2750,68990,Plvb7aRlGh6MOUAvNEeJPeQdOD4FTpby,SpATywNh6bZuzm8s1ceuBUnMUAeoAHHw,6,2,1,0,1,0,4,0,8,1.1428571428571428,1,0.0,0,1,0,1,2,0,0,4,0,2,6,1
2751,69002,f6sYAy41OQsdqlcuUmQWoHmf9GvB4eiI,SpATywNh6bZuzm8s1ceuBUnMUAeoAHHw,8,8,3,0,1,0,7,0,19,2.7142857142857144,2,0.0,0,3,0,1,8,0,0,7,0,4,15,1
2752,69030,fvADHkZjzAohNYEqPdzq6kjINkcTeJGs,SpATywNh6bZuzm8s1ceuBUnMUAeoAHHw,1,0,0,0,0,0,1,0,1,0.14285714285714285,1,0.0,0,0,0,0,0,0,0,1,0,0,1,1
2753,69035,Z71mo3axv3ChUzLxRVr9u5krFj7IoCv8,SpATywNh6bZuzm8s1ceuBUnMUAeoAHHw,1,0,0,0,0,0,1,0,1,0.14285714285714285,1,0.0,0,0,0,0,0,0,0,1,0,0,1,1
2754,69046,iOxekl9VdW2ENNqFsiAkjUDt6XuQIiCO,G8EPVSXsOYB5YQWZGiz1aVq5Pgr2GrQu,9,4,0,0,0,1,8,1,14,2.0,1,0.0,0,0,0,0,4,1,0,8,1,0,14,1
2755,69051,NCEmznACf7J3BIMI6JIs4ZzQnHlfSjOZ,SpATywNh6bZuzm8s1ceuBUnMUAeoAHHw,2,0,0,0,0,0,2,0,2,0.2857142857142857,1,0.0,0,0,0,0,0,0,0,2,0,0,2,1
2756,69066,0a6HihupPBi4xpjolN637qOYG6WSN1Gx,SpATywNh6bZuzm8s1ceuBUnMUAeoAHHw,14,28,17,0,8,0,5,0,58,8.285714285714286,3,0.0,6,17,0,8,22,0,0,5,0,31,27,0
2757,69070,g5yKalRrHBvoyNkzpNTa67etQfVwykko,SpATywNh6bZuzm8s1ceuBUnMUAeoAHHw,18,17,7,16,5,0,1,0,46,6.571428571428571,1,0.0,3,7,14,5,14,0,2,1,0,29,17,0
2758,69076,cy1UxkAxcqJswFy9Syqm01bsE17PQcla,SpATywNh6bZuzm8s1ceuBUnMUAeoAHHw,7,12,7,0,3,0,3,0,25,3.5714285714285716,2,0.0,0,7,0,3,12,0,0,3,0,10,15,0
2759,69081,BByvTH8isxSvKoMrLrxzWQ5eR0EYxeSe,SpATywNh6bZuzm8s1ceuBUnMUAeoAHHw,6,2,2,0,1,1,2,0,8,1.1428571428571428,1,0.0,0,2,0,1,2,1,0,2,0,3,5,1
2760,69088,tZsLQPiwQA1iRhDP7AIV5FXBJBCNasRN,SpATywNh6bZuzm8s1ceuBUnMUAeoAHHw,5,3,1,0,1,0,2,0,7,1.0,1,0.0,0,1,0,1,3,0,0,2,0,2,5,1
2761,69090,jtRxF2WWWP8ViskFgfl6yKIsTs5XUZVy,SpATywNh6bZuzm8s1ceuBUnMUAeoAHHw,5,2,1,0,1,0,2,0,6,0.8571428571428571,1,0.0,0,1,0,1,2,0,0,2,0,2,4,1
2762,69096,JsUpucQyiTLV5gDB7KrgqzRdiUsoUyeZ,SpATywNh6bZuzm8s1ceuBUnMUAeoAHHw,1,0,0,0,0,0,1,0,1,0.14285714285714285,1,0.0,0,0,0,0,0,0,0,1,0,0,1,1
2763,69098,EXVoxE3v0YCKVCUy0azISc65MiXBDpAw,SpATywNh6bZuzm8s1ceuBUnMUAeoAHHw,5,3,1,0,1,0,1,0,6,0.8571428571428571,1,0.0,0,1,0,1,3,0,0,1,0,2,4,1
2764,69099,JQSlrp0DjB9to2Jj4hPDSm3T2LtQheyt,SpATywNh6bZuzm8s1ceuBUnMUAeoAHHw,1,0,0,0,0,0,1,0,1,0.14285714285714285,1,0.0,0,0,0,0,0,0,0,1,0,0,1,1
2765,69111,1pa7pgDaPKVXrmbNpHMbk5nmhTlNRGem,bWdj2GDclj5ofokWjzoa5jAwMkxCykd6,1,0,0,0,0,0,1,0,1,0.14285714285714285,1,0.0,0,0,0,0,0,0,0,1,0,0,1,1
2766,69118,27R6lnSTl4HmEumP2huFCqg7wjTw1o6f,SpATywNh6bZuzm8s1ceuBUnMUAeoAHHw,10,9,4,0,1,1,6,1,22,3.142857142857143,1,0.0,0,4,0,1,9,1,0,6,1,5,17,1
2767,69127,y7mamutAMELy79Bgdj0zOeVjiQ071oNX,bWdj2GDclj5ofokWjzoa5jAwMkxCykd6,3,2,1,0,0,0,2,0,5,0.7142857142857143,1,0.0,0,1,0,0,2,0,0,2,0,1,4,1
2768,69130,pGYLDmhkSj1iBp1YljlDSId0XSrjZNZR,SpATywNh6bZuzm8s1ceuBUnMUAeoAHHw,16,18,11,8,5,0,5,0,47,6.714285714285714,5,0.0,2,11,8,5,16,0,0,5,0,26,21,1
2769,69136,dcJzvjKrpatpLnXddQ3Vx9PLCNP0aaAz,SpATywNh6bZuzm8s1ceuBUnMUAeoAHHw,5,2,1,0,1,0,2,0,6,0.8571428571428571,1,0.0,0,1,0,1,2,0,0,2,0,2,4,1
2770,69138,C5Rja3fyOmRxfpM2pXQmwA2G5rEfb320,SpATywNh6bZuzm8s1ceuBUnMUAeoAHHw,13,33,0,11,0,0,3,0,47,6.714285714285714,1,0.0,6,0,10,0,27,0,1,3,0,16,31,1
2771,69142,YLA48gUHn1Dc2R5xXAOe8bpBqZ5RWVW4,bWdj2GDclj5ofokWjzoa5jAwMkxCykd6,1,0,0,0,0,0,1,0,1,0.14285714285714285,1,0.0,0,0,0,0,0,0,0,1,0,0,1,1
2772,69163,Oc5qPJBdwZoUrwnszLfpz6LxBxG1LBA2,SpATywNh6bZuzm8s1ceuBUnMUAeoAHHw,1,0,0,0,0,0,1,0,1,0.14285714285714285,1,0.0,0,0,0,0,0,0,0,1,0,0,1,1
2773,69170,RfZCGgQvqSwCxzUkNgQBjxizWHoR00JV,SpATywNh6bZuzm8s1ceuBUnMUAeoAHHw,1,0,0,0,0,0,1,0,1,0.14285714285714285,1,0.0,0,0,0,0,0,0,0,1,0,0,1,1
2774,69172,g2ieOC0GwkKqaZWeJNXowTArkXtXRKC6,SpATywNh6bZuzm8s1ceuBUnMUAeoAHHw,1,0,0,0,0,0,1,0,1,0.14285714285714285,1,0.0,0,0,0,0,0,0,0,1,0,0,1,0
2775,69179,WX5bge9EFbPypYuObEiSD1Gyvh8Z866G,A3fsA9Zfv1X2fVEQhTw51lKENdNrEqT3,7,4,1,0,1,0,2,0,8,1.1428571428571428,1,0.0,0,1,0,1,4,0,0,2,0,2,6,1
2776,69184,2qz1ezmlR3R3fKwgJceAEHpik5SGv87j,SpATywNh6bZuzm8s1ceuBUnMUAeoAHHw,1,0,0,0,0,0,1,0,1,0.14285714285714285,1,0.0,0,0,0,0,0,0,0,1,0,0,1,1
2777,69193,R8klv9uflG5co96NLU45hbr8n54FLcZh,SpATywNh6bZuzm8s1ceuBUnMUAeoAHHw,1,0,0,0,0,0,1,0,1,0.14285714285714285,1,0.0,0,0,0,0,0,0,0,1,0,0,1,1
2778,69194,pngME6c5Y6LdP7X9v20FCeYjZ97OMCQR,SpATywNh6bZuzm8s1ceuBUnMUAeoAHHw,11,7,1,11,0,1,4,1,25,3.5714285714285716,1,0.0,2,1,10,0,5,1,1,4,1,13,12,1
2779,69199,CpruMjpYp2wLmRpTC4dJZ8iwMDhltzag,RXDvfPUBYFlVdlueBFbLW0mhhAyGEqpt,1,0,0,0,0,0,1,0,1,0.14285714285714285,1,0.0,0,0,0,0,0,0,0,1,0,0,1,1
2780,69213,WX5bge9EFbPypYuObEiSD1Gyvh8Z866G,bWdj2GDclj5ofokWjzoa5jAwMkxCykd6,9,4,2,12,2,0,2,0,22,3.142857142857143,1,0.0,1,2,11,2,3,0,1,2,0,16,6,0
2781,69218,YZJnbvfbnhVRirLqDRHGzQv4606Wu6TO,bWdj2GDclj5ofokWjzoa5jAwMkxCykd6,7,9,6,0,3,0,3,0,21,3.0,2,0.0,1,6,0,3,8,0,0,3,0,10,11,1
2782,69224,65ggrHSAXoVCOK75IinKW9i4EJF8EDcN,SpATywNh6bZuzm8s1ceuBUnMUAeoAHHw,6,3,1,0,1,0,2,0,7,1.0,1,0.0,0,1,0,1,3,0,0,2,0,2,5,1
2783,69233,W8K4VS8rPvnPTNUJrqgtS2FKH93KmR91,A3fsA9Zfv1X2fVEQhTw51lKENdNrEqT3,66,34,17,194,17,0,2,0,264,37.714285714285715,2,0.0,2,17,166,17,32,0,28,2,0,202,62,1
2784,69258,8O10QoLvReRhqOHRxozXCjfp01CP9Y6X,RXDvfPUBYFlVdlueBFbLW0mhhAyGEqpt,5,2,1,0,1,0,2,0,6,0.8571428571428571,1,0.0,0,1,0,1,2,0,0,2,0,2,4,1
2785,69261,Y0yiSfPX9V0A8oNPfdzCuT5yHRuHvSj6,SpATywNh6bZuzm8s1ceuBUnMUAeoAHHw,7,5,4,0,1,0,2,1,13,1.8571428571428572,1,0.0,0,4,0,1,5,0,0,2,1,5,8,1
2786,69266,ZutC6FPMJvnUSI7oc7F8Om4NpwtKuyEH,SpATywNh6bZuzm8s1ceuBUnMUAeoAHHw,8,5,2,0,2,0,3,0,12,1.7142857142857142,1,0.0,0,2,0,2,5,0,0,3,0,4,8,1
2787,69270,2XqSSCGvWuNVBTm3MCFePDMOSuloLKPQ,SpATywNh6bZuzm8s1ceuBUnMUAeoAHHw,7,3,1,0,1,3,3,0,11,1.5714285714285714,2,0.0,0,1,0,1,3,3,0,3,0,2,9,1
2788,69273,61kObDGseAVKKKJnoykLCdN2clfrzPTZ,SpATywNh6bZuzm8s1ceuBUnMUAeoAHHw,7,8,4,0,3,0,1,0,16,2.2857142857142856,1,0.0,0,4,0,3,8,0,0,1,0,7,9,1
2789,69295,NGQ6HXbhxwBlJxikVxca5noX2u8xI9AV,bWdj2GDclj5ofokWjzoa5jAwMkxCykd6,17,17,7,50,10,0,1,0,85,12.142857142857142,1,0.0,9,7,43,10,8,0,7,1,0,69,16,0
2790,69304,JR238GZjZ1ruNiJtwVaWypz6LFnrEv5m,A3fsA9Zfv1X2fVEQhTw51lKENdNrEqT3,8,3,1,0,0,1,7,1,13,1.8571428571428572,1,0.0,0,1,0,0,3,1,0,7,1,1,12,1
2791,69313,JZ8D07WpMQUIA2O2a3f2Q2gV7h70rqbC,SpATywNh6bZuzm8s1ceuBUnMUAeoAHHw,15,19,9,8,4,30,5,0,75,10.714285714285714,2,0.0,7,9,7,4,12,30,1,5,0,27,48,1
2792,69343,hSBgpCIALinoasvGugUi15XiQqzIP0W5,SpATywNh6bZuzm8s1ceuBUnMUAeoAHHw,11,34,10,0,6,1,16,0,67,9.571428571428571,2,0.0,0,10,0,6,34,1,0,16,0,16,51,1
2793,69344,mAEhdvjtLD2ESiLI6ko7GgTTKTJ1f5Tn,SpATywNh6bZuzm8s1ceuBUnMUAeoAHHw,4,9,2,0,0,0,1,0,12,1.7142857142857142,1,0.0,6,2,0,0,3,0,0,1,0,8,4,1
2794,69346,4G8hhK38eDoUtZ2viIFKnYiWqmC4nF56,SpATywNh6bZuzm8s1ceuBUnMUAeoAHHw,6,15,2,0,0,0,5,0,22,3.142857142857143,2,0.0,10,2,0,0,5,0,0,5,0,12,10,1
2795,69347,mhllqKKDFjXI3RWMG7mLE4M16FOLrFxr,SpATywNh6bZuzm8s1ceuBUnMUAeoAHHw,4,3,1,0,1,1,1,0,7,1.0,1,0.0,0,1,0,1,3,1,0,1,0,2,5,1
2796,69364,4cOOYrtQdvpiZuIPnsoBt4lhRdbqEcsp,SpATywNh6bZuzm8s1ceuBUnMUAeoAHHw,12,13,0,12,0,0,1,0,26,3.7142857142857144,1,0.0,5,0,12,0,8,0,0,1,0,17,9,1
2797,69369,uMEUDlZ1tL8WoZ2EmL0CStSYwA0zOal8,bWdj2GDclj5ofokWjzoa5jAwMkxCykd6,3,2,1,0,0,0,1,0,4,0.5714285714285714,1,0.0,0,1,0,0,2,0,0,1,0,1,3,1
2798,69370,YsoUugdKj0wstrontIOHZ151jgNGqxCe,G8EPVSXsOYB5YQWZGiz1aVq5Pgr2GrQu,8,6,3,0,2,0,3,0,14,2.0,2,0.0,0,3,0,2,6,0,0,3,0,5,9,1
2799,69386,yeibveOoJwlHHcJycB6lhQvIP04mhNkZ,SpATywNh6bZuzm8s1ceuBUnMUAeoAHHw,7,11,0,0,0,0,1,0,12,1.7142857142857142,1,0.0,1,0,0,0,10,0,0,1,0,1,11,1
2800,69392,TmRAKP6Cldz70hzdom0pqdRRs9qbBLvD,SpATywNh6bZuzm8s1ceuBUnMUAeoAHHw,4,1,0,0,0,0,3,0,4,0.5714285714285714,1,0.0,0,0,0,0,1,0,0,3,0,0,4,1
2801,69404,EB2RCe088gjmT7cbJrt6urBwZOusH5vg,SpATywNh6bZuzm8s1ceuBUnMUAeoAHHw,16,24,11,9,5,0,1,0,50,7.142857142857143,1,0.0,8,11,9,5,16,0,0,1,0,33,17,1
2802,69407,cpYO1CIRym9qUpCwm4jnjZ21HfSKew1t,SpATywNh6bZuzm8s1ceuBUnMUAeoAHHw,20,26,1,15,1,4,14,1,62,8.857142857142858,2,0.0,9,1,15,1,17,4,0,14,1,26,36,1
2803,69418,Wb7djzeQ8T0CrP6nbbq8WdqHClynqFRu,SpATywNh6bZuzm8s1ceuBUnMUAeoAHHw,1,0,0,0,0,0,1,0,1,0.14285714285714285,1,0.0,0,0,0,0,0,0,0,1,0,0,1,1
2804,69426,2iC0lVJQRHLawEI3r58K4Wl79T69zQyN,G8EPVSXsOYB5YQWZGiz1aVq5Pgr2GrQu,6,4,0,0,0,2,6,0,12,1.7142857142857142,1,0.0,0,0,0,0,4,2,0,6,0,0,12,1
2805,69435,vPqhvdjrX3GgCAjq6K96tYCv7DiMTBkh,SpATywNh6bZuzm8s1ceuBUnMUAeoAHHw,15,26,0,10,0,0,5,0,41,5.857142857142857,2,0.0,4,0,10,0,22,0,0,5,0,14,27,0
2806,69437,tHPSGx00vsFzhzr0zwBlWWarqJT4wPHF,bWdj2GDclj5ofokWjzoa5jAwMkxCykd6,18,15,10,36,6,0,2,0,69,9.857142857142858,2,0.0,3,10,35,6,12,0,1,2,0,54,15,1
2807,69438,QDpN8D19Mr8RZumTONWpZNlCWcHCCTbH,SpATywNh6bZuzm8s1ceuBUnMUAeoAHHw,5,5,1,0,0,0,2,0,8,1.1428571428571428,2,0.0,0,1,0,0,5,0,0,2,0,1,7,1
2808,69439,WELjmgdsP962Pc1teJ96xvofKraKe6qa,A3fsA9Zfv1X2fVEQhTw51lKENdNrEqT3,2,0,0,0,0,4,2,0,6,0.8571428571428571,2,0.0,0,0,0,0,0,4,0,2,0,0,6,1
2809,69443,JnRbwXg3XGYAmOXQP1OiJxv44LsKYQS5,SpATywNh6bZuzm8s1ceuBUnMUAeoAHHw,21,22,1,26,1,5,8,1,64,9.142857142857142,2,0.0,7,1,23,1,15,5,3,8,1,32,32,0
2810,69444,sfdgnQL9ZJy8iQoJsTh6pz33V1sjsZlD,A3fsA9Zfv1X2fVEQhTw51lKENdNrEqT3,11,11,8,0,5,0,3,0,27,3.857142857142857,1,0.0,0,8,0,5,11,0,0,3,0,13,14,0
2811,69452,30KFUYZeibWx0Iky00wqYaxS7YWNwWx4,SpATywNh6bZuzm8s1ceuBUnMUAeoAHHw,5,5,2,0,1,0,1,0,9,1.2857142857142858,1,0.0,0,2,0,1,5,0,0,1,0,3,6,1
2812,69466,DcPL5Zur8S33yRX2fv1HxqidGklhFV5P,SpATywNh6bZuzm8s1ceuBUnMUAeoAHHw,22,31,17,18,7,2,9,1,85,12.142857142857142,2,0.0,9,17,15,7,22,2,3,9,1,48,37,1
2813,69471,x9up4wvnaS79M9udGA7fqhv1sigb86bK,SpATywNh6bZuzm8s1ceuBUnMUAeoAHHw,6,3,2,0,1,0,2,0,8,1.1428571428571428,1,0.0,0,2,0,1,3,0,0,2,0,3,5,1
2814,69477,FlAkKX6ow9SvOzk0dTWPWgnX5766zY29,G8EPVSXsOYB5YQWZGiz1aVq5Pgr2GrQu,21,28,12,30,9,0,3,0,82,11.714285714285714,2,0.0,5,12,25,9,23,0,5,3,0,51,31,0
2815,69478,8tkFlxYnls5Mxd2ekCeWIpaKuJe1mR6W,G8EPVSXsOYB5YQWZGiz1aVq5Pgr2GrQu,19,25,8,12,8,4,6,1,64,9.142857142857142,1,0.0,15,8,7,8,10,4,5,6,1,38,26,1
2816,69500,pNxcbeMWYcUZBxJCtPF9qmCQyBYd1bU7,SpATywNh6bZuzm8s1ceuBUnMUAeoAHHw,29,36,18,32,9,2,10,0,107,15.285714285714286,2,0.0,14,18,30,9,22,2,2,10,0,71,36,1
2817,69536,F6yoJDYdOCdZg3HrTm4YkvnDfcsvPtnN,SpATywNh6bZuzm8s1ceuBUnMUAeoAHHw,7,6,3,0,2,0,1,0,12,1.7142857142857142,1,0.0,0,3,0,2,6,0,0,1,0,5,7,1
2818,69538,RCYov8DEPqszWUDtrunbywhn5eFESjlB,SpATywNh6bZuzm8s1ceuBUnMUAeoAHHw,16,22,8,9,5,7,5,1,57,8.142857142857142,1,0.0,9,8,9,5,13,7,0,5,1,31,26,1
2819,69540,a160ewxyRJdtN45GnX3uGxkLMyeZKvV7,bWdj2GDclj5ofokWjzoa5jAwMkxCykd6,10,8,5,0,1,0,8,1,23,3.2857142857142856,1,0.0,0,5,0,1,8,0,0,8,1,6,17,1
2820,69543,ZAi0jAKRdwQEtga2Yygb9adNtNc26TKH,SpATywNh6bZuzm8s1ceuBUnMUAeoAHHw,7,6,3,0,1,0,2,0,12,1.7142857142857142,1,0.0,2,3,0,1,4,0,0,2,0,6,6,1
2821,69548,cjgnRFcpPxhUwluGuMHbhKtpIo8g67oX,SpATywNh6bZuzm8s1ceuBUnMUAeoAHHw,5,2,1,0,1,0,5,0,9,1.2857142857142858,1,0.0,0,1,0,1,2,0,0,5,0,2,7,1
2822,69561,Z4SPpJfwg3kmbYmCX1430X6xnjXFgqan,SpATywNh6bZuzm8s1ceuBUnMUAeoAHHw,1,0,0,0,0,0,1,0,1,0.14285714285714285,1,0.0,0,0,0,0,0,0,0,1,0,0,1,1
2823,69567,q3DUInVVvDGT22ACyMKixODyUkgLOKmI,SpATywNh6bZuzm8s1ceuBUnMUAeoAHHw,15,20,14,13,6,0,3,0,56,8.0,2,0.0,4,14,13,6,16,0,0,3,0,37,19,1
2824,69577,zdQpZzeZtdBJrKxe0kkh4zz1KUaEeB2I,G8EPVSXsOYB5YQWZGiz1aVq5Pgr2GrQu,19,12,9,22,5,2,2,0,52,7.428571428571429,1,0.0,1,9,18,5,11,2,4,2,0,33,19,1
2825,69590,aYhMdR5xaez3fr0lBrD6kCxYiCOyculR,SpATywNh6bZuzm8s1ceuBUnMUAeoAHHw,3,0,0,0,0,1,2,0,3,0.42857142857142855,1,0.0,0,0,0,0,0,1,0,2,0,0,3,0
2826,69594,0pQnhOp7TmXmyZJvGFVAPDeo6QapvPWM,SpATywNh6bZuzm8s1ceuBUnMUAeoAHHw,1,0,0,0,0,0,1,0,1,0.14285714285714285,1,0.0,0,0,0,0,0,0,0,1,0,0,1,1
2827,69602,ebvWYER6Bde0EUcNXXIX0vyTB9ur6Kqi,bWdj2GDclj5ofokWjzoa5jAwMkxCykd6,3,2,0,0,0,0,1,0,3,0.42857142857142855,1,0.0,0,0,0,0,2,0,0,1,0,0,3,1
2828,69604,ebvWYER6Bde0EUcNXXIX0vyTB9ur6Kqi,RXDvfPUBYFlVdlueBFbLW0mhhAyGEqpt,7,5,0,0,0,2,5,0,12,1.7142857142857142,1,0.0,1,0,0,0,4,2,0,5,0,1,11,1
2829,69608,luffaRyMH17lmf9lXIITCUvmvLstdhJF,SpATywNh6bZuzm8s1ceuBUnMUAeoAHHw,1,0,0,0,0,0,1,0,1,0.14285714285714285,1,0.0,0,0,0,0,0,0,0,1,0,0,1,1
2830,69609,m6d8SS4M8CUq3BoC3xOyTU0oHsPjDd2w,SpATywNh6bZuzm8s1ceuBUnMUAeoAHHw,4,2,0,0,0,0,2,0,4,0.5714285714285714,1,0.0,0,0,0,0,2,0,0,2,0,0,4,1
2831,69611,nJobBmBuwmDPhO4EIrWUJq110WMVvZw4,SpATywNh6bZuzm8s1ceuBUnMUAeoAHHw,8,4,3,0,2,0,2,0,11,1.5714285714285714,1,0.0,0,3,0,2,4,0,0,2,0,5,6,1
2832,69616,faupOzOQrYnrhUP3CZcXERH5hL8Q3xd2,SpATywNh6bZuzm8s1ceuBUnMUAeoAHHw,7,10,4,0,1,0,1,0,16,2.2857142857142856,1,0.0,3,4,0,1,7,0,0,1,0,8,8,1
2833,69638,nkfthsiEhj5rlE8h2UVfSYWZi1i1pvPD,SpATywNh6bZuzm8s1ceuBUnMUAeoAHHw,25,46,15,22,8,2,7,0,100,14.285714285714286,2,0.0,11,15,19,8,35,2,3,7,0,53,47,1
2834,69643,W17GnVDduKqnwPQhc7qvZa9k2VQEwhjA,G8EPVSXsOYB5YQWZGiz1aVq5Pgr2GrQu,5,2,1,0,1,0,2,0,6,0.8571428571428571,1,0.0,0,1,0,1,2,0,0,2,0,2,4,1
2835,69647,tD4YaA9C1jzNLnr7tPBZ897xHEsnzm9F,SpATywNh6bZuzm8s1ceuBUnMUAeoAHHw,1,0,0,0,0,0,1,0,1,0.14285714285714285,1,0.0,0,0,0,0,0,0,0,1,0,0,1,1
2836,69654,lD3KgUtWok6mjiblbvy163en24cSYNXc,RXDvfPUBYFlVdlueBFbLW0mhhAyGEqpt,1,0,0,0,0,0,1,0,1,0.14285714285714285,1,0.0,0,0,0,0,0,0,0,1,0,0,1,1
2837,69680,tes6smsqnnhtic7mel4he0HOVKxdsIk0,SpATywNh6bZuzm8s1ceuBUnMUAeoAHHw,3,4,2,0,0,0,3,0,9,1.2857142857142858,2,0.0,0,2,0,0,4,0,0,3,0,2,7,1
2838,69684,jKWIhuXmlYFBIapfd4E50TBTHed3oveP,SpATywNh6bZuzm8s1ceuBUnMUAeoAHHw,6,6,3,0,1,0,1,0,11,1.5714285714285714,1,0.0,0,3,0,1,6,0,0,1,0,4,7,1
2839,69690,RsnXePogfsPEsPaBIDmu1zOlkZ0nGsJG,SpATywNh6bZuzm8s1ceuBUnMUAeoAHHw,5,4,2,0,0,0,1,0,7,1.0,1,0.0,0,2,0,0,4,0,0,1,0,2,5,1
2840,69693,Z3XF9lddm62bhylNbOc8gNaNENZtsGVQ,SpATywNh6bZuzm8s1ceuBUnMUAeoAHHw,4,3,1,0,0,0,1,0,5,0.7142857142857143,1,0.0,0,1,0,0,3,0,0,1,0,1,4,1
2841,69697,KCsv9o14hbrQKvzaJVVOUtS9ZXoioMZi,SpATywNh6bZuzm8s1ceuBUnMUAeoAHHw,23,26,16,11,12,0,3,0,68,9.714285714285714,2,0.0,7,16,10,12,19,0,1,3,0,45,23,1
2842,69708,xcD6YWhnGA2xukGmX4eaYrm6VS9ffz1H,RXDvfPUBYFlVdlueBFbLW0mhhAyGEqpt,5,6,4,0,0,0,3,0,13,1.8571428571428572,2,0.0,0,4,0,0,6,0,0,3,0,4,9,0
2843,69709,HkR8egrosmo3p8vvw0Masj2JRYmaSMRW,bWdj2GDclj5ofokWjzoa5jAwMkxCykd6,3,0,0,0,0,1,6,0,7,1.0,2,0.0,0,0,0,0,0,1,0,6,0,0,7,0
2844,69713,8gwjs0B0kUE7stjGZjvEBczr2cXGTwYJ,SpATywNh6bZuzm8s1ceuBUnMUAeoAHHw,10,7,4,6,1,0,1,0,19,2.7142857142857144,1,0.0,2,4,6,1,5,0,0,1,0,13,6,0
2845,69719,o7QNLHma5sLHPf1vf8edH1AxEjwzXjmH,RXDvfPUBYFlVdlueBFbLW0mhhAyGEqpt,4,2,1,0,1,0,1,0,5,0.7142857142857143,1,0.0,0,1,0,1,2,0,0,1,0,2,3,1
2846,69726,MJibuyVypmuBs7BncEuo5i3GOsk8IZAX,SpATywNh6bZuzm8s1ceuBUnMUAeoAHHw,9,5,3,0,1,1,5,0,15,2.142857142857143,1,0.0,0,3,0,1,5,1,0,5,0,4,11,1
2847,69728,RGp0TGYq2GqXU0ffAofLYX0dCiUdIWSh,SpATywNh6bZuzm8s1ceuBUnMUAeoAHHw,9,6,4,0,2,0,4,0,16,2.2857142857142856,2,0.0,0,4,0,2,6,0,0,4,0,6,10,0
2848,69749,1mwVsEWRdpRYvoqkUN67uGNzTUomXEbQ,G8EPVSXsOYB5YQWZGiz1aVq5Pgr2GrQu,22,55,4,0,4,3,8,0,74,10.571428571428571,2,0.0,2,4,0,4,53,3,0,8,0,10,64,1
2849,69750,LITEXQWwZ0HwbfUIw2ZTJ1Nz80g3xPKl,RXDvfPUBYFlVdlueBFbLW0mhhAyGEqpt,5,4,2,0,1,0,1,0,8,1.1428571428571428,1,0.0,0,2,0,1,4,0,0,1,0,3,5,1
2850,69752,WXX8Za7OuZw2MA7QaLNUhKigQ32JFLJo,SpATywNh6bZuzm8s1ceuBUnMUAeoAHHw,11,10,4,1,3,0,2,0,20,2.857142857142857,1,0.0,5,4,1,3,5,0,0,2,0,13,7,1
2851,69774,NiepHsDkcSMT8UZbqGGY6QXqNiJKeyrC,SpATywNh6bZuzm8s1ceuBUnMUAeoAHHw,6,4,1,0,1,0,3,0,9,1.2857142857142858,1,0.0,0,1,0,1,4,0,0,3,0,2,7,1
2852,69776,P1MYDLvlR6YqACMf13Tb8sFZFVWSr1nZ,bWdj2GDclj5ofokWjzoa5jAwMkxCykd6,7,11,0,0,0,0,11,0,22,3.142857142857143,1,0.0,0,0,0,0,11,0,0,11,0,0,22,1
2853,69777,vljlAhHGhHZt2ciFpy2bQxMoEL2SUwdk,G8EPVSXsOYB5YQWZGiz1aVq5Pgr2GrQu,10,5,1,0,0,2,8,1,17,2.4285714285714284,1,0.0,0,1,0,0,5,2,0,8,1,1,16,1
2854,69792,pmTpzYlO4DcSR3Hjn7J1Go0PaUoezH5E,SpATywNh6bZuzm8s1ceuBUnMUAeoAHHw,6,1,1,0,1,0,3,0,6,0.8571428571428571,1,0.0,0,1,0,1,1,0,0,3,0,2,4,1
2855,69800,kzyt7hO7yEeJxQfXO5XM7Bawq3xoVkTz,SpATywNh6bZuzm8s1ceuBUnMUAeoAHHw,1,0,0,0,0,0,1,0,1,0.14285714285714285,1,0.0,0,0,0,0,0,0,0,1,0,0,1,0
2856,69802,2NIeHPnJrY66zbADeGJTptXbk5YYYnSv,G8EPVSXsOYB5YQWZGiz1aVq5Pgr2GrQu,6,3,1,9,0,0,1,0,14,2.0,1,0.0,0,1,7,0,3,0,2,1,0,8,6,1
2857,69808,rDR9DQbHi1eXHd28a6bdjn6YaDG8j833,SpATywNh6bZuzm8s1ceuBUnMUAeoAHHw,4,2,1,0,1,0,1,0,5,0.7142857142857143,1,0.0,0,1,0,1,2,0,0,1,0,2,3,1
2858,69809,j7794Az14TTh7tEEmhTpADHq4ipGllnd,SpATywNh6bZuzm8s1ceuBUnMUAeoAHHw,18,20,11,18,5,16,7,0,77,11.0,3,0.0,6,11,14,5,14,16,4,7,0,36,41,0
2859,69811,RN9YqqNsHa7lmCtbb4sE8JmcbttJklXE,SpATywNh6bZuzm8s1ceuBUnMUAeoAHHw,13,15,2,0,2,31,12,2,64,9.142857142857142,2,0.0,0,2,0,2,15,31,0,12,2,4,60,1
2860,69843,yIgziBEY1QeE2VunyvjKVApcpAZz6INk,bWdj2GDclj5ofokWjzoa5jAwMkxCykd6,8,10,8,0,4,3,1,0,26,3.7142857142857144,1,0.0,0,8,0,4,10,3,0,1,0,12,14,1
2861,69847,LyDM0yrwn8zKtQsuxEGqFMxdhffaZNVY,SpATywNh6bZuzm8s1ceuBUnMUAeoAHHw,4,3,0,0,0,0,1,0,4,0.5714285714285714,1,0.0,0,0,0,0,3,0,0,1,0,0,4,1
2862,69849,jSFXNgNICT3cTdtFY1qrRx06ncJbHNIL,SpATywNh6bZuzm8s1ceuBUnMUAeoAHHw,19,23,13,18,4,0,9,0,67,9.571428571428571,2,0.0,4,13,15,4,19,0,3,9,0,36,31,0
2863,69852,jGWjfQmpnKrCWFzIMxwjgnePo6w3vCLc,SpATywNh6bZuzm8s1ceuBUnMUAeoAHHw,7,10,6,0,2,0,3,0,21,3.0,2,0.0,0,6,0,2,10,0,0,3,0,8,13,1
2864,69854,vtTIluoXpRIe9zpqEiPikMWtGXSMpuiF,SpATywNh6bZuzm8s1ceuBUnMUAeoAHHw,7,11,4,0,1,0,2,0,18,2.5714285714285716,2,0.0,0,4,0,1,11,0,0,2,0,5,13,1
2865,69856,SBz1G9CPNh7b1YKxwzjWQ2S8H7JkEfYW,SpATywNh6bZuzm8s1ceuBUnMUAeoAHHw,13,20,1,12,0,0,1,0,34,4.857142857142857,1,0.0,4,1,11,0,16,0,1,1,0,16,18,0
2866,69861,TgjP3M05p3RMkUJ6UX2DRRlsHiZcIeqm,SpATywNh6bZuzm8s1ceuBUnMUAeoAHHw,17,28,2,15,0,2,7,1,55,7.857142857142857,2,0.0,10,2,12,0,18,2,3,7,1,24,31,1
2867,69877,2eCbk1UbEiqe2btnyk0kQWHxge0iLKhu,SpATywNh6bZuzm8s1ceuBUnMUAeoAHHw,10,4,4,0,4,0,3,0,15,2.142857142857143,1,0.0,0,4,0,4,4,0,0,3,0,8,7,1
2868,69879,T7hyLHRci3AaSKtnxgzZP9PZimkugFag,SpATywNh6bZuzm8s1ceuBUnMUAeoAHHw,4,3,2,0,0,0,3,0,8,1.1428571428571428,1,0.0,0,2,0,0,3,0,0,3,0,2,6,1
2869,69886,C89edYjc0egHm9DK0UhG6TICXc3cgfYt,SpATywNh6bZuzm8s1ceuBUnMUAeoAHHw,5,3,1,0,0,0,2,0,6,0.8571428571428571,1,0.0,0,1,0,0,3,0,0,2,0,1,5,1
2870,69887,uxXbNZQzMKFVtvkoRDDVyoOZczad3AGk,SpATywNh6bZuzm8s1ceuBUnMUAeoAHHw,5,2,1,0,1,0,3,0,7,1.0,1,0.0,0,1,0,1,2,0,0,3,0,2,5,1
2871,69894,uxXbNZQzMKFVtvkoRDDVyoOZczad3AGk,bWdj2GDclj5ofokWjzoa5jAwMkxCykd6,1,0,0,0,0,0,1,0,1,0.14285714285714285,1,0.0,0,0,0,0,0,0,0,1,0,0,1,1
2872,69913,NMnvuPuFFRZJF8iN4i8wvMDrTjhZSOh9,SpATywNh6bZuzm8s1ceuBUnMUAeoAHHw,20,43,11,9,4,1,9,1,78,11.142857142857142,1,0.0,10,11,9,4,33,1,0,9,1,34,44,1
2873,69924,hF9wzZzzUNXUdemSIRccNUzFWcmYBmRA,SpATywNh6bZuzm8s1ceuBUnMUAeoAHHw,4,2,1,0,1,0,1,0,5,0.7142857142857143,1,0.0,0,1,0,1,2,0,0,1,0,2,3,1
2874,69926,iC67OjDFbVlCchthNt40xrjNGlZz61fX,SpATywNh6bZuzm8s1ceuBUnMUAeoAHHw,1,0,0,0,0,0,1,0,1,0.14285714285714285,1,0.0,0,0,0,0,0,0,0,1,0,0,1,0
2875,69928,VzpntkFDzyOIiXtUxc8LkeciWhAJhdSD,SpATywNh6bZuzm8s1ceuBUnMUAeoAHHw,1,0,0,0,0,0,1,0,1,0.14285714285714285,1,0.0,0,0,0,0,0,0,0,1,0,0,1,1
2876,69941,DpqUZKEZpIFvZzvEXk8oaJMRAbEfypNN,SpATywNh6bZuzm8s1ceuBUnMUAeoAHHw,15,11,7,0,7,0,6,0,31,4.428571428571429,1,0.0,2,7,0,7,9,0,0,6,0,16,15,0
2877,69948,lqeVvfv7UmHu5JiyWoTOATw0yL0HJQEo,G8EPVSXsOYB5YQWZGiz1aVq5Pgr2GrQu,1,0,0,0,0,0,1,0,1,0.14285714285714285,1,0.0,0,0,0,0,0,0,0,1,0,0,1,1
2878,69949,jcyADRcnQkvVHllsyVvCCi5Wcx40AoFW,SpATywNh6bZuzm8s1ceuBUnMUAeoAHHw,2,0,0,0,0,0,2,0,2,0.2857142857142857,1,0.0,0,0,0,0,0,0,0,2,0,0,2,1
2879,69975,xL2GGqHxlfngRtz8ATMPQBFRBvX6HArr,SpATywNh6bZuzm8s1ceuBUnMUAeoAHHw,17,18,9,16,0,0,4,0,47,6.714285714285714,1,0.0,8,9,16,0,10,0,0,4,0,33,14,0
2880,69997,viQoPUNtB7SIUiKvJ4gjpMz5oecDT31f,G8EPVSXsOYB5YQWZGiz1aVq5Pgr2GrQu,4,2,1,0,1,0,1,0,5,0.7142857142857143,1,0.0,0,1,0,1,2,0,0,1,0,2,3,1
2881,70006,wBxOvXavxcvDHQtsCbkdt1VRzmB8Qh9E,bWdj2GDclj5ofokWjzoa5jAwMkxCykd6,8,8,4,19,2,0,4,0,37,5.285714285714286,2,0.0,2,4,19,2,6,0,0,4,0,27,10,1
2882,70013,Kmxwvn5YFvJ5yFX0GZXEdEhcQGDP2CuP,SpATywNh6bZuzm8s1ceuBUnMUAeoAHHw,4,2,1,0,1,0,1,0,5,0.7142857142857143,1,0.0,0,1,0,1,2,0,0,1,0,2,3,1
2883,70037,jQGozXgCDEtih8n0QNDjwOxHGubLTjEt,SpATywNh6bZuzm8s1ceuBUnMUAeoAHHw,6,6,4,0,2,0,2,0,14,2.0,1,0.0,0,4,0,2,6,0,0,2,0,6,8,0
2884,70046,J1us9rPcxSTckBHItgnAQKi26DjcRbl6,bWdj2GDclj5ofokWjzoa5jAwMkxCykd6,5,2,1,0,1,0,2,0,6,0.8571428571428571,1,0.0,0,1,0,1,2,0,0,2,0,2,4,1
2885,70049,DbyuNNEIfQSCSjURAYhbFblaR63gfHlU,bWdj2GDclj5ofokWjzoa5jAwMkxCykd6,7,5,1,24,2,0,4,0,36,5.142857142857143,2,0.0,3,1,23,2,2,0,1,4,0,29,7,1
2886,70050,hcNcs1eHZusVH4vyoLl8j9zdN7CZ6Lcy,SpATywNh6bZuzm8s1ceuBUnMUAeoAHHw,13,8,7,6,5,0,1,0,27,3.857142857142857,1,0.0,0,7,5,5,8,0,1,1,0,17,10,1
2887,70063,EJgYYp7MOTUbdsSUr6xoQChx0uLQ5Tys,SpATywNh6bZuzm8s1ceuBUnMUAeoAHHw,7,3,2,0,2,0,2,0,9,1.2857142857142858,1,0.0,0,2,0,2,3,0,0,2,0,4,5,1
2888,70070,nzxk9UvHRiwkN6SIsgPzgRjDaGaCgQRa,bWdj2GDclj5ofokWjzoa5jAwMkxCykd6,1,0,0,0,0,0,1,0,1,0.14285714285714285,1,0.0,0,0,0,0,0,0,0,1,0,0,1,1
2889,70101,vYeGcWGAJP4B8Lvbjdr2jkY9NnpHN8xb,bWdj2GDclj5ofokWjzoa5jAwMkxCykd6,1,0,0,0,0,0,1,0,1,0.14285714285714285,1,0.0,0,0,0,0,0,0,0,1,0,0,1,1
2890,70108,JaY583iEzhUh1H375yAqlbYi0f6zdDLM,SpATywNh6bZuzm8s1ceuBUnMUAeoAHHw,4,3,0,0,0,0,2,0,5,0.7142857142857143,1,0.0,1,0,0,0,2,0,0,2,0,1,4,1
2891,70109,w1PJeTTskG2DF1TtLUpuz9MkqxNdq5EB,SpATywNh6bZuzm8s1ceuBUnMUAeoAHHw,6,8,2,0,2,0,3,0,15,2.142857142857143,2,0.0,0,2,0,2,8,0,0,3,0,4,11,1
2892,70119,NXyco71N78GkVfHnZsK8R307XzQzXNS1,SpATywNh6bZuzm8s1ceuBUnMUAeoAHHw,17,23,9,8,3,0,1,0,44,6.285714285714286,3,0.0,7,9,7,3,16,0,1,1,0,26,18,0
2893,70122,68BjCXfBFqeZ01fFx1csrFmvef5xs0w2,G8EPVSXsOYB5YQWZGiz1aVq5Pgr2GrQu,6,6,3,0,1,0,2,0,12,1.7142857142857142,2,0.0,0,3,0,1,6,0,0,2,0,4,8,1
2894,70137,DyZ33FUAQ083lF7iqwpOMtJVUGHaWBxJ,SpATywNh6bZuzm8s1ceuBUnMUAeoAHHw,1,0,0,0,0,0,1,0,1,0.14285714285714285,1,0.0,0,0,0,0,0,0,0,1,0,0,1,1
2895,70139,j4hecXKY3USBQpRwMuzKA9d9SPzBKhRY,bWdj2GDclj5ofokWjzoa5jAwMkxCykd6,5,3,0,0,0,5,6,0,14,2.0,1,0.0,0,0,0,0,3,5,0,6,0,0,14,1
2896,70151,Zn9SLiwLflmw7DD6LFx0hGPxPjMJmhLJ,SpATywNh6bZuzm8s1ceuBUnMUAeoAHHw,1,0,0,0,0,0,1,0,1,0.14285714285714285,1,0.0,0,0,0,0,0,0,0,1,0,0,1,1
2897,70163,wykDdjB45pC3zZUNNLpkNXDJGEatsGFp,RXDvfPUBYFlVdlueBFbLW0mhhAyGEqpt,1,0,0,0,0,0,1,0,1,0.14285714285714285,1,0.0,0,0,0,0,0,0,0,1,0,0,1,1
2898,70368,4AzWdcwb3SG5chIViRUSkI6mbhUE2J75,fbPkOYLVPtPgIt0MxizjfFJov3JbHyAi,12,25,13,0,6,0,4,0,48,6.857142857142857,3,0.0,2,13,0,6,23,0,0,4,0,21,27,1
2899,70371,kC7JLQowN0BSKnzXXKRn5vuXi1nnM0dA,fbPkOYLVPtPgIt0MxizjfFJov3JbHyAi,4,2,1,0,1,0,1,0,5,0.7142857142857143,1,0.0,0,1,0,1,2,0,0,1,0,2,3,1
2900,70376,61PsrnqGMh19xjWowe2Lz8ELqYCTUUqE,fbPkOYLVPtPgIt0MxizjfFJov3JbHyAi,32,58,29,23,5,2,23,2,142,20.285714285714285,5,0.0,8,29,21,5,50,2,2,23,2,63,79,0
2901,70390,CZolsxTOSFE94rXDRXRTcZmeVsLJ3JH7,fbPkOYLVPtPgIt0MxizjfFJov3JbHyAi,1,0,0,0,0,0,1,0,1,0.14285714285714285,1,0.0,0,0,0,0,0,0,0,1,0,0,1,1
2902,70394,jVBLsQocjzyX8TfhIQuGcF0tRTsZU0fl,fbPkOYLVPtPgIt0MxizjfFJov3JbHyAi,5,3,1,0,1,0,3,0,8,1.1428571428571428,1,0.0,0,1,0,1,3,0,0,3,0,2,6,1
2903,70427,xlOz0HV4EOx3YcSKdziNkU6Tif0rYjnx,fbPkOYLVPtPgIt0MxizjfFJov3JbHyAi,5,2,1,0,1,0,2,0,6,0.8571428571428571,1,0.0,0,1,0,1,2,0,0,2,0,2,4,1
2904,70502,fd3M5GFuTNibIF234PDGuNuJ7TaPIle6,fbPkOYLVPtPgIt0MxizjfFJov3JbHyAi,5,3,1,0,0,0,3,0,7,1.0,1,0.0,0,1,0,0,3,0,0,3,0,1,6,1
2905,70622,vL40lDIpwhva8z6IagRWvDtekT2W0mhZ,fbPkOYLVPtPgIt0MxizjfFJov3JbHyAi,10,6,5,0,4,5,2,0,22,3.142857142857143,1,0.0,0,5,0,4,6,5,0,2,0,9,13,1
2906,70627,VJsbRtMXxy8aqyccEZDzV7pPAGBosBu1,fbPkOYLVPtPgIt0MxizjfFJov3JbHyAi,6,5,2,1,1,0,0,0,9,1.2857142857142858,1,0.0,1,2,1,1,4,0,0,0,0,5,4,0
2907,70641,2uadn8x6eG3s1sEJofJgCr35bh3OHGLh,fbPkOYLVPtPgIt0MxizjfFJov3JbHyAi,4,0,0,0,0,22,3,0,25,3.5714285714285716,1,0.0,0,0,0,0,0,22,0,3,0,0,25,1
2908,70651,zPbUIdTRPjnN9GVjy7Vs8SVwjdhRAaUM,fbPkOYLVPtPgIt0MxizjfFJov3JbHyAi,10,10,7,0,3,0,5,0,25,3.5714285714285716,2,0.0,0,7,0,3,10,0,0,5,0,10,15,1
2909,70652,RUk1UgFf8pHkjYocajMr35nYXvyKvRsO,fbPkOYLVPtPgIt0MxizjfFJov3JbHyAi,21,29,13,0,7,7,6,1,63,9.0,1,0.0,0,13,0,7,29,7,0,6,1,20,43,1
2910,70658,7h3tDULs3BTNaDybaRAqNsIlSNoXgEZh,fbPkOYLVPtPgIt0MxizjfFJov3JbHyAi,8,10,4,0,2,0,2,0,18,2.5714285714285716,1,0.0,1,4,0,2,9,0,0,2,0,7,11,1
2911,70664,8djQJACWabqqdfUYlZxiiBK5fRdO0gWZ,fbPkOYLVPtPgIt0MxizjfFJov3JbHyAi,12,14,9,3,3,9,4,0,42,6.0,1,0.0,2,9,3,3,12,9,0,4,0,17,25,1
2912,70674,tsQNS0TFi4T2OwDWxOZsXYloXeaBeZAv,fbPkOYLVPtPgIt0MxizjfFJov3JbHyAi,10,9,4,3,4,0,1,0,21,3.0,1,0.0,3,4,3,4,6,0,0,1,0,14,7,1
2913,70676,Pv9LrfjnRw1WO1VwPNHCu7aKxUz6zC8i,fbPkOYLVPtPgIt0MxizjfFJov3JbHyAi,11,15,12,0,6,5,3,0,41,5.857142857142857,2,0.0,0,12,0,6,15,5,0,3,0,18,23,1
2914,70677,zmlL73g2U1Ek37ZDQ2H6P7dwK1MBsxuX,fbPkOYLVPtPgIt0MxizjfFJov3JbHyAi,10,16,8,2,5,0,2,0,33,4.714285714285714,2,0.0,5,8,2,5,11,0,0,2,0,20,13,1
2915,70706,2j7JDJ8MsffyV0kSC0vh7baFkUIS4GAx,fbPkOYLVPtPgIt0MxizjfFJov3JbHyAi,31,67,24,30,27,0,9,0,157,22.428571428571427,4,0.0,39,24,24,27,28,0,6,9,0,114,43,1
2916,70781,ctdO04zd7K8QUa5HFdH2dxaEs6nEQGcX,fbPkOYLVPtPgIt0MxizjfFJov3JbHyAi,7,5,3,0,2,0,1,0,11,1.5714285714285714,1,0.0,0,3,0,2,5,0,0,1,0,5,6,0
2917,70897,83JPfkin3GX4GLKqML2uaHSZ5KvsuJhM,fbPkOYLVPtPgIt0MxizjfFJov3JbHyAi,6,7,4,0,3,0,2,0,16,2.2857142857142856,1,0.0,0,4,0,3,7,0,0,2,0,7,9,1
2918,70941,hplRuUXyLFhHcMqMJcb12YjqquTYp3Qw,bWdj2GDclj5ofokWjzoa5jAwMkxCykd6,9,5,2,0,1,1,8,1,18,2.5714285714285716,1,0.0,0,2,0,1,5,1,0,8,1,3,15,1
2919,70964,AtOHbVb7kxzZIoD2M5RWKjBCYCoDUPL6,SpATywNh6bZuzm8s1ceuBUnMUAeoAHHw,8,9,4,0,0,0,2,0,15,2.142857142857143,1,0.0,3,4,0,0,6,0,0,2,0,7,8,0
2920,70969,Ooaq1toVrKJC9KROMnT52Id1rqx2sDam,A3fsA9Zfv1X2fVEQhTw51lKENdNrEqT3,12,8,6,0,5,48,5,0,72,10.285714285714286,3,0.0,0,6,0,5,8,48,0,5,0,11,61,0
2921,71078,dfEK3xvueeR9teWVma5VAaO4dthOOslM,bWdj2GDclj5ofokWjzoa5jAwMkxCykd6,37,26,13,95,12,0,11,0,157,22.428571428571427,2,0.0,11,13,85,12,15,0,10,11,0,121,36,1
2922,71164,GqY8cM6bEQ2o2zTrfF7msueNZ1f4HNE4,A3fsA9Zfv1X2fVEQhTw51lKENdNrEqT3,7,4,1,0,1,0,2,0,8,1.1428571428571428,1,0.0,0,1,0,1,4,0,0,2,0,2,6,1
2923,71272,CeGIsWlT0KBVS1hQGCUY2KCY4J9xzr3t,SpATywNh6bZuzm8s1ceuBUnMUAeoAHHw,9,7,1,0,1,0,4,0,13,1.8571428571428572,2,0.0,0,1,0,1,7,0,0,4,0,2,11,1
2924,71362,f6IvpzZQ4NKKZIUTkgWEi3BVq577qLnM,SpATywNh6bZuzm8s1ceuBUnMUAeoAHHw,9,8,0,8,0,0,1,0,17,2.4285714285714284,1,0.0,3,0,8,0,5,0,0,1,0,11,6,0
2925,71534,6kmRTTlm2tGjO1GkeO8yvcp6lmCvKO0m,A3fsA9Zfv1X2fVEQhTw51lKENdNrEqT3,1,0,0,0,0,0,1,0,1,0.14285714285714285,1,0.0,0,0,0,0,0,0,0,1,0,0,1,1
2926,71700,qGPfY7GDQqrO1DPuPdsJnIrEGeJp1MpX,SpATywNh6bZuzm8s1ceuBUnMUAeoAHHw,5,3,1,0,0,0,2,0,6,0.8571428571428571,1,0.0,0,1,0,0,3,0,0,2,0,1,5,1
2927,71712,TztthVt5KMop1hWx6wFArC8xg8H9VhnG,SpATywNh6bZuzm8s1ceuBUnMUAeoAHHw,4,4,2,0,0,0,1,0,7,1.0,1,0.0,1,2,0,0,3,0,0,1,0,3,4,1
2928,71802,YkfUrC2IjNSUcSjXepY6IHt6QpgdD85G,SpATywNh6bZuzm8s1ceuBUnMUAeoAHHw,11,7,6,0,5,0,1,0,19,2.7142857142857144,1,0.0,0,6,0,5,7,0,0,1,0,11,8,1
2929,71842,ErXNe7efkRl64E8pJRc91VCcYddra1a4,SpATywNh6bZuzm8s1ceuBUnMUAeoAHHw,12,9,0,13,0,1,5,1,29,4.142857142857143,1,0.0,4,0,10,0,5,1,3,5,1,14,15,0
2930,71844,yjE4tqKQR2WC3DLToz6n1TUHIiH6cjX1,SpATywNh6bZuzm8s1ceuBUnMUAeoAHHw,9,11,6,0,4,0,5,0,26,3.7142857142857144,3,0.0,0,6,0,4,11,0,0,5,0,10,16,0
2931,71873,nBOtam7XKIa3PxdTZIAJPzc36wtmbKH4,A3fsA9Zfv1X2fVEQhTw51lKENdNrEqT3,4,0,0,0,0,1,6,0,7,1.0,1,0.0,0,0,0,0,0,1,0,6,0,0,7,1
2932,71935,Cg7iNBAj8Tw36V9R4YA417eEEGy00kAz,SpATywNh6bZuzm8s1ceuBUnMUAeoAHHw,7,5,3,0,1,0,3,0,12,1.7142857142857142,1,0.0,0,3,0,1,5,0,0,3,0,4,8,0
2933,71970,51xlIGXGRsE7YMneHTw1mXYuaEFgELF3,A3fsA9Zfv1X2fVEQhTw51lKENdNrEqT3,28,18,17,0,14,0,1,0,50,7.142857142857143,1,0.0,0,17,0,14,18,0,0,1,0,31,19,0
2934,72034,4D3Mr9GTnnSeHqe4k4RduVTIffzivKXV,SpATywNh6bZuzm8s1ceuBUnMUAeoAHHw,15,8,5,12,2,1,5,1,34,4.857142857142857,1,0.0,2,5,12,2,6,1,0,5,1,21,13,1
2935,72066,FCXISzNoe8FGZLEA3b4ES0P455MShvJn,SpATywNh6bZuzm8s1ceuBUnMUAeoAHHw,4,2,1,0,1,0,1,0,5,0.7142857142857143,1,0.0,0,1,0,1,2,0,0,1,0,2,3,1
2936,72327,vpU9FFM3siBSv5Tq74CkiYBZ5nbD9oub,SpATywNh6bZuzm8s1ceuBUnMUAeoAHHw,12,11,0,12,0,1,1,0,25,3.5714285714285716,1,0.0,3,0,12,0,8,1,0,1,0,15,10,1
2937,72370,WI9rk8aS11tBAJzjcX0JSIgomYYRQVjW,SpATywNh6bZuzm8s1ceuBUnMUAeoAHHw,7,14,1,0,1,0,1,0,17,2.4285714285714284,1,0.0,0,1,0,1,14,0,0,1,0,2,15,0
2938,72375,jpXIq3stqWScWG27acYJbNKpdTmc6kli,bWdj2GDclj5ofokWjzoa5jAwMkxCykd6,24,27,16,66,4,0,19,0,132,18.857142857142858,3,0.0,2,16,61,4,25,0,5,19,0,83,49,0
2939,72416,iPefB9aOL6bAjIaS6Gks903vpOsT6Kof,SpATywNh6bZuzm8s1ceuBUnMUAeoAHHw,8,6,1,0,1,0,6,0,14,2.0,1,0.0,0,1,0,1,6,0,0,6,0,2,12,1
2940,72442,LWfPQEZcfqcdY03cxPtuNt5LIUXK1J1h,bWdj2GDclj5ofokWjzoa5jAwMkxCykd6,7,2,1,0,1,0,3,0,7,1.0,1,0.0,0,1,0,1,2,0,0,3,0,2,5,1
2941,72452,MU4dVyJTD7iIRSTZIdJZ9VoLOxogfKQN,A3fsA9Zfv1X2fVEQhTw51lKENdNrEqT3,3,2,1,0,0,0,1,0,4,0.5714285714285714,1,0.0,0,1,0,0,2,0,0,1,0,1,3,0
2942,72468,clbUGnOQsN7CuaV7idGJ2LVbYN3t8qC3,bWdj2GDclj5ofokWjzoa5jAwMkxCykd6,21,47,3,65,2,8,10,1,136,19.428571428571427,3,0.0,18,3,65,2,29,8,0,10,1,88,48,0
2943,72485,H1nbdkC904EOh8jWeVVcV5piaqMVBsli,RXDvfPUBYFlVdlueBFbLW0mhhAyGEqpt,5,2,0,0,0,0,3,0,5,0.7142857142857143,1,0.0,0,0,0,0,2,0,0,3,0,0,5,0
2944,72532,QPoypIc1fBONo2zEXZGrqFPP68plPMOG,A3fsA9Zfv1X2fVEQhTw51lKENdNrEqT3,41,29,1,82,0,1,15,3,131,18.714285714285715,1,0.0,3,1,64,0,26,1,18,15,3,68,63,0
2945,72588,5fUv2a4WMEi2Bc60cQo0Uzo1I7SufPfI,SpATywNh6bZuzm8s1ceuBUnMUAeoAHHw,24,50,0,24,0,13,8,0,95,13.571428571428571,2,0.0,8,0,23,0,42,13,1,8,0,31,64,0
2946,72692,H2pnCC5fUi5Ho09aPqAE97vnlsM8FGBU,A3fsA9Zfv1X2fVEQhTw51lKENdNrEqT3,44,15,7,162,1,0,6,0,191,27.285714285714285,2,0.0,3,7,153,1,12,0,9,6,0,164,27,0
2947,72701,h2ynGKkFoAy58qRjHGCAYsp0Afa0leqG,SpATywNh6bZuzm8s1ceuBUnMUAeoAHHw,6,5,0,0,0,0,6,0,11,1.5714285714285714,1,0.0,0,0,0,0,5,0,0,6,0,0,11,1
2948,72716,0VjAWG5aLQgXyXeTqTPnha195szz41mH,RXDvfPUBYFlVdlueBFbLW0mhhAyGEqpt,6,3,2,0,1,19,2,0,27,3.857142857142857,1,0.0,0,2,0,1,3,19,0,2,0,3,24,1
2949,72721,1UwRwlLE0RwxPaY5NbrfjlESNYQllZZa,A3fsA9Zfv1X2fVEQhTw51lKENdNrEqT3,5,2,1,0,1,0,2,0,6,0.8571428571428571,1,0.0,0,1,0,1,2,0,0,2,0,2,4,0
2950,72844,pQdSl7i5ZuZeH9uPILgdHrvwskp4vc4V,A3fsA9Zfv1X2fVEQhTw51lKENdNrEqT3,2,0,0,0,0,0,2,0,2,0.2857142857142857,1,0.0,0,0,0,0,0,0,0,2,0,0,2,1
2951,72847,OUbh6hvaOJDp9RK7kgTBzzPmjzmkYhZF,bWdj2GDclj5ofokWjzoa5jAwMkxCykd6,9,7,1,70,0,0,6,0,84,12.0,1,0.0,1,1,68,0,6,0,2,6,0,70,14,1
2952,72850,QqE2Xjwy9gUzOvFdkDqAwAaNZLBZkxvd,G8EPVSXsOYB5YQWZGiz1aVq5Pgr2GrQu,14,17,3,0,1,0,15,0,36,5.142857142857143,4,0.0,0,3,0,1,17,0,0,15,0,4,32,1
2953,72922,ria1rZm5v1iNiSZkl2at79lKlYWZvHeF,SpATywNh6bZuzm8s1ceuBUnMUAeoAHHw,17,20,0,9,0,17,3,0,49,7.0,1,0.0,4,0,9,0,16,17,0,3,0,13,36,0
2954,72967,NYagfMVvA1FDdZ7PZwzv8OVDbZ0jsy8R,SpATywNh6bZuzm8s1ceuBUnMUAeoAHHw,3,0,0,0,0,1,2,0,3,0.42857142857142855,1,0.0,0,0,0,0,0,1,0,2,0,0,3,1
2955,73009,l569pvTkqA1hwU8mlPA8zjV2SyK4a7w2,SpATywNh6bZuzm8s1ceuBUnMUAeoAHHw,20,35,0,34,0,1,1,0,71,10.142857142857142,1,0.0,12,0,29,0,23,1,5,1,0,41,30,0
2956,73180,uoufNidjh1zD724gB2zYdd5MROgtTWHO,A3fsA9Zfv1X2fVEQhTw51lKENdNrEqT3,27,19,16,0,14,0,2,0,51,7.285714285714286,1,0.0,0,16,0,14,19,0,0,2,0,30,21,1
2957,73500,m7jLYh84m9f53uDPmmpRCKYuGkwpenOB,fbPkOYLVPtPgIt0MxizjfFJov3JbHyAi,7,5,2,0,2,0,2,0,11,1.5714285714285714,1,0.0,2,2,0,2,3,0,0,2,0,6,5,1
2958,73514,eAreSTsX7Dih2J54vyrFl8ByPnikZNX4,fbPkOYLVPtPgIt0MxizjfFJov3JbHyAi,9,8,5,0,2,13,2,0,30,4.285714285714286,1,0.0,1,5,0,2,7,13,0,2,0,8,22,0
2959,73885,zlC9nEdRrqLSPX386Mctiz9fIdlU29GI,7GRhBDsirIGkRZBtSMEzNTyDr2JQm4xx,12,17,11,4,11,0,2,0,45,6.428571428571429,2,0.0,4,11,4,11,13,0,0,2,0,30,15,1
2960,73941,vaBnFuKrFzaRvpuQOGO2KMutesPcXn34,SpATywNh6bZuzm8s1ceuBUnMUAeoAHHw,21,27,11,17,5,2,5,1,68,9.714285714285714,2,0.0,11,11,14,5,16,2,3,5,1,41,27,0
2961,74040,CopXShP3zDILDEKJnKili2vT6Sl9AJnD,SpATywNh6bZuzm8s1ceuBUnMUAeoAHHw,2,0,0,0,0,0,2,0,2,0.2857142857142857,1,0.0,0,0,0,0,0,0,0,2,0,0,2,1
2962,74114,OakZIwMalw5UgG2N0rTydClOEPiV8rki,SpATywNh6bZuzm8s1ceuBUnMUAeoAHHw,5,3,1,0,1,0,3,0,8,1.1428571428571428,1,0.0,0,1,0,1,3,0,0,3,0,2,6,0
2963,74121,Ym1ZTRs6QB0e3lMSh4qwLaB0p6ohf0Ak,RXDvfPUBYFlVdlueBFbLW0mhhAyGEqpt,44,54,24,73,22,7,3,0,183,26.142857142857142,1,0.0,24,24,64,22,30,7,9,3,0,134,49,0
2964,74122,MkhWkWrDBg7jFp3XklVC8uZQ46nAon3u,7GRhBDsirIGkRZBtSMEzNTyDr2JQm4xx,5,3,2,0,1,0,1,0,7,1.0,1,0.0,0,2,0,1,3,0,0,1,0,3,4,1
2965,74262,USFNJQ0DS4O3ARJSYADvtg2Aw3GLb3J9,SpATywNh6bZuzm8s1ceuBUnMUAeoAHHw,4,3,2,0,0,0,1,0,6,0.8571428571428571,1,0.0,0,2,0,0,3,0,0,1,0,2,4,1
2966,74329,vCnaR7A3EMdV2eOQ4pBMh0byIjK5VwLE,SpATywNh6bZuzm8s1ceuBUnMUAeoAHHw,3,3,0,0,0,0,1,0,4,0.5714285714285714,1,0.0,0,0,0,0,3,0,0,1,0,0,4,1
2967,74737,xMjaHywxqKHoEbgcAEYnpZkLLGRuzCTC,SpATywNh6bZuzm8s1ceuBUnMUAeoAHHw,16,34,12,12,8,0,5,0,71,10.142857142857142,2,0.0,2,12,9,8,32,0,3,5,0,31,40,0
2968,74739,WnGoJ0X05nmmcr9OBuNGFmD5r4EVF1g6,A3fsA9Zfv1X2fVEQhTw51lKENdNrEqT3,11,7,5,0,3,2,3,0,20,2.857142857142857,1,0.0,0,5,0,3,7,2,0,3,0,8,12,0
2969,74888,hB4yTUnQMne1LtjUUKgpcnhj6jq7S5Co,7GRhBDsirIGkRZBtSMEzNTyDr2JQm4xx,28,40,21,24,20,1,3,0,109,15.571428571428571,3,0.0,16,21,22,20,24,1,2,3,0,79,30,0
2970,74903,Y0dbTriNAgSzbrnkzFHfTSZPt5kDzGfo,7GRhBDsirIGkRZBtSMEzNTyDr2JQm4xx,32,66,2,129,18,0,5,0,220,31.428571428571427,2,0.0,43,2,116,18,23,0,13,5,0,179,41,1
2971,74911,KXR3u54SykbWYMuF2sF6lcMFs68otiQO,SpATywNh6bZuzm8s1ceuBUnMUAeoAHHw,17,14,7,10,4,0,1,0,36,5.142857142857143,2,0.0,2,7,9,4,12,0,1,1,0,22,14,0
2972,75093,Wcbtj2ddFRjLWK9tTZ7uzCDmpegrAZ78,A3fsA9Zfv1X2fVEQhTw51lKENdNrEqT3,17,9,6,38,3,0,2,0,58,8.285714285714286,1,0.0,0,6,32,3,9,0,6,2,0,41,17,0
2973,75102,7PsSHlEYnB89Jan9VqppndjNHL90G8j5,7GRhBDsirIGkRZBtSMEzNTyDr2JQm4xx,1,0,0,0,0,0,1,0,1,0.14285714285714285,1,0.0,0,0,0,0,0,0,0,1,0,0,1,1
2974,75108,35ygmhgWZR3Rp3zgk5PM9pjJe8hJeFw2,G8EPVSXsOYB5YQWZGiz1aVq5Pgr2GrQu,5,4,2,0,0,0,1,0,7,1.0,1,0.0,0,2,0,0,4,0,0,1,0,2,5,0
2975,75237,RFr9TyIVEW42bBHoptkHxr0bo57RDi2m,7GRhBDsirIGkRZBtSMEzNTyDr2JQm4xx,32,41,13,61,9,12,9,0,145,20.714285714285715,1,0.0,27,13,51,9,14,12,10,9,0,100,45,1
2976,75239,azgXgRxypRV3MCHuv22g9fm7GCtWHZdX,SpATywNh6bZuzm8s1ceuBUnMUAeoAHHw,11,21,15,8,0,1,2,0,47,6.714285714285714,1,0.0,6,15,7,0,15,1,1,2,0,28,19,1
2977,75379,MYsCU1zkMrWxPhV1b7wSL5LZIo1zGyhU,A3fsA9Zfv1X2fVEQhTw51lKENdNrEqT3,10,6,5,0,3,0,1,0,15,2.142857142857143,1,0.0,0,5,0,3,6,0,0,1,0,8,7,0
2978,75511,MYsCU1zkMrWxPhV1b7wSL5LZIo1zGyhU,RXDvfPUBYFlVdlueBFbLW0mhhAyGEqpt,15,11,10,0,6,0,1,0,28,4.0,1,0.0,0,10,0,6,11,0,0,1,0,16,12,0
2979,75520,9Ymehs8Guv0M3ykIpbJLNOnh3ut9xb1R,SpATywNh6bZuzm8s1ceuBUnMUAeoAHHw,2,0,0,0,0,0,2,0,2,0.2857142857142857,1,0.0,0,0,0,0,0,0,0,2,0,0,2,1
2980,75752,0CuRIhBavvQKL5rTT1QWf2kztAfRXZug,A3fsA9Zfv1X2fVEQhTw51lKENdNrEqT3,15,22,11,0,5,14,8,0,60,8.571428571428571,2,0.0,0,11,0,5,22,14,0,8,0,16,44,0
2981,75879,Slk5JcZSYHmDLQZXaNVmcMDmjJ16kBhI,SpATywNh6bZuzm8s1ceuBUnMUAeoAHHw,10,9,0,10,0,0,2,0,21,3.0,2,0.0,2,0,8,0,7,0,2,2,0,10,11,0
2982,76044,Qfr71fBWHfCr6Grcd1acKeeOb47jgXr2,RXDvfPUBYFlVdlueBFbLW0mhhAyGEqpt,17,14,10,0,7,3,6,0,40,5.714285714285714,1,0.0,0,10,0,7,14,3,0,6,0,17,23,1
2983,76235,jByBG50ghoSer5UP92qpkAfDGFpraaH7,SpATywNh6bZuzm8s1ceuBUnMUAeoAHHw,14,18,12,10,2,3,6,0,51,7.285714285714286,1,0.0,2,12,10,2,16,3,0,6,0,26,25,0
2984,76295,Slk5JcZSYHmDLQZXaNVmcMDmjJ16kBhI,bWdj2GDclj5ofokWjzoa5jAwMkxCykd6,29,40,6,94,2,5,15,1,163,23.285714285714285,3,0.0,4,6,86,2,36,5,8,15,1,98,65,0
2985,76325,R5PVQLHQfRcyGqt0KVpTkwcmfBgB3rs1,7GRhBDsirIGkRZBtSMEzNTyDr2JQm4xx,8,9,3,2,1,2,3,0,20,2.857142857142857,1,0.0,1,3,2,1,8,2,0,3,0,7,13,0
2986,77034,s6iksgptFmyh2vfiarKdJkiKnp6RLi3f,7GRhBDsirIGkRZBtSMEzNTyDr2JQm4xx,8,2,1,0,0,5,9,2,19,2.7142857142857144,1,0.0,0,1,0,0,2,5,0,9,2,1,18,0
2987,77169,Cp72CI2Sf9jM7OL4FtK9fjTjNz5WkQpA,fbPkOYLVPtPgIt0MxizjfFJov3JbHyAi,21,20,16,0,7,0,6,1,50,7.142857142857143,2,0.0,0,16,0,7,20,0,0,6,1,23,27,1
2988,77171,HBsmUsRxNy9YIFuJFQ7jYNsbYwo3J2fi,fbPkOYLVPtPgIt0MxizjfFJov3JbHyAi,2,0,0,0,0,0,4,0,4,0.5714285714285714,1,0.0,0,0,0,0,0,0,0,4,0,0,4,1
2989,77174,SAaosoVr2vtr4dixGOnJyFfsZpQgNJkr,fbPkOYLVPtPgIt0MxizjfFJov3JbHyAi,7,3,2,0,2,0,2,0,9,1.2857142857142858,1,0.0,0,2,0,2,3,0,0,2,0,4,5,1
2990,77175,uHjc02bb5yahJPEhzfl5FY8Jbd1eMOQQ,fbPkOYLVPtPgIt0MxizjfFJov3JbHyAi,6,2,1,0,1,0,4,0,8,1.1428571428571428,1,0.0,0,1,0,1,2,0,0,4,0,2,6,1
2991,77178,sgnybIqhppcE8t2VPYKo1tSMEtj9RDxf,fbPkOYLVPtPgIt0MxizjfFJov3JbHyAi,11,13,2,4,5,0,2,0,26,3.7142857142857144,1,0.0,7,2,4,5,6,0,0,2,0,18,8,1
2992,77179,eoSLO9oJFq2ypi74bXNS4eHCMDLAFDL3,fbPkOYLVPtPgIt0MxizjfFJov3JbHyAi,22,61,15,21,21,0,5,0,123,17.571428571428573,5,0.0,34,15,15,21,27,0,6,5,0,85,38,0
2993,77180,4G8giDRiV5HhGR2bRPmscEq6mPK32SgK,fbPkOYLVPtPgIt0MxizjfFJov3JbHyAi,1,0,0,0,0,0,1,0,1,0.14285714285714285,1,0.0,0,0,0,0,0,0,0,1,0,0,1,1
2994,77183,bDjOfMP0w62FEHIuWcxaWhNnsKOONfSS,fbPkOYLVPtPgIt0MxizjfFJov3JbHyAi,8,3,2,0,2,0,3,1,11,1.5714285714285714,1,0.0,0,2,0,2,3,0,0,3,1,4,7,1
2995,77186,ezX0IzuZ3J41r6pzTzeXqv8c59Uxb12M,fbPkOYLVPtPgIt0MxizjfFJov3JbHyAi,25,56,25,44,9,6,15,2,157,22.428571428571427,2,0.0,20,25,37,9,36,6,7,15,2,91,66,1
2996,77192,meLyG0wJkMmV21DuYQM3wSrWMuffsNoT,fbPkOYLVPtPgIt0MxizjfFJov3JbHyAi,6,7,1,0,2,0,2,0,12,1.7142857142857142,1,0.0,4,1,0,2,3,0,0,2,0,7,5,1
2997,77193,alkuv5SdY4gggdYWMPXddOsJJh5KuvhQ,fbPkOYLVPtPgIt0MxizjfFJov3JbHyAi,8,5,2,0,2,1,4,1,15,2.142857142857143,1,0.0,0,2,0,2,5,1,0,4,1,4,11,1
2998,77195,gir9E9ZUbwj6bCUNLD2kQmOx1nsVwG4J,fbPkOYLVPtPgIt0MxizjfFJov3JbHyAi,1,0,0,0,0,0,1,0,1,0.14285714285714285,1,0.0,0,0,0,0,0,0,0,1,0,0,1,1
2999,77196,MzVpgt6eIu33aOAUbbblQyleNNMrWM7t,fbPkOYLVPtPgIt0MxizjfFJov3JbHyAi,5,2,1,0,1,0,2,0,6,0.8571428571428571,1,0.0,0,1,0,1,2,0,0,2,0,2,4,1
3000,77199,KG6oNmBFEPQJXhvAD0RPIYEBC1kCcYzu,fbPkOYLVPtPgIt0MxizjfFJov3JbHyAi,12,12,8,2,4,0,6,0,32,4.571428571428571,1,0.0,1,8,2,4,11,0,0,6,0,15,17,1
3001,77201,syI09vfTHJXWHQvllYPBF5DBbMlFFVEK,fbPkOYLVPtPgIt0MxizjfFJov3JbHyAi,7,6,3,0,1,0,4,0,14,2.0,2,0.0,0,3,0,1,6,0,0,4,0,4,10,1
3002,77202,U7npE6DxNpBR5QQ69mhzcy60y59pDPJp,fbPkOYLVPtPgIt0MxizjfFJov3JbHyAi,7,4,3,0,3,0,2,0,12,1.7142857142857142,1,0.0,0,3,0,3,4,0,0,2,0,6,6,1
3003,77203,riM9GkB0ajSqpIPlVq4tRzOjk7wJ6NHE,fbPkOYLVPtPgIt0MxizjfFJov3JbHyAi,4,2,0,0,0,0,2,0,4,0.5714285714285714,1,0.0,0,0,0,0,2,0,0,2,0,0,4,1
3004,77204,cNbaOf1E9E66ogkJPuo6YM141nAFPTNg,fbPkOYLVPtPgIt0MxizjfFJov3JbHyAi,14,22,15,0,11,3,5,0,56,8.0,2,0.0,2,15,0,11,20,3,0,5,0,28,28,1
3005,77205,tAelht5FQdpcbtZQoKgvZA90XQy6zeRb,fbPkOYLVPtPgIt0MxizjfFJov3JbHyAi,7,5,4,0,3,0,1,0,13,1.8571428571428572,1,0.0,0,4,0,3,5,0,0,1,0,7,6,1
3006,77207,AXWWqNDiRDejTjo5V7yUaMbjtzXKhlP0,fbPkOYLVPtPgIt0MxizjfFJov3JbHyAi,10,6,3,0,2,5,5,1,22,3.142857142857143,1,0.0,1,3,0,2,5,5,0,5,1,6,16,1
3007,77848,4s6cwLPbdRkDxHfFtEkiNoQ9RLKrwhVv,A3fsA9Zfv1X2fVEQhTw51lKENdNrEqT3,14,7,5,0,4,4,6,1,27,3.857142857142857,1,0.0,0,5,0,4,7,4,0,6,1,9,18,1
3008,77895,ywdL3xkp7d2PSjbvnflAvIe7Wp6Q4SRe,bWdj2GDclj5ofokWjzoa5jAwMkxCykd6,22,26,14,78,4,0,10,0,132,18.857142857142858,2,0.0,4,14,70,4,22,0,8,10,0,92,40,0
3009,77993,c8WJAdYLV71mOx4ZXSglpCNd0dBUR3Om,A3fsA9Zfv1X2fVEQhTw51lKENdNrEqT3,32,13,7,58,3,0,11,0,92,13.142857142857142,3,0.0,1,7,57,3,12,0,1,11,0,68,24,0
3010,78000,fFuKiCeoQQwOgD8VAud2ta198Mbq05KK,bWdj2GDclj5ofokWjzoa5jAwMkxCykd6,16,25,13,12,5,51,10,0,116,16.571428571428573,3,0.0,2,13,12,5,23,51,0,10,0,32,84,0
3011,78095,pd8vtyQRUNRd6UqLQhDDx4sQEKhI3nO6,SpATywNh6bZuzm8s1ceuBUnMUAeoAHHw,1,0,0,0,0,0,3,0,3,0.42857142857142855,2,0.0,0,0,0,0,0,0,0,3,0,0,3,1
3012,78101,ew5XZC7WSosl0QdXH45kYD3syMSGbOj6,SpATywNh6bZuzm8s1ceuBUnMUAeoAHHw,3,4,2,0,0,0,2,0,8,1.1428571428571428,1,0.0,0,2,0,0,4,0,0,2,0,2,6,1
3013,78113,95wznOdbj11g3FRFEWLtWETJ4xtU9Lr5,G8EPVSXsOYB5YQWZGiz1aVq5Pgr2GrQu,2,0,0,0,0,0,3,0,3,0.42857142857142855,1,0.0,0,0,0,0,0,0,0,3,0,0,3,1
3014,78207,KxuHPQOdlWxQw9hyxXdRrGHh12yzsPD2,SpATywNh6bZuzm8s1ceuBUnMUAeoAHHw,12,22,0,24,0,0,4,0,50,7.142857142857143,1,0.0,7,0,19,0,15,0,5,4,0,26,24,0
3015,78456,eBckG9AVr6bIBOpezfRr2S1KzQMM7OtD,SpATywNh6bZuzm8s1ceuBUnMUAeoAHHw,4,2,1,0,1,0,1,0,5,0.7142857142857143,1,0.0,0,1,0,1,2,0,0,1,0,2,3,1
3016,78564,X8qfNjsHrwR5R67KkU9t7FXc6jQSGsyo,A3fsA9Zfv1X2fVEQhTw51lKENdNrEqT3,9,12,3,0,1,6,5,0,27,3.857142857142857,1,0.0,0,3,0,1,12,6,0,5,0,4,23,1
3017,78584,5bg7aQCg1xT3BNwuorGcguCUDl8W5Lwl,bWdj2GDclj5ofokWjzoa5jAwMkxCykd6,3,2,1,0,0,7,1,0,11,1.5714285714285714,1,0.0,0,1,0,0,2,7,0,1,0,1,10,1
3018,78686,38U4yWxOl4oZXP5u7g0lCPmmavOa19Ln,A3fsA9Zfv1X2fVEQhTw51lKENdNrEqT3,9,10,1,0,1,0,5,0,17,2.4285714285714284,1,0.0,0,1,0,1,10,0,0,5,0,2,15,1
3019,78691,tmJw00mRQLbE68iN3hs2GcRMynHK5cxp,A3fsA9Zfv1X2fVEQhTw51lKENdNrEqT3,35,22,17,54,11,2,6,2,114,16.285714285714285,1,0.0,2,17,46,11,20,2,8,6,2,76,38,1
3020,78776,eAArxLyCThtu9N3Mv8rQculKbGSa66j9,A3fsA9Zfv1X2fVEQhTw51lKENdNrEqT3,4,2,1,0,0,0,2,0,5,0.7142857142857143,1,0.0,0,1,0,0,2,0,0,2,0,1,4,1
3021,78822,WmqMKoevd5yMpzwxk3BDNFkg4y1FZjx5,A3fsA9Zfv1X2fVEQhTw51lKENdNrEqT3,5,7,0,0,0,0,2,0,9,1.2857142857142858,1,0.0,0,0,0,0,7,0,0,2,0,0,9,1
3022,78834,Ffohn9JNnGJQD2IavzMTS00ubnVtcb2T,bWdj2GDclj5ofokWjzoa5jAwMkxCykd6,26,19,11,63,3,0,6,0,102,14.571428571428571,4,0.0,3,11,52,3,16,0,11,6,0,69,33,0
3023,78897,E96VmAw6m1AOHRckdqiq2ASKbnHBlpAb,A3fsA9Zfv1X2fVEQhTw51lKENdNrEqT3,10,16,2,2,0,0,2,0,22,3.142857142857143,1,0.0,0,2,2,0,16,0,0,2,0,4,18,0
3024,78914,azVElWk7I3VwRJA3S907C5a9P0Jn3yCG,SpATywNh6bZuzm8s1ceuBUnMUAeoAHHw,4,5,5,0,1,0,0,0,11,1.5714285714285714,1,0.0,0,5,0,1,5,0,0,0,0,6,5,1
3025,78948,0OC0czg5KrchA85VzU71XhGpYSu49K6t,SpATywNh6bZuzm8s1ceuBUnMUAeoAHHw,14,20,2,0,1,0,8,0,31,4.428571428571429,1,0.0,4,2,0,1,16,0,0,8,0,7,24,0
3026,78972,ef55znmweQJrijlI0fO1Ekc271nZnV0m,SpATywNh6bZuzm8s1ceuBUnMUAeoAHHw,17,11,8,6,5,0,3,0,33,4.714285714285714,1,0.0,2,8,6,5,9,0,0,3,0,21,12,0
3027,78984,v6Va3YleqjOFxWX0C18ItZbiVgGPA6xX,RXDvfPUBYFlVdlueBFbLW0mhhAyGEqpt,21,21,0,20,0,2,3,0,46,6.571428571428571,1,0.0,4,0,20,0,17,2,0,3,0,24,22,1
3028,79006,mP6z9RZ14UwkQFXdxH2YSItn6R2tzg1x,SpATywNh6bZuzm8s1ceuBUnMUAeoAHHw,6,10,7,0,2,2,2,0,23,3.2857142857142856,3,0.0,0,7,0,2,10,2,0,2,0,9,14,1
3029,79020,lYvVL2L87vZrMtNfBHPIK2tByK515zCD,SpATywNh6bZuzm8s1ceuBUnMUAeoAHHw,31,51,23,38,12,0,10,0,134,19.142857142857142,1,0.0,9,23,32,12,42,0,6,10,0,76,58,1
3030,79022,twCpzhGO216Hze2mrl4NXCjfHuwTo4Bh,SpATywNh6bZuzm8s1ceuBUnMUAeoAHHw,17,17,13,6,6,0,3,0,45,6.428571428571429,1,0.0,2,13,6,6,15,0,0,3,0,27,18,0
3031,79110,TpoKGwVbR1z5uy5X3SWIdHRQv5iAfdP8,G8EPVSXsOYB5YQWZGiz1aVq5Pgr2GrQu,79,78,42,212,17,13,10,1,373,53.285714285714285,2,0.0,14,42,193,17,64,13,19,10,1,266,107,0
3032,79163,LwwIfMdYfjJJxHB8Z4Fggv4xXuygh6dE,A3fsA9Zfv1X2fVEQhTw51lKENdNrEqT3,5,9,2,0,0,0,2,0,13,1.8571428571428572,2,0.0,0,2,0,0,9,0,0,2,0,2,11,1
3033,79169,LwwIfMdYfjJJxHB8Z4Fggv4xXuygh6dE,bWdj2GDclj5ofokWjzoa5jAwMkxCykd6,7,12,1,0,1,0,7,0,21,3.0,2,0.0,0,1,0,1,12,0,0,7,0,2,19,0
3034,79287,wd4pAwN3deBeynXwR5OfOX4prNtBduEk,bWdj2GDclj5ofokWjzoa5jAwMkxCykd6,6,11,3,0,2,0,2,0,18,2.5714285714285716,1,0.0,5,3,0,2,6,0,0,2,0,10,8,1
3035,79299,gpn05NwMGqKm6lLZGRrnOmPlhHxlC7Wb,A3fsA9Zfv1X2fVEQhTw51lKENdNrEqT3,28,7,3,44,1,0,7,0,62,8.857142857142858,1,0.0,1,3,43,1,6,0,1,7,0,48,14,1
3036,79378,LgPlpopSU02baX8XsEJO6rWixplusEKm,SpATywNh6bZuzm8s1ceuBUnMUAeoAHHw,9,5,4,0,1,0,4,0,14,2.0,1,0.0,0,4,0,1,5,0,0,4,0,5,9,0
3037,79511,NMqhcmmxkLiM0RcDlPlkNnMgmo9q8VT7,A3fsA9Zfv1X2fVEQhTw51lKENdNrEqT3,3,4,0,0,0,0,1,0,5,0.7142857142857143,1,0.0,0,0,0,0,4,0,0,1,0,0,5,1
3038,79516,PSAOLNrXnjwLk6spKn3AQn9MyKNbkNFR,A3fsA9Zfv1X2fVEQhTw51lKENdNrEqT3,10,7,5,0,4,0,3,0,19,2.7142857142857144,1,0.0,0,5,0,4,7,0,0,3,0,9,10,1
3039,79530,iF24oNq097ygA95BwYxAfvpVnpWVn9EH,A3fsA9Zfv1X2fVEQhTw51lKENdNrEqT3,1,0,0,0,0,0,1,0,1,0.14285714285714285,1,0.0,0,0,0,0,0,0,0,1,0,0,1,1
3040,79582,yMKOk0dVftHnVR1CEiO9scq4ARXi4xK4,A3fsA9Zfv1X2fVEQhTw51lKENdNrEqT3,15,6,6,0,6,0,3,0,21,3.0,1,0.0,0,6,0,6,6,0,0,3,0,12,9,0
3041,79584,ZbdgVvxsxyG1aqBQ8n6eLVu27gWAZvhX,A3fsA9Zfv1X2fVEQhTw51lKENdNrEqT3,1,0,0,0,0,0,1,0,1,0.14285714285714285,1,0.0,0,0,0,0,0,0,0,1,0,0,1,1
3042,79606,ZOTpNZ0MPCzhXQVB7FrlPGVckR2bh01V,SpATywNh6bZuzm8s1ceuBUnMUAeoAHHw,7,6,5,0,0,0,4,0,15,2.142857142857143,1,0.0,0,5,0,0,6,0,0,4,0,5,10,0
3043,79614,fIRimGrxWNqdzbEvkhoxiWFjGRhUXcWW,A3fsA9Zfv1X2fVEQhTw51lKENdNrEqT3,17,29,7,0,4,0,4,0,44,6.285714285714286,2,0.0,0,7,0,4,29,0,0,4,0,11,33,0
3044,79658,MIuMzVdl8gwQZWh4ux7IRLhRo5aprHQC,A3fsA9Zfv1X2fVEQhTw51lKENdNrEqT3,24,13,10,0,10,0,2,0,35,5.0,1,0.0,0,10,0,10,13,0,0,2,0,20,15,1
3045,79672,kzKMRE4CEMjRtmtzEE50k044KTV0exYI,A3fsA9Zfv1X2fVEQhTw51lKENdNrEqT3,4,2,0,0,0,0,2,0,4,0.5714285714285714,1,0.0,0,0,0,0,2,0,0,2,0,0,4,1
3046,79708,rScZ8wYdCfayAwidHm4E5aYRTim0GnWj,A3fsA9Zfv1X2fVEQhTw51lKENdNrEqT3,7,3,2,0,2,0,4,0,11,1.5714285714285714,1,0.0,0,2,0,2,3,0,0,4,0,4,7,1
3047,79750,iRchfzTUfvY9CtdBwkeS8vPP8TSfaMHm,A3fsA9Zfv1X2fVEQhTw51lKENdNrEqT3,9,12,6,0,5,0,6,0,29,4.142857142857143,1,0.0,1,6,0,5,11,0,0,6,0,12,17,1
3048,79767,ffg9VbmMkFKj2DfO61ClA5PDHr5Xa6gN,A3fsA9Zfv1X2fVEQhTw51lKENdNrEqT3,4,3,1,0,0,0,1,0,5,0.7142857142857143,1,0.0,0,1,0,0,3,0,0,1,0,1,4,1
3049,79789,WIkPVA3ZQexYqPa7aSal3hPiR2XYOXKW,A3fsA9Zfv1X2fVEQhTw51lKENdNrEqT3,42,18,16,60,13,0,2,0,109,15.571428571428571,1,0.0,1,16,52,13,17,0,8,2,0,82,27,1
3050,79797,ziI4sKMlAzhuWPMy9t2U96G01O68Dxyj,A3fsA9Zfv1X2fVEQhTw51lKENdNrEqT3,7,2,1,0,1,0,6,0,10,1.4285714285714286,1,0.0,0,1,0,1,2,0,0,6,0,2,8,0
3051,79813,qMFAmPw34z5IViYTtA1Kkpcn2uEg1WBM,RXDvfPUBYFlVdlueBFbLW0mhhAyGEqpt,19,26,11,16,9,0,2,0,64,9.142857142857142,2,0.0,4,11,14,9,22,0,2,2,0,38,26,1
3052,79887,yonwfYKGqRaxFqA59D8fadwOwcb5hmqL,SpATywNh6bZuzm8s1ceuBUnMUAeoAHHw,6,3,2,0,1,0,4,0,10,1.4285714285714286,1,0.0,0,2,0,1,3,0,0,4,0,3,7,1
3053,79908,Q2dKqJgalCRkN8Z90Lq1SNPa32DtEIlR,A3fsA9Zfv1X2fVEQhTw51lKENdNrEqT3,4,2,0,0,0,0,3,0,5,0.7142857142857143,2,0.0,0,0,0,0,2,0,0,3,0,0,5,1
3054,79912,6aZq0tRjnqwqsZYSpN4QHIWtCCCKxYqK,A3fsA9Zfv1X2fVEQhTw51lKENdNrEqT3,7,3,2,0,2,0,2,0,9,1.2857142857142858,1,0.0,0,2,0,2,3,0,0,2,0,4,5,1
3055,79959,ViTvmoQakNqraCyfp2YEkEE863w1n9bk,A3fsA9Zfv1X2fVEQhTw51lKENdNrEqT3,11,14,9,0,7,0,4,0,34,4.857142857142857,1,0.0,0,9,0,7,14,0,0,4,0,16,18,1
3056,79973,lxjW2IwfKKnK2DrRSZaIR9GsDl9lxdt8,A3fsA9Zfv1X2fVEQhTw51lKENdNrEqT3,22,21,11,0,8,0,6,0,46,6.571428571428571,2,0.0,0,11,0,8,21,0,0,6,0,19,27,0
3057,79990,M0c3f3OA8Aim8kZWQMZkBlO1O030yIDl,A3fsA9Zfv1X2fVEQhTw51lKENdNrEqT3,7,4,1,0,1,0,7,0,13,1.8571428571428572,1,0.0,0,1,0,1,4,0,0,7,0,2,11,1
3058,80011,va3cVfF38XAjn4LEh6VxTTEdlP5IupZ2,A3fsA9Zfv1X2fVEQhTw51lKENdNrEqT3,37,25,0,52,0,0,6,0,83,11.857142857142858,1,0.0,3,0,47,0,22,0,5,6,0,50,33,1
3059,80047,QjwQzuiA6TAJjCb0ag4sYfZRjiTOPACp,SpATywNh6bZuzm8s1ceuBUnMUAeoAHHw,6,4,2,0,1,0,1,0,8,1.1428571428571428,1,0.0,0,2,0,1,4,0,0,1,0,3,5,0
3060,80069,srJeJbIuD6nlvLtYdUFiQcvh7X1ghk8m,A3fsA9Zfv1X2fVEQhTw51lKENdNrEqT3,1,0,0,0,0,0,1,0,1,0.14285714285714285,1,0.0,0,0,0,0,0,0,0,1,0,0,1,1
3061,80096,IAOTVxG7e06ArppQIZcVBCeppiZS52Zi,A3fsA9Zfv1X2fVEQhTw51lKENdNrEqT3,1,0,0,0,0,0,1,0,1,0.14285714285714285,1,0.0,0,0,0,0,0,0,0,1,0,0,1,1
3062,80136,XQFWhrsULMJrGiXoFieAPwx4Rm1ETQ8D,SpATywNh6bZuzm8s1ceuBUnMUAeoAHHw,17,24,11,14,5,0,2,0,56,8.0,1,0.0,11,11,13,5,13,0,1,2,0,40,16,0
3063,80196,y6xjaNTFuIUic3qLUBgR8svfOIFXDQ53,A3fsA9Zfv1X2fVEQhTw51lKENdNrEqT3,2,0,0,0,0,0,4,0,4,0.5714285714285714,1,0.0,0,0,0,0,0,0,0,4,0,0,4,1
3064,80207,53qrF6M0dMx7kKnOiKvVv5yJevXuY3XD,RXDvfPUBYFlVdlueBFbLW0mhhAyGEqpt,50,27,16,87,9,5,9,7,160,22.857142857142858,1,0.0,8,16,79,9,19,5,8,9,7,112,48,1
3065,80231,v20UMppd3ocHkd49REEhfohYTaesL83r,SpATywNh6bZuzm8s1ceuBUnMUAeoAHHw,1,0,0,0,0,0,1,0,1,0.14285714285714285,1,0.0,0,0,0,0,0,0,0,1,0,0,1,1
3066,80258,AlLFcyRB5UwpN8dJK67Vqu0OFPpIDrGm,A3fsA9Zfv1X2fVEQhTw51lKENdNrEqT3,60,32,26,168,17,18,8,0,269,38.42857142857143,3,0.0,3,26,137,17,29,18,31,8,0,183,86,0
3067,80288,TY4t65XwSRMNK0q3MPTxoH0jDDniCwnz,A3fsA9Zfv1X2fVEQhTw51lKENdNrEqT3,1,0,0,0,0,0,1,0,1,0.14285714285714285,1,0.0,0,0,0,0,0,0,0,1,0,0,1,1
3068,80289,ZNeDcv9lqRN7ZQjZM2CkfhEwlbeNJpas,SpATywNh6bZuzm8s1ceuBUnMUAeoAHHw,29,20,13,22,7,3,11,2,78,11.142857142857142,2,0.0,4,13,21,7,16,3,1,11,2,45,33,0
3069,80324,I90xPqkS9HpEgNxHw8dM4fDCcTPeHknd,A3fsA9Zfv1X2fVEQhTw51lKENdNrEqT3,1,0,0,0,0,0,1,0,1,0.14285714285714285,1,0.0,0,0,0,0,0,0,0,1,0,0,1,1
3070,80344,EFMEoi5W4mceo8rjft5LKrYvvT3E2eat,A3fsA9Zfv1X2fVEQhTw51lKENdNrEqT3,5,4,1,0,1,0,1,0,7,1.0,1,0.0,0,1,0,1,4,0,0,1,0,2,5,1
3071,80360,eShFyPGgCT65uThL7XGiKvmljTNciFAA,G8EPVSXsOYB5YQWZGiz1aVq5Pgr2GrQu,34,52,7,50,7,5,12,1,134,19.142857142857142,2,0.0,15,7,36,7,37,5,14,12,1,65,69,1
3072,80400,xH5f8nfW6oTIgHjXoQgEUKIx6qvDN8rk,A3fsA9Zfv1X2fVEQhTw51lKENdNrEqT3,5,4,0,0,0,0,5,0,9,1.2857142857142858,2,0.0,0,0,0,0,4,0,0,5,0,0,9,1
3073,80550,CXCaJpUSDS18xEbIkOvQDpHLpsuhXdw4,A3fsA9Zfv1X2fVEQhTw51lKENdNrEqT3,6,3,1,0,1,0,2,0,7,1.0,1,0.0,0,1,0,1,3,0,0,2,0,2,5,1
3074,80561,0TYsGSagjtpdvts8BjnEYwbdzO0Cq9cu,bWdj2GDclj5ofokWjzoa5jAwMkxCykd6,5,2,1,0,1,0,4,0,8,1.1428571428571428,1,0.0,0,1,0,1,2,0,0,4,0,2,6,1
3075,80563,ZjWuXv8EONEQWoGCaTlXceVXFgdHRHNG,A3fsA9Zfv1X2fVEQhTw51lKENdNrEqT3,24,12,1,58,0,0,2,0,73,10.428571428571429,1,0.0,1,1,47,0,11,0,11,2,0,49,24,1
3076,80564,qWUac1M6H0GGCt2oRkcCo2PK0QcGvZVS,A3fsA9Zfv1X2fVEQhTw51lKENdNrEqT3,8,5,0,8,0,0,1,0,14,2.0,1,0.0,1,0,8,0,4,0,0,1,0,9,5,1
3077,80660,TMS9M7AUlYgaEtdQAX29SchyEATrODFG,G8EPVSXsOYB5YQWZGiz1aVq5Pgr2GrQu,4,2,2,0,1,0,0,0,5,0.7142857142857143,1,0.0,0,2,0,1,2,0,0,0,0,3,2,1
3078,80698,CqJyXqN2l3WOJQLqxchvfRFp3seiLXw6,A3fsA9Zfv1X2fVEQhTw51lKENdNrEqT3,15,15,7,0,6,0,4,0,32,4.571428571428571,2,0.0,0,7,0,6,15,0,0,4,0,13,19,1
3079,80728,EZ8RICWKm2CZHfClKFJxNtx1ItORs9so,SpATywNh6bZuzm8s1ceuBUnMUAeoAHHw,4,3,1,0,0,0,1,0,5,0.7142857142857143,1,0.0,0,1,0,0,3,0,0,1,0,1,4,1
3080,80758,T4bTYOzPYArqtWPF4tmIGoxoB2vrFxrw,SpATywNh6bZuzm8s1ceuBUnMUAeoAHHw,19,19,12,6,7,0,7,1,52,7.428571428571429,3,0.0,3,12,6,7,16,0,0,7,1,28,24,1
3081,80779,6qgQAmX6y5wh5nEPRINOiKrZNoTl5yfT,bWdj2GDclj5ofokWjzoa5jAwMkxCykd6,11,14,10,0,1,16,10,0,51,7.285714285714286,3,0.0,1,10,0,1,13,16,0,10,0,12,39,1
3082,80780,Nn60hlJlXHP7n7M6lOuhaSQUkd1WY1lX,A3fsA9Zfv1X2fVEQhTw51lKENdNrEqT3,2,0,0,0,0,0,2,0,2,0.2857142857142857,1,0.0,0,0,0,0,0,0,0,2,0,0,2,1
3083,80798,B0jVKFlvXfKwVR9pXnhJZcf2VbxqeEJP,SpATywNh6bZuzm8s1ceuBUnMUAeoAHHw,8,6,3,0,2,0,2,0,13,1.8571428571428572,1,0.0,0,3,0,2,6,0,0,2,0,5,8,1
3084,80849,2mD1u3b1vLrSJM0DZTrsvLcZVBVwwd27,A3fsA9Zfv1X2fVEQhTw51lKENdNrEqT3,3,0,0,0,0,0,3,0,3,0.42857142857142855,1,0.0,0,0,0,0,0,0,0,3,0,0,3,1
3085,80867,pXgjy4DXaOKMQD4LAgLui9VHE5CpkZu9,fbPkOYLVPtPgIt0MxizjfFJov3JbHyAi,16,16,10,0,7,0,2,0,35,5.0,1,0.0,3,10,0,7,13,0,0,2,0,20,15,1
3086,80868,swFi5fb79eZLyE5zYDE8WBJhH3Y94beD,fbPkOYLVPtPgIt0MxizjfFJov3JbHyAi,2,0,0,0,0,0,2,0,2,0.2857142857142857,1,0.0,0,0,0,0,0,0,0,2,0,0,2,1
3087,80869,Ov1eEIsyiq4NpsQyBb4m5rDEEYvFdikk,fbPkOYLVPtPgIt0MxizjfFJov3JbHyAi,10,7,5,0,3,1,2,0,18,2.5714285714285716,1,0.0,0,5,0,3,7,1,0,2,0,8,10,1
3088,80870,YM9Z89N137bY5qphnaUaFSAicUvT78c0,fbPkOYLVPtPgIt0MxizjfFJov3JbHyAi,8,11,7,0,3,0,5,0,26,3.7142857142857144,1,0.0,0,7,0,3,11,0,0,5,0,10,16,1
3089,80871,Rs4pfmJlaHiSs2fYG1vucMoIlgnMNq35,fbPkOYLVPtPgIt0MxizjfFJov3JbHyAi,1,0,0,0,0,0,1,0,1,0.14285714285714285,1,0.0,0,0,0,0,0,0,0,1,0,0,1,1
3090,80873,J6Gdt3OhkKwtA1tiJMtQErFzdO5CDNjE,fbPkOYLVPtPgIt0MxizjfFJov3JbHyAi,4,3,0,0,0,0,1,0,4,0.5714285714285714,1,0.0,0,0,0,0,3,0,0,1,0,0,4,1
3091,80877,9aS1NSJb2Hj0xHbbuoyhLmktYrjypxsy,fbPkOYLVPtPgIt0MxizjfFJov3JbHyAi,10,18,6,6,3,18,7,0,58,8.285714285714286,2,0.0,8,6,6,3,10,18,0,7,0,23,35,1
3092,80878,mz4jh38pq3jPwJJzfaN8eT823I3JqGp6,fbPkOYLVPtPgIt0MxizjfFJov3JbHyAi,6,4,0,0,0,2,5,1,12,1.7142857142857142,1,0.0,0,0,0,0,4,2,0,5,1,0,12,1
3093,80881,whV1nFYZoFkMMEitqUr4NmhBR8HyCOwO,fbPkOYLVPtPgIt0MxizjfFJov3JbHyAi,9,12,8,0,3,7,3,0,33,4.714285714285714,3,0.0,0,8,0,3,12,7,0,3,0,11,22,1
3094,80882,a98Mt6r9LLCkAEPo2R3JVMN20OhIPoaG,fbPkOYLVPtPgIt0MxizjfFJov3JbHyAi,9,10,5,0,4,0,6,1,26,3.7142857142857144,4,0.0,0,5,0,4,10,0,0,6,1,9,17,1
3095,80884,jUXtuG5Q1xcdJqmPNWwEYGXvh7x6ZP49,fbPkOYLVPtPgIt0MxizjfFJov3JbHyAi,1,0,0,0,0,0,2,0,2,0.2857142857142857,2,0.0,0,0,0,0,0,0,0,2,0,0,2,1
3096,80886,0DzldTHKdoH90kklIAjpWyAEe6XDDjyM,fbPkOYLVPtPgIt0MxizjfFJov3JbHyAi,5,4,2,0,1,0,1,0,8,1.1428571428571428,1,0.0,1,2,0,1,3,0,0,1,0,4,4,1
3097,80887,oFIudRLykO0Fs6hEVqUgdjhHssApq1CY,fbPkOYLVPtPgIt0MxizjfFJov3JbHyAi,10,6,3,8,4,0,2,0,23,3.2857142857142856,1,0.0,2,3,6,4,4,0,2,2,0,15,8,1
3098,80888,koWvCadm1og0LpcFvcQlTqhBDNIm2AFz,fbPkOYLVPtPgIt0MxizjfFJov3JbHyAi,5,3,2,0,1,0,1,0,7,1.0,1,0.0,0,2,0,1,3,0,0,1,0,3,4,1
3099,80889,K8SEVoLEOyaxiId31CfQ3tViDlX904mj,fbPkOYLVPtPgIt0MxizjfFJov3JbHyAi,7,3,2,0,2,0,2,0,9,1.2857142857142858,1,0.0,0,2,0,2,3,0,0,2,0,4,5,1
3100,80893,u5RnzaYe9alTOldsdopsRhwom5jR9n5h,fbPkOYLVPtPgIt0MxizjfFJov3JbHyAi,12,16,6,4,7,0,3,0,36,5.142857142857143,1,0.0,8,6,4,7,8,0,0,3,0,25,11,1
3101,80895,b17BXpd9CJ1FbG7Eiys3N3TmOMsQOqc5,fbPkOYLVPtPgIt0MxizjfFJov3JbHyAi,6,2,1,0,1,0,3,0,7,1.0,1,0.0,0,1,0,1,2,0,0,3,0,2,5,1
3102,80897,IVsQLNPDPXZtEeF9QnUix2gm2WS214ki,fbPkOYLVPtPgIt0MxizjfFJov3JbHyAi,1,0,0,0,0,0,1,0,1,0.14285714285714285,1,0.0,0,0,0,0,0,0,0,1,0,0,1,1
3103,80898,87MEmQxd2seObxQu44Z8XlD7ySMr8nwp,fbPkOYLVPtPgIt0MxizjfFJov3JbHyAi,9,3,2,0,2,0,9,1,17,2.4285714285714284,1,0.0,0,2,0,2,3,0,0,9,1,4,13,1
3104,80899,LB9Y3hHJxXFKUivI2IDZO69UMgf1mHWd,fbPkOYLVPtPgIt0MxizjfFJov3JbHyAi,5,8,0,0,0,0,1,0,9,1.2857142857142858,1,0.0,0,0,0,0,8,0,0,1,0,0,9,1
3105,80900,zbVrmGy9kpOt2q8xeIclHo9H8afE2cMh,fbPkOYLVPtPgIt0MxizjfFJov3JbHyAi,4,6,2,0,0,0,1,0,9,1.2857142857142858,1,0.0,0,2,0,0,6,0,0,1,0,2,7,1
3106,82357,1v1hnAW2fjxDgMlfMAcBqTKOh6UMFrVl,7GRhBDsirIGkRZBtSMEzNTyDr2JQm4xx,9,9,2,2,2,1,4,0,20,2.857142857142857,2,0.0,4,2,2,2,5,1,0,4,0,10,10,1
3107,82391,r6vCAWlYIzTyZ2tN64AHwtfHr1599fdG,7GRhBDsirIGkRZBtSMEzNTyDr2JQm4xx,38,168,4,41,8,0,23,0,244,34.857142857142854,3,0.0,116,4,35,8,52,0,6,23,0,163,81,0
3108,82642,7IO6p4687fQRowFKh8aP2BRrTBz96sXF,G8EPVSXsOYB5YQWZGiz1aVq5Pgr2GrQu,16,12,5,14,5,0,1,0,37,5.285714285714286,1,0.0,6,5,8,5,6,0,6,1,0,24,13,0
3109,82751,8kDMxN2jxnl0uIdlggQjT6QmHT7F6WvQ,A3fsA9Zfv1X2fVEQhTw51lKENdNrEqT3,9,10,1,0,0,0,5,0,16,2.2857142857142856,1,0.0,0,1,0,0,10,0,0,5,0,1,15,0
3110,82832,bNG7kJA3jy4DW8PDzMNAT9OoyHwhutqS,bWdj2GDclj5ofokWjzoa5jAwMkxCykd6,3,2,0,0,0,0,5,0,7,1.0,1,0.0,0,0,0,0,2,0,0,5,0,0,7,1
3111,82840,Jee7EGsn5XYP5oawysLFsO8VcnPFjYWM,SpATywNh6bZuzm8s1ceuBUnMUAeoAHHw,10,12,8,0,4,0,1,0,25,3.5714285714285716,1,0.0,3,8,0,4,9,0,0,1,0,15,10,1
3112,82875,LSxdutAKHjruUktaLYDzR4TTFH4npHSj,SpATywNh6bZuzm8s1ceuBUnMUAeoAHHw,1,0,0,0,0,0,1,0,1,0.14285714285714285,1,0.0,0,0,0,0,0,0,0,1,0,0,1,1
3113,82997,HKDSRzc7MQzCfJsk49D6xFQK4oFHHvy7,RXDvfPUBYFlVdlueBFbLW0mhhAyGEqpt,25,50,2,0,2,0,9,0,63,9.0,2,0.0,13,2,0,2,37,0,0,9,0,17,46,1
3114,83126,Lcn36O95deZy87mO20P7rqE00Sa7JkLZ,SpATywNh6bZuzm8s1ceuBUnMUAeoAHHw,14,20,9,4,2,10,9,1,55,7.857142857142857,2,0.0,8,9,4,2,12,10,0,9,1,23,32,1
3115,83237,EzJ8kmSst3q4WJG0Np16XBDvh9hFUAyd,SpATywNh6bZuzm8s1ceuBUnMUAeoAHHw,8,11,0,0,0,2,1,0,14,2.0,1,0.0,0,0,0,0,11,2,0,1,0,0,14,0
3116,83305,4NR9J7NrWx9P8bFiOFbZEGtYIezzdGum,SpATywNh6bZuzm8s1ceuBUnMUAeoAHHw,4,3,1,0,1,0,2,0,7,1.0,1,0.0,0,1,0,1,3,0,0,2,0,2,5,1
3117,83403,e7qNFJlKhMPlLeAG8swrUc3pRnnUCD82,SpATywNh6bZuzm8s1ceuBUnMUAeoAHHw,29,28,16,33,7,1,5,0,90,12.857142857142858,2,0.0,9,16,30,7,19,1,3,5,0,62,28,0
3118,83578,t8qBiDTvOvYmrxcVIErRuEOf38tywm6t,A3fsA9Zfv1X2fVEQhTw51lKENdNrEqT3,4,3,2,0,0,2,2,0,9,1.2857142857142858,1,0.0,0,2,0,0,3,2,0,2,0,2,7,1
3119,83597,kzdGmpsGUR2isiUTRf34FiwBn190CZX2,SpATywNh6bZuzm8s1ceuBUnMUAeoAHHw,1,0,0,0,0,0,1,0,1,0.14285714285714285,1,0.0,0,0,0,0,0,0,0,1,0,0,1,1
3120,83610,LsCKaHxDojvW6mqkt4YixGtP1AxIvEcR,SpATywNh6bZuzm8s1ceuBUnMUAeoAHHw,10,9,0,7,0,0,3,0,19,2.7142857142857144,1,0.0,0,0,6,0,9,0,1,3,0,6,13,0
3121,83614,f0G6xN4ok96NnHxUb12ID1EOiKvmCYmR,SpATywNh6bZuzm8s1ceuBUnMUAeoAHHw,4,3,2,0,0,0,1,0,6,0.8571428571428571,1,0.0,0,2,0,0,3,0,0,1,0,2,4,1
3122,83861,yfR3kQ7JpR4tbAAtg2uJogcbjyExFgIX,A3fsA9Zfv1X2fVEQhTw51lKENdNrEqT3,17,9,0,40,0,0,3,0,52,7.428571428571429,1,0.0,3,0,39,0,6,0,1,3,0,42,10,1
3123,83933,bA4tnPZD0UU4XAL3OkL7nUjtkAzbgj9d,bWdj2GDclj5ofokWjzoa5jAwMkxCykd6,10,27,10,6,5,6,4,0,58,8.285714285714286,1,0.0,4,10,5,5,23,6,1,4,0,24,34,0
3124,84260,rYr2KHitWY2dJDjTm0iH4NPcJrqWE49C,fbPkOYLVPtPgIt0MxizjfFJov3JbHyAi,6,3,2,0,2,0,1,0,8,1.1428571428571428,1,0.0,0,2,0,2,3,0,0,1,0,4,4,1
3125,84262,FPAm2uFeanUhwrUMeNexrdAIqWOfXUXu,fbPkOYLVPtPgIt0MxizjfFJov3JbHyAi,9,3,2,0,1,0,9,2,17,2.4285714285714284,1,0.0,0,2,0,1,3,0,0,9,2,3,14,1
3126,84263,wYQFQjixTa6JPR4LS7RDubQDsjze2pIh,fbPkOYLVPtPgIt0MxizjfFJov3JbHyAi,4,0,0,0,0,1,6,0,7,1.0,1,0.0,0,0,0,0,0,1,0,6,0,0,7,1
3127,84265,RfVW0lNKrf9tzkgd827lLFW37SMuSXSa,fbPkOYLVPtPgIt0MxizjfFJov3JbHyAi,1,0,0,0,0,0,1,0,1,0.14285714285714285,1,0.0,0,0,0,0,0,0,0,1,0,0,1,1
3128,84266,Y9sABG91qMGS63qErzaDtI7NXtIr1yry,fbPkOYLVPtPgIt0MxizjfFJov3JbHyAi,1,0,0,0,0,0,2,0,2,0.2857142857142857,1,0.0,0,0,0,0,0,0,0,2,0,0,2,1
3129,84267,fSXZR9jouiiFWLCY3FdQ789t2sGYhvFo,fbPkOYLVPtPgIt0MxizjfFJov3JbHyAi,8,3,2,0,2,0,5,0,12,1.7142857142857142,1,0.0,0,2,0,2,3,0,0,5,0,4,8,1
3130,84269,m3CYAa4IcxX9Ylz9hZ2wRjnl2ftCrROV,fbPkOYLVPtPgIt0MxizjfFJov3JbHyAi,2,0,0,0,0,0,2,0,2,0.2857142857142857,1,0.0,0,0,0,0,0,0,0,2,0,0,2,1
3131,84271,hqClGLaQsSBO8I9GqLKpIixM0sA0K0b8,fbPkOYLVPtPgIt0MxizjfFJov3JbHyAi,7,5,2,0,1,0,6,0,14,2.0,1,0.0,0,2,0,1,5,0,0,6,0,3,11,0
3132,84272,evnakjU40Z6lomGsTCUgDGsdugdMX48K,fbPkOYLVPtPgIt0MxizjfFJov3JbHyAi,1,0,0,0,0,0,1,0,1,0.14285714285714285,1,0.0,0,0,0,0,0,0,0,1,0,0,1,1
3133,84275,pzjUl0u19ajI9ZVL0U8kEZyjNgq0vPjp,fbPkOYLVPtPgIt0MxizjfFJov3JbHyAi,6,1,1,0,1,0,3,0,6,0.8571428571428571,1,0.0,0,1,0,1,1,0,0,3,0,2,4,1
3134,84280,BCFi8OFpWeV6fuTRoD5vV8AJMWuQ1jB1,fbPkOYLVPtPgIt0MxizjfFJov3JbHyAi,1,0,0,0,0,0,1,0,1,0.14285714285714285,1,0.0,0,0,0,0,0,0,0,1,0,0,1,1
3135,84283,e0psMwhUBdLDxrOxBkoveKoEdFTTZrF1,fbPkOYLVPtPgIt0MxizjfFJov3JbHyAi,1,0,0,0,0,0,1,0,1,0.14285714285714285,1,0.0,0,0,0,0,0,0,0,1,0,0,1,1
3136,84286,jzGZfbr4RQdn7HQn4oyJMDfKBcS7VFEE,fbPkOYLVPtPgIt0MxizjfFJov3JbHyAi,5,5,0,0,0,0,5,0,10,1.4285714285714286,1,0.0,0,0,0,0,5,0,0,5,0,0,10,1
3137,84287,7Wr0weM79zMxBVlRbYesNzjHgoZsdOEJ,fbPkOYLVPtPgIt0MxizjfFJov3JbHyAi,5,2,1,0,1,0,2,0,6,0.8571428571428571,1,0.0,0,1,0,1,2,0,0,2,0,2,4,1
3138,84288,7o7xgD7LMzcqbchAXccb0936AlSMEPrX,fbPkOYLVPtPgIt0MxizjfFJov3JbHyAi,11,16,5,0,2,1,8,1,33,4.714285714285714,1,0.0,0,5,0,2,16,1,0,8,1,7,26,1
3139,84290,ZjhTJ45cHD4xtUxPoyNMJGOQiBl5fTQp,fbPkOYLVPtPgIt0MxizjfFJov3JbHyAi,5,1,1,0,1,0,3,0,6,0.8571428571428571,1,0.0,0,1,0,1,1,0,0,3,0,2,4,1
3140,84292,vvCucU5XJyhTM3r43nJfSwk9oTpOoOzq,fbPkOYLVPtPgIt0MxizjfFJov3JbHyAi,2,0,0,0,0,0,2,0,2,0.2857142857142857,1,0.0,0,0,0,0,0,0,0,2,0,0,2,1
3141,84428,X7EWmuNzsz8xJY0A1pRUOJGHwrCZ0B64,bWdj2GDclj5ofokWjzoa5jAwMkxCykd6,5,4,1,0,2,0,6,0,13,1.8571428571428572,1,0.0,2,1,0,2,2,0,0,6,0,5,8,1
3142,84435,OOJh2Yrr6RQf9QAHFBo7EBzeZ2OAmLfw,SpATywNh6bZuzm8s1ceuBUnMUAeoAHHw,4,3,1,0,0,0,2,0,6,0.8571428571428571,1,0.0,0,1,0,0,3,0,0,2,0,1,5,1
3143,84436,Vu8rN942EwDIOj6iE8IDqvSFXpvGHO9R,bWdj2GDclj5ofokWjzoa5jAwMkxCykd6,1,0,0,0,0,0,1,0,1,0.14285714285714285,1,0.0,0,0,0,0,0,0,0,1,0,0,1,1
3144,84462,bfYktB6xMRG2G8ooGt6o3rE63qV6JxlI,A3fsA9Zfv1X2fVEQhTw51lKENdNrEqT3,1,0,0,0,0,0,1,0,1,0.14285714285714285,1,0.0,0,0,0,0,0,0,0,1,0,0,1,1
3145,84519,RijiZcjqs3Sau2onXuynGNDorKgFFeFF,bWdj2GDclj5ofokWjzoa5jAwMkxCykd6,2,0,0,0,0,0,2,0,2,0.2857142857142857,1,0.0,0,0,0,0,0,0,0,2,0,0,2,1
3146,84525,Q8lgDaE6CB6Qe5bNGFRY9Gtyuy1mU1jD,bWdj2GDclj5ofokWjzoa5jAwMkxCykd6,5,6,1,0,0,0,2,0,9,1.2857142857142858,1,0.0,1,1,0,0,5,0,0,2,0,2,7,1
3147,84556,OatCEetKd31vq2MFNsgH6MMikZrZEqiC,bWdj2GDclj5ofokWjzoa5jAwMkxCykd6,6,5,0,0,1,0,3,0,9,1.2857142857142858,1,0.0,0,0,0,1,5,0,0,3,0,1,8,1
3148,84580,7dBPQqnhg3HraIZoj8IGy6tqqgLAonOI,SpATywNh6bZuzm8s1ceuBUnMUAeoAHHw,22,39,1,22,0,0,5,0,67,9.571428571428571,2,0.0,18,1,21,0,21,0,1,5,0,40,27,1
3149,84601,xH5f8nfW6oTIgHjXoQgEUKIx6qvDN8rk,SpATywNh6bZuzm8s1ceuBUnMUAeoAHHw,10,10,5,4,2,0,3,0,24,3.4285714285714284,1,0.0,3,5,3,2,7,0,1,3,0,13,11,1
3150,84623,bVCYDQX7pJxff6OyJX4M9s17AtFlpk5i,bWdj2GDclj5ofokWjzoa5jAwMkxCykd6,7,4,2,0,2,0,2,0,10,1.4285714285714286,1,0.0,0,2,0,2,4,0,0,2,0,4,6,1
3151,84653,M8sw9Q866fjD6jCvGFf8R8DxTYZlPOJu,A3fsA9Zfv1X2fVEQhTw51lKENdNrEqT3,6,3,2,0,1,0,2,0,8,1.1428571428571428,1,0.0,0,2,0,1,3,0,0,2,0,3,5,1
3152,84661,WEqUhplW7x1SpLabVjNcI5M4HsCYjumg,bWdj2GDclj5ofokWjzoa5jAwMkxCykd6,1,0,0,0,0,0,1,0,1,0.14285714285714285,1,0.0,0,0,0,0,0,0,0,1,0,0,1,1
3153,84662,WEqUhplW7x1SpLabVjNcI5M4HsCYjumg,A3fsA9Zfv1X2fVEQhTw51lKENdNrEqT3,1,0,0,0,0,0,1,0,1,0.14285714285714285,1,0.0,0,0,0,0,0,0,0,1,0,0,1,0
3154,84666,hBNiP82EasOgIR36wjHyg8vPIDQi3YO9,bWdj2GDclj5ofokWjzoa5jAwMkxCykd6,2,0,0,0,0,0,3,0,3,0.42857142857142855,1,0.0,0,0,0,0,0,0,0,3,0,0,3,1
3155,84675,BEEx400Zym1Adj0LXV9O094DcgDYxMgU,SpATywNh6bZuzm8s1ceuBUnMUAeoAHHw,4,2,1,0,1,2,1,0,7,1.0,1,0.0,0,1,0,1,2,2,0,1,0,2,5,1
3156,84683,4VbB29c0q05cB50SX5b3ExZB3pSJc6RG,bWdj2GDclj5ofokWjzoa5jAwMkxCykd6,1,0,0,0,0,0,1,0,1,0.14285714285714285,1,0.0,0,0,0,0,0,0,0,1,0,0,1,1
3157,84699,BePz5wimB2cOHtaUExV25HDlvULcE611,bWdj2GDclj5ofokWjzoa5jAwMkxCykd6,1,0,0,0,0,0,1,0,1,0.14285714285714285,1,0.0,0,0,0,0,0,0,0,1,0,0,1,1
3158,84700,y6ntZnNLGo4HBLvhhvkQknL88GLC1lnO,A3fsA9Zfv1X2fVEQhTw51lKENdNrEqT3,9,11,6,0,3,0,2,0,22,3.142857142857143,1,0.0,0,6,0,3,11,0,0,2,0,9,13,1
3159,84701,T7Fjesc6ALJYDwDrKyS5CHisl2gr4aWJ,SpATywNh6bZuzm8s1ceuBUnMUAeoAHHw,18,25,8,16,4,2,7,1,63,9.0,1,0.0,11,8,15,4,14,2,1,7,1,38,25,1
3160,84702,BePz5wimB2cOHtaUExV25HDlvULcE611,A3fsA9Zfv1X2fVEQhTw51lKENdNrEqT3,7,4,2,0,2,0,2,0,10,1.4285714285714286,1,0.0,0,2,0,2,4,0,0,2,0,4,6,1
3161,84709,1Ld3jQU8M0eiaLBshs8gjcgQEfdlgHyZ,A3fsA9Zfv1X2fVEQhTw51lKENdNrEqT3,4,1,0,0,0,0,4,0,5,0.7142857142857143,2,0.0,0,0,0,0,1,0,0,4,0,0,5,1
3162,84728,GEuM5Jv5mgEiHQoZ7WZazbnkG2fcrd9Y,SpATywNh6bZuzm8s1ceuBUnMUAeoAHHw,27,36,23,21,15,2,4,0,101,14.428571428571429,2,0.0,10,23,19,15,26,2,2,4,0,67,34,0
3163,84745,BecDXRtXjm4nVBtBp7AS3BiGeJeKZmYu,SpATywNh6bZuzm8s1ceuBUnMUAeoAHHw,8,19,14,0,4,2,8,0,47,6.714285714285714,2,0.0,0,14,0,4,19,2,0,8,0,18,29,1
3164,84762,NC1pdSztpfJLgz1bqVoe5aonviJWe881,A3fsA9Zfv1X2fVEQhTw51lKENdNrEqT3,9,7,1,0,1,1,5,0,15,2.142857142857143,1,0.0,0,1,0,1,7,1,0,5,0,2,13,1
3165,84772,zZhdHu8U17iajwoRnuWugvDVR1mdDKy8,bWdj2GDclj5ofokWjzoa5jAwMkxCykd6,5,2,1,0,1,0,2,0,6,0.8571428571428571,1,0.0,0,1,0,1,2,0,0,2,0,2,4,1
3166,84777,pQdSl7i5ZuZeH9uPILgdHrvwskp4vc4V,SpATywNh6bZuzm8s1ceuBUnMUAeoAHHw,2,0,0,0,0,0,2,0,2,0.2857142857142857,1,0.0,0,0,0,0,0,0,0,2,0,0,2,1
3167,84779,Yg1xD2SamgKDKmDpRN2e3H3NAX0vGE2e,SpATywNh6bZuzm8s1ceuBUnMUAeoAHHw,23,36,2,31,1,7,16,0,93,13.285714285714286,3,0.0,18,2,28,1,18,7,3,16,0,49,44,1
3168,84789,rK4055OdlTymOWiwkxW7eIve09mowPhX,SpATywNh6bZuzm8s1ceuBUnMUAeoAHHw,7,7,3,0,1,0,2,0,13,1.8571428571428572,1,0.0,3,3,0,1,4,0,0,2,0,7,6,1
3169,84792,uGYj0yruFsWhwZGIUR02DogFquupaSDC,A3fsA9Zfv1X2fVEQhTw51lKENdNrEqT3,2,0,0,0,0,0,2,0,2,0.2857142857142857,1,0.0,0,0,0,0,0,0,0,2,0,0,2,1
3170,84795,uGYj0yruFsWhwZGIUR02DogFquupaSDC,SpATywNh6bZuzm8s1ceuBUnMUAeoAHHw,3,0,0,0,0,0,3,0,3,0.42857142857142855,1,0.0,0,0,0,0,0,0,0,3,0,0,3,1
3171,84798,TMW9SZvtLJ7yT5p9QtW5dUGKwlkcqKyn,SpATywNh6bZuzm8s1ceuBUnMUAeoAHHw,4,5,0,0,0,0,1,0,6,0.8571428571428571,1,0.0,0,0,0,0,5,0,0,1,0,0,6,1
3172,84805,eo86tl8OT9De2TqE4YR9qShJM6EFKpQ8,bWdj2GDclj5ofokWjzoa5jAwMkxCykd6,1,0,0,0,0,0,1,0,1,0.14285714285714285,1,0.0,0,0,0,0,0,0,0,1,0,0,1,1
3173,84812,hfXydPAjmOPsUaxL2NqJ9TVTB2YLFfnT,A3fsA9Zfv1X2fVEQhTw51lKENdNrEqT3,6,6,4,0,1,0,1,0,12,1.7142857142857142,1,0.0,1,4,0,1,5,0,0,1,0,6,6,1
3174,84817,Wefj86tFjwJZnMq6IAWMjbzJgYWyoGE5,SpATywNh6bZuzm8s1ceuBUnMUAeoAHHw,5,2,1,0,1,0,2,0,6,0.8571428571428571,1,0.0,0,1,0,1,2,0,0,2,0,2,4,1
3175,84826,Q9zNW7tUNygCfX90HmMYh3sp90BWwKOU,SpATywNh6bZuzm8s1ceuBUnMUAeoAHHw,5,5,2,0,1,0,3,0,11,1.5714285714285714,2,0.0,0,2,0,1,5,0,0,3,0,3,8,1
3176,84828,Q9zNW7tUNygCfX90HmMYh3sp90BWwKOU,A3fsA9Zfv1X2fVEQhTw51lKENdNrEqT3,7,5,2,0,2,0,4,0,13,1.8571428571428572,2,0.0,0,2,0,2,5,0,0,4,0,4,9,1
3177,84830,Q9zNW7tUNygCfX90HmMYh3sp90BWwKOU,bWdj2GDclj5ofokWjzoa5jAwMkxCykd6,1,0,0,0,0,0,4,0,4,0.5714285714285714,1,0.0,0,0,0,0,0,0,0,4,0,0,4,1
3178,84833,lYZxf8lh7ftdpqB6JLOchZTdcrWSTRKb,SpATywNh6bZuzm8s1ceuBUnMUAeoAHHw,1,0,0,0,0,0,1,0,1,0.14285714285714285,1,0.0,0,0,0,0,0,0,0,1,0,0,1,1
3179,84839,VIwJtaSOWWljnDL02ObzIxH4JeVU0QQ1,A3fsA9Zfv1X2fVEQhTw51lKENdNrEqT3,11,10,7,0,3,0,8,0,28,4.0,2,0.0,0,7,0,3,10,0,0,8,0,10,18,1
3180,84843,SgKrscfCtmytbxsrqs57oYYzOpyIlSfF,A3fsA9Zfv1X2fVEQhTw51lKENdNrEqT3,13,8,5,4,2,3,2,0,24,3.4285714285714284,1,0.0,0,5,4,2,8,3,0,2,0,11,13,0
3181,84847,FeSQQc9CIFMTYLlHcSRbUJqf0NNwxJ2K,A3fsA9Zfv1X2fVEQhTw51lKENdNrEqT3,3,2,0,0,0,0,1,0,3,0.42857142857142855,1,0.0,0,0,0,0,2,0,0,1,0,0,3,0
3182,84848,ykaUPJW4Nc9r2mv4b25QxgdHgIcQ63RQ,A3fsA9Zfv1X2fVEQhTw51lKENdNrEqT3,3,5,1,0,0,0,1,0,7,1.0,2,0.0,0,1,0,0,5,0,0,1,0,1,6,0
3183,84851,1GaXo8IuKFR6VdEVIYRJbTRl2qOzgbEk,SpATywNh6bZuzm8s1ceuBUnMUAeoAHHw,20,15,12,2,9,0,2,0,40,5.714285714285714,2,0.0,1,12,2,9,14,0,0,2,0,24,16,1
3184,84859,tW4kGyQmGPxJ7lQyOwGHaOFglTma7gIC,A3fsA9Zfv1X2fVEQhTw51lKENdNrEqT3,1,0,0,0,0,0,1,0,1,0.14285714285714285,1,0.0,0,0,0,0,0,0,0,1,0,0,1,1
3185,84861,HWTC2OrGiLVAGzdqeYnCu2ZFUrUbe6I6,A3fsA9Zfv1X2fVEQhTw51lKENdNrEqT3,24,13,11,0,9,0,10,0,43,6.142857142857143,2,0.0,0,11,0,9,13,0,0,10,0,20,23,1
3186,84878,94L6G6uqjoIozyLQIsc4GEWmNn1tQth5,SpATywNh6bZuzm8s1ceuBUnMUAeoAHHw,5,5,2,0,1,0,1,0,9,1.2857142857142858,1,0.0,2,2,0,1,3,0,0,1,0,5,4,1
3187,84900,kFEFWVRKxySg48KS2BQ5EGBj2Fy43YYR,SpATywNh6bZuzm8s1ceuBUnMUAeoAHHw,19,47,0,41,0,0,1,0,89,12.714285714285714,1,0.0,28,0,34,0,19,0,7,1,0,62,27,0
3188,84901,vDE54330fhfIeduEF4A9zDFR0caHiOdH,SpATywNh6bZuzm8s1ceuBUnMUAeoAHHw,5,4,2,0,2,0,1,0,9,1.2857142857142858,1,0.0,0,2,0,2,4,0,0,1,0,4,5,0
3189,84917,0vwRPKOOXqPVOG208KGIKC6ZMS7Sq8oQ,SpATywNh6bZuzm8s1ceuBUnMUAeoAHHw,1,0,0,0,0,0,1,0,1,0.14285714285714285,1,0.0,0,0,0,0,0,0,0,1,0,0,1,1
3190,84921,P8HECw7bHyNqGqPTlWbv24tTg1SG6bAf,bWdj2GDclj5ofokWjzoa5jAwMkxCykd6,5,2,1,0,1,0,2,0,6,0.8571428571428571,1,0.0,0,1,0,1,2,0,0,2,0,2,4,1
3191,84961,Z7OL2jReCGgQtTEQuUTXjMfA5lyDuHVX,bWdj2GDclj5ofokWjzoa5jAwMkxCykd6,1,0,0,0,0,0,1,0,1,0.14285714285714285,1,0.0,0,0,0,0,0,0,0,1,0,0,1,1
3192,84966,pCc4oMnSwjyLKgjKHMWP0AClAZXrGa7k,SpATywNh6bZuzm8s1ceuBUnMUAeoAHHw,4,3,2,0,2,0,1,0,8,1.1428571428571428,1,0.0,0,2,0,2,3,0,0,1,0,4,4,1
3193,84984,DzeVjg4mxykX9i07xMVI01d13jNEeveb,SpATywNh6bZuzm8s1ceuBUnMUAeoAHHw,7,2,1,0,1,1,5,0,10,1.4285714285714286,1,0.0,0,1,0,1,2,1,0,5,0,2,8,1
3194,84985,CrUGk3m8dLEwGtioGoHIpBu2eedFaqft,A3fsA9Zfv1X2fVEQhTw51lKENdNrEqT3,1,0,0,0,0,0,1,0,1,0.14285714285714285,1,0.0,0,0,0,0,0,0,0,1,0,0,1,1
3195,84991,NA0DQ3D2dj2Qrm5FSVbmrxMOfzF4fwPf,A3fsA9Zfv1X2fVEQhTw51lKENdNrEqT3,4,4,0,0,0,2,2,0,8,1.1428571428571428,1,0.0,0,0,0,0,4,2,0,2,0,0,8,1
3196,85012,DyupaV8BmUavHjvovvxyDg1D0z37S8dm,bWdj2GDclj5ofokWjzoa5jAwMkxCykd6,7,4,3,0,2,0,2,0,11,1.5714285714285714,2,0.0,0,3,0,2,4,0,0,2,0,5,6,1
3197,85021,QAaGqoCRVYYJLVC9SEo8gPzESLmuOfNy,SpATywNh6bZuzm8s1ceuBUnMUAeoAHHw,6,3,1,0,2,0,1,0,7,1.0,1,0.0,0,1,0,2,3,0,0,1,0,3,4,1
3198,85025,BvCRPlMfMau2kDEBEjyV1l6RJMQy5B5l,A3fsA9Zfv1X2fVEQhTw51lKENdNrEqT3,5,3,2,0,0,0,4,0,9,1.2857142857142858,1,0.0,0,2,0,0,3,0,0,4,0,2,7,1
3199,85046,kNdT4Mob6J1VkdvqbhmS4aPzbDLqNeYP,bWdj2GDclj5ofokWjzoa5jAwMkxCykd6,3,3,0,0,0,0,0,0,3,0.42857142857142855,1,0.0,0,0,0,0,3,0,0,0,0,0,3,1
3200,85050,nyeqFiX3kXuwJTyYhNUJyRvPBqtJ6Two,bWdj2GDclj5ofokWjzoa5jAwMkxCykd6,5,2,1,0,1,0,4,0,8,1.1428571428571428,1,0.0,0,1,0,1,2,0,0,4,0,2,6,1
3201,85076,oW1xvgPq04VONgGO2ScFMsBR7tam1x2P,SpATywNh6bZuzm8s1ceuBUnMUAeoAHHw,6,6,1,0,1,0,2,0,10,1.4285714285714286,1,0.0,0,1,0,1,6,0,0,2,0,2,8,1
3202,85111,4sNqSI7Ntno9WsJhOo6RhAKwZwVuo3TV,bWdj2GDclj5ofokWjzoa5jAwMkxCykd6,1,0,0,0,0,0,1,0,1,0.14285714285714285,1,0.0,0,0,0,0,0,0,0,1,0,0,1,1
3203,85125,HpVSIYjYyErYvGk0jIIh7vGC0VGqoFpj,bWdj2GDclj5ofokWjzoa5jAwMkxCykd6,8,4,2,0,1,0,7,1,15,2.142857142857143,1,0.0,0,2,0,1,4,0,0,7,1,3,12,0
3204,85126,PWCmirnemxe8gmyr1O505eqeMATy6y8u,SpATywNh6bZuzm8s1ceuBUnMUAeoAHHw,7,3,2,0,2,0,2,0,9,1.2857142857142858,1,0.0,0,2,0,2,3,0,0,2,0,4,5,0
3205,85127,dZqFLbQhzRGv0XrnoR6Btyn7eZPLWNcs,SpATywNh6bZuzm8s1ceuBUnMUAeoAHHw,12,18,0,20,0,0,2,0,40,5.714285714285714,1,0.0,6,0,17,0,12,0,3,2,0,23,17,1
3206,85129,BvCRPlMfMau2kDEBEjyV1l6RJMQy5B5l,bWdj2GDclj5ofokWjzoa5jAwMkxCykd6,4,7,3,0,0,2,5,0,17,2.4285714285714284,1,0.0,2,3,0,0,5,2,0,5,0,5,12,1
3207,85135,n2FEbIJOdMpzLhQAaysQpPRu04nDuH4a,bWdj2GDclj5ofokWjzoa5jAwMkxCykd6,7,9,4,0,3,0,2,0,18,2.5714285714285716,1,0.0,0,4,0,3,9,0,0,2,0,7,11,1
3208,85144,CVCf4od7ffnWY5VcGG9qXOV7fsgr6eo9,G8EPVSXsOYB5YQWZGiz1aVq5Pgr2GrQu,8,2,0,0,0,0,13,0,15,2.142857142857143,1,0.0,0,0,0,0,2,0,0,13,0,0,15,1
3209,85174,TNWu8lQOCqXwhlhWhjlBSPXoG0TmfsH5,SpATywNh6bZuzm8s1ceuBUnMUAeoAHHw,1,0,0,0,0,0,2,0,2,0.2857142857142857,1,0.0,0,0,0,0,0,0,0,2,0,0,2,1
3210,85178,TNWu8lQOCqXwhlhWhjlBSPXoG0TmfsH5,bWdj2GDclj5ofokWjzoa5jAwMkxCykd6,1,0,0,0,0,0,2,0,2,0.2857142857142857,1,0.0,0,0,0,0,0,0,0,2,0,0,2,1
3211,85182,TNWu8lQOCqXwhlhWhjlBSPXoG0TmfsH5,A3fsA9Zfv1X2fVEQhTw51lKENdNrEqT3,1,0,0,0,0,0,2,0,2,0.2857142857142857,1,0.0,0,0,0,0,0,0,0,2,0,0,2,1
3212,85191,YgaRsb5CJPElWQw5mvJ8Vl3IfLfYzm4F,SpATywNh6bZuzm8s1ceuBUnMUAeoAHHw,16,16,8,10,5,0,3,0,42,6.0,2,0.0,3,8,10,5,13,0,0,3,0,26,16,1
3213,85204,rSg9Ux5o4Clwkrl8yQB8aMYBxGhrELBb,bWdj2GDclj5ofokWjzoa5jAwMkxCykd6,5,3,1,0,1,0,2,0,7,1.0,1,0.0,0,1,0,1,3,0,0,2,0,2,5,1
3214,85215,hu8eak1Xmf8voE8pnxPzkSD2dZP9Sipf,RXDvfPUBYFlVdlueBFbLW0mhhAyGEqpt,3,1,0,0,0,0,2,0,3,0.42857142857142855,1,0.0,0,0,0,0,1,0,0,2,0,0,3,1
3215,85221,QtVFRX2q8o00yrhDoRxTCIn6JhufsUXY,A3fsA9Zfv1X2fVEQhTw51lKENdNrEqT3,1,0,0,0,0,0,1,0,1,0.14285714285714285,1,0.0,0,0,0,0,0,0,0,1,0,0,1,1
3216,85234,x8deFWL3OuMwdtM1Ar06UAP0kS8JTUGt,SpATywNh6bZuzm8s1ceuBUnMUAeoAHHw,14,32,0,21,0,0,2,0,55,7.857142857142857,1,0.0,19,0,18,0,13,0,3,2,0,37,18,1
3217,85236,rSg9Ux5o4Clwkrl8yQB8aMYBxGhrELBb,A3fsA9Zfv1X2fVEQhTw51lKENdNrEqT3,6,3,1,0,1,0,2,0,7,1.0,1,0.0,0,1,0,1,3,0,0,2,0,2,5,1
3218,85254,5AnTWuSZRA41O05i9OVXdtPUlL8FmaJL,SpATywNh6bZuzm8s1ceuBUnMUAeoAHHw,13,22,4,2,1,7,19,3,58,8.285714285714286,2,0.0,1,4,2,1,21,7,0,19,3,8,50,1
3219,85307,HDadS1kWhA9nJbFHsRG6aT6o1pPlcFrf,SpATywNh6bZuzm8s1ceuBUnMUAeoAHHw,1,0,0,0,0,0,1,0,1,0.14285714285714285,1,0.0,0,0,0,0,0,0,0,1,0,0,1,1
3220,85315,6wxNqFTG10UU1QlHAjCeeHAXofHA0Wd6,A3fsA9Zfv1X2fVEQhTw51lKENdNrEqT3,2,0,0,0,0,0,2,0,2,0.2857142857142857,1,0.0,0,0,0,0,0,0,0,2,0,0,2,1
3221,85320,6W33zL2q4028wAczl90YoEq5VRoJonHk,bWdj2GDclj5ofokWjzoa5jAwMkxCykd6,2,0,0,0,0,0,2,0,2,0.2857142857142857,1,0.0,0,0,0,0,0,0,0,2,0,0,2,0
3222,85329,dkZKTQ89aNq1jLWsQ8GHGCzeOaVmaX8E,SpATywNh6bZuzm8s1ceuBUnMUAeoAHHw,1,0,0,0,0,0,1,0,1,0.14285714285714285,1,0.0,0,0,0,0,0,0,0,1,0,0,1,1
3223,85336,176ILS8J1NMmZsoc0RxEg8JQJcz6ksLo,A3fsA9Zfv1X2fVEQhTw51lKENdNrEqT3,1,0,0,0,0,0,1,0,1,0.14285714285714285,1,0.0,0,0,0,0,0,0,0,1,0,0,1,1
3224,85340,7iqCukuZ9oGbANuGlupslMrsiHUFtGa5,bWdj2GDclj5ofokWjzoa5jAwMkxCykd6,3,3,1,0,0,0,1,0,5,0.7142857142857143,1,0.0,0,1,0,0,3,0,0,1,0,1,4,1
3225,85347,qr1Y8xuPrcpdzScNHYsirGXqasfUdOVa,A3fsA9Zfv1X2fVEQhTw51lKENdNrEqT3,12,12,9,0,5,0,5,0,31,4.428571428571429,2,0.0,0,9,0,5,12,0,0,5,0,14,17,1
3226,85360,sT9hGAnww95aeGvqwQpJlS3ORhWDT49F,SpATywNh6bZuzm8s1ceuBUnMUAeoAHHw,14,19,12,6,1,0,6,0,44,6.285714285714286,1,0.0,3,12,6,1,16,0,0,6,0,22,22,0
3227,85362,h7k1wsPKqQnsb0xgegTBlN0S8ZpolGHh,SpATywNh6bZuzm8s1ceuBUnMUAeoAHHw,6,5,1,0,1,0,2,0,9,1.2857142857142858,1,0.0,0,1,0,1,5,0,0,2,0,2,7,1
3228,85381,MaYaRLQWCfitDjLO89g6UksqHgmMxPRV,SpATywNh6bZuzm8s1ceuBUnMUAeoAHHw,23,31,2,38,0,1,8,1,81,11.571428571428571,2,0.0,12,2,32,0,19,1,6,8,1,46,35,0
3229,87094,TPPsOieQBcwqH8dqABTR3mddQ5gDzlZO,A3fsA9Zfv1X2fVEQhTw51lKENdNrEqT3,22,26,20,0,18,0,3,0,67,9.571428571428571,1,0.0,3,20,0,18,23,0,0,3,0,41,26,1
3230,87147,PHBho9Sc0XQZt8wGEuns5tbDU5eoHa8g,A3fsA9Zfv1X2fVEQhTw51lKENdNrEqT3,24,43,24,0,15,0,13,0,95,13.571428571428571,2,0.0,4,24,0,15,39,0,0,13,0,43,52,0
3231,87190,rs3WOUQ4PSHbNxyhVeLlE6lgdYqGPTef,SpATywNh6bZuzm8s1ceuBUnMUAeoAHHw,16,26,5,15,3,0,4,0,53,7.571428571428571,1,0.0,20,5,14,3,6,0,1,4,0,42,11,1
3232,87447,QflUMQYqgKuyQPnCteHvz3LqhJ9AwCga,RXDvfPUBYFlVdlueBFbLW0mhhAyGEqpt,37,63,47,0,39,6,8,0,163,23.285714285714285,2,0.0,8,47,0,39,55,6,0,8,0,94,69,1
3233,87520,pqsPOTJhOrzp1CuSM0L3m4JXPVXPbkqe,SpATywNh6bZuzm8s1ceuBUnMUAeoAHHw,4,2,1,0,0,0,2,0,5,0.7142857142857143,1,0.0,0,1,0,0,2,0,0,2,0,1,4,1
3234,87544,HF98YPKzT8oi2j9flZW9kstZcvL3ZimG,SpATywNh6bZuzm8s1ceuBUnMUAeoAHHw,7,8,4,0,2,0,1,0,15,2.142857142857143,1,0.0,0,4,0,2,8,0,0,1,0,6,9,0
3235,87563,mLnrkBxCMzHzCOgxlcePLHngsSsyrmY0,SpATywNh6bZuzm8s1ceuBUnMUAeoAHHw,17,35,0,20,0,2,11,1,69,9.857142857142858,2,0.0,15,0,18,0,20,2,2,11,1,33,36,0
3236,87987,Ffohn9JNnGJQD2IavzMTS00ubnVtcb2T,SpATywNh6bZuzm8s1ceuBUnMUAeoAHHw,17,12,8,6,4,0,2,0,32,4.571428571428571,2,0.0,2,8,6,4,10,0,0,2,0,20,12,0
3237,88029,bSaZ1hYnI1zX06sBhHjW0JtYDEAqEuPp,SpATywNh6bZuzm8s1ceuBUnMUAeoAHHw,16,14,0,8,0,1,10,2,35,5.0,1,0.0,3,0,7,0,11,1,1,10,2,10,25,0
3238,88086,ffLXxfgMU4yir9uI5fIkKo2iZzEw2Lpz,A3fsA9Zfv1X2fVEQhTw51lKENdNrEqT3,4,0,0,0,0,1,3,0,4,0.5714285714285714,1,0.0,0,0,0,0,0,1,0,3,0,0,4,1
3239,88290,zagfJzNHtSvWCFgkMj9NSIbmff9j4Jzi,7GRhBDsirIGkRZBtSMEzNTyDr2JQm4xx,5,2,1,0,1,1,4,0,9,1.2857142857142858,1,0.0,0,1,0,1,2,1,0,4,0,2,7,1
3240,88395,qInCpaeuecWrGMAIOnQb1wZeYTgOfrqB,7GRhBDsirIGkRZBtSMEzNTyDr2JQm4xx,1,0,0,0,0,0,1,0,1,0.14285714285714285,1,0.0,0,0,0,0,0,0,0,1,0,0,1,1
3241,88419,Nnydl7u2ge7nezXYbZ5DWwoPbVU96qN7,7GRhBDsirIGkRZBtSMEzNTyDr2JQm4xx,25,25,12,25,7,2,4,0,75,10.714285714285714,1,0.0,8,12,19,7,17,2,6,4,0,46,29,1
3242,88520,klfSXDgeuLd0URCaUqSBWiGxyD6lj0zh,7GRhBDsirIGkRZBtSMEzNTyDr2JQm4xx,31,53,12,38,14,18,7,0,142,20.285714285714285,1,0.0,34,12,33,14,19,18,5,7,0,93,49,1
3243,88535,RMHhN3yqeqMVtL0le3LPxRjp5aMu0uOX,7GRhBDsirIGkRZBtSMEzNTyDr2JQm4xx,7,3,2,0,2,0,2,0,9,1.2857142857142858,1,0.0,0,2,0,2,3,0,0,2,0,4,5,1
3244,88543,dorUpp1ODfe9BqxoBX8EUNGD90FW70kn,7GRhBDsirIGkRZBtSMEzNTyDr2JQm4xx,37,61,20,58,15,0,2,0,156,22.285714285714285,1,0.0,30,20,52,15,31,0,6,2,0,117,39,0
3245,88559,dpAgQLtjPDPymVmdyZFVsWQut5sougN0,7GRhBDsirIGkRZBtSMEzNTyDr2JQm4xx,11,3,2,0,2,4,6,1,18,2.5714285714285716,1,0.0,0,2,0,2,3,4,0,6,1,4,14,1
3246,88609,NRGKxfD21idsk82Fv2MwrybcNTOKr52A,7GRhBDsirIGkRZBtSMEzNTyDr2JQm4xx,1,0,0,0,0,0,1,0,1,0.14285714285714285,1,0.0,0,0,0,0,0,0,0,1,0,0,1,1
3247,88671,uUGE7QSg22XWq63RpYifnvGl7ha2AJY9,7GRhBDsirIGkRZBtSMEzNTyDr2JQm4xx,1,0,0,0,0,0,1,0,1,0.14285714285714285,1,0.0,0,0,0,0,0,0,0,1,0,0,1,1
3248,88682,IPGiOAgTo8oAVcrOKeYCONet5W5qWWCW,7GRhBDsirIGkRZBtSMEzNTyDr2JQm4xx,2,0,0,0,0,0,2,0,2,0.2857142857142857,1,0.0,0,0,0,0,0,0,0,2,0,0,2,1
3249,88683,YPNKBmbK0WLMDD2GyDPdurqVlRMJYUzc,7GRhBDsirIGkRZBtSMEzNTyDr2JQm4xx,3,0,0,0,0,0,3,0,3,0.42857142857142855,1,0.0,0,0,0,0,0,0,0,3,0,0,3,1
3250,88691,OanZ4liHLS9Z9zOLSdbk7KQJbN4gOKSZ,7GRhBDsirIGkRZBtSMEzNTyDr2JQm4xx,1,0,0,0,0,0,1,0,1,0.14285714285714285,1,0.0,0,0,0,0,0,0,0,1,0,0,1,1
3251,88856,hluzPB1y7zkKLSSzVkJvXfWNLyDAuRho,fbPkOYLVPtPgIt0MxizjfFJov3JbHyAi,9,7,5,0,3,0,2,0,17,2.4285714285714284,1,0.0,0,5,0,3,7,0,0,2,0,8,9,1
3252,89217,PA2zIjexrl5X42bUhfLaCsans4YmH5zQ,SpATywNh6bZuzm8s1ceuBUnMUAeoAHHw,3,2,1,0,0,0,1,0,4,0.5714285714285714,1,0.0,0,1,0,0,2,0,0,1,0,1,3,1
3253,89431,nYSFDE8RCbcZhD46fRSvPHUvA1ahfupi,RXDvfPUBYFlVdlueBFbLW0mhhAyGEqpt,12,11,1,0,1,2,2,0,17,2.4285714285714284,1,0.0,0,1,0,1,11,2,0,2,0,2,15,1
3254,89504,g8m22R7W0Wo8v9RXY0TMbj5qf5RFgvht,SpATywNh6bZuzm8s1ceuBUnMUAeoAHHw,3,2,1,0,0,0,2,0,5,0.7142857142857143,1,0.0,0,1,0,0,2,0,0,2,0,1,4,1
3255,89528,UUMX1CmSolRdRWNSlMStbZ6MtOKuPj1e,bWdj2GDclj5ofokWjzoa5jAwMkxCykd6,3,2,0,0,0,0,1,0,3,0.42857142857142855,1,0.0,0,0,0,0,2,0,0,1,0,0,3,0
3256,89547,yiyWtvIUUgzCTrQ1w4vh6W1sUUxvDdmd,G8EPVSXsOYB5YQWZGiz1aVq5Pgr2GrQu,9,11,3,0,3,0,2,0,19,2.7142857142857144,1,0.0,2,3,0,3,9,0,0,2,0,8,11,1
3257,89582,IVRKzAf1gWN5ButpaPiczzsxf6iD5MK8,SpATywNh6bZuzm8s1ceuBUnMUAeoAHHw,19,20,9,6,4,1,8,0,48,6.857142857142857,1,0.0,9,9,6,4,11,1,0,8,0,28,20,0
3258,89637,9FULiZu6qUnuIs2MyDSoVO8NHl3dw8Ao,SpATywNh6bZuzm8s1ceuBUnMUAeoAHHw,4,4,3,0,0,0,1,0,8,1.1428571428571428,1,0.0,0,3,0,0,4,0,0,1,0,3,5,1
3259,89652,g8m22R7W0Wo8v9RXY0TMbj5qf5RFgvht,G8EPVSXsOYB5YQWZGiz1aVq5Pgr2GrQu,3,2,1,0,0,0,2,0,5,0.7142857142857143,1,0.0,0,1,0,0,2,0,0,2,0,1,4,1
3260,89657,d1q0By7DZyiPLgwuG8hyGXtu0NW1hfAc,SpATywNh6bZuzm8s1ceuBUnMUAeoAHHw,6,4,1,0,1,0,1,0,7,1.0,1,0.0,0,1,0,1,4,0,0,1,0,2,5,1
3261,89669,tmmvczbZLiPw6t5Ru9DTWRYnvMI3hKxN,G8EPVSXsOYB5YQWZGiz1aVq5Pgr2GrQu,4,2,1,0,0,0,2,0,5,0.7142857142857143,1,0.0,0,1,0,0,2,0,0,2,0,1,4,1
3262,89718,gJUEUQ7J006sORAArhI6J8FkT7xUEHkB,SpATywNh6bZuzm8s1ceuBUnMUAeoAHHw,18,19,13,16,4,1,4,0,57,8.142857142857142,2,0.0,2,13,14,4,17,1,2,4,0,33,24,1
3263,89764,Ur5YqRaNsaD6KYfRfGA2p4Zmd8kpRITc,SpATywNh6bZuzm8s1ceuBUnMUAeoAHHw,14,13,8,6,3,4,4,0,38,5.428571428571429,2,0.0,2,8,6,3,11,4,0,4,0,19,19,0
3264,89899,uI2C8kZvxXShkoacauA0S9izMW2oRB2R,RXDvfPUBYFlVdlueBFbLW0mhhAyGEqpt,26,26,14,60,7,5,2,0,114,16.285714285714285,2,0.0,7,14,54,7,19,5,6,2,0,82,32,1
3265,89971,DpB3NoJLarAGiHUaBV6zvSP8bR0qw4yk,RXDvfPUBYFlVdlueBFbLW0mhhAyGEqpt,19,14,13,0,10,0,1,0,38,5.428571428571429,2,0.0,0,13,0,10,14,0,0,1,0,23,15,1
3266,89994,zvOHbaUWjxRZ9zCYxYPMcUH4Ef5dE8Ae,G8EPVSXsOYB5YQWZGiz1aVq5Pgr2GrQu,7,4,1,0,1,0,7,0,13,1.8571428571428572,2,0.0,0,1,0,1,4,0,0,7,0,2,11,1
3267,90041,JaLvdj0QPGLA6QlwJ3N2oF66NiYZ7XSV,bWdj2GDclj5ofokWjzoa5jAwMkxCykd6,24,19,11,58,3,18,4,0,113,16.142857142857142,1,0.0,2,11,47,3,17,18,11,4,0,63,50,0
3268,90183,SYRx2sSX9LDLLUNNibf5r7JJQePy5BRh,G8EPVSXsOYB5YQWZGiz1aVq5Pgr2GrQu,6,6,1,2,0,0,1,0,10,1.4285714285714286,1,0.0,2,1,1,0,4,0,1,1,0,4,6,1
3269,90249,RDTdhSHGbxVSFCWLWYH4XRafyz4IOkLm,SpATywNh6bZuzm8s1ceuBUnMUAeoAHHw,4,4,1,0,0,0,1,0,6,0.8571428571428571,1,0.0,0,1,0,0,4,0,0,1,0,1,5,1
3270,90253,5a7fehAo0Ol3kwHzhNqAYRGEzPLIE5FD,bWdj2GDclj5ofokWjzoa5jAwMkxCykd6,1,0,0,0,0,0,1,0,1,0.14285714285714285,1,0.0,0,0,0,0,0,0,0,1,0,0,1,1
3271,90266,n0HFF3TwqKuBMzzkdLCbvb8Mji5ZUnVX,SpATywNh6bZuzm8s1ceuBUnMUAeoAHHw,5,3,2,0,1,0,1,0,7,1.0,1,0.0,0,2,0,1,3,0,0,1,0,3,4,1
3272,90278,bweLZE6WiefKMb8vrgzlIS50q4xPrbd3,G8EPVSXsOYB5YQWZGiz1aVq5Pgr2GrQu,2,0,1,0,1,0,0,0,2,0.2857142857142857,1,0.0,0,1,0,1,0,0,0,0,0,2,0,1
3273,90343,jl79Z6TfXd4YLzsAQwSCeo1eMaF6Ha8d,bWdj2GDclj5ofokWjzoa5jAwMkxCykd6,9,6,0,0,0,4,13,3,26,3.7142857142857144,1,0.0,0,0,0,0,6,4,0,13,3,0,26,1
3274,90482,LfSoKi26BKEYZHPv7eOdEODBvG4bpVnt,SpATywNh6bZuzm8s1ceuBUnMUAeoAHHw,7,5,3,0,1,0,3,0,12,1.7142857142857142,1,0.0,0,3,0,1,5,0,0,3,0,4,8,1
3275,90560,QqAAFsY8kslizUQKd5uhHbFKpFbb6EW2,SpATywNh6bZuzm8s1ceuBUnMUAeoAHHw,18,17,9,15,4,0,3,0,48,6.857142857142857,1,0.0,2,9,15,4,15,0,0,3,0,30,18,0
3276,90590,jAHcjIKPY9dlDu300CKSWdNxocPzZC4f,G8EPVSXsOYB5YQWZGiz1aVq5Pgr2GrQu,4,3,1,0,0,0,1,0,5,0.7142857142857143,1,0.0,0,1,0,0,3,0,0,1,0,1,4,1
3277,90643,LvpKAlZO7ziKr9qX3nIahz2mFKsUbwWI,SpATywNh6bZuzm8s1ceuBUnMUAeoAHHw,2,0,0,0,0,0,2,0,2,0.2857142857142857,1,0.0,0,0,0,0,0,0,0,2,0,0,2,1
3278,90674,bLDIg7orV5sh30oIBmQ342IswZTJ8Q5l,RXDvfPUBYFlVdlueBFbLW0mhhAyGEqpt,7,4,3,0,2,0,1,0,10,1.4285714285714286,1,0.0,0,3,0,2,4,0,0,1,0,5,5,1
3279,90678,wQn1gyWkMsHmRn6FRBCpTkRxPyoDtHcK,G8EPVSXsOYB5YQWZGiz1aVq5Pgr2GrQu,1,1,0,0,0,0,0,0,1,0.14285714285714285,1,0.0,0,0,0,0,1,0,0,0,0,0,1,1
3280,90746,ldckbcGV67YBoSN68pz7hDadzOTSpXE4,G8EPVSXsOYB5YQWZGiz1aVq5Pgr2GrQu,4,4,1,12,1,0,0,0,18,2.5714285714285716,1,0.0,3,1,11,1,1,0,1,0,0,16,2,1
3281,90789,bEGwB6bxwamH303rlcp1dTooqcWaF93C,SpATywNh6bZuzm8s1ceuBUnMUAeoAHHw,9,6,2,0,2,5,4,0,19,2.7142857142857144,2,0.0,0,2,0,2,6,5,0,4,0,4,15,0
3282,90855,KogrHROquIJLSXIZqzhYU9Hcb9zVebwT,SpATywNh6bZuzm8s1ceuBUnMUAeoAHHw,4,5,3,0,0,0,1,0,9,1.2857142857142858,1,0.0,0,3,0,0,5,0,0,1,0,3,6,1
3283,90887,GVUw4u2UhYktwQlrJTo9fWmDS2qzWpQC,SpATywNh6bZuzm8s1ceuBUnMUAeoAHHw,15,19,1,8,1,47,7,0,83,11.857142857142858,1,0.0,2,1,8,1,17,47,0,7,0,12,71,0
3284,90905,R3vdKqOlKdhOGFVIJPoEGMoTbxTcB9bc,SpATywNh6bZuzm8s1ceuBUnMUAeoAHHw,5,1,1,0,1,0,2,0,5,0.7142857142857143,1,0.0,0,1,0,1,1,0,0,2,0,2,3,1
3285,90991,MSVIULFa47b8oOycWVWVcPhuMCdDd5NZ,SpATywNh6bZuzm8s1ceuBUnMUAeoAHHw,15,12,0,10,0,1,4,1,28,4.0,1,0.0,3,0,9,0,9,1,1,4,1,12,16,1
3286,91008,UB0nPfUwWgaRThrVeKik4SwdfP63TRHx,SpATywNh6bZuzm8s1ceuBUnMUAeoAHHw,6,4,1,0,1,0,1,0,7,1.0,1,0.0,0,1,0,1,4,0,0,1,0,2,5,1
3287,91013,bqWpav7ocOhCfb3xc4QgAvBDK5g8BmiZ,bWdj2GDclj5ofokWjzoa5jAwMkxCykd6,10,7,6,0,2,0,1,0,16,2.2857142857142856,1,0.0,0,6,0,2,7,0,0,1,0,8,8,1
3288,91045,dB4WDfiw60nGNNAG9g9zNz1Z102rMluZ,SpATywNh6bZuzm8s1ceuBUnMUAeoAHHw,5,3,2,0,1,0,1,0,7,1.0,1,0.0,0,2,0,1,3,0,0,1,0,3,4,1
3289,91105,ZxvROepgS8uZpWYEjrhlsfyND4f2cw2o,SpATywNh6bZuzm8s1ceuBUnMUAeoAHHw,13,11,5,15,2,0,6,0,39,5.571428571428571,1,0.0,6,5,12,2,5,0,3,6,0,25,14,0
3290,91108,nJUQO0awidSkRki1FSo1rhLXdIxrzKfS,G8EPVSXsOYB5YQWZGiz1aVq5Pgr2GrQu,3,2,1,0,0,0,1,0,4,0.5714285714285714,1,0.0,0,1,0,0,2,0,0,1,0,1,3,0
3291,91162,ORT6fH4QpWfdVApgOFbiZIUgnndzWNam,SpATywNh6bZuzm8s1ceuBUnMUAeoAHHw,9,7,6,0,5,0,1,0,19,2.7142857142857144,1,0.0,0,6,0,5,7,0,0,1,0,11,8,0
3292,91178,ogkoDosyBhbZAvybtPbmcuc4tjatNf2P,G8EPVSXsOYB5YQWZGiz1aVq5Pgr2GrQu,6,4,3,6,0,0,1,0,14,2.0,1,0.0,0,3,5,0,4,0,1,1,0,8,6,1
3293,91204,JwpnWAbXqqokshNbyxBH2QHaOUPb8wrj,G8EPVSXsOYB5YQWZGiz1aVq5Pgr2GrQu,9,10,1,0,1,0,3,1,16,2.2857142857142856,1,0.0,0,1,0,1,10,0,0,3,1,2,14,0
3294,91328,OZaq72DmJH6bReA6lKvO4XbWYjmwsu42,bWdj2GDclj5ofokWjzoa5jAwMkxCykd6,8,11,4,34,1,0,3,0,53,7.571428571428571,1,0.0,2,4,32,1,9,0,2,3,0,39,14,1
3295,91360,Y7IgoRAqVJfNlsulCSI4HObujHPSzoLA,bWdj2GDclj5ofokWjzoa5jAwMkxCykd6,5,4,3,0,1,0,4,0,12,1.7142857142857142,2,0.0,0,3,0,1,4,0,0,4,0,4,8,1
3296,91448,IRULN38M25Cl78bawBWQTQjcpwpaaNDt,SpATywNh6bZuzm8s1ceuBUnMUAeoAHHw,11,18,0,15,0,0,2,0,35,5.0,1,0.0,6,0,13,0,12,0,2,2,0,19,16,1
3297,91479,7wwnUxCzQI2wyfpl5OyzTa3WTS3Ri45e,bWdj2GDclj5ofokWjzoa5jAwMkxCykd6,1,0,0,0,0,0,1,0,1,0.14285714285714285,1,0.0,0,0,0,0,0,0,0,1,0,0,1,1
3298,92997,83JPfkin3GX4GLKqML2uaHSZ5KvsuJhM,SpATywNh6bZuzm8s1ceuBUnMUAeoAHHw,3,2,0,0,0,0,1,0,3,0.42857142857142855,1,0.0,0,0,0,0,2,0,0,1,0,0,3,1
3299,93108,dBPTjHGtowbPnTOm514Emm9Jz5rIzrSj,SpATywNh6bZuzm8s1ceuBUnMUAeoAHHw,9,10,1,0,0,0,1,0,12,1.7142857142857142,1,0.0,0,1,0,0,10,0,0,1,0,1,11,1
3300,93210,O9DTMIbbKOPsa4B7k1STk0nNuSR3cdx2,SpATywNh6bZuzm8s1ceuBUnMUAeoAHHw,1,0,0,0,0,0,1,0,1,0.14285714285714285,1,0.0,0,0,0,0,0,0,0,1,0,0,1,1
3301,93338,J9IFZ6lJS0kAA8VxmLEtsSsATCVlFyib,G8EPVSXsOYB5YQWZGiz1aVq5Pgr2GrQu,2,0,0,0,0,0,2,0,2,0.2857142857142857,1,0.0,0,0,0,0,0,0,0,2,0,0,2,1
3302,93414,LiD14ALXLddUqpdQnujGFxQiBSoJOZGF,bWdj2GDclj5ofokWjzoa5jAwMkxCykd6,10,21,4,16,2,3,14,0,60,8.571428571428571,4,0.0,1,4,14,2,20,3,2,14,0,21,39,0
3303,93444,wfUVHBmDLe0V8vTm9YNAi5Eoe98kipNK,RXDvfPUBYFlVdlueBFbLW0mhhAyGEqpt,11,18,1,0,1,0,2,1,23,3.2857142857142856,1,0.0,2,1,0,1,16,0,0,2,1,4,19,1
3304,93463,KnjIylBxQGK5ybTZHRQCIOf6LVaiEDiE,SpATywNh6bZuzm8s1ceuBUnMUAeoAHHw,9,3,1,12,0,14,5,0,35,5.0,1,0.0,2,1,9,0,1,14,3,5,0,12,23,1
3305,93513,yuqYkP52C7pQOIQ48GEgTRDqcNtFSeb3,bWdj2GDclj5ofokWjzoa5jAwMkxCykd6,7,6,4,0,1,2,5,0,18,2.5714285714285716,1,0.0,0,4,0,1,6,2,0,5,0,5,13,1
3306,93517,1yALM9xjClF6jgXaABxhrYNC8eb8bQ9n,bWdj2GDclj5ofokWjzoa5jAwMkxCykd6,9,19,10,4,2,14,4,0,53,7.571428571428571,1,0.0,2,10,3,2,17,14,1,4,0,17,36,1
3307,93531,RHEMdhoy3TVz84IqO3CiO0ZVmx7sjl4N,A3fsA9Zfv1X2fVEQhTw51lKENdNrEqT3,4,2,1,0,0,0,2,0,5,0.7142857142857143,1,0.0,0,1,0,0,2,0,0,2,0,1,4,0
3308,93668,wmwDf7eIRrKPL0l8cNmMygnEPd5vzoqs,bWdj2GDclj5ofokWjzoa5jAwMkxCykd6,8,5,1,0,0,1,5,1,13,1.8571428571428572,1,0.0,0,1,0,0,5,1,0,5,1,1,12,1
3309,93728,GZzbpBGluNcEXFZ9BEQgqFPzH6qJC8rT,SpATywNh6bZuzm8s1ceuBUnMUAeoAHHw,6,4,1,0,1,0,1,0,7,1.0,1,0.0,0,1,0,1,4,0,0,1,0,2,5,1
3310,93744,ROmxIDt1Nv5jCVXIVh1nfk5f1b4KKNIR,bWdj2GDclj5ofokWjzoa5jAwMkxCykd6,1,0,0,0,0,0,1,0,1,0.14285714285714285,1,0.0,0,0,0,0,0,0,0,1,0,0,1,1
3311,93756,KO9zYaiac2CNagQLdx3aJ9c2fXXMgIJX,SpATywNh6bZuzm8s1ceuBUnMUAeoAHHw,4,3,0,0,0,0,1,0,4,0.5714285714285714,1,0.0,0,0,0,0,3,0,0,1,0,0,4,1
3312,93774,2AXxkCmyE7acjKrdHA94DKX4eMigeF9j,A3fsA9Zfv1X2fVEQhTw51lKENdNrEqT3,14,8,6,0,6,0,1,0,21,3.0,1,0.0,0,6,0,6,8,0,0,1,0,12,9,1
3313,93799,SvayS3hRjiQUsZJZ3Z80XuRW7pnvNCGH,SpATywNh6bZuzm8s1ceuBUnMUAeoAHHw,14,14,1,8,1,9,4,0,37,5.285714285714286,1,0.0,2,1,8,1,12,9,0,4,0,12,25,1
3314,93814,uHLnVmnvVGRf9UQIVsgUkoIvLInqWS41,RXDvfPUBYFlVdlueBFbLW0mhhAyGEqpt,7,12,6,0,2,3,6,0,29,4.142857142857143,1,0.0,0,6,0,2,12,3,0,6,0,8,21,1
3315,94124,XyD01HhzMuHzP5ArHNJFexoSZMamD6Wh,G8EPVSXsOYB5YQWZGiz1aVq5Pgr2GrQu,9,6,2,0,2,0,3,3,16,2.2857142857142856,1,0.0,2,2,0,2,4,0,0,3,3,6,10,1
3316,94128,sKWLe14EbvHw5vqAsPu64KkYjNDdUiTB,SpATywNh6bZuzm8s1ceuBUnMUAeoAHHw,6,4,0,0,0,0,2,0,6,0.8571428571428571,1,0.0,0,0,0,0,4,0,0,2,0,0,6,0
3317,94286,M8C9BDFICk4ida59GU0jjp556zazDEi1,A3fsA9Zfv1X2fVEQhTw51lKENdNrEqT3,7,4,3,0,2,0,1,0,10,1.4285714285714286,1,0.0,0,3,0,2,4,0,0,1,0,5,5,1
3318,94294,M8C9BDFICk4ida59GU0jjp556zazDEi1,bWdj2GDclj5ofokWjzoa5jAwMkxCykd6,4,7,3,0,0,0,4,0,14,2.0,2,0.0,0,3,0,0,7,0,0,4,0,3,11,1
3319,94327,nm4sJLNdobmK6nfqGoX1goxharKsSyKv,RXDvfPUBYFlVdlueBFbLW0mhhAyGEqpt,2,0,1,0,1,0,0,0,2,0.2857142857142857,1,0.0,0,1,0,1,0,0,0,0,0,2,0,1
3320,94338,yk8HuNxXIum8r8XDIOHqnAVeWfg9tYo1,bWdj2GDclj5ofokWjzoa5jAwMkxCykd6,22,29,13,60,8,0,2,0,112,16.0,1,0.0,14,13,60,8,15,0,0,2,0,95,17,1
3321,94434,D7ijm86N7h5o3w1fsSkZ0iVyhHtcIbis,SpATywNh6bZuzm8s1ceuBUnMUAeoAHHw,19,37,9,40,2,11,5,1,105,15.0,1,0.0,26,9,34,2,11,11,6,5,1,71,34,0
3322,94892,nPRsjektHdbQkeAf1fIK4JbhrESPbPsA,fbPkOYLVPtPgIt0MxizjfFJov3JbHyAi,1,0,0,0,0,0,1,0,1,0.14285714285714285,1,0.0,0,0,0,0,0,0,0,1,0,0,1,1
3323,94908,Y0dtU5bUn0PrrnfgvOUCPfb1rktwn4CX,fbPkOYLVPtPgIt0MxizjfFJov3JbHyAi,5,3,2,0,1,0,1,0,7,1.0,1,0.0,0,2,0,1,3,0,0,1,0,3,4,1
3324,94949,6VGKONVpl1KgJ6EuaAzeKa8BNrxzEeZU,fbPkOYLVPtPgIt0MxizjfFJov3JbHyAi,5,6,0,0,0,0,1,0,7,1.0,1,0.0,0,0,0,0,6,0,0,1,0,0,7,1
3325,95304,sXXu4twesSnXXidsHxSOeMg5Xzk8xAsm,A3fsA9Zfv1X2fVEQhTw51lKENdNrEqT3,2,0,0,0,0,0,2,0,2,0.2857142857142857,1,0.0,0,0,0,0,0,0,0,2,0,0,2,0
3326,95315,U0aWEpE7Ns3m6FjrcttSNCCy6f34uaV4,SpATywNh6bZuzm8s1ceuBUnMUAeoAHHw,1,0,0,0,0,0,1,0,1,0.14285714285714285,1,0.0,0,0,0,0,0,0,0,1,0,0,1,1
3327,95323,Ge5fW9CsKdA0D6503NL20NzJpcoMVtar,SpATywNh6bZuzm8s1ceuBUnMUAeoAHHw,6,2,1,0,1,0,3,0,7,1.0,1,0.0,0,1,0,1,2,0,0,3,0,2,5,1
3328,95333,YybGVTqjY7vuqDLgHStfT8JBgnvTLDFS,bWdj2GDclj5ofokWjzoa5jAwMkxCykd6,6,2,1,0,1,0,3,0,7,1.0,1,0.0,0,1,0,1,2,0,0,3,0,2,5,1
3329,95336,QzVwezWUOBpl33EMiprsTWQNwkGzpYUZ,RXDvfPUBYFlVdlueBFbLW0mhhAyGEqpt,1,0,0,0,0,0,1,0,1,0.14285714285714285,1,0.0,0,0,0,0,0,0,0,1,0,0,1,0
3330,95343,WjGAvDgXPzKEfssMPXtQ1xVWZPI1hH6R,SpATywNh6bZuzm8s1ceuBUnMUAeoAHHw,3,2,0,0,0,0,1,0,3,0.42857142857142855,1,0.0,0,0,0,0,2,0,0,1,0,0,3,0
3331,95365,Ieqd5itEcYJJN0R1exEtlEqnGZPAbCE6,A3fsA9Zfv1X2fVEQhTw51lKENdNrEqT3,4,3,1,0,1,0,2,0,7,1.0,1,0.0,0,1,0,1,3,0,0,2,0,2,5,1
3332,95379,jl79Z6TfXd4YLzsAQwSCeo1eMaF6Ha8d,A3fsA9Zfv1X2fVEQhTw51lKENdNrEqT3,10,7,0,0,0,4,9,1,21,3.0,1,0.0,0,0,0,0,7,4,0,9,1,0,21,1
3333,95421,Bha7QMGmONKAqxvqVmMzYDzgn03rupB9,A3fsA9Zfv1X2fVEQhTw51lKENdNrEqT3,2,0,0,0,0,0,2,0,2,0.2857142857142857,1,0.0,0,0,0,0,0,0,0,2,0,0,2,1
3334,95443,Bha7QMGmONKAqxvqVmMzYDzgn03rupB9,bWdj2GDclj5ofokWjzoa5jAwMkxCykd6,4,2,1,0,0,0,3,0,6,0.8571428571428571,1,0.0,0,1,0,0,2,0,0,3,0,1,5,1
3335,95457,5yUqlUp9Xefz1r5QbYyqOcfkyddpZEv3,SpATywNh6bZuzm8s1ceuBUnMUAeoAHHw,19,22,6,12,5,0,5,0,50,7.142857142857143,1,0.0,9,6,10,5,13,0,2,5,0,30,20,1
3336,95460,yell4xFioKaQh1Eh8e1BHgTr9kNc23uL,G8EPVSXsOYB5YQWZGiz1aVq5Pgr2GrQu,2,0,0,0,0,0,2,0,2,0.2857142857142857,1,0.0,0,0,0,0,0,0,0,2,0,0,2,1
3337,95491,pO2KznyI9EIaBuWTbRmHrZfzq1y78Swj,A3fsA9Zfv1X2fVEQhTw51lKENdNrEqT3,10,6,4,0,4,0,3,0,17,2.4285714285714284,1,0.0,1,4,0,4,5,0,0,3,0,9,8,1
3338,95501,XgCNwD2cEVKtD4WAVaPORGAj8LHTJr5e,A3fsA9Zfv1X2fVEQhTw51lKENdNrEqT3,1,0,0,0,0,0,1,0,1,0.14285714285714285,1,0.0,0,0,0,0,0,0,0,1,0,0,1,1
3339,95518,GjBrMYHaMHg9XRlK0GO1kzoiYlxNFcC2,A3fsA9Zfv1X2fVEQhTw51lKENdNrEqT3,60,29,19,126,9,0,13,0,196,28.0,3,0.0,2,19,118,9,27,0,8,13,0,148,48,1
3340,95519,3TwYkv5KYm0nsRHdmcaiJpajLH9JQ0UG,A3fsA9Zfv1X2fVEQhTw51lKENdNrEqT3,3,0,0,0,0,0,5,0,5,0.7142857142857143,1,0.0,0,0,0,0,0,0,0,5,0,0,5,1
3341,95547,t3XemfoUPPfcRENYQvP2H3PO2tJX9CiG,SpATywNh6bZuzm8s1ceuBUnMUAeoAHHw,4,2,1,0,1,0,1,0,5,0.7142857142857143,1,0.0,0,1,0,1,2,0,0,1,0,2,3,1
3342,95560,oSEQ14Ll1d8ZBrsI9L5wTDmDWqMOqneK,A3fsA9Zfv1X2fVEQhTw51lKENdNrEqT3,14,7,6,0,6,1,7,1,28,4.0,1,0.0,0,6,0,6,7,1,0,7,1,12,16,1
3343,95566,WdzyWsqPss1ohcmLXQZkxthaNy8YyGzL,A3fsA9Zfv1X2fVEQhTw51lKENdNrEqT3,3,0,0,0,0,0,5,0,5,0.7142857142857143,1,0.0,0,0,0,0,0,0,0,5,0,0,5,1
3344,95567,BlS8PCoC6oTDUZj2Hj1GOesx0cnG3IDt,A3fsA9Zfv1X2fVEQhTw51lKENdNrEqT3,8,6,4,0,2,0,5,0,17,2.4285714285714284,1,0.0,0,4,0,2,6,0,0,5,0,6,11,1
3345,95570,nYSFDE8RCbcZhD46fRSvPHUvA1ahfupi,SpATywNh6bZuzm8s1ceuBUnMUAeoAHHw,8,9,1,0,1,4,5,0,20,2.857142857142857,1,0.0,0,1,0,1,9,4,0,5,0,2,18,1
3346,95579,8DrwDXKGEBLVwNt7dUNV7BIWxiG8AH1C,A3fsA9Zfv1X2fVEQhTw51lKENdNrEqT3,8,7,2,0,2,0,7,0,18,2.5714285714285716,1,0.0,0,2,0,2,7,0,0,7,0,4,14,1
3347,95584,vnJ8iXwVjPF96rPn5RIZQWSaOopjKseH,SpATywNh6bZuzm8s1ceuBUnMUAeoAHHw,28,33,14,40,8,0,11,0,106,15.142857142857142,1,0.0,8,14,34,8,25,0,6,11,0,64,42,1
3348,95604,nYSFDE8RCbcZhD46fRSvPHUvA1ahfupi,G8EPVSXsOYB5YQWZGiz1aVq5Pgr2GrQu,7,4,1,0,1,1,2,0,9,1.2857142857142858,1,0.0,0,1,0,1,4,1,0,2,0,2,7,1
3349,95610,nYSFDE8RCbcZhD46fRSvPHUvA1ahfupi,A3fsA9Zfv1X2fVEQhTw51lKENdNrEqT3,9,7,1,0,1,3,2,0,14,2.0,1,0.0,0,1,0,1,7,3,0,2,0,2,12,1
3350,95621,nH3NRDQLecB3hMbOpaitsdqKrlyEIXGh,SpATywNh6bZuzm8s1ceuBUnMUAeoAHHw,18,16,8,34,3,0,2,0,63,9.0,1,0.0,6,8,29,3,10,0,5,2,0,46,17,0
3351,95640,Y7qsqdZIsv6Hy0vu4LtgtbOKv08z7vaS,A3fsA9Zfv1X2fVEQhTw51lKENdNrEqT3,2,0,0,0,0,0,2,0,2,0.2857142857142857,1,0.0,0,0,0,0,0,0,0,2,0,0,2,1
3352,95647,kHWuc10C4T4imgPGXw1iL9DdxxMDyloj,A3fsA9Zfv1X2fVEQhTw51lKENdNrEqT3,2,0,0,0,0,0,3,0,3,0.42857142857142855,1,0.0,0,0,0,0,0,0,0,3,0,0,3,1
3353,95655,aFVIDdMfPLCaqut6kVxorTellYImwEAn,RXDvfPUBYFlVdlueBFbLW0mhhAyGEqpt,1,0,0,0,0,0,1,0,1,0.14285714285714285,1,0.0,0,0,0,0,0,0,0,1,0,0,1,1
3354,95692,PoMIsULf4fdpKNpab6c33l88EClRsCjy,A3fsA9Zfv1X2fVEQhTw51lKENdNrEqT3,14,7,6,0,5,0,2,0,20,2.857142857142857,1,0.0,0,6,0,5,7,0,0,2,0,11,9,0
3355,95693,lLO2IvxcSlYUuWvFwkacGc9eGibtMx0u,A3fsA9Zfv1X2fVEQhTw51lKENdNrEqT3,1,0,0,0,0,0,1,0,1,0.14285714285714285,1,0.0,0,0,0,0,0,0,0,1,0,0,1,1
3356,95713,XUeZabU3qZWCaiD6wFnhBaCufbfFTb2H,A3fsA9Zfv1X2fVEQhTw51lKENdNrEqT3,16,7,6,0,6,0,3,0,22,3.142857142857143,1,0.0,0,6,0,6,7,0,0,3,0,12,10,1
3357,95742,Y9G0Vd7vUaj0pt9EeQDbDOvFl3eVdYaR,RXDvfPUBYFlVdlueBFbLW0mhhAyGEqpt,1,0,0,0,0,0,1,0,1,0.14285714285714285,1,0.0,0,0,0,0,0,0,0,1,0,0,1,1
3358,95754,fXpjk0OrbkXxQzpvttVDelNPD6lPfJXA,SpATywNh6bZuzm8s1ceuBUnMUAeoAHHw,20,14,8,19,6,0,6,0,53,7.571428571428571,1,0.0,6,8,16,6,8,0,3,6,0,36,17,1
3359,95775,WuM67GwQW9M3d1mnuGHuvAdo907S9qb5,SpATywNh6bZuzm8s1ceuBUnMUAeoAHHw,1,0,0,0,0,0,1,0,1,0.14285714285714285,1,0.0,0,0,0,0,0,0,0,1,0,0,1,0
3360,95777,Yc8rNkAsH37cAbAebyiE6I2RsfVaxpIZ,A3fsA9Zfv1X2fVEQhTw51lKENdNrEqT3,7,3,2,0,2,0,2,0,9,1.2857142857142858,1,0.0,0,2,0,2,3,0,0,2,0,4,5,1
3361,95783,Xcq5CVanT8J8ISNJVeThaVoqYhMkjumr,SpATywNh6bZuzm8s1ceuBUnMUAeoAHHw,5,2,1,0,1,0,2,0,6,0.8571428571428571,1,0.0,0,1,0,1,2,0,0,2,0,2,4,1
3362,95790,aSlIMkfly6xTMJCGTWDQcnFZjajcWM6y,A3fsA9Zfv1X2fVEQhTw51lKENdNrEqT3,7,4,1,0,1,0,2,0,8,1.1428571428571428,1,0.0,0,1,0,1,4,0,0,2,0,2,6,1
3363,95796,AfmdKPTL0IbcupndNMlY5c7PImPraChY,SpATywNh6bZuzm8s1ceuBUnMUAeoAHHw,13,11,6,7,2,0,1,0,27,3.857142857142857,1,0.0,4,6,7,2,7,0,0,1,0,19,8,1
3364,95800,XhN7QGypor4DcMvMWEJ3oRIi5DeJwYDV,SpATywNh6bZuzm8s1ceuBUnMUAeoAHHw,14,20,1,15,1,2,3,0,42,6.0,2,0.0,10,1,14,1,10,2,1,3,0,26,16,1
3365,95805,jN3AJMUVBTsXIfTNwaMmorNzhVw7coVS,A3fsA9Zfv1X2fVEQhTw51lKENdNrEqT3,2,0,0,0,0,0,2,0,2,0.2857142857142857,1,0.0,0,0,0,0,0,0,0,2,0,0,2,1
3366,95817,1uEo4BzsZxlgHBFClnUu9nbvDrRmzn4T,SpATywNh6bZuzm8s1ceuBUnMUAeoAHHw,7,4,3,5,1,0,1,0,14,2.0,1,0.0,0,3,5,1,4,0,0,1,0,9,5,1
3367,95824,qHYMkh2G06Tgj4MMABvKGj1g29BRMeXu,SpATywNh6bZuzm8s1ceuBUnMUAeoAHHw,6,4,3,0,3,0,1,0,11,1.5714285714285714,1,0.0,0,3,0,3,4,0,0,1,0,6,5,1
3368,95827,1u5RJ3ohzI9I8TYHEG8zy2n2QjuVVCRw,SpATywNh6bZuzm8s1ceuBUnMUAeoAHHw,1,0,0,0,0,0,1,0,1,0.14285714285714285,1,0.0,0,0,0,0,0,0,0,1,0,0,1,1
3369,95834,86utfBtmFqtE8TLsj2h1BusfBdMTH1O8,SpATywNh6bZuzm8s1ceuBUnMUAeoAHHw,10,11,3,1,2,0,2,0,19,2.7142857142857144,2,0.0,2,3,1,2,9,0,0,2,0,8,11,1
3370,95841,AEeLy9n4nUl6UlG8WfSP7Q5sqAzFdtaD,A3fsA9Zfv1X2fVEQhTw51lKENdNrEqT3,7,9,7,0,6,0,1,0,23,3.2857142857142856,3,0.0,0,7,0,6,9,0,0,1,0,13,10,0
3371,95849,j3HNnX1GWjrCGNX5n4Ax13Vu5X6WNds7,SpATywNh6bZuzm8s1ceuBUnMUAeoAHHw,5,2,1,0,1,0,2,0,6,0.8571428571428571,1,0.0,0,1,0,1,2,0,0,2,0,2,4,1
3372,95866,wdK5DIKl9qd73hM1uOx3ufcKj0J9AcRr,A3fsA9Zfv1X2fVEQhTw51lKENdNrEqT3,9,6,5,0,4,0,1,0,16,2.2857142857142856,1,0.0,0,5,0,4,6,0,0,1,0,9,7,1
3373,95877,ofStwmRRBPN4Od7HYTx4tgAh724FKaML,RXDvfPUBYFlVdlueBFbLW0mhhAyGEqpt,8,4,0,0,0,4,4,1,13,1.8571428571428572,1,0.0,0,0,0,0,4,4,0,4,1,0,13,1
3374,95886,xsD2uaFheAaDTDHzSeAKROA0IH2KQICZ,SpATywNh6bZuzm8s1ceuBUnMUAeoAHHw,12,11,1,6,1,0,2,0,21,3.0,1,0.0,2,1,6,1,9,0,0,2,0,10,11,1
3375,95903,8Bi5fR0qSZjzFptY6NNbPZ6GLpteABmy,SpATywNh6bZuzm8s1ceuBUnMUAeoAHHw,4,2,0,0,0,0,3,0,5,0.7142857142857143,2,0.0,0,0,0,0,2,0,0,3,0,0,5,1
3376,95914,rTLMEQB78zn1g6bt6KRypanGZ8QWPbQv,A3fsA9Zfv1X2fVEQhTw51lKENdNrEqT3,42,51,13,88,11,22,10,0,195,27.857142857142858,4,0.0,6,13,69,11,45,22,19,10,0,99,96,0
3377,95924,yF9l9yvoXyIeGTDuNPcQeoWm8bOFk82H,A3fsA9Zfv1X2fVEQhTw51lKENdNrEqT3,1,0,0,0,0,0,1,0,1,0.14285714285714285,1,0.0,0,0,0,0,0,0,0,1,0,0,1,1
3378,95938,H8hXX8mRAbdpVvW9JxPUH4Vz1O6DjIDQ,SpATywNh6bZuzm8s1ceuBUnMUAeoAHHw,12,15,4,11,3,0,1,0,34,4.857142857142857,1,0.0,10,4,10,3,5,0,1,1,0,27,7,1
3379,95943,Gnvd8M3zeIOpApc28ArYy1li1qM7ZTwg,SpATywNh6bZuzm8s1ceuBUnMUAeoAHHw,15,26,0,18,0,1,10,2,57,8.142857142857142,2,0.0,6,0,15,0,20,1,3,10,2,21,36,1
3380,95946,VSxmvcFHrZIVtNnTaFw0qdfh1Zdl1LMy,SpATywNh6bZuzm8s1ceuBUnMUAeoAHHw,27,38,18,12,9,0,3,0,80,11.428571428571429,2,0.0,17,18,12,9,21,0,0,3,0,56,24,0
3381,95965,L22oksNNnEaRYr1idj7T9wNLQN39zTXs,SpATywNh6bZuzm8s1ceuBUnMUAeoAHHw,8,2,1,0,1,1,5,1,11,1.5714285714285714,1,0.0,0,1,0,1,2,1,0,5,1,2,9,1
3382,95979,kYCiC9sjJhVea0nSa72pTn7A2eOhjLmI,SpATywNh6bZuzm8s1ceuBUnMUAeoAHHw,1,0,0,0,0,0,1,0,1,0.14285714285714285,1,0.0,0,0,0,0,0,0,0,1,0,0,1,1
3383,95984,D9YS628mhjQ1I60HvdkUWN4SFDF5a33E,SpATywNh6bZuzm8s1ceuBUnMUAeoAHHw,7,2,0,0,0,1,5,1,9,1.2857142857142858,1,0.0,0,0,0,0,2,1,0,5,1,0,9,1
3384,95991,S144mYN036ngEoT5NOZhFV5f1CGtYvQl,SpATywNh6bZuzm8s1ceuBUnMUAeoAHHw,7,2,0,0,0,1,7,1,11,1.5714285714285714,1,0.0,0,0,0,0,2,1,0,7,1,0,11,1
3385,96002,Hxd16O3nQG6ddXQCBbAu8BGBmmZmiixl,bWdj2GDclj5ofokWjzoa5jAwMkxCykd6,1,0,0,0,0,0,1,0,1,0.14285714285714285,1,0.0,0,0,0,0,0,0,0,1,0,0,1,1
3386,96009,GpLd8OePUlzkVkOH6kyAjUXsolCeEYNN,RXDvfPUBYFlVdlueBFbLW0mhhAyGEqpt,7,3,1,0,1,0,3,0,8,1.1428571428571428,1,0.0,0,1,0,1,3,0,0,3,0,2,6,1
3387,96015,5AnpX5rZgeZiqdXpEpBXchayqHICSQR2,SpATywNh6bZuzm8s1ceuBUnMUAeoAHHw,9,6,4,0,2,0,2,0,14,2.0,1,0.0,1,4,0,2,5,0,0,2,0,7,7,1
3388,96018,HPasLgueYgbdk1es5obBHn6eCO700ZnM,G8EPVSXsOYB5YQWZGiz1aVq5Pgr2GrQu,5,2,1,0,1,0,3,0,7,1.0,1,0.0,0,1,0,1,2,0,0,3,0,2,5,1
3389,96021,ix15aF6FOEF1waZCSZt01VrPOuPGJ3yM,SpATywNh6bZuzm8s1ceuBUnMUAeoAHHw,11,15,0,6,0,0,2,0,23,3.2857142857142856,2,0.0,8,0,6,0,7,0,0,2,0,14,9,0
3390,96028,3tDepbYkazgiOrBsQmbtJa1H3rNZc54O,SpATywNh6bZuzm8s1ceuBUnMUAeoAHHw,9,5,1,0,1,0,7,2,16,2.2857142857142856,2,0.0,0,1,0,1,5,0,0,7,2,2,14,0
3391,96037,zwqhxdboQszkcKvPN5pyN1nGDFR4ub3y,bWdj2GDclj5ofokWjzoa5jAwMkxCykd6,7,8,1,6,4,0,3,0,22,3.142857142857143,2,0.0,6,1,6,4,2,0,0,3,0,17,5,1
3392,96038,NGxVJQppNBMfgJiFwD3Ox6xl5bHm79ig,A3fsA9Zfv1X2fVEQhTw51lKENdNrEqT3,7,5,4,0,1,0,2,0,12,1.7142857142857142,1,0.0,0,4,0,1,5,0,0,2,0,5,7,1
3393,96051,nl7CfVETct3efRgniW8qXKplgQDLZElB,bWdj2GDclj5ofokWjzoa5jAwMkxCykd6,2,0,0,0,0,0,3,0,3,0.42857142857142855,1,0.0,0,0,0,0,0,0,0,3,0,0,3,1
3394,96060,1FiRW6JL0h34vWqoZjG8ei2zujPF23NL,A3fsA9Zfv1X2fVEQhTw51lKENdNrEqT3,44,15,7,78,2,1,8,1,112,16.0,2,0.0,4,7,75,2,11,1,3,8,1,88,24,1
3395,96063,McYATdhZDDMDpni6a4GbjI06ustMpvdV,bWdj2GDclj5ofokWjzoa5jAwMkxCykd6,1,0,0,0,0,0,2,0,2,0.2857142857142857,2,0.0,0,0,0,0,0,0,0,2,0,0,2,1
3396,96074,MiDD69NvLCtsK6jzM5U32WgBFDv8XbVJ,A3fsA9Zfv1X2fVEQhTw51lKENdNrEqT3,11,7,2,0,2,0,11,1,23,3.2857142857142856,1,0.0,0,2,0,2,7,0,0,11,1,4,19,0
3397,96080,nBih09u5WtqrKAXZJuGGTQZ4MinMYlfW,SpATywNh6bZuzm8s1ceuBUnMUAeoAHHw,5,2,0,0,0,0,7,0,9,1.2857142857142858,1,0.0,0,0,0,0,2,0,0,7,0,0,9,1
3398,96094,ps5VcFUapZM31sy4VNJWOTFBzN98932v,SpATywNh6bZuzm8s1ceuBUnMUAeoAHHw,1,0,0,0,0,0,1,0,1,0.14285714285714285,1,0.0,0,0,0,0,0,0,0,1,0,0,1,1
3399,96102,VLNGwZ1eoTZ1MrW64VolhWSmnDD0C1Ov,A3fsA9Zfv1X2fVEQhTw51lKENdNrEqT3,3,0,0,0,0,2,2,0,4,0.5714285714285714,1,0.0,0,0,0,0,0,2,0,2,0,0,4,1
3400,96105,IhdK4MEktWiSl0ozGtXiJFeE1awPcboi,SpATywNh6bZuzm8s1ceuBUnMUAeoAHHw,29,37,19,37,8,3,8,0,112,16.0,2,0.0,6,19,32,8,31,3,5,8,0,65,47,1
3401,96109,gnTcbZ4BOuQk0BfuzZDpGiEEYJSGOrYu,SpATywNh6bZuzm8s1ceuBUnMUAeoAHHw,16,13,8,14,5,0,1,0,41,5.857142857142857,1,0.0,2,8,13,5,11,0,1,1,0,28,13,1
3402,96112,o3REKVT5jtm2Ed8QHiz1c3PlSbYTElLg,SpATywNh6bZuzm8s1ceuBUnMUAeoAHHw,3,0,0,0,0,0,3,0,3,0.42857142857142855,1,0.0,0,0,0,0,0,0,0,3,0,0,3,1
3403,96113,o3REKVT5jtm2Ed8QHiz1c3PlSbYTElLg,G8EPVSXsOYB5YQWZGiz1aVq5Pgr2GrQu,2,0,0,0,0,0,2,0,2,0.2857142857142857,1,0.0,0,0,0,0,0,0,0,2,0,0,2,1
3404,96114,XYKEbaRABcMuBHmMB2I3YkBepzCp0swB,A3fsA9Zfv1X2fVEQhTw51lKENdNrEqT3,25,12,1,72,0,0,3,0,88,12.571428571428571,2,0.0,3,1,58,0,9,0,14,3,0,62,26,1
3405,96121,gnTcbZ4BOuQk0BfuzZDpGiEEYJSGOrYu,A3fsA9Zfv1X2fVEQhTw51lKENdNrEqT3,6,3,2,0,2,0,2,0,9,1.2857142857142858,1,0.0,0,2,0,2,3,0,0,2,0,4,5,1
3406,96126,8n73BBd3mvRJq2a0KZ4WJWTYj65s8f61,bWdj2GDclj5ofokWjzoa5jAwMkxCykd6,1,0,0,0,0,0,1,0,1,0.14285714285714285,1,0.0,0,0,0,0,0,0,0,1,0,0,1,1
3407,96133,gMMqUNqa2ZYLkCBhPE0t3hx9nA1CQadH,SpATywNh6bZuzm8s1ceuBUnMUAeoAHHw,19,39,24,12,15,0,8,0,98,14.0,4,0.0,10,24,12,15,29,0,0,8,0,61,37,0
3408,96140,QTgmoEmFx7yveY8D3dDCUQU4BnndurNn,RXDvfPUBYFlVdlueBFbLW0mhhAyGEqpt,63,87,36,80,18,11,12,1,245,35.0,5,0.0,15,36,78,18,72,11,2,12,1,147,98,0
3409,96698,kfq7KT5bB5EYh8pOfijeZyMqCV9XlzvB,RXDvfPUBYFlVdlueBFbLW0mhhAyGEqpt,13,9,7,0,2,7,4,1,30,4.285714285714286,1,0.0,0,7,0,2,9,7,0,4,1,9,21,0
3410,96805,l5LcQXaXypTaa8UtbYyDr1XartlmUM1X,A3fsA9Zfv1X2fVEQhTw51lKENdNrEqT3,3,0,0,0,0,0,5,0,5,0.7142857142857143,1,0.0,0,0,0,0,0,0,0,5,0,0,5,1
3411,96818,ULdF32fTmMpV957Ngz6P80D0kuxYFb2A,SpATywNh6bZuzm8s1ceuBUnMUAeoAHHw,19,9,7,10,4,0,10,2,42,6.0,2,0.0,2,7,9,4,7,0,1,10,2,22,20,0
3412,97117,c8WJAdYLV71mOx4ZXSglpCNd0dBUR3Om,7GRhBDsirIGkRZBtSMEzNTyDr2JQm4xx,3,2,1,0,0,0,1,0,4,0.5714285714285714,1,0.0,0,1,0,0,2,0,0,1,0,1,3,0
3413,97214,9HiOT9GgvrP1q1oAqpQLpBir7zKJrsoX,A3fsA9Zfv1X2fVEQhTw51lKENdNrEqT3,25,26,13,0,9,0,5,0,53,7.571428571428571,1,0.0,0,13,0,9,26,0,0,5,0,22,31,0
3414,97503,kuZwBvEdgeUtKZ495C2FptBbxEtLtmVH,A3fsA9Zfv1X2fVEQhTw51lKENdNrEqT3,15,24,13,18,10,0,4,0,69,9.857142857142858,3,0.0,0,13,14,10,24,0,4,4,0,37,32,0
3415,99118,8P2tXYi4EZDZkbdP0MJKzxjbxyxdg79S,bWdj2GDclj5ofokWjzoa5jAwMkxCykd6,3,2,0,0,0,0,2,0,4,0.5714285714285714,1,0.0,0,0,0,0,2,0,0,2,0,0,4,1
3416,99357,dA2znH7Ys1BZ6Ag1jC6siF2XLsfXuatY,G8EPVSXsOYB5YQWZGiz1aVq5Pgr2GrQu,9,12,4,0,4,0,2,0,22,3.142857142857143,1,0.0,0,4,0,4,12,0,0,2,0,8,14,1
3417,99367,7j1Qy60pQmlvQ7Dqk2iUN3aMOz565Svk,SpATywNh6bZuzm8s1ceuBUnMUAeoAHHw,4,2,1,0,0,0,2,0,5,0.7142857142857143,1,0.0,0,1,0,0,2,0,0,2,0,1,4,1
3418,99419,CIojvdkZCguBWuN7246vWmUJ6qBNp7JQ,RXDvfPUBYFlVdlueBFbLW0mhhAyGEqpt,21,16,9,19,4,5,4,1,58,8.285714285714286,1,0.0,5,9,18,4,11,5,1,4,1,36,22,1
3419,99460,x0kuyWECJARUGYUkf8OBmp3NS07aeieW,SpATywNh6bZuzm8s1ceuBUnMUAeoAHHw,15,23,1,24,0,0,3,0,51,7.285714285714286,1,0.0,13,1,20,0,10,0,4,3,0,34,17,1
3420,99499,nazeZS8BdRMOGGuVriyb5M21Pn5Qng36,RXDvfPUBYFlVdlueBFbLW0mhhAyGEqpt,2,0,0,0,0,0,3,0,3,0.42857142857142855,1,0.0,0,0,0,0,0,0,0,3,0,0,3,1
3421,99519,qsSi1uSJyI5PyAmcKOuOd3i9fMbo7Kcq,SpATywNh6bZuzm8s1ceuBUnMUAeoAHHw,15,21,3,0,3,3,6,0,36,5.142857142857143,1,0.0,0,3,0,3,21,3,0,6,0,6,30,1
3422,99639,HdhmGphCRXsQFbeFhgLmEJAXmcjxk1qH,G8EPVSXsOYB5YQWZGiz1aVq5Pgr2GrQu,1,0,0,0,0,0,1,0,1,0.14285714285714285,1,0.0,0,0,0,0,0,0,0,1,0,0,1,1
3423,99747,SH3THvT9ATqMny80GD63EuK5GGnf8XMU,bWdj2GDclj5ofokWjzoa5jAwMkxCykd6,3,3,0,0,0,0,1,0,4,0.5714285714285714,1,0.0,0,0,0,0,3,0,0,1,0,0,4,1
3424,99990,BY7rZbvKNAuIQddu3IMUH8CKbKBlCl4t,SpATywNh6bZuzm8s1ceuBUnMUAeoAHHw,5,4,1,0,0,0,4,1,10,1.4285714285714286,1,0.0,0,1,0,0,4,0,0,4,1,1,9,0
3425,100132,zhtf7EZUjW6s3Guz5lXD8KDXJ4lw9cuB,SpATywNh6bZuzm8s1ceuBUnMUAeoAHHw,15,11,9,4,5,0,4,0,33,4.714285714285714,1,0.0,0,9,4,5,11,0,0,4,0,18,15,0
3426,100383,CgW6eb6Uo35foWi9RCL2029DF7zH5e88,SpATywNh6bZuzm8s1ceuBUnMUAeoAHHw,7,2,1,0,1,1,5,1,11,1.5714285714285714,1,0.0,0,1,0,1,2,1,0,5,1,2,9,1
3427,100408,MlHPKmdi90dDdvX24jYoFlYEp8xS4RGn,RXDvfPUBYFlVdlueBFbLW0mhhAyGEqpt,3,2,0,0,0,0,1,0,3,0.42857142857142855,1,0.0,0,0,0,0,2,0,0,1,0,0,3,0
3428,100450,lU8LXbJuGJewdk0jE0yxpPj20hcwCqO8,A3fsA9Zfv1X2fVEQhTw51lKENdNrEqT3,23,4,2,62,0,0,3,0,71,10.142857142857142,1,0.0,1,2,56,0,3,0,6,3,0,59,12,0
3429,100554,8msriFvaCCtQyOBjAsLjk1IXyxsB0lzq,RXDvfPUBYFlVdlueBFbLW0mhhAyGEqpt,1,0,1,0,0,0,0,0,1,0.14285714285714285,1,0.0,0,1,0,0,0,0,0,0,0,1,0,1
3430,100614,qeHXe8DRkB9urr63HS1yAMwTxQkwIbff,RXDvfPUBYFlVdlueBFbLW0mhhAyGEqpt,4,3,0,0,0,0,1,0,4,0.5714285714285714,1,0.0,0,0,0,0,3,0,0,1,0,0,4,1
3431,100661,3C8bDgUvFDILMw4UNlmk2n4yo5NHVGtC,SpATywNh6bZuzm8s1ceuBUnMUAeoAHHw,3,2,0,0,0,0,1,0,3,0.42857142857142855,1,0.0,0,0,0,0,2,0,0,1,0,0,3,1
3432,100779,Qi3PLuC7w2Yo9hFgq37MObjY8icnRdc6,bWdj2GDclj5ofokWjzoa5jAwMkxCykd6,25,22,10,61,19,18,7,1,138,19.714285714285715,2,0.0,3,10,51,19,19,18,10,7,1,83,55,1
3433,100817,jSNLRK8jxSbbcqhbWW7DXZqoGlvGgXDY,G8EPVSXsOYB5YQWZGiz1aVq5Pgr2GrQu,1,0,0,0,0,0,1,0,1,0.14285714285714285,1,0.0,0,0,0,0,0,0,0,1,0,0,1,1
3434,100862,G6iele4ho79nU5jQ1J8umZLq8jEFa9yN,bWdj2GDclj5ofokWjzoa5jAwMkxCykd6,3,2,1,0,0,12,2,0,17,2.4285714285714284,1,0.0,0,1,0,0,2,12,0,2,0,1,16,1
3435,100990,CnuwKGLCLbXYnPgy82VEWYA1NOiOhvr0,SpATywNh6bZuzm8s1ceuBUnMUAeoAHHw,12,12,0,10,0,0,1,0,23,3.2857142857142856,1,0.0,2,0,8,0,10,0,2,1,0,10,13,0
3436,101152,7B5rcRMuJ6A1xAdnnIVDusvPjMkwnC77,bWdj2GDclj5ofokWjzoa5jAwMkxCykd6,11,12,1,18,0,0,4,0,35,5.0,2,0.0,2,1,16,0,10,0,2,4,0,19,16,1
3437,102975,DvNxKU9g5rp8dv94zJRF8Ah76URW61cr,SpATywNh6bZuzm8s1ceuBUnMUAeoAHHw,9,4,3,0,3,0,2,0,12,1.7142857142857142,1,0.0,0,3,0,3,4,0,0,2,0,6,6,1
3438,103157,8IuzZOXaXVUql9pLZtNuJIyLoDJ8ZL4V,A3fsA9Zfv1X2fVEQhTw51lKENdNrEqT3,20,17,7,50,2,0,2,0,78,11.142857142857142,1,0.0,2,7,43,2,15,0,7,2,0,54,24,1
3439,103347,hNJz0qbOhrUgajUkzqSdDbybHkuRglfs,SpATywNh6bZuzm8s1ceuBUnMUAeoAHHw,17,12,8,15,4,0,2,0,41,5.857142857142857,2,0.0,2,8,13,4,10,0,2,2,0,27,14,0
3440,103457,XvNNzv39b8VqKid0q4fV9ms2wVNAdWks,bWdj2GDclj5ofokWjzoa5jAwMkxCykd6,18,44,16,84,4,0,17,0,165,23.571428571428573,3,0.0,12,16,81,4,32,0,3,17,0,113,52,0
3441,103661,Z5Gd8RjsJSljoHUoBd3hvIVNy4VKuGq0,SpATywNh6bZuzm8s1ceuBUnMUAeoAHHw,12,12,5,10,1,20,2,0,50,7.142857142857143,1,0.0,4,5,9,1,8,20,1,2,0,19,31,0
3442,103668,p9NcQP74LARrulF6JzGeab5yk6ciJM9V,SpATywNh6bZuzm8s1ceuBUnMUAeoAHHw,12,25,1,10,1,1,2,0,40,5.714285714285714,1,0.0,6,1,10,1,19,1,0,2,0,18,22,0
3443,103930,Txv4UTCXPzwxfIDD6g3LwRLt3kYLBXuk,SpATywNh6bZuzm8s1ceuBUnMUAeoAHHw,14,18,9,10,2,0,6,0,45,6.428571428571429,3,0.0,3,9,9,2,15,0,1,6,0,23,22,0
3444,104296,qIvK9ObB3zgAcjyEoNQW2L93AtBba9D4,G8EPVSXsOYB5YQWZGiz1aVq5Pgr2GrQu,7,5,0,0,0,0,4,0,9,1.2857142857142858,1,0.0,0,0,0,0,5,0,0,4,0,0,9,0
3445,104301,Vy093XdUJPwNTmCPocZUTd1XYGzzyp34,G8EPVSXsOYB5YQWZGiz1aVq5Pgr2GrQu,2,0,0,0,0,0,2,0,2,0.2857142857142857,1,0.0,0,0,0,0,0,0,0,2,0,0,2,1
3446,104335,PcrKUgtxZcGXBYkLOmECh99m3fhAOabf,G8EPVSXsOYB5YQWZGiz1aVq5Pgr2GrQu,3,2,0,0,0,0,1,0,3,0.42857142857142855,1,0.0,0,0,0,0,2,0,0,1,0,0,3,1
3447,104361,xnObPmivHmj7phvTSVLNuvvFk898J2aO,RXDvfPUBYFlVdlueBFbLW0mhhAyGEqpt,1,0,0,0,0,0,1,0,1,0.14285714285714285,1,0.0,0,0,0,0,0,0,0,1,0,0,1,1
3448,104391,jTauqnokjVi6ospRFXXduew42x2G5Up9,G8EPVSXsOYB5YQWZGiz1aVq5Pgr2GrQu,7,3,2,0,2,0,2,0,9,1.2857142857142858,1,0.0,0,2,0,2,3,0,0,2,0,4,5,1
3449,104458,I3Y9SshT4Px6bPwzvv7ixI5CQirBePZQ,SpATywNh6bZuzm8s1ceuBUnMUAeoAHHw,4,3,2,0,0,0,1,0,6,0.8571428571428571,1,0.0,0,2,0,0,3,0,0,1,0,2,4,1
3450,104464,4OFy9ZLb1svxpVgXkgI60wOGeiU4V4oA,G8EPVSXsOYB5YQWZGiz1aVq5Pgr2GrQu,1,0,0,0,0,0,1,0,1,0.14285714285714285,1,0.0,0,0,0,0,0,0,0,1,0,0,1,1
3451,104489,wT2PCRFj23I7HDSSujNYjrYVx91GnsP3,A3fsA9Zfv1X2fVEQhTw51lKENdNrEqT3,4,2,1,0,1,0,3,0,7,1.0,2,0.0,0,1,0,1,2,0,0,3,0,2,5,0
3452,104540,WELjmgdsP962Pc1teJ96xvofKraKe6qa,bWdj2GDclj5ofokWjzoa5jAwMkxCykd6,4,3,2,0,0,7,4,0,16,2.2857142857142856,2,0.0,0,2,0,0,3,7,0,4,0,2,14,0
3453,104582,xM1yUWSpt3htcKGdTrpZVO5ZeftoW9re,G8EPVSXsOYB5YQWZGiz1aVq5Pgr2GrQu,10,6,2,8,1,0,5,0,22,3.142857142857143,1,0.0,3,2,6,1,3,0,2,5,0,12,10,1
3454,104590,hlub8IQ6xr3M5qQPn6YnEFWROpuhMcwL,A3fsA9Zfv1X2fVEQhTw51lKENdNrEqT3,1,0,0,0,0,0,1,0,1,0.14285714285714285,1,0.0,0,0,0,0,0,0,0,1,0,0,1,1
3455,104606,n0z9CmHQ1aT2Na1Alnc3POrgJ8DExUjg,G8EPVSXsOYB5YQWZGiz1aVq5Pgr2GrQu,8,12,3,0,3,1,4,0,23,3.2857142857142856,1,0.0,5,3,0,3,7,1,0,4,0,11,12,1
3456,104610,3C1lYSFixKkKNR8DGEXYYhDOAMAek2Zr,G8EPVSXsOYB5YQWZGiz1aVq5Pgr2GrQu,12,10,4,6,4,0,2,0,26,3.7142857142857144,1,0.0,5,4,3,4,5,0,3,2,0,16,10,1
3457,104613,Ek3NRIw6r3qK8qXdjTcUWOMSezARAlja,bWdj2GDclj5ofokWjzoa5jAwMkxCykd6,8,18,7,0,4,2,10,2,43,6.142857142857143,2,0.0,4,7,0,4,14,2,0,10,2,15,28,1
3458,104630,CtmqfatIKebJswM6ar9T0zVFJv52NCRl,G8EPVSXsOYB5YQWZGiz1aVq5Pgr2GrQu,7,11,0,0,0,0,5,0,16,2.2857142857142856,1,0.0,6,0,0,0,5,0,0,5,0,6,10,1
3459,104632,z2UutrDxctGBl3XhV09hNxXdsZmqDZvY,RXDvfPUBYFlVdlueBFbLW0mhhAyGEqpt,1,0,0,0,0,0,1,0,1,0.14285714285714285,1,0.0,0,0,0,0,0,0,0,1,0,0,1,1
3460,104642,OyCwM8soHH8QE4hfLYRsx6iyHPIOqWTw,SpATywNh6bZuzm8s1ceuBUnMUAeoAHHw,1,0,0,0,0,0,1,0,1,0.14285714285714285,1,0.0,0,0,0,0,0,0,0,1,0,0,1,1
3461,104697,HlYiU2TA92it9HWOPDlsBmlpdZ7J7QTJ,A3fsA9Zfv1X2fVEQhTw51lKENdNrEqT3,3,2,1,0,0,0,1,0,4,0.5714285714285714,1,0.0,0,1,0,0,2,0,0,1,0,1,3,1
3462,104746,Lzsz8G97Oqbb3ZBCI5dR9gHrqQ1EH7Ym,bWdj2GDclj5ofokWjzoa5jAwMkxCykd6,3,0,1,0,0,0,2,0,3,0.42857142857142855,1,0.0,0,1,0,0,0,0,0,2,0,1,2,1
3463,104755,cwVdqEP9opAeKfgoOEHlcQUqgyjLtu9l,G8EPVSXsOYB5YQWZGiz1aVq5Pgr2GrQu,5,2,1,0,1,0,2,0,6,0.8571428571428571,1,0.0,0,1,0,1,2,0,0,2,0,2,4,1
3464,104762,Lo2vU6mH3fqBjPz8YtN99A9tnKdHVK6o,SpATywNh6bZuzm8s1ceuBUnMUAeoAHHw,8,9,6,0,3,0,6,0,24,3.4285714285714284,1,0.0,0,6,0,3,9,0,0,6,0,9,15,1
3465,104767,futyrc5ZKHBBJxaxN8pRQj4FOD0yyEl8,RXDvfPUBYFlVdlueBFbLW0mhhAyGEqpt,7,9,5,0,1,0,2,0,17,2.4285714285714284,1,0.0,0,5,0,1,9,0,0,2,0,6,11,1
3466,104795,cjnjr7Duofdr7KxOEuxuSM38OHUgNo60,G8EPVSXsOYB5YQWZGiz1aVq5Pgr2GrQu,11,15,3,0,3,0,4,0,25,3.5714285714285716,1,0.0,0,3,0,3,15,0,0,4,0,6,19,0
3467,104828,TvgIXPYmwQ8PEavqO4tLfxpm2FF8nOoT,RXDvfPUBYFlVdlueBFbLW0mhhAyGEqpt,5,2,1,0,1,0,3,0,7,1.0,1,0.0,0,1,0,1,2,0,0,3,0,2,5,1
3468,104867,vO07VFd2DYWPdrvNiSqsqXFTXPKE00c4,RXDvfPUBYFlVdlueBFbLW0mhhAyGEqpt,1,0,0,0,0,0,1,0,1,0.14285714285714285,1,0.0,0,0,0,0,0,0,0,1,0,0,1,1
3469,104916,Pe6a7Y0LdkKZQUrgr38AH2nCOR1VUYXS,SpATywNh6bZuzm8s1ceuBUnMUAeoAHHw,18,23,11,16,7,0,2,0,59,8.428571428571429,1,0.0,7,11,15,7,16,0,1,2,0,40,19,0
3470,104920,CGn56kdY0PhcUPAztOY3cUKmF6tF5atc,RXDvfPUBYFlVdlueBFbLW0mhhAyGEqpt,5,2,1,0,1,0,2,0,6,0.8571428571428571,1,0.0,0,1,0,1,2,0,0,2,0,2,4,1
3471,104924,e1PghwtNUGs6vA3J705NBEUcrBHwivKH,G8EPVSXsOYB5YQWZGiz1aVq5Pgr2GrQu,19,19,1,32,0,1,13,1,67,9.571428571428571,2,0.0,2,1,28,0,17,1,4,13,1,31,36,0
3472,104936,9xV1wwHzLoXwKNrE0sl58GGQQc4oj1NS,bWdj2GDclj5ofokWjzoa5jAwMkxCykd6,3,2,1,0,0,0,4,0,7,1.0,2,0.0,0,1,0,0,2,0,0,4,0,1,6,1
3473,104943,8yrIKDtnkYcLfERwrXrvcRGxHxbt2Jd3,RXDvfPUBYFlVdlueBFbLW0mhhAyGEqpt,5,4,0,0,0,1,3,0,8,1.1428571428571428,1,0.0,0,0,0,0,4,1,0,3,0,0,8,1
3474,105029,AdZFV9sO1gJgqtrxJrKT3ZcjH3XA6zTA,RXDvfPUBYFlVdlueBFbLW0mhhAyGEqpt,1,0,0,0,0,0,1,0,1,0.14285714285714285,1,0.0,0,0,0,0,0,0,0,1,0,0,1,1
3475,105055,J7rstoE2U9Xgk66AuMKUxWUISAvdCQAz,G8EPVSXsOYB5YQWZGiz1aVq5Pgr2GrQu,12,11,1,6,2,1,5,1,27,3.857142857142857,1,0.0,5,1,3,2,6,1,3,5,1,11,16,1
3476,105070,C6BeEBrAxqOuF3t7YwEepluTHqEHWFpN,G8EPVSXsOYB5YQWZGiz1aVq5Pgr2GrQu,5,4,1,0,1,0,1,0,7,1.0,1,0.0,0,1,0,1,4,0,0,1,0,2,5,1
3477,105074,O4P6YgbHRYZHkVgbR7e9lebrpm34oAOF,G8EPVSXsOYB5YQWZGiz1aVq5Pgr2GrQu,2,0,0,0,0,0,2,0,2,0.2857142857142857,1,0.0,0,0,0,0,0,0,0,2,0,0,2,1
3478,105146,hzBzR1u0wuRoc2H2cG5d9FzvO4PwKrLQ,SpATywNh6bZuzm8s1ceuBUnMUAeoAHHw,7,22,8,0,4,3,4,0,41,5.857142857142857,2,0.0,6,8,0,4,16,3,0,4,0,18,23,1
3479,105153,qTzYx0lbBuxcg0Yki7msaMyOo4bFeb91,SpATywNh6bZuzm8s1ceuBUnMUAeoAHHw,16,9,6,13,4,0,2,0,34,4.857142857142857,1,0.0,2,6,13,4,7,0,0,2,0,25,9,0
3480,105161,e8r3psiscML69Zoh8ndZVq9bRmvgsAna,RXDvfPUBYFlVdlueBFbLW0mhhAyGEqpt,3,0,0,0,0,0,4,0,4,0.5714285714285714,1,0.0,0,0,0,0,0,0,0,4,0,0,4,1
3481,105191,BFrfDseDfXCBvtTfCsJAy36Ogk6b0Rfx,G8EPVSXsOYB5YQWZGiz1aVq5Pgr2GrQu,6,5,2,0,2,0,1,0,10,1.4285714285714286,1,0.0,0,2,0,2,5,0,0,1,0,4,6,1
3482,105249,TS1ZCG3Pe57Kb9bO3M4HccqPzgampcZm,RXDvfPUBYFlVdlueBFbLW0mhhAyGEqpt,1,0,0,0,0,0,1,0,1,0.14285714285714285,1,0.0,0,0,0,0,0,0,0,1,0,0,1,1
3483,105262,47V3QOKZAFRfMjY5qh3dGgU05qgUrwzk,SpATywNh6bZuzm8s1ceuBUnMUAeoAHHw,15,13,6,6,4,0,1,0,30,4.285714285714286,1,0.0,2,6,6,4,11,0,0,1,0,18,12,0
3484,105263,4HfbFsCyYszJO7w4OHW3KiOw346tCEQ3,RXDvfPUBYFlVdlueBFbLW0mhhAyGEqpt,9,11,8,0,2,0,3,0,24,3.4285714285714284,2,0.0,0,8,0,2,11,0,0,3,0,10,14,0
3485,105271,b1VyhJSDHv0QJ3rH7siQ8iNr5JEetUc9,RXDvfPUBYFlVdlueBFbLW0mhhAyGEqpt,6,7,3,0,1,0,3,0,14,2.0,1,0.0,0,3,0,1,7,0,0,3,0,4,10,1
3486,105273,eGtLsIjZlkWgWdMhhuLPGoqFtXLYqSzQ,G8EPVSXsOYB5YQWZGiz1aVq5Pgr2GrQu,11,14,8,0,5,0,5,0,32,4.571428571428571,1,0.0,0,8,0,5,14,0,0,5,0,13,19,0
3487,105274,6nb23dYhCIP1cVQ6kR327mxTR7zAmW6A,SpATywNh6bZuzm8s1ceuBUnMUAeoAHHw,12,11,8,3,4,0,1,0,27,3.857142857142857,1,0.0,2,8,3,4,9,0,0,1,0,17,10,1
3488,105289,BRC3IBMyw5vaRtTzcXuOEQUfoXyf29w0,G8EPVSXsOYB5YQWZGiz1aVq5Pgr2GrQu,8,2,1,0,2,0,3,0,8,1.1428571428571428,1,0.0,0,1,0,2,2,0,0,3,0,3,5,1
3489,105365,4ReTrx0DPSKofx7nLibnDMfTITGlbh8n,SpATywNh6bZuzm8s1ceuBUnMUAeoAHHw,6,4,2,0,1,0,1,0,8,1.1428571428571428,1,0.0,0,2,0,1,4,0,0,1,0,3,5,1
3490,105403,BAyiuAHT9YavjRYUTL3SqAF5fajY78B8,G8EPVSXsOYB5YQWZGiz1aVq5Pgr2GrQu,9,5,4,0,4,0,2,0,15,2.142857142857143,1,0.0,0,4,0,4,5,0,0,2,0,8,7,1
3491,105445,LdIFMEp4Gma3xMuOQ2mpp1BJ3jFvB9c2,bWdj2GDclj5ofokWjzoa5jAwMkxCykd6,18,19,8,52,2,4,7,0,92,13.142857142857142,2,0.0,3,8,46,2,16,4,6,7,0,59,33,0
3492,105456,P9cYtrIJUSQx41yE7x59h9MgXtuGnnbs,G8EPVSXsOYB5YQWZGiz1aVq5Pgr2GrQu,1,0,0,0,0,0,1,0,1,0.14285714285714285,1,0.0,0,0,0,0,0,0,0,1,0,0,1,1
3493,105513,huQkoBKNhxQg56EbGDFifh0dLnvHtGe7,SpATywNh6bZuzm8s1ceuBUnMUAeoAHHw,17,12,8,6,4,0,3,0,33,4.714285714285714,2,0.0,2,8,6,4,10,0,0,3,0,20,13,1
3494,105517,bR55dFOoIQqPJPBvXoxJUIXx5dva0hOC,G8EPVSXsOYB5YQWZGiz1aVq5Pgr2GrQu,9,3,2,0,2,0,4,0,11,1.5714285714285714,1,0.0,0,2,0,2,3,0,0,4,0,4,7,1
3495,105530,yjJ1iNhFO6aUkQdyDFXsvnts4X4TBbt1,G8EPVSXsOYB5YQWZGiz1aVq5Pgr2GrQu,14,8,7,0,6,0,6,1,28,4.0,1,0.0,0,7,0,6,8,0,0,6,1,13,15,1
3496,105554,lD9Di3R0D8jVkARIDTv9uHKlPOJul1IJ,RXDvfPUBYFlVdlueBFbLW0mhhAyGEqpt,21,12,10,0,7,1,10,3,43,6.142857142857143,1,0.0,0,10,0,7,12,1,0,10,3,17,26,1
3497,105596,9U8TB2VVR3SpNOaUoetOaSnkDznyBFBg,G8EPVSXsOYB5YQWZGiz1aVq5Pgr2GrQu,5,3,0,0,0,0,2,0,5,0.7142857142857143,1,0.0,0,0,0,0,3,0,0,2,0,0,5,1
3498,105611,Z91ylcCa0QBPuZRAZnN7Bi8KMhEMk84I,G8EPVSXsOYB5YQWZGiz1aVq5Pgr2GrQu,1,0,0,0,0,0,1,0,1,0.14285714285714285,1,0.0,0,0,0,0,0,0,0,1,0,0,1,1
3499,105614,jkI0zARZWQkZpKjEUfCP0wADmuTyrZSB,G8EPVSXsOYB5YQWZGiz1aVq5Pgr2GrQu,5,2,1,0,1,0,2,0,6,0.8571428571428571,1,0.0,0,1,0,1,2,0,0,2,0,2,4,1
3500,105706,Higp7tL2evAdDfwxJ7Fv3MD5xI1FILhG,G8EPVSXsOYB5YQWZGiz1aVq5Pgr2GrQu,1,0,0,0,0,0,1,0,1,0.14285714285714285,1,0.0,0,0,0,0,0,0,0,1,0,0,1,1
3501,105707,YXw4AHOHrgMAyUR11Z0AMDwuHnZeqZI7,G8EPVSXsOYB5YQWZGiz1aVq5Pgr2GrQu,5,2,1,0,1,0,2,0,6,0.8571428571428571,1,0.0,0,1,0,1,2,0,0,2,0,2,4,1
3502,106004,ZPzO2Jq9MyhQSTfjOYO9iqzdnziVzHhF,7GRhBDsirIGkRZBtSMEzNTyDr2JQm4xx,18,27,11,8,6,0,7,0,59,8.428571428571429,1,0.0,12,11,7,6,15,0,1,7,0,36,23,1
3503,106443,t3vj4r7JOWedUjNWDPc1a4izv1Cmnqwm,RXDvfPUBYFlVdlueBFbLW0mhhAyGEqpt,12,10,2,28,2,0,2,0,44,6.285714285714286,1,0.0,6,2,26,2,4,0,2,2,0,36,8,1
3504,106591,rxfzVJVj4XNymQN7SX1pdLUM549NCrW7,SpATywNh6bZuzm8s1ceuBUnMUAeoAHHw,3,2,1,0,0,0,2,0,5,0.7142857142857143,1,0.0,0,1,0,0,2,0,0,2,0,1,4,0
3505,106940,NKTsGtocSBmn1p0LL8TfbQ17Oh6XvCt3,SpATywNh6bZuzm8s1ceuBUnMUAeoAHHw,3,2,1,0,0,0,1,0,4,0.5714285714285714,1,0.0,0,1,0,0,2,0,0,1,0,1,3,0
3506,108008,7JBtUpIhUnYCA4q3ae7hJoTZvMtE4cUd,SpATywNh6bZuzm8s1ceuBUnMUAeoAHHw,9,9,1,0,1,0,2,0,13,1.8571428571428572,1,0.0,0,1,0,1,9,0,0,2,0,2,11,1
3507,108247,JVwYgpbMnhyXKC0xUgsIj4AIloKjDOV1,A3fsA9Zfv1X2fVEQhTw51lKENdNrEqT3,3,2,0,0,0,2,1,0,5,0.7142857142857143,1,0.0,0,0,0,0,2,2,0,1,0,0,5,1
3508,108262,BKTGezJoHjleu4tXARXtOL0EOZtL4wb9,bWdj2GDclj5ofokWjzoa5jAwMkxCykd6,9,8,4,0,3,0,1,0,16,2.2857142857142856,2,0.0,0,4,0,3,8,0,0,1,0,7,9,1
3509,108489,HBfe50okXo4yGURKfz5xhaX3ToIkoF7Q,A3fsA9Zfv1X2fVEQhTw51lKENdNrEqT3,41,36,17,61,10,15,4,0,143,20.428571428571427,1,0.0,1,17,51,10,35,15,10,4,0,79,64,1
3510,108588,anqtRE1JbVfWjk9aVYgpNXBcTCoFe9WO,RXDvfPUBYFlVdlueBFbLW0mhhAyGEqpt,1,0,0,0,0,0,1,0,1,0.14285714285714285,1,0.0,0,0,0,0,0,0,0,1,0,0,1,1
3511,108740,z8PlFZ3kRCGZCtReInG4syWyRUKvCeDo,RXDvfPUBYFlVdlueBFbLW0mhhAyGEqpt,21,28,2,20,5,0,2,0,57,8.142857142857142,1,0.0,13,2,20,5,15,0,0,2,0,40,17,0
3512,108782,KdDp90RfX0ap0e8qJs31e2eGxlYje3er,A3fsA9Zfv1X2fVEQhTw51lKENdNrEqT3,5,6,3,0,0,0,4,0,13,1.8571428571428572,1,0.0,0,3,0,0,6,0,0,4,0,3,10,1
3513,108810,zcKuGtc5O9cMvHSHaVwufdFteCrEpUtA,A3fsA9Zfv1X2fVEQhTw51lKENdNrEqT3,61,29,15,164,8,33,9,0,258,36.857142857142854,2,0.0,3,15,138,8,26,33,26,9,0,164,94,1
3514,108845,VBP5PzVQEKJYFH0y5ffEek5WfP9EW7uc,bWdj2GDclj5ofokWjzoa5jAwMkxCykd6,5,7,4,0,1,0,3,0,15,2.142857142857143,3,0.0,0,4,0,1,7,0,0,3,0,5,10,1
3515,109074,3Q4BnqdcagQPfwKNQquFMuffhZmA481O,A3fsA9Zfv1X2fVEQhTw51lKENdNrEqT3,15,11,9,18,6,3,2,0,49,7.0,1,0.0,0,9,17,6,11,3,1,2,0,32,17,0
3516,109193,SclrH2608f72JlTtkBQ5xWQXCuDyyco3,A3fsA9Zfv1X2fVEQhTw51lKENdNrEqT3,33,13,9,96,4,0,7,0,129,18.428571428571427,2,0.0,1,9,85,4,12,0,11,7,0,99,30,0
3517,109312,XyoP35cBUiKk44G72mbtEXCBjk8FmHfo,RXDvfPUBYFlVdlueBFbLW0mhhAyGEqpt,23,14,9,40,4,0,2,0,69,9.857142857142858,1,0.0,4,9,37,4,10,0,3,2,0,54,15,1
3518,109537,F5SjzrcjsAWqSZbt6NDh8MAkDqWpXhkX,SpATywNh6bZuzm8s1ceuBUnMUAeoAHHw,17,25,8,16,3,1,1,0,54,7.714285714285714,1,0.0,16,8,15,3,9,1,1,1,0,42,12,1
3519,109569,XTOZBwO5vG1hcHef4AbuiTP7iSg27hS9,A3fsA9Zfv1X2fVEQhTw51lKENdNrEqT3,4,3,1,0,0,0,1,0,5,0.7142857142857143,1,0.0,0,1,0,0,3,0,0,1,0,1,4,1
3520,109651,9JqGpnHdkbKBOmcT3LmREcuqxduizBra,SpATywNh6bZuzm8s1ceuBUnMUAeoAHHw,1,0,0,0,0,0,1,0,1,0.14285714285714285,1,0.0,0,0,0,0,0,0,0,1,0,0,1,1
3521,109664,SzAtQzNOap38B7fNAidQGz1HfRyu6YSS,A3fsA9Zfv1X2fVEQhTw51lKENdNrEqT3,1,0,0,0,0,0,1,0,1,0.14285714285714285,1,0.0,0,0,0,0,0,0,0,1,0,0,1,1
3522,109716,9257hE3j2ibuyvUsd5ug9QNBvZR626xP,SpATywNh6bZuzm8s1ceuBUnMUAeoAHHw,15,18,6,18,4,0,1,0,47,6.714285714285714,1,0.0,8,6,15,4,10,0,3,1,0,33,14,1
3523,109935,CViRSkXaB71kW0MpqfES8A240EKnhiKp,SpATywNh6bZuzm8s1ceuBUnMUAeoAHHw,8,6,5,0,3,0,1,0,15,2.142857142857143,1,0.0,0,5,0,3,6,0,0,1,0,8,7,1
3524,109938,jhSBNR9EEysD5KhTnnFndvZuefk9V3rI,SpATywNh6bZuzm8s1ceuBUnMUAeoAHHw,16,16,12,15,5,0,5,0,53,7.571428571428571,2,0.0,2,12,13,5,14,0,2,5,0,32,21,0
3525,110005,CD2QgLWd9xNuEgr45XWnWQUVbnjf79M7,A3fsA9Zfv1X2fVEQhTw51lKENdNrEqT3,1,0,0,0,0,0,1,0,1,0.14285714285714285,1,0.0,0,0,0,0,0,0,0,1,0,0,1,1
3526,113825,xUhDcXiX03QQg1jNR3Lksh9CrGcRUkPg,7GRhBDsirIGkRZBtSMEzNTyDr2JQm4xx,13,21,1,0,3,4,8,0,37,5.285714285714286,2,0.0,5,1,0,3,16,4,0,8,0,9,28,0
3527,113845,EwpbggvNdZkeSTjdG48aEltlJYavm02s,7GRhBDsirIGkRZBtSMEzNTyDr2JQm4xx,4,2,1,0,1,0,1,0,5,0.7142857142857143,1,0.0,0,1,0,1,2,0,0,1,0,2,3,1
3528,113846,7hhGe4WcGEHypOzIVz3DLRx9GS52ozkE,7GRhBDsirIGkRZBtSMEzNTyDr2JQm4xx,15,20,11,10,7,0,3,0,51,7.285714285714286,2,0.0,6,11,8,7,14,0,2,3,0,32,19,1
3529,113935,nDRvdnRCphlivJCuFTuhDKgd5jyHoHuK,7GRhBDsirIGkRZBtSMEzNTyDr2JQm4xx,49,136,73,90,31,4,27,0,361,51.57142857142857,7,0.0,40,73,76,31,96,4,14,27,0,220,141,0
3530,113957,JoqAGqbao71wc04PyVzx7SVvlZZ0knbI,7GRhBDsirIGkRZBtSMEzNTyDr2JQm4xx,23,54,16,32,7,10,10,0,129,18.428571428571427,3,0.0,27,16,29,7,27,10,3,10,0,79,50,1
3531,114029,B7LHt2Cj2bBAHJSILTk3b5ZvfNYywzep,7GRhBDsirIGkRZBtSMEzNTyDr2JQm4xx,9,6,3,0,1,0,5,0,15,2.142857142857143,1,0.0,1,3,0,1,5,0,0,5,0,5,10,1
3532,114045,40f11BuizcEv7ZFFxcPqa0v1O1iUUbkI,7GRhBDsirIGkRZBtSMEzNTyDr2JQm4xx,7,6,3,0,2,0,2,0,13,1.8571428571428572,2,0.0,1,3,0,2,5,0,0,2,0,6,7,1
3533,114118,hNtOw8NhFSEVmWVm0uZ7niVIy1y64lqK,7GRhBDsirIGkRZBtSMEzNTyDr2JQm4xx,4,0,0,0,0,0,10,0,10,1.4285714285714286,2,0.0,0,0,0,0,0,0,0,10,0,0,10,1
3534,114136,tkUa5CpArdCreqMyzIcAuTFrrxiEVJbS,7GRhBDsirIGkRZBtSMEzNTyDr2JQm4xx,30,30,13,34,11,15,12,0,115,16.428571428571427,1,0.0,16,13,29,11,14,15,5,12,0,69,46,1
3535,114140,nUWkRuhBy34ASlaPMCQ75Oelnn64cfdy,7GRhBDsirIGkRZBtSMEzNTyDr2JQm4xx,39,76,27,22,22,0,9,0,156,22.285714285714285,2,0.0,45,27,21,22,31,0,1,9,0,115,41,0
3536,114147,okqN4nBVKRYYrkYonKicKGOmPqVGYjZh,7GRhBDsirIGkRZBtSMEzNTyDr2JQm4xx,4,3,1,0,0,0,4,0,8,1.1428571428571428,2,0.0,0,1,0,0,3,0,0,4,0,1,7,0
3537,114179,QZbPGbTnAqz8GS6cm25XcpeiETovvLN6,7GRhBDsirIGkRZBtSMEzNTyDr2JQm4xx,2,0,0,0,0,0,3,0,3,0.42857142857142855,1,0.0,0,0,0,0,0,0,0,3,0,0,3,0
3538,114255,dtcl5eI6yhwMyoweqshgFuTzKqFJQm0u,7GRhBDsirIGkRZBtSMEzNTyDr2JQm4xx,2,0,0,0,0,0,3,0,3,0.42857142857142855,1,0.0,0,0,0,0,0,0,0,3,0,0,3,1
3539,114289,yt0pMjWs1WUyd9gdp8SqXOjWyU58K3uA,7GRhBDsirIGkRZBtSMEzNTyDr2JQm4xx,2,0,0,0,0,0,2,0,2,0.2857142857142857,2,0.0,0,0,0,0,0,0,0,2,0,0,2,1
3540,114349,HHtkMPGPD7M5HjKp2cITsAXThUPUGeqi,7GRhBDsirIGkRZBtSMEzNTyDr2JQm4xx,19,44,8,18,10,0,6,0,86,12.285714285714286,2,0.0,19,8,15,10,25,0,3,6,0,52,34,1
3541,114404,RrDvHNy910b7XxqIkvHWSamS4IG3fgCH,7GRhBDsirIGkRZBtSMEzNTyDr2JQm4xx,1,0,0,0,0,0,1,0,1,0.14285714285714285,1,0.0,0,0,0,0,0,0,0,1,0,0,1,1
3542,114429,NEVPUSDkU7HaE7xRESmGkn6KaWhWlNDH,7GRhBDsirIGkRZBtSMEzNTyDr2JQm4xx,11,19,4,51,0,0,1,0,75,10.714285714285714,1,0.0,14,4,44,0,5,0,7,1,0,62,13,1
3543,114458,hu8eak1Xmf8voE8pnxPzkSD2dZP9Sipf,7GRhBDsirIGkRZBtSMEzNTyDr2JQm4xx,2,0,0,0,0,0,4,0,4,0.5714285714285714,2,0.0,0,0,0,0,0,0,0,4,0,0,4,0
3544,114460,gBUQvhjVwGtG2bUGFkuQNt86DA2hmTm5,7GRhBDsirIGkRZBtSMEzNTyDr2JQm4xx,43,133,62,64,34,0,30,3,326,46.57142857142857,3,0.0,63,62,54,34,70,0,10,30,3,213,113,1
3545,114491,MU4dVyJTD7iIRSTZIdJZ9VoLOxogfKQN,7GRhBDsirIGkRZBtSMEzNTyDr2JQm4xx,4,2,1,0,1,0,1,0,5,0.7142857142857143,1,0.0,0,1,0,1,2,0,0,1,0,2,3,1
3546,114492,oxOzo82Nq65tcwE6AZvxglw3lN8SeywJ,7GRhBDsirIGkRZBtSMEzNTyDr2JQm4xx,5,2,1,0,1,0,2,0,6,0.8571428571428571,1,0.0,0,1,0,1,2,0,0,2,0,2,4,1
3547,114508,DahdU3m64q9GHbzMvs6TdHVFTDo4asbt,7GRhBDsirIGkRZBtSMEzNTyDr2JQm4xx,10,3,2,0,1,1,7,2,16,2.2857142857142856,1,0.0,0,2,0,1,3,1,0,7,2,3,13,0
3548,114536,BIrtFqgMfUNvzbgStoEGnPt5I5Uav700,7GRhBDsirIGkRZBtSMEzNTyDr2JQm4xx,1,0,0,0,0,0,1,0,1,0.14285714285714285,1,0.0,0,0,0,0,0,0,0,1,0,0,1,1
3549,114546,CKlPS4aJNSCYcpmTEnTkXSXKz4jn8q0W,7GRhBDsirIGkRZBtSMEzNTyDr2JQm4xx,2,0,0,0,0,0,2,0,2,0.2857142857142857,1,0.0,0,0,0,0,0,0,0,2,0,0,2,1
3550,114562,BQSRjVmgixA5nv8k53vKwJ20bVp0NOMd,7GRhBDsirIGkRZBtSMEzNTyDr2JQm4xx,43,58,22,65,14,107,13,1,280,40.0,4,0.0,29,22,54,14,29,107,11,13,1,119,161,0
3551,114597,rwCHpAN1sY0GvFYG7zQQk2qpgkOBz9O3,7GRhBDsirIGkRZBtSMEzNTyDr2JQm4xx,1,0,0,0,0,0,1,0,1,0.14285714285714285,1,0.0,0,0,0,0,0,0,0,1,0,0,1,1
3552,114622,whDoakw9KuyWQ8M0W7cddKOMydB0d6nf,fbPkOYLVPtPgIt0MxizjfFJov3JbHyAi,14,26,7,8,14,0,2,0,57,8.142857142857142,1,0.0,18,7,6,14,8,0,2,2,0,45,12,1
3553,114639,IXyECojptU5NkfL9RFdtwIRy87m56pw9,fbPkOYLVPtPgIt0MxizjfFJov3JbHyAi,27,82,35,23,17,40,51,13,261,37.285714285714285,7,0.0,25,35,14,17,57,40,9,51,13,91,170,1
3554,114652,wuaIkUodYTr49NZ7BbMPsEdpO0t0C8Nt,fbPkOYLVPtPgIt0MxizjfFJov3JbHyAi,13,20,0,8,2,0,4,0,34,4.857142857142857,1,0.0,8,0,7,2,12,0,1,4,0,17,17,1
3555,117356,BEpwi711y09XyC4DFTNZ8NMJ5PwUJeE1,fbPkOYLVPtPgIt0MxizjfFJov3JbHyAi,19,43,23,2,5,52,13,4,142,20.285714285714285,4,0.0,2,23,1,5,41,52,1,13,4,31,111,0
3556,117357,jdo8ZaITXdNg3iaXD5IuBNuDQn99Df8w,fbPkOYLVPtPgIt0MxizjfFJov3JbHyAi,4,4,2,0,0,0,1,0,7,1.0,1,0.0,0,2,0,0,4,0,0,1,0,2,5,1
3557,117375,70RbSAVcGIyny9mWjCd20wt9FfgzeOIU,fbPkOYLVPtPgIt0MxizjfFJov3JbHyAi,3,3,2,0,0,0,1,0,6,0.8571428571428571,1,0.0,0,2,0,0,3,0,0,1,0,2,4,1
3558,117384,QE7VYemIj4pMHXuEl2xp801KoSOaKbg6,fbPkOYLVPtPgIt0MxizjfFJov3JbHyAi,9,8,4,0,3,0,1,0,16,2.2857142857142856,1,0.0,2,4,0,3,6,0,0,1,0,9,7,1
3559,117391,dGox9f4ZDlHQwjKRHa3wEmIJzGDWDxPX,fbPkOYLVPtPgIt0MxizjfFJov3JbHyAi,10,13,4,8,6,0,1,0,32,4.571428571428571,1,0.0,8,4,6,6,5,0,2,1,0,24,8,1
3560,117394,x61GVEFoUQZEIHnVsxBCw0kitfDOhP0p,fbPkOYLVPtPgIt0MxizjfFJov3JbHyAi,2,0,0,0,0,18,2,0,20,2.857142857142857,1,0.0,0,0,0,0,0,18,0,2,0,0,20,1
3561,117402,BdMHqR5WAKDssANXDMso5QusZ7X7eexo,fbPkOYLVPtPgIt0MxizjfFJov3JbHyAi,25,82,31,11,18,33,8,1,184,26.285714285714285,2,0.0,31,31,10,18,51,33,1,8,1,90,94,1
3562,117416,no2ug7TKVsupL4LU2a5jY2GhYHkskTdw,fbPkOYLVPtPgIt0MxizjfFJov3JbHyAi,41,65,35,30,18,9,9,0,166,23.714285714285715,3,0.0,22,35,24,18,43,9,6,9,0,99,67,1
3563,117423,NXEwBXbU6vvce77sujWgRB6LivhFJvRb,fbPkOYLVPtPgIt0MxizjfFJov3JbHyAi,6,5,3,0,1,0,3,0,12,1.7142857142857142,1,0.0,0,3,0,1,5,0,0,3,0,4,8,1
3564,117450,NTi3RF6xGnkzsfYTj8D33u4sH3LbVAHE,fbPkOYLVPtPgIt0MxizjfFJov3JbHyAi,8,10,5,10,0,0,1,0,26,3.7142857142857144,1,0.0,2,5,9,0,8,0,1,1,0,16,10,1
3565,117459,8BPmxHv8u8jXk5HWBs0qXnY9uZ2rLMGq,fbPkOYLVPtPgIt0MxizjfFJov3JbHyAi,5,3,2,0,1,0,1,0,7,1.0,1,0.0,0,2,0,1,3,0,0,1,0,3,4,0
3566,117461,OakZIwMalw5UgG2N0rTydClOEPiV8rki,fbPkOYLVPtPgIt0MxizjfFJov3JbHyAi,16,26,10,10,6,6,1,0,59,8.428571428571429,1,0.0,5,10,10,6,21,6,0,1,0,31,28,1
3567,117474,1HKWuDclbOiSiuIlQVduMPq7fJCJ9Rls,fbPkOYLVPtPgIt0MxizjfFJov3JbHyAi,5,7,4,0,0,0,3,0,14,2.0,1,0.0,0,4,0,0,7,0,0,3,0,4,10,1
3568,117487,UvYdE00Z5Ts8a6wK0WxKxxpGT2cAkrRh,fbPkOYLVPtPgIt0MxizjfFJov3JbHyAi,9,19,5,4,4,0,2,0,34,4.857142857142857,1,0.0,6,5,3,4,13,0,1,2,0,18,16,0
3569,117493,Cn5FQ7TJ9erBCpMOguGrs26OG5h6UtTt,fbPkOYLVPtPgIt0MxizjfFJov3JbHyAi,9,8,4,0,3,0,4,0,19,2.7142857142857144,1,0.0,2,4,0,3,6,0,0,4,0,9,10,1
3570,117501,Djtv0PgEw9uZSQc7WiXmZsJgnFOxrvrt,A3fsA9Zfv1X2fVEQhTw51lKENdNrEqT3,1,0,0,0,0,0,1,0,1,0.14285714285714285,1,0.0,0,0,0,0,0,0,0,1,0,0,1,1
3571,117509,ydSu1htsBf3RzcwY9UTcwNk58kfOh1CK,SpATywNh6bZuzm8s1ceuBUnMUAeoAHHw,8,12,0,4,0,0,5,0,21,3.0,3,0.0,0,0,4,0,12,0,0,5,0,4,17,0
3572,117517,s6b6Agzyi3Or4EEcsJYYkdvPZgCCL57f,A3fsA9Zfv1X2fVEQhTw51lKENdNrEqT3,5,3,1,0,0,0,4,0,8,1.1428571428571428,1,0.0,0,1,0,0,3,0,0,4,0,1,7,1
3573,117534,qX3w4IgztgXyu9swieirFObama3kJyza,bWdj2GDclj5ofokWjzoa5jAwMkxCykd6,24,34,3,70,6,0,11,0,124,17.714285714285715,3,0.0,13,3,64,6,21,0,6,11,0,86,38,1
3574,117536,f07Kut7kBpGHis5iRAbMzHKfd6CS5vLr,A3fsA9Zfv1X2fVEQhTw51lKENdNrEqT3,8,18,14,0,0,90,8,0,130,18.571428571428573,3,0.0,1,14,0,0,17,90,0,8,0,15,115,0
3575,117546,EX3gOxFqlG8z0KCJnBCBLiCIiQRkFF4q,A3fsA9Zfv1X2fVEQhTw51lKENdNrEqT3,9,3,2,0,2,0,4,0,11,1.5714285714285714,1,0.0,0,2,0,2,3,0,0,4,0,4,7,1
3576,117552,wKSiPD3ccCI47tDYWhx56Wd2BJP8ki2L,SpATywNh6bZuzm8s1ceuBUnMUAeoAHHw,4,3,2,0,0,0,2,0,7,1.0,1,0.0,0,2,0,0,3,0,0,2,0,2,5,0
3577,117561,ADL0cXowUMs4wyiAOHKMOrtTHu5tmUqi,A3fsA9Zfv1X2fVEQhTw51lKENdNrEqT3,25,15,9,66,0,0,17,0,107,15.285714285714286,4,0.0,0,9,63,0,15,0,3,17,0,72,35,0
3578,117563,W5xQOH5MemwXn7klqn6rjd1MM4WzuzQi,SpATywNh6bZuzm8s1ceuBUnMUAeoAHHw,16,11,5,20,3,0,4,0,43,6.142857142857143,2,0.0,5,5,17,3,6,0,3,4,0,30,13,0
3579,117586,23MV7Tf2OIT2UG3xeA8mvmRw6rIFBd81,A3fsA9Zfv1X2fVEQhTw51lKENdNrEqT3,30,27,20,6,13,8,22,2,98,14.0,4,0.0,0,20,6,13,27,8,0,22,2,39,59,1
3580,117602,BcsAFxTYYWhC1bNDfK977UfoS17oCWvP,SpATywNh6bZuzm8s1ceuBUnMUAeoAHHw,14,22,2,10,0,3,2,0,39,5.571428571428571,1,0.0,7,2,9,0,15,3,1,2,0,18,21,0
3581,117611,BbvGM92sGSMMIrRMXDFdD1GEnySzXRYT,SpATywNh6bZuzm8s1ceuBUnMUAeoAHHw,13,14,0,12,1,0,1,0,28,4.0,1,0.0,2,0,12,1,12,0,0,1,0,15,13,0
3582,117653,xdxiKeJYKflgdr88D3HSJXuR1e81YpjG,A3fsA9Zfv1X2fVEQhTw51lKENdNrEqT3,24,19,15,0,10,0,5,0,49,7.0,3,0.0,0,15,0,10,19,0,0,5,0,25,24,1
3583,117668,ZvlB6WVwV84B3g1S1DABzlXirXgL69kV,SpATywNh6bZuzm8s1ceuBUnMUAeoAHHw,14,16,5,19,4,0,12,0,56,8.0,5,0.0,11,5,16,4,5,0,3,12,0,36,20,1
3584,117698,JjO25OOm89Iye7MTZHSNIwd1wvv7Llpy,bWdj2GDclj5ofokWjzoa5jAwMkxCykd6,2,0,0,0,0,0,2,0,2,0.2857142857142857,1,0.0,0,0,0,0,0,0,0,2,0,0,2,1
3585,117703,70SrKRY1oWl5d62cNgc8OZe8Ra3cen1a,SpATywNh6bZuzm8s1ceuBUnMUAeoAHHw,13,30,1,18,0,0,3,0,52,7.428571428571429,2,0.0,11,1,15,0,19,0,3,3,0,27,25,0
3586,117730,ZRcEnEYSSBQbkjzMu7sidjbxasfrmw8l,A3fsA9Zfv1X2fVEQhTw51lKENdNrEqT3,38,48,23,78,2,0,11,0,162,23.142857142857142,3,0.0,1,23,62,2,47,0,16,11,0,88,74,0
3587,117732,cQJEH4N9NA86ElT2x4zkE6ToN6rVT4MQ,A3fsA9Zfv1X2fVEQhTw51lKENdNrEqT3,30,24,22,18,16,0,3,0,83,11.857142857142858,3,0.0,0,22,16,16,24,0,2,3,0,54,29,1
3588,117749,yNygMjDRQbsmQrkdzv6Ni3gEhrA9rC9T,G8EPVSXsOYB5YQWZGiz1aVq5Pgr2GrQu,3,4,2,0,0,0,2,0,8,1.1428571428571428,1,0.0,0,2,0,0,4,0,0,2,0,2,6,1
3589,117782,usFuTvFQpKrRjDwn3CiAVcIq4WWtoKl0,RXDvfPUBYFlVdlueBFbLW0mhhAyGEqpt,19,17,12,14,10,39,21,11,124,17.714285714285715,5,0.0,0,12,13,10,17,39,1,21,11,35,89,0
3590,117813,wKbSE55kexrWAbxmePgEr4VHk4YSiEaC,A3fsA9Zfv1X2fVEQhTw51lKENdNrEqT3,1,0,0,0,0,0,1,0,1,0.14285714285714285,1,0.0,0,0,0,0,0,0,0,1,0,0,1,1
3591,117838,E6GtLgX3I7VGOpV74LvaV5V5J9ND1jUQ,SpATywNh6bZuzm8s1ceuBUnMUAeoAHHw,1,0,0,0,0,0,1,0,1,0.14285714285714285,1,0.0,0,0,0,0,0,0,0,1,0,0,1,1
3592,117865,57P5UbCfzn8GLpyzVkqMDPp8kp3hFIaz,bWdj2GDclj5ofokWjzoa5jAwMkxCykd6,2,2,1,0,0,0,0,0,3,0.42857142857142855,1,0.0,0,1,0,0,2,0,0,0,0,1,2,1
3593,117866,o7ztEzN1VLXMPiKeM3Eu4FDhVLhHjR47,A3fsA9Zfv1X2fVEQhTw51lKENdNrEqT3,17,11,9,0,6,4,3,0,33,4.714285714285714,1,0.0,0,9,0,6,11,4,0,3,0,15,18,1
3594,117906,NoA9xueUUthCTfidqnFplOKsMZsY3DHa,A3fsA9Zfv1X2fVEQhTw51lKENdNrEqT3,3,4,2,0,0,0,2,0,8,1.1428571428571428,1,0.0,0,2,0,0,4,0,0,2,0,2,6,1
3595,117907,Z3bFvTwttDZ4bCfkqeyPSBE9NPAPKPqN,SpATywNh6bZuzm8s1ceuBUnMUAeoAHHw,5,6,4,0,0,0,2,0,12,1.7142857142857142,2,0.0,0,4,0,0,6,0,0,2,0,4,8,0
3596,117910,QtoTN2OyyTcqe6Us4ENFLFoSg3hJkA40,SpATywNh6bZuzm8s1ceuBUnMUAeoAHHw,10,27,3,0,2,0,8,0,40,5.714285714285714,2,0.0,7,3,0,2,20,0,0,8,0,12,28,0
3597,117927,M45J6fNUaggda3LzoFU6r4v9Do7R8HkV,bWdj2GDclj5ofokWjzoa5jAwMkxCykd6,17,51,40,0,10,8,5,0,114,16.285714285714285,1,0.0,5,40,0,10,46,8,0,5,0,55,59,0
3598,117940,JYCXGTBUXKAgLYAuYSVkBAkWpoJ7TYUE,G8EPVSXsOYB5YQWZGiz1aVq5Pgr2GrQu,46,50,17,60,6,21,16,3,173,24.714285714285715,3,0.0,25,17,35,6,25,21,25,16,3,83,90,0
3599,117948,1AlOrbJ2y8dS4ycbJ2sP2OTCfMGEqZ01,SpATywNh6bZuzm8s1ceuBUnMUAeoAHHw,21,27,16,28,7,0,6,1,85,12.142857142857142,1,0.0,7,16,22,7,20,0,6,6,1,52,33,0
3600,118032,VE9HD5yzeCmqc2pNGfTQWsVbRdaqJBIV,A3fsA9Zfv1X2fVEQhTw51lKENdNrEqT3,4,2,1,0,1,0,1,0,5,0.7142857142857143,1,0.0,0,1,0,1,2,0,0,1,0,2,3,1
3601,118083,hJwtwnOzJaTrAeP4eXJAEwz2xbKsgc4M,SpATywNh6bZuzm8s1ceuBUnMUAeoAHHw,1,0,0,0,0,0,7,0,7,1.0,5,0.0,0,0,0,0,0,0,0,7,0,0,7,0
3602,118124,11qZqrXXcQbdqet0TC5DW03t5yp66Tzn,SpATywNh6bZuzm8s1ceuBUnMUAeoAHHw,16,9,6,8,4,0,4,0,31,4.428571428571429,2,0.0,2,6,8,4,7,0,0,4,0,20,11,0
3603,118145,CUEyHbsjLlbX6I7tsbnNjxFI1v5Lj4iD,SpATywNh6bZuzm8s1ceuBUnMUAeoAHHw,10,19,3,0,3,0,3,0,28,4.0,1,0.0,0,3,0,3,19,0,0,3,0,6,22,0
3604,118153,UwereIH21fVhvJGOSErkxB1cQ9i013xS,SpATywNh6bZuzm8s1ceuBUnMUAeoAHHw,1,0,0,0,0,0,1,0,1,0.14285714285714285,1,0.0,0,0,0,0,0,0,0,1,0,0,1,0
3605,118171,U3R4m4eLMm2lirgI7HLueBKsNpxhFpn9,A3fsA9Zfv1X2fVEQhTw51lKENdNrEqT3,5,3,2,0,0,0,2,0,7,1.0,1,0.0,0,2,0,0,3,0,0,2,0,2,5,0
3606,118178,qAVFbR5cx9X92KNDPDJmLoSTth8nEsRM,RXDvfPUBYFlVdlueBFbLW0mhhAyGEqpt,52,49,18,148,8,35,5,0,263,37.57142857142857,3,0.0,13,18,135,8,36,35,13,5,0,174,89,0
3607,118222,IONYwfWuSLUzRHMHVpaPTPvGauCNosjD,SpATywNh6bZuzm8s1ceuBUnMUAeoAHHw,5,11,7,0,4,0,4,0,26,3.7142857142857144,1,0.0,0,7,0,4,11,0,0,4,0,11,15,1
3608,118237,rT3zpA0g6rjJ1jZXfn6mCIcHmMcmU756,SpATywNh6bZuzm8s1ceuBUnMUAeoAHHw,5,6,5,0,3,7,2,0,23,3.2857142857142856,1,0.0,0,5,0,3,6,7,0,2,0,8,15,1
3609,118260,5rpYxIaCTDb4PhszkJWpACOx5VMpNGcQ,A3fsA9Zfv1X2fVEQhTw51lKENdNrEqT3,9,7,5,0,3,8,6,0,29,4.142857142857143,2,0.0,0,5,0,3,7,8,0,6,0,8,21,1
3610,118267,GyWTABuPpZEqO585EnNTIpM2B2faPYN3,SpATywNh6bZuzm8s1ceuBUnMUAeoAHHw,26,30,18,14,14,2,2,0,80,11.428571428571429,1,0.0,11,18,14,14,19,2,0,2,0,57,23,1
3611,118284,iRkGn6DaWx0LZKTkLTjixCrksMnftQiz,SpATywNh6bZuzm8s1ceuBUnMUAeoAHHw,6,5,1,0,1,0,1,0,8,1.1428571428571428,1,0.0,0,1,0,1,5,0,0,1,0,2,6,1
3612,118297,jSCfroddrqNUSCH6KjU0nXMDCSxYb3do,A3fsA9Zfv1X2fVEQhTw51lKENdNrEqT3,1,0,0,0,0,0,1,0,1,0.14285714285714285,1,0.0,0,0,0,0,0,0,0,1,0,0,1,1
3613,118324,QRV1oI1S8Ffuh8TqoOSVsQ6W4xedCLat,SpATywNh6bZuzm8s1ceuBUnMUAeoAHHw,4,4,0,0,0,0,1,0,5,0.7142857142857143,1,0.0,0,0,0,0,4,0,0,1,0,0,5,0
3614,118336,50cUUtrBaOZeeifZra0Sj4seKRuBEyFS,SpATywNh6bZuzm8s1ceuBUnMUAeoAHHw,12,40,5,0,2,0,2,0,49,7.0,2,0.0,19,5,0,2,21,0,0,2,0,26,23,0
3615,118395,LVTU4qA4F3wWkxH81iGfu4ZuIt77nyhh,A3fsA9Zfv1X2fVEQhTw51lKENdNrEqT3,4,2,1,0,0,0,2,0,5,0.7142857142857143,1,0.0,0,1,0,0,2,0,0,2,0,1,4,0
3616,118423,9iGaqBGS5kkoXjLd87hUL2eIJMVUVKfU,bWdj2GDclj5ofokWjzoa5jAwMkxCykd6,6,6,3,0,2,0,3,0,14,2.0,2,0.0,0,3,0,2,6,0,0,3,0,5,9,1
3617,118433,U4egSBuIz4Tp2aExbhUIhaem6H1lHi4I,A3fsA9Zfv1X2fVEQhTw51lKENdNrEqT3,1,0,0,0,0,0,1,0,1,0.14285714285714285,1,0.0,0,0,0,0,0,0,0,1,0,0,1,0
3618,118453,X285XxvFlCKmuDlV3vzMxZpCu1V9X67P,G8EPVSXsOYB5YQWZGiz1aVq5Pgr2GrQu,26,34,21,10,11,0,4,0,80,11.428571428571429,1,0.0,10,21,9,11,24,0,1,4,0,51,29,1
3619,118484,grhneBVDCBhvBD53OXACTDGfdH3pEWQ2,SpATywNh6bZuzm8s1ceuBUnMUAeoAHHw,15,14,1,12,0,0,4,1,32,4.571428571428571,2,0.0,4,1,9,0,10,0,3,4,1,14,18,0
3620,118517,AADHk2CnqIXqU54SVoJYYzHXkzsT7VVX,SpATywNh6bZuzm8s1ceuBUnMUAeoAHHw,21,52,26,29,3,25,10,8,153,21.857142857142858,3,0.0,16,26,24,3,36,25,5,10,8,69,84,0
3621,118552,bQgvxTEfpKkG7faV4J3DTFNYdIGmaRJn,A3fsA9Zfv1X2fVEQhTw51lKENdNrEqT3,2,0,0,0,0,0,2,0,2,0.2857142857142857,1,0.0,0,0,0,0,0,0,0,2,0,0,2,1
3622,118561,Go1ERHGiNnYVc6rXpAjttQ9IaXemOnqN,A3fsA9Zfv1X2fVEQhTw51lKENdNrEqT3,4,3,2,0,0,0,1,0,6,0.8571428571428571,1,0.0,0,2,0,0,3,0,0,1,0,2,4,1
3623,118567,TQy9wSoPujib2kvNE4TTZJIA8yQmRsFr,bWdj2GDclj5ofokWjzoa5jAwMkxCykd6,3,3,0,0,0,0,1,0,4,0.5714285714285714,1,0.0,0,0,0,0,3,0,0,1,0,0,4,1
3624,118592,RiCs84yGV6JCwVfBOhcXa8oCpUMbIJNf,SpATywNh6bZuzm8s1ceuBUnMUAeoAHHw,21,51,2,18,1,10,14,1,97,13.857142857142858,2,0.0,18,2,17,1,33,10,1,14,1,38,59,0
3625,118594,r0yZNwEG828V0TMkCl61Reya5Y5HO5aR,A3fsA9Zfv1X2fVEQhTw51lKENdNrEqT3,3,3,1,0,0,0,2,0,6,0.8571428571428571,1,0.0,0,1,0,0,3,0,0,2,0,1,5,1
3626,118599,tp9GLoYyljDV6mILQxrtrv1Iw4qcPl5Z,A3fsA9Zfv1X2fVEQhTw51lKENdNrEqT3,7,4,2,0,2,0,3,0,11,1.5714285714285714,1,0.0,1,2,0,2,3,0,0,3,0,5,6,1
3627,118626,sjQQWItXAp5E8ocdOnRRzFCiZKv0PVqn,SpATywNh6bZuzm8s1ceuBUnMUAeoAHHw,17,18,5,11,0,0,4,0,38,5.428571428571429,1,0.0,2,5,10,0,16,0,1,4,0,17,21,0
3628,118629,f4eElh7NTKGsWnUHRO9BuyTOQtrsnWlM,SpATywNh6bZuzm8s1ceuBUnMUAeoAHHw,17,16,9,19,4,0,6,0,54,7.714285714285714,1,0.0,6,9,17,4,10,0,2,6,0,36,18,1
3629,118633,NuFKQkAxfn2PT3wbGN0i3erkBYbjqkix,A3fsA9Zfv1X2fVEQhTw51lKENdNrEqT3,53,15,0,170,0,2,8,1,196,28.0,2,0.0,2,0,148,0,13,2,22,8,1,150,46,0
3630,118653,YmAogTXGoaSGS2jBtwsCLUVebiwWGuMB,A3fsA9Zfv1X2fVEQhTw51lKENdNrEqT3,17,18,15,0,13,4,4,0,54,7.714285714285714,3,0.0,0,15,0,13,18,4,0,4,0,28,26,1
3631,118665,eNgDL8k9xOLyBlZ3UNlseJHly8SfPZZu,A3fsA9Zfv1X2fVEQhTw51lKENdNrEqT3,52,66,51,76,28,32,14,1,268,38.285714285714285,5,0.0,5,51,58,28,61,32,18,14,1,142,126,0
3632,118667,oamKaVYtYcTWlWXxR9gjWFZVaqJSv9QD,RXDvfPUBYFlVdlueBFbLW0mhhAyGEqpt,56,120,2,102,31,5,7,0,267,38.142857142857146,3,0.0,76,2,97,31,44,5,5,7,0,206,61,0
3633,118668,vbghp1PVpZxFaWqasEyQzIEfPKBk8vPh,A3fsA9Zfv1X2fVEQhTw51lKENdNrEqT3,12,7,4,0,4,0,3,0,18,2.5714285714285716,2,0.0,1,4,0,4,6,0,0,3,0,9,9,1
3634,118691,DvqqmzfQOqhniG6rRYaSYRCVzVLc6KPG,A3fsA9Zfv1X2fVEQhTw51lKENdNrEqT3,5,3,2,0,1,0,1,0,7,1.0,1,0.0,0,2,0,1,3,0,0,1,0,3,4,1
3635,118692,34Xbf7uBGJ4LnJBXPtvvptwjUQQdkYUg,A3fsA9Zfv1X2fVEQhTw51lKENdNrEqT3,4,2,1,0,0,0,2,0,5,0.7142857142857143,1,0.0,0,1,0,0,2,0,0,2,0,1,4,0
3636,118713,GzZqgl4giqqW7TCBTX5a2jDyy6Q646Os,SpATywNh6bZuzm8s1ceuBUnMUAeoAHHw,4,3,0,0,0,0,3,0,6,0.8571428571428571,1,0.0,0,0,0,0,3,0,0,3,0,0,6,1
3637,118722,DHhoczdtvn37Fynebgh7tMkKtF0dh4jQ,A3fsA9Zfv1X2fVEQhTw51lKENdNrEqT3,1,0,0,0,0,0,1,0,1,0.14285714285714285,1,0.0,0,0,0,0,0,0,0,1,0,0,1,1
3638,118752,v5ZzaFsvASHZHFHDQx30X4bWu2OAn0TJ,bWdj2GDclj5ofokWjzoa5jAwMkxCykd6,11,18,1,30,5,1,7,1,63,9.0,1,0.0,10,1,30,5,8,1,0,7,1,46,17,1
3639,118771,lrp5AGJUh69hKuCI5IYUEU19E2beipwd,A3fsA9Zfv1X2fVEQhTw51lKENdNrEqT3,16,15,1,30,1,2,2,0,51,7.285714285714286,3,0.0,0,1,25,1,15,2,5,2,0,27,24,1
3640,118774,DqNAxwTcrk055KEf1va6hv0cFfrqGSiY,A3fsA9Zfv1X2fVEQhTw51lKENdNrEqT3,7,13,5,0,1,0,2,0,21,3.0,2,0.0,0,5,0,1,13,0,0,2,0,6,15,1
3641,118783,bKVslXuzEQ1pv4c6iV5mVjs6X6avUbmL,G8EPVSXsOYB5YQWZGiz1aVq5Pgr2GrQu,1,0,0,0,0,0,1,0,1,0.14285714285714285,1,0.0,0,0,0,0,0,0,0,1,0,0,1,0
3642,118829,oYXc35V0j0DGRrciqWRUFfGtnQPnDhaQ,A3fsA9Zfv1X2fVEQhTw51lKENdNrEqT3,7,12,1,0,0,0,5,0,18,2.5714285714285716,1,0.0,0,1,0,0,12,0,0,5,0,1,17,1
3643,118876,eLhnZqVqldawLLuaLdbS0XPiIKiZAief,RXDvfPUBYFlVdlueBFbLW0mhhAyGEqpt,15,16,0,0,0,8,4,0,28,4.0,1,0.0,0,0,0,0,16,8,0,4,0,0,28,0
3644,118913,xUhDcXiX03QQg1jNR3Lksh9CrGcRUkPg,A3fsA9Zfv1X2fVEQhTw51lKENdNrEqT3,32,75,34,106,1,93,17,0,326,46.57142857142857,6,0.0,12,34,77,1,63,93,29,17,0,124,202,0
3645,118919,TOHE2cn8sx2ym4g7cRhp3c9gQIpGV4UB,A3fsA9Zfv1X2fVEQhTw51lKENdNrEqT3,1,0,0,0,0,0,1,0,1,0.14285714285714285,1,0.0,0,0,0,0,0,0,0,1,0,0,1,1
3646,118923,FcPFK6OTsUF1j3uNGabdzGTvbY8kcO3D,A3fsA9Zfv1X2fVEQhTw51lKENdNrEqT3,6,5,4,0,1,0,1,0,11,1.5714285714285714,1,0.0,0,4,0,1,5,0,0,1,0,5,6,1
3647,118926,efygWYkxxUMOGInRZT4qEeuzMRlIpQq6,SpATywNh6bZuzm8s1ceuBUnMUAeoAHHw,25,41,24,8,12,1,10,0,96,13.714285714285714,3,0.0,11,24,8,12,30,1,0,10,0,55,41,0
3648,118930,fiLsrcAU0ZFm61T8xhRUwb5p8PN605CT,SpATywNh6bZuzm8s1ceuBUnMUAeoAHHw,7,3,2,0,2,0,2,0,9,1.2857142857142858,1,0.0,0,2,0,2,3,0,0,2,0,4,5,1
3649,118943,6hOFMnbpcErHmlwc3MeiSQOkkbkZvsdF,SpATywNh6bZuzm8s1ceuBUnMUAeoAHHw,2,0,1,0,1,0,0,0,2,0.2857142857142857,1,0.0,0,1,0,1,0,0,0,0,0,2,0,0
3650,118944,pqKCkJOspd9xXtA4k6IDJS4Js61XmolB,SpATywNh6bZuzm8s1ceuBUnMUAeoAHHw,2,0,1,0,1,0,0,0,2,0.2857142857142857,1,0.0,0,1,0,1,0,0,0,0,0,2,0,1
3651,118957,28PHU9suTM8EqUKsQwsvQ03DzFXi0yDl,RXDvfPUBYFlVdlueBFbLW0mhhAyGEqpt,1,0,0,0,0,0,3,0,3,0.42857142857142855,2,0.0,0,0,0,0,0,0,0,3,0,0,3,1
3652,118962,UHbjjkoY8eePNp6r324vyfQdD3BvD0KM,G8EPVSXsOYB5YQWZGiz1aVq5Pgr2GrQu,8,5,4,0,1,0,2,0,12,1.7142857142857142,1,0.0,0,4,0,1,5,0,0,2,0,5,7,1
3653,118964,YvVuka2rxSzzYYNnDLtzVMee0hjbsr3Q,SpATywNh6bZuzm8s1ceuBUnMUAeoAHHw,2,0,1,0,1,0,0,0,2,0.2857142857142857,1,0.0,0,1,0,1,0,0,0,0,0,2,0,1
3654,118966,zQeYO5pZ1xh2UAEMjLOadhLt0hmfHHxb,bWdj2GDclj5ofokWjzoa5jAwMkxCykd6,3,4,2,0,0,0,1,0,7,1.0,1,0.0,0,2,0,0,4,0,0,1,0,2,5,1
3655,118977,rwmKpdbePJfKvi814EI3msCq1quO9ftl,SpATywNh6bZuzm8s1ceuBUnMUAeoAHHw,6,2,0,0,0,0,5,1,8,1.1428571428571428,1,0.0,0,0,0,0,2,0,0,5,1,0,8,1
3656,118987,u79qFvGauNOAmgDpP2DklDOwG6ISKFXs,SpATywNh6bZuzm8s1ceuBUnMUAeoAHHw,10,30,6,0,2,0,2,0,40,5.714285714285714,1,0.0,23,6,0,2,7,0,0,2,0,31,9,1
3657,118993,5R2yvtH9LNaB7I0DFs0y5Dgzft4SPkTz,SpATywNh6bZuzm8s1ceuBUnMUAeoAHHw,16,13,8,13,4,0,5,0,43,6.142857142857143,1,0.0,2,8,13,4,11,0,0,5,0,27,16,1
3658,119001,DXaGQeTbJkNEulVow7g1qYtfMHcxt0Bb,SpATywNh6bZuzm8s1ceuBUnMUAeoAHHw,15,29,2,8,2,0,0,0,41,5.857142857142857,2,0.0,8,2,8,2,21,0,0,0,0,20,21,0
3659,119008,i41wq4JFa1zWjnzk4s4F0u6D3S1UMuDT,bWdj2GDclj5ofokWjzoa5jAwMkxCykd6,1,0,0,0,0,0,1,0,1,0.14285714285714285,1,0.0,0,0,0,0,0,0,0,1,0,0,1,1
3660,119009,c8TFm45r0bfBe26eBlEeUAKDBoTJT9yV,SpATywNh6bZuzm8s1ceuBUnMUAeoAHHw,8,9,0,19,0,0,1,0,29,4.142857142857143,1,0.0,4,0,16,0,5,0,3,1,0,20,9,0
3661,119012,gVK9JFuVehH4w6Ht2Q17t4NUtbNWFPNf,SpATywNh6bZuzm8s1ceuBUnMUAeoAHHw,7,2,0,0,0,0,9,1,12,1.7142857142857142,1,0.0,0,0,0,0,2,0,0,9,1,0,12,1
3662,119026,Pqb8mgUOFwNjSYHZCNAFlv28S1hEJuyW,RXDvfPUBYFlVdlueBFbLW0mhhAyGEqpt,7,3,2,0,1,0,4,0,10,1.4285714285714286,1,0.0,1,2,0,1,2,0,0,4,0,4,6,1
3663,119027,5tL0goZ0bMjNeuGHJZ9VZymSM6PzqaXn,SpATywNh6bZuzm8s1ceuBUnMUAeoAHHw,13,17,12,0,9,0,2,0,40,5.714285714285714,2,0.0,3,12,0,9,14,0,0,2,0,24,16,0
3664,119042,lVwgv61cg8fkhW9rg5b1PIPnuUWxb0Vk,bWdj2GDclj5ofokWjzoa5jAwMkxCykd6,6,7,4,0,1,13,4,0,29,4.142857142857143,3,0.0,0,4,0,1,7,13,0,4,0,5,24,1
3665,119057,pKoUS2SEKCFMATrFfyk1PMmORYo186Kb,G8EPVSXsOYB5YQWZGiz1aVq5Pgr2GrQu,54,157,3,102,12,1,15,1,291,41.57142857142857,3,0.0,89,3,73,12,68,1,29,15,1,177,114,0
3666,119060,vnVRudtEjYlZLumIJaQJj0f2z3slueSl,SpATywNh6bZuzm8s1ceuBUnMUAeoAHHw,12,15,9,10,5,0,5,0,44,6.285714285714286,1,0.0,2,9,9,5,13,0,1,5,0,25,19,1
3667,119071,pcGXxspzr6LCJz7Udn3jdISDvA5WWes9,G8EPVSXsOYB5YQWZGiz1aVq5Pgr2GrQu,4,3,1,0,0,0,1,0,5,0.7142857142857143,1,0.0,0,1,0,0,3,0,0,1,0,1,4,1
3668,119080,iPvQyQrtKaIWy8V9F09NldCS64KhU7EA,G8EPVSXsOYB5YQWZGiz1aVq5Pgr2GrQu,1,0,0,0,0,0,1,0,1,0.14285714285714285,1,0.0,0,0,0,0,0,0,0,1,0,0,1,1
3669,119090,RwiQ9qTlDDbK4m60mKR4JxmbkQn57Rff,RXDvfPUBYFlVdlueBFbLW0mhhAyGEqpt,7,5,4,0,1,10,2,4,26,3.7142857142857144,1,0.0,0,4,0,1,5,10,0,2,4,5,21,1
3670,119104,jq4JfpgApzrMRuCNvYDPIsQTWPeEZuhJ,G8EPVSXsOYB5YQWZGiz1aVq5Pgr2GrQu,26,29,4,81,2,29,12,3,160,22.857142857142858,1,0.0,11,4,71,2,18,29,10,12,3,88,72,1
3671,119109,PZtj1GnJa5qYIICIjESUcqp401L5vmnR,G8EPVSXsOYB5YQWZGiz1aVq5Pgr2GrQu,21,36,0,58,2,24,17,2,139,19.857142857142858,1,0.0,17,0,48,2,19,24,10,17,2,67,72,1
3672,119130,7iwTSJc32zh43nzmRibHZmGv70Vk4Lgo,SpATywNh6bZuzm8s1ceuBUnMUAeoAHHw,5,2,1,0,1,0,4,0,8,1.1428571428571428,1,0.0,0,1,0,1,2,0,0,4,0,2,6,1
3673,119131,NOm4CR7y4Aje7RwR2ZLNwhU4SfabY7lA,SpATywNh6bZuzm8s1ceuBUnMUAeoAHHw,4,5,2,0,0,0,3,0,10,1.4285714285714286,1,0.0,0,2,0,0,5,0,0,3,0,2,8,1
3674,119143,YMxXtA5A6XX1bdm998q3OXZqnuIpo8I0,SpATywNh6bZuzm8s1ceuBUnMUAeoAHHw,13,31,13,0,0,27,6,0,77,11.0,3,0.0,8,13,0,0,23,27,0,6,0,21,56,0
3675,119151,RlfxLmk0H7RVTMayoeG4aa7x6bQD0aZn,SpATywNh6bZuzm8s1ceuBUnMUAeoAHHw,4,2,1,0,1,0,1,0,5,0.7142857142857143,1,0.0,0,1,0,1,2,0,0,1,0,2,3,1
3676,119152,xJut5jnrMH6sobZn5JCJO1JseLVZmDHM,SpATywNh6bZuzm8s1ceuBUnMUAeoAHHw,11,15,6,0,4,0,3,0,28,4.0,1,0.0,0,6,0,4,15,0,0,3,0,10,18,1
3677,119159,rbbo6gYUB5I1wwOafpQCdj4m6UPXHmsz,SpATywNh6bZuzm8s1ceuBUnMUAeoAHHw,6,5,3,0,1,1,3,1,14,2.0,1,0.0,0,3,0,1,5,1,0,3,1,4,10,0
3678,119170,kd67Lm5QGeYWxcKJYnacCNFbyj5NIxDh,SpATywNh6bZuzm8s1ceuBUnMUAeoAHHw,11,16,2,27,0,0,1,0,46,6.571428571428571,1,0.0,12,2,21,0,4,0,6,1,0,35,11,0
3679,119185,mu7Zdr1ChN6xNMWE8Otd7Si7TQhm7pEQ,SpATywNh6bZuzm8s1ceuBUnMUAeoAHHw,8,12,7,0,4,0,6,0,29,4.142857142857143,2,0.0,0,7,0,4,12,0,0,6,0,11,18,0
3680,119190,oUj6dSGxHzsnU6uTXKwTomk9vwlHt6j0,G8EPVSXsOYB5YQWZGiz1aVq5Pgr2GrQu,15,15,11,0,7,0,6,0,39,5.571428571428571,3,0.0,0,11,0,7,15,0,0,6,0,18,21,1
3681,119192,NoA9xueUUthCTfidqnFplOKsMZsY3DHa,SpATywNh6bZuzm8s1ceuBUnMUAeoAHHw,18,27,11,22,5,0,5,0,70,10.0,1,0.0,4,11,21,5,23,0,1,5,0,41,29,1
3682,119203,PZqGQ10gijeZZaXj244FlA0iYVn9rzPC,SpATywNh6bZuzm8s1ceuBUnMUAeoAHHw,5,2,1,0,1,0,2,0,6,0.8571428571428571,1,0.0,0,1,0,1,2,0,0,2,0,2,4,1
3683,119204,okqN4nBVKRYYrkYonKicKGOmPqVGYjZh,G8EPVSXsOYB5YQWZGiz1aVq5Pgr2GrQu,7,6,2,0,1,0,5,0,14,2.0,1,0.0,0,2,0,1,6,0,0,5,0,3,11,0
3684,119212,ttJwJCfGlOpWVOx9vRULE7UdoGyFI9Ut,SpATywNh6bZuzm8s1ceuBUnMUAeoAHHw,5,6,3,0,2,0,1,0,12,1.7142857142857142,1,0.0,2,3,0,2,4,0,0,1,0,7,5,1
3685,119217,UbE5C1Pto1KvqgPPDmGO0svv7BwAZk15,G8EPVSXsOYB5YQWZGiz1aVq5Pgr2GrQu,9,7,4,0,4,0,2,0,17,2.4285714285714284,1,0.0,0,4,0,4,7,0,0,2,0,8,9,1
3686,119224,ieJctBgJj74PFo2P7ymmdVzAX2v62LKu,G8EPVSXsOYB5YQWZGiz1aVq5Pgr2GrQu,12,11,5,0,4,0,6,0,26,3.7142857142857144,1,0.0,0,5,0,4,11,0,0,6,0,9,17,1
3687,119237,63TreuteShRAITxpj6URpYIQ3kURzPmt,bWdj2GDclj5ofokWjzoa5jAwMkxCykd6,8,9,1,0,1,10,7,1,29,4.142857142857143,1,0.0,2,1,0,1,7,10,0,7,1,4,25,1
3688,119239,okqN4nBVKRYYrkYonKicKGOmPqVGYjZh,bWdj2GDclj5ofokWjzoa5jAwMkxCykd6,7,23,11,0,0,0,7,0,41,5.857142857142857,1,0.0,1,11,0,0,22,0,0,7,0,12,29,0
3689,119243,q3pPbgY0JhPpTgQfSrEbBAWd7rbmYjI4,SpATywNh6bZuzm8s1ceuBUnMUAeoAHHw,14,32,2,15,2,0,7,0,58,8.285714285714286,1,0.0,11,2,15,2,21,0,0,7,0,30,28,0
3690,119245,7RIgMHzHpMzY7qBXHPj6WiDKK3U9H2Wz,SpATywNh6bZuzm8s1ceuBUnMUAeoAHHw,15,14,13,0,12,0,2,0,41,5.857142857142857,1,0.0,0,13,0,12,14,0,0,2,0,25,16,0
3691,119251,qujx8xRYXJGJrQ3ruvaaTF7TTwy8KaeC,G8EPVSXsOYB5YQWZGiz1aVq5Pgr2GrQu,9,5,3,0,1,0,4,0,13,1.8571428571428572,1,0.0,0,3,0,1,5,0,0,4,0,4,9,1
3692,119265,8oiFYmMp7IOF1mfFRmhZ7Lug8ImrhTTO,SpATywNh6bZuzm8s1ceuBUnMUAeoAHHw,6,8,3,0,0,0,2,0,13,1.8571428571428572,2,0.0,2,3,0,0,6,0,0,2,0,5,8,1
3693,119266,iacqYcgHTn7FZ8NE4roe5kgAUjDF0efr,SpATywNh6bZuzm8s1ceuBUnMUAeoAHHw,14,12,10,0,8,0,4,0,34,4.857142857142857,1,0.0,0,10,0,8,12,0,0,4,0,18,16,0
3694,119288,NDGU2YEumOCOuP8YkbdyT4JHlfK2eImX,SpATywNh6bZuzm8s1ceuBUnMUAeoAHHw,9,6,4,0,2,0,2,0,14,2.0,1,0.0,0,4,0,2,6,0,0,2,0,6,8,1
3695,119289,ch9jXib8D5Z69PRYwp1WHAUa7SmEdgIr,SpATywNh6bZuzm8s1ceuBUnMUAeoAHHw,18,19,7,11,3,1,10,2,53,7.571428571428571,1,0.0,10,7,11,3,9,1,0,10,2,31,22,1
3696,119290,AJAawUTIK5tTWvBfm3QRQhh9S7SsRdRA,SpATywNh6bZuzm8s1ceuBUnMUAeoAHHw,8,6,1,0,1,1,3,1,13,1.8571428571428572,1,0.0,0,1,0,1,6,1,0,3,1,2,11,1
3697,119293,845wZKTJiCD0zuzvTs70K7NaBfTnltXS,SpATywNh6bZuzm8s1ceuBUnMUAeoAHHw,7,2,1,0,1,10,4,1,19,2.7142857142857144,1,0.0,0,1,0,1,2,10,0,4,1,2,17,1
3698,119294,tdyEqQ928g4zwLz7u1XUELM0nW67gqKU,G8EPVSXsOYB5YQWZGiz1aVq5Pgr2GrQu,24,79,37,42,6,0,11,0,175,25.0,2,0.0,17,37,40,6,62,0,2,11,0,100,75,1
3699,119295,yuOMBhnDAvRSNCNkI5M8rpsRFdq6dg7T,RXDvfPUBYFlVdlueBFbLW0mhhAyGEqpt,4,2,1,0,1,0,1,0,5,0.7142857142857143,1,0.0,0,1,0,1,2,0,0,1,0,2,3,1
3700,119300,1P5MvFqtZDoED6FWgTnhCj192U5gDdPF,G8EPVSXsOYB5YQWZGiz1aVq5Pgr2GrQu,12,12,0,6,0,19,7,1,45,6.428571428571429,1,0.0,8,0,5,0,4,19,1,7,1,13,32,0
3701,119305,kLbYKjAePyQg6GOXHiVGeoyhhDvXEfjN,SpATywNh6bZuzm8s1ceuBUnMUAeoAHHw,17,21,2,12,0,6,12,5,58,8.285714285714286,2,0.0,5,2,12,0,16,6,0,12,5,19,39,0
3702,119309,kWr0BhoQMxiu9wSeKhtyX0T1P5JfsERH,SpATywNh6bZuzm8s1ceuBUnMUAeoAHHw,19,21,11,22,4,7,13,0,78,11.142857142857142,6,0.0,3,11,20,4,18,7,2,13,0,38,40,0
3703,119325,grNuFIQJF1sOOkw8RJjaExhlwTJt52uU,SpATywNh6bZuzm8s1ceuBUnMUAeoAHHw,20,36,15,12,4,41,15,2,125,17.857142857142858,3,0.0,11,15,11,4,25,41,1,15,2,41,84,0
3704,119330,Xx6t23p3XIha0hNmBziFcHG3GcEwTmQl,SpATywNh6bZuzm8s1ceuBUnMUAeoAHHw,29,28,17,25,9,29,36,2,146,20.857142857142858,1,0.0,7,17,22,9,21,29,3,36,2,55,91,0
3705,119332,FEK5BtdsP2RwxkLYp7U5A0VI3SgJyNlk,SpATywNh6bZuzm8s1ceuBUnMUAeoAHHw,5,7,1,0,1,0,1,0,10,1.4285714285714286,2,0.0,0,1,0,1,7,0,0,1,0,2,8,1
3706,119359,DhNEa94k5xGKWUPgWcx5F0CO6u6J4iIb,G8EPVSXsOYB5YQWZGiz1aVq5Pgr2GrQu,33,57,28,96,17,17,11,2,228,32.57142857142857,2,0.0,26,28,75,17,31,17,21,11,2,146,82,1
3707,119361,d0czHY9SleKhWFZVHkBc11jXgenCfeaE,SpATywNh6bZuzm8s1ceuBUnMUAeoAHHw,17,14,11,0,6,3,4,2,40,5.714285714285714,1,0.0,0,11,0,6,14,3,0,4,2,17,23,1
3708,119368,WfocL88obqufkiW8V6EsVJAto3ptM4se,RXDvfPUBYFlVdlueBFbLW0mhhAyGEqpt,6,3,0,0,0,1,3,0,7,1.0,1,0.0,0,0,0,0,3,1,0,3,0,0,7,1
3709,119369,w0JXf5IU53zIrRHN4nASHPBtvGw0J3e8,SpATywNh6bZuzm8s1ceuBUnMUAeoAHHw,1,0,0,0,0,0,1,0,1,0.14285714285714285,1,0.0,0,0,0,0,0,0,0,1,0,0,1,1
3710,119372,RwvuGEh3euIR11rktJrGBhzDqcQMkhOC,SpATywNh6bZuzm8s1ceuBUnMUAeoAHHw,16,20,12,8,6,0,2,0,48,6.857142857142857,1,0.0,6,12,7,6,14,0,1,2,0,31,17,0
3711,119382,tiXCEdgwB1xd20Vy4mgIvE207fd2jlXf,SpATywNh6bZuzm8s1ceuBUnMUAeoAHHw,28,35,15,30,8,0,4,0,92,13.142857142857142,2,0.0,17,15,28,8,18,0,2,4,0,68,24,1
3712,119383,v2tR5cCXv44SOe8Z266q9U5FU2iAwtD3,SpATywNh6bZuzm8s1ceuBUnMUAeoAHHw,20,16,11,4,7,0,6,0,44,6.285714285714286,1,0.0,6,11,4,7,10,0,0,6,0,28,16,1
3713,119401,rSKz43hYiPnNMTLyx15fL1ocrthBLweg,SpATywNh6bZuzm8s1ceuBUnMUAeoAHHw,6,10,4,0,2,5,4,0,25,3.5714285714285716,2,0.0,3,4,0,2,7,5,0,4,0,9,16,1
3714,119408,TDRTbyk0dkUIgXlX1DR0wEGLNYKbj2kE,SpATywNh6bZuzm8s1ceuBUnMUAeoAHHw,5,7,2,0,1,0,1,0,11,1.5714285714285714,1,0.0,2,2,0,1,5,0,0,1,0,5,6,0
3715,119413,HNjmezOX8bu6iW67SYkfKBzixQs4v7AY,SpATywNh6bZuzm8s1ceuBUnMUAeoAHHw,3,2,1,0,0,0,1,0,4,0.5714285714285714,1,0.0,0,1,0,0,2,0,0,1,0,1,3,0
3716,119422,8bsgdKFaSfwROHIZCKXm97BMUW4OFzed,SpATywNh6bZuzm8s1ceuBUnMUAeoAHHw,16,9,6,12,4,1,3,0,35,5.0,1,0.0,2,6,10,4,7,1,2,3,0,22,13,0
3717,119437,WnuLHUQ0J3BeGgl165qL2l7BKuVDR3LS,RXDvfPUBYFlVdlueBFbLW0mhhAyGEqpt,9,8,1,10,2,0,3,0,24,3.4285714285714284,1,0.0,2,1,9,2,6,0,1,3,0,14,10,0
3718,119456,72z519PMt8GGBXLvF1FG0oMJuciCSWYJ,RXDvfPUBYFlVdlueBFbLW0mhhAyGEqpt,12,18,4,12,3,0,6,0,43,6.142857142857143,4,0.0,1,4,10,3,17,0,2,6,0,18,25,1
3719,119461,6ZwHbtvdiS8islxnPJXOOnLtMpvU3IpT,SpATywNh6bZuzm8s1ceuBUnMUAeoAHHw,8,14,8,0,5,0,3,0,30,4.285714285714286,3,0.0,0,8,0,5,14,0,0,3,0,13,17,0
3720,119482,S2q1gEPtloNcMfcAwTCrDjaeEJ3ox2aC,A3fsA9Zfv1X2fVEQhTw51lKENdNrEqT3,4,3,2,0,0,0,2,0,7,1.0,2,0.0,0,2,0,0,3,0,0,2,0,2,5,1
3721,119493,50aSuabL02e7lLNBHTRXsMQnBChV2lSX,G8EPVSXsOYB5YQWZGiz1aVq5Pgr2GrQu,4,2,0,0,0,0,2,0,4,0.5714285714285714,1,0.0,0,0,0,0,2,0,0,2,0,0,4,1
3722,119501,iWlNj0RlfLQkFgeY87o4tMiHnUMI1yTI,G8EPVSXsOYB5YQWZGiz1aVq5Pgr2GrQu,2,1,0,0,0,0,1,0,2,0.2857142857142857,1,0.0,0,0,0,0,1,0,0,1,0,0,2,1
3723,119515,0mqsqXT4HPDOQPxpDnEoZEe1KeuUzpQx,SpATywNh6bZuzm8s1ceuBUnMUAeoAHHw,16,41,6,10,6,0,9,0,72,10.285714285714286,3,0.0,5,6,9,6,36,0,1,9,0,26,46,0
3724,119520,ZQcWT47pZxjNboL0V0inwxjvImMCbKfc,SpATywNh6bZuzm8s1ceuBUnMUAeoAHHw,18,54,15,10,6,0,9,0,94,13.428571428571429,3,0.0,2,15,8,6,52,0,2,9,0,31,63,0
3725,119528,BnWzYOrzXkQQKpdPflOsG06i68fZaDTp,SpATywNh6bZuzm8s1ceuBUnMUAeoAHHw,8,5,0,0,0,0,6,0,11,1.5714285714285714,1,0.0,0,0,0,0,5,0,0,6,0,0,11,1
3726,119537,OHgepWjzcLmDHpgOxR6c8DhDBUqi1HDm,G8EPVSXsOYB5YQWZGiz1aVq5Pgr2GrQu,2,0,0,0,0,0,2,0,2,0.2857142857142857,1,0.0,0,0,0,0,0,0,0,2,0,0,2,1
3727,119540,OHgepWjzcLmDHpgOxR6c8DhDBUqi1HDm,bWdj2GDclj5ofokWjzoa5jAwMkxCykd6,7,2,1,0,1,0,4,0,8,1.1428571428571428,1,0.0,0,1,0,1,2,0,0,4,0,2,6,1
3728,119547,NHjxa47feJ9sWQnmg6HoO6L78eHIRwnl,RXDvfPUBYFlVdlueBFbLW0mhhAyGEqpt,7,7,1,0,0,0,1,0,9,1.2857142857142858,1,0.0,0,1,0,0,7,0,0,1,0,1,8,1
3729,119556,ZQcWT47pZxjNboL0V0inwxjvImMCbKfc,A3fsA9Zfv1X2fVEQhTw51lKENdNrEqT3,13,37,10,0,3,0,9,0,59,8.428571428571429,3,0.0,0,10,0,3,37,0,0,9,0,13,46,1
3730,119563,HbDZBLuVJ2GX78KybFnufJtg8yn0zj71,SpATywNh6bZuzm8s1ceuBUnMUAeoAHHw,14,10,9,8,5,0,1,0,33,4.714285714285714,1,0.0,0,9,6,5,10,0,2,1,0,20,13,1
3731,119570,vuz6r1wL6cSmPMYDw5wsdIxwDVSbQPGA,SpATywNh6bZuzm8s1ceuBUnMUAeoAHHw,14,18,11,16,3,1,2,0,51,7.285714285714286,1,0.0,5,11,14,3,13,1,2,2,0,33,18,1
3732,119577,ZtIdVQN3EYruDP82MkDXBV4HsWJ99nHc,SpATywNh6bZuzm8s1ceuBUnMUAeoAHHw,9,5,1,6,0,0,2,0,14,2.0,1,0.0,0,1,5,0,5,0,1,2,0,6,8,1
3733,119590,hWuNPhEBxnKOOJFguUTUYW5SrQ5ZI8jY,SpATywNh6bZuzm8s1ceuBUnMUAeoAHHw,5,2,1,0,1,0,2,0,6,0.8571428571428571,1,0.0,0,1,0,1,2,0,0,2,0,2,4,1
3734,119595,GPzUdrAeOhUs39B3OZTNuOkoEWda0QRy,G8EPVSXsOYB5YQWZGiz1aVq5Pgr2GrQu,9,6,0,0,0,3,10,0,19,2.7142857142857144,1,0.0,0,0,0,0,6,3,0,10,0,0,19,1
3735,119601,VW1NSXHsRBHsQFDrAdwMVKxbl0FK1kSa,SpATywNh6bZuzm8s1ceuBUnMUAeoAHHw,4,5,1,0,0,0,2,0,8,1.1428571428571428,1,0.0,0,1,0,0,5,0,0,2,0,1,7,0
3736,119603,RwVsCYe1en11KhE66sG3vEW9DQBctFlb,SpATywNh6bZuzm8s1ceuBUnMUAeoAHHw,5,3,2,3,0,0,1,0,9,1.2857142857142858,1,0.0,0,2,3,0,3,0,0,1,0,5,4,1
3737,119629,nIvIddlMAmTQagaACOulbZ6PInxlyOy2,G8EPVSXsOYB5YQWZGiz1aVq5Pgr2GrQu,1,0,0,0,0,0,1,0,1,0.14285714285714285,1,0.0,0,0,0,0,0,0,0,1,0,0,1,1
3738,119630,nIvIddlMAmTQagaACOulbZ6PInxlyOy2,RXDvfPUBYFlVdlueBFbLW0mhhAyGEqpt,1,0,0,0,0,0,1,0,1,0.14285714285714285,1,0.0,0,0,0,0,0,0,0,1,0,0,1,1
3739,119633,owff2SMFy8taj2Sp3iBe2dPorkqov8kW,SpATywNh6bZuzm8s1ceuBUnMUAeoAHHw,16,10,8,10,7,6,1,0,42,6.0,2,0.0,2,8,9,7,8,6,1,1,0,26,16,0
3740,119636,ocTIjxG8zBs0mQRpUtpuAKc7MDpzU7Sd,RXDvfPUBYFlVdlueBFbLW0mhhAyGEqpt,5,2,1,0,1,0,3,0,7,1.0,1,0.0,0,1,0,1,2,0,0,3,0,2,5,1
3741,119662,sImBATl7O8yGkyet4MbeHdX4JDcSvSmd,SpATywNh6bZuzm8s1ceuBUnMUAeoAHHw,6,4,1,0,1,0,2,0,8,1.1428571428571428,1,0.0,0,1,0,1,4,0,0,2,0,2,6,1
3742,119668,Iydx83GAroCbGGGXrOpRJJuSwZtmEEM2,G8EPVSXsOYB5YQWZGiz1aVq5Pgr2GrQu,4,2,1,0,1,2,1,0,7,1.0,1,0.0,0,1,0,1,2,2,0,1,0,2,5,0
3743,119670,zVRAzbnjBCQDkq8v9znUSK3YAm6GKwXz,SpATywNh6bZuzm8s1ceuBUnMUAeoAHHw,13,18,1,6,0,1,6,1,33,4.714285714285714,1,0.0,2,1,5,0,16,1,1,6,1,8,25,0
3744,119681,528WImnBRwlpaJrHx5YESmcymECT8QVd,SpATywNh6bZuzm8s1ceuBUnMUAeoAHHw,7,6,4,0,3,0,2,0,15,2.142857142857143,1,0.0,0,4,0,3,6,0,0,2,0,7,8,1
3745,119685,OOIu03NBEHePUSUIFa86FGFP5M136EAn,SpATywNh6bZuzm8s1ceuBUnMUAeoAHHw,21,33,9,12,4,0,3,0,61,8.714285714285714,2,0.0,15,9,12,4,18,0,0,3,0,40,21,0
3746,119699,poqFOGQT2LdvIPHVhQsrQlPpawp1crlg,RXDvfPUBYFlVdlueBFbLW0mhhAyGEqpt,5,18,9,0,9,0,0,0,36,5.142857142857143,1,0.0,0,9,0,9,18,0,0,0,0,18,18,0
3747,119705,jyrCU8C7BRBPvFcEuIthOI2idRHtzC9e,RXDvfPUBYFlVdlueBFbLW0mhhAyGEqpt,3,0,0,0,0,0,3,0,3,0.42857142857142855,1,0.0,0,0,0,0,0,0,0,3,0,0,3,1
3748,119706,4aBimyYkJ2UKqGpkp7oZ1zAX2svcfueq,SpATywNh6bZuzm8s1ceuBUnMUAeoAHHw,8,12,3,19,1,0,0,0,35,5.0,1,0.0,10,3,17,1,2,0,2,0,0,31,4,1
3749,119713,6PXcyDdGgas03jfN9GNBg7eDbTNLi58b,bWdj2GDclj5ofokWjzoa5jAwMkxCykd6,2,0,0,0,0,0,2,0,2,0.2857142857142857,1,0.0,0,0,0,0,0,0,0,2,0,0,2,1
3750,119718,GB4yB9EIEjt1Ja66w5VOBhvDfHhUpkZn,G8EPVSXsOYB5YQWZGiz1aVq5Pgr2GrQu,7,4,2,0,2,0,1,0,9,1.2857142857142858,1,0.0,0,2,0,2,4,0,0,1,0,4,5,1
3751,119720,k6RJ44LpfDefc4BqSfb5Ks3bqRLzpbPs,A3fsA9Zfv1X2fVEQhTw51lKENdNrEqT3,8,4,0,10,0,0,2,0,16,2.2857142857142856,1,0.0,0,0,9,0,4,0,1,2,0,9,7,1
3752,119726,crYeYmekM522NBCXMSSwnlz38sA9PXwb,SpATywNh6bZuzm8s1ceuBUnMUAeoAHHw,1,0,0,0,0,0,1,0,1,0.14285714285714285,1,0.0,0,0,0,0,0,0,0,1,0,0,1,1
3753,119730,6ap3DhKROc7tFODwClFOjVJl3s3EA3mu,G8EPVSXsOYB5YQWZGiz1aVq5Pgr2GrQu,8,5,4,0,4,0,6,0,19,2.7142857142857144,2,0.0,0,4,0,4,5,0,0,6,0,8,11,1
3754,119735,7spTo5lIRwZxDBcGilRyFIwiDfkCxjQE,SpATywNh6bZuzm8s1ceuBUnMUAeoAHHw,10,13,1,0,0,0,2,0,16,2.2857142857142856,1,0.0,4,1,0,0,9,0,0,2,0,5,11,1
3755,119738,mu5O3Y2ITikjmKkPmDursRzlvrhHDXTz,SpATywNh6bZuzm8s1ceuBUnMUAeoAHHw,2,0,0,0,0,0,2,0,2,0.2857142857142857,1,0.0,0,0,0,0,0,0,0,2,0,0,2,1
3756,119742,PHTS4r6mOEHpVZfm3SzAd9KLg785EPpx,SpATywNh6bZuzm8s1ceuBUnMUAeoAHHw,14,33,16,0,4,21,7,0,81,11.571428571428571,5,0.0,1,16,0,4,32,21,0,7,0,21,60,0
3757,119748,wIXH3gEY2v8CIGUg8D6sapoHRbIUXs86,SpATywNh6bZuzm8s1ceuBUnMUAeoAHHw,20,19,1,17,0,1,2,0,40,5.714285714285714,1,0.0,5,1,17,0,14,1,0,2,0,23,17,1
3758,119749,r81fu0o4ondjTT64GPXMD4igVXZTnWR1,G8EPVSXsOYB5YQWZGiz1aVq5Pgr2GrQu,15,18,1,22,0,0,2,0,43,6.142857142857143,1,0.0,3,1,17,0,15,0,5,2,0,21,22,1
3759,119758,VbCHzxhJd8ennilHHm3zMG389MZjcR4g,SpATywNh6bZuzm8s1ceuBUnMUAeoAHHw,28,27,13,30,7,10,5,0,92,13.142857142857142,6,0.0,10,13,28,7,17,10,2,5,0,58,34,0
3760,119759,eXv6ACzt62C4hMSoDSIQMvmz4LEnGBtm,SpATywNh6bZuzm8s1ceuBUnMUAeoAHHw,14,19,8,22,0,7,9,1,66,9.428571428571429,3,0.0,9,8,17,0,10,7,5,9,1,34,32,0
3761,119765,pTILTxXRSQA3FxWLi5P70kOpV3SZ6Qdg,SpATywNh6bZuzm8s1ceuBUnMUAeoAHHw,1,0,0,0,0,0,1,0,1,0.14285714285714285,1,0.0,0,0,0,0,0,0,0,1,0,0,1,1
3762,119767,OXe0TiHLRyjl3AO2ffihLeA3ZfDF07jU,SpATywNh6bZuzm8s1ceuBUnMUAeoAHHw,8,7,1,0,1,0,1,0,10,1.4285714285714286,1,0.0,0,1,0,1,7,0,0,1,0,2,8,1
3763,119775,Hvo87huFBpCunolEWjcvbDUcmX9h25rT,SpATywNh6bZuzm8s1ceuBUnMUAeoAHHw,27,26,15,9,8,0,3,0,61,8.714285714285714,1,0.0,6,15,9,8,20,0,0,3,0,38,23,1
3764,119777,6r9w9XrCXpAInFHxfDIxOD9m18cX5jcd,SpATywNh6bZuzm8s1ceuBUnMUAeoAHHw,9,9,1,0,1,0,3,0,14,2.0,1,0.0,0,1,0,1,9,0,0,3,0,2,12,1
3765,119783,XRCyFAenNfq06SRijoW2bL3eLeq7TTnH,SpATywNh6bZuzm8s1ceuBUnMUAeoAHHw,2,0,0,0,0,0,2,0,2,0.2857142857142857,1,0.0,0,0,0,0,0,0,0,2,0,0,2,1
3766,119789,s5PM22AMhoKbdj4BvXCXSb2DG7kHVY83,bWdj2GDclj5ofokWjzoa5jAwMkxCykd6,7,9,2,0,1,0,1,0,13,1.8571428571428572,1,0.0,0,2,0,1,9,0,0,1,0,3,10,1
3767,119801,jORRvCSUTQr1FHykD1dmWMVMdAoKMUmG,RXDvfPUBYFlVdlueBFbLW0mhhAyGEqpt,8,3,2,0,2,0,4,1,12,1.7142857142857142,1,0.0,0,2,0,2,3,0,0,4,1,4,8,1
3768,119802,pgn1580cn8cQemEJzrm47II2SqctZZrK,G8EPVSXsOYB5YQWZGiz1aVq5Pgr2GrQu,34,20,17,0,16,0,1,0,54,7.714285714285714,1,0.0,0,17,0,16,20,0,0,1,0,33,21,0
3769,119807,ABAPRQWSFErhHUFQsJmCoj4Rpg4DtQ8w,bWdj2GDclj5ofokWjzoa5jAwMkxCykd6,2,0,0,0,0,0,3,0,3,0.42857142857142855,1,0.0,0,0,0,0,0,0,0,3,0,0,3,1
3770,119833,DhGcyoTp73fKDVPL51XtXQlMqfdtfXVc,SpATywNh6bZuzm8s1ceuBUnMUAeoAHHw,6,3,2,0,2,0,1,0,8,1.1428571428571428,1,0.0,0,2,0,2,3,0,0,1,0,4,4,1
3771,119867,bCILkQHxUJub9H7cxxmSR5zqZAu3BvHB,SpATywNh6bZuzm8s1ceuBUnMUAeoAHHw,24,19,15,0,8,0,5,0,47,6.714285714285714,2,0.0,0,15,0,8,19,0,0,5,0,23,24,1
3772,119878,T7izEMyckZ14Dpb0HXCCbCEgRCtemG2v,A3fsA9Zfv1X2fVEQhTw51lKENdNrEqT3,4,3,0,0,0,0,2,0,5,0.7142857142857143,1,0.0,0,0,0,0,3,0,0,2,0,0,5,1
3773,119879,ClHMnOLy9vZKRtNjcA9yPWajeNvRCNdE,RXDvfPUBYFlVdlueBFbLW0mhhAyGEqpt,1,0,0,0,0,0,1,0,1,0.14285714285714285,1,0.0,0,0,0,0,0,0,0,1,0,0,1,1
3774,119888,pgB6pQ9DmcVMwAXk0gVwFSTwyA4alFe0,SpATywNh6bZuzm8s1ceuBUnMUAeoAHHw,7,4,3,0,0,1,5,0,13,1.8571428571428572,2,0.0,0,3,0,0,4,1,0,5,0,3,10,1
3775,119892,6PXcyDdGgas03jfN9GNBg7eDbTNLi58b,SpATywNh6bZuzm8s1ceuBUnMUAeoAHHw,5,3,1,0,1,1,3,0,9,1.2857142857142858,1,0.0,0,1,0,1,3,1,0,3,0,2,7,1
3776,119895,JAh5RXKrssqx6aZ2Y0OKL2tpBD86qsyv,SpATywNh6bZuzm8s1ceuBUnMUAeoAHHw,10,8,1,0,1,0,9,0,19,2.7142857142857144,1,0.0,0,1,0,1,8,0,0,9,0,2,17,1
3777,119896,c4MI9OfbyJ0RGX9j0ZiKqfaHb3fSOPCp,SpATywNh6bZuzm8s1ceuBUnMUAeoAHHw,4,5,0,0,0,0,2,0,7,1.0,1,0.0,0,0,0,0,5,0,0,2,0,0,7,1
3778,119905,alePu0FhXWTyAf3z1TbtScq1Obpgwyvj,SpATywNh6bZuzm8s1ceuBUnMUAeoAHHw,10,5,2,0,2,1,9,1,20,2.857142857142857,1,0.0,0,2,0,2,5,1,0,9,1,4,16,0
3779,119907,Tlrkgpa05toeVrZOHafHN5HVS3Ley7hG,A3fsA9Zfv1X2fVEQhTw51lKENdNrEqT3,49,33,23,46,13,1,10,1,127,18.142857142857142,2,0.0,6,23,46,13,27,1,0,10,1,88,39,1
3780,119923,nrDkIZH2wqEVh6i4pBxcbRBJIMc9s20b,SpATywNh6bZuzm8s1ceuBUnMUAeoAHHw,12,18,2,16,2,0,5,0,43,6.142857142857143,2,0.0,4,2,14,2,14,0,2,5,0,22,21,0
3781,119933,nHnSkTZVeRCsQFFRAJ2tasC3JodYcJAU,SpATywNh6bZuzm8s1ceuBUnMUAeoAHHw,14,25,11,0,8,0,3,0,47,6.714285714285714,1,0.0,0,11,0,8,25,0,0,3,0,19,28,1
3782,119935,4uCHoIviHPzCtwadirbZDGuLNqx4H5qx,SpATywNh6bZuzm8s1ceuBUnMUAeoAHHw,15,17,8,23,3,0,1,0,52,7.428571428571429,1,0.0,7,8,20,3,10,0,3,1,0,38,14,0
3783,119937,l70wRZ2DS0s6LjbT7C4gRoGrF27x9p2H,bWdj2GDclj5ofokWjzoa5jAwMkxCykd6,1,0,0,0,0,0,1,0,1,0.14285714285714285,1,0.0,0,0,0,0,0,0,0,1,0,0,1,1
3784,119938,hdh7f9dbamC5OLbnjQIw5ciTwmy2oqSe,A3fsA9Zfv1X2fVEQhTw51lKENdNrEqT3,9,5,4,0,3,0,1,0,13,1.8571428571428572,1,0.0,0,4,0,3,5,0,0,1,0,7,6,1
3785,119942,D9eQoamtTDpiMV0b0OdGca728kthGUV3,SpATywNh6bZuzm8s1ceuBUnMUAeoAHHw,6,4,0,4,0,0,2,0,10,1.4285714285714286,1,0.0,1,0,4,0,3,0,0,2,0,5,5,0
3786,119947,jnIQMhy9SQ2YnxY9vLXkaYJhqSTRkdV3,SpATywNh6bZuzm8s1ceuBUnMUAeoAHHw,10,9,7,0,5,0,2,0,23,3.2857142857142856,1,0.0,0,7,0,5,9,0,0,2,0,12,11,1
3787,119949,3dRJytFtMTBsljPJJKUMWZqWEGtFd6rm,SpATywNh6bZuzm8s1ceuBUnMUAeoAHHw,14,16,4,17,3,0,2,0,42,6.0,1,0.0,10,4,14,3,6,0,3,2,0,31,11,1
3788,119953,ixEbiSQCdFYvedCjd9ZSVhkHMvgSKaLG,SpATywNh6bZuzm8s1ceuBUnMUAeoAHHw,8,6,4,0,3,0,3,0,16,2.2857142857142856,2,0.0,0,4,0,3,6,0,0,3,0,7,9,1
3789,119958,lm0zg2eARlzCRkKcI4nbhfozsZEvEhl3,SpATywNh6bZuzm8s1ceuBUnMUAeoAHHw,11,8,1,12,0,0,2,0,23,3.2857142857142856,1,0.0,2,1,11,0,6,0,1,2,0,14,9,1
3790,119960,4TtGjmtd4ISORDD5okRgx7kXAcGUW8IN,RXDvfPUBYFlVdlueBFbLW0mhhAyGEqpt,1,0,0,0,0,0,1,0,1,0.14285714285714285,1,0.0,0,0,0,0,0,0,0,1,0,0,1,1
3791,119969,RpC8ahxzmHtiHrtEolXbAvhs5yymX13F,SpATywNh6bZuzm8s1ceuBUnMUAeoAHHw,5,4,3,0,2,0,2,0,11,1.5714285714285714,1,0.0,0,3,0,2,4,0,0,2,0,5,6,1
3792,119970,4kQU73UJCeVbdLolFE0fE9baW58Y34lz,SpATywNh6bZuzm8s1ceuBUnMUAeoAHHw,11,8,5,0,3,0,8,1,25,3.5714285714285716,1,0.0,0,5,0,3,8,0,0,8,1,8,17,1
3793,119973,0NGZq9HZW5KOrSfzSGGipuN20pCRDMWu,RXDvfPUBYFlVdlueBFbLW0mhhAyGEqpt,13,9,6,0,4,3,4,0,26,3.7142857142857144,1,0.0,0,6,0,4,9,3,0,4,0,10,16,0
3794,119974,VLq5RjmauxaFZfPnx2f9r9Dehjw868o9,SpATywNh6bZuzm8s1ceuBUnMUAeoAHHw,6,4,3,0,1,0,1,0,9,1.2857142857142858,1,0.0,0,3,0,1,4,0,0,1,0,4,5,0
3795,119983,8ZvgmVWPuU4xKWq9tw3YZdhhMDnHsFgT,SpATywNh6bZuzm8s1ceuBUnMUAeoAHHw,18,27,20,12,9,0,13,0,81,11.571428571428571,4,0.0,2,20,10,9,25,0,2,13,0,41,40,0
3796,119991,EjqS3A2Iv9J8JTjinbKy3gdtrrXaSQyJ,bWdj2GDclj5ofokWjzoa5jAwMkxCykd6,3,2,1,0,0,0,1,0,4,0.5714285714285714,1,0.0,0,1,0,0,2,0,0,1,0,1,3,1
3797,119994,O4934ANB2qMTFJBwUqvZeG7DbnQJCsce,SpATywNh6bZuzm8s1ceuBUnMUAeoAHHw,27,28,11,29,7,0,3,0,78,11.142857142857142,2,0.0,8,11,27,7,20,0,2,3,0,53,25,1
3798,120019,eC4QFVNRkDMJURDQ2ZX8Orvtuy3F8ILJ,SpATywNh6bZuzm8s1ceuBUnMUAeoAHHw,8,4,2,0,1,0,6,0,13,1.8571428571428572,1,0.0,0,2,0,1,4,0,0,6,0,3,10,1
3799,120021,xr2T8ak6swOOfU9oanYvPbQ4STab9s9f,bWdj2GDclj5ofokWjzoa5jAwMkxCykd6,9,21,1,0,2,0,3,0,27,3.857142857142857,1,0.0,6,1,0,2,15,0,0,3,0,9,18,1
3800,120022,npXfYqxF0TCNN5vliwdRJdFcBk0rmfXv,bWdj2GDclj5ofokWjzoa5jAwMkxCykd6,13,18,6,16,7,5,6,1,59,8.428571428571429,4,0.0,5,6,14,7,13,5,2,6,1,32,27,0
3801,120026,ZH0VWJ7XJWogjYH6Qq2Nr4TMh6fe5JGW,SpATywNh6bZuzm8s1ceuBUnMUAeoAHHw,14,30,3,6,0,0,4,0,43,6.142857142857143,3,0.0,0,3,6,0,30,0,0,4,0,9,34,0
3802,120052,2VfZF4h8v7eR70PfxTwoJImij1XH3cw0,SpATywNh6bZuzm8s1ceuBUnMUAeoAHHw,9,5,4,0,3,1,13,0,26,3.7142857142857144,1,0.0,0,4,0,3,5,1,0,13,0,7,19,1
3803,120053,WELjmgdsP962Pc1teJ96xvofKraKe6qa,RXDvfPUBYFlVdlueBFbLW0mhhAyGEqpt,6,5,3,0,1,9,2,0,20,2.857142857142857,1,0.0,0,3,0,1,5,9,0,2,0,4,16,1
3804,120056,fzsHY2LgfBXg8YsHOoWkwNUOqIdUaJDy,bWdj2GDclj5ofokWjzoa5jAwMkxCykd6,2,0,0,0,0,0,3,0,3,0.42857142857142855,1,0.0,0,0,0,0,0,0,0,3,0,0,3,1
3805,120069,md1Mf60Z4ySa4NKHKWMKq8Bxh8C0w3Ro,SpATywNh6bZuzm8s1ceuBUnMUAeoAHHw,10,12,6,0,2,4,7,0,31,4.428571428571429,2,0.0,2,6,0,2,10,4,0,7,0,10,21,1
3806,120070,JkGUdKB9J1ONvSF3GWx5guW4dzLf3fLB,RXDvfPUBYFlVdlueBFbLW0mhhAyGEqpt,6,4,3,0,1,0,2,0,10,1.4285714285714286,1,0.0,0,3,0,1,4,0,0,2,0,4,6,1
3807,120071,3n6ajKAkQu8rgtUnNpdWOfMF8VSNsMVs,G8EPVSXsOYB5YQWZGiz1aVq5Pgr2GrQu,6,5,3,0,0,0,3,0,11,1.5714285714285714,2,0.0,0,3,0,0,5,0,0,3,0,3,8,1
3808,120073,2VfZF4h8v7eR70PfxTwoJImij1XH3cw0,RXDvfPUBYFlVdlueBFbLW0mhhAyGEqpt,5,2,1,0,1,0,2,0,6,0.8571428571428571,1,0.0,0,1,0,1,2,0,0,2,0,2,4,1
3809,120075,OwDVM5C0ZIkYKCNBKi1eBMmRNb7I7ptI,bWdj2GDclj5ofokWjzoa5jAwMkxCykd6,2,0,0,0,0,0,5,0,5,0.7142857142857143,1,0.0,0,0,0,0,0,0,0,5,0,0,5,1
3810,120076,4YCZfbR5vSUmQm9JKU53CaLT4o7zzhD5,G8EPVSXsOYB5YQWZGiz1aVq5Pgr2GrQu,1,0,0,0,0,0,1,0,1,0.14285714285714285,1,0.0,0,0,0,0,0,0,0,1,0,0,1,1
3811,120078,saXRSf4MnhO78zgLoljZlslavqJjBtLm,bWdj2GDclj5ofokWjzoa5jAwMkxCykd6,8,7,1,0,1,0,9,0,18,2.5714285714285716,2,0.0,0,1,0,1,7,0,0,9,0,2,16,1
3812,120085,SozLQk8695JG7fvj1Enp26s5ACJQjjq5,RXDvfPUBYFlVdlueBFbLW0mhhAyGEqpt,1,0,0,0,0,0,1,0,1,0.14285714285714285,1,0.0,0,0,0,0,0,0,0,1,0,0,1,1
3813,120097,5pfeeYLWSB4wCSWnPZbrmiSBS3yXgMsk,bWdj2GDclj5ofokWjzoa5jAwMkxCykd6,3,2,0,0,0,0,2,0,4,0.5714285714285714,1,0.0,0,0,0,0,2,0,0,2,0,0,4,1
3814,120100,JdKnU2sktk6AZyjwyIqgEXYK8OtgPCn2,bWdj2GDclj5ofokWjzoa5jAwMkxCykd6,10,20,7,0,3,0,6,0,36,5.142857142857143,1,0.0,4,7,0,3,16,0,0,6,0,14,22,0
3815,120111,aGyzysUQgcpficWqTygk8rcuo677dPZU,SpATywNh6bZuzm8s1ceuBUnMUAeoAHHw,17,28,3,0,2,1,8,1,43,6.142857142857143,2,0.0,1,3,0,2,27,1,0,8,1,6,37,0
3816,120118,cPZ5ch8V46zptI5nnRGh9SfMnAQrVDUi,bWdj2GDclj5ofokWjzoa5jAwMkxCykd6,3,2,1,0,0,0,1,0,4,0.5714285714285714,1,0.0,0,1,0,0,2,0,0,1,0,1,3,0
3817,120124,Ga7iU5IP3f6oL4nXlygCBVszreMPGCt3,G8EPVSXsOYB5YQWZGiz1aVq5Pgr2GrQu,1,0,0,0,0,0,1,0,1,0.14285714285714285,1,0.0,0,0,0,0,0,0,0,1,0,0,1,1
3818,120126,c6XaDpje2iQSWpoXkTtf00BW6tACh6Q9,SpATywNh6bZuzm8s1ceuBUnMUAeoAHHw,20,19,10,12,6,5,6,1,59,8.428571428571429,1,0.0,3,10,12,6,16,5,0,6,1,31,28,0
3819,120129,nDUXGSBgQyo69KyzDsvsphUp6qKxv1Ib,SpATywNh6bZuzm8s1ceuBUnMUAeoAHHw,5,2,1,0,1,0,2,0,6,0.8571428571428571,1,0.0,0,1,0,1,2,0,0,2,0,2,4,1
3820,120134,nKMPTOF6v1sp7aVmO78zmSRg9f9QXrTf,A3fsA9Zfv1X2fVEQhTw51lKENdNrEqT3,40,19,16,45,12,1,1,0,94,13.428571428571429,1,0.0,1,16,42,12,18,1,3,1,0,71,23,1
3821,120142,Uxom3QvnZvmlcNVTXDTJG0YgMkZr2hhX,SpATywNh6bZuzm8s1ceuBUnMUAeoAHHw,7,3,2,0,2,0,2,0,9,1.2857142857142858,1,0.0,0,2,0,2,3,0,0,2,0,4,5,1
3822,120149,LY15AitabC9VNRy9N91XwsKL39G9Yhym,SpATywNh6bZuzm8s1ceuBUnMUAeoAHHw,11,10,7,0,2,0,1,0,20,2.857142857142857,1,0.0,0,7,0,2,10,0,0,1,0,9,11,1
3823,120153,la15uCtK5VeDQX41dystrGx2B895Oqjw,RXDvfPUBYFlVdlueBFbLW0mhhAyGEqpt,8,5,2,10,1,0,1,0,19,2.7142857142857144,1,0.0,1,2,10,1,4,0,0,1,0,14,5,1
3824,120158,durZRNVeZgKGbNDftJUmwBeNsWC0AnPo,SpATywNh6bZuzm8s1ceuBUnMUAeoAHHw,1,0,0,0,0,0,1,0,1,0.14285714285714285,1,0.0,0,0,0,0,0,0,0,1,0,0,1,1
3825,120170,80Av2RXrFoxNOdv7EQUM2TDOM0gyNH0J,bWdj2GDclj5ofokWjzoa5jAwMkxCykd6,4,2,1,0,1,0,2,0,6,0.8571428571428571,1,0.0,0,1,0,1,2,0,0,2,0,2,4,1
3826,120171,ThGblU6q4nWmu3ORXgM7eQc8q9vcBP4r,A3fsA9Zfv1X2fVEQhTw51lKENdNrEqT3,36,37,4,56,1,0,21,0,119,17.0,3,0.0,4,4,49,1,33,0,7,21,0,58,61,1
3827,120177,83cBV2IXkwoW1nUaa1kxaJ98L3bxFsPn,A3fsA9Zfv1X2fVEQhTw51lKENdNrEqT3,37,20,11,72,0,7,8,0,118,16.857142857142858,4,0.0,2,11,72,0,18,7,0,8,0,85,33,0
3828,120181,yBsDX1Dsw9hy8f2NuaeMfD0tvX413Igw,bWdj2GDclj5ofokWjzoa5jAwMkxCykd6,4,2,1,0,1,0,1,0,5,0.7142857142857143,1,0.0,0,1,0,1,2,0,0,1,0,2,3,0
3829,120194,Uylyq7LmmNSvSWdWZxt9uRF9NmGdfp0A,RXDvfPUBYFlVdlueBFbLW0mhhAyGEqpt,1,0,0,0,0,0,1,0,1,0.14285714285714285,1,0.0,0,0,0,0,0,0,0,1,0,0,1,1
3830,120196,qLscbApWydA7z1h7Ht7RN2UnF0mvGZpF,SpATywNh6bZuzm8s1ceuBUnMUAeoAHHw,8,11,0,5,0,0,3,0,19,2.7142857142857144,1,0.0,2,0,4,0,9,0,1,3,0,6,13,1
3831,120219,Yp8yvTzeMvocSqLvL15ovVwipej5zHiT,SpATywNh6bZuzm8s1ceuBUnMUAeoAHHw,1,0,0,0,0,0,1,0,1,0.14285714285714285,1,0.0,0,0,0,0,0,0,0,1,0,0,1,1
3832,120228,zVgOUCulbNx05te9mrJWZeO6VJGrw5WO,G8EPVSXsOYB5YQWZGiz1aVq5Pgr2GrQu,14,19,10,8,1,0,9,0,47,6.714285714285714,2,0.0,3,10,5,1,16,0,3,9,0,19,28,1
3833,120230,LY15AitabC9VNRy9N91XwsKL39G9Yhym,G8EPVSXsOYB5YQWZGiz1aVq5Pgr2GrQu,13,10,6,0,6,0,2,0,24,3.4285714285714284,2,0.0,2,6,0,6,8,0,0,2,0,14,10,1
3834,120234,1Rj37m2TWBRQIZjAlVjTge1bBoqghnB2,bWdj2GDclj5ofokWjzoa5jAwMkxCykd6,6,0,0,0,0,1,6,1,8,1.1428571428571428,1,0.0,0,0,0,0,0,1,0,6,1,0,8,1
3835,120251,qY3mO9VSgbSXrTZIckLWUEq4U741QpCT,SpATywNh6bZuzm8s1ceuBUnMUAeoAHHw,8,7,4,6,0,2,6,0,25,3.5714285714285716,1,0.0,2,4,5,0,5,2,1,6,0,11,14,0
3836,120255,3nXqsLutTeQFNz1Ya8GTFnWUmV4VnYmX,SpATywNh6bZuzm8s1ceuBUnMUAeoAHHw,6,4,0,0,0,0,2,0,6,0.8571428571428571,1,0.0,0,0,0,0,4,0,0,2,0,0,6,1
3837,120262,x2vyDUpFuVAQOVEKoczKBtYvi1pP4Hfq,SpATywNh6bZuzm8s1ceuBUnMUAeoAHHw,1,0,0,0,0,0,1,0,1,0.14285714285714285,1,0.0,0,0,0,0,0,0,0,1,0,0,1,1
3838,120263,farPAnvPmsSrd5ovHg0tlsOgoAj5LoAg,SpATywNh6bZuzm8s1ceuBUnMUAeoAHHw,4,2,1,0,1,0,1,0,5,0.7142857142857143,1,0.0,0,1,0,1,2,0,0,1,0,2,3,1
3839,120270,oh70wjHZNiJm6YMEO2zTeIrDQMUiqmDd,A3fsA9Zfv1X2fVEQhTw51lKENdNrEqT3,6,5,1,0,1,0,1,0,8,1.1428571428571428,1,0.0,0,1,0,1,5,0,0,1,0,2,6,1
3840,120279,1cxiENcEp3mVuj0hieZU2n66DvVX0lKj,bWdj2GDclj5ofokWjzoa5jAwMkxCykd6,1,0,0,0,0,0,1,0,1,0.14285714285714285,1,0.0,0,0,0,0,0,0,0,1,0,0,1,1
3841,120296,WnLVBva4oiF8muizYYbe8GP2LesbDaQA,SpATywNh6bZuzm8s1ceuBUnMUAeoAHHw,9,4,3,0,3,0,2,0,12,1.7142857142857142,1,0.0,0,3,0,3,4,0,0,2,0,6,6,1
3842,120318,Z01b5ZH1XnM8VywoaG2LGeoRdMPqFc6F,SpATywNh6bZuzm8s1ceuBUnMUAeoAHHw,9,9,4,0,3,0,7,1,24,3.4285714285714284,1,0.0,5,4,0,3,4,0,0,7,1,12,12,1
3843,120337,KDeaSgZ6wTHm30JcQgLQFVdVYbxH0KHc,SpATywNh6bZuzm8s1ceuBUnMUAeoAHHw,5,6,2,0,0,0,2,0,10,1.4285714285714286,2,0.0,0,2,0,0,6,0,0,2,0,2,8,1
3844,120345,DsvMkutBFtLefRL1hsHU5bFQpdJBtlsH,SpATywNh6bZuzm8s1ceuBUnMUAeoAHHw,14,11,1,11,1,0,2,0,26,3.7142857142857144,1,0.0,2,1,9,1,9,0,2,2,0,13,13,1
3845,120365,aXiJW8ayzWdjAFuCXJZEkZEM0lQLoZYD,bWdj2GDclj5ofokWjzoa5jAwMkxCykd6,1,0,0,0,0,0,1,0,1,0.14285714285714285,1,0.0,0,0,0,0,0,0,0,1,0,0,1,1
3846,120369,Z0j9vlmYA8vddl2WEYwRJJAGu9WTMzZU,SpATywNh6bZuzm8s1ceuBUnMUAeoAHHw,6,3,2,0,2,0,1,0,8,1.1428571428571428,1,0.0,0,2,0,2,3,0,0,1,0,4,4,1
3847,120374,ePOpOKycvORTPdc6DfieYb44dd8ej3gR,SpATywNh6bZuzm8s1ceuBUnMUAeoAHHw,8,7,6,0,6,0,1,0,20,2.857142857142857,1,0.0,0,6,0,6,7,0,0,1,0,12,8,1
3848,120390,snoVfOu7m3uQyb0rtN2hVEbVR2VoIt0E,SpATywNh6bZuzm8s1ceuBUnMUAeoAHHw,1,0,0,0,0,0,1,0,1,0.14285714285714285,1,0.0,0,0,0,0,0,0,0,1,0,0,1,1
3849,120399,tQgPfoIxEUrRTpkUJ12lc7yYMouZEU13,SpATywNh6bZuzm8s1ceuBUnMUAeoAHHw,5,6,2,0,2,0,2,0,12,1.7142857142857142,1,0.0,0,2,0,2,6,0,0,2,0,4,8,1
3850,120400,STgJR8QT5S3NDhZTGanzgxzj1oLmNnCR,SpATywNh6bZuzm8s1ceuBUnMUAeoAHHw,19,10,8,0,7,3,6,0,34,4.857142857142857,1,0.0,0,8,0,7,10,3,0,6,0,15,19,1
3851,120406,7Tzl2OTGekrrZ1AXSNaODNbj4vnVdNB2,G8EPVSXsOYB5YQWZGiz1aVq5Pgr2GrQu,18,30,3,20,4,0,5,0,62,8.857142857142858,2,0.0,13,3,11,4,17,0,9,5,0,31,31,0
3852,120415,lk6sSo2mEoREiTaQjIlY6dKahZkFRKmP,bWdj2GDclj5ofokWjzoa5jAwMkxCykd6,4,1,1,0,0,0,2,0,4,0.5714285714285714,1,0.0,0,1,0,0,1,0,0,2,0,1,3,1
3853,120416,vQlqRATWFUYVohKNm8Qpw3XkVdJ2DmuJ,SpATywNh6bZuzm8s1ceuBUnMUAeoAHHw,14,18,0,17,0,0,1,0,36,5.142857142857143,1,0.0,7,0,14,0,11,0,3,1,0,21,15,1
3854,120417,DHUv7XpIZcPp2QYGNmTXjhgg7Zq4BpJ7,G8EPVSXsOYB5YQWZGiz1aVq5Pgr2GrQu,4,2,1,0,1,0,1,0,5,0.7142857142857143,1,0.0,0,1,0,1,2,0,0,1,0,2,3,1
3855,120421,ouTwCUFDa5PRzaHQSaChM41Y1q02nIPV,SpATywNh6bZuzm8s1ceuBUnMUAeoAHHw,12,9,1,0,1,0,8,1,20,2.857142857142857,1,0.0,0,1,0,1,9,0,0,8,1,2,18,1
3856,120425,uEDnklEhnnZbnvzJYYw9brmjh3D3gkF9,SpATywNh6bZuzm8s1ceuBUnMUAeoAHHw,1,0,0,0,0,0,1,0,1,0.14285714285714285,1,0.0,0,0,0,0,0,0,0,1,0,0,1,1
3857,120435,OifsLGRBGBgFFNsSrNDnK5W8Vbn9qLGX,SpATywNh6bZuzm8s1ceuBUnMUAeoAHHw,8,8,0,0,0,0,0,0,8,1.1428571428571428,2,0.0,0,0,0,0,8,0,0,0,0,0,8,1
3858,120437,do3bUhF7O0txAhPkHUppSnV3jZUZ9sqF,SpATywNh6bZuzm8s1ceuBUnMUAeoAHHw,5,2,1,0,1,0,2,0,6,0.8571428571428571,1,0.0,0,1,0,1,2,0,0,2,0,2,4,1
3859,120457,1La5rp9ZSz9cfpqCRJiC01Rwvuq5VVrf,SpATywNh6bZuzm8s1ceuBUnMUAeoAHHw,11,9,4,12,1,0,2,0,28,4.0,1,0.0,4,4,12,1,5,0,0,2,0,21,7,0
3860,120460,5MOHfgPntZIsRWkQebauzpUgUSaHvhFJ,bWdj2GDclj5ofokWjzoa5jAwMkxCykd6,4,5,3,0,0,0,3,0,11,1.5714285714285714,2,0.0,0,3,0,0,5,0,0,3,0,3,8,1
3861,120471,I6qoCcohBrCkqxmkans73ezft5aIvcN6,SpATywNh6bZuzm8s1ceuBUnMUAeoAHHw,5,4,2,0,1,0,1,0,8,1.1428571428571428,1,0.0,0,2,0,1,4,0,0,1,0,3,5,1
3862,120480,GJdrQdNnhszyte4F0GpLkVjDN5SstsoH,SpATywNh6bZuzm8s1ceuBUnMUAeoAHHw,21,46,9,20,8,1,7,1,92,13.142857142857142,3,0.0,4,9,18,8,42,1,2,7,1,39,53,0
3863,120489,MgS6WK9esRya9QyP2ZOjbNdLSIL7NuM9,bWdj2GDclj5ofokWjzoa5jAwMkxCykd6,12,15,10,2,2,0,1,0,30,4.285714285714286,1,0.0,4,10,2,2,11,0,0,1,0,18,12,0
3864,120505,QZQvnzqgk3ZJQavig3cFuZehXC8CHrPm,bWdj2GDclj5ofokWjzoa5jAwMkxCykd6,7,2,2,0,2,0,2,0,8,1.1428571428571428,1,0.0,0,2,0,2,2,0,0,2,0,4,4,1
3865,120524,MgS6WK9esRya9QyP2ZOjbNdLSIL7NuM9,RXDvfPUBYFlVdlueBFbLW0mhhAyGEqpt,7,7,4,0,1,0,2,0,14,2.0,2,0.0,0,4,0,1,7,0,0,2,0,5,9,1
3866,120531,Fkd43qYCuPn5hi79UziIpsXZru3xZf0R,SpATywNh6bZuzm8s1ceuBUnMUAeoAHHw,4,2,1,0,1,0,1,0,5,0.7142857142857143,1,0.0,0,1,0,1,2,0,0,1,0,2,3,1
3867,120538,kJkXo4nSNqbMETrXDpi6P9tfSt1mYjrM,SpATywNh6bZuzm8s1ceuBUnMUAeoAHHw,11,19,7,0,3,0,6,0,35,5.0,2,0.0,0,7,0,3,19,0,0,6,0,10,25,1
3868,120540,U0zx3N1uSd1t4oNG6aeia4oGy5qrTYII,SpATywNh6bZuzm8s1ceuBUnMUAeoAHHw,14,12,7,9,3,0,1,0,32,4.571428571428571,1,0.0,4,7,9,3,8,0,0,1,0,23,9,1
3869,120547,6T4qq3cdISFF5pyvVKMrcmEINY6BysCY,A3fsA9Zfv1X2fVEQhTw51lKENdNrEqT3,44,18,8,134,0,30,6,2,198,28.285714285714285,3,0.0,7,8,117,0,11,30,17,6,2,132,66,0
3870,120550,SiUZQJJjUWzItu4TetvbGbgpJYIYKjWr,SpATywNh6bZuzm8s1ceuBUnMUAeoAHHw,4,2,1,0,1,0,1,0,5,0.7142857142857143,1,0.0,0,1,0,1,2,0,0,1,0,2,3,1
3871,120554,33YJhO56Hz6X3YkBaXAE8jLXj3hGQz0E,RXDvfPUBYFlVdlueBFbLW0mhhAyGEqpt,4,2,1,0,1,0,1,0,5,0.7142857142857143,1,0.0,0,1,0,1,2,0,0,1,0,2,3,1
3872,120559,4YCZfbR5vSUmQm9JKU53CaLT4o7zzhD5,SpATywNh6bZuzm8s1ceuBUnMUAeoAHHw,1,0,0,0,0,0,2,0,2,0.2857142857142857,1,0.0,0,0,0,0,0,0,0,2,0,0,2,1
3873,120567,VL7NPBJuyzF1uV3nhlsl7JEimjvq8BIB,SpATywNh6bZuzm8s1ceuBUnMUAeoAHHw,20,77,48,6,23,2,11,0,167,23.857142857142858,3,0.0,7,48,6,23,70,2,0,11,0,84,83,0
3874,120570,EIpkB0c46fQRf924Hrf1SRiPLyg6N4rm,RXDvfPUBYFlVdlueBFbLW0mhhAyGEqpt,6,3,1,0,1,2,2,0,9,1.2857142857142858,1,0.0,0,1,0,1,3,2,0,2,0,2,7,1
3875,120571,ZcwgBhx2C5CsYaUWf4YQ2u1SWzTYaxss,A3fsA9Zfv1X2fVEQhTw51lKENdNrEqT3,9,5,4,0,3,0,1,0,13,1.8571428571428572,1,0.0,0,4,0,3,5,0,0,1,0,7,6,0
3876,120576,WIgM6nvV9YFBo82xFhtQp6923xmcbs69,SpATywNh6bZuzm8s1ceuBUnMUAeoAHHw,16,22,11,12,0,0,4,0,49,7.0,2,0.0,9,11,12,0,13,0,0,4,0,32,17,0
3877,120580,tepLda5wSKMdrl1YSxQ7o9ErmWSmjLIs,SpATywNh6bZuzm8s1ceuBUnMUAeoAHHw,25,46,30,19,4,29,21,0,149,21.285714285714285,3,0.0,9,30,18,4,37,29,1,21,0,61,88,0
3878,120581,lggvGpvA9S46sPyt7OTjASGRNtpXIFQL,SpATywNh6bZuzm8s1ceuBUnMUAeoAHHw,1,0,0,0,0,0,1,0,1,0.14285714285714285,1,0.0,0,0,0,0,0,0,0,1,0,0,1,1
3879,120592,eS2KrqTdusBuI6pcIMw5VPgc4bcyJ1eG,bWdj2GDclj5ofokWjzoa5jAwMkxCykd6,2,0,0,0,0,0,2,0,2,0.2857142857142857,1,0.0,0,0,0,0,0,0,0,2,0,0,2,1
3880,120599,yhSGXw7EnYX7J3WWxRb9piBAfJaOtRLJ,SpATywNh6bZuzm8s1ceuBUnMUAeoAHHw,1,0,0,0,0,0,1,0,1,0.14285714285714285,1,0.0,0,0,0,0,0,0,0,1,0,0,1,1
3881,120621,7rzvmKtANOU8M4posmrNW445K28DcImr,SpATywNh6bZuzm8s1ceuBUnMUAeoAHHw,2,0,0,0,0,0,2,0,2,0.2857142857142857,1,0.0,0,0,0,0,0,0,0,2,0,0,2,0
3882,120628,T84tM0SY1NeTwy8ZOUv1K7SYM12l3y0u,SpATywNh6bZuzm8s1ceuBUnMUAeoAHHw,14,15,8,0,5,14,9,2,53,7.571428571428571,3,0.0,3,8,0,5,12,14,0,9,2,16,37,1
3883,120633,IU1lGseLxckCGwI4nmuh7Ca5kBungyEP,SpATywNh6bZuzm8s1ceuBUnMUAeoAHHw,14,35,2,25,2,0,2,0,66,9.428571428571429,1,0.0,17,2,21,2,18,0,4,2,0,42,24,1
3884,120647,RrUICdqzzS6uEuuuo42x7DWjiBSOVyuw,RXDvfPUBYFlVdlueBFbLW0mhhAyGEqpt,11,7,6,0,2,2,4,0,21,3.0,1,0.0,0,6,0,2,7,2,0,4,0,8,13,1
3885,120650,AqOYZE1KwO9ElxY4ESIL8wZt1KCX4QiQ,SpATywNh6bZuzm8s1ceuBUnMUAeoAHHw,16,19,9,13,5,0,3,0,49,7.0,1,0.0,3,9,13,5,16,0,0,3,0,30,19,0
3886,120654,8eYQfp27L4KqSIcQS2lfdmoY7VEE1qFC,RXDvfPUBYFlVdlueBFbLW0mhhAyGEqpt,6,5,0,0,0,0,5,0,10,1.4285714285714286,1,0.0,0,0,0,0,5,0,0,5,0,0,10,1
3887,120685,dWpBguIfALUazWbTuRqWRbI4Z6RC5ZA1,SpATywNh6bZuzm8s1ceuBUnMUAeoAHHw,12,5,2,0,2,3,16,2,30,4.285714285714286,1,0.0,0,2,0,2,5,3,0,16,2,4,26,1
3888,120692,yPANNiQQMnN6yMtp5OhnGyYLdZrKDZ9V,RXDvfPUBYFlVdlueBFbLW0mhhAyGEqpt,9,4,3,0,2,0,3,0,12,1.7142857142857142,1,0.0,0,3,0,2,4,0,0,3,0,5,7,1
3889,120707,YBlpuOz29CjjHYq0RuGLiSzLtjKLdYy2,RXDvfPUBYFlVdlueBFbLW0mhhAyGEqpt,2,0,0,0,0,0,4,0,4,0.5714285714285714,2,0.0,0,0,0,0,0,0,0,4,0,0,4,0
3890,120715,ucFGb4sKO6LhsbUaWhFjc3yaUOdGfmQa,RXDvfPUBYFlVdlueBFbLW0mhhAyGEqpt,7,2,2,0,2,0,2,0,8,1.1428571428571428,1,0.0,0,2,0,2,2,0,0,2,0,4,4,1
3891,120724,s4dtgJUQtJkEKTGiW6rNu8EDXRkyQStr,bWdj2GDclj5ofokWjzoa5jAwMkxCykd6,1,0,0,0,0,0,1,0,1,0.14285714285714285,1,0.0,0,0,0,0,0,0,0,1,0,0,1,1
3892,120736,niznzPsNcmf0qkvKVIABVzsBAFOWmMfr,SpATywNh6bZuzm8s1ceuBUnMUAeoAHHw,20,21,1,8,1,1,7,1,40,5.714285714285714,1,0.0,2,1,8,1,19,1,0,7,1,12,28,1
3893,120743,es5GTyNQHE6XqsHqRasxkSTkn6q7y8k2,SpATywNh6bZuzm8s1ceuBUnMUAeoAHHw,18,21,12,11,4,3,4,0,55,7.857142857142857,3,0.0,5,12,9,4,16,3,2,4,0,30,25,0
3894,120744,dvGlk7sqlRtsNklrx9jTekm5CnQWuhDQ,SpATywNh6bZuzm8s1ceuBUnMUAeoAHHw,9,5,4,0,3,0,1,0,13,1.8571428571428572,1,0.0,0,4,0,3,5,0,0,1,0,7,6,1
3895,120755,PQyLGsdBWhEy27jacipkmntLAvcsGeQa,SpATywNh6bZuzm8s1ceuBUnMUAeoAHHw,28,22,12,30,8,4,7,0,83,11.857142857142858,2,0.0,9,12,25,8,13,4,5,7,0,54,29,0
3896,120768,lu6LWsHgfburMRdWsFabIR2bIQ3MFD6f,RXDvfPUBYFlVdlueBFbLW0mhhAyGEqpt,17,10,9,0,6,0,5,0,30,4.285714285714286,2,0.0,0,9,0,6,10,0,0,5,0,15,15,0
3897,120769,9ejhHF65VDeA89TY7yPYCEx8qdV4K69n,A3fsA9Zfv1X2fVEQhTw51lKENdNrEqT3,28,17,11,28,9,0,2,0,67,9.571428571428571,1,0.0,1,11,24,9,16,0,4,2,0,45,22,1
3898,120773,uiXIZg9P7E1egIRj5Sno619DS7IwlQY9,SpATywNh6bZuzm8s1ceuBUnMUAeoAHHw,1,0,0,0,0,0,1,0,1,0.14285714285714285,1,0.0,0,0,0,0,0,0,0,1,0,0,1,1
3899,120776,9ejhHF65VDeA89TY7yPYCEx8qdV4K69n,bWdj2GDclj5ofokWjzoa5jAwMkxCykd6,1,0,0,0,0,0,2,0,2,0.2857142857142857,1,0.0,0,0,0,0,0,0,0,2,0,0,2,1
3900,120785,Axaz2TU9iWJqggZ8S9ZVW7y3xhVfFBfg,SpATywNh6bZuzm8s1ceuBUnMUAeoAHHw,9,4,3,0,1,7,6,1,22,3.142857142857143,1,0.0,0,3,0,1,4,7,0,6,1,4,18,1
3901,120787,JBH4PfoUtr8SFyt6u3u3ciODwm9LbhKT,SpATywNh6bZuzm8s1ceuBUnMUAeoAHHw,8,2,1,0,1,0,5,1,10,1.4285714285714286,1,0.0,0,1,0,1,2,0,0,5,1,2,8,1
3902,120792,vSEsL1qLMsR8cNJOX6mMDcN6nVaHqWNR,bWdj2GDclj5ofokWjzoa5jAwMkxCykd6,1,0,0,0,0,0,1,0,1,0.14285714285714285,1,0.0,0,0,0,0,0,0,0,1,0,0,1,1
3903,120800,7bnGjPq4sg9VhmEEoEqqXHNgeEpEuUDV,bWdj2GDclj5ofokWjzoa5jAwMkxCykd6,7,5,3,0,1,9,3,1,22,3.142857142857143,1,0.0,0,3,0,1,5,9,0,3,1,4,18,0
3904,120807,KHl8vTLwoQOTsjJg2pVXTnG0Is0a8K1K,SpATywNh6bZuzm8s1ceuBUnMUAeoAHHw,5,2,1,0,1,0,2,1,7,1.0,1,0.0,0,1,0,1,2,0,0,2,1,2,5,1
3905,120809,bWtnIrdbQPafPqPLZtocbxJYk8IfZ76X,SpATywNh6bZuzm8s1ceuBUnMUAeoAHHw,7,3,2,0,2,0,2,0,9,1.2857142857142858,1,0.0,0,2,0,2,3,0,0,2,0,4,5,1
3906,120825,tQAgy689j7VgAO7nbWHE1fj0JJjMUDvF,SpATywNh6bZuzm8s1ceuBUnMUAeoAHHw,4,2,0,0,0,0,2,0,4,0.5714285714285714,1,0.0,0,0,0,0,2,0,0,2,0,0,4,1
3907,120827,tCQ9JALurTpI0v0jgUfmOoOzw21YvN4S,RXDvfPUBYFlVdlueBFbLW0mhhAyGEqpt,10,4,3,0,1,2,6,1,17,2.4285714285714284,1,0.0,0,3,0,1,4,2,0,6,1,4,13,1
3908,120831,JLn36xalC1eIUd4jm6gux9oEgx3gpDxA,SpATywNh6bZuzm8s1ceuBUnMUAeoAHHw,15,24,0,17,0,0,5,0,46,6.571428571428571,2,0.0,6,0,15,0,18,0,2,5,0,21,25,1
3909,120833,72z519PMt8GGBXLvF1FG0oMJuciCSWYJ,SpATywNh6bZuzm8s1ceuBUnMUAeoAHHw,5,4,1,0,0,0,4,0,9,1.2857142857142858,3,0.0,0,1,0,0,4,0,0,4,0,1,8,1
3910,120844,JjOxJWvSLO4lglPA5ATD8doF5KAfdZlo,G8EPVSXsOYB5YQWZGiz1aVq5Pgr2GrQu,1,0,0,0,0,0,1,0,1,0.14285714285714285,1,0.0,0,0,0,0,0,0,0,1,0,0,1,1
3911,120846,UkERsue63b46ZbS092pGmdIWYcMFC2bg,SpATywNh6bZuzm8s1ceuBUnMUAeoAHHw,7,7,1,0,0,0,4,0,12,1.7142857142857142,2,0.0,0,1,0,0,7,0,0,4,0,1,11,1
3912,120852,EPmLjBxeWpwhjwoRgtmLV8RkhFOu2zzj,G8EPVSXsOYB5YQWZGiz1aVq5Pgr2GrQu,1,0,0,0,0,0,1,0,1,0.14285714285714285,1,0.0,0,0,0,0,0,0,0,1,0,0,1,1
3913,120874,c7JueNv3hDicP8Z6SVI5VQqnBM3V6CD4,SpATywNh6bZuzm8s1ceuBUnMUAeoAHHw,8,7,3,0,2,2,15,3,32,4.571428571428571,1,0.0,0,3,0,2,7,2,0,15,3,5,27,1
3914,120878,edVuZXQuYE4LHUfAzzB1uGhpYsPr0vJx,SpATywNh6bZuzm8s1ceuBUnMUAeoAHHw,20,14,7,19,4,2,8,1,55,7.857142857142857,2,0.0,2,7,16,4,12,2,3,8,1,29,26,0
3915,120881,Ow20UOjVruC0CURQijQixRuf9scGhyUK,G8EPVSXsOYB5YQWZGiz1aVq5Pgr2GrQu,5,2,2,0,2,0,3,0,9,1.2857142857142858,2,0.0,0,2,0,2,2,0,0,3,0,4,5,1
3916,120893,xb9WJcv3uIYBfZD9WqegvIpYdxaUF3h5,bWdj2GDclj5ofokWjzoa5jAwMkxCykd6,7,5,4,0,3,0,1,0,13,1.8571428571428572,1,0.0,0,4,0,3,5,0,0,1,0,7,6,1
3917,120904,kFp6IoufrvIevAVHehiSDqUBNzpbkI6L,bWdj2GDclj5ofokWjzoa5jAwMkxCykd6,18,25,13,6,6,2,8,1,61,8.714285714285714,4,0.0,4,13,6,6,21,2,0,8,1,29,32,0
3918,120919,DahdU3m64q9GHbzMvs6TdHVFTDo4asbt,SpATywNh6bZuzm8s1ceuBUnMUAeoAHHw,3,0,0,0,0,0,5,0,5,0.7142857142857143,3,0.0,0,0,0,0,0,0,0,5,0,0,5,1
3919,120924,ocmyq6MXRULfgpYdGM8QGfWnP2Queprt,SpATywNh6bZuzm8s1ceuBUnMUAeoAHHw,28,48,28,15,15,0,19,4,129,18.428571428571427,4,0.0,5,28,15,15,43,0,0,19,4,63,66,1
3920,120927,4bcOXBC1lhgwF9Pg3IMx9vJFVwNtFyik,SpATywNh6bZuzm8s1ceuBUnMUAeoAHHw,10,27,0,0,0,0,10,0,37,5.285714285714286,3,0.0,0,0,0,0,27,0,0,10,0,0,37,1
3921,120936,i0ksX07HnsV5rQlWqOr1uKEuc7yNU24c,A3fsA9Zfv1X2fVEQhTw51lKENdNrEqT3,16,18,12,0,3,19,10,0,62,8.857142857142858,2,0.0,0,12,0,3,18,19,0,10,0,15,47,0
3922,120940,KkBPwixR7onoXlZ2HnK8cYokgUE3P396,bWdj2GDclj5ofokWjzoa5jAwMkxCykd6,3,2,0,0,0,0,1,0,3,0.42857142857142855,1,0.0,0,0,0,0,2,0,0,1,0,0,3,1
3923,120948,TevGcL3mCy823FJCU3MpLHqDSnMlx8KC,SpATywNh6bZuzm8s1ceuBUnMUAeoAHHw,28,19,13,29,8,0,3,0,72,10.285714285714286,2,0.0,4,13,22,8,15,0,7,3,0,47,25,0
3924,120953,HGkuwdB1J817cl9wl529SZa2OTu14HFB,SpATywNh6bZuzm8s1ceuBUnMUAeoAHHw,20,15,8,15,4,8,9,1,60,8.571428571428571,1,0.0,4,8,13,4,11,8,2,9,1,29,31,0
3925,120964,JCDOEMgsanA2Wd8RJtg9ctpT52Gae7ak,SpATywNh6bZuzm8s1ceuBUnMUAeoAHHw,1,0,0,0,0,0,1,0,1,0.14285714285714285,1,0.0,0,0,0,0,0,0,0,1,0,0,1,1
3926,120967,nToY9YbKok17BpaPlTxZF9mLZdFu0iiS,G8EPVSXsOYB5YQWZGiz1aVq5Pgr2GrQu,17,19,12,0,9,0,6,0,46,6.571428571428571,3,0.0,3,12,0,9,16,0,0,6,0,24,22,1
3927,120969,hNYqJEuS1AXT481SIEkT37fZObOmjXuX,G8EPVSXsOYB5YQWZGiz1aVq5Pgr2GrQu,6,4,2,0,1,0,4,0,11,1.5714285714285714,1,0.0,0,2,0,1,4,0,0,4,0,3,8,1
3928,120983,Tg9kFmEr6KGEyzeoopWvQ3WCSPhx01lk,SpATywNh6bZuzm8s1ceuBUnMUAeoAHHw,19,19,12,10,5,1,7,1,55,7.857142857142857,2,0.0,3,12,10,5,16,1,0,7,1,30,25,1
3929,120986,OcU9jyzQQ3iLPmO8KqVEvCwQSxQdBoZu,SpATywNh6bZuzm8s1ceuBUnMUAeoAHHw,11,15,7,0,5,1,10,1,39,5.571428571428571,2,0.0,4,7,0,5,11,1,0,10,1,16,23,1
3930,120998,y7Z8jSjEija2cXP8zDhgGRVfac5fnMAR,SpATywNh6bZuzm8s1ceuBUnMUAeoAHHw,8,10,0,2,0,0,1,0,13,1.8571428571428572,2,0.0,1,0,2,0,9,0,0,1,0,3,10,1
3931,121001,k2w7Fl2HRg9SZoDIHFnK8RXCKuBBE2y7,A3fsA9Zfv1X2fVEQhTw51lKENdNrEqT3,23,15,8,40,4,1,1,0,69,9.857142857142858,1,0.0,1,8,34,4,14,1,6,1,0,47,22,1
3932,121014,5sovUdBY4AsVUtXY7BWDVXxvHAPsWkZb,A3fsA9Zfv1X2fVEQhTw51lKENdNrEqT3,9,5,4,0,3,0,1,0,13,1.8571428571428572,1,0.0,0,4,0,3,5,0,0,1,0,7,6,1
3933,121017,iW5zRjJuIjvxlxhDULlodfhsU8gFYbbs,SpATywNh6bZuzm8s1ceuBUnMUAeoAHHw,8,7,6,0,0,0,2,0,15,2.142857142857143,1,0.0,0,6,0,0,7,0,0,2,0,6,9,1
3934,121039,QaKdVtbgjSMpkDFYeFcsaL5O2NEtGRQz,SpATywNh6bZuzm8s1ceuBUnMUAeoAHHw,1,0,0,0,0,0,1,0,1,0.14285714285714285,1,0.0,0,0,0,0,0,0,0,1,0,0,1,1
3935,121053,npZiJYBXIvuULdTyVSfZOjhsnEdX6i82,SpATywNh6bZuzm8s1ceuBUnMUAeoAHHw,30,37,18,37,8,0,5,0,105,15.0,2,0.0,15,18,31,8,22,0,6,5,0,72,33,0
3936,121085,hWWjbjEJOX0Ph07p1EJp8Ya48hU8wP5v,SpATywNh6bZuzm8s1ceuBUnMUAeoAHHw,21,35,17,17,9,0,6,0,84,12.0,1,0.0,9,17,16,9,26,0,1,6,0,51,33,0
3937,121096,ZtA9pLb0sfgqk6iLVTJtOHVhh3oHeQLC,SpATywNh6bZuzm8s1ceuBUnMUAeoAHHw,5,2,0,0,0,0,3,0,5,0.7142857142857143,1,0.0,0,0,0,0,2,0,0,3,0,0,5,1
3938,121099,cHpOktJabOMVpsE04dze5ePRZnN7bWdJ,A3fsA9Zfv1X2fVEQhTw51lKENdNrEqT3,14,8,6,0,5,0,3,0,22,3.142857142857143,2,0.0,0,6,0,5,8,0,0,3,0,11,11,1
3939,121101,34fQh4AyuAWML6hByTmQJCsftdAFH2Hu,SpATywNh6bZuzm8s1ceuBUnMUAeoAHHw,6,9,7,0,0,0,2,0,18,2.5714285714285716,1,0.0,0,7,0,0,9,0,0,2,0,7,11,1
3940,121118,vTTrcE2RlYlajsEul9ylLY6DUQNcdNgN,SpATywNh6bZuzm8s1ceuBUnMUAeoAHHw,7,6,4,0,2,0,2,0,14,2.0,2,0.0,0,4,0,2,6,0,0,2,0,6,8,1
3941,121122,GlVmjWGZ8XsOuLGdZvtzRw0xzELGNzxx,bWdj2GDclj5ofokWjzoa5jAwMkxCykd6,2,4,2,0,0,0,0,0,6,0.8571428571428571,2,0.0,0,2,0,0,4,0,0,0,0,2,4,1
3942,121137,5uUrNOrq1vz8XtHDv1LWcBc27EEqbO5u,SpATywNh6bZuzm8s1ceuBUnMUAeoAHHw,17,34,3,17,1,0,5,0,60,8.571428571428571,3,0.0,2,3,16,1,32,0,1,5,0,22,38,1
3943,121140,QAb8PmUj3McyQuaW6daHNk0NhlxSWKuO,SpATywNh6bZuzm8s1ceuBUnMUAeoAHHw,1,0,0,0,0,0,2,0,2,0.2857142857142857,2,0.0,0,0,0,0,0,0,0,2,0,0,2,1
3944,121141,YhSlQp6TZH2sVWIgjyn2YxpekmOBzjQt,SpATywNh6bZuzm8s1ceuBUnMUAeoAHHw,19,15,11,10,5,0,6,0,47,6.714285714285714,2,0.0,2,11,10,5,13,0,0,6,0,28,19,0
3945,121142,xlx6h4vTU14b0zR9O9NKqKPZoDtNmECc,A3fsA9Zfv1X2fVEQhTw51lKENdNrEqT3,10,8,4,0,2,0,3,0,17,2.4285714285714284,1,0.0,2,4,0,2,6,0,0,3,0,8,9,1
3946,121143,rik0F1mWVOeGz53BJ3pfmg90EeuTpONo,bWdj2GDclj5ofokWjzoa5jAwMkxCykd6,5,5,1,0,1,0,2,0,9,1.2857142857142858,1,0.0,0,1,0,1,5,0,0,2,0,2,7,1
3947,121145,atoEVjauO8UqqxbDs90qm3bNJMwCLIt0,SpATywNh6bZuzm8s1ceuBUnMUAeoAHHw,5,2,1,0,1,0,2,0,6,0.8571428571428571,1,0.0,0,1,0,1,2,0,0,2,0,2,4,0
3948,121156,ZPtKMZp2cxlBd5CcEcoCaraY1yoC22cg,SpATywNh6bZuzm8s1ceuBUnMUAeoAHHw,30,21,14,44,8,1,7,0,95,13.571428571428571,2,0.0,4,14,38,8,17,1,6,7,0,64,31,0
3949,121161,Yl3fWDphM6Ifhmu0NrJgclA0dIl02Kms,A3fsA9Zfv1X2fVEQhTw51lKENdNrEqT3,10,5,3,0,2,0,4,0,14,2.0,1,0.0,1,3,0,2,4,0,0,4,0,6,8,1
3950,121165,Sp3nYt5ii7nPRoxqEiVcKwwIa973Pnnr,A3fsA9Zfv1X2fVEQhTw51lKENdNrEqT3,29,11,6,64,2,0,4,0,87,12.428571428571429,2,0.0,4,6,54,2,7,0,10,4,0,66,21,1
3951,121169,WJs2oS3DHmzLGumW31DTiDLH77aXdb4Z,G8EPVSXsOYB5YQWZGiz1aVq5Pgr2GrQu,1,0,0,0,0,0,1,0,1,0.14285714285714285,1,0.0,0,0,0,0,0,0,0,1,0,0,1,1
3952,121171,w81M8LsxqroaoVvhuOiOu12ogu2TTrVp,SpATywNh6bZuzm8s1ceuBUnMUAeoAHHw,8,8,2,0,3,0,3,0,16,2.2857142857142856,2,0.0,0,2,0,3,8,0,0,3,0,5,11,1
3953,121172,J7iejq5NtsfdHjPTK3MrPhGPRoJN9WrB,bWdj2GDclj5ofokWjzoa5jAwMkxCykd6,1,0,0,0,0,0,1,0,1,0.14285714285714285,1,0.0,0,0,0,0,0,0,0,1,0,0,1,1
3954,121195,rrD2k9raPTugWiiZJjKTcEpxfKzXPOoh,A3fsA9Zfv1X2fVEQhTw51lKENdNrEqT3,5,2,1,0,1,0,2,0,6,0.8571428571428571,1,0.0,0,1,0,1,2,0,0,2,0,2,4,1
3955,121200,xyoj4G3pVqlUCzQtS2iNDV55nyPLJkyp,A3fsA9Zfv1X2fVEQhTw51lKENdNrEqT3,8,5,4,0,4,0,1,0,14,2.0,1,0.0,0,4,0,4,5,0,0,1,0,8,6,1
3956,121201,osRqgZRzeeCEid1eYNHbUWEZePoVbqKO,SpATywNh6bZuzm8s1ceuBUnMUAeoAHHw,6,3,1,0,1,0,2,0,7,1.0,1,0.0,0,1,0,1,3,0,0,2,0,2,5,1
3957,121205,irUhnQtLaQWO9Ilnw5LLg2nfVwuwwh1f,SpATywNh6bZuzm8s1ceuBUnMUAeoAHHw,2,2,0,0,0,0,1,0,3,0.42857142857142855,1,0.0,0,0,0,0,2,0,0,1,0,0,3,1
3958,121225,6lL0tobxamv6kkGYMIOtqqnjmWQC4apa,A3fsA9Zfv1X2fVEQhTw51lKENdNrEqT3,71,30,23,138,16,3,8,1,219,31.285714285714285,2,0.0,2,23,123,16,28,3,15,8,1,164,55,1
3959,121226,RdjpcuNJHcq9iKd6LdCp1m7jbwau68ud,SpATywNh6bZuzm8s1ceuBUnMUAeoAHHw,2,0,0,0,0,1,2,0,3,0.42857142857142855,1,0.0,0,0,0,0,0,1,0,2,0,0,3,1
3960,121232,lojhMqQRO46DZsZEpJYUmk4ki07ZAOFG,SpATywNh6bZuzm8s1ceuBUnMUAeoAHHw,1,0,0,0,0,0,1,0,1,0.14285714285714285,1,0.0,0,0,0,0,0,0,0,1,0,0,1,1
3961,121261,YPxQmDfYnmHgiT7CBa1xK3KUyMZAnQfd,A3fsA9Zfv1X2fVEQhTw51lKENdNrEqT3,8,4,3,0,2,0,2,0,11,1.5714285714285714,1,0.0,0,3,0,2,4,0,0,2,0,5,6,1
3962,121269,OifsLGRBGBgFFNsSrNDnK5W8Vbn9qLGX,A3fsA9Zfv1X2fVEQhTw51lKENdNrEqT3,2,2,0,0,0,0,0,0,2,0.2857142857142857,1,0.0,0,0,0,0,2,0,0,0,0,0,2,1
3963,121279,iSSrSd8vVxBC2JC6ajviRFDfdtqLCuym,A3fsA9Zfv1X2fVEQhTw51lKENdNrEqT3,1,0,0,0,0,0,1,0,1,0.14285714285714285,1,0.0,0,0,0,0,0,0,0,1,0,0,1,1
3964,121286,go4j7bRhXINgA1WuC2lRA0Hee8dTMRV5,SpATywNh6bZuzm8s1ceuBUnMUAeoAHHw,8,6,4,0,2,0,6,0,18,2.5714285714285716,2,0.0,0,4,0,2,6,0,0,6,0,6,12,1
3965,121292,b4JhdDZuiMoCYMffFqg7ALO9K4ZBVn12,A3fsA9Zfv1X2fVEQhTw51lKENdNrEqT3,31,29,23,0,15,1,14,0,82,11.714285714285714,2,0.0,0,23,0,15,29,1,0,14,0,38,44,1
3966,121298,ONVx5VkCTs6D7RWJGi0oaLbXvf1yyHqy,bWdj2GDclj5ofokWjzoa5jAwMkxCykd6,1,0,0,0,0,0,1,0,1,0.14285714285714285,1,0.0,0,0,0,0,0,0,0,1,0,0,1,1
3967,121308,vFTyJ5TiVtOMNTDle7WFtHDAgvur1Shs,SpATywNh6bZuzm8s1ceuBUnMUAeoAHHw,7,4,3,0,3,0,2,0,12,1.7142857142857142,1,0.0,0,3,0,3,4,0,0,2,0,6,6,1
3968,121315,20miIbW6puYcFBNRUpHWBfGdgoL7IsKl,A3fsA9Zfv1X2fVEQhTw51lKENdNrEqT3,2,0,0,0,0,0,3,0,3,0.42857142857142855,1,0.0,0,0,0,0,0,0,0,3,0,0,3,1
3969,121316,AOiSjL4Nis9M3s1AhiMS89hfMIvo6CLU,SpATywNh6bZuzm8s1ceuBUnMUAeoAHHw,1,0,0,0,0,0,1,0,1,0.14285714285714285,1,0.0,0,0,0,0,0,0,0,1,0,0,1,1
3970,121325,togvLGeHHJalLzAy7gb7bMJngLXYGAjs,bWdj2GDclj5ofokWjzoa5jAwMkxCykd6,6,2,1,0,1,0,3,0,7,1.0,1,0.0,0,1,0,1,2,0,0,3,0,2,5,1
3971,121327,togvLGeHHJalLzAy7gb7bMJngLXYGAjs,A3fsA9Zfv1X2fVEQhTw51lKENdNrEqT3,2,0,0,0,0,0,2,0,2,0.2857142857142857,1,0.0,0,0,0,0,0,0,0,2,0,0,2,1
3972,121329,zJaHqs5kxeHEJuK4mQU1DIdrSDzLOTmW,bWdj2GDclj5ofokWjzoa5jAwMkxCykd6,1,0,0,0,0,0,1,0,1,0.14285714285714285,1,0.0,0,0,0,0,0,0,0,1,0,0,1,1
3973,121334,X9tesPfVRQu9R7pVopuvpFNecLnZt8Km,SpATywNh6bZuzm8s1ceuBUnMUAeoAHHw,16,15,11,0,5,0,8,0,39,5.571428571428571,3,0.0,0,11,0,5,15,0,0,8,0,16,23,1
3974,121335,rcQSbcF05AQYvzQJmDOGu4MfsQVuu05l,SpATywNh6bZuzm8s1ceuBUnMUAeoAHHw,29,27,16,33,7,2,6,1,92,13.142857142857142,2,0.0,8,16,29,7,19,2,4,6,1,60,32,0
3975,121350,OaR2omePx63fXdBiAV1sA954f6IcbIvq,A3fsA9Zfv1X2fVEQhTw51lKENdNrEqT3,20,19,13,18,7,0,13,0,70,10.0,3,0.0,2,13,18,7,17,0,0,13,0,40,30,0
3976,121354,EIHhmYlRU23gD32AsZHHvSXzjtFCo0yL,SpATywNh6bZuzm8s1ceuBUnMUAeoAHHw,12,16,1,14,0,2,3,0,36,5.142857142857143,2,0.0,3,1,12,0,13,2,2,3,0,16,20,1
3977,121375,JwzCuKRnJiCboJiRTMovpzJhdCfcNETm,A3fsA9Zfv1X2fVEQhTw51lKENdNrEqT3,12,14,1,0,2,0,1,0,18,2.5714285714285716,1,0.0,0,1,0,2,14,0,0,1,0,3,15,1
3978,121382,Kgm7zLW8p8Jc9BDI12KiHyoMRqlC0TXl,SpATywNh6bZuzm8s1ceuBUnMUAeoAHHw,1,0,0,0,0,0,1,0,1,0.14285714285714285,1,0.0,0,0,0,0,0,0,0,1,0,0,1,1
3979,121383,7af3IyECXIPSWoeM4guaEGHMHNE9EYdr,SpATywNh6bZuzm8s1ceuBUnMUAeoAHHw,1,0,0,0,0,0,1,0,1,0.14285714285714285,1,0.0,0,0,0,0,0,0,0,1,0,0,1,1
3980,121385,3pMXqJaEYEy2mxtFTggtjQ8mcRHGvdLr,SpATywNh6bZuzm8s1ceuBUnMUAeoAHHw,5,4,3,0,0,0,2,0,9,1.2857142857142858,2,0.0,0,3,0,0,4,0,0,2,0,3,6,1
3981,121390,3jWLQZ2XpNpB2H4UFvKRCVfzgbIsEanY,A3fsA9Zfv1X2fVEQhTw51lKENdNrEqT3,1,0,0,0,0,0,1,0,1,0.14285714285714285,1,0.0,0,0,0,0,0,0,0,1,0,0,1,1
3982,121395,Xn0msswMya4DdeH7Dc0xTOd0ODvYwWM7,SpATywNh6bZuzm8s1ceuBUnMUAeoAHHw,1,0,0,0,0,0,1,0,1,0.14285714285714285,1,0.0,0,0,0,0,0,0,0,1,0,0,1,1
3983,121400,BMjIPGqtYoLatxXDEHrhiIMt72Ckp0Wf,SpATywNh6bZuzm8s1ceuBUnMUAeoAHHw,5,8,3,0,0,0,2,0,13,1.8571428571428572,1,0.0,0,3,0,0,8,0,0,2,0,3,10,1
3984,121403,Uf8FY0gZoVytp6K7SsDRXVZeOCL2hDEX,bWdj2GDclj5ofokWjzoa5jAwMkxCykd6,11,7,5,0,2,6,10,1,31,4.428571428571429,1,0.0,0,5,0,2,7,6,0,10,1,7,24,1
3985,121409,vi8rW5hK5fGcrIxB8UA7uUUfvDXFcBEr,SpATywNh6bZuzm8s1ceuBUnMUAeoAHHw,6,3,2,0,2,0,1,0,8,1.1428571428571428,1,0.0,0,2,0,2,3,0,0,1,0,4,4,1
3986,121411,VytsQ5XFduK8xsP7edRPe1GY948fNELc,SpATywNh6bZuzm8s1ceuBUnMUAeoAHHw,1,0,0,0,0,0,1,0,1,0.14285714285714285,1,0.0,0,0,0,0,0,0,0,1,0,0,1,1
3987,121418,HSjT6fK4xHlufEG141acXPeMw5gqxgnK,RXDvfPUBYFlVdlueBFbLW0mhhAyGEqpt,1,0,0,0,0,0,1,0,1,0.14285714285714285,1,0.0,0,0,0,0,0,0,0,1,0,0,1,1
3988,121419,I6qGclNEImKeNJdvIwY5PrrMknw1zeQu,SpATywNh6bZuzm8s1ceuBUnMUAeoAHHw,18,21,12,11,4,0,5,0,53,7.571428571428571,1,0.0,4,12,10,4,17,0,1,5,0,30,23,0
3989,121430,wmNYHs69T6CHydhCxfzhydbjA79LMuTD,A3fsA9Zfv1X2fVEQhTw51lKENdNrEqT3,5,3,2,0,1,0,2,0,8,1.1428571428571428,1,0.0,0,2,0,1,3,0,0,2,0,3,5,1
3990,121432,SZ5q3TqDiWq8s23sHXWpsG5po2IH5JPk,A3fsA9Zfv1X2fVEQhTw51lKENdNrEqT3,42,18,12,64,10,0,5,0,109,15.571428571428571,1,0.0,4,12,58,10,14,0,6,5,0,84,25,1
3991,121448,TdEOLyaFODrUztdbfcJuA9ZwFd0i4XD2,SpATywNh6bZuzm8s1ceuBUnMUAeoAHHw,4,3,2,0,0,0,1,0,6,0.8571428571428571,1,0.0,0,2,0,0,3,0,0,1,0,2,4,1
3992,121457,ZBXcY1yn7nPU5Nfb3hlu4PDRbw4uvT17,bWdj2GDclj5ofokWjzoa5jAwMkxCykd6,5,2,1,0,1,0,2,0,6,0.8571428571428571,1,0.0,0,1,0,1,2,0,0,2,0,2,4,1
3993,121491,YydaZKjlAxGfDjMV5cfCRvsT4mycBKZj,SpATywNh6bZuzm8s1ceuBUnMUAeoAHHw,2,0,0,0,0,0,2,0,2,0.2857142857142857,1,0.0,0,0,0,0,0,0,0,2,0,0,2,1
3994,121499,4pJSh8LpNyCkIEyBWC74bNGXhEuDFen1,A3fsA9Zfv1X2fVEQhTw51lKENdNrEqT3,7,3,2,0,2,0,2,0,9,1.2857142857142858,1,0.0,0,2,0,2,3,0,0,2,0,4,5,1
3995,121506,8MuDfPMTQjGdTGCwKyaBRuguRPTmkIOy,SpATywNh6bZuzm8s1ceuBUnMUAeoAHHw,1,0,0,0,0,0,1,0,1,0.14285714285714285,1,0.0,0,0,0,0,0,0,0,1,0,0,1,1
3996,121507,gt5tqcVggdqz1dxVZeHDF843i5ITQdCe,SpATywNh6bZuzm8s1ceuBUnMUAeoAHHw,4,0,0,0,0,0,8,0,8,1.1428571428571428,1,0.0,0,0,0,0,0,0,0,8,0,0,8,1
3997,121533,H4AuaeZGDkkLMPXUAyZX0i8XXk2BDNyk,G8EPVSXsOYB5YQWZGiz1aVq5Pgr2GrQu,6,6,4,0,2,0,1,0,13,1.8571428571428572,1,0.0,0,4,0,2,6,0,0,1,0,6,7,1
3998,121556,D2GfCnbuT86TYful9fFSzT7T5yZ1f04f,A3fsA9Zfv1X2fVEQhTw51lKENdNrEqT3,34,22,15,30,13,0,6,0,86,12.285714285714286,2,0.0,5,15,26,13,17,0,4,6,0,59,27,1
3999,121558,YPFriT4OfareXOz7G4xpBUwlcCA03JlS,SpATywNh6bZuzm8s1ceuBUnMUAeoAHHw,15,15,13,0,10,0,2,0,40,5.714285714285714,1,0.0,0,13,0,10,15,0,0,2,0,23,17,1
4000,121569,4fggBiTulBMhqyvK9Klo3I0joX8sXLqR,RXDvfPUBYFlVdlueBFbLW0mhhAyGEqpt,7,6,3,0,1,0,3,1,14,2.0,2,0.0,0,3,0,1,6,0,0,3,1,4,10,1
4001,121571,LhjMbgeFB1ZSL6HIgJEVDb0SZxar7EsN,A3fsA9Zfv1X2fVEQhTw51lKENdNrEqT3,1,0,0,0,0,0,1,0,1,0.14285714285714285,1,0.0,0,0,0,0,0,0,0,1,0,0,1,1
4002,121573,kj5o7wMZl1s4q0cggcmipnm7O7L6g4Ps,G8EPVSXsOYB5YQWZGiz1aVq5Pgr2GrQu,1,0,0,0,0,0,1,0,1,0.14285714285714285,1,0.0,0,0,0,0,0,0,0,1,0,0,1,1
4003,121590,9iGaqBGS5kkoXjLd87hUL2eIJMVUVKfU,RXDvfPUBYFlVdlueBFbLW0mhhAyGEqpt,9,15,8,0,0,0,4,0,27,3.857142857142857,3,0.0,0,8,0,0,15,0,0,4,0,8,19,1
4004,121598,CtUi7t368xVR51EojyElWFRq57eG1Gx1,bWdj2GDclj5ofokWjzoa5jAwMkxCykd6,6,2,1,0,1,0,3,1,8,1.1428571428571428,1,0.0,0,1,0,1,2,0,0,3,1,2,6,1
4005,121606,qbhlqWnlMqLEJtHv0AQDrobM0lY6ZQwu,SpATywNh6bZuzm8s1ceuBUnMUAeoAHHw,1,0,0,0,0,0,1,0,1,0.14285714285714285,1,0.0,0,0,0,0,0,0,0,1,0,0,1,1
4006,121611,bDlowck7PoswtmYozGMoa41g1GVEejKh,RXDvfPUBYFlVdlueBFbLW0mhhAyGEqpt,25,31,21,22,14,0,8,0,96,13.714285714285714,2,0.0,6,21,21,14,25,0,1,8,0,62,34,0
4007,121619,JfftjOGdDbpgbrupi0Gwr899R0jzXikJ,A3fsA9Zfv1X2fVEQhTw51lKENdNrEqT3,7,7,5,0,2,0,3,0,17,2.4285714285714284,2,0.0,0,5,0,2,7,0,0,3,0,7,10,1
4008,121641,ThGblU6q4nWmu3ORXgM7eQc8q9vcBP4r,G8EPVSXsOYB5YQWZGiz1aVq5Pgr2GrQu,2,0,0,0,0,0,5,0,5,0.7142857142857143,1,0.0,0,0,0,0,0,0,0,5,0,0,5,1
4009,121643,ZULomXsITwM6vNxcJN8imzU1pyfKn8Cw,bWdj2GDclj5ofokWjzoa5jAwMkxCykd6,4,2,1,0,1,0,1,0,5,0.7142857142857143,1,0.0,0,1,0,1,2,0,0,1,0,2,3,1
4010,121648,jXl4Q6TFlYw71Bn9dguW333wEk83ysVq,SpATywNh6bZuzm8s1ceuBUnMUAeoAHHw,12,35,0,18,0,1,7,0,61,8.714285714285714,2,0.0,12,0,13,0,23,1,5,7,0,25,36,1
4011,121655,h0mYz4sCKBTfszMtgSo44TDhg1SbrdKo,SpATywNh6bZuzm8s1ceuBUnMUAeoAHHw,1,0,0,0,0,0,1,0,1,0.14285714285714285,1,0.0,0,0,0,0,0,0,0,1,0,0,1,1
4012,121662,5HXdL6OatNrhiY174KvxQUp0tpTJ3ory,SpATywNh6bZuzm8s1ceuBUnMUAeoAHHw,12,16,0,8,0,0,5,0,29,4.142857142857143,2,0.0,5,0,7,0,11,0,1,5,0,12,17,0
4013,121671,aCa6UD5e0XT0F0IHI4OQnRXRULZbtISA,SpATywNh6bZuzm8s1ceuBUnMUAeoAHHw,6,2,1,0,1,0,3,0,7,1.0,1,0.0,0,1,0,1,2,0,0,3,0,2,5,1
4014,121698,4QwjE5TQhZzqrIrmgTxr1bYCO2SVUQg8,SpATywNh6bZuzm8s1ceuBUnMUAeoAHHw,5,2,1,0,1,0,2,0,6,0.8571428571428571,1,0.0,0,1,0,1,2,0,0,2,0,2,4,1
4015,121707,4Mn2tC0xP3jJpRjJYgW6V342Z3uScDbd,A3fsA9Zfv1X2fVEQhTw51lKENdNrEqT3,6,3,1,0,1,0,3,0,8,1.1428571428571428,1,0.0,0,1,0,1,3,0,0,3,0,2,6,1
4016,121708,UBz29jsG8rR9fxGJ07ON7jTRlCVHOAv0,A3fsA9Zfv1X2fVEQhTw51lKENdNrEqT3,11,6,4,0,4,0,1,0,15,2.142857142857143,1,0.0,0,4,0,4,6,0,0,1,0,8,7,0
4017,121722,u92r3WC1YEXgmCIXMjFGJYvXTQBxOYhd,SpATywNh6bZuzm8s1ceuBUnMUAeoAHHw,13,11,4,17,3,0,2,0,37,5.285714285714286,1,0.0,6,4,16,3,5,0,1,2,0,29,8,1
4018,121729,ZrDgEyfoUHLa5uf0N0ml9T9xO22FqwKE,SpATywNh6bZuzm8s1ceuBUnMUAeoAHHw,10,15,1,6,0,0,6,0,28,4.0,2,0.0,9,1,6,0,6,0,0,6,0,16,12,0
4019,121734,x6OLIz4hMM0ByyN6TmY57kyFyEddmJ4M,A3fsA9Zfv1X2fVEQhTw51lKENdNrEqT3,6,9,4,0,0,0,4,0,17,2.4285714285714284,2,0.0,0,4,0,0,9,0,0,4,0,4,13,1
4020,121761,x6OLIz4hMM0ByyN6TmY57kyFyEddmJ4M,bWdj2GDclj5ofokWjzoa5jAwMkxCykd6,21,30,11,64,11,1,8,1,126,18.0,2,0.0,11,11,58,11,19,1,6,8,1,91,35,1
4021,121765,v4KRIvW2fm59UFurmYoSZsK2mZZrmnsA,bWdj2GDclj5ofokWjzoa5jAwMkxCykd6,9,6,3,0,1,10,11,2,33,4.714285714285714,3,0.0,0,3,0,1,6,10,0,11,2,4,29,1
4022,121767,v4KRIvW2fm59UFurmYoSZsK2mZZrmnsA,A3fsA9Zfv1X2fVEQhTw51lKENdNrEqT3,6,3,2,0,2,0,1,0,8,1.1428571428571428,1,0.0,0,2,0,2,3,0,0,1,0,4,4,1
4023,121775,jqFdSJ7Rp5LdpTT9xaXcYyPDgZuP8K28,SpATywNh6bZuzm8s1ceuBUnMUAeoAHHw,8,6,1,0,1,0,3,0,11,1.5714285714285714,1,0.0,0,1,0,1,6,0,0,3,0,2,9,1
4024,121787,x4Txzgd0OUi5yqi55NtM21eJpZWiZeEW,A3fsA9Zfv1X2fVEQhTw51lKENdNrEqT3,12,20,2,0,2,0,6,0,30,4.285714285714286,2,0.0,0,2,0,2,20,0,0,6,0,4,26,1
4025,121807,FAflDmZ5UbfFzu5Y3WrugBr3CXMWVehE,bWdj2GDclj5ofokWjzoa5jAwMkxCykd6,1,0,0,0,0,0,1,0,1,0.14285714285714285,1,0.0,0,0,0,0,0,0,0,1,0,0,1,1
4026,121808,QhQuu2NMHYcgj0YP3onmnea8Jv814Mc8,SpATywNh6bZuzm8s1ceuBUnMUAeoAHHw,4,3,1,0,1,0,1,0,6,0.8571428571428571,1,0.0,0,1,0,1,3,0,0,1,0,2,4,1
4027,121817,qZUSZi93i2Ee9CUC34HmFgFywQL2ImeW,SpATywNh6bZuzm8s1ceuBUnMUAeoAHHw,19,44,3,0,3,0,15,1,66,9.428571428571429,1,0.0,3,3,0,3,41,0,0,15,1,9,57,1
4028,121819,PmBLjK8JCE0PzpkrJAjhhCm5nVqtWEV1,A3fsA9Zfv1X2fVEQhTw51lKENdNrEqT3,1,0,0,0,0,0,1,0,1,0.14285714285714285,1,0.0,0,0,0,0,0,0,0,1,0,0,1,1
4029,121821,qsqfA7OOnk8HnDIdBoWsK3JLpkRs9fc7,A3fsA9Zfv1X2fVEQhTw51lKENdNrEqT3,1,0,0,0,0,0,1,0,1,0.14285714285714285,1,0.0,0,0,0,0,0,0,0,1,0,0,1,1
4030,121831,SiH274DFlaeNzsDPV8qquK4qRpZHyEyM,SpATywNh6bZuzm8s1ceuBUnMUAeoAHHw,30,28,18,22,8,8,8,0,92,13.142857142857142,2,0.0,6,18,19,8,22,8,3,8,0,51,41,1
4031,121832,smSHdwJ1UOXCOwbwU1gE5ygVGM1XcWJI,SpATywNh6bZuzm8s1ceuBUnMUAeoAHHw,10,6,3,0,2,0,4,2,17,2.4285714285714284,1,0.0,0,3,0,2,6,0,0,4,2,5,12,1
4032,121833,QhQuu2NMHYcgj0YP3onmnea8Jv814Mc8,G8EPVSXsOYB5YQWZGiz1aVq5Pgr2GrQu,5,3,1,0,1,0,3,0,8,1.1428571428571428,1,0.0,0,1,0,1,3,0,0,3,0,2,6,1
4033,121840,A3FGIvcpmP9UeVzECTe66iC9lFbKmHRb,RXDvfPUBYFlVdlueBFbLW0mhhAyGEqpt,21,29,16,50,6,35,13,31,180,25.714285714285715,4,0.0,5,16,41,6,24,35,9,13,31,68,112,0
4034,121845,k6ujPs3A9T0AUvcnn4NYjtPRZDclle8p,SpATywNh6bZuzm8s1ceuBUnMUAeoAHHw,1,0,0,0,0,0,1,0,1,0.14285714285714285,1,0.0,0,0,0,0,0,0,0,1,0,0,1,1
4035,121846,986WgoFI0AZSDPIvWwBI8MUZveW4E4Xu,SpATywNh6bZuzm8s1ceuBUnMUAeoAHHw,1,0,0,0,0,0,1,0,1,0.14285714285714285,1,0.0,0,0,0,0,0,0,0,1,0,0,1,1
4036,121853,6kheVQ9HoYcmvRy4m74n5u7AB6nlCIYR,SpATywNh6bZuzm8s1ceuBUnMUAeoAHHw,7,3,2,0,2,0,2,0,9,1.2857142857142858,1,0.0,0,2,0,2,3,0,0,2,0,4,5,1
4037,121859,IcRuYze0CzOpE4oHF70ukHAkSTPB9bCH,SpATywNh6bZuzm8s1ceuBUnMUAeoAHHw,16,27,2,14,0,10,8,1,62,8.857142857142858,4,0.0,8,2,13,0,19,10,1,8,1,23,39,1
4038,121873,nHMoTKw6ss0dSnBzmsq0keGpHH2NjvR7,SpATywNh6bZuzm8s1ceuBUnMUAeoAHHw,15,20,7,24,4,0,5,1,61,8.714285714285714,3,0.0,7,7,21,4,13,0,3,5,1,39,22,1
4039,121889,PhJ8qm8JsHCEW9dAikvHznDiB4SDMYD6,A3fsA9Zfv1X2fVEQhTw51lKENdNrEqT3,6,3,2,0,2,0,1,0,8,1.1428571428571428,1,0.0,0,2,0,2,3,0,0,1,0,4,4,1
4040,121891,lyKWlQXSsOSx9dJ1ME8N6mLGOkZhDx56,SpATywNh6bZuzm8s1ceuBUnMUAeoAHHw,3,2,1,0,0,0,1,0,4,0.5714285714285714,1,0.0,0,1,0,0,2,0,0,1,0,1,3,1
4041,121893,Q8D1GMU9DUO6Nj6ySx5rrvLwl2bu2DGZ,SpATywNh6bZuzm8s1ceuBUnMUAeoAHHw,20,35,17,14,6,23,6,0,101,14.428571428571429,3,0.0,10,17,13,6,25,23,1,6,0,46,55,0
4042,121896,IDVV2jtBUYHXvZRwUeupKpLFwBDZmMvi,bWdj2GDclj5ofokWjzoa5jAwMkxCykd6,8,2,2,0,2,0,5,0,11,1.5714285714285714,1,0.0,0,2,0,2,2,0,0,5,0,4,7,1
4043,121903,x2eztv69vavhwR6qv43AthcyQwI14YNr,SpATywNh6bZuzm8s1ceuBUnMUAeoAHHw,6,4,3,0,1,0,1,0,9,1.2857142857142858,1,0.0,0,3,0,1,4,0,0,1,0,4,5,0
4044,121906,DPTAQ5lGsvjESrb4v1mwHpMaZuqLNytl,SpATywNh6bZuzm8s1ceuBUnMUAeoAHHw,26,31,3,22,1,4,9,1,71,10.142857142857142,3,0.0,9,3,17,1,22,4,5,9,1,30,41,0
4045,121937,Ks3akoPw8lV1qZsYDHC2B3y9yzMeHmnf,SpATywNh6bZuzm8s1ceuBUnMUAeoAHHw,1,0,0,0,0,0,2,0,2,0.2857142857142857,1,0.0,0,0,0,0,0,0,0,2,0,0,2,1
4046,121952,x98jQugu3yASfETi9tV0JU7AQJM0sBk6,A3fsA9Zfv1X2fVEQhTw51lKENdNrEqT3,1,0,0,0,0,0,1,0,1,0.14285714285714285,1,0.0,0,0,0,0,0,0,0,1,0,0,1,1
4047,121961,oW9L7CxP0sDxYCxol70CUfkBpdozjWLb,SpATywNh6bZuzm8s1ceuBUnMUAeoAHHw,1,0,0,0,0,0,1,0,1,0.14285714285714285,1,0.0,0,0,0,0,0,0,0,1,0,0,1,0
4048,121984,XGd8OaVZcFiceiXpuPYWv2tDLfwrfQG1,SpATywNh6bZuzm8s1ceuBUnMUAeoAHHw,4,4,2,0,2,0,1,0,9,1.2857142857142858,1,0.0,0,2,0,2,4,0,0,1,0,4,5,1
4049,122008,C7BxnTntfGXjkSosgH12xJ8S1pNqiUlY,SpATywNh6bZuzm8s1ceuBUnMUAeoAHHw,5,1,1,0,1,0,2,0,5,0.7142857142857143,1,0.0,0,1,0,1,1,0,0,2,0,2,3,1
4050,122009,DPTAQ5lGsvjESrb4v1mwHpMaZuqLNytl,G8EPVSXsOYB5YQWZGiz1aVq5Pgr2GrQu,1,0,0,0,0,0,1,0,1,0.14285714285714285,1,0.0,0,0,0,0,0,0,0,1,0,0,1,1
4051,122011,rwCHpAN1sY0GvFYG7zQQk2qpgkOBz9O3,SpATywNh6bZuzm8s1ceuBUnMUAeoAHHw,5,2,1,0,0,2,4,0,9,1.2857142857142858,1,0.0,0,1,0,0,2,2,0,4,0,1,8,1
4052,122031,CfiZ4fswch8CYfHMLc9SAlgLprJRdAVO,SpATywNh6bZuzm8s1ceuBUnMUAeoAHHw,15,16,8,0,16,0,5,0,45,6.428571428571429,2,0.0,0,8,0,16,16,0,0,5,0,24,21,1
4053,122035,PFXaSbylT2XRWmnFTzI7TT06KKEcrU02,G8EPVSXsOYB5YQWZGiz1aVq5Pgr2GrQu,1,0,0,0,0,0,1,0,1,0.14285714285714285,1,0.0,0,0,0,0,0,0,0,1,0,0,1,1
4054,122049,IDVV2jtBUYHXvZRwUeupKpLFwBDZmMvi,A3fsA9Zfv1X2fVEQhTw51lKENdNrEqT3,10,5,5,0,5,0,5,0,20,2.857142857142857,1,0.0,0,5,0,5,5,0,0,5,0,10,10,1
4055,122055,cgc8DGkd3Jwqn7jWLS8pFiVfUMBb7Shb,bWdj2GDclj5ofokWjzoa5jAwMkxCykd6,7,11,0,0,2,0,3,0,16,2.2857142857142856,1,0.0,7,0,0,2,4,0,0,3,0,9,7,1
4056,122060,Cyazs2KNzeLH7rwO0YD9wLQWGHR2SXrB,SpATywNh6bZuzm8s1ceuBUnMUAeoAHHw,3,2,1,0,0,0,1,0,4,0.5714285714285714,1,0.0,0,1,0,0,2,0,0,1,0,1,3,1
4057,122062,Cyazs2KNzeLH7rwO0YD9wLQWGHR2SXrB,A3fsA9Zfv1X2fVEQhTw51lKENdNrEqT3,3,2,1,0,0,0,1,0,4,0.5714285714285714,1,0.0,0,1,0,0,2,0,0,1,0,1,3,1
4058,122063,Cyazs2KNzeLH7rwO0YD9wLQWGHR2SXrB,bWdj2GDclj5ofokWjzoa5jAwMkxCykd6,3,2,1,0,0,0,1,0,4,0.5714285714285714,1,0.0,0,1,0,0,2,0,0,1,0,1,3,1
4059,122072,UdIMXWwMbB1F8xXEtwt8g56Lh72G96hQ,SpATywNh6bZuzm8s1ceuBUnMUAeoAHHw,9,10,9,0,9,0,2,0,30,4.285714285714286,1,0.0,0,9,0,9,10,0,0,2,0,18,12,1
4060,122074,JbB7hpnQ5hVzqELznLtzJLRyOZ2rdnyH,SpATywNh6bZuzm8s1ceuBUnMUAeoAHHw,8,8,2,14,0,0,3,0,27,3.857142857142857,2,0.0,5,2,14,0,3,0,0,3,0,21,6,1
4061,122079,cderIDaWBR3ykedbqXoG7yh75mThXkpL,A3fsA9Zfv1X2fVEQhTw51lKENdNrEqT3,8,16,8,0,0,10,8,0,42,6.0,2,0.0,2,8,0,0,14,10,0,8,0,10,32,1
4062,122080,2dTQ27kTyKMSAN4dn7cbjnuDmdSbybLJ,SpATywNh6bZuzm8s1ceuBUnMUAeoAHHw,13,13,6,15,3,0,4,0,41,5.857142857142857,2,0.0,6,6,15,3,7,0,0,4,0,30,11,0
4063,124650,efygWYkxxUMOGInRZT4qEeuzMRlIpQq6,7GRhBDsirIGkRZBtSMEzNTyDr2JQm4xx,31,33,24,0,25,0,4,0,86,12.285714285714286,2,0.0,6,24,0,25,27,0,0,4,0,55,31,0
4064,124655,znF1cjtWo1KGLXEIK5C3NJfQlk7HZ3U1,7GRhBDsirIGkRZBtSMEzNTyDr2JQm4xx,31,68,19,68,6,35,8,1,205,29.285714285714285,3,0.0,44,19,57,6,24,35,11,8,1,126,79,1
4065,124664,sL5jw3pLWZoRI7avI17oM60mfF67Acgz,7GRhBDsirIGkRZBtSMEzNTyDr2JQm4xx,1,0,0,0,0,0,1,0,1,0.14285714285714285,1,0.0,0,0,0,0,0,0,0,1,0,0,1,1
4066,124672,SglSA2qg6fizXrvdkABD6ypMwWhttZ4P,7GRhBDsirIGkRZBtSMEzNTyDr2JQm4xx,1,0,0,0,0,0,1,0,1,0.14285714285714285,1,0.0,0,0,0,0,0,0,0,1,0,0,1,1
4067,124702,Xv0DoRVy2WPaq7NGSTl3PflvzGmHzjVJ,7GRhBDsirIGkRZBtSMEzNTyDr2JQm4xx,30,105,16,55,10,13,22,0,221,31.571428571428573,4,0.0,54,16,49,10,51,13,6,22,0,129,92,0
4068,124731,kAnFbfXpbNeJLwDkVeY9dBv06ssaFoQQ,7GRhBDsirIGkRZBtSMEzNTyDr2JQm4xx,7,1,1,0,1,0,7,0,10,1.4285714285714286,2,0.0,0,1,0,1,1,0,0,7,0,2,8,1
4069,124761,ioaeb7d1U29jI9wsI7DHJ7aiuWWVX3KB,7GRhBDsirIGkRZBtSMEzNTyDr2JQm4xx,1,0,0,0,0,0,1,0,1,0.14285714285714285,1,0.0,0,0,0,0,0,0,0,1,0,0,1,1
4070,124784,Eh1GmQ1l1uLUtTdjFKV3N8aG3h7KeTZw,7GRhBDsirIGkRZBtSMEzNTyDr2JQm4xx,6,6,3,0,1,0,4,0,14,2.0,2,0.0,0,3,0,1,6,0,0,4,0,4,10,1
4071,124806,Th577tzrUuQ2mCFol11GPYRTSP1uxDgy,7GRhBDsirIGkRZBtSMEzNTyDr2JQm4xx,1,0,0,0,0,0,5,0,5,0.7142857142857143,4,0.0,0,0,0,0,0,0,0,5,0,0,5,1
4072,124883,YglOmvsVjCCnNnyOM9hw1BozNvavt4Yw,7GRhBDsirIGkRZBtSMEzNTyDr2JQm4xx,10,10,5,4,5,0,4,0,28,4.0,2,0.0,3,5,3,5,7,0,1,4,0,16,12,1
4073,124914,Jjmm0y7q4AQOSfmS8g0ehDtEqybh04ZX,7GRhBDsirIGkRZBtSMEzNTyDr2JQm4xx,1,0,0,0,0,0,1,0,1,0.14285714285714285,1,0.0,0,0,0,0,0,0,0,1,0,0,1,1
4074,124920,gZWf27ETcHz4bBmwZPjiPumw55JZ4IOR,7GRhBDsirIGkRZBtSMEzNTyDr2JQm4xx,3,2,0,0,0,0,1,0,3,0.42857142857142855,1,0.0,0,0,0,0,2,0,0,1,0,0,3,1
4075,124935,VRS5uIqYlw2SwZ8kUgzPCb9ckuRb5DEy,7GRhBDsirIGkRZBtSMEzNTyDr2JQm4xx,2,0,0,0,0,0,3,0,3,0.42857142857142855,2,0.0,0,0,0,0,0,0,0,3,0,0,3,1
4076,124949,sQym1SSnuvlV9rWhfoiNBuvnxQoSSsrc,7GRhBDsirIGkRZBtSMEzNTyDr2JQm4xx,4,6,2,0,0,1,2,0,11,1.5714285714285714,1,0.0,1,2,0,0,5,1,0,2,0,3,8,0
4077,124950,Xn0FkHI67ejumzKXwubbQ6h7XBOcvKHb,7GRhBDsirIGkRZBtSMEzNTyDr2JQm4xx,1,0,0,0,0,0,1,0,1,0.14285714285714285,1,0.0,0,0,0,0,0,0,0,1,0,0,1,1
4078,124961,MQKEfJfHQjDI3xyJjnjmz4WwmQkpOvq2,7GRhBDsirIGkRZBtSMEzNTyDr2JQm4xx,4,2,1,0,1,0,1,0,5,0.7142857142857143,1,0.0,0,1,0,1,2,0,0,1,0,2,3,1
4079,125015,wuCb3DAs0UTa3nnL6gSfoBgjTkpbfyNt,7GRhBDsirIGkRZBtSMEzNTyDr2JQm4xx,2,0,0,0,0,0,5,0,5,0.7142857142857143,2,0.0,0,0,0,0,0,0,0,5,0,0,5,0
4080,125055,GjKIGij44vr1LmHxaYp53Ww7DNMH4X51,7GRhBDsirIGkRZBtSMEzNTyDr2JQm4xx,1,0,0,0,0,0,1,0,1,0.14285714285714285,1,0.0,0,0,0,0,0,0,0,1,0,0,1,1
4081,125141,Bh56YjgPG1aYs0o5T2OK5m2v5NWxpiqv,7GRhBDsirIGkRZBtSMEzNTyDr2JQm4xx,1,0,0,0,0,0,1,0,1,0.14285714285714285,1,0.0,0,0,0,0,0,0,0,1,0,0,1,1
4082,125168,lJUTJBRxdmUZMtpc6Z00drkXv7sphS3I,7GRhBDsirIGkRZBtSMEzNTyDr2JQm4xx,1,0,0,0,0,0,1,0,1,0.14285714285714285,1,0.0,0,0,0,0,0,0,0,1,0,0,1,1
4083,125192,GCOHYGlzOItFnghKeaWS09bGB70fHDaY,7GRhBDsirIGkRZBtSMEzNTyDr2JQm4xx,3,1,0,0,0,0,2,0,3,0.42857142857142855,1,0.0,0,0,0,0,1,0,0,2,0,0,3,1
4084,125231,LKQx76DscP8cMaadDZLCOsushv3ygeRX,7GRhBDsirIGkRZBtSMEzNTyDr2JQm4xx,1,0,0,0,0,0,1,0,1,0.14285714285714285,1,0.0,0,0,0,0,0,0,0,1,0,0,1,1
4085,125245,eOxm8XEI11Xs6eiBi1Nu5QzIagZXwEm9,7GRhBDsirIGkRZBtSMEzNTyDr2JQm4xx,7,0,0,0,0,2,6,0,8,1.1428571428571428,1,0.0,0,0,0,0,0,2,0,6,0,0,8,1
4086,125259,BGrU91p3SJR2EobOQ7G1wG17DcXaN4qI,7GRhBDsirIGkRZBtSMEzNTyDr2JQm4xx,5,3,2,0,1,0,1,0,7,1.0,1,0.0,0,2,0,1,3,0,0,1,0,3,4,1
4087,125303,b7PuwalmdIR7gI2f0kgWK9mhLJEyGy0c,7GRhBDsirIGkRZBtSMEzNTyDr2JQm4xx,2,0,0,0,0,0,2,0,2,0.2857142857142857,1,0.0,0,0,0,0,0,0,0,2,0,0,2,1
4088,125376,Im85u8aENweba95uFnFOR6zdQWFnfDOq,7GRhBDsirIGkRZBtSMEzNTyDr2JQm4xx,6,3,2,0,1,0,2,0,8,1.1428571428571428,1,0.0,0,2,0,1,3,0,0,2,0,3,5,1
4089,125417,EApv9HeMdrTOqAiEQ2b8Pe6dV7nBgttc,7GRhBDsirIGkRZBtSMEzNTyDr2JQm4xx,25,30,10,14,12,0,4,0,70,10.0,1,0.0,19,10,11,12,11,0,3,4,0,52,18,1
4090,125427,eRoc2wJbq7MhBPMEmeCelGVn6NCoE6rW,7GRhBDsirIGkRZBtSMEzNTyDr2JQm4xx,5,2,1,0,1,0,2,0,6,0.8571428571428571,1,0.0,0,1,0,1,2,0,0,2,0,2,4,1
4091,125428,7tmNprOSiahGzByaY8XiUnCFEIQfWwuf,7GRhBDsirIGkRZBtSMEzNTyDr2JQm4xx,13,32,7,4,5,0,3,0,51,7.285714285714286,2,0.0,13,7,4,5,19,0,0,3,0,29,22,0
4092,125495,idU4PBrRhkhRSQxacAs4twJhArJhSxu3,7GRhBDsirIGkRZBtSMEzNTyDr2JQm4xx,1,0,0,0,0,0,1,0,1,0.14285714285714285,1,0.0,0,0,0,0,0,0,0,1,0,0,1,1
4093,125497,PBb82RihjctDhPv3TdRmoDOf1nw7NrF1,7GRhBDsirIGkRZBtSMEzNTyDr2JQm4xx,7,7,4,0,2,0,4,0,17,2.4285714285714284,2,0.0,0,4,0,2,7,0,0,4,0,6,11,1
4094,125503,EihYm2z8SiHLHxWvKz7i6RRNVdYLw99f,7GRhBDsirIGkRZBtSMEzNTyDr2JQm4xx,2,0,0,0,0,0,4,0,4,0.5714285714285714,1,0.0,0,0,0,0,0,0,0,4,0,0,4,1
4095,125626,xAPFTLGOI6MhRuvYnyw4iYAuIk60vENo,7GRhBDsirIGkRZBtSMEzNTyDr2JQm4xx,5,9,5,0,0,0,6,0,20,2.857142857142857,1,0.0,0,5,0,0,9,0,0,6,0,5,15,1
4096,125633,FDR62LyL2NPX1eDLrbTp7iEOk4qB3llp,7GRhBDsirIGkRZBtSMEzNTyDr2JQm4xx,22,27,8,10,17,0,7,0,69,9.857142857142858,2,0.0,18,8,10,17,9,0,0,7,0,53,16,1
4097,125658,cUvcpWppohUVKz8Tban8cv5QfXMTXadW,7GRhBDsirIGkRZBtSMEzNTyDr2JQm4xx,1,0,0,0,0,0,1,0,1,0.14285714285714285,1,0.0,0,0,0,0,0,0,0,1,0,0,1,1
4098,125680,tRu7kc3B7i0xOP4FswhcDsdZx5KznD0T,7GRhBDsirIGkRZBtSMEzNTyDr2JQm4xx,2,0,0,0,0,0,3,0,3,0.42857142857142855,1,0.0,0,0,0,0,0,0,0,3,0,0,3,1
4099,125693,Z1sZhLd0yuKMu6iVzogIpx0JDek3jyqT,7GRhBDsirIGkRZBtSMEzNTyDr2JQm4xx,1,0,0,0,0,0,1,0,1,0.14285714285714285,1,0.0,0,0,0,0,0,0,0,1,0,0,1,1
4100,125756,ScNAsndZpkOb6xTMDq2TkU95eVmTkUfl,7GRhBDsirIGkRZBtSMEzNTyDr2JQm4xx,4,2,0,0,0,0,2,0,4,0.5714285714285714,1,0.0,0,0,0,0,2,0,0,2,0,0,4,1
4101,125793,xpwei0fjDTwQJLJhl5FjMPXksqpuR5GG,7GRhBDsirIGkRZBtSMEzNTyDr2JQm4xx,36,33,9,34,10,0,12,0,98,14.0,1,0.0,19,9,34,10,14,0,0,12,0,72,26,0
4102,125803,UgRvVqO3twMvJzAlD49rqrTbxTS8yLpX,7GRhBDsirIGkRZBtSMEzNTyDr2JQm4xx,3,2,0,0,0,0,1,0,3,0.42857142857142855,1,0.0,0,0,0,0,2,0,0,1,0,0,3,1
4103,125837,k0z6RGGewAn8TOLu7gTAfbvZpKAlaO9s,7GRhBDsirIGkRZBtSMEzNTyDr2JQm4xx,1,0,0,0,0,0,1,0,1,0.14285714285714285,1,0.0,0,0,0,0,0,0,0,1,0,0,1,1
4104,125844,PmtrviA6hBub1PH85YXqVyZgghNsuc4g,7GRhBDsirIGkRZBtSMEzNTyDr2JQm4xx,1,0,0,0,0,0,1,0,1,0.14285714285714285,1,0.0,0,0,0,0,0,0,0,1,0,0,1,1
4105,125847,z1ruPoQWI2YQpUKGJMJN29iqd6Mz8fk8,7GRhBDsirIGkRZBtSMEzNTyDr2JQm4xx,8,8,0,4,2,1,2,0,17,2.4285714285714284,1,0.0,4,0,3,2,4,1,1,2,0,9,8,1
4106,125865,PKH12j56WyhhHbwNNO7EjzMEo1oeOneA,7GRhBDsirIGkRZBtSMEzNTyDr2JQm4xx,1,0,0,0,0,0,1,0,1,0.14285714285714285,1,0.0,0,0,0,0,0,0,0,1,0,0,1,1
4107,125959,d8nG3CRjdRKOgHNCQ97Y2ebOYVCkXw4D,7GRhBDsirIGkRZBtSMEzNTyDr2JQm4xx,1,0,0,0,0,0,1,0,1,0.14285714285714285,1,0.0,0,0,0,0,0,0,0,1,0,0,1,1
4108,125993,YNJKXpmmDE2uZ1c64Ovdnu4MZUQJ0A5j,7GRhBDsirIGkRZBtSMEzNTyDr2JQm4xx,1,0,0,0,0,0,1,0,1,0.14285714285714285,1,0.0,0,0,0,0,0,0,0,1,0,0,1,1
4109,126003,Vao6JycAVhIhWbjbxKbLXiDUK1ZHKwjo,7GRhBDsirIGkRZBtSMEzNTyDr2JQm4xx,4,4,2,0,0,0,1,0,7,1.0,1,0.0,0,2,0,0,4,0,0,1,0,2,5,1
4110,126626,0PTt7yojLQH47Ob79awcf5jvqfHw2L3I,fbPkOYLVPtPgIt0MxizjfFJov3JbHyAi,3,2,0,0,0,10,1,0,13,1.8571428571428572,1,0.0,0,0,0,0,2,10,0,1,0,0,13,1
4111,126628,gdWTcSZVoKN1pGf7JyovC0vqfcnT9h18,fbPkOYLVPtPgIt0MxizjfFJov3JbHyAi,7,3,2,0,2,0,3,0,10,1.4285714285714286,2,0.0,0,2,0,2,3,0,0,3,0,4,6,1
4112,126631,I2ghGumCKIaVsnJOGZA0xyJzTnEm5KtW,fbPkOYLVPtPgIt0MxizjfFJov3JbHyAi,4,2,1,0,0,0,2,0,5,0.7142857142857143,1,0.0,0,1,0,0,2,0,0,2,0,1,4,1
4113,126650,LD7pbuVHju3VTu9U8udNh6I7JCsw9ECG,fbPkOYLVPtPgIt0MxizjfFJov3JbHyAi,26,31,16,31,10,0,7,0,95,13.571428571428571,1,0.0,12,16,22,10,19,0,9,7,0,60,35,0
4114,126694,zn2X74vvqUQRINz90WjZLsSsFglpYr7o,fbPkOYLVPtPgIt0MxizjfFJov3JbHyAi,5,3,2,0,0,0,3,0,8,1.1428571428571428,1,0.0,0,2,0,0,3,0,0,3,0,2,6,1
4115,126709,xJHRW2pP02hpKUueg876ng5RKQuuRj6e,fbPkOYLVPtPgIt0MxizjfFJov3JbHyAi,7,2,1,0,1,5,5,2,16,2.2857142857142856,1,0.0,0,1,0,1,2,5,0,5,2,2,14,1
4116,126710,74SN75RPs9smmLOI0EXp2s3BwIneUL6f,fbPkOYLVPtPgIt0MxizjfFJov3JbHyAi,4,2,1,0,1,0,1,0,5,0.7142857142857143,1,0.0,0,1,0,1,2,0,0,1,0,2,3,1
4117,126716,nKDNYUTGPAPqMmlfE7Ub4Qe4fIY0CgoN,fbPkOYLVPtPgIt0MxizjfFJov3JbHyAi,7,3,2,0,2,0,2,0,9,1.2857142857142858,1,0.0,0,2,0,2,3,0,0,2,0,4,5,1
4118,126719,ubotMSWIUOxiTHzx65PiC1ieC4BwcBY3,fbPkOYLVPtPgIt0MxizjfFJov3JbHyAi,7,6,4,0,3,0,8,0,21,3.0,1,0.0,0,4,0,3,6,0,0,8,0,7,14,1
4119,126720,ILgj2bRC3L9liHZTpRi1J62GsWMdjm7i,fbPkOYLVPtPgIt0MxizjfFJov3JbHyAi,33,35,22,16,17,24,8,0,122,17.428571428571427,2,0.0,7,22,13,17,28,24,3,8,0,59,63,0
4120,126721,svRBzwXocvDcjjQhiBGtiJ9xaG6TSovy,fbPkOYLVPtPgIt0MxizjfFJov3JbHyAi,7,13,3,0,3,0,2,0,21,3.0,1,0.0,6,3,0,3,7,0,0,2,0,12,9,1
4121,126723,CEB1n53vwmUc8FHZoBrt4V9IQdrhTfqS,fbPkOYLVPtPgIt0MxizjfFJov3JbHyAi,1,0,0,0,0,0,1,0,1,0.14285714285714285,1,0.0,0,0,0,0,0,0,0,1,0,0,1,1
4122,126725,qad1013ZPW8FX2puHq0BQB5FRF6ADJuZ,fbPkOYLVPtPgIt0MxizjfFJov3JbHyAi,1,0,0,0,0,0,1,0,1,0.14285714285714285,1,0.0,0,0,0,0,0,0,0,1,0,0,1,1
4123,126726,jwPZuNOmAMKPf75y5B5RjmpRb6aVkyKO,fbPkOYLVPtPgIt0MxizjfFJov3JbHyAi,8,5,2,0,2,0,4,0,13,1.8571428571428572,1,0.0,0,2,0,2,5,0,0,4,0,4,9,1
4124,126727,okqN4nBVKRYYrkYonKicKGOmPqVGYjZh,fbPkOYLVPtPgIt0MxizjfFJov3JbHyAi,8,8,4,0,7,0,9,0,28,4.0,3,0.0,0,4,0,7,8,0,0,9,0,11,17,0
4125,126732,c3bBGCRAwL0HZQ0vFzkQ6CAecfLWPbLO,fbPkOYLVPtPgIt0MxizjfFJov3JbHyAi,7,3,2,0,2,0,6,0,13,1.8571428571428572,1,0.0,0,2,0,2,3,0,0,6,0,4,9,1
4126,126733,eGYk5KFWT4Pvjbd5cX2RH5CTBhiHI9SQ,fbPkOYLVPtPgIt0MxizjfFJov3JbHyAi,17,32,6,25,15,0,6,0,84,12.0,1,0.0,25,6,21,15,7,0,4,6,0,67,17,1
4127,126734,AbrmwZ5WdO7ReOka4PEAhehW5B0axP5g,fbPkOYLVPtPgIt0MxizjfFJov3JbHyAi,10,4,2,0,2,4,10,1,23,3.2857142857142856,1,0.0,1,2,0,2,3,4,0,10,1,5,18,1
4128,126735,FXETNH4OzV3fwI4YkwpBpnk1E19ob1X2,fbPkOYLVPtPgIt0MxizjfFJov3JbHyAi,2,0,0,0,0,0,2,0,2,0.2857142857142857,1,0.0,0,0,0,0,0,0,0,2,0,0,2,1
4129,126736,rrBwc9DqMP8jnv9AB7ljubWYdmiLkI0q,fbPkOYLVPtPgIt0MxizjfFJov3JbHyAi,1,0,0,0,0,0,1,0,1,0.14285714285714285,1,0.0,0,0,0,0,0,0,0,1,0,0,1,1
4130,126738,7M93OdpUvlNXQzkFgbb1jjdCwfDx9GtM,fbPkOYLVPtPgIt0MxizjfFJov3JbHyAi,13,7,5,0,5,0,7,0,24,3.4285714285714284,1,0.0,0,5,0,5,7,0,0,7,0,10,14,1
4131,126740,5lk9vcvlk4ZCLjblktkMYKVUtSVMBE5E,fbPkOYLVPtPgIt0MxizjfFJov3JbHyAi,6,8,1,0,2,3,6,0,20,2.857142857142857,1,0.0,2,1,0,2,6,3,0,6,0,5,15,1
4132,126741,lkSkVgerjbY9elu2HritmYHEIObp7PjN,fbPkOYLVPtPgIt0MxizjfFJov3JbHyAi,13,18,6,0,5,0,8,0,37,5.285714285714286,3,0.0,10,6,0,5,8,0,0,8,0,21,16,1
4133,126743,lkPumIFIPcAu2WGl2L8VJbRmISnkyI8O,fbPkOYLVPtPgIt0MxizjfFJov3JbHyAi,1,0,0,0,0,0,1,0,1,0.14285714285714285,1,0.0,0,0,0,0,0,0,0,1,0,0,1,1
4134,126744,oGufUk3TlimKTfZlaD6U33grjPc0CIXa,fbPkOYLVPtPgIt0MxizjfFJov3JbHyAi,1,0,0,0,0,0,1,0,1,0.14285714285714285,1,0.0,0,0,0,0,0,0,0,1,0,0,1,1
4135,126745,LNdimqsJkOxQDP9dT4IGwewg9YvH7zfV,fbPkOYLVPtPgIt0MxizjfFJov3JbHyAi,1,0,0,0,0,0,1,0,1,0.14285714285714285,1,0.0,0,0,0,0,0,0,0,1,0,0,1,1
4136,126747,N8IThlIYSn8Fy4uyyTQSpl5K0TGz5NzT,fbPkOYLVPtPgIt0MxizjfFJov3JbHyAi,1,0,0,0,0,0,1,0,1,0.14285714285714285,1,0.0,0,0,0,0,0,0,0,1,0,0,1,1
4137,126749,dhYRwzeTF8ZdKZPmARZOAee0piLEqFbu,fbPkOYLVPtPgIt0MxizjfFJov3JbHyAi,10,12,5,0,3,3,11,0,34,4.857142857142857,1,0.0,1,5,0,3,11,3,0,11,0,9,25,1
4138,126752,WIgM6nvV9YFBo82xFhtQp6923xmcbs69,fbPkOYLVPtPgIt0MxizjfFJov3JbHyAi,1,0,0,0,0,0,1,0,1,0.14285714285714285,1,0.0,0,0,0,0,0,0,0,1,0,0,1,1
4139,126754,xGbsJo4oJvVhF60tIqZnizNX71bTSMlF,fbPkOYLVPtPgIt0MxizjfFJov3JbHyAi,5,3,1,0,1,0,2,0,7,1.0,1,0.0,0,1,0,1,3,0,0,2,0,2,5,1
4140,126755,sfmDw8Mu24TwJAISRGKb3tkGixPCex4a,fbPkOYLVPtPgIt0MxizjfFJov3JbHyAi,1,0,0,0,0,0,1,0,1,0.14285714285714285,1,0.0,0,0,0,0,0,0,0,1,0,0,1,1
4141,126757,6Rep3wtvxTeRNedCLfqY7iMeUZ3V82V5,fbPkOYLVPtPgIt0MxizjfFJov3JbHyAi,1,0,0,0,0,0,1,0,1,0.14285714285714285,1,0.0,0,0,0,0,0,0,0,1,0,0,1,1
4142,126758,bATDoM6JXGnyb4V3IABuJhs4a0vjJZc3,fbPkOYLVPtPgIt0MxizjfFJov3JbHyAi,7,3,2,0,2,0,2,0,9,1.2857142857142858,1,0.0,0,2,0,2,3,0,0,2,0,4,5,1
4143,126774,4FlFuHK6TBPGfbsvWig6oHoWLKBiaFvx,fbPkOYLVPtPgIt0MxizjfFJov3JbHyAi,8,3,1,0,1,0,6,1,12,1.7142857142857142,1,0.0,0,1,0,1,3,0,0,6,1,2,10,1
4144,126820,qDTU2XGTiB220mLDzlsck7xSj3wUhIhe,fbPkOYLVPtPgIt0MxizjfFJov3JbHyAi,2,0,0,0,0,0,2,0,2,0.2857142857142857,1,0.0,0,0,0,0,0,0,0,2,0,0,2,1
4145,130035,GWG8afsUfRei9CIZYg1Y2sBsF64D5J9k,7GRhBDsirIGkRZBtSMEzNTyDr2JQm4xx,3,2,1,0,0,0,2,0,5,0.7142857142857143,1,0.0,0,1,0,0,2,0,0,2,0,1,4,1
4146,130051,V6I2tWMT4J6OaEfYWYGJXMvy6YbJ0vQk,7GRhBDsirIGkRZBtSMEzNTyDr2JQm4xx,36,46,13,55,0,0,1,0,115,16.428571428571427,1,0.0,22,13,53,0,24,0,2,1,0,88,27,0
4147,130052,zJ1cXp5NsbaO1h7ITMq3mqJ8kisUpMMv,7GRhBDsirIGkRZBtSMEzNTyDr2JQm4xx,47,36,12,108,10,0,3,0,169,24.142857142857142,1,0.0,22,12,100,10,14,0,8,3,0,144,25,1
4148,130318,Mms6sMIkW4Omst3uLD38oJJ4C0ZCQcDW,7GRhBDsirIGkRZBtSMEzNTyDr2JQm4xx,6,5,0,0,0,0,4,0,9,1.2857142857142858,1,0.0,1,0,0,0,4,0,0,4,0,1,8,1
4149,134909,GfFjXeeiX86hNL5LrfmBqRsIDiX1X26k,SpATywNh6bZuzm8s1ceuBUnMUAeoAHHw,27,37,20,30,9,1,4,0,101,14.428571428571429,2,0.0,10,20,27,9,27,1,3,4,0,66,35,1
4150,134917,yNC8T7gdWO96Y2q3tzTQeJUMY0F51xnO,RXDvfPUBYFlVdlueBFbLW0mhhAyGEqpt,42,23,14,52,8,0,3,0,100,14.285714285714286,2,0.0,7,14,52,8,16,0,0,3,0,81,19,1
4151,134918,IFqWOl32JJm0W3Ap2jxVCpJeXeLJlYDp,A3fsA9Zfv1X2fVEQhTw51lKENdNrEqT3,5,3,2,0,0,0,2,0,7,1.0,2,0.0,0,2,0,0,3,0,0,2,0,2,5,1
4152,134919,DLOMX6N4LOgxba8fGitXr3UEhtTSXCQd,bWdj2GDclj5ofokWjzoa5jAwMkxCykd6,7,9,1,0,2,0,3,0,15,2.142857142857143,2,0.0,2,1,0,2,7,0,0,3,0,5,10,1
4153,134934,mWx2Nz03jP9JKc9PS0gQU6sG6k2C9F0d,SpATywNh6bZuzm8s1ceuBUnMUAeoAHHw,15,31,1,22,1,24,2,0,81,11.571428571428571,2,0.0,9,1,20,1,22,24,2,2,0,31,50,0
4154,134936,NOmOOlAJE5nKLDW211ZOVqBtRY1AgNoT,bWdj2GDclj5ofokWjzoa5jAwMkxCykd6,12,21,2,0,0,1,7,0,31,4.428571428571429,1,0.0,1,2,0,0,20,1,0,7,0,3,28,1
4155,134958,vZY5RTyvAOyjF1AYeCntOYrEo9bIz6lQ,G8EPVSXsOYB5YQWZGiz1aVq5Pgr2GrQu,1,0,0,0,0,0,1,0,1,0.14285714285714285,1,0.0,0,0,0,0,0,0,0,1,0,0,1,1
4156,134959,pvIpspZXePJsFKRHWlM49ptwJQDbUcRt,SpATywNh6bZuzm8s1ceuBUnMUAeoAHHw,3,2,0,0,0,0,1,0,3,0.42857142857142855,1,0.0,0,0,0,0,2,0,0,1,0,0,3,1
4157,134961,oqS6zzIbAzdLBJLSTonEDuhKDtanqUaf,SpATywNh6bZuzm8s1ceuBUnMUAeoAHHw,22,25,0,31,0,17,7,0,80,11.428571428571429,2,0.0,7,0,26,0,18,17,5,7,0,33,47,1
4158,134982,CW7Zlsz0NoDYd7q0tu1Krgi9b7wpQUwQ,A3fsA9Zfv1X2fVEQhTw51lKENdNrEqT3,1,0,0,0,0,0,1,0,1,0.14285714285714285,1,0.0,0,0,0,0,0,0,0,1,0,0,1,0
4159,134994,eSBIcO9jl3TmHpUt3HWb9pXo82kpOmfn,bWdj2GDclj5ofokWjzoa5jAwMkxCykd6,7,4,2,0,2,0,1,0,9,1.2857142857142858,1,0.0,0,2,0,2,4,0,0,1,0,4,5,1
4160,135002,Vr0kaKAkI4p2upUYNB1MMKsTShBZob66,A3fsA9Zfv1X2fVEQhTw51lKENdNrEqT3,10,10,5,0,2,13,6,0,36,5.142857142857143,3,0.0,0,5,0,2,10,13,0,6,0,7,29,1
4161,135005,8roapIDCTFIdbLoaqBbYR8jsy1UP5sGP,RXDvfPUBYFlVdlueBFbLW0mhhAyGEqpt,11,9,6,0,3,1,4,0,23,3.2857142857142856,1,0.0,0,6,0,3,9,1,0,4,0,9,14,1
4162,135010,ABF7qktVQ6rBIirYNSz5GNtRM330ID0h,A3fsA9Zfv1X2fVEQhTw51lKENdNrEqT3,1,0,0,0,0,0,2,0,2,0.2857142857142857,1,0.0,0,0,0,0,0,0,0,2,0,0,2,1
4163,135021,TCrdvmbavAJVW5bPiEeyt89TcS6pYL1D,A3fsA9Zfv1X2fVEQhTw51lKENdNrEqT3,2,0,0,0,0,0,3,0,3,0.42857142857142855,1,0.0,0,0,0,0,0,0,0,3,0,0,3,1
4164,135022,f0rWHmI4rV7ssYizy9jzg3UxqKTtG19Y,SpATywNh6bZuzm8s1ceuBUnMUAeoAHHw,20,40,0,20,0,1,9,0,70,10.0,3,0.0,18,0,17,0,22,1,3,9,0,35,35,0
4165,135025,tedGThhHMqVARfBh6zyzyocTKbTJYJpB,SpATywNh6bZuzm8s1ceuBUnMUAeoAHHw,21,27,14,15,5,10,5,1,77,11.0,2,0.0,10,14,12,5,17,10,3,5,1,41,36,1
4166,135026,Cue1j1CEK4ByBYziFbTJAskjanGgrJp6,SpATywNh6bZuzm8s1ceuBUnMUAeoAHHw,17,16,0,10,0,9,2,0,37,5.285714285714286,2,0.0,0,0,10,0,16,9,0,2,0,10,27,0
4167,135035,wQjDRlC3tPpszGzQ3Dfiq7I6azQztJ02,A3fsA9Zfv1X2fVEQhTw51lKENdNrEqT3,13,9,6,4,4,0,2,0,25,3.5714285714285716,1,0.0,2,6,4,4,7,0,0,2,0,16,9,1
4168,135040,QflUMQYqgKuyQPnCteHvz3LqhJ9AwCga,A3fsA9Zfv1X2fVEQhTw51lKENdNrEqT3,2,0,0,0,0,0,9,0,9,1.2857142857142858,1,0.0,0,0,0,0,0,0,0,9,0,0,9,1
4169,135060,UJeg7gRsnH7RZFT5Iv8Y0tTilR96sXcV,A3fsA9Zfv1X2fVEQhTw51lKENdNrEqT3,3,2,0,0,0,0,2,0,4,0.5714285714285714,1,0.0,0,0,0,0,2,0,0,2,0,0,4,1
4170,135065,g9QyBrQkEVh9IC3JA81b7KgVa01DwgUa,SpATywNh6bZuzm8s1ceuBUnMUAeoAHHw,30,29,18,26,10,5,7,2,97,13.857142857142858,1,0.0,8,18,25,10,21,5,1,7,2,61,36,1
4171,135079,GFArLd1huQSmyLkNR2x5AlhFrFWDXs0N,SpATywNh6bZuzm8s1ceuBUnMUAeoAHHw,14,35,6,26,3,0,2,0,72,10.285714285714286,1,0.0,24,6,21,3,11,0,5,2,0,54,18,0
4172,135095,e09uq36QgLuBVK5DERoejsHeMH2uPMRM,bWdj2GDclj5ofokWjzoa5jAwMkxCykd6,1,0,0,0,0,0,1,0,1,0.14285714285714285,1,0.0,0,0,0,0,0,0,0,1,0,0,1,1
4173,135097,EbZIIypapfDMAa5QP57XCFF2cfAshgSo,RXDvfPUBYFlVdlueBFbLW0mhhAyGEqpt,1,0,0,0,0,0,2,0,2,0.2857142857142857,1,0.0,0,0,0,0,0,0,0,2,0,0,2,1
4174,135104,gZWf27ETcHz4bBmwZPjiPumw55JZ4IOR,A3fsA9Zfv1X2fVEQhTw51lKENdNrEqT3,1,0,0,0,0,0,1,0,1,0.14285714285714285,1,0.0,0,0,0,0,0,0,0,1,0,0,1,1
4175,135115,qknWf2eBme9z3XgVNwZwbwdoI0FKipkj,A3fsA9Zfv1X2fVEQhTw51lKENdNrEqT3,35,22,14,70,10,3,4,0,123,17.571428571428573,1,0.0,6,14,55,10,16,3,15,4,0,85,38,1
4176,135119,czraR8jl3tjb5vvHKbMcAmZkpcCxXmtq,bWdj2GDclj5ofokWjzoa5jAwMkxCykd6,7,3,2,0,2,1,3,0,11,1.5714285714285714,1,0.0,0,2,0,2,3,1,0,3,0,4,7,1
4177,135128,jbfQf8j93qEc8QCxEb0dikXBABlkLrcO,G8EPVSXsOYB5YQWZGiz1aVq5Pgr2GrQu,1,0,0,0,0,0,1,0,1,0.14285714285714285,1,0.0,0,0,0,0,0,0,0,1,0,0,1,1
4178,135137,A3FGIvcpmP9UeVzECTe66iC9lFbKmHRb,A3fsA9Zfv1X2fVEQhTw51lKENdNrEqT3,4,4,3,0,0,0,2,0,9,1.2857142857142858,2,0.0,0,3,0,0,4,0,0,2,0,3,6,1
4179,135143,LbQhhYRYGsyaTkO1QusAxgXnsVSB1OSE,SpATywNh6bZuzm8s1ceuBUnMUAeoAHHw,7,1,1,0,1,1,6,1,11,1.5714285714285714,1,0.0,0,1,0,1,1,1,0,6,1,2,9,1
4180,135168,wMQxNrryGKgbGXsy17gJPlh2fJdDvt8s,bWdj2GDclj5ofokWjzoa5jAwMkxCykd6,13,19,6,72,5,9,3,0,114,16.285714285714285,2,0.0,8,6,65,5,11,9,7,3,0,84,30,1
4181,135172,qLscbApWydA7z1h7Ht7RN2UnF0mvGZpF,RXDvfPUBYFlVdlueBFbLW0mhhAyGEqpt,13,14,1,0,0,1,7,1,24,3.4285714285714284,2,0.0,0,1,0,0,14,1,0,7,1,1,23,1
4182,135188,qhmgArW8a15UOGQrFTosGi03wE1TjPeN,G8EPVSXsOYB5YQWZGiz1aVq5Pgr2GrQu,31,46,1,38,4,0,2,0,91,13.0,1,0.0,30,1,24,4,16,0,14,2,0,59,32,1
4183,135190,wLSijvQvjlVUQosga79Y2P2NJWJt5aXA,SpATywNh6bZuzm8s1ceuBUnMUAeoAHHw,15,24,11,20,4,3,3,0,65,9.285714285714286,1,0.0,4,11,16,4,20,3,4,3,0,35,30,0
4184,135205,ps2zbzmz8NQnCm6f0pvJpkBQkQh2tR1v,bWdj2GDclj5ofokWjzoa5jAwMkxCykd6,17,53,38,0,14,0,12,0,117,16.714285714285715,2,0.0,2,38,0,14,51,0,0,12,0,54,63,1
4185,135209,XPNYQB8BXxVJKoqXsnIXNkzgmqWM9Jf1,bWdj2GDclj5ofokWjzoa5jAwMkxCykd6,1,0,0,0,0,0,1,0,1,0.14285714285714285,1,0.0,0,0,0,0,0,0,0,1,0,0,1,0
4186,135219,njjQXvcpocYF8aiLDJ8yZfLnv69cMgqm,SpATywNh6bZuzm8s1ceuBUnMUAeoAHHw,18,10,9,0,8,0,2,0,29,4.142857142857143,1,0.0,0,9,0,8,10,0,0,2,0,17,12,1
4187,135222,MpTAgw3ozhmeD7C8xc95FgAYRb7j4nGM,SpATywNh6bZuzm8s1ceuBUnMUAeoAHHw,6,2,1,0,1,0,3,0,7,1.0,1,0.0,0,1,0,1,2,0,0,3,0,2,5,1
4188,135232,ZfIQYurnR6gJbWxLJ81cU3ZqzX4mpHm0,A3fsA9Zfv1X2fVEQhTw51lKENdNrEqT3,27,47,23,4,16,0,13,0,103,14.714285714285714,3,0.0,3,23,4,16,44,0,0,13,0,46,57,1
4189,135234,8JTz84ZDdJm6tvsd7hgyCl1RB6wU6r2e,A3fsA9Zfv1X2fVEQhTw51lKENdNrEqT3,6,3,2,0,1,0,2,0,8,1.1428571428571428,1,0.0,0,2,0,1,3,0,0,2,0,3,5,1
4190,135242,JJ57bFsns5I0rz7X8YoOwiZazG9JNmlR,SpATywNh6bZuzm8s1ceuBUnMUAeoAHHw,1,0,0,0,0,0,1,0,1,0.14285714285714285,1,0.0,0,0,0,0,0,0,0,1,0,0,1,1
4191,135247,n67Q6gA8OyrfjvaOwbClftMWf4trlmyC,A3fsA9Zfv1X2fVEQhTw51lKENdNrEqT3,12,9,6,0,5,0,3,0,23,3.2857142857142856,1,0.0,0,6,0,5,9,0,0,3,0,11,12,1
4192,135252,1umo7etGwkx7NcpFxVialzDD37NdyqRT,G8EPVSXsOYB5YQWZGiz1aVq5Pgr2GrQu,43,75,34,58,7,0,3,0,177,25.285714285714285,1,0.0,38,34,37,7,37,0,21,3,0,116,61,0
4193,135271,orkLWN7Jw88UrSJVImY9WyAA9wO3axVi,A3fsA9Zfv1X2fVEQhTw51lKENdNrEqT3,1,0,0,0,0,0,1,0,1,0.14285714285714285,1,0.0,0,0,0,0,0,0,0,1,0,0,1,1
4194,135272,MZomFQTbHAKaDGd0B9fv7KQ9MRsZJ7m6,bWdj2GDclj5ofokWjzoa5jAwMkxCykd6,4,4,1,0,0,0,2,0,7,1.0,1,0.0,0,1,0,0,4,0,0,2,0,1,6,1
4195,135304,43KrXQWA5nPYKCMGBRnIKMf2ytZWgrcW,bWdj2GDclj5ofokWjzoa5jAwMkxCykd6,1,0,0,0,0,0,1,0,1,0.14285714285714285,1,0.0,0,0,0,0,0,0,0,1,0,0,1,1
4196,135305,43KrXQWA5nPYKCMGBRnIKMf2ytZWgrcW,A3fsA9Zfv1X2fVEQhTw51lKENdNrEqT3,1,0,0,0,0,0,2,0,2,0.2857142857142857,1,0.0,0,0,0,0,0,0,0,2,0,0,2,1
4197,135319,XRgwz0GPwgb7aVdSZ4HGlz0QU2iMHxW2,A3fsA9Zfv1X2fVEQhTw51lKENdNrEqT3,8,3,2,0,2,1,3,2,13,1.8571428571428572,1,0.0,0,2,0,2,3,1,0,3,2,4,9,1
4198,135335,NXrRVU4FxMGO3zABXLL6x3AW8OEzmOAP,SpATywNh6bZuzm8s1ceuBUnMUAeoAHHw,3,0,0,0,0,0,3,0,3,0.42857142857142855,1,0.0,0,0,0,0,0,0,0,3,0,0,3,1
4199,135337,1Qo7KMYcvZsuiBzdvEuPj5kKA7qUbqJV,RXDvfPUBYFlVdlueBFbLW0mhhAyGEqpt,1,0,0,0,0,0,1,0,1,0.14285714285714285,1,0.0,0,0,0,0,0,0,0,1,0,0,1,1
4200,135358,ENiSmEGDuCang79gWrzmkKVXvQ2o3noj,SpATywNh6bZuzm8s1ceuBUnMUAeoAHHw,13,21,3,0,3,0,4,0,31,4.428571428571429,4,0.0,0,3,0,3,21,0,0,4,0,6,25,1
4201,135377,ZfIQYurnR6gJbWxLJ81cU3ZqzX4mpHm0,SpATywNh6bZuzm8s1ceuBUnMUAeoAHHw,28,60,24,21,6,3,11,0,125,17.857142857142858,2,0.0,18,24,16,6,42,3,5,11,0,64,61,0
4202,135390,IGFSjvLtGQCYdnhMcrAQcaIreY53ybWv,bWdj2GDclj5ofokWjzoa5jAwMkxCykd6,22,23,3,67,1,24,2,0,120,17.142857142857142,2,0.0,5,3,58,1,18,24,9,2,0,67,53,0
4203,135396,g5cfvDvYqz1BC4LMGanzPaVPPBmwbapa,SpATywNh6bZuzm8s1ceuBUnMUAeoAHHw,7,4,3,0,2,0,1,0,10,1.4285714285714286,1,0.0,0,3,0,2,4,0,0,1,0,5,5,0
4204,135399,46rTxBSjCmRWQay8Ou4hIiZJB66kf2no,RXDvfPUBYFlVdlueBFbLW0mhhAyGEqpt,6,1,1,0,1,0,6,0,9,1.2857142857142858,1,0.0,0,1,0,1,1,0,0,6,0,2,7,1
4205,135412,kdSYbpVWFVGC6Yy5JRVMZRVsatOK3Lvr,SpATywNh6bZuzm8s1ceuBUnMUAeoAHHw,14,8,5,11,3,0,2,0,29,4.142857142857143,1,0.0,2,5,11,3,6,0,0,2,0,21,8,1
4206,135415,HshUJf4SCu4uNEnMGOCihwqMFgpruX2A,bWdj2GDclj5ofokWjzoa5jAwMkxCykd6,13,13,7,20,7,11,4,1,63,9.0,1,0.0,3,7,17,7,10,11,3,4,1,34,29,0
4207,135418,OdctoiqHnsBGK57e7GpH3g9wz0WU5g5f,SpATywNh6bZuzm8s1ceuBUnMUAeoAHHw,1,0,0,0,0,0,1,0,1,0.14285714285714285,1,0.0,0,0,0,0,0,0,0,1,0,0,1,1
4208,135420,58eQNUjs318sjON50Y8nkDIw70NM1q5r,SpATywNh6bZuzm8s1ceuBUnMUAeoAHHw,15,24,0,17,0,1,6,0,48,6.857142857142857,3,0.0,12,0,14,0,12,1,3,6,0,26,22,1
4209,135425,LoyL1dLg21zF03lUMGts7AHY1XLphBvU,SpATywNh6bZuzm8s1ceuBUnMUAeoAHHw,21,27,9,20,5,0,1,0,62,8.857142857142858,1,0.0,11,9,19,5,16,0,1,1,0,44,18,1
4210,135428,yNBmodc8EXXXXDprMuN3jSh3qPXFcpn8,bWdj2GDclj5ofokWjzoa5jAwMkxCykd6,3,5,1,0,0,0,1,0,7,1.0,1,0.0,0,1,0,0,5,0,0,1,0,1,6,1
4211,135442,x6BtQH70uuLHaxqzHA21U9wmfT0SxzD9,RXDvfPUBYFlVdlueBFbLW0mhhAyGEqpt,1,0,0,0,0,0,1,0,1,0.14285714285714285,1,0.0,0,0,0,0,0,0,0,1,0,0,1,1
4212,135447,ivxBGUbA7UT7tzED0gKK31cJU8Lv97zd,A3fsA9Zfv1X2fVEQhTw51lKENdNrEqT3,6,5,1,0,1,0,3,1,11,1.5714285714285714,1,0.0,0,1,0,1,5,0,0,3,1,2,9,1
4213,135458,l3gXcoEEAi47BjXtnIC98tO9tYDIMoBh,SpATywNh6bZuzm8s1ceuBUnMUAeoAHHw,1,0,0,0,0,0,1,0,1,0.14285714285714285,1,0.0,0,0,0,0,0,0,0,1,0,0,1,1
4214,135459,EXZ81qqSldwR1xdBEwBZ7wmgbTHF86sl,bWdj2GDclj5ofokWjzoa5jAwMkxCykd6,39,88,52,149,34,24,11,3,361,51.57142857142857,3,0.0,15,52,125,34,73,24,24,11,3,226,135,0
4215,135464,LpEtIb2L9alLwOQca0Li1HTQlgRpqszP,SpATywNh6bZuzm8s1ceuBUnMUAeoAHHw,5,2,1,0,1,0,2,0,6,0.8571428571428571,1,0.0,0,1,0,1,2,0,0,2,0,2,4,0
4216,135482,AbI9GGAE5Qd4SVmAdr7BeGuvfhPX7Wtw,SpATywNh6bZuzm8s1ceuBUnMUAeoAHHw,9,9,0,6,1,0,2,0,18,2.5714285714285716,1,0.0,0,0,5,1,9,0,1,2,0,6,12,1
4217,135484,gPVsxFydsCsfu82yACdpzeHHS3WY2N6x,SpATywNh6bZuzm8s1ceuBUnMUAeoAHHw,5,2,1,0,1,0,2,0,6,0.8571428571428571,1,0.0,0,1,0,1,2,0,0,2,0,2,4,1
4218,135499,MgBJbfRXH0QNEJmIiGY28SpmFvbhxSoF,A3fsA9Zfv1X2fVEQhTw51lKENdNrEqT3,4,2,1,0,0,5,2,0,10,1.4285714285714286,1,0.0,0,1,0,0,2,5,0,2,0,1,9,1
4219,135507,irZDaKqT4KdxcZGgiOHoDpvTtZyUugWP,A3fsA9Zfv1X2fVEQhTw51lKENdNrEqT3,6,3,1,0,1,0,2,0,7,1.0,1,0.0,0,1,0,1,3,0,0,2,0,2,5,1
4220,135529,ibuUKEEpKQv3Ka1yViFkKH0Ap8k9qs3g,SpATywNh6bZuzm8s1ceuBUnMUAeoAHHw,3,4,0,0,0,0,1,0,5,0.7142857142857143,1,0.0,0,0,0,0,4,0,0,1,0,0,5,1
4221,135533,oM7zTsGBhypmiyvXB06I1GE7QqwfEoSV,SpATywNh6bZuzm8s1ceuBUnMUAeoAHHw,1,0,0,0,0,0,1,0,1,0.14285714285714285,1,0.0,0,0,0,0,0,0,0,1,0,0,1,1
4222,135535,oM7zTsGBhypmiyvXB06I1GE7QqwfEoSV,bWdj2GDclj5ofokWjzoa5jAwMkxCykd6,1,0,0,0,0,0,1,0,1,0.14285714285714285,1,0.0,0,0,0,0,0,0,0,1,0,0,1,1
4223,135536,oM7zTsGBhypmiyvXB06I1GE7QqwfEoSV,A3fsA9Zfv1X2fVEQhTw51lKENdNrEqT3,2,0,0,0,0,0,3,0,3,0.42857142857142855,1,0.0,0,0,0,0,0,0,0,3,0,0,3,1
4224,135547,XuaSoIyzQwXQTlS6fvGcmzTRqL1S8Nnj,A3fsA9Zfv1X2fVEQhTw51lKENdNrEqT3,6,4,0,0,0,0,7,0,11,1.5714285714285714,1,0.0,0,0,0,0,4,0,0,7,0,0,11,1
4225,135552,oaQkoDjpR1FzyXXhOzFvMONGKXrM2zS0,SpATywNh6bZuzm8s1ceuBUnMUAeoAHHw,6,3,1,0,1,0,2,0,7,1.0,1,0.0,0,1,0,1,3,0,0,2,0,2,5,1
4226,135553,HQ9RppyfbU41Pv363qQe8zqkh0OzGsvv,SpATywNh6bZuzm8s1ceuBUnMUAeoAHHw,17,12,8,14,4,0,3,0,41,5.857142857142857,2,0.0,2,8,13,4,10,0,1,3,0,27,14,1
4227,135554,nrNRU1bochGfgxXZNdc89zA9KtJYIKVZ,SpATywNh6bZuzm8s1ceuBUnMUAeoAHHw,13,9,7,0,5,0,3,0,24,3.4285714285714284,2,0.0,0,7,0,5,9,0,0,3,0,12,12,0
4228,135560,p7o6CUVxTvhF5zDZdbTejHoySKfqycmC,A3fsA9Zfv1X2fVEQhTw51lKENdNrEqT3,6,3,2,0,1,0,2,0,8,1.1428571428571428,1,0.0,0,2,0,1,3,0,0,2,0,3,5,1
4229,135566,vycvLwIlVlbz3tEwZzvFj0YINSM3Ga0S,A3fsA9Zfv1X2fVEQhTw51lKENdNrEqT3,2,0,0,0,0,0,5,0,5,0.7142857142857143,1,0.0,0,0,0,0,0,0,0,5,0,0,5,1
4230,135570,JoLD64z5yUuFbScCfKMnv8dODXOTXhRU,RXDvfPUBYFlVdlueBFbLW0mhhAyGEqpt,16,13,0,26,0,0,1,0,40,5.714285714285714,1,0.0,3,0,25,0,10,0,1,1,0,28,12,1
4231,135590,VYMfm0tgVS6x4Eosz9NPpRPYpCrgFsMy,RXDvfPUBYFlVdlueBFbLW0mhhAyGEqpt,62,45,27,173,13,4,7,0,269,38.42857142857143,2,0.0,14,27,157,13,31,4,16,7,0,211,58,0
4232,135613,8lCrBaMkcXk8KsL7M8AYgjnsyFuSP4yK,SpATywNh6bZuzm8s1ceuBUnMUAeoAHHw,1,0,0,0,0,0,1,0,1,0.14285714285714285,1,0.0,0,0,0,0,0,0,0,1,0,0,1,0
4233,135614,jWsLxS98Uf5iPgurn9PRvQM3beT2rSkF,RXDvfPUBYFlVdlueBFbLW0mhhAyGEqpt,8,5,4,0,2,0,1,0,12,1.7142857142857142,1,0.0,0,4,0,2,5,0,0,1,0,6,6,1
4234,135619,dmVv4oc5Gy8IXIoX1c6y61vCY7ZjC5c1,SpATywNh6bZuzm8s1ceuBUnMUAeoAHHw,17,15,7,6,4,3,6,0,41,5.857142857142857,2,0.0,2,7,6,4,13,3,0,6,0,19,22,1
4235,135624,MwZAtUJAIGUF9YvAxz812Aiz5L37mA7l,A3fsA9Zfv1X2fVEQhTw51lKENdNrEqT3,8,3,0,0,0,0,9,1,13,1.8571428571428572,1,0.0,0,0,0,0,3,0,0,9,1,0,13,1
4236,135627,p8PDk7PIRcdv8OilLQ1EB9K2d3Uc8Sea,SpATywNh6bZuzm8s1ceuBUnMUAeoAHHw,5,3,2,0,1,0,1,0,7,1.0,1,0.0,0,2,0,1,3,0,0,1,0,3,4,1
4237,135651,8E88mVxxHiSEV3ReMbiLkIuYAxJ6YXeO,A3fsA9Zfv1X2fVEQhTw51lKENdNrEqT3,7,9,6,0,2,0,4,0,21,3.0,3,0.0,0,6,0,2,9,0,0,4,0,8,13,0
4238,135653,ZtI7VkDL2OGaTLjYGXUs2OJh9j1CJRBG,A3fsA9Zfv1X2fVEQhTw51lKENdNrEqT3,1,0,0,0,0,0,1,0,1,0.14285714285714285,1,0.0,0,0,0,0,0,0,0,1,0,0,1,1
4239,135660,700mBNy8Tl4Vnb1y2ttxNbwsqHUl4IAM,RXDvfPUBYFlVdlueBFbLW0mhhAyGEqpt,1,0,0,0,0,0,1,0,1,0.14285714285714285,1,0.0,0,0,0,0,0,0,0,1,0,0,1,0
4240,135683,tK1ujwYOutLxYQ1M2MwQkyt3NUvkvmdS,SpATywNh6bZuzm8s1ceuBUnMUAeoAHHw,7,3,2,0,2,0,2,0,9,1.2857142857142858,1,0.0,0,2,0,2,3,0,0,2,0,4,5,1
4241,135687,txe41Ukj2eG7YicOJ2zPZM0lmaXGVXJ2,bWdj2GDclj5ofokWjzoa5jAwMkxCykd6,2,0,0,0,0,0,3,0,3,0.42857142857142855,1,0.0,0,0,0,0,0,0,0,3,0,0,3,1
4242,135692,txe41Ukj2eG7YicOJ2zPZM0lmaXGVXJ2,A3fsA9Zfv1X2fVEQhTw51lKENdNrEqT3,1,0,0,0,0,0,2,0,2,0.2857142857142857,1,0.0,0,0,0,0,0,0,0,2,0,0,2,1
4243,135701,0JlJQUp9pPJEAtzsQAEQWYAKuWMKB5Wj,SpATywNh6bZuzm8s1ceuBUnMUAeoAHHw,1,0,0,0,0,0,1,0,1,0.14285714285714285,1,0.0,0,0,0,0,0,0,0,1,0,0,1,1
4244,135703,1i94xoT1OVM1lTP3R294JlD5odSrEcP5,SpATywNh6bZuzm8s1ceuBUnMUAeoAHHw,11,20,0,0,0,0,3,0,23,3.2857142857142856,3,0.0,6,0,0,0,14,0,0,3,0,6,17,1
4245,135709,EvNxwwShcQXgwZllGhuS7z5fGOL08A9A,SpATywNh6bZuzm8s1ceuBUnMUAeoAHHw,19,49,21,14,9,0,7,0,100,14.285714285714286,5,0.0,6,21,13,9,43,0,1,7,0,49,51,0
4246,135710,W1eC8dDo2Br41T5aJYgOhKyFK29UHKkl,bWdj2GDclj5ofokWjzoa5jAwMkxCykd6,1,0,0,0,0,0,1,0,1,0.14285714285714285,1,0.0,0,0,0,0,0,0,0,1,0,0,1,1
4247,135713,uw4petWia8mRNE3kHXaUdR4MrfrMeMii,SpATywNh6bZuzm8s1ceuBUnMUAeoAHHw,7,7,4,0,3,0,1,0,15,2.142857142857143,1,0.0,0,4,0,3,7,0,0,1,0,7,8,0
4248,135718,P3c6lZK14dvErTUVPURdGKdrWTycrHyk,SpATywNh6bZuzm8s1ceuBUnMUAeoAHHw,8,5,2,0,2,0,3,0,12,1.7142857142857142,1,0.0,0,2,0,2,5,0,0,3,0,4,8,1
4249,135730,H8XaU1gbefHT7MZ45ya2B80ofczKeIUJ,bWdj2GDclj5ofokWjzoa5jAwMkxCykd6,14,8,4,30,2,1,6,0,51,7.285714285714286,2,0.0,2,4,25,2,6,1,5,6,0,33,18,0
4250,135731,NBdBSIIhFodg28Tlkf7g5CN58dT0AVfw,A3fsA9Zfv1X2fVEQhTw51lKENdNrEqT3,5,1,1,0,0,0,10,0,12,1.7142857142857142,2,0.0,0,1,0,0,1,0,0,10,0,1,11,1
4251,135750,S9HR7eC8Gw4zo138FI1zxgIn4ZjLPEI1,RXDvfPUBYFlVdlueBFbLW0mhhAyGEqpt,2,0,0,0,0,0,5,0,5,0.7142857142857143,1,0.0,0,0,0,0,0,0,0,5,0,0,5,1
4252,135760,S9HR7eC8Gw4zo138FI1zxgIn4ZjLPEI1,SpATywNh6bZuzm8s1ceuBUnMUAeoAHHw,1,0,0,0,0,0,1,0,1,0.14285714285714285,1,0.0,0,0,0,0,0,0,0,1,0,0,1,1
4253,135772,B5AczbKF5ZPxp6QPkgM4LlavowE2gAlY,bWdj2GDclj5ofokWjzoa5jAwMkxCykd6,1,0,0,0,0,0,1,0,1,0.14285714285714285,1,0.0,0,0,0,0,0,0,0,1,0,0,1,1
4254,135789,PCI2iKpgTMjPS1xfOSmpWNe7sqLAlttf,G8EPVSXsOYB5YQWZGiz1aVq5Pgr2GrQu,1,0,0,0,0,0,1,0,1,0.14285714285714285,1,0.0,0,0,0,0,0,0,0,1,0,0,1,1
4255,135794,FpBG6AfbqT8rtlNKLvRAodERdOKPGQfD,A3fsA9Zfv1X2fVEQhTw51lKENdNrEqT3,7,3,2,0,2,0,2,0,9,1.2857142857142858,1,0.0,0,2,0,2,3,0,0,2,0,4,5,1
4256,135795,CAnNKDdlHhDJqz95kWpWwBuKgmoUwH3k,RXDvfPUBYFlVdlueBFbLW0mhhAyGEqpt,5,2,1,0,1,0,2,0,6,0.8571428571428571,1,0.0,0,1,0,1,2,0,0,2,0,2,4,1
4257,135813,E4hjF5LL5g3DmDyETJzEmj6OhjarBopN,A3fsA9Zfv1X2fVEQhTw51lKENdNrEqT3,2,0,0,0,0,0,3,0,3,0.42857142857142855,1,0.0,0,0,0,0,0,0,0,3,0,0,3,1
4258,135826,ETvKJXrBLwN7msxC91B5PIQrzaf0kAW1,A3fsA9Zfv1X2fVEQhTw51lKENdNrEqT3,1,0,0,0,0,0,1,0,1,0.14285714285714285,1,0.0,0,0,0,0,0,0,0,1,0,0,1,1
4259,135829,iyNW22GLVn7ltcBOUiQmam3mjjq9r9cL,A3fsA9Zfv1X2fVEQhTw51lKENdNrEqT3,4,5,0,0,0,0,1,0,6,0.8571428571428571,2,0.0,0,0,0,0,5,0,0,1,0,0,6,1
4260,135969,QiJcxNGmLOdmB6eeGiBPeeCTz8AUKVVD,A3fsA9Zfv1X2fVEQhTw51lKENdNrEqT3,5,3,1,0,1,1,1,0,7,1.0,1,0.0,0,1,0,1,3,1,0,1,0,2,5,1
4261,136004,XpLwBNjV7lkbo9HRLwBFqy6jHSpPfym2,SpATywNh6bZuzm8s1ceuBUnMUAeoAHHw,8,5,3,0,2,0,3,0,13,1.8571428571428572,2,0.0,0,3,0,2,5,0,0,3,0,5,8,0
4262,136150,7aQ6rvmUrAZhXOumaP4VW6FvjX4qSmMG,SpATywNh6bZuzm8s1ceuBUnMUAeoAHHw,26,21,14,14,7,4,2,0,62,8.857142857142858,1,0.0,6,14,14,7,15,4,0,2,0,41,21,1
4263,136220,kJR7SORW78mX9yl9TvMAdIrYcwnnZz4r,7GRhBDsirIGkRZBtSMEzNTyDr2JQm4xx,3,2,1,0,0,0,2,0,5,0.7142857142857143,1,0.0,0,1,0,0,2,0,0,2,0,1,4,1
4264,136275,khelYX1bk51SSadsVaUzKR0zRRNCX0tK,7GRhBDsirIGkRZBtSMEzNTyDr2JQm4xx,12,27,9,25,0,0,2,0,63,9.0,1,0.0,16,9,22,0,11,0,3,2,0,47,16,1
4265,136386,FM7LvWy0SQdmiC09CRsUT44n0BqWWa2S,SpATywNh6bZuzm8s1ceuBUnMUAeoAHHw,7,21,0,0,0,0,1,0,22,3.142857142857143,1,0.0,0,0,0,0,21,0,0,1,0,0,22,0
4266,136411,AUmfgp7YjPBzDSEEKYtmp5NT1ZaUbwCu,A3fsA9Zfv1X2fVEQhTw51lKENdNrEqT3,72,40,29,148,18,18,13,2,268,38.285714285714285,1,0.0,4,29,128,18,36,18,20,13,2,179,89,0
4267,136442,TOTNiRasgzo7kH1hlyiehLV3DbzVA61v,7GRhBDsirIGkRZBtSMEzNTyDr2JQm4xx,30,32,6,56,9,44,9,0,156,22.285714285714285,2,0.0,24,6,48,9,8,44,8,9,0,87,69,1
4268,136447,ecut1h0rhjLzcs1jrL1hILYqwNtlJCKC,7GRhBDsirIGkRZBtSMEzNTyDr2JQm4xx,14,21,8,3,3,0,2,0,37,5.285714285714286,1,0.0,5,8,3,3,16,0,0,2,0,19,18,1
4269,136495,EbKjJZq8GOECUxJBvCCbIZN8O8RweU4z,A3fsA9Zfv1X2fVEQhTw51lKENdNrEqT3,5,2,1,0,1,0,2,0,6,0.8571428571428571,1,0.0,0,1,0,1,2,0,0,2,0,2,4,1
4270,136530,hZR4MwcYec4g0GoOyJFngJGEyWOySpv2,G8EPVSXsOYB5YQWZGiz1aVq5Pgr2GrQu,9,6,5,0,2,6,4,0,23,3.2857142857142856,1,0.0,0,5,0,2,6,6,0,4,0,7,16,0
4271,136562,UUf7W9nrVz0icOeIhIvztvvypaJKgHhN,SpATywNh6bZuzm8s1ceuBUnMUAeoAHHw,11,9,6,0,2,0,6,0,23,3.2857142857142856,2,0.0,0,6,0,2,9,0,0,6,0,8,15,1
4272,136641,ndSSvoqRP9UOBqRicNUijfD0pPNDqiTJ,7GRhBDsirIGkRZBtSMEzNTyDr2JQm4xx,21,36,23,8,24,2,15,1,109,15.571428571428571,1,0.0,12,23,7,24,24,2,1,15,1,66,43,0
4273,136683,J3FKLxbUlPTor4lyG8lMpHc8oUQEjfcp,RXDvfPUBYFlVdlueBFbLW0mhhAyGEqpt,18,14,10,0,9,8,10,2,53,7.571428571428571,2,0.0,0,10,0,9,14,8,0,10,2,19,34,0
4274,136701,0Vr5nGGnd8VQ31kkuDTufqDyRIq6gvkS,RXDvfPUBYFlVdlueBFbLW0mhhAyGEqpt,45,28,11,68,7,1,5,0,120,17.142857142857142,1,0.0,7,11,68,7,21,1,0,5,0,93,27,1
4275,136811,MgBJbfRXH0QNEJmIiGY28SpmFvbhxSoF,7GRhBDsirIGkRZBtSMEzNTyDr2JQm4xx,4,2,0,0,0,1,2,0,5,0.7142857142857143,1,0.0,0,0,0,0,2,1,0,2,0,0,5,1
4276,136961,Cx9UgN9CA3ZQNCspfULD8FGJJpSFtxJF,bWdj2GDclj5ofokWjzoa5jAwMkxCykd6,20,22,12,18,6,1,8,2,69,9.857142857142858,1,0.0,5,12,18,6,17,1,0,8,2,41,28,0
4277,137117,TXBaUi0GpvXZWCDXsKlkFWTtfaT87UMz,A3fsA9Zfv1X2fVEQhTw51lKENdNrEqT3,7,4,2,0,0,3,5,1,15,2.142857142857143,1,0.0,1,2,0,0,3,3,0,5,1,3,12,1
4278,137231,ZSEIlb9ma209LSHLrk2K3oKNlkQui4gF,7GRhBDsirIGkRZBtSMEzNTyDr2JQm4xx,11,12,7,6,7,0,1,0,33,4.714285714285714,1,0.0,4,7,5,7,8,0,1,1,0,23,10,1
4279,137320,8XstJLDa8agdHppUFVVZbvtgkIjc1hSo,fbPkOYLVPtPgIt0MxizjfFJov3JbHyAi,5,4,2,0,1,0,3,0,10,1.4285714285714286,1,0.0,0,2,0,1,4,0,0,3,0,3,7,1
4280,137354,WtDMxixQmy03wB9jEWr2xYQPm36rgbzM,fbPkOYLVPtPgIt0MxizjfFJov3JbHyAi,8,7,2,3,1,0,3,0,16,2.2857142857142856,1,0.0,1,2,3,1,6,0,0,3,0,7,9,1
4281,137401,kQsVPicmVfwF40LR0Bwbh20EXwnKbn92,fbPkOYLVPtPgIt0MxizjfFJov3JbHyAi,17,28,8,8,9,4,8,1,66,9.428571428571429,1,0.0,19,8,7,9,9,4,1,8,1,43,23,1
4282,138172,jb9pTa916Vn2VeH0D7ExYaf2JyoI9zrO,7GRhBDsirIGkRZBtSMEzNTyDr2JQm4xx,29,67,1,42,3,28,16,0,157,22.428571428571427,1,0.0,33,1,35,3,34,28,7,16,0,72,85,0
4283,138326,t4tnBhQAPqBnCFRCjzr4Y2gSOW7MaWb7,SpATywNh6bZuzm8s1ceuBUnMUAeoAHHw,4,2,1,0,1,0,1,0,5,0.7142857142857143,1,0.0,0,1,0,1,2,0,0,1,0,2,3,0
4284,138327,yq5rHqpCTagxs6XCaAXxmCSySzn2U3u8,A3fsA9Zfv1X2fVEQhTw51lKENdNrEqT3,43,6,3,146,1,0,6,0,162,23.142857142857142,1,0.0,2,3,119,1,4,0,27,6,0,125,37,1
4285,138358,8RGLvfdludl70fdPksu2JYtYCxSVr9FR,SpATywNh6bZuzm8s1ceuBUnMUAeoAHHw,13,17,0,20,0,0,2,0,39,5.571428571428571,1,0.0,2,0,16,0,15,0,4,2,0,18,21,1
4286,138420,GGf1UPTxgLShqKb7PDIL9hAwpCBcU4fs,SpATywNh6bZuzm8s1ceuBUnMUAeoAHHw,6,3,2,0,2,0,1,0,8,1.1428571428571428,1,0.0,0,2,0,2,3,0,0,1,0,4,4,1
4287,138731,Za7TsRG0IgcPg4zI5JWLKyABDBTbji9K,7GRhBDsirIGkRZBtSMEzNTyDr2JQm4xx,5,5,2,9,0,0,1,0,17,2.4285714285714284,1,0.0,2,2,7,0,3,0,2,1,0,11,6,1
4288,138921,SdmxANaN4VeJNVCXABSOs77O0krJ65nl,SpATywNh6bZuzm8s1ceuBUnMUAeoAHHw,17,21,10,16,4,0,3,0,54,7.714285714285714,1,0.0,2,10,14,4,19,0,2,3,0,30,24,1
4289,138979,9Mbi6CksSOlTvzJd1jV7pzorOP4mmF9E,SpATywNh6bZuzm8s1ceuBUnMUAeoAHHw,8,6,3,0,2,0,1,0,12,1.7142857142857142,1,0.0,0,3,0,2,6,0,0,1,0,5,7,0
4290,139217,OOIu03NBEHePUSUIFa86FGFP5M136EAn,RXDvfPUBYFlVdlueBFbLW0mhhAyGEqpt,20,30,14,14,11,0,6,0,75,10.714285714285714,3,0.0,3,14,14,11,27,0,0,6,0,42,33,0
4291,139222,St6usTSSgX5U9v7wchuMWqmBKoCcDwN2,bWdj2GDclj5ofokWjzoa5jAwMkxCykd6,4,4,0,0,0,0,1,0,5,0.7142857142857143,1,0.0,0,0,0,0,4,0,0,1,0,0,5,1
4292,139252,AKVd0gnvEJlgz6OnGwqybMUQOVjHL58y,SpATywNh6bZuzm8s1ceuBUnMUAeoAHHw,9,11,9,0,7,0,1,0,28,4.0,1,0.0,0,9,0,7,11,0,0,1,0,16,12,0
4293,139262,CQI3ipMoYWvyV7ZuewrTlOYAM3gikvMq,7GRhBDsirIGkRZBtSMEzNTyDr2JQm4xx,13,16,8,4,5,0,2,0,35,5.0,1,0.0,4,8,4,5,12,0,0,2,0,21,14,1
4294,139331,jIQxdn4syEISmeL05XWgww3FZktzs7MC,SpATywNh6bZuzm8s1ceuBUnMUAeoAHHw,19,21,9,17,4,0,6,0,57,8.142857142857142,1,0.0,9,9,15,4,12,0,2,6,0,37,20,0
4295,140068,dRD1DS5DuggVygcG59W7832HdVYwtgOn,7GRhBDsirIGkRZBtSMEzNTyDr2JQm4xx,1,0,0,0,0,0,1,0,1,0.14285714285714285,1,0.0,0,0,0,0,0,0,0,1,0,0,1,1
4296,140282,xcD6YWhnGA2xukGmX4eaYrm6VS9ffz1H,7GRhBDsirIGkRZBtSMEzNTyDr2JQm4xx,4,2,0,0,0,0,5,0,7,1.0,1,0.0,0,0,0,0,2,0,0,5,0,0,7,0
4297,143840,kuZwBvEdgeUtKZ495C2FptBbxEtLtmVH,bWdj2GDclj5ofokWjzoa5jAwMkxCykd6,3,2,1,0,0,0,2,0,5,0.7142857142857143,1,0.0,0,1,0,0,2,0,0,2,0,1,4,1
4298,143867,Pnezq6slEV4CIBxIFIPqhlGLNILa8T8M,SpATywNh6bZuzm8s1ceuBUnMUAeoAHHw,12,15,0,14,0,0,2,0,31,4.428571428571429,1,0.0,2,0,12,0,13,0,2,2,0,14,17,0
4299,143908,nwFT4lnmg30fCvHRB6tbALo9FpcanuLx,SpATywNh6bZuzm8s1ceuBUnMUAeoAHHw,1,0,0,0,0,0,1,0,1,0.14285714285714285,1,0.0,0,0,0,0,0,0,0,1,0,0,1,0
4300,143909,nwFT4lnmg30fCvHRB6tbALo9FpcanuLx,A3fsA9Zfv1X2fVEQhTw51lKENdNrEqT3,4,3,0,0,0,0,2,0,5,0.7142857142857143,1,0.0,0,0,0,0,3,0,0,2,0,0,5,1
4301,143933,Mi4V9PN04XHkOYjYbsNOyLc2HUiygd5R,SpATywNh6bZuzm8s1ceuBUnMUAeoAHHw,14,18,0,18,0,0,3,0,39,5.571428571428571,1,0.0,0,0,16,0,18,0,2,3,0,16,23,1
4302,143940,rMQIZQBxSTMFTRmvcfmpoYqCAUhMol3Y,A3fsA9Zfv1X2fVEQhTw51lKENdNrEqT3,5,3,1,0,1,0,1,0,6,0.8571428571428571,1,0.0,0,1,0,1,3,0,0,1,0,2,4,1
4303,143945,U0EvfjsY5qqb8sRRReWuk6YqXYpCTRVc,SpATywNh6bZuzm8s1ceuBUnMUAeoAHHw,7,11,5,0,1,0,1,0,18,2.5714285714285716,1,0.0,5,5,0,1,6,0,0,1,0,11,7,0
4304,144325,IKQYwh1PoPanPyuEqIIRzDtzc0tOUD2x,SpATywNh6bZuzm8s1ceuBUnMUAeoAHHw,3,2,0,0,0,0,2,0,4,0.5714285714285714,1,0.0,0,0,0,0,2,0,0,2,0,0,4,0
4305,144363,svmQRfMWV47ki33Dy8s4c1zTDx5xyqqy,SpATywNh6bZuzm8s1ceuBUnMUAeoAHHw,22,27,0,29,0,1,4,0,61,8.714285714285714,1,0.0,9,0,26,0,18,1,3,4,0,35,26,1
4306,144468,mU6A1Eh1Sbu4ybvtOk62E6H19PAtCNgh,SpATywNh6bZuzm8s1ceuBUnMUAeoAHHw,15,11,8,13,4,2,2,0,40,5.714285714285714,1,0.0,2,8,10,4,9,2,3,2,0,24,16,1
4307,144578,OUsTbnD6QZatQvggR5YjMxWOH6TYQEkw,SpATywNh6bZuzm8s1ceuBUnMUAeoAHHw,4,2,1,0,1,0,0,0,4,0.5714285714285714,1,0.0,0,1,0,1,2,0,0,0,0,2,2,1
4308,144793,Q4yECXO7W1LpqtiMAu4zBn3zpNL7asTt,RXDvfPUBYFlVdlueBFbLW0mhhAyGEqpt,3,2,1,0,0,0,1,0,4,0.5714285714285714,1,0.0,0,1,0,0,2,0,0,1,0,1,3,1
4309,145000,FsN3EYiAfRxm9msVQNiGujMlmaZjdiLV,A3fsA9Zfv1X2fVEQhTw51lKENdNrEqT3,1,0,0,0,0,0,1,0,1,0.14285714285714285,1,0.0,0,0,0,0,0,0,0,1,0,0,1,1
4310,145137,yCZXjIGq001xO7v4MWCrl9HykbxmZHu1,SpATywNh6bZuzm8s1ceuBUnMUAeoAHHw,9,10,5,14,0,0,1,0,30,4.285714285714286,1,0.0,4,5,11,0,6,0,3,1,0,20,10,0
4311,145206,GQtHf5FrRCd4lKlDjEvxcTzFdncOzUUt,SpATywNh6bZuzm8s1ceuBUnMUAeoAHHw,1,0,0,0,0,0,1,0,1,0.14285714285714285,1,0.0,0,0,0,0,0,0,0,1,0,0,1,1
4312,145367,D9K6eWkEOoVrLczNZaGo49KoERtz2c6V,SpATywNh6bZuzm8s1ceuBUnMUAeoAHHw,13,12,6,11,2,0,2,0,33,4.714285714285714,1,0.0,4,6,10,2,8,0,1,2,0,22,11,1
4313,145403,NO22WSq5lVGwq6WPEcqalEaMjYIZxX3u,SpATywNh6bZuzm8s1ceuBUnMUAeoAHHw,3,2,0,0,0,0,1,0,3,0.42857142857142855,1,0.0,0,0,0,0,2,0,0,1,0,0,3,1
4314,145545,2CCQpD8tgu5ha7nXCDy4k1uINvkP56Wv,7GRhBDsirIGkRZBtSMEzNTyDr2JQm4xx,2,0,0,0,0,0,5,0,5,0.7142857142857143,1,0.0,0,0,0,0,0,0,0,5,0,0,5,1
4315,145547,rT3zpA0g6rjJ1jZXfn6mCIcHmMcmU756,7GRhBDsirIGkRZBtSMEzNTyDr2JQm4xx,42,60,22,54,23,1,12,0,172,24.571428571428573,2,0.0,30,22,44,23,30,1,10,12,0,119,53,0
4316,145550,RuTxY8DaJW8mZYxEAeQrQJD3l4wbq41Q,7GRhBDsirIGkRZBtSMEzNTyDr2JQm4xx,6,3,0,0,0,0,3,0,6,0.8571428571428571,1,0.0,0,0,0,0,3,0,0,3,0,0,6,0
4317,145552,J9NhhdMcyji8QpxegDrg5mXOQMf3xBRf,7GRhBDsirIGkRZBtSMEzNTyDr2JQm4xx,1,0,0,0,0,0,1,0,1,0.14285714285714285,1,0.0,0,0,0,0,0,0,0,1,0,0,1,1
4318,145560,vGQAID39BKk1FvQYReBWX247x3QlYrgz,7GRhBDsirIGkRZBtSMEzNTyDr2JQm4xx,6,15,4,0,1,0,2,0,22,3.142857142857143,1,0.0,6,4,0,1,9,0,0,2,0,11,11,1
4319,145583,iiP1QVGLP2M3sIU07s5hEwnMnf9UaC7w,7GRhBDsirIGkRZBtSMEzNTyDr2JQm4xx,5,3,1,0,1,0,1,0,6,0.8571428571428571,1,0.0,0,1,0,1,3,0,0,1,0,2,4,1
4320,145608,3kzqQ9nu0puySXndbv8HvzuMPwBlBjfc,7GRhBDsirIGkRZBtSMEzNTyDr2JQm4xx,18,14,7,8,3,2,11,1,46,6.571428571428571,2,0.0,0,7,6,3,14,2,2,11,1,16,30,1
4321,145620,S9UJJr8IVX3RcksPSP43kxazIyd4D4o5,7GRhBDsirIGkRZBtSMEzNTyDr2JQm4xx,1,0,0,0,0,0,1,0,1,0.14285714285714285,1,0.0,0,0,0,0,0,0,0,1,0,0,1,1
4322,145622,520kTOJ5a6HoTMe30flreSub2cyQqOhY,7GRhBDsirIGkRZBtSMEzNTyDr2JQm4xx,6,7,4,0,1,0,2,0,14,2.0,1,0.0,0,4,0,1,7,0,0,2,0,5,9,1
4323,145653,NCnx21IrphITLHEQy42s0jDfFa8Z92Kq,7GRhBDsirIGkRZBtSMEzNTyDr2JQm4xx,27,32,0,48,6,3,2,0,91,13.0,1,0.0,21,0,43,6,11,3,5,2,0,70,21,1
4324,145667,dNsNKeQao2yeFH4xZSLIDRMA5I5s2F7t,7GRhBDsirIGkRZBtSMEzNTyDr2JQm4xx,10,4,1,4,0,1,8,1,19,2.7142857142857144,1,0.0,2,1,3,0,2,1,1,8,1,6,13,1
4325,145672,J2mZhHnfnDU9Z2NM0dfjKg8jCciGVkrO,7GRhBDsirIGkRZBtSMEzNTyDr2JQm4xx,1,0,0,0,0,0,1,0,1,0.14285714285714285,1,0.0,0,0,0,0,0,0,0,1,0,0,1,1
4326,145700,4w6yJxocEKgAV94E61slsyKYrolKgTdS,7GRhBDsirIGkRZBtSMEzNTyDr2JQm4xx,2,0,0,0,0,0,2,0,2,0.2857142857142857,1,0.0,0,0,0,0,0,0,0,2,0,0,2,1
4327,145706,VQbP5QE49Z71QPyvJxZhD4TLO56u1QUG,7GRhBDsirIGkRZBtSMEzNTyDr2JQm4xx,10,11,3,9,2,0,2,0,27,3.857142857142857,1,0.0,7,3,8,2,4,0,1,2,0,20,7,1
4328,145733,j2PX858BWhrQRgl6BBT72xW4SDvQKpBb,7GRhBDsirIGkRZBtSMEzNTyDr2JQm4xx,1,0,0,0,0,0,1,0,1,0.14285714285714285,1,0.0,0,0,0,0,0,0,0,1,0,0,1,1
4329,145753,6UQSgDDlbey2YMMKaSOEpDJ0KQllZPpX,7GRhBDsirIGkRZBtSMEzNTyDr2JQm4xx,4,0,0,0,0,0,4,0,4,0.5714285714285714,1,0.0,0,0,0,0,0,0,0,4,0,0,4,1
4330,145763,lnkkWGyIr1b44KiKgAFL6qVeebRfNJt3,7GRhBDsirIGkRZBtSMEzNTyDr2JQm4xx,17,28,0,37,0,0,4,0,69,9.857142857142858,2,0.0,16,0,32,0,12,0,5,4,0,48,21,1
4331,145766,IL2QJO9D8DzgZ0CQ8CMzPpcGTIPKd3bR,7GRhBDsirIGkRZBtSMEzNTyDr2JQm4xx,1,0,0,0,0,0,1,0,1,0.14285714285714285,1,0.0,0,0,0,0,0,0,0,1,0,0,1,1
4332,145774,UtbznsHbbIxKlUqw2M2px85X4bXZRgMG,7GRhBDsirIGkRZBtSMEzNTyDr2JQm4xx,1,0,0,0,0,0,1,0,1,0.14285714285714285,1,0.0,0,0,0,0,0,0,0,1,0,0,1,1
4333,145785,r1hSpHaWwriGvone6pflJV8zZcv0Gdcl,7GRhBDsirIGkRZBtSMEzNTyDr2JQm4xx,2,0,0,0,0,0,2,0,2,0.2857142857142857,1,0.0,0,0,0,0,0,0,0,2,0,0,2,1
4334,145795,yEBTzrvNFAmfa9M4QYcbmiIM6sJKI3UY,7GRhBDsirIGkRZBtSMEzNTyDr2JQm4xx,2,0,0,0,0,0,4,0,4,0.5714285714285714,1,0.0,0,0,0,0,0,0,0,4,0,0,4,1
4335,145817,sqxWpMhcYtYMOXwrr0icUXKE79UdB0Zx,7GRhBDsirIGkRZBtSMEzNTyDr2JQm4xx,14,17,1,2,1,0,6,1,28,4.0,1,0.0,1,1,2,1,16,0,0,6,1,5,23,1
4336,145827,dgFOOUSNfQK8xIrT47Av0Q04bBFeE21W,7GRhBDsirIGkRZBtSMEzNTyDr2JQm4xx,1,0,0,0,0,0,1,0,1,0.14285714285714285,1,0.0,0,0,0,0,0,0,0,1,0,0,1,0
4337,145897,amg8X8B8QF6NtkilqTdjsvKuhYv7sNrc,7GRhBDsirIGkRZBtSMEzNTyDr2JQm4xx,5,7,2,0,0,0,2,0,11,1.5714285714285714,1,0.0,0,2,0,0,7,0,0,2,0,2,9,1
4338,145980,HAj954mCjfBGJQsjyOUvywwmDcTn3cfv,7GRhBDsirIGkRZBtSMEzNTyDr2JQm4xx,3,2,1,0,0,0,1,0,4,0.5714285714285714,1,0.0,0,1,0,0,2,0,0,1,0,1,3,1
4339,145993,FTJVq9TWMdAK3okD5xbyDXGZ8r3m7Y4p,7GRhBDsirIGkRZBtSMEzNTyDr2JQm4xx,3,2,0,0,0,0,1,0,3,0.42857142857142855,1,0.0,0,0,0,0,2,0,0,1,0,0,3,1
4340,145997,xZ2FRlEfvjMgYQGaQTIBwdHmWyFrjfGH,7GRhBDsirIGkRZBtSMEzNTyDr2JQm4xx,2,1,0,0,0,0,2,0,3,0.42857142857142855,1,0.0,0,0,0,0,1,0,0,2,0,0,3,0
4341,146003,0Jy5agBaIEKZmcjIoKNgJ60hHPcSDAap,7GRhBDsirIGkRZBtSMEzNTyDr2JQm4xx,1,0,0,0,0,0,1,0,1,0.14285714285714285,1,0.0,0,0,0,0,0,0,0,1,0,0,1,1
4342,147012,T9AvdYMob6A7XymtAVQOWMZ2VKIDwWSx,RXDvfPUBYFlVdlueBFbLW0mhhAyGEqpt,7,4,0,0,0,1,7,2,14,2.0,1,0.0,0,0,0,0,4,1,0,7,2,0,14,1
4343,147416,Wi6NsYPSasqtq71046KwRwCUoJ7gSxqZ,G8EPVSXsOYB5YQWZGiz1aVq5Pgr2GrQu,8,5,3,0,0,13,7,1,29,4.142857142857143,1,0.0,1,3,0,0,4,13,0,7,1,4,25,1
4344,147758,jEGqrC42iEC0MkvaQaekkhZsW8YPZGtW,fbPkOYLVPtPgIt0MxizjfFJov3JbHyAi,1,0,0,0,0,0,1,0,1,0.14285714285714285,1,0.0,0,0,0,0,0,0,0,1,0,0,1,1
4345,147759,pFE82fh5DH8NUVtvV1y83suNQP2lNeAe,fbPkOYLVPtPgIt0MxizjfFJov3JbHyAi,4,8,3,0,0,0,3,0,14,2.0,2,0.0,1,3,0,0,7,0,0,3,0,4,10,1
4346,147761,6lr9avMLLLHkFmJUiXzIeIFidbBgUCxs,fbPkOYLVPtPgIt0MxizjfFJov3JbHyAi,4,2,1,0,1,0,2,0,6,0.8571428571428571,1,0.0,0,1,0,1,2,0,0,2,0,2,4,1
4347,147762,h6gp6OLQCLhKTyjanK3TbnUuf19NH0Ob,fbPkOYLVPtPgIt0MxizjfFJov3JbHyAi,1,0,0,0,0,0,1,0,1,0.14285714285714285,1,0.0,0,0,0,0,0,0,0,1,0,0,1,1
4348,147763,Eth5NiW62QeegjonEwzsKZ7huvzhHIVn,fbPkOYLVPtPgIt0MxizjfFJov3JbHyAi,1,0,0,0,0,0,1,0,1,0.14285714285714285,1,0.0,0,0,0,0,0,0,0,1,0,0,1,1
4349,147764,J2kOdVfbOVzDYlg6JttZzYj1ijMbmOfa,fbPkOYLVPtPgIt0MxizjfFJov3JbHyAi,9,5,3,0,3,0,2,0,13,1.8571428571428572,1,0.0,1,3,0,3,4,0,0,2,0,7,6,1
4350,147768,1YQhKlVbSWSyRB9mcpedGa7M41YWFSmU,fbPkOYLVPtPgIt0MxizjfFJov3JbHyAi,8,2,1,0,1,3,7,1,15,2.142857142857143,1,0.0,0,1,0,1,2,3,0,7,1,2,13,1
4351,147769,KDxyrbt1mVWE3rzc84dyTK3d2hDl8n9y,fbPkOYLVPtPgIt0MxizjfFJov3JbHyAi,5,0,0,0,0,0,5,1,6,0.8571428571428571,1,0.0,0,0,0,0,0,0,0,5,1,0,6,1
4352,147770,tKs772tHpR5tE8Ceee9VXQcqKPNhx6zt,fbPkOYLVPtPgIt0MxizjfFJov3JbHyAi,1,0,0,0,0,0,1,0,1,0.14285714285714285,1,0.0,0,0,0,0,0,0,0,1,0,0,1,1
4353,147771,o1Z0mcnOVXV8qXjqUo78WebzsF68mpLE,fbPkOYLVPtPgIt0MxizjfFJov3JbHyAi,6,5,3,0,3,0,3,0,14,2.0,1,0.0,1,3,0,3,4,0,0,3,0,7,7,1
4354,147772,mFN7ZQWOcVa7LiP8Oo1W0WPTVxvqcwqO,fbPkOYLVPtPgIt0MxizjfFJov3JbHyAi,13,11,8,0,5,3,1,0,28,4.0,1,0.0,2,8,0,5,9,3,0,1,0,15,13,1
4355,147773,PvYWxw3yEbAoadQAkzpd3k3f7OpG6DoE,fbPkOYLVPtPgIt0MxizjfFJov3JbHyAi,5,2,1,0,1,0,2,0,6,0.8571428571428571,1,0.0,0,1,0,1,2,0,0,2,0,2,4,1
4356,147774,GwBsELCYAYNo2pcJ3Hwab6UtiG3ye1Qj,fbPkOYLVPtPgIt0MxizjfFJov3JbHyAi,19,20,13,0,7,5,9,0,54,7.714285714285714,4,0.0,0,13,0,7,20,5,0,9,0,20,34,1
4357,147775,wm3H7yjZZekKOdpMLsAK0Ro798c59IP1,fbPkOYLVPtPgIt0MxizjfFJov3JbHyAi,5,2,1,0,1,0,2,0,6,0.8571428571428571,1,0.0,0,1,0,1,2,0,0,2,0,2,4,1
4358,147776,aeUD1Q8xXZqlrQjVnPDT03gNdmvseEAG,fbPkOYLVPtPgIt0MxizjfFJov3JbHyAi,1,0,0,0,0,0,1,0,1,0.14285714285714285,1,0.0,0,0,0,0,0,0,0,1,0,0,1,1
4359,147778,UqdW6exgqWwrDooHrQBPDZ2CP0Vab4m7,fbPkOYLVPtPgIt0MxizjfFJov3JbHyAi,5,2,1,0,1,0,2,0,6,0.8571428571428571,1,0.0,0,1,0,1,2,0,0,2,0,2,4,1
4360,147780,Ov4mGbTBr19epZTdyb8WcJdW9YbNKnAm,fbPkOYLVPtPgIt0MxizjfFJov3JbHyAi,6,4,1,0,1,0,4,0,10,1.4285714285714286,1,0.0,0,1,0,1,4,0,0,4,0,2,8,1
4361,147781,5xOYe3GtSFIz24skQDwp2bS5mtMryo1i,fbPkOYLVPtPgIt0MxizjfFJov3JbHyAi,5,2,1,0,1,0,3,0,7,1.0,1,0.0,0,1,0,1,2,0,0,3,0,2,5,1
4362,147782,D1P1Hsf44r0eDI7GpWUjS6UCddknnKAg,fbPkOYLVPtPgIt0MxizjfFJov3JbHyAi,1,0,0,0,0,0,1,0,1,0.14285714285714285,1,0.0,0,0,0,0,0,0,0,1,0,0,1,1
4363,147783,T24KPVGcghdv6P7ytQKE6lhStbj1tDHE,fbPkOYLVPtPgIt0MxizjfFJov3JbHyAi,7,3,2,0,2,0,2,0,9,1.2857142857142858,1,0.0,0,2,0,2,3,0,0,2,0,4,5,1
4364,147784,K1OObDgsc7SijBamTjkwfIoFyHtZ3ZU6,fbPkOYLVPtPgIt0MxizjfFJov3JbHyAi,11,14,8,0,6,1,7,1,37,5.285714285714286,1,0.0,2,8,0,6,12,1,0,7,1,16,21,1
4365,147785,hOKkjeN6nHMO6D4VBHXzVFHaUdaVhrEZ,fbPkOYLVPtPgIt0MxizjfFJov3JbHyAi,6,3,1,0,1,6,6,0,17,2.4285714285714284,1,0.0,0,1,0,1,3,6,0,6,0,2,15,1
4366,147786,TuaZjf9Q9UcuuonmpyeQa8sFOZhELQm1,fbPkOYLVPtPgIt0MxizjfFJov3JbHyAi,8,3,2,0,2,0,9,0,16,2.2857142857142856,1,0.0,0,2,0,2,3,0,0,9,0,4,12,1
4367,147787,H69WO9aanRW4gzX23LgvL4SatIAdfXLh,fbPkOYLVPtPgIt0MxizjfFJov3JbHyAi,1,0,0,0,0,0,1,0,1,0.14285714285714285,1,0.0,0,0,0,0,0,0,0,1,0,0,1,1
4368,147789,xJLiT7aQ8wJaqtjbqZPuNyUe7xsRIYUx,fbPkOYLVPtPgIt0MxizjfFJov3JbHyAi,10,5,2,0,3,0,8,2,20,2.857142857142857,1,0.0,2,2,0,3,3,0,0,8,2,7,13,1
4369,147790,EQQGIzDw0KP7FL3ru9SVFlekfV91SRlx,fbPkOYLVPtPgIt0MxizjfFJov3JbHyAi,7,3,2,0,2,0,2,0,9,1.2857142857142858,1,0.0,0,2,0,2,3,0,0,2,0,4,5,1
4370,147791,UGbvFlSQXPNfRziPAOx4kHkl79A7jmGG,fbPkOYLVPtPgIt0MxizjfFJov3JbHyAi,18,29,9,12,12,1,3,0,66,9.428571428571429,2,0.0,8,9,12,12,21,1,0,3,0,41,25,1
4371,147793,UHhf3OS5KTsSmirrMDTBosghF0Ip6ptz,fbPkOYLVPtPgIt0MxizjfFJov3JbHyAi,1,0,0,0,0,0,1,0,1,0.14285714285714285,1,0.0,0,0,0,0,0,0,0,1,0,0,1,1
4372,147794,KsHIB2XNLK7Fs02PF75Xmf4i3fa72rIT,fbPkOYLVPtPgIt0MxizjfFJov3JbHyAi,2,0,0,0,0,0,2,0,2,0.2857142857142857,1,0.0,0,0,0,0,0,0,0,2,0,0,2,1
4373,148334,7gxdF7npc77h7z0KnU9ezGYqtBJqY4fQ,7GRhBDsirIGkRZBtSMEzNTyDr2JQm4xx,29,48,15,52,13,0,3,0,131,18.714285714285715,2,0.0,30,15,48,13,18,0,4,3,0,106,25,0
4374,148359,uZ1O39GxSmePAndNprQEBYYChQSQNkhB,fbPkOYLVPtPgIt0MxizjfFJov3JbHyAi,13,11,8,5,5,0,7,1,37,5.285714285714286,1,0.0,2,8,5,5,9,0,0,7,1,20,17,1
4375,148360,wJP9G4aa97RALoz7jgfom2Is1dozR5XV,fbPkOYLVPtPgIt0MxizjfFJov3JbHyAi,5,3,2,0,1,0,1,0,7,1.0,1,0.0,0,2,0,1,3,0,0,1,0,3,4,1
4376,148653,fO1rPCd8LF1QZM5kj2eXZwLqI6uO4Zpz,A3fsA9Zfv1X2fVEQhTw51lKENdNrEqT3,26,19,15,10,10,0,2,0,56,8.0,1,0.0,1,15,9,10,18,0,1,2,0,35,21,1
4377,148843,El7h5k9dEnkCTNiRD6ocpDGK1aq9r5Q4,SpATywNh6bZuzm8s1ceuBUnMUAeoAHHw,19,23,0,25,0,8,4,3,63,9.0,1,0.0,9,0,23,0,14,8,2,4,3,32,31,1
4378,148949,KVBhg9xLiQ9g29dG7acnqU2JhAhcB1WP,SpATywNh6bZuzm8s1ceuBUnMUAeoAHHw,2,0,0,0,0,7,1,0,8,1.1428571428571428,1,0.0,0,0,0,0,0,7,0,1,0,0,8,1
4379,149251,nK3rDT3I0HOsKd8MAJyaw5mnBzHCmQCb,SpATywNh6bZuzm8s1ceuBUnMUAeoAHHw,5,2,1,0,1,0,2,0,6,0.8571428571428571,1,0.0,0,1,0,1,2,0,0,2,0,2,4,1
4380,149431,I45Q3yivyiRN2kHVhbV8bUCfrXvtpUvU,SpATywNh6bZuzm8s1ceuBUnMUAeoAHHw,18,18,11,9,6,0,5,0,49,7.0,3,0.0,3,11,9,6,15,0,0,5,0,29,20,0
4381,149492,Ev6KS9MaK9gTGqPDnT9PUK5kybHZnCjh,RXDvfPUBYFlVdlueBFbLW0mhhAyGEqpt,15,20,10,0,7,0,1,0,38,5.428571428571429,2,0.0,0,10,0,7,20,0,0,1,0,17,21,1
4382,150105,G2qtWwR1edRN2N5qfu1AgRch8m00Htg9,SpATywNh6bZuzm8s1ceuBUnMUAeoAHHw,18,15,8,10,4,0,2,0,39,5.571428571428571,1,0.0,2,8,10,4,13,0,0,2,0,24,15,1
4383,152855,GPbq86k98Rz9tUbijEEopIymy9u0Fcyf,7GRhBDsirIGkRZBtSMEzNTyDr2JQm4xx,6,6,1,2,1,0,1,0,11,1.5714285714285714,1,0.0,3,1,2,1,3,0,0,1,0,7,4,1
4384,152864,hCBb0btCYW2ppCBVarI67JyCO4pJ7eb9,7GRhBDsirIGkRZBtSMEzNTyDr2JQm4xx,1,0,0,0,0,0,1,0,1,0.14285714285714285,1,0.0,0,0,0,0,0,0,0,1,0,0,1,1
4385,152879,dqSfWCCLLdDoawrlG8LB6YtjPp851gTf,7GRhBDsirIGkRZBtSMEzNTyDr2JQm4xx,1,0,0,0,0,0,1,0,1,0.14285714285714285,1,0.0,0,0,0,0,0,0,0,1,0,0,1,1
4386,152931,bKVslXuzEQ1pv4c6iV5mVjs6X6avUbmL,7GRhBDsirIGkRZBtSMEzNTyDr2JQm4xx,11,32,3,0,3,3,1,0,42,6.0,2,0.0,5,3,0,3,27,3,0,1,0,11,31,1
4387,152938,Lf93y7eBw6lMLWUxl2k8Aa6sTuqt3rkX,7GRhBDsirIGkRZBtSMEzNTyDr2JQm4xx,38,65,19,57,20,2,15,2,180,25.714285714285715,1,0.0,31,19,51,20,34,2,6,15,2,121,59,1
4388,152954,sITNvJWxCzf6WaNIdOh2TIdks7kOsSJ9,7GRhBDsirIGkRZBtSMEzNTyDr2JQm4xx,1,0,0,0,0,0,1,0,1,0.14285714285714285,1,0.0,0,0,0,0,0,0,0,1,0,0,1,1
4389,152987,AzVjKFfX4LhEl6lfJyI7leulN5tgJJFC,7GRhBDsirIGkRZBtSMEzNTyDr2JQm4xx,2,0,0,0,0,0,2,0,2,0.2857142857142857,1,0.0,0,0,0,0,0,0,0,2,0,0,2,1
4390,152991,8x5LnIwANrYRfzVuO8KI6hCDTjG995Zm,7GRhBDsirIGkRZBtSMEzNTyDr2JQm4xx,36,34,9,214,0,0,2,0,259,37.0,1,0.0,16,9,191,0,18,0,23,2,0,216,43,1
4391,152997,Bos3zEEnAcYzPXQktMkJJ0ak5mhGWCAf,7GRhBDsirIGkRZBtSMEzNTyDr2JQm4xx,40,44,15,170,0,0,3,0,232,33.142857142857146,1,0.0,17,15,159,0,27,0,11,3,0,191,41,1
4392,153006,S2jcDn3vCeFbqJDKmfQ5CtCJMDMc0dCL,7GRhBDsirIGkRZBtSMEzNTyDr2JQm4xx,1,0,0,0,0,0,1,0,1,0.14285714285714285,1,0.0,0,0,0,0,0,0,0,1,0,0,1,1
4393,153011,MU2dpqeoXpRCc5hjW6jEYEhmjukPgsDA,7GRhBDsirIGkRZBtSMEzNTyDr2JQm4xx,1,0,0,0,0,0,1,0,1,0.14285714285714285,1,0.0,0,0,0,0,0,0,0,1,0,0,1,1
4394,153055,DQfW4bOWdBOe4SfBmetTmbxwKFxrUYju,7GRhBDsirIGkRZBtSMEzNTyDr2JQm4xx,29,51,2,68,4,17,9,1,152,21.714285714285715,1,0.0,24,2,58,4,27,17,10,9,1,88,64,1
4395,153110,G1Fi5Ihmt1UntL9sxYjXIiKyHUtRhwud,7GRhBDsirIGkRZBtSMEzNTyDr2JQm4xx,1,0,0,0,0,0,1,0,1,0.14285714285714285,1,0.0,0,0,0,0,0,0,0,1,0,0,1,1
4396,153161,wFvodFqghxL7iISMFbYXkYNq6P6eK5gH,7GRhBDsirIGkRZBtSMEzNTyDr2JQm4xx,1,0,0,0,0,0,1,0,1,0.14285714285714285,1,0.0,0,0,0,0,0,0,0,1,0,0,1,1
4397,153184,VhcJDUnonrNMNnFkqYhfbm6haKp8kch0,7GRhBDsirIGkRZBtSMEzNTyDr2JQm4xx,10,16,4,0,5,4,4,0,33,4.714285714285714,1,0.0,5,4,0,5,11,4,0,4,0,14,19,1
4398,153191,eYNvtk5CsI9HdFompLA9hNZLZOidbC7w,7GRhBDsirIGkRZBtSMEzNTyDr2JQm4xx,2,0,0,0,0,0,2,0,2,0.2857142857142857,1,0.0,0,0,0,0,0,0,0,2,0,0,2,1
4399,153231,cYX89S5aEiRwSUpLGmwi2u7t2zEOcoD7,SpATywNh6bZuzm8s1ceuBUnMUAeoAHHw,6,5,3,0,2,0,3,0,13,1.8571428571428572,2,0.0,0,3,0,2,5,0,0,3,0,5,8,1
4400,153253,DKdrh8xgsWflkjgGhFow61asDvGQGw1P,bWdj2GDclj5ofokWjzoa5jAwMkxCykd6,13,33,11,98,4,3,10,2,161,23.0,2,0.0,6,11,96,4,27,3,2,10,2,117,44,1
4401,153256,KLnx64Dkkv51tfpLPbQ8sIJ698FwQUkp,bWdj2GDclj5ofokWjzoa5jAwMkxCykd6,4,2,0,0,0,0,4,0,6,0.8571428571428571,1,0.0,0,0,0,0,2,0,0,4,0,0,6,1
4402,153264,yN30P4SLRbmDewtu5A5YdbrNC6oNgNQn,SpATywNh6bZuzm8s1ceuBUnMUAeoAHHw,21,31,0,26,0,3,5,0,65,9.285714285714286,1,0.0,8,0,25,0,23,3,1,5,0,33,32,1
4403,153286,qzyzNBM5k9TrDdDhv4o4ZBzLquisQf0j,bWdj2GDclj5ofokWjzoa5jAwMkxCykd6,5,11,1,0,0,0,2,0,14,2.0,2,0.0,2,1,0,0,9,0,0,2,0,3,11,1
4404,153297,vljlAhHGhHZt2ciFpy2bQxMoEL2SUwdk,A3fsA9Zfv1X2fVEQhTw51lKENdNrEqT3,7,6,0,0,0,0,2,0,8,1.1428571428571428,1,0.0,0,0,0,0,6,0,0,2,0,0,8,1
4405,153306,I45Q3yivyiRN2kHVhbV8bUCfrXvtpUvU,A3fsA9Zfv1X2fVEQhTw51lKENdNrEqT3,9,4,3,0,3,0,2,0,12,1.7142857142857142,1,0.0,0,3,0,3,4,0,0,2,0,6,6,1
4406,153308,erktNoGO81kr4QkrHCOsCmKD0qcxd37Z,bWdj2GDclj5ofokWjzoa5jAwMkxCykd6,5,2,1,0,1,0,2,0,6,0.8571428571428571,1,0.0,0,1,0,1,2,0,0,2,0,2,4,1
4407,153326,AZlc6zt0IWDCnhebkR8dcDm8Jn7On2BO,G8EPVSXsOYB5YQWZGiz1aVq5Pgr2GrQu,2,0,0,0,0,4,1,0,5,0.7142857142857143,1,0.0,0,0,0,0,0,4,0,1,0,0,5,1
4408,153339,kgtwfSxV6DlyR7XWJO7BpLSg33UPKjB8,SpATywNh6bZuzm8s1ceuBUnMUAeoAHHw,1,0,0,0,0,0,1,0,1,0.14285714285714285,1,0.0,0,0,0,0,0,0,0,1,0,0,1,1
4409,153348,rew0c3O7roxnm8EfAzYQGMCDX1NNxnod,bWdj2GDclj5ofokWjzoa5jAwMkxCykd6,5,2,1,0,1,0,2,0,6,0.8571428571428571,1,0.0,0,1,0,1,2,0,0,2,0,2,4,1
4410,153362,NAuTAy6LFtpkSTeaDzpzRRxCaq6qJCQ5,bWdj2GDclj5ofokWjzoa5jAwMkxCykd6,1,0,0,0,0,0,1,0,1,0.14285714285714285,1,0.0,0,0,0,0,0,0,0,1,0,0,1,1
4411,153375,EnaSTRqxkWjMR8pSWQe4ipdWniwPtGKE,A3fsA9Zfv1X2fVEQhTw51lKENdNrEqT3,1,0,0,0,0,0,1,0,1,0.14285714285714285,1,0.0,0,0,0,0,0,0,0,1,0,0,1,1
4412,153391,afQkAxUvdLu532EqkP2BO2E822Re7HYk,SpATywNh6bZuzm8s1ceuBUnMUAeoAHHw,1,0,0,0,0,0,1,0,1,0.14285714285714285,1,0.0,0,0,0,0,0,0,0,1,0,0,1,1
4413,153397,HQm7nMTOyi7HCPaL4vs2tkbd4DWxfE67,A3fsA9Zfv1X2fVEQhTw51lKENdNrEqT3,8,4,2,0,2,0,5,0,13,1.8571428571428572,1,0.0,1,2,0,2,3,0,0,5,0,5,8,1
4414,153405,SQBW44VzMb5zXQWTfzFzAP2RU7qxP2su,A3fsA9Zfv1X2fVEQhTw51lKENdNrEqT3,4,3,2,0,1,0,1,0,7,1.0,2,0.0,0,2,0,1,3,0,0,1,0,3,4,1
4415,153410,0akUPLtvQvvS6uDU84fTYZNIPYPvoH52,A3fsA9Zfv1X2fVEQhTw51lKENdNrEqT3,8,4,1,0,1,1,5,1,13,1.8571428571428572,1,0.0,0,1,0,1,4,1,0,5,1,2,11,1
4416,153427,BtyJK9nVdN1kc0SoyvBwk9Why1olo9fX,SpATywNh6bZuzm8s1ceuBUnMUAeoAHHw,4,2,1,0,0,0,2,0,5,0.7142857142857143,1,0.0,0,1,0,0,2,0,0,2,0,1,4,1
4417,153440,piC2LAhWCCsSJOB3RH6MaHzy9gHIudvG,RXDvfPUBYFlVdlueBFbLW0mhhAyGEqpt,1,0,0,0,0,0,1,0,1,0.14285714285714285,1,0.0,0,0,0,0,0,0,0,1,0,0,1,1
4418,153480,pwnvfCtqibSBzw9gewKZFVOUFkyHecrp,RXDvfPUBYFlVdlueBFbLW0mhhAyGEqpt,1,0,0,0,0,0,1,0,1,0.14285714285714285,1,0.0,0,0,0,0,0,0,0,1,0,0,1,1
4419,153509,EzJJd1vaXRdhAvKq2Q0XoWVWiA4HWk5i,bWdj2GDclj5ofokWjzoa5jAwMkxCykd6,2,0,0,0,0,0,3,0,3,0.42857142857142855,1,0.0,0,0,0,0,0,0,0,3,0,0,3,1
4420,153514,63urTnMQ6906ju0tncFpKl8xLgyyTd5d,SpATywNh6bZuzm8s1ceuBUnMUAeoAHHw,10,5,1,0,1,2,7,1,17,2.4285714285714284,1,0.0,0,1,0,1,5,2,0,7,1,2,15,1
4421,153534,am1ujnojA2ZUYWhKXji6KHqg6kwAFj5z,SpATywNh6bZuzm8s1ceuBUnMUAeoAHHw,7,3,2,0,2,0,2,0,9,1.2857142857142858,1,0.0,0,2,0,2,3,0,0,2,0,4,5,1
4422,153550,CfbsMYGg57bCv0HnMFe2zrw0mAeXuZTI,SpATywNh6bZuzm8s1ceuBUnMUAeoAHHw,2,0,0,0,0,0,2,0,2,0.2857142857142857,1,0.0,0,0,0,0,0,0,0,2,0,0,2,1
4423,153555,YqtqVDKc4pZH2IHRYh05LZbT8NkeJ2tA,bWdj2GDclj5ofokWjzoa5jAwMkxCykd6,10,8,3,0,2,1,8,1,23,3.2857142857142856,1,0.0,3,3,0,2,5,1,0,8,1,8,15,1
4424,153561,AxjnggPTKyT2aYQCBpgnjenDZZbNsOpc,G8EPVSXsOYB5YQWZGiz1aVq5Pgr2GrQu,6,6,2,0,2,0,5,0,15,2.142857142857143,1,0.0,0,2,0,2,6,0,0,5,0,4,11,1
4425,153566,UBlBWZ3qSNiPpjfNB2f0HBLc8JT09fQp,A3fsA9Zfv1X2fVEQhTw51lKENdNrEqT3,13,9,6,0,4,0,11,3,33,4.714285714285714,1,0.0,0,6,0,4,9,0,0,11,3,10,23,1
4426,153568,jR4AfVlqsecU2OD2EAAPnmIP3mzjfI1q,RXDvfPUBYFlVdlueBFbLW0mhhAyGEqpt,3,0,0,0,0,0,3,0,3,0.42857142857142855,1,0.0,0,0,0,0,0,0,0,3,0,0,3,1
4427,153581,6VwrXuZWbgcjNNDx17wfxtM1n4lp5Lty,SpATywNh6bZuzm8s1ceuBUnMUAeoAHHw,5,3,1,0,1,0,2,0,7,1.0,1,0.0,0,1,0,1,3,0,0,2,0,2,5,1
4428,153583,ManuYhUk0ydtDbFYHqGK5HcrqUDdhmXT,A3fsA9Zfv1X2fVEQhTw51lKENdNrEqT3,17,9,1,12,1,2,7,1,33,4.714285714285714,1,0.0,0,1,10,1,9,2,2,7,1,12,21,1
4429,153586,JtIk3EAEhmwR0FR2ilwFzJTkMTjDzXA6,bWdj2GDclj5ofokWjzoa5jAwMkxCykd6,5,4,2,0,2,0,2,0,10,1.4285714285714286,1,0.0,1,2,0,2,3,0,0,2,0,5,5,1
4430,153597,6eigRKdKORgy46hn8ZqOQWxZJBzNbSVK,SpATywNh6bZuzm8s1ceuBUnMUAeoAHHw,12,13,0,45,0,10,1,0,69,9.857142857142858,1,0.0,8,0,38,0,5,10,7,1,0,46,23,0
4431,153624,TQ1Tb2cgiG68xs6aUf696l3C3zHYq6fS,A3fsA9Zfv1X2fVEQhTw51lKENdNrEqT3,4,3,2,0,0,0,1,0,6,0.8571428571428571,1,0.0,0,2,0,0,3,0,0,1,0,2,4,1
4432,153627,Cx9UgN9CA3ZQNCspfULD8FGJJpSFtxJF,A3fsA9Zfv1X2fVEQhTw51lKENdNrEqT3,30,20,17,0,13,0,6,0,56,8.0,2,0.0,0,17,0,13,20,0,0,6,0,30,26,1
4433,153633,IRpbgsWkgoZJzwjoe9EnoRzUlAbnuMfL,SpATywNh6bZuzm8s1ceuBUnMUAeoAHHw,7,10,3,0,2,0,1,0,16,2.2857142857142856,1,0.0,0,3,0,2,10,0,0,1,0,5,11,1
4434,153667,htua1xywlnpsMMY7EJSOsurL86GI912X,SpATywNh6bZuzm8s1ceuBUnMUAeoAHHw,18,19,12,12,5,0,5,0,53,7.571428571428571,2,0.0,2,12,9,5,17,0,3,5,0,28,25,1
4435,153670,9CQfIvDiQz4gDArSnTXOgxNKUwJW75pD,G8EPVSXsOYB5YQWZGiz1aVq5Pgr2GrQu,7,5,3,0,1,0,2,0,11,1.5714285714285714,1,0.0,0,3,0,1,5,0,0,2,0,4,7,1
4436,153672,GLPmzj5hXdU3lPOHJ5T9KsJUoi44XCjZ,bWdj2GDclj5ofokWjzoa5jAwMkxCykd6,8,3,2,0,2,0,3,1,11,1.5714285714285714,1,0.0,0,2,0,2,3,0,0,3,1,4,7,1
4437,153675,ncZpzPYvUtQjJgcrnY99CiTzo4JQVsl8,A3fsA9Zfv1X2fVEQhTw51lKENdNrEqT3,1,0,0,0,0,0,1,0,1,0.14285714285714285,1,0.0,0,0,0,0,0,0,0,1,0,0,1,1
4438,153676,rMQIZQBxSTMFTRmvcfmpoYqCAUhMol3Y,bWdj2GDclj5ofokWjzoa5jAwMkxCykd6,4,5,0,0,0,0,1,0,6,0.8571428571428571,1,0.0,1,0,0,0,4,0,0,1,0,1,5,0
4439,153677,ncZpzPYvUtQjJgcrnY99CiTzo4JQVsl8,RXDvfPUBYFlVdlueBFbLW0mhhAyGEqpt,1,0,0,0,0,0,1,0,1,0.14285714285714285,1,0.0,0,0,0,0,0,0,0,1,0,0,1,1
4440,153683,X9vm4W9jxNs3PEUtGGsO0Yn0aFWIbkg5,SpATywNh6bZuzm8s1ceuBUnMUAeoAHHw,11,21,8,0,0,0,2,0,31,4.428571428571429,1,0.0,6,8,0,0,15,0,0,2,0,14,17,1
4441,153696,kQrbauxiC7YRwJ9kMbwlTSfqUjp3UrEF,SpATywNh6bZuzm8s1ceuBUnMUAeoAHHw,9,8,3,19,1,0,1,0,32,4.571428571428571,2,0.0,4,3,17,1,4,0,2,1,0,25,7,1
4442,153712,GQQgnryyOjGmrLa2rKAbo7L18aO95YIN,SpATywNh6bZuzm8s1ceuBUnMUAeoAHHw,8,6,4,0,4,0,1,0,15,2.142857142857143,1,0.0,0,4,0,4,6,0,0,1,0,8,7,1
4443,153714,hMspMrStrcDDx9Uzg5qhswDwr2Wyqchl,bWdj2GDclj5ofokWjzoa5jAwMkxCykd6,5,5,4,0,1,0,1,0,11,1.5714285714285714,1,0.0,0,4,0,1,5,0,0,1,0,5,6,1
4444,153717,ikhBAd1BuMTyBJimuuSlAf6s44URi8zu,A3fsA9Zfv1X2fVEQhTw51lKENdNrEqT3,14,6,4,0,3,6,10,5,34,4.857142857142857,1,0.0,1,4,0,3,5,6,0,10,5,8,26,1
4445,153719,9AI5pszWPE25mtEwaHMtbhaDZrYN4oZ9,SpATywNh6bZuzm8s1ceuBUnMUAeoAHHw,5,2,1,0,1,0,2,0,6,0.8571428571428571,1,0.0,0,1,0,1,2,0,0,2,0,2,4,1
4446,153723,TqRaDvXJpdWXGkJNi0RDsTtg47jRUl81,bWdj2GDclj5ofokWjzoa5jAwMkxCykd6,1,0,0,0,0,0,1,0,1,0.14285714285714285,1,0.0,0,0,0,0,0,0,0,1,0,0,1,0
4447,153728,58eQNUjs318sjON50Y8nkDIw70NM1q5r,A3fsA9Zfv1X2fVEQhTw51lKENdNrEqT3,3,1,0,0,0,0,2,0,3,0.42857142857142855,1,0.0,0,0,0,0,1,0,0,2,0,0,3,1
4448,153736,PjOclk6Yw0TIvLC3mHiumPaKYTUJC7i8,G8EPVSXsOYB5YQWZGiz1aVq5Pgr2GrQu,1,0,0,0,0,0,2,0,2,0.2857142857142857,1,0.0,0,0,0,0,0,0,0,2,0,0,2,1
4449,153740,EVmZGFFbud1idCrJ2HZ0M1Xnc7jp4QF2,SpATywNh6bZuzm8s1ceuBUnMUAeoAHHw,1,0,0,0,0,0,1,0,1,0.14285714285714285,1,0.0,0,0,0,0,0,0,0,1,0,0,1,1
4450,153751,sUtQh78DXyhh3vE9rxqMUoIBjqNSKrC0,A3fsA9Zfv1X2fVEQhTw51lKENdNrEqT3,9,4,3,0,3,0,2,1,13,1.8571428571428572,1,0.0,0,3,0,3,4,0,0,2,1,6,7,1
4451,153752,sUtQh78DXyhh3vE9rxqMUoIBjqNSKrC0,bWdj2GDclj5ofokWjzoa5jAwMkxCykd6,2,0,0,0,0,0,2,0,2,0.2857142857142857,1,0.0,0,0,0,0,0,0,0,2,0,0,2,1
4452,153760,sUtQh78DXyhh3vE9rxqMUoIBjqNSKrC0,RXDvfPUBYFlVdlueBFbLW0mhhAyGEqpt,1,0,0,0,0,0,1,0,1,0.14285714285714285,1,0.0,0,0,0,0,0,0,0,1,0,0,1,1
4453,153765,JTN1G4IwNqBxpxjKApCtLeoFv6NT4I58,SpATywNh6bZuzm8s1ceuBUnMUAeoAHHw,5,4,3,0,1,0,1,0,9,1.2857142857142858,1,0.0,0,3,0,1,4,0,0,1,0,4,5,1
4454,153767,mUDgTVmygSuewvWeFS0TPPpUtE7wznA7,SpATywNh6bZuzm8s1ceuBUnMUAeoAHHw,5,2,1,0,1,0,2,0,6,0.8571428571428571,1,0.0,0,1,0,1,2,0,0,2,0,2,4,0
4455,153791,qScEGLnewgguP1Ewzar5maJbQBA27NyN,SpATywNh6bZuzm8s1ceuBUnMUAeoAHHw,13,21,0,17,0,6,5,0,49,7.0,1,0.0,9,0,14,0,12,6,3,5,0,23,26,1
4456,153809,57xBvLPGpSkzxqkLuJgHQNjPmsEoPQJW,A3fsA9Zfv1X2fVEQhTw51lKENdNrEqT3,4,4,0,0,0,0,1,0,5,0.7142857142857143,1,0.0,0,0,0,0,4,0,0,1,0,0,5,1
4457,153818,LM1rmZxY7OzUOcYjeqeOXcU9AGsbnd9q,SpATywNh6bZuzm8s1ceuBUnMUAeoAHHw,5,2,1,0,1,0,2,0,6,0.8571428571428571,1,0.0,0,1,0,1,2,0,0,2,0,2,4,1
4458,153819,HkcPmWCSdk3INCYsquWGQGZKijdTCD0w,SpATywNh6bZuzm8s1ceuBUnMUAeoAHHw,5,5,2,0,1,0,1,0,9,1.2857142857142858,1,0.0,0,2,0,1,5,0,0,1,0,3,6,1
4459,153821,57xBvLPGpSkzxqkLuJgHQNjPmsEoPQJW,bWdj2GDclj5ofokWjzoa5jAwMkxCykd6,3,6,0,0,0,2,1,0,9,1.2857142857142858,1,0.0,1,0,0,0,5,2,0,1,0,1,8,1
4460,153822,GmUgGkHH917kYWGPPkvD4RSeUx3CJaej,SpATywNh6bZuzm8s1ceuBUnMUAeoAHHw,15,17,0,14,0,5,7,1,44,6.285714285714286,1,0.0,10,0,11,0,7,5,3,7,1,21,23,1
4461,153823,wsHwZ3NkY1tqHKUuOn0buAOnr2acx1MP,bWdj2GDclj5ofokWjzoa5jAwMkxCykd6,3,0,0,0,0,0,3,0,3,0.42857142857142855,1,0.0,0,0,0,0,0,0,0,3,0,0,3,1
4462,153831,uhU9XFMHqXe19d0SBpTzsSNqTtdSMXBT,bWdj2GDclj5ofokWjzoa5jAwMkxCykd6,1,0,0,0,0,0,1,0,1,0.14285714285714285,1,0.0,0,0,0,0,0,0,0,1,0,0,1,1
4463,153842,bdZOWERl4VN1w1rz4KfnRlahupg4gIpq,bWdj2GDclj5ofokWjzoa5jAwMkxCykd6,10,17,10,64,0,16,7,2,116,16.571428571428573,1,0.0,3,10,62,0,14,16,2,7,2,75,41,1
4464,153862,WCBxImuXCQhe4JCGgmUbhM2fHJqNW9fo,A3fsA9Zfv1X2fVEQhTw51lKENdNrEqT3,8,11,5,0,3,0,2,0,21,3.0,1,0.0,0,5,0,3,11,0,0,2,0,8,13,1
4465,153869,Ya9PqShf5x9jueZxN5yIDpfhkNWrfHAh,RXDvfPUBYFlVdlueBFbLW0mhhAyGEqpt,9,4,4,0,3,1,3,0,15,2.142857142857143,1,0.0,0,4,0,3,4,1,0,3,0,7,8,1
4466,153871,kyU7VEeDwoGKq58Y5h10sPBzrIAFqfVi,bWdj2GDclj5ofokWjzoa5jAwMkxCykd6,5,2,1,0,1,0,2,0,6,0.8571428571428571,1,0.0,0,1,0,1,2,0,0,2,0,2,4,1
4467,153873,lHqG7UT3evpRhAVEeXMKWozC3OBfRB6b,A3fsA9Zfv1X2fVEQhTw51lKENdNrEqT3,1,0,0,0,0,0,1,0,1,0.14285714285714285,1,0.0,0,0,0,0,0,0,0,1,0,0,1,1
4468,153874,KSxx5GQKyHs39JznmMANF7eJRsaveHfw,A3fsA9Zfv1X2fVEQhTw51lKENdNrEqT3,7,6,1,0,0,2,5,1,15,2.142857142857143,1,0.0,0,1,0,0,6,2,0,5,1,1,14,1
4469,153892,d2NzzaJnxOD8hORDU0JQIrwAo12srVeO,SpATywNh6bZuzm8s1ceuBUnMUAeoAHHw,6,8,6,0,3,0,2,0,19,2.7142857142857144,2,0.0,0,6,0,3,8,0,0,2,0,9,10,1
4470,153895,f3YcaJisiu4LNXF8c0nltyQqDOirQ4G3,bWdj2GDclj5ofokWjzoa5jAwMkxCykd6,8,7,4,0,2,5,5,1,24,3.4285714285714284,1,0.0,0,4,0,2,7,5,0,5,1,6,18,1
4471,153899,RuTxY8DaJW8mZYxEAeQrQJD3l4wbq41Q,bWdj2GDclj5ofokWjzoa5jAwMkxCykd6,5,3,1,0,1,0,2,0,7,1.0,1,0.0,0,1,0,1,3,0,0,2,0,2,5,1
4472,153900,idxxWwMKAxBMibSoM88bXM2M515R6wYi,SpATywNh6bZuzm8s1ceuBUnMUAeoAHHw,5,2,1,0,1,0,2,0,6,0.8571428571428571,1,0.0,0,1,0,1,2,0,0,2,0,2,4,1
4473,153903,XmbkXRvCaUzUbqcHrpRU9UVMv582qDRu,G8EPVSXsOYB5YQWZGiz1aVq5Pgr2GrQu,17,7,4,20,2,2,9,1,45,6.428571428571429,1,0.0,0,4,18,2,7,2,2,9,1,24,21,1
4474,153928,rWCtYQJxLY6x4HYR2cUOUU68SSwJtOXD,SpATywNh6bZuzm8s1ceuBUnMUAeoAHHw,1,0,0,0,0,0,1,0,1,0.14285714285714285,1,0.0,0,0,0,0,0,0,0,1,0,0,1,1
4475,153935,xCtx9oK39TlKlw1wuTfbxFcC7lD8Tvmu,SpATywNh6bZuzm8s1ceuBUnMUAeoAHHw,6,11,3,0,1,0,3,0,18,2.5714285714285716,1,0.0,0,3,0,1,11,0,0,3,0,4,14,1
4476,153936,UU4MEikmCGklRVK3djHNSk7yxxkesa3p,SpATywNh6bZuzm8s1ceuBUnMUAeoAHHw,6,5,0,0,1,0,2,0,8,1.1428571428571428,1,0.0,0,0,0,1,5,0,0,2,0,1,7,1
4477,153941,ECkqmAuIkv3ncN9wNJby8oOn15qTd9kR,A3fsA9Zfv1X2fVEQhTw51lKENdNrEqT3,1,0,0,0,0,0,1,0,1,0.14285714285714285,1,0.0,0,0,0,0,0,0,0,1,0,0,1,1
4478,153950,4IJ56QlJSL8avuRQEkrBcEyhUIO3LIP3,A3fsA9Zfv1X2fVEQhTw51lKENdNrEqT3,33,21,11,36,4,0,13,0,85,12.142857142857142,2,0.0,3,11,36,4,18,0,0,13,0,54,31,0
4479,153951,QcAEBwtOda13Q2hwEpOzUuFeV6Y52Ggz,SpATywNh6bZuzm8s1ceuBUnMUAeoAHHw,6,10,1,0,0,0,1,0,12,1.7142857142857142,2,0.0,0,1,0,0,10,0,0,1,0,1,11,1
4480,153958,LhMGo1H458StfoGsiIJMkiDJEIOqqbKe,SpATywNh6bZuzm8s1ceuBUnMUAeoAHHw,18,16,11,0,8,0,2,0,37,5.285714285714286,1,0.0,3,11,0,8,13,0,0,2,0,22,15,0
4481,153988,vN0Rkga5RDQhnR6Qd8HVKAqnd5DqO9Q9,G8EPVSXsOYB5YQWZGiz1aVq5Pgr2GrQu,3,0,0,0,0,0,3,0,3,0.42857142857142855,1,0.0,0,0,0,0,0,0,0,3,0,0,3,1
4482,153989,lqbdGj6Vu3etzwWvEelu4TAXnkcY6ywX,SpATywNh6bZuzm8s1ceuBUnMUAeoAHHw,5,2,1,0,1,0,2,0,6,0.8571428571428571,1,0.0,0,1,0,1,2,0,0,2,0,2,4,1
4483,153990,wUS4QMZENKgcJOovrFGfoZniw3fDJWWg,SpATywNh6bZuzm8s1ceuBUnMUAeoAHHw,15,13,7,22,1,0,4,0,47,6.714285714285714,2,0.0,4,7,20,1,9,0,2,4,0,32,15,0
4484,153995,Bj2SxvASGVcIXgTPxMzZPlX3DzMVAgje,bWdj2GDclj5ofokWjzoa5jAwMkxCykd6,6,4,1,2,2,0,3,0,12,1.7142857142857142,1,0.0,2,1,2,2,2,0,0,3,0,7,5,1
4485,153996,7IjzbYGXgciR2DhqsqrtMeDkNMFINoYx,SpATywNh6bZuzm8s1ceuBUnMUAeoAHHw,20,37,15,5,5,1,23,1,87,12.428571428571429,2,0.0,13,15,5,5,24,1,0,23,1,38,49,1
4486,153997,zdA78Dg0BGWLvIRxkEt1PHhxNyG6hsIH,SpATywNh6bZuzm8s1ceuBUnMUAeoAHHw,1,0,0,0,0,0,1,0,1,0.14285714285714285,1,0.0,0,0,0,0,0,0,0,1,0,0,1,1
4487,154002,oO8PkmS40wsHMDT2LhD46mYGdAQ8FooI,bWdj2GDclj5ofokWjzoa5jAwMkxCykd6,7,13,7,0,3,11,1,0,35,5.0,1,0.0,2,7,0,3,11,11,0,1,0,12,23,1
4488,154011,u1aZFlVWlqtE11RPrh292EwKCdah7ek7,SpATywNh6bZuzm8s1ceuBUnMUAeoAHHw,4,2,0,0,0,0,2,0,4,0.5714285714285714,1,0.0,0,0,0,0,2,0,0,2,0,0,4,1
4489,154040,zWXhTxTG418YOfBpnhuFBg2UPPJXEdZa,SpATywNh6bZuzm8s1ceuBUnMUAeoAHHw,5,3,1,0,1,0,1,0,6,0.8571428571428571,1,0.0,0,1,0,1,3,0,0,1,0,2,4,1
4490,154056,3v4pf4Z2sq302espsMpIgHq4VUPDIN8A,SpATywNh6bZuzm8s1ceuBUnMUAeoAHHw,5,2,1,0,1,1,2,0,7,1.0,1,0.0,0,1,0,1,2,1,0,2,0,2,5,1
4491,154062,TSAIY3YjXsZdZc9oVcWWYSbgnOAvAP3E,G8EPVSXsOYB5YQWZGiz1aVq5Pgr2GrQu,5,3,1,0,1,0,2,0,7,1.0,1,0.0,0,1,0,1,3,0,0,2,0,2,5,1
4492,154066,BJOmIWRDihyZz3o40vbdAfCNe0WIbLc5,SpATywNh6bZuzm8s1ceuBUnMUAeoAHHw,6,2,1,0,1,0,3,0,7,1.0,1,0.0,0,1,0,1,2,0,0,3,0,2,5,1
4493,154076,22YNnFMji9XXRm4684KBVp3G0eZTCIft,A3fsA9Zfv1X2fVEQhTw51lKENdNrEqT3,13,8,5,0,4,0,8,0,25,3.5714285714285716,1,0.0,0,5,0,4,8,0,0,8,0,9,16,1
4494,154091,3FZ7859u0AJ285S0tHRE6ylhfDMJda8K,SpATywNh6bZuzm8s1ceuBUnMUAeoAHHw,1,0,0,0,0,0,1,0,1,0.14285714285714285,1,0.0,0,0,0,0,0,0,0,1,0,0,1,1
4495,154093,p6TgFJdLQMaMzbR16kycIPcRPnBj3paK,SpATywNh6bZuzm8s1ceuBUnMUAeoAHHw,4,2,1,0,1,0,1,0,5,0.7142857142857143,1,0.0,0,1,0,1,2,0,0,1,0,2,3,1
4496,154101,SS2LhAp5I5Z43oIfHH4Ih7CTNU5vDf5h,SpATywNh6bZuzm8s1ceuBUnMUAeoAHHw,1,0,0,0,0,0,1,0,1,0.14285714285714285,1,0.0,0,0,0,0,0,0,0,1,0,0,1,1
4497,154104,9Jy1wR1kNKfVIlzkWjf6DnrfYfDGnPzT,SpATywNh6bZuzm8s1ceuBUnMUAeoAHHw,5,4,3,0,1,0,2,0,10,1.4285714285714286,1,0.0,0,3,0,1,4,0,0,2,0,4,6,0
4498,154109,Cx9AvhpaoGF7JJ71AI7APeANc2Vipt9I,SpATywNh6bZuzm8s1ceuBUnMUAeoAHHw,1,0,0,0,0,0,1,0,1,0.14285714285714285,1,0.0,0,0,0,0,0,0,0,1,0,0,1,1
4499,154111,fKBgr7W6Vaq7CaM5NPYdwouK9aGfjKnk,SpATywNh6bZuzm8s1ceuBUnMUAeoAHHw,4,3,0,0,0,0,5,0,8,1.1428571428571428,1,0.0,0,0,0,0,3,0,0,5,0,0,8,1
4500,154128,bw9Orpcerztec7DXXrZLdtk0pUJ9Agjc,RXDvfPUBYFlVdlueBFbLW0mhhAyGEqpt,12,6,1,3,1,1,3,0,15,2.142857142857143,1,0.0,1,1,3,1,5,1,0,3,0,6,9,1
4501,154145,MUAq8cgExXjyCvVsMiE64RjE0HwCMEx8,A3fsA9Zfv1X2fVEQhTw51lKENdNrEqT3,7,2,1,0,1,0,6,1,11,1.5714285714285714,1,0.0,0,1,0,1,2,0,0,6,1,2,9,1
4502,154161,YtJbqHCfQeko1zihs9n6E1Ly00ndbcI5,bWdj2GDclj5ofokWjzoa5jAwMkxCykd6,4,1,0,0,0,0,4,0,5,0.7142857142857143,1,0.0,0,0,0,0,1,0,0,4,0,0,5,1
4503,154171,2m1f0GkzC3lXY6f5kS8aatrSNoeQ2Cc4,SpATywNh6bZuzm8s1ceuBUnMUAeoAHHw,11,17,10,0,6,3,12,0,48,6.857142857142857,2,0.0,3,10,0,6,14,3,0,12,0,19,29,1
4504,154190,fZpfLVVUEp7GXISLcNFyxWveiOP0dldp,SpATywNh6bZuzm8s1ceuBUnMUAeoAHHw,8,15,0,0,0,0,1,0,16,2.2857142857142856,1,0.0,1,0,0,0,14,0,0,1,0,1,15,0
4505,154193,6HPRmmMDN5OSycgmfnsrqG7YAJbfsWTK,SpATywNh6bZuzm8s1ceuBUnMUAeoAHHw,19,25,8,29,3,0,3,0,68,9.714285714285714,2,0.0,8,8,27,3,17,0,2,3,0,46,22,1
4506,154199,bZtNzDzO2qmGZ75gSzCr8t2M40vhOtlI,A3fsA9Zfv1X2fVEQhTw51lKENdNrEqT3,9,4,2,0,1,2,10,1,20,2.857142857142857,2,0.0,0,2,0,1,4,2,0,10,1,3,17,0
4507,154200,ADL0cXowUMs4wyiAOHKMOrtTHu5tmUqi,bWdj2GDclj5ofokWjzoa5jAwMkxCykd6,6,10,5,0,1,0,6,0,22,3.142857142857143,3,0.0,0,5,0,1,10,0,0,6,0,6,16,1
4508,154484,iacqYcgHTn7FZ8NE4roe5kgAUjDF0efr,7GRhBDsirIGkRZBtSMEzNTyDr2JQm4xx,3,2,1,0,0,0,1,0,4,0.5714285714285714,1,0.0,0,1,0,0,2,0,0,1,0,1,3,1
4509,154583,asAtaJoAJHlf2G0ikRIi1BJt6dsbnxvW,7GRhBDsirIGkRZBtSMEzNTyDr2JQm4xx,2,0,0,0,0,0,5,0,5,0.7142857142857143,2,0.0,0,0,0,0,0,0,0,5,0,0,5,1
4510,155101,JbB7hpnQ5hVzqELznLtzJLRyOZ2rdnyH,A3fsA9Zfv1X2fVEQhTw51lKENdNrEqT3,4,2,1,0,0,0,2,0,5,0.7142857142857143,1,0.0,0,1,0,0,2,0,0,2,0,1,4,1
4511,155141,PUySp8Qi7ahosRvBWR6xsbTAmeC3pRdT,SpATywNh6bZuzm8s1ceuBUnMUAeoAHHw,19,18,11,6,5,2,10,0,52,7.428571428571429,2,0.0,2,11,6,5,16,2,0,10,0,24,28,0
4512,155562,f7tZxTkA0B7yOxMWeydGO2hW0y86mAhD,RXDvfPUBYFlVdlueBFbLW0mhhAyGEqpt,13,7,5,0,5,0,4,0,21,3.0,1,0.0,1,5,0,5,6,0,0,4,0,11,10,1
4513,156211,KDWP2k3afTGhSxEaH7oA3UMXbJchV5C0,SpATywNh6bZuzm8s1ceuBUnMUAeoAHHw,6,4,1,0,1,0,2,0,8,1.1428571428571428,1,0.0,0,1,0,1,4,0,0,2,0,2,6,0
4514,156384,eQeAZJfAlQDBFNhBayGkUGtYxXtMJqJ1,A3fsA9Zfv1X2fVEQhTw51lKENdNrEqT3,7,8,6,0,1,0,2,0,17,2.4285714285714284,1,0.0,0,6,0,1,8,0,0,2,0,7,10,1
4515,156559,Un3EzEE4Sz8i5Z84q9e50URbIAEkkVSB,bWdj2GDclj5ofokWjzoa5jAwMkxCykd6,8,5,1,0,1,1,7,1,16,2.2857142857142856,1,0.0,0,1,0,1,5,1,0,7,1,2,14,1
4516,156708,qzgqMBszLUnJd9ZV8Zyg9x0an59yJyuH,A3fsA9Zfv1X2fVEQhTw51lKENdNrEqT3,7,7,4,0,1,0,2,0,14,2.0,1,0.0,0,4,0,1,7,0,0,2,0,5,9,1
4517,157312,9FHojamNYxBNrQ6PYQ6fNVNJw4Al6wFf,7GRhBDsirIGkRZBtSMEzNTyDr2JQm4xx,28,69,4,8,8,3,17,2,111,15.857142857142858,1,0.0,28,4,6,8,41,3,2,17,2,46,65,1
4518,157493,oBNu1yheXNm4QzvTpRG6uVhpeMCjpi7n,7GRhBDsirIGkRZBtSMEzNTyDr2JQm4xx,20,15,12,10,10,0,2,0,49,7.0,1,0.0,2,12,10,10,13,0,0,2,0,34,15,1
4519,161706,2XDpaAo3slMsrFQXFgtVX89IlqkzpX74,7GRhBDsirIGkRZBtSMEzNTyDr2JQm4xx,25,42,4,45,0,9,2,0,102,14.571428571428571,1,0.0,23,4,37,0,19,9,8,2,0,64,38,1
4520,161713,ySy2zYThCkVZr5MjEXuKxq60wfOynxkJ,7GRhBDsirIGkRZBtSMEzNTyDr2JQm4xx,1,0,0,0,0,0,1,0,1,0.14285714285714285,1,0.0,0,0,0,0,0,0,0,1,0,0,1,1
4521,161720,xdxiKeJYKflgdr88D3HSJXuR1e81YpjG,7GRhBDsirIGkRZBtSMEzNTyDr2JQm4xx,3,2,1,0,0,0,1,0,4,0.5714285714285714,1,0.0,0,1,0,0,2,0,0,1,0,1,3,1
4522,161747,i7uheDJIh5lOS1HvZimsF1kp1fKEvbnh,7GRhBDsirIGkRZBtSMEzNTyDr2JQm4xx,1,0,0,0,0,0,1,0,1,0.14285714285714285,1,0.0,0,0,0,0,0,0,0,1,0,0,1,1
4523,161754,Xipj7T5lLiw1KZ1W0l4R2RMWExB1p24F,7GRhBDsirIGkRZBtSMEzNTyDr2JQm4xx,1,0,0,0,0,0,1,0,1,0.14285714285714285,1,0.0,0,0,0,0,0,0,0,1,0,0,1,1
4524,161876,rwuM6JXyr9NW5skD2mjToJGXTpHNXOXm,7GRhBDsirIGkRZBtSMEzNTyDr2JQm4xx,10,6,4,0,2,0,4,0,16,2.2857142857142856,1,0.0,0,4,0,2,6,0,0,4,0,6,10,1
4525,161903,UtNvwiEIu7iQRo2Po9FxglHJbAYaDW68,7GRhBDsirIGkRZBtSMEzNTyDr2JQm4xx,9,18,2,14,1,8,2,0,45,6.428571428571429,2,0.0,6,2,12,1,12,8,2,2,0,21,24,0
4526,161916,UwYS4S13mN9PKtlnG61IUx3MqUPXsSwd,7GRhBDsirIGkRZBtSMEzNTyDr2JQm4xx,1,0,0,0,0,0,1,0,1,0.14285714285714285,1,0.0,0,0,0,0,0,0,0,1,0,0,1,1
4527,161917,ClHMnOLy9vZKRtNjcA9yPWajeNvRCNdE,7GRhBDsirIGkRZBtSMEzNTyDr2JQm4xx,30,56,10,67,8,0,1,0,142,20.285714285714285,1,0.0,20,10,61,8,36,0,6,1,0,99,43,1
4528,161935,uKGXhzbiDEpxCHjVlf9dmkGcQbxLosVe,7GRhBDsirIGkRZBtSMEzNTyDr2JQm4xx,14,12,8,0,5,0,2,0,27,3.857142857142857,1,0.0,0,8,0,5,12,0,0,2,0,13,14,1
4529,161939,5kEshmgSAUGvBEOsnsKU8IViB0lkOwoD,7GRhBDsirIGkRZBtSMEzNTyDr2JQm4xx,10,5,0,48,0,0,2,0,55,7.857142857142857,1,0.0,2,0,43,0,3,0,5,2,0,45,10,1
4530,161972,MXpZg6Y3WvwOURUS1VvgXTxhk1pXKVY7,7GRhBDsirIGkRZBtSMEzNTyDr2JQm4xx,13,11,5,12,6,0,1,0,35,5.0,1,0.0,5,5,10,6,6,0,2,1,0,26,9,1
4531,161994,ePOpOKycvORTPdc6DfieYb44dd8ej3gR,7GRhBDsirIGkRZBtSMEzNTyDr2JQm4xx,1,0,0,0,0,0,1,0,1,0.14285714285714285,1,0.0,0,0,0,0,0,0,0,1,0,0,1,1
4532,162062,J8ozccvPLhHs7wXw9VrsAZ8xFj3qhhGw,7GRhBDsirIGkRZBtSMEzNTyDr2JQm4xx,4,4,2,0,0,0,1,0,7,1.0,1,0.0,0,2,0,0,4,0,0,1,0,2,5,1
4533,162105,iJS4NO25TGJOkDkxwNThNbes0mRasAmQ,7GRhBDsirIGkRZBtSMEzNTyDr2JQm4xx,17,14,7,16,8,0,2,0,47,6.714285714285714,1,0.0,4,7,14,8,10,0,2,2,0,33,14,1
4534,162121,jjgQ4rbsYW6nenx45QcLulM61xyCV5lA,7GRhBDsirIGkRZBtSMEzNTyDr2JQm4xx,1,0,0,0,0,0,1,0,1,0.14285714285714285,1,0.0,0,0,0,0,0,0,0,1,0,0,1,1
4535,162160,oBhK6ZD6VFllj6i4Noya3bCJzaI8iNet,7GRhBDsirIGkRZBtSMEzNTyDr2JQm4xx,1,0,0,0,0,0,1,0,1,0.14285714285714285,1,0.0,0,0,0,0,0,0,0,1,0,0,1,1
4536,162259,ZttplEH5TKj1WzPyzoO9Df2vFzi15P8B,7GRhBDsirIGkRZBtSMEzNTyDr2JQm4xx,5,2,1,0,1,0,2,0,6,0.8571428571428571,1,0.0,0,1,0,1,2,0,0,2,0,2,4,0
4537,162270,CXpq1UcG0elhHuiCZeD2FXcwR7rCcPqM,7GRhBDsirIGkRZBtSMEzNTyDr2JQm4xx,1,0,0,0,0,0,1,0,1,0.14285714285714285,1,0.0,0,0,0,0,0,0,0,1,0,0,1,1
4538,162310,IY2XGmMLdQpnN2CAArJJlJXjbbQc8pm5,7GRhBDsirIGkRZBtSMEzNTyDr2JQm4xx,9,3,3,0,3,0,4,1,14,2.0,1,0.0,0,3,0,3,3,0,0,4,1,6,8,1
4539,162313,Ql4EosuzRo0tVj3lvTLhkLOyEsWZly6m,7GRhBDsirIGkRZBtSMEzNTyDr2JQm4xx,18,17,6,27,7,3,4,0,64,9.142857142857142,1,0.0,8,6,24,7,9,3,3,4,0,45,19,1
4540,162315,eLddk0FueVUEJUwpfOsyoO4vLUtPFHIZ,7GRhBDsirIGkRZBtSMEzNTyDr2JQm4xx,2,0,0,0,0,0,2,0,2,0.2857142857142857,1,0.0,0,0,0,0,0,0,0,2,0,0,2,1
4541,162321,FRqEtBjptiNhO97ht9j9vzryGlyCBOWn,7GRhBDsirIGkRZBtSMEzNTyDr2JQm4xx,1,0,0,0,0,0,1,0,1,0.14285714285714285,1,0.0,0,0,0,0,0,0,0,1,0,0,1,1
4542,162361,SRWyybFCyRnJ5WkAnmW9p9zBXOYVWjli,7GRhBDsirIGkRZBtSMEzNTyDr2JQm4xx,8,4,3,0,3,0,3,1,14,2.0,1,0.0,0,3,0,3,4,0,0,3,1,6,8,1
4543,162368,1YVvREjW4GG7vGtDdZTgfavzuWoJyEQ1,7GRhBDsirIGkRZBtSMEzNTyDr2JQm4xx,3,2,1,0,0,0,1,0,4,0.5714285714285714,1,0.0,0,1,0,0,2,0,0,1,0,1,3,1
4544,162648,Nc3ZZeizgzMQ7ljgRcfUdDiH0EOAXMpI,fbPkOYLVPtPgIt0MxizjfFJov3JbHyAi,4,2,1,0,1,0,1,0,5,0.7142857142857143,1,0.0,0,1,0,1,2,0,0,1,0,2,3,1
4545,162649,0KUBjckzhPh04pcpref906kWaVGOckIo,fbPkOYLVPtPgIt0MxizjfFJov3JbHyAi,1,0,0,0,0,0,1,0,1,0.14285714285714285,1,0.0,0,0,0,0,0,0,0,1,0,0,1,1
4546,162650,V6E1tx9saR5jAji0JFYWv5QlYX2evnTz,fbPkOYLVPtPgIt0MxizjfFJov3JbHyAi,5,4,1,0,1,0,1,0,7,1.0,1,0.0,0,1,0,1,4,0,0,1,0,2,5,1
4547,162651,YowQZlyvBksxQT6KgTXhQMJmbU93kRLD,fbPkOYLVPtPgIt0MxizjfFJov3JbHyAi,9,4,3,0,2,0,6,0,15,2.142857142857143,2,0.0,0,3,0,2,4,0,0,6,0,5,10,1
4548,162652,ez8FDX1i0b7pyEME5JxBBRyGHo5i1NxT,fbPkOYLVPtPgIt0MxizjfFJov3JbHyAi,5,2,1,0,1,0,11,0,15,2.142857142857143,1,0.0,0,1,0,1,2,0,0,11,0,2,13,1
4549,162656,KSRVmTGtqcEHSDvxEeA6R7dUXFztkOiS,fbPkOYLVPtPgIt0MxizjfFJov3JbHyAi,9,3,2,0,2,1,10,0,18,2.5714285714285716,1,0.0,0,2,0,2,3,1,0,10,0,4,14,1
4550,162657,2D1HXSTD406ltsrZw4ApG5jDeXzE2KN2,fbPkOYLVPtPgIt0MxizjfFJov3JbHyAi,9,4,3,0,3,0,6,1,17,2.4285714285714284,1,0.0,0,3,0,3,4,0,0,6,1,6,11,1
4551,162658,xC5auIx5EjJCsJXVxhOLOCVWQh5LEXXH,fbPkOYLVPtPgIt0MxizjfFJov3JbHyAi,6,7,4,0,0,0,1,0,12,1.7142857142857142,1,0.0,0,4,0,0,7,0,0,1,0,4,8,1
4552,162659,WSgIm6djd7gHeBntYx8K78vnaXdzEUiL,fbPkOYLVPtPgIt0MxizjfFJov3JbHyAi,1,0,0,0,0,0,1,0,1,0.14285714285714285,1,0.0,0,0,0,0,0,0,0,1,0,0,1,1
4553,162660,llYG1mfEDeV8Y5AFdIVbdEPymP3mr3rj,fbPkOYLVPtPgIt0MxizjfFJov3JbHyAi,6,2,1,0,1,0,3,0,7,1.0,1,0.0,0,1,0,1,2,0,0,3,0,2,5,1
4554,162661,KZBxo2oXfcrXYFa3c9hEkQ12gjuvG6yO,fbPkOYLVPtPgIt0MxizjfFJov3JbHyAi,13,18,8,0,4,0,6,0,36,5.142857142857143,1,0.0,1,8,0,4,17,0,0,6,0,13,23,1
4555,162666,naFnVVivN8IeDypOt2hjD9CIwDCj76XP,fbPkOYLVPtPgIt0MxizjfFJov3JbHyAi,9,4,3,0,3,0,4,0,14,2.0,1,0.0,0,3,0,3,4,0,0,4,0,6,8,1
4556,162671,MH888ZUNYQEtzY7davmN9IOBnnNRrZa7,fbPkOYLVPtPgIt0MxizjfFJov3JbHyAi,2,0,0,0,0,0,6,0,6,0.8571428571428571,1,0.0,0,0,0,0,0,0,0,6,0,0,6,1
4557,162673,7l3GpI16MslYkR5zIHoJyawqfDaUFhUp,fbPkOYLVPtPgIt0MxizjfFJov3JbHyAi,12,30,8,16,11,7,5,0,77,11.0,2,0.0,15,8,13,11,15,7,3,5,0,47,30,1
4558,162676,yYnx2Djc2xdWmysqfYS5LaytJ644aZht,fbPkOYLVPtPgIt0MxizjfFJov3JbHyAi,10,14,7,0,6,3,6,1,37,5.285714285714286,1,0.0,4,7,0,6,10,3,0,6,1,17,20,1
4559,162678,QLkjPbhzjYBuoRyN6jpM1zgzPhFcXPgV,fbPkOYLVPtPgIt0MxizjfFJov3JbHyAi,7,2,1,0,1,0,6,1,11,1.5714285714285714,1,0.0,0,1,0,1,2,0,0,6,1,2,9,1
4560,162679,4wGoSTuzJXBCojeNmaxk9GbR1KaCV7ql,fbPkOYLVPtPgIt0MxizjfFJov3JbHyAi,1,0,0,0,0,0,1,0,1,0.14285714285714285,1,0.0,0,0,0,0,0,0,0,1,0,0,1,1
4561,162680,Zt0s8z7D4BOSO5NcolkhNghzd1kCk6hq,fbPkOYLVPtPgIt0MxizjfFJov3JbHyAi,1,0,0,0,0,0,1,0,1,0.14285714285714285,1,0.0,0,0,0,0,0,0,0,1,0,0,1,1
4562,162681,uoKTE5T5YjIuFpYd6T7OJca437ewpV5r,fbPkOYLVPtPgIt0MxizjfFJov3JbHyAi,7,4,3,0,2,1,5,0,15,2.142857142857143,1,0.0,0,3,0,2,4,1,0,5,0,5,10,1
4563,162682,pvA5hAXeC4hqGygcnZUaZJq577cEj1jy,fbPkOYLVPtPgIt0MxizjfFJov3JbHyAi,4,2,0,0,0,0,4,0,6,0.8571428571428571,1,0.0,0,0,0,0,2,0,0,4,0,0,6,1
4564,162685,VW6QI6YQieHfuGH7gHn8hEJuMvSxxHAp,fbPkOYLVPtPgIt0MxizjfFJov3JbHyAi,7,6,4,0,3,0,2,0,15,2.142857142857143,1,0.0,0,4,0,3,6,0,0,2,0,7,8,1
4565,162687,y8AdDSbHENRUD5ii0AuyONW5YY98sBlv,fbPkOYLVPtPgIt0MxizjfFJov3JbHyAi,2,0,0,0,0,0,2,0,2,0.2857142857142857,1,0.0,0,0,0,0,0,0,0,2,0,0,2,1
4566,162689,OY5aMjVZYmvVnPhf0Ien1tS1qoTzYCve,fbPkOYLVPtPgIt0MxizjfFJov3JbHyAi,1,0,0,0,0,0,1,0,1,0.14285714285714285,1,0.0,0,0,0,0,0,0,0,1,0,0,1,1
4567,162690,4fAtuZyf3pqLNg4NAgnHL2LTveUsNAHR,fbPkOYLVPtPgIt0MxizjfFJov3JbHyAi,7,2,0,0,0,0,8,2,12,1.7142857142857142,1,0.0,0,0,0,0,2,0,0,8,2,0,12,1
4568,162691,RXL48ch4QpTtcFwRepyduTfKEKrGyTKN,fbPkOYLVPtPgIt0MxizjfFJov3JbHyAi,4,3,2,0,0,0,2,0,7,1.0,1,0.0,0,2,0,0,3,0,0,2,0,2,5,1
4569,162692,gwOQCfMjy3mPEOM9frEBJIEoEp54k479,fbPkOYLVPtPgIt0MxizjfFJov3JbHyAi,7,5,2,0,2,0,4,0,13,1.8571428571428572,1,0.0,2,2,0,2,3,0,0,4,0,6,7,1
4570,162693,cAiYY43X2fHcaVTtJkfbXwU4uE2YSYcT,fbPkOYLVPtPgIt0MxizjfFJov3JbHyAi,1,0,0,0,0,0,1,0,1,0.14285714285714285,1,0.0,0,0,0,0,0,0,0,1,0,0,1,1
4571,162694,Ht6ACDtkBUDQYG2zJ9PW4yD5omwx8FOt,fbPkOYLVPtPgIt0MxizjfFJov3JbHyAi,14,13,10,0,7,1,10,0,41,5.857142857142857,2,0.0,0,10,0,7,13,1,0,10,0,17,24,1
4572,162695,HjTLxjkRtxfAyk5V8KdvHAETDClCPqM8,fbPkOYLVPtPgIt0MxizjfFJov3JbHyAi,2,0,0,0,0,0,2,0,2,0.2857142857142857,1,0.0,0,0,0,0,0,0,0,2,0,0,2,1
4573,162696,d0rOxeHVhXN56S1SdxDqutEizIO79l17,fbPkOYLVPtPgIt0MxizjfFJov3JbHyAi,7,2,1,0,1,0,5,0,9,1.2857142857142858,1,0.0,0,1,0,1,2,0,0,5,0,2,7,1
4574,162697,itGGfLzW4kinBqXhqpdYcm0uN1rV3AUu,fbPkOYLVPtPgIt0MxizjfFJov3JbHyAi,8,2,1,0,1,35,10,1,50,7.142857142857143,1,0.0,0,1,0,1,2,35,0,10,1,2,48,1
4575,162698,Qkc0CJeX5rSUk4cMC7WmTWxFf636HopV,fbPkOYLVPtPgIt0MxizjfFJov3JbHyAi,6,3,1,0,1,0,2,0,7,1.0,1,0.0,0,1,0,1,3,0,0,2,0,2,5,1
4576,162699,zOMqB2xbzDTe4odeoQFhdTt3CHQxy4f2,fbPkOYLVPtPgIt0MxizjfFJov3JbHyAi,5,2,1,0,1,0,3,0,7,1.0,1,0.0,0,1,0,1,2,0,0,3,0,2,5,1
4577,162701,CqDZkF3Y4Ub1OGba7JosAdKhIi9VL2wR,fbPkOYLVPtPgIt0MxizjfFJov3JbHyAi,8,3,2,0,2,0,3,0,10,1.4285714285714286,1,0.0,0,2,0,2,3,0,0,3,0,4,6,1
4578,162703,Vvmg4GFkxtES0j2sr2rm1vhisTqz0hYp,fbPkOYLVPtPgIt0MxizjfFJov3JbHyAi,1,0,0,0,0,0,1,0,1,0.14285714285714285,1,0.0,0,0,0,0,0,0,0,1,0,0,1,1
4579,162705,EXeNK59x0ypZcTmicRInOt3hG7yAskPL,fbPkOYLVPtPgIt0MxizjfFJov3JbHyAi,1,0,0,0,0,0,1,0,1,0.14285714285714285,1,0.0,0,0,0,0,0,0,0,1,0,0,1,1
4580,162707,cqdnmjbJq0lDv2xgeKuzXqVr5xQytWr0,fbPkOYLVPtPgIt0MxizjfFJov3JbHyAi,1,0,0,0,0,0,1,0,1,0.14285714285714285,1,0.0,0,0,0,0,0,0,0,1,0,0,1,1
4581,162709,gD7dR7qYBA1tFY5jHEs9UR01plTA8iId,fbPkOYLVPtPgIt0MxizjfFJov3JbHyAi,8,8,5,0,2,0,4,0,19,2.7142857142857144,1,0.0,0,5,0,2,8,0,0,4,0,7,12,1
4582,162712,cXYqUXWJSTT7g3JkZOD6VVFxaOdV583i,fbPkOYLVPtPgIt0MxizjfFJov3JbHyAi,12,10,7,0,7,0,1,0,25,3.5714285714285716,1,0.0,1,7,0,7,9,0,0,1,0,15,10,1
4583,162714,HwZxiuOTyvjMb92UmTQViLX9URtxzqcc,fbPkOYLVPtPgIt0MxizjfFJov3JbHyAi,5,3,1,0,1,0,2,0,7,1.0,1,0.0,0,1,0,1,3,0,0,2,0,2,5,1
4584,163470,vbOiF6cnlAMZD8LbHyglMTSugmHV6DHA,RXDvfPUBYFlVdlueBFbLW0mhhAyGEqpt,12,11,6,0,4,0,9,0,30,4.285714285714286,1,0.0,2,6,0,4,9,0,0,9,0,12,18,1
4585,163549,kD7KrEgPns8NN7pPH4RunWGvMBAYF6OW,RXDvfPUBYFlVdlueBFbLW0mhhAyGEqpt,1,0,0,0,0,0,1,0,1,0.14285714285714285,1,0.0,0,0,0,0,0,0,0,1,0,0,1,0
4586,163833,KVtMqoPC0QDsoF45TzGd0BaG4fzRLrFd,SpATywNh6bZuzm8s1ceuBUnMUAeoAHHw,10,15,3,0,0,5,3,0,26,3.7142857142857144,1,0.0,0,3,0,0,15,5,0,3,0,3,23,1
4587,163836,SQBW44VzMb5zXQWTfzFzAP2RU7qxP2su,SpATywNh6bZuzm8s1ceuBUnMUAeoAHHw,5,9,3,0,1,0,1,0,14,2.0,1,0.0,4,3,0,1,5,0,0,1,0,8,6,1
4588,163934,5NIrDL6VpBxdJ6CyWDkvlKDqSlFChzvA,SpATywNh6bZuzm8s1ceuBUnMUAeoAHHw,18,12,10,8,6,0,1,0,37,5.285714285714286,1,0.0,0,10,8,6,12,0,0,1,0,24,13,0
4589,163982,cikSh880jtc26b154AaVhDiV1L6H6F3g,SpATywNh6bZuzm8s1ceuBUnMUAeoAHHw,7,6,4,0,2,0,4,0,16,2.2857142857142856,1,0.0,0,4,0,2,6,0,0,4,0,6,10,0
4590,164024,s5CJLvNaNPk4PiGqc6NTFvObROYB0OQQ,SpATywNh6bZuzm8s1ceuBUnMUAeoAHHw,14,18,0,9,0,0,3,0,30,4.285714285714286,1,0.0,4,0,9,0,14,0,0,3,0,13,17,0
4591,164497,r0yZNwEG828V0TMkCl61Reya5Y5HO5aR,SpATywNh6bZuzm8s1ceuBUnMUAeoAHHw,7,8,4,0,3,0,1,0,16,2.2857142857142856,1,0.0,0,4,0,3,8,0,0,1,0,7,9,1
4592,164522,KsAGy1yiN8nYXJpS6DHcH3mgCmV9iuno,RXDvfPUBYFlVdlueBFbLW0mhhAyGEqpt,17,10,9,0,6,0,1,0,26,3.7142857142857144,1,0.0,0,9,0,6,10,0,0,1,0,15,11,1
4593,164962,IwDrIHJtpM1SKA7Se5PnSGFRi77bmt0i,G8EPVSXsOYB5YQWZGiz1aVq5Pgr2GrQu,1,0,0,0,0,0,1,0,1,0.14285714285714285,1,0.0,0,0,0,0,0,0,0,1,0,0,1,1
4594,164963,IwDrIHJtpM1SKA7Se5PnSGFRi77bmt0i,bWdj2GDclj5ofokWjzoa5jAwMkxCykd6,2,0,0,0,0,0,2,0,2,0.2857142857142857,1,0.0,0,0,0,0,0,0,0,2,0,0,2,1
4595,164967,Jk09qA6alwSJzVuIqHppbDvZyk5u7ZHA,SpATywNh6bZuzm8s1ceuBUnMUAeoAHHw,16,19,0,14,0,1,4,1,39,5.571428571428571,1,0.0,8,0,13,0,11,1,1,4,1,21,18,1
4596,164978,NimtbKU9auo6KOsWhgU5KdNhvgw88gOw,bWdj2GDclj5ofokWjzoa5jAwMkxCykd6,5,2,1,0,1,0,2,0,6,0.8571428571428571,1,0.0,0,1,0,1,2,0,0,2,0,2,4,1
4597,164983,idGQZu8btUqvVr9UadRnlmVq4UYW0mU2,SpATywNh6bZuzm8s1ceuBUnMUAeoAHHw,1,0,0,0,0,0,1,0,1,0.14285714285714285,1,0.0,0,0,0,0,0,0,0,1,0,0,1,1
4598,164999,muJ6MIRhOdDL6SrbHsZ7Ks5a50Iz9AeC,G8EPVSXsOYB5YQWZGiz1aVq5Pgr2GrQu,40,54,19,24,14,1,5,0,117,16.714285714285715,1,0.0,12,19,13,14,42,1,11,5,0,58,59,0
4599,165000,nazeZS8BdRMOGGuVriyb5M21Pn5Qng36,G8EPVSXsOYB5YQWZGiz1aVq5Pgr2GrQu,1,0,0,0,0,0,1,0,1,0.14285714285714285,1,0.0,0,0,0,0,0,0,0,1,0,0,1,1
4600,165020,D1bGDJ4bL5x58ejhrACWlbqkfYdH5dQ6,G8EPVSXsOYB5YQWZGiz1aVq5Pgr2GrQu,2,0,0,0,0,0,5,0,5,0.7142857142857143,1,0.0,0,0,0,0,0,0,0,5,0,0,5,1
4601,165028,l1eQ9gI2TTb4dmIRNT0TZDzdHfiIL8H7,SpATywNh6bZuzm8s1ceuBUnMUAeoAHHw,4,2,1,0,1,0,1,0,5,0.7142857142857143,1,0.0,0,1,0,1,2,0,0,1,0,2,3,1
4602,165035,qKfZusm0R8jxltESvgi15dswdw73Gjlp,SpATywNh6bZuzm8s1ceuBUnMUAeoAHHw,4,6,3,0,0,0,2,0,11,1.5714285714285714,1,0.0,2,3,0,0,4,0,0,2,0,5,6,1
4603,165043,WLEMGeSXBUEafvCWOKhfcrxNQOC05nqM,bWdj2GDclj5ofokWjzoa5jAwMkxCykd6,6,2,1,0,1,0,5,1,10,1.4285714285714286,1,0.0,0,1,0,1,2,0,0,5,1,2,8,1
4604,165045,WzO2F8mFL9S6WyVuaBKRnAo7AfpK6MFq,SpATywNh6bZuzm8s1ceuBUnMUAeoAHHw,1,1,0,0,0,0,0,0,1,0.14285714285714285,1,0.0,0,0,0,0,1,0,0,0,0,0,1,1
4605,165064,PXNipZTrm6ag7nUFRb8wDcb09bEqCKm5,bWdj2GDclj5ofokWjzoa5jAwMkxCykd6,16,7,4,72,1,0,3,0,87,12.428571428571429,1,0.0,0,4,62,1,7,0,10,3,0,67,20,1
4606,165066,jaOmqqWd0RurZsiyeEDBNOhHZZXgisPQ,G8EPVSXsOYB5YQWZGiz1aVq5Pgr2GrQu,10,16,8,6,5,0,4,0,39,5.571428571428571,3,0.0,5,8,3,5,11,0,3,4,0,21,18,1
4607,165067,Wm4d7ifDaTgcR0GfUqwJt5OZKbYglRCq,bWdj2GDclj5ofokWjzoa5jAwMkxCykd6,1,0,0,0,0,0,1,0,1,0.14285714285714285,1,0.0,0,0,0,0,0,0,0,1,0,0,1,1
4608,165074,ij6lhOw7nYbJY8ZynpI4C6NhJmjCSNsH,bWdj2GDclj5ofokWjzoa5jAwMkxCykd6,7,6,2,0,3,1,4,1,17,2.4285714285714284,1,0.0,3,2,0,3,3,1,0,4,1,8,9,1
4609,165079,5B9CBBwEycq9mrKyjhnz4JxWbxAUtqXx,bWdj2GDclj5ofokWjzoa5jAwMkxCykd6,2,0,0,0,0,0,3,0,3,0.42857142857142855,1,0.0,0,0,0,0,0,0,0,3,0,0,3,1
4610,165098,zX1TLWT3E7MpbG4kzvZO6rEOvxyi9iAE,SpATywNh6bZuzm8s1ceuBUnMUAeoAHHw,4,2,1,0,1,0,1,0,5,0.7142857142857143,1,0.0,0,1,0,1,2,0,0,1,0,2,3,1
4611,165102,8IsnQQnfLzKrobCqyqui1F07ZqYQDg46,G8EPVSXsOYB5YQWZGiz1aVq5Pgr2GrQu,20,60,4,40,9,1,4,0,118,16.857142857142858,1,0.0,37,4,25,9,23,1,15,4,0,75,43,1
4612,165103,Tc9HVYhVH0mbvYBIDHqjba6NetUmurJg,SpATywNh6bZuzm8s1ceuBUnMUAeoAHHw,1,0,0,0,0,0,1,0,1,0.14285714285714285,1,0.0,0,0,0,0,0,0,0,1,0,0,1,1
4613,165110,o0yBW91wJfDjK5Q4nsWKulavXcIg9y1s,SpATywNh6bZuzm8s1ceuBUnMUAeoAHHw,1,0,0,0,0,0,1,0,1,0.14285714285714285,1,0.0,0,0,0,0,0,0,0,1,0,0,1,1
4614,165112,Ml3VPfyUCPhgR4WxRurT5TFwkYDGbSwH,SpATywNh6bZuzm8s1ceuBUnMUAeoAHHw,13,8,6,0,3,2,6,1,26,3.7142857142857144,1,0.0,0,6,0,3,8,2,0,6,1,9,17,1
4615,165114,o0yBW91wJfDjK5Q4nsWKulavXcIg9y1s,bWdj2GDclj5ofokWjzoa5jAwMkxCykd6,1,0,0,0,0,0,1,0,1,0.14285714285714285,1,0.0,0,0,0,0,0,0,0,1,0,0,1,1
4616,165124,h3uJUtBmEvmKgQr2Q8BC6FJ5GRugm894,bWdj2GDclj5ofokWjzoa5jAwMkxCykd6,3,0,0,0,0,0,3,0,3,0.42857142857142855,1,0.0,0,0,0,0,0,0,0,3,0,0,3,1
4617,165134,kaAc9OSRmTYmUacyuwJF8uvWHTHZhU6I,SpATywNh6bZuzm8s1ceuBUnMUAeoAHHw,3,2,0,0,0,0,1,0,3,0.42857142857142855,1,0.0,0,0,0,0,2,0,0,1,0,0,3,1
4618,165142,6PDeQOxrHkZQRUh0DA1ORZrJ9fgsXVig,SpATywNh6bZuzm8s1ceuBUnMUAeoAHHw,6,1,1,0,1,0,3,0,6,0.8571428571428571,1,0.0,0,1,0,1,1,0,0,3,0,2,4,1
4619,165148,pdZm7VuSx559JxocpNxvzJ1tzNwrAivH,SpATywNh6bZuzm8s1ceuBUnMUAeoAHHw,11,6,3,2,2,0,5,0,18,2.5714285714285716,1,0.0,2,3,2,2,4,0,0,5,0,9,9,1
4620,165152,KOUX6K1HiyGmH7Bu8fXQloWlM5ql067i,SpATywNh6bZuzm8s1ceuBUnMUAeoAHHw,1,0,0,0,0,0,1,0,1,0.14285714285714285,1,0.0,0,0,0,0,0,0,0,1,0,0,1,1
4621,165164,OhaXK8lO0kUyQn9GvgyzAKVV6q7Nf881,G8EPVSXsOYB5YQWZGiz1aVq5Pgr2GrQu,17,17,9,6,7,2,6,0,47,6.714285714285714,1,0.0,5,9,3,7,12,2,3,6,0,24,23,1
4622,165183,oBIU2QyRoi1Laa10XMgxHQ2fgzYMbfW0,RXDvfPUBYFlVdlueBFbLW0mhhAyGEqpt,7,4,3,0,1,0,2,0,10,1.4285714285714286,1,0.0,0,3,0,1,4,0,0,2,0,4,6,1
4623,165187,Wm4d7ifDaTgcR0GfUqwJt5OZKbYglRCq,SpATywNh6bZuzm8s1ceuBUnMUAeoAHHw,12,12,6,0,4,0,2,0,24,3.4285714285714284,1,0.0,0,6,0,4,12,0,0,2,0,10,14,1
4624,165190,gR8vpBOtEmg1p0U3mlFoyPZ2gKmD8M8k,bWdj2GDclj5ofokWjzoa5jAwMkxCykd6,1,0,0,0,0,0,1,0,1,0.14285714285714285,1,0.0,0,0,0,0,0,0,0,1,0,0,1,1
4625,165194,Qn3OccgDXQpcut9yLA9jXfau6FPbS72n,bWdj2GDclj5ofokWjzoa5jAwMkxCykd6,1,0,0,0,0,0,1,0,1,0.14285714285714285,1,0.0,0,0,0,0,0,0,0,1,0,0,1,1
4626,165205,EP7JoIZBfkdGbLwYL5xgvZ6bevF26Inu,SpATywNh6bZuzm8s1ceuBUnMUAeoAHHw,10,7,5,0,4,1,6,1,24,3.4285714285714284,1,0.0,0,5,0,4,7,1,0,6,1,9,15,1
4627,165208,kERhRnhdT9O0KrRIFldGxnMdaroWZIzP,bWdj2GDclj5ofokWjzoa5jAwMkxCykd6,8,4,0,0,0,2,6,1,13,1.8571428571428572,1,0.0,0,0,0,0,4,2,0,6,1,0,13,1
4628,165211,xNRLLiS6E0KC8Qrwk7McgtlhyqJ4FeFj,SpATywNh6bZuzm8s1ceuBUnMUAeoAHHw,1,0,0,0,0,0,1,0,1,0.14285714285714285,1,0.0,0,0,0,0,0,0,0,1,0,0,1,1
4629,165214,PaIBEPuJYWYGsLlp86uNBuTjQqpfezDI,G8EPVSXsOYB5YQWZGiz1aVq5Pgr2GrQu,6,3,1,0,1,0,2,0,7,1.0,1,0.0,0,1,0,1,3,0,0,2,0,2,5,1
4630,165215,1ak0eRZu8M5MlKljzewZoOjF7rom18Lp,SpATywNh6bZuzm8s1ceuBUnMUAeoAHHw,14,13,5,19,3,0,2,0,42,6.0,1,0.0,6,5,16,3,7,0,3,2,0,30,12,1
4631,165216,wricgx1QoMh70qtCt5pQGc1O8zgAKC8W,SpATywNh6bZuzm8s1ceuBUnMUAeoAHHw,6,2,2,0,0,1,3,0,8,1.1428571428571428,1,0.0,0,2,0,0,2,1,0,3,0,2,6,1
4632,165225,ofD9EgkVhROhMeSiR6CvxPzrkKAVlk9e,SpATywNh6bZuzm8s1ceuBUnMUAeoAHHw,4,2,0,0,0,0,2,0,4,0.5714285714285714,1,0.0,0,0,0,0,2,0,0,2,0,0,4,1
4633,165230,frKiIgyfjqTyVCSr7oHYXE3h3ahmBYPu,SpATywNh6bZuzm8s1ceuBUnMUAeoAHHw,9,4,3,0,3,0,2,0,12,1.7142857142857142,1,0.0,0,3,0,3,4,0,0,2,0,6,6,1
4634,165232,0tHH7qf3NqLHNPGNzZQ6gb0TO9yXFipC,SpATywNh6bZuzm8s1ceuBUnMUAeoAHHw,6,2,1,0,1,0,3,0,7,1.0,1,0.0,0,1,0,1,2,0,0,3,0,2,5,1
4635,165251,pQwQ7lq50KHnzLX18552MmFyRyK2NBh3,SpATywNh6bZuzm8s1ceuBUnMUAeoAHHw,2,1,1,0,0,0,0,0,2,0.2857142857142857,1,0.0,0,1,0,0,1,0,0,0,0,1,1,1
4636,165256,z9oiQyplHlMmhFVKenfY0OjMOlRO24Ty,SpATywNh6bZuzm8s1ceuBUnMUAeoAHHw,9,13,6,0,3,0,1,0,23,3.2857142857142856,1,0.0,0,6,0,3,13,0,0,1,0,9,14,0
4637,165259,5pl9QZtfcLF7zmReytidQLwrDKpwL5AY,G8EPVSXsOYB5YQWZGiz1aVq5Pgr2GrQu,18,14,10,0,9,0,5,1,39,5.571428571428571,1,0.0,2,10,0,9,12,0,0,5,1,21,18,1
4638,165269,NrHk4qmJXuD0TsjkQSnghKpk9ZjGAOyU,bWdj2GDclj5ofokWjzoa5jAwMkxCykd6,17,9,8,0,5,3,6,1,32,4.571428571428571,1,0.0,0,8,0,5,9,3,0,6,1,13,19,1
4639,165274,2EVUeEjVIM9F9OWjZ4WZKUdJeVQtpas5,SpATywNh6bZuzm8s1ceuBUnMUAeoAHHw,1,0,0,0,0,0,1,0,1,0.14285714285714285,1,0.0,0,0,0,0,0,0,0,1,0,0,1,0
4640,165275,nIaUSG86MljehwfWdoHPVChPOF3VCDSs,SpATywNh6bZuzm8s1ceuBUnMUAeoAHHw,1,0,0,0,0,0,1,0,1,0.14285714285714285,1,0.0,0,0,0,0,0,0,0,1,0,0,1,1
4641,165277,2HOmNQE0nDdyZUXCoC3g1k9N8rwQhnPY,RXDvfPUBYFlVdlueBFbLW0mhhAyGEqpt,3,1,0,0,0,0,2,0,3,0.42857142857142855,1,0.0,0,0,0,0,1,0,0,2,0,0,3,1
4642,165314,k1lsxE5YiR3LJaUe06e2F2PB8Llyh0eb,SpATywNh6bZuzm8s1ceuBUnMUAeoAHHw,7,3,2,0,2,0,2,0,9,1.2857142857142858,1,0.0,0,2,0,2,3,0,0,2,0,4,5,1
4643,165315,SZwbwmX9qJUPYLRS3g1l8moP7xnTFUCL,G8EPVSXsOYB5YQWZGiz1aVq5Pgr2GrQu,7,2,0,0,0,0,7,3,12,1.7142857142857142,1,0.0,0,0,0,0,2,0,0,7,3,0,12,1
4644,165316,QjeOsFvzphzL2UBVpgKTVxr9nbyzd09u,SpATywNh6bZuzm8s1ceuBUnMUAeoAHHw,5,4,3,0,3,0,2,0,12,1.7142857142857142,1,0.0,0,3,0,3,4,0,0,2,0,6,6,1
4645,165318,H5hq1RXMZvjdgAVV42G1HlcBUWfqaAQD,SpATywNh6bZuzm8s1ceuBUnMUAeoAHHw,6,3,0,0,0,0,3,0,6,0.8571428571428571,1,0.0,0,0,0,0,3,0,0,3,0,0,6,1
4646,165319,ELnpGakFfMjgNeN5VeZv7LPxT1yvRGG2,SpATywNh6bZuzm8s1ceuBUnMUAeoAHHw,1,0,0,0,0,0,1,0,1,0.14285714285714285,1,0.0,0,0,0,0,0,0,0,1,0,0,1,1
4647,165333,Vi6OE1s5C9epsDKkpv5rYzlTigz225uK,SpATywNh6bZuzm8s1ceuBUnMUAeoAHHw,7,3,2,0,2,1,2,0,10,1.4285714285714286,1,0.0,0,2,0,2,3,1,0,2,0,4,6,1
4648,165334,FsXs9JXJ9sX8GX6pr0IRKZCa3w12SCYq,G8EPVSXsOYB5YQWZGiz1aVq5Pgr2GrQu,5,2,1,0,1,0,3,0,7,1.0,1,0.0,0,1,0,1,2,0,0,3,0,2,5,1
4649,165337,SiDEVAV0vWeEC76b25xnijgEBNeEhRJy,SpATywNh6bZuzm8s1ceuBUnMUAeoAHHw,1,0,0,0,0,0,1,0,1,0.14285714285714285,1,0.0,0,0,0,0,0,0,0,1,0,0,1,1
4650,165340,oaoj9be4jW2Hot8wYgYrzLRvB0RU4KYy,SpATywNh6bZuzm8s1ceuBUnMUAeoAHHw,3,2,1,0,0,0,1,0,4,0.5714285714285714,1,0.0,0,1,0,0,2,0,0,1,0,1,3,1
4651,165353,SiDEVAV0vWeEC76b25xnijgEBNeEhRJy,bWdj2GDclj5ofokWjzoa5jAwMkxCykd6,1,0,0,0,0,0,1,0,1,0.14285714285714285,1,0.0,0,0,0,0,0,0,0,1,0,0,1,1
4652,165373,PhwD1ZKLhvgbOMQEx5zAfzeK2oPW1QkC,SpATywNh6bZuzm8s1ceuBUnMUAeoAHHw,1,0,0,0,0,0,1,0,1,0.14285714285714285,1,0.0,0,0,0,0,0,0,0,1,0,0,1,1
4653,165376,yR0NraAWygNs5cts7Fvc0zvbt2sGOVtI,SpATywNh6bZuzm8s1ceuBUnMUAeoAHHw,2,0,0,0,0,0,2,0,2,0.2857142857142857,1,0.0,0,0,0,0,0,0,0,2,0,0,2,1
4654,165378,H3h5uLXB3vbpRqjJs3VxBW591kIrIfb3,SpATywNh6bZuzm8s1ceuBUnMUAeoAHHw,4,3,1,0,1,0,2,0,7,1.0,1,0.0,0,1,0,1,3,0,0,2,0,2,5,0
4655,165390,QNGWdAKV7t5cBffSfxkRIBFN3DRIwrkT,SpATywNh6bZuzm8s1ceuBUnMUAeoAHHw,5,2,1,0,1,0,2,0,6,0.8571428571428571,1,0.0,0,1,0,1,2,0,0,2,0,2,4,1
4656,165419,G6cW0d2bzLHgB0vreFbhNx3GSiMBKbtv,bWdj2GDclj5ofokWjzoa5jAwMkxCykd6,4,3,1,0,1,0,1,0,6,0.8571428571428571,1,0.0,0,1,0,1,3,0,0,1,0,2,4,1
4657,165422,rROYd0uArbh5iBXaNezR5YmAESEuia7u,bWdj2GDclj5ofokWjzoa5jAwMkxCykd6,2,0,0,0,0,0,2,0,2,0.2857142857142857,1,0.0,0,0,0,0,0,0,0,2,0,0,2,1
4658,165427,QDpN8D19Mr8RZumTONWpZNlCWcHCCTbH,RXDvfPUBYFlVdlueBFbLW0mhhAyGEqpt,1,0,0,0,0,0,1,0,1,0.14285714285714285,1,0.0,0,0,0,0,0,0,0,1,0,0,1,1
4659,165428,MCX6PserzHPOVcVElkM3aC5c5GhSLDKg,SpATywNh6bZuzm8s1ceuBUnMUAeoAHHw,7,6,4,0,1,0,4,0,15,2.142857142857143,1,0.0,0,4,0,1,6,0,0,4,0,5,10,1
4660,165432,171vdjJg3ZQqEKQGGQqQb3EXy77TiE88,SpATywNh6bZuzm8s1ceuBUnMUAeoAHHw,2,0,0,0,0,0,2,0,2,0.2857142857142857,1,0.0,0,0,0,0,0,0,0,2,0,0,2,1
4661,165446,bWVYIzoXIGQmlYVnRkh7UPWZa7BftJJn,SpATywNh6bZuzm8s1ceuBUnMUAeoAHHw,2,0,0,0,0,0,2,0,2,0.2857142857142857,1,0.0,0,0,0,0,0,0,0,2,0,0,2,1
4662,165458,MQKEfJfHQjDI3xyJjnjmz4WwmQkpOvq2,bWdj2GDclj5ofokWjzoa5jAwMkxCykd6,3,2,1,0,0,0,2,0,5,0.7142857142857143,1,0.0,0,1,0,0,2,0,0,2,0,1,4,1
4663,165462,0RrAM7mPLzd3skZgaRP9NKB2Gqbiiam3,SpATywNh6bZuzm8s1ceuBUnMUAeoAHHw,3,2,0,0,0,0,2,0,4,0.5714285714285714,1,0.0,0,0,0,0,2,0,0,2,0,0,4,1
4664,165485,WXsAy1py6xNoAtmIQsPWN4rhdvzggrq1,SpATywNh6bZuzm8s1ceuBUnMUAeoAHHw,1,0,0,0,0,0,1,0,1,0.14285714285714285,1,0.0,0,0,0,0,0,0,0,1,0,0,1,1
4665,165489,WXsAy1py6xNoAtmIQsPWN4rhdvzggrq1,RXDvfPUBYFlVdlueBFbLW0mhhAyGEqpt,15,19,2,0,2,0,5,0,28,4.0,2,0.0,0,2,0,2,19,0,0,5,0,4,24,1
4666,165491,wg9kzusa79hS4fFC5hU9Laht66GWJcDA,RXDvfPUBYFlVdlueBFbLW0mhhAyGEqpt,1,0,0,0,0,0,1,0,1,0.14285714285714285,1,0.0,0,0,0,0,0,0,0,1,0,0,1,1
4667,165524,8wyKs5vTbaPjVAzqiPgYkv71kXMupepX,SpATywNh6bZuzm8s1ceuBUnMUAeoAHHw,6,3,1,0,1,2,2,0,9,1.2857142857142858,1,0.0,0,1,0,1,3,2,0,2,0,2,7,1
4668,165525,pLYG36p2jiNeVIQQxkAjPMCy7LTje21i,bWdj2GDclj5ofokWjzoa5jAwMkxCykd6,1,0,0,0,0,0,1,0,1,0.14285714285714285,1,0.0,0,0,0,0,0,0,0,1,0,0,1,1
4669,165530,2g49Uxh0o7UNSAoA6NR0GAmfGLF8JjXt,SpATywNh6bZuzm8s1ceuBUnMUAeoAHHw,11,14,0,23,1,7,3,0,48,6.857142857142857,1,0.0,8,0,20,1,6,7,3,3,0,29,19,1
4670,165531,srCZOXVyb44qlEge30QR25H9jokNeHzQ,SpATywNh6bZuzm8s1ceuBUnMUAeoAHHw,3,2,0,0,0,0,1,0,3,0.42857142857142855,1,0.0,0,0,0,0,2,0,0,1,0,0,3,0
4671,165536,1ImGMKyV7Di3tjZEdKRuDKDVzc7buyQG,SpATywNh6bZuzm8s1ceuBUnMUAeoAHHw,6,7,1,0,1,0,2,0,11,1.5714285714285714,1,0.0,0,1,0,1,7,0,0,2,0,2,9,1
4672,165539,GKKPaN5cNHTg4FgODePiiUlUMrULEfiu,SpATywNh6bZuzm8s1ceuBUnMUAeoAHHw,8,6,4,0,3,0,2,0,15,2.142857142857143,1,0.0,0,4,0,3,6,0,0,2,0,7,8,1
4673,165563,OIJqLsLQ0l4P9wwH2Os3C8W1InCTTS4l,SpATywNh6bZuzm8s1ceuBUnMUAeoAHHw,1,0,0,0,0,0,1,0,1,0.14285714285714285,1,0.0,0,0,0,0,0,0,0,1,0,0,1,1
4674,165566,Ml5BpcJCzlIYi0qFUUXB9FVaOk4IObDm,SpATywNh6bZuzm8s1ceuBUnMUAeoAHHw,5,4,0,0,0,0,2,0,6,0.8571428571428571,1,0.0,0,0,0,0,4,0,0,2,0,0,6,1
4675,165576,5fYqTmVKkWf8WeRMHDLJyPdR1zqgEtLM,SpATywNh6bZuzm8s1ceuBUnMUAeoAHHw,6,2,1,0,1,0,3,0,7,1.0,1,0.0,0,1,0,1,2,0,0,3,0,2,5,1
4676,165581,cp1vQuxrP7S8Bxj7ORUE5wjTIrRPfe4O,SpATywNh6bZuzm8s1ceuBUnMUAeoAHHw,7,8,0,0,0,0,5,1,14,2.0,1,0.0,2,0,0,0,6,0,0,5,1,2,12,1
4677,165592,JWwJ8KbdNh7FB84c1h8AD4pHgPCC9uj6,SpATywNh6bZuzm8s1ceuBUnMUAeoAHHw,8,4,3,0,3,0,1,0,11,1.5714285714285714,1,0.0,0,3,0,3,4,0,0,1,0,6,5,1
4678,165606,XmbLwxmQRLXz9T2ULgWW6uwVskMK6ds2,SpATywNh6bZuzm8s1ceuBUnMUAeoAHHw,17,23,0,12,0,0,1,0,36,5.142857142857143,1,0.0,4,0,12,0,19,0,0,1,0,16,20,1
4679,165612,KL4xQqmMI37CKNQsNsMM9emaoJIOAgLu,SpATywNh6bZuzm8s1ceuBUnMUAeoAHHw,8,9,2,0,1,0,3,0,15,2.142857142857143,1,0.0,0,2,0,1,9,0,0,3,0,3,12,1
4680,165617,fB4iAxEUCZ6aGoIPtPsbdJRsMMg2k42A,SpATywNh6bZuzm8s1ceuBUnMUAeoAHHw,10,8,5,2,1,0,3,0,19,2.7142857142857144,1,0.0,1,5,2,1,7,0,0,3,0,9,10,1
4681,165620,llrEAs9SMv6dYcefFrAK178vmmmglVzw,SpATywNh6bZuzm8s1ceuBUnMUAeoAHHw,9,5,3,0,2,1,6,1,18,2.5714285714285716,1,0.0,0,3,0,2,5,1,0,6,1,5,13,1
4682,165626,85DVIn1pw5TUgdo2ZtmymnwN8xrWNYCJ,G8EPVSXsOYB5YQWZGiz1aVq5Pgr2GrQu,1,0,0,0,0,0,1,0,1,0.14285714285714285,1,0.0,0,0,0,0,0,0,0,1,0,0,1,1
4683,165635,OLNUzQUHvlNsi2WFlH5eEyaieqKXrEz7,RXDvfPUBYFlVdlueBFbLW0mhhAyGEqpt,1,0,0,0,0,0,1,0,1,0.14285714285714285,1,0.0,0,0,0,0,0,0,0,1,0,0,1,1
4684,165640,GOWvSpqnQlbRYn3L1ovF5Dk4awbNrqjv,bWdj2GDclj5ofokWjzoa5jAwMkxCykd6,8,6,3,0,3,0,1,0,13,1.8571428571428572,1,0.0,0,3,0,3,6,0,0,1,0,6,7,1
4685,165648,45RDvtjbfAzQUYoMqYnUCNheNvdQTBQf,SpATywNh6bZuzm8s1ceuBUnMUAeoAHHw,1,0,0,0,0,0,1,0,1,0.14285714285714285,1,0.0,0,0,0,0,0,0,0,1,0,0,1,1
4686,165678,u5R8HPCpot8dC2SKEeIgSJg3TYEfNk6j,SpATywNh6bZuzm8s1ceuBUnMUAeoAHHw,5,2,1,0,1,0,2,0,6,0.8571428571428571,1,0.0,0,1,0,1,2,0,0,2,0,2,4,1
4687,165681,zZk0zQJxr08CnTp44rAPtrScPbsUq7U7,SpATywNh6bZuzm8s1ceuBUnMUAeoAHHw,6,3,2,0,1,0,3,0,9,1.2857142857142858,1,0.0,0,2,0,1,3,0,0,3,0,3,6,0
4688,165689,WVNZbdoXW7KA02SSLbuMYRv36MSZshQF,SpATywNh6bZuzm8s1ceuBUnMUAeoAHHw,5,3,2,0,2,0,2,0,9,1.2857142857142858,1,0.0,0,2,0,2,3,0,0,2,0,4,5,1
4689,165692,VKQwP2UGxFr8cW02yW69JgEmp944MwNR,SpATywNh6bZuzm8s1ceuBUnMUAeoAHHw,12,13,8,0,5,0,2,0,28,4.0,2,0.0,2,8,0,5,11,0,0,2,0,15,13,0
4690,165693,h7XFnfSxsjydwMPLvMejh0cg5xL1ZDd5,SpATywNh6bZuzm8s1ceuBUnMUAeoAHHw,5,2,1,0,1,0,2,0,6,0.8571428571428571,1,0.0,0,1,0,1,2,0,0,2,0,2,4,1
4691,165694,oNStIislotbuK2XCCskaFe8CInb3EbrY,SpATywNh6bZuzm8s1ceuBUnMUAeoAHHw,4,2,0,0,0,0,2,0,4,0.5714285714285714,1,0.0,0,0,0,0,2,0,0,2,0,0,4,1
4692,165697,0gS5Q732yxgOQo1BReYmVwLNG0PEmJtw,RXDvfPUBYFlVdlueBFbLW0mhhAyGEqpt,1,0,0,0,0,0,2,0,2,0.2857142857142857,1,0.0,0,0,0,0,0,0,0,2,0,0,2,1
4693,165703,9gwK2SMO9RzFmbR3NVs20xNig2HGOi8l,SpATywNh6bZuzm8s1ceuBUnMUAeoAHHw,7,4,2,0,2,0,2,0,10,1.4285714285714286,1,0.0,1,2,0,2,3,0,0,2,0,5,5,1
4694,165707,XOhs3C3hEbYCXLCkazKW0gKNbUWn1jg2,G8EPVSXsOYB5YQWZGiz1aVq5Pgr2GrQu,1,0,0,0,0,0,1,0,1,0.14285714285714285,1,0.0,0,0,0,0,0,0,0,1,0,0,1,1
4695,165710,ZSl6vjDvuQwmk9tpCIu9AiiDVVFMdktp,bWdj2GDclj5ofokWjzoa5jAwMkxCykd6,3,2,1,0,0,0,2,0,5,0.7142857142857143,2,0.0,0,1,0,0,2,0,0,2,0,1,4,1
4696,165738,rHhFTy1MHghalNQn9kKgxeI72dfIAI1Z,SpATywNh6bZuzm8s1ceuBUnMUAeoAHHw,2,0,0,0,0,0,2,0,2,0.2857142857142857,1,0.0,0,0,0,0,0,0,0,2,0,0,2,0
4697,165748,GrUpT0uWeNhnYmy4WRpw1EFafAAAhhi9,SpATywNh6bZuzm8s1ceuBUnMUAeoAHHw,13,18,0,15,0,10,3,0,46,6.571428571428571,1,0.0,4,0,15,0,14,10,0,3,0,19,27,0
4698,165758,BqlRpJCqwZj92xSZouRWh3sD1AZZKBEX,G8EPVSXsOYB5YQWZGiz1aVq5Pgr2GrQu,1,0,0,0,0,0,1,0,1,0.14285714285714285,1,0.0,0,0,0,0,0,0,0,1,0,0,1,1
4699,165760,zfQZFTiqHKQUgpAItjpYn7ZjkbIcP825,G8EPVSXsOYB5YQWZGiz1aVq5Pgr2GrQu,6,2,1,0,1,0,4,0,8,1.1428571428571428,1,0.0,0,1,0,1,2,0,0,4,0,2,6,1
4700,165762,6WkOKMKB5P2APoB7vbWWLXwAR3emifoG,A3fsA9Zfv1X2fVEQhTw51lKENdNrEqT3,7,5,4,0,1,0,1,0,11,1.5714285714285714,1,0.0,0,4,0,1,5,0,0,1,0,5,6,1
4701,165763,ON4mKUtTdsRS7Qi2xUjPqd2ovm0Dg75e,SpATywNh6bZuzm8s1ceuBUnMUAeoAHHw,9,11,5,6,0,1,4,0,27,3.857142857142857,2,0.0,1,5,5,0,10,1,1,4,0,11,16,1
4702,165793,NKdzAvohqx5ZB0phtZyAtuBxXKa68OBU,SpATywNh6bZuzm8s1ceuBUnMUAeoAHHw,3,2,0,0,0,0,1,0,3,0.42857142857142855,1,0.0,0,0,0,0,2,0,0,1,0,0,3,1
4703,165799,tWEnJYIhXMJ03Foo959mubaAJUHZPTw0,RXDvfPUBYFlVdlueBFbLW0mhhAyGEqpt,1,0,0,0,0,0,1,0,1,0.14285714285714285,1,0.0,0,0,0,0,0,0,0,1,0,0,1,1
4704,165814,0vxIliccHyPsFqS3FXAcl5CXDHX5ju89,SpATywNh6bZuzm8s1ceuBUnMUAeoAHHw,1,0,0,0,0,0,1,0,1,0.14285714285714285,1,0.0,0,0,0,0,0,0,0,1,0,0,1,1
4705,165819,RgSsBQ3nqtDrfLpSobr2YuUHRErLTR4s,RXDvfPUBYFlVdlueBFbLW0mhhAyGEqpt,11,7,6,0,5,0,1,0,19,2.7142857142857144,1,0.0,0,6,0,5,7,0,0,1,0,11,8,1
4706,166211,535rqCxCBVvAkDc6bSBePBKNVyS23A04,fbPkOYLVPtPgIt0MxizjfFJov3JbHyAi,7,3,1,0,2,0,2,0,8,1.1428571428571428,1,0.0,0,1,0,2,3,0,0,2,0,3,5,1
4707,167084,OtGMx6eKyVYjbz3L87VVmC99kyg1WjEl,SpATywNh6bZuzm8s1ceuBUnMUAeoAHHw,19,21,10,18,5,14,5,2,75,10.714285714285714,1,0.0,4,10,15,5,17,14,3,5,2,34,41,0
4708,167283,ilday4HM3BCIYcolQVgtTOYVZxbISCZm,G8EPVSXsOYB5YQWZGiz1aVq5Pgr2GrQu,8,6,3,0,1,2,4,0,16,2.2857142857142856,1,0.0,0,3,0,1,6,2,0,4,0,4,12,1
4709,167738,8MuGb55gUM18pukCITXgZoTSobqXs9G4,A3fsA9Zfv1X2fVEQhTw51lKENdNrEqT3,2,0,0,0,0,0,2,0,2,0.2857142857142857,1,0.0,0,0,0,0,0,0,0,2,0,0,2,1
4710,168016,Xdurokd2SSgNf25hifq07OxoiHEDcyiq,fbPkOYLVPtPgIt0MxizjfFJov3JbHyAi,5,6,4,0,0,2,4,0,16,2.2857142857142856,1,0.0,0,4,0,0,6,2,0,4,0,4,12,1
4711,170262,RHsk3gHUm8VEfb9FwEFf8vBDNKZZ0LWe,bWdj2GDclj5ofokWjzoa5jAwMkxCykd6,28,29,16,88,8,4,6,0,151,21.571428571428573,1,0.0,8,16,70,8,21,4,18,6,0,102,49,0
4712,170284,3RtHMyLQOrBsDYp6yo5VYdmS72cr3PBJ,bWdj2GDclj5ofokWjzoa5jAwMkxCykd6,5,1,1,0,1,0,3,0,6,0.8571428571428571,1,0.0,0,1,0,1,1,0,0,3,0,2,4,1
4713,170412,Z6SakRvyvh7ZuaV4DHEE1b3QLOpPcfOm,SpATywNh6bZuzm8s1ceuBUnMUAeoAHHw,9,7,1,12,0,0,1,0,21,3.0,1,0.0,2,1,12,0,5,0,0,1,0,15,6,0
4714,170681,cJJis1Eo88AzCRowxVa7rzvY4ZLonXwZ,A3fsA9Zfv1X2fVEQhTw51lKENdNrEqT3,6,2,1,0,1,0,4,0,8,1.1428571428571428,1,0.0,0,1,0,1,2,0,0,4,0,2,6,1
4715,172761,sL5jw3pLWZoRI7avI17oM60mfF67Acgz,fbPkOYLVPtPgIt0MxizjfFJov3JbHyAi,1,0,0,0,0,0,1,0,1,0.14285714285714285,1,0.0,0,0,0,0,0,0,0,1,0,0,1,0
4716,173927,2jcDulxQhwaZp6ERelJB4WRzpPoEb0N3,G8EPVSXsOYB5YQWZGiz1aVq5Pgr2GrQu,24,19,9,46,8,5,10,0,97,13.857142857142858,1,0.0,9,9,38,8,10,5,8,10,0,64,33,1
4717,174379,BeoWdDFNsVFqWVq3B4qjYh8vNjNTgwSB,A3fsA9Zfv1X2fVEQhTw51lKENdNrEqT3,3,2,1,0,0,0,5,0,8,1.1428571428571428,1,0.0,0,1,0,0,2,0,0,5,0,1,7,1
4718,174420,LKippngJk3cGSHQFQuBifcn7F1qfi1gi,A3fsA9Zfv1X2fVEQhTw51lKENdNrEqT3,7,3,2,0,2,0,2,0,9,1.2857142857142858,1,0.0,0,2,0,2,3,0,0,2,0,4,5,1
4719,174444,2dsmXUwyJ6i3C5akCdjurWqi0Hs9JJIw,A3fsA9Zfv1X2fVEQhTw51lKENdNrEqT3,4,2,1,0,1,0,1,0,5,0.7142857142857143,1,0.0,0,1,0,1,2,0,0,1,0,2,3,1
4720,174534,uxH2QBwZxSFN9LkkI09Zd3NZx6wgvi3y,A3fsA9Zfv1X2fVEQhTw51lKENdNrEqT3,7,4,1,0,1,0,2,0,8,1.1428571428571428,1,0.0,0,1,0,1,4,0,0,2,0,2,6,1
4721,174592,Q80okLXehG3FaUclazDQaglICbThrfeN,A3fsA9Zfv1X2fVEQhTw51lKENdNrEqT3,12,4,2,0,2,0,9,1,18,2.5714285714285716,1,0.0,0,2,0,2,4,0,0,9,1,4,14,1
4722,174614,TEtpertndC0kxUAzNDZsnaaHXZ1UiUgn,A3fsA9Zfv1X2fVEQhTw51lKENdNrEqT3,6,2,1,0,1,0,4,3,11,1.5714285714285714,1,0.0,0,1,0,1,2,0,0,4,3,2,9,1
4723,174645,lJdTg9WUYwumFfeQmhmLXhBEAFP0NsAi,A3fsA9Zfv1X2fVEQhTw51lKENdNrEqT3,1,0,0,0,0,0,1,0,1,0.14285714285714285,1,0.0,0,0,0,0,0,0,0,1,0,0,1,1
4724,174672,N5iDERl36Pe29yDG8gDe9a99dYgqwB7y,A3fsA9Zfv1X2fVEQhTw51lKENdNrEqT3,1,0,0,0,0,0,1,0,1,0.14285714285714285,1,0.0,0,0,0,0,0,0,0,1,0,0,1,1
4725,174695,mu7Zdr1ChN6xNMWE8Otd7Si7TQhm7pEQ,bWdj2GDclj5ofokWjzoa5jAwMkxCykd6,6,5,3,0,2,0,4,0,14,2.0,1,0.0,0,3,0,2,5,0,0,4,0,5,9,1
4726,174811,JdEJSTgj9mzyZgP3wbpkgBRlhmZAWyOb,A3fsA9Zfv1X2fVEQhTw51lKENdNrEqT3,8,6,1,0,1,0,3,0,11,1.5714285714285714,1,0.0,0,1,0,1,6,0,0,3,0,2,9,1
4727,174850,JsUvqozri9AItThk54BBjEwYIqDey9JK,SpATywNh6bZuzm8s1ceuBUnMUAeoAHHw,3,2,0,0,0,0,1,0,3,0.42857142857142855,1,0.0,0,0,0,0,2,0,0,1,0,0,3,1
4728,174890,JsUvqozri9AItThk54BBjEwYIqDey9JK,A3fsA9Zfv1X2fVEQhTw51lKENdNrEqT3,1,0,0,0,0,0,1,0,1,0.14285714285714285,1,0.0,0,0,0,0,0,0,0,1,0,0,1,1
4729,174896,W38DcguBOORgyx8AQARyx9O00yMNPg6e,A3fsA9Zfv1X2fVEQhTw51lKENdNrEqT3,20,11,10,0,8,0,1,0,30,4.285714285714286,1,0.0,0,10,0,8,11,0,0,1,0,18,12,1
4730,174947,YXkiTHpE2a6E2kDFUh3HT5sKHSlA7gXq,A3fsA9Zfv1X2fVEQhTw51lKENdNrEqT3,21,16,10,0,8,0,3,0,37,5.285714285714286,1,0.0,5,10,0,8,11,0,0,3,0,23,14,1
4731,175031,fiQPKilJkIFWShuteKFoAKrsoRjAoTQq,G8EPVSXsOYB5YQWZGiz1aVq5Pgr2GrQu,11,6,3,22,1,0,1,0,33,4.714285714285714,1,0.0,1,3,20,1,5,0,2,1,0,25,8,1
4732,175042,fN9yVRde7R2H7fN2gH8pJh2bfcNVmJQE,SpATywNh6bZuzm8s1ceuBUnMUAeoAHHw,4,3,1,0,1,0,1,0,6,0.8571428571428571,1,0.0,0,1,0,1,3,0,0,1,0,2,4,1
4733,175061,WoXtpP4H4ghgkRBv3UuiyrHP7GFAl55y,A3fsA9Zfv1X2fVEQhTw51lKENdNrEqT3,1,0,0,0,0,0,1,0,1,0.14285714285714285,1,0.0,0,0,0,0,0,0,0,1,0,0,1,1
4734,175139,Vdk84P68xIHXBGrWqw3oEozZYT063dLv,A3fsA9Zfv1X2fVEQhTw51lKENdNrEqT3,3,2,1,0,0,0,1,0,4,0.5714285714285714,1,0.0,0,1,0,0,2,0,0,1,0,1,3,1
4735,175145,U6qE2fx7rlT2WEmACzAkhjUhd8LCbR1p,A3fsA9Zfv1X2fVEQhTw51lKENdNrEqT3,8,4,3,0,3,0,1,0,11,1.5714285714285714,1,0.0,0,3,0,3,4,0,0,1,0,6,5,1
4736,175170,o9SCOAY5nuSxaVorNF1mq3E0AGKQbCox,A3fsA9Zfv1X2fVEQhTw51lKENdNrEqT3,1,0,0,0,0,0,1,0,1,0.14285714285714285,1,0.0,0,0,0,0,0,0,0,1,0,0,1,1
4737,175256,jdfd8H9lnYttHWf9Izxs2MscynFXyhGW,A3fsA9Zfv1X2fVEQhTw51lKENdNrEqT3,4,5,1,0,0,0,1,0,7,1.0,1,0.0,0,1,0,0,5,0,0,1,0,1,6,0
4738,175322,YaeMtpEn02jmas25d0067kgG6T0CswLK,A3fsA9Zfv1X2fVEQhTw51lKENdNrEqT3,1,0,0,0,0,0,1,0,1,0.14285714285714285,1,0.0,0,0,0,0,0,0,0,1,0,0,1,1
4739,175337,4jGp0wM4bWQL7YeW1fZnRYCrYjnWjDPp,A3fsA9Zfv1X2fVEQhTw51lKENdNrEqT3,2,0,0,0,0,0,2,0,2,0.2857142857142857,1,0.0,0,0,0,0,0,0,0,2,0,0,2,1
4740,175380,xyhTJkgGghEribeWkvfmDO529PeI6BOD,A3fsA9Zfv1X2fVEQhTw51lKENdNrEqT3,23,16,11,0,11,0,4,0,42,6.0,1,0.0,0,11,0,11,16,0,0,4,0,22,20,1
4741,175396,EvySN154YDM9eHA8rncD5Y4XnKitTOWj,A3fsA9Zfv1X2fVEQhTw51lKENdNrEqT3,1,0,0,0,0,0,1,0,1,0.14285714285714285,1,0.0,0,0,0,0,0,0,0,1,0,0,1,1
4742,175398,MoQLSLdgc8N78DNeGEQHypzHbyf063p0,A3fsA9Zfv1X2fVEQhTw51lKENdNrEqT3,1,0,0,0,0,0,1,0,1,0.14285714285714285,1,0.0,0,0,0,0,0,0,0,1,0,0,1,1
4743,175422,JLpYHpRsamf04qcVxCPYwLYYhT8v6H5r,A3fsA9Zfv1X2fVEQhTw51lKENdNrEqT3,9,4,3,0,3,0,2,0,12,1.7142857142857142,1,0.0,0,3,0,3,4,0,0,2,0,6,6,1
4744,175438,dcYgKBzujpMIqe60unjrhnmHIEGafOxK,fbPkOYLVPtPgIt0MxizjfFJov3JbHyAi,1,0,0,0,0,0,1,0,1,0.14285714285714285,1,0.0,0,0,0,0,0,0,0,1,0,0,1,1
4745,175441,bcbHJfb8lY4U1KCijmTk7gJHSF0OiBaV,fbPkOYLVPtPgIt0MxizjfFJov3JbHyAi,8,4,4,0,4,0,4,0,16,2.2857142857142856,1,0.0,0,4,0,4,4,0,0,4,0,8,8,1
4746,175442,VMKrpzh7jQOpngYePozoQTNizGUgxuvX,fbPkOYLVPtPgIt0MxizjfFJov3JbHyAi,5,0,0,0,0,3,6,1,10,1.4285714285714286,1,0.0,0,0,0,0,0,3,0,6,1,0,10,0
4747,175443,uOJVnPYi8EJLtbdq5vki7NQKzKS5WxlN,fbPkOYLVPtPgIt0MxizjfFJov3JbHyAi,9,23,2,0,2,0,8,1,36,5.142857142857143,1,0.0,7,2,0,2,16,0,0,8,1,11,25,1
4748,175448,8Ify4dSBeSQhnw6uYnkYU0v4wr7gJcMS,fbPkOYLVPtPgIt0MxizjfFJov3JbHyAi,9,8,2,0,4,0,8,1,23,3.2857142857142856,1,0.0,5,2,0,4,3,0,0,8,1,11,12,1
4749,175449,wR7MeRMuDjqJzIdX6xUDIhHYl6LZetsZ,fbPkOYLVPtPgIt0MxizjfFJov3JbHyAi,1,0,0,0,0,0,1,0,1,0.14285714285714285,1,0.0,0,0,0,0,0,0,0,1,0,0,1,1
4750,175452,UGrzFFoMUY8lyETY7WUVQiSf705Madpt,fbPkOYLVPtPgIt0MxizjfFJov3JbHyAi,1,0,0,0,0,0,1,0,1,0.14285714285714285,1,0.0,0,0,0,0,0,0,0,1,0,0,1,1
4751,175454,xMTEKIKt8iJP63Gwx7tRgqa1pIDmZgMk,fbPkOYLVPtPgIt0MxizjfFJov3JbHyAi,1,0,0,0,0,0,1,0,1,0.14285714285714285,1,0.0,0,0,0,0,0,0,0,1,0,0,1,1
4752,175455,QLDHYthOyr0cclZ1Sc6usIODjIEumKpI,fbPkOYLVPtPgIt0MxizjfFJov3JbHyAi,7,3,2,0,2,0,2,0,9,1.2857142857142858,1,0.0,0,2,0,2,3,0,0,2,0,4,5,1
4753,175456,OTIaOWnuQGJS24y1xroPuPud7cEKSrq6,fbPkOYLVPtPgIt0MxizjfFJov3JbHyAi,7,8,2,0,4,0,2,0,16,2.2857142857142856,1,0.0,5,2,0,4,3,0,0,2,0,11,5,1
4754,175457,5p4xnVU1oXqeHfhqOsPC09VPLJWVQgy1,fbPkOYLVPtPgIt0MxizjfFJov3JbHyAi,7,4,3,0,3,0,2,0,12,1.7142857142857142,1,0.0,0,3,0,3,4,0,0,2,0,6,6,1
4755,175461,XB0CsTWEqiEaZYtZLlV2XbWJ8POYjAA4,fbPkOYLVPtPgIt0MxizjfFJov3JbHyAi,7,4,2,0,2,0,4,0,12,1.7142857142857142,1,0.0,1,2,0,2,3,0,0,4,0,5,7,1
4756,175465,YhKyManCtFjOHDUhvEEwYRA6Sue32NUJ,fbPkOYLVPtPgIt0MxizjfFJov3JbHyAi,10,6,4,0,2,6,9,3,30,4.285714285714286,1,0.0,0,4,0,2,6,6,0,9,3,6,24,1
4757,175467,Ato56ooa6y54tphZfyEFBMuiinGkCdDC,fbPkOYLVPtPgIt0MxizjfFJov3JbHyAi,5,3,1,0,1,0,2,0,7,1.0,1,0.0,0,1,0,1,3,0,0,2,0,2,5,1
4758,175468,nV17iCvBE2XN1lp2NOww0UgnrnPkpny4,fbPkOYLVPtPgIt0MxizjfFJov3JbHyAi,13,16,5,11,7,1,13,3,56,8.0,1,0.0,8,5,8,7,8,1,3,13,3,28,28,1
4759,175469,3Un500IqBW3emCZEkVYOgMvAW5xeb1AP,fbPkOYLVPtPgIt0MxizjfFJov3JbHyAi,1,0,0,0,0,0,1,0,1,0.14285714285714285,1,0.0,0,0,0,0,0,0,0,1,0,0,1,1
4760,175471,Ar7wri6od2sIMOfx95hPmMwDttR4wtOC,fbPkOYLVPtPgIt0MxizjfFJov3JbHyAi,1,0,0,0,0,0,1,0,1,0.14285714285714285,1,0.0,0,0,0,0,0,0,0,1,0,0,1,1
4761,175474,Y1jXhPhCX2kJOjFXBIjhhtIcj4SJDjMI,fbPkOYLVPtPgIt0MxizjfFJov3JbHyAi,7,3,2,0,2,0,2,0,9,1.2857142857142858,1,0.0,0,2,0,2,3,0,0,2,0,4,5,1
4762,175475,1w0szCmbk0c8fTIiC10xTGm5aiOfXQpV,fbPkOYLVPtPgIt0MxizjfFJov3JbHyAi,5,2,1,0,1,0,3,0,7,1.0,1,0.0,0,1,0,1,2,0,0,3,0,2,5,1
4763,175476,CobcodAmjDEWWm8RdgM2qfuZmhHbHRNU,fbPkOYLVPtPgIt0MxizjfFJov3JbHyAi,6,3,1,0,1,0,6,0,11,1.5714285714285714,1,0.0,1,1,0,1,2,0,0,6,0,3,8,1
4764,175477,YK7kIznrzD8DIJpIXSwoLltRvaesCrfj,fbPkOYLVPtPgIt0MxizjfFJov3JbHyAi,6,3,2,0,2,0,2,0,9,1.2857142857142858,1,0.0,0,2,0,2,3,0,0,2,0,4,5,1
4765,175478,FIQFfdFooB5Qr3t4W3Ez4CHK8yaDPL6r,fbPkOYLVPtPgIt0MxizjfFJov3JbHyAi,8,7,3,0,2,5,2,1,20,2.857142857142857,1,0.0,0,3,0,2,7,5,0,2,1,5,15,1
4766,175479,5257BfDOFjjC1F8tPsdm817yJFHm3nJq,fbPkOYLVPtPgIt0MxizjfFJov3JbHyAi,5,2,1,0,1,0,2,0,6,0.8571428571428571,1,0.0,0,1,0,1,2,0,0,2,0,2,4,1
4767,175480,GCbj5MX1kqm8CtGBmbuXpnp1WMiRGaCo,fbPkOYLVPtPgIt0MxizjfFJov3JbHyAi,4,2,0,0,0,0,2,0,4,0.5714285714285714,1,0.0,0,0,0,0,2,0,0,2,0,0,4,1
4768,175481,ofogRZ8rNViMcr7xZw7tGZINwIkOUuzb,fbPkOYLVPtPgIt0MxizjfFJov3JbHyAi,7,3,2,0,2,0,3,0,10,1.4285714285714286,1,0.0,0,2,0,2,3,0,0,3,0,4,6,1
4769,175484,6EaK0gHFiSwbLJpDVBHv9ZNNoyIiEert,fbPkOYLVPtPgIt0MxizjfFJov3JbHyAi,1,0,0,0,0,0,1,0,1,0.14285714285714285,1,0.0,0,0,0,0,0,0,0,1,0,0,1,1
4770,175485,9karhKHktKTUl1g2B756WZohKwl0YF1K,fbPkOYLVPtPgIt0MxizjfFJov3JbHyAi,2,0,0,0,0,0,3,0,3,0.42857142857142855,1,0.0,0,0,0,0,0,0,0,3,0,0,3,1
4771,175486,om0KjvovtBK0gZUSboAPRv5A6Jkm00Ei,fbPkOYLVPtPgIt0MxizjfFJov3JbHyAi,7,5,2,0,2,0,4,0,13,1.8571428571428572,1,0.0,0,2,0,2,5,0,0,4,0,4,9,0
4772,175487,wNSaTBieURYU9eqRBVXTHwg7UnVH1LNG,fbPkOYLVPtPgIt0MxizjfFJov3JbHyAi,7,8,2,0,3,0,4,0,17,2.4285714285714284,1,0.0,2,2,0,3,6,0,0,4,0,7,10,1
4773,175489,gqg82ZlqVKWjlS0c4NNxNoHosWhYfCyK,fbPkOYLVPtPgIt0MxizjfFJov3JbHyAi,7,3,2,0,2,0,2,0,9,1.2857142857142858,1,0.0,0,2,0,2,3,0,0,2,0,4,5,1
4774,175490,PnA6r0X1SYV0NubfDqVTrMnAW0y3wbco,fbPkOYLVPtPgIt0MxizjfFJov3JbHyAi,8,5,2,0,3,0,5,1,16,2.2857142857142856,1,0.0,2,2,0,3,3,0,0,5,1,7,9,1
4775,175492,BsdltKARtL2vwhO9E4jy6NsRDyZPduO2,fbPkOYLVPtPgIt0MxizjfFJov3JbHyAi,6,3,1,0,1,0,2,0,7,1.0,1,0.0,0,1,0,1,3,0,0,2,0,2,5,1
4776,175493,LAOj1accETKmU8VQwigRsaQa5A7qsGPe,fbPkOYLVPtPgIt0MxizjfFJov3JbHyAi,7,5,2,0,2,0,4,0,13,1.8571428571428572,1,0.0,0,2,0,2,5,0,0,4,0,4,9,1
4777,175494,drW0fI24E8OPT5rwVcYcGjFLcooZDvPF,fbPkOYLVPtPgIt0MxizjfFJov3JbHyAi,7,5,3,0,2,0,2,0,12,1.7142857142857142,2,0.0,0,3,0,2,5,0,0,2,0,5,7,1
4778,175496,e5SHaCJ1YwrfRF0jQyBahObK2P8hYPve,fbPkOYLVPtPgIt0MxizjfFJov3JbHyAi,5,2,1,0,1,0,2,0,6,0.8571428571428571,1,0.0,0,1,0,1,2,0,0,2,0,2,4,1
4779,175497,IbpttTpyCGfZ6D6p8wXVxA8GNM8MhK7W,fbPkOYLVPtPgIt0MxizjfFJov3JbHyAi,1,0,0,0,0,0,1,0,1,0.14285714285714285,1,0.0,0,0,0,0,0,0,0,1,0,0,1,1
4780,175499,qbL2YHzrsuMmEiJasxtJywxONtOZbPqY,fbPkOYLVPtPgIt0MxizjfFJov3JbHyAi,5,3,1,0,1,0,4,0,9,1.2857142857142858,1,0.0,0,1,0,1,3,0,0,4,0,2,7,1
4781,175500,052V26a8dvnnaUmI4wUAzyjC2b7PSOrg,fbPkOYLVPtPgIt0MxizjfFJov3JbHyAi,5,3,1,0,1,0,1,0,6,0.8571428571428571,1,0.0,0,1,0,1,3,0,0,1,0,2,4,1
4782,175501,m9TcnazDdqlnNxcGRCE8U6df3FfqDKf1,fbPkOYLVPtPgIt0MxizjfFJov3JbHyAi,4,3,1,0,0,0,2,0,6,0.8571428571428571,1,0.0,0,1,0,0,3,0,0,2,0,1,5,1
4783,175502,CGrFKacz6p4gJHwJ4xqUr7POA26XzDqd,fbPkOYLVPtPgIt0MxizjfFJov3JbHyAi,4,2,1,0,1,0,1,0,5,0.7142857142857143,2,0.0,0,1,0,1,2,0,0,1,0,2,3,1
4784,175503,LTwrn8iO2pRbLrTnW6wOA9gDNQYv9ip1,fbPkOYLVPtPgIt0MxizjfFJov3JbHyAi,6,3,2,0,2,0,1,0,8,1.1428571428571428,1,0.0,0,2,0,2,3,0,0,1,0,4,4,1
4785,175504,3N5sXtJHk0S0MyzqJoRxaXFTELV1xCPn,fbPkOYLVPtPgIt0MxizjfFJov3JbHyAi,7,8,4,0,4,0,1,0,17,2.4285714285714284,1,0.0,2,4,0,4,6,0,0,1,0,10,7,1
4786,175505,WHZrYzY9tohLccoqyQSfSqyUPDUl9WdE,fbPkOYLVPtPgIt0MxizjfFJov3JbHyAi,7,3,2,0,2,0,2,0,9,1.2857142857142858,1,0.0,0,2,0,2,3,0,0,2,0,4,5,1
4787,175506,qTno0LLDbZSn2CC4rZpUMVqkfAX6tLBw,fbPkOYLVPtPgIt0MxizjfFJov3JbHyAi,1,0,0,0,0,0,1,0,1,0.14285714285714285,1,0.0,0,0,0,0,0,0,0,1,0,0,1,1
4788,175507,CFYmGwr95iYII1Xahjw54NZCjdk2d4Wp,fbPkOYLVPtPgIt0MxizjfFJov3JbHyAi,6,6,1,0,1,0,2,0,10,1.4285714285714286,1,0.0,1,1,0,1,5,0,0,2,0,3,7,1
4789,175508,XyCxlADmHDxfuETiOd9Qt3MOPKhTmOlb,fbPkOYLVPtPgIt0MxizjfFJov3JbHyAi,6,4,1,0,1,0,2,0,8,1.1428571428571428,1,0.0,0,1,0,1,4,0,0,2,0,2,6,1
4790,175510,kY9yPgTd7RyYG1qUhQ8Q0xOuR3Fox0Ti,fbPkOYLVPtPgIt0MxizjfFJov3JbHyAi,2,0,0,0,0,0,4,0,4,0.5714285714285714,1,0.0,0,0,0,0,0,0,0,4,0,0,4,1
4791,175515,R3pJN0fTux9sFYOjyzF0EbS2c0Xrmde3,fbPkOYLVPtPgIt0MxizjfFJov3JbHyAi,6,6,3,0,2,0,10,0,21,3.0,1,0.0,2,3,0,2,4,0,0,10,0,7,14,1
4792,175516,ldm7FcdWlJdLvNLq5omS5m0FzdvPxViY,fbPkOYLVPtPgIt0MxizjfFJov3JbHyAi,7,8,3,0,4,0,2,0,17,2.4285714285714284,1,0.0,2,3,0,4,6,0,0,2,0,9,8,1
4793,175518,tLauqU6m7jR9M9FVV91XHWWjOVljDHTA,fbPkOYLVPtPgIt0MxizjfFJov3JbHyAi,18,31,14,16,12,2,6,0,81,11.571428571428571,1,0.0,13,14,12,12,18,2,4,6,0,51,30,1
4794,175520,tkWTBuD8nrYklSlgsF9aKVPineGUm2wd,fbPkOYLVPtPgIt0MxizjfFJov3JbHyAi,7,10,2,0,1,0,3,0,16,2.2857142857142856,1,0.0,0,2,0,1,10,0,0,3,0,3,13,1
4795,175523,cv7s2nnOAGwzgfER5oZNesmUBbRGxCps,fbPkOYLVPtPgIt0MxizjfFJov3JbHyAi,7,3,2,0,2,0,2,0,9,1.2857142857142858,1,0.0,0,2,0,2,3,0,0,2,0,4,5,1
4796,175524,VeDeV6aD6kowERv1ygPjE9YEMgMJMOAv,fbPkOYLVPtPgIt0MxizjfFJov3JbHyAi,1,0,0,0,0,0,1,0,1,0.14285714285714285,1,0.0,0,0,0,0,0,0,0,1,0,0,1,1
4797,175526,ucQjAvDjYoqpSh3nQps3rSAEs5u7Mvtk,fbPkOYLVPtPgIt0MxizjfFJov3JbHyAi,2,0,0,0,0,0,2,0,2,0.2857142857142857,1,0.0,0,0,0,0,0,0,0,2,0,0,2,1
4798,175528,mz46tnsW5yzzVlL3u3XwzrxNaj8Gctbo,fbPkOYLVPtPgIt0MxizjfFJov3JbHyAi,1,0,0,0,0,0,1,0,1,0.14285714285714285,1,0.0,0,0,0,0,0,0,0,1,0,0,1,1
4799,175531,eXM1gBg4CSAoJIkchTxClftGT7trcN3I,fbPkOYLVPtPgIt0MxizjfFJov3JbHyAi,5,2,1,0,1,0,2,0,6,0.8571428571428571,1,0.0,0,1,0,1,2,0,0,2,0,2,4,1
4800,175533,TL1aA8ITe7VP42GX52yE5M5UsjXNCOS3,fbPkOYLVPtPgIt0MxizjfFJov3JbHyAi,3,2,1,0,0,0,1,0,4,0.5714285714285714,1,0.0,0,1,0,0,2,0,0,1,0,1,3,1
4801,175534,UtAqhqB3FX1II4t3OmHm0AmqSdhnUJww,fbPkOYLVPtPgIt0MxizjfFJov3JbHyAi,1,0,0,0,0,0,1,0,1,0.14285714285714285,1,0.0,0,0,0,0,0,0,0,1,0,0,1,1
4802,175535,Bf0qullIcB7YMd6p0ga3kapcfp1HAy4D,fbPkOYLVPtPgIt0MxizjfFJov3JbHyAi,4,2,1,0,1,0,1,0,5,0.7142857142857143,1,0.0,0,1,0,1,2,0,0,1,0,2,3,1
4803,175536,UGeVqsUEeFxkRpYFM0kXm2U5Cm8I1M7Q,fbPkOYLVPtPgIt0MxizjfFJov3JbHyAi,9,5,3,0,3,0,2,0,13,1.8571428571428572,1,0.0,1,3,0,3,4,0,0,2,0,7,6,1
4804,175537,nTUP3gEuwVy2Io3TzQXGmuh9VvJxgHk3,fbPkOYLVPtPgIt0MxizjfFJov3JbHyAi,1,0,0,0,0,0,1,0,1,0.14285714285714285,1,0.0,0,0,0,0,0,0,0,1,0,0,1,1
4805,175539,1CCZmdq6Gb6gZ6uKsuQ6KwhvPKPrUh2U,fbPkOYLVPtPgIt0MxizjfFJov3JbHyAi,5,2,1,0,1,0,4,0,8,1.1428571428571428,1,0.0,0,1,0,1,2,0,0,4,0,2,6,1
4806,175540,xB6Yoh3Jxp1w9CTAondnOiYqF7QVxKDy,fbPkOYLVPtPgIt0MxizjfFJov3JbHyAi,5,3,2,0,1,0,1,0,7,1.0,1,0.0,0,2,0,1,3,0,0,1,0,3,4,1
4807,175542,B02fY98iRJpi5vADl4eH2XHtzf1uLIV2,fbPkOYLVPtPgIt0MxizjfFJov3JbHyAi,5,3,1,0,1,0,2,0,7,1.0,1,0.0,0,1,0,1,3,0,0,2,0,2,5,1
4808,175543,O9Ru4jbLuBmSjAvyVz5x9pDKgWs38Hwv,fbPkOYLVPtPgIt0MxizjfFJov3JbHyAi,5,2,1,0,1,0,2,0,6,0.8571428571428571,1,0.0,0,1,0,1,2,0,0,2,0,2,4,1
4809,175544,U4zrVJHh3FaieGmYntHxuYMlUehDirPp,fbPkOYLVPtPgIt0MxizjfFJov3JbHyAi,4,2,1,0,1,0,1,0,5,0.7142857142857143,1,0.0,0,1,0,1,2,0,0,1,0,2,3,1
4810,175545,1R1CKWtxnh6YgR55bjp2SqlcSVpP0TFg,fbPkOYLVPtPgIt0MxizjfFJov3JbHyAi,5,4,0,0,0,4,4,0,12,1.7142857142857142,1,0.0,0,0,0,0,4,4,0,4,0,0,12,1
4811,175547,KjHPeZFepHZBGvn3dcFcrV9gz6Gs9Ua1,fbPkOYLVPtPgIt0MxizjfFJov3JbHyAi,1,0,0,0,0,0,1,0,1,0.14285714285714285,1,0.0,0,0,0,0,0,0,0,1,0,0,1,1
4812,177493,K3eaSd5rYP9Gkimldqt40pigYQrGeLsH,A3fsA9Zfv1X2fVEQhTw51lKENdNrEqT3,16,8,7,0,6,0,2,0,23,3.2857142857142856,1,0.0,0,7,0,6,8,0,0,2,0,13,10,1
4813,177648,XTgYONXtkRAl3sCFaGFF8e1mU9AMcEwg,A3fsA9Zfv1X2fVEQhTw51lKENdNrEqT3,1,0,0,0,0,0,1,0,1,0.14285714285714285,1,0.0,0,0,0,0,0,0,0,1,0,0,1,1
4814,177656,3EOSgrGzaBOPj9C9GS5Q7Pv420ga9IOi,SpATywNh6bZuzm8s1ceuBUnMUAeoAHHw,16,16,8,0,6,0,2,0,32,4.571428571428571,2,0.0,0,8,0,6,16,0,0,2,0,14,18,1
4815,177692,EovGqmWXTyV2r8yAXv2wZ0VYOf33vn0t,SpATywNh6bZuzm8s1ceuBUnMUAeoAHHw,8,9,2,0,2,0,4,0,17,2.4285714285714284,1,0.0,1,2,0,2,8,0,0,4,0,5,12,1
4816,177701,vvZAdi1giBsqNJd2MIMUF2BeNIuSYzIL,A3fsA9Zfv1X2fVEQhTw51lKENdNrEqT3,1,0,0,0,0,0,1,0,1,0.14285714285714285,1,0.0,0,0,0,0,0,0,0,1,0,0,1,1
4817,177705,wlzAgdvhO4A4jv5wZbftQLCtHeMZtcKt,A3fsA9Zfv1X2fVEQhTw51lKENdNrEqT3,8,1,1,0,1,1,11,1,16,2.2857142857142856,1,0.0,0,1,0,1,1,1,0,11,1,2,14,1
4818,177706,Hw8jmGp4VI4tAz6cfKhHDOeLB2t7MJ9z,A3fsA9Zfv1X2fVEQhTw51lKENdNrEqT3,1,0,0,0,0,0,1,0,1,0.14285714285714285,1,0.0,0,0,0,0,0,0,0,1,0,0,1,1
4819,177712,bkuP1EtN8mdTFJXvfsUwoFetipNOKV1x,bWdj2GDclj5ofokWjzoa5jAwMkxCykd6,4,2,0,0,0,0,2,0,4,0.5714285714285714,1,0.0,0,0,0,0,2,0,0,2,0,0,4,0
4820,177716,YeSu5vnyd7NLR6mjoon0rNurw7LtWHKM,SpATywNh6bZuzm8s1ceuBUnMUAeoAHHw,5,2,1,0,1,0,2,0,6,0.8571428571428571,1,0.0,0,1,0,1,2,0,0,2,0,2,4,1
4821,177731,nWfmkEV4YCKZ7mcPyrthk5xsFNQD6yNN,SpATywNh6bZuzm8s1ceuBUnMUAeoAHHw,15,13,2,11,0,0,2,0,28,4.0,1,0.0,0,2,10,0,13,0,1,2,0,12,16,1
4822,177737,F7IgmS7BQy7wghj5xQppsiqo1bYAbUaS,A3fsA9Zfv1X2fVEQhTw51lKENdNrEqT3,2,0,0,0,0,0,3,0,3,0.42857142857142855,1,0.0,0,0,0,0,0,0,0,3,0,0,3,1
4823,177744,7MJ8Lhv2PsjCppkY7orFcs7zn9hmP4MG,A3fsA9Zfv1X2fVEQhTw51lKENdNrEqT3,5,2,1,0,1,0,2,0,6,0.8571428571428571,1,0.0,0,1,0,1,2,0,0,2,0,2,4,1
4824,177746,FTdbZ3S8aZZ61DWcRvHq8VI8NuRVTtYB,SpATywNh6bZuzm8s1ceuBUnMUAeoAHHw,5,3,1,0,1,0,1,0,6,0.8571428571428571,1,0.0,0,1,0,1,3,0,0,1,0,2,4,1
4825,177781,Fjsr4YVijnhHCyav53zNG4j0ri6wctia,SpATywNh6bZuzm8s1ceuBUnMUAeoAHHw,5,2,1,0,1,1,2,0,7,1.0,1,0.0,0,1,0,1,2,1,0,2,0,2,5,1
4826,177802,IfuP3wsHPcoufqx0FyqFKUytwStvSPv8,SpATywNh6bZuzm8s1ceuBUnMUAeoAHHw,8,7,1,0,1,0,2,0,11,1.5714285714285714,1,0.0,0,1,0,1,7,0,0,2,0,2,9,1
4827,177808,h1QswJ31uhxfyhfP3OhNVJBUvcTub6pW,A3fsA9Zfv1X2fVEQhTw51lKENdNrEqT3,6,2,1,0,1,0,3,0,7,1.0,1,0.0,0,1,0,1,2,0,0,3,0,2,5,1
4828,177815,bntZ4rfkG0kbpKVyaZN5dpSYAjphN7lA,SpATywNh6bZuzm8s1ceuBUnMUAeoAHHw,2,0,0,0,0,0,4,0,4,0.5714285714285714,1,0.0,0,0,0,0,0,0,0,4,0,0,4,1
4829,177826,6Orjf1CvaLA2u5CajSzbONgKa1cSGpsp,SpATywNh6bZuzm8s1ceuBUnMUAeoAHHw,5,2,1,0,1,0,2,0,6,0.8571428571428571,1,0.0,0,1,0,1,2,0,0,2,0,2,4,1
4830,177833,WfZHYsGW1JdLRZrh0HxeGf3PWw6Zaiy6,SpATywNh6bZuzm8s1ceuBUnMUAeoAHHw,5,2,1,0,1,0,2,0,6,0.8571428571428571,1,0.0,0,1,0,1,2,0,0,2,0,2,4,1
4831,177838,sJcjGGS4IqxtZ0yUL13beAzln7dowOpj,SpATywNh6bZuzm8s1ceuBUnMUAeoAHHw,1,0,0,0,0,0,1,0,1,0.14285714285714285,1,0.0,0,0,0,0,0,0,0,1,0,0,1,1
4832,177874,vCeaWq9tqFyvtajgk87uB8epKyzp49he,SpATywNh6bZuzm8s1ceuBUnMUAeoAHHw,13,12,5,11,2,1,4,0,35,5.0,1,0.0,5,5,9,2,7,1,2,4,0,21,14,1
4833,177882,EwT4gfO7FSX1b89EA44scYJQueULJfeO,SpATywNh6bZuzm8s1ceuBUnMUAeoAHHw,5,2,1,0,1,0,2,0,6,0.8571428571428571,1,0.0,0,1,0,1,2,0,0,2,0,2,4,1
4834,177889,Ccj8NEsaoMQRZnTXAxQZ3mlzMKhmRScC,SpATywNh6bZuzm8s1ceuBUnMUAeoAHHw,16,23,10,6,4,0,3,0,46,6.571428571428571,1,0.0,6,10,6,4,17,0,0,3,0,26,20,0
4835,177896,A6tOI6UQdaIkkVbh2LcanNew6i5iO2fH,bWdj2GDclj5ofokWjzoa5jAwMkxCykd6,1,0,0,0,0,0,2,0,2,0.2857142857142857,1,0.0,0,0,0,0,0,0,0,2,0,0,2,1
4836,177916,x5efWjoRyi52rQ7JepSo4abkhsClgbZ4,bWdj2GDclj5ofokWjzoa5jAwMkxCykd6,2,0,0,0,0,0,2,0,2,0.2857142857142857,1,0.0,0,0,0,0,0,0,0,2,0,0,2,1
4837,177918,Ck862YJ4TKsW5xBb6Obw9gcSWBzSDmoA,SpATywNh6bZuzm8s1ceuBUnMUAeoAHHw,10,12,0,19,0,0,2,0,33,4.714285714285714,1,0.0,4,0,15,0,8,0,4,2,0,19,14,1
4838,177946,fsYAWTSjas5dj2ZT4ziu6J8GfCN2A543,SpATywNh6bZuzm8s1ceuBUnMUAeoAHHw,8,2,1,0,1,1,5,1,11,1.5714285714285714,1,0.0,0,1,0,1,2,1,0,5,1,2,9,1
4839,178015,IZxwz54TsYvU9RDBY0Jd0dZSoQSefAFM,SpATywNh6bZuzm8s1ceuBUnMUAeoAHHw,3,0,0,0,0,0,7,0,7,1.0,1,0.0,0,0,0,0,0,0,0,7,0,0,7,1
4840,178018,EQaS3CpcvDJhQrwHEK3TrEH3gvn0Dpxt,A3fsA9Zfv1X2fVEQhTw51lKENdNrEqT3,1,0,0,0,0,0,1,0,1,0.14285714285714285,1,0.0,0,0,0,0,0,0,0,1,0,0,1,1
4841,178031,dH1fJFd4EUa9cDGkzaH97LNe2YTOAGRI,bWdj2GDclj5ofokWjzoa5jAwMkxCykd6,1,0,0,0,0,0,2,0,2,0.2857142857142857,1,0.0,0,0,0,0,0,0,0,2,0,0,2,1
4842,178048,ZnF4cH0Rkfun3Ujybr1tuGGeHps3w9hO,A3fsA9Zfv1X2fVEQhTw51lKENdNrEqT3,20,10,9,0,8,0,2,0,29,4.142857142857143,1,0.0,0,9,0,8,10,0,0,2,0,17,12,1
4843,178057,vOyNIvbmr9YMEBhwQMSd5QWgWHEvzCE0,SpATywNh6bZuzm8s1ceuBUnMUAeoAHHw,9,8,1,10,1,0,3,0,23,3.2857142857142856,1,0.0,2,1,9,1,6,0,1,3,0,13,10,1
4844,178065,Cwlc0kvvLoKXxEuXNQkjFRo818TDMpZS,A3fsA9Zfv1X2fVEQhTw51lKENdNrEqT3,12,6,5,0,5,0,1,0,17,2.4285714285714284,1,0.0,0,5,0,5,6,0,0,1,0,10,7,1
4845,178071,8uKfJT3Ferex7gSStlreZzcbQrGyXHDu,A3fsA9Zfv1X2fVEQhTw51lKENdNrEqT3,13,5,4,22,3,0,1,0,35,5.0,1,0.0,0,4,19,3,5,0,3,1,0,26,9,1
4846,178091,YRvoydpc37Vpysmtw8O9rzowfgsZu7lO,SpATywNh6bZuzm8s1ceuBUnMUAeoAHHw,5,5,2,0,1,3,1,0,12,1.7142857142857142,1,0.0,2,2,0,1,3,3,0,1,0,5,7,1
4847,178094,esEoFNEKF5IP6OxWYdt6tpHD0Qc2cHks,SpATywNh6bZuzm8s1ceuBUnMUAeoAHHw,4,4,1,0,1,0,1,0,7,1.0,1,0.0,0,1,0,1,4,0,0,1,0,2,5,1
4848,178095,44onQpYi5VTnyFsvK7UkRriRlwhqqD0U,SpATywNh6bZuzm8s1ceuBUnMUAeoAHHw,1,0,0,0,0,0,1,0,1,0.14285714285714285,1,0.0,0,0,0,0,0,0,0,1,0,0,1,1
4849,178108,gSVv2aL3mlSaSez3uclTs7guBwBPusEU,A3fsA9Zfv1X2fVEQhTw51lKENdNrEqT3,1,0,0,0,0,0,1,0,1,0.14285714285714285,1,0.0,0,0,0,0,0,0,0,1,0,0,1,1
4850,178129,NMPg56MDKMVC7ti0J9mAofQpqCKjpKCl,bWdj2GDclj5ofokWjzoa5jAwMkxCykd6,8,5,1,0,2,1,6,1,16,2.2857142857142856,1,0.0,3,1,0,2,2,1,0,6,1,6,10,1
4851,178130,NMPg56MDKMVC7ti0J9mAofQpqCKjpKCl,A3fsA9Zfv1X2fVEQhTw51lKENdNrEqT3,1,0,0,0,0,0,1,0,1,0.14285714285714285,1,0.0,0,0,0,0,0,0,0,1,0,0,1,1
4852,178173,yuqt6qA4ywnzzkfFkXqBct0eJDj9XUsS,SpATywNh6bZuzm8s1ceuBUnMUAeoAHHw,6,1,1,0,1,0,3,0,6,0.8571428571428571,1,0.0,0,1,0,1,1,0,0,3,0,2,4,1
4853,178187,3THLA2KuYKQhJc7rfDiBcIyyI3oWoZEW,bWdj2GDclj5ofokWjzoa5jAwMkxCykd6,1,0,0,0,0,0,1,0,1,0.14285714285714285,1,0.0,0,0,0,0,0,0,0,1,0,0,1,1
4854,178206,vYYhKPJ8OWf68zu55Ez1PMsu8DH2KE0M,A3fsA9Zfv1X2fVEQhTw51lKENdNrEqT3,7,5,4,0,4,1,3,0,17,2.4285714285714284,1,0.0,0,4,0,4,5,1,0,3,0,8,9,1
4855,178214,ZgFCLkDPzcdiy0sIzPjvfQAgjdD1TUt9,A3fsA9Zfv1X2fVEQhTw51lKENdNrEqT3,8,6,3,0,1,2,9,2,23,3.2857142857142856,1,0.0,0,3,0,1,6,2,0,9,2,4,19,1
4856,179834,ymWpwD3GRW9ut1JiVBQeAWpoDiatjwOa,A3fsA9Zfv1X2fVEQhTw51lKENdNrEqT3,1,0,0,0,0,0,1,0,1,0.14285714285714285,1,0.0,0,0,0,0,0,0,0,1,0,0,1,1
4857,180050,yAFOzDqu62VOeEElP9JgOlIiP2xoZYrS,7GRhBDsirIGkRZBtSMEzNTyDr2JQm4xx,1,0,0,0,0,0,1,0,1,0.14285714285714285,1,0.0,0,0,0,0,0,0,0,1,0,0,1,1
4858,180099,jrgM1oW0TWS88MYVs7LRUQjqPhGPE54P,7GRhBDsirIGkRZBtSMEzNTyDr2JQm4xx,46,72,36,50,20,32,23,0,233,33.285714285714285,1,0.0,31,36,44,20,41,32,6,23,0,131,102,1
4859,180179,SFfKdrEty3lLCn3Lw45FtRZTydUXwmxu,7GRhBDsirIGkRZBtSMEzNTyDr2JQm4xx,5,2,1,0,1,0,2,0,6,0.8571428571428571,1,0.0,0,1,0,1,2,0,0,2,0,2,4,1
4860,180216,QSaImtnwSyIvS5AffCcxoWPOjD7SK8AN,7GRhBDsirIGkRZBtSMEzNTyDr2JQm4xx,1,0,0,0,0,0,1,0,1,0.14285714285714285,1,0.0,0,0,0,0,0,0,0,1,0,0,1,1
4861,180269,oPqCsuIFtZAPoNsyhKvigrqOFJmD29Ve,7GRhBDsirIGkRZBtSMEzNTyDr2JQm4xx,9,12,6,0,2,9,6,0,35,5.0,1,0.0,1,6,0,2,11,9,0,6,0,9,26,1
4862,180318,Hf0URgVFicQOS2VXZZFuo5o8pUWE4p7E,7GRhBDsirIGkRZBtSMEzNTyDr2JQm4xx,1,0,0,0,0,0,1,0,1,0.14285714285714285,1,0.0,0,0,0,0,0,0,0,1,0,0,1,1
4863,180326,vIJUyeZxiAlOeYPEqKJHsdkNk5HQVTjW,7GRhBDsirIGkRZBtSMEzNTyDr2JQm4xx,1,0,0,0,0,0,1,0,1,0.14285714285714285,1,0.0,0,0,0,0,0,0,0,1,0,0,1,1
4864,183038,AvefIGzCaOx0Wgqe3dv7u8LN0NNvyUzu,RXDvfPUBYFlVdlueBFbLW0mhhAyGEqpt,10,3,2,12,2,0,3,0,22,3.142857142857143,1,0.0,1,2,11,2,2,0,1,3,0,16,6,1
4865,183863,OyUzOGgEg3D1ADlF5EJGg06nY3QmnkdW,RXDvfPUBYFlVdlueBFbLW0mhhAyGEqpt,11,6,6,0,6,0,5,0,23,3.2857142857142856,2,0.0,0,6,0,6,6,0,0,5,0,12,11,1
4866,183903,Pe0BOQruXYclUh2pOuaZXsDRh9S1JXgK,G8EPVSXsOYB5YQWZGiz1aVq5Pgr2GrQu,15,16,1,14,1,0,1,0,33,4.714285714285714,1,0.0,0,1,13,1,16,0,1,1,0,15,18,1
4867,185699,iHtSvehLiNBG0wCDW2WxQ7UVFKpHQkCr,G8EPVSXsOYB5YQWZGiz1aVq5Pgr2GrQu,4,0,0,0,0,0,3,1,4,0.5714285714285714,1,0.0,0,0,0,0,0,0,0,3,1,0,4,1
4868,185996,rqLYGFT8OdZ1rVwTL6aA81jhg4BwFBcq,SpATywNh6bZuzm8s1ceuBUnMUAeoAHHw,8,11,6,4,2,0,1,0,24,3.4285714285714284,1,0.0,4,6,4,2,7,0,0,1,0,16,8,1
4869,186172,eC7mMb2gTYoACNwQi5SJ70EXu79ikkpz,G8EPVSXsOYB5YQWZGiz1aVq5Pgr2GrQu,12,22,0,16,1,1,7,1,48,6.857142857142857,1,0.0,4,0,12,1,18,1,4,7,1,17,31,0
4870,186860,6wrpSaMSo2sFDvbkUAkMpT5um9Gim187,RXDvfPUBYFlVdlueBFbLW0mhhAyGEqpt,1,0,1,0,0,0,0,0,1,0.14285714285714285,1,0.0,0,1,0,0,0,0,0,0,0,1,0,1
4871,186871,gCagcmlQCSqfTruAye7CNDK3pgpCGf84,G8EPVSXsOYB5YQWZGiz1aVq5Pgr2GrQu,2,0,1,0,1,0,0,0,2,0.2857142857142857,1,0.0,0,1,0,1,0,0,0,0,0,2,0,1
4872,188085,zRnOVNOS86llNSo73YXoV5gxm1bqsSCm,SpATywNh6bZuzm8s1ceuBUnMUAeoAHHw,5,2,1,0,1,0,2,0,6,0.8571428571428571,1,0.0,0,1,0,1,2,0,0,2,0,2,4,1
4873,188090,ybIzxkMDLWLrDVExEcMDqo8WM6vEGkZZ,SpATywNh6bZuzm8s1ceuBUnMUAeoAHHw,1,0,0,0,0,0,1,0,1,0.14285714285714285,1,0.0,0,0,0,0,0,0,0,1,0,0,1,1
4874,188094,ThbgWOtxqhoj3CitI04NYmRPUH8AcwTc,bWdj2GDclj5ofokWjzoa5jAwMkxCykd6,5,2,1,0,1,0,2,0,6,0.8571428571428571,1,0.0,0,1,0,1,2,0,0,2,0,2,4,1
4875,188109,OH3E8d7hl8qczf2rbzD7q87CuSXHDkzd,SpATywNh6bZuzm8s1ceuBUnMUAeoAHHw,7,3,2,0,2,0,2,0,9,1.2857142857142858,1,0.0,0,2,0,2,3,0,0,2,0,4,5,1
4876,188110,C3IAtr3DP6X43hGuQp5cpcBsS3W9ZHlR,A3fsA9Zfv1X2fVEQhTw51lKENdNrEqT3,4,3,2,0,0,0,1,0,6,0.8571428571428571,1,0.0,0,2,0,0,3,0,0,1,0,2,4,1
4877,188116,MK8k0hhUdWdpYmj0isuX8T1dViy4UCt1,SpATywNh6bZuzm8s1ceuBUnMUAeoAHHw,6,5,1,0,1,0,1,0,8,1.1428571428571428,1,0.0,0,1,0,1,5,0,0,1,0,2,6,1
4878,188130,yf5lbvaFDQkrMlGgcstn1q64tRnOCok9,SpATywNh6bZuzm8s1ceuBUnMUAeoAHHw,1,0,0,0,0,0,1,0,1,0.14285714285714285,1,0.0,0,0,0,0,0,0,0,1,0,0,1,1
4879,188131,M16e8QYaHQdZuQp8Y763VwuDYhM2nJCJ,bWdj2GDclj5ofokWjzoa5jAwMkxCykd6,1,0,0,0,0,0,1,0,1,0.14285714285714285,1,0.0,0,0,0,0,0,0,0,1,0,0,1,1
4880,188142,rUr3hxt1niPeDbjT1dWASqAoHDERYMHJ,A3fsA9Zfv1X2fVEQhTw51lKENdNrEqT3,16,3,1,58,0,0,2,0,64,9.142857142857142,1,0.0,0,1,50,0,3,0,8,2,0,51,13,1
4881,188154,iiOxy6ZHzLGvKGuYRdh7FVWh0KnEKqfO,bWdj2GDclj5ofokWjzoa5jAwMkxCykd6,2,0,0,0,0,0,2,0,2,0.2857142857142857,1,0.0,0,0,0,0,0,0,0,2,0,0,2,1
4882,188159,7Yp7JtPvuAevQOAXXsHTKvHnWR7urZQ4,G8EPVSXsOYB5YQWZGiz1aVq5Pgr2GrQu,13,10,6,0,5,1,9,1,32,4.571428571428571,1,0.0,0,6,0,5,10,1,0,9,1,11,21,1
4883,188164,CHnoo745rkdwAbtfBdiAFrd16E9EwOo7,SpATywNh6bZuzm8s1ceuBUnMUAeoAHHw,7,3,2,0,2,0,2,0,9,1.2857142857142858,1,0.0,0,2,0,2,3,0,0,2,0,4,5,1
4884,188166,CHnoo745rkdwAbtfBdiAFrd16E9EwOo7,A3fsA9Zfv1X2fVEQhTw51lKENdNrEqT3,2,0,0,0,0,0,2,0,2,0.2857142857142857,1,0.0,0,0,0,0,0,0,0,2,0,0,2,1
4885,188187,L4jaFu0vxNsfaC1OhafSk08ztmq6goZk,bWdj2GDclj5ofokWjzoa5jAwMkxCykd6,1,0,0,0,0,0,1,0,1,0.14285714285714285,1,0.0,0,0,0,0,0,0,0,1,0,0,1,1
4886,188194,ZbaPpC6DlaDgy5Ic6oj7YX9qkm2j3Pmr,bWdj2GDclj5ofokWjzoa5jAwMkxCykd6,1,0,0,0,0,0,1,0,1,0.14285714285714285,1,0.0,0,0,0,0,0,0,0,1,0,0,1,1
4887,188195,GSVK27iuI3PAZqwurTaJZ7s4wwjamYAo,bWdj2GDclj5ofokWjzoa5jAwMkxCykd6,1,0,0,0,0,0,1,0,1,0.14285714285714285,1,0.0,0,0,0,0,0,0,0,1,0,0,1,1
4888,188217,aXH2LOKFA6E3yNtljCtC3Nc8jVn6ci1H,A3fsA9Zfv1X2fVEQhTw51lKENdNrEqT3,1,0,0,0,0,0,1,0,1,0.14285714285714285,1,0.0,0,0,0,0,0,0,0,1,0,0,1,1
4889,188219,ycZck16llBAZloBk10bwfMcnaMnaXQWK,G8EPVSXsOYB5YQWZGiz1aVq5Pgr2GrQu,8,8,1,4,1,0,3,0,17,2.4285714285714284,1,0.0,0,1,3,1,8,0,1,3,0,5,12,1
4890,188239,zItJ3nxDMUzUt8KfP7wnRxeJL6qP12Ql,SpATywNh6bZuzm8s1ceuBUnMUAeoAHHw,21,16,10,19,7,1,3,1,57,8.142857142857142,1,0.0,5,10,16,7,11,1,3,3,1,38,19,0
4891,188247,BKY6uxinHYYQ0SbTdivOCWOjfYsvPMBo,G8EPVSXsOYB5YQWZGiz1aVq5Pgr2GrQu,21,37,30,36,19,0,7,1,130,18.571428571428573,1,0.0,2,30,35,19,35,0,1,7,1,86,44,1
4892,188261,JxIBkz7Ac4cigQzgeXEdcv5rttnqlmPu,SpATywNh6bZuzm8s1ceuBUnMUAeoAHHw,7,13,6,0,5,0,1,0,25,3.5714285714285716,1,0.0,0,6,0,5,13,0,0,1,0,11,14,1
4893,188265,4M7QUx9Fzm9ZPaWRvEUxQx27jAilEGAL,SpATywNh6bZuzm8s1ceuBUnMUAeoAHHw,1,0,0,0,0,0,1,0,1,0.14285714285714285,1,0.0,0,0,0,0,0,0,0,1,0,0,1,1
4894,188285,VDLlgOqW7FFpT6uHqFXXlnnZR1JOz0x8,bWdj2GDclj5ofokWjzoa5jAwMkxCykd6,5,2,1,0,1,0,2,0,6,0.8571428571428571,1,0.0,0,1,0,1,2,0,0,2,0,2,4,1
4895,188303,jIZxfoiSxH2AO4xoJAniqOuewjPFpPI5,bWdj2GDclj5ofokWjzoa5jAwMkxCykd6,2,0,0,0,0,0,2,0,2,0.2857142857142857,1,0.0,0,0,0,0,0,0,0,2,0,0,2,1
4896,188309,YBtKAFQt6fk6EIukc4Ut5J2kdzYxomaP,G8EPVSXsOYB5YQWZGiz1aVq5Pgr2GrQu,4,2,0,0,0,0,2,1,5,0.7142857142857143,1,0.0,0,0,0,0,2,0,0,2,1,0,5,1
4897,188313,Z34rmr1DW5f5nfzpsFgtbvoODrTWS0gR,A3fsA9Zfv1X2fVEQhTw51lKENdNrEqT3,10,6,5,0,3,0,2,0,16,2.2857142857142856,1,0.0,0,5,0,3,6,0,0,2,0,8,8,1
4898,188317,SgxzSZm3WqSNUUUyFr3EYdvWEPQiCYXc,SpATywNh6bZuzm8s1ceuBUnMUAeoAHHw,5,4,1,0,0,1,3,0,9,1.2857142857142858,1,0.0,0,1,0,0,4,1,0,3,0,1,8,1
4899,188340,lXbqqhFQBJZOyvWBPJdHT24KBsdCctUo,A3fsA9Zfv1X2fVEQhTw51lKENdNrEqT3,2,0,0,0,0,0,2,0,2,0.2857142857142857,1,0.0,0,0,0,0,0,0,0,2,0,0,2,1
4900,188349,OiGglfoFWXujNzXY3OeV6ty8l3z95RBT,G8EPVSXsOYB5YQWZGiz1aVq5Pgr2GrQu,5,2,1,0,1,0,4,0,8,1.1428571428571428,1,0.0,0,1,0,1,2,0,0,4,0,2,6,1
4901,188350,jafkqz7Ls6SMq5HQIDonLkyeZrg5LRjK,bWdj2GDclj5ofokWjzoa5jAwMkxCykd6,2,0,0,0,0,0,3,0,3,0.42857142857142855,1,0.0,0,0,0,0,0,0,0,3,0,0,3,1
4902,188365,4ly9tFjgsKJLiMP1XUHFz2i27nHiXdvU,bWdj2GDclj5ofokWjzoa5jAwMkxCykd6,2,0,0,0,0,0,2,0,2,0.2857142857142857,1,0.0,0,0,0,0,0,0,0,2,0,0,2,1
4903,188366,Qb1CgQ8SxoQQTE8swhxPBVi0nI23eAzb,A3fsA9Zfv1X2fVEQhTw51lKENdNrEqT3,24,8,4,52,1,0,1,0,66,9.428571428571429,1,0.0,2,4,51,1,6,0,1,1,0,58,8,1
4904,188380,YvqXtgBNC43WLi1Y1OHrc4YV5wJZj5BZ,SpATywNh6bZuzm8s1ceuBUnMUAeoAHHw,1,0,0,0,0,0,1,0,1,0.14285714285714285,1,0.0,0,0,0,0,0,0,0,1,0,0,1,1
4905,188395,3RtHMyLQOrBsDYp6yo5VYdmS72cr3PBJ,A3fsA9Zfv1X2fVEQhTw51lKENdNrEqT3,4,4,1,0,0,0,2,0,7,1.0,1,0.0,0,1,0,0,4,0,0,2,0,1,6,1
4906,188404,vN6O2x0QSqyADqu8ib3CnGtyQMSLegp0,SpATywNh6bZuzm8s1ceuBUnMUAeoAHHw,6,5,2,0,1,0,3,0,11,1.5714285714285714,1,0.0,0,2,0,1,5,0,0,3,0,3,8,1
4907,188429,O1acx8tASPAKCowx3gb1g3tmN6Tc39LY,SpATywNh6bZuzm8s1ceuBUnMUAeoAHHw,5,3,1,0,1,0,2,0,7,1.0,1,0.0,0,1,0,1,3,0,0,2,0,2,5,1
4908,188437,xGSY8Cd0Vf3OB8ao8DFjx5u3ZfaDhjub,SpATywNh6bZuzm8s1ceuBUnMUAeoAHHw,4,2,0,0,0,0,3,0,5,0.7142857142857143,1,0.0,0,0,0,0,2,0,0,3,0,0,5,1
4909,188443,2I5ebzNsijWnJvqjKSef4ff3wTM7uHNA,SpATywNh6bZuzm8s1ceuBUnMUAeoAHHw,19,21,13,18,6,1,6,1,66,9.428571428571429,1,0.0,5,13,15,6,16,1,3,6,1,39,27,1
4910,188449,Pp88hiBrGOv2jXNIxXAtL4Okpq7q1gT0,SpATywNh6bZuzm8s1ceuBUnMUAeoAHHw,9,10,4,4,0,0,2,0,20,2.857142857142857,1,0.0,4,4,3,0,6,0,1,2,0,11,9,1
4911,188453,hVaGaJRn8sLkma0vlTnpuIvccDoCcRmU,SpATywNh6bZuzm8s1ceuBUnMUAeoAHHw,11,9,1,10,0,0,3,0,23,3.2857142857142856,1,0.0,1,1,9,0,8,0,1,3,0,11,12,1
4912,188457,gKGgdSFWPcygAewBStBoLPqo60qbmH1E,SpATywNh6bZuzm8s1ceuBUnMUAeoAHHw,6,3,1,0,1,0,2,0,7,1.0,1,0.0,0,1,0,1,3,0,0,2,0,2,5,1
4913,188473,A5GOsdnH2EcjC6B3eZFXiZImo9yFgAgf,SpATywNh6bZuzm8s1ceuBUnMUAeoAHHw,7,5,1,0,1,0,2,0,9,1.2857142857142858,1,0.0,0,1,0,1,5,0,0,2,0,2,7,1
4914,188474,T2bqEEIIeGnaI1g4yvbhFPGfktTUZc7r,A3fsA9Zfv1X2fVEQhTw51lKENdNrEqT3,2,0,0,0,0,0,3,0,3,0.42857142857142855,1,0.0,0,0,0,0,0,0,0,3,0,0,3,1
4915,188485,DnH0S2FmhfjVrDlDj5ZYyy4G86Cb3LMh,A3fsA9Zfv1X2fVEQhTw51lKENdNrEqT3,20,8,7,0,7,1,8,1,32,4.571428571428571,1,0.0,0,7,0,7,8,1,0,8,1,14,18,1
4916,188490,V6YPbhCrTroTd2oOIiUcM7kFRRLU5vrj,A3fsA9Zfv1X2fVEQhTw51lKENdNrEqT3,10,5,4,0,4,0,1,0,14,2.0,1,0.0,0,4,0,4,5,0,0,1,0,8,6,1
4917,188492,Bm156uclJazpLCklS4EEwaPxoPGPtFcp,SpATywNh6bZuzm8s1ceuBUnMUAeoAHHw,5,2,1,0,1,0,2,0,6,0.8571428571428571,1,0.0,0,1,0,1,2,0,0,2,0,2,4,1
4918,188500,j6ThnD1jS0Zu8CWEKNbNRNMNGJz47quI,SpATywNh6bZuzm8s1ceuBUnMUAeoAHHw,19,18,13,14,11,3,1,0,60,8.571428571428571,1,0.0,3,13,14,11,15,3,0,1,0,41,19,1
4919,188505,YnmpFl6RHXV2PnbToNbHTDGl7f0k3wEj,SpATywNh6bZuzm8s1ceuBUnMUAeoAHHw,7,3,2,0,2,0,2,0,9,1.2857142857142858,1,0.0,0,2,0,2,3,0,0,2,0,4,5,1
4920,188513,Vr0kaKAkI4p2upUYNB1MMKsTShBZob66,bWdj2GDclj5ofokWjzoa5jAwMkxCykd6,1,0,0,0,0,0,1,0,1,0.14285714285714285,1,0.0,0,0,0,0,0,0,0,1,0,0,1,1
4921,188517,udLbdwzexRvhhTaiAuWi3yugEk6gj6AD,SpATywNh6bZuzm8s1ceuBUnMUAeoAHHw,6,5,4,0,4,0,1,0,14,2.0,1,0.0,0,4,0,4,5,0,0,1,0,8,6,1
4922,188521,bK37SC4aHpDxnD3Rvkijz9Wy2oAlQRmW,bWdj2GDclj5ofokWjzoa5jAwMkxCykd6,6,2,0,0,0,0,7,1,10,1.4285714285714286,1,0.0,0,0,0,0,2,0,0,7,1,0,10,1
4923,188530,1NKuiSaTPUbZFDACCyv5YoUfO7qDer9w,SpATywNh6bZuzm8s1ceuBUnMUAeoAHHw,3,3,1,0,0,0,1,0,5,0.7142857142857143,1,0.0,0,1,0,0,3,0,0,1,0,1,4,1
4924,188532,3sMwGCOGCL2RAMMG6tfFT0UobGq5flFz,SpATywNh6bZuzm8s1ceuBUnMUAeoAHHw,6,3,2,0,2,0,1,0,8,1.1428571428571428,1,0.0,0,2,0,2,3,0,0,1,0,4,4,1
4925,188535,DVNRZ0Vb68sNhFssev2X8FTZcbZTVgAF,RXDvfPUBYFlVdlueBFbLW0mhhAyGEqpt,1,0,0,0,0,0,1,0,1,0.14285714285714285,1,0.0,0,0,0,0,0,0,0,1,0,0,1,1
4926,188543,JV1BgG1khCT6s4RU5oY7ZOSmwW31Qjbp,A3fsA9Zfv1X2fVEQhTw51lKENdNrEqT3,3,0,0,0,0,1,2,0,3,0.42857142857142855,1,0.0,0,0,0,0,0,1,0,2,0,0,3,1
4927,188551,SSoRd5SzkY86SEd4leqERj2oURCXSCvn,SpATywNh6bZuzm8s1ceuBUnMUAeoAHHw,5,2,1,0,1,0,2,0,6,0.8571428571428571,1,0.0,0,1,0,1,2,0,0,2,0,2,4,1
4928,188559,pGYLDmhkSj1iBp1YljlDSId0XSrjZNZR,A3fsA9Zfv1X2fVEQhTw51lKENdNrEqT3,7,4,3,0,2,0,1,0,10,1.4285714285714286,1,0.0,0,3,0,2,4,0,0,1,0,5,5,1
4929,188560,5gty34EJtQfrhgxngYuTOUGIUr24foZa,SpATywNh6bZuzm8s1ceuBUnMUAeoAHHw,2,0,0,0,0,0,2,0,2,0.2857142857142857,1,0.0,0,0,0,0,0,0,0,2,0,0,2,1
4930,188567,j6ThnD1jS0Zu8CWEKNbNRNMNGJz47quI,A3fsA9Zfv1X2fVEQhTw51lKENdNrEqT3,10,7,5,0,5,0,1,0,18,2.5714285714285716,1,0.0,1,5,0,5,6,0,0,1,0,11,7,1
4931,188572,y9xw5DVwyk92GMkn6gBPMifXrAjYvHji,A3fsA9Zfv1X2fVEQhTw51lKENdNrEqT3,13,10,6,0,3,0,6,2,27,3.857142857142857,1,0.0,2,6,0,3,8,0,0,6,2,11,16,1
4932,188593,urj2Kr7Ws5qXQZp6biE11Qihh39xd0AE,SpATywNh6bZuzm8s1ceuBUnMUAeoAHHw,1,0,0,0,0,0,1,0,1,0.14285714285714285,1,0.0,0,0,0,0,0,0,0,1,0,0,1,1
4933,188618,xteF5FHjR9QQQGxa0LyAUB4pHnIcVbG6,SpATywNh6bZuzm8s1ceuBUnMUAeoAHHw,1,0,0,0,0,0,1,0,1,0.14285714285714285,1,0.0,0,0,0,0,0,0,0,1,0,0,1,1
4934,188635,0sfQp4STEjfvmoiPU7wK8kVHvDAbzKnN,SpATywNh6bZuzm8s1ceuBUnMUAeoAHHw,7,3,1,0,2,0,2,0,8,1.1428571428571428,1,0.0,0,1,0,2,3,0,0,2,0,3,5,1
4935,188643,16lFu8CHy4ustz36vrR0Ab5cogeu487w,A3fsA9Zfv1X2fVEQhTw51lKENdNrEqT3,2,0,0,0,0,0,2,0,2,0.2857142857142857,1,0.0,0,0,0,0,0,0,0,2,0,0,2,1
4936,194479,onTUKKbDoguwNYZBVtONhnnEUSuWUV8S,G8EPVSXsOYB5YQWZGiz1aVq5Pgr2GrQu,9,3,1,0,1,0,5,1,11,1.5714285714285714,1,0.0,0,1,0,1,3,0,0,5,1,2,9,1
4937,194507,FlQozMQpruyYmAqeyZEzRE9TkM48Rlw4,RXDvfPUBYFlVdlueBFbLW0mhhAyGEqpt,4,2,1,0,1,0,1,0,5,0.7142857142857143,1,0.0,0,1,0,1,2,0,0,1,0,2,3,1
4938,194511,34PiVxaMQlPDCBhflVVNOJYBNiFJq4sd,G8EPVSXsOYB5YQWZGiz1aVq5Pgr2GrQu,4,2,0,0,0,0,2,0,4,0.5714285714285714,1,0.0,0,0,0,0,2,0,0,2,0,0,4,1
4939,194549,om0KjvovtBK0gZUSboAPRv5A6Jkm00Ei,G8EPVSXsOYB5YQWZGiz1aVq5Pgr2GrQu,1,0,0,0,0,0,2,0,2,0.2857142857142857,1,0.0,0,0,0,0,0,0,0,2,0,0,2,1
4940,194619,8IMVGvB09WRKHeXEjWGkZOVu6CXmlVXA,G8EPVSXsOYB5YQWZGiz1aVq5Pgr2GrQu,1,0,0,0,0,0,1,0,1,0.14285714285714285,1,0.0,0,0,0,0,0,0,0,1,0,0,1,1
4941,194625,cDJMTZrtYqA5Zzp6GydZkLUzHLBofVka,G8EPVSXsOYB5YQWZGiz1aVq5Pgr2GrQu,6,2,1,0,1,5,4,0,13,1.8571428571428572,1,0.0,0,1,0,1,2,5,0,4,0,2,11,0
4942,194633,NLv4FgxnCzxez4sx4x5czDhMA2RThzip,G8EPVSXsOYB5YQWZGiz1aVq5Pgr2GrQu,11,8,1,0,1,0,3,0,13,1.8571428571428572,1,0.0,0,1,0,1,8,0,0,3,0,2,11,0
4943,194813,pFd3DZfpKrECGIK8sknjrUy2fJFwKULW,G8EPVSXsOYB5YQWZGiz1aVq5Pgr2GrQu,2,0,0,0,0,0,3,0,3,0.42857142857142855,1,0.0,0,0,0,0,0,0,0,3,0,0,3,1
4944,194844,V6I2tWMT4J6OaEfYWYGJXMvy6YbJ0vQk,RXDvfPUBYFlVdlueBFbLW0mhhAyGEqpt,1,0,0,0,0,0,1,0,1,0.14285714285714285,1,0.0,0,0,0,0,0,0,0,1,0,0,1,1
4945,194870,4sHw1UrsiyaJNXlPeVCwFs89kPI7rFXb,RXDvfPUBYFlVdlueBFbLW0mhhAyGEqpt,1,0,0,0,0,0,1,0,1,0.14285714285714285,1,0.0,0,0,0,0,0,0,0,1,0,0,1,1
4946,194930,4pOcM6UwGexWSApv8Q2hzDn3Wxf1tNaX,G8EPVSXsOYB5YQWZGiz1aVq5Pgr2GrQu,2,0,0,0,0,0,4,0,4,0.5714285714285714,1,0.0,0,0,0,0,0,0,0,4,0,0,4,1
4947,194965,FuiskmcpMN6lu4pckLk8iCQBFUYbh2yw,G8EPVSXsOYB5YQWZGiz1aVq5Pgr2GrQu,6,3,1,0,1,0,2,0,7,1.0,1,0.0,0,1,0,1,3,0,0,2,0,2,5,1
4948,195013,Y8EaHrodQDFZUcVDuYNEubkGRhsaWq8Y,RXDvfPUBYFlVdlueBFbLW0mhhAyGEqpt,6,0,0,0,0,0,10,3,13,1.8571428571428572,1,0.0,0,0,0,0,0,0,0,10,3,0,13,1
4949,195033,IPw8SBo730f13L9fdyPJQsRb6dxi5glI,G8EPVSXsOYB5YQWZGiz1aVq5Pgr2GrQu,7,6,0,0,0,0,2,0,8,1.1428571428571428,1,0.0,0,0,0,0,6,0,0,2,0,0,8,1
4950,195040,B8Q6zzQbCDmmGJ2Jkpuj3FBNKJuawYVo,G8EPVSXsOYB5YQWZGiz1aVq5Pgr2GrQu,4,4,0,0,0,0,2,0,6,0.8571428571428571,1,0.0,0,0,0,0,4,0,0,2,0,0,6,1
4951,195062,9YkZ5i0tAbds4GKPFoxObCx79Yv0yxVA,G8EPVSXsOYB5YQWZGiz1aVq5Pgr2GrQu,22,21,13,26,7,1,4,0,72,10.285714285714286,1,0.0,6,13,19,7,15,1,7,4,0,45,27,0
4952,195175,02LTWEFxRPP3VB0zkhjBsebsLQ1XAvEO,G8EPVSXsOYB5YQWZGiz1aVq5Pgr2GrQu,1,0,0,0,0,0,1,0,1,0.14285714285714285,1,0.0,0,0,0,0,0,0,0,1,0,0,1,1
4953,195184,NtEul7SVttJozgojuYe5lpg4GBGEyM2O,G8EPVSXsOYB5YQWZGiz1aVq5Pgr2GrQu,6,0,0,0,0,1,5,1,7,1.0,1,0.0,0,0,0,0,0,1,0,5,1,0,7,1
4954,195219,Nvud1QIhR4FBjW055r9HSxywupZk5GAR,RXDvfPUBYFlVdlueBFbLW0mhhAyGEqpt,10,6,1,0,1,0,6,3,17,2.4285714285714284,1,0.0,0,1,0,1,6,0,0,6,3,2,15,0
4955,195235,fIET0xNMcDIlnjd0AnC9TZEnn5s3AA6i,G8EPVSXsOYB5YQWZGiz1aVq5Pgr2GrQu,21,23,5,18,4,1,5,0,56,8.0,1,0.0,15,5,9,4,8,1,9,5,0,33,23,1
4956,195260,sbaJoVFlMLyfg1PbRG67GWzU7ygSqHEa,G8EPVSXsOYB5YQWZGiz1aVq5Pgr2GrQu,4,6,0,0,0,0,4,0,10,1.4285714285714286,1,0.0,0,0,0,0,6,0,0,4,0,0,10,0
4957,195318,ee58foeX64HQVEJT3urOlMI7BjSHbs8j,G8EPVSXsOYB5YQWZGiz1aVq5Pgr2GrQu,5,5,0,0,0,0,4,0,9,1.2857142857142858,1,0.0,0,0,0,0,5,0,0,4,0,0,9,1
4958,195326,0Si73COGxildPoctZYuOxLe1rgf9eDaM,RXDvfPUBYFlVdlueBFbLW0mhhAyGEqpt,8,3,1,0,1,0,3,0,8,1.1428571428571428,1,0.0,0,1,0,1,3,0,0,3,0,2,6,1
4959,195423,5qPjBVti4pvxDDFGs1UFTjnAG1OLcLcB,RXDvfPUBYFlVdlueBFbLW0mhhAyGEqpt,3,2,0,0,0,0,1,0,3,0.42857142857142855,1,0.0,0,0,0,0,2,0,0,1,0,0,3,1
4960,195475,VCHjbUg5mmZIrDffSGKLebg8S6dLXnyn,RXDvfPUBYFlVdlueBFbLW0mhhAyGEqpt,2,0,0,0,0,0,2,0,2,0.2857142857142857,1,0.0,0,0,0,0,0,0,0,2,0,0,2,0
4961,195544,BXV7sGq2IrRSqCFuLKgoxpKYDPSPpUSj,G8EPVSXsOYB5YQWZGiz1aVq5Pgr2GrQu,1,0,0,0,0,0,1,0,1,0.14285714285714285,1,0.0,0,0,0,0,0,0,0,1,0,0,1,1
4962,195552,xNnZt1wpctMu8RWBLbfzbKE1cqLvtEr3,G8EPVSXsOYB5YQWZGiz1aVq5Pgr2GrQu,1,0,0,0,0,0,1,0,1,0.14285714285714285,1,0.0,0,0,0,0,0,0,0,1,0,0,1,1
4963,195562,mfr902ctNImyZnb2hOpmu3P3IkYTM2W3,G8EPVSXsOYB5YQWZGiz1aVq5Pgr2GrQu,37,55,14,64,7,0,1,0,141,20.142857142857142,1,0.0,32,14,43,7,23,0,21,1,0,96,45,1
4964,195570,UcPGwduguQweVEpy1bHMRcDAVjaxDzZ7,G8EPVSXsOYB5YQWZGiz1aVq5Pgr2GrQu,7,3,2,0,2,0,2,0,9,1.2857142857142858,1,0.0,0,2,0,2,3,0,0,2,0,4,5,1
