,enrollment_id,username,course_id,no_of_objects3,bno_access3,bno_pageclose3,bno_problem3,bno_video3,bno_discussion3,bno_navigate3,bno_wiki3,bno_total3,bno_avg3,no_of_active_days3,time_consumption3,browser_access3,browser_pageclose3,browser_problem3,browser_video3,server_access3,server_discussion3,server_problem3,server_navigate3,server_wiki3,bno_browser3,bno_server3,label
0,34,OeLBIzS0gNQ56euxy5b66gAZMzQCGE7n,7GRhBDsirIGkRZBtSMEzNTyDr2JQm4xx,38,104,26,68,19,3,18,1,239,34.142857142857146,7,-12704537.0,61,26,58,19,43,3,10,18,1,164,75,0
1,66,cGrHiRjztN9fSltHujpfWaaWfYWiidiG,7GRhBDsirIGkRZBtSMEzNTyDr2JQm4xx,48,130,33,78,17,139,17,0,414,59.142857142857146,3,0.0,42,33,61,17,88,139,17,17,0,153,261,0
2,89,Po17baTutQqG3KBkMaahpxQ7IpjhFfZa,7GRhBDsirIGkRZBtSMEzNTyDr2JQm4xx,28,76,4,44,13,3,3,0,143,20.428571428571427,4,0.0,42,4,39,13,34,3,5,3,0,98,45,1
3,145,TZOWoG0yzTTzAfx5K054mpl5rZTlZIcZ,7GRhBDsirIGkRZBtSMEzNTyDr2JQm4xx,30,89,32,28,22,6,7,1,185,26.428571428571427,6,0.0,28,32,25,22,61,6,3,7,1,107,78,1
4,163,jJZ8z8M2beLy33Z7JJbNFq1bQd8o43FV,7GRhBDsirIGkRZBtSMEzNTyDr2JQm4xx,5,4,2,0,0,0,2,0,8,1.1428571428571428,1,0.0,1,2,0,0,3,0,0,2,0,3,5,1
5,312,BCPhbcVTukJPsOtUJJbyOWvpso8GiEV1,7GRhBDsirIGkRZBtSMEzNTyDr2JQm4xx,37,125,27,119,36,37,26,0,370,52.857142857142854,3,0.0,87,27,99,36,38,37,20,26,0,249,121,0
6,384,zcVNiJm0X4Vm9oBHkuQez1iW6Hb7iAYl,7GRhBDsirIGkRZBtSMEzNTyDr2JQm4xx,17,29,9,11,18,1,3,0,71,10.142857142857142,1,0.0,20,9,11,18,9,1,0,3,0,58,13,1
7,405,jWgeQ7calOYQcs5lv7T9mWy3KUSp4lwk,7GRhBDsirIGkRZBtSMEzNTyDr2JQm4xx,1,0,0,0,0,0,1,0,1,0.14285714285714285,1,0.0,0,0,0,0,0,0,0,1,0,0,1,1
8,488,j2rHuSroJ2LNNnea5uXtGt5k8dfNg0dE,7GRhBDsirIGkRZBtSMEzNTyDr2JQm4xx,5,2,1,0,1,0,2,0,6,0.8571428571428571,1,0.0,0,1,0,1,2,0,0,2,0,2,4,1
9,508,hbwWiZJx2DqUaUjG4c2EvTFTwMA32fWP,7GRhBDsirIGkRZBtSMEzNTyDr2JQm4xx,37,108,32,52,6,1,3,0,202,28.857142857142858,2,0.0,66,32,46,6,42,1,6,3,0,150,52,1
10,571,cuuYGTWWAmhidQoRHdGzANriCatcPrlK,7GRhBDsirIGkRZBtSMEzNTyDr2JQm4xx,10,32,8,15,0,6,2,0,63,9.0,2,0.0,23,8,12,0,9,6,3,2,0,43,20,0
11,578,eER8RoiVQhlBLlO4WV7kKfWOx4XE0E9c,7GRhBDsirIGkRZBtSMEzNTyDr2JQm4xx,13,17,11,6,9,3,3,0,49,7.0,2,0.0,4,11,5,9,13,3,1,3,0,29,20,1
12,618,M5ID2aNMWGm5ShsGkFPYgTgN2UReXK8g,7GRhBDsirIGkRZBtSMEzNTyDr2JQm4xx,19,29,12,32,12,2,3,0,90,12.857142857142858,2,0.0,14,12,27,12,15,2,5,3,0,65,25,1
13,694,DVxZxPUgYsodJVtjUg4HG3ZucfJoWgwo,7GRhBDsirIGkRZBtSMEzNTyDr2JQm4xx,7,5,1,2,2,0,2,0,12,1.7142857142857142,1,0.0,2,1,2,2,3,0,0,2,0,7,5,1
14,755,qVDHsjIzoOtZnTwpJtbJGpvapy4sRYpW,7GRhBDsirIGkRZBtSMEzNTyDr2JQm4xx,1,1,0,0,0,0,0,0,1,0.14285714285714285,1,0.0,0,0,0,0,1,0,0,0,0,0,1,1
15,849,se5zs87qj8m5HDpiAuY9fHW8e8hfOFuJ,7GRhBDsirIGkRZBtSMEzNTyDr2JQm4xx,3,2,1,0,0,0,1,0,4,0.5714285714285714,1,0.0,0,1,0,0,2,0,0,1,0,1,3,0
16,948,iYWLR7w0j5yEEe1bCu5IYYyXjnXbv448,7GRhBDsirIGkRZBtSMEzNTyDr2JQm4xx,11,11,7,2,1,0,2,0,23,3.2857142857142856,1,0.0,3,7,1,1,8,0,1,2,0,12,11,0
17,1130,aaJeZnIT5e0GpVZyGMksW5aGfCnXK0Ln,7GRhBDsirIGkRZBtSMEzNTyDr2JQm4xx,13,14,1,10,0,0,1,0,26,3.7142857142857144,1,0.0,6,1,5,0,8,0,5,1,0,12,14,1
18,1194,WFh9KL1sDhp4NpPSjJuGtUwdjU2As3jU,7GRhBDsirIGkRZBtSMEzNTyDr2JQm4xx,33,61,9,101,8,7,24,1,211,30.142857142857142,4,0.0,32,9,93,8,29,7,8,24,1,142,69,1
19,1293,2CIqPxwfpdleLKAwuxTPlDujU1ToKMCe,7GRhBDsirIGkRZBtSMEzNTyDr2JQm4xx,30,39,18,67,9,21,8,0,162,23.142857142857142,3,0.0,14,18,59,9,25,21,8,8,0,100,62,0
20,1304,CSh5hGbaSFu2yCb31iVMOVwKocrH471Q,7GRhBDsirIGkRZBtSMEzNTyDr2JQm4xx,6,3,2,0,1,0,2,0,8,1.1428571428571428,1,0.0,0,2,0,1,3,0,0,2,0,3,5,1
21,1334,BdwcZr5MO8X0sPJO0Tqucc1g1g6IA4vq,7GRhBDsirIGkRZBtSMEzNTyDr2JQm4xx,44,257,58,73,14,18,11,0,431,61.57142857142857,4,0.0,140,58,66,14,117,18,7,11,0,278,153,0
22,1396,4pgEahxP0BMucPOaES4iKt1glSEl2goc,7GRhBDsirIGkRZBtSMEzNTyDr2JQm4xx,37,76,16,50,14,0,12,0,168,24.0,3,0.0,35,16,38,14,41,0,12,12,0,103,65,0
23,1436,hmtOqZVjWQ6rLJb3YkFWytQIy20ogszh,7GRhBDsirIGkRZBtSMEzNTyDr2JQm4xx,6,8,2,0,3,4,2,0,19,2.7142857142857144,1,0.0,2,2,0,3,6,4,0,2,0,7,12,1
24,1644,P18honwQPPbELUE86qFIATuZK3YDtjvG,7GRhBDsirIGkRZBtSMEzNTyDr2JQm4xx,8,8,2,4,1,0,2,0,17,2.4285714285714284,2,0.0,1,2,4,1,7,0,0,2,0,8,9,1
25,1739,MSwjf2I17FAgMFqknSNlHHVpwcQKsxyQ,7GRhBDsirIGkRZBtSMEzNTyDr2JQm4xx,90,137,44,137,45,112,17,5,497,71.0,4,0.0,69,44,111,45,68,112,26,17,5,269,228,1
26,1765,8nlNDsWSaxHCvsMKtqhBs81sknEiTCeb,7GRhBDsirIGkRZBtSMEzNTyDr2JQm4xx,63,59,27,42,31,0,5,0,164,23.428571428571427,2,0.0,24,27,32,31,35,0,10,5,0,114,50,0
27,1771,jImHfNEIObE674KdIbKVj7cCJ4ufqzHJ,7GRhBDsirIGkRZBtSMEzNTyDr2JQm4xx,18,45,27,2,7,330,41,4,456,65.14285714285714,7,0.0,4,27,1,7,41,330,1,41,4,39,417,0
28,1775,mIe8dQN3qDFpsTsivIoOXC4yOCPP2RyG,7GRhBDsirIGkRZBtSMEzNTyDr2JQm4xx,50,184,35,41,24,25,11,1,321,45.857142857142854,4,0.0,97,35,40,24,87,25,1,11,1,196,125,0
29,1802,STdhsQG5tLZHsan5xGUL8YXDFoc6MDRe,fbPkOYLVPtPgIt0MxizjfFJov3JbHyAi,21,48,3,30,3,9,8,0,101,14.428571428571429,2,0.0,20,3,30,3,28,9,0,8,0,56,45,0
30,1808,Slk5JcZSYHmDLQZXaNVmcMDmjJ16kBhI,fbPkOYLVPtPgIt0MxizjfFJov3JbHyAi,15,44,1,6,3,0,8,0,62,8.857142857142858,5,0.0,11,1,5,3,33,0,1,8,0,20,42,1
31,1814,KVMcZ0CphnUUs4jbRYRdgMvMogJko09j,fbPkOYLVPtPgIt0MxizjfFJov3JbHyAi,24,36,26,10,10,14,6,0,102,14.571428571428571,2,0.0,6,26,9,10,30,14,1,6,0,51,51,0
32,1824,iQpP0qT2CHD9i5LDED8ej6YadyfX6mXh,fbPkOYLVPtPgIt0MxizjfFJov3JbHyAi,5,3,1,0,1,0,2,0,7,1.0,1,0.0,0,1,0,1,3,0,0,2,0,2,5,1
33,1836,XlDfnhryafmarvecZhKZMWL7AupGjwi4,fbPkOYLVPtPgIt0MxizjfFJov3JbHyAi,3,5,1,0,0,0,3,0,9,1.2857142857142858,2,0.0,0,1,0,0,5,0,0,3,0,1,8,1
34,1848,JfQVgXDVu1NGs9lcRBOD4w6V7BSaZCc2,fbPkOYLVPtPgIt0MxizjfFJov3JbHyAi,20,20,11,16,6,4,6,0,63,9.0,5,0.0,5,11,13,6,15,4,3,6,0,35,28,0
35,1850,62aEkx5hiqjq7miMyrFwVbP7Jkesq4eo,fbPkOYLVPtPgIt0MxizjfFJov3JbHyAi,5,4,2,0,1,0,1,0,8,1.1428571428571428,1,0.0,1,2,0,1,3,0,0,1,0,4,4,0
36,1851,cAUuHXvOoCXwQjZWWRqNDA8udivSTUZW,fbPkOYLVPtPgIt0MxizjfFJov3JbHyAi,13,14,0,0,2,0,2,0,18,2.5714285714285716,1,0.0,2,0,0,2,12,0,0,2,0,4,14,0
37,1854,sjBn8oayOINN3T3JZLXHY4beCfaHLSkq,fbPkOYLVPtPgIt0MxizjfFJov3JbHyAi,3,2,0,0,0,0,1,0,3,0.42857142857142855,1,0.0,0,0,0,0,2,0,0,1,0,0,3,0
38,1855,cy2CnLMLxJkryBCEHSwR3ZMTpAjnoO1C,fbPkOYLVPtPgIt0MxizjfFJov3JbHyAi,27,53,6,9,3,61,10,0,142,20.285714285714285,4,0.0,6,6,8,3,47,61,1,10,0,23,119,0
39,1857,3LBSAbcxxmlIGNLvUbxOBHP17eWw2EWo,fbPkOYLVPtPgIt0MxizjfFJov3JbHyAi,44,53,33,27,14,26,11,1,165,23.571428571428573,2,0.0,13,33,26,14,40,26,1,11,1,86,79,0
40,1858,K0OSl2yDmHYQ9TtZdxy9shErNwx3ga0n,fbPkOYLVPtPgIt0MxizjfFJov3JbHyAi,9,8,2,1,4,5,7,0,27,3.857142857142857,1,0.0,4,2,1,4,4,5,0,7,0,11,16,0
41,1868,euJ8gpxfARpnWjt9X8Fyxm47A6A32cKl,fbPkOYLVPtPgIt0MxizjfFJov3JbHyAi,21,56,36,24,25,9,10,0,160,22.857142857142858,5,0.0,11,36,18,25,45,9,6,10,0,90,70,0
42,1887,K4MChPhhtYZYK5nsYtiS9NQwcF94wGaC,fbPkOYLVPtPgIt0MxizjfFJov3JbHyAi,1,0,0,0,0,0,1,0,1,0.14285714285714285,1,0.0,0,0,0,0,0,0,0,1,0,0,1,1
43,1889,9lZ5nNFJAuEwr4dRJLRoTk52o5oWJaUg,fbPkOYLVPtPgIt0MxizjfFJov3JbHyAi,18,25,15,5,6,17,6,0,74,10.571428571428571,4,0.0,5,15,5,6,20,17,0,6,0,31,43,0
44,1892,h8BwrBZ61dHhi5fhxZzTUeeYh9J3sER4,fbPkOYLVPtPgIt0MxizjfFJov3JbHyAi,13,10,8,0,4,0,3,0,25,3.5714285714285716,1,0.0,0,8,0,4,10,0,0,3,0,12,13,0
45,1907,O4E7as3W8jLvygS4k9RX6VKdAkX7GkpR,fbPkOYLVPtPgIt0MxizjfFJov3JbHyAi,15,22,1,14,1,3,15,0,56,8.0,2,0.0,8,1,10,1,14,3,4,15,0,20,36,0
46,1908,uJfbc9I7P24gwBxCb4NuFSYLPcQJXbJC,fbPkOYLVPtPgIt0MxizjfFJov3JbHyAi,24,53,38,10,18,24,9,0,152,21.714285714285715,4,0.0,9,38,9,18,44,24,1,9,0,74,78,0
47,1914,Ms0MC4W5moiGJLWP7iE3FImeH9CHN4KT,fbPkOYLVPtPgIt0MxizjfFJov3JbHyAi,41,29,22,0,18,0,4,0,73,10.428571428571429,1,0.0,4,22,0,18,25,0,0,4,0,44,29,0
48,1919,ZVE1PX7xOz79BV4QTr7JFzHx09U83o43,fbPkOYLVPtPgIt0MxizjfFJov3JbHyAi,10,8,5,5,2,10,0,0,30,4.285714285714286,1,0.0,2,5,4,2,6,10,1,0,0,13,17,0
49,1920,3Nb5o5OohsDNIgLceYbTurAWBMiIQRDh,fbPkOYLVPtPgIt0MxizjfFJov3JbHyAi,4,4,3,0,0,5,4,0,16,2.2857142857142856,2,0.0,0,3,0,0,4,5,0,4,0,3,13,0
50,1927,KGKXtIu1hkHju7SCZs8gtmA9OwHIqK9w,fbPkOYLVPtPgIt0MxizjfFJov3JbHyAi,35,63,44,0,22,58,15,0,202,28.857142857142858,5,0.0,7,44,0,22,56,58,0,15,0,73,129,0
51,1930,7Qi8MZVdpAWF6Jx24ApQvOp3KudDuUEC,fbPkOYLVPtPgIt0MxizjfFJov3JbHyAi,5,3,2,0,1,0,1,0,7,1.0,1,0.0,0,2,0,1,3,0,0,1,0,3,4,1
52,1937,vtrHNbtnxRGyZem1sSOdKIp109fZtSKY,fbPkOYLVPtPgIt0MxizjfFJov3JbHyAi,4,2,1,0,0,3,2,0,8,1.1428571428571428,1,0.0,0,1,0,0,2,3,0,2,0,1,7,0
53,1944,FPtAc2MhfpwZkpPIx5xZqPDLAMDq2xlZ,fbPkOYLVPtPgIt0MxizjfFJov3JbHyAi,7,9,7,0,0,0,2,0,18,2.5714285714285716,1,0.0,0,7,0,0,9,0,0,2,0,7,11,0
54,1946,oNX40hvUpCseO8BHKhGJvG2jyQpYKQyk,fbPkOYLVPtPgIt0MxizjfFJov3JbHyAi,16,15,7,8,4,0,2,0,36,5.142857142857143,2,0.0,4,7,8,4,11,0,0,2,0,23,13,0
55,3978,h8n9HekAuyT08sLL5qmdMZ3BdSJVR4QF,fbPkOYLVPtPgIt0MxizjfFJov3JbHyAi,4,4,2,0,0,4,2,0,12,1.7142857142857142,1,0.0,0,2,0,0,4,4,0,2,0,2,10,0
56,3979,2GATpIfDBYFyTgYmFkr0bda9mVfNXuAl,fbPkOYLVPtPgIt0MxizjfFJov3JbHyAi,20,26,13,10,8,0,4,0,61,8.714285714285714,2,0.0,8,13,10,8,18,0,0,4,0,39,22,0
57,3980,7CTS8g5RByDUjwfG52XdQusTnAWGmBhD,fbPkOYLVPtPgIt0MxizjfFJov3JbHyAi,1,3,0,0,0,0,0,0,3,0.42857142857142855,2,0.0,0,0,0,0,3,0,0,0,0,0,3,1
58,3996,w2cvWGtYDFIPnh2ovYoWa5sxrg1Qp0H1,fbPkOYLVPtPgIt0MxizjfFJov3JbHyAi,11,11,8,0,5,0,3,0,27,3.857142857142857,1,0.0,0,8,0,5,11,0,0,3,0,13,14,1
59,3998,q4Yehmjs3jQT9rXdV6cXhcGjESMqINf5,fbPkOYLVPtPgIt0MxizjfFJov3JbHyAi,20,21,13,11,10,0,2,0,57,8.142857142857142,1,0.0,6,13,11,10,15,0,0,2,0,40,17,0
60,4007,tfoakS3EMOjWuYWNRSgWZTjBxe3Mf9Te,fbPkOYLVPtPgIt0MxizjfFJov3JbHyAi,8,6,4,0,2,0,3,0,15,2.142857142857143,1,0.0,0,4,0,2,6,0,0,3,0,6,9,0
61,4008,54s32diFNl04mUbmkn3h7tEt4XEhQ65w,fbPkOYLVPtPgIt0MxizjfFJov3JbHyAi,10,12,1,11,3,0,1,0,28,4.0,1,0.0,7,1,10,3,5,0,1,1,0,21,7,0
62,4023,A98oANyiAwfle2kQ1TjJxeaYVrk9o9i7,fbPkOYLVPtPgIt0MxizjfFJov3JbHyAi,5,3,2,0,0,0,5,0,10,1.4285714285714286,1,0.0,0,2,0,0,3,0,0,5,0,2,8,1
63,4027,WYF6gnZ4xRpre5Df26WMDKWFofwrAPRG,fbPkOYLVPtPgIt0MxizjfFJov3JbHyAi,5,10,0,0,0,0,2,0,12,1.7142857142857142,2,0.0,1,0,0,0,9,0,0,2,0,1,11,1
64,4032,rLDet26H0uxPJ5dsCZ5fa0WL1GxwPxuK,fbPkOYLVPtPgIt0MxizjfFJov3JbHyAi,4,2,1,0,0,10,5,0,18,2.5714285714285716,1,0.0,0,1,0,0,2,10,0,5,0,1,17,1
65,4038,RZRLmBfJaLV1U3x2iNOo982VF2lx4M5E,fbPkOYLVPtPgIt0MxizjfFJov3JbHyAi,1,0,0,0,0,6,0,0,6,0.8571428571428571,1,0.0,0,0,0,0,0,6,0,0,0,0,6,0
66,4045,hC8ztRi3EjwyWcSJecvgX15KmWpaGcdW,fbPkOYLVPtPgIt0MxizjfFJov3JbHyAi,11,15,9,0,6,1,14,1,46,6.571428571428571,3,0.0,0,9,0,6,15,1,0,14,1,15,31,1
67,4055,rAB3GdBf2kyPvfhSALJZpfL3o8n2yfaM,fbPkOYLVPtPgIt0MxizjfFJov3JbHyAi,12,14,9,4,5,0,4,0,36,5.142857142857143,3,0.0,1,9,3,5,13,0,1,4,0,18,18,1
68,4074,pPhnCYGqjbUED63FvqrsKWCb9oPSb13A,fbPkOYLVPtPgIt0MxizjfFJov3JbHyAi,3,2,1,0,0,0,1,0,4,0.5714285714285714,1,0.0,0,1,0,0,2,0,0,1,0,1,3,1
69,4082,Intzo0A8tpMyd3IA01YG1BctRIdPWdNV,fbPkOYLVPtPgIt0MxizjfFJov3JbHyAi,3,0,0,0,0,2,2,0,4,0.5714285714285714,1,0.0,0,0,0,0,0,2,0,2,0,0,4,0
70,4087,kyUPY0MEVeZNvkmrQxOn0CHNXLZiD03b,fbPkOYLVPtPgIt0MxizjfFJov3JbHyAi,14,22,14,0,6,10,7,0,59,8.428571428571429,2,0.0,4,14,0,6,18,10,0,7,0,24,35,0
71,4096,7f5BucMg0feISwFBvqaHF0DKL8QG4WFt,fbPkOYLVPtPgIt0MxizjfFJov3JbHyAi,3,2,1,0,0,0,1,0,4,0.5714285714285714,1,0.0,0,1,0,0,2,0,0,1,0,1,3,1
72,4099,Rp1QUon6WyfjWJdUcBo02v2P6oL5StoN,fbPkOYLVPtPgIt0MxizjfFJov3JbHyAi,8,8,6,0,4,0,2,0,20,2.857142857142857,1,0.0,0,6,0,4,8,0,0,2,0,10,10,0
73,4100,biOEnvJNbNmJmtnLohBToN5g3ppQrMj4,fbPkOYLVPtPgIt0MxizjfFJov3JbHyAi,27,80,40,19,15,6,7,1,168,24.0,3,0.0,25,40,17,15,55,6,2,7,1,97,71,0
74,4107,hXZgc5Oc8L3KNvO8ElQE29RF6Exzr76M,fbPkOYLVPtPgIt0MxizjfFJov3JbHyAi,6,10,0,0,0,7,3,0,20,2.857142857142857,3,0.0,0,0,0,0,10,7,0,3,0,0,20,1
75,4110,IhZdPOtOeXyg0OwsQIkD0XHc4IVBLzMp,fbPkOYLVPtPgIt0MxizjfFJov3JbHyAi,8,12,9,0,0,0,3,0,24,3.4285714285714284,1,0.0,1,9,0,0,11,0,0,3,0,10,14,1
76,4123,v5fgLzwSp4csuplvg9kjWtplfkZ2GwCX,fbPkOYLVPtPgIt0MxizjfFJov3JbHyAi,10,15,10,3,6,7,4,0,45,6.428571428571429,2,0.0,1,10,3,6,14,7,0,4,0,20,25,1
77,4156,7wnX5auEB03UpnNYej7D6uFMFlr0UMF4,fbPkOYLVPtPgIt0MxizjfFJov3JbHyAi,2,0,0,0,0,3,1,0,4,0.5714285714285714,1,0.0,0,0,0,0,0,3,0,1,0,0,4,1
78,4166,bUnyK1hKhmXoEcHzbj5c3xR9U7XUAY5Y,fbPkOYLVPtPgIt0MxizjfFJov3JbHyAi,4,6,1,0,1,0,0,0,8,1.1428571428571428,1,0.0,0,1,0,1,6,0,0,0,0,2,6,1
79,4180,vQkP6BX5beW8TPAuFxWcKaAXLl3r77bC,SpATywNh6bZuzm8s1ceuBUnMUAeoAHHw,4,3,2,0,2,0,2,0,9,1.2857142857142858,1,0.0,0,2,0,2,3,0,0,2,0,4,5,1
80,4188,Em0hjKXRkhdtpThrexhSS4wvCtqaUFMH,SpATywNh6bZuzm8s1ceuBUnMUAeoAHHw,26,38,13,35,6,0,4,0,96,13.714285714285714,2,0.0,22,13,29,6,16,0,6,4,0,70,26,0
81,4189,DMRT6aSto1hsV85RHmev1d5IWcNMIFEq,SpATywNh6bZuzm8s1ceuBUnMUAeoAHHw,7,6,3,10,1,0,0,0,20,2.857142857142857,1,0.0,4,3,9,1,2,0,1,0,0,17,3,0
82,4257,7FYMj2bFfaTXHKfoaKa59KqAPXY4BWgD,SpATywNh6bZuzm8s1ceuBUnMUAeoAHHw,4,2,1,0,0,0,3,0,6,0.8571428571428571,2,0.0,0,1,0,0,2,0,0,3,0,1,5,0
83,4264,I91CCtQfetYUPwkEXIvTFBP6tbrp1spN,SpATywNh6bZuzm8s1ceuBUnMUAeoAHHw,3,9,5,0,0,0,4,0,18,2.5714285714285716,3,0.0,0,5,0,0,9,0,0,4,0,5,13,0
84,4267,RGl45e2VVMMdpatWhMc5IOKclnuxXpA1,SpATywNh6bZuzm8s1ceuBUnMUAeoAHHw,10,12,7,0,4,0,3,0,26,3.7142857142857144,2,0.0,0,7,0,4,12,0,0,3,0,11,15,0
85,4282,sm8Pt42lYmt5RjZttn9EWmBp0Dzh6yOg,G8EPVSXsOYB5YQWZGiz1aVq5Pgr2GrQu,35,34,19,0,16,0,5,0,74,10.571428571428571,2,0.0,3,19,0,16,31,0,0,5,0,38,36,1
86,4289,zEiNHlokNuJTLVoV4Hy4kJd9kzaIjztD,G8EPVSXsOYB5YQWZGiz1aVq5Pgr2GrQu,26,29,17,50,5,174,5,3,283,40.42857142857143,6,0.0,2,17,49,5,27,174,1,5,3,73,210,1
87,4307,T90Hs0qj1GFlvauwj06O8IdnwXmrJzdZ,SpATywNh6bZuzm8s1ceuBUnMUAeoAHHw,9,24,1,5,0,0,2,0,32,4.571428571428571,1,0.0,1,1,4,0,23,0,1,2,0,6,26,1
88,4315,BQkLFspAkEwZRgeuoSbQxFTr6POAaRzP,SpATywNh6bZuzm8s1ceuBUnMUAeoAHHw,2,0,0,0,0,0,3,0,3,0.42857142857142855,1,0.0,0,0,0,0,0,0,0,3,0,0,3,0
89,4356,4K59wuCrpPJyRcx38K4BUYetxztFLpnt,SpATywNh6bZuzm8s1ceuBUnMUAeoAHHw,9,4,3,0,3,0,4,0,14,2.0,1,0.0,0,3,0,3,4,0,0,4,0,6,8,1
90,4363,TQnfaXCRCgVZx9kYYn4s6Q3eXGXW2mAu,SpATywNh6bZuzm8s1ceuBUnMUAeoAHHw,5,9,3,0,1,0,4,0,17,2.4285714285714284,2,0.0,0,3,0,1,9,0,0,4,0,4,13,0
91,4367,5I2aLwWP8vG6g175Y3fJi9X9n53v6aCn,SpATywNh6bZuzm8s1ceuBUnMUAeoAHHw,5,4,2,0,0,17,6,0,29,4.142857142857143,4,0.0,0,2,0,0,4,17,0,6,0,2,27,1
92,4380,5GeMwmyzCXMcMYfcWdKaXbpNNdL8bmPq,bWdj2GDclj5ofokWjzoa5jAwMkxCykd6,18,20,8,30,3,54,26,0,141,20.142857142857142,4,0.0,4,8,25,3,16,54,5,26,0,40,101,0
93,4385,wzrtLsMLUwSE1eXDXVMESg2JjrWZl4JD,SpATywNh6bZuzm8s1ceuBUnMUAeoAHHw,7,16,8,0,0,6,8,0,38,5.428571428571429,4,0.0,3,8,0,0,13,6,0,8,0,11,27,0
94,4417,0wJhtCWK60WPCeRF62m8T80DtNpWhRrg,A3fsA9Zfv1X2fVEQhTw51lKENdNrEqT3,5,10,5,0,0,0,2,0,17,2.4285714285714284,2,0.0,0,5,0,0,10,0,0,2,0,5,12,1
95,4427,8DDe6pT3DTsk8IoUaxeHbA3kSbfeV3pT,SpATywNh6bZuzm8s1ceuBUnMUAeoAHHw,12,29,8,3,1,0,19,0,60,8.571428571428571,3,0.0,5,8,3,1,24,0,0,19,0,17,43,1
96,4429,BKMLDrZrwnjIMy3sAyFHQhrFM6liXbvY,SpATywNh6bZuzm8s1ceuBUnMUAeoAHHw,10,9,0,12,0,0,1,0,22,3.142857142857143,1,0.0,2,0,12,0,7,0,0,1,0,14,8,1
97,4438,3IgwuZBiVdgdYRQ9ySaEvpMizbjCJFS0,SpATywNh6bZuzm8s1ceuBUnMUAeoAHHw,18,13,7,12,5,21,5,0,63,9.0,2,0.0,4,7,10,5,9,21,2,5,0,26,37,0
98,4460,oxOzo82Nq65tcwE6AZvxglw3lN8SeywJ,bWdj2GDclj5ofokWjzoa5jAwMkxCykd6,5,3,2,0,1,0,1,0,7,1.0,1,0.0,0,2,0,1,3,0,0,1,0,3,4,1
99,4467,ud8Y2EsnBupML3rKElwJORvnGy1H8SMp,bWdj2GDclj5ofokWjzoa5jAwMkxCykd6,4,2,1,0,1,0,1,0,5,0.7142857142857143,1,0.0,0,1,0,1,2,0,0,1,0,2,3,1
100,4471,lEIFkqeT396JMSPUyiaHNMN8g7bQ1x9p,RXDvfPUBYFlVdlueBFbLW0mhhAyGEqpt,72,82,66,94,54,11,22,2,331,47.285714285714285,4,0.0,15,66,93,54,67,11,1,22,2,228,103,0
101,4492,800Nw5pvfdV7zCXCGav7KOLaYLAdOKht,SpATywNh6bZuzm8s1ceuBUnMUAeoAHHw,4,4,1,0,0,0,4,0,9,1.2857142857142858,2,0.0,0,1,0,0,4,0,0,4,0,1,8,0
102,4494,wONMmUHIYwPBmEB9lgpOY3KCldKiuZFl,G8EPVSXsOYB5YQWZGiz1aVq5Pgr2GrQu,40,42,10,56,6,0,14,0,128,18.285714285714285,3,0.0,28,10,34,6,14,0,22,14,0,78,50,0
103,4501,dQuJ0DGjqbpnmQbHBTUIoBt7YzvOBCuV,SpATywNh6bZuzm8s1ceuBUnMUAeoAHHw,11,12,7,0,4,0,1,0,24,3.4285714285714284,1,0.0,3,7,0,4,9,0,0,1,0,14,10,1
104,4503,JJDRXXLRU75H8Dx2cuK7Td1V7D7QoKg9,SpATywNh6bZuzm8s1ceuBUnMUAeoAHHw,22,26,0,26,1,0,11,0,64,9.142857142857142,4,0.0,7,0,25,1,19,0,1,11,0,33,31,0
105,4557,s4xNNQ4RZ35amMfmvZawsu7u8CabnIey,A3fsA9Zfv1X2fVEQhTw51lKENdNrEqT3,5,4,2,0,1,0,1,0,8,1.1428571428571428,1,0.0,0,2,0,1,4,0,0,1,0,3,5,0
106,4562,sOkc0wEXSSLpxtxlqjZObJqg94IyLpuY,bWdj2GDclj5ofokWjzoa5jAwMkxCykd6,14,17,1,20,0,0,6,0,44,6.285714285714286,3,0.0,3,1,16,0,14,0,4,6,0,20,24,1
107,4576,alnogGpZqhBWQHh6ZLeZUIXk896ksLOu,RXDvfPUBYFlVdlueBFbLW0mhhAyGEqpt,4,2,1,0,0,0,2,0,5,0.7142857142857143,1,0.0,0,1,0,0,2,0,0,2,0,1,4,1
108,4597,y7HHpDc09mCS3h1lthBIJASJI1RnROT7,RXDvfPUBYFlVdlueBFbLW0mhhAyGEqpt,7,4,3,0,2,0,1,0,10,1.4285714285714286,1,0.0,0,3,0,2,4,0,0,1,0,5,5,1
109,4639,3OcDTnCwcizCpcOtz2UR6tflsBOvlv2R,SpATywNh6bZuzm8s1ceuBUnMUAeoAHHw,4,4,0,0,0,0,4,0,8,1.1428571428571428,3,0.0,0,0,0,0,4,0,0,4,0,0,8,0
110,4642,qP2KbX0Pm1BCeErne0g8Q8oALeaVx7L6,SpATywNh6bZuzm8s1ceuBUnMUAeoAHHw,4,2,1,0,1,0,1,0,5,0.7142857142857143,1,0.0,0,1,0,1,2,0,0,1,0,2,3,0
111,4653,IeSddciCla7lkuGxlh3rPQuCAXyzOV2D,SpATywNh6bZuzm8s1ceuBUnMUAeoAHHw,17,13,6,16,3,9,6,2,55,7.857142857142857,2,0.0,6,6,13,3,7,9,3,6,2,28,27,1
112,4654,DsHgWZRTJ1y1l15smwhB78ZQq3d8dyKP,SpATywNh6bZuzm8s1ceuBUnMUAeoAHHw,1,0,0,0,0,0,5,0,5,0.7142857142857143,3,0.0,0,0,0,0,0,0,0,5,0,0,5,0
113,4668,r5RSR6lot2jmkfKvV1hMDjuwwaPyA58W,SpATywNh6bZuzm8s1ceuBUnMUAeoAHHw,4,4,1,0,0,0,5,0,10,1.4285714285714286,2,0.0,0,1,0,0,4,0,0,5,0,1,9,0
114,4678,SXmv5BCLsa8KcmJ2wx7Xg5CRI8Gu1aDd,bWdj2GDclj5ofokWjzoa5jAwMkxCykd6,9,8,4,0,3,0,3,0,18,2.5714285714285716,1,0.0,0,4,0,3,8,0,0,3,0,7,11,0
115,4682,a59vIKGy87nbLYAxp6cxkmNDzOYhSXnX,SpATywNh6bZuzm8s1ceuBUnMUAeoAHHw,21,20,16,13,8,2,5,0,64,9.142857142857142,2,0.0,2,16,13,8,18,2,0,5,0,39,25,1
116,4699,7xdvqdjwrTcnpU47VRFtnMnSYVyjOAaR,SpATywNh6bZuzm8s1ceuBUnMUAeoAHHw,2,0,0,0,0,0,2,0,2,0.2857142857142857,1,0.0,0,0,0,0,0,0,0,2,0,0,2,0
117,4701,eg4vjaGd0e6Yp3fu5azU2ZqedIZ6GBxl,SpATywNh6bZuzm8s1ceuBUnMUAeoAHHw,6,8,0,0,0,0,7,0,15,2.142857142857143,3,0.0,0,0,0,0,8,0,0,7,0,0,15,0
118,4703,C8ZlatATbcer8D4Z8pCX4rv1Rcx870po,RXDvfPUBYFlVdlueBFbLW0mhhAyGEqpt,26,28,16,75,11,16,3,0,149,21.285714285714285,2,0.0,9,16,56,11,19,16,19,3,0,92,57,0
119,4778,xcD6YWhnGA2xukGmX4eaYrm6VS9ffz1H,G8EPVSXsOYB5YQWZGiz1aVq5Pgr2GrQu,25,23,17,32,6,0,5,0,83,11.857142857142858,2,0.0,0,17,26,6,23,0,6,5,0,49,34,0
120,4810,2LtuchYgE8Pco2t6mZeF2PkyT5iYJ1L1,SpATywNh6bZuzm8s1ceuBUnMUAeoAHHw,14,22,4,8,2,5,10,0,51,7.285714285714286,4,0.0,2,4,8,2,20,5,0,10,0,16,35,0
121,4814,SmONSyS4YgG4Afnv6ZxU81t7p4CQPV5P,A3fsA9Zfv1X2fVEQhTw51lKENdNrEqT3,16,31,5,0,0,0,19,1,56,8.0,4,0.0,0,5,0,0,31,0,0,19,1,5,51,1
122,4828,f2h2VLvmMjqsSE1GgoTjiV7kOBQ7ba5D,SpATywNh6bZuzm8s1ceuBUnMUAeoAHHw,15,20,8,0,6,5,3,1,43,6.142857142857143,4,0.0,6,8,0,6,14,5,0,3,1,20,23,0
123,4853,6dSQI7mEgoqnNix7RTxCbRowcn4dgEn6,SpATywNh6bZuzm8s1ceuBUnMUAeoAHHw,7,3,2,7,1,0,3,0,16,2.2857142857142856,2,0.0,0,2,6,1,3,0,1,3,0,9,7,0
124,4862,9k6Repn2h6zXTygwvpy8LAM7GzTSYQBm,G8EPVSXsOYB5YQWZGiz1aVq5Pgr2GrQu,50,42,30,64,20,0,7,0,163,23.285714285714285,4,0.0,4,30,59,20,38,0,5,7,0,113,50,0
125,4866,GmHJt2279LUj6P2OGQD6V5Y1W95kmZpl,SpATywNh6bZuzm8s1ceuBUnMUAeoAHHw,7,7,0,0,0,17,4,0,28,4.0,2,0.0,0,0,0,0,7,17,0,4,0,0,28,1
126,4870,T2tyjiaDe9s4tWUugE6FZTShWofnfMqo,bWdj2GDclj5ofokWjzoa5jAwMkxCykd6,26,40,1,72,3,28,11,2,157,22.428571428571427,6,0.0,7,1,63,3,33,28,9,11,2,74,83,0
127,4885,sOkc0wEXSSLpxtxlqjZObJqg94IyLpuY,A3fsA9Zfv1X2fVEQhTw51lKENdNrEqT3,30,46,2,58,0,1,15,0,122,17.428571428571427,4,0.0,2,2,49,0,44,1,9,15,0,53,69,0
128,4912,gVGEUb9jfMmddRlcGqXsnz4ZV26w6q4e,SpATywNh6bZuzm8s1ceuBUnMUAeoAHHw,14,16,11,7,4,0,5,0,43,6.142857142857143,3,0.0,0,11,6,4,16,0,1,5,0,21,22,0
129,4945,ySy2zYThCkVZr5MjEXuKxq60wfOynxkJ,SpATywNh6bZuzm8s1ceuBUnMUAeoAHHw,5,4,0,0,0,7,6,1,18,2.5714285714285716,3,0.0,0,0,0,0,4,7,0,6,1,0,18,0
130,4946,SVwfCRY50hd9Fz0klab9XqT7QROcyhqY,SpATywNh6bZuzm8s1ceuBUnMUAeoAHHw,16,15,9,18,4,0,1,0,47,6.714285714285714,1,0.0,5,9,15,4,10,0,3,1,0,33,14,0
131,4950,QIQydLQKNp8IAhwJcWzcTMkwBUNbfwOF,SpATywNh6bZuzm8s1ceuBUnMUAeoAHHw,22,58,1,17,2,471,23,5,577,82.42857142857143,4,0.0,18,1,15,2,40,471,2,23,5,36,541,0
132,4953,VZdYnvKDyQlSbZcXkY9T9OB3rX2Vy7uz,SpATywNh6bZuzm8s1ceuBUnMUAeoAHHw,1,0,0,0,0,0,1,0,1,0.14285714285714285,1,0.0,0,0,0,0,0,0,0,1,0,0,1,1
133,4957,W4dUmcINvn4EmYk22ZRR3EuEX8WaEqL8,bWdj2GDclj5ofokWjzoa5jAwMkxCykd6,5,5,2,0,1,1,2,0,11,1.5714285714285714,1,0.0,0,2,0,1,5,1,0,2,0,3,8,1
134,4959,DCJHya56uWCPb8fqNJdPu3ruMX2t5RgK,bWdj2GDclj5ofokWjzoa5jAwMkxCykd6,1,0,0,0,0,0,1,0,1,0.14285714285714285,1,0.0,0,0,0,0,0,0,0,1,0,0,1,1
135,4981,syrttArug8Mpzs9L0IHsvBtATawYF9J2,bWdj2GDclj5ofokWjzoa5jAwMkxCykd6,18,13,7,16,4,0,4,0,44,6.285714285714286,2,0.0,3,7,14,4,10,0,2,4,0,28,16,0
136,4991,meJV5qRzmJA836PpWZKeoFo4ZX1xiQOS,RXDvfPUBYFlVdlueBFbLW0mhhAyGEqpt,16,17,10,22,7,2,0,0,58,8.285714285714286,1,0.0,0,10,19,7,17,2,3,0,0,36,22,1
137,5020,7kNYuUNvdIVdadzDsnKIKM0Ln3KLHYo2,SpATywNh6bZuzm8s1ceuBUnMUAeoAHHw,2,0,0,0,0,0,2,0,2,0.2857142857142857,1,0.0,0,0,0,0,0,0,0,2,0,0,2,1
138,5022,QCXbyb2FyuLlETPxf3u27tgIYTs9gTM4,SpATywNh6bZuzm8s1ceuBUnMUAeoAHHw,17,31,21,15,10,10,4,0,91,13.0,2,0.0,6,21,14,10,25,10,1,4,0,51,40,0
139,5031,6Qw49dxLKsjbapN7r9Da43ajoDW7rCxT,G8EPVSXsOYB5YQWZGiz1aVq5Pgr2GrQu,4,3,2,0,0,52,2,0,59,8.428571428571429,5,0.0,0,2,0,0,3,52,0,2,0,2,57,0
140,5041,m9R5p8ELPeEGL2TgmgmNZypetc0YKw9N,SpATywNh6bZuzm8s1ceuBUnMUAeoAHHw,5,2,1,0,1,0,2,0,6,0.8571428571428571,1,0.0,0,1,0,1,2,0,0,2,0,2,4,1
141,5082,rVF6sxySmleXKBlMsWpXjKDnmQNSzrnS,G8EPVSXsOYB5YQWZGiz1aVq5Pgr2GrQu,118,167,112,294,63,21,38,0,695,99.28571428571429,5,0.0,31,112,245,63,136,21,49,38,0,451,244,0
142,5096,rsMqzQV4BJo2NdhTX79HDXS5zRZgLPX5,SpATywNh6bZuzm8s1ceuBUnMUAeoAHHw,15,19,9,23,2,0,4,0,57,8.142857142857142,2,0.0,9,9,19,2,10,0,4,4,0,39,18,0
143,5142,B6vCUtkVL8SVuEEWctSPinCUr9rxihnh,G8EPVSXsOYB5YQWZGiz1aVq5Pgr2GrQu,7,4,3,4,1,0,1,0,13,1.8571428571428572,1,0.0,0,3,3,1,4,0,1,1,0,7,6,0
144,5152,RZI7KROUR7i2T6MB71TuoKGbXE5WXiwO,bWdj2GDclj5ofokWjzoa5jAwMkxCykd6,1,0,0,0,0,0,1,0,1,0.14285714285714285,1,0.0,0,0,0,0,0,0,0,1,0,0,1,1
145,5153,JiVwV8l6zLIAeTDli3uYE3CMxT1oG8Me,SpATywNh6bZuzm8s1ceuBUnMUAeoAHHw,4,4,1,0,0,0,8,0,13,1.8571428571428572,2,0.0,0,1,0,0,4,0,0,8,0,1,12,0
146,5217,EP1XQRGS4HZOG1hdGzNZdD1HFhJcHpos,RXDvfPUBYFlVdlueBFbLW0mhhAyGEqpt,6,9,2,0,0,8,6,0,25,3.5714285714285716,3,0.0,0,2,0,0,9,8,0,6,0,2,23,0
147,5224,vEkraIjbJw9RkPvqczZeJYSVVtpO2PkE,G8EPVSXsOYB5YQWZGiz1aVq5Pgr2GrQu,5,1,1,0,0,0,3,0,5,0.7142857142857143,1,0.0,0,1,0,0,1,0,0,3,0,1,4,1
148,5259,hdKqkkWKrDzbKE9btGChBqiCfsTwp68E,bWdj2GDclj5ofokWjzoa5jAwMkxCykd6,21,34,21,24,2,52,26,1,160,22.857142857142858,6,0.0,4,21,18,2,30,52,6,26,1,45,115,0
149,5303,o9EVHnUUU8I3f9dlC8NAcnHlKvZOnRmy,bWdj2GDclj5ofokWjzoa5jAwMkxCykd6,39,42,12,96,8,3,9,1,171,24.428571428571427,3,0.0,10,12,90,8,32,3,6,9,1,120,51,0
150,5305,o9EVHnUUU8I3f9dlC8NAcnHlKvZOnRmy,A3fsA9Zfv1X2fVEQhTw51lKENdNrEqT3,34,18,10,58,6,0,6,0,98,14.0,4,0.0,1,10,55,6,17,0,3,6,0,72,26,0
151,5310,OMEL4ay2FeLAUvBpF5PNfopRFoBTNYW8,SpATywNh6bZuzm8s1ceuBUnMUAeoAHHw,3,2,0,0,0,0,1,0,3,0.42857142857142855,1,0.0,0,0,0,0,2,0,0,1,0,0,3,0
152,5319,hDWTDNoM8bIQS3Q25EYxxHniqW2wmxDn,bWdj2GDclj5ofokWjzoa5jAwMkxCykd6,9,11,4,18,2,1,2,0,38,5.428571428571429,1,0.0,1,4,16,2,10,1,2,2,0,23,15,0
153,5332,DJ09O49b2a0ZKXkFKbGfN66X8003c5sz,SpATywNh6bZuzm8s1ceuBUnMUAeoAHHw,5,3,2,0,1,0,1,0,7,1.0,1,0.0,0,2,0,1,3,0,0,1,0,3,4,1
154,5340,oDnQYjxji4p3XVFJMOGI9NvIvASqoqC1,SpATywNh6bZuzm8s1ceuBUnMUAeoAHHw,11,5,5,0,3,0,2,0,15,2.142857142857143,1,0.0,0,5,0,3,5,0,0,2,0,8,7,1
155,5345,Kssd3yKtVgKi0ua0svvR8GgbZwRwIJMZ,SpATywNh6bZuzm8s1ceuBUnMUAeoAHHw,4,12,8,0,0,0,3,0,23,3.2857142857142856,5,0.0,2,8,0,0,10,0,0,3,0,10,13,0
156,5354,lMGiEKoNsKRALWBxyYFHfE9Y79x8NYWS,G8EPVSXsOYB5YQWZGiz1aVq5Pgr2GrQu,1,0,0,0,0,0,1,0,1,0.14285714285714285,1,0.0,0,0,0,0,0,0,0,1,0,0,1,1
157,5363,WXWUGznWk133hcEltnw7lYbm2oVZoXLf,SpATywNh6bZuzm8s1ceuBUnMUAeoAHHw,8,24,17,0,0,0,12,0,53,7.571428571428571,5,0.0,0,17,0,0,24,0,0,12,0,17,36,1
158,5389,cd7VGHrZb4Blwr9YuFp9MqF71m5wWUVd,G8EPVSXsOYB5YQWZGiz1aVq5Pgr2GrQu,85,75,5,170,8,2,6,0,266,38.0,4,0.0,46,5,117,8,29,2,53,6,0,176,90,0
159,5390,NL3IFunZJHMkqSLqiaHHbVIge1Bdgn26,G8EPVSXsOYB5YQWZGiz1aVq5Pgr2GrQu,25,24,9,18,5,10,12,0,78,11.142857142857142,3,0.0,10,9,9,5,14,10,9,12,0,33,45,0
160,5392,Tj9gyzxktEEAGnL07HQ3qbd2V0oCt16o,SpATywNh6bZuzm8s1ceuBUnMUAeoAHHw,5,14,5,0,0,0,7,0,26,3.7142857142857144,2,0.0,0,5,0,0,14,0,0,7,0,5,21,0
161,5397,I6gFU4rZZ1rIaEMk0n0tBNQZ2tGcnjLw,SpATywNh6bZuzm8s1ceuBUnMUAeoAHHw,2,0,0,0,0,0,5,0,5,0.7142857142857143,2,0.0,0,0,0,0,0,0,0,5,0,0,5,0
162,5414,4qM7n65VbCTp8lq3dbzhDmImmEZcwgn8,A3fsA9Zfv1X2fVEQhTw51lKENdNrEqT3,4,5,1,0,0,5,3,0,14,2.0,2,0.0,2,1,0,0,3,5,0,3,0,3,11,0
163,5454,3ZzNkdWgGb47Go07PRKPf0XZ6jjhVCB4,bWdj2GDclj5ofokWjzoa5jAwMkxCykd6,1,0,0,0,0,0,1,0,1,0.14285714285714285,1,0.0,0,0,0,0,0,0,0,1,0,0,1,0
164,5458,YOkiW0yIzjAwppKQnKaeEhWktVPNCIFb,A3fsA9Zfv1X2fVEQhTw51lKENdNrEqT3,4,3,2,0,0,0,1,0,6,0.8571428571428571,1,0.0,0,2,0,0,3,0,0,1,0,2,4,1
165,5469,fn3RgMp4JCABnOK3IDXz6cUAXpmeuiYQ,SpATywNh6bZuzm8s1ceuBUnMUAeoAHHw,3,4,2,0,0,0,2,0,8,1.1428571428571428,2,0.0,0,2,0,0,4,0,0,2,0,2,6,1
166,5472,OLX98cHycOH1FdInwYYk8PZBVFPyIkIG,SpATywNh6bZuzm8s1ceuBUnMUAeoAHHw,15,17,7,7,3,0,3,0,37,5.285714285714286,2,0.0,6,7,7,3,11,0,0,3,0,23,14,0
167,5486,TMdqZjFm6eGvpWCVvOj8xDCqkoxEsWlO,RXDvfPUBYFlVdlueBFbLW0mhhAyGEqpt,8,7,4,0,2,0,0,0,13,1.8571428571428572,1,0.0,0,4,0,2,7,0,0,0,0,6,7,1
168,5487,gqe5NXbZbf5uXY0rPviLeIFOMpQyekdp,SpATywNh6bZuzm8s1ceuBUnMUAeoAHHw,11,10,0,18,0,0,2,0,30,4.285714285714286,2,0.0,2,0,15,0,8,0,3,2,0,17,13,1
169,5498,F2owRK2SDPW5FCDK4TxmBVHsTtJ44Nxq,bWdj2GDclj5ofokWjzoa5jAwMkxCykd6,5,3,1,0,1,0,1,0,6,0.8571428571428571,1,0.0,0,1,0,1,3,0,0,1,0,2,4,1
170,5499,F2owRK2SDPW5FCDK4TxmBVHsTtJ44Nxq,SpATywNh6bZuzm8s1ceuBUnMUAeoAHHw,11,12,1,18,0,0,1,0,32,4.571428571428571,1,0.0,5,1,15,0,7,0,3,1,0,21,11,1
171,5511,YTuPtoiiUgMUEO0EcQhHENEgNCcauWbW,SpATywNh6bZuzm8s1ceuBUnMUAeoAHHw,5,2,1,0,1,0,3,0,7,1.0,2,0.0,0,1,0,1,2,0,0,3,0,2,5,1
172,5535,0N8Aw17N0N8m1sn7piRGEu1YkeZIgvRo,SpATywNh6bZuzm8s1ceuBUnMUAeoAHHw,7,11,1,0,1,0,1,0,14,2.0,1,0.0,0,1,0,1,11,0,0,1,0,2,12,0
173,5568,w1PJeTTskG2DF1TtLUpuz9MkqxNdq5EB,bWdj2GDclj5ofokWjzoa5jAwMkxCykd6,7,13,3,7,3,0,4,0,30,4.285714285714286,1,0.0,1,3,5,3,12,0,2,4,0,12,18,1
174,5573,GdXLROZTUYTypGrrX0BjPE53M0Un36D7,SpATywNh6bZuzm8s1ceuBUnMUAeoAHHw,1,0,0,0,0,0,1,0,1,0.14285714285714285,1,0.0,0,0,0,0,0,0,0,1,0,0,1,1
175,5582,kKBIfyZmN22zBj263eKBa0SA1U5xYMsR,SpATywNh6bZuzm8s1ceuBUnMUAeoAHHw,1,0,0,0,0,0,2,0,2,0.2857142857142857,1,0.0,0,0,0,0,0,0,0,2,0,0,2,0
176,5601,i2rj1wVH6A7tnVQEIJcyKc1jnWx6tXOX,G8EPVSXsOYB5YQWZGiz1aVq5Pgr2GrQu,19,6,0,32,0,0,3,0,41,5.857142857142857,3,0.0,0,0,27,0,6,0,5,3,0,27,14,1
177,5605,k2w7Fl2HRg9SZoDIHFnK8RXCKuBBE2y7,bWdj2GDclj5ofokWjzoa5jAwMkxCykd6,17,32,13,18,3,18,17,0,101,14.428571428571429,4,0.0,4,13,15,3,28,18,3,17,0,35,66,0
178,5620,ZOxTwY2wRpdYn3qbKBoyT1PgdUitZ7Hl,RXDvfPUBYFlVdlueBFbLW0mhhAyGEqpt,2,0,0,0,0,0,2,0,2,0.2857142857142857,1,0.0,0,0,0,0,0,0,0,2,0,0,2,1
179,5669,HbDaABEakQmE8DQEoFoIphu2SH13rFRy,SpATywNh6bZuzm8s1ceuBUnMUAeoAHHw,3,2,1,0,0,0,2,0,5,0.7142857142857143,1,0.0,0,1,0,0,2,0,0,2,0,1,4,0
180,5692,KtQYnyrETXqJCvCxj7ZUnFcjZBBdiT7G,SpATywNh6bZuzm8s1ceuBUnMUAeoAHHw,3,5,3,0,0,0,3,0,11,1.5714285714285714,3,0.0,0,3,0,0,5,0,0,3,0,3,8,0
181,5698,YflGnFPlp9G4H12kW5BF7wIEcEPJDElk,SpATywNh6bZuzm8s1ceuBUnMUAeoAHHw,28,35,21,22,9,0,7,0,94,13.428571428571429,2,0.0,7,21,20,9,28,0,2,7,0,57,37,0
182,5725,DLDhUvvvfnnYFJuV65Zt2yaS0jPJgvzq,bWdj2GDclj5ofokWjzoa5jAwMkxCykd6,45,87,0,156,4,60,29,1,337,48.142857142857146,5,0.0,29,0,125,4,58,60,31,29,1,158,179,0
183,5726,tzyyAYK7Q2hNPhv988H6lH5D7hdM24rK,SpATywNh6bZuzm8s1ceuBUnMUAeoAHHw,1,0,0,0,0,0,1,0,1,0.14285714285714285,1,0.0,0,0,0,0,0,0,0,1,0,0,1,0
184,5738,SfZbjjvyiSDCCOAoK4WFbDb5dRmW5oVl,bWdj2GDclj5ofokWjzoa5jAwMkxCykd6,2,0,0,0,0,0,2,0,2,0.2857142857142857,1,0.0,0,0,0,0,0,0,0,2,0,0,2,1
185,5745,PpMDt0ql3KtH4YMuxusWOnbL4LfspwvV,A3fsA9Zfv1X2fVEQhTw51lKENdNrEqT3,5,3,2,0,1,0,1,0,7,1.0,1,0.0,0,2,0,1,3,0,0,1,0,3,4,1
186,5775,TO8Y79YghtROlTlvlXU7LRtpWyGNF6ec,SpATywNh6bZuzm8s1ceuBUnMUAeoAHHw,8,9,0,0,0,0,1,0,10,1.4285714285714286,1,0.0,0,0,0,0,9,0,0,1,0,0,10,1
187,5776,wQWBo1X8BGkSznCww6CpwIPV7Jbmgkei,SpATywNh6bZuzm8s1ceuBUnMUAeoAHHw,9,8,4,0,2,0,1,0,15,2.142857142857143,1,0.0,0,4,0,2,8,0,0,1,0,6,9,1
188,5778,A3AW3c7i1MF6oyHBEYvrXWvBxZwqeuYh,SpATywNh6bZuzm8s1ceuBUnMUAeoAHHw,10,9,0,6,0,0,3,0,18,2.5714285714285716,2,0.0,4,0,6,0,5,0,0,3,0,10,8,0
189,5782,hjUSUM6roI2mLGkMAqBjE0uxFRBSMYHJ,A3fsA9Zfv1X2fVEQhTw51lKENdNrEqT3,16,18,11,0,4,2,7,0,42,6.0,4,0.0,0,11,0,4,18,2,0,7,0,15,27,1
190,5787,I6LLxQVZ3Y3gFYxr9F3TFVba9rYQ1D0f,RXDvfPUBYFlVdlueBFbLW0mhhAyGEqpt,1,0,0,0,0,0,1,0,1,0.14285714285714285,1,0.0,0,0,0,0,0,0,0,1,0,0,1,1
191,5796,8tzllCaQFf5FO2XcYgqoYiMGBjUwujYx,SpATywNh6bZuzm8s1ceuBUnMUAeoAHHw,4,6,0,0,0,0,3,0,9,1.2857142857142858,1,0.0,0,0,0,0,6,0,0,3,0,0,9,1
192,5835,unk5CPF7I3bAjMFdo7PROcIzOFweEiwK,SpATywNh6bZuzm8s1ceuBUnMUAeoAHHw,1,0,0,0,0,0,1,0,1,0.14285714285714285,1,0.0,0,0,0,0,0,0,0,1,0,0,1,1
193,5859,pGMnNtuqcZlCojrlW4Qh2PIHblJQmotx,SpATywNh6bZuzm8s1ceuBUnMUAeoAHHw,5,3,2,0,0,0,2,0,7,1.0,1,0.0,0,2,0,0,3,0,0,2,0,2,5,1
194,5889,Oe7zyPdqUKEu4xpqbiVxJiAwdUxxeOQv,A3fsA9Zfv1X2fVEQhTw51lKENdNrEqT3,15,13,8,0,5,0,8,0,34,4.857142857142857,2,0.0,0,8,0,5,13,0,0,8,0,13,21,1
195,5904,L4jaFu0vxNsfaC1OhafSk08ztmq6goZk,SpATywNh6bZuzm8s1ceuBUnMUAeoAHHw,3,3,0,0,0,0,1,0,4,0.5714285714285714,1,0.0,0,0,0,0,3,0,0,1,0,0,4,0
196,5987,x3bTgsr7QSCiaq6OJXRLOfvMZYUxrJaI,G8EPVSXsOYB5YQWZGiz1aVq5Pgr2GrQu,4,2,0,0,0,0,2,0,4,0.5714285714285714,1,0.0,0,0,0,0,2,0,0,2,0,0,4,1
197,5992,Ov9SdOcJjrPsko4RxSRp3diSYNiMCffC,bWdj2GDclj5ofokWjzoa5jAwMkxCykd6,5,2,1,0,1,0,2,0,6,0.8571428571428571,1,0.0,0,1,0,1,2,0,0,2,0,2,4,1
198,6000,2mD1u3b1vLrSJM0DZTrsvLcZVBVwwd27,RXDvfPUBYFlVdlueBFbLW0mhhAyGEqpt,5,5,4,0,0,0,6,0,15,2.142857142857143,4,0.0,0,4,0,0,5,0,0,6,0,4,11,0
199,6010,gEPTO2jN7POX6QtJlMdktFPT74irRyFu,SpATywNh6bZuzm8s1ceuBUnMUAeoAHHw,4,5,5,0,4,0,1,0,15,2.142857142857143,4,0.0,0,5,0,4,5,0,0,1,0,9,6,0
200,6060,1gK3jCeXNxEbn9wGz2jRwqB6S5hBMDkt,bWdj2GDclj5ofokWjzoa5jAwMkxCykd6,21,31,14,44,0,20,7,1,117,16.714285714285715,2,0.0,4,14,39,0,27,20,5,7,1,57,60,1
201,6070,Hj4fYYa64lvHLVeQZBqs9EQ1OtgHTvl6,SpATywNh6bZuzm8s1ceuBUnMUAeoAHHw,17,29,9,16,1,3,9,0,67,9.571428571428571,3,0.0,7,9,14,1,22,3,2,9,0,31,36,0
202,6074,xQWsagZWr4hwuLscur4NAIFNIWIrJTay,RXDvfPUBYFlVdlueBFbLW0mhhAyGEqpt,15,13,10,30,6,0,5,0,64,9.142857142857142,2,0.0,2,10,28,6,11,0,2,5,0,46,18,0
203,6075,4pJCNd3c3ApEtuK2GDe7eGNzOhsu04W5,G8EPVSXsOYB5YQWZGiz1aVq5Pgr2GrQu,32,54,38,9,11,83,19,7,221,31.571428571428573,6,0.0,4,38,8,11,50,83,1,19,7,61,160,0
204,6077,X6F4jGrpHmts6Pi9fPAm5nX0OzNeK6MU,SpATywNh6bZuzm8s1ceuBUnMUAeoAHHw,13,14,0,8,0,0,4,0,26,3.7142857142857144,1,0.0,0,0,6,0,14,0,2,4,0,6,20,1
205,6102,DJPrQ8k1R0aSF2q32X8eWoHfRxJjw6WA,SpATywNh6bZuzm8s1ceuBUnMUAeoAHHw,7,3,2,0,0,3,6,1,15,2.142857142857143,2,0.0,0,2,0,0,3,3,0,6,1,2,13,1
206,6105,lVM3D8yPmd62Fdb29hI2YI0VPwlNvI4t,A3fsA9Zfv1X2fVEQhTw51lKENdNrEqT3,22,36,29,0,19,2,6,0,92,13.142857142857142,3,0.0,0,29,0,19,36,2,0,6,0,48,44,1
207,6106,lPxeEtjpZuY166gKAbN1CLkUMLrqY98p,SpATywNh6bZuzm8s1ceuBUnMUAeoAHHw,14,27,0,13,1,3,18,1,63,9.0,2,0.0,4,0,13,1,23,3,0,18,1,18,45,1
208,6108,WWWH5rGgnKzcRMEBKWqCKBbIYZVZp9Wi,SpATywNh6bZuzm8s1ceuBUnMUAeoAHHw,12,16,2,12,0,0,3,0,33,4.714285714285714,3,0.0,4,2,12,0,12,0,0,3,0,18,15,0
209,6114,PIxnueIZLpBbMAAHbhlsEVGPkWRYGpMI,RXDvfPUBYFlVdlueBFbLW0mhhAyGEqpt,37,44,0,47,3,0,10,0,104,14.857142857142858,3,0.0,8,0,43,3,36,0,4,10,0,54,50,0
210,6123,onsmNYIoPFEi185f5ZLsQXD70I3K25Cb,A3fsA9Zfv1X2fVEQhTw51lKENdNrEqT3,9,14,6,0,2,0,3,0,25,3.5714285714285716,1,0.0,0,6,0,2,14,0,0,3,0,8,17,1
211,6134,UhLO5kko2VQ90AI2af3XOU7N46nRv9TM,SpATywNh6bZuzm8s1ceuBUnMUAeoAHHw,13,14,1,16,0,0,5,0,36,5.142857142857143,1,0.0,4,1,16,0,10,0,0,5,0,21,15,0
212,6140,IBg4xmPqhTfP3qhSQ0m2yOJeGxXoGyqu,RXDvfPUBYFlVdlueBFbLW0mhhAyGEqpt,3,0,0,0,0,63,14,0,77,11.0,5,0.0,0,0,0,0,0,63,0,14,0,0,77,0
213,6158,hdYiR72pQ6vIYKybYRC3s5GFqsrsnSH9,SpATywNh6bZuzm8s1ceuBUnMUAeoAHHw,1,0,0,0,0,0,1,0,1,0.14285714285714285,1,0.0,0,0,0,0,0,0,0,1,0,0,1,1
214,6168,H2ZjrPimYfiWwdYkdNOPsZZk83kbIBCz,bWdj2GDclj5ofokWjzoa5jAwMkxCykd6,4,3,0,0,0,0,1,0,4,0.5714285714285714,1,0.0,0,0,0,0,3,0,0,1,0,0,4,1
215,6185,rowlJHASOW6yJNtP0z67l2i9CtJCMokD,SpATywNh6bZuzm8s1ceuBUnMUAeoAHHw,13,16,1,19,1,11,3,0,51,7.285714285714286,2,0.0,4,1,16,1,12,11,3,3,0,22,29,0
216,6192,uFKxt8ud4wgPXsnEMlnj4koWPrsJIWsU,SpATywNh6bZuzm8s1ceuBUnMUAeoAHHw,4,6,1,0,0,0,7,0,14,2.0,3,0.0,0,1,0,0,6,0,0,7,0,1,13,0
217,6240,IkJ5dxCbqNRxBRuENFqjes2Z4rIDUrXn,SpATywNh6bZuzm8s1ceuBUnMUAeoAHHw,4,4,2,0,0,0,2,0,8,1.1428571428571428,1,0.0,0,2,0,0,4,0,0,2,0,2,6,0
218,6271,q2xQCstASp96wpspi8iqsuaqJ7gzfsux,A3fsA9Zfv1X2fVEQhTw51lKENdNrEqT3,8,6,2,4,0,0,2,0,14,2.0,2,0.0,0,2,4,0,6,0,0,2,0,6,8,0
219,6273,pP1hwdPGxzBA8F4ZSgJiv9MEvr2pc047,SpATywNh6bZuzm8s1ceuBUnMUAeoAHHw,8,7,1,0,1,2,4,1,16,2.2857142857142856,1,0.0,0,1,0,1,7,2,0,4,1,2,14,1
220,6303,jqoeUpESPoqODjA4STQaMBhAr7OND2EP,bWdj2GDclj5ofokWjzoa5jAwMkxCykd6,4,2,1,0,0,0,6,0,9,1.2857142857142858,1,0.0,0,1,0,0,2,0,0,6,0,1,8,1
221,6306,Q8L1mPYwfiwtGo48PB0N9B5ppVi0px10,SpATywNh6bZuzm8s1ceuBUnMUAeoAHHw,4,4,2,0,0,0,9,0,15,2.142857142857143,4,0.0,0,2,0,0,4,0,0,9,0,2,13,0
222,6317,3Bw18YJt9vJt2emNNJ6GnWW50YrVLdEa,bWdj2GDclj5ofokWjzoa5jAwMkxCykd6,34,15,6,157,3,57,9,0,247,35.285714285714285,1,0.0,6,6,144,3,9,57,13,9,0,159,88,0
223,6331,SYptj19Xjkw9HEWtBs53CLIV7bhIU7QA,SpATywNh6bZuzm8s1ceuBUnMUAeoAHHw,6,3,2,0,1,0,3,0,9,1.2857142857142858,1,0.0,0,2,0,1,3,0,0,3,0,3,6,1
224,6347,TAjGGV7oJgeUhPcj5Eum0tnVYrY7qjOE,RXDvfPUBYFlVdlueBFbLW0mhhAyGEqpt,53,174,54,79,28,5,30,4,374,53.42857142857143,4,0.0,27,54,71,28,147,5,8,30,4,180,194,0
225,6357,Aay6TeSPyFLmKNsg9Z4tXGnlIddPmJBP,SpATywNh6bZuzm8s1ceuBUnMUAeoAHHw,1,0,0,0,0,0,1,0,1,0.14285714285714285,1,0.0,0,0,0,0,0,0,0,1,0,0,1,1
226,6368,Fa7tOqP1WKllvNDMgvUWmTzPr8J8vhy8,A3fsA9Zfv1X2fVEQhTw51lKENdNrEqT3,12,21,17,0,12,0,7,0,57,8.142857142857142,5,0.0,0,17,0,12,21,0,0,7,0,29,28,1
227,6382,9a1CkPBtfy1cinURU7wYCdYhBZbPuPSf,A3fsA9Zfv1X2fVEQhTw51lKENdNrEqT3,25,9,3,56,1,0,1,0,70,10.0,2,0.0,5,3,52,1,4,0,4,1,0,61,9,1
228,6406,LA9dJIvAE6FLxCCQV1kWQN6m88ZCSRLZ,bWdj2GDclj5ofokWjzoa5jAwMkxCykd6,9,9,1,0,2,1,4,0,17,2.4285714285714284,1,0.0,3,1,0,2,6,1,0,4,0,6,11,1
229,6411,eI6xeMCc7v1nfOYfnKZdOO91PA7nex8M,bWdj2GDclj5ofokWjzoa5jAwMkxCykd6,9,3,2,0,2,0,4,1,12,1.7142857142857142,1,0.0,0,2,0,2,3,0,0,4,1,4,8,1
230,6420,oQDGeS36nDLt1VqHdqEgamkq2vJOp7Bp,SpATywNh6bZuzm8s1ceuBUnMUAeoAHHw,5,3,1,0,1,0,1,0,6,0.8571428571428571,1,0.0,0,1,0,1,3,0,0,1,0,2,4,1
231,6424,SmSrrYBj6KLZ39TqXb57CVWv6gX6sF7Q,SpATywNh6bZuzm8s1ceuBUnMUAeoAHHw,6,3,3,0,1,0,2,0,9,1.2857142857142858,2,0.0,0,3,0,1,3,0,0,2,0,4,5,0
232,6426,e3L16MrCoJp6rSpz1IWKaDG3S5tGTRpK,RXDvfPUBYFlVdlueBFbLW0mhhAyGEqpt,35,20,17,26,14,0,8,0,85,12.142857142857142,4,0.0,2,17,23,14,18,0,3,8,0,56,29,0
233,6435,nFeXukK9uLZggTwgBm3mDIxskaBXISqn,SpATywNh6bZuzm8s1ceuBUnMUAeoAHHw,2,1,1,0,0,0,0,0,2,0.2857142857142857,1,0.0,0,1,0,0,1,0,0,0,0,1,1,1
234,6448,yau38b5UXLNmzsSxrtZsXYfKt6l52ZSP,A3fsA9Zfv1X2fVEQhTw51lKENdNrEqT3,6,3,2,0,1,0,4,0,10,1.4285714285714286,1,0.0,0,2,0,1,3,0,0,4,0,3,7,0
235,6457,wxlTuL6FVeoyKGq1xWxdRI4GRTsaG1Ha,SpATywNh6bZuzm8s1ceuBUnMUAeoAHHw,5,6,3,0,0,0,1,0,10,1.4285714285714286,1,0.0,2,3,0,0,4,0,0,1,0,5,5,1
236,6466,GUIjXzC11NU91af1UN0XPnms1Mnty0es,G8EPVSXsOYB5YQWZGiz1aVq5Pgr2GrQu,10,5,4,0,2,0,3,0,14,2.0,1,0.0,0,4,0,2,5,0,0,3,0,6,8,1
237,6488,aYhMdR5xaez3fr0lBrD6kCxYiCOyculR,RXDvfPUBYFlVdlueBFbLW0mhhAyGEqpt,63,68,42,107,6,334,4,2,563,80.42857142857143,6,0.0,17,42,78,6,51,334,29,4,2,143,420,0
238,6506,DCJPPLzeeZhBbsYhL4xGedJzVmW41Gnk,SpATywNh6bZuzm8s1ceuBUnMUAeoAHHw,4,2,1,0,0,12,5,0,20,2.857142857142857,3,0.0,0,1,0,0,2,12,0,5,0,1,19,0
239,6516,1CrVBOpFvr6rOy553Xrye0bjPdL11eu8,RXDvfPUBYFlVdlueBFbLW0mhhAyGEqpt,22,29,10,20,4,15,5,0,83,11.857142857142858,3,0.0,4,10,20,4,25,15,0,5,0,38,45,0
240,6517,7u3azzypzNqPYEFxf0DcbGOgDVhkOXos,A3fsA9Zfv1X2fVEQhTw51lKENdNrEqT3,32,12,6,82,5,0,6,0,111,15.857142857142858,2,0.0,1,6,73,5,11,0,9,6,0,85,26,0
241,6523,dna1EUjVeT7Ka4gaXCCa53DsP3COwQS1,SpATywNh6bZuzm8s1ceuBUnMUAeoAHHw,4,4,1,0,0,0,5,0,10,1.4285714285714286,3,0.0,0,1,0,0,4,0,0,5,0,1,9,0
242,6528,97yjJniO9qlZAjgn3gm4HXnkbwnHzt9O,SpATywNh6bZuzm8s1ceuBUnMUAeoAHHw,3,8,2,0,0,1,3,0,14,2.0,2,0.0,0,2,0,0,8,1,0,3,0,2,12,1
243,6535,tuBxNlu8Vf06uK8sXGF2P17UeyGdHKNN,SpATywNh6bZuzm8s1ceuBUnMUAeoAHHw,5,2,0,0,0,2,3,1,8,1.1428571428571428,1,0.0,0,0,0,0,2,2,0,3,1,0,8,1
244,6574,09vierxoREaD4msGgreYQSyOiGeSiZdQ,SpATywNh6bZuzm8s1ceuBUnMUAeoAHHw,3,2,1,0,0,0,1,0,4,0.5714285714285714,1,0.0,0,1,0,0,2,0,0,1,0,1,3,0
245,6587,Y89GJdSZUpoYFMgx00SCe6qFoYoXIpUj,A3fsA9Zfv1X2fVEQhTw51lKENdNrEqT3,23,35,2,70,1,0,1,0,109,15.571428571428571,3,0.0,0,2,58,1,35,0,12,1,0,61,48,0
246,6620,ImttANzrjJymFPMjHDf4wrhhCWWSpYTI,A3fsA9Zfv1X2fVEQhTw51lKENdNrEqT3,24,53,19,0,0,0,6,0,78,11.142857142857142,3,0.0,2,19,0,0,51,0,0,6,0,21,57,1
247,6637,qcaVl4qf6hxavlIQkbkKC1Gm28s0psJd,SpATywNh6bZuzm8s1ceuBUnMUAeoAHHw,5,4,1,0,0,0,1,0,6,0.8571428571428571,1,0.0,0,1,0,0,4,0,0,1,0,1,5,1
248,6643,lDflzmK9F6H42Kj6EtaBezWOcB4UUWiV,SpATywNh6bZuzm8s1ceuBUnMUAeoAHHw,16,15,9,8,2,0,6,0,40,5.714285714285714,4,0.0,2,9,7,2,13,0,1,6,0,20,20,0
249,6675,1K9ntuEgUSRWzXpTTqORcRDzpeO83CFG,SpATywNh6bZuzm8s1ceuBUnMUAeoAHHw,5,2,1,0,1,0,2,0,6,0.8571428571428571,1,0.0,0,1,0,1,2,0,0,2,0,2,4,1
250,6679,tY5a0NX1zue0V7W3ml5X4bo1Gus2ozCa,SpATywNh6bZuzm8s1ceuBUnMUAeoAHHw,28,38,17,22,7,0,15,0,99,14.142857142857142,4,0.0,13,17,20,7,25,0,2,15,0,57,42,0
251,6685,mfQ48K9Gnf187sLZBiTNegL6UkMDsKbJ,SpATywNh6bZuzm8s1ceuBUnMUAeoAHHw,20,39,3,34,1,0,5,0,82,11.714285714285714,3,0.0,21,3,31,1,18,0,3,5,0,56,26,0
252,6708,7FUJzRatex45Tiw3cL91Uz5fZD5gpQMy,G8EPVSXsOYB5YQWZGiz1aVq5Pgr2GrQu,2,0,0,0,0,0,2,0,2,0.2857142857142857,1,0.0,0,0,0,0,0,0,0,2,0,0,2,1
253,6813,UvqKXPrebnykj7gkohis9MIhsKJQCjxw,G8EPVSXsOYB5YQWZGiz1aVq5Pgr2GrQu,17,34,32,32,17,0,4,0,119,17.0,2,0.0,0,32,31,17,34,0,1,4,0,80,39,0
254,6824,e12uQn96OlYfknMdqSXCXdImglIj4IRR,bWdj2GDclj5ofokWjzoa5jAwMkxCykd6,20,27,16,0,7,26,16,2,94,13.428571428571429,3,0.0,3,16,0,7,24,26,0,16,2,26,68,0
255,6835,05hxkbgK0IX5639oITtQjU5YEEUBb8L1,SpATywNh6bZuzm8s1ceuBUnMUAeoAHHw,21,61,4,19,3,4,9,1,101,14.428571428571429,3,0.0,24,4,17,3,37,4,2,9,1,48,53,0
256,6838,AyhJARh0xhxObM9zhvUdDxlTCtu309eW,SpATywNh6bZuzm8s1ceuBUnMUAeoAHHw,4,2,1,0,0,0,2,0,5,0.7142857142857143,1,0.0,0,1,0,0,2,0,0,2,0,1,4,1
257,6873,NAuTAy6LFtpkSTeaDzpzRRxCaq6qJCQ5,A3fsA9Zfv1X2fVEQhTw51lKENdNrEqT3,12,8,6,0,2,3,6,0,25,3.5714285714285716,2,0.0,0,6,0,2,8,3,0,6,0,8,17,0
258,6881,jzWvwaTexkgbyBrPkQbXDb98Viqx6cSS,G8EPVSXsOYB5YQWZGiz1aVq5Pgr2GrQu,3,2,1,0,0,0,1,0,4,0.5714285714285714,1,0.0,0,1,0,0,2,0,0,1,0,1,3,1
259,6889,M2RAm5z8WwQ5y9jyAQgRWh88PDVhS1V9,RXDvfPUBYFlVdlueBFbLW0mhhAyGEqpt,1,0,0,0,0,0,1,0,1,0.14285714285714285,1,0.0,0,0,0,0,0,0,0,1,0,0,1,1
260,6898,UxSaaQ6GZyl7nlDC1x0TA1qshXRkMyH8,RXDvfPUBYFlVdlueBFbLW0mhhAyGEqpt,28,52,19,22,12,7,6,0,118,16.857142857142858,1,0.0,14,19,22,12,38,7,0,6,0,67,51,0
261,6914,5XorWInOikFQGiy06qBvCZ6iOgBDDoJu,SpATywNh6bZuzm8s1ceuBUnMUAeoAHHw,11,11,5,0,3,0,2,0,21,3.0,1,0.0,5,5,0,3,6,0,0,2,0,13,8,0
262,6916,x6r7USCSuVFGzUeOMsU9rcLC4WDuI3GF,A3fsA9Zfv1X2fVEQhTw51lKENdNrEqT3,4,4,2,0,0,0,4,0,10,1.4285714285714286,2,0.0,0,2,0,0,4,0,0,4,0,2,8,0
263,6917,ZolI9SZEN13j7gv74MFUKg6bUxZlsWPc,G8EPVSXsOYB5YQWZGiz1aVq5Pgr2GrQu,7,5,2,0,2,0,2,0,11,1.5714285714285714,1,0.0,0,2,0,2,5,0,0,2,0,4,7,1
264,6925,h9168zUD8zDtaVgTWmp8akLV044AqETE,G8EPVSXsOYB5YQWZGiz1aVq5Pgr2GrQu,59,72,23,196,0,19,4,0,314,44.857142857142854,2,0.0,46,23,157,0,26,19,39,4,0,226,88,0
265,6931,s6iPd6MFpHWkQ354d5Z6XCZ6dbx7CutD,SpATywNh6bZuzm8s1ceuBUnMUAeoAHHw,4,3,2,0,0,0,1,0,6,0.8571428571428571,1,0.0,0,2,0,0,3,0,0,1,0,2,4,0
266,6938,a6f3gPi6axX0cfBnUGVliBDQrPx92l1r,A3fsA9Zfv1X2fVEQhTw51lKENdNrEqT3,18,25,18,0,10,0,8,0,61,8.714285714285714,4,0.0,1,18,0,10,24,0,0,8,0,29,32,1
267,6948,4r712Cp6HawShlWfCnD4BeT5bNCQMkQ4,SpATywNh6bZuzm8s1ceuBUnMUAeoAHHw,3,2,1,0,0,0,1,0,4,0.5714285714285714,1,0.0,0,1,0,0,2,0,0,1,0,1,3,0
268,6956,ykaUPJW4Nc9r2mv4b25QxgdHgIcQ63RQ,SpATywNh6bZuzm8s1ceuBUnMUAeoAHHw,2,0,0,0,0,12,1,0,13,1.8571428571428572,4,0.0,0,0,0,0,0,12,0,1,0,0,13,0
269,6969,YfVqOdQV9ZXJgq8aC5ARPHksMFUwqOvU,SpATywNh6bZuzm8s1ceuBUnMUAeoAHHw,2,0,0,0,0,0,2,0,2,0.2857142857142857,1,0.0,0,0,0,0,0,0,0,2,0,0,2,1
270,6981,Pp5JJMKWhHjqXDQq6vl852N5LskPEcDA,bWdj2GDclj5ofokWjzoa5jAwMkxCykd6,3,2,0,0,0,0,2,0,4,0.5714285714285714,1,0.0,0,0,0,0,2,0,0,2,0,0,4,1
271,6983,7fC3V6ivG07wUIMOmiYFzSlyjWvbYnYf,A3fsA9Zfv1X2fVEQhTw51lKENdNrEqT3,29,14,0,116,0,0,4,0,134,19.142857142857142,3,0.0,1,0,98,0,13,0,18,4,0,99,35,0
272,6989,QXMWMAYLhXvptULktpThtcXNRQ6JansN,SpATywNh6bZuzm8s1ceuBUnMUAeoAHHw,6,28,15,0,1,0,23,0,67,9.571428571428571,7,0.0,0,15,0,1,28,0,0,23,0,16,51,0
273,7020,43QhXZfKBBZHpTmjLSVuTzbc6djzr40d,SpATywNh6bZuzm8s1ceuBUnMUAeoAHHw,1,0,0,0,0,0,1,0,1,0.14285714285714285,1,0.0,0,0,0,0,0,0,0,1,0,0,1,0
274,7051,86WaolA0zlcsNwK3PQQKKGFDOSiqigXx,SpATywNh6bZuzm8s1ceuBUnMUAeoAHHw,26,25,10,28,7,0,3,0,73,10.428571428571429,1,0.0,4,10,24,7,21,0,4,3,0,45,28,1
275,7070,NHNfeNYNs1K8l9QFLPxdhmQxgpP2pCve,SpATywNh6bZuzm8s1ceuBUnMUAeoAHHw,13,7,5,0,4,1,5,1,23,3.2857142857142856,1,0.0,1,5,0,4,6,1,0,5,1,10,13,1
276,7107,oBmksukoqTKiKpWhco7hv7dHpVNhiTm0,SpATywNh6bZuzm8s1ceuBUnMUAeoAHHw,7,7,0,0,0,0,2,0,9,1.2857142857142858,1,0.0,0,0,0,0,7,0,0,2,0,0,9,1
277,7119,03YAuQnjuYjTWwgHqE1110CZpZwknRbj,RXDvfPUBYFlVdlueBFbLW0mhhAyGEqpt,8,8,5,24,0,0,2,0,39,5.571428571428571,2,0.0,0,5,21,0,8,0,3,2,0,26,13,0
278,7138,tJ7FzaUMbzSP2K4BtZobNqzCoEbllcH1,RXDvfPUBYFlVdlueBFbLW0mhhAyGEqpt,35,61,3,71,2,218,28,9,392,56.0,7,0.0,17,3,68,2,44,218,3,28,9,90,302,0
279,7143,ahFkMpqRNclNalhsRFgKmc75UZfOTdgQ,SpATywNh6bZuzm8s1ceuBUnMUAeoAHHw,23,63,25,25,7,0,6,0,126,18.0,7,0.0,16,25,19,7,47,0,6,6,0,67,59,1
280,7151,2QwHrFxGcIFGuR6TyUnlExhchaRL2Ipx,SpATywNh6bZuzm8s1ceuBUnMUAeoAHHw,11,29,6,15,0,0,7,0,57,8.142857142857142,5,0.0,9,6,12,0,20,0,3,7,0,27,30,0
281,7182,HlYiU2TA92it9HWOPDlsBmlpdZ7J7QTJ,SpATywNh6bZuzm8s1ceuBUnMUAeoAHHw,4,7,3,0,0,0,4,0,14,2.0,3,0.0,0,3,0,0,7,0,0,4,0,3,11,1
282,7211,KcnsNeA0wAhOuQ7U5h8zRsePAeKM7tfj,SpATywNh6bZuzm8s1ceuBUnMUAeoAHHw,6,3,0,0,1,0,2,0,6,0.8571428571428571,1,0.0,0,0,0,1,3,0,0,2,0,1,5,1
283,7225,WixZusYrasZzR9owXlaQpXrbIZeJOheR,SpATywNh6bZuzm8s1ceuBUnMUAeoAHHw,4,10,4,0,0,0,3,0,17,2.4285714285714284,3,0.0,3,4,0,0,7,0,0,3,0,7,10,0
284,7233,Kv9yM6Ye606xOusGmqGDWX6SW9fdHP2Q,bWdj2GDclj5ofokWjzoa5jAwMkxCykd6,9,7,2,0,1,25,7,1,43,6.142857142857143,2,0.0,0,2,0,1,7,25,0,7,1,3,40,1
285,7246,WixZusYrasZzR9owXlaQpXrbIZeJOheR,RXDvfPUBYFlVdlueBFbLW0mhhAyGEqpt,1,0,0,0,0,0,1,0,1,0.14285714285714285,1,0.0,0,0,0,0,0,0,0,1,0,0,1,1
286,7258,sT9hGAnww95aeGvqwQpJlS3ORhWDT49F,A3fsA9Zfv1X2fVEQhTw51lKENdNrEqT3,5,6,3,0,0,0,1,0,10,1.4285714285714286,1,0.0,0,3,0,0,6,0,0,1,0,3,7,1
287,7282,gMP76SzwbIEJUCyidRWCdRJzafVqamrK,bWdj2GDclj5ofokWjzoa5jAwMkxCykd6,8,8,2,0,2,1,11,0,24,3.4285714285714284,2,0.0,3,2,0,2,5,1,0,11,0,7,17,1
288,7283,K5Sy6doI03r5uctdEcvObhW1bpzNGROt,G8EPVSXsOYB5YQWZGiz1aVq5Pgr2GrQu,17,25,13,8,8,0,4,0,58,8.285714285714286,4,0.0,5,13,5,8,20,0,3,4,0,31,27,0
289,7304,VSEOcWZYpZiKC2PUmidzj4VqbBnc3GAo,A3fsA9Zfv1X2fVEQhTw51lKENdNrEqT3,23,3,2,66,0,0,13,0,84,12.0,2,0.0,1,2,58,0,2,0,8,13,0,61,23,0
290,7332,5kqorcxIJejDFcc1de7q3uie94xFSgMJ,SpATywNh6bZuzm8s1ceuBUnMUAeoAHHw,7,12,8,0,1,0,3,0,24,3.4285714285714284,2,0.0,0,8,0,1,12,0,0,3,0,9,15,0
291,7337,J5FkxM9o8L4y51xbaKwQjZuay8KpJMzH,SpATywNh6bZuzm8s1ceuBUnMUAeoAHHw,5,5,1,0,0,6,2,0,14,2.0,3,0.0,2,1,0,0,3,6,0,2,0,3,11,1
292,7338,XpquNqg2EIDRwNL88GzK6drchpRZMQN1,A3fsA9Zfv1X2fVEQhTw51lKENdNrEqT3,7,7,5,0,3,0,0,0,15,2.142857142857143,2,0.0,0,5,0,3,7,0,0,0,0,8,7,0
293,7345,B9KqNNxXBxHFUsJnQKQysblL3f8zF7sg,bWdj2GDclj5ofokWjzoa5jAwMkxCykd6,7,14,2,0,0,0,4,0,20,2.857142857142857,4,0.0,3,2,0,0,11,0,0,4,0,5,15,0
294,7348,5a7fehAo0Ol3kwHzhNqAYRGEzPLIE5FD,SpATywNh6bZuzm8s1ceuBUnMUAeoAHHw,9,5,4,0,3,0,1,0,13,1.8571428571428572,1,0.0,0,4,0,3,5,0,0,1,0,7,6,1
295,7364,84Vq27rxsidbGJFxLO0cd5e2CSiXRChu,A3fsA9Zfv1X2fVEQhTw51lKENdNrEqT3,37,37,26,66,6,5,12,0,152,21.714285714285715,4,0.0,2,26,60,6,35,5,6,12,0,94,58,1
296,7377,84Vq27rxsidbGJFxLO0cd5e2CSiXRChu,SpATywNh6bZuzm8s1ceuBUnMUAeoAHHw,17,10,9,0,7,0,2,0,28,4.0,2,0.0,0,9,0,7,10,0,0,2,0,16,12,1
297,7380,y4ROZxtUW2SffaQ3DMgCK81r0GDNLnMO,SpATywNh6bZuzm8s1ceuBUnMUAeoAHHw,4,2,0,0,0,0,3,0,5,0.7142857142857143,1,0.0,0,0,0,0,2,0,0,3,0,0,5,0
298,7387,u82lBhpDxJIwlZISEntCxj1zgVFdW0vT,SpATywNh6bZuzm8s1ceuBUnMUAeoAHHw,7,26,13,0,0,34,28,2,103,14.714285714285714,6,0.0,0,13,0,0,26,34,0,28,2,13,90,0
299,7402,XESEnxXOxYn0sEg8u7X5S27rymbaMzNA,SpATywNh6bZuzm8s1ceuBUnMUAeoAHHw,5,5,3,0,0,0,6,0,14,2.0,1,0.0,0,3,0,0,5,0,0,6,0,3,11,0
300,7405,thbVK5OkB13GLXnOCtBegvQeqDmjraYm,SpATywNh6bZuzm8s1ceuBUnMUAeoAHHw,4,4,2,0,0,0,5,0,11,1.5714285714285714,2,0.0,0,2,0,0,4,0,0,5,0,2,9,0
301,7456,1CrVBOpFvr6rOy553Xrye0bjPdL11eu8,A3fsA9Zfv1X2fVEQhTw51lKENdNrEqT3,44,56,27,58,5,55,25,1,227,32.42857142857143,5,0.0,6,27,56,5,50,55,2,25,1,94,133,0
302,7470,zwtc7XYkGr4Bhsl8UEIZlPO0o9lpzfSZ,A3fsA9Zfv1X2fVEQhTw51lKENdNrEqT3,29,11,3,92,2,0,2,0,110,15.714285714285714,2,0.0,1,3,81,2,10,0,11,2,0,87,23,0
303,7477,5DIcniD9kRbDupVPBNugV5by0SZHtD2e,SpATywNh6bZuzm8s1ceuBUnMUAeoAHHw,3,4,0,0,0,0,3,0,7,1.0,1,0.0,0,0,0,0,4,0,0,3,0,0,7,0
304,7484,ZghgmsFKGlL396BKFJoJeIy2X7crdnN0,SpATywNh6bZuzm8s1ceuBUnMUAeoAHHw,1,0,0,0,0,0,1,0,1,0.14285714285714285,1,0.0,0,0,0,0,0,0,0,1,0,0,1,0
305,7490,uUSTKM8g1hIskJbYHh1UiIQ6epHTSTNR,G8EPVSXsOYB5YQWZGiz1aVq5Pgr2GrQu,11,13,8,2,4,0,3,0,30,4.285714285714286,2,0.0,2,8,2,4,11,0,0,3,0,16,14,0
306,7505,1sFJ1Szdx1WU21TgC1PRv3tkQ09H4qed,SpATywNh6bZuzm8s1ceuBUnMUAeoAHHw,2,0,0,0,0,0,2,0,2,0.2857142857142857,1,0.0,0,0,0,0,0,0,0,2,0,0,2,1
307,7541,CGIwACA114zcxKI2ZiGPCkXleQcVHz2y,SpATywNh6bZuzm8s1ceuBUnMUAeoAHHw,2,0,0,0,0,0,2,0,2,0.2857142857142857,2,0.0,0,0,0,0,0,0,0,2,0,0,2,0
308,7543,fGIeAB7IRJCHxzCo8u4GLaPKxQfHeCdi,SpATywNh6bZuzm8s1ceuBUnMUAeoAHHw,5,3,2,0,0,8,13,0,26,3.7142857142857144,4,0.0,0,2,0,0,3,8,0,13,0,2,24,0
309,7551,dnay2jAX3cgskuo0IcUq4nB4ZOtSKU5x,SpATywNh6bZuzm8s1ceuBUnMUAeoAHHw,4,3,1,0,0,0,4,0,8,1.1428571428571428,2,0.0,0,1,0,0,3,0,0,4,0,1,7,0
310,7554,eO5CgKdvPHZfZ8krv7wlSTYp2EdmZAmV,RXDvfPUBYFlVdlueBFbLW0mhhAyGEqpt,23,35,0,32,3,0,1,0,71,10.142857142857142,2,0.0,9,0,30,3,26,0,2,1,0,42,29,1
311,7587,wEaTyOJwwvOCk7eUttQISK5WPXL7ANNV,SpATywNh6bZuzm8s1ceuBUnMUAeoAHHw,1,0,0,0,0,0,1,0,1,0.14285714285714285,1,0.0,0,0,0,0,0,0,0,1,0,0,1,0
312,7616,PcrKUgtxZcGXBYkLOmECh99m3fhAOabf,SpATywNh6bZuzm8s1ceuBUnMUAeoAHHw,14,21,0,16,0,0,4,0,41,5.857142857142857,3,0.0,3,0,14,0,18,0,2,4,0,17,24,0
313,7623,uRIMG7KJWhHO81Kf9MvAfUFzZC6juL3s,bWdj2GDclj5ofokWjzoa5jAwMkxCykd6,12,8,1,22,1,0,1,0,33,4.714285714285714,1,0.0,2,1,19,1,6,0,3,1,0,23,10,0
314,7651,HL6JESJ9UfnK7mtp7EsklcgEKja4gTaC,RXDvfPUBYFlVdlueBFbLW0mhhAyGEqpt,2,0,0,0,0,2,1,0,3,0.42857142857142855,1,0.0,0,0,0,0,0,2,0,1,0,0,3,1
315,7656,v9Jp2iBPSFTVxP8FrUe1odwfz8Hd1wS3,SpATywNh6bZuzm8s1ceuBUnMUAeoAHHw,1,0,0,0,0,0,1,0,1,0.14285714285714285,1,0.0,0,0,0,0,0,0,0,1,0,0,1,0
316,7659,1KSlK2xXHUc3PjC1CsQEQaomGBagqDXf,A3fsA9Zfv1X2fVEQhTw51lKENdNrEqT3,2,0,1,0,1,0,0,0,2,0.2857142857142857,1,0.0,0,1,0,1,0,0,0,0,0,2,0,1
317,7667,ImCVHOP1jti1S73II8BRabWE6aqK4I6u,SpATywNh6bZuzm8s1ceuBUnMUAeoAHHw,2,0,0,0,0,0,2,0,2,0.2857142857142857,1,0.0,0,0,0,0,0,0,0,2,0,0,2,1
318,7670,NKzNFHK6LaJqjMec69ZX5HfBigF4yyJV,SpATywNh6bZuzm8s1ceuBUnMUAeoAHHw,5,2,1,0,0,4,8,2,17,2.4285714285714284,1,0.0,0,1,0,0,2,4,0,8,2,1,16,0
319,7677,HPp2Yy992FcBIXDjeQl0bEftbV1QFRDS,SpATywNh6bZuzm8s1ceuBUnMUAeoAHHw,16,49,18,24,6,0,4,0,101,14.428571428571429,3,0.0,12,18,18,6,37,0,6,4,0,54,47,0
320,7683,uydIb4MWCn95KWcEhKwj3VRfjvxXo8Nj,A3fsA9Zfv1X2fVEQhTw51lKENdNrEqT3,40,67,40,78,0,280,38,1,504,72.0,7,0.0,7,40,54,0,60,280,24,38,1,101,403,0
321,7694,a6f3gPi6axX0cfBnUGVliBDQrPx92l1r,SpATywNh6bZuzm8s1ceuBUnMUAeoAHHw,4,14,6,0,0,0,6,0,26,3.7142857142857144,4,0.0,0,6,0,0,14,0,0,6,0,6,20,0
322,7701,f81JJCqMlkJdA9lV7uQBviuGlLm2CDkR,SpATywNh6bZuzm8s1ceuBUnMUAeoAHHw,3,2,0,0,0,0,2,0,4,0.5714285714285714,1,0.0,0,0,0,0,2,0,0,2,0,0,4,0
323,7720,LyBG9vpZvAGsIKFzeD4gB6XRCVzk12fF,A3fsA9Zfv1X2fVEQhTw51lKENdNrEqT3,1,0,0,0,0,0,1,0,1,0.14285714285714285,1,0.0,0,0,0,0,0,0,0,1,0,0,1,1
324,7729,xkt3K6JWpnfeixDBdwkLXaHgXuuGt35v,A3fsA9Zfv1X2fVEQhTw51lKENdNrEqT3,27,11,6,90,0,0,7,0,114,16.285714285714285,2,0.0,1,6,78,0,10,0,12,7,0,85,29,1
325,7731,ZD844NRFhgHqwskHd8pIBuIwDiTAY4NC,SpATywNh6bZuzm8s1ceuBUnMUAeoAHHw,14,17,9,10,4,2,3,0,45,6.428571428571429,2,0.0,4,9,9,4,13,2,1,3,0,26,19,0
326,7766,3kfsZtV93tVXeg8YtF9PTasYswVdOeLx,SpATywNh6bZuzm8s1ceuBUnMUAeoAHHw,3,14,0,0,0,0,8,0,22,3.142857142857143,6,0.0,0,0,0,0,14,0,0,8,0,0,22,0
327,7771,Rdvgrardg53H2oeCgmOt8vFxIUu5nogb,SpATywNh6bZuzm8s1ceuBUnMUAeoAHHw,9,16,7,0,0,0,4,0,27,3.857142857142857,1,0.0,6,7,0,0,10,0,0,4,0,13,14,0
328,7774,EQU3KQKmF0NpNwQmPmUw90ptahwADmIz,SpATywNh6bZuzm8s1ceuBUnMUAeoAHHw,4,5,1,0,0,0,1,0,7,1.0,1,0.0,2,1,0,0,3,0,0,1,0,3,4,1
329,7778,moK1GdnqoYxhSRCf5a95lgXdVNdzYrjs,A3fsA9Zfv1X2fVEQhTw51lKENdNrEqT3,29,19,2,44,0,0,13,0,78,11.142857142857142,5,0.0,1,2,43,0,18,0,1,13,0,46,32,0
330,7786,7aA6BrVZipLHOrozlrYBMEmfMq4MXahq,RXDvfPUBYFlVdlueBFbLW0mhhAyGEqpt,11,9,2,17,0,0,4,0,32,4.571428571428571,3,0.0,1,2,15,0,8,0,2,4,0,18,14,0
331,7789,pdotXwlXOl4cuEJn7TjzheQq2EZaH9qB,SpATywNh6bZuzm8s1ceuBUnMUAeoAHHw,1,1,0,0,0,0,0,0,1,0.14285714285714285,1,0.0,0,0,0,0,1,0,0,0,0,0,1,1
332,7831,SozLQk8695JG7fvj1Enp26s5ACJQjjq5,SpATywNh6bZuzm8s1ceuBUnMUAeoAHHw,3,2,1,0,0,0,1,0,4,0.5714285714285714,1,0.0,0,1,0,0,2,0,0,1,0,1,3,0
333,7844,cSB2xmj1Zot5hgCLSHhxDNISJzHyYsXf,SpATywNh6bZuzm8s1ceuBUnMUAeoAHHw,1,0,0,0,0,0,3,0,3,0.42857142857142855,3,0.0,0,0,0,0,0,0,0,3,0,0,3,1
334,7869,34oDxV5jJfVaGWSsgPNGJP2ott7rJu7I,SpATywNh6bZuzm8s1ceuBUnMUAeoAHHw,21,70,31,20,23,3,13,0,160,22.857142857142858,3,0.0,22,31,16,23,48,3,4,13,0,92,68,0
335,7872,ZosutOeXAHBSIvZIuIxhmKGfV7JZESP5,SpATywNh6bZuzm8s1ceuBUnMUAeoAHHw,2,0,0,0,0,0,2,0,2,0.2857142857142857,1,0.0,0,0,0,0,0,0,0,2,0,0,2,0
336,7916,TIvBCmMDquWj2iwTixxUP6A3HzcrQyq3,SpATywNh6bZuzm8s1ceuBUnMUAeoAHHw,4,2,1,0,0,0,5,0,8,1.1428571428571428,3,0.0,0,1,0,0,2,0,0,5,0,1,7,0
337,7932,Dm0fTQ5hQ4vZLMdCz8HpFheMP2yCMt3n,SpATywNh6bZuzm8s1ceuBUnMUAeoAHHw,1,0,0,0,0,0,1,0,1,0.14285714285714285,1,0.0,0,0,0,0,0,0,0,1,0,0,1,0
338,7953,KIPXc8MOqmnlmMqnIzIeaBqliIw9pS44,RXDvfPUBYFlVdlueBFbLW0mhhAyGEqpt,3,2,1,0,0,0,2,0,5,0.7142857142857143,1,0.0,0,1,0,0,2,0,0,2,0,1,4,1
339,7971,Y7KMNxUWz3B2grUtFCf2FgfpqFMvSy0l,G8EPVSXsOYB5YQWZGiz1aVq5Pgr2GrQu,44,33,23,104,13,1,15,1,190,27.142857142857142,4,0.0,0,23,82,13,33,1,22,15,1,118,72,0
340,8012,jagu0OJDhWTGFhfCMk0ghqluLpW3kzdC,SpATywNh6bZuzm8s1ceuBUnMUAeoAHHw,2,0,0,0,0,0,4,0,4,0.5714285714285714,2,0.0,0,0,0,0,0,0,0,4,0,0,4,0
341,8040,IjI8O6qhXWrzvoHGjD0jKSLTrkjwywnZ,SpATywNh6bZuzm8s1ceuBUnMUAeoAHHw,18,28,1,19,0,10,8,1,67,9.571428571428571,1,0.0,10,1,16,0,18,10,3,8,1,27,40,0
342,8042,XDPvGyFLLEYwbNEQik2MM4yiADs5rrYJ,SpATywNh6bZuzm8s1ceuBUnMUAeoAHHw,3,2,1,0,0,0,2,0,5,0.7142857142857143,1,0.0,0,1,0,0,2,0,0,2,0,1,4,1
343,8048,lPfsYctvOlk2KshSTR0YzF9fsG0sDcXm,SpATywNh6bZuzm8s1ceuBUnMUAeoAHHw,4,2,1,0,0,0,2,0,5,0.7142857142857143,1,0.0,0,1,0,0,2,0,0,2,0,1,4,0
344,8060,aJPDWxjvWh7cfVWUTg8ZVK8q5wjeFEdQ,SpATywNh6bZuzm8s1ceuBUnMUAeoAHHw,10,18,10,0,3,0,10,0,41,5.857142857142857,1,0.0,0,10,0,3,18,0,0,10,0,13,28,1
345,8123,q6JeU48PcDOdiZ368tb3IoCh3BVgnxVp,bWdj2GDclj5ofokWjzoa5jAwMkxCykd6,16,36,20,8,15,0,3,0,82,11.714285714285714,3,0.0,1,20,6,15,35,0,2,3,0,42,40,1
346,8145,ZDVmuYiPoGm0gu1bR2BaE1soF6dU5v1W,A3fsA9Zfv1X2fVEQhTw51lKENdNrEqT3,22,60,23,4,13,0,1,0,101,14.428571428571429,1,0.0,0,23,4,13,60,0,0,1,0,40,61,1
347,8243,VAe2acDlYib7o05H0M3tg4gQoc5gLI96,SpATywNh6bZuzm8s1ceuBUnMUAeoAHHw,7,11,6,0,1,0,2,0,20,2.857142857142857,1,0.0,1,6,0,1,10,0,0,2,0,8,12,1
348,8257,ANOp8mWNHTZUswLhYddMTdBChUriYZaX,RXDvfPUBYFlVdlueBFbLW0mhhAyGEqpt,24,110,7,44,0,20,17,0,198,28.285714285714285,4,0.0,9,7,40,0,101,20,4,17,0,56,142,0
349,8305,kpS5tMAHQr9yJyfVB9Mkc4TlfmouYjNE,SpATywNh6bZuzm8s1ceuBUnMUAeoAHHw,3,5,4,0,0,0,1,0,10,1.4285714285714286,3,0.0,0,4,0,0,5,0,0,1,0,4,6,0
350,8312,cYibpCaMUGq0WjgUWfTv0iIvJ7QbFj5E,SpATywNh6bZuzm8s1ceuBUnMUAeoAHHw,3,0,0,0,0,0,9,0,9,1.2857142857142858,3,0.0,0,0,0,0,0,0,0,9,0,0,9,0
351,8375,U7C8tpNUwsrK1uIrWw0ieIQJYwOo61Uc,SpATywNh6bZuzm8s1ceuBUnMUAeoAHHw,3,2,1,0,0,0,1,0,4,0.5714285714285714,1,0.0,0,1,0,0,2,0,0,1,0,1,3,1
352,8381,XDUz0oVcNwke0CqAlFlmwOWSA32SgeFl,SpATywNh6bZuzm8s1ceuBUnMUAeoAHHw,3,4,0,0,0,0,3,0,7,1.0,2,0.0,0,0,0,0,4,0,0,3,0,0,7,0
353,8410,kWUbu8oK1dFJKpHhiF15MwcSzNzv8GaS,A3fsA9Zfv1X2fVEQhTw51lKENdNrEqT3,6,6,4,0,2,0,3,0,15,2.142857142857143,1,0.0,0,4,0,2,6,0,0,3,0,6,9,1
354,8424,ukCIrv5h45nbdIEPPmMlvipT87B8fFE7,RXDvfPUBYFlVdlueBFbLW0mhhAyGEqpt,4,23,19,0,0,0,2,0,44,6.285714285714286,7,0.0,0,19,0,0,23,0,0,2,0,19,25,0
355,8443,ITkxDxE80MnM3R1P6Tny4qeXU1QIqBHa,A3fsA9Zfv1X2fVEQhTw51lKENdNrEqT3,43,28,19,118,11,8,5,0,189,27.0,1,0.0,2,19,104,11,26,8,14,5,0,136,53,1
356,8457,jcXoYFaI9QPcliotiwIgOLeObkrSUvNn,SpATywNh6bZuzm8s1ceuBUnMUAeoAHHw,1,0,0,0,0,0,1,0,1,0.14285714285714285,1,0.0,0,0,0,0,0,0,0,1,0,0,1,0
357,8478,UY6XF5Ob1mgKcqmlUI5FgYfIUUIUAwxR,SpATywNh6bZuzm8s1ceuBUnMUAeoAHHw,1,0,0,0,0,0,1,0,1,0.14285714285714285,1,0.0,0,0,0,0,0,0,0,1,0,0,1,0
358,8505,DpXkrIHIAIPNESKyvFah0WhpVT5PHFeL,SpATywNh6bZuzm8s1ceuBUnMUAeoAHHw,11,11,6,8,0,0,5,0,30,4.285714285714286,2,0.0,2,6,7,0,9,0,1,5,0,15,15,0
359,8517,4tj4DQ4XnBvn4uM9Mw2kTJbN1KPDkno4,SpATywNh6bZuzm8s1ceuBUnMUAeoAHHw,4,7,2,0,0,0,2,0,11,1.5714285714285714,1,0.0,4,2,0,0,3,0,0,2,0,6,5,0
360,8523,0Vj24SN7QK68fxZGEj9b6pGHh8nTXfGG,A3fsA9Zfv1X2fVEQhTw51lKENdNrEqT3,27,14,8,94,1,0,2,0,119,17.0,2,0.0,2,8,87,1,12,0,7,2,0,98,21,0
361,8540,83bogZlv4TVHMx4MUYOU3yEQWNYHnGAe,G8EPVSXsOYB5YQWZGiz1aVq5Pgr2GrQu,1,0,0,0,0,0,1,0,1,0.14285714285714285,1,0.0,0,0,0,0,0,0,0,1,0,0,1,1
362,8570,ApFdQQBcLqTLoA4wIvtlnnwFs4FrlVS1,RXDvfPUBYFlVdlueBFbLW0mhhAyGEqpt,36,44,24,38,15,0,20,0,141,20.142857142857142,4,0.0,15,24,33,15,29,0,5,20,0,87,54,0
363,8574,7jkKKf5Pb7FrtJ3WnuF11G7ePioUPJm3,A3fsA9Zfv1X2fVEQhTw51lKENdNrEqT3,5,3,2,0,1,0,1,0,7,1.0,1,0.0,0,2,0,1,3,0,0,1,0,3,4,1
364,8582,x0VzAeYdlywtGLqE1HF68qQMYZTLfsw9,SpATywNh6bZuzm8s1ceuBUnMUAeoAHHw,18,17,8,10,4,0,5,0,44,6.285714285714286,3,0.0,8,8,10,4,9,0,0,5,0,30,14,0
365,8585,28jQkMYgDOh7TIBKdGn62G1sm2slN0BP,A3fsA9Zfv1X2fVEQhTw51lKENdNrEqT3,33,20,13,82,8,0,4,0,127,18.142857142857142,3,0.0,1,13,71,8,19,0,11,4,0,93,34,0
366,8586,Xci1viGBABzXjikcwwlwGEGBfmePUlzw,SpATywNh6bZuzm8s1ceuBUnMUAeoAHHw,6,6,2,0,0,10,7,0,25,3.5714285714285716,2,0.0,3,2,0,0,3,10,0,7,0,5,20,1
367,8616,GexMn1szbSD50sX3ghgNlwAzziO50D2R,SpATywNh6bZuzm8s1ceuBUnMUAeoAHHw,11,10,1,0,1,18,13,0,43,6.142857142857143,4,0.0,1,1,0,1,9,18,0,13,0,3,40,0
368,8628,nQgK4glIoTighvWZSrb5cpZqSgT49IUz,SpATywNh6bZuzm8s1ceuBUnMUAeoAHHw,12,13,6,6,0,0,4,0,29,4.142857142857143,2,0.0,4,6,6,0,9,0,0,4,0,16,13,0
369,8636,2tNnsKlcvz4IV4xQh5sF75J9zNq5DtzC,SpATywNh6bZuzm8s1ceuBUnMUAeoAHHw,6,5,0,0,0,6,1,0,12,1.7142857142857142,1,0.0,0,0,0,0,5,6,0,1,0,0,12,1
370,8640,g2XbJogybHS3UQDYBcO0HoCO8HfG7ABm,A3fsA9Zfv1X2fVEQhTw51lKENdNrEqT3,3,2,1,0,0,0,1,0,4,0.5714285714285714,1,0.0,0,1,0,0,2,0,0,1,0,1,3,1
371,8649,uQjl8NGtIQkRfoe9edBiMgtYYmdkzVXR,bWdj2GDclj5ofokWjzoa5jAwMkxCykd6,28,80,38,71,19,30,11,0,249,35.57142857142857,4,0.0,11,38,59,19,69,30,12,11,0,127,122,0
372,8652,15n53eqSRMLQKZaiigI2Vgclm7aKceka,A3fsA9Zfv1X2fVEQhTw51lKENdNrEqT3,7,5,2,0,1,0,4,0,12,1.7142857142857142,2,0.0,0,2,0,1,5,0,0,4,0,3,9,0
373,8660,CxUPOQRaQMGLmbOcfniIQOhh24PXLDR6,A3fsA9Zfv1X2fVEQhTw51lKENdNrEqT3,10,15,7,0,2,14,5,1,44,6.285714285714286,4,0.0,0,7,0,2,15,14,0,5,1,9,35,0
374,8677,k6Ev3pOofJatsjXYv6yHRgeWPlAQcaXL,SpATywNh6bZuzm8s1ceuBUnMUAeoAHHw,3,2,1,0,0,0,1,0,4,0.5714285714285714,1,0.0,0,1,0,0,2,0,0,1,0,1,3,1
375,8690,NuBf7vtWvcfQjgrelnmNuJu6a5WC9FFT,SpATywNh6bZuzm8s1ceuBUnMUAeoAHHw,10,12,1,0,0,7,8,2,30,4.285714285714286,2,0.0,0,1,0,0,12,7,0,8,2,1,29,0
376,8741,XWElpBT4PKnC5pi96PLjtYP5u9l1rrKm,SpATywNh6bZuzm8s1ceuBUnMUAeoAHHw,1,0,0,0,0,0,3,0,3,0.42857142857142855,2,0.0,0,0,0,0,0,0,0,3,0,0,3,0
377,8748,IZ5pWpBLzW50MjCCGxCjTz4w6DVz2MU3,A3fsA9Zfv1X2fVEQhTw51lKENdNrEqT3,3,2,1,0,0,0,1,0,4,0.5714285714285714,1,0.0,0,1,0,0,2,0,0,1,0,1,3,0
378,8752,tsTDNHtkzUQqr6Le5CiKzEb1J3ub8XpE,G8EPVSXsOYB5YQWZGiz1aVq5Pgr2GrQu,36,33,6,59,7,0,3,0,108,15.428571428571429,5,0.0,12,6,51,7,21,0,8,3,0,76,32,0
379,8768,Za0SfT4qDZpXUZtWaYX1DLLmm9w6G9yO,RXDvfPUBYFlVdlueBFbLW0mhhAyGEqpt,24,25,13,0,8,14,6,1,67,9.571428571428571,1,0.0,0,13,0,8,25,14,0,6,1,21,46,1
380,8772,NLUFE7ndaVQ8A2tkIa8xBpPqWZbahAYT,SpATywNh6bZuzm8s1ceuBUnMUAeoAHHw,1,0,0,0,0,0,1,0,1,0.14285714285714285,1,0.0,0,0,0,0,0,0,0,1,0,0,1,0
381,8778,hkmT0j8GDy3ymXnKaIcUDPdFkebvKRou,SpATywNh6bZuzm8s1ceuBUnMUAeoAHHw,4,0,0,0,0,3,3,1,7,1.0,1,0.0,0,0,0,0,0,3,0,3,1,0,7,0
382,8790,hShFZH2IARrzxZjv2Hbws9rmf9bt3f58,SpATywNh6bZuzm8s1ceuBUnMUAeoAHHw,14,44,8,18,0,0,6,1,77,11.0,3,0.0,17,8,15,0,27,0,3,6,1,40,37,0
383,8820,sqKEuRhvHf94SnQ2C0IdhOfhaSrrM6tg,SpATywNh6bZuzm8s1ceuBUnMUAeoAHHw,19,19,3,16,5,0,7,1,51,7.285714285714286,2,0.0,4,3,14,5,15,0,2,7,1,26,25,0
384,8833,BX9KMh9DUbDRkGw8SYAs3wHv0hHJ990Z,SpATywNh6bZuzm8s1ceuBUnMUAeoAHHw,3,8,4,0,0,0,4,0,16,2.2857142857142856,3,0.0,0,4,0,0,8,0,0,4,0,4,12,0
385,8894,8IuzZOXaXVUql9pLZtNuJIyLoDJ8ZL4V,bWdj2GDclj5ofokWjzoa5jAwMkxCykd6,4,5,3,0,0,0,3,0,11,1.5714285714285714,2,0.0,0,3,0,0,5,0,0,3,0,3,8,1
386,8908,9lksmcPg7FQE2FGQIA9VvWum1Z9DYrHM,SpATywNh6bZuzm8s1ceuBUnMUAeoAHHw,4,4,2,0,0,0,2,0,8,1.1428571428571428,1,0.0,0,2,0,0,4,0,0,2,0,2,6,1
387,8939,awz7o49PrUBSNrYng5ZPMFSJBn6RXWK1,G8EPVSXsOYB5YQWZGiz1aVq5Pgr2GrQu,36,44,31,34,13,0,16,0,138,19.714285714285715,5,0.0,2,31,32,13,42,0,2,16,0,78,60,0
388,8976,7uaenfsWfnarv8At387iUkznBBW20T7a,SpATywNh6bZuzm8s1ceuBUnMUAeoAHHw,7,7,4,0,1,0,2,0,14,2.0,2,0.0,0,4,0,1,7,0,0,2,0,5,9,0
389,8978,WCRryRCEKP6zK3AUHtR5dzBwncEtNUH8,G8EPVSXsOYB5YQWZGiz1aVq5Pgr2GrQu,34,71,8,82,6,0,15,0,182,26.0,7,0.0,11,8,69,6,60,0,13,15,0,94,88,0
390,9007,WDMP5c2Ubx8vVSFegA0mXeU23cYb0qCY,RXDvfPUBYFlVdlueBFbLW0mhhAyGEqpt,11,18,1,13,0,23,3,0,58,8.285714285714286,7,0.0,1,1,9,0,17,23,4,3,0,11,47,0
391,9035,ANOp8mWNHTZUswLhYddMTdBChUriYZaX,SpATywNh6bZuzm8s1ceuBUnMUAeoAHHw,1,0,0,0,0,0,1,0,1,0.14285714285714285,1,0.0,0,0,0,0,0,0,0,1,0,0,1,0
392,9146,ZZYUdx90J4oaTxXr1v9ckDyAAO4fdRrW,bWdj2GDclj5ofokWjzoa5jAwMkxCykd6,7,2,2,0,2,0,2,0,8,1.1428571428571428,1,0.0,0,2,0,2,2,0,0,2,0,4,4,1
393,9220,lnpRXkDrSwjGYP4CoWLvjg5xZj4SSBHh,SpATywNh6bZuzm8s1ceuBUnMUAeoAHHw,3,2,1,0,0,2,2,0,7,1.0,2,0.0,0,1,0,0,2,2,0,2,0,1,6,0
394,9246,oolYEp2BotSva2yfmUYiIDYQiMjym92z,SpATywNh6bZuzm8s1ceuBUnMUAeoAHHw,1,0,0,0,0,0,1,0,1,0.14285714285714285,1,0.0,0,0,0,0,0,0,0,1,0,0,1,0
395,9257,XQsLTRxBgT09jhwR2kw4g3k34p5O8kHV,A3fsA9Zfv1X2fVEQhTw51lKENdNrEqT3,5,3,2,0,1,0,1,0,7,1.0,1,0.0,0,2,0,1,3,0,0,1,0,3,4,1
396,9260,OXDIjQPBiuWpB7PdzfniEtiITaq40Kxq,SpATywNh6bZuzm8s1ceuBUnMUAeoAHHw,3,2,1,0,0,0,1,0,4,0.5714285714285714,1,0.0,0,1,0,0,2,0,0,1,0,1,3,1
397,9272,8lhedVUrxjbKOOXrDoKpLvh9BgBDrVND,SpATywNh6bZuzm8s1ceuBUnMUAeoAHHw,3,2,0,0,0,0,2,0,4,0.5714285714285714,1,0.0,0,0,0,0,2,0,0,2,0,0,4,0
398,9273,Mu4L96Qo7KWrVAKYK2IsPfV4EjP9aNL4,G8EPVSXsOYB5YQWZGiz1aVq5Pgr2GrQu,1,0,0,0,0,0,1,0,1,0.14285714285714285,1,0.0,0,0,0,0,0,0,0,1,0,0,1,1
399,9275,Mu4L96Qo7KWrVAKYK2IsPfV4EjP9aNL4,SpATywNh6bZuzm8s1ceuBUnMUAeoAHHw,2,0,0,0,0,24,1,0,25,3.5714285714285716,1,0.0,0,0,0,0,0,24,0,1,0,0,25,1
400,9295,Xj0ZJ92JN6F4CNXTzd0Bvhi4bYi9S3VP,SpATywNh6bZuzm8s1ceuBUnMUAeoAHHw,8,7,7,0,7,0,7,0,28,4.0,3,0.0,0,7,0,7,7,0,0,7,0,14,14,0
401,9315,MjPA7JgM9XbkzRn3BICo8xJPG5qfeCcD,bWdj2GDclj5ofokWjzoa5jAwMkxCykd6,5,7,5,0,4,0,1,0,17,2.4285714285714284,1,0.0,0,5,0,4,7,0,0,1,0,9,8,1
402,9327,tJN8ZYcrD7OwnBb01xCqUSDOnzwFRPdf,SpATywNh6bZuzm8s1ceuBUnMUAeoAHHw,6,5,2,0,0,0,4,0,11,1.5714285714285714,3,0.0,0,2,0,0,5,0,0,4,0,2,9,0
403,9328,3SP9iNDvUt8m67ZMqC5DpQRe6ekkTpsP,SpATywNh6bZuzm8s1ceuBUnMUAeoAHHw,1,0,0,0,0,0,15,0,15,2.142857142857143,5,0.0,0,0,0,0,0,0,0,15,0,0,15,1
404,9347,dQweEcdBCmNmUPOeO7X4TTmH8zuMq2aJ,bWdj2GDclj5ofokWjzoa5jAwMkxCykd6,4,5,2,0,0,0,1,0,8,1.1428571428571428,1,0.0,1,2,0,0,4,0,0,1,0,3,5,1
405,9422,KqXKhfoS0ErJVO04c2y8uGBxUt61ck8m,SpATywNh6bZuzm8s1ceuBUnMUAeoAHHw,1,0,0,0,0,0,1,0,1,0.14285714285714285,1,0.0,0,0,0,0,0,0,0,1,0,0,1,1
406,9460,zOr0niRplBKfkwpPHNykN96u1FhzegfK,G8EPVSXsOYB5YQWZGiz1aVq5Pgr2GrQu,20,155,82,22,3,60,28,0,350,50.0,5,0.0,15,82,16,3,140,60,6,28,0,116,234,0
407,9468,JnhPqAOFLEpgEufKhwt0tmkUNhkNteVd,SpATywNh6bZuzm8s1ceuBUnMUAeoAHHw,5,3,1,0,1,0,1,0,6,0.8571428571428571,1,0.0,0,1,0,1,3,0,0,1,0,2,4,1
408,9469,V4PEne3FGwC3uaaGa4t7iLZtyEIE0fzF,SpATywNh6bZuzm8s1ceuBUnMUAeoAHHw,9,7,1,13,0,0,2,0,23,3.2857142857142856,1,0.0,3,1,11,0,4,0,2,2,0,15,8,1
409,9510,20lTdK7j1fcbNyoe9mD2q7qXvA5Z8HOD,SpATywNh6bZuzm8s1ceuBUnMUAeoAHHw,13,37,26,0,16,0,8,0,87,12.428571428571429,2,0.0,1,26,0,16,36,0,0,8,0,43,44,0
410,9517,fN4I0M2Yv3uPvseFkDyQdSg5ZokzJaMj,RXDvfPUBYFlVdlueBFbLW0mhhAyGEqpt,3,2,1,0,0,0,1,0,4,0.5714285714285714,1,0.0,0,1,0,0,2,0,0,1,0,1,3,1
411,9533,xdUSsALCLmQFNaGX8BEyTR2RhmvhWdsB,SpATywNh6bZuzm8s1ceuBUnMUAeoAHHw,3,4,2,0,0,0,4,0,10,1.4285714285714286,2,0.0,0,2,0,0,4,0,0,4,0,2,8,0
412,9549,RV3mgnFEm5em6PXoEJeQNSKFCpjzfVyy,bWdj2GDclj5ofokWjzoa5jAwMkxCykd6,2,0,0,0,0,17,3,0,20,2.857142857142857,2,0.0,0,0,0,0,0,17,0,3,0,0,20,0
413,9550,7J9JIWVCQG1g6yXh3uTVbrSu3pa18Ezn,SpATywNh6bZuzm8s1ceuBUnMUAeoAHHw,6,5,3,0,0,0,3,0,11,1.5714285714285714,2,0.0,0,3,0,0,5,0,0,3,0,3,8,0
414,9624,GD8FRA1y66qb4KlW9w61HoAU1TWGpDoa,G8EPVSXsOYB5YQWZGiz1aVq5Pgr2GrQu,10,22,11,0,0,78,21,0,132,18.857142857142858,7,0.0,3,11,0,0,19,78,0,21,0,14,118,0
415,9643,UzwJVyLJF6Ih9iHYPyYWMullgIr89o5m,SpATywNh6bZuzm8s1ceuBUnMUAeoAHHw,3,4,2,0,0,0,5,0,11,1.5714285714285714,2,0.0,0,2,0,0,4,0,0,5,0,2,9,0
416,9655,66U3TkcZA1aSl7HKRun9CzahgGH85zQD,SpATywNh6bZuzm8s1ceuBUnMUAeoAHHw,5,4,1,0,0,3,6,0,14,2.0,2,0.0,0,1,0,0,4,3,0,6,0,1,13,0
417,9663,C4q4gNQYEpjKh7pq1qjN8i3L7uSpUX9d,bWdj2GDclj5ofokWjzoa5jAwMkxCykd6,28,32,20,26,12,0,5,0,95,13.571428571428571,2,0.0,7,20,20,12,25,0,6,5,0,59,36,0
418,9672,Bi4hHmeTLwTbUCScu9tC6ZZN7frLUhVP,A3fsA9Zfv1X2fVEQhTw51lKENdNrEqT3,60,26,19,78,11,0,10,0,144,20.571428571428573,2,0.0,3,19,77,11,23,0,1,10,0,110,34,0
419,9720,0dBn4alo7QBTd62VD5XO0yNMbQ5QN2OQ,bWdj2GDclj5ofokWjzoa5jAwMkxCykd6,5,3,2,0,1,0,1,0,7,1.0,1,0.0,0,2,0,1,3,0,0,1,0,3,4,1
420,9783,CZfXDHVnNPClikyXrFzPhkQoFiILzXmF,SpATywNh6bZuzm8s1ceuBUnMUAeoAHHw,6,9,1,0,0,0,3,0,13,1.8571428571428572,2,0.0,0,1,0,0,9,0,0,3,0,1,12,0
421,9784,WnYAypmYi03odcBC7NgJFsh1FzqrpNw6,SpATywNh6bZuzm8s1ceuBUnMUAeoAHHw,4,3,2,0,0,0,1,0,6,0.8571428571428571,1,0.0,0,2,0,0,3,0,0,1,0,2,4,0
422,9790,yUvG5Vqh097epwWCIkZetr2ZlwvQRcLL,SpATywNh6bZuzm8s1ceuBUnMUAeoAHHw,1,0,0,0,0,0,1,0,1,0.14285714285714285,1,0.0,0,0,0,0,0,0,0,1,0,0,1,0
423,9793,B2ahwtOo16YsNrAQ9LRd2yjP18Ni9l2c,SpATywNh6bZuzm8s1ceuBUnMUAeoAHHw,4,5,0,0,0,0,3,0,8,1.1428571428571428,2,0.0,0,0,0,0,5,0,0,3,0,0,8,0
424,9797,Dnyzk8ev480byt0tTEIN8mPtG79PwCH1,RXDvfPUBYFlVdlueBFbLW0mhhAyGEqpt,29,19,16,2,11,9,2,0,59,8.428571428571429,1,0.0,1,16,2,11,18,9,0,2,0,30,29,1
425,9852,1wIqcRX58Bpw6RXvGnbxsc6WbPwWGwXd,SpATywNh6bZuzm8s1ceuBUnMUAeoAHHw,1,0,0,0,0,0,1,0,1,0.14285714285714285,1,0.0,0,0,0,0,0,0,0,1,0,0,1,0
426,9869,0RNr6P08D2zaPSoifoE3KvUeNCFcBSvA,SpATywNh6bZuzm8s1ceuBUnMUAeoAHHw,3,2,1,0,0,0,1,0,4,0.5714285714285714,1,0.0,0,1,0,0,2,0,0,1,0,1,3,0
427,9873,u4s0SPiIkynucY7ReF58TL89R2q4zw1x,SpATywNh6bZuzm8s1ceuBUnMUAeoAHHw,5,3,2,0,1,0,1,0,7,1.0,1,0.0,0,2,0,1,3,0,0,1,0,3,4,1
428,9904,OfMabADNCpK7MfQ7IaqBsUw8RvPeHL0S,RXDvfPUBYFlVdlueBFbLW0mhhAyGEqpt,1,0,0,0,0,0,1,0,1,0.14285714285714285,1,0.0,0,0,0,0,0,0,0,1,0,0,1,0
429,9929,oaL3pbpAfEH9L4o42G6X4xjme1kXt2tm,SpATywNh6bZuzm8s1ceuBUnMUAeoAHHw,9,12,8,0,2,0,1,0,23,3.2857142857142856,1,0.0,2,8,0,2,10,0,0,1,0,12,11,0
430,9943,KXKbDyPytrUZAnNaQjyZgMFkA2w3Wpvj,SpATywNh6bZuzm8s1ceuBUnMUAeoAHHw,16,24,15,8,8,50,17,1,123,17.571428571428573,4,0.0,4,15,7,8,20,50,1,17,1,34,89,1
431,9946,Jd5OP6GIsguRdsq9k3eSYNENmzhPbdGe,G8EPVSXsOYB5YQWZGiz1aVq5Pgr2GrQu,3,4,2,0,0,0,2,0,8,1.1428571428571428,2,0.0,0,2,0,0,4,0,0,2,0,2,6,0
432,9949,IUn6MADAjAYkGlJisA1WiDvCeNlJd5Xd,SpATywNh6bZuzm8s1ceuBUnMUAeoAHHw,3,2,1,0,0,0,2,0,5,0.7142857142857143,2,0.0,0,1,0,0,2,0,0,2,0,1,4,0
433,9953,KeGByI8uvXcUVBvZaFAzVTfOuPfjSv5Y,SpATywNh6bZuzm8s1ceuBUnMUAeoAHHw,4,5,1,0,0,0,1,0,7,1.0,1,0.0,1,1,0,0,4,0,0,1,0,2,5,1
434,10015,gFtSwrFBdsFWgLyqjSCzwaUhlQmEHgOq,SpATywNh6bZuzm8s1ceuBUnMUAeoAHHw,17,19,12,22,4,0,3,0,60,8.571428571428571,3,0.0,4,12,21,4,15,0,1,3,0,41,19,0
435,10016,5z0TnHJcRYhCDHjnNu4kmaWirO8lucwr,SpATywNh6bZuzm8s1ceuBUnMUAeoAHHw,1,0,0,0,0,0,2,0,2,0.2857142857142857,1,0.0,0,0,0,0,0,0,0,2,0,0,2,1
436,10025,SozAkRr5kfRi3urQaoczmRXQoW70onBa,A3fsA9Zfv1X2fVEQhTw51lKENdNrEqT3,15,25,0,0,0,0,3,0,28,4.0,1,0.0,0,0,0,0,25,0,0,3,0,0,28,1
437,10035,FELnhQR0c7GZZX82ioYJEZsqujOrfyf7,A3fsA9Zfv1X2fVEQhTw51lKENdNrEqT3,3,2,1,0,0,4,2,0,9,1.2857142857142858,1,0.0,0,1,0,0,2,4,0,2,0,1,8,1
438,10059,UOOsauq1lFlLECbNF7MRjSfLxlpKxsoG,SpATywNh6bZuzm8s1ceuBUnMUAeoAHHw,1,0,0,0,0,0,2,0,2,0.2857142857142857,2,0.0,0,0,0,0,0,0,0,2,0,0,2,0
439,10062,e0buQlxlHVWdQd03EOAehldJOI8AeFTm,SpATywNh6bZuzm8s1ceuBUnMUAeoAHHw,7,14,4,0,0,0,11,0,29,4.142857142857143,3,0.0,1,4,0,0,13,0,0,11,0,5,24,1
440,10101,30Velr3UVYghs85WZNOKXFcrgzOgBsfI,SpATywNh6bZuzm8s1ceuBUnMUAeoAHHw,5,0,0,0,0,3,4,0,7,1.0,1,0.0,0,0,0,0,0,3,0,4,0,0,7,0
441,10123,pAxOMca5gwJLembsUpWhZwow68Ox9dFB,SpATywNh6bZuzm8s1ceuBUnMUAeoAHHw,4,2,1,0,0,0,2,0,5,0.7142857142857143,1,0.0,0,1,0,0,2,0,0,2,0,1,4,0
442,10132,ILMhPMpEir8VP8Uy0NQI7guQFniKAiGh,SpATywNh6bZuzm8s1ceuBUnMUAeoAHHw,4,6,0,0,0,0,6,0,12,1.7142857142857142,3,0.0,0,0,0,0,6,0,0,6,0,0,12,0
443,10149,KG1VMsurgFKqkMv9nVqkO9ppjva59kYw,SpATywNh6bZuzm8s1ceuBUnMUAeoAHHw,5,4,2,0,0,0,2,0,8,1.1428571428571428,1,0.0,1,2,0,0,3,0,0,2,0,3,5,0
444,10173,ewZzdypyl0fDIzKshXnlZXjyO7oizoCq,SpATywNh6bZuzm8s1ceuBUnMUAeoAHHw,1,0,0,0,0,0,1,0,1,0.14285714285714285,1,0.0,0,0,0,0,0,0,0,1,0,0,1,1
445,10183,rf43ZHojMqXQ775bmX3nnHgQ62d9XvGK,SpATywNh6bZuzm8s1ceuBUnMUAeoAHHw,1,0,0,0,0,0,2,0,2,0.2857142857142857,2,0.0,0,0,0,0,0,0,0,2,0,0,2,1
446,10188,2rS9ufrltSIJVkQHjlKCjTvqcoR7anzz,A3fsA9Zfv1X2fVEQhTw51lKENdNrEqT3,18,19,9,0,3,0,8,0,39,5.571428571428571,3,0.0,0,9,0,3,19,0,0,8,0,12,27,1
447,10189,sY8CcZG79KJSl2UAc47IiYJD1k5ghqCN,SpATywNh6bZuzm8s1ceuBUnMUAeoAHHw,5,5,3,0,1,0,2,0,11,1.5714285714285714,2,0.0,0,3,0,1,5,0,0,2,0,4,7,1
448,10197,tqvOTiQbipkIXQL7CIR5dckxV83rng9S,SpATywNh6bZuzm8s1ceuBUnMUAeoAHHw,11,12,9,0,8,0,2,0,31,4.428571428571429,3,0.0,0,9,0,8,12,0,0,2,0,17,14,0
449,10201,MB156dsmOWVhw7SmCPNYcmBUK9V54bIt,SpATywNh6bZuzm8s1ceuBUnMUAeoAHHw,9,15,1,0,1,0,2,0,19,2.7142857142857144,1,0.0,5,1,0,1,10,0,0,2,0,7,12,1
450,10217,VWRhwnsbyy7kINpd5Pldlp01a86tVlAt,SpATywNh6bZuzm8s1ceuBUnMUAeoAHHw,18,33,14,11,5,0,8,3,74,10.571428571428571,1,0.0,12,14,10,5,21,0,1,8,3,41,33,0
451,10220,L4Uo99RvQ1cxFdSSaMag731dHicuHxV2,SpATywNh6bZuzm8s1ceuBUnMUAeoAHHw,1,0,0,0,0,0,1,0,1,0.14285714285714285,1,0.0,0,0,0,0,0,0,0,1,0,0,1,0
452,10243,YdCaKimqYb8kuFiHEtjPDsCbtIch1tfO,SpATywNh6bZuzm8s1ceuBUnMUAeoAHHw,5,10,5,0,0,0,5,0,20,2.857142857142857,2,0.0,1,5,0,0,9,0,0,5,0,6,14,0
453,10266,8Q42Hi4bJP7SqbH4XystURHk2B8tBI5i,G8EPVSXsOYB5YQWZGiz1aVq5Pgr2GrQu,11,9,4,0,4,0,2,0,19,2.7142857142857144,2,0.0,0,4,0,4,9,0,0,2,0,8,11,0
454,10345,cRvonGDWMKfxHYP6TdkGqL61F16M4yAA,SpATywNh6bZuzm8s1ceuBUnMUAeoAHHw,11,13,0,0,2,2,2,0,19,2.7142857142857144,1,0.0,2,0,0,2,11,2,0,2,0,4,15,1
455,10385,4SjsVB9NX97jh5FCSnOdHgEUANJ1svZm,SpATywNh6bZuzm8s1ceuBUnMUAeoAHHw,9,4,3,0,1,0,8,1,17,2.4285714285714284,1,0.0,0,3,0,1,4,0,0,8,1,4,13,0
456,10394,EF3EfvSrA0c1KnpZ3bhY87a1rscondwY,SpATywNh6bZuzm8s1ceuBUnMUAeoAHHw,3,2,0,0,0,0,3,0,5,0.7142857142857143,1,0.0,0,0,0,0,2,0,0,3,0,0,5,0
457,10402,CQOn4KWCA0duDCOSP1DQzvXZ3yAfq1zW,RXDvfPUBYFlVdlueBFbLW0mhhAyGEqpt,4,3,2,0,0,0,1,0,6,0.8571428571428571,1,0.0,0,2,0,0,3,0,0,1,0,2,4,0
458,10454,6tpE26inQQeNPyhZ0HoRMm7l4NlMiWJC,SpATywNh6bZuzm8s1ceuBUnMUAeoAHHw,7,6,1,14,0,0,1,0,22,3.142857142857143,1,0.0,2,1,13,0,4,0,1,1,0,16,6,0
459,10471,l7T8dOWG1cEtOxAxVcD5zNV6vn1g4oYM,G8EPVSXsOYB5YQWZGiz1aVq5Pgr2GrQu,21,34,3,34,2,0,9,0,82,11.714285714285714,3,0.0,8,3,32,2,26,0,2,9,0,45,37,1
460,10507,rf43ZHojMqXQ775bmX3nnHgQ62d9XvGK,bWdj2GDclj5ofokWjzoa5jAwMkxCykd6,3,2,1,0,0,0,2,0,5,0.7142857142857143,1,0.0,0,1,0,0,2,0,0,2,0,1,4,0
461,10525,w8NGfLpAxSvlcPdxr1N6ClRtnCD7UkJu,A3fsA9Zfv1X2fVEQhTw51lKENdNrEqT3,33,15,4,82,2,4,11,1,119,17.0,2,0.0,1,4,70,2,14,4,12,11,1,77,42,0
462,10563,IQCtPVNPylpjpNjZtQrr88vV5qPansN0,SpATywNh6bZuzm8s1ceuBUnMUAeoAHHw,5,6,4,0,0,0,2,0,12,1.7142857142857142,1,0.0,0,4,0,0,6,0,0,2,0,4,8,0
463,10569,54BZa2PEVowNqI6EO6NzeCnkR49ry3oS,SpATywNh6bZuzm8s1ceuBUnMUAeoAHHw,7,7,0,2,0,0,3,0,12,1.7142857142857142,2,0.0,0,0,1,0,7,0,1,3,0,1,11,0
464,10574,NFgPnsok64XIrx8pioLRAIHoliaoDIvn,SpATywNh6bZuzm8s1ceuBUnMUAeoAHHw,5,16,4,0,0,0,1,0,21,3.0,1,0.0,9,4,0,0,7,0,0,1,0,13,8,0
465,10612,BTSZE2PXdA7MkOyBKPCnqqHRa0lxJtHO,SpATywNh6bZuzm8s1ceuBUnMUAeoAHHw,3,2,1,0,0,0,2,0,5,0.7142857142857143,2,0.0,0,1,0,0,2,0,0,2,0,1,4,0
466,10629,okYlHVritwXcHhkiNLd9pfhBZv2uubiO,SpATywNh6bZuzm8s1ceuBUnMUAeoAHHw,1,0,0,0,0,0,1,0,1,0.14285714285714285,1,0.0,0,0,0,0,0,0,0,1,0,0,1,1
467,10652,teqJGecOr4a6oVYU1O9bgvPkX5ZSKA8N,SpATywNh6bZuzm8s1ceuBUnMUAeoAHHw,3,2,1,0,0,0,1,0,4,0.5714285714285714,1,0.0,0,1,0,0,2,0,0,1,0,1,3,0
468,10653,7xJbwgQFzeH69YJLbZncWAGT3dRrKubC,bWdj2GDclj5ofokWjzoa5jAwMkxCykd6,51,102,53,149,27,9,37,3,380,54.285714285714285,3,0.0,29,53,126,27,73,9,23,37,3,235,145,0
469,10705,CeupRRMHE9iQJGvyrBKaDsPPM9lhEl5t,SpATywNh6bZuzm8s1ceuBUnMUAeoAHHw,1,0,0,0,0,0,1,0,1,0.14285714285714285,1,0.0,0,0,0,0,0,0,0,1,0,0,1,0
470,10809,gzv7fk7jLAAb6tXwbmA5ceisqqnvcETz,SpATywNh6bZuzm8s1ceuBUnMUAeoAHHw,5,5,3,0,0,0,4,0,12,1.7142857142857142,1,0.0,0,3,0,0,5,0,0,4,0,3,9,0
471,10819,v21GnAmoo56SIXGBSOh9jDiYo8T7Od29,SpATywNh6bZuzm8s1ceuBUnMUAeoAHHw,3,2,0,0,0,0,1,0,3,0.42857142857142855,1,0.0,0,0,0,0,2,0,0,1,0,0,3,0
472,10822,xYLJB56SVkFUOdT5vN3Qq6OYNlnP0Fjc,RXDvfPUBYFlVdlueBFbLW0mhhAyGEqpt,11,19,7,0,5,0,3,0,34,4.857142857142857,3,0.0,0,7,0,5,19,0,0,3,0,12,22,0
473,10853,2uZ2ZHQBnnVrb5vAtTu1AloVYtZL1MXg,G8EPVSXsOYB5YQWZGiz1aVq5Pgr2GrQu,41,96,35,60,7,0,14,0,212,30.285714285714285,5,0.0,10,35,51,7,86,0,9,14,0,103,109,0
474,10891,L5fA3BAe6FOUhd5mq4cXOYYHxtSuGgKM,SpATywNh6bZuzm8s1ceuBUnMUAeoAHHw,9,10,4,8,0,2,7,0,31,4.428571428571429,2,0.0,4,4,8,0,6,2,0,7,0,16,15,0
475,10955,rieeUlMbLxJ13UbEQlJjvhM4prlyBS6B,SpATywNh6bZuzm8s1ceuBUnMUAeoAHHw,4,5,2,0,0,46,4,0,57,8.142857142857142,3,0.0,0,2,0,0,5,46,0,4,0,2,55,0
476,10990,xxd1UUpRh1yQGgGLMyjshPknKZCNEYlg,A3fsA9Zfv1X2fVEQhTw51lKENdNrEqT3,24,31,16,2,9,5,6,0,69,9.857142857142858,3,0.0,1,16,1,9,30,5,1,6,0,27,42,0
477,11001,4vKI2gaXrHATS50fqVyDxXcmRy0MrgJS,bWdj2GDclj5ofokWjzoa5jAwMkxCykd6,5,3,2,0,1,0,1,0,7,1.0,1,0.0,0,2,0,1,3,0,0,1,0,3,4,0
478,11036,0kTYCEXFiuNuYfSpCOb8HIL3aF9nkrGc,SpATywNh6bZuzm8s1ceuBUnMUAeoAHHw,1,0,0,0,0,0,2,0,2,0.2857142857142857,2,0.0,0,0,0,0,0,0,0,2,0,0,2,0
479,11068,E6SywimuBT6ZGpGjcedDyV1LTcQRc9ds,A3fsA9Zfv1X2fVEQhTw51lKENdNrEqT3,1,0,0,0,0,0,1,0,1,0.14285714285714285,1,0.0,0,0,0,0,0,0,0,1,0,0,1,1
480,11087,vrHzQ6JF32OpLCmbxoOSorIkJkRXwSrS,SpATywNh6bZuzm8s1ceuBUnMUAeoAHHw,5,5,1,0,1,0,2,0,9,1.2857142857142858,1,0.0,0,1,0,1,5,0,0,2,0,2,7,1
481,11113,tDwPtwMZBHQrqhm9RKWd7GW4j1pmFbeZ,A3fsA9Zfv1X2fVEQhTw51lKENdNrEqT3,1,0,0,0,0,0,1,0,1,0.14285714285714285,1,0.0,0,0,0,0,0,0,0,1,0,0,1,1
482,11136,iVrbldNmEASAlMSnUTWFx7qcEdScVNde,SpATywNh6bZuzm8s1ceuBUnMUAeoAHHw,3,2,1,0,0,0,1,0,4,0.5714285714285714,1,0.0,0,1,0,0,2,0,0,1,0,1,3,1
483,11163,arCKlRkqmCQRumxhAEQROrAdYVJBCNWo,SpATywNh6bZuzm8s1ceuBUnMUAeoAHHw,1,0,0,0,0,0,1,0,1,0.14285714285714285,1,0.0,0,0,0,0,0,0,0,1,0,0,1,0
484,11179,gryVUwWLvrsNv4F8O3kiEBAQILnJg7OT,SpATywNh6bZuzm8s1ceuBUnMUAeoAHHw,2,0,0,0,0,0,3,0,3,0.42857142857142855,1,0.0,0,0,0,0,0,0,0,3,0,0,3,0
485,11355,Z5t6AGEyADeSVHWZTgBW4lR5XMnM5VWU,SpATywNh6bZuzm8s1ceuBUnMUAeoAHHw,3,2,1,0,0,0,1,0,4,0.5714285714285714,1,0.0,0,1,0,0,2,0,0,1,0,1,3,0
486,11410,YEYkPWHcftKd8bKe1Q9b21lzhv1SChRM,SpATywNh6bZuzm8s1ceuBUnMUAeoAHHw,3,2,1,0,0,0,2,0,5,0.7142857142857143,1,0.0,0,1,0,0,2,0,0,2,0,1,4,1
487,11425,82UlWF6Fm1gkNum7nNbVw0yOV1BUdNoS,bWdj2GDclj5ofokWjzoa5jAwMkxCykd6,21,10,8,46,3,31,2,0,100,14.285714285714286,2,0.0,0,8,39,3,10,31,7,2,0,50,50,0
488,11428,82UlWF6Fm1gkNum7nNbVw0yOV1BUdNoS,A3fsA9Zfv1X2fVEQhTw51lKENdNrEqT3,53,51,30,118,12,32,19,3,265,37.857142857142854,6,0.0,10,30,90,12,41,32,28,19,3,142,123,0
489,11463,uFcd6yCTniScAvbMiWJYRQ8Du52ubELm,RXDvfPUBYFlVdlueBFbLW0mhhAyGEqpt,1,0,0,0,0,0,1,0,1,0.14285714285714285,1,0.0,0,0,0,0,0,0,0,1,0,0,1,0
490,11475,UJiJ4PvH4qodyDnURbFXyi5LWwaSKUwb,RXDvfPUBYFlVdlueBFbLW0mhhAyGEqpt,6,10,5,0,0,47,18,0,80,11.428571428571429,4,0.0,0,5,0,0,10,47,0,18,0,5,75,0
491,11478,RGf4k3THi4AV4qsAjc1UEOWiIeDYcchf,A3fsA9Zfv1X2fVEQhTw51lKENdNrEqT3,37,40,21,78,4,0,12,0,155,22.142857142857142,5,0.0,4,21,66,4,36,0,12,12,0,95,60,0
492,11492,zKdMAgWBKjA8jF1t74QW0q0ZxGMcvW9t,RXDvfPUBYFlVdlueBFbLW0mhhAyGEqpt,28,16,8,40,6,2,7,0,79,11.285714285714286,1,0.0,4,8,40,6,12,2,0,7,0,58,21,1
493,11509,sQVxVjeT9NfPAT9IdDUsY0RSB3XrvO2y,SpATywNh6bZuzm8s1ceuBUnMUAeoAHHw,3,2,0,0,0,0,4,0,6,0.8571428571428571,2,0.0,0,0,0,0,2,0,0,4,0,0,6,0
494,11515,iIwpETh60BkJfJQJqvWucH2tzh64j0U3,SpATywNh6bZuzm8s1ceuBUnMUAeoAHHw,1,0,0,0,0,0,1,0,1,0.14285714285714285,1,0.0,0,0,0,0,0,0,0,1,0,0,1,0
495,11522,MOJ1BiwMK7lBUiFS9DTwwPvbUWIkdFFP,A3fsA9Zfv1X2fVEQhTw51lKENdNrEqT3,3,5,3,0,0,0,1,0,9,1.2857142857142858,3,0.0,0,3,0,0,5,0,0,1,0,3,6,1
496,11547,NKnL5oTIIxOmPf0Ep5iKaKIecNheR2t7,SpATywNh6bZuzm8s1ceuBUnMUAeoAHHw,22,40,24,4,10,0,4,0,82,11.714285714285714,2,0.0,9,24,4,10,31,0,0,4,0,47,35,0
497,11555,7OkCZWJW1Ow4wpTBUq53amL13pV2vy2v,G8EPVSXsOYB5YQWZGiz1aVq5Pgr2GrQu,13,19,10,0,8,0,5,0,42,6.0,2,0.0,0,10,0,8,19,0,0,5,0,18,24,0
498,11618,FftGEmgyFF5pWtfM0EZJwp0rzcGMH1JL,SpATywNh6bZuzm8s1ceuBUnMUAeoAHHw,1,0,0,0,0,0,2,0,2,0.2857142857142857,1,0.0,0,0,0,0,0,0,0,2,0,0,2,1
499,11636,Y3uwxWCm13Ol5xozrT2GPjOPhBlC2kOq,RXDvfPUBYFlVdlueBFbLW0mhhAyGEqpt,7,4,2,35,0,0,1,0,42,6.0,1,0.0,0,2,32,0,4,0,3,1,0,34,8,1
500,11690,37daqGAbA6x2VvXkiqdWX1nBv2Tqqgte,G8EPVSXsOYB5YQWZGiz1aVq5Pgr2GrQu,10,18,8,0,1,0,3,0,30,4.285714285714286,1,0.0,0,8,0,1,18,0,0,3,0,9,21,0
501,11741,n3cFXGx3rjoPJPOmeF5tlnmkFmFFJI7p,A3fsA9Zfv1X2fVEQhTw51lKENdNrEqT3,3,2,0,0,0,0,2,0,4,0.5714285714285714,2,0.0,0,0,0,0,2,0,0,2,0,0,4,1
502,11811,YRnTGuoAQA7UM3uV59YNXUYN4n1CR9jv,SpATywNh6bZuzm8s1ceuBUnMUAeoAHHw,3,2,1,0,0,0,3,0,6,0.8571428571428571,2,0.0,0,1,0,0,2,0,0,3,0,1,5,0
503,11841,4GMbKnTV7f2uA3paM09GNAdyVnypDTbs,A3fsA9Zfv1X2fVEQhTw51lKENdNrEqT3,24,11,1,66,0,0,4,0,82,11.714285714285714,2,0.0,3,1,62,0,8,0,4,4,0,66,16,0
504,11862,n42jeLyeDpoJPwT1pkhXRyhzHjUnC2KC,SpATywNh6bZuzm8s1ceuBUnMUAeoAHHw,4,4,2,0,0,0,4,0,10,1.4285714285714286,2,0.0,0,2,0,0,4,0,0,4,0,2,8,1
505,11892,QkpDyGn4qqqwpxvXRrFsAsKSrEtfkQJQ,SpATywNh6bZuzm8s1ceuBUnMUAeoAHHw,3,2,1,0,0,0,1,0,4,0.5714285714285714,1,0.0,0,1,0,0,2,0,0,1,0,1,3,0
506,11914,5YO2NGkR6BZ1s4HfeOrLezgFkpBKmNPV,SpATywNh6bZuzm8s1ceuBUnMUAeoAHHw,25,26,21,13,11,0,6,0,77,11.0,2,0.0,1,21,11,11,25,0,2,6,0,44,33,0
507,11917,uuxrUSHn3GpYFneZnY8GpLgr5XiyDABs,A3fsA9Zfv1X2fVEQhTw51lKENdNrEqT3,15,14,12,0,7,0,4,0,37,5.285714285714286,1,0.0,0,12,0,7,14,0,0,4,0,19,18,0
508,11921,JERgMmFADxaPxEUdcYHhaMN4ZwNAyErv,A3fsA9Zfv1X2fVEQhTw51lKENdNrEqT3,3,5,2,0,0,0,3,0,10,1.4285714285714286,2,0.0,0,2,0,0,5,0,0,3,0,2,8,0
509,11922,gKme5KJOgqJrjNwDUsRPKwK3QFyN7vPD,RXDvfPUBYFlVdlueBFbLW0mhhAyGEqpt,20,29,15,31,11,0,3,0,89,12.714285714285714,2,0.0,11,15,30,11,18,0,1,3,0,67,22,0
510,11977,JtbtRyqX4dZ0edFKFJwGNY9JG3aidrlj,SpATywNh6bZuzm8s1ceuBUnMUAeoAHHw,6,4,2,0,0,0,8,0,14,2.0,2,0.0,0,2,0,0,4,0,0,8,0,2,12,0
511,12011,q36eiA77bwwsXGg05ifhgnTFDpR9Ar4V,bWdj2GDclj5ofokWjzoa5jAwMkxCykd6,18,20,10,22,4,10,6,1,73,10.428571428571429,3,0.0,7,10,18,4,13,10,4,6,1,39,34,0
512,12053,7m381KBoEq7nybFxitllQlgHOa7YYR1i,SpATywNh6bZuzm8s1ceuBUnMUAeoAHHw,9,12,3,0,1,0,3,0,19,2.7142857142857144,2,0.0,0,3,0,1,12,0,0,3,0,4,15,0
513,12141,4n0eavxCNp4F6LlqtEg5gsmyBVEbRBeE,G8EPVSXsOYB5YQWZGiz1aVq5Pgr2GrQu,6,5,2,2,1,0,1,0,11,1.5714285714285714,1,0.0,1,2,2,1,4,0,0,1,0,6,5,1
514,12147,VJw4zFdkpwcu4sXr2e3LyD2CU2ajLhIu,SpATywNh6bZuzm8s1ceuBUnMUAeoAHHw,7,5,3,2,0,0,6,0,16,2.2857142857142856,2,0.0,0,3,1,0,5,0,1,6,0,4,12,0
515,12293,UxPdjVFzcqqJoB99RNTW4pwswAcQ32eZ,RXDvfPUBYFlVdlueBFbLW0mhhAyGEqpt,1,0,0,0,0,0,2,0,2,0.2857142857142857,2,0.0,0,0,0,0,0,0,0,2,0,0,2,0
516,12330,9iGaqBGS5kkoXjLd87hUL2eIJMVUVKfU,A3fsA9Zfv1X2fVEQhTw51lKENdNrEqT3,4,3,2,0,0,0,2,0,7,1.0,1,0.0,0,2,0,0,3,0,0,2,0,2,5,0
517,12350,7m381KBoEq7nybFxitllQlgHOa7YYR1i,G8EPVSXsOYB5YQWZGiz1aVq5Pgr2GrQu,9,24,9,0,5,0,2,0,40,5.714285714285714,2,0.0,0,9,0,5,24,0,0,2,0,14,26,1
518,12363,5wKAjfQ5T37M2WWxYAwMeUeLhDScm1Z0,bWdj2GDclj5ofokWjzoa5jAwMkxCykd6,2,0,0,0,0,6,1,0,7,1.0,1,0.0,0,0,0,0,0,6,0,1,0,0,7,0
519,12383,7OkCZWJW1Ow4wpTBUq53amL13pV2vy2v,SpATywNh6bZuzm8s1ceuBUnMUAeoAHHw,7,3,0,0,0,19,4,1,27,3.857142857142857,1,0.0,0,0,0,0,3,19,0,4,1,0,27,0
520,12410,wXFfHtwd9smrvhh9NQW7SmEEo1001LDW,A3fsA9Zfv1X2fVEQhTw51lKENdNrEqT3,11,6,4,0,1,8,7,3,29,4.142857142857143,1,0.0,0,4,0,1,6,8,0,7,3,5,24,1
521,12412,s24Qk0ZpAXR97ldBDtgP8DE6rT8or69U,SpATywNh6bZuzm8s1ceuBUnMUAeoAHHw,4,12,2,0,0,0,2,0,16,2.2857142857142856,2,0.0,0,2,0,0,12,0,0,2,0,2,14,0
522,12445,CqxK3XGagGgLgWXJIkp8qfeo0SWv94XW,RXDvfPUBYFlVdlueBFbLW0mhhAyGEqpt,3,2,1,0,0,0,1,0,4,0.5714285714285714,1,0.0,0,1,0,0,2,0,0,1,0,1,3,0
523,12464,NSrMJ69WS92LaJ6a09xOpViELCrjji8S,SpATywNh6bZuzm8s1ceuBUnMUAeoAHHw,4,4,2,0,0,0,3,0,9,1.2857142857142858,2,0.0,0,2,0,0,4,0,0,3,0,2,7,0
524,12580,kB76SiSV4uYN77hHUOgf3IbLpFWkgJbj,SpATywNh6bZuzm8s1ceuBUnMUAeoAHHw,3,2,1,0,0,0,2,0,5,0.7142857142857143,1,0.0,0,1,0,0,2,0,0,2,0,1,4,0
525,12588,XQTN1LOe7iul8RvZ4acTOpEntRORT1SG,SpATywNh6bZuzm8s1ceuBUnMUAeoAHHw,1,0,0,0,0,0,1,0,1,0.14285714285714285,1,0.0,0,0,0,0,0,0,0,1,0,0,1,1
526,12616,gLKRPeA7yYfxDrcYMLyblT6wVEjgwKPH,SpATywNh6bZuzm8s1ceuBUnMUAeoAHHw,1,0,0,0,0,0,2,0,2,0.2857142857142857,2,0.0,0,0,0,0,0,0,0,2,0,0,2,0
527,12620,LxV8BE7SALs1WsK81jAFnmtwnc7yS8ck,G8EPVSXsOYB5YQWZGiz1aVq5Pgr2GrQu,10,14,8,0,2,0,3,0,27,3.857142857142857,2,0.0,2,8,0,2,12,0,0,3,0,12,15,1
528,12649,TexDHGk8F5I6X0NlqVQwzJ9MMWpLdMbB,SpATywNh6bZuzm8s1ceuBUnMUAeoAHHw,3,4,2,0,0,0,2,0,8,1.1428571428571428,2,0.0,0,2,0,0,4,0,0,2,0,2,6,0
529,12667,h1g6Jk0YES6cZKnPtmszwjPCneFTGd3j,bWdj2GDclj5ofokWjzoa5jAwMkxCykd6,5,2,1,0,0,0,4,1,8,1.1428571428571428,1,0.0,0,1,0,0,2,0,0,4,1,1,7,1
530,12682,I19aG6zmdTntoy0T8VxEogbN4WVEZZNa,SpATywNh6bZuzm8s1ceuBUnMUAeoAHHw,22,32,2,28,0,0,4,0,66,9.428571428571429,2,0.0,12,2,26,0,20,0,2,4,0,40,26,1
531,12707,Hr9mm3bIoeLv4wyDeAcwJNdd3K6mgRy4,SpATywNh6bZuzm8s1ceuBUnMUAeoAHHw,3,2,1,0,0,0,1,0,4,0.5714285714285714,1,0.0,0,1,0,0,2,0,0,1,0,1,3,0
532,12735,KBt3gvTJLTIjt4EkmG3y3LICooEML1xW,G8EPVSXsOYB5YQWZGiz1aVq5Pgr2GrQu,32,38,23,26,12,0,12,2,113,16.142857142857142,2,0.0,11,23,19,12,27,0,7,12,2,65,48,1
533,12742,arTGhRrKZksM4iY72XDJ8i8oBmMABS0m,SpATywNh6bZuzm8s1ceuBUnMUAeoAHHw,1,0,0,0,0,0,2,0,2,0.2857142857142857,2,0.0,0,0,0,0,0,0,0,2,0,0,2,0
534,12745,rRt0QHymEdl6Kph5VPgdVUvepB7ZBNXt,SpATywNh6bZuzm8s1ceuBUnMUAeoAHHw,16,29,11,11,6,0,4,0,61,8.714285714285714,2,0.0,6,11,10,6,23,0,1,4,0,33,28,0
535,12750,i67qzouvUD7nINgK6d1xrH4pvufZqbFd,SpATywNh6bZuzm8s1ceuBUnMUAeoAHHw,1,0,0,0,0,0,1,0,1,0.14285714285714285,1,0.0,0,0,0,0,0,0,0,1,0,0,1,0
536,12753,79Po0Awyh8Z7ruF9y6agajWClv9uUoPL,SpATywNh6bZuzm8s1ceuBUnMUAeoAHHw,22,29,2,15,1,0,4,0,51,7.285714285714286,3,0.0,6,2,15,1,23,0,0,4,0,24,27,1
537,12834,ZYxocA1Ix9ILa1C9VKK1bM1W4sEOXUVw,SpATywNh6bZuzm8s1ceuBUnMUAeoAHHw,5,4,0,0,0,0,1,0,5,0.7142857142857143,1,0.0,0,0,0,0,4,0,0,1,0,0,5,0
538,12892,P0uW8e7uWJsgVO5MWg1krlEvXljM181Y,bWdj2GDclj5ofokWjzoa5jAwMkxCykd6,5,3,1,0,0,0,4,0,8,1.1428571428571428,2,0.0,0,1,0,0,3,0,0,4,0,1,7,1
539,12948,f7pgA2Hp0s8DkqzKuvE0Kw8QRuoBh3Zv,A3fsA9Zfv1X2fVEQhTw51lKENdNrEqT3,15,7,3,32,0,0,2,0,44,6.285714285714286,1,0.0,3,3,27,0,4,0,5,2,0,33,11,0
540,12956,lEIFkqeT396JMSPUyiaHNMN8g7bQ1x9p,SpATywNh6bZuzm8s1ceuBUnMUAeoAHHw,2,0,0,0,0,0,4,0,4,0.5714285714285714,3,0.0,0,0,0,0,0,0,0,4,0,0,4,0
541,12976,KpbHdGVlZIWVraCiFee7Cav2rNnqqrsJ,SpATywNh6bZuzm8s1ceuBUnMUAeoAHHw,4,4,3,0,0,0,2,0,9,1.2857142857142858,1,0.0,0,3,0,0,4,0,0,2,0,3,6,1
542,12993,8r4M2l7ATXMXEQUCAknekZVeyUGIpRyK,SpATywNh6bZuzm8s1ceuBUnMUAeoAHHw,5,4,0,0,0,0,5,0,9,1.2857142857142858,2,0.0,0,0,0,0,4,0,0,5,0,0,9,1
543,13023,MAktGJIumyskhJp25e79u9tVhauVJ2c6,SpATywNh6bZuzm8s1ceuBUnMUAeoAHHw,8,5,0,0,0,13,9,0,27,3.857142857142857,1,0.0,0,0,0,0,5,13,0,9,0,0,27,0
544,13135,nF3fyodzvP9Kt8uvHxBDafFDSHuZ38jd,SpATywNh6bZuzm8s1ceuBUnMUAeoAHHw,1,0,0,0,0,0,2,0,2,0.2857142857142857,2,0.0,0,0,0,0,0,0,0,2,0,0,2,1
545,13143,igeK6rUQT7Ehyj7yY5oAEj8DvOITiuBO,SpATywNh6bZuzm8s1ceuBUnMUAeoAHHw,4,19,3,0,0,0,6,0,28,4.0,3,0.0,0,3,0,0,19,0,0,6,0,3,25,0
546,13147,p9Pgf9XUtcr2kL39MqLlMakadbFqlUtX,RXDvfPUBYFlVdlueBFbLW0mhhAyGEqpt,10,12,6,22,4,0,1,0,45,6.428571428571429,1,0.0,5,6,17,4,7,0,5,1,0,32,13,1
547,13179,pOKZyBql9SdI7DoREUHq99ghEycAS0cI,bWdj2GDclj5ofokWjzoa5jAwMkxCykd6,4,4,0,0,0,0,1,0,5,0.7142857142857143,1,0.0,0,0,0,0,4,0,0,1,0,0,5,1
548,13207,PMDa1SUjeddLyhfDscbnAxL67GyZb6sD,SpATywNh6bZuzm8s1ceuBUnMUAeoAHHw,3,2,1,0,0,0,1,0,4,0.5714285714285714,1,0.0,0,1,0,0,2,0,0,1,0,1,3,0
549,13227,0wJhtCWK60WPCeRF62m8T80DtNpWhRrg,RXDvfPUBYFlVdlueBFbLW0mhhAyGEqpt,28,56,28,58,13,12,7,0,174,24.857142857142858,4,0.0,6,28,52,13,50,12,6,7,0,99,75,0
550,13240,m52orXncJIuZMWO7LnwS1hFqDU5X5m24,SpATywNh6bZuzm8s1ceuBUnMUAeoAHHw,1,0,0,0,0,0,1,0,1,0.14285714285714285,1,0.0,0,0,0,0,0,0,0,1,0,0,1,0
551,13259,KovPBJesZmgqVCWR3DXdtvcd4XyHL9BT,SpATywNh6bZuzm8s1ceuBUnMUAeoAHHw,11,13,0,10,0,0,9,0,32,4.571428571428571,2,0.0,2,0,9,0,11,0,1,9,0,11,21,0
552,13273,bKbwS8bsj3eNxoCQcsrg5SKpHAoJ8uGu,A3fsA9Zfv1X2fVEQhTw51lKENdNrEqT3,2,2,0,0,0,0,0,0,2,0.2857142857142857,1,0.0,0,0,0,0,2,0,0,0,0,0,2,1
553,13338,UidTeyEs50r1zTQVJtstLvLcMUKrNN3b,SpATywNh6bZuzm8s1ceuBUnMUAeoAHHw,12,12,1,6,1,0,4,0,24,3.4285714285714284,3,0.0,2,1,6,1,10,0,0,4,0,10,14,0
554,13358,Aw7PeIkLW9CDHbPpPSjrFUdtBaUuHUXm,bWdj2GDclj5ofokWjzoa5jAwMkxCykd6,15,9,6,20,5,0,11,0,51,7.285714285714286,3,0.0,3,6,16,5,6,0,4,11,0,30,21,0
555,13398,bqWpav7ocOhCfb3xc4QgAvBDK5g8BmiZ,SpATywNh6bZuzm8s1ceuBUnMUAeoAHHw,3,2,1,0,0,0,1,0,4,0.5714285714285714,1,0.0,0,1,0,0,2,0,0,1,0,1,3,0
556,13402,mGb99e4ZiyyEapZp3B98Pssar5eWGHEz,G8EPVSXsOYB5YQWZGiz1aVq5Pgr2GrQu,11,10,1,18,1,0,1,0,31,4.428571428571429,1,0.0,1,1,16,1,9,0,2,1,0,19,12,1
557,13430,j0gxXks7DZitzyeEGG2agLKFp30HqXVu,bWdj2GDclj5ofokWjzoa5jAwMkxCykd6,7,21,9,0,1,0,1,0,32,4.571428571428571,1,0.0,3,9,0,1,18,0,0,1,0,13,19,0
558,13469,OLmaTq1VRWq8uhF6WwamKt59rXmIqMgh,SpATywNh6bZuzm8s1ceuBUnMUAeoAHHw,5,3,2,0,1,0,1,0,7,1.0,1,0.0,0,2,0,1,3,0,0,1,0,3,4,1
559,13479,sfuANiSFq72qS7aoKnyvPaRtXw7bLFiY,SpATywNh6bZuzm8s1ceuBUnMUAeoAHHw,3,2,1,0,0,0,1,0,4,0.5714285714285714,1,0.0,0,1,0,0,2,0,0,1,0,1,3,1
560,13491,KKBYOCb35hszQy5vSfsxbAFYFgilEECF,SpATywNh6bZuzm8s1ceuBUnMUAeoAHHw,4,2,1,0,0,0,3,0,6,0.8571428571428571,1,0.0,0,1,0,0,2,0,0,3,0,1,5,1
561,13518,OcFLLEI56U80V98vNeJ7LrlE5FWxkkpp,SpATywNh6bZuzm8s1ceuBUnMUAeoAHHw,1,0,0,0,0,0,1,0,1,0.14285714285714285,1,0.0,0,0,0,0,0,0,0,1,0,0,1,0
562,13530,7dPYuxC1NExRQjXFHnhWbTviIyBFUDmL,SpATywNh6bZuzm8s1ceuBUnMUAeoAHHw,2,1,1,0,0,0,0,0,2,0.2857142857142857,1,0.0,0,1,0,0,1,0,0,0,0,1,1,1
563,13594,sZYvW7O1yC1PAj5iYABgZ056jCM2PsNq,SpATywNh6bZuzm8s1ceuBUnMUAeoAHHw,4,7,4,0,0,0,5,0,16,2.2857142857142856,2,0.0,0,4,0,0,7,0,0,5,0,4,12,0
564,13605,g2crr0D1YRZspeg3aG0QVrkBBPBltTjz,SpATywNh6bZuzm8s1ceuBUnMUAeoAHHw,13,12,3,12,0,5,2,0,34,4.857142857142857,3,0.0,2,3,11,0,10,5,1,2,0,16,18,0
565,13610,r10mjNLAOjkXo9ipKqWrD4Hts48L6lcD,G8EPVSXsOYB5YQWZGiz1aVq5Pgr2GrQu,11,11,7,0,6,0,1,0,25,3.5714285714285716,2,0.0,0,7,0,6,11,0,0,1,0,13,12,0
566,13714,e4xoItGqdt7VvYzxou1Pv23rnKAXXXsC,SpATywNh6bZuzm8s1ceuBUnMUAeoAHHw,5,3,1,0,0,0,2,0,6,0.8571428571428571,1,0.0,0,1,0,0,3,0,0,2,0,1,5,1
567,13764,fdJXQSSucuzaRljy096jXgInnW2TakHQ,SpATywNh6bZuzm8s1ceuBUnMUAeoAHHw,5,5,2,0,0,0,2,0,9,1.2857142857142858,1,0.0,2,2,0,0,3,0,0,2,0,4,5,0
568,13788,xYZJv26kEF7oZiNSoEZMnXHo33iYNlMJ,A3fsA9Zfv1X2fVEQhTw51lKENdNrEqT3,5,3,2,0,0,0,2,0,7,1.0,1,0.0,0,2,0,0,3,0,0,2,0,2,5,1
569,14683,EK8cH2rqaeWCMjTFz8xL65N7r32HerY9,7GRhBDsirIGkRZBtSMEzNTyDr2JQm4xx,31,49,23,26,16,41,5,0,160,22.857142857142858,3,0.0,18,23,21,16,31,41,5,5,0,78,82,0
570,14690,ZbWUV0qkotaaSLhz8iJBNOk5nD7qDeuY,7GRhBDsirIGkRZBtSMEzNTyDr2JQm4xx,17,16,9,4,10,0,3,0,42,6.0,1,0.0,6,9,4,10,10,0,0,3,0,29,13,0
571,14815,IQhh6lXlVmCrcAcXbMrK8pYs2wjQgUqq,7GRhBDsirIGkRZBtSMEzNTyDr2JQm4xx,2,0,0,0,0,29,1,0,30,4.285714285714286,1,0.0,0,0,0,0,0,29,0,1,0,0,30,0
572,14818,UgETwjVUoQXyxwFA12B4jwRDb3R4sQSN,7GRhBDsirIGkRZBtSMEzNTyDr2JQm4xx,12,17,7,12,5,0,2,0,43,6.142857142857143,1,0.0,8,7,10,5,9,0,2,2,0,30,13,1
573,14829,QZIRHdwFgibI2SBehTrmLAZxED1F4JL7,7GRhBDsirIGkRZBtSMEzNTyDr2JQm4xx,20,38,12,12,15,0,2,0,79,11.285714285714286,1,0.0,8,12,10,15,30,0,2,2,0,45,34,1
574,14846,5Xet5BwM6xDYh8pbaupnwmiq9T6jy7TC,7GRhBDsirIGkRZBtSMEzNTyDr2JQm4xx,7,2,2,0,2,0,2,0,8,1.1428571428571428,1,0.0,0,2,0,2,2,0,0,2,0,4,4,1
575,15016,yZ9FndAKqVsKwZtO1B2JJJblefdbhZ02,7GRhBDsirIGkRZBtSMEzNTyDr2JQm4xx,12,8,0,8,0,18,9,0,43,6.142857142857143,1,0.0,2,0,8,0,6,18,0,9,0,10,33,1
576,15017,Qp9WPjKz2PASr9CWx9cGEYZGKd1Nemqr,7GRhBDsirIGkRZBtSMEzNTyDr2JQm4xx,14,19,5,27,0,61,8,0,120,17.142857142857142,1,0.0,14,5,24,0,5,61,3,8,0,43,77,1
577,15107,HFGNqnAY2MWiYF3III5EKx6o7tu1uiwJ,7GRhBDsirIGkRZBtSMEzNTyDr2JQm4xx,26,49,22,15,19,9,4,0,118,16.857142857142858,2,0.0,17,22,13,19,32,9,2,4,0,71,47,1
578,15110,5zX31TZPkBQ4nxGKP7lPYFABTGNW6PHa,7GRhBDsirIGkRZBtSMEzNTyDr2JQm4xx,8,5,3,0,3,2,1,0,14,2.0,1,0.0,1,3,0,3,4,2,0,1,0,7,7,1
579,15164,ziRAzdRuzlLfb854mAvEaRYGuXqnCERH,7GRhBDsirIGkRZBtSMEzNTyDr2JQm4xx,16,15,4,10,5,0,2,0,36,5.142857142857143,1,0.0,7,4,8,5,8,0,2,2,0,24,12,0
580,15178,28PHU9suTM8EqUKsQwsvQ03DzFXi0yDl,7GRhBDsirIGkRZBtSMEzNTyDr2JQm4xx,58,86,26,108,33,14,1,0,268,38.285714285714285,2,0.0,60,26,85,33,26,14,23,1,0,204,64,0
581,15397,iWIAGeS3ATYiVCcaQcig63Lt0fYY4o8o,7GRhBDsirIGkRZBtSMEzNTyDr2JQm4xx,16,19,11,55,2,4,4,0,95,13.571428571428571,1,0.0,4,11,50,2,15,4,5,4,0,67,28,0
582,15445,hrmgRr5TKkTKcJMaNH4IpBZoiQT9X6aI,7GRhBDsirIGkRZBtSMEzNTyDr2JQm4xx,21,51,3,21,16,0,9,0,100,14.285714285714286,4,0.0,35,3,17,16,16,0,4,9,0,71,29,0
583,15484,2OBbYlHxjDvtkcifhxwhxMZlYPhEHOro,7GRhBDsirIGkRZBtSMEzNTyDr2JQm4xx,25,38,3,99,1,0,6,0,147,21.0,4,0.0,19,3,83,1,19,0,16,6,0,106,41,0
584,15541,ILkUjE8LhIAQFlZwnOqsyA4K0QvAbnzA,7GRhBDsirIGkRZBtSMEzNTyDr2JQm4xx,39,175,34,65,26,161,15,1,477,68.14285714285714,7,0.0,107,34,55,26,68,161,10,15,1,222,255,0
585,15577,WeG9Rj8lv2ekdTamRkXPOfgW6N9lzyds,7GRhBDsirIGkRZBtSMEzNTyDr2JQm4xx,13,16,6,10,6,10,4,0,52,7.428571428571429,2,0.0,7,6,8,6,9,10,2,4,0,27,25,1
586,15596,Jag1EXQWfAuTRiCgcVLyhRRkdOL9RtSD,7GRhBDsirIGkRZBtSMEzNTyDr2JQm4xx,4,2,1,0,0,0,2,0,5,0.7142857142857143,1,0.0,0,1,0,0,2,0,0,2,0,1,4,1
587,15634,oco4sYAQqzdnYEwLykTSM4qmOTgkFoAN,7GRhBDsirIGkRZBtSMEzNTyDr2JQm4xx,39,158,58,86,16,10,29,1,358,51.142857142857146,4,0.0,81,58,73,16,77,10,13,29,1,228,130,0
588,15637,syrttArug8Mpzs9L0IHsvBtATawYF9J2,7GRhBDsirIGkRZBtSMEzNTyDr2JQm4xx,7,9,5,0,0,0,2,0,16,2.2857142857142856,2,0.0,2,5,0,0,7,0,0,2,0,7,9,1
589,15783,Jm4nQ05ndX10jbofbWx6S0r9VXrqia6S,7GRhBDsirIGkRZBtSMEzNTyDr2JQm4xx,29,31,12,91,3,0,3,0,140,20.0,2,0.0,12,12,78,3,19,0,13,3,0,105,35,0
590,15812,zTVBZ1zOMswSgDWxrOfzKUr5J9HO6HOE,7GRhBDsirIGkRZBtSMEzNTyDr2JQm4xx,31,61,20,26,10,3,10,0,130,18.571428571428573,4,0.0,18,20,22,10,43,3,4,10,0,70,60,1
591,15836,Ms0MC4W5moiGJLWP7iE3FImeH9CHN4KT,7GRhBDsirIGkRZBtSMEzNTyDr2JQm4xx,9,12,2,0,1,0,2,0,17,2.4285714285714284,2,0.0,3,2,0,1,9,0,0,2,0,6,11,0
592,15867,itOUYtUQXKtiNJoDhHvixGSCtswgEapf,7GRhBDsirIGkRZBtSMEzNTyDr2JQm4xx,9,9,2,2,4,0,0,0,17,2.4285714285714284,1,0.0,6,2,2,4,3,0,0,0,0,14,3,1
593,16009,Slk5JcZSYHmDLQZXaNVmcMDmjJ16kBhI,7GRhBDsirIGkRZBtSMEzNTyDr2JQm4xx,29,96,19,38,11,0,9,0,173,24.714285714285715,4,0.0,43,19,31,11,53,0,7,9,0,104,69,0
594,16095,2WHRUx9c3z0u3SMwexxVlR2sgx8QCphl,7GRhBDsirIGkRZBtSMEzNTyDr2JQm4xx,1,0,0,0,0,0,1,0,1,0.14285714285714285,1,0.0,0,0,0,0,0,0,0,1,0,0,1,1
595,16126,6YaJxva3ruoxqQBNg2zA6CX5WSixFgrI,7GRhBDsirIGkRZBtSMEzNTyDr2JQm4xx,31,62,24,24,20,3,11,0,144,20.571428571428573,3,0.0,29,24,24,20,33,3,0,11,0,97,47,1
596,16137,qG2WjxxVTjr5YeDGnwFvACGaHzeUu9HC,7GRhBDsirIGkRZBtSMEzNTyDr2JQm4xx,35,42,13,9,20,2,10,1,97,13.857142857142858,2,0.0,26,13,9,20,16,2,0,10,1,68,29,1
597,16242,CtBdHmlYqpaYTMEPBvno3lS1o4khTfTp,7GRhBDsirIGkRZBtSMEzNTyDr2JQm4xx,31,26,12,26,13,12,1,0,90,12.857142857142858,1,0.0,13,12,24,13,13,12,2,1,0,62,28,1
598,16326,vEWkXCfBtnzPc8huJqQsoGlEGR1bS2AS,7GRhBDsirIGkRZBtSMEzNTyDr2JQm4xx,10,13,10,0,3,0,2,0,28,4.0,1,0.0,2,10,0,3,11,0,0,2,0,15,13,1
599,16384,DmRnf6emOOeLa4MI9vNggFDmgXu8cRIO,7GRhBDsirIGkRZBtSMEzNTyDr2JQm4xx,64,159,70,121,18,34,38,4,444,63.42857142857143,3,0.0,70,70,102,18,89,34,19,38,4,260,184,0
600,16467,pz4WzmrapGULqEk99lfOZVzJbwiC2Cl1,7GRhBDsirIGkRZBtSMEzNTyDr2JQm4xx,42,112,0,82,8,36,11,5,254,36.285714285714285,3,0.0,52,0,69,8,60,36,13,11,5,129,125,1
601,16473,aPM6Pkx8yXzDO1Wq6YMG1wXnFkTU2WLX,7GRhBDsirIGkRZBtSMEzNTyDr2JQm4xx,21,35,0,18,10,0,2,0,65,9.285714285714286,1,0.0,22,0,14,10,13,0,4,2,0,46,19,1
602,16669,D222lqyFrC2b1DAJCNvtq2cDPE2yWdSh,7GRhBDsirIGkRZBtSMEzNTyDr2JQm4xx,13,19,7,0,7,5,8,4,50,7.142857142857143,2,0.0,8,7,0,7,11,5,0,8,4,22,28,1
603,16792,fbDgsipajp0xhHFfXN21wQyuQBNdN7hy,7GRhBDsirIGkRZBtSMEzNTyDr2JQm4xx,31,28,12,29,16,0,1,0,86,12.285714285714286,1,0.0,14,12,24,16,14,0,5,1,0,66,20,0
604,16987,Ar7wri6od2sIMOfx95hPmMwDttR4wtOC,7GRhBDsirIGkRZBtSMEzNTyDr2JQm4xx,28,41,15,67,5,0,5,0,133,19.0,4,0.0,22,15,60,5,19,0,7,5,0,102,31,0
605,17035,M76ofI2UJItYXeusDRswE1mzVX9YlrVW,7GRhBDsirIGkRZBtSMEzNTyDr2JQm4xx,28,53,18,81,4,0,2,0,158,22.571428571428573,2,0.0,32,18,71,4,21,0,10,2,0,125,33,1
606,17124,xOB7vl3l1Tpb0i0cSWni40BfJ5FBclms,7GRhBDsirIGkRZBtSMEzNTyDr2JQm4xx,12,17,3,10,4,0,2,0,36,5.142857142857143,2,0.0,8,3,8,4,9,0,2,2,0,23,13,0
607,17242,OcmM4lAJy1xB9HSsEUxVtaUQ7oE5dcTp,7GRhBDsirIGkRZBtSMEzNTyDr2JQm4xx,11,32,12,0,9,1,3,0,57,8.142857142857142,2,0.0,0,12,0,9,32,1,0,3,0,21,36,0
608,17485,7fC3V6ivG07wUIMOmiYFzSlyjWvbYnYf,7GRhBDsirIGkRZBtSMEzNTyDr2JQm4xx,27,24,0,80,3,0,4,0,111,15.857142857142858,2,0.0,13,0,67,3,11,0,13,4,0,83,28,0
609,17545,DGDF7EtBLvOTcfUxrOsvdCg2Ar6LlSc6,7GRhBDsirIGkRZBtSMEzNTyDr2JQm4xx,1,0,0,0,0,0,3,0,3,0.42857142857142855,3,0.0,0,0,0,0,0,0,0,3,0,0,3,0
610,17634,UA8vU3s92g3lXc62U363PEO0xor6Mpeg,7GRhBDsirIGkRZBtSMEzNTyDr2JQm4xx,22,17,7,0,14,0,1,0,39,5.571428571428571,1,0.0,9,7,0,14,8,0,0,1,0,30,9,0
611,17673,JSViK46d91E9ikMcvKp1rzZlHAqQuH4h,7GRhBDsirIGkRZBtSMEzNTyDr2JQm4xx,2,4,2,0,0,0,0,0,6,0.8571428571428571,4,0.0,0,2,0,0,4,0,0,0,0,2,4,1
612,19594,4x6w2QLFfXQ2dHDa4fBCOvJ1UYg7yE69,fbPkOYLVPtPgIt0MxizjfFJov3JbHyAi,11,7,4,8,3,0,1,0,23,3.2857142857142856,1,0.0,2,4,5,3,5,0,3,1,0,14,9,1
613,19596,lhkiaYX6n9dxQvsKk8vp6UZQBNlsuGnH,fbPkOYLVPtPgIt0MxizjfFJov3JbHyAi,3,0,0,0,0,0,3,0,3,0.42857142857142855,1,0.0,0,0,0,0,0,0,0,3,0,0,3,0
614,19613,hPhvZr1dLTLTcIKq5t7vAfQqTozZXlRI,fbPkOYLVPtPgIt0MxizjfFJov3JbHyAi,21,20,15,0,11,0,2,0,48,6.857142857142857,2,0.0,0,15,0,11,20,0,0,2,0,26,22,1
615,19637,8MQx62NrM26CEa5RRkhFUh36AiGGNx6S,fbPkOYLVPtPgIt0MxizjfFJov3JbHyAi,9,14,1,0,1,0,3,0,19,2.7142857142857144,2,0.0,0,1,0,1,14,0,0,3,0,2,17,0
616,19662,tvh0r7BXEnkkRFvEGDSaxc2cnDAVPflf,fbPkOYLVPtPgIt0MxizjfFJov3JbHyAi,7,9,1,0,0,0,8,0,18,2.5714285714285716,5,0.0,0,1,0,0,9,0,0,8,0,1,17,1
617,19677,rl1ijjmPoVXrn0BLw0LMwhU2iQWvim3X,fbPkOYLVPtPgIt0MxizjfFJov3JbHyAi,18,15,9,10,5,8,0,0,47,6.714285714285714,2,0.0,5,9,10,5,10,8,0,0,0,29,18,0
618,19680,PLKfIj5PWmJ1pq6F2TAT2ZidBGAMa6pt,fbPkOYLVPtPgIt0MxizjfFJov3JbHyAi,7,4,3,0,0,1,6,0,14,2.0,1,0.0,0,3,0,0,4,1,0,6,0,3,11,1
619,19682,jq3G4vNjVUo5sqAQquCFzqcPQiyiVAd4,fbPkOYLVPtPgIt0MxizjfFJov3JbHyAi,5,8,3,0,0,0,2,0,13,1.8571428571428572,1,0.0,0,3,0,0,8,0,0,2,0,3,10,1
620,19688,RxXRKZYpbfKbF79XwFGwONhlZ3CWNuKc,fbPkOYLVPtPgIt0MxizjfFJov3JbHyAi,4,2,1,0,1,0,1,0,5,0.7142857142857143,1,0.0,0,1,0,1,2,0,0,1,0,2,3,1
621,19697,94kd1qvIZ0nokZPS6BCV8qxXnL5MM2jB,fbPkOYLVPtPgIt0MxizjfFJov3JbHyAi,22,75,34,14,23,2,11,0,159,22.714285714285715,3,0.0,15,34,14,23,60,2,0,11,0,86,73,0
622,19710,2mdoNlBiXpgUVSmoihAheHl3NISmi738,fbPkOYLVPtPgIt0MxizjfFJov3JbHyAi,48,60,39,17,16,1,17,1,151,21.571428571428573,1,0.0,11,39,16,16,49,1,1,17,1,82,69,1
623,19734,PwwEqEv3o1wfWN5Eu8NuK3q82yRAO9LK,fbPkOYLVPtPgIt0MxizjfFJov3JbHyAi,9,4,3,0,3,0,2,0,12,1.7142857142857142,1,0.0,0,3,0,3,4,0,0,2,0,6,6,1
624,19749,0artPLh8IkCTAf124kxiUrz2J9bSLV97,fbPkOYLVPtPgIt0MxizjfFJov3JbHyAi,5,5,3,0,1,0,3,0,12,1.7142857142857142,2,0.0,0,3,0,1,5,0,0,3,0,4,8,1
625,19761,2ZVrSpja22JYuBdqG7iHOipKnnGEm2ou,fbPkOYLVPtPgIt0MxizjfFJov3JbHyAi,5,5,2,0,0,3,3,0,13,1.8571428571428572,2,0.0,0,2,0,0,5,3,0,3,0,2,11,0
626,19764,IHJGcg8XuB6HPRBrjHVn1eWwbgo7JSEZ,fbPkOYLVPtPgIt0MxizjfFJov3JbHyAi,25,21,11,18,8,0,3,0,61,8.714285714285714,2,0.0,6,11,18,8,15,0,0,3,0,43,18,1
627,19765,oZrYS5rqR18A77jULvm9aJ8bGsP88f4h,fbPkOYLVPtPgIt0MxizjfFJov3JbHyAi,9,14,8,0,1,4,4,0,31,4.428571428571429,3,0.0,0,8,0,1,14,4,0,4,0,9,22,0
628,19770,HneXab7aMQtYruvuxuZ9dNY5QxwlGitq,fbPkOYLVPtPgIt0MxizjfFJov3JbHyAi,14,17,10,12,7,2,3,0,51,7.285714285714286,1,0.0,4,10,9,7,13,2,3,3,0,30,21,1
629,19772,fKgU6PKVjgAnp4uvGa6MHJe7D2ZYaBc1,fbPkOYLVPtPgIt0MxizjfFJov3JbHyAi,21,45,19,17,17,16,5,3,122,17.428571428571427,2,0.0,20,19,13,17,25,16,4,5,3,69,53,1
630,19774,R0JUZ056kzFL6PD0dHwCASPDjJEFALuj,fbPkOYLVPtPgIt0MxizjfFJov3JbHyAi,25,25,13,21,10,3,4,0,76,10.857142857142858,3,0.0,8,13,19,10,17,3,2,4,0,50,26,1
631,19775,tA1lc3vnumj95Nh6FWr8EK0wWDHGYnC2,fbPkOYLVPtPgIt0MxizjfFJov3JbHyAi,14,7,7,0,6,1,2,0,23,3.2857142857142856,1,0.0,0,7,0,6,7,1,0,2,0,13,10,1
632,19787,Uud6ejfxjo2wR9C9pIlBSyKMyMrHfe52,fbPkOYLVPtPgIt0MxizjfFJov3JbHyAi,5,3,2,0,2,2,1,0,10,1.4285714285714286,2,0.0,0,2,0,2,3,2,0,1,0,4,6,1
633,19801,eRM1cqDGfrej4Riud5wVHQPpEv2yAjcd,fbPkOYLVPtPgIt0MxizjfFJov3JbHyAi,6,5,4,0,3,1,0,0,13,1.8571428571428572,1,0.0,0,4,0,3,5,1,0,0,0,7,6,1
634,19805,mulCI7iOK8lLmqauH7xJJcesnUywr862,fbPkOYLVPtPgIt0MxizjfFJov3JbHyAi,1,0,0,0,0,0,1,0,1,0.14285714285714285,1,0.0,0,0,0,0,0,0,0,1,0,0,1,1
635,19808,iv92crQZIzkBMlffqmkcGn935WuSz4il,fbPkOYLVPtPgIt0MxizjfFJov3JbHyAi,12,14,7,0,4,1,9,1,36,5.142857142857143,1,0.0,0,7,0,4,14,1,0,9,1,11,25,1
636,19811,i3UVHHN0j4qIwZlYLBYHJICyHTcdcLCq,fbPkOYLVPtPgIt0MxizjfFJov3JbHyAi,5,2,1,0,1,0,2,0,6,0.8571428571428571,1,0.0,0,1,0,1,2,0,0,2,0,2,4,1
637,19812,mnOHLhQDMWuHBooceLF0rczqDD9bUim8,fbPkOYLVPtPgIt0MxizjfFJov3JbHyAi,7,8,5,0,3,0,3,0,19,2.7142857142857144,2,0.0,1,5,0,3,7,0,0,3,0,9,10,1
638,19813,QBgKSCSCtuy3kameVOAw6Wwz0K2iKBbH,fbPkOYLVPtPgIt0MxizjfFJov3JbHyAi,7,1,1,0,1,0,7,0,10,1.4285714285714286,1,0.0,0,1,0,1,1,0,0,7,0,2,8,1
639,19816,08IVc3h7dXZMEursFSIPoikCC2aZN7Rx,fbPkOYLVPtPgIt0MxizjfFJov3JbHyAi,6,2,1,0,1,0,5,1,10,1.4285714285714286,1,0.0,0,1,0,1,2,0,0,5,1,2,8,1
640,19817,8FipiYFD5ufymfN3QkHjea5yaJKq4FqA,fbPkOYLVPtPgIt0MxizjfFJov3JbHyAi,14,13,7,0,5,0,14,1,40,5.714285714285714,2,0.0,3,7,0,5,10,0,0,14,1,15,25,1
641,19826,HuDb7M7dL9QrDMvQSMZiZjXQu7KASVlk,fbPkOYLVPtPgIt0MxizjfFJov3JbHyAi,1,0,0,0,0,0,1,0,1,0.14285714285714285,1,0.0,0,0,0,0,0,0,0,1,0,0,1,1
642,19830,J19fRobYymSKSws9Yoy23YPes8L6wyrW,fbPkOYLVPtPgIt0MxizjfFJov3JbHyAi,21,20,15,0,9,6,18,3,71,10.142857142857142,3,0.0,0,15,0,9,20,6,0,18,3,24,47,1
643,19831,TuwawmYF5vKqxlkjFW9KLE2z6pGSYesW,fbPkOYLVPtPgIt0MxizjfFJov3JbHyAi,7,3,2,0,2,0,2,0,9,1.2857142857142858,1,0.0,0,2,0,2,3,0,0,2,0,4,5,1
644,19832,5SmzJtCsl9zVvD6aNu6O5oGjHDZpcVHV,fbPkOYLVPtPgIt0MxizjfFJov3JbHyAi,5,3,2,0,0,1,3,1,10,1.4285714285714286,1,0.0,0,2,0,0,3,1,0,3,1,2,8,1
645,19835,ERdNSLuXe4QWBWuCUcfh6NqIoQCrGXv1,fbPkOYLVPtPgIt0MxizjfFJov3JbHyAi,23,21,10,19,10,0,2,0,62,8.857142857142858,3,0.0,7,10,15,10,14,0,4,2,0,42,20,1
646,19837,iPJRBluqQatkmbuqumnMGE3SRxlXa7A1,fbPkOYLVPtPgIt0MxizjfFJov3JbHyAi,1,0,0,0,0,0,1,0,1,0.14285714285714285,1,0.0,0,0,0,0,0,0,0,1,0,0,1,1
647,19839,dsDDZP1tTIurmngds776Mxkx99B7QaoD,fbPkOYLVPtPgIt0MxizjfFJov3JbHyAi,8,7,5,0,4,0,3,0,19,2.7142857142857144,2,0.0,0,5,0,4,7,0,0,3,0,9,10,1
648,19845,FOhKzePMHLals6J3nHBPn1VH8EqTuIWc,fbPkOYLVPtPgIt0MxizjfFJov3JbHyAi,7,3,2,0,2,0,6,0,13,1.8571428571428572,2,0.0,0,2,0,2,3,0,0,6,0,4,9,1
649,19846,3mL78JhEm154Hwp0XQW8ZVuzbvUw5uCk,fbPkOYLVPtPgIt0MxizjfFJov3JbHyAi,4,2,1,0,0,0,3,0,6,0.8571428571428571,1,0.0,0,1,0,0,2,0,0,3,0,1,5,1
650,19848,VZNenETJcretQ75QoBMXgygqhUZNWX9e,fbPkOYLVPtPgIt0MxizjfFJov3JbHyAi,7,6,2,0,1,0,2,0,11,1.5714285714285714,1,0.0,0,2,0,1,6,0,0,2,0,3,8,1
651,19856,cNw6DSimidnnJTy63mT8fC6ow4HuQb5s,fbPkOYLVPtPgIt0MxizjfFJov3JbHyAi,18,18,8,5,7,4,4,1,47,6.714285714285714,1,0.0,9,8,5,7,9,4,0,4,1,29,18,0
652,19858,j0qtw4MyzPS0BrZiuGQy55Y9HiEw9Wyz,fbPkOYLVPtPgIt0MxizjfFJov3JbHyAi,7,7,2,0,2,0,7,0,18,2.5714285714285716,2,0.0,0,2,0,2,7,0,0,7,0,4,14,1
653,19862,jWsLxS98Uf5iPgurn9PRvQM3beT2rSkF,fbPkOYLVPtPgIt0MxizjfFJov3JbHyAi,2,0,0,0,0,0,3,0,3,0.42857142857142855,1,0.0,0,0,0,0,0,0,0,3,0,0,3,1
654,19863,cL4725Y58Cl01IjeOv5CCdtpjNF0EqJp,fbPkOYLVPtPgIt0MxizjfFJov3JbHyAi,1,0,0,0,0,0,1,0,1,0.14285714285714285,1,0.0,0,0,0,0,0,0,0,1,0,0,1,1
655,19864,xpAxjSreQEJGjM28FJsQcyiEt1VA8RXl,fbPkOYLVPtPgIt0MxizjfFJov3JbHyAi,24,43,21,10,6,7,8,0,95,13.571428571428571,3,0.0,7,21,10,6,36,7,0,8,0,44,51,0
656,19865,bVTv3LNbSDemleiUP48OewgXg39Jt9HM,fbPkOYLVPtPgIt0MxizjfFJov3JbHyAi,2,0,0,0,0,0,3,0,3,0.42857142857142855,1,0.0,0,0,0,0,0,0,0,3,0,0,3,1
657,19878,iuOmDEhpvOE7SqnGlPzkF3AFhAsHx7fO,fbPkOYLVPtPgIt0MxizjfFJov3JbHyAi,18,30,9,21,6,0,11,0,77,11.0,4,0.0,8,9,17,6,22,0,4,11,0,40,37,1
658,19880,7cdSr9CqRrEGZIWG84xbV4x3Kafz72lh,fbPkOYLVPtPgIt0MxizjfFJov3JbHyAi,2,2,1,0,0,0,0,0,3,0.42857142857142855,1,0.0,0,1,0,0,2,0,0,0,0,1,2,1
659,19881,PW9Md9XLqRR5MZXK4hL3T3H1o4IZAcWS,fbPkOYLVPtPgIt0MxizjfFJov3JbHyAi,5,3,1,0,1,0,2,0,7,1.0,1,0.0,0,1,0,1,3,0,0,2,0,2,5,1
660,19882,bISN9xXdPBM2gxjOPU4uIyceAQnHyeaO,fbPkOYLVPtPgIt0MxizjfFJov3JbHyAi,9,11,3,0,1,0,5,0,20,2.857142857142857,1,0.0,0,3,0,1,11,0,0,5,0,4,16,1
661,19883,oBB4V7EIN8ossAzWm6ldlqIytEJdobH7,fbPkOYLVPtPgIt0MxizjfFJov3JbHyAi,2,0,0,0,0,9,1,0,10,1.4285714285714286,1,0.0,0,0,0,0,0,9,0,1,0,0,10,1
662,19890,IVtvtdZLBtL9DhFAioWkcCx38OrFXpXg,fbPkOYLVPtPgIt0MxizjfFJov3JbHyAi,15,34,13,14,0,11,12,0,84,12.0,4,0.0,13,13,14,0,21,11,0,12,0,40,44,0
663,19891,wgvtQPGwXLcgDRyRFzsNLvjTzjo4pZey,fbPkOYLVPtPgIt0MxizjfFJov3JbHyAi,11,7,4,0,2,1,11,1,26,3.7142857142857144,1,0.0,0,4,0,2,7,1,0,11,1,6,20,1
664,19892,W2otfyc3X4TPBPK1UZBOKMi0pFwInYnb,fbPkOYLVPtPgIt0MxizjfFJov3JbHyAi,8,2,1,0,1,1,5,1,11,1.5714285714285714,1,0.0,0,1,0,1,2,1,0,5,1,2,9,0
665,19899,g1LjBGhO06u71QjhH8AiBdRCV0auffeV,fbPkOYLVPtPgIt0MxizjfFJov3JbHyAi,5,2,1,0,1,0,2,0,6,0.8571428571428571,1,0.0,0,1,0,1,2,0,0,2,0,2,4,1
666,19900,b7PuwalmdIR7gI2f0kgWK9mhLJEyGy0c,fbPkOYLVPtPgIt0MxizjfFJov3JbHyAi,1,0,0,0,0,0,1,0,1,0.14285714285714285,1,0.0,0,0,0,0,0,0,0,1,0,0,1,1
667,19901,d45S9FtiK3JaUn5gt0gBKZnLs0OGVQHt,fbPkOYLVPtPgIt0MxizjfFJov3JbHyAi,18,13,10,0,10,1,7,1,42,6.0,2,0.0,2,10,0,10,11,1,0,7,1,22,20,1
668,19902,WaEPHAZo5pH7Npa5iwnKZ2EJATuLkfKt,fbPkOYLVPtPgIt0MxizjfFJov3JbHyAi,13,13,1,0,1,0,3,0,18,2.5714285714285716,1,0.0,1,1,0,1,12,0,0,3,0,3,15,1
669,19904,C7C4g4nHC5w1aNh5moBHlv2F8Oo4TbRT,fbPkOYLVPtPgIt0MxizjfFJov3JbHyAi,11,8,5,0,4,0,2,0,19,2.7142857142857144,1,0.0,0,5,0,4,8,0,0,2,0,9,10,1
670,19909,eGMQ402zeENVOKkP29KRxs0f1wZX1TvA,fbPkOYLVPtPgIt0MxizjfFJov3JbHyAi,5,4,0,0,0,0,2,0,6,0.8571428571428571,1,0.0,0,0,0,0,4,0,0,2,0,0,6,1
671,19910,1Epnr53yLJpI4d6wSWAUymSv0Yujn22A,fbPkOYLVPtPgIt0MxizjfFJov3JbHyAi,44,77,41,43,27,1,25,0,214,30.571428571428573,4,0.0,25,41,38,27,52,1,5,25,0,131,83,0
672,19911,JZFzammsPtqI96gZi5jjWsT1PaVAEh64,fbPkOYLVPtPgIt0MxizjfFJov3JbHyAi,4,2,1,0,1,0,3,0,7,1.0,1,0.0,0,1,0,1,2,0,0,3,0,2,5,1
673,19913,XbORnKU4LaOdLNHafCieVF22rPhRdsHM,fbPkOYLVPtPgIt0MxizjfFJov3JbHyAi,7,9,5,0,4,0,1,0,19,2.7142857142857144,1,0.0,0,5,0,4,9,0,0,1,0,9,10,1
674,19914,iUELwsAOi144Gv3ZwF4pg4MHhyg4VTy9,fbPkOYLVPtPgIt0MxizjfFJov3JbHyAi,7,3,2,0,2,0,2,0,9,1.2857142857142858,1,0.0,0,2,0,2,3,0,0,2,0,4,5,1
675,19915,qFnFxVZ0kWnoJ6Z9EGCtfX2XIxJ2ju5D,fbPkOYLVPtPgIt0MxizjfFJov3JbHyAi,5,2,1,0,0,0,2,0,5,0.7142857142857143,1,0.0,0,1,0,0,2,0,0,2,0,1,4,0
676,19919,RIeL3dVlafJn0CvzFRWYuhAjPOY5jm6q,fbPkOYLVPtPgIt0MxizjfFJov3JbHyAi,8,9,3,0,2,0,4,0,18,2.5714285714285716,1,0.0,0,3,0,2,9,0,0,4,0,5,13,1
677,19921,3CdjWVi2KulUMxBQEG35wDbgAd5vv1rf,fbPkOYLVPtPgIt0MxizjfFJov3JbHyAi,1,0,0,0,0,0,1,0,1,0.14285714285714285,1,0.0,0,0,0,0,0,0,0,1,0,0,1,1
678,19922,1qrewX2JRhRs3lyeTFWMYnwQw6V9CpLd,fbPkOYLVPtPgIt0MxizjfFJov3JbHyAi,6,3,1,0,1,0,2,0,7,1.0,1,0.0,0,1,0,1,3,0,0,2,0,2,5,1
679,19923,a0YvhqmPpF6B62CVp5XUUUyQ2cFSSLDq,fbPkOYLVPtPgIt0MxizjfFJov3JbHyAi,7,4,3,0,2,0,1,0,10,1.4285714285714286,1,0.0,0,3,0,2,4,0,0,1,0,5,5,1
680,19924,OT5T42YlAbCtocwISa5ev3ROMYVra29q,fbPkOYLVPtPgIt0MxizjfFJov3JbHyAi,1,0,0,0,0,0,1,0,1,0.14285714285714285,1,0.0,0,0,0,0,0,0,0,1,0,0,1,1
681,19925,u82lBhpDxJIwlZISEntCxj1zgVFdW0vT,fbPkOYLVPtPgIt0MxizjfFJov3JbHyAi,1,0,0,0,0,0,2,0,2,0.2857142857142857,1,0.0,0,0,0,0,0,0,0,2,0,0,2,1
682,19927,tfmBOfTcprRGNfQ7gzFBd9blOJuDxGOv,fbPkOYLVPtPgIt0MxizjfFJov3JbHyAi,1,0,0,0,0,0,1,0,1,0.14285714285714285,1,0.0,0,0,0,0,0,0,0,1,0,0,1,1
683,19929,rVO8IsFZOLqwyY7i49TyObO4q8Yse38O,fbPkOYLVPtPgIt0MxizjfFJov3JbHyAi,13,11,0,0,0,8,7,1,27,3.857142857142857,2,0.0,1,0,0,0,10,8,0,7,1,1,26,1
684,19930,5YTEHfbdjCMCzr5G677ZGUzXcQxELgAb,fbPkOYLVPtPgIt0MxizjfFJov3JbHyAi,5,3,2,0,2,0,3,0,10,1.4285714285714286,2,0.0,0,2,0,2,3,0,0,3,0,4,6,1
685,19931,Mae23dMejP7a3ejG0UsFTeoQgkbLs5l7,fbPkOYLVPtPgIt0MxizjfFJov3JbHyAi,2,0,0,0,0,0,4,0,4,0.5714285714285714,1,0.0,0,0,0,0,0,0,0,4,0,0,4,1
686,19944,tShEWwQUmNvdJJLgb6IWQwSvspfEXM5K,fbPkOYLVPtPgIt0MxizjfFJov3JbHyAi,8,6,4,0,2,0,3,0,15,2.142857142857143,2,0.0,0,4,0,2,6,0,0,3,0,6,9,1
687,19945,k6ezCrD5h8una2gKZ9FLMwuP5gpk8HYa,fbPkOYLVPtPgIt0MxizjfFJov3JbHyAi,8,3,2,0,2,0,5,0,12,1.7142857142857142,1,0.0,0,2,0,2,3,0,0,5,0,4,8,1
688,19946,l9HZDhlAzMA7SQE77dy0GfpgPqHQZI8y,fbPkOYLVPtPgIt0MxizjfFJov3JbHyAi,12,24,11,11,9,1,12,0,68,9.714285714285714,1,0.0,7,11,8,9,17,1,3,12,0,35,33,0
689,19950,ok15ssTMon44FKUffK29mVEN6xTGU7F9,fbPkOYLVPtPgIt0MxizjfFJov3JbHyAi,4,2,0,0,0,0,2,0,4,0.5714285714285714,1,0.0,0,0,0,0,2,0,0,2,0,0,4,1
690,19952,qzE4xRGg4xgP1uXuFdpBCVtFm7DMRWEv,fbPkOYLVPtPgIt0MxizjfFJov3JbHyAi,17,53,0,27,13,1,13,5,112,16.0,1,0.0,35,0,19,13,18,1,8,13,5,67,45,1
691,19954,eL4FSQJCTtWaJ5Qlsbb1oH9XvIKsOuUy,fbPkOYLVPtPgIt0MxizjfFJov3JbHyAi,9,3,2,0,2,5,6,0,18,2.5714285714285716,1,0.0,0,2,0,2,3,5,0,6,0,4,14,1
692,19957,1dkRu3NI0VUWfhY3RmHWMkMxYXCnS1Uj,fbPkOYLVPtPgIt0MxizjfFJov3JbHyAi,11,14,10,0,9,1,10,3,47,6.714285714285714,1,0.0,2,10,0,9,12,1,0,10,3,21,26,1
693,21469,5oy5I8Xh5KkzBBzgBTkYXJ5uADqnzeVC,7GRhBDsirIGkRZBtSMEzNTyDr2JQm4xx,9,21,8,2,3,2,6,0,42,6.0,2,0.0,4,8,2,3,17,2,0,6,0,17,25,0
694,21478,43nq30xhRsgmZVAWkH8Zjb7IyZDGRDeY,7GRhBDsirIGkRZBtSMEzNTyDr2JQm4xx,4,11,3,0,0,0,2,0,16,2.2857142857142856,1,0.0,6,3,0,0,5,0,0,2,0,9,7,0
695,21498,pqUcxq00SFcjmnxHDdHJfvpMD3HzyhM8,7GRhBDsirIGkRZBtSMEzNTyDr2JQm4xx,40,75,26,51,18,19,13,3,205,29.285714285714285,2,0.0,25,26,42,18,50,19,9,13,3,111,94,1
696,21499,L74tKRZpBi1qsh0NM3EwE5D87acCLK8s,7GRhBDsirIGkRZBtSMEzNTyDr2JQm4xx,27,42,13,50,3,0,12,0,120,17.142857142857142,3,0.0,24,13,43,3,18,0,7,12,0,83,37,0
697,21500,SkSNdONKSsRL2ZUQhM3bWRg6jfQsm6hV,7GRhBDsirIGkRZBtSMEzNTyDr2JQm4xx,20,12,8,0,7,1,6,0,34,4.857142857142857,2,0.0,2,8,0,7,10,1,0,6,0,17,17,1
698,21503,PUFh3BsQaDVIJMDvwsFTqkrgAzvjO9ME,7GRhBDsirIGkRZBtSMEzNTyDr2JQm4xx,5,5,1,0,0,0,5,0,11,1.5714285714285714,2,0.0,0,1,0,0,5,0,0,5,0,1,10,1
699,21528,S5RuYbQmA5K156juNY12D97yGDmISJaQ,7GRhBDsirIGkRZBtSMEzNTyDr2JQm4xx,26,68,1,19,1,0,4,0,93,13.285714285714286,3,0.0,29,1,12,1,39,0,7,4,0,43,50,0
700,21533,zqwrod4FlqaduP76a40P1VYHXufy1EKD,7GRhBDsirIGkRZBtSMEzNTyDr2JQm4xx,7,3,2,0,1,5,5,1,17,2.4285714285714284,1,0.0,1,2,0,1,2,5,0,5,1,4,13,0
701,21566,r0xLQZJ7XErj8hBxXhgtLAa0ZIpucchx,7GRhBDsirIGkRZBtSMEzNTyDr2JQm4xx,16,16,13,0,10,0,2,0,41,5.857142857142857,2,0.0,0,13,0,10,16,0,0,2,0,23,18,0
702,21832,W5CVKONt5qsYlbCwSDDjPmuQMWPx8PFD,7GRhBDsirIGkRZBtSMEzNTyDr2JQm4xx,25,28,11,10,14,0,2,0,65,9.285714285714286,1,0.0,8,11,5,14,20,0,5,2,0,38,27,0
703,22007,eovSKdG09ZHYTXNtS1zUIy1RfsRsCibs,7GRhBDsirIGkRZBtSMEzNTyDr2JQm4xx,47,193,82,61,67,942,94,0,1439,205.57142857142858,7,0.0,89,82,46,67,104,942,15,94,0,284,1155,0
704,22020,xdfT7UfbG0ewFi6FNN3zlNGBGpobyBrO,7GRhBDsirIGkRZBtSMEzNTyDr2JQm4xx,14,17,1,0,1,0,2,0,21,3.0,2,0.0,0,1,0,1,17,0,0,2,0,2,19,1
705,22130,lw56FfuS5fUETVCyRkCnysAZop6MzvUe,7GRhBDsirIGkRZBtSMEzNTyDr2JQm4xx,14,21,9,4,3,4,5,0,46,6.571428571428571,2,0.0,6,9,3,3,15,4,1,5,0,21,25,0
706,22676,CMoV5dPTzwxV3W6HJJmvW8wSnp90ZPh2,SpATywNh6bZuzm8s1ceuBUnMUAeoAHHw,3,4,2,0,0,0,2,0,8,1.1428571428571428,2,0.0,0,2,0,0,4,0,0,2,0,2,6,0
707,22738,83J9IXuPcwdDBJoFENdSQFWzvgELVzeu,G8EPVSXsOYB5YQWZGiz1aVq5Pgr2GrQu,10,22,6,12,2,5,4,0,51,7.285714285714286,1,0.0,10,6,6,2,12,5,6,4,0,24,27,1
708,22757,LJYBef7iIBiSZz8D7KTtMTsdkyd91gnR,SpATywNh6bZuzm8s1ceuBUnMUAeoAHHw,25,31,16,18,8,8,3,0,84,12.0,3,0.0,9,16,16,8,22,8,2,3,0,49,35,0
709,22766,BImVQpNaWI5ZZjLENiRV2V2LYkbW88m0,RXDvfPUBYFlVdlueBFbLW0mhhAyGEqpt,4,3,1,0,0,0,1,0,5,0.7142857142857143,1,0.0,0,1,0,0,3,0,0,1,0,1,4,0
710,22776,jaMKMvlU4KDCkm4HrM0MWVH43rDA8rY1,A3fsA9Zfv1X2fVEQhTw51lKENdNrEqT3,17,11,8,0,7,0,2,0,28,4.0,1,0.0,0,8,0,7,11,0,0,2,0,15,13,1
711,22787,XCY83tv4aCv2fMTPmH1QE6tZOtr7KzJT,G8EPVSXsOYB5YQWZGiz1aVq5Pgr2GrQu,53,55,38,176,2,38,25,0,334,47.714285714285715,5,0.0,7,38,149,2,48,38,27,25,0,196,138,0
712,22814,zyIWmJjaz36PnMZpAzR2HEZCUbJWe8iQ,A3fsA9Zfv1X2fVEQhTw51lKENdNrEqT3,12,9,7,2,4,0,3,0,25,3.5714285714285716,2,0.0,0,7,2,4,9,0,0,3,0,13,12,1
713,22859,JJDRXXLRU75H8Dx2cuK7Td1V7D7QoKg9,RXDvfPUBYFlVdlueBFbLW0mhhAyGEqpt,24,49,2,44,10,0,8,0,113,16.142857142857142,5,0.0,21,2,36,10,28,0,8,8,0,69,44,0
714,22880,ti1hbICHLqROy8Y7XhKRxGlLqF2ITiDH,RXDvfPUBYFlVdlueBFbLW0mhhAyGEqpt,2,0,0,0,0,0,2,0,2,0.2857142857142857,1,0.0,0,0,0,0,0,0,0,2,0,0,2,0
715,22898,t2LtqHppiTuDN14mSCfUVu9qYG7mBNAD,A3fsA9Zfv1X2fVEQhTw51lKENdNrEqT3,10,6,5,0,3,0,1,0,15,2.142857142857143,1,0.0,0,5,0,3,6,0,0,1,0,8,7,0
716,22915,dLoTMfurIDgppPqjn68MhR8oLIGjxbCC,bWdj2GDclj5ofokWjzoa5jAwMkxCykd6,28,68,25,50,21,37,8,0,209,29.857142857142858,2,0.0,30,25,48,21,38,37,2,8,0,124,85,1
717,22924,SY3KixRowLNTROWYYZsbpxNmhMe23Wc3,SpATywNh6bZuzm8s1ceuBUnMUAeoAHHw,7,16,5,0,2,0,2,0,25,3.5714285714285716,4,0.0,0,5,0,2,16,0,0,2,0,7,18,1
718,22937,7mQeRnk4E67KJHDHSAp1BOWEWVuxMvA2,SpATywNh6bZuzm8s1ceuBUnMUAeoAHHw,3,2,1,0,0,0,2,0,5,0.7142857142857143,1,0.0,0,1,0,0,2,0,0,2,0,1,4,1
719,23011,Qi3PLuC7w2Yo9hFgq37MObjY8icnRdc6,A3fsA9Zfv1X2fVEQhTw51lKENdNrEqT3,11,37,17,0,3,13,14,0,84,12.0,2,0.0,0,17,0,3,37,13,0,14,0,20,64,0
720,23016,jZn0klM9Bk084k9gvux7E5DK1oO1FwuJ,SpATywNh6bZuzm8s1ceuBUnMUAeoAHHw,3,2,1,0,0,0,1,0,4,0.5714285714285714,1,0.0,0,1,0,0,2,0,0,1,0,1,3,0
721,23038,0DzldTHKdoH90kklIAjpWyAEe6XDDjyM,SpATywNh6bZuzm8s1ceuBUnMUAeoAHHw,7,24,0,0,0,0,15,0,39,5.571428571428571,4,0.0,3,0,0,0,21,0,0,15,0,3,36,0
722,23075,CUMuKIhvWkMSk50Or6FhgPf1tk7jntYp,SpATywNh6bZuzm8s1ceuBUnMUAeoAHHw,4,3,2,0,0,0,1,0,6,0.8571428571428571,1,0.0,0,2,0,0,3,0,0,1,0,2,4,0
723,23097,5wbqpjsRycE3Ij1gukLWuLp8it7vr80U,SpATywNh6bZuzm8s1ceuBUnMUAeoAHHw,3,2,1,0,0,0,2,0,5,0.7142857142857143,1,0.0,0,1,0,0,2,0,0,2,0,1,4,1
724,23121,9S5uoFAiVHVF4D2DNR23wCkbQZ8LhtES,SpATywNh6bZuzm8s1ceuBUnMUAeoAHHw,4,3,1,0,0,0,1,0,5,0.7142857142857143,1,0.0,0,1,0,0,3,0,0,1,0,1,4,0
725,23131,hGDnsprgLmlBuNCzDAhbMdsa7xgZW8Z4,bWdj2GDclj5ofokWjzoa5jAwMkxCykd6,21,10,4,67,1,0,6,0,88,12.571428571428571,2,0.0,3,4,62,1,7,0,5,6,0,70,18,1
726,23142,6j5Aoj3JOkcTRkyfXNVtTy229CS4uihi,G8EPVSXsOYB5YQWZGiz1aVq5Pgr2GrQu,34,34,20,29,13,0,6,0,102,14.571428571428571,5,0.0,9,20,26,13,25,0,3,6,0,68,34,0
727,23183,HycevJIm7cBjf1oJ5QCBMMXEBTG8jyRF,A3fsA9Zfv1X2fVEQhTw51lKENdNrEqT3,11,16,10,0,2,0,8,0,36,5.142857142857143,2,0.0,2,10,0,2,14,0,0,8,0,14,22,0
728,23185,HycevJIm7cBjf1oJ5QCBMMXEBTG8jyRF,bWdj2GDclj5ofokWjzoa5jAwMkxCykd6,20,14,9,24,2,1,7,0,57,8.142857142857142,3,0.0,1,9,24,2,13,1,0,7,0,36,21,0
729,23201,mE5coXp72CvzVrqwpPF6wLVZrHDH0Vlq,SpATywNh6bZuzm8s1ceuBUnMUAeoAHHw,4,3,1,0,0,0,1,0,5,0.7142857142857143,1,0.0,0,1,0,0,3,0,0,1,0,1,4,0
730,23299,FuoDsqlUs6ZIyTkMTIVnWx4xFWKln8DR,SpATywNh6bZuzm8s1ceuBUnMUAeoAHHw,10,10,6,15,1,0,2,0,34,4.857142857142857,2,0.0,2,6,14,1,8,0,1,2,0,23,11,0
731,23316,QdSH85e6TVvHCb4lCpuXbYzwkD8QbL3t,G8EPVSXsOYB5YQWZGiz1aVq5Pgr2GrQu,16,16,8,0,5,0,3,0,32,4.571428571428571,2,0.0,2,8,0,5,14,0,0,3,0,15,17,0
732,23332,V1z8w9SjLbULVqlANveH3qv7vwfEbAs7,A3fsA9Zfv1X2fVEQhTw51lKENdNrEqT3,4,4,1,0,0,0,7,0,12,1.7142857142857142,1,0.0,0,1,0,0,4,0,0,7,0,1,11,0
733,23391,X8qfNjsHrwR5R67KkU9t7FXc6jQSGsyo,bWdj2GDclj5ofokWjzoa5jAwMkxCykd6,17,23,5,18,3,7,11,0,67,9.571428571428571,2,0.0,2,5,16,3,21,7,2,11,0,26,41,1
734,23401,xMuijSepoYpWnTVSuzhdordHJTyRt87I,SpATywNh6bZuzm8s1ceuBUnMUAeoAHHw,4,2,1,0,0,0,2,0,5,0.7142857142857143,1,0.0,0,1,0,0,2,0,0,2,0,1,4,1
735,23403,GWG8afsUfRei9CIZYg1Y2sBsF64D5J9k,A3fsA9Zfv1X2fVEQhTw51lKENdNrEqT3,35,17,10,78,5,0,4,0,114,16.285714285714285,2,0.0,3,10,65,5,14,0,13,4,0,83,31,0
736,23410,yGTKMCuyZTpBDN6edeGIEf8UqO2mMowi,SpATywNh6bZuzm8s1ceuBUnMUAeoAHHw,5,3,2,0,1,0,1,0,7,1.0,1,0.0,0,2,0,1,3,0,0,1,0,3,4,1
737,23458,cAyxesGtWW4tBzueSc3JcCfBcF1iSxzo,SpATywNh6bZuzm8s1ceuBUnMUAeoAHHw,3,2,1,0,0,0,1,0,4,0.5714285714285714,1,0.0,0,1,0,0,2,0,0,1,0,1,3,0
738,23502,wNbKFPX6oYsfVEr8buyWthBblPuPZGxv,A3fsA9Zfv1X2fVEQhTw51lKENdNrEqT3,35,22,14,100,5,23,6,0,170,24.285714285714285,2,0.0,3,14,82,5,19,23,18,6,0,104,66,0
739,23541,ACrAvl4ssWNFndB2wDhI3oY0Vqi5B1FR,SpATywNh6bZuzm8s1ceuBUnMUAeoAHHw,3,6,3,0,0,0,2,0,11,1.5714285714285714,2,0.0,0,3,0,0,6,0,0,2,0,3,8,0
740,23550,7yphMCe2LQupOHSaDA3UQC9kbDeEuBie,SpATywNh6bZuzm8s1ceuBUnMUAeoAHHw,24,34,14,25,6,0,3,0,82,11.714285714285714,3,0.0,8,14,24,6,26,0,1,3,0,52,30,0
741,23557,M6VmJD8JYDR5w6GV5uzAgWpIXM5eanml,SpATywNh6bZuzm8s1ceuBUnMUAeoAHHw,1,0,0,0,0,0,1,0,1,0.14285714285714285,1,0.0,0,0,0,0,0,0,0,1,0,0,1,0
742,23589,mptZxS2IRXAopBdChMP75EgVt5rtRsUT,SpATywNh6bZuzm8s1ceuBUnMUAeoAHHw,4,7,3,0,0,0,3,0,13,1.8571428571428572,3,0.0,0,3,0,0,7,0,0,3,0,3,10,1
743,23616,VADc1m6JjTG2LuLkbhEfhADWJMHaDmqK,SpATywNh6bZuzm8s1ceuBUnMUAeoAHHw,30,54,30,28,10,17,9,1,149,21.285714285714285,3,0.0,13,30,26,10,41,17,2,9,1,79,70,0
744,23621,HRaTe8gWBsDiLkzfbQMnooVDWfwWVb7m,SpATywNh6bZuzm8s1ceuBUnMUAeoAHHw,5,6,2,0,0,0,2,0,10,1.4285714285714286,2,0.0,0,2,0,0,6,0,0,2,0,2,8,0
745,23634,hs0BkyfSJv3crs4cIvcxkt53zip5FMPg,SpATywNh6bZuzm8s1ceuBUnMUAeoAHHw,4,4,3,0,0,0,1,0,8,1.1428571428571428,1,0.0,0,3,0,0,4,0,0,1,0,3,5,1
746,23642,04gG5zVwZ7Vr68t1LtjimV9KPqGTDxDK,SpATywNh6bZuzm8s1ceuBUnMUAeoAHHw,18,21,14,19,4,2,10,0,70,10.0,5,0.0,6,14,16,4,15,2,3,10,0,40,30,0
747,23667,1NMKv7RE12uBMKwNJI30Cx8Z5ltMGoee,SpATywNh6bZuzm8s1ceuBUnMUAeoAHHw,3,2,1,0,0,0,2,0,5,0.7142857142857143,1,0.0,0,1,0,0,2,0,0,2,0,1,4,0
748,23672,F9d8ehlFxvqouYiZgUKxdbX5NI44Sbpl,SpATywNh6bZuzm8s1ceuBUnMUAeoAHHw,5,3,2,0,1,0,1,0,7,1.0,1,0.0,0,2,0,1,3,0,0,1,0,3,4,1
749,23682,iSZJZtUn8nc9fyool89gRRN7Cq78oUfm,SpATywNh6bZuzm8s1ceuBUnMUAeoAHHw,3,2,1,0,0,8,3,0,14,2.0,2,0.0,0,1,0,0,2,8,0,3,0,1,13,0
750,23699,jM1yIagOMV2CwD8o07UMrVdo7z0hqKJ4,bWdj2GDclj5ofokWjzoa5jAwMkxCykd6,34,13,13,76,6,0,1,0,109,15.571428571428571,1,0.0,4,13,75,6,9,0,1,1,0,98,11,0
751,23724,wQU3lY7mCoAWFqnxNLhiEFrdAWtS5Hh9,SpATywNh6bZuzm8s1ceuBUnMUAeoAHHw,3,0,0,0,0,4,3,0,7,1.0,1,0.0,0,0,0,0,0,4,0,3,0,0,7,0
752,23751,zvOHbaUWjxRZ9zCYxYPMcUH4Ef5dE8Ae,RXDvfPUBYFlVdlueBFbLW0mhhAyGEqpt,6,3,1,0,1,0,2,0,7,1.0,1,0.0,0,1,0,1,3,0,0,2,0,2,5,1
753,23772,bQK35cKsW9Hy5fNgckzz4Jo7bFzQOyma,G8EPVSXsOYB5YQWZGiz1aVq5Pgr2GrQu,17,25,5,22,4,0,1,0,57,8.142857142857142,1,0.0,17,5,11,4,8,0,11,1,0,37,20,0
754,23776,JoruyAOmEeM1qjcSEWRUjLvQUHpNPZGp,SpATywNh6bZuzm8s1ceuBUnMUAeoAHHw,9,15,0,0,0,0,5,0,20,2.857142857142857,1,0.0,0,0,0,0,15,0,0,5,0,0,20,1
755,23818,oAs7swdosdDbKq3u64wlCP6EHVlCh67P,bWdj2GDclj5ofokWjzoa5jAwMkxCykd6,4,2,1,0,0,0,2,0,5,0.7142857142857143,1,0.0,0,1,0,0,2,0,0,2,0,1,4,1
756,23839,xHZbSROhwP4RRQerUVWvcNTfOGc2DHWf,bWdj2GDclj5ofokWjzoa5jAwMkxCykd6,12,41,23,0,5,0,22,0,91,13.0,6,0.0,0,23,0,5,41,0,0,22,0,28,63,0
757,23845,TSxGfcluByCTxwgFYbniUiwGZJ5ZTUOD,RXDvfPUBYFlVdlueBFbLW0mhhAyGEqpt,12,10,8,13,2,4,1,0,38,5.428571428571429,1,0.0,0,8,12,2,10,4,1,1,0,22,16,1
758,23859,XNb7KU6KeHuNJzclGX2ePynnmu8yxV3v,SpATywNh6bZuzm8s1ceuBUnMUAeoAHHw,4,14,1,0,0,0,7,0,22,3.142857142857143,2,0.0,0,1,0,0,14,0,0,7,0,1,21,0
759,23962,5pjAdY5K4FfgQPLSzQKwXaKF78ph9a0y,RXDvfPUBYFlVdlueBFbLW0mhhAyGEqpt,27,61,37,30,18,28,18,1,193,27.571428571428573,4,0.0,10,37,28,18,51,28,2,18,1,93,100,0
760,23994,AkYabqnQmQubmhD6vLFPcIqa194wOTvs,SpATywNh6bZuzm8s1ceuBUnMUAeoAHHw,8,5,1,0,1,0,2,0,9,1.2857142857142858,1,0.0,0,1,0,1,5,0,0,2,0,2,7,1
761,24000,tML4IQ8jFiP4YuH9NbvzKQFqAdof0qcO,SpATywNh6bZuzm8s1ceuBUnMUAeoAHHw,1,0,0,0,0,0,1,0,1,0.14285714285714285,1,0.0,0,0,0,0,0,0,0,1,0,0,1,0
762,24021,wPWqnGAkrR45TEYOXZpjGrKRubMl9rFP,SpATywNh6bZuzm8s1ceuBUnMUAeoAHHw,5,4,2,0,0,0,4,0,10,1.4285714285714286,2,0.0,0,2,0,0,4,0,0,4,0,2,8,0
763,24024,OIPBfPb9802WcbHz02njDB4ysP5ao9fe,SpATywNh6bZuzm8s1ceuBUnMUAeoAHHw,7,4,0,0,0,0,3,0,7,1.0,1,0.0,0,0,0,0,4,0,0,3,0,0,7,0
764,24025,REvshIGXuaBWprkQ9qA5D33qmf3QiAwV,SpATywNh6bZuzm8s1ceuBUnMUAeoAHHw,5,8,4,0,0,0,10,0,22,3.142857142857143,3,0.0,0,4,0,0,8,0,0,10,0,4,18,0
765,24076,hWoXRoePYaW50QNR65rI6g0ffdFAubIq,SpATywNh6bZuzm8s1ceuBUnMUAeoAHHw,8,6,5,0,4,0,0,0,15,2.142857142857143,1,0.0,1,5,0,4,5,0,0,0,0,10,5,1
766,24086,wx9LUKj4KCj2VrJqkWxv5NlmYX9Bw5rx,RXDvfPUBYFlVdlueBFbLW0mhhAyGEqpt,28,79,6,8,5,0,13,0,111,15.857142857142858,2,0.0,2,6,7,5,77,0,1,13,0,20,91,1
767,24138,tCb9JPhOhIatDlJOcmjorPeSIRsd6N1b,SpATywNh6bZuzm8s1ceuBUnMUAeoAHHw,5,5,0,0,0,0,5,0,10,1.4285714285714286,2,0.0,0,0,0,0,5,0,0,5,0,0,10,0
768,24287,Ms0MC4W5moiGJLWP7iE3FImeH9CHN4KT,bWdj2GDclj5ofokWjzoa5jAwMkxCykd6,16,8,0,46,0,14,8,0,76,10.857142857142858,3,0.0,1,0,39,0,7,14,7,8,0,40,36,0
769,24303,pYcnIzYPgb3xzrOvmR9y0UUIZo4gqKuO,RXDvfPUBYFlVdlueBFbLW0mhhAyGEqpt,23,38,19,19,9,12,8,0,105,15.0,4,0.0,7,19,18,9,31,12,1,8,0,53,52,0
770,24304,UzwJVyLJF6Ih9iHYPyYWMullgIr89o5m,RXDvfPUBYFlVdlueBFbLW0mhhAyGEqpt,8,11,8,0,3,0,3,0,25,3.5714285714285716,2,0.0,1,8,0,3,10,0,0,3,0,12,13,0
771,24312,wGN3pCdk72KFTm52vXIRH474TFtQqduI,SpATywNh6bZuzm8s1ceuBUnMUAeoAHHw,6,7,4,0,1,0,2,0,14,2.0,2,0.0,1,4,0,1,6,0,0,2,0,6,8,0
772,24325,bPrEBQILvyBjp3odJGGZ7KxlAV5Gu9sz,SpATywNh6bZuzm8s1ceuBUnMUAeoAHHw,8,6,4,0,1,0,2,0,13,1.8571428571428572,1,0.0,1,4,0,1,5,0,0,2,0,6,7,0
773,24332,NY9lbGArbud0VjFCO45IgKzDykuc5Wkn,SpATywNh6bZuzm8s1ceuBUnMUAeoAHHw,8,20,3,0,0,3,16,1,43,6.142857142857143,4,0.0,3,3,0,0,17,3,0,16,1,6,37,1
774,24383,Ialz252wY3knIVjOtCWLYcvvPO6EGRFT,SpATywNh6bZuzm8s1ceuBUnMUAeoAHHw,9,12,0,0,0,0,13,2,27,3.857142857142857,3,0.0,2,0,0,0,10,0,0,13,2,2,25,0
775,24444,mFNGHC6aCmhHmhRXFCDO0uvnGnNYaro0,A3fsA9Zfv1X2fVEQhTw51lKENdNrEqT3,6,7,4,0,0,0,3,0,14,2.0,2,0.0,0,4,0,0,7,0,0,3,0,4,10,1
776,24481,MlSRfdfvLbnwipGT1vckZAUcsWbqV0Nz,bWdj2GDclj5ofokWjzoa5jAwMkxCykd6,15,11,3,34,0,0,9,0,57,8.142857142857142,2,0.0,3,3,29,0,8,0,5,9,0,35,22,0
777,24495,MhaNzTwlOubA2mdN8jvZF4ySj9a3XsvZ,G8EPVSXsOYB5YQWZGiz1aVq5Pgr2GrQu,7,9,4,8,0,0,4,0,25,3.5714285714285716,1,0.0,2,4,6,0,7,0,2,4,0,12,13,1
778,24532,Hxi6d4DzV7K1jcnZIhXlJzpIYDP4sYeZ,G8EPVSXsOYB5YQWZGiz1aVq5Pgr2GrQu,4,3,0,0,0,0,1,0,4,0.5714285714285714,1,0.0,0,0,0,0,3,0,0,1,0,0,4,0
779,24629,ja7eUjcxSqFnoRSNZAdtMUdo5WLyuwNj,RXDvfPUBYFlVdlueBFbLW0mhhAyGEqpt,9,5,3,22,1,0,1,0,32,4.571428571428571,1,0.0,1,3,17,1,4,0,5,1,0,22,10,1
780,24702,VPT5ZBddqdKmipdjPIcaTABROj9B5qkg,bWdj2GDclj5ofokWjzoa5jAwMkxCykd6,37,36,26,91,14,9,8,1,185,26.428571428571427,3,0.0,7,26,78,14,29,9,13,8,1,125,60,0
781,24775,FeUvHE3xENj0OT6fhaRqvHDDKwwtsMRR,SpATywNh6bZuzm8s1ceuBUnMUAeoAHHw,1,0,0,0,0,0,1,0,1,0.14285714285714285,1,0.0,0,0,0,0,0,0,0,1,0,0,1,0
782,24821,2Hx9g01WcHXaoIvHRFrUfZqDWuVhvV5b,SpATywNh6bZuzm8s1ceuBUnMUAeoAHHw,5,15,5,0,0,2,9,0,31,4.428571428571429,4,0.0,0,5,0,0,15,2,0,9,0,5,26,0
783,24847,IhWjcgRzoXcWcgj0TSEsE1klKuKl9aDP,G8EPVSXsOYB5YQWZGiz1aVq5Pgr2GrQu,33,44,15,58,16,1,8,1,143,20.428571428571427,2,0.0,26,15,39,16,18,1,19,8,1,96,47,0
784,24860,FPPbdZs5zRERbNXCB9udITtxlck6dBd9,SpATywNh6bZuzm8s1ceuBUnMUAeoAHHw,5,7,1,0,0,2,4,0,14,2.0,1,0.0,0,1,0,0,7,2,0,4,0,1,13,0
785,24875,97rJErYjCaSZkM2sQr4Hy3em0yNLLl9Z,7GRhBDsirIGkRZBtSMEzNTyDr2JQm4xx,26,75,21,44,2,0,5,0,147,21.0,1,0.0,24,21,39,2,51,0,5,5,0,86,61,0
786,25008,AlPSASl29ys7OO31KpYSADARO0IiSNGm,SpATywNh6bZuzm8s1ceuBUnMUAeoAHHw,11,6,5,0,4,0,1,0,16,2.2857142857142856,1,0.0,0,5,0,4,6,0,0,1,0,9,7,1
787,25047,e8HsYbNWN6cCQbTmxFf7TraoRlE6iBxd,A3fsA9Zfv1X2fVEQhTw51lKENdNrEqT3,70,51,29,152,22,9,27,1,291,41.57142857142857,3,0.0,2,29,140,22,49,9,12,27,1,193,98,0
788,25086,ljqvAdk5ocV9irAsEHJ87jRvF9JOTCHu,SpATywNh6bZuzm8s1ceuBUnMUAeoAHHw,31,48,18,38,7,30,22,1,164,23.428571428571427,4,0.0,25,18,33,7,23,30,5,22,1,83,81,1
789,25128,5ysSxswt94Gjj7n5OSEcRzDBWhgbKFUg,SpATywNh6bZuzm8s1ceuBUnMUAeoAHHw,4,10,3,0,0,0,3,0,16,2.2857142857142856,3,0.0,4,3,0,0,6,0,0,3,0,7,9,0
790,25140,s4t4u8r9weCt43Z5PXbFAgqmS5WJ6hj5,G8EPVSXsOYB5YQWZGiz1aVq5Pgr2GrQu,8,8,1,4,1,0,2,0,16,2.2857142857142856,2,0.0,2,1,2,1,6,0,2,2,0,6,10,1
791,25206,36GRXkIW2SpIWQz7gvMq2JRXacytqSzV,SpATywNh6bZuzm8s1ceuBUnMUAeoAHHw,10,12,9,0,3,4,6,0,34,4.857142857142857,3,0.0,0,9,0,3,12,4,0,6,0,12,22,0
792,25236,JmXGzVVfQa5TXaQwtZdggsgBkbZbIeH5,bWdj2GDclj5ofokWjzoa5jAwMkxCykd6,7,6,5,0,4,0,1,0,16,2.2857142857142856,1,0.0,0,5,0,4,6,0,0,1,0,9,7,0
793,25289,YfHmALaAUVJkTXPVPoa3sijNQuWgYS7R,SpATywNh6bZuzm8s1ceuBUnMUAeoAHHw,5,7,3,0,0,0,3,0,13,1.8571428571428572,2,0.0,2,3,0,0,5,0,0,3,0,5,8,0
794,25292,ETzcC9n39CwhBb4MTbqq1Ng4NqGIoiPj,A3fsA9Zfv1X2fVEQhTw51lKENdNrEqT3,10,16,0,0,0,0,6,0,22,3.142857142857143,1,0.0,0,0,0,0,16,0,0,6,0,0,22,1
795,25311,yG8wEEmCuC5YTy4CQDGA5I639Z9JzSu0,SpATywNh6bZuzm8s1ceuBUnMUAeoAHHw,9,9,4,0,4,0,2,0,19,2.7142857142857144,1,0.0,0,4,0,4,9,0,0,2,0,8,11,1
796,25333,SIdEQEXoagJ5WwAcAkPtkVF6pipatiIa,A3fsA9Zfv1X2fVEQhTw51lKENdNrEqT3,2,0,0,0,0,0,2,0,2,0.2857142857142857,1,0.0,0,0,0,0,0,0,0,2,0,0,2,0
797,25510,SXQudUQxotVyHX3jIj58IdonMUWj4z4L,SpATywNh6bZuzm8s1ceuBUnMUAeoAHHw,14,17,10,0,2,0,10,0,39,5.571428571428571,4,0.0,3,10,0,2,14,0,0,10,0,15,24,0
798,25577,s5bmHBniKJzstjkFlsJcJn6YQEnj7XjP,RXDvfPUBYFlVdlueBFbLW0mhhAyGEqpt,6,8,3,0,2,0,2,0,15,2.142857142857143,1,0.0,2,3,0,2,6,0,0,2,0,7,8,1
799,25593,BiaPgBnlrEY2EiwA20PKZL3VeANI5Sfw,SpATywNh6bZuzm8s1ceuBUnMUAeoAHHw,4,3,2,0,0,0,2,0,7,1.0,1,0.0,0,2,0,0,3,0,0,2,0,2,5,1
800,25652,HrUHfBacH3u3gfsauI41ANlvNzWZshRh,A3fsA9Zfv1X2fVEQhTw51lKENdNrEqT3,4,3,2,0,0,0,1,0,6,0.8571428571428571,1,0.0,0,2,0,0,3,0,0,1,0,2,4,0
801,25653,TJlb1m2PM0vBaKFhpndqRNwoSVpMlE8f,A3fsA9Zfv1X2fVEQhTw51lKENdNrEqT3,3,2,0,0,0,0,1,0,3,0.42857142857142855,1,0.0,0,0,0,0,2,0,0,1,0,0,3,1
802,25765,E31WqWw5nCEWlSKgmhsOSj5j4T79ypCl,SpATywNh6bZuzm8s1ceuBUnMUAeoAHHw,4,4,2,0,0,0,4,0,10,1.4285714285714286,3,0.0,0,2,0,0,4,0,0,4,0,2,8,0
803,25793,V2mnxM1tJc479TW7qqC55qpZNUZBAJ2y,G8EPVSXsOYB5YQWZGiz1aVq5Pgr2GrQu,35,47,23,102,7,24,22,1,226,32.285714285714285,2,0.0,19,23,82,7,28,24,20,22,1,131,95,0
804,25807,Zl8ThqnwtmFsX5mPsLsbut5BCVNIbE7S,SpATywNh6bZuzm8s1ceuBUnMUAeoAHHw,27,36,24,12,9,3,9,1,94,13.428571428571429,2,0.0,3,24,10,9,33,3,2,9,1,46,48,0
805,25837,b5Gj1OyeYKLhLlGsleyNSSJpbJ2lneFj,SpATywNh6bZuzm8s1ceuBUnMUAeoAHHw,13,18,2,17,0,0,2,0,39,5.571428571428571,2,0.0,6,2,15,0,12,0,2,2,0,23,16,1
806,25864,koGmxwg6FRa19ZshKXnyLXLosS5G7cau,7GRhBDsirIGkRZBtSMEzNTyDr2JQm4xx,4,2,0,0,0,0,2,0,4,0.5714285714285714,1,0.0,0,0,0,0,2,0,0,2,0,0,4,1
807,25867,8AVk1xYha38NNysY3dSGM9P4W7fXA7gi,SpATywNh6bZuzm8s1ceuBUnMUAeoAHHw,12,14,6,0,5,0,2,0,27,3.857142857142857,1,0.0,0,6,0,5,14,0,0,2,0,11,16,0
808,25883,HrUHfBacH3u3gfsauI41ANlvNzWZshRh,SpATywNh6bZuzm8s1ceuBUnMUAeoAHHw,6,10,5,0,0,0,6,0,21,3.0,3,0.0,2,5,0,0,8,0,0,6,0,7,14,0
809,25895,DLDhUvvvfnnYFJuV65Zt2yaS0jPJgvzq,SpATywNh6bZuzm8s1ceuBUnMUAeoAHHw,8,11,0,0,0,14,15,1,41,5.857142857142857,4,0.0,0,0,0,0,11,14,0,15,1,0,41,0
810,25901,pIkx6nDAjTla5NYVEsjhMXOIu5zXDzmO,SpATywNh6bZuzm8s1ceuBUnMUAeoAHHw,13,10,6,0,4,0,5,2,27,3.857142857142857,1,0.0,0,6,0,4,10,0,0,5,2,10,17,0
811,25963,3Ew3yAxjSntFFYCyahG9TNwPBtEjhvBu,SpATywNh6bZuzm8s1ceuBUnMUAeoAHHw,14,15,11,0,7,3,5,3,44,6.285714285714286,3,0.0,1,11,0,7,14,3,0,5,3,19,25,1
812,26027,l5LfU8gApOG72AnBkdAbfOLQLwFH7Zo2,A3fsA9Zfv1X2fVEQhTw51lKENdNrEqT3,10,11,1,0,1,0,3,0,16,2.2857142857142856,2,0.0,1,1,0,1,10,0,0,3,0,3,13,0
813,26148,JqvGTplcVBLcq3YzEUVslmYGYOBREBZ1,SpATywNh6bZuzm8s1ceuBUnMUAeoAHHw,6,12,1,0,0,22,10,0,45,6.428571428571429,4,0.0,3,1,0,0,9,22,0,10,0,4,41,0
814,26208,USLTnsAwagwK2c83KXd1SNEeENnzkTTo,7GRhBDsirIGkRZBtSMEzNTyDr2JQm4xx,1,0,0,0,0,0,3,0,3,0.42857142857142855,3,0.0,0,0,0,0,0,0,0,3,0,0,3,0
815,26277,m3MqtCVwUomC1r1STaTTddPYjy0l0hZb,bWdj2GDclj5ofokWjzoa5jAwMkxCykd6,1,0,0,0,0,0,1,0,1,0.14285714285714285,1,0.0,0,0,0,0,0,0,0,1,0,0,1,1
816,26286,d5fIWN5kvqsn40aHFJvoDDo4RHSEcHNo,SpATywNh6bZuzm8s1ceuBUnMUAeoAHHw,9,10,8,0,5,0,2,0,25,3.5714285714285716,2,0.0,0,8,0,5,10,0,0,2,0,13,12,1
817,26297,UjnOd8eB67vR87Hc1uvDJpBawBhqSd4C,SpATywNh6bZuzm8s1ceuBUnMUAeoAHHw,17,23,11,18,8,0,3,0,63,9.0,2,0.0,8,11,15,8,15,0,3,3,0,42,21,1
818,26322,XMtcnsDNasKCOMBWrsjCVH5NONQyEryR,A3fsA9Zfv1X2fVEQhTw51lKENdNrEqT3,5,6,4,0,0,1,3,0,14,2.0,1,0.0,0,4,0,0,6,1,0,3,0,4,10,0
819,26326,drIV8ws6G2eFjZA06SdUOTyJLvhyaXrd,SpATywNh6bZuzm8s1ceuBUnMUAeoAHHw,1,0,0,0,0,0,2,0,2,0.2857142857142857,2,0.0,0,0,0,0,0,0,0,2,0,0,2,0
820,26335,IW0jtTZGLkJezOCVgyOKwdgLTuPt0owB,SpATywNh6bZuzm8s1ceuBUnMUAeoAHHw,20,24,0,34,1,5,5,1,70,10.0,1,0.0,10,0,29,1,14,5,5,5,1,40,30,0
821,26372,n9pMeUNiRSC6CgcSbq2dPbx8FhUkGah9,A3fsA9Zfv1X2fVEQhTw51lKENdNrEqT3,44,32,24,0,20,2,11,0,89,12.714285714285714,3,0.0,0,24,0,20,32,2,0,11,0,44,45,0
822,26435,N0Sos51WanCzoSGKDmMPzQtMlLxY3bFb,bWdj2GDclj5ofokWjzoa5jAwMkxCykd6,10,10,7,0,1,10,7,1,36,5.142857142857143,3,0.0,1,7,0,1,9,10,0,7,1,9,27,0
823,26442,C8XrXSQZNN8RR6xEeSRWbKA5jTxVTtPT,SpATywNh6bZuzm8s1ceuBUnMUAeoAHHw,8,10,8,0,4,0,4,0,26,3.7142857142857144,2,0.0,0,8,0,4,10,0,0,4,0,12,14,0
824,26499,5dvfr5EjWeXuIobwrgh7MVbCslwNXi21,SpATywNh6bZuzm8s1ceuBUnMUAeoAHHw,15,49,5,9,3,0,3,0,69,9.857142857142858,2,0.0,15,5,8,3,34,0,1,3,0,31,38,0
825,26511,wdK5DIKl9qd73hM1uOx3ufcKj0J9AcRr,SpATywNh6bZuzm8s1ceuBUnMUAeoAHHw,5,11,6,0,0,0,4,0,21,3.0,4,0.0,0,6,0,0,11,0,0,4,0,6,15,1
826,26595,ZRB8OhpRpRUzGZm1XUTryPd3ZIuqeZkS,SpATywNh6bZuzm8s1ceuBUnMUAeoAHHw,24,38,5,28,3,0,6,0,80,11.428571428571429,2,0.0,11,5,23,3,27,0,5,6,0,42,38,0
827,26625,chwuEH1iMc682zjOmO4zFwwfUl1drv8Q,RXDvfPUBYFlVdlueBFbLW0mhhAyGEqpt,5,1,1,0,1,0,9,0,12,1.7142857142857142,3,0.0,0,1,0,1,1,0,0,9,0,2,10,0
828,26678,OsS1Y0pb3ORCYhSo3uyNzAmfIGWlMI5F,SpATywNh6bZuzm8s1ceuBUnMUAeoAHHw,21,28,0,19,0,12,9,2,70,10.0,2,0.0,7,0,18,0,21,12,1,9,2,25,45,1
829,26699,2WPAcVd6xHOkO7YPphHLRGJqR9SuLhLc,SpATywNh6bZuzm8s1ceuBUnMUAeoAHHw,19,22,10,26,5,0,4,0,67,9.571428571428571,1,0.0,11,10,23,5,11,0,3,4,0,49,18,0
830,26704,OF8cZCIXPsuM4CdS1yd3vA1SWWYblMbf,SpATywNh6bZuzm8s1ceuBUnMUAeoAHHw,17,17,9,14,4,0,3,0,47,6.714285714285714,3,0.0,5,9,13,4,12,0,1,3,0,31,16,0
831,26769,QKh6yCjm7KCBJwTgcTdbJMWujg3bWjbd,SpATywNh6bZuzm8s1ceuBUnMUAeoAHHw,3,2,1,0,0,0,1,0,4,0.5714285714285714,1,0.0,0,1,0,0,2,0,0,1,0,1,3,0
832,26806,v3af5rWc4AOfzZv6mvaIgDKPH5PLVH0T,RXDvfPUBYFlVdlueBFbLW0mhhAyGEqpt,12,15,7,0,1,40,17,2,82,11.714285714285714,2,0.0,0,7,0,1,15,40,0,17,2,8,74,0
833,26857,g44r9jnfvUwG99HEAhIahumgutn1iCtI,SpATywNh6bZuzm8s1ceuBUnMUAeoAHHw,4,2,0,0,0,0,3,0,5,0.7142857142857143,2,0.0,0,0,0,0,2,0,0,3,0,0,5,0
834,26878,zNRtwNQkiCM9OW1nTIM2OGHUm9Iu3JVP,RXDvfPUBYFlVdlueBFbLW0mhhAyGEqpt,2,0,0,0,0,0,2,0,2,0.2857142857142857,1,0.0,0,0,0,0,0,0,0,2,0,0,2,0
835,26879,nE23LYiQpabdXkj6YvKSja9sZnHRizmo,A3fsA9Zfv1X2fVEQhTw51lKENdNrEqT3,14,45,0,0,0,0,6,0,51,7.285714285714286,6,0.0,0,0,0,0,45,0,0,6,0,0,51,0
836,26894,oEaD8Zao03KxJihTh9QEYpbyK6kjdhuu,bWdj2GDclj5ofokWjzoa5jAwMkxCykd6,1,0,0,0,0,0,1,0,1,0.14285714285714285,1,0.0,0,0,0,0,0,0,0,1,0,0,1,1
837,26899,SKqtOWa2uBCWLrCYlzFMjf1B70kuA2m8,SpATywNh6bZuzm8s1ceuBUnMUAeoAHHw,17,14,9,9,3,0,3,0,38,5.428571428571429,2,0.0,2,9,8,3,12,0,1,3,0,22,16,0
838,26923,PQxAX7A8tQB7sGIcC9YvDjqPxTwtHPvm,SpATywNh6bZuzm8s1ceuBUnMUAeoAHHw,5,7,3,0,0,0,5,0,15,2.142857142857143,2,0.0,0,3,0,0,7,0,0,5,0,3,12,0
839,26924,vptj4ETLtFQ4ma0zcDVByNO4VFhFTiIc,SpATywNh6bZuzm8s1ceuBUnMUAeoAHHw,14,53,6,15,2,3,3,0,82,11.714285714285714,4,0.0,22,6,15,2,31,3,0,3,0,45,37,0
840,26946,DsHgWZRTJ1y1l15smwhB78ZQq3d8dyKP,A3fsA9Zfv1X2fVEQhTw51lKENdNrEqT3,1,0,0,0,0,0,1,0,1,0.14285714285714285,1,0.0,0,0,0,0,0,0,0,1,0,0,1,0
841,26980,eHoa4dnAqoZqw72CCle00GlHxpp5Lihg,SpATywNh6bZuzm8s1ceuBUnMUAeoAHHw,27,39,19,27,11,5,5,0,106,15.142857142857142,4,0.0,16,19,26,11,23,5,1,5,0,72,34,0
842,27064,ZMTcKQbBQl56kBXzK6ZZeR0SWzh1XSjd,A3fsA9Zfv1X2fVEQhTw51lKENdNrEqT3,5,4,3,0,0,0,1,0,8,1.1428571428571428,1,0.0,0,3,0,0,4,0,0,1,0,3,5,0
843,27107,GNsGzjFSidI9fBCvT9fI5F8kfuYTc1I2,SpATywNh6bZuzm8s1ceuBUnMUAeoAHHw,2,0,0,0,0,2,1,0,3,0.42857142857142855,1,0.0,0,0,0,0,0,2,0,1,0,0,3,0
844,27116,Y1uVq657IWCue4abNsh62IVHKtmwsQHQ,G8EPVSXsOYB5YQWZGiz1aVq5Pgr2GrQu,1,0,0,0,0,0,1,0,1,0.14285714285714285,1,0.0,0,0,0,0,0,0,0,1,0,0,1,0
845,27161,TNArortVQm3F09odJ2W3xdM27lVc5PiX,7GRhBDsirIGkRZBtSMEzNTyDr2JQm4xx,7,6,1,6,2,0,1,0,16,2.2857142857142856,1,0.0,3,1,5,2,3,0,1,1,0,11,5,1
846,27164,q0GZFChoVOuhzxYur1QICnKH6imiHQh6,SpATywNh6bZuzm8s1ceuBUnMUAeoAHHw,17,24,9,24,0,1,11,1,70,10.0,3,0.0,4,9,24,0,20,1,0,11,1,37,33,0
847,27178,3GyWUBVi0ZEtgDniG78bG37zc4UZrPNu,RXDvfPUBYFlVdlueBFbLW0mhhAyGEqpt,21,27,11,24,6,6,4,0,78,11.142857142857142,2,0.0,7,11,23,6,20,6,1,4,0,47,31,1
848,27187,imtJFGBCtMAkOvvJ09P5N0sgBTGSUYzd,SpATywNh6bZuzm8s1ceuBUnMUAeoAHHw,14,14,6,16,3,0,1,0,40,5.714285714285714,1,0.0,7,6,14,3,7,0,2,1,0,30,10,0
849,27189,PYm9QxL1CCjHYX7XOqp8vXAiT1dnOhc3,SpATywNh6bZuzm8s1ceuBUnMUAeoAHHw,1,0,0,0,0,0,1,0,1,0.14285714285714285,1,0.0,0,0,0,0,0,0,0,1,0,0,1,1
850,27223,amNosdi6Uiilljdy8esSBA3F29NKPLUW,SpATywNh6bZuzm8s1ceuBUnMUAeoAHHw,1,0,0,0,0,0,1,0,1,0.14285714285714285,1,0.0,0,0,0,0,0,0,0,1,0,0,1,1
851,27336,uHeTIz8GkglZUts3zio1tGR2aBoYwiQE,A3fsA9Zfv1X2fVEQhTw51lKENdNrEqT3,28,9,5,60,2,0,1,0,77,11.0,1,0.0,1,5,58,2,8,0,2,1,0,66,11,1
852,27364,VxTZo8wWibkIng7J8YPkqWh1rsEKvqTC,7GRhBDsirIGkRZBtSMEzNTyDr2JQm4xx,3,4,2,0,2,0,0,0,8,1.1428571428571428,3,0.0,0,2,0,2,4,0,0,0,0,4,4,0
853,27404,HDD1g3rYbRszzNZAvMB0irAHbU4W6xUO,SpATywNh6bZuzm8s1ceuBUnMUAeoAHHw,18,48,1,15,0,6,5,1,76,10.857142857142858,3,0.0,14,1,14,0,34,6,1,5,1,29,47,1
854,27429,IYFIdswDKEsO4j14D9vS4fhZEQBqA7vK,SpATywNh6bZuzm8s1ceuBUnMUAeoAHHw,3,2,1,0,0,0,2,0,5,0.7142857142857143,2,0.0,0,1,0,0,2,0,0,2,0,1,4,0
855,27497,g6Nv7zrAUSY5suYgQ1EV1HY4bAaM1IoO,A3fsA9Zfv1X2fVEQhTw51lKENdNrEqT3,2,0,0,0,0,0,6,0,6,0.8571428571428571,1,0.0,0,0,0,0,0,0,0,6,0,0,6,1
856,27501,rfOApTbQ4xF2665bHZIBhoJqQcTU6i9L,SpATywNh6bZuzm8s1ceuBUnMUAeoAHHw,31,33,18,12,10,5,8,0,86,12.285714285714286,2,0.0,11,18,12,10,22,5,0,8,0,51,35,0
857,27535,VQ4FtoMJj29hpPrAQ6LMEGesAofjErC4,G8EPVSXsOYB5YQWZGiz1aVq5Pgr2GrQu,12,20,1,4,0,9,7,2,43,6.142857142857143,2,0.0,10,1,2,0,10,9,2,7,2,13,30,0
858,27536,p7V6MquT5r2C7VmRzYjQEOsKx7s5gJug,SpATywNh6bZuzm8s1ceuBUnMUAeoAHHw,3,4,2,0,0,0,3,0,9,1.2857142857142858,2,0.0,0,2,0,0,4,0,0,3,0,2,7,0
859,30658,Sk4DUKJRImF6lijTnkABuH01jDj9zcnP,7GRhBDsirIGkRZBtSMEzNTyDr2JQm4xx,6,9,3,0,1,0,1,0,14,2.0,1,0.0,5,3,0,1,4,0,0,1,0,9,5,0
860,30700,uAXW7zeSaEEtMIdMcVsYpUquscAKUnr7,7GRhBDsirIGkRZBtSMEzNTyDr2JQm4xx,7,10,9,0,7,0,1,0,27,3.857142857142857,1,0.0,0,9,0,7,10,0,0,1,0,16,11,1
861,30706,2aVoBs6PX62Evhzhd5ZYUQ5juZY4Z8Ua,7GRhBDsirIGkRZBtSMEzNTyDr2JQm4xx,4,4,1,0,1,0,0,0,6,0.8571428571428571,2,0.0,0,1,0,1,4,0,0,0,0,2,4,0
862,30778,vocq2qTAQIpXo7NloCyQjKAwRekZv7g6,A3fsA9Zfv1X2fVEQhTw51lKENdNrEqT3,5,48,7,0,0,0,19,0,74,10.571428571428571,4,0.0,0,7,0,0,48,0,0,19,0,7,67,1
863,30813,9mbf3ur4VQ377zp6wWXm0F44HQK66rP5,SpATywNh6bZuzm8s1ceuBUnMUAeoAHHw,22,33,4,12,4,6,12,4,75,10.714285714285714,3,0.0,10,4,10,4,23,6,2,12,4,28,47,0
864,30818,aRrVk5Mj3FLAOkeQfPKXeuOPNpHy5HUB,RXDvfPUBYFlVdlueBFbLW0mhhAyGEqpt,71,84,49,143,21,20,19,2,338,48.285714285714285,3,0.0,17,49,132,21,67,20,11,19,2,219,119,0
865,30823,jLGWqcJWbPwbqDpaLuVE2buM1VcjzYrZ,A3fsA9Zfv1X2fVEQhTw51lKENdNrEqT3,74,40,34,170,28,0,4,0,276,39.42857142857143,2,0.0,2,34,148,28,38,0,22,4,0,212,64,0
866,30875,7xwH0IGxUu9oyiAWk7HpSQpakcHGIuLy,G8EPVSXsOYB5YQWZGiz1aVq5Pgr2GrQu,3,2,0,0,0,4,2,0,8,1.1428571428571428,1,0.0,0,0,0,0,2,4,0,2,0,0,8,0
867,30915,8HJiZoOTUArj8ouKObToEc9cbZd1p0Hh,SpATywNh6bZuzm8s1ceuBUnMUAeoAHHw,19,21,11,12,7,0,2,0,53,7.571428571428571,1,0.0,8,11,12,7,13,0,0,2,0,38,15,1
868,30926,JODIGhSXEMOFdMb0BMfI1hphmGCcGiv9,7GRhBDsirIGkRZBtSMEzNTyDr2JQm4xx,6,6,4,0,2,0,2,0,14,2.0,1,0.0,0,4,0,2,6,0,0,2,0,6,8,1
869,30960,HFSA5mZu8SjtTZt5y8xxQ1NSNLuijpbs,SpATywNh6bZuzm8s1ceuBUnMUAeoAHHw,14,7,4,9,3,1,6,0,30,4.285714285714286,1,0.0,2,4,8,3,5,1,1,6,0,17,13,0
870,30986,8KSstsh3YYhIzd54fsYY1T96OfiCGWLi,SpATywNh6bZuzm8s1ceuBUnMUAeoAHHw,14,35,9,22,0,0,14,0,80,11.428571428571429,3,0.0,22,9,21,0,13,0,1,14,0,52,28,0
871,30996,WNlTer437rP0ycEd1BKVfCjGSSopiPqX,SpATywNh6bZuzm8s1ceuBUnMUAeoAHHw,7,8,2,0,0,29,13,0,52,7.428571428571429,4,0.0,1,2,0,0,7,29,0,13,0,3,49,0
872,31002,EfteYUnYYLq9uOBoKEC0F2UwFqIZoKtW,RXDvfPUBYFlVdlueBFbLW0mhhAyGEqpt,28,34,21,46,13,0,2,0,116,16.571428571428573,4,0.0,10,21,45,13,24,0,1,2,0,89,27,0
873,31033,uUSTKM8g1hIskJbYHh1UiIQ6epHTSTNR,SpATywNh6bZuzm8s1ceuBUnMUAeoAHHw,18,28,10,32,2,0,1,0,73,10.428571428571429,1,0.0,15,10,28,2,13,0,4,1,0,55,18,0
874,31153,rIlg2veK76CYPAY7z09GokFHQqwC8sW7,SpATywNh6bZuzm8s1ceuBUnMUAeoAHHw,14,22,1,8,1,0,4,0,36,5.142857142857143,3,0.0,4,1,7,1,18,0,1,4,0,13,23,0
875,31167,4bLrsVDvLnrTqHqeIpcqQPyvl02eai7n,A3fsA9Zfv1X2fVEQhTw51lKENdNrEqT3,1,0,0,0,0,0,1,0,1,0.14285714285714285,1,0.0,0,0,0,0,0,0,0,1,0,0,1,1
876,31186,71r0cSGOl797B6z3Ozx79KsmcnthtUKF,RXDvfPUBYFlVdlueBFbLW0mhhAyGEqpt,23,41,4,19,4,12,8,1,89,12.714285714285714,3,0.0,5,4,19,4,36,12,0,8,1,32,57,0
877,31204,YOx6Tvp6HBSp6Lo310sbWxV28yIh3XN8,G8EPVSXsOYB5YQWZGiz1aVq5Pgr2GrQu,6,12,5,0,0,0,4,0,21,3.0,2,0.0,3,5,0,0,9,0,0,4,0,8,13,0
878,31220,s6iksgptFmyh2vfiarKdJkiKnp6RLi3f,SpATywNh6bZuzm8s1ceuBUnMUAeoAHHw,21,22,12,13,6,25,3,0,81,11.571428571428571,2,0.0,6,12,12,6,16,25,1,3,0,36,45,0
879,31242,Qn3OccgDXQpcut9yLA9jXfau6FPbS72n,SpATywNh6bZuzm8s1ceuBUnMUAeoAHHw,5,4,0,0,0,0,6,0,10,1.4285714285714286,2,0.0,0,0,0,0,4,0,0,6,0,0,10,0
880,31273,llEGY9nmTOZhiXi105AGZUS4gAhSawAh,SpATywNh6bZuzm8s1ceuBUnMUAeoAHHw,20,21,9,18,4,4,8,1,65,9.285714285714286,2,0.0,5,9,16,4,16,4,2,8,1,34,31,0
881,31280,juUpKesViORjdDJidJ4RSlxH0qwbmcck,SpATywNh6bZuzm8s1ceuBUnMUAeoAHHw,19,48,24,5,18,3,2,0,100,14.285714285714286,2,0.0,8,24,4,18,40,3,1,2,0,54,46,0
882,31316,sl67PTvziUv3kTFj6qEnYHRaFoNTaM8y,SpATywNh6bZuzm8s1ceuBUnMUAeoAHHw,11,9,7,0,5,0,2,0,23,3.2857142857142856,1,0.0,0,7,0,5,9,0,0,2,0,12,11,0
883,31356,zIHhHIwIbH6mJbe3ZAvW2ovaPewaq0E0,SpATywNh6bZuzm8s1ceuBUnMUAeoAHHw,3,2,1,0,0,0,1,0,4,0.5714285714285714,1,0.0,0,1,0,0,2,0,0,1,0,1,3,0
884,31360,QVtQEOECDBxqQMPDJLsWNOlhwI5DCP74,SpATywNh6bZuzm8s1ceuBUnMUAeoAHHw,20,52,22,18,11,42,8,3,156,22.285714285714285,3,0.0,10,22,15,11,42,42,3,8,3,58,98,0
885,31371,YkxwabMuriYpqC21021WUsYLLutSSx4O,SpATywNh6bZuzm8s1ceuBUnMUAeoAHHw,18,21,14,12,7,0,3,6,63,9.0,5,0.0,3,14,11,7,18,0,1,3,6,35,28,0
886,31389,QAV02IL7ajntDdHVirqabwTRIN1Sa6iz,SpATywNh6bZuzm8s1ceuBUnMUAeoAHHw,3,6,0,0,0,0,5,0,11,1.5714285714285714,2,0.0,0,0,0,0,6,0,0,5,0,0,11,0
887,31392,p6Izm60d3R0uvZiSe15AoVnOEu77nAhg,SpATywNh6bZuzm8s1ceuBUnMUAeoAHHw,3,0,0,0,0,4,3,0,7,1.0,1,0.0,0,0,0,0,0,4,0,3,0,0,7,0
888,31399,VBP5PzVQEKJYFH0y5ffEek5WfP9EW7uc,SpATywNh6bZuzm8s1ceuBUnMUAeoAHHw,1,0,0,0,0,0,4,0,4,0.5714285714285714,3,0.0,0,0,0,0,0,0,0,4,0,0,4,0
889,31400,S9MHz2GfayML2H9BuRARNQ0WUO9mAJgZ,SpATywNh6bZuzm8s1ceuBUnMUAeoAHHw,3,2,1,0,0,0,3,0,6,0.8571428571428571,2,0.0,0,1,0,0,2,0,0,3,0,1,5,0
890,31459,1xFsl22T8LEiEJ3kwPWguQfPNcGWZ8JV,7GRhBDsirIGkRZBtSMEzNTyDr2JQm4xx,1,1,0,0,0,0,0,0,1,0.14285714285714285,1,0.0,0,0,0,0,1,0,0,0,0,0,1,1
891,31500,EQgg3GYPXWNLa9U010kt5ZSvruPXJLGA,SpATywNh6bZuzm8s1ceuBUnMUAeoAHHw,7,9,5,0,3,0,2,0,19,2.7142857142857144,2,0.0,0,5,0,3,9,0,0,2,0,8,11,0
892,31503,YwFTXHSC31SX1LraRWOGlHPt5rdaD4Vy,SpATywNh6bZuzm8s1ceuBUnMUAeoAHHw,9,14,7,3,0,85,6,0,115,16.428571428571427,2,0.0,5,7,3,0,9,85,0,6,0,15,100,0
893,31544,NqCDW2Wa7d0wWx7VYLXJDwB6ylSM8NEL,G8EPVSXsOYB5YQWZGiz1aVq5Pgr2GrQu,35,44,11,50,0,1,10,0,116,16.571428571428573,2,0.0,17,11,31,0,27,1,19,10,0,59,57,0
894,31573,VWrks7JFbeZpwdWqwwZkJoHpmfIv7cqz,7GRhBDsirIGkRZBtSMEzNTyDr2JQm4xx,5,5,4,0,1,0,0,0,10,1.4285714285714286,1,0.0,0,4,0,1,5,0,0,0,0,5,5,0
895,31728,mpNBMReKZvwryUvgjwY0cwVFK7aOune8,SpATywNh6bZuzm8s1ceuBUnMUAeoAHHw,19,19,9,15,4,0,5,0,52,7.428571428571429,2,0.0,8,9,15,4,11,0,0,5,0,36,16,0
896,31804,lHdOeTUXYVL6iAgJVxxf5RxusHAIMUqu,SpATywNh6bZuzm8s1ceuBUnMUAeoAHHw,1,0,0,0,0,0,2,0,2,0.2857142857142857,1,0.0,0,0,0,0,0,0,0,2,0,0,2,0
897,31834,8nijJeJQ3xDzhCTAr7Z0RTVPHqfdjajs,SpATywNh6bZuzm8s1ceuBUnMUAeoAHHw,1,0,0,0,0,0,1,0,1,0.14285714285714285,1,0.0,0,0,0,0,0,0,0,1,0,0,1,0
898,31878,VXwRO03Gu4QrNRkeAj0lYc8T94Ap4aw5,SpATywNh6bZuzm8s1ceuBUnMUAeoAHHw,13,17,2,21,1,0,2,0,43,6.142857142857143,2,0.0,4,2,18,1,13,0,3,2,0,25,18,0
899,32014,t8eDuPU4MsZrMH2MoE1n7JeYLVBJZOGD,SpATywNh6bZuzm8s1ceuBUnMUAeoAHHw,3,2,1,0,0,0,2,0,5,0.7142857142857143,1,0.0,0,1,0,0,2,0,0,2,0,1,4,0
900,32114,MOcMwRKo0dtFqZ5xWBgRzquuZGKtQyf4,7GRhBDsirIGkRZBtSMEzNTyDr2JQm4xx,16,36,12,4,11,0,4,0,67,9.571428571428571,2,0.0,6,12,4,11,30,0,0,4,0,33,34,1
901,32122,ZvU0YqNTtgKWTlVIbqvnVys23p5WRiDJ,SpATywNh6bZuzm8s1ceuBUnMUAeoAHHw,2,2,1,0,0,58,0,0,61,8.714285714285714,1,0.0,0,1,0,0,2,58,0,0,0,1,60,0
902,32168,RHl3DsvAX7TisJ7qBptmgrrtDAQvH7mr,SpATywNh6bZuzm8s1ceuBUnMUAeoAHHw,7,13,4,14,0,0,3,0,34,4.857142857142857,3,0.0,2,4,12,0,11,0,2,3,0,18,16,0
903,32208,bNZH4hUHavni696ZcBLvxZCrBSALUDxX,SpATywNh6bZuzm8s1ceuBUnMUAeoAHHw,4,2,1,0,1,0,1,0,5,0.7142857142857143,2,0.0,0,1,0,1,2,0,0,1,0,2,3,0
904,32244,jN0wpnfaU5DsLxvEqII5WFiC356NJUbF,SpATywNh6bZuzm8s1ceuBUnMUAeoAHHw,3,2,1,0,0,0,1,0,4,0.5714285714285714,1,0.0,0,1,0,0,2,0,0,1,0,1,3,1
905,32263,kAQFM0dEgOQIxOG9jTMe5puRtNxZZWMN,bWdj2GDclj5ofokWjzoa5jAwMkxCykd6,31,20,2,84,2,0,3,0,111,15.857142857142858,3,0.0,6,2,73,2,14,0,11,3,0,83,28,0
906,32269,kCqsvQZpasUHfVJzYbijAKww9O0shrRg,RXDvfPUBYFlVdlueBFbLW0mhhAyGEqpt,25,37,5,20,2,14,14,0,92,13.142857142857142,3,0.0,0,5,14,2,37,14,6,14,0,21,71,0
907,32284,wkkLqkPlDLOrNrbR4UCtQIDxtXcGov1B,SpATywNh6bZuzm8s1ceuBUnMUAeoAHHw,4,4,1,0,0,0,2,0,7,1.0,1,0.0,0,1,0,0,4,0,0,2,0,1,6,1
908,32309,MZpeXlPtlAGSfwuC5xwB1U0DIOZvGtVZ,SpATywNh6bZuzm8s1ceuBUnMUAeoAHHw,2,0,0,0,0,0,4,0,4,0.5714285714285714,2,0.0,0,0,0,0,0,0,0,4,0,0,4,0
909,32319,PZyZDM2uyBRGPZg3kQscavWjpR2bFYiU,SpATywNh6bZuzm8s1ceuBUnMUAeoAHHw,16,11,9,11,5,4,7,1,48,6.857142857142857,1,0.0,0,9,11,5,11,4,0,7,1,25,23,0
910,32346,rrZSZFoEgH3bOKdkZ0UyNzOq7Pdyx5G0,SpATywNh6bZuzm8s1ceuBUnMUAeoAHHw,20,43,2,4,1,13,12,3,78,11.142857142857142,1,0.0,5,2,4,1,38,13,0,12,3,12,66,0
911,32359,aLRP3ahB5SIcOn5vpM1VPEh9ib2QIioX,SpATywNh6bZuzm8s1ceuBUnMUAeoAHHw,18,26,10,8,5,0,8,0,57,8.142857142857142,6,0.0,2,10,7,5,24,0,1,8,0,24,33,0
912,32385,rIb3lxEaK77vmLDTqDgCNFDZAYjyvbtK,7GRhBDsirIGkRZBtSMEzNTyDr2JQm4xx,3,4,2,0,0,0,2,0,8,1.1428571428571428,2,0.0,0,2,0,0,4,0,0,2,0,2,6,1
913,32409,9iGaqBGS5kkoXjLd87hUL2eIJMVUVKfU,G8EPVSXsOYB5YQWZGiz1aVq5Pgr2GrQu,4,9,3,0,0,0,3,0,15,2.142857142857143,1,0.0,0,3,0,0,9,0,0,3,0,3,12,0
914,32426,gGSMkNgPdXpBQgdZzyjzifomyCxFSNyt,bWdj2GDclj5ofokWjzoa5jAwMkxCykd6,8,20,8,0,1,0,10,0,39,5.571428571428571,4,0.0,0,8,0,1,20,0,0,10,0,9,30,0
915,32436,QqE2Xjwy9gUzOvFdkDqAwAaNZLBZkxvd,SpATywNh6bZuzm8s1ceuBUnMUAeoAHHw,7,17,1,0,0,0,13,0,31,4.428571428571429,3,0.0,0,1,0,0,17,0,0,13,0,1,30,0
916,32464,QAguKdvn52pCJKW91rO3BCY8l8ZCAdvQ,A3fsA9Zfv1X2fVEQhTw51lKENdNrEqT3,53,38,29,62,21,5,16,3,174,24.857142857142858,2,0.0,1,29,59,21,37,5,3,16,3,110,64,0
917,32484,QqE2Xjwy9gUzOvFdkDqAwAaNZLBZkxvd,A3fsA9Zfv1X2fVEQhTw51lKENdNrEqT3,2,0,0,0,0,0,4,0,4,0.5714285714285714,2,0.0,0,0,0,0,0,0,0,4,0,0,4,0
918,32492,5NsbP59FWlyl4NFONUzt3drLLr5EFRFj,G8EPVSXsOYB5YQWZGiz1aVq5Pgr2GrQu,3,2,1,0,0,0,1,0,4,0.5714285714285714,1,0.0,0,1,0,0,2,0,0,1,0,1,3,1
919,32577,fNAZ3rWuqq8OkAKKKUzZOQQ9DpAle4lu,SpATywNh6bZuzm8s1ceuBUnMUAeoAHHw,3,2,1,0,0,0,2,0,5,0.7142857142857143,1,0.0,0,1,0,0,2,0,0,2,0,1,4,0
920,32647,vBbIZDmFTh3FCbK0DEiE7jyE0eCpDvg4,RXDvfPUBYFlVdlueBFbLW0mhhAyGEqpt,27,19,11,32,4,4,8,1,79,11.285714285714286,1,0.0,4,11,31,4,15,4,1,8,1,50,29,0
921,32685,MaXB6YBpSNUvXtEuCcY3Jwa8jwvsWVE8,G8EPVSXsOYB5YQWZGiz1aVq5Pgr2GrQu,36,71,2,8,2,0,7,1,91,13.0,1,0.0,16,2,4,2,55,0,4,7,1,24,67,0
922,32694,bVveXRWwKdTb7eqX4rWDKBUhdf8PtEkw,SpATywNh6bZuzm8s1ceuBUnMUAeoAHHw,3,4,2,0,0,0,1,0,7,1.0,3,0.0,0,2,0,0,4,0,0,1,0,2,5,0
923,32844,b1eRrhapWSjtM2Ih9Xn0eBEZAyjqmlvI,SpATywNh6bZuzm8s1ceuBUnMUAeoAHHw,4,4,2,0,0,6,4,0,16,2.2857142857142856,3,0.0,0,2,0,0,4,6,0,4,0,2,14,0
924,32874,67ZqfHh3zcLqo5qUacGllEiszIkOne95,G8EPVSXsOYB5YQWZGiz1aVq5Pgr2GrQu,26,96,63,0,67,1,18,1,246,35.142857142857146,5,0.0,12,63,0,67,84,1,0,18,1,142,104,0
925,32901,4JyZWYWxxqGCPr9dTz7bgpLcCXWs003A,SpATywNh6bZuzm8s1ceuBUnMUAeoAHHw,7,11,5,0,4,0,10,0,30,4.285714285714286,1,0.0,0,5,0,4,11,0,0,10,0,9,21,0
926,32938,zZwP4suQybM1gcslFDQ5UITiG9iZ789v,SpATywNh6bZuzm8s1ceuBUnMUAeoAHHw,14,20,12,12,2,4,4,2,56,8.0,1,0.0,4,12,9,2,16,4,3,4,2,27,29,0
927,32988,mZVWUPFbkuZINQtykHT2ZyZY5zMXgvJ7,SpATywNh6bZuzm8s1ceuBUnMUAeoAHHw,19,16,2,16,2,0,5,1,42,6.0,2,0.0,2,2,14,2,14,0,2,5,1,20,22,0
928,33001,ZFpXjzvya7Y5x9HmUsgToer6v1L16WM2,SpATywNh6bZuzm8s1ceuBUnMUAeoAHHw,5,4,3,0,1,0,1,0,9,1.2857142857142858,1,0.0,0,3,0,1,4,0,0,1,0,4,5,0
929,33017,GFBEJrga7DM4UEcrt340p3oRNaL97Gn4,SpATywNh6bZuzm8s1ceuBUnMUAeoAHHw,5,3,2,0,0,0,3,0,8,1.1428571428571428,1,0.0,0,2,0,0,3,0,0,3,0,2,6,0
930,33018,gi1cGXmBNmpbe6lA2hzKFh8EEd7gQMCM,SpATywNh6bZuzm8s1ceuBUnMUAeoAHHw,2,0,0,0,0,0,2,0,2,0.2857142857142857,1,0.0,0,0,0,0,0,0,0,2,0,0,2,0
931,33058,fNAZ3rWuqq8OkAKKKUzZOQQ9DpAle4lu,RXDvfPUBYFlVdlueBFbLW0mhhAyGEqpt,3,2,1,0,0,0,2,0,5,0.7142857142857143,1,0.0,0,1,0,0,2,0,0,2,0,1,4,0
932,33062,ZVmjT1rppq7ilCPRRtmAl1wo0gOugsCt,RXDvfPUBYFlVdlueBFbLW0mhhAyGEqpt,54,78,54,104,37,2,7,0,282,40.285714285714285,4,0.0,16,54,101,37,62,2,3,7,0,208,74,0
933,33113,PjZvizXDkcC0c394BYUQIpEWacrPH7EJ,SpATywNh6bZuzm8s1ceuBUnMUAeoAHHw,14,10,0,10,0,19,8,2,49,7.0,1,0.0,2,0,9,0,8,19,1,8,2,11,38,1
934,33145,UUY3BPLR7A3Xa6FGsztMCn6xCbxtdCYu,SpATywNh6bZuzm8s1ceuBUnMUAeoAHHw,22,18,10,6,8,2,2,0,46,6.571428571428571,2,0.0,7,10,6,8,11,2,0,2,0,31,15,0
935,33146,aFVLxK4Hau9wDglF79kWvvimpoa2MXNc,SpATywNh6bZuzm8s1ceuBUnMUAeoAHHw,5,5,4,0,0,0,2,0,11,1.5714285714285714,1,0.0,0,4,0,0,5,0,0,2,0,4,7,1
936,33187,yiWok4eQ5hgdJ8eYi2O0qHhy67Y9EA3E,SpATywNh6bZuzm8s1ceuBUnMUAeoAHHw,1,0,0,0,0,0,1,0,1,0.14285714285714285,1,0.0,0,0,0,0,0,0,0,1,0,0,1,0
937,33199,r9mrNmOIUUDf7AorDYXKUl4G7R8wfHcf,SpATywNh6bZuzm8s1ceuBUnMUAeoAHHw,17,18,9,19,6,1,2,0,55,7.857142857142857,1,0.0,5,9,17,6,13,1,2,2,0,37,18,0
938,33234,we9tWnySpl1G7k7FqyXPj8wmC2gUYK0W,A3fsA9Zfv1X2fVEQhTw51lKENdNrEqT3,4,3,0,0,0,0,1,0,4,0.5714285714285714,1,0.0,0,0,0,0,3,0,0,1,0,0,4,0
939,33280,1vY5OZ1u5dkB4jIpVDeMNw33uHVvYDm0,G8EPVSXsOYB5YQWZGiz1aVq5Pgr2GrQu,14,23,8,0,30,0,1,0,62,8.857142857142858,1,0.0,1,8,0,30,22,0,0,1,0,39,23,0
940,33401,qV3ci4HSmOh0O2gqYUVjaVHqqz2r9u2d,G8EPVSXsOYB5YQWZGiz1aVq5Pgr2GrQu,5,3,1,0,0,0,2,0,6,0.8571428571428571,1,0.0,0,1,0,0,3,0,0,2,0,1,5,1
941,33416,viuKt4GgrX0rYL5EpHoxJbsiC9TblSuk,SpATywNh6bZuzm8s1ceuBUnMUAeoAHHw,31,53,25,0,11,85,20,2,196,28.0,4,0.0,20,25,0,11,33,85,0,20,2,56,140,0
942,33426,SbSUciasvLhHVTorJDvZBPRhwTmOgntH,SpATywNh6bZuzm8s1ceuBUnMUAeoAHHw,8,9,1,0,1,0,3,0,14,2.0,1,0.0,0,1,0,1,9,0,0,3,0,2,12,0
943,33475,0KNVWAChIRBDwntcO5Dr5l3KgkUsRh3O,SpATywNh6bZuzm8s1ceuBUnMUAeoAHHw,8,13,1,0,0,0,1,0,15,2.142857142857143,3,0.0,0,1,0,0,13,0,0,1,0,1,14,0
944,33493,1vY5OZ1u5dkB4jIpVDeMNw33uHVvYDm0,SpATywNh6bZuzm8s1ceuBUnMUAeoAHHw,5,7,4,0,1,0,3,0,15,2.142857142857143,1,0.0,0,4,0,1,7,0,0,3,0,5,10,0
945,33513,H2Rgqo3kRDsNdbNVEDl0788s9SSdLM8P,7GRhBDsirIGkRZBtSMEzNTyDr2JQm4xx,11,24,4,4,4,0,3,0,39,5.571428571428571,3,0.0,6,4,3,4,18,0,1,3,0,17,22,1
946,33520,qmYTrueiQKfoQnGxjqfwlMlw7HOR9CKj,A3fsA9Zfv1X2fVEQhTw51lKENdNrEqT3,49,1281,52,78,20,0,14,0,1445,206.42857142857142,5,0.0,3,52,60,20,1278,0,18,14,0,135,1310,0
947,33579,wFWVvTUKN4Nj5vWrbX5PVi6EvLKq8sqa,SpATywNh6bZuzm8s1ceuBUnMUAeoAHHw,32,34,14,38,8,4,10,5,113,16.142857142857142,2,0.0,15,14,31,8,19,4,7,10,5,68,45,0
948,33601,B9KqNNxXBxHFUsJnQKQysblL3f8zF7sg,7GRhBDsirIGkRZBtSMEzNTyDr2JQm4xx,23,77,4,0,8,0,4,0,93,13.285714285714286,3,0.0,45,4,0,8,32,0,0,4,0,57,36,0
949,33639,3bwizzI2zhkZarj0AirZFGuMorcba8W4,SpATywNh6bZuzm8s1ceuBUnMUAeoAHHw,21,18,13,10,8,4,12,4,69,9.857142857142858,2,0.0,2,13,9,8,16,4,1,12,4,32,37,1
950,33643,InrAmtl2MgoSpFoohTtv1oXbh4bisxXW,bWdj2GDclj5ofokWjzoa5jAwMkxCykd6,3,2,0,0,0,0,1,0,3,0.42857142857142855,1,0.0,0,0,0,0,2,0,0,1,0,0,3,0
951,33666,RCdcltNaQLfcoxT7YKTjQxAYUbCmzzKd,A3fsA9Zfv1X2fVEQhTw51lKENdNrEqT3,39,27,21,86,11,2,7,0,154,22.0,3,0.0,1,21,71,11,26,2,15,7,0,104,50,0
952,34602,bS2IOWKbnbandmSXQXzI1vhjNhpDoKfN,7GRhBDsirIGkRZBtSMEzNTyDr2JQm4xx,17,23,6,54,4,2,2,0,91,13.0,6,0.0,6,6,46,4,17,2,8,2,0,62,29,1
953,34683,tEGUB4A2P1CFVrtUpVRZCuET3K7QndSr,7GRhBDsirIGkRZBtSMEzNTyDr2JQm4xx,8,5,3,0,2,0,6,0,16,2.2857142857142856,3,0.0,0,3,0,2,5,0,0,6,0,5,11,1
954,34750,dZiWNJzMYOhdEdmTnxnlGn0TB2qVPzZP,7GRhBDsirIGkRZBtSMEzNTyDr2JQm4xx,2,0,0,0,0,0,3,0,3,0.42857142857142855,1,0.0,0,0,0,0,0,0,0,3,0,0,3,1
955,34758,phhASQ029vNNdFMJmgP5NypplnmnI83R,7GRhBDsirIGkRZBtSMEzNTyDr2JQm4xx,13,16,9,49,1,0,5,0,80,11.428571428571429,3,0.0,2,9,43,1,14,0,6,5,0,55,25,0
956,34766,PJE8xaLvi7LkfqoaW5URpwOl6Zp0XkBz,7GRhBDsirIGkRZBtSMEzNTyDr2JQm4xx,1,0,0,0,0,0,1,0,1,0.14285714285714285,1,0.0,0,0,0,0,0,0,0,1,0,0,1,1
957,34792,dIopyk7eN7utmmbDdsk2JIW9Z0tySqPS,7GRhBDsirIGkRZBtSMEzNTyDr2JQm4xx,58,80,3,59,17,1,6,0,166,23.714285714285715,5,0.0,41,3,45,17,39,1,14,6,0,106,60,0
958,34804,27KU7J0xhwne5RAwWlMtoP7JA6sMyYoP,7GRhBDsirIGkRZBtSMEzNTyDr2JQm4xx,1,0,0,0,0,0,1,0,1,0.14285714285714285,1,0.0,0,0,0,0,0,0,0,1,0,0,1,1
959,34821,TRB5qhhumnbB7Yl6OQQJ0TCXgatMT1rj,7GRhBDsirIGkRZBtSMEzNTyDr2JQm4xx,6,3,2,0,2,0,1,0,8,1.1428571428571428,1,0.0,0,2,0,2,3,0,0,1,0,4,4,1
960,34842,LyBG9vpZvAGsIKFzeD4gB6XRCVzk12fF,7GRhBDsirIGkRZBtSMEzNTyDr2JQm4xx,9,11,7,0,5,0,4,0,27,3.857142857142857,1,0.0,2,7,0,5,9,0,0,4,0,14,13,1
961,34846,zVTKdKxLJYjz5XCh3vZ8AWdcMxkpEsE1,7GRhBDsirIGkRZBtSMEzNTyDr2JQm4xx,7,6,4,0,3,0,4,0,17,2.4285714285714284,1,0.0,0,4,0,3,6,0,0,4,0,7,10,1
962,34848,iBXl7c5cfIbBo4iOvRO7FtL1YDwjYkZC,7GRhBDsirIGkRZBtSMEzNTyDr2JQm4xx,1,0,0,0,0,0,1,0,1,0.14285714285714285,1,0.0,0,0,0,0,0,0,0,1,0,0,1,1
963,34857,pelK71W03sE3yGvlh2inDZDZzii32E4l,7GRhBDsirIGkRZBtSMEzNTyDr2JQm4xx,1,0,0,0,0,0,2,0,2,0.2857142857142857,1,0.0,0,0,0,0,0,0,0,2,0,0,2,1
964,34883,C4q4gNQYEpjKh7pq1qjN8i3L7uSpUX9d,7GRhBDsirIGkRZBtSMEzNTyDr2JQm4xx,52,75,20,0,31,0,3,0,129,18.428571428571427,2,0.0,20,20,0,31,55,0,0,3,0,71,58,0
965,34897,I7MInQU0IyHrO5RwKExwH0rTfGFmb00M,7GRhBDsirIGkRZBtSMEzNTyDr2JQm4xx,30,28,12,26,12,0,0,0,78,11.142857142857142,2,0.0,14,12,13,12,14,0,13,0,0,51,27,1
966,35039,URPpxYyCEjr1OE9SkqYA4izrGFGWLVkB,7GRhBDsirIGkRZBtSMEzNTyDr2JQm4xx,21,93,20,32,11,1,4,0,161,23.0,2,0.0,34,20,28,11,59,1,4,4,0,93,68,1
967,35082,8WC0ll7mpckRF9WawvJVdrokISfPhV8m,7GRhBDsirIGkRZBtSMEzNTyDr2JQm4xx,1,0,0,0,0,0,1,0,1,0.14285714285714285,1,0.0,0,0,0,0,0,0,0,1,0,0,1,1
968,35109,oiUHDt5e0cU5z0JTxVcs5GBEfUv9FQOW,7GRhBDsirIGkRZBtSMEzNTyDr2JQm4xx,1,0,0,0,0,0,1,0,1,0.14285714285714285,1,0.0,0,0,0,0,0,0,0,1,0,0,1,1
969,35143,7eHsOwDNMYF4417CWrgdB8gK0Wr4kfqA,7GRhBDsirIGkRZBtSMEzNTyDr2JQm4xx,44,150,32,101,24,1,14,0,322,46.0,4,0.0,101,32,87,24,49,1,14,14,0,244,78,0
970,35149,0MLatjoztZTXhoA4l9vLnoup5p3z66PW,7GRhBDsirIGkRZBtSMEzNTyDr2JQm4xx,9,7,5,0,5,0,5,0,22,3.142857142857143,1,0.0,0,5,0,5,7,0,0,5,0,10,12,1
971,35208,c0bjMduOwhlaRS3h8xRhAhid9jTsLzPD,7GRhBDsirIGkRZBtSMEzNTyDr2JQm4xx,5,5,2,0,1,0,1,0,9,1.2857142857142858,1,0.0,0,2,0,1,5,0,0,1,0,3,6,1
972,35608,nH0kSZNGQd9lZaOsssfRVpCIHD2KW4j6,7GRhBDsirIGkRZBtSMEzNTyDr2JQm4xx,20,25,11,21,9,0,2,0,68,9.714285714285714,2,0.0,11,11,17,9,14,0,4,2,0,48,20,1
973,35662,ISNkLbVsU7lMqk5vdrFnPCVx4y3a9MZD,7GRhBDsirIGkRZBtSMEzNTyDr2JQm4xx,41,73,32,26,23,15,5,0,174,24.857142857142858,1,0.0,30,32,16,23,43,15,10,5,0,101,73,1
974,35686,skJn7dtfSekFrPHRHs9swZ9AtSUKi36u,7GRhBDsirIGkRZBtSMEzNTyDr2JQm4xx,4,2,1,0,0,0,3,0,6,0.8571428571428571,1,0.0,0,1,0,0,2,0,0,3,0,1,5,0
975,35696,Vtwq7W3DodckYgwQIiThiTk1zWdBpMl0,7GRhBDsirIGkRZBtSMEzNTyDr2JQm4xx,10,8,2,2,2,0,4,1,19,2.7142857142857144,2,0.0,3,2,2,2,5,0,0,4,1,9,10,1
976,35725,BqXfJC2PEXaOut3jaDziE5COnZJ5tCVg,7GRhBDsirIGkRZBtSMEzNTyDr2JQm4xx,19,14,5,12,6,0,2,0,39,5.571428571428571,2,0.0,7,5,7,6,7,0,5,2,0,25,14,1
977,35881,712ruuJBHxwe16Nyde1AP6y2j0cVhIJD,7GRhBDsirIGkRZBtSMEzNTyDr2JQm4xx,68,51,16,76,11,0,5,0,159,22.714285714285715,1,0.0,28,16,75,11,23,0,1,5,0,130,29,0
978,37587,9RND50Xx7veKeepJEVVvFKwUGiemuZp5,G8EPVSXsOYB5YQWZGiz1aVq5Pgr2GrQu,3,2,1,0,0,0,1,0,4,0.5714285714285714,1,0.0,0,1,0,0,2,0,0,1,0,1,3,1
979,37610,v7t0p3xAszbLv0yg1dCcAEjixfvU7JCE,SpATywNh6bZuzm8s1ceuBUnMUAeoAHHw,17,33,17,16,6,0,3,0,75,10.714285714285714,3,0.0,13,17,13,6,20,0,3,3,0,49,26,0
980,37666,zeUi2UnQZPPF6bRQXw2s8LZ41ZOdqRAa,SpATywNh6bZuzm8s1ceuBUnMUAeoAHHw,17,16,9,6,4,0,3,0,38,5.428571428571429,4,0.0,4,9,6,4,12,0,0,3,0,23,15,0
981,37690,1Ti3XKNP5gzLh1si7Apz4GKt53UijsKr,SpATywNh6bZuzm8s1ceuBUnMUAeoAHHw,3,2,1,0,0,0,2,0,5,0.7142857142857143,1,0.0,0,1,0,0,2,0,0,2,0,1,4,0
982,37691,FisqRa6EMb5EsK7GdBjEQwdg4YXD4Xed,bWdj2GDclj5ofokWjzoa5jAwMkxCykd6,13,18,13,12,5,3,4,0,55,7.857142857142857,2,0.0,1,13,11,5,17,3,1,4,0,30,25,1
983,37706,5D134KQAUnU8gDw5hYnvC82YSO8giiEU,SpATywNh6bZuzm8s1ceuBUnMUAeoAHHw,3,2,1,0,0,9,2,0,14,2.0,2,0.0,0,1,0,0,2,9,0,2,0,1,13,0
984,37710,t89Lbc9NyQ1awHKwpUunu51m4E6DMYhk,SpATywNh6bZuzm8s1ceuBUnMUAeoAHHw,1,0,0,0,0,0,1,0,1,0.14285714285714285,1,0.0,0,0,0,0,0,0,0,1,0,0,1,0
985,37713,7fOZzyBcCx06Vw2a40A0eroSD5VkDcNa,SpATywNh6bZuzm8s1ceuBUnMUAeoAHHw,3,2,1,0,0,10,3,0,16,2.2857142857142856,2,0.0,0,1,0,0,2,10,0,3,0,1,15,0
986,37761,bzoYFRQVu6SapCnsZ0DOXeU3JXiLIJu3,SpATywNh6bZuzm8s1ceuBUnMUAeoAHHw,2,0,0,0,0,0,4,0,4,0.5714285714285714,2,0.0,0,0,0,0,0,0,0,4,0,0,4,0
987,37782,MT2eJtF59AVNdUs7mwFqputROb2HgEm3,SpATywNh6bZuzm8s1ceuBUnMUAeoAHHw,12,9,5,12,2,0,2,0,30,4.285714285714286,2,0.0,2,5,9,2,7,0,3,2,0,18,12,0
988,37788,y1rNC08s1iP76iivJMPjmiTg1SiPQTDp,SpATywNh6bZuzm8s1ceuBUnMUAeoAHHw,5,7,0,0,0,0,1,0,8,1.1428571428571428,1,0.0,1,0,0,0,6,0,0,1,0,1,7,1
989,37831,fmoIo5oPDyRcnHhnGH8MKyUTeXZvimIR,SpATywNh6bZuzm8s1ceuBUnMUAeoAHHw,17,20,8,9,5,12,3,0,57,8.142857142857142,1,0.0,11,8,9,5,9,12,0,3,0,33,24,0
990,37883,9Uee7oEuuMmgPx2IzPfFkWgkHZyPbWr0,SpATywNh6bZuzm8s1ceuBUnMUAeoAHHw,10,12,4,10,0,0,3,0,29,4.142857142857143,1,0.0,5,4,10,0,7,0,0,3,0,19,10,0
991,37887,5vUuq5ZeDCNce4LmvH0naoUjpb3qbNOp,bWdj2GDclj5ofokWjzoa5jAwMkxCykd6,3,2,1,0,0,0,1,0,4,0.5714285714285714,1,0.0,0,1,0,0,2,0,0,1,0,1,3,1
992,37905,lV4ifbsehEXWBwQOY9bU762jcRSMFY5M,SpATywNh6bZuzm8s1ceuBUnMUAeoAHHw,3,2,1,0,0,0,2,0,5,0.7142857142857143,2,0.0,0,1,0,0,2,0,0,2,0,1,4,0
993,37926,mUOanMUrsiycv8pF8RX4xyc7qtUXAMUs,bWdj2GDclj5ofokWjzoa5jAwMkxCykd6,1,0,0,0,0,0,1,0,1,0.14285714285714285,1,0.0,0,0,0,0,0,0,0,1,0,0,1,1
994,37932,UYyUkvxHd4tIc6aiQcuHfsTYHPlQXaAb,G8EPVSXsOYB5YQWZGiz1aVq5Pgr2GrQu,86,85,34,226,13,9,14,3,384,54.857142857142854,2,0.0,48,34,161,13,37,9,65,14,3,256,128,1
995,37992,lFmplH6KaQigIQOByvMn1p8i4p6OLLhs,SpATywNh6bZuzm8s1ceuBUnMUAeoAHHw,16,15,10,13,6,0,3,0,47,6.714285714285714,2,0.0,2,10,12,6,13,0,1,3,0,30,17,1
996,37993,pYcnIzYPgb3xzrOvmR9y0UUIZo4gqKuO,SpATywNh6bZuzm8s1ceuBUnMUAeoAHHw,22,42,30,8,11,1,6,0,98,14.0,4,0.0,4,30,7,11,38,1,1,6,0,52,46,0
997,38077,ltTao4EsmrwmN0pXNyC05GxRX7ymLAGM,SpATywNh6bZuzm8s1ceuBUnMUAeoAHHw,17,17,9,18,6,26,4,2,82,11.714285714285714,1,0.0,3,9,16,6,14,26,2,4,2,34,48,1
998,38117,udxFfabXtaVUvVlT3wEleIvfDBGe9yE2,SpATywNh6bZuzm8s1ceuBUnMUAeoAHHw,14,35,7,0,4,0,12,0,58,8.285714285714286,5,0.0,3,7,0,4,32,0,0,12,0,14,44,0
999,38119,53oi8zKKD3qFJiM7JZLKGYnyxQCMyuUV,SpATywNh6bZuzm8s1ceuBUnMUAeoAHHw,7,4,3,0,2,0,1,0,10,1.4285714285714286,1,0.0,0,3,0,2,4,0,0,1,0,5,5,0
1000,38158,i1weaEaafaiWi31Ms4bwoF6JM4IRf714,SpATywNh6bZuzm8s1ceuBUnMUAeoAHHw,6,5,4,0,2,0,1,0,12,1.7142857142857142,1,0.0,0,4,0,2,5,0,0,1,0,6,6,0
1001,38268,JDTEn5xJLcPCagcpPFhmwRsZ0N8AbJZ6,A3fsA9Zfv1X2fVEQhTw51lKENdNrEqT3,8,12,0,0,0,0,9,1,22,3.142857142857143,2,0.0,2,0,0,0,10,0,0,9,1,2,20,1
1002,38298,5FKi7MQVDgjqvQXvzQgvsTDVCkGiyjdK,SpATywNh6bZuzm8s1ceuBUnMUAeoAHHw,8,2,2,0,2,0,8,0,14,2.0,2,0.0,0,2,0,2,2,0,0,8,0,4,10,0
1003,38346,0KKudduxSM0i9qq9j381LmD3t0z9aJ9R,SpATywNh6bZuzm8s1ceuBUnMUAeoAHHw,1,0,0,0,0,0,1,0,1,0.14285714285714285,1,0.0,0,0,0,0,0,0,0,1,0,0,1,0
1004,38356,DJeWlgB4cP1RQ3JZLa1wZwd4zgAbYOxv,SpATywNh6bZuzm8s1ceuBUnMUAeoAHHw,3,2,1,0,0,0,1,0,4,0.5714285714285714,1,0.0,0,1,0,0,2,0,0,1,0,1,3,1
1005,38444,hBkBlAVjz5BY7zZnohogA0eA3ndLKNkg,SpATywNh6bZuzm8s1ceuBUnMUAeoAHHw,23,35,18,26,5,8,8,2,102,14.571428571428571,1,0.0,13,18,24,5,22,8,2,8,2,60,42,1
1006,38468,SHRanMph56qnHJKMofxrIA8VyLg99gvL,SpATywNh6bZuzm8s1ceuBUnMUAeoAHHw,4,3,0,0,0,0,2,0,5,0.7142857142857143,2,0.0,0,0,0,0,3,0,0,2,0,0,5,0
1007,38469,kOr03XnYLBaytLqdfTXgh6ll5b7wmEto,SpATywNh6bZuzm8s1ceuBUnMUAeoAHHw,4,5,2,0,0,1,2,0,10,1.4285714285714286,2,0.0,2,2,0,0,3,1,0,2,0,4,6,0
1008,38533,pqUcxq00SFcjmnxHDdHJfvpMD3HzyhM8,A3fsA9Zfv1X2fVEQhTw51lKENdNrEqT3,4,5,2,0,0,1,1,0,9,1.2857142857142858,2,0.0,0,2,0,0,5,1,0,1,0,2,7,0
1009,38560,op5Oi3uTeIRoABlsMVgAwjAoITQ3GmAH,SpATywNh6bZuzm8s1ceuBUnMUAeoAHHw,3,2,0,0,0,0,2,0,4,0.5714285714285714,1,0.0,0,0,0,0,2,0,0,2,0,0,4,1
1010,38654,wJIBDD9rPqnYMIKUazC26GmZhLI0Mfvr,RXDvfPUBYFlVdlueBFbLW0mhhAyGEqpt,7,3,3,0,3,0,0,0,9,1.2857142857142858,2,0.0,0,3,0,3,3,0,0,0,0,6,3,1
1011,38691,dCqryZS5yEyDDbYzWpFyoRjFGlVzafA6,SpATywNh6bZuzm8s1ceuBUnMUAeoAHHw,3,4,2,0,0,0,2,0,8,1.1428571428571428,1,0.0,0,2,0,0,4,0,0,2,0,2,6,0
1012,38701,E4KzNEU3ybRlAOiHqHHsGQEXiaxyHgoT,RXDvfPUBYFlVdlueBFbLW0mhhAyGEqpt,4,3,2,0,0,0,2,0,7,1.0,1,0.0,0,2,0,0,3,0,0,2,0,2,5,0
1013,38854,Xi85gYtmIKPj1CmvXveeSMqfVqnWSguE,bWdj2GDclj5ofokWjzoa5jAwMkxCykd6,2,0,0,0,0,16,1,0,17,2.4285714285714284,1,0.0,0,0,0,0,0,16,0,1,0,0,17,0
1014,38870,jaeRBfNSkyTpFxAZieHe5vTAkzlHFDmm,A3fsA9Zfv1X2fVEQhTw51lKENdNrEqT3,27,23,12,66,0,6,3,0,110,15.714285714285714,1,0.0,4,12,54,0,19,6,12,3,0,70,40,1
1015,38935,Bv9FSXvHlE6wLC4E4yrAKqe3BQhrrtfx,bWdj2GDclj5ofokWjzoa5jAwMkxCykd6,9,11,0,0,1,0,3,0,15,2.142857142857143,1,0.0,4,0,0,1,7,0,0,3,0,5,10,1
1016,38949,7HiGv3GGo0SXqM9pqC4B8FvUEghdfkna,A3fsA9Zfv1X2fVEQhTw51lKENdNrEqT3,43,30,15,68,10,0,10,0,133,19.0,4,0.0,2,15,58,10,28,0,10,10,0,85,48,0
1017,39023,t66hZYQIW0VPLqiRabyUSn9c1rXaD96i,G8EPVSXsOYB5YQWZGiz1aVq5Pgr2GrQu,5,1,1,0,1,0,3,0,6,0.8571428571428571,1,0.0,0,1,0,1,1,0,0,3,0,2,4,1
1018,39095,Lc5TZPB93C58CDuO8VjF5g6g9boxDaHr,SpATywNh6bZuzm8s1ceuBUnMUAeoAHHw,1,0,0,0,0,0,1,0,1,0.14285714285714285,1,0.0,0,0,0,0,0,0,0,1,0,0,1,1
1019,39114,2nqqGgbA0MihvBXBZoRijk6wA6yRTkC8,SpATywNh6bZuzm8s1ceuBUnMUAeoAHHw,3,9,5,0,0,2,4,0,20,2.857142857142857,4,0.0,0,5,0,0,9,2,0,4,0,5,15,1
1020,39134,wjTC7wnlKcnUR3GStNksYXKWSSmG8wiR,SpATywNh6bZuzm8s1ceuBUnMUAeoAHHw,27,32,17,28,7,1,9,1,95,13.571428571428571,1,0.0,11,17,25,7,21,1,3,9,1,60,35,1
1021,39140,zVX5LPwTGC1SEitxSfv31cubNXKJSEc2,SpATywNh6bZuzm8s1ceuBUnMUAeoAHHw,12,8,4,28,0,0,9,0,49,7.0,2,0.0,4,4,26,0,4,0,2,9,0,34,15,0
1022,39154,BGVVwabO5K2aC65VwhxWT01Y18m3Nzj6,SpATywNh6bZuzm8s1ceuBUnMUAeoAHHw,14,29,0,13,1,4,2,0,49,7.0,1,0.0,5,0,11,1,24,4,2,2,0,17,32,0
1023,39164,7GjcmlDBrfMQgiPOO8hsiYQuQLOINerQ,SpATywNh6bZuzm8s1ceuBUnMUAeoAHHw,6,5,3,0,0,0,2,0,10,1.4285714285714286,1,0.0,1,3,0,0,4,0,0,2,0,4,6,0
1024,39177,HzHckETSltPKPBe9aHJBFKMPGsxyznRF,RXDvfPUBYFlVdlueBFbLW0mhhAyGEqpt,14,17,13,24,4,4,3,0,65,9.285714285714286,2,0.0,2,13,21,4,15,4,3,3,0,40,25,0
1025,39195,E4KzNEU3ybRlAOiHqHHsGQEXiaxyHgoT,G8EPVSXsOYB5YQWZGiz1aVq5Pgr2GrQu,35,32,14,58,6,0,4,0,114,16.285714285714285,1,0.0,15,14,42,6,17,0,16,4,0,77,37,0
1026,39253,eBPwvAxm4arXAr6DDABCeVRfgkKzrVG9,A3fsA9Zfv1X2fVEQhTw51lKENdNrEqT3,5,3,1,0,1,0,1,0,6,0.8571428571428571,1,0.0,0,1,0,1,3,0,0,1,0,2,4,1
1027,39271,MuWLBiVwYCkYNKOHYGJD8tH8opD9K24n,G8EPVSXsOYB5YQWZGiz1aVq5Pgr2GrQu,16,15,0,28,0,0,2,0,45,6.428571428571429,1,0.0,3,0,20,0,12,0,8,2,0,23,22,1
1028,39279,MbSy3vYucWpXbJ8XgmPxO6zrZOjC9oUB,SpATywNh6bZuzm8s1ceuBUnMUAeoAHHw,3,2,1,0,0,0,1,0,4,0.5714285714285714,1,0.0,0,1,0,0,2,0,0,1,0,1,3,1
1029,39416,NiOuJ51IxTtojHMts8OdX2AfCH09G7vK,SpATywNh6bZuzm8s1ceuBUnMUAeoAHHw,7,6,4,0,2,0,2,0,14,2.0,1,0.0,0,4,0,2,6,0,0,2,0,6,8,1
1030,39438,PCU2OsmEUaGQvWJWbob5pKb7iiPbQ7ze,SpATywNh6bZuzm8s1ceuBUnMUAeoAHHw,6,15,0,0,0,0,5,0,20,2.857142857142857,2,0.0,0,0,0,0,15,0,0,5,0,0,20,1
1031,39493,Sw0laYN5mow6XiHfrWCJl4qnRcU0Nesb,SpATywNh6bZuzm8s1ceuBUnMUAeoAHHw,16,13,9,15,4,0,2,0,43,6.142857142857143,1,0.0,2,9,14,4,11,0,1,2,0,29,14,0
1032,39518,jeuXS3tUDyyNfvbrveLA3P9Aday4J2bg,SpATywNh6bZuzm8s1ceuBUnMUAeoAHHw,3,2,0,0,0,0,2,0,4,0.5714285714285714,1,0.0,0,0,0,0,2,0,0,2,0,0,4,0
1033,39523,U2HBhhMvJdYJzypYvAaM7auP4hEAIFmE,SpATywNh6bZuzm8s1ceuBUnMUAeoAHHw,4,4,1,0,0,1,4,0,10,1.4285714285714286,2,0.0,0,1,0,0,4,1,0,4,0,1,9,0
1034,39528,UPv4XJg0qIN0z1e32NPBqipWdQJZCo5I,G8EPVSXsOYB5YQWZGiz1aVq5Pgr2GrQu,53,50,37,109,12,0,29,1,238,34.0,6,0.0,0,37,95,12,50,0,14,29,1,144,94,0
1035,39531,ZicPLcC85bFypm3Kcvbq59RwoYBxR8MH,A3fsA9Zfv1X2fVEQhTw51lKENdNrEqT3,11,12,6,8,0,1,8,1,36,5.142857142857143,3,0.0,3,6,7,0,9,1,1,8,1,16,20,1
1036,39610,5JJq364DIcWk9Vho0reVJETDCFza3l8p,SpATywNh6bZuzm8s1ceuBUnMUAeoAHHw,3,2,1,0,0,0,2,0,5,0.7142857142857143,1,0.0,0,1,0,0,2,0,0,2,0,1,4,1
1037,39635,xcD6YWhnGA2xukGmX4eaYrm6VS9ffz1H,SpATywNh6bZuzm8s1ceuBUnMUAeoAHHw,1,0,0,0,0,0,1,0,1,0.14285714285714285,1,0.0,0,0,0,0,0,0,0,1,0,0,1,0
1038,39650,6FzXe5nPWUHRxntREHsQRnp7x1pxuhUz,SpATywNh6bZuzm8s1ceuBUnMUAeoAHHw,3,4,2,0,0,0,3,0,9,1.2857142857142858,3,0.0,0,2,0,0,4,0,0,3,0,2,7,0
1039,39750,g6zfMiS5ibUHTabfgiFKHajbGLSVfwvj,SpATywNh6bZuzm8s1ceuBUnMUAeoAHHw,8,6,4,0,2,0,2,0,14,2.0,1,0.0,0,4,0,2,6,0,0,2,0,6,8,1
1040,39766,Bq3dgySLNxUfP2DnFVHYyEWwaDcd9ALN,A3fsA9Zfv1X2fVEQhTw51lKENdNrEqT3,4,3,1,0,0,0,1,0,5,0.7142857142857143,1,0.0,0,1,0,0,3,0,0,1,0,1,4,1
1041,39803,VdNVtOVHu3uq36SFu7mu40diveL7bnVd,A3fsA9Zfv1X2fVEQhTw51lKENdNrEqT3,11,9,7,0,5,0,3,0,24,3.4285714285714284,1,0.0,0,7,0,5,9,0,0,3,0,12,12,1
1042,39841,9BRoND09uAkQha4X7ED5IFkfUaItyWWP,SpATywNh6bZuzm8s1ceuBUnMUAeoAHHw,7,5,1,0,1,0,2,0,9,1.2857142857142858,1,0.0,1,1,0,1,4,0,0,2,0,3,6,1
1043,39845,xwqLmgu4yZxUsX04FDtQMDL3awvB0E5w,SpATywNh6bZuzm8s1ceuBUnMUAeoAHHw,7,9,3,18,0,0,3,0,33,4.714285714285714,2,0.0,4,3,15,0,5,0,3,3,0,22,11,0
1044,39878,pLB7K8hva7hpUpPIa0JWEXpoyBHIkbAO,SpATywNh6bZuzm8s1ceuBUnMUAeoAHHw,3,2,1,0,0,0,1,0,4,0.5714285714285714,1,0.0,0,1,0,0,2,0,0,1,0,1,3,1
1045,39922,2GATpIfDBYFyTgYmFkr0bda9mVfNXuAl,SpATywNh6bZuzm8s1ceuBUnMUAeoAHHw,5,6,0,0,0,0,2,0,8,1.1428571428571428,2,0.0,0,0,0,0,6,0,0,2,0,0,8,0
1046,39958,Peb8kjmFqGQvYDTvo4JTH8WhAEOnPF2h,SpATywNh6bZuzm8s1ceuBUnMUAeoAHHw,1,0,0,0,0,0,1,0,1,0.14285714285714285,1,0.0,0,0,0,0,0,0,0,1,0,0,1,1
1047,39962,p3Cz4BAZGaZT08I2Dwew8OwWDC6PUWgc,SpATywNh6bZuzm8s1ceuBUnMUAeoAHHw,1,0,0,0,0,0,2,0,2,0.2857142857142857,2,0.0,0,0,0,0,0,0,0,2,0,0,2,1
1048,40026,JlRuZgjmv2hzO83ouspiZFc9FxGockFl,RXDvfPUBYFlVdlueBFbLW0mhhAyGEqpt,5,3,2,0,1,0,1,0,7,1.0,1,0.0,0,2,0,1,3,0,0,1,0,3,4,1
1049,40036,vUH5NhW2dOJJ7pGM4nFysRqnPlXzFZdY,SpATywNh6bZuzm8s1ceuBUnMUAeoAHHw,16,18,3,20,2,0,3,0,46,6.571428571428571,2,0.0,2,3,17,2,16,0,3,3,0,24,22,0
1050,40097,Rf6xXor9EmVmU5Nrbaea2KpXMtqjkHJb,SpATywNh6bZuzm8s1ceuBUnMUAeoAHHw,12,12,6,0,4,0,2,0,24,3.4285714285714284,1,0.0,0,6,0,4,12,0,0,2,0,10,14,0
1051,40125,znkDmOOvUgN8z7Q2bDidRTpqlGavufFM,SpATywNh6bZuzm8s1ceuBUnMUAeoAHHw,3,2,1,0,0,0,2,0,5,0.7142857142857143,1,0.0,0,1,0,0,2,0,0,2,0,1,4,0
1052,40178,JhXfd0Tlc69bJyZdJPZXaAHtjoBDG89W,A3fsA9Zfv1X2fVEQhTw51lKENdNrEqT3,21,42,2,0,2,0,12,0,58,8.285714285714286,4,0.0,0,2,0,2,42,0,0,12,0,4,54,0
1053,40207,mVPS8qtXmBYw6oQCHhHlXYGOl1msXZRm,SpATywNh6bZuzm8s1ceuBUnMUAeoAHHw,17,12,7,12,3,0,3,0,37,5.285714285714286,1,0.0,2,7,12,3,10,0,0,3,0,24,13,1
1054,40224,sV3jtFrXfncSgh7Xsq4nWcxj42E0NrUb,SpATywNh6bZuzm8s1ceuBUnMUAeoAHHw,11,15,2,0,3,0,9,0,29,4.142857142857143,3,0.0,0,2,0,3,15,0,0,9,0,5,24,0
1055,40330,e8tjBT4TkBUZGDf1oULgV0xlcUpSchNd,SpATywNh6bZuzm8s1ceuBUnMUAeoAHHw,18,50,27,14,15,0,2,0,108,15.428571428571429,1,0.0,20,27,13,15,30,0,1,2,0,75,33,0
1056,40335,xLE9ZE3BmJvIiYogSmZ2Qwy8Pm6jvutZ,SpATywNh6bZuzm8s1ceuBUnMUAeoAHHw,1,0,0,0,0,0,1,0,1,0.14285714285714285,1,0.0,0,0,0,0,0,0,0,1,0,0,1,0
1057,40392,zT5Abo7SNHsAkCFKMvhJJJDWNu2sl4mh,SpATywNh6bZuzm8s1ceuBUnMUAeoAHHw,1,0,0,0,0,0,1,0,1,0.14285714285714285,1,0.0,0,0,0,0,0,0,0,1,0,0,1,0
1058,40403,Anr82PPgHyVjFu2RaZRNpr3IKYwAUnAW,SpATywNh6bZuzm8s1ceuBUnMUAeoAHHw,8,11,6,0,3,0,3,0,23,3.2857142857142856,2,0.0,0,6,0,3,11,0,0,3,0,9,14,1
1059,40416,0Cx8S0i9vAPm7jZ8jXLUkrYp9xGpIHIS,bWdj2GDclj5ofokWjzoa5jAwMkxCykd6,3,4,2,0,0,3,2,0,11,1.5714285714285714,1,0.0,0,2,0,0,4,3,0,2,0,2,9,1
1060,40428,RSvPQSF8RarDsP4aI3ftScWWjvINqjc5,A3fsA9Zfv1X2fVEQhTw51lKENdNrEqT3,3,2,1,0,1,0,0,0,4,0.5714285714285714,2,0.0,0,1,0,1,2,0,0,0,0,2,2,1
1061,40441,b11C6Y0UpRSFGpKvHTlz5TF2Rt9ScBoX,SpATywNh6bZuzm8s1ceuBUnMUAeoAHHw,1,0,0,0,0,0,0,1,1,0.14285714285714285,1,0.0,0,0,0,0,0,0,0,0,1,0,1,0
1062,40462,9hqCAq1z2NOCYAE7PjnGwKxGA9KHvl0W,A3fsA9Zfv1X2fVEQhTw51lKENdNrEqT3,2,2,0,0,0,0,0,0,2,0.2857142857142857,1,0.0,0,0,0,0,2,0,0,0,0,0,2,1
1063,40502,PzBfPYmnOZYwUEXwnCaNraevSYiEicsw,G8EPVSXsOYB5YQWZGiz1aVq5Pgr2GrQu,14,14,0,18,0,3,9,2,46,6.571428571428571,1,0.0,6,0,13,0,8,3,5,9,2,19,27,1
1064,40648,zUbaOnwFf34fsU2q7dIMt7fpEzRZebx6,SpATywNh6bZuzm8s1ceuBUnMUAeoAHHw,11,19,9,0,6,0,2,0,36,5.142857142857143,1,0.0,8,9,0,6,11,0,0,2,0,23,13,1
1065,40704,qmYTrueiQKfoQnGxjqfwlMlw7HOR9CKj,bWdj2GDclj5ofokWjzoa5jAwMkxCykd6,1,0,0,0,0,0,2,0,2,0.2857142857142857,2,0.0,0,0,0,0,0,0,0,2,0,0,2,0
1066,40802,DFKzgJXlXxnZVHESIM4fYC543XX9ZfDV,SpATywNh6bZuzm8s1ceuBUnMUAeoAHHw,3,2,1,0,0,0,1,0,4,0.5714285714285714,1,0.0,0,1,0,0,2,0,0,1,0,1,3,1
1067,40900,f6iCNPPMIJtA2FTvaT2H53upAxoDRLhb,SpATywNh6bZuzm8s1ceuBUnMUAeoAHHw,6,8,3,0,0,0,3,0,14,2.0,1,0.0,2,3,0,0,6,0,0,3,0,5,9,1
1068,40966,xHfGdYj0sYZXXCzkQp0eF5wBXW7C2C6R,A3fsA9Zfv1X2fVEQhTw51lKENdNrEqT3,5,3,1,0,1,0,1,0,6,0.8571428571428571,1,0.0,0,1,0,1,3,0,0,1,0,2,4,1
1069,40973,BasnDhJkjNSRVUOCCIoBniAgNajwACiL,SpATywNh6bZuzm8s1ceuBUnMUAeoAHHw,2,0,0,0,0,0,3,0,3,0.42857142857142855,2,0.0,0,0,0,0,0,0,0,3,0,0,3,0
1070,41133,sIrvXnSy3oMgG36f8e8UxJCnsTfr739w,7GRhBDsirIGkRZBtSMEzNTyDr2JQm4xx,14,21,0,0,0,0,4,0,25,3.5714285714285716,1,0.0,3,0,0,0,18,0,0,4,0,3,22,1
1071,41208,ttoFK5oOPrxtfVxJpGPFCiEs8J6AbuAg,7GRhBDsirIGkRZBtSMEzNTyDr2JQm4xx,1,0,0,0,0,0,1,0,1,0.14285714285714285,1,0.0,0,0,0,0,0,0,0,1,0,0,1,1
1072,41424,Gn1QSm7WrSyhbej7tThohiyBKeBu1xtD,7GRhBDsirIGkRZBtSMEzNTyDr2JQm4xx,41,44,15,62,15,2,10,1,149,21.285714285714285,3,0.0,19,15,51,15,25,2,11,10,1,100,49,0
1073,41589,JXidMLGzH1hCHEXJsiJMrwBekkp4L4vD,7GRhBDsirIGkRZBtSMEzNTyDr2JQm4xx,7,5,2,6,0,3,1,0,17,2.4285714285714284,1,0.0,2,2,3,0,3,3,3,1,0,7,10,1
1074,41740,blaKT90TeOTAa2RsAkTxWQqeLxEi93Qu,7GRhBDsirIGkRZBtSMEzNTyDr2JQm4xx,1,0,0,0,0,0,1,0,1,0.14285714285714285,1,0.0,0,0,0,0,0,0,0,1,0,0,1,1
1075,43653,79QUI05RY9ZPkyZ2QTF4ldf0I0DmjbaG,7GRhBDsirIGkRZBtSMEzNTyDr2JQm4xx,5,5,2,0,0,2,2,0,11,1.5714285714285714,2,0.0,0,2,0,0,5,2,0,2,0,2,9,1
1076,43667,YwEhgJrFq2w9QJl2yCPd9xaL0Uk6VujF,7GRhBDsirIGkRZBtSMEzNTyDr2JQm4xx,20,19,6,269,2,0,4,0,300,42.857142857142854,1,0.0,9,6,251,2,10,0,18,4,0,268,32,0
1077,43672,tCqgfXrL2rXAh5RJpLuMHSLSRwrclyuQ,7GRhBDsirIGkRZBtSMEzNTyDr2JQm4xx,37,157,43,131,25,22,11,0,389,55.57142857142857,5,0.0,56,43,113,25,101,22,18,11,0,237,152,0
1078,43674,zkqKiyV6OvwyKPkyCN37KC4hTRCpZYCH,7GRhBDsirIGkRZBtSMEzNTyDr2JQm4xx,17,20,10,10,10,0,2,0,52,7.428571428571429,2,0.0,8,10,9,10,12,0,1,2,0,37,15,0
1079,43685,Up0igPeMCPcrrFPZ1HsfM8Bq5rwAfYwv,7GRhBDsirIGkRZBtSMEzNTyDr2JQm4xx,40,54,16,52,18,17,3,0,160,22.857142857142858,2,0.0,33,16,42,18,21,17,10,3,0,109,51,0
1080,43697,ta4rrlwAs90RPkpFC9k1ckRd8n8Nkgxn,7GRhBDsirIGkRZBtSMEzNTyDr2JQm4xx,4,0,0,0,0,0,4,0,4,0.5714285714285714,1,0.0,0,0,0,0,0,0,0,4,0,0,4,1
1081,43700,z4NoXHrcgkhn7BypZflRO6Tgobh52UXj,7GRhBDsirIGkRZBtSMEzNTyDr2JQm4xx,4,3,2,0,0,0,1,0,6,0.8571428571428571,1,0.0,0,2,0,0,3,0,0,1,0,2,4,0
1082,43713,KjugBA6V5bkEA5fAIbJoGnSUlDhZoaIH,7GRhBDsirIGkRZBtSMEzNTyDr2JQm4xx,32,89,24,80,11,2,8,0,214,30.571428571428573,2,0.0,34,24,72,11,55,2,8,8,0,141,73,0
1083,44057,ZEbYOmWwQ4Xr4MxJtDQOJ8jnLIcd8Z5c,fbPkOYLVPtPgIt0MxizjfFJov3JbHyAi,7,7,5,0,3,0,2,0,17,2.4285714285714284,1,0.0,0,5,0,3,7,0,0,2,0,8,9,1
1084,44131,dzaUNwKZy91BtYj96fOhuSgIlp9lXQDU,fbPkOYLVPtPgIt0MxizjfFJov3JbHyAi,22,17,10,6,5,0,4,0,42,6.0,2,0.0,5,10,6,5,12,0,0,4,0,26,16,0
1085,44155,ufy4LHvMWo0whrRq15door8x99FGdY4J,fbPkOYLVPtPgIt0MxizjfFJov3JbHyAi,4,6,4,0,0,0,0,0,10,1.4285714285714286,1,0.0,2,4,0,0,4,0,0,0,0,6,4,1
1086,44192,c1zULVJb8UrzwaeCwQXbXVIx3xb2chrp,fbPkOYLVPtPgIt0MxizjfFJov3JbHyAi,2,0,0,0,0,0,2,0,2,0.2857142857142857,1,0.0,0,0,0,0,0,0,0,2,0,0,2,0
1087,44245,Qs9VQJkriDZBH3FlG0bgTumvMa49MEaO,fbPkOYLVPtPgIt0MxizjfFJov3JbHyAi,11,19,7,3,5,7,2,0,43,6.142857142857143,2,0.0,6,7,3,5,13,7,0,2,0,21,22,0
1088,44273,v4VtiypZ3gKvKYOCZEjKIfSgOk6hH0T6,fbPkOYLVPtPgIt0MxizjfFJov3JbHyAi,18,15,7,16,6,0,3,0,47,6.714285714285714,1,0.0,5,7,12,6,10,0,4,3,0,30,17,1
1089,45614,aCMLJ0A5ki1G82R2CtOxjr8OrznWuiC4,RXDvfPUBYFlVdlueBFbLW0mhhAyGEqpt,10,9,1,2,1,0,1,0,14,2.0,1,0.0,2,1,2,1,7,0,0,1,0,6,8,0
1090,46053,gvkM0LsKRQYuvgC8Hpf4C14gSdMpspZj,RXDvfPUBYFlVdlueBFbLW0mhhAyGEqpt,14,17,4,21,8,0,2,0,52,7.428571428571429,1,0.0,13,4,18,8,4,0,3,2,0,43,9,1
1091,46068,H3iVkRV8UPZvsbvYrU1dnbX51IlHemsF,RXDvfPUBYFlVdlueBFbLW0mhhAyGEqpt,4,3,0,0,0,0,2,0,5,0.7142857142857143,2,0.0,0,0,0,0,3,0,0,2,0,0,5,0
1092,46437,TOrqBZDp9GjgXoTZI9iOS0r8wbO7CyB1,RXDvfPUBYFlVdlueBFbLW0mhhAyGEqpt,26,25,19,32,11,0,2,0,89,12.714285714285714,1,0.0,5,19,31,11,20,0,1,2,0,66,23,0
1093,46479,xSwC5YVwlqQI12zsRbCFcdEzFRC8jvLt,fbPkOYLVPtPgIt0MxizjfFJov3JbHyAi,12,45,1,15,0,4,2,0,67,9.571428571428571,3,0.0,26,1,13,0,19,4,2,2,0,40,27,1
1094,46486,XYKEbaRABcMuBHmMB2I3YkBepzCp0swB,fbPkOYLVPtPgIt0MxizjfFJov3JbHyAi,17,24,1,14,2,19,6,0,66,9.428571428571429,3,0.0,9,1,11,2,15,19,3,6,0,23,43,1
1095,46509,wUS4QMZENKgcJOovrFGfoZniw3fDJWWg,fbPkOYLVPtPgIt0MxizjfFJov3JbHyAi,34,33,19,13,6,16,12,0,99,14.142857142857142,3,0.0,10,19,13,6,23,16,0,12,0,48,51,0
1096,46535,fdzq5tofwv4sAm3YqrsC6AMOnGl1oPA0,fbPkOYLVPtPgIt0MxizjfFJov3JbHyAi,1,0,0,0,0,0,1,0,1,0.14285714285714285,1,0.0,0,0,0,0,0,0,0,1,0,0,1,1
1097,46554,XDsU9hjOJ2JutIT7BD3Uu690qeQfLlzy,fbPkOYLVPtPgIt0MxizjfFJov3JbHyAi,5,3,2,0,1,0,1,0,7,1.0,1,0.0,0,2,0,1,3,0,0,1,0,3,4,0
1098,47706,P59zgxkiZZAY4L2oDvB0C7gvcL7QBtyx,7GRhBDsirIGkRZBtSMEzNTyDr2JQm4xx,20,23,9,62,2,0,1,0,97,13.857142857142858,1,0.0,13,9,59,2,10,0,3,1,0,83,14,0
1099,47712,ilWzYGLWBh9DSc1MV8g2C4Go5wDNgUHX,7GRhBDsirIGkRZBtSMEzNTyDr2JQm4xx,3,2,1,0,0,0,1,0,4,0.5714285714285714,1,0.0,0,1,0,0,2,0,0,1,0,1,3,1
1100,47737,kqS8BwWN9R1093oeblGkvtCsQJ68Gh0G,7GRhBDsirIGkRZBtSMEzNTyDr2JQm4xx,6,4,2,2,1,0,1,0,10,1.4285714285714286,1,0.0,1,2,1,1,3,0,1,1,0,5,5,1
1101,47760,jWh61XkRTjwdqASpqvrGaFWBIry4gjxu,fbPkOYLVPtPgIt0MxizjfFJov3JbHyAi,3,2,2,0,2,0,0,0,6,0.8571428571428571,2,0.0,0,2,0,2,2,0,0,0,0,4,2,1
1102,47779,rVswAzjMLz5uIPbCwAU1SliCQFpiAqey,fbPkOYLVPtPgIt0MxizjfFJov3JbHyAi,6,3,2,0,1,0,2,0,8,1.1428571428571428,1,0.0,0,2,0,1,3,0,0,2,0,3,5,1
1103,47806,uXSmZuPz2xNXPk2qFBcPykAtedr98vP4,fbPkOYLVPtPgIt0MxizjfFJov3JbHyAi,8,5,4,0,2,0,1,0,12,1.7142857142857142,1,0.0,0,4,0,2,5,0,0,1,0,6,6,1
1104,47810,ZQszEDvefL66DoX1xrFttL5Z99UGUgJi,fbPkOYLVPtPgIt0MxizjfFJov3JbHyAi,1,0,0,0,0,0,1,0,1,0.14285714285714285,1,0.0,0,0,0,0,0,0,0,1,0,0,1,0
1105,47838,bJNzzdFbeXF3gRIHxGK6VlbnTQeUffyz,fbPkOYLVPtPgIt0MxizjfFJov3JbHyAi,1,0,0,0,0,0,1,0,1,0.14285714285714285,1,0.0,0,0,0,0,0,0,0,1,0,0,1,1
1106,47850,EA93zC2FZSfWuUTy2fGF8qAEwUDl0X8s,fbPkOYLVPtPgIt0MxizjfFJov3JbHyAi,21,16,10,8,4,18,6,1,63,9.0,3,0.0,4,10,8,4,12,18,0,6,1,26,37,1
1107,47853,ZZRh21sVolimyM3CDUIIgG9cuzaZauji,fbPkOYLVPtPgIt0MxizjfFJov3JbHyAi,11,7,5,2,1,3,4,1,23,3.2857142857142856,1,0.0,1,5,2,1,6,3,0,4,1,9,14,1
1108,47861,DIrQamaTjjU1PZti9ZjQXTxfEYtPLnQl,fbPkOYLVPtPgIt0MxizjfFJov3JbHyAi,7,5,3,0,2,0,0,0,10,1.4285714285714286,1,0.0,0,3,0,2,5,0,0,0,0,5,5,1
1109,47894,Rz28tFT5qYZaEQ78Ly3OdJx8TpvsmLBy,bWdj2GDclj5ofokWjzoa5jAwMkxCykd6,8,11,4,20,0,0,6,0,41,5.857142857142857,3,0.0,0,4,19,0,11,0,1,6,0,23,18,0
1110,47900,t8SjYilFMTCG5Wi1o6mcbWFbM7fvPbYd,SpATywNh6bZuzm8s1ceuBUnMUAeoAHHw,1,0,0,0,0,0,1,0,1,0.14285714285714285,1,0.0,0,0,0,0,0,0,0,1,0,0,1,0
1111,47938,szUZ2QsyqJuXPgyS49q35y1kTVrrBlKT,SpATywNh6bZuzm8s1ceuBUnMUAeoAHHw,4,5,3,0,0,0,5,0,13,1.8571428571428572,3,0.0,0,3,0,0,5,0,0,5,0,3,10,0
1112,48018,xecOK3aJ3hCti9mz2pAAcwSq9d1S8ATw,SpATywNh6bZuzm8s1ceuBUnMUAeoAHHw,3,2,0,0,0,0,2,0,4,0.5714285714285714,1,0.0,0,0,0,0,2,0,0,2,0,0,4,0
1113,48041,SmONSyS4YgG4Afnv6ZxU81t7p4CQPV5P,bWdj2GDclj5ofokWjzoa5jAwMkxCykd6,1,0,0,0,0,0,1,0,1,0.14285714285714285,1,0.0,0,0,0,0,0,0,0,1,0,0,1,1
1114,48045,O6XTfrmBXPHHKFN07CLCPWqyMP9NsQuf,A3fsA9Zfv1X2fVEQhTw51lKENdNrEqT3,7,3,2,0,2,0,3,0,10,1.4285714285714286,1,0.0,0,2,0,2,3,0,0,3,0,4,6,0
1115,48093,23GFMJXBCJBMscnU5tVwAanleKYVql9b,SpATywNh6bZuzm8s1ceuBUnMUAeoAHHw,5,4,2,0,0,15,8,3,32,4.571428571428571,4,0.0,0,2,0,0,4,15,0,8,3,2,30,0
1116,48114,rzXoVvb6RM0hS48T1GDjFso4hKBDuhsd,bWdj2GDclj5ofokWjzoa5jAwMkxCykd6,32,33,22,61,14,0,6,0,136,19.428571428571427,1,0.0,5,22,54,14,28,0,7,6,0,95,41,0
1117,48204,pl9XUoy865SinWI51RNAlmhqaJHEhs94,SpATywNh6bZuzm8s1ceuBUnMUAeoAHHw,7,5,3,0,2,0,1,0,11,1.5714285714285714,1,0.0,0,3,0,2,5,0,0,1,0,5,6,1
1118,48246,ieR2oDuOBOWrOSx08B7vLKsdvt41Kjgw,A3fsA9Zfv1X2fVEQhTw51lKENdNrEqT3,21,17,11,0,7,0,4,0,39,5.571428571428571,1,0.0,3,11,0,7,14,0,0,4,0,21,18,0
1119,48261,wi7Ze896VO17gMeNUgqgfOVbxlFbfvaK,SpATywNh6bZuzm8s1ceuBUnMUAeoAHHw,1,0,0,0,0,0,1,0,1,0.14285714285714285,1,0.0,0,0,0,0,0,0,0,1,0,0,1,0
1120,48307,xqNT9GHVIeGkzMPTfiXtvyG6m6zaY6B9,A3fsA9Zfv1X2fVEQhTw51lKENdNrEqT3,3,0,0,0,0,0,4,0,4,0.5714285714285714,1,0.0,0,0,0,0,0,0,0,4,0,0,4,1
1121,48325,vkfHpP1V5bzhsiIUQc7ID6uM0xIbyM6G,bWdj2GDclj5ofokWjzoa5jAwMkxCykd6,6,5,2,0,3,0,1,0,11,1.5714285714285714,3,0.0,2,2,0,3,3,0,0,1,0,7,4,1
1122,48345,pnW8XX8zC0UKr9mm25Bt1RQ7xgXCstp3,A3fsA9Zfv1X2fVEQhTw51lKENdNrEqT3,2,0,0,0,0,0,4,0,4,0.5714285714285714,2,0.0,0,0,0,0,0,0,0,4,0,0,4,0
1123,48370,3HC1D1DG8BjKUNFZlgm7gcIQVOGrzi6J,SpATywNh6bZuzm8s1ceuBUnMUAeoAHHw,1,0,0,0,0,0,2,0,2,0.2857142857142857,2,0.0,0,0,0,0,0,0,0,2,0,0,2,0
1124,48386,5jz6qtmzJGoTjjzPCohz2U8oEp7qiszP,SpATywNh6bZuzm8s1ceuBUnMUAeoAHHw,1,0,0,0,0,0,1,0,1,0.14285714285714285,1,0.0,0,0,0,0,0,0,0,1,0,0,1,0
1125,48446,QIQR6VwK3cpUKM5lDzadEKeQATM23w8z,A3fsA9Zfv1X2fVEQhTw51lKENdNrEqT3,15,26,0,0,0,0,4,0,30,4.285714285714286,3,0.0,0,0,0,0,26,0,0,4,0,0,30,1
1126,48454,g1ncrxE30iLPOXYuzSV4ccCqY3Ww9KwB,A3fsA9Zfv1X2fVEQhTw51lKENdNrEqT3,4,2,1,0,0,1,3,0,7,1.0,2,0.0,0,1,0,0,2,1,0,3,0,1,6,1
1127,48492,Av4RUzIKiBksZoh2Q0L0akgGSwn9yOvk,SpATywNh6bZuzm8s1ceuBUnMUAeoAHHw,24,19,15,8,8,8,3,0,61,8.714285714285714,1,0.0,2,15,8,8,17,8,0,3,0,33,28,0
1128,48529,hkwn5MNEUKXaOvo8i7hJxIoCohTDhE10,SpATywNh6bZuzm8s1ceuBUnMUAeoAHHw,7,4,3,0,2,0,2,0,11,1.5714285714285714,1,0.0,0,3,0,2,4,0,0,2,0,5,6,0
1129,48587,v6QLYqOum8NXSX8h0M5DMTP0vkr2qfHa,SpATywNh6bZuzm8s1ceuBUnMUAeoAHHw,6,5,3,0,0,31,13,0,52,7.428571428571429,4,0.0,0,3,0,0,5,31,0,13,0,3,49,0
1130,48617,LSvU72CFq1TrHd9SCZOiKQ0qcV2oa2Ok,A3fsA9Zfv1X2fVEQhTw51lKENdNrEqT3,4,8,1,0,0,0,2,0,11,1.5714285714285714,2,0.0,2,1,0,0,6,0,0,2,0,3,8,0
1131,48630,oymhnrhhZTojmhR9U4GGxnwHZLmXRmW8,SpATywNh6bZuzm8s1ceuBUnMUAeoAHHw,4,4,1,0,0,0,4,0,9,1.2857142857142858,2,0.0,0,1,0,0,4,0,0,4,0,1,8,1
1132,48643,RCdcltNaQLfcoxT7YKTjQxAYUbCmzzKd,SpATywNh6bZuzm8s1ceuBUnMUAeoAHHw,4,7,4,0,0,3,6,0,20,2.857142857142857,3,0.0,0,4,0,0,7,3,0,6,0,4,16,0
1133,48684,ugIvWXr0VKdRfQslnLOrtvUMZY9HB5mg,A3fsA9Zfv1X2fVEQhTw51lKENdNrEqT3,1,0,0,0,0,0,1,0,1,0.14285714285714285,1,0.0,0,0,0,0,0,0,0,1,0,0,1,1
1134,48693,AnsnVs5AVUHmSDONSrxZt8MIRHsOXvcc,SpATywNh6bZuzm8s1ceuBUnMUAeoAHHw,2,0,0,0,0,9,2,0,11,1.5714285714285714,2,0.0,0,0,0,0,0,9,0,2,0,0,11,0
1135,48701,z4snJqWxxByo4wMmQ2g1knGwZpMDrb1I,SpATywNh6bZuzm8s1ceuBUnMUAeoAHHw,5,3,2,0,2,0,0,0,7,1.0,1,0.0,0,2,0,2,3,0,0,0,0,4,3,0
1136,48716,EJmjPRM04Uqau3e0OiUKVcHUyavQV9Hd,SpATywNh6bZuzm8s1ceuBUnMUAeoAHHw,5,4,1,0,1,0,2,0,8,1.1428571428571428,2,0.0,0,1,0,1,4,0,0,2,0,2,6,0
1137,48717,Kkk2oty8lHBEgyFYDiZgsO24fUpD8pZQ,A3fsA9Zfv1X2fVEQhTw51lKENdNrEqT3,12,11,9,0,7,0,4,0,31,4.428571428571429,2,0.0,0,9,0,7,11,0,0,4,0,16,15,1
1138,48724,oxWNSOCXM5YtqWviH5bNOZtEWIiiD3Ad,SpATywNh6bZuzm8s1ceuBUnMUAeoAHHw,13,12,0,19,0,0,2,0,33,4.714285714285714,1,0.0,4,0,16,0,8,0,3,2,0,20,13,0
1139,48851,U2YEyQJ6vRjLD9a41Fy3cKvRrxCg3qKu,SpATywNh6bZuzm8s1ceuBUnMUAeoAHHw,5,7,3,0,0,1,4,0,15,2.142857142857143,3,0.0,0,3,0,0,7,1,0,4,0,3,12,0
1140,48873,FgYPvBwLri7YiFI9og6clP9FuKJ08jX7,G8EPVSXsOYB5YQWZGiz1aVq5Pgr2GrQu,5,4,2,0,1,0,2,0,9,1.2857142857142858,2,0.0,0,2,0,1,4,0,0,2,0,3,6,1
1141,48923,rJ7deFT9ohZCOevrsW5L4Px2yVgiatFT,A3fsA9Zfv1X2fVEQhTw51lKENdNrEqT3,24,28,21,0,13,0,4,0,66,9.428571428571429,1,0.0,2,21,0,13,26,0,0,4,0,36,30,1
1142,48934,PPMgD0y4ftWviyNbM56pMh7QBTyoyQi0,A3fsA9Zfv1X2fVEQhTw51lKENdNrEqT3,35,23,0,64,0,0,5,0,92,13.142857142857142,2,0.0,1,0,57,0,22,0,7,5,0,58,34,1
1143,48957,7xLRAUzJSfSBonILgUC8oEWPnbxwGYvj,RXDvfPUBYFlVdlueBFbLW0mhhAyGEqpt,21,21,1,21,0,0,0,0,43,6.142857142857143,2,0.0,0,1,18,0,21,0,3,0,0,19,24,1
1144,48968,3Y0bPm3E3Ch9XQ8h4cbV56DUaTL5U5qc,SpATywNh6bZuzm8s1ceuBUnMUAeoAHHw,14,30,10,19,0,9,6,1,75,10.714285714285714,4,0.0,8,10,16,0,22,9,3,6,1,34,41,0
1145,48974,Ze9kgklMuT1yRhjZzYqZ128xNCVJ9Ing,SpATywNh6bZuzm8s1ceuBUnMUAeoAHHw,13,13,5,13,4,0,2,0,37,5.285714285714286,1,0.0,2,5,11,4,11,0,2,2,0,22,15,0
1146,49079,uqA5Smdw6BACOcL0f2tmxwTTxZXBpZpE,A3fsA9Zfv1X2fVEQhTw51lKENdNrEqT3,6,7,3,0,1,0,3,0,14,2.0,2,0.0,0,3,0,1,7,0,0,3,0,4,10,1
1147,49086,G7CuAdMTwHj5eYhpu5z9RBNQZMziV4KR,SpATywNh6bZuzm8s1ceuBUnMUAeoAHHw,6,9,2,0,1,0,2,0,14,2.0,1,0.0,0,2,0,1,9,0,0,2,0,3,11,0
1148,49123,hZuqApg1u2xIALq7aPkxAemxANyM5ZQO,SpATywNh6bZuzm8s1ceuBUnMUAeoAHHw,26,19,15,26,10,0,7,0,77,11.0,1,0.0,4,15,24,10,15,0,2,7,0,53,24,0
1149,49154,ahTQ6twHrEgeLAYHLb7pWZDspU6rrM6J,A3fsA9Zfv1X2fVEQhTw51lKENdNrEqT3,14,13,12,0,6,0,1,0,32,4.571428571428571,1,0.0,0,12,0,6,13,0,0,1,0,18,14,1
1150,49173,1n5WyoQB7crKqtXBR0SIfThQpW2Y5gVs,SpATywNh6bZuzm8s1ceuBUnMUAeoAHHw,5,3,2,0,1,0,1,0,7,1.0,1,0.0,0,2,0,1,3,0,0,1,0,3,4,0
1151,49176,NPHytleW9ri0zHSbUOwP2d33PRO3w2MK,SpATywNh6bZuzm8s1ceuBUnMUAeoAHHw,3,2,1,0,0,0,1,0,4,0.5714285714285714,1,0.0,0,1,0,0,2,0,0,1,0,1,3,0
1152,49183,TNa2CwMEhRRkLaiFBsLLeLu23oFHBijc,SpATywNh6bZuzm8s1ceuBUnMUAeoAHHw,3,2,0,0,0,0,2,0,4,0.5714285714285714,1,0.0,0,0,0,0,2,0,0,2,0,0,4,0
1153,49202,l70wRZ2DS0s6LjbT7C4gRoGrF27x9p2H,A3fsA9Zfv1X2fVEQhTw51lKENdNrEqT3,7,11,0,0,0,2,6,0,19,2.7142857142857144,3,0.0,0,0,0,0,11,2,0,6,0,0,19,1
1154,49254,Hw8jmGp4VI4tAz6cfKhHDOeLB2t7MJ9z,SpATywNh6bZuzm8s1ceuBUnMUAeoAHHw,1,0,0,0,0,0,1,0,1,0.14285714285714285,1,0.0,0,0,0,0,0,0,0,1,0,0,1,1
1155,49271,L1EklyJfiTl8KTmYGUWKSBRLYXBLn3BW,SpATywNh6bZuzm8s1ceuBUnMUAeoAHHw,15,23,17,12,9,0,1,0,62,8.857142857142858,2,0.0,3,17,11,9,20,0,1,1,0,40,22,0
1156,49279,SAT7bMoLoVZhaMB8v6lFFmYFR0NgSYce,A3fsA9Zfv1X2fVEQhTw51lKENdNrEqT3,9,2,1,0,1,2,8,1,15,2.142857142857143,1,0.0,0,1,0,1,2,2,0,8,1,2,13,1
1157,49280,CGjJFqZQSngbEn6BLTOwdJsdGHCnhvU8,SpATywNh6bZuzm8s1ceuBUnMUAeoAHHw,14,14,6,5,4,0,3,0,32,4.571428571428571,1,0.0,3,6,4,4,11,0,1,3,0,17,15,1
1158,49302,3uU9hzp6POZeWb9TkpjJweQiyjZgKmLY,SpATywNh6bZuzm8s1ceuBUnMUAeoAHHw,1,0,0,0,0,0,1,0,1,0.14285714285714285,1,0.0,0,0,0,0,0,0,0,1,0,0,1,0
1159,49398,829nD15I0zFbxTlo9Kk4QZLCipO4Bdiu,A3fsA9Zfv1X2fVEQhTw51lKENdNrEqT3,2,0,0,0,0,0,2,0,2,0.2857142857142857,1,0.0,0,0,0,0,0,0,0,2,0,0,2,1
1160,49423,S9Zsax2BYcPzUt4rHtigt6S1ZlRCRjuu,SpATywNh6bZuzm8s1ceuBUnMUAeoAHHw,20,25,14,6,4,2,10,1,62,8.857142857142858,3,0.0,2,14,6,4,23,2,0,10,1,26,36,0
1161,49460,cvdLaf0MdwYwJIsGvs9mqC9xuvaOoxKF,A3fsA9Zfv1X2fVEQhTw51lKENdNrEqT3,22,43,9,0,6,0,7,1,66,9.428571428571429,2,0.0,0,9,0,6,43,0,0,7,1,15,51,1
1162,49511,H1nbdkC904EOh8jWeVVcV5piaqMVBsli,SpATywNh6bZuzm8s1ceuBUnMUAeoAHHw,3,4,1,0,0,0,2,0,7,1.0,2,0.0,0,1,0,0,4,0,0,2,0,1,6,0
1163,49513,I15DoIEv5oOQwZnGe2Nztxp5iKM5K2pr,SpATywNh6bZuzm8s1ceuBUnMUAeoAHHw,25,44,2,22,5,3,10,0,86,12.285714285714286,2,0.0,5,2,18,5,39,3,4,10,0,30,56,0
1164,49543,0OsY8LWQHJyrf2iZ6AGYuDrpmW3bfvqO,SpATywNh6bZuzm8s1ceuBUnMUAeoAHHw,18,29,13,11,4,0,10,0,67,9.571428571428571,4,0.0,8,13,10,4,21,0,1,10,0,35,32,0
1165,49553,bFQZxr4iRVJaZh2fO7R9dida2Y7glw1T,SpATywNh6bZuzm8s1ceuBUnMUAeoAHHw,31,28,13,37,8,1,7,1,95,13.571428571428571,2,0.0,13,13,32,8,15,1,5,7,1,66,29,0
1166,49610,G43uBjhkBEsnK2sHC51NOglfCGNDkydQ,SpATywNh6bZuzm8s1ceuBUnMUAeoAHHw,17,12,7,4,4,0,4,0,31,4.428571428571429,1,0.0,4,7,4,4,8,0,0,4,0,19,12,1
1167,49611,00SOCgKq1H6iYExhbauCeUrQFSjIMetG,SpATywNh6bZuzm8s1ceuBUnMUAeoAHHw,7,3,2,0,1,0,4,0,10,1.4285714285714286,1,0.0,0,2,0,1,3,0,0,4,0,3,7,0
1168,49620,twg5LqeyEPdLZyjl4T3Yb1man7ZRuOed,SpATywNh6bZuzm8s1ceuBUnMUAeoAHHw,1,0,0,0,0,0,3,0,3,0.42857142857142855,3,0.0,0,0,0,0,0,0,0,3,0,0,3,0
1169,49626,LiONc59joHBCh6XOJp7hfXs4mjQEsGy4,SpATywNh6bZuzm8s1ceuBUnMUAeoAHHw,14,15,7,17,3,0,6,0,48,6.857142857142857,2,0.0,5,7,17,3,10,0,0,6,0,32,16,1
1170,49633,lcYZKeyU0m8T0hVxudGSh4HqQiun1Pb4,SpATywNh6bZuzm8s1ceuBUnMUAeoAHHw,13,12,0,4,0,0,4,0,20,2.857142857142857,1,0.0,4,0,4,0,8,0,0,4,0,8,12,1
1171,49650,Y3zuofaAdrsNcwq0tuYyHFkAsBUWoV8a,SpATywNh6bZuzm8s1ceuBUnMUAeoAHHw,3,2,0,0,0,0,2,0,4,0.5714285714285714,1,0.0,0,0,0,0,2,0,0,2,0,0,4,0
1172,49654,1bKMONcV6Mq58szdlIajPdFyqaw4BvrA,SpATywNh6bZuzm8s1ceuBUnMUAeoAHHw,3,2,0,0,0,0,1,0,3,0.42857142857142855,1,0.0,0,0,0,0,2,0,0,1,0,0,3,1
1173,49655,H1nbdkC904EOh8jWeVVcV5piaqMVBsli,G8EPVSXsOYB5YQWZGiz1aVq5Pgr2GrQu,56,56,4,179,2,0,16,0,257,36.714285714285715,3,0.0,10,4,163,2,46,0,16,16,0,179,78,0
1174,49656,BoK7CAUaCFqnLgmWLxeOHg8YkXUSeCtc,SpATywNh6bZuzm8s1ceuBUnMUAeoAHHw,7,8,4,0,2,0,2,0,16,2.2857142857142856,1,0.0,0,4,0,2,8,0,0,2,0,6,10,0
1175,49679,GF5Rflu9cCcL8EFuacKpsHdGIeCCsr9m,SpATywNh6bZuzm8s1ceuBUnMUAeoAHHw,9,13,2,0,1,0,2,0,18,2.5714285714285716,1,0.0,0,2,0,1,13,0,0,2,0,3,15,0
1176,49691,bVLtn3iBc4ibW8xWVzLLM3Hs9gCB0qb7,SpATywNh6bZuzm8s1ceuBUnMUAeoAHHw,1,0,0,0,0,0,1,0,1,0.14285714285714285,1,0.0,0,0,0,0,0,0,0,1,0,0,1,0
1177,49705,Lce2TIYgGhTbahYzTHHK4e5KxnEianpx,G8EPVSXsOYB5YQWZGiz1aVq5Pgr2GrQu,5,2,1,0,1,0,3,0,7,1.0,2,0.0,0,1,0,1,2,0,0,3,0,2,5,1
1178,49710,LzTBHDjLePaTqbybIwaptvUgkC0hWYCZ,SpATywNh6bZuzm8s1ceuBUnMUAeoAHHw,2,0,0,0,0,0,2,0,2,0.2857142857142857,1,0.0,0,0,0,0,0,0,0,2,0,0,2,0
1179,49749,EwhKhClSv2Ps16I3uKtjdSj1YI7rGPIh,SpATywNh6bZuzm8s1ceuBUnMUAeoAHHw,5,4,2,0,0,0,1,0,7,1.0,1,0.0,0,2,0,0,4,0,0,1,0,2,5,0
1180,49759,k9PbwipCcCjE65bhyUr029mHfI0NwL1R,A3fsA9Zfv1X2fVEQhTw51lKENdNrEqT3,5,2,1,0,1,0,2,0,6,0.8571428571428571,1,0.0,0,1,0,1,2,0,0,2,0,2,4,1
1181,49766,Lce2TIYgGhTbahYzTHHK4e5KxnEianpx,SpATywNh6bZuzm8s1ceuBUnMUAeoAHHw,6,8,3,0,1,0,3,0,15,2.142857142857143,2,0.0,0,3,0,1,8,0,0,3,0,4,11,1
1182,49803,3FwKlBDtKGlNAYyQNzHL1qfkuXpNOPVW,A3fsA9Zfv1X2fVEQhTw51lKENdNrEqT3,15,17,12,0,5,2,14,0,50,7.142857142857143,3,0.0,0,12,0,5,17,2,0,14,0,17,33,0
1183,49863,rVswAzjMLz5uIPbCwAU1SliCQFpiAqey,SpATywNh6bZuzm8s1ceuBUnMUAeoAHHw,3,4,2,0,0,0,4,0,10,1.4285714285714286,2,0.0,0,2,0,0,4,0,0,4,0,2,8,0
1184,49883,m5Ev3sP4lHJ0ibeJ0LosEcT9fpQ7nqsa,SpATywNh6bZuzm8s1ceuBUnMUAeoAHHw,12,17,0,15,0,0,4,0,36,5.142857142857143,2,0.0,3,0,14,0,14,0,1,4,0,17,19,0
1185,49918,ydYJlUXOoM7xCFpD6o4c1fr3yZVc0YKb,SpATywNh6bZuzm8s1ceuBUnMUAeoAHHw,7,5,4,0,4,0,2,0,15,2.142857142857143,1,0.0,0,4,0,4,5,0,0,2,0,8,7,0
1186,49946,LNdimqsJkOxQDP9dT4IGwewg9YvH7zfV,G8EPVSXsOYB5YQWZGiz1aVq5Pgr2GrQu,21,13,6,22,4,0,1,0,46,6.571428571428571,1,0.0,6,6,17,4,7,0,5,1,0,33,13,0
1187,49949,8kmVwd95niwmuvSIAWJVA4Pqx2tMb8kH,A3fsA9Zfv1X2fVEQhTw51lKENdNrEqT3,10,9,0,0,0,0,1,0,10,1.4285714285714286,1,0.0,0,0,0,0,9,0,0,1,0,0,10,1
1188,49954,wUH86mMJYdGCZbgyy3OXf5PGskcw9ISy,RXDvfPUBYFlVdlueBFbLW0mhhAyGEqpt,12,9,1,0,0,6,7,1,24,3.4285714285714284,2,0.0,0,1,0,0,9,6,0,7,1,1,23,1
1189,49967,7tmNprOSiahGzByaY8XiUnCFEIQfWwuf,bWdj2GDclj5ofokWjzoa5jAwMkxCykd6,4,3,2,0,0,0,1,0,6,0.8571428571428571,1,0.0,0,2,0,0,3,0,0,1,0,2,4,0
1190,49987,ctfOhdlbQGiOVF89Y090EmsAqQEvSWmz,SpATywNh6bZuzm8s1ceuBUnMUAeoAHHw,17,36,1,12,0,0,10,0,59,8.428571428571429,5,0.0,12,1,11,0,24,0,1,10,0,24,35,0
1191,50046,Pot71eWzAwlFIQ6WGEu1vr9IkLdwRub9,SpATywNh6bZuzm8s1ceuBUnMUAeoAHHw,8,9,6,0,3,0,3,0,21,3.0,1,0.0,0,6,0,3,9,0,0,3,0,9,12,0
1192,50077,HNEdRWA988TWNlPkPkScnQdIH5zRazOo,SpATywNh6bZuzm8s1ceuBUnMUAeoAHHw,18,27,12,13,5,6,2,0,65,9.285714285714286,2,0.0,8,12,12,5,19,6,1,2,0,37,28,0
1193,50083,0lcODMnOtMqKwcOQQi0MUEWuUnIKYPe1,A3fsA9Zfv1X2fVEQhTw51lKENdNrEqT3,28,15,0,84,1,0,6,0,106,15.142857142857142,3,0.0,1,0,76,1,14,0,8,6,0,78,28,1
1194,50092,rPKaOWNl9cYkLvtQk035CJPYGwPAMUtv,SpATywNh6bZuzm8s1ceuBUnMUAeoAHHw,3,2,1,0,0,0,1,0,4,0.5714285714285714,1,0.0,0,1,0,0,2,0,0,1,0,1,3,0
1195,50099,sDoPeRFIl4sblcl7cpIozq9zgLVwKPZK,SpATywNh6bZuzm8s1ceuBUnMUAeoAHHw,9,6,1,2,0,0,2,0,11,1.5714285714285714,1,0.0,0,1,2,0,6,0,0,2,0,3,8,0
1196,50100,5u5MqcjfkyBtFhEFfICuuKJJdSbQMwNN,SpATywNh6bZuzm8s1ceuBUnMUAeoAHHw,14,27,12,19,5,0,4,0,67,9.571428571428571,1,0.0,11,12,16,5,16,0,3,4,0,44,23,1
1197,50143,kmn6CGih1FILZybV8MrApq46D7xH5npO,SpATywNh6bZuzm8s1ceuBUnMUAeoAHHw,13,11,7,0,5,4,7,0,34,4.857142857142857,3,0.0,0,7,0,5,11,4,0,7,0,12,22,0
1198,50175,CfX84b3AnOREjEgHXp5gQV78osBjxVJV,RXDvfPUBYFlVdlueBFbLW0mhhAyGEqpt,17,24,0,46,0,0,5,0,75,10.714285714285714,3,0.0,7,0,39,0,17,0,7,5,0,46,29,0
1199,50176,CU5xrwbVWBzQZTDEzCWYaPDOJwNXjtq2,A3fsA9Zfv1X2fVEQhTw51lKENdNrEqT3,15,22,3,0,3,7,2,0,37,5.285714285714286,5,0.0,0,3,0,3,22,7,0,2,0,6,31,0
1200,50254,rf43ZHojMqXQ775bmX3nnHgQ62d9XvGK,A3fsA9Zfv1X2fVEQhTw51lKENdNrEqT3,6,8,6,0,0,0,4,0,18,2.5714285714285716,2,0.0,0,6,0,0,8,0,0,4,0,6,12,1
1201,50280,8kmVwd95niwmuvSIAWJVA4Pqx2tMb8kH,bWdj2GDclj5ofokWjzoa5jAwMkxCykd6,1,0,0,0,0,0,1,0,1,0.14285714285714285,1,0.0,0,0,0,0,0,0,0,1,0,0,1,1
1202,50319,7eLlsseV075nalpvk2K7Ka9Wx9qMiOW4,SpATywNh6bZuzm8s1ceuBUnMUAeoAHHw,13,19,15,0,8,2,8,2,54,7.714285714285714,3,0.0,2,15,0,8,17,2,0,8,2,25,29,0
1203,50324,OIups6Cq9XY2CbwOPuI31XrOSt1FeD7G,SpATywNh6bZuzm8s1ceuBUnMUAeoAHHw,6,8,0,0,0,0,1,0,9,1.2857142857142858,1,0.0,0,0,0,0,8,0,0,1,0,0,9,0
1204,50348,4clLK6Y8CprtsnOm6pLtpUpbGTeCufAu,SpATywNh6bZuzm8s1ceuBUnMUAeoAHHw,15,22,9,9,5,0,3,0,48,6.857142857142857,1,0.0,9,9,9,5,13,0,0,3,0,32,16,0
1205,50374,hAzZgxrFOBoGWYS4hUaB1UgnpeWilVGC,SpATywNh6bZuzm8s1ceuBUnMUAeoAHHw,18,13,7,17,5,0,3,0,45,6.428571428571429,1,0.0,3,7,15,5,10,0,2,3,0,30,15,1
1206,50410,dy5U2Hr6hWmpYZri5b9XY0EijWuyuZjO,A3fsA9Zfv1X2fVEQhTw51lKENdNrEqT3,2,0,0,0,0,0,2,0,2,0.2857142857142857,1,0.0,0,0,0,0,0,0,0,2,0,0,2,1
1207,50414,x29OOChdmJGXK62DnUpwKbwJurqULmnD,A3fsA9Zfv1X2fVEQhTw51lKENdNrEqT3,2,0,0,0,0,0,2,0,2,0.2857142857142857,1,0.0,0,0,0,0,0,0,0,2,0,0,2,1
1208,50416,Xdag5jOmE7uWC3FmBvgPc5F7lO3QNcPW,SpATywNh6bZuzm8s1ceuBUnMUAeoAHHw,14,22,10,21,1,10,5,3,72,10.285714285714286,2,0.0,4,10,18,1,18,10,3,5,3,33,39,0
1209,50453,oeAE2ju0pElvnhTP1w6Sla895xthJTKj,A3fsA9Zfv1X2fVEQhTw51lKENdNrEqT3,1,0,0,0,0,0,1,0,1,0.14285714285714285,1,0.0,0,0,0,0,0,0,0,1,0,0,1,1
1210,50461,Mk1WltctY1vlvTjvcoOEN36uI9KP8emp,SpATywNh6bZuzm8s1ceuBUnMUAeoAHHw,14,24,14,0,7,0,5,0,50,7.142857142857143,3,0.0,1,14,0,7,23,0,0,5,0,22,28,0
1211,50508,9VvuC4slhZy3KdxqSDDnJl1JHYWZF5th,A3fsA9Zfv1X2fVEQhTw51lKENdNrEqT3,15,16,11,0,6,0,6,0,39,5.571428571428571,3,0.0,0,11,0,6,16,0,0,6,0,17,22,1
1212,50528,faeF4I5p3gAJMB1p4LfYVeCLQZKervYV,A3fsA9Zfv1X2fVEQhTw51lKENdNrEqT3,6,5,2,0,1,0,4,0,12,1.7142857142857142,3,0.0,0,2,0,1,5,0,0,4,0,3,9,1
1213,50546,8rXJHeqrLpho5nIQgbDcpBTvBrVnGged,A3fsA9Zfv1X2fVEQhTw51lKENdNrEqT3,25,4,0,54,0,0,18,0,76,10.857142857142858,3,0.0,1,0,50,0,3,0,4,18,0,51,25,1
1214,50573,8ksQz9dz4s7ijHzYWnxMOGz2bplP7OAs,SpATywNh6bZuzm8s1ceuBUnMUAeoAHHw,8,13,1,16,0,0,1,0,31,4.428571428571429,1,0.0,8,1,13,0,5,0,3,1,0,22,9,1
1215,50583,RDYqKiZt9A6fUXvjmZNUfSbfEZdDLqXa,A3fsA9Zfv1X2fVEQhTw51lKENdNrEqT3,8,3,2,0,2,0,3,0,10,1.4285714285714286,1,0.0,0,2,0,2,3,0,0,3,0,4,6,1
1216,50595,y1ePxH9bhUBdav1d6VZPfHfp0HugcSgX,A3fsA9Zfv1X2fVEQhTw51lKENdNrEqT3,7,3,2,0,2,0,2,0,9,1.2857142857142858,1,0.0,0,2,0,2,3,0,0,2,0,4,5,1
1217,50611,RgxmGDfKcBuOKimrAda6q6r1m3kTwJWg,A3fsA9Zfv1X2fVEQhTw51lKENdNrEqT3,5,2,1,0,1,0,2,0,6,0.8571428571428571,2,0.0,0,1,0,1,2,0,0,2,0,2,4,1
1218,50660,6jPw8ZwEXjLpnrxZT6HkwOQ20NkEyvU7,SpATywNh6bZuzm8s1ceuBUnMUAeoAHHw,1,0,0,0,0,0,1,0,1,0.14285714285714285,1,0.0,0,0,0,0,0,0,0,1,0,0,1,0
1219,50679,tqvOTiQbipkIXQL7CIR5dckxV83rng9S,G8EPVSXsOYB5YQWZGiz1aVq5Pgr2GrQu,3,2,1,0,0,0,1,0,4,0.5714285714285714,1,0.0,0,1,0,0,2,0,0,1,0,1,3,0
1220,50707,Aa2R9ra7UkMT71HsVEpaQpVn5z60q5tc,G8EPVSXsOYB5YQWZGiz1aVq5Pgr2GrQu,18,14,9,0,5,8,12,1,49,7.0,1,0.0,0,9,0,5,14,8,0,12,1,14,35,1
1221,50723,85CdJb1zpoAUDtR6sIsTNXjrVvfGwx1A,SpATywNh6bZuzm8s1ceuBUnMUAeoAHHw,28,70,26,20,7,16,12,0,151,21.571428571428573,4,0.0,31,26,16,7,39,16,4,12,0,80,71,0
1222,50754,FJxbzfYvIetXhjzEILF0NWt1RCss96LW,A3fsA9Zfv1X2fVEQhTw51lKENdNrEqT3,32,31,21,0,19,0,14,2,87,12.428571428571429,5,0.0,0,21,0,19,31,0,0,14,2,40,47,0
1223,50782,spcUWaGtojfez6ZdF6aqlTnU3zU2dqpy,A3fsA9Zfv1X2fVEQhTw51lKENdNrEqT3,67,75,35,122,21,10,24,1,288,41.142857142857146,2,0.0,5,35,102,21,70,10,20,24,1,163,125,0
1224,52454,quFRN0nuO6SCdHOgmUhTlayoumtzVI29,7GRhBDsirIGkRZBtSMEzNTyDr2JQm4xx,24,33,1,60,9,0,0,0,103,14.714285714285714,2,0.0,19,1,51,9,14,0,9,0,0,80,23,1
1225,52546,dNx7yBBYuWpRM4BeMNLD1yOnUwcueGfB,7GRhBDsirIGkRZBtSMEzNTyDr2JQm4xx,8,10,6,4,2,0,2,0,24,3.4285714285714284,1,0.0,1,6,2,2,9,0,2,2,0,11,13,1
1226,52669,Q8hb0j5K90GRKBQLUtk9egje9fPULAJD,7GRhBDsirIGkRZBtSMEzNTyDr2JQm4xx,2,0,0,0,0,0,2,0,2,0.2857142857142857,1,0.0,0,0,0,0,0,0,0,2,0,0,2,0
1227,53020,Z4kedXjIF6f3uubwtldCvvLQcT4vIEro,7GRhBDsirIGkRZBtSMEzNTyDr2JQm4xx,4,6,2,0,0,0,1,0,9,1.2857142857142858,1,0.0,3,2,0,0,3,0,0,1,0,5,4,1
1228,53048,8gk5kBMYT20pCB4wpUHe3xKwSYDbtvzS,SpATywNh6bZuzm8s1ceuBUnMUAeoAHHw,4,6,3,0,0,0,3,0,12,1.7142857142857142,2,0.0,0,3,0,0,6,0,0,3,0,3,9,1
1229,53049,8cVIhj7cvR0q9dzupEColmwPbOHZ624c,SpATywNh6bZuzm8s1ceuBUnMUAeoAHHw,1,0,0,0,0,0,1,0,1,0.14285714285714285,1,0.0,0,0,0,0,0,0,0,1,0,0,1,0
1230,53119,AwKhkfPOqEnTXG1Cn8Gmf8HHhYnwnTgu,SpATywNh6bZuzm8s1ceuBUnMUAeoAHHw,9,14,0,6,0,15,2,0,37,5.285714285714286,1,0.0,3,0,5,0,11,15,1,2,0,8,29,1
1231,53140,Jf77UYIvUtofHBGpvQMQ0qUfMZBh9rRJ,A3fsA9Zfv1X2fVEQhTw51lKENdNrEqT3,10,13,7,6,2,0,2,0,30,4.285714285714286,1,0.0,4,7,5,2,9,0,1,2,0,18,12,1
1232,53194,5y4YA2mbDcwuEjNHeStgjLfqN1rsKZgP,SpATywNh6bZuzm8s1ceuBUnMUAeoAHHw,4,3,0,0,0,0,1,0,4,0.5714285714285714,1,0.0,0,0,0,0,3,0,0,1,0,0,4,0
1233,53209,GOcyurvQpr52NaTeXKp3vF6yg377GcU5,SpATywNh6bZuzm8s1ceuBUnMUAeoAHHw,3,0,0,0,0,7,2,1,10,1.4285714285714286,1,0.0,0,0,0,0,0,7,0,2,1,0,10,0
1234,53360,boitIxZvCZ9przAKAQqxtWTvavMJkqzn,SpATywNh6bZuzm8s1ceuBUnMUAeoAHHw,3,2,1,0,0,0,2,0,5,0.7142857142857143,2,0.0,0,1,0,0,2,0,0,2,0,1,4,0
1235,53381,hJ48EYDAUcnIubJFw4NRxQxCK6ApJIxf,SpATywNh6bZuzm8s1ceuBUnMUAeoAHHw,1,0,0,0,0,0,1,0,1,0.14285714285714285,1,0.0,0,0,0,0,0,0,0,1,0,0,1,1
1236,53453,A4vEkOAwhpQEgLFKtjOc7tdIxawwQcIi,SpATywNh6bZuzm8s1ceuBUnMUAeoAHHw,1,0,0,0,0,0,1,0,1,0.14285714285714285,1,0.0,0,0,0,0,0,0,0,1,0,0,1,1
1237,53462,9rLNySnV0yxkzZA7V8enLIbzXZCrF6IJ,RXDvfPUBYFlVdlueBFbLW0mhhAyGEqpt,18,34,17,10,11,1,12,3,88,12.571428571428571,3,0.0,2,17,10,11,32,1,0,12,3,40,48,0
1238,53483,t20VhGjJQwmwXV8X5LeBQDucO3YuiMru,SpATywNh6bZuzm8s1ceuBUnMUAeoAHHw,10,17,1,0,0,26,5,1,50,7.142857142857143,2,0.0,5,1,0,0,12,26,0,5,1,6,44,0
1239,53484,WyWFczdn2Y2i2D9wUJkB93D49zn2CheK,SpATywNh6bZuzm8s1ceuBUnMUAeoAHHw,1,0,0,0,0,0,2,0,2,0.2857142857142857,1,0.0,0,0,0,0,0,0,0,2,0,0,2,0
1240,53507,sqZsZQq9LcjzbfCPmehLyMMrK3ClcYAT,A3fsA9Zfv1X2fVEQhTw51lKENdNrEqT3,1,0,0,0,0,0,1,0,1,0.14285714285714285,1,0.0,0,0,0,0,0,0,0,1,0,0,1,1
1241,53666,uxWS9amhXxmjOvqXmZExJSg0LcMFBAvq,RXDvfPUBYFlVdlueBFbLW0mhhAyGEqpt,9,5,4,0,1,1,12,2,25,3.5714285714285716,1,0.0,0,4,0,1,5,1,0,12,2,5,20,1
1242,53741,CV8kQrzk7Ma4h2GmuCAW4YCocO4w4WSf,bWdj2GDclj5ofokWjzoa5jAwMkxCykd6,1,0,0,0,0,0,1,0,1,0.14285714285714285,1,0.0,0,0,0,0,0,0,0,1,0,0,1,1
1243,53792,p62iTg6ZpvzODJCBLH2d7SVfdoSWuy8j,RXDvfPUBYFlVdlueBFbLW0mhhAyGEqpt,1,0,0,0,0,0,1,0,1,0.14285714285714285,1,0.0,0,0,0,0,0,0,0,1,0,0,1,0
1244,53805,sytW49I21SJ70ElOkXGU5SHeeHl1E3fL,A3fsA9Zfv1X2fVEQhTw51lKENdNrEqT3,3,2,1,0,0,0,1,0,4,0.5714285714285714,1,0.0,0,1,0,0,2,0,0,1,0,1,3,1
1245,53856,4jDSfVr3FM2ZrR7U3LMbeRYrZXGv5CAV,SpATywNh6bZuzm8s1ceuBUnMUAeoAHHw,12,25,7,20,2,0,1,0,55,7.857142857142857,1,0.0,17,7,17,2,8,0,3,1,0,43,12,1
1246,53986,z9sj5HIJml1DMOMfRKKBQ7IvS2IoE424,bWdj2GDclj5ofokWjzoa5jAwMkxCykd6,14,47,24,24,0,19,16,0,130,18.571428571428573,2,0.0,9,24,22,0,38,19,2,16,0,55,75,1
1247,54035,6UfIu5SKHPYfwZxBxJpGSqhLHKhbdsl0,SpATywNh6bZuzm8s1ceuBUnMUAeoAHHw,3,2,1,0,0,0,2,0,5,0.7142857142857143,1,0.0,0,1,0,0,2,0,0,2,0,1,4,0
1248,54086,uIIavYxNuEJ6NG2Ex383dBZvdILceLZJ,SpATywNh6bZuzm8s1ceuBUnMUAeoAHHw,18,27,11,17,4,0,6,1,66,9.428571428571429,1,0.0,13,11,16,4,14,0,1,6,1,44,22,0
1249,54100,ULxriJOFgcYW8OKrxzYPWeTN4MYJZpRj,SpATywNh6bZuzm8s1ceuBUnMUAeoAHHw,9,15,2,0,1,0,5,0,23,3.2857142857142856,2,0.0,0,2,0,1,15,0,0,5,0,3,20,1
1250,54112,GASbwPXxwryodKV3AqYKdU5jEaEhIE7r,SpATywNh6bZuzm8s1ceuBUnMUAeoAHHw,2,0,0,0,0,0,2,0,2,0.2857142857142857,1,0.0,0,0,0,0,0,0,0,2,0,0,2,0
1251,54120,S9bleRJbl0xJFa4yPXuTgULWJ67nbMqi,SpATywNh6bZuzm8s1ceuBUnMUAeoAHHw,16,18,11,12,6,0,4,0,51,7.285714285714286,3,0.0,2,11,10,6,16,0,2,4,0,29,22,0
1252,54156,QYaJtD7z5M6YcGNpdHV2JTsxqV4tXm9a,SpATywNh6bZuzm8s1ceuBUnMUAeoAHHw,1,0,0,0,0,0,2,0,2,0.2857142857142857,2,0.0,0,0,0,0,0,0,0,2,0,0,2,0
1253,54189,cN6OZq4ak5IqzN7Lw32XLOS12DhlWO8Q,A3fsA9Zfv1X2fVEQhTw51lKENdNrEqT3,60,46,25,156,13,7,5,0,252,36.0,2,0.0,4,25,121,13,42,7,35,5,0,163,89,0
1254,54193,smg4SHkT0uQ59GP6Camalxkw6c32vtzM,SpATywNh6bZuzm8s1ceuBUnMUAeoAHHw,4,0,0,0,0,1,3,0,4,0.5714285714285714,1,0.0,0,0,0,0,0,1,0,3,0,0,4,0
1255,54196,4mLn5YrkZbnxPXEuAYTSn9TKZyVmWQjo,SpATywNh6bZuzm8s1ceuBUnMUAeoAHHw,3,2,0,0,0,0,1,0,3,0.42857142857142855,1,0.0,0,0,0,0,2,0,0,1,0,0,3,0
1256,54209,ke8J6J68PMmqZ8rK8FCDUgXlLZQpLLZW,bWdj2GDclj5ofokWjzoa5jAwMkxCykd6,5,10,3,0,1,0,2,0,16,2.2857142857142856,2,0.0,0,3,0,1,10,0,0,2,0,4,12,1
1257,54256,wtEiMTsSGyqVYmzAUWtaJeXU5b3t5li0,SpATywNh6bZuzm8s1ceuBUnMUAeoAHHw,4,2,1,0,1,0,2,0,6,0.8571428571428571,1,0.0,0,1,0,1,2,0,0,2,0,2,4,0
1258,54354,1GwCcPnawuwjaFyAi38hoJxQ9NHTHcHa,SpATywNh6bZuzm8s1ceuBUnMUAeoAHHw,15,29,9,35,0,0,5,1,79,11.285714285714286,2,0.0,17,9,32,0,12,0,3,5,1,58,21,1
1259,54403,IiprEhfBJUF3Volv4Wt8hDKs67azhw4N,SpATywNh6bZuzm8s1ceuBUnMUAeoAHHw,3,4,2,0,0,0,3,0,9,1.2857142857142858,3,0.0,0,2,0,0,4,0,0,3,0,2,7,0
1260,54441,jWzOKFReJZdfMoypRkZGX0AJ4yOxVurG,SpATywNh6bZuzm8s1ceuBUnMUAeoAHHw,4,3,1,0,0,0,1,0,5,0.7142857142857143,1,0.0,0,1,0,0,3,0,0,1,0,1,4,1
1261,54474,2cQfWhwRUGUv48S47s2aDWYzSM5LRy6r,SpATywNh6bZuzm8s1ceuBUnMUAeoAHHw,10,12,1,16,0,0,2,0,31,4.428571428571429,2,0.0,2,1,14,0,10,0,2,2,0,17,14,1
1262,54539,obFplu8p0J5bdsesTSoaj6Bc4UGbTB6M,A3fsA9Zfv1X2fVEQhTw51lKENdNrEqT3,1,0,0,0,0,0,2,0,2,0.2857142857142857,1,0.0,0,0,0,0,0,0,0,2,0,0,2,1
1263,54609,zqJYLp2Za4wDRWdLkC6hOzbgm2qW4Dc0,fbPkOYLVPtPgIt0MxizjfFJov3JbHyAi,6,3,2,0,2,0,2,0,9,1.2857142857142858,1,0.0,0,2,0,2,3,0,0,2,0,4,5,1
1264,54633,dTyQ7W3SS3T02L83rAdjVWHrGRV4tFve,fbPkOYLVPtPgIt0MxizjfFJov3JbHyAi,2,0,0,0,0,0,2,0,2,0.2857142857142857,1,0.0,0,0,0,0,0,0,0,2,0,0,2,1
1265,54642,1SXEIjzcoG8fdGB2rpSblj2HngER2yeu,fbPkOYLVPtPgIt0MxizjfFJov3JbHyAi,1,0,0,0,0,0,1,0,1,0.14285714285714285,1,0.0,0,0,0,0,0,0,0,1,0,0,1,1
1266,54832,XTByA0ecuKljeTXiSoi3vawyiYSNo5Ez,SpATywNh6bZuzm8s1ceuBUnMUAeoAHHw,6,5,3,0,2,0,6,0,16,2.2857142857142856,1,0.0,0,3,0,2,5,0,0,6,0,5,11,0
1267,54970,YbQfcgwKrjskWW3wyOzQUUJYzdeHmY82,A3fsA9Zfv1X2fVEQhTw51lKENdNrEqT3,23,13,7,88,0,4,7,0,119,17.0,3,0.0,1,7,76,0,12,4,12,7,0,84,35,0
1268,54997,IJWUl0dWQiuiW9w5y2FbSbROivrhPUri,G8EPVSXsOYB5YQWZGiz1aVq5Pgr2GrQu,21,19,8,16,4,0,6,1,54,7.714285714285714,1,0.0,9,8,8,4,10,0,8,6,1,29,25,0
1269,55003,PnDN2WssnANedhxbDqo06cZR8VfXOHcf,SpATywNh6bZuzm8s1ceuBUnMUAeoAHHw,17,34,14,25,1,44,8,1,127,18.142857142857142,2,0.0,16,14,20,1,18,44,5,8,1,51,76,0
1270,55046,OsjipUObm67JsyJjOy7xHoa32L8CSYg5,7GRhBDsirIGkRZBtSMEzNTyDr2JQm4xx,23,23,1,22,2,0,2,0,50,7.142857142857143,2,0.0,10,1,22,2,13,0,0,2,0,35,15,1
1271,55086,PfTpx7WgTJY6IpNokJ2POml34GMs7LTI,A3fsA9Zfv1X2fVEQhTw51lKENdNrEqT3,34,13,9,64,5,0,4,0,95,13.571428571428571,3,0.0,1,9,64,5,12,0,0,4,0,79,16,0
1272,55102,tC06tDcyfiakkQ82nvNuQ9hOr0id1lp4,A3fsA9Zfv1X2fVEQhTw51lKENdNrEqT3,6,0,0,0,0,2,5,1,8,1.1428571428571428,1,0.0,0,0,0,0,0,2,0,5,1,0,8,1
1273,55218,9DhjEr6688N0pGcvfzUDBy2Ch8BrzD6G,SpATywNh6bZuzm8s1ceuBUnMUAeoAHHw,25,64,3,25,0,12,28,4,136,19.428571428571427,4,0.0,20,3,21,0,44,12,4,28,4,44,92,0
1274,55268,yRP1A8CWHIiqi7L2SKgryjvGOEaUovOk,SpATywNh6bZuzm8s1ceuBUnMUAeoAHHw,15,27,2,16,1,0,4,0,50,7.142857142857143,1,0.0,6,2,15,1,21,0,1,4,0,24,26,0
1275,55335,YPEupTuOqSGieSSneZcv3AcUcSBCtbGY,RXDvfPUBYFlVdlueBFbLW0mhhAyGEqpt,42,54,3,62,5,15,13,1,153,21.857142857142858,2,0.0,12,3,58,5,42,15,4,13,1,78,75,1
1276,55587,dNMg8HqASFn9pIW9ZR7BiQy6ZwZupOce,A3fsA9Zfv1X2fVEQhTw51lKENdNrEqT3,6,3,1,0,1,0,3,0,8,1.1428571428571428,1,0.0,0,1,0,1,3,0,0,3,0,2,6,1
1277,55589,dNMg8HqASFn9pIW9ZR7BiQy6ZwZupOce,bWdj2GDclj5ofokWjzoa5jAwMkxCykd6,5,2,1,0,1,0,2,0,6,0.8571428571428571,1,0.0,0,1,0,1,2,0,0,2,0,2,4,0
1278,55606,QuPJMxHrI2abilMygWFCmLFsgGUQO9Wm,bWdj2GDclj5ofokWjzoa5jAwMkxCykd6,11,13,7,12,3,0,3,0,38,5.428571428571429,1,0.0,3,7,9,3,10,0,3,3,0,22,16,1
1279,55714,ycZVLmNiTgP7M4zqov9Nx3hYhdN2qhKF,A3fsA9Zfv1X2fVEQhTw51lKENdNrEqT3,13,29,23,0,17,0,6,0,75,10.714285714285714,4,0.0,0,23,0,17,29,0,0,6,0,40,35,1
1280,55731,ybcsmPlarjax7Mq4kzteIAIZbYqmFvSY,G8EPVSXsOYB5YQWZGiz1aVq5Pgr2GrQu,4,3,2,0,0,0,1,0,6,0.8571428571428571,1,0.0,0,2,0,0,3,0,0,1,0,2,4,0
1281,55733,zVX5LPwTGC1SEitxSfv31cubNXKJSEc2,G8EPVSXsOYB5YQWZGiz1aVq5Pgr2GrQu,27,14,11,170,0,0,10,3,208,29.714285714285715,1,0.0,0,11,163,0,14,0,7,10,3,174,34,0
1282,55852,zC2jRq3r9EI7fiKmdxBaoujmdY4A8FN5,G8EPVSXsOYB5YQWZGiz1aVq5Pgr2GrQu,24,26,2,32,5,14,4,1,84,12.0,2,0.0,9,2,26,5,17,14,6,4,1,42,42,0
1283,55860,PmH4XgxtQe1CNb3l16TlTY5tyEhuC40E,SpATywNh6bZuzm8s1ceuBUnMUAeoAHHw,4,6,3,0,0,0,2,0,11,1.5714285714285714,2,0.0,0,3,0,0,6,0,0,2,0,3,8,0
1284,55918,JOqHNkiAQMopMtNnxSpHdAOKSp68V43j,A3fsA9Zfv1X2fVEQhTw51lKENdNrEqT3,23,4,2,78,0,7,5,0,96,13.714285714285714,1,0.0,1,2,65,0,3,7,13,5,0,68,28,1
1285,55928,ar4cwuAwjqKFHUFshoX4Vj4edt6iUva1,bWdj2GDclj5ofokWjzoa5jAwMkxCykd6,6,2,1,0,1,0,5,1,10,1.4285714285714286,1,0.0,0,1,0,1,2,0,0,5,1,2,8,0
1286,55978,JVRk883TChkd8D0ZSH6CEb3OUHD06lXQ,SpATywNh6bZuzm8s1ceuBUnMUAeoAHHw,1,0,0,0,0,0,3,0,3,0.42857142857142855,2,0.0,0,0,0,0,0,0,0,3,0,0,3,0
1287,56003,UqClTQDqKMNYDPHUpaTnYqiluGgaVwby,7GRhBDsirIGkRZBtSMEzNTyDr2JQm4xx,5,3,2,0,1,0,1,0,7,1.0,2,0.0,0,2,0,1,3,0,0,1,0,3,4,1
1288,56031,QOTn8ztUNlHS3hl3hqCv4ofIiB3cOmPL,SpATywNh6bZuzm8s1ceuBUnMUAeoAHHw,10,8,4,0,1,3,6,0,22,3.142857142857143,1,0.0,2,4,0,1,6,3,0,6,0,7,15,0
1289,56078,kKj1FlDO03hIJs4qO2fYyQxEzv7HbwXh,SpATywNh6bZuzm8s1ceuBUnMUAeoAHHw,9,19,0,0,0,0,4,0,23,3.2857142857142856,2,0.0,0,0,0,0,19,0,0,4,0,0,23,1
1290,56104,WZLkW7B5dsHccBcGjqVOiLakE0tHruAV,SpATywNh6bZuzm8s1ceuBUnMUAeoAHHw,6,7,1,0,1,0,1,0,10,1.4285714285714286,1,0.0,0,1,0,1,7,0,0,1,0,2,8,1
1291,56138,0K6JPqiivQzicxY4EV4nqMLCL3a08A97,7GRhBDsirIGkRZBtSMEzNTyDr2JQm4xx,2,0,0,0,0,0,2,0,2,0.2857142857142857,1,0.0,0,0,0,0,0,0,0,2,0,0,2,1
1292,56153,YgnjU1hWSGf8038ZkUT6S1YfeICauUtf,SpATywNh6bZuzm8s1ceuBUnMUAeoAHHw,17,16,7,9,5,2,1,0,40,5.714285714285714,1,0.0,8,7,9,5,8,2,0,1,0,29,11,0
1293,56160,e3Xx0LWeS8euUOsFo80XF3J80EQ2D87p,SpATywNh6bZuzm8s1ceuBUnMUAeoAHHw,24,44,3,22,3,0,7,1,80,11.428571428571429,3,0.0,8,3,18,3,36,0,4,7,1,32,48,0
1294,56189,sMMDk03UePJILkRIn5YDW5tA5us6h51J,SpATywNh6bZuzm8s1ceuBUnMUAeoAHHw,20,25,15,21,5,3,7,0,76,10.857142857142858,3,0.0,3,15,19,5,22,3,2,7,0,42,34,1
1295,56221,mxDmiNiZbTWbG5eX6cuqeU6lZnYbJUhB,SpATywNh6bZuzm8s1ceuBUnMUAeoAHHw,8,9,4,0,0,1,8,1,23,3.2857142857142856,2,0.0,0,4,0,0,9,1,0,8,1,4,19,0
1296,56260,GLN4A8S1FfCje62RkokqBLEULjMYf2Jo,SpATywNh6bZuzm8s1ceuBUnMUAeoAHHw,17,14,1,8,1,0,12,1,37,5.285714285714286,3,0.0,0,1,6,1,14,0,2,12,1,8,29,0
1297,56283,eCJEYxlte8R6sbqh66Nohv34rvkne1DG,SpATywNh6bZuzm8s1ceuBUnMUAeoAHHw,28,28,14,12,8,10,6,0,78,11.142857142857142,1,0.0,12,14,12,8,16,10,0,6,0,46,32,1
1298,56334,6A5mn3Pn8IBDZpMvNejUh5y2X9g7rQUJ,SpATywNh6bZuzm8s1ceuBUnMUAeoAHHw,10,9,1,7,1,0,7,0,25,3.5714285714285716,1,0.0,0,1,6,1,9,0,1,7,0,8,17,0
1299,56397,1KCmpfcoDnRnd9ITYAgYi4eQPwc5jiJz,SpATywNh6bZuzm8s1ceuBUnMUAeoAHHw,15,19,0,6,0,0,6,0,31,4.428571428571429,5,0.0,2,0,6,0,17,0,0,6,0,8,23,1
1300,56410,m7ppZFqoqxq4drq32V7wzPII9oNFXP01,SpATywNh6bZuzm8s1ceuBUnMUAeoAHHw,20,26,17,6,7,0,3,0,59,8.428571428571429,2,0.0,6,17,6,7,20,0,0,3,0,36,23,0
1301,56436,2B1Sa19tBbYgocD2xlB5fX7K09dmclmZ,SpATywNh6bZuzm8s1ceuBUnMUAeoAHHw,27,47,12,35,6,2,13,2,117,16.714285714285715,4,0.0,5,12,31,6,42,2,4,13,2,54,63,1
1302,56464,mUGiOApqSIPNJJAxx9ku1Ubhn4j7vYNp,SpATywNh6bZuzm8s1ceuBUnMUAeoAHHw,16,21,5,9,3,3,5,0,46,6.571428571428571,2,0.0,6,5,9,3,15,3,0,5,0,23,23,0
1303,56517,Rz28tFT5qYZaEQ78Ly3OdJx8TpvsmLBy,A3fsA9Zfv1X2fVEQhTw51lKENdNrEqT3,4,6,2,0,0,0,5,0,13,1.8571428571428572,2,0.0,0,2,0,0,6,0,0,5,0,2,11,0
1304,56566,6qgQAmX6y5wh5nEPRINOiKrZNoTl5yfT,G8EPVSXsOYB5YQWZGiz1aVq5Pgr2GrQu,53,46,26,64,13,0,8,3,160,22.857142857142858,3,0.0,13,26,52,13,33,0,12,8,3,104,56,0
1305,56617,hhlID9e9RXNsuOHzHvfjbzrkpQmbpeir,SpATywNh6bZuzm8s1ceuBUnMUAeoAHHw,18,13,9,10,4,0,2,0,38,5.428571428571429,3,0.0,3,9,9,4,10,0,1,2,0,25,13,1
1306,56636,PdrdE0IIRUHKPZyUMDrlUIJ0Ny8UuZco,A3fsA9Zfv1X2fVEQhTw51lKENdNrEqT3,14,6,3,14,1,0,9,0,33,4.714285714285714,2,0.0,0,3,13,1,6,0,1,9,0,17,16,1
1307,56642,7ttzq6sOsWQ5eEpZriKP7OLuIb0DcSbF,SpATywNh6bZuzm8s1ceuBUnMUAeoAHHw,22,22,11,18,4,2,5,1,63,9.0,2,0.0,9,11,15,4,13,2,3,5,1,39,24,0
1308,56652,uHeTIz8GkglZUts3zio1tGR2aBoYwiQE,bWdj2GDclj5ofokWjzoa5jAwMkxCykd6,17,16,8,23,4,0,2,0,53,7.571428571428571,2,0.0,4,8,23,4,12,0,0,2,0,39,14,1
1309,56653,A0M3i5nfjroJ4PM9wmVXYOoLY3tY0fag,SpATywNh6bZuzm8s1ceuBUnMUAeoAHHw,9,43,0,19,0,0,0,0,62,8.857142857142858,3,0.0,17,0,17,0,26,0,2,0,0,34,28,0
1310,56657,QjRqlcg02MPH1ssCHCoMGSYCtFlPbtU9,A3fsA9Zfv1X2fVEQhTw51lKENdNrEqT3,5,4,1,0,1,0,5,0,11,1.5714285714285714,3,0.0,0,1,0,1,4,0,0,5,0,2,9,1
1311,56678,GHx2mQF50a1TJotiqGtGfhTS2ssF34QK,A3fsA9Zfv1X2fVEQhTw51lKENdNrEqT3,5,2,1,0,1,0,2,0,6,0.8571428571428571,1,0.0,0,1,0,1,2,0,0,2,0,2,4,1
1312,56721,SK7IxqKpOFb3vAlYnYjFjD4PVuXVBlrm,SpATywNh6bZuzm8s1ceuBUnMUAeoAHHw,24,48,4,36,1,19,15,2,125,17.857142857142858,2,0.0,14,4,32,1,34,19,4,15,2,51,74,0
1313,56732,csg0yBjjrshmLGGyq6UVgiiqMZP9T0vI,bWdj2GDclj5ofokWjzoa5jAwMkxCykd6,9,7,5,0,4,0,7,1,24,3.4285714285714284,3,0.0,0,5,0,4,7,0,0,7,1,9,15,1
1314,56733,i9CWvduTcskommMHOeHEvsItP05JGHxW,SpATywNh6bZuzm8s1ceuBUnMUAeoAHHw,17,29,9,10,4,0,3,0,55,7.857142857142857,3,0.0,8,9,8,4,21,0,2,3,0,29,26,0
1315,56741,GXi0JiFESUZlctzkqcyy8vfaIeTzKOhp,SpATywNh6bZuzm8s1ceuBUnMUAeoAHHw,21,22,12,0,8,0,5,0,47,6.714285714285714,3,0.0,6,12,0,8,16,0,0,5,0,26,21,1
1316,56758,3X0JLX6UvJnnRb5GkwbFJgAokE5g69D0,A3fsA9Zfv1X2fVEQhTw51lKENdNrEqT3,46,23,13,162,1,0,3,0,202,28.857142857142858,1,0.0,5,13,145,1,18,0,17,3,0,164,38,1
1317,56782,Kh53GURdm4wzt7JTpZoCCzo0wL64E4IV,SpATywNh6bZuzm8s1ceuBUnMUAeoAHHw,1,0,0,0,0,0,1,0,1,0.14285714285714285,1,0.0,0,0,0,0,0,0,0,1,0,0,1,1
1318,56787,73lhhrOcE2srJj5BkIzSweWSnQRZBT2o,bWdj2GDclj5ofokWjzoa5jAwMkxCykd6,30,39,25,84,0,0,8,0,156,22.285714285714285,3,0.0,5,25,71,0,34,0,13,8,0,101,55,1
1319,56824,1NMKAl678ZBpdBkhXfYTAgEyYygMZz0x,SpATywNh6bZuzm8s1ceuBUnMUAeoAHHw,13,18,2,0,2,0,5,0,27,3.857142857142857,2,0.0,1,2,0,2,17,0,0,5,0,5,22,1
1320,56826,ilWzYGLWBh9DSc1MV8g2C4Go5wDNgUHX,A3fsA9Zfv1X2fVEQhTw51lKENdNrEqT3,5,6,4,0,0,3,5,0,18,2.5714285714285716,2,0.0,0,4,0,0,6,3,0,5,0,4,14,0
1321,56867,qDignCY8ZSbFAHDmfGr6um90qnmxvInL,bWdj2GDclj5ofokWjzoa5jAwMkxCykd6,38,38,22,74,12,21,9,1,177,25.285714285714285,2,0.0,9,22,60,12,29,21,14,9,1,103,74,1
1322,56869,F1uYmg9j3YwgNnk0aXzCliVPelaqL3Ra,G8EPVSXsOYB5YQWZGiz1aVq5Pgr2GrQu,2,0,0,0,0,0,2,0,2,0.2857142857142857,1,0.0,0,0,0,0,0,0,0,2,0,0,2,1
1323,56879,7bo2b6hOKJdeJMUZPegC3OXRiqnOBuKu,SpATywNh6bZuzm8s1ceuBUnMUAeoAHHw,1,0,0,0,0,0,2,0,2,0.2857142857142857,1,0.0,0,0,0,0,0,0,0,2,0,0,2,1
1324,56886,PJRBo6fo8GkTYEZAj3yApWIU4z2xQiJ3,SpATywNh6bZuzm8s1ceuBUnMUAeoAHHw,12,26,9,0,9,0,3,0,47,6.714285714285714,1,0.0,0,9,0,9,26,0,0,3,0,18,29,1
1325,56891,afVQ7OP9Yg7nQrenfRDF9heWvtL5syxt,SpATywNh6bZuzm8s1ceuBUnMUAeoAHHw,1,0,0,0,0,0,2,0,2,0.2857142857142857,1,0.0,0,0,0,0,0,0,0,2,0,0,2,1
1326,56952,H7pGBNaBrGHYeUmvNiEOm731zZ0Xqtux,RXDvfPUBYFlVdlueBFbLW0mhhAyGEqpt,14,20,6,0,6,2,8,1,43,6.142857142857143,2,0.0,2,6,0,6,18,2,0,8,1,14,29,1
1327,56959,qZhmmNUvkNXdf3u04DTUQOFEBxxO10p4,A3fsA9Zfv1X2fVEQhTw51lKENdNrEqT3,9,5,4,0,3,0,1,0,13,1.8571428571428572,1,0.0,0,4,0,3,5,0,0,1,0,7,6,1
1328,56994,7W8jjJVFEvdsz605K0BoRU3E0G6E9Kji,G8EPVSXsOYB5YQWZGiz1aVq5Pgr2GrQu,1,0,0,0,0,0,1,0,1,0.14285714285714285,1,0.0,0,0,0,0,0,0,0,1,0,0,1,1
1329,56999,vbTgITzq6jZRj0oUV5gFotgOlwSXnjML,G8EPVSXsOYB5YQWZGiz1aVq5Pgr2GrQu,37,42,24,82,7,7,8,0,170,24.285714285714285,1,0.0,13,24,65,7,29,7,17,8,0,109,61,0
1330,57006,dJ2h8ddhmpweKKIE5BpE7xXimjPVsm52,G8EPVSXsOYB5YQWZGiz1aVq5Pgr2GrQu,1,0,0,0,0,0,1,0,1,0.14285714285714285,1,0.0,0,0,0,0,0,0,0,1,0,0,1,0
1331,57008,ZtLnEkCqeRnvyqFQdbYPmQSGK8YkXNE8,SpATywNh6bZuzm8s1ceuBUnMUAeoAHHw,15,15,1,15,1,0,6,1,39,5.571428571428571,2,0.0,4,1,15,1,11,0,0,6,1,21,18,0
1332,57029,I7IIrHAh1LzzCf8lcvI92o8deFulzAh8,SpATywNh6bZuzm8s1ceuBUnMUAeoAHHw,1,0,0,0,0,0,1,0,1,0.14285714285714285,1,0.0,0,0,0,0,0,0,0,1,0,0,1,1
1333,57044,I7IIrHAh1LzzCf8lcvI92o8deFulzAh8,bWdj2GDclj5ofokWjzoa5jAwMkxCykd6,1,0,0,0,0,0,1,0,1,0.14285714285714285,1,0.0,0,0,0,0,0,0,0,1,0,0,1,1
1334,57046,AKrswbnpGlIzlwfZKfo5lwKhJzNpXmb1,SpATywNh6bZuzm8s1ceuBUnMUAeoAHHw,13,35,1,17,0,0,3,0,56,8.0,1,0.0,18,1,15,0,17,0,2,3,0,34,22,0
1335,57056,uMWcv4ZmW7X4PBv6egGkJZliUjuRluME,RXDvfPUBYFlVdlueBFbLW0mhhAyGEqpt,1,0,0,0,0,0,1,0,1,0.14285714285714285,1,0.0,0,0,0,0,0,0,0,1,0,0,1,1
1336,57059,cYibpCaMUGq0WjgUWfTv0iIvJ7QbFj5E,A3fsA9Zfv1X2fVEQhTw51lKENdNrEqT3,18,8,8,0,8,0,12,0,36,5.142857142857143,3,0.0,0,8,0,8,8,0,0,12,0,16,20,1
1337,57064,vAq6n4okEOzm4Q7527tzA1bof68awv28,G8EPVSXsOYB5YQWZGiz1aVq5Pgr2GrQu,9,6,1,0,1,0,2,0,10,1.4285714285714286,1,0.0,0,1,0,1,6,0,0,2,0,2,8,1
1338,57065,nxmaEvO6WAl9UO0RB8OmpscRPO1Nbssm,A3fsA9Zfv1X2fVEQhTw51lKENdNrEqT3,6,4,1,0,1,0,1,0,7,1.0,1,0.0,0,1,0,1,4,0,0,1,0,2,5,1
1339,57070,uMWcv4ZmW7X4PBv6egGkJZliUjuRluME,G8EPVSXsOYB5YQWZGiz1aVq5Pgr2GrQu,5,5,0,0,0,0,2,0,7,1.0,1,0.0,0,0,0,0,5,0,0,2,0,0,7,1
1340,57196,9hgjLw4OD5u1XjZx0s9EMRnEguVXBlYy,A3fsA9Zfv1X2fVEQhTw51lKENdNrEqT3,14,12,8,0,6,0,1,0,27,3.857142857142857,1,0.0,0,8,0,6,12,0,0,1,0,14,13,1
1341,57250,3Jq0rhguTOZ7fja70sOOKUPAPqu7fQyT,SpATywNh6bZuzm8s1ceuBUnMUAeoAHHw,6,5,4,0,0,1,4,0,14,2.0,3,0.0,0,4,0,0,5,1,0,4,0,4,10,0
1342,57265,NFGYUC7dcOkWJh2BiZLJheVSucAvXvpt,bWdj2GDclj5ofokWjzoa5jAwMkxCykd6,15,18,2,47,0,18,11,2,98,14.0,3,0.0,1,2,43,0,17,18,4,11,2,46,52,0
1343,57277,bt7h6JIDcUKzJSKeXMoVM1LEqwbXUCBJ,SpATywNh6bZuzm8s1ceuBUnMUAeoAHHw,13,32,1,18,0,0,7,0,58,8.285714285714286,3,0.0,4,1,15,0,28,0,3,7,0,20,38,0
1344,57321,mSToVMacc08MhsUyEFn562K69bpANB3P,A3fsA9Zfv1X2fVEQhTw51lKENdNrEqT3,76,25,21,74,18,0,3,0,141,20.142857142857142,1,0.0,3,21,74,18,22,0,0,3,0,116,25,1
1345,57323,xayicpjClPkwcfGTr3r84hb5pfZk0nB8,RXDvfPUBYFlVdlueBFbLW0mhhAyGEqpt,19,19,12,6,9,4,8,1,59,8.428571428571429,2,0.0,4,12,6,9,15,4,0,8,1,31,28,1
1346,57327,RdOaDfHEeBBslFA96Ipf8QaGmA7wq7Rz,SpATywNh6bZuzm8s1ceuBUnMUAeoAHHw,4,3,0,0,0,0,3,0,6,0.8571428571428571,1,0.0,0,0,0,0,3,0,0,3,0,0,6,0
1347,57329,XyoP35cBUiKk44G72mbtEXCBjk8FmHfo,bWdj2GDclj5ofokWjzoa5jAwMkxCykd6,25,43,27,36,9,1,26,0,142,20.285714285714285,3,0.0,4,27,28,9,39,1,8,26,0,68,74,1
1348,57345,SmBAgHRNeYWZKP2SpqpKXwVR3YhUZnjq,SpATywNh6bZuzm8s1ceuBUnMUAeoAHHw,14,22,0,16,0,7,11,0,56,8.0,2,0.0,9,0,14,0,13,7,2,11,0,23,33,0
1349,57353,3SNPt0tgFaFs22ZCc56rWyLmizBS9I72,SpATywNh6bZuzm8s1ceuBUnMUAeoAHHw,1,0,0,0,0,0,1,0,1,0.14285714285714285,1,0.0,0,0,0,0,0,0,0,1,0,0,1,1
1350,57423,MJQDYgQSk0Dles3B2EOjCe8Rc6SLp0Te,SpATywNh6bZuzm8s1ceuBUnMUAeoAHHw,1,0,0,0,0,0,1,0,1,0.14285714285714285,1,0.0,0,0,0,0,0,0,0,1,0,0,1,1
1351,57424,ITiFsDuHkhq2oCixW0Woe4mx6l3FjxPc,SpATywNh6bZuzm8s1ceuBUnMUAeoAHHw,7,5,2,0,2,0,2,0,11,1.5714285714285714,1,0.0,0,2,0,2,5,0,0,2,0,4,7,1
1352,57453,1ITGuQ2R8DpLVa12S7xW3GeCStKCoFln,SpATywNh6bZuzm8s1ceuBUnMUAeoAHHw,6,5,1,12,0,0,4,0,22,3.142857142857143,1,0.0,1,1,10,0,4,0,2,4,0,12,10,1
1353,57522,FCOtK161WkcVOQohkw4NuKVb2dJLDsJS,A3fsA9Zfv1X2fVEQhTw51lKENdNrEqT3,1,0,0,0,0,0,1,0,1,0.14285714285714285,1,0.0,0,0,0,0,0,0,0,1,0,0,1,1
1354,57525,OLSxCkluLildKVrVnzRIsj47tt9tVHj9,bWdj2GDclj5ofokWjzoa5jAwMkxCykd6,5,2,1,0,1,0,3,0,7,1.0,1,0.0,0,1,0,1,2,0,0,3,0,2,5,1
1355,57544,rwwtkpIIPQWlSN0q7WUWaQBBUS2Mm6IT,SpATywNh6bZuzm8s1ceuBUnMUAeoAHHw,1,0,0,0,0,0,1,0,1,0.14285714285714285,1,0.0,0,0,0,0,0,0,0,1,0,0,1,1
1356,57550,mN3Kbbx6eP7NH0lwyK6LVlERNttoP58u,SpATywNh6bZuzm8s1ceuBUnMUAeoAHHw,2,0,0,0,0,0,3,0,3,0.42857142857142855,1,0.0,0,0,0,0,0,0,0,3,0,0,3,1
1357,57552,JjC5gQBcEdEGxqUfdmNRpoNHaHUkhFr3,SpATywNh6bZuzm8s1ceuBUnMUAeoAHHw,18,15,5,11,3,0,5,1,40,5.714285714285714,1,0.0,4,5,10,3,11,0,1,5,1,22,18,1
1358,57576,uA7r7QkkxMOoLmO6n5eQTQ4mcfRiz1sY,SpATywNh6bZuzm8s1ceuBUnMUAeoAHHw,7,1,1,0,1,0,5,0,8,1.1428571428571428,1,0.0,0,1,0,1,1,0,0,5,0,2,6,1
1359,57641,C2kNfLlJQRAYF9jyyvOY33F0K0B7w85s,bWdj2GDclj5ofokWjzoa5jAwMkxCykd6,6,4,2,0,2,0,1,0,9,1.2857142857142858,1,0.0,0,2,0,2,4,0,0,1,0,4,5,1
1360,57657,r4CghvxKbP3R549p5B3LTdvr7lbYRqXF,G8EPVSXsOYB5YQWZGiz1aVq5Pgr2GrQu,3,2,1,0,0,0,1,0,4,0.5714285714285714,1,0.0,0,1,0,0,2,0,0,1,0,1,3,0
1361,57679,f3dcnqPelEIMHduho80ktIjNJSihd3u6,SpATywNh6bZuzm8s1ceuBUnMUAeoAHHw,8,6,3,0,1,0,8,1,19,2.7142857142857144,2,0.0,0,3,0,1,6,0,0,8,1,4,15,1
1362,57684,uq4F79CzLXcUWikv4BbYmEqP6niBgdHB,SpATywNh6bZuzm8s1ceuBUnMUAeoAHHw,6,3,2,0,2,0,1,0,8,1.1428571428571428,1,0.0,0,2,0,2,3,0,0,1,0,4,4,1
1363,57687,pRBbSmiVEBaGz4jkeqwSc7HR4j4zPAwQ,RXDvfPUBYFlVdlueBFbLW0mhhAyGEqpt,5,0,0,0,0,1,4,1,6,0.8571428571428571,1,0.0,0,0,0,0,0,1,0,4,1,0,6,1
1364,57710,pp3MkpuoWvkyzXCuYr4td0R2Hp9mxMXr,RXDvfPUBYFlVdlueBFbLW0mhhAyGEqpt,4,3,2,0,0,0,1,0,6,0.8571428571428571,1,0.0,0,2,0,0,3,0,0,1,0,2,4,1
1365,57716,oDMwcP97XCFhatRKDALyEk29j0A66Zee,SpATywNh6bZuzm8s1ceuBUnMUAeoAHHw,6,1,1,0,1,0,5,0,8,1.1428571428571428,2,0.0,0,1,0,1,1,0,0,5,0,2,6,1
1366,57761,tS5yd0InBPlA0CVUCBIjrGWKHeeeibf9,A3fsA9Zfv1X2fVEQhTw51lKENdNrEqT3,8,13,7,0,1,0,6,0,27,3.857142857142857,1,0.0,2,7,0,1,11,0,0,6,0,10,17,0
1367,57796,oieeinmRIRZuvg1KZp8yYpFAojV2pQvR,SpATywNh6bZuzm8s1ceuBUnMUAeoAHHw,9,8,5,0,3,1,6,0,23,3.2857142857142856,1,0.0,0,5,0,3,8,1,0,6,0,8,15,1
1368,57841,7J9JIWVCQG1g6yXh3uTVbrSu3pa18Ezn,bWdj2GDclj5ofokWjzoa5jAwMkxCykd6,10,14,6,6,3,1,3,0,33,4.714285714285714,2,0.0,4,6,6,3,10,1,0,3,0,19,14,1
1369,57843,23LSJ7PS8hJRx4MiulnRK0RfIKtQHqFP,SpATywNh6bZuzm8s1ceuBUnMUAeoAHHw,1,0,0,0,0,0,1,0,1,0.14285714285714285,1,0.0,0,0,0,0,0,0,0,1,0,0,1,1
1370,57857,4dPv5sV5dbfclN0Y8IwI4Ic117ct14yS,SpATywNh6bZuzm8s1ceuBUnMUAeoAHHw,5,3,0,0,0,0,3,0,6,0.8571428571428571,2,0.0,0,0,0,0,3,0,0,3,0,0,6,1
1371,57876,ftjlnmyEYFbgOc72QgwdUJYu6fgVXYpz,A3fsA9Zfv1X2fVEQhTw51lKENdNrEqT3,7,3,2,0,2,0,3,0,10,1.4285714285714286,1,0.0,0,2,0,2,3,0,0,3,0,4,6,1
1372,57907,4lfVtIfwsnJZLFeonBqOpKEgIshst3Yq,SpATywNh6bZuzm8s1ceuBUnMUAeoAHHw,10,24,12,5,7,0,9,0,57,8.142857142857142,1,0.0,6,12,4,7,18,0,1,9,0,29,28,0
1373,57910,se9ZVl8DNkiCW8i2nP0p3krrUcQqYC47,A3fsA9Zfv1X2fVEQhTw51lKENdNrEqT3,7,3,2,10,0,0,5,0,20,2.857142857142857,1,0.0,0,2,10,0,3,0,0,5,0,12,8,0
1374,57952,Axw4HBt3l6GD2DONFf7w1tmix5Mk5VUT,A3fsA9Zfv1X2fVEQhTw51lKENdNrEqT3,1,0,0,0,0,0,1,0,1,0.14285714285714285,1,0.0,0,0,0,0,0,0,0,1,0,0,1,1
1375,57987,sqasMoGc0IU5lpNZsO5KtcLYxSWllMxq,RXDvfPUBYFlVdlueBFbLW0mhhAyGEqpt,12,18,8,4,7,4,9,9,59,8.428571428571429,1,0.0,2,8,2,7,16,4,2,9,9,19,40,0
1376,58013,Bf025FfgNrlcqN8gYGnmBAhjBy0v5Xmo,bWdj2GDclj5ofokWjzoa5jAwMkxCykd6,7,4,3,0,2,0,1,0,10,1.4285714285714286,1,0.0,0,3,0,2,4,0,0,1,0,5,5,1
1377,58025,SJPM6RlM27WGlBQJlWcTA7fvsKmlPxUf,SpATywNh6bZuzm8s1ceuBUnMUAeoAHHw,7,2,1,0,1,0,6,0,10,1.4285714285714286,1,0.0,0,1,0,1,2,0,0,6,0,2,8,1
1378,58062,rGJvvNRNeS4weXphC4pxwlmBwDQi7NXo,SpATywNh6bZuzm8s1ceuBUnMUAeoAHHw,19,29,13,8,9,1,11,2,73,10.428571428571429,2,0.0,12,13,7,9,17,1,1,11,2,41,32,0
1379,58069,nWDRtsdyQI6TNTQknsvrXkgOEaTh8I0k,SpATywNh6bZuzm8s1ceuBUnMUAeoAHHw,5,3,2,0,0,0,2,0,7,1.0,1,0.0,0,2,0,0,3,0,0,2,0,2,5,0
1380,58142,G2OV1K6QAb8ZlrDRCrLDF7tfA5J7JUDN,SpATywNh6bZuzm8s1ceuBUnMUAeoAHHw,5,5,3,0,1,0,1,0,10,1.4285714285714286,1,0.0,0,3,0,1,5,0,0,1,0,4,6,1
1381,58147,GHWD27wG643ibd6OSLThLJ3MzX9fgfxx,A3fsA9Zfv1X2fVEQhTw51lKENdNrEqT3,22,19,12,0,9,0,5,0,45,6.428571428571429,2,0.0,0,12,0,9,19,0,0,5,0,21,24,1
1382,58148,yvxDmdTtwak3ePh9ZZvgT2yHbtqhLJuU,SpATywNh6bZuzm8s1ceuBUnMUAeoAHHw,5,2,1,0,1,0,2,0,6,0.8571428571428571,1,0.0,0,1,0,1,2,0,0,2,0,2,4,1
1383,58156,wXw48gUOB5BEkScgUyQMzs63eq0ygNDQ,RXDvfPUBYFlVdlueBFbLW0mhhAyGEqpt,2,0,0,0,0,0,5,0,5,0.7142857142857143,2,0.0,0,0,0,0,0,0,0,5,0,0,5,1
1384,58162,g2crr0D1YRZspeg3aG0QVrkBBPBltTjz,RXDvfPUBYFlVdlueBFbLW0mhhAyGEqpt,6,4,1,0,0,0,2,0,7,1.0,1,0.0,0,1,0,0,4,0,0,2,0,1,6,0
1385,58172,I4jcIexarcejSCh8gI54DZO3U7SFfRnT,A3fsA9Zfv1X2fVEQhTw51lKENdNrEqT3,3,0,0,0,0,0,4,0,4,0.5714285714285714,1,0.0,0,0,0,0,0,0,0,4,0,0,4,1
1386,58212,ZguimpvCE02pFqkl0KfDAtmrarDM70Qf,SpATywNh6bZuzm8s1ceuBUnMUAeoAHHw,6,3,1,0,0,0,4,0,8,1.1428571428571428,1,0.0,0,1,0,0,3,0,0,4,0,1,7,1
1387,58217,v1amutsyDOYm3WMqvptGI8JyXdvsTElC,SpATywNh6bZuzm8s1ceuBUnMUAeoAHHw,8,6,1,0,0,2,9,2,20,2.857142857142857,2,0.0,0,1,0,0,6,2,0,9,2,1,19,1
1388,58219,edP9uXMvyr9FSmSy32CnOxTQSMqfGr89,bWdj2GDclj5ofokWjzoa5jAwMkxCykd6,14,25,11,154,4,3,6,0,203,29.0,1,0.0,8,11,145,4,17,3,9,6,0,168,35,1
1389,58223,nZTn5dZMRyIKKNGuMbIWH6lpWaWoYX62,A3fsA9Zfv1X2fVEQhTw51lKENdNrEqT3,6,5,0,0,0,2,7,0,14,2.0,1,0.0,0,0,0,0,5,2,0,7,0,0,14,1
1390,58235,L4PW9E8umRTJy4rgt9ZPyCVXzCxIYlU4,SpATywNh6bZuzm8s1ceuBUnMUAeoAHHw,13,22,7,13,1,20,4,0,67,9.571428571428571,2,0.0,12,7,11,1,10,20,2,4,0,31,36,0
1391,58251,9irOSn8DGZwWtwp11aWu1YWsaS4jzhvZ,SpATywNh6bZuzm8s1ceuBUnMUAeoAHHw,4,4,0,0,0,0,1,0,5,0.7142857142857143,1,0.0,0,0,0,0,4,0,0,1,0,0,5,1
1392,58280,5lq0KJvq1lt50dcD5m6Vr40ogvrDdcc4,bWdj2GDclj5ofokWjzoa5jAwMkxCykd6,6,8,5,0,3,0,5,0,21,3.0,2,0.0,0,5,0,3,8,0,0,5,0,8,13,1
1393,58282,Gqs4K8SBL8tl8fMHpBqpJerrgEsieHU3,SpATywNh6bZuzm8s1ceuBUnMUAeoAHHw,16,19,9,14,4,0,2,0,48,6.857142857142857,3,0.0,2,9,13,4,17,0,1,2,0,28,20,0
1394,58305,skJn7dtfSekFrPHRHs9swZ9AtSUKi36u,A3fsA9Zfv1X2fVEQhTw51lKENdNrEqT3,4,4,3,0,0,0,1,0,8,1.1428571428571428,1,0.0,0,3,0,0,4,0,0,1,0,3,5,1
1395,58333,e3wUoJuzsENUfMiDHKcPh8dxiNI0W3xf,G8EPVSXsOYB5YQWZGiz1aVq5Pgr2GrQu,12,9,1,22,1,0,2,0,35,5.0,1,0.0,6,1,16,1,3,0,6,2,0,24,11,0
1396,58334,ROctVkWGGi4RH8QWmC2p1iWZZ8pihPaJ,SpATywNh6bZuzm8s1ceuBUnMUAeoAHHw,6,16,0,0,0,0,2,0,18,2.5714285714285716,1,0.0,0,0,0,0,16,0,0,2,0,0,18,0
1397,58336,LceCGRrY68iwKOq6ziCnmuJ3uxzNypKD,SpATywNh6bZuzm8s1ceuBUnMUAeoAHHw,12,13,4,0,3,0,7,2,29,4.142857142857143,1,0.0,2,4,0,3,11,0,0,7,2,9,20,1
1398,58341,MU4dVyJTD7iIRSTZIdJZ9VoLOxogfKQN,SpATywNh6bZuzm8s1ceuBUnMUAeoAHHw,18,18,10,24,4,0,3,0,59,8.428571428571429,3,0.0,5,10,24,4,13,0,0,3,0,43,16,0
1399,58348,n2LjMxx7cFpUJ3R3HfCHwCtJjfcc1KR0,G8EPVSXsOYB5YQWZGiz1aVq5Pgr2GrQu,5,3,2,0,1,0,1,0,7,1.0,1,0.0,0,2,0,1,3,0,0,1,0,3,4,0
1400,58356,O28nyHG0T9JeDH3GQl7amYJuULZ1QRpo,SpATywNh6bZuzm8s1ceuBUnMUAeoAHHw,12,16,2,14,0,0,4,0,36,5.142857142857143,2,0.0,7,2,12,0,9,0,2,4,0,21,15,1
1401,58385,ewcDv7X6I323ciCMJsU4n4MdvO632A9I,RXDvfPUBYFlVdlueBFbLW0mhhAyGEqpt,10,5,1,15,1,0,2,0,24,3.4285714285714284,1,0.0,1,1,15,1,4,0,0,2,0,18,6,1
1402,58409,TfXAnflKNnQz6DuwkJiGkjk0fNqIcdbb,RXDvfPUBYFlVdlueBFbLW0mhhAyGEqpt,5,0,0,0,0,0,5,1,6,0.8571428571428571,1,0.0,0,0,0,0,0,0,0,5,1,0,6,1
1403,58411,yvRYzlOzyvQRJ6DXF1Anm7UfajnELRZn,A3fsA9Zfv1X2fVEQhTw51lKENdNrEqT3,5,3,0,0,0,1,2,0,6,0.8571428571428571,1,0.0,0,0,0,0,3,1,0,2,0,0,6,1
1404,58414,TfXAnflKNnQz6DuwkJiGkjk0fNqIcdbb,G8EPVSXsOYB5YQWZGiz1aVq5Pgr2GrQu,5,1,0,0,1,0,3,0,5,0.7142857142857143,1,0.0,0,0,0,1,1,0,0,3,0,1,4,1
1405,58419,WuM67GwQW9M3d1mnuGHuvAdo907S9qb5,bWdj2GDclj5ofokWjzoa5jAwMkxCykd6,1,0,0,0,0,0,1,0,1,0.14285714285714285,1,0.0,0,0,0,0,0,0,0,1,0,0,1,1
1406,58428,tuO76fueBYFOMVa8D7FaN7k7B9sFUsap,SpATywNh6bZuzm8s1ceuBUnMUAeoAHHw,5,5,2,0,2,0,2,0,11,1.5714285714285714,1,0.0,0,2,0,2,5,0,0,2,0,4,7,1
1407,58430,Ymf9IGFQ8uCjyMPNR9dFL9vuwfZDvaPV,SpATywNh6bZuzm8s1ceuBUnMUAeoAHHw,6,6,0,0,0,22,3,0,31,4.428571428571429,2,0.0,0,0,0,0,6,22,0,3,0,0,31,0
1408,58458,fgzbUfrTxXYCuiFYTG1cTemcEJUl36an,SpATywNh6bZuzm8s1ceuBUnMUAeoAHHw,14,21,4,14,2,0,6,0,47,6.714285714285714,5,0.0,2,4,13,2,19,0,1,6,0,21,26,0
1409,58467,4ZEbiCstCbPqjH1vXT26zSCciOWvR8I5,G8EPVSXsOYB5YQWZGiz1aVq5Pgr2GrQu,5,2,1,0,1,0,2,0,6,0.8571428571428571,1,0.0,0,1,0,1,2,0,0,2,0,2,4,1
1410,58484,P84G9ZsyavajrfOKINVq0Jyux3TvjGmZ,G8EPVSXsOYB5YQWZGiz1aVq5Pgr2GrQu,7,6,5,12,2,0,2,0,27,3.857142857142857,1,0.0,0,5,10,2,6,0,2,2,0,17,10,1
1411,58509,HRP0Ut3HnZWoD62izV4kICPH3gchormt,SpATywNh6bZuzm8s1ceuBUnMUAeoAHHw,14,27,0,4,0,0,1,0,32,4.571428571428571,1,0.0,0,0,4,0,27,0,0,1,0,4,28,0
1412,58535,tdWhb9WfoB7e0A5Gjo7JvSpPeeCoQg77,SpATywNh6bZuzm8s1ceuBUnMUAeoAHHw,16,16,7,6,5,0,2,0,36,5.142857142857143,1,0.0,3,7,6,5,13,0,0,2,0,21,15,0
1413,58572,rFRGZ1wCWpRq5Le1v28DF6OVdqA54N4w,SpATywNh6bZuzm8s1ceuBUnMUAeoAHHw,6,2,0,0,0,0,4,0,6,0.8571428571428571,1,0.0,0,0,0,0,2,0,0,4,0,0,6,1
1414,58576,3mm3mJxVS0eLh8IUtBxaLL8aknBAQjDa,SpATywNh6bZuzm8s1ceuBUnMUAeoAHHw,6,5,0,0,0,0,2,0,7,1.0,1,0.0,0,0,0,0,5,0,0,2,0,0,7,1
1415,58580,likrBm8tgfB2kgdZuLI51EWK70wAYbOl,SpATywNh6bZuzm8s1ceuBUnMUAeoAHHw,4,2,1,0,0,0,2,0,5,0.7142857142857143,1,0.0,0,1,0,0,2,0,0,2,0,1,4,1
1416,58626,AsYvTZR1ylqWCh3nfRxgHS2CzZpeou5v,SpATywNh6bZuzm8s1ceuBUnMUAeoAHHw,1,0,0,0,0,0,4,0,4,0.5714285714285714,3,0.0,0,0,0,0,0,0,0,4,0,0,4,0
1417,58628,BvTWqNCI5Vv3DyY42Ht6x5bgcNEbXEjw,SpATywNh6bZuzm8s1ceuBUnMUAeoAHHw,16,10,7,10,4,0,1,0,32,4.571428571428571,2,0.0,2,7,9,4,8,0,1,1,0,22,10,1
1418,58639,GaLDEM0QPnCAP0wDlZ6pkRoEABK9VTLg,bWdj2GDclj5ofokWjzoa5jAwMkxCykd6,4,5,0,0,1,3,1,0,10,1.4285714285714286,1,0.0,2,0,0,1,3,3,0,1,0,3,7,1
1419,58656,OtgLotOlNqEcaPG4XzsiqBelLdYnlk9e,A3fsA9Zfv1X2fVEQhTw51lKENdNrEqT3,33,20,16,32,13,0,1,0,82,11.714285714285714,1,0.0,2,16,32,13,18,0,0,1,0,63,19,1
1420,58661,t8qBiDTvOvYmrxcVIErRuEOf38tywm6t,SpATywNh6bZuzm8s1ceuBUnMUAeoAHHw,19,19,14,12,9,17,8,2,81,11.571428571428571,3,0.0,2,14,9,9,17,17,3,8,2,34,47,0
1421,58690,y9A8XMlmfPaglBBuQFjiuxUOvb1WQu2v,A3fsA9Zfv1X2fVEQhTw51lKENdNrEqT3,12,11,6,0,5,0,8,0,30,4.285714285714286,2,0.0,0,6,0,5,11,0,0,8,0,11,19,1
1422,58716,wvyfPUc1aKmHhDODOwE0BnlNIGHCCfJd,G8EPVSXsOYB5YQWZGiz1aVq5Pgr2GrQu,5,3,1,0,1,0,2,0,7,1.0,1,0.0,0,1,0,1,3,0,0,2,0,2,5,1
1423,58724,QEq8GPuIzTapWcXcWLs8dzh5C4ugJ6qX,G8EPVSXsOYB5YQWZGiz1aVq5Pgr2GrQu,35,37,18,49,5,3,6,0,118,16.857142857142858,3,0.0,15,18,41,5,22,3,8,6,0,79,39,0
1424,58725,kQl6hEKF14dslDmIkyc1xBQGSSHXGS8M,bWdj2GDclj5ofokWjzoa5jAwMkxCykd6,4,0,0,0,0,0,4,1,5,0.7142857142857143,1,0.0,0,0,0,0,0,0,0,4,1,0,5,1
1425,58739,IUn6MADAjAYkGlJisA1WiDvCeNlJd5Xd,bWdj2GDclj5ofokWjzoa5jAwMkxCykd6,8,7,3,0,3,6,2,0,21,3.0,1,0.0,2,3,0,3,5,6,0,2,0,8,13,1
1426,58805,HaNTytYTKLUDOv5j8ZGLMuMeNQsJjViU,SpATywNh6bZuzm8s1ceuBUnMUAeoAHHw,8,8,5,0,4,0,5,0,22,3.142857142857143,2,0.0,1,5,0,4,7,0,0,5,0,10,12,1
1427,58831,f1TK7a3kaFF32JoXcfjlq2WtR27QUBak,SpATywNh6bZuzm8s1ceuBUnMUAeoAHHw,22,22,0,23,0,1,8,1,55,7.857142857142857,1,0.0,8,0,21,0,14,1,2,8,1,29,26,1
1428,58840,uuM5V1CEd7qVq722bOUrzRwoxB5HlAl5,SpATywNh6bZuzm8s1ceuBUnMUAeoAHHw,19,22,12,8,9,0,3,0,54,7.714285714285714,2,0.0,3,12,8,9,19,0,0,3,0,32,22,1
1429,58851,HcP22z9Adhad0eR6ILSXQ1kzpXBgJlCr,bWdj2GDclj5ofokWjzoa5jAwMkxCykd6,15,12,2,68,0,0,2,0,84,12.0,2,0.0,2,2,60,0,10,0,8,2,0,64,20,1
1430,58853,7wyfXvc1g99QNmXzEb4w8C1vE0Vi2bHm,A3fsA9Zfv1X2fVEQhTw51lKENdNrEqT3,4,2,1,0,1,0,1,0,5,0.7142857142857143,1,0.0,0,1,0,1,2,0,0,1,0,2,3,0
1431,58869,qUEvY9WI1m6Sm8flMRVsOdJpkuUerQfo,A3fsA9Zfv1X2fVEQhTw51lKENdNrEqT3,3,0,0,0,0,0,5,2,7,1.0,1,0.0,0,0,0,0,0,0,0,5,2,0,7,1
1432,58876,KynvXtYIsEUZo4QPbGVWVhUBwzeS3e9w,SpATywNh6bZuzm8s1ceuBUnMUAeoAHHw,11,6,4,0,3,0,2,0,15,2.142857142857143,1,0.0,0,4,0,3,6,0,0,2,0,7,8,1
1433,58909,BeY1QEJLx8hEoll66FHHZbsUvI2zt7s5,A3fsA9Zfv1X2fVEQhTw51lKENdNrEqT3,1,0,0,0,0,0,1,0,1,0.14285714285714285,1,0.0,0,0,0,0,0,0,0,1,0,0,1,1
1434,58914,DnweC9zfy9ur38RHmjIuaW6oqiFXCgkS,A3fsA9Zfv1X2fVEQhTw51lKENdNrEqT3,39,36,4,82,11,2,4,0,139,19.857142857142858,3,0.0,4,4,69,11,32,2,13,4,0,88,51,1
1435,58922,6HIBebNSnNEoSeekVShzxF3x0IcbgohT,SpATywNh6bZuzm8s1ceuBUnMUAeoAHHw,5,5,0,0,0,0,2,0,7,1.0,1,0.0,0,0,0,0,5,0,0,2,0,0,7,1
1436,58970,PvDd5wrDKH5IBJRRd1ycECXD88pHC4R8,SpATywNh6bZuzm8s1ceuBUnMUAeoAHHw,7,6,2,0,1,0,4,0,13,1.8571428571428572,1,0.0,0,2,0,1,6,0,0,4,0,3,10,1
1437,58996,w9HBKKfn4YUOWYdwRHKe80SIWiO37ZMJ,SpATywNh6bZuzm8s1ceuBUnMUAeoAHHw,8,14,6,14,0,0,6,0,40,5.714285714285714,3,0.0,4,6,13,0,10,0,1,6,0,23,17,0
1438,58997,1zErz13s8fNQRVaEvkOtvw6bLhr23yB4,bWdj2GDclj5ofokWjzoa5jAwMkxCykd6,11,8,7,64,0,0,1,0,80,11.428571428571429,1,0.0,0,7,62,0,8,0,2,1,0,69,11,0
1439,59002,yQ30DktO8KD929ApuNMOdNKTtmTpkfc3,G8EPVSXsOYB5YQWZGiz1aVq5Pgr2GrQu,3,0,0,0,0,4,2,0,6,0.8571428571428571,1,0.0,0,0,0,0,0,4,0,2,0,0,6,1
1440,59005,yQ30DktO8KD929ApuNMOdNKTtmTpkfc3,A3fsA9Zfv1X2fVEQhTw51lKENdNrEqT3,3,0,0,0,0,4,2,0,6,0.8571428571428571,1,0.0,0,0,0,0,0,4,0,2,0,0,6,1
1441,59014,D2lFXeOodglgSTRNVccRvVrNvHlYgfLJ,G8EPVSXsOYB5YQWZGiz1aVq5Pgr2GrQu,1,0,0,0,0,0,1,0,1,0.14285714285714285,1,0.0,0,0,0,0,0,0,0,1,0,0,1,1
1442,59018,Sz4iN9vM7plSJObu2Kgng7aJijtNNsts,A3fsA9Zfv1X2fVEQhTw51lKENdNrEqT3,7,12,0,0,0,0,9,0,21,3.0,2,0.0,0,0,0,0,12,0,0,9,0,0,21,1
1443,59056,HPaDTzk2xymxbpoa0VdcxdHl3uFfOfZk,A3fsA9Zfv1X2fVEQhTw51lKENdNrEqT3,11,15,11,0,0,1,21,0,48,6.857142857142857,3,0.0,0,11,0,0,15,1,0,21,0,11,37,1
1444,59064,gzTBwYPoQwnODJJ2vedsUKp2EoGao5Fz,A3fsA9Zfv1X2fVEQhTw51lKENdNrEqT3,2,0,0,0,0,0,2,0,2,0.2857142857142857,1,0.0,0,0,0,0,0,0,0,2,0,0,2,1
1445,59081,QscGDFmAAH7jp4ntcbRqVptjZvFSEe7R,SpATywNh6bZuzm8s1ceuBUnMUAeoAHHw,1,0,0,0,0,0,1,0,1,0.14285714285714285,1,0.0,0,0,0,0,0,0,0,1,0,0,1,1
1446,59085,FJb17GnhVysnDMr4UIVdFwaw18TJ0gzC,A3fsA9Zfv1X2fVEQhTw51lKENdNrEqT3,8,3,2,0,2,0,4,0,11,1.5714285714285714,1,0.0,0,2,0,2,3,0,0,4,0,4,7,1
1447,59087,QscGDFmAAH7jp4ntcbRqVptjZvFSEe7R,A3fsA9Zfv1X2fVEQhTw51lKENdNrEqT3,13,7,6,0,6,0,5,0,24,3.4285714285714284,1,0.0,0,6,0,6,7,0,0,5,0,12,12,1
1448,59099,NXeUyqTgIKYglW6oNMecGCOxIW2GzUKK,bWdj2GDclj5ofokWjzoa5jAwMkxCykd6,2,0,0,0,0,0,5,0,5,0.7142857142857143,1,0.0,0,0,0,0,0,0,0,5,0,0,5,1
1449,59100,Vn4kuqpkxWqlMyrGvyBY4A7iKQdYdIwO,SpATywNh6bZuzm8s1ceuBUnMUAeoAHHw,2,0,0,0,0,0,2,0,2,0.2857142857142857,1,0.0,0,0,0,0,0,0,0,2,0,0,2,1
1450,59102,Vn4kuqpkxWqlMyrGvyBY4A7iKQdYdIwO,A3fsA9Zfv1X2fVEQhTw51lKENdNrEqT3,5,2,1,0,1,0,2,0,6,0.8571428571428571,1,0.0,0,1,0,1,2,0,0,2,0,2,4,1
1451,59118,bEjkLIwm3iSyqTCwCLyh4lFO7vLzJeAj,SpATywNh6bZuzm8s1ceuBUnMUAeoAHHw,33,25,17,29,7,12,19,2,111,15.857142857142858,2,0.0,4,17,27,7,21,12,2,19,2,55,56,0
1452,59132,3LOMe6pmkiIt95Dd5LqCGi1tBreM2BMk,A3fsA9Zfv1X2fVEQhTw51lKENdNrEqT3,4,2,0,0,0,0,2,0,4,0.5714285714285714,1,0.0,0,0,0,0,2,0,0,2,0,0,4,0
1453,59136,3LOMe6pmkiIt95Dd5LqCGi1tBreM2BMk,bWdj2GDclj5ofokWjzoa5jAwMkxCykd6,1,0,0,0,0,0,1,0,1,0.14285714285714285,1,0.0,0,0,0,0,0,0,0,1,0,0,1,1
1454,59137,kqS8BwWN9R1093oeblGkvtCsQJ68Gh0G,bWdj2GDclj5ofokWjzoa5jAwMkxCykd6,6,6,5,0,1,0,2,0,14,2.0,1,0.0,0,5,0,1,6,0,0,2,0,6,8,1
1455,60048,BVLL3tf1KrYCKKfxj1p07nnbpn909YvK,7GRhBDsirIGkRZBtSMEzNTyDr2JQm4xx,1,0,0,0,0,0,1,0,1,0.14285714285714285,1,0.0,0,0,0,0,0,0,0,1,0,0,1,0
1456,60082,Yre3ZpWIJIVmlOfN5qpPiUgPhyFZbBYP,7GRhBDsirIGkRZBtSMEzNTyDr2JQm4xx,1,0,0,0,0,0,1,0,1,0.14285714285714285,1,0.0,0,0,0,0,0,0,0,1,0,0,1,1
1457,60085,n63tS6f6RbAUQIT0fHxjepUtvV0en8Ph,7GRhBDsirIGkRZBtSMEzNTyDr2JQm4xx,21,19,1,50,2,0,2,0,74,10.571428571428571,1,0.0,9,1,42,2,10,0,8,2,0,54,20,1
1458,60203,ntJs93C1h80peQsrk4sMYD3xVOjdEHeo,7GRhBDsirIGkRZBtSMEzNTyDr2JQm4xx,37,98,14,30,20,4,13,0,179,25.571428571428573,2,0.0,83,14,29,20,15,4,1,13,0,146,33,0
1459,60281,jzL5Nt58a8ZENNg776MwldmnOh4VPeJQ,7GRhBDsirIGkRZBtSMEzNTyDr2JQm4xx,2,0,0,0,0,0,2,0,2,0.2857142857142857,1,0.0,0,0,0,0,0,0,0,2,0,0,2,1
1460,60353,kf5ROCzcgJvsKj9HScT2CaHiyyffBGek,7GRhBDsirIGkRZBtSMEzNTyDr2JQm4xx,12,6,5,0,5,1,1,0,18,2.5714285714285716,1,0.0,0,5,0,5,6,1,0,1,0,10,8,0
1461,60413,i67qzouvUD7nINgK6d1xrH4pvufZqbFd,7GRhBDsirIGkRZBtSMEzNTyDr2JQm4xx,14,14,0,4,1,0,3,0,22,3.142857142857143,2,0.0,4,0,2,1,10,0,2,3,0,7,15,0
1462,60420,5hts9kMf50L6rxwk0MtgECu1e5TGRRGY,7GRhBDsirIGkRZBtSMEzNTyDr2JQm4xx,25,41,11,33,6,0,11,0,102,14.571428571428571,1,0.0,25,11,30,6,16,0,3,11,0,72,30,1
1463,60528,MvqSmpyUgimv8LaGxWMIruwa3ijANQg7,7GRhBDsirIGkRZBtSMEzNTyDr2JQm4xx,65,86,31,14,37,7,5,0,180,25.714285714285715,1,0.0,51,31,11,37,35,7,3,5,0,130,50,0
1464,60546,uQUPzFXltLm3Yz8qgEvw1fMPbbS4q4MZ,7GRhBDsirIGkRZBtSMEzNTyDr2JQm4xx,16,11,8,0,6,1,4,0,30,4.285714285714286,1,0.0,1,8,0,6,10,1,0,4,0,15,15,1
1465,60582,rxoO7csZGXeNzFVWfGDQB1CjrR87Fi1E,7GRhBDsirIGkRZBtSMEzNTyDr2JQm4xx,1,0,0,0,0,0,1,0,1,0.14285714285714285,1,0.0,0,0,0,0,0,0,0,1,0,0,1,1
1466,60704,yNvoGEAldEGg40wBXPaEulBPVW5wyRH0,7GRhBDsirIGkRZBtSMEzNTyDr2JQm4xx,22,49,9,34,1,0,15,0,108,15.428571428571429,2,0.0,16,9,24,1,33,0,10,15,0,50,58,1
1467,60718,Y7IgoRAqVJfNlsulCSI4HObujHPSzoLA,7GRhBDsirIGkRZBtSMEzNTyDr2JQm4xx,1,0,0,0,0,0,1,0,1,0.14285714285714285,1,0.0,0,0,0,0,0,0,0,1,0,0,1,1
1468,60723,QgvoRraMo579WBSQvu2KL1PVI0ztp4eg,7GRhBDsirIGkRZBtSMEzNTyDr2JQm4xx,23,52,16,0,19,1,2,0,90,12.857142857142858,2,0.0,12,16,0,19,40,1,0,2,0,47,43,0
1469,60741,D8UARtO8PEJDGRGb02jImyINnyDXbx45,7GRhBDsirIGkRZBtSMEzNTyDr2JQm4xx,2,0,0,0,0,0,2,0,2,0.2857142857142857,1,0.0,0,0,0,0,0,0,0,2,0,0,2,1
1470,60955,M3my6svOw1PavchA0YdMglvZWFkBWiG6,7GRhBDsirIGkRZBtSMEzNTyDr2JQm4xx,11,13,4,6,4,3,4,0,34,4.857142857142857,2,0.0,8,4,4,4,5,3,2,4,0,20,14,1
1471,60999,0mQOSUffcJjPsamqb6puS0gzn5BcFgYT,7GRhBDsirIGkRZBtSMEzNTyDr2JQm4xx,7,0,0,0,0,0,12,1,13,1.8571428571428572,2,0.0,0,0,0,0,0,0,0,12,1,0,13,1
1472,61017,fqE9fKOVWr7QYvXsbQOki5x99YlGSz4q,7GRhBDsirIGkRZBtSMEzNTyDr2JQm4xx,1,0,0,0,0,0,2,0,2,0.2857142857142857,1,0.0,0,0,0,0,0,0,0,2,0,0,2,1
1473,61032,2YrfQZgyUPdiZGXhplgKBSkvHochAfw6,7GRhBDsirIGkRZBtSMEzNTyDr2JQm4xx,7,6,4,0,0,0,2,0,12,1.7142857142857142,1,0.0,1,4,0,0,5,0,0,2,0,5,7,1
1474,61034,2Jljmu9EbGTkE1rTEOxUuOimOJr4EGWY,7GRhBDsirIGkRZBtSMEzNTyDr2JQm4xx,37,43,1,39,10,14,5,0,112,16.0,2,0.0,27,1,24,10,16,14,15,5,0,62,50,1
1475,61046,T06O7WnBCRWoH9e9v0RWmUTKobJEYFfL,7GRhBDsirIGkRZBtSMEzNTyDr2JQm4xx,1,0,0,0,0,0,1,0,1,0.14285714285714285,1,0.0,0,0,0,0,0,0,0,1,0,0,1,1
1476,61085,AG6iKV2oiQPN8wTOXQgZ5wPRMFQuNd0H,7GRhBDsirIGkRZBtSMEzNTyDr2JQm4xx,2,0,0,0,0,0,2,0,2,0.2857142857142857,1,0.0,0,0,0,0,0,0,0,2,0,0,2,1
1477,61116,9JKtUaJcAEBh7CYVmXIhRY2O1dODpq4M,7GRhBDsirIGkRZBtSMEzNTyDr2JQm4xx,14,20,7,0,5,0,1,0,33,4.714285714285714,1,0.0,2,7,0,5,18,0,0,1,0,14,19,1
1478,61118,pGlV0XYWRjXFSIdN56x9p6AvQyXwsZVS,7GRhBDsirIGkRZBtSMEzNTyDr2JQm4xx,30,38,22,70,4,18,4,0,156,22.285714285714285,2,0.0,10,22,58,4,28,18,12,4,0,94,62,0
1479,61157,ZgFCLkDPzcdiy0sIzPjvfQAgjdD1TUt9,7GRhBDsirIGkRZBtSMEzNTyDr2JQm4xx,37,88,34,33,33,0,9,0,197,28.142857142857142,2,0.0,42,34,20,33,46,0,13,9,0,129,68,0
1480,61191,3aCvKfVcHo3o7tH4s5PG9YBIGdvHDxQN,7GRhBDsirIGkRZBtSMEzNTyDr2JQm4xx,5,2,1,0,1,1,4,0,9,1.2857142857142858,1,0.0,0,1,0,1,2,1,0,4,0,2,7,1
1481,61231,KkdnagFJtwwq5n9Iuy7rnQaTqa2llFa9,7GRhBDsirIGkRZBtSMEzNTyDr2JQm4xx,1,0,0,0,0,0,1,0,1,0.14285714285714285,1,0.0,0,0,0,0,0,0,0,1,0,0,1,1
1482,61249,4BrxxQsWWJwGRocTSsfalu4whQ4Xfcpc,7GRhBDsirIGkRZBtSMEzNTyDr2JQm4xx,5,2,1,0,1,0,3,0,7,1.0,2,0.0,0,1,0,1,2,0,0,3,0,2,5,1
1483,61255,pZf9C3kBoPRYrDIubyGYbLZN4CZgU7xr,7GRhBDsirIGkRZBtSMEzNTyDr2JQm4xx,6,4,2,0,1,0,2,0,9,1.2857142857142858,1,0.0,2,2,0,1,2,0,0,2,0,5,4,1
1484,61260,cKCzrCCCXe9nkBgWepq9AEXje7SITRTz,7GRhBDsirIGkRZBtSMEzNTyDr2JQm4xx,1,0,0,0,0,0,1,0,1,0.14285714285714285,1,0.0,0,0,0,0,0,0,0,1,0,0,1,1
1485,61594,gAvRDaA2RH7LeyEqnpEQ7DzPuz3btZqk,SpATywNh6bZuzm8s1ceuBUnMUAeoAHHw,13,12,7,6,0,0,2,0,27,3.857142857142857,1,0.0,4,7,6,0,8,0,0,2,0,17,10,0
1486,61595,3rZRyyAqQR0LHT7iXSTyhR4wZI7IzOpN,SpATywNh6bZuzm8s1ceuBUnMUAeoAHHw,2,0,0,0,0,0,4,0,4,0.5714285714285714,1,0.0,0,0,0,0,0,0,0,4,0,0,4,0
1487,61601,gLjUrp9o3bBy4JIhHE7DImScxZdU76o3,bWdj2GDclj5ofokWjzoa5jAwMkxCykd6,19,13,9,72,3,0,0,0,97,13.857142857142858,2,0.0,2,9,64,3,11,0,8,0,0,78,19,0
1488,61613,gF4BAuOIIfmyUL9KgVWqdIaoDpcXFfvU,SpATywNh6bZuzm8s1ceuBUnMUAeoAHHw,7,8,3,0,1,0,2,0,14,2.0,1,0.0,0,3,0,1,8,0,0,2,0,4,10,1
1489,61798,C912XMR2YQ2SiCcqNj7moioYbFr61u4G,SpATywNh6bZuzm8s1ceuBUnMUAeoAHHw,29,45,25,26,9,20,7,0,132,18.857142857142858,2,0.0,9,25,20,9,36,20,6,7,0,63,69,0
1490,61873,GjYrFH6x4o6vyLHEw4EuuSJvAfuLPk1y,SpATywNh6bZuzm8s1ceuBUnMUAeoAHHw,4,7,4,0,0,0,2,0,13,1.8571428571428572,2,0.0,0,4,0,0,7,0,0,2,0,4,9,0
1491,61902,q2vdNmhZGOp0NF57Oy2lI01Qgjw4Vdei,SpATywNh6bZuzm8s1ceuBUnMUAeoAHHw,5,7,4,0,2,0,2,0,15,2.142857142857143,2,0.0,1,4,0,2,6,0,0,2,0,7,8,1
1492,61904,zt8D4cN45BQ8WOokF7iya4FQJ1n05JY2,SpATywNh6bZuzm8s1ceuBUnMUAeoAHHw,7,8,6,0,0,0,2,0,16,2.2857142857142856,1,0.0,0,6,0,0,8,0,0,2,0,6,10,0
1493,61940,gaDguOzhGUiRAlt47AbgfmnftuQ8EhI2,SpATywNh6bZuzm8s1ceuBUnMUAeoAHHw,27,49,20,39,8,44,10,1,171,24.428571428571427,1,0.0,15,20,33,8,34,44,6,10,1,76,95,1
1494,62025,PDbQl9kvVSEqhb3jM3LOTLEyGnuh6urj,SpATywNh6bZuzm8s1ceuBUnMUAeoAHHw,21,32,19,3,9,0,10,0,73,10.428571428571429,2,0.0,3,19,3,9,29,0,0,10,0,34,39,0
1495,62027,NcracMTfiaTPMbO6SSDnt9CDc4SnvBs9,bWdj2GDclj5ofokWjzoa5jAwMkxCykd6,18,11,6,12,3,0,5,0,37,5.285714285714286,1,0.0,3,6,12,3,8,0,0,5,0,24,13,0
1496,62128,R2cga9JVVM2tXEVs2saYswslfxAU4nMk,A3fsA9Zfv1X2fVEQhTw51lKENdNrEqT3,9,11,8,2,1,0,5,0,27,3.857142857142857,6,0.0,1,8,2,1,10,0,0,5,0,12,15,1
1497,62213,QbN1rcT6X70kGcCCu9qHO2zQXGCyhPMc,SpATywNh6bZuzm8s1ceuBUnMUAeoAHHw,3,2,1,0,0,0,2,0,5,0.7142857142857143,1,0.0,0,1,0,0,2,0,0,2,0,1,4,1
1498,62254,X4KSPkBIdPEeXdEy4Fa5NvixCQZdfNj3,SpATywNh6bZuzm8s1ceuBUnMUAeoAHHw,23,19,11,24,4,5,3,0,66,9.428571428571429,2,0.0,5,11,19,4,14,5,5,3,0,39,27,1
1499,62312,l4QykzFcC41mVGOdUpTYCbuYnqmkZCXe,SpATywNh6bZuzm8s1ceuBUnMUAeoAHHw,18,35,1,36,0,0,1,0,73,10.428571428571429,1,0.0,21,1,33,0,14,0,3,1,0,55,18,0
1500,62335,o4bCCaWBA9uHbyXIM2IOJcgIkEya6ZFa,SpATywNh6bZuzm8s1ceuBUnMUAeoAHHw,4,2,0,0,0,0,3,0,5,0.7142857142857143,1,0.0,0,0,0,0,2,0,0,3,0,0,5,0
1501,62349,YBtKAFQt6fk6EIukc4Ut5J2kdzYxomaP,SpATywNh6bZuzm8s1ceuBUnMUAeoAHHw,18,38,25,15,17,0,11,0,106,15.142857142857142,2,0.0,6,25,12,17,32,0,3,11,0,60,46,1
1502,62356,wjS8ie6ACTxewSCQo7zpBy0tu4z4RYPD,SpATywNh6bZuzm8s1ceuBUnMUAeoAHHw,13,13,0,12,0,0,10,0,35,5.0,4,0.0,2,0,10,0,11,0,2,10,0,12,23,0
1503,62360,g1maG24WsPdpEOMuZUsxQc7SlEYHJjT4,bWdj2GDclj5ofokWjzoa5jAwMkxCykd6,3,2,1,0,0,0,1,0,4,0.5714285714285714,1,0.0,0,1,0,0,2,0,0,1,0,1,3,0
1504,62381,m2GM5nfba5AfGmEJzump9yjCc3h5OBqL,SpATywNh6bZuzm8s1ceuBUnMUAeoAHHw,4,3,1,0,1,0,1,0,6,0.8571428571428571,1,0.0,0,1,0,1,3,0,0,1,0,2,4,1
1505,62428,Y5CSlxjOPHMFV7ik3pSpx6t0PJdYKnrH,SpATywNh6bZuzm8s1ceuBUnMUAeoAHHw,1,0,0,0,0,0,2,0,2,0.2857142857142857,2,0.0,0,0,0,0,0,0,0,2,0,0,2,0
1506,62437,vhnbHBui7nCh3pAshTJ2BoFD1CEurx5q,SpATywNh6bZuzm8s1ceuBUnMUAeoAHHw,15,20,5,6,2,0,5,0,38,5.428571428571429,5,0.0,0,5,5,2,20,0,1,5,0,12,26,0
1507,62443,ogzXep3azQvjQ2uIPIxw4TZLNiUXYlgD,A3fsA9Zfv1X2fVEQhTw51lKENdNrEqT3,9,15,11,0,2,0,3,0,31,4.428571428571429,2,0.0,0,11,0,2,15,0,0,3,0,13,18,0
1508,62457,k3z8wjqNUcBUtJc11ZY5CI3syE6W1pg9,SpATywNh6bZuzm8s1ceuBUnMUAeoAHHw,8,3,2,0,2,0,4,0,11,1.5714285714285714,1,0.0,0,2,0,2,3,0,0,4,0,4,7,0
1509,62458,j8vYdYwa9gvt7hkF8dykZR2D4h75QsII,SpATywNh6bZuzm8s1ceuBUnMUAeoAHHw,1,0,0,0,0,0,1,0,1,0.14285714285714285,1,0.0,0,0,0,0,0,0,0,1,0,0,1,1
1510,62490,GWSq56qmQUucFgSgP2raEZeoKP7Athee,SpATywNh6bZuzm8s1ceuBUnMUAeoAHHw,11,9,0,13,0,1,4,0,27,3.857142857142857,1,0.0,2,0,13,0,7,1,0,4,0,15,12,0
1511,62514,ggEr2STKTwtSSUdtGCmiPr3DBu3TJ34B,A3fsA9Zfv1X2fVEQhTw51lKENdNrEqT3,5,3,0,2,0,0,1,0,6,0.8571428571428571,1,0.0,0,0,2,0,3,0,0,1,0,2,4,1
1512,62576,ogmMRCX7tMP9zl6WROraIuGWloPIZQ3P,SpATywNh6bZuzm8s1ceuBUnMUAeoAHHw,31,42,25,17,12,27,11,3,137,19.571428571428573,3,0.0,13,25,16,12,29,27,1,11,3,66,71,1
1513,62593,fBjkk55LEjUXpgvkPNjyZGCtR2am4TcN,SpATywNh6bZuzm8s1ceuBUnMUAeoAHHw,4,4,3,0,0,0,2,0,9,1.2857142857142858,1,0.0,0,3,0,0,4,0,0,2,0,3,6,0
1514,62695,N0Sos51WanCzoSGKDmMPzQtMlLxY3bFb,A3fsA9Zfv1X2fVEQhTw51lKENdNrEqT3,34,20,12,90,6,9,12,0,149,21.285714285714285,4,0.0,1,12,71,6,19,9,19,12,0,90,59,0
1515,62751,RjUWkdPtbuKazr3SZ8iaujuOx2ne7ey1,7GRhBDsirIGkRZBtSMEzNTyDr2JQm4xx,15,22,9,6,14,7,1,0,59,8.428571428571429,1,0.0,9,9,6,14,13,7,0,1,0,38,21,0
1516,62780,7lWGgkVC73zkYVnYZAzOXyCIO3N3M6br,SpATywNh6bZuzm8s1ceuBUnMUAeoAHHw,16,21,8,6,4,0,5,0,44,6.285714285714286,3,0.0,5,8,6,4,16,0,0,5,0,23,21,0
1517,62810,jkLf5s9Tdb22fUhtxgRjd7TDlKmc2OGK,A3fsA9Zfv1X2fVEQhTw51lKENdNrEqT3,7,3,2,0,2,0,2,0,9,1.2857142857142858,2,0.0,0,2,0,2,3,0,0,2,0,4,5,1
1518,62834,TfNQptQajWTQqzlzDAn72SRQxELYzNd4,SpATywNh6bZuzm8s1ceuBUnMUAeoAHHw,4,3,0,0,0,0,3,0,6,0.8571428571428571,2,0.0,0,0,0,0,3,0,0,3,0,0,6,0
1519,62835,Wx4OW1b1MfVESAexiltid2V2dN7xsH1D,SpATywNh6bZuzm8s1ceuBUnMUAeoAHHw,5,17,1,0,0,2,1,0,21,3.0,2,0.0,1,1,0,0,16,2,0,1,0,2,19,0
1520,62936,l6huwkyakLvA9G4ixwxpAcJxBdbbcmJP,SpATywNh6bZuzm8s1ceuBUnMUAeoAHHw,3,4,2,0,0,0,2,0,8,1.1428571428571428,2,0.0,0,2,0,0,4,0,0,2,0,2,6,0
1521,62938,eLqag6twmL6nT6SLVrpY07QGG3bytKwe,SpATywNh6bZuzm8s1ceuBUnMUAeoAHHw,3,2,0,0,0,0,1,0,3,0.42857142857142855,1,0.0,0,0,0,0,2,0,0,1,0,0,3,0
1522,62970,RS564zscXajJOiW9woDtEu4M9LDaNEPd,7GRhBDsirIGkRZBtSMEzNTyDr2JQm4xx,9,8,4,0,3,0,1,0,16,2.2857142857142856,1,0.0,0,4,0,3,8,0,0,1,0,7,9,1
1523,63008,MjjHVlUuOHpErRpbxsSv5C4Ujl4db690,bWdj2GDclj5ofokWjzoa5jAwMkxCykd6,24,16,0,126,0,7,1,0,150,21.428571428571427,1,0.0,4,0,119,0,12,7,7,1,0,123,27,1
1524,63072,TvDWPoJyTprTu0vxto5NxLIJOfQBmxVE,7GRhBDsirIGkRZBtSMEzNTyDr2JQm4xx,1,1,0,0,0,0,0,0,1,0.14285714285714285,1,0.0,0,0,0,0,1,0,0,0,0,0,1,0
1525,63187,CTfjOlWW4k8IhTEXOJYJ7bo74K8z07kZ,A3fsA9Zfv1X2fVEQhTw51lKENdNrEqT3,2,0,0,0,0,0,3,0,3,0.42857142857142855,1,0.0,0,0,0,0,0,0,0,3,0,0,3,0
1526,63271,DHenWrxVzReZszxo1qw3Im0Zj99tiAII,A3fsA9Zfv1X2fVEQhTw51lKENdNrEqT3,8,11,6,0,3,10,3,0,33,4.714285714285714,1,0.0,0,6,0,3,11,10,0,3,0,9,24,0
1527,63322,Q7wqVDqz10tk4xe6QnkzI1dJqMLzdK4Z,7GRhBDsirIGkRZBtSMEzNTyDr2JQm4xx,18,52,14,8,6,1,11,0,92,13.142857142857142,5,0.0,34,14,5,6,18,1,3,11,0,59,33,0
1528,63461,4TtGjmtd4ISORDD5okRgx7kXAcGUW8IN,7GRhBDsirIGkRZBtSMEzNTyDr2JQm4xx,64,102,39,110,30,27,29,0,337,48.142857142857146,4,0.0,57,39,92,30,45,27,18,29,0,218,119,0
1529,63576,7MQqMUzAoBFEcqTatVu5Epa9H5xTJ6XT,A3fsA9Zfv1X2fVEQhTw51lKENdNrEqT3,97,49,36,164,23,3,15,1,291,41.57142857142857,5,0.0,4,36,147,23,45,3,17,15,1,210,81,0
1530,63687,dtbXtMjPqeEvzoZBFe2y9uSDcjL0lnx2,A3fsA9Zfv1X2fVEQhTw51lKENdNrEqT3,51,40,2,139,0,12,12,0,205,29.285714285714285,4,0.0,7,2,114,0,33,12,25,12,0,123,82,0
1531,64152,e6qJWnBH5Aakpza4HlA3Q0irc2hEFZ0M,7GRhBDsirIGkRZBtSMEzNTyDr2JQm4xx,9,9,1,0,1,0,3,0,14,2.0,1,0.0,0,1,0,1,9,0,0,3,0,2,12,1
1532,65669,YXA6PyHIufuhVR6DkHMJ9uQ5pDJwufmy,7GRhBDsirIGkRZBtSMEzNTyDr2JQm4xx,4,3,0,0,0,0,2,0,5,0.7142857142857143,1,0.0,0,0,0,0,3,0,0,2,0,0,5,1
1533,65718,aPDsc8X2fcDutxzM0D9vmuKFKeVLb7iC,7GRhBDsirIGkRZBtSMEzNTyDr2JQm4xx,8,11,4,0,2,1,1,0,19,2.7142857142857144,1,0.0,5,4,0,2,6,1,0,1,0,11,8,1
1534,65754,d7lqWAJ8cu1e9f8Lb1eNhG3YSdhF0Qy7,7GRhBDsirIGkRZBtSMEzNTyDr2JQm4xx,3,0,0,0,0,0,4,0,4,0.5714285714285714,1,0.0,0,0,0,0,0,0,0,4,0,0,4,1
1535,65760,Eq2fj8YhTifRHDOTFGHgDmpANxyMLkTX,7GRhBDsirIGkRZBtSMEzNTyDr2JQm4xx,2,0,0,0,0,0,2,0,2,0.2857142857142857,1,0.0,0,0,0,0,0,0,0,2,0,0,2,1
1536,65803,frLOkZRmi3O7wD4LykXjaoVn2dsJFYHr,7GRhBDsirIGkRZBtSMEzNTyDr2JQm4xx,2,0,0,0,0,0,2,0,2,0.2857142857142857,1,0.0,0,0,0,0,0,0,0,2,0,0,2,1
1537,65811,eGQZZVxmcbNonF0wFWctXG5fJptHLiDM,7GRhBDsirIGkRZBtSMEzNTyDr2JQm4xx,13,6,4,0,3,0,7,2,22,3.142857142857143,1,0.0,0,4,0,3,6,0,0,7,2,7,15,0
1538,65862,FWTjpNOuI4RsBkDu0yW01kwOX7KPfCTS,7GRhBDsirIGkRZBtSMEzNTyDr2JQm4xx,1,0,0,0,0,0,1,0,1,0.14285714285714285,1,0.0,0,0,0,0,0,0,0,1,0,0,1,1
1539,65872,dr13KuqOo10EJH5V4oOgMy17ewEUhD7o,7GRhBDsirIGkRZBtSMEzNTyDr2JQm4xx,1,0,0,0,0,0,1,0,1,0.14285714285714285,1,0.0,0,0,0,0,0,0,0,1,0,0,1,1
1540,65947,qREvGviufJ3VVxNkA2MjB1npr7InnyIq,7GRhBDsirIGkRZBtSMEzNTyDr2JQm4xx,1,0,0,0,0,0,1,0,1,0.14285714285714285,1,0.0,0,0,0,0,0,0,0,1,0,0,1,1
1541,65951,OiCP77rDGj7m0OeIgoy8NyAC1iklb2Wq,7GRhBDsirIGkRZBtSMEzNTyDr2JQm4xx,1,0,0,0,0,0,1,0,1,0.14285714285714285,1,0.0,0,0,0,0,0,0,0,1,0,0,1,1
1542,66573,ES3MJj3KCIAnVbhhUwdNjoq2AG6ouBZT,SpATywNh6bZuzm8s1ceuBUnMUAeoAHHw,3,2,1,0,0,0,1,0,4,0.5714285714285714,1,0.0,0,1,0,0,2,0,0,1,0,1,3,1
1543,66584,ZRcEnEYSSBQbkjzMu7sidjbxasfrmw8l,RXDvfPUBYFlVdlueBFbLW0mhhAyGEqpt,8,19,9,0,0,0,4,0,32,4.571428571428571,2,0.0,1,9,0,0,18,0,0,4,0,10,22,1
1544,66646,qZhmmNUvkNXdf3u04DTUQOFEBxxO10p4,G8EPVSXsOYB5YQWZGiz1aVq5Pgr2GrQu,24,37,7,30,6,0,4,0,84,12.0,2,0.0,10,7,27,6,27,0,3,4,0,50,34,1
1545,66711,VS8f8oTxWcbwLqrK393hBZWMoBFa1gFJ,SpATywNh6bZuzm8s1ceuBUnMUAeoAHHw,8,8,5,0,2,0,2,0,17,2.4285714285714284,2,0.0,0,5,0,2,8,0,0,2,0,7,10,0
1546,66713,LMGbvXS3ZBgtTcKCRLMcqBHrfADBxwXe,G8EPVSXsOYB5YQWZGiz1aVq5Pgr2GrQu,84,87,5,136,3,40,18,0,289,41.285714285714285,5,0.0,42,5,94,3,45,40,42,18,0,144,145,0
1547,66745,qt9pojYUdSU9dxSioMDEso1f0UH6has1,SpATywNh6bZuzm8s1ceuBUnMUAeoAHHw,5,6,3,6,0,0,3,0,18,2.5714285714285716,1,0.0,1,3,5,0,5,0,1,3,0,9,9,1
1548,66789,5ZyvCd3AP7a8azCiLN5JfLAP53iZpAyD,SpATywNh6bZuzm8s1ceuBUnMUAeoAHHw,2,0,0,0,0,0,2,0,2,0.2857142857142857,2,0.0,0,0,0,0,0,0,0,2,0,0,2,0
1549,66820,MvNnLQma2eBM9bCcMIR159XYSNp8VREs,bWdj2GDclj5ofokWjzoa5jAwMkxCykd6,35,28,16,162,6,22,5,0,239,34.142857142857146,2,0.0,6,16,135,6,22,22,27,5,0,163,76,1
1550,66893,HBNOGDmQrCA8ZCNHwMOm4mGR9448iscJ,SpATywNh6bZuzm8s1ceuBUnMUAeoAHHw,6,3,2,0,1,0,2,0,8,1.1428571428571428,1,0.0,0,2,0,1,3,0,0,2,0,3,5,0
1551,66922,wEaTyOJwwvOCk7eUttQISK5WPXL7ANNV,RXDvfPUBYFlVdlueBFbLW0mhhAyGEqpt,8,28,6,0,2,0,2,0,38,5.428571428571429,4,0.0,4,6,0,2,24,0,0,2,0,12,26,0
1552,66928,UnlpBoCCKa1g59dweQPJmefdPMpfSVLe,G8EPVSXsOYB5YQWZGiz1aVq5Pgr2GrQu,16,15,4,18,2,0,0,0,39,5.571428571428571,2,0.0,9,4,9,2,6,0,9,0,0,24,15,1
1553,66938,mLUKkahZJn2S9K7hZVXpun7HflxZlNfK,RXDvfPUBYFlVdlueBFbLW0mhhAyGEqpt,5,3,1,0,1,0,1,0,6,0.8571428571428571,1,0.0,0,1,0,1,3,0,0,1,0,2,4,1
1554,66967,TZMHSuVEUzvE9F9oFUPDubVVCOh0OUwA,SpATywNh6bZuzm8s1ceuBUnMUAeoAHHw,3,2,1,0,0,0,2,0,5,0.7142857142857143,1,0.0,0,1,0,0,2,0,0,2,0,1,4,1
1555,67062,lsez2NExtDzqmHTj1WxlkldAKydbGpGz,SpATywNh6bZuzm8s1ceuBUnMUAeoAHHw,3,4,1,0,0,0,2,0,7,1.0,1,0.0,0,1,0,0,4,0,0,2,0,1,6,0
1556,67113,3WF0lrMOUTt8kHZhSzrGOICZhAfsfzhb,SpATywNh6bZuzm8s1ceuBUnMUAeoAHHw,18,18,11,15,6,4,6,0,60,8.571428571428571,2,0.0,4,11,15,6,14,4,0,6,0,36,24,0
1557,67179,5Zxu05K7VSTA0XR5o51TQgeWQSwtutqu,SpATywNh6bZuzm8s1ceuBUnMUAeoAHHw,8,24,11,0,5,0,5,0,45,6.428571428571429,3,0.0,0,11,0,5,24,0,0,5,0,16,29,1
1558,67197,OvFsbGXgDD3DXdRTUFBoMvrSVsi4VT3x,SpATywNh6bZuzm8s1ceuBUnMUAeoAHHw,4,2,1,0,0,2,2,0,7,1.0,1,0.0,0,1,0,0,2,2,0,2,0,1,6,0
1559,67242,vy0D7u7Ahtj15h3nmn3LQzZAhD31JIs2,G8EPVSXsOYB5YQWZGiz1aVq5Pgr2GrQu,21,29,13,22,5,2,7,1,79,11.285714285714286,1,0.0,12,13,14,5,17,2,8,7,1,44,35,1
1560,67315,gc2449Ag0boGNd6nrwcfyjhFar24UaYH,RXDvfPUBYFlVdlueBFbLW0mhhAyGEqpt,13,10,8,0,5,0,0,0,23,3.2857142857142856,1,0.0,0,8,0,5,10,0,0,0,0,13,10,1
1561,67356,T6lJMwNIVHZiShXC2FiLzuiG8wkuUByo,SpATywNh6bZuzm8s1ceuBUnMUAeoAHHw,1,0,0,0,0,0,2,0,2,0.2857142857142857,1,0.0,0,0,0,0,0,0,0,2,0,0,2,1
1562,67390,aQ6WrdDe9pTNwVW3vmaMOs1pxy5r3Dxa,RXDvfPUBYFlVdlueBFbLW0mhhAyGEqpt,3,2,1,0,0,0,1,0,4,0.5714285714285714,1,0.0,0,1,0,0,2,0,0,1,0,1,3,1
1563,67407,s42YRljOqExiv71QhA2soTLfn9kHZdPI,G8EPVSXsOYB5YQWZGiz1aVq5Pgr2GrQu,3,2,1,0,0,0,1,0,4,0.5714285714285714,1,0.0,0,1,0,0,2,0,0,1,0,1,3,1
1564,67426,VFYk1GyeJyGqK1t09cLe0E5m7KsULmvc,G8EPVSXsOYB5YQWZGiz1aVq5Pgr2GrQu,7,9,5,0,2,4,3,0,23,3.2857142857142856,3,0.0,0,5,0,2,9,4,0,3,0,7,16,1
1565,67432,FdsEBC0mHy1vT6x3hjK3QpB4Q1Uhf4Gh,SpATywNh6bZuzm8s1ceuBUnMUAeoAHHw,9,8,0,0,0,0,3,0,11,1.5714285714285714,1,0.0,0,0,0,0,8,0,0,3,0,0,11,0
1566,67471,a6W98SSI7NFdfjtHnUJXqYQ7M2ljRDYt,SpATywNh6bZuzm8s1ceuBUnMUAeoAHHw,5,12,4,0,0,0,3,0,19,2.7142857142857144,2,0.0,5,4,0,0,7,0,0,3,0,9,10,0
1567,67544,gSzwbDlzeyvDrdHnrWsBTEKJeSjOW5Jb,RXDvfPUBYFlVdlueBFbLW0mhhAyGEqpt,6,6,1,0,1,0,3,0,11,1.5714285714285714,1,0.0,3,1,0,1,3,0,0,3,0,5,6,1
1568,67609,VaOhD86uWnK2TjloSi50DgiXbw9C3K0T,SpATywNh6bZuzm8s1ceuBUnMUAeoAHHw,6,7,3,0,1,0,4,0,15,2.142857142857143,1,0.0,0,3,0,1,7,0,0,4,0,4,11,1
1569,67623,Sqd3Eviij3ahMVLlwINw4LiDCg7rwrfy,RXDvfPUBYFlVdlueBFbLW0mhhAyGEqpt,4,3,1,0,0,0,3,1,8,1.1428571428571428,1,0.0,0,1,0,0,3,0,0,3,1,1,7,1
1570,67642,BwXR7IzUtCAN8pzY1XJl6dbItwnWn8P1,SpATywNh6bZuzm8s1ceuBUnMUAeoAHHw,5,8,6,0,0,0,4,0,18,2.5714285714285716,2,0.0,0,6,0,0,8,0,0,4,0,6,12,0
1571,67705,3cEo76QwJwldypMfZu21btn9IT8f6eL0,SpATywNh6bZuzm8s1ceuBUnMUAeoAHHw,4,7,0,0,0,0,2,0,9,1.2857142857142858,1,0.0,2,0,0,0,5,0,0,2,0,2,7,1
1572,67805,3g0CiljEiblxCvXeNEcFARnThDq8TtPt,SpATywNh6bZuzm8s1ceuBUnMUAeoAHHw,7,4,3,0,2,0,2,0,11,1.5714285714285714,1,0.0,0,3,0,2,4,0,0,2,0,5,6,0
1573,67852,3Aezv8lgcVyIW4Uwgi3KMiL4RZSkwke5,SpATywNh6bZuzm8s1ceuBUnMUAeoAHHw,1,0,0,0,0,0,1,0,1,0.14285714285714285,1,0.0,0,0,0,0,0,0,0,1,0,0,1,1
1574,67879,bRwq2z1Yz5KS0MW4CkmNDI34p59fmbas,RXDvfPUBYFlVdlueBFbLW0mhhAyGEqpt,3,2,0,0,0,0,1,0,3,0.42857142857142855,1,0.0,0,0,0,0,2,0,0,1,0,0,3,1
1575,67918,pzHaWUcmzb5LgLjIjpaBYBq7daMNFpyk,SpATywNh6bZuzm8s1ceuBUnMUAeoAHHw,7,5,1,0,0,0,3,0,9,1.2857142857142858,1,0.0,0,1,0,0,5,0,0,3,0,1,8,1
1576,67930,x6K6gEN1bi7EtUHqEXEFGztPxJcTq3NW,SpATywNh6bZuzm8s1ceuBUnMUAeoAHHw,20,15,9,18,5,0,2,0,49,7.0,1,0.0,2,9,15,5,13,0,3,2,0,31,18,1
1577,68014,eSHpbUzZvfLR4whtzGnR3u58hC1o1DTb,SpATywNh6bZuzm8s1ceuBUnMUAeoAHHw,16,24,7,17,5,0,1,0,54,7.714285714285714,1,0.0,16,7,14,5,8,0,3,1,0,42,12,1
1578,68043,mHfTvd1CfaCURBT44fgL7AymprwCoavs,SpATywNh6bZuzm8s1ceuBUnMUAeoAHHw,4,2,1,0,0,0,2,0,5,0.7142857142857143,1,0.0,0,1,0,0,2,0,0,2,0,1,4,1
1579,68059,V87r8ov3AJYZnaKsWbASGu8Ya7b0fguH,SpATywNh6bZuzm8s1ceuBUnMUAeoAHHw,1,0,0,0,0,0,1,0,1,0.14285714285714285,1,0.0,0,0,0,0,0,0,0,1,0,0,1,1
1580,68070,1VCQvdBqSLamldHF1ZwYh2NF4ESIqek2,bWdj2GDclj5ofokWjzoa5jAwMkxCykd6,13,5,2,46,2,1,8,0,64,9.142857142857142,2,0.0,2,2,41,2,3,1,5,8,0,47,17,1
1581,68080,PwGj8ON4yrWpMaoZE0ES8sG2eAqFQNfN,bWdj2GDclj5ofokWjzoa5jAwMkxCykd6,11,6,5,0,4,0,1,0,16,2.2857142857142856,1,0.0,0,5,0,4,6,0,0,1,0,9,7,1
1582,68117,MDJGW12z1ZhMFT2gTIbEYAqP2tu7pkDh,SpATywNh6bZuzm8s1ceuBUnMUAeoAHHw,4,4,2,0,0,0,6,0,12,1.7142857142857142,3,0.0,0,2,0,0,4,0,0,6,0,2,10,0
1583,68122,q1MlrkW0KNfJjOXajII1Q1GZBULc6aNj,SpATywNh6bZuzm8s1ceuBUnMUAeoAHHw,12,15,1,17,1,0,3,0,37,5.285714285714286,1,0.0,2,1,15,1,13,0,2,3,0,19,18,1
1584,68170,bpxaFadaQixJuWRVtAAq5miKiBM3zC6u,bWdj2GDclj5ofokWjzoa5jAwMkxCykd6,10,28,0,0,0,0,8,0,36,5.142857142857143,3,0.0,6,0,0,0,22,0,0,8,0,6,30,1
1585,68177,y6oK2aw09rZ1km46IcOJlYdWLv4Nbbgi,G8EPVSXsOYB5YQWZGiz1aVq5Pgr2GrQu,10,6,5,0,4,0,7,1,23,3.2857142857142856,2,0.0,0,5,0,4,6,0,0,7,1,9,14,1
1586,68219,PLTytqL5kLJdDGm9MvAFVaFDS2S7nPDO,SpATywNh6bZuzm8s1ceuBUnMUAeoAHHw,1,0,0,0,0,0,2,0,2,0.2857142857142857,2,0.0,0,0,0,0,0,0,0,2,0,0,2,1
1587,68301,NRKadp4j4jPDuLDbaa9Nm62h1VN187qT,SpATywNh6bZuzm8s1ceuBUnMUAeoAHHw,16,26,10,18,5,0,1,0,60,8.571428571428571,1,0.0,14,10,15,5,12,0,3,1,0,44,16,1
1588,68629,M2AmcvqhvMtUlyRV6vMvvoM2IhrMmAwT,bWdj2GDclj5ofokWjzoa5jAwMkxCykd6,5,3,2,0,1,0,1,0,7,1.0,1,0.0,0,2,0,1,3,0,0,1,0,3,4,1
1589,68657,kouVFmC9KYKK6YQi2WuQuIKCuxGX5ljt,RXDvfPUBYFlVdlueBFbLW0mhhAyGEqpt,6,3,1,0,1,0,2,0,7,1.0,1,0.0,0,1,0,1,3,0,0,2,0,2,5,0
1590,68676,OvG0QIZOPiV3oa4UqFgxzNEprO7pKVmV,SpATywNh6bZuzm8s1ceuBUnMUAeoAHHw,4,6,3,0,0,2,5,0,16,2.2857142857142856,2,0.0,0,3,0,0,6,2,0,5,0,3,13,0
1591,68704,5MOHfgPntZIsRWkQebauzpUgUSaHvhFJ,SpATywNh6bZuzm8s1ceuBUnMUAeoAHHw,5,4,3,0,0,0,1,0,8,1.1428571428571428,1,0.0,0,3,0,0,4,0,0,1,0,3,5,0
1592,68739,kNijCkWRNCwIOtL9mKx9mB8Vau6ujWr3,SpATywNh6bZuzm8s1ceuBUnMUAeoAHHw,2,0,0,0,0,2,1,0,3,0.42857142857142855,1,0.0,0,0,0,0,0,2,0,1,0,0,3,1
1593,68804,3o4QanEzrLxU7IR8E0SkDLt6uwLmz5BV,G8EPVSXsOYB5YQWZGiz1aVq5Pgr2GrQu,8,6,2,6,1,0,4,0,19,2.7142857142857144,1,0.0,2,2,4,1,4,0,2,4,0,9,10,1
1594,68839,ci6w9FxXwoWvsu2Aw9ojvjfPhjaGgaxN,SpATywNh6bZuzm8s1ceuBUnMUAeoAHHw,1,0,0,0,0,0,1,0,1,0.14285714285714285,1,0.0,0,0,0,0,0,0,0,1,0,0,1,1
1595,68867,mJAgtJKHxy28GsPIeuAEUCIOXmHzCywF,A3fsA9Zfv1X2fVEQhTw51lKENdNrEqT3,3,2,1,0,0,0,2,0,5,0.7142857142857143,1,0.0,0,1,0,0,2,0,0,2,0,1,4,0
1596,68889,jagu0OJDhWTGFhfCMk0ghqluLpW3kzdC,A3fsA9Zfv1X2fVEQhTw51lKENdNrEqT3,18,8,8,0,7,0,2,0,25,3.5714285714285716,2,0.0,0,8,0,7,8,0,0,2,0,15,10,1
1597,68894,SG7N8DhpCuhIu06IIzLX0CSolbyIDsIx,SpATywNh6bZuzm8s1ceuBUnMUAeoAHHw,5,6,3,0,0,1,7,0,17,2.4285714285714284,4,0.0,0,3,0,0,6,1,0,7,0,3,14,1
1598,68986,c7CZsOAhREk5r7i8Wn5QXe6C7ebs3xYP,A3fsA9Zfv1X2fVEQhTw51lKENdNrEqT3,7,7,4,0,2,2,4,0,19,2.7142857142857144,1,0.0,0,4,0,2,7,2,0,4,0,6,13,1
1599,69014,souC6CA0wrFXemJ5RC2IcVOFZKY3Ud6D,A3fsA9Zfv1X2fVEQhTw51lKENdNrEqT3,28,12,3,88,3,7,12,0,125,17.857142857142858,3,0.0,1,3,76,3,11,7,12,12,0,83,42,0
1600,69115,Vd6ebRuiLfwgqB5waj4eS9hJ1uyBDxCf,A3fsA9Zfv1X2fVEQhTw51lKENdNrEqT3,11,8,1,0,1,0,12,1,23,3.2857142857142856,2,0.0,0,1,0,1,8,0,0,12,1,2,21,1
1601,69131,8Ir6rIjO15kuvM3s5xrQH1rB1m97Mcy9,SpATywNh6bZuzm8s1ceuBUnMUAeoAHHw,3,2,0,0,0,0,1,0,3,0.42857142857142855,1,0.0,0,0,0,0,2,0,0,1,0,0,3,0
1602,69147,cRQPwEYCK3Iw8dKAOD2ODiUgaKZ6yPed,SpATywNh6bZuzm8s1ceuBUnMUAeoAHHw,4,2,0,0,0,0,2,0,4,0.5714285714285714,1,0.0,0,0,0,0,2,0,0,2,0,0,4,1
1603,69161,3X0JLX6UvJnnRb5GkwbFJgAokE5g69D0,SpATywNh6bZuzm8s1ceuBUnMUAeoAHHw,6,7,1,0,1,0,1,0,10,1.4285714285714286,2,0.0,0,1,0,1,7,0,0,1,0,2,8,0
1604,69192,agX8fi6SsMsbGjpTUuXM1FgToYG9zbAn,SpATywNh6bZuzm8s1ceuBUnMUAeoAHHw,1,0,0,0,0,0,1,0,1,0.14285714285714285,1,0.0,0,0,0,0,0,0,0,1,0,0,1,0
1605,69200,udnRYxurswpE4GUZcnc80kafg0hn3fpz,A3fsA9Zfv1X2fVEQhTw51lKENdNrEqT3,4,4,2,0,0,0,1,0,7,1.0,1,0.0,0,2,0,0,4,0,0,1,0,2,5,0
1606,69297,X9IKf8GgqS6dvoKX3VBo51mIr8yb4uFC,bWdj2GDclj5ofokWjzoa5jAwMkxCykd6,19,32,12,13,6,0,5,0,68,9.714285714285714,1,0.0,7,12,12,6,25,0,1,5,0,37,31,1
1607,69308,YtPY6V9gKVYBGYaBakDnRKgXM0SCPhH8,RXDvfPUBYFlVdlueBFbLW0mhhAyGEqpt,4,4,2,0,0,0,6,0,12,1.7142857142857142,3,0.0,0,2,0,0,4,0,0,6,0,2,10,0
1608,69324,byxGWUJV72XqYw0RcV5v8EuZ9oh6gief,G8EPVSXsOYB5YQWZGiz1aVq5Pgr2GrQu,3,2,1,0,0,0,1,0,4,0.5714285714285714,1,0.0,0,1,0,0,2,0,0,1,0,1,3,1
1609,69397,egpXv13dykaiU64GCgTaQGg1ErRD7Rsb,SpATywNh6bZuzm8s1ceuBUnMUAeoAHHw,9,5,5,6,4,0,0,0,20,2.857142857142857,1,0.0,0,5,5,4,5,0,1,0,0,14,6,0
1610,69445,raxo74HBCa6UxUGfmq3EGBBeCoVCmLfg,SpATywNh6bZuzm8s1ceuBUnMUAeoAHHw,11,15,1,17,0,5,3,0,41,5.857142857142857,1,0.0,6,1,15,0,9,5,2,3,0,22,19,1
1611,69462,SzqR1lIvSkqy1yQXOqGRgT5uhu7VR5Jw,SpATywNh6bZuzm8s1ceuBUnMUAeoAHHw,20,19,14,0,8,0,6,0,47,6.714285714285714,3,0.0,0,14,0,8,19,0,0,6,0,22,25,0
1612,69489,pAlH2DhoFB2i4Ut8T7hcWTIp67bJvsYn,SpATywNh6bZuzm8s1ceuBUnMUAeoAHHw,1,0,0,0,0,0,1,0,1,0.14285714285714285,1,0.0,0,0,0,0,0,0,0,1,0,0,1,1
1613,69522,ujYI83byKXzx4VeC0hyxjCKBGRrqMCEx,SpATywNh6bZuzm8s1ceuBUnMUAeoAHHw,1,0,1,0,0,0,0,0,1,0.14285714285714285,1,0.0,0,1,0,0,0,0,0,0,0,1,0,1
1614,69575,HnVGC3qJM46V1b2wdd4Z0HoEFuWu57RL,A3fsA9Zfv1X2fVEQhTw51lKENdNrEqT3,6,5,1,0,0,0,1,0,7,1.0,1,0.0,0,1,0,0,5,0,0,1,0,1,6,1
1615,69598,KYXtOFYh9POr4cq75pjZ8a127l5uxf5U,SpATywNh6bZuzm8s1ceuBUnMUAeoAHHw,10,9,5,0,4,0,1,0,19,2.7142857142857144,1,0.0,0,5,0,4,9,0,0,1,0,9,10,1
1616,69612,kgME9COu6f9ljQ8FhJeUQLVyeGDbkeLG,A3fsA9Zfv1X2fVEQhTw51lKENdNrEqT3,6,11,1,0,0,0,9,1,22,3.142857142857143,3,0.0,0,1,0,0,11,0,0,9,1,1,21,0
1617,69642,V5AS4ngknDMHs5ddf49SxlAoYguZsiN3,A3fsA9Zfv1X2fVEQhTw51lKENdNrEqT3,31,16,9,50,5,2,5,0,87,12.428571428571429,1,0.0,1,9,46,5,15,2,4,5,0,61,26,0
1618,69880,wJ6pUrPXT2xprnVlaCeorPmn4kCAli3G,A3fsA9Zfv1X2fVEQhTw51lKENdNrEqT3,12,14,10,2,5,46,2,0,79,11.285714285714286,2,0.0,1,10,1,5,13,46,1,2,0,17,62,1
1619,69906,qowpjfcpUK1iU9rrtJ9U3WvarOVtt4V0,SpATywNh6bZuzm8s1ceuBUnMUAeoAHHw,5,4,1,0,1,2,1,0,9,1.2857142857142858,1,0.0,0,1,0,1,4,2,0,1,0,2,7,0
1620,69972,6AqVXM3NzhPR7CIRltoRCDhzdk8YVusO,SpATywNh6bZuzm8s1ceuBUnMUAeoAHHw,7,14,9,0,0,0,6,0,29,4.142857142857143,2,0.0,1,9,0,0,13,0,0,6,0,10,19,0
1621,69984,979PHlsnLj7fGUBEOVls6yVfgExSRWl0,SpATywNh6bZuzm8s1ceuBUnMUAeoAHHw,25,19,15,9,8,12,10,0,73,10.428571428571429,2,0.0,0,15,7,8,19,12,2,10,0,30,43,0
1622,70130,r9R01U9QisCDxxLmorZFQ60ReGG1wPEx,SpATywNh6bZuzm8s1ceuBUnMUAeoAHHw,6,2,1,0,0,0,4,0,7,1.0,1,0.0,0,1,0,0,2,0,0,4,0,1,6,1
1623,70141,j4hecXKY3USBQpRwMuzKA9d9SPzBKhRY,SpATywNh6bZuzm8s1ceuBUnMUAeoAHHw,6,2,1,0,0,1,5,1,10,1.4285714285714286,1,0.0,0,1,0,0,2,1,0,5,1,1,9,1
1624,70362,zp9CVU4G1wbuvD6zHeghytszv1OWHRbH,fbPkOYLVPtPgIt0MxizjfFJov3JbHyAi,5,2,1,0,1,0,5,0,9,1.2857142857142858,1,0.0,0,1,0,1,2,0,0,5,0,2,7,1
1625,70364,d11XQPw4CaDnMkkvSEo4JqU6avErSb1R,fbPkOYLVPtPgIt0MxizjfFJov3JbHyAi,9,13,2,7,4,0,5,1,32,4.571428571428571,1,0.0,10,2,6,4,3,0,1,5,1,22,10,1
1626,70366,PpnPvK9DbTHdgRWHJHXOlINRXSc8Npmg,fbPkOYLVPtPgIt0MxizjfFJov3JbHyAi,7,3,2,0,2,0,4,0,11,1.5714285714285714,1,0.0,0,2,0,2,3,0,0,4,0,4,7,1
1627,70367,mJZNVvZltlGUOWmItS7lca1ZZKMYLgfv,fbPkOYLVPtPgIt0MxizjfFJov3JbHyAi,4,2,1,0,1,0,1,0,5,0.7142857142857143,1,0.0,0,1,0,1,2,0,0,1,0,2,3,1
1628,70369,QCF16jxhtQhmTizksY0agEWgfjSL0OQi,fbPkOYLVPtPgIt0MxizjfFJov3JbHyAi,6,1,1,0,1,0,3,0,6,0.8571428571428571,1,0.0,0,1,0,1,1,0,0,3,0,2,4,1
1629,70370,aM5KMfNvJMZXpckhWVfcYsB4JIRgyTpb,fbPkOYLVPtPgIt0MxizjfFJov3JbHyAi,3,0,0,0,0,0,5,0,5,0.7142857142857143,1,0.0,0,0,0,0,0,0,0,5,0,0,5,1
1630,70374,i7IcrBPDb6j5yESxBfBh5UcQNbAuMnQu,fbPkOYLVPtPgIt0MxizjfFJov3JbHyAi,1,0,0,0,0,0,1,0,1,0.14285714285714285,1,0.0,0,0,0,0,0,0,0,1,0,0,1,1
1631,70380,kI6ffxnrSLteZt1Y2KV2Lxy8Xwr4FbXB,fbPkOYLVPtPgIt0MxizjfFJov3JbHyAi,18,16,7,6,10,0,2,0,41,5.857142857142857,1,0.0,6,7,6,10,10,0,0,2,0,29,12,1
1632,70382,elPwHt777Sck2SbnBg6Zjs34W93VBNVZ,fbPkOYLVPtPgIt0MxizjfFJov3JbHyAi,8,6,4,0,3,0,4,0,17,2.4285714285714284,1,0.0,0,4,0,3,6,0,0,4,0,7,10,1
1633,70383,Op31ey1e8ia2T8lQ6kca7MllnthYRRtp,fbPkOYLVPtPgIt0MxizjfFJov3JbHyAi,9,11,6,0,4,0,5,0,26,3.7142857142857144,2,0.0,2,6,0,4,9,0,0,5,0,12,14,1
1634,70386,SP7hg1EWo2mZkHuxZFtI4Vbcyr5vcP4h,fbPkOYLVPtPgIt0MxizjfFJov3JbHyAi,16,26,6,11,8,2,17,1,71,10.142857142857142,2,0.0,11,6,10,8,15,2,1,17,1,35,36,1
1635,70387,gTEZJ29F2arwuZ50nMHedjyXqssA1HaK,fbPkOYLVPtPgIt0MxizjfFJov3JbHyAi,8,6,3,0,4,0,1,0,14,2.0,1,0.0,2,3,0,4,4,0,0,1,0,9,5,1
1636,70402,b8GqJ93lAZFVpg9Mwv9wl7tS2AylqN7M,fbPkOYLVPtPgIt0MxizjfFJov3JbHyAi,7,7,4,0,2,0,4,0,17,2.4285714285714284,1,0.0,0,4,0,2,7,0,0,4,0,6,11,1
1637,70403,n0BoTjy9bHkXIWArHniej1rGvdJMGwHf,fbPkOYLVPtPgIt0MxizjfFJov3JbHyAi,8,5,2,0,2,6,4,1,20,2.857142857142857,1,0.0,0,2,0,2,5,6,0,4,1,4,16,1
1638,70405,0mn9lI6rmOQgtsjwJJCZKT5aBtKrZOEC,fbPkOYLVPtPgIt0MxizjfFJov3JbHyAi,1,0,0,0,0,0,1,0,1,0.14285714285714285,1,0.0,0,0,0,0,0,0,0,1,0,0,1,1
1639,70408,rPtP72DMEyNlpUomeqVVqrg44j30SIpW,fbPkOYLVPtPgIt0MxizjfFJov3JbHyAi,9,10,7,0,1,0,4,2,24,3.4285714285714284,1,0.0,0,7,0,1,10,0,0,4,2,8,16,1
1640,70411,84PbfOPlGI9IjAK4ghphRdENNw1iTjGO,fbPkOYLVPtPgIt0MxizjfFJov3JbHyAi,1,0,0,0,0,0,1,0,1,0.14285714285714285,1,0.0,0,0,0,0,0,0,0,1,0,0,1,1
1641,70413,kMAOJzCNXdlJhsuMcIBGlBO8JULKbUln,fbPkOYLVPtPgIt0MxizjfFJov3JbHyAi,9,12,7,0,4,0,6,0,29,4.142857142857143,2,0.0,0,7,0,4,12,0,0,6,0,11,18,1
1642,70415,dRkGRhgEz0P6Cj2gSWKZ3jwm6LAB5sTl,fbPkOYLVPtPgIt0MxizjfFJov3JbHyAi,1,0,0,0,0,0,1,0,1,0.14285714285714285,1,0.0,0,0,0,0,0,0,0,1,0,0,1,1
1643,70416,TkGkraxFZeISMMLd87fcbklBTVTLGOhm,fbPkOYLVPtPgIt0MxizjfFJov3JbHyAi,32,36,21,18,10,1,4,0,90,12.857142857142858,2,0.0,10,21,18,10,26,1,0,4,0,59,31,1
1644,70417,U3vRWJ9ZlxOl62be4tXpqiQTVZSIgIE3,fbPkOYLVPtPgIt0MxizjfFJov3JbHyAi,1,0,0,0,0,0,1,0,1,0.14285714285714285,1,0.0,0,0,0,0,0,0,0,1,0,0,1,1
1645,70418,TgD7HTL6BBYi1V76wOsbmKwneDk5GeY1,fbPkOYLVPtPgIt0MxizjfFJov3JbHyAi,11,9,4,0,3,0,3,0,19,2.7142857142857144,1,0.0,4,4,0,3,5,0,0,3,0,11,8,1
1646,70420,nb4zZ4thsaPUV3M4XPmI0s66LlJvQ5KS,fbPkOYLVPtPgIt0MxizjfFJov3JbHyAi,12,7,5,0,3,0,5,0,20,2.857142857142857,1,0.0,0,5,0,3,7,0,0,5,0,8,12,1
1647,70421,JRVFRZlL9O1Hg2XIIgM1SU6gF5ZFwBDs,fbPkOYLVPtPgIt0MxizjfFJov3JbHyAi,1,0,0,0,0,0,1,0,1,0.14285714285714285,1,0.0,0,0,0,0,0,0,0,1,0,0,1,1
1648,70422,BaBxjEn3TWZ4ftqH98jukKacUK8Z3SVk,fbPkOYLVPtPgIt0MxizjfFJov3JbHyAi,5,2,1,0,1,0,2,0,6,0.8571428571428571,1,0.0,0,1,0,1,2,0,0,2,0,2,4,1
1649,70425,Cko24A4msOu0ocJWLZJpsB3dmU1FdwtS,fbPkOYLVPtPgIt0MxizjfFJov3JbHyAi,1,0,0,0,0,0,1,0,1,0.14285714285714285,1,0.0,0,0,0,0,0,0,0,1,0,0,1,1
1650,70426,y2pJnc0KPSLQND52yd5rcX8VRJR3QNZU,fbPkOYLVPtPgIt0MxizjfFJov3JbHyAi,5,2,1,0,1,2,2,0,8,1.1428571428571428,1,0.0,0,1,0,1,2,2,0,2,0,2,6,1
1651,70430,wEobeJ4f0gBmMcwQxjxFZn1OCeOPZzYY,fbPkOYLVPtPgIt0MxizjfFJov3JbHyAi,9,4,3,0,3,1,5,1,17,2.4285714285714284,1,0.0,0,3,0,3,4,1,0,5,1,6,11,1
1652,70432,TINvhk9VLXQ3D49XU1y8baDw0NlbVtwm,fbPkOYLVPtPgIt0MxizjfFJov3JbHyAi,1,0,0,0,0,0,1,0,1,0.14285714285714285,1,0.0,0,0,0,0,0,0,0,1,0,0,1,1
1653,70440,s8W8cdIMLI0wttTxhl9oTzo8KNby6TlB,fbPkOYLVPtPgIt0MxizjfFJov3JbHyAi,5,2,1,0,1,0,2,0,6,0.8571428571428571,1,0.0,0,1,0,1,2,0,0,2,0,2,4,1
1654,70442,wMrBLf0Bj3KcyXZhbv1Gc8JYaCbLqMxI,fbPkOYLVPtPgIt0MxizjfFJov3JbHyAi,1,0,0,0,0,0,1,0,1,0.14285714285714285,1,0.0,0,0,0,0,0,0,0,1,0,0,1,1
1655,70443,KU2ZvHkEQEb3JAaLolzvBVJ54ROyNU4O,fbPkOYLVPtPgIt0MxizjfFJov3JbHyAi,8,3,2,0,2,1,3,0,11,1.5714285714285714,1,0.0,0,2,0,2,3,1,0,3,0,4,7,1
1656,70444,9DnTA9cJdXk1sLNPfwadV56caZuYgPFA,fbPkOYLVPtPgIt0MxizjfFJov3JbHyAi,7,6,4,0,4,0,2,0,16,2.2857142857142856,1,0.0,1,4,0,4,5,0,0,2,0,9,7,1
1657,70447,e1JkrjLmoNWMhYF8oakgy1uiYBC2tSp7,fbPkOYLVPtPgIt0MxizjfFJov3JbHyAi,7,7,3,0,2,3,3,0,18,2.5714285714285716,1,0.0,0,3,0,2,7,3,0,3,0,5,13,1
1658,70448,Tnqp8RxwOeUuCC7Qp8CqF6vKQxL9Cimc,fbPkOYLVPtPgIt0MxizjfFJov3JbHyAi,7,7,1,0,1,0,8,0,17,2.4285714285714284,1,0.0,0,1,0,1,7,0,0,8,0,2,15,1
1659,70450,B9Ey1tIo6ANxVa0IvzoinvUWj4cenbLl,fbPkOYLVPtPgIt0MxizjfFJov3JbHyAi,30,69,1,29,4,0,2,0,105,15.0,2,0.0,24,1,24,4,45,0,5,2,0,53,52,1
1660,70451,5n43m0O6jMd9u06uLjQWfLgplW2Mj8WG,fbPkOYLVPtPgIt0MxizjfFJov3JbHyAi,7,3,2,0,2,0,3,0,10,1.4285714285714286,2,0.0,0,2,0,2,3,0,0,3,0,4,6,1
1661,70453,j5jJTM3hFoonQXLPD4VBAk3sLP9YQf22,fbPkOYLVPtPgIt0MxizjfFJov3JbHyAi,6,1,1,0,1,0,5,0,8,1.1428571428571428,1,0.0,0,1,0,1,1,0,0,5,0,2,6,1
1662,70454,6GqrPcO4oJU2rSJnj2GMOg35aldNMAg2,fbPkOYLVPtPgIt0MxizjfFJov3JbHyAi,1,0,0,0,0,0,1,0,1,0.14285714285714285,1,0.0,0,0,0,0,0,0,0,1,0,0,1,1
1663,70460,uIBAKDJwWewmJzOoAu8wXcXt7IZWFCLk,fbPkOYLVPtPgIt0MxizjfFJov3JbHyAi,4,0,0,0,0,0,4,0,4,0.5714285714285714,1,0.0,0,0,0,0,0,0,0,4,0,0,4,1
1664,70464,5pNBiCcrjVf8w8PgJKHP647T7U9arPze,fbPkOYLVPtPgIt0MxizjfFJov3JbHyAi,2,0,0,0,0,0,2,0,2,0.2857142857142857,1,0.0,0,0,0,0,0,0,0,2,0,0,2,1
1665,70465,5CrBlR6zrkauTaeaZtpYKwSZbYlbmRp4,fbPkOYLVPtPgIt0MxizjfFJov3JbHyAi,7,3,2,0,2,0,2,0,9,1.2857142857142858,1,0.0,0,2,0,2,3,0,0,2,0,4,5,1
1666,70466,peaGEeAVqM29YYBxjRmiLTEtcrDX5FwI,fbPkOYLVPtPgIt0MxizjfFJov3JbHyAi,1,0,0,0,0,0,1,0,1,0.14285714285714285,1,0.0,0,0,0,0,0,0,0,1,0,0,1,1
1667,70467,AF2WqhAeg8UXHquisOTxLVKHXh1OOPd5,fbPkOYLVPtPgIt0MxizjfFJov3JbHyAi,11,4,2,6,2,3,6,1,24,3.4285714285714284,1,0.0,1,2,5,2,3,3,1,6,1,10,14,1
1668,70468,ETCPUMqyU09gcKrtaCRQ42i068JLqy26,fbPkOYLVPtPgIt0MxizjfFJov3JbHyAi,13,7,4,7,5,4,7,1,35,5.0,1,0.0,2,4,5,5,5,4,2,7,1,16,19,1
1669,70475,r5QBoGyTGzPPNMXpOkVWAVSD4WtheLjK,fbPkOYLVPtPgIt0MxizjfFJov3JbHyAi,1,0,0,0,0,0,1,0,1,0.14285714285714285,1,0.0,0,0,0,0,0,0,0,1,0,0,1,1
1670,70479,IeJFnRP45F5IqEsCwWOVkYId1qIootxH,fbPkOYLVPtPgIt0MxizjfFJov3JbHyAi,8,5,3,0,3,0,2,0,13,1.8571428571428572,2,0.0,0,3,0,3,5,0,0,2,0,6,7,1
1671,70480,ZnZUpsAwhsKxOeo88uKWqXms7Hr6vGQ0,fbPkOYLVPtPgIt0MxizjfFJov3JbHyAi,1,0,0,0,0,0,1,0,1,0.14285714285714285,1,0.0,0,0,0,0,0,0,0,1,0,0,1,1
1672,70483,F8PplJ0MdSBFJMkvQSa7z6RMAQvcxOkt,fbPkOYLVPtPgIt0MxizjfFJov3JbHyAi,13,24,0,8,0,3,5,0,40,5.714285714285714,2,0.0,3,0,7,0,21,3,1,5,0,10,30,0
1673,70489,1KY2xQE7nTlowha0qhSxoa3VZ8IEtTuU,fbPkOYLVPtPgIt0MxizjfFJov3JbHyAi,4,2,1,0,1,0,1,0,5,0.7142857142857143,1,0.0,0,1,0,1,2,0,0,1,0,2,3,1
1674,70491,o72e1M3GwrvLzNPjTViCBNsXT3sIbItE,fbPkOYLVPtPgIt0MxizjfFJov3JbHyAi,8,5,2,0,2,0,4,0,13,1.8571428571428572,1,0.0,0,2,0,2,5,0,0,4,0,4,9,1
1675,70493,PQN68zvQWtqLWovgQi2j4ZPXjsSbybWb,fbPkOYLVPtPgIt0MxizjfFJov3JbHyAi,1,0,0,0,0,0,1,0,1,0.14285714285714285,1,0.0,0,0,0,0,0,0,0,1,0,0,1,1
1676,70494,lgip049r6Eu24ga2SPdixKHu4ShoVkOP,fbPkOYLVPtPgIt0MxizjfFJov3JbHyAi,1,0,0,0,0,0,1,0,1,0.14285714285714285,1,0.0,0,0,0,0,0,0,0,1,0,0,1,1
1677,70497,vGQJgu8tmA9kQpG8GdauGWSuqyqtNE3M,fbPkOYLVPtPgIt0MxizjfFJov3JbHyAi,1,0,0,0,0,0,1,0,1,0.14285714285714285,1,0.0,0,0,0,0,0,0,0,1,0,0,1,1
1678,70498,LK1fNSP3UpGaGwYkuo0BQyI3g1s3ODJ4,fbPkOYLVPtPgIt0MxizjfFJov3JbHyAi,7,3,2,0,2,0,4,0,11,1.5714285714285714,1,0.0,0,2,0,2,3,0,0,4,0,4,7,1
1679,70499,R0fqJCKSDdlape9O3QiJvxhX8OJnijdc,fbPkOYLVPtPgIt0MxizjfFJov3JbHyAi,14,23,12,19,10,3,6,0,73,10.428571428571429,2,0.0,9,12,13,10,14,3,6,6,0,44,29,1
1680,70500,wuj7kbmCy3JkqjSYqFBD6rEwetA5ny2r,fbPkOYLVPtPgIt0MxizjfFJov3JbHyAi,8,3,2,0,2,2,6,0,15,2.142857142857143,1,0.0,0,2,0,2,3,2,0,6,0,4,11,1
1681,70505,0uebMpTrpNYgDgvdKb7MmNThyYHd0W5n,fbPkOYLVPtPgIt0MxizjfFJov3JbHyAi,8,6,3,0,2,1,6,0,18,2.5714285714285716,1,0.0,0,3,0,2,6,1,0,6,0,5,13,1
1682,70507,edTxzupkEcnjoBMEEWcWCMVwXX7Jf82i,fbPkOYLVPtPgIt0MxizjfFJov3JbHyAi,9,8,3,2,2,0,2,0,17,2.4285714285714284,1,0.0,1,3,2,2,7,0,0,2,0,8,9,1
1683,70508,gJS3lYqFTHr060G9WKP0FBIIOt76kylk,fbPkOYLVPtPgIt0MxizjfFJov3JbHyAi,7,5,2,0,2,0,2,0,11,1.5714285714285714,1,0.0,0,2,0,2,5,0,0,2,0,4,7,1
1684,70683,hkJbQtfl1ac72y2vr8c3dGSqgpUqSDf1,fbPkOYLVPtPgIt0MxizjfFJov3JbHyAi,1,0,0,0,0,0,1,0,1,0.14285714285714285,1,0.0,0,0,0,0,0,0,0,1,0,0,1,1
1685,70684,Cd9ft0A4qlmf8URzSzFBOzoArPR6PTDL,fbPkOYLVPtPgIt0MxizjfFJov3JbHyAi,44,62,24,67,23,16,8,1,201,28.714285714285715,3,0.0,33,24,59,23,29,16,8,8,1,139,62,1
1686,70686,NUUrfkmQ6PTn8vYLlenz4k9BmiPCmi7I,fbPkOYLVPtPgIt0MxizjfFJov3JbHyAi,5,3,2,0,1,0,1,0,7,1.0,1,0.0,0,2,0,1,3,0,0,1,0,3,4,0
1687,70689,WFLWEfQrQsuFMQB4h1DfinKxHOxaJgRw,fbPkOYLVPtPgIt0MxizjfFJov3JbHyAi,9,9,5,0,2,5,3,0,24,3.4285714285714284,1,0.0,0,5,0,2,9,5,0,3,0,7,17,1
1688,70692,6qrT2bYbFD0verDQZWOnrOjhEccqo56g,fbPkOYLVPtPgIt0MxizjfFJov3JbHyAi,19,49,18,13,8,26,12,0,126,18.0,6,0.0,24,18,12,8,25,26,1,12,0,62,64,0
1689,70694,a0K0pCjTVYvmpJhsgniZUHaxogtZRZu6,fbPkOYLVPtPgIt0MxizjfFJov3JbHyAi,1,0,0,0,0,0,1,0,1,0.14285714285714285,1,0.0,0,0,0,0,0,0,0,1,0,0,1,1
1690,70696,Pt9EMdXHAJoREYsz9PnQvEKtrmRTWsTp,fbPkOYLVPtPgIt0MxizjfFJov3JbHyAi,2,0,0,0,0,0,2,0,2,0.2857142857142857,1,0.0,0,0,0,0,0,0,0,2,0,0,2,1
1691,70698,FN0V2FJ9PwsmZe2ZdtFoTzNeftwa8lew,fbPkOYLVPtPgIt0MxizjfFJov3JbHyAi,4,2,1,0,1,0,1,0,5,0.7142857142857143,1,0.0,0,1,0,1,2,0,0,1,0,2,3,1
1692,70707,KIkxhCvZoGl3wo3zfjbQsMpSQMiIEEXM,fbPkOYLVPtPgIt0MxizjfFJov3JbHyAi,6,7,4,0,2,0,5,0,18,2.5714285714285716,1,0.0,0,4,0,2,7,0,0,5,0,6,12,1
1693,70714,NPIHq6nnRF0fUledjFKG5ROeHLCshlez,fbPkOYLVPtPgIt0MxizjfFJov3JbHyAi,13,12,8,0,6,0,9,0,35,5.0,2,0.0,0,8,0,6,12,0,0,9,0,14,21,1
1694,70716,7aQ84DnQTSRkdmQzmLpA6ZuenMv0j2zy,fbPkOYLVPtPgIt0MxizjfFJov3JbHyAi,1,0,0,0,0,0,1,0,1,0.14285714285714285,1,0.0,0,0,0,0,0,0,0,1,0,0,1,1
1695,70718,Zh4ywqGGZpnusw56NY7i4goj5JrNtqvq,fbPkOYLVPtPgIt0MxizjfFJov3JbHyAi,13,9,5,0,6,0,2,0,22,3.142857142857143,1,0.0,3,5,0,6,6,0,0,2,0,14,8,1
1696,70719,mCG9v0HfdST0gIHQ17sgmmDB5sK4zRUH,fbPkOYLVPtPgIt0MxizjfFJov3JbHyAi,4,2,0,0,0,0,4,0,6,0.8571428571428571,1,0.0,0,0,0,0,2,0,0,4,0,0,6,1
1697,70720,1sdBeDtu3vvbkIr8j4KgcWPZ5NNqSuy1,fbPkOYLVPtPgIt0MxizjfFJov3JbHyAi,2,0,0,0,0,0,2,0,2,0.2857142857142857,1,0.0,0,0,0,0,0,0,0,2,0,0,2,1
1698,70724,Tp7YlU9FicEPdF8OYctnhCNGsZgZyAsQ,fbPkOYLVPtPgIt0MxizjfFJov3JbHyAi,1,0,0,0,0,0,1,0,1,0.14285714285714285,1,0.0,0,0,0,0,0,0,0,1,0,0,1,1
1699,70725,GKYvnmyIP1jWi6afQrMmOmjTFVpSxJct,fbPkOYLVPtPgIt0MxizjfFJov3JbHyAi,11,8,6,0,6,3,19,1,43,6.142857142857143,1,0.0,2,6,0,6,6,3,0,19,1,14,29,1
1700,70726,yz3oOBelfOSc6Zj3ARcY1Ttj6774hRYk,fbPkOYLVPtPgIt0MxizjfFJov3JbHyAi,13,15,8,0,5,3,10,1,42,6.0,2,0.0,0,8,0,5,15,3,0,10,1,13,29,1
1701,70731,baDb9SDqFGaUm6SQ1U1wIZZwVOEGfEyo,fbPkOYLVPtPgIt0MxizjfFJov3JbHyAi,5,2,1,0,1,0,4,0,8,1.1428571428571428,1,0.0,0,1,0,1,2,0,0,4,0,2,6,1
1702,70733,ZmL8VQqDEMaFfRIwjy7tQi9WkUzCCBLM,fbPkOYLVPtPgIt0MxizjfFJov3JbHyAi,10,9,6,0,2,0,9,2,28,4.0,1,0.0,0,6,0,2,9,0,0,9,2,8,20,1
1703,70735,p9NcQP74LARrulF6JzGeab5yk6ciJM9V,fbPkOYLVPtPgIt0MxizjfFJov3JbHyAi,5,6,2,0,2,0,2,0,12,1.7142857142857142,1,0.0,0,2,0,2,6,0,0,2,0,4,8,0
1704,70738,6dbTbyd09itvDaSueIGFOrLEXchCwk95,fbPkOYLVPtPgIt0MxizjfFJov3JbHyAi,1,0,0,0,0,0,1,0,1,0.14285714285714285,1,0.0,0,0,0,0,0,0,0,1,0,0,1,1
1705,70739,UpVcxzqMkt11Nj9X8RwveSuqRLLT8jcK,fbPkOYLVPtPgIt0MxizjfFJov3JbHyAi,1,0,0,0,0,0,2,0,2,0.2857142857142857,1,0.0,0,0,0,0,0,0,0,2,0,0,2,1
1706,70740,dfuGl47rq6fydJ1Iu9G64MAVsec4tYLw,fbPkOYLVPtPgIt0MxizjfFJov3JbHyAi,8,4,3,0,2,0,4,0,13,1.8571428571428572,1,0.0,0,3,0,2,4,0,0,4,0,5,8,1
1707,70741,UkIsdTaWagDppaZDW5tymVOWOun6ZaQI,fbPkOYLVPtPgIt0MxizjfFJov3JbHyAi,2,0,0,0,0,0,2,0,2,0.2857142857142857,1,0.0,0,0,0,0,0,0,0,2,0,0,2,1
1708,70745,p6AFdMGSdHZgjyt65ZYRzektbK0I84xl,fbPkOYLVPtPgIt0MxizjfFJov3JbHyAi,6,2,1,0,1,0,3,0,7,1.0,1,0.0,0,1,0,1,2,0,0,3,0,2,5,1
1709,70746,LQmyF5rgACOl1PlQazAUIkQQzPowi62e,fbPkOYLVPtPgIt0MxizjfFJov3JbHyAi,6,1,1,0,1,0,5,0,8,1.1428571428571428,1,0.0,0,1,0,1,1,0,0,5,0,2,6,1
1710,70748,Ym6TvHrxnwJdfewbwqJsshYwGQqwpbLU,fbPkOYLVPtPgIt0MxizjfFJov3JbHyAi,1,0,0,0,0,0,1,0,1,0.14285714285714285,1,0.0,0,0,0,0,0,0,0,1,0,0,1,1
1711,70751,ENyodDgJyA2wd97NHYIDwdpe1Vs11mPZ,fbPkOYLVPtPgIt0MxizjfFJov3JbHyAi,1,0,0,0,0,0,1,0,1,0.14285714285714285,1,0.0,0,0,0,0,0,0,0,1,0,0,1,1
1712,70754,nFgkSMwO2ng2Retk5DgcNAqWaKFo0gCU,fbPkOYLVPtPgIt0MxizjfFJov3JbHyAi,8,8,3,0,3,0,3,0,17,2.4285714285714284,1,0.0,0,3,0,3,8,0,0,3,0,6,11,1
1713,70755,3HpxfMDfQbW9g9Tin4Z0gZM45TYocput,fbPkOYLVPtPgIt0MxizjfFJov3JbHyAi,5,2,1,0,1,0,2,0,6,0.8571428571428571,1,0.0,0,1,0,1,2,0,0,2,0,2,4,1
1714,70756,vBhHgjMP9zQ8a4hHaJHnj26pjx8bQlTJ,fbPkOYLVPtPgIt0MxizjfFJov3JbHyAi,1,0,0,0,0,0,2,0,2,0.2857142857142857,1,0.0,0,0,0,0,0,0,0,2,0,0,2,1
1715,70758,RwU7Y7lavLbhtCQP0Z40qchKwKbkXpWv,fbPkOYLVPtPgIt0MxizjfFJov3JbHyAi,2,0,0,0,0,0,2,0,2,0.2857142857142857,1,0.0,0,0,0,0,0,0,0,2,0,0,2,1
1716,70759,9yy85NagPiS34NJ87i7KYeHGwZcaY5RV,fbPkOYLVPtPgIt0MxizjfFJov3JbHyAi,1,0,0,0,0,0,1,0,1,0.14285714285714285,1,0.0,0,0,0,0,0,0,0,1,0,0,1,1
1717,70763,Dcb7ijWo8pQsf9LOueamq5fOrw00PG6q,fbPkOYLVPtPgIt0MxizjfFJov3JbHyAi,6,5,3,0,2,2,3,0,15,2.142857142857143,1,0.0,0,3,0,2,5,2,0,3,0,5,10,1
1718,70766,GjiH1IkIccjLrYuqfEsVjmx7CFuQL57X,fbPkOYLVPtPgIt0MxizjfFJov3JbHyAi,6,6,1,0,2,0,2,0,11,1.5714285714285714,1,0.0,3,1,0,2,3,0,0,2,0,6,5,1
1719,70767,NdQp2i50zLfip7hkQMmu9RAwjvzQx8Ro,fbPkOYLVPtPgIt0MxizjfFJov3JbHyAi,1,0,0,0,0,0,1,0,1,0.14285714285714285,1,0.0,0,0,0,0,0,0,0,1,0,0,1,1
1720,70768,k5ImVzQqedaNbB81c2Hwkrfmv9j8DVBf,fbPkOYLVPtPgIt0MxizjfFJov3JbHyAi,7,3,2,0,2,0,4,0,11,1.5714285714285714,1,0.0,0,2,0,2,3,0,0,4,0,4,7,1
1721,70777,WyyKrch61UrttdMbjuQKzg4QBmDCrCBH,fbPkOYLVPtPgIt0MxizjfFJov3JbHyAi,5,2,1,0,1,0,2,0,6,0.8571428571428571,1,0.0,0,1,0,1,2,0,0,2,0,2,4,1
1722,70778,MIqfP3VsJ9nH7bZE9ekfrlzlbcWQcCFl,fbPkOYLVPtPgIt0MxizjfFJov3JbHyAi,1,0,0,0,0,0,1,0,1,0.14285714285714285,1,0.0,0,0,0,0,0,0,0,1,0,0,1,1
1723,70782,rdl2Dm3C3i0ppIthR1Qn4oaBGTeiNx1U,fbPkOYLVPtPgIt0MxizjfFJov3JbHyAi,7,3,2,0,2,0,2,0,9,1.2857142857142858,1,0.0,0,2,0,2,3,0,0,2,0,4,5,1
1724,70785,hW0YVXPA152YM5ruixi6vg4sBZmIyH6B,fbPkOYLVPtPgIt0MxizjfFJov3JbHyAi,2,0,0,0,0,0,5,0,5,0.7142857142857143,1,0.0,0,0,0,0,0,0,0,5,0,0,5,1
1725,70786,jqG9CfpKiNNgI1mgrk9KW86K86stS6Mi,fbPkOYLVPtPgIt0MxizjfFJov3JbHyAi,9,9,0,0,1,1,13,1,25,3.5714285714285716,1,0.0,3,0,0,1,6,1,0,13,1,4,21,1
1726,70788,ekWb02aBPJno00ztvjZNAv3AR4LI6ZAw,fbPkOYLVPtPgIt0MxizjfFJov3JbHyAi,5,2,0,0,1,0,2,0,5,0.7142857142857143,1,0.0,0,0,0,1,2,0,0,2,0,1,4,1
1727,70790,TmPyC7E4NTBA6YmjfcP4ojkHVXONYmBN,fbPkOYLVPtPgIt0MxizjfFJov3JbHyAi,5,2,1,0,1,0,2,0,6,0.8571428571428571,1,0.0,0,1,0,1,2,0,0,2,0,2,4,1
1728,70791,3qcRHdffVLa2D7HfTn4z6WZ2lXzvrhpG,fbPkOYLVPtPgIt0MxizjfFJov3JbHyAi,6,3,1,0,1,0,2,0,7,1.0,1,0.0,0,1,0,1,3,0,0,2,0,2,5,1
1729,70792,JkroiUnjq2uHCiIMgFI03fh765OIWPrR,fbPkOYLVPtPgIt0MxizjfFJov3JbHyAi,1,0,0,0,0,0,1,0,1,0.14285714285714285,1,0.0,0,0,0,0,0,0,0,1,0,0,1,1
1730,70795,jjlr08B8z0coeMcgDdnBVJKSEYA9jwu6,fbPkOYLVPtPgIt0MxizjfFJov3JbHyAi,1,0,0,0,0,0,1,0,1,0.14285714285714285,1,0.0,0,0,0,0,0,0,0,1,0,0,1,1
1731,70798,boC2S8uyvVowlqLg3Y1XsVwiDCwAmln4,fbPkOYLVPtPgIt0MxizjfFJov3JbHyAi,5,2,1,0,1,0,4,0,8,1.1428571428571428,1,0.0,0,1,0,1,2,0,0,4,0,2,6,1
1732,70800,2mpeAdpOL3tGWTeEe4ZWOPVvXPu3FJnP,fbPkOYLVPtPgIt0MxizjfFJov3JbHyAi,6,2,0,0,0,0,6,1,9,1.2857142857142858,1,0.0,0,0,0,0,2,0,0,6,1,0,9,1
1733,70801,a5niF0PQgSShvkt9NB1sc4s6iuS0oVal,fbPkOYLVPtPgIt0MxizjfFJov3JbHyAi,5,2,1,0,1,0,2,0,6,0.8571428571428571,1,0.0,0,1,0,1,2,0,0,2,0,2,4,1
1734,70802,KSimnpWBH0drMHTMBZ6ujLNrpiHo2Ats,fbPkOYLVPtPgIt0MxizjfFJov3JbHyAi,6,0,0,0,0,1,13,3,17,2.4285714285714284,1,0.0,0,0,0,0,0,1,0,13,3,0,17,1
1735,70805,X5eROzQX7rhyrxBey0oqBe6jtRxHyD2A,fbPkOYLVPtPgIt0MxizjfFJov3JbHyAi,6,1,1,0,1,0,3,0,6,0.8571428571428571,1,0.0,0,1,0,1,1,0,0,3,0,2,4,1
1736,70806,BVznem1ellaAs8tYskTZaTrvHXJyT2Zb,fbPkOYLVPtPgIt0MxizjfFJov3JbHyAi,5,2,1,0,1,0,2,0,6,0.8571428571428571,1,0.0,0,1,0,1,2,0,0,2,0,2,4,1
1737,70807,lcguF24eJLLJpEr3dB9FY8rhbtdiFvGC,fbPkOYLVPtPgIt0MxizjfFJov3JbHyAi,1,0,0,0,0,0,1,0,1,0.14285714285714285,1,0.0,0,0,0,0,0,0,0,1,0,0,1,1
1738,70810,CBBhqECPTNqAKZUrRWMmwFKMWNkqEZn0,fbPkOYLVPtPgIt0MxizjfFJov3JbHyAi,7,3,2,0,2,0,2,0,9,1.2857142857142858,1,0.0,0,2,0,2,3,0,0,2,0,4,5,1
1739,70811,m78E7vltQhJgZgrROuk3QTJpjWRjCXpP,fbPkOYLVPtPgIt0MxizjfFJov3JbHyAi,5,3,1,0,1,0,2,0,7,1.0,1,0.0,1,1,0,1,2,0,0,2,0,3,4,1
1740,70815,w5jq4cUGCLiYNuQqjhzyyIK1nCXtEQY7,fbPkOYLVPtPgIt0MxizjfFJov3JbHyAi,2,0,0,0,0,0,2,0,2,0.2857142857142857,1,0.0,0,0,0,0,0,0,0,2,0,0,2,1
1741,70816,5CB4swFPweP7kpiIuMEez08nNIJxrTCU,fbPkOYLVPtPgIt0MxizjfFJov3JbHyAi,7,3,2,0,2,0,2,0,9,1.2857142857142858,1,0.0,0,2,0,2,3,0,0,2,0,4,5,1
1742,70818,VYp7s59UUnQczX0IlO39VEvKPQphb7ko,fbPkOYLVPtPgIt0MxizjfFJov3JbHyAi,1,0,0,0,0,0,1,0,1,0.14285714285714285,1,0.0,0,0,0,0,0,0,0,1,0,0,1,1
1743,70819,vjFBv13y086gggICV62EHu0yBgOzNutV,fbPkOYLVPtPgIt0MxizjfFJov3JbHyAi,7,7,2,0,2,0,5,0,16,2.2857142857142856,2,0.0,0,2,0,2,7,0,0,5,0,4,12,1
1744,70827,ldVvKkl14x8Ir8UvT4LavBfHwbFTWxfX,fbPkOYLVPtPgIt0MxizjfFJov3JbHyAi,2,0,0,0,0,0,3,0,3,0.42857142857142855,1,0.0,0,0,0,0,0,0,0,3,0,0,3,1
1745,70834,KVX7Y5dqohnBCFqFu0UMGdbJ0FKj1RGE,fbPkOYLVPtPgIt0MxizjfFJov3JbHyAi,7,2,1,0,1,0,4,0,8,1.1428571428571428,1,0.0,0,1,0,1,2,0,0,4,0,2,6,1
1746,70835,yEUx5EDkSQZ0AERWiDLd07Yf3D0jNmra,fbPkOYLVPtPgIt0MxizjfFJov3JbHyAi,5,2,1,0,1,0,2,0,6,0.8571428571428571,1,0.0,0,1,0,1,2,0,0,2,0,2,4,0
1747,70838,V2oXO5MUVbmMLpm49RH7wP2e7GBuZQIG,fbPkOYLVPtPgIt0MxizjfFJov3JbHyAi,6,5,1,0,1,0,3,0,10,1.4285714285714286,1,0.0,0,1,0,1,5,0,0,3,0,2,8,1
1748,70841,pzZeaYxzJXbuhi5KTdAt0eeAxzLlFc60,fbPkOYLVPtPgIt0MxizjfFJov3JbHyAi,8,17,0,4,1,0,6,0,28,4.0,1,0.0,5,0,3,1,12,0,1,6,0,9,19,1
1749,70843,4Ofl2Ny0Hi8mgxaGCrkktZk3mHl8PQkx,fbPkOYLVPtPgIt0MxizjfFJov3JbHyAi,1,0,0,0,0,0,2,0,2,0.2857142857142857,1,0.0,0,0,0,0,0,0,0,2,0,0,2,1
1750,70844,JKI9pSyEwU7yqpCLpxIR9F4XQMHCp20K,fbPkOYLVPtPgIt0MxizjfFJov3JbHyAi,5,2,1,0,1,0,2,0,6,0.8571428571428571,1,0.0,0,1,0,1,2,0,0,2,0,2,4,1
1751,70848,dizRBkb9QQnO5lOZ4qzzgmJWVuYvCZWl,fbPkOYLVPtPgIt0MxizjfFJov3JbHyAi,1,0,0,0,0,0,1,0,1,0.14285714285714285,1,0.0,0,0,0,0,0,0,0,1,0,0,1,1
1752,70849,rvGeJBDthuxogYD9iVgKqZ9WWdzkhnrb,fbPkOYLVPtPgIt0MxizjfFJov3JbHyAi,1,0,0,0,0,0,1,0,1,0.14285714285714285,1,0.0,0,0,0,0,0,0,0,1,0,0,1,1
1753,70851,aMumXCd09eIRYN1LbGM5nVYZFHRtNPDe,fbPkOYLVPtPgIt0MxizjfFJov3JbHyAi,6,2,1,0,1,0,4,0,8,1.1428571428571428,1,0.0,0,1,0,1,2,0,0,4,0,2,6,1
1754,70852,hgNqBAseHohc9BKsFOMM49J0ufMjGDL5,fbPkOYLVPtPgIt0MxizjfFJov3JbHyAi,4,2,1,0,0,0,2,0,5,0.7142857142857143,1,0.0,0,1,0,0,2,0,0,2,0,1,4,1
1755,70853,t6NWwU4qK3YyLYX7t7fzZJQHw55QhxpE,fbPkOYLVPtPgIt0MxizjfFJov3JbHyAi,10,13,4,7,4,0,4,0,32,4.571428571428571,1,0.0,5,4,5,4,8,0,2,4,0,18,14,1
1756,70856,2ZrkcHnwnE6Pn0A4sJYSZoI8FSiFAo2R,fbPkOYLVPtPgIt0MxizjfFJov3JbHyAi,7,1,1,0,1,1,4,1,9,1.2857142857142858,1,0.0,0,1,0,1,1,1,0,4,1,2,7,1
1757,70857,P4rYy4VFFS1aWSnIl4t3iCnhdV1GUZUL,fbPkOYLVPtPgIt0MxizjfFJov3JbHyAi,5,2,1,0,1,1,3,0,8,1.1428571428571428,1,0.0,0,1,0,1,2,1,0,3,0,2,6,1
1758,70860,gDi6f8yecAtULPjPfuTZCDylLlh4kFrA,fbPkOYLVPtPgIt0MxizjfFJov3JbHyAi,5,2,1,0,1,0,2,0,6,0.8571428571428571,1,0.0,0,1,0,1,2,0,0,2,0,2,4,1
1759,70863,xDc1xgzFSFoS6IiGjf8r0vplCBQSLEw0,fbPkOYLVPtPgIt0MxizjfFJov3JbHyAi,11,9,4,2,4,0,4,0,23,3.2857142857142856,1,0.0,3,4,2,4,6,0,0,4,0,13,10,1
1760,70865,scS3D2DWLKsKrvVVvWQWPPqVUehrWkS1,fbPkOYLVPtPgIt0MxizjfFJov3JbHyAi,1,0,0,0,0,0,1,0,1,0.14285714285714285,1,0.0,0,0,0,0,0,0,0,1,0,0,1,1
1761,70868,9t6TphVDPn8QCqkJMSSSD8suJg54nDg1,fbPkOYLVPtPgIt0MxizjfFJov3JbHyAi,7,3,2,0,2,0,3,0,10,1.4285714285714286,1,0.0,0,2,0,2,3,0,0,3,0,4,6,1
1762,70871,EVZzKo71oTynD4qvlIqI8WHFpHDNDZTk,fbPkOYLVPtPgIt0MxizjfFJov3JbHyAi,8,6,3,0,1,1,4,0,15,2.142857142857143,1,0.0,1,3,0,1,5,1,0,4,0,5,10,0
1763,70873,p9vt4gNfihsixdGiLCuufIHsmW3jvD7a,fbPkOYLVPtPgIt0MxizjfFJov3JbHyAi,1,0,0,0,0,0,1,0,1,0.14285714285714285,1,0.0,0,0,0,0,0,0,0,1,0,0,1,1
1764,70874,0bySEAm2oYtQ2Tleetx3OtzbFfR26iOs,fbPkOYLVPtPgIt0MxizjfFJov3JbHyAi,9,7,5,0,5,0,2,0,19,2.7142857142857144,1,0.0,0,5,0,5,7,0,0,2,0,10,9,1
1765,70878,JJ6wlXEIablDydF4jOHDhv4TjKDeXQan,fbPkOYLVPtPgIt0MxizjfFJov3JbHyAi,7,7,2,0,3,0,2,0,14,2.0,1,0.0,4,2,0,3,3,0,0,2,0,9,5,1
1766,70879,4OTqFMCZxx7r7u5a2qYtSI5NaNF7PvO8,fbPkOYLVPtPgIt0MxizjfFJov3JbHyAi,8,4,3,0,3,0,1,0,11,1.5714285714285714,1,0.0,0,3,0,3,4,0,0,1,0,6,5,1
1767,70880,K8EiUmRs9Nq0Qj4O9mjSk5qQn6E6D5cj,fbPkOYLVPtPgIt0MxizjfFJov3JbHyAi,5,2,1,0,1,0,2,0,6,0.8571428571428571,1,0.0,0,1,0,1,2,0,0,2,0,2,4,1
1768,70881,sOSUJ9Hzn8EsMXvSoMXyqd2CJLKFDkw3,fbPkOYLVPtPgIt0MxizjfFJov3JbHyAi,1,0,0,0,0,0,1,0,1,0.14285714285714285,1,0.0,0,0,0,0,0,0,0,1,0,0,1,1
1769,70882,XluaP5TPFhLRlajx7bmLwFy9eBFAVswr,fbPkOYLVPtPgIt0MxizjfFJov3JbHyAi,1,0,0,0,0,0,1,0,1,0.14285714285714285,1,0.0,0,0,0,0,0,0,0,1,0,0,1,1
1770,70883,NeDoKNVSKD8Aiq0pOti0J4aVmpnS5aEL,fbPkOYLVPtPgIt0MxizjfFJov3JbHyAi,7,7,2,0,3,0,7,0,19,2.7142857142857144,1,0.0,2,2,0,3,5,0,0,7,0,7,12,1
1771,70886,8p7u7RxFna6sXuG4TtD3bPfcMY9zmEQb,fbPkOYLVPtPgIt0MxizjfFJov3JbHyAi,5,2,1,0,1,0,4,0,8,1.1428571428571428,1,0.0,0,1,0,1,2,0,0,4,0,2,6,1
1772,70887,JROXjwvC9rxe26lrQwNHzIbtlVSWvibf,fbPkOYLVPtPgIt0MxizjfFJov3JbHyAi,5,3,1,0,1,0,2,0,7,1.0,1,0.0,0,1,0,1,3,0,0,2,0,2,5,1
1773,70890,4G4NYV5HdrqJgMd8tHZhlgK9Wwk62py3,fbPkOYLVPtPgIt0MxizjfFJov3JbHyAi,1,0,0,0,0,0,1,0,1,0.14285714285714285,1,0.0,0,0,0,0,0,0,0,1,0,0,1,1
1774,70892,kITorNxbn0jKRrU5oeVoAkoKxKssAebK,fbPkOYLVPtPgIt0MxizjfFJov3JbHyAi,7,5,2,0,3,0,2,0,12,1.7142857142857142,1,0.0,2,2,0,3,3,0,0,2,0,7,5,1
1775,70893,RMMuFeZ2nCFjdFF7Br5oAsh68xDnP2Kt,fbPkOYLVPtPgIt0MxizjfFJov3JbHyAi,2,0,0,0,0,0,2,0,2,0.2857142857142857,1,0.0,0,0,0,0,0,0,0,2,0,0,2,1
1776,70895,iAXqLonwJtIlRlvnGYLtu7A6G32sN6pK,fbPkOYLVPtPgIt0MxizjfFJov3JbHyAi,2,0,0,0,0,0,2,0,2,0.2857142857142857,1,0.0,0,0,0,0,0,0,0,2,0,0,2,1
1777,70900,w5Nz5FF2iacISxkk1j18hYO33XJu5f6u,fbPkOYLVPtPgIt0MxizjfFJov3JbHyAi,2,0,0,0,0,0,2,0,2,0.2857142857142857,1,0.0,0,0,0,0,0,0,0,2,0,0,2,1
1778,70901,5Sdd90y9f6G1O01oh8dNylP38h97ZkQP,fbPkOYLVPtPgIt0MxizjfFJov3JbHyAi,5,2,1,0,1,0,2,0,6,0.8571428571428571,1,0.0,0,1,0,1,2,0,0,2,0,2,4,1
1779,70928,iem7aobLjfwmsInz2aJm33FyllmcOoxM,SpATywNh6bZuzm8s1ceuBUnMUAeoAHHw,11,22,4,0,0,6,18,2,52,7.428571428571429,4,0.0,1,4,0,0,21,6,0,18,2,5,47,1
1780,70935,JiFgudQA4nZtHR8rdanNuKW7boGcferp,SpATywNh6bZuzm8s1ceuBUnMUAeoAHHw,9,12,3,17,1,0,1,0,34,4.857142857142857,1,0.0,8,3,16,1,4,0,1,1,0,28,6,1
1781,70936,u2D7DEFYPnV7TgAwmWCf915LuQlPziwx,SpATywNh6bZuzm8s1ceuBUnMUAeoAHHw,1,0,0,0,0,0,1,0,1,0.14285714285714285,1,0.0,0,0,0,0,0,0,0,1,0,0,1,1
1782,70966,USLTnsAwagwK2c83KXd1SNEeENnzkTTo,SpATywNh6bZuzm8s1ceuBUnMUAeoAHHw,1,0,0,0,0,0,2,0,2,0.2857142857142857,1,0.0,0,0,0,0,0,0,0,2,0,0,2,1
1783,70971,1GwCcPnawuwjaFyAi38hoJxQ9NHTHcHa,A3fsA9Zfv1X2fVEQhTw51lKENdNrEqT3,6,2,1,0,0,0,8,0,11,1.5714285714285714,1,0.0,0,1,0,0,2,0,0,8,0,1,10,1
1784,71007,ah7dn7oeJ2Zo8NzKmljnoEEVEzPzQawZ,A3fsA9Zfv1X2fVEQhTw51lKENdNrEqT3,10,13,5,0,2,1,7,0,28,4.0,2,0.0,0,5,0,2,13,1,0,7,0,7,21,1
1785,71008,l5FaUWasiv60gSjMCgxRDYxpxpwnBW6p,SpATywNh6bZuzm8s1ceuBUnMUAeoAHHw,13,10,5,2,3,0,3,0,23,3.2857142857142856,1,0.0,0,5,2,3,10,0,0,3,0,10,13,1
1786,71009,CKlApvgsp3P7WP3VG5px4QWIpk803niH,A3fsA9Zfv1X2fVEQhTw51lKENdNrEqT3,5,0,0,0,0,0,6,3,9,1.2857142857142858,1,0.0,0,0,0,0,0,0,0,6,3,0,9,1
1787,71012,2UIdqPRKpgTkXkubY12P5suWz65Jis6l,SpATywNh6bZuzm8s1ceuBUnMUAeoAHHw,9,18,10,0,2,0,7,1,38,5.428571428571429,2,0.0,2,10,0,2,16,0,0,7,1,14,24,1
1788,71017,QjbLQSoFVavd6LHLH5XtUy4x4q9nhmtF,SpATywNh6bZuzm8s1ceuBUnMUAeoAHHw,15,9,8,0,7,0,1,0,25,3.5714285714285716,1,0.0,0,8,0,7,9,0,0,1,0,15,10,0
1789,71084,PehZ8w7lhwueNJQVLn4O4a5DjlM7RVHJ,A3fsA9Zfv1X2fVEQhTw51lKENdNrEqT3,77,39,18,204,13,0,5,0,279,39.857142857142854,2,0.0,3,18,177,13,36,0,27,5,0,211,68,1
1790,71089,bOlBfDLwRlFztzXeRI7M3tpbHNy8C56c,SpATywNh6bZuzm8s1ceuBUnMUAeoAHHw,16,25,0,23,0,14,5,0,67,9.571428571428571,1,0.0,5,0,19,0,20,14,4,5,0,24,43,1
1791,71104,zxmge3ZElgX2vkJ2cCOzkeMQCnk45k6Y,G8EPVSXsOYB5YQWZGiz1aVq5Pgr2GrQu,4,5,3,0,0,0,2,0,10,1.4285714285714286,2,0.0,0,3,0,0,5,0,0,2,0,3,7,1
1792,71106,8IMVGvB09WRKHeXEjWGkZOVu6CXmlVXA,A3fsA9Zfv1X2fVEQhTw51lKENdNrEqT3,1,0,0,0,0,0,1,0,1,0.14285714285714285,1,0.0,0,0,0,0,0,0,0,1,0,0,1,1
1793,71110,D5E2Qt7jBeIZBIFcDabwhaaXeayXbs8U,bWdj2GDclj5ofokWjzoa5jAwMkxCykd6,4,5,2,0,0,0,4,0,11,1.5714285714285714,2,0.0,0,2,0,0,5,0,0,4,0,2,9,1
1794,71116,gMihFFRgCbvgH3cTGh2cgQ4GULLM91Yq,SpATywNh6bZuzm8s1ceuBUnMUAeoAHHw,20,29,3,6,2,4,8,1,53,7.571428571428571,2,0.0,5,3,6,2,24,4,0,8,1,16,37,0
1795,71139,loLM1q927UBCE6cjZ1Vielkh2VBpufUl,A3fsA9Zfv1X2fVEQhTw51lKENdNrEqT3,39,27,25,0,21,0,4,0,77,11.0,1,0.0,0,25,0,21,27,0,0,4,0,46,31,1
1796,71140,loLM1q927UBCE6cjZ1Vielkh2VBpufUl,SpATywNh6bZuzm8s1ceuBUnMUAeoAHHw,19,12,11,0,9,0,3,0,35,5.0,1,0.0,0,11,0,9,12,0,0,3,0,20,15,1
1797,71162,FixP7IuJ80KsWtzMzcQsJZKOjLxDKZgC,G8EPVSXsOYB5YQWZGiz1aVq5Pgr2GrQu,1,0,0,0,0,0,1,0,1,0.14285714285714285,1,0.0,0,0,0,0,0,0,0,1,0,0,1,1
1798,71180,6zXGZtvwHnFZCYFcS3Xzk5yrVH7CXdoJ,bWdj2GDclj5ofokWjzoa5jAwMkxCykd6,7,4,2,4,0,0,2,0,12,1.7142857142857142,1,0.0,1,2,4,0,3,0,0,2,0,7,5,0
1799,71197,5PZBmKEXGmnHhrok7M9vaGB06CAzFVOO,A3fsA9Zfv1X2fVEQhTw51lKENdNrEqT3,68,35,16,126,14,0,4,0,195,27.857142857142858,2,0.0,4,16,109,14,31,0,17,4,0,143,52,0
1800,71204,SEiRJIrKqIUXJc6AKB5rH8Do4LEjJRIR,SpATywNh6bZuzm8s1ceuBUnMUAeoAHHw,8,4,3,0,2,0,2,0,11,1.5714285714285714,1,0.0,0,3,0,2,4,0,0,2,0,5,6,1
1801,71227,HieJch2LMldZteUgpMFf3KIoNYB4ohUW,RXDvfPUBYFlVdlueBFbLW0mhhAyGEqpt,5,2,1,0,1,0,2,0,6,0.8571428571428571,1,0.0,0,1,0,1,2,0,0,2,0,2,4,0
1802,71233,OYKjrPxX9BZcmbpGQNe0saEMxsDF2LNu,SpATywNh6bZuzm8s1ceuBUnMUAeoAHHw,1,0,0,0,0,0,1,0,1,0.14285714285714285,1,0.0,0,0,0,0,0,0,0,1,0,0,1,1
1803,71277,ZzEeIm98vbP9lRunZYePLW46UyhiVxbR,bWdj2GDclj5ofokWjzoa5jAwMkxCykd6,3,2,1,0,0,0,1,0,4,0.5714285714285714,1,0.0,0,1,0,0,2,0,0,1,0,1,3,1
1804,71279,YYCI1ivPCDRa3x25VBUTnS1EqXk51k7P,A3fsA9Zfv1X2fVEQhTw51lKENdNrEqT3,6,5,3,0,0,0,3,0,11,1.5714285714285714,1,0.0,0,3,0,0,5,0,0,3,0,3,8,1
1805,71280,YUT6CW7iSh1xoUpF2nfmR8w0ThlxeIYe,SpATywNh6bZuzm8s1ceuBUnMUAeoAHHw,14,15,0,26,0,0,4,0,45,6.428571428571429,2,0.0,6,0,21,0,9,0,5,4,0,27,18,0
1806,71288,ynZwxbnEbKW0W9hd646CFEVp0hOxydow,SpATywNh6bZuzm8s1ceuBUnMUAeoAHHw,24,25,11,30,6,0,4,0,76,10.857142857142858,2,0.0,13,11,27,6,12,0,3,4,0,57,19,0
1807,71302,xNhIay3NLh7QqL0JWfWBdzb4B9nitBX9,G8EPVSXsOYB5YQWZGiz1aVq5Pgr2GrQu,5,2,1,0,1,0,2,0,6,0.8571428571428571,1,0.0,0,1,0,1,2,0,0,2,0,2,4,0
1808,71309,04MTc9DP7u70zt8WMvntZYPfTFQUHhtX,SpATywNh6bZuzm8s1ceuBUnMUAeoAHHw,2,0,0,0,0,0,3,0,3,0.42857142857142855,2,0.0,0,0,0,0,0,0,0,3,0,0,3,0
1809,71318,bOlBfDLwRlFztzXeRI7M3tpbHNy8C56c,bWdj2GDclj5ofokWjzoa5jAwMkxCykd6,5,2,1,0,1,0,2,0,6,0.8571428571428571,1,0.0,0,1,0,1,2,0,0,2,0,2,4,1
1810,71358,WfFzDu02yVQhznDpti9qz88KkaHNMAz5,SpATywNh6bZuzm8s1ceuBUnMUAeoAHHw,2,0,0,0,0,0,2,0,2,0.2857142857142857,1,0.0,0,0,0,0,0,0,0,2,0,0,2,1
1811,71361,fnAQHOrM0aOC0GQVDcBG5sVn1wNxVUAt,SpATywNh6bZuzm8s1ceuBUnMUAeoAHHw,29,24,15,12,7,1,4,0,63,9.0,2,0.0,5,15,12,7,19,1,0,4,0,39,24,0
1812,71373,oNf6qoW6E6dhoPJKSUjvElFlUKN9drLY,G8EPVSXsOYB5YQWZGiz1aVq5Pgr2GrQu,5,12,3,0,4,0,3,0,22,3.142857142857143,2,0.0,7,3,0,4,5,0,0,3,0,14,8,1
1813,71404,hKHtoNLNdXjroo5MBUJPMKLH6p5UkRTG,SpATywNh6bZuzm8s1ceuBUnMUAeoAHHw,8,5,1,0,0,1,6,1,14,2.0,1,0.0,0,1,0,0,5,1,0,6,1,1,13,1
1814,71421,5Ls9Y8mfUb8JgZfSWkF8kDMEq3gGISZD,G8EPVSXsOYB5YQWZGiz1aVq5Pgr2GrQu,6,5,1,0,1,0,4,0,11,1.5714285714285714,1,0.0,0,1,0,1,5,0,0,4,0,2,9,1
1815,71426,onsmNYIoPFEi185f5ZLsQXD70I3K25Cb,bWdj2GDclj5ofokWjzoa5jAwMkxCykd6,4,5,1,0,0,0,1,0,7,1.0,1,0.0,1,1,0,0,4,0,0,1,0,2,5,1
1816,71558,nqvxWBh8RMlOMSpTtlC0WlRIvQffkk6Q,SpATywNh6bZuzm8s1ceuBUnMUAeoAHHw,26,22,15,16,12,1,7,0,73,10.428571428571429,1,0.0,5,15,16,12,17,1,0,7,0,48,25,0
1817,71562,6yNhQyEbKEsWZJAOZYhGdgOd9YcNxjUf,G8EPVSXsOYB5YQWZGiz1aVq5Pgr2GrQu,1,0,0,0,0,0,1,0,1,0.14285714285714285,1,0.0,0,0,0,0,0,0,0,1,0,0,1,1
1818,71579,01fFtDlb7q6YVhWJvhsOvwQMPs8xw65f,A3fsA9Zfv1X2fVEQhTw51lKENdNrEqT3,1,0,0,0,0,0,1,0,1,0.14285714285714285,1,0.0,0,0,0,0,0,0,0,1,0,0,1,1
1819,71586,DgIUsdyZ2bZRmyXrVqC2xYLKsZlQY2uf,SpATywNh6bZuzm8s1ceuBUnMUAeoAHHw,11,10,1,3,1,0,3,0,18,2.5714285714285716,2,0.0,0,1,3,1,10,0,0,3,0,5,13,1
1820,71593,EU6hvCkOpmY7eHAp1iULlNAf6vTYfvA3,G8EPVSXsOYB5YQWZGiz1aVq5Pgr2GrQu,1,0,0,0,0,0,1,0,1,0.14285714285714285,1,0.0,0,0,0,0,0,0,0,1,0,0,1,1
1821,71594,gIXV45WkMOjKV6SvlgkVrQlYJRphcrVX,A3fsA9Zfv1X2fVEQhTw51lKENdNrEqT3,8,4,3,0,3,0,1,0,11,1.5714285714285714,1,0.0,0,3,0,3,4,0,0,1,0,6,5,1
1822,71601,jsJkZlRrCs7XDDe36sdBTD1SNVw3QiEY,SpATywNh6bZuzm8s1ceuBUnMUAeoAHHw,4,0,0,0,0,0,4,0,4,0.5714285714285714,2,0.0,0,0,0,0,0,0,0,4,0,0,4,0
1823,71611,KWdhtnEkrke9rgi3l1csNclNjZVhn1s4,SpATywNh6bZuzm8s1ceuBUnMUAeoAHHw,5,7,0,0,0,0,4,0,11,1.5714285714285714,2,0.0,0,0,0,0,7,0,0,4,0,0,11,1
1824,71634,ojqn4pgOfPG4Pc3ke3CSjZ4IF82Cz5Gt,SpATywNh6bZuzm8s1ceuBUnMUAeoAHHw,3,2,0,0,0,0,1,0,3,0.42857142857142855,1,0.0,0,0,0,0,2,0,0,1,0,0,3,1
1825,71670,AqzJls3OFl2nFap48g5Tia0Yo0Y7Cer3,G8EPVSXsOYB5YQWZGiz1aVq5Pgr2GrQu,7,8,2,0,3,0,3,0,16,2.2857142857142856,1,0.0,2,2,0,3,6,0,0,3,0,7,9,1
1826,71711,NwQCoUHJKyAdqdG7U0utXO1oyZsmr8V3,bWdj2GDclj5ofokWjzoa5jAwMkxCykd6,1,0,0,0,0,0,1,0,1,0.14285714285714285,1,0.0,0,0,0,0,0,0,0,1,0,0,1,1
1827,71754,MwsjD881hF2KUCEG3rXUPSq3GKMfMo2d,A3fsA9Zfv1X2fVEQhTw51lKENdNrEqT3,7,4,2,0,1,0,5,0,12,1.7142857142857142,1,0.0,0,2,0,1,4,0,0,5,0,3,9,0
1828,71759,foGsrANktd6dCLnplglYgW0LYGi2yeuV,bWdj2GDclj5ofokWjzoa5jAwMkxCykd6,6,4,2,8,0,0,3,0,17,2.4285714285714284,1,0.0,0,2,7,0,4,0,1,3,0,9,8,1
1829,71809,3VdXvjSQZjkmaMxk7jVlpKzQwHK0VW6h,RXDvfPUBYFlVdlueBFbLW0mhhAyGEqpt,1,0,0,0,0,0,1,0,1,0.14285714285714285,1,0.0,0,0,0,0,0,0,0,1,0,0,1,0
1830,71829,n1JdH8HPXOUoCHQIEd4YCo0nlAshsKdG,SpATywNh6bZuzm8s1ceuBUnMUAeoAHHw,17,14,9,14,5,2,6,0,50,7.142857142857143,3,0.0,2,9,13,5,12,2,1,6,0,29,21,0
1831,71836,BVpzzXeXh42vyU3wE9rUQpEUs8P1ZpSo,SpATywNh6bZuzm8s1ceuBUnMUAeoAHHw,6,6,4,4,0,0,2,0,16,2.2857142857142856,1,0.0,1,4,3,0,5,0,1,2,0,8,8,0
1832,71843,TtktJZVgpwig0r3gUw8lQnr2rEFBADhH,G8EPVSXsOYB5YQWZGiz1aVq5Pgr2GrQu,6,9,3,0,2,0,2,0,16,2.2857142857142856,1,0.0,5,3,0,2,4,0,0,2,0,10,6,1
1833,71860,kTJIJds7bRsw0KFlLhCoB2PivF66Tf3q,A3fsA9Zfv1X2fVEQhTw51lKENdNrEqT3,33,19,17,50,13,0,1,0,100,14.285714285714286,1,0.0,0,17,44,13,19,0,6,1,0,74,26,1
1834,71865,nvXkSuJjNwPy4x4PN83PXogIa9iXtJsm,A3fsA9Zfv1X2fVEQhTw51lKENdNrEqT3,20,14,10,0,7,6,7,0,44,6.285714285714286,1,0.0,1,10,0,7,13,6,0,7,0,18,26,1
1835,71871,xyDv5uzKguLKwuLAtjs5magaAGWqhgm8,A3fsA9Zfv1X2fVEQhTw51lKENdNrEqT3,5,4,0,0,0,0,4,0,8,1.1428571428571428,1,0.0,0,0,0,0,4,0,0,4,0,0,8,0
1836,71872,pxwAvlbOFGjXMz981vvB3RuwcS56iZNF,SpATywNh6bZuzm8s1ceuBUnMUAeoAHHw,1,0,0,0,0,0,1,0,1,0.14285714285714285,1,0.0,0,0,0,0,0,0,0,1,0,0,1,1
1837,71892,AimQk6bFhhGPpMH9HY88V7PvSxxOwe07,SpATywNh6bZuzm8s1ceuBUnMUAeoAHHw,3,1,0,0,0,0,2,0,3,0.42857142857142855,1,0.0,0,0,0,0,1,0,0,2,0,0,3,1
1838,71928,z9s7UAFfwXliVd2GScbNHLyqLTBO7649,SpATywNh6bZuzm8s1ceuBUnMUAeoAHHw,6,3,1,0,1,0,2,0,7,1.0,1,0.0,0,1,0,1,3,0,0,2,0,2,5,1
1839,71961,LyDM0yrwn8zKtQsuxEGqFMxdhffaZNVY,A3fsA9Zfv1X2fVEQhTw51lKENdNrEqT3,6,9,1,0,1,0,4,1,16,2.2857142857142856,1,0.0,1,1,0,1,8,0,0,4,1,3,13,1
1840,71962,Gq7C34w2v5h08r5B2E14BoawNOpfmfl0,SpATywNh6bZuzm8s1ceuBUnMUAeoAHHw,4,2,1,0,1,0,1,0,5,0.7142857142857143,1,0.0,0,1,0,1,2,0,0,1,0,2,3,1
1841,71999,Pe5WMotTf5HMq3hNpICq7pbnjQeqT1z5,SpATywNh6bZuzm8s1ceuBUnMUAeoAHHw,17,28,13,14,6,0,5,0,66,9.428571428571429,4,0.0,10,13,11,6,18,0,3,5,0,40,26,0
1842,72014,KL9U9geosSonjO9r5P2YyGdv6jdUGAmi,SpATywNh6bZuzm8s1ceuBUnMUAeoAHHw,5,2,1,0,1,0,2,0,6,0.8571428571428571,1,0.0,0,1,0,1,2,0,0,2,0,2,4,1
1843,72071,7gwAY8GKvsU7xwUilNpzEOAvbLd2D9r9,A3fsA9Zfv1X2fVEQhTw51lKENdNrEqT3,1,0,0,0,0,0,1,0,1,0.14285714285714285,1,0.0,0,0,0,0,0,0,0,1,0,0,1,1
1844,72086,0LMHRy44jwjr4gUThAzfzfGCUeg2Lm1J,SpATywNh6bZuzm8s1ceuBUnMUAeoAHHw,5,3,2,0,1,0,1,0,7,1.0,1,0.0,0,2,0,1,3,0,0,1,0,3,4,1
1845,72092,bLIF0ETNcg7fjkutu8YBWJptM3zxtu2Z,bWdj2GDclj5ofokWjzoa5jAwMkxCykd6,12,10,8,0,7,0,7,0,32,4.571428571428571,2,0.0,2,8,0,7,8,0,0,7,0,17,15,0
1846,72114,UuK4SgZkmPrFxeH0ZPCRQ63pVXUSe96N,bWdj2GDclj5ofokWjzoa5jAwMkxCykd6,1,0,0,0,0,0,1,0,1,0.14285714285714285,1,0.0,0,0,0,0,0,0,0,1,0,0,1,1
1847,72116,QeJMYd11is6DqiF8uVkla2ZwnHb26tuu,RXDvfPUBYFlVdlueBFbLW0mhhAyGEqpt,13,15,1,0,1,0,5,0,22,3.142857142857143,3,0.0,3,1,0,1,12,0,0,5,0,5,17,0
1848,72120,a8HvMkBRr1QnoDxivZVIhrkeiZFWplka,A3fsA9Zfv1X2fVEQhTw51lKENdNrEqT3,26,14,6,72,1,0,5,0,98,14.0,1,0.0,5,6,56,1,9,0,16,5,0,68,30,1
1849,72128,6oNhI3z3lPtYcSpGC1lnWpyyeDMBUOtK,SpATywNh6bZuzm8s1ceuBUnMUAeoAHHw,4,6,3,0,0,0,6,0,15,2.142857142857143,2,0.0,0,3,0,0,6,0,0,6,0,3,12,1
1850,72133,2qQuu2Qhkw7hRYngnGfnNzXYklrDkMwy,SpATywNh6bZuzm8s1ceuBUnMUAeoAHHw,5,6,2,0,2,0,2,0,12,1.7142857142857142,2,0.0,0,2,0,2,6,0,0,2,0,4,8,1
1851,72150,dDLv4oouOmVB45Y4hnRyV7IUqT7tMKiq,A3fsA9Zfv1X2fVEQhTw51lKENdNrEqT3,14,11,8,0,6,4,1,0,30,4.285714285714286,1,0.0,0,8,0,6,11,4,0,1,0,14,16,0
1852,72158,kiNfuRpgeROReVuBtap1KwDDZc9hG55i,A3fsA9Zfv1X2fVEQhTw51lKENdNrEqT3,3,4,1,0,0,0,1,0,6,0.8571428571428571,1,0.0,0,1,0,0,4,0,0,1,0,1,5,1
1853,72169,Lb7wmhbhC16FSS5Xq3dqazq7PwTHyvZu,bWdj2GDclj5ofokWjzoa5jAwMkxCykd6,6,5,3,0,1,0,2,0,11,1.5714285714285714,1,0.0,0,3,0,1,5,0,0,2,0,4,7,1
1854,72173,yS4hKsLzPsdj6M1qMcvQzXXEbCXgtzUx,bWdj2GDclj5ofokWjzoa5jAwMkxCykd6,2,0,0,0,0,0,2,0,2,0.2857142857142857,1,0.0,0,0,0,0,0,0,0,2,0,0,2,1
1855,72222,Fdt86Xu5OLPdaOgl6M1XDpiJ3zar7SU6,RXDvfPUBYFlVdlueBFbLW0mhhAyGEqpt,3,3,1,0,0,0,1,0,5,0.7142857142857143,1,0.0,0,1,0,0,3,0,0,1,0,1,4,1
1856,72255,H9uyY7qx5i6ZDOUonFHaANKxCA5aZsQi,G8EPVSXsOYB5YQWZGiz1aVq5Pgr2GrQu,7,4,1,0,1,0,2,0,8,1.1428571428571428,1,0.0,0,1,0,1,4,0,0,2,0,2,6,1
1857,72259,tzUG2qRl7N6mPYRCQUU2RS3J3hIQZLrD,A3fsA9Zfv1X2fVEQhTw51lKENdNrEqT3,4,2,1,0,1,0,1,0,5,0.7142857142857143,1,0.0,0,1,0,1,2,0,0,1,0,2,3,1
1858,72271,VCY6PHshXOjPWWfmo1l8Uf1lH1o7rZ3R,A3fsA9Zfv1X2fVEQhTw51lKENdNrEqT3,17,13,9,0,5,0,6,0,33,4.714285714285714,2,0.0,0,9,0,5,13,0,0,6,0,14,19,1
1859,72280,Daw06K1PSOXldo19kBgHP5sewulb7Vu5,RXDvfPUBYFlVdlueBFbLW0mhhAyGEqpt,59,119,4,172,6,86,8,2,397,56.714285714285715,2,0.0,16,4,160,6,103,86,12,8,2,186,211,1
1860,72303,hrPjKcL9rUfM1fnC8qta4lu2HmlsBLv6,RXDvfPUBYFlVdlueBFbLW0mhhAyGEqpt,15,21,11,0,5,0,5,0,42,6.0,1,0.0,7,11,0,5,14,0,0,5,0,23,19,0
1861,72333,uqA5Smdw6BACOcL0f2tmxwTTxZXBpZpE,bWdj2GDclj5ofokWjzoa5jAwMkxCykd6,5,3,2,0,1,0,1,0,7,1.0,1,0.0,0,2,0,1,3,0,0,1,0,3,4,1
1862,72350,axVh7TT3ftc0JLvNMlUvTGTAABKlThNj,A3fsA9Zfv1X2fVEQhTw51lKENdNrEqT3,17,24,4,0,3,0,8,0,39,5.571428571428571,2,0.0,0,4,0,3,24,0,0,8,0,7,32,1
1863,72378,dQa6sgmVY94byuB0fCTjymlGLIKJnAZ4,RXDvfPUBYFlVdlueBFbLW0mhhAyGEqpt,11,10,6,0,5,0,3,0,24,3.4285714285714284,1,0.0,1,6,0,5,9,0,0,3,0,12,12,1
1864,72389,1WzAMExdp2DcGRBAFaFF5ZvQSa9V2NEI,SpATywNh6bZuzm8s1ceuBUnMUAeoAHHw,5,2,1,0,1,0,2,0,6,0.8571428571428571,1,0.0,0,1,0,1,2,0,0,2,0,2,4,1
1865,72390,L6W8jpUrnYiTQTQzsQIQrX6pgKIdMfa4,SpATywNh6bZuzm8s1ceuBUnMUAeoAHHw,8,15,8,4,1,0,2,0,30,4.285714285714286,2,0.0,0,8,4,1,15,0,0,2,0,13,17,1
1866,72392,dQQ8UnfzoKHmhQlZOaaW0cB14DhE2hvY,A3fsA9Zfv1X2fVEQhTw51lKENdNrEqT3,11,20,1,10,0,3,2,0,36,5.142857142857143,1,0.0,0,1,8,0,20,3,2,2,0,9,27,0
1867,72455,tAelht5FQdpcbtZQoKgvZA90XQy6zeRb,RXDvfPUBYFlVdlueBFbLW0mhhAyGEqpt,5,5,0,0,0,3,1,0,9,1.2857142857142858,1,0.0,1,0,0,0,4,3,0,1,0,1,8,1
1868,72456,IP3TW53lg1ZMqNldZdGWMD6MaLDRhhOf,SpATywNh6bZuzm8s1ceuBUnMUAeoAHHw,5,3,2,0,1,0,1,0,7,1.0,1,0.0,0,2,0,1,3,0,0,1,0,3,4,1
1869,72476,gpgk1aIkjyvlgo7OYZtMXPlVgE39gvnr,SpATywNh6bZuzm8s1ceuBUnMUAeoAHHw,17,24,13,11,5,2,5,0,60,8.571428571428571,2,0.0,8,13,10,5,16,2,1,5,0,36,24,0
1870,72500,yYXy4lOleg47AQUxi7o5Lu77Hx9q6unU,bWdj2GDclj5ofokWjzoa5jAwMkxCykd6,5,3,2,0,1,1,2,0,9,1.2857142857142858,1,0.0,0,2,0,1,3,1,0,2,0,3,6,1
1871,72533,kPw5nR6GIfIGfnUDhfrz9sq3P6l2CmOK,RXDvfPUBYFlVdlueBFbLW0mhhAyGEqpt,3,4,2,0,0,0,2,0,8,1.1428571428571428,2,0.0,0,2,0,0,4,0,0,2,0,2,6,1
1872,72536,j8vYdYwa9gvt7hkF8dykZR2D4h75QsII,G8EPVSXsOYB5YQWZGiz1aVq5Pgr2GrQu,9,7,5,0,3,0,4,0,19,2.7142857142857144,1,0.0,0,5,0,3,7,0,0,4,0,8,11,1
1873,72537,jjKgBLfKr1bgWBjonayzbZy5XgTBUiEC,G8EPVSXsOYB5YQWZGiz1aVq5Pgr2GrQu,5,2,1,0,1,0,3,0,7,1.0,1,0.0,0,1,0,1,2,0,0,3,0,2,5,1
1874,72560,9czpFwHJ3FpE9rgLseKKVivLeSQjwoKI,SpATywNh6bZuzm8s1ceuBUnMUAeoAHHw,5,5,2,0,2,0,1,0,10,1.4285714285714286,1,0.0,0,2,0,2,5,0,0,1,0,4,6,1
1875,72564,R5b7anZZznZcISIbyICZwboB1D1ac57s,SpATywNh6bZuzm8s1ceuBUnMUAeoAHHw,3,2,1,0,0,0,1,0,4,0.5714285714285714,1,0.0,0,1,0,0,2,0,0,1,0,1,3,1
1876,72572,2QSRX6tWhC0oLYllnKUwIH2KIoHl3tDb,SpATywNh6bZuzm8s1ceuBUnMUAeoAHHw,22,33,0,23,0,0,4,0,60,8.571428571428571,2,0.0,13,0,18,0,20,0,5,4,0,31,29,1
1877,72592,yYXy4lOleg47AQUxi7o5Lu77Hx9q6unU,G8EPVSXsOYB5YQWZGiz1aVq5Pgr2GrQu,1,0,0,0,0,0,1,0,1,0.14285714285714285,1,0.0,0,0,0,0,0,0,0,1,0,0,1,1
1878,72621,RDShgnILA5yAnXM7kXsfq5adI49HPdeC,A3fsA9Zfv1X2fVEQhTw51lKENdNrEqT3,5,4,0,0,0,0,2,0,6,0.8571428571428571,1,0.0,0,0,0,0,4,0,0,2,0,0,6,1
1879,72649,rPY59o3LLmGBPTPMGcA5vX57KVfmywv5,A3fsA9Zfv1X2fVEQhTw51lKENdNrEqT3,6,8,1,0,0,2,7,1,19,2.7142857142857144,1,0.0,0,1,0,0,8,2,0,7,1,1,18,1
1880,72667,9FaPBbsYKn0C9myyRYf9vYNhns2eJDpD,A3fsA9Zfv1X2fVEQhTw51lKENdNrEqT3,16,31,14,0,12,0,2,0,59,8.428571428571429,2,0.0,0,14,0,12,31,0,0,2,0,26,33,1
1881,72686,JoqAGqbao71wc04PyVzx7SVvlZZ0knbI,A3fsA9Zfv1X2fVEQhTw51lKENdNrEqT3,2,2,1,0,0,1,0,0,4,0.5714285714285714,1,0.0,0,1,0,0,2,1,0,0,0,1,3,0
1882,72758,IU4mzAYv3AON3EBKGRzZhQZqrR0hM5uu,SpATywNh6bZuzm8s1ceuBUnMUAeoAHHw,5,6,4,0,3,0,3,0,16,2.2857142857142856,2,0.0,1,4,0,3,5,0,0,3,0,8,8,1
1883,72762,Sn4V2T6RAiQ47UvRCtMkFCdxnmF36LZI,SpATywNh6bZuzm8s1ceuBUnMUAeoAHHw,1,0,0,0,0,0,1,0,1,0.14285714285714285,1,0.0,0,0,0,0,0,0,0,1,0,0,1,1
1884,72765,pHhp9CI7VmM6wgR3zr0LKfyfj9hb4ctX,SpATywNh6bZuzm8s1ceuBUnMUAeoAHHw,5,2,0,0,0,1,4,0,7,1.0,1,0.0,0,0,0,0,2,1,0,4,0,0,7,1
1885,72780,DLQjQ8KI2pm8VfJepKRqQrT7eYq3mD8r,RXDvfPUBYFlVdlueBFbLW0mhhAyGEqpt,6,12,7,0,4,0,1,0,24,3.4285714285714284,2,0.0,4,7,0,4,8,0,0,1,0,15,9,0
1886,72812,xgPoMcAyqtOnl7aMAll1Vnr6k8ioz2It,SpATywNh6bZuzm8s1ceuBUnMUAeoAHHw,1,0,0,0,0,0,2,0,2,0.2857142857142857,1,0.0,0,0,0,0,0,0,0,2,0,0,2,1
1887,72815,OvxL2ijquKYfjNqaOR5I9ilNOVFLo0dG,A3fsA9Zfv1X2fVEQhTw51lKENdNrEqT3,2,0,0,0,0,0,4,0,4,0.5714285714285714,1,0.0,0,0,0,0,0,0,0,4,0,0,4,1
1888,72838,JLIulwgtbPcmpwL3Ibb9AniYS6ncpOrp,A3fsA9Zfv1X2fVEQhTw51lKENdNrEqT3,5,0,0,0,0,1,7,0,8,1.1428571428571428,1,0.0,0,0,0,0,0,1,0,7,0,0,8,1
1889,72848,pQdSl7i5ZuZeH9uPILgdHrvwskp4vc4V,bWdj2GDclj5ofokWjzoa5jAwMkxCykd6,7,6,4,0,3,4,2,0,19,2.7142857142857144,2,0.0,0,4,0,3,6,4,0,2,0,7,12,1
1890,72871,3z37iBp19kh1LYVfVTprpt7Nc7WFUSh9,A3fsA9Zfv1X2fVEQhTw51lKENdNrEqT3,23,21,19,0,2,0,4,0,46,6.571428571428571,2,0.0,0,19,0,2,21,0,0,4,0,21,25,1
1891,72904,BaoTOxDWhvejgHTi1F9XwMHc0M9R5At7,SpATywNh6bZuzm8s1ceuBUnMUAeoAHHw,6,1,1,0,1,0,3,0,6,0.8571428571428571,1,0.0,0,1,0,1,1,0,0,3,0,2,4,1
1892,72936,oIV4CHUFSVzLmdvea6ZMZ3tpsiIb8a2U,RXDvfPUBYFlVdlueBFbLW0mhhAyGEqpt,6,4,0,0,0,14,4,9,31,4.428571428571429,1,0.0,0,0,0,0,4,14,0,4,9,0,31,0
1893,72944,lv2TJU2QSmR6ZpD7FaidN3ql3NuYRcZ1,A3fsA9Zfv1X2fVEQhTw51lKENdNrEqT3,8,9,1,0,1,0,5,0,16,2.2857142857142856,1,0.0,0,1,0,1,9,0,0,5,0,2,14,1
1894,72948,DEGiuzhB04pwSFBxNndJCumCtMNBwFrd,A3fsA9Zfv1X2fVEQhTw51lKENdNrEqT3,10,8,4,0,3,0,4,0,19,2.7142857142857144,1,0.0,0,4,0,3,8,0,0,4,0,7,12,1
1895,72966,5bg7aQCg1xT3BNwuorGcguCUDl8W5Lwl,SpATywNh6bZuzm8s1ceuBUnMUAeoAHHw,23,47,1,27,0,6,9,1,91,13.0,2,0.0,16,1,21,0,31,6,6,9,1,38,53,0
1896,72979,6BV17cQBS0vMXReFAexYd9wW7Rs6YIDr,RXDvfPUBYFlVdlueBFbLW0mhhAyGEqpt,2,0,0,0,0,0,2,0,2,0.2857142857142857,1,0.0,0,0,0,0,0,0,0,2,0,0,2,1
1897,72993,N8pR87BNJJZF5Ez15Nl4SeXnB2JbgnGF,SpATywNh6bZuzm8s1ceuBUnMUAeoAHHw,3,2,0,0,0,0,1,0,3,0.42857142857142855,1,0.0,0,0,0,0,2,0,0,1,0,0,3,1
1898,73001,NlHO5hXiy7TmVTHiRgExH6y7p9gJG1YF,A3fsA9Zfv1X2fVEQhTw51lKENdNrEqT3,35,21,19,0,17,0,2,1,60,8.571428571428571,1,0.0,0,19,0,17,21,0,0,2,1,36,24,1
1899,73019,Sle0t5zy0VbRjUdpojBY9wV6zuG12LCM,RXDvfPUBYFlVdlueBFbLW0mhhAyGEqpt,1,0,0,0,0,0,1,0,1,0.14285714285714285,1,0.0,0,0,0,0,0,0,0,1,0,0,1,1
1900,73050,Hj6wuu6IJzCenxWAs1sLyWNMm32YIpDq,SpATywNh6bZuzm8s1ceuBUnMUAeoAHHw,5,2,0,0,0,0,4,0,6,0.8571428571428571,1,0.0,0,0,0,0,2,0,0,4,0,0,6,1
1901,73078,pQJkPXwRF9VuLrQomaax9ecDhBYo49Wz,bWdj2GDclj5ofokWjzoa5jAwMkxCykd6,1,0,0,0,0,0,1,0,1,0.14285714285714285,1,0.0,0,0,0,0,0,0,0,1,0,0,1,0
1902,73079,Oe7zyPdqUKEu4xpqbiVxJiAwdUxxeOQv,bWdj2GDclj5ofokWjzoa5jAwMkxCykd6,7,7,4,0,3,0,4,0,18,2.5714285714285716,2,0.0,0,4,0,3,7,0,0,4,0,7,11,1
1903,73101,AeXY5V6bNirN94d0GfQQQX1fFim1uqSr,SpATywNh6bZuzm8s1ceuBUnMUAeoAHHw,8,20,2,0,0,0,7,0,29,4.142857142857143,3,0.0,2,2,0,0,18,0,0,7,0,4,25,0
1904,73110,TOybu3VTl57Gwz61jxLAAYZF2xYkGB5M,SpATywNh6bZuzm8s1ceuBUnMUAeoAHHw,3,2,1,0,0,0,2,0,5,0.7142857142857143,2,0.0,0,1,0,0,2,0,0,2,0,1,4,1
1905,73115,Zx0bFLnVRMy9krgKUk9lItbN7v3mJCyu,SpATywNh6bZuzm8s1ceuBUnMUAeoAHHw,1,0,0,0,0,0,1,0,1,0.14285714285714285,1,0.0,0,0,0,0,0,0,0,1,0,0,1,1
1906,73116,ikZ5e1jXRpMQVOcFqH67Ve7tNtXOJxoc,bWdj2GDclj5ofokWjzoa5jAwMkxCykd6,3,2,1,0,0,0,2,0,5,0.7142857142857143,1,0.0,0,1,0,0,2,0,0,2,0,1,4,1
1907,73126,ikZ5e1jXRpMQVOcFqH67Ve7tNtXOJxoc,SpATywNh6bZuzm8s1ceuBUnMUAeoAHHw,1,0,0,0,0,0,1,0,1,0.14285714285714285,1,0.0,0,0,0,0,0,0,0,1,0,0,1,1
1908,73144,rSEfJyHxNlxmmbC9ORIbqcFKKq08QDrh,bWdj2GDclj5ofokWjzoa5jAwMkxCykd6,10,30,12,40,6,32,6,0,126,18.0,2,0.0,5,12,39,6,25,32,1,6,0,62,64,0
1909,73159,wZbfkDTJEKLN8i3q2vyR2D63BVy1yfzP,RXDvfPUBYFlVdlueBFbLW0mhhAyGEqpt,1,0,0,0,0,0,1,0,1,0.14285714285714285,1,0.0,0,0,0,0,0,0,0,1,0,0,1,1
1910,73160,bQyVE18uOQgosEkzDxCae8JLEu2KcOfx,bWdj2GDclj5ofokWjzoa5jAwMkxCykd6,16,26,14,26,10,2,5,1,84,12.0,2,0.0,9,14,23,10,17,2,3,5,1,56,28,1
1911,73165,QeAOpQzyLu4fxeYb4rnli0YrGwCr0z5U,RXDvfPUBYFlVdlueBFbLW0mhhAyGEqpt,1,0,0,0,0,0,1,0,1,0.14285714285714285,1,0.0,0,0,0,0,0,0,0,1,0,0,1,1
1912,73170,afdo7sttc7aaNvz9ca7YCfhlkfRUdKCm,A3fsA9Zfv1X2fVEQhTw51lKENdNrEqT3,1,0,0,0,0,0,1,0,1,0.14285714285714285,1,0.0,0,0,0,0,0,0,0,1,0,0,1,1
1913,73504,50aSuabL02e7lLNBHTRXsMQnBChV2lSX,fbPkOYLVPtPgIt0MxizjfFJov3JbHyAi,4,3,1,0,0,0,1,0,5,0.7142857142857143,1,0.0,0,1,0,0,3,0,0,1,0,1,4,1
1914,73543,qCHnpaFMgw6f0BW7hG9Qa9zJ3b9yr9G8,fbPkOYLVPtPgIt0MxizjfFJov3JbHyAi,5,0,0,0,0,1,10,4,15,2.142857142857143,1,0.0,0,0,0,0,0,1,0,10,4,0,15,1
1915,73953,7VDn6ntyPpx1GsPLNVgZQF03WDWTuKJo,bWdj2GDclj5ofokWjzoa5jAwMkxCykd6,6,7,5,0,0,0,2,0,14,2.0,1,0.0,0,5,0,0,7,0,0,2,0,5,9,0
1916,73959,UNKWHkTsZ3RudPGKkhB4ao4XLNWXegZ9,7GRhBDsirIGkRZBtSMEzNTyDr2JQm4xx,8,11,0,0,3,0,2,0,16,2.2857142857142856,2,0.0,5,0,0,3,6,0,0,2,0,8,8,1
1917,73998,ej4gQoO7wYuk4hf1qDoakX8UCNofUE33,SpATywNh6bZuzm8s1ceuBUnMUAeoAHHw,4,2,1,0,0,0,3,0,6,0.8571428571428571,1,0.0,0,1,0,0,2,0,0,3,0,1,5,1
1918,74104,7TkkuA0EEQqi6jLSaHSvDaS7U5kNSv36,SpATywNh6bZuzm8s1ceuBUnMUAeoAHHw,17,25,13,10,2,8,7,1,66,9.428571428571429,1,0.0,4,13,9,2,21,8,1,7,1,28,38,0
1919,74300,MgS6WK9esRya9QyP2ZOjbNdLSIL7NuM9,SpATywNh6bZuzm8s1ceuBUnMUAeoAHHw,19,33,17,26,3,0,6,0,85,12.142857142857142,2,0.0,12,17,22,3,21,0,4,6,0,54,31,0
1920,74301,WCAIb19YcAzAlp07XtATiiwpdzMqbAbp,7GRhBDsirIGkRZBtSMEzNTyDr2JQm4xx,27,23,10,40,7,0,1,0,81,11.571428571428571,1,0.0,12,10,36,7,11,0,4,1,0,65,16,0
1921,74529,YfLkHn3sP8pusiYlKK6o5F2jXKBNkL8d,SpATywNh6bZuzm8s1ceuBUnMUAeoAHHw,17,26,14,8,5,0,5,0,58,8.285714285714286,4,0.0,5,14,8,5,21,0,0,5,0,32,26,0
1922,74608,U3R4m4eLMm2lirgI7HLueBKsNpxhFpn9,7GRhBDsirIGkRZBtSMEzNTyDr2JQm4xx,28,32,19,30,4,0,4,0,89,12.714285714285714,2,0.0,12,19,30,4,20,0,0,4,0,65,24,1
1923,74611,oulkc1tf0Kd1NPyUx3LDpZLt1fzzxHYa,SpATywNh6bZuzm8s1ceuBUnMUAeoAHHw,5,5,0,0,0,0,2,0,7,1.0,1,0.0,0,0,0,0,5,0,0,2,0,0,7,1
1924,74653,HL0jm7zWkHTTtUFklIJxsfljBDgcIEre,SpATywNh6bZuzm8s1ceuBUnMUAeoAHHw,8,12,1,18,0,0,1,0,32,4.571428571428571,1,0.0,7,1,15,0,5,0,3,1,0,23,9,1
1925,74717,tBy7E7qZZZ98Oih5sTNUdDZRIpZZM98z,SpATywNh6bZuzm8s1ceuBUnMUAeoAHHw,4,5,4,0,0,0,4,0,13,1.8571428571428572,2,0.0,0,4,0,0,5,0,0,4,0,4,9,0
1926,74733,nd2ZHSI1Tvo1sLaItC7AKiAwHujqev1a,SpATywNh6bZuzm8s1ceuBUnMUAeoAHHw,10,7,1,2,1,0,4,0,15,2.142857142857143,1,0.0,0,1,2,1,7,0,0,4,0,4,11,1
1927,74836,lFMbkCaY0FKfyGbh1VOL30jTZ1USVgB2,G8EPVSXsOYB5YQWZGiz1aVq5Pgr2GrQu,2,1,0,0,0,0,1,0,2,0.2857142857142857,1,0.0,0,0,0,0,1,0,0,1,0,0,2,1
1928,74841,lFMbkCaY0FKfyGbh1VOL30jTZ1USVgB2,RXDvfPUBYFlVdlueBFbLW0mhhAyGEqpt,10,6,5,0,3,6,1,0,21,3.0,1,0.0,0,5,0,3,6,6,0,1,0,8,13,0
1929,74918,Y0dbTriNAgSzbrnkzFHfTSZPt5kDzGfo,SpATywNh6bZuzm8s1ceuBUnMUAeoAHHw,13,17,1,10,1,0,1,0,30,4.285714285714286,1,0.0,5,1,9,1,12,0,1,1,0,16,14,0
1930,74935,7n6VTEPIznuedo1nynk3WFAbvlKYIs72,SpATywNh6bZuzm8s1ceuBUnMUAeoAHHw,6,4,3,0,3,0,1,0,11,1.5714285714285714,1,0.0,0,3,0,3,4,0,0,1,0,6,5,0
1931,75054,dtbXtMjPqeEvzoZBFe2y9uSDcjL0lnx2,RXDvfPUBYFlVdlueBFbLW0mhhAyGEqpt,3,4,0,0,0,9,2,0,15,2.142857142857143,2,0.0,0,0,0,0,4,9,0,2,0,0,15,0
1932,75113,5EOGhyHOLLtbW0eEa8Dnfl5My4kdYkdc,SpATywNh6bZuzm8s1ceuBUnMUAeoAHHw,1,0,0,0,0,0,2,0,2,0.2857142857142857,2,0.0,0,0,0,0,0,0,0,2,0,0,2,0
1933,75206,ZXWRS3Ah3Q3TKxtUJXxAAlsPTxzCg1Vz,SpATywNh6bZuzm8s1ceuBUnMUAeoAHHw,5,7,2,2,0,0,1,0,12,1.7142857142857142,1,0.0,4,2,1,0,3,0,1,1,0,7,5,0
1934,75508,RHl3DsvAX7TisJ7qBptmgrrtDAQvH7mr,bWdj2GDclj5ofokWjzoa5jAwMkxCykd6,13,21,15,0,4,5,6,0,51,7.285714285714286,1,0.0,1,15,0,4,20,5,0,6,0,20,31,1
1935,75599,yBKc8UQ3yoU6nYnfaJz62fH80CgKFtOX,SpATywNh6bZuzm8s1ceuBUnMUAeoAHHw,17,12,7,15,4,0,2,0,40,5.714285714285714,1,0.0,4,7,12,4,8,0,3,2,0,27,13,0
1936,75673,I6LvRAT5lrglfRc7HjtOiHjECPtrYMcD,SpATywNh6bZuzm8s1ceuBUnMUAeoAHHw,5,3,2,0,2,0,2,0,9,1.2857142857142858,1,0.0,0,2,0,2,3,0,0,2,0,4,5,1
1937,75699,88AD1l4wNMBju3FfWmP2xvwRYAECtTFg,A3fsA9Zfv1X2fVEQhTw51lKENdNrEqT3,4,2,1,0,1,0,3,0,7,1.0,1,0.0,0,1,0,1,2,0,0,3,0,2,5,1
1938,75792,dhPF0MOUpHT5OZTFAONgRdkH1ZwnZtFz,SpATywNh6bZuzm8s1ceuBUnMUAeoAHHw,15,13,5,12,3,0,3,0,36,5.142857142857143,1,0.0,8,5,12,3,5,0,0,3,0,28,8,0
1939,75950,vRfp4R3Ka5ikFbaOY5bQDke3cTfTq6Oz,RXDvfPUBYFlVdlueBFbLW0mhhAyGEqpt,14,11,1,0,1,9,7,2,31,4.428571428571429,2,0.0,0,1,0,1,11,9,0,7,2,2,29,0
1940,75955,m1ZHf0Vy9SZyKEONoAW39ljflZCTH7Li,bWdj2GDclj5ofokWjzoa5jAwMkxCykd6,7,1,1,0,1,1,6,1,11,1.5714285714285714,1,0.0,0,1,0,1,1,1,0,6,1,2,9,1
1941,75969,8Dno8ERd119JayTOKlG7uDmGtkfLJOke,SpATywNh6bZuzm8s1ceuBUnMUAeoAHHw,1,0,0,0,0,0,1,0,1,0.14285714285714285,1,0.0,0,0,0,0,0,0,0,1,0,0,1,0
1942,75980,mDHr8WvVVX9KSvXMqxtLvZ6vP4uuNF6E,A3fsA9Zfv1X2fVEQhTw51lKENdNrEqT3,4,5,1,0,0,0,1,0,7,1.0,2,0.0,2,1,0,0,3,0,0,1,0,3,4,1
1943,76038,6RuWsSvS3Ngnjl37PzNAaaGn8Jd9a1lW,bWdj2GDclj5ofokWjzoa5jAwMkxCykd6,9,15,9,0,8,0,6,0,38,5.428571428571429,3,0.0,0,9,0,8,15,0,0,6,0,17,21,0
1944,76119,FXen1VSms29mqypmBsJLgiCW5lwzRuUO,7GRhBDsirIGkRZBtSMEzNTyDr2JQm4xx,5,2,1,0,1,0,4,0,8,1.1428571428571428,2,0.0,0,1,0,1,2,0,0,4,0,2,6,1
1945,76252,BCPhbcVTukJPsOtUJJbyOWvpso8GiEV1,A3fsA9Zfv1X2fVEQhTw51lKENdNrEqT3,7,3,2,0,2,0,2,0,9,1.2857142857142858,1,0.0,0,2,0,2,3,0,0,2,0,4,5,1
1946,76261,wzJUcvl4LpGNAis186Xl9ztjI1WNWkac,bWdj2GDclj5ofokWjzoa5jAwMkxCykd6,6,5,1,0,1,1,4,0,12,1.7142857142857142,1,0.0,2,1,0,1,3,1,0,4,0,4,8,1
1947,76370,LjHLegep3fnzz3EMIdyj4iJ3mzoK4FmA,7GRhBDsirIGkRZBtSMEzNTyDr2JQm4xx,2,0,0,0,0,0,2,0,2,0.2857142857142857,1,0.0,0,0,0,0,0,0,0,2,0,0,2,1
1948,76965,RVwSAHxCpXjdqkEsoVeRRSWT7FKnXTih,7GRhBDsirIGkRZBtSMEzNTyDr2JQm4xx,5,2,1,0,1,0,3,0,7,1.0,1,0.0,0,1,0,1,2,0,0,3,0,2,5,1
1949,76990,OdMr7dE5UlAme9Tp979vREBvY5CV50po,7GRhBDsirIGkRZBtSMEzNTyDr2JQm4xx,34,27,21,2,21,0,4,0,75,10.714285714285714,2,0.0,3,21,2,21,24,0,0,4,0,47,28,1
1950,77027,BCR9Csw9e3gBBos2x8J4HYYW5Gara6WV,7GRhBDsirIGkRZBtSMEzNTyDr2JQm4xx,1,0,0,0,0,0,1,0,1,0.14285714285714285,1,0.0,0,0,0,0,0,0,0,1,0,0,1,1
1951,77032,KPMkMHpUZOSbFRkwKqywhwm1W34kGRsr,7GRhBDsirIGkRZBtSMEzNTyDr2JQm4xx,5,2,1,0,1,0,2,0,6,0.8571428571428571,1,0.0,0,1,0,1,2,0,0,2,0,2,4,1
1952,77044,bikkCYRyUxervPNSkXQBtcADPD3aMEN1,7GRhBDsirIGkRZBtSMEzNTyDr2JQm4xx,1,0,0,0,0,0,1,0,1,0.14285714285714285,1,0.0,0,0,0,0,0,0,0,1,0,0,1,1
1953,77126,qg6GOCuPcDwehPMMAEed7GZuAdyiaV9B,7GRhBDsirIGkRZBtSMEzNTyDr2JQm4xx,26,61,7,17,10,0,9,0,104,14.857142857142858,4,0.0,23,7,13,10,38,0,4,9,0,53,51,1
1954,77291,lQduia23vRF72bXB1H9gO7pdoAy9qGnz,fbPkOYLVPtPgIt0MxizjfFJov3JbHyAi,1,0,0,0,0,0,1,0,1,0.14285714285714285,1,0.0,0,0,0,0,0,0,0,1,0,0,1,1
1955,77850,embp7e5rTedl4SQPXvv0NKkthNGlazF4,SpATywNh6bZuzm8s1ceuBUnMUAeoAHHw,4,2,1,0,0,0,3,0,6,0.8571428571428571,2,0.0,0,1,0,0,2,0,0,3,0,1,5,0
1956,77861,j6kVkVGKYZT7ozL2NE5rOIexD3a1ewYn,SpATywNh6bZuzm8s1ceuBUnMUAeoAHHw,8,8,4,12,0,0,1,0,25,3.5714285714285716,1,0.0,2,4,12,0,6,0,0,1,0,18,7,1
1957,77887,H6fuaLg1W7r0yBwU0d54zcjFYdRqOb7F,G8EPVSXsOYB5YQWZGiz1aVq5Pgr2GrQu,3,0,0,0,0,2,3,0,5,0.7142857142857143,1,0.0,0,0,0,0,0,2,0,3,0,0,5,1
1958,77899,hzFAznB2sXwDzCFipnygLE0hHHIOs6xS,SpATywNh6bZuzm8s1ceuBUnMUAeoAHHw,5,4,2,0,1,0,2,0,9,1.2857142857142858,1,0.0,0,2,0,1,4,0,0,2,0,3,6,1
1959,77902,k6QLpQDqSxoScgN883dLN4OsoeXNCHXO,A3fsA9Zfv1X2fVEQhTw51lKENdNrEqT3,34,11,9,42,6,0,1,0,69,9.857142857142858,1,0.0,1,9,40,6,10,0,2,1,0,56,13,1
1960,77929,0RJFDjD2CVBIyw0gHM4auA9R2PVZlVls,A3fsA9Zfv1X2fVEQhTw51lKENdNrEqT3,1,0,0,0,0,0,2,0,2,0.2857142857142857,1,0.0,0,0,0,0,0,0,0,2,0,0,2,1
1961,77930,I0nVBKgpf6bHOhRUWavCqORVydlrPxcM,SpATywNh6bZuzm8s1ceuBUnMUAeoAHHw,18,19,12,21,9,37,14,3,115,16.428571428571427,2,0.0,7,12,16,9,12,37,5,14,3,44,71,1
1962,77938,OzLs7gFwYfouUVXwjEfaGoBWiTah7ale,SpATywNh6bZuzm8s1ceuBUnMUAeoAHHw,5,2,0,0,0,0,3,0,5,0.7142857142857143,1,0.0,0,0,0,0,2,0,0,3,0,0,5,1
1963,77948,HAqiq102XDB03bRDdmGODD1MUBTXSItL,G8EPVSXsOYB5YQWZGiz1aVq5Pgr2GrQu,7,4,3,0,2,0,1,0,10,1.4285714285714286,1,0.0,0,3,0,2,4,0,0,1,0,5,5,1
1964,77985,2F24CPGRVpuuQV8bvAX6eV5uD1OH1Kpn,G8EPVSXsOYB5YQWZGiz1aVq5Pgr2GrQu,56,80,29,112,17,23,16,2,279,39.857142857142854,2,0.0,42,29,74,17,38,23,38,16,2,162,117,0
1965,78018,fy5xZE2F1NUrBRDmEbdeJaWR2l3rL5ig,SpATywNh6bZuzm8s1ceuBUnMUAeoAHHw,1,0,0,0,0,0,1,0,1,0.14285714285714285,1,0.0,0,0,0,0,0,0,0,1,0,0,1,1
1966,78064,SfR30NvxnwHQ5GQOQOoN6OMoANxaB8dS,SpATywNh6bZuzm8s1ceuBUnMUAeoAHHw,5,4,3,0,1,0,2,0,10,1.4285714285714286,1,0.0,0,3,0,1,4,0,0,2,0,4,6,0
1967,78070,QohXbMcmvW7RNSJxfmP5GzKeuaXyUolt,A3fsA9Zfv1X2fVEQhTw51lKENdNrEqT3,2,0,0,0,0,0,2,0,2,0.2857142857142857,1,0.0,0,0,0,0,0,0,0,2,0,0,2,1
1968,78073,ccbXVA4l2WmbAoIr2ZeJIfHBbUkKPKY8,SpATywNh6bZuzm8s1ceuBUnMUAeoAHHw,5,3,2,0,0,0,2,0,7,1.0,1,0.0,0,2,0,0,3,0,0,2,0,2,5,1
1969,78076,QohXbMcmvW7RNSJxfmP5GzKeuaXyUolt,bWdj2GDclj5ofokWjzoa5jAwMkxCykd6,2,0,0,0,0,0,2,0,2,0.2857142857142857,1,0.0,0,0,0,0,0,0,0,2,0,0,2,1
1970,78085,EBk1CmtgbTvc4xbs4Wf7K9jFvWEzLY93,SpATywNh6bZuzm8s1ceuBUnMUAeoAHHw,4,2,0,0,0,0,2,0,4,0.5714285714285714,1,0.0,0,0,0,0,2,0,0,2,0,0,4,1
1971,78106,hu8eak1Xmf8voE8pnxPzkSD2dZP9Sipf,bWdj2GDclj5ofokWjzoa5jAwMkxCykd6,2,0,0,0,0,0,5,0,5,0.7142857142857143,2,0.0,0,0,0,0,0,0,0,5,0,0,5,0
1972,78107,UuDjs68Ty88iPLGMXsqZ9bEqUXmWG3bB,RXDvfPUBYFlVdlueBFbLW0mhhAyGEqpt,5,2,1,0,1,0,2,0,6,0.8571428571428571,1,0.0,0,1,0,1,2,0,0,2,0,2,4,1
1973,78131,TCKPmzjJvJ3IQnj25q0Ug4x7iyC4opM1,G8EPVSXsOYB5YQWZGiz1aVq5Pgr2GrQu,10,39,6,10,7,0,2,0,64,9.142857142857142,1,0.0,31,6,7,7,8,0,3,2,0,51,13,1
1974,78134,CNb0Sul2DOkX3VhMOeM6DWqvlrGgHagf,SpATywNh6bZuzm8s1ceuBUnMUAeoAHHw,13,20,9,22,4,0,2,0,57,8.142857142857142,2,0.0,7,9,19,4,13,0,3,2,0,39,18,1
1975,78144,GcwFf1WfRMSdZDYsPn5itkdYlvMUCmT9,SpATywNh6bZuzm8s1ceuBUnMUAeoAHHw,14,21,1,10,1,0,1,0,34,4.857142857142857,2,0.0,4,1,9,1,17,0,1,1,0,15,19,0
1976,78146,sFLCac725cSrEUin5pNRyKxt7gjQ6A4F,SpATywNh6bZuzm8s1ceuBUnMUAeoAHHw,1,0,0,0,0,0,1,0,1,0.14285714285714285,1,0.0,0,0,0,0,0,0,0,1,0,0,1,1
1977,78150,fohEc7UwYR3csB1Bpgdq1GKT1TmpT3GW,RXDvfPUBYFlVdlueBFbLW0mhhAyGEqpt,6,3,1,0,0,1,7,0,12,1.7142857142857142,1,0.0,0,1,0,0,3,1,0,7,0,1,11,1
1978,78188,CNb0Sul2DOkX3VhMOeM6DWqvlrGgHagf,bWdj2GDclj5ofokWjzoa5jAwMkxCykd6,5,3,2,0,1,0,1,0,7,1.0,1,0.0,0,2,0,1,3,0,0,1,0,3,4,1
1979,78247,BLoa1RvSOgexbSH4hGzCihmBc8pXd0Db,A3fsA9Zfv1X2fVEQhTw51lKENdNrEqT3,37,50,2,52,1,0,4,0,109,15.571428571428571,3,0.0,1,2,44,1,49,0,8,4,0,48,61,1
1980,78252,CWfEuozBd4liyBTvOMVgNSWJo0S8l1jG,bWdj2GDclj5ofokWjzoa5jAwMkxCykd6,5,2,1,0,1,0,2,0,6,0.8571428571428571,1,0.0,0,1,0,1,2,0,0,2,0,2,4,1
1981,78259,qrEmM3cwwlnfXom63xX0BSDx8s5nHv9K,bWdj2GDclj5ofokWjzoa5jAwMkxCykd6,2,0,0,0,0,0,2,0,2,0.2857142857142857,1,0.0,0,0,0,0,0,0,0,2,0,0,2,1
1982,78275,FVKs2RoZnz9qxmMnghcMqKWH7KjgxJV1,RXDvfPUBYFlVdlueBFbLW0mhhAyGEqpt,7,4,3,0,2,0,1,0,10,1.4285714285714286,1,0.0,0,3,0,2,4,0,0,1,0,5,5,1
1983,78278,VtX4hhecWicdXYhNKnhWUU7LwsYiud5S,bWdj2GDclj5ofokWjzoa5jAwMkxCykd6,1,0,0,0,0,0,1,0,1,0.14285714285714285,1,0.0,0,0,0,0,0,0,0,1,0,0,1,1
1984,78291,eIz1QdRrhcYteukRLgOlTi2GZdnEpdtj,A3fsA9Zfv1X2fVEQhTw51lKENdNrEqT3,4,2,0,0,0,0,2,0,4,0.5714285714285714,1,0.0,0,0,0,0,2,0,0,2,0,0,4,1
1985,78294,kj5o7wMZl1s4q0cggcmipnm7O7L6g4Ps,bWdj2GDclj5ofokWjzoa5jAwMkxCykd6,14,17,8,32,4,7,4,0,72,10.285714285714286,2,0.0,4,8,30,4,13,7,2,4,0,46,26,0
1986,78328,VhJqWY1s8NggIUb1uIcah3mgkAeL4PFu,G8EPVSXsOYB5YQWZGiz1aVq5Pgr2GrQu,1,0,0,0,0,0,1,0,1,0.14285714285714285,1,0.0,0,0,0,0,0,0,0,1,0,0,1,1
1987,78356,l8Cml1vejHI8GVsgohdNxJJsxeTOpjUQ,SpATywNh6bZuzm8s1ceuBUnMUAeoAHHw,6,5,4,0,0,0,1,0,10,1.4285714285714286,1,0.0,0,4,0,0,5,0,0,1,0,4,6,1
1988,78364,v6o58htBZfIjF729xn3THeVFCKiQP2tT,G8EPVSXsOYB5YQWZGiz1aVq5Pgr2GrQu,14,14,2,0,2,2,4,1,25,3.5714285714285716,2,0.0,1,2,0,2,13,2,0,4,1,5,20,1
1989,78367,DC7ZPAOAq4kNVVbfZX7lyJLqoL2DWXgr,SpATywNh6bZuzm8s1ceuBUnMUAeoAHHw,7,9,5,0,4,0,2,0,20,2.857142857142857,1,0.0,0,5,0,4,9,0,0,2,0,9,11,1
1990,78379,J4Fo8v0uo0dR8AKSqg2SMkO8YLPwA09H,G8EPVSXsOYB5YQWZGiz1aVq5Pgr2GrQu,1,0,0,0,0,0,4,0,4,0.5714285714285714,1,0.0,0,0,0,0,0,0,0,4,0,0,4,1
1991,78385,dovSPYooNHmzLLH97Ddy4FG7Uxhw5XJl,SpATywNh6bZuzm8s1ceuBUnMUAeoAHHw,4,4,0,0,0,0,2,0,6,0.8571428571428571,1,0.0,0,0,0,0,4,0,0,2,0,0,6,1
1992,78406,fsn9YvLK8wuINxunCG4BkE8FOh4c3KxI,SpATywNh6bZuzm8s1ceuBUnMUAeoAHHw,7,8,0,0,0,0,1,0,9,1.2857142857142858,1,0.0,2,0,0,0,6,0,0,1,0,2,7,1
1993,78429,HLfj9ZxtIK3gYbcHFCAqaNCGqWLq7h1g,SpATywNh6bZuzm8s1ceuBUnMUAeoAHHw,24,28,1,32,0,4,10,2,77,11.0,1,0.0,9,1,29,0,19,4,3,10,2,39,38,0
1994,78452,ukfWsseqqJzHHxAFnLMKYh1SZzExeQ1z,SpATywNh6bZuzm8s1ceuBUnMUAeoAHHw,5,5,1,0,0,0,2,0,8,1.1428571428571428,2,0.0,0,1,0,0,5,0,0,2,0,1,7,1
1995,78454,4N9xQarXAZMYyOjOJvMQmOHnVfoe0iL0,bWdj2GDclj5ofokWjzoa5jAwMkxCykd6,5,2,1,0,1,0,2,0,6,0.8571428571428571,1,0.0,0,1,0,1,2,0,0,2,0,2,4,1
1996,78462,4N9xQarXAZMYyOjOJvMQmOHnVfoe0iL0,A3fsA9Zfv1X2fVEQhTw51lKENdNrEqT3,2,0,0,0,0,0,2,0,2,0.2857142857142857,1,0.0,0,0,0,0,0,0,0,2,0,0,2,1
1997,78478,CVkN7W2203PPB4rzsX0i8SBpQ0bSRkaq,SpATywNh6bZuzm8s1ceuBUnMUAeoAHHw,12,14,9,0,5,0,2,0,30,4.285714285714286,2,0.0,2,9,0,5,12,0,0,2,0,16,14,1
1998,78546,Ckb71Ev9RlsIUvVDfkFS0AumQJilppvB,G8EPVSXsOYB5YQWZGiz1aVq5Pgr2GrQu,6,3,2,0,1,0,2,0,8,1.1428571428571428,1,0.0,0,2,0,1,3,0,0,2,0,3,5,1
1999,78552,J3O8yjXr4pvdR3n8Y9AW4odHeMijwVD2,bWdj2GDclj5ofokWjzoa5jAwMkxCykd6,1,0,0,0,0,0,1,0,1,0.14285714285714285,1,0.0,0,0,0,0,0,0,0,1,0,0,1,1
2000,78554,byxGWUJV72XqYw0RcV5v8EuZ9oh6gief,A3fsA9Zfv1X2fVEQhTw51lKENdNrEqT3,5,2,1,0,1,0,2,0,6,0.8571428571428571,1,0.0,0,1,0,1,2,0,0,2,0,2,4,1
2001,78563,Q0vBzPj4VWPVd7xoAbS8zktOTeProdeI,SpATywNh6bZuzm8s1ceuBUnMUAeoAHHw,3,0,0,0,0,0,3,0,3,0.42857142857142855,1,0.0,0,0,0,0,0,0,0,3,0,0,3,1
2002,78566,5maEerTJ8LtZeFZwRiLIZfXoq0lcubLt,SpATywNh6bZuzm8s1ceuBUnMUAeoAHHw,6,1,0,0,0,1,5,1,8,1.1428571428571428,1,0.0,0,0,0,0,1,1,0,5,1,0,8,1
2003,78591,W7aaCFsYNegloRh1IlKOwq22jdh9r52p,bWdj2GDclj5ofokWjzoa5jAwMkxCykd6,6,3,2,0,2,0,1,0,8,1.1428571428571428,1,0.0,0,2,0,2,3,0,0,1,0,4,4,1
2004,78603,7u0QfTKQg4itZK9m8foLXkIGwUxxHMsT,SpATywNh6bZuzm8s1ceuBUnMUAeoAHHw,17,18,9,8,4,0,2,0,41,5.857142857142857,2,0.0,7,9,7,4,11,0,1,2,0,27,14,0
2005,78614,nMd49DSNNePu4Cd3bHT7FsqsTOmZl63t,SpATywNh6bZuzm8s1ceuBUnMUAeoAHHw,6,4,1,0,1,0,3,0,9,1.2857142857142858,1,0.0,0,1,0,1,4,0,0,3,0,2,7,1
2006,78624,QVaNdoLdCHk4HcXO8MB1JKVhy7nw6JiC,SpATywNh6bZuzm8s1ceuBUnMUAeoAHHw,6,4,2,0,2,0,2,0,10,1.4285714285714286,1,0.0,0,2,0,2,4,0,0,2,0,4,6,1
2007,78643,9QoP6HvypJsXUxtVuM29FbJymaoWAuTM,G8EPVSXsOYB5YQWZGiz1aVq5Pgr2GrQu,1,0,0,0,0,0,1,0,1,0.14285714285714285,1,0.0,0,0,0,0,0,0,0,1,0,0,1,1
2008,78648,fjIKsKO6rizBomnPFn2db56S1nui3RlN,A3fsA9Zfv1X2fVEQhTw51lKENdNrEqT3,29,10,6,56,3,1,5,0,81,11.571428571428571,1,0.0,1,6,49,3,9,1,7,5,0,59,22,1
2009,78671,9keXBjwmh66adK5DT8X8J8K1A8xi7IUl,RXDvfPUBYFlVdlueBFbLW0mhhAyGEqpt,2,0,0,0,0,0,2,0,2,0.2857142857142857,1,0.0,0,0,0,0,0,0,0,2,0,0,2,1
2010,78673,Ufo4AkS2vTW82q9Kpcrkrp0gG0Us5zu9,A3fsA9Zfv1X2fVEQhTw51lKENdNrEqT3,6,3,1,0,1,0,2,0,7,1.0,1,0.0,0,1,0,1,3,0,0,2,0,2,5,1
2011,78682,nVXGW3QRysmVp7bseFXpH5xogt6vyuOe,SpATywNh6bZuzm8s1ceuBUnMUAeoAHHw,4,5,2,0,2,0,1,0,10,1.4285714285714286,1,0.0,0,2,0,2,5,0,0,1,0,4,6,1
2012,78705,xXEgWJZrqICodDuxWm4svOQTBLDSu5hO,SpATywNh6bZuzm8s1ceuBUnMUAeoAHHw,7,7,4,0,2,1,4,0,18,2.5714285714285716,1,0.0,1,4,0,2,6,1,0,4,0,7,11,1
2013,78715,5Zgwu2mRcsc21AmNDehMpm5vDwlgKfhs,SpATywNh6bZuzm8s1ceuBUnMUAeoAHHw,3,2,1,0,0,0,1,0,4,0.5714285714285714,1,0.0,0,1,0,0,2,0,0,1,0,1,3,1
2014,78742,rcukprbmUUwwNHHsW6YmnM6VwI4ca3R8,A3fsA9Zfv1X2fVEQhTw51lKENdNrEqT3,14,10,7,0,4,0,6,0,27,3.857142857142857,1,0.0,0,7,0,4,10,0,0,6,0,11,16,0
2015,78786,r62e9eSPsszv1Iv2O1V4lcMcbaHlq1ob,SpATywNh6bZuzm8s1ceuBUnMUAeoAHHw,4,3,1,0,0,0,1,0,5,0.7142857142857143,1,0.0,0,1,0,0,3,0,0,1,0,1,4,0
2016,78791,Jio2hP66Psjw6H7dqS3rSmz5gymQvwGj,SpATywNh6bZuzm8s1ceuBUnMUAeoAHHw,7,6,0,1,0,0,2,0,9,1.2857142857142858,1,0.0,1,0,1,0,5,0,0,2,0,2,7,1
2017,78797,5NRnaGcpNIGEuH61FLOcxB7Rjs6WPiNk,SpATywNh6bZuzm8s1ceuBUnMUAeoAHHw,4,6,3,0,0,0,6,0,15,2.142857142857143,2,0.0,0,3,0,0,6,0,0,6,0,3,12,0
2018,78801,jaHWKFBvrvFfPb0Pq50zaMZ2xpeRooXu,A3fsA9Zfv1X2fVEQhTw51lKENdNrEqT3,1,0,0,0,0,0,1,0,1,0.14285714285714285,1,0.0,0,0,0,0,0,0,0,1,0,0,1,0
2019,78827,BfP8PslkevtFenf019uAk6GhN9zhCFdJ,bWdj2GDclj5ofokWjzoa5jAwMkxCykd6,15,26,11,0,7,1,12,1,58,8.285714285714286,1,0.0,6,11,0,7,20,1,0,12,1,24,34,1
2020,78845,900ZMEgjiXT78JdNbM02wL3ugTz6vLs2,G8EPVSXsOYB5YQWZGiz1aVq5Pgr2GrQu,7,6,1,0,0,0,10,0,17,2.4285714285714284,2,0.0,0,1,0,0,6,0,0,10,0,1,16,1
2021,78848,oZKhsAromYlsN9MhR64yAv55dJDSDM8L,G8EPVSXsOYB5YQWZGiz1aVq5Pgr2GrQu,25,22,12,36,5,0,4,0,79,11.285714285714286,3,0.0,4,12,30,5,18,0,6,4,0,51,28,1
2022,78886,pgMwb3FHEjNb1xNpBTJ5ysmRdBbuUNFr,bWdj2GDclj5ofokWjzoa5jAwMkxCykd6,6,4,1,0,1,0,1,0,7,1.0,1,0.0,0,1,0,1,4,0,0,1,0,2,5,1
2023,78899,XKfrMCVtqlIZ8enVJyGd7DD1q7PXaYx0,RXDvfPUBYFlVdlueBFbLW0mhhAyGEqpt,12,7,1,0,1,1,8,2,20,2.857142857142857,1,0.0,0,1,0,1,7,1,0,8,2,2,18,1
2024,78910,R6RINUtJNooptLfHmBRIBRqFOknkjv0Y,A3fsA9Zfv1X2fVEQhTw51lKENdNrEqT3,13,12,5,0,13,0,7,0,37,5.285714285714286,2,0.0,0,5,0,13,12,0,0,7,0,18,19,1
2025,78918,8Sqo9fjyeTTkNJlQMuecsmvzSyQTiwcU,bWdj2GDclj5ofokWjzoa5jAwMkxCykd6,4,2,0,0,0,0,6,0,8,1.1428571428571428,1,0.0,0,0,0,0,2,0,0,6,0,0,8,1
2026,78924,E96VmAw6m1AOHRckdqiq2ASKbnHBlpAb,bWdj2GDclj5ofokWjzoa5jAwMkxCykd6,1,0,0,0,0,0,3,0,3,0.42857142857142855,3,0.0,0,0,0,0,0,0,0,3,0,0,3,1
2027,78930,E96VmAw6m1AOHRckdqiq2ASKbnHBlpAb,G8EPVSXsOYB5YQWZGiz1aVq5Pgr2GrQu,5,3,1,0,1,0,3,0,8,1.1428571428571428,2,0.0,0,1,0,1,3,0,0,3,0,2,6,0
2028,78943,9V8VFOZzrHxUcwRnnOPkl8rtMgpamwhU,SpATywNh6bZuzm8s1ceuBUnMUAeoAHHw,21,12,9,10,6,0,2,0,39,5.571428571428571,2,0.0,2,9,9,6,10,0,1,2,0,26,13,1
2029,78953,AZZvRPcRkLSa6vwofzfwsEULTUhiKy0E,SpATywNh6bZuzm8s1ceuBUnMUAeoAHHw,5,13,1,0,0,0,8,0,22,3.142857142857143,3,0.0,0,1,0,0,13,0,0,8,0,1,21,0
2030,78954,NTiEDRwIJDqquqeFtNjQXUg4Zc46ytbZ,A3fsA9Zfv1X2fVEQhTw51lKENdNrEqT3,6,3,1,0,1,0,2,0,7,1.0,1,0.0,0,1,0,1,3,0,0,2,0,2,5,1
2031,78971,d1mccaMvv72HL0M2QdKzu9aosPAbZ4Jm,SpATywNh6bZuzm8s1ceuBUnMUAeoAHHw,12,21,0,9,0,0,1,0,31,4.428571428571429,2,0.0,2,0,9,0,19,0,0,1,0,11,20,0
2032,78976,lcVqjHqBHtoTMy2BSyBnlkYx5IiPAsSb,bWdj2GDclj5ofokWjzoa5jAwMkxCykd6,7,3,2,0,2,0,2,0,9,1.2857142857142858,1,0.0,0,2,0,2,3,0,0,2,0,4,5,1
2033,79024,PK7vOojKKM8ZMg0GtBGDF9d0jIW1oXVZ,RXDvfPUBYFlVdlueBFbLW0mhhAyGEqpt,28,35,23,41,11,4,7,2,123,17.571428571428573,2,0.0,6,23,36,11,29,4,5,7,2,76,47,1
2034,79034,BvXEJOM5AeibxeBR17cOLsAehRuv6EQw,SpATywNh6bZuzm8s1ceuBUnMUAeoAHHw,6,3,2,0,2,0,1,0,8,1.1428571428571428,1,0.0,0,2,0,2,3,0,0,1,0,4,4,1
2035,79037,RMjCtTkNaNDIV51mcacmsIEv4W4wGcOW,RXDvfPUBYFlVdlueBFbLW0mhhAyGEqpt,5,2,1,0,1,0,2,0,6,0.8571428571428571,1,0.0,0,1,0,1,2,0,0,2,0,2,4,1
2036,79065,0baA6sMZRRooPzlc3eqoVKOLHs7oBMf1,SpATywNh6bZuzm8s1ceuBUnMUAeoAHHw,1,0,0,0,0,0,1,0,1,0.14285714285714285,1,0.0,0,0,0,0,0,0,0,1,0,0,1,1
2037,79085,jByBG50ghoSer5UP92qpkAfDGFpraaH7,RXDvfPUBYFlVdlueBFbLW0mhhAyGEqpt,2,0,0,0,0,0,2,0,2,0.2857142857142857,1,0.0,0,0,0,0,0,0,0,2,0,0,2,1
2038,79088,oA5bEHkRJtiDJKnesmAjUtrhTVSOkHe2,SpATywNh6bZuzm8s1ceuBUnMUAeoAHHw,15,19,10,14,4,0,4,0,51,7.285714285714286,2,0.0,6,10,13,4,13,0,1,4,0,33,18,1
2039,79114,oBHfkEBZPsjUqPWXyw1yW9Gipn9KMPDQ,SpATywNh6bZuzm8s1ceuBUnMUAeoAHHw,5,5,2,0,1,0,1,0,9,1.2857142857142858,1,0.0,0,2,0,1,5,0,0,1,0,3,6,1
2040,79115,DGHGkVhiaZ33J21HoxaqqxRbqavzVFGk,A3fsA9Zfv1X2fVEQhTw51lKENdNrEqT3,10,16,1,0,1,0,5,0,23,3.2857142857142856,1,0.0,0,1,0,1,16,0,0,5,0,2,21,1
2041,79116,oeEXBADlWmjYmDN9P4tzDfKaayj6OdaD,G8EPVSXsOYB5YQWZGiz1aVq5Pgr2GrQu,7,6,3,0,1,0,3,0,13,1.8571428571428572,1,0.0,0,3,0,1,6,0,0,3,0,4,9,1
2042,79128,Ph6B1QAiUfnOFxg1hNL5nD7wXbSCaM6i,G8EPVSXsOYB5YQWZGiz1aVq5Pgr2GrQu,30,28,23,44,11,0,16,2,124,17.714285714285715,2,0.0,0,23,38,11,28,0,6,16,2,72,52,1
2043,79150,1anSA7G3nrsDO0JSarewPnqCvjcLjtpi,SpATywNh6bZuzm8s1ceuBUnMUAeoAHHw,10,21,8,4,2,0,6,0,41,5.857142857142857,3,0.0,0,8,4,2,21,0,0,6,0,14,27,0
2044,79164,wGfXRYqHkdAo1fVEEY9NvW8qy6M9m0mI,A3fsA9Zfv1X2fVEQhTw51lKENdNrEqT3,11,27,14,0,8,26,8,0,83,11.857142857142858,2,0.0,1,14,0,8,26,26,0,8,0,23,60,1
2045,79191,xjuSmklePl6doFxX117CjHgupR8gIiqr,G8EPVSXsOYB5YQWZGiz1aVq5Pgr2GrQu,6,5,1,0,1,0,3,0,10,1.4285714285714286,1,0.0,0,1,0,1,5,0,0,3,0,2,8,1
2046,79208,88xoeZRrDqjjjrf57zHp7JPU0EIVMG6O,SpATywNh6bZuzm8s1ceuBUnMUAeoAHHw,3,2,0,0,0,0,1,0,3,0.42857142857142855,1,0.0,0,0,0,0,2,0,0,1,0,0,3,1
2047,79213,kuV0mzlgGFUIK4wXcwcPFRatONM4P10L,SpATywNh6bZuzm8s1ceuBUnMUAeoAHHw,15,24,10,23,1,0,7,0,65,9.285714285714286,3,0.0,9,10,18,1,15,0,5,7,0,38,27,0
2048,79232,SSC60v48DtGYrHD9najK5BurQrkLKWXS,SpATywNh6bZuzm8s1ceuBUnMUAeoAHHw,1,0,0,0,0,0,1,0,1,0.14285714285714285,1,0.0,0,0,0,0,0,0,0,1,0,0,1,1
2049,79265,V1B34PKYcESnicIbQVUA4gpuU2uOqNWz,bWdj2GDclj5ofokWjzoa5jAwMkxCykd6,6,10,4,0,1,0,2,0,17,2.4285714285714284,1,0.0,2,4,0,1,8,0,0,2,0,7,10,1
2050,79268,V1B34PKYcESnicIbQVUA4gpuU2uOqNWz,SpATywNh6bZuzm8s1ceuBUnMUAeoAHHw,4,1,1,0,0,1,2,0,5,0.7142857142857143,1,0.0,0,1,0,0,1,1,0,2,0,1,4,1
2051,79269,1bKMONcV6Mq58szdlIajPdFyqaw4BvrA,bWdj2GDclj5ofokWjzoa5jAwMkxCykd6,5,2,1,0,1,0,2,0,6,0.8571428571428571,1,0.0,0,1,0,1,2,0,0,2,0,2,4,1
2052,79274,aS1MRv3e3cFJbWfbj7uedfCUW4ml1QfE,SpATywNh6bZuzm8s1ceuBUnMUAeoAHHw,18,29,20,6,8,0,8,0,71,10.142857142857142,3,0.0,2,20,5,8,27,0,1,8,0,35,36,0
2053,79296,q84ghl694GzSAMHfGeDgZUVdIow6vpJO,SpATywNh6bZuzm8s1ceuBUnMUAeoAHHw,13,19,9,4,6,0,1,0,39,5.571428571428571,2,0.0,8,9,4,6,11,0,0,1,0,27,12,1
2054,79317,9L22i5qdoV8PU8pyjQgR5HeuxRCoRVpK,SpATywNh6bZuzm8s1ceuBUnMUAeoAHHw,24,44,25,15,14,0,7,0,105,15.0,3,0.0,0,25,13,14,44,0,2,7,0,52,53,1
2055,79322,b9hN1tjIpM67gB8PuwPQ3u561lqo1V2f,RXDvfPUBYFlVdlueBFbLW0mhhAyGEqpt,3,1,1,0,1,0,0,0,3,0.42857142857142855,1,0.0,0,1,0,1,1,0,0,0,0,2,1,0
2056,79339,PNuCKnyPWCRVxphTjJ1pIquyKu0dURK7,A3fsA9Zfv1X2fVEQhTw51lKENdNrEqT3,4,3,1,0,0,0,2,0,6,0.8571428571428571,1,0.0,0,1,0,0,3,0,0,2,0,1,5,1
2057,79353,SHRanMph56qnHJKMofxrIA8VyLg99gvL,bWdj2GDclj5ofokWjzoa5jAwMkxCykd6,4,4,0,0,0,0,2,0,6,0.8571428571428571,2,0.0,0,0,0,0,4,0,0,2,0,0,6,0
2058,79354,gBZ3DHDU78LvTtx2wVh6bkCOt1eL771m,A3fsA9Zfv1X2fVEQhTw51lKENdNrEqT3,11,11,1,0,1,0,5,0,18,2.5714285714285716,2,0.0,0,1,0,1,11,0,0,5,0,2,16,1
2059,79387,GCu64KhvD3k4ysmsfT3aBU2fTrWS3rtB,SpATywNh6bZuzm8s1ceuBUnMUAeoAHHw,5,5,0,0,0,0,2,0,7,1.0,1,0.0,0,0,0,0,5,0,0,2,0,0,7,1
2060,79391,Q3913BpDariYbEj8ZlFy9MQJV1rZlZAJ,SpATywNh6bZuzm8s1ceuBUnMUAeoAHHw,5,8,1,2,0,0,2,0,13,1.8571428571428572,2,0.0,1,1,2,0,7,0,0,2,0,4,9,1
2061,79403,xWXhCGrW03YluuceUyewYdqXryhbgrdd,SpATywNh6bZuzm8s1ceuBUnMUAeoAHHw,9,4,1,0,1,5,6,1,18,2.5714285714285716,1,0.0,0,1,0,1,4,5,0,6,1,2,16,1
2062,79433,1WrKf0VE4OvwmI8ZMK9zpJFtYHCCItqb,SpATywNh6bZuzm8s1ceuBUnMUAeoAHHw,1,0,0,0,0,0,1,0,1,0.14285714285714285,1,0.0,0,0,0,0,0,0,0,1,0,0,1,1
2063,79439,crl3o7sxyMWLnKWiaz3BBw0rhIdF3cXr,bWdj2GDclj5ofokWjzoa5jAwMkxCykd6,15,15,1,34,1,4,11,0,66,9.428571428571429,1,0.0,7,1,33,1,8,4,1,11,0,42,24,1
2064,79442,mCWUqPjCgQQazWm9jyDsH7XslBjGoVeA,SpATywNh6bZuzm8s1ceuBUnMUAeoAHHw,18,12,9,0,7,0,5,0,33,4.714285714285714,1,0.0,0,9,0,7,12,0,0,5,0,16,17,1
2065,79449,qwFDXKt0M8f2bQWHQ9IwMnRpFGf93NNf,SpATywNh6bZuzm8s1ceuBUnMUAeoAHHw,3,4,1,0,0,0,2,0,7,1.0,2,0.0,0,1,0,0,4,0,0,2,0,1,6,1
2066,79450,IKVKcza5vT9JehCbhoro1CRnVpL575lj,SpATywNh6bZuzm8s1ceuBUnMUAeoAHHw,1,0,0,0,0,0,1,0,1,0.14285714285714285,1,0.0,0,0,0,0,0,0,0,1,0,0,1,1
2067,79466,fu60FMGFqAwgUp8glfVKZNcdqYonSFb4,A3fsA9Zfv1X2fVEQhTw51lKENdNrEqT3,12,11,3,0,2,0,7,0,23,3.2857142857142856,1,0.0,0,3,0,2,11,0,0,7,0,5,18,1
2068,79481,IHB272IdBeuDM3MeGjnOfHr8AhA89HNb,RXDvfPUBYFlVdlueBFbLW0mhhAyGEqpt,43,48,33,63,11,25,9,0,189,27.0,3,0.0,9,33,55,11,39,25,8,9,0,108,81,1
2069,79483,i39wrwOFUT4cBFVx9tMMQ3lQ2qJwZK9W,A3fsA9Zfv1X2fVEQhTw51lKENdNrEqT3,3,6,4,0,0,0,1,0,11,1.5714285714285714,2,0.0,0,4,0,0,6,0,0,1,0,4,7,1
2070,79509,G0i0hCTwH2K62ld1aO6Hf5Ntp0ahokSh,SpATywNh6bZuzm8s1ceuBUnMUAeoAHHw,2,0,0,0,0,0,3,0,3,0.42857142857142855,1,0.0,0,0,0,0,0,0,0,3,0,0,3,0
2071,79519,NUQJxbePNRtXQQBXCQFchv4ww5sWUrml,SpATywNh6bZuzm8s1ceuBUnMUAeoAHHw,5,8,0,0,0,0,10,0,18,2.5714285714285716,2,0.0,0,0,0,0,8,0,0,10,0,0,18,0
2072,79548,xt59FC0u82DgUh4CRpEaJwaXZlH1aLO1,SpATywNh6bZuzm8s1ceuBUnMUAeoAHHw,23,34,22,12,15,0,7,1,91,13.0,2,0.0,8,22,11,15,26,0,1,7,1,56,35,0
2073,79555,ygHFzUOzEqkLxFm5OclfxvG9i48BUAuT,SpATywNh6bZuzm8s1ceuBUnMUAeoAHHw,2,0,0,0,0,0,3,0,3,0.42857142857142855,2,0.0,0,0,0,0,0,0,0,3,0,0,3,0
2074,79576,w1E1CWgFfuFOCR0VzQkihC3ia5yrssmV,RXDvfPUBYFlVdlueBFbLW0mhhAyGEqpt,1,0,0,0,0,0,1,0,1,0.14285714285714285,1,0.0,0,0,0,0,0,0,0,1,0,0,1,1
2075,79592,D6jwUujWuVnAZzyPLog7cSVfWJ6qOkhT,SpATywNh6bZuzm8s1ceuBUnMUAeoAHHw,22,33,0,31,0,11,17,4,96,13.714285714285714,1,0.0,15,0,28,0,18,11,3,17,4,43,53,1
2076,79604,ZbdgVvxsxyG1aqBQ8n6eLVu27gWAZvhX,bWdj2GDclj5ofokWjzoa5jAwMkxCykd6,1,0,0,0,0,0,1,0,1,0.14285714285714285,1,0.0,0,0,0,0,0,0,0,1,0,0,1,1
2077,79619,Z21gQGlXtQP1JO0odoLDtH3q2Pa791DY,bWdj2GDclj5ofokWjzoa5jAwMkxCykd6,8,25,12,0,6,3,9,3,58,8.285714285714286,3,0.0,7,12,0,6,18,3,0,9,3,25,33,1
2078,79633,om6ZOCO8LNIrRrNbdISrPEP9oSUDMJl3,SpATywNh6bZuzm8s1ceuBUnMUAeoAHHw,21,15,11,18,8,1,8,1,62,8.857142857142858,1,0.0,2,11,16,8,13,1,2,8,1,37,25,1
2079,79634,rScZ8wYdCfayAwidHm4E5aYRTim0GnWj,bWdj2GDclj5ofokWjzoa5jAwMkxCykd6,6,11,3,0,5,0,5,0,24,3.4285714285714284,1,0.0,6,3,0,5,5,0,0,5,0,14,10,1
2080,79647,y8iVrI2EkMZTkanlXaBHyxYcB0wN7UeI,SpATywNh6bZuzm8s1ceuBUnMUAeoAHHw,4,3,1,0,1,0,1,0,6,0.8571428571428571,1,0.0,0,1,0,1,3,0,0,1,0,2,4,1
2081,79661,yh14zaFitCUTgvBPqRXiaZ6cUijtktL4,bWdj2GDclj5ofokWjzoa5jAwMkxCykd6,5,2,1,0,1,0,2,0,6,0.8571428571428571,1,0.0,0,1,0,1,2,0,0,2,0,2,4,1
2082,79668,7nUtazUwwSnnXJpIKdQBJGpXV6Po42DQ,bWdj2GDclj5ofokWjzoa5jAwMkxCykd6,9,9,1,0,2,0,4,0,16,2.2857142857142856,1,0.0,3,1,0,2,6,0,0,4,0,6,10,1
2083,79671,3njhidxBzYHOjpYDGROQcUAReorseJK1,RXDvfPUBYFlVdlueBFbLW0mhhAyGEqpt,1,0,0,0,0,0,1,0,1,0.14285714285714285,1,0.0,0,0,0,0,0,0,0,1,0,0,1,1
2084,79675,a8972vl53XxyEoK7iq5Ba0NkWofUNUyo,SpATywNh6bZuzm8s1ceuBUnMUAeoAHHw,5,3,0,0,0,0,2,0,5,0.7142857142857143,2,0.0,0,0,0,0,3,0,0,2,0,0,5,1
2085,79711,SUK7J6JSzTvdTuqtYmCn1wzdta5Gs77Z,SpATywNh6bZuzm8s1ceuBUnMUAeoAHHw,1,0,0,0,0,0,1,0,1,0.14285714285714285,1,0.0,0,0,0,0,0,0,0,1,0,0,1,1
2086,79712,840TvauCMn8hUpsV90vm3IXVVzLXLwLs,bWdj2GDclj5ofokWjzoa5jAwMkxCykd6,4,7,2,0,1,0,1,0,11,1.5714285714285714,1,0.0,0,2,0,1,7,0,0,1,0,3,8,1
2087,79743,uDLWNQEFPK65POXXo6bGzcLJ0lsyHLLH,SpATywNh6bZuzm8s1ceuBUnMUAeoAHHw,21,15,8,18,6,0,2,0,49,7.0,1,0.0,5,8,15,6,10,0,3,2,0,34,15,1
2088,79755,rfBYCgJ4870BiJSVIuZN0gKGiTat9rVl,SpATywNh6bZuzm8s1ceuBUnMUAeoAHHw,2,0,0,0,0,0,2,0,2,0.2857142857142857,1,0.0,0,0,0,0,0,0,0,2,0,0,2,1
2089,79761,ffg9VbmMkFKj2DfO61ClA5PDHr5Xa6gN,SpATywNh6bZuzm8s1ceuBUnMUAeoAHHw,1,0,0,0,0,0,1,0,1,0.14285714285714285,1,0.0,0,0,0,0,0,0,0,1,0,0,1,0
2090,79768,WdB4AHM5Haltuxu4ztk7CYoMHww58fwR,SpATywNh6bZuzm8s1ceuBUnMUAeoAHHw,1,0,0,0,0,0,1,0,1,0.14285714285714285,1,0.0,0,0,0,0,0,0,0,1,0,0,1,1
2091,79801,Tdve80vJG7bg0NAfZoErDkCePh9ZdZtG,SpATywNh6bZuzm8s1ceuBUnMUAeoAHHw,3,2,1,0,0,0,1,0,4,0.5714285714285714,1,0.0,0,1,0,0,2,0,0,1,0,1,3,1
2092,79802,nVaguRnMzumbu6IYJqT40xfdj6StQFDm,bWdj2GDclj5ofokWjzoa5jAwMkxCykd6,4,4,1,0,1,0,2,0,8,1.1428571428571428,1,0.0,2,1,0,1,2,0,0,2,0,4,4,1
2093,79809,5tD3trtPQ6jzqFRimP1PMPhgvFtRmfA4,SpATywNh6bZuzm8s1ceuBUnMUAeoAHHw,1,0,0,0,0,0,1,0,1,0.14285714285714285,1,0.0,0,0,0,0,0,0,0,1,0,0,1,1
2094,79818,dCAqk9uHiS99GMTcJQtThG8XWnwwbp5Q,SpATywNh6bZuzm8s1ceuBUnMUAeoAHHw,20,20,9,10,4,1,5,1,50,7.142857142857143,1,0.0,10,9,10,4,10,1,0,5,1,33,17,1
2095,79831,7kTdvih7UMOiFKC9aXRp88JppGP4qSKH,SpATywNh6bZuzm8s1ceuBUnMUAeoAHHw,18,23,11,16,4,0,2,0,56,8.0,2,0.0,4,11,15,4,19,0,1,2,0,34,22,1
2096,79838,s5zDvm6xFFkPgy4oe8OGNGVHxFpWHGBV,SpATywNh6bZuzm8s1ceuBUnMUAeoAHHw,17,14,6,20,4,2,5,1,52,7.428571428571429,1,0.0,7,6,16,4,7,2,4,5,1,33,19,1
2097,79869,f3vfjinjwis5qk6FJAP4uRDxySTgo1bo,G8EPVSXsOYB5YQWZGiz1aVq5Pgr2GrQu,7,3,2,0,2,0,2,0,9,1.2857142857142858,1,0.0,0,2,0,2,3,0,0,2,0,4,5,1
2098,79878,ccvSRrE3qWZJWxhZblz5YcekpwGotPgS,SpATywNh6bZuzm8s1ceuBUnMUAeoAHHw,3,2,1,0,0,0,1,0,4,0.5714285714285714,1,0.0,0,1,0,0,2,0,0,1,0,1,3,1
2099,79894,x3bTgsr7QSCiaq6OJXRLOfvMZYUxrJaI,bWdj2GDclj5ofokWjzoa5jAwMkxCykd6,10,5,4,0,4,0,1,0,14,2.0,1,0.0,0,4,0,4,5,0,0,1,0,8,6,1
2100,79907,Q2dKqJgalCRkN8Z90Lq1SNPa32DtEIlR,bWdj2GDclj5ofokWjzoa5jAwMkxCykd6,1,0,0,0,0,0,1,0,1,0.14285714285714285,1,0.0,0,0,0,0,0,0,0,1,0,0,1,1
2101,79942,og3zNDLl7XmMMAhbJtxTc4Nj33wztyot,SpATywNh6bZuzm8s1ceuBUnMUAeoAHHw,6,3,1,0,0,0,4,1,9,1.2857142857142858,1,0.0,0,1,0,0,3,0,0,4,1,1,8,1
2102,79975,Z3TCNncfxAFUErtBz9OqcQV0lBb4yIuz,SpATywNh6bZuzm8s1ceuBUnMUAeoAHHw,13,20,0,10,0,1,8,0,39,5.571428571428571,1,0.0,10,0,10,0,10,1,0,8,0,20,19,1
2103,79984,oKZwUGrYHqdyevQMbQx5wJjMj1yq2zA6,A3fsA9Zfv1X2fVEQhTw51lKENdNrEqT3,3,2,1,0,0,0,1,0,4,0.5714285714285714,1,0.0,0,1,0,0,2,0,0,1,0,1,3,1
2104,79995,vkOVdQ2Pc6HLkOn2fNIG8JE1qzNLpnwN,RXDvfPUBYFlVdlueBFbLW0mhhAyGEqpt,5,4,0,0,0,0,2,0,6,0.8571428571428571,1,0.0,0,0,0,0,4,0,0,2,0,0,6,1
2105,79998,q3XMARasETEzJyvJUxEAfFYsH6Z5s8Zv,bWdj2GDclj5ofokWjzoa5jAwMkxCykd6,3,2,1,0,0,0,1,0,4,0.5714285714285714,1,0.0,0,1,0,0,2,0,0,1,0,1,3,0
2106,80019,YOBshYgk5gyR7XdL7ay26cecY2tdQtWp,SpATywNh6bZuzm8s1ceuBUnMUAeoAHHw,21,32,18,22,0,3,9,4,88,12.571428571428571,2,0.0,8,18,18,0,24,3,4,9,4,44,44,0
2107,80040,4AJWWnsd8QGDSRF4HLmdDQcz8kiBAcGz,SpATywNh6bZuzm8s1ceuBUnMUAeoAHHw,7,4,3,0,2,0,2,0,11,1.5714285714285714,2,0.0,0,3,0,2,4,0,0,2,0,5,6,1
2108,80092,IAOTVxG7e06ArppQIZcVBCeppiZS52Zi,G8EPVSXsOYB5YQWZGiz1aVq5Pgr2GrQu,1,0,0,0,0,0,1,0,1,0.14285714285714285,1,0.0,0,0,0,0,0,0,0,1,0,0,1,1
2109,80093,IAOTVxG7e06ArppQIZcVBCeppiZS52Zi,RXDvfPUBYFlVdlueBFbLW0mhhAyGEqpt,1,0,0,0,0,0,1,0,1,0.14285714285714285,1,0.0,0,0,0,0,0,0,0,1,0,0,1,1
2110,80138,TcTuC5hiyHRmVc5qZWpzVJY3ugVLXB30,SpATywNh6bZuzm8s1ceuBUnMUAeoAHHw,2,0,0,0,0,0,4,0,4,0.5714285714285714,1,0.0,0,0,0,0,0,0,0,4,0,0,4,1
2111,80163,qepVwgjKQRsdgtfeDxtXZatdyxHVESv4,SpATywNh6bZuzm8s1ceuBUnMUAeoAHHw,10,13,1,0,0,4,7,1,26,3.7142857142857144,1,0.0,0,1,0,0,13,4,0,7,1,1,25,1
2112,80177,BHKXnEVm5p8zUlT49NSc8LjGWmHUvROs,SpATywNh6bZuzm8s1ceuBUnMUAeoAHHw,7,2,1,0,1,0,6,0,10,1.4285714285714286,1,0.0,0,1,0,1,2,0,0,6,0,2,8,1
2113,80185,BHKXnEVm5p8zUlT49NSc8LjGWmHUvROs,RXDvfPUBYFlVdlueBFbLW0mhhAyGEqpt,1,0,0,0,0,0,1,0,1,0.14285714285714285,1,0.0,0,0,0,0,0,0,0,1,0,0,1,1
2114,80195,aZzurUzXBMxrnGRFBA3YxJsNpq6Cyxbm,SpATywNh6bZuzm8s1ceuBUnMUAeoAHHw,7,6,5,0,0,0,1,0,12,1.7142857142857142,1,0.0,0,5,0,0,6,0,0,1,0,5,7,0
2115,80216,GkgOdr5534YC0rxEW6eOGTvUI1TnqsRC,SpATywNh6bZuzm8s1ceuBUnMUAeoAHHw,5,2,1,0,1,0,2,0,6,0.8571428571428571,1,0.0,0,1,0,1,2,0,0,2,0,2,4,1
2116,80236,V9sr2zgjH2joKkLVi0Sqvx5Qp7qYhjJ9,A3fsA9Zfv1X2fVEQhTw51lKENdNrEqT3,6,4,1,0,1,0,1,0,7,1.0,1,0.0,0,1,0,1,4,0,0,1,0,2,5,1
2117,80247,eYRBHvvJOtQ80CX15zmkpE9dCWbRpi7K,SpATywNh6bZuzm8s1ceuBUnMUAeoAHHw,5,2,1,0,1,0,2,0,6,0.8571428571428571,1,0.0,0,1,0,1,2,0,0,2,0,2,4,0
2118,80300,GUw906kJ57cW8NGG6UWBrUmH3fuOQE9A,SpATywNh6bZuzm8s1ceuBUnMUAeoAHHw,1,0,0,0,0,0,1,0,1,0.14285714285714285,1,0.0,0,0,0,0,0,0,0,1,0,0,1,1
2119,80319,4cRZxyVNjv13lU3nu2aK2rwyndExVCGa,SpATywNh6bZuzm8s1ceuBUnMUAeoAHHw,5,4,1,0,1,0,3,0,9,1.2857142857142858,2,0.0,0,1,0,1,4,0,0,3,0,2,7,0
2120,80326,Y3w6vYVJTXZRYwblrdBFP6YHJ2PSSEq2,RXDvfPUBYFlVdlueBFbLW0mhhAyGEqpt,21,30,21,0,0,0,4,0,55,7.857142857142857,1,0.0,3,21,0,0,27,0,0,4,0,24,31,0
2121,80366,0wJhtCWK60WPCeRF62m8T80DtNpWhRrg,bWdj2GDclj5ofokWjzoa5jAwMkxCykd6,1,0,0,0,0,0,1,0,1,0.14285714285714285,1,0.0,0,0,0,0,0,0,0,1,0,0,1,1
2122,80372,qrXtlHZ3b3drLfwVarPNRUa07Lp9hqJh,SpATywNh6bZuzm8s1ceuBUnMUAeoAHHw,2,0,0,0,0,0,2,0,2,0.2857142857142857,1,0.0,0,0,0,0,0,0,0,2,0,0,2,1
2123,80386,RXKLhNquRsGdvYtQGHp0VVbeAvXlNqmn,SpATywNh6bZuzm8s1ceuBUnMUAeoAHHw,2,0,0,0,0,0,3,0,3,0.42857142857142855,1,0.0,0,0,0,0,0,0,0,3,0,0,3,1
2124,80393,S8OVDYMWVqlXct5SL79m7HIG5CpKKYZc,SpATywNh6bZuzm8s1ceuBUnMUAeoAHHw,6,7,2,1,0,0,7,0,17,2.4285714285714284,2,0.0,4,2,1,0,3,0,0,7,0,7,10,0
2125,80411,GC4OF9yGz21AkcWehLa95SfLGyYuVKMP,SpATywNh6bZuzm8s1ceuBUnMUAeoAHHw,5,4,2,2,0,0,1,0,9,1.2857142857142858,1,0.0,1,2,1,0,3,0,1,1,0,4,5,0
2126,80463,G4gv3psLUg6DraQbf90HcUcwjZl74koo,SpATywNh6bZuzm8s1ceuBUnMUAeoAHHw,3,2,1,0,0,0,1,0,4,0.5714285714285714,1,0.0,0,1,0,0,2,0,0,1,0,1,3,1
2127,80471,AZ8hE11Dcjz74P3tHeZJFdS8MoworAxL,G8EPVSXsOYB5YQWZGiz1aVq5Pgr2GrQu,48,125,0,51,3,16,11,6,212,30.285714285714285,3,0.0,11,0,43,3,114,16,8,11,6,57,155,0
2128,80472,2tSCGGcBbyusCnHqpGiQkgQi3re0uZxB,G8EPVSXsOYB5YQWZGiz1aVq5Pgr2GrQu,20,36,13,0,9,2,14,1,75,10.714285714285714,2,0.0,0,13,0,9,36,2,0,14,1,22,53,1
2129,80476,xIixYS0PTebuXuOSaEZKc4qh4BFu0Dqa,bWdj2GDclj5ofokWjzoa5jAwMkxCykd6,1,0,0,0,0,0,2,0,2,0.2857142857142857,1,0.0,0,0,0,0,0,0,0,2,0,0,2,1
2130,80490,SQsqundSwoyc0WsLMzMDq40PcZstmoDl,SpATywNh6bZuzm8s1ceuBUnMUAeoAHHw,7,4,3,0,3,0,2,0,12,1.7142857142857142,1,0.0,0,3,0,3,4,0,0,2,0,6,6,1
2131,80499,YotAwxbRJChtPJRmqiR2vpTmWxO7oSJ0,bWdj2GDclj5ofokWjzoa5jAwMkxCykd6,1,0,0,0,0,0,2,0,2,0.2857142857142857,1,0.0,0,0,0,0,0,0,0,2,0,0,2,1
2132,80543,SJGYusQ5bKHgmVHB9ZU6VNixBNlg7610,SpATywNh6bZuzm8s1ceuBUnMUAeoAHHw,5,2,1,0,1,0,2,0,6,0.8571428571428571,1,0.0,0,1,0,1,2,0,0,2,0,2,4,1
2133,80577,LeM9PaeUEt6YxtDTcxg2tcMBc03CKGpH,G8EPVSXsOYB5YQWZGiz1aVq5Pgr2GrQu,1,0,0,0,0,0,1,0,1,0.14285714285714285,1,0.0,0,0,0,0,0,0,0,1,0,0,1,1
2134,80593,z9sj5HIJml1DMOMfRKKBQ7IvS2IoE424,A3fsA9Zfv1X2fVEQhTw51lKENdNrEqT3,1,0,0,0,0,0,1,0,1,0.14285714285714285,1,0.0,0,0,0,0,0,0,0,1,0,0,1,1
2135,80603,iWBeIhxgRjHKtzWSQwKS5OP5OzUjqRhH,bWdj2GDclj5ofokWjzoa5jAwMkxCykd6,4,4,1,10,1,0,1,0,17,2.4285714285714284,1,0.0,2,1,9,1,2,0,1,1,0,13,4,1
2136,80606,2cQfWhwRUGUv48S47s2aDWYzSM5LRy6r,RXDvfPUBYFlVdlueBFbLW0mhhAyGEqpt,3,2,0,0,0,0,1,0,3,0.42857142857142855,1,0.0,0,0,0,0,2,0,0,1,0,0,3,1
2137,80610,XIynS55sKEeUm9UamMF9V3hYXLI7Q5XZ,bWdj2GDclj5ofokWjzoa5jAwMkxCykd6,6,1,1,0,1,0,3,0,6,0.8571428571428571,1,0.0,0,1,0,1,1,0,0,3,0,2,4,1
2138,80614,srJeJbIuD6nlvLtYdUFiQcvh7X1ghk8m,SpATywNh6bZuzm8s1ceuBUnMUAeoAHHw,1,0,0,0,0,0,1,0,1,0.14285714285714285,1,0.0,0,0,0,0,0,0,0,1,0,0,1,1
2139,80646,1XuOICh6QrUFIc1MJAW7XRUBUSTY0RN7,SpATywNh6bZuzm8s1ceuBUnMUAeoAHHw,11,15,8,0,3,3,13,2,44,6.285714285714286,2,0.0,0,8,0,3,15,3,0,13,2,11,33,1
2140,80685,SyrTnLXKpH34dNmIyW3n9ptk8gbsqg3F,bWdj2GDclj5ofokWjzoa5jAwMkxCykd6,1,0,0,0,0,0,1,0,1,0.14285714285714285,1,0.0,0,0,0,0,0,0,0,1,0,0,1,1
2141,80686,SyrTnLXKpH34dNmIyW3n9ptk8gbsqg3F,G8EPVSXsOYB5YQWZGiz1aVq5Pgr2GrQu,1,0,0,0,0,0,1,0,1,0.14285714285714285,1,0.0,0,0,0,0,0,0,0,1,0,0,1,1
2142,80718,a5enjFKHyOqV9BlzZwj7DoNQQjSWFxve,SpATywNh6bZuzm8s1ceuBUnMUAeoAHHw,3,2,1,0,0,0,1,0,4,0.5714285714285714,1,0.0,0,1,0,0,2,0,0,1,0,1,3,1
2143,80725,eVZffGeL4uoEevrNNMdcmW6f0YwT8plW,bWdj2GDclj5ofokWjzoa5jAwMkxCykd6,5,3,2,0,1,0,1,0,7,1.0,1,0.0,0,2,0,1,3,0,0,1,0,3,4,1
2144,80748,H6iwP0B7nHcYZaQbDpLJEx2H7FXYxL7S,RXDvfPUBYFlVdlueBFbLW0mhhAyGEqpt,12,6,3,6,2,0,5,0,22,3.142857142857143,2,0.0,3,3,3,2,3,0,3,5,0,11,11,0
2145,80761,xyhTJkgGghEribeWkvfmDO529PeI6BOD,bWdj2GDclj5ofokWjzoa5jAwMkxCykd6,19,17,15,0,16,0,5,0,53,7.571428571428571,1,0.0,2,15,0,16,15,0,0,5,0,33,20,1
2146,80777,Nn60hlJlXHP7n7M6lOuhaSQUkd1WY1lX,bWdj2GDclj5ofokWjzoa5jAwMkxCykd6,2,0,0,0,0,0,2,0,2,0.2857142857142857,1,0.0,0,0,0,0,0,0,0,2,0,0,2,1
2147,80797,OmF4aFe06TkjIpsTgGpQ4vBzMWi2jjQV,SpATywNh6bZuzm8s1ceuBUnMUAeoAHHw,7,6,3,0,2,0,3,0,14,2.0,1,0.0,0,3,0,2,6,0,0,3,0,5,9,1
2148,80800,a98Mt6r9LLCkAEPo2R3JVMN20OhIPoaG,SpATywNh6bZuzm8s1ceuBUnMUAeoAHHw,13,19,13,4,9,0,1,0,46,6.571428571428571,3,0.0,1,13,4,9,18,0,0,1,0,27,19,1
2149,80828,7cqcexGmNTOg3kBfOTQxhsQAuLbRP0aP,SpATywNh6bZuzm8s1ceuBUnMUAeoAHHw,4,2,1,0,1,0,1,0,5,0.7142857142857143,1,0.0,0,1,0,1,2,0,0,1,0,2,3,1
2150,80862,JPgtg8QJos7Rq7D0ICcp60lZ9MEetv8V,RXDvfPUBYFlVdlueBFbLW0mhhAyGEqpt,5,2,1,0,1,0,2,0,6,0.8571428571428571,1,0.0,0,1,0,1,2,0,0,2,0,2,4,1
2151,80875,zgLhc8F17sS6o8GPDEBAA43SRssMOYHD,fbPkOYLVPtPgIt0MxizjfFJov3JbHyAi,1,0,0,0,0,0,1,0,1,0.14285714285714285,1,0.0,0,0,0,0,0,0,0,1,0,0,1,1
2152,80891,1IMOvf9v1bRH0tUTRkiIkzGe833lnAgf,fbPkOYLVPtPgIt0MxizjfFJov3JbHyAi,1,0,0,0,0,0,1,0,1,0.14285714285714285,1,0.0,0,0,0,0,0,0,0,1,0,0,1,0
2153,80892,OqzJYk2L0XqYLfMs4LljNI8HpBsCF1TU,fbPkOYLVPtPgIt0MxizjfFJov3JbHyAi,6,5,2,4,1,0,1,0,13,1.8571428571428572,1,0.0,1,2,3,1,4,0,1,1,0,7,6,1
2154,82293,h7Gk9Pr4tHraGHEA4N989G6mMEttrQ7F,fbPkOYLVPtPgIt0MxizjfFJov3JbHyAi,4,2,1,0,1,0,1,0,5,0.7142857142857143,1,0.0,0,1,0,1,2,0,0,1,0,2,3,1
2155,82296,cRhYOWmRYGzfmTeQOfNoa47hIiXDh8uB,fbPkOYLVPtPgIt0MxizjfFJov3JbHyAi,8,7,3,0,2,3,4,0,19,2.7142857142857144,1,0.0,0,3,0,2,7,3,0,4,0,5,14,1
2156,82298,L39ZdOzVu52b5Nu8u3TuFdomCuDfGlbZ,fbPkOYLVPtPgIt0MxizjfFJov3JbHyAi,7,3,2,0,2,0,2,0,9,1.2857142857142858,1,0.0,0,2,0,2,3,0,0,2,0,4,5,1
2157,82300,W0m8271d1PwWD9jcR5ad8muDNmmDz2n0,fbPkOYLVPtPgIt0MxizjfFJov3JbHyAi,6,2,1,0,1,0,3,0,7,1.0,1,0.0,0,1,0,1,2,0,0,3,0,2,5,1
2158,82306,SMcFR1tzrGAErGanrAOTaiQacFJ5UscL,fbPkOYLVPtPgIt0MxizjfFJov3JbHyAi,1,0,0,0,0,0,1,0,1,0.14285714285714285,1,0.0,0,0,0,0,0,0,0,1,0,0,1,1
2159,82320,PZsNp0sdZSh88V88314df0SFpq2hITu9,7GRhBDsirIGkRZBtSMEzNTyDr2JQm4xx,35,54,22,18,14,4,12,0,124,17.714285714285715,3,0.0,25,22,11,14,29,4,7,12,0,72,52,1
2160,82384,43E2rt302JULLcYiauLjUubEtMqnfHMM,7GRhBDsirIGkRZBtSMEzNTyDr2JQm4xx,1,0,0,0,0,0,1,0,1,0.14285714285714285,1,0.0,0,0,0,0,0,0,0,1,0,0,1,1
2161,82393,LEErhOa5boiziYl0X6XgUtaE9oegOl2r,7GRhBDsirIGkRZBtSMEzNTyDr2JQm4xx,1,0,0,0,0,0,1,0,1,0.14285714285714285,1,0.0,0,0,0,0,0,0,0,1,0,0,1,1
2162,82399,viuKt4GgrX0rYL5EpHoxJbsiC9TblSuk,7GRhBDsirIGkRZBtSMEzNTyDr2JQm4xx,12,27,9,0,1,8,5,1,51,7.285714285714286,1,0.0,16,9,0,1,11,8,0,5,1,26,25,1
2163,82405,TciQEzJA4hKxeo0Ve5JLByGDZHpNx3uy,7GRhBDsirIGkRZBtSMEzNTyDr2JQm4xx,2,0,0,0,0,0,3,0,3,0.42857142857142855,1,0.0,0,0,0,0,0,0,0,3,0,0,3,1
2164,82417,cYrWUXTiBgGjy3hGqmm3n1c0yjpEqf1w,7GRhBDsirIGkRZBtSMEzNTyDr2JQm4xx,11,6,3,0,4,1,6,0,20,2.857142857142857,1,0.0,2,3,0,4,4,1,0,6,0,9,11,1
2165,82418,uJax5vCFklO8HHpSUYT3Fz3R0owwtr35,7GRhBDsirIGkRZBtSMEzNTyDr2JQm4xx,1,0,0,0,0,0,1,0,1,0.14285714285714285,1,0.0,0,0,0,0,0,0,0,1,0,0,1,1
2166,82437,XivfOnvugBk6XlGIM6kdwKfGcR3nQxRm,7GRhBDsirIGkRZBtSMEzNTyDr2JQm4xx,7,3,2,0,2,0,2,0,9,1.2857142857142858,1,0.0,0,2,0,2,3,0,0,2,0,4,5,1
2167,82453,vUKsMiJwv2QfsgGCTNCgcgyS6zvBvgBp,7GRhBDsirIGkRZBtSMEzNTyDr2JQm4xx,13,9,7,0,4,6,11,1,38,5.428571428571429,1,0.0,0,7,0,4,9,6,0,11,1,11,27,1
2168,82511,uGqq5Gc0yuBAXiGPLk4UFpV86PfbPpKt,7GRhBDsirIGkRZBtSMEzNTyDr2JQm4xx,23,52,11,14,10,0,1,0,88,12.571428571428571,1,0.0,8,11,7,10,44,0,7,1,0,36,52,1
2169,82519,RhKR05rzUu0u9Tu4D52krXN6Zpp20wSB,7GRhBDsirIGkRZBtSMEzNTyDr2JQm4xx,1,0,0,0,0,0,1,0,1,0.14285714285714285,1,0.0,0,0,0,0,0,0,0,1,0,0,1,1
2170,82549,LzZbSzxCF6j5IK4opjLkxGirHE6VTy2b,7GRhBDsirIGkRZBtSMEzNTyDr2JQm4xx,23,35,2,28,0,1,2,0,68,9.714285714285714,2,0.0,17,2,22,0,18,1,6,2,0,41,27,0
2171,82606,ieYbeKnQ9Q6nxVAutigoFXyNAyGepcVf,SpATywNh6bZuzm8s1ceuBUnMUAeoAHHw,30,29,18,37,9,1,5,1,100,14.285714285714286,1,0.0,7,18,33,9,22,1,4,5,1,67,33,0
2172,82645,CSh5hGbaSFu2yCb31iVMOVwKocrH471Q,RXDvfPUBYFlVdlueBFbLW0mhhAyGEqpt,15,14,9,8,3,1,6,1,42,6.0,2,0.0,1,9,8,3,13,1,0,6,1,21,21,0
2173,82718,0ToFygcG0ie7U9Wejy2h2RyDoLh56OuH,SpATywNh6bZuzm8s1ceuBUnMUAeoAHHw,1,0,0,0,0,0,1,0,1,0.14285714285714285,1,0.0,0,0,0,0,0,0,0,1,0,0,1,1
2174,82797,BzvzyDIHLe9MZwFkiZf5BNkVkHrFZ1uP,SpATywNh6bZuzm8s1ceuBUnMUAeoAHHw,15,16,6,12,3,0,2,0,39,5.571428571428571,2,0.0,2,6,10,3,14,0,2,2,0,21,18,1
2175,82809,CSh5hGbaSFu2yCb31iVMOVwKocrH471Q,bWdj2GDclj5ofokWjzoa5jAwMkxCykd6,9,12,7,0,4,0,9,0,32,4.571428571428571,3,0.0,0,7,0,4,12,0,0,9,0,11,21,1
2176,82815,IYjgMeQycDQkXIpTAZqsKVDfOfuGTmr6,G8EPVSXsOYB5YQWZGiz1aVq5Pgr2GrQu,5,1,1,6,0,0,2,0,10,1.4285714285714286,1,0.0,0,1,5,0,1,0,1,2,0,6,4,1
2177,82825,PCDzowxElNLixXyfAFPkQqlbkMlIrEa9,bWdj2GDclj5ofokWjzoa5jAwMkxCykd6,1,0,0,0,0,0,1,0,1,0.14285714285714285,1,0.0,0,0,0,0,0,0,0,1,0,0,1,1
2178,82826,6PLrCNmfEwPk8NveiZ2kjz8b6TJ4tdFy,SpATywNh6bZuzm8s1ceuBUnMUAeoAHHw,7,5,1,0,1,0,7,0,14,2.0,3,0.0,0,1,0,1,5,0,0,7,0,2,12,1
2179,82839,0eZxP7v4dLkYnlOrNv9f440B7CYLqmGw,A3fsA9Zfv1X2fVEQhTw51lKENdNrEqT3,8,4,0,0,0,3,8,1,16,2.2857142857142856,1,0.0,0,0,0,0,4,3,0,8,1,0,16,0
2180,82935,VZy08QiJfjzIhB9oyZbfkS8kOqdqXxGQ,SpATywNh6bZuzm8s1ceuBUnMUAeoAHHw,20,42,23,6,5,1,26,0,103,14.714285714285714,4,0.0,2,23,6,5,40,1,0,26,0,36,67,0
2181,82945,jMzDAkDrCqzTj207GrZXDfLQXbYc8WXP,SpATywNh6bZuzm8s1ceuBUnMUAeoAHHw,4,5,0,0,0,0,1,0,6,0.8571428571428571,1,0.0,0,0,0,0,5,0,0,1,0,0,6,1
2182,83008,OifsLGRBGBgFFNsSrNDnK5W8Vbn9qLGX,bWdj2GDclj5ofokWjzoa5jAwMkxCykd6,3,2,0,0,0,0,1,0,3,0.42857142857142855,1,0.0,0,0,0,0,2,0,0,1,0,0,3,1
2183,83011,7IO6p4687fQRowFKh8aP2BRrTBz96sXF,SpATywNh6bZuzm8s1ceuBUnMUAeoAHHw,15,7,6,0,6,0,2,0,21,3.0,1,0.0,0,6,0,6,7,0,0,2,0,12,9,1
2184,83016,6nEFiLob034lX78wkreIicrVXormSdsR,SpATywNh6bZuzm8s1ceuBUnMUAeoAHHw,7,2,0,0,0,9,6,2,19,2.7142857142857144,1,0.0,0,0,0,0,2,9,0,6,2,0,19,1
2185,83024,xhSNxzAdJZ3UvqN1HWRUi586YbiFg3gP,SpATywNh6bZuzm8s1ceuBUnMUAeoAHHw,7,3,2,0,2,0,2,0,9,1.2857142857142858,1,0.0,0,2,0,2,3,0,0,2,0,4,5,1
2186,83034,JfftjOGdDbpgbrupi0Gwr899R0jzXikJ,RXDvfPUBYFlVdlueBFbLW0mhhAyGEqpt,14,9,7,0,5,0,2,0,23,3.2857142857142856,2,0.0,0,7,0,5,9,0,0,2,0,12,11,1
2187,83050,8N1dftZZEH60qM7KC0I3DLQjIoLpq8rg,bWdj2GDclj5ofokWjzoa5jAwMkxCykd6,8,5,4,0,2,0,4,1,16,2.2857142857142856,1,0.0,0,4,0,2,5,0,0,4,1,6,10,1
2188,83051,5txttxupjDZ5RVkKM8mUX5AwlfTmH5yF,SpATywNh6bZuzm8s1ceuBUnMUAeoAHHw,9,3,2,0,2,1,4,0,12,1.7142857142857142,1,0.0,0,2,0,2,3,1,0,4,0,4,8,1
2189,83086,HDl6obmuly5u871WtIy4bB83rJ9ydWpb,SpATywNh6bZuzm8s1ceuBUnMUAeoAHHw,24,20,12,32,6,1,4,0,75,10.714285714285714,1,0.0,5,12,27,6,15,1,5,4,0,50,25,1
2190,83165,jqU1D59XEYqlC5xpuvwRL444Dk2gM9HE,bWdj2GDclj5ofokWjzoa5jAwMkxCykd6,1,0,0,0,0,0,1,0,1,0.14285714285714285,1,0.0,0,0,0,0,0,0,0,1,0,0,1,1
2191,83170,TOdJr6wpv1Do14qMOudEcAu5ZtPnzG5P,G8EPVSXsOYB5YQWZGiz1aVq5Pgr2GrQu,50,18,18,213,9,0,6,0,264,37.714285714285715,2,0.0,0,18,187,9,18,0,26,6,0,214,50,0
2192,83174,5A8qgesuumI82DPHv10fhG2s0pO5oVZR,A3fsA9Zfv1X2fVEQhTw51lKENdNrEqT3,1,0,0,0,0,0,1,0,1,0.14285714285714285,1,0.0,0,0,0,0,0,0,0,1,0,0,1,1
2193,83211,Wr4SmSlfffOCt9SGCoEYbe3u98RIz0dN,A3fsA9Zfv1X2fVEQhTw51lKENdNrEqT3,20,16,13,0,10,0,4,0,43,6.142857142857143,2,0.0,0,13,0,10,16,0,0,4,0,23,20,1
2194,83227,EUmZ5qzjwgko2PIWEnctkvYh7APnUrX9,bWdj2GDclj5ofokWjzoa5jAwMkxCykd6,12,32,3,0,2,0,12,0,49,7.0,4,0.0,0,3,0,2,32,0,0,12,0,5,44,0
2195,83270,nLSuRa1Xl0BD98Gi62KN22iPrqq32BXg,A3fsA9Zfv1X2fVEQhTw51lKENdNrEqT3,2,0,0,0,0,0,2,0,2,0.2857142857142857,1,0.0,0,0,0,0,0,0,0,2,0,0,2,1
2196,83277,dT92IjRcuruPiAlpqVUTtu3wNL9IIegT,SpATywNh6bZuzm8s1ceuBUnMUAeoAHHw,1,0,0,0,0,0,1,0,1,0.14285714285714285,1,0.0,0,0,0,0,0,0,0,1,0,0,1,1
2197,83283,PBR461hkZjzKwEmSOTgV69v6hIW4qt59,RXDvfPUBYFlVdlueBFbLW0mhhAyGEqpt,3,0,0,0,0,0,4,0,4,0.5714285714285714,1,0.0,0,0,0,0,0,0,0,4,0,0,4,1
2198,83284,3CjVt7bXLLNxAWX8paG8Hg5eS8UkaYeH,A3fsA9Zfv1X2fVEQhTw51lKENdNrEqT3,9,6,0,0,0,2,5,1,14,2.0,1,0.0,0,0,0,0,6,2,0,5,1,0,14,1
2199,83290,V5AS4ngknDMHs5ddf49SxlAoYguZsiN3,SpATywNh6bZuzm8s1ceuBUnMUAeoAHHw,22,22,12,16,4,3,5,0,62,8.857142857142858,2,0.0,7,12,15,4,15,3,1,5,0,38,24,1
2200,83304,BQi6o3YIDMuHZg7pBKL2EQvhTIhuaxJ1,SpATywNh6bZuzm8s1ceuBUnMUAeoAHHw,1,0,0,0,0,0,1,0,1,0.14285714285714285,1,0.0,0,0,0,0,0,0,0,1,0,0,1,1
2201,83310,4NR9J7NrWx9P8bFiOFbZEGtYIezzdGum,A3fsA9Zfv1X2fVEQhTw51lKENdNrEqT3,11,5,4,0,4,0,2,0,15,2.142857142857143,1,0.0,0,4,0,4,5,0,0,2,0,8,7,0
2202,83336,gFQthJ0fgeQ9ZBHD40PszFOUEAsK6l6q,SpATywNh6bZuzm8s1ceuBUnMUAeoAHHw,2,0,0,0,0,0,2,0,2,0.2857142857142857,1,0.0,0,0,0,0,0,0,0,2,0,0,2,1
2203,83380,cxfyjhDPSpiPao628A4EolvaTnOncviL,A3fsA9Zfv1X2fVEQhTw51lKENdNrEqT3,7,3,2,0,2,0,3,0,10,1.4285714285714286,1,0.0,0,2,0,2,3,0,0,3,0,4,6,1
2204,83382,yBjxhcDDJKIAjEmiiiesRzMTh8bRt1ah,A3fsA9Zfv1X2fVEQhTw51lKENdNrEqT3,2,0,0,0,0,0,2,0,2,0.2857142857142857,1,0.0,0,0,0,0,0,0,0,2,0,0,2,0
2205,83390,GRkdPFTbm7uYMggKfYKpZacMj3qggIR1,bWdj2GDclj5ofokWjzoa5jAwMkxCykd6,7,5,3,0,1,0,5,0,14,2.0,1,0.0,0,3,0,1,5,0,0,5,0,4,10,1
2206,83391,5lnG922UFflYKbVHck7tAuI1NLtyYgBb,A3fsA9Zfv1X2fVEQhTw51lKENdNrEqT3,2,0,0,0,0,0,2,0,2,0.2857142857142857,1,0.0,0,0,0,0,0,0,0,2,0,0,2,1
2207,83411,sw7EOsxnjfyxD0QxJsjO2WXRMXBWJD2E,bWdj2GDclj5ofokWjzoa5jAwMkxCykd6,12,15,5,0,4,0,3,0,27,3.857142857142857,4,0.0,0,5,0,4,15,0,0,3,0,9,18,1
2208,83466,QuvCYikodbdRYaQkbLfEjRfwbs69qsbc,SpATywNh6bZuzm8s1ceuBUnMUAeoAHHw,1,0,0,0,0,0,1,0,1,0.14285714285714285,1,0.0,0,0,0,0,0,0,0,1,0,0,1,1
2209,83513,FN4Q8gUJQiuKtRiPQS3gBMUWwSnDptW4,SpATywNh6bZuzm8s1ceuBUnMUAeoAHHw,19,19,9,13,4,0,2,0,47,6.714285714285714,1,0.0,8,9,10,4,11,0,3,2,0,31,16,1
2210,83521,OmeHT0PntcI0ieBORzxyW3ukuMNHL2Uw,SpATywNh6bZuzm8s1ceuBUnMUAeoAHHw,1,0,0,0,0,0,1,0,1,0.14285714285714285,1,0.0,0,0,0,0,0,0,0,1,0,0,1,1
2211,83527,zAxSsEdPeUZGGnFIWSFOZ9V5E0hHlR0L,SpATywNh6bZuzm8s1ceuBUnMUAeoAHHw,5,4,1,0,1,0,1,0,7,1.0,1,0.0,1,1,0,1,3,0,0,1,0,3,4,1
2212,83528,HH0bgFZJUfJrK8yCEOD0HA8raoSrd2bR,SpATywNh6bZuzm8s1ceuBUnMUAeoAHHw,11,14,4,12,0,35,8,0,73,10.428571428571429,2,0.0,5,4,9,0,9,35,3,8,0,18,55,0
2213,83531,g1LVeBlQiVCOcKiTDDTy4PafQkGd4pbr,SpATywNh6bZuzm8s1ceuBUnMUAeoAHHw,6,4,1,0,1,0,2,0,8,1.1428571428571428,1,0.0,0,1,0,1,4,0,0,2,0,2,6,1
2214,83557,VcIkh3vonmMTX4dPSjJiYVRsVaKRhYaU,SpATywNh6bZuzm8s1ceuBUnMUAeoAHHw,2,0,0,0,0,0,2,0,2,0.2857142857142857,1,0.0,0,0,0,0,0,0,0,2,0,0,2,1
2215,83577,ew5XZC7WSosl0QdXH45kYD3syMSGbOj6,A3fsA9Zfv1X2fVEQhTw51lKENdNrEqT3,40,21,12,64,10,0,2,0,109,15.571428571428571,1,0.0,1,12,54,10,20,0,10,2,0,77,32,1
2216,83602,Z1uIScALT37BtyCtbFy33E9DuvHO2hks,SpATywNh6bZuzm8s1ceuBUnMUAeoAHHw,1,0,0,0,0,0,1,0,1,0.14285714285714285,1,0.0,0,0,0,0,0,0,0,1,0,0,1,1
2217,83613,puN480TO3qbGXrXmM5qoOdmstQ51OC6E,bWdj2GDclj5ofokWjzoa5jAwMkxCykd6,22,18,10,50,2,8,21,1,110,15.714285714285714,2,0.0,0,10,47,2,18,8,3,21,1,59,51,0
2218,83623,H6I6nkJ6DtlIXdQ1opNRFdSYIFjksvYQ,SpATywNh6bZuzm8s1ceuBUnMUAeoAHHw,13,12,9,0,4,0,2,0,27,3.857142857142857,2,0.0,0,9,0,4,12,0,0,2,0,13,14,1
2219,83684,MO75JAKfd03NfkJH3IgG154Ck5oA1Wzt,SpATywNh6bZuzm8s1ceuBUnMUAeoAHHw,12,15,8,0,4,1,11,1,40,5.714285714285714,1,0.0,2,8,0,4,13,1,0,11,1,14,26,0
2220,83717,O3LrBOriu4LFn5iIVlnw3bx3Q9TUIlm3,SpATywNh6bZuzm8s1ceuBUnMUAeoAHHw,1,0,0,0,0,0,1,0,1,0.14285714285714285,1,0.0,0,0,0,0,0,0,0,1,0,0,1,1
2221,83753,WxaYTMCI7yD8mE0osZVkZT9Orbo545LC,A3fsA9Zfv1X2fVEQhTw51lKENdNrEqT3,6,6,2,0,1,0,2,0,11,1.5714285714285714,1,0.0,0,2,0,1,6,0,0,2,0,3,8,1
2222,83765,YInPZ2NvQ1CvXlUb40X1VRvv4vqAWNKy,A3fsA9Zfv1X2fVEQhTw51lKENdNrEqT3,1,0,0,0,0,0,2,0,2,0.2857142857142857,1,0.0,0,0,0,0,0,0,0,2,0,0,2,1
2223,83776,1K0aEYcUjU3Omy9tzQvSoGMqsCiOBzQn,SpATywNh6bZuzm8s1ceuBUnMUAeoAHHw,5,2,1,0,1,0,2,0,6,0.8571428571428571,1,0.0,0,1,0,1,2,0,0,2,0,2,4,1
2224,83777,GYVy4Kw2IYTFaIZeLaixuEy0D5OoDjTn,A3fsA9Zfv1X2fVEQhTw51lKENdNrEqT3,1,0,0,0,0,0,1,0,1,0.14285714285714285,1,0.0,0,0,0,0,0,0,0,1,0,0,1,1
2225,83780,LUGJNGKKEXef9vp90U0uf3eBnGjvPHqY,bWdj2GDclj5ofokWjzoa5jAwMkxCykd6,5,1,0,0,1,0,3,0,5,0.7142857142857143,1,0.0,0,0,0,1,1,0,0,3,0,1,4,1
2226,83781,rwRg5VLLMifE3rBQ9ovBdMe754UeHyD2,SpATywNh6bZuzm8s1ceuBUnMUAeoAHHw,8,9,0,0,0,0,7,0,16,2.2857142857142856,1,0.0,5,0,0,0,4,0,0,7,0,5,11,1
2227,83783,VgSuhdH7aYuXsDcf74CEOycHQbwhkHBq,A3fsA9Zfv1X2fVEQhTw51lKENdNrEqT3,2,0,0,0,0,0,2,0,2,0.2857142857142857,1,0.0,0,0,0,0,0,0,0,2,0,0,2,1
2228,83811,svi8vAETiYnBPEWWZIRd4gAyZTcaxP58,bWdj2GDclj5ofokWjzoa5jAwMkxCykd6,1,0,0,0,0,0,1,0,1,0.14285714285714285,1,0.0,0,0,0,0,0,0,0,1,0,0,1,1
2229,83868,X4KSPkBIdPEeXdEy4Fa5NvixCQZdfNj3,bWdj2GDclj5ofokWjzoa5jAwMkxCykd6,1,0,0,0,0,0,1,0,1,0.14285714285714285,1,0.0,0,0,0,0,0,0,0,1,0,0,1,1
2230,83880,ZQE4YlSay0qfyoMsVO9k7S4IfrHuRzoo,A3fsA9Zfv1X2fVEQhTw51lKENdNrEqT3,1,0,0,0,0,0,1,0,1,0.14285714285714285,1,0.0,0,0,0,0,0,0,0,1,0,0,1,1
2231,83890,hkZJZMuEk3eRSgWhjH7jPcJrlgv2RTNl,bWdj2GDclj5ofokWjzoa5jAwMkxCykd6,3,2,1,0,0,0,2,0,5,0.7142857142857143,1,0.0,0,1,0,0,2,0,0,2,0,1,4,1
2232,83899,TB2wDsOo3kDLa90fD8fPr19ZM5ZS7ZAB,A3fsA9Zfv1X2fVEQhTw51lKENdNrEqT3,2,0,0,0,0,0,2,0,2,0.2857142857142857,1,0.0,0,0,0,0,0,0,0,2,0,0,2,1
2233,83902,9fqjCwCWiE2ZIs1HrK3mm4R5MSyOKac5,A3fsA9Zfv1X2fVEQhTw51lKENdNrEqT3,6,3,2,0,1,0,2,0,8,1.1428571428571428,1,0.0,0,2,0,1,3,0,0,2,0,3,5,1
2234,83919,mFpiELMd2y5tbkdxs4m8pKS7gXHb7bIO,RXDvfPUBYFlVdlueBFbLW0mhhAyGEqpt,15,9,7,0,6,0,2,0,24,3.4285714285714284,2,0.0,0,7,0,6,9,0,0,2,0,13,11,1
2235,83928,wQsOYND6Uk5mviOI6mS6ntmifQ69LbeV,A3fsA9Zfv1X2fVEQhTw51lKENdNrEqT3,8,4,2,0,2,0,3,0,11,1.5714285714285714,1,0.0,0,2,0,2,4,0,0,3,0,4,7,1
2236,83951,I6oJUzF1kneNCI5HLEngmj8oOrT8LAPo,A3fsA9Zfv1X2fVEQhTw51lKENdNrEqT3,1,0,0,0,0,0,1,0,1,0.14285714285714285,1,0.0,0,0,0,0,0,0,0,1,0,0,1,1
2237,83979,sTq9v868sPUgTaUUmCiFRadbl8t0UoCG,SpATywNh6bZuzm8s1ceuBUnMUAeoAHHw,11,15,4,14,2,2,3,0,40,5.714285714285714,1,0.0,10,4,11,2,5,2,3,3,0,27,13,1
2238,84010,Slef5w11bVkmRsTBBwhS62k507EfhwU6,SpATywNh6bZuzm8s1ceuBUnMUAeoAHHw,7,5,3,0,2,0,2,0,12,1.7142857142857142,1,0.0,1,3,0,2,4,0,0,2,0,6,6,1
2239,84033,mFKbFysEV5gGAbHL9fgzkpXci6xFiaFe,bWdj2GDclj5ofokWjzoa5jAwMkxCykd6,3,3,1,0,0,0,2,0,6,0.8571428571428571,1,0.0,0,1,0,0,3,0,0,2,0,1,5,1
2240,84034,lDJqver3AFFUyXISNdqvZpmq6OeWVl0r,A3fsA9Zfv1X2fVEQhTw51lKENdNrEqT3,3,2,1,0,0,0,1,0,4,0.5714285714285714,1,0.0,0,1,0,0,2,0,0,1,0,1,3,0
2241,84048,dhO2y8sIijAlPYlXxsHK1aEk6O7FL2Q2,A3fsA9Zfv1X2fVEQhTw51lKENdNrEqT3,1,0,0,0,0,0,1,0,1,0.14285714285714285,1,0.0,0,0,0,0,0,0,0,1,0,0,1,1
2242,84050,dhO2y8sIijAlPYlXxsHK1aEk6O7FL2Q2,bWdj2GDclj5ofokWjzoa5jAwMkxCykd6,1,0,0,0,0,0,1,0,1,0.14285714285714285,1,0.0,0,0,0,0,0,0,0,1,0,0,1,1
2243,84058,mMS5utPEE0kau31EdquwgaN1e0nxF2V4,SpATywNh6bZuzm8s1ceuBUnMUAeoAHHw,3,2,1,0,0,0,1,0,4,0.5714285714285714,1,0.0,0,1,0,0,2,0,0,1,0,1,3,1
2244,84067,JA3GjaqmpFLtt1yojsnNXLqhMexKQ8aw,A3fsA9Zfv1X2fVEQhTw51lKENdNrEqT3,2,0,0,0,0,0,2,0,2,0.2857142857142857,1,0.0,0,0,0,0,0,0,0,2,0,0,2,1
2245,84083,bl8YOhounxXowMizQE2ibaM5H4dVfT77,SpATywNh6bZuzm8s1ceuBUnMUAeoAHHw,1,0,0,0,0,0,1,0,1,0.14285714285714285,1,0.0,0,0,0,0,0,0,0,1,0,0,1,1
2246,84112,m94Ln6mKwrTlZEJamxaNSzUQ9VRwHEQK,SpATywNh6bZuzm8s1ceuBUnMUAeoAHHw,5,1,1,0,1,0,2,0,5,0.7142857142857143,1,0.0,0,1,0,1,1,0,0,2,0,2,3,1
2247,84128,ZCUEihNB1w88UL2EoTplrSA9QYdknyaF,SpATywNh6bZuzm8s1ceuBUnMUAeoAHHw,7,4,1,0,1,1,4,2,13,1.8571428571428572,1,0.0,0,1,0,1,4,1,0,4,2,2,11,1
2248,84132,bVLtn3iBc4ibW8xWVzLLM3Hs9gCB0qb7,bWdj2GDclj5ofokWjzoa5jAwMkxCykd6,1,0,0,0,0,0,1,0,1,0.14285714285714285,1,0.0,0,0,0,0,0,0,0,1,0,0,1,1
2249,84134,KVl6nnI1zsPf8ekwqnmOATbcWkWGBTQA,SpATywNh6bZuzm8s1ceuBUnMUAeoAHHw,5,3,1,0,1,0,1,0,6,0.8571428571428571,1,0.0,0,1,0,1,3,0,0,1,0,2,4,1
2250,84144,XSeWDgxGevybVHeILVqIcSB7rPdA6Gvi,SpATywNh6bZuzm8s1ceuBUnMUAeoAHHw,1,0,0,0,0,0,1,0,1,0.14285714285714285,1,0.0,0,0,0,0,0,0,0,1,0,0,1,1
2251,84159,n51reZ5FTJkHLnQwBqURrmxGDzwEsEjy,SpATywNh6bZuzm8s1ceuBUnMUAeoAHHw,31,50,28,31,8,0,10,0,127,18.142857142857142,2,0.0,8,28,26,8,42,0,5,10,0,70,57,0
2252,84169,YTpSaD5WvcxnMj244x9U8tK7ZjCb9sw0,bWdj2GDclj5ofokWjzoa5jAwMkxCykd6,1,0,0,0,0,0,1,0,1,0.14285714285714285,1,0.0,0,0,0,0,0,0,0,1,0,0,1,1
2253,84176,Xv4cOEYZEExzsBdbjc8lrCLUZHXLo5uk,SpATywNh6bZuzm8s1ceuBUnMUAeoAHHw,5,3,2,0,0,6,6,0,17,2.4285714285714284,1,0.0,0,2,0,0,3,6,0,6,0,2,15,0
2254,84180,tZMtcgGsCq7JvLpFL4lhYMv0agvGaZe2,bWdj2GDclj5ofokWjzoa5jAwMkxCykd6,5,2,1,0,1,0,2,0,6,0.8571428571428571,1,0.0,0,1,0,1,2,0,0,2,0,2,4,1
2255,84183,xXxqqh9yVGi9oZiE57nohuMrqKDnoyIS,A3fsA9Zfv1X2fVEQhTw51lKENdNrEqT3,7,3,2,0,0,0,5,0,10,1.4285714285714286,1,0.0,0,2,0,0,3,0,0,5,0,2,8,1
2256,84184,OsngIQPLVNsvztjbyMTR3Q1awEr69xBU,SpATywNh6bZuzm8s1ceuBUnMUAeoAHHw,3,2,0,0,0,0,1,0,3,0.42857142857142855,1,0.0,0,0,0,0,2,0,0,1,0,0,3,1
2257,84285,6dxWIDqaYjsp7lwDHFYen9IBERKYGMUl,fbPkOYLVPtPgIt0MxizjfFJov3JbHyAi,4,1,1,0,1,0,1,0,4,0.5714285714285714,1,0.0,0,1,0,1,1,0,0,1,0,2,2,1
2258,84439,lmCPiW6l0WNp9Ttn0lhwFDs7FfVubtvY,SpATywNh6bZuzm8s1ceuBUnMUAeoAHHw,5,4,0,0,0,0,1,0,5,0.7142857142857143,1,0.0,0,0,0,0,4,0,0,1,0,0,5,0
2259,84617,7QvV3hsa8puVP6u6wQJmusW3X0nL3GiJ,RXDvfPUBYFlVdlueBFbLW0mhhAyGEqpt,6,4,2,0,1,0,2,0,9,1.2857142857142858,1,0.0,0,2,0,1,4,0,0,2,0,3,6,1
2260,84687,LuY5FiD3zLZEjwGtpCcfkhMm5sUdJ1VF,RXDvfPUBYFlVdlueBFbLW0mhhAyGEqpt,1,0,0,0,0,0,1,0,1,0.14285714285714285,1,0.0,0,0,0,0,0,0,0,1,0,0,1,1
2261,84697,aaRUd5jlFUSCfSYwox8KYccyK9uFgesK,G8EPVSXsOYB5YQWZGiz1aVq5Pgr2GrQu,5,2,1,0,1,0,2,0,6,0.8571428571428571,1,0.0,0,1,0,1,2,0,0,2,0,2,4,1
2262,84712,rK4055OdlTymOWiwkxW7eIve09mowPhX,bWdj2GDclj5ofokWjzoa5jAwMkxCykd6,14,18,9,40,6,4,1,0,78,11.142857142857142,1,0.0,7,9,35,6,11,4,5,1,0,57,21,1
2263,84733,9WmzxyamLAgd2LnrO6zydiN7WV3MNZZt,SpATywNh6bZuzm8s1ceuBUnMUAeoAHHw,4,2,1,0,0,1,2,0,6,0.8571428571428571,1,0.0,0,1,0,0,2,1,0,2,0,1,5,1
2264,84773,pQdSl7i5ZuZeH9uPILgdHrvwskp4vc4V,RXDvfPUBYFlVdlueBFbLW0mhhAyGEqpt,2,0,0,0,0,0,2,0,2,0.2857142857142857,1,0.0,0,0,0,0,0,0,0,2,0,0,2,1
2265,84856,IKpNQ2VJXcBrssoIsB3X4wtY2qE1YTKj,bWdj2GDclj5ofokWjzoa5jAwMkxCykd6,3,4,2,0,0,0,2,0,8,1.1428571428571428,1,0.0,0,2,0,0,4,0,0,2,0,2,6,1
2266,84920,P8HECw7bHyNqGqPTlWbv24tTg1SG6bAf,A3fsA9Zfv1X2fVEQhTw51lKENdNrEqT3,3,2,1,0,0,0,2,0,5,0.7142857142857143,1,0.0,0,1,0,0,2,0,0,2,0,1,4,1
2267,84932,fpXwVrOW9HYGTHXhtLxKXSs2JRhI6VdQ,G8EPVSXsOYB5YQWZGiz1aVq5Pgr2GrQu,2,0,0,0,0,0,2,0,2,0.2857142857142857,1,0.0,0,0,0,0,0,0,0,2,0,0,2,1
2268,84941,wdyLBUXnKZHWy3hjP9iEUMTvoZlBkTI1,A3fsA9Zfv1X2fVEQhTw51lKENdNrEqT3,47,14,11,132,9,0,2,0,168,24.0,1,0.0,3,11,106,9,11,0,26,2,0,129,39,1
2269,85000,7ZT5u11YEDTZhD4NZDPzOcLz6uLhq9Bd,RXDvfPUBYFlVdlueBFbLW0mhhAyGEqpt,9,7,4,8,1,0,1,0,21,3.0,1,0.0,1,4,7,1,6,0,1,1,0,13,8,1
2270,85143,cnF5YfjX3CQt7JMSCL8P4leqdmCPbBni,SpATywNh6bZuzm8s1ceuBUnMUAeoAHHw,6,6,1,0,1,0,3,0,11,1.5714285714285714,1,0.0,0,1,0,1,6,0,0,3,0,2,9,1
2271,85147,Yce7TA6zcxabzTyAHw2EdJ3TEisyjXyi,G8EPVSXsOYB5YQWZGiz1aVq5Pgr2GrQu,1,0,0,0,0,0,1,0,1,0.14285714285714285,1,0.0,0,0,0,0,0,0,0,1,0,0,1,1
2272,85159,t5GAapz2qu7QW3ZA52Mo1qG5gvWMLT4H,G8EPVSXsOYB5YQWZGiz1aVq5Pgr2GrQu,11,23,9,0,8,0,1,0,41,5.857142857142857,1,0.0,13,9,0,8,10,0,0,1,0,30,11,1
2273,85211,aCaozGkyCsn54GVTA7Zc8fb6f5Q5mLe0,G8EPVSXsOYB5YQWZGiz1aVq5Pgr2GrQu,2,0,0,0,0,0,2,0,2,0.2857142857142857,1,0.0,0,0,0,0,0,0,0,2,0,0,2,1
2274,85214,t5GAapz2qu7QW3ZA52Mo1qG5gvWMLT4H,SpATywNh6bZuzm8s1ceuBUnMUAeoAHHw,1,0,0,0,0,0,2,0,2,0.2857142857142857,1,0.0,0,0,0,0,0,0,0,2,0,0,2,0
2275,85253,XJf8gYhDJm1hrkVJvLQ4HKEnvPd3mIMq,G8EPVSXsOYB5YQWZGiz1aVq5Pgr2GrQu,22,32,1,50,0,0,1,0,84,12.0,1,0.0,16,1,33,0,16,0,17,1,0,50,34,1
2276,85283,9WmzxyamLAgd2LnrO6zydiN7WV3MNZZt,RXDvfPUBYFlVdlueBFbLW0mhhAyGEqpt,9,10,9,0,4,0,1,0,24,3.4285714285714284,1,0.0,0,9,0,4,10,0,0,1,0,13,11,1
2277,85297,4VgoVQWGOr2mBZAQVNzDshzPrpqcYbQA,SpATywNh6bZuzm8s1ceuBUnMUAeoAHHw,3,2,0,0,0,0,1,0,3,0.42857142857142855,1,0.0,0,0,0,0,2,0,0,1,0,0,3,1
2278,87018,puN480TO3qbGXrXmM5qoOdmstQ51OC6E,A3fsA9Zfv1X2fVEQhTw51lKENdNrEqT3,6,2,1,0,0,0,6,0,9,1.2857142857142858,2,0.0,0,1,0,0,2,0,0,6,0,1,8,0
2279,87033,zvew9uiEAc86Yp9YluqFrNFVBMozMu7i,A3fsA9Zfv1X2fVEQhTw51lKENdNrEqT3,1,0,0,0,0,0,1,0,1,0.14285714285714285,1,0.0,0,0,0,0,0,0,0,1,0,0,1,1
2280,87057,SWjmkEB4DVctTeY4CrwF2QrGDf4olJAZ,RXDvfPUBYFlVdlueBFbLW0mhhAyGEqpt,27,34,23,26,10,2,5,0,100,14.285714285714286,1,0.0,7,23,26,10,27,2,0,5,0,66,34,0
2281,87127,dNFEIzn0depAU4oAUIlHxTqSNcin3JsM,SpATywNh6bZuzm8s1ceuBUnMUAeoAHHw,1,0,0,0,0,0,1,0,1,0.14285714285714285,1,0.0,0,0,0,0,0,0,0,1,0,0,1,0
2282,87133,O6WL6sxvoPCZnvTLyTPxdXbnpOz3wcJ4,A3fsA9Zfv1X2fVEQhTw51lKENdNrEqT3,10,7,2,0,2,0,2,0,13,1.8571428571428572,1,0.0,0,2,0,2,7,0,0,2,0,4,9,0
2283,87198,BPhS68WnBhNHxaKVrJj2k4cMtvSG9MHx,A3fsA9Zfv1X2fVEQhTw51lKENdNrEqT3,1,0,0,0,0,0,1,0,1,0.14285714285714285,1,0.0,0,0,0,0,0,0,0,1,0,0,1,1
2284,87268,D8OsqlH4HwBA4SgJzaxGlNrfcU5wwsM1,A3fsA9Zfv1X2fVEQhTw51lKENdNrEqT3,8,4,1,0,1,0,5,0,11,1.5714285714285714,1,0.0,0,1,0,1,4,0,0,5,0,2,9,1
2285,87290,VMnSHKgiFqLTglPUaPUtMkU91MLAPOwr,A3fsA9Zfv1X2fVEQhTw51lKENdNrEqT3,1,0,0,0,0,0,1,0,1,0.14285714285714285,1,0.0,0,0,0,0,0,0,0,1,0,0,1,1
2286,87349,FrSJpsrFHBf3i9duciIn6pd6hWdG8OCf,SpATywNh6bZuzm8s1ceuBUnMUAeoAHHw,12,8,6,0,5,0,4,0,23,3.2857142857142856,2,0.0,0,6,0,5,8,0,0,4,0,11,12,1
2287,87491,FlceAJAIuFEY4b8DElr16vmZGD1aqVDJ,A3fsA9Zfv1X2fVEQhTw51lKENdNrEqT3,2,0,0,0,0,0,2,0,2,0.2857142857142857,1,0.0,0,0,0,0,0,0,0,2,0,0,2,1
2288,87584,NtOBKvqn4kjpyBFY5EbWAhwnHWFAQxgf,A3fsA9Zfv1X2fVEQhTw51lKENdNrEqT3,1,0,0,0,0,0,3,0,3,0.42857142857142855,2,0.0,0,0,0,0,0,0,0,3,0,0,3,1
2289,87596,omogDjehriHed7WOB06lowOCzWJT5HFG,SpATywNh6bZuzm8s1ceuBUnMUAeoAHHw,1,0,0,0,0,0,1,0,1,0.14285714285714285,1,0.0,0,0,0,0,0,0,0,1,0,0,1,1
2290,87630,IUn6MADAjAYkGlJisA1WiDvCeNlJd5Xd,A3fsA9Zfv1X2fVEQhTw51lKENdNrEqT3,6,3,1,0,1,0,4,0,9,1.2857142857142858,1,0.0,0,1,0,1,3,0,0,4,0,2,7,1
2291,87695,oL1G89Phk4nduULmJ17br7A4xddcHdc4,A3fsA9Zfv1X2fVEQhTw51lKENdNrEqT3,7,4,3,0,2,0,1,0,10,1.4285714285714286,1,0.0,0,3,0,2,4,0,0,1,0,5,5,0
2292,87724,LC5o73xONnaYfCUJGUgN0IxEKcRaag3p,SpATywNh6bZuzm8s1ceuBUnMUAeoAHHw,7,5,1,0,1,0,3,0,10,1.4285714285714286,1,0.0,0,1,0,1,5,0,0,3,0,2,8,1
2293,87802,3JEt0I9b0JhZhM0RD2D5jI5S8zjjeHFo,SpATywNh6bZuzm8s1ceuBUnMUAeoAHHw,5,4,1,0,0,0,1,0,6,0.8571428571428571,1,0.0,0,1,0,0,4,0,0,1,0,1,5,0
2294,87845,px7NQdp7hj15LfG8wdonX24QornqR4Mh,A3fsA9Zfv1X2fVEQhTw51lKENdNrEqT3,4,5,1,0,0,0,1,0,7,1.0,1,0.0,0,1,0,0,5,0,0,1,0,1,6,1
2295,87858,0LERVBlr0s6pvZPTHfS8Y74dmJWxJhcj,A3fsA9Zfv1X2fVEQhTw51lKENdNrEqT3,63,30,18,168,9,1,21,2,249,35.57142857142857,2,0.0,2,18,166,9,28,1,2,21,2,195,54,0
2296,87885,6pqyTvtsNsVOIJ2FRrlzuEgPKDTZeNek,A3fsA9Zfv1X2fVEQhTw51lKENdNrEqT3,2,0,0,0,0,0,2,0,2,0.2857142857142857,1,0.0,0,0,0,0,0,0,0,2,0,0,2,1
2297,87896,sUisvEEUk43TysdqdEKz0DR2Te843pgb,A3fsA9Zfv1X2fVEQhTw51lKENdNrEqT3,4,7,1,0,0,0,2,0,10,1.4285714285714286,1,0.0,0,1,0,0,7,0,0,2,0,1,9,1
2298,88076,qBuydljzKIRip5ZglverOwggslbNziA6,A3fsA9Zfv1X2fVEQhTw51lKENdNrEqT3,1,0,0,0,0,0,5,0,5,0.7142857142857143,1,0.0,0,0,0,0,0,0,0,5,0,0,5,1
2299,88097,dCAqk9uHiS99GMTcJQtThG8XWnwwbp5Q,A3fsA9Zfv1X2fVEQhTw51lKENdNrEqT3,10,23,0,0,0,0,4,0,27,3.857142857142857,1,0.0,0,0,0,0,23,0,0,4,0,0,27,1
2300,88166,fVHUMs4z7aTjXofyWNn8EBPM3SN6fL56,A3fsA9Zfv1X2fVEQhTw51lKENdNrEqT3,1,0,0,0,0,0,1,0,1,0.14285714285714285,1,0.0,0,0,0,0,0,0,0,1,0,0,1,1
2301,88172,mB36rXDIKgGQROGEKlrDrvsLRYA6xyWr,A3fsA9Zfv1X2fVEQhTw51lKENdNrEqT3,47,28,17,88,10,2,23,4,172,24.571428571428573,3,0.0,4,17,76,10,24,2,12,23,4,107,65,0
2302,88193,aQvvfNyOjWznHFpUuaLIM1cVrgSp2dSp,SpATywNh6bZuzm8s1ceuBUnMUAeoAHHw,9,14,0,9,0,0,6,2,31,4.428571428571429,1,0.0,3,0,7,0,11,0,2,6,2,10,21,0
2303,88213,6mJ65eKOiDJ0B2UMjBjMI3Dy4vxZcYQe,A3fsA9Zfv1X2fVEQhTw51lKENdNrEqT3,5,3,2,0,1,0,1,0,7,1.0,1,0.0,0,2,0,1,3,0,0,1,0,3,4,0
2304,88216,M8C9BDFICk4ida59GU0jjp556zazDEi1,RXDvfPUBYFlVdlueBFbLW0mhhAyGEqpt,13,17,11,0,6,0,2,0,36,5.142857142857143,1,0.0,4,11,0,6,13,0,0,2,0,21,15,1
2305,88254,1YjqOVdQNZSxHR5EL885UCWZImOftZfX,A3fsA9Zfv1X2fVEQhTw51lKENdNrEqT3,1,0,0,0,0,0,1,0,1,0.14285714285714285,1,0.0,0,0,0,0,0,0,0,1,0,0,1,1
2306,89233,8eAdemzlZoqb3LPXg3UGAyOaCroYfZmg,RXDvfPUBYFlVdlueBFbLW0mhhAyGEqpt,6,3,2,0,1,0,2,0,8,1.1428571428571428,1,0.0,0,2,0,1,3,0,0,2,0,3,5,1
2307,89326,wNXelOaGj6HkY91hCddHRdOCiLagph7q,SpATywNh6bZuzm8s1ceuBUnMUAeoAHHw,5,1,1,0,1,0,2,0,5,0.7142857142857143,1,0.0,0,1,0,1,1,0,0,2,0,2,3,0
2308,89333,NkHKHGQ1t9WfF0WY6b3ThoMuQiXODoZm,SpATywNh6bZuzm8s1ceuBUnMUAeoAHHw,14,18,1,12,1,0,5,0,37,5.285714285714286,1,0.0,4,1,12,1,14,0,0,5,0,18,19,1
2309,89462,bX1EJ8H8O7LvPaK2JoRVQC0BaLpmhHE6,SpATywNh6bZuzm8s1ceuBUnMUAeoAHHw,6,8,1,0,0,0,5,0,14,2.0,3,0.0,2,1,0,0,6,0,0,5,0,3,11,0
2310,89571,YuqMJYvTgiTQGQOAOb2fKJpGas8AG3Wr,SpATywNh6bZuzm8s1ceuBUnMUAeoAHHw,6,3,1,0,1,0,2,0,7,1.0,1,0.0,0,1,0,1,3,0,0,2,0,2,5,0
2311,89683,JGkH5G6iVBgcA8nzn9agd5N20Wo6tva5,SpATywNh6bZuzm8s1ceuBUnMUAeoAHHw,3,2,1,0,0,0,2,0,5,0.7142857142857143,1,0.0,0,1,0,0,2,0,0,2,0,1,4,1
2312,89711,Jm4nQ05ndX10jbofbWx6S0r9VXrqia6S,RXDvfPUBYFlVdlueBFbLW0mhhAyGEqpt,10,6,4,9,1,0,1,0,21,3.0,1,0.0,1,4,8,1,5,0,1,1,0,14,7,0
2313,89834,lt4iWOuay8QhJ4JJzXkh1WtUiAfTTub9,G8EPVSXsOYB5YQWZGiz1aVq5Pgr2GrQu,7,3,0,0,0,0,11,1,15,2.142857142857143,1,0.0,0,0,0,0,3,0,0,11,1,0,15,0
2314,90026,RyilkQdPLBJZ4lFr5oZI0Ei4sfkfiESh,SpATywNh6bZuzm8s1ceuBUnMUAeoAHHw,9,6,4,0,2,0,1,0,13,1.8571428571428572,1,0.0,0,4,0,2,6,0,0,1,0,6,7,0
2315,90031,4dfnEKxHCmGabkBCiKHt5nKr3H7Bwo1x,SpATywNh6bZuzm8s1ceuBUnMUAeoAHHw,4,3,2,0,0,0,1,0,6,0.8571428571428571,1,0.0,0,2,0,0,3,0,0,1,0,2,4,0
2316,90116,T7izEMyckZ14Dpb0HXCCbCEgRCtemG2v,RXDvfPUBYFlVdlueBFbLW0mhhAyGEqpt,2,2,0,0,0,0,0,0,2,0.2857142857142857,1,0.0,0,0,0,0,2,0,0,0,0,0,2,1
2317,90121,PD0QXI0Ip2PVwJ6kJaKkkINkj7BvGZMC,bWdj2GDclj5ofokWjzoa5jAwMkxCykd6,39,32,1,302,2,0,15,0,352,50.285714285714285,1,0.0,15,1,274,2,17,0,28,15,0,292,60,1
2318,90144,clUDzV1xLWOCz6yJz1NXsCWqgZVFuU6d,SpATywNh6bZuzm8s1ceuBUnMUAeoAHHw,5,3,2,0,1,0,1,0,7,1.0,1,0.0,0,2,0,1,3,0,0,1,0,3,4,0
2319,90163,oSabIe7L5topw6hwV4H4ZV0Ug7ZVNxfV,SpATywNh6bZuzm8s1ceuBUnMUAeoAHHw,5,4,0,0,0,0,1,0,5,0.7142857142857143,1,0.0,0,0,0,0,4,0,0,1,0,0,5,0
2320,90164,EJkZzukbCIAgIlh7QDQUWfa1bYDEcyN6,SpATywNh6bZuzm8s1ceuBUnMUAeoAHHw,6,3,2,0,1,0,3,0,9,1.2857142857142858,1,0.0,0,2,0,1,3,0,0,3,0,3,6,1
2321,90281,0nJUVE3hT3v1fqbd9NpHDszm9KS6NNTn,SpATywNh6bZuzm8s1ceuBUnMUAeoAHHw,5,6,3,0,0,0,1,0,10,1.4285714285714286,1,0.0,2,3,0,0,4,0,0,1,0,5,5,1
2322,90301,nNRUhTxrQUyQlj0B4LUbcGCoMBsVhXak,SpATywNh6bZuzm8s1ceuBUnMUAeoAHHw,7,14,5,0,1,0,4,0,24,3.4285714285714284,2,0.0,5,5,0,1,9,0,0,4,0,11,13,1
2323,90368,aVj2n54Hek70fJUdNTLLf71YkfuWdwdm,bWdj2GDclj5ofokWjzoa5jAwMkxCykd6,6,6,3,0,1,0,2,0,12,1.7142857142857142,1,0.0,0,3,0,1,6,0,0,2,0,4,8,1
2324,90384,HOZheAyAGMSpb5Rm4jAeFCDd0CkpsnTU,SpATywNh6bZuzm8s1ceuBUnMUAeoAHHw,15,22,0,21,0,36,6,1,86,12.285714285714286,1,0.0,8,0,18,0,14,36,3,6,1,26,60,1
2325,90688,j8vYdYwa9gvt7hkF8dykZR2D4h75QsII,RXDvfPUBYFlVdlueBFbLW0mhhAyGEqpt,5,3,2,0,1,0,1,0,7,1.0,1,0.0,0,2,0,1,3,0,0,1,0,3,4,1
2326,90724,5vkNIYp2bYY1LtZU7tLxethQegJYgNo1,bWdj2GDclj5ofokWjzoa5jAwMkxCykd6,5,3,2,10,0,0,1,0,16,2.2857142857142856,1,0.0,0,2,8,0,3,0,2,1,0,10,6,1
2327,90734,lHTZAvBbd0zcUoZ0ZCqy0WxYTp3sveXN,RXDvfPUBYFlVdlueBFbLW0mhhAyGEqpt,21,30,14,1,9,1,6,0,61,8.714285714285714,1,0.0,6,14,1,9,24,1,0,6,0,30,31,1
2328,90999,CwyOL3RMOVLomxrxyN9D4jPa9R0iWrS5,G8EPVSXsOYB5YQWZGiz1aVq5Pgr2GrQu,7,6,5,0,4,0,1,0,16,2.2857142857142856,1,0.0,0,5,0,4,6,0,0,1,0,9,7,0
2329,91092,mXfwwTIVjHMqoVKAh2iEQbinKUCJHwTp,SpATywNh6bZuzm8s1ceuBUnMUAeoAHHw,5,3,2,0,1,0,1,0,7,1.0,1,0.0,0,2,0,1,3,0,0,1,0,3,4,1
2330,91113,LDDV5GLR4T4AoJ4swm7PTuKciMVwXQ01,G8EPVSXsOYB5YQWZGiz1aVq5Pgr2GrQu,12,15,4,0,3,1,8,0,31,4.428571428571429,3,0.0,0,4,0,3,15,1,0,8,0,7,24,0
2331,91211,YlWJRLkP5QIlBcoTrKDrquHDRSLUHmOs,SpATywNh6bZuzm8s1ceuBUnMUAeoAHHw,1,0,0,0,0,0,1,0,1,0.14285714285714285,1,0.0,0,0,0,0,0,0,0,1,0,0,1,0
2332,91383,BcJnhjzA1hw0WNze9uWUZQ49uBAiBHyH,SpATywNh6bZuzm8s1ceuBUnMUAeoAHHw,6,6,0,0,1,2,1,0,10,1.4285714285714286,1,0.0,2,0,0,1,4,2,0,1,0,3,7,0
2333,91414,HSyljcmKCDSksgg7xJb6gUib0wBvYjVv,G8EPVSXsOYB5YQWZGiz1aVq5Pgr2GrQu,7,8,5,0,1,0,3,0,17,2.4285714285714284,1,0.0,0,5,0,1,8,0,0,3,0,6,11,1
2334,91480,3NG42RQfrkx04BX4rgjNYVd7JioduuEW,SpATywNh6bZuzm8s1ceuBUnMUAeoAHHw,20,40,23,9,7,0,10,0,89,12.714285714285714,5,0.0,3,23,9,7,37,0,0,10,0,42,47,0
2335,91484,Ja9aSTrbcYBJIk0knND32MhX73YVzDja,SpATywNh6bZuzm8s1ceuBUnMUAeoAHHw,3,2,1,0,0,0,1,0,4,0.5714285714285714,1,0.0,0,1,0,0,2,0,0,1,0,1,3,1
2336,92842,5fh1jlCU7jXB4QIW6qiZqp3idmC7zGIG,SpATywNh6bZuzm8s1ceuBUnMUAeoAHHw,1,0,0,0,0,0,1,0,1,0.14285714285714285,1,0.0,0,0,0,0,0,0,0,1,0,0,1,1
2337,92858,PO9UqxqUlWjKdLcKUuvXjpBUsCJBV13h,SpATywNh6bZuzm8s1ceuBUnMUAeoAHHw,8,13,1,0,0,0,2,0,16,2.2857142857142856,2,0.0,3,1,0,0,10,0,0,2,0,4,12,0
2338,92883,TY1XSpzUxZYHUqU0tQYtstvuwKCsGYpR,G8EPVSXsOYB5YQWZGiz1aVq5Pgr2GrQu,28,17,16,0,12,0,3,0,48,6.857142857142857,1,0.0,0,16,0,12,17,0,0,3,0,28,20,1
2339,92942,erkNYBqLpKRElyeL8GeAgO43CMazg6Rt,SpATywNh6bZuzm8s1ceuBUnMUAeoAHHw,5,4,3,0,0,0,4,0,11,1.5714285714285714,1,0.0,0,3,0,0,4,0,0,4,0,3,8,1
2340,93008,OdMr7dE5UlAme9Tp979vREBvY5CV50po,SpATywNh6bZuzm8s1ceuBUnMUAeoAHHw,1,0,0,0,0,0,2,0,2,0.2857142857142857,1,0.0,0,0,0,0,0,0,0,2,0,0,2,0
2341,93243,IsU1RKSKxT8SmvRzyXcC6emxRwMddmTJ,G8EPVSXsOYB5YQWZGiz1aVq5Pgr2GrQu,5,2,1,0,0,0,3,1,7,1.0,1,0.0,0,1,0,0,2,0,0,3,1,1,6,0
2342,93406,wCSstPXY2jshjpNaBAQvMm9l3Kvl06VT,bWdj2GDclj5ofokWjzoa5jAwMkxCykd6,9,19,17,0,13,0,1,0,50,7.142857142857143,4,0.0,0,17,0,13,19,0,0,1,0,30,20,1
2343,93555,mG2KwufBG46hwF0tMEUG2jvsfUa3PSHf,SpATywNh6bZuzm8s1ceuBUnMUAeoAHHw,7,6,0,0,0,0,1,0,7,1.0,1,0.0,0,0,0,0,6,0,0,1,0,0,7,0
2344,93611,mG2KwufBG46hwF0tMEUG2jvsfUa3PSHf,RXDvfPUBYFlVdlueBFbLW0mhhAyGEqpt,9,11,1,0,0,0,1,0,13,1.8571428571428572,1,0.0,0,1,0,0,11,0,0,1,0,1,12,0
2345,93620,HJ2Te0AnFOdWtPQ1mbU0gvcfD3BsPlu2,SpATywNh6bZuzm8s1ceuBUnMUAeoAHHw,10,9,6,0,3,0,3,0,21,3.0,2,0.0,0,6,0,3,9,0,0,3,0,9,12,0
2346,93689,KXi2lu4GlKmrO1lJTLg3t4l701rvNXNZ,A3fsA9Zfv1X2fVEQhTw51lKENdNrEqT3,3,2,1,0,0,0,2,0,5,0.7142857142857143,2,0.0,0,1,0,0,2,0,0,2,0,1,4,0
2347,93702,5JlWaFjebQSvyUeyQLJ4C0BlriWkf8Hy,SpATywNh6bZuzm8s1ceuBUnMUAeoAHHw,6,4,1,0,1,0,1,0,7,1.0,1,0.0,0,1,0,1,4,0,0,1,0,2,5,1
2348,93753,fCj90D5XHmebJ0IrbbuHaVfcb7tqMxkl,bWdj2GDclj5ofokWjzoa5jAwMkxCykd6,3,2,1,0,0,0,1,0,4,0.5714285714285714,1,0.0,0,1,0,0,2,0,0,1,0,1,3,1
2349,93996,xV4buLLcPPEcE2C8BKOwlQiGdSlriMdM,RXDvfPUBYFlVdlueBFbLW0mhhAyGEqpt,1,0,0,0,0,0,1,0,1,0.14285714285714285,1,0.0,0,0,0,0,0,0,0,1,0,0,1,1
2350,94003,aj6uF4XWV3XUUfOpWCk3NuntI2wXym6n,A3fsA9Zfv1X2fVEQhTw51lKENdNrEqT3,4,4,0,0,0,0,1,0,5,0.7142857142857143,1,0.0,1,0,0,0,3,0,0,1,0,1,4,1
2351,94328,plAreEiDkQpc8zc9xmMhqujDBy2S6jmC,SpATywNh6bZuzm8s1ceuBUnMUAeoAHHw,5,4,2,0,0,0,1,0,7,1.0,1,0.0,0,2,0,0,4,0,0,1,0,2,5,1
2352,94408,kdTkyJM1xm4AQ2tXVSlZpNtOhQ8qhZ4V,SpATywNh6bZuzm8s1ceuBUnMUAeoAHHw,5,3,2,0,1,0,1,0,7,1.0,1,0.0,0,2,0,1,3,0,0,1,0,3,4,0
2353,94443,FZWt1vapJFvo3kXFvlr3Pcq5dqSsXIdl,SpATywNh6bZuzm8s1ceuBUnMUAeoAHHw,6,3,1,0,0,0,3,1,8,1.1428571428571428,1,0.0,0,1,0,0,3,0,0,3,1,1,7,1
2354,94486,gl2YVlebVAvCcxsYaIoTwLj5l1IGqntH,SpATywNh6bZuzm8s1ceuBUnMUAeoAHHw,18,24,13,23,0,0,4,0,64,9.142857142857142,2,0.0,8,13,22,0,16,0,1,4,0,43,21,0
2355,95386,lVwgv61cg8fkhW9rg5b1PIPnuUWxb0Vk,A3fsA9Zfv1X2fVEQhTw51lKENdNrEqT3,11,8,6,0,2,0,1,0,17,2.4285714285714284,2,0.0,0,6,0,2,8,0,0,1,0,8,9,0
2356,95425,79rw5BhFSnhvdIaVsXl3jeEXJRviIjGz,A3fsA9Zfv1X2fVEQhTw51lKENdNrEqT3,7,4,3,0,0,0,5,0,12,1.7142857142857142,1,0.0,0,3,0,0,4,0,0,5,0,3,9,0
2357,95605,UaSh8dwx8gnofYbXlmpqj9uYDbpJ89pX,A3fsA9Zfv1X2fVEQhTw51lKENdNrEqT3,3,2,0,0,0,1,1,0,4,0.5714285714285714,1,0.0,0,0,0,0,2,1,0,1,0,0,4,1
2358,95899,qwWysWdLmrwh0JmjPYNGVFqdat8Jy8Lb,bWdj2GDclj5ofokWjzoa5jAwMkxCykd6,5,3,0,0,1,0,1,0,5,0.7142857142857143,1,0.0,0,0,0,1,3,0,0,1,0,1,4,0
2359,95958,Ar7wri6od2sIMOfx95hPmMwDttR4wtOC,A3fsA9Zfv1X2fVEQhTw51lKENdNrEqT3,16,4,3,44,0,0,2,0,53,7.571428571428571,1,0.0,0,3,38,0,4,0,6,2,0,41,12,0
2360,96073,FZWt1vapJFvo3kXFvlr3Pcq5dqSsXIdl,G8EPVSXsOYB5YQWZGiz1aVq5Pgr2GrQu,1,0,0,0,0,0,1,0,1,0.14285714285714285,1,0.0,0,0,0,0,0,0,0,1,0,0,1,1
2361,96929,uaGHWOyiH6GRJNYQ5wYQgdGgJiyGijb7,SpATywNh6bZuzm8s1ceuBUnMUAeoAHHw,1,0,0,0,0,0,1,0,1,0.14285714285714285,1,0.0,0,0,0,0,0,0,0,1,0,0,1,0
2362,97224,PKH12j56WyhhHbwNNO7EjzMEo1oeOneA,A3fsA9Zfv1X2fVEQhTw51lKENdNrEqT3,4,4,1,0,0,0,1,0,6,0.8571428571428571,1,0.0,0,1,0,0,4,0,0,1,0,1,5,1
2363,97533,LzIeScVJDrRe6pKpJZPOE5digO2qGiFj,A3fsA9Zfv1X2fVEQhTw51lKENdNrEqT3,31,16,14,60,12,0,2,0,104,14.857142857142858,1,0.0,1,14,55,12,15,0,5,2,0,82,22,0
2364,97840,Ffohn9JNnGJQD2IavzMTS00ubnVtcb2T,A3fsA9Zfv1X2fVEQhTw51lKENdNrEqT3,33,13,9,64,5,0,3,0,94,13.428571428571429,3,0.0,1,9,58,5,12,0,6,3,0,73,21,0
2365,99015,fe6JA2o6NTgNBdf1OgbAshmKUEnJCT1r,bWdj2GDclj5ofokWjzoa5jAwMkxCykd6,4,5,1,0,0,0,1,0,7,1.0,1,0.0,0,1,0,0,5,0,0,1,0,1,6,1
2366,99204,cKCzrCCCXe9nkBgWepq9AEXje7SITRTz,bWdj2GDclj5ofokWjzoa5jAwMkxCykd6,1,0,0,0,0,0,1,0,1,0.14285714285714285,1,0.0,0,0,0,0,0,0,0,1,0,0,1,1
2367,99206,cKCzrCCCXe9nkBgWepq9AEXje7SITRTz,G8EPVSXsOYB5YQWZGiz1aVq5Pgr2GrQu,1,0,0,0,0,0,1,0,1,0.14285714285714285,1,0.0,0,0,0,0,0,0,0,1,0,0,1,1
2368,99269,Ft3L9H2tidLSHsWi4FR179aCWB2oFssD,SpATywNh6bZuzm8s1ceuBUnMUAeoAHHw,1,0,0,0,0,0,1,0,1,0.14285714285714285,1,0.0,0,0,0,0,0,0,0,1,0,0,1,1
2369,99336,3gXjYz3VFr0TvsDYUgKtksPt5WrPBmEo,SpATywNh6bZuzm8s1ceuBUnMUAeoAHHw,3,2,1,0,0,0,1,0,4,0.5714285714285714,1,0.0,0,1,0,0,2,0,0,1,0,1,3,0
2370,99464,VFYk1GyeJyGqK1t09cLe0E5m7KsULmvc,SpATywNh6bZuzm8s1ceuBUnMUAeoAHHw,12,14,8,0,5,0,2,0,29,4.142857142857143,2,0.0,0,8,0,5,14,0,0,2,0,13,16,1
2371,99722,F5WXvUA8z1Vfdvlva1pujweut7tGE04r,A3fsA9Zfv1X2fVEQhTw51lKENdNrEqT3,1,0,0,0,0,0,1,0,1,0.14285714285714285,1,0.0,0,0,0,0,0,0,0,1,0,0,1,1
2372,100065,C79HFTpOf1aC6aMRuXhus1qHumhqEAFk,SpATywNh6bZuzm8s1ceuBUnMUAeoAHHw,7,6,1,0,1,0,2,0,10,1.4285714285714286,1,0.0,0,1,0,1,6,0,0,2,0,2,8,0
2373,100105,MKNBl3hhuuRZuBxyPOWBVV1OHzyXBuxg,SpATywNh6bZuzm8s1ceuBUnMUAeoAHHw,25,40,20,6,8,0,5,0,79,11.285714285714286,2,0.0,7,20,6,8,33,0,0,5,0,41,38,0
2374,100200,walE7JsvJqHl8yLz0PR8Oim32Lz4OIQ0,SpATywNh6bZuzm8s1ceuBUnMUAeoAHHw,9,19,6,0,1,0,3,0,29,4.142857142857143,1,0.0,11,6,0,1,8,0,0,3,0,18,11,1
2375,100216,iukICc3JPXkGjh0WhluWsphhopQF3KWw,SpATywNh6bZuzm8s1ceuBUnMUAeoAHHw,1,0,0,0,0,0,1,0,1,0.14285714285714285,1,0.0,0,0,0,0,0,0,0,1,0,0,1,1
2376,100294,G7KJV0aUuu9N2GhQ0BQmtfVIkYBSsISM,SpATywNh6bZuzm8s1ceuBUnMUAeoAHHw,6,16,7,0,0,0,1,0,24,3.4285714285714284,1,0.0,5,7,0,0,11,0,0,1,0,12,12,1
2377,100389,Q9YOU7BuWjkOYwh9pr1oIgYKYXPPRz5K,RXDvfPUBYFlVdlueBFbLW0mhhAyGEqpt,8,5,2,11,1,0,1,0,20,2.857142857142857,1,0.0,1,2,10,1,4,0,1,1,0,14,6,0
2378,100518,6DFg8IrvITdyV3FmRQrzgnl2oAgir5Pb,SpATywNh6bZuzm8s1ceuBUnMUAeoAHHw,2,0,0,0,0,0,2,0,2,0.2857142857142857,1,0.0,0,0,0,0,0,0,0,2,0,0,2,0
2379,100640,NfAbLg5OeUTUtF15GhHCETvzoFPtTDPd,SpATywNh6bZuzm8s1ceuBUnMUAeoAHHw,1,0,0,0,0,0,2,0,2,0.2857142857142857,2,0.0,0,0,0,0,0,0,0,2,0,0,2,1
2380,100749,1AsQo0zAkltKFUhbJK8sQo8EMtQlw4Zw,A3fsA9Zfv1X2fVEQhTw51lKENdNrEqT3,3,2,1,0,0,0,2,0,5,0.7142857142857143,1,0.0,0,1,0,0,2,0,0,2,0,1,4,1
2381,100859,xRb4cp7PVGLqlqc7BJgnld2XsE0F6wB3,SpATywNh6bZuzm8s1ceuBUnMUAeoAHHw,6,10,3,0,0,0,0,0,13,1.8571428571428572,1,0.0,0,3,0,0,10,0,0,0,0,3,10,0
2382,100863,VOKNou0BOm9l4CocxGjdRfkeAbtz86uT,SpATywNh6bZuzm8s1ceuBUnMUAeoAHHw,7,3,1,0,0,1,7,1,13,1.8571428571428572,1,0.0,0,1,0,0,3,1,0,7,1,1,12,1
2383,100989,MaNbEqxyOcaRJ63ZfC9DudJtV0A5y3yK,SpATywNh6bZuzm8s1ceuBUnMUAeoAHHw,17,17,9,21,0,7,6,1,61,8.714285714285714,1,0.0,6,9,18,0,11,7,3,6,1,33,28,0
2384,101045,PCtqctDcjJHl3GW7yk0aug87eqbAmlqT,SpATywNh6bZuzm8s1ceuBUnMUAeoAHHw,1,0,0,0,0,0,1,0,1,0.14285714285714285,1,0.0,0,0,0,0,0,0,0,1,0,0,1,1
2385,102867,jSPgiXDCISXGmLFuOlDszBfMRRboKynI,A3fsA9Zfv1X2fVEQhTw51lKENdNrEqT3,1,0,0,0,0,0,1,0,1,0.14285714285714285,1,0.0,0,0,0,0,0,0,0,1,0,0,1,1
2386,102875,ovOrxCTVGxQyC9labPGJ3gKHEzv9s9aZ,bWdj2GDclj5ofokWjzoa5jAwMkxCykd6,1,0,0,0,0,0,1,0,1,0.14285714285714285,1,0.0,0,0,0,0,0,0,0,1,0,0,1,1
2387,102900,xwcqyIIcIUCDL9lZCj9OZxM9SjcoYp0H,SpATywNh6bZuzm8s1ceuBUnMUAeoAHHw,1,0,0,0,0,0,1,0,1,0.14285714285714285,1,0.0,0,0,0,0,0,0,0,1,0,0,1,1
2388,102920,e4IPxveF8RO3es6V6Od4YTjwU9tdhLXH,SpATywNh6bZuzm8s1ceuBUnMUAeoAHHw,1,0,0,0,0,0,1,0,1,0.14285714285714285,1,0.0,0,0,0,0,0,0,0,1,0,0,1,1
2389,102926,qoU1vhHFDDec5VkeyGO4XQ5CxMj2dkga,SpATywNh6bZuzm8s1ceuBUnMUAeoAHHw,1,0,0,0,0,0,1,0,1,0.14285714285714285,1,0.0,0,0,0,0,0,0,0,1,0,0,1,1
2390,102932,0zaZMwzUlPvudODMBJsoUQT9Stnqz6b0,SpATywNh6bZuzm8s1ceuBUnMUAeoAHHw,3,2,1,0,0,0,2,0,5,0.7142857142857143,1,0.0,0,1,0,0,2,0,0,2,0,1,4,1
2391,102935,44A0UDfpSdZoyeaVNyFZyzOHFRBDzohf,A3fsA9Zfv1X2fVEQhTw51lKENdNrEqT3,2,0,0,0,0,0,3,0,3,0.42857142857142855,1,0.0,0,0,0,0,0,0,0,3,0,0,3,1
2392,102962,hQlXSGkScEDJBAZj2lP5Zs9i72B5KYMn,bWdj2GDclj5ofokWjzoa5jAwMkxCykd6,15,9,5,8,6,78,7,1,114,16.285714285714285,2,0.0,3,5,7,6,6,78,1,7,1,21,93,1
2393,102986,mLfiafLgtlHk6mFhbivnwgftpNV0VfBx,A3fsA9Zfv1X2fVEQhTw51lKENdNrEqT3,5,5,1,0,0,0,1,0,7,1.0,1,0.0,0,1,0,0,5,0,0,1,0,1,6,1
2394,103003,vkX2gJv5gCZeM2YeKQWeGJdzNJhrpKeU,SpATywNh6bZuzm8s1ceuBUnMUAeoAHHw,3,0,0,0,0,1,2,0,3,0.42857142857142855,1,0.0,0,0,0,0,0,1,0,2,0,0,3,0
2395,103004,9tN6QbOi425qNnZ8oxcgeFVfUtI2koh7,RXDvfPUBYFlVdlueBFbLW0mhhAyGEqpt,3,3,1,0,0,0,2,0,6,0.8571428571428571,1,0.0,0,1,0,0,3,0,0,2,0,1,5,0
2396,103011,A3hbg0sRzJCuZelHR2utUpF4kEQMHGoX,A3fsA9Zfv1X2fVEQhTw51lKENdNrEqT3,5,4,2,0,1,0,2,0,9,1.2857142857142858,1,0.0,0,2,0,1,4,0,0,2,0,3,6,1
2397,103046,4dcb5500hUVpclJ4asFWqYt7G3CBRrnY,SpATywNh6bZuzm8s1ceuBUnMUAeoAHHw,1,0,0,0,0,0,1,0,1,0.14285714285714285,1,0.0,0,0,0,0,0,0,0,1,0,0,1,1
2398,103066,gLAW4GOuyz8JKg5RO5Sf2rzir65isCiq,SpATywNh6bZuzm8s1ceuBUnMUAeoAHHw,1,0,0,0,0,0,1,0,1,0.14285714285714285,1,0.0,0,0,0,0,0,0,0,1,0,0,1,1
2399,103131,KKoJVU8RPVKYX0YtUEw7IyEbFA7WdrnE,SpATywNh6bZuzm8s1ceuBUnMUAeoAHHw,3,2,1,0,0,0,1,0,4,0.5714285714285714,1,0.0,0,1,0,0,2,0,0,1,0,1,3,0
2400,103133,pmbdGuMJDBIMvlssCxECy27GzvD3oiIB,SpATywNh6bZuzm8s1ceuBUnMUAeoAHHw,7,7,6,0,5,0,1,0,19,2.7142857142857144,1,0.0,0,6,0,5,7,0,0,1,0,11,8,1
2401,103138,EFMEoi5W4mceo8rjft5LKrYvvT3E2eat,RXDvfPUBYFlVdlueBFbLW0mhhAyGEqpt,2,0,0,0,0,0,2,0,2,0.2857142857142857,1,0.0,0,0,0,0,0,0,0,2,0,0,2,1
2402,103212,3GMOahsvICu1XQltlxIUR4GKvebsHIVx,SpATywNh6bZuzm8s1ceuBUnMUAeoAHHw,7,5,2,0,2,0,2,0,11,1.5714285714285714,1,0.0,0,2,0,2,5,0,0,2,0,4,7,1
2403,103220,8c2gk77rfHeG4kEZpifVHT547X2ayTNE,A3fsA9Zfv1X2fVEQhTw51lKENdNrEqT3,74,39,28,180,15,21,10,1,294,42.0,4,0.0,2,28,157,15,37,21,23,10,1,202,92,1
2404,103228,1xVduM1Mt4TlM51sUaZjO9TKdOfcUOIw,RXDvfPUBYFlVdlueBFbLW0mhhAyGEqpt,1,0,0,0,0,0,1,0,1,0.14285714285714285,1,0.0,0,0,0,0,0,0,0,1,0,0,1,1
2405,103272,tm8lPw8iVlVgbaJMBVyV1VDYMbk4uQOB,bWdj2GDclj5ofokWjzoa5jAwMkxCykd6,7,7,2,0,2,0,4,0,15,2.142857142857143,1,0.0,0,2,0,2,7,0,0,4,0,4,11,1
2406,103284,KmIlNo2pbRKBzhZUiCgI2YhiW6w8iosj,SpATywNh6bZuzm8s1ceuBUnMUAeoAHHw,1,0,0,0,0,0,1,0,1,0.14285714285714285,1,0.0,0,0,0,0,0,0,0,1,0,0,1,1
2407,103290,HFGNcmUXULevazeUTNEcAY9fpoL4pzVP,SpATywNh6bZuzm8s1ceuBUnMUAeoAHHw,4,2,1,0,1,0,1,0,5,0.7142857142857143,1,0.0,0,1,0,1,2,0,0,1,0,2,3,1
2408,103291,3xICsH6EXuYyV8kexin75XnVadi3rENN,SpATywNh6bZuzm8s1ceuBUnMUAeoAHHw,16,16,7,37,1,1,4,0,66,9.428571428571429,1,0.0,6,7,32,1,10,1,5,4,0,46,20,1
2409,103310,9LpHZ4FqcvjHyiN7Brp9qNNIFri6dqhc,SpATywNh6bZuzm8s1ceuBUnMUAeoAHHw,1,0,0,0,0,0,1,0,1,0.14285714285714285,1,0.0,0,0,0,0,0,0,0,1,0,0,1,1
2410,103321,nWOH01aZ04H6r4egoMRiiMsuUse9lbQb,SpATywNh6bZuzm8s1ceuBUnMUAeoAHHw,4,3,0,0,0,0,1,0,4,0.5714285714285714,1,0.0,0,0,0,0,3,0,0,1,0,0,4,1
2411,103349,hNJz0qbOhrUgajUkzqSdDbybHkuRglfs,bWdj2GDclj5ofokWjzoa5jAwMkxCykd6,16,18,12,22,3,1,7,1,64,9.142857142857142,2,0.0,2,12,20,3,16,1,2,7,1,37,27,1
2412,103368,RqBHYGZ0TJ0og1l3UKsrEDKJTiEi7UGH,bWdj2GDclj5ofokWjzoa5jAwMkxCykd6,1,0,0,0,0,0,1,0,1,0.14285714285714285,1,0.0,0,0,0,0,0,0,0,1,0,0,1,1
2413,103401,BfcoBJeBA5nEQ2BMwBPOzhifSeHVOPF7,A3fsA9Zfv1X2fVEQhTw51lKENdNrEqT3,3,2,1,0,0,0,2,0,5,0.7142857142857143,1,0.0,0,1,0,0,2,0,0,2,0,1,4,1
2414,103403,kSmNmb8pAXQzQwcesy0KCmn8So8gUF15,RXDvfPUBYFlVdlueBFbLW0mhhAyGEqpt,11,7,1,18,1,0,2,0,29,4.142857142857143,1,0.0,1,1,17,1,6,0,1,2,0,20,9,1
2415,103416,VQlGEIRUzXNT6foVsTH49rZlcPgJT0yF,RXDvfPUBYFlVdlueBFbLW0mhhAyGEqpt,5,2,1,0,1,0,2,0,6,0.8571428571428571,1,0.0,0,1,0,1,2,0,0,2,0,2,4,1
2416,103540,gEnHreVcQ3mWSHejulW9Wh8JYbtvdJff,G8EPVSXsOYB5YQWZGiz1aVq5Pgr2GrQu,6,3,1,0,1,0,2,0,7,1.0,1,0.0,0,1,0,1,3,0,0,2,0,2,5,1
2417,103542,3kqAYaZkgzFfJM9JvWI5IyiYihK9SbF2,SpATywNh6bZuzm8s1ceuBUnMUAeoAHHw,1,0,0,0,0,0,1,0,1,0.14285714285714285,1,0.0,0,0,0,0,0,0,0,1,0,0,1,1
2418,103556,uckssqvWyUYWLFOLUxtXhLnqEepVbBJ2,A3fsA9Zfv1X2fVEQhTw51lKENdNrEqT3,6,4,0,0,0,3,5,0,12,1.7142857142857142,1,0.0,0,0,0,0,4,3,0,5,0,0,12,1
2419,103579,DYy3OcZHNqaAwRPZTK5mmyz2pajxcVFG,SpATywNh6bZuzm8s1ceuBUnMUAeoAHHw,18,14,9,0,7,0,2,0,32,4.571428571428571,1,0.0,4,9,0,7,10,0,0,2,0,20,12,1
2420,103582,dQsgkNAYSmg3HfiJLo9hIHon4zbbBGlt,SpATywNh6bZuzm8s1ceuBUnMUAeoAHHw,1,0,0,0,0,0,1,0,1,0.14285714285714285,1,0.0,0,0,0,0,0,0,0,1,0,0,1,1
2421,103598,5ZyvCd3AP7a8azCiLN5JfLAP53iZpAyD,bWdj2GDclj5ofokWjzoa5jAwMkxCykd6,1,0,0,0,0,0,1,0,1,0.14285714285714285,1,0.0,0,0,0,0,0,0,0,1,0,0,1,1
2422,103599,5ZyvCd3AP7a8azCiLN5JfLAP53iZpAyD,G8EPVSXsOYB5YQWZGiz1aVq5Pgr2GrQu,1,0,0,0,0,0,1,0,1,0.14285714285714285,1,0.0,0,0,0,0,0,0,0,1,0,0,1,1
2423,103615,MoPVKWdkHBgBJN1rFoQXD7HKqTLuGX5j,SpATywNh6bZuzm8s1ceuBUnMUAeoAHHw,1,0,0,0,0,0,1,0,1,0.14285714285714285,1,0.0,0,0,0,0,0,0,0,1,0,0,1,1
2424,103621,rVswAzjMLz5uIPbCwAU1SliCQFpiAqey,G8EPVSXsOYB5YQWZGiz1aVq5Pgr2GrQu,20,27,15,12,14,0,1,0,69,9.857142857142858,1,0.0,11,15,9,14,16,0,3,1,0,49,20,1
2425,103631,KYNdfogmKCD7SA1muZkW9WEyjcJ7qGwm,A3fsA9Zfv1X2fVEQhTw51lKENdNrEqT3,1,0,0,0,0,0,2,0,2,0.2857142857142857,1,0.0,0,0,0,0,0,0,0,2,0,0,2,1
2426,103688,C14ut6PDfZPN3lsINMru6CQXJOaUeNzg,SpATywNh6bZuzm8s1ceuBUnMUAeoAHHw,2,0,0,0,0,0,3,0,3,0.42857142857142855,1,0.0,0,0,0,0,0,0,0,3,0,0,3,1
2427,103708,rpRCEhtlHGcZRNaEFyNtzZ3h0JQuYrgr,A3fsA9Zfv1X2fVEQhTw51lKENdNrEqT3,1,0,0,0,0,0,1,0,1,0.14285714285714285,1,0.0,0,0,0,0,0,0,0,1,0,0,1,1
2428,103717,DKs1wVuJxi1MManiJftFpHeYNStTfS5A,G8EPVSXsOYB5YQWZGiz1aVq5Pgr2GrQu,2,0,0,0,0,0,4,0,4,0.5714285714285714,1,0.0,0,0,0,0,0,0,0,4,0,0,4,1
2429,103736,SAZRKAldhv9NmeRo6l8G7XnPsnj9TVyU,SpATywNh6bZuzm8s1ceuBUnMUAeoAHHw,1,0,0,0,0,0,1,0,1,0.14285714285714285,1,0.0,0,0,0,0,0,0,0,1,0,0,1,1
2430,103751,C8XrXSQZNN8RR6xEeSRWbKA5jTxVTtPT,RXDvfPUBYFlVdlueBFbLW0mhhAyGEqpt,1,0,0,0,0,0,1,0,1,0.14285714285714285,1,0.0,0,0,0,0,0,0,0,1,0,0,1,1
2431,103769,KyO1xM8jR0HMi7DDZ6rJYV6HufMfhFF3,SpATywNh6bZuzm8s1ceuBUnMUAeoAHHw,5,4,0,0,0,0,4,0,8,1.1428571428571428,1,0.0,0,0,0,0,4,0,0,4,0,0,8,1
2432,103770,EReWp6ilgaQY61GGX2jAkIc5IQisheJq,A3fsA9Zfv1X2fVEQhTw51lKENdNrEqT3,1,0,0,0,0,0,1,0,1,0.14285714285714285,1,0.0,0,0,0,0,0,0,0,1,0,0,1,1
2433,103771,SozLQk8695JG7fvj1Enp26s5ACJQjjq5,A3fsA9Zfv1X2fVEQhTw51lKENdNrEqT3,1,0,0,0,0,0,1,0,1,0.14285714285714285,1,0.0,0,0,0,0,0,0,0,1,0,0,1,1
2434,103772,ZeGQYJuhuvawQN9a4lM0EAzsC8fPW88J,SpATywNh6bZuzm8s1ceuBUnMUAeoAHHw,5,2,1,0,1,0,2,0,6,0.8571428571428571,1,0.0,0,1,0,1,2,0,0,2,0,2,4,1
2435,103780,8E8MlkBOuzGaVSvo1UqdWtwoQrTmYFYq,A3fsA9Zfv1X2fVEQhTw51lKENdNrEqT3,4,2,0,0,0,0,3,0,5,0.7142857142857143,1,0.0,0,0,0,0,2,0,0,3,0,0,5,1
2436,103781,DT8AqUhZw7EK0K7nTcFJ3ScDyeNUfkdW,SpATywNh6bZuzm8s1ceuBUnMUAeoAHHw,1,0,0,0,0,0,1,0,1,0.14285714285714285,1,0.0,0,0,0,0,0,0,0,1,0,0,1,1
2437,103787,g5LcibasYPSrvvKLR0Yho0cbKscCPTQe,A3fsA9Zfv1X2fVEQhTw51lKENdNrEqT3,2,0,0,0,0,0,4,0,4,0.5714285714285714,1,0.0,0,0,0,0,0,0,0,4,0,0,4,1
2438,103793,FllaTGiiKjVXL8ZyJAcKfQZYECjbYHzz,SpATywNh6bZuzm8s1ceuBUnMUAeoAHHw,1,0,0,0,0,0,1,0,1,0.14285714285714285,1,0.0,0,0,0,0,0,0,0,1,0,0,1,1
2439,103795,2ONNcB0Lk7y2f17JTT6X0dSaCbLlHzeP,A3fsA9Zfv1X2fVEQhTw51lKENdNrEqT3,24,13,11,0,10,4,4,0,42,6.0,1,0.0,0,11,0,10,13,4,0,4,0,21,21,1
2440,103796,sRe9Dv91RM9tcMLN8FfoFlx7APGbmbBC,SpATywNh6bZuzm8s1ceuBUnMUAeoAHHw,1,0,0,0,0,0,1,0,1,0.14285714285714285,1,0.0,0,0,0,0,0,0,0,1,0,0,1,1
2441,103813,CbIcKD0jazBhPd3ibnu0zTtemqpWb0KP,A3fsA9Zfv1X2fVEQhTw51lKENdNrEqT3,44,27,18,78,10,6,7,0,146,20.857142857142858,2,0.0,3,18,67,10,24,6,11,7,0,98,48,1
2442,103823,yc5B41HNSQqUbPLwIoeXaaIoBMGyXjZi,A3fsA9Zfv1X2fVEQhTw51lKENdNrEqT3,6,6,3,0,2,0,2,0,13,1.8571428571428572,1,0.0,0,3,0,2,6,0,0,2,0,5,8,1
2443,103828,z9EFyZFox24cBI6falpy1wiVcAxDOJLn,A3fsA9Zfv1X2fVEQhTw51lKENdNrEqT3,2,0,0,0,0,0,2,0,2,0.2857142857142857,1,0.0,0,0,0,0,0,0,0,2,0,0,2,1
2444,103842,At5CmMT40Lj8XDlMUQSu8tvnJD3w6cR2,SpATywNh6bZuzm8s1ceuBUnMUAeoAHHw,15,23,2,12,2,3,10,3,55,7.857142857142857,2,0.0,3,2,11,2,20,3,1,10,3,18,37,0
2445,103846,QvVe60KGKvAk40HokMNHSxHXG9LVzuVG,SpATywNh6bZuzm8s1ceuBUnMUAeoAHHw,1,0,0,0,0,0,1,0,1,0.14285714285714285,1,0.0,0,0,0,0,0,0,0,1,0,0,1,1
2446,103852,VJiHrUKuVkG2Wd7Jui04ER4qa9ZGvV1t,SpATywNh6bZuzm8s1ceuBUnMUAeoAHHw,15,13,7,6,2,1,4,1,34,4.857142857142857,1,0.0,2,7,6,2,11,1,0,4,1,17,17,1
2447,103870,EvnHBVsAsAQbfQWtAPpt54pufnNRU5R4,bWdj2GDclj5ofokWjzoa5jAwMkxCykd6,7,12,0,0,0,0,4,0,16,2.2857142857142856,1,0.0,0,0,0,0,12,0,0,4,0,0,16,1
2448,103886,wNLjey13wdSjq72WLYu2h7JxRXlqFXV6,SpATywNh6bZuzm8s1ceuBUnMUAeoAHHw,21,19,8,15,5,2,10,1,60,8.571428571428571,1,0.0,9,8,13,5,10,2,2,10,1,35,25,0
2449,103890,AwuND473CGsGJtyEL3enVuAsVwEKK9kF,G8EPVSXsOYB5YQWZGiz1aVq5Pgr2GrQu,5,2,1,0,1,0,2,0,6,0.8571428571428571,1,0.0,0,1,0,1,2,0,0,2,0,2,4,1
2450,103903,0w9tP8TINgzfbBeYFJprB82ry0PjYiWn,SpATywNh6bZuzm8s1ceuBUnMUAeoAHHw,5,5,2,0,1,0,3,0,11,1.5714285714285714,1,0.0,0,2,0,1,5,0,0,3,0,3,8,0
2451,103908,KKVIEI2lseDGpdoOhUIkkmAMhzuJw0y5,SpATywNh6bZuzm8s1ceuBUnMUAeoAHHw,1,0,0,0,0,0,1,0,1,0.14285714285714285,1,0.0,0,0,0,0,0,0,0,1,0,0,1,1
2452,103915,Bt9uonGNpSTNQAZJ5XpbRJvBeauLMg6y,SpATywNh6bZuzm8s1ceuBUnMUAeoAHHw,5,2,1,0,1,0,2,0,6,0.8571428571428571,1,0.0,0,1,0,1,2,0,0,2,0,2,4,1
2453,103920,ixGKuRwAIkkpbDBbmpHTQFbowyxzIwFP,A3fsA9Zfv1X2fVEQhTw51lKENdNrEqT3,2,0,0,0,0,0,2,0,2,0.2857142857142857,1,0.0,0,0,0,0,0,0,0,2,0,0,2,1
2454,103921,illxSnHmbH86MI7oeDlx7PoAaCvI0459,SpATywNh6bZuzm8s1ceuBUnMUAeoAHHw,4,2,0,0,0,0,4,0,6,0.8571428571428571,1,0.0,0,0,0,0,2,0,0,4,0,0,6,1
2455,103923,ixGKuRwAIkkpbDBbmpHTQFbowyxzIwFP,bWdj2GDclj5ofokWjzoa5jAwMkxCykd6,2,0,0,0,0,0,2,0,2,0.2857142857142857,1,0.0,0,0,0,0,0,0,0,2,0,0,2,1
2456,103932,nMJrb50Z6QbaFrpJMS3h5YwSiL2VcT7z,bWdj2GDclj5ofokWjzoa5jAwMkxCykd6,1,0,0,0,0,0,1,0,1,0.14285714285714285,1,0.0,0,0,0,0,0,0,0,1,0,0,1,1
2457,103950,JNia6gKvSZOSZQHrR3Kro8PKF3m40Fop,RXDvfPUBYFlVdlueBFbLW0mhhAyGEqpt,34,23,9,59,9,0,1,0,101,14.428571428571429,1,0.0,13,9,55,9,10,0,4,1,0,86,15,1
2458,103967,kjoYyxOsZaiCA9S8PMK5B69QLaH15SYn,SpATywNh6bZuzm8s1ceuBUnMUAeoAHHw,5,2,1,0,0,2,5,1,11,1.5714285714285714,1,0.0,0,1,0,0,2,2,0,5,1,1,10,0
2459,103983,c7BA0CHOGHUb6Zvl8EDChyZRMoY8mJ72,bWdj2GDclj5ofokWjzoa5jAwMkxCykd6,6,7,1,0,1,0,3,0,12,1.7142857142857142,1,0.0,1,1,0,1,6,0,0,3,0,3,9,1
2460,104024,fCVSDkZ4pJqiysBxp6DwZw9KkCTFdKeE,SpATywNh6bZuzm8s1ceuBUnMUAeoAHHw,1,0,0,0,0,0,1,0,1,0.14285714285714285,1,0.0,0,0,0,0,0,0,0,1,0,0,1,1
2461,104032,s6g3JP590BuuXwlDJeFKSGLH2Uubd3rm,SpATywNh6bZuzm8s1ceuBUnMUAeoAHHw,2,0,0,0,0,0,3,0,3,0.42857142857142855,1,0.0,0,0,0,0,0,0,0,3,0,0,3,1
2462,104052,xdSWJOkklt1feMPe59TTfCkpvZpm9Xg2,A3fsA9Zfv1X2fVEQhTw51lKENdNrEqT3,1,0,0,0,0,0,1,0,1,0.14285714285714285,1,0.0,0,0,0,0,0,0,0,1,0,0,1,1
2463,104081,eGnXUl0T4jiT9b8r6xuMUjzOt9Gv7xEL,A3fsA9Zfv1X2fVEQhTw51lKENdNrEqT3,28,18,12,70,6,0,3,0,109,15.571428571428571,2,0.0,1,12,55,6,17,0,15,3,0,74,35,1
2464,104084,axVh7TT3ftc0JLvNMlUvTGTAABKlThNj,SpATywNh6bZuzm8s1ceuBUnMUAeoAHHw,2,0,0,0,0,0,3,0,3,0.42857142857142855,1,0.0,0,0,0,0,0,0,0,3,0,0,3,1
2465,104090,fGDhAQY2WhkQYcL5XaYeDMBiOUQEoTnX,A3fsA9Zfv1X2fVEQhTw51lKENdNrEqT3,46,19,14,110,12,0,3,0,158,22.571428571428573,2,0.0,2,14,92,12,17,0,18,3,0,120,38,1
2466,104110,qwWysWdLmrwh0JmjPYNGVFqdat8Jy8Lb,A3fsA9Zfv1X2fVEQhTw51lKENdNrEqT3,3,2,0,0,0,0,2,0,4,0.5714285714285714,1,0.0,0,0,0,0,2,0,0,2,0,0,4,1
2467,104112,1nvi4T1tSgoWvIN9EbUwnTy7YI8AhzKg,SpATywNh6bZuzm8s1ceuBUnMUAeoAHHw,6,2,1,0,1,0,3,1,8,1.1428571428571428,1,0.0,0,1,0,1,2,0,0,3,1,2,6,1
2468,104128,Whrc7O8OYrwQtVL43oMCOWkRLnJ5RAnq,bWdj2GDclj5ofokWjzoa5jAwMkxCykd6,6,2,1,0,1,0,3,0,7,1.0,1,0.0,0,1,0,1,2,0,0,3,0,2,5,1
2469,104155,eHoa4dnAqoZqw72CCle00GlHxpp5Lihg,bWdj2GDclj5ofokWjzoa5jAwMkxCykd6,3,2,0,0,0,0,1,0,3,0.42857142857142855,1,0.0,0,0,0,0,2,0,0,1,0,0,3,1
2470,104174,fq6GCepmmh2YUfaUpWUiL4vGs9AXZLYY,SpATywNh6bZuzm8s1ceuBUnMUAeoAHHw,1,0,0,0,0,0,1,0,1,0.14285714285714285,1,0.0,0,0,0,0,0,0,0,1,0,0,1,1
2471,104214,j3WvRsPrA16gNidaQCOf3oXIUr2Xe5Lw,bWdj2GDclj5ofokWjzoa5jAwMkxCykd6,6,6,2,0,1,0,2,0,11,1.5714285714285714,1,0.0,2,2,0,1,4,0,0,2,0,5,6,1
2472,104237,JUwnpYDokyUXTC7SfWpuPqShDK4ZEqmX,bWdj2GDclj5ofokWjzoa5jAwMkxCykd6,1,0,0,0,0,0,1,0,1,0.14285714285714285,1,0.0,0,0,0,0,0,0,0,1,0,0,1,1
2473,104248,ixafWGJcoRhCM5cJdtULfcNp2InCr2Sa,bWdj2GDclj5ofokWjzoa5jAwMkxCykd6,1,0,0,0,0,0,1,0,1,0.14285714285714285,1,0.0,0,0,0,0,0,0,0,1,0,0,1,1
2474,104257,JnJdiqdl8G12l0bbDCbx68wMLkGjKDPl,bWdj2GDclj5ofokWjzoa5jAwMkxCykd6,1,0,0,0,0,0,1,0,1,0.14285714285714285,1,0.0,0,0,0,0,0,0,0,1,0,0,1,1
2475,104287,E4KzNEU3ybRlAOiHqHHsGQEXiaxyHgoT,SpATywNh6bZuzm8s1ceuBUnMUAeoAHHw,17,19,12,12,5,0,5,0,53,7.571428571428571,2,0.0,4,12,12,5,15,0,0,5,0,33,20,0
2476,104438,KJtTFVCUZxFPCdrcl94b8VUY3eA2PtX6,SpATywNh6bZuzm8s1ceuBUnMUAeoAHHw,17,15,1,18,0,13,7,1,55,7.857142857142857,2,0.0,4,1,15,0,11,13,3,7,1,20,35,0
2477,104454,S6zuEdHkGvIDnx9FvNNHc7xwyevTBNEw,G8EPVSXsOYB5YQWZGiz1aVq5Pgr2GrQu,9,3,1,18,0,0,1,0,23,3.2857142857142856,1,0.0,0,1,16,0,3,0,2,1,0,17,6,0
2478,104660,T118Cf7QnojriLhCFYL99xCQBHodaMMt,A3fsA9Zfv1X2fVEQhTw51lKENdNrEqT3,11,7,6,0,4,0,1,0,18,2.5714285714285716,1,0.0,0,6,0,4,7,0,0,1,0,10,8,1
2479,104729,EJ7udUHYDMabOR6DK8F5Y2Y2wljl56Yz,SpATywNh6bZuzm8s1ceuBUnMUAeoAHHw,10,9,3,6,0,0,2,0,20,2.857142857142857,1,0.0,2,3,6,0,7,0,0,2,0,11,9,1
2480,104803,GHw9ck750jm0mkRym0HeCGrJelDoub5a,SpATywNh6bZuzm8s1ceuBUnMUAeoAHHw,1,0,0,0,0,0,1,0,1,0.14285714285714285,1,0.0,0,0,0,0,0,0,0,1,0,0,1,0
2481,104921,xBMlDE0EhLrV6UTu12C10f1Ev99CwT31,SpATywNh6bZuzm8s1ceuBUnMUAeoAHHw,3,2,1,0,0,0,1,0,4,0.5714285714285714,1,0.0,0,1,0,0,2,0,0,1,0,1,3,1
2482,105006,0fpX00EX1TEQvQDvfUOFFIekoZBhUJ55,SpATywNh6bZuzm8s1ceuBUnMUAeoAHHw,5,3,1,0,1,0,1,0,6,0.8571428571428571,1,0.0,0,1,0,1,3,0,0,1,0,2,4,1
2483,105048,skA6GV4QKGFVtxye7Nlz906gXUD3qCvf,SpATywNh6bZuzm8s1ceuBUnMUAeoAHHw,1,0,0,0,0,0,1,0,1,0.14285714285714285,1,0.0,0,0,0,0,0,0,0,1,0,0,1,1
2484,105126,5THwHjTl3CwrsU1mIg0WeedsGDfvyUMr,G8EPVSXsOYB5YQWZGiz1aVq5Pgr2GrQu,9,7,4,0,3,0,3,0,17,2.4285714285714284,1,0.0,0,4,0,3,7,0,0,3,0,7,10,1
2485,105348,jyuEVmbrPcyGnV7pufxSb0rPrKJZItsk,SpATywNh6bZuzm8s1ceuBUnMUAeoAHHw,7,14,8,0,0,0,4,0,26,3.7142857142857144,2,0.0,2,8,0,0,12,0,0,4,0,10,16,1
2486,105420,biOEnvJNbNmJmtnLohBToN5g3ppQrMj4,SpATywNh6bZuzm8s1ceuBUnMUAeoAHHw,5,5,3,0,1,0,1,0,10,1.4285714285714286,1,0.0,0,3,0,1,5,0,0,1,0,4,6,1
2487,105558,GbO46rd9u4nTIYKWQ4uqsc2u6MxCvlf3,A3fsA9Zfv1X2fVEQhTw51lKENdNrEqT3,3,2,1,0,0,0,1,0,4,0.5714285714285714,1,0.0,0,1,0,0,2,0,0,1,0,1,3,1
2488,105621,Z2LpxeyN5IUym4huJGBt4liqsVm2EQ7Q,SpATywNh6bZuzm8s1ceuBUnMUAeoAHHw,3,4,2,0,0,0,2,0,8,1.1428571428571428,2,0.0,0,2,0,0,4,0,0,2,0,2,6,0
2489,105773,40Xea2YMOWW1uT2M8t7POlJQUIkhUdnJ,7GRhBDsirIGkRZBtSMEzNTyDr2JQm4xx,7,4,3,0,2,0,3,0,12,1.7142857142857142,1,0.0,0,3,0,2,4,0,0,3,0,5,7,1
2490,105862,QcbB4zGNvIA8Hos1EmgULZPHy4JycNs5,7GRhBDsirIGkRZBtSMEzNTyDr2JQm4xx,1,0,0,0,0,0,2,0,2,0.2857142857142857,1,0.0,0,0,0,0,0,0,0,2,0,0,2,1
2491,105928,T8ZgVxZ1KcbbwwKauSYOnW28FLVyPTlj,7GRhBDsirIGkRZBtSMEzNTyDr2JQm4xx,2,0,0,0,0,0,2,0,2,0.2857142857142857,1,0.0,0,0,0,0,0,0,0,2,0,0,2,1
2492,105967,FxPyq8YtKk0yw3NNE8ZksN1yqg6GsuE4,7GRhBDsirIGkRZBtSMEzNTyDr2JQm4xx,2,0,0,0,0,0,6,0,6,0.8571428571428571,1,0.0,0,0,0,0,0,0,0,6,0,0,6,1
2493,105969,ikVmCxeXCKQtR8OPUUdHoGQCjATpEVdj,7GRhBDsirIGkRZBtSMEzNTyDr2JQm4xx,9,6,2,6,2,1,5,0,22,3.142857142857143,1,0.0,2,2,5,2,4,1,1,5,0,11,11,1
2494,105978,Z0RxOk6qXdCVEUwgYNFnCN7QFecq61SF,7GRhBDsirIGkRZBtSMEzNTyDr2JQm4xx,1,0,0,0,0,0,1,0,1,0.14285714285714285,1,0.0,0,0,0,0,0,0,0,1,0,0,1,1
2495,106017,UTdeWmi6AePo1O6hg6pDbCCeGok0eGfZ,7GRhBDsirIGkRZBtSMEzNTyDr2JQm4xx,1,0,0,0,0,0,1,0,1,0.14285714285714285,1,0.0,0,0,0,0,0,0,0,1,0,0,1,1
2496,106897,yrxUCbkwiU0Qgu0wZMF5MylHBneN7zri,SpATywNh6bZuzm8s1ceuBUnMUAeoAHHw,12,11,5,11,2,0,1,0,30,4.285714285714286,1,0.0,3,5,11,2,8,0,0,1,0,21,9,0
2497,108421,Z8VFKUoySr9L7FZfGeoeDWQqxwnJbTos,SpATywNh6bZuzm8s1ceuBUnMUAeoAHHw,3,4,0,0,0,0,3,0,7,1.0,1,0.0,0,0,0,0,4,0,0,3,0,0,7,0
2498,108618,6pZAnEuoA7RiYeKYKN3oDQwjOWGfm51A,A3fsA9Zfv1X2fVEQhTw51lKENdNrEqT3,1,0,0,0,0,0,1,0,1,0.14285714285714285,1,0.0,0,0,0,0,0,0,0,1,0,0,1,1
2499,108658,FAjTaGnsfZLBQS9slQbYMPpuh5mcYxue,SpATywNh6bZuzm8s1ceuBUnMUAeoAHHw,4,2,1,0,0,3,3,0,9,1.2857142857142858,2,0.0,0,1,0,0,2,3,0,3,0,1,8,0
2500,109342,obFxfGLSP12hWUYqYGw1SR5lINNLUPlg,SpATywNh6bZuzm8s1ceuBUnMUAeoAHHw,18,59,11,11,4,2,9,1,97,13.857142857142858,3,0.0,29,11,10,4,30,2,1,9,1,54,43,1
2501,109400,9uGUU0TH4lqYEkuGLK9jp9MwW0oSvGiG,A3fsA9Zfv1X2fVEQhTw51lKENdNrEqT3,3,0,0,0,0,0,3,0,3,0.42857142857142855,1,0.0,0,0,0,0,0,0,0,3,0,0,3,1
2502,109536,Cv1aavObJnuABKfipF6OGePzg0BnGPFs,SpATywNh6bZuzm8s1ceuBUnMUAeoAHHw,2,0,0,0,0,0,2,0,2,0.2857142857142857,1,0.0,0,0,0,0,0,0,0,2,0,0,2,1
2503,109538,Cv1aavObJnuABKfipF6OGePzg0BnGPFs,A3fsA9Zfv1X2fVEQhTw51lKENdNrEqT3,4,1,1,0,0,0,2,0,4,0.5714285714285714,1,0.0,0,1,0,0,1,0,0,2,0,1,3,1
2504,109908,HCwGALsXdQRvdnW9Y1SicRkbFYJcehRz,G8EPVSXsOYB5YQWZGiz1aVq5Pgr2GrQu,41,43,16,54,7,10,8,1,139,19.857142857142858,1,0.0,21,16,40,7,22,10,14,8,1,84,55,0
2505,109982,DmULS2tEq0maGheqJ8Xg7VkvUxmleIug,SpATywNh6bZuzm8s1ceuBUnMUAeoAHHw,8,21,0,0,0,0,1,0,22,3.142857142857143,1,0.0,0,0,0,0,21,0,0,1,0,0,22,0
2506,113224,YnryKMU5NBkS3Ubsyb9gjAcDZ6iJfgwC,7GRhBDsirIGkRZBtSMEzNTyDr2JQm4xx,1,0,0,0,0,0,1,0,1,0.14285714285714285,1,0.0,0,0,0,0,0,0,0,1,0,0,1,1
2507,113276,eswvbpHhxCUZC3kUIoEHkNpn6ukXHFpo,7GRhBDsirIGkRZBtSMEzNTyDr2JQm4xx,5,2,1,0,1,0,3,0,7,1.0,1,0.0,0,1,0,1,2,0,0,3,0,2,5,0
2508,113891,9d8tCYKPfh5NHPKNlwRKmrZh3Cuf1Ls2,7GRhBDsirIGkRZBtSMEzNTyDr2JQm4xx,12,44,15,0,5,0,4,0,68,9.714285714285714,4,0.0,0,15,0,5,44,0,0,4,0,20,48,0
2509,113977,AnqzEiR7s4CfuKEZI3xmlDjhp0SJ9rWN,7GRhBDsirIGkRZBtSMEzNTyDr2JQm4xx,27,55,22,40,8,53,9,1,188,26.857142857142858,1,0.0,12,22,34,8,43,53,6,9,1,76,112,0
2510,113991,z7I1QeH8tOlWf6s0Xi8QGEEG8QaCPAno,7GRhBDsirIGkRZBtSMEzNTyDr2JQm4xx,1,1,0,0,0,0,0,0,1,0.14285714285714285,1,0.0,0,0,0,0,1,0,0,0,0,0,1,1
2511,114122,4Pd3e254V1ylErxapJL6FJZ2vSaLD95s,7GRhBDsirIGkRZBtSMEzNTyDr2JQm4xx,27,56,4,19,9,3,6,0,97,13.857142857142858,2,0.0,26,4,18,9,30,3,1,6,0,57,40,0
2512,114299,uuzc81RWrrz7iGcyTE1vS0JQYD0lJgbY,7GRhBDsirIGkRZBtSMEzNTyDr2JQm4xx,8,7,0,0,0,2,3,1,13,1.8571428571428572,1,0.0,0,0,0,0,7,2,0,3,1,0,13,1
2513,114411,2jRIZMWHA5rH4ew2UCv2iZrYBWoFczyG,7GRhBDsirIGkRZBtSMEzNTyDr2JQm4xx,32,47,2,36,6,1,5,0,97,13.857142857142858,4,0.0,19,2,26,6,28,1,10,5,0,53,44,0
2514,114559,KkSinTdG2PbGrJIRATMZos8HES46UawO,7GRhBDsirIGkRZBtSMEzNTyDr2JQm4xx,8,18,7,0,5,0,3,0,33,4.714285714285714,3,0.0,3,7,0,5,15,0,0,3,0,15,18,0
2515,114568,39kDK9y6rUMxkyJQwaOrfTRJDkq1CpVh,7GRhBDsirIGkRZBtSMEzNTyDr2JQm4xx,1,0,0,0,1,0,0,0,1,0.14285714285714285,1,0.0,0,0,0,1,0,0,0,0,0,1,0,1
2516,114615,dADOrE6FAWkIPcnZuLBj5KGmzjdxSunH,fbPkOYLVPtPgIt0MxizjfFJov3JbHyAi,22,47,24,20,16,9,3,0,119,17.0,2,0.0,19,24,20,16,28,9,0,3,0,79,40,0
2517,114620,6T8cBNKGNp544PxJriaeroN36khQqLPz,fbPkOYLVPtPgIt0MxizjfFJov3JbHyAi,1,0,0,0,0,0,1,0,1,0.14285714285714285,1,0.0,0,0,0,0,0,0,0,1,0,0,1,1
2518,117437,HOh9uzKRHmixUSVl017qRO1fRhTakF2v,fbPkOYLVPtPgIt0MxizjfFJov3JbHyAi,3,2,1,0,0,0,1,0,4,0.5714285714285714,1,0.0,0,1,0,0,2,0,0,1,0,1,3,1
2519,117442,kyRDtUassKyWkKwd2NxuRMWbNGMmYQuD,fbPkOYLVPtPgIt0MxizjfFJov3JbHyAi,25,34,15,17,7,1,4,0,78,11.142857142857142,5,0.0,6,15,15,7,28,1,2,4,0,43,35,1
2520,117504,7nfwj1I7hYBfuxm4jUuStM2n17LzzRmj,SpATywNh6bZuzm8s1ceuBUnMUAeoAHHw,2,0,0,0,0,6,1,0,7,1.0,1,0.0,0,0,0,0,0,6,0,1,0,0,7,0
2521,117532,qX3w4IgztgXyu9swieirFObama3kJyza,G8EPVSXsOYB5YQWZGiz1aVq5Pgr2GrQu,10,14,1,15,1,0,4,0,35,5.0,2,0.0,2,1,13,1,12,0,2,4,0,17,18,1
2522,117567,KlEAwfTXNSli6vdNdYlm5CYknLkxK1Br,SpATywNh6bZuzm8s1ceuBUnMUAeoAHHw,16,23,10,14,3,10,2,0,62,8.857142857142858,1,0.0,7,10,11,3,16,10,3,2,0,31,31,0
2523,117572,xH5f8nfW6oTIgHjXoQgEUKIx6qvDN8rk,RXDvfPUBYFlVdlueBFbLW0mhhAyGEqpt,9,4,2,6,1,0,3,0,16,2.2857142857142856,1,0.0,1,2,6,1,3,0,0,3,0,10,6,1
2524,117609,hyhyxhn6qO7nii28PZygBx2DF5Qsnp6b,SpATywNh6bZuzm8s1ceuBUnMUAeoAHHw,2,0,1,0,1,0,0,0,2,0.2857142857142857,1,0.0,0,1,0,1,0,0,0,0,0,2,0,1
2525,117610,ByImt5XiYRVr6hSHRVc9HRcRiIYkoT5Y,SpATywNh6bZuzm8s1ceuBUnMUAeoAHHw,5,8,2,0,0,0,2,0,12,1.7142857142857142,2,0.0,2,2,0,0,6,0,0,2,0,4,8,0
2526,117612,Kd69M9W1nim0woqVm1QxfVaSebsYtFIh,SpATywNh6bZuzm8s1ceuBUnMUAeoAHHw,28,30,13,32,7,0,2,0,84,12.0,1,0.0,9,13,28,7,21,0,4,2,0,57,27,1
2527,117613,VEmnuZOsoHSPcS4ojGYL7wyh1ioGqsGt,SpATywNh6bZuzm8s1ceuBUnMUAeoAHHw,3,4,2,0,0,0,3,0,9,1.2857142857142858,3,0.0,0,2,0,0,4,0,0,3,0,2,7,0
2528,117615,NdhfP9LezOw47EKstFkVNQYaCX8DmoQI,SpATywNh6bZuzm8s1ceuBUnMUAeoAHHw,15,26,1,19,0,0,6,0,52,7.428571428571429,5,0.0,7,1,16,0,19,0,3,6,0,24,28,0
2529,117655,MkluYfJDefHhcRPY3QsRGiWxg2BDcm18,SpATywNh6bZuzm8s1ceuBUnMUAeoAHHw,26,80,1,24,1,5,30,3,144,20.571428571428573,4,0.0,35,1,22,1,45,5,2,30,3,59,85,0
2530,117671,LvmRr9NACuniPuboiWpXG15NCOEyIfpb,SpATywNh6bZuzm8s1ceuBUnMUAeoAHHw,17,9,8,13,4,0,2,0,36,5.142857142857143,1,0.0,0,8,11,4,9,0,2,2,0,23,13,0
2531,117672,NdhfP9LezOw47EKstFkVNQYaCX8DmoQI,RXDvfPUBYFlVdlueBFbLW0mhhAyGEqpt,32,50,0,80,5,13,8,0,156,22.285714285714285,5,0.0,19,0,73,5,31,13,7,8,0,97,59,0
2532,117673,nC8ZC7ZEZFxQ1fyXozb96bBtFUPG3sJG,RXDvfPUBYFlVdlueBFbLW0mhhAyGEqpt,24,16,12,0,8,2,7,1,46,6.571428571428571,1,0.0,0,12,0,8,16,2,0,7,1,20,26,1
2533,117675,l64zD2DC6Q6fZRqMhhM1r4HOjVM4BOX7,SpATywNh6bZuzm8s1ceuBUnMUAeoAHHw,11,13,1,16,0,0,1,0,31,4.428571428571429,1,0.0,6,1,15,0,7,0,1,1,0,22,9,0
2534,117679,VE9HD5yzeCmqc2pNGfTQWsVbRdaqJBIV,SpATywNh6bZuzm8s1ceuBUnMUAeoAHHw,4,4,1,0,0,0,4,0,9,1.2857142857142858,3,0.0,0,1,0,0,4,0,0,4,0,1,8,0
2535,117680,qnnOX2tUCPlICAK14wMKzZel5x1shlyc,SpATywNh6bZuzm8s1ceuBUnMUAeoAHHw,1,0,0,0,0,0,1,0,1,0.14285714285714285,1,0.0,0,0,0,0,0,0,0,1,0,0,1,1
2536,117682,TwVX3mHoGy0nFKENpqHSy2JVaUgsNzW0,SpATywNh6bZuzm8s1ceuBUnMUAeoAHHw,1,0,0,0,0,0,1,0,1,0.14285714285714285,1,0.0,0,0,0,0,0,0,0,1,0,0,1,1
2537,117700,hKd0tEZKHss60gUM0z43MBrDD3KnSpLX,bWdj2GDclj5ofokWjzoa5jAwMkxCykd6,9,12,2,0,1,2,6,1,24,3.4285714285714284,2,0.0,0,2,0,1,12,2,0,6,1,3,21,1
2538,117701,VgmFAu9L9uoZcxRAsErY5yMnCkdw48U0,SpATywNh6bZuzm8s1ceuBUnMUAeoAHHw,3,0,0,0,0,0,6,0,6,0.8571428571428571,2,0.0,0,0,0,0,0,0,0,6,0,0,6,0
2539,117704,imCqSahSQFbp2MKSKmbn03XNPhpj1Zgr,bWdj2GDclj5ofokWjzoa5jAwMkxCykd6,4,4,1,0,0,0,1,0,6,0.8571428571428571,1,0.0,0,1,0,0,4,0,0,1,0,1,5,1
2540,117705,KM2jhllffvH7le7smUIPpeiXHGu50JUy,G8EPVSXsOYB5YQWZGiz1aVq5Pgr2GrQu,14,12,0,27,1,0,1,0,41,5.857142857142857,1,0.0,6,0,23,1,6,0,4,1,0,30,11,1
2541,117713,BdtTUaUgpTqIzhF2tLHXM8NXK8k0XF8q,bWdj2GDclj5ofokWjzoa5jAwMkxCykd6,12,22,9,10,13,0,2,0,56,8.0,2,0.0,3,9,7,13,19,0,3,2,0,32,24,0
2542,117723,B1Gq6e77yv7kkDqJ7SH2TygdPDzPBwQh,RXDvfPUBYFlVdlueBFbLW0mhhAyGEqpt,17,39,25,6,1,30,18,3,122,17.428571428571427,7,0.0,0,25,3,1,39,30,3,18,3,29,93,0
2543,117725,HPir8NcsI5RSXTzlx3oC2YqcMhZG1iu7,bWdj2GDclj5ofokWjzoa5jAwMkxCykd6,7,1,1,0,1,0,9,0,12,1.7142857142857142,2,0.0,0,1,0,1,1,0,0,9,0,2,10,0
2544,117726,IspEVPShBbjx8d4IihOvyrT9DEmhjxUS,RXDvfPUBYFlVdlueBFbLW0mhhAyGEqpt,4,2,1,0,1,0,1,0,5,0.7142857142857143,1,0.0,0,1,0,1,2,0,0,1,0,2,3,1
2545,117734,cQJEH4N9NA86ElT2x4zkE6ToN6rVT4MQ,bWdj2GDclj5ofokWjzoa5jAwMkxCykd6,6,5,4,0,2,0,0,0,11,1.5714285714285714,2,0.0,1,4,0,2,4,0,0,0,0,7,4,0
2546,117742,FhtwGNNoWtYYBXhYRu77jAPRU1UPxpBL,SpATywNh6bZuzm8s1ceuBUnMUAeoAHHw,29,23,14,12,7,0,7,0,63,9.0,3,0.0,6,14,12,7,17,0,0,7,0,39,24,0
2547,117774,jFYWygr5nLqLhHkXltZRkT0S1zQoLEVR,A3fsA9Zfv1X2fVEQhTw51lKENdNrEqT3,39,37,23,104,9,3,24,0,200,28.571428571428573,4,0.0,1,23,87,9,36,3,17,24,0,120,80,0
2548,117784,CFQksue0mvvarj6k4PvTddPXnYjnyZ25,SpATywNh6bZuzm8s1ceuBUnMUAeoAHHw,10,11,1,9,0,0,1,0,22,3.142857142857143,1,0.0,0,1,7,0,11,0,2,1,0,8,14,1
2549,117791,efPQEaUnbKTGcoOM9khi0sSrVhfE9TxE,bWdj2GDclj5ofokWjzoa5jAwMkxCykd6,3,2,1,0,0,0,2,0,5,0.7142857142857143,1,0.0,0,1,0,0,2,0,0,2,0,1,4,1
2550,117800,RJv5TI20pjqK3VtKSctdVBLm65ceGNPu,SpATywNh6bZuzm8s1ceuBUnMUAeoAHHw,5,12,7,0,0,0,6,0,25,3.5714285714285716,5,0.0,0,7,0,0,12,0,0,6,0,7,18,0
2551,117893,Bos3zEEnAcYzPXQktMkJJ0ak5mhGWCAf,SpATywNh6bZuzm8s1ceuBUnMUAeoAHHw,3,2,1,0,0,0,1,0,4,0.5714285714285714,1,0.0,0,1,0,0,2,0,0,1,0,1,3,0
2552,117935,1R1zO9aMB7Mx1Lw84JzsChVEV5JpwmZv,SpATywNh6bZuzm8s1ceuBUnMUAeoAHHw,5,3,2,0,0,0,8,0,13,1.8571428571428572,5,0.0,0,2,0,0,3,0,0,8,0,2,11,0
2553,117989,4dfnEKxHCmGabkBCiKHt5nKr3H7Bwo1x,G8EPVSXsOYB5YQWZGiz1aVq5Pgr2GrQu,4,2,1,0,1,0,1,0,5,0.7142857142857143,2,0.0,0,1,0,1,2,0,0,1,0,2,3,0
2554,118027,LKippngJk3cGSHQFQuBifcn7F1qfi1gi,SpATywNh6bZuzm8s1ceuBUnMUAeoAHHw,6,3,2,0,2,0,1,0,8,1.1428571428571428,1,0.0,0,2,0,2,3,0,0,1,0,4,4,1
2555,118040,Eemq3hk1Q3P1Pw1UumR7jNQlYsAdhi76,SpATywNh6bZuzm8s1ceuBUnMUAeoAHHw,1,0,0,0,0,0,2,0,2,0.2857142857142857,2,0.0,0,0,0,0,0,0,0,2,0,0,2,1
2556,118052,lQKPFBdAwC9d5aFjgrzYc27szNyJlIOi,bWdj2GDclj5ofokWjzoa5jAwMkxCykd6,1,0,0,0,0,0,2,0,2,0.2857142857142857,1,0.0,0,0,0,0,0,0,0,2,0,0,2,1
2557,118056,skJn7dtfSekFrPHRHs9swZ9AtSUKi36u,bWdj2GDclj5ofokWjzoa5jAwMkxCykd6,4,3,2,0,0,0,1,0,6,0.8571428571428571,1,0.0,0,2,0,0,3,0,0,1,0,2,4,1
2558,118084,hJwtwnOzJaTrAeP4eXJAEwz2xbKsgc4M,A3fsA9Zfv1X2fVEQhTw51lKENdNrEqT3,2,0,0,0,0,0,5,0,5,0.7142857142857143,2,0.0,0,0,0,0,0,0,0,5,0,0,5,0
2559,118085,hJwtwnOzJaTrAeP4eXJAEwz2xbKsgc4M,bWdj2GDclj5ofokWjzoa5jAwMkxCykd6,1,0,0,0,0,0,5,0,5,0.7142857142857143,4,0.0,0,0,0,0,0,0,0,5,0,0,5,0
2560,118091,hJwtwnOzJaTrAeP4eXJAEwz2xbKsgc4M,RXDvfPUBYFlVdlueBFbLW0mhhAyGEqpt,1,0,0,0,0,0,6,0,6,0.8571428571428571,5,0.0,0,0,0,0,0,0,0,6,0,0,6,1
2561,118100,qceTeoelxto8cUOivqTuxvNZNnsHQRN6,SpATywNh6bZuzm8s1ceuBUnMUAeoAHHw,28,31,17,19,11,1,6,0,85,12.142857142857142,4,0.0,5,17,18,11,26,1,1,6,0,51,34,0
2562,118110,n97hqxU6pa0pyrYxofJJX3kbArZF9Hya,SpATywNh6bZuzm8s1ceuBUnMUAeoAHHw,5,2,1,0,1,0,2,0,6,0.8571428571428571,1,0.0,0,1,0,1,2,0,0,2,0,2,4,1
2563,118111,vlcrE6RvFFuyjHZx9sgpQaFTegXr4wza,bWdj2GDclj5ofokWjzoa5jAwMkxCykd6,5,3,2,0,1,0,2,0,8,1.1428571428571428,1,0.0,0,2,0,1,3,0,0,2,0,3,5,1
2564,118115,QXyZtQTzdxqnHSXK4hpAwUSj9MimJfEp,SpATywNh6bZuzm8s1ceuBUnMUAeoAHHw,20,19,9,33,3,13,3,1,81,11.571428571428571,1,0.0,9,9,30,3,10,13,3,3,1,51,30,0
2565,118118,l3b9HlsGDQW9AY17jLNuKVLgfuE5tsF4,SpATywNh6bZuzm8s1ceuBUnMUAeoAHHw,8,13,7,0,0,1,9,0,30,4.285714285714286,5,0.0,0,7,0,0,13,1,0,9,0,7,23,0
2566,118119,5rIDDYg0Y0BALcyb0c2BGIVHn1eXoPjW,SpATywNh6bZuzm8s1ceuBUnMUAeoAHHw,17,16,8,6,4,0,4,0,38,5.428571428571429,2,0.0,4,8,6,4,12,0,0,4,0,22,16,1
2567,118127,h4Ts0QZ9Axnf77ZfOuF03oUEp9wmSbSp,SpATywNh6bZuzm8s1ceuBUnMUAeoAHHw,8,7,4,0,2,0,3,0,16,2.2857142857142856,2,0.0,0,4,0,2,7,0,0,3,0,6,10,1
2568,118130,0sa6kP9h4ahNr7Hzfeaa1Mssp5M7IVmw,SpATywNh6bZuzm8s1ceuBUnMUAeoAHHw,5,15,4,0,2,0,5,0,26,3.7142857142857144,2,0.0,0,4,0,2,15,0,0,5,0,6,20,1
2569,118174,FeFq7ZGqpMZdGp1e1neypp6dkWmjw2YJ,SpATywNh6bZuzm8s1ceuBUnMUAeoAHHw,3,3,0,0,0,0,1,0,4,0.5714285714285714,1,0.0,0,0,0,0,3,0,0,1,0,0,4,1
2570,118203,HX0eOrMEwIw9JyfkWs6Tn0Lny06N2ZVO,SpATywNh6bZuzm8s1ceuBUnMUAeoAHHw,18,27,11,15,4,1,3,0,61,8.714285714285714,2,0.0,11,11,13,4,16,1,2,3,0,39,22,0
2571,118208,iPn4eHBBcGh91aOsj9d5XOb4QbfUGe6N,bWdj2GDclj5ofokWjzoa5jAwMkxCykd6,14,14,5,16,4,2,12,1,54,7.714285714285714,1,0.0,5,5,14,4,9,2,2,12,1,28,26,1
2572,118218,66rxtelZjlVaBERuinHZ5AhHu9R6Idp5,SpATywNh6bZuzm8s1ceuBUnMUAeoAHHw,6,5,1,0,1,0,2,0,9,1.2857142857142858,1,0.0,0,1,0,1,5,0,0,2,0,2,7,1
2573,118232,TANF2ueHbJbwPsuSCbh96NH4X4PT1TeC,SpATywNh6bZuzm8s1ceuBUnMUAeoAHHw,19,24,1,22,0,0,1,0,48,6.857142857142857,1,0.0,8,1,21,0,16,0,1,1,0,30,18,1
2574,118239,4uAdkCJ4XUaD1NQGV93nNifOuyurJNKS,SpATywNh6bZuzm8s1ceuBUnMUAeoAHHw,17,35,0,7,0,4,6,0,52,7.428571428571429,2,0.0,17,0,7,0,18,4,0,6,0,24,28,0
2575,118258,5rpYxIaCTDb4PhszkJWpACOx5VMpNGcQ,SpATywNh6bZuzm8s1ceuBUnMUAeoAHHw,3,4,2,0,0,0,3,0,9,1.2857142857142858,2,0.0,0,2,0,0,4,0,0,3,0,2,7,0
2576,118279,JGr8n6jajfkXDK9cWT8ogx09tHg0xA1G,SpATywNh6bZuzm8s1ceuBUnMUAeoAHHw,5,2,1,0,1,0,2,0,6,0.8571428571428571,1,0.0,0,1,0,1,2,0,0,2,0,2,4,1
2577,118318,7hhGe4WcGEHypOzIVz3DLRx9GS52ozkE,RXDvfPUBYFlVdlueBFbLW0mhhAyGEqpt,17,24,17,8,9,0,9,0,67,9.571428571428571,4,0.0,2,17,7,9,22,0,1,9,0,35,32,0
2578,118339,cu2czfUbk8fdWWzCcDvTVYWH50Wg3XUq,SpATywNh6bZuzm8s1ceuBUnMUAeoAHHw,13,16,0,17,0,1,9,4,47,6.714285714285714,3,0.0,4,0,16,0,12,1,1,9,4,20,27,0
2579,118354,go2ODVnHLUhmZxhceJfs22CCaN5tZ78H,SpATywNh6bZuzm8s1ceuBUnMUAeoAHHw,5,2,1,0,1,0,2,0,6,0.8571428571428571,1,0.0,0,1,0,1,2,0,0,2,0,2,4,1
2580,118368,Tsd6J3Xles5MCEcWektA7d5EB7cldkxK,bWdj2GDclj5ofokWjzoa5jAwMkxCykd6,1,0,0,0,0,0,1,0,1,0.14285714285714285,1,0.0,0,0,0,0,0,0,0,1,0,0,1,1
2581,118369,httl8KJFJiDMZk4tgEQADrIoYysynrAv,SpATywNh6bZuzm8s1ceuBUnMUAeoAHHw,8,5,1,0,1,0,2,0,9,1.2857142857142858,1,0.0,0,1,0,1,5,0,0,2,0,2,7,1
2582,118371,hZtYMC0K38gXqBKrTDOxWf2kSwG06wA4,RXDvfPUBYFlVdlueBFbLW0mhhAyGEqpt,28,30,13,30,8,19,6,0,106,15.142857142857142,3,0.0,4,13,26,8,26,19,4,6,0,51,55,0
2583,118393,LVTU4qA4F3wWkxH81iGfu4ZuIt77nyhh,SpATywNh6bZuzm8s1ceuBUnMUAeoAHHw,7,13,5,0,1,0,8,0,27,3.857142857142857,4,0.0,0,5,0,1,13,0,0,8,0,6,21,0
2584,118422,ZNBGAlJve4TYJ3FcDlTLBdyuklADldDZ,bWdj2GDclj5ofokWjzoa5jAwMkxCykd6,4,2,1,0,0,0,2,0,5,0.7142857142857143,1,0.0,0,1,0,0,2,0,0,2,0,1,4,1
2585,118435,U4egSBuIz4Tp2aExbhUIhaem6H1lHi4I,bWdj2GDclj5ofokWjzoa5jAwMkxCykd6,3,3,1,0,0,0,2,0,6,0.8571428571428571,1,0.0,0,1,0,0,3,0,0,2,0,1,5,1
2586,118467,Lu93o5GXoxd6qTdHk7BshqxRhX67SrrE,SpATywNh6bZuzm8s1ceuBUnMUAeoAHHw,7,10,0,0,0,0,1,0,11,1.5714285714285714,1,0.0,2,0,0,0,8,0,0,1,0,2,9,0
2587,118468,s18XVhMq5o50489RseclkjZSQF8K6sqD,G8EPVSXsOYB5YQWZGiz1aVq5Pgr2GrQu,20,22,14,24,8,0,2,0,70,10.0,2,0.0,4,14,19,8,18,0,5,2,0,45,25,1
2588,118500,37JCabFNpj6A5aUwdVeB55bOPV42TLJp,RXDvfPUBYFlVdlueBFbLW0mhhAyGEqpt,5,2,1,0,1,0,3,0,7,1.0,2,0.0,0,1,0,1,2,0,0,3,0,2,5,1
2589,118501,dhPPBp8unV3f13L4xkPHpVmkrnYAmORu,SpATywNh6bZuzm8s1ceuBUnMUAeoAHHw,7,4,3,0,3,0,2,0,12,1.7142857142857142,1,0.0,0,3,0,3,4,0,0,2,0,6,6,1
2590,118506,GrjEbVPh1uYw8afH98AN7VXn6UMAVnC8,A3fsA9Zfv1X2fVEQhTw51lKENdNrEqT3,4,3,0,0,0,0,3,0,6,0.8571428571428571,1,0.0,0,0,0,0,3,0,0,3,0,0,6,1
2591,118508,TnL4ialg6Pf5M7cIMrmaVmE9VMhEtv14,RXDvfPUBYFlVdlueBFbLW0mhhAyGEqpt,8,6,1,0,1,2,3,1,14,2.0,1,0.0,0,1,0,1,6,2,0,3,1,2,12,1
2592,118514,W3axEfDtpWFQrOsjh1ju6UWJlt7DtE7b,SpATywNh6bZuzm8s1ceuBUnMUAeoAHHw,12,10,0,0,0,0,8,1,19,2.7142857142857144,3,0.0,0,0,0,0,10,0,0,8,1,0,19,1
2593,118535,Xd9kUiTgAJSeI24Pf6yPClc38pebYRoH,SpATywNh6bZuzm8s1ceuBUnMUAeoAHHw,5,4,2,0,0,0,2,0,8,1.1428571428571428,1,0.0,0,2,0,0,4,0,0,2,0,2,6,1
2594,118548,2i4UZQIumoYMpXAy2hMZiboq0bmSvHzQ,RXDvfPUBYFlVdlueBFbLW0mhhAyGEqpt,6,10,0,0,0,0,1,0,11,1.5714285714285714,1,0.0,0,0,0,0,10,0,0,1,0,0,11,1
2595,118554,YBwTM3Bv2witVJ0Ed4zAbHn1UCLHLsEN,G8EPVSXsOYB5YQWZGiz1aVq5Pgr2GrQu,19,25,9,22,5,0,3,0,64,9.142857142857142,3,0.0,12,9,12,5,13,0,10,3,0,38,26,0
2596,118577,fjx9OtTbfeYJcewn1ZUVP1qyFT70WiAr,SpATywNh6bZuzm8s1ceuBUnMUAeoAHHw,1,0,0,0,0,0,1,0,1,0.14285714285714285,1,0.0,0,0,0,0,0,0,0,1,0,0,1,1
2597,118590,7GOzqt1OWuRQhmoyI6QcRiOEY3qIt0kS,SpATywNh6bZuzm8s1ceuBUnMUAeoAHHw,4,2,0,0,0,0,2,0,4,0.5714285714285714,1,0.0,0,0,0,0,2,0,0,2,0,0,4,1
2598,118620,tKs772tHpR5tE8Ceee9VXQcqKPNhx6zt,SpATywNh6bZuzm8s1ceuBUnMUAeoAHHw,16,14,1,6,1,3,8,1,34,4.857142857142857,3,0.0,0,1,5,1,14,3,1,8,1,7,27,1
2599,118652,eNgDL8k9xOLyBlZ3UNlseJHly8SfPZZu,bWdj2GDclj5ofokWjzoa5jAwMkxCykd6,22,29,18,38,3,0,9,0,97,13.857142857142858,5,0.0,3,18,31,3,26,0,7,9,0,55,42,0
2600,118658,eJLeV7Xq2bhq90HDU7vo6Tpmzbd63FDZ,SpATywNh6bZuzm8s1ceuBUnMUAeoAHHw,3,8,4,0,0,0,4,0,16,2.2857142857142856,4,0.0,0,4,0,0,8,0,0,4,0,4,12,0
2601,118687,c1BXmJNemroOPh6WUefTBD28s2WzSNwi,A3fsA9Zfv1X2fVEQhTw51lKENdNrEqT3,29,15,1,68,2,0,3,0,89,12.714285714285714,3,0.0,2,1,63,2,13,0,5,3,0,68,21,1
2602,118688,c1BXmJNemroOPh6WUefTBD28s2WzSNwi,SpATywNh6bZuzm8s1ceuBUnMUAeoAHHw,5,3,1,0,1,0,1,0,6,0.8571428571428571,1,0.0,0,1,0,1,3,0,0,1,0,2,4,0
2603,118704,ZfIQYurnR6gJbWxLJ81cU3ZqzX4mpHm0,bWdj2GDclj5ofokWjzoa5jAwMkxCykd6,3,2,1,0,0,0,1,0,4,0.5714285714285714,1,0.0,0,1,0,0,2,0,0,1,0,1,3,0
2604,118714,MdZgTLmSGHkFWwMHVbVxaIOd0RHUp1Ya,G8EPVSXsOYB5YQWZGiz1aVq5Pgr2GrQu,8,2,2,0,2,1,3,0,10,1.4285714285714286,1,0.0,0,2,0,2,2,1,0,3,0,4,6,1
2605,118716,fomJrwdlOVBB27jkNMuLttmiA1XIZPzf,SpATywNh6bZuzm8s1ceuBUnMUAeoAHHw,13,18,3,4,3,1,1,0,30,4.285714285714286,3,0.0,4,3,3,3,14,1,1,1,0,13,17,1
2606,118723,9Gk0qMwFPQMSYtSGwJwjevbzKboXiTpg,SpATywNh6bZuzm8s1ceuBUnMUAeoAHHw,25,29,1,36,1,10,10,1,88,12.571428571428571,2,0.0,8,1,30,1,21,10,6,10,1,40,48,1
2607,118727,uFAwXIcuVZUrzooQS3i05Ojiq5CkITl5,G8EPVSXsOYB5YQWZGiz1aVq5Pgr2GrQu,5,2,1,0,1,0,2,0,6,0.8571428571428571,1,0.0,0,1,0,1,2,0,0,2,0,2,4,1
2608,118735,f6FNE8vNtrL6TKWAyYNA5KZvLoAoDp49,SpATywNh6bZuzm8s1ceuBUnMUAeoAHHw,8,8,3,0,4,0,14,0,29,4.142857142857143,2,0.0,0,3,0,4,8,0,0,14,0,7,22,1
2609,118748,grNuFIQJF1sOOkw8RJjaExhlwTJt52uU,G8EPVSXsOYB5YQWZGiz1aVq5Pgr2GrQu,6,5,3,0,0,0,7,0,15,2.142857142857143,3,0.0,0,3,0,0,5,0,0,7,0,3,12,0
2610,118753,5ccVO0DXIbSzn48qO0PlyxYK6uXvmUBC,SpATywNh6bZuzm8s1ceuBUnMUAeoAHHw,12,11,9,0,6,0,3,0,29,4.142857142857143,2,0.0,0,9,0,6,11,0,0,3,0,15,14,1
2611,118757,8x72g1EnsW8bYBL6HWtA15C4pKj2sPjA,G8EPVSXsOYB5YQWZGiz1aVq5Pgr2GrQu,4,5,0,0,0,0,2,0,7,1.0,2,0.0,0,0,0,0,5,0,0,2,0,0,7,1
2612,118770,JMRIHPxvEm8exxpzKPAmRrEIUgoG5Mrh,SpATywNh6bZuzm8s1ceuBUnMUAeoAHHw,7,10,4,0,1,1,5,0,21,3.0,3,0.0,0,4,0,1,10,1,0,5,0,5,16,0
2613,118779,xH5f8nfW6oTIgHjXoQgEUKIx6qvDN8rk,bWdj2GDclj5ofokWjzoa5jAwMkxCykd6,1,0,0,0,0,0,1,0,1,0.14285714285714285,1,0.0,0,0,0,0,0,0,0,1,0,0,1,0
2614,118792,bKVslXuzEQ1pv4c6iV5mVjs6X6avUbmL,SpATywNh6bZuzm8s1ceuBUnMUAeoAHHw,4,0,0,0,0,2,3,0,5,0.7142857142857143,2,0.0,0,0,0,0,0,2,0,3,0,0,5,1
2615,118793,lrp5AGJUh69hKuCI5IYUEU19E2beipwd,bWdj2GDclj5ofokWjzoa5jAwMkxCykd6,9,12,0,0,0,7,4,0,23,3.2857142857142856,2,0.0,0,0,0,0,12,7,0,4,0,0,23,1
2616,118797,Lk947zUxODvAz9uAzr7LhEhqya4oVnNV,SpATywNh6bZuzm8s1ceuBUnMUAeoAHHw,5,4,2,0,0,0,2,0,8,1.1428571428571428,1,0.0,1,2,0,0,3,0,0,2,0,3,5,0
2617,118805,c9mIdDAhRczXEb5UJiDqrnVR2zYNOBwR,A3fsA9Zfv1X2fVEQhTw51lKENdNrEqT3,1,0,0,0,0,0,1,0,1,0.14285714285714285,1,0.0,0,0,0,0,0,0,0,1,0,0,1,1
2618,118806,NbUyHCtjlZY38KWhmKKrrw2eE1rI3XlV,SpATywNh6bZuzm8s1ceuBUnMUAeoAHHw,4,2,1,0,1,0,1,0,5,0.7142857142857143,1,0.0,0,1,0,1,2,0,0,1,0,2,3,0
2619,118869,5J6qme6tgFximxgH6JaagcgP0HlXsQ9E,SpATywNh6bZuzm8s1ceuBUnMUAeoAHHw,1,0,0,0,0,0,1,0,1,0.14285714285714285,1,0.0,0,0,0,0,0,0,0,1,0,0,1,1
2620,118870,5J6qme6tgFximxgH6JaagcgP0HlXsQ9E,G8EPVSXsOYB5YQWZGiz1aVq5Pgr2GrQu,2,0,0,0,0,0,2,0,2,0.2857142857142857,1,0.0,0,0,0,0,0,0,0,2,0,0,2,1
2621,118873,xKEKXJFa8iwv6Ll5IrcgpUyxzmqp78kE,G8EPVSXsOYB5YQWZGiz1aVq5Pgr2GrQu,4,2,1,0,1,0,2,0,6,0.8571428571428571,1,0.0,0,1,0,1,2,0,0,2,0,2,4,1
2622,118880,bqWpav7ocOhCfb3xc4QgAvBDK5g8BmiZ,RXDvfPUBYFlVdlueBFbLW0mhhAyGEqpt,6,7,4,0,0,0,4,0,15,2.142857142857143,2,0.0,0,4,0,0,7,0,0,4,0,4,11,0
2623,118884,c8WJAdYLV71mOx4ZXSglpCNd0dBUR3Om,SpATywNh6bZuzm8s1ceuBUnMUAeoAHHw,3,6,2,0,0,0,3,0,11,1.5714285714285714,3,0.0,0,2,0,0,6,0,0,3,0,2,9,0
2624,118894,5ESBYT4YXwThMhRWcyNvUGRmyEr1sxDg,bWdj2GDclj5ofokWjzoa5jAwMkxCykd6,8,12,5,58,1,0,2,0,78,11.142857142857142,2,0.0,1,5,56,1,11,0,2,2,0,63,15,0
2625,118896,Jp4TJ4yNuhjTEvrsxd0CarZSf22aa7u6,bWdj2GDclj5ofokWjzoa5jAwMkxCykd6,1,0,0,0,0,0,1,0,1,0.14285714285714285,1,0.0,0,0,0,0,0,0,0,1,0,0,1,1
2626,118899,4TYIBYUjGx5Az0xYJI94tEHK7klSyatr,SpATywNh6bZuzm8s1ceuBUnMUAeoAHHw,1,0,0,0,0,0,1,0,1,0.14285714285714285,1,0.0,0,0,0,0,0,0,0,1,0,0,1,1
2627,118902,fhqx50pW0TcVQ59FT0II7MmWoAXcWiY8,RXDvfPUBYFlVdlueBFbLW0mhhAyGEqpt,1,0,0,0,0,0,2,0,2,0.2857142857142857,1,0.0,0,0,0,0,0,0,0,2,0,0,2,1
2628,118960,TzZdxcOoymQCIG3dwqgzf7xbUV8iLHy5,SpATywNh6bZuzm8s1ceuBUnMUAeoAHHw,5,5,0,0,0,1,5,0,11,1.5714285714285714,2,0.0,0,0,0,0,5,1,0,5,0,0,11,1
2629,118971,u2BXxIc4z9dAiJXDpFgnfPpgZoYcSTcc,bWdj2GDclj5ofokWjzoa5jAwMkxCykd6,3,2,1,0,0,0,2,0,5,0.7142857142857143,1,0.0,0,1,0,0,2,0,0,2,0,1,4,1
2630,119004,3eP3vquJMvO37pCrMFuVqCWmbxwqBlGj,A3fsA9Zfv1X2fVEQhTw51lKENdNrEqT3,4,3,1,0,0,0,1,0,5,0.7142857142857143,1,0.0,0,1,0,0,3,0,0,1,0,1,4,1
2631,119018,YlBjTpSiRd0E60X9iyws01NkNrRpj13s,SpATywNh6bZuzm8s1ceuBUnMUAeoAHHw,10,14,3,18,0,0,1,0,36,5.142857142857143,1,0.0,6,3,17,0,8,0,1,1,0,26,10,1
2632,119045,VXXH6vGXZQbtzT48oIYSMTaYkPq1TVm5,SpATywNh6bZuzm8s1ceuBUnMUAeoAHHw,19,19,11,12,6,3,4,0,55,7.857142857142857,1,0.0,2,11,11,6,17,3,1,4,0,30,25,0
2633,119053,fS72R3kjN9mNNeiYurwm3Uc8w1dF6aYm,SpATywNh6bZuzm8s1ceuBUnMUAeoAHHw,6,18,6,0,1,2,2,0,29,4.142857142857143,2,0.0,9,6,0,1,9,2,0,2,0,16,13,0
2634,119081,GXJYNcNV7uKT2JtMLlsgpwRjSgogNoCV,SpATywNh6bZuzm8s1ceuBUnMUAeoAHHw,4,3,2,0,0,0,1,0,6,0.8571428571428571,1,0.0,0,2,0,0,3,0,0,1,0,2,4,1
2635,119116,syYCTgfx3QIfokZD3KllJs2hnCVUuN4D,G8EPVSXsOYB5YQWZGiz1aVq5Pgr2GrQu,11,18,7,0,5,0,1,0,31,4.428571428571429,1,0.0,0,7,0,5,18,0,0,1,0,12,19,1
2636,119128,OUbrW18OgibVb4I41eHFiFhkobpgjEP2,bWdj2GDclj5ofokWjzoa5jAwMkxCykd6,9,5,4,0,3,0,2,0,14,2.0,1,0.0,0,4,0,3,5,0,0,2,0,7,7,0
2637,119135,LU9kxt8aKnlOn8SnA2EuX2MLajf5Sg2a,RXDvfPUBYFlVdlueBFbLW0mhhAyGEqpt,6,3,2,0,1,0,2,0,8,1.1428571428571428,1,0.0,0,2,0,1,3,0,0,2,0,3,5,1
2638,119144,ppepyuI84wHcCSvA9T6Tm0AI9MVxK9O7,SpATywNh6bZuzm8s1ceuBUnMUAeoAHHw,18,19,8,12,5,9,6,4,63,9.0,1,0.0,10,8,10,5,9,9,2,6,4,33,30,0
2639,119158,y71lRBqIdu5iPiLn9Yi5PQm6GFIvgLwB,SpATywNh6bZuzm8s1ceuBUnMUAeoAHHw,5,11,7,0,0,0,4,0,22,3.142857142857143,2,0.0,1,7,0,0,10,0,0,4,0,8,14,0
2640,119181,mu7Zdr1ChN6xNMWE8Otd7Si7TQhm7pEQ,A3fsA9Zfv1X2fVEQhTw51lKENdNrEqT3,6,3,2,0,1,0,2,0,8,1.1428571428571428,1,0.0,0,2,0,1,3,0,0,2,0,3,5,1
2641,119189,OXg5CDewbDZIhWJ50yEsGOqULuWAjfkH,SpATywNh6bZuzm8s1ceuBUnMUAeoAHHw,3,2,1,0,0,0,1,0,4,0.5714285714285714,1,0.0,0,1,0,0,2,0,0,1,0,1,3,0
2642,119210,MgBJbfRXH0QNEJmIiGY28SpmFvbhxSoF,SpATywNh6bZuzm8s1ceuBUnMUAeoAHHw,4,8,4,0,0,0,8,0,20,2.857142857142857,3,0.0,0,4,0,0,8,0,0,8,0,4,16,0
2643,119254,i0ksX07HnsV5rQlWqOr1uKEuc7yNU24c,SpATywNh6bZuzm8s1ceuBUnMUAeoAHHw,3,2,1,0,0,0,1,0,4,0.5714285714285714,1,0.0,0,1,0,0,2,0,0,1,0,1,3,0
2644,119277,sBmxTL0paOf5h6iJST2iiGwB52qodqPr,bWdj2GDclj5ofokWjzoa5jAwMkxCykd6,3,2,1,0,0,0,1,0,4,0.5714285714285714,1,0.0,0,1,0,0,2,0,0,1,0,1,3,0
2645,119311,o5C13ZWWgtJ11zB44EfcDF5SUBXAMxu8,SpATywNh6bZuzm8s1ceuBUnMUAeoAHHw,5,3,1,0,1,0,1,0,6,0.8571428571428571,1,0.0,0,1,0,1,3,0,0,1,0,2,4,0
2646,119354,dTKURyZ9dyqGbe4l7wsUGgSU85JHBAFq,SpATywNh6bZuzm8s1ceuBUnMUAeoAHHw,3,2,1,0,0,0,1,0,4,0.5714285714285714,1,0.0,0,1,0,0,2,0,0,1,0,1,3,0
2647,119390,hZR4MwcYec4g0GoOyJFngJGEyWOySpv2,A3fsA9Zfv1X2fVEQhTw51lKENdNrEqT3,5,2,1,0,0,0,6,0,9,1.2857142857142858,2,0.0,0,1,0,0,2,0,0,6,0,1,8,0
2648,119391,mxHDkP66knN7zmdYEUQKDHYwEophbx3W,SpATywNh6bZuzm8s1ceuBUnMUAeoAHHw,4,7,1,0,0,0,4,0,12,1.7142857142857142,2,0.0,1,1,0,0,6,0,0,4,0,2,10,0
2649,119506,KouA4JUz2i1n0FC6Xu2JucWPd7vnGUb0,SpATywNh6bZuzm8s1ceuBUnMUAeoAHHw,4,2,1,0,0,0,3,0,6,0.8571428571428571,2,0.0,0,1,0,0,2,0,0,3,0,1,5,0
2650,119509,8MuGb55gUM18pukCITXgZoTSobqXs9G4,SpATywNh6bZuzm8s1ceuBUnMUAeoAHHw,2,0,0,0,0,0,3,0,3,0.42857142857142855,2,0.0,0,0,0,0,0,0,0,3,0,0,3,1
2651,119524,RRKT0H2BFDE1dQIQFr3IpZgVIVSJVg71,SpATywNh6bZuzm8s1ceuBUnMUAeoAHHw,1,0,0,0,0,0,1,0,1,0.14285714285714285,1,0.0,0,0,0,0,0,0,0,1,0,0,1,0
2652,119543,Cf7GCeUZzG7WjvUIyGfwv9hfcwXPVq5G,G8EPVSXsOYB5YQWZGiz1aVq5Pgr2GrQu,18,54,1,7,3,0,4,0,69,9.857142857142858,3,0.0,10,1,4,3,44,0,3,4,0,18,51,0
2653,119567,Dl433WBzpFXMdRxwA66dmtxmpsyN7fkX,SpATywNh6bZuzm8s1ceuBUnMUAeoAHHw,3,8,3,0,0,0,5,0,16,2.2857142857142856,4,0.0,0,3,0,0,8,0,0,5,0,3,13,0
2654,119618,nIvIddlMAmTQagaACOulbZ6PInxlyOy2,A3fsA9Zfv1X2fVEQhTw51lKENdNrEqT3,9,10,6,0,3,0,1,0,20,2.857142857142857,1,0.0,3,6,0,3,7,0,0,1,0,12,8,1
2655,119695,EGp6xRzNCnsCPDRg0mfvtfy8t2jZt4I9,SpATywNh6bZuzm8s1ceuBUnMUAeoAHHw,1,0,0,0,0,0,1,0,1,0.14285714285714285,1,0.0,0,0,0,0,0,0,0,1,0,0,1,0
2656,119701,dkqBzIxmPMIDvZ06VSkMjfODuMzZmTP8,A3fsA9Zfv1X2fVEQhTw51lKENdNrEqT3,12,28,18,0,10,0,2,0,58,8.285714285714286,2,0.0,0,18,0,10,28,0,0,2,0,28,30,1
2657,119745,UvgRbw5a5wuG6YWcUt1dwOeNyn0b7Smd,SpATywNh6bZuzm8s1ceuBUnMUAeoAHHw,3,2,1,0,0,0,1,0,4,0.5714285714285714,1,0.0,0,1,0,0,2,0,0,1,0,1,3,1
2658,119863,C8zDhaG0vPsQegBtS55u3JZHiYuueFnE,A3fsA9Zfv1X2fVEQhTw51lKENdNrEqT3,1,0,0,0,0,0,4,0,4,0.5714285714285714,3,0.0,0,0,0,0,0,0,0,4,0,0,4,0
2659,119944,ico4mWfX6sj6OUii1pav0Sth51UYo7la,SpATywNh6bZuzm8s1ceuBUnMUAeoAHHw,26,25,16,17,10,0,2,0,70,10.0,1,0.0,8,16,16,10,17,0,1,2,0,50,20,1
2660,119957,u08BFRXkclhXgm6zX4b6QASKB5vRi3vI,G8EPVSXsOYB5YQWZGiz1aVq5Pgr2GrQu,6,8,5,0,1,0,3,0,17,2.4285714285714284,2,0.0,0,5,0,1,8,0,0,3,0,6,11,1
2661,120047,YeW4hKsNTCNPhFuRao1EDcfgQ0cnIKSL,SpATywNh6bZuzm8s1ceuBUnMUAeoAHHw,17,19,10,18,5,0,2,0,54,7.714285714285714,1,0.0,6,10,15,5,13,0,3,2,0,36,18,0
2662,120065,fFuKiCeoQQwOgD8VAud2ta198Mbq05KK,A3fsA9Zfv1X2fVEQhTw51lKENdNrEqT3,4,4,2,0,0,0,1,0,7,1.0,1,0.0,0,2,0,0,4,0,0,1,0,2,5,1
2663,120094,rn4nO5004kgupfgjaXh0qv5wJPGuOGCi,RXDvfPUBYFlVdlueBFbLW0mhhAyGEqpt,4,3,1,0,0,0,1,0,5,0.7142857142857143,1,0.0,0,1,0,0,3,0,0,1,0,1,4,1
2664,120223,nrDkIZH2wqEVh6i4pBxcbRBJIMc9s20b,G8EPVSXsOYB5YQWZGiz1aVq5Pgr2GrQu,21,19,2,44,4,0,6,0,75,10.714285714285714,3,0.0,4,2,42,4,15,0,2,6,0,52,23,0
2665,120235,RYd1k9DojojPZwrkV3NjsTI5OdZnPV9W,RXDvfPUBYFlVdlueBFbLW0mhhAyGEqpt,3,2,0,0,0,0,1,0,3,0.42857142857142855,1,0.0,0,0,0,0,2,0,0,1,0,0,3,1
2666,120239,80Av2RXrFoxNOdv7EQUM2TDOM0gyNH0J,SpATywNh6bZuzm8s1ceuBUnMUAeoAHHw,7,14,6,0,2,2,4,0,28,4.0,1,0.0,2,6,0,2,12,2,0,4,0,10,18,1
2667,120275,wx3mAGKFM6cge9w8piWfsYKppmWVhkYO,A3fsA9Zfv1X2fVEQhTw51lKENdNrEqT3,18,17,9,0,7,0,1,0,34,4.857142857142857,1,0.0,0,9,0,7,17,0,0,1,0,16,18,1
2668,120497,pb5Jjq3Ash9pKloUfJAc3dsHOjXwUSUN,SpATywNh6bZuzm8s1ceuBUnMUAeoAHHw,1,0,0,0,0,0,1,0,1,0.14285714285714285,1,0.0,0,0,0,0,0,0,0,1,0,0,1,1
2669,120499,5scsz5bGh8T1roTXhO7UpMXlEDKIsK9l,SpATywNh6bZuzm8s1ceuBUnMUAeoAHHw,1,0,0,0,0,0,1,0,1,0.14285714285714285,1,0.0,0,0,0,0,0,0,0,1,0,0,1,1
2670,120544,OektSQ9TNN3cEy3ZKuUs35c7BdSOqtaQ,bWdj2GDclj5ofokWjzoa5jAwMkxCykd6,3,4,2,0,0,0,2,0,8,1.1428571428571428,1,0.0,0,2,0,0,4,0,0,2,0,2,6,1
2671,120751,fTZGf1uwMtb2LTyvoTILgCp8LRW0SKIe,RXDvfPUBYFlVdlueBFbLW0mhhAyGEqpt,3,1,1,0,1,0,0,0,3,0.42857142857142855,1,0.0,0,1,0,1,1,0,0,0,0,2,1,1
2672,120771,IvdoAzckjyWWCkzCy6V0BjWvOwMyZEwg,bWdj2GDclj5ofokWjzoa5jAwMkxCykd6,13,3,2,35,0,0,1,0,41,5.857142857142857,1,0.0,0,2,35,0,3,0,0,1,0,37,4,1
2673,120808,OTAUIgoWBEWsq2kd8lnvB0dKpj3SXEdR,SpATywNh6bZuzm8s1ceuBUnMUAeoAHHw,5,3,2,0,0,0,4,0,9,1.2857142857142858,2,0.0,0,2,0,0,3,0,0,4,0,2,7,1
2674,120835,EaFWRMbtKR52j7nbPydGVwuzgPsml9aN,A3fsA9Zfv1X2fVEQhTw51lKENdNrEqT3,5,3,2,2,0,0,1,0,8,1.1428571428571428,1,0.0,0,2,2,0,3,0,0,1,0,4,4,1
2675,120892,pAkhnLI0s5vboktZycO7Tobv6jbspULh,SpATywNh6bZuzm8s1ceuBUnMUAeoAHHw,3,4,1,0,0,0,3,0,8,1.1428571428571428,2,0.0,0,1,0,0,4,0,0,3,0,1,7,1
2676,120909,aldLXGpzmiip2CUSDhqN8A5UpGMVUHxY,A3fsA9Zfv1X2fVEQhTw51lKENdNrEqT3,4,6,4,0,0,0,4,0,14,2.0,3,0.0,0,4,0,0,6,0,0,4,0,4,10,0
2677,120973,VsZvGrXbL1e6v6hmpJQH8MldIkCBO9P7,RXDvfPUBYFlVdlueBFbLW0mhhAyGEqpt,5,0,0,0,0,1,4,1,6,0.8571428571428571,1,0.0,0,0,0,0,0,1,0,4,1,0,6,0
2678,120975,KjHOE07fI9pBFKqiwhrvCwjITj7tyFWN,G8EPVSXsOYB5YQWZGiz1aVq5Pgr2GrQu,19,11,5,12,3,0,9,0,40,5.714285714285714,1,0.0,3,5,10,3,8,0,2,9,0,21,19,1
2679,121100,8mYFryxeRH8GSnHog9hmhUPRk60LCyFI,SpATywNh6bZuzm8s1ceuBUnMUAeoAHHw,4,2,1,0,0,0,3,0,6,0.8571428571428571,1,0.0,0,1,0,0,2,0,0,3,0,1,5,1
2680,121105,M8ur292SdHouJ1LnQyJMDkHJM5sUPxnX,SpATywNh6bZuzm8s1ceuBUnMUAeoAHHw,9,15,1,0,1,0,2,0,19,2.7142857142857144,1,0.0,0,1,0,1,15,0,0,2,0,2,17,0
2681,121134,4IxaKtzWvkfFEFZ43UhJQOyIahcBxrF2,SpATywNh6bZuzm8s1ceuBUnMUAeoAHHw,11,16,2,14,0,0,3,0,35,5.0,2,0.0,2,2,12,0,14,0,2,3,0,16,19,1
2682,121136,kHp5QZURLzbWn4koqFYZnQmO0kliz5hb,SpATywNh6bZuzm8s1ceuBUnMUAeoAHHw,2,2,1,0,0,0,0,0,3,0.42857142857142855,1,0.0,0,1,0,0,2,0,0,0,0,1,2,1
2683,121191,MbmumbK7FHZlEn2oNe4YMQEQzBas1u6w,bWdj2GDclj5ofokWjzoa5jAwMkxCykd6,5,6,3,0,2,0,1,0,12,1.7142857142857142,1,0.0,1,3,0,2,5,0,0,1,0,6,6,0
2684,121328,o1wU0MfzmEznHSZOZDS8DejIhVczhoMt,A3fsA9Zfv1X2fVEQhTw51lKENdNrEqT3,1,0,0,0,0,0,1,0,1,0.14285714285714285,1,0.0,0,0,0,0,0,0,0,1,0,0,1,1
2685,121330,o1wU0MfzmEznHSZOZDS8DejIhVczhoMt,bWdj2GDclj5ofokWjzoa5jAwMkxCykd6,1,0,0,0,0,0,2,0,2,0.2857142857142857,1,0.0,0,0,0,0,0,0,0,2,0,0,2,1
2686,121339,oKz0rKWQtHW8DkPwxTgdemWb21NvE4BO,SpATywNh6bZuzm8s1ceuBUnMUAeoAHHw,3,2,0,0,0,0,1,0,3,0.42857142857142855,1,0.0,0,0,0,0,2,0,0,1,0,0,3,1
2687,121345,ePaTLgBKhclwas3ClxzVVmTCgYzhx4go,SpATywNh6bZuzm8s1ceuBUnMUAeoAHHw,1,0,0,0,0,0,2,0,2,0.2857142857142857,1,0.0,0,0,0,0,0,0,0,2,0,0,2,0
2688,121446,Haz3G1DnETqwzmdUg5ALbCZo1Lv5wDs9,SpATywNh6bZuzm8s1ceuBUnMUAeoAHHw,3,2,1,0,0,0,1,0,4,0.5714285714285714,1,0.0,0,1,0,0,2,0,0,1,0,1,3,1
2689,121656,aVeyGdrz6Ir4LmiLkJqBoRjG1lQ7MsV8,bWdj2GDclj5ofokWjzoa5jAwMkxCykd6,32,49,23,80,4,2,13,1,172,24.571428571428573,4,0.0,8,23,69,4,41,2,11,13,1,104,68,0
2690,121712,zdC6SE3iIVhpYTGT1Ftflp0F2V48NqFq,SpATywNh6bZuzm8s1ceuBUnMUAeoAHHw,3,5,2,0,0,0,4,0,11,1.5714285714285714,1,0.0,0,2,0,0,5,0,0,4,0,2,9,1
2691,121743,bFBipIvg3ynAbrvo3mXNRP6i8NWVQRYx,A3fsA9Zfv1X2fVEQhTw51lKENdNrEqT3,16,10,7,0,4,1,8,1,31,4.428571428571429,1,0.0,1,7,0,4,9,1,0,8,1,12,19,1
2692,121766,EbdsJCzME79IdKcgnIKOnAggJJmkpV77,G8EPVSXsOYB5YQWZGiz1aVq5Pgr2GrQu,3,1,1,0,1,0,0,0,3,0.42857142857142855,1,0.0,0,1,0,1,1,0,0,0,0,2,1,0
2693,121829,gOODBz9FfXPZcnKA2RT49UqbScA5gVkT,SpATywNh6bZuzm8s1ceuBUnMUAeoAHHw,5,3,2,0,1,0,1,0,7,1.0,1,0.0,0,2,0,1,3,0,0,1,0,3,4,1
2694,121870,iY0UWsKzM76w2sBfvkSz2A0A6313cEPM,SpATywNh6bZuzm8s1ceuBUnMUAeoAHHw,4,3,1,0,0,0,1,0,5,0.7142857142857143,1,0.0,0,1,0,0,3,0,0,1,0,1,4,1
2695,124685,qwhxcjW9iIMBAQoGSWDtst34AFkcFQoV,7GRhBDsirIGkRZBtSMEzNTyDr2JQm4xx,3,2,1,0,0,0,1,0,4,0.5714285714285714,1,0.0,0,1,0,0,2,0,0,1,0,1,3,0
2696,124719,s1zoJG6TsTv8LP9PRWCYbeiv4OLIivpy,7GRhBDsirIGkRZBtSMEzNTyDr2JQm4xx,1,0,0,0,0,0,1,0,1,0.14285714285714285,1,0.0,0,0,0,0,0,0,0,1,0,0,1,1
2697,124723,pyk8IpgYoJC2oe3kCohOVZ3WNjOmgeaA,7GRhBDsirIGkRZBtSMEzNTyDr2JQm4xx,1,0,1,0,0,0,0,0,1,0.14285714285714285,1,0.0,0,1,0,0,0,0,0,0,0,1,0,1
2698,126648,j9gdcEQiWF4hz17rFxv9vKJSxkrv7Ewo,fbPkOYLVPtPgIt0MxizjfFJov3JbHyAi,6,7,5,0,3,2,5,0,22,3.142857142857143,2,0.0,0,5,0,3,7,2,0,5,0,8,14,1
2699,126699,AGXZupnvuozaRzZmgdrKKyAy6oGdUdjZ,fbPkOYLVPtPgIt0MxizjfFJov3JbHyAi,19,22,12,0,8,3,10,0,55,7.857142857142857,1,0.0,3,12,0,8,19,3,0,10,0,23,32,1
2700,126715,Z7UOgoOv3zZwU9zvjSxLYTFWLOhyMpWi,fbPkOYLVPtPgIt0MxizjfFJov3JbHyAi,5,4,2,0,0,0,1,0,7,1.0,1,0.0,0,2,0,0,4,0,0,1,0,2,5,1
2701,126742,B1Gq6e77yv7kkDqJ7SH2TygdPDzPBwQh,fbPkOYLVPtPgIt0MxizjfFJov3JbHyAi,31,37,22,7,11,0,9,0,86,12.285714285714286,5,0.0,10,22,7,11,27,0,0,9,0,50,36,1
2702,126750,bpsYUsj9C1SHgZpkPYxDXsRDOrg2cbuw,fbPkOYLVPtPgIt0MxizjfFJov3JbHyAi,10,7,5,0,2,0,3,0,17,2.4285714285714284,1,0.0,0,5,0,2,7,0,0,3,0,7,10,1
2703,126756,UQ2ITfvqEyrVlMsMiud1odTDb3yeUeeN,fbPkOYLVPtPgIt0MxizjfFJov3JbHyAi,5,5,2,0,2,0,1,0,10,1.4285714285714286,1,0.0,2,2,0,2,3,0,0,1,0,6,4,1
2704,126759,J0Jr0TKZ0YD8uJCfONhkS8KssytjG3hc,fbPkOYLVPtPgIt0MxizjfFJov3JbHyAi,2,0,0,0,0,0,2,0,2,0.2857142857142857,1,0.0,0,0,0,0,0,0,0,2,0,0,2,1
2705,126761,hqsJGd5HdE81psGb4B1N1K2xygUelqqn,fbPkOYLVPtPgIt0MxizjfFJov3JbHyAi,6,4,1,0,1,0,2,0,8,1.1428571428571428,1,0.0,0,1,0,1,4,0,0,2,0,2,6,1
2706,126765,yPVm3gMP0Ua9286Fd70ELAKAMFUpJIch,fbPkOYLVPtPgIt0MxizjfFJov3JbHyAi,1,0,0,0,0,0,1,0,1,0.14285714285714285,1,0.0,0,0,0,0,0,0,0,1,0,0,1,1
2707,126769,woczpAN6oIjjbcNjAQmIX9goIrlwr2g9,fbPkOYLVPtPgIt0MxizjfFJov3JbHyAi,10,13,1,0,1,5,7,2,29,4.142857142857143,1,0.0,0,1,0,1,13,5,0,7,2,2,27,1
2708,126770,QFN96cQBPcYAoDio3PD3qLU8mHPVFQ0T,fbPkOYLVPtPgIt0MxizjfFJov3JbHyAi,6,4,2,0,1,0,5,0,12,1.7142857142857142,3,0.0,0,2,0,1,4,0,0,5,0,3,9,1
2709,126772,uyZkiVvKwTUQeuXVbvnxcY0xXv0uj7Ou,fbPkOYLVPtPgIt0MxizjfFJov3JbHyAi,1,0,0,0,0,0,1,0,1,0.14285714285714285,1,0.0,0,0,0,0,0,0,0,1,0,0,1,1
2710,126775,MAbW0tb6J6Ti6Kh8CYUUbPwQNXH2uKzn,fbPkOYLVPtPgIt0MxizjfFJov3JbHyAi,11,6,4,0,2,0,6,0,18,2.5714285714285716,1,0.0,0,4,0,2,6,0,0,6,0,6,12,1
2711,126776,TEQ7zDYP3udNYg4MKBEvplriqU11dJpm,fbPkOYLVPtPgIt0MxizjfFJov3JbHyAi,1,0,0,0,0,0,1,0,1,0.14285714285714285,1,0.0,0,0,0,0,0,0,0,1,0,0,1,1
2712,126777,8KYOYZWZbeVcKwsAhVG92wVYE0ZslgMQ,fbPkOYLVPtPgIt0MxizjfFJov3JbHyAi,5,2,1,0,1,0,2,0,6,0.8571428571428571,1,0.0,0,1,0,1,2,0,0,2,0,2,4,1
2713,126779,eyG4WSrJfjS4SfFmzFCbTyf0yLzdGMxZ,fbPkOYLVPtPgIt0MxizjfFJov3JbHyAi,1,0,0,0,0,0,1,0,1,0.14285714285714285,1,0.0,0,0,0,0,0,0,0,1,0,0,1,1
2714,126781,u3SPm1HFwlhJpJKaAvQIjwvJr5QcuOph,fbPkOYLVPtPgIt0MxizjfFJov3JbHyAi,5,4,0,0,0,0,3,0,7,1.0,1,0.0,0,0,0,0,4,0,0,3,0,0,7,0
2715,126782,TbkRfFxVYcq9Rq8GnS46iBuAWkShuGej,fbPkOYLVPtPgIt0MxizjfFJov3JbHyAi,3,2,0,0,0,0,1,0,3,0.42857142857142855,1,0.0,0,0,0,0,2,0,0,1,0,0,3,0
2716,126784,jQGozXgCDEtih8n0QNDjwOxHGubLTjEt,fbPkOYLVPtPgIt0MxizjfFJov3JbHyAi,1,0,0,0,0,0,1,0,1,0.14285714285714285,1,0.0,0,0,0,0,0,0,0,1,0,0,1,1
2717,126785,bBtpKgA1DDqVgPxBOPJD6FyVYlM8yP8k,fbPkOYLVPtPgIt0MxizjfFJov3JbHyAi,7,5,4,0,4,0,2,0,15,2.142857142857143,1,0.0,0,4,0,4,5,0,0,2,0,8,7,1
2718,126797,vGSY3dMMulNZBhg7BC3Q8zuYArSKaMtG,fbPkOYLVPtPgIt0MxizjfFJov3JbHyAi,7,3,2,0,2,0,2,0,9,1.2857142857142858,1,0.0,0,2,0,2,3,0,0,2,0,4,5,1
2719,126798,YHm4iQLswg3Pw6HtKnjyefCEQG0rl9m6,fbPkOYLVPtPgIt0MxizjfFJov3JbHyAi,10,6,4,0,3,0,5,1,19,2.7142857142857144,2,0.0,0,4,0,3,6,0,0,5,1,7,12,1
2720,126801,Fa7tOqP1WKllvNDMgvUWmTzPr8J8vhy8,fbPkOYLVPtPgIt0MxizjfFJov3JbHyAi,1,0,0,0,0,0,1,0,1,0.14285714285714285,1,0.0,0,0,0,0,0,0,0,1,0,0,1,1
2721,126806,XnwSWp6D0m9yaPyTk2anmJeLluFnRetD,fbPkOYLVPtPgIt0MxizjfFJov3JbHyAi,6,3,1,0,1,0,2,0,7,1.0,1,0.0,0,1,0,1,3,0,0,2,0,2,5,0
2722,126810,YJTfq6mzE4rimmKGzMEkvlYd7pAv6QtE,fbPkOYLVPtPgIt0MxizjfFJov3JbHyAi,14,19,7,4,8,0,7,0,45,6.428571428571429,1,0.0,8,7,4,8,11,0,0,7,0,27,18,1
2723,126811,xwDnH1SlgpccyWc0HLXDPtkJbN2m4BgP,fbPkOYLVPtPgIt0MxizjfFJov3JbHyAi,10,5,4,0,3,3,5,1,21,3.0,1,0.0,0,4,0,3,5,3,0,5,1,7,14,1
2724,126813,sGprTXM41u2VOQkjfWkUju8jW985WAIG,fbPkOYLVPtPgIt0MxizjfFJov3JbHyAi,5,2,1,0,1,0,2,0,6,0.8571428571428571,1,0.0,0,1,0,1,2,0,0,2,0,2,4,1
2725,126814,8ecFqxBT7B9wx9rsVeuCI9d8eEGRfTVR,fbPkOYLVPtPgIt0MxizjfFJov3JbHyAi,1,0,0,0,0,0,1,0,1,0.14285714285714285,1,0.0,0,0,0,0,0,0,0,1,0,0,1,1
2726,126815,TjWuVHmc0AB9gfvtbCmyYG1vTFdPfyIz,fbPkOYLVPtPgIt0MxizjfFJov3JbHyAi,8,3,2,0,2,0,3,0,10,1.4285714285714286,1,0.0,0,2,0,2,3,0,0,3,0,4,6,1
2727,126816,QlvFciinGDGt7csjDmjYPPZqFlKAzfUP,fbPkOYLVPtPgIt0MxizjfFJov3JbHyAi,9,5,2,0,2,0,5,0,14,2.0,1,0.0,0,2,0,2,5,0,0,5,0,4,10,1
2728,126817,8n73BBd3mvRJq2a0KZ4WJWTYj65s8f61,fbPkOYLVPtPgIt0MxizjfFJov3JbHyAi,1,0,0,0,0,0,1,0,1,0.14285714285714285,1,0.0,0,0,0,0,0,0,0,1,0,0,1,1
2729,130073,IGWRz8xQdPwjKqBNKTjONoXgcj0XdulM,7GRhBDsirIGkRZBtSMEzNTyDr2JQm4xx,2,0,0,0,0,0,2,0,2,0.2857142857142857,1,0.0,0,0,0,0,0,0,0,2,0,0,2,0
2730,130079,HePRyod5aTSIcFeoVudB8huyR12d5o5i,7GRhBDsirIGkRZBtSMEzNTyDr2JQm4xx,23,22,0,14,5,0,2,0,43,6.142857142857143,1,0.0,12,0,7,5,10,0,7,2,0,24,19,1
2731,130151,oaoj9be4jW2Hot8wYgYrzLRvB0RU4KYy,7GRhBDsirIGkRZBtSMEzNTyDr2JQm4xx,4,2,1,0,1,0,1,0,5,0.7142857142857143,1,0.0,0,1,0,1,2,0,0,1,0,2,3,0
2732,134914,yNC8T7gdWO96Y2q3tzTQeJUMY0F51xnO,SpATywNh6bZuzm8s1ceuBUnMUAeoAHHw,4,4,3,0,0,0,2,0,9,1.2857142857142858,2,0.0,0,3,0,0,4,0,0,2,0,3,6,0
2733,134957,oaNAVS5nMmZPkgC88QZyCkxZpo6GIFQk,G8EPVSXsOYB5YQWZGiz1aVq5Pgr2GrQu,6,6,4,2,0,0,3,0,15,2.142857142857143,2,0.0,0,4,2,0,6,0,0,3,0,6,9,1
2734,135043,XoKIP4RGpnZk163890vUyWhLOIUSaapU,A3fsA9Zfv1X2fVEQhTw51lKENdNrEqT3,42,36,20,80,9,0,7,0,152,21.714285714285715,2,0.0,3,20,63,9,33,0,17,7,0,95,57,1
2735,135069,bgBLWArC7sr7mZdIi75AaJrBI0yN4gRx,SpATywNh6bZuzm8s1ceuBUnMUAeoAHHw,5,4,0,0,0,3,2,0,9,1.2857142857142858,1,0.0,1,0,0,0,3,3,0,2,0,1,8,0
2736,135103,gZWf27ETcHz4bBmwZPjiPumw55JZ4IOR,RXDvfPUBYFlVdlueBFbLW0mhhAyGEqpt,1,0,0,0,0,0,1,0,1,0.14285714285714285,1,0.0,0,0,0,0,0,0,0,1,0,0,1,1
2737,135109,EJXR6GjvUW4ftcdNw7M6s3AjFADQ5nWH,G8EPVSXsOYB5YQWZGiz1aVq5Pgr2GrQu,1,0,0,0,0,0,1,0,1,0.14285714285714285,1,0.0,0,0,0,0,0,0,0,1,0,0,1,1
2738,135159,yAxjMvvPF3HDitgCGIcnFlXrbnOszGcQ,bWdj2GDclj5ofokWjzoa5jAwMkxCykd6,1,0,0,0,0,0,1,0,1,0.14285714285714285,1,0.0,0,0,0,0,0,0,0,1,0,0,1,1
2739,135164,jRV8IFAqLHlnm6Yo5f3lbOm8y9FKnSQS,SpATywNh6bZuzm8s1ceuBUnMUAeoAHHw,11,8,5,15,1,0,2,0,31,4.428571428571429,1,0.0,2,5,13,1,6,0,2,2,0,21,10,1
2740,135285,ORZA67vQIOSB05DsIbFIoGl0EWiKz8Mx,RXDvfPUBYFlVdlueBFbLW0mhhAyGEqpt,12,14,2,0,0,13,0,0,29,4.142857142857143,2,0.0,0,2,0,0,14,13,0,0,0,2,27,1
2741,135321,x6BtQH70uuLHaxqzHA21U9wmfT0SxzD9,G8EPVSXsOYB5YQWZGiz1aVq5Pgr2GrQu,1,0,0,0,0,0,2,0,2,0.2857142857142857,1,0.0,0,0,0,0,0,0,0,2,0,0,2,1
2742,135333,Hmy7IERSuMBFx0LPTwulENadvjRMvkqo,SpATywNh6bZuzm8s1ceuBUnMUAeoAHHw,16,10,7,15,4,10,2,0,48,6.857142857142857,2,0.0,2,7,15,4,8,10,0,2,0,28,20,1
2743,135422,GR5uAqC8TkTRctStVcrTSN6GkRpM0Sgw,bWdj2GDclj5ofokWjzoa5jAwMkxCykd6,19,23,14,20,11,8,5,0,81,11.571428571428571,2,0.0,4,14,19,11,19,8,1,5,0,48,33,1
2744,135594,gikp9GqTKNuof6stdLjZVJv1OHEXFMyZ,G8EPVSXsOYB5YQWZGiz1aVq5Pgr2GrQu,40,69,28,124,0,0,0,0,221,31.571428571428573,3,0.0,41,28,84,0,28,0,40,0,0,153,68,0
2745,135673,5ZrPblaWYg1V0nkRfCyVA4ssWqd4pnQb,SpATywNh6bZuzm8s1ceuBUnMUAeoAHHw,1,0,0,0,0,0,1,0,1,0.14285714285714285,1,0.0,0,0,0,0,0,0,0,1,0,0,1,0
2746,135766,lOkl9iaUDyjk0zbwJLRgFqBRBNNBSRwr,SpATywNh6bZuzm8s1ceuBUnMUAeoAHHw,3,0,0,0,0,0,2,1,3,0.42857142857142855,1,0.0,0,0,0,0,0,0,0,2,1,0,3,0
2747,135807,mgLL2TOXKEK8di2v3UUyM4FMUqEuj4kl,SpATywNh6bZuzm8s1ceuBUnMUAeoAHHw,16,19,14,21,11,0,2,0,67,9.571428571428571,1,0.0,4,14,18,11,15,0,3,2,0,47,20,0
2748,135811,5sps38f5Y5pZOFcONQeuy3Uw9461fahZ,SpATywNh6bZuzm8s1ceuBUnMUAeoAHHw,14,21,8,12,3,0,2,0,46,6.571428571428571,2,0.0,7,8,10,3,14,0,2,2,0,28,18,1
2749,136038,P38VxMH253jjoDZHRNefTKyEAydphpb2,SpATywNh6bZuzm8s1ceuBUnMUAeoAHHw,11,12,6,10,0,3,5,0,36,5.142857142857143,2,0.0,5,6,9,0,7,3,1,5,0,20,16,1
2750,136143,hnr1SrvwKs73pIl4Y8iA8BBWZr0Bh6Qj,G8EPVSXsOYB5YQWZGiz1aVq5Pgr2GrQu,9,16,1,8,3,0,5,0,33,4.714285714285714,1,0.0,6,1,5,3,10,0,3,5,0,15,18,0
2751,136149,St6usTSSgX5U9v7wchuMWqmBKoCcDwN2,SpATywNh6bZuzm8s1ceuBUnMUAeoAHHw,7,7,0,6,0,0,2,0,15,2.142857142857143,2,0.0,4,0,6,0,3,0,0,2,0,10,5,0
2752,136209,oGK3c8nk6Ftl3V2u1zOvslszD4LDLr3w,G8EPVSXsOYB5YQWZGiz1aVq5Pgr2GrQu,9,8,5,0,3,0,1,0,17,2.4285714285714284,1,0.0,0,5,0,3,8,0,0,1,0,8,9,1
2753,136210,bIjd8KK4L7j9O8VoOs8qHKzlQRCxHLCH,SpATywNh6bZuzm8s1ceuBUnMUAeoAHHw,14,18,1,16,1,6,5,0,47,6.714285714285714,2,0.0,9,1,15,1,9,6,1,5,0,26,21,0
2754,136317,PSnfBRJFzUH9xyPpWKLqfkQbVy7w07sO,SpATywNh6bZuzm8s1ceuBUnMUAeoAHHw,25,29,3,25,1,1,16,1,76,10.857142857142858,3,0.0,11,3,21,1,18,1,4,16,1,36,40,1
2755,136375,QzQWYrrIVOUqhShDM2t03rN3byjq3J7w,SpATywNh6bZuzm8s1ceuBUnMUAeoAHHw,15,28,3,18,1,4,8,0,62,8.857142857142858,1,0.0,11,3,15,1,17,4,3,8,0,30,32,0
2756,136398,gtKTzkXHwS41ljYVmjlLLf4WyQSkK02q,7GRhBDsirIGkRZBtSMEzNTyDr2JQm4xx,6,7,5,0,0,0,2,0,14,2.0,1,0.0,0,5,0,0,7,0,0,2,0,5,9,1
2757,136413,SAZKFz2NUOxVKdkBgcAx84BjxoboQOlS,SpATywNh6bZuzm8s1ceuBUnMUAeoAHHw,3,2,1,0,0,0,1,0,4,0.5714285714285714,1,0.0,0,1,0,0,2,0,0,1,0,1,3,0
2758,136468,YVboeUnAYRezL6JF0VMVpiapYahgjIwn,SpATywNh6bZuzm8s1ceuBUnMUAeoAHHw,1,0,0,0,0,0,1,0,1,0.14285714285714285,1,0.0,0,0,0,0,0,0,0,1,0,0,1,0
2759,136500,AAAvWauitKfXD0xRpNsfpOKQu223kCXG,bWdj2GDclj5ofokWjzoa5jAwMkxCykd6,5,4,3,0,1,0,2,0,10,1.4285714285714286,1,0.0,0,3,0,1,4,0,0,2,0,4,6,1
2760,136540,hZR4MwcYec4g0GoOyJFngJGEyWOySpv2,7GRhBDsirIGkRZBtSMEzNTyDr2JQm4xx,3,0,0,0,0,6,8,0,14,2.0,2,0.0,0,0,0,0,0,6,0,8,0,0,14,0
2761,136547,LkEFlCqQYkjvIKgJmv3NaW67JKbg7cls,SpATywNh6bZuzm8s1ceuBUnMUAeoAHHw,1,0,0,0,0,0,1,0,1,0.14285714285714285,1,0.0,0,0,0,0,0,0,0,1,0,0,1,0
2762,136564,JHhY30IKFzw4LWcyrHuTEglWNqRkqdDU,SpATywNh6bZuzm8s1ceuBUnMUAeoAHHw,2,0,0,0,0,0,2,0,2,0.2857142857142857,1,0.0,0,0,0,0,0,0,0,2,0,0,2,1
2763,136592,JHhY30IKFzw4LWcyrHuTEglWNqRkqdDU,RXDvfPUBYFlVdlueBFbLW0mhhAyGEqpt,21,12,8,66,0,0,2,0,88,12.571428571428571,1,0.0,4,8,56,0,8,0,10,2,0,68,20,1
2764,136596,YqY5WPa8kwIoLBKGaVnXfSZOMvkSrEdU,SpATywNh6bZuzm8s1ceuBUnMUAeoAHHw,19,21,12,10,6,22,12,0,83,11.857142857142858,3,0.0,5,12,9,6,16,22,1,12,0,32,51,0
2765,136602,YqY5WPa8kwIoLBKGaVnXfSZOMvkSrEdU,A3fsA9Zfv1X2fVEQhTw51lKENdNrEqT3,3,2,1,0,0,0,1,0,4,0.5714285714285714,1,0.0,0,1,0,0,2,0,0,1,0,1,3,1
2766,136673,St6usTSSgX5U9v7wchuMWqmBKoCcDwN2,A3fsA9Zfv1X2fVEQhTw51lKENdNrEqT3,12,5,1,20,1,0,1,0,28,4.0,1,0.0,0,1,19,1,5,0,1,1,0,21,7,1
2767,136743,PV4ahNYgW8Lcd9nNe0xrpkqG7Ws3zMb1,SpATywNh6bZuzm8s1ceuBUnMUAeoAHHw,18,17,11,10,5,1,7,0,51,7.285714285714286,3,0.0,2,11,8,5,15,1,2,7,0,26,25,0
2768,136785,nsbeAj5BI7VK72NYmPa0cGgkMq0PU2h6,SpATywNh6bZuzm8s1ceuBUnMUAeoAHHw,10,9,1,0,1,0,3,0,14,2.0,1,0.0,0,1,0,1,9,0,0,3,0,2,12,0
2769,136799,HycevJIm7cBjf1oJ5QCBMMXEBTG8jyRF,G8EPVSXsOYB5YQWZGiz1aVq5Pgr2GrQu,4,2,1,0,0,0,2,0,5,0.7142857142857143,1,0.0,0,1,0,0,2,0,0,2,0,1,4,1
2770,136822,LKQx76DscP8cMaadDZLCOsushv3ygeRX,bWdj2GDclj5ofokWjzoa5jAwMkxCykd6,1,0,0,0,0,0,3,0,3,0.42857142857142855,1,0.0,0,0,0,0,0,0,0,3,0,0,3,1
2771,136860,5NKHIcFKbvZvjnI6x0vdD0R4rE65640c,SpATywNh6bZuzm8s1ceuBUnMUAeoAHHw,5,5,1,0,0,0,3,0,9,1.2857142857142858,1,0.0,0,1,0,0,5,0,0,3,0,1,8,0
2772,136897,xNcMMIyB0y99dNaEOIqDnvCMrU2SAEOP,G8EPVSXsOYB5YQWZGiz1aVq5Pgr2GrQu,39,41,18,64,12,0,9,0,144,20.571428571428573,3,0.0,15,18,45,12,26,0,19,9,0,90,54,0
2773,137324,nyH7Jx4kN1AdDJdwkZQoUDqYoovHgbk5,fbPkOYLVPtPgIt0MxizjfFJov3JbHyAi,10,6,3,2,2,1,4,1,19,2.7142857142857144,1,0.0,2,3,2,2,4,1,0,4,1,9,10,0
2774,137335,b2ohpFiEgZaZsBBPqUMnfjpywCAbNR88,fbPkOYLVPtPgIt0MxizjfFJov3JbHyAi,1,0,0,0,0,0,2,0,2,0.2857142857142857,1,0.0,0,0,0,0,0,0,0,2,0,0,2,1
2775,137408,7ZpK2Qdkfg6qjiDNvxUiqNClV9f1rdSE,fbPkOYLVPtPgIt0MxizjfFJov3JbHyAi,27,20,15,0,11,20,7,1,74,10.571428571428571,2,0.0,0,15,0,11,20,20,0,7,1,26,48,1
2776,137427,g5cfvDvYqz1BC4LMGanzPaVPPBmwbapa,fbPkOYLVPtPgIt0MxizjfFJov3JbHyAi,6,4,3,0,1,0,1,0,9,1.2857142857142858,1,0.0,0,3,0,1,4,0,0,1,0,4,5,0
2777,138202,JvCyyatgxKHz9VFtDJVVBL31IMYHuDOZ,7GRhBDsirIGkRZBtSMEzNTyDr2JQm4xx,4,2,0,0,0,0,3,0,5,0.7142857142857143,1,0.0,0,0,0,0,2,0,0,3,0,0,5,1
2778,138226,xBRGHAvkTfDDok4cH7N9aC7OMTMv6n3O,7GRhBDsirIGkRZBtSMEzNTyDr2JQm4xx,9,4,3,0,3,0,3,0,13,1.8571428571428572,1,0.0,0,3,0,3,4,0,0,3,0,6,7,1
2779,138250,szmVnhPypUPoSdN8Z8D02a6M8Gjrnwmf,A3fsA9Zfv1X2fVEQhTw51lKENdNrEqT3,4,4,2,0,0,0,2,0,8,1.1428571428571428,1,0.0,0,2,0,0,4,0,0,2,0,2,6,1
2780,138261,JL9rcevmVnCXKLKkXE87B1mrZmlYAcd1,SpATywNh6bZuzm8s1ceuBUnMUAeoAHHw,22,26,13,12,6,0,3,0,60,8.571428571428571,3,0.0,10,13,12,6,16,0,0,3,0,41,19,0
2781,138287,UJP97i2EJO4yjxI3DoA9AGA9qgzPRSeL,SpATywNh6bZuzm8s1ceuBUnMUAeoAHHw,6,5,1,0,1,0,4,0,11,1.5714285714285714,1,0.0,0,1,0,1,5,0,0,4,0,2,9,0
2782,138343,ekYJdZlodJJPGitBh9pJscwF42WGcv9J,SpATywNh6bZuzm8s1ceuBUnMUAeoAHHw,4,2,1,0,0,0,2,0,5,0.7142857142857143,1,0.0,0,1,0,0,2,0,0,2,0,1,4,1
2783,138357,NWaycxyjC99lvvlBzZhN9tb7U8fdoRvb,SpATywNh6bZuzm8s1ceuBUnMUAeoAHHw,17,31,11,16,3,32,16,0,109,15.571428571428571,2,0.0,17,11,14,3,14,32,2,16,0,45,64,0
2784,138411,MF5edVvM6lCZDxnMdHelos9TUh3KERjn,G8EPVSXsOYB5YQWZGiz1aVq5Pgr2GrQu,5,2,1,0,1,0,2,0,6,0.8571428571428571,1,0.0,0,1,0,1,2,0,0,2,0,2,4,1
2785,138422,PBT0xI17u81InQO08yLXpu6kSLQPC6l6,SpATywNh6bZuzm8s1ceuBUnMUAeoAHHw,5,6,1,0,1,0,3,0,11,1.5714285714285714,2,0.0,0,1,0,1,6,0,0,3,0,2,9,0
2786,138496,mSXZKJ9e3RCTXopgrFUphpxYgeKp7tlG,SpATywNh6bZuzm8s1ceuBUnMUAeoAHHw,8,21,8,0,0,0,5,0,34,4.857142857142857,2,0.0,6,8,0,0,15,0,0,5,0,14,20,0
2787,138554,Px8gWLqn4P0S59C09B0pkBi24hj9iKEG,7GRhBDsirIGkRZBtSMEzNTyDr2JQm4xx,9,3,1,6,1,0,3,0,14,2.0,1,0.0,1,1,3,1,2,0,3,3,0,6,8,1
2788,138785,O1Ztz9KIKs4JpSImKRRrzfUM0dpj0hIe,SpATywNh6bZuzm8s1ceuBUnMUAeoAHHw,17,30,1,41,0,49,10,0,131,18.714285714285715,2,0.0,11,1,33,0,19,49,8,10,0,45,86,0
2789,138865,AYiGvgKDaGiBpYEcJ7Espvi6dQy2aiFd,SpATywNh6bZuzm8s1ceuBUnMUAeoAHHw,13,32,3,10,0,0,4,0,49,7.0,2,0.0,16,3,10,0,16,0,0,4,0,29,20,0
2790,138957,LDYjWqhrIxv22jlLe9In731UT9Ne6fvw,SpATywNh6bZuzm8s1ceuBUnMUAeoAHHw,2,0,0,0,0,0,5,0,5,0.7142857142857143,3,0.0,0,0,0,0,0,0,0,5,0,0,5,1
2791,139071,a7ZVMpb0c7CARO4liNTBsp4hgkFIkG4C,A3fsA9Zfv1X2fVEQhTw51lKENdNrEqT3,10,8,6,0,3,10,5,0,32,4.571428571428571,2,0.0,0,6,0,3,8,10,0,5,0,9,23,1
2792,139081,AUQbcN6sP8jOc3r7pDcomR6R8baoxLvG,RXDvfPUBYFlVdlueBFbLW0mhhAyGEqpt,26,62,37,49,5,0,9,0,162,23.142857142857142,4,0.0,15,37,38,5,47,0,11,9,0,95,67,0
2793,139085,heVJWbQBtCN8obfXQBAbcR0I5MnOvCPs,G8EPVSXsOYB5YQWZGiz1aVq5Pgr2GrQu,31,25,13,57,5,2,9,3,114,16.285714285714285,2,0.0,3,13,50,5,22,2,7,9,3,71,43,0
2794,139134,tS8frxV0M3TGWaoIiOl49ThYexkN4UpR,7GRhBDsirIGkRZBtSMEzNTyDr2JQm4xx,1,0,0,0,0,0,2,0,2,0.2857142857142857,1,0.0,0,0,0,0,0,0,0,2,0,0,2,1
2795,139302,mFcnZc9xJHpcsnNSqrnt1TraJ39cAeOG,SpATywNh6bZuzm8s1ceuBUnMUAeoAHHw,19,30,5,6,2,5,14,1,63,9.0,2,0.0,2,5,5,2,28,5,1,14,1,14,49,0
2796,139312,vlarE7zCdES78rsfbZ9s0PTdwVr1rAk4,A3fsA9Zfv1X2fVEQhTw51lKENdNrEqT3,11,24,4,0,4,0,2,0,34,4.857142857142857,2,0.0,1,4,0,4,23,0,0,2,0,9,25,1
2797,139479,cDV3uv01OqR28HAw8WapmztMslx9jbkZ,A3fsA9Zfv1X2fVEQhTw51lKENdNrEqT3,8,8,4,0,0,1,5,1,19,2.7142857142857144,1,0.0,1,4,0,0,7,1,0,5,1,5,14,1
2798,139497,CQdAGcIvDdIBklDWFKtch5fpBdl4NTjN,SpATywNh6bZuzm8s1ceuBUnMUAeoAHHw,3,2,1,0,0,0,1,0,4,0.5714285714285714,1,0.0,0,1,0,0,2,0,0,1,0,1,3,1
2799,139502,hLHRmItIrBAAjPponbejbmcuRqVRIxcd,G8EPVSXsOYB5YQWZGiz1aVq5Pgr2GrQu,30,44,10,62,8,1,7,1,133,19.0,1,0.0,32,10,42,8,12,1,20,7,1,92,41,1
2800,139625,NHjxa47feJ9sWQnmg6HoO6L78eHIRwnl,7GRhBDsirIGkRZBtSMEzNTyDr2JQm4xx,1,0,0,0,0,0,2,0,2,0.2857142857142857,1,0.0,0,0,0,0,0,0,0,2,0,0,2,0
2801,139721,YI82gOPk3osjTxu9r38iyjq6I3W2WIaD,RXDvfPUBYFlVdlueBFbLW0mhhAyGEqpt,13,11,8,0,5,0,4,0,28,4.0,2,0.0,0,8,0,5,11,0,0,4,0,13,15,0
2802,140092,Kj9Et9zogxYDw98nFXPSMQhkkCBlhXs5,7GRhBDsirIGkRZBtSMEzNTyDr2JQm4xx,2,0,0,0,0,0,3,0,3,0.42857142857142855,2,0.0,0,0,0,0,0,0,0,3,0,0,3,1
2803,140220,D0DS3PcqkWtMhWmrWYDI3H9xnPeFgKco,7GRhBDsirIGkRZBtSMEzNTyDr2JQm4xx,6,8,3,0,0,0,4,0,15,2.142857142857143,2,0.0,2,3,0,0,6,0,0,4,0,5,10,1
2804,140241,Un3EzEE4Sz8i5Z84q9e50URbIAEkkVSB,7GRhBDsirIGkRZBtSMEzNTyDr2JQm4xx,2,0,0,0,0,0,3,0,3,0.42857142857142855,1,0.0,0,0,0,0,0,0,0,3,0,0,3,1
2805,140247,R9YTqKiRQtfCswOmsq4jluMVxY0uToJG,7GRhBDsirIGkRZBtSMEzNTyDr2JQm4xx,40,43,18,20,9,3,10,1,104,14.857142857142858,2,0.0,23,18,18,9,20,3,2,10,1,68,36,0
2806,140274,fb2hdXt8pnk8ljm4Tpi5PWJyJ7R8YxLU,7GRhBDsirIGkRZBtSMEzNTyDr2JQm4xx,11,9,3,0,3,0,3,0,18,2.5714285714285716,1,0.0,0,3,0,3,9,0,0,3,0,6,12,1
2807,140288,MdVSD7oG0mERo7XaQwvRtC5hdVN6DJiQ,7GRhBDsirIGkRZBtSMEzNTyDr2JQm4xx,11,9,1,0,3,0,2,0,15,2.142857142857143,1,0.0,3,1,0,3,6,0,0,2,0,7,8,0
2808,140333,bqWpav7ocOhCfb3xc4QgAvBDK5g8BmiZ,7GRhBDsirIGkRZBtSMEzNTyDr2JQm4xx,28,37,15,13,11,0,6,0,82,11.714285714285714,4,0.0,16,15,12,11,21,0,1,6,0,54,28,1
2809,140338,vixag6bpwzwtdrSKIAHFpP8XohE3IVGO,7GRhBDsirIGkRZBtSMEzNTyDr2JQm4xx,33,46,11,80,12,11,4,0,164,23.428571428571427,2,0.0,17,11,68,12,29,11,12,4,0,108,56,0
2810,140362,DpqUZKEZpIFvZzvEXk8oaJMRAbEfypNN,7GRhBDsirIGkRZBtSMEzNTyDr2JQm4xx,2,0,0,0,0,0,2,0,2,0.2857142857142857,1,0.0,0,0,0,0,0,0,0,2,0,0,2,1
2811,140518,PMkZTQovf4dyR4mK2UbNwrhFIlkDMtO5,7GRhBDsirIGkRZBtSMEzNTyDr2JQm4xx,3,2,0,0,0,0,1,0,3,0.42857142857142855,1,0.0,0,0,0,0,2,0,0,1,0,0,3,1
2812,140555,TfgVRC9skFsGu3qq14caEQmfjmrp7rot,7GRhBDsirIGkRZBtSMEzNTyDr2JQm4xx,1,0,0,0,0,0,1,0,1,0.14285714285714285,1,0.0,0,0,0,0,0,0,0,1,0,0,1,1
2813,140571,PQkWevD3d0oRYo5mywsIaSsfEsqdcqoj,7GRhBDsirIGkRZBtSMEzNTyDr2JQm4xx,6,2,1,0,1,0,3,0,7,1.0,1,0.0,0,1,0,1,2,0,0,3,0,2,5,1
2814,140586,H7wQq68VgsnXYKOgXKXD2z0yXvbrWDzD,7GRhBDsirIGkRZBtSMEzNTyDr2JQm4xx,2,0,0,0,0,0,2,0,2,0.2857142857142857,1,0.0,0,0,0,0,0,0,0,2,0,0,2,1
2815,140625,4f8jLRXqSCdB2uiZvxNaCELloSkIP9xi,7GRhBDsirIGkRZBtSMEzNTyDr2JQm4xx,1,0,0,0,0,0,1,0,1,0.14285714285714285,1,0.0,0,0,0,0,0,0,0,1,0,0,1,1
2816,140631,ah26WailHR7EV3M12BWTgtjGcr75lRFT,7GRhBDsirIGkRZBtSMEzNTyDr2JQm4xx,7,4,1,18,0,0,2,0,25,3.5714285714285716,1,0.0,1,1,16,0,3,0,2,2,0,18,7,1
2817,140709,98UEGByxiN7tned6NDQeKfQDq4HCSGvQ,7GRhBDsirIGkRZBtSMEzNTyDr2JQm4xx,5,2,1,0,1,0,2,0,6,0.8571428571428571,1,0.0,0,1,0,1,2,0,0,2,0,2,4,1
2818,143589,z7uFh58nBoces7c1gc4iOr2l4NXGSjok,SpATywNh6bZuzm8s1ceuBUnMUAeoAHHw,12,11,5,14,1,0,4,0,35,5.0,1,0.0,3,5,14,1,8,0,0,4,0,23,12,0
2819,143646,BQAHxDKbPTX2OmvOEbIJrtNWABd3lWzF,G8EPVSXsOYB5YQWZGiz1aVq5Pgr2GrQu,7,10,4,5,3,0,1,0,23,3.2857142857142856,1,0.0,4,4,5,3,6,0,0,1,0,16,7,1
2820,143658,qCIGCxbEF5IZjc2KbYsE1TkH5yxiGth5,SpATywNh6bZuzm8s1ceuBUnMUAeoAHHw,5,5,0,0,0,0,1,0,6,0.8571428571428571,1,0.0,0,0,0,0,5,0,0,1,0,0,6,1
2821,143662,rZhamd6VgzDuUbGwNlJUwteIExfrDmL0,SpATywNh6bZuzm8s1ceuBUnMUAeoAHHw,17,18,10,6,6,0,1,0,41,5.857142857142857,1,0.0,6,10,6,6,12,0,0,1,0,28,13,1
2822,143678,P1PW7aZzx8NF90gRnrYjkf5ZxxKRlBng,SpATywNh6bZuzm8s1ceuBUnMUAeoAHHw,13,14,8,5,2,3,8,4,44,6.285714285714286,1,0.0,0,8,4,2,14,3,1,8,4,14,30,1
2823,143729,YITGGXKhxzNHdElox232lzcaZdJ61YFn,G8EPVSXsOYB5YQWZGiz1aVq5Pgr2GrQu,3,2,0,0,0,0,2,0,4,0.5714285714285714,1,0.0,0,0,0,0,2,0,0,2,0,0,4,1
2824,143813,GJGZOa9ckBlFcfojmDXHYkGGywyzKOaN,SpATywNh6bZuzm8s1ceuBUnMUAeoAHHw,5,3,1,0,1,19,3,0,27,3.857142857142857,2,0.0,0,1,0,1,3,19,0,3,0,2,25,1
2825,143822,kfS0nefl4PODD2Wbg3xDtahejAoyK8Co,RXDvfPUBYFlVdlueBFbLW0mhhAyGEqpt,30,37,27,52,11,38,5,0,170,24.285714285714285,3,0.0,4,27,49,11,33,38,3,5,0,91,79,0
2826,143942,kS57PN5w4M8SePVOR15O2soQi4RHoCPq,SpATywNh6bZuzm8s1ceuBUnMUAeoAHHw,16,15,7,5,4,0,5,1,37,5.285714285714286,3,0.0,0,7,5,4,15,0,0,5,1,16,21,0
2827,143954,8jktIbkTyfsrxSTzXB9djfwFIqhVk9sD,G8EPVSXsOYB5YQWZGiz1aVq5Pgr2GrQu,1,0,0,0,0,0,1,0,1,0.14285714285714285,1,0.0,0,0,0,0,0,0,0,1,0,0,1,1
2828,144077,0gS5Q732yxgOQo1BReYmVwLNG0PEmJtw,bWdj2GDclj5ofokWjzoa5jAwMkxCykd6,4,5,2,0,0,0,2,0,9,1.2857142857142858,1,0.0,0,2,0,0,5,0,0,2,0,2,7,1
2829,144221,KkSinTdG2PbGrJIRATMZos8HES46UawO,bWdj2GDclj5ofokWjzoa5jAwMkxCykd6,5,4,2,0,1,0,1,0,8,1.1428571428571428,1,0.0,0,2,0,1,4,0,0,1,0,3,5,0
2830,144321,l9yVkoh4OzNZS3boMvfvu1qkbaccG6pv,SpATywNh6bZuzm8s1ceuBUnMUAeoAHHw,22,48,22,10,7,21,11,4,123,17.571428571428573,2,0.0,17,22,8,7,31,21,2,11,4,54,69,0
2831,144565,aGxe7bEAMBiGMI7BWz3muh2QIgH75sEQ,SpATywNh6bZuzm8s1ceuBUnMUAeoAHHw,5,3,1,0,1,0,1,0,6,0.8571428571428571,1,0.0,0,1,0,1,3,0,0,1,0,2,4,1
2832,144588,TfgVRC9skFsGu3qq14caEQmfjmrp7rot,A3fsA9Zfv1X2fVEQhTw51lKENdNrEqT3,5,6,2,0,0,6,3,0,17,2.4285714285714284,2,0.0,1,2,0,0,5,6,0,3,0,3,14,1
2833,144597,8sZcaktUJCX4PaAufyDgY0i3vpLY8cZl,SpATywNh6bZuzm8s1ceuBUnMUAeoAHHw,8,10,4,6,0,0,3,0,23,3.2857142857142856,2,0.0,4,4,6,0,6,0,0,3,0,14,9,1
2834,144649,uKGXhzbiDEpxCHjVlf9dmkGcQbxLosVe,A3fsA9Zfv1X2fVEQhTw51lKENdNrEqT3,42,7,3,114,0,0,2,0,126,18.0,1,0.0,2,3,114,0,5,0,0,2,0,119,7,1
2835,144681,ZbpLZuhcPXDt8MCBlzIEU31Qmn57Ldle,SpATywNh6bZuzm8s1ceuBUnMUAeoAHHw,3,4,2,0,0,0,2,0,8,1.1428571428571428,2,0.0,0,2,0,0,4,0,0,2,0,2,6,0
2836,144715,xQxCv7HVGUZGKsbGAuM07smPdylb1xSw,SpATywNh6bZuzm8s1ceuBUnMUAeoAHHw,19,11,8,15,4,1,5,2,46,6.571428571428571,1,0.0,2,8,13,4,9,1,2,5,2,27,19,1
2837,144719,xQxCv7HVGUZGKsbGAuM07smPdylb1xSw,A3fsA9Zfv1X2fVEQhTw51lKENdNrEqT3,30,11,6,98,3,3,6,1,128,18.285714285714285,3,0.0,1,6,88,3,10,3,10,6,1,98,30,1
2838,144806,7vmy4dx8h1nmyk40XB1bVEo0ZK716pcj,SpATywNh6bZuzm8s1ceuBUnMUAeoAHHw,5,8,0,0,0,0,2,0,10,1.4285714285714286,1,0.0,2,0,0,0,6,0,0,2,0,2,8,0
2839,145054,aRdmmgSzM3Ga3svQ0ZT0DvTgw1R0bnD6,SpATywNh6bZuzm8s1ceuBUnMUAeoAHHw,4,5,1,0,0,0,1,0,7,1.0,1,0.0,2,1,0,0,3,0,0,1,0,3,4,0
2840,145066,YOvd9uht0tZm889aIFQH8jd68xtH7inE,A3fsA9Zfv1X2fVEQhTw51lKENdNrEqT3,20,11,5,46,0,0,9,0,71,10.142857142857142,2,0.0,1,5,41,0,10,0,5,9,0,47,24,0
2841,145177,2HllbOBswZcfya5rDzlXYMHVB93oWjxb,SpATywNh6bZuzm8s1ceuBUnMUAeoAHHw,6,19,7,0,2,0,4,0,32,4.571428571428571,2,0.0,0,7,0,2,19,0,0,4,0,9,23,1
2842,145465,IvdoAzckjyWWCkzCy6V0BjWvOwMyZEwg,A3fsA9Zfv1X2fVEQhTw51lKENdNrEqT3,20,7,1,70,0,0,9,1,88,12.571428571428571,3,0.0,3,1,61,0,4,0,9,9,1,65,23,1
2843,145865,YYoTz5aT6oXhrDferhw1rplLYmNDgFub,7GRhBDsirIGkRZBtSMEzNTyDr2JQm4xx,39,89,1,0,14,0,1,0,105,15.0,1,0.0,60,1,0,14,29,0,0,1,0,75,30,0
2844,145878,vkI2g6NMz3qUYtvneHWPmtBdkC0OUJ1I,7GRhBDsirIGkRZBtSMEzNTyDr2JQm4xx,1,0,0,0,0,0,1,0,1,0.14285714285714285,1,0.0,0,0,0,0,0,0,0,1,0,0,1,1
2845,145953,TUdJl2punKYQuyj7cqcfXJ5p7FVAGa9A,7GRhBDsirIGkRZBtSMEzNTyDr2JQm4xx,1,0,0,0,0,0,1,0,1,0.14285714285714285,1,0.0,0,0,0,0,0,0,0,1,0,0,1,1
2846,146589,cmPAv0G01upQaGYeDqwQ4S5qXOhzhpzv,7GRhBDsirIGkRZBtSMEzNTyDr2JQm4xx,26,22,8,22,8,0,6,0,66,9.428571428571429,1,0.0,13,8,11,8,9,0,11,6,0,40,26,1
2847,146953,TkwNaNrSLynIgxaNvilfhFA70R9L2fY3,RXDvfPUBYFlVdlueBFbLW0mhhAyGEqpt,28,32,2,21,2,0,8,0,65,9.285714285714286,2,0.0,3,2,19,2,29,0,2,8,0,26,39,0
2848,148308,AgkxRkUEeKaWJWeFdUfFP1oidzDmX3wN,7GRhBDsirIGkRZBtSMEzNTyDr2JQm4xx,2,0,0,0,0,0,2,0,2,0.2857142857142857,1,0.0,0,0,0,0,0,0,0,2,0,0,2,1
2849,148441,C5JjdaA2TpnbGFuMIjvBUyS5u6COBRuh,A3fsA9Zfv1X2fVEQhTw51lKENdNrEqT3,47,35,20,180,7,0,5,0,247,35.285714285714285,3,0.0,3,20,178,7,32,0,2,5,0,208,39,1
2850,148465,aISyThuiw10fsCPPUtqVz2ccwIDIESls,G8EPVSXsOYB5YQWZGiz1aVq5Pgr2GrQu,34,42,27,91,0,17,6,0,183,26.142857142857142,3,0.0,11,27,76,0,31,17,15,6,0,114,69,0
2851,148503,9CQfIvDiQz4gDArSnTXOgxNKUwJW75pD,SpATywNh6bZuzm8s1ceuBUnMUAeoAHHw,6,5,2,0,0,0,8,0,15,2.142857142857143,2,0.0,0,2,0,0,5,0,0,8,0,2,13,0
2852,148577,1TDqryriD1i68B6PFn9vcGOnlC4cHux8,A3fsA9Zfv1X2fVEQhTw51lKENdNrEqT3,13,14,7,0,7,0,2,0,30,4.285714285714286,1,0.0,0,7,0,7,14,0,0,2,0,14,16,1
2853,148598,sg4VVv9cgk6nt80dZvUKhL5H7RMgLm0l,SpATywNh6bZuzm8s1ceuBUnMUAeoAHHw,5,3,1,0,0,0,2,0,6,0.8571428571428571,1,0.0,0,1,0,0,3,0,0,2,0,1,5,1
2854,148611,oGTSG0bYZEKmqMQUI2QOgfbr6I1mZJJh,SpATywNh6bZuzm8s1ceuBUnMUAeoAHHw,10,22,4,0,1,0,14,0,41,5.857142857142857,2,0.0,0,4,0,1,22,0,0,14,0,5,36,1
2855,148612,ZdOBK87GOMIn8wzMbSvbPLgG549sCOY6,A3fsA9Zfv1X2fVEQhTw51lKENdNrEqT3,6,3,2,0,2,0,1,0,8,1.1428571428571428,1,0.0,0,2,0,2,3,0,0,1,0,4,4,1
2856,148627,eK6us9hOnBMXSFhvwgioyiPARpsZ94KW,A3fsA9Zfv1X2fVEQhTw51lKENdNrEqT3,2,0,0,0,0,0,3,0,3,0.42857142857142855,1,0.0,0,0,0,0,0,0,0,3,0,0,3,1
2857,148654,sTxEoxueQ2iNvcjPH8BgpVT2Uz1KyXvb,A3fsA9Zfv1X2fVEQhTw51lKENdNrEqT3,12,14,10,0,4,8,7,0,43,6.142857142857143,2,0.0,1,10,0,4,13,8,0,7,0,15,28,1
2858,148666,cAYlx5bxU4cY2ACDTf2EB19Cf6nnrW4p,A3fsA9Zfv1X2fVEQhTw51lKENdNrEqT3,2,0,0,0,0,0,2,0,2,0.2857142857142857,1,0.0,0,0,0,0,0,0,0,2,0,0,2,1
2859,148668,qaT3OJRfY4kTUsuWIZdgTvNFyRsoPB48,A3fsA9Zfv1X2fVEQhTw51lKENdNrEqT3,16,19,2,20,1,0,9,0,51,7.285714285714286,2,0.0,0,2,15,1,19,0,5,9,0,18,33,1
2860,148724,4YDp1nxKf6ZgyVxOrG2MY3nyG30jIlTN,SpATywNh6bZuzm8s1ceuBUnMUAeoAHHw,7,5,1,0,1,0,1,0,8,1.1428571428571428,1,0.0,0,1,0,1,5,0,0,1,0,2,6,1
2861,148741,lcf8IA11Zd7V2ZBaDLUO5BNWLkJI60Zh,A3fsA9Zfv1X2fVEQhTw51lKENdNrEqT3,6,5,1,0,1,0,2,0,9,1.2857142857142858,2,0.0,0,1,0,1,5,0,0,2,0,2,7,1
2862,149135,HDeZBhNQKtgQRWJ96cSCNvruJhAhiBb4,SpATywNh6bZuzm8s1ceuBUnMUAeoAHHw,1,0,0,0,0,0,2,0,2,0.2857142857142857,1,0.0,0,0,0,0,0,0,0,2,0,0,2,1
2863,149175,fxLa2btVt7GxkzfoIMOfvQ33z85P1T4A,A3fsA9Zfv1X2fVEQhTw51lKENdNrEqT3,1,0,0,0,0,0,1,0,1,0.14285714285714285,1,0.0,0,0,0,0,0,0,0,1,0,0,1,1
2864,149400,ne1lWju9UTXOBd1dA2M5rJRVVshMCIYz,A3fsA9Zfv1X2fVEQhTw51lKENdNrEqT3,2,0,0,0,0,0,2,0,2,0.2857142857142857,1,0.0,0,0,0,0,0,0,0,2,0,0,2,1
2865,149420,vVmrtbXOR8LaWp48hajdNZIlFCL7http,SpATywNh6bZuzm8s1ceuBUnMUAeoAHHw,7,4,3,0,3,0,2,0,12,1.7142857142857142,1,0.0,0,3,0,3,4,0,0,2,0,6,6,1
2866,149421,RAAQLpPenoCljHENtpqjvSXS8Gfv0T1E,A3fsA9Zfv1X2fVEQhTw51lKENdNrEqT3,13,6,4,0,3,1,5,1,20,2.857142857142857,1,0.0,0,4,0,3,6,1,0,5,1,7,13,1
2867,149440,HhHFHVl0FdyFAQQ7F70xD2HQyGMqv85Q,A3fsA9Zfv1X2fVEQhTw51lKENdNrEqT3,15,18,2,0,1,0,5,0,26,3.7142857142857144,3,0.0,0,2,0,1,18,0,0,5,0,3,23,1
2868,149505,TgcCH3erWiZRHJcY2HABDtNaJwPoDafv,SpATywNh6bZuzm8s1ceuBUnMUAeoAHHw,3,0,0,0,0,0,3,0,3,0.42857142857142855,1,0.0,0,0,0,0,0,0,0,3,0,0,3,1
2869,149569,KR5RKdabOCnxR33wIN39OavKAg4R47ZU,A3fsA9Zfv1X2fVEQhTw51lKENdNrEqT3,9,4,1,0,1,1,6,0,13,1.8571428571428572,1,0.0,0,1,0,1,4,1,0,6,0,2,11,1
2870,149570,8958pt2z4OHwTl32JK0k9CAPziEN4Bzu,SpATywNh6bZuzm8s1ceuBUnMUAeoAHHw,3,2,1,0,0,0,1,0,4,0.5714285714285714,1,0.0,0,1,0,0,2,0,0,1,0,1,3,1
2871,149573,0aomsNaDMmIRvMUNvKVIFXzFDfLWKysB,A3fsA9Zfv1X2fVEQhTw51lKENdNrEqT3,2,0,0,0,0,0,2,0,2,0.2857142857142857,1,0.0,0,0,0,0,0,0,0,2,0,0,2,1
2872,149575,MDp7DOIvKcLxQwYa7iYETsW6UM7XLKe9,SpATywNh6bZuzm8s1ceuBUnMUAeoAHHw,3,2,0,0,0,0,1,0,3,0.42857142857142855,1,0.0,0,0,0,0,2,0,0,1,0,0,3,1
2873,149586,SdSbeWd4oEnIQjEokLws1yqSOv3sXqaR,A3fsA9Zfv1X2fVEQhTw51lKENdNrEqT3,2,0,0,0,0,0,2,0,2,0.2857142857142857,1,0.0,0,0,0,0,0,0,0,2,0,0,2,1
2874,149633,tmwYxPndf0bBoBktnRObtCNzTZcFIFQq,SpATywNh6bZuzm8s1ceuBUnMUAeoAHHw,9,13,0,2,0,0,4,0,19,2.7142857142857144,2,0.0,6,0,2,0,7,0,0,4,0,8,11,1
2875,149655,BvI5CiGNtYcKpjVG9fTMezMQs6vWmHfH,bWdj2GDclj5ofokWjzoa5jAwMkxCykd6,4,4,3,0,3,0,1,0,11,1.5714285714285714,1,0.0,0,3,0,3,4,0,0,1,0,6,5,1
2876,149682,cQ0KD7lyMK06WYdfiZiDvkcnrB91X6dF,RXDvfPUBYFlVdlueBFbLW0mhhAyGEqpt,1,0,0,0,0,0,1,0,1,0.14285714285714285,1,0.0,0,0,0,0,0,0,0,1,0,0,1,0
2877,149724,p5nLTT7lxlGHa4qmyYsgcjTpAWKheo2V,A3fsA9Zfv1X2fVEQhTw51lKENdNrEqT3,5,3,2,0,1,0,2,0,8,1.1428571428571428,1,0.0,0,2,0,1,3,0,0,2,0,3,5,1
2878,149734,364UhjscaMOKYjf1pPgmVT64NkpJR1Jx,A3fsA9Zfv1X2fVEQhTw51lKENdNrEqT3,1,0,0,0,0,0,1,0,1,0.14285714285714285,1,0.0,0,0,0,0,0,0,0,1,0,0,1,1
2879,149814,OUOJlObKrXM0JmEUq0o8KzZHzr8jy9dn,A3fsA9Zfv1X2fVEQhTw51lKENdNrEqT3,8,4,3,0,3,0,1,0,11,1.5714285714285714,1,0.0,0,3,0,3,4,0,0,1,0,6,5,0
2880,149853,EGrooJVAAIUP6U4I2p0rt4nL3Y713JTJ,bWdj2GDclj5ofokWjzoa5jAwMkxCykd6,12,17,12,0,7,0,8,0,44,6.285714285714286,2,0.0,0,12,0,7,17,0,0,8,0,19,25,1
2881,149861,s1avI0XWB1DlJJFaBkTxVlC3TXo4qwtF,A3fsA9Zfv1X2fVEQhTw51lKENdNrEqT3,2,0,0,0,0,0,2,0,2,0.2857142857142857,1,0.0,0,0,0,0,0,0,0,2,0,0,2,1
2882,149869,DV9cmKY91lk8lKsMUmLIMP1KsHFcyZMK,bWdj2GDclj5ofokWjzoa5jAwMkxCykd6,5,10,6,0,0,0,1,0,17,2.4285714285714284,1,0.0,0,6,0,0,10,0,0,1,0,6,11,1
2883,150014,iyF9qVPSlqT1UqIz618IudxC9zNsOV1h,A3fsA9Zfv1X2fVEQhTw51lKENdNrEqT3,1,0,0,0,0,0,1,0,1,0.14285714285714285,1,0.0,0,0,0,0,0,0,0,1,0,0,1,1
2884,150075,FWX9YkLyj47mhurdCZuuv2217ViDfzCr,A3fsA9Zfv1X2fVEQhTw51lKENdNrEqT3,2,0,0,0,0,0,2,0,2,0.2857142857142857,1,0.0,0,0,0,0,0,0,0,2,0,0,2,1
2885,153205,pvxjw4szSuluDWQ3DWPes9Mzs1MCvxjI,SpATywNh6bZuzm8s1ceuBUnMUAeoAHHw,7,3,2,0,0,5,7,1,18,2.5714285714285716,1,0.0,0,2,0,0,3,5,0,7,1,2,16,1
2886,153335,OgqpjGMMInWS9PhYsy4mlMX0fhVM7tcA,SpATywNh6bZuzm8s1ceuBUnMUAeoAHHw,15,19,15,14,12,0,1,0,61,8.714285714285714,1,0.0,3,15,13,12,16,0,1,1,0,43,18,1
2887,153457,cYe4n4c9KPDfBEWjGIRj6ImLxtmj3FnE,SpATywNh6bZuzm8s1ceuBUnMUAeoAHHw,4,3,2,0,0,0,1,0,6,0.8571428571428571,1,0.0,0,2,0,0,3,0,0,1,0,2,4,0
2888,153708,cX96KcLUG7eWbqHO7enIWngg59YqtKEY,SpATywNh6bZuzm8s1ceuBUnMUAeoAHHw,1,0,0,0,0,0,1,0,1,0.14285714285714285,1,0.0,0,0,0,0,0,0,0,1,0,0,1,1
2889,153775,NDTWRDiLyYPUSKAzpsOEnrkggSOfO91T,SpATywNh6bZuzm8s1ceuBUnMUAeoAHHw,3,2,1,0,0,0,1,0,4,0.5714285714285714,1,0.0,0,1,0,0,2,0,0,1,0,1,3,1
2890,154004,Cf7GCeUZzG7WjvUIyGfwv9hfcwXPVq5G,SpATywNh6bZuzm8s1ceuBUnMUAeoAHHw,13,20,1,17,0,11,7,0,56,8.0,3,0.0,5,1,15,0,15,11,2,7,0,21,35,0
2891,154133,zUPpTYisLLzFG12BVDvWrty0j8q1G6Si,SpATywNh6bZuzm8s1ceuBUnMUAeoAHHw,16,22,0,18,1,2,8,0,51,7.285714285714286,4,0.0,9,0,17,1,13,2,1,8,0,27,24,0
2892,154302,6MMO6p1gWBmDJN4eS7QrAi6Zg4mTPljX,SpATywNh6bZuzm8s1ceuBUnMUAeoAHHw,6,7,1,0,0,0,3,0,11,1.5714285714285714,1,0.0,0,1,0,0,7,0,0,3,0,1,10,1
2893,154436,VgwfEqq4zzESU4PqjsdqDnf6ZuDvfVVs,A3fsA9Zfv1X2fVEQhTw51lKENdNrEqT3,1,0,0,0,0,0,1,0,1,0.14285714285714285,1,0.0,0,0,0,0,0,0,0,1,0,0,1,1
2894,154532,y4jCbRq0ZMCabQVeAWisCVju9AF82joj,bWdj2GDclj5ofokWjzoa5jAwMkxCykd6,1,0,0,0,0,0,1,0,1,0.14285714285714285,1,0.0,0,0,0,0,0,0,0,1,0,0,1,1
2895,154570,EXZ81qqSldwR1xdBEwBZ7wmgbTHF86sl,A3fsA9Zfv1X2fVEQhTw51lKENdNrEqT3,50,29,23,98,18,7,5,1,181,25.857142857142858,1,0.0,1,23,80,18,28,7,18,5,1,122,59,0
2896,154630,PE4KBwh4ltl7dienGR8pJbew7yjFv3Vz,RXDvfPUBYFlVdlueBFbLW0mhhAyGEqpt,26,22,14,26,5,0,5,0,72,10.285714285714286,1,0.0,4,14,24,5,18,0,2,5,0,47,25,0
2897,154867,GnGb3MjVBgYFavJRehOmmU05ktvVgJLM,SpATywNh6bZuzm8s1ceuBUnMUAeoAHHw,4,6,1,0,0,2,6,0,15,2.142857142857143,3,0.0,0,1,0,0,6,2,0,6,0,1,14,0
2898,155270,xcsswfe3yez02HFG13qFCOZgHBl5zUGi,SpATywNh6bZuzm8s1ceuBUnMUAeoAHHw,15,13,5,37,1,3,2,1,62,8.857142857142858,1,0.0,7,5,31,1,6,3,6,2,1,44,18,0
2899,155367,LSvU72CFq1TrHd9SCZOiKQ0qcV2oa2Ok,SpATywNh6bZuzm8s1ceuBUnMUAeoAHHw,3,2,0,0,0,0,1,0,3,0.42857142857142855,1,0.0,0,0,0,0,2,0,0,1,0,0,3,1
2900,155432,LkEFlCqQYkjvIKgJmv3NaW67JKbg7cls,bWdj2GDclj5ofokWjzoa5jAwMkxCykd6,9,11,2,14,1,0,15,1,44,6.285714285714286,2,0.0,2,2,13,1,9,0,1,15,1,18,26,1
2901,155453,lmCPiW6l0WNp9Ttn0lhwFDs7FfVubtvY,bWdj2GDclj5ofokWjzoa5jAwMkxCykd6,3,2,0,0,0,0,1,0,3,0.42857142857142855,1,0.0,0,0,0,0,2,0,0,1,0,0,3,1
2902,155459,cuPQwSytidcCUilblyO4K9ALDT0iH8XK,SpATywNh6bZuzm8s1ceuBUnMUAeoAHHw,9,33,6,0,5,0,8,0,52,7.428571428571429,3,0.0,2,6,0,5,31,0,0,8,0,13,39,0
2903,155473,vIGrumQhxED6ggjqRtDJTWjYD26BFXvf,SpATywNh6bZuzm8s1ceuBUnMUAeoAHHw,4,2,1,0,1,0,1,0,5,0.7142857142857143,1,0.0,0,1,0,1,2,0,0,1,0,2,3,1
2904,155477,6QvLuupNiStrzgd1XTxuVafPKhPqbm1k,SpATywNh6bZuzm8s1ceuBUnMUAeoAHHw,1,0,0,0,0,0,2,0,2,0.2857142857142857,1,0.0,0,0,0,0,0,0,0,2,0,0,2,1
2905,155505,anKy5XeCNcJg717tYlt4WP7NvJptZoH3,SpATywNh6bZuzm8s1ceuBUnMUAeoAHHw,6,3,2,0,1,0,2,0,8,1.1428571428571428,1,0.0,0,2,0,1,3,0,0,2,0,3,5,1
2906,155507,SgOZJSP28EVOKcdy4QUHKj5FTNBlaKTy,bWdj2GDclj5ofokWjzoa5jAwMkxCykd6,4,3,2,0,0,0,1,0,6,0.8571428571428571,1,0.0,0,2,0,0,3,0,0,1,0,2,4,1
2907,155515,RWIpGfxvEVJcZlPnYrpOXKnv6jNCgDMr,G8EPVSXsOYB5YQWZGiz1aVq5Pgr2GrQu,5,2,1,0,1,0,2,0,6,0.8571428571428571,1,0.0,0,1,0,1,2,0,0,2,0,2,4,1
2908,155519,LPuI0zsA5TBOFE9XpHozb9j9tJuwGxCb,RXDvfPUBYFlVdlueBFbLW0mhhAyGEqpt,9,8,5,0,1,0,5,0,19,2.7142857142857144,2,0.0,0,5,0,1,8,0,0,5,0,6,13,0
2909,155553,bpGV6fnSXAO5YTgsxVkdmYC0rSgonD8Y,SpATywNh6bZuzm8s1ceuBUnMUAeoAHHw,7,6,1,0,1,0,1,0,9,1.2857142857142858,1,0.0,0,1,0,1,6,0,0,1,0,2,7,1
2910,155560,I0VfBqvM8JyWCrBNLkrKH3hPvb4CxoQx,SpATywNh6bZuzm8s1ceuBUnMUAeoAHHw,23,30,1,26,1,1,5,0,64,9.142857142857142,2,0.0,7,1,24,1,23,1,2,5,0,33,31,1
2911,155575,LigXW35gPDwdC5qVp0UrC4fmHQ8ox9Rk,bWdj2GDclj5ofokWjzoa5jAwMkxCykd6,7,6,3,0,2,0,1,0,12,1.7142857142857142,1,0.0,0,3,0,2,6,0,0,1,0,5,7,1
2912,155580,RRM0TElcCY25pdcWRkMGxwCn30ehvK5c,SpATywNh6bZuzm8s1ceuBUnMUAeoAHHw,25,37,18,22,6,0,1,0,84,12.0,1,0.0,15,18,18,6,22,0,4,1,0,57,27,0
2913,155610,UK0wMwBzvN90sgDmKYl9zi5a5BuEJyvZ,RXDvfPUBYFlVdlueBFbLW0mhhAyGEqpt,29,20,9,35,7,19,4,0,94,13.428571428571429,3,0.0,7,9,34,7,13,19,1,4,0,57,37,1
2914,155611,dd7Jtt1fMMutX1RG7iWTpWNKUpGu8Lqf,A3fsA9Zfv1X2fVEQhTw51lKENdNrEqT3,35,50,29,62,0,3,24,1,169,24.142857142857142,3,0.0,6,29,49,0,44,3,13,24,1,84,85,1
2915,155637,qjvq1sHqAcfKswM6blXTqWOneUd9IwNB,SpATywNh6bZuzm8s1ceuBUnMUAeoAHHw,5,2,1,0,1,0,2,0,6,0.8571428571428571,1,0.0,0,1,0,1,2,0,0,2,0,2,4,1
2916,155650,qsqwu8COYqhvRbnpZxaxzFgLRXRrEQUY,SpATywNh6bZuzm8s1ceuBUnMUAeoAHHw,5,3,2,0,1,0,1,0,7,1.0,1,0.0,0,2,0,1,3,0,0,1,0,3,4,1
2917,155705,CFhLEVkKrtcBJJ6gRh8HSuSfw1jMfUb7,SpATywNh6bZuzm8s1ceuBUnMUAeoAHHw,2,0,0,0,0,0,2,0,2,0.2857142857142857,1,0.0,0,0,0,0,0,0,0,2,0,0,2,1
2918,155719,US9otMg797RbX2BsleYBFadMSrBjJXZF,SpATywNh6bZuzm8s1ceuBUnMUAeoAHHw,2,0,0,0,0,0,2,0,2,0.2857142857142857,1,0.0,0,0,0,0,0,0,0,2,0,0,2,1
2919,155741,1fhx237jT4Kg2Hfne9D1cZg9DXyWHZEN,bWdj2GDclj5ofokWjzoa5jAwMkxCykd6,6,5,3,0,2,0,5,0,15,2.142857142857143,2,0.0,0,3,0,2,5,0,0,5,0,5,10,0
2920,155745,bcDgsH6ZU4RUVLG7I2fsAvcl6B7ySYCd,RXDvfPUBYFlVdlueBFbLW0mhhAyGEqpt,5,5,0,0,0,0,2,0,7,1.0,2,0.0,0,0,0,0,5,0,0,2,0,0,7,1
2921,155782,I19aG6zmdTntoy0T8VxEogbN4WVEZZNa,G8EPVSXsOYB5YQWZGiz1aVq5Pgr2GrQu,11,9,1,10,1,0,3,0,24,3.4285714285714284,2,0.0,3,1,7,1,6,0,3,3,0,12,12,1
2922,155787,IkURdjJHTtVaMfzGLDY0ow22hHa6VKoA,G8EPVSXsOYB5YQWZGiz1aVq5Pgr2GrQu,1,0,0,0,0,0,1,0,1,0.14285714285714285,1,0.0,0,0,0,0,0,0,0,1,0,0,1,1
2923,155816,088SASUPOVYUGhoEly8vlrkGvRBJoNwp,SpATywNh6bZuzm8s1ceuBUnMUAeoAHHw,5,2,1,0,1,0,3,0,7,1.0,1,0.0,0,1,0,1,2,0,0,3,0,2,5,1
2924,155821,jaQSY9BdnD0HM1u5vJYwNWQnUzzZzI8e,SpATywNh6bZuzm8s1ceuBUnMUAeoAHHw,1,0,0,0,0,0,1,0,1,0.14285714285714285,1,0.0,0,0,0,0,0,0,0,1,0,0,1,1
2925,155826,VFaDw1WYcOtIcsxfLW3x5fsJ2JkUIOUZ,G8EPVSXsOYB5YQWZGiz1aVq5Pgr2GrQu,22,14,9,62,5,0,2,0,92,13.142857142857142,2,0.0,3,9,52,5,11,0,10,2,0,69,23,0
2926,155845,kAH6V7JzDoLq5AdXMqvLO78igpFvmPcb,SpATywNh6bZuzm8s1ceuBUnMUAeoAHHw,3,2,0,0,0,0,1,0,3,0.42857142857142855,1,0.0,0,0,0,0,2,0,0,1,0,0,3,1
2927,155885,4G4cusC28dHeOh2Typ91i1q3Okbvvqth,bWdj2GDclj5ofokWjzoa5jAwMkxCykd6,3,2,1,0,0,0,1,0,4,0.5714285714285714,1,0.0,0,1,0,0,2,0,0,1,0,1,3,1
2928,155915,tJ3sl9o76r3EHByeMBO5S5Oajse8uEcy,SpATywNh6bZuzm8s1ceuBUnMUAeoAHHw,12,7,1,4,1,0,3,0,16,2.2857142857142856,1,0.0,0,1,4,1,7,0,0,3,0,6,10,0
2929,155927,5zF3LAGlpXwVChANKN0umOaI1kNrk73h,SpATywNh6bZuzm8s1ceuBUnMUAeoAHHw,1,0,0,0,0,0,1,0,1,0.14285714285714285,1,0.0,0,0,0,0,0,0,0,1,0,0,1,1
2930,155964,nVB1o73xluQXZjoI2dUYHGxbCDG8qiCL,RXDvfPUBYFlVdlueBFbLW0mhhAyGEqpt,1,0,0,0,0,0,1,0,1,0.14285714285714285,1,0.0,0,0,0,0,0,0,0,1,0,0,1,0
2931,155976,7xpmz6LF4dl35fFKZgRU70OZyF8UO4PL,SpATywNh6bZuzm8s1ceuBUnMUAeoAHHw,7,5,2,0,2,0,2,0,11,1.5714285714285714,1,0.0,0,2,0,2,5,0,0,2,0,4,7,0
2932,155978,8Q914g366DdD8SM59Cwv8CGJVdCfYrAr,SpATywNh6bZuzm8s1ceuBUnMUAeoAHHw,20,15,12,4,8,0,2,0,41,5.857142857142857,2,0.0,0,12,3,8,15,0,1,2,0,23,18,1
2933,156011,V6bmtFqzrgy6dG2nlcL1Nh8X9EOeOyrE,SpATywNh6bZuzm8s1ceuBUnMUAeoAHHw,5,3,1,0,1,0,1,0,6,0.8571428571428571,1,0.0,0,1,0,1,3,0,0,1,0,2,4,1
2934,156064,xSvCHzbSKemMKYEdGEAC5YZv1OdVf9nN,bWdj2GDclj5ofokWjzoa5jAwMkxCykd6,3,0,0,0,0,0,3,0,3,0.42857142857142855,1,0.0,0,0,0,0,0,0,0,3,0,0,3,1
2935,156067,3JnJF2wvxZ8RWlVFjIL8g8mywZiR6k1T,G8EPVSXsOYB5YQWZGiz1aVq5Pgr2GrQu,18,23,16,26,9,0,4,1,79,11.285714285714286,1,0.0,5,16,22,9,18,0,4,4,1,52,27,1
2936,156123,iMSX1uHcSxcasOlc9agP5kI5TmyEQeiD,G8EPVSXsOYB5YQWZGiz1aVq5Pgr2GrQu,1,0,0,0,0,0,1,0,1,0.14285714285714285,1,0.0,0,0,0,0,0,0,0,1,0,0,1,1
2937,156130,i6hU5SR8XgkqdPxlmxtV7dYt9PZfaBTn,SpATywNh6bZuzm8s1ceuBUnMUAeoAHHw,5,2,1,0,1,0,2,0,6,0.8571428571428571,1,0.0,0,1,0,1,2,0,0,2,0,2,4,1
2938,156133,i6hU5SR8XgkqdPxlmxtV7dYt9PZfaBTn,bWdj2GDclj5ofokWjzoa5jAwMkxCykd6,6,8,3,0,2,0,2,0,15,2.142857142857143,1,0.0,3,3,0,2,5,0,0,2,0,8,7,1
2939,156141,i6hU5SR8XgkqdPxlmxtV7dYt9PZfaBTn,RXDvfPUBYFlVdlueBFbLW0mhhAyGEqpt,10,9,3,0,2,0,4,0,18,2.5714285714285716,1,0.0,0,3,0,2,9,0,0,4,0,5,13,1
2940,156174,xWDzyWVfwaNblicJcu1jEcVTvovEMjsP,SpATywNh6bZuzm8s1ceuBUnMUAeoAHHw,14,46,0,21,0,6,7,1,81,11.571428571428571,1,0.0,31,0,18,0,15,6,3,7,1,49,32,1
2941,156203,TJJeYBVqqJqVT0UpmMwKMknr7rLf2JfH,G8EPVSXsOYB5YQWZGiz1aVq5Pgr2GrQu,1,0,0,0,0,0,1,0,1,0.14285714285714285,1,0.0,0,0,0,0,0,0,0,1,0,0,1,1
2942,156210,QJa7950JZ1G1IXjh9PFTLBwHz50g7cPs,RXDvfPUBYFlVdlueBFbLW0mhhAyGEqpt,6,3,1,0,1,0,2,0,7,1.0,1,0.0,0,1,0,1,3,0,0,2,0,2,5,1
2943,156215,craou3bPovoGYp07wkpPUHi7pTV19nnS,SpATywNh6bZuzm8s1ceuBUnMUAeoAHHw,1,0,0,0,0,0,1,0,1,0.14285714285714285,1,0.0,0,0,0,0,0,0,0,1,0,0,1,1
2944,156218,lOpYzxjzA9vRip7edGAzRT31tzjhDFRT,SpATywNh6bZuzm8s1ceuBUnMUAeoAHHw,14,15,1,20,0,1,7,1,45,6.428571428571429,1,0.0,2,1,17,0,13,1,3,7,1,20,25,1
2945,156249,NOCI3alBOLdcP6U9772QoJvMxwy9UAN6,SpATywNh6bZuzm8s1ceuBUnMUAeoAHHw,7,12,5,0,1,0,3,0,21,3.0,2,0.0,3,5,0,1,9,0,0,3,0,9,12,1
2946,156274,0sjXk2kwvvV16YH049lNSti4Pj1sg16S,bWdj2GDclj5ofokWjzoa5jAwMkxCykd6,8,9,4,12,0,1,5,0,31,4.428571428571429,1,0.0,3,4,11,0,6,1,1,5,0,18,13,1
2947,156295,BMNiq5EV6A8TNZJcxF7Tx1slpqQ99u0q,SpATywNh6bZuzm8s1ceuBUnMUAeoAHHw,1,0,0,0,0,0,1,0,1,0.14285714285714285,1,0.0,0,0,0,0,0,0,0,1,0,0,1,1
2948,156308,ifnHK7elzUrx6FoT7eceCrEZMhAwQ98l,A3fsA9Zfv1X2fVEQhTw51lKENdNrEqT3,28,13,11,18,9,0,5,0,56,8.0,1,0.0,0,11,16,9,13,0,2,5,0,36,20,1
2949,156323,WN48iLnvvEk85bn1Ax5lHk0fUlDw6OCg,SpATywNh6bZuzm8s1ceuBUnMUAeoAHHw,13,15,0,12,0,2,7,1,37,5.285714285714286,1,0.0,0,0,10,0,15,2,2,7,1,10,27,1
2950,156325,OpLX96TX0mzsRYhDl2C02nVgjI6j9XrW,RXDvfPUBYFlVdlueBFbLW0mhhAyGEqpt,1,0,0,0,0,0,1,0,1,0.14285714285714285,1,0.0,0,0,0,0,0,0,0,1,0,0,1,1
2951,156435,45E6hpwDMHp9Q3Pt1xT8q04bbowKk87g,bWdj2GDclj5ofokWjzoa5jAwMkxCykd6,40,64,30,74,25,6,29,2,230,32.857142857142854,5,0.0,23,30,71,25,41,6,3,29,2,149,81,1
2952,156506,WsrGHMpJC5JoJNy1qcc46gvaDlt9pDn6,SpATywNh6bZuzm8s1ceuBUnMUAeoAHHw,9,4,3,0,3,0,2,0,12,1.7142857142857142,1,0.0,0,3,0,3,4,0,0,2,0,6,6,1
2953,156510,Atic9bcAYez6iPYGWH9qjmSkP3PGX2jq,bWdj2GDclj5ofokWjzoa5jAwMkxCykd6,3,3,1,0,0,0,2,0,6,0.8571428571428571,1,0.0,0,1,0,0,3,0,0,2,0,1,5,1
2954,156518,Atic9bcAYez6iPYGWH9qjmSkP3PGX2jq,RXDvfPUBYFlVdlueBFbLW0mhhAyGEqpt,23,40,15,29,12,0,12,1,109,15.571428571428571,1,0.0,7,15,23,12,33,0,6,12,1,57,52,1
2955,156529,JS5kXpYeMxOghDu5iWEChapuWqXPxCs4,RXDvfPUBYFlVdlueBFbLW0mhhAyGEqpt,2,0,0,0,0,0,2,0,2,0.2857142857142857,1,0.0,0,0,0,0,0,0,0,2,0,0,2,1
2956,156543,HoNj5dKRTM00OCznK2rkvjainbjOBy0O,bWdj2GDclj5ofokWjzoa5jAwMkxCykd6,11,5,3,0,2,1,10,1,22,3.142857142857143,1,0.0,0,3,0,2,5,1,0,10,1,5,17,1
2957,156560,wiTUeXradyIJk2N3XHfmkjuyGIQHziQH,SpATywNh6bZuzm8s1ceuBUnMUAeoAHHw,13,12,7,11,2,0,3,0,35,5.0,2,0.0,0,7,10,2,12,0,1,3,0,19,16,0
2958,156562,Un3EzEE4Sz8i5Z84q9e50URbIAEkkVSB,A3fsA9Zfv1X2fVEQhTw51lKENdNrEqT3,5,2,1,0,1,0,5,0,9,1.2857142857142858,3,0.0,0,1,0,1,2,0,0,5,0,2,7,1
2959,156569,OLSxCkluLildKVrVnzRIsj47tt9tVHj9,A3fsA9Zfv1X2fVEQhTw51lKENdNrEqT3,2,0,0,0,0,0,3,0,3,0.42857142857142855,1,0.0,0,0,0,0,0,0,0,3,0,0,3,1
2960,156579,TqZSbKLYcFD5gfQ0wHk9V7SVlkqO9WOv,A3fsA9Zfv1X2fVEQhTw51lKENdNrEqT3,2,0,0,0,0,0,3,0,3,0.42857142857142855,1,0.0,0,0,0,0,0,0,0,3,0,0,3,1
2961,156615,1l4J4YNslNweqVYZ9PIiphpLsWKaZHE7,SpATywNh6bZuzm8s1ceuBUnMUAeoAHHw,14,21,9,14,3,4,3,0,54,7.714285714285714,1,0.0,9,9,11,3,12,4,3,3,0,32,22,0
2962,156656,7IdpyRf57AcKqRM0ayoEIjOEGtDFURim,SpATywNh6bZuzm8s1ceuBUnMUAeoAHHw,17,43,24,4,7,0,10,0,88,12.571428571428571,3,0.0,0,24,3,7,43,0,1,10,0,34,54,0
2963,156682,dgVkbE4MU9DJV1tctk0wRyOO49V94n6e,SpATywNh6bZuzm8s1ceuBUnMUAeoAHHw,7,15,0,0,0,0,6,0,21,3.0,3,0.0,0,0,0,0,15,0,0,6,0,0,21,1
2964,156689,t59SBB5EkGAnAVQuchgekkDDOWF5xR9g,bWdj2GDclj5ofokWjzoa5jAwMkxCykd6,4,1,0,0,0,0,3,0,4,0.5714285714285714,1,0.0,0,0,0,0,1,0,0,3,0,0,4,1
2965,156713,OIIVm7SlB1MihSMHP9mqOAQU5V2HwVOP,A3fsA9Zfv1X2fVEQhTw51lKENdNrEqT3,2,0,0,0,0,0,2,0,2,0.2857142857142857,1,0.0,0,0,0,0,0,0,0,2,0,0,2,1
2966,156717,X535Iu5jdKv0ppLqkwhIGZajlbhLXvmn,bWdj2GDclj5ofokWjzoa5jAwMkxCykd6,6,2,1,0,1,0,8,0,12,1.7142857142857142,1,0.0,0,1,0,1,2,0,0,8,0,2,10,1
2967,156761,gK3XDdBxJJXAYJgDo42Lu6DpWYFShLP7,SpATywNh6bZuzm8s1ceuBUnMUAeoAHHw,5,13,0,0,0,0,1,0,14,2.0,1,0.0,4,0,0,0,9,0,0,1,0,4,10,1
2968,156794,O8fsI8cLbZAXSgU5jDWyt6O1zSRxLyqW,SpATywNh6bZuzm8s1ceuBUnMUAeoAHHw,4,0,0,0,0,1,3,4,8,1.1428571428571428,1,0.0,0,0,0,0,0,1,0,3,4,0,8,1
2969,156801,HoH1joiBpbDlKqg5IXGbrLHAYskumoZ0,A3fsA9Zfv1X2fVEQhTw51lKENdNrEqT3,6,2,1,0,1,0,3,0,7,1.0,1,0.0,0,1,0,1,2,0,0,3,0,2,5,1
2970,156805,GtIbKUKASYfKNPKGxbljpDBTth0Im6QW,A3fsA9Zfv1X2fVEQhTw51lKENdNrEqT3,2,0,0,0,0,0,2,0,2,0.2857142857142857,1,0.0,0,0,0,0,0,0,0,2,0,0,2,1
2971,156828,WRiHtWJX61VUGyAGQFSHJ3czdrgqxeQW,SpATywNh6bZuzm8s1ceuBUnMUAeoAHHw,1,0,0,0,0,0,1,0,1,0.14285714285714285,1,0.0,0,0,0,0,0,0,0,1,0,0,1,1
2972,157189,uo7YhZ0OnoXU4DzC6rBENt0NolKURdsm,7GRhBDsirIGkRZBtSMEzNTyDr2JQm4xx,10,10,6,0,2,0,5,0,23,3.2857142857142856,1,0.0,1,6,0,2,9,0,0,5,0,9,14,1
2973,157198,C9PYulDhlCOnLsyEzeELLLcPxqCNkZMm,7GRhBDsirIGkRZBtSMEzNTyDr2JQm4xx,4,2,0,0,0,0,6,0,8,1.1428571428571428,1,0.0,0,0,0,0,2,0,0,6,0,0,8,1
2974,157202,GXOvdzrIyLHGb3WpOAU0L7zoSw672i7L,7GRhBDsirIGkRZBtSMEzNTyDr2JQm4xx,2,0,0,0,0,0,2,0,2,0.2857142857142857,1,0.0,0,0,0,0,0,0,0,2,0,0,2,1
2975,157234,YsQh8U8uW7iK5N2UDcWrxeNI3UNG6b7j,7GRhBDsirIGkRZBtSMEzNTyDr2JQm4xx,1,0,0,0,0,0,2,0,2,0.2857142857142857,1,0.0,0,0,0,0,0,0,0,2,0,0,2,1
2976,157259,hED50EZVrg4iRW4iqOekbQhqnICw3N8M,7GRhBDsirIGkRZBtSMEzNTyDr2JQm4xx,5,3,2,0,2,0,2,0,9,1.2857142857142858,1,0.0,0,2,0,2,3,0,0,2,0,4,5,1
2977,157286,2GvFS2RdNGmAeuBW2TvolO9O5aFFmxNB,7GRhBDsirIGkRZBtSMEzNTyDr2JQm4xx,1,0,0,0,0,0,1,0,1,0.14285714285714285,1,0.0,0,0,0,0,0,0,0,1,0,0,1,1
2978,157347,5ehf4EFN8WhDbvmb2WvfZwpaBD0cj1oj,7GRhBDsirIGkRZBtSMEzNTyDr2JQm4xx,6,3,1,0,1,0,2,0,7,1.0,1,0.0,0,1,0,1,3,0,0,2,0,2,5,1
2979,157377,DJXmR0KXC00UhtfnxnB0CPGhSlDcn5wL,7GRhBDsirIGkRZBtSMEzNTyDr2JQm4xx,1,0,0,0,0,0,1,0,1,0.14285714285714285,1,0.0,0,0,0,0,0,0,0,1,0,0,1,1
2980,157488,abZjyy6CkJwLuRnRyGB2GrxhAkPifaxi,7GRhBDsirIGkRZBtSMEzNTyDr2JQm4xx,7,5,0,0,0,1,4,0,10,1.4285714285714286,1,0.0,0,0,0,0,5,1,0,4,0,0,10,1
2981,157627,xHfGdYj0sYZXXCzkQp0eF5wBXW7C2C6R,7GRhBDsirIGkRZBtSMEzNTyDr2JQm4xx,1,0,0,0,0,0,1,0,1,0.14285714285714285,1,0.0,0,0,0,0,0,0,0,1,0,0,1,1
2982,160309,m1fBxfdP24tbh5rWoiFGny0cd2DQDU7n,7GRhBDsirIGkRZBtSMEzNTyDr2JQm4xx,2,0,0,0,0,0,2,0,2,0.2857142857142857,1,0.0,0,0,0,0,0,0,0,2,0,0,2,1
2983,160343,oCUO9XlUIOh3Ij7ThU6V6i4UFCJQT7mf,7GRhBDsirIGkRZBtSMEzNTyDr2JQm4xx,1,0,0,0,0,0,1,0,1,0.14285714285714285,1,0.0,0,0,0,0,0,0,0,1,0,0,1,1
2984,160370,SWQaeOMzpLQ0O6BdWhgpESQIJJfRIjcf,7GRhBDsirIGkRZBtSMEzNTyDr2JQm4xx,1,0,0,0,0,0,1,0,1,0.14285714285714285,1,0.0,0,0,0,0,0,0,0,1,0,0,1,1
2985,160374,YxPma1Wq13D1SO5XQzSvHgBwRYOIrVRk,7GRhBDsirIGkRZBtSMEzNTyDr2JQm4xx,1,0,0,0,0,0,1,0,1,0.14285714285714285,1,0.0,0,0,0,0,0,0,0,1,0,0,1,1
2986,160404,5va1sV2BwXc5BtIB3Klat9ON2fDXMGdg,7GRhBDsirIGkRZBtSMEzNTyDr2JQm4xx,1,0,0,0,0,0,1,0,1,0.14285714285714285,1,0.0,0,0,0,0,0,0,0,1,0,0,1,1
2987,160417,nrol5VxiNERghlxTlRYzcM0aTVUVOtUp,7GRhBDsirIGkRZBtSMEzNTyDr2JQm4xx,1,0,0,0,0,0,1,0,1,0.14285714285714285,1,0.0,0,0,0,0,0,0,0,1,0,0,1,1
2988,160447,VaYYfZ3JVOT6bOWghdrqK1SOwK0gM5y2,7GRhBDsirIGkRZBtSMEzNTyDr2JQm4xx,1,0,0,0,0,0,1,0,1,0.14285714285714285,1,0.0,0,0,0,0,0,0,0,1,0,0,1,1
2989,160487,PRfZLzeSQB5SIGo2mbBK9MaxsrpewgA0,7GRhBDsirIGkRZBtSMEzNTyDr2JQm4xx,10,6,2,0,2,3,11,0,24,3.4285714285714284,1,0.0,2,2,0,2,4,3,0,11,0,6,18,1
2990,160726,8E88mVxxHiSEV3ReMbiLkIuYAxJ6YXeO,bWdj2GDclj5ofokWjzoa5jAwMkxCykd6,4,3,2,0,0,0,1,0,6,0.8571428571428571,1,0.0,0,2,0,0,3,0,0,1,0,2,4,1
2991,160766,WpwD79l1tHxSYGvzddD5jkm0kQD6YzUK,SpATywNh6bZuzm8s1ceuBUnMUAeoAHHw,8,4,0,0,0,1,6,1,12,1.7142857142857142,1,0.0,0,0,0,0,4,1,0,6,1,0,12,0
2992,161218,IoUEv205kL70u2MwbYRNexNGlv0hD8vn,SpATywNh6bZuzm8s1ceuBUnMUAeoAHHw,13,17,10,18,0,1,2,0,48,6.857142857142857,1,0.0,6,10,18,0,11,1,0,2,0,34,14,1
2993,161424,vVoYtG2vzUhg3qXoaTM1GNiznwKfFexh,A3fsA9Zfv1X2fVEQhTw51lKENdNrEqT3,1,0,0,0,0,0,1,0,1,0.14285714285714285,1,0.0,0,0,0,0,0,0,0,1,0,0,1,1
2994,162029,OUbrW18OgibVb4I41eHFiFhkobpgjEP2,A3fsA9Zfv1X2fVEQhTw51lKENdNrEqT3,16,10,8,0,6,0,6,0,30,4.285714285714286,2,0.0,0,8,0,6,10,0,0,6,0,14,16,0
2995,163208,afMatYBEskDEx2mzVDW2B6YoXRt9RGEu,7GRhBDsirIGkRZBtSMEzNTyDr2JQm4xx,1,0,0,0,0,0,1,0,1,0.14285714285714285,1,0.0,0,0,0,0,0,0,0,1,0,0,1,1
2996,163263,4i5hqm1gfzAWGRB4svclJb7LMO8qbrVL,7GRhBDsirIGkRZBtSMEzNTyDr2JQm4xx,4,3,1,0,0,0,2,0,6,0.8571428571428571,1,0.0,0,1,0,0,3,0,0,2,0,1,5,1
2997,163295,kgapU06uO2FTgFvaWXJYj3aeIVCjcJ3p,7GRhBDsirIGkRZBtSMEzNTyDr2JQm4xx,1,0,0,0,0,0,1,0,1,0.14285714285714285,1,0.0,0,0,0,0,0,0,0,1,0,0,1,1
2998,163305,sPLn9Z0P7AWvSFd67DQFXqDRTnVlsDDq,7GRhBDsirIGkRZBtSMEzNTyDr2JQm4xx,7,4,3,0,3,0,2,0,12,1.7142857142857142,1,0.0,0,3,0,3,4,0,0,2,0,6,6,1
2999,163310,TpVcNSSZgwZ6DE3d1K8SPrDWLNQ6MrgR,7GRhBDsirIGkRZBtSMEzNTyDr2JQm4xx,1,0,0,0,0,0,1,0,1,0.14285714285714285,1,0.0,0,0,0,0,0,0,0,1,0,0,1,1
3000,163451,rUr3hxt1niPeDbjT1dWASqAoHDERYMHJ,bWdj2GDclj5ofokWjzoa5jAwMkxCykd6,13,3,2,56,0,0,1,0,62,8.857142857142858,1,0.0,0,2,49,0,3,0,7,1,0,51,11,0
3001,163522,0z2VYcRtlKJQ1Og2a3In5C7pwhw0mXLE,SpATywNh6bZuzm8s1ceuBUnMUAeoAHHw,16,17,9,12,5,25,2,0,70,10.0,2,0.0,7,9,12,5,10,25,0,2,0,33,37,1
3002,163624,J4pjYRUS78455k3x6FlgE0qLyKCkWPB4,SpATywNh6bZuzm8s1ceuBUnMUAeoAHHw,3,2,1,0,0,0,2,0,5,0.7142857142857143,1,0.0,0,1,0,0,2,0,0,2,0,1,4,1
3003,163664,75QwID9vkHNyAC3jIqeF9fNTGOKWDCMd,SpATywNh6bZuzm8s1ceuBUnMUAeoAHHw,18,26,0,18,0,9,5,2,60,8.571428571428571,1,0.0,8,0,12,0,18,9,6,5,2,20,40,0
3004,163843,6ifSGyv1OJBX59YUfupEGQzaFg12QLcw,RXDvfPUBYFlVdlueBFbLW0mhhAyGEqpt,14,7,6,0,5,0,2,2,22,3.142857142857143,1,0.0,0,6,0,5,7,0,0,2,2,11,11,1
3005,164169,g8GaCwXJUf6SPnVxk3h41vOpn1g2rMNj,G8EPVSXsOYB5YQWZGiz1aVq5Pgr2GrQu,9,6,4,0,2,0,2,0,14,2.0,1,0.0,0,4,0,2,6,0,0,2,0,6,8,1
3006,164459,viXqqg0vx2jNkZn6Nty7fAz4j4zmpVoE,SpATywNh6bZuzm8s1ceuBUnMUAeoAHHw,7,14,6,0,1,0,4,0,25,3.5714285714285716,2,0.0,1,6,0,1,13,0,0,4,0,8,17,0
3007,164462,gD7dR7qYBA1tFY5jHEs9UR01plTA8iId,SpATywNh6bZuzm8s1ceuBUnMUAeoAHHw,6,11,1,0,0,0,1,0,13,1.8571428571428572,1,0.0,2,1,0,0,9,0,0,1,0,3,10,0
3008,164502,gjOO3qwnQCAatqMKu7gZIW5sztiBAppS,SpATywNh6bZuzm8s1ceuBUnMUAeoAHHw,1,0,0,0,0,0,1,0,1,0.14285714285714285,1,0.0,0,0,0,0,0,0,0,1,0,0,1,1
3009,164613,EBMQHva9lsULDK4s7iJrovR7inTeu6Ks,SpATywNh6bZuzm8s1ceuBUnMUAeoAHHw,14,18,7,11,4,0,1,0,41,5.857142857142857,1,0.0,7,7,9,4,11,0,2,1,0,27,14,1
3010,164783,HNOiqLBLlemqEjDq99MX1KCbGHtf7sfC,SpATywNh6bZuzm8s1ceuBUnMUAeoAHHw,3,2,1,0,0,1,2,0,6,0.8571428571428571,1,0.0,0,1,0,0,2,1,0,2,0,1,5,1
3011,164914,VAF0Nhm4Uogjf17s6SveryaIcEEMWJow,SpATywNh6bZuzm8s1ceuBUnMUAeoAHHw,3,1,1,0,1,0,0,0,3,0.42857142857142855,1,0.0,0,1,0,1,1,0,0,0,0,2,1,1
3012,164975,QWhWii7LiCaC2aGmlsc9abDahkygX2yj,RXDvfPUBYFlVdlueBFbLW0mhhAyGEqpt,1,0,0,0,0,0,1,0,1,0.14285714285714285,1,0.0,0,0,0,0,0,0,0,1,0,0,1,1
3013,165138,iqnxkAIvXEPq7LutRrGOzst5meEvTsYz,SpATywNh6bZuzm8s1ceuBUnMUAeoAHHw,1,0,0,0,0,0,1,0,1,0.14285714285714285,1,0.0,0,0,0,0,0,0,0,1,0,0,1,1
3014,165574,JfftjOGdDbpgbrupi0Gwr899R0jzXikJ,G8EPVSXsOYB5YQWZGiz1aVq5Pgr2GrQu,5,4,3,0,1,0,2,0,10,1.4285714285714286,1,0.0,0,3,0,1,4,0,0,2,0,4,6,1
3015,165923,Ae22hvALqv0MxUz0BtfyFRCZH8Unzasl,fbPkOYLVPtPgIt0MxizjfFJov3JbHyAi,9,6,2,0,1,0,4,0,13,1.8571428571428572,1,0.0,0,2,0,1,6,0,0,4,0,3,10,1
3016,165924,g4PsrTaWbf4PyAkwCyr7KPRrkKd1GQUF,fbPkOYLVPtPgIt0MxizjfFJov3JbHyAi,47,85,55,27,42,0,7,0,216,30.857142857142858,1,0.0,22,55,19,42,63,0,8,7,0,138,78,1
3017,165929,N0ztuAsLjfbstbT2QmcILqqvk7xyZRdK,fbPkOYLVPtPgIt0MxizjfFJov3JbHyAi,4,2,0,0,0,4,5,0,11,1.5714285714285714,1,0.0,0,0,0,0,2,4,0,5,0,0,11,1
3018,165932,2DzEePfp8vI6Xs0JiVvwLEBMcAhSfVlO,fbPkOYLVPtPgIt0MxizjfFJov3JbHyAi,27,15,13,0,11,0,2,0,41,5.857142857142857,1,0.0,0,13,0,11,15,0,0,2,0,24,17,1
3019,165933,AFquoviJC5pTQRr2e6rOoJKhtZPD68e6,fbPkOYLVPtPgIt0MxizjfFJov3JbHyAi,1,0,0,0,0,0,1,0,1,0.14285714285714285,1,0.0,0,0,0,0,0,0,0,1,0,0,1,1
3020,165935,n1KDgjl33Pixp3I97r6srvTiO5SuF7Nz,fbPkOYLVPtPgIt0MxizjfFJov3JbHyAi,2,0,0,0,0,0,3,0,3,0.42857142857142855,1,0.0,0,0,0,0,0,0,0,3,0,0,3,1
3021,165936,dEMaD0MQ8e6kvzK6uTaTqEapXiabfWOZ,fbPkOYLVPtPgIt0MxizjfFJov3JbHyAi,1,0,0,0,0,0,1,0,1,0.14285714285714285,1,0.0,0,0,0,0,0,0,0,1,0,0,1,1
3022,165937,Tinpz4fjOCtpep3uA5BTGuPzKNOjU7rZ,fbPkOYLVPtPgIt0MxizjfFJov3JbHyAi,8,2,1,0,1,0,6,1,11,1.5714285714285714,1,0.0,0,1,0,1,2,0,0,6,1,2,9,1
3023,165938,0KJ4hMwNKcU4u0kRo24XysZZkRQaIxT8,fbPkOYLVPtPgIt0MxizjfFJov3JbHyAi,11,6,4,0,3,1,5,0,19,2.7142857142857144,1,0.0,0,4,0,3,6,1,0,5,0,7,12,1
3024,165940,xQ2BABxu01BWouoal36eufzFXJFj8740,fbPkOYLVPtPgIt0MxizjfFJov3JbHyAi,5,2,1,0,1,0,4,0,8,1.1428571428571428,1,0.0,0,1,0,1,2,0,0,4,0,2,6,1
3025,165941,sYY4KU9duRm2WvtJaAqFW3lrzMYM9YTK,fbPkOYLVPtPgIt0MxizjfFJov3JbHyAi,1,0,0,0,0,0,1,0,1,0.14285714285714285,1,0.0,0,0,0,0,0,0,0,1,0,0,1,1
3026,165945,L4G4vKN8ytBRvs68XcSQcEruocF5VrXF,fbPkOYLVPtPgIt0MxizjfFJov3JbHyAi,11,12,4,1,7,0,5,0,29,4.142857142857143,1,0.0,7,4,1,7,5,0,0,5,0,19,10,1
3027,165946,PkAoACuemSFXbpeGyaVjPpfHQnZGDRZj,fbPkOYLVPtPgIt0MxizjfFJov3JbHyAi,1,0,0,0,0,0,1,0,1,0.14285714285714285,1,0.0,0,0,0,0,0,0,0,1,0,0,1,1
3028,165948,hkJlttz5bDZp3UAkxISJCqbBUU7zCJGE,fbPkOYLVPtPgIt0MxizjfFJov3JbHyAi,6,5,1,0,2,0,2,0,10,1.4285714285714286,1,0.0,2,1,0,2,3,0,0,2,0,5,5,1
3029,165950,nD4vzUC5IhneshAQmhqAnl7GVhvdL4Oa,fbPkOYLVPtPgIt0MxizjfFJov3JbHyAi,6,5,4,0,3,0,2,0,14,2.0,1,0.0,0,4,0,3,5,0,0,2,0,7,7,1
3030,165952,9qEU7W2Isd4L4gGJxLIjYzA3Il6E8bpq,fbPkOYLVPtPgIt0MxizjfFJov3JbHyAi,1,0,0,0,0,0,1,0,1,0.14285714285714285,1,0.0,0,0,0,0,0,0,0,1,0,0,1,1
3031,165953,Xi5jJx0Z2MOBm1fPpYwlvuzwElYhyszd,fbPkOYLVPtPgIt0MxizjfFJov3JbHyAi,8,6,3,0,1,0,3,1,14,2.0,1,0.0,0,3,0,1,6,0,0,3,1,4,10,1
3032,165959,nDEAbdtySU0D9dF3CpKEHZFDA8qmxdYa,fbPkOYLVPtPgIt0MxizjfFJov3JbHyAi,4,2,0,0,0,0,2,0,4,0.5714285714285714,1,0.0,0,0,0,0,2,0,0,2,0,0,4,1
3033,165960,7vIvISS7ijOom6TvJIkwXN5GvDUAFRxR,fbPkOYLVPtPgIt0MxizjfFJov3JbHyAi,1,0,0,0,0,0,1,0,1,0.14285714285714285,1,0.0,0,0,0,0,0,0,0,1,0,0,1,1
3034,165962,XVAhFtuqfyjnzPVdjpwB4j2TwuAUpbEa,fbPkOYLVPtPgIt0MxizjfFJov3JbHyAi,5,2,1,0,1,0,2,0,6,0.8571428571428571,1,0.0,0,1,0,1,2,0,0,2,0,2,4,1
3035,165966,ClOkOu5t4KsYmmlGT8TtbSp6RHO1dS7b,fbPkOYLVPtPgIt0MxizjfFJov3JbHyAi,15,25,11,10,14,0,6,0,66,9.428571428571429,2,0.0,12,11,9,14,13,0,1,6,0,46,20,1
3036,165968,m2dEISaBvHWrLGQEI5zibEiH1nbUMDmE,fbPkOYLVPtPgIt0MxizjfFJov3JbHyAi,3,2,1,0,0,0,2,0,5,0.7142857142857143,1,0.0,0,1,0,0,2,0,0,2,0,1,4,1
3037,165971,No3uaZVX8QfUWi2WuoYFYrVrLQNiuZit,fbPkOYLVPtPgIt0MxizjfFJov3JbHyAi,10,17,8,0,1,6,4,0,36,5.142857142857143,2,0.0,6,8,0,1,11,6,0,4,0,15,21,0
3038,165972,1FTDLU0hMqcHLpAYkeifJZgSteMYLeP4,fbPkOYLVPtPgIt0MxizjfFJov3JbHyAi,9,7,4,0,3,0,2,0,16,2.2857142857142856,1,0.0,1,4,0,3,6,0,0,2,0,8,8,1
3039,165973,hJvv1gUOmLiHeeVGHBEcsZYIwyTiE5ff,fbPkOYLVPtPgIt0MxizjfFJov3JbHyAi,9,3,2,0,2,0,4,0,11,1.5714285714285714,1,0.0,0,2,0,2,3,0,0,4,0,4,7,1
3040,165980,toJoC2Dz4pkE4Zg9u6dfUofCepqbYSQk,fbPkOYLVPtPgIt0MxizjfFJov3JbHyAi,4,2,0,0,0,0,4,0,6,0.8571428571428571,1,0.0,0,0,0,0,2,0,0,4,0,0,6,1
3041,165981,LbU1jyqO2EUpiuLYtgaX21ombTqyoZWL,fbPkOYLVPtPgIt0MxizjfFJov3JbHyAi,5,4,0,0,0,0,6,0,10,1.4285714285714286,1,0.0,0,0,0,0,4,0,0,6,0,0,10,1
3042,165984,UQfv7o9p9lV4lRkL1vVMlZTP2dPtcdzG,fbPkOYLVPtPgIt0MxizjfFJov3JbHyAi,5,3,1,0,1,0,2,0,7,1.0,1,0.0,0,1,0,1,3,0,0,2,0,2,5,1
3043,165985,UAzjSo4qDf1pkQceftDVLCKsvfzQ6NyU,fbPkOYLVPtPgIt0MxizjfFJov3JbHyAi,18,16,8,0,7,1,2,0,34,4.857142857142857,1,0.0,0,8,0,7,16,1,0,2,0,15,19,1
3044,165988,GE48LtSsMWryASGs1FlnEw40AwktRNOT,fbPkOYLVPtPgIt0MxizjfFJov3JbHyAi,7,3,2,0,2,8,4,0,19,2.7142857142857144,1,0.0,0,2,0,2,3,8,0,4,0,4,15,1
3045,165989,b5WncJSLsMNsvTtUX4GOshLjrNYBfS0U,fbPkOYLVPtPgIt0MxizjfFJov3JbHyAi,1,0,0,0,0,0,1,0,1,0.14285714285714285,1,0.0,0,0,0,0,0,0,0,1,0,0,1,1
3046,165992,Wt8lglrVLSreEoovOJIO0VXJgpwg81lv,fbPkOYLVPtPgIt0MxizjfFJov3JbHyAi,9,6,3,0,2,0,5,1,17,2.4285714285714284,1,0.0,0,3,0,2,6,0,0,5,1,5,12,1
3047,165993,8yNyyy8aPKd19nuqwaynaLkU67KuROpn,fbPkOYLVPtPgIt0MxizjfFJov3JbHyAi,17,10,9,0,9,0,2,0,30,4.285714285714286,1,0.0,0,9,0,9,10,0,0,2,0,18,12,1
3048,165994,O5kAlgXfdKVePlq806YxmEVko0qCkZzG,fbPkOYLVPtPgIt0MxizjfFJov3JbHyAi,1,0,0,0,0,0,2,0,2,0.2857142857142857,1,0.0,0,0,0,0,0,0,0,2,0,0,2,1
3049,165995,zDgM2vvltn6gXNx1hUBDd8fFebbnmmWo,fbPkOYLVPtPgIt0MxizjfFJov3JbHyAi,1,0,0,0,0,0,1,0,1,0.14285714285714285,1,0.0,0,0,0,0,0,0,0,1,0,0,1,1
3050,165996,LXj1WYMapfbcZixGvlzo4y3R5Bt3m0Vn,fbPkOYLVPtPgIt0MxizjfFJov3JbHyAi,1,0,0,0,0,0,1,0,1,0.14285714285714285,1,0.0,0,0,0,0,0,0,0,1,0,0,1,1
3051,166000,PMOSmRt4fRUG27WzPyEHqHKXX14Xi4NX,fbPkOYLVPtPgIt0MxizjfFJov3JbHyAi,1,0,0,0,0,0,1,0,1,0.14285714285714285,1,0.0,0,0,0,0,0,0,0,1,0,0,1,1
3052,166001,Hc6XZmx7ZQQRjy23848JYEBkgJsujUuY,fbPkOYLVPtPgIt0MxizjfFJov3JbHyAi,5,2,1,0,1,0,3,0,7,1.0,1,0.0,0,1,0,1,2,0,0,3,0,2,5,1
3053,166004,r5jinF0G0Atp0uUdWzFeA9Dxz6JBtOHv,fbPkOYLVPtPgIt0MxizjfFJov3JbHyAi,8,3,2,0,2,0,3,0,10,1.4285714285714286,1,0.0,0,2,0,2,3,0,0,3,0,4,6,1
3054,166007,ffImGRf9pvFQSBFckBEzUfl1PucCkATq,fbPkOYLVPtPgIt0MxizjfFJov3JbHyAi,1,0,0,0,0,0,1,0,1,0.14285714285714285,1,0.0,0,0,0,0,0,0,0,1,0,0,1,1
3055,166008,q4qRNKt6T9G0qxbDK4nh8fPY4HlIZJpN,fbPkOYLVPtPgIt0MxizjfFJov3JbHyAi,1,0,0,0,0,0,1,0,1,0.14285714285714285,1,0.0,0,0,0,0,0,0,0,1,0,0,1,1
3056,166010,jTd3OCBirsXRXozKADIUhKrXCVzIgRme,fbPkOYLVPtPgIt0MxizjfFJov3JbHyAi,11,21,6,0,8,0,3,0,38,5.428571428571429,1,0.0,14,6,0,8,7,0,0,3,0,28,10,1
3057,166011,T2B2X3gb5fdopiXu62Tu4E2DMy7sMSD1,fbPkOYLVPtPgIt0MxizjfFJov3JbHyAi,1,0,0,0,0,0,1,0,1,0.14285714285714285,1,0.0,0,0,0,0,0,0,0,1,0,0,1,1
3058,166016,vpmKK2fvh0wwuItw5yJ4YzfFSwaX4K1i,fbPkOYLVPtPgIt0MxizjfFJov3JbHyAi,1,0,0,0,0,0,1,0,1,0.14285714285714285,1,0.0,0,0,0,0,0,0,0,1,0,0,1,1
3059,166017,ImymTAbHJfMMMPKBwnuXmdPedLhaLLQ4,fbPkOYLVPtPgIt0MxizjfFJov3JbHyAi,1,0,0,0,0,0,1,0,1,0.14285714285714285,1,0.0,0,0,0,0,0,0,0,1,0,0,1,1
3060,166136,yl1czWTsEc25eyLba69IHArFJ1AESbkB,fbPkOYLVPtPgIt0MxizjfFJov3JbHyAi,11,7,4,0,2,0,10,1,24,3.4285714285714284,2,0.0,0,4,0,2,7,0,0,10,1,6,18,1
3061,166137,BZAa5FHuzEdX48cxIhsFBf8tlybpBCLx,fbPkOYLVPtPgIt0MxizjfFJov3JbHyAi,1,0,0,0,0,0,1,0,1,0.14285714285714285,1,0.0,0,0,0,0,0,0,0,1,0,0,1,1
3062,166145,1drLxoSaZXWb9UC1qR0hH1CkYJWXeTKQ,fbPkOYLVPtPgIt0MxizjfFJov3JbHyAi,1,0,0,0,0,0,1,0,1,0.14285714285714285,1,0.0,0,0,0,0,0,0,0,1,0,0,1,1
3063,166146,RFGMjZRXt4tuFIbx8DYfxpBzyQc4B9QK,fbPkOYLVPtPgIt0MxizjfFJov3JbHyAi,2,0,0,0,0,0,7,0,7,1.0,1,0.0,0,0,0,0,0,0,0,7,0,0,7,1
3064,166147,uDXojcZmAjRrYpbHg6OiLrdKtE8isYPI,fbPkOYLVPtPgIt0MxizjfFJov3JbHyAi,1,0,0,0,0,0,1,0,1,0.14285714285714285,1,0.0,0,0,0,0,0,0,0,1,0,0,1,1
3065,166148,gEfA8oSIHqbidc8ueZMiKg0wULpPs9EE,fbPkOYLVPtPgIt0MxizjfFJov3JbHyAi,3,1,0,0,0,0,6,0,7,1.0,1,0.0,0,0,0,0,1,0,0,6,0,0,7,1
3066,166149,jz0z8WtMaF1l7Nd9g9Ta3D63c4ohIzb2,fbPkOYLVPtPgIt0MxizjfFJov3JbHyAi,5,2,1,0,1,0,2,0,6,0.8571428571428571,1,0.0,0,1,0,1,2,0,0,2,0,2,4,1
3067,166153,zXvDUt3LgrB0KNQc9FoWhJ1W2pAiQJPd,fbPkOYLVPtPgIt0MxizjfFJov3JbHyAi,1,0,0,0,0,0,1,0,1,0.14285714285714285,1,0.0,0,0,0,0,0,0,0,1,0,0,1,1
3068,166154,lSZoAh0N0Lt8L3rqDq2pbnhpzHs4jrDI,fbPkOYLVPtPgIt0MxizjfFJov3JbHyAi,5,2,1,0,1,0,4,0,8,1.1428571428571428,1,0.0,0,1,0,1,2,0,0,4,0,2,6,1
3069,166155,ef55znmweQJrijlI0fO1Ekc271nZnV0m,fbPkOYLVPtPgIt0MxizjfFJov3JbHyAi,5,2,1,0,1,0,2,0,6,0.8571428571428571,1,0.0,0,1,0,1,2,0,0,2,0,2,4,1
3070,166156,Gc9FbbmaGQGlnmnRUjTL7bYNyXYRT1nJ,fbPkOYLVPtPgIt0MxizjfFJov3JbHyAi,2,0,0,0,0,0,2,0,2,0.2857142857142857,1,0.0,0,0,0,0,0,0,0,2,0,0,2,1
3071,166157,tfQHC1cUfGIbjxrAzAZrBm9HnB72SzwU,fbPkOYLVPtPgIt0MxizjfFJov3JbHyAi,20,20,14,0,10,7,12,7,70,10.0,1,0.0,2,14,0,10,18,7,0,12,7,26,44,1
3072,166158,HMNOnIW6u5dbPy0UCu54RGHmZvKhZGzf,fbPkOYLVPtPgIt0MxizjfFJov3JbHyAi,5,11,1,0,1,0,4,0,17,2.4285714285714284,1,0.0,9,1,0,1,2,0,0,4,0,11,6,1
3073,166160,qQOsZomAFoKDKPSRrF5FYWs1Zz9uDJVk,fbPkOYLVPtPgIt0MxizjfFJov3JbHyAi,2,0,0,0,0,0,4,0,4,0.5714285714285714,1,0.0,0,0,0,0,0,0,0,4,0,0,4,1
3074,166163,vvtmzsrkptNlFQlQRiEFe3TANujrEqYp,fbPkOYLVPtPgIt0MxizjfFJov3JbHyAi,1,0,0,0,0,0,1,0,1,0.14285714285714285,1,0.0,0,0,0,0,0,0,0,1,0,0,1,1
3075,166164,5RdGNDILnjdvCJ7HdlzpCtXsdeo7gaMF,fbPkOYLVPtPgIt0MxizjfFJov3JbHyAi,1,0,0,0,0,0,1,0,1,0.14285714285714285,1,0.0,0,0,0,0,0,0,0,1,0,0,1,1
3076,166168,rqjy9MBaTbrPcPapKqAdlw4agDXaSEfE,fbPkOYLVPtPgIt0MxizjfFJov3JbHyAi,1,0,0,0,0,0,1,0,1,0.14285714285714285,1,0.0,0,0,0,0,0,0,0,1,0,0,1,1
3077,166170,kmvJp6nzoFXW8Oc5kR5gMGOAAX5QexyP,fbPkOYLVPtPgIt0MxizjfFJov3JbHyAi,1,0,0,0,0,0,1,0,1,0.14285714285714285,1,0.0,0,0,0,0,0,0,0,1,0,0,1,1
3078,166175,R3cwyGYX3VZeygFsQJH9jlsc69OIabHp,fbPkOYLVPtPgIt0MxizjfFJov3JbHyAi,4,3,0,0,0,0,2,0,5,0.7142857142857143,1,0.0,0,0,0,0,3,0,0,2,0,0,5,1
3079,166177,1GJwPJw465ARTw6DCRQ9CrmILllIR9bx,fbPkOYLVPtPgIt0MxizjfFJov3JbHyAi,2,0,0,0,0,0,2,0,2,0.2857142857142857,1,0.0,0,0,0,0,0,0,0,2,0,0,2,1
3080,166182,QuVyCkZrDonWxKYO9hgDhn6YwJRZulhs,fbPkOYLVPtPgIt0MxizjfFJov3JbHyAi,8,2,1,0,1,5,16,1,26,3.7142857142857144,1,0.0,0,1,0,1,2,5,0,16,1,2,24,1
3081,166186,HdUhc4G7VRJcbtjXjCH13w2JqJd1SSbb,fbPkOYLVPtPgIt0MxizjfFJov3JbHyAi,5,2,1,0,1,0,2,0,6,0.8571428571428571,1,0.0,0,1,0,1,2,0,0,2,0,2,4,1
3082,166187,zoMCPyYhAfGWkHGBJFERTWZdMBzykaRB,fbPkOYLVPtPgIt0MxizjfFJov3JbHyAi,4,4,2,0,0,0,1,0,7,1.0,1,0.0,0,2,0,0,4,0,0,1,0,2,5,1
3083,166188,6Lis3QiZL3noC9wlW2RHCrUdD9IiBvZi,fbPkOYLVPtPgIt0MxizjfFJov3JbHyAi,5,2,1,0,1,0,3,0,7,1.0,1,0.0,0,1,0,1,2,0,0,3,0,2,5,1
3084,166189,nEQJ6jbTp4ska93bUrSmQZHx5JprZiSY,fbPkOYLVPtPgIt0MxizjfFJov3JbHyAi,2,0,0,0,0,0,2,0,2,0.2857142857142857,1,0.0,0,0,0,0,0,0,0,2,0,0,2,1
3085,166194,YTGf8IW1bAvGMGrrIZgbZY9E8w2ZKJg9,fbPkOYLVPtPgIt0MxizjfFJov3JbHyAi,5,2,1,0,1,0,2,0,6,0.8571428571428571,1,0.0,0,1,0,1,2,0,0,2,0,2,4,1
3086,166198,ljbA5yUe3ZigWWTZVZHvaZzlcQ3OUJib,fbPkOYLVPtPgIt0MxizjfFJov3JbHyAi,8,5,1,0,1,0,8,1,16,2.2857142857142856,1,0.0,0,1,0,1,5,0,0,8,1,2,14,1
3087,166203,28rpiJDQpdq3215vdwQ3rsZ0mFqWnJQZ,fbPkOYLVPtPgIt0MxizjfFJov3JbHyAi,6,2,1,0,1,0,3,0,7,1.0,1,0.0,0,1,0,1,2,0,0,3,0,2,5,1
3088,166204,vAIC6rsvgV7HbKGkew8JoXcaRFgXoors,fbPkOYLVPtPgIt0MxizjfFJov3JbHyAi,5,2,1,0,0,0,5,0,8,1.1428571428571428,1,0.0,0,1,0,0,2,0,0,5,0,1,7,1
3089,166207,8y2thNQcTL5saoD2DkzYwLVOul0NGb55,fbPkOYLVPtPgIt0MxizjfFJov3JbHyAi,1,0,0,0,0,0,1,0,1,0.14285714285714285,1,0.0,0,0,0,0,0,0,0,1,0,0,1,1
3090,166210,KLos613TyBDKjmDfE1975SNolozt8fEs,fbPkOYLVPtPgIt0MxizjfFJov3JbHyAi,3,0,0,0,0,0,3,0,3,0.42857142857142855,1,0.0,0,0,0,0,0,0,0,3,0,0,3,1
3091,166213,qIz5uvx21yY3zTPvMFcPXhap84pBzDvR,fbPkOYLVPtPgIt0MxizjfFJov3JbHyAi,6,4,0,0,0,3,5,0,12,1.7142857142857142,1,0.0,0,0,0,0,4,3,0,5,0,0,12,1
3092,166215,0sg2jGIMVa15FUIKUaYVkaVNV1yVl35B,fbPkOYLVPtPgIt0MxizjfFJov3JbHyAi,7,3,2,0,2,0,2,0,9,1.2857142857142858,1,0.0,0,2,0,2,3,0,0,2,0,4,5,1
3093,166217,G8RQSDElGQvlM3p8kKR2TUxzTka4oOJb,fbPkOYLVPtPgIt0MxizjfFJov3JbHyAi,7,7,2,0,3,0,2,0,14,2.0,1,0.0,2,2,0,3,5,0,0,2,0,7,7,1
3094,166220,gJIxI0ytF6J0PbE93GpuuDnUUCLDIzYX,fbPkOYLVPtPgIt0MxizjfFJov3JbHyAi,1,0,0,0,0,0,2,0,2,0.2857142857142857,1,0.0,0,0,0,0,0,0,0,2,0,0,2,1
3095,166222,tEG8YJMefgmQpIrlmBvHrR6glsVPJZ6p,fbPkOYLVPtPgIt0MxizjfFJov3JbHyAi,1,0,0,0,0,0,2,0,2,0.2857142857142857,1,0.0,0,0,0,0,0,0,0,2,0,0,2,1
3096,166225,HJ92FBrq5yG61EaDVcrZGDa4ZRxYv0Cx,fbPkOYLVPtPgIt0MxizjfFJov3JbHyAi,10,8,6,0,5,3,3,0,25,3.5714285714285716,1,0.0,0,6,0,5,8,3,0,3,0,11,14,1
3097,166227,aM04j8B80UycNpLiy2mFNdgBiaLCgDBx,fbPkOYLVPtPgIt0MxizjfFJov3JbHyAi,7,5,0,0,0,0,3,1,9,1.2857142857142858,1,0.0,0,0,0,0,5,0,0,3,1,0,9,1
3098,166229,QjbLQSoFVavd6LHLH5XtUy4x4q9nhmtF,fbPkOYLVPtPgIt0MxizjfFJov3JbHyAi,1,0,0,0,0,0,1,0,1,0.14285714285714285,1,0.0,0,0,0,0,0,0,0,1,0,0,1,1
3099,166230,6V2GrQFILHPsB0ekNjtLouAcbsjILF5g,fbPkOYLVPtPgIt0MxizjfFJov3JbHyAi,6,3,1,0,1,0,3,0,8,1.1428571428571428,1,0.0,0,1,0,1,3,0,0,3,0,2,6,1
3100,166231,YClUw7DFcczmQH6YbCWf4FT5MXeix8uw,fbPkOYLVPtPgIt0MxizjfFJov3JbHyAi,2,0,0,0,0,0,2,0,2,0.2857142857142857,1,0.0,0,0,0,0,0,0,0,2,0,0,2,1
3101,166232,sjjdkFlcuWgdDM2N9WBHJl0FJpmG07bZ,fbPkOYLVPtPgIt0MxizjfFJov3JbHyAi,5,2,1,0,1,0,2,0,6,0.8571428571428571,1,0.0,0,1,0,1,2,0,0,2,0,2,4,1
3102,166233,nig5RNhFSqFXsyMzwiBEQh8ryEN4ZIW3,fbPkOYLVPtPgIt0MxizjfFJov3JbHyAi,5,2,1,0,1,0,2,0,6,0.8571428571428571,1,0.0,0,1,0,1,2,0,0,2,0,2,4,1
3103,166237,2wxemnlILR4SFHmJ1CKeBLLcblIV9xQc,fbPkOYLVPtPgIt0MxizjfFJov3JbHyAi,25,20,11,27,9,0,4,0,71,10.142857142857142,2,0.0,6,11,21,9,14,0,6,4,0,47,24,1
3104,166239,GOEtSHSk6DV4bxigVVOBhrHtzfU5WaJO,fbPkOYLVPtPgIt0MxizjfFJov3JbHyAi,1,0,0,0,0,0,1,0,1,0.14285714285714285,1,0.0,0,0,0,0,0,0,0,1,0,0,1,1
3105,166241,sMpDCfadCgwh9MAo1W5K6Ik5Xg8rzern,fbPkOYLVPtPgIt0MxizjfFJov3JbHyAi,5,2,1,0,1,0,2,0,6,0.8571428571428571,1,0.0,0,1,0,1,2,0,0,2,0,2,4,1
3106,166242,2ZLHuYdEPLeyzuC7GNPXNtQbYDCmU9Z1,fbPkOYLVPtPgIt0MxizjfFJov3JbHyAi,6,8,1,0,0,0,2,0,11,1.5714285714285714,1,0.0,0,1,0,0,8,0,0,2,0,1,10,1
3107,166244,Zr7j8ccseRGaMTB9CSbtk2OoktQLUUwZ,fbPkOYLVPtPgIt0MxizjfFJov3JbHyAi,6,3,2,0,2,0,2,0,9,1.2857142857142858,1,0.0,0,2,0,2,3,0,0,2,0,4,5,1
3108,166251,zVoLjf7Wywq3t0MyK9V8JzWR92KniZeU,fbPkOYLVPtPgIt0MxizjfFJov3JbHyAi,8,5,4,0,3,0,2,0,14,2.0,1,0.0,0,4,0,3,5,0,0,2,0,7,7,1
3109,166254,wngLvF30yMtlqza2OIUSM8afhkLgGdV8,fbPkOYLVPtPgIt0MxizjfFJov3JbHyAi,9,5,3,0,2,0,5,0,15,2.142857142857143,1,0.0,0,3,0,2,5,0,0,5,0,5,10,1
3110,166256,uV3c7rC8Ip9ENwSIvLcI3iDJv4HC7nU6,fbPkOYLVPtPgIt0MxizjfFJov3JbHyAi,2,0,0,0,0,0,2,0,2,0.2857142857142857,1,0.0,0,0,0,0,0,0,0,2,0,0,2,1
3111,166265,JiE41HEDLoDarEll7cozPc0WO4mcLeH6,fbPkOYLVPtPgIt0MxizjfFJov3JbHyAi,1,0,0,0,0,0,1,0,1,0.14285714285714285,1,0.0,0,0,0,0,0,0,0,1,0,0,1,1
3112,166266,hyVguxdlO834U7lJnfhtMwTqeljzE8To,fbPkOYLVPtPgIt0MxizjfFJov3JbHyAi,1,0,0,0,0,0,1,0,1,0.14285714285714285,1,0.0,0,0,0,0,0,0,0,1,0,0,1,1
3113,166268,VfDy4viU8b0DxX44uijydrR8w1btSfvR,fbPkOYLVPtPgIt0MxizjfFJov3JbHyAi,9,5,2,0,3,0,4,1,15,2.142857142857143,1,0.0,3,2,0,3,2,0,0,4,1,8,7,1
3114,166269,qAwHClVR46j65q8IKTsxQetmapBK6gNC,fbPkOYLVPtPgIt0MxizjfFJov3JbHyAi,7,3,2,0,2,0,2,0,9,1.2857142857142858,1,0.0,0,2,0,2,3,0,0,2,0,4,5,1
3115,166270,iKJVI2OnWgKnPrc0Q2cfGD7sAkCQTWo1,fbPkOYLVPtPgIt0MxizjfFJov3JbHyAi,3,0,0,0,0,0,3,0,3,0.42857142857142855,1,0.0,0,0,0,0,0,0,0,3,0,0,3,1
3116,166271,lG1PrdMGbnNZVltQvWyOn6wGH1s1gk5W,fbPkOYLVPtPgIt0MxizjfFJov3JbHyAi,1,0,0,0,0,0,1,0,1,0.14285714285714285,1,0.0,0,0,0,0,0,0,0,1,0,0,1,1
3117,166272,HYufVGFQGrizf7sdp2S51f0QPp8O4VIP,fbPkOYLVPtPgIt0MxizjfFJov3JbHyAi,7,3,2,0,2,0,2,0,9,1.2857142857142858,1,0.0,0,2,0,2,3,0,0,2,0,4,5,1
3118,166273,vwF9cLvOjQPJg8J8Y2uNLf6gHvdxzL30,SpATywNh6bZuzm8s1ceuBUnMUAeoAHHw,4,2,1,0,1,0,2,0,6,0.8571428571428571,2,0.0,0,1,0,1,2,0,0,2,0,2,4,1
3119,166289,GQO5pvF9fB0ke4HvwJNUQnKPfOMPwhu0,G8EPVSXsOYB5YQWZGiz1aVq5Pgr2GrQu,36,29,10,68,6,0,1,0,114,16.285714285714285,3,0.0,17,10,45,6,12,0,23,1,0,78,36,1
3120,166295,A9LNHFYBxavFsnHS2U7qtB3ibz5wKw5b,bWdj2GDclj5ofokWjzoa5jAwMkxCykd6,1,0,0,0,0,0,1,0,1,0.14285714285714285,1,0.0,0,0,0,0,0,0,0,1,0,0,1,1
3121,166298,OOJh2Yrr6RQf9QAHFBo7EBzeZ2OAmLfw,A3fsA9Zfv1X2fVEQhTw51lKENdNrEqT3,6,3,2,4,0,0,1,0,10,1.4285714285714286,1,0.0,0,2,4,0,3,0,0,1,0,6,4,1
3122,166311,LFPiiJVIeEKgwmiuE09C3QlUZFR5rtPM,RXDvfPUBYFlVdlueBFbLW0mhhAyGEqpt,14,11,10,0,6,5,4,0,36,5.142857142857143,1,0.0,0,10,0,6,11,5,0,4,0,16,20,1
3123,166339,NkHKP7XmU89AhYrwGvkJ0gX5lfpDGkiJ,SpATywNh6bZuzm8s1ceuBUnMUAeoAHHw,2,0,0,0,0,0,2,0,2,0.2857142857142857,1,0.0,0,0,0,0,0,0,0,2,0,0,2,1
3124,166361,QWw1s7G2LDYzdw5hFh2RBbUqb52YVk7z,G8EPVSXsOYB5YQWZGiz1aVq5Pgr2GrQu,23,36,1,48,2,1,7,0,95,13.571428571428571,1,0.0,19,1,34,2,17,1,14,7,0,56,39,0
3125,166369,s5BonLZqcYCYjyVoBrmolAFZYQqEpVbb,G8EPVSXsOYB5YQWZGiz1aVq5Pgr2GrQu,1,0,0,0,0,0,1,0,1,0.14285714285714285,1,0.0,0,0,0,0,0,0,0,1,0,0,1,0
3126,166379,LWaNb4rILMf9lRML9VmyknZzkoxWoxSQ,A3fsA9Zfv1X2fVEQhTw51lKENdNrEqT3,1,0,0,0,0,0,1,0,1,0.14285714285714285,1,0.0,0,0,0,0,0,0,0,1,0,0,1,1
3127,166384,rmly0YU7hFQRO8wpDGfNQC1vAS0Xq6hn,SpATywNh6bZuzm8s1ceuBUnMUAeoAHHw,14,9,5,7,3,0,2,0,26,3.7142857142857144,1,0.0,3,5,7,3,6,0,0,2,0,18,8,1
3128,166443,FCpDPyaXXEn58dtFe3pQEjUaayUuOg53,SpATywNh6bZuzm8s1ceuBUnMUAeoAHHw,6,4,0,0,0,0,13,0,17,2.4285714285714284,2,0.0,0,0,0,0,4,0,0,13,0,0,17,1
3129,166518,4kW33d8ryobHswayOAbGxV1Ajm5odAVu,A3fsA9Zfv1X2fVEQhTw51lKENdNrEqT3,2,0,0,0,0,0,2,0,2,0.2857142857142857,1,0.0,0,0,0,0,0,0,0,2,0,0,2,1
3130,166524,IOrrTEnPwrStZyNOLFQoK4fs0RpiYPV1,G8EPVSXsOYB5YQWZGiz1aVq5Pgr2GrQu,10,5,2,0,2,8,7,0,24,3.4285714285714284,1,0.0,0,2,0,2,5,8,0,7,0,4,20,1
3131,166548,uMeAc1BFeZrPyaawT7Nx4cOMjZQcepML,RXDvfPUBYFlVdlueBFbLW0mhhAyGEqpt,2,0,0,0,0,0,2,0,2,0.2857142857142857,1,0.0,0,0,0,0,0,0,0,2,0,0,2,1
3132,166552,9NLsBRyvwuJAnXVvkV43elEklDfakfqV,SpATywNh6bZuzm8s1ceuBUnMUAeoAHHw,2,0,0,0,0,0,2,0,2,0.2857142857142857,1,0.0,0,0,0,0,0,0,0,2,0,0,2,1
3133,166568,FkoJ32PRPnjEOGAz921mfwOw4fAtGvO0,SpATywNh6bZuzm8s1ceuBUnMUAeoAHHw,14,17,5,26,3,0,1,0,52,7.428571428571429,1,0.0,10,5,22,3,7,0,4,1,0,40,12,1
3134,166606,uZlOX0cgouu0bXrLq6YA6PRMU30ZaiaI,bWdj2GDclj5ofokWjzoa5jAwMkxCykd6,4,2,1,0,1,0,1,0,5,0.7142857142857143,1,0.0,0,1,0,1,2,0,0,1,0,2,3,1
3135,166633,BiNLDHg34tW2DztH304CnM3NbDxCatLY,bWdj2GDclj5ofokWjzoa5jAwMkxCykd6,7,7,0,26,3,1,6,0,43,6.142857142857143,1,0.0,6,0,24,3,1,1,2,6,0,33,10,1
3136,166639,9Ad0EBsep3vN2c8xQobr7UDwfMqhMFKU,SpATywNh6bZuzm8s1ceuBUnMUAeoAHHw,9,6,5,0,3,0,3,0,17,2.4285714285714284,2,0.0,0,5,0,3,6,0,0,3,0,8,9,0
3137,166748,F4CmkpkMtWFLCelouIUJgiRRRgpQv809,A3fsA9Zfv1X2fVEQhTw51lKENdNrEqT3,1,0,0,0,0,0,1,0,1,0.14285714285714285,1,0.0,0,0,0,0,0,0,0,1,0,0,1,1
3138,166776,mFcnZc9xJHpcsnNSqrnt1TraJ39cAeOG,RXDvfPUBYFlVdlueBFbLW0mhhAyGEqpt,1,0,0,0,0,0,1,0,1,0.14285714285714285,1,0.0,0,0,0,0,0,0,0,1,0,0,1,1
3139,166795,AjRTjBqF69K8qynYqEW0T141KyGuqhS2,A3fsA9Zfv1X2fVEQhTw51lKENdNrEqT3,1,0,0,0,0,0,1,0,1,0.14285714285714285,1,0.0,0,0,0,0,0,0,0,1,0,0,1,1
3140,166823,zhM73YZZY0lktyVnZ4AxEL9UuCvFGPVE,A3fsA9Zfv1X2fVEQhTw51lKENdNrEqT3,9,7,0,0,0,1,9,1,18,2.5714285714285716,1,0.0,0,0,0,0,7,1,0,9,1,0,18,1
3141,166849,MdggzNQQNxgbc1AXVjikoAJPUP3VWCUi,A3fsA9Zfv1X2fVEQhTw51lKENdNrEqT3,5,2,1,0,1,0,2,0,6,0.8571428571428571,1,0.0,0,1,0,1,2,0,0,2,0,2,4,1
3142,166852,WOjJXPk6hpVRJhHaF4hHfePlOcQhWUPY,SpATywNh6bZuzm8s1ceuBUnMUAeoAHHw,8,10,7,0,5,0,2,0,24,3.4285714285714284,2,0.0,0,7,0,5,10,0,0,2,0,12,12,1
3143,166909,bp0wAoMxu88KWfIqaBPqEsMxSHSKb7rw,A3fsA9Zfv1X2fVEQhTw51lKENdNrEqT3,1,0,0,0,0,0,1,0,1,0.14285714285714285,1,0.0,0,0,0,0,0,0,0,1,0,0,1,1
3144,166926,bp0wAoMxu88KWfIqaBPqEsMxSHSKb7rw,RXDvfPUBYFlVdlueBFbLW0mhhAyGEqpt,1,0,0,0,0,0,1,0,1,0.14285714285714285,1,0.0,0,0,0,0,0,0,0,1,0,0,1,1
3145,166933,Uaf2oDHJ8L0D42K5PrmMB0KrT5Tv0JEb,bWdj2GDclj5ofokWjzoa5jAwMkxCykd6,2,0,0,0,0,0,2,0,2,0.2857142857142857,1,0.0,0,0,0,0,0,0,0,2,0,0,2,1
3146,166945,Crt3eVh2fZmwU8n336w6v5vI95DwJSl7,SpATywNh6bZuzm8s1ceuBUnMUAeoAHHw,9,4,3,0,2,2,4,2,17,2.4285714285714284,1,0.0,0,3,0,2,4,2,0,4,2,5,12,1
3147,166952,V52G1wHOq5zd0Up8zjShFJCn7Er4GImu,SpATywNh6bZuzm8s1ceuBUnMUAeoAHHw,3,4,1,0,0,0,2,0,7,1.0,1,0.0,0,1,0,0,4,0,0,2,0,1,6,1
3148,166954,diqtTQE3aIn9EfLQeyH3g1mHmhR3kGFy,SpATywNh6bZuzm8s1ceuBUnMUAeoAHHw,5,3,1,0,1,0,2,0,7,1.0,1,0.0,0,1,0,1,3,0,0,2,0,2,5,1
3149,166982,KsUm63CS66fccBaGn2XmCwaaNmurTIUr,SpATywNh6bZuzm8s1ceuBUnMUAeoAHHw,6,3,1,0,1,0,2,0,7,1.0,1,0.0,0,1,0,1,3,0,0,2,0,2,5,1
3150,166985,KVFLGfkLjESnixIuWE2enCugNN1bDzvq,A3fsA9Zfv1X2fVEQhTw51lKENdNrEqT3,11,11,1,0,0,0,1,0,13,1.8571428571428572,1,0.0,0,1,0,0,11,0,0,1,0,1,12,1
3151,166998,lzb8kR5dRzqO59ncQoQqbKNH1bW2854J,bWdj2GDclj5ofokWjzoa5jAwMkxCykd6,1,0,0,0,0,0,1,0,1,0.14285714285714285,1,0.0,0,0,0,0,0,0,0,1,0,0,1,1
3152,166999,dUop8tAAPSP400w8c2tq4wG1pwOMUqYS,A3fsA9Zfv1X2fVEQhTw51lKENdNrEqT3,7,3,2,0,2,0,6,0,13,1.8571428571428572,1,0.0,0,2,0,2,3,0,0,6,0,4,9,0
3153,167023,JpMQoarOn6JQcf557ZUmfYqpeHPAEtez,A3fsA9Zfv1X2fVEQhTw51lKENdNrEqT3,5,6,2,0,0,0,2,0,10,1.4285714285714286,2,0.0,0,2,0,0,6,0,0,2,0,2,8,1
3154,167056,STjQHRvW81iYlnhczfhr8jnAyuOyD8VG,bWdj2GDclj5ofokWjzoa5jAwMkxCykd6,3,2,0,0,0,0,1,0,3,0.42857142857142855,1,0.0,0,0,0,0,2,0,0,1,0,0,3,1
3155,167063,jWFFw5rdEwwLuLnKwYIpyv4HO3N0mTOS,G8EPVSXsOYB5YQWZGiz1aVq5Pgr2GrQu,7,9,5,0,2,0,3,0,19,2.7142857142857144,1,0.0,0,5,0,2,9,0,0,3,0,7,12,1
3156,167071,eip5MMGOVDSg5Q7RWXlSlAH5Sizgq4mr,G8EPVSXsOYB5YQWZGiz1aVq5Pgr2GrQu,17,14,1,24,1,4,5,1,50,7.142857142857143,1,0.0,3,1,21,1,11,4,3,5,1,26,24,1
3157,167076,OWbwbOuhTRx8Sll5Avvz5AZRO647LCJ4,SpATywNh6bZuzm8s1ceuBUnMUAeoAHHw,1,0,0,0,0,0,1,0,1,0.14285714285714285,1,0.0,0,0,0,0,0,0,0,1,0,0,1,1
3158,167080,OWbwbOuhTRx8Sll5Avvz5AZRO647LCJ4,bWdj2GDclj5ofokWjzoa5jAwMkxCykd6,1,0,0,0,0,0,1,0,1,0.14285714285714285,1,0.0,0,0,0,0,0,0,0,1,0,0,1,1
3159,167094,SoREPWdOHEFnyEXb3M5qgLwqpLSv5EJy,SpATywNh6bZuzm8s1ceuBUnMUAeoAHHw,1,0,0,0,0,0,1,0,1,0.14285714285714285,1,0.0,0,0,0,0,0,0,0,1,0,0,1,1
3160,167098,NuaG3GppxhXVOLv5fu633RlMWR7B08SC,SpATywNh6bZuzm8s1ceuBUnMUAeoAHHw,11,12,8,0,6,3,3,0,32,4.571428571428571,2,0.0,2,8,0,6,10,3,0,3,0,16,16,1
3161,167101,1Z0JbSMoZNTapARGDhipa6UEe1xrZepu,G8EPVSXsOYB5YQWZGiz1aVq5Pgr2GrQu,2,0,0,0,0,0,2,0,2,0.2857142857142857,1,0.0,0,0,0,0,0,0,0,2,0,0,2,1
3162,167115,WAC7RGZ1uYeT92igfYiLgTnHWPEtN2IA,A3fsA9Zfv1X2fVEQhTw51lKENdNrEqT3,5,4,3,0,0,0,1,0,8,1.1428571428571428,2,0.0,0,3,0,0,4,0,0,1,0,3,5,1
3163,167120,woVLVXPiC8hhTnKZW3Z7hk3owLtphTuf,RXDvfPUBYFlVdlueBFbLW0mhhAyGEqpt,16,29,5,0,4,1,5,0,44,6.285714285714286,2,0.0,1,5,0,4,28,1,0,5,0,10,34,1
3164,167137,yxFacYGK53644aEjhoi40V3IIQttQjtF,SpATywNh6bZuzm8s1ceuBUnMUAeoAHHw,10,7,5,0,4,0,4,0,20,2.857142857142857,1,0.0,0,5,0,4,7,0,0,4,0,9,11,1
3165,167157,udF4jwSYeJ58QSIxsDPfAqb9mSqSCjuB,SpATywNh6bZuzm8s1ceuBUnMUAeoAHHw,19,60,3,16,1,6,17,1,104,14.857142857142858,1,0.0,16,3,14,1,44,6,2,17,1,34,70,1
3166,167166,4Mf2EKSJhzPrUZBvK6JSHuGanRWOAS1S,SpATywNh6bZuzm8s1ceuBUnMUAeoAHHw,10,13,8,0,0,0,6,0,27,3.857142857142857,2,0.0,2,8,0,0,11,0,0,6,0,10,17,0
3167,167180,jQg5UakMQRKmdDEXjxxf2nAUZSauWzhl,A3fsA9Zfv1X2fVEQhTw51lKENdNrEqT3,1,0,0,0,0,0,1,0,1,0.14285714285714285,1,0.0,0,0,0,0,0,0,0,1,0,0,1,1
3168,167185,8RHWOUyn5mqf53McvuS18SiueTk2U6y2,bWdj2GDclj5ofokWjzoa5jAwMkxCykd6,1,0,0,0,0,0,1,0,1,0.14285714285714285,1,0.0,0,0,0,0,0,0,0,1,0,0,1,1
3169,167186,8RHWOUyn5mqf53McvuS18SiueTk2U6y2,G8EPVSXsOYB5YQWZGiz1aVq5Pgr2GrQu,1,0,0,0,0,0,1,0,1,0.14285714285714285,1,0.0,0,0,0,0,0,0,0,1,0,0,1,1
3170,167217,j0gxXks7DZitzyeEGG2agLKFp30HqXVu,A3fsA9Zfv1X2fVEQhTw51lKENdNrEqT3,3,3,1,0,0,0,2,0,6,0.8571428571428571,1,0.0,0,1,0,0,3,0,0,2,0,1,5,1
3171,167234,Me95BqnMi7W18LuJ9CGsC9vdXTLZ2e0Y,A3fsA9Zfv1X2fVEQhTw51lKENdNrEqT3,5,2,1,0,1,0,2,0,6,0.8571428571428571,1,0.0,0,1,0,1,2,0,0,2,0,2,4,1
3172,167236,yjqa4N4fhl3Uv2C3tR6TSWjlxDfm3vvM,SpATywNh6bZuzm8s1ceuBUnMUAeoAHHw,1,0,0,0,0,0,1,0,1,0.14285714285714285,1,0.0,0,0,0,0,0,0,0,1,0,0,1,1
3173,167244,Cie8MgBDvC4HVRvuqtFzP8SkWOhgrE8X,SpATywNh6bZuzm8s1ceuBUnMUAeoAHHw,9,4,3,0,2,0,4,0,13,1.8571428571428572,1,0.0,0,3,0,2,4,0,0,4,0,5,8,1
3174,167251,5B2bGhS2BSsBKATjNqdTQPUYoxJcc0Mm,SpATywNh6bZuzm8s1ceuBUnMUAeoAHHw,4,2,0,0,0,0,2,0,4,0.5714285714285714,1,0.0,0,0,0,0,2,0,0,2,0,0,4,1
3175,167256,8BBrs2YJZdMAa1GwaqwG4BfeZccyZZAj,SpATywNh6bZuzm8s1ceuBUnMUAeoAHHw,6,3,1,0,1,0,2,0,7,1.0,1,0.0,0,1,0,1,3,0,0,2,0,2,5,1
3176,167261,Uylyq7LmmNSvSWdWZxt9uRF9NmGdfp0A,bWdj2GDclj5ofokWjzoa5jAwMkxCykd6,1,0,0,0,0,0,1,0,1,0.14285714285714285,1,0.0,0,0,0,0,0,0,0,1,0,0,1,1
3177,167268,srnnzUkIJr2Uisav8LfnV4SnpbNw9CLp,A3fsA9Zfv1X2fVEQhTw51lKENdNrEqT3,36,18,14,50,12,0,4,0,98,14.0,1,0.0,0,14,40,12,18,0,10,4,0,66,32,1
3178,167291,T1pFbYP74kktq7cBESkP625j6elO7EQ5,RXDvfPUBYFlVdlueBFbLW0mhhAyGEqpt,1,0,0,0,0,0,2,0,2,0.2857142857142857,1,0.0,0,0,0,0,0,0,0,2,0,0,2,1
3179,167301,AW6dihJ9WRBecrtuIS74toM8othH6GFu,A3fsA9Zfv1X2fVEQhTw51lKENdNrEqT3,1,0,0,0,0,0,1,0,1,0.14285714285714285,1,0.0,0,0,0,0,0,0,0,1,0,0,1,1
3180,167334,0gocHINf7b8BcvWaTrMFBEJhugD8UJOT,bWdj2GDclj5ofokWjzoa5jAwMkxCykd6,9,9,4,14,3,0,2,0,32,4.571428571428571,1,0.0,1,4,14,3,8,0,0,2,0,22,10,1
3181,167353,mtxEm66XLaiLgrwQ9kSbmVMuiNAGb6i1,G8EPVSXsOYB5YQWZGiz1aVq5Pgr2GrQu,7,4,3,0,1,0,2,0,10,1.4285714285714286,1,0.0,0,3,0,1,4,0,0,2,0,4,6,1
3182,167370,XF1lbfsr5ID8AfWQ0nphBhI7tZhRqdpu,SpATywNh6bZuzm8s1ceuBUnMUAeoAHHw,1,0,0,0,0,0,1,0,1,0.14285714285714285,1,0.0,0,0,0,0,0,0,0,1,0,0,1,1
3183,167371,khelYX1bk51SSadsVaUzKR0zRRNCX0tK,G8EPVSXsOYB5YQWZGiz1aVq5Pgr2GrQu,1,0,0,0,0,0,1,0,1,0.14285714285714285,1,0.0,0,0,0,0,0,0,0,1,0,0,1,1
3184,167376,PYjcXVq1OKher1f36I3CGAnm6VaLRVjt,SpATywNh6bZuzm8s1ceuBUnMUAeoAHHw,8,6,2,0,2,0,10,0,20,2.857142857142857,1,0.0,0,2,0,2,6,0,0,10,0,4,16,1
3185,167393,6HV2PEjNIKCVMQQpYRQLuV1rrZqqecaV,A3fsA9Zfv1X2fVEQhTw51lKENdNrEqT3,4,2,1,0,1,0,1,0,5,0.7142857142857143,1,0.0,0,1,0,1,2,0,0,1,0,2,3,1
3186,167418,IJukBY2O39rtRouJ47sBmIN9gUZZjnWA,G8EPVSXsOYB5YQWZGiz1aVq5Pgr2GrQu,10,8,0,2,0,3,5,1,19,2.7142857142857144,1,0.0,1,0,1,0,7,3,1,5,1,2,17,1
3187,167434,itD4TUoq2Q3TVeq59M2vmGREnVktdivl,SpATywNh6bZuzm8s1ceuBUnMUAeoAHHw,27,63,22,6,10,1,8,0,110,15.714285714285714,1,0.0,17,22,6,10,46,1,0,8,0,55,55,1
3188,167466,DnweC9zfy9ur38RHmjIuaW6oqiFXCgkS,bWdj2GDclj5ofokWjzoa5jAwMkxCykd6,7,8,1,0,0,0,11,1,21,3.0,1,0.0,0,1,0,0,8,0,0,11,1,1,20,1
3189,167472,CetRT5zy2dJHyaPU2zMnW0reXnT8Dv2y,A3fsA9Zfv1X2fVEQhTw51lKENdNrEqT3,2,0,0,0,0,0,2,0,2,0.2857142857142857,1,0.0,0,0,0,0,0,0,0,2,0,0,2,1
3190,167488,vVoYtG2vzUhg3qXoaTM1GNiznwKfFexh,bWdj2GDclj5ofokWjzoa5jAwMkxCykd6,1,0,0,0,0,0,1,0,1,0.14285714285714285,1,0.0,0,0,0,0,0,0,0,1,0,0,1,1
3191,167489,mSYAcGhYeeC24f8F6IWiUOGlXEIiXJkh,SpATywNh6bZuzm8s1ceuBUnMUAeoAHHw,6,4,1,0,1,0,2,0,8,1.1428571428571428,1,0.0,0,1,0,1,4,0,0,2,0,2,6,1
3192,167531,umctuhbIVZDh6EHjPhWargzhNqVIeFMx,A3fsA9Zfv1X2fVEQhTw51lKENdNrEqT3,6,2,1,0,0,0,4,0,7,1.0,1,0.0,0,1,0,0,2,0,0,4,0,1,6,0
3193,167541,Vhkg4eDJgn0Rp70JPNuOdQoUbRDAoXSb,A3fsA9Zfv1X2fVEQhTw51lKENdNrEqT3,1,0,0,0,0,0,1,0,1,0.14285714285714285,1,0.0,0,0,0,0,0,0,0,1,0,0,1,0
3194,167552,E8lMjkJcqZcrPtGwbo8pVkzTRx8M7QkS,bWdj2GDclj5ofokWjzoa5jAwMkxCykd6,1,0,0,0,0,0,1,0,1,0.14285714285714285,1,0.0,0,0,0,0,0,0,0,1,0,0,1,1
3195,167577,eHoAPmcAKzybBYPqIBAsLFgjVfVlCiap,SpATywNh6bZuzm8s1ceuBUnMUAeoAHHw,2,0,0,0,0,0,3,0,3,0.42857142857142855,1,0.0,0,0,0,0,0,0,0,3,0,0,3,1
3196,167624,9qQce5SZ6DqKQeFsRsFiD6wzPO21moby,A3fsA9Zfv1X2fVEQhTw51lKENdNrEqT3,2,0,0,0,0,0,2,0,2,0.2857142857142857,1,0.0,0,0,0,0,0,0,0,2,0,0,2,1
3197,167635,VR79xuyJ7PSmMj6conPf0NxNjdhA8iEp,G8EPVSXsOYB5YQWZGiz1aVq5Pgr2GrQu,7,6,1,0,0,0,2,0,9,1.2857142857142858,1,0.0,0,1,0,0,6,0,0,2,0,1,8,1
3198,167641,JRUKMEmBZ3p5F0JpSVHv1lQEiMQUvro3,A3fsA9Zfv1X2fVEQhTw51lKENdNrEqT3,1,0,0,0,0,0,1,0,1,0.14285714285714285,1,0.0,0,0,0,0,0,0,0,1,0,0,1,1
3199,167655,NLi2kjhCXYFKfB8CCoscLBzBlekXHhro,SpATywNh6bZuzm8s1ceuBUnMUAeoAHHw,8,2,2,0,2,0,3,0,9,1.2857142857142858,1,0.0,0,2,0,2,2,0,0,3,0,4,5,1
3200,167690,ksWipsarCZTS7QX1xkzW3yKB8j25yNgG,bWdj2GDclj5ofokWjzoa5jAwMkxCykd6,4,1,0,0,0,0,3,0,4,0.5714285714285714,1,0.0,0,0,0,0,1,0,0,3,0,0,4,0
3201,167731,wXw48gUOB5BEkScgUyQMzs63eq0ygNDQ,A3fsA9Zfv1X2fVEQhTw51lKENdNrEqT3,2,0,0,0,0,0,2,0,2,0.2857142857142857,1,0.0,0,0,0,0,0,0,0,2,0,0,2,1
3202,167756,9oZb5hKpZvxzCcQaYVLX0TsS9OdCbI4H,bWdj2GDclj5ofokWjzoa5jAwMkxCykd6,8,10,6,0,3,0,6,0,25,3.5714285714285716,2,0.0,0,6,0,3,10,0,0,6,0,9,16,1
3203,167773,dv5Xzy3RizPqbGvGIMXlJIDl0kMrBVlb,A3fsA9Zfv1X2fVEQhTw51lKENdNrEqT3,5,2,1,0,1,0,2,0,6,0.8571428571428571,1,0.0,0,1,0,1,2,0,0,2,0,2,4,1
3204,167779,BWZyBrJDBbkcDEXyE3CSVFoVlT2CRRku,A3fsA9Zfv1X2fVEQhTw51lKENdNrEqT3,6,3,1,0,1,0,7,0,12,1.7142857142857142,1,0.0,0,1,0,1,3,0,0,7,0,2,10,1
3205,167790,qLSi3XQmUN8iJosa2X5FwVvEhgucVA2x,SpATywNh6bZuzm8s1ceuBUnMUAeoAHHw,10,13,3,0,1,0,8,0,25,3.5714285714285716,2,0.0,4,3,0,1,9,0,0,8,0,8,17,0
3206,167796,oxdAxF8oDPK7RK5K5ZEWwiPiTwAbAz6a,A3fsA9Zfv1X2fVEQhTw51lKENdNrEqT3,2,0,0,0,0,0,5,0,5,0.7142857142857143,1,0.0,0,0,0,0,0,0,0,5,0,0,5,1
3207,167797,oxdAxF8oDPK7RK5K5ZEWwiPiTwAbAz6a,bWdj2GDclj5ofokWjzoa5jAwMkxCykd6,1,0,0,0,0,0,1,0,1,0.14285714285714285,1,0.0,0,0,0,0,0,0,0,1,0,0,1,1
3208,169715,Uk2Y8qj9Cf6T7k2O1cxM5Fue4zKTF1K8,fbPkOYLVPtPgIt0MxizjfFJov3JbHyAi,1,0,0,0,0,0,1,0,1,0.14285714285714285,1,0.0,0,0,0,0,0,0,0,1,0,0,1,1
3209,169893,S6HlGgJHN4fE4VtlVBKQWpgIrEWuiqMi,SpATywNh6bZuzm8s1ceuBUnMUAeoAHHw,10,9,5,0,1,6,6,1,28,4.0,1,0.0,2,5,0,1,7,6,0,6,1,8,20,1
3210,170184,JXFir7EgTVcRLR36C3eOl6MVr5FCwAGN,A3fsA9Zfv1X2fVEQhTw51lKENdNrEqT3,15,10,10,0,8,0,3,0,31,4.428571428571429,1,0.0,0,10,0,8,10,0,0,3,0,18,13,1
3211,170268,9IP5FYaoy3mLJ0e4bLrHDIO94Xx0pbLk,SpATywNh6bZuzm8s1ceuBUnMUAeoAHHw,9,15,6,0,0,0,1,0,22,3.142857142857143,1,0.0,0,6,0,0,15,0,0,1,0,6,16,1
3212,170604,npbzydZfydGneeM7kdEFvQEFfvT3OFkh,SpATywNh6bZuzm8s1ceuBUnMUAeoAHHw,1,0,0,0,0,0,1,0,1,0.14285714285714285,1,0.0,0,0,0,0,0,0,0,1,0,0,1,1
3213,172580,WIulMAW8PLfyLvnliYk0w4Xs9IJHKZPS,7GRhBDsirIGkRZBtSMEzNTyDr2JQm4xx,1,0,0,0,0,0,1,0,1,0.14285714285714285,1,0.0,0,0,0,0,0,0,0,1,0,0,1,1
3214,172586,QSTrkUuhSEg0x9wjoRozsXEqzcdQePNj,7GRhBDsirIGkRZBtSMEzNTyDr2JQm4xx,1,0,0,0,0,0,1,0,1,0.14285714285714285,1,0.0,0,0,0,0,0,0,0,1,0,0,1,1
3215,172637,7fwVXF5ctPhb8pPmrNYDi2ycSDGABklq,7GRhBDsirIGkRZBtSMEzNTyDr2JQm4xx,1,0,0,0,0,0,2,0,2,0.2857142857142857,1,0.0,0,0,0,0,0,0,0,2,0,0,2,1
3216,172639,ZkfFwyK1OgVihBxVb6PuDCZttx0mY0GH,7GRhBDsirIGkRZBtSMEzNTyDr2JQm4xx,80,98,1,137,26,9,1,0,272,38.857142857142854,1,0.0,57,1,107,26,41,9,30,1,0,191,81,1
3217,172652,BQrTVd5AOKxfCXQ15n97ruZoGw3X3oOg,7GRhBDsirIGkRZBtSMEzNTyDr2JQm4xx,5,0,0,0,0,0,4,1,5,0.7142857142857143,1,0.0,0,0,0,0,0,0,0,4,1,0,5,1
3218,172653,GXhnYeLJGU7thFAyP76FesLSBQZtYEFj,7GRhBDsirIGkRZBtSMEzNTyDr2JQm4xx,1,0,0,0,0,0,1,0,1,0.14285714285714285,1,0.0,0,0,0,0,0,0,0,1,0,0,1,1
3219,172656,AWe1OrHic5QgI67j2F2SMPIoWgknbRTT,7GRhBDsirIGkRZBtSMEzNTyDr2JQm4xx,1,0,0,0,0,0,1,0,1,0.14285714285714285,1,0.0,0,0,0,0,0,0,0,1,0,0,1,1
3220,172680,bZ3XRxia6UScLuWULOu3ewlnF0TkayUX,7GRhBDsirIGkRZBtSMEzNTyDr2JQm4xx,4,3,1,0,0,0,2,0,6,0.8571428571428571,1,0.0,0,1,0,0,3,0,0,2,0,1,5,1
3221,172686,2umGjyQGiFi0nRyyzYdQU4YlPFMXEUMJ,7GRhBDsirIGkRZBtSMEzNTyDr2JQm4xx,5,2,0,0,0,0,3,0,5,0.7142857142857143,1,0.0,0,0,0,0,2,0,0,3,0,0,5,1
3222,172687,Hofgj6U6Hb3QZslFyBygVjWjwrzFRzS4,7GRhBDsirIGkRZBtSMEzNTyDr2JQm4xx,5,2,1,0,1,0,2,0,6,0.8571428571428571,1,0.0,0,1,0,1,2,0,0,2,0,2,4,1
3223,172698,4K9c4s8wbYa5MpdlPvKSdwuXWOFTVcAh,7GRhBDsirIGkRZBtSMEzNTyDr2JQm4xx,2,0,0,0,0,0,2,0,2,0.2857142857142857,1,0.0,0,0,0,0,0,0,0,2,0,0,2,1
3224,172735,Uxd7sramSgOYbTkMuTemo7Lms4lBJja0,7GRhBDsirIGkRZBtSMEzNTyDr2JQm4xx,33,31,17,0,13,0,6,0,67,9.571428571428571,2,0.0,0,17,0,13,31,0,0,6,0,30,37,1
3225,172741,Y51MqWhaiGyWdNickwBkKEZ7LC7se5uV,7GRhBDsirIGkRZBtSMEzNTyDr2JQm4xx,1,0,0,0,0,0,1,0,1,0.14285714285714285,1,0.0,0,0,0,0,0,0,0,1,0,0,1,1
3226,172746,0dwnge5EOc1G7OI2GIE4cTm6v44kkXQF,7GRhBDsirIGkRZBtSMEzNTyDr2JQm4xx,1,0,0,0,0,0,1,0,1,0.14285714285714285,1,0.0,0,0,0,0,0,0,0,1,0,0,1,1
3227,173107,4Uyhf3xkbmSb7blGg2niZUhegHNb0hzL,RXDvfPUBYFlVdlueBFbLW0mhhAyGEqpt,4,3,1,0,0,0,2,0,6,0.8571428571428571,1,0.0,0,1,0,0,3,0,0,2,0,1,5,1
3228,173132,IiVLoMJOOO6WIlHpWZzTbrIoLgzhhi73,A3fsA9Zfv1X2fVEQhTw51lKENdNrEqT3,22,11,8,16,7,0,5,0,47,6.714285714285714,1,0.0,2,8,13,7,9,0,3,5,0,30,17,1
3229,173146,p9UNvuDUoGgEq49Fv2ZMxggXXq1CzTMu,SpATywNh6bZuzm8s1ceuBUnMUAeoAHHw,6,8,1,0,0,2,7,0,18,2.5714285714285716,1,0.0,0,1,0,0,8,2,0,7,0,1,17,1
3230,173161,3OBHdoV61de7ICMrnWAXr689Eb2AyuN0,bWdj2GDclj5ofokWjzoa5jAwMkxCykd6,7,9,4,0,3,0,6,0,22,3.142857142857143,2,0.0,0,4,0,3,9,0,0,6,0,7,15,1
3231,173169,Q99tY6BQBfoYxTWMIDBzu9lKtLusDydm,SpATywNh6bZuzm8s1ceuBUnMUAeoAHHw,6,0,0,0,0,2,16,4,22,3.142857142857143,2,0.0,0,0,0,0,0,2,0,16,4,0,22,1
3232,173175,hg0Y9I3uepRleBrpQgMC0flFaJC1a5b5,SpATywNh6bZuzm8s1ceuBUnMUAeoAHHw,1,0,0,0,0,0,1,0,1,0.14285714285714285,1,0.0,0,0,0,0,0,0,0,1,0,0,1,1
3233,173216,55qFOvzjFp79P87tCKKcDPlhphK7gh3v,bWdj2GDclj5ofokWjzoa5jAwMkxCykd6,1,0,0,0,0,0,1,0,1,0.14285714285714285,1,0.0,0,0,0,0,0,0,0,1,0,0,1,1
3234,173230,G0Iaa3Ru4yPHix0W4Oym2wsHGEPhwa0d,bWdj2GDclj5ofokWjzoa5jAwMkxCykd6,7,6,1,0,1,0,5,1,14,2.0,1,0.0,2,1,0,1,4,0,0,5,1,4,10,1
3235,173235,eAe5usC174Ujb9GhpQmntkASbUTyc3ZW,SpATywNh6bZuzm8s1ceuBUnMUAeoAHHw,11,9,6,0,4,0,9,0,28,4.0,1,0.0,0,6,0,4,9,0,0,9,0,10,18,1
3236,173249,qggUO4B0NhIPqMhJwgIAZM8ZaIbpr9nE,bWdj2GDclj5ofokWjzoa5jAwMkxCykd6,9,16,10,0,5,0,5,0,36,5.142857142857143,1,0.0,1,10,0,5,15,0,0,5,0,16,20,1
3237,173267,8uSQsFhnhoJeSVZylwMfyqKR37MO9Qyr,RXDvfPUBYFlVdlueBFbLW0mhhAyGEqpt,4,2,1,0,1,0,1,0,5,0.7142857142857143,1,0.0,0,1,0,1,2,0,0,1,0,2,3,1
3238,173269,CVWG6F2iwkhpH91rOg9zh1AtSbOQkfbH,A3fsA9Zfv1X2fVEQhTw51lKENdNrEqT3,2,0,0,0,0,0,4,0,4,0.5714285714285714,1,0.0,0,0,0,0,0,0,0,4,0,0,4,1
3239,173330,l1rg3D8Gp1lv7dbBBYKvzTS3OZ5DRjWH,SpATywNh6bZuzm8s1ceuBUnMUAeoAHHw,1,0,0,0,0,0,1,0,1,0.14285714285714285,1,0.0,0,0,0,0,0,0,0,1,0,0,1,1
3240,173343,b7SUdO6QxE15XMARzgNrelIPh5ZxATAg,SpATywNh6bZuzm8s1ceuBUnMUAeoAHHw,16,20,9,23,4,2,3,1,62,8.857142857142858,1,0.0,7,9,19,4,13,2,4,3,1,39,23,1
3241,173373,1ZxIq2EElt84sjQ7d0VZrg3vpxtlpcZe,A3fsA9Zfv1X2fVEQhTw51lKENdNrEqT3,10,8,4,0,3,0,1,0,16,2.2857142857142856,1,0.0,0,4,0,3,8,0,0,1,0,7,9,0
3242,173395,1rAx2MzCP3OdnS9l4ZxlmSEx7YN3W0Gb,SpATywNh6bZuzm8s1ceuBUnMUAeoAHHw,7,7,1,0,1,0,4,0,13,1.8571428571428572,1,0.0,0,1,0,1,7,0,0,4,0,2,11,1
3243,173427,pZclLMasmWwcOV7UoObjB05HxqI7cJ5M,RXDvfPUBYFlVdlueBFbLW0mhhAyGEqpt,1,0,0,0,0,0,1,0,1,0.14285714285714285,1,0.0,0,0,0,0,0,0,0,1,0,0,1,1
3244,173429,pZclLMasmWwcOV7UoObjB05HxqI7cJ5M,A3fsA9Zfv1X2fVEQhTw51lKENdNrEqT3,1,0,0,0,0,0,1,0,1,0.14285714285714285,1,0.0,0,0,0,0,0,0,0,1,0,0,1,1
3245,173441,jQV5ACK38puVA98RZWJrb2Gyr0Mic373,SpATywNh6bZuzm8s1ceuBUnMUAeoAHHw,20,24,10,0,8,4,5,1,52,7.428571428571429,1,0.0,12,10,0,8,12,4,0,5,1,30,22,1
3246,173462,l1rg3D8Gp1lv7dbBBYKvzTS3OZ5DRjWH,RXDvfPUBYFlVdlueBFbLW0mhhAyGEqpt,1,0,0,0,0,0,1,0,1,0.14285714285714285,1,0.0,0,0,0,0,0,0,0,1,0,0,1,1
3247,173471,zvLkVcjFtCYyIxQ5AgxEHNEKFJjc1e0w,SpATywNh6bZuzm8s1ceuBUnMUAeoAHHw,4,1,1,0,0,0,2,0,4,0.5714285714285714,1,0.0,0,1,0,0,1,0,0,2,0,1,3,1
3248,173480,z3ey1NJRJhuGG3iwCXYitfKXJ1Ty9TFL,bWdj2GDclj5ofokWjzoa5jAwMkxCykd6,6,4,1,0,0,0,5,0,10,1.4285714285714286,2,0.0,1,1,0,0,3,0,0,5,0,2,8,1
3249,173551,VfzK5aO28OrAOvVXtOq353z79D2I5ZHx,SpATywNh6bZuzm8s1ceuBUnMUAeoAHHw,22,27,15,0,9,9,11,0,71,10.142857142857142,2,0.0,8,15,0,9,19,9,0,11,0,32,39,0
3250,173569,pPWrFxlyBbGTjAYm5iDIHfNugNgnbATN,G8EPVSXsOYB5YQWZGiz1aVq5Pgr2GrQu,32,34,18,74,9,12,10,1,158,22.571428571428573,1,0.0,12,18,62,9,22,12,12,10,1,101,57,1
3251,173570,5tgxttwTGvGdqr8cj2QgTLRxUmP4TAY4,SpATywNh6bZuzm8s1ceuBUnMUAeoAHHw,8,10,5,0,2,0,6,1,24,3.4285714285714284,1,0.0,2,5,0,2,8,0,0,6,1,9,15,1
3252,173576,5s2QZF0oRCYI8h2ElmgC6T7pH2gEDZ5h,SpATywNh6bZuzm8s1ceuBUnMUAeoAHHw,1,0,0,0,0,0,1,0,1,0.14285714285714285,1,0.0,0,0,0,0,0,0,0,1,0,0,1,1
3253,173606,5uCuxLE5XjM4y4nmjuWckCuNM8tm7Xz4,SpATywNh6bZuzm8s1ceuBUnMUAeoAHHw,3,2,0,0,0,0,1,0,3,0.42857142857142855,1,0.0,0,0,0,0,2,0,0,1,0,0,3,1
3254,173625,InWzQofmWk3UUIO2mLGTDK9j8XVQqQav,SpATywNh6bZuzm8s1ceuBUnMUAeoAHHw,1,0,0,0,0,0,1,0,1,0.14285714285714285,1,0.0,0,0,0,0,0,0,0,1,0,0,1,1
3255,173652,dzkU7a9rkvja83jr7hi3MLZJCXGqFq8k,bWdj2GDclj5ofokWjzoa5jAwMkxCykd6,4,2,0,0,0,0,2,0,4,0.5714285714285714,1,0.0,0,0,0,0,2,0,0,2,0,0,4,1
3256,173655,QfXTKSibNslqH18MyW3petQKWGiJxDlu,SpATywNh6bZuzm8s1ceuBUnMUAeoAHHw,5,10,4,0,0,0,2,0,16,2.2857142857142856,1,0.0,5,4,0,0,5,0,0,2,0,9,7,1
3257,173659,Lip64fuGzBG9bHRLCDw8nCt2gpYw3z1x,SpATywNh6bZuzm8s1ceuBUnMUAeoAHHw,4,2,1,0,1,0,1,0,5,0.7142857142857143,1,0.0,0,1,0,1,2,0,0,1,0,2,3,1
3258,173670,QqiwZUOB51djz0tMukIyFdlQb4Z6iwAX,SpATywNh6bZuzm8s1ceuBUnMUAeoAHHw,7,2,1,0,1,0,4,0,8,1.1428571428571428,1,0.0,0,1,0,1,2,0,0,4,0,2,6,1
3259,173672,vJ4UKNeuK5ggw4DX9ClwnqNtdiFYCRPF,G8EPVSXsOYB5YQWZGiz1aVq5Pgr2GrQu,1,0,0,0,0,0,1,0,1,0.14285714285714285,1,0.0,0,0,0,0,0,0,0,1,0,0,1,1
3260,173679,NN4GiQISIB9GdLTS8U7HRzfPuCQVrfY9,SpATywNh6bZuzm8s1ceuBUnMUAeoAHHw,16,15,5,34,2,2,7,0,65,9.285714285714286,1,0.0,9,5,31,2,6,2,3,7,0,47,18,1
3261,173694,g2VgGARpgGy9rA8aDCffqfXvItMu95Qi,SpATywNh6bZuzm8s1ceuBUnMUAeoAHHw,1,0,0,0,0,0,1,0,1,0.14285714285714285,1,0.0,0,0,0,0,0,0,0,1,0,0,1,1
3262,173748,wymqx0ld7yvIDGrfVTrgZliVZU4YCmE4,G8EPVSXsOYB5YQWZGiz1aVq5Pgr2GrQu,6,5,0,0,0,0,2,0,7,1.0,1,0.0,0,0,0,0,5,0,0,2,0,0,7,1
3263,173803,rZWsxN7JeP5OFYbUn0RS9NxjY5ZERM0R,bWdj2GDclj5ofokWjzoa5jAwMkxCykd6,5,2,1,0,1,0,3,0,7,1.0,2,0.0,0,1,0,1,2,0,0,3,0,2,5,1
3264,173854,quIYM1jY47tlZKkC1EmJRDFcBV4a3Pzy,A3fsA9Zfv1X2fVEQhTw51lKENdNrEqT3,1,0,0,0,0,0,1,0,1,0.14285714285714285,1,0.0,0,0,0,0,0,0,0,1,0,0,1,1
3265,173859,pPZkiQmDPKqQ9IZ0jTf8ExIfHdZSz9Tp,bWdj2GDclj5ofokWjzoa5jAwMkxCykd6,1,0,0,0,0,0,1,0,1,0.14285714285714285,1,0.0,0,0,0,0,0,0,0,1,0,0,1,1
3266,173869,oc7rYZFgg4c4rgCWuUOquFZJ5FqnUHSF,bWdj2GDclj5ofokWjzoa5jAwMkxCykd6,6,7,1,0,1,0,3,0,12,1.7142857142857142,1,0.0,1,1,0,1,6,0,0,3,0,3,9,1
3267,173872,Wx0PLmR8YQAVeoFy76pJe5bN12QOsMrr,A3fsA9Zfv1X2fVEQhTw51lKENdNrEqT3,3,5,0,0,0,0,1,0,6,0.8571428571428571,1,0.0,0,0,0,0,5,0,0,1,0,0,6,1
3268,173880,worFKZrD9eECXAuz5EQKtbbV0K7MG3Jl,A3fsA9Zfv1X2fVEQhTw51lKENdNrEqT3,5,2,1,0,1,0,2,0,6,0.8571428571428571,1,0.0,0,1,0,1,2,0,0,2,0,2,4,1
3269,173918,dr13KuqOo10EJH5V4oOgMy17ewEUhD7o,SpATywNh6bZuzm8s1ceuBUnMUAeoAHHw,3,2,1,0,0,0,1,0,4,0.5714285714285714,1,0.0,0,1,0,0,2,0,0,1,0,1,3,1
3270,173934,WI9rk8aS11tBAJzjcX0JSIgomYYRQVjW,RXDvfPUBYFlVdlueBFbLW0mhhAyGEqpt,7,4,1,0,1,0,2,0,8,1.1428571428571428,1,0.0,0,1,0,1,4,0,0,2,0,2,6,0
3271,173958,wLc4w0avBex1xIgZCkms6IVr5BNBkA7D,bWdj2GDclj5ofokWjzoa5jAwMkxCykd6,1,0,0,0,0,0,1,0,1,0.14285714285714285,1,0.0,0,0,0,0,0,0,0,1,0,0,1,1
3272,173959,wLc4w0avBex1xIgZCkms6IVr5BNBkA7D,G8EPVSXsOYB5YQWZGiz1aVq5Pgr2GrQu,1,0,0,0,0,0,1,0,1,0.14285714285714285,1,0.0,0,0,0,0,0,0,0,1,0,0,1,1
3273,174032,WLXtV9xU02TWrBcV5JQ79YomKzdOBWBA,RXDvfPUBYFlVdlueBFbLW0mhhAyGEqpt,4,4,2,0,0,0,1,0,7,1.0,1,0.0,0,2,0,0,4,0,0,1,0,2,5,1
3274,174046,DXGwefPqbHu4FBeaKolUD6Ln1C2rCmyf,G8EPVSXsOYB5YQWZGiz1aVq5Pgr2GrQu,25,31,11,40,6,1,10,4,103,14.714285714285714,1,0.0,9,11,30,6,22,1,10,10,4,56,47,0
3275,174049,8X2IzVay8QcdAEdyXNzTeeH0ARyTPIC0,SpATywNh6bZuzm8s1ceuBUnMUAeoAHHw,6,8,3,0,4,0,1,0,16,2.2857142857142856,1,0.0,0,3,0,4,8,0,0,1,0,7,9,0
3276,174052,WXV25nLp7cw3t4qC0Fe3ygibuK55tgf8,G8EPVSXsOYB5YQWZGiz1aVq5Pgr2GrQu,2,0,0,0,0,0,2,0,2,0.2857142857142857,1,0.0,0,0,0,0,0,0,0,2,0,0,2,1
3277,174082,Q3T5Pj9Os86NEqSmgUZNRoi8BUkSoDlj,A3fsA9Zfv1X2fVEQhTw51lKENdNrEqT3,1,0,0,0,0,0,3,0,3,0.42857142857142855,1,0.0,0,0,0,0,0,0,0,3,0,0,3,1
3278,174116,89IraAtUfhoGAQgzdMP1844g2s2iN4Ox,SpATywNh6bZuzm8s1ceuBUnMUAeoAHHw,1,0,0,0,0,0,1,0,1,0.14285714285714285,1,0.0,0,0,0,0,0,0,0,1,0,0,1,1
3279,174121,y0CnonzJAddQ4oYr5LBSP0Y6KP3RgPGg,A3fsA9Zfv1X2fVEQhTw51lKENdNrEqT3,4,2,1,0,1,0,2,0,6,0.8571428571428571,1,0.0,0,1,0,1,2,0,0,2,0,2,4,1
3280,174126,TmcXoxCT48jZhYzJE3XlHytbzJ2TbpDY,A3fsA9Zfv1X2fVEQhTw51lKENdNrEqT3,7,4,2,6,0,0,3,0,15,2.142857142857143,1,0.0,0,2,5,0,4,0,1,3,0,7,8,1
3281,174151,CYfp5XD3W4sJRVjPRPe04xpN1AZbw9Yo,A3fsA9Zfv1X2fVEQhTw51lKENdNrEqT3,2,0,0,0,0,0,3,0,3,0.42857142857142855,1,0.0,0,0,0,0,0,0,0,3,0,0,3,1
3282,174168,y4jCbRq0ZMCabQVeAWisCVju9AF82joj,SpATywNh6bZuzm8s1ceuBUnMUAeoAHHw,10,24,1,21,0,3,4,0,53,7.571428571428571,1,0.0,16,1,20,0,8,3,1,4,0,37,16,1
3283,174181,lfpXyXNaegoXeiZXYzm52nn3ZFsKBMvI,SpATywNh6bZuzm8s1ceuBUnMUAeoAHHw,10,12,8,0,5,0,5,0,30,4.285714285714286,2,0.0,1,8,0,5,11,0,0,5,0,14,16,1
3284,174187,j7bASIUMnf4CT11rRWorZg0FZhBTc03O,A3fsA9Zfv1X2fVEQhTw51lKENdNrEqT3,14,8,6,0,6,1,5,1,27,3.857142857142857,1,0.0,0,6,0,6,8,1,0,5,1,12,15,1
3285,174206,8MuGb55gUM18pukCITXgZoTSobqXs9G4,RXDvfPUBYFlVdlueBFbLW0mhhAyGEqpt,1,0,0,0,0,0,2,0,2,0.2857142857142857,2,0.0,0,0,0,0,0,0,0,2,0,0,2,1
3286,174234,Dl6PswZ2ZYiCfnhIcCRn4UIAM0nQUpoC,G8EPVSXsOYB5YQWZGiz1aVq5Pgr2GrQu,3,2,0,0,0,0,1,0,3,0.42857142857142855,1,0.0,0,0,0,0,2,0,0,1,0,0,3,1
3287,174256,lb2vEQsRSFOUOLUPsaKbebc6S33mhh7Z,SpATywNh6bZuzm8s1ceuBUnMUAeoAHHw,2,0,0,0,0,0,2,0,2,0.2857142857142857,1,0.0,0,0,0,0,0,0,0,2,0,0,2,0
3288,174274,xzqF2LiZ7Zp1COlqOBger1kuvNL9t5JK,SpATywNh6bZuzm8s1ceuBUnMUAeoAHHw,1,0,0,0,0,0,1,0,1,0.14285714285714285,1,0.0,0,0,0,0,0,0,0,1,0,0,1,1
3289,174277,GQaFlkVp1r2Jb2YbiuWBbDDwc8QpDAHv,SpATywNh6bZuzm8s1ceuBUnMUAeoAHHw,9,8,6,0,3,2,1,0,20,2.857142857142857,1,0.0,0,6,0,3,8,2,0,1,0,9,11,1
3290,174290,m2ZLzpDl6tgvDR1yy6DPvftlSHnPZA0w,SpATywNh6bZuzm8s1ceuBUnMUAeoAHHw,1,0,0,0,0,0,1,0,1,0.14285714285714285,1,0.0,0,0,0,0,0,0,0,1,0,0,1,1
3291,174293,ZikrDKT0jI7fYxhfVuJrd7XXP7MsQajU,RXDvfPUBYFlVdlueBFbLW0mhhAyGEqpt,7,2,1,0,1,0,4,0,8,1.1428571428571428,1,0.0,0,1,0,1,2,0,0,4,0,2,6,1
3292,174301,m03K9KziYA4aijvIDRK7t2E4lIAdgRz2,RXDvfPUBYFlVdlueBFbLW0mhhAyGEqpt,4,2,1,0,1,0,1,0,5,0.7142857142857143,2,0.0,0,1,0,1,2,0,0,1,0,2,3,1
3293,174365,TDTdTCIURzk1Bl0eZfd6udEe9QlGGMaa,SpATywNh6bZuzm8s1ceuBUnMUAeoAHHw,1,0,0,0,0,0,1,0,1,0.14285714285714285,1,0.0,0,0,0,0,0,0,0,1,0,0,1,1
3294,174377,BeoWdDFNsVFqWVq3B4qjYh8vNjNTgwSB,bWdj2GDclj5ofokWjzoa5jAwMkxCykd6,6,3,2,0,0,0,8,0,13,1.8571428571428572,1,0.0,0,2,0,0,3,0,0,8,0,2,11,1
3295,174421,mSZYyfRNnqnDs7qyuaQEMEvx5vC2JS4M,A3fsA9Zfv1X2fVEQhTw51lKENdNrEqT3,3,2,0,0,0,0,1,0,3,0.42857142857142855,1,0.0,0,0,0,0,2,0,0,1,0,0,3,0
3296,174440,0t4jRqsyu2b51z09AohkTBv9a8OIUmuF,SpATywNh6bZuzm8s1ceuBUnMUAeoAHHw,2,0,0,0,0,0,2,0,2,0.2857142857142857,1,0.0,0,0,0,0,0,0,0,2,0,0,2,1
3297,174455,SjtyUL4RbrEJ36TmtDDzIzVYsveRIJ1b,bWdj2GDclj5ofokWjzoa5jAwMkxCykd6,4,2,0,0,0,0,2,0,4,0.5714285714285714,1,0.0,0,0,0,0,2,0,0,2,0,0,4,1
3298,174467,vnBONRqvzvm1KY9GmYXYArKs5stTyMmI,SpATywNh6bZuzm8s1ceuBUnMUAeoAHHw,20,13,7,16,4,2,9,5,56,8.0,1,0.0,4,7,13,4,9,2,3,9,5,28,28,0
3299,174478,EhHrinjt1AkEWC09AFZwBuP61S5NJgjn,SpATywNh6bZuzm8s1ceuBUnMUAeoAHHw,9,5,2,17,0,0,3,0,27,3.857142857142857,1,0.0,2,2,14,0,3,0,3,3,0,18,9,0
3300,174493,4G31JkuuWxQoMwYLKWmTZsOhrqR0raRg,SpATywNh6bZuzm8s1ceuBUnMUAeoAHHw,6,3,1,0,1,0,2,0,7,1.0,1,0.0,0,1,0,1,3,0,0,2,0,2,5,1
3301,174498,ZKJhytrxdXS5RaM2M9yN55tRum5T67Xk,SpATywNh6bZuzm8s1ceuBUnMUAeoAHHw,14,12,2,15,1,1,2,0,33,4.714285714285714,1,0.0,2,2,14,1,10,1,1,2,0,19,14,1
3302,174499,mBTzaYN6U4cNwjdbd3oK6uaVLfiAM7NK,G8EPVSXsOYB5YQWZGiz1aVq5Pgr2GrQu,7,4,1,0,2,0,2,0,9,1.2857142857142858,1,0.0,0,1,0,2,4,0,0,2,0,3,6,1
3303,174506,uHZhFUoOlSaoYs0uE4nLbnPxUYbY0Yrk,SpATywNh6bZuzm8s1ceuBUnMUAeoAHHw,4,2,1,0,1,0,1,0,5,0.7142857142857143,1,0.0,0,1,0,1,2,0,0,1,0,2,3,1
3304,174510,1JwhB7sCpqQuMWgVLCoQdnUSus34sW5p,SpATywNh6bZuzm8s1ceuBUnMUAeoAHHw,5,5,0,0,0,0,2,0,7,1.0,1,0.0,2,0,0,0,3,0,0,2,0,2,5,1
3305,174545,ghkFruWSKEsLlDR9iiyligX2yJuxgpBc,bWdj2GDclj5ofokWjzoa5jAwMkxCykd6,2,0,0,0,0,0,3,0,3,0.42857142857142855,1,0.0,0,0,0,0,0,0,0,3,0,0,3,1
3306,174581,SKmQOLoApKRqa0N0zki38NHNgkClkW5s,SpATywNh6bZuzm8s1ceuBUnMUAeoAHHw,1,0,0,0,0,0,1,0,1,0.14285714285714285,1,0.0,0,0,0,0,0,0,0,1,0,0,1,1
3307,174607,zbOrtc172Sp0ZiF8CTU6kMNb51nYxkNM,SpATywNh6bZuzm8s1ceuBUnMUAeoAHHw,7,3,2,0,2,0,2,0,9,1.2857142857142858,1,0.0,0,2,0,2,3,0,0,2,0,4,5,1
3308,174618,364stkhSwXjUJtELSEaOhKFcZM4gOjC8,SpATywNh6bZuzm8s1ceuBUnMUAeoAHHw,1,0,0,0,0,0,1,0,1,0.14285714285714285,1,0.0,0,0,0,0,0,0,0,1,0,0,1,1
3309,174665,6WpUAvOn0104PVGU1qRupfdkikcVBl8O,bWdj2GDclj5ofokWjzoa5jAwMkxCykd6,3,3,2,0,0,0,1,0,6,0.8571428571428571,1,0.0,0,2,0,0,3,0,0,1,0,2,4,1
3310,174692,xMCJ7gcgv1mN5rb4Qh9dpQVUc9zQ1NLX,SpATywNh6bZuzm8s1ceuBUnMUAeoAHHw,3,2,1,0,0,0,1,0,4,0.5714285714285714,1,0.0,0,1,0,0,2,0,0,1,0,1,3,1
3311,174699,Qn3OccgDXQpcut9yLA9jXfau6FPbS72n,G8EPVSXsOYB5YQWZGiz1aVq5Pgr2GrQu,1,0,0,0,0,0,2,0,2,0.2857142857142857,1,0.0,0,0,0,0,0,0,0,2,0,0,2,1
3312,174703,Nu3CWEbOlEVCvqetIYQvBCpTSFLSYvQK,SpATywNh6bZuzm8s1ceuBUnMUAeoAHHw,21,49,1,17,1,10,17,2,97,13.857142857142858,2,0.0,6,1,14,1,43,10,3,17,2,22,75,1
3313,174704,ExNrdfeKsdYl3xmpiJlCBa13JPKyssuX,bWdj2GDclj5ofokWjzoa5jAwMkxCykd6,1,0,0,0,0,0,1,0,1,0.14285714285714285,1,0.0,0,0,0,0,0,0,0,1,0,0,1,1
3314,174718,Bos3zEEnAcYzPXQktMkJJ0ak5mhGWCAf,RXDvfPUBYFlVdlueBFbLW0mhhAyGEqpt,6,7,3,0,0,0,2,0,12,1.7142857142857142,1,0.0,1,3,0,0,6,0,0,2,0,4,8,1
3315,174776,Cx0tee2LW48hN6gexDH5QIypELm3snyx,SpATywNh6bZuzm8s1ceuBUnMUAeoAHHw,10,8,5,0,2,3,8,2,28,4.0,1,0.0,0,5,0,2,8,3,0,8,2,7,21,1
3316,174782,lJdTg9WUYwumFfeQmhmLXhBEAFP0NsAi,bWdj2GDclj5ofokWjzoa5jAwMkxCykd6,5,2,1,0,1,0,2,0,6,0.8571428571428571,1,0.0,0,1,0,1,2,0,0,2,0,2,4,1
3317,174791,KOAZzInqWpDIVXEW7JyQaWggITRPncK9,SpATywNh6bZuzm8s1ceuBUnMUAeoAHHw,1,0,0,0,0,0,1,0,1,0.14285714285714285,1,0.0,0,0,0,0,0,0,0,1,0,0,1,1
3318,174810,f3LuhvFBRGY0JOGlDxTNaj2JOJbt7lLA,SpATywNh6bZuzm8s1ceuBUnMUAeoAHHw,6,2,1,0,1,0,3,0,7,1.0,1,0.0,0,1,0,1,2,0,0,3,0,2,5,0
3319,174820,JIZNiH5rUr2fGUoXZgKLocS74nHb5Kfe,SpATywNh6bZuzm8s1ceuBUnMUAeoAHHw,7,2,1,0,1,2,5,0,11,1.5714285714285714,1,0.0,0,1,0,1,2,2,0,5,0,2,9,1
3320,174878,fUQHFT4QEMRSPqJAQlXlvlyNwca9Q0dU,RXDvfPUBYFlVdlueBFbLW0mhhAyGEqpt,10,6,1,10,1,0,1,0,19,2.7142857142857144,1,0.0,1,1,9,1,5,0,1,1,0,12,7,1
3321,174885,wRvAUuJF3e8pqF4oxebNspXV7iBtMI7e,SpATywNh6bZuzm8s1ceuBUnMUAeoAHHw,1,0,0,0,0,0,1,0,1,0.14285714285714285,1,0.0,0,0,0,0,0,0,0,1,0,0,1,1
3322,174949,YXkiTHpE2a6E2kDFUh3HT5sKHSlA7gXq,bWdj2GDclj5ofokWjzoa5jAwMkxCykd6,16,16,7,0,7,0,2,0,32,4.571428571428571,1,0.0,8,7,0,7,8,0,0,2,0,22,10,1
3323,174969,KNwOU3S87AmXfVT27bvvRv8ipePthXCY,SpATywNh6bZuzm8s1ceuBUnMUAeoAHHw,11,21,1,13,0,1,2,0,38,5.428571428571429,1,0.0,15,1,10,0,6,1,3,2,0,26,12,1
3324,174982,0MmlbOf0DHxRZhBoMcyjh2941ezon8FA,SpATywNh6bZuzm8s1ceuBUnMUAeoAHHw,7,6,3,0,2,0,1,0,12,1.7142857142857142,1,0.0,0,3,0,2,6,0,0,1,0,5,7,1
3325,174991,UGNnaAmmHc9OFVaFlHMVxlDwTqvJ9WLn,bWdj2GDclj5ofokWjzoa5jAwMkxCykd6,1,0,0,0,0,0,1,0,1,0.14285714285714285,1,0.0,0,0,0,0,0,0,0,1,0,0,1,1
3326,175009,bd7vHnljHgvVUg5G5sT2JbyZM9wuH2wF,SpATywNh6bZuzm8s1ceuBUnMUAeoAHHw,4,10,0,0,0,0,1,0,11,1.5714285714285714,1,0.0,2,0,0,0,8,0,0,1,0,2,9,1
3327,175021,cpZrl3oP8x5CfyDGz9KAwfLq9wo2kZMm,RXDvfPUBYFlVdlueBFbLW0mhhAyGEqpt,23,32,11,44,7,0,8,0,102,14.571428571428571,1,0.0,12,11,39,7,20,0,5,8,0,69,33,1
3328,175028,RHEMdhoy3TVz84IqO3CiO0ZVmx7sjl4N,bWdj2GDclj5ofokWjzoa5jAwMkxCykd6,4,2,1,0,1,0,2,0,6,0.8571428571428571,1,0.0,0,1,0,1,2,0,0,2,0,2,4,1
3329,175037,Y3qAwvAkfEroY8Y6AzBfazMCosAJgRZ3,SpATywNh6bZuzm8s1ceuBUnMUAeoAHHw,6,2,1,0,1,0,3,0,7,1.0,1,0.0,0,1,0,1,2,0,0,3,0,2,5,1
3330,175057,WoXtpP4H4ghgkRBv3UuiyrHP7GFAl55y,bWdj2GDclj5ofokWjzoa5jAwMkxCykd6,1,0,0,0,0,0,1,0,1,0.14285714285714285,1,0.0,0,0,0,0,0,0,0,1,0,0,1,1
3331,175069,4TvXiLQVsUU0sQ96NFZAreKy5tMXycWg,SpATywNh6bZuzm8s1ceuBUnMUAeoAHHw,4,2,0,0,0,0,2,0,4,0.5714285714285714,1,0.0,0,0,0,0,2,0,0,2,0,0,4,1
3332,175071,SP5kRtjsDOoGpzdvGCfZdzeWgxpoSNBK,G8EPVSXsOYB5YQWZGiz1aVq5Pgr2GrQu,1,0,0,0,0,0,2,0,2,0.2857142857142857,1,0.0,0,0,0,0,0,0,0,2,0,0,2,1
3333,175118,azb7CJ1Bmhkt4qbwHzuZGxEpJ1dCkFJu,G8EPVSXsOYB5YQWZGiz1aVq5Pgr2GrQu,5,2,1,0,1,0,3,0,7,1.0,1,0.0,0,1,0,1,2,0,0,3,0,2,5,1
3334,175132,0Vpaa5lAyqNTaFltvCAV7J9K7ZDbZPNf,SpATywNh6bZuzm8s1ceuBUnMUAeoAHHw,2,0,0,0,0,0,2,0,2,0.2857142857142857,1,0.0,0,0,0,0,0,0,0,2,0,0,2,1
3335,175152,WAC7RGZ1uYeT92igfYiLgTnHWPEtN2IA,bWdj2GDclj5ofokWjzoa5jAwMkxCykd6,4,2,1,0,1,0,1,0,5,0.7142857142857143,1,0.0,0,1,0,1,2,0,0,1,0,2,3,1
3336,175196,rtg3Ki4vk14kI9MkEBE0pkOCAO2AnCnU,bWdj2GDclj5ofokWjzoa5jAwMkxCykd6,5,6,3,0,0,0,3,0,12,1.7142857142857142,1,0.0,0,3,0,0,6,0,0,3,0,3,9,1
3337,175206,cl2EKvvSJRHCOKFRMNWxvwP24f0kGb0G,SpATywNh6bZuzm8s1ceuBUnMUAeoAHHw,1,0,0,0,0,0,1,0,1,0.14285714285714285,1,0.0,0,0,0,0,0,0,0,1,0,0,1,1
3338,175238,lPm1TSKMUQ7eGKQEhVdTw2Bwzsvcola7,SpATywNh6bZuzm8s1ceuBUnMUAeoAHHw,1,0,0,0,0,0,1,0,1,0.14285714285714285,1,0.0,0,0,0,0,0,0,0,1,0,0,1,1
3339,175246,kaNpWuIxNLxZkDfmjMzrYRVzuOgwIf0o,SpATywNh6bZuzm8s1ceuBUnMUAeoAHHw,1,0,0,0,0,0,2,0,2,0.2857142857142857,2,0.0,0,0,0,0,0,0,0,2,0,0,2,1
3340,175260,w2E5tS0N7MCQaF7A3ASAFp8VmrqDhyey,SpATywNh6bZuzm8s1ceuBUnMUAeoAHHw,14,8,6,0,5,0,3,0,22,3.142857142857143,2,0.0,0,6,0,5,8,0,0,3,0,11,11,1
3341,175267,gkFOg5eTAnAUv8n8zVKmC9VjpOwrpc30,SpATywNh6bZuzm8s1ceuBUnMUAeoAHHw,9,6,2,0,1,1,15,1,26,3.7142857142857144,2,0.0,0,2,0,1,6,1,0,15,1,3,23,1
3342,175312,RdEm3Fs8S0aOIDZ4Rs9JfR67o5xMZbr0,G8EPVSXsOYB5YQWZGiz1aVq5Pgr2GrQu,5,3,1,0,1,0,4,0,9,1.2857142857142858,1,0.0,0,1,0,1,3,0,0,4,0,2,7,1
3343,175343,GBFE5Y91W0Tc0xOvCqFBzxsDNroDv8Is,SpATywNh6bZuzm8s1ceuBUnMUAeoAHHw,2,0,0,0,0,0,2,0,2,0.2857142857142857,1,0.0,0,0,0,0,0,0,0,2,0,0,2,1
3344,175368,gs6GqCtB6XgQ6UWjy1alecSfvRxFU0T2,SpATywNh6bZuzm8s1ceuBUnMUAeoAHHw,2,0,0,0,0,0,2,0,2,0.2857142857142857,1,0.0,0,0,0,0,0,0,0,2,0,0,2,1
3345,175379,9WmzxyamLAgd2LnrO6zydiN7WV3MNZZt,bWdj2GDclj5ofokWjzoa5jAwMkxCykd6,5,4,3,0,1,0,2,0,10,1.4285714285714286,1,0.0,0,3,0,1,4,0,0,2,0,4,6,1
3346,175405,VpSqFaUAI6VHKIVES1nyHNkouDYoubbm,SpATywNh6bZuzm8s1ceuBUnMUAeoAHHw,9,6,1,0,1,0,3,0,11,1.5714285714285714,1,0.0,1,1,0,1,5,0,0,3,0,3,8,1
3347,175407,wcdy3oa7dAkP6qisbcdJvc8HycOW6ePt,SpATywNh6bZuzm8s1ceuBUnMUAeoAHHw,3,0,0,0,0,0,3,0,3,0.42857142857142855,1,0.0,0,0,0,0,0,0,0,3,0,0,3,1
3348,175423,JLpYHpRsamf04qcVxCPYwLYYhT8v6H5r,bWdj2GDclj5ofokWjzoa5jAwMkxCykd6,8,6,4,0,3,0,4,0,17,2.4285714285714284,1,0.0,0,4,0,3,6,0,0,4,0,7,10,1
3349,176353,4bOUwTkieqMfvbCbKosegaSfDeZ15GKM,fbPkOYLVPtPgIt0MxizjfFJov3JbHyAi,1,0,0,0,0,0,1,0,1,0.14285714285714285,1,0.0,0,0,0,0,0,0,0,1,0,0,1,1
3350,176354,3dMiR0LoABiSpQX4JYFVOM3r1eOr65HJ,fbPkOYLVPtPgIt0MxizjfFJov3JbHyAi,5,3,1,0,1,0,2,0,7,1.0,1,0.0,0,1,0,1,3,0,0,2,0,2,5,1
3351,176356,LKippngJk3cGSHQFQuBifcn7F1qfi1gi,fbPkOYLVPtPgIt0MxizjfFJov3JbHyAi,5,2,1,0,1,0,2,0,6,0.8571428571428571,1,0.0,0,1,0,1,2,0,0,2,0,2,4,1
3352,176357,8fBfbIuoUTzFONbekOgtlFtpKC5U6cNy,fbPkOYLVPtPgIt0MxizjfFJov3JbHyAi,10,8,3,3,3,1,4,0,22,3.142857142857143,1,0.0,3,3,3,3,5,1,0,4,0,12,10,1
3353,176358,cRpYMDSjBvEWIbn0U0hppujot5LNLTzW,fbPkOYLVPtPgIt0MxizjfFJov3JbHyAi,1,0,0,0,0,0,1,0,1,0.14285714285714285,1,0.0,0,0,0,0,0,0,0,1,0,0,1,1
3354,176359,38evuz11qT1yopNFOWEFJXqo6AKQdprx,fbPkOYLVPtPgIt0MxizjfFJov3JbHyAi,2,0,0,0,0,0,2,0,2,0.2857142857142857,1,0.0,0,0,0,0,0,0,0,2,0,0,2,1
3355,176362,tvD1wy5qLV5qKtu0LjnfHhQiwEJLQsKc,fbPkOYLVPtPgIt0MxizjfFJov3JbHyAi,7,5,3,4,3,0,1,0,16,2.2857142857142856,1,0.0,1,3,4,3,4,0,0,1,0,11,5,1
3356,176363,XpETIOce5NnU4qKIbkLob1tMSekzlpRK,fbPkOYLVPtPgIt0MxizjfFJov3JbHyAi,1,0,0,0,0,0,1,0,1,0.14285714285714285,1,0.0,0,0,0,0,0,0,0,1,0,0,1,1
3357,176364,zCHrzoFCDvrZWbgn6xqNjq29YrwinxJ6,fbPkOYLVPtPgIt0MxizjfFJov3JbHyAi,1,0,0,0,0,0,1,0,1,0.14285714285714285,1,0.0,0,0,0,0,0,0,0,1,0,0,1,1
3358,176366,ffNDXW73vFMgnRNtFmP91F2Fk6GpIDWe,fbPkOYLVPtPgIt0MxizjfFJov3JbHyAi,1,0,0,0,0,0,1,0,1,0.14285714285714285,1,0.0,0,0,0,0,0,0,0,1,0,0,1,1
3359,176367,QY2qA0MFHIqq0CtvZf3SzdZ2ea7Q99KG,fbPkOYLVPtPgIt0MxizjfFJov3JbHyAi,9,3,2,0,2,1,4,1,13,1.8571428571428572,1,0.0,0,2,0,2,3,1,0,4,1,4,9,1
3360,176369,3T6lo0hNKqGF8AeLHQEHxxeYIjJqOuY5,fbPkOYLVPtPgIt0MxizjfFJov3JbHyAi,2,0,0,0,0,0,2,0,2,0.2857142857142857,1,0.0,0,0,0,0,0,0,0,2,0,0,2,1
3361,176371,TKArhe0MXX8UInue0tvcz8uoMFUDLTjv,fbPkOYLVPtPgIt0MxizjfFJov3JbHyAi,1,0,0,0,0,0,1,0,1,0.14285714285714285,1,0.0,0,0,0,0,0,0,0,1,0,0,1,1
3362,176377,BnytRM0DS11v1j8Y5GXtdZweLuyRzpWa,7GRhBDsirIGkRZBtSMEzNTyDr2JQm4xx,11,8,5,4,4,0,2,0,23,3.2857142857142856,1,0.0,2,5,3,4,6,0,1,2,0,14,9,1
3363,176382,V5AS4ngknDMHs5ddf49SxlAoYguZsiN3,7GRhBDsirIGkRZBtSMEzNTyDr2JQm4xx,3,2,0,0,0,0,1,0,3,0.42857142857142855,1,0.0,0,0,0,0,2,0,0,1,0,0,3,1
3364,176397,L1FTG9TM6RI5TBCTexQgshQhXhu2oZpJ,7GRhBDsirIGkRZBtSMEzNTyDr2JQm4xx,6,8,6,0,6,0,1,0,21,3.0,1,0.0,0,6,0,6,8,0,0,1,0,12,9,1
3365,176468,rGRFKIkiXYdsTLVzdgfkfhoHp29YmFvI,7GRhBDsirIGkRZBtSMEzNTyDr2JQm4xx,1,0,0,0,0,0,1,0,1,0.14285714285714285,1,0.0,0,0,0,0,0,0,0,1,0,0,1,1
3366,176515,NYt3HW4iIDKFfkoDHUmE2GfhEi6C8Rqu,7GRhBDsirIGkRZBtSMEzNTyDr2JQm4xx,8,12,6,0,1,4,3,0,26,3.7142857142857144,1,0.0,4,6,0,1,8,4,0,3,0,11,15,1
3367,176520,BGZaaH5HDVuGvqaegp5MyJblPEuJpcXP,7GRhBDsirIGkRZBtSMEzNTyDr2JQm4xx,1,0,0,0,0,0,1,0,1,0.14285714285714285,1,0.0,0,0,0,0,0,0,0,1,0,0,1,1
3368,176521,bwHNoPHxbyrlfAktOsYn5l9pphqY7rqI,7GRhBDsirIGkRZBtSMEzNTyDr2JQm4xx,1,0,0,0,0,0,1,0,1,0.14285714285714285,1,0.0,0,0,0,0,0,0,0,1,0,0,1,1
3369,176528,7HpnoaIGu4hhAe6wQLzGOmmP3DNYMvrt,7GRhBDsirIGkRZBtSMEzNTyDr2JQm4xx,4,2,0,0,0,0,2,0,4,0.5714285714285714,1,0.0,0,0,0,0,2,0,0,2,0,0,4,1
3370,176555,zFJuKZAKTq12e9QE2ZEqSrQuW0gQ7ZSR,bWdj2GDclj5ofokWjzoa5jAwMkxCykd6,11,34,14,48,5,10,12,0,123,17.571428571428573,1,0.0,12,14,46,5,22,10,2,12,0,77,46,1
3371,176561,XPil0z3F5cAc6rFPjolit1u4hGh3bLog,bWdj2GDclj5ofokWjzoa5jAwMkxCykd6,2,0,0,0,0,0,3,0,3,0.42857142857142855,1,0.0,0,0,0,0,0,0,0,3,0,0,3,1
3372,176562,QgWb5bq53lHXqabN0HBji70t8pNuQpJI,A3fsA9Zfv1X2fVEQhTw51lKENdNrEqT3,6,3,2,0,1,0,3,0,9,1.2857142857142858,1,0.0,0,2,0,1,3,0,0,3,0,3,6,1
3373,176576,1ZnERDT2WSNZGJeanMnjXX2EswCJEUwX,SpATywNh6bZuzm8s1ceuBUnMUAeoAHHw,3,2,1,0,0,0,1,0,4,0.5714285714285714,1,0.0,0,1,0,0,2,0,0,1,0,1,3,1
3374,176625,NMToinRYtSSoVCXpJZRcRohg7dcw6Du0,SpATywNh6bZuzm8s1ceuBUnMUAeoAHHw,1,0,0,0,0,0,1,0,1,0.14285714285714285,1,0.0,0,0,0,0,0,0,0,1,0,0,1,1
3375,176635,TYUe9cujyrCsl9vgAyeTTK1SiwFBDVY7,A3fsA9Zfv1X2fVEQhTw51lKENdNrEqT3,2,0,0,0,0,0,2,0,2,0.2857142857142857,1,0.0,0,0,0,0,0,0,0,2,0,0,2,1
3376,176657,KGNZfzsWKEpndUg4ZWkpY4ThWCsiKpiv,A3fsA9Zfv1X2fVEQhTw51lKENdNrEqT3,1,0,0,0,0,0,1,0,1,0.14285714285714285,1,0.0,0,0,0,0,0,0,0,1,0,0,1,1
3377,176705,MED58Yjp1Lb99iMEyvwZJoRdEHymCjSn,SpATywNh6bZuzm8s1ceuBUnMUAeoAHHw,9,5,1,0,1,3,11,1,22,3.142857142857143,1,0.0,0,1,0,1,5,3,0,11,1,2,20,1
3378,176735,44GafVKSjOefcGtCUMS1SAXmrzlFFSGG,A3fsA9Zfv1X2fVEQhTw51lKENdNrEqT3,8,6,0,0,0,1,4,0,11,1.5714285714285714,1,0.0,0,0,0,0,6,1,0,4,0,0,11,1
3379,176736,GHfo4pUmbP0HyeQVp8PPz8kn0kTFo6yb,SpATywNh6bZuzm8s1ceuBUnMUAeoAHHw,16,18,0,33,0,0,1,0,52,7.428571428571429,1,0.0,6,0,28,0,12,0,5,1,0,34,18,0
3380,176753,nSViyQ7vSn8aF5YHjw7hmNhhRklO9laV,SpATywNh6bZuzm8s1ceuBUnMUAeoAHHw,5,2,1,0,1,0,3,0,7,1.0,1,0.0,0,1,0,1,2,0,0,3,0,2,5,1
3381,176757,1BR9RQvHYYkyWaPC2GRTHswQs8AyO4gg,SpATywNh6bZuzm8s1ceuBUnMUAeoAHHw,15,35,2,21,3,0,3,0,64,9.142857142857142,1,0.0,20,2,18,3,15,0,3,3,0,43,21,1
3382,176774,kvxGydllm6BLbdP0nm9jaxgMVk1FHTYp,SpATywNh6bZuzm8s1ceuBUnMUAeoAHHw,20,46,25,25,0,3,9,2,110,15.714285714285714,1,0.0,16,25,19,0,30,3,6,9,2,60,50,1
3383,176776,wvaRW3X5tOUHanl7PiOdxpXKHWAXL5Dm,SpATywNh6bZuzm8s1ceuBUnMUAeoAHHw,1,0,0,0,0,0,1,0,1,0.14285714285714285,1,0.0,0,0,0,0,0,0,0,1,0,0,1,1
3384,176822,BEwpQuUn0betGBYfWGax81LgeoTlg8LE,SpATywNh6bZuzm8s1ceuBUnMUAeoAHHw,17,14,2,15,2,5,5,1,44,6.285714285714286,1,0.0,5,2,12,2,9,5,3,5,1,21,23,0
3385,176823,frevGWOFyf2Wo6uQjpFNvZnyWeFbKP0E,A3fsA9Zfv1X2fVEQhTw51lKENdNrEqT3,8,9,0,6,0,0,3,0,18,2.5714285714285716,2,0.0,0,0,6,0,9,0,0,3,0,6,12,1
3386,176831,vt6yAFP86tVXKBFMjBeWFksicr6ADIhP,SpATywNh6bZuzm8s1ceuBUnMUAeoAHHw,5,2,1,0,1,0,2,0,6,0.8571428571428571,1,0.0,0,1,0,1,2,0,0,2,0,2,4,1
3387,176836,nfdmRSIeQ1UeHw7VkGM3TXlNpKXW3emB,bWdj2GDclj5ofokWjzoa5jAwMkxCykd6,1,0,0,0,0,0,1,0,1,0.14285714285714285,1,0.0,0,0,0,0,0,0,0,1,0,0,1,1
3388,176873,tD2t0ZHpAx0YjQwAL8UEB0neif6SIb4V,bWdj2GDclj5ofokWjzoa5jAwMkxCykd6,1,0,0,0,0,0,1,0,1,0.14285714285714285,1,0.0,0,0,0,0,0,0,0,1,0,0,1,1
3389,176877,tD2t0ZHpAx0YjQwAL8UEB0neif6SIb4V,A3fsA9Zfv1X2fVEQhTw51lKENdNrEqT3,1,0,0,0,0,0,1,0,1,0.14285714285714285,1,0.0,0,0,0,0,0,0,0,1,0,0,1,1
3390,176884,2bO6MisGrRWNEa1nUMHMWWTQVeKS23eS,SpATywNh6bZuzm8s1ceuBUnMUAeoAHHw,11,6,6,0,6,0,2,0,20,2.857142857142857,1,0.0,0,6,0,6,6,0,0,2,0,12,8,1
3391,176909,wjicnAF12JyAapuh15sdon1diUWswaFA,bWdj2GDclj5ofokWjzoa5jAwMkxCykd6,6,3,1,0,1,0,2,0,7,1.0,1,0.0,0,1,0,1,3,0,0,2,0,2,5,1
3392,176910,hlLJjac8psTxnrEYNcjoWRSyE9PLM0jF,A3fsA9Zfv1X2fVEQhTw51lKENdNrEqT3,6,3,2,0,2,0,2,0,9,1.2857142857142858,1,0.0,0,2,0,2,3,0,0,2,0,4,5,1
3393,176941,YmECTGgjL6NRIrd1m4lXekfVt4GlrSQ1,bWdj2GDclj5ofokWjzoa5jAwMkxCykd6,10,14,7,4,5,10,6,1,47,6.714285714285714,2,0.0,1,7,3,5,13,10,1,6,1,16,31,1
3394,176959,IxN0oMkJdKmNRarUB8mq0kSQRx8qnGax,bWdj2GDclj5ofokWjzoa5jAwMkxCykd6,3,0,0,0,0,0,3,0,3,0.42857142857142855,1,0.0,0,0,0,0,0,0,0,3,0,0,3,1
3395,177010,CxhwRDRCARhFka2Q3podETDsye29rlXb,SpATywNh6bZuzm8s1ceuBUnMUAeoAHHw,5,4,2,0,1,0,2,0,9,1.2857142857142858,1,0.0,0,2,0,1,4,0,0,2,0,3,6,1
3396,177060,Et66VbQRwkFnF42twZ8Z4ErFWQLehmwC,A3fsA9Zfv1X2fVEQhTw51lKENdNrEqT3,8,5,1,0,1,0,2,0,9,1.2857142857142858,1,0.0,0,1,0,1,5,0,0,2,0,2,7,0
3397,177101,2G9uV9MMhfw3z7a992GuBzgkXLp94apO,A3fsA9Zfv1X2fVEQhTw51lKENdNrEqT3,6,3,1,0,1,0,5,0,10,1.4285714285714286,1,0.0,0,1,0,1,3,0,0,5,0,2,8,1
3398,177105,niznzPsNcmf0qkvKVIABVzsBAFOWmMfr,A3fsA9Zfv1X2fVEQhTw51lKENdNrEqT3,6,6,0,0,0,0,6,0,12,1.7142857142857142,2,0.0,0,0,0,0,6,0,0,6,0,0,12,1
3399,177113,66JqxLLiEx06fBDzS4MuyYNc7nIpYGk9,A3fsA9Zfv1X2fVEQhTw51lKENdNrEqT3,43,31,23,56,12,0,2,0,124,17.714285714285715,2,0.0,1,23,50,12,30,0,6,2,0,86,38,0
3400,177123,cuPQwSytidcCUilblyO4K9ALDT0iH8XK,A3fsA9Zfv1X2fVEQhTw51lKENdNrEqT3,1,0,0,0,0,0,1,0,1,0.14285714285714285,1,0.0,0,0,0,0,0,0,0,1,0,0,1,1
3401,177167,DkBEQyIekQixrRUA1DCrhgBXxcYJJXln,SpATywNh6bZuzm8s1ceuBUnMUAeoAHHw,1,0,0,0,0,0,1,0,1,0.14285714285714285,1,0.0,0,0,0,0,0,0,0,1,0,0,1,1
3402,177177,nURvxLXCCRcUx0rr21CCKt2pPqq3RcJ7,SpATywNh6bZuzm8s1ceuBUnMUAeoAHHw,6,5,1,0,1,0,2,0,9,1.2857142857142858,1,0.0,0,1,0,1,5,0,0,2,0,2,7,1
3403,177185,eT9OhUahWhAeZfHPEbxGN9qGHwvkkQvs,SpATywNh6bZuzm8s1ceuBUnMUAeoAHHw,1,0,0,0,0,0,1,0,1,0.14285714285714285,1,0.0,0,0,0,0,0,0,0,1,0,0,1,1
3404,177190,LfqjHStsZ12hVtRAj2u8KdIMPVFnabmD,bWdj2GDclj5ofokWjzoa5jAwMkxCykd6,1,0,0,0,0,0,1,0,1,0.14285714285714285,1,0.0,0,0,0,0,0,0,0,1,0,0,1,1
3405,177192,mBNdEgFmgGVvgyDWBgZluXCXQS1DNZxP,bWdj2GDclj5ofokWjzoa5jAwMkxCykd6,6,4,2,0,2,0,1,0,9,1.2857142857142858,1,0.0,0,2,0,2,4,0,0,1,0,4,5,1
3406,177210,xmv8WUz0fQb7fJNMHkcUN733RgAFZjFP,SpATywNh6bZuzm8s1ceuBUnMUAeoAHHw,5,5,1,0,1,0,2,0,9,1.2857142857142858,1,0.0,0,1,0,1,5,0,0,2,0,2,7,1
3407,177225,jGkFsr85Pqt6G74Ct0j5bqEqPLMt7wa3,bWdj2GDclj5ofokWjzoa5jAwMkxCykd6,2,0,0,0,0,0,2,0,2,0.2857142857142857,1,0.0,0,0,0,0,0,0,0,2,0,0,2,1
3408,177226,jGkFsr85Pqt6G74Ct0j5bqEqPLMt7wa3,A3fsA9Zfv1X2fVEQhTw51lKENdNrEqT3,2,0,0,0,0,0,2,0,2,0.2857142857142857,1,0.0,0,0,0,0,0,0,0,2,0,0,2,1
3409,177266,QiYah6MaRTZX43IYRVARS0cRIO6IdBSv,bWdj2GDclj5ofokWjzoa5jAwMkxCykd6,2,0,0,0,0,0,2,0,2,0.2857142857142857,1,0.0,0,0,0,0,0,0,0,2,0,0,2,1
3410,177308,g1C9Sv2GzsuaWdnKXvZB1yWKiZN0Fg91,bWdj2GDclj5ofokWjzoa5jAwMkxCykd6,1,0,0,0,0,0,1,0,1,0.14285714285714285,1,0.0,0,0,0,0,0,0,0,1,0,0,1,1
3411,177320,qiPgVnk4J2KtMigrE44RvNt4xKpRJnr3,SpATywNh6bZuzm8s1ceuBUnMUAeoAHHw,1,0,0,0,0,0,1,0,1,0.14285714285714285,1,0.0,0,0,0,0,0,0,0,1,0,0,1,1
3412,177347,fGIeAB7IRJCHxzCo8u4GLaPKxQfHeCdi,bWdj2GDclj5ofokWjzoa5jAwMkxCykd6,19,39,19,14,11,0,3,0,86,12.285714285714286,2,0.0,6,19,13,11,33,0,1,3,0,49,37,1
3413,177377,9NDg9VwFVuCbATto5EGvC6PrvN5Y88Xw,bWdj2GDclj5ofokWjzoa5jAwMkxCykd6,1,0,0,0,0,0,1,0,1,0.14285714285714285,1,0.0,0,0,0,0,0,0,0,1,0,0,1,1
3414,177380,g9JwaoBhrenD3JLPIF4Rgp3VFIAz66kP,bWdj2GDclj5ofokWjzoa5jAwMkxCykd6,10,20,1,60,1,10,12,2,106,15.142857142857142,1,0.0,8,1,59,1,12,10,1,12,2,69,37,1
3415,177405,IOvPoNN8l7pPy4G3bKTENwwaE7wXUaKr,A3fsA9Zfv1X2fVEQhTw51lKENdNrEqT3,7,2,1,0,1,0,7,0,11,1.5714285714285714,1,0.0,0,1,0,1,2,0,0,7,0,2,9,1
3416,177430,zF9V63zn5gsiipqbdXutnSHDmKKLyPTo,SpATywNh6bZuzm8s1ceuBUnMUAeoAHHw,5,4,1,0,1,0,3,0,9,1.2857142857142858,1,0.0,1,1,0,1,3,0,0,3,0,3,6,1
3417,177432,J3Fq3KF0FVOYO5SL2II3p94rxzVjXgko,SpATywNh6bZuzm8s1ceuBUnMUAeoAHHw,6,1,1,0,1,0,3,0,6,0.8571428571428571,1,0.0,0,1,0,1,1,0,0,3,0,2,4,0
3418,177436,RVgC7pWiS5TIqo11u8gn0FiACXxbMvEV,SpATywNh6bZuzm8s1ceuBUnMUAeoAHHw,4,3,0,0,0,0,2,0,5,0.7142857142857143,1,0.0,0,0,0,0,3,0,0,2,0,0,5,1
3419,177442,SWQUdK85RnayLE3toQQorQRoqxtUEkUa,bWdj2GDclj5ofokWjzoa5jAwMkxCykd6,13,6,2,44,0,0,2,0,54,7.714285714285714,1,0.0,0,2,38,0,6,0,6,2,0,40,14,0
3420,177460,NXEwBXbU6vvce77sujWgRB6LivhFJvRb,A3fsA9Zfv1X2fVEQhTw51lKENdNrEqT3,7,6,3,0,2,0,2,0,13,1.8571428571428572,1,0.0,0,3,0,2,6,0,0,2,0,5,8,1
3421,177461,TLRNemgJ2qb9k6dqDLHmoeJOx0QEylHX,SpATywNh6bZuzm8s1ceuBUnMUAeoAHHw,11,8,5,0,3,5,6,1,28,4.0,1,0.0,1,5,0,3,7,5,0,6,1,9,19,1
3422,177501,K3eaSd5rYP9Gkimldqt40pigYQrGeLsH,bWdj2GDclj5ofokWjzoa5jAwMkxCykd6,4,2,1,0,0,0,2,0,5,0.7142857142857143,1,0.0,0,1,0,0,2,0,0,2,0,1,4,1
3423,177522,UtuMMiTcYdEIPqLGUrTySvaHfGG20tSq,SpATywNh6bZuzm8s1ceuBUnMUAeoAHHw,5,2,1,0,1,0,2,0,6,0.8571428571428571,1,0.0,0,1,0,1,2,0,0,2,0,2,4,1
3424,177822,IfuP3wsHPcoufqx0FyqFKUytwStvSPv8,G8EPVSXsOYB5YQWZGiz1aVq5Pgr2GrQu,8,5,1,0,1,0,2,0,9,1.2857142857142858,1,0.0,0,1,0,1,5,0,0,2,0,2,7,1
3425,177827,ryn67VWPQk6LcF6yj0ExcHQJuf0D8gOm,G8EPVSXsOYB5YQWZGiz1aVq5Pgr2GrQu,7,11,0,0,2,0,3,0,16,2.2857142857142856,1,0.0,8,0,0,2,3,0,0,3,0,10,6,1
3426,178047,g5hqByjT71l7XQpoHooh42h6aYalEjyF,RXDvfPUBYFlVdlueBFbLW0mhhAyGEqpt,3,3,2,0,0,16,2,0,23,3.2857142857142856,1,0.0,0,2,0,0,3,16,0,2,0,2,21,1
3427,178056,xk56WEVJEAYlfTe18KDPHjwyCpm6eESo,RXDvfPUBYFlVdlueBFbLW0mhhAyGEqpt,1,0,0,0,0,0,1,0,1,0.14285714285714285,1,0.0,0,0,0,0,0,0,0,1,0,0,1,1
3428,178123,jpxpIqdWMtlxqJfj67lnudhyEHl6x8Bm,RXDvfPUBYFlVdlueBFbLW0mhhAyGEqpt,5,3,2,0,1,0,1,0,7,1.0,1,0.0,0,2,0,1,3,0,0,1,0,3,4,1
3429,178140,m5gaSzexRDWD05xetdfM0AEyRBJhEUro,G8EPVSXsOYB5YQWZGiz1aVq5Pgr2GrQu,8,3,0,0,0,1,7,1,12,1.7142857142857142,1,0.0,0,0,0,0,3,1,0,7,1,0,12,1
3430,179212,R23hQIkxpjGDipcAUB8Dm9M15B8oN1UL,A3fsA9Zfv1X2fVEQhTw51lKENdNrEqT3,1,0,0,0,0,0,1,0,1,0.14285714285714285,1,0.0,0,0,0,0,0,0,0,1,0,0,1,0
3431,179254,scd3kJGQZMfO9m14NZd9uOrxe7XoIWpn,SpATywNh6bZuzm8s1ceuBUnMUAeoAHHw,16,13,6,17,1,1,6,0,44,6.285714285714286,1,0.0,6,6,15,1,7,1,2,6,0,28,16,0
3432,179269,4ML4Rs54jY3fM6KAvqncawhNmnqaKs8R,A3fsA9Zfv1X2fVEQhTw51lKENdNrEqT3,2,0,0,0,0,0,3,0,3,0.42857142857142855,1,0.0,0,0,0,0,0,0,0,3,0,0,3,1
3433,179362,RNNuxsM5xlYyyu9stwQmqEuw1Q1FUKuB,A3fsA9Zfv1X2fVEQhTw51lKENdNrEqT3,2,0,0,0,0,0,4,0,4,0.5714285714285714,1,0.0,0,0,0,0,0,0,0,4,0,0,4,1
3434,179568,hcWxPPFXJZEtM1yKNtZ1ZD1nYFNlYmMq,A3fsA9Zfv1X2fVEQhTw51lKENdNrEqT3,4,4,1,0,0,0,2,0,7,1.0,2,0.0,0,1,0,0,4,0,0,2,0,1,6,1
3435,179588,Xi3RoGAOjHAkUXOmQAg8CMkVWfFCkb7n,A3fsA9Zfv1X2fVEQhTw51lKENdNrEqT3,1,0,0,0,0,0,1,0,1,0.14285714285714285,1,0.0,0,0,0,0,0,0,0,1,0,0,1,1
3436,179601,TGiJnSEfOlHtpx1NmAAE5E7Ka91RcY3D,A3fsA9Zfv1X2fVEQhTw51lKENdNrEqT3,1,0,0,0,0,0,1,0,1,0.14285714285714285,1,0.0,0,0,0,0,0,0,0,1,0,0,1,1
3437,179667,KT45H8qrJu79sTHkCPHSA9sUb3RNHJTY,A3fsA9Zfv1X2fVEQhTw51lKENdNrEqT3,1,0,0,0,0,0,1,0,1,0.14285714285714285,1,0.0,0,0,0,0,0,0,0,1,0,0,1,1
3438,179860,SL3jxjEQk6v82n0aWfLP80T9svpvrAxv,A3fsA9Zfv1X2fVEQhTw51lKENdNrEqT3,7,3,2,0,2,0,2,0,9,1.2857142857142858,1,0.0,0,2,0,2,3,0,0,2,0,4,5,0
3439,179969,nCZrnJjbpsSoXVwiEhCJqTYAOI3F94p9,A3fsA9Zfv1X2fVEQhTw51lKENdNrEqT3,10,5,4,0,4,0,1,0,14,2.0,1,0.0,0,4,0,4,5,0,0,1,0,8,6,1
3440,180007,d61Mq2WOkbOPuslLwPbE2HIvs5VJCHXC,A3fsA9Zfv1X2fVEQhTw51lKENdNrEqT3,2,0,0,0,0,0,2,0,2,0.2857142857142857,1,0.0,0,0,0,0,0,0,0,2,0,0,2,1
3441,184080,Q0ABMzqV4ZKePGWKS9YO1g6VONZhZLgg,RXDvfPUBYFlVdlueBFbLW0mhhAyGEqpt,1,0,0,0,0,0,1,0,1,0.14285714285714285,1,0.0,0,0,0,0,0,0,0,1,0,0,1,0
3442,185842,gQqEJZs7B37MmzRexP5otRszUHd2KLYy,SpATywNh6bZuzm8s1ceuBUnMUAeoAHHw,16,11,8,17,4,0,1,0,41,5.857142857142857,1,0.0,2,8,15,4,9,0,2,1,0,29,12,1
3443,193461,9GrY3tpi0hw7X0WFc7jJ7GdKfBSQDQX0,A3fsA9Zfv1X2fVEQhTw51lKENdNrEqT3,14,12,10,0,2,0,1,0,25,3.5714285714285716,1,0.0,0,10,0,2,12,0,0,1,0,12,13,1
3444,193529,Q3zkClKdiEJIkoKspwBuSNOwYXuxalAX,SpATywNh6bZuzm8s1ceuBUnMUAeoAHHw,7,5,3,0,3,0,2,0,13,1.8571428571428572,1,0.0,0,3,0,3,5,0,0,2,0,6,7,0
3445,193546,ut2Z39AHP6ZT6QUG6LjRTh7eJLhOH9rE,SpATywNh6bZuzm8s1ceuBUnMUAeoAHHw,1,0,0,0,0,0,1,0,1,0.14285714285714285,1,0.0,0,0,0,0,0,0,0,1,0,0,1,1
3446,193547,tomN9mWyg9iwVzF8UU8hmvw3PQ3xuR0k,G8EPVSXsOYB5YQWZGiz1aVq5Pgr2GrQu,5,5,0,0,0,0,1,0,6,0.8571428571428571,1,0.0,0,0,0,0,5,0,0,1,0,0,6,1
3447,193558,E5gNyf8gzkIFqEMMzFfX1babw0jRMtve,SpATywNh6bZuzm8s1ceuBUnMUAeoAHHw,1,0,0,0,0,0,1,0,1,0.14285714285714285,1,0.0,0,0,0,0,0,0,0,1,0,0,1,1
3448,193621,KHdvxdy2R5AbDwK3ZeYjgr8BjoNdfk08,SpATywNh6bZuzm8s1ceuBUnMUAeoAHHw,18,40,11,28,7,0,2,0,88,12.571428571428571,1,0.0,28,11,24,7,12,0,4,2,0,70,18,1
3449,193662,VgqneuQZQ3AncdWCqb9v0uAbatLD1T8K,SpATywNh6bZuzm8s1ceuBUnMUAeoAHHw,3,0,0,0,0,1,4,0,5,0.7142857142857143,1,0.0,0,0,0,0,0,1,0,4,0,0,5,1
3450,193670,DQNJ5C68L0zW9SqNuKPhfxZqhIFSYAAT,SpATywNh6bZuzm8s1ceuBUnMUAeoAHHw,7,1,1,0,1,1,4,1,9,1.2857142857142858,1,0.0,0,1,0,1,1,1,0,4,1,2,7,1
3451,193674,cNh6wy7Ir03u71mDLbzarbbzMgepTdGC,A3fsA9Zfv1X2fVEQhTw51lKENdNrEqT3,7,12,4,0,2,0,7,0,25,3.5714285714285716,1,0.0,0,4,0,2,12,0,0,7,0,6,19,1
3452,193692,VwBmQMjyoGFc84WCvHOjmFbeW8jbYRgl,bWdj2GDclj5ofokWjzoa5jAwMkxCykd6,1,0,0,0,0,0,1,0,1,0.14285714285714285,1,0.0,0,0,0,0,0,0,0,1,0,0,1,1
3453,193711,kEyzl5U0qNnr42pVaGkY13nZ2IWHqrcn,A3fsA9Zfv1X2fVEQhTw51lKENdNrEqT3,8,11,2,0,0,0,6,0,19,2.7142857142857144,1,0.0,0,2,0,0,11,0,0,6,0,2,17,1
3454,193740,QZU7ovSo60LPfLhEkMZQvJSmegKjwMYj,bWdj2GDclj5ofokWjzoa5jAwMkxCykd6,1,0,0,0,0,0,1,0,1,0.14285714285714285,1,0.0,0,0,0,0,0,0,0,1,0,0,1,1
3455,193755,nKyehpqCzFKe7AQ0H2jeEWUcUDLPIpGO,SpATywNh6bZuzm8s1ceuBUnMUAeoAHHw,3,2,1,0,0,0,1,0,4,0.5714285714285714,1,0.0,0,1,0,0,2,0,0,1,0,1,3,1
3456,193779,sxaa8Ea6Lo6kUM7O8EMurbYXKbm0hujM,A3fsA9Zfv1X2fVEQhTw51lKENdNrEqT3,4,2,1,0,0,0,2,0,5,0.7142857142857143,1,0.0,0,1,0,0,2,0,0,2,0,1,4,1
3457,193823,3vhCoT2dzeVdCpmcedhNzxK4VNLZ2l0r,A3fsA9Zfv1X2fVEQhTw51lKENdNrEqT3,2,0,0,0,0,0,2,0,2,0.2857142857142857,1,0.0,0,0,0,0,0,0,0,2,0,0,2,0
3458,193837,FMDDO6Y1UiugRDKpi0pVbHvW0zsQHjbn,A3fsA9Zfv1X2fVEQhTw51lKENdNrEqT3,1,0,0,0,0,0,2,0,2,0.2857142857142857,1,0.0,0,0,0,0,0,0,0,2,0,0,2,1
3459,193841,dfFEAUBIaQMqykMKdgVE6J8eiY6sOxye,SpATywNh6bZuzm8s1ceuBUnMUAeoAHHw,1,0,0,0,0,0,1,0,1,0.14285714285714285,1,0.0,0,0,0,0,0,0,0,1,0,0,1,1
3460,193849,hnA8kwZbTriWwmx5JyNt7w45L87YwoEF,G8EPVSXsOYB5YQWZGiz1aVq5Pgr2GrQu,6,3,1,0,1,1,2,0,8,1.1428571428571428,1,0.0,0,1,0,1,3,1,0,2,0,2,6,1
3461,193855,DC8hVUW5lzy6OHDhVmFS5qTdzgQgs5yo,G8EPVSXsOYB5YQWZGiz1aVq5Pgr2GrQu,10,5,4,0,3,0,2,0,14,2.0,1,0.0,0,4,0,3,5,0,0,2,0,7,7,1
3462,193873,aax9J1adQbt26SqiuCHMyd0MidU5QFDr,SpATywNh6bZuzm8s1ceuBUnMUAeoAHHw,18,20,8,20,3,2,9,1,63,9.0,1,0.0,5,8,16,3,15,2,4,9,1,32,31,1
3463,193875,XDysHi7lmceIm5Mq9k6RvheRnsYOet1p,SpATywNh6bZuzm8s1ceuBUnMUAeoAHHw,7,10,3,0,3,0,3,0,19,2.7142857142857144,1,0.0,0,3,0,3,10,0,0,3,0,6,13,1
3464,193876,t1OYI1zdmZ8QFHlNczrmBq9UprH9pvCH,SpATywNh6bZuzm8s1ceuBUnMUAeoAHHw,4,2,1,0,1,0,1,0,5,0.7142857142857143,1,0.0,0,1,0,1,2,0,0,1,0,2,3,1
3465,193886,glhFN9pJVRx23uQGYu0vpxeXZDAwQ2Ta,bWdj2GDclj5ofokWjzoa5jAwMkxCykd6,3,2,1,0,0,0,2,0,5,0.7142857142857143,1,0.0,0,1,0,0,2,0,0,2,0,1,4,1
3466,193898,CzuKHquS2mEQaelvyNFMdu8Hprmbh3VI,A3fsA9Zfv1X2fVEQhTw51lKENdNrEqT3,14,6,6,0,6,0,3,0,21,3.0,1,0.0,0,6,0,6,6,0,0,3,0,12,9,1
3467,193901,Qp3BNNi2PRh8N3k7qOPk9z3KeApis9gf,RXDvfPUBYFlVdlueBFbLW0mhhAyGEqpt,1,0,0,0,0,0,1,0,1,0.14285714285714285,1,0.0,0,0,0,0,0,0,0,1,0,0,1,1
3468,193923,TXo0CCOBoSUl3sGr1fGqVDX7GLiPHTPL,SpATywNh6bZuzm8s1ceuBUnMUAeoAHHw,13,27,8,0,4,0,1,0,40,5.714285714285714,1,0.0,0,8,0,4,27,0,0,1,0,12,28,1
3469,193971,B9OrY2GCm2nBIEwFkCzWGpeUovQjjQhl,SpATywNh6bZuzm8s1ceuBUnMUAeoAHHw,6,3,1,0,1,0,2,0,7,1.0,1,0.0,0,1,0,1,3,0,0,2,0,2,5,1
3470,193976,MdokNqUjzmrixfK2dFiZvz1LZ7rVu7Cj,SpATywNh6bZuzm8s1ceuBUnMUAeoAHHw,4,2,0,0,0,0,2,0,4,0.5714285714285714,1,0.0,0,0,0,0,2,0,0,2,0,0,4,1
3471,193989,kTjP7AQblBZanJKF3X14Zgingjm852XK,A3fsA9Zfv1X2fVEQhTw51lKENdNrEqT3,24,4,2,42,0,1,6,1,56,8.0,1,0.0,2,2,41,0,2,1,1,6,1,45,11,1
3472,194009,QnyEBvmb3eYd1kNyaAYx0F6xZuTb2DX9,SpATywNh6bZuzm8s1ceuBUnMUAeoAHHw,3,2,0,0,0,0,1,0,3,0.42857142857142855,1,0.0,0,0,0,0,2,0,0,1,0,0,3,1
3473,194016,0Gb2L45v3CzxlKP5WG7b6lBKOfgBuWF4,bWdj2GDclj5ofokWjzoa5jAwMkxCykd6,1,0,0,0,0,0,1,0,1,0.14285714285714285,1,0.0,0,0,0,0,0,0,0,1,0,0,1,1
3474,194049,mpIXHW5sILjjHOwn1u3NkBPJs6lkxDFU,A3fsA9Zfv1X2fVEQhTw51lKENdNrEqT3,1,0,0,0,0,0,1,0,1,0.14285714285714285,1,0.0,0,0,0,0,0,0,0,1,0,0,1,1
3475,194057,UasrjB6Lz57MSXiyP9hy734A5ulOXRm3,SpATywNh6bZuzm8s1ceuBUnMUAeoAHHw,8,2,2,0,2,0,6,0,12,1.7142857142857142,1,0.0,0,2,0,2,2,0,0,6,0,4,8,1
3476,194064,RGBg5OBpyocoeZ6vgulRvdHAe4GhCDz5,RXDvfPUBYFlVdlueBFbLW0mhhAyGEqpt,1,0,0,0,0,0,1,0,1,0.14285714285714285,1,0.0,0,0,0,0,0,0,0,1,0,0,1,1
3477,194106,RbyWsDK4wdT2As4ssmcjxiIXfIRi33se,RXDvfPUBYFlVdlueBFbLW0mhhAyGEqpt,1,0,0,0,0,0,1,0,1,0.14285714285714285,1,0.0,0,0,0,0,0,0,0,1,0,0,1,1
3478,194111,RbyWsDK4wdT2As4ssmcjxiIXfIRi33se,SpATywNh6bZuzm8s1ceuBUnMUAeoAHHw,1,0,0,0,0,0,1,0,1,0.14285714285714285,1,0.0,0,0,0,0,0,0,0,1,0,0,1,1
3479,194122,Jag1EXQWfAuTRiCgcVLyhRRkdOL9RtSD,SpATywNh6bZuzm8s1ceuBUnMUAeoAHHw,5,2,1,0,1,0,2,0,6,0.8571428571428571,1,0.0,0,1,0,1,2,0,0,2,0,2,4,1
3480,194149,r3BpteKZps4orgYHVV47mEy8Bf1f88sS,SpATywNh6bZuzm8s1ceuBUnMUAeoAHHw,1,0,0,0,0,0,1,0,1,0.14285714285714285,1,0.0,0,0,0,0,0,0,0,1,0,0,1,1
3481,194174,aPhG1FOMABaf6t82UGQZl3EdavvBRVEM,SpATywNh6bZuzm8s1ceuBUnMUAeoAHHw,8,5,3,0,2,0,4,0,14,2.0,1,0.0,0,3,0,2,5,0,0,4,0,5,9,1
3482,194202,BRI1NrrNzUCAkotknDhVlhYBChSBuaKT,A3fsA9Zfv1X2fVEQhTw51lKENdNrEqT3,5,2,1,0,1,0,5,0,9,1.2857142857142858,1,0.0,0,1,0,1,2,0,0,5,0,2,7,1
3483,194229,Utp3WJ8WUPD5DMyG8PNbE11goCMql2Z7,A3fsA9Zfv1X2fVEQhTw51lKENdNrEqT3,1,0,0,0,0,0,1,0,1,0.14285714285714285,1,0.0,0,0,0,0,0,0,0,1,0,0,1,1
3484,194249,pYpEHiiN5hrwCDFMKyLxLiOaj9mHQ7GD,SpATywNh6bZuzm8s1ceuBUnMUAeoAHHw,8,15,7,0,4,0,4,0,30,4.285714285714286,1,0.0,0,7,0,4,15,0,0,4,0,11,19,1
3485,194264,FLurI80IK98XkIDWszFSc1I4xJfHkDui,SpATywNh6bZuzm8s1ceuBUnMUAeoAHHw,12,9,4,22,2,0,3,0,40,5.714285714285714,1,0.0,2,4,18,2,7,0,4,3,0,26,14,1
3486,194271,KZl7dzvypdUdUZeB27FsOKIroCh34ZqE,A3fsA9Zfv1X2fVEQhTw51lKENdNrEqT3,1,0,0,0,0,0,1,0,1,0.14285714285714285,1,0.0,0,0,0,0,0,0,0,1,0,0,1,1
3487,194287,MAiX9Mv3NnsExv5ROawUklmLMW7Nn262,SpATywNh6bZuzm8s1ceuBUnMUAeoAHHw,15,11,9,17,6,0,8,0,51,7.285714285714286,1,0.0,2,9,14,6,9,0,3,8,0,31,20,1
3488,194317,90AfsCq5UXzZCbixYNCLPLgYyR0EOdy8,G8EPVSXsOYB5YQWZGiz1aVq5Pgr2GrQu,2,0,0,0,0,0,2,0,2,0.2857142857142857,1,0.0,0,0,0,0,0,0,0,2,0,0,2,0
3489,194320,DJXmR0KXC00UhtfnxnB0CPGhSlDcn5wL,A3fsA9Zfv1X2fVEQhTw51lKENdNrEqT3,1,0,0,0,0,0,1,0,1,0.14285714285714285,1,0.0,0,0,0,0,0,0,0,1,0,0,1,1
3490,194324,n2VuZ0fqJlR2ojRwATHr8Dfs9pdWlC2O,A3fsA9Zfv1X2fVEQhTw51lKENdNrEqT3,2,0,0,0,0,0,2,0,2,0.2857142857142857,1,0.0,0,0,0,0,0,0,0,2,0,0,2,1
3491,194327,M1VqvJkrHwdSwkXPdddYGz81xvnLA8HS,SpATywNh6bZuzm8s1ceuBUnMUAeoAHHw,1,0,0,0,0,0,1,0,1,0.14285714285714285,1,0.0,0,0,0,0,0,0,0,1,0,0,1,1
3492,194336,QrSRvY8A0BnQzetj7Na9CGZYc5c4hg6D,SpATywNh6bZuzm8s1ceuBUnMUAeoAHHw,1,0,0,0,0,0,1,0,1,0.14285714285714285,1,0.0,0,0,0,0,0,0,0,1,0,0,1,1
3493,194343,v3fCRqF4yjcmyXUAihELSrQ7bgYySQHE,SpATywNh6bZuzm8s1ceuBUnMUAeoAHHw,1,0,0,0,0,0,1,0,1,0.14285714285714285,1,0.0,0,0,0,0,0,0,0,1,0,0,1,0
3494,194366,MxupZhGQSwq1Hs7FHVKBBW3oeB56xups,SpATywNh6bZuzm8s1ceuBUnMUAeoAHHw,5,4,3,0,2,0,1,0,10,1.4285714285714286,1,0.0,0,3,0,2,4,0,0,1,0,5,5,1
3495,194382,Vnz3YQtaGP9Lud4eJsx4REuNf7a7Z6K7,SpATywNh6bZuzm8s1ceuBUnMUAeoAHHw,2,0,0,0,0,0,4,0,4,0.5714285714285714,1,0.0,0,0,0,0,0,0,0,4,0,0,4,1
3496,194391,bdUXVrhZKpaP1VpbMxVaAFkizIqnujVe,A3fsA9Zfv1X2fVEQhTw51lKENdNrEqT3,7,3,2,0,2,0,2,0,9,1.2857142857142858,1,0.0,0,2,0,2,3,0,0,2,0,4,5,1
3497,194402,HR018KR2tBP057NQs8ykDSVXzmSvDGhY,SpATywNh6bZuzm8s1ceuBUnMUAeoAHHw,1,0,0,0,0,0,1,0,1,0.14285714285714285,1,0.0,0,0,0,0,0,0,0,1,0,0,1,1
3498,194403,UF7B9M1202zm8vZITrztmSzM22WJBlYD,bWdj2GDclj5ofokWjzoa5jAwMkxCykd6,2,0,0,0,0,0,2,0,2,0.2857142857142857,1,0.0,0,0,0,0,0,0,0,2,0,0,2,1
3499,194443,InBEEGDWD99h4yXK2rL9tIFIqmzEV1Dr,SpATywNh6bZuzm8s1ceuBUnMUAeoAHHw,1,0,0,0,0,0,1,0,1,0.14285714285714285,1,0.0,0,0,0,0,0,0,0,1,0,0,1,1
3500,194464,kMcdY0ONNEzYAx15mWphYUVwn71ZDd1H,A3fsA9Zfv1X2fVEQhTw51lKENdNrEqT3,9,7,5,0,0,0,14,0,26,3.7142857142857144,1,0.0,0,5,0,0,7,0,0,14,0,5,21,1
3501,194468,3zCxXtKsxr4Va4aHW0QJdJglnVCQNojy,A3fsA9Zfv1X2fVEQhTw51lKENdNrEqT3,4,1,1,0,0,0,2,0,4,0.5714285714285714,1,0.0,0,1,0,0,1,0,0,2,0,1,3,1
3502,195612,v5ZclElew7ejFho1P7oX3s4a7TxNLCyF,7GRhBDsirIGkRZBtSMEzNTyDr2JQm4xx,1,0,0,0,0,0,1,0,1,0.14285714285714285,1,0.0,0,0,0,0,0,0,0,1,0,0,1,1
3503,195629,wnskylPQEd73X69h6kGVzeSF3KYHcgop,7GRhBDsirIGkRZBtSMEzNTyDr2JQm4xx,1,0,0,0,0,0,1,0,1,0.14285714285714285,1,0.0,0,0,0,0,0,0,0,1,0,0,1,1
3504,195677,CnWkaEKTjMJzfUHjUWYYcuY1pest8HcE,7GRhBDsirIGkRZBtSMEzNTyDr2JQm4xx,2,0,0,0,0,0,2,0,2,0.2857142857142857,1,0.0,0,0,0,0,0,0,0,2,0,0,2,1
3505,195683,nT6QAy9LYRgx8ymnax3zVsoU2kI3RSib,7GRhBDsirIGkRZBtSMEzNTyDr2JQm4xx,4,0,0,0,0,0,3,1,4,0.5714285714285714,1,0.0,0,0,0,0,0,0,0,3,1,0,4,1
3506,195698,Wn6M5pDE1BQQohcN99ynI9TPsF44SXAJ,7GRhBDsirIGkRZBtSMEzNTyDr2JQm4xx,4,2,1,0,1,0,1,0,5,0.7142857142857143,1,0.0,0,1,0,1,2,0,0,1,0,2,3,1
3507,195703,C800geUBh3GYBhoh4cW6ReKUGj5LAMGi,7GRhBDsirIGkRZBtSMEzNTyDr2JQm4xx,1,0,0,0,0,0,1,0,1,0.14285714285714285,1,0.0,0,0,0,0,0,0,0,1,0,0,1,1
3508,195739,BBfiARXlf8DQ4mmAXStqrzMqGcJUzid6,7GRhBDsirIGkRZBtSMEzNTyDr2JQm4xx,5,2,1,0,1,1,2,0,7,1.0,1,0.0,0,1,0,1,2,1,0,2,0,2,5,1
3509,195747,LezrgeG2DMZV4p8bIqSrF4Mu5gNQ96cn,7GRhBDsirIGkRZBtSMEzNTyDr2JQm4xx,17,16,1,0,1,0,1,0,19,2.7142857142857144,1,0.0,0,1,0,1,16,0,0,1,0,2,17,1
3510,195799,cQIOkGZ64oWxmjLUWB6bjywMucqysG5O,7GRhBDsirIGkRZBtSMEzNTyDr2JQm4xx,2,0,0,0,0,0,2,0,2,0.2857142857142857,1,0.0,0,0,0,0,0,0,0,2,0,0,2,1
3511,200156,VlDniFDr4BUyYYqSDi6VTSgVdE4PjFNm,fbPkOYLVPtPgIt0MxizjfFJov3JbHyAi,2,0,0,0,0,0,4,0,4,0.5714285714285714,1,0.0,0,0,0,0,0,0,0,4,0,0,4,1
3512,200158,OBrE671jmAa0zcKhOwZbsgknJEYhO9ZQ,fbPkOYLVPtPgIt0MxizjfFJov3JbHyAi,6,3,1,0,1,0,4,0,9,1.2857142857142858,1,0.0,0,1,0,1,3,0,0,4,0,2,7,1
3513,200160,WY8ZjTYNIGxqmEBUqyR8YNe7kour5nSN,fbPkOYLVPtPgIt0MxizjfFJov3JbHyAi,2,0,0,0,0,0,2,0,2,0.2857142857142857,1,0.0,0,0,0,0,0,0,0,2,0,0,2,1
3514,200161,3GyPhLgeVf6ayT8WwMOzrwG0vX3cMBOI,fbPkOYLVPtPgIt0MxizjfFJov3JbHyAi,14,14,7,8,6,1,14,2,52,7.428571428571429,1,0.0,4,7,6,6,10,1,2,14,2,23,29,1
3515,200164,SEHcNh1vMg4ZLYiSoUqvCFsKMsJ8CB2i,fbPkOYLVPtPgIt0MxizjfFJov3JbHyAi,1,0,0,0,0,0,1,0,1,0.14285714285714285,1,0.0,0,0,0,0,0,0,0,1,0,0,1,1
3516,200167,iwXVrgcqAKROauUa9mk2BApUHKtwoacr,fbPkOYLVPtPgIt0MxizjfFJov3JbHyAi,5,2,1,0,1,0,2,0,6,0.8571428571428571,1,0.0,0,1,0,1,2,0,0,2,0,2,4,1
3517,200168,AYthRqjUqxgBOMkMdZlsA0hn0RkYMhX1,fbPkOYLVPtPgIt0MxizjfFJov3JbHyAi,11,14,9,0,8,1,3,0,35,5.0,1,0.0,3,9,0,8,11,1,0,3,0,20,15,1
3518,200170,8uvIif4A5L5EPYASYSg4Tx0sVAF45af4,fbPkOYLVPtPgIt0MxizjfFJov3JbHyAi,2,2,0,0,0,0,0,0,2,0.2857142857142857,1,0.0,0,0,0,0,2,0,0,0,0,0,2,1
3519,200172,TNhUrfYcya3yxRpJxMcmjGjIL7iLVR1R,fbPkOYLVPtPgIt0MxizjfFJov3JbHyAi,1,0,0,0,0,0,1,0,1,0.14285714285714285,1,0.0,0,0,0,0,0,0,0,1,0,0,1,1
3520,200174,5OFiMxDgE4Mm8y2SD0A2gGR1Jne1kbKh,fbPkOYLVPtPgIt0MxizjfFJov3JbHyAi,4,2,1,0,0,0,2,0,5,0.7142857142857143,1,0.0,0,1,0,0,2,0,0,2,0,1,4,1
3521,200176,pzhB8LO3WWjbU215lU1c8Ly5btvgYfuP,fbPkOYLVPtPgIt0MxizjfFJov3JbHyAi,6,0,0,0,0,2,7,1,10,1.4285714285714286,1,0.0,0,0,0,0,0,2,0,7,1,0,10,1
