,enrollment_id,username,course_id,no_of_objects2,bno_access2,bno_pageclose2,bno_problem2,bno_video2,bno_discussion2,bno_navigate2,bno_wiki2,bno_total2,bno_avg2,no_of_active_days2,time_consumption2,browser_access2,browser_pageclose2,browser_problem2,browser_video2,server_access2,server_discussion2,server_problem2,server_navigate2,server_wiki2,bno_browser2,bno_server2,label
0,34,OeLBIzS0gNQ56euxy5b66gAZMzQCGE7n,7GRhBDsirIGkRZBtSMEzNTyDr2JQm4xx,37,36,11,38,11,5,12,1,114,16.285714285714285,4,-2139554.0,21,11,34,11,15,5,4,12,1,77,37,0
1,66,cGrHiRjztN9fSltHujpfWaaWfYWiidiG,7GRhBDsirIGkRZBtSMEzNTyDr2JQm4xx,38,131,10,65,11,51,15,0,283,40.42857142857143,7,0.0,42,10,52,11,89,51,13,15,0,115,168,0
2,85,OdsEBh425XZxll0hTUv04OAotDf6aGtE,7GRhBDsirIGkRZBtSMEzNTyDr2JQm4xx,10,14,4,2,3,0,5,0,28,4.0,3,0.0,1,4,2,3,13,0,0,5,0,10,18,1
3,89,Po17baTutQqG3KBkMaahpxQ7IpjhFfZa,7GRhBDsirIGkRZBtSMEzNTyDr2JQm4xx,16,22,1,34,4,8,0,0,69,9.857142857142858,2,0.0,14,1,28,4,8,8,6,0,0,47,22,1
4,145,TZOWoG0yzTTzAfx5K054mpl5rZTlZIcZ,7GRhBDsirIGkRZBtSMEzNTyDr2JQm4xx,15,29,8,12,5,0,4,1,59,8.428571428571429,2,0.0,6,8,11,5,23,0,1,4,1,30,29,1
5,163,jJZ8z8M2beLy33Z7JJbNFq1bQd8o43FV,7GRhBDsirIGkRZBtSMEzNTyDr2JQm4xx,5,9,3,0,0,1,3,0,16,2.2857142857142856,2,0.0,4,3,0,0,5,1,0,3,0,7,9,1
6,312,BCPhbcVTukJPsOtUJJbyOWvpso8GiEV1,7GRhBDsirIGkRZBtSMEzNTyDr2JQm4xx,10,19,7,5,3,24,9,0,67,9.571428571428571,5,0.0,3,7,4,3,16,24,1,9,0,17,50,0
7,384,zcVNiJm0X4Vm9oBHkuQez1iW6Hb7iAYl,7GRhBDsirIGkRZBtSMEzNTyDr2JQm4xx,31,67,26,54,15,2,3,0,167,23.857142857142858,1,0.0,39,26,50,15,28,2,4,3,0,130,37,1
8,397,9JGDpM8F0Ioe7WqwIugLWqE5Qa4gQNAo,7GRhBDsirIGkRZBtSMEzNTyDr2JQm4xx,5,0,0,0,0,0,6,0,6,0.8571428571428571,1,0.0,0,0,0,0,0,0,0,6,0,0,6,1
9,405,jWgeQ7calOYQcs5lv7T9mWy3KUSp4lwk,7GRhBDsirIGkRZBtSMEzNTyDr2JQm4xx,7,4,1,0,1,0,2,0,8,1.1428571428571428,1,0.0,0,1,0,1,4,0,0,2,0,2,6,1
10,457,LP0dfF7fyuhmmsZ61rjoy3gAmrNgZfWE,7GRhBDsirIGkRZBtSMEzNTyDr2JQm4xx,5,3,0,0,0,0,2,0,5,0.7142857142857143,1,0.0,0,0,0,0,3,0,0,2,0,0,5,1
11,488,j2rHuSroJ2LNNnea5uXtGt5k8dfNg0dE,7GRhBDsirIGkRZBtSMEzNTyDr2JQm4xx,1,0,0,0,0,0,1,0,1,0.14285714285714285,1,0.0,0,0,0,0,0,0,0,1,0,0,1,1
12,508,hbwWiZJx2DqUaUjG4c2EvTFTwMA32fWP,7GRhBDsirIGkRZBtSMEzNTyDr2JQm4xx,51,92,41,103,18,1,6,1,262,37.42857142857143,3,0.0,38,41,93,18,54,1,10,6,1,190,72,1
13,529,VjgzAw2H8q9OHgJwlSzUGU3MhKciCosm,7GRhBDsirIGkRZBtSMEzNTyDr2JQm4xx,1,0,0,0,0,0,1,0,1,0.14285714285714285,1,0.0,0,0,0,0,0,0,0,1,0,0,1,1
14,559,gZhclo8obnDdq4Hpc6ohnKIqNEyfFli3,7GRhBDsirIGkRZBtSMEzNTyDr2JQm4xx,39,49,24,47,19,0,6,0,145,20.714285714285715,2,0.0,21,24,39,19,28,0,8,6,0,103,42,1
15,571,cuuYGTWWAmhidQoRHdGzANriCatcPrlK,7GRhBDsirIGkRZBtSMEzNTyDr2JQm4xx,32,52,26,61,28,2,2,0,171,24.428571428571427,6,0.0,26,26,52,28,26,2,9,2,0,132,39,0
16,578,eER8RoiVQhlBLlO4WV7kKfWOx4XE0E9c,7GRhBDsirIGkRZBtSMEzNTyDr2JQm4xx,30,71,27,50,14,58,10,0,230,32.857142857142854,4,0.0,33,27,42,14,38,58,8,10,0,116,114,1
17,618,M5ID2aNMWGm5ShsGkFPYgTgN2UReXK8g,7GRhBDsirIGkRZBtSMEzNTyDr2JQm4xx,23,58,26,24,22,0,5,0,135,19.285714285714285,3,0.0,22,26,21,22,36,0,3,5,0,91,44,1
18,694,DVxZxPUgYsodJVtjUg4HG3ZucfJoWgwo,7GRhBDsirIGkRZBtSMEzNTyDr2JQm4xx,21,29,6,82,3,0,22,0,142,20.285714285714285,2,0.0,10,6,78,3,19,0,4,22,0,97,45,1
19,755,qVDHsjIzoOtZnTwpJtbJGpvapy4sRYpW,7GRhBDsirIGkRZBtSMEzNTyDr2JQm4xx,32,78,17,65,22,0,3,0,185,26.428571428571427,7,0.0,39,17,57,22,39,0,8,3,0,135,50,1
20,849,se5zs87qj8m5HDpiAuY9fHW8e8hfOFuJ,7GRhBDsirIGkRZBtSMEzNTyDr2JQm4xx,17,27,16,14,3,3,4,0,67,9.571428571428571,1,0.0,6,16,11,3,21,3,3,4,0,36,31,0
21,874,QpsLmP3WeC01C1T5jY6uw1yDvPjAiorO,7GRhBDsirIGkRZBtSMEzNTyDr2JQm4xx,1,0,0,0,0,0,1,0,1,0.14285714285714285,1,0.0,0,0,0,0,0,0,0,1,0,0,1,1
22,948,iYWLR7w0j5yEEe1bCu5IYYyXjnXbv448,7GRhBDsirIGkRZBtSMEzNTyDr2JQm4xx,22,49,21,11,8,26,9,4,128,18.285714285714285,5,0.0,16,21,9,8,33,26,2,9,4,54,74,0
23,998,RJ1FVW8gXQIpK321uzh2Sh69ojlsqnvg,7GRhBDsirIGkRZBtSMEzNTyDr2JQm4xx,1,0,0,0,0,0,1,0,1,0.14285714285714285,1,0.0,0,0,0,0,0,0,0,1,0,0,1,1
24,1042,ypoGZw2r9uT31DVWRK8Ak5IwBPQDf2ZW,7GRhBDsirIGkRZBtSMEzNTyDr2JQm4xx,14,62,17,12,3,3,4,0,101,14.428571428571429,2,0.0,39,17,12,3,23,3,0,4,0,71,30,1
25,1067,9XUvtVr9N38jFL9d3KSBLe5NN0NI5Xv8,7GRhBDsirIGkRZBtSMEzNTyDr2JQm4xx,1,0,0,0,0,0,2,0,2,0.2857142857142857,2,0.0,0,0,0,0,0,0,0,2,0,0,2,1
26,1130,aaJeZnIT5e0GpVZyGMksW5aGfCnXK0Ln,7GRhBDsirIGkRZBtSMEzNTyDr2JQm4xx,39,107,1,79,0,35,7,1,230,32.857142857142854,2,0.0,60,1,57,0,47,35,22,7,1,118,112,1
27,1194,WFh9KL1sDhp4NpPSjJuGtUwdjU2As3jU,7GRhBDsirIGkRZBtSMEzNTyDr2JQm4xx,17,26,5,31,2,0,5,0,69,9.857142857142858,2,0.0,14,5,31,2,12,0,0,5,0,52,17,1
28,1197,x9GXQQjoWNWecF7wnG4Lnubsxy4Sbicl,7GRhBDsirIGkRZBtSMEzNTyDr2JQm4xx,42,95,27,63,28,12,14,0,239,34.142857142857146,3,0.0,56,27,54,28,39,12,9,14,0,165,74,1
29,1293,2CIqPxwfpdleLKAwuxTPlDujU1ToKMCe,7GRhBDsirIGkRZBtSMEzNTyDr2JQm4xx,12,12,6,8,3,7,4,0,40,5.714285714285714,2,0.0,2,6,7,3,10,7,1,4,0,18,22,0
30,1298,xdVF44pcmC57LxybIN6S03WC3lkijhye,7GRhBDsirIGkRZBtSMEzNTyDr2JQm4xx,5,3,2,0,2,0,2,0,9,1.2857142857142858,1,0.0,0,2,0,2,3,0,0,2,0,4,5,0
31,1304,CSh5hGbaSFu2yCb31iVMOVwKocrH471Q,7GRhBDsirIGkRZBtSMEzNTyDr2JQm4xx,7,12,8,0,5,0,3,0,28,4.0,2,0.0,2,8,0,5,10,0,0,3,0,15,13,1
32,1327,2cWT2r9kI6XDpveso7mwMhmCGJDMpJ6X,7GRhBDsirIGkRZBtSMEzNTyDr2JQm4xx,1,0,0,0,0,0,1,0,1,0.14285714285714285,1,0.0,0,0,0,0,0,0,0,1,0,0,1,1
33,1334,BdwcZr5MO8X0sPJO0Tqucc1g1g6IA4vq,7GRhBDsirIGkRZBtSMEzNTyDr2JQm4xx,8,9,2,8,0,0,2,0,21,3.0,1,0.0,1,2,7,0,8,0,1,2,0,10,11,0
34,1395,YAuAlaDad79jVXW80O0RGtQjJBBOLDit,7GRhBDsirIGkRZBtSMEzNTyDr2JQm4xx,5,4,1,0,0,0,3,1,9,1.2857142857142858,1,0.0,1,1,0,0,3,0,0,3,1,2,7,1
35,1396,4pgEahxP0BMucPOaES4iKt1glSEl2goc,7GRhBDsirIGkRZBtSMEzNTyDr2JQm4xx,47,224,59,85,16,40,26,1,451,64.42857142857143,6,0.0,106,59,67,16,118,40,18,26,1,248,203,0
36,1434,M3xTB6LenTJvMpybZKparVtRZKzrRM1R,7GRhBDsirIGkRZBtSMEzNTyDr2JQm4xx,1,0,0,0,0,0,1,0,1,0.14285714285714285,1,0.0,0,0,0,0,0,0,0,1,0,0,1,1
37,1436,hmtOqZVjWQ6rLJb3YkFWytQIy20ogszh,7GRhBDsirIGkRZBtSMEzNTyDr2JQm4xx,20,22,6,21,9,2,6,0,66,9.428571428571429,2,0.0,12,6,18,9,10,2,3,6,0,45,21,1
38,1644,P18honwQPPbELUE86qFIATuZK3YDtjvG,7GRhBDsirIGkRZBtSMEzNTyDr2JQm4xx,28,51,4,48,5,7,5,0,120,17.142857142857142,4,0.0,29,4,38,5,22,7,10,5,0,76,44,1
39,1682,rGP2g0AMaZmMVMjLaxKJkSmzZgbB3U4e,7GRhBDsirIGkRZBtSMEzNTyDr2JQm4xx,4,0,0,0,0,0,4,0,4,0.5714285714285714,1,0.0,0,0,0,0,0,0,0,4,0,0,4,0
40,1739,MSwjf2I17FAgMFqknSNlHHVpwcQKsxyQ,7GRhBDsirIGkRZBtSMEzNTyDr2JQm4xx,17,40,8,21,16,0,1,0,86,12.285714285714286,1,0.0,18,8,17,16,22,0,4,1,0,59,27,1
41,1765,8nlNDsWSaxHCvsMKtqhBs81sknEiTCeb,7GRhBDsirIGkRZBtSMEzNTyDr2JQm4xx,17,17,8,14,6,0,3,0,48,6.857142857142857,2,0.0,4,8,11,6,13,0,3,3,0,29,19,0
42,1771,jImHfNEIObE674KdIbKVj7cCJ4ufqzHJ,7GRhBDsirIGkRZBtSMEzNTyDr2JQm4xx,18,26,12,12,3,197,22,2,274,39.142857142857146,7,0.0,11,12,9,3,15,197,3,22,2,35,239,0
43,1775,mIe8dQN3qDFpsTsivIoOXC4yOCPP2RyG,7GRhBDsirIGkRZBtSMEzNTyDr2JQm4xx,36,58,14,0,14,9,13,1,109,15.571428571428571,3,0.0,22,14,0,14,36,9,0,13,1,50,59,0
44,1808,Slk5JcZSYHmDLQZXaNVmcMDmjJ16kBhI,fbPkOYLVPtPgIt0MxizjfFJov3JbHyAi,16,42,1,16,1,16,7,0,83,11.857142857142858,5,0.0,9,1,14,1,33,16,2,7,0,25,58,1
45,1814,KVMcZ0CphnUUs4jbRYRdgMvMogJko09j,fbPkOYLVPtPgIt0MxizjfFJov3JbHyAi,38,59,38,31,13,22,14,0,177,25.285714285714285,4,0.0,12,38,26,13,47,22,5,14,0,89,88,0
46,1837,QvqMF8oqvOJDLWUvXbTcLl7n0z5cypNQ,fbPkOYLVPtPgIt0MxizjfFJov3JbHyAi,10,12,8,0,6,1,12,2,41,5.857142857142857,1,0.0,1,8,0,6,11,1,0,12,2,15,26,1
47,1848,JfQVgXDVu1NGs9lcRBOD4w6V7BSaZCc2,fbPkOYLVPtPgIt0MxizjfFJov3JbHyAi,24,26,14,18,7,12,9,0,86,12.285714285714286,3,0.0,5,14,15,7,21,12,3,9,0,41,45,0
48,1854,sjBn8oayOINN3T3JZLXHY4beCfaHLSkq,fbPkOYLVPtPgIt0MxizjfFJov3JbHyAi,4,4,1,0,0,0,1,0,6,0.8571428571428571,1,0.0,0,1,0,0,4,0,0,1,0,1,5,0
49,1855,cy2CnLMLxJkryBCEHSwR3ZMTpAjnoO1C,fbPkOYLVPtPgIt0MxizjfFJov3JbHyAi,41,109,30,10,18,331,38,1,537,76.71428571428571,6,0.0,9,30,9,18,100,331,1,38,1,66,471,0
50,1868,euJ8gpxfARpnWjt9X8Fyxm47A6A32cKl,fbPkOYLVPtPgIt0MxizjfFJov3JbHyAi,39,83,45,15,21,35,24,1,224,32.0,6,0.0,17,45,13,21,66,35,2,24,1,96,128,0
51,1877,BPWa0SjleiqllaywZCKubwGSdtmQ6n1j,fbPkOYLVPtPgIt0MxizjfFJov3JbHyAi,6,3,1,0,1,0,2,0,7,1.0,1,0.0,0,1,0,1,3,0,0,2,0,2,5,1
52,1889,9lZ5nNFJAuEwr4dRJLRoTk52o5oWJaUg,fbPkOYLVPtPgIt0MxizjfFJov3JbHyAi,24,37,20,11,9,66,20,0,163,23.285714285714285,5,0.0,7,20,10,9,30,66,1,20,0,46,117,0
53,1892,h8BwrBZ61dHhi5fhxZzTUeeYh9J3sER4,fbPkOYLVPtPgIt0MxizjfFJov3JbHyAi,17,15,11,0,7,0,3,0,36,5.142857142857143,2,0.0,0,11,0,7,15,0,0,3,0,18,18,0
54,1905,rH9yibot6cCOaAZphZeWIT7V2pydvksO,fbPkOYLVPtPgIt0MxizjfFJov3JbHyAi,5,3,2,0,1,0,1,0,7,1.0,1,0.0,0,2,0,1,3,0,0,1,0,3,4,1
55,1907,O4E7as3W8jLvygS4k9RX6VKdAkX7GkpR,fbPkOYLVPtPgIt0MxizjfFJov3JbHyAi,12,10,4,4,6,1,7,0,32,4.571428571428571,1,0.0,5,4,4,6,5,1,0,7,0,19,13,0
56,1908,uJfbc9I7P24gwBxCb4NuFSYLPcQJXbJC,fbPkOYLVPtPgIt0MxizjfFJov3JbHyAi,46,115,74,39,43,93,26,6,396,56.57142857142857,6,0.0,30,74,32,43,85,93,7,26,6,179,217,0
57,1914,Ms0MC4W5moiGJLWP7iE3FImeH9CHN4KT,fbPkOYLVPtPgIt0MxizjfFJov3JbHyAi,4,3,0,0,0,0,1,0,4,0.5714285714285714,1,0.0,0,0,0,0,3,0,0,1,0,0,4,0
58,1919,ZVE1PX7xOz79BV4QTr7JFzHx09U83o43,fbPkOYLVPtPgIt0MxizjfFJov3JbHyAi,30,83,47,12,28,16,9,1,196,28.0,4,0.0,20,47,11,28,63,16,1,9,1,106,90,0
59,1920,3Nb5o5OohsDNIgLceYbTurAWBMiIQRDh,fbPkOYLVPtPgIt0MxizjfFJov3JbHyAi,44,58,32,31,26,16,8,0,171,24.428571428571427,3,0.0,19,32,26,26,39,16,5,8,0,103,68,0
60,1924,bRmU4ghbgx16XrcSMiRmwAVngSF9Tm10,fbPkOYLVPtPgIt0MxizjfFJov3JbHyAi,3,2,0,0,0,0,1,0,3,0.42857142857142855,1,0.0,0,0,0,0,2,0,0,1,0,0,3,0
61,1925,UHEdqIfQMlcBmdDDlAACqjd4uHB22PZR,fbPkOYLVPtPgIt0MxizjfFJov3JbHyAi,7,5,3,0,0,5,3,1,17,2.4285714285714284,2,0.0,0,3,0,0,5,5,0,3,1,3,14,0
62,1927,KGKXtIu1hkHju7SCZs8gtmA9OwHIqK9w,fbPkOYLVPtPgIt0MxizjfFJov3JbHyAi,32,66,50,0,33,125,21,0,295,42.142857142857146,6,0.0,4,50,0,33,62,125,0,21,0,87,208,0
63,1937,vtrHNbtnxRGyZem1sSOdKIp109fZtSKY,fbPkOYLVPtPgIt0MxizjfFJov3JbHyAi,26,30,16,22,8,26,9,0,111,15.857142857142858,2,0.0,9,16,18,8,21,26,4,9,0,51,60,0
64,1946,oNX40hvUpCseO8BHKhGJvG2jyQpYKQyk,fbPkOYLVPtPgIt0MxizjfFJov3JbHyAi,11,15,8,4,4,7,4,0,42,6.0,2,0.0,4,8,4,4,11,7,0,4,0,20,22,0
65,3978,h8n9HekAuyT08sLL5qmdMZ3BdSJVR4QF,fbPkOYLVPtPgIt0MxizjfFJov3JbHyAi,13,16,9,0,4,18,9,0,56,8.0,2,0.0,1,9,0,4,15,18,0,9,0,14,42,0
66,3979,2GATpIfDBYFyTgYmFkr0bda9mVfNXuAl,fbPkOYLVPtPgIt0MxizjfFJov3JbHyAi,38,49,23,28,16,6,6,1,129,18.428571428571427,3,0.0,22,23,25,16,27,6,3,6,1,86,43,0
67,3983,eQnxTOv5tF733HrH1v8IIfXTQQ20WB86,fbPkOYLVPtPgIt0MxizjfFJov3JbHyAi,2,0,0,0,0,0,5,0,5,0.7142857142857143,1,0.0,0,0,0,0,0,0,0,5,0,0,5,1
68,3985,d4cb9OZbLbDBqzuhcJemwCaulhBw3XcA,fbPkOYLVPtPgIt0MxizjfFJov3JbHyAi,7,17,0,5,1,0,1,0,24,3.4285714285714284,1,0.0,6,0,4,1,11,0,1,1,0,11,13,1
69,3998,q4Yehmjs3jQT9rXdV6cXhcGjESMqINf5,fbPkOYLVPtPgIt0MxizjfFJov3JbHyAi,26,57,37,14,17,13,11,1,150,21.428571428571427,6,0.0,10,37,13,17,47,13,1,11,1,77,73,0
70,4004,guY4SSn1fy4TWThod7s2lBFrUtiOX15g,fbPkOYLVPtPgIt0MxizjfFJov3JbHyAi,9,14,6,1,5,3,5,1,35,5.0,1,0.0,5,6,1,5,9,3,0,5,1,17,18,1
71,4007,tfoakS3EMOjWuYWNRSgWZTjBxe3Mf9Te,fbPkOYLVPtPgIt0MxizjfFJov3JbHyAi,10,9,4,0,2,3,8,1,27,3.857142857142857,2,0.0,0,4,0,2,9,3,0,8,1,6,21,0
72,4008,54s32diFNl04mUbmkn3h7tEt4XEhQ65w,fbPkOYLVPtPgIt0MxizjfFJov3JbHyAi,3,2,1,0,0,0,1,0,4,0.5714285714285714,1,0.0,0,1,0,0,2,0,0,1,0,1,3,0
73,4011,cHr4Ma0WfX0OLiO7JvZC8s1q3EauwDjN,fbPkOYLVPtPgIt0MxizjfFJov3JbHyAi,22,42,16,5,16,3,8,3,93,13.285714285714286,2,0.0,15,16,4,16,27,3,1,8,3,51,42,1
74,4023,A98oANyiAwfle2kQ1TjJxeaYVrk9o9i7,fbPkOYLVPtPgIt0MxizjfFJov3JbHyAi,24,48,28,21,9,28,10,1,145,20.714285714285715,2,0.0,11,28,16,9,37,28,5,10,1,64,81,1
75,4027,WYF6gnZ4xRpre5Df26WMDKWFofwrAPRG,fbPkOYLVPtPgIt0MxizjfFJov3JbHyAi,9,40,0,4,0,0,7,0,51,7.285714285714286,3,0.0,6,0,4,0,34,0,0,7,0,10,41,1
76,4038,RZRLmBfJaLV1U3x2iNOo982VF2lx4M5E,fbPkOYLVPtPgIt0MxizjfFJov3JbHyAi,35,37,20,26,12,34,6,1,136,19.428571428571427,4,0.0,10,20,23,12,27,34,3,6,1,65,71,0
77,4050,0MTpVXdT8ASYCb3Z08epLhiKNkl8GgEQ,fbPkOYLVPtPgIt0MxizjfFJov3JbHyAi,4,3,2,0,0,0,2,0,7,1.0,1,0.0,0,2,0,0,3,0,0,2,0,2,5,1
78,4063,DYy3OcZHNqaAwRPZTK5mmyz2pajxcVFG,fbPkOYLVPtPgIt0MxizjfFJov3JbHyAi,10,6,4,8,3,0,1,0,22,3.142857142857143,2,0.0,1,4,5,3,5,0,3,1,0,13,9,1
79,4079,k6RJ44LpfDefc4BqSfb5Ks3bqRLzpbPs,fbPkOYLVPtPgIt0MxizjfFJov3JbHyAi,3,2,1,0,0,0,1,0,4,0.5714285714285714,1,0.0,0,1,0,0,2,0,0,1,0,1,3,1
80,4080,wGCry3EmryoBv7Csae49tbGzHF0lQra2,fbPkOYLVPtPgIt0MxizjfFJov3JbHyAi,1,0,0,0,0,0,1,0,1,0.14285714285714285,1,0.0,0,0,0,0,0,0,0,1,0,0,1,1
81,4082,Intzo0A8tpMyd3IA01YG1BctRIdPWdNV,fbPkOYLVPtPgIt0MxizjfFJov3JbHyAi,2,0,0,0,0,8,1,0,9,1.2857142857142858,1,0.0,0,0,0,0,0,8,0,1,0,0,9,0
82,4089,xHHwDRtwZQVvSchbI5GuritLImybQBlY,fbPkOYLVPtPgIt0MxizjfFJov3JbHyAi,8,9,6,0,2,0,3,0,20,2.857142857142857,2,0.0,0,6,0,2,9,0,0,3,0,8,12,1
83,4092,FWBo1Ve6aUEc5FnBNwSlwL8Ejasy32Ah,fbPkOYLVPtPgIt0MxizjfFJov3JbHyAi,22,148,4,21,7,31,10,0,221,31.571428571428573,5,0.0,56,4,17,7,92,31,4,10,0,84,137,1
84,4099,Rp1QUon6WyfjWJdUcBo02v2P6oL5StoN,fbPkOYLVPtPgIt0MxizjfFJov3JbHyAi,7,4,3,0,2,0,1,0,10,1.4285714285714286,1,0.0,0,3,0,2,4,0,0,1,0,5,5,0
85,4100,biOEnvJNbNmJmtnLohBToN5g3ppQrMj4,fbPkOYLVPtPgIt0MxizjfFJov3JbHyAi,26,68,15,36,19,0,4,0,142,20.285714285714285,1,0.0,29,15,30,19,39,0,6,4,0,93,49,0
86,4102,DQcZziMBGJTQn4VwY66mMsTqydvYxO88,fbPkOYLVPtPgIt0MxizjfFJov3JbHyAi,9,9,3,3,3,0,1,0,19,2.7142857142857144,1,0.0,4,3,2,3,5,0,1,1,0,12,7,1
87,4107,hXZgc5Oc8L3KNvO8ElQE29RF6Exzr76M,fbPkOYLVPtPgIt0MxizjfFJov3JbHyAi,24,89,0,20,2,20,14,1,146,20.857142857142858,5,0.0,29,0,18,2,60,20,2,14,1,49,97,1
88,4123,v5fgLzwSp4csuplvg9kjWtplfkZ2GwCX,fbPkOYLVPtPgIt0MxizjfFJov3JbHyAi,23,31,17,25,10,39,7,0,129,18.428571428571427,3,0.0,9,17,23,10,22,39,2,7,0,59,70,1
89,4144,8FXCmdqVnzf3TYAPHoGg8tXyARiNLHCI,fbPkOYLVPtPgIt0MxizjfFJov3JbHyAi,5,3,2,0,1,0,1,0,7,1.0,1,0.0,0,2,0,1,3,0,0,1,0,3,4,1
90,4153,9bv4TssyKs6woXSaEFvigyhEyIkdO1mQ,fbPkOYLVPtPgIt0MxizjfFJov3JbHyAi,6,7,0,4,0,0,1,0,12,1.7142857142857142,1,0.0,1,0,4,0,6,0,0,1,0,5,7,1
91,4154,P7HoHyQzVXLghYr6m3MYTEIsDQbHfDfp,fbPkOYLVPtPgIt0MxizjfFJov3JbHyAi,7,5,3,0,2,0,2,0,12,1.7142857142857142,1,0.0,1,3,0,2,4,0,0,2,0,6,6,1
92,4156,7wnX5auEB03UpnNYej7D6uFMFlr0UMF4,fbPkOYLVPtPgIt0MxizjfFJov3JbHyAi,24,45,14,14,13,14,9,0,109,15.571428571428571,2,0.0,18,14,13,13,27,14,1,9,0,58,51,1
93,4158,i2lUV72IHqqXWYqLFMWv3y4XGmlq2lXa,fbPkOYLVPtPgIt0MxizjfFJov3JbHyAi,14,23,11,18,0,0,4,0,56,8.0,3,0.0,5,11,17,0,18,0,1,4,0,33,23,0
94,4166,bUnyK1hKhmXoEcHzbj5c3xR9U7XUAY5Y,fbPkOYLVPtPgIt0MxizjfFJov3JbHyAi,5,2,1,5,0,0,0,0,8,1.1428571428571428,2,0.0,0,1,4,0,2,0,1,0,0,5,3,1
95,4188,Em0hjKXRkhdtpThrexhSS4wvCtqaUFMH,SpATywNh6bZuzm8s1ceuBUnMUAeoAHHw,6,3,2,0,2,0,2,0,9,1.2857142857142858,1,0.0,0,2,0,2,3,0,0,2,0,4,5,0
96,4189,DMRT6aSto1hsV85RHmev1d5IWcNMIFEq,SpATywNh6bZuzm8s1ceuBUnMUAeoAHHw,10,18,4,0,2,0,2,0,26,3.7142857142857144,1,0.0,0,4,0,2,18,0,0,2,0,6,20,0
97,4191,s0DIFg7W3dnddXITKcNP8LHUkKIQHugk,A3fsA9Zfv1X2fVEQhTw51lKENdNrEqT3,34,23,13,36,10,0,5,1,88,12.571428571428571,5,0.0,1,13,35,10,22,0,1,5,1,59,29,0
98,4240,bN6JhUz4s97Xsh7eq2ZH1ilTMaKJDuUF,A3fsA9Zfv1X2fVEQhTw51lKENdNrEqT3,30,41,6,76,1,5,9,0,138,19.714285714285715,5,0.0,3,6,59,1,38,5,17,9,0,69,69,1
99,4257,7FYMj2bFfaTXHKfoaKa59KqAPXY4BWgD,SpATywNh6bZuzm8s1ceuBUnMUAeoAHHw,17,19,11,16,4,0,11,0,61,8.714285714285714,5,0.0,2,11,15,4,17,0,1,11,0,32,29,0
100,4264,I91CCtQfetYUPwkEXIvTFBP6tbrp1spN,SpATywNh6bZuzm8s1ceuBUnMUAeoAHHw,31,37,18,14,12,2,5,1,89,12.714285714285714,2,0.0,16,18,13,12,21,2,1,5,1,59,30,0
101,4267,RGl45e2VVMMdpatWhMc5IOKclnuxXpA1,SpATywNh6bZuzm8s1ceuBUnMUAeoAHHw,13,7,6,8,3,0,9,0,33,4.714285714285714,1,0.0,1,6,6,3,6,0,2,9,0,16,17,0
102,4289,zEiNHlokNuJTLVoV4Hy4kJd9kzaIjztD,G8EPVSXsOYB5YQWZGiz1aVq5Pgr2GrQu,66,131,37,116,25,40,7,0,356,50.857142857142854,5,0.0,59,37,77,25,72,40,39,7,0,198,158,1
103,4315,BQkLFspAkEwZRgeuoSbQxFTr6POAaRzP,SpATywNh6bZuzm8s1ceuBUnMUAeoAHHw,8,9,2,15,0,0,5,0,31,4.428571428571429,2,0.0,6,2,15,0,3,0,0,5,0,23,8,0
104,4363,TQnfaXCRCgVZx9kYYn4s6Q3eXGXW2mAu,SpATywNh6bZuzm8s1ceuBUnMUAeoAHHw,17,23,10,18,5,1,4,0,61,8.714285714285714,2,0.0,5,10,15,5,18,1,3,4,0,35,26,0
105,4367,5I2aLwWP8vG6g175Y3fJi9X9n53v6aCn,SpATywNh6bZuzm8s1ceuBUnMUAeoAHHw,20,29,15,18,6,167,33,0,268,38.285714285714285,6,0.0,4,15,15,6,25,167,3,33,0,40,228,1
106,4380,5GeMwmyzCXMcMYfcWdKaXbpNNdL8bmPq,bWdj2GDclj5ofokWjzoa5jAwMkxCykd6,26,23,16,96,2,166,28,1,332,47.42857142857143,2,0.0,3,16,75,2,20,166,21,28,1,96,236,0
107,4385,wzrtLsMLUwSE1eXDXVMESg2JjrWZl4JD,SpATywNh6bZuzm8s1ceuBUnMUAeoAHHw,5,9,5,0,0,0,1,0,15,2.142857142857143,3,0.0,3,5,0,0,6,0,0,1,0,8,7,0
108,4417,0wJhtCWK60WPCeRF62m8T80DtNpWhRrg,A3fsA9Zfv1X2fVEQhTw51lKENdNrEqT3,44,30,15,72,12,0,5,0,134,19.142857142857142,3,0.0,1,15,69,12,29,0,3,5,0,97,37,1
109,4427,8DDe6pT3DTsk8IoUaxeHbA3kSbfeV3pT,SpATywNh6bZuzm8s1ceuBUnMUAeoAHHw,6,1,1,0,1,0,6,0,9,1.2857142857142858,1,0.0,0,1,0,1,1,0,0,6,0,2,7,1
110,4429,BKMLDrZrwnjIMy3sAyFHQhrFM6liXbvY,SpATywNh6bZuzm8s1ceuBUnMUAeoAHHw,11,14,0,12,0,0,2,0,28,4.0,1,0.0,7,0,12,0,7,0,0,2,0,19,9,1
111,4471,lEIFkqeT396JMSPUyiaHNMN8g7bQ1x9p,RXDvfPUBYFlVdlueBFbLW0mhhAyGEqpt,6,3,0,0,0,0,7,1,11,1.5714285714285714,2,0.0,0,0,0,0,3,0,0,7,1,0,11,0
112,4492,800Nw5pvfdV7zCXCGav7KOLaYLAdOKht,SpATywNh6bZuzm8s1ceuBUnMUAeoAHHw,13,13,0,9,0,0,3,0,25,3.5714285714285716,1,0.0,4,0,9,0,9,0,0,3,0,13,12,0
113,4494,wONMmUHIYwPBmEB9lgpOY3KCldKiuZFl,G8EPVSXsOYB5YQWZGiz1aVq5Pgr2GrQu,17,15,8,2,7,0,5,0,37,5.285714285714286,2,0.0,6,8,2,7,9,0,0,5,0,23,14,0
114,4503,JJDRXXLRU75H8Dx2cuK7Td1V7D7QoKg9,SpATywNh6bZuzm8s1ceuBUnMUAeoAHHw,13,12,1,0,1,2,8,1,25,3.5714285714285716,2,0.0,3,1,0,1,9,2,0,8,1,5,20,0
115,4529,DB1URyLII1znnmxnZlmmkOEalzIpmvtZ,A3fsA9Zfv1X2fVEQhTw51lKENdNrEqT3,18,18,9,0,5,0,6,0,38,5.428571428571429,1,0.0,0,9,0,5,18,0,0,6,0,14,24,1
116,4557,s4xNNQ4RZ35amMfmvZawsu7u8CabnIey,A3fsA9Zfv1X2fVEQhTw51lKENdNrEqT3,6,5,2,0,0,8,8,0,23,3.2857142857142856,2,0.0,0,2,0,0,5,8,0,8,0,2,21,0
117,4558,oxOzo82Nq65tcwE6AZvxglw3lN8SeywJ,A3fsA9Zfv1X2fVEQhTw51lKENdNrEqT3,18,13,11,0,8,0,2,0,34,4.857142857142857,1,0.0,0,11,0,8,13,0,0,2,0,19,15,1
118,4562,sOkc0wEXSSLpxtxlqjZObJqg94IyLpuY,bWdj2GDclj5ofokWjzoa5jAwMkxCykd6,22,28,0,58,0,0,9,0,95,13.571428571428571,3,0.0,2,0,49,0,26,0,9,9,0,51,44,1
119,4580,PUW0i4IuafllkJEtV0GCqmTDeLHkDmH3,A3fsA9Zfv1X2fVEQhTw51lKENdNrEqT3,30,42,22,92,6,60,13,0,235,33.57142857142857,4,0.0,1,22,74,6,41,60,18,13,0,103,132,0
120,4609,UqksMVZ1lLvn2u7s6dT9SU5OFeNJnaAy,A3fsA9Zfv1X2fVEQhTw51lKENdNrEqT3,45,73,34,42,21,3,9,2,184,26.285714285714285,4,0.0,4,34,38,21,69,3,4,9,2,97,87,1
121,4639,3OcDTnCwcizCpcOtz2UR6tflsBOvlv2R,SpATywNh6bZuzm8s1ceuBUnMUAeoAHHw,16,25,2,19,0,0,11,0,57,8.142857142857142,4,0.0,6,2,18,0,19,0,1,11,0,26,31,0
122,4653,IeSddciCla7lkuGxlh3rPQuCAXyzOV2D,SpATywNh6bZuzm8s1ceuBUnMUAeoAHHw,18,34,12,19,8,7,4,0,84,12.0,2,0.0,20,12,18,8,14,7,1,4,0,58,26,1
123,4654,DsHgWZRTJ1y1l15smwhB78ZQq3d8dyKP,SpATywNh6bZuzm8s1ceuBUnMUAeoAHHw,13,17,2,15,1,0,3,0,38,5.428571428571429,3,0.0,2,2,14,1,15,0,1,3,0,19,19,0
124,4668,r5RSR6lot2jmkfKvV1hMDjuwwaPyA58W,SpATywNh6bZuzm8s1ceuBUnMUAeoAHHw,17,35,2,21,3,0,5,0,66,9.428571428571429,3,0.0,21,2,17,3,14,0,4,5,0,43,23,0
125,4678,SXmv5BCLsa8KcmJ2wx7Xg5CRI8Gu1aDd,bWdj2GDclj5ofokWjzoa5jAwMkxCykd6,7,8,4,0,1,0,2,0,15,2.142857142857143,2,0.0,0,4,0,1,8,0,0,2,0,5,10,0
126,4699,7xdvqdjwrTcnpU47VRFtnMnSYVyjOAaR,SpATywNh6bZuzm8s1ceuBUnMUAeoAHHw,13,17,2,14,0,0,3,0,36,5.142857142857143,1,0.0,2,2,13,0,15,0,1,3,0,17,19,0
127,4701,eg4vjaGd0e6Yp3fu5azU2ZqedIZ6GBxl,SpATywNh6bZuzm8s1ceuBUnMUAeoAHHw,13,13,0,14,0,7,6,0,40,5.714285714285714,1,0.0,5,0,11,0,8,7,3,6,0,16,24,0
128,4703,C8ZlatATbcer8D4Z8pCX4rv1Rcx870po,RXDvfPUBYFlVdlueBFbLW0mhhAyGEqpt,24,16,9,18,3,5,7,7,65,9.285714285714286,1,0.0,3,9,18,3,13,5,0,7,7,33,32,0
129,4778,xcD6YWhnGA2xukGmX4eaYrm6VS9ffz1H,G8EPVSXsOYB5YQWZGiz1aVq5Pgr2GrQu,26,44,24,36,5,3,10,0,122,17.428571428571427,1,0.0,13,24,26,5,31,3,10,10,0,68,54,0
130,4810,2LtuchYgE8Pco2t6mZeF2PkyT5iYJ1L1,SpATywNh6bZuzm8s1ceuBUnMUAeoAHHw,9,7,4,0,2,2,3,0,18,2.5714285714285716,2,0.0,0,4,0,2,7,2,0,3,0,6,12,0
131,4814,SmONSyS4YgG4Afnv6ZxU81t7p4CQPV5P,A3fsA9Zfv1X2fVEQhTw51lKENdNrEqT3,29,48,11,16,8,0,6,0,89,12.714285714285714,4,0.0,0,11,13,8,48,0,3,6,0,32,57,1
132,4862,9k6Repn2h6zXTygwvpy8LAM7GzTSYQBm,G8EPVSXsOYB5YQWZGiz1aVq5Pgr2GrQu,14,15,9,3,5,0,7,1,40,5.714285714285714,2,0.0,3,9,2,5,12,0,1,7,1,19,21,0
133,4866,GmHJt2279LUj6P2OGQD6V5Y1W95kmZpl,SpATywNh6bZuzm8s1ceuBUnMUAeoAHHw,13,22,5,7,4,0,2,0,40,5.714285714285714,3,0.0,0,5,6,4,22,0,1,2,0,15,25,1
134,4870,T2tyjiaDe9s4tWUugE6FZTShWofnfMqo,bWdj2GDclj5ofokWjzoa5jAwMkxCykd6,16,42,4,50,8,27,5,0,136,19.428571428571427,4,0.0,13,4,47,8,29,27,3,5,0,72,64,0
135,4885,sOkc0wEXSSLpxtxlqjZObJqg94IyLpuY,A3fsA9Zfv1X2fVEQhTw51lKENdNrEqT3,34,41,2,66,1,18,21,0,149,21.285714285714285,5,0.0,3,2,59,1,38,18,7,21,0,65,84,0
136,4912,gVGEUb9jfMmddRlcGqXsnz4ZV26w6q4e,SpATywNh6bZuzm8s1ceuBUnMUAeoAHHw,12,11,7,9,4,0,1,0,32,4.571428571428571,1,0.0,3,7,7,4,8,0,2,1,0,21,11,0
137,4918,QDpN8D19Mr8RZumTONWpZNlCWcHCCTbH,A3fsA9Zfv1X2fVEQhTw51lKENdNrEqT3,18,42,5,0,1,0,5,0,53,7.571428571428571,4,0.0,0,5,0,1,42,0,0,5,0,6,47,0
138,4945,ySy2zYThCkVZr5MjEXuKxq60wfOynxkJ,SpATywNh6bZuzm8s1ceuBUnMUAeoAHHw,15,22,1,14,1,18,7,0,63,9.0,3,0.0,2,1,13,1,20,18,1,7,0,17,46,0
139,4946,SVwfCRY50hd9Fz0klab9XqT7QROcyhqY,SpATywNh6bZuzm8s1ceuBUnMUAeoAHHw,16,22,10,18,5,6,5,0,66,9.428571428571429,1,0.0,10,10,15,5,12,6,3,5,0,40,26,0
140,4953,VZdYnvKDyQlSbZcXkY9T9OB3rX2Vy7uz,SpATywNh6bZuzm8s1ceuBUnMUAeoAHHw,2,0,0,0,0,0,2,0,2,0.2857142857142857,1,0.0,0,0,0,0,0,0,0,2,0,0,2,1
141,4981,syrttArug8Mpzs9L0IHsvBtATawYF9J2,bWdj2GDclj5ofokWjzoa5jAwMkxCykd6,39,34,12,93,15,14,6,1,175,25.0,1,0.0,20,12,76,15,14,14,17,6,1,123,52,0
142,4991,meJV5qRzmJA836PpWZKeoFo4ZX1xiQOS,RXDvfPUBYFlVdlueBFbLW0mhhAyGEqpt,5,3,2,0,1,0,0,0,6,0.8571428571428571,1,0.0,0,2,0,1,3,0,0,0,0,3,3,1
143,5020,7kNYuUNvdIVdadzDsnKIKM0Ln3KLHYo2,SpATywNh6bZuzm8s1ceuBUnMUAeoAHHw,19,43,22,8,6,0,18,0,97,13.857142857142858,5,0.0,6,22,7,6,37,0,1,18,0,41,56,1
144,5022,QCXbyb2FyuLlETPxf3u27tgIYTs9gTM4,SpATywNh6bZuzm8s1ceuBUnMUAeoAHHw,12,15,10,0,2,4,4,0,35,5.0,1,0.0,2,10,0,2,13,4,0,4,0,14,21,0
145,5031,6Qw49dxLKsjbapN7r9Da43ajoDW7rCxT,G8EPVSXsOYB5YQWZGiz1aVq5Pgr2GrQu,13,17,10,2,4,132,2,0,167,23.857142857142858,5,0.0,0,10,1,4,17,132,1,2,0,15,152,0
146,5069,pOySDxOmbrI0pDd4UMGfMc77U1VB32Te,A3fsA9Zfv1X2fVEQhTw51lKENdNrEqT3,2,0,0,0,0,0,2,0,2,0.2857142857142857,1,0.0,0,0,0,0,0,0,0,2,0,0,2,1
147,5082,rVF6sxySmleXKBlMsWpXjKDnmQNSzrnS,G8EPVSXsOYB5YQWZGiz1aVq5Pgr2GrQu,40,51,24,64,10,1,26,1,177,25.285714285714285,3,0.0,20,24,47,10,31,1,17,26,1,101,76,0
148,5096,rsMqzQV4BJo2NdhTX79HDXS5zRZgLPX5,SpATywNh6bZuzm8s1ceuBUnMUAeoAHHw,10,3,3,0,3,0,5,0,14,2.0,1,0.0,0,3,0,3,3,0,0,5,0,6,8,0
149,5142,B6vCUtkVL8SVuEEWctSPinCUr9rxihnh,G8EPVSXsOYB5YQWZGiz1aVq5Pgr2GrQu,42,72,32,82,16,18,10,1,231,33.0,2,0.0,31,32,62,16,41,18,20,10,1,141,90,0
150,5152,RZI7KROUR7i2T6MB71TuoKGbXE5WXiwO,bWdj2GDclj5ofokWjzoa5jAwMkxCykd6,6,8,0,0,0,0,3,0,11,1.5714285714285714,1,0.0,0,0,0,0,8,0,0,3,0,0,11,1
151,5153,JiVwV8l6zLIAeTDli3uYE3CMxT1oG8Me,SpATywNh6bZuzm8s1ceuBUnMUAeoAHHw,10,22,3,0,1,0,12,0,38,5.428571428571429,3,0.0,1,3,0,1,21,0,0,12,0,5,33,0
152,5173,d6aHeIWZcsirh8eDlHrmG2KrUzDWnJuj,A3fsA9Zfv1X2fVEQhTw51lKENdNrEqT3,13,13,9,0,7,0,5,0,34,4.857142857142857,1,0.0,0,9,0,7,13,0,0,5,0,16,18,1
153,5217,EP1XQRGS4HZOG1hdGzNZdD1HFhJcHpos,RXDvfPUBYFlVdlueBFbLW0mhhAyGEqpt,22,23,3,28,0,16,6,0,76,10.857142857142858,2,0.0,6,3,26,0,17,16,2,6,0,35,41,0
154,5224,vEkraIjbJw9RkPvqczZeJYSVVtpO2PkE,G8EPVSXsOYB5YQWZGiz1aVq5Pgr2GrQu,11,5,4,0,4,0,3,0,16,2.2857142857142856,1,0.0,0,4,0,4,5,0,0,3,0,8,8,1
155,5259,hdKqkkWKrDzbKE9btGChBqiCfsTwp68E,bWdj2GDclj5ofokWjzoa5jAwMkxCykd6,25,38,21,92,7,150,36,2,346,49.42857142857143,6,0.0,4,21,84,7,34,150,8,36,2,116,230,0
156,5279,cs5iJZEgrhw6pymo9S5BmSlmIVmjOxuC,A3fsA9Zfv1X2fVEQhTw51lKENdNrEqT3,4,2,1,0,1,0,1,0,5,0.7142857142857143,1,0.0,0,1,0,1,2,0,0,1,0,2,3,1
157,5303,o9EVHnUUU8I3f9dlC8NAcnHlKvZOnRmy,bWdj2GDclj5ofokWjzoa5jAwMkxCykd6,7,7,1,0,1,0,2,0,11,1.5714285714285714,2,0.0,0,1,0,1,7,0,0,2,0,2,9,0
158,5305,o9EVHnUUU8I3f9dlC8NAcnHlKvZOnRmy,A3fsA9Zfv1X2fVEQhTw51lKENdNrEqT3,29,25,1,52,0,7,8,0,93,13.285714285714286,4,0.0,1,1,47,0,24,7,5,8,0,49,44,0
159,5310,OMEL4ay2FeLAUvBpF5PNfopRFoBTNYW8,SpATywNh6bZuzm8s1ceuBUnMUAeoAHHw,6,11,0,0,0,0,2,0,13,1.8571428571428572,1,0.0,4,0,0,0,7,0,0,2,0,4,9,0
160,5332,DJ09O49b2a0ZKXkFKbGfN66X8003c5sz,SpATywNh6bZuzm8s1ceuBUnMUAeoAHHw,10,13,12,0,9,0,1,0,35,5.0,1,0.0,0,12,0,9,13,0,0,1,0,21,14,1
161,5340,oDnQYjxji4p3XVFJMOGI9NvIvASqoqC1,SpATywNh6bZuzm8s1ceuBUnMUAeoAHHw,2,0,0,0,0,0,3,0,3,0.42857142857142855,2,0.0,0,0,0,0,0,0,0,3,0,0,3,1
162,5345,Kssd3yKtVgKi0ua0svvR8GgbZwRwIJMZ,SpATywNh6bZuzm8s1ceuBUnMUAeoAHHw,13,26,7,6,2,0,2,0,43,6.142857142857143,5,0.0,2,7,6,2,24,0,0,2,0,17,26,0
163,5363,WXWUGznWk133hcEltnw7lYbm2oVZoXLf,SpATywNh6bZuzm8s1ceuBUnMUAeoAHHw,17,30,12,6,3,3,18,0,72,10.285714285714286,4,0.0,2,12,6,3,28,3,0,18,0,23,49,1
164,5389,cd7VGHrZb4Blwr9YuFp9MqF71m5wWUVd,G8EPVSXsOYB5YQWZGiz1aVq5Pgr2GrQu,2,0,0,0,0,0,2,0,2,0.2857142857142857,1,0.0,0,0,0,0,0,0,0,2,0,0,2,0
165,5390,NL3IFunZJHMkqSLqiaHHbVIge1Bdgn26,G8EPVSXsOYB5YQWZGiz1aVq5Pgr2GrQu,8,7,2,4,1,0,1,0,15,2.142857142857143,1,0.0,3,2,2,1,4,0,2,1,0,8,7,0
166,5392,Tj9gyzxktEEAGnL07HQ3qbd2V0oCt16o,SpATywNh6bZuzm8s1ceuBUnMUAeoAHHw,23,63,32,24,11,17,19,0,166,23.714285714285715,2,0.0,16,32,18,11,47,17,6,19,0,77,89,0
167,5397,I6gFU4rZZ1rIaEMk0n0tBNQZ2tGcnjLw,SpATywNh6bZuzm8s1ceuBUnMUAeoAHHw,14,14,5,19,3,0,4,0,45,6.428571428571429,1,0.0,9,5,15,3,5,0,4,4,0,32,13,0
168,5414,4qM7n65VbCTp8lq3dbzhDmImmEZcwgn8,A3fsA9Zfv1X2fVEQhTw51lKENdNrEqT3,32,43,3,118,0,120,25,1,310,44.285714285714285,5,0.0,2,3,99,0,41,120,19,25,1,104,206,0
169,5454,3ZzNkdWgGb47Go07PRKPf0XZ6jjhVCB4,bWdj2GDclj5ofokWjzoa5jAwMkxCykd6,15,23,12,24,6,43,8,0,116,16.571428571428573,3,0.0,5,12,20,6,18,43,4,8,0,43,73,0
170,5458,YOkiW0yIzjAwppKQnKaeEhWktVPNCIFb,A3fsA9Zfv1X2fVEQhTw51lKENdNrEqT3,28,17,13,44,5,1,18,1,99,14.142857142857142,4,0.0,1,13,35,5,16,1,9,18,1,54,45,1
171,5469,fn3RgMp4JCABnOK3IDXz6cUAXpmeuiYQ,SpATywNh6bZuzm8s1ceuBUnMUAeoAHHw,20,18,14,0,10,1,5,0,48,6.857142857142857,2,0.0,0,14,0,10,18,1,0,5,0,24,24,1
172,5472,OLX98cHycOH1FdInwYYk8PZBVFPyIkIG,SpATywNh6bZuzm8s1ceuBUnMUAeoAHHw,7,7,5,0,1,0,3,0,16,2.2857142857142856,2,0.0,0,5,0,1,7,0,0,3,0,6,10,0
173,5487,gqe5NXbZbf5uXY0rPviLeIFOMpQyekdp,SpATywNh6bZuzm8s1ceuBUnMUAeoAHHw,8,5,1,0,0,0,5,0,11,1.5714285714285714,1,0.0,0,1,0,0,5,0,0,5,0,1,10,1
174,5498,F2owRK2SDPW5FCDK4TxmBVHsTtJ44Nxq,bWdj2GDclj5ofokWjzoa5jAwMkxCykd6,7,11,0,0,1,0,5,0,17,2.4285714285714284,3,0.0,0,0,0,1,11,0,0,5,0,1,16,1
175,5499,F2owRK2SDPW5FCDK4TxmBVHsTtJ44Nxq,SpATywNh6bZuzm8s1ceuBUnMUAeoAHHw,7,5,1,0,1,0,1,0,8,1.1428571428571428,1,0.0,0,1,0,1,5,0,0,1,0,2,6,1
176,5554,C6xrhZPOmVH2gCVNP26gSSPka2CcwgB5,A3fsA9Zfv1X2fVEQhTw51lKENdNrEqT3,60,25,17,90,12,0,8,0,152,21.714285714285715,3,0.0,8,17,89,12,17,0,1,8,0,126,26,1
177,5573,GdXLROZTUYTypGrrX0BjPE53M0Un36D7,SpATywNh6bZuzm8s1ceuBUnMUAeoAHHw,16,35,0,8,0,0,3,0,46,6.571428571428571,1,0.0,18,0,8,0,17,0,0,3,0,26,20,1
178,5582,kKBIfyZmN22zBj263eKBa0SA1U5xYMsR,SpATywNh6bZuzm8s1ceuBUnMUAeoAHHw,21,73,6,7,5,53,6,0,150,21.428571428571427,3,0.0,8,6,7,5,65,53,0,6,0,26,124,0
179,5605,k2w7Fl2HRg9SZoDIHFnK8RXCKuBBE2y7,bWdj2GDclj5ofokWjzoa5jAwMkxCykd6,24,41,21,43,2,49,31,2,189,27.0,7,0.0,2,21,40,2,39,49,3,31,2,65,124,0
180,5620,ZOxTwY2wRpdYn3qbKBoyT1PgdUitZ7Hl,RXDvfPUBYFlVdlueBFbLW0mhhAyGEqpt,21,25,18,2,8,6,7,0,66,9.428571428571429,1,0.0,0,18,2,8,25,6,0,7,0,28,38,1
181,5645,UCDPR1k7RkPBDIde3KiukiosB55WbRVo,A3fsA9Zfv1X2fVEQhTw51lKENdNrEqT3,5,3,2,0,1,0,2,0,8,1.1428571428571428,1,0.0,0,2,0,1,3,0,0,2,0,3,5,1
182,5669,HbDaABEakQmE8DQEoFoIphu2SH13rFRy,SpATywNh6bZuzm8s1ceuBUnMUAeoAHHw,28,48,30,16,13,4,5,0,116,16.571428571428573,3,0.0,12,30,15,13,36,4,1,5,0,70,46,0
183,5692,KtQYnyrETXqJCvCxj7ZUnFcjZBBdiT7G,SpATywNh6bZuzm8s1ceuBUnMUAeoAHHw,18,17,11,14,5,0,5,0,52,7.428571428571429,1,0.0,2,11,13,5,15,0,1,5,0,31,21,0
184,5726,tzyyAYK7Q2hNPhv988H6lH5D7hdM24rK,SpATywNh6bZuzm8s1ceuBUnMUAeoAHHw,18,15,7,12,3,4,6,0,47,6.714285714285714,2,0.0,5,7,12,3,10,4,0,6,0,27,20,0
185,5745,PpMDt0ql3KtH4YMuxusWOnbL4LfspwvV,A3fsA9Zfv1X2fVEQhTw51lKENdNrEqT3,31,29,18,68,3,28,10,0,156,22.285714285714285,5,0.0,2,18,57,3,27,28,11,10,0,80,76,1
186,5775,TO8Y79YghtROlTlvlXU7LRtpWyGNF6ec,SpATywNh6bZuzm8s1ceuBUnMUAeoAHHw,3,2,0,0,0,0,1,0,3,0.42857142857142855,1,0.0,0,0,0,0,2,0,0,1,0,0,3,1
187,5778,A3AW3c7i1MF6oyHBEYvrXWvBxZwqeuYh,SpATywNh6bZuzm8s1ceuBUnMUAeoAHHw,1,0,0,0,0,0,1,0,1,0.14285714285714285,1,0.0,0,0,0,0,0,0,0,1,0,0,1,0
188,5782,hjUSUM6roI2mLGkMAqBjE0uxFRBSMYHJ,A3fsA9Zfv1X2fVEQhTw51lKENdNrEqT3,39,17,11,84,3,0,6,0,121,17.285714285714285,2,0.0,2,11,73,3,15,0,11,6,0,89,32,1
189,5859,pGMnNtuqcZlCojrlW4Qh2PIHblJQmotx,SpATywNh6bZuzm8s1ceuBUnMUAeoAHHw,18,11,8,13,5,0,3,0,40,5.714285714285714,1,0.0,2,8,13,5,9,0,0,3,0,28,12,1
190,5889,Oe7zyPdqUKEu4xpqbiVxJiAwdUxxeOQv,A3fsA9Zfv1X2fVEQhTw51lKENdNrEqT3,8,12,7,0,3,0,12,0,34,4.857142857142857,2,0.0,0,7,0,3,12,0,0,12,0,10,24,1
191,5904,L4jaFu0vxNsfaC1OhafSk08ztmq6goZk,SpATywNh6bZuzm8s1ceuBUnMUAeoAHHw,12,14,7,0,4,0,7,0,32,4.571428571428571,1,0.0,0,7,0,4,14,0,0,7,0,11,21,0
192,5925,sc5S8mzwcw7LbcetViv5Dahuhyet4uF1,A3fsA9Zfv1X2fVEQhTw51lKENdNrEqT3,13,17,12,20,0,16,14,1,80,11.428571428571429,2,0.0,1,12,17,0,16,16,3,14,1,30,50,1
193,5928,QJQFN1rOmy0JEkg26kEuCjYYvoywuFFu,A3fsA9Zfv1X2fVEQhTw51lKENdNrEqT3,5,2,1,0,1,0,2,0,6,0.8571428571428571,2,0.0,0,1,0,1,2,0,0,2,0,2,4,1
194,6000,2mD1u3b1vLrSJM0DZTrsvLcZVBVwwd27,RXDvfPUBYFlVdlueBFbLW0mhhAyGEqpt,7,8,7,0,5,0,0,0,20,2.857142857142857,4,0.0,0,7,0,5,8,0,0,0,0,12,8,0
195,6010,gEPTO2jN7POX6QtJlMdktFPT74irRyFu,SpATywNh6bZuzm8s1ceuBUnMUAeoAHHw,10,9,1,12,0,0,1,0,23,3.2857142857142856,2,0.0,2,1,12,0,7,0,0,1,0,15,8,0
196,6074,xQWsagZWr4hwuLscur4NAIFNIWIrJTay,RXDvfPUBYFlVdlueBFbLW0mhhAyGEqpt,12,9,9,0,4,0,8,0,30,4.285714285714286,1,0.0,0,9,0,4,9,0,0,8,0,13,17,0
197,6075,4pJCNd3c3ApEtuK2GDe7eGNzOhsu04W5,G8EPVSXsOYB5YQWZGiz1aVq5Pgr2GrQu,14,24,9,6,0,47,18,0,104,14.857142857142858,5,0.0,2,9,5,0,22,47,1,18,0,16,88,0
198,6102,DJPrQ8k1R0aSF2q32X8eWoHfRxJjw6WA,SpATywNh6bZuzm8s1ceuBUnMUAeoAHHw,23,29,11,41,3,15,8,1,108,15.428571428571429,1,0.0,13,11,35,3,16,15,6,8,1,62,46,1
199,6105,lVM3D8yPmd62Fdb29hI2YI0VPwlNvI4t,A3fsA9Zfv1X2fVEQhTw51lKENdNrEqT3,16,10,7,0,7,0,6,0,30,4.285714285714286,2,0.0,2,7,0,7,8,0,0,6,0,16,14,1
200,6108,WWWH5rGgnKzcRMEBKWqCKBbIYZVZp9Wi,SpATywNh6bZuzm8s1ceuBUnMUAeoAHHw,19,31,1,18,0,7,4,0,61,8.714285714285714,2,0.0,11,1,16,0,20,7,2,4,0,28,33,0
201,6123,onsmNYIoPFEi185f5ZLsQXD70I3K25Cb,A3fsA9Zfv1X2fVEQhTw51lKENdNrEqT3,6,4,3,0,1,0,1,0,9,1.2857142857142858,1,0.0,0,3,0,1,4,0,0,1,0,4,5,1
202,6134,UhLO5kko2VQ90AI2af3XOU7N46nRv9TM,SpATywNh6bZuzm8s1ceuBUnMUAeoAHHw,11,12,4,18,5,1,17,1,58,8.285714285714286,2,0.0,6,4,17,5,6,1,1,17,1,32,26,0
203,6140,IBg4xmPqhTfP3qhSQ0m2yOJeGxXoGyqu,RXDvfPUBYFlVdlueBFbLW0mhhAyGEqpt,2,0,0,0,0,47,4,0,51,7.285714285714286,1,0.0,0,0,0,0,0,47,0,4,0,0,51,0
204,6192,uFKxt8ud4wgPXsnEMlnj4koWPrsJIWsU,SpATywNh6bZuzm8s1ceuBUnMUAeoAHHw,18,25,16,6,7,2,15,0,71,10.142857142857142,2,0.0,3,16,6,7,22,2,0,15,0,32,39,0
205,6220,hyKcsvbAZrS0MucDsyUSihT6aOgvgztm,A3fsA9Zfv1X2fVEQhTw51lKENdNrEqT3,8,9,4,0,4,0,1,0,18,2.5714285714285716,1,0.0,0,4,0,4,9,0,0,1,0,8,10,1
206,6240,IkJ5dxCbqNRxBRuENFqjes2Z4rIDUrXn,SpATywNh6bZuzm8s1ceuBUnMUAeoAHHw,31,45,16,43,9,13,7,0,133,19.0,2,0.0,22,16,35,9,23,13,8,7,0,82,51,0
207,6271,q2xQCstASp96wpspi8iqsuaqJ7gzfsux,A3fsA9Zfv1X2fVEQhTw51lKENdNrEqT3,26,23,1,52,0,0,2,0,78,11.142857142857142,2,0.0,7,1,47,0,16,0,5,2,0,55,23,0
208,6292,TmCsqieGLPEH7gIm9lIZtj95nwJ99JkM,A3fsA9Zfv1X2fVEQhTw51lKENdNrEqT3,7,3,2,0,2,0,3,0,10,1.4285714285714286,1,0.0,0,2,0,2,3,0,0,3,0,4,6,1
209,6303,jqoeUpESPoqODjA4STQaMBhAr7OND2EP,bWdj2GDclj5ofokWjzoa5jAwMkxCykd6,5,4,1,0,0,0,4,0,9,1.2857142857142858,1,0.0,0,1,0,0,4,0,0,4,0,1,8,1
210,6306,Q8L1mPYwfiwtGo48PB0N9B5ppVi0px10,SpATywNh6bZuzm8s1ceuBUnMUAeoAHHw,19,27,14,12,5,0,10,0,68,9.714285714285714,2,0.0,8,14,12,5,19,0,0,10,0,39,29,0
211,6331,SYptj19Xjkw9HEWtBs53CLIV7bhIU7QA,SpATywNh6bZuzm8s1ceuBUnMUAeoAHHw,30,63,33,19,10,31,18,0,174,24.857142857142858,3,0.0,6,33,18,10,57,31,1,18,0,67,107,1
212,6347,TAjGGV7oJgeUhPcj5Eum0tnVYrY7qjOE,RXDvfPUBYFlVdlueBFbLW0mhhAyGEqpt,6,6,3,2,0,1,2,0,14,2.0,2,0.0,0,3,1,0,6,1,1,2,0,4,10,0
213,6368,Fa7tOqP1WKllvNDMgvUWmTzPr8J8vhy8,A3fsA9Zfv1X2fVEQhTw51lKENdNrEqT3,9,8,6,0,3,0,2,0,19,2.7142857142857144,2,0.0,0,6,0,3,8,0,0,2,0,9,10,1
214,6382,9a1CkPBtfy1cinURU7wYCdYhBZbPuPSf,A3fsA9Zfv1X2fVEQhTw51lKENdNrEqT3,6,0,0,0,0,2,5,1,8,1.1428571428571428,1,0.0,0,0,0,0,0,2,0,5,1,0,8,1
215,6424,SmSrrYBj6KLZ39TqXb57CVWv6gX6sF7Q,SpATywNh6bZuzm8s1ceuBUnMUAeoAHHw,20,26,15,19,7,10,10,1,88,12.571428571428571,4,0.0,4,15,16,7,22,10,3,10,1,42,46,0
216,6435,nFeXukK9uLZggTwgBm3mDIxskaBXISqn,SpATywNh6bZuzm8s1ceuBUnMUAeoAHHw,12,20,3,18,0,0,1,0,42,6.0,4,0.0,5,3,15,0,15,0,3,1,0,23,19,1
217,6448,yau38b5UXLNmzsSxrtZsXYfKt6l52ZSP,A3fsA9Zfv1X2fVEQhTw51lKENdNrEqT3,3,1,1,0,1,0,0,0,3,0.42857142857142855,1,0.0,0,1,0,1,1,0,0,0,0,2,1,0
218,6472,wxlTuL6FVeoyKGq1xWxdRI4GRTsaG1Ha,A3fsA9Zfv1X2fVEQhTw51lKENdNrEqT3,5,4,3,0,0,0,1,0,8,1.1428571428571428,1,0.0,0,3,0,0,4,0,0,1,0,3,5,1
219,6488,aYhMdR5xaez3fr0lBrD6kCxYiCOyculR,RXDvfPUBYFlVdlueBFbLW0mhhAyGEqpt,18,33,23,0,3,851,13,3,926,132.28571428571428,6,0.0,2,23,0,3,31,851,0,13,3,28,898,0
220,6506,DCJPPLzeeZhBbsYhL4xGedJzVmW41Gnk,SpATywNh6bZuzm8s1ceuBUnMUAeoAHHw,29,40,25,31,11,13,7,0,127,18.142857142857142,3,0.0,11,25,28,11,29,13,3,7,0,75,52,0
221,6516,1CrVBOpFvr6rOy553Xrye0bjPdL11eu8,RXDvfPUBYFlVdlueBFbLW0mhhAyGEqpt,7,13,8,0,1,25,4,0,51,7.285714285714286,3,0.0,1,8,0,1,12,25,0,4,0,10,41,0
222,6517,7u3azzypzNqPYEFxf0DcbGOgDVhkOXos,A3fsA9Zfv1X2fVEQhTw51lKENdNrEqT3,29,8,6,86,4,1,7,0,112,16.0,1,0.0,1,6,78,4,7,1,8,7,0,89,23,0
223,6523,dna1EUjVeT7Ka4gaXCCa53DsP3COwQS1,SpATywNh6bZuzm8s1ceuBUnMUAeoAHHw,19,19,2,31,0,0,1,0,53,7.571428571428571,1,0.0,4,2,25,0,15,0,6,1,0,31,22,0
224,6528,97yjJniO9qlZAjgn3gm4HXnkbwnHzt9O,SpATywNh6bZuzm8s1ceuBUnMUAeoAHHw,12,38,1,21,1,10,4,0,75,10.714285714285714,1,0.0,13,1,15,1,25,10,6,4,0,30,45,1
225,6535,tuBxNlu8Vf06uK8sXGF2P17UeyGdHKNN,SpATywNh6bZuzm8s1ceuBUnMUAeoAHHw,20,19,17,2,8,0,2,0,48,6.857142857142857,1,0.0,0,17,2,8,19,0,0,2,0,27,21,1
226,6587,Y89GJdSZUpoYFMgx00SCe6qFoYoXIpUj,A3fsA9Zfv1X2fVEQhTw51lKENdNrEqT3,24,36,2,62,1,0,5,0,106,15.142857142857142,4,0.0,0,2,50,1,36,0,12,5,0,53,53,0
227,6620,ImttANzrjJymFPMjHDf4wrhhCWWSpYTI,A3fsA9Zfv1X2fVEQhTw51lKENdNrEqT3,7,11,0,0,0,0,4,0,15,2.142857142857143,1,0.0,0,0,0,0,11,0,0,4,0,0,15,1
228,6637,qcaVl4qf6hxavlIQkbkKC1Gm28s0psJd,SpATywNh6bZuzm8s1ceuBUnMUAeoAHHw,19,26,1,40,0,0,2,0,69,9.857142857142858,1,0.0,9,1,34,0,17,0,6,2,0,44,25,1
229,6643,lDflzmK9F6H42Kj6EtaBezWOcB4UUWiV,SpATywNh6bZuzm8s1ceuBUnMUAeoAHHw,7,9,5,0,2,0,4,0,20,2.857142857142857,2,0.0,0,5,0,2,9,0,0,4,0,7,13,0
230,6760,yh14zaFitCUTgvBPqRXiaZ6cUijtktL4,A3fsA9Zfv1X2fVEQhTw51lKENdNrEqT3,70,32,24,112,14,3,10,3,198,28.285714285714285,2,0.0,3,24,98,14,29,3,14,10,3,139,59,1
231,6813,UvqKXPrebnykj7gkohis9MIhsKJQCjxw,G8EPVSXsOYB5YQWZGiz1aVq5Pgr2GrQu,6,4,2,0,1,0,3,0,10,1.4285714285714286,2,0.0,0,2,0,1,4,0,0,3,0,3,7,0
232,6816,dSloiolTuQA1YnIVrIEZb5m23cL24cRw,A3fsA9Zfv1X2fVEQhTw51lKENdNrEqT3,5,5,2,0,1,0,2,0,10,1.4285714285714286,2,0.0,0,2,0,1,5,0,0,2,0,3,7,1
233,6824,e12uQn96OlYfknMdqSXCXdImglIj4IRR,bWdj2GDclj5ofokWjzoa5jAwMkxCykd6,17,22,14,0,5,46,12,1,100,14.285714285714286,3,0.0,1,14,0,5,21,46,0,12,1,20,80,0
234,6835,05hxkbgK0IX5639oITtQjU5YEEUBb8L1,SpATywNh6bZuzm8s1ceuBUnMUAeoAHHw,12,34,1,17,1,0,1,0,54,7.714285714285714,1,0.0,14,1,14,1,20,0,3,1,0,30,24,0
235,6838,AyhJARh0xhxObM9zhvUdDxlTCtu309eW,SpATywNh6bZuzm8s1ceuBUnMUAeoAHHw,17,18,11,8,6,25,3,0,71,10.142857142857142,2,0.0,3,11,8,6,15,25,0,3,0,28,43,1
236,6873,NAuTAy6LFtpkSTeaDzpzRRxCaq6qJCQ5,A3fsA9Zfv1X2fVEQhTw51lKENdNrEqT3,52,65,48,73,28,0,36,0,250,35.714285714285715,6,0.0,5,48,65,28,60,0,8,36,0,146,104,0
237,6881,jzWvwaTexkgbyBrPkQbXDb98Viqx6cSS,G8EPVSXsOYB5YQWZGiz1aVq5Pgr2GrQu,2,0,0,0,0,6,1,0,7,1.0,1,0.0,0,0,0,0,0,6,0,1,0,0,7,1
238,6898,UxSaaQ6GZyl7nlDC1x0TA1qshXRkMyH8,RXDvfPUBYFlVdlueBFbLW0mhhAyGEqpt,47,75,23,89,18,16,11,0,232,33.142857142857146,1,0.0,27,23,85,18,48,16,4,11,0,153,79,0
239,6914,5XorWInOikFQGiy06qBvCZ6iOgBDDoJu,SpATywNh6bZuzm8s1ceuBUnMUAeoAHHw,25,56,22,17,8,43,12,3,161,23.0,1,0.0,28,22,16,8,28,43,1,12,3,74,87,0
240,6916,x6r7USCSuVFGzUeOMsU9rcLC4WDuI3GF,A3fsA9Zfv1X2fVEQhTw51lKENdNrEqT3,13,18,11,0,0,1,13,1,44,6.285714285714286,2,0.0,0,11,0,0,18,1,0,13,1,11,33,0
241,6931,s6iPd6MFpHWkQ354d5Z6XCZ6dbx7CutD,SpATywNh6bZuzm8s1ceuBUnMUAeoAHHw,12,6,5,4,3,0,3,0,21,3.0,2,0.0,0,5,3,3,6,0,1,3,0,11,10,0
242,6938,a6f3gPi6axX0cfBnUGVliBDQrPx92l1r,A3fsA9Zfv1X2fVEQhTw51lKENdNrEqT3,29,49,31,112,19,0,8,0,219,31.285714285714285,4,0.0,5,31,92,19,44,0,20,8,0,147,72,1
243,6948,4r712Cp6HawShlWfCnD4BeT5bNCQMkQ4,SpATywNh6bZuzm8s1ceuBUnMUAeoAHHw,22,26,2,24,0,7,6,1,66,9.428571428571429,3,0.0,7,2,19,0,19,7,5,6,1,28,38,0
244,6956,ykaUPJW4Nc9r2mv4b25QxgdHgIcQ63RQ,SpATywNh6bZuzm8s1ceuBUnMUAeoAHHw,19,14,7,12,4,10,5,1,53,7.571428571428571,3,0.0,2,7,12,4,12,10,0,5,1,25,28,0
245,6983,7fC3V6ivG07wUIMOmiYFzSlyjWvbYnYf,A3fsA9Zfv1X2fVEQhTw51lKENdNrEqT3,29,21,0,116,0,0,8,0,145,20.714285714285715,4,0.0,3,0,98,0,18,0,18,8,0,101,44,0
246,6985,Pp5JJMKWhHjqXDQq6vl852N5LskPEcDA,A3fsA9Zfv1X2fVEQhTw51lKENdNrEqT3,3,2,0,0,0,0,2,0,4,0.5714285714285714,1,0.0,0,0,0,0,2,0,0,2,0,0,4,1
247,6989,QXMWMAYLhXvptULktpThtcXNRQ6JansN,SpATywNh6bZuzm8s1ceuBUnMUAeoAHHw,18,38,18,6,6,0,29,0,97,13.857142857142858,6,0.0,6,18,6,6,32,0,0,29,0,36,61,0
248,7004,4L8FEL9uQ33lr2hJ5CSJNyGu6GEq5daD,A3fsA9Zfv1X2fVEQhTw51lKENdNrEqT3,2,0,0,0,0,0,2,0,2,0.2857142857142857,1,0.0,0,0,0,0,0,0,0,2,0,0,2,1
249,7020,43QhXZfKBBZHpTmjLSVuTzbc6djzr40d,SpATywNh6bZuzm8s1ceuBUnMUAeoAHHw,16,24,0,14,2,0,4,0,44,6.285714285714286,1,0.0,8,0,13,2,16,0,1,4,0,23,21,0
250,7032,ogcVEHXlejDZ3EsIUfi0CHUmNlnDccd3,A3fsA9Zfv1X2fVEQhTw51lKENdNrEqT3,4,0,0,0,0,0,4,0,4,0.5714285714285714,1,0.0,0,0,0,0,0,0,0,4,0,0,4,1
251,7085,UrENN1zIfJIc4hCxDDWe8c7coKokiTdF,A3fsA9Zfv1X2fVEQhTw51lKENdNrEqT3,54,33,23,76,15,3,6,1,157,22.428571428571427,2,0.0,4,23,62,15,29,3,14,6,1,104,53,1
252,7119,03YAuQnjuYjTWwgHqE1110CZpZwknRbj,RXDvfPUBYFlVdlueBFbLW0mhhAyGEqpt,21,23,11,28,7,0,6,0,75,10.714285714285714,2,0.0,5,11,28,7,18,0,0,6,0,51,24,0
253,7138,tJ7FzaUMbzSP2K4BtZobNqzCoEbllcH1,RXDvfPUBYFlVdlueBFbLW0mhhAyGEqpt,17,45,22,20,1,310,48,29,475,67.85714285714286,7,0.0,2,22,13,1,43,310,7,48,29,38,437,0
254,7143,ahFkMpqRNclNalhsRFgKmc75UZfOTdgQ,SpATywNh6bZuzm8s1ceuBUnMUAeoAHHw,8,21,9,10,0,0,2,0,42,6.0,4,0.0,10,9,7,0,11,0,3,2,0,26,16,1
255,7151,2QwHrFxGcIFGuR6TyUnlExhchaRL2Ipx,SpATywNh6bZuzm8s1ceuBUnMUAeoAHHw,10,21,7,0,2,0,4,0,34,4.857142857142857,2,0.0,0,7,0,2,21,0,0,4,0,9,25,0
256,7182,HlYiU2TA92it9HWOPDlsBmlpdZ7J7QTJ,SpATywNh6bZuzm8s1ceuBUnMUAeoAHHw,23,36,13,16,4,0,11,0,80,11.428571428571429,4,0.0,8,13,16,4,28,0,0,11,0,41,39,1
257,7258,sT9hGAnww95aeGvqwQpJlS3ORhWDT49F,A3fsA9Zfv1X2fVEQhTw51lKENdNrEqT3,9,10,6,0,3,0,3,0,22,3.142857142857143,2,0.0,1,6,0,3,9,0,0,3,0,10,12,1
258,7282,gMP76SzwbIEJUCyidRWCdRJzafVqamrK,bWdj2GDclj5ofokWjzoa5jAwMkxCykd6,9,9,2,0,0,0,6,1,18,2.5714285714285716,1,0.0,0,2,0,0,9,0,0,6,1,2,16,1
259,7283,K5Sy6doI03r5uctdEcvObhW1bpzNGROt,G8EPVSXsOYB5YQWZGiz1aVq5Pgr2GrQu,11,24,15,0,3,0,13,0,55,7.857142857142857,2,0.0,0,15,0,3,24,0,0,13,0,18,37,0
260,7304,VSEOcWZYpZiKC2PUmidzj4VqbBnc3GAo,A3fsA9Zfv1X2fVEQhTw51lKENdNrEqT3,24,9,5,69,0,7,20,0,110,15.714285714285714,5,0.0,4,5,58,0,5,7,11,20,0,67,43,0
261,7332,5kqorcxIJejDFcc1de7q3uie94xFSgMJ,SpATywNh6bZuzm8s1ceuBUnMUAeoAHHw,17,50,27,10,4,0,11,0,102,14.571428571428571,4,0.0,7,27,9,4,43,0,1,11,0,47,55,0
262,7336,XaZ9suMr2OUkXLhyKSMfk6SMeajIT5ha,A3fsA9Zfv1X2fVEQhTw51lKENdNrEqT3,7,6,1,0,1,0,5,0,13,1.8571428571428572,1,0.0,0,1,0,1,6,0,0,5,0,2,11,1
263,7337,J5FkxM9o8L4y51xbaKwQjZuay8KpJMzH,SpATywNh6bZuzm8s1ceuBUnMUAeoAHHw,18,26,6,15,2,9,5,0,63,9.0,1,0.0,6,6,12,2,20,9,3,5,0,26,37,1
264,7338,XpquNqg2EIDRwNL88GzK6drchpRZMQN1,A3fsA9Zfv1X2fVEQhTw51lKENdNrEqT3,21,15,13,0,11,1,6,0,46,6.571428571428571,3,0.0,0,13,0,11,15,1,0,6,0,24,22,0
265,7345,B9KqNNxXBxHFUsJnQKQysblL3f8zF7sg,bWdj2GDclj5ofokWjzoa5jAwMkxCykd6,7,13,1,0,0,0,8,0,22,3.142857142857143,4,0.0,0,1,0,0,13,0,0,8,0,1,21,0
266,7348,5a7fehAo0Ol3kwHzhNqAYRGEzPLIE5FD,SpATywNh6bZuzm8s1ceuBUnMUAeoAHHw,10,16,12,0,7,0,6,0,41,5.857142857142857,3,0.0,0,12,0,7,16,0,0,6,0,19,22,1
267,7364,84Vq27rxsidbGJFxLO0cd5e2CSiXRChu,A3fsA9Zfv1X2fVEQhTw51lKENdNrEqT3,29,16,10,54,3,2,5,0,90,12.857142857142858,3,0.0,2,10,49,3,14,2,5,5,0,64,26,1
268,7380,y4ROZxtUW2SffaQ3DMgCK81r0GDNLnMO,SpATywNh6bZuzm8s1ceuBUnMUAeoAHHw,16,14,5,14,4,0,1,0,38,5.428571428571429,2,0.0,5,5,12,4,9,0,2,1,0,26,12,0
269,7387,u82lBhpDxJIwlZISEntCxj1zgVFdW0vT,SpATywNh6bZuzm8s1ceuBUnMUAeoAHHw,27,102,58,23,23,59,37,5,307,43.857142857142854,7,0.0,30,58,16,23,72,59,7,37,5,127,180,0
270,7402,XESEnxXOxYn0sEg8u7X5S27rymbaMzNA,SpATywNh6bZuzm8s1ceuBUnMUAeoAHHw,21,54,28,30,11,11,18,0,152,21.714285714285715,2,0.0,19,28,24,11,35,11,6,18,0,82,70,0
271,7405,thbVK5OkB13GLXnOCtBegvQeqDmjraYm,SpATywNh6bZuzm8s1ceuBUnMUAeoAHHw,16,24,10,15,3,12,7,0,71,10.142857142857142,2,0.0,11,10,15,3,13,12,0,7,0,39,32,0
272,7410,MRybyq1cnqatDusvwSwOpxgKfQSDJUE3,bWdj2GDclj5ofokWjzoa5jAwMkxCykd6,12,7,4,14,1,0,6,1,33,4.714285714285714,1,0.0,1,4,14,1,6,0,0,6,1,20,13,1
273,7425,AV3xIWfwsQ5uGH8Qf1BwlVsUBUI5kjl1,SpATywNh6bZuzm8s1ceuBUnMUAeoAHHw,7,15,5,0,2,0,2,0,24,3.4285714285714284,2,0.0,0,5,0,2,15,0,0,2,0,7,17,1
274,7445,mawBMWVaMDuwBgxqJlSNvSnxuZmWfWRW,SpATywNh6bZuzm8s1ceuBUnMUAeoAHHw,14,23,2,8,1,0,10,0,44,6.285714285714286,3,0.0,2,2,8,1,21,0,0,10,0,13,31,0
275,7456,1CrVBOpFvr6rOy553Xrye0bjPdL11eu8,A3fsA9Zfv1X2fVEQhTw51lKENdNrEqT3,11,18,11,0,4,31,7,0,71,10.142857142857142,2,0.0,2,11,0,4,16,31,0,7,0,17,54,0
276,7459,RvbHqbSC41GB9aoXWEA7k8GnWBXN8w9e,SpATywNh6bZuzm8s1ceuBUnMUAeoAHHw,5,3,0,0,0,0,2,0,5,0.7142857142857143,1,0.0,0,0,0,0,3,0,0,2,0,0,5,1
277,7460,oTbhbArArMYa19mRFQxnzp4vm2INrkSU,SpATywNh6bZuzm8s1ceuBUnMUAeoAHHw,13,15,2,0,1,2,7,1,28,4.0,1,0.0,3,2,0,1,12,2,0,7,1,6,22,1
278,7477,5DIcniD9kRbDupVPBNugV5by0SZHtD2e,SpATywNh6bZuzm8s1ceuBUnMUAeoAHHw,20,35,3,34,1,0,4,0,77,11.0,2,0.0,14,3,29,1,21,0,5,4,0,47,30,0
279,7484,ZghgmsFKGlL396BKFJoJeIy2X7crdnN0,SpATywNh6bZuzm8s1ceuBUnMUAeoAHHw,14,15,6,17,2,6,5,0,51,7.285714285714286,2,0.0,5,6,16,2,10,6,1,5,0,29,22,0
280,7489,uUSTKM8g1hIskJbYHh1UiIQ6epHTSTNR,bWdj2GDclj5ofokWjzoa5jAwMkxCykd6,7,11,7,0,1,0,4,0,23,3.2857142857142856,2,0.0,0,7,0,1,11,0,0,4,0,8,15,1
281,7490,uUSTKM8g1hIskJbYHh1UiIQ6epHTSTNR,G8EPVSXsOYB5YQWZGiz1aVq5Pgr2GrQu,3,4,2,0,0,0,3,0,9,1.2857142857142858,1,0.0,0,2,0,0,4,0,0,3,0,2,7,0
282,7494,CSp8QkNZa6B12LzJipxPFgC5w6lKLtbn,RXDvfPUBYFlVdlueBFbLW0mhhAyGEqpt,20,25,3,26,4,10,12,1,81,11.571428571428571,2,0.0,5,3,26,4,20,10,0,12,1,38,43,0
283,7497,guprsx2yFQ5jOFQRa2OmDTvoe1Qtus0L,SpATywNh6bZuzm8s1ceuBUnMUAeoAHHw,7,11,6,0,3,0,1,0,21,3.0,1,0.0,0,6,0,3,11,0,0,1,0,9,12,1
284,7500,BQwuBUR4WYRdCAVoQUNUZK3Ln34YX0iv,SpATywNh6bZuzm8s1ceuBUnMUAeoAHHw,5,2,1,0,0,0,4,0,7,1.0,1,0.0,0,1,0,0,2,0,0,4,0,1,6,1
285,7505,1sFJ1Szdx1WU21TgC1PRv3tkQ09H4qed,SpATywNh6bZuzm8s1ceuBUnMUAeoAHHw,16,17,9,10,4,8,11,1,60,8.571428571428571,1,0.0,4,9,9,4,13,8,1,11,1,26,34,1
286,7524,UNtI3N6D9AZsFIjfiItWfMe73uBfp0VS,SpATywNh6bZuzm8s1ceuBUnMUAeoAHHw,1,0,0,0,0,0,1,0,1,0.14285714285714285,1,0.0,0,0,0,0,0,0,0,1,0,0,1,0
287,7541,CGIwACA114zcxKI2ZiGPCkXleQcVHz2y,SpATywNh6bZuzm8s1ceuBUnMUAeoAHHw,17,26,4,17,2,3,13,1,66,9.428571428571429,4,0.0,7,4,14,2,19,3,3,13,1,27,39,0
288,7543,fGIeAB7IRJCHxzCo8u4GLaPKxQfHeCdi,SpATywNh6bZuzm8s1ceuBUnMUAeoAHHw,18,40,21,14,11,0,8,0,94,13.428571428571429,1,0.0,8,21,13,11,32,0,1,8,0,53,41,0
289,7551,dnay2jAX3cgskuo0IcUq4nB4ZOtSKU5x,SpATywNh6bZuzm8s1ceuBUnMUAeoAHHw,15,23,9,14,3,1,8,0,58,8.285714285714286,3,0.0,2,9,13,3,21,1,1,8,0,27,31,0
290,7554,eO5CgKdvPHZfZ8krv7wlSTYp2EdmZAmV,RXDvfPUBYFlVdlueBFbLW0mhhAyGEqpt,26,46,0,38,2,15,4,0,105,15.0,1,0.0,17,0,32,2,29,15,6,4,0,51,54,1
291,7586,40eiF3ZEuOYP1RP6XBUcW4OUQFmNxf9i,SpATywNh6bZuzm8s1ceuBUnMUAeoAHHw,20,22,11,10,4,4,8,1,60,8.571428571428571,1,0.0,4,11,10,4,18,4,0,8,1,29,31,0
292,7587,wEaTyOJwwvOCk7eUttQISK5WPXL7ANNV,SpATywNh6bZuzm8s1ceuBUnMUAeoAHHw,12,12,4,0,2,1,8,1,28,4.0,1,0.0,1,4,0,2,11,1,0,8,1,7,21,0
293,7616,PcrKUgtxZcGXBYkLOmECh99m3fhAOabf,SpATywNh6bZuzm8s1ceuBUnMUAeoAHHw,5,4,3,0,0,0,1,0,8,1.1428571428571428,1,0.0,0,3,0,0,4,0,0,1,0,3,5,0
294,7623,uRIMG7KJWhHO81Kf9MvAfUFzZC6juL3s,bWdj2GDclj5ofokWjzoa5jAwMkxCykd6,6,9,6,0,2,0,3,0,20,2.857142857142857,3,0.0,0,6,0,2,9,0,0,3,0,8,12,0
295,7649,cauH4YekuRKFsHZgdw9jChinljVOhzCP,SpATywNh6bZuzm8s1ceuBUnMUAeoAHHw,20,16,10,19,8,0,1,0,54,7.714285714285714,2,0.0,4,10,16,8,12,0,3,1,0,38,16,1
296,7651,HL6JESJ9UfnK7mtp7EsklcgEKja4gTaC,RXDvfPUBYFlVdlueBFbLW0mhhAyGEqpt,18,28,1,24,2,2,3,0,60,8.571428571428571,2,0.0,9,1,24,2,19,2,0,3,0,36,24,1
297,7656,v9Jp2iBPSFTVxP8FrUe1odwfz8Hd1wS3,SpATywNh6bZuzm8s1ceuBUnMUAeoAHHw,17,13,8,6,4,8,5,0,44,6.285714285714286,1,0.0,2,8,6,4,11,8,0,5,0,20,24,0
298,7659,1KSlK2xXHUc3PjC1CsQEQaomGBagqDXf,A3fsA9Zfv1X2fVEQhTw51lKENdNrEqT3,6,4,2,0,1,0,1,0,8,1.1428571428571428,1,0.0,0,2,0,1,4,0,0,1,0,3,5,1
299,7660,ae4nSawB3M11Wmq3zKGmekxyJPcADmL9,bWdj2GDclj5ofokWjzoa5jAwMkxCykd6,1,0,0,0,0,0,1,0,1,0.14285714285714285,1,0.0,0,0,0,0,0,0,0,1,0,0,1,1
300,7667,ImCVHOP1jti1S73II8BRabWE6aqK4I6u,SpATywNh6bZuzm8s1ceuBUnMUAeoAHHw,1,0,0,0,0,0,1,0,1,0.14285714285714285,1,0.0,0,0,0,0,0,0,0,1,0,0,1,1
301,7670,NKzNFHK6LaJqjMec69ZX5HfBigF4yyJV,SpATywNh6bZuzm8s1ceuBUnMUAeoAHHw,17,15,9,8,5,6,6,0,49,7.0,1,0.0,5,9,8,5,10,6,0,6,0,27,22,0
302,7677,HPp2Yy992FcBIXDjeQl0bEftbV1QFRDS,SpATywNh6bZuzm8s1ceuBUnMUAeoAHHw,6,6,3,0,0,0,2,0,11,1.5714285714285714,1,0.0,0,3,0,0,6,0,0,2,0,3,8,0
303,7681,3RcsrMTbPrb8ZHYXLlgwoRK7zrqTGSuq,bWdj2GDclj5ofokWjzoa5jAwMkxCykd6,6,3,2,0,2,0,1,0,8,1.1428571428571428,1,0.0,0,2,0,2,3,0,0,1,0,4,4,1
304,7683,uydIb4MWCn95KWcEhKwj3VRfjvxXo8Nj,A3fsA9Zfv1X2fVEQhTw51lKENdNrEqT3,47,71,40,116,0,303,48,0,578,82.57142857142857,7,0.0,10,40,86,0,61,303,30,48,0,136,442,0
305,7694,a6f3gPi6axX0cfBnUGVliBDQrPx92l1r,SpATywNh6bZuzm8s1ceuBUnMUAeoAHHw,17,27,18,27,8,0,4,0,84,12.0,2,0.0,5,18,21,8,22,0,6,4,0,52,32,0
306,7701,f81JJCqMlkJdA9lV7uQBviuGlLm2CDkR,SpATywNh6bZuzm8s1ceuBUnMUAeoAHHw,18,53,5,14,4,1,23,0,100,14.285714285714286,5,0.0,12,5,12,4,41,1,2,23,0,33,67,0
307,7729,xkt3K6JWpnfeixDBdwkLXaHgXuuGt35v,A3fsA9Zfv1X2fVEQhTw51lKENdNrEqT3,9,3,2,24,0,0,1,0,30,4.285714285714286,1,0.0,0,2,21,0,3,0,3,1,0,23,7,1
308,7731,ZD844NRFhgHqwskHd8pIBuIwDiTAY4NC,SpATywNh6bZuzm8s1ceuBUnMUAeoAHHw,17,13,10,0,5,0,4,0,32,4.571428571428571,2,0.0,0,10,0,5,13,0,0,4,0,15,17,0
309,7766,3kfsZtV93tVXeg8YtF9PTasYswVdOeLx,SpATywNh6bZuzm8s1ceuBUnMUAeoAHHw,14,25,0,12,0,0,6,0,43,6.142857142857143,2,0.0,6,0,12,0,19,0,0,6,0,18,25,0
310,7767,GcInGCXKYnNWAnYbqUyxJe7hi4ZjhElg,RXDvfPUBYFlVdlueBFbLW0mhhAyGEqpt,20,16,11,0,10,0,1,0,38,5.428571428571429,1,0.0,3,11,0,10,13,0,0,1,0,24,14,1
311,7771,Rdvgrardg53H2oeCgmOt8vFxIUu5nogb,SpATywNh6bZuzm8s1ceuBUnMUAeoAHHw,21,21,14,14,6,0,5,0,60,8.571428571428571,2,0.0,3,14,11,6,18,0,3,5,0,34,26,0
312,7774,EQU3KQKmF0NpNwQmPmUw90ptahwADmIz,SpATywNh6bZuzm8s1ceuBUnMUAeoAHHw,12,12,1,0,0,10,5,1,29,4.142857142857143,1,0.0,2,1,0,0,10,10,0,5,1,3,26,1
313,7778,moK1GdnqoYxhSRCf5a95lgXdVNdzYrjs,A3fsA9Zfv1X2fVEQhTw51lKENdNrEqT3,31,15,8,46,3,6,17,0,95,13.571428571428571,4,0.0,1,8,42,3,14,6,4,17,0,54,41,0
314,7781,h1PVCD4diCwozuU4ZjcMLdFycUmYpSIc,G8EPVSXsOYB5YQWZGiz1aVq5Pgr2GrQu,8,8,5,0,1,0,4,0,18,2.5714285714285716,3,0.0,0,5,0,1,8,0,0,4,0,6,12,0
315,7786,7aA6BrVZipLHOrozlrYBMEmfMq4MXahq,RXDvfPUBYFlVdlueBFbLW0mhhAyGEqpt,17,25,4,26,1,0,7,0,63,9.0,4,0.0,4,4,21,1,21,0,5,7,0,30,33,0
316,7789,pdotXwlXOl4cuEJn7TjzheQq2EZaH9qB,SpATywNh6bZuzm8s1ceuBUnMUAeoAHHw,2,2,0,0,0,0,0,0,2,0.2857142857142857,1,0.0,0,0,0,0,2,0,0,0,0,0,2,1
317,7793,z2zhro5MCTuNkAWXNKBS5L7zEtJc0Vs9,SpATywNh6bZuzm8s1ceuBUnMUAeoAHHw,19,31,20,6,12,9,4,0,82,11.714285714285714,1,0.0,8,20,6,12,23,9,0,4,0,46,36,0
318,7820,tcrOs8a5NYKg0fcf0qJ4buK5RKIEFS5o,RXDvfPUBYFlVdlueBFbLW0mhhAyGEqpt,4,2,1,0,0,0,2,0,5,0.7142857142857143,1,0.0,0,1,0,0,2,0,0,2,0,1,4,0
319,7831,SozLQk8695JG7fvj1Enp26s5ACJQjjq5,SpATywNh6bZuzm8s1ceuBUnMUAeoAHHw,18,17,13,10,6,5,5,1,57,8.142857142857142,2,0.0,2,13,10,6,15,5,0,5,1,31,26,0
320,7844,cSB2xmj1Zot5hgCLSHhxDNISJzHyYsXf,SpATywNh6bZuzm8s1ceuBUnMUAeoAHHw,6,8,0,0,0,0,2,0,10,1.4285714285714286,1,0.0,0,0,0,0,8,0,0,2,0,0,10,1
321,7869,34oDxV5jJfVaGWSsgPNGJP2ott7rJu7I,SpATywNh6bZuzm8s1ceuBUnMUAeoAHHw,9,8,5,0,4,0,0,0,17,2.4285714285714284,2,0.0,1,5,0,4,7,0,0,0,0,10,7,0
322,7872,ZosutOeXAHBSIvZIuIxhmKGfV7JZESP5,SpATywNh6bZuzm8s1ceuBUnMUAeoAHHw,13,19,13,0,11,0,41,0,84,12.0,2,0.0,0,13,0,11,19,0,0,41,0,24,60,0
323,7885,S58o7T8J2JcEBTi3bdMATXeMdhJbXqYq,SpATywNh6bZuzm8s1ceuBUnMUAeoAHHw,31,30,17,27,9,11,11,2,107,15.285714285714286,2,0.0,7,17,24,9,23,11,3,11,2,57,50,0
324,7900,pVR5qyfYJN582jaXWwJ4YRpKGyADx6Eu,RXDvfPUBYFlVdlueBFbLW0mhhAyGEqpt,29,18,15,0,11,0,4,0,48,6.857142857142857,1,0.0,2,15,0,11,16,0,0,4,0,28,20,1
325,7916,TIvBCmMDquWj2iwTixxUP6A3HzcrQyq3,SpATywNh6bZuzm8s1ceuBUnMUAeoAHHw,23,35,16,16,9,6,11,0,93,13.285714285714286,3,0.0,4,16,11,9,31,6,5,11,0,40,53,0
326,7932,Dm0fTQ5hQ4vZLMdCz8HpFheMP2yCMt3n,SpATywNh6bZuzm8s1ceuBUnMUAeoAHHw,1,0,0,0,0,0,1,0,1,0.14285714285714285,1,0.0,0,0,0,0,0,0,0,1,0,0,1,0
327,7953,KIPXc8MOqmnlmMqnIzIeaBqliIw9pS44,RXDvfPUBYFlVdlueBFbLW0mhhAyGEqpt,16,26,13,14,7,2,10,0,72,10.285714285714286,1,0.0,2,13,13,7,24,2,1,10,0,35,37,1
328,7971,Y7KMNxUWz3B2grUtFCf2FgfpqFMvSy0l,G8EPVSXsOYB5YQWZGiz1aVq5Pgr2GrQu,21,26,16,42,7,4,16,4,115,16.428571428571427,2,0.0,3,16,37,7,23,4,5,16,4,63,52,0
329,7982,9MK6uRaOnLFmxpxcsZHlBDf4ITU7Vvr6,SpATywNh6bZuzm8s1ceuBUnMUAeoAHHw,7,3,0,0,0,0,4,0,7,1.0,1,0.0,0,0,0,0,3,0,0,4,0,0,7,1
330,8012,jagu0OJDhWTGFhfCMk0ghqluLpW3kzdC,SpATywNh6bZuzm8s1ceuBUnMUAeoAHHw,20,13,9,12,5,1,5,4,49,7.0,1,0.0,3,9,10,5,10,1,2,5,4,27,22,0
331,8033,e2lOOqKSlF9Fw65H87m0cJslmAtz6Yej,SpATywNh6bZuzm8s1ceuBUnMUAeoAHHw,5,2,1,0,1,0,2,0,6,0.8571428571428571,1,0.0,0,1,0,1,2,0,0,2,0,2,4,1
332,8040,IjI8O6qhXWrzvoHGjD0jKSLTrkjwywnZ,SpATywNh6bZuzm8s1ceuBUnMUAeoAHHw,2,0,0,0,0,0,2,0,2,0.2857142857142857,1,0.0,0,0,0,0,0,0,0,2,0,0,2,0
333,8042,XDPvGyFLLEYwbNEQik2MM4yiADs5rrYJ,SpATywNh6bZuzm8s1ceuBUnMUAeoAHHw,11,11,6,0,2,10,3,0,32,4.571428571428571,2,0.0,2,6,0,2,9,10,0,3,0,10,22,1
334,8048,lPfsYctvOlk2KshSTR0YzF9fsG0sDcXm,SpATywNh6bZuzm8s1ceuBUnMUAeoAHHw,7,10,7,0,0,0,4,2,23,3.2857142857142856,2,0.0,0,7,0,0,10,0,0,4,2,7,16,0
335,8054,3nOS3JEH08BgwunQqioyEFfja4qIND4p,SpATywNh6bZuzm8s1ceuBUnMUAeoAHHw,6,4,3,0,0,0,2,0,9,1.2857142857142858,1,0.0,0,3,0,0,4,0,0,2,0,3,6,1
336,8060,aJPDWxjvWh7cfVWUTg8ZVK8q5wjeFEdQ,SpATywNh6bZuzm8s1ceuBUnMUAeoAHHw,11,12,2,8,1,1,7,1,32,4.571428571428571,2,0.0,1,2,7,1,11,1,1,7,1,11,21,1
337,8084,Rl9j2cgwioq6OBXKad44x4Um0fdVh2gk,SpATywNh6bZuzm8s1ceuBUnMUAeoAHHw,6,2,1,0,1,0,3,0,7,1.0,1,0.0,0,1,0,1,2,0,0,3,0,2,5,1
338,8090,cXITZ8Hjmr6myIyBLbDLY8s8nux0OPPJ,SpATywNh6bZuzm8s1ceuBUnMUAeoAHHw,3,2,0,0,0,0,1,0,3,0.42857142857142855,1,0.0,0,0,0,0,2,0,0,1,0,0,3,1
339,8091,Nt122dpzJdE1gwkHUV6Ncnzj3MDda3Gr,G8EPVSXsOYB5YQWZGiz1aVq5Pgr2GrQu,5,9,1,2,1,0,3,0,16,2.2857142857142856,1,0.0,3,1,1,1,6,0,1,3,0,6,10,1
340,8094,cZCWNPGtcdIiIlOnNkFDWI8KTo9TOlAC,SpATywNh6bZuzm8s1ceuBUnMUAeoAHHw,6,1,1,0,1,0,4,0,7,1.0,1,0.0,0,1,0,1,1,0,0,4,0,2,5,1
341,8112,X4PGvTm4F0x49zE1LPpj4etdmQj6eS9S,SpATywNh6bZuzm8s1ceuBUnMUAeoAHHw,9,14,8,0,5,0,3,0,30,4.285714285714286,1,0.0,0,8,0,5,14,0,0,3,0,13,17,0
342,8123,q6JeU48PcDOdiZ368tb3IoCh3BVgnxVp,bWdj2GDclj5ofokWjzoa5jAwMkxCykd6,17,43,17,16,16,14,7,0,113,16.142857142857142,3,0.0,10,17,14,16,33,14,2,7,0,57,56,1
343,8166,eOxm8XEI11Xs6eiBi1Nu5QzIagZXwEm9,SpATywNh6bZuzm8s1ceuBUnMUAeoAHHw,10,6,4,0,2,26,5,0,43,6.142857142857143,2,0.0,0,4,0,2,6,26,0,5,0,6,37,0
344,8168,jtxvuHBV8ZOgNnNCL1A1WerzR2TVfFNy,A3fsA9Zfv1X2fVEQhTw51lKENdNrEqT3,5,3,2,0,1,0,2,0,8,1.1428571428571428,2,0.0,0,2,0,1,3,0,0,2,0,3,5,1
345,8185,WgYQBUzSJJLcj6PwA0d8MdNri6k7nN4s,RXDvfPUBYFlVdlueBFbLW0mhhAyGEqpt,5,2,1,0,1,0,4,0,8,1.1428571428571428,2,0.0,0,1,0,1,2,0,0,4,0,2,6,1
346,8188,XpMzbdWNf7VknZxctjGvDzxNpyCLWCaP,SpATywNh6bZuzm8s1ceuBUnMUAeoAHHw,8,8,6,0,4,0,2,0,20,2.857142857142857,2,0.0,0,6,0,4,8,0,0,2,0,10,10,1
347,8210,YxqHC7YRxEYSyD66BTdrU6f4qZw3IxAu,SpATywNh6bZuzm8s1ceuBUnMUAeoAHHw,7,1,1,0,1,0,4,0,7,1.0,1,0.0,0,1,0,1,1,0,0,4,0,2,5,1
348,8243,VAe2acDlYib7o05H0M3tg4gQoc5gLI96,SpATywNh6bZuzm8s1ceuBUnMUAeoAHHw,24,22,13,17,6,0,2,0,60,8.571428571428571,3,0.0,8,13,17,6,14,0,0,2,0,44,16,1
349,8254,rD3x5Ovuza1MLiqkvaHksaL42hepSLSa,bWdj2GDclj5ofokWjzoa5jAwMkxCykd6,10,11,5,8,3,0,3,0,30,4.285714285714286,2,0.0,1,5,8,3,10,0,0,3,0,17,13,1
350,8257,ANOp8mWNHTZUswLhYddMTdBChUriYZaX,RXDvfPUBYFlVdlueBFbLW0mhhAyGEqpt,41,217,5,68,6,141,31,0,468,66.85714285714286,6,0.0,52,5,63,6,165,141,5,31,0,126,342,0
351,8284,X9u2Hncxz9A6DpGBhCZ5wulJhsMdyVac,RXDvfPUBYFlVdlueBFbLW0mhhAyGEqpt,11,11,9,0,4,0,3,0,27,3.857142857142857,2,0.0,0,9,0,4,11,0,0,3,0,13,14,1
352,8291,ljmWZCzWPqv1RXsn1q2wpsQtrnA1zct2,bWdj2GDclj5ofokWjzoa5jAwMkxCykd6,3,2,1,0,0,0,2,0,5,0.7142857142857143,1,0.0,0,1,0,0,2,0,0,2,0,1,4,1
353,8301,KdYI01F9Xc7qTt82weazWGHtHsUvxDB7,SpATywNh6bZuzm8s1ceuBUnMUAeoAHHw,12,18,5,0,4,6,4,0,37,5.285714285714286,3,0.0,2,5,0,4,16,6,0,4,0,11,26,1
354,8305,kpS5tMAHQr9yJyfVB9Mkc4TlfmouYjNE,SpATywNh6bZuzm8s1ceuBUnMUAeoAHHw,18,47,12,0,4,1,10,2,76,10.857142857142858,7,0.0,0,12,0,4,47,1,0,10,2,16,60,0
355,8312,cYibpCaMUGq0WjgUWfTv0iIvJ7QbFj5E,SpATywNh6bZuzm8s1ceuBUnMUAeoAHHw,16,9,6,12,5,2,7,0,41,5.857142857142857,1,0.0,3,6,11,5,6,2,1,7,0,25,16,0
356,8345,qDcPjYl3DZy0WT2lmJT9GmZYgAdLwjE1,SpATywNh6bZuzm8s1ceuBUnMUAeoAHHw,5,6,1,0,0,0,2,0,9,1.2857142857142858,1,0.0,3,1,0,0,3,0,0,2,0,4,5,1
357,8348,f6fUoSUJslaShApLLQ3C3hAE39t0Ewco,SpATywNh6bZuzm8s1ceuBUnMUAeoAHHw,25,42,13,18,6,31,7,2,119,17.0,1,0.0,23,13,17,6,19,31,1,7,2,59,60,1
358,8375,U7C8tpNUwsrK1uIrWw0ieIQJYwOo61Uc,SpATywNh6bZuzm8s1ceuBUnMUAeoAHHw,19,23,15,8,7,0,2,0,55,7.857142857142857,2,0.0,2,15,6,7,21,0,2,2,0,30,25,1
359,8378,ZipuPEeCqze6LFrYfkIZBU7ronXF3JAb,SpATywNh6bZuzm8s1ceuBUnMUAeoAHHw,18,19,13,12,6,0,3,0,53,7.571428571428571,2,0.0,3,13,12,6,16,0,0,3,0,34,19,0
360,8381,XDUz0oVcNwke0CqAlFlmwOWSA32SgeFl,SpATywNh6bZuzm8s1ceuBUnMUAeoAHHw,10,19,1,0,0,0,4,0,24,3.4285714285714284,3,0.0,2,1,0,0,17,0,0,4,0,3,21,0
361,8397,a9P7gN6Av72Gjg1AVS7Rv4BiyiW2xpDS,bWdj2GDclj5ofokWjzoa5jAwMkxCykd6,3,0,0,0,0,1,3,0,4,0.5714285714285714,1,0.0,0,0,0,0,0,1,0,3,0,0,4,1
362,8408,NYt3HW4iIDKFfkoDHUmE2GfhEi6C8Rqu,bWdj2GDclj5ofokWjzoa5jAwMkxCykd6,6,4,2,0,0,0,8,0,14,2.0,2,0.0,0,2,0,0,4,0,0,8,0,2,12,1
363,8424,ukCIrv5h45nbdIEPPmMlvipT87B8fFE7,RXDvfPUBYFlVdlueBFbLW0mhhAyGEqpt,39,47,35,2,21,17,13,5,140,20.0,2,0.0,0,35,2,21,47,17,0,13,5,58,82,0
364,8427,sOkc0wEXSSLpxtxlqjZObJqg94IyLpuY,SpATywNh6bZuzm8s1ceuBUnMUAeoAHHw,15,33,0,12,0,0,8,0,53,7.571428571428571,6,0.0,11,0,9,0,22,0,3,8,0,20,33,0
365,8449,TTJoWZMu9qE69gK338lM1DPPuzOJjTS2,SpATywNh6bZuzm8s1ceuBUnMUAeoAHHw,6,4,1,0,1,0,1,0,7,1.0,1,0.0,0,1,0,1,4,0,0,1,0,2,5,1
366,8457,jcXoYFaI9QPcliotiwIgOLeObkrSUvNn,SpATywNh6bZuzm8s1ceuBUnMUAeoAHHw,8,8,1,0,0,0,1,0,10,1.4285714285714286,1,0.0,0,1,0,0,8,0,0,1,0,1,9,0
367,8471,qLCBP0aNIaDp6cyqIvUit2p06Y7zVnQy,G8EPVSXsOYB5YQWZGiz1aVq5Pgr2GrQu,7,6,1,0,1,0,2,0,10,1.4285714285714286,1,0.0,1,1,0,1,5,0,0,2,0,3,7,1
368,8478,UY6XF5Ob1mgKcqmlUI5FgYfIUUIUAwxR,SpATywNh6bZuzm8s1ceuBUnMUAeoAHHw,17,43,16,19,7,1,9,0,95,13.571428571428571,3,0.0,10,16,16,7,33,1,3,9,0,49,46,0
369,8504,2cKDRLsZWRQVPO7xdF2dpJ6vw1EsD7pk,bWdj2GDclj5ofokWjzoa5jAwMkxCykd6,6,11,3,0,1,0,2,0,17,2.4285714285714284,2,0.0,1,3,0,1,10,0,0,2,0,5,12,1
370,8505,DpXkrIHIAIPNESKyvFah0WhpVT5PHFeL,SpATywNh6bZuzm8s1ceuBUnMUAeoAHHw,5,4,3,0,0,3,1,0,11,1.5714285714285714,1,0.0,0,3,0,0,4,3,0,1,0,3,8,0
371,8510,2cKDRLsZWRQVPO7xdF2dpJ6vw1EsD7pk,A3fsA9Zfv1X2fVEQhTw51lKENdNrEqT3,64,69,26,218,11,0,3,0,327,46.714285714285715,3,0.0,10,26,182,11,59,0,36,3,0,229,98,1
372,8517,4tj4DQ4XnBvn4uM9Mw2kTJbN1KPDkno4,SpATywNh6bZuzm8s1ceuBUnMUAeoAHHw,15,27,12,14,5,11,3,0,72,10.285714285714286,1,0.0,6,12,14,5,21,11,0,3,0,37,35,0
373,8522,aLRP3ahB5SIcOn5vpM1VPEh9ib2QIioX,bWdj2GDclj5ofokWjzoa5jAwMkxCykd6,3,2,0,0,0,0,1,0,3,0.42857142857142855,1,0.0,0,0,0,0,2,0,0,1,0,0,3,1
374,8523,0Vj24SN7QK68fxZGEj9b6pGHh8nTXfGG,A3fsA9Zfv1X2fVEQhTw51lKENdNrEqT3,4,6,4,0,0,0,3,0,13,1.8571428571428572,2,0.0,0,4,0,0,6,0,0,3,0,4,9,0
375,8526,HBfe50okXo4yGURKfz5xhaX3ToIkoF7Q,bWdj2GDclj5ofokWjzoa5jAwMkxCykd6,24,33,16,50,3,10,6,0,118,16.857142857142858,2,0.0,2,16,47,3,31,10,3,6,0,68,50,1
376,8529,lnzFfoDYtlWPJMTPbihufULiQk1Jv9SB,SpATywNh6bZuzm8s1ceuBUnMUAeoAHHw,6,2,1,0,1,0,3,0,7,1.0,1,0.0,0,1,0,1,2,0,0,3,0,2,5,1
377,8540,83bogZlv4TVHMx4MUYOU3yEQWNYHnGAe,G8EPVSXsOYB5YQWZGiz1aVq5Pgr2GrQu,2,13,4,0,0,0,0,0,17,2.4285714285714284,4,0.0,0,4,0,0,13,0,0,0,0,4,13,1
378,8553,aGkT5uzDJUsKsLNIW3C8wBL1bUhJSBfn,SpATywNh6bZuzm8s1ceuBUnMUAeoAHHw,16,18,1,26,0,0,0,0,45,6.428571428571429,3,0.0,7,1,22,0,11,0,4,0,0,30,15,0
379,8570,ApFdQQBcLqTLoA4wIvtlnnwFs4FrlVS1,RXDvfPUBYFlVdlueBFbLW0mhhAyGEqpt,4,2,1,0,0,0,5,0,8,1.1428571428571428,3,0.0,0,1,0,0,2,0,0,5,0,1,7,0
380,8574,7jkKKf5Pb7FrtJ3WnuF11G7ePioUPJm3,A3fsA9Zfv1X2fVEQhTw51lKENdNrEqT3,5,3,2,0,1,0,1,0,7,1.0,1,0.0,0,2,0,1,3,0,0,1,0,3,4,1
381,8582,x0VzAeYdlywtGLqE1HF68qQMYZTLfsw9,SpATywNh6bZuzm8s1ceuBUnMUAeoAHHw,6,10,6,0,2,0,4,0,22,3.142857142857143,2,0.0,0,6,0,2,10,0,0,4,0,8,14,0
382,8585,28jQkMYgDOh7TIBKdGn62G1sm2slN0BP,A3fsA9Zfv1X2fVEQhTw51lKENdNrEqT3,23,9,6,53,3,0,2,0,73,10.428571428571429,2,0.0,0,6,46,3,9,0,7,2,0,55,18,0
383,8586,Xci1viGBABzXjikcwwlwGEGBfmePUlzw,SpATywNh6bZuzm8s1ceuBUnMUAeoAHHw,23,93,37,13,3,30,19,2,197,28.142857142857142,2,0.0,43,37,13,3,50,30,0,19,2,96,101,1
384,8616,GexMn1szbSD50sX3ghgNlwAzziO50D2R,SpATywNh6bZuzm8s1ceuBUnMUAeoAHHw,19,30,5,12,3,11,7,0,68,9.714285714285714,1,0.0,5,5,11,3,25,11,1,7,0,24,44,0
385,8619,7yfm92CNSrFqBw5yp2Efl7B2jNSXGlux,SpATywNh6bZuzm8s1ceuBUnMUAeoAHHw,1,0,0,0,0,0,1,0,1,0.14285714285714285,1,0.0,0,0,0,0,0,0,0,1,0,0,1,1
386,8620,x0VzAeYdlywtGLqE1HF68qQMYZTLfsw9,bWdj2GDclj5ofokWjzoa5jAwMkxCykd6,8,7,5,0,3,0,2,0,17,2.4285714285714284,1,0.0,0,5,0,3,7,0,0,2,0,8,9,1
387,8628,nQgK4glIoTighvWZSrb5cpZqSgT49IUz,SpATywNh6bZuzm8s1ceuBUnMUAeoAHHw,14,17,11,0,6,0,7,0,41,5.857142857142857,3,0.0,2,11,0,6,15,0,0,7,0,19,22,0
388,8636,2tNnsKlcvz4IV4xQh5sF75J9zNq5DtzC,SpATywNh6bZuzm8s1ceuBUnMUAeoAHHw,11,23,1,14,0,0,0,0,38,5.428571428571429,1,0.0,14,1,13,0,9,0,1,0,0,28,10,1
389,8640,g2XbJogybHS3UQDYBcO0HoCO8HfG7ABm,A3fsA9Zfv1X2fVEQhTw51lKENdNrEqT3,8,6,1,2,0,0,2,0,11,1.5714285714285714,1,0.0,0,1,2,0,6,0,0,2,0,3,8,1
390,8641,3dlrFJzmVyUebS1oyKqPiquAJj3CweSU,SpATywNh6bZuzm8s1ceuBUnMUAeoAHHw,17,36,2,15,1,2,8,1,65,9.285714285714286,1,0.0,12,2,12,1,24,2,3,8,1,27,38,1
391,8649,uQjl8NGtIQkRfoe9edBiMgtYYmdkzVXR,bWdj2GDclj5ofokWjzoa5jAwMkxCykd6,5,8,5,0,0,0,5,0,18,2.5714285714285716,3,0.0,0,5,0,0,8,0,0,5,0,5,13,0
392,8652,15n53eqSRMLQKZaiigI2Vgclm7aKceka,A3fsA9Zfv1X2fVEQhTw51lKENdNrEqT3,4,2,0,0,0,0,2,0,4,0.5714285714285714,1,0.0,0,0,0,0,2,0,0,2,0,0,4,0
393,8660,CxUPOQRaQMGLmbOcfniIQOhh24PXLDR6,A3fsA9Zfv1X2fVEQhTw51lKENdNrEqT3,14,23,12,0,4,3,11,1,54,7.714285714285714,4,0.0,0,12,0,4,23,3,0,11,1,16,38,0
394,8677,k6Ev3pOofJatsjXYv6yHRgeWPlAQcaXL,SpATywNh6bZuzm8s1ceuBUnMUAeoAHHw,17,14,9,11,3,0,4,0,41,5.857142857142857,1,0.0,2,9,10,3,12,0,1,4,0,24,17,1
395,8683,xlLP2MUG9CBaax1U0Ai47Er5upBZhMpV,SpATywNh6bZuzm8s1ceuBUnMUAeoAHHw,11,16,10,0,4,0,2,0,32,4.571428571428571,1,0.0,2,10,0,4,14,0,0,2,0,16,16,1
396,8690,NuBf7vtWvcfQjgrelnmNuJu6a5WC9FFT,SpATywNh6bZuzm8s1ceuBUnMUAeoAHHw,16,32,2,12,1,0,7,0,54,7.714285714285714,1,0.0,3,2,12,1,29,0,0,7,0,18,36,0
397,8734,fxq584v5hQmVOHgm4uohGT9XrYo1FGMS,SpATywNh6bZuzm8s1ceuBUnMUAeoAHHw,18,52,13,20,7,0,10,0,102,14.571428571428571,1,0.0,5,13,16,7,47,0,4,10,0,41,61,0
398,8741,XWElpBT4PKnC5pi96PLjtYP5u9l1rrKm,SpATywNh6bZuzm8s1ceuBUnMUAeoAHHw,16,43,22,10,5,2,13,0,95,13.571428571428571,3,0.0,9,22,9,5,34,2,1,13,0,45,50,0
399,8752,tsTDNHtkzUQqr6Le5CiKzEb1J3ub8XpE,G8EPVSXsOYB5YQWZGiz1aVq5Pgr2GrQu,12,16,3,12,5,0,0,0,36,5.142857142857143,3,0.0,5,3,7,5,11,0,5,0,0,20,16,0
400,8756,cPzUMr5q8dc3UpQvyyBObvWhUfY89oua,SpATywNh6bZuzm8s1ceuBUnMUAeoAHHw,28,23,15,30,9,0,4,0,81,11.571428571428571,1,0.0,5,15,25,9,18,0,5,4,0,54,27,1
401,8766,V8icfAYA9I8myBnRTjbheMwStuoZOBk5,SpATywNh6bZuzm8s1ceuBUnMUAeoAHHw,16,32,7,19,0,2,14,2,76,10.857142857142858,3,0.0,6,7,16,0,26,2,3,14,2,29,47,1
402,8768,Za0SfT4qDZpXUZtWaYX1DLLmm9w6G9yO,RXDvfPUBYFlVdlueBFbLW0mhhAyGEqpt,7,7,5,0,2,0,1,0,15,2.142857142857143,1,0.0,0,5,0,2,7,0,0,1,0,7,8,1
403,8772,NLUFE7ndaVQ8A2tkIa8xBpPqWZbahAYT,SpATywNh6bZuzm8s1ceuBUnMUAeoAHHw,17,13,8,26,4,0,4,0,55,7.857142857142857,1,0.0,3,8,21,4,10,0,5,4,0,36,19,0
404,8778,hkmT0j8GDy3ymXnKaIcUDPdFkebvKRou,SpATywNh6bZuzm8s1ceuBUnMUAeoAHHw,19,15,6,23,4,6,9,1,64,9.142857142857142,2,0.0,8,6,19,4,7,6,4,9,1,37,27,0
405,8783,V9A9B2T9pRTU3AqvpqzuKs4MfRcAEte2,RXDvfPUBYFlVdlueBFbLW0mhhAyGEqpt,7,4,3,0,2,0,1,0,10,1.4285714285714286,1,0.0,0,3,0,2,4,0,0,1,0,5,5,1
406,8790,hShFZH2IARrzxZjv2Hbws9rmf9bt3f58,SpATywNh6bZuzm8s1ceuBUnMUAeoAHHw,20,26,9,18,6,0,1,0,60,8.571428571428571,1,0.0,16,9,16,6,10,0,2,1,0,47,13,0
407,8820,sqKEuRhvHf94SnQ2C0IdhOfhaSrrM6tg,SpATywNh6bZuzm8s1ceuBUnMUAeoAHHw,5,20,1,0,0,0,3,0,24,3.4285714285714284,3,0.0,2,1,0,0,18,0,0,3,0,3,21,0
408,8830,LfzKT52vEtoxbNqX2vKaJI7cIpPCsgUd,SpATywNh6bZuzm8s1ceuBUnMUAeoAHHw,7,3,2,0,2,0,4,0,11,1.5714285714285714,1,0.0,0,2,0,2,3,0,0,4,0,4,7,1
409,8831,SoFzOO60yRk0ggHCvfEgIFgyAhcbDPEU,SpATywNh6bZuzm8s1ceuBUnMUAeoAHHw,5,2,1,0,1,0,2,0,6,0.8571428571428571,1,0.0,0,1,0,1,2,0,0,2,0,2,4,1
410,8833,BX9KMh9DUbDRkGw8SYAs3wHv0hHJ990Z,SpATywNh6bZuzm8s1ceuBUnMUAeoAHHw,16,24,16,13,9,0,5,0,67,9.571428571428571,4,0.0,2,16,11,9,22,0,2,5,0,38,29,0
411,8862,5QXD7nGlfa5LD2DcNq8Av61TrcRi85rU,G8EPVSXsOYB5YQWZGiz1aVq5Pgr2GrQu,15,15,1,39,3,0,2,0,60,8.571428571428571,1,0.0,8,1,32,3,7,0,7,2,0,44,16,0
412,8863,4vEHDSGKXu9Cie3on99cieDjI4lud9xW,SpATywNh6bZuzm8s1ceuBUnMUAeoAHHw,12,26,1,14,0,0,2,0,43,6.142857142857143,1,0.0,13,1,13,0,13,0,1,2,0,27,16,1
413,8874,XrkmN79zYVHhoXA87bb44oUhAS8HKFji,SpATywNh6bZuzm8s1ceuBUnMUAeoAHHw,16,35,20,0,3,6,12,1,77,11.0,1,0.0,2,20,0,3,33,6,0,12,1,25,52,1
414,8880,mVMuUEeLKa3SdL5JnStqlN0fzPnKsCAA,SpATywNh6bZuzm8s1ceuBUnMUAeoAHHw,1,0,0,0,0,0,1,0,1,0.14285714285714285,1,0.0,0,0,0,0,0,0,0,1,0,0,1,1
415,8882,NAmyRYUXoAoJaF1WmEUzfZdW5j2jsFh1,SpATywNh6bZuzm8s1ceuBUnMUAeoAHHw,5,3,2,0,1,0,1,0,7,1.0,1,0.0,0,2,0,1,3,0,0,1,0,3,4,0
416,8894,8IuzZOXaXVUql9pLZtNuJIyLoDJ8ZL4V,bWdj2GDclj5ofokWjzoa5jAwMkxCykd6,3,6,2,0,0,0,3,0,11,1.5714285714285714,2,0.0,0,2,0,0,6,0,0,3,0,2,9,1
417,8903,cvlNPzqQj2LOz3Z7WcczCYX7AEEZY5z2,RXDvfPUBYFlVdlueBFbLW0mhhAyGEqpt,7,5,2,0,1,2,6,0,16,2.2857142857142856,1,0.0,0,2,0,1,5,2,0,6,0,3,13,1
418,8908,9lksmcPg7FQE2FGQIA9VvWum1Z9DYrHM,SpATywNh6bZuzm8s1ceuBUnMUAeoAHHw,4,7,4,0,0,0,3,0,14,2.0,1,0.0,2,4,0,0,5,0,0,3,0,6,8,1
419,8915,RlIzEuK7g6sugNWIIhijiyryQft8qZof,SpATywNh6bZuzm8s1ceuBUnMUAeoAHHw,7,5,4,0,3,0,1,0,13,1.8571428571428572,1,0.0,0,4,0,3,5,0,0,1,0,7,6,1
420,8939,awz7o49PrUBSNrYng5ZPMFSJBn6RXWK1,G8EPVSXsOYB5YQWZGiz1aVq5Pgr2GrQu,40,50,32,48,15,0,7,0,152,21.714285714285715,4,0.0,0,32,44,15,50,0,4,7,0,91,61,0
421,8943,dQggCBdg5KVSltApPCgVZB7TTUQzzzoI,RXDvfPUBYFlVdlueBFbLW0mhhAyGEqpt,49,42,24,101,10,22,5,0,204,29.142857142857142,3,0.0,10,24,86,10,32,22,15,5,0,130,74,1
422,8954,N7x6rez9AavUVus2y33zQwbgvW9e4FwN,bWdj2GDclj5ofokWjzoa5jAwMkxCykd6,4,2,1,0,1,0,1,0,5,0.7142857142857143,1,0.0,0,1,0,1,2,0,0,1,0,2,3,1
423,8972,3NITGQuylcrTi63aoWqnzXuF5Rtf7QVq,SpATywNh6bZuzm8s1ceuBUnMUAeoAHHw,12,10,7,0,4,8,1,0,30,4.285714285714286,1,0.0,0,7,0,4,10,8,0,1,0,11,19,1
424,8976,7uaenfsWfnarv8At387iUkznBBW20T7a,SpATywNh6bZuzm8s1ceuBUnMUAeoAHHw,17,31,8,13,3,7,10,1,73,10.428571428571429,2,0.0,16,8,10,3,15,7,3,10,1,37,36,0
425,8978,WCRryRCEKP6zK3AUHtR5dzBwncEtNUH8,G8EPVSXsOYB5YQWZGiz1aVq5Pgr2GrQu,56,108,8,122,8,0,26,0,272,38.857142857142854,6,0.0,41,8,92,8,67,0,30,26,0,149,123,0
426,9001,lvwGRCEVK5ut59266fZHM9ppN9a4Qw6i,SpATywNh6bZuzm8s1ceuBUnMUAeoAHHw,5,3,2,0,1,0,1,0,7,1.0,1,0.0,0,2,0,1,3,0,0,1,0,3,4,1
427,9007,WDMP5c2Ubx8vVSFegA0mXeU23cYb0qCY,RXDvfPUBYFlVdlueBFbLW0mhhAyGEqpt,52,82,7,67,4,34,17,2,213,30.428571428571427,7,0.0,13,7,64,4,69,34,3,17,2,88,125,0
428,9035,ANOp8mWNHTZUswLhYddMTdBChUriYZaX,SpATywNh6bZuzm8s1ceuBUnMUAeoAHHw,15,29,0,25,0,1,7,0,62,8.857142857142858,2,0.0,5,0,23,0,24,1,2,7,0,28,34,0
429,9039,AoGNGJBevj5UJJAo0rhBglhkcP4W6WBy,G8EPVSXsOYB5YQWZGiz1aVq5Pgr2GrQu,1,0,0,0,0,0,1,0,1,0.14285714285714285,1,0.0,0,0,0,0,0,0,0,1,0,0,1,1
430,9043,aiXR63FJxLzLjxOw200I9QHjcVwt5TEN,SpATywNh6bZuzm8s1ceuBUnMUAeoAHHw,7,7,1,0,1,5,2,0,16,2.2857142857142856,1,0.0,0,1,0,1,7,5,0,2,0,2,14,1
431,9136,UqGW2x76mENodjXkUPPKnojGcrLxXcJN,SpATywNh6bZuzm8s1ceuBUnMUAeoAHHw,17,21,10,23,4,2,2,0,62,8.857142857142858,2,0.0,8,10,19,4,13,2,4,2,0,41,21,0
432,9146,ZZYUdx90J4oaTxXr1v9ckDyAAO4fdRrW,bWdj2GDclj5ofokWjzoa5jAwMkxCykd6,4,2,0,0,0,0,2,0,4,0.5714285714285714,1,0.0,0,0,0,0,2,0,0,2,0,0,4,1
433,9149,8SekjqaLbfUPHiuX7ZCPwYfF03sn6XJi,RXDvfPUBYFlVdlueBFbLW0mhhAyGEqpt,8,10,6,6,1,3,0,0,26,3.7142857142857144,2,0.0,2,6,6,1,8,3,0,0,0,15,11,1
434,9190,aP7onqFgeKEyIpEWyf9FmzL3YmPhzgtY,SpATywNh6bZuzm8s1ceuBUnMUAeoAHHw,5,4,2,0,0,0,2,0,8,1.1428571428571428,1,0.0,0,2,0,0,4,0,0,2,0,2,6,1
435,9197,1F8H7rmfvGmKxlm2143vBRoEH3vbZnuH,SpATywNh6bZuzm8s1ceuBUnMUAeoAHHw,7,5,2,0,2,0,4,0,13,1.8571428571428572,1,0.0,0,2,0,2,5,0,0,4,0,4,9,1
436,9206,Gdklwa0GJ75FwxPq1eHDC2rS99nIOtyi,bWdj2GDclj5ofokWjzoa5jAwMkxCykd6,26,34,21,78,5,0,7,0,145,20.714285714285715,3,0.0,6,21,73,5,28,0,5,7,0,105,40,1
437,9211,wSA7fJey1UFj4xGAji5nvUhhmZ43Jtbi,SpATywNh6bZuzm8s1ceuBUnMUAeoAHHw,7,7,2,0,1,0,8,0,18,2.5714285714285716,1,0.0,0,2,0,1,7,0,0,8,0,3,15,1
438,9220,lnpRXkDrSwjGYP4CoWLvjg5xZj4SSBHh,SpATywNh6bZuzm8s1ceuBUnMUAeoAHHw,18,20,12,6,5,1,2,0,46,6.571428571428571,1,0.0,3,12,6,5,17,1,0,2,0,26,20,0
439,9229,pSPqM0wxHLvU8pOPPVGkhJ6iIpXOwE0D,SpATywNh6bZuzm8s1ceuBUnMUAeoAHHw,5,2,1,0,1,3,3,0,10,1.4285714285714286,1,0.0,0,1,0,1,2,3,0,3,0,2,8,1
440,9232,b3doS3mx4rZAsWrCVosVej8UMBCaG0ZM,SpATywNh6bZuzm8s1ceuBUnMUAeoAHHw,16,28,10,18,4,0,2,0,62,8.857142857142858,1,0.0,16,10,17,4,12,0,1,2,0,47,15,1
441,9246,oolYEp2BotSva2yfmUYiIDYQiMjym92z,SpATywNh6bZuzm8s1ceuBUnMUAeoAHHw,6,5,2,0,1,0,1,0,9,1.2857142857142858,1,0.0,0,2,0,1,5,0,0,1,0,3,6,0
442,9257,XQsLTRxBgT09jhwR2kw4g3k34p5O8kHV,A3fsA9Zfv1X2fVEQhTw51lKENdNrEqT3,16,32,17,0,6,11,13,3,82,11.714285714285714,4,0.0,5,17,0,6,27,11,0,13,3,28,54,1
443,9260,OXDIjQPBiuWpB7PdzfniEtiITaq40Kxq,SpATywNh6bZuzm8s1ceuBUnMUAeoAHHw,18,25,12,16,4,0,8,0,65,9.285714285714286,5,0.0,3,12,14,4,22,0,2,8,0,33,32,1
444,9272,8lhedVUrxjbKOOXrDoKpLvh9BgBDrVND,SpATywNh6bZuzm8s1ceuBUnMUAeoAHHw,15,24,8,13,3,0,1,0,49,7.0,1,0.0,8,8,11,3,16,0,2,1,0,30,19,0
445,9273,Mu4L96Qo7KWrVAKYK2IsPfV4EjP9aNL4,G8EPVSXsOYB5YQWZGiz1aVq5Pgr2GrQu,1,0,0,0,0,0,3,0,3,0.42857142857142855,2,0.0,0,0,0,0,0,0,0,3,0,0,3,1
446,9275,Mu4L96Qo7KWrVAKYK2IsPfV4EjP9aNL4,SpATywNh6bZuzm8s1ceuBUnMUAeoAHHw,19,16,9,24,4,0,5,0,58,8.285714285714286,1,0.0,5,9,20,4,11,0,4,5,0,38,20,1
447,9291,0rBpfipIkPUXXv4992tUqetb5IpoweSC,SpATywNh6bZuzm8s1ceuBUnMUAeoAHHw,12,13,1,12,0,0,6,1,33,4.714285714285714,2,0.0,4,1,12,0,9,0,0,6,1,17,16,1
448,9295,Xj0ZJ92JN6F4CNXTzd0Bvhi4bYi9S3VP,SpATywNh6bZuzm8s1ceuBUnMUAeoAHHw,7,5,2,0,1,0,6,0,14,2.0,2,0.0,0,2,0,1,5,0,0,6,0,3,11,0
449,9315,MjPA7JgM9XbkzRn3BICo8xJPG5qfeCcD,bWdj2GDclj5ofokWjzoa5jAwMkxCykd6,3,6,5,0,5,0,0,0,16,2.2857142857142856,2,0.0,0,5,0,5,6,0,0,0,0,10,6,1
450,9327,tJN8ZYcrD7OwnBb01xCqUSDOnzwFRPdf,SpATywNh6bZuzm8s1ceuBUnMUAeoAHHw,14,22,2,6,0,0,4,0,34,4.857142857142857,1,0.0,5,2,6,0,17,0,0,4,0,13,21,0
451,9328,3SP9iNDvUt8m67ZMqC5DpQRe6ekkTpsP,SpATywNh6bZuzm8s1ceuBUnMUAeoAHHw,1,0,0,0,0,0,5,0,5,0.7142857142857143,4,0.0,0,0,0,0,0,0,0,5,0,0,5,1
452,9329,sh6bGbGsbHzTVrRuQUATUDypFgGrJyhP,bWdj2GDclj5ofokWjzoa5jAwMkxCykd6,1,0,0,0,0,0,1,0,1,0.14285714285714285,1,0.0,0,0,0,0,0,0,0,1,0,0,1,1
453,9335,hsFDq5MhfyyJ0opvBTTLO0xNuy1mKh4f,SpATywNh6bZuzm8s1ceuBUnMUAeoAHHw,12,7,6,0,4,0,1,0,18,2.5714285714285716,1,0.0,0,6,0,4,7,0,0,1,0,10,8,1
454,9347,dQweEcdBCmNmUPOeO7X4TTmH8zuMq2aJ,bWdj2GDclj5ofokWjzoa5jAwMkxCykd6,22,23,16,100,0,0,9,0,148,21.142857142857142,1,0.0,2,16,67,0,21,0,33,9,0,85,63,1
455,9357,aSYSmBNLMzBrel3rF1bQSMOfc7OKhL4q,SpATywNh6bZuzm8s1ceuBUnMUAeoAHHw,12,17,9,0,7,0,7,0,40,5.714285714285714,3,0.0,0,9,0,7,17,0,0,7,0,16,24,1
456,9358,I2ghGumCKIaVsnJOGZA0xyJzTnEm5KtW,RXDvfPUBYFlVdlueBFbLW0mhhAyGEqpt,8,8,5,0,1,5,1,0,20,2.857142857142857,1,0.0,1,5,0,1,7,5,0,1,0,7,13,1
457,9362,EoYFOaJU19EU8QGJeHpIRqrgzpIVI4Qd,bWdj2GDclj5ofokWjzoa5jAwMkxCykd6,1,0,0,0,0,0,1,0,1,0.14285714285714285,1,0.0,0,0,0,0,0,0,0,1,0,0,1,1
458,9391,ZVsvi9Hs3gwMngikgiUNz4ONY4BYnfbY,SpATywNh6bZuzm8s1ceuBUnMUAeoAHHw,1,0,0,0,0,0,1,0,1,0.14285714285714285,1,0.0,0,0,0,0,0,0,0,1,0,0,1,1
459,9419,JZCy2v8CZ2nSCAUiBMrG3NWUkCCn6jiz,G8EPVSXsOYB5YQWZGiz1aVq5Pgr2GrQu,21,56,7,0,1,1,5,0,70,10.0,4,0.0,5,7,0,1,51,1,0,5,0,13,57,1
460,9422,KqXKhfoS0ErJVO04c2y8uGBxUt61ck8m,SpATywNh6bZuzm8s1ceuBUnMUAeoAHHw,15,18,1,20,1,0,5,0,45,6.428571428571429,1,0.0,9,1,19,1,9,0,1,5,0,30,15,1
461,9460,zOr0niRplBKfkwpPHNykN96u1FhzegfK,G8EPVSXsOYB5YQWZGiz1aVq5Pgr2GrQu,31,38,29,0,16,16,4,0,103,14.714285714285714,2,0.0,0,29,0,16,38,16,0,4,0,45,58,0
462,9466,XDPvGyFLLEYwbNEQik2MM4yiADs5rrYJ,G8EPVSXsOYB5YQWZGiz1aVq5Pgr2GrQu,2,0,0,0,0,0,2,0,2,0.2857142857142857,1,0.0,0,0,0,0,0,0,0,2,0,0,2,1
463,9468,JnhPqAOFLEpgEufKhwt0tmkUNhkNteVd,SpATywNh6bZuzm8s1ceuBUnMUAeoAHHw,16,19,3,23,0,0,6,0,51,7.285714285714286,2,0.0,6,3,22,0,13,0,1,6,0,31,20,1
464,9469,V4PEne3FGwC3uaaGa4t7iLZtyEIE0fzF,SpATywNh6bZuzm8s1ceuBUnMUAeoAHHw,25,43,10,16,4,15,25,3,116,16.571428571428573,5,0.0,10,10,13,4,33,15,3,25,3,37,79,1
465,9470,XDPvGyFLLEYwbNEQik2MM4yiADs5rrYJ,RXDvfPUBYFlVdlueBFbLW0mhhAyGEqpt,2,0,0,0,0,0,2,0,2,0.2857142857142857,1,0.0,0,0,0,0,0,0,0,2,0,0,2,1
466,9480,xNIFyatWugs5Maa0edr0HyKzFRsz7FQp,G8EPVSXsOYB5YQWZGiz1aVq5Pgr2GrQu,2,0,0,0,0,0,2,0,2,0.2857142857142857,1,0.0,0,0,0,0,0,0,0,2,0,0,2,1
467,9482,2YohZ5UKGzy1qUgVAShosLdhgm3pfvsR,SpATywNh6bZuzm8s1ceuBUnMUAeoAHHw,6,3,1,0,1,0,2,0,7,1.0,1,0.0,0,1,0,1,3,0,0,2,0,2,5,1
468,9510,20lTdK7j1fcbNyoe9mD2q7qXvA5Z8HOD,SpATywNh6bZuzm8s1ceuBUnMUAeoAHHw,18,30,20,0,15,0,3,0,68,9.714285714285714,1,0.0,5,20,0,15,25,0,0,3,0,40,28,0
469,9517,fN4I0M2Yv3uPvseFkDyQdSg5ZokzJaMj,RXDvfPUBYFlVdlueBFbLW0mhhAyGEqpt,25,33,23,56,9,100,0,0,221,31.571428571428573,2,0.0,6,23,51,9,27,100,5,0,0,89,132,1
470,9533,xdUSsALCLmQFNaGX8BEyTR2RhmvhWdsB,SpATywNh6bZuzm8s1ceuBUnMUAeoAHHw,17,9,6,12,4,0,3,0,34,4.857142857142857,1,0.0,2,6,12,4,7,0,0,3,0,24,10,0
471,9549,RV3mgnFEm5em6PXoEJeQNSKFCpjzfVyy,bWdj2GDclj5ofokWjzoa5jAwMkxCykd6,10,10,4,4,1,75,18,0,112,16.0,5,0.0,1,4,3,1,9,75,1,18,0,9,103,0
472,9550,7J9JIWVCQG1g6yXh3uTVbrSu3pa18Ezn,SpATywNh6bZuzm8s1ceuBUnMUAeoAHHw,28,37,23,18,7,7,9,2,103,14.714285714285714,2,0.0,9,23,17,7,28,7,1,9,2,56,47,0
473,9581,c9jAWas5mvRKYRBHiOkTzLeYoPWRHLa3,G8EPVSXsOYB5YQWZGiz1aVq5Pgr2GrQu,1,0,0,0,0,0,2,0,2,0.2857142857142857,1,0.0,0,0,0,0,0,0,0,2,0,0,2,1
474,9624,GD8FRA1y66qb4KlW9w61HoAU1TWGpDoa,G8EPVSXsOYB5YQWZGiz1aVq5Pgr2GrQu,17,24,11,18,0,284,54,4,395,56.42857142857143,7,0.0,1,11,16,0,23,284,2,54,4,28,367,0
475,9636,zcw6JFT1cBTyKAWUWt6eG4jvVYxHMSLq,SpATywNh6bZuzm8s1ceuBUnMUAeoAHHw,17,18,9,14,3,0,2,0,46,6.571428571428571,1,0.0,6,9,13,3,12,0,1,2,0,31,15,0
476,9643,UzwJVyLJF6Ih9iHYPyYWMullgIr89o5m,SpATywNh6bZuzm8s1ceuBUnMUAeoAHHw,10,10,6,8,0,0,2,0,26,3.7142857142857144,2,0.0,2,6,8,0,8,0,0,2,0,16,10,0
477,9655,66U3TkcZA1aSl7HKRun9CzahgGH85zQD,SpATywNh6bZuzm8s1ceuBUnMUAeoAHHw,16,13,7,6,4,9,4,0,43,6.142857142857143,2,0.0,5,7,6,4,8,9,0,4,0,22,21,0
478,9663,C4q4gNQYEpjKh7pq1qjN8i3L7uSpUX9d,bWdj2GDclj5ofokWjzoa5jAwMkxCykd6,26,13,8,88,2,3,7,2,123,17.571428571428573,2,0.0,2,8,76,2,11,3,12,7,2,88,35,0
479,9720,0dBn4alo7QBTd62VD5XO0yNMbQ5QN2OQ,bWdj2GDclj5ofokWjzoa5jAwMkxCykd6,9,19,7,0,4,0,1,0,31,4.428571428571429,1,0.0,0,7,0,4,19,0,0,1,0,11,20,1
480,9724,YwojqO58bCgaotjJoOTtpKH2oiEFOZyB,bWdj2GDclj5ofokWjzoa5jAwMkxCykd6,9,5,3,10,4,0,0,0,22,3.142857142857143,1,0.0,2,3,8,4,3,0,2,0,0,17,5,1
481,9746,ZPXEPNmHJO62FgTOVc5NtKcudTAnHNKW,SpATywNh6bZuzm8s1ceuBUnMUAeoAHHw,5,2,1,0,1,0,2,0,6,0.8571428571428571,2,0.0,0,1,0,1,2,0,0,2,0,2,4,1
482,9760,HNHEsc9fD0OwHisMoqyCkexAkrQ9Muqq,bWdj2GDclj5ofokWjzoa5jAwMkxCykd6,6,4,2,0,1,0,5,0,12,1.7142857142857142,1,0.0,0,2,0,1,4,0,0,5,0,3,9,0
483,9783,CZfXDHVnNPClikyXrFzPhkQoFiILzXmF,SpATywNh6bZuzm8s1ceuBUnMUAeoAHHw,13,22,1,16,0,0,1,0,40,5.714285714285714,1,0.0,7,1,14,0,15,0,2,1,0,22,18,0
484,9784,WnYAypmYi03odcBC7NgJFsh1FzqrpNw6,SpATywNh6bZuzm8s1ceuBUnMUAeoAHHw,5,3,2,0,1,0,1,0,7,1.0,1,0.0,0,2,0,1,3,0,0,1,0,3,4,0
485,9790,yUvG5Vqh097epwWCIkZetr2ZlwvQRcLL,SpATywNh6bZuzm8s1ceuBUnMUAeoAHHw,10,15,3,6,0,0,6,0,30,4.285714285714286,3,0.0,6,3,6,0,9,0,0,6,0,15,15,0
486,9793,B2ahwtOo16YsNrAQ9LRd2yjP18Ni9l2c,SpATywNh6bZuzm8s1ceuBUnMUAeoAHHw,15,83,13,6,9,0,11,0,122,17.428571428571427,6,0.0,2,13,6,9,81,0,0,11,0,30,92,0
487,9797,Dnyzk8ev480byt0tTEIN8mPtG79PwCH1,RXDvfPUBYFlVdlueBFbLW0mhhAyGEqpt,4,6,4,0,2,0,0,0,12,1.7142857142857142,3,0.0,0,4,0,2,6,0,0,0,0,6,6,1
488,9812,fARr9B8lZ63xDV7GkxAczvRhzY3xBLi6,RXDvfPUBYFlVdlueBFbLW0mhhAyGEqpt,4,4,0,0,0,2,1,0,7,1.0,2,0.0,0,0,0,0,4,2,0,1,0,0,7,1
489,9839,bunHowa0BgtekXN64zdm8G1L1XdN8gBZ,bWdj2GDclj5ofokWjzoa5jAwMkxCykd6,6,7,1,4,1,0,4,0,17,2.4285714285714284,1,0.0,4,1,4,1,3,0,0,4,0,10,7,1
490,9852,1wIqcRX58Bpw6RXvGnbxsc6WbPwWGwXd,SpATywNh6bZuzm8s1ceuBUnMUAeoAHHw,14,29,2,17,0,0,8,0,56,8.0,2,0.0,12,2,16,0,17,0,1,8,0,30,26,0
491,9869,0RNr6P08D2zaPSoifoE3KvUeNCFcBSvA,SpATywNh6bZuzm8s1ceuBUnMUAeoAHHw,13,21,1,6,0,0,2,0,30,4.285714285714286,2,0.0,4,1,6,0,17,0,0,2,0,11,19,0
492,9873,u4s0SPiIkynucY7ReF58TL89R2q4zw1x,SpATywNh6bZuzm8s1ceuBUnMUAeoAHHw,15,18,9,6,5,0,2,0,40,5.714285714285714,2,0.0,2,9,6,5,16,0,0,2,0,22,18,1
493,9904,OfMabADNCpK7MfQ7IaqBsUw8RvPeHL0S,RXDvfPUBYFlVdlueBFbLW0mhhAyGEqpt,28,47,29,38,14,8,10,0,146,20.857142857142858,3,0.0,12,29,38,14,35,8,0,10,0,93,53,0
494,9923,CRrOxkmi8hXpA4NrCBnJ87Z2odaZzKo5,SpATywNh6bZuzm8s1ceuBUnMUAeoAHHw,20,13,7,14,4,14,6,1,59,8.428571428571429,1,0.0,5,7,14,4,8,14,0,6,1,30,29,1
495,9928,ylxIxsQV8oDzYk1f9bdd1UWiUi1ODLbL,SpATywNh6bZuzm8s1ceuBUnMUAeoAHHw,15,50,1,8,1,8,14,0,82,11.714285714285714,4,0.0,6,1,8,1,44,8,0,14,0,16,66,0
496,9929,oaL3pbpAfEH9L4o42G6X4xjme1kXt2tm,SpATywNh6bZuzm8s1ceuBUnMUAeoAHHw,16,29,16,12,11,0,7,0,75,10.714285714285714,4,0.0,2,16,11,11,27,0,1,7,0,40,35,0
497,9943,KXKbDyPytrUZAnNaQjyZgMFkA2w3Wpvj,SpATywNh6bZuzm8s1ceuBUnMUAeoAHHw,26,57,38,38,18,42,15,1,209,29.857142857142858,3,0.0,10,38,30,18,47,42,8,15,1,96,113,1
498,9946,Jd5OP6GIsguRdsq9k3eSYNENmzhPbdGe,G8EPVSXsOYB5YQWZGiz1aVq5Pgr2GrQu,1,0,0,0,0,0,1,0,1,0.14285714285714285,1,0.0,0,0,0,0,0,0,0,1,0,0,1,0
499,9949,IUn6MADAjAYkGlJisA1WiDvCeNlJd5Xd,SpATywNh6bZuzm8s1ceuBUnMUAeoAHHw,16,20,15,6,10,0,3,0,54,7.714285714285714,3,0.0,3,15,6,10,17,0,0,3,0,34,20,0
500,9953,KeGByI8uvXcUVBvZaFAzVTfOuPfjSv5Y,SpATywNh6bZuzm8s1ceuBUnMUAeoAHHw,9,13,5,0,0,4,16,1,39,5.571428571428571,3,0.0,4,5,0,0,9,4,0,16,1,9,30,1
501,9963,YleydB3G0OM4jGw8hrXeA6aAbHfKvakN,SpATywNh6bZuzm8s1ceuBUnMUAeoAHHw,8,5,4,0,2,0,1,0,12,1.7142857142857142,1,0.0,0,4,0,2,5,0,0,1,0,6,6,1
502,9970,Eok9XbYPb68kijAV2YozwwDkJT3HyKxy,RXDvfPUBYFlVdlueBFbLW0mhhAyGEqpt,6,4,3,0,1,0,1,0,9,1.2857142857142858,1,0.0,0,3,0,1,4,0,0,1,0,4,5,1
503,9976,lGkFqL5UAvY3j67ej7JQek066TD04jDH,bWdj2GDclj5ofokWjzoa5jAwMkxCykd6,1,0,0,0,0,0,1,0,1,0.14285714285714285,1,0.0,0,0,0,0,0,0,0,1,0,0,1,1
504,9988,GVRJN4wkoooaXJUVmwnX983A87KsrZPK,SpATywNh6bZuzm8s1ceuBUnMUAeoAHHw,16,28,17,8,7,154,10,1,225,32.142857142857146,5,0.0,5,17,7,7,23,154,1,10,1,36,189,0
505,10015,gFtSwrFBdsFWgLyqjSCzwaUhlQmEHgOq,SpATywNh6bZuzm8s1ceuBUnMUAeoAHHw,14,11,8,6,5,0,2,0,32,4.571428571428571,2,0.0,0,8,5,5,11,0,1,2,0,18,14,0
506,10016,5z0TnHJcRYhCDHjnNu4kmaWirO8lucwr,SpATywNh6bZuzm8s1ceuBUnMUAeoAHHw,13,135,5,0,4,3,10,0,157,22.428571428571427,3,0.0,24,5,0,4,111,3,0,10,0,33,124,1
507,10018,yzEVvmdwGMRoO2gS2DXIrqQbxP7DOJod,SpATywNh6bZuzm8s1ceuBUnMUAeoAHHw,7,3,2,0,2,0,2,0,9,1.2857142857142858,1,0.0,0,2,0,2,3,0,0,2,0,4,5,1
508,10024,FELnhQR0c7GZZX82ioYJEZsqujOrfyf7,bWdj2GDclj5ofokWjzoa5jAwMkxCykd6,4,2,1,0,0,3,2,0,8,1.1428571428571428,1,0.0,0,1,0,0,2,3,0,2,0,1,7,1
509,10035,FELnhQR0c7GZZX82ioYJEZsqujOrfyf7,A3fsA9Zfv1X2fVEQhTw51lKENdNrEqT3,2,0,0,0,0,4,2,0,6,0.8571428571428571,1,0.0,0,0,0,0,0,4,0,2,0,0,6,1
510,10050,syrttArug8Mpzs9L0IHsvBtATawYF9J2,RXDvfPUBYFlVdlueBFbLW0mhhAyGEqpt,7,5,3,0,2,0,4,0,14,2.0,2,0.0,0,3,0,2,5,0,0,4,0,5,9,1
511,10059,UOOsauq1lFlLECbNF7MRjSfLxlpKxsoG,SpATywNh6bZuzm8s1ceuBUnMUAeoAHHw,15,10,6,6,5,0,5,0,32,4.571428571428571,2,0.0,2,6,6,5,8,0,0,5,0,19,13,0
512,10062,e0buQlxlHVWdQd03EOAehldJOI8AeFTm,SpATywNh6bZuzm8s1ceuBUnMUAeoAHHw,18,26,12,9,8,3,2,0,60,8.571428571428571,1,0.0,9,12,9,8,17,3,0,2,0,38,22,1
513,10077,Hm4CsH22c8YOwrQia0hrSt9jO8gMpoFd,SpATywNh6bZuzm8s1ceuBUnMUAeoAHHw,9,7,2,0,2,0,4,0,15,2.142857142857143,1,0.0,0,2,0,2,7,0,0,4,0,4,11,1
514,10101,30Velr3UVYghs85WZNOKXFcrgzOgBsfI,SpATywNh6bZuzm8s1ceuBUnMUAeoAHHw,19,14,8,14,4,9,8,0,57,8.142857142857142,3,0.0,4,8,13,4,10,9,1,8,0,29,28,0
515,10103,yS4oyG8z71VcMw1yy9w2LWRiDWgGhtKA,SpATywNh6bZuzm8s1ceuBUnMUAeoAHHw,5,3,2,0,1,0,1,0,7,1.0,1,0.0,0,2,0,1,3,0,0,1,0,3,4,0
516,10113,D1iAkJgGLDV90w339eOp4Bqd5z6wvBY6,G8EPVSXsOYB5YQWZGiz1aVq5Pgr2GrQu,26,25,13,41,7,0,6,1,93,13.285714285714286,1,0.0,8,13,34,7,17,0,7,6,1,62,31,1
517,10123,pAxOMca5gwJLembsUpWhZwow68Ox9dFB,SpATywNh6bZuzm8s1ceuBUnMUAeoAHHw,31,63,22,44,11,21,13,0,174,24.857142857142858,3,0.0,26,22,34,11,37,21,10,13,0,93,81,0
518,10132,ILMhPMpEir8VP8Uy0NQI7guQFniKAiGh,SpATywNh6bZuzm8s1ceuBUnMUAeoAHHw,19,33,12,6,5,1,8,1,66,9.428571428571429,3,0.0,9,12,6,5,24,1,0,8,1,32,34,0
519,10149,KG1VMsurgFKqkMv9nVqkO9ppjva59kYw,SpATywNh6bZuzm8s1ceuBUnMUAeoAHHw,9,12,7,0,1,0,7,0,27,3.857142857142857,1,0.0,2,7,0,1,10,0,0,7,0,10,17,0
520,10157,CUHsvexAAfaCEMKsM3644JTxXL5DgSss,SpATywNh6bZuzm8s1ceuBUnMUAeoAHHw,5,3,1,0,1,0,1,0,6,0.8571428571428571,1,0.0,0,1,0,1,3,0,0,1,0,2,4,1
521,10173,ewZzdypyl0fDIzKshXnlZXjyO7oizoCq,SpATywNh6bZuzm8s1ceuBUnMUAeoAHHw,7,11,0,0,0,0,1,0,12,1.7142857142857142,2,0.0,0,0,0,0,11,0,0,1,0,0,12,1
522,10183,rf43ZHojMqXQ775bmX3nnHgQ62d9XvGK,SpATywNh6bZuzm8s1ceuBUnMUAeoAHHw,17,18,9,9,4,0,3,0,43,6.142857142857143,3,0.0,2,9,9,4,16,0,0,3,0,24,19,1
523,10188,2rS9ufrltSIJVkQHjlKCjTvqcoR7anzz,A3fsA9Zfv1X2fVEQhTw51lKENdNrEqT3,5,4,1,0,0,0,1,0,6,0.8571428571428571,1,0.0,0,1,0,0,4,0,0,1,0,1,5,1
524,10189,sY8CcZG79KJSl2UAc47IiYJD1k5ghqCN,SpATywNh6bZuzm8s1ceuBUnMUAeoAHHw,6,8,4,0,2,0,2,0,16,2.2857142857142856,2,0.0,0,4,0,2,8,0,0,2,0,6,10,1
525,10197,tqvOTiQbipkIXQL7CIR5dckxV83rng9S,SpATywNh6bZuzm8s1ceuBUnMUAeoAHHw,7,12,7,0,2,0,4,0,25,3.5714285714285716,2,0.0,0,7,0,2,12,0,0,4,0,9,16,0
526,10201,MB156dsmOWVhw7SmCPNYcmBUK9V54bIt,SpATywNh6bZuzm8s1ceuBUnMUAeoAHHw,13,52,7,0,6,1,14,4,84,12.0,2,0.0,0,7,0,6,52,1,0,14,4,13,71,1
527,10217,VWRhwnsbyy7kINpd5Pldlp01a86tVlAt,SpATywNh6bZuzm8s1ceuBUnMUAeoAHHw,18,24,16,0,7,8,14,3,72,10.285714285714286,2,0.0,0,16,0,7,24,8,0,14,3,23,49,0
528,10220,L4Uo99RvQ1cxFdSSaMag731dHicuHxV2,SpATywNh6bZuzm8s1ceuBUnMUAeoAHHw,15,11,0,24,0,1,9,1,46,6.571428571428571,2,0.0,2,0,18,0,9,1,6,9,1,20,26,0
529,10226,DHenWrxVzReZszxo1qw3Im0Zj99tiAII,bWdj2GDclj5ofokWjzoa5jAwMkxCykd6,16,16,11,0,6,0,7,0,40,5.714285714285714,2,0.0,0,11,0,6,16,0,0,7,0,17,23,1
530,10229,NF3XhJyO8NABn8EYOnk4mda6QMNEzq1R,SpATywNh6bZuzm8s1ceuBUnMUAeoAHHw,5,4,1,0,1,0,1,0,7,1.0,1,0.0,0,1,0,1,4,0,0,1,0,2,5,1
531,10239,tFhufiT6u4TsvucRy3FgIz40XsxZ2qh7,SpATywNh6bZuzm8s1ceuBUnMUAeoAHHw,7,4,3,0,3,0,4,0,14,2.0,1,0.0,0,3,0,3,4,0,0,4,0,6,8,1
532,10241,7kTdvih7UMOiFKC9aXRp88JppGP4qSKH,G8EPVSXsOYB5YQWZGiz1aVq5Pgr2GrQu,15,11,5,8,4,0,2,0,30,4.285714285714286,2,0.0,4,5,4,4,7,0,4,2,0,17,13,1
533,10243,YdCaKimqYb8kuFiHEtjPDsCbtIch1tfO,SpATywNh6bZuzm8s1ceuBUnMUAeoAHHw,15,24,8,27,1,0,2,0,62,8.857142857142858,1,0.0,14,8,21,1,10,0,6,2,0,44,18,0
534,10266,8Q42Hi4bJP7SqbH4XystURHk2B8tBI5i,G8EPVSXsOYB5YQWZGiz1aVq5Pgr2GrQu,19,4,3,64,1,0,1,0,73,10.428571428571429,1,0.0,0,3,54,1,4,0,10,1,0,58,15,0
535,10285,GIsRCDxWVYGm4So2chhYPzgj7oVxCsSB,SpATywNh6bZuzm8s1ceuBUnMUAeoAHHw,9,6,1,0,1,0,2,0,10,1.4285714285714286,1,0.0,0,1,0,1,6,0,0,2,0,2,8,1
536,10332,86utfBtmFqtE8TLsj2h1BusfBdMTH1O8,G8EPVSXsOYB5YQWZGiz1aVq5Pgr2GrQu,1,0,0,0,0,0,1,0,1,0.14285714285714285,1,0.0,0,0,0,0,0,0,0,1,0,0,1,1
537,10345,cRvonGDWMKfxHYP6TdkGqL61F16M4yAA,SpATywNh6bZuzm8s1ceuBUnMUAeoAHHw,15,24,7,23,3,0,2,0,59,8.428571428571429,1,0.0,14,7,18,3,10,0,5,2,0,42,17,1
538,10350,VPNixAQG356EF5jDEqbiZrQi2WBUwBq3,bWdj2GDclj5ofokWjzoa5jAwMkxCykd6,1,0,0,0,0,0,1,0,1,0.14285714285714285,1,0.0,0,0,0,0,0,0,0,1,0,0,1,1
539,10366,c4eku5xKmsJEaRwRx0NUj58EVKBhTUlh,bWdj2GDclj5ofokWjzoa5jAwMkxCykd6,1,0,0,0,0,0,1,0,1,0.14285714285714285,1,0.0,0,0,0,0,0,0,0,1,0,0,1,1
540,10385,4SjsVB9NX97jh5FCSnOdHgEUANJ1svZm,SpATywNh6bZuzm8s1ceuBUnMUAeoAHHw,17,15,8,13,4,0,3,0,43,6.142857142857143,1,0.0,6,8,11,4,9,0,2,3,0,29,14,0
541,10387,MicTROP14z0YujgzSBBjIifCsW8T6Yg4,RXDvfPUBYFlVdlueBFbLW0mhhAyGEqpt,6,0,0,0,0,1,6,1,8,1.1428571428571428,1,0.0,0,0,0,0,0,1,0,6,1,0,8,1
542,10394,EF3EfvSrA0c1KnpZ3bhY87a1rscondwY,SpATywNh6bZuzm8s1ceuBUnMUAeoAHHw,17,22,11,20,5,0,5,0,63,9.0,2,0.0,6,11,17,5,16,0,3,5,0,39,24,0
543,10399,D2M0lUAbb3NbvYyEfkDkoqJ8mQHTb4db,G8EPVSXsOYB5YQWZGiz1aVq5Pgr2GrQu,39,31,11,48,8,12,2,0,112,16.0,1,0.0,19,11,28,8,12,12,20,2,0,66,46,0
544,10402,CQOn4KWCA0duDCOSP1DQzvXZ3yAfq1zW,RXDvfPUBYFlVdlueBFbLW0mhhAyGEqpt,33,47,32,95,18,81,15,6,294,42.0,3,0.0,8,32,84,18,39,81,11,15,6,142,152,0
545,10420,Eu9HoDt3WhECHgcXaERosbI6lMj7Hipb,bWdj2GDclj5ofokWjzoa5jAwMkxCykd6,14,27,17,0,10,0,6,0,60,8.571428571428571,3,0.0,3,17,0,10,24,0,0,6,0,30,30,0
546,10437,N0P6Yrg1zRuUPyVufFpM0ZExnJnGTKKG,SpATywNh6bZuzm8s1ceuBUnMUAeoAHHw,14,18,2,8,0,0,7,0,35,5.0,1,0.0,2,2,8,0,16,0,0,7,0,12,23,0
547,10445,wXYPFlL861BbeAt6BcFbVApC7BUFADjk,A3fsA9Zfv1X2fVEQhTw51lKENdNrEqT3,6,14,0,0,0,0,2,0,16,2.2857142857142856,1,0.0,0,0,0,0,14,0,0,2,0,0,16,1
548,10451,JLVzu9EMywyHTSJk37J5rGpw1UsulAZc,SpATywNh6bZuzm8s1ceuBUnMUAeoAHHw,15,68,24,0,10,1,22,3,128,18.285714285714285,2,0.0,10,24,0,10,58,1,0,22,3,44,84,1
549,10454,6tpE26inQQeNPyhZ0HoRMm7l4NlMiWJC,SpATywNh6bZuzm8s1ceuBUnMUAeoAHHw,6,3,1,0,1,0,2,0,7,1.0,1,0.0,0,1,0,1,3,0,0,2,0,2,5,0
550,10463,uhU9XFMHqXe19d0SBpTzsSNqTtdSMXBT,SpATywNh6bZuzm8s1ceuBUnMUAeoAHHw,19,32,21,2,5,2,13,0,75,10.714285714285714,3,0.0,6,21,2,5,26,2,0,13,0,34,41,1
551,10471,l7T8dOWG1cEtOxAxVcD5zNV6vn1g4oYM,G8EPVSXsOYB5YQWZGiz1aVq5Pgr2GrQu,2,0,0,0,0,0,6,0,6,0.8571428571428571,4,0.0,0,0,0,0,0,0,0,6,0,0,6,1
552,10475,haRKCROopZUqu2HvR7rfja2IzweZ0l2Z,G8EPVSXsOYB5YQWZGiz1aVq5Pgr2GrQu,1,0,0,0,0,0,1,0,1,0.14285714285714285,1,0.0,0,0,0,0,0,0,0,1,0,0,1,1
553,10483,TroWrp5S8FhNJSgSuQ7Yk9WR8zsmBapA,SpATywNh6bZuzm8s1ceuBUnMUAeoAHHw,6,3,2,0,1,0,2,0,8,1.1428571428571428,1,0.0,0,2,0,1,3,0,0,2,0,3,5,1
554,10491,egnijdxL4Cz1CfzoCQSNIgWry6KIzA7P,SpATywNh6bZuzm8s1ceuBUnMUAeoAHHw,4,6,2,0,0,0,1,0,9,1.2857142857142858,1,0.0,0,2,0,0,6,0,0,1,0,2,7,0
555,10505,L5cqiD5dkEVfnPDeQYK5cFR9ssDpnyPm,SpATywNh6bZuzm8s1ceuBUnMUAeoAHHw,2,0,0,0,0,0,2,0,2,0.2857142857142857,1,0.0,0,0,0,0,0,0,0,2,0,0,2,1
556,10507,rf43ZHojMqXQ775bmX3nnHgQ62d9XvGK,bWdj2GDclj5ofokWjzoa5jAwMkxCykd6,10,17,8,4,2,2,6,0,39,5.571428571428571,4,0.0,1,8,4,2,16,2,0,6,0,15,24,0
557,10519,lnzFfoDYtlWPJMTPbihufULiQk1Jv9SB,bWdj2GDclj5ofokWjzoa5jAwMkxCykd6,7,7,1,0,1,0,3,0,12,1.7142857142857142,1,0.0,0,1,0,1,7,0,0,3,0,2,10,1
558,10537,4zppanuK6US9rtvd04IL60AQkgDx5lm5,RXDvfPUBYFlVdlueBFbLW0mhhAyGEqpt,12,14,1,0,0,3,2,0,20,2.857142857142857,1,0.0,0,1,0,0,14,3,0,2,0,1,19,1
559,10538,xhM6sGbifURQLX65jKTsRiTJp9ePqM2R,RXDvfPUBYFlVdlueBFbLW0mhhAyGEqpt,1,0,0,0,0,0,1,0,1,0.14285714285714285,1,0.0,0,0,0,0,0,0,0,1,0,0,1,1
560,10560,m4jrmeR3FtkOUCbFelK4w5ennRkxlxWD,A3fsA9Zfv1X2fVEQhTw51lKENdNrEqT3,18,12,8,24,4,0,3,0,51,7.285714285714286,2,0.0,1,8,19,4,11,0,5,3,0,32,19,0
561,10563,IQCtPVNPylpjpNjZtQrr88vV5qPansN0,SpATywNh6bZuzm8s1ceuBUnMUAeoAHHw,18,12,9,8,4,0,1,0,34,4.857142857142857,1,0.0,2,9,8,4,10,0,0,1,0,23,11,0
562,10569,54BZa2PEVowNqI6EO6NzeCnkR49ry3oS,SpATywNh6bZuzm8s1ceuBUnMUAeoAHHw,14,22,0,13,0,27,8,0,70,10.0,3,0.0,4,0,10,0,18,27,3,8,0,14,56,0
563,10574,NFgPnsok64XIrx8pioLRAIHoliaoDIvn,SpATywNh6bZuzm8s1ceuBUnMUAeoAHHw,10,16,4,20,0,0,7,0,47,6.714285714285714,2,0.0,5,4,17,0,11,0,3,7,0,26,21,0
564,10579,QoRl6lUIBIR1pRLScf6eg36kOBc6a9q5,SpATywNh6bZuzm8s1ceuBUnMUAeoAHHw,2,0,0,0,0,0,4,0,4,0.5714285714285714,1,0.0,0,0,0,0,0,0,0,4,0,0,4,1
565,10607,ySOA4rbQpe1GOPfJP5VkUnJIGjlF7GXO,SpATywNh6bZuzm8s1ceuBUnMUAeoAHHw,14,20,0,18,0,0,3,0,41,5.857142857142857,2,0.0,10,0,15,0,10,0,3,3,0,25,16,1
566,10612,BTSZE2PXdA7MkOyBKPCnqqHRa0lxJtHO,SpATywNh6bZuzm8s1ceuBUnMUAeoAHHw,14,18,0,25,0,0,4,0,47,6.714285714285714,3,0.0,4,0,21,0,14,0,4,4,0,25,22,0
567,10627,80aCDppJ7kPmOrquzLdsI5OBB47H5IdW,G8EPVSXsOYB5YQWZGiz1aVq5Pgr2GrQu,2,0,0,0,0,0,2,0,2,0.2857142857142857,1,0.0,0,0,0,0,0,0,0,2,0,0,2,1
568,10629,okYlHVritwXcHhkiNLd9pfhBZv2uubiO,SpATywNh6bZuzm8s1ceuBUnMUAeoAHHw,27,22,12,33,9,1,4,0,81,11.571428571428571,2,0.0,7,12,29,9,15,1,4,4,0,57,24,1
569,10641,Q5TmTVdy8nnH2vTL73s67ZseaCMO3k91,SpATywNh6bZuzm8s1ceuBUnMUAeoAHHw,10,4,4,0,3,0,2,0,13,1.8571428571428572,1,0.0,0,4,0,3,4,0,0,2,0,7,6,0
570,10652,teqJGecOr4a6oVYU1O9bgvPkX5ZSKA8N,SpATywNh6bZuzm8s1ceuBUnMUAeoAHHw,16,14,9,0,6,0,4,0,33,4.714285714285714,2,0.0,0,9,0,6,14,0,0,4,0,15,18,0
571,10653,7xJbwgQFzeH69YJLbZncWAGT3dRrKubC,bWdj2GDclj5ofokWjzoa5jAwMkxCykd6,17,15,6,86,5,1,8,1,122,17.428571428571427,1,0.0,6,6,85,5,9,1,1,8,1,102,20,0
572,10687,CXT3urKvwCIfBmuQmODRcZXAAAJs07Dk,RXDvfPUBYFlVdlueBFbLW0mhhAyGEqpt,1,0,0,0,0,0,1,0,1,0.14285714285714285,1,0.0,0,0,0,0,0,0,0,1,0,0,1,1
573,10705,CeupRRMHE9iQJGvyrBKaDsPPM9lhEl5t,SpATywNh6bZuzm8s1ceuBUnMUAeoAHHw,18,21,13,10,4,3,6,0,57,8.142857142857142,3,0.0,2,13,8,4,19,3,2,6,0,27,30,0
574,10721,trG5MFuNMIgyTGz1X8WvOUa7Zgqkp3Oe,SpATywNh6bZuzm8s1ceuBUnMUAeoAHHw,17,18,7,18,3,3,7,2,58,8.285714285714286,1,0.0,9,7,15,3,9,3,3,7,2,34,24,1
575,10738,uyomj5PLSD8MuBnIm3UXNOM2zJB1f3kv,bWdj2GDclj5ofokWjzoa5jAwMkxCykd6,6,4,3,0,1,0,1,0,9,1.2857142857142858,1,0.0,0,3,0,1,4,0,0,1,0,4,5,1
576,10804,kGzsRVbG5WMbWj0lYrhayqrDZ1knQphM,SpATywNh6bZuzm8s1ceuBUnMUAeoAHHw,1,0,0,0,0,0,1,0,1,0.14285714285714285,1,0.0,0,0,0,0,0,0,0,1,0,0,1,1
577,10808,8dXlYKMlojZ10oWsfo0feSv9eUr2FQcM,G8EPVSXsOYB5YQWZGiz1aVq5Pgr2GrQu,5,2,1,0,1,0,2,0,6,0.8571428571428571,1,0.0,0,1,0,1,2,0,0,2,0,2,4,1
578,10809,gzv7fk7jLAAb6tXwbmA5ceisqqnvcETz,SpATywNh6bZuzm8s1ceuBUnMUAeoAHHw,8,5,4,0,2,2,1,0,14,2.0,1,0.0,0,4,0,2,5,2,0,1,0,6,8,0
579,10819,v21GnAmoo56SIXGBSOh9jDiYo8T7Od29,SpATywNh6bZuzm8s1ceuBUnMUAeoAHHw,14,27,0,7,0,0,4,0,38,5.428571428571429,2,0.0,10,0,7,0,17,0,0,4,0,17,21,0
580,10822,xYLJB56SVkFUOdT5vN3Qq6OYNlnP0Fjc,RXDvfPUBYFlVdlueBFbLW0mhhAyGEqpt,15,23,9,0,7,0,7,0,46,6.571428571428571,3,0.0,0,9,0,7,23,0,0,7,0,16,30,0
581,10823,aGY42WVQQtCQKQRks3knIxGWrLxCy60h,G8EPVSXsOYB5YQWZGiz1aVq5Pgr2GrQu,10,4,0,0,0,3,7,1,15,2.142857142857143,1,0.0,0,0,0,0,4,3,0,7,1,0,15,1
582,10835,kGzsRVbG5WMbWj0lYrhayqrDZ1knQphM,bWdj2GDclj5ofokWjzoa5jAwMkxCykd6,1,0,0,0,0,0,1,0,1,0.14285714285714285,1,0.0,0,0,0,0,0,0,0,1,0,0,1,1
583,10853,2uZ2ZHQBnnVrb5vAtTu1AloVYtZL1MXg,G8EPVSXsOYB5YQWZGiz1aVq5Pgr2GrQu,40,98,27,65,13,7,22,0,232,33.142857142857146,5,0.0,11,27,50,13,87,7,15,22,0,101,131,0
584,10869,fuprfcX49r5QcUYvMQnvvzEf76cx4sRp,bWdj2GDclj5ofokWjzoa5jAwMkxCykd6,9,12,1,6,1,1,5,4,30,4.285714285714286,1,0.0,5,1,5,1,7,1,1,5,4,12,18,1
585,10876,4vKI2gaXrHATS50fqVyDxXcmRy0MrgJS,A3fsA9Zfv1X2fVEQhTw51lKENdNrEqT3,10,13,12,0,10,0,1,0,36,5.142857142857143,1,0.0,0,12,0,10,13,0,0,1,0,22,14,1
586,10891,L5fA3BAe6FOUhd5mq4cXOYYHxtSuGgKM,SpATywNh6bZuzm8s1ceuBUnMUAeoAHHw,15,33,15,0,7,5,6,0,66,9.428571428571429,2,0.0,15,15,0,7,18,5,0,6,0,37,29,0
587,10917,Bf9it9d08iLIslwAMDaZjQzh1Kdl2qhf,SpATywNh6bZuzm8s1ceuBUnMUAeoAHHw,3,2,0,0,0,0,1,0,3,0.42857142857142855,1,0.0,0,0,0,0,2,0,0,1,0,0,3,0
588,10952,nKH0niV76APk64AIPNglQ4nJBpaxE108,SpATywNh6bZuzm8s1ceuBUnMUAeoAHHw,19,40,2,19,1,12,15,1,90,12.857142857142858,2,0.0,9,2,16,1,31,12,3,15,1,28,62,0
589,10955,rieeUlMbLxJ13UbEQlJjvhM4prlyBS6B,SpATywNh6bZuzm8s1ceuBUnMUAeoAHHw,30,30,13,35,7,46,17,5,153,21.857142857142858,5,0.0,7,13,31,7,23,46,4,17,5,58,95,0
590,10990,xxd1UUpRh1yQGgGLMyjshPknKZCNEYlg,A3fsA9Zfv1X2fVEQhTw51lKENdNrEqT3,32,19,10,70,4,0,9,0,112,16.0,4,0.0,1,10,57,4,18,0,13,9,0,72,40,0
591,10998,h5xiKkT5i4jRXd69Uq7dCU9wazCqxrHf,bWdj2GDclj5ofokWjzoa5jAwMkxCykd6,2,0,0,0,0,0,2,0,2,0.2857142857142857,1,0.0,0,0,0,0,0,0,0,2,0,0,2,1
592,11001,4vKI2gaXrHATS50fqVyDxXcmRy0MrgJS,bWdj2GDclj5ofokWjzoa5jAwMkxCykd6,10,9,6,0,2,3,3,0,23,3.2857142857142856,2,0.0,1,6,0,2,8,3,0,3,0,9,14,0
593,11023,T1BAt2dEt9EzWcybuzXyLq6mHbiEQWZt,G8EPVSXsOYB5YQWZGiz1aVq5Pgr2GrQu,6,3,2,0,2,0,1,0,8,1.1428571428571428,1,0.0,0,2,0,2,3,0,0,1,0,4,4,1
594,11036,0kTYCEXFiuNuYfSpCOb8HIL3aF9nkrGc,SpATywNh6bZuzm8s1ceuBUnMUAeoAHHw,17,12,7,10,4,0,2,0,35,5.0,1,0.0,4,7,9,4,8,0,1,2,0,24,11,0
595,11052,T1BAt2dEt9EzWcybuzXyLq6mHbiEQWZt,SpATywNh6bZuzm8s1ceuBUnMUAeoAHHw,4,2,1,0,1,0,2,0,6,0.8571428571428571,1,0.0,0,1,0,1,2,0,0,2,0,2,4,1
596,11068,E6SywimuBT6ZGpGjcedDyV1LTcQRc9ds,A3fsA9Zfv1X2fVEQhTw51lKENdNrEqT3,6,5,3,0,1,0,2,0,11,1.5714285714285714,1,0.0,0,3,0,1,5,0,0,2,0,4,7,1
597,11087,vrHzQ6JF32OpLCmbxoOSorIkJkRXwSrS,SpATywNh6bZuzm8s1ceuBUnMUAeoAHHw,3,2,1,0,0,0,1,0,4,0.5714285714285714,1,0.0,0,1,0,0,2,0,0,1,0,1,3,1
598,11103,hGRsAtrDXcgCObVXPjFeCVGCoNSaOPeW,SpATywNh6bZuzm8s1ceuBUnMUAeoAHHw,5,3,2,0,1,0,2,0,8,1.1428571428571428,1,0.0,0,2,0,1,3,0,0,2,0,3,5,1
599,11104,hGRsAtrDXcgCObVXPjFeCVGCoNSaOPeW,G8EPVSXsOYB5YQWZGiz1aVq5Pgr2GrQu,4,2,1,0,1,0,1,0,5,0.7142857142857143,1,0.0,0,1,0,1,2,0,0,1,0,2,3,1
600,11136,iVrbldNmEASAlMSnUTWFx7qcEdScVNde,SpATywNh6bZuzm8s1ceuBUnMUAeoAHHw,8,17,10,0,6,0,2,0,35,5.0,3,0.0,0,10,0,6,17,0,0,2,0,16,19,1
601,11143,P9MGcZfmosEjD4PEwCVp6vB9MzPbeKLI,G8EPVSXsOYB5YQWZGiz1aVq5Pgr2GrQu,1,0,0,0,0,0,1,0,1,0.14285714285714285,1,0.0,0,0,0,0,0,0,0,1,0,0,1,1
602,11146,e2vebmlDc23PpKpfRYyd1By1iCXcv3UO,RXDvfPUBYFlVdlueBFbLW0mhhAyGEqpt,42,32,0,58,0,0,3,0,93,13.285714285714286,3,0.0,9,0,56,0,23,0,2,3,0,65,28,1
603,11163,arCKlRkqmCQRumxhAEQROrAdYVJBCNWo,SpATywNh6bZuzm8s1ceuBUnMUAeoAHHw,11,13,8,0,3,0,4,0,28,4.0,2,0.0,0,8,0,3,13,0,0,4,0,11,17,0
604,11179,gryVUwWLvrsNv4F8O3kiEBAQILnJg7OT,SpATywNh6bZuzm8s1ceuBUnMUAeoAHHw,11,14,0,11,0,7,3,0,35,5.0,1,0.0,5,0,11,0,9,7,0,3,0,16,19,0
605,11198,HbdIEiZ1jslj2pBp8czn7lhBbxLYjtpj,SpATywNh6bZuzm8s1ceuBUnMUAeoAHHw,7,12,5,0,1,0,2,0,20,2.857142857142857,2,0.0,2,5,0,1,10,0,0,2,0,8,12,1
606,11225,Vmvdv9k8S1ONPkUHSdXPEenyx7UNVISW,SpATywNh6bZuzm8s1ceuBUnMUAeoAHHw,3,2,0,0,0,0,1,0,3,0.42857142857142855,1,0.0,0,0,0,0,2,0,0,1,0,0,3,1
607,11290,JZZnn79hJZh6uernNE50Bi5HDewJf78E,RXDvfPUBYFlVdlueBFbLW0mhhAyGEqpt,15,14,5,0,2,8,3,0,32,4.571428571428571,1,0.0,0,5,0,2,14,8,0,3,0,7,25,1
608,11303,gnjZOoI8BeitDTrO8bhWhoFLWjid4LeA,bWdj2GDclj5ofokWjzoa5jAwMkxCykd6,7,9,4,0,0,0,5,0,18,2.5714285714285716,1,0.0,2,4,0,0,7,0,0,5,0,6,12,1
609,11306,5ZQSBzYZG0AalCCLt1PNSHaXvEDYOMak,SpATywNh6bZuzm8s1ceuBUnMUAeoAHHw,1,0,0,0,0,0,2,0,2,0.2857142857142857,1,0.0,0,0,0,0,0,0,0,2,0,0,2,1
610,11314,o7HGnjuXHyEfteJtxVQ5dpBJz7Yzz0T1,SpATywNh6bZuzm8s1ceuBUnMUAeoAHHw,7,3,0,0,0,2,4,0,9,1.2857142857142858,1,0.0,0,0,0,0,3,2,0,4,0,0,9,1
611,11326,IFQQStJmvfA3NyTN88jNEn631VKsGQET,SpATywNh6bZuzm8s1ceuBUnMUAeoAHHw,7,2,1,0,1,1,4,0,9,1.2857142857142858,1,0.0,0,1,0,1,2,1,0,4,0,2,7,1
612,11344,SHXTFVyrdbzmF1pJEIvr2zpR8jK358bb,SpATywNh6bZuzm8s1ceuBUnMUAeoAHHw,14,27,1,8,1,0,2,0,39,5.571428571428571,2,0.0,3,1,8,1,24,0,0,2,0,13,26,1
613,11355,Z5t6AGEyADeSVHWZTgBW4lR5XMnM5VWU,SpATywNh6bZuzm8s1ceuBUnMUAeoAHHw,29,41,14,12,10,0,3,0,80,11.428571428571429,2,0.0,13,14,12,10,28,0,0,3,0,49,31,0
614,11356,KXkOWXgIJuvmtvaUVHrKWAaqrFaY5cx8,SpATywNh6bZuzm8s1ceuBUnMUAeoAHHw,10,18,0,22,0,3,6,3,52,7.428571428571429,2,0.0,13,0,18,0,5,3,4,6,3,31,21,1
615,11357,WJKEaeH3ob9wscd3i5dXEY7kRPHMEwVj,bWdj2GDclj5ofokWjzoa5jAwMkxCykd6,3,1,1,0,1,0,0,0,3,0.42857142857142855,1,0.0,0,1,0,1,1,0,0,0,0,2,1,1
616,11362,13fzVwLJSsgGzTLwjEHCuvf0Ks8dgxYZ,SpATywNh6bZuzm8s1ceuBUnMUAeoAHHw,15,16,1,8,1,0,6,0,32,4.571428571428571,3,0.0,2,1,8,1,14,0,0,6,0,12,20,1
617,11410,YEYkPWHcftKd8bKe1Q9b21lzhv1SChRM,SpATywNh6bZuzm8s1ceuBUnMUAeoAHHw,20,17,11,10,5,1,5,1,50,7.142857142857143,2,0.0,2,11,10,5,15,1,0,5,1,28,22,1
618,11414,HYCkyEJhW9QtzilmanJKsxRLSBi9UGoV,bWdj2GDclj5ofokWjzoa5jAwMkxCykd6,2,0,0,0,0,0,2,0,2,0.2857142857142857,1,0.0,0,0,0,0,0,0,0,2,0,0,2,1
619,11425,82UlWF6Fm1gkNum7nNbVw0yOV1BUdNoS,bWdj2GDclj5ofokWjzoa5jAwMkxCykd6,4,4,2,0,0,5,5,0,16,2.2857142857142856,3,0.0,0,2,0,0,4,5,0,5,0,2,14,0
620,11428,82UlWF6Fm1gkNum7nNbVw0yOV1BUdNoS,A3fsA9Zfv1X2fVEQhTw51lKENdNrEqT3,4,8,4,0,0,0,2,0,14,2.0,2,0.0,1,4,0,0,7,0,0,2,0,5,9,0
621,11463,uFcd6yCTniScAvbMiWJYRQ8Du52ubELm,RXDvfPUBYFlVdlueBFbLW0mhhAyGEqpt,14,12,2,8,2,0,2,0,26,3.7142857142857144,2,0.0,0,2,7,2,12,0,1,2,0,11,15,0
622,11475,UJiJ4PvH4qodyDnURbFXyi5LWwaSKUwb,RXDvfPUBYFlVdlueBFbLW0mhhAyGEqpt,29,40,23,48,12,41,15,1,180,25.714285714285715,4,0.0,8,23,47,12,32,41,1,15,1,90,90,0
623,11478,RGf4k3THi4AV4qsAjc1UEOWiIeDYcchf,A3fsA9Zfv1X2fVEQhTw51lKENdNrEqT3,3,2,0,0,0,0,1,0,3,0.42857142857142855,1,0.0,0,0,0,0,2,0,0,1,0,0,3,0
624,11492,zKdMAgWBKjA8jF1t74QW0q0ZxGMcvW9t,RXDvfPUBYFlVdlueBFbLW0mhhAyGEqpt,19,9,7,16,5,0,2,0,39,5.571428571428571,1,0.0,2,7,15,5,7,0,1,2,0,29,10,1
625,11509,sQVxVjeT9NfPAT9IdDUsY0RSB3XrvO2y,SpATywNh6bZuzm8s1ceuBUnMUAeoAHHw,18,35,18,24,0,20,5,0,102,14.571428571428571,2,0.0,12,18,18,0,23,20,6,5,0,48,54,0
626,11515,iIwpETh60BkJfJQJqvWucH2tzh64j0U3,SpATywNh6bZuzm8s1ceuBUnMUAeoAHHw,17,37,16,14,1,0,11,0,79,11.285714285714286,4,0.0,8,16,13,1,29,0,1,11,0,38,41,0
627,11522,MOJ1BiwMK7lBUiFS9DTwwPvbUWIkdFFP,A3fsA9Zfv1X2fVEQhTw51lKENdNrEqT3,21,29,22,22,7,0,3,0,83,11.857142857142858,7,0.0,2,22,21,7,27,0,1,3,0,52,31,1
628,11547,NKnL5oTIIxOmPf0Ep5iKaKIecNheR2t7,SpATywNh6bZuzm8s1ceuBUnMUAeoAHHw,16,21,9,12,4,0,4,0,50,7.142857142857143,2,0.0,9,9,12,4,12,0,0,4,0,34,16,0
629,11555,7OkCZWJW1Ow4wpTBUq53amL13pV2vy2v,G8EPVSXsOYB5YQWZGiz1aVq5Pgr2GrQu,22,64,14,48,11,13,21,0,171,24.428571428571427,4,0.0,8,14,40,11,56,13,8,21,0,73,98,0
630,11618,FftGEmgyFF5pWtfM0EZJwp0rzcGMH1JL,SpATywNh6bZuzm8s1ceuBUnMUAeoAHHw,31,74,44,28,17,4,40,10,217,31.0,4,0.0,9,44,25,17,65,4,3,40,10,95,122,1
631,11636,Y3uwxWCm13Ol5xozrT2GPjOPhBlC2kOq,RXDvfPUBYFlVdlueBFbLW0mhhAyGEqpt,9,18,0,0,0,0,2,0,20,2.857142857142857,2,0.0,0,0,0,0,18,0,0,2,0,0,20,1
632,11646,MR4k3wv95Ttq1fQaT9W4WgxrPezl0N4j,G8EPVSXsOYB5YQWZGiz1aVq5Pgr2GrQu,11,15,5,16,2,0,3,0,41,5.857142857142857,1,0.0,2,5,12,2,13,0,4,3,0,21,20,1
633,11647,KAHcIFqF1cp4MJN69oD7XlQBuGCiexCt,bWdj2GDclj5ofokWjzoa5jAwMkxCykd6,2,0,0,0,0,0,2,0,2,0.2857142857142857,1,0.0,0,0,0,0,0,0,0,2,0,0,2,1
634,11677,FduexGuoL0tC7LqIuSFtIm03lXvHHbSw,SpATywNh6bZuzm8s1ceuBUnMUAeoAHHw,8,29,1,0,0,4,23,4,61,8.714285714285714,4,0.0,0,1,0,0,29,4,0,23,4,1,60,1
635,11690,37daqGAbA6x2VvXkiqdWX1nBv2Tqqgte,G8EPVSXsOYB5YQWZGiz1aVq5Pgr2GrQu,35,82,41,92,18,4,18,1,256,36.57142857142857,4,0.0,24,41,77,18,58,4,15,18,1,160,96,0
636,11741,n3cFXGx3rjoPJPOmeF5tlnmkFmFFJI7p,A3fsA9Zfv1X2fVEQhTw51lKENdNrEqT3,48,45,27,72,9,24,28,2,207,29.571428571428573,5,0.0,4,27,54,9,41,24,18,28,2,94,113,1
637,11758,7UZLQknm2A0Xcs9lZDmhCq5ocQIOEmmj,SpATywNh6bZuzm8s1ceuBUnMUAeoAHHw,26,25,11,16,6,0,11,1,70,10.0,2,0.0,10,11,14,6,15,0,2,11,1,41,29,1
638,11811,YRnTGuoAQA7UM3uV59YNXUYN4n1CR9jv,SpATywNh6bZuzm8s1ceuBUnMUAeoAHHw,17,14,8,6,4,0,3,0,35,5.0,3,0.0,4,8,6,4,10,0,0,3,0,22,13,0
639,11827,McYATdhZDDMDpni6a4GbjI06ustMpvdV,G8EPVSXsOYB5YQWZGiz1aVq5Pgr2GrQu,7,3,2,0,2,4,2,0,13,1.8571428571428572,1,0.0,0,2,0,2,3,4,0,2,0,4,9,1
640,11836,zm7kTPWc2Ij7nyP9Co8cVtDEuAGTQRmn,A3fsA9Zfv1X2fVEQhTw51lKENdNrEqT3,5,3,1,0,1,0,2,0,7,1.0,1,0.0,0,1,0,1,3,0,0,2,0,2,5,1
641,11839,McYATdhZDDMDpni6a4GbjI06ustMpvdV,A3fsA9Zfv1X2fVEQhTw51lKENdNrEqT3,10,8,6,0,5,6,2,0,27,3.857142857142857,2,0.0,0,6,0,5,8,6,0,2,0,11,16,1
642,11841,4GMbKnTV7f2uA3paM09GNAdyVnypDTbs,A3fsA9Zfv1X2fVEQhTw51lKENdNrEqT3,10,11,3,0,1,0,3,0,18,2.5714285714285716,2,0.0,0,3,0,1,11,0,0,3,0,4,14,0
643,11842,MFEX8ieEZqjvGSzLHf4hJjdY1BCifo1Q,G8EPVSXsOYB5YQWZGiz1aVq5Pgr2GrQu,9,5,2,4,2,0,3,0,16,2.2857142857142856,1,0.0,1,2,3,2,4,0,1,3,0,8,8,1
644,11862,n42jeLyeDpoJPwT1pkhXRyhzHjUnC2KC,SpATywNh6bZuzm8s1ceuBUnMUAeoAHHw,19,31,14,0,4,1,11,5,66,9.428571428571429,5,0.0,5,14,0,4,26,1,0,11,5,23,43,1
645,11867,2axjl9Byq908rUlMrYGzo2sfhA3p18fU,SpATywNh6bZuzm8s1ceuBUnMUAeoAHHw,11,6,4,1,3,0,2,0,16,2.2857142857142856,1,0.0,1,4,1,3,5,0,0,2,0,9,7,1
646,11892,QkpDyGn4qqqwpxvXRrFsAsKSrEtfkQJQ,SpATywNh6bZuzm8s1ceuBUnMUAeoAHHw,17,15,10,18,5,0,4,0,52,7.428571428571429,2,0.0,2,10,17,5,13,0,1,4,0,34,18,0
647,11895,Er0phLmicWoU9yr3sUBC2BCne0YIK1vQ,A3fsA9Zfv1X2fVEQhTw51lKENdNrEqT3,30,24,15,34,11,0,9,0,93,13.285714285714286,3,0.0,0,15,29,11,24,0,5,9,0,55,38,1
648,11896,UzuB1gScsXJ6b46FForXq5x2wnZw4QoH,SpATywNh6bZuzm8s1ceuBUnMUAeoAHHw,18,28,15,13,8,0,9,0,73,10.428571428571429,3,0.0,2,15,12,8,26,0,1,9,0,37,36,0
649,11900,8xT75XL9dKm7CwLmOxtys3bmWBh3OJmY,RXDvfPUBYFlVdlueBFbLW0mhhAyGEqpt,25,33,3,11,1,0,5,0,53,7.571428571428571,2,0.0,8,3,11,1,25,0,0,5,0,23,30,0
650,11914,5YO2NGkR6BZ1s4HfeOrLezgFkpBKmNPV,SpATywNh6bZuzm8s1ceuBUnMUAeoAHHw,1,0,0,0,0,0,1,0,1,0.14285714285714285,1,0.0,0,0,0,0,0,0,0,1,0,0,1,0
651,11917,uuxrUSHn3GpYFneZnY8GpLgr5XiyDABs,A3fsA9Zfv1X2fVEQhTw51lKENdNrEqT3,12,8,6,0,5,0,5,1,25,3.5714285714285716,1,0.0,0,6,0,5,8,0,0,5,1,11,14,0
652,11920,uarVJhEs6XLW7Dw1D7iBgEK6zPe65WwX,A3fsA9Zfv1X2fVEQhTw51lKENdNrEqT3,1,0,0,0,0,0,1,0,1,0.14285714285714285,1,0.0,0,0,0,0,0,0,0,1,0,0,1,1
653,11921,JERgMmFADxaPxEUdcYHhaMN4ZwNAyErv,A3fsA9Zfv1X2fVEQhTw51lKENdNrEqT3,71,34,20,164,13,24,14,1,270,38.57142857142857,2,0.0,6,20,137,13,28,24,27,14,1,176,94,0
654,11922,gKme5KJOgqJrjNwDUsRPKwK3QFyN7vPD,RXDvfPUBYFlVdlueBFbLW0mhhAyGEqpt,10,13,9,15,3,0,3,0,43,6.142857142857143,2,0.0,1,9,14,3,12,0,1,3,0,27,16,0
655,11951,Nsiwn7635mGlMs5nxmspwUbmVQaPZWQ6,G8EPVSXsOYB5YQWZGiz1aVq5Pgr2GrQu,21,18,10,26,7,1,11,1,74,10.571428571428571,3,0.0,2,10,21,7,16,1,5,11,1,40,34,1
656,11956,oyFfPK6y9oPPwQR5mbsXW98FJaEnU88b,bWdj2GDclj5ofokWjzoa5jAwMkxCykd6,4,2,1,0,1,0,2,0,6,0.8571428571428571,1,0.0,0,1,0,1,2,0,0,2,0,2,4,1
657,11977,JtbtRyqX4dZ0edFKFJwGNY9JG3aidrlj,SpATywNh6bZuzm8s1ceuBUnMUAeoAHHw,29,40,18,26,12,4,18,1,119,17.0,3,0.0,16,18,20,12,24,4,6,18,1,66,53,0
658,11983,058hmyJK1lejTwX8sX29U5yFETfrvQ95,G8EPVSXsOYB5YQWZGiz1aVq5Pgr2GrQu,1,0,0,0,0,0,1,0,1,0.14285714285714285,1,0.0,0,0,0,0,0,0,0,1,0,0,1,1
659,11986,058hmyJK1lejTwX8sX29U5yFETfrvQ95,A3fsA9Zfv1X2fVEQhTw51lKENdNrEqT3,1,0,0,0,0,0,1,0,1,0.14285714285714285,1,0.0,0,0,0,0,0,0,0,1,0,0,1,1
660,12007,Uwggq8NcihxhBLnReA5tboVbRLkIS371,SpATywNh6bZuzm8s1ceuBUnMUAeoAHHw,1,0,0,0,0,0,1,0,1,0.14285714285714285,1,0.0,0,0,0,0,0,0,0,1,0,0,1,1
661,12011,q36eiA77bwwsXGg05ifhgnTFDpR9Ar4V,bWdj2GDclj5ofokWjzoa5jAwMkxCykd6,31,30,18,92,6,9,8,0,163,23.285714285714285,4,0.0,6,18,77,6,24,9,15,8,0,107,56,0
662,12020,LHFojLmJ5Ll3LGp6GnqLClTkRFP5a32j,bWdj2GDclj5ofokWjzoa5jAwMkxCykd6,1,0,0,0,0,0,1,0,1,0.14285714285714285,1,0.0,0,0,0,0,0,0,0,1,0,0,1,1
663,12030,gSxiLtAU3HWIGwL9IJcAr6lB3iS2AC6Z,A3fsA9Zfv1X2fVEQhTw51lKENdNrEqT3,2,0,0,0,0,0,2,0,2,0.2857142857142857,1,0.0,0,0,0,0,0,0,0,2,0,0,2,1
664,12053,7m381KBoEq7nybFxitllQlgHOa7YYR1i,SpATywNh6bZuzm8s1ceuBUnMUAeoAHHw,15,37,1,12,0,0,6,0,56,8.0,3,0.0,2,1,12,0,35,0,0,6,0,15,41,0
665,12090,M7Vbw5q1oL32IfEMSI9AM5uHCUMDFHmm,A3fsA9Zfv1X2fVEQhTw51lKENdNrEqT3,19,17,11,2,5,1,17,3,56,8.0,2,0.0,0,11,2,5,17,1,0,17,3,18,38,1
666,12099,tCXa4pMsMXRuliZWNM9so3Odte6UmpYj,bWdj2GDclj5ofokWjzoa5jAwMkxCykd6,1,0,0,0,0,0,1,0,1,0.14285714285714285,1,0.0,0,0,0,0,0,0,0,1,0,0,1,1
667,12113,l6nLhBWETqCazxhjGSPbpZQRNqpsMPRD,bWdj2GDclj5ofokWjzoa5jAwMkxCykd6,2,0,0,0,0,0,4,0,4,0.5714285714285714,1,0.0,0,0,0,0,0,0,0,4,0,0,4,1
668,12141,4n0eavxCNp4F6LlqtEg5gsmyBVEbRBeE,G8EPVSXsOYB5YQWZGiz1aVq5Pgr2GrQu,7,9,4,0,1,0,4,0,18,2.5714285714285716,2,0.0,0,4,0,1,9,0,0,4,0,5,13,1
669,12147,VJw4zFdkpwcu4sXr2e3LyD2CU2ajLhIu,SpATywNh6bZuzm8s1ceuBUnMUAeoAHHw,30,40,19,18,9,22,11,0,119,17.0,1,0.0,7,19,17,9,33,22,1,11,0,52,67,0
670,12178,V2ut0n3Er1p82GdKRcLWOrmZXj3No2ts,bWdj2GDclj5ofokWjzoa5jAwMkxCykd6,1,0,0,0,0,0,1,0,1,0.14285714285714285,1,0.0,0,0,0,0,0,0,0,1,0,0,1,1
671,12203,TSpDTvH7tx13LMObu1OWRVwKh8isSitO,SpATywNh6bZuzm8s1ceuBUnMUAeoAHHw,14,16,4,3,3,0,6,1,33,4.714285714285714,1,0.0,4,4,3,3,12,0,0,6,1,14,19,1
672,12208,dOjwcbpJoBEbemc7xmUKlO5o5THYYuWb,RXDvfPUBYFlVdlueBFbLW0mhhAyGEqpt,67,76,26,85,14,25,15,2,243,34.714285714285715,3,0.0,23,26,83,14,53,25,2,15,2,146,97,0
673,12223,ysTOTg8n91NBng8BrzlEom4lR6CnDwPC,SpATywNh6bZuzm8s1ceuBUnMUAeoAHHw,16,29,13,0,4,0,6,3,55,7.857142857142857,1,0.0,5,13,0,4,24,0,0,6,3,22,33,1
674,12241,YqzonIu9nUz3X2nkdJiReRrylaOckiCC,SpATywNh6bZuzm8s1ceuBUnMUAeoAHHw,21,31,2,24,1,4,14,1,77,11.0,2,0.0,17,2,21,1,14,4,3,14,1,41,36,0
675,12246,I0uHaMvDeJM1w1AenEVj8xWzg3OizAzv,G8EPVSXsOYB5YQWZGiz1aVq5Pgr2GrQu,34,43,1,60,0,2,16,2,124,17.714285714285715,2,0.0,10,1,48,0,33,2,12,16,2,59,65,1
676,12253,Kxifrwa9ntGWJyRtJS6owg0ZQfSyRPcW,A3fsA9Zfv1X2fVEQhTw51lKENdNrEqT3,2,0,0,0,0,0,2,0,2,0.2857142857142857,1,0.0,0,0,0,0,0,0,0,2,0,0,2,0
677,12262,GAfZCFoItZF6u2g6TmFIAYqk177Q5kZH,SpATywNh6bZuzm8s1ceuBUnMUAeoAHHw,30,25,13,25,7,1,8,0,79,11.285714285714286,1,0.0,8,13,21,7,17,1,4,8,0,49,30,1
678,12287,zZK4lWrYYn5bTLcjHRRO0XA8xNwpu7OT,RXDvfPUBYFlVdlueBFbLW0mhhAyGEqpt,23,19,10,27,7,0,9,0,72,10.285714285714286,3,0.0,4,10,26,7,15,0,1,9,0,47,25,0
679,12293,UxPdjVFzcqqJoB99RNTW4pwswAcQ32eZ,RXDvfPUBYFlVdlueBFbLW0mhhAyGEqpt,32,20,18,0,15,0,23,0,76,10.857142857142858,3,0.0,2,18,0,15,18,0,0,23,0,35,41,0
680,12302,OeLBIzS0gNQ56euxy5b66gAZMzQCGE7n,A3fsA9Zfv1X2fVEQhTw51lKENdNrEqT3,71,31,21,140,14,2,30,2,240,34.285714285714285,3,0.0,2,21,116,14,29,2,24,30,2,153,87,1
681,12316,8SG0IoRU1kfooCNm4CWXEAnDe54VjVcy,A3fsA9Zfv1X2fVEQhTw51lKENdNrEqT3,14,11,7,0,4,2,6,1,31,4.428571428571429,1,0.0,2,7,0,4,9,2,0,6,1,13,18,1
682,12330,9iGaqBGS5kkoXjLd87hUL2eIJMVUVKfU,A3fsA9Zfv1X2fVEQhTw51lKENdNrEqT3,39,39,23,98,4,0,14,1,179,25.571428571428573,3,0.0,8,23,86,4,31,0,12,14,1,121,58,0
683,12350,7m381KBoEq7nybFxitllQlgHOa7YYR1i,G8EPVSXsOYB5YQWZGiz1aVq5Pgr2GrQu,57,129,28,122,18,15,18,0,330,47.142857142857146,6,0.0,3,28,113,18,126,15,9,18,0,162,168,1
684,12356,GW78UVODV1oPxxynjXG1U7em3gdA8wQF,SpATywNh6bZuzm8s1ceuBUnMUAeoAHHw,15,14,10,5,6,0,3,1,39,5.571428571428571,1,0.0,0,10,5,6,14,0,0,3,1,21,18,0
685,12358,nlf7AlI08jbhXKXagULClsgDoakDOx2G,SpATywNh6bZuzm8s1ceuBUnMUAeoAHHw,12,8,6,0,5,2,6,1,28,4.0,1,0.0,0,6,0,5,8,2,0,6,1,11,17,1
686,12363,5wKAjfQ5T37M2WWxYAwMeUeLhDScm1Z0,bWdj2GDclj5ofokWjzoa5jAwMkxCykd6,3,0,0,0,0,19,7,0,26,3.7142857142857144,3,0.0,0,0,0,0,0,19,0,7,0,0,26,0
687,12372,Dx1ZzKpwFtwNhE9gdaLaohssqGyqrqjD,A3fsA9Zfv1X2fVEQhTw51lKENdNrEqT3,17,19,8,30,0,17,7,0,81,11.571428571428571,2,0.0,4,8,26,0,15,17,4,7,0,38,43,1
688,12374,dkmoSmrpP5gK9Xi6ySwrroCNfUlumbtO,G8EPVSXsOYB5YQWZGiz1aVq5Pgr2GrQu,12,7,0,10,0,0,2,0,19,2.7142857142857144,1,0.0,0,0,8,0,7,0,2,2,0,8,11,1
689,12381,zZsHSLX7Hk1sqhZYCfBgGlYJnqetGIKf,SpATywNh6bZuzm8s1ceuBUnMUAeoAHHw,3,2,1,0,0,0,1,0,4,0.5714285714285714,1,0.0,0,1,0,0,2,0,0,1,0,1,3,1
690,12383,7OkCZWJW1Ow4wpTBUq53amL13pV2vy2v,SpATywNh6bZuzm8s1ceuBUnMUAeoAHHw,4,5,1,0,0,0,2,0,8,1.1428571428571428,2,0.0,2,1,0,0,3,0,0,2,0,3,5,0
691,12394,HXDAyPRsApqduwAe8pSs8BlStcKWeCOs,bWdj2GDclj5ofokWjzoa5jAwMkxCykd6,5,6,3,0,1,0,3,0,13,1.8571428571428572,2,0.0,0,3,0,1,6,0,0,3,0,4,9,1
692,12410,wXFfHtwd9smrvhh9NQW7SmEEo1001LDW,A3fsA9Zfv1X2fVEQhTw51lKENdNrEqT3,13,15,9,10,1,0,6,0,41,5.857142857142857,3,0.0,1,9,8,1,14,0,2,6,0,19,22,1
693,12412,s24Qk0ZpAXR97ldBDtgP8DE6rT8or69U,SpATywNh6bZuzm8s1ceuBUnMUAeoAHHw,8,9,0,16,0,0,1,0,26,3.7142857142857144,1,0.0,5,0,14,0,4,0,2,1,0,19,7,0
694,12442,HbmZzALzRW0CJmaD07o1oMpvJwGgfjK4,SpATywNh6bZuzm8s1ceuBUnMUAeoAHHw,7,8,2,0,2,0,2,0,14,2.0,2,0.0,1,2,0,2,7,0,0,2,0,5,9,1
695,12445,CqxK3XGagGgLgWXJIkp8qfeo0SWv94XW,RXDvfPUBYFlVdlueBFbLW0mhhAyGEqpt,21,50,30,14,7,8,9,2,120,17.142857142857142,4,0.0,12,30,14,7,38,8,0,9,2,63,57,0
696,12464,NSrMJ69WS92LaJ6a09xOpViELCrjji8S,SpATywNh6bZuzm8s1ceuBUnMUAeoAHHw,14,20,4,15,1,19,7,0,66,9.428571428571429,4,0.0,6,4,13,1,14,19,2,7,0,24,42,0
697,12480,q54oCvxsY1LE19jtoD23qGpHSrkdhUlF,A3fsA9Zfv1X2fVEQhTw51lKENdNrEqT3,6,3,1,0,1,0,2,0,7,1.0,1,0.0,0,1,0,1,3,0,0,2,0,2,5,1
698,12482,35upFtDrqCqWhj8RVNLHqe6Xg75dIX7z,G8EPVSXsOYB5YQWZGiz1aVq5Pgr2GrQu,4,3,1,2,0,0,2,0,8,1.1428571428571428,2,0.0,1,1,2,0,2,0,0,2,0,4,4,1
699,12515,UKrQdzHwNJRJK7ZoTzKsoWlrkEbsQk7X,RXDvfPUBYFlVdlueBFbLW0mhhAyGEqpt,1,0,0,0,0,0,1,0,1,0.14285714285714285,1,0.0,0,0,0,0,0,0,0,1,0,0,1,1
700,12522,MRCD9XxqQVpIexf9EdSwdaoHW691k7OH,SpATywNh6bZuzm8s1ceuBUnMUAeoAHHw,12,15,8,6,0,0,2,0,31,4.428571428571429,1,0.0,4,8,6,0,11,0,0,2,0,18,13,1
701,12569,4Z7n4wdauhlOTY95FN6j39vUUWT0ZgYl,SpATywNh6bZuzm8s1ceuBUnMUAeoAHHw,6,13,7,0,3,0,2,0,25,3.5714285714285716,2,0.0,0,7,0,3,13,0,0,2,0,10,15,1
702,12580,kB76SiSV4uYN77hHUOgf3IbLpFWkgJbj,SpATywNh6bZuzm8s1ceuBUnMUAeoAHHw,29,27,17,35,9,0,5,0,93,13.285714285714286,2,0.0,6,17,30,9,21,0,5,5,0,62,31,0
703,12583,JRuzCriX6hvuTQ943ttXKlmrFVyfxMHr,SpATywNh6bZuzm8s1ceuBUnMUAeoAHHw,17,17,11,3,4,0,2,0,37,5.285714285714286,2,0.0,0,11,3,4,17,0,0,2,0,18,19,0
704,12586,jfC6fPTH59GZUrxarremx8AmMC8XNgfG,SpATywNh6bZuzm8s1ceuBUnMUAeoAHHw,24,33,21,13,8,2,2,0,79,11.285714285714286,3,0.0,7,21,13,8,26,2,0,2,0,49,30,1
705,12588,XQTN1LOe7iul8RvZ4acTOpEntRORT1SG,SpATywNh6bZuzm8s1ceuBUnMUAeoAHHw,1,0,0,0,0,0,1,0,1,0.14285714285714285,1,0.0,0,0,0,0,0,0,0,1,0,0,1,1
706,12597,R8tAdEYq32rVkLXscE5SipLgbsEEPIk8,bWdj2GDclj5ofokWjzoa5jAwMkxCykd6,1,0,0,0,0,0,2,0,2,0.2857142857142857,1,0.0,0,0,0,0,0,0,0,2,0,0,2,1
707,12600,NO22WSq5lVGwq6WPEcqalEaMjYIZxX3u,bWdj2GDclj5ofokWjzoa5jAwMkxCykd6,6,4,0,0,0,0,5,0,9,1.2857142857142858,2,0.0,0,0,0,0,4,0,0,5,0,0,9,1
708,12616,gLKRPeA7yYfxDrcYMLyblT6wVEjgwKPH,SpATywNh6bZuzm8s1ceuBUnMUAeoAHHw,32,48,23,16,14,5,8,1,115,16.428571428571427,3,0.0,9,23,14,14,39,5,2,8,1,60,55,0
709,12620,LxV8BE7SALs1WsK81jAFnmtwnc7yS8ck,G8EPVSXsOYB5YQWZGiz1aVq5Pgr2GrQu,8,7,3,0,3,0,3,0,16,2.2857142857142856,1,0.0,2,3,0,3,5,0,0,3,0,8,8,1
710,12626,NSkQyRZ5kDInEI8yx5AGmbuyJ28eG48A,SpATywNh6bZuzm8s1ceuBUnMUAeoAHHw,31,38,21,24,10,5,10,0,108,15.428571428571429,3,0.0,5,21,19,10,33,5,5,10,0,55,53,0
711,12633,8DlfU1bgriTJuUO8vI8x268Lnn7yRdfp,A3fsA9Zfv1X2fVEQhTw51lKENdNrEqT3,5,2,1,0,1,4,6,0,14,2.0,2,0.0,0,1,0,1,2,4,0,6,0,2,12,1
712,12649,TexDHGk8F5I6X0NlqVQwzJ9MMWpLdMbB,SpATywNh6bZuzm8s1ceuBUnMUAeoAHHw,28,26,13,35,6,4,6,1,91,13.0,2,0.0,9,13,27,6,17,4,8,6,1,55,36,0
713,12667,h1g6Jk0YES6cZKnPtmszwjPCneFTGd3j,bWdj2GDclj5ofokWjzoa5jAwMkxCykd6,13,12,8,0,6,18,11,1,56,8.0,2,0.0,0,8,0,6,12,18,0,11,1,14,42,1
714,12682,I19aG6zmdTntoy0T8VxEogbN4WVEZZNa,SpATywNh6bZuzm8s1ceuBUnMUAeoAHHw,5,5,1,0,0,0,2,0,8,1.1428571428571428,1,0.0,2,1,0,0,3,0,0,2,0,3,5,1
715,12689,1Ld3jQU8M0eiaLBshs8gjcgQEfdlgHyZ,RXDvfPUBYFlVdlueBFbLW0mhhAyGEqpt,30,21,15,0,12,0,4,0,52,7.428571428571429,3,0.0,2,15,0,12,19,0,0,4,0,29,23,1
716,12707,Hr9mm3bIoeLv4wyDeAcwJNdd3K6mgRy4,SpATywNh6bZuzm8s1ceuBUnMUAeoAHHw,30,39,22,26,8,3,8,0,106,15.142857142857142,2,0.0,9,22,25,8,30,3,1,8,0,64,42,0
717,12711,rDEv38jBkahw1DC082iTP7UbA4sE1KaP,SpATywNh6bZuzm8s1ceuBUnMUAeoAHHw,13,9,1,17,1,0,3,0,31,4.428571428571429,1,0.0,2,1,15,1,7,0,2,3,0,19,12,0
718,12726,bQve3ajdEL4IqADUWqNBP99IoqvejzJV,A3fsA9Zfv1X2fVEQhTw51lKENdNrEqT3,6,3,0,0,0,4,8,1,16,2.2857142857142856,2,0.0,0,0,0,0,3,4,0,8,1,0,16,1
719,12735,KBt3gvTJLTIjt4EkmG3y3LICooEML1xW,G8EPVSXsOYB5YQWZGiz1aVq5Pgr2GrQu,6,5,2,0,2,0,6,0,15,2.142857142857143,3,0.0,0,2,0,2,5,0,0,6,0,4,11,1
720,12742,arTGhRrKZksM4iY72XDJ8i8oBmMABS0m,SpATywNh6bZuzm8s1ceuBUnMUAeoAHHw,17,34,2,3,2,18,10,0,69,9.857142857142858,3,0.0,5,2,3,2,29,18,0,10,0,12,57,0
721,12745,rRt0QHymEdl6Kph5VPgdVUvepB7ZBNXt,SpATywNh6bZuzm8s1ceuBUnMUAeoAHHw,7,10,4,0,2,0,2,0,18,2.5714285714285716,2,0.0,0,4,0,2,10,0,0,2,0,6,12,0
722,12750,i67qzouvUD7nINgK6d1xrH4pvufZqbFd,SpATywNh6bZuzm8s1ceuBUnMUAeoAHHw,20,29,1,27,0,3,6,0,66,9.428571428571429,3,0.0,6,1,25,0,23,3,2,6,0,32,34,0
723,12753,79Po0Awyh8Z7ruF9y6agajWClv9uUoPL,SpATywNh6bZuzm8s1ceuBUnMUAeoAHHw,5,6,0,0,0,0,1,0,7,1.0,1,0.0,0,0,0,0,6,0,0,1,0,0,7,1
724,12761,rtYqtRTnqUXb6diSp0MKjdA0eLt2BJ3X,SpATywNh6bZuzm8s1ceuBUnMUAeoAHHw,19,30,14,17,4,20,11,0,96,13.714285714285714,3,0.0,8,14,15,4,22,20,2,11,0,41,55,0
725,12768,ghgdA2SJuIXQM23Hgf4BrlUd29ois5mW,SpATywNh6bZuzm8s1ceuBUnMUAeoAHHw,14,19,1,12,1,6,5,0,44,6.285714285714286,2,0.0,6,1,11,1,13,6,1,5,0,19,25,1
726,12784,rZSLmwiYX8trzeLsBLeg8r0IN1GBbqOC,bWdj2GDclj5ofokWjzoa5jAwMkxCykd6,1,0,0,0,0,0,1,0,1,0.14285714285714285,1,0.0,0,0,0,0,0,0,0,1,0,0,1,1
727,12796,P5jfghvfecmYY6IMTqwwXqe4o108QRc4,SpATywNh6bZuzm8s1ceuBUnMUAeoAHHw,18,11,9,0,8,0,4,0,32,4.571428571428571,3,0.0,0,9,0,8,11,0,0,4,0,17,15,1
728,12805,P0uW8e7uWJsgVO5MWg1krlEvXljM181Y,G8EPVSXsOYB5YQWZGiz1aVq5Pgr2GrQu,1,0,0,0,0,0,2,0,2,0.2857142857142857,2,0.0,0,0,0,0,0,0,0,2,0,0,2,1
729,12808,idxWUfEs3kYL0r7IC35umYY3ZJQ22Zab,SpATywNh6bZuzm8s1ceuBUnMUAeoAHHw,5,5,3,0,1,0,1,0,10,1.4285714285714286,1,0.0,0,3,0,1,5,0,0,1,0,4,6,1
730,12813,L3khlyhxkzKPVeEgnV2Dt5jl6Pe5Thm4,RXDvfPUBYFlVdlueBFbLW0mhhAyGEqpt,1,0,0,0,0,0,1,0,1,0.14285714285714285,1,0.0,0,0,0,0,0,0,0,1,0,0,1,1
731,12834,ZYxocA1Ix9ILa1C9VKK1bM1W4sEOXUVw,SpATywNh6bZuzm8s1ceuBUnMUAeoAHHw,19,25,0,29,0,0,7,0,61,8.714285714285714,3,0.0,12,0,28,0,13,0,1,7,0,40,21,0
732,12845,syrttArug8Mpzs9L0IHsvBtATawYF9J2,SpATywNh6bZuzm8s1ceuBUnMUAeoAHHw,8,5,4,0,1,0,3,0,13,1.8571428571428572,3,0.0,0,4,0,1,5,0,0,3,0,5,8,1
733,12853,55dttExESw0iXI74tkLBOaeITFkRCx90,A3fsA9Zfv1X2fVEQhTw51lKENdNrEqT3,42,39,21,58,8,2,15,1,144,20.571428571428573,3,0.0,1,21,48,8,38,2,10,15,1,78,66,1
734,12854,cVHCYdG6eoXKQe55dLZbvLgwBGbWam7p,A3fsA9Zfv1X2fVEQhTw51lKENdNrEqT3,11,11,2,0,1,0,6,0,20,2.857142857142857,3,0.0,0,2,0,1,11,0,0,6,0,3,17,1
735,12856,0wSRq6mRtt7ajwm8CWZxYMig1mbMrg7d,bWdj2GDclj5ofokWjzoa5jAwMkxCykd6,1,0,0,0,0,0,1,0,1,0.14285714285714285,1,0.0,0,0,0,0,0,0,0,1,0,0,1,1
736,12883,KKz5C2CIERGp4d0g7P8ZO1hnR4NT39t2,SpATywNh6bZuzm8s1ceuBUnMUAeoAHHw,28,27,16,16,10,9,4,0,82,11.714285714285714,2,0.0,6,16,13,10,21,9,3,4,0,45,37,0
737,12888,lMy0A59BRo4770ALzvOjsBS5HJkCRV78,A3fsA9Zfv1X2fVEQhTw51lKENdNrEqT3,9,17,8,0,3,10,7,0,45,6.428571428571429,4,0.0,0,8,0,3,17,10,0,7,0,11,34,1
738,12892,P0uW8e7uWJsgVO5MWg1krlEvXljM181Y,bWdj2GDclj5ofokWjzoa5jAwMkxCykd6,7,2,2,4,1,0,3,0,12,1.7142857142857142,1,0.0,0,2,4,1,2,0,0,3,0,7,5,1
739,12948,f7pgA2Hp0s8DkqzKuvE0Kw8QRuoBh3Zv,A3fsA9Zfv1X2fVEQhTw51lKENdNrEqT3,17,6,4,57,0,8,1,0,76,10.857142857142858,1,0.0,0,4,46,0,6,8,11,1,0,50,26,0
740,12956,lEIFkqeT396JMSPUyiaHNMN8g7bQ1x9p,SpATywNh6bZuzm8s1ceuBUnMUAeoAHHw,24,54,18,18,6,2,14,1,113,16.142857142857142,3,0.0,35,18,17,6,19,2,1,14,1,76,37,0
741,12976,KpbHdGVlZIWVraCiFee7Cav2rNnqqrsJ,SpATywNh6bZuzm8s1ceuBUnMUAeoAHHw,17,22,16,10,10,0,3,0,61,8.714285714285714,1,0.0,2,16,10,10,20,0,0,3,0,38,23,1
742,12993,8r4M2l7ATXMXEQUCAknekZVeyUGIpRyK,SpATywNh6bZuzm8s1ceuBUnMUAeoAHHw,9,24,0,0,0,0,20,0,44,6.285714285714286,2,0.0,0,0,0,0,24,0,0,20,0,0,44,1
743,13011,3Eee8QbVtHhcwedqstQME1x67jOdVLkK,SpATywNh6bZuzm8s1ceuBUnMUAeoAHHw,5,3,0,0,0,1,4,3,11,1.5714285714285714,1,0.0,0,0,0,0,3,1,0,4,3,0,11,1
744,13023,MAktGJIumyskhJp25e79u9tVhauVJ2c6,SpATywNh6bZuzm8s1ceuBUnMUAeoAHHw,18,20,10,18,7,34,12,1,102,14.571428571428571,2,0.0,4,10,15,7,16,34,3,12,1,36,66,0
745,13088,AbunVo6pGQTlDxnSJmOS7flQ0Vb2S3xP,bWdj2GDclj5ofokWjzoa5jAwMkxCykd6,13,13,5,18,3,6,12,1,58,8.285714285714286,2,0.0,4,5,18,3,9,6,0,12,1,30,28,1
746,13109,YW2vWUP3xrebFWQq20TaENvqpb9ZdJV6,SpATywNh6bZuzm8s1ceuBUnMUAeoAHHw,15,11,6,10,4,4,2,0,37,5.285714285714286,1,0.0,2,6,9,4,9,4,1,2,0,21,16,0
747,13129,AbunVo6pGQTlDxnSJmOS7flQ0Vb2S3xP,A3fsA9Zfv1X2fVEQhTw51lKENdNrEqT3,1,0,0,0,0,0,3,0,3,0.42857142857142855,2,0.0,0,0,0,0,0,0,0,3,0,0,3,1
748,13135,nF3fyodzvP9Kt8uvHxBDafFDSHuZ38jd,SpATywNh6bZuzm8s1ceuBUnMUAeoAHHw,18,34,3,18,3,5,5,0,68,9.714285714285714,2,0.0,2,3,15,3,32,5,3,5,0,23,45,1
749,13143,igeK6rUQT7Ehyj7yY5oAEj8DvOITiuBO,SpATywNh6bZuzm8s1ceuBUnMUAeoAHHw,17,24,13,14,6,2,5,0,64,9.142857142857142,3,0.0,5,13,12,6,19,2,2,5,0,36,28,0
750,13147,p9Pgf9XUtcr2kL39MqLlMakadbFqlUtX,RXDvfPUBYFlVdlueBFbLW0mhhAyGEqpt,5,4,3,0,2,0,2,0,11,1.5714285714285714,3,0.0,0,3,0,2,4,0,0,2,0,5,6,1
751,13159,gMZKWOenFyVb6m3mcpDQmzDRcu1zvYbF,G8EPVSXsOYB5YQWZGiz1aVq5Pgr2GrQu,4,4,0,0,0,0,3,0,7,1.0,1,0.0,0,0,0,0,4,0,0,3,0,0,7,1
752,13179,pOKZyBql9SdI7DoREUHq99ghEycAS0cI,bWdj2GDclj5ofokWjzoa5jAwMkxCykd6,4,2,0,0,1,0,1,0,4,0.5714285714285714,1,0.0,0,0,0,1,2,0,0,1,0,1,3,1
753,13187,i67qzouvUD7nINgK6d1xrH4pvufZqbFd,bWdj2GDclj5ofokWjzoa5jAwMkxCykd6,3,2,0,0,0,0,3,0,5,0.7142857142857143,1,0.0,0,0,0,0,2,0,0,3,0,0,5,1
754,13206,GSkYUOcl4XzYMWSWhE6gXRGQ9kqPeXsi,RXDvfPUBYFlVdlueBFbLW0mhhAyGEqpt,8,7,5,0,3,0,2,0,17,2.4285714285714284,2,0.0,0,5,0,3,7,0,0,2,0,8,9,1
755,13207,PMDa1SUjeddLyhfDscbnAxL67GyZb6sD,SpATywNh6bZuzm8s1ceuBUnMUAeoAHHw,17,31,17,16,1,5,7,0,77,11.0,3,0.0,2,17,16,1,29,5,0,7,0,36,41,0
756,13212,pR0rEzd43YPn1ujQN1oHxqL0z3U4G8ju,SpATywNh6bZuzm8s1ceuBUnMUAeoAHHw,1,0,0,0,0,0,1,0,1,0.14285714285714285,1,0.0,0,0,0,0,0,0,0,1,0,0,1,1
757,13214,XFmrH2WQYMYLXRE1Jm7VValFt236PUJr,SpATywNh6bZuzm8s1ceuBUnMUAeoAHHw,22,24,1,24,1,0,3,0,53,7.571428571428571,2,0.0,8,1,20,1,16,0,4,3,0,30,23,1
758,13227,0wJhtCWK60WPCeRF62m8T80DtNpWhRrg,RXDvfPUBYFlVdlueBFbLW0mhhAyGEqpt,46,44,20,98,11,0,5,0,178,25.428571428571427,4,0.0,9,20,94,11,35,0,4,5,0,134,44,0
759,13233,UM3F51S6vWhAORUn5XfgddMSa2NpuDR3,bWdj2GDclj5ofokWjzoa5jAwMkxCykd6,5,4,1,0,1,0,3,0,9,1.2857142857142858,2,0.0,0,1,0,1,4,0,0,3,0,2,7,1
760,13240,m52orXncJIuZMWO7LnwS1hFqDU5X5m24,SpATywNh6bZuzm8s1ceuBUnMUAeoAHHw,16,16,6,20,4,3,2,0,51,7.285714285714286,1,0.0,6,6,17,4,10,3,3,2,0,33,18,0
761,13259,KovPBJesZmgqVCWR3DXdtvcd4XyHL9BT,SpATywNh6bZuzm8s1ceuBUnMUAeoAHHw,9,8,4,0,3,0,3,0,18,2.5714285714285716,1,0.0,0,4,0,3,8,0,0,3,0,7,11,0
762,13263,CZ6gFOo6OnSPq5AGDZTDmf17XM8Rum8M,SpATywNh6bZuzm8s1ceuBUnMUAeoAHHw,10,8,0,11,0,0,3,0,22,3.142857142857143,1,0.0,3,0,10,0,5,0,1,3,0,13,9,1
763,13273,bKbwS8bsj3eNxoCQcsrg5SKpHAoJ8uGu,A3fsA9Zfv1X2fVEQhTw51lKENdNrEqT3,49,42,2,148,0,8,12,0,212,30.285714285714285,5,0.0,11,2,120,0,31,8,28,12,0,133,79,1
764,13290,bDOMCQV7nFdKo0pDqOPr3ECLpgkdBCSt,A3fsA9Zfv1X2fVEQhTw51lKENdNrEqT3,14,23,2,0,2,0,4,0,31,4.428571428571429,2,0.0,0,2,0,2,23,0,0,4,0,4,27,1
765,13316,7P8eMWaZZgnw2duzHVId8BVYAnTZapE1,SpATywNh6bZuzm8s1ceuBUnMUAeoAHHw,8,4,2,0,2,0,8,0,16,2.2857142857142856,1,0.0,0,2,0,2,4,0,0,8,0,4,12,1
766,13319,sqZsZQq9LcjzbfCPmehLyMMrK3ClcYAT,SpATywNh6bZuzm8s1ceuBUnMUAeoAHHw,3,2,0,0,0,0,1,0,3,0.42857142857142855,1,0.0,0,0,0,0,2,0,0,1,0,0,3,1
767,13338,UidTeyEs50r1zTQVJtstLvLcMUKrNN3b,SpATywNh6bZuzm8s1ceuBUnMUAeoAHHw,7,11,1,4,0,0,3,0,19,2.7142857142857144,2,0.0,5,1,4,0,6,0,0,3,0,10,9,0
768,13358,Aw7PeIkLW9CDHbPpPSjrFUdtBaUuHUXm,bWdj2GDclj5ofokWjzoa5jAwMkxCykd6,23,12,6,42,2,18,20,1,101,14.428571428571429,4,0.0,4,6,36,2,8,18,6,20,1,48,53,0
769,13379,TGngiWN6RHpSD048KJCksxngjFh0emXm,A3fsA9Zfv1X2fVEQhTw51lKENdNrEqT3,7,6,1,0,1,0,3,0,11,1.5714285714285714,1,0.0,0,1,0,1,6,0,0,3,0,2,9,1
770,13386,5KSMnQXKnbRqNWod4v539vcEvMedku3c,bWdj2GDclj5ofokWjzoa5jAwMkxCykd6,2,0,0,0,0,0,2,0,2,0.2857142857142857,1,0.0,0,0,0,0,0,0,0,2,0,0,2,1
771,13398,bqWpav7ocOhCfb3xc4QgAvBDK5g8BmiZ,SpATywNh6bZuzm8s1ceuBUnMUAeoAHHw,8,15,8,0,2,0,5,0,30,4.285714285714286,3,0.0,3,8,0,2,12,0,0,5,0,13,17,0
772,13402,mGb99e4ZiyyEapZp3B98Pssar5eWGHEz,G8EPVSXsOYB5YQWZGiz1aVq5Pgr2GrQu,15,17,1,30,1,0,3,0,52,7.428571428571429,2,0.0,3,1,24,1,14,0,6,3,0,29,23,1
773,13424,PfZH4Yubwsve9DvShzAvHjayDN16nhpN,G8EPVSXsOYB5YQWZGiz1aVq5Pgr2GrQu,1,0,0,0,0,0,1,0,1,0.14285714285714285,1,0.0,0,0,0,0,0,0,0,1,0,0,1,1
774,13430,j0gxXks7DZitzyeEGG2agLKFp30HqXVu,bWdj2GDclj5ofokWjzoa5jAwMkxCykd6,11,26,11,0,1,1,6,0,45,6.428571428571429,2,0.0,5,11,0,1,21,1,0,6,0,17,28,0
775,13460,mG2HKIW4KvK5MNtCekVvEvxXHT51PCPq,A3fsA9Zfv1X2fVEQhTw51lKENdNrEqT3,1,0,0,0,0,0,1,0,1,0.14285714285714285,1,0.0,0,0,0,0,0,0,0,1,0,0,1,1
776,13469,OLmaTq1VRWq8uhF6WwamKt59rXmIqMgh,SpATywNh6bZuzm8s1ceuBUnMUAeoAHHw,5,4,2,0,1,0,2,0,9,1.2857142857142858,1,0.0,0,2,0,1,4,0,0,2,0,3,6,1
777,13477,9pzI899XVNJmMa8xv35JoCa2P4C0Faa4,bWdj2GDclj5ofokWjzoa5jAwMkxCykd6,14,31,3,0,2,39,13,1,89,12.714285714285714,2,0.0,0,3,0,2,31,39,0,13,1,5,84,1
778,13479,sfuANiSFq72qS7aoKnyvPaRtXw7bLFiY,SpATywNh6bZuzm8s1ceuBUnMUAeoAHHw,7,8,3,0,2,0,2,0,15,2.142857142857143,1,0.0,0,3,0,2,8,0,0,2,0,5,10,1
779,13490,RtDHl5nE4LpZJE4fPWaXYE5l5ziJJw3q,SpATywNh6bZuzm8s1ceuBUnMUAeoAHHw,6,7,3,0,3,0,1,0,14,2.0,1,0.0,0,3,0,3,7,0,0,1,0,6,8,1
780,13491,KKBYOCb35hszQy5vSfsxbAFYFgilEECF,SpATywNh6bZuzm8s1ceuBUnMUAeoAHHw,12,10,6,9,1,0,4,0,30,4.285714285714286,2,0.0,4,6,9,1,6,0,0,4,0,20,10,1
781,13518,OcFLLEI56U80V98vNeJ7LrlE5FWxkkpp,SpATywNh6bZuzm8s1ceuBUnMUAeoAHHw,19,35,15,12,8,21,9,2,102,14.571428571428571,3,0.0,7,15,12,8,28,21,0,9,2,42,60,0
782,13525,J1f9rNzR7t1WQhWY7vU0QrkaWuS9xCeR,bWdj2GDclj5ofokWjzoa5jAwMkxCykd6,11,5,3,14,2,0,10,0,34,4.857142857142857,2,0.0,2,3,13,2,3,0,1,10,0,20,14,1
783,13530,7dPYuxC1NExRQjXFHnhWbTviIyBFUDmL,SpATywNh6bZuzm8s1ceuBUnMUAeoAHHw,2,6,7,0,0,0,0,0,13,1.8571428571428572,7,0.0,0,7,0,0,6,0,0,0,0,7,6,1
784,13537,LDoffeIzXBaEA3EoYd9Gp4Kl36LUuUJD,SpATywNh6bZuzm8s1ceuBUnMUAeoAHHw,10,12,6,0,1,17,10,4,50,7.142857142857143,3,0.0,0,6,0,1,12,17,0,10,4,7,43,1
785,13552,IGnubmoC2Z3kyMhnm5cfb5h7HnKkMEVq,G8EPVSXsOYB5YQWZGiz1aVq5Pgr2GrQu,2,0,0,0,0,0,3,0,3,0.42857142857142855,1,0.0,0,0,0,0,0,0,0,3,0,0,3,1
786,13578,7XgWWxsOrwxcFjioh5NncRGrx77dSS5r,SpATywNh6bZuzm8s1ceuBUnMUAeoAHHw,23,33,1,21,1,1,8,0,65,9.285714285714286,2,0.0,7,1,19,1,26,1,2,8,0,28,37,0
787,13583,UmlMF2TsgsipXk92JRV0A7TQAmCZuKWV,SpATywNh6bZuzm8s1ceuBUnMUAeoAHHw,6,4,1,0,0,0,2,0,7,1.0,1,0.0,0,1,0,0,4,0,0,2,0,1,6,1
788,13587,zFEKyzORyNtVsN87mi1ReZjFEUKvm21T,SpATywNh6bZuzm8s1ceuBUnMUAeoAHHw,25,32,19,12,9,9,6,2,89,12.714285714285714,3,0.0,3,19,10,9,29,9,2,6,2,41,48,1
789,13594,sZYvW7O1yC1PAj5iYABgZ056jCM2PsNq,SpATywNh6bZuzm8s1ceuBUnMUAeoAHHw,13,20,8,4,4,0,2,0,38,5.428571428571429,2,0.0,9,8,4,4,11,0,0,2,0,25,13,0
790,13605,g2crr0D1YRZspeg3aG0QVrkBBPBltTjz,SpATywNh6bZuzm8s1ceuBUnMUAeoAHHw,12,19,3,19,1,0,2,0,44,6.285714285714286,3,0.0,9,3,16,1,10,0,3,2,0,29,15,0
791,13610,r10mjNLAOjkXo9ipKqWrD4Hts48L6lcD,G8EPVSXsOYB5YQWZGiz1aVq5Pgr2GrQu,45,19,15,134,12,0,3,0,183,26.142857142857142,1,0.0,0,15,113,12,19,0,21,3,0,140,43,0
792,13672,kP6GmMO1OBG46GzGpGgNEkhdNz0eN2Yt,SpATywNh6bZuzm8s1ceuBUnMUAeoAHHw,1,0,0,0,0,0,1,0,1,0.14285714285714285,1,0.0,0,0,0,0,0,0,0,1,0,0,1,1
793,13684,XkKS323fFxBVezQ5JyIgzxHDxEKEwwEf,A3fsA9Zfv1X2fVEQhTw51lKENdNrEqT3,7,4,2,8,0,0,1,0,15,2.142857142857143,1,0.0,1,2,8,0,3,0,0,1,0,11,4,0
794,13696,r0yAsNzYkqEPYi6zNhQfzuueDjmcyFRr,bWdj2GDclj5ofokWjzoa5jAwMkxCykd6,2,0,0,0,0,0,3,0,3,0.42857142857142855,1,0.0,0,0,0,0,0,0,0,3,0,0,3,1
795,13703,FaZLW3HiYLflnTCxi4BN21oHHvNYhtue,SpATywNh6bZuzm8s1ceuBUnMUAeoAHHw,10,12,8,0,2,0,4,0,26,3.7142857142857144,3,0.0,0,8,0,2,12,0,0,4,0,10,16,1
796,13711,H2Rgqo3kRDsNdbNVEDl0788s9SSdLM8P,bWdj2GDclj5ofokWjzoa5jAwMkxCykd6,6,5,2,0,2,0,4,0,13,1.8571428571428572,3,0.0,0,2,0,2,5,0,0,4,0,4,9,1
797,13714,e4xoItGqdt7VvYzxou1Pv23rnKAXXXsC,SpATywNh6bZuzm8s1ceuBUnMUAeoAHHw,7,7,1,0,1,0,4,0,13,1.8571428571428572,2,0.0,0,1,0,1,7,0,0,4,0,2,11,1
798,13720,9JsNhrsWtCheE46kbgKiC6TCsPPGBSze,SpATywNh6bZuzm8s1ceuBUnMUAeoAHHw,19,31,17,9,5,3,5,0,70,10.0,2,0.0,7,17,9,5,24,3,0,5,0,38,32,1
799,13750,6UfeuZvS7L15CgcbiecsOUDWQezuLDJz,SpATywNh6bZuzm8s1ceuBUnMUAeoAHHw,1,0,0,0,0,0,1,0,1,0.14285714285714285,1,0.0,0,0,0,0,0,0,0,1,0,0,1,1
800,13751,wfHTtk8oy0CiP4p3waBMhlIvxeVIbZqk,SpATywNh6bZuzm8s1ceuBUnMUAeoAHHw,18,18,4,9,3,8,14,0,56,8.0,4,0.0,4,4,9,3,14,8,0,14,0,20,36,0
801,13758,Pt4CHQaH2Lj9ri6xbjrkQ0IBNpZPKhdM,SpATywNh6bZuzm8s1ceuBUnMUAeoAHHw,2,0,0,0,0,0,2,0,2,0.2857142857142857,1,0.0,0,0,0,0,0,0,0,2,0,0,2,1
802,13764,fdJXQSSucuzaRljy096jXgInnW2TakHQ,SpATywNh6bZuzm8s1ceuBUnMUAeoAHHw,23,54,28,33,1,2,6,0,124,17.714285714285715,3,0.0,13,28,27,1,41,2,6,6,0,69,55,0
803,13780,EikisME12XnhqTfgnKK3O8hmfAWTmSd3,G8EPVSXsOYB5YQWZGiz1aVq5Pgr2GrQu,27,19,2,74,1,0,6,0,102,14.571428571428571,3,0.0,1,2,62,1,18,0,12,6,0,66,36,0
804,13788,xYZJv26kEF7oZiNSoEZMnXHo33iYNlMJ,A3fsA9Zfv1X2fVEQhTw51lKENdNrEqT3,25,6,3,62,0,2,4,1,78,11.142857142857142,1,0.0,1,3,55,0,5,2,7,4,1,59,19,1
805,14683,EK8cH2rqaeWCMjTFz8xL65N7r32HerY9,7GRhBDsirIGkRZBtSMEzNTyDr2JQm4xx,35,56,16,50,13,65,10,3,213,30.428571428571427,5,0.0,31,16,42,13,25,65,8,10,3,102,111,0
806,14690,ZbWUV0qkotaaSLhz8iJBNOk5nD7qDeuY,7GRhBDsirIGkRZBtSMEzNTyDr2JQm4xx,23,41,24,0,25,0,7,0,97,13.857142857142858,2,0.0,11,24,0,25,30,0,0,7,0,60,37,0
807,14815,IQhh6lXlVmCrcAcXbMrK8pYs2wjQgUqq,7GRhBDsirIGkRZBtSMEzNTyDr2JQm4xx,4,1,1,0,0,155,5,0,162,23.142857142857142,3,0.0,0,1,0,0,1,155,0,5,0,1,161,0
808,14818,UgETwjVUoQXyxwFA12B4jwRDb3R4sQSN,7GRhBDsirIGkRZBtSMEzNTyDr2JQm4xx,26,47,20,49,15,0,6,0,137,19.571428571428573,4,0.0,21,20,45,15,26,0,4,6,0,101,36,1
809,14829,QZIRHdwFgibI2SBehTrmLAZxED1F4JL7,7GRhBDsirIGkRZBtSMEzNTyDr2JQm4xx,5,4,2,0,1,0,1,0,8,1.1428571428571428,1,0.0,0,2,0,1,4,0,0,1,0,3,5,1
810,14836,lEIFkqeT396JMSPUyiaHNMN8g7bQ1x9p,7GRhBDsirIGkRZBtSMEzNTyDr2JQm4xx,6,1,1,0,1,0,3,0,6,0.8571428571428571,1,0.0,0,1,0,1,1,0,0,3,0,2,4,1
811,14837,CEMMuEEc653PcYnJ6cnr3jxrYZv9f8D1,7GRhBDsirIGkRZBtSMEzNTyDr2JQm4xx,1,0,0,0,0,0,1,0,1,0.14285714285714285,1,0.0,0,0,0,0,0,0,0,1,0,0,1,1
812,14846,5Xet5BwM6xDYh8pbaupnwmiq9T6jy7TC,7GRhBDsirIGkRZBtSMEzNTyDr2JQm4xx,19,21,8,18,10,9,6,0,72,10.285714285714286,2,0.0,13,8,16,10,8,9,2,6,0,47,25,1
813,14851,SDvatKCgfdtv12UzJLxR0GYxgD4pUkgT,7GRhBDsirIGkRZBtSMEzNTyDr2JQm4xx,21,34,13,36,3,5,8,0,99,14.142857142857142,3,0.0,16,13,31,3,18,5,5,8,0,63,36,1
814,14873,vJOKvfBreLyHqbEVMHx8ymKhM8KWKMc3,7GRhBDsirIGkRZBtSMEzNTyDr2JQm4xx,1,0,0,0,0,0,1,0,1,0.14285714285714285,1,0.0,0,0,0,0,0,0,0,1,0,0,1,1
815,14944,g4UocDcFYSnUbOlhUZMBUfqXzzGSRrqN,7GRhBDsirIGkRZBtSMEzNTyDr2JQm4xx,1,0,0,0,0,0,1,0,1,0.14285714285714285,1,0.0,0,0,0,0,0,0,0,1,0,0,1,1
816,14990,5VgPwWusKQIJc1LutXp6JyAv3fzKgfIX,7GRhBDsirIGkRZBtSMEzNTyDr2JQm4xx,16,22,10,8,9,0,2,0,51,7.285714285714286,2,0.0,7,10,7,9,15,0,1,2,0,33,18,1
817,15016,yZ9FndAKqVsKwZtO1B2JJJblefdbhZ02,7GRhBDsirIGkRZBtSMEzNTyDr2JQm4xx,5,2,1,0,1,0,8,0,12,1.7142857142857142,3,0.0,1,1,0,1,1,0,0,8,0,3,9,1
818,15017,Qp9WPjKz2PASr9CWx9cGEYZGKd1Nemqr,7GRhBDsirIGkRZBtSMEzNTyDr2JQm4xx,11,15,6,0,5,1,15,0,42,6.0,1,0.0,4,6,0,5,11,1,0,15,0,15,27,1
819,15107,HFGNqnAY2MWiYF3III5EKx6o7tu1uiwJ,7GRhBDsirIGkRZBtSMEzNTyDr2JQm4xx,31,94,36,89,13,37,9,0,278,39.714285714285715,5,0.0,40,36,74,13,54,37,15,9,0,163,115,1
820,15110,5zX31TZPkBQ4nxGKP7lPYFABTGNW6PHa,7GRhBDsirIGkRZBtSMEzNTyDr2JQm4xx,1,0,0,0,0,0,1,0,1,0.14285714285714285,1,0.0,0,0,0,0,0,0,0,1,0,0,1,1
821,15132,uOfATV0WsL0BPHDdVyS70rl0sYjdudpd,7GRhBDsirIGkRZBtSMEzNTyDr2JQm4xx,19,20,9,0,7,0,3,0,39,5.571428571428571,2,0.0,9,9,0,7,11,0,0,3,0,25,14,1
822,15164,ziRAzdRuzlLfb854mAvEaRYGuXqnCERH,7GRhBDsirIGkRZBtSMEzNTyDr2JQm4xx,39,92,27,78,19,5,14,0,235,33.57142857142857,3,0.0,51,27,64,19,41,5,14,14,0,161,74,0
823,15178,28PHU9suTM8EqUKsQwsvQ03DzFXi0yDl,7GRhBDsirIGkRZBtSMEzNTyDr2JQm4xx,9,10,4,2,3,0,3,0,22,3.142857142857143,2,0.0,3,4,2,3,7,0,0,3,0,12,10,0
824,15282,FRiuKxH98VzIG6N65WQEkvVSqVJx6TSd,7GRhBDsirIGkRZBtSMEzNTyDr2JQm4xx,14,22,8,11,11,0,2,0,54,7.714285714285714,1,0.0,13,8,11,11,9,0,0,2,0,43,11,1
825,15318,5ApoT0ZoLbVQmiV8xOjwVDUBfTF6QDuq,7GRhBDsirIGkRZBtSMEzNTyDr2JQm4xx,4,7,2,0,0,1,3,0,13,1.8571428571428572,1,0.0,4,2,0,0,3,1,0,3,0,6,7,1
826,15397,iWIAGeS3ATYiVCcaQcig63Lt0fYY4o8o,7GRhBDsirIGkRZBtSMEzNTyDr2JQm4xx,41,57,16,95,21,9,5,0,203,29.0,2,0.0,39,16,85,21,18,9,10,5,0,161,42,0
827,15445,hrmgRr5TKkTKcJMaNH4IpBZoiQT9X6aI,7GRhBDsirIGkRZBtSMEzNTyDr2JQm4xx,3,0,0,0,0,0,3,0,3,0.42857142857142855,1,0.0,0,0,0,0,0,0,0,3,0,0,3,0
828,15469,udnRYxurswpE4GUZcnc80kafg0hn3fpz,7GRhBDsirIGkRZBtSMEzNTyDr2JQm4xx,6,7,2,4,1,0,1,0,15,2.142857142857143,1,0.0,1,2,3,1,6,0,1,1,0,7,8,1
829,15478,pHniYPYuaHgPmhy34oeWjiQMJE6eXmrA,7GRhBDsirIGkRZBtSMEzNTyDr2JQm4xx,1,0,0,0,0,0,1,0,1,0.14285714285714285,1,0.0,0,0,0,0,0,0,0,1,0,0,1,1
830,15484,2OBbYlHxjDvtkcifhxwhxMZlYPhEHOro,7GRhBDsirIGkRZBtSMEzNTyDr2JQm4xx,24,44,3,52,2,0,5,0,106,15.142857142857142,3,0.0,17,3,49,2,27,0,3,5,0,71,35,0
831,15541,ILkUjE8LhIAQFlZwnOqsyA4K0QvAbnzA,7GRhBDsirIGkRZBtSMEzNTyDr2JQm4xx,39,190,59,52,20,49,47,6,423,60.42857142857143,5,0.0,97,59,42,20,93,49,10,47,6,218,205,0
832,15577,WeG9Rj8lv2ekdTamRkXPOfgW6N9lzyds,7GRhBDsirIGkRZBtSMEzNTyDr2JQm4xx,9,15,5,9,2,0,2,0,33,4.714285714285714,2,0.0,4,5,8,2,11,0,1,2,0,19,14,1
833,15593,917a11esEUG2kjEBnxsgADWhvlUYEWb2,7GRhBDsirIGkRZBtSMEzNTyDr2JQm4xx,1,0,0,0,0,0,1,0,1,0.14285714285714285,1,0.0,0,0,0,0,0,0,0,1,0,0,1,1
834,15596,Jag1EXQWfAuTRiCgcVLyhRRkdOL9RtSD,7GRhBDsirIGkRZBtSMEzNTyDr2JQm4xx,31,29,14,36,5,11,10,1,106,15.142857142857142,3,0.0,11,14,35,5,18,11,1,10,1,65,41,1
835,15604,MUERAHHFAKMlIE27Ma0uSdeN9dFIyDRi,7GRhBDsirIGkRZBtSMEzNTyDr2JQm4xx,6,3,1,0,1,0,3,0,8,1.1428571428571428,2,0.0,0,1,0,1,3,0,0,3,0,2,6,1
836,15634,oco4sYAQqzdnYEwLykTSM4qmOTgkFoAN,7GRhBDsirIGkRZBtSMEzNTyDr2JQm4xx,12,7,2,0,1,0,8,0,18,2.5714285714285716,2,0.0,0,2,0,1,7,0,0,8,0,3,15,0
837,15637,syrttArug8Mpzs9L0IHsvBtATawYF9J2,7GRhBDsirIGkRZBtSMEzNTyDr2JQm4xx,37,63,22,67,10,3,2,0,167,23.857142857142858,2,0.0,37,22,56,10,26,3,11,2,0,125,42,1
838,15676,fT8l2Rgir0TYnZP4X9UADbvRi0H8tycH,7GRhBDsirIGkRZBtSMEzNTyDr2JQm4xx,1,0,0,0,0,0,1,0,1,0.14285714285714285,1,0.0,0,0,0,0,0,0,0,1,0,0,1,1
839,15783,Jm4nQ05ndX10jbofbWx6S0r9VXrqia6S,7GRhBDsirIGkRZBtSMEzNTyDr2JQm4xx,28,51,21,51,11,0,9,0,143,20.428571428571427,4,0.0,20,21,45,11,31,0,6,9,0,97,46,0
840,15812,zTVBZ1zOMswSgDWxrOfzKUr5J9HO6HOE,7GRhBDsirIGkRZBtSMEzNTyDr2JQm4xx,70,174,52,152,35,5,21,0,439,62.714285714285715,5,0.0,77,52,133,35,97,5,19,21,0,297,142,1
841,15829,tD36vn1aCu8pvS184dpJPyASEvtRWzdE,7GRhBDsirIGkRZBtSMEzNTyDr2JQm4xx,23,32,11,38,9,12,4,0,106,15.142857142857142,4,0.0,16,11,35,9,16,12,3,4,0,71,35,0
842,15836,Ms0MC4W5moiGJLWP7iE3FImeH9CHN4KT,7GRhBDsirIGkRZBtSMEzNTyDr2JQm4xx,31,69,3,49,4,0,7,0,132,18.857142857142858,3,0.0,41,3,43,4,28,0,6,7,0,91,41,0
843,15867,itOUYtUQXKtiNJoDhHvixGSCtswgEapf,7GRhBDsirIGkRZBtSMEzNTyDr2JQm4xx,24,35,21,18,20,6,4,0,104,14.857142857142858,4,0.0,11,21,15,20,24,6,3,4,0,67,37,1
844,16009,Slk5JcZSYHmDLQZXaNVmcMDmjJ16kBhI,7GRhBDsirIGkRZBtSMEzNTyDr2JQm4xx,32,89,8,65,6,0,6,0,174,24.857142857142858,5,0.0,39,8,52,6,50,0,13,6,0,105,69,0
845,16016,SSM7wEvdZo8FZW0zxJcXGwdA1S6Vbn5Q,7GRhBDsirIGkRZBtSMEzNTyDr2JQm4xx,5,3,1,0,0,0,2,0,6,0.8571428571428571,1,0.0,0,1,0,0,3,0,0,2,0,1,5,1
846,16095,2WHRUx9c3z0u3SMwexxVlR2sgx8QCphl,7GRhBDsirIGkRZBtSMEzNTyDr2JQm4xx,2,0,0,0,0,0,3,0,3,0.42857142857142855,2,0.0,0,0,0,0,0,0,0,3,0,0,3,1
847,16109,cmnVKDF5NlWXx0AsUNgswSBrQUc0cjpO,7GRhBDsirIGkRZBtSMEzNTyDr2JQm4xx,6,3,2,0,1,0,2,0,8,1.1428571428571428,1,0.0,0,2,0,1,3,0,0,2,0,3,5,1
848,16126,6YaJxva3ruoxqQBNg2zA6CX5WSixFgrI,7GRhBDsirIGkRZBtSMEzNTyDr2JQm4xx,33,91,22,23,13,10,3,0,162,23.142857142857142,2,0.0,51,22,23,13,40,10,0,3,0,109,53,1
849,16137,qG2WjxxVTjr5YeDGnwFvACGaHzeUu9HC,7GRhBDsirIGkRZBtSMEzNTyDr2JQm4xx,26,18,9,23,9,0,3,0,62,8.857142857142858,1,0.0,8,9,21,9,10,0,2,3,0,47,15,1
850,16217,ESzAGDiQvgaXvzXTziuj7JqXtnuQhUld,7GRhBDsirIGkRZBtSMEzNTyDr2JQm4xx,15,10,6,12,4,0,1,0,33,4.714285714285714,1,0.0,2,6,10,4,8,0,2,1,0,22,11,1
851,16222,u6EnJOtoYTYGkLQOUZyVf756OPCxjorW,7GRhBDsirIGkRZBtSMEzNTyDr2JQm4xx,2,0,0,0,0,0,2,0,2,0.2857142857142857,1,0.0,0,0,0,0,0,0,0,2,0,0,2,1
852,16235,fV5QpAWiywuCcKLCcDbuJBbZ43MyivgG,7GRhBDsirIGkRZBtSMEzNTyDr2JQm4xx,33,58,14,54,15,7,7,0,155,22.142857142857142,3,0.0,22,14,46,15,36,7,8,7,0,97,58,1
853,16242,CtBdHmlYqpaYTMEPBvno3lS1o4khTfTp,7GRhBDsirIGkRZBtSMEzNTyDr2JQm4xx,37,62,29,61,32,4,3,0,191,27.285714285714285,5,0.0,26,29,56,32,36,4,5,3,0,143,48,1
854,16326,vEWkXCfBtnzPc8huJqQsoGlEGR1bS2AS,7GRhBDsirIGkRZBtSMEzNTyDr2JQm4xx,11,30,3,34,0,2,1,0,70,10.0,1,0.0,26,3,27,0,4,2,7,1,0,56,14,1
855,16350,jPtottuCTEl2a1fB4pqDjwAHNeUWQz5o,7GRhBDsirIGkRZBtSMEzNTyDr2JQm4xx,41,65,26,62,20,4,14,2,193,27.571428571428573,2,0.0,34,26,52,20,31,4,10,14,2,132,61,0
856,16353,bONRCO0uATZ9orvOXASjWia0swY9AaMZ,7GRhBDsirIGkRZBtSMEzNTyDr2JQm4xx,62,93,23,125,20,5,6,0,272,38.857142857142854,1,0.0,37,23,102,20,56,5,23,6,0,182,90,1
857,16384,DmRnf6emOOeLa4MI9vNggFDmgXu8cRIO,7GRhBDsirIGkRZBtSMEzNTyDr2JQm4xx,17,31,9,22,11,0,6,0,79,11.285714285714286,2,0.0,19,9,18,11,12,0,4,6,0,57,22,0
858,16467,pz4WzmrapGULqEk99lfOZVzJbwiC2Cl1,7GRhBDsirIGkRZBtSMEzNTyDr2JQm4xx,27,83,0,42,4,35,7,0,171,24.428571428571427,3,0.0,33,0,37,4,50,35,5,7,0,74,97,1
859,16473,aPM6Pkx8yXzDO1Wq6YMG1wXnFkTU2WLX,7GRhBDsirIGkRZBtSMEzNTyDr2JQm4xx,40,93,16,127,13,2,2,0,253,36.142857142857146,2,0.0,37,16,118,13,56,2,9,2,0,184,69,1
860,16572,ckaBfYMRcWDmM0gkDIb3PY6kSLd0nbzq,7GRhBDsirIGkRZBtSMEzNTyDr2JQm4xx,3,0,0,0,0,0,5,0,5,0.7142857142857143,1,0.0,0,0,0,0,0,0,0,5,0,0,5,0
861,16587,3l2AMuYrLjfvMGOYSOdPeQAMIHP0QDGn,7GRhBDsirIGkRZBtSMEzNTyDr2JQm4xx,5,4,3,6,0,0,0,0,13,1.8571428571428572,1,0.0,1,3,5,0,3,0,1,0,0,9,4,0
862,16638,QJSnryS3zb1gL3fTkTse6gK6PnzljUD1,7GRhBDsirIGkRZBtSMEzNTyDr2JQm4xx,14,17,1,36,1,1,1,0,57,8.142857142857142,1,0.0,9,1,33,1,8,1,3,1,0,44,13,1
863,16641,nq7nltznx1EwtcnQOuGwGVLzMwD63I5W,7GRhBDsirIGkRZBtSMEzNTyDr2JQm4xx,4,6,3,0,0,0,2,0,11,1.5714285714285714,1,0.0,1,3,0,0,5,0,0,2,0,4,7,1
864,16669,D222lqyFrC2b1DAJCNvtq2cDPE2yWdSh,7GRhBDsirIGkRZBtSMEzNTyDr2JQm4xx,20,59,28,20,12,0,5,0,124,17.714285714285715,3,0.0,18,28,18,12,41,0,2,5,0,76,48,1
865,16792,fbDgsipajp0xhHFfXN21wQyuQBNdN7hy,7GRhBDsirIGkRZBtSMEzNTyDr2JQm4xx,37,41,14,74,19,2,3,0,153,21.857142857142858,1,0.0,23,14,64,19,18,2,10,3,0,120,33,0
866,16816,clv7wTDLUGVcdBnHuGK5igxvVYbUFhfO,7GRhBDsirIGkRZBtSMEzNTyDr2JQm4xx,1,0,0,0,0,0,1,0,1,0.14285714285714285,1,0.0,0,0,0,0,0,0,0,1,0,0,1,1
867,16838,krqPTjwq96uxScwTNs38D4Dn2uZHC91r,7GRhBDsirIGkRZBtSMEzNTyDr2JQm4xx,5,3,1,0,1,0,2,0,7,1.0,1,0.0,0,1,0,1,3,0,0,2,0,2,5,1
868,16880,JxLtKAnMek98G5fWpyeTaKlh0zheuNnU,7GRhBDsirIGkRZBtSMEzNTyDr2JQm4xx,1,0,0,0,0,0,1,0,1,0.14285714285714285,1,0.0,0,0,0,0,0,0,0,1,0,0,1,1
869,16987,Ar7wri6od2sIMOfx95hPmMwDttR4wtOC,7GRhBDsirIGkRZBtSMEzNTyDr2JQm4xx,39,74,25,68,23,0,3,0,193,27.571428571428573,2,0.0,41,25,60,23,33,0,8,3,0,149,44,0
870,17035,M76ofI2UJItYXeusDRswE1mzVX9YlrVW,7GRhBDsirIGkRZBtSMEzNTyDr2JQm4xx,50,110,33,194,0,2,10,0,349,49.857142857142854,3,0.0,73,33,168,0,37,2,26,10,0,274,75,1
871,17060,WX5bge9EFbPypYuObEiSD1Gyvh8Z866G,7GRhBDsirIGkRZBtSMEzNTyDr2JQm4xx,35,32,15,0,20,0,6,0,73,10.428571428571429,1,0.0,14,15,0,20,18,0,0,6,0,49,24,1
872,17088,V08OBGRnuhGVZi2iGPXN66GxN6wKZmV9,7GRhBDsirIGkRZBtSMEzNTyDr2JQm4xx,2,0,0,0,0,0,2,0,2,0.2857142857142857,1,0.0,0,0,0,0,0,0,0,2,0,0,2,1
873,17102,queJQcMYiH8jxjXTFMi1fslIxDDACkNw,7GRhBDsirIGkRZBtSMEzNTyDr2JQm4xx,25,25,13,20,9,1,6,0,74,10.571428571428571,1,0.0,11,13,17,9,14,1,3,6,0,50,24,1
874,17124,xOB7vl3l1Tpb0i0cSWni40BfJ5FBclms,7GRhBDsirIGkRZBtSMEzNTyDr2JQm4xx,18,25,6,12,5,0,10,0,58,8.285714285714286,2,0.0,5,6,10,5,20,0,2,10,0,26,32,0
875,17240,g2VgGARpgGy9rA8aDCffqfXvItMu95Qi,7GRhBDsirIGkRZBtSMEzNTyDr2JQm4xx,16,26,15,13,11,0,7,0,72,10.285714285714286,3,0.0,5,15,12,11,21,0,1,7,0,43,29,0
876,17242,OcmM4lAJy1xB9HSsEUxVtaUQ7oE5dcTp,7GRhBDsirIGkRZBtSMEzNTyDr2JQm4xx,1,0,0,0,0,0,1,0,1,0.14285714285714285,1,0.0,0,0,0,0,0,0,0,1,0,0,1,0
877,17257,E4fUiWo3de6EW3llrqGI6KBrgWgpa0OH,7GRhBDsirIGkRZBtSMEzNTyDr2JQm4xx,9,13,5,0,1,7,11,0,37,5.285714285714286,1,0.0,0,5,0,1,13,7,0,11,0,6,31,1
878,17338,RLvXqOMggPmNW2f1XGbARyW4Nurlrkjt,7GRhBDsirIGkRZBtSMEzNTyDr2JQm4xx,4,2,0,0,0,0,3,0,5,0.7142857142857143,1,0.0,0,0,0,0,2,0,0,3,0,0,5,1
879,17408,yV812AacRwieF2jdqr0WB58v7NmmEdx5,7GRhBDsirIGkRZBtSMEzNTyDr2JQm4xx,1,0,0,0,0,0,2,0,2,0.2857142857142857,1,0.0,0,0,0,0,0,0,0,2,0,0,2,1
880,17485,7fC3V6ivG07wUIMOmiYFzSlyjWvbYnYf,7GRhBDsirIGkRZBtSMEzNTyDr2JQm4xx,53,93,1,195,12,9,14,0,324,46.285714285714285,4,0.0,48,1,166,12,45,9,29,14,0,227,97,0
881,17505,X0efozcVijJghBnDtnJGbXo656NrPVoZ,7GRhBDsirIGkRZBtSMEzNTyDr2JQm4xx,2,0,0,0,0,0,2,0,2,0.2857142857142857,1,0.0,0,0,0,0,0,0,0,2,0,0,2,1
882,17545,DGDF7EtBLvOTcfUxrOsvdCg2Ar6LlSc6,7GRhBDsirIGkRZBtSMEzNTyDr2JQm4xx,12,54,18,0,0,0,4,0,76,10.857142857142858,2,0.0,9,18,0,0,45,0,0,4,0,27,49,0
883,17634,UA8vU3s92g3lXc62U363PEO0xor6Mpeg,7GRhBDsirIGkRZBtSMEzNTyDr2JQm4xx,21,17,8,0,10,0,2,0,37,5.285714285714286,3,0.0,6,8,0,10,11,0,0,2,0,24,13,0
884,17673,JSViK46d91E9ikMcvKp1rzZlHAqQuH4h,7GRhBDsirIGkRZBtSMEzNTyDr2JQm4xx,4,5,2,0,0,0,1,0,8,1.1428571428571428,1,0.0,0,2,0,0,5,0,0,1,0,2,6,1
885,19596,lhkiaYX6n9dxQvsKk8vp6UZQBNlsuGnH,fbPkOYLVPtPgIt0MxizjfFJov3JbHyAi,27,49,25,19,12,38,11,0,154,22.0,3,0.0,22,25,16,12,27,38,3,11,0,75,79,0
886,19613,hPhvZr1dLTLTcIKq5t7vAfQqTozZXlRI,fbPkOYLVPtPgIt0MxizjfFJov3JbHyAi,6,4,3,0,1,0,1,0,9,1.2857142857142858,1,0.0,0,3,0,1,4,0,0,1,0,4,5,1
887,19619,BcKYeHv4ZKY4DeUPw2M71hKVyOhypokT,fbPkOYLVPtPgIt0MxizjfFJov3JbHyAi,8,11,7,0,3,0,2,0,23,3.2857142857142856,1,0.0,0,7,0,3,11,0,0,2,0,10,13,1
888,19625,TvUBYMbHTCcIGUIFw5l8y3Oo0Axsdspt,fbPkOYLVPtPgIt0MxizjfFJov3JbHyAi,19,21,17,0,10,4,4,0,56,8.0,1,0.0,0,17,0,10,21,4,0,4,0,27,29,1
889,19635,fz559cnktTQw4xrHI1wICm1ao7bugAZA,fbPkOYLVPtPgIt0MxizjfFJov3JbHyAi,5,5,3,0,1,0,1,0,10,1.4285714285714286,1,0.0,0,3,0,1,5,0,0,1,0,4,6,1
890,19637,8MQx62NrM26CEa5RRkhFUh36AiGGNx6S,fbPkOYLVPtPgIt0MxizjfFJov3JbHyAi,9,17,1,0,1,0,1,0,20,2.857142857142857,1,0.0,0,1,0,1,17,0,0,1,0,2,18,0
891,19647,95Gw2yhEY17itkROcjsEWWGhFV0TNXNK,fbPkOYLVPtPgIt0MxizjfFJov3JbHyAi,8,8,5,0,0,7,2,0,22,3.142857142857143,1,0.0,0,5,0,0,8,7,0,2,0,5,17,1
892,19662,tvh0r7BXEnkkRFvEGDSaxc2cnDAVPflf,fbPkOYLVPtPgIt0MxizjfFJov3JbHyAi,4,3,0,0,0,0,1,0,4,0.5714285714285714,1,0.0,0,0,0,0,3,0,0,1,0,0,4,1
893,19663,dqE1PGrWExsbP4JkEoKdSn4p50FzqbEb,fbPkOYLVPtPgIt0MxizjfFJov3JbHyAi,1,0,0,0,0,0,1,0,1,0.14285714285714285,1,0.0,0,0,0,0,0,0,0,1,0,0,1,1
894,19677,rl1ijjmPoVXrn0BLw0LMwhU2iQWvim3X,fbPkOYLVPtPgIt0MxizjfFJov3JbHyAi,23,43,30,24,8,36,5,0,146,20.857142857142858,4,0.0,8,30,21,8,35,36,3,5,0,67,79,0
895,19680,PLKfIj5PWmJ1pq6F2TAT2ZidBGAMa6pt,fbPkOYLVPtPgIt0MxizjfFJov3JbHyAi,6,7,2,0,0,8,3,1,21,3.0,1,0.0,4,2,0,0,3,8,0,3,1,6,15,1
896,19681,XY4zkM1XF8dydjqcvDmQyLNW1UDj6PeN,fbPkOYLVPtPgIt0MxizjfFJov3JbHyAi,6,7,4,0,3,0,1,0,15,2.142857142857143,1,0.0,1,4,0,3,6,0,0,1,0,8,7,1
897,19688,RxXRKZYpbfKbF79XwFGwONhlZ3CWNuKc,fbPkOYLVPtPgIt0MxizjfFJov3JbHyAi,1,0,0,0,0,0,1,0,1,0.14285714285714285,1,0.0,0,0,0,0,0,0,0,1,0,0,1,1
898,19697,94kd1qvIZ0nokZPS6BCV8qxXnL5MM2jB,fbPkOYLVPtPgIt0MxizjfFJov3JbHyAi,25,68,32,19,13,60,25,1,218,31.142857142857142,6,0.0,9,32,19,13,59,60,0,25,1,73,145,0
899,19706,ZgQ15hhI1Ucp5464waJfnBAlAZitQ6GS,fbPkOYLVPtPgIt0MxizjfFJov3JbHyAi,17,17,11,8,5,0,5,0,46,6.571428571428571,2,0.0,3,11,7,5,14,0,1,5,0,26,20,1
900,19710,2mdoNlBiXpgUVSmoihAheHl3NISmi738,fbPkOYLVPtPgIt0MxizjfFJov3JbHyAi,6,4,3,0,1,0,1,0,9,1.2857142857142858,1,0.0,0,3,0,1,4,0,0,1,0,4,5,1
901,19712,YviwWEN6zon2XUnzizUs5e4hMfvZTKyo,fbPkOYLVPtPgIt0MxizjfFJov3JbHyAi,7,4,3,0,2,0,1,0,10,1.4285714285714286,1,0.0,0,3,0,2,4,0,0,1,0,5,5,1
902,19724,iaR2pnkwyNY3r5zTqD1W39STthtx49ji,fbPkOYLVPtPgIt0MxizjfFJov3JbHyAi,23,55,17,17,15,0,8,0,112,16.0,3,0.0,23,17,15,15,32,0,2,8,0,70,42,1
903,19725,47CO43LdBnUCItnxzVzNK8EGYhZB4UEL,fbPkOYLVPtPgIt0MxizjfFJov3JbHyAi,5,2,1,0,1,0,2,0,6,0.8571428571428571,1,0.0,0,1,0,1,2,0,0,2,0,2,4,0
904,19727,bL3u5qIjoppYFsMUfGswfFLujxnAggge,fbPkOYLVPtPgIt0MxizjfFJov3JbHyAi,16,14,8,5,6,23,5,2,63,9.0,2,0.0,4,8,5,6,10,23,0,5,2,23,40,0
905,19728,klABCgiMhTPJ0XO3mm3Xvqo3F5v3JzEw,fbPkOYLVPtPgIt0MxizjfFJov3JbHyAi,2,0,0,0,0,0,2,0,2,0.2857142857142857,1,0.0,0,0,0,0,0,0,0,2,0,0,2,1
906,19729,GP9uxCl0w0ORUxGcBwBhHCA6EDx2EOSR,fbPkOYLVPtPgIt0MxizjfFJov3JbHyAi,7,9,6,0,3,3,9,0,30,4.285714285714286,1,0.0,0,6,0,3,9,3,0,9,0,9,21,1
907,19734,PwwEqEv3o1wfWN5Eu8NuK3q82yRAO9LK,fbPkOYLVPtPgIt0MxizjfFJov3JbHyAi,1,0,0,0,0,0,1,0,1,0.14285714285714285,1,0.0,0,0,0,0,0,0,0,1,0,0,1,1
908,19736,RTFyJMIqIq6xWTPdoUugdDSXlWY0NS3w,fbPkOYLVPtPgIt0MxizjfFJov3JbHyAi,3,0,0,0,0,2,3,0,5,0.7142857142857143,1,0.0,0,0,0,0,0,2,0,3,0,0,5,1
909,19737,r5nHhhPp8wNqkUKwaWfUvmNqly1MZrKz,fbPkOYLVPtPgIt0MxizjfFJov3JbHyAi,8,10,2,0,2,1,2,0,17,2.4285714285714284,2,0.0,1,2,0,2,9,1,0,2,0,5,12,0
910,19739,XyD01HhzMuHzP5ArHNJFexoSZMamD6Wh,fbPkOYLVPtPgIt0MxizjfFJov3JbHyAi,3,2,1,0,0,0,1,0,4,0.5714285714285714,1,0.0,0,1,0,0,2,0,0,1,0,1,3,1
911,19740,J0agIiDPDsO7EgNBs76RsZQyZ6XLl2nX,fbPkOYLVPtPgIt0MxizjfFJov3JbHyAi,9,5,5,0,4,0,6,0,20,2.857142857142857,2,0.0,0,5,0,4,5,0,0,6,0,9,11,1
912,19741,IMwEerHys6R3vOnp3J0coaa20HaLBM5L,fbPkOYLVPtPgIt0MxizjfFJov3JbHyAi,7,8,4,0,2,0,2,0,16,2.2857142857142856,1,0.0,1,4,0,2,7,0,0,2,0,7,9,1
913,19747,5QI6OaFhCHlCtRcFfvDdZQ38fgw6K7ZS,fbPkOYLVPtPgIt0MxizjfFJov3JbHyAi,2,0,0,0,0,0,3,0,3,0.42857142857142855,1,0.0,0,0,0,0,0,0,0,3,0,0,3,1
914,19749,0artPLh8IkCTAf124kxiUrz2J9bSLV97,fbPkOYLVPtPgIt0MxizjfFJov3JbHyAi,7,9,5,0,0,2,5,1,22,3.142857142857143,1,0.0,1,5,0,0,8,2,0,5,1,6,16,1
915,19750,g80H6iY57adZtyt3qdJsUFLOZl0two6T,fbPkOYLVPtPgIt0MxizjfFJov3JbHyAi,6,3,1,0,1,0,4,0,9,1.2857142857142858,1,0.0,0,1,0,1,3,0,0,4,0,2,7,1
916,19751,21WmZ1MYMXM5lnwi17lhbA5W7URRxFf7,fbPkOYLVPtPgIt0MxizjfFJov3JbHyAi,2,0,0,0,0,0,2,0,2,0.2857142857142857,1,0.0,0,0,0,0,0,0,0,2,0,0,2,1
917,19755,jMt06vkBXL8VPGQpBPqacOfIuLzrVTe6,fbPkOYLVPtPgIt0MxizjfFJov3JbHyAi,14,16,11,5,8,37,6,0,83,11.857142857142858,1,0.0,3,11,4,8,13,37,1,6,0,26,57,1
918,19756,rYmGXfabWDSzV9Y1YJe1P9bXx90UHqZS,fbPkOYLVPtPgIt0MxizjfFJov3JbHyAi,7,9,2,0,3,0,6,0,20,2.857142857142857,1,0.0,5,2,0,3,4,0,0,6,0,10,10,1
919,19760,fKydOJi1gInT4LhNbAI1K5Nn83QpbQ9b,fbPkOYLVPtPgIt0MxizjfFJov3JbHyAi,9,4,3,0,2,0,5,1,15,2.142857142857143,1,0.0,0,3,0,2,4,0,0,5,1,5,10,1
920,19761,2ZVrSpja22JYuBdqG7iHOipKnnGEm2ou,fbPkOYLVPtPgIt0MxizjfFJov3JbHyAi,24,36,20,9,10,3,5,0,83,11.857142857142858,3,0.0,10,20,8,10,26,3,1,5,0,48,35,0
921,19764,IHJGcg8XuB6HPRBrjHVn1eWwbgo7JSEZ,fbPkOYLVPtPgIt0MxizjfFJov3JbHyAi,5,2,1,0,1,0,2,0,6,0.8571428571428571,1,0.0,0,1,0,1,2,0,0,2,0,2,4,1
922,19765,oZrYS5rqR18A77jULvm9aJ8bGsP88f4h,fbPkOYLVPtPgIt0MxizjfFJov3JbHyAi,33,58,28,17,13,3,16,1,136,19.428571428571427,6,0.0,10,28,14,13,48,3,3,16,1,65,71,0
923,19770,HneXab7aMQtYruvuxuZ9dNY5QxwlGitq,fbPkOYLVPtPgIt0MxizjfFJov3JbHyAi,8,2,1,0,1,0,8,1,13,1.8571428571428572,1,0.0,0,1,0,1,2,0,0,8,1,2,11,1
924,19772,fKgU6PKVjgAnp4uvGa6MHJe7D2ZYaBc1,fbPkOYLVPtPgIt0MxizjfFJov3JbHyAi,12,11,8,0,7,0,3,0,29,4.142857142857143,2,0.0,0,8,0,7,11,0,0,3,0,15,14,1
925,19773,VryhTUuSCWlg2ThKmkz8AynIgw8SfZgv,fbPkOYLVPtPgIt0MxizjfFJov3JbHyAi,10,5,3,0,3,0,3,0,14,2.0,1,0.0,0,3,0,3,5,0,0,3,0,6,8,1
926,19774,R0JUZ056kzFL6PD0dHwCASPDjJEFALuj,fbPkOYLVPtPgIt0MxizjfFJov3JbHyAi,43,118,75,39,56,12,10,1,311,44.42857142857143,4,0.0,31,75,38,56,87,12,1,10,1,200,111,1
927,19775,tA1lc3vnumj95Nh6FWr8EK0wWDHGYnC2,fbPkOYLVPtPgIt0MxizjfFJov3JbHyAi,13,14,5,10,7,3,3,3,45,6.428571428571429,1,0.0,8,5,7,7,6,3,3,3,3,27,18,1
928,19778,8b7ZppycC3YQh10hFhgFNseCAwtseLj5,fbPkOYLVPtPgIt0MxizjfFJov3JbHyAi,5,2,1,0,1,0,2,0,6,0.8571428571428571,1,0.0,0,1,0,1,2,0,0,2,0,2,4,0
929,19784,KqVrk2SHI9QdxCC7nQf6EBD4bfm6dNDK,fbPkOYLVPtPgIt0MxizjfFJov3JbHyAi,39,43,21,25,12,52,27,4,184,26.285714285714285,4,0.0,11,21,21,12,32,52,4,27,4,65,119,1
930,19786,pVW1QDTezd5CM1iZ8cdugaLwJl6C95dO,fbPkOYLVPtPgIt0MxizjfFJov3JbHyAi,1,0,0,0,0,0,1,0,1,0.14285714285714285,1,0.0,0,0,0,0,0,0,0,1,0,0,1,1
931,19787,Uud6ejfxjo2wR9C9pIlBSyKMyMrHfe52,fbPkOYLVPtPgIt0MxizjfFJov3JbHyAi,9,12,10,0,8,7,0,0,37,5.285714285714286,4,0.0,0,10,0,8,12,7,0,0,0,18,19,1
932,19792,gmI36QrP5V0XjdeY5fw2LtMzPgNNn1eX,fbPkOYLVPtPgIt0MxizjfFJov3JbHyAi,12,10,5,5,6,0,2,0,28,4.0,1,0.0,2,5,4,6,8,0,1,2,0,17,11,1
933,19796,szY7iRYrnZrzBCwm4obBzatvtWaWEKSz,fbPkOYLVPtPgIt0MxizjfFJov3JbHyAi,13,16,10,13,9,0,1,0,49,7.0,1,0.0,5,10,9,9,11,0,4,1,0,33,16,1
934,19797,kV0etVT4eF07a55Y2wFFrCm2NuKlfy3O,fbPkOYLVPtPgIt0MxizjfFJov3JbHyAi,11,14,7,0,4,0,4,1,30,4.285714285714286,2,0.0,0,7,0,4,14,0,0,4,1,11,19,1
935,19801,eRM1cqDGfrej4Riud5wVHQPpEv2yAjcd,fbPkOYLVPtPgIt0MxizjfFJov3JbHyAi,11,6,4,0,4,0,3,0,17,2.4285714285714284,2,0.0,0,4,0,4,6,0,0,3,0,8,9,1
936,19802,JOTZzIfdhlRRSJT88VvraViqFb0FOnua,fbPkOYLVPtPgIt0MxizjfFJov3JbHyAi,9,8,5,0,1,0,7,0,21,3.0,2,0.0,0,5,0,1,8,0,0,7,0,6,15,1
937,19830,J19fRobYymSKSws9Yoy23YPes8L6wyrW,fbPkOYLVPtPgIt0MxizjfFJov3JbHyAi,5,2,1,0,1,0,3,0,7,1.0,1,0.0,0,1,0,1,2,0,0,3,0,2,5,1
938,19856,cNw6DSimidnnJTy63mT8fC6ow4HuQb5s,fbPkOYLVPtPgIt0MxizjfFJov3JbHyAi,37,59,43,22,19,33,11,1,188,26.857142857142858,2,0.0,12,43,19,19,47,33,3,11,1,93,95,0
939,19864,xpAxjSreQEJGjM28FJsQcyiEt1VA8RXl,fbPkOYLVPtPgIt0MxizjfFJov3JbHyAi,23,52,22,27,6,3,10,0,120,17.142857142857142,5,0.0,7,22,26,6,45,3,1,10,0,61,59,0
940,19880,7cdSr9CqRrEGZIWG84xbV4x3Kafz72lh,fbPkOYLVPtPgIt0MxizjfFJov3JbHyAi,15,15,6,10,9,1,4,1,46,6.571428571428571,1,0.0,9,6,8,9,6,1,2,4,1,32,14,1
941,19883,oBB4V7EIN8ossAzWm6ldlqIytEJdobH7,fbPkOYLVPtPgIt0MxizjfFJov3JbHyAi,12,14,7,0,4,41,9,3,78,11.142857142857142,2,0.0,4,7,0,4,10,41,0,9,3,15,63,1
942,19890,IVtvtdZLBtL9DhFAioWkcCx38OrFXpXg,fbPkOYLVPtPgIt0MxizjfFJov3JbHyAi,27,70,30,26,0,16,24,1,167,23.857142857142858,5,0.0,27,30,25,0,43,16,1,24,1,82,85,0
943,19902,WaEPHAZo5pH7Npa5iwnKZ2EJATuLkfKt,fbPkOYLVPtPgIt0MxizjfFJov3JbHyAi,10,10,1,0,1,0,4,0,16,2.2857142857142856,1,0.0,1,1,0,1,9,0,0,4,0,3,13,1
944,19913,XbORnKU4LaOdLNHafCieVF22rPhRdsHM,fbPkOYLVPtPgIt0MxizjfFJov3JbHyAi,1,0,0,0,0,0,1,0,1,0.14285714285714285,1,0.0,0,0,0,0,0,0,0,1,0,0,1,1
945,21469,5oy5I8Xh5KkzBBzgBTkYXJ5uADqnzeVC,7GRhBDsirIGkRZBtSMEzNTyDr2JQm4xx,36,99,27,67,20,14,3,0,230,32.857142857142854,3,0.0,39,27,55,20,60,14,12,3,0,141,89,0
946,21478,43nq30xhRsgmZVAWkH8Zjb7IyZDGRDeY,7GRhBDsirIGkRZBtSMEzNTyDr2JQm4xx,41,97,25,78,24,53,10,0,287,41.0,4,0.0,64,25,68,24,33,53,10,10,0,181,106,0
947,21499,L74tKRZpBi1qsh0NM3EwE5D87acCLK8s,7GRhBDsirIGkRZBtSMEzNTyDr2JQm4xx,10,10,6,10,0,0,5,0,31,4.428571428571429,2,0.0,0,6,9,0,10,0,1,5,0,15,16,0
948,21503,PUFh3BsQaDVIJMDvwsFTqkrgAzvjO9ME,7GRhBDsirIGkRZBtSMEzNTyDr2JQm4xx,6,2,1,0,1,0,4,0,8,1.1428571428571428,1,0.0,0,1,0,1,2,0,0,4,0,2,6,1
949,21832,W5CVKONt5qsYlbCwSDDjPmuQMWPx8PFD,7GRhBDsirIGkRZBtSMEzNTyDr2JQm4xx,10,7,2,0,2,0,4,0,15,2.142857142857143,1,0.0,0,2,0,2,7,0,0,4,0,4,11,0
950,22007,eovSKdG09ZHYTXNtS1zUIy1RfsRsCibs,7GRhBDsirIGkRZBtSMEzNTyDr2JQm4xx,44,293,93,115,50,901,79,4,1535,219.28571428571428,4,0.0,170,93,90,50,123,901,25,79,4,403,1132,0
951,22148,IA6nFLwiYdBOXKobyV12AjVhFzxFaVpR,7GRhBDsirIGkRZBtSMEzNTyDr2JQm4xx,25,22,10,25,6,0,6,0,69,9.857142857142858,2,0.0,9,10,24,6,13,0,1,6,0,49,20,1
952,22649,kpDqfPKqqQYJmKMTzN1Sox48V4ZPJuXL,SpATywNh6bZuzm8s1ceuBUnMUAeoAHHw,11,14,6,12,2,0,2,0,36,5.142857142857143,2,0.0,6,6,9,2,8,0,3,2,0,23,13,1
953,22660,nwlJxZtiMdof1orslmN8VJv3ydVnbeg5,RXDvfPUBYFlVdlueBFbLW0mhhAyGEqpt,5,4,2,0,2,0,1,0,9,1.2857142857142858,1,0.0,0,2,0,2,4,0,0,1,0,4,5,1
954,22676,CMoV5dPTzwxV3W6HJJmvW8wSnp90ZPh2,SpATywNh6bZuzm8s1ceuBUnMUAeoAHHw,14,11,9,0,5,0,3,0,28,4.0,2,0.0,0,9,0,5,11,0,0,3,0,14,14,0
955,22715,3cB0rEpxJxC0jjqfQ9EPT6ntxFajOXrx,SpATywNh6bZuzm8s1ceuBUnMUAeoAHHw,14,31,16,10,5,0,2,0,64,9.142857142857142,2,0.0,14,16,10,5,17,0,0,2,0,45,19,0
956,22724,GXmYCsHMMMsjIL2A9DYKMEw8AEscVD5s,A3fsA9Zfv1X2fVEQhTw51lKENdNrEqT3,25,26,17,32,7,3,15,3,103,14.714285714285714,3,0.0,2,17,26,7,24,3,6,15,3,52,51,0
957,22738,83J9IXuPcwdDBJoFENdSQFWzvgELVzeu,G8EPVSXsOYB5YQWZGiz1aVq5Pgr2GrQu,7,12,6,0,1,3,5,0,27,3.857142857142857,1,0.0,0,6,0,1,12,3,0,5,0,7,20,1
958,22741,ooFElJ4ZPOLTBMQwigtvKfnHk0DNrR2R,SpATywNh6bZuzm8s1ceuBUnMUAeoAHHw,1,0,0,0,0,0,1,0,1,0.14285714285714285,1,0.0,0,0,0,0,0,0,0,1,0,0,1,1
959,22744,D2ho5VQQzNWAcdswkNScRjqQiNPjKhpn,A3fsA9Zfv1X2fVEQhTw51lKENdNrEqT3,11,12,1,0,1,0,15,0,29,4.142857142857143,1,0.0,0,1,0,1,12,0,0,15,0,2,27,1
960,22747,5GeMwmyzCXMcMYfcWdKaXbpNNdL8bmPq,A3fsA9Zfv1X2fVEQhTw51lKENdNrEqT3,4,2,1,0,0,0,2,0,5,0.7142857142857143,1,0.0,0,1,0,0,2,0,0,2,0,1,4,1
961,22757,LJYBef7iIBiSZz8D7KTtMTsdkyd91gnR,SpATywNh6bZuzm8s1ceuBUnMUAeoAHHw,4,2,1,0,0,0,2,0,5,0.7142857142857143,1,0.0,0,1,0,0,2,0,0,2,0,1,4,0
962,22762,MCJiDMInWw8URpDdqHAwEp0pExHWdLRC,SpATywNh6bZuzm8s1ceuBUnMUAeoAHHw,4,2,1,0,1,0,1,0,5,0.7142857142857143,1,0.0,0,1,0,1,2,0,0,1,0,2,3,1
963,22766,BImVQpNaWI5ZZjLENiRV2V2LYkbW88m0,RXDvfPUBYFlVdlueBFbLW0mhhAyGEqpt,5,4,2,0,0,0,1,0,7,1.0,1,0.0,0,2,0,0,4,0,0,1,0,2,5,0
964,22776,jaMKMvlU4KDCkm4HrM0MWVH43rDA8rY1,A3fsA9Zfv1X2fVEQhTw51lKENdNrEqT3,17,11,8,0,6,0,6,1,32,4.571428571428571,3,0.0,0,8,0,6,11,0,0,6,1,14,18,1
965,22777,jpXIq3stqWScWG27acYJbNKpdTmc6kli,A3fsA9Zfv1X2fVEQhTw51lKENdNrEqT3,49,51,41,50,29,12,10,0,193,27.571428571428573,3,0.0,3,41,44,29,48,12,6,10,0,117,76,1
966,22787,XCY83tv4aCv2fMTPmH1QE6tZOtr7KzJT,G8EPVSXsOYB5YQWZGiz1aVq5Pgr2GrQu,64,79,19,122,14,35,20,1,290,41.42857142857143,3,0.0,29,19,99,14,50,35,23,20,1,161,129,0
967,22800,xiHLAVx1lOeJhtdb9rNdxGApg3TIwPUZ,SpATywNh6bZuzm8s1ceuBUnMUAeoAHHw,10,12,1,6,0,0,2,0,21,3.0,2,0.0,3,1,5,0,9,0,1,2,0,9,12,1
968,22814,zyIWmJjaz36PnMZpAzR2HEZCUbJWe8iQ,A3fsA9Zfv1X2fVEQhTw51lKENdNrEqT3,5,2,1,0,1,0,2,0,6,0.8571428571428571,1,0.0,0,1,0,1,2,0,0,2,0,2,4,1
969,22859,JJDRXXLRU75H8Dx2cuK7Td1V7D7QoKg9,RXDvfPUBYFlVdlueBFbLW0mhhAyGEqpt,32,46,0,46,2,10,18,5,127,18.142857142857142,2,0.0,13,0,36,2,33,10,10,18,5,51,76,0
970,22876,yZi2eaDxP9Hsc5TkKYLN2LUYSBmbQGTr,SpATywNh6bZuzm8s1ceuBUnMUAeoAHHw,16,11,6,12,4,0,2,0,35,5.0,1,0.0,4,6,9,4,7,0,3,2,0,23,12,0
971,22877,qjNUBrpwN8flYc0VorTlQJNEWSbIR2KA,A3fsA9Zfv1X2fVEQhTw51lKENdNrEqT3,28,17,0,89,0,3,3,0,112,16.0,1,0.0,3,0,77,0,14,3,12,3,0,80,32,1
972,22880,ti1hbICHLqROy8Y7XhKRxGlLqF2ITiDH,RXDvfPUBYFlVdlueBFbLW0mhhAyGEqpt,21,16,7,23,4,0,6,0,56,8.0,3,0.0,4,7,23,4,12,0,0,6,0,38,18,0
973,22898,t2LtqHppiTuDN14mSCfUVu9qYG7mBNAD,A3fsA9Zfv1X2fVEQhTw51lKENdNrEqT3,70,43,24,180,14,6,8,0,275,39.285714285714285,2,0.0,5,24,157,14,38,6,23,8,0,200,75,0
974,22899,AoDbGxsdtQ88iavwLYzXC5a1sZ4YMkt5,SpATywNh6bZuzm8s1ceuBUnMUAeoAHHw,9,9,7,0,4,0,1,0,21,3.0,1,0.0,0,7,0,4,9,0,0,1,0,11,10,1
975,22905,i17yw0GYsvz8XFpq0Y9RtdPoiYFDGh9w,bWdj2GDclj5ofokWjzoa5jAwMkxCykd6,1,0,0,0,0,0,1,0,1,0.14285714285714285,1,0.0,0,0,0,0,0,0,0,1,0,0,1,1
976,22906,CLsYy7g1hYWHJyj1aROfKK9oTeo5yxJx,A3fsA9Zfv1X2fVEQhTw51lKENdNrEqT3,58,26,21,66,17,2,11,1,144,20.571428571428573,2,0.0,1,21,60,17,25,2,6,11,1,99,45,1
977,22911,i17yw0GYsvz8XFpq0Y9RtdPoiYFDGh9w,A3fsA9Zfv1X2fVEQhTw51lKENdNrEqT3,1,0,0,0,0,0,1,0,1,0.14285714285714285,1,0.0,0,0,0,0,0,0,0,1,0,0,1,1
978,22915,dLoTMfurIDgppPqjn68MhR8oLIGjxbCC,bWdj2GDclj5ofokWjzoa5jAwMkxCykd6,17,33,15,42,6,17,6,0,119,17.0,3,0.0,5,15,37,6,28,17,5,6,0,63,56,1
979,22924,SY3KixRowLNTROWYYZsbpxNmhMe23Wc3,SpATywNh6bZuzm8s1ceuBUnMUAeoAHHw,5,4,0,0,1,0,2,0,7,1.0,2,0.0,0,0,0,1,4,0,0,2,0,1,6,1
980,22934,I4EJkH4zClhTB2lKNgq7Q2fKtUYoVDSA,A3fsA9Zfv1X2fVEQhTw51lKENdNrEqT3,5,6,2,0,0,0,3,0,11,1.5714285714285714,1,0.0,0,2,0,0,6,0,0,3,0,2,9,1
981,22937,7mQeRnk4E67KJHDHSAp1BOWEWVuxMvA2,SpATywNh6bZuzm8s1ceuBUnMUAeoAHHw,29,45,18,44,12,2,8,1,130,18.571428571428573,1,0.0,10,18,42,12,35,2,2,8,1,82,48,1
982,22976,cVHCYdG6eoXKQe55dLZbvLgwBGbWam7p,RXDvfPUBYFlVdlueBFbLW0mhhAyGEqpt,1,0,0,0,0,0,1,0,1,0.14285714285714285,1,0.0,0,0,0,0,0,0,0,1,0,0,1,1
983,22985,Dkp4ht4oz2wUhu9UvNTwrqC02rtqcSZH,SpATywNh6bZuzm8s1ceuBUnMUAeoAHHw,4,2,1,0,0,0,3,0,6,0.8571428571428571,1,0.0,0,1,0,0,2,0,0,3,0,1,5,1
984,22998,nCARlKCtX8cCYdg9wv53tMq1HV8fOfAB,RXDvfPUBYFlVdlueBFbLW0mhhAyGEqpt,7,17,3,0,1,0,0,0,21,3.0,3,0.0,0,3,0,1,17,0,0,0,0,4,17,1
985,22999,cbxqNQUcwI376TUiYgRRo2dXuIaImWoc,SpATywNh6bZuzm8s1ceuBUnMUAeoAHHw,26,50,32,2,15,1,25,2,127,18.142857142857142,2,0.0,7,32,2,15,43,1,0,25,2,56,71,1
986,23011,Qi3PLuC7w2Yo9hFgq37MObjY8icnRdc6,A3fsA9Zfv1X2fVEQhTw51lKENdNrEqT3,31,28,13,86,5,0,6,0,138,19.714285714285715,3,0.0,4,13,68,5,24,0,18,6,0,90,48,0
987,23016,jZn0klM9Bk084k9gvux7E5DK1oO1FwuJ,SpATywNh6bZuzm8s1ceuBUnMUAeoAHHw,12,12,9,7,4,0,3,0,35,5.0,2,0.0,0,9,6,4,12,0,1,3,0,19,16,0
988,23032,UInMBEH8f1h2vxXVslRsWyLOTv8ggYq3,RXDvfPUBYFlVdlueBFbLW0mhhAyGEqpt,15,20,8,0,5,5,4,0,42,6.0,3,0.0,0,8,0,5,20,5,0,4,0,13,29,0
989,23035,e09uq36QgLuBVK5DERoejsHeMH2uPMRM,SpATywNh6bZuzm8s1ceuBUnMUAeoAHHw,1,0,0,0,0,0,1,0,1,0.14285714285714285,1,0.0,0,0,0,0,0,0,0,1,0,0,1,1
990,23038,0DzldTHKdoH90kklIAjpWyAEe6XDDjyM,SpATywNh6bZuzm8s1ceuBUnMUAeoAHHw,14,54,15,16,0,5,19,0,109,15.571428571428571,6,0.0,15,15,14,0,39,5,2,19,0,44,65,0
991,23041,TJxPKDYS9NmvmYGlrCikboEkhHDTOEHy,SpATywNh6bZuzm8s1ceuBUnMUAeoAHHw,8,15,7,0,1,0,6,0,29,4.142857142857143,1,0.0,5,7,0,1,10,0,0,6,0,13,16,0
992,23070,XHWdewLJ6o4Ir5vIcSMNfq1s8TFbjZbE,bWdj2GDclj5ofokWjzoa5jAwMkxCykd6,19,58,22,178,14,33,18,1,324,46.285714285714285,2,0.0,22,22,173,14,36,33,5,18,1,231,93,1
993,23072,Pb0Dj6dRtTGmcuNxvaHjmGw0iPTyjSsN,bWdj2GDclj5ofokWjzoa5jAwMkxCykd6,6,3,2,0,1,0,3,0,9,1.2857142857142858,1,0.0,0,2,0,1,3,0,0,3,0,3,6,1
994,23075,CUMuKIhvWkMSk50Or6FhgPf1tk7jntYp,SpATywNh6bZuzm8s1ceuBUnMUAeoAHHw,14,17,8,14,0,0,6,0,45,6.428571428571429,3,0.0,4,8,14,0,13,0,0,6,0,26,19,0
995,23097,5wbqpjsRycE3Ij1gukLWuLp8it7vr80U,SpATywNh6bZuzm8s1ceuBUnMUAeoAHHw,17,46,28,8,1,197,25,2,307,43.857142857142854,5,0.0,5,28,8,1,41,197,0,25,2,42,265,1
996,23113,Xcdjjhyr6mdJr4bRWqVyHg8s2pWIVQGq,SpATywNh6bZuzm8s1ceuBUnMUAeoAHHw,27,44,5,30,3,11,11,4,108,15.428571428571429,3,0.0,11,5,28,3,33,11,2,11,4,47,61,1
997,23121,9S5uoFAiVHVF4D2DNR23wCkbQZ8LhtES,SpATywNh6bZuzm8s1ceuBUnMUAeoAHHw,10,11,2,8,0,0,4,0,25,3.5714285714285716,3,0.0,2,2,7,0,9,0,1,4,0,11,14,0
998,23123,rq9XJ5UGjNC0AliEbyfxvu7XJPaoSOc4,A3fsA9Zfv1X2fVEQhTw51lKENdNrEqT3,2,0,0,0,0,0,4,0,4,0.5714285714285714,1,0.0,0,0,0,0,0,0,0,4,0,0,4,1
999,23131,hGDnsprgLmlBuNCzDAhbMdsa7xgZW8Z4,bWdj2GDclj5ofokWjzoa5jAwMkxCykd6,20,20,6,18,8,0,14,0,66,9.428571428571429,1,0.0,5,6,16,8,15,0,2,14,0,35,31,1
1000,23142,6j5Aoj3JOkcTRkyfXNVtTy229CS4uihi,G8EPVSXsOYB5YQWZGiz1aVq5Pgr2GrQu,46,82,39,33,33,0,7,0,194,27.714285714285715,6,0.0,6,39,30,33,76,0,3,7,0,108,86,0
1001,23166,4eKGhI4OMlwHB0DLaezQlJp1reuJgarH,SpATywNh6bZuzm8s1ceuBUnMUAeoAHHw,1,0,0,0,0,0,1,0,1,0.14285714285714285,1,0.0,0,0,0,0,0,0,0,1,0,0,1,1
1002,23183,HycevJIm7cBjf1oJ5QCBMMXEBTG8jyRF,A3fsA9Zfv1X2fVEQhTw51lKENdNrEqT3,48,26,14,78,1,0,6,0,125,17.857142857142858,2,0.0,7,14,77,1,19,0,1,6,0,99,26,0
1003,23185,HycevJIm7cBjf1oJ5QCBMMXEBTG8jyRF,bWdj2GDclj5ofokWjzoa5jAwMkxCykd6,12,23,17,0,2,0,9,0,51,7.285714285714286,3,0.0,3,17,0,2,20,0,0,9,0,22,29,0
1004,23197,BDdKHYPp1edgylVPYUBHaWJ6W3VobGdR,SpATywNh6bZuzm8s1ceuBUnMUAeoAHHw,19,38,18,16,7,0,3,0,82,11.714285714285714,2,0.0,17,18,14,7,21,0,2,3,0,56,26,1
1005,23201,mE5coXp72CvzVrqwpPF6wLVZrHDH0Vlq,SpATywNh6bZuzm8s1ceuBUnMUAeoAHHw,18,39,16,0,9,0,6,1,71,10.142857142857142,6,0.0,2,16,0,9,37,0,0,6,1,27,44,0
1006,23206,ieR2oDuOBOWrOSx08B7vLKsdvt41Kjgw,bWdj2GDclj5ofokWjzoa5jAwMkxCykd6,5,4,1,0,1,0,1,0,7,1.0,1,0.0,1,1,0,1,3,0,0,1,0,3,4,1
1007,23234,BDdKHYPp1edgylVPYUBHaWJ6W3VobGdR,A3fsA9Zfv1X2fVEQhTw51lKENdNrEqT3,5,2,1,0,1,0,2,0,6,0.8571428571428571,1,0.0,0,1,0,1,2,0,0,2,0,2,4,1
1008,23251,bzY7Zh4yWh2gGtmeq5pe4zgMiusHTGEG,SpATywNh6bZuzm8s1ceuBUnMUAeoAHHw,25,80,2,49,1,2,26,1,161,23.0,2,0.0,38,2,41,1,42,2,8,26,1,82,79,0
1009,23299,FuoDsqlUs6ZIyTkMTIVnWx4xFWKln8DR,SpATywNh6bZuzm8s1ceuBUnMUAeoAHHw,5,3,2,0,1,0,1,0,7,1.0,1,0.0,0,2,0,1,3,0,0,1,0,3,4,0
1010,23316,QdSH85e6TVvHCb4lCpuXbYzwkD8QbL3t,G8EPVSXsOYB5YQWZGiz1aVq5Pgr2GrQu,28,35,20,0,16,0,4,0,75,10.714285714285714,1,0.0,0,20,0,16,35,0,0,4,0,36,39,0
1011,23322,w2sKd0cOObBRKhbutYISAGM6GUL3hKiJ,A3fsA9Zfv1X2fVEQhTw51lKENdNrEqT3,1,0,0,0,0,0,1,0,1,0.14285714285714285,1,0.0,0,0,0,0,0,0,0,1,0,0,1,1
1012,23324,RPoX07eqJOUgad0B2fv5ckLas5jasaoP,SpATywNh6bZuzm8s1ceuBUnMUAeoAHHw,17,31,9,35,0,1,8,1,85,12.142857142857142,2,0.0,13,9,33,0,18,1,2,8,1,55,30,1
1013,23329,v8AEmfj5ScfNiqWSiB9twce4e05jQ9FQ,SpATywNh6bZuzm8s1ceuBUnMUAeoAHHw,12,32,2,22,1,0,2,0,59,8.428571428571429,2,0.0,23,2,19,1,9,0,3,2,0,45,14,1
1014,23332,V1z8w9SjLbULVqlANveH3qv7vwfEbAs7,A3fsA9Zfv1X2fVEQhTw51lKENdNrEqT3,29,13,7,78,1,2,17,2,120,17.142857142857142,3,0.0,1,7,67,1,12,2,11,17,2,76,44,0
1015,23382,JMglfzDzzLZlgpswShgX51nDQKwTuVTV,A3fsA9Zfv1X2fVEQhTw51lKENdNrEqT3,1,0,0,0,0,0,1,0,1,0.14285714285714285,1,0.0,0,0,0,0,0,0,0,1,0,0,1,1
1016,23385,YA61oYIgn1IPmbXidnuJfNVCdVlD8MoO,SpATywNh6bZuzm8s1ceuBUnMUAeoAHHw,15,12,0,14,0,0,3,0,29,4.142857142857143,1,0.0,1,0,12,0,11,0,2,3,0,13,16,1
1017,23387,BQkLFspAkEwZRgeuoSbQxFTr6POAaRzP,RXDvfPUBYFlVdlueBFbLW0mhhAyGEqpt,1,0,0,0,0,0,1,0,1,0.14285714285714285,1,0.0,0,0,0,0,0,0,0,1,0,0,1,1
1018,23391,X8qfNjsHrwR5R67KkU9t7FXc6jQSGsyo,bWdj2GDclj5ofokWjzoa5jAwMkxCykd6,4,2,1,0,0,0,2,0,5,0.7142857142857143,1,0.0,0,1,0,0,2,0,0,2,0,1,4,1
1019,23401,xMuijSepoYpWnTVSuzhdordHJTyRt87I,SpATywNh6bZuzm8s1ceuBUnMUAeoAHHw,28,56,22,35,4,100,24,1,242,34.57142857142857,4,0.0,16,22,31,4,40,100,4,24,1,73,169,1
1020,23403,GWG8afsUfRei9CIZYg1Y2sBsF64D5J9k,A3fsA9Zfv1X2fVEQhTw51lKENdNrEqT3,55,21,12,140,6,0,5,0,184,26.285714285714285,4,0.0,3,12,118,6,18,0,22,5,0,139,45,0
1021,23408,3rgatvueGycmzmQ7x6De7keieQ0tMDvZ,A3fsA9Zfv1X2fVEQhTw51lKENdNrEqT3,43,42,20,50,18,14,8,1,153,21.857142857142858,2,0.0,1,20,45,18,41,14,5,8,1,84,69,1
1022,23410,yGTKMCuyZTpBDN6edeGIEf8UqO2mMowi,SpATywNh6bZuzm8s1ceuBUnMUAeoAHHw,9,5,4,0,3,0,1,0,13,1.8571428571428572,1,0.0,0,4,0,3,5,0,0,1,0,7,6,1
1023,23425,rWIeDjJz93lBgbp2QkVHj8gv55De3Px0,G8EPVSXsOYB5YQWZGiz1aVq5Pgr2GrQu,58,59,27,62,16,2,12,4,182,26.0,3,0.0,17,27,44,16,42,2,18,12,4,104,78,1
1024,23443,2XRKCevyRsuXIpuLiEj19nm5B7ajsjxd,SpATywNh6bZuzm8s1ceuBUnMUAeoAHHw,7,5,3,2,1,0,1,0,12,1.7142857142857142,1,0.0,1,3,2,1,4,0,0,1,0,7,5,1
1025,23454,mP7U4YN4Z2p45M3a970DvaALst8JAKLF,SpATywNh6bZuzm8s1ceuBUnMUAeoAHHw,19,39,0,32,0,0,10,0,81,11.571428571428571,1,0.0,25,0,28,0,14,0,4,10,0,53,28,1
1026,23458,cAyxesGtWW4tBzueSc3JcCfBcF1iSxzo,SpATywNh6bZuzm8s1ceuBUnMUAeoAHHw,28,50,23,40,13,0,6,0,132,18.857142857142858,2,0.0,20,23,33,13,30,0,7,6,0,89,43,0
1027,23469,OTkfNwsIOtoJh2hERixG2jmKnV6iaybJ,SpATywNh6bZuzm8s1ceuBUnMUAeoAHHw,1,0,0,0,0,0,1,0,1,0.14285714285714285,1,0.0,0,0,0,0,0,0,0,1,0,0,1,1
1028,23485,oAqokxwZETOc0FlXbPrJtKYU20wkk4k3,SpATywNh6bZuzm8s1ceuBUnMUAeoAHHw,16,10,6,0,6,0,2,0,24,3.4285714285714284,1,0.0,0,6,0,6,10,0,0,2,0,12,12,1
1029,23496,lbe9cMTwmlycpcYHc5ZN07ZsGdA6t7WW,SpATywNh6bZuzm8s1ceuBUnMUAeoAHHw,9,9,1,0,0,1,6,1,18,2.5714285714285716,1,0.0,2,1,0,0,7,1,0,6,1,3,15,1
1030,23502,wNbKFPX6oYsfVEr8buyWthBblPuPZGxv,A3fsA9Zfv1X2fVEQhTw51lKENdNrEqT3,68,20,15,116,12,16,8,1,188,26.857142857142858,1,0.0,4,15,101,12,16,16,15,8,1,132,56,0
1031,23521,sNkOLwlXc0EK57Dlcru7W9TUcu8lkNDn,bWdj2GDclj5ofokWjzoa5jAwMkxCykd6,16,17,11,0,7,0,6,0,41,5.857142857142857,1,0.0,1,11,0,7,16,0,0,6,0,19,22,1
1032,23523,DsdEYwXt7PO92K8VROCVVtUqrprzaIo4,RXDvfPUBYFlVdlueBFbLW0mhhAyGEqpt,18,48,0,0,0,19,7,1,75,10.714285714285714,2,0.0,0,0,0,0,48,19,0,7,1,0,75,1
1033,23526,xC7QA3lJWLoIMEwPvqIxcLnCt0KwsxwT,G8EPVSXsOYB5YQWZGiz1aVq5Pgr2GrQu,89,94,40,263,30,4,12,1,444,63.42857142857143,4,0.0,42,40,224,30,52,4,39,12,1,336,108,1
1034,23530,CfoeUJ6vk7a3PuEp1yrQNFUplkLjQYge,SpATywNh6bZuzm8s1ceuBUnMUAeoAHHw,18,44,18,20,9,0,2,0,93,13.285714285714286,2,0.0,22,18,17,9,22,0,3,2,0,66,27,0
1035,23541,ACrAvl4ssWNFndB2wDhI3oY0Vqi5B1FR,SpATywNh6bZuzm8s1ceuBUnMUAeoAHHw,27,29,14,24,7,6,14,0,94,13.428571428571429,4,0.0,12,14,23,7,17,6,1,14,0,56,38,0
1036,23550,7yphMCe2LQupOHSaDA3UQC9kbDeEuBie,SpATywNh6bZuzm8s1ceuBUnMUAeoAHHw,5,3,2,0,2,0,2,0,9,1.2857142857142858,1,0.0,0,2,0,2,3,0,0,2,0,4,5,0
1037,23557,M6VmJD8JYDR5w6GV5uzAgWpIXM5eanml,SpATywNh6bZuzm8s1ceuBUnMUAeoAHHw,15,10,6,12,5,0,1,0,34,4.857142857142857,1,0.0,2,6,10,5,8,0,2,1,0,23,11,0
1038,23574,N8e8TX5f8OfPjOu3ngCuXkApyUMeZAHw,A3fsA9Zfv1X2fVEQhTw51lKENdNrEqT3,6,2,1,0,1,0,4,1,9,1.2857142857142858,1,0.0,0,1,0,1,2,0,0,4,1,2,7,1
1039,23576,mRXmcsJQnNw2mccUFVukDwZxk7roAYf4,SpATywNh6bZuzm8s1ceuBUnMUAeoAHHw,6,10,6,0,0,0,2,0,18,2.5714285714285716,2,0.0,0,6,0,0,10,0,0,2,0,6,12,1
1040,23589,mptZxS2IRXAopBdChMP75EgVt5rtRsUT,SpATywNh6bZuzm8s1ceuBUnMUAeoAHHw,15,16,11,0,5,0,6,0,38,5.428571428571429,4,0.0,0,11,0,5,16,0,0,6,0,16,22,1
1041,23601,jKWIhuXmlYFBIapfd4E50TBTHed3oveP,A3fsA9Zfv1X2fVEQhTw51lKENdNrEqT3,1,0,0,0,0,0,1,0,1,0.14285714285714285,1,0.0,0,0,0,0,0,0,0,1,0,0,1,1
1042,23616,VADc1m6JjTG2LuLkbhEfhADWJMHaDmqK,SpATywNh6bZuzm8s1ceuBUnMUAeoAHHw,4,7,7,0,0,0,0,0,14,2.0,4,0.0,0,7,0,0,7,0,0,0,0,7,7,0
1043,23621,HRaTe8gWBsDiLkzfbQMnooVDWfwWVb7m,SpATywNh6bZuzm8s1ceuBUnMUAeoAHHw,16,38,4,19,1,0,10,0,72,10.285714285714286,3,0.0,9,4,16,1,29,0,3,10,0,30,42,0
1044,23629,1GEou0jUAwSZvf4K9js5E10dDnbmQpAC,bWdj2GDclj5ofokWjzoa5jAwMkxCykd6,15,12,8,0,4,0,5,0,29,4.142857142857143,2,0.0,0,8,0,4,12,0,0,5,0,12,17,1
1045,23634,hs0BkyfSJv3crs4cIvcxkt53zip5FMPg,SpATywNh6bZuzm8s1ceuBUnMUAeoAHHw,1,0,0,0,0,0,1,0,1,0.14285714285714285,1,0.0,0,0,0,0,0,0,0,1,0,0,1,1
1046,23642,04gG5zVwZ7Vr68t1LtjimV9KPqGTDxDK,SpATywNh6bZuzm8s1ceuBUnMUAeoAHHw,6,6,2,0,1,0,2,0,11,1.5714285714285714,2,0.0,0,2,0,1,6,0,0,2,0,3,8,0
1047,23651,35E85h2ExBPeTd1VmxNX0GKo8krIMsCP,RXDvfPUBYFlVdlueBFbLW0mhhAyGEqpt,5,3,2,0,1,0,2,0,8,1.1428571428571428,2,0.0,0,2,0,1,3,0,0,2,0,3,5,1
1048,23657,xM0eQ8CWGY7oZgCPJhirOkGhAfAvdQUi,SpATywNh6bZuzm8s1ceuBUnMUAeoAHHw,5,3,2,0,1,0,1,0,7,1.0,1,0.0,0,2,0,1,3,0,0,1,0,3,4,1
1049,23667,1NMKv7RE12uBMKwNJI30Cx8Z5ltMGoee,SpATywNh6bZuzm8s1ceuBUnMUAeoAHHw,22,25,16,8,10,0,3,0,62,8.857142857142858,2,0.0,6,16,8,10,19,0,0,3,0,40,22,0
1050,23672,F9d8ehlFxvqouYiZgUKxdbX5NI44Sbpl,SpATywNh6bZuzm8s1ceuBUnMUAeoAHHw,16,23,11,22,3,11,5,0,75,10.714285714285714,1,0.0,6,11,19,3,17,11,3,5,0,39,36,1
1051,23682,iSZJZtUn8nc9fyool89gRRN7Cq78oUfm,SpATywNh6bZuzm8s1ceuBUnMUAeoAHHw,25,17,9,21,7,0,2,0,56,8.0,1,0.0,7,9,20,7,10,0,1,2,0,43,13,0
1052,23694,PjedxGW8p1bztGxVlzTokusg6LFto1Md,bWdj2GDclj5ofokWjzoa5jAwMkxCykd6,1,0,0,0,0,0,1,0,1,0.14285714285714285,1,0.0,0,0,0,0,0,0,0,1,0,0,1,1
1053,23699,jM1yIagOMV2CwD8o07UMrVdo7z0hqKJ4,bWdj2GDclj5ofokWjzoa5jAwMkxCykd6,6,6,3,0,1,0,1,0,11,1.5714285714285714,1,0.0,1,3,0,1,5,0,0,1,0,5,6,0
1054,23720,zJDljX1Y3FrDgAuEWJGqwBvE3KAWJPAz,A3fsA9Zfv1X2fVEQhTw51lKENdNrEqT3,6,1,1,0,1,0,5,0,8,1.1428571428571428,1,0.0,0,1,0,1,1,0,0,5,0,2,6,1
1055,23724,wQU3lY7mCoAWFqnxNLhiEFrdAWtS5Hh9,SpATywNh6bZuzm8s1ceuBUnMUAeoAHHw,15,14,8,4,4,0,3,0,33,4.714285714285714,1,0.0,0,8,4,4,14,0,0,3,0,16,17,0
1056,23747,x3sZblYMoUvQJbk7l9GY688n7RQqaQct,A3fsA9Zfv1X2fVEQhTw51lKENdNrEqT3,9,8,1,0,1,0,1,0,11,1.5714285714285714,1,0.0,0,1,0,1,8,0,0,1,0,2,9,1
1057,23751,zvOHbaUWjxRZ9zCYxYPMcUH4Ef5dE8Ae,RXDvfPUBYFlVdlueBFbLW0mhhAyGEqpt,7,8,0,0,0,0,4,0,12,1.7142857142857142,1,0.0,0,0,0,0,8,0,0,4,0,0,12,1
1058,23772,bQK35cKsW9Hy5fNgckzz4Jo7bFzQOyma,G8EPVSXsOYB5YQWZGiz1aVq5Pgr2GrQu,34,54,26,52,13,8,14,4,171,24.428571428571427,1,0.0,24,26,41,13,30,8,11,14,4,104,67,0
1059,23776,JoruyAOmEeM1qjcSEWRUjLvQUHpNPZGp,SpATywNh6bZuzm8s1ceuBUnMUAeoAHHw,3,2,0,0,0,0,2,0,4,0.5714285714285714,1,0.0,0,0,0,0,2,0,0,2,0,0,4,1
1060,23787,ct5yYqhcbduN7OPtxPDjwHer2K46eeEH,bWdj2GDclj5ofokWjzoa5jAwMkxCykd6,8,7,1,0,2,0,4,0,14,2.0,1,0.0,2,1,0,2,5,0,0,4,0,5,9,1
1061,23811,kj5o7wMZl1s4q0cggcmipnm7O7L6g4Ps,SpATywNh6bZuzm8s1ceuBUnMUAeoAHHw,32,29,15,30,7,3,13,1,98,14.0,3,0.0,8,15,27,7,21,3,3,13,1,57,41,1
1062,23818,oAs7swdosdDbKq3u64wlCP6EHVlCh67P,bWdj2GDclj5ofokWjzoa5jAwMkxCykd6,8,18,9,0,6,0,5,0,38,5.428571428571429,2,0.0,0,9,0,6,18,0,0,5,0,15,23,1
1063,23839,xHZbSROhwP4RRQerUVWvcNTfOGc2DHWf,bWdj2GDclj5ofokWjzoa5jAwMkxCykd6,4,7,3,0,0,0,4,0,14,2.0,4,0.0,0,3,0,0,7,0,0,4,0,3,11,0
1064,23845,TSxGfcluByCTxwgFYbniUiwGZJ5ZTUOD,RXDvfPUBYFlVdlueBFbLW0mhhAyGEqpt,15,8,7,0,7,0,2,0,24,3.4285714285714284,1,0.0,0,7,0,7,8,0,0,2,0,14,10,1
1065,23853,RERZDO4CwF9dxtSu0h5YmBuy5kxPiJg0,SpATywNh6bZuzm8s1ceuBUnMUAeoAHHw,12,22,3,22,2,0,3,0,52,7.428571428571429,2,0.0,9,3,19,2,13,0,3,3,0,33,19,0
1066,23859,XNb7KU6KeHuNJzclGX2ePynnmu8yxV3v,SpATywNh6bZuzm8s1ceuBUnMUAeoAHHw,27,47,11,22,6,7,5,0,98,14.0,1,0.0,4,11,18,6,43,7,4,5,0,39,59,0
1067,23866,7WsRevbkgPhYSJirD1kBI2okhIiuBQwH,A3fsA9Zfv1X2fVEQhTw51lKENdNrEqT3,2,0,0,0,0,0,3,0,3,0.42857142857142855,1,0.0,0,0,0,0,0,0,0,3,0,0,3,1
1068,23884,GJmfZNR8PZRpI11B5boI8G7Sd4djdQgk,SpATywNh6bZuzm8s1ceuBUnMUAeoAHHw,6,3,2,0,1,0,2,0,8,1.1428571428571428,2,0.0,0,2,0,1,3,0,0,2,0,3,5,1
1069,23906,XIUlzpQjeuAoBiPuklTmwavmE8N5buiR,bWdj2GDclj5ofokWjzoa5jAwMkxCykd6,9,6,4,0,3,0,6,1,20,2.857142857142857,1,0.0,0,4,0,3,6,0,0,6,1,7,13,1
1070,23913,6MGET4duNnhYB7elJoLURxwHMKRGtg9y,bWdj2GDclj5ofokWjzoa5jAwMkxCykd6,6,8,1,20,1,0,1,0,31,4.428571428571429,1,0.0,5,1,19,1,3,0,1,1,0,26,5,1
1071,23962,5pjAdY5K4FfgQPLSzQKwXaKF78ph9a0y,RXDvfPUBYFlVdlueBFbLW0mhhAyGEqpt,32,45,22,36,5,0,7,0,115,16.428571428571427,3,0.0,2,22,35,5,43,0,1,7,0,64,51,0
1072,23977,tkDslnD6NXbenEreFtnV2nvNZ4GDJajz,RXDvfPUBYFlVdlueBFbLW0mhhAyGEqpt,4,4,2,0,0,0,3,0,9,1.2857142857142858,1,0.0,0,2,0,0,4,0,0,3,0,2,7,1
1073,23984,HAPPxnLUjIhcauBZnnWBFk3JE6gETTxa,SpATywNh6bZuzm8s1ceuBUnMUAeoAHHw,7,4,3,0,2,0,1,0,10,1.4285714285714286,1,0.0,0,3,0,2,4,0,0,1,0,5,5,1
1074,23994,AkYabqnQmQubmhD6vLFPcIqa194wOTvs,SpATywNh6bZuzm8s1ceuBUnMUAeoAHHw,1,0,0,0,0,0,1,0,1,0.14285714285714285,1,0.0,0,0,0,0,0,0,0,1,0,0,1,1
1075,24000,tML4IQ8jFiP4YuH9NbvzKQFqAdof0qcO,SpATywNh6bZuzm8s1ceuBUnMUAeoAHHw,15,20,0,18,0,69,10,3,120,17.142857142857142,3,0.0,4,0,16,0,16,69,2,10,3,20,100,0
1076,24021,wPWqnGAkrR45TEYOXZpjGrKRubMl9rFP,SpATywNh6bZuzm8s1ceuBUnMUAeoAHHw,17,45,1,19,1,4,7,0,77,11.0,4,0.0,11,1,16,1,34,4,3,7,0,29,48,0
1077,24024,OIPBfPb9802WcbHz02njDB4ysP5ao9fe,SpATywNh6bZuzm8s1ceuBUnMUAeoAHHw,15,18,0,11,0,0,5,0,34,4.857142857142857,1,0.0,5,0,10,0,13,0,1,5,0,15,19,0
1078,24025,REvshIGXuaBWprkQ9qA5D33qmf3QiAwV,SpATywNh6bZuzm8s1ceuBUnMUAeoAHHw,21,21,18,12,14,0,3,0,68,9.714285714285714,2,0.0,0,18,10,14,21,0,2,3,0,42,26,0
1079,24049,koZ8gxZRuDJaBnv7V4tJo48rZ57BbCd4,SpATywNh6bZuzm8s1ceuBUnMUAeoAHHw,19,13,7,18,4,0,4,0,46,6.571428571428571,1,0.0,4,7,17,4,9,0,1,4,0,32,14,1
1080,24056,UKrQdzHwNJRJK7ZoTzKsoWlrkEbsQk7X,A3fsA9Zfv1X2fVEQhTw51lKENdNrEqT3,1,0,0,0,0,0,1,0,1,0.14285714285714285,1,0.0,0,0,0,0,0,0,0,1,0,0,1,1
1081,24076,hWoXRoePYaW50QNR65rI6g0ffdFAubIq,SpATywNh6bZuzm8s1ceuBUnMUAeoAHHw,17,17,9,2,6,0,4,1,39,5.571428571428571,1,0.0,0,9,2,6,17,0,0,4,1,17,22,1
1082,24086,wx9LUKj4KCj2VrJqkWxv5NlmYX9Bw5rx,RXDvfPUBYFlVdlueBFbLW0mhhAyGEqpt,29,72,5,32,7,0,23,1,140,20.0,2,0.0,11,5,29,7,61,0,3,23,1,52,88,1
1083,24122,4e4wTy2Vsuz8jVFYgJOgi1kIGDWREiPH,bWdj2GDclj5ofokWjzoa5jAwMkxCykd6,21,39,10,46,6,0,1,0,102,14.571428571428571,1,0.0,14,10,43,6,25,0,3,1,0,73,29,0
1084,24132,je9A6l6tP7wnbFhNJD7vbbHTYhqshuqB,SpATywNh6bZuzm8s1ceuBUnMUAeoAHHw,4,8,3,0,0,0,2,0,13,1.8571428571428572,2,0.0,3,3,0,0,5,0,0,2,0,6,7,1
1085,24135,yntNdGOvrRZS9CTrjjNKRRz96Mc1JGbf,bWdj2GDclj5ofokWjzoa5jAwMkxCykd6,4,3,1,0,0,0,1,0,5,0.7142857142857143,1,0.0,0,1,0,0,3,0,0,1,0,1,4,1
1086,24138,tCb9JPhOhIatDlJOcmjorPeSIRsd6N1b,SpATywNh6bZuzm8s1ceuBUnMUAeoAHHw,26,56,3,26,3,0,11,0,99,14.142857142857142,3,0.0,13,3,20,3,43,0,6,11,0,39,60,0
1087,24148,uvl7kPB3Po3jrDtnQvCsunCWcJhdeQPU,bWdj2GDclj5ofokWjzoa5jAwMkxCykd6,1,0,0,0,0,0,2,0,2,0.2857142857142857,2,0.0,0,0,0,0,0,0,0,2,0,0,2,1
1088,24151,c7klirhrxknzNn3AkRTiBI36lun1Z17S,SpATywNh6bZuzm8s1ceuBUnMUAeoAHHw,7,4,3,0,2,0,2,0,11,1.5714285714285714,1,0.0,0,3,0,2,4,0,0,2,0,5,6,1
1089,24155,uUKSUB3HEdGhPX6CV6kspFVUkErIumI9,SpATywNh6bZuzm8s1ceuBUnMUAeoAHHw,18,11,5,14,4,6,4,0,44,6.285714285714286,2,0.0,2,5,12,4,9,6,2,4,0,23,21,1
1090,24169,s4TNdVBVykBR8x72RZEnjBx6ebkwwW3k,SpATywNh6bZuzm8s1ceuBUnMUAeoAHHw,1,0,0,0,0,0,1,0,1,0.14285714285714285,1,0.0,0,0,0,0,0,0,0,1,0,0,1,1
1091,24249,A1MWkFESy8kUA44NvA6UlE1jbCsV980k,SpATywNh6bZuzm8s1ceuBUnMUAeoAHHw,6,5,1,0,1,0,3,0,10,1.4285714285714286,1,0.0,0,1,0,1,5,0,0,3,0,2,8,1
1092,24277,hzJi6Q52SSiJSH5oo1cc45XsfYCFzZYG,SpATywNh6bZuzm8s1ceuBUnMUAeoAHHw,7,7,2,0,2,0,3,0,14,2.0,2,0.0,0,2,0,2,7,0,0,3,0,4,10,1
1093,24287,Ms0MC4W5moiGJLWP7iE3FImeH9CHN4KT,bWdj2GDclj5ofokWjzoa5jAwMkxCykd6,5,5,0,0,0,0,3,0,8,1.1428571428571428,2,0.0,1,0,0,0,4,0,0,3,0,1,7,0
1094,24303,pYcnIzYPgb3xzrOvmR9y0UUIZo4gqKuO,RXDvfPUBYFlVdlueBFbLW0mhhAyGEqpt,3,2,1,0,0,0,1,0,4,0.5714285714285714,1,0.0,0,1,0,0,2,0,0,1,0,1,3,0
1095,24304,UzwJVyLJF6Ih9iHYPyYWMullgIr89o5m,RXDvfPUBYFlVdlueBFbLW0mhhAyGEqpt,31,52,34,36,5,2,15,0,144,20.571428571428573,3,0.0,5,34,33,5,47,2,3,15,0,77,67,0
1096,24312,wGN3pCdk72KFTm52vXIRH474TFtQqduI,SpATywNh6bZuzm8s1ceuBUnMUAeoAHHw,29,35,20,29,14,0,5,0,103,14.714285714285714,2,0.0,10,20,28,14,25,0,1,5,0,72,31,0
1097,24325,bPrEBQILvyBjp3odJGGZ7KxlAV5Gu9sz,SpATywNh6bZuzm8s1ceuBUnMUAeoAHHw,18,26,14,17,5,3,14,6,85,12.142857142857142,2,0.0,6,14,16,5,20,3,1,14,6,41,44,0
1098,24332,NY9lbGArbud0VjFCO45IgKzDykuc5Wkn,SpATywNh6bZuzm8s1ceuBUnMUAeoAHHw,28,78,47,30,44,0,6,0,205,29.285714285714285,2,0.0,14,47,30,44,64,0,0,6,0,135,70,1
1099,24358,IIdYSsTHK0XdI7wZc5S09iVifP1zJLzN,SpATywNh6bZuzm8s1ceuBUnMUAeoAHHw,4,3,1,0,0,0,1,0,5,0.7142857142857143,1,0.0,0,1,0,0,3,0,0,1,0,1,4,1
1100,24361,dWVj5G83xAxBDmPzLgLHfDC3pxyIk4K1,A3fsA9Zfv1X2fVEQhTw51lKENdNrEqT3,7,3,2,0,2,0,2,0,9,1.2857142857142858,1,0.0,0,2,0,2,3,0,0,2,0,4,5,1
1101,24370,nuKEM7FMFD9npzL9DafH3T1pYgMoLJoQ,SpATywNh6bZuzm8s1ceuBUnMUAeoAHHw,11,24,9,5,4,0,2,0,44,6.285714285714286,2,0.0,6,9,4,4,18,0,1,2,0,23,21,0
1102,24373,5p4xnVU1oXqeHfhqOsPC09VPLJWVQgy1,SpATywNh6bZuzm8s1ceuBUnMUAeoAHHw,20,18,13,8,6,2,12,1,60,8.571428571428571,3,0.0,2,13,7,6,16,2,1,12,1,28,32,1
1103,24383,Ialz252wY3knIVjOtCWLYcvvPO6EGRFT,SpATywNh6bZuzm8s1ceuBUnMUAeoAHHw,15,16,2,14,0,0,5,0,37,5.285714285714286,2,0.0,3,2,13,0,13,0,1,5,0,18,19,0
1104,24388,4v506xwnN2gFG9XeSNIeiBlmXImooi1O,SpATywNh6bZuzm8s1ceuBUnMUAeoAHHw,26,63,31,24,14,2,16,0,150,21.428571428571427,4,0.0,12,31,21,14,51,2,3,16,0,78,72,0
1105,24394,Zhz7dkJdB0wauB8JtGSDj0NsuH0ZH8Cd,SpATywNh6bZuzm8s1ceuBUnMUAeoAHHw,7,4,3,0,2,0,1,0,10,1.4285714285714286,1,0.0,0,3,0,2,4,0,0,1,0,5,5,1
1106,24410,F95Wv3qn0qNK1jUsJHuRDZbU4th6dVHD,RXDvfPUBYFlVdlueBFbLW0mhhAyGEqpt,1,0,0,0,0,0,1,0,1,0.14285714285714285,1,0.0,0,0,0,0,0,0,0,1,0,0,1,1
1107,24430,ADFd6U5gb8MuQY2di0urTV7aR0h11Ir1,bWdj2GDclj5ofokWjzoa5jAwMkxCykd6,2,0,0,0,0,0,2,0,2,0.2857142857142857,1,0.0,0,0,0,0,0,0,0,2,0,0,2,1
1108,24444,mFNGHC6aCmhHmhRXFCDO0uvnGnNYaro0,A3fsA9Zfv1X2fVEQhTw51lKENdNrEqT3,7,6,2,0,1,0,3,0,12,1.7142857142857142,3,0.0,0,2,0,1,6,0,0,3,0,3,9,1
1109,24476,1yAfuEW0CNQiRXnPO0v79LFUyx4hhTWm,A3fsA9Zfv1X2fVEQhTw51lKENdNrEqT3,1,0,0,0,0,0,1,0,1,0.14285714285714285,1,0.0,0,0,0,0,0,0,0,1,0,0,1,1
1110,24481,MlSRfdfvLbnwipGT1vckZAUcsWbqV0Nz,bWdj2GDclj5ofokWjzoa5jAwMkxCykd6,35,20,11,145,5,0,10,0,191,27.285714285714285,2,0.0,9,11,131,5,11,0,14,10,0,156,35,0
1111,24484,B5XH6YQeVGrE18VTFwIQP3iU5E4UvLjO,SpATywNh6bZuzm8s1ceuBUnMUAeoAHHw,1,0,0,0,0,0,1,0,1,0.14285714285714285,1,0.0,0,0,0,0,0,0,0,1,0,0,1,1
1112,24495,MhaNzTwlOubA2mdN8jvZF4ySj9a3XsvZ,G8EPVSXsOYB5YQWZGiz1aVq5Pgr2GrQu,18,19,16,32,6,0,4,0,77,11.0,1,0.0,0,16,29,6,19,0,3,4,0,51,26,1
1113,24518,iXoEMwcJ5o4IM7VKZ5pyam9GxPy4olUQ,A3fsA9Zfv1X2fVEQhTw51lKENdNrEqT3,1,0,0,0,0,0,2,0,2,0.2857142857142857,1,0.0,0,0,0,0,0,0,0,2,0,0,2,1
1114,24521,iXoEMwcJ5o4IM7VKZ5pyam9GxPy4olUQ,SpATywNh6bZuzm8s1ceuBUnMUAeoAHHw,6,5,2,0,1,0,2,0,10,1.4285714285714286,2,0.0,0,2,0,1,5,0,0,2,0,3,7,1
1115,24527,iXoEMwcJ5o4IM7VKZ5pyam9GxPy4olUQ,RXDvfPUBYFlVdlueBFbLW0mhhAyGEqpt,1,0,0,0,0,0,3,0,3,0.42857142857142855,1,0.0,0,0,0,0,0,0,0,3,0,0,3,1
1116,24532,Hxi6d4DzV7K1jcnZIhXlJzpIYDP4sYeZ,G8EPVSXsOYB5YQWZGiz1aVq5Pgr2GrQu,7,5,1,0,1,0,1,0,8,1.1428571428571428,1,0.0,0,1,0,1,5,0,0,1,0,2,6,0
1117,24567,QDaW6SyhKIOYnUckUXKfy6A7QKIp9Kb8,bWdj2GDclj5ofokWjzoa5jAwMkxCykd6,3,0,0,0,0,8,4,0,12,1.7142857142857142,1,0.0,0,0,0,0,0,8,0,4,0,0,12,1
1118,24656,LpLPysd45mBlrVFCgTTBBbMGnlXmZLO1,7GRhBDsirIGkRZBtSMEzNTyDr2JQm4xx,5,19,0,0,0,0,6,0,25,3.5714285714285716,2,0.0,0,0,0,0,19,0,0,6,0,0,25,1
1119,24674,99qhCmy07rsquumjTFRELTtrLHpQpj07,bWdj2GDclj5ofokWjzoa5jAwMkxCykd6,3,4,2,0,0,0,2,0,8,1.1428571428571428,1,0.0,0,2,0,0,4,0,0,2,0,2,6,0
1120,24760,NVJD7a4veZi4dOPtkddbSAsIN5dFV8jt,SpATywNh6bZuzm8s1ceuBUnMUAeoAHHw,8,11,5,0,0,5,2,0,23,3.2857142857142856,1,0.0,5,5,0,0,6,5,0,2,0,10,13,0
1121,24775,FeUvHE3xENj0OT6fhaRqvHDDKwwtsMRR,SpATywNh6bZuzm8s1ceuBUnMUAeoAHHw,16,17,11,14,5,0,2,0,49,7.0,2,0.0,2,11,12,5,15,0,2,2,0,30,19,0
1122,24821,2Hx9g01WcHXaoIvHRFrUfZqDWuVhvV5b,SpATywNh6bZuzm8s1ceuBUnMUAeoAHHw,20,31,1,27,0,0,6,0,65,9.285714285714286,1,0.0,9,1,26,0,22,0,1,6,0,36,29,0
1123,24841,GfRp1O86gI5zJJh8SIJ1bczUJPWlAqoK,7GRhBDsirIGkRZBtSMEzNTyDr2JQm4xx,11,35,0,0,1,0,3,0,39,5.571428571428571,2,0.0,3,0,0,1,32,0,0,3,0,4,35,1
1124,24860,FPPbdZs5zRERbNXCB9udITtxlck6dBd9,SpATywNh6bZuzm8s1ceuBUnMUAeoAHHw,12,16,0,8,0,33,2,0,59,8.428571428571429,1,0.0,2,0,8,0,14,33,0,2,0,10,49,0
1125,24875,97rJErYjCaSZkM2sQr4Hy3em0yNLLl9Z,7GRhBDsirIGkRZBtSMEzNTyDr2JQm4xx,27,113,25,93,3,13,5,0,252,36.0,1,0.0,43,25,82,3,70,13,11,5,0,153,99,0
1126,25128,5ysSxswt94Gjj7n5OSEcRzDBWhgbKFUg,SpATywNh6bZuzm8s1ceuBUnMUAeoAHHw,20,28,11,16,3,0,2,0,60,8.571428571428571,2,0.0,15,11,15,3,13,0,1,2,0,44,16,0
1127,25140,s4t4u8r9weCt43Z5PXbFAgqmS5WJ6hj5,G8EPVSXsOYB5YQWZGiz1aVq5Pgr2GrQu,30,41,2,42,2,27,11,1,126,18.0,3,0.0,16,2,28,2,25,27,14,11,1,48,78,1
1128,25196,3Oka5GvBd9TakXRvr9D5vxoJEhxwuxJA,RXDvfPUBYFlVdlueBFbLW0mhhAyGEqpt,63,104,65,136,27,12,17,1,362,51.714285714285715,4,0.0,27,65,131,27,77,12,5,17,1,250,112,0
1129,25206,36GRXkIW2SpIWQz7gvMq2JRXacytqSzV,SpATywNh6bZuzm8s1ceuBUnMUAeoAHHw,22,24,14,12,9,18,11,0,88,12.571428571428571,2,0.0,7,14,12,9,17,18,0,11,0,42,46,0
1130,25236,JmXGzVVfQa5TXaQwtZdggsgBkbZbIeH5,bWdj2GDclj5ofokWjzoa5jAwMkxCykd6,3,2,1,0,0,2,2,0,7,1.0,1,0.0,0,1,0,0,2,2,0,2,0,1,6,0
1131,25289,YfHmALaAUVJkTXPVPoa3sijNQuWgYS7R,SpATywNh6bZuzm8s1ceuBUnMUAeoAHHw,28,40,24,12,15,0,5,0,96,13.714285714285714,1,0.0,9,24,12,15,31,0,0,5,0,60,36,0
1132,25510,SXQudUQxotVyHX3jIj58IdonMUWj4z4L,SpATywNh6bZuzm8s1ceuBUnMUAeoAHHw,19,30,22,12,9,5,11,0,89,12.714285714285714,1,0.0,2,22,12,9,28,5,0,11,0,45,44,0
1133,25577,s5bmHBniKJzstjkFlsJcJn6YQEnj7XjP,RXDvfPUBYFlVdlueBFbLW0mhhAyGEqpt,1,0,0,0,0,0,1,0,1,0.14285714285714285,1,0.0,0,0,0,0,0,0,0,1,0,0,1,1
1134,25593,BiaPgBnlrEY2EiwA20PKZL3VeANI5Sfw,SpATywNh6bZuzm8s1ceuBUnMUAeoAHHw,16,30,11,37,1,0,6,0,85,12.142857142857142,3,0.0,15,11,31,1,15,0,6,6,0,58,27,1
1135,25633,LeLXLvHK2djzEG514AFcju6wr7gFXkH2,SpATywNh6bZuzm8s1ceuBUnMUAeoAHHw,14,23,9,20,3,13,5,0,73,10.428571428571429,2,0.0,11,9,17,3,12,13,3,5,0,40,33,1
1136,25652,HrUHfBacH3u3gfsauI41ANlvNzWZshRh,A3fsA9Zfv1X2fVEQhTw51lKENdNrEqT3,30,16,12,88,7,0,5,0,128,18.285714285714285,3,0.0,1,12,77,7,15,0,11,5,0,97,31,0
1137,25653,TJlb1m2PM0vBaKFhpndqRNwoSVpMlE8f,A3fsA9Zfv1X2fVEQhTw51lKENdNrEqT3,2,0,0,0,0,0,3,0,3,0.42857142857142855,1,0.0,0,0,0,0,0,0,0,3,0,0,3,1
1138,25673,gyFw0Vge0Tj4Yoavkd7TNvnmTGksA31j,SpATywNh6bZuzm8s1ceuBUnMUAeoAHHw,27,26,10,38,7,0,4,0,85,12.142857142857142,2,0.0,15,10,31,7,11,0,7,4,0,63,22,0
1139,25735,pwnvfCtqibSBzw9gewKZFVOUFkyHecrp,SpATywNh6bZuzm8s1ceuBUnMUAeoAHHw,6,5,0,0,0,0,2,0,7,1.0,1,0.0,0,0,0,0,5,0,0,2,0,0,7,1
1140,25765,E31WqWw5nCEWlSKgmhsOSj5j4T79ypCl,SpATywNh6bZuzm8s1ceuBUnMUAeoAHHw,18,12,8,19,4,0,3,0,46,6.571428571428571,2,0.0,2,8,16,4,10,0,3,3,0,30,16,0
1141,25807,Zl8ThqnwtmFsX5mPsLsbut5BCVNIbE7S,SpATywNh6bZuzm8s1ceuBUnMUAeoAHHw,3,3,0,0,0,0,1,0,4,0.5714285714285714,1,0.0,0,0,0,0,3,0,0,1,0,0,4,0
1142,25883,HrUHfBacH3u3gfsauI41ANlvNzWZshRh,SpATywNh6bZuzm8s1ceuBUnMUAeoAHHw,14,20,8,14,0,3,11,3,59,8.428571428571429,2,0.0,9,8,13,0,11,3,1,11,3,30,29,0
1143,25895,DLDhUvvvfnnYFJuV65Zt2yaS0jPJgvzq,SpATywNh6bZuzm8s1ceuBUnMUAeoAHHw,18,43,0,26,0,1,13,1,84,12.0,4,0.0,25,0,24,0,18,1,2,13,1,49,35,0
1144,25901,pIkx6nDAjTla5NYVEsjhMXOIu5zXDzmO,SpATywNh6bZuzm8s1ceuBUnMUAeoAHHw,3,2,1,0,0,0,2,0,5,0.7142857142857143,1,0.0,0,1,0,0,2,0,0,2,0,1,4,0
1145,25963,3Ew3yAxjSntFFYCyahG9TNwPBtEjhvBu,SpATywNh6bZuzm8s1ceuBUnMUAeoAHHw,26,28,18,4,11,8,10,3,82,11.714285714285714,1,0.0,6,18,4,11,22,8,0,10,3,39,43,1
1146,26027,l5LfU8gApOG72AnBkdAbfOLQLwFH7Zo2,A3fsA9Zfv1X2fVEQhTw51lKENdNrEqT3,6,6,2,0,0,0,3,0,11,1.5714285714285714,1,0.0,1,2,0,0,5,0,0,3,0,3,8,0
1147,26033,6izQCEneEK1X6C1taxn0XENXkSv3cl84,A3fsA9Zfv1X2fVEQhTw51lKENdNrEqT3,20,16,8,22,5,0,2,0,53,7.571428571428571,1,0.0,0,8,20,5,16,0,2,2,0,33,20,0
1148,26148,JqvGTplcVBLcq3YzEUVslmYGYOBREBZ1,SpATywNh6bZuzm8s1ceuBUnMUAeoAHHw,11,13,0,7,0,5,5,0,30,4.285714285714286,3,0.0,2,0,7,0,11,5,0,5,0,9,21,0
1149,26208,USLTnsAwagwK2c83KXd1SNEeENnzkTTo,7GRhBDsirIGkRZBtSMEzNTyDr2JQm4xx,3,0,0,0,0,14,9,0,23,3.2857142857142856,5,0.0,0,0,0,0,0,14,0,9,0,0,23,0
1150,26236,b3xaxczfVryBkeC1YPbXWEZUleYIZAnq,SpATywNh6bZuzm8s1ceuBUnMUAeoAHHw,5,2,2,0,2,0,2,0,8,1.1428571428571428,1,0.0,0,2,0,2,2,0,0,2,0,4,4,1
1151,26255,v6GmjzoPMSZcgdRV04c3r4zmEQVHxeod,A3fsA9Zfv1X2fVEQhTw51lKENdNrEqT3,7,4,2,0,2,0,1,0,9,1.2857142857142858,1,0.0,0,2,0,2,4,0,0,1,0,4,5,1
1152,26326,drIV8ws6G2eFjZA06SdUOTyJLvhyaXrd,SpATywNh6bZuzm8s1ceuBUnMUAeoAHHw,10,7,3,6,0,0,7,1,24,3.4285714285714284,3,0.0,2,3,6,0,5,0,0,7,1,11,13,0
1153,26435,N0Sos51WanCzoSGKDmMPzQtMlLxY3bFb,bWdj2GDclj5ofokWjzoa5jAwMkxCykd6,21,33,19,22,9,4,10,1,98,14.0,2,0.0,5,19,20,9,28,4,2,10,1,53,45,0
1154,26442,C8XrXSQZNN8RR6xEeSRWbKA5jTxVTtPT,SpATywNh6bZuzm8s1ceuBUnMUAeoAHHw,20,20,12,0,8,0,2,0,42,6.0,1,0.0,7,12,0,8,13,0,0,2,0,27,15,0
1155,26511,wdK5DIKl9qd73hM1uOx3ufcKj0J9AcRr,SpATywNh6bZuzm8s1ceuBUnMUAeoAHHw,19,20,13,12,8,0,3,0,56,8.0,2,0.0,6,13,11,8,14,0,1,3,0,38,18,1
1156,26625,chwuEH1iMc682zjOmO4zFwwfUl1drv8Q,RXDvfPUBYFlVdlueBFbLW0mhhAyGEqpt,24,28,19,36,12,7,7,0,109,15.571428571428571,1,0.0,9,19,33,12,19,7,3,7,0,73,36,0
1157,26704,OF8cZCIXPsuM4CdS1yd3vA1SWWYblMbf,SpATywNh6bZuzm8s1ceuBUnMUAeoAHHw,3,2,1,0,0,0,2,0,5,0.7142857142857143,1,0.0,0,1,0,0,2,0,0,2,0,1,4,0
1158,26769,QKh6yCjm7KCBJwTgcTdbJMWujg3bWjbd,SpATywNh6bZuzm8s1ceuBUnMUAeoAHHw,12,14,1,14,0,0,1,0,30,4.285714285714286,1,0.0,6,1,13,0,8,0,1,1,0,20,10,0
1159,26806,v3af5rWc4AOfzZv6mvaIgDKPH5PLVH0T,RXDvfPUBYFlVdlueBFbLW0mhhAyGEqpt,3,2,1,0,0,17,1,0,21,3.0,1,0.0,0,1,0,0,2,17,0,1,0,1,20,0
1160,26857,g44r9jnfvUwG99HEAhIahumgutn1iCtI,SpATywNh6bZuzm8s1ceuBUnMUAeoAHHw,29,45,21,29,9,0,10,0,114,16.285714285714285,3,0.0,15,21,26,9,30,0,3,10,0,71,43,0
1161,26878,zNRtwNQkiCM9OW1nTIM2OGHUm9Iu3JVP,RXDvfPUBYFlVdlueBFbLW0mhhAyGEqpt,28,29,2,49,3,5,9,0,97,13.857142857142858,3,0.0,8,2,45,3,21,5,4,9,0,58,39,0
1162,26879,nE23LYiQpabdXkj6YvKSja9sZnHRizmo,A3fsA9Zfv1X2fVEQhTw51lKENdNrEqT3,1,1,0,0,0,0,0,0,1,0.14285714285714285,1,0.0,0,0,0,0,1,0,0,0,0,0,1,0
1163,26923,PQxAX7A8tQB7sGIcC9YvDjqPxTwtHPvm,SpATywNh6bZuzm8s1ceuBUnMUAeoAHHw,9,7,2,18,0,0,6,0,33,4.714285714285714,2,0.0,2,2,15,0,5,0,3,6,0,19,14,0
1164,26924,vptj4ETLtFQ4ma0zcDVByNO4VFhFTiIc,SpATywNh6bZuzm8s1ceuBUnMUAeoAHHw,10,13,4,0,1,5,6,1,30,4.285714285714286,1,0.0,6,4,0,1,7,5,0,6,1,11,19,0
1165,26946,DsHgWZRTJ1y1l15smwhB78ZQq3d8dyKP,A3fsA9Zfv1X2fVEQhTw51lKENdNrEqT3,1,0,0,0,0,0,2,0,2,0.2857142857142857,2,0.0,0,0,0,0,0,0,0,2,0,0,2,0
1166,27161,TNArortVQm3F09odJ2W3xdM27lVc5PiX,7GRhBDsirIGkRZBtSMEzNTyDr2JQm4xx,8,12,5,0,3,0,1,0,21,3.0,1,0.0,0,5,0,3,12,0,0,1,0,8,13,1
1167,27164,q0GZFChoVOuhzxYur1QICnKH6imiHQh6,SpATywNh6bZuzm8s1ceuBUnMUAeoAHHw,4,3,0,0,0,0,1,0,4,0.5714285714285714,1,0.0,0,0,0,0,3,0,0,1,0,0,4,0
1168,27223,amNosdi6Uiilljdy8esSBA3F29NKPLUW,SpATywNh6bZuzm8s1ceuBUnMUAeoAHHw,14,13,8,13,5,0,2,0,41,5.857142857142857,2,0.0,4,8,13,5,9,0,0,2,0,30,11,1
1169,27305,mvWG8WfFoikkAB9Wg1mtbCZJVje4NMeg,bWdj2GDclj5ofokWjzoa5jAwMkxCykd6,8,7,6,0,3,0,1,0,17,2.4285714285714284,1,0.0,0,6,0,3,7,0,0,1,0,9,8,0
1170,27332,rz8gqb0xki7JyRvmBK5JfOlM8YmBiT6q,SpATywNh6bZuzm8s1ceuBUnMUAeoAHHw,17,22,10,12,8,3,6,0,61,8.714285714285714,3,0.0,7,10,12,8,15,3,0,6,0,37,24,0
1171,27364,VxTZo8wWibkIng7J8YPkqWh1rsEKvqTC,7GRhBDsirIGkRZBtSMEzNTyDr2JQm4xx,4,5,4,0,4,0,1,0,14,2.0,6,0.0,0,4,0,4,5,0,0,1,0,8,6,0
1172,27429,IYFIdswDKEsO4j14D9vS4fhZEQBqA7vK,SpATywNh6bZuzm8s1ceuBUnMUAeoAHHw,12,18,7,8,1,13,11,0,58,8.285714285714286,3,0.0,7,7,8,1,11,13,0,11,0,23,35,0
1173,27449,M8C9BDFICk4ida59GU0jjp556zazDEi1,SpATywNh6bZuzm8s1ceuBUnMUAeoAHHw,7,6,3,0,1,0,3,0,13,1.8571428571428572,2,0.0,0,3,0,1,6,0,0,3,0,4,9,0
1174,27536,p7V6MquT5r2C7VmRzYjQEOsKx7s5gJug,SpATywNh6bZuzm8s1ceuBUnMUAeoAHHw,9,5,4,0,3,0,1,0,13,1.8571428571428572,1,0.0,0,4,0,3,5,0,0,1,0,7,6,0
1175,30658,Sk4DUKJRImF6lijTnkABuH01jDj9zcnP,7GRhBDsirIGkRZBtSMEzNTyDr2JQm4xx,11,10,5,10,5,1,2,0,33,4.714285714285714,1,0.0,4,5,8,5,6,1,2,2,0,22,11,0
1176,30700,uAXW7zeSaEEtMIdMcVsYpUquscAKUnr7,7GRhBDsirIGkRZBtSMEzNTyDr2JQm4xx,16,19,15,0,10,0,3,0,47,6.714285714285714,2,0.0,1,15,0,10,18,0,0,3,0,26,21,1
1177,30785,rf4oo5VCac1USN0w21Ny3OOp1AZe5MC5,RXDvfPUBYFlVdlueBFbLW0mhhAyGEqpt,35,19,0,48,0,2,2,0,71,10.142857142857142,1,0.0,7,0,47,0,12,2,1,2,0,54,17,1
1178,30875,7xwH0IGxUu9oyiAWk7HpSQpakcHGIuLy,G8EPVSXsOYB5YQWZGiz1aVq5Pgr2GrQu,5,8,1,0,1,2,1,0,13,1.8571428571428572,2,0.0,0,1,0,1,8,2,0,1,0,2,11,0
1179,30926,JODIGhSXEMOFdMb0BMfI1hphmGCcGiv9,7GRhBDsirIGkRZBtSMEzNTyDr2JQm4xx,5,2,1,0,0,0,3,0,6,0.8571428571428571,1,0.0,0,1,0,0,2,0,0,3,0,1,5,1
1180,30996,WNlTer437rP0ycEd1BKVfCjGSSopiPqX,SpATywNh6bZuzm8s1ceuBUnMUAeoAHHw,15,14,0,8,0,1,7,1,31,4.428571428571429,1,0.0,2,0,8,0,12,1,0,7,1,10,21,0
1181,31033,uUSTKM8g1hIskJbYHh1UiIQ6epHTSTNR,SpATywNh6bZuzm8s1ceuBUnMUAeoAHHw,10,23,10,0,5,0,4,0,42,6.0,2,0.0,8,10,0,5,15,0,0,4,0,23,19,0
1182,31152,AdsXlEjQFIksauSrVM6XkycFKpsPMY96,G8EPVSXsOYB5YQWZGiz1aVq5Pgr2GrQu,33,96,54,88,23,1,9,1,272,38.857142857142854,5,0.0,33,54,69,23,63,1,19,9,1,179,93,0
1183,31186,71r0cSGOl797B6z3Ozx79KsmcnthtUKF,RXDvfPUBYFlVdlueBFbLW0mhhAyGEqpt,9,17,3,0,2,21,12,2,57,8.142857142857142,1,0.0,2,3,0,2,15,21,0,12,2,7,50,0
1184,31204,YOx6Tvp6HBSp6Lo310sbWxV28yIh3XN8,G8EPVSXsOYB5YQWZGiz1aVq5Pgr2GrQu,30,34,20,0,23,0,1,0,78,11.142857142857142,3,0.0,13,20,0,23,21,0,0,1,0,56,22,0
1185,31205,JzHC5tjVySaXz4V3Y0e4piHyrkmeSqU5,SpATywNh6bZuzm8s1ceuBUnMUAeoAHHw,17,20,12,14,5,0,6,0,57,8.142857142857142,4,0.0,2,12,12,5,18,0,2,6,0,31,26,0
1186,31242,Qn3OccgDXQpcut9yLA9jXfau6FPbS72n,SpATywNh6bZuzm8s1ceuBUnMUAeoAHHw,23,32,0,12,0,9,10,1,64,9.142857142857142,1,0.0,9,0,12,0,23,9,0,10,1,21,43,0
1187,31313,vAwmKvW9O3gDJNDrzxbIT5kjf2troQFn,SpATywNh6bZuzm8s1ceuBUnMUAeoAHHw,5,3,1,0,1,0,1,0,6,0.8571428571428571,1,0.0,0,1,0,1,3,0,0,1,0,2,4,1
1188,31356,zIHhHIwIbH6mJbe3ZAvW2ovaPewaq0E0,SpATywNh6bZuzm8s1ceuBUnMUAeoAHHw,9,17,5,11,0,16,6,0,55,7.857142857142857,2,0.0,9,5,11,0,8,16,0,6,0,25,30,0
1189,31399,VBP5PzVQEKJYFH0y5ffEek5WfP9EW7uc,SpATywNh6bZuzm8s1ceuBUnMUAeoAHHw,17,10,7,8,4,0,3,0,32,4.571428571428571,2,0.0,2,7,8,4,8,0,0,3,0,21,11,0
1190,31400,S9MHz2GfayML2H9BuRARNQ0WUO9mAJgZ,SpATywNh6bZuzm8s1ceuBUnMUAeoAHHw,18,10,7,12,4,2,4,0,39,5.571428571428571,1,0.0,2,7,10,4,8,2,2,4,0,23,16,0
1191,31459,1xFsl22T8LEiEJ3kwPWguQfPNcGWZ8JV,7GRhBDsirIGkRZBtSMEzNTyDr2JQm4xx,21,64,2,0,3,3,22,2,96,13.714285714285714,2,0.0,39,2,0,3,25,3,0,22,2,44,52,1
1192,31503,YwFTXHSC31SX1LraRWOGlHPt5rdaD4Vy,SpATywNh6bZuzm8s1ceuBUnMUAeoAHHw,8,8,3,0,0,0,6,1,18,2.5714285714285716,1,0.0,2,3,0,0,6,0,0,6,1,5,13,0
1193,31691,TUAvpbJIqPqAXiWUMr89vm0HdACTuiA8,SpATywNh6bZuzm8s1ceuBUnMUAeoAHHw,9,15,1,0,1,0,4,0,21,3.0,2,0.0,0,1,0,1,15,0,0,4,0,2,19,0
1194,31804,lHdOeTUXYVL6iAgJVxxf5RxusHAIMUqu,SpATywNh6bZuzm8s1ceuBUnMUAeoAHHw,17,23,12,12,7,0,3,0,57,8.142857142857142,2,0.0,5,12,12,7,18,0,0,3,0,36,21,0
1195,32014,t8eDuPU4MsZrMH2MoE1n7JeYLVBJZOGD,SpATywNh6bZuzm8s1ceuBUnMUAeoAHHw,12,13,6,12,0,2,7,1,41,5.857142857142857,2,0.0,5,6,10,0,8,2,2,7,1,21,20,0
1196,32114,MOcMwRKo0dtFqZ5xWBgRzquuZGKtQyf4,7GRhBDsirIGkRZBtSMEzNTyDr2JQm4xx,9,20,6,0,7,2,2,0,37,5.285714285714286,2,0.0,6,6,0,7,14,2,0,2,0,19,18,1
1197,32122,ZvU0YqNTtgKWTlVIbqvnVys23p5WRiDJ,SpATywNh6bZuzm8s1ceuBUnMUAeoAHHw,6,7,4,0,1,26,2,0,40,5.714285714285714,2,0.0,0,4,0,1,7,26,0,2,0,5,35,0
1198,32168,RHl3DsvAX7TisJ7qBptmgrrtDAQvH7mr,SpATywNh6bZuzm8s1ceuBUnMUAeoAHHw,5,3,1,0,1,0,2,0,7,1.0,1,0.0,0,1,0,1,3,0,0,2,0,2,5,0
1199,32208,bNZH4hUHavni696ZcBLvxZCrBSALUDxX,SpATywNh6bZuzm8s1ceuBUnMUAeoAHHw,17,23,2,25,1,9,4,0,64,9.142857142857142,5,0.0,4,2,23,1,19,9,2,4,0,30,34,0
1200,32226,4TtGjmtd4ISORDD5okRgx7kXAcGUW8IN,SpATywNh6bZuzm8s1ceuBUnMUAeoAHHw,18,15,7,12,4,0,7,0,45,6.428571428571429,3,0.0,7,7,11,4,8,0,1,7,0,29,16,0
1201,32244,jN0wpnfaU5DsLxvEqII5WFiC356NJUbF,SpATywNh6bZuzm8s1ceuBUnMUAeoAHHw,18,21,9,11,5,0,9,3,58,8.285714285714286,1,0.0,10,9,11,5,11,0,0,9,3,35,23,1
1202,32288,8rXJHeqrLpho5nIQgbDcpBTvBrVnGged,SpATywNh6bZuzm8s1ceuBUnMUAeoAHHw,15,35,1,20,0,0,5,0,61,8.714285714285714,2,0.0,11,1,17,0,24,0,3,5,0,29,32,0
1203,32309,MZpeXlPtlAGSfwuC5xwB1U0DIOZvGtVZ,SpATywNh6bZuzm8s1ceuBUnMUAeoAHHw,14,30,0,19,1,3,2,0,55,7.857142857142857,1,0.0,16,0,16,1,14,3,3,2,0,33,22,0
1204,32346,rrZSZFoEgH3bOKdkZ0UyNzOq7Pdyx5G0,SpATywNh6bZuzm8s1ceuBUnMUAeoAHHw,11,23,13,0,1,0,9,0,46,6.571428571428571,1,0.0,0,13,0,1,23,0,0,9,0,14,32,0
1205,32385,rIb3lxEaK77vmLDTqDgCNFDZAYjyvbtK,7GRhBDsirIGkRZBtSMEzNTyDr2JQm4xx,23,22,11,26,5,0,2,0,66,9.428571428571429,1,0.0,10,11,24,5,12,0,2,2,0,50,16,1
1206,32409,9iGaqBGS5kkoXjLd87hUL2eIJMVUVKfU,G8EPVSXsOYB5YQWZGiz1aVq5Pgr2GrQu,16,13,8,16,1,0,4,0,42,6.0,2,0.0,0,8,15,1,13,0,1,4,0,24,18,0
1207,32426,gGSMkNgPdXpBQgdZzyjzifomyCxFSNyt,bWdj2GDclj5ofokWjzoa5jAwMkxCykd6,2,0,0,0,0,0,2,0,2,0.2857142857142857,1,0.0,0,0,0,0,0,0,0,2,0,0,2,0
1208,32436,QqE2Xjwy9gUzOvFdkDqAwAaNZLBZkxvd,SpATywNh6bZuzm8s1ceuBUnMUAeoAHHw,16,37,1,13,2,30,6,0,89,12.714285714285714,1,0.0,6,1,11,2,31,30,2,6,0,20,69,0
1209,32484,QqE2Xjwy9gUzOvFdkDqAwAaNZLBZkxvd,A3fsA9Zfv1X2fVEQhTw51lKENdNrEqT3,10,8,0,0,0,0,16,0,24,3.4285714285714284,3,0.0,0,0,0,0,8,0,0,16,0,0,24,0
1210,32492,5NsbP59FWlyl4NFONUzt3drLLr5EFRFj,G8EPVSXsOYB5YQWZGiz1aVq5Pgr2GrQu,64,96,37,154,14,9,14,1,325,46.42857142857143,3,0.0,52,37,114,14,44,9,40,14,1,217,108,1
1211,32501,mOJqDc22cg6Tc62XCr7iPStv8YxEXhpp,SpATywNh6bZuzm8s1ceuBUnMUAeoAHHw,15,19,10,18,3,5,5,0,60,8.571428571428571,2,0.0,2,10,15,3,17,5,3,5,0,30,30,0
1212,32577,fNAZ3rWuqq8OkAKKKUzZOQQ9DpAle4lu,SpATywNh6bZuzm8s1ceuBUnMUAeoAHHw,18,24,9,12,5,0,4,0,54,7.714285714285714,2,0.0,9,9,12,5,15,0,0,4,0,35,19,0
1213,32616,MVcepYvxjrdyzudBtT6xf978LVM5p04U,SpATywNh6bZuzm8s1ceuBUnMUAeoAHHw,20,14,9,20,4,4,7,2,60,8.571428571428571,2,0.0,2,9,17,4,12,4,3,7,2,32,28,0
1214,32647,vBbIZDmFTh3FCbK0DEiE7jyE0eCpDvg4,RXDvfPUBYFlVdlueBFbLW0mhhAyGEqpt,5,2,1,0,1,0,2,0,6,0.8571428571428571,1,0.0,0,1,0,1,2,0,0,2,0,2,4,0
1215,32694,bVveXRWwKdTb7eqX4rWDKBUhdf8PtEkw,SpATywNh6bZuzm8s1ceuBUnMUAeoAHHw,20,18,1,22,0,0,2,0,43,6.142857142857143,1,0.0,6,1,18,0,12,0,4,2,0,25,18,0
1216,32725,NHPpKvbnrSpxM8e1DORBWJbRCpmrxZw8,G8EPVSXsOYB5YQWZGiz1aVq5Pgr2GrQu,5,3,1,0,1,0,1,0,6,0.8571428571428571,1,0.0,0,1,0,1,3,0,0,1,0,2,4,0
1217,32844,b1eRrhapWSjtM2Ih9Xn0eBEZAyjqmlvI,SpATywNh6bZuzm8s1ceuBUnMUAeoAHHw,19,19,11,16,5,8,4,1,64,9.142857142857142,1,0.0,4,11,14,5,15,8,2,4,1,34,30,0
1218,33017,GFBEJrga7DM4UEcrt340p3oRNaL97Gn4,SpATywNh6bZuzm8s1ceuBUnMUAeoAHHw,15,8,5,7,2,14,9,0,45,6.428571428571429,1,0.0,2,5,7,2,6,14,0,9,0,16,29,0
1219,33023,XzkMRCsMMuNT5Al9kV5PMqeThOnNDLN6,7GRhBDsirIGkRZBtSMEzNTyDr2JQm4xx,3,3,2,0,0,2,3,0,10,1.4285714285714286,1,0.0,0,2,0,0,3,2,0,3,0,2,8,1
1220,33058,fNAZ3rWuqq8OkAKKKUzZOQQ9DpAle4lu,RXDvfPUBYFlVdlueBFbLW0mhhAyGEqpt,70,86,47,206,28,6,15,0,388,55.42857142857143,3,0.0,18,47,186,28,68,6,20,15,0,279,109,0
1221,33062,ZVmjT1rppq7ilCPRRtmAl1wo0gOugsCt,RXDvfPUBYFlVdlueBFbLW0mhhAyGEqpt,16,8,5,26,3,0,1,0,43,6.142857142857143,1,0.0,2,5,25,3,6,0,1,1,0,35,8,0
1222,33097,RJ1FVW8gXQIpK321uzh2Sh69ojlsqnvg,bWdj2GDclj5ofokWjzoa5jAwMkxCykd6,13,20,8,38,3,5,14,1,89,12.714285714285714,2,0.0,4,8,37,3,16,5,1,14,1,52,37,0
1223,33121,pKcgftm88lERht9rjtO6yDT8uF9jnp1z,7GRhBDsirIGkRZBtSMEzNTyDr2JQm4xx,8,11,4,0,4,0,1,0,20,2.857142857142857,1,0.0,2,4,0,4,9,0,0,1,0,10,10,1
1224,33146,aFVLxK4Hau9wDglF79kWvvimpoa2MXNc,SpATywNh6bZuzm8s1ceuBUnMUAeoAHHw,14,14,0,12,0,20,6,2,54,7.714285714285714,1,0.0,4,0,12,0,10,20,0,6,2,16,38,1
1225,33156,NgffOurIf9EDLm5SB7efcduZd82QhoOU,RXDvfPUBYFlVdlueBFbLW0mhhAyGEqpt,20,19,10,12,6,13,5,0,65,9.285714285714286,2,0.0,4,10,12,6,15,13,0,5,0,32,33,0
1226,33187,yiWok4eQ5hgdJ8eYi2O0qHhy67Y9EA3E,SpATywNh6bZuzm8s1ceuBUnMUAeoAHHw,30,32,18,31,9,6,6,1,103,14.714285714285714,2,0.0,12,18,28,9,20,6,3,6,1,67,36,0
1227,33280,1vY5OZ1u5dkB4jIpVDeMNw33uHVvYDm0,G8EPVSXsOYB5YQWZGiz1aVq5Pgr2GrQu,21,28,9,26,5,1,2,0,71,10.142857142857142,2,0.0,10,9,18,5,18,1,8,2,0,42,29,0
1228,33325,jXgMhQKbkiBaFyvNHAIM6AePvnnTFQC0,SpATywNh6bZuzm8s1ceuBUnMUAeoAHHw,21,19,11,24,0,0,4,0,58,8.285714285714286,2,0.0,6,11,24,0,13,0,0,4,0,41,17,0
1229,33400,R3LdCHGJ0oYuX8fUQhI8dRkzUs6gLWrE,SpATywNh6bZuzm8s1ceuBUnMUAeoAHHw,18,19,6,28,1,11,11,1,77,11.0,2,0.0,10,6,22,1,9,11,6,11,1,39,38,0
1230,33416,viuKt4GgrX0rYL5EpHoxJbsiC9TblSuk,SpATywNh6bZuzm8s1ceuBUnMUAeoAHHw,13,22,13,0,6,7,10,0,58,8.285714285714286,2,0.0,0,13,0,6,22,7,0,10,0,19,39,0
1231,33493,1vY5OZ1u5dkB4jIpVDeMNw33uHVvYDm0,SpATywNh6bZuzm8s1ceuBUnMUAeoAHHw,17,24,9,16,7,2,5,0,63,9.0,2,0.0,8,9,12,7,16,2,4,5,0,36,27,0
1232,33513,H2Rgqo3kRDsNdbNVEDl0788s9SSdLM8P,7GRhBDsirIGkRZBtSMEzNTyDr2JQm4xx,14,15,4,16,3,0,4,0,42,6.0,3,0.0,2,4,14,3,13,0,2,4,0,23,19,1
1233,33520,qmYTrueiQKfoQnGxjqfwlMlw7HOR9CKj,A3fsA9Zfv1X2fVEQhTw51lKENdNrEqT3,8,4,1,0,0,3,17,2,27,3.857142857142857,2,0.0,0,1,0,0,4,3,0,17,2,1,26,0
1234,33577,YZSZ4TOtqHUreAioK1x0YBDmIRumwoti,7GRhBDsirIGkRZBtSMEzNTyDr2JQm4xx,10,13,2,11,2,0,2,0,30,4.285714285714286,1,0.0,4,2,10,2,9,0,1,2,0,18,12,1
1235,33601,B9KqNNxXBxHFUsJnQKQysblL3f8zF7sg,7GRhBDsirIGkRZBtSMEzNTyDr2JQm4xx,18,35,0,0,5,0,4,0,44,6.285714285714286,1,0.0,15,0,0,5,20,0,0,4,0,20,24,0
1236,33643,InrAmtl2MgoSpFoohTtv1oXbh4bisxXW,bWdj2GDclj5ofokWjzoa5jAwMkxCykd6,3,2,0,0,0,0,1,0,3,0.42857142857142855,1,0.0,0,0,0,0,2,0,0,1,0,0,3,0
1237,33666,RCdcltNaQLfcoxT7YKTjQxAYUbCmzzKd,A3fsA9Zfv1X2fVEQhTw51lKENdNrEqT3,11,8,6,0,3,0,4,0,21,3.0,3,0.0,0,6,0,3,8,0,0,4,0,9,12,0
1238,34602,bS2IOWKbnbandmSXQXzI1vhjNhpDoKfN,7GRhBDsirIGkRZBtSMEzNTyDr2JQm4xx,13,18,7,36,1,8,5,0,75,10.714285714285714,3,0.0,8,7,32,1,10,8,4,5,0,48,27,1
1239,35039,URPpxYyCEjr1OE9SkqYA4izrGFGWLVkB,7GRhBDsirIGkRZBtSMEzNTyDr2JQm4xx,24,22,8,30,6,0,4,0,70,10.0,1,0.0,7,8,25,6,15,0,5,4,0,46,24,1
1240,35143,7eHsOwDNMYF4417CWrgdB8gK0Wr4kfqA,7GRhBDsirIGkRZBtSMEzNTyDr2JQm4xx,20,34,14,22,2,0,6,0,78,11.142857142857142,2,0.0,14,14,18,2,20,0,4,6,0,48,30,0
1241,35607,2LWu6JMOYyxkKMq63i00WbtT7iPpdOSr,7GRhBDsirIGkRZBtSMEzNTyDr2JQm4xx,2,0,0,0,0,0,2,0,2,0.2857142857142857,1,0.0,0,0,0,0,0,0,0,2,0,0,2,1
1242,35608,nH0kSZNGQd9lZaOsssfRVpCIHD2KW4j6,7GRhBDsirIGkRZBtSMEzNTyDr2JQm4xx,16,35,9,22,7,0,1,0,74,10.571428571428571,1,0.0,13,9,18,7,22,0,4,1,0,47,27,1
1243,35686,skJn7dtfSekFrPHRHs9swZ9AtSUKi36u,7GRhBDsirIGkRZBtSMEzNTyDr2JQm4xx,3,2,1,0,0,0,2,0,5,0.7142857142857143,2,0.0,0,1,0,0,2,0,0,2,0,1,4,0
1244,37552,gL9BFkziNrTyhzKvF4GTh7vW4ctCxqfr,SpATywNh6bZuzm8s1ceuBUnMUAeoAHHw,7,10,1,0,1,0,0,0,12,1.7142857142857142,3,0.0,0,1,0,1,10,0,0,0,0,2,10,0
1245,37553,AVMp8F9T45cyhHDRnad5d9bxFkDP4PTv,A3fsA9Zfv1X2fVEQhTw51lKENdNrEqT3,5,4,0,6,0,0,2,0,12,1.7142857142857142,1,0.0,0,0,6,0,4,0,0,2,0,6,6,1
1246,37586,rVtxqWpWg55yh0PkkVeeVKt0oQv342j9,G8EPVSXsOYB5YQWZGiz1aVq5Pgr2GrQu,5,3,3,0,3,0,2,0,11,1.5714285714285714,1,0.0,0,3,0,3,3,0,0,2,0,6,5,0
1247,37587,9RND50Xx7veKeepJEVVvFKwUGiemuZp5,G8EPVSXsOYB5YQWZGiz1aVq5Pgr2GrQu,2,0,1,0,1,0,0,0,2,0.2857142857142857,1,0.0,0,1,0,1,0,0,0,0,0,2,0,1
1248,37690,1Ti3XKNP5gzLh1si7Apz4GKt53UijsKr,SpATywNh6bZuzm8s1ceuBUnMUAeoAHHw,15,26,8,17,4,0,1,0,56,8.0,1,0.0,5,8,17,4,21,0,0,1,0,34,22,0
1249,37706,5D134KQAUnU8gDw5hYnvC82YSO8giiEU,SpATywNh6bZuzm8s1ceuBUnMUAeoAHHw,18,27,11,20,5,0,5,0,68,9.714285714285714,1,0.0,12,11,15,5,15,0,5,5,0,43,25,0
1250,37710,t89Lbc9NyQ1awHKwpUunu51m4E6DMYhk,SpATywNh6bZuzm8s1ceuBUnMUAeoAHHw,9,12,5,9,0,1,1,0,28,4.0,1,0.0,5,5,9,0,7,1,0,1,0,19,9,0
1251,37713,7fOZzyBcCx06Vw2a40A0eroSD5VkDcNa,SpATywNh6bZuzm8s1ceuBUnMUAeoAHHw,19,23,13,9,8,11,4,1,69,9.857142857142858,1,0.0,8,13,9,8,15,11,0,4,1,38,31,0
1252,37761,bzoYFRQVu6SapCnsZ0DOXeU3JXiLIJu3,SpATywNh6bZuzm8s1ceuBUnMUAeoAHHw,17,16,8,12,4,6,1,0,47,6.714285714285714,1,0.0,6,8,12,4,10,6,0,1,0,30,17,0
1253,37769,gsdvPbnmqv3G3TICTRxTHCvyG0vd5lw3,G8EPVSXsOYB5YQWZGiz1aVq5Pgr2GrQu,12,10,6,0,4,31,4,0,55,7.857142857142857,1,0.0,2,6,0,4,8,31,0,4,0,12,43,1
1254,37831,fmoIo5oPDyRcnHhnGH8MKyUTeXZvimIR,SpATywNh6bZuzm8s1ceuBUnMUAeoAHHw,3,2,1,0,0,0,1,0,4,0.5714285714285714,1,0.0,0,1,0,0,2,0,0,1,0,1,3,0
1255,37873,dpBOLaUWFOAehWXZrpwiocVfiOMhN5GL,SpATywNh6bZuzm8s1ceuBUnMUAeoAHHw,18,22,10,13,5,0,5,0,55,7.857142857142857,1,0.0,7,10,11,5,15,0,2,5,0,33,22,0
1256,37904,313ZU7SnTnilkzRb4b84vNDTmwgTEy5n,G8EPVSXsOYB5YQWZGiz1aVq5Pgr2GrQu,20,12,10,0,10,0,1,0,33,4.714285714285714,1,0.0,0,10,0,10,12,0,0,1,0,20,13,1
1257,37905,lV4ifbsehEXWBwQOY9bU762jcRSMFY5M,SpATywNh6bZuzm8s1ceuBUnMUAeoAHHw,20,27,10,6,4,0,5,1,53,7.571428571428571,2,0.0,10,10,6,4,17,0,0,5,1,30,23,0
1258,37932,UYyUkvxHd4tIc6aiQcuHfsTYHPlQXaAb,G8EPVSXsOYB5YQWZGiz1aVq5Pgr2GrQu,11,9,6,0,6,0,3,0,24,3.4285714285714284,1,0.0,2,6,0,6,7,0,0,3,0,14,10,1
1259,37972,k0lvFNaTVHTtB1XHBZ8229ej4v1r4rPk,A3fsA9Zfv1X2fVEQhTw51lKENdNrEqT3,1,0,0,0,0,0,1,0,1,0.14285714285714285,1,0.0,0,0,0,0,0,0,0,1,0,0,1,0
1260,38049,7n0QZ7z1Xa9itNmJQbQwoSvEI6n7oD9f,G8EPVSXsOYB5YQWZGiz1aVq5Pgr2GrQu,7,4,5,0,5,0,0,0,14,2.0,1,0.0,0,5,0,5,4,0,0,0,0,10,4,0
1261,38117,udxFfabXtaVUvVlT3wEleIvfDBGe9yE2,SpATywNh6bZuzm8s1ceuBUnMUAeoAHHw,18,27,2,24,1,3,3,0,60,8.571428571428571,1,0.0,11,2,18,1,16,3,6,3,0,32,28,0
1262,38119,53oi8zKKD3qFJiM7JZLKGYnyxQCMyuUV,SpATywNh6bZuzm8s1ceuBUnMUAeoAHHw,10,10,7,0,5,0,2,0,24,3.4285714285714284,1,0.0,0,7,0,5,10,0,0,2,0,12,12,0
1263,38133,cqdnmjbJq0lDv2xgeKuzXqVr5xQytWr0,SpATywNh6bZuzm8s1ceuBUnMUAeoAHHw,3,2,1,0,0,0,1,0,4,0.5714285714285714,1,0.0,0,1,0,0,2,0,0,1,0,1,3,1
1264,38268,JDTEn5xJLcPCagcpPFhmwRsZ0N8AbJZ6,A3fsA9Zfv1X2fVEQhTw51lKENdNrEqT3,5,4,0,0,0,0,2,0,6,0.8571428571428571,1,0.0,1,0,0,0,3,0,0,2,0,1,5,1
1265,38298,5FKi7MQVDgjqvQXvzQgvsTDVCkGiyjdK,SpATywNh6bZuzm8s1ceuBUnMUAeoAHHw,14,8,6,2,4,0,2,0,22,3.142857142857143,1,0.0,1,6,2,4,7,0,0,2,0,13,9,0
1266,38356,DJeWlgB4cP1RQ3JZLa1wZwd4zgAbYOxv,SpATywNh6bZuzm8s1ceuBUnMUAeoAHHw,12,9,8,0,6,0,1,0,24,3.4285714285714284,1,0.0,0,8,0,6,9,0,0,1,0,14,10,1
1267,38436,v9mjKPlqj9n2M1xFKzFtpQVo3yi6HxGV,A3fsA9Zfv1X2fVEQhTw51lKENdNrEqT3,28,34,22,54,12,0,5,0,127,18.142857142857142,1,0.0,4,22,43,12,30,0,11,5,0,81,46,1
1268,38468,SHRanMph56qnHJKMofxrIA8VyLg99gvL,SpATywNh6bZuzm8s1ceuBUnMUAeoAHHw,8,7,3,0,2,2,4,0,18,2.5714285714285716,1,0.0,0,3,0,2,7,2,0,4,0,5,13,0
1269,38469,kOr03XnYLBaytLqdfTXgh6ll5b7wmEto,SpATywNh6bZuzm8s1ceuBUnMUAeoAHHw,10,6,3,18,0,14,3,1,45,6.428571428571429,1,0.0,2,3,15,0,4,14,3,3,1,20,25,0
1270,38487,G9YOnYlxMjTyBQskKi3FlOCiDMxWpomt,SpATywNh6bZuzm8s1ceuBUnMUAeoAHHw,10,11,5,0,3,0,1,0,20,2.857142857142857,1,0.0,0,5,0,3,11,0,0,1,0,8,12,1
1271,38603,BK89tGWFvtCB5b9BaDDNxW929HW7wR4P,G8EPVSXsOYB5YQWZGiz1aVq5Pgr2GrQu,4,3,1,0,0,0,1,0,5,0.7142857142857143,1,0.0,0,1,0,0,3,0,0,1,0,1,4,0
1272,38604,piuFZPcLrtqUCR4Mz7Dvqp0k5ELkq8NC,G8EPVSXsOYB5YQWZGiz1aVq5Pgr2GrQu,7,4,3,0,2,0,1,0,10,1.4285714285714286,1,0.0,0,3,0,2,4,0,0,1,0,5,5,1
1273,38654,wJIBDD9rPqnYMIKUazC26GmZhLI0Mfvr,RXDvfPUBYFlVdlueBFbLW0mhhAyGEqpt,3,2,1,0,0,0,1,0,4,0.5714285714285714,1,0.0,0,1,0,0,2,0,0,1,0,1,3,1
1274,38691,dCqryZS5yEyDDbYzWpFyoRjFGlVzafA6,SpATywNh6bZuzm8s1ceuBUnMUAeoAHHw,14,10,9,0,4,0,1,0,24,3.4285714285714284,1,0.0,0,9,0,4,10,0,0,1,0,13,11,0
1275,38701,E4KzNEU3ybRlAOiHqHHsGQEXiaxyHgoT,RXDvfPUBYFlVdlueBFbLW0mhhAyGEqpt,2,0,0,0,0,0,2,0,2,0.2857142857142857,1,0.0,0,0,0,0,0,0,0,2,0,0,2,0
1276,38828,RtAy5lws7b5k9geORbL2U1lmgZpp3fVx,SpATywNh6bZuzm8s1ceuBUnMUAeoAHHw,4,5,0,0,0,0,3,0,8,1.1428571428571428,1,0.0,0,0,0,0,5,0,0,3,0,0,8,1
1277,38845,BuxVbSmnOVgkaYnbyCiqICvSSomeF2JH,G8EPVSXsOYB5YQWZGiz1aVq5Pgr2GrQu,5,7,0,0,0,1,2,0,10,1.4285714285714286,1,0.0,0,0,0,0,7,1,0,2,0,0,10,1
1278,38855,uEJhWNudTN4AiJAcLu3Q22sgnPRHYbuv,G8EPVSXsOYB5YQWZGiz1aVq5Pgr2GrQu,16,10,6,34,2,0,8,2,62,8.857142857142858,2,0.0,0,6,31,2,10,0,3,8,2,39,23,0
1279,38907,arTGhRrKZksM4iY72XDJ8i8oBmMABS0m,bWdj2GDclj5ofokWjzoa5jAwMkxCykd6,3,2,1,0,0,0,1,0,4,0.5714285714285714,1,0.0,0,1,0,0,2,0,0,1,0,1,3,1
1280,38920,0a9a6o0rpJD7kzJZwGRL9kB3jevQvRa8,SpATywNh6bZuzm8s1ceuBUnMUAeoAHHw,16,18,0,20,0,4,10,0,52,7.428571428571429,2,0.0,5,0,15,0,13,4,5,10,0,20,32,0
1281,38949,7HiGv3GGo0SXqM9pqC4B8FvUEghdfkna,A3fsA9Zfv1X2fVEQhTw51lKENdNrEqT3,6,0,0,0,0,1,5,0,6,0.8571428571428571,1,0.0,0,0,0,0,0,1,0,5,0,0,6,0
1282,39114,2nqqGgbA0MihvBXBZoRijk6wA6yRTkC8,SpATywNh6bZuzm8s1ceuBUnMUAeoAHHw,19,36,21,14,10,39,10,1,131,18.714285714285715,3,0.0,2,21,13,10,34,39,1,10,1,46,85,1
1283,39164,7GjcmlDBrfMQgiPOO8hsiYQuQLOINerQ,SpATywNh6bZuzm8s1ceuBUnMUAeoAHHw,16,13,7,12,4,0,1,0,37,5.285714285714286,1,0.0,4,7,11,4,9,0,1,1,0,26,11,0
1284,39177,HzHckETSltPKPBe9aHJBFKMPGsxyznRF,RXDvfPUBYFlVdlueBFbLW0mhhAyGEqpt,22,18,9,42,8,0,4,0,81,11.571428571428571,2,0.0,6,9,35,8,12,0,7,4,0,58,23,0
1285,39195,E4KzNEU3ybRlAOiHqHHsGQEXiaxyHgoT,G8EPVSXsOYB5YQWZGiz1aVq5Pgr2GrQu,16,25,7,26,5,0,4,0,67,9.571428571428571,1,0.0,17,7,15,5,8,0,11,4,0,44,23,0
1286,39253,eBPwvAxm4arXAr6DDABCeVRfgkKzrVG9,A3fsA9Zfv1X2fVEQhTw51lKENdNrEqT3,29,22,1,74,0,0,9,0,106,15.142857142857142,2,0.0,4,1,68,0,18,0,6,9,0,73,33,1
1287,39355,z3YnX73v2uoVHmuLGzQD2gKKBoJqIQxK,A3fsA9Zfv1X2fVEQhTw51lKENdNrEqT3,3,2,0,0,0,0,1,0,3,0.42857142857142855,1,0.0,0,0,0,0,2,0,0,1,0,0,3,1
1288,39408,mC2fzvwPaO34Kq32ibCwzrJ2EjHwbRrb,A3fsA9Zfv1X2fVEQhTw51lKENdNrEqT3,19,17,14,0,10,0,5,1,47,6.714285714285714,1,0.0,0,14,0,10,17,0,0,5,1,24,23,1
1289,39416,NiOuJ51IxTtojHMts8OdX2AfCH09G7vK,SpATywNh6bZuzm8s1ceuBUnMUAeoAHHw,6,3,2,0,1,0,2,0,8,1.1428571428571428,1,0.0,0,2,0,1,3,0,0,2,0,3,5,1
1290,39437,YaP2AuckukEZITP3IVvIt6Z8ci6RHew7,A3fsA9Zfv1X2fVEQhTw51lKENdNrEqT3,26,19,17,18,8,0,1,0,63,9.0,1,0.0,0,17,15,8,19,0,3,1,0,40,23,1
1291,39438,PCU2OsmEUaGQvWJWbob5pKb7iiPbQ7ze,SpATywNh6bZuzm8s1ceuBUnMUAeoAHHw,3,2,0,0,0,0,1,0,3,0.42857142857142855,1,0.0,0,0,0,0,2,0,0,1,0,0,3,1
1292,39518,jeuXS3tUDyyNfvbrveLA3P9Aday4J2bg,SpATywNh6bZuzm8s1ceuBUnMUAeoAHHw,16,14,8,13,4,0,3,0,42,6.0,2,0.0,2,8,13,4,12,0,0,3,0,27,15,0
1293,39523,U2HBhhMvJdYJzypYvAaM7auP4hEAIFmE,SpATywNh6bZuzm8s1ceuBUnMUAeoAHHw,16,14,6,17,2,9,6,1,55,7.857142857142857,1,0.0,7,6,15,2,7,9,2,6,1,30,25,0
1294,39528,UPv4XJg0qIN0z1e32NPBqipWdQJZCo5I,G8EPVSXsOYB5YQWZGiz1aVq5Pgr2GrQu,36,26,22,38,13,0,9,0,108,15.428571428571429,2,0.0,0,22,34,13,26,0,4,9,0,69,39,0
1295,39531,ZicPLcC85bFypm3Kcvbq59RwoYBxR8MH,A3fsA9Zfv1X2fVEQhTw51lKENdNrEqT3,3,2,0,0,0,0,1,0,3,0.42857142857142855,1,0.0,0,0,0,0,2,0,0,1,0,0,3,1
1296,39551,iwZaMWnVmB8vAWyB7qgI9UDj7NG1VyL9,G8EPVSXsOYB5YQWZGiz1aVq5Pgr2GrQu,5,8,0,0,0,0,0,0,8,1.1428571428571428,1,0.0,0,0,0,0,8,0,0,0,0,0,8,1
1297,39603,BYn6cWVQSMORsIVShYVRAnnkHpLyiUv8,A3fsA9Zfv1X2fVEQhTw51lKENdNrEqT3,4,3,2,0,0,0,1,0,6,0.8571428571428571,1,0.0,0,2,0,0,3,0,0,1,0,2,4,1
1298,39635,xcD6YWhnGA2xukGmX4eaYrm6VS9ffz1H,SpATywNh6bZuzm8s1ceuBUnMUAeoAHHw,19,17,11,8,5,0,6,0,47,6.714285714285714,1,0.0,2,11,7,5,15,0,1,6,0,25,22,0
1299,39643,IueU0b60sjtimOacIi9j88xjmyRWizli,G8EPVSXsOYB5YQWZGiz1aVq5Pgr2GrQu,10,8,4,12,0,4,6,8,42,6.0,1,0.0,0,4,10,0,8,4,2,6,8,14,28,0
1300,39650,6FzXe5nPWUHRxntREHsQRnp7x1pxuhUz,SpATywNh6bZuzm8s1ceuBUnMUAeoAHHw,16,37,19,6,10,0,5,0,77,11.0,2,0.0,5,19,6,10,32,0,0,5,0,40,37,0
1301,39708,eHl6vKLwTQcSxYHb6DIMnO9xh3WNvHJf,SpATywNh6bZuzm8s1ceuBUnMUAeoAHHw,14,13,6,10,3,0,2,0,34,4.857142857142857,1,0.0,7,6,10,3,6,0,0,2,0,26,8,0
1302,39795,ePUeHwknBJGR0K3G08IRIZccLLyuYW03,SpATywNh6bZuzm8s1ceuBUnMUAeoAHHw,5,5,1,0,0,0,1,0,7,1.0,1,0.0,0,1,0,0,5,0,0,1,0,1,6,1
1303,39840,eTm1NthBlqTXH0yqAhllYK6AeYLcvZS4,SpATywNh6bZuzm8s1ceuBUnMUAeoAHHw,17,13,8,11,4,0,3,0,39,5.571428571428571,2,0.0,4,8,10,4,9,0,1,3,0,26,13,1
1304,39845,xwqLmgu4yZxUsX04FDtQMDL3awvB0E5w,SpATywNh6bZuzm8s1ceuBUnMUAeoAHHw,13,15,7,0,4,0,3,0,29,4.142857142857143,1,0.0,4,7,0,4,11,0,0,3,0,15,14,0
1305,39878,pLB7K8hva7hpUpPIa0JWEXpoyBHIkbAO,SpATywNh6bZuzm8s1ceuBUnMUAeoAHHw,20,23,13,14,4,2,7,1,64,9.142857142857142,1,0.0,6,13,11,4,17,2,3,7,1,34,30,1
1306,39922,2GATpIfDBYFyTgYmFkr0bda9mVfNXuAl,SpATywNh6bZuzm8s1ceuBUnMUAeoAHHw,15,24,0,12,0,11,8,1,56,8.0,2,0.0,3,0,12,0,21,11,0,8,1,15,41,0
1307,39962,p3Cz4BAZGaZT08I2Dwew8OwWDC6PUWgc,SpATywNh6bZuzm8s1ceuBUnMUAeoAHHw,16,13,7,10,4,0,1,0,35,5.0,1,0.0,5,7,10,4,8,0,0,1,0,26,9,1
1308,40026,JlRuZgjmv2hzO83ouspiZFc9FxGockFl,RXDvfPUBYFlVdlueBFbLW0mhhAyGEqpt,7,4,3,0,2,0,1,0,10,1.4285714285714286,1,0.0,0,3,0,2,4,0,0,1,0,5,5,1
1309,40067,p2NSaI2ihMq1kpyPoZO7VVEhFNMs1UZl,G8EPVSXsOYB5YQWZGiz1aVq5Pgr2GrQu,26,12,1,131,1,0,2,0,147,21.0,1,0.0,2,1,110,1,10,0,21,2,0,114,33,0
1310,40073,gT1aUgmAT0anYSW9us4nwhFYETF9WL3j,bWdj2GDclj5ofokWjzoa5jAwMkxCykd6,1,0,0,0,0,0,1,0,1,0.14285714285714285,1,0.0,0,0,0,0,0,0,0,1,0,0,1,1
1311,40125,znkDmOOvUgN8z7Q2bDidRTpqlGavufFM,SpATywNh6bZuzm8s1ceuBUnMUAeoAHHw,17,38,9,18,4,0,4,0,73,10.428571428571429,1,0.0,16,9,17,4,22,0,1,4,0,46,27,0
1312,40165,Vcn2Ncl6KVYaVVug7iW4LScBfpTMatic,RXDvfPUBYFlVdlueBFbLW0mhhAyGEqpt,4,2,0,0,0,0,2,0,4,0.5714285714285714,1,0.0,0,0,0,0,2,0,0,2,0,0,4,1
1313,40178,JhXfd0Tlc69bJyZdJPZXaAHtjoBDG89W,A3fsA9Zfv1X2fVEQhTw51lKENdNrEqT3,6,9,2,0,1,0,3,0,15,2.142857142857143,1,0.0,0,2,0,1,9,0,0,3,0,3,12,0
1314,40207,mVPS8qtXmBYw6oQCHhHlXYGOl1msXZRm,SpATywNh6bZuzm8s1ceuBUnMUAeoAHHw,5,4,1,0,0,0,4,0,9,1.2857142857142858,1,0.0,1,1,0,0,3,0,0,4,0,2,7,1
1315,40237,tBcWnrptNiGaZgy4k51BltzcKki801j1,A3fsA9Zfv1X2fVEQhTw51lKENdNrEqT3,1,0,0,0,0,0,1,0,1,0.14285714285714285,1,0.0,0,0,0,0,0,0,0,1,0,0,1,1
1316,40243,3LBUjm1FFFdQL8moOjwGZJaqcxdpVPTx,SpATywNh6bZuzm8s1ceuBUnMUAeoAHHw,5,5,1,0,1,0,1,0,8,1.1428571428571428,1,0.0,2,1,0,1,3,0,0,1,0,4,4,1
1317,40287,O1a4fHzT6b5r4IWUDa3zddRbshvfRlE4,A3fsA9Zfv1X2fVEQhTw51lKENdNrEqT3,3,4,2,0,0,0,1,0,7,1.0,1,0.0,0,2,0,0,4,0,0,1,0,2,5,1
1318,40335,xLE9ZE3BmJvIiYogSmZ2Qwy8Pm6jvutZ,SpATywNh6bZuzm8s1ceuBUnMUAeoAHHw,16,19,0,18,0,6,8,1,52,7.428571428571429,1,0.0,9,0,15,0,10,6,3,8,1,24,28,0
1319,40347,cC2qlM5WjvVF4gXhZ3ctfElOjyJIEAhi,SpATywNh6bZuzm8s1ceuBUnMUAeoAHHw,2,0,0,0,0,3,1,0,4,0.5714285714285714,1,0.0,0,0,0,0,0,3,0,1,0,0,4,1
1320,40392,zT5Abo7SNHsAkCFKMvhJJJDWNu2sl4mh,SpATywNh6bZuzm8s1ceuBUnMUAeoAHHw,18,22,7,15,4,0,11,0,59,8.428571428571429,1,0.0,2,7,14,4,20,0,1,11,0,27,32,0
1321,40395,55BMoXCnWKUmNoRDU7bcdmqWNuK9JpZ6,bWdj2GDclj5ofokWjzoa5jAwMkxCykd6,4,2,0,0,0,0,2,0,4,0.5714285714285714,1,0.0,0,0,0,0,2,0,0,2,0,0,4,1
1322,40428,RSvPQSF8RarDsP4aI3ftScWWjvINqjc5,A3fsA9Zfv1X2fVEQhTw51lKENdNrEqT3,9,6,5,0,5,0,0,0,16,2.2857142857142856,3,0.0,0,5,0,5,6,0,0,0,0,10,6,1
1323,40441,b11C6Y0UpRSFGpKvHTlz5TF2Rt9ScBoX,SpATywNh6bZuzm8s1ceuBUnMUAeoAHHw,9,11,4,20,0,0,6,1,42,6.0,1,0.0,6,4,16,0,5,0,4,6,1,26,16,0
1324,40704,qmYTrueiQKfoQnGxjqfwlMlw7HOR9CKj,bWdj2GDclj5ofokWjzoa5jAwMkxCykd6,6,6,2,0,0,1,14,2,25,3.5714285714285716,2,0.0,0,2,0,0,6,1,0,14,2,2,23,0
1325,40768,NlHO5hXiy7TmVTHiRgExH6y7p9gJG1YF,SpATywNh6bZuzm8s1ceuBUnMUAeoAHHw,7,4,3,0,2,0,1,0,10,1.4285714285714286,1,0.0,0,3,0,2,4,0,0,1,0,5,5,1
1326,40780,EO0fRulUc32LbMOOGfwwNWyNgnF8pKY9,RXDvfPUBYFlVdlueBFbLW0mhhAyGEqpt,24,24,12,37,8,0,6,0,87,12.428571428571429,1,0.0,10,12,32,8,14,0,5,6,0,62,25,1
1327,40782,eEl2lnEvtyQyZa1YqA2JcBHBfdkh8SHK,SpATywNh6bZuzm8s1ceuBUnMUAeoAHHw,4,2,1,0,0,0,3,0,6,0.8571428571428571,1,0.0,0,1,0,0,2,0,0,3,0,1,5,1
1328,40869,8gfCGxZ6lFjZr89RwPF8oXZs1Qn6Pq6X,A3fsA9Zfv1X2fVEQhTw51lKENdNrEqT3,14,4,3,32,0,0,5,0,44,6.285714285714286,2,0.0,1,3,28,0,3,0,4,5,0,32,12,1
1329,40973,BasnDhJkjNSRVUOCCIoBniAgNajwACiL,SpATywNh6bZuzm8s1ceuBUnMUAeoAHHw,12,11,1,13,0,0,3,0,28,4.0,1,0.0,4,1,13,0,7,0,0,3,0,18,10,0
1330,41010,uOFQjpYGMV24K1kl5khOKpWKqO5hcEHE,7GRhBDsirIGkRZBtSMEzNTyDr2JQm4xx,7,8,2,0,2,0,2,0,14,2.0,1,0.0,0,2,0,2,8,0,0,2,0,4,10,1
1331,41098,luetGJM4RCCEdMBc9OfxVqFFziudg0s4,7GRhBDsirIGkRZBtSMEzNTyDr2JQm4xx,2,0,0,0,0,0,3,0,3,0.42857142857142855,1,0.0,0,0,0,0,0,0,0,3,0,0,3,1
1332,41120,XpdeGVr67ypvPB6NlvDXEjF8wDCu5FS9,7GRhBDsirIGkRZBtSMEzNTyDr2JQm4xx,1,0,0,0,0,0,1,0,1,0.14285714285714285,1,0.0,0,0,0,0,0,0,0,1,0,0,1,1
1333,41133,sIrvXnSy3oMgG36f8e8UxJCnsTfr739w,7GRhBDsirIGkRZBtSMEzNTyDr2JQm4xx,6,3,1,0,1,2,6,0,13,1.8571428571428572,2,0.0,0,1,0,1,3,2,0,6,0,2,11,1
1334,41208,ttoFK5oOPrxtfVxJpGPFCiEs8J6AbuAg,7GRhBDsirIGkRZBtSMEzNTyDr2JQm4xx,2,0,0,0,0,0,2,0,2,0.2857142857142857,1,0.0,0,0,0,0,0,0,0,2,0,0,2,1
1335,41313,muzVsCrsBxqiBPr2RsB5pEdOhDGWWCl3,7GRhBDsirIGkRZBtSMEzNTyDr2JQm4xx,4,3,1,0,1,0,1,0,6,0.8571428571428571,1,0.0,1,1,0,1,2,0,0,1,0,3,3,1
1336,41408,xbPbNw5WluotpcGvfodgid2Z7Rc8OfQr,7GRhBDsirIGkRZBtSMEzNTyDr2JQm4xx,1,0,0,0,0,0,1,0,1,0.14285714285714285,1,0.0,0,0,0,0,0,0,0,1,0,0,1,1
1337,41424,Gn1QSm7WrSyhbej7tThohiyBKeBu1xtD,7GRhBDsirIGkRZBtSMEzNTyDr2JQm4xx,37,45,21,85,12,0,4,0,167,23.857142857142858,2,0.0,20,21,74,12,25,0,11,4,0,127,40,0
1338,41448,we9tWnySpl1G7k7FqyXPj8wmC2gUYK0W,7GRhBDsirIGkRZBtSMEzNTyDr2JQm4xx,1,0,0,0,0,0,1,0,1,0.14285714285714285,1,0.0,0,0,0,0,0,0,0,1,0,0,1,1
1339,41455,emCY4aIQuto3vHDbWyLccdGfPM1ClSuh,7GRhBDsirIGkRZBtSMEzNTyDr2JQm4xx,4,1,0,0,0,0,3,0,4,0.5714285714285714,1,0.0,0,0,0,0,1,0,0,3,0,0,4,1
1340,41589,JXidMLGzH1hCHEXJsiJMrwBekkp4L4vD,7GRhBDsirIGkRZBtSMEzNTyDr2JQm4xx,24,37,17,27,7,0,2,0,90,12.857142857142858,3,0.0,18,17,25,7,19,0,2,2,0,67,23,1
1341,41740,blaKT90TeOTAa2RsAkTxWQqeLxEi93Qu,7GRhBDsirIGkRZBtSMEzNTyDr2JQm4xx,1,0,0,0,0,0,1,0,1,0.14285714285714285,1,0.0,0,0,0,0,0,0,0,1,0,0,1,1
1342,41796,vpQq8XFeke8cuyYAJhpFzjSzZZBP51AP,7GRhBDsirIGkRZBtSMEzNTyDr2JQm4xx,1,0,0,0,0,0,1,0,1,0.14285714285714285,1,0.0,0,0,0,0,0,0,0,1,0,0,1,1
1343,41799,Qqy3TZdyBKfhf7zgHIRI72ZJ5QbTtpkb,7GRhBDsirIGkRZBtSMEzNTyDr2JQm4xx,11,12,4,0,3,0,3,0,22,3.142857142857143,1,0.0,0,4,0,3,12,0,0,3,0,7,15,1
1344,41805,kuZwBvEdgeUtKZ495C2FptBbxEtLtmVH,7GRhBDsirIGkRZBtSMEzNTyDr2JQm4xx,6,11,3,0,2,0,1,0,17,2.4285714285714284,1,0.0,3,3,0,2,8,0,0,1,0,8,9,1
1345,43653,79QUI05RY9ZPkyZ2QTF4ldf0I0DmjbaG,7GRhBDsirIGkRZBtSMEzNTyDr2JQm4xx,5,5,4,0,0,1,1,0,11,1.5714285714285714,1,0.0,0,4,0,0,5,1,0,1,0,4,7,1
1346,43667,YwEhgJrFq2w9QJl2yCPd9xaL0Uk6VujF,7GRhBDsirIGkRZBtSMEzNTyDr2JQm4xx,9,10,1,21,0,0,5,0,37,5.285714285714286,1,0.0,8,1,19,0,2,0,2,5,0,28,9,0
1347,43672,tCqgfXrL2rXAh5RJpLuMHSLSRwrclyuQ,7GRhBDsirIGkRZBtSMEzNTyDr2JQm4xx,25,66,16,34,10,1,4,0,131,18.714285714285715,3,0.0,18,16,30,10,48,1,4,4,0,74,57,0
1348,43685,Up0igPeMCPcrrFPZ1HsfM8Bq5rwAfYwv,7GRhBDsirIGkRZBtSMEzNTyDr2JQm4xx,17,16,6,20,8,5,1,0,56,8.0,1,0.0,9,6,18,8,7,5,2,1,0,41,15,0
1349,43700,z4NoXHrcgkhn7BypZflRO6Tgobh52UXj,7GRhBDsirIGkRZBtSMEzNTyDr2JQm4xx,20,45,12,34,0,11,8,0,110,15.714285714285714,2,0.0,22,12,27,0,23,11,7,8,0,61,49,0
1350,43713,KjugBA6V5bkEA5fAIbJoGnSUlDhZoaIH,7GRhBDsirIGkRZBtSMEzNTyDr2JQm4xx,37,51,14,50,10,2,12,2,141,20.142857142857142,1,0.0,20,14,43,10,31,2,7,12,2,87,54,0
1351,44007,oPl0NnurlzpABskP5WrrITS0Jx7a7lgG,fbPkOYLVPtPgIt0MxizjfFJov3JbHyAi,5,3,2,0,1,0,1,0,7,1.0,1,0.0,0,2,0,1,3,0,0,1,0,3,4,1
1352,44008,uISGM4LqBUfXPHskRZuSs9XeQkD4VUeT,fbPkOYLVPtPgIt0MxizjfFJov3JbHyAi,18,31,15,10,9,7,2,0,74,10.571428571428571,2,0.0,13,15,9,9,18,7,1,2,0,46,28,1
1353,44015,NHPpKvbnrSpxM8e1DORBWJbRCpmrxZw8,fbPkOYLVPtPgIt0MxizjfFJov3JbHyAi,9,7,4,0,2,0,4,0,17,2.4285714285714284,2,0.0,2,4,0,2,5,0,0,4,0,8,9,1
1354,44079,L5pA3H7m2qYFia4DHW15gmoKoflabQUC,fbPkOYLVPtPgIt0MxizjfFJov3JbHyAi,7,6,4,0,2,7,2,0,21,3.0,1,0.0,0,4,0,2,6,7,0,2,0,6,15,1
1355,44131,dzaUNwKZy91BtYj96fOhuSgIlp9lXQDU,fbPkOYLVPtPgIt0MxizjfFJov3JbHyAi,44,66,31,21,22,46,19,0,205,29.285714285714285,4,0.0,19,31,19,22,47,46,2,19,0,91,114,0
1356,44152,ckUgzG88eR58uy370LgSc7zPpsWm2L4O,fbPkOYLVPtPgIt0MxizjfFJov3JbHyAi,7,4,2,0,1,0,2,0,9,1.2857142857142858,1,0.0,0,2,0,1,4,0,0,2,0,3,6,1
1357,44155,ufy4LHvMWo0whrRq15door8x99FGdY4J,fbPkOYLVPtPgIt0MxizjfFJov3JbHyAi,7,13,6,3,0,4,0,0,26,3.7142857142857144,2,0.0,6,6,3,0,7,4,0,0,0,15,11,1
1358,44159,tfcOvcMIVTpughZ66Us0P1WhX9cxijTo,fbPkOYLVPtPgIt0MxizjfFJov3JbHyAi,3,2,1,0,0,0,1,0,4,0.5714285714285714,1,0.0,0,1,0,0,2,0,0,1,0,1,3,1
1359,44192,c1zULVJb8UrzwaeCwQXbXVIx3xb2chrp,fbPkOYLVPtPgIt0MxizjfFJov3JbHyAi,1,0,0,0,0,0,1,0,1,0.14285714285714285,1,0.0,0,0,0,0,0,0,0,1,0,0,1,0
1360,44220,hy5uxKEcxvtHS3tlaeM1vWwbo38Hj0n0,fbPkOYLVPtPgIt0MxizjfFJov3JbHyAi,6,8,4,0,2,6,1,0,21,3.0,1,0.0,0,4,0,2,8,6,0,1,0,6,15,0
1361,44221,JBImmJkUH6RU5EuKvs04Gb9Ih8CxmZjg,fbPkOYLVPtPgIt0MxizjfFJov3JbHyAi,2,0,0,0,0,0,4,0,4,0.5714285714285714,1,0.0,0,0,0,0,0,0,0,4,0,0,4,1
1362,44226,VYNucadxJwAl4oUfBMF6a5hY4ZvYaLjQ,fbPkOYLVPtPgIt0MxizjfFJov3JbHyAi,20,37,10,24,8,1,3,0,83,11.857142857142858,1,0.0,24,10,22,8,13,1,2,3,0,64,19,1
1363,44231,AQMZ0ecVv6yIj8PNV5GC8bjPJquyjuSz,fbPkOYLVPtPgIt0MxizjfFJov3JbHyAi,6,5,2,0,1,0,2,1,11,1.5714285714285714,1,0.0,0,2,0,1,5,0,0,2,1,3,8,1
1364,44245,Qs9VQJkriDZBH3FlG0bgTumvMa49MEaO,fbPkOYLVPtPgIt0MxizjfFJov3JbHyAi,15,56,19,7,23,2,6,0,113,16.142857142857142,4,0.0,17,19,6,23,39,2,1,6,0,65,48,0
1365,44250,g1tIXPWfZhmnEZEG9z52U31YrMwRUSiT,fbPkOYLVPtPgIt0MxizjfFJov3JbHyAi,14,19,8,12,8,2,7,1,57,8.142857142857142,1,0.0,8,8,8,8,11,2,4,7,1,32,25,1
1366,44254,DxX4QPcfDwxjWtFJm5EFgLobXDWqAEqS,fbPkOYLVPtPgIt0MxizjfFJov3JbHyAi,5,3,2,0,1,0,1,0,7,1.0,1,0.0,0,2,0,1,3,0,0,1,0,3,4,1
1367,44259,v5DL1tRN6AvAeQThFmEHNCo6sn5M6uIG,fbPkOYLVPtPgIt0MxizjfFJov3JbHyAi,5,4,3,0,0,0,3,0,10,1.4285714285714286,1,0.0,0,3,0,0,4,0,0,3,0,3,7,1
1368,44261,JaD7mqaE0bkEF64A4nrAbGGFeYQR80Ys,fbPkOYLVPtPgIt0MxizjfFJov3JbHyAi,8,10,2,5,2,0,0,0,19,2.7142857142857144,2,0.0,6,2,4,2,4,0,1,0,0,14,5,1
1369,44266,8LoJ3UkmcZEmQsx5Wwgf18vm50gv36wN,fbPkOYLVPtPgIt0MxizjfFJov3JbHyAi,20,15,7,13,6,0,2,0,43,6.142857142857143,1,0.0,7,7,12,6,8,0,1,2,0,32,11,1
1370,44309,LLsy8k18PLzqaAWgeu3HZsydISuZ18ow,fbPkOYLVPtPgIt0MxizjfFJov3JbHyAi,15,23,8,9,9,0,3,0,52,7.428571428571429,2,0.0,10,8,6,9,13,0,3,3,0,33,19,1
1371,45360,n2Bw3Z0s4Gtstp5ZMzZilJIZC4rZeeNT,RXDvfPUBYFlVdlueBFbLW0mhhAyGEqpt,14,13,10,0,6,0,6,0,35,5.0,1,0.0,0,10,0,6,13,0,0,6,0,16,19,0
1372,45577,JXWz1gOpRnT7ZzNBuPorM6sgihC1HCez,G8EPVSXsOYB5YQWZGiz1aVq5Pgr2GrQu,12,9,3,10,1,1,4,1,29,4.142857142857143,1,0.0,5,3,9,1,4,1,1,4,1,18,11,1
1373,45614,aCMLJ0A5ki1G82R2CtOxjr8OrznWuiC4,RXDvfPUBYFlVdlueBFbLW0mhhAyGEqpt,3,2,1,0,0,0,1,0,4,0.5714285714285714,1,0.0,0,1,0,0,2,0,0,1,0,1,3,0
1374,46068,H3iVkRV8UPZvsbvYrU1dnbX51IlHemsF,RXDvfPUBYFlVdlueBFbLW0mhhAyGEqpt,5,3,1,0,1,0,1,0,6,0.8571428571428571,1,0.0,0,1,0,1,3,0,0,1,0,2,4,0
1375,46437,TOrqBZDp9GjgXoTZI9iOS0r8wbO7CyB1,RXDvfPUBYFlVdlueBFbLW0mhhAyGEqpt,5,2,1,0,1,2,2,0,8,1.1428571428571428,1,0.0,0,1,0,1,2,2,0,2,0,2,6,0
1376,46479,xSwC5YVwlqQI12zsRbCFcdEzFRC8jvLt,fbPkOYLVPtPgIt0MxizjfFJov3JbHyAi,36,160,11,28,9,114,29,2,353,50.42857142857143,5,0.0,59,11,27,9,101,114,1,29,2,106,247,1
1377,46480,MtDn5Hc2NrJY0NIN3hUo3bzbe51wyoG1,fbPkOYLVPtPgIt0MxizjfFJov3JbHyAi,6,2,1,0,1,0,4,0,8,1.1428571428571428,1,0.0,0,1,0,1,2,0,0,4,0,2,6,1
1378,46486,XYKEbaRABcMuBHmMB2I3YkBepzCp0swB,fbPkOYLVPtPgIt0MxizjfFJov3JbHyAi,21,55,2,17,11,56,11,1,153,21.857142857142858,3,0.0,28,2,12,11,27,56,5,11,1,53,100,1
1379,46488,5VcQW1dsZO9SFTtQE9ieV8dTnE3WZtAH,fbPkOYLVPtPgIt0MxizjfFJov3JbHyAi,42,95,26,39,16,1,14,4,195,27.857142857142858,3,0.0,24,26,33,16,71,1,6,14,4,99,96,1
1380,46490,GFOtGeWpej2vOEFvAlaIiOAxIuydKL8r,fbPkOYLVPtPgIt0MxizjfFJov3JbHyAi,1,0,0,0,0,0,1,0,1,0.14285714285714285,1,0.0,0,0,0,0,0,0,0,1,0,0,1,1
1381,46491,5DtI3jRGKF8MjArBAkeRlZ7S3llvU9hJ,fbPkOYLVPtPgIt0MxizjfFJov3JbHyAi,13,15,11,0,8,0,12,0,46,6.571428571428571,1,0.0,1,11,0,8,14,0,0,12,0,20,26,1
1382,46493,ZSamATIYC2PRfbcHh6ixkqUmlwzHYO9B,fbPkOYLVPtPgIt0MxizjfFJov3JbHyAi,7,2,1,0,1,4,4,2,14,2.0,1,0.0,0,1,0,1,2,4,0,4,2,2,12,1
1383,46495,kyoxb5V3l4e9xHjLzGcc4Zkj5x5jcbib,fbPkOYLVPtPgIt0MxizjfFJov3JbHyAi,27,30,16,29,14,11,5,1,106,15.142857142857142,2,0.0,12,16,21,14,18,11,8,5,1,63,43,1
1384,46497,S3wWlLKFbpoawwphxIy6q8DO9Rbo9Vr2,fbPkOYLVPtPgIt0MxizjfFJov3JbHyAi,2,0,0,0,0,0,2,0,2,0.2857142857142857,1,0.0,0,0,0,0,0,0,0,2,0,0,2,1
1385,46499,lRdsv9fYLnIcUL3TBjBQriZ2JWdvMb3q,fbPkOYLVPtPgIt0MxizjfFJov3JbHyAi,11,14,5,7,8,0,8,0,42,6.0,1,0.0,8,5,5,8,6,0,2,8,0,26,16,1
1386,46502,1jF4i27HOUbotwD2J9eQl8mWP4HNYpQb,fbPkOYLVPtPgIt0MxizjfFJov3JbHyAi,7,6,3,0,2,0,5,1,17,2.4285714285714284,1,0.0,1,3,0,2,5,0,0,5,1,6,11,1
1387,46506,zFt7rS5Ni4X3ECj04tcq3nH3EFoFZ84i,fbPkOYLVPtPgIt0MxizjfFJov3JbHyAi,6,5,2,0,2,0,2,0,11,1.5714285714285714,1,0.0,0,2,0,2,5,0,0,2,0,4,7,1
1388,46507,PCZm3QTx838vIR2ddmMUqYGr7hfCHZlX,fbPkOYLVPtPgIt0MxizjfFJov3JbHyAi,1,0,0,0,0,0,2,0,2,0.2857142857142857,1,0.0,0,0,0,0,0,0,0,2,0,0,2,1
1389,46508,sRnzromKdYo1GrGgSS37szKdSdhGa5G6,fbPkOYLVPtPgIt0MxizjfFJov3JbHyAi,18,10,9,0,8,0,2,0,29,4.142857142857143,1,0.0,0,9,0,8,10,0,0,2,0,17,12,1
1390,46509,wUS4QMZENKgcJOovrFGfoZniw3fDJWWg,fbPkOYLVPtPgIt0MxizjfFJov3JbHyAi,25,31,18,8,6,18,24,1,106,15.142857142857142,5,0.0,7,18,8,6,24,18,0,24,1,39,67,0
1391,46510,vCnaR7A3EMdV2eOQ4pBMh0byIjK5VwLE,fbPkOYLVPtPgIt0MxizjfFJov3JbHyAi,13,25,12,0,1,4,6,0,48,6.857142857142857,1,0.0,0,12,0,1,25,4,0,6,0,13,35,1
1392,46521,oSHVr2wJcX30QpIU9UqknqqlABAuhq3p,fbPkOYLVPtPgIt0MxizjfFJov3JbHyAi,8,4,3,0,2,0,7,0,16,2.2857142857142856,1,0.0,0,3,0,2,4,0,0,7,0,5,11,1
1393,46525,8leBy69GlSv8dJWktFbENy7QX7XuxXJV,fbPkOYLVPtPgIt0MxizjfFJov3JbHyAi,1,0,0,0,0,0,1,0,1,0.14285714285714285,1,0.0,0,0,0,0,0,0,0,1,0,0,1,1
1394,46528,0WR29JaRQtT4k6Qay1AHwZZo1wPFV6rM,fbPkOYLVPtPgIt0MxizjfFJov3JbHyAi,8,3,2,0,2,0,3,0,10,1.4285714285714286,1,0.0,0,2,0,2,3,0,0,3,0,4,6,1
1395,46532,iWEmpult7cdvgdjFW97TkROBvpRLqQNG,fbPkOYLVPtPgIt0MxizjfFJov3JbHyAi,1,0,0,0,0,0,1,0,1,0.14285714285714285,1,0.0,0,0,0,0,0,0,0,1,0,0,1,1
1396,46535,fdzq5tofwv4sAm3YqrsC6AMOnGl1oPA0,fbPkOYLVPtPgIt0MxizjfFJov3JbHyAi,26,48,1,18,9,13,20,2,111,15.857142857142858,3,0.0,25,1,15,9,23,13,3,20,2,50,61,1
1397,46537,TPC5VVSAcF8gFV38c4L30rHoJE6Gnwyt,fbPkOYLVPtPgIt0MxizjfFJov3JbHyAi,1,0,0,0,0,0,1,0,1,0.14285714285714285,1,0.0,0,0,0,0,0,0,0,1,0,0,1,1
1398,46538,PUFh3BsQaDVIJMDvwsFTqkrgAzvjO9ME,fbPkOYLVPtPgIt0MxizjfFJov3JbHyAi,5,4,2,0,1,0,1,0,8,1.1428571428571428,1,0.0,0,2,0,1,4,0,0,1,0,3,5,1
1399,46539,5lKHsIfbHqFuRTaXGCcOvuWTQPnbutQz,fbPkOYLVPtPgIt0MxizjfFJov3JbHyAi,14,16,4,4,8,5,13,1,51,7.285714285714286,1,0.0,10,4,3,8,6,5,1,13,1,25,26,1
1400,46542,pSw6NR4rsSse1CEq7lXuqdp47AxBAOW4,fbPkOYLVPtPgIt0MxizjfFJov3JbHyAi,12,8,5,6,4,0,5,0,28,4.0,1,0.0,1,5,5,4,7,0,1,5,0,15,13,1
1401,46545,z5vRcYNQa59xIDqKogHjXQX8tInd0ezN,fbPkOYLVPtPgIt0MxizjfFJov3JbHyAi,7,4,3,0,0,0,4,1,12,1.7142857142857142,1,0.0,0,3,0,0,4,0,0,4,1,3,9,1
1402,46546,RxVWvRN6nC74h4K2UUaoi1CZPrOsRdzT,fbPkOYLVPtPgIt0MxizjfFJov3JbHyAi,10,4,3,0,3,0,3,0,13,1.8571428571428572,1,0.0,0,3,0,3,4,0,0,3,0,6,7,1
1403,46548,85Gd0egbITBoZ0qf12CC4QmkR1r0ZNfP,fbPkOYLVPtPgIt0MxizjfFJov3JbHyAi,1,0,0,0,0,0,1,0,1,0.14285714285714285,1,0.0,0,0,0,0,0,0,0,1,0,0,1,1
1404,46551,kWet01DzGE5Z1z6FwJt5yEexIuvkBhsh,fbPkOYLVPtPgIt0MxizjfFJov3JbHyAi,4,2,1,0,0,0,2,0,5,0.7142857142857143,1,0.0,0,1,0,0,2,0,0,2,0,1,4,0
1405,46553,3iTz6LNdmrAf4N1vHZusHFiE1Zs4S5Tp,fbPkOYLVPtPgIt0MxizjfFJov3JbHyAi,14,9,5,0,4,1,6,2,27,3.857142857142857,1,0.0,2,5,0,4,7,1,0,6,2,11,16,1
1406,46554,XDsU9hjOJ2JutIT7BD3Uu690qeQfLlzy,fbPkOYLVPtPgIt0MxizjfFJov3JbHyAi,8,6,4,0,3,0,6,0,19,2.7142857142857144,1,0.0,0,4,0,3,6,0,0,6,0,7,12,0
1407,46563,jeCWCRGTMsRbs6OIyOwUGbeuGaxOlgRf,fbPkOYLVPtPgIt0MxizjfFJov3JbHyAi,8,6,3,0,4,0,3,0,16,2.2857142857142856,2,0.0,2,3,0,4,4,0,0,3,0,9,7,1
1408,46572,ot3QeXNrfLK0N6qyT4MMuMtdNheYtJct,fbPkOYLVPtPgIt0MxizjfFJov3JbHyAi,7,2,1,0,1,2,4,1,11,1.5714285714285714,1,0.0,0,1,0,1,2,2,0,4,1,2,9,1
1409,46575,Qo1OAp8GglCOhKICbcJQhmG7Ih2RNYzD,fbPkOYLVPtPgIt0MxizjfFJov3JbHyAi,2,0,0,0,0,0,4,0,4,0.5714285714285714,1,0.0,0,0,0,0,0,0,0,4,0,0,4,1
1410,46583,oIYeGNswP9C35pzco2q8t5ZyALp7umIE,fbPkOYLVPtPgIt0MxizjfFJov3JbHyAi,1,0,0,0,0,0,1,0,1,0.14285714285714285,1,0.0,0,0,0,0,0,0,0,1,0,0,1,1
1411,46584,l6QkvTQevuUo95YVKmMOiOhmjs3kJ3PF,fbPkOYLVPtPgIt0MxizjfFJov3JbHyAi,1,0,0,0,0,0,1,0,1,0.14285714285714285,1,0.0,0,0,0,0,0,0,0,1,0,0,1,1
1412,46586,2sZGSeEPKMgpuspPc9ln3wAme2MWPynt,fbPkOYLVPtPgIt0MxizjfFJov3JbHyAi,1,0,0,0,0,0,1,0,1,0.14285714285714285,1,0.0,0,0,0,0,0,0,0,1,0,0,1,1
1413,46591,XQCUbONg6Qt5ssh0BzFokuANDDKZfnIv,fbPkOYLVPtPgIt0MxizjfFJov3JbHyAi,8,12,0,2,0,0,1,0,15,2.142857142857143,2,0.0,1,0,2,0,11,0,0,1,0,3,12,1
1414,46592,6EsKULTJVMq3E9IpeZllE0vOQuFiZwCm,fbPkOYLVPtPgIt0MxizjfFJov3JbHyAi,1,0,0,0,0,0,1,0,1,0.14285714285714285,1,0.0,0,0,0,0,0,0,0,1,0,0,1,1
1415,46594,43LGAyiQH2Nct9LoZlyA6wH2hSGoRMei,fbPkOYLVPtPgIt0MxizjfFJov3JbHyAi,1,0,0,0,0,0,1,0,1,0.14285714285714285,1,0.0,0,0,0,0,0,0,0,1,0,0,1,1
1416,47712,ilWzYGLWBh9DSc1MV8g2C4Go5wDNgUHX,7GRhBDsirIGkRZBtSMEzNTyDr2JQm4xx,30,22,7,30,9,20,3,0,91,13.0,1,0.0,14,7,26,9,8,20,4,3,0,56,35,1
1417,47737,kqS8BwWN9R1093oeblGkvtCsQJ68Gh0G,7GRhBDsirIGkRZBtSMEzNTyDr2JQm4xx,3,2,1,0,0,0,1,0,4,0.5714285714285714,1,0.0,0,1,0,0,2,0,0,1,0,1,3,1
1418,47748,kBcjUv7wCsLl51XfcJpKl8Rz4VIbTmWw,fbPkOYLVPtPgIt0MxizjfFJov3JbHyAi,10,6,3,1,1,0,4,0,15,2.142857142857143,2,0.0,1,3,1,1,5,0,0,4,0,6,9,1
1419,47760,jWh61XkRTjwdqASpqvrGaFWBIry4gjxu,fbPkOYLVPtPgIt0MxizjfFJov3JbHyAi,4,2,1,0,1,0,1,0,5,0.7142857142857143,1,0.0,0,1,0,1,2,0,0,1,0,2,3,1
1420,47770,KO9zYaiac2CNagQLdx3aJ9c2fXXMgIJX,fbPkOYLVPtPgIt0MxizjfFJov3JbHyAi,14,12,8,0,4,2,6,1,33,4.714285714285714,4,0.0,0,8,0,4,12,2,0,6,1,12,21,0
1421,47794,lQ3NA8rIFeBdMYWA2lzeVtp3TG4uBQXU,fbPkOYLVPtPgIt0MxizjfFJov3JbHyAi,8,17,10,6,10,0,1,0,44,6.285714285714286,1,0.0,3,10,4,10,14,0,2,1,0,27,17,1
1422,47809,LwiFBYAg8FxzttVYXUksrgMfJRvI4SFJ,fbPkOYLVPtPgIt0MxizjfFJov3JbHyAi,8,8,4,0,0,1,6,0,19,2.7142857142857144,1,0.0,1,4,0,0,7,1,0,6,0,5,14,1
1423,47810,ZQszEDvefL66DoX1xrFttL5Z99UGUgJi,fbPkOYLVPtPgIt0MxizjfFJov3JbHyAi,8,11,7,1,1,36,3,0,59,8.428571428571429,2,0.0,1,7,1,1,10,36,0,3,0,10,49,0
1424,47812,FQ1LFgTnlxgM163pJYQ8F6cnOancinCK,fbPkOYLVPtPgIt0MxizjfFJov3JbHyAi,5,5,0,1,1,0,1,0,8,1.1428571428571428,1,0.0,2,0,1,1,3,0,0,1,0,4,4,1
1425,47816,JyOwpTqxlZyOZXFXAlv3kcbVV4zSYrRf,fbPkOYLVPtPgIt0MxizjfFJov3JbHyAi,8,4,2,0,2,0,2,0,10,1.4285714285714286,1,0.0,0,2,0,2,4,0,0,2,0,4,6,1
1426,47817,5NX0UTrEG0Nosf3C8odmhhCWYxUKxKSk,fbPkOYLVPtPgIt0MxizjfFJov3JbHyAi,5,2,1,0,1,0,2,0,6,0.8571428571428571,1,0.0,0,1,0,1,2,0,0,2,0,2,4,1
1427,47818,4aUZNrEysB01BTDaMjEoJUWN7ca7RotB,fbPkOYLVPtPgIt0MxizjfFJov3JbHyAi,12,12,4,2,5,0,5,0,28,4.0,1,0.0,6,4,2,5,6,0,0,5,0,17,11,1
1428,47820,ZJVdccRSVGtL7lRrhASOIKDRLk41rGEl,fbPkOYLVPtPgIt0MxizjfFJov3JbHyAi,8,5,3,0,2,0,2,0,12,1.7142857142857142,1,0.0,0,3,0,2,5,0,0,2,0,5,7,1
1429,47822,T0bX8618p1zppaN2AzjlfD61pjXKKkDP,fbPkOYLVPtPgIt0MxizjfFJov3JbHyAi,2,0,0,0,0,0,2,0,2,0.2857142857142857,1,0.0,0,0,0,0,0,0,0,2,0,0,2,1
1430,47824,wwifhf2JKuRRsCekTCD33hbtOjxoHPnW,fbPkOYLVPtPgIt0MxizjfFJov3JbHyAi,44,75,34,33,25,34,8,0,209,29.857142857142858,4,0.0,36,34,27,25,39,34,6,8,0,122,87,1
1431,47826,6cy8BWaUGaMCAOjojQczbStvsRKYISdK,fbPkOYLVPtPgIt0MxizjfFJov3JbHyAi,7,5,3,0,1,0,6,0,15,2.142857142857143,3,0.0,0,3,0,1,5,0,0,6,0,4,11,1
1432,47828,W7e0QUNKaRKq7UxQ0gmzqrmRmeubAvn2,fbPkOYLVPtPgIt0MxizjfFJov3JbHyAi,5,2,1,0,1,0,2,0,6,0.8571428571428571,1,0.0,0,1,0,1,2,0,0,2,0,2,4,1
1433,47838,bJNzzdFbeXF3gRIHxGK6VlbnTQeUffyz,fbPkOYLVPtPgIt0MxizjfFJov3JbHyAi,10,12,3,4,5,0,4,0,28,4.0,1,0.0,7,3,3,5,5,0,1,4,0,18,10,1
1434,47839,ymWpwD3GRW9ut1JiVBQeAWpoDiatjwOa,fbPkOYLVPtPgIt0MxizjfFJov3JbHyAi,12,9,6,3,4,5,1,0,28,4.0,1,0.0,2,6,3,4,7,5,0,1,0,15,13,1
1435,47846,DUdBmTRQYTDfiJ48gpt3WzQELlnWqHAt,fbPkOYLVPtPgIt0MxizjfFJov3JbHyAi,27,34,21,15,17,36,16,1,140,20.0,4,0.0,8,21,12,17,26,36,3,16,1,58,82,1
1436,47848,bo0kzQtcVPpunN4Y9LfeiFpB6omq1iOi,fbPkOYLVPtPgIt0MxizjfFJov3JbHyAi,1,0,0,0,0,0,1,0,1,0.14285714285714285,1,0.0,0,0,0,0,0,0,0,1,0,0,1,1
1437,47850,EA93zC2FZSfWuUTy2fGF8qAEwUDl0X8s,fbPkOYLVPtPgIt0MxizjfFJov3JbHyAi,13,19,11,4,4,6,3,0,47,6.714285714285714,3,0.0,5,11,3,4,14,6,1,3,0,23,24,1
1438,47853,ZZRh21sVolimyM3CDUIIgG9cuzaZauji,fbPkOYLVPtPgIt0MxizjfFJov3JbHyAi,28,32,18,21,7,23,9,1,111,15.857142857142858,4,0.0,9,18,17,7,23,23,4,9,1,51,60,1
1439,47861,DIrQamaTjjU1PZti9ZjQXTxfEYtPLnQl,fbPkOYLVPtPgIt0MxizjfFJov3JbHyAi,29,48,26,19,13,3,14,1,124,17.714285714285715,3,0.0,12,26,15,13,36,3,4,14,1,66,58,1
1440,47894,Rz28tFT5qYZaEQ78Ly3OdJx8TpvsmLBy,bWdj2GDclj5ofokWjzoa5jAwMkxCykd6,9,9,6,0,1,0,6,0,22,3.142857142857143,1,0.0,0,6,0,1,9,0,0,6,0,7,15,0
1441,47900,t8SjYilFMTCG5Wi1o6mcbWFbM7fvPbYd,SpATywNh6bZuzm8s1ceuBUnMUAeoAHHw,29,36,23,12,16,0,4,0,91,13.0,2,0.0,9,23,12,16,27,0,0,4,0,60,31,0
1442,47938,szUZ2QsyqJuXPgyS49q35y1kTVrrBlKT,SpATywNh6bZuzm8s1ceuBUnMUAeoAHHw,21,55,20,30,9,0,6,1,121,17.285714285714285,1,0.0,24,20,23,9,31,0,7,6,1,76,45,0
1443,48018,xecOK3aJ3hCti9mz2pAAcwSq9d1S8ATw,SpATywNh6bZuzm8s1ceuBUnMUAeoAHHw,14,27,1,22,0,0,5,1,56,8.0,1,0.0,8,1,21,0,19,0,1,5,1,30,26,0
1444,48093,23GFMJXBCJBMscnU5tVwAanleKYVql9b,SpATywNh6bZuzm8s1ceuBUnMUAeoAHHw,19,37,24,21,12,32,14,1,141,20.142857142857142,4,0.0,5,24,19,12,32,32,2,14,1,60,81,0
1445,48246,ieR2oDuOBOWrOSx08B7vLKsdvt41Kjgw,A3fsA9Zfv1X2fVEQhTw51lKENdNrEqT3,9,14,1,0,1,0,1,0,17,2.4285714285714284,1,0.0,1,1,0,1,13,0,0,1,0,3,14,0
1446,48261,wi7Ze896VO17gMeNUgqgfOVbxlFbfvaK,SpATywNh6bZuzm8s1ceuBUnMUAeoAHHw,19,34,18,12,9,2,12,2,89,12.714285714285714,3,0.0,2,18,9,9,32,2,3,12,2,38,51,0
1447,48370,3HC1D1DG8BjKUNFZlgm7gcIQVOGrzi6J,SpATywNh6bZuzm8s1ceuBUnMUAeoAHHw,20,30,18,0,10,29,4,0,91,13.0,2,0.0,9,18,0,10,21,29,0,4,0,37,54,0
1448,48386,5jz6qtmzJGoTjjzPCohz2U8oEp7qiszP,SpATywNh6bZuzm8s1ceuBUnMUAeoAHHw,18,19,8,16,6,4,6,1,60,8.571428571428571,2,0.0,5,8,13,6,14,4,3,6,1,32,28,0
1449,48446,QIQR6VwK3cpUKM5lDzadEKeQATM23w8z,A3fsA9Zfv1X2fVEQhTw51lKENdNrEqT3,1,0,0,0,0,0,1,0,1,0.14285714285714285,1,0.0,0,0,0,0,0,0,0,1,0,0,1,1
1450,48484,HsuSSkmNEe51pmwRC4MuavuxD1n89icY,SpATywNh6bZuzm8s1ceuBUnMUAeoAHHw,10,3,2,0,2,6,6,1,20,2.857142857142857,1,0.0,0,2,0,2,3,6,0,6,1,4,16,1
1451,48570,VTFDw2vJ6rzCiyEGWQUVkoldm7wzhtYa,SpATywNh6bZuzm8s1ceuBUnMUAeoAHHw,18,31,15,0,8,6,8,0,68,9.714285714285714,3,0.0,10,15,0,8,21,6,0,8,0,33,35,1
1452,48587,v6QLYqOum8NXSX8h0M5DMTP0vkr2qfHa,SpATywNh6bZuzm8s1ceuBUnMUAeoAHHw,32,82,39,24,18,117,36,1,317,45.285714285714285,7,0.0,26,39,24,18,56,117,0,36,1,107,210,0
1453,48617,LSvU72CFq1TrHd9SCZOiKQ0qcV2oa2Ok,A3fsA9Zfv1X2fVEQhTw51lKENdNrEqT3,6,12,1,0,1,0,4,0,18,2.5714285714285716,3,0.0,0,1,0,1,12,0,0,4,0,2,16,0
1454,48643,RCdcltNaQLfcoxT7YKTjQxAYUbCmzzKd,SpATywNh6bZuzm8s1ceuBUnMUAeoAHHw,16,10,7,16,4,3,1,0,41,5.857142857142857,1,0.0,2,7,14,4,8,3,2,1,0,27,14,0
1455,48701,z4snJqWxxByo4wMmQ2g1knGwZpMDrb1I,SpATywNh6bZuzm8s1ceuBUnMUAeoAHHw,11,25,16,0,15,0,0,0,56,8.0,3,0.0,0,16,0,15,25,0,0,0,0,31,25,0
1456,48851,U2YEyQJ6vRjLD9a41Fy3cKvRrxCg3qKu,SpATywNh6bZuzm8s1ceuBUnMUAeoAHHw,12,25,15,16,1,2,12,0,71,10.142857142857142,2,0.0,3,15,14,1,22,2,2,12,0,33,38,0
1457,48957,7xLRAUzJSfSBonILgUC8oEWPnbxwGYvj,RXDvfPUBYFlVdlueBFbLW0mhhAyGEqpt,14,20,1,0,1,0,1,0,23,3.2857142857142856,1,0.0,0,1,0,1,20,0,0,1,0,2,21,1
1458,48968,3Y0bPm3E3Ch9XQ8h4cbV56DUaTL5U5qc,SpATywNh6bZuzm8s1ceuBUnMUAeoAHHw,11,9,7,0,0,1,7,1,25,3.5714285714285716,1,0.0,0,7,0,0,9,1,0,7,1,7,18,0
1459,48988,n0HFF3TwqKuBMzzkdLCbvb8Mji5ZUnVX,bWdj2GDclj5ofokWjzoa5jAwMkxCykd6,4,2,1,0,1,0,1,0,5,0.7142857142857143,1,0.0,0,1,0,1,2,0,0,1,0,2,3,0
1460,49082,21PlIQxHvCIRuT4YC0IvZYCzvQ1GOkuQ,SpATywNh6bZuzm8s1ceuBUnMUAeoAHHw,5,3,1,0,1,0,1,0,6,0.8571428571428571,1,0.0,0,1,0,1,3,0,0,1,0,2,4,1
1461,49176,NPHytleW9ri0zHSbUOwP2d33PRO3w2MK,SpATywNh6bZuzm8s1ceuBUnMUAeoAHHw,12,10,5,14,1,7,3,0,40,5.714285714285714,2,0.0,3,5,14,1,7,7,0,3,0,23,17,0
1462,49183,TNa2CwMEhRRkLaiFBsLLeLu23oFHBijc,SpATywNh6bZuzm8s1ceuBUnMUAeoAHHw,14,14,1,13,1,0,4,0,33,4.714285714285714,3,0.0,2,1,10,1,12,0,3,4,0,14,19,0
1463,49202,l70wRZ2DS0s6LjbT7C4gRoGrF27x9p2H,A3fsA9Zfv1X2fVEQhTw51lKENdNrEqT3,44,27,0,92,0,12,17,0,148,21.142857142857142,4,0.0,4,0,88,0,23,12,4,17,0,92,56,1
1464,49254,Hw8jmGp4VI4tAz6cfKhHDOeLB2t7MJ9z,SpATywNh6bZuzm8s1ceuBUnMUAeoAHHw,12,13,7,6,0,20,4,0,50,7.142857142857143,3,0.0,4,7,6,0,9,20,0,4,0,17,33,1
1465,49302,3uU9hzp6POZeWb9TkpjJweQiyjZgKmLY,SpATywNh6bZuzm8s1ceuBUnMUAeoAHHw,15,19,13,14,8,0,3,0,57,8.142857142857142,2,0.0,2,13,13,8,17,0,1,3,0,36,21,0
1466,49423,S9Zsax2BYcPzUt4rHtigt6S1ZlRCRjuu,SpATywNh6bZuzm8s1ceuBUnMUAeoAHHw,4,4,1,0,0,0,1,0,6,0.8571428571428571,1,0.0,0,1,0,0,4,0,0,1,0,1,5,0
1467,49460,cvdLaf0MdwYwJIsGvs9mqC9xuvaOoxKF,A3fsA9Zfv1X2fVEQhTw51lKENdNrEqT3,3,1,1,0,1,0,0,0,3,0.42857142857142855,1,0.0,0,1,0,1,1,0,0,0,0,2,1,1
1468,49511,H1nbdkC904EOh8jWeVVcV5piaqMVBsli,SpATywNh6bZuzm8s1ceuBUnMUAeoAHHw,14,12,1,12,0,0,3,0,28,4.0,2,0.0,2,1,12,0,10,0,0,3,0,15,13,0
1469,49541,NblSZLprYLuCPJABpiPhGyWCznOG5gpM,SpATywNh6bZuzm8s1ceuBUnMUAeoAHHw,16,19,11,0,6,0,2,0,38,5.428571428571429,2,0.0,0,11,0,6,19,0,0,2,0,17,21,1
1470,49610,G43uBjhkBEsnK2sHC51NOglfCGNDkydQ,SpATywNh6bZuzm8s1ceuBUnMUAeoAHHw,23,32,15,16,9,2,10,0,84,12.0,3,0.0,15,15,15,9,17,2,1,10,0,54,30,1
1471,49620,twg5LqeyEPdLZyjl4T3Yb1man7ZRuOed,SpATywNh6bZuzm8s1ceuBUnMUAeoAHHw,18,30,2,12,1,2,10,2,59,8.428571428571429,3,0.0,8,2,12,1,22,2,0,10,2,23,36,0
1472,49650,Y3zuofaAdrsNcwq0tuYyHFkAsBUWoV8a,SpATywNh6bZuzm8s1ceuBUnMUAeoAHHw,12,15,5,15,1,8,3,0,47,6.714285714285714,2,0.0,4,5,12,1,11,8,3,3,0,22,25,0
1473,49655,H1nbdkC904EOh8jWeVVcV5piaqMVBsli,G8EPVSXsOYB5YQWZGiz1aVq5Pgr2GrQu,67,99,3,212,5,5,11,0,335,47.857142857142854,3,0.0,59,3,169,5,40,5,43,11,0,236,99,0
1474,49710,LzTBHDjLePaTqbybIwaptvUgkC0hWYCZ,SpATywNh6bZuzm8s1ceuBUnMUAeoAHHw,19,27,16,12,7,2,6,0,70,10.0,2,0.0,6,16,12,7,21,2,0,6,0,41,29,0
1475,49749,EwhKhClSv2Ps16I3uKtjdSj1YI7rGPIh,SpATywNh6bZuzm8s1ceuBUnMUAeoAHHw,5,5,2,0,0,0,3,0,10,1.4285714285714286,2,0.0,0,2,0,0,5,0,0,3,0,2,8,0
1476,49766,Lce2TIYgGhTbahYzTHHK4e5KxnEianpx,SpATywNh6bZuzm8s1ceuBUnMUAeoAHHw,5,2,1,0,1,0,2,0,6,0.8571428571428571,1,0.0,0,1,0,1,2,0,0,2,0,2,4,1
1477,49803,3FwKlBDtKGlNAYyQNzHL1qfkuXpNOPVW,A3fsA9Zfv1X2fVEQhTw51lKENdNrEqT3,6,4,3,2,0,0,3,0,12,1.7142857142857142,1,0.0,0,3,2,0,4,0,0,3,0,5,7,0
1478,49836,0vUwtohBIGCms6pa9p1s0k5cJHWURa4P,SpATywNh6bZuzm8s1ceuBUnMUAeoAHHw,14,19,0,16,0,4,1,0,40,5.714285714285714,1,0.0,6,0,14,0,13,4,2,1,0,20,20,0
1479,49863,rVswAzjMLz5uIPbCwAU1SliCQFpiAqey,SpATywNh6bZuzm8s1ceuBUnMUAeoAHHw,25,15,10,15,7,0,1,0,48,6.857142857142857,1,0.0,4,10,14,7,11,0,1,1,0,35,13,0
1480,49946,LNdimqsJkOxQDP9dT4IGwewg9YvH7zfV,G8EPVSXsOYB5YQWZGiz1aVq5Pgr2GrQu,5,3,2,0,1,0,1,0,7,1.0,1,0.0,0,2,0,1,3,0,0,1,0,3,4,0
1481,49949,8kmVwd95niwmuvSIAWJVA4Pqx2tMb8kH,A3fsA9Zfv1X2fVEQhTw51lKENdNrEqT3,16,15,11,0,8,0,3,0,37,5.285714285714286,1,0.0,1,11,0,8,14,0,0,3,0,20,17,1
1482,49987,ctfOhdlbQGiOVF89Y090EmsAqQEvSWmz,SpATywNh6bZuzm8s1ceuBUnMUAeoAHHw,1,0,0,0,0,0,1,0,1,0.14285714285714285,1,0.0,0,0,0,0,0,0,0,1,0,0,1,0
1483,50039,Ib4hBLihYWrsRQnVhSZKjb9Z8z0NZ4FI,SpATywNh6bZuzm8s1ceuBUnMUAeoAHHw,17,26,0,12,0,11,7,2,58,8.285714285714286,3,0.0,4,0,9,0,22,11,3,7,2,13,45,1
1484,50046,Pot71eWzAwlFIQ6WGEu1vr9IkLdwRub9,SpATywNh6bZuzm8s1ceuBUnMUAeoAHHw,6,3,2,0,1,0,2,0,8,1.1428571428571428,1,0.0,0,2,0,1,3,0,0,2,0,3,5,0
1485,50067,nYSFDE8RCbcZhD46fRSvPHUvA1ahfupi,bWdj2GDclj5ofokWjzoa5jAwMkxCykd6,12,10,1,0,1,35,10,1,58,8.285714285714286,2,0.0,0,1,0,1,10,35,0,10,1,2,56,1
1486,50092,rPKaOWNl9cYkLvtQk035CJPYGwPAMUtv,SpATywNh6bZuzm8s1ceuBUnMUAeoAHHw,15,16,8,12,2,2,5,1,46,6.571428571428571,3,0.0,2,8,12,2,14,2,0,5,1,24,22,0
1487,50143,kmn6CGih1FILZybV8MrApq46D7xH5npO,SpATywNh6bZuzm8s1ceuBUnMUAeoAHHw,17,17,2,1,2,7,13,1,43,6.142857142857143,2,0.0,1,2,1,2,16,7,0,13,1,6,37,0
1488,50254,rf43ZHojMqXQ775bmX3nnHgQ62d9XvGK,A3fsA9Zfv1X2fVEQhTw51lKENdNrEqT3,4,2,1,0,0,0,2,1,6,0.8571428571428571,1,0.0,0,1,0,0,2,0,0,2,1,1,5,1
1489,50319,7eLlsseV075nalpvk2K7Ka9Wx9qMiOW4,SpATywNh6bZuzm8s1ceuBUnMUAeoAHHw,8,2,2,0,2,1,8,1,16,2.2857142857142856,2,0.0,0,2,0,2,2,1,0,8,1,4,12,0
1490,50324,OIups6Cq9XY2CbwOPuI31XrOSt1FeD7G,SpATywNh6bZuzm8s1ceuBUnMUAeoAHHw,11,9,0,21,0,0,1,0,31,4.428571428571429,1,0.0,2,0,17,0,7,0,4,1,0,19,12,0
1491,50416,Xdag5jOmE7uWC3FmBvgPc5F7lO3QNcPW,SpATywNh6bZuzm8s1ceuBUnMUAeoAHHw,12,14,8,0,3,0,2,0,27,3.857142857142857,2,0.0,0,8,0,3,14,0,0,2,0,11,16,0
1492,50528,faeF4I5p3gAJMB1p4LfYVeCLQZKervYV,A3fsA9Zfv1X2fVEQhTw51lKENdNrEqT3,37,42,1,66,0,0,2,0,111,15.857142857142858,2,0.0,2,1,59,0,40,0,7,2,0,62,49,1
1493,50573,8ksQz9dz4s7ijHzYWnxMOGz2bplP7OAs,SpATywNh6bZuzm8s1ceuBUnMUAeoAHHw,6,6,1,3,0,0,1,0,11,1.5714285714285714,1,0.0,2,1,3,0,4,0,0,1,0,6,5,1
1494,50660,6jPw8ZwEXjLpnrxZT6HkwOQ20NkEyvU7,SpATywNh6bZuzm8s1ceuBUnMUAeoAHHw,20,39,7,17,6,246,20,0,335,47.857142857142854,5,0.0,8,7,14,6,31,246,3,20,0,35,300,0
1495,52454,quFRN0nuO6SCdHOgmUhTlayoumtzVI29,7GRhBDsirIGkRZBtSMEzNTyDr2JQm4xx,31,32,2,65,7,0,2,0,108,15.428571428571429,1,0.0,18,2,58,7,14,0,7,2,0,85,23,1
1496,52537,Jm6sJTkF2CzUeH5fDnA3ZYS6v322ABBN,7GRhBDsirIGkRZBtSMEzNTyDr2JQm4xx,5,2,1,0,1,0,2,0,6,0.8571428571428571,1,0.0,0,1,0,1,2,0,0,2,0,2,4,1
1497,52546,dNx7yBBYuWpRM4BeMNLD1yOnUwcueGfB,7GRhBDsirIGkRZBtSMEzNTyDr2JQm4xx,4,2,1,0,1,0,2,0,6,0.8571428571428571,1,0.0,0,1,0,1,2,0,0,2,0,2,4,1
1498,52669,Q8hb0j5K90GRKBQLUtk9egje9fPULAJD,7GRhBDsirIGkRZBtSMEzNTyDr2JQm4xx,1,0,0,0,0,0,1,0,1,0.14285714285714285,1,0.0,0,0,0,0,0,0,0,1,0,0,1,0
1499,52789,OO7beVHPObBfPwHA9jIrdvSr48hMom1m,7GRhBDsirIGkRZBtSMEzNTyDr2JQm4xx,27,46,15,54,16,3,1,0,135,19.285714285714285,5,0.0,24,15,46,16,22,3,8,1,0,101,34,0
1500,52835,ESHOHiiFNOO5h5pqzByY0J6PmNipWo8U,7GRhBDsirIGkRZBtSMEzNTyDr2JQm4xx,1,0,0,0,0,0,1,0,1,0.14285714285714285,1,0.0,0,0,0,0,0,0,0,1,0,0,1,1
1501,52935,VQQV4EfxxGcWfIRpLvaTXUUXZHA1kehZ,7GRhBDsirIGkRZBtSMEzNTyDr2JQm4xx,1,0,0,0,0,0,1,0,1,0.14285714285714285,1,0.0,0,0,0,0,0,0,0,1,0,0,1,1
1502,53000,CGPCZptxVu9ER3GGm9DUJ9SpSOShg1OZ,7GRhBDsirIGkRZBtSMEzNTyDr2JQm4xx,37,53,14,60,12,3,1,0,143,20.428571428571427,1,0.0,25,14,52,12,28,3,8,1,0,103,40,1
1503,53020,Z4kedXjIF6f3uubwtldCvvLQcT4vIEro,7GRhBDsirIGkRZBtSMEzNTyDr2JQm4xx,3,2,0,0,0,0,1,0,3,0.42857142857142855,1,0.0,0,0,0,0,2,0,0,1,0,0,3,1
1504,53046,t8qBiDTvOvYmrxcVIErRuEOf38tywm6t,bWdj2GDclj5ofokWjzoa5jAwMkxCykd6,10,20,13,0,3,12,10,0,58,8.285714285714286,1,0.0,2,13,0,3,18,12,0,10,0,18,40,1
1505,53048,8gk5kBMYT20pCB4wpUHe3xKwSYDbtvzS,SpATywNh6bZuzm8s1ceuBUnMUAeoAHHw,12,12,6,0,4,0,3,0,25,3.5714285714285716,2,0.0,0,6,0,4,12,0,0,3,0,10,15,1
1506,53049,8cVIhj7cvR0q9dzupEColmwPbOHZ624c,SpATywNh6bZuzm8s1ceuBUnMUAeoAHHw,19,18,11,19,6,11,5,0,70,10.0,2,0.0,4,11,16,6,14,11,3,5,0,37,33,0
1507,53063,LbpzBfhp2Wgcn9ayrU6jOBjfquY2961S,SpATywNh6bZuzm8s1ceuBUnMUAeoAHHw,7,3,2,0,2,0,2,0,9,1.2857142857142858,1,0.0,0,2,0,2,3,0,0,2,0,4,5,1
1508,53070,3Ph0mVs6YY4X7VkfoALrDqpzMeDhFoCj,A3fsA9Zfv1X2fVEQhTw51lKENdNrEqT3,5,9,5,0,0,0,2,0,16,2.2857142857142856,2,0.0,0,5,0,0,9,0,0,2,0,5,11,1
1509,53118,5bplw4NcU21nNTIEcExDZZHISObWtI7D,SpATywNh6bZuzm8s1ceuBUnMUAeoAHHw,2,0,0,0,0,0,2,0,2,0.2857142857142857,1,0.0,0,0,0,0,0,0,0,2,0,0,2,1
1510,53119,AwKhkfPOqEnTXG1Cn8Gmf8HHhYnwnTgu,SpATywNh6bZuzm8s1ceuBUnMUAeoAHHw,7,5,3,0,1,0,3,0,12,1.7142857142857142,1,0.0,2,3,0,1,3,0,0,3,0,6,6,1
1511,53124,1mZ7vCkgdZSC0cu4gxvMxxm9xwGvwvAR,SpATywNh6bZuzm8s1ceuBUnMUAeoAHHw,12,7,0,8,0,0,4,1,20,2.857142857142857,1,0.0,1,0,7,0,6,0,1,4,1,8,12,1
1512,53139,nNXdLwc4WRmQjF7qTMoDc98hNmIFSp8j,SpATywNh6bZuzm8s1ceuBUnMUAeoAHHw,6,4,3,0,1,0,4,0,12,1.7142857142857142,3,0.0,0,3,0,1,4,0,0,4,0,4,8,1
1513,53140,Jf77UYIvUtofHBGpvQMQ0qUfMZBh9rRJ,A3fsA9Zfv1X2fVEQhTw51lKENdNrEqT3,55,30,19,72,14,0,4,1,140,20.0,2,0.0,2,19,68,14,28,0,4,4,1,103,37,1
1514,53155,PPZEwof9f8rZx0lcTpURHpbkLB2YY5hH,bWdj2GDclj5ofokWjzoa5jAwMkxCykd6,1,0,0,0,0,0,1,0,1,0.14285714285714285,1,0.0,0,0,0,0,0,0,0,1,0,0,1,1
1515,53161,oS1Vf0Ayi2kmK9AxKSgJ38BEbMfbnGmy,SpATywNh6bZuzm8s1ceuBUnMUAeoAHHw,19,33,2,12,1,17,5,1,71,10.142857142857142,3,0.0,14,2,10,1,19,17,2,5,1,27,44,1
1516,53163,MxIyDpIx03wSGr0H52jiRE3GZR3Xt5iM,SpATywNh6bZuzm8s1ceuBUnMUAeoAHHw,29,58,29,44,14,1,7,0,153,21.857142857142858,3,0.0,21,29,38,14,37,1,6,7,0,102,51,1
1517,53170,BBcMLJIRqEjAV0Iy0PZLL6aDRdsecvdG,G8EPVSXsOYB5YQWZGiz1aVq5Pgr2GrQu,20,18,0,26,1,0,6,0,51,7.285714285714286,1,0.0,4,0,22,1,14,0,4,6,0,27,24,1
1518,53194,5y4YA2mbDcwuEjNHeStgjLfqN1rsKZgP,SpATywNh6bZuzm8s1ceuBUnMUAeoAHHw,6,4,1,0,1,0,1,0,7,1.0,1,0.0,0,1,0,1,4,0,0,1,0,2,5,0
1519,53198,TVNQBfVHiiSK1QlXMueUvqhShIHov5rx,A3fsA9Zfv1X2fVEQhTw51lKENdNrEqT3,4,0,0,0,0,0,8,0,8,1.1428571428571428,1,0.0,0,0,0,0,0,0,0,8,0,0,8,1
1520,53209,GOcyurvQpr52NaTeXKp3vF6yg377GcU5,SpATywNh6bZuzm8s1ceuBUnMUAeoAHHw,10,10,2,12,0,1,11,1,37,5.285714285714286,2,0.0,3,2,12,0,7,1,0,11,1,17,20,0
1521,53219,igvNYxEcQQQ9zsQs0eESBN7rFelE1Oyt,SpATywNh6bZuzm8s1ceuBUnMUAeoAHHw,6,4,1,0,1,0,2,0,8,1.1428571428571428,1,0.0,1,1,0,1,3,0,0,2,0,3,5,1
1522,53223,xv3zPM1UCM9DtQrJ8sbmGYaRlj8FtrlB,SpATywNh6bZuzm8s1ceuBUnMUAeoAHHw,22,34,1,16,0,7,4,0,62,8.857142857142858,2,0.0,14,1,16,0,20,7,0,4,0,31,31,1
1523,53247,tHPSGx00vsFzhzr0zwBlWWarqJT4wPHF,A3fsA9Zfv1X2fVEQhTw51lKENdNrEqT3,33,11,9,50,7,0,1,0,78,11.142857142857142,1,0.0,1,9,45,7,10,0,5,1,0,62,16,1
1524,53255,mOyYFNs2t1Eh1aA09x8EHu6wqp81MSvv,bWdj2GDclj5ofokWjzoa5jAwMkxCykd6,3,2,1,0,0,0,1,0,4,0.5714285714285714,1,0.0,0,1,0,0,2,0,0,1,0,1,3,1
1525,53275,tixHTdVBfyAX1gHufSYbGyCBT9OKYh0u,SpATywNh6bZuzm8s1ceuBUnMUAeoAHHw,10,8,4,0,3,0,2,0,17,2.4285714285714284,1,0.0,3,4,0,3,5,0,0,2,0,10,7,1
1526,53280,N7f90nGBEKO2Wy697fsY7gOd7p4hRhpZ,SpATywNh6bZuzm8s1ceuBUnMUAeoAHHw,8,4,2,0,1,7,4,1,19,2.7142857142857144,1,0.0,0,2,0,1,4,7,0,4,1,3,16,1
1527,53281,1R6B3xPo1MU8MeIr72077lkCH6LzghZG,SpATywNh6bZuzm8s1ceuBUnMUAeoAHHw,18,15,9,16,5,0,6,0,51,7.285714285714286,1,0.0,2,9,13,5,13,0,3,6,0,29,22,1
1528,53295,yo1PAd1hBwimD9OOoxvyi6mwQC5bfK9g,bWdj2GDclj5ofokWjzoa5jAwMkxCykd6,5,5,3,0,1,0,3,0,12,1.7142857142857142,1,0.0,0,3,0,1,5,0,0,3,0,4,8,1
1529,53312,uQjl8NGtIQkRfoe9edBiMgtYYmdkzVXR,SpATywNh6bZuzm8s1ceuBUnMUAeoAHHw,1,0,0,0,0,0,1,0,1,0.14285714285714285,1,0.0,0,0,0,0,0,0,0,1,0,0,1,0
1530,53336,5naaONANTJUheGV6edn51qgkV97IPNdM,SpATywNh6bZuzm8s1ceuBUnMUAeoAHHw,1,0,0,0,0,0,1,0,1,0.14285714285714285,1,0.0,0,0,0,0,0,0,0,1,0,0,1,1
1531,53346,oNcOLZOgRKuqVCWgf9VQFQ2ph82THXaV,RXDvfPUBYFlVdlueBFbLW0mhhAyGEqpt,1,0,0,0,0,0,1,0,1,0.14285714285714285,1,0.0,0,0,0,0,0,0,0,1,0,0,1,0
1532,53360,boitIxZvCZ9przAKAQqxtWTvavMJkqzn,SpATywNh6bZuzm8s1ceuBUnMUAeoAHHw,17,11,8,6,4,0,1,0,30,4.285714285714286,1,0.0,2,8,6,4,9,0,0,1,0,20,10,0
1533,53368,mf00J2vS5aNSPGjL8Bq3W8G35vnnAtUS,SpATywNh6bZuzm8s1ceuBUnMUAeoAHHw,14,14,1,11,0,0,4,0,30,4.285714285714286,2,0.0,3,1,11,0,11,0,0,4,0,15,15,1
1534,53374,rSB9ieAhUU6VlZTakIYbk4lUm5NlM8Bf,SpATywNh6bZuzm8s1ceuBUnMUAeoAHHw,2,0,0,0,0,0,2,0,2,0.2857142857142857,1,0.0,0,0,0,0,0,0,0,2,0,0,2,1
1535,53381,hJ48EYDAUcnIubJFw4NRxQxCK6ApJIxf,SpATywNh6bZuzm8s1ceuBUnMUAeoAHHw,10,9,0,10,0,2,3,0,24,3.4285714285714284,1,0.0,4,0,10,0,5,2,0,3,0,14,10,1
1536,53396,0qQG1Nylz3pu9h7MazaVuzCwo13YkYej,SpATywNh6bZuzm8s1ceuBUnMUAeoAHHw,10,12,5,0,3,0,3,0,23,3.2857142857142856,2,0.0,0,5,0,3,12,0,0,3,0,8,15,1
1537,53418,0uULbxMYxykuellS4DES6XbGTfaCngOW,A3fsA9Zfv1X2fVEQhTw51lKENdNrEqT3,8,10,0,0,0,0,4,0,14,2.0,1,0.0,0,0,0,0,10,0,0,4,0,0,14,1
1538,53421,oyKGOSyMOi0AM9nt7p8h8Y1cF1HEnPtq,SpATywNh6bZuzm8s1ceuBUnMUAeoAHHw,4,2,1,0,1,0,1,0,5,0.7142857142857143,1,0.0,0,1,0,1,2,0,0,1,0,2,3,1
1539,53423,26YZUhjQbxCihl3CNnlwudlVL638MFZI,SpATywNh6bZuzm8s1ceuBUnMUAeoAHHw,7,9,0,0,0,1,8,0,18,2.5714285714285716,1,0.0,0,0,0,0,9,1,0,8,0,0,18,1
1540,53453,A4vEkOAwhpQEgLFKtjOc7tdIxawwQcIi,SpATywNh6bZuzm8s1ceuBUnMUAeoAHHw,17,23,12,10,5,0,5,0,55,7.857142857142857,3,0.0,7,12,8,5,16,0,2,5,0,32,23,1
1541,53456,WFLWEfQrQsuFMQB4h1DfinKxHOxaJgRw,RXDvfPUBYFlVdlueBFbLW0mhhAyGEqpt,2,0,0,0,0,0,2,0,2,0.2857142857142857,2,0.0,0,0,0,0,0,0,0,2,0,0,2,1
1542,53462,9rLNySnV0yxkzZA7V8enLIbzXZCrF6IJ,RXDvfPUBYFlVdlueBFbLW0mhhAyGEqpt,5,4,2,0,1,0,2,0,9,1.2857142857142858,2,0.0,0,2,0,1,4,0,0,2,0,3,6,0
1543,53483,t20VhGjJQwmwXV8X5LeBQDucO3YuiMru,SpATywNh6bZuzm8s1ceuBUnMUAeoAHHw,19,16,3,41,1,26,10,2,99,14.142857142857142,2,0.0,5,3,34,1,11,26,7,10,2,43,56,0
1544,53484,WyWFczdn2Y2i2D9wUJkB93D49zn2CheK,SpATywNh6bZuzm8s1ceuBUnMUAeoAHHw,1,0,0,0,0,0,2,0,2,0.2857142857142857,2,0.0,0,0,0,0,0,0,0,2,0,0,2,0
1545,53501,5vi4PfMqn3pILscFmPde7WIp5OpFzjzt,SpATywNh6bZuzm8s1ceuBUnMUAeoAHHw,4,3,1,0,1,0,2,0,7,1.0,1,0.0,0,1,0,1,3,0,0,2,0,2,5,0
1546,53505,nG7nzscbe2QtoUFUlgTpRDhBo6dlFgWT,SpATywNh6bZuzm8s1ceuBUnMUAeoAHHw,1,0,0,0,0,0,1,0,1,0.14285714285714285,1,0.0,0,0,0,0,0,0,0,1,0,0,1,1
1547,53507,sqZsZQq9LcjzbfCPmehLyMMrK3ClcYAT,A3fsA9Zfv1X2fVEQhTw51lKENdNrEqT3,7,3,2,0,2,0,3,0,10,1.4285714285714286,1,0.0,0,2,0,2,3,0,0,3,0,4,6,1
1548,53526,4XbWtzoFwF5LOOV7fIRFhXr7S6ATs5RB,SpATywNh6bZuzm8s1ceuBUnMUAeoAHHw,9,6,1,0,1,9,4,1,22,3.142857142857143,1,0.0,0,1,0,1,6,9,0,4,1,2,20,1
1549,53534,ssMidTFfcaAGjWiJzMk3J73LCswwO4yV,A3fsA9Zfv1X2fVEQhTw51lKENdNrEqT3,7,0,0,0,0,2,6,1,9,1.2857142857142858,1,0.0,0,0,0,0,0,2,0,6,1,0,9,1
1550,53565,0HsU2yFVHR5yKm9Hke3oyrM0twIu2eg3,bWdj2GDclj5ofokWjzoa5jAwMkxCykd6,7,10,1,58,2,0,4,0,75,10.714285714285714,1,0.0,8,1,57,2,2,0,1,4,0,68,7,1
1551,53587,VDscv2ylkQ5hVjxSl7FzkFmJDmBcIaMr,A3fsA9Zfv1X2fVEQhTw51lKENdNrEqT3,5,3,2,0,1,0,1,0,7,1.0,1,0.0,0,2,0,1,3,0,0,1,0,3,4,1
1552,53596,fHnWrc914HQUCHZRKa2nPteHkVOkvlJI,SpATywNh6bZuzm8s1ceuBUnMUAeoAHHw,15,16,2,16,0,3,9,1,47,6.714285714285714,3,0.0,4,2,14,0,12,3,2,9,1,20,27,0
1553,53630,w7s7CbDlE2P2RGY2w8kEYH9keSavEsec,SpATywNh6bZuzm8s1ceuBUnMUAeoAHHw,7,5,2,0,1,0,6,0,14,2.0,1,0.0,0,2,0,1,5,0,0,6,0,3,11,1
1554,53649,dtP0jNvfsrthiSc4EbxmbNOv0Ufz6AhB,RXDvfPUBYFlVdlueBFbLW0mhhAyGEqpt,7,4,3,0,3,0,3,0,13,1.8571428571428572,1,0.0,0,3,0,3,4,0,0,3,0,6,7,1
1555,53666,uxWS9amhXxmjOvqXmZExJSg0LcMFBAvq,RXDvfPUBYFlVdlueBFbLW0mhhAyGEqpt,11,10,8,0,5,0,7,0,30,4.285714285714286,2,0.0,2,8,0,5,8,0,0,7,0,15,15,1
1556,53669,j79CPp6e09l3A1MeqgSV5ajYlxbk9Ixy,A3fsA9Zfv1X2fVEQhTw51lKENdNrEqT3,33,18,5,58,5,0,5,0,91,13.0,2,0.0,2,5,53,5,16,0,5,5,0,65,26,1
1557,53694,dXgGUXhGtPdqA3aOz733dBgKiaq7cvX6,SpATywNh6bZuzm8s1ceuBUnMUAeoAHHw,13,21,2,0,2,0,15,0,40,5.714285714285714,4,0.0,0,2,0,2,21,0,0,15,0,4,36,1
1558,53718,Ar22lkOE5FvesxoMKtYhm8Cbv4MUQUYF,SpATywNh6bZuzm8s1ceuBUnMUAeoAHHw,1,0,0,0,0,0,1,0,1,0.14285714285714285,1,0.0,0,0,0,0,0,0,0,1,0,0,1,1
1559,53721,lSVRjk6dkgEmIe9I21hvsRF98Lf2IKdM,SpATywNh6bZuzm8s1ceuBUnMUAeoAHHw,15,18,7,11,3,0,4,0,43,6.142857142857143,1,0.0,3,7,11,3,15,0,0,4,0,24,19,1
1560,53740,oUC5J8T9mINNExS4753FcPxbWA9dWDjN,SpATywNh6bZuzm8s1ceuBUnMUAeoAHHw,17,17,10,5,4,1,7,1,45,6.428571428571429,1,0.0,3,10,4,4,14,1,1,7,1,21,24,1
1561,53741,CV8kQrzk7Ma4h2GmuCAW4YCocO4w4WSf,bWdj2GDclj5ofokWjzoa5jAwMkxCykd6,4,4,1,0,2,0,1,0,8,1.1428571428571428,1,0.0,2,1,0,2,2,0,0,1,0,5,3,1
1562,53755,FOAFoPTPHDIp8ur1T09KgTEj3KeABYBf,SpATywNh6bZuzm8s1ceuBUnMUAeoAHHw,2,0,0,0,0,0,2,0,2,0.2857142857142857,1,0.0,0,0,0,0,0,0,0,2,0,0,2,1
1563,53760,KGXFn1n0h5LwrdyZxyMenRRVTJ2x6Rjd,RXDvfPUBYFlVdlueBFbLW0mhhAyGEqpt,4,3,2,0,2,0,1,0,8,1.1428571428571428,1,0.0,0,2,0,2,3,0,0,1,0,4,4,1
1564,53766,KIPXc8MOqmnlmMqnIzIeaBqliIw9pS44,SpATywNh6bZuzm8s1ceuBUnMUAeoAHHw,16,16,8,7,3,0,4,0,38,5.428571428571429,1,0.0,3,8,7,3,13,0,0,4,0,21,17,1
1565,53786,L5GEhRbHdd9onnNJ8EJkvOQW3HytY3G8,SpATywNh6bZuzm8s1ceuBUnMUAeoAHHw,12,10,5,0,5,0,3,0,23,3.2857142857142856,1,0.0,2,5,0,5,8,0,0,3,0,12,11,1
1566,53792,p62iTg6ZpvzODJCBLH2d7SVfdoSWuy8j,RXDvfPUBYFlVdlueBFbLW0mhhAyGEqpt,58,81,55,102,21,0,2,0,261,37.285714285714285,2,0.0,18,55,96,21,63,0,6,2,0,190,71,0
1567,53796,10a3aPUuiEikOQBzdtiLA8dXlMBNaCqq,A3fsA9Zfv1X2fVEQhTw51lKENdNrEqT3,1,0,0,0,0,0,1,0,1,0.14285714285714285,1,0.0,0,0,0,0,0,0,0,1,0,0,1,1
1568,53805,sytW49I21SJ70ElOkXGU5SHeeHl1E3fL,A3fsA9Zfv1X2fVEQhTw51lKENdNrEqT3,23,19,14,0,10,0,7,0,50,7.142857142857143,3,0.0,2,14,0,10,17,0,0,7,0,26,24,1
1569,53818,mBrhN2Nrf27UQ54otia4OdwjR0gGrIS1,SpATywNh6bZuzm8s1ceuBUnMUAeoAHHw,8,6,1,0,0,1,8,0,16,2.2857142857142856,1,0.0,0,1,0,0,6,1,0,8,0,1,15,1
1570,53835,8rXJHeqrLpho5nIQgbDcpBTvBrVnGged,bWdj2GDclj5ofokWjzoa5jAwMkxCykd6,13,23,3,38,0,10,7,1,82,11.714285714285714,1,0.0,6,3,34,0,17,10,4,7,1,43,39,1
1571,53856,4jDSfVr3FM2ZrR7U3LMbeRYrZXGv5CAV,SpATywNh6bZuzm8s1ceuBUnMUAeoAHHw,8,4,2,0,2,1,2,1,12,1.7142857142857142,1,0.0,0,2,0,2,4,1,0,2,1,4,8,1
1572,53865,jKfEyfk0HFbzE5vAszOX5qLRWBhzLYt2,A3fsA9Zfv1X2fVEQhTw51lKENdNrEqT3,1,0,0,0,0,0,1,0,1,0.14285714285714285,1,0.0,0,0,0,0,0,0,0,1,0,0,1,1
1573,53872,jKfEyfk0HFbzE5vAszOX5qLRWBhzLYt2,bWdj2GDclj5ofokWjzoa5jAwMkxCykd6,1,0,0,0,0,0,1,0,1,0.14285714285714285,1,0.0,0,0,0,0,0,0,0,1,0,0,1,1
1574,53893,8C3Ev7v016DKmnVXW2AvnqT9jJXWxsa8,SpATywNh6bZuzm8s1ceuBUnMUAeoAHHw,7,3,2,0,2,0,2,0,9,1.2857142857142858,1,0.0,0,2,0,2,3,0,0,2,0,4,5,1
1575,53903,4XxIEPI2UOvU2fn3nQAeJ4R1qsxwKTmu,SpATywNh6bZuzm8s1ceuBUnMUAeoAHHw,21,29,15,0,11,0,11,0,66,9.428571428571429,1,0.0,4,15,0,11,25,0,0,11,0,30,36,0
1576,53916,BsBj37bM37sYKQjSXV07xFL8gbIptVn8,bWdj2GDclj5ofokWjzoa5jAwMkxCykd6,2,0,0,0,0,0,2,0,2,0.2857142857142857,1,0.0,0,0,0,0,0,0,0,2,0,0,2,1
1577,53920,Oiq6C4nL7ZnZProqskptBCeXrYJ4FTge,A3fsA9Zfv1X2fVEQhTw51lKENdNrEqT3,1,0,0,0,0,0,2,0,2,0.2857142857142857,1,0.0,0,0,0,0,0,0,0,2,0,0,2,1
1578,53930,IARcq51sP2SqR9JLBLqyXGL88k6Z1aOe,SpATywNh6bZuzm8s1ceuBUnMUAeoAHHw,1,0,0,0,0,0,1,0,1,0.14285714285714285,1,0.0,0,0,0,0,0,0,0,1,0,0,1,1
1579,53970,mopAEhc4oYbNGgdB14MDU4Z5IjNO4SXn,SpATywNh6bZuzm8s1ceuBUnMUAeoAHHw,22,25,2,34,0,0,5,0,66,9.428571428571429,1,0.0,6,2,28,0,19,0,6,5,0,36,30,1
1580,53984,QYVRHTpooyTkzSbIywJ7ri5o4t73Xwty,SpATywNh6bZuzm8s1ceuBUnMUAeoAHHw,7,15,5,0,3,0,3,0,26,3.7142857142857144,1,0.0,0,5,0,3,15,0,0,3,0,8,18,1
1581,53986,z9sj5HIJml1DMOMfRKKBQ7IvS2IoE424,bWdj2GDclj5ofokWjzoa5jAwMkxCykd6,16,55,27,0,11,14,18,0,125,17.857142857142858,3,0.0,0,27,0,11,55,14,0,18,0,38,87,1
1582,53989,1kEIJj7vLRBM7EdRHp9VWjLFIqNPjA0F,SpATywNh6bZuzm8s1ceuBUnMUAeoAHHw,5,2,1,0,1,0,3,0,7,1.0,1,0.0,0,1,0,1,2,0,0,3,0,2,5,1
1583,54035,6UfIu5SKHPYfwZxBxJpGSqhLHKhbdsl0,SpATywNh6bZuzm8s1ceuBUnMUAeoAHHw,13,11,10,2,7,0,3,0,33,4.714285714285714,1,0.0,0,10,2,7,11,0,0,3,0,19,14,0
1584,54045,A9hKsxxgL4q5b7FGmUZTmhhYJ9IUDrBm,SpATywNh6bZuzm8s1ceuBUnMUAeoAHHw,17,42,21,0,14,2,8,0,87,12.428571428571429,4,0.0,6,21,0,14,36,2,0,8,0,41,46,0
1585,54054,W3FcEvxr2cIwq2NIdATNIqtjoGLetLLn,bWdj2GDclj5ofokWjzoa5jAwMkxCykd6,9,11,1,20,0,8,6,2,48,6.857142857142857,1,0.0,1,1,18,0,10,8,2,6,2,20,28,1
1586,54072,Y9YzwTET1OUYhHsLt97DLY5Tl5O9atqy,SpATywNh6bZuzm8s1ceuBUnMUAeoAHHw,12,21,10,0,10,0,1,0,42,6.0,2,0.0,0,10,0,10,21,0,0,1,0,20,22,1
1587,54086,uIIavYxNuEJ6NG2Ex383dBZvdILceLZJ,SpATywNh6bZuzm8s1ceuBUnMUAeoAHHw,7,5,2,0,2,0,1,0,10,1.4285714285714286,1,0.0,0,2,0,2,5,0,0,1,0,4,6,0
1588,54090,IwRf58Af79ziuqQX85M6J2Lo8D4N0Ygn,A3fsA9Zfv1X2fVEQhTw51lKENdNrEqT3,8,5,3,0,3,0,2,0,13,1.8571428571428572,1,0.0,0,3,0,3,5,0,0,2,0,6,7,1
1589,54093,1rAHmNrxrqnzHEQFMlydmQ968LsZW0oG,RXDvfPUBYFlVdlueBFbLW0mhhAyGEqpt,15,8,5,10,2,7,7,3,42,6.0,2,0.0,1,5,9,2,7,7,1,7,3,17,25,1
1590,54095,mANHObgCOxed01sMVUE2CCh0Yy4sWlCz,bWdj2GDclj5ofokWjzoa5jAwMkxCykd6,4,2,0,0,0,0,3,0,5,0.7142857142857143,1,0.0,0,0,0,0,2,0,0,3,0,0,5,1
1591,54100,ULxriJOFgcYW8OKrxzYPWeTN4MYJZpRj,SpATywNh6bZuzm8s1ceuBUnMUAeoAHHw,5,4,0,0,1,0,1,0,6,0.8571428571428571,1,0.0,0,0,0,1,4,0,0,1,0,1,5,1
1592,54105,On4dVQn2MRHkwqRorWIyGST4bzaBJgjb,SpATywNh6bZuzm8s1ceuBUnMUAeoAHHw,6,4,2,0,1,0,1,0,8,1.1428571428571428,1,0.0,0,2,0,1,4,0,0,1,0,3,5,1
1593,54107,puAOKUG4MdJZvu6TGCieg6bgD5WGJ0qf,bWdj2GDclj5ofokWjzoa5jAwMkxCykd6,6,2,1,0,0,6,8,2,19,2.7142857142857144,1,0.0,0,1,0,0,2,6,0,8,2,1,18,1
1594,54112,GASbwPXxwryodKV3AqYKdU5jEaEhIE7r,SpATywNh6bZuzm8s1ceuBUnMUAeoAHHw,14,13,3,3,1,0,6,1,27,3.857142857142857,1,0.0,1,3,3,1,12,0,0,6,1,8,19,0
1595,54120,S9bleRJbl0xJFa4yPXuTgULWJ67nbMqi,SpATywNh6bZuzm8s1ceuBUnMUAeoAHHw,3,6,3,0,0,0,3,0,12,1.7142857142857142,2,0.0,0,3,0,0,6,0,0,3,0,3,9,0
1596,54127,puAOKUG4MdJZvu6TGCieg6bgD5WGJ0qf,A3fsA9Zfv1X2fVEQhTw51lKENdNrEqT3,1,0,0,0,0,0,1,0,1,0.14285714285714285,1,0.0,0,0,0,0,0,0,0,1,0,0,1,1
1597,54142,oEOiBLMr97GK8O9ympHG9NMLQODJ0Xam,A3fsA9Zfv1X2fVEQhTw51lKENdNrEqT3,1,0,0,0,0,0,1,0,1,0.14285714285714285,1,0.0,0,0,0,0,0,0,0,1,0,0,1,1
1598,54151,6f80AuCxgLhEz4q3r0Z7Tne4jeBhxVpZ,SpATywNh6bZuzm8s1ceuBUnMUAeoAHHw,18,33,9,23,5,1,9,1,81,11.571428571428571,1,0.0,10,9,20,5,23,1,3,9,1,44,37,0
1599,54156,QYaJtD7z5M6YcGNpdHV2JTsxqV4tXm9a,SpATywNh6bZuzm8s1ceuBUnMUAeoAHHw,13,22,13,13,0,19,2,0,69,9.857142857142858,2,0.0,6,13,12,0,16,19,1,2,0,31,38,0
1600,54174,qsAhBackOo3cL2WuRLzyR4ErX4nTraFk,bWdj2GDclj5ofokWjzoa5jAwMkxCykd6,8,9,2,2,5,0,2,0,20,2.857142857142857,1,0.0,6,2,2,5,3,0,0,2,0,15,5,1
1601,54189,cN6OZq4ak5IqzN7Lw32XLOS12DhlWO8Q,A3fsA9Zfv1X2fVEQhTw51lKENdNrEqT3,4,3,2,0,0,0,1,0,6,0.8571428571428571,1,0.0,0,2,0,0,3,0,0,1,0,2,4,0
1602,54190,U6zvwzZFC3hs6bhxG6asVA50snx1s2RU,SpATywNh6bZuzm8s1ceuBUnMUAeoAHHw,4,2,1,0,1,0,1,0,5,0.7142857142857143,1,0.0,0,1,0,1,2,0,0,1,0,2,3,1
1603,54191,Io3VzTK6sP3a0ZVRKkRhFNz8A2ULjris,G8EPVSXsOYB5YQWZGiz1aVq5Pgr2GrQu,2,0,0,0,0,0,3,0,3,0.42857142857142855,1,0.0,0,0,0,0,0,0,0,3,0,0,3,1
1604,54193,smg4SHkT0uQ59GP6Camalxkw6c32vtzM,SpATywNh6bZuzm8s1ceuBUnMUAeoAHHw,14,19,1,12,1,0,4,0,37,5.285714285714286,2,0.0,2,1,9,1,17,0,3,4,0,13,24,0
1605,54196,4mLn5YrkZbnxPXEuAYTSn9TKZyVmWQjo,SpATywNh6bZuzm8s1ceuBUnMUAeoAHHw,11,14,0,0,0,0,3,0,17,2.4285714285714284,2,0.0,0,0,0,0,14,0,0,3,0,0,17,0
1606,54209,ke8J6J68PMmqZ8rK8FCDUgXlLZQpLLZW,bWdj2GDclj5ofokWjzoa5jAwMkxCykd6,3,4,0,0,0,0,2,0,6,0.8571428571428571,2,0.0,0,0,0,0,4,0,0,2,0,0,6,1
1607,54215,ZbaPpC6DlaDgy5Ic6oj7YX9qkm2j3Pmr,A3fsA9Zfv1X2fVEQhTw51lKENdNrEqT3,1,0,0,0,0,0,1,0,1,0.14285714285714285,1,0.0,0,0,0,0,0,0,0,1,0,0,1,1
1608,54230,RJ1FVW8gXQIpK321uzh2Sh69ojlsqnvg,A3fsA9Zfv1X2fVEQhTw51lKENdNrEqT3,12,6,5,0,4,0,2,0,17,2.4285714285714284,1,0.0,0,5,0,4,6,0,0,2,0,9,8,0
1609,54245,DauUa5EOQjYVJ9IOEZ6MNnCJpVrdodep,SpATywNh6bZuzm8s1ceuBUnMUAeoAHHw,5,2,1,0,1,0,2,0,6,0.8571428571428571,1,0.0,0,1,0,1,2,0,0,2,0,2,4,1
1610,54248,4rM5k15XYnxmy5xR9L5EVWP9CatXJ8wI,SpATywNh6bZuzm8s1ceuBUnMUAeoAHHw,4,2,0,0,0,0,3,0,5,0.7142857142857143,1,0.0,0,0,0,0,2,0,0,3,0,0,5,1
1611,54256,wtEiMTsSGyqVYmzAUWtaJeXU5b3t5li0,SpATywNh6bZuzm8s1ceuBUnMUAeoAHHw,1,0,0,0,0,0,1,0,1,0.14285714285714285,1,0.0,0,0,0,0,0,0,0,1,0,0,1,0
1612,54263,haOx3D2RVOqd6ga1rw8OsvbEHoupYgpz,SpATywNh6bZuzm8s1ceuBUnMUAeoAHHw,14,9,4,12,3,3,3,0,34,4.857142857142857,1,0.0,2,4,9,3,7,3,3,3,0,18,16,1
1613,54267,o4j0NDzLh6XqpDKcvRg8Lx9N4HUYeTuP,A3fsA9Zfv1X2fVEQhTw51lKENdNrEqT3,1,0,0,0,0,0,1,0,1,0.14285714285714285,1,0.0,0,0,0,0,0,0,0,1,0,0,1,1
1614,54269,7EEqnuI1QuwYA0sZvgr9zLDxbRgASZvg,A3fsA9Zfv1X2fVEQhTw51lKENdNrEqT3,1,0,0,0,0,0,1,0,1,0.14285714285714285,1,0.0,0,0,0,0,0,0,0,1,0,0,1,1
1615,54286,NCyQ1ytdiWvqyE3iylDLFJzABxi8HOfD,SpATywNh6bZuzm8s1ceuBUnMUAeoAHHw,3,0,0,0,0,0,5,0,5,0.7142857142857143,1,0.0,0,0,0,0,0,0,0,5,0,0,5,1
1616,54307,Io3VzTK6sP3a0ZVRKkRhFNz8A2ULjris,A3fsA9Zfv1X2fVEQhTw51lKENdNrEqT3,2,0,0,0,0,0,2,0,2,0.2857142857142857,1,0.0,0,0,0,0,0,0,0,2,0,0,2,1
1617,54317,uKEv904ylJe7cpj2OP28yUTrESfvx6LR,SpATywNh6bZuzm8s1ceuBUnMUAeoAHHw,5,3,2,0,1,0,2,0,8,1.1428571428571428,1,0.0,0,2,0,1,3,0,0,2,0,3,5,1
1618,54326,Fq6XRhpyARqo3e2KmYQqUPcebNvG6D8A,SpATywNh6bZuzm8s1ceuBUnMUAeoAHHw,4,3,0,0,0,0,2,0,5,0.7142857142857143,1,0.0,0,0,0,0,3,0,0,2,0,0,5,1
1619,54347,u4dhcCVujoYC7k1ILiJ5SLaS1NfapC9a,SpATywNh6bZuzm8s1ceuBUnMUAeoAHHw,4,2,1,0,1,0,1,0,5,0.7142857142857143,1,0.0,0,1,0,1,2,0,0,1,0,2,3,1
1620,54354,1GwCcPnawuwjaFyAi38hoJxQ9NHTHcHa,SpATywNh6bZuzm8s1ceuBUnMUAeoAHHw,5,8,5,0,3,0,2,0,18,2.5714285714285716,2,0.0,0,5,0,3,8,0,0,2,0,8,10,1
1621,54400,hMJOWQDhTMJkvOumtHtoyaiAzs72Ex16,A3fsA9Zfv1X2fVEQhTw51lKENdNrEqT3,1,0,0,0,0,0,2,0,2,0.2857142857142857,1,0.0,0,0,0,0,0,0,0,2,0,0,2,1
1622,54403,IiprEhfBJUF3Volv4Wt8hDKs67azhw4N,SpATywNh6bZuzm8s1ceuBUnMUAeoAHHw,14,17,1,16,0,13,5,0,52,7.428571428571429,3,0.0,3,1,14,0,14,13,2,5,0,18,34,0
1623,54406,WK8aAMlHaWKAnJlGkt1oHqYhwnCNU9kd,SpATywNh6bZuzm8s1ceuBUnMUAeoAHHw,13,10,8,0,6,0,3,0,27,3.857142857142857,2,0.0,0,8,0,6,10,0,0,3,0,14,13,1
1624,54424,iU4BkerxkC85turiATAPlGLqWWQBW3EA,SpATywNh6bZuzm8s1ceuBUnMUAeoAHHw,6,4,2,0,2,0,2,0,10,1.4285714285714286,1,0.0,0,2,0,2,4,0,0,2,0,4,6,0
1625,54428,fvcf8Mss4D9M5Dkk5Dn5T9NiTapwZ9dB,bWdj2GDclj5ofokWjzoa5jAwMkxCykd6,13,6,5,0,5,0,7,0,23,3.2857142857142856,3,0.0,0,5,0,5,6,0,0,7,0,10,13,1
1626,54433,0LlQk6hYRlvSzomDUaPkEEBmqmYnYmBf,A3fsA9Zfv1X2fVEQhTw51lKENdNrEqT3,8,9,3,0,3,0,3,0,18,2.5714285714285716,1,0.0,0,3,0,3,9,0,0,3,0,6,12,1
1627,54441,jWzOKFReJZdfMoypRkZGX0AJ4yOxVurG,SpATywNh6bZuzm8s1ceuBUnMUAeoAHHw,6,5,2,0,0,0,3,0,10,1.4285714285714286,1,0.0,2,2,0,0,3,0,0,3,0,4,6,1
1628,54454,xPyi5tVWLdzwESKbVSwWQTZrKjlUSal4,A3fsA9Zfv1X2fVEQhTw51lKENdNrEqT3,7,2,0,0,0,0,6,2,10,1.4285714285714286,1,0.0,0,0,0,0,2,0,0,6,2,0,10,1
1629,54456,9y3oRyXROykl3sBJ7TIi1TtD7SPjZS8A,RXDvfPUBYFlVdlueBFbLW0mhhAyGEqpt,1,0,0,0,0,0,1,0,1,0.14285714285714285,1,0.0,0,0,0,0,0,0,0,1,0,0,1,1
1630,54466,X0qRVbMFwtmOOuQv50UvryYfYmnstiNp,RXDvfPUBYFlVdlueBFbLW0mhhAyGEqpt,4,6,1,0,0,0,3,0,10,1.4285714285714286,2,0.0,0,1,0,0,6,0,0,3,0,1,9,1
1631,54474,2cQfWhwRUGUv48S47s2aDWYzSM5LRy6r,SpATywNh6bZuzm8s1ceuBUnMUAeoAHHw,6,4,1,0,1,0,1,0,7,1.0,1,0.0,0,1,0,1,4,0,0,1,0,2,5,1
1632,54513,wD600Vm6nYpRlm6dPdneFPtwC1POqb2E,SpATywNh6bZuzm8s1ceuBUnMUAeoAHHw,9,9,4,0,2,0,2,0,17,2.4285714285714284,1,0.0,2,4,0,2,7,0,0,2,0,8,9,1
1633,54539,obFplu8p0J5bdsesTSoaj6Bc4UGbTB6M,A3fsA9Zfv1X2fVEQhTw51lKENdNrEqT3,3,2,0,0,0,0,1,0,3,0.42857142857142855,1,0.0,0,0,0,0,2,0,0,1,0,0,3,1
1634,54560,PuyGNo8qc6xk0x7N225chheH1U0jpEmh,SpATywNh6bZuzm8s1ceuBUnMUAeoAHHw,6,5,2,4,0,0,1,0,12,1.7142857142857142,1,0.0,1,2,3,0,4,0,1,1,0,6,6,0
1635,54562,FjbDR3UaxcNBkb6IH3GDQCUcWtWdh8Qq,RXDvfPUBYFlVdlueBFbLW0mhhAyGEqpt,34,22,12,36,10,0,3,0,83,11.857142857142858,1,0.0,7,12,34,10,15,0,2,3,0,63,20,1
1636,54579,UTQBVZwwRuN7bMqGkwJeqpNJF2PPrsFV,bWdj2GDclj5ofokWjzoa5jAwMkxCykd6,5,4,2,0,1,0,2,0,9,1.2857142857142858,2,0.0,0,2,0,1,4,0,0,2,0,3,6,1
1637,54583,CQQHZVTg11Q29ZpbkjEKlKziDTQM27vd,SpATywNh6bZuzm8s1ceuBUnMUAeoAHHw,2,0,0,0,0,0,2,0,2,0.2857142857142857,1,0.0,0,0,0,0,0,0,0,2,0,0,2,1
1638,54714,GtuEelYfNaXxzKOllxbFfafnobOPHIGx,A3fsA9Zfv1X2fVEQhTw51lKENdNrEqT3,2,0,0,0,0,3,1,0,4,0.5714285714285714,1,0.0,0,0,0,0,0,3,0,1,0,0,4,1
1639,54970,YbQfcgwKrjskWW3wyOzQUUJYzdeHmY82,A3fsA9Zfv1X2fVEQhTw51lKENdNrEqT3,11,13,7,0,5,0,7,0,32,4.571428571428571,1,0.0,1,7,0,5,12,0,0,7,0,13,19,0
1640,55046,OsjipUObm67JsyJjOy7xHoa32L8CSYg5,7GRhBDsirIGkRZBtSMEzNTyDr2JQm4xx,47,53,2,75,1,1,4,0,136,19.428571428571427,2,0.0,27,2,73,1,26,1,2,4,0,103,33,1
1641,55086,PfTpx7WgTJY6IpNokJ2POml34GMs7LTI,A3fsA9Zfv1X2fVEQhTw51lKENdNrEqT3,28,7,5,68,3,0,1,0,84,12.0,1,0.0,1,5,65,3,6,0,3,1,0,74,10,0
1642,55108,oASR1hbK6DD6OJfTJCDKLW9l2vPgw7kR,SpATywNh6bZuzm8s1ceuBUnMUAeoAHHw,8,9,5,0,4,0,2,0,20,2.857142857142857,1,0.0,0,5,0,4,9,0,0,2,0,9,11,0
1643,55218,9DhjEr6688N0pGcvfzUDBy2Ch8BrzD6G,SpATywNh6bZuzm8s1ceuBUnMUAeoAHHw,6,5,0,0,0,0,3,0,8,1.1428571428571428,1,0.0,1,0,0,0,4,0,0,3,0,1,7,0
1644,55362,xkt3K6JWpnfeixDBdwkLXaHgXuuGt35v,7GRhBDsirIGkRZBtSMEzNTyDr2JQm4xx,10,14,7,4,6,0,3,0,34,4.857142857142857,2,0.0,2,7,3,6,12,0,1,3,0,18,16,1
1645,55398,46OTr627jSWtC8wrPe4BZiyNeqDxFeE3,SpATywNh6bZuzm8s1ceuBUnMUAeoAHHw,6,8,4,0,0,0,1,0,13,1.8571428571428572,1,0.0,2,4,0,0,6,0,0,1,0,6,7,0
1646,55714,ycZVLmNiTgP7M4zqov9Nx3hYhdN2qhKF,A3fsA9Zfv1X2fVEQhTw51lKENdNrEqT3,20,10,9,0,9,0,2,0,30,4.285714285714286,1,0.0,0,9,0,9,10,0,0,2,0,18,12,1
1647,55733,zVX5LPwTGC1SEitxSfv31cubNXKJSEc2,G8EPVSXsOYB5YQWZGiz1aVq5Pgr2GrQu,6,2,2,0,1,0,2,0,7,1.0,1,0.0,0,2,0,1,2,0,0,2,0,3,4,0
1648,55852,zC2jRq3r9EI7fiKmdxBaoujmdY4A8FN5,G8EPVSXsOYB5YQWZGiz1aVq5Pgr2GrQu,7,11,0,2,1,0,1,0,15,2.142857142857143,1,0.0,7,0,2,1,4,0,0,1,0,10,5,0
1649,55860,PmH4XgxtQe1CNb3l16TlTY5tyEhuC40E,SpATywNh6bZuzm8s1ceuBUnMUAeoAHHw,31,59,30,38,18,16,12,1,174,24.857142857142858,1,0.0,18,30,32,18,41,16,6,12,1,98,76,0
1650,55918,JOqHNkiAQMopMtNnxSpHdAOKSp68V43j,A3fsA9Zfv1X2fVEQhTw51lKENdNrEqT3,29,14,7,82,2,5,7,0,117,16.714285714285715,4,0.0,4,7,67,2,10,5,15,7,0,80,37,1
1651,55967,EK7Y6jLbcTIHEzN8KJHD55mY3w7SjZfJ,SpATywNh6bZuzm8s1ceuBUnMUAeoAHHw,18,36,0,8,2,5,2,0,53,7.571428571428571,1,0.0,17,0,8,2,19,5,0,2,0,27,26,1
1652,55978,JVRk883TChkd8D0ZSH6CEb3OUHD06lXQ,SpATywNh6bZuzm8s1ceuBUnMUAeoAHHw,21,25,13,14,5,5,3,0,65,9.285714285714286,1,0.0,5,13,13,5,20,5,1,3,0,36,29,0
1653,56078,kKj1FlDO03hIJs4qO2fYyQxEzv7HbwXh,SpATywNh6bZuzm8s1ceuBUnMUAeoAHHw,7,5,1,0,1,0,1,0,8,1.1428571428571428,1,0.0,0,1,0,1,5,0,0,1,0,2,6,1
1654,56104,WZLkW7B5dsHccBcGjqVOiLakE0tHruAV,SpATywNh6bZuzm8s1ceuBUnMUAeoAHHw,5,5,0,0,0,0,2,0,7,1.0,1,0.0,0,0,0,0,5,0,0,2,0,0,7,1
1655,56114,PmaZVK1XohXhK9MuIDoeUlsnQ3xunZ0o,SpATywNh6bZuzm8s1ceuBUnMUAeoAHHw,2,0,0,0,0,0,2,0,2,0.2857142857142857,1,0.0,0,0,0,0,0,0,0,2,0,0,2,1
1656,56517,Rz28tFT5qYZaEQ78Ly3OdJx8TpvsmLBy,A3fsA9Zfv1X2fVEQhTw51lKENdNrEqT3,9,7,4,0,1,0,19,0,31,4.428571428571429,1,0.0,0,4,0,1,7,0,0,19,0,5,26,0
1657,56566,6qgQAmX6y5wh5nEPRINOiKrZNoTl5yfT,G8EPVSXsOYB5YQWZGiz1aVq5Pgr2GrQu,6,7,5,2,0,3,2,0,19,2.7142857142857144,2,0.0,0,5,2,0,7,3,0,2,0,7,12,0
1658,56617,hhlID9e9RXNsuOHzHvfjbzrkpQmbpeir,SpATywNh6bZuzm8s1ceuBUnMUAeoAHHw,1,0,0,0,0,0,3,0,3,0.42857142857142855,1,0.0,0,0,0,0,0,0,0,3,0,0,3,1
1659,56652,uHeTIz8GkglZUts3zio1tGR2aBoYwiQE,bWdj2GDclj5ofokWjzoa5jAwMkxCykd6,16,19,14,36,2,17,3,0,91,13.0,1,0.0,2,14,31,2,17,17,5,3,0,49,42,1
1660,56867,qDignCY8ZSbFAHDmfGr6um90qnmxvInL,bWdj2GDclj5ofokWjzoa5jAwMkxCykd6,9,12,6,0,0,0,3,0,21,3.0,1,0.0,1,6,0,0,11,0,0,3,0,7,14,1
1661,56959,qZhmmNUvkNXdf3u04DTUQOFEBxxO10p4,A3fsA9Zfv1X2fVEQhTw51lKENdNrEqT3,1,0,0,0,0,0,2,0,2,0.2857142857142857,1,0.0,0,0,0,0,0,0,0,2,0,0,2,1
1662,56999,vbTgITzq6jZRj0oUV5gFotgOlwSXnjML,G8EPVSXsOYB5YQWZGiz1aVq5Pgr2GrQu,82,97,36,299,11,0,11,0,454,64.85714285714286,3,0.0,51,36,239,11,46,0,60,11,0,337,117,0
1663,57044,I7IIrHAh1LzzCf8lcvI92o8deFulzAh8,bWdj2GDclj5ofokWjzoa5jAwMkxCykd6,1,0,0,0,0,0,2,0,2,0.2857142857142857,1,0.0,0,0,0,0,0,0,0,2,0,0,2,1
1664,57250,3Jq0rhguTOZ7fja70sOOKUPAPqu7fQyT,SpATywNh6bZuzm8s1ceuBUnMUAeoAHHw,18,29,16,8,11,9,5,0,78,11.142857142857142,2,0.0,9,16,8,11,20,9,0,5,0,44,34,0
1665,57265,NFGYUC7dcOkWJh2BiZLJheVSucAvXvpt,bWdj2GDclj5ofokWjzoa5jAwMkxCykd6,4,2,1,0,1,0,1,0,5,0.7142857142857143,1,0.0,0,1,0,1,2,0,0,1,0,2,3,0
1666,57327,RdOaDfHEeBBslFA96Ipf8QaGmA7wq7Rz,SpATywNh6bZuzm8s1ceuBUnMUAeoAHHw,5,6,2,0,0,0,5,0,13,1.8571428571428572,1,0.0,0,2,0,0,6,0,0,5,0,2,11,0
1667,57329,XyoP35cBUiKk44G72mbtEXCBjk8FmHfo,bWdj2GDclj5ofokWjzoa5jAwMkxCykd6,19,28,14,15,7,0,4,0,68,9.714285714285714,2,0.0,8,14,13,7,20,0,2,4,0,42,26,1
1668,57710,pp3MkpuoWvkyzXCuYr4td0R2Hp9mxMXr,RXDvfPUBYFlVdlueBFbLW0mhhAyGEqpt,10,10,5,0,2,1,6,0,24,3.4285714285714284,1,0.0,0,5,0,2,10,1,0,6,0,7,17,1
1669,57761,tS5yd0InBPlA0CVUCBIjrGWKHeeeibf9,A3fsA9Zfv1X2fVEQhTw51lKENdNrEqT3,3,2,1,0,0,0,1,0,4,0.5714285714285714,1,0.0,0,1,0,0,2,0,0,1,0,1,3,0
1670,58013,Bf025FfgNrlcqN8gYGnmBAhjBy0v5Xmo,bWdj2GDclj5ofokWjzoa5jAwMkxCykd6,6,26,15,0,4,0,7,0,52,7.428571428571429,1,0.0,5,15,0,4,21,0,0,7,0,24,28,1
1671,58069,nWDRtsdyQI6TNTQknsvrXkgOEaTh8I0k,SpATywNh6bZuzm8s1ceuBUnMUAeoAHHw,25,23,13,16,8,5,3,0,68,9.714285714285714,1,0.0,8,13,16,8,15,5,0,3,0,45,23,0
1672,58147,GHWD27wG643ibd6OSLThLJ3MzX9fgfxx,A3fsA9Zfv1X2fVEQhTw51lKENdNrEqT3,12,6,4,0,4,0,2,0,16,2.2857142857142856,1,0.0,0,4,0,4,6,0,0,2,0,8,8,1
1673,58251,9irOSn8DGZwWtwp11aWu1YWsaS4jzhvZ,SpATywNh6bZuzm8s1ceuBUnMUAeoAHHw,3,2,0,0,0,0,1,0,3,0.42857142857142855,1,0.0,0,0,0,0,2,0,0,1,0,0,3,1
1674,58282,Gqs4K8SBL8tl8fMHpBqpJerrgEsieHU3,SpATywNh6bZuzm8s1ceuBUnMUAeoAHHw,8,17,2,0,1,0,3,0,23,3.2857142857142856,3,0.0,0,2,0,1,17,0,0,3,0,3,20,0
1675,58305,skJn7dtfSekFrPHRHs9swZ9AtSUKi36u,A3fsA9Zfv1X2fVEQhTw51lKENdNrEqT3,1,0,0,0,0,0,1,0,1,0.14285714285714285,1,0.0,0,0,0,0,0,0,0,1,0,0,1,1
1676,58334,ROctVkWGGi4RH8QWmC2p1iWZZ8pihPaJ,SpATywNh6bZuzm8s1ceuBUnMUAeoAHHw,3,2,0,0,0,0,1,0,3,0.42857142857142855,1,0.0,0,0,0,0,2,0,0,1,0,0,3,0
1677,58341,MU4dVyJTD7iIRSTZIdJZ9VoLOxogfKQN,SpATywNh6bZuzm8s1ceuBUnMUAeoAHHw,3,2,1,0,0,0,1,0,4,0.5714285714285714,1,0.0,0,1,0,0,2,0,0,1,0,1,3,0
1678,58348,n2LjMxx7cFpUJ3R3HfCHwCtJjfcc1KR0,G8EPVSXsOYB5YQWZGiz1aVq5Pgr2GrQu,9,7,5,0,3,0,2,0,17,2.4285714285714284,2,0.0,0,5,0,3,7,0,0,2,0,8,9,0
1679,58430,Ymf9IGFQ8uCjyMPNR9dFL9vuwfZDvaPV,SpATywNh6bZuzm8s1ceuBUnMUAeoAHHw,18,45,1,16,1,92,11,1,167,23.857142857142858,3,0.0,13,1,14,1,32,92,2,11,1,29,138,0
1680,58458,fgzbUfrTxXYCuiFYTG1cTemcEJUl36an,SpATywNh6bZuzm8s1ceuBUnMUAeoAHHw,3,6,3,0,0,1,3,0,13,1.8571428571428572,3,0.0,0,3,0,0,6,1,0,3,0,3,10,0
1681,58626,AsYvTZR1ylqWCh3nfRxgHS2CzZpeou5v,SpATywNh6bZuzm8s1ceuBUnMUAeoAHHw,17,18,15,12,6,0,2,0,53,7.571428571428571,1,0.0,2,15,12,6,16,0,0,2,0,35,18,0
1682,58661,t8qBiDTvOvYmrxcVIErRuEOf38tywm6t,SpATywNh6bZuzm8s1ceuBUnMUAeoAHHw,6,6,5,0,1,4,1,0,17,2.4285714285714284,1,0.0,0,5,0,1,6,4,0,1,0,6,11,0
1683,58724,QEq8GPuIzTapWcXcWLs8dzh5C4ugJ6qX,G8EPVSXsOYB5YQWZGiz1aVq5Pgr2GrQu,34,32,13,38,9,4,2,0,98,14.0,1,0.0,16,13,22,9,16,4,16,2,0,60,38,0
1684,58851,HcP22z9Adhad0eR6ILSXQ1kzpXBgJlCr,bWdj2GDclj5ofokWjzoa5jAwMkxCykd6,5,11,3,0,2,0,3,0,19,2.7142857142857144,2,0.0,1,3,0,2,10,0,0,3,0,6,13,1
1685,58996,w9HBKKfn4YUOWYdwRHKe80SIWiO37ZMJ,SpATywNh6bZuzm8s1ceuBUnMUAeoAHHw,17,30,12,14,6,0,7,0,69,9.857142857142858,2,0.0,8,12,13,6,22,0,1,7,0,39,30,0
1686,58997,1zErz13s8fNQRVaEvkOtvw6bLhr23yB4,bWdj2GDclj5ofokWjzoa5jAwMkxCykd6,11,8,4,34,0,0,1,0,47,6.714285714285714,1,0.0,3,4,28,0,5,0,6,1,0,35,12,0
1687,59056,HPaDTzk2xymxbpoa0VdcxdHl3uFfOfZk,A3fsA9Zfv1X2fVEQhTw51lKENdNrEqT3,4,2,1,0,0,0,2,0,5,0.7142857142857143,1,0.0,0,1,0,0,2,0,0,2,0,1,4,1
1688,59064,gzTBwYPoQwnODJJ2vedsUKp2EoGao5Fz,A3fsA9Zfv1X2fVEQhTw51lKENdNrEqT3,1,0,0,0,0,0,2,0,2,0.2857142857142857,2,0.0,0,0,0,0,0,0,0,2,0,0,2,1
1689,60203,ntJs93C1h80peQsrk4sMYD3xVOjdEHeo,7GRhBDsirIGkRZBtSMEzNTyDr2JQm4xx,38,112,29,85,30,84,9,0,349,49.857142857142854,4,0.0,74,29,76,30,38,84,9,9,0,209,140,0
1690,60546,uQUPzFXltLm3Yz8qgEvw1fMPbbS4q4MZ,7GRhBDsirIGkRZBtSMEzNTyDr2JQm4xx,4,2,1,0,1,0,2,0,6,0.8571428571428571,1,0.0,0,1,0,1,2,0,0,2,0,2,4,1
1691,61118,pGlV0XYWRjXFSIdN56x9p6AvQyXwsZVS,7GRhBDsirIGkRZBtSMEzNTyDr2JQm4xx,25,28,9,49,6,4,3,0,99,14.142857142857142,2,0.0,16,9,40,6,12,4,9,3,0,71,28,0
1692,61595,3rZRyyAqQR0LHT7iXSTyhR4wZI7IzOpN,SpATywNh6bZuzm8s1ceuBUnMUAeoAHHw,14,19,0,15,0,0,1,0,35,5.0,1,0.0,4,0,13,0,15,0,2,1,0,17,18,0
1693,61601,gLjUrp9o3bBy4JIhHE7DImScxZdU76o3,bWdj2GDclj5ofokWjzoa5jAwMkxCykd6,7,4,1,20,1,0,0,0,26,3.7142857142857144,2,0.0,1,1,17,1,3,0,3,0,0,20,6,0
1694,61613,gF4BAuOIIfmyUL9KgVWqdIaoDpcXFfvU,SpATywNh6bZuzm8s1ceuBUnMUAeoAHHw,18,50,14,18,4,0,4,0,90,12.857142857142858,1,0.0,9,14,16,4,41,0,2,4,0,43,47,1
1695,61786,CE534SSZ9CscDvjbZWQWNUmxhQozf8Uw,SpATywNh6bZuzm8s1ceuBUnMUAeoAHHw,16,33,19,22,6,0,3,0,83,11.857142857142858,2,0.0,11,19,17,6,22,0,5,3,0,53,30,0
1696,61873,GjYrFH6x4o6vyLHEw4EuuSJvAfuLPk1y,SpATywNh6bZuzm8s1ceuBUnMUAeoAHHw,28,33,15,30,8,0,6,0,92,13.142857142857142,1,0.0,17,15,24,8,16,0,6,6,0,64,28,0
1697,61902,q2vdNmhZGOp0NF57Oy2lI01Qgjw4Vdei,SpATywNh6bZuzm8s1ceuBUnMUAeoAHHw,8,10,8,0,5,0,2,0,25,3.5714285714285716,1,0.0,0,8,0,5,10,0,0,2,0,13,12,1
1698,62027,NcracMTfiaTPMbO6SSDnt9CDc4SnvBs9,bWdj2GDclj5ofokWjzoa5jAwMkxCykd6,26,11,5,50,2,3,6,1,78,11.142857142857142,1,0.0,2,5,45,2,9,3,5,6,1,54,24,0
1699,62042,ml2yAwYHzufxZ6xJCtzUFr2eNYyPECGG,SpATywNh6bZuzm8s1ceuBUnMUAeoAHHw,22,36,19,27,8,0,3,0,93,13.285714285714286,1,0.0,14,19,24,8,22,0,3,3,0,65,28,1
1700,62101,uJIh67cllxQLgAhipzdDZMEunDbuBxvF,SpATywNh6bZuzm8s1ceuBUnMUAeoAHHw,16,10,8,4,4,0,2,0,28,4.0,1,0.0,1,8,4,4,9,0,0,2,0,17,11,0
1701,62128,R2cga9JVVM2tXEVs2saYswslfxAU4nMk,A3fsA9Zfv1X2fVEQhTw51lKENdNrEqT3,9,4,3,0,2,0,5,0,14,2.0,1,0.0,0,3,0,2,4,0,0,5,0,5,9,1
1702,62213,QbN1rcT6X70kGcCCu9qHO2zQXGCyhPMc,SpATywNh6bZuzm8s1ceuBUnMUAeoAHHw,7,10,3,0,2,0,2,0,17,2.4285714285714284,1,0.0,0,3,0,2,10,0,0,2,0,5,12,1
1703,62349,YBtKAFQt6fk6EIukc4Ut5J2kdzYxomaP,SpATywNh6bZuzm8s1ceuBUnMUAeoAHHw,1,0,0,0,0,0,1,0,1,0.14285714285714285,1,0.0,0,0,0,0,0,0,0,1,0,0,1,1
1704,62360,g1maG24WsPdpEOMuZUsxQc7SlEYHJjT4,bWdj2GDclj5ofokWjzoa5jAwMkxCykd6,6,7,3,0,2,0,3,0,15,2.142857142857143,1,0.0,2,3,0,2,5,0,0,3,0,7,8,0
1705,62368,4ct6kljhf27XSdXxxeVXKJL0lQ4aKOK7,7GRhBDsirIGkRZBtSMEzNTyDr2JQm4xx,6,4,1,0,1,0,1,0,7,1.0,1,0.0,0,1,0,1,4,0,0,1,0,2,5,1
1706,62428,Y5CSlxjOPHMFV7ik3pSpx6t0PJdYKnrH,SpATywNh6bZuzm8s1ceuBUnMUAeoAHHw,17,16,10,12,5,0,3,0,46,6.571428571428571,1,0.0,4,10,10,5,12,0,2,3,0,29,17,0
1707,62458,j8vYdYwa9gvt7hkF8dykZR2D4h75QsII,SpATywNh6bZuzm8s1ceuBUnMUAeoAHHw,17,23,11,17,3,6,4,0,64,9.142857142857142,1,0.0,10,11,15,3,13,6,2,4,0,39,25,1
1708,62484,l0WeYpTymokLlVEEJTixsYdgJaxPgZqy,7GRhBDsirIGkRZBtSMEzNTyDr2JQm4xx,1,0,0,0,0,0,1,0,1,0.14285714285714285,1,0.0,0,0,0,0,0,0,0,1,0,0,1,1
1709,62490,GWSq56qmQUucFgSgP2raEZeoKP7Athee,SpATywNh6bZuzm8s1ceuBUnMUAeoAHHw,6,57,0,0,0,0,2,0,59,8.428571428571429,1,0.0,0,0,0,0,57,0,0,2,0,0,59,0
1710,62530,l7f4vHvlZkxCYoU9qM63V45bmndBSeZQ,SpATywNh6bZuzm8s1ceuBUnMUAeoAHHw,7,5,2,18,0,0,1,0,26,3.7142857142857144,1,0.0,2,2,15,0,3,0,3,1,0,19,7,0
1711,62593,fBjkk55LEjUXpgvkPNjyZGCtR2am4TcN,SpATywNh6bZuzm8s1ceuBUnMUAeoAHHw,24,33,18,16,12,0,5,0,84,12.0,4,0.0,3,18,15,12,30,0,1,5,0,48,36,0
1712,62664,6rvhZ1qSfYtmyLXdh13xI1z8Ly1xy1X7,A3fsA9Zfv1X2fVEQhTw51lKENdNrEqT3,2,0,0,0,0,0,2,0,2,0.2857142857142857,1,0.0,0,0,0,0,0,0,0,2,0,0,2,1
1713,62695,N0Sos51WanCzoSGKDmMPzQtMlLxY3bFb,A3fsA9Zfv1X2fVEQhTw51lKENdNrEqT3,33,11,8,76,4,8,7,1,115,16.428571428571427,1,0.0,1,8,61,4,10,8,15,7,1,74,41,0
1714,62751,RjUWkdPtbuKazr3SZ8iaujuOx2ne7ey1,7GRhBDsirIGkRZBtSMEzNTyDr2JQm4xx,16,30,13,20,2,16,3,0,84,12.0,1,0.0,15,13,20,2,15,16,0,3,0,50,34,0
1715,62936,l6huwkyakLvA9G4ixwxpAcJxBdbbcmJP,SpATywNh6bZuzm8s1ceuBUnMUAeoAHHw,16,16,9,11,6,2,2,0,46,6.571428571428571,1,0.0,6,9,11,6,10,2,0,2,0,32,14,0
1716,62938,eLqag6twmL6nT6SLVrpY07QGG3bytKwe,SpATywNh6bZuzm8s1ceuBUnMUAeoAHHw,3,4,0,0,0,0,2,0,6,0.8571428571428571,2,0.0,0,0,0,0,4,0,0,2,0,0,6,0
1717,62970,RS564zscXajJOiW9woDtEu4M9LDaNEPd,7GRhBDsirIGkRZBtSMEzNTyDr2JQm4xx,7,6,3,0,2,0,1,0,12,1.7142857142857142,1,0.0,0,3,0,2,6,0,0,1,0,5,7,1
1718,62985,SDq3f6KWdckVLJCSJxIwedwz5gfJhoTJ,SpATywNh6bZuzm8s1ceuBUnMUAeoAHHw,5,4,2,0,0,0,1,0,7,1.0,1,0.0,0,2,0,0,4,0,0,1,0,2,5,1
1719,63072,TvDWPoJyTprTu0vxto5NxLIJOfQBmxVE,7GRhBDsirIGkRZBtSMEzNTyDr2JQm4xx,3,5,1,0,0,0,0,0,6,0.8571428571428571,1,0.0,0,1,0,0,5,0,0,0,0,1,5,0
1720,63124,8nlNDsWSaxHCvsMKtqhBs81sknEiTCeb,A3fsA9Zfv1X2fVEQhTw51lKENdNrEqT3,32,21,17,0,12,0,6,0,56,8.0,3,0.0,0,17,0,12,21,0,0,6,0,29,27,0
1721,63161,CcZ2EQGxkq4lhEIujCU8FZkit7DT7C79,7GRhBDsirIGkRZBtSMEzNTyDr2JQm4xx,4,0,0,0,0,0,3,1,4,0.5714285714285714,1,0.0,0,0,0,0,0,0,0,3,1,0,4,0
1722,63242,jzQypdHgDGImzo6sjFmv4z8itS7CTk6P,7GRhBDsirIGkRZBtSMEzNTyDr2JQm4xx,12,37,1,18,0,5,11,0,72,10.285714285714286,1,0.0,21,1,13,0,16,5,5,11,0,35,37,1
1723,63271,DHenWrxVzReZszxo1qw3Im0Zj99tiAII,A3fsA9Zfv1X2fVEQhTw51lKENdNrEqT3,24,9,4,56,0,19,7,0,95,13.571428571428571,1,0.0,3,4,49,0,6,19,7,7,0,56,39,0
1724,63299,HvCZ1bV9L7D0erySzp1UH1mW8tuWfYPw,7GRhBDsirIGkRZBtSMEzNTyDr2JQm4xx,2,1,0,0,0,0,1,0,2,0.2857142857142857,1,0.0,0,0,0,0,1,0,0,1,0,0,2,1
1725,63317,cCSfok1u0ViZa45fCaFvMzY0bswyqxIC,7GRhBDsirIGkRZBtSMEzNTyDr2JQm4xx,1,0,0,0,0,0,1,0,1,0.14285714285714285,1,0.0,0,0,0,0,0,0,0,1,0,0,1,1
1726,63322,Q7wqVDqz10tk4xe6QnkzI1dJqMLzdK4Z,7GRhBDsirIGkRZBtSMEzNTyDr2JQm4xx,1,0,0,0,0,0,1,0,1,0.14285714285714285,1,0.0,0,0,0,0,0,0,0,1,0,0,1,0
1727,63368,UkY8GL1wnGxl65A7vEeGH2v9yDS6ABDQ,7GRhBDsirIGkRZBtSMEzNTyDr2JQm4xx,1,0,0,0,0,0,1,0,1,0.14285714285714285,1,0.0,0,0,0,0,0,0,0,1,0,0,1,1
1728,63379,jSPgiXDCISXGmLFuOlDszBfMRRboKynI,7GRhBDsirIGkRZBtSMEzNTyDr2JQm4xx,7,4,3,0,2,0,1,0,10,1.4285714285714286,1,0.0,0,3,0,2,4,0,0,1,0,5,5,1
1729,63427,OcEwAP7KVM22YlzUoPdivyTSWtkZ4qVM,7GRhBDsirIGkRZBtSMEzNTyDr2JQm4xx,1,0,0,0,0,0,2,0,2,0.2857142857142857,1,0.0,0,0,0,0,0,0,0,2,0,0,2,1
1730,63439,YPxQmDfYnmHgiT7CBa1xK3KUyMZAnQfd,7GRhBDsirIGkRZBtSMEzNTyDr2JQm4xx,10,5,3,4,3,0,2,0,17,2.4285714285714284,1,0.0,1,3,4,3,4,0,0,2,0,11,6,1
1731,63461,4TtGjmtd4ISORDD5okRgx7kXAcGUW8IN,7GRhBDsirIGkRZBtSMEzNTyDr2JQm4xx,10,10,5,0,1,0,4,0,20,2.857142857142857,3,0.0,4,5,0,1,6,0,0,4,0,10,10,0
1732,63529,DPNeCmHDELHrss8mkRKEcvkApu8OfWuh,7GRhBDsirIGkRZBtSMEzNTyDr2JQm4xx,6,3,2,0,2,0,1,0,8,1.1428571428571428,1,0.0,0,2,0,2,3,0,0,1,0,4,4,1
1733,63565,AumBArZbFsuZrJ22dCd66gJYrxhP9K8S,7GRhBDsirIGkRZBtSMEzNTyDr2JQm4xx,6,2,1,0,1,0,4,0,8,1.1428571428571428,1,0.0,0,1,0,1,2,0,0,4,0,2,6,1
1734,63568,ibHntt3xSwry6DyouiN0fYSmzCgepI7L,7GRhBDsirIGkRZBtSMEzNTyDr2JQm4xx,5,2,1,0,1,0,2,0,6,0.8571428571428571,1,0.0,0,1,0,1,2,0,0,2,0,2,4,1
1735,63569,oioEx16Qafdl8cwDYVMh95PwtEgk5wrw,7GRhBDsirIGkRZBtSMEzNTyDr2JQm4xx,6,7,0,7,0,0,2,0,16,2.2857142857142856,1,0.0,1,0,6,0,6,0,1,2,0,7,9,1
1736,63602,d0OQm2fl37nUvfl8Q7XxAwON3v0i0KHs,7GRhBDsirIGkRZBtSMEzNTyDr2JQm4xx,1,0,0,0,0,0,1,0,1,0.14285714285714285,1,0.0,0,0,0,0,0,0,0,1,0,0,1,1
1737,63687,dtbXtMjPqeEvzoZBFe2y9uSDcjL0lnx2,A3fsA9Zfv1X2fVEQhTw51lKENdNrEqT3,8,8,0,0,0,8,3,0,19,2.7142857142857144,1,0.0,0,0,0,0,8,8,0,3,0,0,19,0
1738,63698,uA8SH3KKGTykRcaxzO63OBZZtTvabLlI,7GRhBDsirIGkRZBtSMEzNTyDr2JQm4xx,7,3,1,0,1,0,3,0,8,1.1428571428571428,1,0.0,0,1,0,1,3,0,0,3,0,2,6,1
1739,63880,4RiemE5r88jWq9gaL0lVYzjeUhWq3sNP,7GRhBDsirIGkRZBtSMEzNTyDr2JQm4xx,2,0,0,0,0,0,3,0,3,0.42857142857142855,1,0.0,0,0,0,0,0,0,0,3,0,0,3,1
1740,63975,vSoHqjlgOX9Gp12iQzdBUtqEoI4dyxq9,7GRhBDsirIGkRZBtSMEzNTyDr2JQm4xx,1,0,0,0,0,0,1,0,1,0.14285714285714285,1,0.0,0,0,0,0,0,0,0,1,0,0,1,1
1741,63986,kYf958xQgpYsrp0Tv3pEoO2XCYRj674R,7GRhBDsirIGkRZBtSMEzNTyDr2JQm4xx,7,3,2,0,0,1,6,1,13,1.8571428571428572,1,0.0,0,2,0,0,3,1,0,6,1,2,11,1
1742,64056,dpaGOQqV12WO7eNeCUpu7DUPmdhwuEC5,7GRhBDsirIGkRZBtSMEzNTyDr2JQm4xx,1,0,0,0,0,0,1,0,1,0.14285714285714285,1,0.0,0,0,0,0,0,0,0,1,0,0,1,1
1743,64152,e6qJWnBH5Aakpza4HlA3Q0irc2hEFZ0M,7GRhBDsirIGkRZBtSMEzNTyDr2JQm4xx,1,0,0,0,0,0,1,0,1,0.14285714285714285,1,0.0,0,0,0,0,0,0,0,1,0,0,1,1
1744,65754,d7lqWAJ8cu1e9f8Lb1eNhG3YSdhF0Qy7,7GRhBDsirIGkRZBtSMEzNTyDr2JQm4xx,3,1,0,0,0,0,2,0,3,0.42857142857142855,1,0.0,0,0,0,0,1,0,0,2,0,0,3,1
1745,66553,X1KDcg6FJGcjALhOEz460JY2SzJ27Ewm,RXDvfPUBYFlVdlueBFbLW0mhhAyGEqpt,6,1,1,0,1,0,7,0,10,1.4285714285714286,1,0.0,0,1,0,1,1,0,0,7,0,2,8,1
1746,66583,L3sYIZrtCe33arrsIgJGTKImw4yL48kj,G8EPVSXsOYB5YQWZGiz1aVq5Pgr2GrQu,11,8,5,0,3,0,4,0,20,2.857142857142857,1,0.0,0,5,0,3,8,0,0,4,0,8,12,0
1747,66584,ZRcEnEYSSBQbkjzMu7sidjbxasfrmw8l,RXDvfPUBYFlVdlueBFbLW0mhhAyGEqpt,3,2,1,0,0,0,1,0,4,0.5714285714285714,1,0.0,0,1,0,0,2,0,0,1,0,1,3,1
1748,66616,aQkZtyhfWM4x1GodnKorBxGkYsdqjpct,G8EPVSXsOYB5YQWZGiz1aVq5Pgr2GrQu,5,3,1,0,0,0,2,0,6,0.8571428571428571,1,0.0,0,1,0,0,3,0,0,2,0,1,5,1
1749,66621,5TeLMYHqzQAKUmQpWnvEv2hxOy9X1UKJ,SpATywNh6bZuzm8s1ceuBUnMUAeoAHHw,5,4,3,0,0,0,1,0,8,1.1428571428571428,1,0.0,0,3,0,0,4,0,0,1,0,3,5,1
1750,66646,qZhmmNUvkNXdf3u04DTUQOFEBxxO10p4,G8EPVSXsOYB5YQWZGiz1aVq5Pgr2GrQu,34,32,11,50,6,0,8,1,108,15.428571428571429,3,0.0,4,11,42,6,28,0,8,8,1,63,45,1
1751,66695,9hMYmYnY4O2N6jg4p4MNxwDczZbVqp3T,RXDvfPUBYFlVdlueBFbLW0mhhAyGEqpt,21,12,11,0,9,0,2,1,35,5.0,1,0.0,0,11,0,9,12,0,0,2,1,20,15,1
1752,66713,LMGbvXS3ZBgtTcKCRLMcqBHrfADBxwXe,G8EPVSXsOYB5YQWZGiz1aVq5Pgr2GrQu,1,0,0,0,0,0,1,0,1,0.14285714285714285,1,0.0,0,0,0,0,0,0,0,1,0,0,1,0
1753,66745,qt9pojYUdSU9dxSioMDEso1f0UH6has1,SpATywNh6bZuzm8s1ceuBUnMUAeoAHHw,11,15,5,0,2,0,2,0,24,3.4285714285714284,1,0.0,2,5,0,2,13,0,0,2,0,9,15,1
1754,66789,5ZyvCd3AP7a8azCiLN5JfLAP53iZpAyD,SpATywNh6bZuzm8s1ceuBUnMUAeoAHHw,2,0,0,0,0,0,2,0,2,0.2857142857142857,1,0.0,0,0,0,0,0,0,0,2,0,0,2,0
1755,66911,n0HFF3TwqKuBMzzkdLCbvb8Mji5ZUnVX,RXDvfPUBYFlVdlueBFbLW0mhhAyGEqpt,7,4,3,0,2,0,1,0,10,1.4285714285714286,1,0.0,0,3,0,2,4,0,0,1,0,5,5,1
1756,66928,UnlpBoCCKa1g59dweQPJmefdPMpfSVLe,G8EPVSXsOYB5YQWZGiz1aVq5Pgr2GrQu,11,13,7,16,4,0,0,0,40,5.714285714285714,2,0.0,5,7,8,4,8,0,8,0,0,24,16,1
1757,66948,ylHVd8NK0xyUeGJijtfFcdu7sSX07hsS,SpATywNh6bZuzm8s1ceuBUnMUAeoAHHw,5,3,2,0,1,0,1,0,7,1.0,1,0.0,0,2,0,1,3,0,0,1,0,3,4,1
1758,66972,4mxqWsjuug2blsnsk9e2hDH5ZKMeIfme,SpATywNh6bZuzm8s1ceuBUnMUAeoAHHw,6,3,2,0,1,0,4,0,10,1.4285714285714286,1,0.0,0,2,0,1,3,0,0,4,0,3,7,1
1759,67020,jWJjb2ULtCbg7TxaVgejXvNjReg1rWMJ,SpATywNh6bZuzm8s1ceuBUnMUAeoAHHw,6,3,0,0,0,0,10,0,13,1.8571428571428572,1,0.0,0,0,0,0,3,0,0,10,0,0,13,1
1760,67062,lsez2NExtDzqmHTj1WxlkldAKydbGpGz,SpATywNh6bZuzm8s1ceuBUnMUAeoAHHw,16,12,8,7,4,0,2,0,33,4.714285714285714,2,0.0,2,8,7,4,10,0,0,2,0,21,12,0
1761,67084,t2CefH6ir3GuQXTz3Lok7bxtMew2Evw7,RXDvfPUBYFlVdlueBFbLW0mhhAyGEqpt,12,6,5,0,4,0,2,0,17,2.4285714285714284,1,0.0,0,5,0,4,6,0,0,2,0,9,8,1
1762,67186,2mFdcZdKuSUvueHyZE3zvpjXpyVcJptR,bWdj2GDclj5ofokWjzoa5jAwMkxCykd6,17,26,3,31,1,5,5,1,72,10.285714285714286,1,0.0,9,3,28,1,17,5,3,5,1,41,31,1
1763,67197,OvFsbGXgDD3DXdRTUFBoMvrSVsi4VT3x,SpATywNh6bZuzm8s1ceuBUnMUAeoAHHw,13,8,5,18,2,0,4,0,37,5.285714285714286,1,0.0,2,5,15,2,6,0,3,4,0,24,13,0
1764,67304,WYUvDmjrCchGW5prlJ6BZEDjHOYsgZsG,G8EPVSXsOYB5YQWZGiz1aVq5Pgr2GrQu,19,22,8,22,3,5,5,0,65,9.285714285714286,2,0.0,11,8,11,3,11,5,11,5,0,33,32,1
1765,67311,rRP9Jqic5Mwtv2NanjU01SwWXGZ8kuBu,SpATywNh6bZuzm8s1ceuBUnMUAeoAHHw,5,3,1,0,1,0,1,0,6,0.8571428571428571,1,0.0,0,1,0,1,3,0,0,1,0,2,4,1
1766,67315,gc2449Ag0boGNd6nrwcfyjhFar24UaYH,RXDvfPUBYFlVdlueBFbLW0mhhAyGEqpt,3,7,3,0,0,0,2,0,12,1.7142857142857142,2,0.0,0,3,0,0,7,0,0,2,0,3,9,1
1767,67344,dWJvaQw3sMX6buidtTfwYxdEvR1DZxlK,bWdj2GDclj5ofokWjzoa5jAwMkxCykd6,4,4,0,0,0,0,1,0,5,0.7142857142857143,1,0.0,0,0,0,0,4,0,0,1,0,0,5,1
1768,67356,T6lJMwNIVHZiShXC2FiLzuiG8wkuUByo,SpATywNh6bZuzm8s1ceuBUnMUAeoAHHw,6,2,0,0,0,1,5,1,9,1.2857142857142858,1,0.0,0,0,0,0,2,1,0,5,1,0,9,1
1769,67390,aQ6WrdDe9pTNwVW3vmaMOs1pxy5r3Dxa,RXDvfPUBYFlVdlueBFbLW0mhhAyGEqpt,8,9,6,0,0,12,4,1,32,4.571428571428571,1,0.0,0,6,0,0,9,12,0,4,1,6,26,1
1770,67403,s42YRljOqExiv71QhA2soTLfn9kHZdPI,bWdj2GDclj5ofokWjzoa5jAwMkxCykd6,3,2,1,0,0,0,2,0,5,0.7142857142857143,1,0.0,0,1,0,0,2,0,0,2,0,1,4,1
1771,67407,s42YRljOqExiv71QhA2soTLfn9kHZdPI,G8EPVSXsOYB5YQWZGiz1aVq5Pgr2GrQu,9,14,10,0,0,0,3,0,27,3.857142857142857,2,0.0,0,10,0,0,14,0,0,3,0,10,17,1
1772,67420,IQ0KwwSF7jAVaA1XdkRcnXVwTeEvf1Lv,G8EPVSXsOYB5YQWZGiz1aVq5Pgr2GrQu,4,1,0,0,0,0,5,0,6,0.8571428571428571,1,0.0,0,0,0,0,1,0,0,5,0,0,6,1
1773,67426,VFYk1GyeJyGqK1t09cLe0E5m7KsULmvc,G8EPVSXsOYB5YQWZGiz1aVq5Pgr2GrQu,3,0,0,0,0,30,3,0,33,4.714285714285714,2,0.0,0,0,0,0,0,30,0,3,0,0,33,1
1774,67432,FdsEBC0mHy1vT6x3hjK3QpB4Q1Uhf4Gh,SpATywNh6bZuzm8s1ceuBUnMUAeoAHHw,18,15,0,12,0,0,4,1,32,4.571428571428571,1,0.0,2,0,10,0,13,0,2,4,1,12,20,0
1775,67642,BwXR7IzUtCAN8pzY1XJl6dbItwnWn8P1,SpATywNh6bZuzm8s1ceuBUnMUAeoAHHw,10,10,5,9,1,0,4,0,29,4.142857142857143,2,0.0,2,5,9,1,8,0,0,4,0,17,12,0
1776,67658,h5afPVcogbI1QW4dfwFBz4UIlWjjM3RW,SpATywNh6bZuzm8s1ceuBUnMUAeoAHHw,20,21,10,14,4,3,9,2,63,9.0,1,0.0,8,10,13,4,13,3,1,9,2,35,28,0
1777,67852,3Aezv8lgcVyIW4Uwgi3KMiL4RZSkwke5,SpATywNh6bZuzm8s1ceuBUnMUAeoAHHw,9,6,3,16,0,0,3,0,28,4.0,2,0.0,2,3,14,0,4,0,2,3,0,19,9,1
1778,67918,pzHaWUcmzb5LgLjIjpaBYBq7daMNFpyk,SpATywNh6bZuzm8s1ceuBUnMUAeoAHHw,16,24,0,15,0,0,4,0,43,6.142857142857143,1,0.0,9,0,15,0,15,0,0,4,0,24,19,1
1779,68045,Qxy5KsClrN9vr6xM8xy9xnCXA2MaJ6Yo,SpATywNh6bZuzm8s1ceuBUnMUAeoAHHw,1,0,0,0,0,0,2,0,2,0.2857142857142857,1,0.0,0,0,0,0,0,0,0,2,0,0,2,1
1780,68106,13DcuqcvvZMyCe7b78EqeBeeWiXw335e,G8EPVSXsOYB5YQWZGiz1aVq5Pgr2GrQu,10,57,1,0,26,0,1,0,85,12.142857142857142,1,0.0,50,1,0,26,7,0,0,1,0,77,8,1
1781,68117,MDJGW12z1ZhMFT2gTIbEYAqP2tu7pkDh,SpATywNh6bZuzm8s1ceuBUnMUAeoAHHw,22,31,15,17,4,60,15,2,144,20.571428571428573,3,0.0,12,15,15,4,19,60,2,15,2,46,98,0
1782,68170,bpxaFadaQixJuWRVtAAq5miKiBM3zC6u,bWdj2GDclj5ofokWjzoa5jAwMkxCykd6,12,34,9,0,1,0,15,0,59,8.428571428571429,3,0.0,4,9,0,1,30,0,0,15,0,14,45,1
1783,68171,XNe46LXabpvEI4s4Cxqc45erOVco8nzW,RXDvfPUBYFlVdlueBFbLW0mhhAyGEqpt,4,4,3,0,0,0,2,0,9,1.2857142857142858,1,0.0,0,3,0,0,4,0,0,2,0,3,6,0
1784,68218,Lbpr3xWnQcIYr1qRkqlNlsrYRpIeuPh8,SpATywNh6bZuzm8s1ceuBUnMUAeoAHHw,6,10,3,0,2,2,3,0,20,2.857142857142857,2,0.0,0,3,0,2,10,2,0,3,0,5,15,1
1785,68219,PLTytqL5kLJdDGm9MvAFVaFDS2S7nPDO,SpATywNh6bZuzm8s1ceuBUnMUAeoAHHw,15,12,7,6,4,0,2,0,31,4.428571428571429,1,0.0,2,7,6,4,10,0,0,2,0,19,12,1
1786,68366,KWreIfKGdz3TT4Efo15YH7GPido1RPFL,RXDvfPUBYFlVdlueBFbLW0mhhAyGEqpt,3,2,1,0,0,0,1,0,4,0.5714285714285714,1,0.0,0,1,0,0,2,0,0,1,0,1,3,1
1787,68391,GVe9EjZzf7ESYXvbkluFC1UhcDJcs9er,bWdj2GDclj5ofokWjzoa5jAwMkxCykd6,3,2,1,0,0,0,1,0,4,0.5714285714285714,1,0.0,0,1,0,0,2,0,0,1,0,1,3,1
1788,68469,Xa3jTMZEURd4gE5fwojMlxo2QtjAxwez,bWdj2GDclj5ofokWjzoa5jAwMkxCykd6,1,0,0,0,0,0,1,0,1,0.14285714285714285,1,0.0,0,0,0,0,0,0,0,1,0,0,1,1
1789,68522,iSIDy53M1GeZpXt46JkUT1CVMnifiRBT,G8EPVSXsOYB5YQWZGiz1aVq5Pgr2GrQu,6,3,2,8,0,0,2,0,15,2.142857142857143,1,0.0,0,2,7,0,3,0,1,2,0,9,6,1
1790,68531,hZR4MwcYec4g0GoOyJFngJGEyWOySpv2,RXDvfPUBYFlVdlueBFbLW0mhhAyGEqpt,6,3,2,0,1,5,4,0,15,2.142857142857143,1,0.0,0,2,0,1,3,5,0,4,0,3,12,0
1791,68546,op92WqXlATrimvc1hvYZEQwtjHkoChge,RXDvfPUBYFlVdlueBFbLW0mhhAyGEqpt,1,0,0,0,0,0,1,0,1,0.14285714285714285,1,0.0,0,0,0,0,0,0,0,1,0,0,1,1
1792,68583,forPgRyluFqH5fyMZfnKJctNYjPII95b,RXDvfPUBYFlVdlueBFbLW0mhhAyGEqpt,7,3,0,0,0,5,7,1,16,2.2857142857142856,1,0.0,0,0,0,0,3,5,0,7,1,0,16,1
1793,68629,M2AmcvqhvMtUlyRV6vMvvoM2IhrMmAwT,bWdj2GDclj5ofokWjzoa5jAwMkxCykd6,7,5,3,0,1,0,2,0,11,1.5714285714285714,1,0.0,0,3,0,1,5,0,0,2,0,4,7,1
1794,68657,kouVFmC9KYKK6YQi2WuQuIKCuxGX5ljt,RXDvfPUBYFlVdlueBFbLW0mhhAyGEqpt,3,2,1,0,0,0,1,0,4,0.5714285714285714,1,0.0,0,1,0,0,2,0,0,1,0,1,3,0
1795,68676,OvG0QIZOPiV3oa4UqFgxzNEprO7pKVmV,SpATywNh6bZuzm8s1ceuBUnMUAeoAHHw,17,13,6,8,4,1,3,0,35,5.0,1,0.0,2,6,8,4,11,1,0,3,0,20,15,0
1796,68704,5MOHfgPntZIsRWkQebauzpUgUSaHvhFJ,SpATywNh6bZuzm8s1ceuBUnMUAeoAHHw,7,16,8,0,0,0,3,0,27,3.857142857142857,2,0.0,5,8,0,0,11,0,0,3,0,13,14,0
1797,68739,kNijCkWRNCwIOtL9mKx9mB8Vau6ujWr3,SpATywNh6bZuzm8s1ceuBUnMUAeoAHHw,28,44,13,29,6,18,4,3,117,16.714285714285715,1,0.0,27,13,28,6,17,18,1,4,3,74,43,1
1798,68811,JXT9wmO8lGZMBaQQK0U8pHKQIW1oOnDo,RXDvfPUBYFlVdlueBFbLW0mhhAyGEqpt,5,2,2,0,2,0,2,0,8,1.1428571428571428,1,0.0,0,2,0,2,2,0,0,2,0,4,4,1
1799,68822,T3xcwszBjaOdB7YgVcZfsRhjJ9lfkEVZ,SpATywNh6bZuzm8s1ceuBUnMUAeoAHHw,1,0,0,0,0,0,1,0,1,0.14285714285714285,1,0.0,0,0,0,0,0,0,0,1,0,0,1,1
1800,68833,tn5nSlJLNdxx4Uni5Dn3S8nwDR8GJibq,SpATywNh6bZuzm8s1ceuBUnMUAeoAHHw,17,16,10,9,5,0,3,0,43,6.142857142857143,1,0.0,3,10,9,5,13,0,0,3,0,27,16,0
1801,68839,ci6w9FxXwoWvsu2Aw9ojvjfPhjaGgaxN,SpATywNh6bZuzm8s1ceuBUnMUAeoAHHw,9,16,8,10,0,0,8,0,42,6.0,4,0.0,2,8,8,0,14,0,2,8,0,18,24,1
1802,68849,l21tCwOolR7RD0CZyqRiNHHeEZC1D67K,bWdj2GDclj5ofokWjzoa5jAwMkxCykd6,5,4,2,0,1,0,1,0,8,1.1428571428571428,1,0.0,1,2,0,1,3,0,0,1,0,4,4,1
1803,68852,IC3lGAGjjevFNisK97Sg5rNNaiFl6GUf,SpATywNh6bZuzm8s1ceuBUnMUAeoAHHw,8,9,1,0,0,0,7,2,19,2.7142857142857144,1,0.0,0,1,0,0,9,0,0,7,2,1,18,1
1804,68855,QfnbskMOJDzclneyUxl9CDLAwpjYY8bi,SpATywNh6bZuzm8s1ceuBUnMUAeoAHHw,5,3,1,0,1,0,1,0,6,0.8571428571428571,1,0.0,0,1,0,1,3,0,0,1,0,2,4,1
1805,68858,nrnVeosxoYxlthTbtXiJng8EyjNCisBw,SpATywNh6bZuzm8s1ceuBUnMUAeoAHHw,13,14,2,18,1,0,5,0,40,5.714285714285714,2,0.0,4,2,14,1,10,0,4,5,0,21,19,1
1806,68867,mJAgtJKHxy28GsPIeuAEUCIOXmHzCywF,A3fsA9Zfv1X2fVEQhTw51lKENdNrEqT3,43,55,39,78,24,14,10,0,220,31.428571428571427,4,0.0,3,39,65,24,52,14,13,10,0,131,89,0
1807,68876,5IM8g7YMOYo5qH7Yu3x31T3JkVOH9iqe,SpATywNh6bZuzm8s1ceuBUnMUAeoAHHw,7,6,3,0,2,0,1,0,12,1.7142857142857142,1,0.0,0,3,0,2,6,0,0,1,0,5,7,0
1808,68891,AyMpxTtI93rQBcmn1hZDJ5NB66ddrTt8,bWdj2GDclj5ofokWjzoa5jAwMkxCykd6,15,16,7,62,5,20,3,0,113,16.142857142857142,1,0.0,7,7,59,5,9,20,3,3,0,78,35,1
1809,68894,SG7N8DhpCuhIu06IIzLX0CSolbyIDsIx,SpATywNh6bZuzm8s1ceuBUnMUAeoAHHw,28,48,21,27,7,3,7,0,113,16.142857142857142,3,0.0,17,21,26,7,31,3,1,7,0,71,42,1
1810,68925,ObpezNQRvm77jf0ubZxdLKEQMiNil6VQ,bWdj2GDclj5ofokWjzoa5jAwMkxCykd6,7,9,2,0,1,0,10,0,22,3.142857142857143,1,0.0,0,2,0,1,9,0,0,10,0,3,19,1
1811,68941,g5OpPhveV3tEyIL9sXOQK1bIZWgyqgNP,SpATywNh6bZuzm8s1ceuBUnMUAeoAHHw,1,0,0,0,0,0,1,0,1,0.14285714285714285,1,0.0,0,0,0,0,0,0,0,1,0,0,1,1
1812,68966,GiA8pWWKZYTUi7chN7ntBN35fCWU2nBu,SpATywNh6bZuzm8s1ceuBUnMUAeoAHHw,8,1,1,0,1,0,6,1,10,1.4285714285714286,1,0.0,0,1,0,1,1,0,0,6,1,2,8,1
1813,68969,koujvnfMBhMkCgSrbEaysh2AE5Gpg2YT,G8EPVSXsOYB5YQWZGiz1aVq5Pgr2GrQu,15,7,5,0,5,0,7,0,24,3.4285714285714284,1,0.0,0,5,0,5,7,0,0,7,0,10,14,0
1814,68970,TxEB3EFyNbwMBYmqmAZljhKEWyORCpLb,SpATywNh6bZuzm8s1ceuBUnMUAeoAHHw,1,0,0,0,0,0,1,0,1,0.14285714285714285,1,0.0,0,0,0,0,0,0,0,1,0,0,1,1
1815,68979,ugU2OsTm2YN2IbGmjW7DHhMX6BMMKbiK,G8EPVSXsOYB5YQWZGiz1aVq5Pgr2GrQu,8,7,4,6,0,0,2,0,19,2.7142857142857144,1,0.0,2,4,4,0,5,0,2,2,0,10,9,1
1816,68994,Xl37kHv8hz1ETmkFgpIsXpoKOIdQzB5H,SpATywNh6bZuzm8s1ceuBUnMUAeoAHHw,5,2,1,0,1,0,2,0,6,0.8571428571428571,1,0.0,0,1,0,1,2,0,0,2,0,2,4,1
1817,68996,xC7QA3lJWLoIMEwPvqIxcLnCt0KwsxwT,SpATywNh6bZuzm8s1ceuBUnMUAeoAHHw,2,0,0,0,0,0,2,0,2,0.2857142857142857,1,0.0,0,0,0,0,0,0,0,2,0,0,2,1
1818,68998,sNC7XF6Nlmfza5mofBS4sZLhOb44U4Ts,G8EPVSXsOYB5YQWZGiz1aVq5Pgr2GrQu,1,0,0,0,0,0,1,0,1,0.14285714285714285,1,0.0,0,0,0,0,0,0,0,1,0,0,1,1
1819,69007,wYGhiFjdBLkU2x7JJ3K1n2UAh76fIcQi,SpATywNh6bZuzm8s1ceuBUnMUAeoAHHw,10,11,9,0,7,1,2,0,30,4.285714285714286,2,0.0,0,9,0,7,11,1,0,2,0,16,14,1
1820,69031,8lWVuB48GCoDnvIn7Nn1tDxRI6ibKTRq,SpATywNh6bZuzm8s1ceuBUnMUAeoAHHw,5,2,1,0,1,0,2,0,6,0.8571428571428571,1,0.0,0,1,0,1,2,0,0,2,0,2,4,1
1821,69043,YVCPApRVJS0XKKCEpBt52bsseKQk9Woy,SpATywNh6bZuzm8s1ceuBUnMUAeoAHHw,1,0,0,0,0,0,1,0,1,0.14285714285714285,1,0.0,0,0,0,0,0,0,0,1,0,0,1,1
1822,69065,57ya2ykgKZwUUOXe4VfUt0HWtgZeemvj,SpATywNh6bZuzm8s1ceuBUnMUAeoAHHw,1,0,0,0,0,0,1,0,1,0.14285714285714285,1,0.0,0,0,0,0,0,0,0,1,0,0,1,1
1823,69082,lt7x7W9L5dc1lSFEc965LhUn5shsg0v8,SpATywNh6bZuzm8s1ceuBUnMUAeoAHHw,4,3,0,0,0,0,2,0,5,0.7142857142857143,1,0.0,0,0,0,0,3,0,0,2,0,0,5,1
1824,69095,dK22lzU3sHpxa7kQiSzhTpdq8w2wdIKM,G8EPVSXsOYB5YQWZGiz1aVq5Pgr2GrQu,5,3,0,0,0,0,6,1,10,1.4285714285714286,2,0.0,1,0,0,0,2,0,0,6,1,1,9,0
1825,69103,ZwACmcXP1dFceMUleNJ3flkTstESRohK,SpATywNh6bZuzm8s1ceuBUnMUAeoAHHw,25,30,13,39,4,0,7,0,93,13.285714285714286,1,0.0,14,13,36,4,16,0,3,7,0,67,26,1
1826,69116,8RAttpsmVeGyWHWVdhomVf58WbsxdKtJ,SpATywNh6bZuzm8s1ceuBUnMUAeoAHHw,3,1,1,0,1,0,0,0,3,0.42857142857142855,1,0.0,0,1,0,1,1,0,0,0,0,2,1,1
1827,69131,8Ir6rIjO15kuvM3s5xrQH1rB1m97Mcy9,SpATywNh6bZuzm8s1ceuBUnMUAeoAHHw,3,2,1,0,0,5,1,0,9,1.2857142857142858,1,0.0,0,1,0,0,2,5,0,1,0,1,8,0
1828,69147,cRQPwEYCK3Iw8dKAOD2ODiUgaKZ6yPed,SpATywNh6bZuzm8s1ceuBUnMUAeoAHHw,18,28,1,14,0,2,8,0,53,7.571428571428571,2,0.0,7,1,13,0,21,2,1,8,0,21,32,1
1829,69154,oBZQGNxV159KYVTxhJiCHURpoG2050SJ,SpATywNh6bZuzm8s1ceuBUnMUAeoAHHw,2,0,0,0,0,0,2,0,2,0.2857142857142857,1,0.0,0,0,0,0,0,0,0,2,0,0,2,1
1830,69155,K0iCXE1mno7izlBrkQAs4SEkYDRU9qXa,SpATywNh6bZuzm8s1ceuBUnMUAeoAHHw,5,3,1,0,1,0,2,0,7,1.0,1,0.0,2,1,0,1,1,0,0,2,0,4,3,1
1831,69161,3X0JLX6UvJnnRb5GkwbFJgAokE5g69D0,SpATywNh6bZuzm8s1ceuBUnMUAeoAHHw,17,23,2,8,0,0,4,0,37,5.285714285714286,3,0.0,7,2,8,0,16,0,0,4,0,17,20,0
1832,69192,agX8fi6SsMsbGjpTUuXM1FgToYG9zbAn,SpATywNh6bZuzm8s1ceuBUnMUAeoAHHw,9,6,5,0,2,0,1,0,14,2.0,1,0.0,0,5,0,2,6,0,0,1,0,7,7,0
1833,69231,yRvmuoOlApBAgoa9MY5Qvy0RDYuNtlAF,G8EPVSXsOYB5YQWZGiz1aVq5Pgr2GrQu,7,5,0,0,0,0,5,0,10,1.4285714285714286,1,0.0,0,0,0,0,5,0,0,5,0,0,10,1
1834,69237,xG3AmboF4HBUiYwQZV4JGVdvJNCIXdwN,SpATywNh6bZuzm8s1ceuBUnMUAeoAHHw,10,26,13,1,7,0,4,0,51,7.285714285714286,2,0.0,9,13,1,7,17,0,0,4,0,30,21,1
1835,69240,IXJE6OTajH0Geh8I1ZW7ljkRPJ4pkmfl,SpATywNh6bZuzm8s1ceuBUnMUAeoAHHw,10,9,6,4,0,0,1,0,20,2.857142857142857,1,0.0,1,6,3,0,8,0,1,1,0,10,10,1
1836,69259,7bRPtq6P8Xywkbl391z1cfKif2lsM9WW,SpATywNh6bZuzm8s1ceuBUnMUAeoAHHw,29,26,16,40,7,0,4,0,93,13.285714285714286,2,0.0,7,16,36,7,19,0,4,4,0,66,27,1
1837,69268,Eq98WSTQOt9fRmYbHT449FU0RWdVZ5zB,SpATywNh6bZuzm8s1ceuBUnMUAeoAHHw,5,2,1,0,1,0,2,0,6,0.8571428571428571,1,0.0,0,1,0,1,2,0,0,2,0,2,4,1
1838,69276,FSJWTYbpEABu1Che9CXJ2jTRzNOHiIPA,SpATywNh6bZuzm8s1ceuBUnMUAeoAHHw,9,6,2,0,2,0,7,0,17,2.4285714285714284,1,0.0,0,2,0,2,6,0,0,7,0,4,13,1
1839,69284,UhXyunBodgS5DssUOIaVTTsNfgvZZxEV,bWdj2GDclj5ofokWjzoa5jAwMkxCykd6,4,3,1,0,0,0,2,0,6,0.8571428571428571,1,0.0,0,1,0,0,3,0,0,2,0,1,5,1
1840,69285,3bqMPd7dmQ6bVwYt9AjfxpDPMW8ppczj,RXDvfPUBYFlVdlueBFbLW0mhhAyGEqpt,1,0,0,0,0,0,1,0,1,0.14285714285714285,1,0.0,0,0,0,0,0,0,0,1,0,0,1,1
1841,69293,ovvuiEhj0QBv4xi11GVjXr8JhlCgaPmd,A3fsA9Zfv1X2fVEQhTw51lKENdNrEqT3,2,0,0,0,0,0,3,0,3,0.42857142857142855,1,0.0,0,0,0,0,0,0,0,3,0,0,3,1
1842,69297,X9IKf8GgqS6dvoKX3VBo51mIr8yb4uFC,bWdj2GDclj5ofokWjzoa5jAwMkxCykd6,1,0,0,0,0,0,1,0,1,0.14285714285714285,1,0.0,0,0,0,0,0,0,0,1,0,0,1,1
1843,69308,YtPY6V9gKVYBGYaBakDnRKgXM0SCPhH8,RXDvfPUBYFlVdlueBFbLW0mhhAyGEqpt,26,32,23,32,15,0,6,0,108,15.428571428571429,2,0.0,6,23,30,15,26,0,2,6,0,74,34,0
1844,69322,WfiWheCcfnYrlo1ljQjtyFUB6mwR6CMB,SpATywNh6bZuzm8s1ceuBUnMUAeoAHHw,12,10,7,0,4,0,6,0,27,3.857142857142857,1,0.0,0,7,0,4,10,0,0,6,0,11,16,1
1845,69324,byxGWUJV72XqYw0RcV5v8EuZ9oh6gief,G8EPVSXsOYB5YQWZGiz1aVq5Pgr2GrQu,13,10,6,0,4,0,8,0,28,4.0,1,0.0,0,6,0,4,10,0,0,8,0,10,18,1
1846,69345,pNeNjRs1mK0wHcAzJFxLXdAPA9xgPVV6,bWdj2GDclj5ofokWjzoa5jAwMkxCykd6,5,2,1,0,1,0,2,0,6,0.8571428571428571,1,0.0,0,1,0,1,2,0,0,2,0,2,4,1
1847,69360,VtYfYYb8PipDmwJ9fAnXpdTb4dF89SFx,SpATywNh6bZuzm8s1ceuBUnMUAeoAHHw,11,5,4,0,4,0,2,0,15,2.142857142857143,1,0.0,0,4,0,4,5,0,0,2,0,8,7,1
1848,69371,YaUoJwJr3oO9HJ6WDm7V4UT5kFsGziL7,bWdj2GDclj5ofokWjzoa5jAwMkxCykd6,1,0,0,0,0,0,1,0,1,0.14285714285714285,1,0.0,0,0,0,0,0,0,0,1,0,0,1,1
1849,69382,7jncvDKBN22Fxg064o0NyimMY6U2A5Li,SpATywNh6bZuzm8s1ceuBUnMUAeoAHHw,5,2,1,0,1,0,2,0,6,0.8571428571428571,1,0.0,0,1,0,1,2,0,0,2,0,2,4,1
1850,69387,hPdb7IzvQK13aLXEDwxSH4zOMfPRUsSC,SpATywNh6bZuzm8s1ceuBUnMUAeoAHHw,1,0,0,0,0,0,1,0,1,0.14285714285714285,1,0.0,0,0,0,0,0,0,0,1,0,0,1,1
1851,69391,d5euO6JYPz1tRdmilapWDL1Th3AQudPQ,SpATywNh6bZuzm8s1ceuBUnMUAeoAHHw,6,3,1,0,1,0,2,0,7,1.0,1,0.0,0,1,0,1,3,0,0,2,0,2,5,1
1852,69393,sQMQGXUKDLttJ8ntfMuRvWEcncBHKCzb,G8EPVSXsOYB5YQWZGiz1aVq5Pgr2GrQu,5,4,0,0,0,0,2,0,6,0.8571428571428571,1,0.0,0,0,0,0,4,0,0,2,0,0,6,1
1853,69394,9fEcx2YdFV830apuhCo8G8R1veKyhCNk,G8EPVSXsOYB5YQWZGiz1aVq5Pgr2GrQu,1,0,0,0,0,0,1,0,1,0.14285714285714285,1,0.0,0,0,0,0,0,0,0,1,0,0,1,1
1854,69396,x87E9Qmbnh2qCEUiaevhSD7rp8sUrupo,SpATywNh6bZuzm8s1ceuBUnMUAeoAHHw,5,4,3,0,2,0,1,0,10,1.4285714285714286,1,0.0,0,3,0,2,4,0,0,1,0,5,5,1
1855,69397,egpXv13dykaiU64GCgTaQGg1ErRD7Rsb,SpATywNh6bZuzm8s1ceuBUnMUAeoAHHw,11,7,5,0,1,15,6,1,35,5.0,2,0.0,0,5,0,1,7,15,0,6,1,6,29,0
1856,69400,FlAkKX6ow9SvOzk0dTWPWgnX5766zY29,SpATywNh6bZuzm8s1ceuBUnMUAeoAHHw,22,27,10,12,7,1,3,0,60,8.571428571428571,2,0.0,6,10,12,7,21,1,0,3,0,35,25,1
1857,69420,aI2WbSCktVyijPTHCbgAdpzpfdnFGcq9,bWdj2GDclj5ofokWjzoa5jAwMkxCykd6,1,0,0,0,0,0,1,0,1,0.14285714285714285,1,0.0,0,0,0,0,0,0,0,1,0,0,1,1
1858,69421,wj8cbMyESeAf93mp00EllV31jkPIrA6z,SpATywNh6bZuzm8s1ceuBUnMUAeoAHHw,7,4,2,0,0,0,7,3,16,2.2857142857142856,1,0.0,0,2,0,0,4,0,0,7,3,2,14,1
1859,69436,vEfGT3eaoianaMgM5zzcNn9WTzHGX3lJ,bWdj2GDclj5ofokWjzoa5jAwMkxCykd6,12,5,4,0,4,0,3,0,16,2.2857142857142856,1,0.0,0,4,0,4,5,0,0,3,0,8,8,1
1860,69445,raxo74HBCa6UxUGfmq3EGBBeCoVCmLfg,SpATywNh6bZuzm8s1ceuBUnMUAeoAHHw,4,0,0,0,0,1,3,0,4,0.5714285714285714,1,0.0,0,0,0,0,0,1,0,3,0,0,4,1
1861,69462,SzqR1lIvSkqy1yQXOqGRgT5uhu7VR5Jw,SpATywNh6bZuzm8s1ceuBUnMUAeoAHHw,32,37,22,24,10,12,12,2,119,17.0,3,0.0,5,22,23,10,32,12,1,12,2,60,59,0
1862,69484,RbewLSSgBXbMSLEvzESHw0b6pdUZ0dT1,SpATywNh6bZuzm8s1ceuBUnMUAeoAHHw,15,17,7,0,5,0,2,0,31,4.428571428571429,1,0.0,0,7,0,5,17,0,0,2,0,12,19,1
1863,69488,0n2rFsphNy9JVeuypULNewx4jCGSFGND,bWdj2GDclj5ofokWjzoa5jAwMkxCykd6,5,2,1,0,1,0,2,0,6,0.8571428571428571,1,0.0,0,1,0,1,2,0,0,2,0,2,4,1
1864,69489,pAlH2DhoFB2i4Ut8T7hcWTIp67bJvsYn,SpATywNh6bZuzm8s1ceuBUnMUAeoAHHw,5,2,1,0,1,0,2,0,6,0.8571428571428571,1,0.0,0,1,0,1,2,0,0,2,0,2,4,1
1865,69512,3MwBdkgOXpVBf89tXLybMhGjxxsiq8lW,SpATywNh6bZuzm8s1ceuBUnMUAeoAHHw,5,7,3,0,2,0,2,0,14,2.0,1,0.0,0,3,0,2,7,0,0,2,0,5,9,1
1866,69522,ujYI83byKXzx4VeC0hyxjCKBGRrqMCEx,SpATywNh6bZuzm8s1ceuBUnMUAeoAHHw,6,7,2,0,1,0,2,0,12,1.7142857142857142,1,0.0,0,2,0,1,7,0,0,2,0,3,9,1
1867,69525,wRAgiRhqkN35cIVBbnaU2eOM8fyImml7,SpATywNh6bZuzm8s1ceuBUnMUAeoAHHw,5,2,1,0,1,0,2,0,6,0.8571428571428571,1,0.0,0,1,0,1,2,0,0,2,0,2,4,1
1868,69528,ujAdSwtAMW0jWhrnzge1oByew4uYe5CY,SpATywNh6bZuzm8s1ceuBUnMUAeoAHHw,5,2,1,0,1,0,2,0,6,0.8571428571428571,1,0.0,0,1,0,1,2,0,0,2,0,2,4,1
1869,69550,rY4HuopoXNauFhpb4SYxSCmQkbvhS34C,SpATywNh6bZuzm8s1ceuBUnMUAeoAHHw,1,0,0,0,0,0,1,0,1,0.14285714285714285,1,0.0,0,0,0,0,0,0,0,1,0,0,1,0
1870,69575,HnVGC3qJM46V1b2wdd4Z0HoEFuWu57RL,A3fsA9Zfv1X2fVEQhTw51lKENdNrEqT3,3,2,0,0,0,0,2,0,4,0.5714285714285714,1,0.0,0,0,0,0,2,0,0,2,0,0,4,1
1871,69598,KYXtOFYh9POr4cq75pjZ8a127l5uxf5U,SpATywNh6bZuzm8s1ceuBUnMUAeoAHHw,19,33,17,20,10,0,2,0,82,11.714285714285714,2,0.0,10,17,17,10,23,0,3,2,0,54,28,1
1872,69612,kgME9COu6f9ljQ8FhJeUQLVyeGDbkeLG,A3fsA9Zfv1X2fVEQhTw51lKENdNrEqT3,3,3,1,0,0,0,2,0,6,0.8571428571428571,1,0.0,0,1,0,0,3,0,0,2,0,1,5,0
1873,69634,jnvcTpUtga8frGP2ONxrK4VjvbZCmOcF,A3fsA9Zfv1X2fVEQhTw51lKENdNrEqT3,6,10,0,0,0,0,3,0,13,1.8571428571428572,1,0.0,3,0,0,0,7,0,0,3,0,3,10,1
1874,69640,C78Rc70fLP1AFI7RwOL8R7Vch3jy9civ,bWdj2GDclj5ofokWjzoa5jAwMkxCykd6,7,8,1,4,4,0,2,0,19,2.7142857142857144,1,0.0,6,1,4,4,2,0,0,2,0,15,4,1
1875,69678,zprnKj46wnzt21jHYpriZ9OaUlDuPgz5,SpATywNh6bZuzm8s1ceuBUnMUAeoAHHw,8,6,4,0,3,3,4,0,20,2.857142857142857,1,0.0,0,4,0,3,6,3,0,4,0,7,13,1
1876,69691,C8X9Lf56reSC06tYvkcDbAXogOIv2aQH,SpATywNh6bZuzm8s1ceuBUnMUAeoAHHw,6,3,1,0,1,0,2,0,7,1.0,1,0.0,0,1,0,1,3,0,0,2,0,2,5,1
1877,69711,I8DzhVfDWUcYhRFQ0yqaOgzpzxPiQBKk,bWdj2GDclj5ofokWjzoa5jAwMkxCykd6,6,5,2,0,1,0,3,0,11,1.5714285714285714,1,0.0,0,2,0,1,5,0,0,3,0,3,8,1
1878,69764,BLvQXA2YaaLZxMBjVQ5Po1TXbL69VEdH,SpATywNh6bZuzm8s1ceuBUnMUAeoAHHw,5,2,1,0,1,0,2,0,6,0.8571428571428571,1,0.0,0,1,0,1,2,0,0,2,0,2,4,1
1879,69770,JgN8P3Oh101qfcWX1dxprWYo04K2OTYg,bWdj2GDclj5ofokWjzoa5jAwMkxCykd6,4,2,1,0,1,0,1,0,5,0.7142857142857143,1,0.0,0,1,0,1,2,0,0,1,0,2,3,1
1880,69786,231vKE9Ghn3hPwkNFyzJyi0Car52cYe1,bWdj2GDclj5ofokWjzoa5jAwMkxCykd6,1,0,0,0,0,0,1,0,1,0.14285714285714285,1,0.0,0,0,0,0,0,0,0,1,0,0,1,1
1881,69804,RBKGxYBfWpgkY9AF7ooiIKdEMpAJTvzp,bWdj2GDclj5ofokWjzoa5jAwMkxCykd6,1,0,0,0,0,0,1,0,1,0.14285714285714285,1,0.0,0,0,0,0,0,0,0,1,0,0,1,1
1882,69823,pD1s3J2DAVHqxnTOsnHBHGIq9d5lcpqD,SpATywNh6bZuzm8s1ceuBUnMUAeoAHHw,19,18,7,15,4,5,9,1,59,8.428571428571429,3,0.0,6,7,13,4,12,5,2,9,1,30,29,0
1883,69828,RI0oJHr7vWXzPLP3ybfgZBQolmA0lbjl,SpATywNh6bZuzm8s1ceuBUnMUAeoAHHw,25,26,11,30,7,0,3,0,77,11.0,2,0.0,4,11,24,7,22,0,6,3,0,46,31,0
1884,69868,gV1Y6A8RpgDuAD47r6UGF54v9TD2f7uU,SpATywNh6bZuzm8s1ceuBUnMUAeoAHHw,17,12,9,9,7,0,1,0,38,5.428571428571429,1,0.0,2,9,9,7,10,0,0,1,0,27,11,0
1885,69880,wJ6pUrPXT2xprnVlaCeorPmn4kCAli3G,A3fsA9Zfv1X2fVEQhTw51lKENdNrEqT3,30,18,13,70,9,46,5,1,162,23.142857142857142,2,0.0,1,13,55,9,17,46,15,5,1,78,84,1
1886,69900,KXHDxoyacxCXhUbcgqweNNZf38mVEmJs,SpATywNh6bZuzm8s1ceuBUnMUAeoAHHw,14,11,7,16,4,0,2,0,40,5.714285714285714,1,0.0,3,7,14,4,8,0,2,2,0,28,12,1
1887,69902,ZLrfFX2a65pmAVGtiIPK4faxDMnbmzh2,SpATywNh6bZuzm8s1ceuBUnMUAeoAHHw,4,5,2,0,0,0,3,0,10,1.4285714285714286,1,0.0,0,2,0,0,5,0,0,3,0,2,8,1
1888,69906,qowpjfcpUK1iU9rrtJ9U3WvarOVtt4V0,SpATywNh6bZuzm8s1ceuBUnMUAeoAHHw,19,20,12,9,6,9,3,0,59,8.428571428571429,1,0.0,5,12,9,6,15,9,0,3,0,32,27,0
1889,69970,dYC6Q6IXtOHRHCawBvKivQeuFVOWFZ5M,SpATywNh6bZuzm8s1ceuBUnMUAeoAHHw,5,4,2,6,0,0,1,0,13,1.8571428571428572,1,0.0,1,2,5,0,3,0,1,1,0,8,5,1
1890,69972,6AqVXM3NzhPR7CIRltoRCDhzdk8YVusO,SpATywNh6bZuzm8s1ceuBUnMUAeoAHHw,18,14,10,14,4,3,3,3,51,7.285714285714286,1,0.0,3,10,13,4,11,3,1,3,3,30,21,0
1891,69983,CabsQjb2Sd2I3ynTdtsErAG67rLex08f,SpATywNh6bZuzm8s1ceuBUnMUAeoAHHw,7,3,0,0,0,1,4,1,9,1.2857142857142858,1,0.0,0,0,0,0,3,1,0,4,1,0,9,1
1892,69984,979PHlsnLj7fGUBEOVls6yVfgExSRWl0,SpATywNh6bZuzm8s1ceuBUnMUAeoAHHw,2,0,0,0,0,0,2,0,2,0.2857142857142857,1,0.0,0,0,0,0,0,0,0,2,0,0,2,0
1893,70011,gfov2YfhzgUzN6Vbd3DOhS3J4f6Zpsmw,SpATywNh6bZuzm8s1ceuBUnMUAeoAHHw,15,15,12,19,10,0,0,0,56,8.0,2,0.0,2,12,16,10,13,0,3,0,0,40,16,1
1894,70019,mRVxG27OAHo6TDwz5EATZqlFWV3ONpTz,SpATywNh6bZuzm8s1ceuBUnMUAeoAHHw,2,0,0,0,0,0,2,0,2,0.2857142857142857,1,0.0,0,0,0,0,0,0,0,2,0,0,2,1
1895,70021,J782awhmjhWAohIOvWifbZTNvhSxGcmf,SpATywNh6bZuzm8s1ceuBUnMUAeoAHHw,9,8,6,0,3,0,3,0,20,2.857142857142857,1,0.0,0,6,0,3,8,0,0,3,0,9,11,1
1896,70042,7VdMdsntecIH9xdStqUN45Z6l4PdR7Lf,SpATywNh6bZuzm8s1ceuBUnMUAeoAHHw,4,4,1,0,0,0,3,0,8,1.1428571428571428,1,0.0,0,1,0,0,4,0,0,3,0,1,7,1
1897,70054,DyupaV8BmUavHjvovvxyDg1D0z37S8dm,SpATywNh6bZuzm8s1ceuBUnMUAeoAHHw,10,9,7,0,5,0,4,0,25,3.5714285714285716,2,0.0,0,7,0,5,9,0,0,4,0,12,13,1
1898,70060,nXqrD0yeRarrFPn56WxkuqRZ3ny2kh9R,SpATywNh6bZuzm8s1ceuBUnMUAeoAHHw,2,0,0,0,0,0,2,0,2,0.2857142857142857,1,0.0,0,0,0,0,0,0,0,2,0,0,2,1
1899,70080,lhSfCfPZnDk6mpF0h6gOX9NA2ZuZUrvg,SpATywNh6bZuzm8s1ceuBUnMUAeoAHHw,3,2,0,0,0,0,2,0,4,0.5714285714285714,1,0.0,0,0,0,0,2,0,0,2,0,0,4,0
1900,70081,S0YS2NCKuZXB21pPEkAadXWVZsUyQWb2,SpATywNh6bZuzm8s1ceuBUnMUAeoAHHw,4,6,1,0,0,0,1,0,8,1.1428571428571428,1,0.0,0,1,0,0,6,0,0,1,0,1,7,1
1901,70084,0uULbxMYxykuellS4DES6XbGTfaCngOW,SpATywNh6bZuzm8s1ceuBUnMUAeoAHHw,4,2,0,0,0,0,3,0,5,0.7142857142857143,2,0.0,0,0,0,0,2,0,0,3,0,0,5,1
1902,70086,05tZSn1VpjmBZfEP79jJJrxZA1bk8Ov5,SpATywNh6bZuzm8s1ceuBUnMUAeoAHHw,5,15,5,0,0,0,1,0,21,3.0,4,0.0,3,5,0,0,12,0,0,1,0,8,13,0
1903,70094,vjGeuAzCU9VuvJBAkOsbOGPQ1dhGyEOw,SpATywNh6bZuzm8s1ceuBUnMUAeoAHHw,10,11,1,0,0,0,6,2,20,2.857142857142857,1,0.0,3,1,0,0,8,0,0,6,2,4,16,1
1904,70097,0uULbxMYxykuellS4DES6XbGTfaCngOW,bWdj2GDclj5ofokWjzoa5jAwMkxCykd6,6,4,0,10,1,0,2,0,17,2.4285714285714284,1,0.0,2,0,10,1,2,0,0,2,0,13,4,1
1905,70112,CNg7OyU6zWgKAN5K0oJtHsglhaU3oGQ9,SpATywNh6bZuzm8s1ceuBUnMUAeoAHHw,5,4,1,0,1,0,1,0,7,1.0,1,0.0,0,1,0,1,4,0,0,1,0,2,5,1
1906,70113,xPyi5tVWLdzwESKbVSwWQTZrKjlUSal4,bWdj2GDclj5ofokWjzoa5jAwMkxCykd6,2,0,0,0,0,0,2,0,2,0.2857142857142857,1,0.0,0,0,0,0,0,0,0,2,0,0,2,1
1907,70117,Unmtjjmp5vQtsUKiq2OfCGrdrro6CfzN,SpATywNh6bZuzm8s1ceuBUnMUAeoAHHw,22,62,34,22,9,44,16,0,187,26.714285714285715,4,0.0,14,34,18,9,48,44,4,16,0,75,112,0
1908,70118,ynRrL3n4SK143BrBaMe5mVlDwKfYLlFe,SpATywNh6bZuzm8s1ceuBUnMUAeoAHHw,5,2,1,0,1,0,2,0,6,0.8571428571428571,1,0.0,0,1,0,1,2,0,0,2,0,2,4,1
1909,70130,r9R01U9QisCDxxLmorZFQ60ReGG1wPEx,SpATywNh6bZuzm8s1ceuBUnMUAeoAHHw,20,17,16,0,13,0,3,0,49,7.0,1,0.0,0,16,0,13,17,0,0,3,0,29,20,1
1910,70141,j4hecXKY3USBQpRwMuzKA9d9SPzBKhRY,SpATywNh6bZuzm8s1ceuBUnMUAeoAHHw,6,7,0,0,0,0,2,0,9,1.2857142857142858,1,0.0,3,0,0,0,4,0,0,2,0,3,6,1
1911,70364,d11XQPw4CaDnMkkvSEo4JqU6avErSb1R,fbPkOYLVPtPgIt0MxizjfFJov3JbHyAi,5,2,1,0,1,9,8,0,21,3.0,1,0.0,0,1,0,1,2,9,0,8,0,2,19,1
1912,70383,Op31ey1e8ia2T8lQ6kca7MllnthYRRtp,fbPkOYLVPtPgIt0MxizjfFJov3JbHyAi,7,7,5,0,0,0,2,1,15,2.142857142857143,1,0.0,0,5,0,0,7,0,0,2,1,5,10,1
1913,70416,TkGkraxFZeISMMLd87fcbklBTVTLGOhm,fbPkOYLVPtPgIt0MxizjfFJov3JbHyAi,18,17,11,10,8,7,10,1,64,9.142857142857142,1,0.0,5,11,9,8,12,7,1,10,1,33,31,1
1914,70483,F8PplJ0MdSBFJMkvQSa7z6RMAQvcxOkt,fbPkOYLVPtPgIt0MxizjfFJov3JbHyAi,1,0,0,0,0,0,1,0,1,0.14285714285714285,1,0.0,0,0,0,0,0,0,0,1,0,0,1,0
1915,70499,R0fqJCKSDdlape9O3QiJvxhX8OJnijdc,fbPkOYLVPtPgIt0MxizjfFJov3JbHyAi,7,4,3,0,1,0,6,0,14,2.0,1,0.0,0,3,0,1,4,0,0,6,0,4,10,1
1916,70650,kbSUu2Z40fu4lSlgv22Wu70hAt5BnJoC,fbPkOYLVPtPgIt0MxizjfFJov3JbHyAi,5,4,0,0,0,10,5,0,19,2.7142857142857144,1,0.0,0,0,0,0,4,10,0,5,0,0,19,1
1917,70686,NUUrfkmQ6PTn8vYLlenz4k9BmiPCmi7I,fbPkOYLVPtPgIt0MxizjfFJov3JbHyAi,5,3,2,0,0,0,2,0,7,1.0,1,0.0,0,2,0,0,3,0,0,2,0,2,5,0
1918,70692,6qrT2bYbFD0verDQZWOnrOjhEccqo56g,fbPkOYLVPtPgIt0MxizjfFJov3JbHyAi,25,81,42,12,19,66,24,1,245,35.0,6,0.0,20,42,12,19,61,66,0,24,1,93,152,0
1919,71358,WfFzDu02yVQhznDpti9qz88KkaHNMAz5,SpATywNh6bZuzm8s1ceuBUnMUAeoAHHw,7,4,2,0,2,0,5,0,13,1.8571428571428572,3,0.0,0,2,0,2,4,0,0,5,0,4,9,1
1920,71611,KWdhtnEkrke9rgi3l1csNclNjZVhn1s4,SpATywNh6bZuzm8s1ceuBUnMUAeoAHHw,10,42,1,0,0,0,9,0,52,7.428571428571429,3,0.0,0,1,0,0,42,0,0,9,0,1,51,1
1921,71829,n1JdH8HPXOUoCHQIEd4YCo0nlAshsKdG,SpATywNh6bZuzm8s1ceuBUnMUAeoAHHw,8,8,4,0,0,1,4,1,18,2.5714285714285716,1,0.0,2,4,0,0,6,1,0,4,1,6,12,0
1922,71860,kTJIJds7bRsw0KFlLhCoB2PivF66Tf3q,A3fsA9Zfv1X2fVEQhTw51lKENdNrEqT3,8,6,3,0,1,0,7,1,18,2.5714285714285716,2,0.0,0,3,0,1,6,0,0,7,1,4,14,1
1923,71865,nvXkSuJjNwPy4x4PN83PXogIa9iXtJsm,A3fsA9Zfv1X2fVEQhTw51lKENdNrEqT3,12,6,5,0,5,0,2,0,18,2.5714285714285716,1,0.0,0,5,0,5,6,0,0,2,0,10,8,1
1924,72133,2qQuu2Qhkw7hRYngnGfnNzXYklrDkMwy,SpATywNh6bZuzm8s1ceuBUnMUAeoAHHw,5,3,1,0,1,0,1,0,6,0.8571428571428571,1,0.0,0,1,0,1,3,0,0,1,0,2,4,1
1925,72150,dDLv4oouOmVB45Y4hnRyV7IUqT7tMKiq,A3fsA9Zfv1X2fVEQhTw51lKENdNrEqT3,31,22,12,100,3,7,8,0,152,21.714285714285715,1,0.0,5,12,81,3,17,7,19,8,0,101,51,0
1926,72280,Daw06K1PSOXldo19kBgHP5sewulb7Vu5,RXDvfPUBYFlVdlueBFbLW0mhhAyGEqpt,1,0,0,0,0,0,1,0,1,0.14285714285714285,1,0.0,0,0,0,0,0,0,0,1,0,0,1,1
1927,72390,L6W8jpUrnYiTQTQzsQIQrX6pgKIdMfa4,SpATywNh6bZuzm8s1ceuBUnMUAeoAHHw,9,3,2,0,2,0,5,0,12,1.7142857142857142,1,0.0,0,2,0,2,3,0,0,5,0,4,8,1
1928,72392,dQQ8UnfzoKHmhQlZOaaW0cB14DhE2hvY,A3fsA9Zfv1X2fVEQhTw51lKENdNrEqT3,4,4,0,0,0,0,2,0,6,0.8571428571428571,1,0.0,1,0,0,0,3,0,0,2,0,1,5,0
1929,72476,gpgk1aIkjyvlgo7OYZtMXPlVgE39gvnr,SpATywNh6bZuzm8s1ceuBUnMUAeoAHHw,12,26,7,15,1,0,5,0,54,7.714285714285714,2,0.0,14,7,13,1,12,0,2,5,0,35,19,0
1930,72533,kPw5nR6GIfIGfnUDhfrz9sq3P6l2CmOK,RXDvfPUBYFlVdlueBFbLW0mhhAyGEqpt,8,8,6,0,2,0,2,0,18,2.5714285714285716,2,0.0,0,6,0,2,8,0,0,2,0,8,10,1
1931,72686,JoqAGqbao71wc04PyVzx7SVvlZZ0knbI,A3fsA9Zfv1X2fVEQhTw51lKENdNrEqT3,25,18,10,66,0,3,7,0,104,14.857142857142858,3,0.0,1,10,66,0,17,3,0,7,0,77,27,0
1932,72848,pQdSl7i5ZuZeH9uPILgdHrvwskp4vc4V,bWdj2GDclj5ofokWjzoa5jAwMkxCykd6,2,0,0,0,0,0,2,0,2,0.2857142857142857,1,0.0,0,0,0,0,0,0,0,2,0,0,2,1
1933,72936,oIV4CHUFSVzLmdvea6ZMZ3tpsiIb8a2U,RXDvfPUBYFlVdlueBFbLW0mhhAyGEqpt,5,16,1,0,1,0,3,0,21,3.0,1,0.0,3,1,0,1,13,0,0,3,0,5,16,0
1934,73001,NlHO5hXiy7TmVTHiRgExH6y7p9gJG1YF,A3fsA9Zfv1X2fVEQhTw51lKENdNrEqT3,5,3,2,0,1,0,1,0,7,1.0,1,0.0,0,2,0,1,3,0,0,1,0,3,4,1
1935,73110,TOybu3VTl57Gwz61jxLAAYZF2xYkGB5M,SpATywNh6bZuzm8s1ceuBUnMUAeoAHHw,25,17,13,12,7,7,5,0,61,8.714285714285714,1,0.0,0,13,10,7,17,7,2,5,0,30,31,1
1936,73502,UGYGSfRkJhOkgkdlCI6YSCshpNvwBF31,fbPkOYLVPtPgIt0MxizjfFJov3JbHyAi,6,6,4,0,1,0,6,0,17,2.4285714285714284,1,0.0,0,4,0,1,6,0,0,6,0,5,12,1
1937,73504,50aSuabL02e7lLNBHTRXsMQnBChV2lSX,fbPkOYLVPtPgIt0MxizjfFJov3JbHyAi,7,5,2,0,2,0,4,0,13,1.8571428571428572,1,0.0,0,2,0,2,5,0,0,4,0,4,9,1
1938,73518,mEXms676UX2nEtOWi785T3a9YDRXn6eo,fbPkOYLVPtPgIt0MxizjfFJov3JbHyAi,4,4,0,0,0,0,1,0,5,0.7142857142857143,1,0.0,0,0,0,0,4,0,0,1,0,0,5,1
1939,73519,BjBet1XrpmufRo3nJSBrADvKxDiooNdd,fbPkOYLVPtPgIt0MxizjfFJov3JbHyAi,1,0,0,0,0,0,1,0,1,0.14285714285714285,1,0.0,0,0,0,0,0,0,0,1,0,0,1,1
1940,73906,oXeIIZJhS8XqLTW0ryKumqV3ZtrZlFuh,7GRhBDsirIGkRZBtSMEzNTyDr2JQm4xx,12,32,8,8,10,0,3,0,61,8.714285714285714,2,0.0,11,8,7,10,21,0,1,3,0,36,25,1
1941,73908,4sCPuVlkq4rBRlBYNyTR5EDg94co1oy4,7GRhBDsirIGkRZBtSMEzNTyDr2JQm4xx,4,5,2,0,0,0,1,0,8,1.1428571428571428,1,0.0,2,2,0,0,3,0,0,1,0,4,4,1
1942,73953,7VDn6ntyPpx1GsPLNVgZQF03WDWTuKJo,bWdj2GDclj5ofokWjzoa5jAwMkxCykd6,26,36,24,64,6,2,14,0,146,20.857142857142858,2,0.0,3,24,52,6,33,2,12,14,0,85,61,0
1943,74104,7TkkuA0EEQqi6jLSaHSvDaS7U5kNSv36,SpATywNh6bZuzm8s1ceuBUnMUAeoAHHw,6,6,3,0,1,0,4,0,14,2.0,1,0.0,0,3,0,1,6,0,0,4,0,4,10,0
1944,74139,gVHbwM9IOrk1olFEuw0FAfVujUgJm8AG,7GRhBDsirIGkRZBtSMEzNTyDr2JQm4xx,16,40,8,10,3,0,2,0,63,9.0,2,0.0,27,8,9,3,13,0,1,2,0,47,16,0
1945,74334,ovvuiEhj0QBv4xi11GVjXr8JhlCgaPmd,SpATywNh6bZuzm8s1ceuBUnMUAeoAHHw,22,31,16,12,11,0,17,0,87,12.428571428571429,2,0.0,6,16,10,11,25,0,2,17,0,43,44,0
1946,74386,QlvFciinGDGt7csjDmjYPPZqFlKAzfUP,SpATywNh6bZuzm8s1ceuBUnMUAeoAHHw,23,33,6,13,5,2,7,1,67,9.571428571428571,2,0.0,9,6,12,5,24,2,1,7,1,32,35,0
1947,74468,rgJ7j684KtaDcmKD94RFdpwPnoKFUmIV,7GRhBDsirIGkRZBtSMEzNTyDr2JQm4xx,22,15,11,30,6,9,1,0,72,10.285714285714286,1,0.0,2,11,26,6,13,9,4,1,0,45,27,1
1948,74529,YfLkHn3sP8pusiYlKK6o5F2jXKBNkL8d,SpATywNh6bZuzm8s1ceuBUnMUAeoAHHw,6,6,1,0,0,0,1,0,8,1.1428571428571428,1,0.0,0,1,0,0,6,0,0,1,0,1,7,0
1949,74608,U3R4m4eLMm2lirgI7HLueBKsNpxhFpn9,7GRhBDsirIGkRZBtSMEzNTyDr2JQm4xx,5,4,3,0,0,0,1,0,8,1.1428571428571428,1,0.0,0,3,0,0,4,0,0,1,0,3,5,1
1950,74618,RtmYmukzSU8h3Uq6suOYxJKRcISOQfvL,RXDvfPUBYFlVdlueBFbLW0mhhAyGEqpt,16,12,8,0,5,0,3,0,28,4.0,2,0.0,1,8,0,5,11,0,0,3,0,14,14,0
1951,74717,tBy7E7qZZZ98Oih5sTNUdDZRIpZZM98z,SpATywNh6bZuzm8s1ceuBUnMUAeoAHHw,8,12,3,10,0,14,4,0,43,6.142857142857143,2,0.0,3,3,10,0,9,14,0,4,0,16,27,0
1952,74792,DSoedfH3iEqkDSoEfnR9hPK9fGA03nvE,A3fsA9Zfv1X2fVEQhTw51lKENdNrEqT3,10,3,2,38,0,8,1,0,52,7.428571428571429,1,0.0,0,2,32,0,3,8,6,1,0,34,18,1
1953,74801,L0e1YP7bRzjNsIzxzTyXlM0Ldh6xltNG,SpATywNh6bZuzm8s1ceuBUnMUAeoAHHw,32,44,21,38,10,2,8,1,124,17.714285714285715,1,0.0,9,21,35,10,35,2,3,8,1,75,49,0
1954,74818,knxAJpSFDgjN8jBmnCV7BB7s4fbgoTt1,7GRhBDsirIGkRZBtSMEzNTyDr2JQm4xx,2,0,0,0,0,0,2,0,2,0.2857142857142857,1,0.0,0,0,0,0,0,0,0,2,0,0,2,1
1955,75046,JxLtKAnMek98G5fWpyeTaKlh0zheuNnU,A3fsA9Zfv1X2fVEQhTw51lKENdNrEqT3,8,7,2,0,1,1,4,1,16,2.2857142857142856,1,0.0,1,2,0,1,6,1,0,4,1,4,12,1
1956,75054,dtbXtMjPqeEvzoZBFe2y9uSDcjL0lnx2,RXDvfPUBYFlVdlueBFbLW0mhhAyGEqpt,10,9,1,0,0,7,1,0,18,2.5714285714285716,1,0.0,0,1,0,0,9,7,0,1,0,1,17,0
1957,75113,5EOGhyHOLLtbW0eEa8Dnfl5My4kdYkdc,SpATywNh6bZuzm8s1ceuBUnMUAeoAHHw,22,23,9,12,4,1,7,2,58,8.285714285714286,1,0.0,6,9,12,4,17,1,0,7,2,31,27,0
1958,75143,KKE8q8DWecTGi2Mp6eRnxhZGGD7eG4J3,SpATywNh6bZuzm8s1ceuBUnMUAeoAHHw,6,3,1,0,1,0,2,0,7,1.0,1,0.0,0,1,0,1,3,0,0,2,0,2,5,1
1959,75206,ZXWRS3Ah3Q3TKxtUJXxAAlsPTxzCg1Vz,SpATywNh6bZuzm8s1ceuBUnMUAeoAHHw,15,14,7,21,0,2,7,1,52,7.428571428571429,1,0.0,4,7,20,0,10,2,1,7,1,31,21,0
1960,75382,O0pFwh56sT4vz63TrFMWxlTyZHTENk1t,SpATywNh6bZuzm8s1ceuBUnMUAeoAHHw,20,27,0,17,0,1,2,0,47,6.714285714285714,1,0.0,15,0,16,0,12,1,1,2,0,31,16,0
1961,75557,514TWhkGGUhLu2MdvTnb8eiBH3DCFHzg,SpATywNh6bZuzm8s1ceuBUnMUAeoAHHw,17,21,12,18,3,0,1,0,55,7.857142857142857,1,0.0,6,12,18,3,15,0,0,1,0,39,16,0
1962,75565,A8uNxAeXRi6PUyfK3nbO106vNrsfyDAv,SpATywNh6bZuzm8s1ceuBUnMUAeoAHHw,17,19,10,16,7,0,7,0,59,8.428571428571429,1,0.0,7,10,14,7,12,0,2,7,0,38,21,0
1963,75619,qwKwEhJ5oWm5TB1Q6emluPsrjHPCR2z1,SpATywNh6bZuzm8s1ceuBUnMUAeoAHHw,22,21,13,20,6,0,7,0,67,9.571428571428571,1,0.0,4,13,17,6,17,0,3,7,0,40,27,1
1964,75980,mDHr8WvVVX9KSvXMqxtLvZ6vP4uuNF6E,A3fsA9Zfv1X2fVEQhTw51lKENdNrEqT3,6,6,0,0,0,1,4,0,11,1.5714285714285714,1,0.0,0,0,0,0,6,1,0,4,0,0,11,1
1965,76119,FXen1VSms29mqypmBsJLgiCW5lwzRuUO,7GRhBDsirIGkRZBtSMEzNTyDr2JQm4xx,17,17,7,8,7,0,3,0,42,6.0,1,0.0,7,7,6,7,10,0,2,3,0,27,15,1
1966,76261,wzJUcvl4LpGNAis186Xl9ztjI1WNWkac,bWdj2GDclj5ofokWjzoa5jAwMkxCykd6,5,0,0,0,0,0,6,1,7,1.0,2,0.0,0,0,0,0,0,0,0,6,1,0,7,1
1967,76314,0htS0wNp12VQ7YgJ628sRK5TB1tJHlRO,7GRhBDsirIGkRZBtSMEzNTyDr2JQm4xx,8,5,3,0,3,0,1,0,12,1.7142857142857142,1,0.0,1,3,0,3,4,0,0,1,0,7,5,1
1968,77044,bikkCYRyUxervPNSkXQBtcADPD3aMEN1,7GRhBDsirIGkRZBtSMEzNTyDr2JQm4xx,2,0,0,0,0,0,2,0,2,0.2857142857142857,1,0.0,0,0,0,0,0,0,0,2,0,0,2,1
1969,77126,qg6GOCuPcDwehPMMAEed7GZuAdyiaV9B,7GRhBDsirIGkRZBtSMEzNTyDr2JQm4xx,11,18,2,0,3,0,4,0,27,3.857142857142857,4,0.0,3,2,0,3,15,0,0,4,0,8,19,1
1970,77170,jOMPEpDTypAwtZP0adzz5Y6TGIr0Cgak,fbPkOYLVPtPgIt0MxizjfFJov3JbHyAi,6,10,1,1,4,0,1,0,17,2.4285714285714284,1,0.0,7,1,1,4,3,0,0,1,0,13,4,1
1971,77172,mI1vyeEbuUIxkGVi9aK5r9kjcaPF7SVi,fbPkOYLVPtPgIt0MxizjfFJov3JbHyAi,8,11,7,0,4,0,2,0,24,3.4285714285714284,1,0.0,0,7,0,4,11,0,0,2,0,11,13,1
1972,77173,GkJR3TNQR5bDjgiA7ByPHRWSb3vgtDKO,fbPkOYLVPtPgIt0MxizjfFJov3JbHyAi,9,10,5,0,3,6,4,1,29,4.142857142857143,1,0.0,1,5,0,3,9,6,0,4,1,9,20,1
1973,77176,hNJz0qbOhrUgajUkzqSdDbybHkuRglfs,fbPkOYLVPtPgIt0MxizjfFJov3JbHyAi,6,5,2,0,2,0,1,0,10,1.4285714285714286,1,0.0,0,2,0,2,5,0,0,1,0,4,6,1
1974,77177,NHGmMinB9WoQusKCx50F4M4nJF124Ms4,fbPkOYLVPtPgIt0MxizjfFJov3JbHyAi,4,2,1,0,1,0,1,0,5,0.7142857142857143,1,0.0,0,1,0,1,2,0,0,1,0,2,3,1
1975,77181,SFygdEesOWeEamKu8iZBsgHneiDiai0R,fbPkOYLVPtPgIt0MxizjfFJov3JbHyAi,4,3,0,0,0,0,1,0,4,0.5714285714285714,1,0.0,0,0,0,0,3,0,0,1,0,0,4,1
1976,77182,kmeB6Kxx4KEk3yK7YODyZKeWU8kJfyJH,fbPkOYLVPtPgIt0MxizjfFJov3JbHyAi,4,2,1,0,1,0,1,0,5,0.7142857142857143,1,0.0,0,1,0,1,2,0,0,1,0,2,3,1
1977,77184,wf4sRCFbvakokDkU4vw1lmU1y8DrYHz0,fbPkOYLVPtPgIt0MxizjfFJov3JbHyAi,7,14,5,0,2,9,6,0,36,5.142857142857143,2,0.0,3,5,0,2,11,9,0,6,0,10,26,1
1978,77185,QQjzUMnFih1Op25f6SGBPhOGRMF8l0bA,fbPkOYLVPtPgIt0MxizjfFJov3JbHyAi,22,36,14,13,13,0,1,0,77,11.0,1,0.0,14,14,11,13,22,0,2,1,0,52,25,1
1979,77187,JGkH5G6iVBgcA8nzn9agd5N20Wo6tva5,fbPkOYLVPtPgIt0MxizjfFJov3JbHyAi,21,15,13,0,8,0,4,0,40,5.714285714285714,1,0.0,0,13,0,8,15,0,0,4,0,21,19,1
1980,77188,DiP7fLvMTHut4vp8IPCEmth5BO8Y3xyZ,fbPkOYLVPtPgIt0MxizjfFJov3JbHyAi,9,10,5,0,4,13,7,3,42,6.0,1,0.0,2,5,0,4,8,13,0,7,3,11,31,1
1981,77189,Qj3OHkTzcEQwSk4fOQ3gLUAEOg61tV0J,fbPkOYLVPtPgIt0MxizjfFJov3JbHyAi,6,4,2,0,2,0,2,0,10,1.4285714285714286,1,0.0,0,2,0,2,4,0,0,2,0,4,6,1
1982,77190,YK4AUh2swGXXiib7M9ur8qjJXCBGfumK,fbPkOYLVPtPgIt0MxizjfFJov3JbHyAi,1,0,0,0,0,0,1,0,1,0.14285714285714285,1,0.0,0,0,0,0,0,0,0,1,0,0,1,1
1983,77191,E4C4yZPrf8ephwcq1p7RUy4dbVmvF86s,fbPkOYLVPtPgIt0MxizjfFJov3JbHyAi,1,0,0,0,0,0,2,0,2,0.2857142857142857,1,0.0,0,0,0,0,0,0,0,2,0,0,2,1
1984,77194,uOfATV0WsL0BPHDdVyS70rl0sYjdudpd,fbPkOYLVPtPgIt0MxizjfFJov3JbHyAi,10,18,8,4,3,0,7,0,40,5.714285714285714,1,0.0,4,8,3,3,14,0,1,7,0,18,22,1
1985,77197,4UvxElQD05jrzT8uj3rOHyCF67vFPUKP,fbPkOYLVPtPgIt0MxizjfFJov3JbHyAi,13,24,12,7,8,3,1,0,55,7.857142857142857,2,0.0,9,12,6,8,15,3,1,1,0,35,20,1
1986,77198,nctrJ6DXEbLac5Q8LCtyQd0IItjuRIih,fbPkOYLVPtPgIt0MxizjfFJov3JbHyAi,10,19,3,0,3,3,20,2,50,7.142857142857143,1,0.0,3,3,0,3,16,3,0,20,2,9,41,1
1987,77200,rwyVxnMY0KdYFbt5Rt6BKFYkmT4l68h9,fbPkOYLVPtPgIt0MxizjfFJov3JbHyAi,5,2,1,0,1,0,2,0,6,0.8571428571428571,1,0.0,0,1,0,1,2,0,0,2,0,2,4,1
1988,77206,OE8YoNemuZxKuixEPGeEQM6Dw53MRjvX,fbPkOYLVPtPgIt0MxizjfFJov3JbHyAi,1,0,0,0,0,0,1,0,1,0.14285714285714285,1,0.0,0,0,0,0,0,0,0,1,0,0,1,1
1989,77208,H47G4l8xfadoi35VSQjLwEe5Da3Pfkds,fbPkOYLVPtPgIt0MxizjfFJov3JbHyAi,4,2,1,0,1,0,1,0,5,0.7142857142857143,1,0.0,0,1,0,1,2,0,0,1,0,2,3,1
1990,77278,y7yLjFt2yMwjL5qqPUFP5MHo49CCR80j,fbPkOYLVPtPgIt0MxizjfFJov3JbHyAi,6,1,0,0,0,1,6,1,9,1.2857142857142858,1,0.0,0,0,0,0,1,1,0,6,1,0,9,0
1991,77302,KRi80h1uK84snC5HvtQKWlsjwt9i3oa5,fbPkOYLVPtPgIt0MxizjfFJov3JbHyAi,5,2,1,0,0,0,3,1,7,1.0,1,0.0,0,1,0,0,2,0,0,3,1,1,6,1
1992,77850,embp7e5rTedl4SQPXvv0NKkthNGlazF4,SpATywNh6bZuzm8s1ceuBUnMUAeoAHHw,18,22,8,20,5,0,6,0,61,8.714285714285714,2,0.0,6,8,16,5,16,0,4,6,0,35,26,0
1993,77861,j6kVkVGKYZT7ozL2NE5rOIexD3a1ewYn,SpATywNh6bZuzm8s1ceuBUnMUAeoAHHw,4,3,0,0,0,4,1,0,8,1.1428571428571428,1,0.0,0,0,0,0,3,4,0,1,0,0,8,1
1994,77948,HAqiq102XDB03bRDdmGODD1MUBTXSItL,G8EPVSXsOYB5YQWZGiz1aVq5Pgr2GrQu,10,7,2,8,3,0,5,0,25,3.5714285714285716,1,0.0,5,2,4,3,2,0,4,5,0,14,11,1
1995,78106,hu8eak1Xmf8voE8pnxPzkSD2dZP9Sipf,bWdj2GDclj5ofokWjzoa5jAwMkxCykd6,2,0,0,0,0,0,4,0,4,0.5714285714285714,2,0.0,0,0,0,0,0,0,0,4,0,0,4,0
1996,78188,CNb0Sul2DOkX3VhMOeM6DWqvlrGgHagf,bWdj2GDclj5ofokWjzoa5jAwMkxCykd6,6,5,2,0,1,0,3,1,12,1.7142857142857142,1,0.0,0,2,0,1,5,0,0,3,1,3,9,1
1997,78294,kj5o7wMZl1s4q0cggcmipnm7O7L6g4Ps,bWdj2GDclj5ofokWjzoa5jAwMkxCykd6,16,17,9,90,8,0,6,0,130,18.571428571428573,2,0.0,6,9,87,8,11,0,3,6,0,110,20,0
1998,78786,r62e9eSPsszv1Iv2O1V4lcMcbaHlq1ob,SpATywNh6bZuzm8s1ceuBUnMUAeoAHHw,18,19,1,25,0,0,2,0,47,6.714285714285714,1,0.0,6,1,21,0,13,0,4,2,0,28,19,0
1999,78797,5NRnaGcpNIGEuH61FLOcxB7Rjs6WPiNk,SpATywNh6bZuzm8s1ceuBUnMUAeoAHHw,30,41,24,14,10,1,8,0,98,14.0,2,0.0,9,24,13,10,32,1,1,8,0,56,42,0
2000,78886,pgMwb3FHEjNb1xNpBTJ5ysmRdBbuUNFr,bWdj2GDclj5ofokWjzoa5jAwMkxCykd6,9,7,1,14,1,0,2,0,25,3.5714285714285716,2,0.0,1,1,14,1,6,0,0,2,0,17,8,1
2001,78910,R6RINUtJNooptLfHmBRIBRqFOknkjv0Y,A3fsA9Zfv1X2fVEQhTw51lKENdNrEqT3,19,33,12,0,8,1,1,0,55,7.857142857142857,1,0.0,0,12,0,8,33,1,0,1,0,20,35,1
2002,78953,AZZvRPcRkLSa6vwofzfwsEULTUhiKy0E,SpATywNh6bZuzm8s1ceuBUnMUAeoAHHw,15,20,10,9,2,0,6,0,47,6.714285714285714,2,0.0,6,10,9,2,14,0,0,6,0,27,20,0
2003,79088,oA5bEHkRJtiDJKnesmAjUtrhTVSOkHe2,SpATywNh6bZuzm8s1ceuBUnMUAeoAHHw,8,11,9,0,7,0,3,0,30,4.285714285714286,1,0.0,0,9,0,7,11,0,0,3,0,16,14,1
2004,79164,wGfXRYqHkdAo1fVEEY9NvW8qy6M9m0mI,A3fsA9Zfv1X2fVEQhTw51lKENdNrEqT3,8,5,0,0,0,18,7,1,31,4.428571428571429,2,0.0,0,0,0,0,5,18,0,7,1,0,31,1
2005,79208,88xoeZRrDqjjjrf57zHp7JPU0EIVMG6O,SpATywNh6bZuzm8s1ceuBUnMUAeoAHHw,8,9,0,14,0,0,2,0,25,3.5714285714285716,1,0.0,5,0,14,0,4,0,0,2,0,19,6,1
2006,79509,G0i0hCTwH2K62ld1aO6Hf5Ntp0ahokSh,SpATywNh6bZuzm8s1ceuBUnMUAeoAHHw,30,62,29,19,11,16,40,4,181,25.857142857142858,4,0.0,14,29,19,11,48,16,0,40,4,73,108,0
2007,79519,NUQJxbePNRtXQQBXCQFchv4ww5sWUrml,SpATywNh6bZuzm8s1ceuBUnMUAeoAHHw,17,25,0,39,0,1,3,0,68,9.714285714285714,1,0.0,15,0,33,0,10,1,6,3,0,48,20,0
2008,79538,68aPv7D3ZE4JVkIRm8IjOcsEwxcFlwFO,A3fsA9Zfv1X2fVEQhTw51lKENdNrEqT3,3,3,0,0,0,0,1,0,4,0.5714285714285714,1,0.0,0,0,0,0,3,0,0,1,0,0,4,1
2009,79555,ygHFzUOzEqkLxFm5OclfxvG9i48BUAuT,SpATywNh6bZuzm8s1ceuBUnMUAeoAHHw,17,37,3,0,1,10,8,3,62,8.857142857142858,2,0.0,3,3,0,1,34,10,0,8,3,7,55,0
2010,79735,e9EeV5SqA2AUMzzKRuYh9383pOYfTL5t,A3fsA9Zfv1X2fVEQhTw51lKENdNrEqT3,2,0,0,0,0,0,2,0,2,0.2857142857142857,1,0.0,0,0,0,0,0,0,0,2,0,0,2,1
2011,79761,ffg9VbmMkFKj2DfO61ClA5PDHr5Xa6gN,SpATywNh6bZuzm8s1ceuBUnMUAeoAHHw,3,2,0,0,0,0,1,0,3,0.42857142857142855,1,0.0,0,0,0,0,2,0,0,1,0,0,3,0
2012,79822,WUz9eKwwTabZi4dE6GkJ03kYfBXiol2h,A3fsA9Zfv1X2fVEQhTw51lKENdNrEqT3,2,0,0,0,0,9,4,0,13,1.8571428571428572,2,0.0,0,0,0,0,0,9,0,4,0,0,13,1
2013,79956,hcKYo6bLhlANvHE0FxLuR4YY8jocfBwJ,A3fsA9Zfv1X2fVEQhTw51lKENdNrEqT3,9,14,0,0,0,28,3,0,45,6.428571428571429,2,0.0,0,0,0,0,14,28,0,3,0,0,45,1
2014,79984,oKZwUGrYHqdyevQMbQx5wJjMj1yq2zA6,A3fsA9Zfv1X2fVEQhTw51lKENdNrEqT3,4,3,1,0,0,0,2,0,6,0.8571428571428571,1,0.0,0,1,0,0,3,0,0,2,0,1,5,1
2015,80138,TcTuC5hiyHRmVc5qZWpzVJY3ugVLXB30,SpATywNh6bZuzm8s1ceuBUnMUAeoAHHw,3,2,0,0,0,0,1,0,3,0.42857142857142855,1,0.0,0,0,0,0,2,0,0,1,0,0,3,1
2016,80164,6iOLSqRTRABETCaDgzA6NufDV3dLbSSl,A3fsA9Zfv1X2fVEQhTw51lKENdNrEqT3,2,0,0,0,0,0,2,0,2,0.2857142857142857,1,0.0,0,0,0,0,0,0,0,2,0,0,2,1
2017,80236,V9sr2zgjH2joKkLVi0Sqvx5Qp7qYhjJ9,A3fsA9Zfv1X2fVEQhTw51lKENdNrEqT3,6,5,0,0,0,0,1,0,6,0.8571428571428571,1,0.0,0,0,0,0,5,0,0,1,0,0,6,1
2018,80251,P6CjwZWiHeS0SJlPQAf4bN1TR1u7fnyP,A3fsA9Zfv1X2fVEQhTw51lKENdNrEqT3,14,13,10,0,7,2,9,2,43,6.142857142857143,2,0.0,0,10,0,7,13,2,0,9,2,17,26,0
2019,80320,pz6FqQOVyf4J4lzlAfhLNtZDyqwAxEPh,A3fsA9Zfv1X2fVEQhTw51lKENdNrEqT3,12,9,6,0,5,0,3,0,23,3.2857142857142856,1,0.0,0,6,0,5,9,0,0,3,0,11,12,1
2020,80342,eq0DfIOiXorIpuNIOqxe4ooh3gnV5qKw,A3fsA9Zfv1X2fVEQhTw51lKENdNrEqT3,7,3,2,0,2,0,3,0,10,1.4285714285714286,1,0.0,0,2,0,2,3,0,0,3,0,4,6,1
2021,80411,GC4OF9yGz21AkcWehLa95SfLGyYuVKMP,SpATywNh6bZuzm8s1ceuBUnMUAeoAHHw,8,9,2,14,0,12,2,0,39,5.571428571428571,1,0.0,6,2,14,0,3,12,0,2,0,22,17,0
2022,80497,YotAwxbRJChtPJRmqiR2vpTmWxO7oSJ0,A3fsA9Zfv1X2fVEQhTw51lKENdNrEqT3,1,0,0,0,0,0,1,0,1,0.14285714285714285,1,0.0,0,0,0,0,0,0,0,1,0,0,1,1
2023,80514,DdUTtw4QPNiBxHI38HgtVDIMn8onRmHc,A3fsA9Zfv1X2fVEQhTw51lKENdNrEqT3,4,5,1,0,0,0,2,0,8,1.1428571428571428,2,0.0,0,1,0,0,5,0,0,2,0,1,7,0
2024,80578,WCnGcaqoXPOoj0smksJ3AG2zfJ5bQ6q1,A3fsA9Zfv1X2fVEQhTw51lKENdNrEqT3,6,1,1,0,1,0,3,0,6,0.8571428571428571,1,0.0,0,1,0,1,1,0,0,3,0,2,4,1
2025,80593,z9sj5HIJml1DMOMfRKKBQ7IvS2IoE424,A3fsA9Zfv1X2fVEQhTw51lKENdNrEqT3,1,0,0,0,0,0,2,0,2,0.2857142857142857,1,0.0,0,0,0,0,0,0,0,2,0,0,2,1
2026,80621,L5BsWcgN6IMgchaeVR0q3PWadEiOivUf,A3fsA9Zfv1X2fVEQhTw51lKENdNrEqT3,6,2,1,0,1,1,3,1,9,1.2857142857142858,1,0.0,0,1,0,1,2,1,0,3,1,2,7,1
2027,80646,1XuOICh6QrUFIc1MJAW7XRUBUSTY0RN7,SpATywNh6bZuzm8s1ceuBUnMUAeoAHHw,3,2,1,0,0,0,1,0,4,0.5714285714285714,1,0.0,0,1,0,0,2,0,0,1,0,1,3,1
2028,80650,CViRSkXaB71kW0MpqfES8A240EKnhiKp,A3fsA9Zfv1X2fVEQhTw51lKENdNrEqT3,5,5,3,0,2,0,2,0,12,1.7142857142857142,1,0.0,0,3,0,2,5,0,0,2,0,5,7,1
2029,80721,9pnVOC0WBepjoyI2qcaWMzrSP0RPnX7J,A3fsA9Zfv1X2fVEQhTw51lKENdNrEqT3,4,2,0,0,0,0,2,0,4,0.5714285714285714,1,0.0,0,0,0,0,2,0,0,2,0,0,4,1
2030,80744,EGvZuk2o6udfOjbP1e9MeD8Ju07DscTY,A3fsA9Zfv1X2fVEQhTw51lKENdNrEqT3,1,0,0,0,0,0,3,0,3,0.42857142857142855,1,0.0,0,0,0,0,0,0,0,3,0,0,3,1
2031,80800,a98Mt6r9LLCkAEPo2R3JVMN20OhIPoaG,SpATywNh6bZuzm8s1ceuBUnMUAeoAHHw,5,7,4,0,2,0,3,0,16,2.2857142857142856,1,0.0,0,4,0,2,7,0,0,3,0,6,10,1
2032,80820,auTfNrVnLCOPJ3vRg0BBNLuEGlk6Jhzf,A3fsA9Zfv1X2fVEQhTw51lKENdNrEqT3,1,0,0,0,0,0,1,0,1,0.14285714285714285,1,0.0,0,0,0,0,0,0,0,1,0,0,1,1
2033,80865,detHMtXeNBDLl1yfq61M11qScSHezCTa,fbPkOYLVPtPgIt0MxizjfFJov3JbHyAi,7,5,3,0,3,0,5,0,16,2.2857142857142856,1,0.0,1,3,0,3,4,0,0,5,0,7,9,1
2034,80866,lPCl89OkL3ywqPQ9tkoc7yQfPt2jOe8J,fbPkOYLVPtPgIt0MxizjfFJov3JbHyAi,11,22,8,6,9,27,15,4,91,13.0,1,0.0,12,8,4,9,10,27,2,15,4,33,58,1
2035,80872,pGAbpSQSqm8kO5KHqj1P91gbLxgxqLMR,fbPkOYLVPtPgIt0MxizjfFJov3JbHyAi,1,0,0,0,0,0,1,0,1,0.14285714285714285,1,0.0,0,0,0,0,0,0,0,1,0,0,1,1
2036,80874,tH916xRbn4bSZXJ6Z57PlnTAPQfz04PX,fbPkOYLVPtPgIt0MxizjfFJov3JbHyAi,13,10,5,3,4,0,3,0,25,3.5714285714285716,1,0.0,2,5,3,4,8,0,0,3,0,14,11,1
2037,80875,zgLhc8F17sS6o8GPDEBAA43SRssMOYHD,fbPkOYLVPtPgIt0MxizjfFJov3JbHyAi,3,2,1,0,0,0,1,0,4,0.5714285714285714,1,0.0,0,1,0,0,2,0,0,1,0,1,3,1
2038,80876,yoqZagpPshUzxT5y74jKK6qgFqUHTRAQ,fbPkOYLVPtPgIt0MxizjfFJov3JbHyAi,7,4,2,0,2,0,3,0,11,1.5714285714285714,1,0.0,1,2,0,2,3,0,0,3,0,5,6,1
2039,80879,QRBHeXWoh4Eq5qFFGeXnL66X034DcN82,fbPkOYLVPtPgIt0MxizjfFJov3JbHyAi,7,5,4,0,3,0,2,0,14,2.0,1,0.0,0,4,0,3,5,0,0,2,0,7,7,1
2040,80880,nwSsR1adl0WQZ5D0MOHLkrBumdQn65bS,fbPkOYLVPtPgIt0MxizjfFJov3JbHyAi,1,0,0,0,0,0,1,0,1,0.14285714285714285,1,0.0,0,0,0,0,0,0,0,1,0,0,1,1
2041,80883,dl3uJviN00Na5GELdMJFr7DikNXKgldw,fbPkOYLVPtPgIt0MxizjfFJov3JbHyAi,12,13,4,8,4,0,11,1,41,5.857142857142857,1,0.0,5,4,6,4,8,0,2,11,1,19,22,1
2042,80885,OJ0LoXMYeoupgtCsqXPKoTXc19jkOfHU,fbPkOYLVPtPgIt0MxizjfFJov3JbHyAi,6,13,0,2,2,0,3,0,20,2.857142857142857,1,0.0,7,0,2,2,6,0,0,3,0,11,9,1
2043,80890,9iv095QjZS4Q7X9b663JhI4Y5VIooOZJ,fbPkOYLVPtPgIt0MxizjfFJov3JbHyAi,7,4,3,0,2,0,8,0,17,2.4285714285714284,1,0.0,0,3,0,2,4,0,0,8,0,5,12,1
2044,80891,1IMOvf9v1bRH0tUTRkiIkzGe833lnAgf,fbPkOYLVPtPgIt0MxizjfFJov3JbHyAi,4,2,1,0,1,0,1,0,5,0.7142857142857143,1,0.0,0,1,0,1,2,0,0,1,0,2,3,0
2045,80892,OqzJYk2L0XqYLfMs4LljNI8HpBsCF1TU,fbPkOYLVPtPgIt0MxizjfFJov3JbHyAi,6,6,3,0,1,0,1,0,11,1.5714285714285714,1,0.0,1,3,0,1,5,0,0,1,0,5,6,1
2046,80894,wa9yiDToqQTrEAjEFYLZvJZ6yii3aZEK,fbPkOYLVPtPgIt0MxizjfFJov3JbHyAi,9,3,3,0,3,3,9,2,23,3.2857142857142856,1,0.0,0,3,0,3,3,3,0,9,2,6,17,1
2047,80896,F7beo1Qs8FACPdfc8t0SncgEfDkdNWKi,fbPkOYLVPtPgIt0MxizjfFJov3JbHyAi,12,19,14,0,7,33,13,2,88,12.571428571428571,3,0.0,1,14,0,7,18,33,0,13,2,22,66,1
2048,82405,TciQEzJA4hKxeo0Ve5JLByGDZHpNx3uy,7GRhBDsirIGkRZBtSMEzNTyDr2JQm4xx,7,6,2,0,0,10,9,0,27,3.857142857142857,1,0.0,0,2,0,0,6,10,0,9,0,2,25,1
2049,82549,LzZbSzxCF6j5IK4opjLkxGirHE6VTy2b,7GRhBDsirIGkRZBtSMEzNTyDr2JQm4xx,8,9,1,0,2,0,1,0,13,1.8571428571428572,1,0.0,2,1,0,2,7,0,0,1,0,5,8,0
2050,82826,6PLrCNmfEwPk8NveiZ2kjz8b6TJ4tdFy,SpATywNh6bZuzm8s1ceuBUnMUAeoAHHw,16,19,0,14,0,2,7,0,42,6.0,1,0.0,6,0,11,0,13,2,3,7,0,17,25,1
2051,83034,JfftjOGdDbpgbrupi0Gwr899R0jzXikJ,RXDvfPUBYFlVdlueBFbLW0mhhAyGEqpt,9,13,8,0,3,0,5,0,29,4.142857142857143,3,0.0,0,8,0,3,13,0,0,5,0,11,18,1
2052,83156,wSQurJctKIVWroKFEwLtZd7EI4FKyqnr,G8EPVSXsOYB5YQWZGiz1aVq5Pgr2GrQu,25,45,12,74,8,0,2,0,141,20.142857142857142,1,0.0,19,12,57,8,26,0,17,2,0,96,45,0
2053,83277,dT92IjRcuruPiAlpqVUTtu3wNL9IIegT,SpATywNh6bZuzm8s1ceuBUnMUAeoAHHw,1,0,0,0,0,0,1,0,1,0.14285714285714285,1,0.0,0,0,0,0,0,0,0,1,0,0,1,1
2054,84034,lDJqver3AFFUyXISNdqvZpmq6OeWVl0r,A3fsA9Zfv1X2fVEQhTw51lKENdNrEqT3,18,12,10,0,7,0,4,0,33,4.714285714285714,1,0.0,0,10,0,7,12,0,0,4,0,17,16,0
2055,84176,Xv4cOEYZEExzsBdbjc8lrCLUZHXLo5uk,SpATywNh6bZuzm8s1ceuBUnMUAeoAHHw,28,43,14,39,8,14,8,1,127,18.142857142857142,2,0.0,21,14,32,8,22,14,7,8,1,75,52,0
2056,84258,HOl7cCI0BgZTJ7INtqfMX4dKD4xHl51U,fbPkOYLVPtPgIt0MxizjfFJov3JbHyAi,14,29,6,12,7,0,1,0,55,7.857142857142857,1,0.0,15,6,9,7,14,0,3,1,0,37,18,1
2057,84259,xi2KO7WcXIB6LKlzLxLjQ5IcXn6cZQFV,fbPkOYLVPtPgIt0MxizjfFJov3JbHyAi,7,3,2,0,2,0,4,0,11,1.5714285714285714,1,0.0,0,2,0,2,3,0,0,4,0,4,7,1
2058,84261,lBljSQvIVCpw7S5SELQHg4JfMSTvCBRe,fbPkOYLVPtPgIt0MxizjfFJov3JbHyAi,10,13,1,0,1,0,3,0,18,2.5714285714285716,1,0.0,0,1,0,1,13,0,0,3,0,2,16,0
2059,84264,MSLYJeLT8SYZ3UpCzbTuM5WBLAn4P9C0,fbPkOYLVPtPgIt0MxizjfFJov3JbHyAi,5,2,1,0,1,0,2,0,6,0.8571428571428571,1,0.0,0,1,0,1,2,0,0,2,0,2,4,0
2060,84268,MaxCNnPaLK24RRWF9HKJTqddyOCcvhNc,fbPkOYLVPtPgIt0MxizjfFJov3JbHyAi,8,7,4,0,2,0,4,0,17,2.4285714285714284,1,0.0,0,4,0,2,7,0,0,4,0,6,11,1
2061,84270,HRxHszLswfw468mOCwAnOXdKGRZhTUPo,fbPkOYLVPtPgIt0MxizjfFJov3JbHyAi,9,9,1,0,2,0,2,0,14,2.0,1,0.0,2,1,0,2,7,0,0,2,0,5,9,1
2062,84273,Mbzz4hCvkXsTjBUMTZvnUnOUU5DkeepD,fbPkOYLVPtPgIt0MxizjfFJov3JbHyAi,13,23,13,0,5,13,5,0,59,8.428571428571429,1,0.0,0,13,0,5,23,13,0,5,0,18,41,1
2063,84274,KSAnx8l7GLibIHVjfaVpoMytCY29O5jV,fbPkOYLVPtPgIt0MxizjfFJov3JbHyAi,14,10,7,0,6,0,6,0,29,4.142857142857143,1,0.0,0,7,0,6,10,0,0,6,0,13,16,1
2064,84276,FHZxLNKuH41dzVdZ6xZP53e1ChodL4Nf,fbPkOYLVPtPgIt0MxizjfFJov3JbHyAi,2,0,0,0,0,0,2,0,2,0.2857142857142857,1,0.0,0,0,0,0,0,0,0,2,0,0,2,1
2065,84277,2j1tzVxn26ffq0mMvPPBIt1027gHtJr2,fbPkOYLVPtPgIt0MxizjfFJov3JbHyAi,3,0,0,0,0,0,4,0,4,0.5714285714285714,1,0.0,0,0,0,0,0,0,0,4,0,0,4,1
2066,84278,sW5iKRsVcoKx4Fgip5uKQwojFhK3kh4H,fbPkOYLVPtPgIt0MxizjfFJov3JbHyAi,7,8,3,0,2,0,4,0,17,2.4285714285714284,1,0.0,3,3,0,2,5,0,0,4,0,8,9,1
2067,84279,IKnWhfStgn6HzF4rCtxpMA6vaE95bkoN,fbPkOYLVPtPgIt0MxizjfFJov3JbHyAi,41,56,31,28,21,7,6,0,149,21.285714285714285,1,0.0,18,31,23,21,38,7,5,6,0,93,56,1
2068,84281,E6x1c22fqqwc9Xq0TREOCZPgn8h5NZRY,fbPkOYLVPtPgIt0MxizjfFJov3JbHyAi,2,0,0,0,0,0,2,0,2,0.2857142857142857,1,0.0,0,0,0,0,0,0,0,2,0,0,2,1
2069,84282,oyKcbflIhFWjfv9zJsn9ws83l2i6sd8B,fbPkOYLVPtPgIt0MxizjfFJov3JbHyAi,5,0,0,0,0,0,4,1,5,0.7142857142857143,1,0.0,0,0,0,0,0,0,0,4,1,0,5,1
2070,84284,SfvT6FHCLeajKH96s2LkoIO8YQ9sAqIE,fbPkOYLVPtPgIt0MxizjfFJov3JbHyAi,1,0,0,0,0,0,1,0,1,0.14285714285714285,1,0.0,0,0,0,0,0,0,0,1,0,0,1,1
2071,84285,6dxWIDqaYjsp7lwDHFYen9IBERKYGMUl,fbPkOYLVPtPgIt0MxizjfFJov3JbHyAi,11,12,8,0,6,1,8,1,36,5.142857142857143,3,0.0,0,8,0,6,12,1,0,8,1,14,22,1
2072,84289,8a6lcOY5tqRSg2M4LEQLAhRHX2NBy9qe,fbPkOYLVPtPgIt0MxizjfFJov3JbHyAi,1,0,0,0,0,0,1,0,1,0.14285714285714285,1,0.0,0,0,0,0,0,0,0,1,0,0,1,1
2073,84291,8V79kzOnHwVk0Szz0Nr0pjOSCgEaC0bl,fbPkOYLVPtPgIt0MxizjfFJov3JbHyAi,1,0,0,0,0,0,1,0,1,0.14285714285714285,1,0.0,0,0,0,0,0,0,0,1,0,0,1,0
2074,84433,Vu8rN942EwDIOj6iE8IDqvSFXpvGHO9R,A3fsA9Zfv1X2fVEQhTw51lKENdNrEqT3,49,28,21,72,12,0,10,0,143,20.428571428571427,2,0.0,4,21,57,12,24,0,15,10,0,94,49,1
2075,84438,zo3To03Q5Rdok3x4Zu1wNdsKqNDBlzyd,SpATywNh6bZuzm8s1ceuBUnMUAeoAHHw,3,2,1,0,0,2,1,0,6,0.8571428571428571,2,0.0,0,1,0,0,2,2,0,1,0,1,5,1
2076,84439,lmCPiW6l0WNp9Ttn0lhwFDs7FfVubtvY,SpATywNh6bZuzm8s1ceuBUnMUAeoAHHw,14,20,7,23,3,0,1,0,54,7.714285714285714,1,0.0,12,7,21,3,8,0,2,1,0,43,11,0
2077,84443,d27sJazbqmVDzx5twhACbiEBxUXvQf2a,SpATywNh6bZuzm8s1ceuBUnMUAeoAHHw,8,4,1,0,1,0,6,0,12,1.7142857142857142,1,0.0,0,1,0,1,4,0,0,6,0,2,10,1
2078,84463,ROXnyv16zBgjdP3dwdWTQaFrI7qQfgov,bWdj2GDclj5ofokWjzoa5jAwMkxCykd6,3,0,0,0,0,0,3,0,3,0.42857142857142855,1,0.0,0,0,0,0,0,0,0,3,0,0,3,1
2079,84487,dlcs3mIk1dQaLsNVv2V1gEVdgllvLwJb,SpATywNh6bZuzm8s1ceuBUnMUAeoAHHw,8,10,4,0,1,1,5,0,21,3.0,2,0.0,2,4,0,1,8,1,0,5,0,7,14,1
2080,84488,Hb1qgsgjtdXdXqLzZUND7Apyl9dV7sNn,SpATywNh6bZuzm8s1ceuBUnMUAeoAHHw,15,26,1,18,1,0,2,0,48,6.857142857142857,1,0.0,6,1,15,1,20,0,3,2,0,23,25,1
2081,84493,yEniPsoZW8Rgn4eOpAbvQhjj6pD8iwKc,bWdj2GDclj5ofokWjzoa5jAwMkxCykd6,3,2,0,0,0,0,1,0,3,0.42857142857142855,1,0.0,0,0,0,0,2,0,0,1,0,0,3,1
2082,84511,IDZ1AkiRXaR9yEtXb4Bo4nmlcF9ha0Jw,A3fsA9Zfv1X2fVEQhTw51lKENdNrEqT3,11,10,1,0,1,0,2,0,14,2.0,1,0.0,0,1,0,1,10,0,0,2,0,2,12,1
2083,84515,7zovZ3nFJhhuFND78aqDkmZfLWj3rVkx,bWdj2GDclj5ofokWjzoa5jAwMkxCykd6,8,11,3,0,4,1,5,1,25,3.5714285714285716,1,0.0,5,3,0,4,6,1,0,5,1,12,13,1
2084,84531,UwNh19bGTGX7YEBtcKZFqxDpmh2gUs3A,SpATywNh6bZuzm8s1ceuBUnMUAeoAHHw,16,16,6,12,3,0,2,0,39,5.571428571428571,1,0.0,3,6,12,3,13,0,0,2,0,24,15,0
2085,84533,KYp9UMy6aThBgyjsQnGoWdfiTDRtgnUO,A3fsA9Zfv1X2fVEQhTw51lKENdNrEqT3,4,3,1,0,0,0,1,0,5,0.7142857142857143,1,0.0,0,1,0,0,3,0,0,1,0,1,4,1
2086,84562,k6RJ44LpfDefc4BqSfb5Ks3bqRLzpbPs,SpATywNh6bZuzm8s1ceuBUnMUAeoAHHw,3,2,0,0,0,0,1,0,3,0.42857142857142855,1,0.0,0,0,0,0,2,0,0,1,0,0,3,1
2087,84570,3ROVLcXTo6OjIxmsQ13CBJ7pM5RMLVRs,SpATywNh6bZuzm8s1ceuBUnMUAeoAHHw,1,0,0,0,0,0,1,0,1,0.14285714285714285,1,0.0,0,0,0,0,0,0,0,1,0,0,1,1
2088,84622,UkZfNxIrXEzpCVrNVYStVn9ei74ROLV5,SpATywNh6bZuzm8s1ceuBUnMUAeoAHHw,9,4,3,0,3,0,2,0,12,1.7142857142857142,1,0.0,0,3,0,3,4,0,0,2,0,6,6,1
2089,84637,uqV3t3wNYphdy7WkOt07V9fSIpdy9v7v,SpATywNh6bZuzm8s1ceuBUnMUAeoAHHw,1,0,0,0,0,0,1,0,1,0.14285714285714285,1,0.0,0,0,0,0,0,0,0,1,0,0,1,1
2090,84650,rM6lHK7hiIUNX1NSrJxSbqLCGaqN5u1S,bWdj2GDclj5ofokWjzoa5jAwMkxCykd6,1,0,0,0,0,0,1,0,1,0.14285714285714285,1,0.0,0,0,0,0,0,0,0,1,0,0,1,1
2091,84655,fuprfcX49r5QcUYvMQnvvzEf76cx4sRp,A3fsA9Zfv1X2fVEQhTw51lKENdNrEqT3,1,0,0,0,0,0,1,0,1,0.14285714285714285,1,0.0,0,0,0,0,0,0,0,1,0,0,1,1
2092,84656,DA41CWRarbj2LaaLGDHgoyCQ99QpXH1z,SpATywNh6bZuzm8s1ceuBUnMUAeoAHHw,1,0,0,0,0,0,1,0,1,0.14285714285714285,1,0.0,0,0,0,0,0,0,0,1,0,0,1,1
2093,84696,HDx7XT9cwQtHtGFe0Ylk6QLaCz2f0GRa,bWdj2GDclj5ofokWjzoa5jAwMkxCykd6,8,13,9,0,0,2,4,0,28,4.0,2,0.0,0,9,0,0,13,2,0,4,0,9,19,1
2094,84712,rK4055OdlTymOWiwkxW7eIve09mowPhX,bWdj2GDclj5ofokWjzoa5jAwMkxCykd6,8,7,4,0,2,1,8,1,23,3.2857142857142856,1,0.0,0,4,0,2,7,1,0,8,1,6,17,1
2095,84733,9WmzxyamLAgd2LnrO6zydiN7WV3MNZZt,SpATywNh6bZuzm8s1ceuBUnMUAeoAHHw,21,44,34,12,8,17,9,1,125,17.857142857142858,1,0.0,7,34,12,8,37,17,0,9,1,61,64,1
2096,84746,KyernIkPskZZLcEZuqJdIALK35DoR4YD,SpATywNh6bZuzm8s1ceuBUnMUAeoAHHw,9,7,4,7,3,0,1,0,22,3.142857142857143,1,0.0,1,4,6,3,6,0,1,1,0,14,8,0
2097,84764,l0LgYDne2SMH172pM6WtwTolJro40hEN,bWdj2GDclj5ofokWjzoa5jAwMkxCykd6,8,8,5,0,2,0,2,0,17,2.4285714285714284,1,0.0,0,5,0,2,8,0,0,2,0,7,10,1
2098,84768,DsHgWZRTJ1y1l15smwhB78ZQq3d8dyKP,bWdj2GDclj5ofokWjzoa5jAwMkxCykd6,9,19,1,0,2,0,4,0,26,3.7142857142857144,3,0.0,2,1,0,2,17,0,0,4,0,5,21,1
2099,84803,RijiZcjqs3Sau2onXuynGNDorKgFFeFF,A3fsA9Zfv1X2fVEQhTw51lKENdNrEqT3,1,0,0,0,0,0,1,0,1,0.14285714285714285,1,0.0,0,0,0,0,0,0,0,1,0,0,1,1
2100,84807,lBDP0bEGdpXmY1IAvAuALKqFWFlEuPft,A3fsA9Zfv1X2fVEQhTw51lKENdNrEqT3,1,0,0,0,0,0,1,0,1,0.14285714285714285,1,0.0,0,0,0,0,0,0,0,1,0,0,1,1
2101,84823,Wefj86tFjwJZnMq6IAWMjbzJgYWyoGE5,A3fsA9Zfv1X2fVEQhTw51lKENdNrEqT3,7,4,1,0,1,0,2,0,8,1.1428571428571428,1,0.0,0,1,0,1,4,0,0,2,0,2,6,1
2102,84824,CCr7XJJW4dK2W5QL9m4z2ZC42b4ulnok,SpATywNh6bZuzm8s1ceuBUnMUAeoAHHw,13,14,9,0,4,0,3,0,30,4.285714285714286,2,0.0,2,9,0,4,12,0,0,3,0,15,15,0
2103,84837,yv537v6H4lKuJBGFGcy0VRT6imwv3rrr,SpATywNh6bZuzm8s1ceuBUnMUAeoAHHw,1,0,0,0,0,0,2,0,2,0.2857142857142857,1,0.0,0,0,0,0,0,0,0,2,0,0,2,1
2104,84840,nMDev1avOgY53G2oqsCYhN7adTYqimPz,SpATywNh6bZuzm8s1ceuBUnMUAeoAHHw,9,5,4,0,3,0,1,0,13,1.8571428571428572,1,0.0,0,4,0,3,5,0,0,1,0,7,6,1
2105,84856,IKpNQ2VJXcBrssoIsB3X4wtY2qE1YTKj,bWdj2GDclj5ofokWjzoa5jAwMkxCykd6,8,6,4,0,3,0,1,0,14,2.0,1,0.0,0,4,0,3,6,0,0,1,0,7,7,1
2106,84879,Wq9v1J863GLs0FXJcY6870pE4xwQWj9c,SpATywNh6bZuzm8s1ceuBUnMUAeoAHHw,7,6,3,0,2,1,5,0,17,2.4285714285714284,1,0.0,0,3,0,2,6,1,0,5,0,5,12,1
2107,84893,aXizpBfL2fbBc8SAHrmAdMBwyiDoIJ3v,SpATywNh6bZuzm8s1ceuBUnMUAeoAHHw,3,2,0,0,0,0,2,0,4,0.5714285714285714,1,0.0,0,0,0,0,2,0,0,2,0,0,4,1
2108,84898,BNaKyL5AxH5r8ATMyUD5dD2w9iqh31Mt,SpATywNh6bZuzm8s1ceuBUnMUAeoAHHw,8,6,4,0,3,0,4,0,17,2.4285714285714284,1,0.0,0,4,0,3,6,0,0,4,0,7,10,1
2109,84899,AMjnZTCZ82BDNCUbVBOLwJQKlTsIjteg,bWdj2GDclj5ofokWjzoa5jAwMkxCykd6,1,0,0,0,0,0,1,0,1,0.14285714285714285,1,0.0,0,0,0,0,0,0,0,1,0,0,1,1
2110,84914,CAJCBn0iJNYHHRrNYpaEyoUpQFaCqopf,SpATywNh6bZuzm8s1ceuBUnMUAeoAHHw,3,0,0,0,0,11,2,0,13,1.8571428571428572,1,0.0,0,0,0,0,0,11,0,2,0,0,13,1
2111,84920,P8HECw7bHyNqGqPTlWbv24tTg1SG6bAf,A3fsA9Zfv1X2fVEQhTw51lKENdNrEqT3,11,5,4,0,4,0,2,0,15,2.142857142857143,1,0.0,0,4,0,4,5,0,0,2,0,8,7,1
2112,84924,bkuP1EtN8mdTFJXvfsUwoFetipNOKV1x,A3fsA9Zfv1X2fVEQhTw51lKENdNrEqT3,6,4,0,0,0,2,3,0,9,1.2857142857142858,2,0.0,0,0,0,0,4,2,0,3,0,0,9,0
2113,84933,u0SrW65Zdf0RG2PPgt52qf6MWWYZDmbZ,A3fsA9Zfv1X2fVEQhTw51lKENdNrEqT3,4,2,1,0,1,0,2,0,6,0.8571428571428571,1,0.0,0,1,0,1,2,0,0,2,0,2,4,0
2114,84941,wdyLBUXnKZHWy3hjP9iEUMTvoZlBkTI1,A3fsA9Zfv1X2fVEQhTw51lKENdNrEqT3,28,8,5,84,2,2,3,0,104,14.857142857142858,1,0.0,1,5,66,2,7,2,18,3,0,74,30,1
2115,84943,tqYPV9KH0m40QH4HM703oTrUL5BNNo84,bWdj2GDclj5ofokWjzoa5jAwMkxCykd6,3,3,0,0,0,0,2,0,5,0.7142857142857143,1,0.0,0,0,0,0,3,0,0,2,0,0,5,1
2116,84959,hkI32MAgHvJ4T3I3Up79daEJ8l4sKHaC,A3fsA9Zfv1X2fVEQhTw51lKENdNrEqT3,19,11,10,16,9,0,1,0,47,6.714285714285714,1,0.0,0,10,15,9,11,0,1,1,0,34,13,1
2117,84967,cnF5YfjX3CQt7JMSCL8P4leqdmCPbBni,A3fsA9Zfv1X2fVEQhTw51lKENdNrEqT3,7,6,1,0,1,0,1,0,9,1.2857142857142858,1,0.0,1,1,0,1,5,0,0,1,0,3,6,1
2118,84969,AhGz4Es1bWdEWhXy7JGcFI2vY1lHgQNv,A3fsA9Zfv1X2fVEQhTw51lKENdNrEqT3,11,14,7,0,4,0,9,0,34,4.857142857142857,1,0.0,0,7,0,4,14,0,0,9,0,11,23,1
2119,84982,KogrHROquIJLSXIZqzhYU9Hcb9zVebwT,A3fsA9Zfv1X2fVEQhTw51lKENdNrEqT3,68,28,21,134,13,39,12,1,248,35.42857142857143,3,0.0,3,21,108,13,25,39,26,12,1,145,103,1
2120,85006,tj54X35V4FNci4Kh3LQpxJqVKMwouLiV,SpATywNh6bZuzm8s1ceuBUnMUAeoAHHw,1,0,0,0,0,0,1,0,1,0.14285714285714285,1,0.0,0,0,0,0,0,0,0,1,0,0,1,1
2121,85036,Dieqd8f4UcwVzwl01TlWitYgH9I2P4ID,SpATywNh6bZuzm8s1ceuBUnMUAeoAHHw,14,16,5,15,3,0,2,0,41,5.857142857142857,1,0.0,10,5,12,3,6,0,3,2,0,30,11,1
2122,85058,aIIHBjdeRcv9jhajcTkxD39vpVMqF1ri,SpATywNh6bZuzm8s1ceuBUnMUAeoAHHw,1,0,0,0,0,0,1,0,1,0.14285714285714285,1,0.0,0,0,0,0,0,0,0,1,0,0,1,1
2123,85071,aO0LEwjTmeNegVPIDdxnfGASlS2PDBPM,bWdj2GDclj5ofokWjzoa5jAwMkxCykd6,4,2,0,0,0,0,2,0,4,0.5714285714285714,1,0.0,0,0,0,0,2,0,0,2,0,0,4,1
2124,85074,DxH75iZ2vwK7RWdx8JWNqysBZPhRedJP,SpATywNh6bZuzm8s1ceuBUnMUAeoAHHw,14,9,7,0,6,0,4,0,26,3.7142857142857144,1,0.0,0,7,0,6,9,0,0,4,0,13,13,1
2125,85101,eUiPnt4yNOhbT6A4YKzKQWtxymmKMqK8,SpATywNh6bZuzm8s1ceuBUnMUAeoAHHw,5,2,1,0,1,0,2,0,6,0.8571428571428571,1,0.0,0,1,0,1,2,0,0,2,0,2,4,0
2126,85143,cnF5YfjX3CQt7JMSCL8P4leqdmCPbBni,SpATywNh6bZuzm8s1ceuBUnMUAeoAHHw,5,3,1,0,1,0,1,0,6,0.8571428571428571,1,0.0,0,1,0,1,3,0,0,1,0,2,4,1
2127,85161,bjM6n8DVZxyRbCs3zMbeKGW5iCOjCuf2,SpATywNh6bZuzm8s1ceuBUnMUAeoAHHw,30,32,17,38,7,20,9,1,124,17.714285714285715,3,0.0,12,17,31,7,20,20,7,9,1,67,57,0
2128,85163,W8y6AnXsJBrDnPij0rvHOisz3iKgMu0I,A3fsA9Zfv1X2fVEQhTw51lKENdNrEqT3,1,0,0,0,0,0,1,0,1,0.14285714285714285,1,0.0,0,0,0,0,0,0,0,1,0,0,1,1
2129,85203,9WmzxyamLAgd2LnrO6zydiN7WV3MNZZt,A3fsA9Zfv1X2fVEQhTw51lKENdNrEqT3,20,40,37,0,19,4,6,1,107,15.285714285714286,1,0.0,0,37,0,19,40,4,0,6,1,56,51,1
2130,85214,t5GAapz2qu7QW3ZA52Mo1qG5gvWMLT4H,SpATywNh6bZuzm8s1ceuBUnMUAeoAHHw,19,25,12,0,8,0,1,0,46,6.571428571428571,1,0.0,12,12,0,8,13,0,0,1,0,32,14,0
2131,85217,LgWCkAUxSRrYwIgyk3EiLrbm8VtT63oN,SpATywNh6bZuzm8s1ceuBUnMUAeoAHHw,5,3,0,0,0,0,2,0,5,0.7142857142857143,1,0.0,0,0,0,0,3,0,0,2,0,0,5,1
2132,85224,1DHzwL80UljY6lJVpTYvYIaqwxFV4OAM,A3fsA9Zfv1X2fVEQhTw51lKENdNrEqT3,4,4,0,0,0,0,2,0,6,0.8571428571428571,1,0.0,0,0,0,0,4,0,0,2,0,0,6,1
2133,85249,p6TgFJdLQMaMzbR16kycIPcRPnBj3paK,A3fsA9Zfv1X2fVEQhTw51lKENdNrEqT3,4,2,1,0,1,0,1,0,5,0.7142857142857143,1,0.0,0,1,0,1,2,0,0,1,0,2,3,1
2134,85262,F2owRK2SDPW5FCDK4TxmBVHsTtJ44Nxq,A3fsA9Zfv1X2fVEQhTw51lKENdNrEqT3,12,19,2,0,2,0,3,0,26,3.7142857142857144,2,0.0,0,2,0,2,19,0,0,3,0,4,22,1
2135,85271,pMl3OskiuqgHNgKCqbUXUq2PDmPkrU2r,bWdj2GDclj5ofokWjzoa5jAwMkxCykd6,5,2,1,0,1,0,2,0,6,0.8571428571428571,1,0.0,0,1,0,1,2,0,0,2,0,2,4,1
2136,85283,9WmzxyamLAgd2LnrO6zydiN7WV3MNZZt,RXDvfPUBYFlVdlueBFbLW0mhhAyGEqpt,1,0,0,0,0,0,4,0,4,0.5714285714285714,1,0.0,0,0,0,0,0,0,0,4,0,0,4,1
2137,85284,Ws4jgichwsX0H8doBZ8nJsfB9pxtw9wh,SpATywNh6bZuzm8s1ceuBUnMUAeoAHHw,1,0,0,0,0,0,1,0,1,0.14285714285714285,1,0.0,0,0,0,0,0,0,0,1,0,0,1,1
2138,85286,pMl3OskiuqgHNgKCqbUXUq2PDmPkrU2r,A3fsA9Zfv1X2fVEQhTw51lKENdNrEqT3,2,0,0,0,0,0,2,0,2,0.2857142857142857,1,0.0,0,0,0,0,0,0,0,2,0,0,2,1
2139,85295,Zp1ZZPWn2kKT7nmilqO0Enc4rubJRG8n,SpATywNh6bZuzm8s1ceuBUnMUAeoAHHw,10,19,0,0,0,0,9,0,28,4.0,2,0.0,0,0,0,0,19,0,0,9,0,0,28,0
2140,85297,4VgoVQWGOr2mBZAQVNzDshzPrpqcYbQA,SpATywNh6bZuzm8s1ceuBUnMUAeoAHHw,4,2,0,0,0,0,2,0,4,0.5714285714285714,1,0.0,0,0,0,0,2,0,0,2,0,0,4,1
2141,85328,VZ5o45Yr5Bm8WANLZeoMpkPB24du6vYe,SpATywNh6bZuzm8s1ceuBUnMUAeoAHHw,1,0,0,0,0,0,1,0,1,0.14285714285714285,1,0.0,0,0,0,0,0,0,0,1,0,0,1,1
2142,85331,RZI7KROUR7i2T6MB71TuoKGbXE5WXiwO,SpATywNh6bZuzm8s1ceuBUnMUAeoAHHw,1,0,0,0,0,0,1,0,1,0.14285714285714285,1,0.0,0,0,0,0,0,0,0,1,0,0,1,1
2143,85337,176ILS8J1NMmZsoc0RxEg8JQJcz6ksLo,SpATywNh6bZuzm8s1ceuBUnMUAeoAHHw,1,0,0,0,0,0,1,0,1,0.14285714285714285,1,0.0,0,0,0,0,0,0,0,1,0,0,1,1
2144,85351,4E7spFhBfl0gEqkMBOstVjR5pQXkTXaF,SpATywNh6bZuzm8s1ceuBUnMUAeoAHHw,1,0,0,0,0,0,1,0,1,0.14285714285714285,1,0.0,0,0,0,0,0,0,0,1,0,0,1,1
2145,85376,tO135VWcqma21HvgPTdpgoHPq5kDsz9m,SpATywNh6bZuzm8s1ceuBUnMUAeoAHHw,4,2,1,0,1,0,2,0,6,0.8571428571428571,1,0.0,0,1,0,1,2,0,0,2,0,2,4,1
2146,85377,tO135VWcqma21HvgPTdpgoHPq5kDsz9m,A3fsA9Zfv1X2fVEQhTw51lKENdNrEqT3,4,2,1,0,1,0,1,0,5,0.7142857142857143,1,0.0,0,1,0,1,2,0,0,1,0,2,3,1
2147,87018,puN480TO3qbGXrXmM5qoOdmstQ51OC6E,A3fsA9Zfv1X2fVEQhTw51lKENdNrEqT3,2,0,0,0,0,1,2,0,3,0.42857142857142855,1,0.0,0,0,0,0,0,1,0,2,0,0,3,0
2148,87057,SWjmkEB4DVctTeY4CrwF2QrGDf4olJAZ,RXDvfPUBYFlVdlueBFbLW0mhhAyGEqpt,49,83,35,73,20,32,11,2,256,36.57142857142857,1,0.0,32,35,67,20,51,32,6,11,2,154,102,0
2149,87127,dNFEIzn0depAU4oAUIlHxTqSNcin3JsM,SpATywNh6bZuzm8s1ceuBUnMUAeoAHHw,15,18,7,17,3,0,2,0,47,6.714285714285714,1,0.0,2,7,16,3,16,0,1,2,0,28,19,0
2150,87281,8fWrC0LYUq5E0gzy0gw2GD73h6o6q5AG,SpATywNh6bZuzm8s1ceuBUnMUAeoAHHw,12,41,2,16,0,1,2,0,62,8.857142857142858,2,0.0,25,2,14,0,16,1,2,2,0,41,21,0
2151,87584,NtOBKvqn4kjpyBFY5EbWAhwnHWFAQxgf,A3fsA9Zfv1X2fVEQhTw51lKENdNrEqT3,2,0,0,0,0,0,2,0,2,0.2857142857142857,1,0.0,0,0,0,0,0,0,0,2,0,0,2,1
2152,87912,j9L0wsMRR1iguKEo2FSLNGEw5WM5csHy,SpATywNh6bZuzm8s1ceuBUnMUAeoAHHw,5,0,0,0,0,3,6,1,10,1.4285714285714286,1,0.0,0,0,0,0,0,3,0,6,1,0,10,0
2153,88213,6mJ65eKOiDJ0B2UMjBjMI3Dy4vxZcYQe,A3fsA9Zfv1X2fVEQhTw51lKENdNrEqT3,14,11,9,0,5,4,1,0,30,4.285714285714286,1,0.0,0,9,0,5,11,4,0,1,0,14,16,0
2154,88216,M8C9BDFICk4ida59GU0jjp556zazDEi1,RXDvfPUBYFlVdlueBFbLW0mhhAyGEqpt,6,6,5,0,1,0,2,0,14,2.0,1,0.0,0,5,0,1,6,0,0,2,0,6,8,1
2155,88378,Re4UOQXOMU2zm8GKuNadx9755IwHNGSX,7GRhBDsirIGkRZBtSMEzNTyDr2JQm4xx,2,0,0,0,0,0,4,0,4,0.5714285714285714,1,0.0,0,0,0,0,0,0,0,4,0,0,4,1
2156,88379,uXRfDeihF0hkAkJm7sgGsGBDRqSDq177,7GRhBDsirIGkRZBtSMEzNTyDr2JQm4xx,9,15,6,0,3,1,5,0,30,4.285714285714286,1,0.0,1,6,0,3,14,1,0,5,0,10,20,1
2157,88421,QOc3KAKkR4oB1aPHWnnoHskpc1gxhWoJ,7GRhBDsirIGkRZBtSMEzNTyDr2JQm4xx,3,2,1,0,0,0,1,0,4,0.5714285714285714,1,0.0,0,1,0,0,2,0,0,1,0,1,3,0
2158,88481,N2FuIOQxHi4oGMJNbbYINfgS8eLaVkEY,7GRhBDsirIGkRZBtSMEzNTyDr2JQm4xx,2,0,0,0,0,0,2,0,2,0.2857142857142857,1,0.0,0,0,0,0,0,0,0,2,0,0,2,1
2159,88527,VwAQN5jl3pwsYKyGQTMhCoHGJ3YHi87f,7GRhBDsirIGkRZBtSMEzNTyDr2JQm4xx,2,0,0,0,0,0,2,0,2,0.2857142857142857,1,0.0,0,0,0,0,0,0,0,2,0,0,2,1
2160,88536,8gfCGxZ6lFjZr89RwPF8oXZs1Qn6Pq6X,7GRhBDsirIGkRZBtSMEzNTyDr2JQm4xx,5,1,1,0,0,0,4,0,6,0.8571428571428571,1,0.0,0,1,0,0,1,0,0,4,0,1,5,1
2161,88562,LLVsvExZGFAkPOPauc0mDK88Em0n3cCC,7GRhBDsirIGkRZBtSMEzNTyDr2JQm4xx,6,8,4,0,0,0,7,0,19,2.7142857142857144,1,0.0,0,4,0,0,8,0,0,7,0,4,15,1
2162,88585,I45Q3yivyiRN2kHVhbV8bUCfrXvtpUvU,7GRhBDsirIGkRZBtSMEzNTyDr2JQm4xx,6,4,2,0,2,0,2,0,10,1.4285714285714286,1,0.0,0,2,0,2,4,0,0,2,0,4,6,1
2163,88625,tWlnNsUcyPPaUr4wTjyNOcGM9Bihy4wT,7GRhBDsirIGkRZBtSMEzNTyDr2JQm4xx,1,0,0,0,0,0,1,0,1,0.14285714285714285,1,0.0,0,0,0,0,0,0,0,1,0,0,1,1
2164,88656,dehhpoRrM4rg7t676Y7qCiumWRV2WOzS,7GRhBDsirIGkRZBtSMEzNTyDr2JQm4xx,32,42,18,79,13,12,2,0,166,23.714285714285715,1,0.0,22,18,76,13,20,12,3,2,0,129,37,1
2165,88812,PeUQJJiLjuIkI3TtwdkKlVprakOI9tf7,fbPkOYLVPtPgIt0MxizjfFJov3JbHyAi,5,3,2,0,1,6,1,0,13,1.8571428571428572,1,0.0,0,2,0,1,3,6,0,1,0,3,10,1
2166,88829,Wz7BSBOI9rzgAwf2xVcld90BewMcWv25,fbPkOYLVPtPgIt0MxizjfFJov3JbHyAi,2,0,0,0,0,0,2,0,2,0.2857142857142857,1,0.0,0,0,0,0,0,0,0,2,0,0,2,1
2167,88849,LSAqQ9qRJ6IA5mDIPLRj3aw5O17rNapz,fbPkOYLVPtPgIt0MxizjfFJov3JbHyAi,4,3,1,0,0,0,1,0,5,0.7142857142857143,1,0.0,0,1,0,0,3,0,0,1,0,1,4,1
2168,89411,xSMp0r4oxogHBl1WzBSO421fVgDtvwXN,SpATywNh6bZuzm8s1ceuBUnMUAeoAHHw,3,2,1,0,0,0,1,0,4,0.5714285714285714,1,0.0,0,1,0,0,2,0,0,1,0,1,3,1
2169,89458,iIWDWKAN8CRJ0yZ5zDSccFCRQRwFgxP8,SpATywNh6bZuzm8s1ceuBUnMUAeoAHHw,5,7,2,0,0,0,0,0,9,1.2857142857142858,2,0.0,0,2,0,0,7,0,0,0,0,2,7,1
2170,89462,bX1EJ8H8O7LvPaK2JoRVQC0BaLpmhHE6,SpATywNh6bZuzm8s1ceuBUnMUAeoAHHw,5,2,0,0,0,2,3,1,8,1.1428571428571428,1,0.0,0,0,0,0,2,2,0,3,1,0,8,0
2171,89540,rHj6Vmp3P9JbmX7QWrSBu45DuiDb8koF,SpATywNh6bZuzm8s1ceuBUnMUAeoAHHw,6,5,0,0,0,1,3,0,9,1.2857142857142858,1,0.0,0,0,0,0,5,1,0,3,0,0,9,1
2172,89560,fUNdgzfWSE4HzsYQQ7FDu5pyDUIMQ40m,G8EPVSXsOYB5YQWZGiz1aVq5Pgr2GrQu,13,15,4,12,3,0,1,0,35,5.0,1,0.0,7,4,7,3,8,0,5,1,0,21,14,1
2173,89584,oiThQK6e6zf4TZYBDNHB9rtiG2PNPeXO,SpATywNh6bZuzm8s1ceuBUnMUAeoAHHw,5,4,2,0,0,0,1,0,7,1.0,1,0.0,0,2,0,0,4,0,0,1,0,2,5,1
2174,89625,LUfJKoRDjcYKUaxb5bwr7doPqmv3K3xe,SpATywNh6bZuzm8s1ceuBUnMUAeoAHHw,19,20,11,18,5,0,4,0,58,8.285714285714286,2,0.0,7,11,15,5,13,0,3,4,0,38,20,1
2175,89662,g8m22R7W0Wo8v9RXY0TMbj5qf5RFgvht,bWdj2GDclj5ofokWjzoa5jAwMkxCykd6,3,2,1,0,0,0,2,0,5,0.7142857142857143,1,0.0,0,1,0,0,2,0,0,2,0,1,4,1
2176,89891,MrptC6k13DRD7ZeJDHvlsVV8mT19fxZF,SpATywNh6bZuzm8s1ceuBUnMUAeoAHHw,19,20,4,14,4,2,10,3,57,8.142857142857142,1,0.0,8,4,12,4,12,2,2,10,3,28,29,1
2177,90007,LSvU72CFq1TrHd9SCZOiKQ0qcV2oa2Ok,bWdj2GDclj5ofokWjzoa5jAwMkxCykd6,5,5,0,0,0,0,2,0,7,1.0,1,0.0,0,0,0,0,5,0,0,2,0,0,7,1
2178,90031,4dfnEKxHCmGabkBCiKHt5nKr3H7Bwo1x,SpATywNh6bZuzm8s1ceuBUnMUAeoAHHw,5,10,5,0,0,0,2,0,17,2.4285714285714284,1,0.0,3,5,0,0,7,0,0,2,0,8,9,0
2179,90116,T7izEMyckZ14Dpb0HXCCbCEgRCtemG2v,RXDvfPUBYFlVdlueBFbLW0mhhAyGEqpt,12,14,1,0,0,12,3,0,30,4.285714285714286,2,0.0,0,1,0,0,14,12,0,3,0,1,29,1
2180,90126,Q1m0mfQJyZWS3bGl8oxr6Sp3MEPl2r6y,RXDvfPUBYFlVdlueBFbLW0mhhAyGEqpt,8,4,3,0,1,0,3,0,11,1.5714285714285714,1,0.0,0,3,0,1,4,0,0,3,0,4,7,1
2181,90144,clUDzV1xLWOCz6yJz1NXsCWqgZVFuU6d,SpATywNh6bZuzm8s1ceuBUnMUAeoAHHw,13,8,7,0,5,0,1,0,21,3.0,1,0.0,0,7,0,5,8,0,0,1,0,12,9,0
2182,90145,vFTyJ5TiVtOMNTDle7WFtHDAgvur1Shs,RXDvfPUBYFlVdlueBFbLW0mhhAyGEqpt,28,47,34,32,16,1,9,0,139,19.857142857142858,4,0.0,6,34,30,16,41,1,2,9,0,86,53,1
2183,90159,uhbUne0Zqx7l0LKNWrxxR44WistJmxKI,G8EPVSXsOYB5YQWZGiz1aVq5Pgr2GrQu,1,0,0,0,0,0,1,0,1,0.14285714285714285,1,0.0,0,0,0,0,0,0,0,1,0,0,1,1
2184,90163,oSabIe7L5topw6hwV4H4ZV0Ug7ZVNxfV,SpATywNh6bZuzm8s1ceuBUnMUAeoAHHw,5,10,0,0,0,0,3,0,13,1.8571428571428572,1,0.0,2,0,0,0,8,0,0,3,0,2,11,0
2185,90370,1cbn6mbdbvkgaRHmtNkyztYkaJcKUMeq,bWdj2GDclj5ofokWjzoa5jAwMkxCykd6,7,5,1,0,2,0,5,0,13,1.8571428571428572,1,0.0,3,1,0,2,2,0,0,5,0,6,7,0
2186,90384,HOZheAyAGMSpb5Rm4jAeFCDd0CkpsnTU,SpATywNh6bZuzm8s1ceuBUnMUAeoAHHw,4,6,0,0,0,5,1,0,12,1.7142857142857142,1,0.0,1,0,0,0,5,5,0,1,0,1,11,1
2187,90654,bA5X6ch4ADNfhanzi2mM69bwbihODbQ4,G8EPVSXsOYB5YQWZGiz1aVq5Pgr2GrQu,25,11,6,80,1,0,5,1,104,14.857142857142858,1,0.0,3,6,70,1,8,0,10,5,1,80,24,0
2188,90688,j8vYdYwa9gvt7hkF8dykZR2D4h75QsII,RXDvfPUBYFlVdlueBFbLW0mhhAyGEqpt,13,12,9,0,4,3,3,0,31,4.428571428571429,1,0.0,0,9,0,4,12,3,0,3,0,13,18,1
2189,90783,bpxaFadaQixJuWRVtAAq5miKiBM3zC6u,RXDvfPUBYFlVdlueBFbLW0mhhAyGEqpt,1,0,0,0,0,0,1,0,1,0.14285714285714285,1,0.0,0,0,0,0,0,0,0,1,0,0,1,1
2190,90829,r1uzabdEU8Xrw9e89SInzZPTwxnUupS6,SpATywNh6bZuzm8s1ceuBUnMUAeoAHHw,10,7,5,0,3,1,8,0,24,3.4285714285714284,1,0.0,0,5,0,3,7,1,0,8,0,8,16,1
2191,90917,nazeZS8BdRMOGGuVriyb5M21Pn5Qng36,bWdj2GDclj5ofokWjzoa5jAwMkxCykd6,3,3,2,0,0,0,3,0,8,1.1428571428571428,1,0.0,0,2,0,0,3,0,0,3,0,2,6,1
2192,90972,zZsHSLX7Hk1sqhZYCfBgGlYJnqetGIKf,RXDvfPUBYFlVdlueBFbLW0mhhAyGEqpt,5,3,1,0,1,0,1,0,6,0.8571428571428571,1,0.0,0,1,0,1,3,0,0,1,0,2,4,1
2193,91056,Iji9dmQW7A2gOcEtvLASbynNxhfIM21F,bWdj2GDclj5ofokWjzoa5jAwMkxCykd6,4,3,1,0,0,0,1,0,5,0.7142857142857143,1,0.0,0,1,0,0,3,0,0,1,0,1,4,1
2194,91092,mXfwwTIVjHMqoVKAh2iEQbinKUCJHwTp,SpATywNh6bZuzm8s1ceuBUnMUAeoAHHw,4,4,2,0,0,0,3,0,9,1.2857142857142858,1,0.0,0,2,0,0,4,0,0,3,0,2,7,1
2195,91113,LDDV5GLR4T4AoJ4swm7PTuKciMVwXQ01,G8EPVSXsOYB5YQWZGiz1aVq5Pgr2GrQu,14,21,1,4,2,5,9,0,42,6.0,2,0.0,8,1,4,2,13,5,0,9,0,15,27,0
2196,91383,BcJnhjzA1hw0WNze9uWUZQ49uBAiBHyH,SpATywNh6bZuzm8s1ceuBUnMUAeoAHHw,8,6,1,6,1,0,1,0,15,2.142857142857143,1,0.0,2,1,6,1,4,0,0,1,0,10,5,0
2197,91414,HSyljcmKCDSksgg7xJb6gUib0wBvYjVv,G8EPVSXsOYB5YQWZGiz1aVq5Pgr2GrQu,3,2,1,0,0,0,1,0,4,0.5714285714285714,1,0.0,0,1,0,0,2,0,0,1,0,1,3,1
2198,91574,Utp3WJ8WUPD5DMyG8PNbE11goCMql2Z7,SpATywNh6bZuzm8s1ceuBUnMUAeoAHHw,7,3,2,0,2,0,2,0,9,1.2857142857142858,1,0.0,0,2,0,2,3,0,0,2,0,4,5,1
2199,92858,PO9UqxqUlWjKdLcKUuvXjpBUsCJBV13h,SpATywNh6bZuzm8s1ceuBUnMUAeoAHHw,5,3,2,0,1,0,1,0,7,1.0,1,0.0,0,2,0,1,3,0,0,1,0,3,4,0
2200,92869,1WP7C2GzJDZRslYYccdoHTPh8lrMzeDB,G8EPVSXsOYB5YQWZGiz1aVq5Pgr2GrQu,19,12,9,16,6,2,5,1,51,7.285714285714286,1,0.0,1,9,16,6,11,2,0,5,1,32,19,1
2201,92883,TY1XSpzUxZYHUqU0tQYtstvuwKCsGYpR,G8EPVSXsOYB5YQWZGiz1aVq5Pgr2GrQu,5,4,2,0,0,20,4,0,30,4.285714285714286,2,0.0,0,2,0,0,4,20,0,4,0,2,28,1
2202,92929,0Rhh8KlMvGRxFbePsrW63o0GE8JJ4ZBr,bWdj2GDclj5ofokWjzoa5jAwMkxCykd6,3,0,0,0,0,0,3,0,3,0.42857142857142855,1,0.0,0,0,0,0,0,0,0,3,0,0,3,1
2203,92943,9HqwJ8d4m6K7QOSGhF3dVzXYAYpOl0vj,RXDvfPUBYFlVdlueBFbLW0mhhAyGEqpt,11,10,5,0,4,0,1,0,20,2.857142857142857,1,0.0,0,5,0,4,10,0,0,1,0,9,11,1
2204,93008,OdMr7dE5UlAme9Tp979vREBvY5CV50po,SpATywNh6bZuzm8s1ceuBUnMUAeoAHHw,16,13,7,12,4,0,1,0,37,5.285714285714286,1,0.0,3,7,10,4,10,0,2,1,0,24,13,0
2205,93031,4ihKyViABUcTrutAyMvzpqSavA9xsDnC,SpATywNh6bZuzm8s1ceuBUnMUAeoAHHw,7,5,4,0,3,0,1,0,13,1.8571428571428572,1,0.0,0,4,0,3,5,0,0,1,0,7,6,1
2206,93243,IsU1RKSKxT8SmvRzyXcC6emxRwMddmTJ,G8EPVSXsOYB5YQWZGiz1aVq5Pgr2GrQu,31,17,16,0,15,0,0,0,48,6.857142857142857,1,0.0,0,16,0,15,17,0,0,0,0,31,17,0
2207,93334,KFG6G55toGAeaWBt5UmyioW5n1NVxSjT,bWdj2GDclj5ofokWjzoa5jAwMkxCykd6,13,28,18,13,6,0,10,0,75,10.714285714285714,4,0.0,3,18,12,6,25,0,1,10,0,39,36,0
2208,93406,wCSstPXY2jshjpNaBAQvMm9l3Kvl06VT,bWdj2GDclj5ofokWjzoa5jAwMkxCykd6,9,43,8,0,1,0,17,0,69,9.857142857142858,4,0.0,0,8,0,1,43,0,0,17,0,9,60,1
2209,93430,ThGblU6q4nWmu3ORXgM7eQc8q9vcBP4r,bWdj2GDclj5ofokWjzoa5jAwMkxCykd6,10,27,5,16,3,24,19,0,94,13.428571428571429,5,0.0,2,5,15,3,25,24,1,19,0,25,69,1
2210,93539,hZR4MwcYec4g0GoOyJFngJGEyWOySpv2,SpATywNh6bZuzm8s1ceuBUnMUAeoAHHw,11,6,5,0,3,2,4,0,20,2.857142857142857,1,0.0,0,5,0,3,6,2,0,4,0,8,12,0
2211,93541,ThGblU6q4nWmu3ORXgM7eQc8q9vcBP4r,SpATywNh6bZuzm8s1ceuBUnMUAeoAHHw,21,53,17,12,6,77,30,1,196,28.0,5,0.0,8,17,11,6,45,77,1,30,1,42,154,1
2212,93679,ju4nY4FL2KNi1hifJCQn8sVUqJICxh4O,SpATywNh6bZuzm8s1ceuBUnMUAeoAHHw,11,11,4,16,1,0,3,0,35,5.0,1,0.0,2,4,13,1,9,0,3,3,0,20,15,1
2213,93689,KXi2lu4GlKmrO1lJTLg3t4l701rvNXNZ,A3fsA9Zfv1X2fVEQhTw51lKENdNrEqT3,29,10,6,58,4,0,4,0,82,11.714285714285714,2,0.0,3,6,51,4,7,0,7,4,0,64,18,0
2214,93753,fCj90D5XHmebJ0IrbbuHaVfcb7tqMxkl,bWdj2GDclj5ofokWjzoa5jAwMkxCykd6,19,53,20,18,8,0,3,0,102,14.571428571428571,3,0.0,11,20,17,8,42,0,1,3,0,56,46,1
2215,94322,7CHeHg2oDOu9Zq2LKINtBF6E413tCv88,SpATywNh6bZuzm8s1ceuBUnMUAeoAHHw,8,6,2,0,2,0,4,0,14,2.0,1,0.0,0,2,0,2,6,0,0,4,0,4,10,1
2216,94358,9aS1NSJb2Hj0xHbbuoyhLmktYrjypxsy,G8EPVSXsOYB5YQWZGiz1aVq5Pgr2GrQu,35,31,12,96,7,0,2,0,148,21.142857142857142,1,0.0,18,12,70,7,13,0,26,2,0,107,41,1
2217,94407,vCP75aDcEh5tNmLpxZodjHI02YfPV1g7,SpATywNh6bZuzm8s1ceuBUnMUAeoAHHw,1,0,0,0,0,0,1,0,1,0.14285714285714285,1,0.0,0,0,0,0,0,0,0,1,0,0,1,1
2218,94408,kdTkyJM1xm4AQ2tXVSlZpNtOhQ8qhZ4V,SpATywNh6bZuzm8s1ceuBUnMUAeoAHHw,3,2,1,0,0,0,1,0,4,0.5714285714285714,1,0.0,0,1,0,0,2,0,0,1,0,1,3,0
2219,94443,FZWt1vapJFvo3kXFvlr3Pcq5dqSsXIdl,SpATywNh6bZuzm8s1ceuBUnMUAeoAHHw,27,30,18,31,7,8,5,4,103,14.714285714285714,1,0.0,9,18,28,7,21,8,3,5,4,62,41,1
2220,94486,gl2YVlebVAvCcxsYaIoTwLj5l1IGqntH,SpATywNh6bZuzm8s1ceuBUnMUAeoAHHw,7,10,5,0,0,0,1,0,16,2.2857142857142856,1,0.0,4,5,0,0,6,0,0,1,0,9,7,0
2221,95305,NzceHZYafdRYNlSM9Nht2IC1aPdIvfsS,G8EPVSXsOYB5YQWZGiz1aVq5Pgr2GrQu,7,6,4,2,0,0,1,0,13,1.8571428571428572,1,0.0,1,4,1,0,5,0,1,1,0,6,7,1
2222,95313,qosnWICleDjB0mAqFG1weKjFjwPkMIbX,SpATywNh6bZuzm8s1ceuBUnMUAeoAHHw,12,9,7,0,4,0,4,0,24,3.4285714285714284,1,0.0,0,7,0,4,9,0,0,4,0,11,13,1
2223,95361,Djs1zlGGz9CjaytXVMiGNIbCd4ODEdqG,A3fsA9Zfv1X2fVEQhTw51lKENdNrEqT3,3,0,0,0,0,0,3,0,3,0.42857142857142855,1,0.0,0,0,0,0,0,0,0,3,0,0,3,1
2224,95383,ZHBg1MltX3XrB2nTtco0amjezusVv1FZ,bWdj2GDclj5ofokWjzoa5jAwMkxCykd6,4,3,1,0,1,0,1,0,6,0.8571428571428571,1,0.0,0,1,0,1,3,0,0,1,0,2,4,1
2225,95384,9vMfKHFzhvmzdCBc05dqw5icnEdTUd5x,bWdj2GDclj5ofokWjzoa5jAwMkxCykd6,36,58,27,69,8,0,8,0,170,24.285714285714285,3,0.0,9,27,62,8,49,0,7,8,0,106,64,1
2226,95386,lVwgv61cg8fkhW9rg5b1PIPnuUWxb0Vk,A3fsA9Zfv1X2fVEQhTw51lKENdNrEqT3,12,7,5,0,3,50,14,1,80,11.428571428571429,4,0.0,0,5,0,3,7,50,0,14,1,8,72,0
2227,95388,WVU6lNV4yCEYBx8BfYMKeJgO2PfYQmk7,bWdj2GDclj5ofokWjzoa5jAwMkxCykd6,25,13,0,40,0,0,6,1,60,8.571428571428571,1,0.0,7,0,37,0,6,0,3,6,1,44,16,1
2228,95397,aFMNRUeRxFSXjv2yTdRuJu4lTCyXCFDD,bWdj2GDclj5ofokWjzoa5jAwMkxCykd6,4,2,1,0,1,1,3,0,8,1.1428571428571428,1,0.0,0,1,0,1,2,1,0,3,0,2,6,1
2229,95398,SM6SmE3aMr36NQr3MbQQW1aFlehpkSNf,bWdj2GDclj5ofokWjzoa5jAwMkxCykd6,1,0,0,0,0,0,1,0,1,0.14285714285714285,1,0.0,0,0,0,0,0,0,0,1,0,0,1,1
2230,95399,Id4UmIRRQiLXHoJYSjh5OCO1CRaFgQ2K,A3fsA9Zfv1X2fVEQhTw51lKENdNrEqT3,41,43,20,76,17,2,4,0,162,23.142857142857142,1,0.0,1,20,59,17,42,2,17,4,0,97,65,1
2231,95408,OdsEBh425XZxll0hTUv04OAotDf6aGtE,RXDvfPUBYFlVdlueBFbLW0mhhAyGEqpt,7,13,7,0,3,0,1,0,24,3.4285714285714284,1,0.0,0,7,0,3,13,0,0,1,0,10,14,1
2232,95425,79rw5BhFSnhvdIaVsXl3jeEXJRviIjGz,A3fsA9Zfv1X2fVEQhTw51lKENdNrEqT3,30,11,9,78,3,0,4,0,105,15.0,1,0.0,1,9,67,3,10,0,11,4,0,80,25,0
2233,95427,GdhgDlZa5ZJ9AzwBGC942HC991fsxvHr,G8EPVSXsOYB5YQWZGiz1aVq5Pgr2GrQu,18,19,2,16,2,0,9,6,54,7.714285714285714,1,0.0,0,2,13,2,19,0,3,9,6,17,37,1
2234,95440,NT7bBO2hHEg05ci9UTFOwIHaUZMIdh9x,SpATywNh6bZuzm8s1ceuBUnMUAeoAHHw,14,13,6,18,2,2,4,2,47,6.714285714285714,2,0.0,3,6,15,2,10,2,3,4,2,26,21,1
2235,95461,M507IlBQp64NkSWnSkchjsahApLaE1kJ,A3fsA9Zfv1X2fVEQhTw51lKENdNrEqT3,50,45,33,80,19,7,18,1,203,29.0,2,0.0,3,33,61,19,42,7,19,18,1,116,87,1
2236,95472,Dsiw0jpMBHHLbjdF7l3UeGKLOlfgXUpd,SpATywNh6bZuzm8s1ceuBUnMUAeoAHHw,29,25,15,31,7,1,5,0,84,12.0,1,0.0,5,15,28,7,20,1,3,5,0,55,29,1
2237,95490,pJLSeQHIu4aZZbYoyPq22AsdfE0vwv53,bWdj2GDclj5ofokWjzoa5jAwMkxCykd6,2,0,0,0,0,0,2,0,2,0.2857142857142857,1,0.0,0,0,0,0,0,0,0,2,0,0,2,0
2238,95493,N0D8gfv74t8uM2LFiOg2xy8nVL0vO7Kx,SpATywNh6bZuzm8s1ceuBUnMUAeoAHHw,7,3,2,0,2,0,2,0,9,1.2857142857142858,1,0.0,0,2,0,2,3,0,0,2,0,4,5,1
2239,95507,YLfjSoU2JNGG7f9SEbr83b8mp8z1n7i3,A3fsA9Zfv1X2fVEQhTw51lKENdNrEqT3,1,0,0,0,0,0,1,0,1,0.14285714285714285,1,0.0,0,0,0,0,0,0,0,1,0,0,1,1
2240,95517,WzkRGtR4EenxksGL0ftvaO4vHssxZDFt,A3fsA9Zfv1X2fVEQhTw51lKENdNrEqT3,3,0,0,0,0,0,3,0,3,0.42857142857142855,1,0.0,0,0,0,0,0,0,0,3,0,0,3,1
2241,95521,OF90Hu2g8vPUjKHCP4ULPYNMvRFKxBj6,SpATywNh6bZuzm8s1ceuBUnMUAeoAHHw,20,13,9,17,5,5,4,1,54,7.714285714285714,1,0.0,2,9,14,5,11,5,3,4,1,30,24,0
2242,95561,BILNjgDM4z6ewRYZ6qt3YLHpB6O5FFua,SpATywNh6bZuzm8s1ceuBUnMUAeoAHHw,7,4,3,0,3,0,2,0,12,1.7142857142857142,1,0.0,0,3,0,3,4,0,0,2,0,6,6,1
2243,95583,YaP2AuckukEZITP3IVvIt6Z8ci6RHew7,bWdj2GDclj5ofokWjzoa5jAwMkxCykd6,9,5,4,0,2,0,2,0,13,1.8571428571428572,1,0.0,0,4,0,2,5,0,0,2,0,6,7,1
2244,95588,DxGyu8XXv7e8wbVx0mvEABKcoqoolLlv,bWdj2GDclj5ofokWjzoa5jAwMkxCykd6,4,0,0,0,0,0,11,0,11,1.5714285714285714,1,0.0,0,0,0,0,0,0,0,11,0,0,11,1
2245,95590,XfiCSk5eLAbq9rzQtnLkX2OQTd6M8xFG,A3fsA9Zfv1X2fVEQhTw51lKENdNrEqT3,1,0,0,0,0,0,1,0,1,0.14285714285714285,1,0.0,0,0,0,0,0,0,0,1,0,0,1,1
2246,95593,DHUv7XpIZcPp2QYGNmTXjhgg7Zq4BpJ7,A3fsA9Zfv1X2fVEQhTw51lKENdNrEqT3,18,10,8,12,6,0,2,0,38,5.428571428571429,2,0.0,0,8,10,6,10,0,2,2,0,24,14,1
2247,95595,ZBEHpTfGoLiomhe8zt7rkm2uZVd9b9kk,SpATywNh6bZuzm8s1ceuBUnMUAeoAHHw,5,7,0,0,1,0,1,0,9,1.2857142857142858,1,0.0,0,0,0,1,7,0,0,1,0,1,8,1
2248,95605,UaSh8dwx8gnofYbXlmpqj9uYDbpJ89pX,A3fsA9Zfv1X2fVEQhTw51lKENdNrEqT3,4,2,0,0,0,9,3,0,14,2.0,2,0.0,0,0,0,0,2,9,0,3,0,0,14,1
2249,95617,Daw06K1PSOXldo19kBgHP5sewulb7Vu5,A3fsA9Zfv1X2fVEQhTw51lKENdNrEqT3,1,0,0,0,0,0,1,0,1,0.14285714285714285,1,0.0,0,0,0,0,0,0,0,1,0,0,1,0
2250,95620,Daw06K1PSOXldo19kBgHP5sewulb7Vu5,G8EPVSXsOYB5YQWZGiz1aVq5Pgr2GrQu,1,0,0,0,0,0,1,0,1,0.14285714285714285,1,0.0,0,0,0,0,0,0,0,1,0,0,1,1
2251,95622,DGrwRqi3z3Y9GhMsPFPJjWU0FULJtTwp,A3fsA9Zfv1X2fVEQhTw51lKENdNrEqT3,5,0,0,0,0,0,5,1,6,0.8571428571428571,2,0.0,0,0,0,0,0,0,0,5,1,0,6,1
2252,95624,YLJN09Je7GNR4wBomW2iH8q4HAK5TPdc,RXDvfPUBYFlVdlueBFbLW0mhhAyGEqpt,29,29,8,20,6,23,5,0,91,13.0,1,0.0,3,8,20,6,26,23,0,5,0,37,54,1
2253,95627,fxfoo3EegutxQePINTymJFzExTdNcKVI,SpATywNh6bZuzm8s1ceuBUnMUAeoAHHw,17,12,5,12,4,0,7,0,40,5.714285714285714,2,0.0,2,5,11,4,10,0,1,7,0,22,18,1
2254,95631,cW2QGOVqGX1ONxdDTXMiDqmocWqOnU5N,A3fsA9Zfv1X2fVEQhTw51lKENdNrEqT3,4,3,1,0,0,0,2,0,6,0.8571428571428571,1,0.0,0,1,0,0,3,0,0,2,0,1,5,1
2255,95633,ZtofBugo33Zo9FroLN9tXtgl9O0zgDWY,SpATywNh6bZuzm8s1ceuBUnMUAeoAHHw,20,18,6,27,2,0,2,0,55,7.857142857142857,2,0.0,4,6,24,2,14,0,3,2,0,36,19,0
2256,95646,kHWuc10C4T4imgPGXw1iL9DdxxMDyloj,RXDvfPUBYFlVdlueBFbLW0mhhAyGEqpt,1,0,0,0,0,0,1,0,1,0.14285714285714285,1,0.0,0,0,0,0,0,0,0,1,0,0,1,1
2257,95653,fn3RgMp4JCABnOK3IDXz6cUAXpmeuiYQ,G8EPVSXsOYB5YQWZGiz1aVq5Pgr2GrQu,9,6,3,0,4,0,2,0,15,2.142857142857143,1,0.0,2,3,0,4,4,0,0,2,0,9,6,1
2258,95659,y8wihgxEdHfGcxMV16au6pgiPnSQwx23,RXDvfPUBYFlVdlueBFbLW0mhhAyGEqpt,7,1,1,0,1,0,6,0,9,1.2857142857142858,1,0.0,0,1,0,1,1,0,0,6,0,2,7,1
2259,95662,4NPDuZC5Eo397A2ZzeMAm6BBPfedAt7V,SpATywNh6bZuzm8s1ceuBUnMUAeoAHHw,9,3,2,0,2,0,9,2,18,2.5714285714285716,1,0.0,0,2,0,2,3,0,0,9,2,4,14,1
2260,95669,k24Ps3wdaeoSwT1eSTFmxgPUJ0moWYPO,SpATywNh6bZuzm8s1ceuBUnMUAeoAHHw,6,4,1,0,1,0,3,0,9,1.2857142857142858,1,0.0,0,1,0,1,4,0,0,3,0,2,7,1
2261,95684,Nsz2zYB7CSRbOtMFEx5HNBJ0rxH2o1F7,A3fsA9Zfv1X2fVEQhTw51lKENdNrEqT3,4,0,0,0,0,0,8,0,8,1.1428571428571428,1,0.0,0,0,0,0,0,0,0,8,0,0,8,1
2262,95690,4NPDuZC5Eo397A2ZzeMAm6BBPfedAt7V,G8EPVSXsOYB5YQWZGiz1aVq5Pgr2GrQu,1,0,0,0,0,0,1,0,1,0.14285714285714285,1,0.0,0,0,0,0,0,0,0,1,0,0,1,1
2263,95694,m1Erwr4qiZRddhtJBwtwyQxEqeaRgIgi,SpATywNh6bZuzm8s1ceuBUnMUAeoAHHw,7,3,1,0,1,0,3,1,9,1.2857142857142858,1,0.0,0,1,0,1,3,0,0,3,1,2,7,1
2264,95699,zPbUIdTRPjnN9GVjy7Vs8SVwjdhRAaUM,SpATywNh6bZuzm8s1ceuBUnMUAeoAHHw,4,3,1,0,1,0,2,0,7,1.0,1,0.0,0,1,0,1,3,0,0,2,0,2,5,1
2265,95726,9yvWwncWvyjvEU2gkB98t6ra5ZlqpOOe,SpATywNh6bZuzm8s1ceuBUnMUAeoAHHw,30,29,14,16,7,0,8,1,75,10.714285714285714,1,0.0,6,14,15,7,23,0,1,8,1,42,33,1
2266,95737,CLsYy7g1hYWHJyj1aROfKK9oTeo5yxJx,bWdj2GDclj5ofokWjzoa5jAwMkxCykd6,1,0,0,0,0,0,1,0,1,0.14285714285714285,1,0.0,0,0,0,0,0,0,0,1,0,0,1,1
2267,95744,FXy6zIwT4trAO2Fwnqm3Ehrt0HqoYcIs,SpATywNh6bZuzm8s1ceuBUnMUAeoAHHw,6,5,1,0,1,0,2,0,9,1.2857142857142858,1,0.0,0,1,0,1,5,0,0,2,0,2,7,1
2268,95751,nMyFoPqXKsdnuE6mgxy1XpE5LPKy9GOa,G8EPVSXsOYB5YQWZGiz1aVq5Pgr2GrQu,1,0,0,0,0,0,1,0,1,0.14285714285714285,1,0.0,0,0,0,0,0,0,0,1,0,0,1,1
2269,95768,tKaMjS6KWA4OmqzSfTJZDMyzIRtISbIo,SpATywNh6bZuzm8s1ceuBUnMUAeoAHHw,1,0,0,0,0,0,1,0,1,0.14285714285714285,1,0.0,0,0,0,0,0,0,0,1,0,0,1,0
2270,95785,1SCPwRp6zs8beWzgpgsNRS1NXyUeSOy8,bWdj2GDclj5ofokWjzoa5jAwMkxCykd6,8,13,5,58,2,9,3,0,90,12.857142857142858,1,0.0,5,5,56,2,8,9,2,3,0,68,22,1
2271,95809,gMeKwVdV7xHR9zrsQTTuP5xOz4aKMsCh,RXDvfPUBYFlVdlueBFbLW0mhhAyGEqpt,10,4,4,0,2,0,4,0,14,2.0,1,0.0,0,4,0,2,4,0,0,4,0,6,8,1
2272,95814,pK3w2ljSu5UCiWTsVPCK8fUfSVn5X9S6,SpATywNh6bZuzm8s1ceuBUnMUAeoAHHw,28,43,21,23,13,0,5,0,105,15.0,1,0.0,13,21,23,13,30,0,0,5,0,70,35,1
2273,95815,forPgRyluFqH5fyMZfnKJctNYjPII95b,A3fsA9Zfv1X2fVEQhTw51lKENdNrEqT3,15,5,1,30,0,0,3,0,39,5.571428571428571,1,0.0,0,1,27,0,5,0,3,3,0,28,11,1
2274,95850,NvdQzMD14NnCAS0YAW6YP4m31ATjV5UA,SpATywNh6bZuzm8s1ceuBUnMUAeoAHHw,12,12,6,0,8,1,2,0,29,4.142857142857143,1,0.0,0,6,0,8,12,1,0,2,0,14,15,1
2275,95852,nB9RnfPmq1WfPeBn5EUZt5ffKcXJEdE4,A3fsA9Zfv1X2fVEQhTw51lKENdNrEqT3,1,0,0,0,0,0,2,0,2,0.2857142857142857,1,0.0,0,0,0,0,0,0,0,2,0,0,2,1
2276,95860,JcocKAtlN5pNw3B6wmg6BZFKdvxcJRHw,bWdj2GDclj5ofokWjzoa5jAwMkxCykd6,14,16,8,36,7,0,2,0,69,9.857142857142858,1,0.0,5,8,29,7,11,0,7,2,0,49,20,1
2277,95880,XNJvqr2ia2XRTEmLeguLZckH2aLyvBMM,SpATywNh6bZuzm8s1ceuBUnMUAeoAHHw,6,6,3,0,0,0,3,0,12,1.7142857142857142,2,0.0,0,3,0,0,6,0,0,3,0,3,9,1
2278,95899,qwWysWdLmrwh0JmjPYNGVFqdat8Jy8Lb,bWdj2GDclj5ofokWjzoa5jAwMkxCykd6,7,9,2,0,2,0,7,0,20,2.857142857142857,2,0.0,2,2,0,2,7,0,0,7,0,6,14,0
2279,95901,jzWvwaTexkgbyBrPkQbXDb98Viqx6cSS,A3fsA9Zfv1X2fVEQhTw51lKENdNrEqT3,23,4,2,66,0,0,2,0,74,10.571428571428571,1,0.0,1,2,56,0,3,0,10,2,0,59,15,1
2280,95908,b80Lkn7xNHauWWmN3QIwsLauRSXsSHrY,SpATywNh6bZuzm8s1ceuBUnMUAeoAHHw,6,6,0,0,1,0,2,0,9,1.2857142857142858,1,0.0,2,0,0,1,4,0,0,2,0,3,6,1
2281,95913,m7hBmfvQj5nDU6vEGQuVMa4fkSxlliz4,G8EPVSXsOYB5YQWZGiz1aVq5Pgr2GrQu,4,2,0,0,0,0,2,0,4,0.5714285714285714,1,0.0,0,0,0,0,2,0,0,2,0,0,4,1
2282,95933,pwoJhGEuCXUAzWggYD0Vpr6rlqs95MdC,SpATywNh6bZuzm8s1ceuBUnMUAeoAHHw,6,3,2,0,2,0,1,0,8,1.1428571428571428,1,0.0,0,2,0,2,3,0,0,1,0,4,4,1
2283,95939,q7ixHJ98uI7DV9nBYxjXxbopCkuH6DX6,SpATywNh6bZuzm8s1ceuBUnMUAeoAHHw,3,0,0,0,0,0,3,0,3,0.42857142857142855,1,0.0,0,0,0,0,0,0,0,3,0,0,3,1
2284,95941,5FCCqL18D5yTiqyAg5N299Ugwsv8CI3G,SpATywNh6bZuzm8s1ceuBUnMUAeoAHHw,6,3,1,0,1,0,2,0,7,1.0,1,0.0,0,1,0,1,3,0,0,2,0,2,5,0
2285,95951,Uvg7ZsdO3eZ12twQcai6zLQJvqq6H5qj,G8EPVSXsOYB5YQWZGiz1aVq5Pgr2GrQu,9,5,1,0,1,0,5,0,12,1.7142857142857142,2,0.0,0,1,0,1,5,0,0,5,0,2,10,0
2286,95958,Ar7wri6od2sIMOfx95hPmMwDttR4wtOC,A3fsA9Zfv1X2fVEQhTw51lKENdNrEqT3,30,7,3,56,2,0,6,1,75,10.714285714285714,1,0.0,1,3,49,2,6,0,7,6,1,55,20,0
2287,95978,wfyGhtXQXfiz6Xnx0YIucq6EMEmHdLu2,SpATywNh6bZuzm8s1ceuBUnMUAeoAHHw,1,0,0,0,0,0,1,0,1,0.14285714285714285,1,0.0,0,0,0,0,0,0,0,1,0,0,1,1
2288,95993,pcy81jlx7huLaDPvWWRXTEiJTAUolrbh,A3fsA9Zfv1X2fVEQhTw51lKENdNrEqT3,8,4,3,0,3,0,1,0,11,1.5714285714285714,1,0.0,0,3,0,3,4,0,0,1,0,6,5,1
2289,96003,Hxd16O3nQG6ddXQCBbAu8BGBmmZmiixl,G8EPVSXsOYB5YQWZGiz1aVq5Pgr2GrQu,1,0,0,0,0,0,1,0,1,0.14285714285714285,1,0.0,0,0,0,0,0,0,0,1,0,0,1,1
2290,96011,XtXVGX6xZjaXboxbRFBRNJiE8mlrJ6RY,SpATywNh6bZuzm8s1ceuBUnMUAeoAHHw,1,0,0,0,0,0,2,0,2,0.2857142857142857,1,0.0,0,0,0,0,0,0,0,2,0,0,2,1
2291,96035,NGxVJQppNBMfgJiFwD3Ox6xl5bHm79ig,SpATywNh6bZuzm8s1ceuBUnMUAeoAHHw,7,3,2,0,2,0,2,0,9,1.2857142857142858,1,0.0,0,2,0,2,3,0,0,2,0,4,5,1
2292,96036,zwqhxdboQszkcKvPN5pyN1nGDFR4ub3y,A3fsA9Zfv1X2fVEQhTw51lKENdNrEqT3,6,2,1,0,1,0,4,0,8,1.1428571428571428,1,0.0,0,1,0,1,2,0,0,4,0,2,6,1
2293,96054,G9ja1Sell6i4GCvRpZMszshIwT0u0uoK,SpATywNh6bZuzm8s1ceuBUnMUAeoAHHw,4,3,1,0,1,0,1,0,6,0.8571428571428571,1,0.0,0,1,0,1,3,0,0,1,0,2,4,0
2294,96073,FZWt1vapJFvo3kXFvlr3Pcq5dqSsXIdl,G8EPVSXsOYB5YQWZGiz1aVq5Pgr2GrQu,4,2,0,0,0,0,3,0,5,0.7142857142857143,1,0.0,0,0,0,0,2,0,0,3,0,0,5,1
2295,96099,ps5VcFUapZM31sy4VNJWOTFBzN98932v,RXDvfPUBYFlVdlueBFbLW0mhhAyGEqpt,1,0,0,0,0,0,1,0,1,0.14285714285714285,1,0.0,0,0,0,0,0,0,0,1,0,0,1,0
2296,96116,liXvDig5u9dxIPwxTVIf3BkkLMQ16JFo,SpATywNh6bZuzm8s1ceuBUnMUAeoAHHw,2,0,0,0,0,0,2,0,2,0.2857142857142857,1,0.0,0,0,0,0,0,0,0,2,0,0,2,1
2297,96129,8n73BBd3mvRJq2a0KZ4WJWTYj65s8f61,A3fsA9Zfv1X2fVEQhTw51lKENdNrEqT3,1,0,0,0,0,0,1,0,1,0.14285714285714285,1,0.0,0,0,0,0,0,0,0,1,0,0,1,1
2298,96134,VeFENcSXAiXgJQaSjlXiodtIBxgSrzaH,bWdj2GDclj5ofokWjzoa5jAwMkxCykd6,6,5,0,0,0,0,3,0,8,1.1428571428571428,1,0.0,1,0,0,0,4,0,0,3,0,1,7,0
2299,96732,RHsk3gHUm8VEfb9FwEFf8vBDNKZZ0LWe,A3fsA9Zfv1X2fVEQhTw51lKENdNrEqT3,67,24,19,142,13,0,5,0,203,29.0,1,0.0,2,19,108,13,22,0,34,5,0,142,61,1
2300,97165,YE22fRNdaFtk3nhWfjSOMHWERX5O7Ymi,7GRhBDsirIGkRZBtSMEzNTyDr2JQm4xx,13,17,2,24,1,0,3,0,47,6.714285714285714,1,0.0,9,2,21,1,8,0,3,3,0,33,14,1
2301,97410,TzuMwfaAW66vzYCJbLJUrM2CQWUNVBwC,A3fsA9Zfv1X2fVEQhTw51lKENdNrEqT3,2,0,0,0,0,0,4,0,4,0.5714285714285714,1,0.0,0,0,0,0,0,0,0,4,0,0,4,1
2302,97502,BVpzzXeXh42vyU3wE9rUQpEUs8P1ZpSo,7GRhBDsirIGkRZBtSMEzNTyDr2JQm4xx,32,41,14,96,8,2,11,0,172,24.571428571428573,3,0.0,23,14,88,8,18,2,8,11,0,133,39,1
2303,97701,PlRR5bewxY5s5UPrV9qsB2qkDqRzxPQw,7GRhBDsirIGkRZBtSMEzNTyDr2JQm4xx,15,11,5,19,3,0,1,0,39,5.571428571428571,1,0.0,5,5,16,3,6,0,3,1,0,29,10,1
2304,97805,tPYh43YRHAzuf09xESxSKtWvST0aCsjn,7GRhBDsirIGkRZBtSMEzNTyDr2JQm4xx,8,5,2,18,0,0,2,0,27,3.857142857142857,1,0.0,2,2,17,0,3,0,1,2,0,21,6,1
2305,97840,Ffohn9JNnGJQD2IavzMTS00ubnVtcb2T,A3fsA9Zfv1X2fVEQhTw51lKENdNrEqT3,30,23,13,106,5,0,9,0,156,22.285714285714285,4,0.0,4,13,83,5,19,0,23,9,0,105,51,0
2306,99055,cR6ka5k7tAsfYo9cLOUPkpzWO6OItcGJ,SpATywNh6bZuzm8s1ceuBUnMUAeoAHHw,16,13,9,18,6,2,4,0,52,7.428571428571429,2,0.0,2,9,16,6,11,2,2,4,0,33,19,1
2307,99124,DVOHqEW2vUL1QpZynG6huVjAWwl1vI6M,G8EPVSXsOYB5YQWZGiz1aVq5Pgr2GrQu,4,4,1,0,0,0,2,0,7,1.0,1,0.0,0,1,0,0,4,0,0,2,0,1,6,1
2308,99214,cKCzrCCCXe9nkBgWepq9AEXje7SITRTz,A3fsA9Zfv1X2fVEQhTw51lKENdNrEqT3,1,0,0,0,0,0,1,0,1,0.14285714285714285,1,0.0,0,0,0,0,0,0,0,1,0,0,1,1
2309,99221,wMqCiRTcG9DrOFV3mIQWVG2TWCqZLDsf,G8EPVSXsOYB5YQWZGiz1aVq5Pgr2GrQu,5,4,3,0,1,17,1,0,26,3.7142857142857144,1,0.0,0,3,0,1,4,17,0,1,0,4,22,1
2310,99336,3gXjYz3VFr0TvsDYUgKtksPt5WrPBmEo,SpATywNh6bZuzm8s1ceuBUnMUAeoAHHw,17,15,10,8,4,0,3,0,40,5.714285714285714,2,0.0,2,10,8,4,13,0,0,3,0,24,16,0
2311,99464,VFYk1GyeJyGqK1t09cLe0E5m7KsULmvc,SpATywNh6bZuzm8s1ceuBUnMUAeoAHHw,3,2,0,0,0,0,1,0,3,0.42857142857142855,1,0.0,0,0,0,0,2,0,0,1,0,0,3,1
2312,99777,1umo7etGwkx7NcpFxVialzDD37NdyqRT,SpATywNh6bZuzm8s1ceuBUnMUAeoAHHw,5,9,3,0,0,0,1,0,13,1.8571428571428572,1,0.0,5,3,0,0,4,0,0,1,0,8,5,0
2313,99860,Q8SrRVeWzJizOf34g4fWFcHi3GfFJHUN,SpATywNh6bZuzm8s1ceuBUnMUAeoAHHw,10,11,5,12,1,0,2,0,31,4.428571428571429,1,0.0,2,5,10,1,9,0,2,2,0,18,13,1
2314,100265,McYATdhZDDMDpni6a4GbjI06ustMpvdV,SpATywNh6bZuzm8s1ceuBUnMUAeoAHHw,1,0,0,0,0,0,1,0,1,0.14285714285714285,1,0.0,0,0,0,0,0,0,0,1,0,0,1,1
2315,100266,n2r6kyDnsWpbtliBFHcr0YWSTfVt0HhQ,G8EPVSXsOYB5YQWZGiz1aVq5Pgr2GrQu,16,18,1,12,1,1,3,1,37,5.285714285714286,1,0.0,8,1,6,1,10,1,6,3,1,16,21,1
2316,100389,Q9YOU7BuWjkOYwh9pr1oIgYKYXPPRz5K,RXDvfPUBYFlVdlueBFbLW0mhhAyGEqpt,15,10,5,30,3,2,1,0,51,7.285714285714286,1,0.0,4,5,27,3,6,2,3,1,0,39,12,0
2317,100518,6DFg8IrvITdyV3FmRQrzgnl2oAgir5Pb,SpATywNh6bZuzm8s1ceuBUnMUAeoAHHw,18,16,7,10,4,5,5,0,47,6.714285714285714,1,0.0,2,7,10,4,14,5,0,5,0,23,24,0
2318,100640,NfAbLg5OeUTUtF15GhHCETvzoFPtTDPd,SpATywNh6bZuzm8s1ceuBUnMUAeoAHHw,16,15,0,15,0,11,7,0,48,6.857142857142857,1,0.0,5,0,14,0,10,11,1,7,0,19,29,1
2319,100749,1AsQo0zAkltKFUhbJK8sQo8EMtQlw4Zw,A3fsA9Zfv1X2fVEQhTw51lKENdNrEqT3,6,4,3,0,1,0,2,0,10,1.4285714285714286,1,0.0,0,3,0,1,4,0,0,2,0,4,6,1
2320,101045,PCtqctDcjJHl3GW7yk0aug87eqbAmlqT,SpATywNh6bZuzm8s1ceuBUnMUAeoAHHw,15,11,0,16,0,0,2,0,29,4.142857142857143,1,0.0,2,0,14,0,9,0,2,2,0,16,13,1
2321,101098,Jxd0Gyi2eFjuuzujg1eSA5QBX1QonMfb,bWdj2GDclj5ofokWjzoa5jAwMkxCykd6,11,8,7,0,4,0,5,2,26,3.7142857142857144,1,0.0,0,7,0,4,8,0,0,5,2,11,15,1
2322,101130,4TBbHxtdM6KlXwrDZvHlXfXL45mqy6bL,SpATywNh6bZuzm8s1ceuBUnMUAeoAHHw,8,8,2,0,0,0,2,0,12,1.7142857142857142,2,0.0,0,2,0,0,8,0,0,2,0,2,10,1
2323,101223,MwRVXLIjs7ObnboXYRMgXHQa3UWpN5i5,SpATywNh6bZuzm8s1ceuBUnMUAeoAHHw,10,8,7,0,3,0,1,0,19,2.7142857142857144,1,0.0,0,7,0,3,8,0,0,1,0,10,9,1
2324,103131,KKoJVU8RPVKYX0YtUEw7IyEbFA7WdrnE,SpATywNh6bZuzm8s1ceuBUnMUAeoAHHw,16,13,6,16,4,0,2,0,41,5.857142857142857,1,0.0,4,6,14,4,9,0,2,2,0,28,13,0
2325,103220,8c2gk77rfHeG4kEZpifVHT547X2ayTNE,A3fsA9Zfv1X2fVEQhTw51lKENdNrEqT3,16,9,7,0,6,0,1,0,23,3.2857142857142856,2,0.0,0,7,0,6,9,0,0,1,0,13,10,1
2326,103401,BfcoBJeBA5nEQ2BMwBPOzhifSeHVOPF7,A3fsA9Zfv1X2fVEQhTw51lKENdNrEqT3,11,11,1,0,1,0,3,1,17,2.4285714285714284,1,0.0,0,1,0,1,11,0,0,3,1,2,15,1
2327,103932,nMJrb50Z6QbaFrpJMS3h5YwSiL2VcT7z,bWdj2GDclj5ofokWjzoa5jAwMkxCykd6,2,0,0,0,0,0,2,0,2,0.2857142857142857,1,0.0,0,0,0,0,0,0,0,2,0,0,2,1
2328,104081,eGnXUl0T4jiT9b8r6xuMUjzOt9Gv7xEL,A3fsA9Zfv1X2fVEQhTw51lKENdNrEqT3,29,27,19,22,12,1,12,2,95,13.571428571428571,3,0.0,0,19,19,12,27,1,3,12,2,50,45,1
2329,104257,JnJdiqdl8G12l0bbDCbx68wMLkGjKDPl,bWdj2GDclj5ofokWjzoa5jAwMkxCykd6,5,4,2,0,0,0,4,0,10,1.4285714285714286,1,0.0,0,2,0,0,4,0,0,4,0,2,8,1
2330,104285,eYFN65l456TZjqLokXcupn8BpQg7vecw,G8EPVSXsOYB5YQWZGiz1aVq5Pgr2GrQu,9,7,0,0,1,0,11,0,19,2.7142857142857144,1,0.0,0,0,0,1,7,0,0,11,0,1,18,1
2331,104287,E4KzNEU3ybRlAOiHqHHsGQEXiaxyHgoT,SpATywNh6bZuzm8s1ceuBUnMUAeoAHHw,3,2,1,0,0,0,1,0,4,0.5714285714285714,1,0.0,0,1,0,0,2,0,0,1,0,1,3,0
2332,104293,mKHQM9iW9olu6z2WamdxK7ySH3UwX3JX,RXDvfPUBYFlVdlueBFbLW0mhhAyGEqpt,8,10,4,21,4,0,1,0,40,5.714285714285714,1,0.0,5,4,18,4,5,0,3,1,0,31,9,1
2333,104338,rB9PPwxIRyt27C89H153o2lH09tVr1nK,G8EPVSXsOYB5YQWZGiz1aVq5Pgr2GrQu,6,11,3,0,4,0,2,0,20,2.857142857142857,1,0.0,7,3,0,4,4,0,0,2,0,14,6,1
2334,104362,QVxxpDseuNfbakex6vp7iIpmgTn9LMT8,G8EPVSXsOYB5YQWZGiz1aVq5Pgr2GrQu,7,4,0,0,0,0,3,1,8,1.1428571428571428,1,0.0,0,0,0,0,4,0,0,3,1,0,8,1
2335,104454,S6zuEdHkGvIDnx9FvNNHc7xwyevTBNEw,G8EPVSXsOYB5YQWZGiz1aVq5Pgr2GrQu,74,60,25,207,22,0,6,0,320,45.714285714285715,4,0.0,23,25,174,22,37,0,33,6,0,244,76,0
2336,104529,pRsdTtgRf3HNRCFBVE8ZUsyswXD2QiAk,SpATywNh6bZuzm8s1ceuBUnMUAeoAHHw,5,3,2,0,2,0,0,0,7,1.0,1,0.0,2,2,0,2,1,0,0,0,0,6,1,1
2337,104541,WrS9TB9uT4oSW7UbFINDhj14Cq6LHmEj,G8EPVSXsOYB5YQWZGiz1aVq5Pgr2GrQu,21,20,7,12,5,3,12,1,60,8.571428571428571,1,0.0,5,7,9,5,15,3,3,12,1,26,34,0
2338,104559,efXmiwkTuBoeL7S5luYeU6sYtxURlop6,G8EPVSXsOYB5YQWZGiz1aVq5Pgr2GrQu,2,0,0,0,0,0,2,0,2,0.2857142857142857,1,0.0,0,0,0,0,0,0,0,2,0,0,2,1
2339,104695,pFPFJKqqsl7E3HmJN66ulC7SsHL61zY0,G8EPVSXsOYB5YQWZGiz1aVq5Pgr2GrQu,7,1,1,0,1,0,4,1,8,1.1428571428571428,1,0.0,0,1,0,1,1,0,0,4,1,2,6,1
2340,104803,GHw9ck750jm0mkRym0HeCGrJelDoub5a,SpATywNh6bZuzm8s1ceuBUnMUAeoAHHw,7,3,2,0,1,1,4,0,11,1.5714285714285714,1,0.0,0,2,0,1,3,1,0,4,0,3,8,0
2341,104840,wBcELLuAHs6lwDaecxC5fVgtQ5lnLu3S,RXDvfPUBYFlVdlueBFbLW0mhhAyGEqpt,5,3,0,0,0,0,2,0,5,0.7142857142857143,1,0.0,0,0,0,0,3,0,0,2,0,0,5,1
2342,104911,0lHtTzCCkTGgpl3mL2eT9kPoN3ydIlHv,bWdj2GDclj5ofokWjzoa5jAwMkxCykd6,9,6,5,0,4,0,1,0,16,2.2857142857142856,1,0.0,0,5,0,4,6,0,0,1,0,9,7,1
2343,104973,r6HTx0usTVh2rZ8xnqG9NraBW5uoCbAW,G8EPVSXsOYB5YQWZGiz1aVq5Pgr2GrQu,3,2,0,0,0,0,1,0,3,0.42857142857142855,1,0.0,0,0,0,0,2,0,0,1,0,0,3,1
2344,105009,MoIyInVwEhZdoyGdxNDzoAKuJ4ab4usf,G8EPVSXsOYB5YQWZGiz1aVq5Pgr2GrQu,33,10,5,122,1,0,6,1,145,20.714285714285715,1,0.0,3,5,99,1,7,0,23,6,1,108,37,1
2345,105048,skA6GV4QKGFVtxye7Nlz906gXUD3qCvf,SpATywNh6bZuzm8s1ceuBUnMUAeoAHHw,10,21,1,10,0,0,1,0,33,4.714285714285714,1,0.0,12,1,9,0,9,0,1,1,0,22,11,1
2346,105087,il5WSyfV8t3AlDaoTevF0gOGZQXdoXsc,SpATywNh6bZuzm8s1ceuBUnMUAeoAHHw,10,3,3,0,3,0,3,0,12,1.7142857142857142,1,0.0,0,3,0,3,3,0,0,3,0,6,6,1
2347,105108,HJsFc87NFCDg5yRkkakXIT7nSH8XGxhF,RXDvfPUBYFlVdlueBFbLW0mhhAyGEqpt,2,0,0,0,0,0,3,0,3,0.42857142857142855,2,0.0,0,0,0,0,0,0,0,3,0,0,3,0
2348,105126,5THwHjTl3CwrsU1mIg0WeedsGDfvyUMr,G8EPVSXsOYB5YQWZGiz1aVq5Pgr2GrQu,11,10,5,0,3,1,10,0,29,4.142857142857143,2,0.0,0,5,0,3,10,1,0,10,0,8,21,1
2349,105183,vIlcyxyCAnrnNirD1pT1JNHi1Wuqkh6N,G8EPVSXsOYB5YQWZGiz1aVq5Pgr2GrQu,1,0,0,0,0,0,1,0,1,0.14285714285714285,1,0.0,0,0,0,0,0,0,0,1,0,0,1,1
2350,105310,drUu3tyovHqnF7EAaPHayHDYbWMe2Od6,G8EPVSXsOYB5YQWZGiz1aVq5Pgr2GrQu,1,0,0,0,0,0,1,0,1,0.14285714285714285,1,0.0,0,0,0,0,0,0,0,1,0,0,1,1
2351,105311,drUu3tyovHqnF7EAaPHayHDYbWMe2Od6,RXDvfPUBYFlVdlueBFbLW0mhhAyGEqpt,1,0,0,0,0,0,1,0,1,0.14285714285714285,1,0.0,0,0,0,0,0,0,0,1,0,0,1,1
2352,105323,yiX0lNiEyuJnsK7G0Hy1jjUqzZwKTcF0,SpATywNh6bZuzm8s1ceuBUnMUAeoAHHw,14,18,0,8,0,0,6,0,32,4.571428571428571,1,0.0,2,0,8,0,16,0,0,6,0,10,22,1
2353,105522,Sj6pTyY9d8gvsSx1FCIqF3bTiiQB5ISO,RXDvfPUBYFlVdlueBFbLW0mhhAyGEqpt,1,0,0,0,0,0,1,0,1,0.14285714285714285,1,0.0,0,0,0,0,0,0,0,1,0,0,1,1
2354,105558,GbO46rd9u4nTIYKWQ4uqsc2u6MxCvlf3,A3fsA9Zfv1X2fVEQhTw51lKENdNrEqT3,4,3,2,0,0,0,1,0,6,0.8571428571428571,1,0.0,0,2,0,0,3,0,0,1,0,2,4,1
2355,105613,Z91ylcCa0QBPuZRAZnN7Bi8KMhEMk84I,RXDvfPUBYFlVdlueBFbLW0mhhAyGEqpt,1,0,0,0,0,0,1,0,1,0.14285714285714285,1,0.0,0,0,0,0,0,0,0,1,0,0,1,1
2356,105619,XDUz0oVcNwke0CqAlFlmwOWSA32SgeFl,RXDvfPUBYFlVdlueBFbLW0mhhAyGEqpt,1,0,0,0,0,0,1,0,1,0.14285714285714285,1,0.0,0,0,0,0,0,0,0,1,0,0,1,1
2357,105621,Z2LpxeyN5IUym4huJGBt4liqsVm2EQ7Q,SpATywNh6bZuzm8s1ceuBUnMUAeoAHHw,11,12,3,12,0,17,9,0,53,7.571428571428571,3,0.0,2,3,11,0,10,17,1,9,0,16,37,0
2358,105631,RWrD2aL8EikwNOiemk8w8nKZlf66LQBh,SpATywNh6bZuzm8s1ceuBUnMUAeoAHHw,4,5,3,0,3,0,1,0,12,1.7142857142857142,1,0.0,1,3,0,3,4,0,0,1,0,7,5,1
2359,106897,yrxUCbkwiU0Qgu0wZMF5MylHBneN7zri,SpATywNh6bZuzm8s1ceuBUnMUAeoAHHw,7,9,5,0,2,0,1,0,17,2.4285714285714284,1,0.0,0,5,0,2,9,0,0,1,0,7,10,0
2360,108249,U86H0D53uFDssNj4hNXQwNhRzNF9WB0g,SpATywNh6bZuzm8s1ceuBUnMUAeoAHHw,1,0,0,0,0,0,1,0,1,0.14285714285714285,1,0.0,0,0,0,0,0,0,0,1,0,0,1,1
2361,108421,Z8VFKUoySr9L7FZfGeoeDWQqxwnJbTos,SpATywNh6bZuzm8s1ceuBUnMUAeoAHHw,14,26,1,12,1,7,4,0,51,7.285714285714286,2,0.0,8,1,12,1,18,7,0,4,0,22,29,0
2362,108543,vZzTgGwK0cR24BSm1xzdfANP52hj4iMk,A3fsA9Zfv1X2fVEQhTw51lKENdNrEqT3,5,4,1,0,0,0,6,0,11,1.5714285714285714,1,0.0,0,1,0,0,4,0,0,6,0,1,10,1
2363,108658,FAjTaGnsfZLBQS9slQbYMPpuh5mcYxue,SpATywNh6bZuzm8s1ceuBUnMUAeoAHHw,12,11,5,10,0,9,5,0,40,5.714285714285714,1,0.0,2,5,8,0,9,9,2,5,0,15,25,0
2364,109103,MZomFQTbHAKaDGd0B9fv7KQ9MRsZJ7m6,A3fsA9Zfv1X2fVEQhTw51lKENdNrEqT3,6,7,2,0,1,0,3,0,13,1.8571428571428572,1,0.0,0,2,0,1,7,0,0,3,0,3,10,1
2365,109309,WAUVjfvcVVKr4l1eRzgNNfyqoF4mUwKn,SpATywNh6bZuzm8s1ceuBUnMUAeoAHHw,8,7,6,0,0,0,1,0,14,2.0,1,0.0,0,6,0,0,7,0,0,1,0,6,8,1
2366,109536,Cv1aavObJnuABKfipF6OGePzg0BnGPFs,SpATywNh6bZuzm8s1ceuBUnMUAeoAHHw,7,7,2,6,0,0,5,0,20,2.857142857142857,2,0.0,5,2,6,0,2,0,0,5,0,13,7,1
2367,109538,Cv1aavObJnuABKfipF6OGePzg0BnGPFs,A3fsA9Zfv1X2fVEQhTw51lKENdNrEqT3,41,6,4,156,0,0,6,0,172,24.571428571428573,2,0.0,2,4,156,0,4,0,0,6,0,162,10,1
2368,109542,UzfhQlNSIoLM6AVYNl7JKilqEEtlOXJC,bWdj2GDclj5ofokWjzoa5jAwMkxCykd6,1,0,0,0,0,0,1,0,1,0.14285714285714285,1,0.0,0,0,0,0,0,0,0,1,0,0,1,1
2369,109543,Cv1aavObJnuABKfipF6OGePzg0BnGPFs,bWdj2GDclj5ofokWjzoa5jAwMkxCykd6,21,13,7,96,0,0,5,0,121,17.285714285714285,2,0.0,6,7,93,0,7,0,3,5,0,106,15,1
2370,109661,vlxKYuyoAuMqS1coFL9iKQUv0EZG5cjH,RXDvfPUBYFlVdlueBFbLW0mhhAyGEqpt,1,0,0,0,0,0,1,0,1,0.14285714285714285,1,0.0,0,0,0,0,0,0,0,1,0,0,1,1
2371,109697,pGYP47am2d3xk9zOKdaE6fuoOc52iQiA,A3fsA9Zfv1X2fVEQhTw51lKENdNrEqT3,57,38,0,150,0,0,6,0,194,27.714285714285715,2,0.0,6,0,130,0,32,0,20,6,0,136,58,1
2372,109908,HCwGALsXdQRvdnW9Y1SicRkbFYJcehRz,G8EPVSXsOYB5YQWZGiz1aVq5Pgr2GrQu,9,10,2,4,1,2,4,0,23,3.2857142857142856,1,0.0,6,2,3,1,4,2,1,4,0,12,11,0
2373,109982,DmULS2tEq0maGheqJ8Xg7VkvUxmleIug,SpATywNh6bZuzm8s1ceuBUnMUAeoAHHw,9,19,1,0,1,0,2,0,23,3.2857142857142856,1,0.0,1,1,0,1,18,0,0,2,0,3,20,0
2374,113891,9d8tCYKPfh5NHPKNlwRKmrZh3Cuf1Ls2,7GRhBDsirIGkRZBtSMEzNTyDr2JQm4xx,20,38,19,4,7,0,10,0,78,11.142857142857142,2,0.0,3,19,4,7,35,0,0,10,0,33,45,0
2375,113892,YvqXtgBNC43WLi1Y1OHrc4YV5wJZj5BZ,7GRhBDsirIGkRZBtSMEzNTyDr2JQm4xx,36,105,2,59,10,0,4,0,180,25.714285714285715,1,0.0,20,2,50,10,85,0,9,4,0,82,98,1
2376,113921,cQJEH4N9NA86ElT2x4zkE6ToN6rVT4MQ,7GRhBDsirIGkRZBtSMEzNTyDr2JQm4xx,35,45,18,40,14,2,7,0,126,18.0,2,0.0,21,18,34,14,24,2,6,7,0,87,39,1
2377,113977,AnqzEiR7s4CfuKEZI3xmlDjhp0SJ9rWN,7GRhBDsirIGkRZBtSMEzNTyDr2JQm4xx,19,33,10,25,13,0,6,0,87,12.428571428571429,1,0.0,10,10,20,13,23,0,5,6,0,53,34,0
2378,113978,pi6uVUUcWdM15szjsg09SfyhPrGkMugT,7GRhBDsirIGkRZBtSMEzNTyDr2JQm4xx,7,5,1,0,0,0,5,0,11,1.5714285714285714,2,0.0,0,1,0,0,5,0,0,5,0,1,10,1
2379,113991,z7I1QeH8tOlWf6s0Xi8QGEEG8QaCPAno,7GRhBDsirIGkRZBtSMEzNTyDr2JQm4xx,32,45,21,29,6,35,14,5,155,22.142857142857142,5,0.0,20,21,28,6,25,35,1,14,5,75,80,1
2380,114084,HolfiiRMNIE2y1ufEDM4W3kjJIHyUraM,7GRhBDsirIGkRZBtSMEzNTyDr2JQm4xx,1,0,0,0,0,0,1,0,1,0.14285714285714285,1,0.0,0,0,0,0,0,0,0,1,0,0,1,1
2381,114122,4Pd3e254V1ylErxapJL6FJZ2vSaLD95s,7GRhBDsirIGkRZBtSMEzNTyDr2JQm4xx,12,22,2,3,2,1,3,0,33,4.714285714285714,3,0.0,5,2,3,2,17,1,0,3,0,12,21,0
2382,114193,w43NdaSTOQbbSDTdI0RJiLpdaaUTMsHa,7GRhBDsirIGkRZBtSMEzNTyDr2JQm4xx,1,0,0,0,0,0,1,0,1,0.14285714285714285,1,0.0,0,0,0,0,0,0,0,1,0,0,1,1
2383,114299,uuzc81RWrrz7iGcyTE1vS0JQYD0lJgbY,7GRhBDsirIGkRZBtSMEzNTyDr2JQm4xx,24,59,2,44,3,9,9,0,126,18.0,2,0.0,45,2,37,3,14,9,7,9,0,87,39,1
2384,114411,2jRIZMWHA5rH4ew2UCv2iZrYBWoFczyG,7GRhBDsirIGkRZBtSMEzNTyDr2JQm4xx,2,0,0,0,0,0,3,0,3,0.42857142857142855,1,0.0,0,0,0,0,0,0,0,3,0,0,3,0
2385,114496,rqwp0DRxlrzViX8K4jHTHKpfYZPPmBwb,7GRhBDsirIGkRZBtSMEzNTyDr2JQm4xx,1,0,0,0,0,0,1,0,1,0.14285714285714285,1,0.0,0,0,0,0,0,0,0,1,0,0,1,1
2386,114497,3RcsrMTbPrb8ZHYXLlgwoRK7zrqTGSuq,7GRhBDsirIGkRZBtSMEzNTyDr2JQm4xx,11,19,6,0,0,7,4,0,36,5.142857142857143,1,0.0,8,6,0,0,11,7,0,4,0,14,22,1
2387,114543,aEgt3dXm9v9Y3bAdN5dHXVwqStuJSLzy,7GRhBDsirIGkRZBtSMEzNTyDr2JQm4xx,1,0,0,0,0,0,1,0,1,0.14285714285714285,1,0.0,0,0,0,0,0,0,0,1,0,0,1,1
2388,114559,KkSinTdG2PbGrJIRATMZos8HES46UawO,7GRhBDsirIGkRZBtSMEzNTyDr2JQm4xx,11,28,9,7,5,0,5,0,54,7.714285714285714,5,0.0,7,9,7,5,21,0,0,5,0,28,26,0
2389,114568,39kDK9y6rUMxkyJQwaOrfTRJDkq1CpVh,7GRhBDsirIGkRZBtSMEzNTyDr2JQm4xx,3,2,0,0,0,0,2,0,4,0.5714285714285714,1,0.0,0,0,0,0,2,0,0,2,0,0,4,1
2390,114615,dADOrE6FAWkIPcnZuLBj5KGmzjdxSunH,fbPkOYLVPtPgIt0MxizjfFJov3JbHyAi,23,38,22,27,12,0,3,0,102,14.571428571428571,5,0.0,13,22,24,12,25,0,3,3,0,71,31,0
2391,117386,i0ksX07HnsV5rQlWqOr1uKEuc7yNU24c,fbPkOYLVPtPgIt0MxizjfFJov3JbHyAi,7,2,1,0,1,4,6,1,15,2.142857142857143,1,0.0,0,1,0,1,2,4,0,6,1,2,13,1
2392,117409,oZFc1qOsYmuXaa2y9yuDE2JOyaJ6tpRo,fbPkOYLVPtPgIt0MxizjfFJov3JbHyAi,10,10,5,0,4,0,2,0,21,3.0,1,0.0,0,5,0,4,10,0,0,2,0,9,12,1
2393,117429,pbZR4GJe7P6eoTNcArXxFSrGW6cVA8YU,fbPkOYLVPtPgIt0MxizjfFJov3JbHyAi,6,5,4,0,2,0,2,0,13,1.8571428571428572,1,0.0,0,4,0,2,5,0,0,2,0,6,7,1
2394,117437,HOh9uzKRHmixUSVl017qRO1fRhTakF2v,fbPkOYLVPtPgIt0MxizjfFJov3JbHyAi,14,27,11,6,9,0,5,0,58,8.285714285714286,4,0.0,8,11,4,9,19,0,2,5,0,32,26,1
2395,117442,kyRDtUassKyWkKwd2NxuRMWbNGMmYQuD,fbPkOYLVPtPgIt0MxizjfFJov3JbHyAi,24,44,27,8,7,18,10,0,114,16.285714285714285,4,0.0,7,27,7,7,37,18,1,10,0,48,66,1
2396,117444,oWOfoMSwxFJkBlwLG8XI3GNMHdlBBaGM,fbPkOYLVPtPgIt0MxizjfFJov3JbHyAi,11,16,12,3,2,0,4,0,37,5.285714285714286,6,0.0,4,12,2,2,12,0,1,4,0,20,17,1
2397,117467,hDNiOFPvRB9cUydss5Qxpv78aI19HlnV,fbPkOYLVPtPgIt0MxizjfFJov3JbHyAi,9,5,4,0,3,0,1,0,13,1.8571428571428572,1,0.0,0,4,0,3,5,0,0,1,0,7,6,1
2398,117476,RwvuGEh3euIR11rktJrGBhzDqcQMkhOC,fbPkOYLVPtPgIt0MxizjfFJov3JbHyAi,4,2,1,0,0,0,2,0,5,0.7142857142857143,1,0.0,0,1,0,0,2,0,0,2,0,1,4,1
2399,117504,7nfwj1I7hYBfuxm4jUuStM2n17LzzRmj,SpATywNh6bZuzm8s1ceuBUnMUAeoAHHw,16,20,14,12,9,44,15,0,114,16.285714285714285,5,0.0,4,14,10,9,16,44,2,15,0,37,77,0
2400,117532,qX3w4IgztgXyu9swieirFObama3kJyza,G8EPVSXsOYB5YQWZGiz1aVq5Pgr2GrQu,60,65,3,189,1,2,19,6,285,40.714285714285715,4,0.0,4,3,151,1,61,2,38,19,6,159,126,1
2401,117567,KlEAwfTXNSli6vdNdYlm5CYknLkxK1Br,SpATywNh6bZuzm8s1ceuBUnMUAeoAHHw,16,19,13,0,9,0,3,0,44,6.285714285714286,2,0.0,3,13,0,9,16,0,0,3,0,25,19,0
2402,117568,VK6VYsFJEy8hhWdKq52KmrJkO3b6jNbn,A3fsA9Zfv1X2fVEQhTw51lKENdNrEqT3,34,21,13,36,12,1,15,1,99,14.142857142857142,3,0.0,2,13,30,12,19,1,6,15,1,57,42,0
2403,117609,hyhyxhn6qO7nii28PZygBx2DF5Qsnp6b,SpATywNh6bZuzm8s1ceuBUnMUAeoAHHw,10,10,5,0,4,0,1,0,20,2.857142857142857,1,0.0,0,5,0,4,10,0,0,1,0,9,11,1
2404,117612,Kd69M9W1nim0woqVm1QxfVaSebsYtFIh,SpATywNh6bZuzm8s1ceuBUnMUAeoAHHw,3,2,1,0,0,0,1,0,4,0.5714285714285714,1,0.0,0,1,0,0,2,0,0,1,0,1,3,1
2405,117613,VEmnuZOsoHSPcS4ojGYL7wyh1ioGqsGt,SpATywNh6bZuzm8s1ceuBUnMUAeoAHHw,29,25,17,22,11,0,5,0,80,11.428571428571429,3,0.0,4,17,22,11,21,0,0,5,0,54,26,0
2406,117655,MkluYfJDefHhcRPY3QsRGiWxg2BDcm18,SpATywNh6bZuzm8s1ceuBUnMUAeoAHHw,10,6,1,0,1,3,9,2,22,3.142857142857143,1,0.0,0,1,0,1,6,3,0,9,2,2,20,0
2407,117666,GGjg9S36MZkhfOc2c4FtP7oUCiriIkzW,A3fsA9Zfv1X2fVEQhTw51lKENdNrEqT3,1,0,0,0,0,0,1,0,1,0.14285714285714285,1,0.0,0,0,0,0,0,0,0,1,0,0,1,1
2408,117671,LvmRr9NACuniPuboiWpXG15NCOEyIfpb,SpATywNh6bZuzm8s1ceuBUnMUAeoAHHw,11,10,7,0,3,0,5,0,25,3.5714285714285716,2,0.0,0,7,0,3,10,0,0,5,0,10,15,0
2409,117675,l64zD2DC6Q6fZRqMhhM1r4HOjVM4BOX7,SpATywNh6bZuzm8s1ceuBUnMUAeoAHHw,10,11,1,0,1,1,8,1,23,3.2857142857142856,1,0.0,0,1,0,1,11,1,0,8,1,2,21,0
2410,117679,VE9HD5yzeCmqc2pNGfTQWsVbRdaqJBIV,SpATywNh6bZuzm8s1ceuBUnMUAeoAHHw,17,14,8,6,4,0,1,0,33,4.714285714285714,1,0.0,4,8,6,4,10,0,0,1,0,22,11,0
2411,117701,VgmFAu9L9uoZcxRAsErY5yMnCkdw48U0,SpATywNh6bZuzm8s1ceuBUnMUAeoAHHw,22,18,12,36,8,0,12,0,86,12.285714285714286,3,0.0,4,12,33,8,14,0,3,12,0,57,29,0
2412,117704,imCqSahSQFbp2MKSKmbn03XNPhpj1Zgr,bWdj2GDclj5ofokWjzoa5jAwMkxCykd6,18,21,10,61,4,5,3,0,104,14.857142857142858,1,0.0,3,10,56,4,18,5,5,3,0,73,31,1
2413,117705,KM2jhllffvH7le7smUIPpeiXHGu50JUy,G8EPVSXsOYB5YQWZGiz1aVq5Pgr2GrQu,19,65,1,26,5,4,8,1,110,15.714285714285714,2,0.0,37,1,18,5,28,4,8,8,1,61,49,1
2414,117713,BdtTUaUgpTqIzhF2tLHXM8NXK8k0XF8q,bWdj2GDclj5ofokWjzoa5jAwMkxCykd6,26,59,32,42,0,18,10,0,161,23.0,2,0.0,10,32,40,0,49,18,2,10,0,82,79,0
2415,117723,B1Gq6e77yv7kkDqJ7SH2TygdPDzPBwQh,RXDvfPUBYFlVdlueBFbLW0mhhAyGEqpt,28,42,33,35,15,80,5,1,211,30.142857142857142,3,0.0,6,33,31,15,36,80,4,5,1,85,126,0
2416,117734,cQJEH4N9NA86ElT2x4zkE6ToN6rVT4MQ,bWdj2GDclj5ofokWjzoa5jAwMkxCykd6,7,3,1,18,1,0,2,0,25,3.5714285714285716,1,0.0,1,1,17,1,2,0,1,2,0,20,5,0
2417,117742,FhtwGNNoWtYYBXhYRu77jAPRU1UPxpBL,SpATywNh6bZuzm8s1ceuBUnMUAeoAHHw,5,2,1,0,0,0,3,0,6,0.8571428571428571,1,0.0,0,1,0,0,2,0,0,3,0,1,5,0
2418,117774,jFYWygr5nLqLhHkXltZRkT0S1zQoLEVR,A3fsA9Zfv1X2fVEQhTw51lKENdNrEqT3,33,10,6,96,3,7,6,1,129,18.428571428571427,1,0.0,1,6,84,3,9,7,12,6,1,94,35,0
2419,117791,efPQEaUnbKTGcoOM9khi0sSrVhfE9TxE,bWdj2GDclj5ofokWjzoa5jAwMkxCykd6,11,48,21,4,2,0,9,0,84,12.0,4,0.0,2,21,3,2,46,0,1,9,0,28,56,1
2420,117800,RJv5TI20pjqK3VtKSctdVBLm65ceGNPu,SpATywNh6bZuzm8s1ceuBUnMUAeoAHHw,16,29,11,17,3,3,5,0,68,9.714285714285714,1,0.0,10,11,16,3,19,3,1,5,0,40,28,0
2421,117893,Bos3zEEnAcYzPXQktMkJJ0ak5mhGWCAf,SpATywNh6bZuzm8s1ceuBUnMUAeoAHHw,21,32,11,26,6,0,1,0,76,10.857142857142858,1,0.0,13,11,25,6,19,0,1,1,0,55,21,0
2422,117897,uww7NsJbMYsrx0EthqYUSLQnuRAcw7nQ,A3fsA9Zfv1X2fVEQhTw51lKENdNrEqT3,5,1,1,0,1,0,5,0,8,1.1428571428571428,1,0.0,0,1,0,1,1,0,0,5,0,2,6,1
2423,117935,1R1zO9aMB7Mx1Lw84JzsChVEV5JpwmZv,SpATywNh6bZuzm8s1ceuBUnMUAeoAHHw,20,41,3,12,1,26,21,5,109,15.571428571428571,7,0.0,8,3,12,1,33,26,0,21,5,24,85,0
2424,118040,Eemq3hk1Q3P1Pw1UumR7jNQlYsAdhi76,SpATywNh6bZuzm8s1ceuBUnMUAeoAHHw,11,16,4,19,1,2,4,1,47,6.714285714285714,1,0.0,11,4,17,1,5,2,2,4,1,33,14,1
2425,118084,hJwtwnOzJaTrAeP4eXJAEwz2xbKsgc4M,A3fsA9Zfv1X2fVEQhTw51lKENdNrEqT3,1,0,0,0,0,0,8,0,8,1.1428571428571428,5,0.0,0,0,0,0,0,0,0,8,0,0,8,0
2426,118085,hJwtwnOzJaTrAeP4eXJAEwz2xbKsgc4M,bWdj2GDclj5ofokWjzoa5jAwMkxCykd6,1,0,0,0,0,0,10,0,10,1.4285714285714286,5,0.0,0,0,0,0,0,0,0,10,0,0,10,0
2427,118091,hJwtwnOzJaTrAeP4eXJAEwz2xbKsgc4M,RXDvfPUBYFlVdlueBFbLW0mhhAyGEqpt,1,0,0,0,0,0,7,0,7,1.0,5,0.0,0,0,0,0,0,0,0,7,0,0,7,1
2428,118111,vlcrE6RvFFuyjHZx9sgpQaFTegXr4wza,bWdj2GDclj5ofokWjzoa5jAwMkxCykd6,8,5,3,0,1,0,4,0,13,1.8571428571428572,1,0.0,0,3,0,1,5,0,0,4,0,4,9,1
2429,118118,l3b9HlsGDQW9AY17jLNuKVLgfuE5tsF4,SpATywNh6bZuzm8s1ceuBUnMUAeoAHHw,14,21,7,16,3,0,1,0,48,6.857142857142857,2,0.0,10,7,16,3,11,0,0,1,0,36,12,0
2430,118130,0sa6kP9h4ahNr7Hzfeaa1Mssp5M7IVmw,SpATywNh6bZuzm8s1ceuBUnMUAeoAHHw,5,4,2,0,1,0,1,0,8,1.1428571428571428,1,0.0,0,2,0,1,4,0,0,1,0,3,5,1
2431,118208,iPn4eHBBcGh91aOsj9d5XOb4QbfUGe6N,bWdj2GDclj5ofokWjzoa5jAwMkxCykd6,5,7,2,0,4,0,8,0,21,3.0,2,0.0,4,2,0,4,3,0,0,8,0,10,11,1
2432,118218,66rxtelZjlVaBERuinHZ5AhHu9R6Idp5,SpATywNh6bZuzm8s1ceuBUnMUAeoAHHw,2,0,0,0,0,0,2,0,2,0.2857142857142857,1,0.0,0,0,0,0,0,0,0,2,0,0,2,1
2433,118230,2HbabEHSEnqM0bBaiJs30PG9549v5yOk,A3fsA9Zfv1X2fVEQhTw51lKENdNrEqT3,2,0,0,0,0,0,2,0,2,0.2857142857142857,1,0.0,0,0,0,0,0,0,0,2,0,0,2,1
2434,118232,TANF2ueHbJbwPsuSCbh96NH4X4PT1TeC,SpATywNh6bZuzm8s1ceuBUnMUAeoAHHw,5,2,0,0,1,0,2,0,5,0.7142857142857143,1,0.0,0,0,0,1,2,0,0,2,0,1,4,1
2435,118258,5rpYxIaCTDb4PhszkJWpACOx5VMpNGcQ,SpATywNh6bZuzm8s1ceuBUnMUAeoAHHw,19,15,8,11,4,9,6,0,53,7.571428571428571,2,0.0,5,8,10,4,10,9,1,6,0,27,26,0
2436,118318,7hhGe4WcGEHypOzIVz3DLRx9GS52ozkE,RXDvfPUBYFlVdlueBFbLW0mhhAyGEqpt,24,24,14,26,7,12,5,0,88,12.571428571428571,1,0.0,7,14,25,7,17,12,1,5,0,53,35,0
2437,118326,yKuiBw79vz6YoDe6ZvtlnOfjIuGqFl4A,A3fsA9Zfv1X2fVEQhTw51lKENdNrEqT3,5,4,1,0,0,0,1,0,6,0.8571428571428571,1,0.0,0,1,0,0,4,0,0,1,0,1,5,1
2438,118332,5ZiEBByu9KqLLuVXJILf5031ejtxPgIX,A3fsA9Zfv1X2fVEQhTw51lKENdNrEqT3,1,0,0,0,0,0,1,0,1,0.14285714285714285,1,0.0,0,0,0,0,0,0,0,1,0,0,1,1
2439,118339,cu2czfUbk8fdWWzCcDvTVYWH50Wg3XUq,SpATywNh6bZuzm8s1ceuBUnMUAeoAHHw,6,8,1,0,0,14,3,0,26,3.7142857142857144,3,0.0,0,1,0,0,8,14,0,3,0,1,25,0
2440,118369,httl8KJFJiDMZk4tgEQADrIoYysynrAv,SpATywNh6bZuzm8s1ceuBUnMUAeoAHHw,11,13,1,17,0,0,2,0,33,4.714285714285714,1,0.0,7,1,16,0,6,0,1,2,0,24,9,1
2441,118371,hZtYMC0K38gXqBKrTDOxWf2kSwG06wA4,RXDvfPUBYFlVdlueBFbLW0mhhAyGEqpt,6,3,2,2,0,0,3,0,10,1.4285714285714286,2,0.0,0,2,1,0,3,0,1,3,0,3,7,0
2442,118393,LVTU4qA4F3wWkxH81iGfu4ZuIt77nyhh,SpATywNh6bZuzm8s1ceuBUnMUAeoAHHw,32,37,25,43,8,17,11,1,142,20.285714285714285,1,0.0,5,25,37,8,32,17,6,11,1,75,67,0
2443,118422,ZNBGAlJve4TYJ3FcDlTLBdyuklADldDZ,bWdj2GDclj5ofokWjzoa5jAwMkxCykd6,10,7,2,12,3,0,6,1,31,4.428571428571429,2,0.0,4,2,12,3,3,0,0,6,1,21,10,1
2444,118467,Lu93o5GXoxd6qTdHk7BshqxRhX67SrrE,SpATywNh6bZuzm8s1ceuBUnMUAeoAHHw,17,26,11,6,7,0,2,0,52,7.428571428571429,2,0.0,10,11,6,7,16,0,0,2,0,34,18,0
2445,118506,GrjEbVPh1uYw8afH98AN7VXn6UMAVnC8,A3fsA9Zfv1X2fVEQhTw51lKENdNrEqT3,6,5,0,0,0,0,6,0,11,1.5714285714285714,1,0.0,0,0,0,0,5,0,0,6,0,0,11,1
2446,118514,W3axEfDtpWFQrOsjh1ju6UWJlt7DtE7b,SpATywNh6bZuzm8s1ceuBUnMUAeoAHHw,4,4,1,0,0,0,1,0,6,0.8571428571428571,1,0.0,0,1,0,0,4,0,0,1,0,1,5,1
2447,118548,2i4UZQIumoYMpXAy2hMZiboq0bmSvHzQ,RXDvfPUBYFlVdlueBFbLW0mhhAyGEqpt,6,16,1,0,0,0,3,0,20,2.857142857142857,1,0.0,0,1,0,0,16,0,0,3,0,1,19,1
2448,118642,PpZEAa1Mdati01h1lf363alLOjmVtvBB,A3fsA9Zfv1X2fVEQhTw51lKENdNrEqT3,7,8,4,0,2,0,2,0,16,2.2857142857142856,1,0.0,1,4,0,2,7,0,0,2,0,7,9,1
2449,118650,ANtHTaCISHkEW6ENLanE6G1HEnRFLZdw,A3fsA9Zfv1X2fVEQhTw51lKENdNrEqT3,3,2,1,0,0,0,1,0,4,0.5714285714285714,1,0.0,0,1,0,0,2,0,0,1,0,1,3,0
2450,118652,eNgDL8k9xOLyBlZ3UNlseJHly8SfPZZu,bWdj2GDclj5ofokWjzoa5jAwMkxCykd6,13,34,19,0,4,72,10,0,139,19.857142857142858,4,0.0,6,19,0,4,28,72,0,10,0,29,110,0
2451,118658,eJLeV7Xq2bhq90HDU7vo6Tpmzbd63FDZ,SpATywNh6bZuzm8s1ceuBUnMUAeoAHHw,15,12,9,0,7,0,3,0,31,4.428571428571429,2,0.0,0,9,0,7,12,0,0,3,0,16,15,0
2452,118687,c1BXmJNemroOPh6WUefTBD28s2WzSNwi,A3fsA9Zfv1X2fVEQhTw51lKENdNrEqT3,3,2,0,0,0,0,1,0,3,0.42857142857142855,1,0.0,0,0,0,0,2,0,0,1,0,0,3,1
2453,118704,ZfIQYurnR6gJbWxLJ81cU3ZqzX4mpHm0,bWdj2GDclj5ofokWjzoa5jAwMkxCykd6,6,13,6,0,1,0,5,0,25,3.5714285714285716,3,0.0,1,6,0,1,12,0,0,5,0,8,17,0
2454,118716,fomJrwdlOVBB27jkNMuLttmiA1XIZPzf,SpATywNh6bZuzm8s1ceuBUnMUAeoAHHw,6,4,1,0,1,0,2,0,8,1.1428571428571428,1,0.0,0,1,0,1,4,0,0,2,0,2,6,1
2455,118723,9Gk0qMwFPQMSYtSGwJwjevbzKboXiTpg,SpATywNh6bZuzm8s1ceuBUnMUAeoAHHw,13,20,2,0,1,0,1,0,24,3.4285714285714284,1,0.0,5,2,0,1,15,0,0,1,0,8,16,1
2456,118740,7pYjVdOmbPwcRdb5BQqrv1P4hFEqv8iv,A3fsA9Zfv1X2fVEQhTw51lKENdNrEqT3,7,4,1,0,1,0,2,0,8,1.1428571428571428,1,0.0,0,1,0,1,4,0,0,2,0,2,6,1
2457,118748,grNuFIQJF1sOOkw8RJjaExhlwTJt52uU,G8EPVSXsOYB5YQWZGiz1aVq5Pgr2GrQu,33,46,22,34,15,13,8,1,139,19.857142857142858,5,0.0,0,22,33,15,46,13,1,8,1,70,69,0
2458,118787,bKVslXuzEQ1pv4c6iV5mVjs6X6avUbmL,A3fsA9Zfv1X2fVEQhTw51lKENdNrEqT3,40,14,11,56,10,0,3,0,94,13.428571428571429,2,0.0,1,11,53,10,13,0,3,3,0,75,19,1
2459,118793,lrp5AGJUh69hKuCI5IYUEU19E2beipwd,bWdj2GDclj5ofokWjzoa5jAwMkxCykd6,6,6,0,0,0,0,1,0,7,1.0,1,0.0,0,0,0,0,6,0,0,1,0,0,7,1
2460,118803,AXOBQLaknxwaGBasKpj34YfhU436HR6z,A3fsA9Zfv1X2fVEQhTw51lKENdNrEqT3,1,0,0,0,0,0,1,0,1,0.14285714285714285,1,0.0,0,0,0,0,0,0,0,1,0,0,1,1
2461,118805,c9mIdDAhRczXEb5UJiDqrnVR2zYNOBwR,A3fsA9Zfv1X2fVEQhTw51lKENdNrEqT3,1,0,0,0,0,0,1,0,1,0.14285714285714285,1,0.0,0,0,0,0,0,0,0,1,0,0,1,1
2462,118864,uvmnuTMWO7CUJMGmbknJbfcrAcbdWpqR,A3fsA9Zfv1X2fVEQhTw51lKENdNrEqT3,1,0,0,0,0,0,1,0,1,0.14285714285714285,1,0.0,0,0,0,0,0,0,0,1,0,0,1,1
2463,118880,bqWpav7ocOhCfb3xc4QgAvBDK5g8BmiZ,RXDvfPUBYFlVdlueBFbLW0mhhAyGEqpt,12,19,12,0,5,0,7,0,43,6.142857142857143,3,0.0,2,12,0,5,17,0,0,7,0,19,24,0
2464,118884,c8WJAdYLV71mOx4ZXSglpCNd0dBUR3Om,SpATywNh6bZuzm8s1ceuBUnMUAeoAHHw,17,13,9,12,6,0,4,0,44,6.285714285714286,3,0.0,2,9,11,6,11,0,1,4,0,28,16,0
2465,118934,9Nk7mnk1e8KYLiEHu7uBQQPnqWiwScVk,RXDvfPUBYFlVdlueBFbLW0mhhAyGEqpt,43,56,21,93,12,7,14,1,204,29.142857142857142,2,0.0,16,21,83,12,40,7,10,14,1,132,72,1
2466,118936,0PuPhUY9SiHUBSSrbkLAmF5o2IPgOmxV,SpATywNh6bZuzm8s1ceuBUnMUAeoAHHw,3,3,3,0,3,0,0,0,9,1.2857142857142858,1,0.0,0,3,0,3,3,0,0,0,0,6,3,1
2467,118948,59I5in7ieFGusS8qxVtrv60LZ3ifOtyr,bWdj2GDclj5ofokWjzoa5jAwMkxCykd6,7,11,5,0,1,0,3,0,20,2.857142857142857,2,0.0,2,5,0,1,9,0,0,3,0,8,12,1
2468,118949,ELJa8A81VOfiqD4Bg0Px962sx2WBYvb0,SpATywNh6bZuzm8s1ceuBUnMUAeoAHHw,9,4,3,0,2,9,4,1,23,3.2857142857142856,1,0.0,2,3,0,2,2,9,0,4,1,7,16,0
2469,118951,TBPsTKQ0wiJelelFqXJF9QW001tGl6zy,A3fsA9Zfv1X2fVEQhTw51lKENdNrEqT3,32,24,1,50,0,0,14,0,89,12.714285714285714,2,0.0,3,1,45,0,21,0,5,14,0,49,40,1
2470,118960,TzZdxcOoymQCIG3dwqgzf7xbUV8iLHy5,SpATywNh6bZuzm8s1ceuBUnMUAeoAHHw,1,0,0,0,0,0,1,0,1,0.14285714285714285,1,0.0,0,0,0,0,0,0,0,1,0,0,1,1
2471,118971,u2BXxIc4z9dAiJXDpFgnfPpgZoYcSTcc,bWdj2GDclj5ofokWjzoa5jAwMkxCykd6,5,8,6,0,2,0,4,0,20,2.857142857142857,2,0.0,0,6,0,2,8,0,0,4,0,8,12,1
2472,118998,Xi5jJx0Z2MOBm1fPpYwlvuzwElYhyszd,G8EPVSXsOYB5YQWZGiz1aVq5Pgr2GrQu,7,9,3,0,2,0,1,0,15,2.142857142857143,1,0.0,0,3,0,2,9,0,0,1,0,5,10,1
2473,119006,4dfnEKxHCmGabkBCiKHt5nKr3H7Bwo1x,bWdj2GDclj5ofokWjzoa5jAwMkxCykd6,4,3,1,0,1,0,1,0,6,0.8571428571428571,1,0.0,1,1,0,1,2,0,0,1,0,3,3,1
2474,119018,YlBjTpSiRd0E60X9iyws01NkNrRpj13s,SpATywNh6bZuzm8s1ceuBUnMUAeoAHHw,20,16,10,4,8,0,2,0,40,5.714285714285714,1,0.0,5,10,4,8,11,0,0,2,0,27,13,1
2475,119032,1Y8zyxJNFqsbAxngaSR4MBCJMYy7aumA,bWdj2GDclj5ofokWjzoa5jAwMkxCykd6,1,0,0,0,0,0,1,0,1,0.14285714285714285,1,0.0,0,0,0,0,0,0,0,1,0,0,1,1
2476,119045,VXXH6vGXZQbtzT48oIYSMTaYkPq1TVm5,SpATywNh6bZuzm8s1ceuBUnMUAeoAHHw,14,9,5,12,3,3,3,0,35,5.0,1,0.0,3,5,11,3,6,3,1,3,0,22,13,0
2477,119053,fS72R3kjN9mNNeiYurwm3Uc8w1dF6aYm,SpATywNh6bZuzm8s1ceuBUnMUAeoAHHw,4,6,2,0,0,0,1,0,9,1.2857142857142858,1,0.0,3,2,0,0,3,0,0,1,0,5,4,0
2478,119078,JMeqbYMJuCTPv5oP8GGGEcVIzkVIeo33,G8EPVSXsOYB5YQWZGiz1aVq5Pgr2GrQu,5,2,1,0,1,0,4,0,8,1.1428571428571428,1,0.0,0,1,0,1,2,0,0,4,0,2,6,1
2479,119081,GXJYNcNV7uKT2JtMLlsgpwRjSgogNoCV,SpATywNh6bZuzm8s1ceuBUnMUAeoAHHw,5,6,2,0,0,0,2,0,10,1.4285714285714286,2,0.0,3,2,0,0,3,0,0,2,0,5,5,1
2480,119083,gqAkLU7vUDjTRzHCYv88c6gFo2DAkAbW,G8EPVSXsOYB5YQWZGiz1aVq5Pgr2GrQu,8,4,2,0,2,0,5,0,13,1.8571428571428572,2,0.0,1,2,0,2,3,0,0,5,0,5,8,1
2481,119099,AcUSYBssFtIXtGaa6RbLXgLyfwfDcCt8,SpATywNh6bZuzm8s1ceuBUnMUAeoAHHw,8,2,1,0,1,0,5,1,10,1.4285714285714286,1,0.0,0,1,0,1,2,0,0,5,1,2,8,1
2482,119114,99Z3XYkjkHbSSUTlX3TBtdd4he2ej5Yp,SpATywNh6bZuzm8s1ceuBUnMUAeoAHHw,2,0,1,0,1,0,0,0,2,0.2857142857142857,1,0.0,0,1,0,1,0,0,0,0,0,2,0,1
2483,119116,syYCTgfx3QIfokZD3KllJs2hnCVUuN4D,G8EPVSXsOYB5YQWZGiz1aVq5Pgr2GrQu,15,22,15,0,12,0,5,0,54,7.714285714285714,3,0.0,0,15,0,12,22,0,0,5,0,27,27,1
2484,119118,oxh7qXSiU691JDzseRI3suXHok8L6Fau,SpATywNh6bZuzm8s1ceuBUnMUAeoAHHw,1,0,0,0,0,0,1,0,1,0.14285714285714285,1,0.0,0,0,0,0,0,0,0,1,0,0,1,1
2485,119119,t1xspb1k3lEGBshWKCwAoW44MsPqXHk5,SpATywNh6bZuzm8s1ceuBUnMUAeoAHHw,1,0,0,0,0,0,1,0,1,0.14285714285714285,1,0.0,0,0,0,0,0,0,0,1,0,0,1,1
2486,119122,2GmODuvdJOOWe3lnyYMmKWQOHBH828Cm,SpATywNh6bZuzm8s1ceuBUnMUAeoAHHw,11,6,5,0,4,0,1,0,16,2.2857142857142856,1,0.0,0,5,0,4,6,0,0,1,0,9,7,1
2487,119128,OUbrW18OgibVb4I41eHFiFhkobpgjEP2,bWdj2GDclj5ofokWjzoa5jAwMkxCykd6,8,5,3,0,2,0,1,0,11,1.5714285714285714,1,0.0,0,3,0,2,5,0,0,1,0,5,6,0
2488,119135,LU9kxt8aKnlOn8SnA2EuX2MLajf5Sg2a,RXDvfPUBYFlVdlueBFbLW0mhhAyGEqpt,8,4,2,0,2,0,3,0,11,1.5714285714285714,1,0.0,0,2,0,2,4,0,0,3,0,4,7,1
2489,119144,ppepyuI84wHcCSvA9T6Tm0AI9MVxK9O7,SpATywNh6bZuzm8s1ceuBUnMUAeoAHHw,5,5,4,0,2,0,1,0,12,1.7142857142857142,1,0.0,0,4,0,2,5,0,0,1,0,6,6,0
2490,119156,M2R4IY0V8T0jxOaASirvYDTUV5jV2Rus,bWdj2GDclj5ofokWjzoa5jAwMkxCykd6,4,2,0,0,0,0,2,0,4,0.5714285714285714,1,0.0,0,0,0,0,2,0,0,2,0,0,4,1
2491,119158,y71lRBqIdu5iPiLn9Yi5PQm6GFIvgLwB,SpATywNh6bZuzm8s1ceuBUnMUAeoAHHw,10,13,6,12,0,0,3,0,34,4.857142857142857,1,0.0,4,6,11,0,9,0,1,3,0,21,13,0
2492,119181,mu7Zdr1ChN6xNMWE8Otd7Si7TQhm7pEQ,A3fsA9Zfv1X2fVEQhTw51lKENdNrEqT3,5,6,3,0,0,0,3,0,12,1.7142857142857142,1,0.0,2,3,0,0,4,0,0,3,0,5,7,1
2493,119189,OXg5CDewbDZIhWJ50yEsGOqULuWAjfkH,SpATywNh6bZuzm8s1ceuBUnMUAeoAHHw,22,18,8,24,4,0,5,1,60,8.571428571428571,1,0.0,9,8,23,4,9,0,1,5,1,44,16,0
2494,119210,MgBJbfRXH0QNEJmIiGY28SpmFvbhxSoF,SpATywNh6bZuzm8s1ceuBUnMUAeoAHHw,18,34,14,14,4,2,8,0,76,10.857142857142858,2,0.0,3,14,13,4,31,2,1,8,0,34,42,0
2495,119216,jFlacyEy6lTVCBjW1JtG8q0M3te6pg5n,SpATywNh6bZuzm8s1ceuBUnMUAeoAHHw,8,8,7,0,4,0,1,0,20,2.857142857142857,1,0.0,0,7,0,4,8,0,0,1,0,11,9,1
2496,119226,62W3eQBI1VOzt0BqCcwSBPoLO4GuQy3m,SpATywNh6bZuzm8s1ceuBUnMUAeoAHHw,2,0,0,0,0,0,2,0,2,0.2857142857142857,1,0.0,0,0,0,0,0,0,0,2,0,0,2,1
2497,119227,xxkjaaKQsdSI27nMseGDTa7U8FtH9OJW,SpATywNh6bZuzm8s1ceuBUnMUAeoAHHw,1,0,0,0,0,0,1,0,1,0.14285714285714285,1,0.0,0,0,0,0,0,0,0,1,0,0,1,0
2498,119231,eZgbWFMeI0otfUV1lMfDbtMKCRIv32Fs,bWdj2GDclj5ofokWjzoa5jAwMkxCykd6,4,2,1,0,1,0,1,0,5,0.7142857142857143,1,0.0,0,1,0,1,2,0,0,1,0,2,3,1
2499,119244,l5XRpi9H4fQ2XUHeEPRXRHL6Y4BckIOB,SpATywNh6bZuzm8s1ceuBUnMUAeoAHHw,5,2,1,0,1,0,2,0,6,0.8571428571428571,1,0.0,0,1,0,1,2,0,0,2,0,2,4,1
2500,119254,i0ksX07HnsV5rQlWqOr1uKEuc7yNU24c,SpATywNh6bZuzm8s1ceuBUnMUAeoAHHw,9,7,5,0,3,0,3,0,18,2.5714285714285716,4,0.0,0,5,0,3,7,0,0,3,0,8,10,0
2501,119269,NLv4FgxnCzxez4sx4x5czDhMA2RThzip,bWdj2GDclj5ofokWjzoa5jAwMkxCykd6,5,2,1,0,1,0,2,0,6,0.8571428571428571,1,0.0,0,1,0,1,2,0,0,2,0,2,4,1
2502,119277,sBmxTL0paOf5h6iJST2iiGwB52qodqPr,bWdj2GDclj5ofokWjzoa5jAwMkxCykd6,9,12,8,4,1,0,4,0,29,4.142857142857143,2,0.0,0,8,4,1,12,0,0,4,0,13,16,0
2503,119279,FOCwtnRC84DvGRNwirqX2TIHG72pPbnw,SpATywNh6bZuzm8s1ceuBUnMUAeoAHHw,24,34,17,15,0,4,9,2,81,11.571428571428571,2,0.0,5,17,15,0,29,4,0,9,2,37,44,0
2504,119282,YoVBBM37O51IO7pPJxiQFT0wqXwSlTU1,SpATywNh6bZuzm8s1ceuBUnMUAeoAHHw,1,0,0,0,0,0,2,0,2,0.2857142857142857,1,0.0,0,0,0,0,0,0,0,2,0,0,2,1
2505,119311,o5C13ZWWgtJ11zB44EfcDF5SUBXAMxu8,SpATywNh6bZuzm8s1ceuBUnMUAeoAHHw,9,11,3,0,3,0,3,0,20,2.857142857142857,2,0.0,0,3,0,3,11,0,0,3,0,6,14,0
2506,119315,ektlnuTUH55osIRyBZ2zIfPZcGRkwXyX,SpATywNh6bZuzm8s1ceuBUnMUAeoAHHw,6,2,1,0,1,0,2,0,6,0.8571428571428571,1,0.0,0,1,0,1,2,0,0,2,0,2,4,1
2507,119333,om0KjvovtBK0gZUSboAPRv5A6Jkm00Ei,SpATywNh6bZuzm8s1ceuBUnMUAeoAHHw,1,0,0,0,0,0,1,0,1,0.14285714285714285,1,0.0,0,0,0,0,0,0,0,1,0,0,1,1
2508,119347,hpQLTEd5unsxchTVftQsLrZknN9z8sq4,bWdj2GDclj5ofokWjzoa5jAwMkxCykd6,6,4,1,0,1,0,2,0,8,1.1428571428571428,1,0.0,0,1,0,1,4,0,0,2,0,2,6,1
2509,119352,8EUVcR3i03tV4r6XHeEe98sUtzrKJPIp,SpATywNh6bZuzm8s1ceuBUnMUAeoAHHw,13,9,5,6,3,0,1,0,24,3.4285714285714284,2,0.0,2,5,6,3,7,0,0,1,0,16,8,0
2510,119354,dTKURyZ9dyqGbe4l7wsUGgSU85JHBAFq,SpATywNh6bZuzm8s1ceuBUnMUAeoAHHw,7,6,0,0,0,0,1,0,7,1.0,1,0.0,0,0,0,0,6,0,0,1,0,0,7,0
2511,119356,a7ZVMpb0c7CARO4liNTBsp4hgkFIkG4C,bWdj2GDclj5ofokWjzoa5jAwMkxCykd6,1,0,0,0,0,0,2,0,2,0.2857142857142857,1,0.0,0,0,0,0,0,0,0,2,0,0,2,1
2512,119380,6CE4R3S7kL46D5t23wqANpKa4VUqa9S2,SpATywNh6bZuzm8s1ceuBUnMUAeoAHHw,6,3,1,0,1,0,2,0,7,1.0,1,0.0,0,1,0,1,3,0,0,2,0,2,5,1
2513,119386,nIvIddlMAmTQagaACOulbZ6PInxlyOy2,SpATywNh6bZuzm8s1ceuBUnMUAeoAHHw,14,21,11,12,4,0,2,0,50,7.142857142857143,1,0.0,8,11,12,4,13,0,0,2,0,35,15,1
2514,119391,mxHDkP66knN7zmdYEUQKDHYwEophbx3W,SpATywNh6bZuzm8s1ceuBUnMUAeoAHHw,18,20,13,6,5,2,5,1,52,7.428571428571429,3,0.0,2,13,6,5,18,2,0,5,1,26,26,0
2515,119429,OTXI4wiLpFntQK2eNytsM7PA1sOBHBSJ,G8EPVSXsOYB5YQWZGiz1aVq5Pgr2GrQu,3,4,2,0,1,0,0,0,7,1.0,1,0.0,0,2,0,1,4,0,0,0,0,3,4,0
2516,119430,dHUuZjpItF11lyBzOZmo46k7ssSyfCST,SpATywNh6bZuzm8s1ceuBUnMUAeoAHHw,7,5,3,0,2,0,2,0,12,1.7142857142857142,1,0.0,0,3,0,2,5,0,0,2,0,5,7,1
2517,119467,HTcH1TxkMChxNxwRHZ3kkRRHs5Azwnka,SpATywNh6bZuzm8s1ceuBUnMUAeoAHHw,6,3,1,0,1,0,2,0,7,1.0,1,0.0,0,1,0,1,3,0,0,2,0,2,5,0
2518,119487,pPq1reHOvROgjdMRqZ7zZoFjsUW0sHcE,SpATywNh6bZuzm8s1ceuBUnMUAeoAHHw,5,7,4,0,1,0,2,0,14,2.0,1,0.0,0,4,0,1,7,0,0,2,0,5,9,1
2519,119490,83cBV2IXkwoW1nUaa1kxaJ98L3bxFsPn,RXDvfPUBYFlVdlueBFbLW0mhhAyGEqpt,20,31,21,16,0,19,6,0,93,13.285714285714286,4,0.0,5,21,15,0,26,19,1,6,0,41,52,1
2520,119494,4SbF4DhXcYorYYyJ4XmwwPJZFVh1ZUhY,bWdj2GDclj5ofokWjzoa5jAwMkxCykd6,2,0,0,0,0,0,2,0,2,0.2857142857142857,1,0.0,0,0,0,0,0,0,0,2,0,0,2,1
2521,119495,QXg7RHDSlJliIBbIO3xqJ8cmekKDZLIJ,RXDvfPUBYFlVdlueBFbLW0mhhAyGEqpt,1,0,0,0,0,0,1,0,1,0.14285714285714285,1,0.0,0,0,0,0,0,0,0,1,0,0,1,1
2522,119499,j55CnsxXtuPHDTIgqOvx7oExU3RRtQ4I,bWdj2GDclj5ofokWjzoa5jAwMkxCykd6,1,0,0,0,0,0,1,0,1,0.14285714285714285,1,0.0,0,0,0,0,0,0,0,1,0,0,1,1
2523,119506,KouA4JUz2i1n0FC6Xu2JucWPd7vnGUb0,SpATywNh6bZuzm8s1ceuBUnMUAeoAHHw,18,29,4,8,2,0,9,0,52,7.428571428571429,3,0.0,3,4,8,2,26,0,0,9,0,17,35,0
2524,119509,8MuGb55gUM18pukCITXgZoTSobqXs9G4,SpATywNh6bZuzm8s1ceuBUnMUAeoAHHw,9,7,0,14,0,2,1,0,24,3.4285714285714284,1,0.0,2,0,13,0,5,2,1,1,0,15,9,1
2525,119522,VC4hf15u71ct6dl0hPNvhbtubU19kXe5,RXDvfPUBYFlVdlueBFbLW0mhhAyGEqpt,7,10,1,0,2,0,1,0,14,2.0,1,0.0,2,1,0,2,8,0,0,1,0,5,9,1
2526,119524,RRKT0H2BFDE1dQIQFr3IpZgVIVSJVg71,SpATywNh6bZuzm8s1ceuBUnMUAeoAHHw,17,18,10,12,4,0,6,0,50,7.142857142857143,4,0.0,3,10,9,4,15,0,3,6,0,26,24,0
2527,119543,Cf7GCeUZzG7WjvUIyGfwv9hfcwXPVq5G,G8EPVSXsOYB5YQWZGiz1aVq5Pgr2GrQu,58,88,1,122,3,0,5,0,219,31.285714285714285,2,0.0,34,1,93,3,54,0,29,5,0,131,88,0
2528,119567,Dl433WBzpFXMdRxwA66dmtxmpsyN7fkX,SpATywNh6bZuzm8s1ceuBUnMUAeoAHHw,10,10,2,0,1,0,2,0,15,2.142857142857143,2,0.0,0,2,0,1,10,0,0,2,0,3,12,0
2529,119571,sZV7O4QepCcao3DEyr879t5mUWopWkVJ,SpATywNh6bZuzm8s1ceuBUnMUAeoAHHw,8,10,2,14,0,0,1,0,27,3.857142857142857,1,0.0,6,2,14,0,4,0,0,1,0,22,5,0
2530,119594,LKtddpPnbyASKztptrkj08yJIKu8wvyQ,SpATywNh6bZuzm8s1ceuBUnMUAeoAHHw,6,8,2,0,2,0,1,0,13,1.8571428571428572,1,0.0,0,2,0,2,8,0,0,1,0,4,9,1
2531,119600,SSpeewBDHUNKkvUJM5ASinNHvMXIOEwr,G8EPVSXsOYB5YQWZGiz1aVq5Pgr2GrQu,2,0,0,0,0,2,1,0,3,0.42857142857142855,1,0.0,0,0,0,0,0,2,0,1,0,0,3,1
2532,119619,nIvIddlMAmTQagaACOulbZ6PInxlyOy2,bWdj2GDclj5ofokWjzoa5jAwMkxCykd6,1,0,0,0,0,0,1,0,1,0.14285714285714285,1,0.0,0,0,0,0,0,0,0,1,0,0,1,1
2533,119631,ltVEinCK1OZ9CXJhcqdDg6iZlAvKKTwQ,SpATywNh6bZuzm8s1ceuBUnMUAeoAHHw,6,5,2,0,1,0,3,0,11,1.5714285714285714,1,0.0,2,2,0,1,3,0,0,3,0,5,6,0
2534,119652,Zu9dYhL9acZhCeqBcc9hWzPmaWR78jEQ,SpATywNh6bZuzm8s1ceuBUnMUAeoAHHw,13,8,5,12,3,0,1,0,29,4.142857142857143,1,0.0,2,5,11,3,6,0,1,1,0,21,8,1
2535,119657,3uRdpkkFK8afBf0m3EhgoX6LxrN8Pbes,SpATywNh6bZuzm8s1ceuBUnMUAeoAHHw,7,4,2,0,1,0,2,0,9,1.2857142857142858,1,0.0,0,2,0,1,4,0,0,2,0,3,6,1
2536,119664,8pu9JNwVnUBnBwmPCcdXCPyTfkNF9IyH,SpATywNh6bZuzm8s1ceuBUnMUAeoAHHw,1,0,0,0,0,0,1,0,1,0.14285714285714285,1,0.0,0,0,0,0,0,0,0,1,0,0,1,1
2537,119695,EGp6xRzNCnsCPDRg0mfvtfy8t2jZt4I9,SpATywNh6bZuzm8s1ceuBUnMUAeoAHHw,18,38,9,23,4,0,2,0,76,10.857142857142858,1,0.0,27,9,20,4,11,0,3,2,0,60,16,0
2538,119717,uNXbTIc96Uw6O7qA5DEUx7vv6h22TWxF,SpATywNh6bZuzm8s1ceuBUnMUAeoAHHw,5,2,1,0,1,0,2,0,6,0.8571428571428571,1,0.0,0,1,0,1,2,0,0,2,0,2,4,1
2539,119722,xdLtxzmqjHKGxCxWUtaHyGHCjlQjqauy,SpATywNh6bZuzm8s1ceuBUnMUAeoAHHw,5,2,1,0,1,0,2,0,6,0.8571428571428571,1,0.0,0,1,0,1,2,0,0,2,0,2,4,1
2540,119745,UvgRbw5a5wuG6YWcUt1dwOeNyn0b7Smd,SpATywNh6bZuzm8s1ceuBUnMUAeoAHHw,11,15,1,4,2,0,3,0,25,3.5714285714285716,4,0.0,3,1,4,2,12,0,0,3,0,10,15,1
2541,119756,xdLtxzmqjHKGxCxWUtaHyGHCjlQjqauy,RXDvfPUBYFlVdlueBFbLW0mhhAyGEqpt,6,1,1,0,1,0,3,0,6,0.8571428571428571,1,0.0,0,1,0,1,1,0,0,3,0,2,4,1
2542,119780,6r9w9XrCXpAInFHxfDIxOD9m18cX5jcd,bWdj2GDclj5ofokWjzoa5jAwMkxCykd6,1,0,0,0,0,0,1,0,1,0.14285714285714285,1,0.0,0,0,0,0,0,0,0,1,0,0,1,1
2543,119829,evMifCtMisukBDxvYkui0DyIUgVf4aQM,SpATywNh6bZuzm8s1ceuBUnMUAeoAHHw,1,0,0,0,0,0,1,0,1,0.14285714285714285,1,0.0,0,0,0,0,0,0,0,1,0,0,1,1
2544,119831,xrGttsK9FjNRictE1FckUAFqkfpHfKEh,bWdj2GDclj5ofokWjzoa5jAwMkxCykd6,13,14,8,64,3,2,4,2,97,13.857142857142858,1,0.0,1,8,63,3,13,2,1,4,2,75,22,1
2545,119853,uF2Lhc31StnMPtUmgamWrmnuCJ4n9iAe,bWdj2GDclj5ofokWjzoa5jAwMkxCykd6,7,2,1,0,1,1,5,1,11,1.5714285714285714,1,0.0,0,1,0,1,2,1,0,5,1,2,9,0
2546,119860,zvwdGnH0aGIXM4GZVb8XpCl4QdIDbhPS,G8EPVSXsOYB5YQWZGiz1aVq5Pgr2GrQu,26,48,13,7,8,5,22,1,104,14.857142857142858,2,0.0,11,13,5,8,37,5,2,22,1,37,67,1
2547,119863,C8zDhaG0vPsQegBtS55u3JZHiYuueFnE,A3fsA9Zfv1X2fVEQhTw51lKENdNrEqT3,1,0,0,0,0,0,2,0,2,0.2857142857142857,1,0.0,0,0,0,0,0,0,0,2,0,0,2,0
2548,119864,i9tnH9kRJ3DOJJRtKKsLYacNrvT4eUwS,SpATywNh6bZuzm8s1ceuBUnMUAeoAHHw,1,0,0,0,0,0,1,0,1,0.14285714285714285,1,0.0,0,0,0,0,0,0,0,1,0,0,1,1
2549,119865,fl8sEptrcl2JvFWXejFcnsM7BqWtKl9w,SpATywNh6bZuzm8s1ceuBUnMUAeoAHHw,25,49,19,28,9,0,3,0,108,15.428571428571429,3,0.0,18,19,19,9,31,0,9,3,0,65,43,1
2550,119866,VLCI0RtMsYSrwlXRiyKxAF4TijVOF7sG,SpATywNh6bZuzm8s1ceuBUnMUAeoAHHw,14,49,13,9,0,13,5,0,89,12.714285714285714,4,0.0,28,13,9,0,21,13,0,5,0,50,39,0
2551,119941,5rpYxIaCTDb4PhszkJWpACOx5VMpNGcQ,RXDvfPUBYFlVdlueBFbLW0mhhAyGEqpt,1,0,0,0,0,0,1,0,1,0.14285714285714285,1,0.0,0,0,0,0,0,0,0,1,0,0,1,1
2552,119944,ico4mWfX6sj6OUii1pav0Sth51UYo7la,SpATywNh6bZuzm8s1ceuBUnMUAeoAHHw,4,2,1,0,1,0,1,0,5,0.7142857142857143,1,0.0,0,1,0,1,2,0,0,1,0,2,3,1
2553,119957,u08BFRXkclhXgm6zX4b6QASKB5vRi3vI,G8EPVSXsOYB5YQWZGiz1aVq5Pgr2GrQu,32,39,22,295,8,10,10,0,384,54.857142857142854,3,0.0,9,22,286,8,30,10,9,10,0,325,59,1
2554,119963,CjBVUSApACPW9BPUvs2DTjIpAnotUs5g,SpATywNh6bZuzm8s1ceuBUnMUAeoAHHw,14,18,1,19,1,1,9,1,50,7.142857142857143,1,0.0,11,1,16,1,7,1,3,9,1,29,21,1
2555,119979,SplRKhPt7Yggv7MXNRiesXXwYzrLK9vJ,G8EPVSXsOYB5YQWZGiz1aVq5Pgr2GrQu,3,3,1,0,1,0,0,0,5,0.7142857142857143,2,0.0,0,1,0,1,3,0,0,0,0,2,3,1
2556,120002,12gMTBWTVUlnqCedZPd5qmMR4GGhf0zr,SpATywNh6bZuzm8s1ceuBUnMUAeoAHHw,5,4,2,0,0,0,2,1,9,1.2857142857142858,1,0.0,0,2,0,0,4,0,0,2,1,2,7,1
2557,120012,i2raPzmlvNePAOSFdEUwI0BA2bKyQ3vM,G8EPVSXsOYB5YQWZGiz1aVq5Pgr2GrQu,1,0,0,0,0,0,1,0,1,0.14285714285714285,1,0.0,0,0,0,0,0,0,0,1,0,0,1,1
2558,120034,ZdyJOuWyQCEC2K6zkBmHBJ8KuSKqmluL,SpATywNh6bZuzm8s1ceuBUnMUAeoAHHw,1,0,0,0,0,0,1,0,1,0.14285714285714285,1,0.0,0,0,0,0,0,0,0,1,0,0,1,1
2559,120045,sUwmc6V8FwsEYMDv4tIg9OLo8ph5JoxU,SpATywNh6bZuzm8s1ceuBUnMUAeoAHHw,21,21,13,25,11,1,4,1,76,10.857142857142858,1,0.0,6,13,20,11,15,1,5,4,1,50,26,1
2560,120047,YeW4hKsNTCNPhFuRao1EDcfgQ0cnIKSL,SpATywNh6bZuzm8s1ceuBUnMUAeoAHHw,17,23,10,19,4,2,6,0,64,9.142857142857142,3,0.0,5,10,16,4,18,2,3,6,0,35,29,0
2561,120057,UUY3BPLR7A3Xa6FGsztMCn6xCbxtdCYu,RXDvfPUBYFlVdlueBFbLW0mhhAyGEqpt,1,0,0,0,0,0,1,0,1,0.14285714285714285,1,0.0,0,0,0,0,0,0,0,1,0,0,1,0
2562,120079,L8OTKfJAxDSZZQ12fQtkWrcZUlsGAJb9,RXDvfPUBYFlVdlueBFbLW0mhhAyGEqpt,18,28,9,24,5,4,12,0,82,11.714285714285714,2,0.0,8,9,24,5,20,4,0,12,0,46,36,1
2563,120090,ZOVfvlm206voHlGJ4V6McNGjtxTxB7JQ,bWdj2GDclj5ofokWjzoa5jAwMkxCykd6,3,2,1,0,0,0,2,0,5,0.7142857142857143,1,0.0,0,1,0,0,2,0,0,2,0,1,4,1
2564,120094,rn4nO5004kgupfgjaXh0qv5wJPGuOGCi,RXDvfPUBYFlVdlueBFbLW0mhhAyGEqpt,44,120,1,107,33,0,10,1,272,38.857142857142854,2,0.0,74,1,85,33,46,0,22,10,1,193,79,1
2565,120112,1mkiIDsUp1k3i5MLWwlZyMuhsxinTdaD,SpATywNh6bZuzm8s1ceuBUnMUAeoAHHw,2,0,0,0,0,0,2,0,2,0.2857142857142857,1,0.0,0,0,0,0,0,0,0,2,0,0,2,0
2566,120117,rZEWlNSgKDNaTi3a1r581EGtpdBLkfvY,bWdj2GDclj5ofokWjzoa5jAwMkxCykd6,4,2,1,0,1,6,1,0,11,1.5714285714285714,1,0.0,0,1,0,1,2,6,0,1,0,2,9,1
2567,120128,5cb6e9jDwVr8l5vkAvM3VmmyddxE34Qz,SpATywNh6bZuzm8s1ceuBUnMUAeoAHHw,13,8,5,13,3,0,1,0,30,4.285714285714286,1,0.0,2,5,13,3,6,0,0,1,0,23,7,1
2568,120139,n82RJkzFXSSDMIdkMmtipPuRNBWDUBXQ,SpATywNh6bZuzm8s1ceuBUnMUAeoAHHw,4,6,3,0,0,0,4,3,16,2.2857142857142856,1,0.0,0,3,0,0,6,0,0,4,3,3,13,1
2569,120195,1LkX4t7QGG0LPbqqJvnwJmrweFNAYkvm,A3fsA9Zfv1X2fVEQhTw51lKENdNrEqT3,5,3,1,0,0,0,2,0,6,0.8571428571428571,1,0.0,0,1,0,0,3,0,0,2,0,1,5,1
2570,120215,UnBwSmlOPbYUmVq2fUKodPbT52jzjDn0,A3fsA9Zfv1X2fVEQhTw51lKENdNrEqT3,13,12,11,0,7,0,2,0,32,4.571428571428571,1,0.0,0,11,0,7,12,0,0,2,0,18,14,0
2571,120223,nrDkIZH2wqEVh6i4pBxcbRBJIMc9s20b,G8EPVSXsOYB5YQWZGiz1aVq5Pgr2GrQu,23,17,1,84,0,0,4,0,106,15.142857142857142,1,0.0,2,1,74,0,15,0,10,4,0,77,29,0
2572,120226,Y9zzxa8aT5mj3vCCOFRszZ8rRbH90TaX,SpATywNh6bZuzm8s1ceuBUnMUAeoAHHw,5,2,1,0,1,0,2,0,6,0.8571428571428571,1,0.0,0,1,0,1,2,0,0,2,0,2,4,1
2573,120232,RYd1k9DojojPZwrkV3NjsTI5OdZnPV9W,SpATywNh6bZuzm8s1ceuBUnMUAeoAHHw,3,2,0,0,0,0,2,0,4,0.5714285714285714,1,0.0,0,0,0,0,2,0,0,2,0,0,4,0
2574,120235,RYd1k9DojojPZwrkV3NjsTI5OdZnPV9W,RXDvfPUBYFlVdlueBFbLW0mhhAyGEqpt,5,5,0,0,0,0,2,0,7,1.0,1,0.0,0,0,0,0,5,0,0,2,0,0,7,1
2575,120239,80Av2RXrFoxNOdv7EQUM2TDOM0gyNH0J,SpATywNh6bZuzm8s1ceuBUnMUAeoAHHw,25,19,12,27,7,13,3,0,81,11.571428571428571,2,0.0,2,12,23,7,17,13,4,3,0,44,37,1
2576,120266,kV6dnmPo3GuG7esOG3uZN9iddNOehLbM,SpATywNh6bZuzm8s1ceuBUnMUAeoAHHw,8,8,1,0,1,0,4,0,14,2.0,1,0.0,0,1,0,1,8,0,0,4,0,2,12,1
2577,120288,MWFzxiL4ehMt7chFh9qPkkqOh2NLyxIv,bWdj2GDclj5ofokWjzoa5jAwMkxCykd6,2,0,0,0,0,0,2,0,2,0.2857142857142857,1,0.0,0,0,0,0,0,0,0,2,0,0,2,1
2578,120297,7xobbz91DmuqnSowtdCPvlArDkv1wvpY,bWdj2GDclj5ofokWjzoa5jAwMkxCykd6,3,2,0,0,0,0,6,0,8,1.1428571428571428,3,0.0,0,0,0,0,2,0,0,6,0,0,8,0
2579,120300,8ZCGZdwxBMJVwPZ7vVYEdVzHcXfqVToG,SpATywNh6bZuzm8s1ceuBUnMUAeoAHHw,26,29,7,39,4,24,14,3,120,17.142857142857142,2,0.0,9,7,34,4,20,24,5,14,3,54,66,1
2580,120301,R65nId6muEQL5ltvz9x70wBSJAG43Ylw,SpATywNh6bZuzm8s1ceuBUnMUAeoAHHw,1,0,0,0,0,0,1,0,1,0.14285714285714285,1,0.0,0,0,0,0,0,0,0,1,0,0,1,1
2581,120319,SslryCWQFxjgJq7Qzkpxu4WYyOvHjfIA,SpATywNh6bZuzm8s1ceuBUnMUAeoAHHw,11,17,0,10,0,0,3,0,30,4.285714285714286,1,0.0,2,0,9,0,15,0,1,3,0,11,19,1
2582,120324,BFpj8Vxul230N4kCbxR9rjWJ12ZQLtAV,RXDvfPUBYFlVdlueBFbLW0mhhAyGEqpt,11,30,1,0,2,0,5,1,39,5.571428571428571,2,0.0,2,1,0,2,28,0,0,5,1,5,34,0
2583,120327,gxxdbeVvaQEKyOVBSC4fF8ei2zEnQClv,SpATywNh6bZuzm8s1ceuBUnMUAeoAHHw,7,3,3,0,2,0,3,0,11,1.5714285714285714,1,0.0,0,3,0,2,3,0,0,3,0,5,6,1
2584,120357,v5FeWqSlnditqY6z5ibAMUPKlbcY2Zcg,bWdj2GDclj5ofokWjzoa5jAwMkxCykd6,1,0,0,0,0,0,1,0,1,0.14285714285714285,1,0.0,0,0,0,0,0,0,0,1,0,0,1,1
2585,120395,jFlacyEy6lTVCBjW1JtG8q0M3te6pg5n,RXDvfPUBYFlVdlueBFbLW0mhhAyGEqpt,4,3,2,0,1,0,1,0,7,1.0,1,0.0,0,2,0,1,3,0,0,1,0,3,4,1
2586,120424,PazYalgu71qbC99y9FrRjNpcniWiR2x1,RXDvfPUBYFlVdlueBFbLW0mhhAyGEqpt,11,5,4,0,2,0,4,1,16,2.2857142857142856,1,0.0,0,4,0,2,5,0,0,4,1,6,10,1
2587,120452,5PCeecJ7dPIRTUfiwjNNMWT45OJxiKsA,SpATywNh6bZuzm8s1ceuBUnMUAeoAHHw,14,21,8,20,1,0,3,0,53,7.571428571428571,2,0.0,9,8,16,1,12,0,4,3,0,34,19,1
2588,120497,pb5Jjq3Ash9pKloUfJAc3dsHOjXwUSUN,SpATywNh6bZuzm8s1ceuBUnMUAeoAHHw,3,4,0,0,0,0,2,0,6,0.8571428571428571,1,0.0,0,0,0,0,4,0,0,2,0,0,6,1
2589,120499,5scsz5bGh8T1roTXhO7UpMXlEDKIsK9l,SpATywNh6bZuzm8s1ceuBUnMUAeoAHHw,6,8,3,0,1,0,1,0,13,1.8571428571428572,1,0.0,3,3,0,1,5,0,0,1,0,7,6,1
2590,120528,QHRLeTLFcpDFqErTvT3KvB62zPnO9tRZ,SpATywNh6bZuzm8s1ceuBUnMUAeoAHHw,4,4,0,0,0,0,1,0,5,0.7142857142857143,1,0.0,0,0,0,0,4,0,0,1,0,0,5,1
2591,120544,OektSQ9TNN3cEy3ZKuUs35c7BdSOqtaQ,bWdj2GDclj5ofokWjzoa5jAwMkxCykd6,7,7,4,0,1,0,7,0,19,2.7142857142857144,1,0.0,0,4,0,1,7,0,0,7,0,5,14,1
2592,120579,s7QoBInBc5uVUNfTUCWn8dY2DMQUeNQJ,SpATywNh6bZuzm8s1ceuBUnMUAeoAHHw,6,1,1,0,1,1,3,1,8,1.1428571428571428,1,0.0,0,1,0,1,1,1,0,3,1,2,6,1
2593,120583,cOTtp4pVPpt9GEFdMZaLCIG1IBXouqo8,SpATywNh6bZuzm8s1ceuBUnMUAeoAHHw,2,0,0,0,0,0,2,0,2,0.2857142857142857,1,0.0,0,0,0,0,0,0,0,2,0,0,2,1
2594,120613,o5eh9IEuVj6wwGOFQd5A60hJwFcyh5aW,SpATywNh6bZuzm8s1ceuBUnMUAeoAHHw,2,0,0,0,0,0,2,0,2,0.2857142857142857,1,0.0,0,0,0,0,0,0,0,2,0,0,2,1
2595,120641,bVdTa6NU9Mptus5JV6dyU7pKOHw1EO1M,bWdj2GDclj5ofokWjzoa5jAwMkxCykd6,1,0,0,0,0,0,1,0,1,0.14285714285714285,1,0.0,0,0,0,0,0,0,0,1,0,0,1,1
2596,120674,cR6ka5k7tAsfYo9cLOUPkpzWO6OItcGJ,G8EPVSXsOYB5YQWZGiz1aVq5Pgr2GrQu,17,18,16,6,12,0,2,0,54,7.714285714285714,2,0.0,0,16,5,12,18,0,1,2,0,33,21,1
2597,120686,u5ObOMoHUcvVsOQTGkiv0BRKKcn8v2w8,bWdj2GDclj5ofokWjzoa5jAwMkxCykd6,4,2,1,0,1,0,1,0,5,0.7142857142857143,1,0.0,0,1,0,1,2,0,0,1,0,2,3,1
2598,120697,FJyrOX14z7chWU6pIsUghN5yUhlIZ5Lj,SpATywNh6bZuzm8s1ceuBUnMUAeoAHHw,3,2,0,0,0,0,2,0,4,0.5714285714285714,1,0.0,0,0,0,0,2,0,0,2,0,0,4,0
2599,120703,4dodDlxC4kpDOhgavFhn4UZKBioEfZ2a,SpATywNh6bZuzm8s1ceuBUnMUAeoAHHw,6,4,1,0,1,0,9,0,15,2.142857142857143,2,0.0,0,1,0,1,4,0,0,9,0,2,13,1
2600,120716,RhtPF62U20vYvwTeCimLFb40aCkmO2cH,SpATywNh6bZuzm8s1ceuBUnMUAeoAHHw,5,2,1,0,1,0,2,0,6,0.8571428571428571,1,0.0,0,1,0,1,2,0,0,2,0,2,4,1
2601,120722,1R1zO9aMB7Mx1Lw84JzsChVEV5JpwmZv,G8EPVSXsOYB5YQWZGiz1aVq5Pgr2GrQu,40,48,11,96,7,0,10,0,172,24.571428571428573,4,0.0,16,11,74,7,32,0,22,10,0,108,64,1
2602,120751,fTZGf1uwMtb2LTyvoTILgCp8LRW0SKIe,RXDvfPUBYFlVdlueBFbLW0mhhAyGEqpt,2,1,1,0,0,0,0,0,2,0.2857142857142857,1,0.0,0,1,0,0,1,0,0,0,0,1,1,1
2603,120771,IvdoAzckjyWWCkzCy6V0BjWvOwMyZEwg,bWdj2GDclj5ofokWjzoa5jAwMkxCykd6,6,7,4,0,0,0,2,0,13,1.8571428571428572,2,0.0,0,4,0,0,7,0,0,2,0,4,9,1
2604,120774,7hx1Kw9WXBMDyaoF5WfFzTdCBmNZ2uMk,SpATywNh6bZuzm8s1ceuBUnMUAeoAHHw,13,12,3,0,3,1,9,0,28,4.0,1,0.0,0,3,0,3,12,1,0,9,0,6,22,1
2605,120788,qwhxcjW9iIMBAQoGSWDtst34AFkcFQoV,G8EPVSXsOYB5YQWZGiz1aVq5Pgr2GrQu,6,6,3,0,0,0,4,0,13,1.8571428571428572,2,0.0,0,3,0,0,6,0,0,4,0,3,10,0
2606,120808,OTAUIgoWBEWsq2kd8lnvB0dKpj3SXEdR,SpATywNh6bZuzm8s1ceuBUnMUAeoAHHw,8,5,4,0,3,0,2,0,14,2.0,1,0.0,0,4,0,3,5,0,0,2,0,7,7,1
2607,120818,hn9Zjyg7I7mBsVCg91jyZTDh6RPM5yRT,G8EPVSXsOYB5YQWZGiz1aVq5Pgr2GrQu,2,0,0,0,0,0,2,0,2,0.2857142857142857,2,0.0,0,0,0,0,0,0,0,2,0,0,2,0
2608,120824,tCQ9JALurTpI0v0jgUfmOoOzw21YvN4S,SpATywNh6bZuzm8s1ceuBUnMUAeoAHHw,1,0,0,0,0,0,1,0,1,0.14285714285714285,1,0.0,0,0,0,0,0,0,0,1,0,0,1,1
2609,120835,EaFWRMbtKR52j7nbPydGVwuzgPsml9aN,A3fsA9Zfv1X2fVEQhTw51lKENdNrEqT3,8,5,3,0,0,7,10,1,26,3.7142857142857144,1,0.0,0,3,0,0,5,7,0,10,1,3,23,1
2610,120839,A1aBNAF3YIuzOOCwNaMQAGMwKE189BXm,bWdj2GDclj5ofokWjzoa5jAwMkxCykd6,6,5,1,38,2,0,2,0,48,6.857142857142857,1,0.0,3,1,36,2,2,0,2,2,0,42,6,1
2611,120845,W8fFTJpe1dBAUeFKonCjFttbIjzEdynN,bWdj2GDclj5ofokWjzoa5jAwMkxCykd6,1,0,0,0,0,0,1,0,1,0.14285714285714285,1,0.0,0,0,0,0,0,0,0,1,0,0,1,1
2612,120853,DPc69RrqfbFv98j4qSzKI4WCbxWESHfA,SpATywNh6bZuzm8s1ceuBUnMUAeoAHHw,5,2,1,0,1,0,2,0,6,0.8571428571428571,1,0.0,0,1,0,1,2,0,0,2,0,2,4,1
2613,120861,bRG3KNKPz8MtEb5G1Duc4i5IiNMa8ZLU,G8EPVSXsOYB5YQWZGiz1aVq5Pgr2GrQu,5,4,1,0,0,0,1,0,6,0.8571428571428571,1,0.0,0,1,0,0,4,0,0,1,0,1,5,1
2614,120866,mVNF27p0nlEqUBMpiQFD5RxVmxKtsSbe,bWdj2GDclj5ofokWjzoa5jAwMkxCykd6,1,0,0,0,0,0,1,0,1,0.14285714285714285,1,0.0,0,0,0,0,0,0,0,1,0,0,1,1
2615,120892,pAkhnLI0s5vboktZycO7Tobv6jbspULh,SpATywNh6bZuzm8s1ceuBUnMUAeoAHHw,12,10,8,0,6,0,3,0,27,3.857142857142857,2,0.0,0,8,0,6,10,0,0,3,0,14,13,1
2616,120894,dQweEcdBCmNmUPOeO7X4TTmH8zuMq2aJ,A3fsA9Zfv1X2fVEQhTw51lKENdNrEqT3,12,12,6,0,2,1,9,0,30,4.285714285714286,2,0.0,1,6,0,2,11,1,0,9,0,9,21,1
2617,120906,Z9nbZek76s4RBuA56w1WtME3e9ClZkaP,A3fsA9Zfv1X2fVEQhTw51lKENdNrEqT3,5,3,2,0,1,0,1,0,7,1.0,1,0.0,0,2,0,1,3,0,0,1,0,3,4,0
2618,120907,m83RtezfCwMfEmG0rXtpbc1svhl7ugt0,SpATywNh6bZuzm8s1ceuBUnMUAeoAHHw,4,3,1,0,1,0,1,0,6,0.8571428571428571,1,0.0,0,1,0,1,3,0,0,1,0,2,4,1
2619,120909,aldLXGpzmiip2CUSDhqN8A5UpGMVUHxY,A3fsA9Zfv1X2fVEQhTw51lKENdNrEqT3,58,24,17,116,7,0,10,0,174,24.857142857142858,4,0.0,2,17,110,7,22,0,6,10,0,136,38,0
2620,120915,i8nJS6rmQ6UIbavrvT6pTvkCZLUx9z01,SpATywNh6bZuzm8s1ceuBUnMUAeoAHHw,3,4,0,0,0,0,1,0,5,0.7142857142857143,1,0.0,0,0,0,0,4,0,0,1,0,0,5,1
2621,120928,sApH95kwlTdIi3RvuRD74A0dFhVPKais,SpATywNh6bZuzm8s1ceuBUnMUAeoAHHw,9,12,3,0,2,2,7,0,26,3.7142857142857144,1,0.0,0,3,0,2,12,2,0,7,0,5,21,1
2622,120930,fHz7VQRoJHHTDfRPDpvJLuPlruuvrNnm,SpATywNh6bZuzm8s1ceuBUnMUAeoAHHw,23,30,1,29,1,0,12,0,73,10.428571428571429,2,0.0,11,1,26,1,19,0,3,12,0,39,34,1
2623,120937,qVkkNycc5Psi9bXy8jDUR44I6IjXsj9g,bWdj2GDclj5ofokWjzoa5jAwMkxCykd6,2,0,0,0,0,0,2,0,2,0.2857142857142857,1,0.0,0,0,0,0,0,0,0,2,0,0,2,1
2624,120944,jcYhugRahKquP2fynVIQQrbdtwxaAHse,G8EPVSXsOYB5YQWZGiz1aVq5Pgr2GrQu,1,0,0,0,0,0,1,0,1,0.14285714285714285,1,0.0,0,0,0,0,0,0,0,1,0,0,1,1
2625,120949,ONK0Esb7fhLc69POI06k3Sj1alNC6Fij,SpATywNh6bZuzm8s1ceuBUnMUAeoAHHw,3,2,1,0,0,0,2,0,5,0.7142857142857143,2,0.0,0,1,0,0,2,0,0,2,0,1,4,0
2626,120966,JCDOEMgsanA2Wd8RJtg9ctpT52Gae7ak,bWdj2GDclj5ofokWjzoa5jAwMkxCykd6,7,8,2,0,1,0,5,0,16,2.2857142857142856,2,0.0,0,2,0,1,8,0,0,5,0,3,13,0
2627,120973,VsZvGrXbL1e6v6hmpJQH8MldIkCBO9P7,RXDvfPUBYFlVdlueBFbLW0mhhAyGEqpt,26,35,12,56,8,2,4,0,117,16.714285714285715,1,0.0,12,12,51,8,23,2,5,4,0,83,34,0
2628,120975,KjHOE07fI9pBFKqiwhrvCwjITj7tyFWN,G8EPVSXsOYB5YQWZGiz1aVq5Pgr2GrQu,21,26,13,0,11,0,11,1,62,8.857142857142858,3,0.0,6,13,0,11,20,0,0,11,1,30,32,1
2629,120979,VsZvGrXbL1e6v6hmpJQH8MldIkCBO9P7,A3fsA9Zfv1X2fVEQhTw51lKENdNrEqT3,22,19,9,74,3,0,7,0,112,16.0,2,0.0,0,9,68,3,19,0,6,7,0,80,32,1
2630,120982,JBjDnQZVwVLGdsvKJqTw57nrx9uYY0vn,A3fsA9Zfv1X2fVEQhTw51lKENdNrEqT3,4,15,0,0,0,0,0,0,15,2.142857142857143,1,0.0,0,0,0,0,15,0,0,0,0,0,15,0
2631,120999,evts3oSRq3OSuFymJPKdix8vzAStq0uA,G8EPVSXsOYB5YQWZGiz1aVq5Pgr2GrQu,2,0,0,0,0,0,2,0,2,0.2857142857142857,1,0.0,0,0,0,0,0,0,0,2,0,0,2,1
2632,121006,fiuPlQpFhdwy7ZB3d9YZTvFtxVmpTcZ2,SpATywNh6bZuzm8s1ceuBUnMUAeoAHHw,8,10,1,0,1,0,6,0,18,2.5714285714285716,2,0.0,0,1,0,1,10,0,0,6,0,2,16,1
2633,121019,bA4tnPZD0UU4XAL3OkL7nUjtkAzbgj9d,A3fsA9Zfv1X2fVEQhTw51lKENdNrEqT3,6,8,5,0,1,0,2,0,16,2.2857142857142856,2,0.0,1,5,0,1,7,0,0,2,0,7,9,1
2634,121023,TzRDOFjVsHxcJLvrJENTAv7iaJPhFHB5,SpATywNh6bZuzm8s1ceuBUnMUAeoAHHw,10,5,4,0,3,0,2,0,14,2.0,2,0.0,0,4,0,3,5,0,0,2,0,7,7,1
2635,121044,KkBPwixR7onoXlZ2HnK8cYokgUE3P396,A3fsA9Zfv1X2fVEQhTw51lKENdNrEqT3,1,0,0,0,0,0,1,0,1,0.14285714285714285,1,0.0,0,0,0,0,0,0,0,1,0,0,1,1
2636,121048,nwFT4lnmg30fCvHRB6tbALo9FpcanuLx,bWdj2GDclj5ofokWjzoa5jAwMkxCykd6,7,6,2,0,2,0,2,0,12,1.7142857142857142,1,0.0,0,2,0,2,6,0,0,2,0,4,8,0
2637,121066,gV1Y6A8RpgDuAD47r6UGF54v9TD2f7uU,bWdj2GDclj5ofokWjzoa5jAwMkxCykd6,6,3,1,0,1,0,2,0,7,1.0,1,0.0,0,1,0,1,3,0,0,2,0,2,5,1
2638,121100,8mYFryxeRH8GSnHog9hmhUPRk60LCyFI,SpATywNh6bZuzm8s1ceuBUnMUAeoAHHw,14,16,14,0,7,0,7,0,44,6.285714285714286,2,0.0,0,14,0,7,16,0,0,7,0,21,23,1
2639,121105,M8ur292SdHouJ1LnQyJMDkHJM5sUPxnX,SpATywNh6bZuzm8s1ceuBUnMUAeoAHHw,13,20,1,3,3,0,5,0,32,4.571428571428571,3,0.0,6,1,3,3,14,0,0,5,0,13,19,0
2640,121134,4IxaKtzWvkfFEFZ43UhJQOyIahcBxrF2,SpATywNh6bZuzm8s1ceuBUnMUAeoAHHw,17,27,1,12,1,0,6,0,47,6.714285714285714,3,0.0,2,1,11,1,25,0,1,6,0,15,32,1
2641,121136,kHp5QZURLzbWn4koqFYZnQmO0kliz5hb,SpATywNh6bZuzm8s1ceuBUnMUAeoAHHw,16,10,6,14,4,0,1,0,35,5.0,1,0.0,2,6,11,4,8,0,3,1,0,23,12,1
2642,121174,BK9rzOWePcPYHbJ23OB9suKImXFOyhRl,bWdj2GDclj5ofokWjzoa5jAwMkxCykd6,10,8,1,0,1,5,9,4,28,4.0,1,0.0,0,1,0,1,8,5,0,9,4,2,26,1
2643,121191,MbmumbK7FHZlEn2oNe4YMQEQzBas1u6w,bWdj2GDclj5ofokWjzoa5jAwMkxCykd6,12,21,10,6,5,6,11,2,61,8.714285714285714,2,0.0,3,10,5,5,18,6,1,11,2,23,38,0
2644,121196,VdaBmv5ItdWz4RwMA62FKAWjG3bRe1Fn,SpATywNh6bZuzm8s1ceuBUnMUAeoAHHw,4,3,1,0,1,0,1,0,6,0.8571428571428571,1,0.0,0,1,0,1,3,0,0,1,0,2,4,1
2645,121216,kepzW866hAW80jPanDRXCDYAup0gf1qr,bWdj2GDclj5ofokWjzoa5jAwMkxCykd6,4,2,1,0,1,0,1,0,5,0.7142857142857143,1,0.0,0,1,0,1,2,0,0,1,0,2,3,0
2646,121220,XOhs3C3hEbYCXLCkazKW0gKNbUWn1jg2,SpATywNh6bZuzm8s1ceuBUnMUAeoAHHw,8,6,3,0,3,0,4,0,16,2.2857142857142856,1,0.0,0,3,0,3,6,0,0,4,0,6,10,1
2647,121271,GAKCidUQ8hdeh0WMwEYlK9cUZXNPRN5R,SpATywNh6bZuzm8s1ceuBUnMUAeoAHHw,7,2,1,0,1,0,7,1,12,1.7142857142857142,2,0.0,0,1,0,1,2,0,0,7,1,2,10,1
2648,121284,Sb4VRiha9yR6Zwo717x7pWDjO7cnV2Bc,A3fsA9Zfv1X2fVEQhTw51lKENdNrEqT3,2,0,0,0,0,0,2,0,2,0.2857142857142857,1,0.0,0,0,0,0,0,0,0,2,0,0,2,1
2649,121303,33pzyjn4blqUcVq0e7rGSyVoVXsnplTp,SpATywNh6bZuzm8s1ceuBUnMUAeoAHHw,5,1,1,0,1,0,3,0,6,0.8571428571428571,1,0.0,0,1,0,1,1,0,0,3,0,2,4,1
2650,121304,WOGsOMHGMnkSlS91ohBsyVdWGOJVOnT1,G8EPVSXsOYB5YQWZGiz1aVq5Pgr2GrQu,2,0,0,0,0,0,2,0,2,0.2857142857142857,1,0.0,0,0,0,0,0,0,0,2,0,0,2,1
2651,121313,VrcAU2QLiPqVHHKHjhnkgJoQe1xmnYFr,SpATywNh6bZuzm8s1ceuBUnMUAeoAHHw,4,2,1,0,1,0,1,0,5,0.7142857142857143,1,0.0,0,1,0,1,2,0,0,1,0,2,3,1
2652,121328,o1wU0MfzmEznHSZOZDS8DejIhVczhoMt,A3fsA9Zfv1X2fVEQhTw51lKENdNrEqT3,1,0,0,0,0,0,2,0,2,0.2857142857142857,1,0.0,0,0,0,0,0,0,0,2,0,0,2,1
2653,121330,o1wU0MfzmEznHSZOZDS8DejIhVczhoMt,bWdj2GDclj5ofokWjzoa5jAwMkxCykd6,1,0,0,0,0,0,2,0,2,0.2857142857142857,1,0.0,0,0,0,0,0,0,0,2,0,0,2,1
2654,121339,oKz0rKWQtHW8DkPwxTgdemWb21NvE4BO,SpATywNh6bZuzm8s1ceuBUnMUAeoAHHw,23,33,1,35,0,10,8,0,87,12.428571428571429,3,0.0,17,1,33,0,16,10,2,8,0,51,36,1
2655,121345,ePaTLgBKhclwas3ClxzVVmTCgYzhx4go,SpATywNh6bZuzm8s1ceuBUnMUAeoAHHw,13,20,0,23,0,14,2,0,59,8.428571428571429,1,0.0,6,0,19,0,14,14,4,2,0,25,34,0
2656,121373,HSjT6fK4xHlufEG141acXPeMw5gqxgnK,G8EPVSXsOYB5YQWZGiz1aVq5Pgr2GrQu,6,1,1,0,1,0,3,1,7,1.0,1,0.0,0,1,0,1,1,0,0,3,1,2,5,1
2657,121391,7af3IyECXIPSWoeM4guaEGHMHNE9EYdr,A3fsA9Zfv1X2fVEQhTw51lKENdNrEqT3,1,0,0,0,0,0,1,0,1,0.14285714285714285,1,0.0,0,0,0,0,0,0,0,1,0,0,1,1
2658,121405,H8Mro2560yUzikYuATdEg57a9V5oxWPK,bWdj2GDclj5ofokWjzoa5jAwMkxCykd6,1,0,0,0,0,0,2,0,2,0.2857142857142857,1,0.0,0,0,0,0,0,0,0,2,0,0,2,1
2659,121415,5tRF7MIiw9rvKGI9GzHJVDzIS50Mqb8o,RXDvfPUBYFlVdlueBFbLW0mhhAyGEqpt,7,11,0,0,0,0,3,0,14,2.0,1,0.0,1,0,0,0,10,0,0,3,0,1,13,1
2660,121424,vthDe5chpuGwbDUyc90EI2Y8jHRBb15H,bWdj2GDclj5ofokWjzoa5jAwMkxCykd6,4,2,1,0,1,0,1,0,5,0.7142857142857143,1,0.0,0,1,0,1,2,0,0,1,0,2,3,1
2661,121438,3w2Xuq08gulsgNUr7oA3MOaceNv4Akte,bWdj2GDclj5ofokWjzoa5jAwMkxCykd6,15,22,10,50,6,5,6,0,99,14.142857142857142,2,0.0,8,10,46,6,14,5,4,6,0,70,29,1
2662,121446,Haz3G1DnETqwzmdUg5ALbCZo1Lv5wDs9,SpATywNh6bZuzm8s1ceuBUnMUAeoAHHw,28,26,17,30,9,3,5,0,90,12.857142857142858,2,0.0,6,17,27,9,20,3,3,5,0,59,31,1
2663,121452,NoyfNn91CGqIll5CyV3XCcTClgT3U7jT,A3fsA9Zfv1X2fVEQhTw51lKENdNrEqT3,2,0,0,0,0,0,2,0,2,0.2857142857142857,1,0.0,0,0,0,0,0,0,0,2,0,0,2,1
2664,121455,I8yPwCESlVyB1LCVpuWYAkN68pAAeUAB,G8EPVSXsOYB5YQWZGiz1aVq5Pgr2GrQu,4,3,2,0,2,0,1,0,8,1.1428571428571428,1,0.0,0,2,0,2,3,0,0,1,0,4,4,1
2665,121473,kEe7j5p6NF8FFSn6q8Y544hGSIcyGGey,G8EPVSXsOYB5YQWZGiz1aVq5Pgr2GrQu,1,0,0,0,0,0,1,0,1,0.14285714285714285,1,0.0,0,0,0,0,0,0,0,1,0,0,1,1
2666,121532,OUbh6hvaOJDp9RK7kgTBzzPmjzmkYhZF,A3fsA9Zfv1X2fVEQhTw51lKENdNrEqT3,57,33,0,190,0,2,11,1,237,33.857142857142854,2,0.0,2,0,171,0,31,2,19,11,1,173,64,1
2667,121540,Ys7L3fRt7UujHv4RzbntGwrrv6Omn2bm,A3fsA9Zfv1X2fVEQhTw51lKENdNrEqT3,11,3,2,0,2,0,7,1,15,2.142857142857143,1,0.0,0,2,0,2,3,0,0,7,1,4,11,1
2668,121576,RPsysYLHG9V8ibC4agPmUkz49odzJ61i,SpATywNh6bZuzm8s1ceuBUnMUAeoAHHw,25,22,6,20,4,11,4,0,67,9.571428571428571,2,0.0,5,6,18,4,17,11,2,4,0,33,34,0
2669,121625,ZULomXsITwM6vNxcJN8imzU1pyfKn8Cw,A3fsA9Zfv1X2fVEQhTw51lKENdNrEqT3,14,10,8,0,6,0,3,0,27,3.857142857142857,1,0.0,0,8,0,6,10,0,0,3,0,14,13,1
2670,121656,aVeyGdrz6Ir4LmiLkJqBoRjG1lQ7MsV8,bWdj2GDclj5ofokWjzoa5jAwMkxCykd6,7,9,5,0,1,0,2,0,17,2.4285714285714284,2,0.0,1,5,0,1,8,0,0,2,0,7,10,0
2671,121711,5U79KRZxDDBIetuxjK0KXphUhzbxTzjr,A3fsA9Zfv1X2fVEQhTw51lKENdNrEqT3,10,5,4,0,0,0,7,1,17,2.4285714285714284,1,0.0,0,4,0,0,5,0,0,7,1,4,13,1
2672,121712,zdC6SE3iIVhpYTGT1Ftflp0F2V48NqFq,SpATywNh6bZuzm8s1ceuBUnMUAeoAHHw,19,28,12,12,4,0,8,0,64,9.142857142857142,3,0.0,4,12,12,4,24,0,0,8,0,32,32,1
2673,121721,RNEuStAlTxZHIZFwvfCfasMOM5Hny2Pn,SpATywNh6bZuzm8s1ceuBUnMUAeoAHHw,6,10,3,0,3,0,4,0,20,2.857142857142857,2,0.0,0,3,0,3,10,0,0,4,0,6,14,1
2674,121728,VeR8jO0l4tKfTebOc6UlIMBBM4qQ6Yxm,bWdj2GDclj5ofokWjzoa5jAwMkxCykd6,4,2,0,0,0,0,3,0,5,0.7142857142857143,1,0.0,0,0,0,0,2,0,0,3,0,0,5,1
2675,121730,qCS1MIh1oAUEDPfrxnKYyGX5hZIJFt3C,bWdj2GDclj5ofokWjzoa5jAwMkxCykd6,1,0,0,0,0,0,1,0,1,0.14285714285714285,1,0.0,0,0,0,0,0,0,0,1,0,0,1,1
2676,121731,wBp63rzsgy2LzOR2gkxDj87VT9Ja70XK,SpATywNh6bZuzm8s1ceuBUnMUAeoAHHw,19,17,11,24,5,2,6,0,65,9.285714285714286,1,0.0,3,11,20,5,14,2,4,6,0,39,26,1
2677,121738,V6LNlp0n6EiMGFhm98i6D7Pk9T5LWptM,SpATywNh6bZuzm8s1ceuBUnMUAeoAHHw,5,9,5,0,2,0,2,0,18,2.5714285714285716,1,0.0,0,5,0,2,9,0,0,2,0,7,11,1
2678,121743,bFBipIvg3ynAbrvo3mXNRP6i8NWVQRYx,A3fsA9Zfv1X2fVEQhTw51lKENdNrEqT3,9,3,2,0,1,1,9,2,18,2.5714285714285716,1,0.0,0,2,0,1,3,1,0,9,2,3,15,1
2679,121746,bFBipIvg3ynAbrvo3mXNRP6i8NWVQRYx,bWdj2GDclj5ofokWjzoa5jAwMkxCykd6,10,13,5,46,4,5,7,1,81,11.571428571428571,1,0.0,5,5,45,4,8,5,1,7,1,59,22,1
2680,121766,EbdsJCzME79IdKcgnIKOnAggJJmkpV77,G8EPVSXsOYB5YQWZGiz1aVq5Pgr2GrQu,19,19,14,6,10,0,1,0,50,7.142857142857143,2,0.0,2,14,4,10,17,0,2,1,0,30,20,0
2681,121768,Zt3P4JGoAgyqFxw766ynWY30ef3EfJ1u,SpATywNh6bZuzm8s1ceuBUnMUAeoAHHw,17,23,6,26,0,10,5,1,71,10.142857142857142,1,0.0,15,6,23,0,8,10,3,5,1,44,27,0
2682,121771,mfnQ4udtiPturvDlSRmiBQpHTrOVoPze,G8EPVSXsOYB5YQWZGiz1aVq5Pgr2GrQu,5,2,1,0,1,0,2,0,6,0.8571428571428571,1,0.0,0,1,0,1,2,0,0,2,0,2,4,1
2683,121772,rwS7FTXVRFYQBGZ8fdPbUhnEsoTUJSWr,SpATywNh6bZuzm8s1ceuBUnMUAeoAHHw,6,3,2,0,1,0,3,0,9,1.2857142857142858,1,0.0,0,2,0,1,3,0,0,3,0,3,6,1
2684,121776,sOhMuZ2KPBl6wLWzfGcWvrQoSfIarVJv,SpATywNh6bZuzm8s1ceuBUnMUAeoAHHw,5,2,1,0,1,0,2,0,6,0.8571428571428571,1,0.0,0,1,0,1,2,0,0,2,0,2,4,1
2685,121780,0P5PalAjTetGhnhGgd58OrrRVeAS6i1x,A3fsA9Zfv1X2fVEQhTw51lKENdNrEqT3,13,8,7,0,5,0,2,0,22,3.142857142857143,1,0.0,0,7,0,5,8,0,0,2,0,12,10,1
2686,121789,XC5tRBKME8ONyczymYjZjR1MyrCYegPM,G8EPVSXsOYB5YQWZGiz1aVq5Pgr2GrQu,9,7,4,0,3,0,1,0,15,2.142857142857143,1,0.0,2,4,0,3,5,0,0,1,0,9,6,0
2687,121824,VmpOwZ3zs5p6NuGKzo8TbAiFkD0EdD5q,SpATywNh6bZuzm8s1ceuBUnMUAeoAHHw,1,0,0,0,0,0,1,0,1,0.14285714285714285,1,0.0,0,0,0,0,0,0,0,1,0,0,1,1
2688,121827,LPuVvdpKRDBdr0DGqQ4yh9fw0WfNvnkW,SpATywNh6bZuzm8s1ceuBUnMUAeoAHHw,6,9,0,0,0,0,5,0,14,2.0,2,0.0,0,0,0,0,9,0,0,5,0,0,14,1
2689,121829,gOODBz9FfXPZcnKA2RT49UqbScA5gVkT,SpATywNh6bZuzm8s1ceuBUnMUAeoAHHw,11,13,8,0,5,0,3,0,29,4.142857142857143,1,0.0,0,8,0,5,13,0,0,3,0,13,16,1
2690,121870,iY0UWsKzM76w2sBfvkSz2A0A6313cEPM,SpATywNh6bZuzm8s1ceuBUnMUAeoAHHw,16,10,7,10,4,0,1,0,32,4.571428571428571,1,0.0,2,7,9,4,8,0,1,1,0,22,10,1
2691,121881,PUdcV8hfT4fAKFK5ZdHY1Ahxf6WKmDC8,bWdj2GDclj5ofokWjzoa5jAwMkxCykd6,5,3,1,0,1,0,2,0,7,1.0,1,0.0,0,1,0,1,3,0,0,2,0,2,5,1
2692,121915,QQOQ1mBFT0hbDG4vhxUnw8WQ7hq3XsN0,SpATywNh6bZuzm8s1ceuBUnMUAeoAHHw,19,19,13,3,10,0,2,0,47,6.714285714285714,2,0.0,3,13,3,10,16,0,0,2,0,29,18,1
2693,121927,7HtfIn2KlQH9UsbhFgGhveKOzfNOg6MC,SpATywNh6bZuzm8s1ceuBUnMUAeoAHHw,5,3,2,0,1,0,1,0,7,1.0,1,0.0,0,2,0,1,3,0,0,1,0,3,4,1
2694,121945,sTlxlEkJ3MbMUAeSajnaHOGfpyW9hgq1,RXDvfPUBYFlVdlueBFbLW0mhhAyGEqpt,5,3,1,0,1,0,2,0,7,1.0,1,0.0,0,1,0,1,3,0,0,2,0,2,5,1
2695,121953,ahM4WE7sAySvmZ0R8lWqo09z8fOCvKFZ,SpATywNh6bZuzm8s1ceuBUnMUAeoAHHw,1,0,0,0,0,0,2,0,2,0.2857142857142857,1,0.0,0,0,0,0,0,0,0,2,0,0,2,1
2696,121987,8FfbeT2vcqiuyS9VPg4k7f5KonVLWvGH,A3fsA9Zfv1X2fVEQhTw51lKENdNrEqT3,14,5,0,12,0,1,8,1,27,3.857142857142857,1,0.0,0,0,12,0,5,1,0,8,1,12,15,1
2697,121994,u5RnzaYe9alTOldsdopsRhwom5jR9n5h,SpATywNh6bZuzm8s1ceuBUnMUAeoAHHw,5,2,1,0,1,0,3,0,7,1.0,1,0.0,0,1,0,1,2,0,0,3,0,2,5,1
2698,121997,qkTj1KHhnruIpJto1LtBmn4usHKfmPXZ,G8EPVSXsOYB5YQWZGiz1aVq5Pgr2GrQu,16,9,9,32,5,0,2,0,57,8.142857142857142,1,0.0,0,9,29,5,9,0,3,2,0,43,14,1
2699,122003,s25WPHgkqnodCLzw3vLGSH1CPEjHMBJ5,A3fsA9Zfv1X2fVEQhTw51lKENdNrEqT3,6,5,1,0,1,0,2,0,9,1.2857142857142858,2,0.0,0,1,0,1,5,0,0,2,0,2,7,1
2700,122051,PFXaSbylT2XRWmnFTzI7TT06KKEcrU02,SpATywNh6bZuzm8s1ceuBUnMUAeoAHHw,1,0,0,0,0,0,1,0,1,0.14285714285714285,1,0.0,0,0,0,0,0,0,0,1,0,0,1,1
2701,122058,zBcT1Z0xXooVqe1Y23Zi33CckLeXOFNF,A3fsA9Zfv1X2fVEQhTw51lKENdNrEqT3,2,0,0,0,0,0,2,0,2,0.2857142857142857,1,0.0,0,0,0,0,0,0,0,2,0,0,2,1
2702,122069,Cyazs2KNzeLH7rwO0YD9wLQWGHR2SXrB,RXDvfPUBYFlVdlueBFbLW0mhhAyGEqpt,3,6,3,0,0,0,3,0,12,1.7142857142857142,2,0.0,0,3,0,0,6,0,0,3,0,3,9,1
2703,124667,15vqe2Z6zLmyPR70QAa8Kn2V8zhvh9Uk,7GRhBDsirIGkRZBtSMEzNTyDr2JQm4xx,10,2,2,0,1,2,10,1,18,2.5714285714285716,3,0.0,0,2,0,1,2,2,0,10,1,3,15,1
2704,124685,qwhxcjW9iIMBAQoGSWDtst34AFkcFQoV,7GRhBDsirIGkRZBtSMEzNTyDr2JQm4xx,3,3,2,0,0,0,1,0,6,0.8571428571428571,1,0.0,0,2,0,0,3,0,0,1,0,2,4,0
2705,124687,eQeAZJfAlQDBFNhBayGkUGtYxXtMJqJ1,7GRhBDsirIGkRZBtSMEzNTyDr2JQm4xx,47,140,45,53,31,23,14,0,306,43.714285714285715,1,0.0,78,45,42,31,62,23,11,14,0,196,110,1
2706,124688,MTBFJm3bIEaE6OQdIPJiDEIIoJhDDIeA,7GRhBDsirIGkRZBtSMEzNTyDr2JQm4xx,12,17,4,3,9,0,8,0,41,5.857142857142857,3,0.0,7,4,3,9,10,0,0,8,0,23,18,0
2707,124719,s1zoJG6TsTv8LP9PRWCYbeiv4OLIivpy,7GRhBDsirIGkRZBtSMEzNTyDr2JQm4xx,6,2,1,0,1,0,3,0,7,1.0,1,0.0,0,1,0,1,2,0,0,3,0,2,5,1
2708,124723,pyk8IpgYoJC2oe3kCohOVZ3WNjOmgeaA,7GRhBDsirIGkRZBtSMEzNTyDr2JQm4xx,27,43,10,29,22,0,1,0,105,15.0,3,0.0,29,10,25,22,14,0,4,1,0,86,19,1
2709,124848,LsB37SHCi56YIWKTwUYRQPUU0IwClcqd,7GRhBDsirIGkRZBtSMEzNTyDr2JQm4xx,23,26,7,74,6,0,2,0,115,16.428571428571427,2,0.0,9,7,64,6,17,0,10,2,0,86,29,1
2710,124904,x2sgXnRqpzo0sPEyNVV2LCKHGLD7HPOD,7GRhBDsirIGkRZBtSMEzNTyDr2JQm4xx,4,0,0,0,0,0,4,0,4,0.5714285714285714,1,0.0,0,0,0,0,0,0,0,4,0,0,4,0
2711,124923,O4ePTyZvjwNQI9EDfljqO5u6UAawTsHN,7GRhBDsirIGkRZBtSMEzNTyDr2JQm4xx,1,0,0,0,0,0,1,0,1,0.14285714285714285,1,0.0,0,0,0,0,0,0,0,1,0,0,1,1
2712,124975,Z4Ol2MWosmvKrLpBOUDzuhHb0EYhkqtT,7GRhBDsirIGkRZBtSMEzNTyDr2JQm4xx,13,26,16,8,12,1,11,0,74,10.571428571428571,4,0.0,4,16,7,12,22,1,1,11,0,39,35,1
2713,125017,xVQ88VrIuIA75ygDlevnROobNkwcFnsc,7GRhBDsirIGkRZBtSMEzNTyDr2JQm4xx,3,2,1,0,0,0,1,0,4,0.5714285714285714,1,0.0,0,1,0,0,2,0,0,1,0,1,3,1
2714,125036,CUg5atNUld0AFLgUdvlLcFARmcmAn91I,7GRhBDsirIGkRZBtSMEzNTyDr2JQm4xx,1,0,0,0,0,0,1,0,1,0.14285714285714285,1,0.0,0,0,0,0,0,0,0,1,0,0,1,1
2715,125068,clB9MUAuqkslRUltlqk0A6RGOlCJEK6u,7GRhBDsirIGkRZBtSMEzNTyDr2JQm4xx,2,0,0,0,0,0,2,0,2,0.2857142857142857,1,0.0,0,0,0,0,0,0,0,2,0,0,2,1
2716,125071,PUBGBOFNCd7rxLxHUMk2Fsee5aukfpD6,7GRhBDsirIGkRZBtSMEzNTyDr2JQm4xx,15,17,8,18,3,0,5,1,52,7.428571428571429,2,0.0,3,8,14,3,14,0,4,5,1,28,24,1
2717,125316,zQuOUrw5AhGHdFoJTVTDSPmJiftbKo67,7GRhBDsirIGkRZBtSMEzNTyDr2JQm4xx,2,0,0,0,0,0,2,0,2,0.2857142857142857,1,0.0,0,0,0,0,0,0,0,2,0,0,2,1
2718,125330,qCvAPTsWorFEreRKcqadivyOxQ7Qqyf8,7GRhBDsirIGkRZBtSMEzNTyDr2JQm4xx,2,0,0,0,0,0,2,0,2,0.2857142857142857,1,0.0,0,0,0,0,0,0,0,2,0,0,2,1
2719,125477,rEGrLtnwjrNQJxABPiEg16R7c6zG1e99,7GRhBDsirIGkRZBtSMEzNTyDr2JQm4xx,1,0,0,0,0,0,1,0,1,0.14285714285714285,1,0.0,0,0,0,0,0,0,0,1,0,0,1,1
2720,125569,E4FyPOdTetglhG27zHn1AaZVeKlotKQC,7GRhBDsirIGkRZBtSMEzNTyDr2JQm4xx,1,0,0,0,0,0,1,0,1,0.14285714285714285,1,0.0,0,0,0,0,0,0,0,1,0,0,1,1
2721,125664,RFEAx8yelAgvfPsQekcPEQ1kwjrp5Mon,7GRhBDsirIGkRZBtSMEzNTyDr2JQm4xx,7,3,2,0,2,0,2,0,9,1.2857142857142858,1,0.0,0,2,0,2,3,0,0,2,0,4,5,1
2722,125668,bZtNzDzO2qmGZ75gSzCr8t2M40vhOtlI,7GRhBDsirIGkRZBtSMEzNTyDr2JQm4xx,5,4,2,0,1,0,2,0,9,1.2857142857142858,2,0.0,0,2,0,1,4,0,0,2,0,3,6,1
2723,125913,rPGMKO3AhLxN6LWflYbraX7SC5U9X2nK,7GRhBDsirIGkRZBtSMEzNTyDr2JQm4xx,2,0,0,0,0,2,1,0,3,0.42857142857142855,1,0.0,0,0,0,0,0,2,0,1,0,0,3,1
2724,125976,okxt3sY9reE4jjoKn2yrA6i7c1T3ZGZn,7GRhBDsirIGkRZBtSMEzNTyDr2JQm4xx,4,0,0,0,0,6,4,0,10,1.4285714285714286,1,0.0,0,0,0,0,0,6,0,4,0,0,10,1
2725,126648,j9gdcEQiWF4hz17rFxv9vKJSxkrv7Ewo,fbPkOYLVPtPgIt0MxizjfFJov3JbHyAi,7,8,3,1,3,4,6,0,25,3.5714285714285716,1,0.0,3,3,1,3,5,4,0,6,0,10,15,1
2726,126677,cjIjalOkynRvNiMkIirdnL3eRD5dBGGC,fbPkOYLVPtPgIt0MxizjfFJov3JbHyAi,5,3,2,0,2,0,0,0,7,1.0,1,0.0,1,2,0,2,2,0,0,0,0,5,2,1
2727,126708,1i94xoT1OVM1lTP3R294JlD5odSrEcP5,fbPkOYLVPtPgIt0MxizjfFJov3JbHyAi,28,51,28,12,19,1,13,1,125,17.857142857142858,4,0.0,11,28,10,19,40,1,2,13,1,68,57,1
2728,126711,dTyb50y12ITIbvAI5f6oE5PPvIq2Oszo,fbPkOYLVPtPgIt0MxizjfFJov3JbHyAi,7,3,2,0,2,0,2,0,9,1.2857142857142858,1,0.0,0,2,0,2,3,0,0,2,0,4,5,1
2729,126712,0Au7FrQGJI1dB5PAH0C5RtkL9GE7xsrQ,fbPkOYLVPtPgIt0MxizjfFJov3JbHyAi,12,15,7,0,4,0,4,0,30,4.285714285714286,3,0.0,1,7,0,4,14,0,0,4,0,12,18,1
2730,126713,hIFTaIv0NzQ1m69V2AIINZ2J51nUdfKB,fbPkOYLVPtPgIt0MxizjfFJov3JbHyAi,5,2,1,0,1,0,3,0,7,1.0,1,0.0,0,1,0,1,2,0,0,3,0,2,5,1
2731,126714,E3YF9AxDXKzlOoePQC9jwZYlzCkx0nRD,fbPkOYLVPtPgIt0MxizjfFJov3JbHyAi,1,0,0,0,0,0,1,0,1,0.14285714285714285,1,0.0,0,0,0,0,0,0,0,1,0,0,1,1
2732,126715,Z7UOgoOv3zZwU9zvjSxLYTFWLOhyMpWi,fbPkOYLVPtPgIt0MxizjfFJov3JbHyAi,8,12,3,6,3,0,1,0,25,3.5714285714285716,1,0.0,7,3,6,3,5,0,0,1,0,19,6,1
2733,126717,k0sYEKzK3c3rv35gACdjIcc2Y8cPzQsK,fbPkOYLVPtPgIt0MxizjfFJov3JbHyAi,10,6,5,0,4,0,2,0,17,2.4285714285714284,1,0.0,0,5,0,4,6,0,0,2,0,9,8,1
2734,126718,H3ilxL6ewH8ns8mJBuSJ1FZhvBCjmjMc,fbPkOYLVPtPgIt0MxizjfFJov3JbHyAi,8,2,1,0,1,1,5,1,11,1.5714285714285714,1,0.0,0,1,0,1,2,1,0,5,1,2,9,1
2735,126722,tzAUOAeBXYCK0qh741cOA4XmhuNpOqLn,fbPkOYLVPtPgIt0MxizjfFJov3JbHyAi,7,6,3,0,3,0,2,0,14,2.0,1,0.0,2,3,0,3,4,0,0,2,0,8,6,1
2736,126724,SuzQYmo3OPVDT9qC8VJnnRm1Cxq00x1u,fbPkOYLVPtPgIt0MxizjfFJov3JbHyAi,6,6,5,0,5,0,1,0,17,2.4285714285714284,1,0.0,0,5,0,5,6,0,0,1,0,10,7,1
2737,126728,REzwc4szUdXMxC6Nuk8XTJfPS15NQoOL,fbPkOYLVPtPgIt0MxizjfFJov3JbHyAi,8,6,4,0,3,0,7,0,20,2.857142857142857,1,0.0,0,4,0,3,6,0,0,7,0,7,13,1
2738,126729,eNsbOW0YP21FZLJqRprbqTldsfqGKDug,fbPkOYLVPtPgIt0MxizjfFJov3JbHyAi,4,2,0,0,0,0,3,0,5,0.7142857142857143,1,0.0,0,0,0,0,2,0,0,3,0,0,5,1
2739,126730,K5koBmqwsfMijOIDdKHMgmXnCecYfcPf,fbPkOYLVPtPgIt0MxizjfFJov3JbHyAi,9,3,2,0,2,2,8,2,19,2.7142857142857144,1,0.0,0,2,0,2,3,2,0,8,2,4,15,1
2740,126731,DFFDn6kzjxm3QeQyKXF89GDFKDcalqmY,fbPkOYLVPtPgIt0MxizjfFJov3JbHyAi,1,0,0,0,0,0,2,0,2,0.2857142857142857,1,0.0,0,0,0,0,0,0,0,2,0,0,2,1
2741,126737,vaWLVKWyrsUzDV0qs20ZUq8M3VNW01Uk,fbPkOYLVPtPgIt0MxizjfFJov3JbHyAi,1,0,0,0,0,0,1,0,1,0.14285714285714285,1,0.0,0,0,0,0,0,0,0,1,0,0,1,1
2742,126739,8LFa90D8AIcBXO1V4uhC5TnOcq5mvsUm,fbPkOYLVPtPgIt0MxizjfFJov3JbHyAi,8,3,2,0,2,0,3,0,10,1.4285714285714286,2,0.0,0,2,0,2,3,0,0,3,0,4,6,1
2743,126742,B1Gq6e77yv7kkDqJ7SH2TygdPDzPBwQh,fbPkOYLVPtPgIt0MxizjfFJov3JbHyAi,23,35,17,11,11,7,11,1,93,13.285714285714286,4,0.0,10,17,9,11,25,7,2,11,1,47,46,1
2744,126746,waB7QF553HzTXuwTUim6Y0QTXghcJvpK,fbPkOYLVPtPgIt0MxizjfFJov3JbHyAi,5,2,1,0,1,0,2,0,6,0.8571428571428571,1,0.0,0,1,0,1,2,0,0,2,0,2,4,1
2745,126748,NDe8spAMYp0FsctHBGO44DCP0jh5ivtW,fbPkOYLVPtPgIt0MxizjfFJov3JbHyAi,4,2,1,0,0,0,2,0,5,0.7142857142857143,1,0.0,0,1,0,0,2,0,0,2,0,1,4,1
2746,126750,bpsYUsj9C1SHgZpkPYxDXsRDOrg2cbuw,fbPkOYLVPtPgIt0MxizjfFJov3JbHyAi,13,20,9,1,10,0,2,0,42,6.0,2,0.0,9,9,1,10,11,0,0,2,0,29,13,1
2747,126751,XYrC5UYcATLlP8wN3KwZIBFYvNYdBJrS,fbPkOYLVPtPgIt0MxizjfFJov3JbHyAi,4,3,1,0,0,0,3,0,7,1.0,1,0.0,0,1,0,0,3,0,0,3,0,1,6,1
2748,126753,bo2onan1tteC9PtOvOwWhHvlR04pcJEI,fbPkOYLVPtPgIt0MxizjfFJov3JbHyAi,1,0,0,0,0,0,1,0,1,0.14285714285714285,1,0.0,0,0,0,0,0,0,0,1,0,0,1,1
2749,126756,UQ2ITfvqEyrVlMsMiud1odTDb3yeUeeN,fbPkOYLVPtPgIt0MxizjfFJov3JbHyAi,8,6,3,0,3,0,2,0,14,2.0,1,0.0,2,3,0,3,4,0,0,2,0,8,6,1
2750,130073,IGWRz8xQdPwjKqBNKTjONoXgcj0XdulM,7GRhBDsirIGkRZBtSMEzNTyDr2JQm4xx,12,20,0,18,3,0,5,0,46,6.571428571428571,3,0.0,12,0,16,3,8,0,2,5,0,31,15,0
2751,134911,6ne76rFv6J6TLXUe0mStK4MXCR4J8Kt5,bWdj2GDclj5ofokWjzoa5jAwMkxCykd6,5,1,1,0,1,0,2,0,5,0.7142857142857143,1,0.0,0,1,0,1,1,0,0,2,0,2,3,1
2752,134914,yNC8T7gdWO96Y2q3tzTQeJUMY0F51xnO,SpATywNh6bZuzm8s1ceuBUnMUAeoAHHw,12,13,5,16,0,0,4,0,38,5.428571428571429,2,0.0,5,5,15,0,8,0,1,4,0,25,13,0
2753,134937,9CJfWVOWO2uvtgL9sMlN6s46G91IqAvr,A3fsA9Zfv1X2fVEQhTw51lKENdNrEqT3,4,2,1,0,1,2,2,0,8,1.1428571428571428,1,0.0,0,1,0,1,2,2,0,2,0,2,6,1
2754,134938,1ryg7vHF3PEsYEqZENe5bXv9yZs2dA3V,SpATywNh6bZuzm8s1ceuBUnMUAeoAHHw,4,1,0,0,0,0,4,0,5,0.7142857142857143,1,0.0,0,0,0,0,1,0,0,4,0,0,5,1
2755,134943,YfHmALaAUVJkTXPVPoa3sijNQuWgYS7R,G8EPVSXsOYB5YQWZGiz1aVq5Pgr2GrQu,15,20,9,12,7,0,1,0,49,7.0,1,0.0,9,9,6,7,11,0,6,1,0,31,18,1
2756,134957,oaNAVS5nMmZPkgC88QZyCkxZpo6GIFQk,G8EPVSXsOYB5YQWZGiz1aVq5Pgr2GrQu,15,26,23,12,12,0,2,0,75,10.714285714285714,1,0.0,0,23,11,12,26,0,1,2,0,46,29,1
2757,134996,mr6SHndrMUFTgJeI3Xsa4qtu794cguyo,bWdj2GDclj5ofokWjzoa5jAwMkxCykd6,14,15,3,40,6,0,1,0,65,9.285714285714286,1,0.0,11,3,39,6,4,0,1,1,0,59,6,1
2758,135000,nToY9YbKok17BpaPlTxZF9mLZdFu0iiS,SpATywNh6bZuzm8s1ceuBUnMUAeoAHHw,5,2,1,0,1,0,2,0,6,0.8571428571428571,1,0.0,0,1,0,1,2,0,0,2,0,2,4,1
2759,135012,BTEY71NgAZGYnRCsSAITWHUZps70gyN4,A3fsA9Zfv1X2fVEQhTw51lKENdNrEqT3,3,0,0,0,0,2,4,2,8,1.1428571428571428,1,0.0,0,0,0,0,0,2,0,4,2,0,8,1
2760,135013,BTEY71NgAZGYnRCsSAITWHUZps70gyN4,bWdj2GDclj5ofokWjzoa5jAwMkxCykd6,1,0,0,0,0,0,1,0,1,0.14285714285714285,1,0.0,0,0,0,0,0,0,0,1,0,0,1,1
2761,135029,aLOGAfDRvmZG085q2HFFKLaRHVWlMbeZ,A3fsA9Zfv1X2fVEQhTw51lKENdNrEqT3,11,5,4,0,3,3,10,2,27,3.857142857142857,1,0.0,0,4,0,3,5,3,0,10,2,7,20,1
2762,135036,wFvodFqghxL7iISMFbYXkYNq6P6eK5gH,A3fsA9Zfv1X2fVEQhTw51lKENdNrEqT3,1,0,0,0,0,0,1,0,1,0.14285714285714285,1,0.0,0,0,0,0,0,0,0,1,0,0,1,1
2763,135043,XoKIP4RGpnZk163890vUyWhLOIUSaapU,A3fsA9Zfv1X2fVEQhTw51lKENdNrEqT3,35,25,11,94,3,0,7,0,140,20.0,1,0.0,5,11,75,3,20,0,19,7,0,94,46,1
2764,135068,L0MAfJMwT0DciI5hH53QWdE0NS8GzvBn,A3fsA9Zfv1X2fVEQhTw51lKENdNrEqT3,6,3,2,0,2,0,1,0,8,1.1428571428571428,1,0.0,0,2,0,2,3,0,0,1,0,4,4,1
2765,135069,bgBLWArC7sr7mZdIi75AaJrBI0yN4gRx,SpATywNh6bZuzm8s1ceuBUnMUAeoAHHw,20,38,4,12,3,8,15,1,81,11.571428571428571,3,0.0,6,4,10,3,32,8,2,15,1,23,58,0
2766,135071,5OhdzLluLI4b0UetZ6QtwaKcHtelD4GM,A3fsA9Zfv1X2fVEQhTw51lKENdNrEqT3,25,11,11,0,11,0,3,0,36,5.142857142857143,1,0.0,0,11,0,11,11,0,0,3,0,22,14,1
2767,135077,ml2yAwYHzufxZ6xJCtzUFr2eNYyPECGG,bWdj2GDclj5ofokWjzoa5jAwMkxCykd6,7,5,3,0,1,2,3,0,14,2.0,1,0.0,0,3,0,1,5,2,0,3,0,4,10,1
2768,135103,gZWf27ETcHz4bBmwZPjiPumw55JZ4IOR,RXDvfPUBYFlVdlueBFbLW0mhhAyGEqpt,1,0,0,0,0,0,1,0,1,0.14285714285714285,1,0.0,0,0,0,0,0,0,0,1,0,0,1,1
2769,135109,EJXR6GjvUW4ftcdNw7M6s3AjFADQ5nWH,G8EPVSXsOYB5YQWZGiz1aVq5Pgr2GrQu,20,36,0,46,0,4,11,1,98,14.0,1,0.0,6,0,42,0,30,4,4,11,1,48,50,1
2770,135110,czraR8jl3tjb5vvHKbMcAmZkpcCxXmtq,SpATywNh6bZuzm8s1ceuBUnMUAeoAHHw,6,4,2,0,1,0,2,0,9,1.2857142857142858,1,0.0,0,2,0,1,4,0,0,2,0,3,6,1
2771,135114,lPsprPvnz2KazNU0HiuebkPap36Sy8nd,A3fsA9Zfv1X2fVEQhTw51lKENdNrEqT3,7,3,2,0,2,0,2,0,9,1.2857142857142858,1,0.0,0,2,0,2,3,0,0,2,0,4,5,1
2772,135124,NOmOOlAJE5nKLDW211ZOVqBtRY1AgNoT,A3fsA9Zfv1X2fVEQhTw51lKENdNrEqT3,21,24,2,0,2,1,8,1,38,5.428571428571429,1,0.0,0,2,0,2,24,1,0,8,1,4,34,1
2773,135142,XoKIP4RGpnZk163890vUyWhLOIUSaapU,bWdj2GDclj5ofokWjzoa5jAwMkxCykd6,10,10,2,28,0,0,1,0,41,5.857142857142857,1,0.0,3,2,23,0,7,0,5,1,0,28,13,1
2774,135159,yAxjMvvPF3HDitgCGIcnFlXrbnOszGcQ,bWdj2GDclj5ofokWjzoa5jAwMkxCykd6,8,16,5,114,1,0,3,0,139,19.857142857142858,2,0.0,3,5,112,1,13,0,2,3,0,121,18,1
2775,135164,jRV8IFAqLHlnm6Yo5f3lbOm8y9FKnSQS,SpATywNh6bZuzm8s1ceuBUnMUAeoAHHw,24,24,13,16,8,2,6,1,70,10.0,2,0.0,8,13,14,8,16,2,2,6,1,43,27,1
2776,135165,72z519PMt8GGBXLvF1FG0oMJuciCSWYJ,G8EPVSXsOYB5YQWZGiz1aVq5Pgr2GrQu,1,0,0,0,0,0,1,0,1,0.14285714285714285,1,0.0,0,0,0,0,0,0,0,1,0,0,1,1
2777,135210,XPNYQB8BXxVJKoqXsnIXNkzgmqWM9Jf1,A3fsA9Zfv1X2fVEQhTw51lKENdNrEqT3,1,0,0,0,0,0,1,0,1,0.14285714285714285,1,0.0,0,0,0,0,0,0,0,1,0,0,1,1
2778,135236,8JTz84ZDdJm6tvsd7hgyCl1RB6wU6r2e,bWdj2GDclj5ofokWjzoa5jAwMkxCykd6,2,0,0,0,0,0,2,0,2,0.2857142857142857,1,0.0,0,0,0,0,0,0,0,2,0,0,2,0
2779,135266,orkLWN7Jw88UrSJVImY9WyAA9wO3axVi,SpATywNh6bZuzm8s1ceuBUnMUAeoAHHw,29,28,17,24,9,3,8,1,90,12.857142857142858,1,0.0,4,17,19,9,24,3,5,8,1,49,41,1
2780,135270,orkLWN7Jw88UrSJVImY9WyAA9wO3axVi,bWdj2GDclj5ofokWjzoa5jAwMkxCykd6,1,0,0,0,0,0,1,0,1,0.14285714285714285,1,0.0,0,0,0,0,0,0,0,1,0,0,1,1
2781,135274,FJJqBn1iTJmAbav7Ov5Y4ycyF65fvY1E,SpATywNh6bZuzm8s1ceuBUnMUAeoAHHw,11,7,6,0,2,0,2,0,17,2.4285714285714284,1,0.0,0,6,0,2,7,0,0,2,0,8,9,0
2782,135285,ORZA67vQIOSB05DsIbFIoGl0EWiKz8Mx,RXDvfPUBYFlVdlueBFbLW0mhhAyGEqpt,15,20,3,0,3,0,2,0,28,4.0,2,0.0,2,3,0,3,18,0,0,2,0,8,20,1
2783,135289,eXv6ACzt62C4hMSoDSIQMvmz4LEnGBtm,A3fsA9Zfv1X2fVEQhTw51lKENdNrEqT3,4,2,1,0,0,0,2,0,5,0.7142857142857143,1,0.0,0,1,0,0,2,0,0,2,0,1,4,1
2784,135321,x6BtQH70uuLHaxqzHA21U9wmfT0SxzD9,G8EPVSXsOYB5YQWZGiz1aVq5Pgr2GrQu,9,8,0,14,0,0,3,0,25,3.5714285714285716,1,0.0,4,0,10,0,4,0,4,3,0,14,11,1
2785,135333,Hmy7IERSuMBFx0LPTwulENadvjRMvkqo,SpATywNh6bZuzm8s1ceuBUnMUAeoAHHw,10,19,0,18,0,0,1,0,38,5.428571428571429,1,0.0,4,0,17,0,15,0,1,1,0,21,17,1
2786,135370,DpB3NoJLarAGiHUaBV6zvSP8bR0qw4yk,bWdj2GDclj5ofokWjzoa5jAwMkxCykd6,11,7,6,0,5,0,1,0,19,2.7142857142857144,2,0.0,0,6,0,5,7,0,0,1,0,11,8,1
2787,135376,lg9ClFc1WU5afD4IeCy9GllsKX7cYoEB,A3fsA9Zfv1X2fVEQhTw51lKENdNrEqT3,5,2,0,0,0,0,6,0,8,1.1428571428571428,1,0.0,0,0,0,0,2,0,0,6,0,0,8,1
2788,135378,0G28t6RwNA6XV451Zq3Rvj4OEqQwVjgc,SpATywNh6bZuzm8s1ceuBUnMUAeoAHHw,4,3,1,0,0,0,2,0,6,0.8571428571428571,1,0.0,1,1,0,0,2,0,0,2,0,2,4,1
2789,135405,1R1zO9aMB7Mx1Lw84JzsChVEV5JpwmZv,bWdj2GDclj5ofokWjzoa5jAwMkxCykd6,4,3,1,0,0,0,2,0,6,0.8571428571428571,2,0.0,0,1,0,0,3,0,0,2,0,1,5,1
2790,135422,GR5uAqC8TkTRctStVcrTSN6GkRpM0Sgw,bWdj2GDclj5ofokWjzoa5jAwMkxCykd6,2,0,0,0,0,0,3,0,3,0.42857142857142855,1,0.0,0,0,0,0,0,0,0,3,0,0,3,1
2791,135435,WK0Fgs86cA55qEjGdACCPsAyup9yYjBW,SpATywNh6bZuzm8s1ceuBUnMUAeoAHHw,3,2,0,0,0,0,1,0,3,0.42857142857142855,1,0.0,0,0,0,0,2,0,0,1,0,0,3,1
2792,135449,MzVpgt6eIu33aOAUbbblQyleNNMrWM7t,SpATywNh6bZuzm8s1ceuBUnMUAeoAHHw,6,5,3,0,1,0,1,0,10,1.4285714285714286,1,0.0,0,3,0,1,5,0,0,1,0,4,6,1
2793,135466,JX7kh5ZfjpOmdoUQ8rczM8ziszP4alom,SpATywNh6bZuzm8s1ceuBUnMUAeoAHHw,14,18,7,0,4,0,6,1,36,5.142857142857143,1,0.0,4,7,0,4,14,0,0,6,1,15,21,1
2794,135498,hnr1SrvwKs73pIl4Y8iA8BBWZr0Bh6Qj,SpATywNh6bZuzm8s1ceuBUnMUAeoAHHw,16,19,0,14,0,1,7,1,42,6.0,1,0.0,6,0,12,0,13,1,2,7,1,18,24,1
2795,135509,cVCoN7HidGGECgrwLZ0Mg4plpA9ST0kb,A3fsA9Zfv1X2fVEQhTw51lKENdNrEqT3,1,0,0,0,0,0,1,0,1,0.14285714285714285,1,0.0,0,0,0,0,0,0,0,1,0,0,1,1
2796,135519,0oRPUvEsJVbkR952hI1neMgRcrJImgj3,A3fsA9Zfv1X2fVEQhTw51lKENdNrEqT3,16,9,8,0,7,0,2,0,26,3.7142857142857144,1,0.0,0,8,0,7,9,0,0,2,0,15,11,1
2797,135527,kF53IpFKMxCV7VctlhpV2lrkHuEbgiU3,RXDvfPUBYFlVdlueBFbLW0mhhAyGEqpt,18,12,0,46,0,3,7,2,70,10.0,1,0.0,8,0,41,0,4,3,5,7,2,49,21,0
2798,135549,N1UAN9F5SFtgblynTSPZlPcIrBcrhldq,A3fsA9Zfv1X2fVEQhTw51lKENdNrEqT3,17,12,11,0,11,5,4,1,44,6.285714285714286,1,0.0,0,11,0,11,12,5,0,4,1,22,22,1
2799,135559,LPkDtPFF5RxOnDnsqEeKxwZe2JS0rusW,SpATywNh6bZuzm8s1ceuBUnMUAeoAHHw,29,30,15,32,9,0,3,0,89,12.714285714285714,1,0.0,13,15,28,9,17,0,4,3,0,65,24,1
2800,135574,KNNMSW3oLxGqEqv2czanNkhQgdUkOWgY,A3fsA9Zfv1X2fVEQhTw51lKENdNrEqT3,8,5,4,0,4,0,1,0,14,2.0,1,0.0,0,4,0,4,5,0,0,1,0,8,6,1
2801,135578,WAeA3Wxi4ox0P2eDgiY2JLtPyMIFhfp0,bWdj2GDclj5ofokWjzoa5jAwMkxCykd6,15,23,9,16,9,0,6,1,64,9.142857142857142,1,0.0,12,9,13,9,11,0,3,6,1,43,21,1
2802,135583,ix15aF6FOEF1waZCSZt01VrPOuPGJ3yM,bWdj2GDclj5ofokWjzoa5jAwMkxCykd6,1,0,0,0,0,0,1,0,1,0.14285714285714285,1,0.0,0,0,0,0,0,0,0,1,0,0,1,1
2803,135586,dH1fJFd4EUa9cDGkzaH97LNe2YTOAGRI,SpATywNh6bZuzm8s1ceuBUnMUAeoAHHw,5,4,0,0,0,0,3,0,7,1.0,1,0.0,0,0,0,0,4,0,0,3,0,0,7,1
2804,135592,pO9i2Ab1by3uoxklbewkfKRXc2dQyl5M,SpATywNh6bZuzm8s1ceuBUnMUAeoAHHw,5,3,2,0,2,0,2,0,9,1.2857142857142858,1,0.0,0,2,0,2,3,0,0,2,0,4,5,1
2805,135593,rFiKT35F4vi8a7NpfY1bEgz4HT50lSZd,SpATywNh6bZuzm8s1ceuBUnMUAeoAHHw,5,3,1,0,1,0,1,0,6,0.8571428571428571,1,0.0,0,1,0,1,3,0,0,1,0,2,4,1
2806,135594,gikp9GqTKNuof6stdLjZVJv1OHEXFMyZ,G8EPVSXsOYB5YQWZGiz1aVq5Pgr2GrQu,13,19,7,18,0,0,2,0,46,6.571428571428571,1,0.0,11,7,9,0,8,0,9,2,0,27,19,0
2807,135604,MFpshextOJLHhySF4C6u9eWxWZPDeRiA,G8EPVSXsOYB5YQWZGiz1aVq5Pgr2GrQu,1,0,0,0,0,0,1,0,1,0.14285714285714285,1,0.0,0,0,0,0,0,0,0,1,0,0,1,1
2808,135605,Ql4EosuzRo0tVj3lvTLhkLOyEsWZly6m,A3fsA9Zfv1X2fVEQhTw51lKENdNrEqT3,1,0,0,0,0,0,1,0,1,0.14285714285714285,1,0.0,0,0,0,0,0,0,0,1,0,0,1,1
2809,135618,8vBpgDrBoNVwqQQYIlW93nRYlEk72d2F,A3fsA9Zfv1X2fVEQhTw51lKENdNrEqT3,2,0,0,0,0,0,3,0,3,0.42857142857142855,1,0.0,0,0,0,0,0,0,0,3,0,0,3,1
2810,135620,xe0pnwtsOXCGbwfmaX74fYK9PfsU6JPN,SpATywNh6bZuzm8s1ceuBUnMUAeoAHHw,1,0,0,0,0,0,1,0,1,0.14285714285714285,1,0.0,0,0,0,0,0,0,0,1,0,0,1,1
2811,135625,OQFJERUfDkJREmuh848c2NVEfKc13k0Z,SpATywNh6bZuzm8s1ceuBUnMUAeoAHHw,13,8,7,0,6,0,1,0,22,3.142857142857143,1,0.0,0,7,0,6,8,0,0,1,0,13,9,1
2812,135636,Or5tbal17XyYWYBFOcz5Axiks4gsj2rC,SpATywNh6bZuzm8s1ceuBUnMUAeoAHHw,26,27,12,39,7,0,2,0,87,12.428571428571429,2,0.0,14,12,33,7,13,0,6,2,0,66,21,1
2813,135644,9w2MJQeZHeyFkqwhaftUSXLuvPN6lDkw,SpATywNh6bZuzm8s1ceuBUnMUAeoAHHw,5,20,7,0,0,0,1,0,28,4.0,1,0.0,12,7,0,0,8,0,0,1,0,19,9,1
2814,135671,rmx82oLaycREVuiUJS5poc97xd1UWvXB,SpATywNh6bZuzm8s1ceuBUnMUAeoAHHw,5,2,1,0,1,0,2,0,6,0.8571428571428571,1,0.0,0,1,0,1,2,0,0,2,0,2,4,1
2815,135673,5ZrPblaWYg1V0nkRfCyVA4ssWqd4pnQb,SpATywNh6bZuzm8s1ceuBUnMUAeoAHHw,11,5,2,4,2,0,15,1,29,4.142857142857143,2,0.0,0,2,4,2,5,0,0,15,1,8,21,0
2816,135674,zILXfIGJjWXm6dA2MrEQWr2XeEUry8lN,A3fsA9Zfv1X2fVEQhTw51lKENdNrEqT3,3,3,1,0,0,0,1,0,5,0.7142857142857143,1,0.0,0,1,0,0,3,0,0,1,0,1,4,1
2817,135676,f8veUZRhdgLfRgcJyscv3SPrRGXUYeUM,bWdj2GDclj5ofokWjzoa5jAwMkxCykd6,1,0,0,0,0,0,4,0,4,0.5714285714285714,1,0.0,0,0,0,0,0,0,0,4,0,0,4,1
2818,135688,dXV6CXhMuL2MovsaBcVnWuwVAfDnBy3D,bWdj2GDclj5ofokWjzoa5jAwMkxCykd6,1,0,0,0,0,0,1,0,1,0.14285714285714285,1,0.0,0,0,0,0,0,0,0,1,0,0,1,1
2819,135691,ZtI7VkDL2OGaTLjYGXUs2OJh9j1CJRBG,bWdj2GDclj5ofokWjzoa5jAwMkxCykd6,1,0,0,0,0,0,3,0,3,0.42857142857142855,1,0.0,0,0,0,0,0,0,0,3,0,0,3,1
2820,135705,HHLCfoI58dWnfKs7QJD7m07PMcmUWFLH,bWdj2GDclj5ofokWjzoa5jAwMkxCykd6,1,0,0,0,0,0,1,0,1,0.14285714285714285,1,0.0,0,0,0,0,0,0,0,1,0,0,1,1
2821,135715,Gur5FuhE9EyV9K1F0qLPk7AenhoY8PBS,RXDvfPUBYFlVdlueBFbLW0mhhAyGEqpt,1,0,0,0,0,0,1,0,1,0.14285714285714285,1,0.0,0,0,0,0,0,0,0,1,0,0,1,1
2822,135719,bkOkn0C7FOzFPypI63kak65ajOi43hAv,SpATywNh6bZuzm8s1ceuBUnMUAeoAHHw,4,3,2,0,2,0,1,0,8,1.1428571428571428,1,0.0,0,2,0,2,3,0,0,1,0,4,4,1
2823,135721,pvAe37z1FjLTGYdwlJFjXex25zlpyHtu,G8EPVSXsOYB5YQWZGiz1aVq5Pgr2GrQu,1,0,0,0,0,0,1,0,1,0.14285714285714285,1,0.0,0,0,0,0,0,0,0,1,0,0,1,1
2824,135723,AQfzx8ZlEOE2Pwd3sng1DQ0krIzvYrKM,RXDvfPUBYFlVdlueBFbLW0mhhAyGEqpt,2,0,0,0,0,0,2,0,2,0.2857142857142857,1,0.0,0,0,0,0,0,0,0,2,0,0,2,1
2825,135757,oj8ZT8gny2t1bI3zTIIqiwK9yqWuzw78,SpATywNh6bZuzm8s1ceuBUnMUAeoAHHw,3,2,0,0,0,0,2,0,4,0.5714285714285714,1,0.0,0,0,0,0,2,0,0,2,0,0,4,1
2826,135766,lOkl9iaUDyjk0zbwJLRgFqBRBNNBSRwr,SpATywNh6bZuzm8s1ceuBUnMUAeoAHHw,14,21,1,8,0,3,6,0,39,5.571428571428571,3,0.0,4,1,8,0,17,3,0,6,0,13,26,0
2827,135784,UsP8UHahXGHaChNTAHL4dZh6OmvP94L7,A3fsA9Zfv1X2fVEQhTw51lKENdNrEqT3,1,0,0,0,0,0,1,0,1,0.14285714285714285,1,0.0,0,0,0,0,0,0,0,1,0,0,1,1
2828,135807,mgLL2TOXKEK8di2v3UUyM4FMUqEuj4kl,SpATywNh6bZuzm8s1ceuBUnMUAeoAHHw,13,15,11,0,3,0,4,0,33,4.714285714285714,3,0.0,0,11,0,3,15,0,0,4,0,14,19,0
2829,135811,5sps38f5Y5pZOFcONQeuy3Uw9461fahZ,SpATywNh6bZuzm8s1ceuBUnMUAeoAHHw,9,20,9,0,4,1,9,1,44,6.285714285714286,2,0.0,1,9,0,4,19,1,0,9,1,14,30,1
2830,135817,E47JGU8OIEWEHQErVOIbVuBKL7eug9kL,SpATywNh6bZuzm8s1ceuBUnMUAeoAHHw,1,0,0,0,0,0,1,0,1,0.14285714285714285,1,0.0,0,0,0,0,0,0,0,1,0,0,1,1
2831,135825,ETvKJXrBLwN7msxC91B5PIQrzaf0kAW1,bWdj2GDclj5ofokWjzoa5jAwMkxCykd6,1,0,0,0,0,0,1,0,1,0.14285714285714285,1,0.0,0,0,0,0,0,0,0,1,0,0,1,1
2832,136149,St6usTSSgX5U9v7wchuMWqmBKoCcDwN2,SpATywNh6bZuzm8s1ceuBUnMUAeoAHHw,13,17,0,8,0,0,4,0,29,4.142857142857143,1,0.0,9,0,7,0,8,0,1,4,0,16,13,0
2833,136152,FmYyMdFUePtcDBVgDdhDyxnbGBctrwZJ,SpATywNh6bZuzm8s1ceuBUnMUAeoAHHw,7,2,1,0,1,0,4,1,9,1.2857142857142858,1,0.0,1,1,0,1,1,0,0,4,1,3,6,0
2834,136312,DysXuoUoTtoCjfxHxEQdZhXHC6tNfwru,7GRhBDsirIGkRZBtSMEzNTyDr2JQm4xx,9,11,6,9,7,0,2,0,35,5.0,1,0.0,5,6,8,7,6,0,1,2,0,26,9,1
2835,136413,SAZKFz2NUOxVKdkBgcAx84BjxoboQOlS,SpATywNh6bZuzm8s1ceuBUnMUAeoAHHw,18,17,1,16,0,10,7,0,51,7.285714285714286,2,0.0,3,1,16,0,14,10,0,7,0,20,31,0
2836,136540,hZR4MwcYec4g0GoOyJFngJGEyWOySpv2,7GRhBDsirIGkRZBtSMEzNTyDr2JQm4xx,4,2,1,0,0,0,4,0,7,1.0,2,0.0,0,1,0,0,2,0,0,4,0,1,6,0
2837,136564,JHhY30IKFzw4LWcyrHuTEglWNqRkqdDU,SpATywNh6bZuzm8s1ceuBUnMUAeoAHHw,7,3,1,6,0,0,3,0,13,1.8571428571428572,1,0.0,2,1,6,0,1,0,0,3,0,9,4,1
2838,136797,uXoi7oqvj5HXbvnVGMMeQOqZvw3BW3QM,G8EPVSXsOYB5YQWZGiz1aVq5Pgr2GrQu,10,14,1,12,2,0,1,0,30,4.285714285714286,1,0.0,10,1,8,2,4,0,4,1,0,21,9,0
2839,137301,h774wdF6vIIcl50Js74gckwUtlv9SBGH,fbPkOYLVPtPgIt0MxizjfFJov3JbHyAi,18,28,14,8,7,0,2,0,59,8.428571428571429,1,0.0,10,14,7,7,18,0,1,2,0,38,21,1
2840,137308,UAggpZPNL1hZ0kLwEDSUplsT3ghk1d6y,fbPkOYLVPtPgIt0MxizjfFJov3JbHyAi,6,3,2,0,0,2,4,1,12,1.7142857142857142,1,0.0,0,2,0,0,3,2,0,4,1,2,10,1
2841,137386,5XQirr9i0TWpiYbsECZzYQuaZyvNkBXn,fbPkOYLVPtPgIt0MxizjfFJov3JbHyAi,5,4,1,0,0,0,6,0,11,1.5714285714285714,2,0.0,0,1,0,0,4,0,0,6,0,1,10,1
2842,137415,zs8AbWxu3oihhi0RdSLs1xmLXXgmhkzY,fbPkOYLVPtPgIt0MxizjfFJov3JbHyAi,9,10,2,2,1,5,3,1,24,3.4285714285714284,1,0.0,4,2,2,1,6,5,0,3,1,9,15,1
2843,137427,g5cfvDvYqz1BC4LMGanzPaVPPBmwbapa,fbPkOYLVPtPgIt0MxizjfFJov3JbHyAi,18,11,9,0,5,0,4,0,29,4.142857142857143,2,0.0,0,9,0,5,11,0,0,4,0,14,15,0
2844,137440,zHooznrj1lbipo0SwGxaARgac1BP3h4H,fbPkOYLVPtPgIt0MxizjfFJov3JbHyAi,28,37,19,21,8,5,3,0,93,13.285714285714286,1,0.0,8,19,20,8,29,5,1,3,0,55,38,1
2845,138214,adfbW7xBPY784GRXAIq3fInFogIbD6ro,7GRhBDsirIGkRZBtSMEzNTyDr2JQm4xx,10,12,5,10,0,0,1,0,28,4.0,1,0.0,6,5,9,0,6,0,1,1,0,20,8,0
2846,138250,szmVnhPypUPoSdN8Z8D02a6M8Gjrnwmf,A3fsA9Zfv1X2fVEQhTw51lKENdNrEqT3,27,15,12,84,10,0,1,0,122,17.428571428571427,1,0.0,1,12,73,10,14,0,11,1,0,96,26,1
2847,138422,PBT0xI17u81InQO08yLXpu6kSLQPC6l6,SpATywNh6bZuzm8s1ceuBUnMUAeoAHHw,12,10,1,15,0,0,1,0,27,3.857142857142857,1,0.0,2,1,12,0,8,0,3,1,0,15,12,0
2848,138554,Px8gWLqn4P0S59C09B0pkBi24hj9iKEG,7GRhBDsirIGkRZBtSMEzNTyDr2JQm4xx,12,11,5,1,2,0,8,0,27,3.857142857142857,2,0.0,4,5,1,2,7,0,0,8,0,12,15,1
2849,138818,okqN4nBVKRYYrkYonKicKGOmPqVGYjZh,RXDvfPUBYFlVdlueBFbLW0mhhAyGEqpt,3,2,0,0,0,0,1,0,3,0.42857142857142855,1,0.0,0,0,0,0,2,0,0,1,0,0,3,0
2850,138957,LDYjWqhrIxv22jlLe9In731UT9Ne6fvw,SpATywNh6bZuzm8s1ceuBUnMUAeoAHHw,15,9,4,6,4,0,5,0,28,4.0,1,0.0,2,4,6,4,7,0,0,5,0,16,12,1
2851,139085,heVJWbQBtCN8obfXQBAbcR0I5MnOvCPs,G8EPVSXsOYB5YQWZGiz1aVq5Pgr2GrQu,22,11,5,62,0,6,8,3,95,13.571428571428571,1,0.0,0,5,54,0,11,6,8,8,3,59,36,0
2852,139391,iLtON4OdzeG1y617iqhiryM9G4xoGAr5,SpATywNh6bZuzm8s1ceuBUnMUAeoAHHw,9,22,5,45,0,0,2,0,74,10.571428571428571,1,0.0,14,5,40,0,8,0,5,2,0,59,15,0
2853,139479,cDV3uv01OqR28HAw8WapmztMslx9jbkZ,A3fsA9Zfv1X2fVEQhTw51lKENdNrEqT3,3,2,1,0,0,0,2,0,5,0.7142857142857143,1,0.0,0,1,0,0,2,0,0,2,0,1,4,1
2854,140333,bqWpav7ocOhCfb3xc4QgAvBDK5g8BmiZ,7GRhBDsirIGkRZBtSMEzNTyDr2JQm4xx,28,31,13,32,14,0,2,0,92,13.142857142857142,1,0.0,16,13,27,14,15,0,5,2,0,70,22,1
2855,140362,DpqUZKEZpIFvZzvEXk8oaJMRAbEfypNN,7GRhBDsirIGkRZBtSMEzNTyDr2JQm4xx,3,0,0,0,0,0,3,0,3,0.42857142857142855,1,0.0,0,0,0,0,0,0,0,3,0,0,3,1
2856,140606,RthO8kTkOrnZ3vUDn574hHyfG3vroBt1,7GRhBDsirIGkRZBtSMEzNTyDr2JQm4xx,10,15,9,0,4,0,8,0,36,5.142857142857143,1,0.0,2,9,0,4,13,0,0,8,0,15,21,0
2857,143678,P1PW7aZzx8NF90gRnrYjkf5ZxxKRlBng,SpATywNh6bZuzm8s1ceuBUnMUAeoAHHw,10,13,7,12,1,1,3,0,37,5.285714285714286,1,0.0,2,7,10,1,11,1,2,3,0,20,17,1
2858,143686,xhoMHYDn0DYj6NEexX867ukahPmWhSwf,bWdj2GDclj5ofokWjzoa5jAwMkxCykd6,8,4,3,0,2,0,2,0,11,1.5714285714285714,1,0.0,0,3,0,2,4,0,0,2,0,5,6,1
2859,143813,GJGZOa9ckBlFcfojmDXHYkGGywyzKOaN,SpATywNh6bZuzm8s1ceuBUnMUAeoAHHw,12,12,0,19,0,29,11,3,74,10.571428571428571,1,0.0,6,0,18,0,6,29,1,11,3,24,50,1
2860,143822,kfS0nefl4PODD2Wbg3xDtahejAoyK8Co,RXDvfPUBYFlVdlueBFbLW0mhhAyGEqpt,5,5,3,0,0,4,1,0,13,1.8571428571428572,1,0.0,0,3,0,0,5,4,0,1,0,3,10,0
2861,144160,rukMFkuKsi65w6w0x0BTdkn9Ums9NFFL,RXDvfPUBYFlVdlueBFbLW0mhhAyGEqpt,8,3,2,0,1,1,5,1,13,1.8571428571428572,1,0.0,0,2,0,1,3,1,0,5,1,3,10,1
2862,144183,ZG0u2uQ1GPj4pTtPSRFTX9ZynYPgcWTk,G8EPVSXsOYB5YQWZGiz1aVq5Pgr2GrQu,5,4,1,0,1,0,1,0,7,1.0,1,0.0,0,1,0,1,4,0,0,1,0,2,5,1
2863,144543,3myCXWasasCDpepMqlfZ17VF0Gt1zPNm,SpATywNh6bZuzm8s1ceuBUnMUAeoAHHw,7,22,2,0,2,0,4,0,30,4.285714285714286,1,0.0,0,2,0,2,22,0,0,4,0,4,26,1
2864,144675,R6EtBVYzIOtYw5JSZPuQBl0alOVcbr6I,A3fsA9Zfv1X2fVEQhTw51lKENdNrEqT3,11,7,4,0,2,0,8,1,22,3.142857142857143,1,0.0,0,4,0,2,7,0,0,8,1,6,16,1
2865,144806,7vmy4dx8h1nmyk40XB1bVEo0ZK716pcj,SpATywNh6bZuzm8s1ceuBUnMUAeoAHHw,8,18,9,0,4,0,5,0,36,5.142857142857143,2,0.0,2,9,0,4,16,0,0,5,0,15,21,0
2866,145133,gcAX0pXem59fO2vK8c72MGTEEeEu58YB,SpATywNh6bZuzm8s1ceuBUnMUAeoAHHw,8,5,3,0,1,0,6,1,16,2.2857142857142856,2,0.0,0,3,0,1,5,0,0,6,1,4,12,1
2867,145465,IvdoAzckjyWWCkzCy6V0BjWvOwMyZEwg,A3fsA9Zfv1X2fVEQhTw51lKENdNrEqT3,3,2,1,0,0,0,2,0,5,0.7142857142857143,1,0.0,0,1,0,0,2,0,0,2,0,1,4,1
2868,145556,W7jA7ye7B2WHwijEGRwBOnLy8XlzJD6d,7GRhBDsirIGkRZBtSMEzNTyDr2JQm4xx,9,13,6,3,6,0,3,0,31,4.428571428571429,2,0.0,5,6,3,6,8,0,0,3,0,20,11,1
2869,145573,azsfvKoTKLQ8ipwpPOtqZMAvWCpOjcns,7GRhBDsirIGkRZBtSMEzNTyDr2JQm4xx,1,0,0,0,0,0,1,0,1,0.14285714285714285,1,0.0,0,0,0,0,0,0,0,1,0,0,1,1
2870,145591,zUUxzMGQmBZk6tO8vnbhkaGffbYWZvas,7GRhBDsirIGkRZBtSMEzNTyDr2JQm4xx,1,0,0,0,0,0,1,0,1,0.14285714285714285,1,0.0,0,0,0,0,0,0,0,1,0,0,1,1
2871,145734,hzecatREssedFdFCykKMURt84PE7MA6q,7GRhBDsirIGkRZBtSMEzNTyDr2JQm4xx,1,0,0,0,0,0,1,0,1,0.14285714285714285,1,0.0,0,0,0,0,0,0,0,1,0,0,1,1
2872,145746,qWYBo2adrtMVzANonhELRQVrWKW8T9T5,7GRhBDsirIGkRZBtSMEzNTyDr2JQm4xx,1,0,0,0,0,0,1,0,1,0.14285714285714285,1,0.0,0,0,0,0,0,0,0,1,0,0,1,1
2873,145767,PUvUSLbNhJCmhl8hY6hN43xWGmaNTEJm,7GRhBDsirIGkRZBtSMEzNTyDr2JQm4xx,3,2,1,0,0,0,1,0,4,0.5714285714285714,1,0.0,0,1,0,0,2,0,0,1,0,1,3,1
2874,145806,oIeIfwhQt9r1G6uZ62W7p7DLvDQ1KzcN,7GRhBDsirIGkRZBtSMEzNTyDr2JQm4xx,1,0,0,0,0,0,1,0,1,0.14285714285714285,1,0.0,0,0,0,0,0,0,0,1,0,0,1,1
2875,145824,iOFL9rLCMe8MjMlK3933AhOhA0dxbzTJ,7GRhBDsirIGkRZBtSMEzNTyDr2JQm4xx,2,0,0,0,0,0,2,0,2,0.2857142857142857,1,0.0,0,0,0,0,0,0,0,2,0,0,2,1
2876,145865,YYoTz5aT6oXhrDferhw1rplLYmNDgFub,7GRhBDsirIGkRZBtSMEzNTyDr2JQm4xx,4,2,1,0,1,0,1,0,5,0.7142857142857143,1,0.0,0,1,0,1,2,0,0,1,0,2,3,0
2877,145878,vkI2g6NMz3qUYtvneHWPmtBdkC0OUJ1I,7GRhBDsirIGkRZBtSMEzNTyDr2JQm4xx,10,6,3,0,1,1,9,1,21,3.0,1,0.0,0,3,0,1,6,1,0,9,1,4,17,1
2878,145953,TUdJl2punKYQuyj7cqcfXJ5p7FVAGa9A,7GRhBDsirIGkRZBtSMEzNTyDr2JQm4xx,12,30,13,0,4,1,2,0,50,7.142857142857143,1,0.0,8,13,0,4,22,1,0,2,0,25,25,1
2879,145989,ULvgH0dn9cMQ7RqvqnSWbMcAlKJJQ0Fk,7GRhBDsirIGkRZBtSMEzNTyDr2JQm4xx,2,0,0,0,0,0,2,0,2,0.2857142857142857,1,0.0,0,0,0,0,0,0,0,2,0,0,2,1
2880,147756,kjYtN2fLOM5h2d7NgR39VaAB4M2wF6SJ,fbPkOYLVPtPgIt0MxizjfFJov3JbHyAi,3,0,0,0,0,0,4,0,4,0.5714285714285714,1,0.0,0,0,0,0,0,0,0,4,0,0,4,0
2881,147757,PR1Ko3tMvIqClzd4kShPXdxxynmXc5v2,fbPkOYLVPtPgIt0MxizjfFJov3JbHyAi,3,2,0,0,0,0,1,0,3,0.42857142857142855,1,0.0,0,0,0,0,2,0,0,1,0,0,3,1
2882,147760,Ie773JkkSDQvIHXsBZsmS2dO9aRzKpSr,fbPkOYLVPtPgIt0MxizjfFJov3JbHyAi,5,2,1,0,1,0,2,0,6,0.8571428571428571,1,0.0,0,1,0,1,2,0,0,2,0,2,4,0
2883,147765,FTc6jHk7ojdVaEQtsGdTEiSOrQxUe2mX,fbPkOYLVPtPgIt0MxizjfFJov3JbHyAi,5,2,1,0,1,0,2,0,6,0.8571428571428571,1,0.0,0,1,0,1,2,0,0,2,0,2,4,1
2884,147766,V7i4XepTGJkVDBndf2aQyywvfMxZi1VZ,fbPkOYLVPtPgIt0MxizjfFJov3JbHyAi,5,3,1,0,1,0,3,0,8,1.1428571428571428,1,0.0,0,1,0,1,3,0,0,3,0,2,6,1
2885,147767,pfujrhh6IFsgpvQm0YrnHZDUVmO3MMCt,fbPkOYLVPtPgIt0MxizjfFJov3JbHyAi,2,0,0,0,0,0,3,0,3,0.42857142857142855,1,0.0,0,0,0,0,0,0,0,3,0,0,3,1
2886,147777,ADt4SeNSXIM0T3FNDJeQ4CFmAhPZqDNW,fbPkOYLVPtPgIt0MxizjfFJov3JbHyAi,7,3,2,0,2,0,2,0,9,1.2857142857142858,1,0.0,0,2,0,2,3,0,0,2,0,4,5,1
2887,147779,BucCzwL2XP7gPTz7VVXQ2NN15VleWmxc,fbPkOYLVPtPgIt0MxizjfFJov3JbHyAi,7,3,2,0,2,0,2,0,9,1.2857142857142858,1,0.0,0,2,0,2,3,0,0,2,0,4,5,1
2888,147788,v80xARhw6o0qWoZhV3Z6c6dVXIF7GAis,fbPkOYLVPtPgIt0MxizjfFJov3JbHyAi,8,5,2,0,2,2,5,0,16,2.2857142857142856,1,0.0,0,2,0,2,5,2,0,5,0,4,12,1
2889,147792,rT1OrFQC18rdvYkTGYqwRgC7eDvihHsc,fbPkOYLVPtPgIt0MxizjfFJov3JbHyAi,1,0,0,0,0,2,0,0,2,0.2857142857142857,1,0.0,0,0,0,0,0,2,0,0,0,0,2,1
2890,148297,mSs5bB1Rxg3xYWjWjJY9pVTt7WAiMgyu,7GRhBDsirIGkRZBtSMEzNTyDr2JQm4xx,1,0,0,0,0,0,2,0,2,0.2857142857142857,1,0.0,0,0,0,0,0,0,0,2,0,0,2,0
2891,148353,kxG2Ez4bVR5aERCBG6xs61rr9emGwqKo,fbPkOYLVPtPgIt0MxizjfFJov3JbHyAi,6,3,2,0,2,0,3,0,10,1.4285714285714286,2,0.0,0,2,0,2,3,0,0,3,0,4,6,1
2892,148366,fi4TXeoZ9lfPojTLqkoAXZWQgcUwi3WY,fbPkOYLVPtPgIt0MxizjfFJov3JbHyAi,4,3,3,0,3,0,1,0,10,1.4285714285714286,1,0.0,0,3,0,3,3,0,0,1,0,6,4,1
2893,148465,aISyThuiw10fsCPPUtqVz2ccwIDIESls,G8EPVSXsOYB5YQWZGiz1aVq5Pgr2GrQu,34,30,24,46,0,7,9,5,121,17.285714285714285,2,0.0,0,24,40,0,30,7,6,9,5,64,57,0
2894,148503,9CQfIvDiQz4gDArSnTXOgxNKUwJW75pD,SpATywNh6bZuzm8s1ceuBUnMUAeoAHHw,20,22,14,15,5,0,6,0,62,8.857142857142858,1,0.0,5,14,14,5,17,0,1,6,0,38,24,0
2895,148724,4YDp1nxKf6ZgyVxOrG2MY3nyG30jIlTN,SpATywNh6bZuzm8s1ceuBUnMUAeoAHHw,4,4,1,0,0,0,1,0,6,0.8571428571428571,1,0.0,1,1,0,0,3,0,0,1,0,2,4,1
2896,148776,6EaK0gHFiSwbLJpDVBHv9ZNNoyIiEert,SpATywNh6bZuzm8s1ceuBUnMUAeoAHHw,8,23,3,9,0,0,1,0,36,5.142857142857143,1,0.0,19,3,9,0,4,0,0,1,0,31,5,0
2897,149724,p5nLTT7lxlGHa4qmyYsgcjTpAWKheo2V,A3fsA9Zfv1X2fVEQhTw51lKENdNrEqT3,14,5,4,0,4,0,19,2,34,4.857142857142857,1,0.0,0,4,0,4,5,0,0,19,2,8,26,1
2898,149816,U8u2oofRYkvAFc5S0d9MPpENNm076FZl,G8EPVSXsOYB5YQWZGiz1aVq5Pgr2GrQu,16,17,1,28,1,3,8,0,58,8.285714285714286,1,0.0,2,1,24,1,15,3,4,8,0,28,30,0
2899,149950,byUmCtzRLWWrWRajFZnozMEalaeEKWAr,RXDvfPUBYFlVdlueBFbLW0mhhAyGEqpt,10,5,3,14,2,0,1,0,25,3.5714285714285716,1,0.0,1,3,12,2,4,0,2,1,0,18,7,1
2900,152852,8eAVRzls7MGQwc3WaPP7ONmygmpXQE3K,7GRhBDsirIGkRZBtSMEzNTyDr2JQm4xx,29,32,12,33,9,1,2,0,89,12.714285714285714,1,0.0,18,12,30,9,14,1,3,2,0,69,20,1
2901,152889,4BpRE14XuCFERPNFltqE4ojcMHw6pKyT,7GRhBDsirIGkRZBtSMEzNTyDr2JQm4xx,6,2,1,0,1,0,3,0,7,1.0,1,0.0,0,1,0,1,2,0,0,3,0,2,5,1
2902,152924,1UDHQI8imw8nweB1TYtOC79yWWeAk6dI,7GRhBDsirIGkRZBtSMEzNTyDr2JQm4xx,1,0,0,0,0,0,1,0,1,0.14285714285714285,1,0.0,0,0,0,0,0,0,0,1,0,0,1,1
2903,152950,2bFnB4uI8l4fyqIbUzJ6PgGAsqDupazk,7GRhBDsirIGkRZBtSMEzNTyDr2JQm4xx,5,2,0,0,0,2,4,0,8,1.1428571428571428,1,0.0,0,0,0,0,2,2,0,4,0,0,8,1
2904,153021,dcAfcDe1XQG4OPzTBHUeq4qqwRgLRIBM,7GRhBDsirIGkRZBtSMEzNTyDr2JQm4xx,33,36,18,42,20,3,3,0,122,17.428571428571427,1,0.0,16,18,40,20,20,3,2,3,0,94,28,1
2905,153052,UfBZxbp3dHdvs4dmjpPF1a599SiVHfq9,7GRhBDsirIGkRZBtSMEzNTyDr2JQm4xx,13,14,7,0,4,0,3,0,28,4.0,1,0.0,0,7,0,4,14,0,0,3,0,11,17,1
2906,153070,nNeSwHjoP91mmln5SrcL87TOEBs15zTk,7GRhBDsirIGkRZBtSMEzNTyDr2JQm4xx,2,0,0,0,0,0,2,0,2,0.2857142857142857,1,0.0,0,0,0,0,0,0,0,2,0,0,2,1
2907,153072,IOcEoixO9HVhIQeLNHKaS3iQynrmSTmV,7GRhBDsirIGkRZBtSMEzNTyDr2JQm4xx,12,30,6,8,3,13,3,0,63,9.0,1,0.0,11,6,6,3,19,13,2,3,0,26,37,0
2908,153082,pc8Cijkar16XHq3iOS71C2O61xVOM7hS,7GRhBDsirIGkRZBtSMEzNTyDr2JQm4xx,1,0,0,0,0,0,1,0,1,0.14285714285714285,1,0.0,0,0,0,0,0,0,0,1,0,0,1,1
2909,153106,4dWOmHqqlMb2FlRY2mDnSBR6FrPBKxXO,7GRhBDsirIGkRZBtSMEzNTyDr2JQm4xx,2,0,0,0,0,0,5,0,5,0.7142857142857143,1,0.0,0,0,0,0,0,0,0,5,0,0,5,1
2910,153205,pvxjw4szSuluDWQ3DWPes9Mzs1MCvxjI,SpATywNh6bZuzm8s1ceuBUnMUAeoAHHw,17,15,9,16,4,2,2,0,48,6.857142857142857,2,0.0,3,9,14,4,12,2,2,2,0,30,18,1
2911,153209,5ZHw0M7FTk5cO1fK8KsZKsofS7GANtcz,SpATywNh6bZuzm8s1ceuBUnMUAeoAHHw,14,22,2,10,0,17,7,1,59,8.428571428571429,1,0.0,5,2,9,0,17,17,1,7,1,16,43,1
2912,153222,qGeBgOr7St26ZmQVIT5NibjBEisNw9ln,SpATywNh6bZuzm8s1ceuBUnMUAeoAHHw,9,17,10,0,0,0,3,0,30,4.285714285714286,2,0.0,0,10,0,0,17,0,0,3,0,10,20,1
2913,153223,4iqKNHeZS5JSEDCOEGY9iVAlANRyx0Hy,bWdj2GDclj5ofokWjzoa5jAwMkxCykd6,1,0,0,0,0,0,1,0,1,0.14285714285714285,1,0.0,0,0,0,0,0,0,0,1,0,0,1,1
2914,153230,9pfskqYp4pvR53OXPIHxfdcjDCQolJRR,SpATywNh6bZuzm8s1ceuBUnMUAeoAHHw,25,14,9,19,5,4,8,0,59,8.428571428571429,2,0.0,4,9,17,5,10,4,2,8,0,35,24,1
2915,153240,HKDSRzc7MQzCfJsk49D6xFQK4oFHHvy7,G8EPVSXsOYB5YQWZGiz1aVq5Pgr2GrQu,11,7,1,6,2,0,7,0,23,3.2857142857142856,2,0.0,5,1,3,2,2,0,3,7,0,11,12,1
2916,153250,b9mxLoVADmerKv5HkkvTTWu7wHJ0K2g8,RXDvfPUBYFlVdlueBFbLW0mhhAyGEqpt,5,3,1,0,1,0,1,0,6,0.8571428571428571,1,0.0,0,1,0,1,3,0,0,1,0,2,4,1
2917,153254,CxT0CHLq6J1c8Jut4aoI3ctVaIuJrmZd,SpATywNh6bZuzm8s1ceuBUnMUAeoAHHw,6,2,1,0,1,0,4,0,8,1.1428571428571428,1,0.0,0,1,0,1,2,0,0,4,0,2,6,1
2918,153304,AxjnggPTKyT2aYQCBpgnjenDZZbNsOpc,SpATywNh6bZuzm8s1ceuBUnMUAeoAHHw,9,7,1,2,0,0,1,0,11,1.5714285714285714,1,0.0,0,1,2,0,7,0,0,1,0,3,8,0
2919,153320,17nF9FTjTWCsbOCjXVTb0OZUIQSKIDV1,SpATywNh6bZuzm8s1ceuBUnMUAeoAHHw,5,3,1,0,1,0,1,0,6,0.8571428571428571,1,0.0,0,1,0,1,3,0,0,1,0,2,4,1
2920,153335,OgqpjGMMInWS9PhYsy4mlMX0fhVM7tcA,SpATywNh6bZuzm8s1ceuBUnMUAeoAHHw,16,32,9,16,5,4,2,0,68,9.714285714285714,2,0.0,11,9,14,5,21,4,2,2,0,39,29,1
2921,153344,zFxBEkWmbKmgcm9gb8oYLXK8dhxOMTgG,bWdj2GDclj5ofokWjzoa5jAwMkxCykd6,4,2,1,0,1,0,1,0,5,0.7142857142857143,1,0.0,0,1,0,1,2,0,0,1,0,2,3,1
2922,153359,OsZOOHLTzswhvwcqovfIZ4d3mMdzbQV4,bWdj2GDclj5ofokWjzoa5jAwMkxCykd6,4,2,0,0,0,0,2,0,4,0.5714285714285714,1,0.0,0,0,0,0,2,0,0,2,0,0,4,1
2923,153377,pShr7F4fdPHy76vFAX1gnyjDQNfbMT7w,SpATywNh6bZuzm8s1ceuBUnMUAeoAHHw,9,6,4,0,3,0,5,0,18,2.5714285714285716,1,0.0,0,4,0,3,6,0,0,5,0,7,11,1
2924,153381,mgLL2TOXKEK8di2v3UUyM4FMUqEuj4kl,bWdj2GDclj5ofokWjzoa5jAwMkxCykd6,1,0,0,0,0,0,1,0,1,0.14285714285714285,1,0.0,0,0,0,0,0,0,0,1,0,0,1,1
2925,153388,afQkAxUvdLu532EqkP2BO2E822Re7HYk,A3fsA9Zfv1X2fVEQhTw51lKENdNrEqT3,1,0,0,0,0,0,1,0,1,0.14285714285714285,1,0.0,0,0,0,0,0,0,0,1,0,0,1,1
2926,153389,afQkAxUvdLu532EqkP2BO2E822Re7HYk,bWdj2GDclj5ofokWjzoa5jAwMkxCykd6,1,0,0,0,0,0,1,0,1,0.14285714285714285,1,0.0,0,0,0,0,0,0,0,1,0,0,1,1
2927,153404,ZoDpWjHIWpxSzHmkG8xPsIIgTQq9K5uN,SpATywNh6bZuzm8s1ceuBUnMUAeoAHHw,15,20,7,15,1,2,6,1,52,7.428571428571429,3,0.0,9,7,14,1,11,2,1,6,1,31,21,1
2928,153443,ngup3fucB3JZQIAGeEk4g3OEqzwFokS0,A3fsA9Zfv1X2fVEQhTw51lKENdNrEqT3,15,7,6,0,6,3,6,0,28,4.0,1,0.0,0,6,0,6,7,3,0,6,0,12,16,1
2929,153457,cYe4n4c9KPDfBEWjGIRj6ImLxtmj3FnE,SpATywNh6bZuzm8s1ceuBUnMUAeoAHHw,16,23,9,2,4,0,4,1,43,6.142857142857143,2,0.0,0,9,2,4,23,0,0,4,1,15,28,0
2930,153527,7abxlkdMiNWAIk78NzVnHWo2fZI6eMvl,G8EPVSXsOYB5YQWZGiz1aVq5Pgr2GrQu,1,0,0,0,0,0,1,0,1,0.14285714285714285,1,0.0,0,0,0,0,0,0,0,1,0,0,1,1
2931,153528,Xbyo7HUsTZeFyBz3S4UH7TOjaOcOatNR,G8EPVSXsOYB5YQWZGiz1aVq5Pgr2GrQu,14,9,4,10,2,1,7,0,33,4.714285714285714,1,0.0,3,4,7,2,6,1,3,7,0,16,17,1
2932,153554,5ESBYT4YXwThMhRWcyNvUGRmyEr1sxDg,A3fsA9Zfv1X2fVEQhTw51lKENdNrEqT3,8,9,4,0,2,0,2,0,17,2.4285714285714284,2,0.0,0,4,0,2,9,0,0,2,0,6,11,0
2933,153591,wnrnl9khoFP1InwfVTZawT3pFxBvI7k9,SpATywNh6bZuzm8s1ceuBUnMUAeoAHHw,16,15,2,10,3,0,4,0,34,4.857142857142857,1,0.0,4,2,8,3,11,0,2,4,0,17,17,1
2934,153593,UBlBWZ3qSNiPpjfNB2f0HBLc8JT09fQp,bWdj2GDclj5ofokWjzoa5jAwMkxCykd6,1,0,0,0,0,0,1,0,1,0.14285714285714285,1,0.0,0,0,0,0,0,0,0,1,0,0,1,1
2935,153600,f1mXA42Iut2h3an7dNcb6e25YzQPcYho,SpATywNh6bZuzm8s1ceuBUnMUAeoAHHw,28,44,19,27,11,0,4,0,105,15.0,2,0.0,10,19,25,11,34,0,2,4,0,65,40,1
2936,153603,bGlyGIDBiTQ9cORO6s00PigGAgG0feOe,bWdj2GDclj5ofokWjzoa5jAwMkxCykd6,12,14,0,48,2,6,3,1,74,10.571428571428571,1,0.0,6,0,47,2,8,6,1,3,1,55,19,1
2937,153638,npggYhQDuWIBT1CD0vElHVM5v5VjjGlP,SpATywNh6bZuzm8s1ceuBUnMUAeoAHHw,5,3,1,0,1,0,1,0,6,0.8571428571428571,1,0.0,0,1,0,1,3,0,0,1,0,2,4,1
2938,153642,y0PkAopIdLmRFrkWC9eBHvWT77KfVWMh,SpATywNh6bZuzm8s1ceuBUnMUAeoAHHw,13,24,11,0,7,0,3,0,45,6.428571428571429,2,0.0,0,11,0,7,24,0,0,3,0,18,27,1
2939,153643,1pusTPLSLF5m0UuZqZkNpGlAq8VrQ1KA,G8EPVSXsOYB5YQWZGiz1aVq5Pgr2GrQu,1,0,0,0,0,0,1,0,1,0.14285714285714285,1,0.0,0,0,0,0,0,0,0,1,0,0,1,1
2940,153651,4arExpTK1wIuXqxD9mjuWbelMebzEsNU,SpATywNh6bZuzm8s1ceuBUnMUAeoAHHw,5,2,1,0,1,0,2,0,6,0.8571428571428571,1,0.0,0,1,0,1,2,0,0,2,0,2,4,1
2941,153665,2mwblOfAIlWCnOpKEy9s0V1Ag6iOs76e,SpATywNh6bZuzm8s1ceuBUnMUAeoAHHw,1,0,0,0,0,0,1,0,1,0.14285714285714285,1,0.0,0,0,0,0,0,0,0,1,0,0,1,1
2942,153668,0ORnjZDNtR58wRPjDahIQtI1SSJa0QxJ,SpATywNh6bZuzm8s1ceuBUnMUAeoAHHw,14,13,7,15,5,0,4,0,44,6.285714285714286,1,0.0,5,7,14,5,8,0,1,4,0,31,13,1
2943,153684,htua1xywlnpsMMY7EJSOsurL86GI912X,A3fsA9Zfv1X2fVEQhTw51lKENdNrEqT3,28,8,4,96,1,0,7,0,116,16.571428571428573,1,0.0,2,4,80,1,6,0,16,7,0,87,29,1
2944,153697,JVadOLmYm00UY6RpVFCz6oCIzPWjF9Xb,bWdj2GDclj5ofokWjzoa5jAwMkxCykd6,4,4,1,0,2,0,1,0,8,1.1428571428571428,1,0.0,2,1,0,2,2,0,0,1,0,5,3,1
2945,153698,imNhKIaFauvST7J9xfEWryq9BWP5AbNf,SpATywNh6bZuzm8s1ceuBUnMUAeoAHHw,1,0,0,0,0,0,1,0,1,0.14285714285714285,1,0.0,0,0,0,0,0,0,0,1,0,0,1,1
2946,153705,imNhKIaFauvST7J9xfEWryq9BWP5AbNf,RXDvfPUBYFlVdlueBFbLW0mhhAyGEqpt,1,0,0,0,0,0,1,0,1,0.14285714285714285,1,0.0,0,0,0,0,0,0,0,1,0,0,1,1
2947,153708,cX96KcLUG7eWbqHO7enIWngg59YqtKEY,SpATywNh6bZuzm8s1ceuBUnMUAeoAHHw,4,4,2,0,0,0,1,0,7,1.0,1,0.0,1,2,0,0,3,0,0,1,0,3,4,1
2948,153744,ttb5iuebPMlcVHZPAjxVbJ8njCe9OqDr,SpATywNh6bZuzm8s1ceuBUnMUAeoAHHw,10,7,0,18,0,0,2,0,27,3.857142857142857,1,0.0,2,0,15,0,5,0,3,2,0,17,10,1
2949,153745,lBUrinPM7S9o6yK6K8JSMwJaVRnBcZFO,bWdj2GDclj5ofokWjzoa5jAwMkxCykd6,4,2,0,0,0,0,3,0,5,0.7142857142857143,1,0.0,0,0,0,0,2,0,0,3,0,0,5,1
2950,153761,VEn1n8siGoYMgQvsRJOH6Mt6C0Cu6W64,SpATywNh6bZuzm8s1ceuBUnMUAeoAHHw,28,23,17,24,11,0,3,0,78,11.142857142857142,3,0.0,4,17,23,11,19,0,1,3,0,55,23,1
2951,153775,NDTWRDiLyYPUSKAzpsOEnrkggSOfO91T,SpATywNh6bZuzm8s1ceuBUnMUAeoAHHw,18,22,13,16,7,0,1,0,59,8.428571428571429,1,0.0,8,13,15,7,14,0,1,1,0,43,16,1
2952,153790,IA8IlgrjDUbf5IQm26Ve5t8QQHZhw82k,SpATywNh6bZuzm8s1ceuBUnMUAeoAHHw,1,0,0,0,0,0,1,0,1,0.14285714285714285,1,0.0,0,0,0,0,0,0,0,1,0,0,1,1
2953,153802,JrfTo5GNjMn6EHzlMiG1fSQLURYPPGKs,bWdj2GDclj5ofokWjzoa5jAwMkxCykd6,2,0,0,0,0,0,4,0,4,0.5714285714285714,1,0.0,0,0,0,0,0,0,0,4,0,0,4,1
2954,153806,VhpXVmuePjSLeMVIlElMMladDGd0odWC,bWdj2GDclj5ofokWjzoa5jAwMkxCykd6,17,17,6,24,0,3,4,0,54,7.714285714285714,1,0.0,6,6,23,0,11,3,1,4,0,35,19,0
2955,153810,pGNIRV05CYiaTTY4zIoziuGcEcxqXgio,A3fsA9Zfv1X2fVEQhTw51lKENdNrEqT3,5,1,0,0,0,0,3,2,6,0.8571428571428571,1,0.0,0,0,0,0,1,0,0,3,2,0,6,1
2956,153815,ocmyq6MXRULfgpYdGM8QGfWnP2Queprt,RXDvfPUBYFlVdlueBFbLW0mhhAyGEqpt,1,0,0,0,0,0,1,0,1,0.14285714285714285,1,0.0,0,0,0,0,0,0,0,1,0,0,1,1
2957,153857,BsO4gYCEUXQGKYLyHXV4q0f2CE6gKQPc,bWdj2GDclj5ofokWjzoa5jAwMkxCykd6,2,0,0,0,0,0,2,0,2,0.2857142857142857,1,0.0,0,0,0,0,0,0,0,2,0,0,2,1
2958,153860,ZNBGAlJve4TYJ3FcDlTLBdyuklADldDZ,A3fsA9Zfv1X2fVEQhTw51lKENdNrEqT3,4,3,2,0,0,0,1,0,6,0.8571428571428571,1,0.0,0,2,0,0,3,0,0,1,0,2,4,1
2959,153882,WY9Kk93NuRsoZvVUYcqVREh3xtBHbvAb,SpATywNh6bZuzm8s1ceuBUnMUAeoAHHw,1,0,0,0,0,0,2,0,2,0.2857142857142857,1,0.0,0,0,0,0,0,0,0,2,0,0,2,1
2960,153883,5hosZ8hQASGCVLdW9XYMecTXS9o9Kexh,G8EPVSXsOYB5YQWZGiz1aVq5Pgr2GrQu,7,3,2,0,2,0,2,0,9,1.2857142857142858,1,0.0,0,2,0,2,3,0,0,2,0,4,5,1
2961,153898,q9ayVwEoKiDDsIKc3IAHGSTn37C2BcId,SpATywNh6bZuzm8s1ceuBUnMUAeoAHHw,1,0,0,0,0,0,4,0,4,0.5714285714285714,1,0.0,0,0,0,0,0,0,0,4,0,0,4,1
2962,153916,fg9xG7J3hLazBdFakHteLNxtYgOMtOn7,SpATywNh6bZuzm8s1ceuBUnMUAeoAHHw,5,5,1,0,1,0,3,0,10,1.4285714285714286,1,0.0,2,1,0,1,3,0,0,3,0,4,6,1
2963,153925,LH8Ugxvjxhypkt5v1imhfncDCGMVYvOX,SpATywNh6bZuzm8s1ceuBUnMUAeoAHHw,7,46,3,0,1,1,15,0,66,9.428571428571429,1,0.0,0,3,0,1,46,1,0,15,0,4,62,1
2964,153930,a7HqL5rVaBWdmJJ0LA7o4pdEGfF0vFCf,SpATywNh6bZuzm8s1ceuBUnMUAeoAHHw,24,18,11,29,6,0,3,0,67,9.571428571428571,1,0.0,6,11,28,6,12,0,1,3,0,51,16,1
2965,153939,ECkqmAuIkv3ncN9wNJby8oOn15qTd9kR,bWdj2GDclj5ofokWjzoa5jAwMkxCykd6,1,0,0,0,0,0,1,0,1,0.14285714285714285,1,0.0,0,0,0,0,0,0,0,1,0,0,1,1
2966,153960,lHqG7UT3evpRhAVEeXMKWozC3OBfRB6b,bWdj2GDclj5ofokWjzoa5jAwMkxCykd6,4,1,1,0,0,0,2,0,4,0.5714285714285714,1,0.0,0,1,0,0,1,0,0,2,0,1,3,1
2967,153970,rK6GKHeyjKWUALwDzkIRQ6keCnDOngXi,SpATywNh6bZuzm8s1ceuBUnMUAeoAHHw,2,0,0,0,0,0,2,0,2,0.2857142857142857,1,0.0,0,0,0,0,0,0,0,2,0,0,2,1
2968,153980,RuTxY8DaJW8mZYxEAeQrQJD3l4wbq41Q,A3fsA9Zfv1X2fVEQhTw51lKENdNrEqT3,9,5,1,0,1,0,5,0,12,1.7142857142857142,1,0.0,0,1,0,1,5,0,0,5,0,2,10,1
2969,153981,PWSenA2xTFV9h2dRBUmJc6Dd5CU49Bfk,SpATywNh6bZuzm8s1ceuBUnMUAeoAHHw,2,0,0,0,0,0,3,0,3,0.42857142857142855,1,0.0,0,0,0,0,0,0,0,3,0,0,3,1
2970,153987,tWEnJYIhXMJ03Foo959mubaAJUHZPTw0,bWdj2GDclj5ofokWjzoa5jAwMkxCykd6,1,0,0,0,0,0,1,0,1,0.14285714285714285,1,0.0,0,0,0,0,0,0,0,1,0,0,1,1
2971,153994,y0CnonzJAddQ4oYr5LBSP0Y6KP3RgPGg,bWdj2GDclj5ofokWjzoa5jAwMkxCykd6,3,2,1,0,0,0,1,0,4,0.5714285714285714,1,0.0,0,1,0,0,2,0,0,1,0,1,3,1
2972,154004,Cf7GCeUZzG7WjvUIyGfwv9hfcwXPVq5G,SpATywNh6bZuzm8s1ceuBUnMUAeoAHHw,6,4,1,0,1,0,2,0,8,1.1428571428571428,2,0.0,0,1,0,1,4,0,0,2,0,2,6,0
2973,154030,ijmzTkXDQO41J49xgIf8BYjGtAGyN9zu,SpATywNh6bZuzm8s1ceuBUnMUAeoAHHw,1,0,0,0,0,0,1,0,1,0.14285714285714285,1,0.0,0,0,0,0,0,0,0,1,0,0,1,1
2974,154035,DHCzWncH94ErnybHPppeaE2nTRJmmMhY,SpATywNh6bZuzm8s1ceuBUnMUAeoAHHw,21,42,19,16,6,15,7,2,107,15.285714285714286,1,0.0,17,19,13,6,25,15,3,7,2,55,52,1
2975,154042,2K1Z8MHkxSfa3IoXQMOOkvPRYry0VFvS,A3fsA9Zfv1X2fVEQhTw51lKENdNrEqT3,6,3,2,0,2,0,1,0,8,1.1428571428571428,1,0.0,0,2,0,2,3,0,0,1,0,4,4,1
2976,154089,HiNePj7VyLNET123cNCa7VjP10PYv5CS,SpATywNh6bZuzm8s1ceuBUnMUAeoAHHw,9,9,4,0,2,0,2,0,17,2.4285714285714284,1,0.0,4,4,0,2,5,0,0,2,0,10,7,1
2977,154117,BdPEjrNeRWORvoAvmySSATaD7FpfgjJ7,bWdj2GDclj5ofokWjzoa5jAwMkxCykd6,1,0,0,0,0,0,1,0,1,0.14285714285714285,1,0.0,0,0,0,0,0,0,0,1,0,0,1,1
2978,154119,BdPEjrNeRWORvoAvmySSATaD7FpfgjJ7,A3fsA9Zfv1X2fVEQhTw51lKENdNrEqT3,4,0,0,0,0,0,3,1,4,0.5714285714285714,1,0.0,0,0,0,0,0,0,0,3,1,0,4,1
2979,154123,vljlAhHGhHZt2ciFpy2bQxMoEL2SUwdk,SpATywNh6bZuzm8s1ceuBUnMUAeoAHHw,7,4,1,0,1,0,2,0,8,1.1428571428571428,1,0.0,0,1,0,1,4,0,0,2,0,2,6,1
2980,154133,zUPpTYisLLzFG12BVDvWrty0j8q1G6Si,SpATywNh6bZuzm8s1ceuBUnMUAeoAHHw,3,2,0,0,0,0,1,0,3,0.42857142857142855,1,0.0,0,0,0,0,2,0,0,1,0,0,3,0
2981,154181,BXV7sGq2IrRSqCFuLKgoxpKYDPSPpUSj,A3fsA9Zfv1X2fVEQhTw51lKENdNrEqT3,1,0,0,0,0,0,1,0,1,0.14285714285714285,1,0.0,0,0,0,0,0,0,0,1,0,0,1,1
2982,154194,fZpfLVVUEp7GXISLcNFyxWveiOP0dldp,G8EPVSXsOYB5YQWZGiz1aVq5Pgr2GrQu,10,10,0,0,1,0,2,0,13,1.8571428571428572,1,0.0,0,0,0,1,10,0,0,2,0,1,12,0
2983,154318,27pUZlupG1aVjIY0f9PLE1OvbJSBVMXw,SpATywNh6bZuzm8s1ceuBUnMUAeoAHHw,30,29,17,33,9,2,6,1,97,13.857142857142858,1,0.0,8,17,27,9,21,2,6,6,1,61,36,1
2984,154341,zHI8MHuExufwDJ1uuBe75QQrzwho6OSZ,RXDvfPUBYFlVdlueBFbLW0mhhAyGEqpt,49,127,41,133,33,31,42,1,408,58.285714285714285,1,0.0,68,41,114,33,59,31,19,42,1,256,152,0
2985,154570,EXZ81qqSldwR1xdBEwBZ7wmgbTHF86sl,A3fsA9Zfv1X2fVEQhTw51lKENdNrEqT3,39,22,19,88,15,0,2,0,146,20.857142857142858,2,0.0,1,19,69,15,21,0,19,2,0,104,42,0
2986,154630,PE4KBwh4ltl7dienGR8pJbew7yjFv3Vz,RXDvfPUBYFlVdlueBFbLW0mhhAyGEqpt,51,83,37,82,24,16,18,1,261,37.285714285714285,1,0.0,33,37,76,24,50,16,6,18,1,170,91,0
2987,154662,5U79KRZxDDBIetuxjK0KXphUhzbxTzjr,SpATywNh6bZuzm8s1ceuBUnMUAeoAHHw,7,6,3,0,2,0,3,0,14,2.0,2,0.0,0,3,0,2,6,0,0,3,0,5,9,0
2988,154867,GnGb3MjVBgYFavJRehOmmU05ktvVgJLM,SpATywNh6bZuzm8s1ceuBUnMUAeoAHHw,3,2,1,0,0,0,1,0,4,0.5714285714285714,1,0.0,0,1,0,0,2,0,0,1,0,1,3,0
2989,154971,T6EWQ7jVP89JlHzj41KN1gEtGYevpSQM,7GRhBDsirIGkRZBtSMEzNTyDr2JQm4xx,4,2,0,0,0,0,2,0,4,0.5714285714285714,1,0.0,0,0,0,0,2,0,0,2,0,0,4,1
2990,155260,RYxlkEfybScjuURHdWSAT0EfdWxxzl53,G8EPVSXsOYB5YQWZGiz1aVq5Pgr2GrQu,12,10,3,8,3,0,2,0,26,3.7142857142857144,1,0.0,6,3,5,3,4,0,3,2,0,17,9,1
2991,155580,RRM0TElcCY25pdcWRkMGxwCn30ehvK5c,SpATywNh6bZuzm8s1ceuBUnMUAeoAHHw,2,0,0,0,0,0,2,0,2,0.2857142857142857,1,0.0,0,0,0,0,0,0,0,2,0,0,2,0
2992,155826,VFaDw1WYcOtIcsxfLW3x5fsJ2JkUIOUZ,G8EPVSXsOYB5YQWZGiz1aVq5Pgr2GrQu,3,6,0,0,0,1,2,0,9,1.2857142857142858,1,0.0,0,0,0,0,6,1,0,2,0,0,9,0
2993,155885,4G4cusC28dHeOh2Typ91i1q3Okbvvqth,bWdj2GDclj5ofokWjzoa5jAwMkxCykd6,6,4,1,4,2,0,2,0,13,1.8571428571428572,1,0.0,2,1,3,2,2,0,1,2,0,8,5,1
2994,156562,Un3EzEE4Sz8i5Z84q9e50URbIAEkkVSB,A3fsA9Zfv1X2fVEQhTw51lKENdNrEqT3,1,0,0,0,0,0,2,0,2,0.2857142857142857,1,0.0,0,0,0,0,0,0,0,2,0,0,2,1
2995,160726,8E88mVxxHiSEV3ReMbiLkIuYAxJ6YXeO,bWdj2GDclj5ofokWjzoa5jAwMkxCykd6,3,2,1,0,0,0,2,0,5,0.7142857142857143,1,0.0,0,1,0,0,2,0,0,2,0,1,4,1
2996,161682,HE0yFYNeyW3jGh5EhXv7uoc6O18ATk5R,7GRhBDsirIGkRZBtSMEzNTyDr2JQm4xx,16,15,10,6,8,0,1,0,40,5.714285714285714,1,0.0,3,10,6,8,12,0,0,1,0,27,13,1
2997,161695,5UJZmEar1AX3gQXOzkh3MnQcYdErI17M,7GRhBDsirIGkRZBtSMEzNTyDr2JQm4xx,5,3,1,4,1,0,1,0,10,1.4285714285714286,1,0.0,1,1,3,1,2,0,1,1,0,6,4,1
2998,161723,SKx8r8WhDZSzytfk5iQ25ROJsaDkrIXF,7GRhBDsirIGkRZBtSMEzNTyDr2JQm4xx,11,7,4,0,0,0,22,1,34,4.857142857142857,2,0.0,0,4,0,0,7,0,0,22,1,4,30,1
2999,161805,UCk78TeP5wO91gE0mNeB2p1adOEwLGvE,7GRhBDsirIGkRZBtSMEzNTyDr2JQm4xx,1,0,0,0,0,0,1,0,1,0.14285714285714285,1,0.0,0,0,0,0,0,0,0,1,0,0,1,1
3000,161860,XWulLs8vbnA3SFvatYUqLQya4PNZCGWN,7GRhBDsirIGkRZBtSMEzNTyDr2JQm4xx,2,0,0,0,0,0,2,0,2,0.2857142857142857,1,0.0,0,0,0,0,0,0,0,2,0,0,2,1
3001,161918,SYWOoChsgDN3vqDh0zFb5J4GFaNN5CHm,7GRhBDsirIGkRZBtSMEzNTyDr2JQm4xx,2,0,0,0,0,0,2,0,2,0.2857142857142857,1,0.0,0,0,0,0,0,0,0,2,0,0,2,1
3002,161927,OhL5zrdNWQNDdkrpoCKKJc0ohGhIkdNF,7GRhBDsirIGkRZBtSMEzNTyDr2JQm4xx,7,3,1,0,1,0,6,0,11,1.5714285714285714,1,0.0,0,1,0,1,3,0,0,6,0,2,9,1
3003,161959,AZZvRPcRkLSa6vwofzfwsEULTUhiKy0E,7GRhBDsirIGkRZBtSMEzNTyDr2JQm4xx,1,0,0,0,0,0,1,0,1,0.14285714285714285,1,0.0,0,0,0,0,0,0,0,1,0,0,1,1
3004,161969,MaC2my4u05k7bh5sqzN5aBA80G2sJbiN,7GRhBDsirIGkRZBtSMEzNTyDr2JQm4xx,2,0,0,0,0,0,2,0,2,0.2857142857142857,1,0.0,0,0,0,0,0,0,0,2,0,0,2,1
3005,161977,1eR532KvihOWCrlFgRH6WOHtkLSsyMIL,7GRhBDsirIGkRZBtSMEzNTyDr2JQm4xx,1,0,0,0,0,0,1,0,1,0.14285714285714285,1,0.0,0,0,0,0,0,0,0,1,0,0,1,1
3006,162021,zEeoIZORCHI2d73VPIkIvoJfr8OXEKux,7GRhBDsirIGkRZBtSMEzNTyDr2JQm4xx,2,0,0,0,0,0,4,0,4,0.5714285714285714,1,0.0,0,0,0,0,0,0,0,4,0,0,4,1
3007,162029,OUbrW18OgibVb4I41eHFiFhkobpgjEP2,A3fsA9Zfv1X2fVEQhTw51lKENdNrEqT3,10,6,5,0,3,0,1,0,15,2.142857142857143,1,0.0,0,5,0,3,6,0,0,1,0,8,7,0
3008,162051,EPVEir3f8DxjouE65Q4kYI9YaQMxGE89,7GRhBDsirIGkRZBtSMEzNTyDr2JQm4xx,1,0,0,0,0,0,1,0,1,0.14285714285714285,1,0.0,0,0,0,0,0,0,0,1,0,0,1,1
3009,162089,KN2cc8h9ZKfIgxIX3NczsQQI5NEtrUt5,7GRhBDsirIGkRZBtSMEzNTyDr2JQm4xx,1,0,0,0,0,0,1,0,1,0.14285714285714285,1,0.0,0,0,0,0,0,0,0,1,0,0,1,1
3010,162174,WUH5fKgyK0ITY5YtWCIxwze8XvwwESM5,7GRhBDsirIGkRZBtSMEzNTyDr2JQm4xx,5,4,1,0,1,1,1,0,8,1.1428571428571428,1,0.0,0,1,0,1,4,1,0,1,0,2,6,1
3011,162177,1K0DpvOOuk8vTEPD17uO46UmxJ6dP2I7,7GRhBDsirIGkRZBtSMEzNTyDr2JQm4xx,23,41,14,8,7,0,4,0,74,10.571428571428571,1,0.0,21,14,8,7,20,0,0,4,0,50,24,1
3012,162182,o69BaNn8nNwkn0WRwXTNaYgGrUvOyxv9,7GRhBDsirIGkRZBtSMEzNTyDr2JQm4xx,1,0,0,0,0,0,1,0,1,0.14285714285714285,1,0.0,0,0,0,0,0,0,0,1,0,0,1,1
3013,162210,DtMnsqy6X2aMCS8gI4UYHBMONV1kA6dl,7GRhBDsirIGkRZBtSMEzNTyDr2JQm4xx,6,2,1,0,1,0,3,0,7,1.0,1,0.0,0,1,0,1,2,0,0,3,0,2,5,1
3014,162227,uuKeKkPXlaVWeKPj7Eoyh2mpLD36WFad,7GRhBDsirIGkRZBtSMEzNTyDr2JQm4xx,4,2,1,0,0,0,3,0,6,0.8571428571428571,1,0.0,1,1,0,0,1,0,0,3,0,2,4,1
3015,162252,pUVYMZKME7oxYlcseSFG7zGaoCPbxz6o,7GRhBDsirIGkRZBtSMEzNTyDr2JQm4xx,1,0,0,0,0,0,1,0,1,0.14285714285714285,1,0.0,0,0,0,0,0,0,0,1,0,0,1,1
3016,162347,d0EMfPN6PawhWgPDlCBNVjvE3wPPt43m,7GRhBDsirIGkRZBtSMEzNTyDr2JQm4xx,6,4,2,0,1,1,3,0,11,1.5714285714285714,1,0.0,0,2,0,1,4,1,0,3,0,3,8,1
3017,162653,6yKvwDs84lm1ZlLZzY92MDe16cYzJo5V,fbPkOYLVPtPgIt0MxizjfFJov3JbHyAi,7,6,3,0,4,0,2,0,15,2.142857142857143,1,0.0,2,3,0,4,4,0,0,2,0,9,6,1
3018,162654,8sS5OxFNiGXZ5DUb7jXq3k5CIC9MaMcF,fbPkOYLVPtPgIt0MxizjfFJov3JbHyAi,11,5,2,0,2,10,5,1,25,3.5714285714285716,1,0.0,0,2,0,2,5,10,0,5,1,4,21,1
3019,162655,G8NfWWfRwceCubJJsygDkNdWqvz6p8r7,fbPkOYLVPtPgIt0MxizjfFJov3JbHyAi,4,3,0,0,0,0,3,0,6,0.8571428571428571,1,0.0,0,0,0,0,3,0,0,3,0,0,6,1
3020,162662,7SOATalw6HkrZim2p905lRKSzVKbYoeJ,fbPkOYLVPtPgIt0MxizjfFJov3JbHyAi,1,0,0,0,0,0,1,0,1,0.14285714285714285,1,0.0,0,0,0,0,0,0,0,1,0,0,1,1
3021,162663,HDuNX4LLsLDTkuyYIBGkGV7jAGXEtOuc,fbPkOYLVPtPgIt0MxizjfFJov3JbHyAi,2,0,0,0,0,0,3,0,3,0.42857142857142855,1,0.0,0,0,0,0,0,0,0,3,0,0,3,1
3022,162664,92eKrHML8uFDQVHOmZmmhaJ4gTyx9NDt,fbPkOYLVPtPgIt0MxizjfFJov3JbHyAi,8,4,2,0,2,0,5,0,13,1.8571428571428572,1,0.0,1,2,0,2,3,0,0,5,0,5,8,1
3023,162665,1jbzhg6dAhJ3AT5rxEEXSMGEXTVvHdIx,fbPkOYLVPtPgIt0MxizjfFJov3JbHyAi,2,0,0,0,0,0,3,0,3,0.42857142857142855,1,0.0,0,0,0,0,0,0,0,3,0,0,3,1
3024,162667,ftYE47yTOAFIMqTQk12eUimylWQiUH5C,fbPkOYLVPtPgIt0MxizjfFJov3JbHyAi,5,2,1,0,1,0,3,0,7,1.0,1,0.0,0,1,0,1,2,0,0,3,0,2,5,1
3025,162668,UVZ0046mDQtSPXatD3KanD1N0mcrpfEe,fbPkOYLVPtPgIt0MxizjfFJov3JbHyAi,1,0,0,0,0,0,1,0,1,0.14285714285714285,1,0.0,0,0,0,0,0,0,0,1,0,0,1,1
3026,162669,MEiWJmtZSdxLL8HEGVkX5lxXxAUsGu0A,fbPkOYLVPtPgIt0MxizjfFJov3JbHyAi,1,0,0,0,0,0,1,0,1,0.14285714285714285,1,0.0,0,0,0,0,0,0,0,1,0,0,1,1
3027,162670,0FtVS7ZBI4rrErVUUUqJzFuZedQkaBu3,fbPkOYLVPtPgIt0MxizjfFJov3JbHyAi,1,0,0,0,0,0,1,0,1,0.14285714285714285,1,0.0,0,0,0,0,0,0,0,1,0,0,1,1
3028,162672,tBbrCdeCzTMG76NlqGynFt4AvfyJdikM,fbPkOYLVPtPgIt0MxizjfFJov3JbHyAi,43,32,15,48,13,1,5,1,115,16.428571428571427,1,0.0,14,15,42,13,18,1,6,5,1,84,31,1
3029,162674,Kz3qhdfTJukDJF9DtNWUYj5BtfRsMvnw,fbPkOYLVPtPgIt0MxizjfFJov3JbHyAi,2,0,0,0,0,0,2,0,2,0.2857142857142857,1,0.0,0,0,0,0,0,0,0,2,0,0,2,1
3030,162675,rde4SOUWKvk9DJZt1L0gZmVDXeNYiqdM,fbPkOYLVPtPgIt0MxizjfFJov3JbHyAi,11,6,4,0,3,0,7,1,21,3.0,1,0.0,1,4,0,3,5,0,0,7,1,8,13,1
3031,162677,JJDWSR5T5OI58OQCJ2rXYW6lv04IiDvD,fbPkOYLVPtPgIt0MxizjfFJov3JbHyAi,4,2,1,0,0,5,2,0,10,1.4285714285714286,1,0.0,0,1,0,0,2,5,0,2,0,1,9,1
3032,162683,8zAtOSKV7R70cZuke03f42P9Tj2cyqBy,fbPkOYLVPtPgIt0MxizjfFJov3JbHyAi,5,3,1,0,1,0,2,0,7,1.0,1,0.0,0,1,0,1,3,0,0,2,0,2,5,1
3033,162684,EehddsodITByQl4qGuajkHZ7QOdMQQgV,fbPkOYLVPtPgIt0MxizjfFJov3JbHyAi,7,7,2,0,4,0,2,0,15,2.142857142857143,1,0.0,4,2,0,4,3,0,0,2,0,10,5,1
3034,162686,HIfBwadqUOHP4H0miQANqcPd7btb1kCW,fbPkOYLVPtPgIt0MxizjfFJov3JbHyAi,1,0,0,0,0,0,1,0,1,0.14285714285714285,1,0.0,0,0,0,0,0,0,0,1,0,0,1,1
3035,162688,TfMiuu9vyAM0w8qFqC2lCZDreJEc3tGS,fbPkOYLVPtPgIt0MxizjfFJov3JbHyAi,6,0,0,0,0,1,15,1,17,2.4285714285714284,1,0.0,0,0,0,0,0,1,0,15,1,0,17,1
3036,162700,M9qzbHqIRAsNV3bD2hj1DPeNp2k6AjqO,fbPkOYLVPtPgIt0MxizjfFJov3JbHyAi,6,2,1,0,1,0,4,0,8,1.1428571428571428,1,0.0,0,1,0,1,2,0,0,4,0,2,6,1
3037,162702,hS70rXH0G94qmb9N1eBGrleH41NX9STz,fbPkOYLVPtPgIt0MxizjfFJov3JbHyAi,2,0,0,0,0,0,5,0,5,0.7142857142857143,1,0.0,0,0,0,0,0,0,0,5,0,0,5,1
3038,162704,fX40yNA4s3myhUDdO7ujIUD2VjxgqD1R,fbPkOYLVPtPgIt0MxizjfFJov3JbHyAi,1,0,0,0,0,0,1,0,1,0.14285714285714285,1,0.0,0,0,0,0,0,0,0,1,0,0,1,1
3039,162706,4D3Mr9GTnnSeHqe4k4RduVTIffzivKXV,fbPkOYLVPtPgIt0MxizjfFJov3JbHyAi,10,16,5,0,3,2,11,0,37,5.285714285714286,2,0.0,0,5,0,3,16,2,0,11,0,8,29,1
3040,162708,C9lLMTQ4ry2uksEvYVANv0oVpPhZMbc2,fbPkOYLVPtPgIt0MxizjfFJov3JbHyAi,8,5,3,0,2,0,4,0,14,2.0,1,0.0,0,3,0,2,5,0,0,4,0,5,9,1
3041,162710,724Z1dFlMACAt3kWIjNXL2F7EImzegCP,fbPkOYLVPtPgIt0MxizjfFJov3JbHyAi,1,0,0,0,0,0,1,0,1,0.14285714285714285,1,0.0,0,0,0,0,0,0,0,1,0,0,1,1
3042,162711,xIi7bi5lsr2kQs0Ruk7tQjf4xYRaSVFg,fbPkOYLVPtPgIt0MxizjfFJov3JbHyAi,9,6,4,0,3,0,2,0,15,2.142857142857143,1,0.0,0,4,0,3,6,0,0,2,0,7,8,1
3043,162713,FEsfreZNllfO9KbF7SZ3ITs14Rmiz03Y,fbPkOYLVPtPgIt0MxizjfFJov3JbHyAi,1,0,0,0,0,0,1,0,1,0.14285714285714285,1,0.0,0,0,0,0,0,0,0,1,0,0,1,1
3044,163452,CLgDvHjU8d0JuEtHgdUcLQg1OZ6hE3A8,RXDvfPUBYFlVdlueBFbLW0mhhAyGEqpt,8,6,5,4,1,2,1,0,19,2.7142857142857144,1,0.0,0,5,4,1,6,2,0,1,0,10,9,1
3045,164145,sG64hLkOLC3BnIsKXDBdltBd6B2Qop5m,SpATywNh6bZuzm8s1ceuBUnMUAeoAHHw,9,12,11,0,8,0,1,0,32,4.571428571428571,1,0.0,0,11,0,8,12,0,0,1,0,19,13,1
3046,164147,jSIHGu9DhhauxAb5p4KNEdGcYL30YLp5,SpATywNh6bZuzm8s1ceuBUnMUAeoAHHw,10,8,0,26,0,0,8,1,43,6.142857142857143,1,0.0,4,0,21,0,4,0,5,8,1,25,18,1
3047,164258,Or6EoLeKHgxe5lrewrc5kj5wcFrtEOsX,G8EPVSXsOYB5YQWZGiz1aVq5Pgr2GrQu,2,1,1,0,0,0,0,0,2,0.2857142857142857,1,0.0,0,1,0,0,1,0,0,0,0,1,1,1
3048,164380,V3KgKcJl8bgXAGMp5c8bz9HnZzQfd0IE,SpATywNh6bZuzm8s1ceuBUnMUAeoAHHw,13,16,8,2,5,7,2,0,40,5.714285714285714,1,0.0,0,8,2,5,16,7,0,2,0,15,25,1
3049,164385,zhF9aamFaaPbw8uvKpkg1m1HOa3rg91T,RXDvfPUBYFlVdlueBFbLW0mhhAyGEqpt,14,8,7,0,5,0,1,0,21,3.0,1,0.0,0,7,0,5,8,0,0,1,0,12,9,1
3050,164459,viXqqg0vx2jNkZn6Nty7fAz4j4zmpVoE,SpATywNh6bZuzm8s1ceuBUnMUAeoAHHw,1,0,0,0,0,0,1,0,1,0.14285714285714285,1,0.0,0,0,0,0,0,0,0,1,0,0,1,0
3051,164563,PFKfwO5QSawWdwaylbr1GRPNNNfcQLNj,SpATywNh6bZuzm8s1ceuBUnMUAeoAHHw,8,7,4,0,3,0,0,0,14,2.0,1,0.0,0,4,0,3,7,0,0,0,0,7,7,1
3052,164593,SufYsQHcxz6kvXSXszQU44Defcxsd4P8,RXDvfPUBYFlVdlueBFbLW0mhhAyGEqpt,4,3,2,0,0,0,1,0,6,0.8571428571428571,1,0.0,0,2,0,0,3,0,0,1,0,2,4,1
3053,164692,yc3vj6DBU7J8xD482LnMAUcmHp7gOl84,SpATywNh6bZuzm8s1ceuBUnMUAeoAHHw,1,0,0,0,0,0,2,0,2,0.2857142857142857,1,0.0,0,0,0,0,0,0,0,2,0,0,2,1
3054,164922,JYJhzhhLcfWnYO62UZR1KbHHs0q9wRVk,bWdj2GDclj5ofokWjzoa5jAwMkxCykd6,12,15,10,0,9,3,6,1,44,6.285714285714286,1,0.0,0,10,0,9,15,3,0,6,1,19,25,1
3055,164975,QWhWii7LiCaC2aGmlsc9abDahkygX2yj,RXDvfPUBYFlVdlueBFbLW0mhhAyGEqpt,35,54,1,52,16,6,14,2,145,20.714285714285715,2,0.0,39,1,52,16,15,6,0,14,2,108,37,1
3056,164977,PEXlBba7AOVIBit4NUGVqaiGwqnJFccE,SpATywNh6bZuzm8s1ceuBUnMUAeoAHHw,7,2,1,0,1,1,6,7,18,2.5714285714285716,1,0.0,0,1,0,1,2,1,0,6,7,2,16,1
3057,164986,lOmRRXGlwgiYmSj7mCzKIIlzTAddACO4,G8EPVSXsOYB5YQWZGiz1aVq5Pgr2GrQu,5,3,0,0,0,0,2,0,5,0.7142857142857143,1,0.0,0,0,0,0,3,0,0,2,0,0,5,1
3058,165010,vl5hKvQ1HbHB8mWdynets5dYianhkkEw,SpATywNh6bZuzm8s1ceuBUnMUAeoAHHw,23,26,2,41,1,2,8,0,80,11.428571428571429,1,0.0,9,2,34,1,17,2,7,8,0,46,34,1
3059,165032,KAsAnmW0W2sAx9iOumNKdePG23m5o5NZ,G8EPVSXsOYB5YQWZGiz1aVq5Pgr2GrQu,5,2,1,0,1,0,2,0,6,0.8571428571428571,1,0.0,0,1,0,1,2,0,0,2,0,2,4,1
3060,165036,qLiLNfiu26gzDxiYwA4Ap7WJgGvbO54T,G8EPVSXsOYB5YQWZGiz1aVq5Pgr2GrQu,18,11,10,18,9,0,1,0,49,7.0,1,0.0,0,10,14,9,11,0,4,1,0,33,16,1
3061,165060,YroV7xThop5SUet6C6S1SEBaTvc7XX29,bWdj2GDclj5ofokWjzoa5jAwMkxCykd6,4,2,1,0,1,0,1,0,5,0.7142857142857143,1,0.0,0,1,0,1,2,0,0,1,0,2,3,1
3062,165071,gW23nkmgj3NMln4Q9bQA0x4tJhRu8aiU,SpATywNh6bZuzm8s1ceuBUnMUAeoAHHw,16,25,11,16,6,0,10,1,69,9.857142857142858,1,0.0,6,11,15,6,19,0,1,10,1,38,31,1
3063,165081,L0W17t6QNDHcTTYTnmTQY5Vw4L806sfw,SpATywNh6bZuzm8s1ceuBUnMUAeoAHHw,9,7,5,0,3,0,3,0,18,2.5714285714285716,2,0.0,0,5,0,3,7,0,0,3,0,8,10,1
3064,165099,eSLdnCsz2kfsBjZ0LZmqHuo4kYNor6E7,SpATywNh6bZuzm8s1ceuBUnMUAeoAHHw,20,22,1,17,0,7,3,0,50,7.142857142857143,1,0.0,6,1,17,0,16,7,0,3,0,24,26,1
3065,165101,RdxIloCKNwZUjAJCbmYybZmkq8rwh2UY,bWdj2GDclj5ofokWjzoa5jAwMkxCykd6,4,2,1,0,1,0,1,0,5,0.7142857142857143,1,0.0,0,1,0,1,2,0,0,1,0,2,3,1
3066,165138,iqnxkAIvXEPq7LutRrGOzst5meEvTsYz,SpATywNh6bZuzm8s1ceuBUnMUAeoAHHw,7,1,1,0,1,0,5,0,8,1.1428571428571428,1,0.0,0,1,0,1,1,0,0,5,0,2,6,1
3067,165145,DSvps80WgA0EgfU877YLgHsnaYGMmkvB,SpATywNh6bZuzm8s1ceuBUnMUAeoAHHw,8,3,2,0,2,7,3,1,18,2.5714285714285716,1,0.0,0,2,0,2,3,7,0,3,1,4,14,1
3068,165151,CXDFvBGg10x2RDdl5BC09Fv76dN9FJm7,G8EPVSXsOYB5YQWZGiz1aVq5Pgr2GrQu,4,3,2,0,0,0,1,0,6,0.8571428571428571,1,0.0,0,2,0,0,3,0,0,1,0,2,4,1
3069,165162,5VFQZe1xiEoGXldz0K3uPFcNAeVpHehR,SpATywNh6bZuzm8s1ceuBUnMUAeoAHHw,10,4,4,0,3,0,4,0,15,2.142857142857143,1,0.0,0,4,0,3,4,0,0,4,0,7,8,1
3070,165188,3G9snyduwX0rdXWU1KviPhf7GghlChs3,RXDvfPUBYFlVdlueBFbLW0mhhAyGEqpt,10,12,7,0,1,4,11,0,35,5.0,1,0.0,0,7,0,1,12,4,0,11,0,8,27,1
3071,165219,wxXN8RNX3CwZNnolATAAIEVSki3SPiEo,SpATywNh6bZuzm8s1ceuBUnMUAeoAHHw,2,0,0,0,0,0,2,0,2,0.2857142857142857,1,0.0,0,0,0,0,0,0,0,2,0,0,2,1
3072,165237,gKv0B6A68Wpl10k5COv8OtVYBXqYOYRH,SpATywNh6bZuzm8s1ceuBUnMUAeoAHHw,1,0,0,0,0,0,1,0,1,0.14285714285714285,1,0.0,0,0,0,0,0,0,0,1,0,0,1,1
3073,165253,muJ6MIRhOdDL6SrbHsZ7Ks5a50Iz9AeC,bWdj2GDclj5ofokWjzoa5jAwMkxCykd6,5,2,1,0,1,0,2,0,6,0.8571428571428571,1,0.0,0,1,0,1,2,0,0,2,0,2,4,0
3074,165271,jcO499WyDjlHOvUgk4ks7QVYWjH4e9LQ,SpATywNh6bZuzm8s1ceuBUnMUAeoAHHw,1,0,0,0,0,0,1,0,1,0.14285714285714285,1,0.0,0,0,0,0,0,0,0,1,0,0,1,1
3075,165281,GFb1F59UyYIHTp4jDg01zdNYbr3jH9yn,SpATywNh6bZuzm8s1ceuBUnMUAeoAHHw,11,5,3,0,2,3,8,2,23,3.2857142857142856,1,0.0,0,3,0,2,5,3,0,8,2,5,18,1
3076,165290,ACy24Kiib1ICxyQzhy0EUbYqbqlHiujI,bWdj2GDclj5ofokWjzoa5jAwMkxCykd6,10,8,3,0,2,1,4,1,19,2.7142857142857144,1,0.0,0,3,0,2,8,1,0,4,1,5,14,1
3077,165308,FGZPr41giRou6aZ5USTD1C0RRSJGXFKn,G8EPVSXsOYB5YQWZGiz1aVq5Pgr2GrQu,8,7,3,0,2,0,2,0,14,2.0,1,0.0,0,3,0,2,7,0,0,2,0,5,9,1
3078,165339,LOR1iUTDul78F0nRew73RCh87CQAgj7q,SpATywNh6bZuzm8s1ceuBUnMUAeoAHHw,1,0,0,0,0,0,1,0,1,0.14285714285714285,1,0.0,0,0,0,0,0,0,0,1,0,0,1,1
3079,165347,oaoj9be4jW2Hot8wYgYrzLRvB0RU4KYy,RXDvfPUBYFlVdlueBFbLW0mhhAyGEqpt,3,4,2,0,0,0,2,0,8,1.1428571428571428,2,0.0,0,2,0,0,4,0,0,2,0,2,6,1
3080,165351,5NsbP59FWlyl4NFONUzt3drLLr5EFRFj,SpATywNh6bZuzm8s1ceuBUnMUAeoAHHw,2,0,0,0,0,0,2,0,2,0.2857142857142857,1,0.0,0,0,0,0,0,0,0,2,0,0,2,1
3081,165355,gmPDrqW0AqIaoYWNfDXV8E4PTJ0tnkbT,SpATywNh6bZuzm8s1ceuBUnMUAeoAHHw,10,4,3,0,1,5,8,1,22,3.142857142857143,1,0.0,0,3,0,1,4,5,0,8,1,4,18,1
3082,165387,eXv6ACzt62C4hMSoDSIQMvmz4LEnGBtm,bWdj2GDclj5ofokWjzoa5jAwMkxCykd6,6,4,3,0,2,0,2,0,11,1.5714285714285714,1,0.0,0,3,0,2,4,0,0,2,0,5,6,1
3083,165391,4BWY4WoZwowebQpACrizuzaSUpqFUPYV,SpATywNh6bZuzm8s1ceuBUnMUAeoAHHw,7,2,0,0,0,1,8,2,13,1.8571428571428572,1,0.0,0,0,0,0,2,1,0,8,2,0,13,1
3084,165395,wJflvpFe05Aoyiv7JkqhQs7iDcvnIpoZ,SpATywNh6bZuzm8s1ceuBUnMUAeoAHHw,3,0,0,0,0,0,4,0,4,0.5714285714285714,1,0.0,0,0,0,0,0,0,0,4,0,0,4,1
3085,165397,4BWY4WoZwowebQpACrizuzaSUpqFUPYV,RXDvfPUBYFlVdlueBFbLW0mhhAyGEqpt,1,0,0,0,0,0,2,0,2,0.2857142857142857,1,0.0,0,0,0,0,0,0,0,2,0,0,2,1
3086,165408,PpFcLwYNJUnxth5yje9ruR1epB1qasdR,G8EPVSXsOYB5YQWZGiz1aVq5Pgr2GrQu,1,0,0,0,0,0,1,0,1,0.14285714285714285,1,0.0,0,0,0,0,0,0,0,1,0,0,1,1
3087,165416,7gfKKxmAEuUaewGGeFJgV5nEPJNQy1ri,bWdj2GDclj5ofokWjzoa5jAwMkxCykd6,6,3,1,0,1,0,2,0,7,1.0,1,0.0,0,1,0,1,3,0,0,2,0,2,5,1
3088,165421,MuPHXkwjCSwz1RoycqAjYJvCwPC5fRHQ,SpATywNh6bZuzm8s1ceuBUnMUAeoAHHw,4,2,0,0,0,0,3,0,5,0.7142857142857143,1,0.0,0,0,0,0,2,0,0,3,0,0,5,0
3089,165424,unnmDTt6VikDSSld76xj3NnZu4moxEml,SpATywNh6bZuzm8s1ceuBUnMUAeoAHHw,4,2,1,0,1,0,1,0,5,0.7142857142857143,1,0.0,0,1,0,1,2,0,0,1,0,2,3,1
3090,165466,mURbRAHPKPnW9MwIb0RLcTIXqQNH7qbA,G8EPVSXsOYB5YQWZGiz1aVq5Pgr2GrQu,8,4,3,4,2,0,1,0,14,2.0,1,0.0,0,3,3,2,4,0,1,1,0,8,6,1
3091,165471,zrTXSfdUWbNWByIycayXKhWX2nhPdOah,SpATywNh6bZuzm8s1ceuBUnMUAeoAHHw,5,3,2,0,2,0,2,0,9,1.2857142857142858,1,0.0,0,2,0,2,3,0,0,2,0,4,5,1
3092,165474,ef55znmweQJrijlI0fO1Ekc271nZnV0m,bWdj2GDclj5ofokWjzoa5jAwMkxCykd6,4,0,0,0,0,0,3,1,4,0.5714285714285714,1,0.0,0,0,0,0,0,0,0,3,1,0,4,1
3093,165476,wg9kzusa79hS4fFC5hU9Laht66GWJcDA,SpATywNh6bZuzm8s1ceuBUnMUAeoAHHw,2,0,0,0,0,0,2,0,2,0.2857142857142857,1,0.0,0,0,0,0,0,0,0,2,0,0,2,1
3094,165480,u8gc5TatjVTaxEyEUtNlqAAFJuTBFyST,SpATywNh6bZuzm8s1ceuBUnMUAeoAHHw,1,0,0,0,0,0,1,0,1,0.14285714285714285,1,0.0,0,0,0,0,0,0,0,1,0,0,1,1
3095,165494,kVwgJQqzaO15lvZkwwinpycbi4tCASRL,G8EPVSXsOYB5YQWZGiz1aVq5Pgr2GrQu,17,23,3,18,4,13,2,1,64,9.142857142857142,1,0.0,15,3,10,4,8,13,8,2,1,32,32,1
3096,165498,khqyesGKZx6MpifmBhKg4XXFdITB5Rat,bWdj2GDclj5ofokWjzoa5jAwMkxCykd6,2,0,0,0,0,0,2,0,2,0.2857142857142857,1,0.0,0,0,0,0,0,0,0,2,0,0,2,1
3097,165517,K96pKWxanyeEDM8caXTjQInVlZNIUXf3,SpATywNh6bZuzm8s1ceuBUnMUAeoAHHw,21,16,8,19,5,15,6,2,71,10.142857142857142,1,0.0,7,8,16,5,9,15,3,6,2,36,35,1
3098,165544,cLRv4oHsLxWfkE6gs4eN6fO5y0RK8Odw,SpATywNh6bZuzm8s1ceuBUnMUAeoAHHw,14,12,2,15,1,0,3,0,33,4.714285714285714,1,0.0,2,2,14,1,10,0,1,3,0,19,14,1
3099,165551,8HRO39ObdbulUBajMG3YAwK0YHdJtgkL,SpATywNh6bZuzm8s1ceuBUnMUAeoAHHw,13,19,5,20,2,0,1,0,47,6.714285714285714,1,0.0,10,5,17,2,9,0,3,1,0,34,13,1
3100,165561,31ac9IJz27HinkIEt0yrmmYrar7i8NEX,SpATywNh6bZuzm8s1ceuBUnMUAeoAHHw,1,0,0,0,0,0,1,0,1,0.14285714285714285,1,0.0,0,0,0,0,0,0,0,1,0,0,1,1
3101,165574,JfftjOGdDbpgbrupi0Gwr899R0jzXikJ,G8EPVSXsOYB5YQWZGiz1aVq5Pgr2GrQu,8,9,5,0,2,0,3,0,19,2.7142857142857144,2,0.0,0,5,0,2,9,0,0,3,0,7,12,1
3102,165575,8aKlO5cCI4yOnqtrz5S83gXv1equhodS,G8EPVSXsOYB5YQWZGiz1aVq5Pgr2GrQu,8,8,2,0,3,0,3,0,16,2.2857142857142856,1,0.0,6,2,0,3,2,0,0,3,0,11,5,1
3103,165579,L1KQaJmsFUgy5JpGUsnj3yIIihvD4WWY,SpATywNh6bZuzm8s1ceuBUnMUAeoAHHw,7,10,5,0,2,0,2,0,19,2.7142857142857144,1,0.0,3,5,0,2,7,0,0,2,0,10,9,1
3104,165580,qoIGs6RP8XMC5yN9VowJtSVp77FsPrRk,bWdj2GDclj5ofokWjzoa5jAwMkxCykd6,7,4,3,0,2,0,1,0,10,1.4285714285714286,1,0.0,0,3,0,2,4,0,0,1,0,5,5,1
3105,165594,JlrarspOUiM43Q1LxxzJX6UJ5zQZ4pa3,G8EPVSXsOYB5YQWZGiz1aVq5Pgr2GrQu,4,2,1,0,1,0,1,0,5,0.7142857142857143,1,0.0,0,1,0,1,2,0,0,1,0,2,3,1
3106,165631,GEZRjwL8K0Izm01jtEreajWlGeO5rHqg,SpATywNh6bZuzm8s1ceuBUnMUAeoAHHw,10,9,3,22,1,0,5,0,40,5.714285714285714,2,0.0,3,3,18,1,6,0,4,5,0,25,15,1
3107,165637,OLNUzQUHvlNsi2WFlH5eEyaieqKXrEz7,G8EPVSXsOYB5YQWZGiz1aVq5Pgr2GrQu,1,0,0,0,0,0,1,0,1,0.14285714285714285,1,0.0,0,0,0,0,0,0,0,1,0,0,1,1
3108,165668,e4SJlWpUdMlW0LkwuTE29pgj3noS6rgx,SpATywNh6bZuzm8s1ceuBUnMUAeoAHHw,1,0,0,0,0,0,1,0,1,0.14285714285714285,1,0.0,0,0,0,0,0,0,0,1,0,0,1,1
3109,165670,ec1LcdXAjzvm4pz4UlXIURCzEb68OOjY,SpATywNh6bZuzm8s1ceuBUnMUAeoAHHw,1,0,0,0,0,0,1,0,1,0.14285714285714285,1,0.0,0,0,0,0,0,0,0,1,0,0,1,0
3110,165671,ldzbIC4VdNsM8t2O505cyUmYK0rWwYfY,bWdj2GDclj5ofokWjzoa5jAwMkxCykd6,5,0,0,0,0,0,4,1,5,0.7142857142857143,1,0.0,0,0,0,0,0,0,0,4,1,0,5,1
3111,165674,q8fKbbyHDwglzqbsTcqtDnNuKFFWoakG,SpATywNh6bZuzm8s1ceuBUnMUAeoAHHw,5,2,1,0,1,0,2,0,6,0.8571428571428571,1,0.0,0,1,0,1,2,0,0,2,0,2,4,1
3112,165687,rzRsiRIy5S5PJ3F6R6iAFiLgtXERTKGk,SpATywNh6bZuzm8s1ceuBUnMUAeoAHHw,12,16,9,0,2,1,5,1,34,4.857142857142857,1,0.0,0,9,0,2,16,1,0,5,1,11,23,1
3113,165704,aBWIo3Zb0x1GrHxSSFQ0sr4ViufznfA6,bWdj2GDclj5ofokWjzoa5jAwMkxCykd6,1,0,0,0,0,0,2,0,2,0.2857142857142857,1,0.0,0,0,0,0,0,0,0,2,0,0,2,0
3114,165720,EelpZh5xWl6mtPCPTTMGh3oiYl9f9eIu,SpATywNh6bZuzm8s1ceuBUnMUAeoAHHw,4,3,2,0,0,0,1,0,6,0.8571428571428571,1,0.0,0,2,0,0,3,0,0,1,0,2,4,1
3115,165753,K7gxH2H2bYXoDZcS1lp3t0a4OCfbOLwQ,bWdj2GDclj5ofokWjzoa5jAwMkxCykd6,6,1,1,0,1,0,5,0,8,1.1428571428571428,1,0.0,0,1,0,1,1,0,0,5,0,2,6,1
3116,165754,K6ObBSwI3jvthL8D7fF5vG4yQ857Kh2f,SpATywNh6bZuzm8s1ceuBUnMUAeoAHHw,1,0,0,0,0,0,1,0,1,0.14285714285714285,1,0.0,0,0,0,0,0,0,0,1,0,0,1,1
3117,165767,hbzbE3YW3TFJZGn3KQWHVTTu9qGbrE8v,bWdj2GDclj5ofokWjzoa5jAwMkxCykd6,5,2,1,0,1,0,2,0,6,0.8571428571428571,1,0.0,0,1,0,1,2,0,0,2,0,2,4,1
3118,165774,OOTqWE5x0MzBGyALni92jmdLSQIdjajZ,G8EPVSXsOYB5YQWZGiz1aVq5Pgr2GrQu,5,4,1,0,0,0,3,0,8,1.1428571428571428,1,0.0,0,1,0,0,4,0,0,3,0,1,7,1
3119,165784,rh0SgumcqbNnCp7Kv0VptrPMVPtrWDm8,RXDvfPUBYFlVdlueBFbLW0mhhAyGEqpt,1,0,0,0,0,0,1,0,1,0.14285714285714285,1,0.0,0,0,0,0,0,0,0,1,0,0,1,1
3120,165796,0Au7FrQGJI1dB5PAH0C5RtkL9GE7xsrQ,G8EPVSXsOYB5YQWZGiz1aVq5Pgr2GrQu,2,0,0,0,0,0,2,0,2,0.2857142857142857,1,0.0,0,0,0,0,0,0,0,2,0,0,2,1
3121,165809,Be8IM2i8TFABf4hrPs9xmqBicVH2EMoi,SpATywNh6bZuzm8s1ceuBUnMUAeoAHHw,5,2,1,0,1,0,2,0,6,0.8571428571428571,1,0.0,0,1,0,1,2,0,0,2,0,2,4,1
3122,165968,m2dEISaBvHWrLGQEI5zibEiH1nbUMDmE,fbPkOYLVPtPgIt0MxizjfFJov3JbHyAi,9,5,4,0,4,0,2,0,15,2.142857142857143,1,0.0,0,4,0,4,5,0,0,2,0,8,7,1
3123,165971,No3uaZVX8QfUWi2WuoYFYrVrLQNiuZit,fbPkOYLVPtPgIt0MxizjfFJov3JbHyAi,7,7,5,0,1,0,2,0,15,2.142857142857143,1,0.0,1,5,0,1,6,0,0,2,0,7,8,0
3124,166073,Sy0IBVghIdDN5uhsYaAtE4EZP4lbDR6C,fbPkOYLVPtPgIt0MxizjfFJov3JbHyAi,8,4,3,0,2,0,3,0,12,1.7142857142857142,1,0.0,0,3,0,2,4,0,0,3,0,5,7,1
3125,167115,WAC7RGZ1uYeT92igfYiLgTnHWPEtN2IA,A3fsA9Zfv1X2fVEQhTw51lKENdNrEqT3,8,4,3,0,3,0,3,0,13,1.8571428571428572,1,0.0,0,3,0,3,4,0,0,3,0,6,7,1
3126,169711,gzmN8VLkF6QCaC4IobudOv6PTgb6exUk,fbPkOYLVPtPgIt0MxizjfFJov3JbHyAi,4,2,1,0,1,0,1,0,5,0.7142857142857143,1,0.0,0,1,0,1,2,0,0,1,0,2,3,1
3127,172787,YY7yHizDn0UpGHVq4qoTfbulP3ev5TkC,fbPkOYLVPtPgIt0MxizjfFJov3JbHyAi,6,3,2,0,2,0,1,0,8,1.1428571428571428,1,0.0,0,2,0,2,3,0,0,1,0,4,4,1
3128,174421,mSZYyfRNnqnDs7qyuaQEMEvx5vC2JS4M,A3fsA9Zfv1X2fVEQhTw51lKENdNrEqT3,23,14,11,34,9,0,2,0,70,10.0,1,0.0,2,11,26,9,12,0,8,2,0,48,22,0
3129,174478,EhHrinjt1AkEWC09AFZwBuP61S5NJgjn,SpATywNh6bZuzm8s1ceuBUnMUAeoAHHw,10,10,3,19,0,9,3,0,44,6.285714285714286,1,0.0,5,3,16,0,5,9,3,3,0,24,20,0
3130,174502,4G31JkuuWxQoMwYLKWmTZsOhrqR0raRg,A3fsA9Zfv1X2fVEQhTw51lKENdNrEqT3,10,7,1,0,1,0,2,0,11,1.5714285714285714,1,0.0,0,1,0,1,7,0,0,2,0,2,9,1
3131,174513,1JwhB7sCpqQuMWgVLCoQdnUSus34sW5p,A3fsA9Zfv1X2fVEQhTw51lKENdNrEqT3,4,2,0,0,0,0,2,0,4,0.5714285714285714,1,0.0,0,0,0,0,2,0,0,2,0,0,4,1
3132,174541,FOCCuGaJ7zYTl7CCCo7T3PqrLtxGVeiU,A3fsA9Zfv1X2fVEQhTw51lKENdNrEqT3,36,25,0,50,0,6,7,0,88,12.571428571428571,1,0.0,2,0,45,0,23,6,5,7,0,47,41,1
3133,174563,m98O4dP1opmo7o2tpUGDqrUnbkirc7sM,A3fsA9Zfv1X2fVEQhTw51lKENdNrEqT3,12,17,0,0,0,1,2,0,20,2.857142857142857,1,0.0,1,0,0,0,16,1,0,2,0,1,19,1
3134,174704,ExNrdfeKsdYl3xmpiJlCBa13JPKyssuX,bWdj2GDclj5ofokWjzoa5jAwMkxCykd6,1,0,0,0,0,0,1,0,1,0.14285714285714285,1,0.0,0,0,0,0,0,0,0,1,0,0,1,1
3135,174813,Bau8Ni7vPFHL0Lb3hYTZjsOuiN8oYfUJ,A3fsA9Zfv1X2fVEQhTw51lKENdNrEqT3,1,0,0,0,0,0,1,0,1,0.14285714285714285,1,0.0,0,0,0,0,0,0,0,1,0,0,1,1
3136,174900,5zea5vrXS7Bt1LjTuEN0slFtYiNlymMO,A3fsA9Zfv1X2fVEQhTw51lKENdNrEqT3,7,5,0,0,0,0,3,0,8,1.1428571428571428,1,0.0,0,0,0,0,5,0,0,3,0,0,8,1
3137,174927,A6qBZik0VBfWjUh1l97ldNrUQvZV7VDA,A3fsA9Zfv1X2fVEQhTw51lKENdNrEqT3,1,0,0,0,0,0,1,0,1,0.14285714285714285,1,0.0,0,0,0,0,0,0,0,1,0,0,1,1
3138,175194,8RK6HQkv51lSsSE1n9EptQjyHrkMwfO0,A3fsA9Zfv1X2fVEQhTw51lKENdNrEqT3,1,0,0,0,0,0,1,0,1,0.14285714285714285,1,0.0,0,0,0,0,0,0,0,1,0,0,1,1
3139,175240,xCHQAq5m2mtyQES4gfg6MjCHDUVD1J71,A3fsA9Zfv1X2fVEQhTw51lKENdNrEqT3,5,6,0,0,0,0,2,0,8,1.1428571428571428,1,0.0,0,0,0,0,6,0,0,2,0,0,8,1
3140,175245,ltkP6i2vq0mcbwSjcj4Xv8kSZr3VUqSC,A3fsA9Zfv1X2fVEQhTw51lKENdNrEqT3,8,3,1,0,1,1,4,0,10,1.4285714285714286,1,0.0,0,1,0,1,3,1,0,4,0,2,8,1
3141,175284,Fl2rv0GIrb1pZGPCAVV4X3WnsKhjbfP2,A3fsA9Zfv1X2fVEQhTw51lKENdNrEqT3,8,3,1,0,1,0,5,0,10,1.4285714285714286,1,0.0,0,1,0,1,3,0,0,5,0,2,8,1
3142,175297,cZy6FfSysDXCciyaQBXiY1ElSSQnaYdy,A3fsA9Zfv1X2fVEQhTw51lKENdNrEqT3,1,0,0,0,0,0,1,0,1,0.14285714285714285,1,0.0,0,0,0,0,0,0,0,1,0,0,1,1
3143,175301,QHPjxy7GRZxkE11G18jf1qUIPRoUJGTA,A3fsA9Zfv1X2fVEQhTw51lKENdNrEqT3,2,0,0,0,0,0,2,0,2,0.2857142857142857,1,0.0,0,0,0,0,0,0,0,2,0,0,2,1
3144,175308,SZHxM16r0lTBVocJi0Li5OQAgxZ4K7jz,A3fsA9Zfv1X2fVEQhTw51lKENdNrEqT3,1,0,0,0,0,0,1,0,1,0.14285714285714285,1,0.0,0,0,0,0,0,0,0,1,0,0,1,1
3145,175402,Sy0IBVghIdDN5uhsYaAtE4EZP4lbDR6C,A3fsA9Zfv1X2fVEQhTw51lKENdNrEqT3,2,0,0,0,0,0,2,0,2,0.2857142857142857,1,0.0,0,0,0,0,0,0,0,2,0,0,2,1
3146,175439,GYW6F4RrALjPRMj1o3hg6mOIhsonMLzv,fbPkOYLVPtPgIt0MxizjfFJov3JbHyAi,8,6,4,0,2,1,6,1,20,2.857142857142857,1,0.0,0,4,0,2,6,1,0,6,1,6,14,1
3147,175440,nNNmD0vjq4euECk9TASJLqcY7Yh4uOs7,fbPkOYLVPtPgIt0MxizjfFJov3JbHyAi,1,0,0,0,0,0,1,0,1,0.14285714285714285,1,0.0,0,0,0,0,0,0,0,1,0,0,1,1
3148,175444,m7igssBCJoYXk9iLEbegzoIoWBibQRze,fbPkOYLVPtPgIt0MxizjfFJov3JbHyAi,7,3,2,0,2,0,4,0,11,1.5714285714285714,1,0.0,0,2,0,2,3,0,0,4,0,4,7,1
3149,175445,G6eTAhE9AzVlPFZeS2VRSwDOXtmFA3PX,fbPkOYLVPtPgIt0MxizjfFJov3JbHyAi,4,2,1,0,1,0,1,0,5,0.7142857142857143,1,0.0,0,1,0,1,2,0,0,1,0,2,3,1
3150,175446,juzfwxHXCKii6ul7funGUBQbDVPCyrBB,fbPkOYLVPtPgIt0MxizjfFJov3JbHyAi,8,5,3,0,2,0,3,0,13,1.8571428571428572,1,0.0,0,3,0,2,5,0,0,3,0,5,8,1
3151,175447,S9lWYm9a6FVZ2ODtiJC49kgBYS9VqhGG,fbPkOYLVPtPgIt0MxizjfFJov3JbHyAi,1,0,0,0,0,0,1,0,1,0.14285714285714285,1,0.0,0,0,0,0,0,0,0,1,0,0,1,1
3152,175450,iM7LGMV4VAjVfcFaZFGWFvZYzMBFfU3L,fbPkOYLVPtPgIt0MxizjfFJov3JbHyAi,4,2,1,0,0,0,2,0,5,0.7142857142857143,1,0.0,0,1,0,0,2,0,0,2,0,1,4,1
3153,175451,CH7rIEiCYJderq7iXskzAGjPNDy8sGGS,fbPkOYLVPtPgIt0MxizjfFJov3JbHyAi,6,4,2,0,2,0,1,0,9,1.2857142857142858,1,0.0,0,2,0,2,4,0,0,1,0,4,5,1
3154,175453,BbTCRpsgAELmbNInOYYMcpD2adqJUxaz,fbPkOYLVPtPgIt0MxizjfFJov3JbHyAi,9,9,6,0,2,0,1,0,18,2.5714285714285716,1,0.0,0,6,0,2,9,0,0,1,0,8,10,1
3155,175458,QtQR4oqQYT2ypg7Ijhn9emxLfIBM3Int,fbPkOYLVPtPgIt0MxizjfFJov3JbHyAi,5,3,0,0,0,0,3,0,6,0.8571428571428571,1,0.0,0,0,0,0,3,0,0,3,0,0,6,1
3156,175459,DwjBo7B8hqv5XCU5nIWsl6HyuOZ8ub9E,fbPkOYLVPtPgIt0MxizjfFJov3JbHyAi,8,3,2,0,2,7,5,1,20,2.857142857142857,1,0.0,0,2,0,2,3,7,0,5,1,4,16,1
3157,175460,XCvldc0Z25dIQokzzDRNDq71ULXBAM8F,fbPkOYLVPtPgIt0MxizjfFJov3JbHyAi,1,0,0,0,0,0,1,0,1,0.14285714285714285,1,0.0,0,0,0,0,0,0,0,1,0,0,1,1
3158,175462,IxfgoqdA7w5aqdySNUMg1lSOzs1KfDTQ,fbPkOYLVPtPgIt0MxizjfFJov3JbHyAi,1,0,0,0,0,0,1,0,1,0.14285714285714285,1,0.0,0,0,0,0,0,0,0,1,0,0,1,1
3159,175463,X9Zz94IfisZgL8IIKroVo2fOO5DotKd5,fbPkOYLVPtPgIt0MxizjfFJov3JbHyAi,5,2,1,0,1,0,4,0,8,1.1428571428571428,1,0.0,0,1,0,1,2,0,0,4,0,2,6,1
3160,175464,lo7UFRSxvdl5IBJpBfFiWaG1K4lSvIph,fbPkOYLVPtPgIt0MxizjfFJov3JbHyAi,8,20,1,0,1,3,6,1,32,4.571428571428571,1,0.0,2,1,0,1,18,3,0,6,1,4,28,1
3161,175466,WOZ2OKb8udE0dHnoi6x9XrHwhNGFHraB,fbPkOYLVPtPgIt0MxizjfFJov3JbHyAi,9,5,4,0,4,0,6,0,19,2.7142857142857144,1,0.0,0,4,0,4,5,0,0,6,0,8,11,1
3162,175470,JVXyLCa1OOjkw5FBCNd333Deiv79lmst,fbPkOYLVPtPgIt0MxizjfFJov3JbHyAi,8,4,1,0,1,0,4,1,11,1.5714285714285714,1,0.0,0,1,0,1,4,0,0,4,1,2,9,1
3163,175472,h6X7uJXHEtMGd13bXyyZ1xP1ebsu9X0Q,fbPkOYLVPtPgIt0MxizjfFJov3JbHyAi,1,0,0,0,0,0,1,0,1,0.14285714285714285,1,0.0,0,0,0,0,0,0,0,1,0,0,1,1
3164,175473,DLoC6wyjO8HZpRQISW7NxAXHzLyIHStZ,fbPkOYLVPtPgIt0MxizjfFJov3JbHyAi,11,11,7,0,5,5,9,2,39,5.571428571428571,1,0.0,2,7,0,5,9,5,0,9,2,14,25,1
3165,175482,ifbjnZ4tXcK4dpvbMG3JmLnAWvMTSG5S,fbPkOYLVPtPgIt0MxizjfFJov3JbHyAi,10,6,4,0,3,1,5,1,20,2.857142857142857,1,0.0,0,4,0,3,6,1,0,5,1,7,13,1
3166,175483,1mlsGNriImtvI5bJf0wHc3mOCBScmLWj,fbPkOYLVPtPgIt0MxizjfFJov3JbHyAi,9,9,6,0,2,0,4,0,21,3.0,1,0.0,0,6,0,2,9,0,0,4,0,8,13,1
3167,175488,nQ8zyPaxuBVV0E4EnN5ZsvrgPzjbJntO,fbPkOYLVPtPgIt0MxizjfFJov3JbHyAi,1,0,0,0,0,0,1,0,1,0.14285714285714285,1,0.0,0,0,0,0,0,0,0,1,0,0,1,1
3168,175491,TSm2R7cUPaXhbTrj1LddmwVL7dduRSSa,fbPkOYLVPtPgIt0MxizjfFJov3JbHyAi,1,0,0,0,0,0,1,0,1,0.14285714285714285,1,0.0,0,0,0,0,0,0,0,1,0,0,1,1
3169,175495,zfwGGWHtlXaIDlcPdgrN93eHfeWgyv8l,fbPkOYLVPtPgIt0MxizjfFJov3JbHyAi,1,0,0,0,0,0,1,0,1,0.14285714285714285,1,0.0,0,0,0,0,0,0,0,1,0,0,1,1
3170,175498,1hpNOEDtPnezHqQbgrwjtuMuvCrx4S8A,fbPkOYLVPtPgIt0MxizjfFJov3JbHyAi,13,8,5,0,5,0,2,0,20,2.857142857142857,1,0.0,0,5,0,5,8,0,0,2,0,10,10,1
3171,175509,Nqm1BU7DDwtz5J6sAMZajfpCtdyka8BU,fbPkOYLVPtPgIt0MxizjfFJov3JbHyAi,6,2,0,0,0,1,5,1,9,1.2857142857142858,1,0.0,0,0,0,0,2,1,0,5,1,0,9,1
3172,175511,lFbeWg5shoMMNqLk9Vsb1yCv5tI9us0k,fbPkOYLVPtPgIt0MxizjfFJov3JbHyAi,10,7,3,1,4,0,2,0,17,2.4285714285714284,1,0.0,3,3,1,4,4,0,0,2,0,11,6,1
3173,175512,IybfLDxPgLkzxuWcMtBTeSNmrb96OWvv,fbPkOYLVPtPgIt0MxizjfFJov3JbHyAi,7,3,2,0,2,0,5,0,12,1.7142857142857142,1,0.0,0,2,0,2,3,0,0,5,0,4,8,1
3174,175513,PtpNjyWIZGFluToFVMnoVp1uIp4PTNlV,fbPkOYLVPtPgIt0MxizjfFJov3JbHyAi,4,2,1,0,1,0,1,0,5,0.7142857142857143,1,0.0,0,1,0,1,2,0,0,1,0,2,3,1
3175,175514,lreXxc1V0mKbQc1Fk3HBAHJga7i3ZlPb,fbPkOYLVPtPgIt0MxizjfFJov3JbHyAi,4,0,0,0,0,2,3,1,6,0.8571428571428571,1,0.0,0,0,0,0,0,2,0,3,1,0,6,1
3176,175517,vM4VSeTdZPRUwUiCQKf2BuawElru5sNo,fbPkOYLVPtPgIt0MxizjfFJov3JbHyAi,5,2,1,0,1,0,4,0,8,1.1428571428571428,1,0.0,0,1,0,1,2,0,0,4,0,2,6,1
3177,175519,zZcLo3UhXrAelR5FTKmHlxSZl0wW5YNH,fbPkOYLVPtPgIt0MxizjfFJov3JbHyAi,2,0,0,0,0,0,2,0,2,0.2857142857142857,1,0.0,0,0,0,0,0,0,0,2,0,0,2,1
3178,175521,Z6WF7UnPSWhERdL5zMrsQHVgRqZ42S1n,fbPkOYLVPtPgIt0MxizjfFJov3JbHyAi,2,0,0,0,0,0,2,0,2,0.2857142857142857,1,0.0,0,0,0,0,0,0,0,2,0,0,2,1
3179,175522,wmNYHs69T6CHydhCxfzhydbjA79LMuTD,fbPkOYLVPtPgIt0MxizjfFJov3JbHyAi,7,3,2,0,2,0,2,0,9,1.2857142857142858,1,0.0,0,2,0,2,3,0,0,2,0,4,5,1
3180,175525,QYaJtD7z5M6YcGNpdHV2JTsxqV4tXm9a,fbPkOYLVPtPgIt0MxizjfFJov3JbHyAi,1,0,0,0,0,0,1,0,1,0.14285714285714285,1,0.0,0,0,0,0,0,0,0,1,0,0,1,1
3181,175527,nWRrumnCgp6om94YmjE4CGN8JbKK91s6,fbPkOYLVPtPgIt0MxizjfFJov3JbHyAi,5,2,1,0,1,0,2,0,6,0.8571428571428571,1,0.0,0,1,0,1,2,0,0,2,0,2,4,1
3182,175529,vZY5RTyvAOyjF1AYeCntOYrEo9bIz6lQ,fbPkOYLVPtPgIt0MxizjfFJov3JbHyAi,4,2,1,0,1,0,1,0,5,0.7142857142857143,1,0.0,0,1,0,1,2,0,0,1,0,2,3,1
3183,175530,pmVmbJyOmxphdEXp0eyLXWB51e0e00i9,fbPkOYLVPtPgIt0MxizjfFJov3JbHyAi,7,4,2,0,2,0,3,0,11,1.5714285714285714,1,0.0,0,2,0,2,4,0,0,3,0,4,7,1
3184,175532,Fov1WBMQ9iK40YBqm6CCLgYUxW79OKx1,fbPkOYLVPtPgIt0MxizjfFJov3JbHyAi,10,10,4,0,3,2,9,2,30,4.285714285714286,1,0.0,4,4,0,3,6,2,0,9,2,11,19,1
3185,175538,8DjKcd2LJZN4ior4lkPdphxSMFfQLRGu,fbPkOYLVPtPgIt0MxizjfFJov3JbHyAi,3,0,0,0,0,4,2,0,6,0.8571428571428571,1,0.0,0,0,0,0,0,4,0,2,0,0,6,1
3186,175541,GrlLrE19mhpGaNnXMSNrKxn7KnB7PvUl,fbPkOYLVPtPgIt0MxizjfFJov3JbHyAi,7,4,3,0,3,0,2,0,12,1.7142857142857142,1,0.0,0,3,0,3,4,0,0,2,0,6,6,1
3187,175546,uCYmXbV69zfGcUg2j8bzRMpMZlMnqjT7,fbPkOYLVPtPgIt0MxizjfFJov3JbHyAi,1,0,0,0,0,0,1,0,1,0.14285714285714285,1,0.0,0,0,0,0,0,0,0,1,0,0,1,0
3188,177325,LchclclKlrYHOcXtmhi0Eqhs9daD9eJz,RXDvfPUBYFlVdlueBFbLW0mhhAyGEqpt,46,56,24,124,20,2,2,0,228,32.57142857142857,1,0.0,31,24,115,20,25,2,9,2,0,190,38,1
3189,177347,fGIeAB7IRJCHxzCo8u4GLaPKxQfHeCdi,bWdj2GDclj5ofokWjzoa5jAwMkxCykd6,8,13,5,0,2,0,2,0,22,3.142857142857143,1,0.0,2,5,0,2,11,0,0,2,0,9,13,1
3190,177667,ipVvzWInHV8LAm6qVHoFaV0nnfOGT5ry,SpATywNh6bZuzm8s1ceuBUnMUAeoAHHw,1,0,0,0,0,0,1,0,1,0.14285714285714285,1,0.0,0,0,0,0,0,0,0,1,0,0,1,1
3191,177668,p54dVByd9epbS397rAmrAwTW19iwa3UI,bWdj2GDclj5ofokWjzoa5jAwMkxCykd6,7,3,1,0,1,0,4,0,9,1.2857142857142858,1,0.0,0,1,0,1,3,0,0,4,0,2,7,1
3192,177691,A6oLHbyuoChPN0ROQ5fG10dHGRIiYTTe,SpATywNh6bZuzm8s1ceuBUnMUAeoAHHw,28,29,15,29,10,3,4,0,90,12.857142857142858,1,0.0,11,15,23,10,18,3,6,4,0,59,31,1
3193,177727,G4leME9fPSQLSwsbbKKP6ouczXxo1Wlw,SpATywNh6bZuzm8s1ceuBUnMUAeoAHHw,15,16,7,13,4,0,0,0,40,5.714285714285714,1,0.0,3,7,12,4,13,0,1,0,0,26,14,1
3194,177730,Mvi2iSl7G6NCzuzRtyT9FnCVUPePQVy1,bWdj2GDclj5ofokWjzoa5jAwMkxCykd6,9,18,6,34,5,0,4,0,67,9.571428571428571,1,0.0,9,6,33,5,9,0,1,4,0,53,14,1
3195,177736,3kQ25Y1n5ZQOWjLlVHwcdpzmvrmbPTL3,SpATywNh6bZuzm8s1ceuBUnMUAeoAHHw,14,13,0,0,0,0,4,0,17,2.4285714285714284,1,0.0,0,0,0,0,13,0,0,4,0,0,17,1
3196,177750,QjqGEc1MUmw3VEVWGhyD00LM60lNtKPh,SpATywNh6bZuzm8s1ceuBUnMUAeoAHHw,2,0,0,0,0,0,2,0,2,0.2857142857142857,1,0.0,0,0,0,0,0,0,0,2,0,0,2,1
3197,177755,JHMFz2Gy459G1ldyhA75ALSO8YlPxA4n,A3fsA9Zfv1X2fVEQhTw51lKENdNrEqT3,1,0,0,0,0,0,1,0,1,0.14285714285714285,1,0.0,0,0,0,0,0,0,0,1,0,0,1,1
3198,177766,zmIcVKuNFZm39Xd0zSmSfRofuInASrOB,A3fsA9Zfv1X2fVEQhTw51lKENdNrEqT3,5,2,1,0,1,0,2,0,6,0.8571428571428571,1,0.0,0,1,0,1,2,0,0,2,0,2,4,1
3199,177770,AsCRvwtleeGS6D6WD7MD0zpcijqiUpJg,SpATywNh6bZuzm8s1ceuBUnMUAeoAHHw,1,0,0,0,0,0,1,0,1,0.14285714285714285,1,0.0,0,0,0,0,0,0,0,1,0,0,1,1
3200,177792,Xrjgmm5mgiySWho5SEzdacBLSLkDfygK,SpATywNh6bZuzm8s1ceuBUnMUAeoAHHw,19,9,8,0,7,0,4,0,28,4.0,1,0.0,0,8,0,7,9,0,0,4,0,15,13,1
3201,177799,Yyccad96I3hbgqqNLycAhyGOxNsdJzLL,SpATywNh6bZuzm8s1ceuBUnMUAeoAHHw,15,19,2,0,1,1,9,1,33,4.714285714285714,1,0.0,2,2,0,1,17,1,0,9,1,5,28,1
3202,177809,h1QswJ31uhxfyhfP3OhNVJBUvcTub6pW,bWdj2GDclj5ofokWjzoa5jAwMkxCykd6,2,0,0,0,0,0,2,0,2,0.2857142857142857,1,0.0,0,0,0,0,0,0,0,2,0,0,2,1
3203,177811,KVNNbfG6UQEmke4Oy3hBc7o3aqspqwkG,bWdj2GDclj5ofokWjzoa5jAwMkxCykd6,4,0,0,0,0,0,6,0,6,0.8571428571428571,1,0.0,0,0,0,0,0,0,0,6,0,0,6,1
3204,177817,1lCKn2N8CWNZFqkAXfsrQhctsw90ZkSX,bWdj2GDclj5ofokWjzoa5jAwMkxCykd6,5,2,1,0,1,0,3,0,7,1.0,1,0.0,0,1,0,1,2,0,0,3,0,2,5,1
3205,177866,Pk6H5V6IGPh6QxXblrwO7oI0RG2f9ujy,A3fsA9Zfv1X2fVEQhTw51lKENdNrEqT3,16,9,7,10,5,0,3,0,34,4.857142857142857,1,0.0,0,7,9,5,9,0,1,3,0,21,13,1
3206,177883,3KDcn3HvW3CpzWtc78PKWcm3CxgBERCi,SpATywNh6bZuzm8s1ceuBUnMUAeoAHHw,1,0,0,0,0,0,1,0,1,0.14285714285714285,1,0.0,0,0,0,0,0,0,0,1,0,0,1,1
3207,177898,qKod71hGHVj3I0edUan3ZmfswQIOaBhk,SpATywNh6bZuzm8s1ceuBUnMUAeoAHHw,4,2,0,0,0,0,2,0,4,0.5714285714285714,1,0.0,0,0,0,0,2,0,0,2,0,0,4,0
3208,177913,vMJQI9w07ZiISGIPIFnaaxiyY7O127F5,bWdj2GDclj5ofokWjzoa5jAwMkxCykd6,1,0,0,0,0,0,1,0,1,0.14285714285714285,1,0.0,0,0,0,0,0,0,0,1,0,0,1,1
3209,177917,0Rhh8KlMvGRxFbePsrW63o0GE8JJ4ZBr,A3fsA9Zfv1X2fVEQhTw51lKENdNrEqT3,4,0,0,0,0,0,5,0,5,0.7142857142857143,1,0.0,0,0,0,0,0,0,0,5,0,0,5,1
3210,177935,fCHhd4TOkyXDtd95SIvxpoNr5KiduXIc,bWdj2GDclj5ofokWjzoa5jAwMkxCykd6,7,3,2,0,2,0,2,0,9,1.2857142857142858,1,0.0,0,2,0,2,3,0,0,2,0,4,5,1
3211,177958,kvoUslzLG0mKlFKuSPgqASK2op5HSx76,A3fsA9Zfv1X2fVEQhTw51lKENdNrEqT3,6,5,2,0,1,0,2,0,10,1.4285714285714286,1,0.0,0,2,0,1,5,0,0,2,0,3,7,1
3212,177964,DHUv7XpIZcPp2QYGNmTXjhgg7Zq4BpJ7,bWdj2GDclj5ofokWjzoa5jAwMkxCykd6,1,0,0,0,0,0,1,0,1,0.14285714285714285,1,0.0,0,0,0,0,0,0,0,1,0,0,1,1
3213,177966,IuR34QWilyKtRzmb7qMgvf0gIZLKgowR,SpATywNh6bZuzm8s1ceuBUnMUAeoAHHw,1,0,0,0,0,0,1,0,1,0.14285714285714285,1,0.0,0,0,0,0,0,0,0,1,0,0,1,1
3214,177970,YeBJe2tNupEMDdAag9Wv20aFIU63DOgj,SpATywNh6bZuzm8s1ceuBUnMUAeoAHHw,1,0,0,0,0,0,1,0,1,0.14285714285714285,1,0.0,0,0,0,0,0,0,0,1,0,0,1,1
3215,178000,PhLYSq5B07iE4fjll2EKADOqnDhqPRc7,A3fsA9Zfv1X2fVEQhTw51lKENdNrEqT3,1,0,0,0,0,0,1,0,1,0.14285714285714285,1,0.0,0,0,0,0,0,0,0,1,0,0,1,1
3216,178016,IC7EvxrdI6aK6zztlqGy7t8EMIkvsLWH,SpATywNh6bZuzm8s1ceuBUnMUAeoAHHw,2,2,0,0,0,0,0,0,2,0.2857142857142857,1,0.0,0,0,0,0,2,0,0,0,0,0,2,1
3217,178022,LiD14ALXLddUqpdQnujGFxQiBSoJOZGF,A3fsA9Zfv1X2fVEQhTw51lKENdNrEqT3,3,3,1,0,0,0,1,0,5,0.7142857142857143,1,0.0,0,1,0,0,3,0,0,1,0,1,4,1
3218,178054,HyVNcqbXwwt4x7Lh0NDvZJuGvdEMSlMz,bWdj2GDclj5ofokWjzoa5jAwMkxCykd6,1,0,0,0,0,0,1,0,1,0.14285714285714285,1,0.0,0,0,0,0,0,0,0,1,0,0,1,1
3219,178067,SM0peUZSWYQguXepyPBRDLnLmqFvDaRW,A3fsA9Zfv1X2fVEQhTw51lKENdNrEqT3,16,16,9,0,5,0,5,0,35,5.0,1,0.0,0,9,0,5,16,0,0,5,0,14,21,1
3220,178076,ctPyLd013hzE9dQTFFYRA7Z6fW1VhLt5,SpATywNh6bZuzm8s1ceuBUnMUAeoAHHw,11,14,4,10,2,0,1,0,31,4.428571428571429,1,0.0,9,4,10,2,5,0,0,1,0,25,6,1
3221,178096,YRvoydpc37Vpysmtw8O9rzowfgsZu7lO,bWdj2GDclj5ofokWjzoa5jAwMkxCykd6,3,4,0,0,0,0,1,0,5,0.7142857142857143,1,0.0,1,0,0,0,3,0,0,1,0,1,4,1
3222,178120,yiEYYQaKbyzpwJWElvWXAXdPO93zfPgh,A3fsA9Zfv1X2fVEQhTw51lKENdNrEqT3,1,0,0,0,0,0,1,0,1,0.14285714285714285,1,0.0,0,0,0,0,0,0,0,1,0,0,1,1
3223,178135,7vNqxUIgpaCj3NnoU9xg00b9Tp3tF5Ri,SpATywNh6bZuzm8s1ceuBUnMUAeoAHHw,1,0,0,0,0,0,1,0,1,0.14285714285714285,1,0.0,0,0,0,0,0,0,0,1,0,0,1,1
3224,178152,oRBxd78DtsQ3mEkDyjGaQEGbdrTlmw6j,bWdj2GDclj5ofokWjzoa5jAwMkxCykd6,10,6,2,0,2,0,5,0,15,2.142857142857143,1,0.0,0,2,0,2,6,0,0,5,0,4,11,1
3225,178159,aXJa1zRW8xrdcYprvRlDR2amMkiONMef,SpATywNh6bZuzm8s1ceuBUnMUAeoAHHw,1,0,0,0,0,0,1,0,1,0.14285714285714285,1,0.0,0,0,0,0,0,0,0,1,0,0,1,1
3226,178161,PJ1wLAp2McpPLRMTf6gnqm4Wj7JimEv0,A3fsA9Zfv1X2fVEQhTw51lKENdNrEqT3,5,7,1,0,1,0,1,0,10,1.4285714285714286,1,0.0,0,1,0,1,7,0,0,1,0,2,8,1
3227,178164,dqE1PGrWExsbP4JkEoKdSn4p50FzqbEb,SpATywNh6bZuzm8s1ceuBUnMUAeoAHHw,8,75,41,0,25,7,13,0,161,23.0,1,0.0,6,41,0,25,69,7,0,13,0,72,89,1
3228,178177,bovRkt8OOEauRqwvmsqsFz6hCg8Axl1M,SpATywNh6bZuzm8s1ceuBUnMUAeoAHHw,1,0,0,0,0,0,1,0,1,0.14285714285714285,1,0.0,0,0,0,0,0,0,0,1,0,0,1,1
3229,178204,wMH9y8Ndp4UrZ98WukfHH3BPMXWwQMTj,A3fsA9Zfv1X2fVEQhTw51lKENdNrEqT3,8,6,4,0,1,0,3,0,14,2.0,1,0.0,0,4,0,1,6,0,0,3,0,5,9,1
3230,180085,faKL2n0gPoXoql4sSWDfZo6er3NptGIb,7GRhBDsirIGkRZBtSMEzNTyDr2JQm4xx,2,0,0,0,0,0,2,0,2,0.2857142857142857,1,0.0,0,0,0,0,0,0,0,2,0,0,2,1
3231,180112,tqvV2MwKeLemDHIUsPAVAoV4nZW7CEvr,7GRhBDsirIGkRZBtSMEzNTyDr2JQm4xx,22,18,12,15,10,0,3,0,58,8.285714285714286,1,0.0,4,12,15,10,14,0,0,3,0,41,17,1
3232,180113,gQlwXyK2UfJePDb32xo4quF0aS1cebFG,7GRhBDsirIGkRZBtSMEzNTyDr2JQm4xx,2,0,0,0,0,0,2,0,2,0.2857142857142857,1,0.0,0,0,0,0,0,0,0,2,0,0,2,1
3233,180217,RtFjOHQ78yo3bQ6aRAVmoLevb4Ve3GxB,7GRhBDsirIGkRZBtSMEzNTyDr2JQm4xx,5,2,1,0,0,0,5,0,8,1.1428571428571428,1,0.0,0,1,0,0,2,0,0,5,0,1,7,1
3234,180225,5p1pugPSQA7ekfeoqop7HHA1WjATAX83,7GRhBDsirIGkRZBtSMEzNTyDr2JQm4xx,1,0,0,0,0,0,1,0,1,0.14285714285714285,1,0.0,0,0,0,0,0,0,0,1,0,0,1,1
3235,180244,A6zX6I2GfUhXHkfxx6hY7fkYNihUgWzR,7GRhBDsirIGkRZBtSMEzNTyDr2JQm4xx,1,0,0,0,0,0,1,0,1,0.14285714285714285,1,0.0,0,0,0,0,0,0,0,1,0,0,1,1
3236,180312,hYTVG5ANDBem3sg8QIDjen4BqqV0JGFL,7GRhBDsirIGkRZBtSMEzNTyDr2JQm4xx,1,0,0,0,0,0,1,0,1,0.14285714285714285,1,0.0,0,0,0,0,0,0,0,1,0,0,1,1
3237,182831,ZNcLOAJ2r3H5DqhbGk1CiPtwI7ixaCeK,RXDvfPUBYFlVdlueBFbLW0mhhAyGEqpt,3,2,1,0,0,0,2,0,5,0.7142857142857143,1,0.0,0,1,0,0,2,0,0,2,0,1,4,1
3238,183411,GO3MGrx4XteeFiOXpQf53F1doJGXYUJh,G8EPVSXsOYB5YQWZGiz1aVq5Pgr2GrQu,5,3,2,0,1,0,1,0,7,1.0,1,0.0,0,2,0,1,3,0,0,1,0,3,4,1
3239,183910,52QsTv4Uo7nj5fP154PK0QEBA8xMFRXc,G8EPVSXsOYB5YQWZGiz1aVq5Pgr2GrQu,9,13,0,10,0,0,2,0,25,3.5714285714285716,1,0.0,9,0,7,0,4,0,3,2,0,16,9,1
3240,185973,xpLT6AJby37iITmsTgKzOCviwStat3HT,RXDvfPUBYFlVdlueBFbLW0mhhAyGEqpt,13,11,8,19,4,0,2,0,44,6.285714285714286,1,0.0,1,8,17,4,10,0,2,2,0,30,14,1
3241,186156,ujpnoFj9Sccm69HUxcPfoVG6MkkjyaiE,G8EPVSXsOYB5YQWZGiz1aVq5Pgr2GrQu,6,4,1,0,1,0,2,0,8,1.1428571428571428,1,0.0,0,1,0,1,4,0,0,2,0,2,6,0
3242,186707,mnhLxfC9FQKYouYyd3LS1enEfHJfDKsX,G8EPVSXsOYB5YQWZGiz1aVq5Pgr2GrQu,7,6,1,0,1,0,1,0,9,1.2857142857142858,1,0.0,0,1,0,1,6,0,0,1,0,2,7,0
3243,186852,h8UWLevhpVfEbcVzC3XxVtErwnEzlHV5,RXDvfPUBYFlVdlueBFbLW0mhhAyGEqpt,1,0,0,0,0,0,2,0,2,0.2857142857142857,1,0.0,0,0,0,0,0,0,0,2,0,0,2,0
3244,188096,w8S7oPNGWahl5gDDyBTLSciA1VA7haw4,A3fsA9Zfv1X2fVEQhTw51lKENdNrEqT3,19,17,11,0,8,0,2,0,38,5.428571428571429,1,0.0,3,11,0,8,14,0,0,2,0,22,16,1
3245,188103,O8GYzagsTrclNZXR3HZD1CBdMlg7RUB6,SpATywNh6bZuzm8s1ceuBUnMUAeoAHHw,4,2,0,0,0,0,2,0,4,0.5714285714285714,1,0.0,0,0,0,0,2,0,0,2,0,0,4,1
3246,188113,Q8i7XHeUD92Ae2WeCoNsZYF9vQYf3HPz,SpATywNh6bZuzm8s1ceuBUnMUAeoAHHw,1,0,0,0,0,0,1,0,1,0.14285714285714285,1,0.0,0,0,0,0,0,0,0,1,0,0,1,1
3247,188129,bA4tnPZD0UU4XAL3OkL7nUjtkAzbgj9d,SpATywNh6bZuzm8s1ceuBUnMUAeoAHHw,13,26,11,0,6,0,3,0,46,6.571428571428571,1,0.0,7,11,0,6,19,0,0,3,0,24,22,1
3248,188157,2hMeaUc14fgUG8b3kgXxN1xDYogexPXy,A3fsA9Zfv1X2fVEQhTw51lKENdNrEqT3,8,5,4,0,3,0,1,0,13,1.8571428571428572,1,0.0,0,4,0,3,5,0,0,1,0,7,6,1
3249,188168,Q2xVgvnqNYVNG5kOgvnpJvY9QuBN0RbG,bWdj2GDclj5ofokWjzoa5jAwMkxCykd6,6,3,1,0,1,0,2,0,7,1.0,1,0.0,0,1,0,1,3,0,0,2,0,2,5,1
3250,188176,wwrhZcbbsWF5UNfVZIIcfrs0NelO6L0J,bWdj2GDclj5ofokWjzoa5jAwMkxCykd6,5,2,1,0,1,0,2,0,6,0.8571428571428571,1,0.0,0,1,0,1,2,0,0,2,0,2,4,1
3251,188188,Vhmq36VBivLuLEONnhTEAZGyc0lOW8HG,SpATywNh6bZuzm8s1ceuBUnMUAeoAHHw,1,0,0,0,0,0,1,0,1,0.14285714285714285,1,0.0,0,0,0,0,0,0,0,1,0,0,1,1
3252,188191,K6d2j7PmZmtKVENKrnd412mUvCD6G0Iq,A3fsA9Zfv1X2fVEQhTw51lKENdNrEqT3,36,21,10,52,8,0,9,1,101,14.428571428571429,1,0.0,3,10,47,8,18,0,5,9,1,68,33,1
3253,188218,ycZck16llBAZloBk10bwfMcnaMnaXQWK,RXDvfPUBYFlVdlueBFbLW0mhhAyGEqpt,6,5,0,0,0,0,5,0,10,1.4285714285714286,1,0.0,0,0,0,0,5,0,0,5,0,0,10,1
3254,188241,UQu58ECfm706pzTxKdZuMBkLVofX5BYJ,bWdj2GDclj5ofokWjzoa5jAwMkxCykd6,7,3,2,0,2,0,2,0,9,1.2857142857142858,1,0.0,0,2,0,2,3,0,0,2,0,4,5,1
3255,188249,55wiWWDY37Jvz4XRR5WZBukpONx2E6zf,bWdj2GDclj5ofokWjzoa5jAwMkxCykd6,5,5,3,0,2,0,2,0,12,1.7142857142857142,1,0.0,0,3,0,2,5,0,0,2,0,5,7,1
3256,188256,QycCZ3StVS9Q0gqdzH8YDRcbrA6KQPic,SpATywNh6bZuzm8s1ceuBUnMUAeoAHHw,22,35,11,15,6,0,2,0,69,9.857142857142858,1,0.0,21,11,15,6,14,0,0,2,0,53,16,1
3257,188301,CwrmTUMTRx5M6yQJpPEbrBRyJawjn4Ps,SpATywNh6bZuzm8s1ceuBUnMUAeoAHHw,1,0,0,0,0,0,1,0,1,0.14285714285714285,1,0.0,0,0,0,0,0,0,0,1,0,0,1,1
3258,188323,08FXiN9E2j1PM7CMfj415B4erdhymv4G,SpATywNh6bZuzm8s1ceuBUnMUAeoAHHw,9,2,2,0,2,0,7,1,14,2.0,1,0.0,0,2,0,2,2,0,0,7,1,4,10,1
3259,188332,WxVM9kOqNmenlQy1YKMo3yVYKYKkewCz,bWdj2GDclj5ofokWjzoa5jAwMkxCykd6,1,0,0,0,0,0,1,0,1,0.14285714285714285,1,0.0,0,0,0,0,0,0,0,1,0,0,1,1
3260,188338,7xGbu9oc4JWGY9fgiUO3Qqm473RvS2PB,SpATywNh6bZuzm8s1ceuBUnMUAeoAHHw,7,3,2,0,2,0,2,0,9,1.2857142857142858,1,0.0,0,2,0,2,3,0,0,2,0,4,5,1
3261,188348,4ly9tFjgsKJLiMP1XUHFz2i27nHiXdvU,A3fsA9Zfv1X2fVEQhTw51lKENdNrEqT3,8,3,2,0,0,5,6,1,17,2.4285714285714284,1,0.0,0,2,0,0,3,5,0,6,1,2,15,1
3262,188374,U30BvMtyZpL38NHSSIWCu0FHJgAKw4Fr,A3fsA9Zfv1X2fVEQhTw51lKENdNrEqT3,2,0,0,0,0,0,3,0,3,0.42857142857142855,1,0.0,0,0,0,0,0,0,0,3,0,0,3,0
3263,188386,q3NLZCkaVgPCeFUby9MsDXbo2vYw2wOB,SpATywNh6bZuzm8s1ceuBUnMUAeoAHHw,1,0,0,0,0,0,1,0,1,0.14285714285714285,1,0.0,0,0,0,0,0,0,0,1,0,0,1,1
3264,188415,GAKCidUQ8hdeh0WMwEYlK9cUZXNPRN5R,RXDvfPUBYFlVdlueBFbLW0mhhAyGEqpt,1,0,0,0,0,0,1,0,1,0.14285714285714285,1,0.0,0,0,0,0,0,0,0,1,0,0,1,1
3265,188427,btK3RdfuvWrDzNhOkrOpUgTbQUI2vrLY,SpATywNh6bZuzm8s1ceuBUnMUAeoAHHw,6,7,1,0,1,0,1,0,10,1.4285714285714286,1,0.0,3,1,0,1,4,0,0,1,0,5,5,1
3266,188446,3tkincdjsTSFt3awGPKGfVv9zR1YRwuC,SpATywNh6bZuzm8s1ceuBUnMUAeoAHHw,1,0,0,0,0,0,1,0,1,0.14285714285714285,1,0.0,0,0,0,0,0,0,0,1,0,0,1,1
3267,188447,DUw85TcNpxyZaZKIM1HlHxvgtSm7uwxY,G8EPVSXsOYB5YQWZGiz1aVq5Pgr2GrQu,5,2,1,0,1,0,2,0,6,0.8571428571428571,1,0.0,0,1,0,1,2,0,0,2,0,2,4,0
3268,188458,jFwDcIl1Tm6UHlfb8PtOob6kZkOEjdQr,RXDvfPUBYFlVdlueBFbLW0mhhAyGEqpt,1,0,0,0,0,0,1,0,1,0.14285714285714285,1,0.0,0,0,0,0,0,0,0,1,0,0,1,1
3269,188461,blQKCpClzsxilnQtKRruTVl5WFjEiUZ7,SpATywNh6bZuzm8s1ceuBUnMUAeoAHHw,5,4,3,0,2,0,1,0,10,1.4285714285714286,1,0.0,0,3,0,2,4,0,0,1,0,5,5,1
3270,188475,Onp8u1IlkiXCdEq7Tg9xltw0KEKQAxrs,SpATywNh6bZuzm8s1ceuBUnMUAeoAHHw,6,3,2,0,2,0,1,0,8,1.1428571428571428,1,0.0,0,2,0,2,3,0,0,1,0,4,4,1
3271,188481,gkv9GP4XDvDQ4me5aOnbcgCOOilwq0mr,SpATywNh6bZuzm8s1ceuBUnMUAeoAHHw,1,0,0,0,0,0,1,0,1,0.14285714285714285,1,0.0,0,0,0,0,0,0,0,1,0,0,1,1
3272,188487,yQM2e0pQ43tZ4WbvgNqCdUjXo9r9zUpY,bWdj2GDclj5ofokWjzoa5jAwMkxCykd6,1,0,0,0,0,0,1,0,1,0.14285714285714285,1,0.0,0,0,0,0,0,0,0,1,0,0,1,1
3273,188509,NhmfopX2bIkd9yTnVyho2Qq41VTy8NFx,SpATywNh6bZuzm8s1ceuBUnMUAeoAHHw,6,1,1,0,1,0,3,0,6,0.8571428571428571,1,0.0,0,1,0,1,1,0,0,3,0,2,4,1
3274,188511,g6p03sN0Mi0uDRMoaBI65emUrtGFnpP4,RXDvfPUBYFlVdlueBFbLW0mhhAyGEqpt,20,13,9,14,7,0,7,1,51,7.285714285714286,1,0.0,2,9,14,7,11,0,0,7,1,32,19,1
3275,188522,VZRd1DrilkNeD7Ya8MVZCNtIczH3eEMz,G8EPVSXsOYB5YQWZGiz1aVq5Pgr2GrQu,19,40,23,26,5,0,8,1,103,14.714285714285714,1,0.0,9,23,17,5,31,0,9,8,1,54,49,1
3276,188544,wiVLWKqdbOlotFq1ag8KwC6Hw3JbpdNh,SpATywNh6bZuzm8s1ceuBUnMUAeoAHHw,6,3,1,0,1,0,2,0,7,1.0,1,0.0,0,1,0,1,3,0,0,2,0,2,5,1
3277,188555,uo8XRoO08TmpTH4gap159tNYVx3xop3U,G8EPVSXsOYB5YQWZGiz1aVq5Pgr2GrQu,1,0,0,0,0,0,1,0,1,0.14285714285714285,1,0.0,0,0,0,0,0,0,0,1,0,0,1,1
3278,188558,xqboiFlp42vyY93nDStsbVWBCL5sgIRH,A3fsA9Zfv1X2fVEQhTw51lKENdNrEqT3,24,23,1,16,1,0,7,0,48,6.857142857142857,1,0.0,0,1,13,1,23,0,3,7,0,15,33,1
3279,188561,6mdM8AvYlfditnue2TYJQLFDiBvxSUej,G8EPVSXsOYB5YQWZGiz1aVq5Pgr2GrQu,7,3,0,0,0,0,4,0,7,1.0,1,0.0,0,0,0,0,3,0,0,4,0,0,7,1
3280,188563,SiYxfRymwR9ZXmdv7LpkIYvuHNblUn46,bWdj2GDclj5ofokWjzoa5jAwMkxCykd6,2,0,0,0,0,0,2,0,2,0.2857142857142857,1,0.0,0,0,0,0,0,0,0,2,0,0,2,1
3281,188568,SiYxfRymwR9ZXmdv7LpkIYvuHNblUn46,RXDvfPUBYFlVdlueBFbLW0mhhAyGEqpt,1,0,0,0,0,0,1,0,1,0.14285714285714285,1,0.0,0,0,0,0,0,0,0,1,0,0,1,1
3282,188587,giGUAF5TXBP4oix75tUgV16Pg3alJM4Y,SpATywNh6bZuzm8s1ceuBUnMUAeoAHHw,1,0,0,0,0,0,1,0,1,0.14285714285714285,1,0.0,0,0,0,0,0,0,0,1,0,0,1,1
3283,188602,faupOzOQrYnrhUP3CZcXERH5hL8Q3xd2,bWdj2GDclj5ofokWjzoa5jAwMkxCykd6,1,0,0,0,0,0,1,0,1,0.14285714285714285,1,0.0,0,0,0,0,0,0,0,1,0,0,1,1
3284,188639,sKKYS1ogqmOcjeYfYtZMxdkgoIt3cEVK,SpATywNh6bZuzm8s1ceuBUnMUAeoAHHw,18,15,7,0,7,0,4,0,33,4.714285714285714,1,0.0,0,7,0,7,15,0,0,4,0,14,19,1
3285,194535,fHK2jlK24YNeyNqHHz5jsgZSw0Zz3G3h,G8EPVSXsOYB5YQWZGiz1aVq5Pgr2GrQu,9,6,4,0,2,0,3,0,15,2.142857142857143,1,0.0,0,4,0,2,6,0,0,3,0,6,9,1
3286,194552,VJiHrUKuVkG2Wd7Jui04ER4qa9ZGvV1t,RXDvfPUBYFlVdlueBFbLW0mhhAyGEqpt,1,0,0,0,0,0,1,0,1,0.14285714285714285,1,0.0,0,0,0,0,0,0,0,1,0,0,1,1
3287,194606,fQCBMBoRMdmYhgrCFbeJRBZ7kML0GboZ,RXDvfPUBYFlVdlueBFbLW0mhhAyGEqpt,1,0,0,0,0,0,1,0,1,0.14285714285714285,1,0.0,0,0,0,0,0,0,0,1,0,0,1,1
3288,194770,L7M3Ksh9UBx3xOMl31gqtqz6gfclvqlN,G8EPVSXsOYB5YQWZGiz1aVq5Pgr2GrQu,4,3,1,0,1,0,1,0,6,0.8571428571428571,1,0.0,0,1,0,1,3,0,0,1,0,2,4,1
3289,194797,NFBFv8TG60SG6ScKXY2TuDjWLm29gAEO,G8EPVSXsOYB5YQWZGiz1aVq5Pgr2GrQu,21,19,10,18,4,2,7,1,61,8.714285714285714,1,0.0,5,10,15,4,14,2,3,7,1,34,27,0
3290,194884,hjZ9Xmjh9fy8zpJXBG9oc3s2Pno9M1Qj,G8EPVSXsOYB5YQWZGiz1aVq5Pgr2GrQu,16,14,5,12,5,0,9,1,46,6.571428571428571,1,0.0,8,5,10,5,6,0,2,9,1,28,18,1
3291,194964,i0Fe8GkgETgJLYZf4oG1MMDT0SsDr0Jw,G8EPVSXsOYB5YQWZGiz1aVq5Pgr2GrQu,13,5,4,8,3,0,1,0,21,3.0,1,0.0,0,4,8,3,5,0,0,1,0,15,6,1
3292,194991,ULvgH0dn9cMQ7RqvqnSWbMcAlKJJQ0Fk,RXDvfPUBYFlVdlueBFbLW0mhhAyGEqpt,4,3,1,0,1,0,2,0,7,1.0,1,0.0,0,1,0,1,3,0,0,2,0,2,5,1
3293,195105,L8lHLh6Mth1S7I3sErP5oDZD885a1BOh,RXDvfPUBYFlVdlueBFbLW0mhhAyGEqpt,4,4,3,0,2,0,1,0,10,1.4285714285714286,1,0.0,0,3,0,2,4,0,0,1,0,5,5,1
3294,195134,lIXwq3JER4SWrE0O7y1NzGhial9PDy2H,RXDvfPUBYFlVdlueBFbLW0mhhAyGEqpt,9,4,3,0,3,0,2,0,12,1.7142857142857142,1,0.0,0,3,0,3,4,0,0,2,0,6,6,1
3295,195215,MTAnkeTQnWs9GdHH6O5LRyYCh9iX5uP4,RXDvfPUBYFlVdlueBFbLW0mhhAyGEqpt,1,0,0,0,0,0,2,0,2,0.2857142857142857,1,0.0,0,0,0,0,0,0,0,2,0,0,2,1
3296,195258,JIBg2bFQYc7ncSPQhvBWrAlcobShyiXA,G8EPVSXsOYB5YQWZGiz1aVq5Pgr2GrQu,5,2,0,0,0,0,3,1,6,0.8571428571428571,1,0.0,0,0,0,0,2,0,0,3,1,0,6,1
3297,195274,83JPfkin3GX4GLKqML2uaHSZ5KvsuJhM,G8EPVSXsOYB5YQWZGiz1aVq5Pgr2GrQu,2,0,0,0,0,3,1,0,4,0.5714285714285714,1,0.0,0,0,0,0,0,3,0,1,0,0,4,1
3298,195287,ouhJVRUNWH7xFlD4xC7qUWcBbb5kOVSM,G8EPVSXsOYB5YQWZGiz1aVq5Pgr2GrQu,4,2,0,0,0,1,6,0,9,1.2857142857142858,1,0.0,0,0,0,0,2,1,0,6,0,0,9,1
3299,195383,NXEwBXbU6vvce77sujWgRB6LivhFJvRb,G8EPVSXsOYB5YQWZGiz1aVq5Pgr2GrQu,1,0,0,0,0,0,1,0,1,0.14285714285714285,1,0.0,0,0,0,0,0,0,0,1,0,0,1,1
3300,195392,e5lpY3trke6nXvypvGSIiUjB91TX04sJ,G8EPVSXsOYB5YQWZGiz1aVq5Pgr2GrQu,11,7,4,0,4,0,3,0,18,2.5714285714285716,1,0.0,2,4,0,4,5,0,0,3,0,10,8,1
3301,195420,c8hHWOR1LOb1dNnGiimGKTmT5f2lhdqf,G8EPVSXsOYB5YQWZGiz1aVq5Pgr2GrQu,2,1,0,0,0,0,1,0,2,0.2857142857142857,1,0.0,0,0,0,0,1,0,0,1,0,0,2,1
3302,195455,HIY4CHwa8u7VF0AwJglD4ImtKKzbU3gm,G8EPVSXsOYB5YQWZGiz1aVq5Pgr2GrQu,8,9,0,0,1,13,6,2,31,4.428571428571429,1,0.0,2,0,0,1,7,13,0,6,2,3,28,1
3303,195537,EaFWRMbtKR52j7nbPydGVwuzgPsml9aN,RXDvfPUBYFlVdlueBFbLW0mhhAyGEqpt,1,0,0,0,0,0,1,0,1,0.14285714285714285,1,0.0,0,0,0,0,0,0,0,1,0,0,1,1
