,enrollment_id,username,course_id,no_of_objects4,bno_access4,bno_pageclose4,bno_problem4,bno_video4,bno_discussion4,bno_navigate4,bno_wiki4,bno_total4,bno_avg4,no_of_active_days4,time_consumption4,browser_access4,browser_pageclose4,browser_problem4,browser_video4,server_access4,server_discussion4,server_problem4,server_navigate4,server_wiki4,bno_browser4,bno_server4,label
0,34,OeLBIzS0gNQ56euxy5b66gAZMzQCGE7n,7GRhBDsirIGkRZBtSMEzNTyDr2JQm4xx,29,53,17,10,26,1,4,0,111,15.857142857142858,3,267287.0,28,17,9,26,25,1,1,4,0,80,31,0
1,66,cGrHiRjztN9fSltHujpfWaaWfYWiidiG,7GRhBDsirIGkRZBtSMEzNTyDr2JQm4xx,65,164,41,87,43,41,14,0,390,55.714285714285715,6,0.0,65,41,67,43,99,41,20,14,0,216,174,0
2,89,Po17baTutQqG3KBkMaahpxQ7IpjhFfZa,7GRhBDsirIGkRZBtSMEzNTyDr2JQm4xx,5,4,0,6,0,0,0,0,10,1.4285714285714286,1,0.0,1,0,3,0,3,0,3,0,0,4,6,1
3,108,tIzV4oVJd7GebOZj2uw51WJCx59QGqJ5,5X6FeZozNMgE2VRi3MJYjkkFK8SETtu2,38,58,15,29,27,0,5,0,134,19.142857142857142,8,0.0,36,15,28,27,22,0,1,5,0,106,28,1
4,145,TZOWoG0yzTTzAfx5K054mpl5rZTlZIcZ,7GRhBDsirIGkRZBtSMEzNTyDr2JQm4xx,29,56,22,40,10,24,4,0,156,22.285714285714285,4,0.0,23,22,31,10,33,24,9,4,0,86,70,1
5,312,BCPhbcVTukJPsOtUJJbyOWvpso8GiEV1,7GRhBDsirIGkRZBtSMEzNTyDr2JQm4xx,21,27,9,19,8,15,11,0,89,12.714285714285714,6,0.0,9,9,17,8,18,15,2,11,0,43,46,0
6,348,PUFh3BsQaDVIJMDvwsFTqkrgAzvjO9ME,5X6FeZozNMgE2VRi3MJYjkkFK8SETtu2,6,2,1,0,0,0,12,0,15,2.142857142857143,5,0.0,0,1,0,0,2,0,0,12,0,1,14,0
7,388,wgquDoatKrYebgYKJ0rgOYOEZftOC88l,5X6FeZozNMgE2VRi3MJYjkkFK8SETtu2,1,0,0,0,0,0,1,0,1,0.14285714285714285,1,0.0,0,0,0,0,0,0,0,1,0,0,1,0
8,488,j2rHuSroJ2LNNnea5uXtGt5k8dfNg0dE,7GRhBDsirIGkRZBtSMEzNTyDr2JQm4xx,28,26,10,18,9,0,2,0,65,9.285714285714286,1,0.0,10,10,9,9,16,0,9,2,0,38,27,1
9,537,v3GklML26dWmsHrBRgfyBOOufNAhOXE8,5X6FeZozNMgE2VRi3MJYjkkFK8SETtu2,27,49,4,22,6,0,15,0,96,13.714285714285714,5,0.0,16,4,18,6,33,0,4,15,0,44,52,1
10,571,cuuYGTWWAmhidQoRHdGzANriCatcPrlK,7GRhBDsirIGkRZBtSMEzNTyDr2JQm4xx,41,61,29,48,28,2,2,0,170,24.285714285714285,4,0.0,28,29,39,28,33,2,9,2,0,124,46,0
11,578,eER8RoiVQhlBLlO4WV7kKfWOx4XE0E9c,7GRhBDsirIGkRZBtSMEzNTyDr2JQm4xx,3,2,1,0,0,0,1,0,4,0.5714285714285714,1,0.0,0,1,0,0,2,0,0,1,0,1,3,1
12,618,M5ID2aNMWGm5ShsGkFPYgTgN2UReXK8g,7GRhBDsirIGkRZBtSMEzNTyDr2JQm4xx,25,28,14,30,10,3,4,0,89,12.714285714285714,1,0.0,10,14,24,10,18,3,6,4,0,58,31,1
13,665,SEjaVSZpDJnFuz955p2IN1SjKQ5n5iQT,5X6FeZozNMgE2VRi3MJYjkkFK8SETtu2,32,64,1,32,14,0,13,0,124,17.714285714285715,9,0.0,32,1,30,14,32,0,2,13,0,77,47,1
14,694,DVxZxPUgYsodJVtjUg4HG3ZucfJoWgwo,7GRhBDsirIGkRZBtSMEzNTyDr2JQm4xx,4,4,1,0,0,4,2,0,11,1.5714285714285714,1,0.0,3,1,0,0,1,4,0,2,0,4,7,1
15,696,0PrF4PViZdaRQhbt6FYXwLbcetJ8RnwC,5X6FeZozNMgE2VRi3MJYjkkFK8SETtu2,130,151,2,273,12,0,12,0,450,64.28571428571429,8,0.0,91,2,247,12,60,0,26,12,0,352,98,0
16,698,vbTgITzq6jZRj0oUV5gFotgOlwSXnjML,5X6FeZozNMgE2VRi3MJYjkkFK8SETtu2,127,214,12,303,20,17,42,0,608,86.85714285714286,13,0.0,127,12,269,20,87,17,34,42,0,428,180,0
17,706,gaQ5NcChRgJEDIbUzrzkc0uxMk5PhjhH,5X6FeZozNMgE2VRi3MJYjkkFK8SETtu2,25,75,40,4,16,140,17,0,292,41.714285714285715,13,0.0,20,40,3,16,55,140,1,17,0,79,213,0
18,794,1dxQmK9WwlHWuIG7ZTn4PsJ2vflQBDH3,5X6FeZozNMgE2VRi3MJYjkkFK8SETtu2,8,19,5,2,3,0,9,0,38,5.428571428571429,6,0.0,2,5,2,3,17,0,0,9,0,12,26,1
19,836,jWgeQ7calOYQcs5lv7T9mWy3KUSp4lwk,5X6FeZozNMgE2VRi3MJYjkkFK8SETtu2,5,2,1,0,1,0,2,0,6,0.8571428571428571,1,0.0,0,1,0,1,2,0,0,2,0,2,4,1
20,948,iYWLR7w0j5yEEe1bCu5IYYyXjnXbv448,7GRhBDsirIGkRZBtSMEzNTyDr2JQm4xx,60,124,40,56,28,40,14,0,302,43.142857142857146,6,0.0,70,40,42,28,54,40,14,14,0,180,122,0
21,959,SIuVkNKTY2J1cPfs6wUSNXAjh8XyxgwI,5X6FeZozNMgE2VRi3MJYjkkFK8SETtu2,1,0,0,0,0,0,1,0,1,0.14285714285714285,1,0.0,0,0,0,0,0,0,0,1,0,0,1,1
22,1165,ONITjjzK5mBJXCjV8dV3cxn5gSx54mVg,5X6FeZozNMgE2VRi3MJYjkkFK8SETtu2,8,5,1,8,0,0,3,0,17,2.4285714285714284,2,0.0,0,1,7,0,5,0,1,3,0,8,9,1
23,1194,WFh9KL1sDhp4NpPSjJuGtUwdjU2As3jU,7GRhBDsirIGkRZBtSMEzNTyDr2JQm4xx,46,83,13,67,33,2,13,0,211,30.142857142857142,5,0.0,38,13,53,33,45,2,14,13,0,137,74,1
24,1237,UFv1bKZxvNXWxAHJe8kps3jRxbYwJ8co,5X6FeZozNMgE2VRi3MJYjkkFK8SETtu2,6,9,7,0,4,0,2,0,22,3.142857142857143,1,0.0,0,7,0,4,9,0,0,2,0,11,11,1
25,1261,YxEAEqB4R6GTRBWDvga1GWE0URAxGc6U,5X6FeZozNMgE2VRi3MJYjkkFK8SETtu2,14,38,14,6,1,7,11,0,77,11.0,8,0.0,7,14,5,1,31,7,1,11,0,27,50,0
26,1293,2CIqPxwfpdleLKAwuxTPlDujU1ToKMCe,7GRhBDsirIGkRZBtSMEzNTyDr2JQm4xx,36,42,16,40,17,6,8,0,129,18.428571428571427,3,0.0,19,16,35,17,23,6,5,8,0,87,42,0
27,1298,xdVF44pcmC57LxybIN6S03WC3lkijhye,7GRhBDsirIGkRZBtSMEzNTyDr2JQm4xx,6,4,3,0,2,0,2,0,11,1.5714285714285714,1,0.0,0,3,0,2,4,0,0,2,0,5,6,0
28,1334,BdwcZr5MO8X0sPJO0Tqucc1g1g6IA4vq,7GRhBDsirIGkRZBtSMEzNTyDr2JQm4xx,32,93,34,44,2,16,8,0,197,28.142857142857142,8,0.0,38,34,42,2,55,16,2,8,0,116,81,0
29,1382,JvCKYcuVOlSTBNmxLAtFrakOFOWMnICM,5X6FeZozNMgE2VRi3MJYjkkFK8SETtu2,6,3,1,0,2,0,2,0,8,1.1428571428571428,1,0.0,1,1,0,2,2,0,0,2,0,4,4,1
30,1384,UUY3BPLR7A3Xa6FGsztMCn6xCbxtdCYu,5X6FeZozNMgE2VRi3MJYjkkFK8SETtu2,27,44,7,30,25,0,3,0,109,15.571428571428571,6,0.0,35,7,26,25,9,0,4,3,0,93,16,1
31,1388,8W0dKFntzVy5gs8nAvO6lyUGOY4SLHwO,5X6FeZozNMgE2VRi3MJYjkkFK8SETtu2,2,0,0,0,0,0,2,0,2,0.2857142857142857,1,0.0,0,0,0,0,0,0,0,2,0,0,2,1
32,1396,4pgEahxP0BMucPOaES4iKt1glSEl2goc,7GRhBDsirIGkRZBtSMEzNTyDr2JQm4xx,56,151,44,46,33,0,21,0,295,42.142857142857146,6,0.0,52,44,37,33,99,0,9,21,0,166,129,0
33,1739,MSwjf2I17FAgMFqknSNlHHVpwcQKsxyQ,7GRhBDsirIGkRZBtSMEzNTyDr2JQm4xx,9,7,5,16,0,0,2,0,30,4.285714285714286,1,0.0,1,5,13,0,6,0,3,2,0,19,11,1
34,1765,8nlNDsWSaxHCvsMKtqhBs81sknEiTCeb,7GRhBDsirIGkRZBtSMEzNTyDr2JQm4xx,63,52,24,40,34,0,5,0,155,22.142857142857142,3,0.0,25,24,33,34,27,0,7,5,0,116,39,0
35,1771,jImHfNEIObE674KdIbKVj7cCJ4ufqzHJ,7GRhBDsirIGkRZBtSMEzNTyDr2JQm4xx,27,37,18,39,1,102,15,0,212,30.285714285714285,9,0.0,15,18,34,1,22,102,5,15,0,68,144,0
36,1775,mIe8dQN3qDFpsTsivIoOXC4yOCPP2RyG,7GRhBDsirIGkRZBtSMEzNTyDr2JQm4xx,67,183,9,65,22,5,14,1,299,42.714285714285715,5,0.0,84,9,53,22,99,5,12,14,1,168,131,0
37,1784,UfAib2ALXY0xvrv3U33IqXbLFQct6ZlR,5X6FeZozNMgE2VRi3MJYjkkFK8SETtu2,106,157,63,203,61,0,22,0,506,72.28571428571429,15,0.0,71,63,168,61,86,0,35,22,0,363,143,1
38,1802,STdhsQG5tLZHsan5xGUL8YXDFoc6MDRe,fbPkOYLVPtPgIt0MxizjfFJov3JbHyAi,49,148,2,89,18,103,21,0,381,54.42857142857143,8,0.0,66,2,88,18,82,103,1,21,0,174,207,0
39,1808,Slk5JcZSYHmDLQZXaNVmcMDmjJ16kBhI,fbPkOYLVPtPgIt0MxizjfFJov3JbHyAi,9,22,0,6,0,0,1,0,29,4.142857142857143,1,0.0,11,0,5,0,11,0,1,1,0,16,13,1
40,1809,oo6yDppb7lwtVg5iRhFytpMjmAuhJrAW,fbPkOYLVPtPgIt0MxizjfFJov3JbHyAi,36,125,46,35,11,44,16,2,279,39.857142857142854,3,0.0,18,46,31,11,107,44,4,16,2,106,173,0
41,1810,EaMlaC9qHLvL6wupBNJ0TiXUKnGXhVo4,fbPkOYLVPtPgIt0MxizjfFJov3JbHyAi,27,53,1,0,0,0,1,0,55,7.857142857142857,1,0.0,0,1,0,0,53,0,0,1,0,1,54,1
42,1814,KVMcZ0CphnUUs4jbRYRdgMvMogJko09j,fbPkOYLVPtPgIt0MxizjfFJov3JbHyAi,21,43,28,9,11,0,7,0,98,14.0,5,0.0,5,28,6,11,38,0,3,7,0,50,48,0
43,1820,wcY3GU6p1SvabYZJ4EXjB1vjnfCfIW4s,fbPkOYLVPtPgIt0MxizjfFJov3JbHyAi,1,0,0,0,0,0,1,0,1,0.14285714285714285,1,0.0,0,0,0,0,0,0,0,1,0,0,1,1
44,1824,iQpP0qT2CHD9i5LDED8ej6YadyfX6mXh,fbPkOYLVPtPgIt0MxizjfFJov3JbHyAi,24,77,29,42,17,6,10,0,181,25.857142857142858,3,0.0,15,29,35,17,62,6,7,10,0,96,85,1
45,1825,XE68NKSR0NgsUmxAP8OC135kqBLzzb9D,fbPkOYLVPtPgIt0MxizjfFJov3JbHyAi,4,2,1,0,1,0,2,0,6,0.8571428571428571,1,0.0,0,1,0,1,2,0,0,2,0,2,4,1
46,1834,XuNt1i5t4SR1AjDP4UHvsoux0R9qVf5C,fbPkOYLVPtPgIt0MxizjfFJov3JbHyAi,62,108,57,80,33,65,17,2,362,51.714285714285715,5,0.0,31,57,73,33,77,65,7,17,2,194,168,0
47,1836,XlDfnhryafmarvecZhKZMWL7AupGjwi4,fbPkOYLVPtPgIt0MxizjfFJov3JbHyAi,1,1,0,0,0,0,0,0,1,0.14285714285714285,1,0.0,0,0,0,0,1,0,0,0,0,0,1,1
48,1837,QvqMF8oqvOJDLWUvXbTcLl7n0z5cypNQ,fbPkOYLVPtPgIt0MxizjfFJov3JbHyAi,12,15,10,0,7,0,5,0,37,5.285714285714286,3,0.0,0,10,0,7,15,0,0,5,0,17,20,1
49,1839,qXcFDYoJ2Tmvn4GnsFiSYxCLULI6cc20,fbPkOYLVPtPgIt0MxizjfFJov3JbHyAi,1,0,0,0,0,0,1,0,1,0.14285714285714285,1,0.0,0,0,0,0,0,0,0,1,0,0,1,1
50,1840,Iu7ZFqvdIqcN7J7qsVmoWhike7u8btfF,fbPkOYLVPtPgIt0MxizjfFJov3JbHyAi,6,6,3,0,3,0,1,0,13,1.8571428571428572,1,0.0,0,3,0,3,6,0,0,1,0,6,7,1
51,1841,gTq3Jt1elji3HMm3G6xjBSvg23Zfv1Lq,fbPkOYLVPtPgIt0MxizjfFJov3JbHyAi,4,0,0,0,0,0,3,1,4,0.5714285714285714,1,0.0,0,0,0,0,0,0,0,3,1,0,4,1
52,1843,oijvB3j3cAyuH8Lq33rEfjJgjg2BSCaL,fbPkOYLVPtPgIt0MxizjfFJov3JbHyAi,1,0,0,0,0,0,3,0,3,0.42857142857142855,1,0.0,0,0,0,0,0,0,0,3,0,0,3,0
53,1846,82UlWF6Fm1gkNum7nNbVw0yOV1BUdNoS,fbPkOYLVPtPgIt0MxizjfFJov3JbHyAi,7,9,5,0,2,0,2,0,18,2.5714285714285716,2,0.0,2,5,0,2,7,0,0,2,0,9,9,1
54,1847,MFSnnewEgqB5QLFN17tBwn3frVrP2njr,fbPkOYLVPtPgIt0MxizjfFJov3JbHyAi,6,1,1,0,1,0,3,0,6,0.8571428571428571,1,0.0,0,1,0,1,1,0,0,3,0,2,4,1
55,1848,JfQVgXDVu1NGs9lcRBOD4w6V7BSaZCc2,fbPkOYLVPtPgIt0MxizjfFJov3JbHyAi,30,46,30,12,18,7,15,0,128,18.285714285714285,7,0.0,10,30,12,18,36,7,0,15,0,70,58,0
56,1850,62aEkx5hiqjq7miMyrFwVbP7Jkesq4eo,fbPkOYLVPtPgIt0MxizjfFJov3JbHyAi,45,56,29,32,16,1,14,1,149,21.285714285714285,3,0.0,20,29,29,16,36,1,3,14,1,94,55,0
57,1851,cAUuHXvOoCXwQjZWWRqNDA8udivSTUZW,fbPkOYLVPtPgIt0MxizjfFJov3JbHyAi,20,33,4,0,3,0,6,0,46,6.571428571428571,5,0.0,2,4,0,3,31,0,0,6,0,9,37,0
58,1853,fefutpRiLgvjmF5iytA8L23Z41dS6GAe,fbPkOYLVPtPgIt0MxizjfFJov3JbHyAi,9,4,2,0,2,0,7,0,15,2.142857142857143,1,0.0,1,2,0,2,3,0,0,7,0,5,10,1
59,1854,sjBn8oayOINN3T3JZLXHY4beCfaHLSkq,fbPkOYLVPtPgIt0MxizjfFJov3JbHyAi,26,53,20,17,11,0,6,0,107,15.285714285714286,5,0.0,10,20,17,11,43,0,0,6,0,58,49,0
60,1855,cy2CnLMLxJkryBCEHSwR3ZMTpAjnoO1C,fbPkOYLVPtPgIt0MxizjfFJov3JbHyAi,11,16,0,10,0,65,6,0,97,13.857142857142858,4,0.0,2,0,7,0,14,65,3,6,0,9,88,0
61,1857,3LBSAbcxxmlIGNLvUbxOBHP17eWw2EWo,fbPkOYLVPtPgIt0MxizjfFJov3JbHyAi,22,28,17,8,10,0,6,0,69,9.857142857142858,2,0.0,4,17,8,10,24,0,0,6,0,39,30,0
62,1858,K0OSl2yDmHYQ9TtZdxy9shErNwx3ga0n,fbPkOYLVPtPgIt0MxizjfFJov3JbHyAi,64,78,17,38,16,30,12,0,191,27.285714285714285,3,0.0,38,17,35,16,40,30,3,12,0,106,85,0
63,1860,FGqqsUrb3kPcKGZsrZzktReZzGvahk6x,fbPkOYLVPtPgIt0MxizjfFJov3JbHyAi,1,0,0,0,0,0,1,0,1,0.14285714285714285,1,0.0,0,0,0,0,0,0,0,1,0,0,1,1
64,1866,mrzCfkgyM6KyC9H5Ok54xCLYWyp2COiw,fbPkOYLVPtPgIt0MxizjfFJov3JbHyAi,3,3,1,0,0,0,1,0,5,0.7142857142857143,1,0.0,0,1,0,0,3,0,0,1,0,1,4,1
65,1868,euJ8gpxfARpnWjt9X8Fyxm47A6A32cKl,fbPkOYLVPtPgIt0MxizjfFJov3JbHyAi,10,19,7,4,5,7,7,0,49,7.0,4,0.0,7,7,3,5,12,7,1,7,0,22,27,0
66,1877,BPWa0SjleiqllaywZCKubwGSdtmQ6n1j,fbPkOYLVPtPgIt0MxizjfFJov3JbHyAi,7,5,4,0,3,0,1,0,13,1.8571428571428572,1,0.0,0,4,0,3,5,0,0,1,0,7,6,1
67,1881,02osjR1oAEAT2tx2XAaqACclHtsIr8rE,fbPkOYLVPtPgIt0MxizjfFJov3JbHyAi,8,3,2,0,1,0,6,1,13,1.8571428571428572,1,0.0,0,2,0,1,3,0,0,6,1,3,10,1
68,1884,Lw3OTYhUx7axX1lA5vXOpSGbloCwnp86,fbPkOYLVPtPgIt0MxizjfFJov3JbHyAi,1,0,0,0,0,0,1,0,1,0.14285714285714285,1,0.0,0,0,0,0,0,0,0,1,0,0,1,1
69,1885,9sckfYHCSe28pCKnT8xoBCq2thEZcsel,fbPkOYLVPtPgIt0MxizjfFJov3JbHyAi,7,6,4,0,1,0,1,0,12,1.7142857142857142,1,0.0,0,4,0,1,6,0,0,1,0,5,7,1
70,1887,K4MChPhhtYZYK5nsYtiS9NQwcF94wGaC,fbPkOYLVPtPgIt0MxizjfFJov3JbHyAi,4,2,1,0,0,0,2,0,5,0.7142857142857143,1,0.0,0,1,0,0,2,0,0,2,0,1,4,1
71,1889,9lZ5nNFJAuEwr4dRJLRoTk52o5oWJaUg,fbPkOYLVPtPgIt0MxizjfFJov3JbHyAi,20,39,23,14,11,2,2,0,91,13.0,4,0.0,10,23,13,11,29,2,1,2,0,57,34,0
72,1890,5Je2VLAwuZruzgC8VlqQVm8FviqbC6xZ,fbPkOYLVPtPgIt0MxizjfFJov3JbHyAi,1,0,0,0,0,0,1,0,1,0.14285714285714285,1,0.0,0,0,0,0,0,0,0,1,0,0,1,1
73,1892,h8BwrBZ61dHhi5fhxZzTUeeYh9J3sER4,fbPkOYLVPtPgIt0MxizjfFJov3JbHyAi,15,9,8,0,6,0,1,0,24,3.4285714285714284,1,0.0,0,8,0,6,9,0,0,1,0,14,10,0
74,1896,jUl2kLMoCTUN58qgYEYf5N92MAr4mMfa,fbPkOYLVPtPgIt0MxizjfFJov3JbHyAi,1,0,0,0,0,0,1,0,1,0.14285714285714285,1,0.0,0,0,0,0,0,0,0,1,0,0,1,1
75,1897,hcKYo6bLhlANvHE0FxLuR4YY8jocfBwJ,fbPkOYLVPtPgIt0MxizjfFJov3JbHyAi,1,0,0,0,0,0,1,0,1,0.14285714285714285,1,0.0,0,0,0,0,0,0,0,1,0,0,1,1
76,1898,ZMrMY3HH6RynOCICdOELEimn3CmP7dy3,fbPkOYLVPtPgIt0MxizjfFJov3JbHyAi,21,16,11,0,7,5,12,1,52,7.428571428571429,1,0.0,0,11,0,7,16,5,0,12,1,18,34,1
77,1900,FELnhQR0c7GZZX82ioYJEZsqujOrfyf7,fbPkOYLVPtPgIt0MxizjfFJov3JbHyAi,1,0,0,0,0,0,1,0,1,0.14285714285714285,1,0.0,0,0,0,0,0,0,0,1,0,0,1,1
78,1904,BPDBF5tyty2uKhrkjUyl8tBSIG5JMhpy,fbPkOYLVPtPgIt0MxizjfFJov3JbHyAi,1,0,0,0,0,0,1,0,1,0.14285714285714285,1,0.0,0,0,0,0,0,0,0,1,0,0,1,1
79,1905,rH9yibot6cCOaAZphZeWIT7V2pydvksO,fbPkOYLVPtPgIt0MxizjfFJov3JbHyAi,5,3,2,0,1,0,1,0,7,1.0,1,0.0,0,2,0,1,3,0,0,1,0,3,4,1
80,1907,O4E7as3W8jLvygS4k9RX6VKdAkX7GkpR,fbPkOYLVPtPgIt0MxizjfFJov3JbHyAi,29,38,20,16,12,0,5,0,91,13.0,3,0.0,11,20,12,12,27,0,4,5,0,55,36,0
81,1908,uJfbc9I7P24gwBxCb4NuFSYLPcQJXbJC,fbPkOYLVPtPgIt0MxizjfFJov3JbHyAi,14,28,18,8,7,18,3,0,82,11.714285714285714,2,0.0,4,18,6,7,24,18,2,3,0,35,47,0
82,1912,MdxqKOIqCszdaKiwqbC4Jnh5EK0S8h9R,fbPkOYLVPtPgIt0MxizjfFJov3JbHyAi,9,13,8,0,0,0,11,1,33,4.714285714285714,1,0.0,3,8,0,0,10,0,0,11,1,11,22,1
83,1914,Ms0MC4W5moiGJLWP7iE3FImeH9CHN4KT,fbPkOYLVPtPgIt0MxizjfFJov3JbHyAi,7,7,4,0,2,0,3,0,16,2.2857142857142856,2,0.0,2,4,0,2,5,0,0,3,0,8,8,0
84,1916,tVqAcFuT9hhnm1hCghUIPQ6yusJDuuSu,fbPkOYLVPtPgIt0MxizjfFJov3JbHyAi,5,2,1,0,1,0,3,0,7,1.0,1,0.0,0,1,0,1,2,0,0,3,0,2,5,1
85,1919,ZVE1PX7xOz79BV4QTr7JFzHx09U83o43,fbPkOYLVPtPgIt0MxizjfFJov3JbHyAi,17,15,10,6,4,0,1,0,36,5.142857142857143,2,0.0,4,10,6,4,11,0,0,1,0,24,12,0
86,1920,3Nb5o5OohsDNIgLceYbTurAWBMiIQRDh,fbPkOYLVPtPgIt0MxizjfFJov3JbHyAi,12,13,7,5,2,5,4,0,36,5.142857142857143,3,0.0,2,7,4,2,11,5,1,4,0,15,21,0
87,1921,m5pwX7LcxwodHsYRsjS4kbbCcfNVrJK0,fbPkOYLVPtPgIt0MxizjfFJov3JbHyAi,1,0,0,0,0,0,1,0,1,0.14285714285714285,1,0.0,0,0,0,0,0,0,0,1,0,0,1,1
88,1924,bRmU4ghbgx16XrcSMiRmwAVngSF9Tm10,fbPkOYLVPtPgIt0MxizjfFJov3JbHyAi,7,5,2,0,0,12,8,0,27,3.857142857142857,1,0.0,0,2,0,0,5,12,0,8,0,2,25,0
89,1925,UHEdqIfQMlcBmdDDlAACqjd4uHB22PZR,fbPkOYLVPtPgIt0MxizjfFJov3JbHyAi,10,11,5,0,4,0,3,0,23,3.2857142857142856,2,0.0,0,5,0,4,11,0,0,3,0,9,14,0
90,1927,KGKXtIu1hkHju7SCZs8gtmA9OwHIqK9w,fbPkOYLVPtPgIt0MxizjfFJov3JbHyAi,39,61,43,13,28,65,14,0,224,32.0,6,0.0,9,43,13,28,52,65,0,14,0,93,131,0
91,1930,7Qi8MZVdpAWF6Jx24ApQvOp3KudDuUEC,fbPkOYLVPtPgIt0MxizjfFJov3JbHyAi,3,2,1,0,0,0,1,0,4,0.5714285714285714,1,0.0,0,1,0,0,2,0,0,1,0,1,3,1
92,1935,IYkDwN1NqESg9tIIKef8uQFcXBsQSE34,fbPkOYLVPtPgIt0MxizjfFJov3JbHyAi,1,0,0,0,0,0,2,0,2,0.2857142857142857,1,0.0,0,0,0,0,0,0,0,2,0,0,2,0
93,1937,vtrHNbtnxRGyZem1sSOdKIp109fZtSKY,fbPkOYLVPtPgIt0MxizjfFJov3JbHyAi,4,2,1,0,0,0,2,0,5,0.7142857142857143,1,0.0,0,1,0,0,2,0,0,2,0,1,4,0
94,1942,NRZZegI67zDF052JVDnfYLHjHIY2inab,fbPkOYLVPtPgIt0MxizjfFJov3JbHyAi,1,0,0,0,0,0,1,0,1,0.14285714285714285,1,0.0,0,0,0,0,0,0,0,1,0,0,1,1
95,1944,FPtAc2MhfpwZkpPIx5xZqPDLAMDq2xlZ,fbPkOYLVPtPgIt0MxizjfFJov3JbHyAi,27,59,12,12,8,0,7,0,98,14.0,4,0.0,9,12,11,8,50,0,1,7,0,40,58,0
96,1946,oNX40hvUpCseO8BHKhGJvG2jyQpYKQyk,fbPkOYLVPtPgIt0MxizjfFJov3JbHyAi,8,9,4,0,1,1,2,0,17,2.4285714285714284,2,0.0,0,4,0,1,9,1,0,2,0,5,12,0
97,1958,Kw83ufYGIFIihz0PdiaJro4hz0pKGozQ,5Gyp41oLVo7Gg7vF4vpmggWP5MU70QO6,44,94,42,28,33,26,18,0,241,34.42857142857143,18,0.0,23,42,22,33,71,26,6,18,0,120,121,0
98,1994,47LBAXNnKzRCqKWIovDbM0zFAyPUjM88,5Gyp41oLVo7Gg7vF4vpmggWP5MU70QO6,32,100,45,29,7,15,32,2,230,32.857142857142854,12,0.0,14,45,25,7,86,15,4,32,2,91,139,0
99,2014,ek66b6nmpAPcdgKkBr30KolosV8yrA1B,5Gyp41oLVo7Gg7vF4vpmggWP5MU70QO6,10,17,8,0,5,0,6,0,36,5.142857142857143,2,0.0,0,8,0,5,17,0,0,6,0,13,23,1
100,2053,1pusTPLSLF5m0UuZqZkNpGlAq8VrQ1KA,5Gyp41oLVo7Gg7vF4vpmggWP5MU70QO6,10,8,6,0,3,11,8,0,36,5.142857142857143,2,0.0,0,6,0,3,8,11,0,8,0,9,27,0
101,2106,ykaUPJW4Nc9r2mv4b25QxgdHgIcQ63RQ,5Gyp41oLVo7Gg7vF4vpmggWP5MU70QO6,13,18,9,0,7,0,6,0,40,5.714285714285714,6,0.0,4,9,0,7,14,0,0,6,0,20,20,0
102,2111,0PrF4PViZdaRQhbt6FYXwLbcetJ8RnwC,5Gyp41oLVo7Gg7vF4vpmggWP5MU70QO6,37,73,43,51,13,16,18,1,215,30.714285714285715,6,0.0,17,43,36,13,56,16,15,18,1,109,106,0
103,2119,cs5iJZEgrhw6pymo9S5BmSlmIVmjOxuC,5Gyp41oLVo7Gg7vF4vpmggWP5MU70QO6,5,2,1,0,1,0,2,0,6,0.8571428571428571,1,0.0,0,1,0,1,2,0,0,2,0,2,4,1
104,2136,4BCWVZMgSyk2ZEk4MHhm6b7lpgXWTd1k,5Gyp41oLVo7Gg7vF4vpmggWP5MU70QO6,9,8,5,0,2,0,13,0,28,4.0,4,0.0,0,5,0,2,8,0,0,13,0,7,21,1
105,2151,iukICc3JPXkGjh0WhluWsphhopQF3KWw,5Gyp41oLVo7Gg7vF4vpmggWP5MU70QO6,16,25,8,4,8,46,5,0,96,13.714285714285714,1,0.0,6,8,2,8,19,46,2,5,0,24,72,1
106,2175,H2CmpQwC8u6bUYrLfEioNF80NHwY8Kda,5Gyp41oLVo7Gg7vF4vpmggWP5MU70QO6,8,12,5,0,2,0,3,0,22,3.142857142857143,3,0.0,1,5,0,2,11,0,0,3,0,8,14,1
107,2200,7fC3V6ivG07wUIMOmiYFzSlyjWvbYnYf,5Gyp41oLVo7Gg7vF4vpmggWP5MU70QO6,66,295,141,55,134,34,48,1,708,101.14285714285714,23,0.0,112,141,45,134,183,34,10,48,1,432,276,0
108,2305,TYu8VgV6TkJO1pWVABdfXnpa6VWQUK0O,5Gyp41oLVo7Gg7vF4vpmggWP5MU70QO6,10,9,5,4,3,0,4,0,25,3.5714285714285716,2,0.0,1,5,2,3,8,0,2,4,0,11,14,1
109,2325,7xNBrJLcG8Tw9PPj6SmLjDEzgSVEhwan,5Gyp41oLVo7Gg7vF4vpmggWP5MU70QO6,6,3,2,0,2,0,1,0,8,1.1428571428571428,1,0.0,0,2,0,2,3,0,0,1,0,4,4,1
110,2329,B53rQjZV2s1qM1mdslF7H0dhr2CQ3LuA,5Gyp41oLVo7Gg7vF4vpmggWP5MU70QO6,71,217,110,43,51,30,73,1,525,75.0,14,0.0,63,110,35,51,154,30,8,73,1,259,266,0
111,2357,KVKSKijrm1pqyHhwQWfTwA4kKVI4llyg,5Gyp41oLVo7Gg7vF4vpmggWP5MU70QO6,36,116,64,28,19,41,26,6,300,42.857142857142854,10,0.0,21,64,23,19,95,41,5,26,6,127,173,1
112,2378,jagu0OJDhWTGFhfCMk0ghqluLpW3kzdC,5Gyp41oLVo7Gg7vF4vpmggWP5MU70QO6,55,129,68,50,49,32,69,1,398,56.857142857142854,12,0.0,45,68,37,49,84,32,13,69,1,199,199,0
113,2414,4XD1OCm9J6eGrgnmkV8L1dJofrPXRP8h,5Gyp41oLVo7Gg7vF4vpmggWP5MU70QO6,1,0,0,0,0,0,1,0,1,0.14285714285714285,1,0.0,0,0,0,0,0,0,0,1,0,0,1,1
114,2423,VBP5PzVQEKJYFH0y5ffEek5WfP9EW7uc,5Gyp41oLVo7Gg7vF4vpmggWP5MU70QO6,9,31,17,0,6,0,14,0,68,9.714285714285714,10,0.0,0,17,0,6,31,0,0,14,0,23,45,1
115,2431,aLBCLovWtsTVGrFSP6GDPJFus2iLCsBA,5Gyp41oLVo7Gg7vF4vpmggWP5MU70QO6,39,80,55,34,27,117,63,4,380,54.285714285714285,11,0.0,21,55,28,27,59,117,6,63,4,131,249,0
116,2478,sEaRV4bDDMQNCEEDgfeSBwdLrHLpijC1,5Gyp41oLVo7Gg7vF4vpmggWP5MU70QO6,5,2,1,0,1,0,2,0,6,0.8571428571428571,1,0.0,0,1,0,1,2,0,0,2,0,2,4,1
117,2510,cxmD5n6LDACjvuY8YvfXaGJ22S8l6lkc,5Gyp41oLVo7Gg7vF4vpmggWP5MU70QO6,41,137,79,20,15,11,28,0,290,41.42857142857143,16,0.0,12,79,16,15,125,11,4,28,0,122,168,0
118,2512,whspXo2pdzqGQ7uUMsLjiaHYpjkc35JW,5Gyp41oLVo7Gg7vF4vpmggWP5MU70QO6,49,136,67,20,47,25,21,1,317,45.285714285714285,10,0.0,49,67,11,47,87,25,9,21,1,174,143,0
119,2526,kMNlJ3SUrfspLoccJm7i7Ga1vRDYYkHR,5Gyp41oLVo7Gg7vF4vpmggWP5MU70QO6,9,5,3,0,2,5,6,1,22,3.142857142857143,1,0.0,0,3,0,2,5,5,0,6,1,5,17,0
120,2532,zoIiQhCrqESOgOihvqLK9jmbvYsDyFyX,5Gyp41oLVo7Gg7vF4vpmggWP5MU70QO6,43,138,60,21,12,1,17,0,249,35.57142857142857,4,0.0,57,60,15,12,81,1,6,17,0,144,105,0
121,2543,pE8tdmsTrjN5HHRRTaQLdkGJCKxiu9pi,5Gyp41oLVo7Gg7vF4vpmggWP5MU70QO6,32,44,22,15,13,1,3,0,98,14.0,4,0.0,13,22,9,13,31,1,6,3,0,57,41,1
122,2550,NEe55fIMKdRKAmR8PwThpLdcLgrL5XJ1,5Gyp41oLVo7Gg7vF4vpmggWP5MU70QO6,2,0,0,0,0,0,2,0,2,0.2857142857142857,1,0.0,0,0,0,0,0,0,0,2,0,0,2,1
123,2563,vt827MYpYgT0JKXBC62SZ24Gxa8OJ87k,5Gyp41oLVo7Gg7vF4vpmggWP5MU70QO6,59,326,148,71,59,134,52,4,794,113.42857142857143,11,0.0,107,148,51,59,219,134,20,52,4,365,429,0
124,2604,X9z7B75ZTLkGstRvWBad2bmZQEZBZmda,5Gyp41oLVo7Gg7vF4vpmggWP5MU70QO6,44,146,88,46,18,54,54,3,409,58.42857142857143,15,0.0,28,88,33,18,118,54,13,54,3,167,242,0
125,2614,udnRYxurswpE4GUZcnc80kafg0hn3fpz,5Gyp41oLVo7Gg7vF4vpmggWP5MU70QO6,23,220,44,0,34,0,54,0,352,50.285714285714285,21,0.0,37,44,0,34,183,0,0,54,0,115,237,0
126,2617,M01QL9OpHCk7AlCLR2rtkIB8z4TgIYGl,5Gyp41oLVo7Gg7vF4vpmggWP5MU70QO6,47,290,160,95,65,97,93,17,817,116.71428571428571,15,0.0,72,160,50,65,218,97,45,93,17,347,470,0
127,2625,peOW1xVaKPULFrN5Gy7l1puUz8vUwyZz,5Gyp41oLVo7Gg7vF4vpmggWP5MU70QO6,45,193,124,28,60,74,48,5,532,76.0,22,0.0,30,124,20,60,163,74,8,48,5,234,298,0
128,2630,EMVIXb0OtQUlOTkm4BctcXpIyPV4dTGO,5Gyp41oLVo7Gg7vF4vpmggWP5MU70QO6,4,2,1,0,1,0,2,0,6,0.8571428571428571,1,0.0,0,1,0,1,2,0,0,2,0,2,4,0
129,2664,cV3n4FN1620ZqQlUNaFdXix6LZl6cUn8,5Gyp41oLVo7Gg7vF4vpmggWP5MU70QO6,8,4,3,0,3,0,3,0,13,1.8571428571428572,1,0.0,0,3,0,3,4,0,0,3,0,6,7,1
130,2668,xckq5i6cAJkmHxvopO4zZfFpDuAbJTD2,5Gyp41oLVo7Gg7vF4vpmggWP5MU70QO6,33,102,48,30,19,20,33,1,253,36.142857142857146,8,0.0,18,48,19,19,84,20,11,33,1,104,149,0
131,2675,rnJrTdDu7mP8PmEtAmyCbCH0QGpW6nHa,5Gyp41oLVo7Gg7vF4vpmggWP5MU70QO6,4,2,1,0,1,0,1,0,5,0.7142857142857143,1,0.0,0,1,0,1,2,0,0,1,0,2,3,1
132,2678,mne1Bu1F2f0U7iravmS4eQYQtLTkVvPe,5Gyp41oLVo7Gg7vF4vpmggWP5MU70QO6,4,0,0,0,0,0,7,0,7,1.0,3,0.0,0,0,0,0,0,0,0,7,0,0,7,1
133,2717,WrI30gql4CXiDrOACPqDBIcNFooNoDwk,5Gyp41oLVo7Gg7vF4vpmggWP5MU70QO6,2,0,0,0,0,0,2,0,2,0.2857142857142857,1,0.0,0,0,0,0,0,0,0,2,0,0,2,1
134,2738,96X23CFJ9JM7WmqrATM2bLmfmOiHnfrX,5Gyp41oLVo7Gg7vF4vpmggWP5MU70QO6,35,66,36,13,22,1,7,0,145,20.714285714285715,5,0.0,14,36,7,22,52,1,6,7,0,79,66,0
135,2770,3ZzNkdWgGb47Go07PRKPf0XZ6jjhVCB4,5Gyp41oLVo7Gg7vF4vpmggWP5MU70QO6,42,272,122,29,84,185,66,0,758,108.28571428571429,26,0.0,42,122,24,84,230,185,5,66,0,272,486,0
136,2795,DnDoqjJw1BNGPuZ9dcYerb1WIF0EHs8x,5Gyp41oLVo7Gg7vF4vpmggWP5MU70QO6,24,21,14,2,9,3,18,2,69,9.857142857142858,5,0.0,3,14,2,9,18,3,0,18,2,28,41,1
137,2803,0CSUGuJXm53wz281T7wy30wWcjmP6Jhd,5Gyp41oLVo7Gg7vF4vpmggWP5MU70QO6,33,103,53,18,7,28,18,0,227,32.42857142857143,9,0.0,18,53,13,7,85,28,5,18,0,91,136,0
138,2804,ONKHwhUYyLbMoYOizs3x6BRvtIjp27lG,5Gyp41oLVo7Gg7vF4vpmggWP5MU70QO6,7,5,2,0,2,0,3,0,12,1.7142857142857142,1,0.0,0,2,0,2,5,0,0,3,0,4,8,1
139,2812,hkAtGlDxhMZy9x4yCGvjJAqvDCw8DkBI,5Gyp41oLVo7Gg7vF4vpmggWP5MU70QO6,30,85,15,23,5,19,35,1,183,26.142857142857142,10,0.0,19,15,16,5,66,19,7,35,1,55,128,0
140,2819,bYjPoNbc5ILh7K7s9YR8HLOMNJGN6Ums,5Gyp41oLVo7Gg7vF4vpmggWP5MU70QO6,20,22,14,0,8,15,12,0,71,10.142857142857142,8,0.0,0,14,0,8,22,15,0,12,0,22,49,1
141,2822,t1xspb1k3lEGBshWKCwAoW44MsPqXHk5,5Gyp41oLVo7Gg7vF4vpmggWP5MU70QO6,17,28,1,8,4,0,6,0,47,6.714285714285714,4,0.0,10,1,4,4,18,0,4,6,0,19,28,0
142,2837,Edq6Echk8wEs8ShX5RBw5c8Yx8ANHVje,5Gyp41oLVo7Gg7vF4vpmggWP5MU70QO6,49,111,50,10,33,2,30,2,238,34.0,13,0.0,29,50,5,33,82,2,5,30,2,117,121,0
143,2857,60gY64MOFYUu13Ky5y4CMyoTiFvuhXp2,5Gyp41oLVo7Gg7vF4vpmggWP5MU70QO6,7,3,2,0,2,0,3,0,10,1.4285714285714286,1,0.0,0,2,0,2,3,0,0,3,0,4,6,1
144,2860,2bHG7ONGdh3befVaVcc6ibNYzkNOmb0e,5Gyp41oLVo7Gg7vF4vpmggWP5MU70QO6,13,16,9,0,3,1,7,4,40,5.714285714285714,3,0.0,1,9,0,3,15,1,0,7,4,13,27,1
145,2864,HpFGogxriXu94DUDni0GJRB2oUqWtUQx,5Gyp41oLVo7Gg7vF4vpmggWP5MU70QO6,1,0,0,0,0,0,1,0,1,0.14285714285714285,1,0.0,0,0,0,0,0,0,0,1,0,0,1,1
146,2877,G0kF4kBuM6Jj6hDV14pdfZS9sd6CrECA,5Gyp41oLVo7Gg7vF4vpmggWP5MU70QO6,20,50,21,18,9,3,12,0,113,16.142857142857142,5,0.0,20,21,9,9,30,3,9,12,0,59,54,0
147,2896,FBu5R2eGEtl9EDw0VwXtH1t5i2ELpdqI,5Gyp41oLVo7Gg7vF4vpmggWP5MU70QO6,12,23,6,0,2,0,5,0,36,5.142857142857143,2,0.0,2,6,0,2,21,0,0,5,0,10,26,1
148,2950,XR058hEVFk2cvKXahoJQvXB4I3FGEFWq,5Gyp41oLVo7Gg7vF4vpmggWP5MU70QO6,1,0,0,0,0,0,1,0,1,0.14285714285714285,1,0.0,0,0,0,0,0,0,0,1,0,0,1,0
149,2961,cGrHiRjztN9fSltHujpfWaaWfYWiidiG,5Gyp41oLVo7Gg7vF4vpmggWP5MU70QO6,2,0,0,0,0,0,3,0,3,0.42857142857142855,2,0.0,0,0,0,0,0,0,0,3,0,0,3,1
150,3003,Stmqgxft30bli2DiPibxa3LKP7KjyBRV,5Gyp41oLVo7Gg7vF4vpmggWP5MU70QO6,31,89,47,22,23,50,15,2,248,35.42857142857143,7,0.0,22,47,16,23,67,50,6,15,2,108,140,0
151,3032,5Gu4g9dtF1zjfzBwHRDyoDsx2MPMINMH,5Gyp41oLVo7Gg7vF4vpmggWP5MU70QO6,31,77,40,70,1,0,10,0,198,28.285714285714285,2,0.0,19,40,66,1,58,0,4,10,0,126,72,1
152,3041,RbFI9SCNoIyFjKexw9cTU5NZ0thYBnL5,5Gyp41oLVo7Gg7vF4vpmggWP5MU70QO6,55,204,73,41,62,7,40,3,430,61.42857142857143,13,0.0,82,73,30,62,122,7,11,40,3,247,183,0
153,3067,ew5XZC7WSosl0QdXH45kYD3syMSGbOj6,5Gyp41oLVo7Gg7vF4vpmggWP5MU70QO6,1,0,0,0,0,0,1,0,1,0.14285714285714285,1,0.0,0,0,0,0,0,0,0,1,0,0,1,0
154,3086,8wC0Vn9zhGZjzg8i1kWPjzqsyM8HCSSM,5Gyp41oLVo7Gg7vF4vpmggWP5MU70QO6,69,297,150,112,71,424,48,0,1102,157.42857142857142,21,0.0,96,150,99,71,201,424,13,48,0,416,686,0
155,3087,k3nczalTXlbSi0cYWDqkezTZw8d7MaoO,5Gyp41oLVo7Gg7vF4vpmggWP5MU70QO6,33,107,58,36,23,49,32,11,316,45.142857142857146,13,0.0,25,58,27,23,82,49,9,32,11,133,183,0
156,3091,GgocYHg42QPeXhj3QB7FBVGJqSqHh2yN,5Gyp41oLVo7Gg7vF4vpmggWP5MU70QO6,34,88,26,0,26,5,23,0,168,24.0,8,0.0,27,26,0,26,61,5,0,23,0,79,89,0
157,3103,hSrmLZQ0ouEuE46yYppuvpfSWmkaTAsV,5Gyp41oLVo7Gg7vF4vpmggWP5MU70QO6,22,83,35,13,8,0,23,0,162,23.142857142857142,14,0.0,16,35,12,8,67,0,1,23,0,71,91,0
158,3106,FZjjoikxEifQwEx2vf6LYlhg4yyTwbym,5Gyp41oLVo7Gg7vF4vpmggWP5MU70QO6,51,193,85,18,58,109,54,1,518,74.0,15,0.0,65,85,16,58,128,109,2,54,1,224,294,0
159,3117,3alUhWh257mQM5A6onXPn87mqMwnY8ws,5Gyp41oLVo7Gg7vF4vpmggWP5MU70QO6,1,0,0,0,0,0,1,0,1,0.14285714285714285,1,0.0,0,0,0,0,0,0,0,1,0,0,1,1
160,3133,C2kNfLlJQRAYF9jyyvOY33F0K0B7w85s,5Gyp41oLVo7Gg7vF4vpmggWP5MU70QO6,26,57,12,4,19,0,3,0,95,13.571428571428571,3,0.0,12,12,3,19,45,0,1,3,0,46,49,1
161,3191,fgUFzGHeNl17hqEi3W2JykpUAQc4koPg,5Gyp41oLVo7Gg7vF4vpmggWP5MU70QO6,11,14,6,0,3,0,7,1,31,4.428571428571429,2,0.0,5,6,0,3,9,0,0,7,1,14,17,1
162,3238,RqpNlPb2cCeq8CyPlsCSTNzToel5DLJg,5Gyp41oLVo7Gg7vF4vpmggWP5MU70QO6,9,7,3,0,1,0,12,2,25,3.5714285714285716,2,0.0,0,3,0,1,7,0,0,12,2,4,21,1
163,3267,OxaZt3K3Y0azvZXJrIbIeL0AeQB2p2K4,5Gyp41oLVo7Gg7vF4vpmggWP5MU70QO6,56,179,72,59,41,0,23,0,374,53.42857142857143,12,0.0,64,72,53,41,115,0,6,23,0,230,144,0
164,3271,WbJsJWqKM3lS43E1ayfblK0uOswvkrBy,5Gyp41oLVo7Gg7vF4vpmggWP5MU70QO6,1,0,0,0,0,0,1,0,1,0.14285714285714285,1,0.0,0,0,0,0,0,0,0,1,0,0,1,0
165,3301,heK7nc5k2RSdLj3SvuiNd8QLDb3Aw9tD,5Gyp41oLVo7Gg7vF4vpmggWP5MU70QO6,48,85,39,35,23,0,19,0,201,28.714285714285715,8,0.0,29,39,31,23,56,0,4,19,0,122,79,1
166,3345,3SedPvLa9rnUraW3u95r8D0TjbdwSj9M,5Gyp41oLVo7Gg7vF4vpmggWP5MU70QO6,10,5,4,0,3,0,2,0,14,2.0,1,0.0,0,4,0,3,5,0,0,2,0,7,7,1
167,3374,2r9IB6lC6Oy8Xqssc8yaSHVEOeR5k2WS,5Gyp41oLVo7Gg7vF4vpmggWP5MU70QO6,10,17,7,8,4,0,3,0,39,5.571428571428571,1,0.0,7,7,4,4,10,0,4,3,0,22,17,1
168,3385,y2sFlozPI9e5wiYk71wUsisMSmh9RNB3,5Gyp41oLVo7Gg7vF4vpmggWP5MU70QO6,6,2,1,0,1,0,6,0,10,1.4285714285714286,2,0.0,0,1,0,1,2,0,0,6,0,2,8,1
169,3423,9QYs2JnzEz1dyotEIIiqe5EglaIRqzBA,5Gyp41oLVo7Gg7vF4vpmggWP5MU70QO6,39,83,48,29,15,99,26,1,301,43.0,6,0.0,15,48,22,15,68,99,7,26,1,100,201,1
170,3448,9A7NeA8CSGMqqHgIDjiMNeFZF78KMRT6,5Gyp41oLVo7Gg7vF4vpmggWP5MU70QO6,27,93,34,32,15,13,30,8,225,32.142857142857146,6,0.0,27,34,24,15,66,13,8,30,8,100,125,0
171,3472,mSToVMacc08MhsUyEFn562K69bpANB3P,5Gyp41oLVo7Gg7vF4vpmggWP5MU70QO6,61,293,134,66,40,215,56,14,818,116.85714285714286,14,0.0,67,134,54,40,226,215,12,56,14,295,523,0
172,3480,OkJhYKwSeoxo9QfBqEGs4KQuEMzG6KCA,5Gyp41oLVo7Gg7vF4vpmggWP5MU70QO6,10,14,7,0,2,0,8,0,31,4.428571428571429,3,0.0,0,7,0,2,14,0,0,8,0,9,22,0
173,3490,tc8ZYWI5FOJIIpcsZ5SRyil7whr7RTIT,5Gyp41oLVo7Gg7vF4vpmggWP5MU70QO6,33,235,113,33,32,52,68,3,536,76.57142857142857,19,0.0,25,113,23,32,210,52,10,68,3,193,343,0
174,3493,1La5rp9ZSz9cfpqCRJiC01Rwvuq5VVrf,5Gyp41oLVo7Gg7vF4vpmggWP5MU70QO6,12,15,5,6,3,0,2,0,31,4.428571428571429,4,0.0,3,5,3,3,12,0,3,2,0,14,17,0
175,3515,iFZG4dlakJZdEEPu5PWLYLDec0A3ezk6,5Gyp41oLVo7Gg7vF4vpmggWP5MU70QO6,28,84,41,24,14,19,28,0,210,30.0,11,0.0,12,41,15,14,72,19,9,28,0,82,128,1
176,3532,Ld3sHSdq8bGwJeSrWz9af9hzp17d25R5,5Gyp41oLVo7Gg7vF4vpmggWP5MU70QO6,28,69,32,24,24,27,15,1,192,27.428571428571427,5,0.0,27,32,14,24,42,27,10,15,1,97,95,1
177,3533,6Pp97ClWigmCDyQzndUvEvRvyItrAz2A,5Gyp41oLVo7Gg7vF4vpmggWP5MU70QO6,9,9,3,2,3,0,2,0,19,2.7142857142857144,1,0.0,4,3,1,3,5,0,1,2,0,11,8,1
178,3551,DFGg7Qbju1Dz3JMqDAHjIzuroOYl6wwL,5Gyp41oLVo7Gg7vF4vpmggWP5MU70QO6,48,152,10,47,23,0,4,0,236,33.714285714285715,13,0.0,51,10,38,23,101,0,9,4,0,122,114,0
179,3560,nddmXFfQFzxAIEZ4polypNoRyjVZSqXS,5Gyp41oLVo7Gg7vF4vpmggWP5MU70QO6,17,31,1,10,3,0,6,0,51,7.285714285714286,2,0.0,11,1,5,3,20,0,5,6,0,20,31,0
180,3585,Na52PtAqm4VlTMUv1OPLGNjij0a5votC,5Gyp41oLVo7Gg7vF4vpmggWP5MU70QO6,17,26,13,20,4,20,31,5,119,17.0,7,0.0,0,13,10,4,26,20,10,31,5,27,92,0
181,3610,RgS6cN22NDcPEz2PVRWnmeNSLehqgiy4,5Gyp41oLVo7Gg7vF4vpmggWP5MU70QO6,7,10,5,0,2,0,5,0,22,3.142857142857143,4,0.0,0,5,0,2,10,0,0,5,0,7,15,1
182,3615,pqJQtDHBlTpHU5kx7RDVO2AZuCEpP1kO,5Gyp41oLVo7Gg7vF4vpmggWP5MU70QO6,4,2,1,0,1,0,1,0,5,0.7142857142857143,1,0.0,0,1,0,1,2,0,0,1,0,2,3,0
183,3678,1Ld3jQU8M0eiaLBshs8gjcgQEfdlgHyZ,5Gyp41oLVo7Gg7vF4vpmggWP5MU70QO6,7,3,2,0,2,0,2,0,9,1.2857142857142858,1,0.0,0,2,0,2,3,0,0,2,0,4,5,1
184,3695,96BILLwhKLX5Hn5XJ4XGCvMlo8QDhAAj,5Gyp41oLVo7Gg7vF4vpmggWP5MU70QO6,22,42,20,20,4,0,11,0,97,13.857142857142858,8,0.0,12,20,14,4,30,0,6,11,0,50,47,1
185,3696,TnonHqPC6G7qJ5vHeDou42rbzghbN46S,5Gyp41oLVo7Gg7vF4vpmggWP5MU70QO6,5,8,3,0,0,5,4,0,20,2.857142857142857,2,0.0,0,3,0,0,8,5,0,4,0,3,17,0
186,3765,nGnrvK97r3RMi6jeeCNoh4oNvsCIm83c,5Gyp41oLVo7Gg7vF4vpmggWP5MU70QO6,40,57,38,35,33,0,9,0,172,24.571428571428573,10,0.0,13,38,31,33,44,0,4,9,0,115,57,1
187,3786,Qs2YbK0fD6pTy64WqUQiIpZgcuos1U4U,5Gyp41oLVo7Gg7vF4vpmggWP5MU70QO6,36,100,34,22,25,1,10,1,193,27.571428571428573,6,0.0,26,34,17,25,74,1,5,10,1,102,91,0
188,3799,aQ6WrdDe9pTNwVW3vmaMOs1pxy5r3Dxa,5Gyp41oLVo7Gg7vF4vpmggWP5MU70QO6,43,96,47,41,21,14,33,1,253,36.142857142857146,13,0.0,24,47,28,21,72,14,13,33,1,120,133,0
189,3813,7TThYfyCRCrubmWYQiguJ3i3ufFK20sF,5Gyp41oLVo7Gg7vF4vpmggWP5MU70QO6,38,190,75,16,32,0,26,0,339,48.42857142857143,13,0.0,30,75,11,32,160,0,5,26,0,148,191,0
190,3864,PZd5fNdXR4d8uiQE08GO3FhBeWfKgGZa,5Gyp41oLVo7Gg7vF4vpmggWP5MU70QO6,38,127,35,28,22,14,15,1,242,34.57142857142857,5,0.0,36,35,20,22,91,14,8,15,1,113,129,0
191,3879,6d0wTeGZDr0ncgCyWQX4AMn46gB2ZbPz,5Gyp41oLVo7Gg7vF4vpmggWP5MU70QO6,7,3,2,0,2,0,2,0,9,1.2857142857142858,1,0.0,0,2,0,2,3,0,0,2,0,4,5,1
192,3884,51Zu52p8EKTqQH4hOwojJruuTYI8nSTK,5Gyp41oLVo7Gg7vF4vpmggWP5MU70QO6,9,3,2,0,2,0,9,1,17,2.4285714285714284,1,0.0,0,2,0,2,3,0,0,9,1,4,13,1
193,3885,2gXHY5qLgY96Nt3kImmboPawcy43EQXt,5Gyp41oLVo7Gg7vF4vpmggWP5MU70QO6,1,0,0,0,0,0,1,0,1,0.14285714285714285,1,0.0,0,0,0,0,0,0,0,1,0,0,1,1
194,3949,INw0ppEeVE6U7QZWmqPzkYkz5rCg79CE,5Gyp41oLVo7Gg7vF4vpmggWP5MU70QO6,5,3,1,0,1,0,2,0,7,1.0,1,0.0,0,1,0,1,3,0,0,2,0,2,5,1
195,3958,Sy0IBVghIdDN5uhsYaAtE4EZP4lbDR6C,5Gyp41oLVo7Gg7vF4vpmggWP5MU70QO6,25,72,36,2,15,11,26,1,163,23.285714285714285,8,0.0,19,36,1,15,53,11,1,26,1,71,92,0
196,3977,eEAARLmSvs9SsNUVTuHWgSwtASBchrcX,5Gyp41oLVo7Gg7vF4vpmggWP5MU70QO6,24,184,63,26,11,72,34,2,392,56.0,18,0.0,32,63,23,11,152,72,3,34,2,129,263,0
197,3978,h8n9HekAuyT08sLL5qmdMZ3BdSJVR4QF,fbPkOYLVPtPgIt0MxizjfFJov3JbHyAi,11,5,4,0,3,3,3,0,18,2.5714285714285716,1,0.0,0,4,0,3,5,3,0,3,0,7,11,0
198,3979,2GATpIfDBYFyTgYmFkr0bda9mVfNXuAl,fbPkOYLVPtPgIt0MxizjfFJov3JbHyAi,36,65,26,11,21,14,9,7,153,21.857142857142858,3,0.0,29,26,11,21,36,14,0,9,7,87,66,0
199,3998,q4Yehmjs3jQT9rXdV6cXhcGjESMqINf5,fbPkOYLVPtPgIt0MxizjfFJov3JbHyAi,28,57,30,18,22,16,8,0,151,21.571428571428573,4,0.0,20,30,15,22,37,16,3,8,0,87,64,0
200,4007,tfoakS3EMOjWuYWNRSgWZTjBxe3Mf9Te,fbPkOYLVPtPgIt0MxizjfFJov3JbHyAi,32,43,27,17,11,8,12,1,119,17.0,4,0.0,7,27,14,11,36,8,3,12,1,59,60,0
201,4049,L9qMLlGWAeAI6zWAZIyJtn0wISNa3dxg,fbPkOYLVPtPgIt0MxizjfFJov3JbHyAi,1,0,0,0,0,0,1,0,1,0.14285714285714285,1,0.0,0,0,0,0,0,0,0,1,0,0,1,1
202,4082,Intzo0A8tpMyd3IA01YG1BctRIdPWdNV,fbPkOYLVPtPgIt0MxizjfFJov3JbHyAi,6,0,0,0,0,18,8,1,27,3.857142857142857,1,0.0,0,0,0,0,0,18,0,8,1,0,27,0
203,4087,kyUPY0MEVeZNvkmrQxOn0CHNXLZiD03b,fbPkOYLVPtPgIt0MxizjfFJov3JbHyAi,25,32,20,12,5,28,12,0,109,15.571428571428571,5,0.0,6,20,10,5,26,28,2,12,0,41,68,0
204,4100,biOEnvJNbNmJmtnLohBToN5g3ppQrMj4,fbPkOYLVPtPgIt0MxizjfFJov3JbHyAi,42,92,42,22,18,34,11,1,220,31.428571428571427,4,0.0,13,42,21,18,79,34,1,11,1,94,126,0
205,4107,hXZgc5Oc8L3KNvO8ElQE29RF6Exzr76M,fbPkOYLVPtPgIt0MxizjfFJov3JbHyAi,32,103,0,30,0,28,19,1,181,25.857142857142858,3,0.0,23,0,26,0,80,28,4,19,1,49,132,1
206,4154,P7HoHyQzVXLghYr6m3MYTEIsDQbHfDfp,fbPkOYLVPtPgIt0MxizjfFJov3JbHyAi,8,10,4,2,2,0,2,0,20,2.857142857142857,1,0.0,2,4,2,2,8,0,0,2,0,10,10,1
207,4188,Em0hjKXRkhdtpThrexhSS4wvCtqaUFMH,SpATywNh6bZuzm8s1ceuBUnMUAeoAHHw,29,33,20,18,14,0,4,0,89,12.714285714285714,3,0.0,8,20,16,14,25,0,2,4,0,58,31,0
208,4207,0wJhtCWK60WPCeRF62m8T80DtNpWhRrg,5X6FeZozNMgE2VRi3MJYjkkFK8SETtu2,32,55,13,56,17,0,7,0,148,21.142857142857142,4,0.0,20,13,45,17,35,0,11,7,0,95,53,1
209,4257,7FYMj2bFfaTXHKfoaKa59KqAPXY4BWgD,SpATywNh6bZuzm8s1ceuBUnMUAeoAHHw,13,11,9,0,6,0,2,0,28,4.0,1,0.0,0,9,0,6,11,0,0,2,0,15,13,0
210,4264,I91CCtQfetYUPwkEXIvTFBP6tbrp1spN,SpATywNh6bZuzm8s1ceuBUnMUAeoAHHw,29,35,18,15,5,0,6,0,79,11.285714285714286,6,0.0,7,18,14,5,28,0,1,6,0,44,35,0
211,4267,RGl45e2VVMMdpatWhMc5IOKclnuxXpA1,SpATywNh6bZuzm8s1ceuBUnMUAeoAHHw,18,33,1,11,2,12,14,2,75,10.714285714285714,6,0.0,4,1,9,2,29,12,2,14,2,16,59,0
212,4308,UaSh8dwx8gnofYbXlmpqj9uYDbpJ89pX,5X6FeZozNMgE2VRi3MJYjkkFK8SETtu2,16,94,7,18,8,78,29,0,234,33.42857142857143,9,0.0,34,7,15,8,60,78,3,29,0,64,170,1
213,4315,BQkLFspAkEwZRgeuoSbQxFTr6POAaRzP,SpATywNh6bZuzm8s1ceuBUnMUAeoAHHw,3,2,0,0,0,0,1,0,3,0.42857142857142855,1,0.0,0,0,0,0,2,0,0,1,0,0,3,0
214,4363,TQnfaXCRCgVZx9kYYn4s6Q3eXGXW2mAu,SpATywNh6bZuzm8s1ceuBUnMUAeoAHHw,10,12,0,0,2,0,3,0,17,2.4285714285714284,1,0.0,0,0,0,2,12,0,0,3,0,2,15,0
215,4367,5I2aLwWP8vG6g175Y3fJi9X9n53v6aCn,SpATywNh6bZuzm8s1ceuBUnMUAeoAHHw,22,40,23,16,0,237,45,2,363,51.857142857142854,7,0.0,5,23,13,0,35,237,3,45,2,41,322,1
216,4380,5GeMwmyzCXMcMYfcWdKaXbpNNdL8bmPq,bWdj2GDclj5ofokWjzoa5jAwMkxCykd6,16,21,10,25,2,63,22,2,145,20.714285714285715,5,0.0,6,10,21,2,15,63,4,22,2,39,106,0
217,4385,wzrtLsMLUwSE1eXDXVMESg2JjrWZl4JD,SpATywNh6bZuzm8s1ceuBUnMUAeoAHHw,40,102,56,29,13,0,12,0,212,30.285714285714285,4,0.0,20,56,25,13,82,0,4,12,0,114,98,0
218,4438,3IgwuZBiVdgdYRQ9ySaEvpMizbjCJFS0,SpATywNh6bZuzm8s1ceuBUnMUAeoAHHw,34,35,18,22,11,23,14,0,123,17.571428571428573,4,0.0,6,18,18,11,29,23,4,14,0,53,70,0
219,4471,lEIFkqeT396JMSPUyiaHNMN8g7bQ1x9p,RXDvfPUBYFlVdlueBFbLW0mhhAyGEqpt,37,69,57,48,53,0,7,0,234,33.42857142857143,1,0.0,12,57,45,53,57,0,3,7,0,167,67,0
220,4485,1iBQrizMlXsnqwBfnYHB18bqwVfkqmsq,5X6FeZozNMgE2VRi3MJYjkkFK8SETtu2,1,0,0,0,0,0,1,0,1,0.14285714285714285,1,0.0,0,0,0,0,0,0,0,1,0,0,1,1
221,4492,800Nw5pvfdV7zCXCGav7KOLaYLAdOKht,SpATywNh6bZuzm8s1ceuBUnMUAeoAHHw,15,18,0,8,0,0,3,0,29,4.142857142857143,2,0.0,5,0,8,0,13,0,0,3,0,13,16,0
222,4494,wONMmUHIYwPBmEB9lgpOY3KCldKiuZFl,G8EPVSXsOYB5YQWZGiz1aVq5Pgr2GrQu,71,44,29,93,19,46,24,2,257,36.714285714285715,5,0.0,9,29,72,19,35,46,21,24,2,129,128,0
223,4501,dQuJ0DGjqbpnmQbHBTUIoBt7YzvOBCuV,SpATywNh6bZuzm8s1ceuBUnMUAeoAHHw,3,2,0,0,0,0,1,0,3,0.42857142857142855,1,0.0,0,0,0,0,2,0,0,1,0,0,3,1
224,4503,JJDRXXLRU75H8Dx2cuK7Td1V7D7QoKg9,SpATywNh6bZuzm8s1ceuBUnMUAeoAHHw,22,51,5,6,2,0,11,0,75,10.714285714285714,5,0.0,10,5,5,2,41,0,1,11,0,22,53,0
225,4529,DB1URyLII1znnmxnZlmmkOEalzIpmvtZ,A3fsA9Zfv1X2fVEQhTw51lKENdNrEqT3,3,0,0,0,0,0,3,0,3,0.42857142857142855,1,0.0,0,0,0,0,0,0,0,3,0,0,3,1
226,4557,s4xNNQ4RZ35amMfmvZawsu7u8CabnIey,A3fsA9Zfv1X2fVEQhTw51lKENdNrEqT3,2,0,1,0,1,0,0,0,2,0.2857142857142857,1,0.0,0,1,0,1,0,0,0,0,0,2,0,0
227,4562,sOkc0wEXSSLpxtxlqjZObJqg94IyLpuY,bWdj2GDclj5ofokWjzoa5jAwMkxCykd6,32,32,2,52,0,0,14,0,100,14.285714285714286,5,0.0,3,2,49,0,29,0,3,14,0,54,46,1
228,4580,PUW0i4IuafllkJEtV0GCqmTDeLHkDmH3,A3fsA9Zfv1X2fVEQhTw51lKENdNrEqT3,9,20,3,0,1,5,4,0,33,4.714285714285714,2,0.0,0,3,0,1,20,5,0,4,0,4,29,0
229,4609,UqksMVZ1lLvn2u7s6dT9SU5OFeNJnaAy,A3fsA9Zfv1X2fVEQhTw51lKENdNrEqT3,1,0,0,0,0,0,1,0,1,0.14285714285714285,1,0.0,0,0,0,0,0,0,0,1,0,0,1,1
230,4639,3OcDTnCwcizCpcOtz2UR6tflsBOvlv2R,SpATywNh6bZuzm8s1ceuBUnMUAeoAHHw,27,49,4,16,3,0,11,0,83,11.857142857142858,5,0.0,6,4,15,3,43,0,1,11,0,28,55,0
231,4642,qP2KbX0Pm1BCeErne0g8Q8oALeaVx7L6,SpATywNh6bZuzm8s1ceuBUnMUAeoAHHw,17,40,8,4,2,0,3,0,57,8.142857142857142,5,0.0,3,8,4,2,37,0,0,3,0,17,40,0
232,4653,IeSddciCla7lkuGxlh3rPQuCAXyzOV2D,SpATywNh6bZuzm8s1ceuBUnMUAeoAHHw,5,5,3,0,1,0,2,0,11,1.5714285714285714,2,0.0,0,3,0,1,5,0,0,2,0,4,7,1
233,4654,DsHgWZRTJ1y1l15smwhB78ZQq3d8dyKP,SpATywNh6bZuzm8s1ceuBUnMUAeoAHHw,14,24,1,16,0,0,3,0,44,6.285714285714286,3,0.0,6,1,13,0,18,0,3,3,0,20,24,0
234,4668,r5RSR6lot2jmkfKvV1hMDjuwwaPyA58W,SpATywNh6bZuzm8s1ceuBUnMUAeoAHHw,12,28,5,0,2,0,12,0,47,6.714285714285714,4,0.0,0,5,0,2,28,0,0,12,0,7,40,0
235,4678,SXmv5BCLsa8KcmJ2wx7Xg5CRI8Gu1aDd,bWdj2GDclj5ofokWjzoa5jAwMkxCykd6,9,13,6,0,2,5,6,0,32,4.571428571428571,2,0.0,0,6,0,2,13,5,0,6,0,8,24,0
236,4682,a59vIKGy87nbLYAxp6cxkmNDzOYhSXnX,SpATywNh6bZuzm8s1ceuBUnMUAeoAHHw,9,14,11,0,10,0,4,0,39,5.571428571428571,1,0.0,0,11,0,10,14,0,0,4,0,21,18,1
237,4699,7xdvqdjwrTcnpU47VRFtnMnSYVyjOAaR,SpATywNh6bZuzm8s1ceuBUnMUAeoAHHw,16,18,1,13,0,0,2,0,34,4.857142857142857,1,0.0,6,1,12,0,12,0,1,2,0,19,15,0
238,4701,eg4vjaGd0e6Yp3fu5azU2ZqedIZ6GBxl,SpATywNh6bZuzm8s1ceuBUnMUAeoAHHw,22,23,7,13,4,0,4,0,51,7.285714285714286,3,0.0,5,7,10,4,18,0,3,4,0,26,25,0
239,4703,C8ZlatATbcer8D4Z8pCX4rv1Rcx870po,RXDvfPUBYFlVdlueBFbLW0mhhAyGEqpt,4,2,1,0,0,0,2,0,5,0.7142857142857143,1,0.0,0,1,0,0,2,0,0,2,0,1,4,0
240,4736,6S5hOUFtfNcFsEpLKoUFbikqDYO5OBeF,5X6FeZozNMgE2VRi3MJYjkkFK8SETtu2,24,30,8,38,8,3,3,4,94,13.428571428571429,1,0.0,20,8,31,8,10,3,7,3,4,67,27,1
241,4778,xcD6YWhnGA2xukGmX4eaYrm6VS9ffz1H,G8EPVSXsOYB5YQWZGiz1aVq5Pgr2GrQu,23,15,9,56,2,0,5,0,87,12.428571428571429,1,0.0,0,9,44,2,15,0,12,5,0,55,32,0
242,4810,2LtuchYgE8Pco2t6mZeF2PkyT5iYJ1L1,SpATywNh6bZuzm8s1ceuBUnMUAeoAHHw,18,21,1,8,1,8,7,1,47,6.714285714285714,3,0.0,2,1,8,1,19,8,0,7,1,12,35,0
243,4814,SmONSyS4YgG4Afnv6ZxU81t7p4CQPV5P,A3fsA9Zfv1X2fVEQhTw51lKENdNrEqT3,27,58,28,0,18,0,19,0,123,17.571428571428573,6,0.0,0,28,0,18,58,0,0,19,0,46,77,1
244,4821,3cB0rEpxJxC0jjqfQ9EPT6ntxFajOXrx,5X6FeZozNMgE2VRi3MJYjkkFK8SETtu2,73,278,86,142,69,27,31,0,633,90.42857142857143,6,0.0,152,86,119,69,126,27,23,31,0,426,207,0
245,4828,f2h2VLvmMjqsSE1GgoTjiV7kOBQ7ba5D,SpATywNh6bZuzm8s1ceuBUnMUAeoAHHw,11,12,1,18,1,0,0,0,32,4.571428571428571,1,0.0,2,1,15,1,10,0,3,0,0,19,13,0
246,4862,9k6Repn2h6zXTygwvpy8LAM7GzTSYQBm,G8EPVSXsOYB5YQWZGiz1aVq5Pgr2GrQu,22,25,20,40,13,0,4,0,102,14.571428571428571,4,0.0,0,20,33,13,25,0,7,4,0,66,36,0
247,4866,GmHJt2279LUj6P2OGQD6V5Y1W95kmZpl,SpATywNh6bZuzm8s1ceuBUnMUAeoAHHw,5,3,1,0,1,0,1,0,6,0.8571428571428571,1,0.0,0,1,0,1,3,0,0,1,0,2,4,1
248,4870,T2tyjiaDe9s4tWUugE6FZTShWofnfMqo,bWdj2GDclj5ofokWjzoa5jAwMkxCykd6,6,9,0,0,0,2,4,0,15,2.142857142857143,4,0.0,0,0,0,0,9,2,0,4,0,0,15,0
249,4873,7gQzvY1ridUPLjuboweNhi3eMZVeaUA3,5X6FeZozNMgE2VRi3MJYjkkFK8SETtu2,1,0,0,0,0,0,1,0,1,0.14285714285714285,1,0.0,0,0,0,0,0,0,0,1,0,0,1,1
250,4885,sOkc0wEXSSLpxtxlqjZObJqg94IyLpuY,A3fsA9Zfv1X2fVEQhTw51lKENdNrEqT3,79,59,1,180,0,0,23,0,263,37.57142857142857,4,0.0,8,1,162,0,51,0,18,23,0,171,92,0
251,4945,ySy2zYThCkVZr5MjEXuKxq60wfOynxkJ,SpATywNh6bZuzm8s1ceuBUnMUAeoAHHw,10,13,0,0,0,9,20,0,42,6.0,5,0.0,1,0,0,0,12,9,0,20,0,1,41,0
252,4946,SVwfCRY50hd9Fz0klab9XqT7QROcyhqY,SpATywNh6bZuzm8s1ceuBUnMUAeoAHHw,19,22,16,16,9,0,4,0,67,9.571428571428571,4,0.0,2,16,13,9,20,0,3,4,0,40,27,0
253,4950,QIQydLQKNp8IAhwJcWzcTMkwBUNbfwOF,SpATywNh6bZuzm8s1ceuBUnMUAeoAHHw,17,20,0,12,0,2,3,0,37,5.285714285714286,2,0.0,6,0,12,0,14,2,0,3,0,18,19,0
254,4980,syrttArug8Mpzs9L0IHsvBtATawYF9J2,5X6FeZozNMgE2VRi3MJYjkkFK8SETtu2,146,218,54,355,45,19,19,3,713,101.85714285714286,8,0.0,149,54,290,45,69,19,65,19,3,538,175,0
255,4981,syrttArug8Mpzs9L0IHsvBtATawYF9J2,bWdj2GDclj5ofokWjzoa5jAwMkxCykd6,25,18,9,42,6,0,4,0,79,11.285714285714286,2,0.0,7,9,36,6,11,0,6,4,0,58,21,0
256,4991,meJV5qRzmJA836PpWZKeoFo4ZX1xiQOS,RXDvfPUBYFlVdlueBFbLW0mhhAyGEqpt,15,12,7,0,6,0,0,0,25,3.5714285714285716,2,0.0,0,7,0,6,12,0,0,0,0,13,12,1
257,5020,7kNYuUNvdIVdadzDsnKIKM0Ln3KLHYo2,SpATywNh6bZuzm8s1ceuBUnMUAeoAHHw,18,37,19,7,2,0,9,0,74,10.571428571428571,3,0.0,10,19,7,2,27,0,0,9,0,38,36,1
258,5022,QCXbyb2FyuLlETPxf3u27tgIYTs9gTM4,SpATywNh6bZuzm8s1ceuBUnMUAeoAHHw,10,8,3,0,2,0,1,0,14,2.0,2,0.0,0,3,0,2,8,0,0,1,0,5,9,0
259,5031,6Qw49dxLKsjbapN7r9Da43ajoDW7rCxT,G8EPVSXsOYB5YQWZGiz1aVq5Pgr2GrQu,10,9,7,0,2,122,4,0,144,20.571428571428573,6,0.0,0,7,0,2,9,122,0,4,0,9,135,0
260,5082,rVF6sxySmleXKBlMsWpXjKDnmQNSzrnS,G8EPVSXsOYB5YQWZGiz1aVq5Pgr2GrQu,59,103,68,93,36,35,27,1,363,51.857142857142854,8,0.0,8,68,78,36,95,35,15,27,1,190,173,0
261,5089,9uEyydZSRkLkXhWd7s5xv7f4NfRXrNUe,5X6FeZozNMgE2VRi3MJYjkkFK8SETtu2,8,5,3,0,2,0,15,1,26,3.7142857142857144,1,0.0,0,3,0,2,5,0,0,15,1,5,21,1
262,5142,B6vCUtkVL8SVuEEWctSPinCUr9rxihnh,G8EPVSXsOYB5YQWZGiz1aVq5Pgr2GrQu,50,47,23,122,6,4,12,0,214,30.571428571428573,1,0.0,17,23,92,6,30,4,30,12,0,138,76,0
263,5153,JiVwV8l6zLIAeTDli3uYE3CMxT1oG8Me,SpATywNh6bZuzm8s1ceuBUnMUAeoAHHw,16,24,3,0,3,0,6,0,36,5.142857142857143,2,0.0,0,3,0,3,24,0,0,6,0,6,30,0
264,5217,EP1XQRGS4HZOG1hdGzNZdD1HFhJcHpos,RXDvfPUBYFlVdlueBFbLW0mhhAyGEqpt,5,8,1,0,0,13,6,0,28,4.0,3,0.0,0,1,0,0,8,13,0,6,0,1,27,0
265,5250,UJeg7gRsnH7RZFT5Iv8Y0tTilR96sXcV,5X6FeZozNMgE2VRi3MJYjkkFK8SETtu2,5,2,1,0,1,0,2,0,6,0.8571428571428571,1,0.0,0,1,0,1,2,0,0,2,0,2,4,1
266,5259,hdKqkkWKrDzbKE9btGChBqiCfsTwp68E,bWdj2GDclj5ofokWjzoa5jAwMkxCykd6,1,0,1,0,0,0,0,0,1,0.14285714285714285,1,0.0,0,1,0,0,0,0,0,0,0,1,0,0
267,5303,o9EVHnUUU8I3f9dlC8NAcnHlKvZOnRmy,bWdj2GDclj5ofokWjzoa5jAwMkxCykd6,4,4,1,0,0,0,4,0,9,1.2857142857142858,3,0.0,0,1,0,0,4,0,0,4,0,1,8,0
268,5305,o9EVHnUUU8I3f9dlC8NAcnHlKvZOnRmy,A3fsA9Zfv1X2fVEQhTw51lKENdNrEqT3,45,10,5,138,0,0,5,0,158,22.571428571428573,2,0.0,3,5,120,0,7,0,18,5,0,128,30,0
269,5345,Kssd3yKtVgKi0ua0svvR8GgbZwRwIJMZ,SpATywNh6bZuzm8s1ceuBUnMUAeoAHHw,18,33,12,11,5,6,1,0,68,9.714285714285714,6,0.0,8,12,10,5,25,6,1,1,0,35,33,0
270,5355,PSoMps6mf7eMkjm3aPOL6fXV3Ul1HtBb,5X6FeZozNMgE2VRi3MJYjkkFK8SETtu2,11,10,3,10,4,0,2,0,29,4.142857142857143,1,0.0,5,3,10,4,5,0,0,2,0,22,7,1
271,5363,WXWUGznWk133hcEltnw7lYbm2oVZoXLf,SpATywNh6bZuzm8s1ceuBUnMUAeoAHHw,5,6,0,0,0,0,1,0,7,1.0,1,0.0,0,0,0,0,6,0,0,1,0,0,7,1
272,5389,cd7VGHrZb4Blwr9YuFp9MqF71m5wWUVd,G8EPVSXsOYB5YQWZGiz1aVq5Pgr2GrQu,99,68,5,246,5,1,10,0,335,47.857142857142854,4,0.0,12,5,214,5,56,1,32,10,0,236,99,0
273,5390,NL3IFunZJHMkqSLqiaHHbVIge1Bdgn26,G8EPVSXsOYB5YQWZGiz1aVq5Pgr2GrQu,51,35,29,100,9,0,8,0,181,25.857142857142858,4,0.0,1,29,89,9,34,0,11,8,0,128,53,0
274,5392,Tj9gyzxktEEAGnL07HQ3qbd2V0oCt16o,SpATywNh6bZuzm8s1ceuBUnMUAeoAHHw,30,108,21,32,11,0,16,0,188,26.857142857142858,7,0.0,26,21,21,11,82,0,11,16,0,79,109,0
275,5397,I6gFU4rZZ1rIaEMk0n0tBNQZ2tGcnjLw,SpATywNh6bZuzm8s1ceuBUnMUAeoAHHw,6,2,2,0,1,0,2,0,7,1.0,1,0.0,0,2,0,1,2,0,0,2,0,3,4,0
276,5414,4qM7n65VbCTp8lq3dbzhDmImmEZcwgn8,A3fsA9Zfv1X2fVEQhTw51lKENdNrEqT3,32,26,1,48,0,24,10,0,109,15.571428571428571,3,0.0,1,1,44,0,25,24,4,10,0,46,63,0
277,5424,qNh1HmZZ5IODkL9bGcGUg3xnGvE9VrLH,5X6FeZozNMgE2VRi3MJYjkkFK8SETtu2,19,52,1,20,9,1,7,0,90,12.857142857142858,4,0.0,30,1,19,9,22,1,1,7,0,59,31,1
278,5454,3ZzNkdWgGb47Go07PRKPf0XZ6jjhVCB4,bWdj2GDclj5ofokWjzoa5jAwMkxCykd6,19,28,19,32,7,39,9,0,134,19.142857142857142,4,0.0,1,19,18,7,27,39,14,9,0,45,89,0
279,5458,YOkiW0yIzjAwppKQnKaeEhWktVPNCIFb,A3fsA9Zfv1X2fVEQhTw51lKENdNrEqT3,3,2,1,0,0,0,3,0,6,0.8571428571428571,1,0.0,0,1,0,0,2,0,0,3,0,1,5,1
280,5472,OLX98cHycOH1FdInwYYk8PZBVFPyIkIG,SpATywNh6bZuzm8s1ceuBUnMUAeoAHHw,17,16,9,11,4,0,4,0,44,6.285714285714286,2,0.0,2,9,10,4,14,0,1,4,0,25,19,0
281,5487,gqe5NXbZbf5uXY0rPviLeIFOMpQyekdp,SpATywNh6bZuzm8s1ceuBUnMUAeoAHHw,6,4,0,0,0,0,2,0,6,0.8571428571428571,1,0.0,0,0,0,0,4,0,0,2,0,0,6,1
282,5526,FELnhQR0c7GZZX82ioYJEZsqujOrfyf7,5X6FeZozNMgE2VRi3MJYjkkFK8SETtu2,6,4,1,0,2,38,13,0,58,8.285714285714286,3,0.0,2,1,0,2,2,38,0,13,0,5,53,0
283,5535,0N8Aw17N0N8m1sn7piRGEu1YkeZIgvRo,SpATywNh6bZuzm8s1ceuBUnMUAeoAHHw,7,14,0,0,0,0,1,0,15,2.142857142857143,1,0.0,0,0,0,0,14,0,0,1,0,0,15,0
284,5554,C6xrhZPOmVH2gCVNP26gSSPka2CcwgB5,A3fsA9Zfv1X2fVEQhTw51lKENdNrEqT3,1,0,0,0,0,0,1,0,1,0.14285714285714285,1,0.0,0,0,0,0,0,0,0,1,0,0,1,1
285,5573,GdXLROZTUYTypGrrX0BjPE53M0Un36D7,SpATywNh6bZuzm8s1ceuBUnMUAeoAHHw,17,44,2,8,1,0,4,3,62,8.857142857142858,2,0.0,14,2,8,1,30,0,0,4,3,25,37,1
286,5582,kKBIfyZmN22zBj263eKBa0SA1U5xYMsR,SpATywNh6bZuzm8s1ceuBUnMUAeoAHHw,18,22,1,7,2,20,6,1,59,8.428571428571429,3,0.0,5,1,6,2,17,20,1,6,1,14,45,0
287,5605,k2w7Fl2HRg9SZoDIHFnK8RXCKuBBE2y7,bWdj2GDclj5ofokWjzoa5jAwMkxCykd6,51,48,23,83,9,3,21,0,187,26.714285714285715,5,0.0,10,23,72,9,38,3,11,21,0,114,73,0
288,5619,RHl3DsvAX7TisJ7qBptmgrrtDAQvH7mr,5X6FeZozNMgE2VRi3MJYjkkFK8SETtu2,21,38,19,12,7,9,18,0,103,14.714285714285714,6,0.0,10,19,12,7,28,9,0,18,0,48,55,0
289,5620,ZOxTwY2wRpdYn3qbKBoyT1PgdUitZ7Hl,RXDvfPUBYFlVdlueBFbLW0mhhAyGEqpt,8,8,5,0,2,0,5,0,20,2.857142857142857,1,0.0,0,5,0,2,8,0,0,5,0,7,13,1
290,5669,HbDaABEakQmE8DQEoFoIphu2SH13rFRy,SpATywNh6bZuzm8s1ceuBUnMUAeoAHHw,24,27,16,9,6,2,5,0,65,9.285714285714286,4,0.0,5,16,8,6,22,2,1,5,0,35,30,0
291,5692,KtQYnyrETXqJCvCxj7ZUnFcjZBBdiT7G,SpATywNh6bZuzm8s1ceuBUnMUAeoAHHw,19,20,12,14,6,0,3,0,55,7.857142857142857,2,0.0,2,12,12,6,18,0,2,3,0,32,23,0
292,5713,BvO8iO7xgnKFWgDrKByClW8hgTsia70X,5X6FeZozNMgE2VRi3MJYjkkFK8SETtu2,21,50,14,19,17,9,15,1,125,17.857142857142858,2,0.0,32,14,16,17,18,9,3,15,1,79,46,1
293,5725,DLDhUvvvfnnYFJuV65Zt2yaS0jPJgvzq,bWdj2GDclj5ofokWjzoa5jAwMkxCykd6,23,19,0,50,1,10,9,1,90,12.857142857142858,2,0.0,5,0,43,1,14,10,7,9,1,49,41,0
294,5726,tzyyAYK7Q2hNPhv988H6lH5D7hdM24rK,SpATywNh6bZuzm8s1ceuBUnMUAeoAHHw,19,16,9,10,5,0,2,0,42,6.0,1,0.0,5,9,10,5,11,0,0,2,0,29,13,0
295,5745,PpMDt0ql3KtH4YMuxusWOnbL4LfspwvV,A3fsA9Zfv1X2fVEQhTw51lKENdNrEqT3,1,0,0,0,0,0,1,0,1,0.14285714285714285,1,0.0,0,0,0,0,0,0,0,1,0,0,1,1
296,5778,A3AW3c7i1MF6oyHBEYvrXWvBxZwqeuYh,SpATywNh6bZuzm8s1ceuBUnMUAeoAHHw,11,8,0,7,0,0,5,0,20,2.857142857142857,2,0.0,2,0,7,0,6,0,0,5,0,9,11,0
297,5784,hjUSUM6roI2mLGkMAqBjE0uxFRBSMYHJ,5X6FeZozNMgE2VRi3MJYjkkFK8SETtu2,4,5,1,0,4,0,1,0,11,1.5714285714285714,1,0.0,3,1,0,4,2,0,0,1,0,8,3,1
298,5889,Oe7zyPdqUKEu4xpqbiVxJiAwdUxxeOQv,A3fsA9Zfv1X2fVEQhTw51lKENdNrEqT3,9,10,7,0,4,0,1,0,22,3.142857142857143,1,0.0,0,7,0,4,10,0,0,1,0,11,11,1
299,5904,L4jaFu0vxNsfaC1OhafSk08ztmq6goZk,SpATywNh6bZuzm8s1ceuBUnMUAeoAHHw,27,20,15,0,11,0,4,0,50,7.142857142857143,2,0.0,2,15,0,11,18,0,0,4,0,28,22,0
300,6000,2mD1u3b1vLrSJM0DZTrsvLcZVBVwwd27,RXDvfPUBYFlVdlueBFbLW0mhhAyGEqpt,14,9,9,0,6,0,3,0,27,3.857142857142857,4,0.0,0,9,0,6,9,0,0,3,0,15,12,0
301,6010,gEPTO2jN7POX6QtJlMdktFPT74irRyFu,SpATywNh6bZuzm8s1ceuBUnMUAeoAHHw,15,16,10,12,9,0,0,0,47,6.714285714285714,2,0.0,5,10,11,9,11,0,1,0,0,35,12,0
302,6070,Hj4fYYa64lvHLVeQZBqs9EQ1OtgHTvl6,SpATywNh6bZuzm8s1ceuBUnMUAeoAHHw,25,45,19,12,4,1,14,1,96,13.714285714285714,5,0.0,7,19,12,4,38,1,0,14,1,42,54,0
303,6074,xQWsagZWr4hwuLscur4NAIFNIWIrJTay,RXDvfPUBYFlVdlueBFbLW0mhhAyGEqpt,53,51,31,127,20,56,10,1,296,42.285714285714285,2,0.0,17,31,121,20,34,56,6,10,1,189,107,0
304,6075,4pJCNd3c3ApEtuK2GDe7eGNzOhsu04W5,G8EPVSXsOYB5YQWZGiz1aVq5Pgr2GrQu,32,43,30,2,13,57,10,0,155,22.142857142857142,7,0.0,5,30,1,13,38,57,1,10,0,49,106,0
305,6092,egIcBO9xXh5XDAWBOR2C58eTHcHVaPTq,5X6FeZozNMgE2VRi3MJYjkkFK8SETtu2,4,2,1,0,1,0,1,0,5,0.7142857142857143,1,0.0,0,1,0,1,2,0,0,1,0,2,3,1
306,6102,DJPrQ8k1R0aSF2q32X8eWoHfRxJjw6WA,SpATywNh6bZuzm8s1ceuBUnMUAeoAHHw,23,30,15,20,7,10,10,2,94,13.428571428571429,2,0.0,11,15,17,7,19,10,3,10,2,50,44,1
307,6106,lPxeEtjpZuY166gKAbN1CLkUMLrqY98p,SpATywNh6bZuzm8s1ceuBUnMUAeoAHHw,3,2,0,0,0,0,2,0,4,0.5714285714285714,1,0.0,0,0,0,0,2,0,0,2,0,0,4,1
308,6108,WWWH5rGgnKzcRMEBKWqCKBbIYZVZp9Wi,SpATywNh6bZuzm8s1ceuBUnMUAeoAHHw,22,44,4,14,1,0,3,0,66,9.428571428571429,3,0.0,17,4,12,1,27,0,2,3,0,34,32,0
309,6114,PIxnueIZLpBbMAAHbhlsEVGPkWRYGpMI,RXDvfPUBYFlVdlueBFbLW0mhhAyGEqpt,20,24,4,0,3,22,9,11,73,10.428571428571429,2,0.0,2,4,0,3,22,22,0,9,11,9,64,0
310,6123,onsmNYIoPFEi185f5ZLsQXD70I3K25Cb,A3fsA9Zfv1X2fVEQhTw51lKENdNrEqT3,7,12,4,0,1,0,1,0,18,2.5714285714285716,1,0.0,5,4,0,1,7,0,0,1,0,10,8,1
311,6134,UhLO5kko2VQ90AI2af3XOU7N46nRv9TM,SpATywNh6bZuzm8s1ceuBUnMUAeoAHHw,13,8,1,12,0,0,3,0,24,3.4285714285714284,1,0.0,2,1,12,0,6,0,0,3,0,15,9,0
312,6139,GWUUH9zdw0Ds2AJrirviqep1jIbCs8WU,5X6FeZozNMgE2VRi3MJYjkkFK8SETtu2,2,0,0,0,0,0,2,0,2,0.2857142857142857,1,0.0,0,0,0,0,0,0,0,2,0,0,2,0
313,6140,IBg4xmPqhTfP3qhSQ0m2yOJeGxXoGyqu,RXDvfPUBYFlVdlueBFbLW0mhhAyGEqpt,2,0,0,0,0,10,4,0,14,2.0,3,0.0,0,0,0,0,0,10,0,4,0,0,14,0
314,6185,rowlJHASOW6yJNtP0z67l2i9CtJCMokD,SpATywNh6bZuzm8s1ceuBUnMUAeoAHHw,14,25,0,13,0,6,4,9,57,8.142857142857142,1,0.0,2,0,12,0,23,6,1,4,9,14,43,0
315,6192,uFKxt8ud4wgPXsnEMlnj4koWPrsJIWsU,SpATywNh6bZuzm8s1ceuBUnMUAeoAHHw,12,30,0,0,0,0,3,0,33,4.714285714285714,2,0.0,0,0,0,0,30,0,0,3,0,0,33,0
316,6220,hyKcsvbAZrS0MucDsyUSihT6aOgvgztm,A3fsA9Zfv1X2fVEQhTw51lKENdNrEqT3,4,4,2,0,0,0,1,0,7,1.0,1,0.0,0,2,0,0,4,0,0,1,0,2,5,1
317,6237,iZTKl5rJwABSJbB6n0Qia3oN1YXnM1dc,5X6FeZozNMgE2VRi3MJYjkkFK8SETtu2,4,2,0,0,0,0,2,0,4,0.5714285714285714,1,0.0,0,0,0,0,2,0,0,2,0,0,4,1
318,6240,IkJ5dxCbqNRxBRuENFqjes2Z4rIDUrXn,SpATywNh6bZuzm8s1ceuBUnMUAeoAHHw,19,25,10,13,6,0,1,0,55,7.857142857142857,1,0.0,7,10,12,6,18,0,1,1,0,35,20,0
319,6271,q2xQCstASp96wpspi8iqsuaqJ7gzfsux,A3fsA9Zfv1X2fVEQhTw51lKENdNrEqT3,109,64,48,294,0,0,6,0,412,58.857142857142854,6,0.0,7,48,245,0,57,0,49,6,0,300,112,0
320,6306,Q8L1mPYwfiwtGo48PB0N9B5ppVi0px10,SpATywNh6bZuzm8s1ceuBUnMUAeoAHHw,20,32,16,9,6,0,10,0,73,10.428571428571429,4,0.0,11,16,8,6,21,0,1,10,0,41,32,0
321,6317,3Bw18YJt9vJt2emNNJ6GnWW50YrVLdEa,bWdj2GDclj5ofokWjzoa5jAwMkxCykd6,32,17,2,74,1,14,7,0,115,16.428571428571427,3,0.0,5,2,62,1,12,14,12,7,0,70,45,0
322,6331,SYptj19Xjkw9HEWtBs53CLIV7bhIU7QA,SpATywNh6bZuzm8s1ceuBUnMUAeoAHHw,9,19,6,0,2,0,2,0,29,4.142857142857143,1,0.0,0,6,0,2,19,0,0,2,0,8,21,1
323,6347,TAjGGV7oJgeUhPcj5Eum0tnVYrY7qjOE,RXDvfPUBYFlVdlueBFbLW0mhhAyGEqpt,8,10,4,0,1,6,9,1,31,4.428571428571429,3,0.0,0,4,0,1,10,6,0,9,1,5,26,0
324,6367,62a2qrcVt98j0sATcfHDrGeU9O6dsTND,5X6FeZozNMgE2VRi3MJYjkkFK8SETtu2,8,11,1,0,3,0,5,0,20,2.857142857142857,1,0.0,7,1,0,3,4,0,0,5,0,11,9,0
325,6368,Fa7tOqP1WKllvNDMgvUWmTzPr8J8vhy8,A3fsA9Zfv1X2fVEQhTw51lKENdNrEqT3,4,3,1,0,0,0,1,0,5,0.7142857142857143,1,0.0,0,1,0,0,3,0,0,1,0,1,4,1
326,6424,SmSrrYBj6KLZ39TqXb57CVWv6gX6sF7Q,SpATywNh6bZuzm8s1ceuBUnMUAeoAHHw,11,10,5,0,4,0,0,0,19,2.7142857142857144,1,0.0,0,5,0,4,10,0,0,0,0,9,10,0
327,6426,e3L16MrCoJp6rSpz1IWKaDG3S5tGTRpK,RXDvfPUBYFlVdlueBFbLW0mhhAyGEqpt,14,9,6,0,6,0,6,0,27,3.857142857142857,3,0.0,1,6,0,6,8,0,0,6,0,13,14,0
328,6435,nFeXukK9uLZggTwgBm3mDIxskaBXISqn,SpATywNh6bZuzm8s1ceuBUnMUAeoAHHw,20,32,3,22,2,0,3,0,62,8.857142857142858,3,0.0,7,3,19,2,25,0,3,3,0,31,31,1
329,6488,aYhMdR5xaez3fr0lBrD6kCxYiCOyculR,RXDvfPUBYFlVdlueBFbLW0mhhAyGEqpt,43,56,38,54,1,424,8,21,602,86.0,9,0.0,9,38,33,1,47,424,21,8,21,81,521,0
330,6506,DCJPPLzeeZhBbsYhL4xGedJzVmW41Gnk,SpATywNh6bZuzm8s1ceuBUnMUAeoAHHw,13,11,9,0,4,2,3,0,29,4.142857142857143,2,0.0,0,9,0,4,11,2,0,3,0,13,16,0
331,6516,1CrVBOpFvr6rOy553Xrye0bjPdL11eu8,RXDvfPUBYFlVdlueBFbLW0mhhAyGEqpt,35,43,23,38,15,8,6,0,133,19.0,4,0.0,7,23,37,15,36,8,1,6,0,82,51,0
332,6517,7u3azzypzNqPYEFxf0DcbGOgDVhkOXos,A3fsA9Zfv1X2fVEQhTw51lKENdNrEqT3,72,40,20,118,16,0,16,0,210,30.0,6,0.0,2,20,111,16,38,0,7,16,0,149,61,0
333,6523,dna1EUjVeT7Ka4gaXCCa53DsP3COwQS1,SpATywNh6bZuzm8s1ceuBUnMUAeoAHHw,14,26,1,13,0,0,2,0,42,6.0,1,0.0,8,1,10,0,18,0,3,2,0,19,23,0
334,6574,09vierxoREaD4msGgreYQSyOiGeSiZdQ,SpATywNh6bZuzm8s1ceuBUnMUAeoAHHw,24,28,20,0,13,8,2,0,71,10.142857142857142,2,0.0,0,20,0,13,28,8,0,2,0,33,38,0
335,6587,Y89GJdSZUpoYFMgx00SCe6qFoYoXIpUj,A3fsA9Zfv1X2fVEQhTw51lKENdNrEqT3,48,113,6,124,2,0,1,0,246,35.142857142857146,6,0.0,2,6,102,2,111,0,22,1,0,112,134,0
336,6643,lDflzmK9F6H42Kj6EtaBezWOcB4UUWiV,SpATywNh6bZuzm8s1ceuBUnMUAeoAHHw,21,18,13,9,6,0,5,0,51,7.285714285714286,4,0.0,2,13,8,6,16,0,1,5,0,29,22,0
337,6679,tY5a0NX1zue0V7W3ml5X4bo1Gus2ozCa,SpATywNh6bZuzm8s1ceuBUnMUAeoAHHw,9,13,7,0,2,0,4,0,26,3.7142857142857144,2,0.0,2,7,0,2,11,0,0,4,0,11,15,0
338,6685,mfQ48K9Gnf187sLZBiTNegL6UkMDsKbJ,SpATywNh6bZuzm8s1ceuBUnMUAeoAHHw,19,28,7,14,2,0,20,0,71,10.142857142857142,9,0.0,2,7,12,2,26,0,2,20,0,23,48,0
339,6760,yh14zaFitCUTgvBPqRXiaZ6cUijtktL4,A3fsA9Zfv1X2fVEQhTw51lKENdNrEqT3,8,5,4,0,2,0,2,0,13,1.8571428571428572,1,0.0,0,4,0,2,5,0,0,2,0,6,7,1
340,6809,Sy675y5yY7HGgANETsmQapbB8hGWLA1f,5X6FeZozNMgE2VRi3MJYjkkFK8SETtu2,5,13,0,0,2,5,4,0,24,3.4285714285714284,1,0.0,10,0,0,2,3,5,0,4,0,12,12,1
341,6813,UvqKXPrebnykj7gkohis9MIhsKJQCjxw,G8EPVSXsOYB5YQWZGiz1aVq5Pgr2GrQu,38,71,66,68,36,0,6,0,247,35.285714285714285,2,0.0,0,66,61,36,71,0,7,6,0,163,84,0
342,6816,dSloiolTuQA1YnIVrIEZb5m23cL24cRw,A3fsA9Zfv1X2fVEQhTw51lKENdNrEqT3,3,2,1,0,0,0,1,0,4,0.5714285714285714,1,0.0,0,1,0,0,2,0,0,1,0,1,3,1
343,6824,e12uQn96OlYfknMdqSXCXdImglIj4IRR,bWdj2GDclj5ofokWjzoa5jAwMkxCykd6,10,15,9,0,3,14,11,0,52,7.428571428571429,2,0.0,1,9,0,3,14,14,0,11,0,13,39,0
344,6898,UxSaaQ6GZyl7nlDC1x0TA1qshXRkMyH8,RXDvfPUBYFlVdlueBFbLW0mhhAyGEqpt,37,111,38,36,23,5,2,0,215,30.714285714285715,3,0.0,28,38,35,23,83,5,1,2,0,124,91,0
345,6914,5XorWInOikFQGiy06qBvCZ6iOgBDDoJu,SpATywNh6bZuzm8s1ceuBUnMUAeoAHHw,15,12,10,0,8,0,4,0,34,4.857142857142857,2,0.0,0,10,0,8,12,0,0,4,0,18,16,0
346,6916,x6r7USCSuVFGzUeOMsU9rcLC4WDuI3GF,A3fsA9Zfv1X2fVEQhTw51lKENdNrEqT3,5,3,2,0,0,0,3,0,8,1.1428571428571428,1,0.0,0,2,0,0,3,0,0,3,0,2,6,0
347,6925,h9168zUD8zDtaVgTWmp8akLV044AqETE,G8EPVSXsOYB5YQWZGiz1aVq5Pgr2GrQu,13,6,4,50,0,1,2,0,63,9.0,2,0.0,1,4,44,0,5,1,6,2,0,49,14,0
348,6948,4r712Cp6HawShlWfCnD4BeT5bNCQMkQ4,SpATywNh6bZuzm8s1ceuBUnMUAeoAHHw,25,31,3,16,2,0,4,0,56,8.0,2,0.0,8,3,13,2,23,0,3,4,0,26,30,0
349,6956,ykaUPJW4Nc9r2mv4b25QxgdHgIcQ63RQ,SpATywNh6bZuzm8s1ceuBUnMUAeoAHHw,17,16,7,12,5,15,2,0,57,8.142857142857142,6,0.0,3,7,11,5,13,15,1,2,0,26,31,0
350,6983,7fC3V6ivG07wUIMOmiYFzSlyjWvbYnYf,A3fsA9Zfv1X2fVEQhTw51lKENdNrEqT3,86,43,0,348,0,0,9,0,400,57.142857142857146,4,0.0,3,0,294,0,40,0,54,9,0,297,103,0
351,6989,QXMWMAYLhXvptULktpThtcXNRQ6JansN,SpATywNh6bZuzm8s1ceuBUnMUAeoAHHw,21,47,22,9,9,0,28,0,115,16.428571428571427,7,0.0,6,22,9,9,41,0,0,28,0,46,69,0
352,7020,43QhXZfKBBZHpTmjLSVuTzbc6djzr40d,SpATywNh6bZuzm8s1ceuBUnMUAeoAHHw,16,29,0,9,0,0,12,0,50,7.142857142857143,3,0.0,4,0,8,0,25,0,1,12,0,12,38,0
353,7036,ogcVEHXlejDZ3EsIUfi0CHUmNlnDccd3,5X6FeZozNMgE2VRi3MJYjkkFK8SETtu2,8,7,2,0,0,3,10,3,25,3.5714285714285716,3,0.0,1,2,0,0,6,3,0,10,3,3,22,1
354,7051,86WaolA0zlcsNwK3PQQKKGFDOSiqigXx,SpATywNh6bZuzm8s1ceuBUnMUAeoAHHw,18,14,9,15,6,0,2,0,46,6.571428571428571,1,0.0,2,9,13,6,12,0,2,2,0,30,16,1
355,7119,03YAuQnjuYjTWwgHqE1110CZpZwknRbj,RXDvfPUBYFlVdlueBFbLW0mhhAyGEqpt,35,23,12,64,9,0,1,0,109,15.571428571428571,1,0.0,8,12,62,9,15,0,2,1,0,91,18,0
356,7138,tJ7FzaUMbzSP2K4BtZobNqzCoEbllcH1,RXDvfPUBYFlVdlueBFbLW0mhhAyGEqpt,40,111,8,70,3,261,49,113,615,87.85714285714286,9,0.0,21,8,64,3,90,261,6,49,113,96,519,0
357,7143,ahFkMpqRNclNalhsRFgKmc75UZfOTdgQ,SpATywNh6bZuzm8s1ceuBUnMUAeoAHHw,21,48,20,22,8,0,2,0,100,14.285714285714286,2,0.0,21,20,16,8,27,0,6,2,0,65,35,1
358,7151,2QwHrFxGcIFGuR6TyUnlExhchaRL2Ipx,SpATywNh6bZuzm8s1ceuBUnMUAeoAHHw,18,67,13,18,1,0,23,0,122,17.428571428571427,8,0.0,8,13,15,1,59,0,3,23,0,37,85,0
359,7182,HlYiU2TA92it9HWOPDlsBmlpdZ7J7QTJ,SpATywNh6bZuzm8s1ceuBUnMUAeoAHHw,17,13,9,5,7,0,1,0,35,5.0,1,0.0,3,9,5,7,10,0,0,1,0,24,11,1
360,7258,sT9hGAnww95aeGvqwQpJlS3ORhWDT49F,A3fsA9Zfv1X2fVEQhTw51lKENdNrEqT3,4,3,2,0,0,0,1,0,6,0.8571428571428571,1,0.0,0,2,0,0,3,0,0,1,0,2,4,1
361,7283,K5Sy6doI03r5uctdEcvObhW1bpzNGROt,G8EPVSXsOYB5YQWZGiz1aVq5Pgr2GrQu,62,127,64,108,39,7,9,1,355,50.714285714285715,6,0.0,43,64,71,39,84,7,37,9,1,217,138,0
362,7304,VSEOcWZYpZiKC2PUmidzj4VqbBnc3GAo,A3fsA9Zfv1X2fVEQhTw51lKENdNrEqT3,43,6,3,152,0,0,20,0,181,25.857142857142858,6,0.0,3,3,137,0,3,0,15,20,0,143,38,0
363,7310,Yby0It9Tj4ASosIcvg72qeavqJKBNZLT,5X6FeZozNMgE2VRi3MJYjkkFK8SETtu2,2,0,0,0,0,0,2,0,2,0.2857142857142857,1,0.0,0,0,0,0,0,0,0,2,0,0,2,1
364,7317,EwpbggvNdZkeSTjdG48aEltlJYavm02s,5X6FeZozNMgE2VRi3MJYjkkFK8SETtu2,53,469,13,0,61,0,12,0,555,79.28571428571429,7,0.0,291,13,0,61,178,0,0,12,0,365,190,0
365,7332,5kqorcxIJejDFcc1de7q3uie94xFSgMJ,SpATywNh6bZuzm8s1ceuBUnMUAeoAHHw,20,66,45,0,21,0,6,0,138,19.714285714285715,3,0.0,9,45,0,21,57,0,0,6,0,75,63,0
366,7337,J5FkxM9o8L4y51xbaKwQjZuay8KpJMzH,SpATywNh6bZuzm8s1ceuBUnMUAeoAHHw,22,19,4,17,3,3,4,0,50,7.142857142857143,2,0.0,5,4,14,3,14,3,3,4,0,26,24,1
367,7338,XpquNqg2EIDRwNL88GzK6drchpRZMQN1,A3fsA9Zfv1X2fVEQhTw51lKENdNrEqT3,8,6,5,0,3,0,2,0,16,2.2857142857142856,2,0.0,0,5,0,3,6,0,0,2,0,8,8,0
368,7345,B9KqNNxXBxHFUsJnQKQysblL3f8zF7sg,bWdj2GDclj5ofokWjzoa5jAwMkxCykd6,13,30,5,0,1,0,6,0,42,6.0,5,0.0,5,5,0,1,25,0,0,6,0,11,31,0
369,7364,84Vq27rxsidbGJFxLO0cd5e2CSiXRChu,A3fsA9Zfv1X2fVEQhTw51lKENdNrEqT3,34,26,19,0,15,0,5,0,65,9.285714285714286,3,0.0,0,19,0,15,26,0,0,5,0,34,31,1
370,7377,84Vq27rxsidbGJFxLO0cd5e2CSiXRChu,SpATywNh6bZuzm8s1ceuBUnMUAeoAHHw,27,29,17,6,8,2,12,1,75,10.714285714285714,5,0.0,3,17,6,8,26,2,0,12,1,34,41,1
371,7387,u82lBhpDxJIwlZISEntCxj1zgVFdW0vT,SpATywNh6bZuzm8s1ceuBUnMUAeoAHHw,36,147,70,29,29,37,39,1,352,50.285714285714285,7,0.0,49,70,19,29,98,37,10,39,1,167,185,0
372,7402,XESEnxXOxYn0sEg8u7X5S27rymbaMzNA,SpATywNh6bZuzm8s1ceuBUnMUAeoAHHw,35,39,25,30,12,0,7,0,113,16.142857142857142,1,0.0,5,25,27,12,34,0,3,7,0,69,44,0
373,7405,thbVK5OkB13GLXnOCtBegvQeqDmjraYm,SpATywNh6bZuzm8s1ceuBUnMUAeoAHHw,23,33,22,13,16,7,5,0,96,13.714285714285714,4,0.0,7,22,13,16,26,7,0,5,0,58,38,0
374,7410,MRybyq1cnqatDusvwSwOpxgKfQSDJUE3,bWdj2GDclj5ofokWjzoa5jAwMkxCykd6,8,6,4,10,3,0,1,0,24,3.4285714285714284,1,0.0,1,4,9,3,5,0,1,1,0,17,7,1
375,7445,mawBMWVaMDuwBgxqJlSNvSnxuZmWfWRW,SpATywNh6bZuzm8s1ceuBUnMUAeoAHHw,19,27,1,38,1,0,6,0,73,10.428571428571429,3,0.0,6,1,35,1,21,0,3,6,0,43,30,0
376,7456,1CrVBOpFvr6rOy553Xrye0bjPdL11eu8,A3fsA9Zfv1X2fVEQhTw51lKENdNrEqT3,98,67,40,140,21,8,17,0,293,41.857142857142854,8,0.0,12,40,127,21,55,8,13,17,0,200,93,0
377,7470,zwtc7XYkGr4Bhsl8UEIZlPO0o9lpzfSZ,A3fsA9Zfv1X2fVEQhTw51lKENdNrEqT3,99,87,29,264,20,1,19,3,423,60.42857142857143,3,0.0,3,29,239,20,84,1,25,19,3,291,132,0
378,7477,5DIcniD9kRbDupVPBNugV5by0SZHtD2e,SpATywNh6bZuzm8s1ceuBUnMUAeoAHHw,19,31,8,13,1,0,7,0,60,8.571428571428571,5,0.0,4,8,12,1,27,0,1,7,0,25,35,0
379,7484,ZghgmsFKGlL396BKFJoJeIy2X7crdnN0,SpATywNh6bZuzm8s1ceuBUnMUAeoAHHw,28,32,17,24,11,0,1,0,85,12.142857142857142,2,0.0,12,17,22,11,20,0,2,1,0,62,23,0
380,7489,uUSTKM8g1hIskJbYHh1UiIQ6epHTSTNR,bWdj2GDclj5ofokWjzoa5jAwMkxCykd6,6,8,5,0,1,0,4,0,18,2.5714285714285716,3,0.0,0,5,0,1,8,0,0,4,0,6,12,1
381,7490,uUSTKM8g1hIskJbYHh1UiIQ6epHTSTNR,G8EPVSXsOYB5YQWZGiz1aVq5Pgr2GrQu,8,16,9,0,1,0,5,0,31,4.428571428571429,3,0.0,3,9,0,1,13,0,0,5,0,13,18,0
382,7500,BQwuBUR4WYRdCAVoQUNUZK3Ln34YX0iv,SpATywNh6bZuzm8s1ceuBUnMUAeoAHHw,5,4,1,0,1,0,1,0,7,1.0,1,0.0,0,1,0,1,4,0,0,1,0,2,5,1
383,7524,UNtI3N6D9AZsFIjfiItWfMe73uBfp0VS,SpATywNh6bZuzm8s1ceuBUnMUAeoAHHw,29,20,14,14,10,0,12,0,70,10.0,2,0.0,4,14,14,10,16,0,0,12,0,42,28,0
384,7541,CGIwACA114zcxKI2ZiGPCkXleQcVHz2y,SpATywNh6bZuzm8s1ceuBUnMUAeoAHHw,16,15,3,13,2,0,4,0,37,5.285714285714286,2,0.0,2,3,12,2,13,0,1,4,0,19,18,0
385,7543,fGIeAB7IRJCHxzCo8u4GLaPKxQfHeCdi,SpATywNh6bZuzm8s1ceuBUnMUAeoAHHw,31,84,15,17,10,0,13,0,139,19.857142857142858,4,0.0,21,15,17,10,63,0,0,13,0,63,76,0
386,7551,dnay2jAX3cgskuo0IcUq4nB4ZOtSKU5x,SpATywNh6bZuzm8s1ceuBUnMUAeoAHHw,7,12,4,0,2,0,1,0,19,2.7142857142857144,1,0.0,0,4,0,2,12,0,0,1,0,6,13,0
387,7554,eO5CgKdvPHZfZ8krv7wlSTYp2EdmZAmV,RXDvfPUBYFlVdlueBFbLW0mhhAyGEqpt,1,0,0,0,0,0,1,0,1,0.14285714285714285,1,0.0,0,0,0,0,0,0,0,1,0,0,1,1
388,7586,40eiF3ZEuOYP1RP6XBUcW4OUQFmNxf9i,SpATywNh6bZuzm8s1ceuBUnMUAeoAHHw,12,9,7,0,5,0,2,0,23,3.2857142857142856,1,0.0,0,7,0,5,9,0,0,2,0,12,11,0
389,7587,wEaTyOJwwvOCk7eUttQISK5WPXL7ANNV,SpATywNh6bZuzm8s1ceuBUnMUAeoAHHw,20,24,11,13,3,0,8,3,62,8.857142857142858,1,0.0,6,11,10,3,18,0,3,8,3,30,32,0
390,7616,PcrKUgtxZcGXBYkLOmECh99m3fhAOabf,SpATywNh6bZuzm8s1ceuBUnMUAeoAHHw,7,14,1,0,0,5,5,0,25,3.5714285714285716,1,0.0,0,1,0,0,14,5,0,5,0,1,24,0
391,7651,HL6JESJ9UfnK7mtp7EsklcgEKja4gTaC,RXDvfPUBYFlVdlueBFbLW0mhhAyGEqpt,35,52,6,40,5,2,7,0,112,16.0,4,0.0,14,6,40,5,38,2,0,7,0,65,47,1
392,7656,v9Jp2iBPSFTVxP8FrUe1odwfz8Hd1wS3,SpATywNh6bZuzm8s1ceuBUnMUAeoAHHw,33,37,20,17,10,0,5,0,89,12.714285714285714,2,0.0,13,20,16,10,24,0,1,5,0,59,30,0
393,7670,NKzNFHK6LaJqjMec69ZX5HfBigF4yyJV,SpATywNh6bZuzm8s1ceuBUnMUAeoAHHw,35,52,30,15,13,35,11,1,157,22.428571428571427,3,0.0,14,30,14,13,38,35,1,11,1,71,86,0
394,7677,HPp2Yy992FcBIXDjeQl0bEftbV1QFRDS,SpATywNh6bZuzm8s1ceuBUnMUAeoAHHw,19,15,10,11,5,0,3,0,44,6.285714285714286,2,0.0,2,10,10,5,13,0,1,3,0,27,17,0
395,7683,uydIb4MWCn95KWcEhKwj3VRfjvxXo8Nj,A3fsA9Zfv1X2fVEQhTw51lKENdNrEqT3,31,52,27,22,3,264,47,1,416,59.42857142857143,9,0.0,6,27,14,3,46,264,8,47,1,50,366,0
396,7694,a6f3gPi6axX0cfBnUGVliBDQrPx92l1r,SpATywNh6bZuzm8s1ceuBUnMUAeoAHHw,20,41,23,17,12,0,10,0,103,14.714285714285714,7,0.0,6,23,14,12,35,0,3,10,0,55,48,0
397,7701,f81JJCqMlkJdA9lV7uQBviuGlLm2CDkR,SpATywNh6bZuzm8s1ceuBUnMUAeoAHHw,21,43,4,14,0,0,8,0,69,9.857142857142858,4,0.0,14,4,11,0,29,0,3,8,0,29,40,0
398,7729,xkt3K6JWpnfeixDBdwkLXaHgXuuGt35v,A3fsA9Zfv1X2fVEQhTw51lKENdNrEqT3,22,13,6,62,0,0,3,0,84,12.0,2,0.0,4,6,56,0,9,0,6,3,0,66,18,1
399,7731,ZD844NRFhgHqwskHd8pIBuIwDiTAY4NC,SpATywNh6bZuzm8s1ceuBUnMUAeoAHHw,3,2,1,0,0,0,2,0,5,0.7142857142857143,1,0.0,0,1,0,0,2,0,0,2,0,1,4,0
400,7766,3kfsZtV93tVXeg8YtF9PTasYswVdOeLx,SpATywNh6bZuzm8s1ceuBUnMUAeoAHHw,26,66,1,26,1,0,16,0,110,15.714285714285714,8,0.0,13,1,21,1,53,0,5,16,0,36,74,0
401,7771,Rdvgrardg53H2oeCgmOt8vFxIUu5nogb,SpATywNh6bZuzm8s1ceuBUnMUAeoAHHw,17,20,0,13,0,0,3,0,36,5.142857142857143,2,0.0,4,0,10,0,16,0,3,3,0,14,22,0
402,7774,EQU3KQKmF0NpNwQmPmUw90ptahwADmIz,SpATywNh6bZuzm8s1ceuBUnMUAeoAHHw,5,9,4,0,1,0,4,0,18,2.5714285714285716,2,0.0,0,4,0,1,9,0,0,4,0,5,13,1
403,7778,moK1GdnqoYxhSRCf5a95lgXdVNdzYrjs,A3fsA9Zfv1X2fVEQhTw51lKENdNrEqT3,62,42,4,96,2,0,44,0,188,26.857142857142858,8,0.0,2,4,89,2,40,0,7,44,0,97,91,0
404,7781,h1PVCD4diCwozuU4ZjcMLdFycUmYpSIc,G8EPVSXsOYB5YQWZGiz1aVq5Pgr2GrQu,65,74,32,126,22,1,10,1,266,38.0,4,0.0,36,32,87,22,38,1,39,10,1,177,89,0
405,7786,7aA6BrVZipLHOrozlrYBMEmfMq4MXahq,RXDvfPUBYFlVdlueBFbLW0mhhAyGEqpt,13,29,3,0,1,0,3,0,36,5.142857142857143,3,0.0,5,3,0,1,24,0,0,3,0,9,27,0
406,7793,z2zhro5MCTuNkAWXNKBS5L7zEtJc0Vs9,SpATywNh6bZuzm8s1ceuBUnMUAeoAHHw,22,12,9,12,6,0,3,0,42,6.0,1,0.0,2,9,11,6,10,0,1,3,0,28,14,0
407,7820,tcrOs8a5NYKg0fcf0qJ4buK5RKIEFS5o,RXDvfPUBYFlVdlueBFbLW0mhhAyGEqpt,28,37,12,41,6,6,4,0,106,15.142857142857142,3,0.0,9,12,38,6,28,6,3,4,0,65,41,0
408,7831,SozLQk8695JG7fvj1Enp26s5ACJQjjq5,SpATywNh6bZuzm8s1ceuBUnMUAeoAHHw,34,30,20,14,9,6,19,3,101,14.428571428571429,3,0.0,4,20,13,9,26,6,1,19,3,46,55,0
409,7844,cSB2xmj1Zot5hgCLSHhxDNISJzHyYsXf,SpATywNh6bZuzm8s1ceuBUnMUAeoAHHw,9,5,1,0,1,0,3,0,10,1.4285714285714286,1,0.0,0,1,0,1,5,0,0,3,0,2,8,1
410,7869,34oDxV5jJfVaGWSsgPNGJP2ott7rJu7I,SpATywNh6bZuzm8s1ceuBUnMUAeoAHHw,21,55,26,23,23,0,5,0,132,18.857142857142858,3,0.0,12,26,19,23,43,0,4,5,0,80,52,0
411,7872,ZosutOeXAHBSIvZIuIxhmKGfV7JZESP5,SpATywNh6bZuzm8s1ceuBUnMUAeoAHHw,15,32,17,0,8,0,26,0,83,11.857142857142858,2,0.0,0,17,0,8,32,0,0,26,0,25,58,0
412,7885,S58o7T8J2JcEBTi3bdMATXeMdhJbXqYq,SpATywNh6bZuzm8s1ceuBUnMUAeoAHHw,28,20,15,17,12,5,8,1,78,11.142857142857142,2,0.0,2,15,14,12,18,5,3,8,1,43,35,0
413,7916,TIvBCmMDquWj2iwTixxUP6A3HzcrQyq3,SpATywNh6bZuzm8s1ceuBUnMUAeoAHHw,32,90,24,21,9,6,21,0,171,24.428571428571427,5,0.0,25,24,16,9,65,6,5,21,0,74,97,0
414,7953,KIPXc8MOqmnlmMqnIzIeaBqliIw9pS44,RXDvfPUBYFlVdlueBFbLW0mhhAyGEqpt,10,11,7,0,3,0,2,0,23,3.2857142857142856,1,0.0,2,7,0,3,9,0,0,2,0,12,11,1
415,7971,Y7KMNxUWz3B2grUtFCf2FgfpqFMvSy0l,G8EPVSXsOYB5YQWZGiz1aVq5Pgr2GrQu,63,56,35,190,16,0,25,0,322,46.0,7,0.0,4,35,152,16,52,0,38,25,0,207,115,0
416,8012,jagu0OJDhWTGFhfCMk0ghqluLpW3kzdC,SpATywNh6bZuzm8s1ceuBUnMUAeoAHHw,32,22,13,23,9,4,15,0,86,12.285714285714286,3,0.0,5,13,18,9,17,4,5,15,0,45,41,0
417,8040,IjI8O6qhXWrzvoHGjD0jKSLTrkjwywnZ,SpATywNh6bZuzm8s1ceuBUnMUAeoAHHw,15,22,1,18,1,4,4,0,50,7.142857142857143,1,0.0,2,1,14,1,20,4,4,4,0,18,32,0
418,8048,lPfsYctvOlk2KshSTR0YzF9fsG0sDcXm,SpATywNh6bZuzm8s1ceuBUnMUAeoAHHw,7,7,4,0,2,0,3,0,16,2.2857142857142856,1,0.0,0,4,0,2,7,0,0,3,0,6,10,0
419,8060,aJPDWxjvWh7cfVWUTg8ZVK8q5wjeFEdQ,SpATywNh6bZuzm8s1ceuBUnMUAeoAHHw,14,26,5,6,2,2,8,5,54,7.714285714285714,2,0.0,1,5,5,2,25,2,1,8,5,13,41,1
420,8112,X4PGvTm4F0x49zE1LPpj4etdmQj6eS9S,SpATywNh6bZuzm8s1ceuBUnMUAeoAHHw,38,36,25,0,18,0,9,0,88,12.571428571428571,3,0.0,3,25,0,18,33,0,0,9,0,46,42,0
421,8123,q6JeU48PcDOdiZ368tb3IoCh3BVgnxVp,bWdj2GDclj5ofokWjzoa5jAwMkxCykd6,28,30,20,34,7,69,11,0,171,24.428571428571427,4,0.0,0,20,23,7,30,69,11,11,0,50,121,1
422,8145,ZDVmuYiPoGm0gu1bR2BaE1soF6dU5v1W,A3fsA9Zfv1X2fVEQhTw51lKENdNrEqT3,28,23,13,42,13,3,2,0,96,13.714285714285714,1,0.0,0,13,38,13,23,3,4,2,0,64,32,1
423,8257,ANOp8mWNHTZUswLhYddMTdBChUriYZaX,RXDvfPUBYFlVdlueBFbLW0mhhAyGEqpt,44,109,12,90,16,40,30,1,298,42.57142857142857,7,0.0,35,12,81,16,74,40,9,30,1,144,154,0
424,8301,KdYI01F9Xc7qTt82weazWGHtHsUvxDB7,SpATywNh6bZuzm8s1ceuBUnMUAeoAHHw,18,20,3,7,3,0,4,0,37,5.285714285714286,3,0.0,4,3,7,3,16,0,0,4,0,17,20,1
425,8305,kpS5tMAHQr9yJyfVB9Mkc4TlfmouYjNE,SpATywNh6bZuzm8s1ceuBUnMUAeoAHHw,25,75,7,0,4,0,0,0,86,12.285714285714286,5,0.0,0,7,0,4,75,0,0,0,0,11,75,0
426,8312,cYibpCaMUGq0WjgUWfTv0iIvJ7QbFj5E,SpATywNh6bZuzm8s1ceuBUnMUAeoAHHw,18,12,7,13,6,0,6,0,44,6.285714285714286,1,0.0,5,7,11,6,7,0,2,6,0,29,15,0
427,8378,ZipuPEeCqze6LFrYfkIZBU7ronXF3JAb,SpATywNh6bZuzm8s1ceuBUnMUAeoAHHw,28,18,14,16,11,0,1,0,60,8.571428571428571,1,0.0,3,14,13,11,15,0,3,1,0,41,19,0
428,8381,XDUz0oVcNwke0CqAlFlmwOWSA32SgeFl,SpATywNh6bZuzm8s1ceuBUnMUAeoAHHw,9,17,1,0,0,0,4,0,22,3.142857142857143,4,0.0,0,1,0,0,17,0,0,4,0,1,21,0
429,8410,kWUbu8oK1dFJKpHhiF15MwcSzNzv8GaS,A3fsA9Zfv1X2fVEQhTw51lKENdNrEqT3,3,4,2,0,0,0,2,0,8,1.1428571428571428,2,0.0,0,2,0,0,4,0,0,2,0,2,6,1
430,8424,ukCIrv5h45nbdIEPPmMlvipT87B8fFE7,RXDvfPUBYFlVdlueBFbLW0mhhAyGEqpt,28,48,34,0,14,15,0,0,111,15.857142857142858,7,0.0,0,34,0,14,48,15,0,0,0,48,63,0
431,8427,sOkc0wEXSSLpxtxlqjZObJqg94IyLpuY,SpATywNh6bZuzm8s1ceuBUnMUAeoAHHw,27,48,0,16,0,0,9,0,73,10.428571428571429,2,0.0,7,0,14,0,41,0,2,9,0,21,52,0
432,8457,jcXoYFaI9QPcliotiwIgOLeObkrSUvNn,SpATywNh6bZuzm8s1ceuBUnMUAeoAHHw,10,8,1,0,1,0,1,0,11,1.5714285714285714,1,0.0,0,1,0,1,8,0,0,1,0,2,9,0
433,8478,UY6XF5Ob1mgKcqmlUI5FgYfIUUIUAwxR,SpATywNh6bZuzm8s1ceuBUnMUAeoAHHw,35,41,16,22,10,0,5,0,94,13.428571428571429,2,0.0,9,16,17,10,32,0,5,5,0,52,42,0
434,8505,DpXkrIHIAIPNESKyvFah0WhpVT5PHFeL,SpATywNh6bZuzm8s1ceuBUnMUAeoAHHw,10,17,11,0,0,0,4,0,32,4.571428571428571,3,0.0,0,11,0,0,17,0,0,4,0,11,21,0
435,8516,WFBeS5f6wWn1eFBxyujnTFuvM6fqEpDk,A3fsA9Zfv1X2fVEQhTw51lKENdNrEqT3,8,4,0,6,0,0,2,0,12,1.7142857142857142,1,0.0,1,0,6,0,3,0,0,2,0,7,5,1
436,8517,4tj4DQ4XnBvn4uM9Mw2kTJbN1KPDkno4,SpATywNh6bZuzm8s1ceuBUnMUAeoAHHw,8,16,12,0,4,0,3,0,35,5.0,3,0.0,0,12,0,4,16,0,0,3,0,16,19,0
437,8522,aLRP3ahB5SIcOn5vpM1VPEh9ib2QIioX,bWdj2GDclj5ofokWjzoa5jAwMkxCykd6,3,2,1,0,0,0,1,0,4,0.5714285714285714,1,0.0,0,1,0,0,2,0,0,1,0,1,3,1
438,8523,0Vj24SN7QK68fxZGEj9b6pGHh8nTXfGG,A3fsA9Zfv1X2fVEQhTw51lKENdNrEqT3,4,13,10,0,0,0,5,0,28,4.0,1,0.0,0,10,0,0,13,0,0,5,0,10,18,0
439,8553,aGkT5uzDJUsKsLNIW3C8wBL1bUhJSBfn,SpATywNh6bZuzm8s1ceuBUnMUAeoAHHw,4,4,0,0,0,0,0,0,4,0.5714285714285714,1,0.0,0,0,0,0,4,0,0,0,0,0,4,0
440,8570,ApFdQQBcLqTLoA4wIvtlnnwFs4FrlVS1,RXDvfPUBYFlVdlueBFbLW0mhhAyGEqpt,71,115,75,96,37,42,53,2,420,60.0,6,0.0,26,75,89,37,89,42,7,53,2,227,193,0
441,8574,7jkKKf5Pb7FrtJ3WnuF11G7ePioUPJm3,A3fsA9Zfv1X2fVEQhTw51lKENdNrEqT3,12,8,7,8,3,0,3,0,29,4.142857142857143,1,0.0,0,7,8,3,8,0,0,3,0,18,11,1
442,8582,x0VzAeYdlywtGLqE1HF68qQMYZTLfsw9,SpATywNh6bZuzm8s1ceuBUnMUAeoAHHw,33,46,24,18,14,0,9,0,111,15.857142857142858,5,0.0,14,24,15,14,32,0,3,9,0,67,44,0
443,8585,28jQkMYgDOh7TIBKdGn62G1sm2slN0BP,A3fsA9Zfv1X2fVEQhTw51lKENdNrEqT3,67,42,28,148,16,0,10,0,244,34.857142857142854,7,0.0,2,28,121,16,40,0,27,10,0,167,77,0
444,8586,Xci1viGBABzXjikcwwlwGEGBfmePUlzw,SpATywNh6bZuzm8s1ceuBUnMUAeoAHHw,14,43,19,7,0,22,10,2,103,14.714285714285714,2,0.0,17,19,7,0,26,22,0,10,2,43,60,1
445,8616,GexMn1szbSD50sX3ghgNlwAzziO50D2R,SpATywNh6bZuzm8s1ceuBUnMUAeoAHHw,26,72,9,13,3,17,26,0,140,20.0,4,0.0,22,9,11,3,50,17,2,26,0,45,95,0
446,8628,nQgK4glIoTighvWZSrb5cpZqSgT49IUz,SpATywNh6bZuzm8s1ceuBUnMUAeoAHHw,35,36,23,21,10,0,12,0,102,14.571428571428571,4,0.0,8,23,18,10,28,0,3,12,0,59,43,0
447,8636,2tNnsKlcvz4IV4xQh5sF75J9zNq5DtzC,SpATywNh6bZuzm8s1ceuBUnMUAeoAHHw,17,18,3,16,0,0,1,0,38,5.428571428571429,2,0.0,4,3,16,0,14,0,0,1,0,23,15,1
448,8649,uQjl8NGtIQkRfoe9edBiMgtYYmdkzVXR,bWdj2GDclj5ofokWjzoa5jAwMkxCykd6,11,30,14,8,2,0,8,0,62,8.857142857142858,6,0.0,4,14,6,2,26,0,2,8,0,26,36,0
449,8652,15n53eqSRMLQKZaiigI2Vgclm7aKceka,A3fsA9Zfv1X2fVEQhTw51lKENdNrEqT3,3,4,0,0,0,0,2,0,6,0.8571428571428571,2,0.0,0,0,0,0,4,0,0,2,0,0,6,0
450,8660,CxUPOQRaQMGLmbOcfniIQOhh24PXLDR6,A3fsA9Zfv1X2fVEQhTw51lKENdNrEqT3,2,5,5,0,0,0,0,0,10,1.4285714285714286,5,0.0,0,5,0,0,5,0,0,0,0,5,5,0
451,8677,k6Ev3pOofJatsjXYv6yHRgeWPlAQcaXL,SpATywNh6bZuzm8s1ceuBUnMUAeoAHHw,6,6,4,0,2,0,2,0,14,2.0,1,0.0,0,4,0,2,6,0,0,2,0,6,8,1
452,8690,NuBf7vtWvcfQjgrelnmNuJu6a5WC9FFT,SpATywNh6bZuzm8s1ceuBUnMUAeoAHHw,7,6,2,0,2,0,3,0,13,1.8571428571428572,1,0.0,0,2,0,2,6,0,0,3,0,4,9,0
453,8734,fxq584v5hQmVOHgm4uohGT9XrYo1FGMS,SpATywNh6bZuzm8s1ceuBUnMUAeoAHHw,34,84,28,37,13,0,4,0,166,23.714285714285715,2,0.0,6,28,31,13,78,0,6,4,0,78,88,0
454,8741,XWElpBT4PKnC5pi96PLjtYP5u9l1rrKm,SpATywNh6bZuzm8s1ceuBUnMUAeoAHHw,23,63,22,7,10,4,17,1,124,17.714285714285715,5,0.0,12,22,6,10,51,4,1,17,1,50,74,0
455,8748,IZ5pWpBLzW50MjCCGxCjTz4w6DVz2MU3,A3fsA9Zfv1X2fVEQhTw51lKENdNrEqT3,64,62,35,156,21,0,8,0,282,40.285714285714285,4,0.0,7,35,124,21,55,0,32,8,0,187,95,0
456,8752,tsTDNHtkzUQqr6Le5CiKzEb1J3ub8XpE,G8EPVSXsOYB5YQWZGiz1aVq5Pgr2GrQu,52,28,6,114,6,0,1,0,155,22.142857142857142,6,0.0,2,6,109,6,26,0,5,1,0,123,32,0
457,8756,cPzUMr5q8dc3UpQvyyBObvWhUfY89oua,SpATywNh6bZuzm8s1ceuBUnMUAeoAHHw,17,7,7,0,6,1,5,1,27,3.857142857142857,1,0.0,0,7,0,6,7,1,0,5,1,13,14,1
458,8766,V8icfAYA9I8myBnRTjbheMwStuoZOBk5,SpATywNh6bZuzm8s1ceuBUnMUAeoAHHw,8,8,1,0,1,0,1,0,11,1.5714285714285714,1,0.0,0,1,0,1,8,0,0,1,0,2,9,1
459,8772,NLUFE7ndaVQ8A2tkIa8xBpPqWZbahAYT,SpATywNh6bZuzm8s1ceuBUnMUAeoAHHw,38,35,20,29,11,0,14,2,111,15.857142857142858,3,0.0,7,20,23,11,28,0,6,14,2,61,50,0
460,8783,V9A9B2T9pRTU3AqvpqzuKs4MfRcAEte2,RXDvfPUBYFlVdlueBFbLW0mhhAyGEqpt,5,3,2,0,1,0,1,0,7,1.0,1,0.0,0,2,0,1,3,0,0,1,0,3,4,1
461,8790,hShFZH2IARrzxZjv2Hbws9rmf9bt3f58,SpATywNh6bZuzm8s1ceuBUnMUAeoAHHw,6,9,2,0,1,0,4,0,16,2.2857142857142856,3,0.0,0,2,0,1,9,0,0,4,0,3,13,0
462,8820,sqKEuRhvHf94SnQ2C0IdhOfhaSrrM6tg,SpATywNh6bZuzm8s1ceuBUnMUAeoAHHw,17,43,1,16,1,0,9,0,70,10.0,3,0.0,14,1,14,1,29,0,2,9,0,30,40,0
463,8833,BX9KMh9DUbDRkGw8SYAs3wHv0hHJ990Z,SpATywNh6bZuzm8s1ceuBUnMUAeoAHHw,33,35,21,18,11,0,8,0,93,13.285714285714286,4,0.0,4,21,18,11,31,0,0,8,0,54,39,0
464,8882,NAmyRYUXoAoJaF1WmEUzfZdW5j2jsFh1,SpATywNh6bZuzm8s1ceuBUnMUAeoAHHw,44,56,38,30,21,61,22,1,229,32.714285714285715,6,0.0,11,38,26,21,45,61,4,22,1,96,133,0
465,8939,awz7o49PrUBSNrYng5ZPMFSJBn6RXWK1,G8EPVSXsOYB5YQWZGiz1aVq5Pgr2GrQu,66,97,62,27,46,0,31,0,263,37.57142857142857,7,0.0,4,62,26,46,93,0,1,31,0,138,125,0
466,8976,7uaenfsWfnarv8At387iUkznBBW20T7a,SpATywNh6bZuzm8s1ceuBUnMUAeoAHHw,21,32,16,12,6,2,10,0,78,11.142857142857142,6,0.0,2,16,9,6,30,2,3,10,0,33,45,0
467,8978,WCRryRCEKP6zK3AUHtR5dzBwncEtNUH8,G8EPVSXsOYB5YQWZGiz1aVq5Pgr2GrQu,62,74,9,138,11,3,304,1,540,77.14285714285714,8,0.0,22,9,118,11,52,3,20,304,1,160,380,0
468,9007,WDMP5c2Ubx8vVSFegA0mXeU23cYb0qCY,RXDvfPUBYFlVdlueBFbLW0mhhAyGEqpt,35,50,1,53,0,13,1,0,118,16.857142857142858,8,0.0,8,1,47,0,42,13,6,1,0,56,62,0
469,9035,ANOp8mWNHTZUswLhYddMTdBChUriYZaX,SpATywNh6bZuzm8s1ceuBUnMUAeoAHHw,26,69,0,33,0,18,18,0,138,19.714285714285715,2,0.0,22,0,28,0,47,18,5,18,0,50,88,0
470,9136,UqGW2x76mENodjXkUPPKnojGcrLxXcJN,SpATywNh6bZuzm8s1ceuBUnMUAeoAHHw,24,41,20,15,8,0,8,0,92,13.142857142857142,6,0.0,13,20,14,8,28,0,1,8,0,55,37,0
471,9220,lnpRXkDrSwjGYP4CoWLvjg5xZj4SSBHh,SpATywNh6bZuzm8s1ceuBUnMUAeoAHHw,34,30,21,20,11,6,4,0,92,13.142857142857142,2,0.0,4,21,16,11,26,6,4,4,0,52,40,0
472,9232,b3doS3mx4rZAsWrCVosVej8UMBCaG0ZM,SpATywNh6bZuzm8s1ceuBUnMUAeoAHHw,11,6,5,0,4,0,1,0,16,2.2857142857142856,1,0.0,0,5,0,4,6,0,0,1,0,9,7,1
473,9260,OXDIjQPBiuWpB7PdzfniEtiITaq40Kxq,SpATywNh6bZuzm8s1ceuBUnMUAeoAHHw,7,9,4,0,1,0,2,0,16,2.2857142857142856,1,0.0,3,4,0,1,6,0,0,2,0,8,8,1
474,9272,8lhedVUrxjbKOOXrDoKpLvh9BgBDrVND,SpATywNh6bZuzm8s1ceuBUnMUAeoAHHw,21,39,12,6,8,0,2,0,67,9.571428571428571,2,0.0,1,12,5,8,38,0,1,2,0,26,41,0
475,9275,Mu4L96Qo7KWrVAKYK2IsPfV4EjP9aNL4,SpATywNh6bZuzm8s1ceuBUnMUAeoAHHw,3,2,1,0,0,0,1,0,4,0.5714285714285714,1,0.0,0,1,0,0,2,0,0,1,0,1,3,1
476,9327,tJN8ZYcrD7OwnBb01xCqUSDOnzwFRPdf,SpATywNh6bZuzm8s1ceuBUnMUAeoAHHw,17,34,6,16,5,0,13,0,74,10.571428571428571,3,0.0,2,6,13,5,32,0,3,13,0,26,48,0
477,9328,3SP9iNDvUt8m67ZMqC5DpQRe6ekkTpsP,SpATywNh6bZuzm8s1ceuBUnMUAeoAHHw,1,0,0,0,0,0,1,0,1,0.14285714285714285,1,0.0,0,0,0,0,0,0,0,1,0,0,1,1
478,9357,aSYSmBNLMzBrel3rF1bQSMOfc7OKhL4q,SpATywNh6bZuzm8s1ceuBUnMUAeoAHHw,5,11,1,0,0,0,3,0,15,2.142857142857143,1,0.0,0,1,0,0,11,0,0,3,0,1,14,1
479,9358,I2ghGumCKIaVsnJOGZA0xyJzTnEm5KtW,RXDvfPUBYFlVdlueBFbLW0mhhAyGEqpt,3,2,1,0,0,0,1,0,4,0.5714285714285714,1,0.0,0,1,0,0,2,0,0,1,0,1,3,1
480,9362,EoYFOaJU19EU8QGJeHpIRqrgzpIVI4Qd,bWdj2GDclj5ofokWjzoa5jAwMkxCykd6,3,2,1,0,0,0,1,0,4,0.5714285714285714,1,0.0,0,1,0,0,2,0,0,1,0,1,3,1
481,9422,KqXKhfoS0ErJVO04c2y8uGBxUt61ck8m,SpATywNh6bZuzm8s1ceuBUnMUAeoAHHw,3,3,1,0,0,0,1,0,5,0.7142857142857143,1,0.0,0,1,0,0,3,0,0,1,0,1,4,1
482,9460,zOr0niRplBKfkwpPHNykN96u1FhzegfK,G8EPVSXsOYB5YQWZGiz1aVq5Pgr2GrQu,36,189,69,0,13,84,25,0,380,54.285714285714285,8,0.0,42,69,0,13,147,84,0,25,0,124,256,0
483,9468,JnhPqAOFLEpgEufKhwt0tmkUNhkNteVd,SpATywNh6bZuzm8s1ceuBUnMUAeoAHHw,5,3,1,0,0,0,2,0,6,0.8571428571428571,1,0.0,0,1,0,0,3,0,0,2,0,1,5,1
484,9469,V4PEne3FGwC3uaaGa4t7iLZtyEIE0fzF,SpATywNh6bZuzm8s1ceuBUnMUAeoAHHw,7,4,1,0,1,0,2,0,8,1.1428571428571428,1,0.0,0,1,0,1,4,0,0,2,0,2,6,1
485,9470,XDPvGyFLLEYwbNEQik2MM4yiADs5rrYJ,RXDvfPUBYFlVdlueBFbLW0mhhAyGEqpt,1,0,0,0,0,0,1,0,1,0.14285714285714285,1,0.0,0,0,0,0,0,0,0,1,0,0,1,1
486,9510,20lTdK7j1fcbNyoe9mD2q7qXvA5Z8HOD,SpATywNh6bZuzm8s1ceuBUnMUAeoAHHw,17,18,12,0,8,0,4,0,42,6.0,1,0.0,3,12,0,8,15,0,0,4,0,23,19,0
487,9517,fN4I0M2Yv3uPvseFkDyQdSg5ZokzJaMj,RXDvfPUBYFlVdlueBFbLW0mhhAyGEqpt,22,21,8,38,4,0,3,0,74,10.571428571428571,4,0.0,5,8,38,4,16,0,0,3,0,55,19,1
488,9533,xdUSsALCLmQFNaGX8BEyTR2RhmvhWdsB,SpATywNh6bZuzm8s1ceuBUnMUAeoAHHw,4,4,1,0,0,0,7,0,12,1.7142857142857142,2,0.0,0,1,0,0,4,0,0,7,0,1,11,0
489,9549,RV3mgnFEm5em6PXoEJeQNSKFCpjzfVyy,bWdj2GDclj5ofokWjzoa5jAwMkxCykd6,9,8,1,2,0,40,11,0,62,8.857142857142858,2,0.0,0,1,1,0,8,40,1,11,0,2,60,0
490,9550,7J9JIWVCQG1g6yXh3uTVbrSu3pa18Ezn,SpATywNh6bZuzm8s1ceuBUnMUAeoAHHw,23,18,12,11,7,8,5,0,61,8.714285714285714,2,0.0,2,12,10,7,16,8,1,5,0,31,30,0
491,9624,GD8FRA1y66qb4KlW9w61HoAU1TWGpDoa,G8EPVSXsOYB5YQWZGiz1aVq5Pgr2GrQu,16,31,15,4,3,218,34,2,307,43.857142857142854,9,0.0,1,15,3,3,30,218,1,34,2,22,285,0
492,9636,zcw6JFT1cBTyKAWUWt6eG4jvVYxHMSLq,SpATywNh6bZuzm8s1ceuBUnMUAeoAHHw,19,21,14,7,5,0,3,0,50,7.142857142857143,3,0.0,4,14,7,5,17,0,0,3,0,30,20,0
493,9643,UzwJVyLJF6Ih9iHYPyYWMullgIr89o5m,SpATywNh6bZuzm8s1ceuBUnMUAeoAHHw,14,16,6,8,1,0,4,0,35,5.0,4,0.0,3,6,8,1,13,0,0,4,0,18,17,0
494,9655,66U3TkcZA1aSl7HKRun9CzahgGH85zQD,SpATywNh6bZuzm8s1ceuBUnMUAeoAHHw,17,54,2,15,1,17,14,0,103,14.714285714285714,6,0.0,14,2,15,1,40,17,0,14,0,32,71,0
495,9663,C4q4gNQYEpjKh7pq1qjN8i3L7uSpUX9d,bWdj2GDclj5ofokWjzoa5jAwMkxCykd6,5,6,3,0,1,0,1,0,11,1.5714285714285714,1,0.0,1,3,0,1,5,0,0,1,0,5,6,0
496,9672,Bi4hHmeTLwTbUCScu9tC6ZZN7frLUhVP,A3fsA9Zfv1X2fVEQhTw51lKENdNrEqT3,20,14,12,0,9,0,3,0,38,5.428571428571429,2,0.0,0,12,0,9,14,0,0,3,0,21,17,0
497,9783,CZfXDHVnNPClikyXrFzPhkQoFiILzXmF,SpATywNh6bZuzm8s1ceuBUnMUAeoAHHw,20,32,1,23,1,0,4,0,61,8.714285714285714,2,0.0,6,1,17,1,26,0,6,4,0,25,36,0
498,9784,WnYAypmYi03odcBC7NgJFsh1FzqrpNw6,SpATywNh6bZuzm8s1ceuBUnMUAeoAHHw,24,22,13,12,8,1,4,0,60,8.571428571428571,3,0.0,3,13,9,8,19,1,3,4,0,33,27,0
499,9790,yUvG5Vqh097epwWCIkZetr2ZlwvQRcLL,SpATywNh6bZuzm8s1ceuBUnMUAeoAHHw,25,34,0,12,2,0,7,0,55,7.857142857142857,3,0.0,12,0,12,2,22,0,0,7,0,26,29,0
500,9793,B2ahwtOo16YsNrAQ9LRd2yjP18Ni9l2c,SpATywNh6bZuzm8s1ceuBUnMUAeoAHHw,9,16,4,0,1,0,5,0,26,3.7142857142857144,4,0.0,0,4,0,1,16,0,0,5,0,5,21,0
501,9812,fARr9B8lZ63xDV7GkxAczvRhzY3xBLi6,RXDvfPUBYFlVdlueBFbLW0mhhAyGEqpt,21,19,6,0,5,5,3,0,38,5.428571428571429,2,0.0,0,6,0,5,19,5,0,3,0,11,27,1
502,9852,1wIqcRX58Bpw6RXvGnbxsc6WbPwWGwXd,SpATywNh6bZuzm8s1ceuBUnMUAeoAHHw,4,3,2,0,0,3,2,0,10,1.4285714285714286,1,0.0,0,2,0,0,3,3,0,2,0,2,8,0
503,9869,0RNr6P08D2zaPSoifoE3KvUeNCFcBSvA,SpATywNh6bZuzm8s1ceuBUnMUAeoAHHw,5,4,2,0,1,0,1,0,8,1.1428571428571428,1,0.0,0,2,0,1,4,0,0,1,0,3,5,0
504,9873,u4s0SPiIkynucY7ReF58TL89R2q4zw1x,SpATywNh6bZuzm8s1ceuBUnMUAeoAHHw,5,4,3,0,1,0,2,0,10,1.4285714285714286,1,0.0,0,3,0,1,4,0,0,2,0,4,6,1
505,9904,OfMabADNCpK7MfQ7IaqBsUw8RvPeHL0S,RXDvfPUBYFlVdlueBFbLW0mhhAyGEqpt,39,35,19,52,8,5,8,0,127,18.142857142857142,5,0.0,7,19,52,8,28,5,0,8,0,86,41,0
506,9928,ylxIxsQV8oDzYk1f9bdd1UWiUi1ODLbL,SpATywNh6bZuzm8s1ceuBUnMUAeoAHHw,17,15,1,13,1,1,13,1,45,6.428571428571429,4,0.0,3,1,10,1,12,1,3,13,1,15,30,0
507,9929,oaL3pbpAfEH9L4o42G6X4xjme1kXt2tm,SpATywNh6bZuzm8s1ceuBUnMUAeoAHHw,19,27,16,9,11,0,4,0,67,9.571428571428571,4,0.0,6,16,8,11,21,0,1,4,0,41,26,0
508,9943,KXKbDyPytrUZAnNaQjyZgMFkA2w3Wpvj,SpATywNh6bZuzm8s1ceuBUnMUAeoAHHw,20,33,19,16,8,33,11,0,120,17.142857142857142,3,0.0,2,19,14,8,31,33,2,11,0,43,77,1
509,9946,Jd5OP6GIsguRdsq9k3eSYNENmzhPbdGe,G8EPVSXsOYB5YQWZGiz1aVq5Pgr2GrQu,113,155,75,176,52,6,18,0,482,68.85714285714286,5,0.0,63,75,116,52,92,6,60,18,0,306,176,0
510,9949,IUn6MADAjAYkGlJisA1WiDvCeNlJd5Xd,SpATywNh6bZuzm8s1ceuBUnMUAeoAHHw,34,48,24,9,10,9,16,0,116,16.571428571428573,2,0.0,3,24,8,10,45,9,1,16,0,45,71,0
511,9963,YleydB3G0OM4jGw8hrXeA6aAbHfKvakN,SpATywNh6bZuzm8s1ceuBUnMUAeoAHHw,26,23,16,14,10,0,3,0,66,9.428571428571429,3,0.0,3,16,13,10,20,0,1,3,0,42,24,1
512,9988,GVRJN4wkoooaXJUVmwnX983A87KsrZPK,SpATywNh6bZuzm8s1ceuBUnMUAeoAHHw,8,8,3,9,0,13,2,0,35,5.0,2,0.0,3,3,8,0,5,13,1,2,0,14,21,0
513,10015,gFtSwrFBdsFWgLyqjSCzwaUhlQmEHgOq,SpATywNh6bZuzm8s1ceuBUnMUAeoAHHw,22,26,12,10,7,1,10,0,66,9.428571428571429,6,0.0,2,12,10,7,24,1,0,10,0,31,35,0
514,10016,5z0TnHJcRYhCDHjnNu4kmaWirO8lucwr,SpATywNh6bZuzm8s1ceuBUnMUAeoAHHw,4,3,2,0,0,0,1,0,6,0.8571428571428571,1,0.0,0,2,0,0,3,0,0,1,0,2,4,1
515,10024,FELnhQR0c7GZZX82ioYJEZsqujOrfyf7,bWdj2GDclj5ofokWjzoa5jAwMkxCykd6,3,0,0,0,0,1,2,0,3,0.42857142857142855,1,0.0,0,0,0,0,0,1,0,2,0,0,3,1
516,10035,FELnhQR0c7GZZX82ioYJEZsqujOrfyf7,A3fsA9Zfv1X2fVEQhTw51lKENdNrEqT3,5,2,1,0,0,0,3,0,6,0.8571428571428571,1,0.0,0,1,0,0,2,0,0,3,0,1,5,1
517,10059,UOOsauq1lFlLECbNF7MRjSfLxlpKxsoG,SpATywNh6bZuzm8s1ceuBUnMUAeoAHHw,8,5,3,7,0,0,5,0,20,2.857142857142857,1,0.0,2,3,7,0,3,0,0,5,0,12,8,0
518,10062,e0buQlxlHVWdQd03EOAehldJOI8AeFTm,SpATywNh6bZuzm8s1ceuBUnMUAeoAHHw,14,25,0,12,0,0,5,0,42,6.0,2,0.0,2,0,12,0,23,0,0,5,0,14,28,1
519,10101,30Velr3UVYghs85WZNOKXFcrgzOgBsfI,SpATywNh6bZuzm8s1ceuBUnMUAeoAHHw,6,6,3,0,1,2,2,0,14,2.0,2,0.0,0,3,0,1,6,2,0,2,0,4,10,0
520,10123,pAxOMca5gwJLembsUpWhZwow68Ox9dFB,SpATywNh6bZuzm8s1ceuBUnMUAeoAHHw,3,3,1,0,0,0,2,0,6,0.8571428571428571,2,0.0,0,1,0,0,3,0,0,2,0,1,5,0
521,10132,ILMhPMpEir8VP8Uy0NQI7guQFniKAiGh,SpATywNh6bZuzm8s1ceuBUnMUAeoAHHw,21,30,1,7,2,1,5,0,46,6.571428571428571,3,0.0,2,1,7,2,28,1,0,5,0,12,34,0
522,10149,KG1VMsurgFKqkMv9nVqkO9ppjva59kYw,SpATywNh6bZuzm8s1ceuBUnMUAeoAHHw,8,13,6,0,3,0,1,0,23,3.2857142857142856,1,0.0,2,6,0,3,11,0,0,1,0,11,12,0
523,10183,rf43ZHojMqXQ775bmX3nnHgQ62d9XvGK,SpATywNh6bZuzm8s1ceuBUnMUAeoAHHw,31,32,17,13,10,0,4,0,76,10.857142857142858,3,0.0,2,17,11,10,30,0,2,4,0,40,36,1
524,10188,2rS9ufrltSIJVkQHjlKCjTvqcoR7anzz,A3fsA9Zfv1X2fVEQhTw51lKENdNrEqT3,11,19,6,0,0,0,7,0,32,4.571428571428571,3,0.0,0,6,0,0,19,0,0,7,0,6,26,1
525,10189,sY8CcZG79KJSl2UAc47IiYJD1k5ghqCN,SpATywNh6bZuzm8s1ceuBUnMUAeoAHHw,4,4,2,0,0,0,2,0,8,1.1428571428571428,2,0.0,0,2,0,0,4,0,0,2,0,2,6,1
526,10197,tqvOTiQbipkIXQL7CIR5dckxV83rng9S,SpATywNh6bZuzm8s1ceuBUnMUAeoAHHw,27,44,22,26,12,19,16,0,139,19.857142857142858,7,0.0,12,22,25,12,32,19,1,16,0,71,68,0
527,10201,MB156dsmOWVhw7SmCPNYcmBUK9V54bIt,SpATywNh6bZuzm8s1ceuBUnMUAeoAHHw,10,21,1,6,0,9,11,0,48,6.857142857142857,3,0.0,3,1,6,0,18,9,0,11,0,10,38,1
528,10217,VWRhwnsbyy7kINpd5Pldlp01a86tVlAt,SpATywNh6bZuzm8s1ceuBUnMUAeoAHHw,15,13,11,0,7,0,2,0,33,4.714285714285714,2,0.0,0,11,0,7,13,0,0,2,0,18,15,0
529,10220,L4Uo99RvQ1cxFdSSaMag731dHicuHxV2,SpATywNh6bZuzm8s1ceuBUnMUAeoAHHw,25,45,2,30,0,0,10,0,87,12.428571428571429,7,0.0,6,2,25,0,39,0,5,10,0,33,54,0
530,10241,7kTdvih7UMOiFKC9aXRp88JppGP4qSKH,G8EPVSXsOYB5YQWZGiz1aVq5Pgr2GrQu,5,6,3,0,1,0,2,0,12,1.7142857142857142,1,0.0,0,3,0,1,6,0,0,2,0,4,8,1
531,10243,YdCaKimqYb8kuFiHEtjPDsCbtIch1tfO,SpATywNh6bZuzm8s1ceuBUnMUAeoAHHw,10,18,7,11,0,6,6,7,55,7.857142857142857,4,0.0,7,7,9,0,11,6,2,6,7,23,32,0
532,10266,8Q42Hi4bJP7SqbH4XystURHk2B8tBI5i,G8EPVSXsOYB5YQWZGiz1aVq5Pgr2GrQu,55,23,16,139,9,0,3,0,190,27.142857142857142,2,0.0,3,16,118,9,20,0,21,3,0,146,44,0
533,10321,njb10SfHXKB30cApzPJzWBcqA8VQx0HA,A3fsA9Zfv1X2fVEQhTw51lKENdNrEqT3,5,2,1,0,1,0,3,0,7,1.0,1,0.0,0,1,0,1,2,0,0,3,0,2,5,1
534,10345,cRvonGDWMKfxHYP6TdkGqL61F16M4yAA,SpATywNh6bZuzm8s1ceuBUnMUAeoAHHw,5,5,2,0,1,0,0,0,8,1.1428571428571428,1,0.0,0,2,0,1,5,0,0,0,0,3,5,1
535,10385,4SjsVB9NX97jh5FCSnOdHgEUANJ1svZm,SpATywNh6bZuzm8s1ceuBUnMUAeoAHHw,24,18,13,8,8,0,6,1,54,7.714285714285714,2,0.0,2,13,8,8,16,0,0,6,1,31,23,0
536,10394,EF3EfvSrA0c1KnpZ3bhY87a1rscondwY,SpATywNh6bZuzm8s1ceuBUnMUAeoAHHw,15,14,13,0,10,0,1,0,38,5.428571428571429,1,0.0,0,13,0,10,14,0,0,1,0,23,15,0
537,10437,N0P6Yrg1zRuUPyVufFpM0ZExnJnGTKKG,SpATywNh6bZuzm8s1ceuBUnMUAeoAHHw,11,8,5,14,3,0,1,0,31,4.428571428571429,1,0.0,2,5,11,3,6,0,3,1,0,21,10,0
538,10445,wXYPFlL861BbeAt6BcFbVApC7BUFADjk,A3fsA9Zfv1X2fVEQhTw51lKENdNrEqT3,21,42,4,32,2,0,5,0,85,12.142857142857142,3,0.0,3,4,25,2,39,0,7,5,0,34,51,1
539,10471,l7T8dOWG1cEtOxAxVcD5zNV6vn1g4oYM,G8EPVSXsOYB5YQWZGiz1aVq5Pgr2GrQu,1,0,0,0,0,0,2,0,2,0.2857142857142857,2,0.0,0,0,0,0,0,0,0,2,0,0,2,1
540,10507,rf43ZHojMqXQ775bmX3nnHgQ62d9XvGK,bWdj2GDclj5ofokWjzoa5jAwMkxCykd6,3,2,1,0,0,0,3,0,6,0.8571428571428571,1,0.0,0,1,0,0,2,0,0,3,0,1,5,0
541,10525,w8NGfLpAxSvlcPdxr1N6ClRtnCD7UkJu,A3fsA9Zfv1X2fVEQhTw51lKENdNrEqT3,50,6,1,175,0,0,12,1,195,27.857142857142858,3,0.0,2,1,155,0,4,0,20,12,1,158,37,0
542,10563,IQCtPVNPylpjpNjZtQrr88vV5qPansN0,SpATywNh6bZuzm8s1ceuBUnMUAeoAHHw,30,29,20,11,12,0,3,0,75,10.714285714285714,1,0.0,2,20,9,12,27,0,2,3,0,43,32,0
543,10569,54BZa2PEVowNqI6EO6NzeCnkR49ry3oS,SpATywNh6bZuzm8s1ceuBUnMUAeoAHHw,17,29,0,13,0,0,4,0,46,6.571428571428571,3,0.0,5,0,10,0,24,0,3,4,0,15,31,0
544,10574,NFgPnsok64XIrx8pioLRAIHoliaoDIvn,SpATywNh6bZuzm8s1ceuBUnMUAeoAHHw,17,17,5,20,1,0,10,0,53,7.571428571428571,4,0.0,6,5,16,1,11,0,4,10,0,28,25,0
545,10579,QoRl6lUIBIR1pRLScf6eg36kOBc6a9q5,SpATywNh6bZuzm8s1ceuBUnMUAeoAHHw,2,0,0,0,0,0,3,0,3,0.42857142857142855,1,0.0,0,0,0,0,0,0,0,3,0,0,3,1
546,10612,BTSZE2PXdA7MkOyBKPCnqqHRa0lxJtHO,SpATywNh6bZuzm8s1ceuBUnMUAeoAHHw,21,51,2,14,2,4,9,0,82,11.714285714285714,4,0.0,9,2,11,2,42,4,3,9,0,24,58,0
547,10629,okYlHVritwXcHhkiNLd9pfhBZv2uubiO,SpATywNh6bZuzm8s1ceuBUnMUAeoAHHw,29,25,15,14,11,0,5,0,70,10.0,2,0.0,5,15,12,11,20,0,2,5,0,43,27,1
548,10641,Q5TmTVdy8nnH2vTL73s67ZseaCMO3k91,SpATywNh6bZuzm8s1ceuBUnMUAeoAHHw,9,5,3,12,2,0,4,0,26,3.7142857142857144,2,0.0,2,3,11,2,3,0,1,4,0,18,8,0
549,10652,teqJGecOr4a6oVYU1O9bgvPkX5ZSKA8N,SpATywNh6bZuzm8s1ceuBUnMUAeoAHHw,28,45,8,27,4,0,5,0,89,12.714285714285714,5,0.0,8,8,23,4,37,0,4,5,0,43,46,0
550,10653,7xJbwgQFzeH69YJLbZncWAGT3dRrKubC,bWdj2GDclj5ofokWjzoa5jAwMkxCykd6,32,30,17,76,9,34,11,1,178,25.428571428571427,3,0.0,8,17,63,9,22,34,13,11,1,97,81,0
551,10705,CeupRRMHE9iQJGvyrBKaDsPPM9lhEl5t,SpATywNh6bZuzm8s1ceuBUnMUAeoAHHw,18,23,1,11,1,0,4,0,40,5.714285714285714,2,0.0,4,1,9,1,19,0,2,4,0,15,25,0
552,10808,8dXlYKMlojZ10oWsfo0feSv9eUr2FQcM,G8EPVSXsOYB5YQWZGiz1aVq5Pgr2GrQu,33,64,37,0,29,0,17,1,148,21.142857142857142,6,0.0,12,37,0,29,52,0,0,17,1,78,70,1
553,10809,gzv7fk7jLAAb6tXwbmA5ceisqqnvcETz,SpATywNh6bZuzm8s1ceuBUnMUAeoAHHw,4,3,2,0,0,0,1,0,6,0.8571428571428571,1,0.0,0,2,0,0,3,0,0,1,0,2,4,0
554,10823,aGY42WVQQtCQKQRks3knIxGWrLxCy60h,G8EPVSXsOYB5YQWZGiz1aVq5Pgr2GrQu,3,0,0,0,0,4,2,0,6,0.8571428571428571,1,0.0,0,0,0,0,0,4,0,2,0,0,6,1
555,10853,2uZ2ZHQBnnVrb5vAtTu1AloVYtZL1MXg,G8EPVSXsOYB5YQWZGiz1aVq5Pgr2GrQu,106,202,49,147,17,8,35,4,462,66.0,8,0.0,9,49,119,17,193,8,28,35,4,194,268,0
556,10876,4vKI2gaXrHATS50fqVyDxXcmRy0MrgJS,A3fsA9Zfv1X2fVEQhTw51lKENdNrEqT3,1,0,0,0,0,0,1,0,1,0.14285714285714285,1,0.0,0,0,0,0,0,0,0,1,0,0,1,1
557,10891,L5fA3BAe6FOUhd5mq4cXOYYHxtSuGgKM,SpATywNh6bZuzm8s1ceuBUnMUAeoAHHw,16,18,12,0,7,0,4,0,41,5.857142857142857,3,0.0,3,12,0,7,15,0,0,4,0,22,19,0
558,10917,Bf9it9d08iLIslwAMDaZjQzh1Kdl2qhf,SpATywNh6bZuzm8s1ceuBUnMUAeoAHHw,7,9,0,14,0,0,2,0,25,3.5714285714285716,2,0.0,4,0,11,0,5,0,3,2,0,15,10,0
559,10922,Bf9it9d08iLIslwAMDaZjQzh1Kdl2qhf,A3fsA9Zfv1X2fVEQhTw51lKENdNrEqT3,7,7,0,0,0,0,4,0,11,1.5714285714285714,2,0.0,0,0,0,0,7,0,0,4,0,0,11,0
560,10955,rieeUlMbLxJ13UbEQlJjvhM4prlyBS6B,SpATywNh6bZuzm8s1ceuBUnMUAeoAHHw,22,38,14,12,7,23,13,0,107,15.285714285714286,5,0.0,10,14,11,7,28,23,1,13,0,42,65,0
561,10990,xxd1UUpRh1yQGgGLMyjshPknKZCNEYlg,A3fsA9Zfv1X2fVEQhTw51lKENdNrEqT3,64,64,31,118,15,3,13,1,245,35.0,7,0.0,4,31,91,15,60,3,27,13,1,141,104,0
562,11001,4vKI2gaXrHATS50fqVyDxXcmRy0MrgJS,bWdj2GDclj5ofokWjzoa5jAwMkxCykd6,13,17,8,0,2,1,18,2,48,6.857142857142857,3,0.0,2,8,0,2,15,1,0,18,2,12,36,0
563,11029,1PM9jc7cZ3C091LId9Ek5VaVwRreQ0TH,A3fsA9Zfv1X2fVEQhTw51lKENdNrEqT3,1,0,0,0,0,0,1,0,1,0.14285714285714285,1,0.0,0,0,0,0,0,0,0,1,0,0,1,1
564,11036,0kTYCEXFiuNuYfSpCOb8HIL3aF9nkrGc,SpATywNh6bZuzm8s1ceuBUnMUAeoAHHw,21,26,18,11,5,1,9,0,70,10.0,5,0.0,2,18,9,5,24,1,2,9,0,34,36,0
565,11092,WFURYJe5F7dgP6i0YwgNFeyKSFpNu7xS,A3fsA9Zfv1X2fVEQhTw51lKENdNrEqT3,13,7,6,0,5,0,1,0,19,2.7142857142857144,1,0.0,0,6,0,5,7,0,0,1,0,11,8,1
566,11103,hGRsAtrDXcgCObVXPjFeCVGCoNSaOPeW,SpATywNh6bZuzm8s1ceuBUnMUAeoAHHw,3,2,1,0,0,0,1,0,4,0.5714285714285714,1,0.0,0,1,0,0,2,0,0,1,0,1,3,1
567,11104,hGRsAtrDXcgCObVXPjFeCVGCoNSaOPeW,G8EPVSXsOYB5YQWZGiz1aVq5Pgr2GrQu,3,2,1,0,0,0,1,0,4,0.5714285714285714,1,0.0,0,1,0,0,2,0,0,1,0,1,3,1
568,11165,xebgVIBazn8SEoqG6RUzBHRE4EbzaN4t,A3fsA9Zfv1X2fVEQhTw51lKENdNrEqT3,1,0,0,0,0,0,1,0,1,0.14285714285714285,1,0.0,0,0,0,0,0,0,0,1,0,0,1,1
569,11179,gryVUwWLvrsNv4F8O3kiEBAQILnJg7OT,SpATywNh6bZuzm8s1ceuBUnMUAeoAHHw,7,7,0,3,0,0,3,0,13,1.8571428571428572,1,0.0,2,0,3,0,5,0,0,3,0,5,8,0
570,11198,HbdIEiZ1jslj2pBp8czn7lhBbxLYjtpj,SpATywNh6bZuzm8s1ceuBUnMUAeoAHHw,5,5,3,0,1,0,2,0,11,1.5714285714285714,2,0.0,0,3,0,1,5,0,0,2,0,4,7,1
571,11225,Vmvdv9k8S1ONPkUHSdXPEenyx7UNVISW,SpATywNh6bZuzm8s1ceuBUnMUAeoAHHw,29,44,0,34,0,14,7,2,101,14.428571428571429,1,0.0,23,0,32,0,21,14,2,7,2,55,46,1
572,11355,Z5t6AGEyADeSVHWZTgBW4lR5XMnM5VWU,SpATywNh6bZuzm8s1ceuBUnMUAeoAHHw,16,18,8,17,6,0,2,0,51,7.285714285714286,1,0.0,8,8,14,6,10,0,3,2,0,36,15,0
573,11410,YEYkPWHcftKd8bKe1Q9b21lzhv1SChRM,SpATywNh6bZuzm8s1ceuBUnMUAeoAHHw,10,6,4,0,3,0,1,0,14,2.0,1,0.0,0,4,0,3,6,0,0,1,0,7,7,1
574,11425,82UlWF6Fm1gkNum7nNbVw0yOV1BUdNoS,bWdj2GDclj5ofokWjzoa5jAwMkxCykd6,8,13,7,0,1,2,6,0,29,4.142857142857143,3,0.0,1,7,0,1,12,2,0,6,0,9,20,0
575,11428,82UlWF6Fm1gkNum7nNbVw0yOV1BUdNoS,A3fsA9Zfv1X2fVEQhTw51lKENdNrEqT3,51,41,35,16,24,1,9,0,126,18.0,5,0.0,0,35,13,24,41,1,3,9,0,72,54,0
576,11463,uFcd6yCTniScAvbMiWJYRQ8Du52ubELm,RXDvfPUBYFlVdlueBFbLW0mhhAyGEqpt,1,0,0,0,0,0,1,0,1,0.14285714285714285,1,0.0,0,0,0,0,0,0,0,1,0,0,1,0
577,11475,UJiJ4PvH4qodyDnURbFXyi5LWwaSKUwb,RXDvfPUBYFlVdlueBFbLW0mhhAyGEqpt,43,58,35,88,19,5,26,0,231,33.0,7,0.0,13,35,81,19,45,5,7,26,0,148,83,0
578,11478,RGf4k3THi4AV4qsAjc1UEOWiIeDYcchf,A3fsA9Zfv1X2fVEQhTw51lKENdNrEqT3,25,39,19,44,6,8,10,0,126,18.0,7,0.0,3,19,37,6,36,8,7,10,0,65,61,0
579,11515,iIwpETh60BkJfJQJqvWucH2tzh64j0U3,SpATywNh6bZuzm8s1ceuBUnMUAeoAHHw,27,19,12,4,9,0,2,0,46,6.571428571428571,2,0.0,2,12,4,9,17,0,0,2,0,27,19,0
580,11522,MOJ1BiwMK7lBUiFS9DTwwPvbUWIkdFFP,A3fsA9Zfv1X2fVEQhTw51lKENdNrEqT3,1,0,0,0,0,0,5,0,5,0.7142857142857143,3,0.0,0,0,0,0,0,0,0,5,0,0,5,1
581,11547,NKnL5oTIIxOmPf0Ep5iKaKIecNheR2t7,SpATywNh6bZuzm8s1ceuBUnMUAeoAHHw,18,12,8,10,5,0,3,0,38,5.428571428571429,1,0.0,3,8,7,5,9,0,3,3,0,23,15,0
582,11555,7OkCZWJW1Ow4wpTBUq53amL13pV2vy2v,G8EPVSXsOYB5YQWZGiz1aVq5Pgr2GrQu,5,7,3,0,1,0,3,0,14,2.0,1,0.0,0,3,0,1,7,0,0,3,0,4,10,0
583,11618,FftGEmgyFF5pWtfM0EZJwp0rzcGMH1JL,SpATywNh6bZuzm8s1ceuBUnMUAeoAHHw,8,5,3,0,3,0,5,0,16,2.2857142857142856,2,0.0,2,3,0,3,3,0,0,5,0,8,8,1
584,11636,Y3uwxWCm13Ol5xozrT2GPjOPhBlC2kOq,RXDvfPUBYFlVdlueBFbLW0mhhAyGEqpt,47,45,2,123,0,0,2,0,172,24.571428571428573,3,0.0,11,2,114,0,34,0,9,2,0,127,45,1
585,11677,FduexGuoL0tC7LqIuSFtIm03lXvHHbSw,SpATywNh6bZuzm8s1ceuBUnMUAeoAHHw,6,7,0,0,0,0,4,0,11,1.5714285714285714,1,0.0,0,0,0,0,7,0,0,4,0,0,11,1
586,11690,37daqGAbA6x2VvXkiqdWX1nBv2Tqqgte,G8EPVSXsOYB5YQWZGiz1aVq5Pgr2GrQu,74,160,98,122,44,7,20,1,452,64.57142857142857,6,0.0,0,98,102,44,160,7,20,20,1,244,208,0
587,11811,YRnTGuoAQA7UM3uV59YNXUYN4n1CR9jv,SpATywNh6bZuzm8s1ceuBUnMUAeoAHHw,17,10,7,5,5,0,1,0,28,4.0,1,0.0,2,7,5,5,8,0,0,1,0,19,9,0
588,11841,4GMbKnTV7f2uA3paM09GNAdyVnypDTbs,A3fsA9Zfv1X2fVEQhTw51lKENdNrEqT3,31,15,2,50,2,0,5,0,74,10.571428571428571,3,0.0,1,2,49,2,14,0,1,5,0,54,20,0
589,11892,QkpDyGn4qqqwpxvXRrFsAsKSrEtfkQJQ,SpATywNh6bZuzm8s1ceuBUnMUAeoAHHw,4,3,2,0,0,0,1,0,6,0.8571428571428571,1,0.0,0,2,0,0,3,0,0,1,0,2,4,0
590,11895,Er0phLmicWoU9yr3sUBC2BCne0YIK1vQ,A3fsA9Zfv1X2fVEQhTw51lKENdNrEqT3,39,22,19,0,18,0,2,0,61,8.714285714285714,1,0.0,0,19,0,18,22,0,0,2,0,37,24,1
591,11900,8xT75XL9dKm7CwLmOxtys3bmWBh3OJmY,RXDvfPUBYFlVdlueBFbLW0mhhAyGEqpt,113,100,49,213,15,16,11,1,405,57.857142857142854,4,0.0,23,49,201,15,77,16,12,11,1,288,117,0
592,11914,5YO2NGkR6BZ1s4HfeOrLezgFkpBKmNPV,SpATywNh6bZuzm8s1ceuBUnMUAeoAHHw,8,6,4,0,2,0,2,0,14,2.0,1,0.0,0,4,0,2,6,0,0,2,0,6,8,0
593,11921,JERgMmFADxaPxEUdcYHhaMN4ZwNAyErv,A3fsA9Zfv1X2fVEQhTw51lKENdNrEqT3,33,27,14,84,7,0,7,0,139,19.857142857142858,2,0.0,1,14,73,7,26,0,11,7,0,95,44,0
594,11922,gKme5KJOgqJrjNwDUsRPKwK3QFyN7vPD,RXDvfPUBYFlVdlueBFbLW0mhhAyGEqpt,49,55,34,90,11,2,17,0,209,29.857142857142858,7,0.0,10,34,88,11,45,2,2,17,0,143,66,0
595,11977,JtbtRyqX4dZ0edFKFJwGNY9JG3aidrlj,SpATywNh6bZuzm8s1ceuBUnMUAeoAHHw,13,10,8,0,6,0,4,0,28,4.0,2,0.0,0,8,0,6,10,0,0,4,0,14,14,0
596,12011,q36eiA77bwwsXGg05ifhgnTFDpR9Ar4V,bWdj2GDclj5ofokWjzoa5jAwMkxCykd6,36,56,27,90,10,15,10,1,209,29.857142857142858,6,0.0,11,27,81,10,45,15,9,10,1,129,80,0
597,12053,7m381KBoEq7nybFxitllQlgHOa7YYR1i,SpATywNh6bZuzm8s1ceuBUnMUAeoAHHw,17,64,15,16,6,0,4,0,105,15.0,5,0.0,8,15,13,6,56,0,3,4,0,42,63,0
598,12147,VJw4zFdkpwcu4sXr2e3LyD2CU2ajLhIu,SpATywNh6bZuzm8s1ceuBUnMUAeoAHHw,11,12,6,0,2,0,6,0,26,3.7142857142857144,2,0.0,2,6,0,2,10,0,0,6,0,10,16,0
599,12203,TSpDTvH7tx13LMObu1OWRVwKh8isSitO,SpATywNh6bZuzm8s1ceuBUnMUAeoAHHw,6,5,2,0,1,0,2,0,10,1.4285714285714286,1,0.0,0,2,0,1,5,0,0,2,0,3,7,1
600,12208,dOjwcbpJoBEbemc7xmUKlO5o5THYYuWb,RXDvfPUBYFlVdlueBFbLW0mhhAyGEqpt,35,22,7,38,5,0,7,0,79,11.285714285714286,3,0.0,7,7,38,5,15,0,0,7,0,57,22,0
601,12253,Kxifrwa9ntGWJyRtJS6owg0ZQfSyRPcW,A3fsA9Zfv1X2fVEQhTw51lKENdNrEqT3,4,2,0,0,0,0,2,0,4,0.5714285714285714,1,0.0,0,0,0,0,2,0,0,2,0,0,4,0
602,12287,zZK4lWrYYn5bTLcjHRRO0XA8xNwpu7OT,RXDvfPUBYFlVdlueBFbLW0mhhAyGEqpt,14,6,3,20,3,0,2,0,34,4.857142857142857,1,0.0,3,3,20,3,3,0,0,2,0,29,5,0
603,12293,UxPdjVFzcqqJoB99RNTW4pwswAcQ32eZ,RXDvfPUBYFlVdlueBFbLW0mhhAyGEqpt,20,13,12,0,11,0,15,0,51,7.285714285714286,2,0.0,0,12,0,11,13,0,0,15,0,23,28,0
604,12330,9iGaqBGS5kkoXjLd87hUL2eIJMVUVKfU,A3fsA9Zfv1X2fVEQhTw51lKENdNrEqT3,22,14,6,116,0,0,6,0,142,20.285714285714285,1,0.0,2,6,93,0,12,0,23,6,0,101,41,0
605,12350,7m381KBoEq7nybFxitllQlgHOa7YYR1i,G8EPVSXsOYB5YQWZGiz1aVq5Pgr2GrQu,43,53,20,84,8,3,3,0,171,24.428571428571427,2,0.0,3,20,78,8,50,3,6,3,0,109,62,1
606,12356,GW78UVODV1oPxxynjXG1U7em3gdA8wQF,SpATywNh6bZuzm8s1ceuBUnMUAeoAHHw,4,8,0,0,0,1,2,0,11,1.5714285714285714,1,0.0,0,0,0,0,8,1,0,2,0,0,11,0
607,12383,7OkCZWJW1Ow4wpTBUq53amL13pV2vy2v,SpATywNh6bZuzm8s1ceuBUnMUAeoAHHw,23,40,14,20,10,0,7,0,91,13.0,2,0.0,17,14,16,10,23,0,4,7,0,57,34,0
608,12412,s24Qk0ZpAXR97ldBDtgP8DE6rT8or69U,SpATywNh6bZuzm8s1ceuBUnMUAeoAHHw,13,21,3,30,0,0,5,0,59,8.428571428571429,5,0.0,4,3,27,0,17,0,3,5,0,34,25,0
609,12445,CqxK3XGagGgLgWXJIkp8qfeo0SWv94XW,RXDvfPUBYFlVdlueBFbLW0mhhAyGEqpt,21,22,17,0,9,0,4,0,52,7.428571428571429,4,0.0,0,17,0,9,22,0,0,4,0,26,26,0
610,12464,NSrMJ69WS92LaJ6a09xOpViELCrjji8S,SpATywNh6bZuzm8s1ceuBUnMUAeoAHHw,15,17,2,6,2,13,3,0,43,6.142857142857143,2,0.0,1,2,5,2,16,13,1,3,0,10,33,0
611,12569,4Z7n4wdauhlOTY95FN6j39vUUWT0ZgYl,SpATywNh6bZuzm8s1ceuBUnMUAeoAHHw,10,9,6,0,4,0,2,0,21,3.0,2,0.0,0,6,0,4,9,0,0,2,0,10,11,1
612,12580,kB76SiSV4uYN77hHUOgf3IbLpFWkgJbj,SpATywNh6bZuzm8s1ceuBUnMUAeoAHHw,27,38,20,15,12,0,8,1,94,13.428571428571429,4,0.0,2,20,13,12,36,0,2,8,1,47,47,0
613,12583,JRuzCriX6hvuTQ943ttXKlmrFVyfxMHr,SpATywNh6bZuzm8s1ceuBUnMUAeoAHHw,24,28,10,31,5,2,3,1,80,11.428571428571429,1,0.0,16,10,25,5,12,2,6,3,1,56,24,0
614,12616,gLKRPeA7yYfxDrcYMLyblT6wVEjgwKPH,SpATywNh6bZuzm8s1ceuBUnMUAeoAHHw,20,67,11,16,5,0,12,0,111,15.857142857142858,5,0.0,24,11,13,5,43,0,3,12,0,53,58,0
615,12620,LxV8BE7SALs1WsK81jAFnmtwnc7yS8ck,G8EPVSXsOYB5YQWZGiz1aVq5Pgr2GrQu,9,8,6,2,2,0,2,0,20,2.857142857142857,1,0.0,1,6,2,2,7,0,0,2,0,11,9,1
616,12649,TexDHGk8F5I6X0NlqVQwzJ9MMWpLdMbB,SpATywNh6bZuzm8s1ceuBUnMUAeoAHHw,18,14,9,16,6,0,3,0,48,6.857142857142857,3,0.0,3,9,13,6,11,0,3,3,0,31,17,0
617,12707,Hr9mm3bIoeLv4wyDeAcwJNdd3K6mgRy4,SpATywNh6bZuzm8s1ceuBUnMUAeoAHHw,34,24,15,31,10,0,3,0,83,11.857142857142858,2,0.0,7,15,28,10,17,0,3,3,0,60,23,0
618,12742,arTGhRrKZksM4iY72XDJ8i8oBmMABS0m,SpATywNh6bZuzm8s1ceuBUnMUAeoAHHw,23,47,5,5,0,3,12,0,72,10.285714285714286,6,0.0,7,5,5,0,40,3,0,12,0,17,55,0
619,12745,rRt0QHymEdl6Kph5VPgdVUvepB7ZBNXt,SpATywNh6bZuzm8s1ceuBUnMUAeoAHHw,29,73,13,24,5,0,3,0,118,16.857142857142858,2,0.0,17,13,21,5,56,0,3,3,0,56,62,0
620,12750,i67qzouvUD7nINgK6d1xrH4pvufZqbFd,SpATywNh6bZuzm8s1ceuBUnMUAeoAHHw,23,30,0,28,0,6,7,0,71,10.142857142857142,4,0.0,9,0,22,0,21,6,6,7,0,31,40,0
621,12753,79Po0Awyh8Z7ruF9y6agajWClv9uUoPL,SpATywNh6bZuzm8s1ceuBUnMUAeoAHHw,5,5,0,0,1,0,1,0,7,1.0,1,0.0,0,0,0,1,5,0,0,1,0,1,6,1
622,12761,rtYqtRTnqUXb6diSp0MKjdA0eLt2BJ3X,SpATywNh6bZuzm8s1ceuBUnMUAeoAHHw,33,27,19,15,11,8,5,0,85,12.142857142857142,3,0.0,5,19,14,11,22,8,1,5,0,49,36,0
623,12813,L3khlyhxkzKPVeEgnV2Dt5jl6Pe5Thm4,RXDvfPUBYFlVdlueBFbLW0mhhAyGEqpt,8,12,5,0,3,0,1,0,21,3.0,1,0.0,6,5,0,3,6,0,0,1,0,14,7,1
624,12883,KKz5C2CIERGp4d0g7P8ZO1hnR4NT39t2,SpATywNh6bZuzm8s1ceuBUnMUAeoAHHw,20,12,7,9,5,1,5,3,42,6.0,1,0.0,4,7,8,5,8,1,1,5,3,24,18,0
625,12948,f7pgA2Hp0s8DkqzKuvE0Kw8QRuoBh3Zv,A3fsA9Zfv1X2fVEQhTw51lKENdNrEqT3,12,4,2,18,0,0,1,0,25,3.5714285714285716,1,0.0,0,2,17,0,4,0,1,1,0,19,6,0
626,12956,lEIFkqeT396JMSPUyiaHNMN8g7bQ1x9p,SpATywNh6bZuzm8s1ceuBUnMUAeoAHHw,18,29,12,9,8,0,7,0,65,9.285714285714286,2,0.0,12,12,8,8,17,0,1,7,0,40,25,0
627,12976,KpbHdGVlZIWVraCiFee7Cav2rNnqqrsJ,SpATywNh6bZuzm8s1ceuBUnMUAeoAHHw,18,19,8,5,8,0,3,0,43,6.142857142857143,1,0.0,2,8,5,8,17,0,0,3,0,23,20,1
628,12993,8r4M2l7ATXMXEQUCAknekZVeyUGIpRyK,SpATywNh6bZuzm8s1ceuBUnMUAeoAHHw,6,14,0,0,0,0,6,0,20,2.857142857142857,2,0.0,0,0,0,0,14,0,0,6,0,0,20,1
629,13023,MAktGJIumyskhJp25e79u9tVhauVJ2c6,SpATywNh6bZuzm8s1ceuBUnMUAeoAHHw,15,13,0,12,0,1,4,0,30,4.285714285714286,2,0.0,2,0,11,0,11,1,1,4,0,13,17,0
630,13135,nF3fyodzvP9Kt8uvHxBDafFDSHuZ38jd,SpATywNh6bZuzm8s1ceuBUnMUAeoAHHw,11,36,3,0,3,0,3,0,45,6.428571428571429,2,0.0,0,3,0,3,36,0,0,3,0,6,39,1
631,13143,igeK6rUQT7Ehyj7yY5oAEj8DvOITiuBO,SpATywNh6bZuzm8s1ceuBUnMUAeoAHHw,6,11,3,0,0,0,4,0,18,2.5714285714285716,2,0.0,0,3,0,0,11,0,0,4,0,3,15,0
632,13207,PMDa1SUjeddLyhfDscbnAxL67GyZb6sD,SpATywNh6bZuzm8s1ceuBUnMUAeoAHHw,14,54,29,8,0,0,19,0,110,15.714285714285714,4,0.0,3,29,8,0,51,0,0,19,0,40,70,0
633,13227,0wJhtCWK60WPCeRF62m8T80DtNpWhRrg,RXDvfPUBYFlVdlueBFbLW0mhhAyGEqpt,20,20,7,38,4,0,1,0,70,10.0,1,0.0,6,7,35,4,14,0,3,1,0,52,18,0
634,13240,m52orXncJIuZMWO7LnwS1hFqDU5X5m24,SpATywNh6bZuzm8s1ceuBUnMUAeoAHHw,19,20,12,10,11,0,13,0,66,9.428571428571429,3,0.0,2,12,10,11,18,0,0,13,0,35,31,0
635,13338,UidTeyEs50r1zTQVJtstLvLcMUKrNN3b,SpATywNh6bZuzm8s1ceuBUnMUAeoAHHw,9,30,1,0,0,0,8,0,39,5.571428571428571,4,0.0,0,1,0,0,30,0,0,8,0,1,38,0
636,13358,Aw7PeIkLW9CDHbPpPSjrFUdtBaUuHUXm,bWdj2GDclj5ofokWjzoa5jAwMkxCykd6,20,12,6,35,4,0,14,0,71,10.142857142857142,5,0.0,3,6,32,4,9,0,3,14,0,45,26,0
637,13398,bqWpav7ocOhCfb3xc4QgAvBDK5g8BmiZ,SpATywNh6bZuzm8s1ceuBUnMUAeoAHHw,3,2,1,0,0,0,1,0,4,0.5714285714285714,1,0.0,0,1,0,0,2,0,0,1,0,1,3,0
638,13430,j0gxXks7DZitzyeEGG2agLKFp30HqXVu,bWdj2GDclj5ofokWjzoa5jAwMkxCykd6,11,40,16,0,0,0,4,0,60,8.571428571428571,3,0.0,9,16,0,0,31,0,0,4,0,25,35,0
639,13491,KKBYOCb35hszQy5vSfsxbAFYFgilEECF,SpATywNh6bZuzm8s1ceuBUnMUAeoAHHw,7,4,4,0,4,0,2,0,14,2.0,1,0.0,0,4,0,4,4,0,0,2,0,8,6,1
640,13518,OcFLLEI56U80V98vNeJ7LrlE5FWxkkpp,SpATywNh6bZuzm8s1ceuBUnMUAeoAHHw,36,38,20,31,11,38,11,4,153,21.857142857142858,3,0.0,10,20,28,11,28,38,3,11,4,69,84,0
641,13578,7XgWWxsOrwxcFjioh5NncRGrx77dSS5r,SpATywNh6bZuzm8s1ceuBUnMUAeoAHHw,8,32,5,0,6,0,7,0,50,7.142857142857143,6,0.0,0,5,0,6,32,0,0,7,0,11,39,0
642,13605,g2crr0D1YRZspeg3aG0QVrkBBPBltTjz,SpATywNh6bZuzm8s1ceuBUnMUAeoAHHw,2,1,1,0,0,0,0,0,2,0.2857142857142857,1,0.0,0,1,0,0,1,0,0,0,0,1,1,0
643,13610,r10mjNLAOjkXo9ipKqWrD4Hts48L6lcD,G8EPVSXsOYB5YQWZGiz1aVq5Pgr2GrQu,7,4,3,0,2,0,0,0,9,1.2857142857142858,1,0.0,0,3,0,2,4,0,0,0,0,5,4,0
644,13684,XkKS323fFxBVezQ5JyIgzxHDxEKEwwEf,A3fsA9Zfv1X2fVEQhTw51lKENdNrEqT3,78,19,11,142,2,0,2,0,176,25.142857142857142,1,0.0,6,11,142,2,13,0,0,2,0,161,15,0
645,13751,wfHTtk8oy0CiP4p3waBMhlIvxeVIbZqk,SpATywNh6bZuzm8s1ceuBUnMUAeoAHHw,21,19,14,9,9,5,9,0,65,9.285714285714286,4,0.0,2,14,8,9,17,5,1,9,0,33,32,0
646,13764,fdJXQSSucuzaRljy096jXgInnW2TakHQ,SpATywNh6bZuzm8s1ceuBUnMUAeoAHHw,5,5,3,0,0,0,2,0,10,1.4285714285714286,2,0.0,0,3,0,0,5,0,0,2,0,3,7,0
647,13780,EikisME12XnhqTfgnKK3O8hmfAWTmSd3,G8EPVSXsOYB5YQWZGiz1aVq5Pgr2GrQu,9,10,2,0,1,0,3,0,16,2.2857142857142856,2,0.0,0,2,0,1,10,0,0,3,0,3,13,0
648,14620,7FtUWtWtOf3nOZgatsCqg5hskFNeytpp,5X6FeZozNMgE2VRi3MJYjkkFK8SETtu2,8,8,2,0,1,0,7,1,19,2.7142857142857144,2,0.0,0,2,0,1,8,0,0,7,1,3,16,1
649,14657,MuqCMckJZvG1cCcSC2ZsOM3AWWpLrBZR,5X6FeZozNMgE2VRi3MJYjkkFK8SETtu2,12,15,5,11,6,0,7,1,45,6.428571428571429,3,0.0,6,5,9,6,9,0,2,7,1,26,19,0
650,14666,XF97rGqdAZjCQ3lABhhTnQ0vkqCZZ88w,5X6FeZozNMgE2VRi3MJYjkkFK8SETtu2,3,2,0,0,0,0,1,0,3,0.42857142857142855,1,0.0,0,0,0,0,2,0,0,1,0,0,3,1
651,14683,EK8cH2rqaeWCMjTFz8xL65N7r32HerY9,7GRhBDsirIGkRZBtSMEzNTyDr2JQm4xx,26,43,16,35,12,11,1,0,118,16.857142857142858,1,0.0,22,16,27,12,21,11,8,1,0,77,41,0
652,14690,ZbWUV0qkotaaSLhz8iJBNOk5nD7qDeuY,7GRhBDsirIGkRZBtSMEzNTyDr2JQm4xx,9,13,4,2,7,0,2,0,28,4.0,2,0.0,7,4,2,7,6,0,0,2,0,20,8,0
653,14695,bR8Yt9wBqkSt4bNAyLqdLvjmoEdtlwOY,5X6FeZozNMgE2VRi3MJYjkkFK8SETtu2,55,115,14,54,25,0,3,0,211,30.142857142857142,6,0.0,41,14,51,25,74,0,3,3,0,131,80,1
654,14749,ay8UWPLvleTCjZbhX0m45MeC9HVyUsC1,5X6FeZozNMgE2VRi3MJYjkkFK8SETtu2,22,27,2,21,8,1,13,3,75,10.714285714285714,3,0.0,16,2,19,8,11,1,2,13,3,45,30,1
655,14990,5VgPwWusKQIJc1LutXp6JyAv3fzKgfIX,7GRhBDsirIGkRZBtSMEzNTyDr2JQm4xx,3,3,1,0,0,0,1,0,5,0.7142857142857143,2,0.0,0,1,0,0,3,0,0,1,0,1,4,1
656,15016,yZ9FndAKqVsKwZtO1B2JJJblefdbhZ02,7GRhBDsirIGkRZBtSMEzNTyDr2JQm4xx,7,4,2,4,0,0,3,0,13,1.8571428571428572,1,0.0,2,2,2,0,2,0,2,3,0,6,7,1
657,15029,R4o6u8M88d4gp68vTiRfI0Gudy4UPyor,5X6FeZozNMgE2VRi3MJYjkkFK8SETtu2,52,111,6,158,23,6,13,1,318,45.42857142857143,3,0.0,46,6,132,23,65,6,26,13,1,207,111,0
658,15158,6nI0LAabOD8mpYbsk0fkK8B83pTINX0v,5X6FeZozNMgE2VRi3MJYjkkFK8SETtu2,8,24,9,2,8,0,5,0,48,6.857142857142857,4,0.0,8,9,2,8,16,0,0,5,0,27,21,0
659,15164,ziRAzdRuzlLfb854mAvEaRYGuXqnCERH,7GRhBDsirIGkRZBtSMEzNTyDr2JQm4xx,47,102,38,58,37,40,12,0,287,41.0,3,0.0,56,38,51,37,46,40,7,12,0,182,105,0
660,15178,28PHU9suTM8EqUKsQwsvQ03DzFXi0yDl,7GRhBDsirIGkRZBtSMEzNTyDr2JQm4xx,29,37,15,50,11,1,6,0,120,17.142857142857142,3,0.0,16,15,38,11,21,1,12,6,0,80,40,0
661,15353,zv1MTlqEl4Nw73cGpyMcdRKThLliUAlA,5X6FeZozNMgE2VRi3MJYjkkFK8SETtu2,6,5,2,0,1,0,4,0,12,1.7142857142857142,2,0.0,0,2,0,1,5,0,0,4,0,3,9,1
662,15445,hrmgRr5TKkTKcJMaNH4IpBZoiQT9X6aI,7GRhBDsirIGkRZBtSMEzNTyDr2JQm4xx,11,23,2,0,6,0,2,0,33,4.714285714285714,2,0.0,14,2,0,6,9,0,0,2,0,22,11,0
663,15463,IkoiWVr2ygCLdZNh2Bkmtx3mmgIErIzY,5X6FeZozNMgE2VRi3MJYjkkFK8SETtu2,1,0,0,0,0,0,1,0,1,0.14285714285714285,1,0.0,0,0,0,0,0,0,0,1,0,0,1,1
664,15484,2OBbYlHxjDvtkcifhxwhxMZlYPhEHOro,7GRhBDsirIGkRZBtSMEzNTyDr2JQm4xx,22,23,3,54,0,0,7,0,87,12.428571428571429,5,0.0,9,3,47,0,14,0,7,7,0,59,28,0
665,15540,UuDjs68Ty88iPLGMXsqZ9bEqUXmWG3bB,5X6FeZozNMgE2VRi3MJYjkkFK8SETtu2,1,0,0,0,0,0,1,0,1,0.14285714285714285,1,0.0,0,0,0,0,0,0,0,1,0,0,1,1
666,15541,ILkUjE8LhIAQFlZwnOqsyA4K0QvAbnzA,7GRhBDsirIGkRZBtSMEzNTyDr2JQm4xx,38,148,34,46,28,21,8,0,285,40.714285714285715,6,0.0,91,34,36,28,57,21,10,8,0,189,96,0
667,15577,WeG9Rj8lv2ekdTamRkXPOfgW6N9lzyds,7GRhBDsirIGkRZBtSMEzNTyDr2JQm4xx,5,3,3,0,1,0,1,0,8,1.1428571428571428,2,0.0,0,3,0,1,3,0,0,1,0,4,4,1
668,15587,J5Igg8VrXDnaGFbVX70IduvQll75W8pB,5X6FeZozNMgE2VRi3MJYjkkFK8SETtu2,1,0,0,0,0,0,1,0,1,0.14285714285714285,1,0.0,0,0,0,0,0,0,0,1,0,0,1,1
669,15634,oco4sYAQqzdnYEwLykTSM4qmOTgkFoAN,7GRhBDsirIGkRZBtSMEzNTyDr2JQm4xx,15,22,11,8,1,0,18,1,61,8.714285714285714,4,0.0,5,11,6,1,17,0,2,18,1,23,38,0
670,15637,syrttArug8Mpzs9L0IHsvBtATawYF9J2,7GRhBDsirIGkRZBtSMEzNTyDr2JQm4xx,38,51,20,48,10,1,8,0,138,19.714285714285715,4,0.0,22,20,46,10,29,1,2,8,0,98,40,1
671,15644,V1ISBfZRhnmGbKQmxoCcA5AkClMXp9Rj,5X6FeZozNMgE2VRi3MJYjkkFK8SETtu2,10,21,1,2,4,3,9,3,43,6.142857142857143,3,0.0,11,1,2,4,10,3,0,9,3,18,25,1
672,15783,Jm4nQ05ndX10jbofbWx6S0r9VXrqia6S,7GRhBDsirIGkRZBtSMEzNTyDr2JQm4xx,27,42,15,61,5,0,6,0,129,18.428571428571427,4,0.0,21,15,52,5,21,0,9,6,0,93,36,0
673,15812,zTVBZ1zOMswSgDWxrOfzKUr5J9HO6HOE,7GRhBDsirIGkRZBtSMEzNTyDr2JQm4xx,15,16,4,2,8,0,4,0,34,4.857142857142857,2,0.0,8,4,1,8,8,0,1,4,0,21,13,1
674,15829,tD36vn1aCu8pvS184dpJPyASEvtRWzdE,7GRhBDsirIGkRZBtSMEzNTyDr2JQm4xx,13,15,3,12,5,0,2,0,37,5.285714285714286,2,0.0,7,3,6,5,8,0,6,2,0,21,16,0
675,15836,Ms0MC4W5moiGJLWP7iE3FImeH9CHN4KT,7GRhBDsirIGkRZBtSMEzNTyDr2JQm4xx,8,13,2,2,2,0,6,0,25,3.5714285714285716,4,0.0,2,2,1,2,11,0,1,6,0,7,18,0
676,15867,itOUYtUQXKtiNJoDhHvixGSCtswgEapf,7GRhBDsirIGkRZBtSMEzNTyDr2JQm4xx,39,39,18,16,25,1,0,0,99,14.142857142857142,7,0.0,20,18,15,25,19,1,1,0,0,78,21,1
677,15911,INA4NXYWhyg0zaZtVRPkeCFe7zg5P8Ny,5X6FeZozNMgE2VRi3MJYjkkFK8SETtu2,24,42,15,28,7,0,8,0,100,14.285714285714286,5,0.0,14,15,28,7,28,0,0,8,0,64,36,0
678,16009,Slk5JcZSYHmDLQZXaNVmcMDmjJ16kBhI,7GRhBDsirIGkRZBtSMEzNTyDr2JQm4xx,16,40,4,14,3,0,6,0,67,9.571428571428571,6,0.0,13,4,11,3,27,0,3,6,0,31,36,0
679,16137,qG2WjxxVTjr5YeDGnwFvACGaHzeUu9HC,7GRhBDsirIGkRZBtSMEzNTyDr2JQm4xx,6,6,4,0,2,0,4,0,16,2.2857142857142856,1,0.0,0,4,0,2,6,0,0,4,0,6,10,1
680,16171,HieJch2LMldZteUgpMFf3KIoNYB4ohUW,5X6FeZozNMgE2VRi3MJYjkkFK8SETtu2,1,0,0,0,0,0,1,0,1,0.14285714285714285,1,0.0,0,0,0,0,0,0,0,1,0,0,1,1
681,16242,CtBdHmlYqpaYTMEPBvno3lS1o4khTfTp,7GRhBDsirIGkRZBtSMEzNTyDr2JQm4xx,17,25,5,10,9,0,2,0,51,7.285714285714286,3,0.0,14,5,8,9,11,0,2,2,0,36,15,1
682,16384,DmRnf6emOOeLa4MI9vNggFDmgXu8cRIO,7GRhBDsirIGkRZBtSMEzNTyDr2JQm4xx,26,38,20,4,5,0,14,0,81,11.571428571428571,4,0.0,9,20,3,5,29,0,1,14,0,37,44,0
683,16398,BoLe02lvDeCShGmwKeobGR6lB0bWy1t5,5X6FeZozNMgE2VRi3MJYjkkFK8SETtu2,1,0,0,0,0,0,1,0,1,0.14285714285714285,1,0.0,0,0,0,0,0,0,0,1,0,0,1,1
684,16467,pz4WzmrapGULqEk99lfOZVzJbwiC2Cl1,7GRhBDsirIGkRZBtSMEzNTyDr2JQm4xx,5,4,0,0,0,0,4,1,9,1.2857142857142858,2,0.0,0,0,0,0,4,0,0,4,1,0,9,1
685,16473,aPM6Pkx8yXzDO1Wq6YMG1wXnFkTU2WLX,7GRhBDsirIGkRZBtSMEzNTyDr2JQm4xx,15,43,8,10,8,0,2,0,71,10.142857142857142,3,0.0,16,8,8,8,27,0,2,2,0,40,31,1
686,16475,Od5SJB9QYomULqL762ang9IzHhai9Ph9,5X6FeZozNMgE2VRi3MJYjkkFK8SETtu2,7,3,2,0,2,0,2,0,9,1.2857142857142858,1,0.0,0,2,0,2,3,0,0,2,0,4,5,1
687,16513,DWFLMejD5u3rghjtGauMHAJIC3QSphK7,5X6FeZozNMgE2VRi3MJYjkkFK8SETtu2,3,2,0,0,0,0,4,0,6,0.8571428571428571,1,0.0,0,0,0,0,2,0,0,4,0,0,6,1
688,16523,koNIIdoqi1yUhLIZAXp5I3Fl17qrPzNm,5X6FeZozNMgE2VRi3MJYjkkFK8SETtu2,62,165,46,3,99,0,14,0,327,46.714285714285715,8,0.0,95,46,3,99,70,0,0,14,0,243,84,1
689,16572,ckaBfYMRcWDmM0gkDIb3PY6kSLd0nbzq,7GRhBDsirIGkRZBtSMEzNTyDr2JQm4xx,18,42,8,0,6,0,2,0,58,8.285714285714286,1,0.0,2,8,0,6,40,0,0,2,0,16,42,0
690,16578,fGIeAB7IRJCHxzCo8u4GLaPKxQfHeCdi,5X6FeZozNMgE2VRi3MJYjkkFK8SETtu2,5,2,1,0,1,0,2,0,6,0.8571428571428571,1,0.0,0,1,0,1,2,0,0,2,0,2,4,1
691,16669,D222lqyFrC2b1DAJCNvtq2cDPE2yWdSh,7GRhBDsirIGkRZBtSMEzNTyDr2JQm4xx,25,29,12,10,13,0,2,0,66,9.428571428571429,1,0.0,12,12,9,13,17,0,1,2,0,46,20,1
692,16689,EHb1g6rHAZsPWF8Gnr1xievV0vdAYt5Q,5X6FeZozNMgE2VRi3MJYjkkFK8SETtu2,24,81,19,0,23,1,24,1,149,21.285714285714285,5,0.0,21,19,0,23,60,1,0,24,1,63,86,1
693,16706,slYeCkbTPIrLKmlwHnXlLGAsLG9LsAsp,5X6FeZozNMgE2VRi3MJYjkkFK8SETtu2,13,15,2,16,5,0,3,0,41,5.857142857142857,2,0.0,12,2,13,5,3,0,3,3,0,32,9,1
694,16750,3FnNr9vIYZumFxJHz1azU06JI7Pm6hh3,5X6FeZozNMgE2VRi3MJYjkkFK8SETtu2,21,46,15,4,16,0,12,0,93,13.285714285714286,7,0.0,14,15,4,16,32,0,0,12,0,49,44,0
695,16792,fbDgsipajp0xhHFfXN21wQyuQBNdN7hy,7GRhBDsirIGkRZBtSMEzNTyDr2JQm4xx,24,25,7,44,10,4,1,0,91,13.0,1,0.0,15,7,37,10,10,4,7,1,0,69,22,0
696,16900,WGK8mQ0dncy2teM4KtkdUCsILwqbrJWd,5X6FeZozNMgE2VRi3MJYjkkFK8SETtu2,17,28,1,0,0,0,6,0,35,5.0,4,0.0,0,1,0,0,28,0,0,6,0,1,34,0
697,16905,Wp1xeVcESYWtuQa7LcTjyNCN1tWrWadY,5X6FeZozNMgE2VRi3MJYjkkFK8SETtu2,6,6,0,0,0,0,2,0,8,1.1428571428571428,1,0.0,0,0,0,0,6,0,0,2,0,0,8,1
698,16987,Ar7wri6od2sIMOfx95hPmMwDttR4wtOC,7GRhBDsirIGkRZBtSMEzNTyDr2JQm4xx,32,57,20,42,20,0,4,0,143,20.428571428571427,4,0.0,30,20,36,20,27,0,6,4,0,106,37,0
699,17035,M76ofI2UJItYXeusDRswE1mzVX9YlrVW,7GRhBDsirIGkRZBtSMEzNTyDr2JQm4xx,44,93,20,105,18,0,6,0,242,34.57142857142857,3,0.0,54,20,93,18,39,0,12,6,0,185,57,1
700,17060,WX5bge9EFbPypYuObEiSD1Gyvh8Z866G,7GRhBDsirIGkRZBtSMEzNTyDr2JQm4xx,26,23,9,0,15,0,2,0,49,7.0,1,0.0,12,9,0,15,11,0,0,2,0,36,13,1
701,17124,xOB7vl3l1Tpb0i0cSWni40BfJ5FBclms,7GRhBDsirIGkRZBtSMEzNTyDr2JQm4xx,7,4,3,2,1,0,1,0,11,1.5714285714285714,1,0.0,0,3,1,1,4,0,1,1,0,5,6,0
702,17188,t6owJ66zI1aqKUvaXhE60g958CkKM6DK,5X6FeZozNMgE2VRi3MJYjkkFK8SETtu2,5,4,1,0,2,0,2,0,9,1.2857142857142858,1,0.0,2,1,0,2,2,0,0,2,0,5,4,0
703,17242,OcmM4lAJy1xB9HSsEUxVtaUQ7oE5dcTp,7GRhBDsirIGkRZBtSMEzNTyDr2JQm4xx,18,36,14,16,16,2,4,0,88,12.571428571428571,6,0.0,7,14,8,16,29,2,8,4,0,45,43,0
704,17427,LXb7JMOXN1ofXaAKjur9VNJzkhXbqCgp,5X6FeZozNMgE2VRi3MJYjkkFK8SETtu2,1,0,0,0,0,0,1,0,1,0.14285714285714285,1,0.0,0,0,0,0,0,0,0,1,0,0,1,0
705,17449,yUIi2GUBxhysS9d9StVXyKUpISr6ANil,5X6FeZozNMgE2VRi3MJYjkkFK8SETtu2,33,69,14,19,31,8,37,1,179,25.571428571428573,5,0.0,47,14,18,31,22,8,1,37,1,110,69,0
706,17485,7fC3V6ivG07wUIMOmiYFzSlyjWvbYnYf,7GRhBDsirIGkRZBtSMEzNTyDr2JQm4xx,13,17,0,16,2,0,5,0,40,5.714285714285714,2,0.0,8,0,13,2,9,0,3,5,0,23,17,0
707,17545,DGDF7EtBLvOTcfUxrOsvdCg2Ar6LlSc6,7GRhBDsirIGkRZBtSMEzNTyDr2JQm4xx,1,0,0,0,0,0,1,0,1,0.14285714285714285,1,0.0,0,0,0,0,0,0,0,1,0,0,1,0
708,17589,jJsFOxENnNTTNJOQ1tE8IoKNy1vSDO3t,5X6FeZozNMgE2VRi3MJYjkkFK8SETtu2,6,4,3,0,3,0,1,0,11,1.5714285714285714,1,0.0,0,3,0,3,4,0,0,1,0,6,5,1
709,17634,UA8vU3s92g3lXc62U363PEO0xor6Mpeg,7GRhBDsirIGkRZBtSMEzNTyDr2JQm4xx,24,23,11,0,17,5,2,0,58,8.285714285714286,3,0.0,9,11,0,17,14,5,0,2,0,37,21,0
710,17673,JSViK46d91E9ikMcvKp1rzZlHAqQuH4h,7GRhBDsirIGkRZBtSMEzNTyDr2JQm4xx,9,14,11,0,4,0,3,0,32,4.571428571428571,2,0.0,0,11,0,4,14,0,0,3,0,15,17,1
711,17686,u0SrW65Zdf0RG2PPgt52qf6MWWYZDmbZ,5X6FeZozNMgE2VRi3MJYjkkFK8SETtu2,4,17,2,0,2,0,3,0,24,3.4285714285714284,4,0.0,2,2,0,2,15,0,0,3,0,6,18,1
712,17732,uSYPJScTBnHLomhQS9YX0a2fQSS0kAh7,3VkHkmOtom3jM2wCu94xgzzu1d6Dn7or,65,136,62,41,60,10,31,5,345,49.285714285714285,11,0.0,52,62,40,60,84,10,1,31,5,214,131,1
713,17748,Dha6i4inJ8jK0OySEa9I85ooFkmSQR0f,3VkHkmOtom3jM2wCu94xgzzu1d6Dn7or,79,285,136,46,44,82,57,97,747,106.71428571428571,20,0.0,97,136,44,44,188,82,2,57,97,321,426,0
714,17762,8GF3xih10SN0lTJQvD5ffZk94qz9veVn,3VkHkmOtom3jM2wCu94xgzzu1d6Dn7or,66,198,9,71,18,13,22,4,335,47.857142857142854,14,0.0,111,9,64,18,87,13,7,22,4,202,133,1
715,17772,Ix0I3r1fnKOg1dmzRjt5yYIGOrTQ5F1h,3VkHkmOtom3jM2wCu94xgzzu1d6Dn7or,62,394,20,103,12,49,38,1,617,88.14285714285714,13,0.0,139,20,99,12,255,49,4,38,1,270,347,1
716,17797,Grmueh4kYgLYo2kInw23ZHrSQJbjli7D,3VkHkmOtom3jM2wCu94xgzzu1d6Dn7or,1,0,0,0,0,0,1,0,1,0.14285714285714285,1,0.0,0,0,0,0,0,0,0,1,0,0,1,1
717,17817,X1EUj7wk6F33hO4P0XJp5wPekH9jNbQl,3VkHkmOtom3jM2wCu94xgzzu1d6Dn7or,24,17,15,0,14,0,18,0,64,9.142857142857142,2,0.0,0,15,0,14,17,0,0,18,0,29,35,1
718,17881,brJtU2ctZ98mR2x67cNWnN516bdfRqUH,3VkHkmOtom3jM2wCu94xgzzu1d6Dn7or,53,149,78,73,0,171,20,7,498,71.14285714285714,14,0.0,57,78,71,0,92,171,2,20,7,206,292,0
719,17882,6Nedk2yiWtM4avzjFO0iKSrk1Ko6yIUK,3VkHkmOtom3jM2wCu94xgzzu1d6Dn7or,21,42,20,17,10,7,13,1,110,15.714285714285714,7,0.0,5,20,13,10,37,7,4,13,1,48,62,1
720,17907,pE2pfmXY2JZ1ppA5N0APNqSGmVpRUVPY,3VkHkmOtom3jM2wCu94xgzzu1d6Dn7or,73,224,62,98,39,0,75,1,499,71.28571428571429,14,0.0,85,62,96,39,139,0,2,75,1,282,217,0
721,17945,r3zOb44kbET1pjptzIuq8WZVUENTEA3D,3VkHkmOtom3jM2wCu94xgzzu1d6Dn7or,97,296,155,59,141,67,33,2,753,107.57142857142857,15,0.0,119,155,55,141,177,67,4,33,2,470,283,0
722,18023,XYBLB5vnJS2TawgpFm2PqudALg5wF8Kg,3VkHkmOtom3jM2wCu94xgzzu1d6Dn7or,7,3,1,0,1,0,6,0,11,1.5714285714285714,2,0.0,1,1,0,1,2,0,0,6,0,3,8,1
723,18078,rmxHCOJX4wSBlcTrJuAWqR1bup4swsK6,3VkHkmOtom3jM2wCu94xgzzu1d6Dn7or,1,0,0,0,0,0,1,0,1,0.14285714285714285,1,0.0,0,0,0,0,0,0,0,1,0,0,1,1
724,18086,TnMuPtEYCG1UP1JnaDUM0auIBTc6VjvH,3VkHkmOtom3jM2wCu94xgzzu1d6Dn7or,83,260,122,65,64,140,70,6,727,103.85714285714286,9,0.0,70,122,55,64,190,140,10,70,6,311,416,0
725,18088,IYg5NbiXDzXRMWONARzl3jmz5ST0akR1,3VkHkmOtom3jM2wCu94xgzzu1d6Dn7or,52,67,44,0,36,0,11,0,158,22.571428571428573,8,0.0,0,44,0,36,67,0,0,11,0,80,78,0
726,18092,001Wosm650x4ktE3NPV76K6QhVwlKDP6,3VkHkmOtom3jM2wCu94xgzzu1d6Dn7or,1,0,0,0,0,0,1,0,1,0.14285714285714285,1,0.0,0,0,0,0,0,0,0,1,0,0,1,1
727,18097,RhrhT0DsU5k5o3MtqPuXQswIRC7VTIjC,3VkHkmOtom3jM2wCu94xgzzu1d6Dn7or,1,0,0,0,0,0,3,0,3,0.42857142857142855,1,0.0,0,0,0,0,0,0,0,3,0,0,3,1
728,18101,ag9syR84Cy6sEDoCNkuFTpCWCEtqdqJc,3VkHkmOtom3jM2wCu94xgzzu1d6Dn7or,30,104,35,42,30,86,29,2,328,46.857142857142854,16,0.0,49,35,33,30,55,86,9,29,2,147,181,0
729,18144,pk69em2bhNfGTrrqysMHCMfzjd22WDJE,3VkHkmOtom3jM2wCu94xgzzu1d6Dn7or,31,127,45,33,21,19,25,0,270,38.57142857142857,10,0.0,25,45,33,21,102,19,0,25,0,124,146,0
730,18159,BRclHGtISz8OrVQUxPrUgTFUDM8fjMcZ,3VkHkmOtom3jM2wCu94xgzzu1d6Dn7or,3,0,0,0,0,0,4,0,4,0.5714285714285714,1,0.0,0,0,0,0,0,0,0,4,0,0,4,1
731,18188,PPOy6eFALFchmbWLetIASc4gvjCBJT44,3VkHkmOtom3jM2wCu94xgzzu1d6Dn7or,65,161,67,59,47,36,57,31,458,65.42857142857143,13,0.0,64,67,52,47,97,36,7,57,31,230,228,0
732,18196,Ywb8KfjZdIQ3abMJEb6RTRF3JJxAFjU7,3VkHkmOtom3jM2wCu94xgzzu1d6Dn7or,69,204,49,66,65,44,21,4,453,64.71428571428571,16,0.0,103,49,58,65,101,44,8,21,4,275,178,0
733,18221,MRzfDn8Dt6xZQHTAuGEWQiuznoHxxpTX,3VkHkmOtom3jM2wCu94xgzzu1d6Dn7or,32,71,19,26,29,0,40,0,185,26.428571428571427,11,0.0,44,19,26,29,27,0,0,40,0,118,67,0
734,18243,EGKN6vyN5Q43uHhLGJeQNxMWUFnutUxK,3VkHkmOtom3jM2wCu94xgzzu1d6Dn7or,34,126,33,27,35,37,35,2,295,42.142857142857146,8,0.0,68,33,23,35,58,37,4,35,2,159,136,1
735,18265,KIQtwyG9uOFU6xTKYvwqivjGIZ1GfiMa,3VkHkmOtom3jM2wCu94xgzzu1d6Dn7or,69,229,97,70,82,67,32,4,581,83.0,14,0.0,99,97,70,82,130,67,0,32,4,348,233,0
736,18364,gMeKwVdV7xHR9zrsQTTuP5xOz4aKMsCh,3VkHkmOtom3jM2wCu94xgzzu1d6Dn7or,28,39,19,24,15,2,19,0,118,16.857142857142858,4,0.0,13,19,21,15,26,2,3,19,0,68,50,1
737,18373,dx9pQrhQ84HPZEwcXhND3i57oR5xlZcF,3VkHkmOtom3jM2wCu94xgzzu1d6Dn7or,78,213,55,126,77,7,45,6,529,75.57142857142857,15,0.0,137,55,119,77,76,7,7,45,6,388,141,0
738,18381,9TAoWA17iJi4aGxReuxcPCWmtwK9xK5D,3VkHkmOtom3jM2wCu94xgzzu1d6Dn7or,57,133,35,87,28,1,24,3,311,44.42857142857143,8,0.0,39,35,80,28,94,1,7,24,3,182,129,0
739,18403,I9yi1jZjIznCPzP5fpMJEhPDMiUaetUu,3VkHkmOtom3jM2wCu94xgzzu1d6Dn7or,69,174,73,89,40,19,26,4,425,60.714285714285715,18,0.0,30,73,78,40,144,19,11,26,4,221,204,1
740,18428,kxruAMKyHOcayI2NB5Y6rjVEEl5poFsO,3VkHkmOtom3jM2wCu94xgzzu1d6Dn7or,22,14,11,0,8,10,25,0,68,9.714285714285714,3,0.0,0,11,0,8,14,10,0,25,0,19,49,1
741,18450,lFuxKGBpNGivMMktjiNncr25c8ERjZWC,3VkHkmOtom3jM2wCu94xgzzu1d6Dn7or,25,127,50,23,26,78,39,3,346,49.42857142857143,7,0.0,37,50,19,26,90,78,4,39,3,132,214,0
742,18466,s24Qk0ZpAXR97ldBDtgP8DE6rT8or69U,3VkHkmOtom3jM2wCu94xgzzu1d6Dn7or,80,245,90,90,67,37,32,2,563,80.42857142857143,21,0.0,98,90,73,67,147,37,17,32,2,328,235,0
743,18523,lXSTwshe07PL988rWzAoelFryi3Pn7tG,3VkHkmOtom3jM2wCu94xgzzu1d6Dn7or,7,12,7,0,2,0,8,0,29,4.142857142857143,3,0.0,0,7,0,2,12,0,0,8,0,9,20,1
744,18539,Ci9FGx4bWbxBIrvlwmLcaPnUTvif70a3,3VkHkmOtom3jM2wCu94xgzzu1d6Dn7or,51,111,35,48,17,12,14,10,247,35.285714285714285,10,0.0,30,35,46,17,81,12,2,14,10,128,119,0
745,18542,ECEUT4nRUDaFV5qHTqBhsS2pJikODqSu,3VkHkmOtom3jM2wCu94xgzzu1d6Dn7or,8,11,5,0,4,0,3,0,23,3.2857142857142856,1,0.0,2,5,0,4,9,0,0,3,0,11,12,1
746,18550,Foug4Pz6AbcC9cKxJW2E85auy3I2Ujw9,3VkHkmOtom3jM2wCu94xgzzu1d6Dn7or,9,3,2,0,2,0,7,0,14,2.0,1,0.0,0,2,0,2,3,0,0,7,0,4,10,1
747,18630,LJBTrS8sHkFyN47h6ik2jPfi1u81PolZ,3VkHkmOtom3jM2wCu94xgzzu1d6Dn7or,67,240,63,111,45,56,41,1,557,79.57142857142857,20,0.0,89,63,110,45,151,56,1,41,1,307,250,0
748,18641,wbm7aXhz4d0PkVw0PLDLLW0uINj17nxg,3VkHkmOtom3jM2wCu94xgzzu1d6Dn7or,13,39,13,6,9,6,8,0,81,11.571428571428571,5,0.0,14,13,5,9,25,6,1,8,0,41,40,1
749,18658,6BQ1MfaAfWSP4zUxzPbaafKGCseltjDR,3VkHkmOtom3jM2wCu94xgzzu1d6Dn7or,10,18,7,0,6,0,4,0,35,5.0,3,0.0,5,7,0,6,13,0,0,4,0,18,17,1
750,18663,VSxmvcFHrZIVtNnTaFw0qdfh1Zdl1LMy,3VkHkmOtom3jM2wCu94xgzzu1d6Dn7or,9,21,9,3,3,15,4,0,55,7.857142857142857,3,0.0,6,9,3,3,15,15,0,4,0,21,34,1
751,18689,2xZrQQP23hxOtlLcdItvAyKPIWRJ1v3T,3VkHkmOtom3jM2wCu94xgzzu1d6Dn7or,59,43,33,0,27,0,8,0,111,15.857142857142858,5,0.0,0,33,0,27,43,0,0,8,0,60,51,0
752,18698,pvhPBXiUlAyJeaMIOU2U6eYfza72w7rZ,3VkHkmOtom3jM2wCu94xgzzu1d6Dn7or,8,3,2,0,2,0,5,0,12,1.7142857142857142,3,0.0,0,2,0,2,3,0,0,5,0,4,8,1
753,18702,Qiu00ngPMaYSLIBJ0lGXVVmnZ9RcWVyJ,3VkHkmOtom3jM2wCu94xgzzu1d6Dn7or,18,20,8,10,12,7,2,0,59,8.428571428571429,1,0.0,11,8,10,12,9,7,0,2,0,41,18,1
754,18711,VySPxqxLrvQXsa4ANpNsQKDb6glXzoI5,3VkHkmOtom3jM2wCu94xgzzu1d6Dn7or,54,152,77,26,45,32,44,4,380,54.285714285714285,12,0.0,20,77,26,45,132,32,0,44,4,168,212,0
755,18740,EiNWohr3Zb4jjWZbmhSd0fizIZ5iJUD6,3VkHkmOtom3jM2wCu94xgzzu1d6Dn7or,12,27,12,7,13,11,4,0,74,10.571428571428571,4,0.0,11,12,7,13,16,11,0,4,0,43,31,1
756,18750,HIbKGQJ8yDbPhmqDqsEHxHEydttgfsQA,3VkHkmOtom3jM2wCu94xgzzu1d6Dn7or,63,195,90,41,59,55,35,3,478,68.28571428571429,7,0.0,60,90,37,59,135,55,4,35,3,246,232,0
757,18769,Q8LjqyQUAhel7eahT3smYZreGv7r7aK4,3VkHkmOtom3jM2wCu94xgzzu1d6Dn7or,85,205,73,63,64,59,68,3,535,76.42857142857143,19,0.0,84,73,56,64,121,59,7,68,3,277,258,0
758,18774,y2sW95cqHxDSSyqwCmaoCGpxWGUy5xSo,3VkHkmOtom3jM2wCu94xgzzu1d6Dn7or,79,247,47,88,96,34,13,1,526,75.14285714285714,11,0.0,180,47,82,96,67,34,6,13,1,405,121,0
759,18785,MfMma0Ta6pPfrEXtJ0AJ2URgwzF8BIcO,3VkHkmOtom3jM2wCu94xgzzu1d6Dn7or,2,0,0,0,0,0,3,0,3,0.42857142857142855,1,0.0,0,0,0,0,0,0,0,3,0,0,3,1
760,18900,twL3gg1NxV7siasyIyesAxTIzR4pdVii,3VkHkmOtom3jM2wCu94xgzzu1d6Dn7or,66,189,68,45,42,97,18,0,459,65.57142857142857,9,0.0,69,68,43,42,120,97,2,18,0,222,237,0
761,18903,5PQ2zPZwyHgVOd3muSSBQz7FsKF2poQh,3VkHkmOtom3jM2wCu94xgzzu1d6Dn7or,64,206,57,90,53,25,53,7,491,70.14285714285714,6,0.0,99,57,82,53,107,25,8,53,7,291,200,0
762,18916,KoV68VcO7F3E8wg0KpRNwvTyiwvSxGqA,3VkHkmOtom3jM2wCu94xgzzu1d6Dn7or,9,5,4,0,4,1,3,0,17,2.4285714285714284,1,0.0,0,4,0,4,5,1,0,3,0,8,9,1
763,18930,2UI6dX5TZfoXI1GNCTxQwRjZdy9DYB86,3VkHkmOtom3jM2wCu94xgzzu1d6Dn7or,61,143,42,52,22,7,15,1,282,40.285714285714285,8,0.0,38,42,51,22,105,7,1,15,1,153,129,0
764,18973,bRmWg6mFQ7xPrAw8okLLDyjGujSO4E8W,3VkHkmOtom3jM2wCu94xgzzu1d6Dn7or,77,148,51,46,50,48,98,4,445,63.57142857142857,12,0.0,69,51,42,50,79,48,4,98,4,212,233,0
765,18981,TxPdRo4YM0nG7krToBXcizu0WlDyTWIy,3VkHkmOtom3jM2wCu94xgzzu1d6Dn7or,9,13,5,8,2,2,3,0,33,4.714285714285714,2,0.0,6,5,7,2,7,2,1,3,0,20,13,1
766,19102,6V735G3zF0lLcv0aFmtQmFRoGL9yLYzI,3VkHkmOtom3jM2wCu94xgzzu1d6Dn7or,1,0,0,0,0,0,1,0,1,0.14285714285714285,1,0.0,0,0,0,0,0,0,0,1,0,0,1,1
767,19110,3ny9mc45r6qJQOOxmh4xg5QHGygeiHbu,3VkHkmOtom3jM2wCu94xgzzu1d6Dn7or,57,191,69,41,46,6,35,0,388,55.42857142857143,8,0.0,73,69,38,46,118,6,3,35,0,226,162,0
768,19124,1kjyC7ahZCsVlNSBwjZNyonjDeeXb2jh,3VkHkmOtom3jM2wCu94xgzzu1d6Dn7or,76,267,122,35,89,68,49,9,639,91.28571428571429,18,0.0,40,122,29,89,227,68,6,49,9,280,359,0
769,19159,5yR5O4DRPJvdwUa00RWlgmmSt86eHiWt,3VkHkmOtom3jM2wCu94xgzzu1d6Dn7or,7,5,3,0,1,0,5,1,15,2.142857142857143,1,0.0,0,3,0,1,5,0,0,5,1,4,11,1
770,19224,V3R0gIx6Yd8uB6bFWcwIynkF0zfEHsVH,3VkHkmOtom3jM2wCu94xgzzu1d6Dn7or,71,230,67,54,96,37,40,14,538,76.85714285714286,16,0.0,138,67,48,96,92,37,6,40,14,349,189,0
771,19289,zyMs55MEXcYV6llnecBHL4KGyjGwZwbR,3VkHkmOtom3jM2wCu94xgzzu1d6Dn7or,70,195,54,65,71,27,19,0,431,61.57142857142857,17,0.0,107,54,64,71,88,27,1,19,0,296,135,0
772,19323,PlUF2VKLVgW5qlXUwlw7IbYoWraUDopo,3VkHkmOtom3jM2wCu94xgzzu1d6Dn7or,16,30,9,19,6,10,4,0,78,11.142857142857142,2,0.0,9,9,17,6,21,10,2,4,0,41,37,1
773,19339,lqEGjqZQzcaIOdC4SfhGwonY0sNEdv9v,3VkHkmOtom3jM2wCu94xgzzu1d6Dn7or,10,42,4,0,3,5,6,0,60,8.571428571428571,4,0.0,15,4,0,3,27,5,0,6,0,22,38,1
774,19356,CWyQorKTdtJysACpC8OcqJBGDDmfcHTs,3VkHkmOtom3jM2wCu94xgzzu1d6Dn7or,3,0,0,0,0,0,3,0,3,0.42857142857142855,1,0.0,0,0,0,0,0,0,0,3,0,0,3,1
775,19359,n1ESpvyobZkFsfrWJhKOuY4URaa1sUc5,3VkHkmOtom3jM2wCu94xgzzu1d6Dn7or,65,505,103,78,15,33,59,3,796,113.71428571428571,14,0.0,161,103,76,15,344,33,2,59,3,355,441,0
776,19378,t2pLyQogXlU1FYBSbBXVU6WIkp2EphwW,3VkHkmOtom3jM2wCu94xgzzu1d6Dn7or,10,23,6,0,1,13,16,2,61,8.714285714285714,2,0.0,2,6,0,1,21,13,0,16,2,9,52,1
777,19390,bIGq7A9r0Y0NLU65d3TOWeEFWRfABEv0,3VkHkmOtom3jM2wCu94xgzzu1d6Dn7or,1,0,0,0,0,0,1,0,1,0.14285714285714285,1,0.0,0,0,0,0,0,0,0,1,0,0,1,1
778,19405,YEOUoDIDe7yUhdKE02prv9UscLPObTDD,3VkHkmOtom3jM2wCu94xgzzu1d6Dn7or,1,0,0,0,0,0,2,0,2,0.2857142857142857,1,0.0,0,0,0,0,0,0,0,2,0,0,2,1
779,19406,2bkNmlQB9BrmgVluXIKiykQrlDIy5pxv,3VkHkmOtom3jM2wCu94xgzzu1d6Dn7or,5,2,1,0,1,0,3,0,7,1.0,2,0.0,0,1,0,1,2,0,0,3,0,2,5,1
780,19594,4x6w2QLFfXQ2dHDa4fBCOvJ1UYg7yE69,fbPkOYLVPtPgIt0MxizjfFJov3JbHyAi,5,4,2,0,1,0,1,0,8,1.1428571428571428,1,0.0,1,2,0,1,3,0,0,1,0,4,4,1
781,19596,lhkiaYX6n9dxQvsKk8vp6UZQBNlsuGnH,fbPkOYLVPtPgIt0MxizjfFJov3JbHyAi,41,68,34,34,18,75,21,1,251,35.857142857142854,3,0.0,28,34,28,18,40,75,6,21,1,108,143,0
782,19619,BcKYeHv4ZKY4DeUPw2M71hKVyOhypokT,fbPkOYLVPtPgIt0MxizjfFJov3JbHyAi,6,2,0,0,0,9,6,1,18,2.5714285714285716,1,0.0,0,0,0,0,2,9,0,6,1,0,18,1
783,19677,rl1ijjmPoVXrn0BLw0LMwhU2iQWvim3X,fbPkOYLVPtPgIt0MxizjfFJov3JbHyAi,27,41,24,14,8,53,6,1,147,21.0,5,0.0,11,24,14,8,30,53,0,6,1,57,90,0
784,19684,mya8TfxNbiDk3y9Od8avdqRP3ecWgTII,fbPkOYLVPtPgIt0MxizjfFJov3JbHyAi,8,7,3,4,3,0,1,0,18,2.5714285714285716,1,0.0,3,3,3,3,4,0,1,1,0,12,6,1
785,19697,94kd1qvIZ0nokZPS6BCV8qxXnL5MM2jB,fbPkOYLVPtPgIt0MxizjfFJov3JbHyAi,28,215,96,28,49,17,18,1,424,60.57142857142857,3,0.0,24,96,25,49,191,17,3,18,1,194,230,0
786,19710,2mdoNlBiXpgUVSmoihAheHl3NISmi738,fbPkOYLVPtPgIt0MxizjfFJov3JbHyAi,34,46,29,10,17,0,9,0,111,15.857142857142858,3,0.0,8,29,9,17,38,0,1,9,0,63,48,1
787,19727,bL3u5qIjoppYFsMUfGswfFLujxnAggge,fbPkOYLVPtPgIt0MxizjfFJov3JbHyAi,42,50,29,22,25,15,6,1,148,21.142857142857142,3,0.0,15,29,21,25,35,15,1,6,1,90,58,0
788,19737,r5nHhhPp8wNqkUKwaWfUvmNqly1MZrKz,fbPkOYLVPtPgIt0MxizjfFJov3JbHyAi,2,2,0,0,0,0,0,0,2,0.2857142857142857,1,0.0,0,0,0,0,2,0,0,0,0,0,2,0
789,19761,2ZVrSpja22JYuBdqG7iHOipKnnGEm2ou,fbPkOYLVPtPgIt0MxizjfFJov3JbHyAi,20,17,10,15,5,16,4,0,67,9.571428571428571,1,0.0,6,10,13,5,11,16,2,4,0,34,33,0
790,19765,oZrYS5rqR18A77jULvm9aJ8bGsP88f4h,fbPkOYLVPtPgIt0MxizjfFJov3JbHyAi,26,22,12,18,8,0,2,0,62,8.857142857142858,2,0.0,7,12,16,8,15,0,2,2,0,43,19,0
791,19772,fKgU6PKVjgAnp4uvGa6MHJe7D2ZYaBc1,fbPkOYLVPtPgIt0MxizjfFJov3JbHyAi,7,5,3,0,2,0,1,0,11,1.5714285714285714,1,0.0,1,3,0,2,4,0,0,1,0,6,5,1
792,19774,R0JUZ056kzFL6PD0dHwCASPDjJEFALuj,fbPkOYLVPtPgIt0MxizjfFJov3JbHyAi,34,48,28,32,23,0,4,0,135,19.285714285714285,2,0.0,14,28,31,23,34,0,1,4,0,96,39,1
793,19778,8b7ZppycC3YQh10hFhgFNseCAwtseLj5,fbPkOYLVPtPgIt0MxizjfFJov3JbHyAi,8,4,3,0,2,0,2,0,11,1.5714285714285714,1,0.0,0,3,0,2,4,0,0,2,0,5,6,0
794,19864,xpAxjSreQEJGjM28FJsQcyiEt1VA8RXl,fbPkOYLVPtPgIt0MxizjfFJov3JbHyAi,32,54,25,14,8,2,8,0,111,15.857142857142858,4,0.0,6,25,14,8,48,2,0,8,0,53,58,0
795,19878,iuOmDEhpvOE7SqnGlPzkF3AFhAsHx7fO,fbPkOYLVPtPgIt0MxizjfFJov3JbHyAi,5,4,1,1,0,0,1,0,7,1.0,1,0.0,1,1,1,0,3,0,0,1,0,3,4,1
796,19890,IVtvtdZLBtL9DhFAioWkcCx38OrFXpXg,fbPkOYLVPtPgIt0MxizjfFJov3JbHyAi,15,29,14,8,0,1,6,0,58,8.285714285714286,2,0.0,12,14,8,0,17,1,0,6,0,34,24,0
797,19902,WaEPHAZo5pH7Npa5iwnKZ2EJATuLkfKt,fbPkOYLVPtPgIt0MxizjfFJov3JbHyAi,6,4,1,0,1,0,1,0,7,1.0,1,0.0,0,1,0,1,4,0,0,1,0,2,5,1
798,19910,1Epnr53yLJpI4d6wSWAUymSv0Yujn22A,fbPkOYLVPtPgIt0MxizjfFJov3JbHyAi,9,12,3,6,0,0,1,0,22,3.142857142857143,2,0.0,3,3,6,0,9,0,0,1,0,12,10,0
799,19914,iUELwsAOi144Gv3ZwF4pg4MHhyg4VTy9,fbPkOYLVPtPgIt0MxizjfFJov3JbHyAi,5,3,2,0,1,0,1,0,7,1.0,1,0.0,0,2,0,1,3,0,0,1,0,3,4,1
800,19924,OT5T42YlAbCtocwISa5ev3ROMYVra29q,fbPkOYLVPtPgIt0MxizjfFJov3JbHyAi,9,6,5,0,4,0,5,0,20,2.857142857142857,1,0.0,0,5,0,4,6,0,0,5,0,9,11,1
801,19929,rVO8IsFZOLqwyY7i49TyObO4q8Yse38O,fbPkOYLVPtPgIt0MxizjfFJov3JbHyAi,4,3,1,0,0,0,1,0,5,0.7142857142857143,1,0.0,0,1,0,0,3,0,0,1,0,1,4,1
802,19946,l9HZDhlAzMA7SQE77dy0GfpgPqHQZI8y,fbPkOYLVPtPgIt0MxizjfFJov3JbHyAi,29,66,20,26,19,13,18,1,163,23.285714285714285,6,0.0,32,20,23,19,34,13,3,18,1,94,69,0
803,19952,qzE4xRGg4xgP1uXuFdpBCVtFm7DMRWEv,fbPkOYLVPtPgIt0MxizjfFJov3JbHyAi,13,27,0,23,5,21,7,1,84,12.0,1,0.0,14,0,15,5,13,21,8,7,1,34,50,1
804,20043,qIocZKknaEHoCEEqTwKDXMoKLprrYhO4,5Gyp41oLVo7Gg7vF4vpmggWP5MU70QO6,6,6,2,0,2,0,1,0,11,1.5714285714285714,1,0.0,0,2,0,2,6,0,0,1,0,4,7,1
805,20048,CIjZVb8iJSeRVF4KWC0hvOeGnb2qkTW6,5Gyp41oLVo7Gg7vF4vpmggWP5MU70QO6,15,32,17,11,7,0,7,0,74,10.571428571428571,5,0.0,2,17,7,7,30,0,4,7,0,33,41,1
806,20059,VkAVvn7k93vjjseI32me2kHBgfQ0kdc6,5Gyp41oLVo7Gg7vF4vpmggWP5MU70QO6,15,34,12,8,6,14,7,0,81,11.571428571428571,4,0.0,14,12,5,6,20,14,3,7,0,37,44,1
807,20061,qunpqUxobLJx6Y8utSfs2dqDzCVpWpAQ,5Gyp41oLVo7Gg7vF4vpmggWP5MU70QO6,13,21,9,0,9,28,10,1,78,11.142857142857142,4,0.0,6,9,0,9,15,28,0,10,1,24,54,1
808,20063,NzJuOfalEsOT54AavPrqSe3rsSE0cQkZ,5Gyp41oLVo7Gg7vF4vpmggWP5MU70QO6,4,2,1,0,1,0,1,0,5,0.7142857142857143,1,0.0,0,1,0,1,2,0,0,1,0,2,3,1
809,20065,WDjKwLQgCw0UQT2CtXETzK9vLgBdL9uW,5Gyp41oLVo7Gg7vF4vpmggWP5MU70QO6,10,7,4,0,2,0,5,0,18,2.5714285714285716,2,0.0,0,4,0,2,7,0,0,5,0,6,12,1
810,20067,hdKqkkWKrDzbKE9btGChBqiCfsTwp68E,5Gyp41oLVo7Gg7vF4vpmggWP5MU70QO6,47,199,85,13,68,42,63,6,476,68.0,12,0.0,96,85,11,68,103,42,2,63,6,260,216,1
811,20071,CD5qGdJcyhdSPxUBqUX1ekd9HG7T3yUd,5Gyp41oLVo7Gg7vF4vpmggWP5MU70QO6,15,17,10,5,6,0,6,0,44,6.285714285714286,4,0.0,3,10,4,6,14,0,1,6,0,23,21,1
812,20088,d9iF5wamCJyapOBe9zIdFXXofKiHZBFF,5Gyp41oLVo7Gg7vF4vpmggWP5MU70QO6,33,163,67,24,22,69,46,5,396,56.57142857142857,6,0.0,32,67,15,22,131,69,9,46,5,136,260,1
813,20097,eyE0pR8OFcQU5RgHSRKYOtNQv60KOjOW,5Gyp41oLVo7Gg7vF4vpmggWP5MU70QO6,18,34,24,4,16,8,13,1,100,14.285714285714286,2,0.0,4,24,3,16,30,8,1,13,1,47,53,1
814,20099,yy3mnhQdz8UKZ45nbn0h9FPjCmDR9px9,5Gyp41oLVo7Gg7vF4vpmggWP5MU70QO6,21,29,17,0,8,15,14,1,84,12.0,6,0.0,1,17,0,8,28,15,0,14,1,26,58,1
815,20104,25eG0radMtgfbDURkwAcWJxELIokxKPp,5Gyp41oLVo7Gg7vF4vpmggWP5MU70QO6,4,5,2,0,0,0,1,0,8,1.1428571428571428,1,0.0,0,2,0,0,5,0,0,1,0,2,6,1
816,20115,ITvb0EWV8ZZ88RI4SBwUoVbHLyVcwZRP,5Gyp41oLVo7Gg7vF4vpmggWP5MU70QO6,20,39,15,3,10,6,4,0,77,11.0,4,0.0,16,15,3,10,23,6,0,4,0,44,33,1
817,20130,VeC3hCWeY1E7Ue4F0xd5fbrxtVODX7yh,5Gyp41oLVo7Gg7vF4vpmggWP5MU70QO6,7,6,4,0,3,0,2,0,15,2.142857142857143,2,0.0,0,4,0,3,6,0,0,2,0,7,8,1
818,20142,OyfGRbQeIfHudT9dftM6VmMNaqaBni2W,5Gyp41oLVo7Gg7vF4vpmggWP5MU70QO6,1,0,0,0,0,0,1,0,1,0.14285714285714285,1,0.0,0,0,0,0,0,0,0,1,0,0,1,1
819,20154,c2xJclWCPBe6qCkY4ZnIBuTmDp4MnYP6,5Gyp41oLVo7Gg7vF4vpmggWP5MU70QO6,8,9,3,2,2,0,1,0,17,2.4285714285714284,1,0.0,5,3,1,2,4,0,1,1,0,11,6,1
820,20155,tCH7WvGXMpRKTElgtTaIs3TIobop03rV,5Gyp41oLVo7Gg7vF4vpmggWP5MU70QO6,5,4,1,0,1,0,1,0,7,1.0,1,0.0,0,1,0,1,4,0,0,1,0,2,5,1
821,20156,leoy5SuUwpFaiyPkcOUrWqQIBdmhP9sW,5Gyp41oLVo7Gg7vF4vpmggWP5MU70QO6,12,23,18,0,7,0,8,0,56,8.0,2,0.0,0,18,0,7,23,0,0,8,0,25,31,1
822,20165,WKPeAIiAXdvhirmkXGacjyUoBPaY5Fsx,5Gyp41oLVo7Gg7vF4vpmggWP5MU70QO6,12,14,9,3,4,13,5,1,49,7.0,2,0.0,2,9,2,4,12,13,1,5,1,17,32,1
823,20166,teqaLfbDNSTWdzUpiU4jG8tePhAuvNN3,5Gyp41oLVo7Gg7vF4vpmggWP5MU70QO6,8,3,1,0,1,2,7,1,15,2.142857142857143,1,0.0,0,1,0,1,3,2,0,7,1,2,13,1
824,20171,KG6oNmBFEPQJXhvAD0RPIYEBC1kCcYzu,5Gyp41oLVo7Gg7vF4vpmggWP5MU70QO6,15,22,9,2,4,5,6,1,49,7.0,2,0.0,5,9,2,4,17,5,0,6,1,20,29,1
825,20173,M3gs30iLAcs0soWjrTQtiCP05lYedJ7C,5Gyp41oLVo7Gg7vF4vpmggWP5MU70QO6,3,0,0,0,0,1,2,0,3,0.42857142857142855,1,0.0,0,0,0,0,0,1,0,2,0,0,3,1
826,20177,RJzT6SARrbUV1CbkLbry2DisVfGIAlEE,5Gyp41oLVo7Gg7vF4vpmggWP5MU70QO6,14,13,1,2,6,2,6,1,31,4.428571428571429,1,0.0,7,1,2,6,6,2,0,6,1,16,15,1
827,20416,eOKSQ8jJCz78XIkddlLHd1RyyYmWVNK3,3VkHkmOtom3jM2wCu94xgzzu1d6Dn7or,16,14,8,0,5,0,11,0,38,5.428571428571429,3,0.0,0,8,0,5,14,0,0,11,0,13,25,1
828,20422,adDGX99l1n1iBt8AmYVD4kO1enVdrmvn,3VkHkmOtom3jM2wCu94xgzzu1d6Dn7or,97,189,66,83,63,71,45,4,521,74.42857142857143,11,0.0,99,66,72,63,90,71,11,45,4,300,221,0
829,20426,1La5rp9ZSz9cfpqCRJiC01Rwvuq5VVrf,3VkHkmOtom3jM2wCu94xgzzu1d6Dn7or,94,284,88,179,84,12,70,1,718,102.57142857142857,7,0.0,139,88,171,84,145,12,8,70,1,482,236,0
830,20443,UuzHHE4BsvJ3uANRLbVyAeeeheL79bl6,3VkHkmOtom3jM2wCu94xgzzu1d6Dn7or,1,0,0,0,0,0,1,0,1,0.14285714285714285,1,0.0,0,0,0,0,0,0,0,1,0,0,1,1
831,20494,5PZBmKEXGmnHhrok7M9vaGB06CAzFVOO,5Gyp41oLVo7Gg7vF4vpmggWP5MU70QO6,35,106,31,0,21,0,22,0,180,25.714285714285715,9,0.0,22,31,0,21,84,0,0,22,0,74,106,0
832,20528,zIUWFUBiruRlI0YsqK1cB5MqV7D5JbaQ,5Gyp41oLVo7Gg7vF4vpmggWP5MU70QO6,8,6,4,0,3,0,4,0,17,2.4285714285714284,1,0.0,0,4,0,3,6,0,0,4,0,7,10,0
833,20584,EytS791DMHkWPyEwKtiaQ332ujzLnBwF,5Gyp41oLVo7Gg7vF4vpmggWP5MU70QO6,61,642,228,55,100,142,130,9,1306,186.57142857142858,20,0.0,132,228,49,100,510,142,6,130,9,509,797,0
834,20603,Sl5PevsrNgep5w1PJpEG06fmMj1RG52q,5Gyp41oLVo7Gg7vF4vpmggWP5MU70QO6,5,2,1,0,1,3,4,0,11,1.5714285714285714,1,0.0,0,1,0,1,2,3,0,4,0,2,9,1
835,20626,HpQ6m991ijEworYjOxjwjrx2uQeTX9GV,5Gyp41oLVo7Gg7vF4vpmggWP5MU70QO6,5,2,1,0,1,0,3,0,7,1.0,1,0.0,0,1,0,1,2,0,0,3,0,2,5,1
836,20627,03dVzxLI1AumV0kSjoDxUD9fYstLoIRm,5Gyp41oLVo7Gg7vF4vpmggWP5MU70QO6,27,104,32,25,7,14,34,1,217,31.0,11,0.0,12,32,22,7,92,14,3,34,1,73,144,0
837,20671,S2q1gEPtloNcMfcAwTCrDjaeEJ3ox2aC,5Gyp41oLVo7Gg7vF4vpmggWP5MU70QO6,91,446,226,124,76,285,132,4,1293,184.71428571428572,22,0.0,120,226,107,76,326,285,17,132,4,529,764,0
838,20694,x0VzAeYdlywtGLqE1HF68qQMYZTLfsw9,5Gyp41oLVo7Gg7vF4vpmggWP5MU70QO6,59,146,71,11,41,4,38,3,314,44.857142857142854,15,0.0,39,71,9,41,107,4,2,38,3,160,154,0
839,20715,O4X95fQpNzvt0UCyuWEl2S7R4akLhSmP,5Gyp41oLVo7Gg7vF4vpmggWP5MU70QO6,7,6,3,0,1,0,7,0,17,2.4285714285714284,3,0.0,0,3,0,1,6,0,0,7,0,4,13,1
840,20720,be2BGciqfmGYmo9sjhfujJEyJqmHKX4L,5Gyp41oLVo7Gg7vF4vpmggWP5MU70QO6,13,14,1,0,0,0,2,0,17,2.4285714285714284,1,0.0,1,1,0,0,13,0,0,2,0,2,15,1
841,20735,SY8PjWAcViY3TAxvifjZF4drAUdDweaG,5Gyp41oLVo7Gg7vF4vpmggWP5MU70QO6,43,93,42,98,18,10,17,2,280,40.0,4,0.0,32,42,77,18,61,10,21,17,2,169,111,1
842,20752,HDx7XT9cwQtHtGFe0Ylk6QLaCz2f0GRa,5Gyp41oLVo7Gg7vF4vpmggWP5MU70QO6,29,126,74,57,39,149,24,3,472,67.42857142857143,12,0.0,31,74,37,39,95,149,20,24,3,181,291,0
843,20759,0W851bk6FoM6Xqxl9tkBScwPhSY3L9ta,5Gyp41oLVo7Gg7vF4vpmggWP5MU70QO6,10,6,4,0,0,0,7,2,19,2.7142857142857144,2,0.0,0,4,0,0,6,0,0,7,2,4,15,1
844,20917,O2rUq90V5lR36PY1lXYAoUFT98vBmg1w,5Gyp41oLVo7Gg7vF4vpmggWP5MU70QO6,10,19,6,0,4,0,4,0,33,4.714285714285714,3,0.0,1,6,0,4,18,0,0,4,0,11,22,0
845,20948,PuyGNo8qc6xk0x7N225chheH1U0jpEmh,5Gyp41oLVo7Gg7vF4vpmggWP5MU70QO6,12,13,4,7,4,0,8,0,36,5.142857142857143,4,0.0,2,4,5,4,11,0,2,8,0,15,21,1
846,20957,C41dmWc6HeeNkDNSm8CZALCNogkmWJ1z,5Gyp41oLVo7Gg7vF4vpmggWP5MU70QO6,9,25,0,0,0,0,7,1,33,4.714285714285714,3,0.0,1,0,0,0,24,0,0,7,1,1,32,0
847,21001,uKSoXEJNhPBaLwogtj5AI2INbh67Hhkx,5Gyp41oLVo7Gg7vF4vpmggWP5MU70QO6,7,3,2,0,2,0,2,0,9,1.2857142857142858,1,0.0,0,2,0,2,3,0,0,2,0,4,5,1
848,21017,tLP5rkZGy3HXF1Jaor7VJqja6xXsYWE2,5Gyp41oLVo7Gg7vF4vpmggWP5MU70QO6,14,21,8,10,7,0,1,0,47,6.714285714285714,1,0.0,4,8,5,7,17,0,5,1,0,24,23,0
849,21057,opH3DZ3uCmoJwuaHmCeQ8GdADxdJdHXo,5Gyp41oLVo7Gg7vF4vpmggWP5MU70QO6,6,3,2,0,2,0,1,0,8,1.1428571428571428,1,0.0,0,2,0,2,3,0,0,1,0,4,4,1
850,21064,fK0ybxlrUhmgrAr6gFQPIfSHLrJ4RdyL,5Gyp41oLVo7Gg7vF4vpmggWP5MU70QO6,20,95,38,18,20,9,25,1,206,29.428571428571427,13,0.0,37,38,12,20,58,9,6,25,1,107,99,0
851,21095,YehuiIJSKXIiDi9yLjlODMN0AsaxnPwr,5Gyp41oLVo7Gg7vF4vpmggWP5MU70QO6,13,11,4,2,4,0,3,0,24,3.4285714285714284,2,0.0,3,4,1,4,8,0,1,3,0,12,12,0
852,21097,oaoj9be4jW2Hot8wYgYrzLRvB0RU4KYy,5Gyp41oLVo7Gg7vF4vpmggWP5MU70QO6,22,48,18,14,8,0,20,0,108,15.428571428571429,14,0.0,16,18,9,8,32,0,5,20,0,51,57,0
853,21146,e12uQn96OlYfknMdqSXCXdImglIj4IRR,5Gyp41oLVo7Gg7vF4vpmggWP5MU70QO6,76,631,368,57,111,769,426,8,2370,338.57142857142856,29,0.0,113,368,42,111,518,769,15,426,8,634,1736,0
854,21152,gOLd0TJ7VBK1ACPs2m2Ll9XNi0z0ZlSW,5Gyp41oLVo7Gg7vF4vpmggWP5MU70QO6,9,4,3,0,3,0,3,0,13,1.8571428571428572,1,0.0,0,3,0,3,4,0,0,3,0,6,7,0
855,21168,7ZMduaVYihdhUAhjPf5gtCPmPeHkcI6t,5Gyp41oLVo7Gg7vF4vpmggWP5MU70QO6,25,34,15,24,6,30,9,5,123,17.571428571428573,4,0.0,10,15,13,6,24,30,11,9,5,44,79,0
856,21185,ztoDdWXOMNddavwJ1YAGprIc7Ewm1FkP,5Gyp41oLVo7Gg7vF4vpmggWP5MU70QO6,19,56,23,19,6,1,16,4,125,17.857142857142858,9,0.0,19,23,15,6,37,1,4,16,4,63,62,0
857,21187,eZgbWFMeI0otfUV1lMfDbtMKCRIv32Fs,5Gyp41oLVo7Gg7vF4vpmggWP5MU70QO6,1,0,0,0,0,0,1,0,1,0.14285714285714285,1,0.0,0,0,0,0,0,0,0,1,0,0,1,1
858,21241,QbQngQMAL3BNHIXjcg1taH4YCWBJJPbj,5Gyp41oLVo7Gg7vF4vpmggWP5MU70QO6,76,130,62,66,33,7,44,0,342,48.857142857142854,11,0.0,42,62,58,33,88,7,8,44,0,195,147,0
859,21249,ZjjzblWLBhpCB41WVkrtllAfmPXPK6bc,5Gyp41oLVo7Gg7vF4vpmggWP5MU70QO6,1,0,0,0,0,0,1,0,1,0.14285714285714285,1,0.0,0,0,0,0,0,0,0,1,0,0,1,1
860,21343,mZH0122lLzXNagyBw31ZHMe1GS3GUi9h,5Gyp41oLVo7Gg7vF4vpmggWP5MU70QO6,7,2,1,0,1,0,6,0,10,1.4285714285714286,1,0.0,0,1,0,1,2,0,0,6,0,2,8,0
861,21469,5oy5I8Xh5KkzBBzgBTkYXJ5uADqnzeVC,7GRhBDsirIGkRZBtSMEzNTyDr2JQm4xx,47,98,41,50,39,1,10,0,239,34.142857142857146,5,0.0,28,41,39,39,70,1,11,10,0,147,92,0
862,21478,43nq30xhRsgmZVAWkH8Zjb7IyZDGRDeY,7GRhBDsirIGkRZBtSMEzNTyDr2JQm4xx,55,114,36,46,44,0,8,0,248,35.42857142857143,3,0.0,58,36,40,44,56,0,6,8,0,178,70,0
863,21480,gVgKclRs9U0S4Q8p4FYoky4COwDqIiNN,7GRhBDsirIGkRZBtSMEzNTyDr2JQm4xx,38,81,24,28,14,16,13,2,178,25.428571428571427,3,0.0,34,24,15,14,47,16,13,13,2,87,91,0
864,21498,pqUcxq00SFcjmnxHDdHJfvpMD3HzyhM8,7GRhBDsirIGkRZBtSMEzNTyDr2JQm4xx,31,58,32,24,25,6,2,0,147,21.0,4,0.0,20,32,12,25,38,6,12,2,0,89,58,1
865,21499,L74tKRZpBi1qsh0NM3EwE5D87acCLK8s,7GRhBDsirIGkRZBtSMEzNTyDr2JQm4xx,41,66,28,57,14,0,14,0,179,25.571428571428573,3,0.0,28,28,47,14,38,0,10,14,0,117,62,0
866,21500,SkSNdONKSsRL2ZUQhM3bWRg6jfQsm6hV,7GRhBDsirIGkRZBtSMEzNTyDr2JQm4xx,13,18,7,0,8,0,3,0,36,5.142857142857143,2,0.0,7,7,0,8,11,0,0,3,0,22,14,1
867,21503,PUFh3BsQaDVIJMDvwsFTqkrgAzvjO9ME,7GRhBDsirIGkRZBtSMEzNTyDr2JQm4xx,13,14,9,0,4,9,6,0,42,6.0,4,0.0,2,9,0,4,12,9,0,6,0,15,27,1
868,21509,xQUfEioM1SWfzt7GPks06vCol3vnHwj2,7GRhBDsirIGkRZBtSMEzNTyDr2JQm4xx,26,27,3,6,2,1,10,0,49,7.0,1,0.0,2,3,3,2,25,1,3,10,0,10,39,1
869,21525,jx3xuttzjsapcmXloFswnvznadokOMWC,7GRhBDsirIGkRZBtSMEzNTyDr2JQm4xx,2,0,0,0,0,0,2,0,2,0.2857142857142857,1,0.0,0,0,0,0,0,0,0,2,0,0,2,1
870,21528,S5RuYbQmA5K156juNY12D97yGDmISJaQ,7GRhBDsirIGkRZBtSMEzNTyDr2JQm4xx,31,86,2,46,0,1,10,1,146,20.857142857142858,4,0.0,37,2,35,0,49,1,11,10,1,74,72,0
871,21533,zqwrod4FlqaduP76a40P1VYHXufy1EKD,7GRhBDsirIGkRZBtSMEzNTyDr2JQm4xx,3,2,1,0,0,0,2,0,5,0.7142857142857143,1,0.0,0,1,0,0,2,0,0,2,0,1,4,0
872,21542,1vc4mzvvPXHXb8S531cIWrSOSh2pxuKf,7GRhBDsirIGkRZBtSMEzNTyDr2JQm4xx,1,0,0,0,0,0,1,0,1,0.14285714285714285,1,0.0,0,0,0,0,0,0,0,1,0,0,1,1
873,21544,9yOmrZmCy5JntLIiSDxWkgYcXOxXcJja,7GRhBDsirIGkRZBtSMEzNTyDr2JQm4xx,1,0,0,0,0,0,1,0,1,0.14285714285714285,1,0.0,0,0,0,0,0,0,0,1,0,0,1,1
874,21566,r0xLQZJ7XErj8hBxXhgtLAa0ZIpucchx,7GRhBDsirIGkRZBtSMEzNTyDr2JQm4xx,16,15,5,12,3,0,1,0,36,5.142857142857143,2,0.0,9,5,6,3,6,0,6,1,0,23,13,0
875,21731,duCgCLehWZAcuj5LEq7x7sJx1orDCK54,7GRhBDsirIGkRZBtSMEzNTyDr2JQm4xx,14,11,1,0,1,0,2,0,15,2.142857142857143,2,0.0,0,1,0,1,11,0,0,2,0,2,13,1
876,21832,W5CVKONt5qsYlbCwSDDjPmuQMWPx8PFD,7GRhBDsirIGkRZBtSMEzNTyDr2JQm4xx,11,21,7,4,2,0,8,0,42,6.0,1,0.0,3,7,2,2,18,0,2,8,0,14,28,0
877,21895,kQcHT9XjbeNVxuKuAz9nk02Q91AkSUCM,7GRhBDsirIGkRZBtSMEzNTyDr2JQm4xx,12,16,5,7,3,1,2,0,34,4.857142857142857,1,0.0,10,5,6,3,6,1,1,2,0,24,10,1
878,21968,xYZJv26kEF7oZiNSoEZMnXHo33iYNlMJ,7GRhBDsirIGkRZBtSMEzNTyDr2JQm4xx,10,22,12,6,2,0,3,0,45,6.428571428571429,1,0.0,6,12,4,2,16,0,2,3,0,24,21,1
879,21998,7MDrIAC0QY6MecoCDUshePjpChHSFKAj,7GRhBDsirIGkRZBtSMEzNTyDr2JQm4xx,32,45,3,26,8,1,4,0,87,12.428571428571429,4,0.0,20,3,13,8,25,1,13,4,0,44,43,1
880,22007,eovSKdG09ZHYTXNtS1zUIy1RfsRsCibs,7GRhBDsirIGkRZBtSMEzNTyDr2JQm4xx,74,364,138,134,72,627,107,4,1446,206.57142857142858,9,0.0,142,138,93,72,222,627,41,107,4,445,1001,0
881,22020,xdfT7UfbG0ewFi6FNN3zlNGBGpobyBrO,7GRhBDsirIGkRZBtSMEzNTyDr2JQm4xx,6,5,1,0,1,0,2,0,9,1.2857142857142858,1,0.0,0,1,0,1,5,0,0,2,0,2,7,1
882,22064,CGrk3ociol4MlctElZCSqn1gSvH3cMLH,7GRhBDsirIGkRZBtSMEzNTyDr2JQm4xx,5,2,1,0,1,0,2,0,6,0.8571428571428571,1,0.0,0,1,0,1,2,0,0,2,0,2,4,1
883,22130,lw56FfuS5fUETVCyRkCnysAZop6MzvUe,7GRhBDsirIGkRZBtSMEzNTyDr2JQm4xx,1,0,0,0,0,0,1,0,1,0.14285714285714285,1,0.0,0,0,0,0,0,0,0,1,0,0,1,0
884,22139,sa9w6VcA4PxIhAJp2KzTSPJsL0X03ZNr,7GRhBDsirIGkRZBtSMEzNTyDr2JQm4xx,4,2,0,0,0,0,2,0,4,0.5714285714285714,1,0.0,0,0,0,0,2,0,0,2,0,0,4,1
885,22148,IA6nFLwiYdBOXKobyV12AjVhFzxFaVpR,7GRhBDsirIGkRZBtSMEzNTyDr2JQm4xx,27,35,20,12,10,0,8,0,85,12.142857142857142,4,0.0,11,20,6,10,24,0,6,8,0,47,38,1
886,22218,qpd1RINX0ghAugS9ZiQmRvWMQe2xJWfG,7GRhBDsirIGkRZBtSMEzNTyDr2JQm4xx,21,42,1,8,7,0,3,0,61,8.714285714285714,1,0.0,22,1,4,7,20,0,4,3,0,34,27,1
887,22281,2cexeNbOsPyJY48G2QQ55NGzjHdqCk58,7GRhBDsirIGkRZBtSMEzNTyDr2JQm4xx,5,3,1,0,1,0,2,0,7,1.0,1,0.0,0,1,0,1,3,0,0,2,0,2,5,1
888,22323,03GypNcV97nnANHSdnYU2JoGrwMsJjjG,5Gyp41oLVo7Gg7vF4vpmggWP5MU70QO6,46,168,110,55,31,232,32,4,632,90.28571428571429,8,0.0,42,110,44,31,126,232,11,32,4,227,405,0
889,22333,M5c09jIn57vzZdodGoiXc2t3GBHKnEdj,5Gyp41oLVo7Gg7vF4vpmggWP5MU70QO6,1,0,0,0,0,0,1,0,1,0.14285714285714285,1,0.0,0,0,0,0,0,0,0,1,0,0,1,1
890,22335,Tlq0qO6nXBDLjUKWSbwB4aDjlXu6yQ8B,5Gyp41oLVo7Gg7vF4vpmggWP5MU70QO6,1,0,0,0,0,0,1,0,1,0.14285714285714285,1,0.0,0,0,0,0,0,0,0,1,0,0,1,1
891,22340,n48rQnATxELZcL0zBXDCQ5sZvWdVix8A,5Gyp41oLVo7Gg7vF4vpmggWP5MU70QO6,14,21,9,8,2,14,11,4,69,9.857142857142858,3,0.0,8,9,6,2,13,14,2,11,4,25,44,1
892,22343,eATEjH6ls04OwwQEb2HkWiYXd1crpI5u,5Gyp41oLVo7Gg7vF4vpmggWP5MU70QO6,7,25,14,0,0,0,5,0,44,6.285714285714286,4,0.0,4,14,0,0,21,0,0,5,0,18,26,1
893,22380,ozDqAa9NR19upljNiYSY9USOVIbRcORV,5Gyp41oLVo7Gg7vF4vpmggWP5MU70QO6,5,2,1,0,1,0,2,0,6,0.8571428571428571,1,0.0,0,1,0,1,2,0,0,2,0,2,4,0
894,22443,EEKRPW8tn9Mg3QBn5MHwc7463f6P9lSa,5Gyp41oLVo7Gg7vF4vpmggWP5MU70QO6,4,2,0,0,0,0,4,0,6,0.8571428571428571,1,0.0,0,0,0,0,2,0,0,4,0,0,6,1
895,22456,sK6gPt4M5YY6zXFjM4ov4x53oBKBEf7K,5Gyp41oLVo7Gg7vF4vpmggWP5MU70QO6,9,13,6,0,4,0,13,0,36,5.142857142857143,4,0.0,3,6,0,4,10,0,0,13,0,13,23,1
896,22476,Q8lgDaE6CB6Qe5bNGFRY9Gtyuy1mU1jD,5Gyp41oLVo7Gg7vF4vpmggWP5MU70QO6,12,23,3,3,0,0,7,0,36,5.142857142857143,2,0.0,5,3,3,0,18,0,0,7,0,11,25,1
897,22480,3oOqBk0mNUyJOixMnwNMAtDLNYAAzxVe,5Gyp41oLVo7Gg7vF4vpmggWP5MU70QO6,11,9,6,0,2,3,4,0,24,3.4285714285714284,2,0.0,0,6,0,2,9,3,0,4,0,8,16,1
898,22515,cr5SiKXKH3eaQWReetZzUWaOld962waD,5Gyp41oLVo7Gg7vF4vpmggWP5MU70QO6,19,97,60,44,13,36,34,1,285,40.714285714285715,8,0.0,26,60,30,13,71,36,14,34,1,129,156,1
899,22516,eOxm8XEI11Xs6eiBi1Nu5QzIagZXwEm9,5Gyp41oLVo7Gg7vF4vpmggWP5MU70QO6,19,27,17,0,5,10,9,0,68,9.714285714285714,6,0.0,1,17,0,5,26,10,0,9,0,23,45,0
900,22551,62gWLZfO1hlvqiqA2FxcKx1rgbEBBe8F,5Gyp41oLVo7Gg7vF4vpmggWP5MU70QO6,1,0,0,0,0,0,1,0,1,0.14285714285714285,1,0.0,0,0,0,0,0,0,0,1,0,0,1,1
901,22581,4rwe5BmciR8qkFj7YwyJ3a5aK2xp9xod,5Gyp41oLVo7Gg7vF4vpmggWP5MU70QO6,6,4,2,0,1,0,3,0,10,1.4285714285714286,2,0.0,0,2,0,1,4,0,0,3,0,3,7,1
902,22585,HWY3GUChwPk4DS7QwwTsaS95hGhLWs4z,5Gyp41oLVo7Gg7vF4vpmggWP5MU70QO6,13,15,7,0,4,3,9,1,39,5.571428571428571,1,0.0,2,7,0,4,13,3,0,9,1,13,26,1
903,22605,PF1vEW7ED75SvwErjajgQNwE9nRveOrK,5Gyp41oLVo7Gg7vF4vpmggWP5MU70QO6,1,0,0,0,0,0,2,0,2,0.2857142857142857,1,0.0,0,0,0,0,0,0,0,2,0,0,2,0
904,22631,PFlXkj37sziMD1CZgqKLg1p2NiL2VluN,5Gyp41oLVo7Gg7vF4vpmggWP5MU70QO6,8,3,2,0,2,0,3,0,10,1.4285714285714286,1,0.0,0,2,0,2,3,0,0,3,0,4,6,1
905,22676,CMoV5dPTzwxV3W6HJJmvW8wSnp90ZPh2,SpATywNh6bZuzm8s1ceuBUnMUAeoAHHw,15,12,9,0,7,0,2,0,30,4.285714285714286,2,0.0,0,9,0,7,12,0,0,2,0,16,14,0
906,22715,3cB0rEpxJxC0jjqfQ9EPT6ntxFajOXrx,SpATywNh6bZuzm8s1ceuBUnMUAeoAHHw,15,38,18,18,3,0,8,0,85,12.142857142857142,5,0.0,8,18,15,3,30,0,3,8,0,44,41,0
907,22757,LJYBef7iIBiSZz8D7KTtMTsdkyd91gnR,SpATywNh6bZuzm8s1ceuBUnMUAeoAHHw,3,4,1,0,0,0,2,0,7,1.0,2,0.0,0,1,0,0,4,0,0,2,0,1,6,0
908,22766,BImVQpNaWI5ZZjLENiRV2V2LYkbW88m0,RXDvfPUBYFlVdlueBFbLW0mhhAyGEqpt,23,22,10,12,4,2,11,2,63,9.0,2,0.0,4,10,11,4,18,2,1,11,2,29,34,0
909,22776,jaMKMvlU4KDCkm4HrM0MWVH43rDA8rY1,A3fsA9Zfv1X2fVEQhTw51lKENdNrEqT3,7,8,6,0,2,0,2,0,18,2.5714285714285716,2,0.0,0,6,0,2,8,0,0,2,0,8,10,1
910,22787,XCY83tv4aCv2fMTPmH1QE6tZOtr7KzJT,G8EPVSXsOYB5YQWZGiz1aVq5Pgr2GrQu,11,12,9,0,0,12,8,0,41,5.857142857142857,3,0.0,0,9,0,0,12,12,0,8,0,9,32,0
911,22859,JJDRXXLRU75H8Dx2cuK7Td1V7D7QoKg9,RXDvfPUBYFlVdlueBFbLW0mhhAyGEqpt,24,47,0,0,1,13,11,4,76,10.857142857142858,4,0.0,7,0,0,1,40,13,0,11,4,8,68,0
912,22898,t2LtqHppiTuDN14mSCfUVu9qYG7mBNAD,A3fsA9Zfv1X2fVEQhTw51lKENdNrEqT3,10,9,6,0,3,0,2,0,20,2.857142857142857,2,0.0,0,6,0,3,9,0,0,2,0,9,11,0
913,22899,AoDbGxsdtQ88iavwLYzXC5a1sZ4YMkt5,SpATywNh6bZuzm8s1ceuBUnMUAeoAHHw,5,6,4,0,0,0,0,0,10,1.4285714285714286,1,0.0,1,4,0,0,5,0,0,0,0,5,5,1
914,22924,SY3KixRowLNTROWYYZsbpxNmhMe23Wc3,SpATywNh6bZuzm8s1ceuBUnMUAeoAHHw,27,46,22,0,12,0,5,0,85,12.142857142857142,1,0.0,3,22,0,12,43,0,0,5,0,37,48,1
915,22937,7mQeRnk4E67KJHDHSAp1BOWEWVuxMvA2,SpATywNh6bZuzm8s1ceuBUnMUAeoAHHw,6,7,3,0,1,0,2,0,13,1.8571428571428572,1,0.0,0,3,0,1,7,0,0,2,0,4,9,1
916,22998,nCARlKCtX8cCYdg9wv53tMq1HV8fOfAB,RXDvfPUBYFlVdlueBFbLW0mhhAyGEqpt,18,43,37,0,34,0,0,0,114,16.285714285714285,1,0.0,0,37,0,34,43,0,0,0,0,71,43,1
917,23011,Qi3PLuC7w2Yo9hFgq37MObjY8icnRdc6,A3fsA9Zfv1X2fVEQhTw51lKENdNrEqT3,96,81,39,286,17,38,10,0,471,67.28571428571429,4,0.0,8,39,232,17,73,38,54,10,0,296,175,0
918,23016,jZn0klM9Bk084k9gvux7E5DK1oO1FwuJ,SpATywNh6bZuzm8s1ceuBUnMUAeoAHHw,18,16,13,7,6,0,3,0,45,6.428571428571429,1,0.0,0,13,6,6,16,0,1,3,0,25,20,0
919,23032,UInMBEH8f1h2vxXVslRsWyLOTv8ggYq3,RXDvfPUBYFlVdlueBFbLW0mhhAyGEqpt,3,4,2,0,0,0,3,0,9,1.2857142857142858,1,0.0,0,2,0,0,4,0,0,3,0,2,7,0
920,23038,0DzldTHKdoH90kklIAjpWyAEe6XDDjyM,SpATywNh6bZuzm8s1ceuBUnMUAeoAHHw,14,60,8,12,0,5,26,0,111,15.857142857142858,8,0.0,16,8,11,0,44,5,1,26,0,35,76,0
921,23041,TJxPKDYS9NmvmYGlrCikboEkhHDTOEHy,SpATywNh6bZuzm8s1ceuBUnMUAeoAHHw,6,3,2,0,0,0,3,0,8,1.1428571428571428,1,0.0,1,2,0,0,2,0,0,3,0,3,5,0
922,23075,CUMuKIhvWkMSk50Or6FhgPf1tk7jntYp,SpATywNh6bZuzm8s1ceuBUnMUAeoAHHw,11,13,5,9,0,1,9,1,38,5.428571428571429,2,0.0,4,5,8,0,9,1,1,9,1,17,21,0
923,23097,5wbqpjsRycE3Ij1gukLWuLp8it7vr80U,SpATywNh6bZuzm8s1ceuBUnMUAeoAHHw,15,31,21,11,0,12,5,0,80,11.428571428571429,3,0.0,7,21,10,0,24,12,1,5,0,38,42,1
924,23142,6j5Aoj3JOkcTRkyfXNVtTy229CS4uihi,G8EPVSXsOYB5YQWZGiz1aVq5Pgr2GrQu,24,19,15,6,9,0,4,0,53,7.571428571428571,2,0.0,1,15,5,9,18,0,1,4,0,30,23,0
925,23183,HycevJIm7cBjf1oJ5QCBMMXEBTG8jyRF,A3fsA9Zfv1X2fVEQhTw51lKENdNrEqT3,108,65,38,228,21,0,14,0,366,52.285714285714285,5,0.0,14,38,175,21,51,0,53,14,0,248,118,0
926,23185,HycevJIm7cBjf1oJ5QCBMMXEBTG8jyRF,bWdj2GDclj5ofokWjzoa5jAwMkxCykd6,15,8,5,28,0,0,3,0,44,6.285714285714286,3,0.0,0,5,27,0,8,0,1,3,0,32,12,0
927,23197,BDdKHYPp1edgylVPYUBHaWJ6W3VobGdR,SpATywNh6bZuzm8s1ceuBUnMUAeoAHHw,6,9,0,0,0,0,2,0,11,1.5714285714285714,1,0.0,0,0,0,0,9,0,0,2,0,0,11,1
928,23201,mE5coXp72CvzVrqwpPF6wLVZrHDH0Vlq,SpATywNh6bZuzm8s1ceuBUnMUAeoAHHw,9,29,8,0,0,0,18,0,55,7.857142857142857,6,0.0,0,8,0,0,29,0,0,18,0,8,47,0
929,23251,bzY7Zh4yWh2gGtmeq5pe4zgMiusHTGEG,SpATywNh6bZuzm8s1ceuBUnMUAeoAHHw,7,7,1,0,1,0,1,0,10,1.4285714285714286,1,0.0,2,1,0,1,5,0,0,1,0,4,6,0
930,23299,FuoDsqlUs6ZIyTkMTIVnWx4xFWKln8DR,SpATywNh6bZuzm8s1ceuBUnMUAeoAHHw,22,24,13,14,6,0,3,0,60,8.571428571428571,3,0.0,6,13,12,6,18,0,2,3,0,37,23,0
931,23316,QdSH85e6TVvHCb4lCpuXbYzwkD8QbL3t,G8EPVSXsOYB5YQWZGiz1aVq5Pgr2GrQu,21,42,23,0,14,0,3,0,82,11.714285714285714,4,0.0,0,23,0,14,42,0,0,3,0,37,45,0
932,23332,V1z8w9SjLbULVqlANveH3qv7vwfEbAs7,A3fsA9Zfv1X2fVEQhTw51lKENdNrEqT3,27,34,23,10,13,0,26,0,106,15.142857142857142,4,0.0,2,23,9,13,32,0,1,26,0,47,59,0
933,23401,xMuijSepoYpWnTVSuzhdordHJTyRt87I,SpATywNh6bZuzm8s1ceuBUnMUAeoAHHw,13,10,7,11,0,15,2,0,45,6.428571428571429,1,0.0,2,7,10,0,8,15,1,2,0,19,26,1
934,23403,GWG8afsUfRei9CIZYg1Y2sBsF64D5J9k,A3fsA9Zfv1X2fVEQhTw51lKENdNrEqT3,42,25,12,66,9,0,5,0,117,16.714285714285715,3,0.0,1,12,56,9,24,0,10,5,0,78,39,0
935,23458,cAyxesGtWW4tBzueSc3JcCfBcF1iSxzo,SpATywNh6bZuzm8s1ceuBUnMUAeoAHHw,15,22,12,0,6,0,4,0,44,6.285714285714286,3,0.0,0,12,0,6,22,0,0,4,0,18,26,0
936,23502,wNbKFPX6oYsfVEr8buyWthBblPuPZGxv,A3fsA9Zfv1X2fVEQhTw51lKENdNrEqT3,43,22,14,70,8,13,2,0,129,18.428571428571427,1,0.0,6,14,60,8,16,13,10,2,0,88,41,0
937,23530,CfoeUJ6vk7a3PuEp1yrQNFUplkLjQYge,SpATywNh6bZuzm8s1ceuBUnMUAeoAHHw,29,35,21,29,10,6,4,0,105,15.0,3,0.0,8,21,26,10,27,6,3,4,0,65,40,0
938,23541,ACrAvl4ssWNFndB2wDhI3oY0Vqi5B1FR,SpATywNh6bZuzm8s1ceuBUnMUAeoAHHw,31,26,20,16,9,0,3,0,74,10.571428571428571,3,0.0,4,20,14,9,22,0,2,3,0,47,27,0
939,23557,M6VmJD8JYDR5w6GV5uzAgWpIXM5eanml,SpATywNh6bZuzm8s1ceuBUnMUAeoAHHw,23,47,18,3,8,0,4,0,80,11.428571428571429,3,0.0,0,18,3,8,47,0,0,4,0,29,51,0
940,23589,mptZxS2IRXAopBdChMP75EgVt5rtRsUT,SpATywNh6bZuzm8s1ceuBUnMUAeoAHHw,17,11,7,12,6,0,1,0,37,5.285714285714286,1,0.0,2,7,10,6,9,0,2,1,0,25,12,1
941,23616,VADc1m6JjTG2LuLkbhEfhADWJMHaDmqK,SpATywNh6bZuzm8s1ceuBUnMUAeoAHHw,21,56,31,22,11,0,11,0,131,18.714285714285715,7,0.0,17,31,16,11,39,0,6,11,0,75,56,0
942,23621,HRaTe8gWBsDiLkzfbQMnooVDWfwWVb7m,SpATywNh6bZuzm8s1ceuBUnMUAeoAHHw,33,71,4,27,2,22,15,1,142,20.285714285714285,4,0.0,9,4,24,2,62,22,3,15,1,39,103,0
943,23642,04gG5zVwZ7Vr68t1LtjimV9KPqGTDxDK,SpATywNh6bZuzm8s1ceuBUnMUAeoAHHw,19,20,12,16,7,0,7,0,62,8.857142857142858,2,0.0,2,12,14,7,18,0,2,7,0,35,27,0
944,23651,35E85h2ExBPeTd1VmxNX0GKo8krIMsCP,RXDvfPUBYFlVdlueBFbLW0mhhAyGEqpt,3,2,1,0,0,0,2,0,5,0.7142857142857143,1,0.0,0,1,0,0,2,0,0,2,0,1,4,1
945,23667,1NMKv7RE12uBMKwNJI30Cx8Z5ltMGoee,SpATywNh6bZuzm8s1ceuBUnMUAeoAHHw,5,3,1,0,1,0,1,0,6,0.8571428571428571,1,0.0,0,1,0,1,3,0,0,1,0,2,4,0
946,23672,F9d8ehlFxvqouYiZgUKxdbX5NI44Sbpl,SpATywNh6bZuzm8s1ceuBUnMUAeoAHHw,19,23,14,13,5,0,6,0,61,8.714285714285714,2,0.0,2,14,11,5,21,0,2,6,0,32,29,1
947,23699,jM1yIagOMV2CwD8o07UMrVdo7z0hqKJ4,bWdj2GDclj5ofokWjzoa5jAwMkxCykd6,3,4,2,0,0,0,2,0,8,1.1428571428571428,2,0.0,0,2,0,0,4,0,0,2,0,2,6,0
948,23724,wQU3lY7mCoAWFqnxNLhiEFrdAWtS5Hh9,SpATywNh6bZuzm8s1ceuBUnMUAeoAHHw,12,13,1,4,0,3,4,0,25,3.5714285714285716,2,0.0,0,1,4,0,13,3,0,4,0,5,20,0
949,23772,bQK35cKsW9Hy5fNgckzz4Jo7bFzQOyma,G8EPVSXsOYB5YQWZGiz1aVq5Pgr2GrQu,39,35,9,88,4,9,12,0,157,22.428571428571427,1,0.0,21,9,67,4,14,9,21,12,0,101,56,0
950,23818,oAs7swdosdDbKq3u64wlCP6EHVlCh67P,bWdj2GDclj5ofokWjzoa5jAwMkxCykd6,5,4,2,0,1,0,1,0,8,1.1428571428571428,1,0.0,0,2,0,1,4,0,0,1,0,3,5,1
951,23839,xHZbSROhwP4RRQerUVWvcNTfOGc2DHWf,bWdj2GDclj5ofokWjzoa5jAwMkxCykd6,12,35,17,0,6,1,17,0,76,10.857142857142858,8,0.0,0,17,0,6,35,1,0,17,0,23,53,0
952,23859,XNb7KU6KeHuNJzclGX2ePynnmu8yxV3v,SpATywNh6bZuzm8s1ceuBUnMUAeoAHHw,25,35,3,15,3,5,6,0,67,9.571428571428571,2,0.0,3,3,11,3,32,5,4,6,0,20,47,0
953,23962,5pjAdY5K4FfgQPLSzQKwXaKF78ph9a0y,RXDvfPUBYFlVdlueBFbLW0mhhAyGEqpt,69,205,123,120,55,49,53,18,623,89.0,7,0.0,33,123,104,55,172,49,16,53,18,315,308,0
954,23984,HAPPxnLUjIhcauBZnnWBFk3JE6gETTxa,SpATywNh6bZuzm8s1ceuBUnMUAeoAHHw,9,13,3,10,0,0,2,0,28,4.0,1,0.0,9,3,10,0,4,0,0,2,0,22,6,1
955,23994,AkYabqnQmQubmhD6vLFPcIqa194wOTvs,SpATywNh6bZuzm8s1ceuBUnMUAeoAHHw,3,2,0,0,0,0,2,0,4,0.5714285714285714,1,0.0,0,0,0,0,2,0,0,2,0,0,4,1
956,24000,tML4IQ8jFiP4YuH9NbvzKQFqAdof0qcO,SpATywNh6bZuzm8s1ceuBUnMUAeoAHHw,16,28,0,14,0,0,6,0,48,6.857142857142857,2,0.0,8,0,12,0,20,0,2,6,0,20,28,0
957,24021,wPWqnGAkrR45TEYOXZpjGrKRubMl9rFP,SpATywNh6bZuzm8s1ceuBUnMUAeoAHHw,3,6,0,0,0,0,3,0,9,1.2857142857142858,3,0.0,0,0,0,0,6,0,0,3,0,0,9,0
958,24024,OIPBfPb9802WcbHz02njDB4ysP5ao9fe,SpATywNh6bZuzm8s1ceuBUnMUAeoAHHw,7,13,2,0,0,3,4,0,22,3.142857142857143,2,0.0,0,2,0,0,13,3,0,4,0,2,20,0
959,24025,REvshIGXuaBWprkQ9qA5D33qmf3QiAwV,SpATywNh6bZuzm8s1ceuBUnMUAeoAHHw,4,2,1,0,0,0,2,0,5,0.7142857142857143,1,0.0,0,1,0,0,2,0,0,2,0,1,4,0
960,24076,hWoXRoePYaW50QNR65rI6g0ffdFAubIq,SpATywNh6bZuzm8s1ceuBUnMUAeoAHHw,21,22,13,9,5,0,6,2,57,8.142857142857142,2,0.0,3,13,8,5,19,0,1,6,2,29,28,1
961,24086,wx9LUKj4KCj2VrJqkWxv5NlmYX9Bw5rx,RXDvfPUBYFlVdlueBFbLW0mhhAyGEqpt,17,61,7,0,2,0,8,0,78,11.142857142857142,2,0.0,0,7,0,2,61,0,0,8,0,9,69,1
962,24122,4e4wTy2Vsuz8jVFYgJOgi1kIGDWREiPH,bWdj2GDclj5ofokWjzoa5jAwMkxCykd6,52,82,35,119,8,88,8,0,340,48.57142857142857,3,0.0,19,35,101,8,63,88,18,8,0,163,177,0
963,24138,tCb9JPhOhIatDlJOcmjorPeSIRsd6N1b,SpATywNh6bZuzm8s1ceuBUnMUAeoAHHw,6,10,0,0,0,0,4,0,14,2.0,1,0.0,4,0,0,0,6,0,0,4,0,4,10,0
964,24287,Ms0MC4W5moiGJLWP7iE3FImeH9CHN4KT,bWdj2GDclj5ofokWjzoa5jAwMkxCykd6,12,13,1,0,1,0,3,0,18,2.5714285714285716,2,0.0,4,1,0,1,9,0,0,3,0,6,12,0
965,24303,pYcnIzYPgb3xzrOvmR9y0UUIZo4gqKuO,RXDvfPUBYFlVdlueBFbLW0mhhAyGEqpt,45,51,38,66,14,0,5,0,174,24.857142857142858,3,0.0,8,38,57,14,43,0,9,5,0,117,57,0
966,24304,UzwJVyLJF6Ih9iHYPyYWMullgIr89o5m,RXDvfPUBYFlVdlueBFbLW0mhhAyGEqpt,40,80,42,58,14,0,9,0,203,29.0,4,0.0,19,42,55,14,61,0,3,9,0,130,73,0
967,24312,wGN3pCdk72KFTm52vXIRH474TFtQqduI,SpATywNh6bZuzm8s1ceuBUnMUAeoAHHw,16,11,8,15,5,0,2,0,41,5.857142857142857,1,0.0,2,8,14,5,9,0,1,2,0,29,12,0
968,24325,bPrEBQILvyBjp3odJGGZ7KxlAV5Gu9sz,SpATywNh6bZuzm8s1ceuBUnMUAeoAHHw,22,61,33,6,11,6,17,1,135,19.285714285714285,3,0.0,20,33,6,11,41,6,0,17,1,70,65,0
969,24370,nuKEM7FMFD9npzL9DafH3T1pYgMoLJoQ,SpATywNh6bZuzm8s1ceuBUnMUAeoAHHw,5,6,2,0,0,0,1,0,9,1.2857142857142858,1,0.0,0,2,0,0,6,0,0,1,0,2,7,0
970,24388,4v506xwnN2gFG9XeSNIeiBlmXImooi1O,SpATywNh6bZuzm8s1ceuBUnMUAeoAHHw,25,37,21,11,9,0,3,0,81,11.571428571428571,1,0.0,11,21,11,9,26,0,0,3,0,52,29,0
971,24444,mFNGHC6aCmhHmhRXFCDO0uvnGnNYaro0,A3fsA9Zfv1X2fVEQhTw51lKENdNrEqT3,3,2,1,0,0,0,1,0,4,0.5714285714285714,1,0.0,0,1,0,0,2,0,0,1,0,1,3,1
972,24481,MlSRfdfvLbnwipGT1vckZAUcsWbqV0Nz,bWdj2GDclj5ofokWjzoa5jAwMkxCykd6,19,5,0,56,0,0,8,0,69,9.857142857142858,3,0.0,2,0,51,0,3,0,5,8,0,53,16,0
973,24518,iXoEMwcJ5o4IM7VKZ5pyam9GxPy4olUQ,A3fsA9Zfv1X2fVEQhTw51lKENdNrEqT3,1,0,0,0,0,0,1,0,1,0.14285714285714285,1,0.0,0,0,0,0,0,0,0,1,0,0,1,1
974,24521,iXoEMwcJ5o4IM7VKZ5pyam9GxPy4olUQ,SpATywNh6bZuzm8s1ceuBUnMUAeoAHHw,19,83,26,0,0,0,1,0,110,15.714285714285714,1,0.0,5,26,0,0,78,0,0,1,0,31,79,1
975,24527,iXoEMwcJ5o4IM7VKZ5pyam9GxPy4olUQ,RXDvfPUBYFlVdlueBFbLW0mhhAyGEqpt,2,0,0,0,0,0,2,0,2,0.2857142857142857,1,0.0,0,0,0,0,0,0,0,2,0,0,2,1
976,24629,ja7eUjcxSqFnoRSNZAdtMUdo5WLyuwNj,RXDvfPUBYFlVdlueBFbLW0mhhAyGEqpt,5,5,3,0,0,0,4,0,12,1.7142857142857142,2,0.0,0,3,0,0,5,0,0,4,0,3,9,1
977,24630,oeteUY6248o0vNNJe36iI7NqucdIsIE6,5X6FeZozNMgE2VRi3MJYjkkFK8SETtu2,19,43,22,24,16,9,21,2,137,19.571428571428573,3,0.0,9,22,18,16,34,9,6,21,2,65,72,1
978,24631,IZ5pWpBLzW50MjCCGxCjTz4w6DVz2MU3,SpATywNh6bZuzm8s1ceuBUnMUAeoAHHw,62,109,47,48,32,7,13,1,257,36.714285714285715,6,0.0,20,47,36,32,89,7,12,13,1,135,122,0
979,24637,nyMA2zBXYm7HuZBPBaIREWxpIzdCqsDv,G8EPVSXsOYB5YQWZGiz1aVq5Pgr2GrQu,38,73,25,72,11,0,3,0,184,26.285714285714285,2,0.0,25,25,56,11,48,0,16,3,0,117,67,0
980,24645,0JvlwMe8wRQNeLJu71UvJCaEJca2naUP,bWdj2GDclj5ofokWjzoa5jAwMkxCykd6,4,4,3,0,0,0,2,0,9,1.2857142857142858,1,0.0,0,3,0,0,4,0,0,2,0,3,6,0
981,24648,OYHp1KsItSZuhDkN8owngXagZYO1vfvR,RXDvfPUBYFlVdlueBFbLW0mhhAyGEqpt,1,0,0,0,0,0,3,0,3,0.42857142857142855,1,0.0,0,0,0,0,0,0,0,3,0,0,3,1
982,24674,99qhCmy07rsquumjTFRELTtrLHpQpj07,bWdj2GDclj5ofokWjzoa5jAwMkxCykd6,2,0,0,0,0,0,4,0,4,0.5714285714285714,1,0.0,0,0,0,0,0,0,0,4,0,0,4,0
983,24702,VPT5ZBddqdKmipdjPIcaTABROj9B5qkg,bWdj2GDclj5ofokWjzoa5jAwMkxCykd6,6,7,6,0,1,1,0,0,15,2.142857142857143,2,0.0,0,6,0,1,7,1,0,0,0,7,8,0
984,24713,oORHpMno9LEiGfE2mvfpDDWKt1abfinf,5X6FeZozNMgE2VRi3MJYjkkFK8SETtu2,3,2,1,0,0,0,1,0,4,0.5714285714285714,1,0.0,0,1,0,0,2,0,0,1,0,1,3,1
985,24748,8QeNBSoAmfuMMwnfjCjhlHJfHWJb6Z8j,SpATywNh6bZuzm8s1ceuBUnMUAeoAHHw,1,0,0,0,0,0,1,0,1,0.14285714285714285,1,0.0,0,0,0,0,0,0,0,1,0,0,1,1
986,24751,xeqerqtfOXdU1SxllK1RhCIMXKtA9tQH,SpATywNh6bZuzm8s1ceuBUnMUAeoAHHw,8,11,7,0,4,0,6,0,28,4.0,3,0.0,0,7,0,4,11,0,0,6,0,11,17,0
987,24760,NVJD7a4veZi4dOPtkddbSAsIN5dFV8jt,SpATywNh6bZuzm8s1ceuBUnMUAeoAHHw,6,5,2,0,1,0,4,0,12,1.7142857142857142,3,0.0,0,2,0,1,5,0,0,4,0,3,9,0
988,24775,FeUvHE3xENj0OT6fhaRqvHDDKwwtsMRR,SpATywNh6bZuzm8s1ceuBUnMUAeoAHHw,18,18,11,13,5,0,5,0,52,7.428571428571429,3,0.0,2,11,12,5,16,0,1,5,0,30,22,0
989,24779,8z0bBeHIqg82ZVTL51Hja0n0njQMZcyC,5X6FeZozNMgE2VRi3MJYjkkFK8SETtu2,3,0,0,0,0,0,6,0,6,0.8571428571428571,1,0.0,0,0,0,0,0,0,0,6,0,0,6,1
990,24780,teqJGecOr4a6oVYU1O9bgvPkX5ZSKA8N,5X6FeZozNMgE2VRi3MJYjkkFK8SETtu2,32,60,10,33,11,0,15,0,129,18.428571428571427,7,0.0,16,10,29,11,44,0,4,15,0,66,63,1
991,24787,I2CVLqjSbklpRSQ1uckbwTf2kYu0wpRa,SpATywNh6bZuzm8s1ceuBUnMUAeoAHHw,36,31,19,40,12,0,4,0,106,15.142857142857142,3,0.0,8,19,36,12,23,0,4,4,0,75,31,1
992,24800,Di5QBu2p7TPbC0Y3BSJlyWARS6AhJ7rP,RXDvfPUBYFlVdlueBFbLW0mhhAyGEqpt,8,11,1,0,1,0,2,0,15,2.142857142857143,2,0.0,2,1,0,1,9,0,0,2,0,4,11,0
993,24821,2Hx9g01WcHXaoIvHRFrUfZqDWuVhvV5b,SpATywNh6bZuzm8s1ceuBUnMUAeoAHHw,34,134,58,33,20,17,32,1,295,42.142857142857146,9,0.0,29,58,30,20,105,17,3,32,1,137,158,0
994,24827,we18sTRqUifMn6WUmAqDbzypSRsCwq5X,SpATywNh6bZuzm8s1ceuBUnMUAeoAHHw,63,217,71,65,31,94,25,2,505,72.14285714285714,6,0.0,34,71,61,31,183,94,4,25,2,197,308,0
995,24831,hqh6ySViVHtgDq8aiHphVYPr16SuPhaK,A3fsA9Zfv1X2fVEQhTw51lKENdNrEqT3,9,9,0,0,0,1,5,1,16,2.2857142857142856,2,0.0,0,0,0,0,9,1,0,5,1,0,16,1
996,24844,4R3vIXDDqstJCBTEM96a5Mzkiuubyd9v,bWdj2GDclj5ofokWjzoa5jAwMkxCykd6,8,8,1,0,1,0,9,1,20,2.857142857142857,2,0.0,4,1,0,1,4,0,0,9,1,6,14,1
997,24847,IhWjcgRzoXcWcgj0TSEsE1klKuKl9aDP,G8EPVSXsOYB5YQWZGiz1aVq5Pgr2GrQu,8,15,14,0,12,0,0,0,41,5.857142857142857,4,0.0,0,14,0,12,15,0,0,0,0,26,15,0
998,24860,FPPbdZs5zRERbNXCB9udITtxlck6dBd9,SpATywNh6bZuzm8s1ceuBUnMUAeoAHHw,14,14,0,10,0,7,2,0,33,4.714285714285714,1,0.0,3,0,10,0,11,7,0,2,0,13,20,0
999,24875,97rJErYjCaSZkM2sQr4Hy3em0yNLLl9Z,7GRhBDsirIGkRZBtSMEzNTyDr2JQm4xx,19,47,9,44,2,1,3,0,106,15.142857142857142,1,0.0,18,9,38,2,29,1,6,3,0,67,39,0
1000,24883,DLDhUvvvfnnYFJuV65Zt2yaS0jPJgvzq,A3fsA9Zfv1X2fVEQhTw51lKENdNrEqT3,7,14,0,0,0,1,18,0,33,4.714285714285714,4,0.0,0,0,0,0,14,1,0,18,0,0,33,0
1001,24911,IZHsTsrBUkoyBqF03uelIuzBd5mdFnWL,RXDvfPUBYFlVdlueBFbLW0mhhAyGEqpt,3,2,0,0,0,0,2,0,4,0.5714285714285714,2,0.0,0,0,0,0,2,0,0,2,0,0,4,1
1002,24924,IcgEG8I6oXszRO6jfoKDYvphefvau1gV,SpATywNh6bZuzm8s1ceuBUnMUAeoAHHw,8,5,3,0,2,0,3,0,13,1.8571428571428572,1,0.0,0,3,0,2,5,0,0,3,0,5,8,1
1003,24960,JtMmp5BCDQnYE7CMI3NvnX4aRCZsQW9K,5X6FeZozNMgE2VRi3MJYjkkFK8SETtu2,1,0,0,0,0,0,1,0,1,0.14285714285714285,1,0.0,0,0,0,0,0,0,0,1,0,0,1,1
1004,24961,qXE8lsczz46VcSqxKdxLlIZNzChQNDah,SpATywNh6bZuzm8s1ceuBUnMUAeoAHHw,32,74,1,45,1,12,14,3,150,21.428571428571427,3,0.0,14,1,40,1,60,12,5,14,3,56,94,0
1005,25008,AlPSASl29ys7OO31KpYSADARO0IiSNGm,SpATywNh6bZuzm8s1ceuBUnMUAeoAHHw,13,9,8,0,5,0,1,0,23,3.2857142857142856,1,0.0,0,8,0,5,9,0,0,1,0,13,10,1
1006,25025,Kv8WT2LoDrISf4mI4ty4secTsdpqqYdt,G8EPVSXsOYB5YQWZGiz1aVq5Pgr2GrQu,4,2,1,0,1,0,1,0,5,0.7142857142857143,1,0.0,0,1,0,1,2,0,0,1,0,2,3,1
1007,25047,e8HsYbNWN6cCQbTmxFf7TraoRlE6iBxd,A3fsA9Zfv1X2fVEQhTw51lKENdNrEqT3,105,101,68,254,45,2,24,0,494,70.57142857142857,7,0.0,3,68,236,45,98,2,18,24,0,352,142,0
1008,25057,dOTfu9ZEDKw8CtbNBtHrVvUlMG00Zoil,SpATywNh6bZuzm8s1ceuBUnMUAeoAHHw,17,19,12,2,8,0,5,0,46,6.571428571428571,4,0.0,1,12,2,8,18,0,0,5,0,23,23,0
1009,25061,38evuz11qT1yopNFOWEFJXqo6AKQdprx,5X6FeZozNMgE2VRi3MJYjkkFK8SETtu2,63,96,6,107,24,0,11,9,253,36.142857142857146,4,0.0,57,6,87,24,39,0,20,11,9,174,79,0
1010,25086,ljqvAdk5ocV9irAsEHJ87jRvF9JOTCHu,SpATywNh6bZuzm8s1ceuBUnMUAeoAHHw,19,53,23,14,5,0,17,0,112,16.0,6,0.0,13,23,13,5,40,0,1,17,0,54,58,1
1011,25128,5ysSxswt94Gjj7n5OSEcRzDBWhgbKFUg,SpATywNh6bZuzm8s1ceuBUnMUAeoAHHw,32,28,16,17,10,0,4,0,75,10.714285714285714,4,0.0,8,16,16,10,20,0,1,4,0,50,25,0
1012,25140,s4t4u8r9weCt43Z5PXbFAgqmS5WJ6hj5,G8EPVSXsOYB5YQWZGiz1aVq5Pgr2GrQu,13,18,2,16,1,0,5,0,42,6.0,3,0.0,5,2,10,1,13,0,6,5,0,18,24,1
1013,25180,WPsBmScSkhBvWYkbz4VrY2pkOYr1mtCM,5X6FeZozNMgE2VRi3MJYjkkFK8SETtu2,11,22,3,0,2,0,25,6,58,8.285714285714286,4,0.0,4,3,0,2,18,0,0,25,6,9,49,1
1014,25187,hLAgP9b2jcQPOkjXyGWK7ubP9Fw7WnRM,SpATywNh6bZuzm8s1ceuBUnMUAeoAHHw,6,1,0,0,0,2,4,0,7,1.0,1,0.0,0,0,0,0,1,2,0,4,0,0,7,1
1015,25196,3Oka5GvBd9TakXRvr9D5vxoJEhxwuxJA,RXDvfPUBYFlVdlueBFbLW0mhhAyGEqpt,63,74,52,152,13,9,9,1,310,44.285714285714285,4,0.0,15,52,140,13,59,9,12,9,1,220,90,0
1016,25206,36GRXkIW2SpIWQz7gvMq2JRXacytqSzV,SpATywNh6bZuzm8s1ceuBUnMUAeoAHHw,12,21,12,0,6,0,5,0,44,6.285714285714286,3,0.0,2,12,0,6,19,0,0,5,0,20,24,0
1017,25216,di4VZBCNKfO3i72Xmq3X7LaoJf3R5cWe,SpATywNh6bZuzm8s1ceuBUnMUAeoAHHw,19,16,5,34,1,0,6,0,62,8.857142857142858,2,0.0,7,5,34,1,9,0,0,6,0,47,15,0
1018,25236,JmXGzVVfQa5TXaQwtZdggsgBkbZbIeH5,bWdj2GDclj5ofokWjzoa5jAwMkxCykd6,46,27,18,99,7,0,2,0,153,21.857142857142858,2,0.0,7,18,80,7,20,0,19,2,0,112,41,0
1019,25276,njVv4R6ptnKvcbEeNw52SkPNx5KL1jie,SpATywNh6bZuzm8s1ceuBUnMUAeoAHHw,55,39,30,25,20,0,5,0,119,17.0,4,0.0,6,30,24,20,33,0,1,5,0,80,39,0
1020,25282,IePFEx0pR5xLGQlWWjU59zR6qxTHOeo0,A3fsA9Zfv1X2fVEQhTw51lKENdNrEqT3,87,195,73,0,44,0,31,0,343,49.0,7,0.0,0,73,0,44,195,0,0,31,0,117,226,0
1021,25289,YfHmALaAUVJkTXPVPoa3sijNQuWgYS7R,SpATywNh6bZuzm8s1ceuBUnMUAeoAHHw,18,23,11,7,5,0,4,0,50,7.142857142857143,2,0.0,8,11,7,5,15,0,0,4,0,31,19,0
1022,25292,ETzcC9n39CwhBb4MTbqq1Ng4NqGIoiPj,A3fsA9Zfv1X2fVEQhTw51lKENdNrEqT3,3,2,1,0,0,0,1,0,4,0.5714285714285714,1,0.0,0,1,0,0,2,0,0,1,0,1,3,1
1023,25311,yG8wEEmCuC5YTy4CQDGA5I639Z9JzSu0,SpATywNh6bZuzm8s1ceuBUnMUAeoAHHw,11,10,5,0,4,0,1,0,20,2.857142857142857,1,0.0,0,5,0,4,10,0,0,1,0,9,11,1
1024,25333,SIdEQEXoagJ5WwAcAkPtkVF6pipatiIa,A3fsA9Zfv1X2fVEQhTw51lKENdNrEqT3,30,34,16,0,13,0,4,0,67,9.571428571428571,3,0.0,2,16,0,13,32,0,0,4,0,31,36,0
1025,25337,CZUZ5gxFyc2McH1tEW3brsCqSoaAYd4n,G8EPVSXsOYB5YQWZGiz1aVq5Pgr2GrQu,1,0,0,0,0,0,1,0,1,0.14285714285714285,1,0.0,0,0,0,0,0,0,0,1,0,0,1,1
1026,25362,5wDUV9eufUWwuEFkF2r5hVPvdmezPjXY,SpATywNh6bZuzm8s1ceuBUnMUAeoAHHw,7,5,4,0,3,0,2,0,14,2.0,1,0.0,0,4,0,3,5,0,0,2,0,7,7,1
1027,25380,hGzoosS2IrdNGucTc4VvSDpEfSFx1kOZ,5X6FeZozNMgE2VRi3MJYjkkFK8SETtu2,3,2,1,0,0,0,4,0,7,1.0,1,0.0,0,1,0,0,2,0,0,4,0,1,6,1
1028,25416,RyJBTIZudHI18CHfqwWV9lrFHUkffvwx,SpATywNh6bZuzm8s1ceuBUnMUAeoAHHw,33,58,24,16,11,0,10,0,119,17.0,2,0.0,7,24,15,11,51,0,1,10,0,57,62,1
1029,25420,jNRA434lMAMZjPiQhPmaP5pXlW3ni5X9,SpATywNh6bZuzm8s1ceuBUnMUAeoAHHw,7,3,2,0,2,0,2,0,9,1.2857142857142858,2,0.0,0,2,0,2,3,0,0,2,0,4,5,1
1030,25468,7e4M5QQTsLcXzFpcPHrVWPenswbNvayx,5X6FeZozNMgE2VRi3MJYjkkFK8SETtu2,2,0,0,0,0,0,4,0,4,0.5714285714285714,2,0.0,0,0,0,0,0,0,0,4,0,0,4,1
1031,25481,nXaqEEEC1RuDpdV8FF2KPpkhT6oc7g9j,bWdj2GDclj5ofokWjzoa5jAwMkxCykd6,12,14,6,24,4,1,12,0,61,8.714285714285714,2,0.0,5,6,21,4,9,1,3,12,0,36,25,1
1032,25508,ymIU6ycPRruHx8VRvXTFr9yvjJtz8pmG,SpATywNh6bZuzm8s1ceuBUnMUAeoAHHw,20,21,9,17,3,9,5,0,64,9.142857142857142,3,0.0,5,9,16,3,16,9,1,5,0,33,31,0
1033,25510,SXQudUQxotVyHX3jIj58IdonMUWj4z4L,SpATywNh6bZuzm8s1ceuBUnMUAeoAHHw,25,63,34,20,12,5,19,3,156,22.285714285714285,6,0.0,16,34,17,12,47,5,3,19,3,79,77,0
1034,25518,Vrjrap5JcUBcGnZI9GyoeJ8llD9p1BxJ,G8EPVSXsOYB5YQWZGiz1aVq5Pgr2GrQu,106,92,76,0,56,7,41,4,276,39.42857142857143,7,0.0,5,76,0,56,87,7,0,41,4,137,139,0
1035,25549,ilsWvfOwvBDq0ZQxDoerp77CgQs3yFBs,SpATywNh6bZuzm8s1ceuBUnMUAeoAHHw,21,25,15,5,7,0,8,0,60,8.571428571428571,4,0.0,0,15,5,7,25,0,0,8,0,27,33,0
1036,25577,s5bmHBniKJzstjkFlsJcJn6YQEnj7XjP,RXDvfPUBYFlVdlueBFbLW0mhhAyGEqpt,10,12,5,9,3,0,3,0,32,4.571428571428571,2,0.0,1,5,9,3,11,0,0,3,0,18,14,1
1037,25581,8eVt8Ny7RBlThXRzjRM9qg0Q2kL5QEc7,SpATywNh6bZuzm8s1ceuBUnMUAeoAHHw,1,0,0,0,0,0,1,0,1,0.14285714285714285,1,0.0,0,0,0,0,0,0,0,1,0,0,1,1
1038,25593,BiaPgBnlrEY2EiwA20PKZL3VeANI5Sfw,SpATywNh6bZuzm8s1ceuBUnMUAeoAHHw,6,7,3,0,1,0,1,0,12,1.7142857142857142,1,0.0,3,3,0,1,4,0,0,1,0,7,5,1
1039,25612,Cft94WQ1J7ZOP8ubrVNkQTUMHNF32NER,SpATywNh6bZuzm8s1ceuBUnMUAeoAHHw,19,70,28,12,1,2,15,1,129,18.428571428571427,3,0.0,14,28,10,1,56,2,2,15,1,53,76,0
1040,25633,LeLXLvHK2djzEG514AFcju6wr7gFXkH2,SpATywNh6bZuzm8s1ceuBUnMUAeoAHHw,9,14,8,0,0,0,2,0,24,3.4285714285714284,1,0.0,5,8,0,0,9,0,0,2,0,13,11,1
1041,25637,zrKKa8AP5la65fKoXkp4sUMfYYb2eAtF,G8EPVSXsOYB5YQWZGiz1aVq5Pgr2GrQu,15,26,3,0,1,1,9,0,40,5.714285714285714,4,0.0,0,3,0,1,26,1,0,9,0,4,36,1
1042,25652,HrUHfBacH3u3gfsauI41ANlvNzWZshRh,A3fsA9Zfv1X2fVEQhTw51lKENdNrEqT3,104,67,35,450,24,0,13,0,589,84.14285714285714,3,0.0,3,35,397,24,64,0,53,13,0,459,130,0
1043,25653,TJlb1m2PM0vBaKFhpndqRNwoSVpMlE8f,A3fsA9Zfv1X2fVEQhTw51lKENdNrEqT3,42,25,9,111,4,0,8,0,157,22.428571428571427,2,0.0,3,9,97,4,22,0,14,8,0,113,44,1
1044,25658,HlYiU2TA92it9HWOPDlsBmlpdZ7J7QTJ,bWdj2GDclj5ofokWjzoa5jAwMkxCykd6,7,5,0,0,0,0,2,0,7,1.0,1,0.0,0,0,0,0,5,0,0,2,0,0,7,1
1045,25663,GXhnYeLJGU7thFAyP76FesLSBQZtYEFj,5X6FeZozNMgE2VRi3MJYjkkFK8SETtu2,2,0,0,0,0,0,3,0,3,0.42857142857142855,2,0.0,0,0,0,0,0,0,0,3,0,0,3,0
1046,25673,gyFw0Vge0Tj4Yoavkd7TNvnmTGksA31j,SpATywNh6bZuzm8s1ceuBUnMUAeoAHHw,23,16,8,16,5,0,2,0,47,6.714285714285714,1,0.0,6,8,14,5,10,0,2,2,0,33,14,0
1047,25688,pjY4fWx7BSbcq40Z5pbf9uDCj5HcVuUi,SpATywNh6bZuzm8s1ceuBUnMUAeoAHHw,10,9,5,11,2,0,2,0,29,4.142857142857143,1,0.0,1,5,9,2,8,0,2,2,0,17,12,0
1048,25693,bOaaa5pq6CHfEgyWnmZd4nE6w4eBrY8n,bWdj2GDclj5ofokWjzoa5jAwMkxCykd6,1,0,0,0,0,0,1,0,1,0.14285714285714285,1,0.0,0,0,0,0,0,0,0,1,0,0,1,1
1049,25713,wuaIkUodYTr49NZ7BbMPsEdpO0t0C8Nt,5X6FeZozNMgE2VRi3MJYjkkFK8SETtu2,96,153,6,149,45,0,14,0,367,52.42857142857143,8,0.0,90,6,124,45,63,0,25,14,0,265,102,0
1050,25724,edYhJsFcs7Y8S1yA5J1UkF2OnFEDfEmL,5X6FeZozNMgE2VRi3MJYjkkFK8SETtu2,63,63,17,128,26,15,21,9,279,39.857142857142854,1,0.0,40,17,114,26,23,15,14,21,9,197,82,1
1051,25735,pwnvfCtqibSBzw9gewKZFVOUFkyHecrp,SpATywNh6bZuzm8s1ceuBUnMUAeoAHHw,4,4,0,0,0,0,1,0,5,0.7142857142857143,1,0.0,0,0,0,0,4,0,0,1,0,0,5,1
1052,25765,E31WqWw5nCEWlSKgmhsOSj5j4T79ypCl,SpATywNh6bZuzm8s1ceuBUnMUAeoAHHw,19,24,13,7,5,0,5,0,54,7.714285714285714,3,0.0,6,13,7,5,18,0,0,5,0,31,23,0
1053,25793,V2mnxM1tJc479TW7qqC55qpZNUZBAJ2y,G8EPVSXsOYB5YQWZGiz1aVq5Pgr2GrQu,69,75,31,179,16,0,13,0,314,44.857142857142854,3,0.0,34,31,135,16,41,0,44,13,0,216,98,0
1054,25807,Zl8ThqnwtmFsX5mPsLsbut5BCVNIbE7S,SpATywNh6bZuzm8s1ceuBUnMUAeoAHHw,6,14,8,0,4,0,3,0,29,4.142857142857143,3,0.0,0,8,0,4,14,0,0,3,0,12,17,0
1055,25815,GWprCjSOfnhkIpSV2QR3x0GXabXNfPBZ,bWdj2GDclj5ofokWjzoa5jAwMkxCykd6,6,4,1,0,2,1,4,0,12,1.7142857142857142,1,0.0,2,1,0,2,2,1,0,4,0,5,7,1
1056,25834,j5n4sTa6PLfZD2NvGDdgp6H4HCwWt2aE,5X6FeZozNMgE2VRi3MJYjkkFK8SETtu2,1,0,0,0,0,0,1,0,1,0.14285714285714285,1,0.0,0,0,0,0,0,0,0,1,0,0,1,1
1057,25837,b5Gj1OyeYKLhLlGsleyNSSJpbJ2lneFj,SpATywNh6bZuzm8s1ceuBUnMUAeoAHHw,19,26,2,12,1,0,7,0,48,6.857142857142857,2,0.0,7,2,12,1,19,0,0,7,0,22,26,1
1058,25844,o9m1fMq17KjyGUhfLHLXFO5hoKQ5jU6O,SpATywNh6bZuzm8s1ceuBUnMUAeoAHHw,13,22,0,0,0,0,3,0,25,3.5714285714285716,2,0.0,0,0,0,0,22,0,0,3,0,0,25,1
1059,25846,lLuFFXHZLIm1dQPs5nCzpljCAy6MOLmS,SpATywNh6bZuzm8s1ceuBUnMUAeoAHHw,6,3,1,0,1,0,3,0,8,1.1428571428571428,1,0.0,0,1,0,1,3,0,0,3,0,2,6,1
1060,25864,koGmxwg6FRa19ZshKXnyLXLosS5G7cau,7GRhBDsirIGkRZBtSMEzNTyDr2JQm4xx,8,11,0,0,0,0,2,0,13,1.8571428571428572,1,0.0,0,0,0,0,11,0,0,2,0,0,13,1
1061,25867,8AVk1xYha38NNysY3dSGM9P4W7fXA7gi,SpATywNh6bZuzm8s1ceuBUnMUAeoAHHw,16,15,11,0,6,0,5,0,37,5.285714285714286,3,0.0,0,11,0,6,15,0,0,5,0,17,20,0
1062,25875,CPn2qTyzfSb84Q5RXZs22HrPl5sixCdu,A3fsA9Zfv1X2fVEQhTw51lKENdNrEqT3,1,0,0,0,0,0,1,0,1,0.14285714285714285,1,0.0,0,0,0,0,0,0,0,1,0,0,1,1
1063,25883,HrUHfBacH3u3gfsauI41ANlvNzWZshRh,SpATywNh6bZuzm8s1ceuBUnMUAeoAHHw,20,45,28,17,12,0,13,0,115,16.428571428571427,5,0.0,2,28,14,12,43,0,3,13,0,56,59,0
1064,25888,81OLbBMdpNpbkVstjKtzJy0bjbBi99mi,SpATywNh6bZuzm8s1ceuBUnMUAeoAHHw,45,45,22,50,13,0,14,3,147,21.0,5,0.0,15,22,41,13,30,0,9,14,3,91,56,1
1065,25894,PnzdvfzXkg5rDeQmv0vRztwvfQb99Bwj,5X6FeZozNMgE2VRi3MJYjkkFK8SETtu2,38,108,29,48,34,1,8,0,228,32.57142857142857,5,0.0,56,29,42,34,52,1,6,8,0,161,67,1
1066,25895,DLDhUvvvfnnYFJuV65Zt2yaS0jPJgvzq,SpATywNh6bZuzm8s1ceuBUnMUAeoAHHw,15,26,0,22,0,9,21,1,79,11.285714285714286,5,0.0,6,0,19,0,20,9,3,21,1,25,54,0
1067,25898,cGrHiRjztN9fSltHujpfWaaWfYWiidiG,A3fsA9Zfv1X2fVEQhTw51lKENdNrEqT3,6,6,3,0,0,0,4,0,13,1.8571428571428572,1,0.0,0,3,0,0,6,0,0,4,0,3,10,1
1068,25901,pIkx6nDAjTla5NYVEsjhMXOIu5zXDzmO,SpATywNh6bZuzm8s1ceuBUnMUAeoAHHw,16,7,7,0,6,0,5,0,25,3.5714285714285716,1,0.0,0,7,0,6,7,0,0,5,0,13,12,0
1069,25904,cGrHiRjztN9fSltHujpfWaaWfYWiidiG,bWdj2GDclj5ofokWjzoa5jAwMkxCykd6,3,3,1,0,0,0,1,0,5,0.7142857142857143,1,0.0,0,1,0,0,3,0,0,1,0,1,4,1
1070,25919,SIdEQEXoagJ5WwAcAkPtkVF6pipatiIa,bWdj2GDclj5ofokWjzoa5jAwMkxCykd6,10,4,1,30,1,1,6,1,44,6.285714285714286,2,0.0,1,1,29,1,3,1,1,6,1,32,12,1
1071,25963,3Ew3yAxjSntFFYCyahG9TNwPBtEjhvBu,SpATywNh6bZuzm8s1ceuBUnMUAeoAHHw,14,16,5,0,5,0,2,0,28,4.0,2,0.0,0,5,0,5,16,0,0,2,0,10,18,1
1072,25980,piSFwoJk8ecTZvpcQFfQWuNzR6UBK2aS,A3fsA9Zfv1X2fVEQhTw51lKENdNrEqT3,15,36,1,0,2,1,10,0,50,7.142857142857143,2,0.0,0,1,0,2,36,1,0,10,0,3,47,1
1073,25994,2jj1hSNZOKn7YixrkMYiulmQRlxNCAKp,SpATywNh6bZuzm8s1ceuBUnMUAeoAHHw,3,2,0,0,0,0,1,0,3,0.42857142857142855,1,0.0,0,0,0,0,2,0,0,1,0,0,3,1
1074,26003,AYGrfwmCqnoFaB5IuQBeL8PTqSOc0bJ5,5X6FeZozNMgE2VRi3MJYjkkFK8SETtu2,6,4,0,0,0,0,2,0,6,0.8571428571428571,1,0.0,0,0,0,0,4,0,0,2,0,0,6,1
1075,26027,l5LfU8gApOG72AnBkdAbfOLQLwFH7Zo2,A3fsA9Zfv1X2fVEQhTw51lKENdNrEqT3,30,17,1,90,1,0,5,0,114,16.285714285714285,3,0.0,1,1,72,1,16,0,18,5,0,75,39,0
1076,26033,6izQCEneEK1X6C1taxn0XENXkSv3cl84,A3fsA9Zfv1X2fVEQhTw51lKENdNrEqT3,16,14,7,0,5,2,4,1,33,4.714285714285714,1,0.0,0,7,0,5,14,2,0,4,1,12,21,0
1077,26069,xlgnT59n6M1QNareeSjN1ytXGFL5M34H,G8EPVSXsOYB5YQWZGiz1aVq5Pgr2GrQu,64,70,28,100,16,0,6,0,220,31.428571428571427,2,0.0,38,28,76,16,32,0,24,6,0,158,62,0
1078,26111,GMCQBmsjUSXeJd8f6yOlc7Bh24TS4rkv,SpATywNh6bZuzm8s1ceuBUnMUAeoAHHw,8,3,2,0,2,1,19,0,27,3.857142857142857,1,0.0,0,2,0,2,3,1,0,19,0,4,23,1
1079,26126,EfoxsYvaiqTPtWZL7NNMHTBPpoZQt5UK,SpATywNh6bZuzm8s1ceuBUnMUAeoAHHw,19,69,29,21,11,6,11,0,147,21.0,3,0.0,31,29,19,11,38,6,2,11,0,90,57,0
1080,26137,z8UGly3uiugF5PDT4DP7AAVP1m1jK5W8,bWdj2GDclj5ofokWjzoa5jAwMkxCykd6,1,0,0,0,0,0,3,0,3,0.42857142857142855,1,0.0,0,0,0,0,0,0,0,3,0,0,3,1
1081,26148,JqvGTplcVBLcq3YzEUVslmYGYOBREBZ1,SpATywNh6bZuzm8s1ceuBUnMUAeoAHHw,27,67,22,21,5,23,17,1,156,22.285714285714285,7,0.0,16,22,17,5,51,23,4,17,1,60,96,0
1082,26150,IUS8Ce0Mk0XPctlXRjc3h0Z2l95mH9Of,SpATywNh6bZuzm8s1ceuBUnMUAeoAHHw,2,0,0,0,0,0,2,0,2,0.2857142857142857,1,0.0,0,0,0,0,0,0,0,2,0,0,2,1
1083,26168,6izQCEneEK1X6C1taxn0XENXkSv3cl84,5X6FeZozNMgE2VRi3MJYjkkFK8SETtu2,10,29,6,7,6,0,4,0,52,7.428571428571429,4,0.0,10,6,7,6,19,0,0,4,0,29,23,0
1084,26190,FlHDZPKBaAynG5XiDYuhXZZ01PMUHJc5,A3fsA9Zfv1X2fVEQhTw51lKENdNrEqT3,52,92,68,0,55,0,23,1,239,34.142857142857146,3,0.0,4,68,0,55,88,0,0,23,1,127,112,0
1085,26205,OR7EWwoao6bYv7TsfkmzJ7Oec16YYNDq,SpATywNh6bZuzm8s1ceuBUnMUAeoAHHw,9,4,3,0,3,0,10,0,20,2.857142857142857,2,0.0,0,3,0,3,4,0,0,10,0,6,14,1
1086,26208,USLTnsAwagwK2c83KXd1SNEeENnzkTTo,7GRhBDsirIGkRZBtSMEzNTyDr2JQm4xx,3,0,0,0,0,5,3,0,8,1.1428571428571428,2,0.0,0,0,0,0,0,5,0,3,0,0,8,0
1087,26216,AbUJGk67ueUV6YWXpG4Dr2koeNrU2Sk8,SpATywNh6bZuzm8s1ceuBUnMUAeoAHHw,8,22,6,0,6,0,40,0,74,10.571428571428571,3,0.0,0,6,0,6,22,0,0,40,0,12,62,1
1088,26218,fUPF1tlYv3HJPtJf0Z0k6ib0tZMjiWj6,5X6FeZozNMgE2VRi3MJYjkkFK8SETtu2,6,7,3,0,2,0,2,0,14,2.0,1,0.0,0,3,0,2,7,0,0,2,0,5,9,1
1089,26228,snMfOULya9Q09SdSZY2Ys7iviCn6vdB6,5X6FeZozNMgE2VRi3MJYjkkFK8SETtu2,6,1,1,0,1,0,3,0,6,0.8571428571428571,1,0.0,0,1,0,1,1,0,0,3,0,2,4,1
1090,26236,b3xaxczfVryBkeC1YPbXWEZUleYIZAnq,SpATywNh6bZuzm8s1ceuBUnMUAeoAHHw,33,40,24,36,18,1,8,0,127,18.142857142857142,2,0.0,15,24,32,18,25,1,4,8,0,89,38,1
1091,26248,pJmb8msDK6UJTKUXmJdXuhyoQrk5GlVv,SpATywNh6bZuzm8s1ceuBUnMUAeoAHHw,7,4,3,0,3,0,3,0,13,1.8571428571428572,1,0.0,0,3,0,3,4,0,0,3,0,6,7,1
1092,26255,v6GmjzoPMSZcgdRV04c3r4zmEQVHxeod,A3fsA9Zfv1X2fVEQhTw51lKENdNrEqT3,9,6,4,0,3,0,2,0,15,2.142857142857143,1,0.0,0,4,0,3,6,0,0,2,0,7,8,1
1093,26274,Y51MqWhaiGyWdNickwBkKEZ7LC7se5uV,bWdj2GDclj5ofokWjzoa5jAwMkxCykd6,14,37,8,0,9,3,10,1,68,9.714285714285714,4,0.0,0,8,0,9,37,3,0,10,1,17,51,0
1094,26277,m3MqtCVwUomC1r1STaTTddPYjy0l0hZb,bWdj2GDclj5ofokWjzoa5jAwMkxCykd6,1,0,0,0,0,0,1,0,1,0.14285714285714285,1,0.0,0,0,0,0,0,0,0,1,0,0,1,1
1095,26286,d5fIWN5kvqsn40aHFJvoDDo4RHSEcHNo,SpATywNh6bZuzm8s1ceuBUnMUAeoAHHw,3,4,2,0,0,0,4,0,10,1.4285714285714286,2,0.0,0,2,0,0,4,0,0,4,0,2,8,1
1096,26295,C47wZ77Ppvq0cRz56MIplUrxzRboyv9h,SpATywNh6bZuzm8s1ceuBUnMUAeoAHHw,24,48,10,12,5,0,12,0,87,12.428571428571429,1,0.0,0,10,10,5,48,0,2,12,0,25,62,1
1097,26297,UjnOd8eB67vR87Hc1uvDJpBawBhqSd4C,SpATywNh6bZuzm8s1ceuBUnMUAeoAHHw,19,19,13,12,9,0,3,0,56,8.0,2,0.0,4,13,11,9,15,0,1,3,0,37,19,1
1098,26322,XMtcnsDNasKCOMBWrsjCVH5NONQyEryR,A3fsA9Zfv1X2fVEQhTw51lKENdNrEqT3,8,8,3,0,1,0,6,0,18,2.5714285714285716,3,0.0,0,3,0,1,8,0,0,6,0,4,14,0
1099,26326,drIV8ws6G2eFjZA06SdUOTyJLvhyaXrd,SpATywNh6bZuzm8s1ceuBUnMUAeoAHHw,14,19,7,11,2,4,6,2,51,7.285714285714286,2,0.0,9,7,10,2,10,4,1,6,2,28,23,0
1100,26335,IW0jtTZGLkJezOCVgyOKwdgLTuPt0owB,SpATywNh6bZuzm8s1ceuBUnMUAeoAHHw,29,42,4,31,0,4,4,0,85,12.142857142857142,5,0.0,13,4,25,0,29,4,6,4,0,42,43,0
1101,26336,2s1w2v8MgoByNGqR51pltJWsiHzHAFZ1,SpATywNh6bZuzm8s1ceuBUnMUAeoAHHw,40,48,0,38,0,3,7,0,96,13.714285714285714,6,0.0,10,0,33,0,38,3,5,7,0,43,53,0
1102,26362,SAfnpYIfr0KwKQRQDGxyE1fyeIIuapJW,bWdj2GDclj5ofokWjzoa5jAwMkxCykd6,1,0,0,0,0,0,1,0,1,0.14285714285714285,1,0.0,0,0,0,0,0,0,0,1,0,0,1,1
1103,26372,n9pMeUNiRSC6CgcSbq2dPbx8FhUkGah9,A3fsA9Zfv1X2fVEQhTw51lKENdNrEqT3,5,5,3,0,1,0,4,0,13,1.8571428571428572,2,0.0,0,3,0,1,5,0,0,4,0,4,9,0
1104,26383,PLKfIj5PWmJ1pq6F2TAT2ZidBGAMa6pt,SpATywNh6bZuzm8s1ceuBUnMUAeoAHHw,2,0,0,0,0,0,3,0,3,0.42857142857142855,1,0.0,0,0,0,0,0,0,0,3,0,0,3,1
1105,26407,Do8hbesbT6OBtmo3AMshqQTnDUWGEYzY,bWdj2GDclj5ofokWjzoa5jAwMkxCykd6,4,3,2,0,0,0,1,0,6,0.8571428571428571,1,0.0,0,2,0,0,3,0,0,1,0,2,4,0
1106,26410,hIRmhKUbv5EQgDyxP7vWP9iwTw6fJ29b,A3fsA9Zfv1X2fVEQhTw51lKENdNrEqT3,1,0,0,0,0,0,1,0,1,0.14285714285714285,1,0.0,0,0,0,0,0,0,0,1,0,0,1,1
1107,26411,XGWArK05Wzjd8AdGaPxkShZOu2YZKkZ4,SpATywNh6bZuzm8s1ceuBUnMUAeoAHHw,21,33,14,24,6,3,4,1,85,12.142857142857142,2,0.0,8,14,19,6,25,3,5,4,1,47,38,0
1108,26419,yCobmn3bYowOXtgM2MWC1dOZIX5337iq,5X6FeZozNMgE2VRi3MJYjkkFK8SETtu2,9,8,5,0,6,0,4,0,23,3.2857142857142856,2,0.0,2,5,0,6,6,0,0,4,0,13,10,1
1109,26435,N0Sos51WanCzoSGKDmMPzQtMlLxY3bFb,bWdj2GDclj5ofokWjzoa5jAwMkxCykd6,66,96,62,97,29,10,36,1,331,47.285714285714285,7,0.0,16,62,86,29,80,10,11,36,1,193,138,0
1110,26442,C8XrXSQZNN8RR6xEeSRWbKA5jTxVTtPT,SpATywNh6bZuzm8s1ceuBUnMUAeoAHHw,15,9,7,0,5,0,1,0,22,3.142857142857143,1,0.0,0,7,0,5,9,0,0,1,0,12,10,0
1111,26443,rop0ItXlfQaL7isXEgn3BRt60tvyrDtS,SpATywNh6bZuzm8s1ceuBUnMUAeoAHHw,8,8,4,0,1,0,2,0,15,2.142857142857143,2,0.0,0,4,0,1,8,0,0,2,0,5,10,1
1112,26499,5dvfr5EjWeXuIobwrgh7MVbCslwNXi21,SpATywNh6bZuzm8s1ceuBUnMUAeoAHHw,31,61,19,23,13,0,9,0,125,17.857142857142858,7,0.0,12,19,21,13,49,0,2,9,0,65,60,0
1113,26511,wdK5DIKl9qd73hM1uOx3ufcKj0J9AcRr,SpATywNh6bZuzm8s1ceuBUnMUAeoAHHw,7,17,9,0,1,0,8,0,35,5.0,5,0.0,2,9,0,1,15,0,0,8,0,12,23,1
1114,26537,zzDcC2Q7qPZNjUcDFhhRKUy0mGAUmUju,5X6FeZozNMgE2VRi3MJYjkkFK8SETtu2,1,0,0,0,0,0,1,0,1,0.14285714285714285,1,0.0,0,0,0,0,0,0,0,1,0,0,1,1
1115,26538,aEpxyypSZgchkPG1jGPLZvADGPtcFbJZ,SpATywNh6bZuzm8s1ceuBUnMUAeoAHHw,25,49,1,72,0,0,9,0,131,18.714285714285715,3,0.0,29,1,61,0,20,0,11,9,0,91,40,0
1116,26547,Jb792VQeMGhUz59LQDa5JysSU082aNRs,SpATywNh6bZuzm8s1ceuBUnMUAeoAHHw,4,3,1,0,0,0,1,0,5,0.7142857142857143,1,0.0,0,1,0,0,3,0,0,1,0,1,4,0
1117,26549,pw6cK2a1Sg11o70Y9sMOyOCkYUg7dGT2,SpATywNh6bZuzm8s1ceuBUnMUAeoAHHw,2,0,0,0,0,0,2,0,2,0.2857142857142857,1,0.0,0,0,0,0,0,0,0,2,0,0,2,0
1118,26580,Ce9saCYn5kapFVCsZrhP2U86gMYaxqgR,5X6FeZozNMgE2VRi3MJYjkkFK8SETtu2,4,6,1,0,2,0,1,0,10,1.4285714285714286,1,0.0,4,1,0,2,2,0,0,1,0,7,3,1
1119,26584,3jDnMuiM4IBbYvTjjX7VYaBZ7em1ZL1E,SpATywNh6bZuzm8s1ceuBUnMUAeoAHHw,3,3,0,0,0,0,1,0,4,0.5714285714285714,1,0.0,0,0,0,0,3,0,0,1,0,0,4,1
1120,26593,yYrk7RmkclaZIv32ppfmidCUMKYlGdCg,7GRhBDsirIGkRZBtSMEzNTyDr2JQm4xx,7,6,3,0,1,0,1,0,11,1.5714285714285714,1,0.0,0,3,0,1,6,0,0,1,0,4,7,1
1121,26595,ZRB8OhpRpRUzGZm1XUTryPd3ZIuqeZkS,SpATywNh6bZuzm8s1ceuBUnMUAeoAHHw,18,23,6,13,1,4,7,3,57,8.142857142857142,4,0.0,5,6,11,1,18,4,2,7,3,23,34,0
1122,26599,U67fb5QeZtT5a6ySqaXNsz9xNIhOXSpr,A3fsA9Zfv1X2fVEQhTw51lKENdNrEqT3,4,2,1,0,1,0,1,0,5,0.7142857142857143,1,0.0,0,1,0,1,2,0,0,1,0,2,3,1
1123,26607,xZfmqTm2RfHtIZNcfGRoxYWwTYC59P9Y,SpATywNh6bZuzm8s1ceuBUnMUAeoAHHw,19,11,8,12,4,0,9,0,44,6.285714285714286,2,0.0,2,8,12,4,9,0,0,9,0,26,18,1
1124,26625,chwuEH1iMc682zjOmO4zFwwfUl1drv8Q,RXDvfPUBYFlVdlueBFbLW0mhhAyGEqpt,37,90,31,60,35,2,11,0,229,32.714285714285715,3,0.0,58,31,57,35,32,2,3,11,0,181,48,0
1125,26646,FTFqKwImn2g5HOczngN9ivdTWQOMMnhK,5X6FeZozNMgE2VRi3MJYjkkFK8SETtu2,26,16,3,36,3,0,4,0,62,8.857142857142858,2,0.0,9,3,32,3,7,0,4,4,0,47,15,0
1126,26665,BBhw3UYl7bLm8HtrStGuhGw3LOKEYu9g,SpATywNh6bZuzm8s1ceuBUnMUAeoAHHw,5,2,1,0,1,0,2,0,6,0.8571428571428571,1,0.0,0,1,0,1,2,0,0,2,0,2,4,1
1127,26666,Fz1sWAbM71xoTZjBdVXZ9gkwHcmS3vjC,G8EPVSXsOYB5YQWZGiz1aVq5Pgr2GrQu,67,109,42,186,23,10,21,0,391,55.857142857142854,4,0.0,46,42,141,23,63,10,45,21,0,252,139,0
1128,26673,otvwHl0K2Si9acp5jqqo5PZYsAo2LLFQ,SpATywNh6bZuzm8s1ceuBUnMUAeoAHHw,9,6,5,0,3,0,2,0,16,2.2857142857142856,1,0.0,0,5,0,3,6,0,0,2,0,8,8,0
1129,26678,OsS1Y0pb3ORCYhSo3uyNzAmfIGWlMI5F,SpATywNh6bZuzm8s1ceuBUnMUAeoAHHw,17,35,16,2,5,7,5,0,70,10.0,2,0.0,2,16,2,5,33,7,0,5,0,25,45,1
1130,26699,2WPAcVd6xHOkO7YPphHLRGJqR9SuLhLc,SpATywNh6bZuzm8s1ceuBUnMUAeoAHHw,42,76,47,33,12,32,19,4,223,31.857142857142858,7,0.0,21,47,31,12,55,32,2,19,4,111,112,0
1131,26704,OF8cZCIXPsuM4CdS1yd3vA1SWWYblMbf,SpATywNh6bZuzm8s1ceuBUnMUAeoAHHw,14,19,11,18,0,0,5,0,53,7.571428571428571,3,0.0,4,11,16,0,15,0,2,5,0,31,22,0
1132,26733,M507IlBQp64NkSWnSkchjsahApLaE1kJ,7GRhBDsirIGkRZBtSMEzNTyDr2JQm4xx,3,2,1,0,0,0,1,0,4,0.5714285714285714,1,0.0,0,1,0,0,2,0,0,1,0,1,3,1
1133,26735,tHsxhnUu7P3M7UPovo290TeoX2E43yvd,SpATywNh6bZuzm8s1ceuBUnMUAeoAHHw,31,48,20,13,12,3,9,0,105,15.0,2,0.0,10,20,13,12,38,3,0,9,0,55,50,0
1134,26744,6ukzVV282fPHH5seR4Ah1PDJIZzJboQW,5X6FeZozNMgE2VRi3MJYjkkFK8SETtu2,1,0,0,0,0,0,1,0,1,0.14285714285714285,1,0.0,0,0,0,0,0,0,0,1,0,0,1,1
1135,26745,mVxXM4uqYYFxw6xO5ph13dgwKbKNNXKw,SpATywNh6bZuzm8s1ceuBUnMUAeoAHHw,8,11,7,0,6,0,4,0,28,4.0,2,0.0,0,7,0,6,11,0,0,4,0,13,15,0
1136,26746,6ukzVV282fPHH5seR4Ah1PDJIZzJboQW,bWdj2GDclj5ofokWjzoa5jAwMkxCykd6,8,11,1,0,1,0,3,0,16,2.2857142857142856,1,0.0,0,1,0,1,11,0,0,3,0,2,14,0
1137,26753,rtgTs2kGzBpdKATcXoyCz0DWaiz8id28,A3fsA9Zfv1X2fVEQhTw51lKENdNrEqT3,1,0,0,0,0,0,1,0,1,0.14285714285714285,1,0.0,0,0,0,0,0,0,0,1,0,0,1,1
1138,26756,MV7MV74nJFl2EzcPH6rDJPH3UeLlvY9k,SpATywNh6bZuzm8s1ceuBUnMUAeoAHHw,39,30,25,5,19,0,3,0,82,11.714285714285714,3,0.0,1,25,4,19,29,0,1,3,0,49,33,1
1139,26759,JjnxjfFF8FHgjBS10KWmcZYKQ28dG2oi,bWdj2GDclj5ofokWjzoa5jAwMkxCykd6,2,0,0,0,0,63,4,0,67,9.571428571428571,3,0.0,0,0,0,0,0,63,0,4,0,0,67,0
1140,26769,QKh6yCjm7KCBJwTgcTdbJMWujg3bWjbd,SpATywNh6bZuzm8s1ceuBUnMUAeoAHHw,28,42,4,32,1,0,11,1,91,13.0,3,0.0,9,4,29,1,33,0,3,11,1,43,48,0
1141,26806,v3af5rWc4AOfzZv6mvaIgDKPH5PLVH0T,RXDvfPUBYFlVdlueBFbLW0mhhAyGEqpt,14,26,16,0,9,13,9,0,73,10.428571428571429,3,0.0,4,16,0,9,22,13,0,9,0,29,44,0
1142,26827,k7pBdSa1col2rksCm2mKNY7Iwzq5nzuk,A3fsA9Zfv1X2fVEQhTw51lKENdNrEqT3,18,36,0,0,0,6,14,1,57,8.142857142857142,2,0.0,0,0,0,0,36,6,0,14,1,0,57,0
1143,26844,q2xQCstASp96wpspi8iqsuaqJ7gzfsux,G8EPVSXsOYB5YQWZGiz1aVq5Pgr2GrQu,4,8,2,0,0,0,1,0,11,1.5714285714285714,1,0.0,5,2,0,0,3,0,0,1,0,7,4,1
1144,26849,kXgQA1U58eIoQjOXj3HfFHyjJQARpnZR,bWdj2GDclj5ofokWjzoa5jAwMkxCykd6,17,16,10,14,5,2,16,3,66,9.428571428571429,3,0.0,1,10,13,5,15,2,1,16,3,29,37,0
1145,26854,wuDEBYwzFc59ROSpgH7aHeQr4AtmTI28,A3fsA9Zfv1X2fVEQhTw51lKENdNrEqT3,25,27,14,12,10,0,11,0,74,10.571428571428571,4,0.0,0,14,11,10,27,0,1,11,0,35,39,1
1146,26857,g44r9jnfvUwG99HEAhIahumgutn1iCtI,SpATywNh6bZuzm8s1ceuBUnMUAeoAHHw,31,27,17,9,10,0,7,0,70,10.0,3,0.0,4,17,8,10,23,0,1,7,0,39,31,0
1147,26878,zNRtwNQkiCM9OW1nTIM2OGHUm9Iu3JVP,RXDvfPUBYFlVdlueBFbLW0mhhAyGEqpt,31,50,5,25,4,14,6,0,104,14.857142857142858,4,0.0,13,5,21,4,37,14,4,6,0,43,61,0
1148,26879,nE23LYiQpabdXkj6YvKSja9sZnHRizmo,A3fsA9Zfv1X2fVEQhTw51lKENdNrEqT3,2,7,1,0,0,0,0,0,8,1.1428571428571428,6,0.0,0,1,0,0,7,0,0,0,0,1,7,0
1149,26891,aKISRtXoCAGczNk9HVhnPtc5abILvx15,bWdj2GDclj5ofokWjzoa5jAwMkxCykd6,4,4,0,0,0,8,2,0,14,2.0,1,0.0,0,0,0,0,4,8,0,2,0,0,14,1
1150,26892,KqTFA16VVILHiK0IYy8jaNTctvzYX8nu,5X6FeZozNMgE2VRi3MJYjkkFK8SETtu2,8,38,2,0,17,0,2,0,59,8.428571428571429,1,0.0,27,2,0,17,11,0,0,2,0,46,13,1
1151,26894,oEaD8Zao03KxJihTh9QEYpbyK6kjdhuu,bWdj2GDclj5ofokWjzoa5jAwMkxCykd6,4,2,1,0,1,0,1,0,5,0.7142857142857143,1,0.0,0,1,0,1,2,0,0,1,0,2,3,1
1152,26896,BlnTp1ja3KvzV481CDJ0HdNG9k4YWwl6,SpATywNh6bZuzm8s1ceuBUnMUAeoAHHw,8,9,5,0,2,0,5,0,21,3.0,1,0.0,0,5,0,2,9,0,0,5,0,7,14,1
1153,26899,SKqtOWa2uBCWLrCYlzFMjf1B70kuA2m8,SpATywNh6bZuzm8s1ceuBUnMUAeoAHHw,18,12,5,7,4,0,3,0,31,4.428571428571429,1,0.0,2,5,7,4,10,0,0,3,0,18,13,0
1154,26923,PQxAX7A8tQB7sGIcC9YvDjqPxTwtHPvm,SpATywNh6bZuzm8s1ceuBUnMUAeoAHHw,10,15,4,14,0,0,3,0,36,5.142857142857143,1,0.0,8,4,12,0,7,0,2,3,0,24,12,0
1155,26924,vptj4ETLtFQ4ma0zcDVByNO4VFhFTiIc,SpATywNh6bZuzm8s1ceuBUnMUAeoAHHw,9,19,1,0,2,0,14,0,36,5.142857142857143,4,0.0,0,1,0,2,19,0,0,14,0,3,33,0
1156,26932,j8DKRXlbBhJ6ifZiglKMxqN6K5Ef7FDx,SpATywNh6bZuzm8s1ceuBUnMUAeoAHHw,5,4,2,0,3,0,2,0,11,1.5714285714285714,1,0.0,0,2,0,3,4,0,0,2,0,5,6,1
1157,26935,5QSnLk3nUbOoWCmYIjRNg8lJNQJ2jQBA,5X6FeZozNMgE2VRi3MJYjkkFK8SETtu2,8,6,3,0,1,0,7,2,19,2.7142857142857144,3,0.0,0,3,0,1,6,0,0,7,2,4,15,1
1158,26946,DsHgWZRTJ1y1l15smwhB78ZQq3d8dyKP,A3fsA9Zfv1X2fVEQhTw51lKENdNrEqT3,1,0,0,0,0,0,1,0,1,0.14285714285714285,1,0.0,0,0,0,0,0,0,0,1,0,0,1,0
1159,26952,CoJba6QLtYix733vlbUGcTkbe73oqQlb,A3fsA9Zfv1X2fVEQhTw51lKENdNrEqT3,1,0,0,0,0,0,1,0,1,0.14285714285714285,1,0.0,0,0,0,0,0,0,0,1,0,0,1,1
1160,26980,eHoa4dnAqoZqw72CCle00GlHxpp5Lihg,SpATywNh6bZuzm8s1ceuBUnMUAeoAHHw,9,15,4,0,1,8,5,0,33,4.714285714285714,2,0.0,2,4,0,1,13,8,0,5,0,7,26,0
1161,27002,65UOsOYgBFCK8lFA2oh4JXpCpEJQ6Qpa,SpATywNh6bZuzm8s1ceuBUnMUAeoAHHw,7,3,2,0,2,0,2,0,9,1.2857142857142858,1,0.0,0,2,0,2,3,0,0,2,0,4,5,1
1162,27004,YA7ruJHya4O17V317Yx8gXDQAyqYdgpH,A3fsA9Zfv1X2fVEQhTw51lKENdNrEqT3,10,5,4,0,4,0,1,0,14,2.0,1,0.0,0,4,0,4,5,0,0,1,0,8,6,1
1163,27011,v56sXsiqO16CihVjx7LnUaL1FBKZRJGr,SpATywNh6bZuzm8s1ceuBUnMUAeoAHHw,2,0,0,0,0,0,3,0,3,0.42857142857142855,1,0.0,0,0,0,0,0,0,0,3,0,0,3,1
1164,27025,gpa1OPqp1fw56hdOLoug5JiJSiTGCtE4,bWdj2GDclj5ofokWjzoa5jAwMkxCykd6,48,56,10,98,0,23,11,3,201,28.714285714285715,4,0.0,13,10,95,0,43,23,3,11,3,118,83,0
1165,27036,5iaVnotpymFcumonl8g2gZO9P5jogtd2,bWdj2GDclj5ofokWjzoa5jAwMkxCykd6,2,0,0,0,0,0,3,0,3,0.42857142857142855,2,0.0,0,0,0,0,0,0,0,3,0,0,3,0
1166,27041,jJiAYOerqhZGMDZThRRrc2HdWKEBffOQ,SpATywNh6bZuzm8s1ceuBUnMUAeoAHHw,1,0,0,0,0,0,2,0,2,0.2857142857142857,1,0.0,0,0,0,0,0,0,0,2,0,0,2,1
1167,27049,NyRX8nPDWLIgLtE9cch3ACh6oFi0cOSx,SpATywNh6bZuzm8s1ceuBUnMUAeoAHHw,6,4,2,0,1,0,2,0,9,1.2857142857142858,1,0.0,0,2,0,1,4,0,0,2,0,3,6,0
1168,27064,ZMTcKQbBQl56kBXzK6ZZeR0SWzh1XSjd,A3fsA9Zfv1X2fVEQhTw51lKENdNrEqT3,9,18,12,0,6,0,10,0,46,6.571428571428571,5,0.0,0,12,0,6,18,0,0,10,0,18,28,0
1169,27065,36ku7KQDPB0sZM9OZArWOX1N3O9xu440,SpATywNh6bZuzm8s1ceuBUnMUAeoAHHw,1,0,0,0,0,0,1,0,1,0.14285714285714285,1,0.0,0,0,0,0,0,0,0,1,0,0,1,1
1170,27107,GNsGzjFSidI9fBCvT9fI5F8kfuYTc1I2,SpATywNh6bZuzm8s1ceuBUnMUAeoAHHw,34,35,24,48,13,4,11,0,135,19.285714285714285,3,0.0,6,24,41,13,29,4,7,11,0,84,51,0
1171,27116,Y1uVq657IWCue4abNsh62IVHKtmwsQHQ,G8EPVSXsOYB5YQWZGiz1aVq5Pgr2GrQu,37,50,43,0,10,0,7,0,110,15.714285714285714,3,0.0,0,43,0,10,50,0,0,7,0,53,57,0
1172,27135,4n96XjFWm119IxNfDqefEGXTwnnmn5om,SpATywNh6bZuzm8s1ceuBUnMUAeoAHHw,29,37,2,42,0,0,5,0,86,12.285714285714286,3,0.0,11,2,35,0,26,0,7,5,0,48,38,1
1173,27149,JUWUvJcphX1ykyuSffeN4ZAztcLzCvae,SpATywNh6bZuzm8s1ceuBUnMUAeoAHHw,4,1,0,0,0,0,3,0,4,0.5714285714285714,1,0.0,0,0,0,0,1,0,0,3,0,0,4,0
1174,27161,TNArortVQm3F09odJ2W3xdM27lVc5PiX,7GRhBDsirIGkRZBtSMEzNTyDr2JQm4xx,8,6,3,0,3,1,1,0,14,2.0,1,0.0,0,3,0,3,6,1,0,1,0,6,8,1
1175,27164,q0GZFChoVOuhzxYur1QICnKH6imiHQh6,SpATywNh6bZuzm8s1ceuBUnMUAeoAHHw,6,24,13,0,0,0,12,0,49,7.0,4,0.0,5,13,0,0,19,0,0,12,0,18,31,0
1176,27169,TMLHDEunctUbbn16KffZHzQrVcud2Q9Y,bWdj2GDclj5ofokWjzoa5jAwMkxCykd6,34,43,26,130,18,0,4,0,221,31.571428571428573,2,0.0,12,26,108,18,31,0,22,4,0,164,57,0
1177,27174,ZSKBKnD8wfegggUigWIwrMo7a1rGr9YG,A3fsA9Zfv1X2fVEQhTw51lKENdNrEqT3,8,6,4,0,3,0,3,0,16,2.2857142857142856,1,0.0,0,4,0,3,6,0,0,3,0,7,9,0
1178,27178,3GyWUBVi0ZEtgDniG78bG37zc4UZrPNu,RXDvfPUBYFlVdlueBFbLW0mhhAyGEqpt,57,94,44,103,22,20,16,1,300,42.857142857142854,4,0.0,15,44,92,22,79,20,11,16,1,173,127,1
1179,27186,dI0jOfzj8SJw9E2PkA63bWlxL71OLyUr,bWdj2GDclj5ofokWjzoa5jAwMkxCykd6,6,8,2,0,0,21,4,1,36,5.142857142857143,1,0.0,0,2,0,0,8,21,0,4,1,2,34,0
1180,27187,imtJFGBCtMAkOvvJ09P5N0sgBTGSUYzd,SpATywNh6bZuzm8s1ceuBUnMUAeoAHHw,6,3,2,0,1,0,2,0,8,1.1428571428571428,1,0.0,0,2,0,1,3,0,0,2,0,3,5,0
1181,27189,PYm9QxL1CCjHYX7XOqp8vXAiT1dnOhc3,SpATywNh6bZuzm8s1ceuBUnMUAeoAHHw,4,3,2,0,2,0,1,0,8,1.1428571428571428,1,0.0,0,2,0,2,3,0,0,1,0,4,4,1
1182,27212,4DdK8TmenB23ZCgCZB7QoDxAHSAI2lo5,A3fsA9Zfv1X2fVEQhTw51lKENdNrEqT3,5,2,1,0,1,0,2,0,6,0.8571428571428571,1,0.0,0,1,0,1,2,0,0,2,0,2,4,1
1183,27223,amNosdi6Uiilljdy8esSBA3F29NKPLUW,SpATywNh6bZuzm8s1ceuBUnMUAeoAHHw,5,4,3,0,0,0,1,0,8,1.1428571428571428,1,0.0,0,3,0,0,4,0,0,1,0,3,5,1
1184,27252,623I0R5YkXD8Jxqbb7RUIvBlbAWDAwhe,bWdj2GDclj5ofokWjzoa5jAwMkxCykd6,6,0,0,0,0,0,5,1,6,0.8571428571428571,1,0.0,0,0,0,0,0,0,0,5,1,0,6,1
1185,27268,KmrafWa5j0EoSlyTehpuPHeKeDiU4jD1,SpATywNh6bZuzm8s1ceuBUnMUAeoAHHw,8,8,6,0,4,0,2,0,20,2.857142857142857,3,0.0,0,6,0,4,8,0,0,2,0,10,10,1
1186,27305,mvWG8WfFoikkAB9Wg1mtbCZJVje4NMeg,bWdj2GDclj5ofokWjzoa5jAwMkxCykd6,65,30,16,183,9,92,8,1,339,48.42857142857143,3,0.0,12,16,162,9,18,92,21,8,1,199,140,0
1187,27323,y27oPhdLREvZCyVoOXXG4AcQOB5tYXaz,5X6FeZozNMgE2VRi3MJYjkkFK8SETtu2,8,8,0,12,0,0,2,0,22,3.142857142857143,1,0.0,3,0,9,0,5,0,3,2,0,12,10,1
1188,27331,xrLVCjvq2WZdMIKT9yLmMgpNoKuooAqk,bWdj2GDclj5ofokWjzoa5jAwMkxCykd6,4,2,1,0,1,0,2,0,6,0.8571428571428571,1,0.0,0,1,0,1,2,0,0,2,0,2,4,1
1189,27332,rz8gqb0xki7JyRvmBK5JfOlM8YmBiT6q,SpATywNh6bZuzm8s1ceuBUnMUAeoAHHw,25,33,20,11,14,0,8,0,86,12.285714285714286,4,0.0,5,20,11,14,28,0,0,8,0,50,36,0
1190,27336,uHeTIz8GkglZUts3zio1tGR2aBoYwiQE,A3fsA9Zfv1X2fVEQhTw51lKENdNrEqT3,6,5,3,0,0,0,4,0,12,1.7142857142857142,1,0.0,0,3,0,0,5,0,0,4,0,3,9,1
1191,27350,BFcEovexz00IfJUn8TqPcKhZyCRYBP66,RXDvfPUBYFlVdlueBFbLW0mhhAyGEqpt,2,0,0,0,0,0,2,0,2,0.2857142857142857,1,0.0,0,0,0,0,0,0,0,2,0,0,2,1
1192,27364,VxTZo8wWibkIng7J8YPkqWh1rsEKvqTC,7GRhBDsirIGkRZBtSMEzNTyDr2JQm4xx,3,2,1,0,1,0,0,0,4,0.5714285714285714,2,0.0,0,1,0,1,2,0,0,0,0,2,2,0
1193,27393,zeAmUBAf1zNTSGXoE3zumd8rzCoIwZ5W,5X6FeZozNMgE2VRi3MJYjkkFK8SETtu2,6,2,1,0,1,1,3,0,8,1.1428571428571428,1,0.0,0,1,0,1,2,1,0,3,0,2,6,1
1194,27404,HDD1g3rYbRszzNZAvMB0irAHbU4W6xUO,SpATywNh6bZuzm8s1ceuBUnMUAeoAHHw,7,12,0,0,0,0,2,0,14,2.0,2,0.0,2,0,0,0,10,0,0,2,0,2,12,1
1195,27425,QKFgXpDRmtAntqyPA4XZkFAYLg7Q7QGI,5X6FeZozNMgE2VRi3MJYjkkFK8SETtu2,9,16,5,0,3,7,8,0,39,5.571428571428571,6,0.0,2,5,0,3,14,7,0,8,0,10,29,1
1196,27429,IYFIdswDKEsO4j14D9vS4fhZEQBqA7vK,SpATywNh6bZuzm8s1ceuBUnMUAeoAHHw,5,2,1,0,0,0,5,0,8,1.1428571428571428,2,0.0,0,1,0,0,2,0,0,5,0,1,7,0
1197,27449,M8C9BDFICk4ida59GU0jjp556zazDEi1,SpATywNh6bZuzm8s1ceuBUnMUAeoAHHw,33,30,21,22,12,0,9,0,94,13.428571428571429,3,0.0,6,21,22,12,24,0,0,9,0,61,33,0
1198,27450,h5vEAVTb94xGNGjpn4Ohi5mNcXfM0rMl,G8EPVSXsOYB5YQWZGiz1aVq5Pgr2GrQu,4,2,0,0,0,0,4,0,6,0.8571428571428571,1,0.0,0,0,0,0,2,0,0,4,0,0,6,1
1199,27485,CYUGDG4GDnccqiwcMR066vcF013j1TMy,5X6FeZozNMgE2VRi3MJYjkkFK8SETtu2,1,0,0,0,0,0,1,0,1,0.14285714285714285,1,0.0,0,0,0,0,0,0,0,1,0,0,1,1
1200,27497,g6Nv7zrAUSY5suYgQ1EV1HY4bAaM1IoO,A3fsA9Zfv1X2fVEQhTw51lKENdNrEqT3,1,0,0,0,0,0,3,0,3,0.42857142857142855,3,0.0,0,0,0,0,0,0,0,3,0,0,3,1
1201,27501,rfOApTbQ4xF2665bHZIBhoJqQcTU6i9L,SpATywNh6bZuzm8s1ceuBUnMUAeoAHHw,24,35,20,13,6,16,16,1,107,15.285714285714286,5,0.0,4,20,10,6,31,16,3,16,1,40,67,0
1202,27505,GqvZlCSL2xoDXr8RnEtKoBCGOMk7l8qe,bWdj2GDclj5ofokWjzoa5jAwMkxCykd6,6,3,2,0,2,0,2,0,9,1.2857142857142858,1,0.0,0,2,0,2,3,0,0,2,0,4,5,1
1203,27527,95RaJ62uNSmKXeQXyHNyaKGynHoKJ32a,SpATywNh6bZuzm8s1ceuBUnMUAeoAHHw,38,78,10,54,6,9,22,0,179,25.571428571428573,7,0.0,11,10,49,6,67,9,5,22,0,76,103,0
1204,27535,VQ4FtoMJj29hpPrAQ6LMEGesAofjErC4,G8EPVSXsOYB5YQWZGiz1aVq5Pgr2GrQu,52,142,6,128,5,1,14,2,298,42.57142857142857,3,0.0,57,6,79,5,85,1,49,14,2,147,151,0
1205,27536,p7V6MquT5r2C7VmRzYjQEOsKx7s5gJug,SpATywNh6bZuzm8s1ceuBUnMUAeoAHHw,12,21,13,0,11,0,1,0,46,6.571428571428571,2,0.0,0,13,0,11,21,0,0,1,0,24,22,0
1206,27544,IKxphgSgfhmDrYkWEy2UPL1kCSRYS8xw,5X6FeZozNMgE2VRi3MJYjkkFK8SETtu2,1,0,0,0,0,0,1,0,1,0.14285714285714285,1,0.0,0,0,0,0,0,0,0,1,0,0,1,1
1207,27607,drUu3tyovHqnF7EAaPHayHDYbWMe2Od6,5Gyp41oLVo7Gg7vF4vpmggWP5MU70QO6,1,0,0,0,0,0,1,0,1,0.14285714285714285,1,0.0,0,0,0,0,0,0,0,1,0,0,1,1
1208,27616,bGUkoSiHaU85ol0k2itTO3o20n3CqprE,5Gyp41oLVo7Gg7vF4vpmggWP5MU70QO6,10,18,9,0,7,0,3,0,37,5.285714285714286,5,0.0,3,9,0,7,15,0,0,3,0,19,18,1
1209,27617,v4KRIvW2fm59UFurmYoSZsK2mZZrmnsA,5Gyp41oLVo7Gg7vF4vpmggWP5MU70QO6,6,2,2,0,2,0,3,1,10,1.4285714285714286,1,0.0,0,2,0,2,2,0,0,3,1,4,6,1
1210,27706,p9aMxBwlOcsOm8IZAr1KbsAeyAVOsJip,5Gyp41oLVo7Gg7vF4vpmggWP5MU70QO6,16,32,1,10,5,16,7,0,71,10.142857142857142,3,0.0,13,1,5,5,19,16,5,7,0,24,47,1
1211,27754,1LtLQwRGDjWRPORAmpPeWuHr93qsG62M,5Gyp41oLVo7Gg7vF4vpmggWP5MU70QO6,17,58,13,23,1,0,24,0,119,17.0,14,0.0,8,13,17,1,50,0,6,24,0,39,80,0
1212,27768,6Eab82jqo4MMXOkEe4r2Db4dOEnEqpR0,5Gyp41oLVo7Gg7vF4vpmggWP5MU70QO6,1,0,0,0,0,0,1,0,1,0.14285714285714285,1,0.0,0,0,0,0,0,0,0,1,0,0,1,1
1213,27783,70uIHzP1IIZFMEduQZw3st02yaDjKlgb,5Gyp41oLVo7Gg7vF4vpmggWP5MU70QO6,1,0,0,0,0,0,1,0,1,0.14285714285714285,1,0.0,0,0,0,0,0,0,0,1,0,0,1,1
1214,27819,CUbueK74RGsaWBcRtztdoMN84Z7TxEjm,5Gyp41oLVo7Gg7vF4vpmggWP5MU70QO6,25,116,59,35,11,61,26,0,308,44.0,9,0.0,18,59,33,11,98,61,2,26,0,121,187,1
1215,27820,viy9SL8VsZTV3spMPC3VdzWUDXysWUO1,5Gyp41oLVo7Gg7vF4vpmggWP5MU70QO6,1,0,0,0,0,0,1,0,1,0.14285714285714285,1,0.0,0,0,0,0,0,0,0,1,0,0,1,1
1216,27822,77MPHfwkkt42tGmBSCy7dOnuW7DkYTkO,5Gyp41oLVo7Gg7vF4vpmggWP5MU70QO6,14,28,14,4,6,17,14,1,84,12.0,4,0.0,8,14,2,6,20,17,2,14,1,30,54,1
1217,27843,mHvBsRgkyfNYyV05aPYKWU64f2SEzjkY,5Gyp41oLVo7Gg7vF4vpmggWP5MU70QO6,3,1,0,0,0,0,3,0,4,0.5714285714285714,1,0.0,0,0,0,0,1,0,0,3,0,0,4,1
1218,27846,MtgML9U5DTFJBtDSHAqmZpBwcT6z3Qr8,5Gyp41oLVo7Gg7vF4vpmggWP5MU70QO6,7,3,2,0,2,2,3,0,12,1.7142857142857142,2,0.0,0,2,0,2,3,2,0,3,0,4,8,1
1219,27850,waaEVaw01xHv5SPp8nsqyoks4dnT71r2,5Gyp41oLVo7Gg7vF4vpmggWP5MU70QO6,1,0,0,0,0,0,1,0,1,0.14285714285714285,1,0.0,0,0,0,0,0,0,0,1,0,0,1,1
1220,27873,YxIxtbwFYAh0BVMShR21NdO0uOmG0LY5,5Gyp41oLVo7Gg7vF4vpmggWP5MU70QO6,41,123,76,49,24,24,21,2,319,45.57142857142857,6,0.0,30,76,39,24,93,24,10,21,2,169,150,0
1221,27877,3tUwJI9fq5MBYvk22zmtcZQjmB4I2cFy,5Gyp41oLVo7Gg7vF4vpmggWP5MU70QO6,43,141,37,30,31,36,21,2,298,42.57142857142857,10,0.0,36,37,21,31,105,36,9,21,2,125,173,1
1222,27879,rSEfJyHxNlxmmbC9ORIbqcFKKq08QDrh,5Gyp41oLVo7Gg7vF4vpmggWP5MU70QO6,34,276,112,36,52,33,52,6,567,81.0,14,0.0,66,112,25,52,210,33,11,52,6,255,312,0
1223,27928,oeNNee8VLaOZ4JNiDLP3KQElGyoff6sR,5Gyp41oLVo7Gg7vF4vpmggWP5MU70QO6,52,149,74,58,30,40,24,3,378,54.0,10,0.0,44,74,44,30,105,40,14,24,3,192,186,0
1224,27974,tikKWc2z3n1yGsQSvUOjLhEnyUq9uxRj,5Gyp41oLVo7Gg7vF4vpmggWP5MU70QO6,28,41,20,20,10,7,4,0,102,14.571428571428571,1,0.0,14,20,10,10,27,7,10,4,0,54,48,1
1225,27979,srNyZjyBFnbcDeb5BmRH5eEYCCmYaMEw,5Gyp41oLVo7Gg7vF4vpmggWP5MU70QO6,5,2,1,0,1,0,2,0,6,0.8571428571428571,1,0.0,0,1,0,1,2,0,0,2,0,2,4,1
1226,28007,DevStKADWJCs4VIgaRDuaZTBfJdFYa9g,5Gyp41oLVo7Gg7vF4vpmggWP5MU70QO6,12,12,0,2,0,2,10,1,27,3.857142857142857,1,0.0,1,0,1,0,11,2,1,10,1,2,25,1
1227,28013,h6u0wQj42DYQTidZif6qRzNNOufvDl7O,5Gyp41oLVo7Gg7vF4vpmggWP5MU70QO6,11,15,5,4,2,0,6,0,32,4.571428571428571,1,0.0,4,5,2,2,11,0,2,6,0,13,19,0
1228,28028,33S47D1TFrB6jvfJjcWGTReyNgi4HDab,5Gyp41oLVo7Gg7vF4vpmggWP5MU70QO6,22,60,29,23,9,8,17,0,146,20.857142857142858,6,0.0,15,29,17,9,45,8,6,17,0,70,76,1
1229,28057,ADWuLZoohNdwALlHCNREgIacghlfqz70,5Gyp41oLVo7Gg7vF4vpmggWP5MU70QO6,7,4,3,0,3,0,3,0,13,1.8571428571428572,1,0.0,0,3,0,3,4,0,0,3,0,6,7,1
1230,28088,p2WxyRGvLvUMOSoEWtLVx9Ca2AiCwjk0,5Gyp41oLVo7Gg7vF4vpmggWP5MU70QO6,25,47,28,12,13,0,17,0,117,16.714285714285715,9,0.0,7,28,10,13,40,0,2,17,0,58,59,1
1231,28112,NdlZQ93nuUtsQYuMit4K3FYA797jHC8C,5Gyp41oLVo7Gg7vF4vpmggWP5MU70QO6,32,112,43,16,26,7,28,2,234,33.42857142857143,8,0.0,54,43,9,26,58,7,7,28,2,132,102,1
1232,28145,nlIlTPImkmx3RycwckjSOt8ecoDGrhVu,5Gyp41oLVo7Gg7vF4vpmggWP5MU70QO6,1,0,0,0,0,0,1,0,1,0.14285714285714285,1,0.0,0,0,0,0,0,0,0,1,0,0,1,1
1233,28189,UHZZkddRJgMR0bCu07Tnczse0VrYi3iZ,5Gyp41oLVo7Gg7vF4vpmggWP5MU70QO6,9,5,3,0,4,0,2,0,14,2.0,1,0.0,1,3,0,4,4,0,0,2,0,8,6,1
1234,28218,9nRMm1PA3GIKd2fFGQBMEaDBV01scEDf,5Gyp41oLVo7Gg7vF4vpmggWP5MU70QO6,27,23,11,15,2,0,13,0,64,9.142857142857142,5,0.0,11,11,14,2,12,0,1,13,0,38,26,1
1235,28231,9sUYEAOdTSko17AkFIhOnmpUMN8uDHrD,5Gyp41oLVo7Gg7vF4vpmggWP5MU70QO6,5,2,1,0,1,0,2,0,6,0.8571428571428571,1,0.0,0,1,0,1,2,0,0,2,0,2,4,1
1236,28242,CQEE5jXQnQdeSsabuKkk73kWPFKaO3GL,5Gyp41oLVo7Gg7vF4vpmggWP5MU70QO6,13,35,16,2,8,13,12,0,86,12.285714285714286,6,0.0,7,16,1,8,28,13,1,12,0,32,54,1
1237,28253,NngfiLWKtmRngSqwhm1xLIuOMPkjqqCR,5Gyp41oLVo7Gg7vF4vpmggWP5MU70QO6,1,0,0,0,0,0,1,0,1,0.14285714285714285,1,0.0,0,0,0,0,0,0,0,1,0,0,1,1
1238,28271,2WcVsjeOm3ona29kPjgUdn7qc1GQAfCa,5Gyp41oLVo7Gg7vF4vpmggWP5MU70QO6,27,45,13,49,17,0,33,1,158,22.571428571428573,7,0.0,17,13,42,17,28,0,7,33,1,89,69,1
1239,28296,wxDnmvTLHWGwCYYCjH3qEOtgLqGKeB8y,5Gyp41oLVo7Gg7vF4vpmggWP5MU70QO6,41,182,33,12,41,7,24,15,314,44.857142857142854,11,0.0,46,33,7,41,136,7,5,24,15,127,187,1
1240,28307,8pbtepvLHKYhhqvn4VghNNHAGw8nBJaB,5Gyp41oLVo7Gg7vF4vpmggWP5MU70QO6,41,74,44,70,16,0,12,0,216,30.857142857142858,10,0.0,19,44,50,16,55,0,20,12,0,129,87,1
1241,28328,9Cl0RXvHs0leQ1PBsYPWvbt2EpF3zWdx,5Gyp41oLVo7Gg7vF4vpmggWP5MU70QO6,28,61,20,26,7,7,25,4,150,21.428571428571427,3,0.0,27,20,19,7,34,7,7,25,4,73,77,1
1242,28367,wCtJVdIYmv9Ms8iZG8chc5znpGA7mYoM,5Gyp41oLVo7Gg7vF4vpmggWP5MU70QO6,7,8,2,0,2,0,2,0,14,2.0,1,0.0,0,2,0,2,8,0,0,2,0,4,10,1
1243,28376,m7dQRuIWJcVuQOdc14mARu3GfoCyBYQO,5Gyp41oLVo7Gg7vF4vpmggWP5MU70QO6,1,0,0,0,0,0,1,0,1,0.14285714285714285,1,0.0,0,0,0,0,0,0,0,1,0,0,1,1
1244,28389,zXvgHfBVkiLefO10bIMvxqrtbllI8QiV,5Gyp41oLVo7Gg7vF4vpmggWP5MU70QO6,1,0,0,0,0,0,1,0,1,0.14285714285714285,1,0.0,0,0,0,0,0,0,0,1,0,0,1,1
1245,28437,mUsneGKGGtjpeKrQAc5CoB6gvO9CvofU,5Gyp41oLVo7Gg7vF4vpmggWP5MU70QO6,21,49,23,6,14,0,15,0,107,15.285714285714286,7,0.0,18,23,5,14,31,0,1,15,0,60,47,1
1246,28465,HYcYXnKZ11ZiED2AGb0isAMMeWUBvmoH,5Gyp41oLVo7Gg7vF4vpmggWP5MU70QO6,12,30,15,2,8,8,8,0,71,10.142857142857142,3,0.0,8,15,1,8,22,8,1,8,0,32,39,1
1247,28466,TgfUDub3GKAehIIzA0jeuMPCKRYYqncC,5Gyp41oLVo7Gg7vF4vpmggWP5MU70QO6,1,0,0,0,0,0,2,0,2,0.2857142857142857,1,0.0,0,0,0,0,0,0,0,2,0,0,2,1
1248,28479,YYnNGp0Y5eLRtkILBLNkAtUGBjLA3jPV,5Gyp41oLVo7Gg7vF4vpmggWP5MU70QO6,1,0,0,0,0,0,2,0,2,0.2857142857142857,2,0.0,0,0,0,0,0,0,0,2,0,0,2,1
1249,28493,5ESBYT4YXwThMhRWcyNvUGRmyEr1sxDg,5Gyp41oLVo7Gg7vF4vpmggWP5MU70QO6,17,37,16,4,9,2,7,0,75,10.714285714285714,4,0.0,8,16,2,9,29,2,2,7,0,35,40,0
1250,28514,wy2vY5aiYwg0C5zglGAXrG2vaWLSbGC9,5Gyp41oLVo7Gg7vF4vpmggWP5MU70QO6,34,112,22,11,7,71,28,2,253,36.142857142857146,11,0.0,13,22,8,7,99,71,3,28,2,50,203,0
1251,28528,v4hK9ikpjeYzPcAbZUA4mSmZ1iseqmpe,5Gyp41oLVo7Gg7vF4vpmggWP5MU70QO6,1,0,0,0,0,0,5,0,5,0.7142857142857143,2,0.0,0,0,0,0,0,0,0,5,0,0,5,1
1252,28535,6O4ynOxdnlabP5dKzzkEL18OruuOmtCz,5Gyp41oLVo7Gg7vF4vpmggWP5MU70QO6,8,2,1,0,0,3,8,1,15,2.142857142857143,2,0.0,0,1,0,0,2,3,0,8,1,1,14,1
1253,28550,w85QVmINOIyrXRzegh8uuBeGTw3K4uG8,5Gyp41oLVo7Gg7vF4vpmggWP5MU70QO6,23,48,26,8,14,12,10,0,118,16.857142857142858,5,0.0,13,26,7,14,35,12,1,10,0,60,58,1
1254,28551,ZmfdNNznGUKjrKBTFXV9DMVwFsyogQYG,5Gyp41oLVo7Gg7vF4vpmggWP5MU70QO6,12,24,6,0,3,0,6,0,39,5.571428571428571,2,0.0,9,6,0,3,15,0,0,6,0,18,21,0
1255,28563,p8pFuUg19xWGOlJygMvSlQjonA3l7FUn,5Gyp41oLVo7Gg7vF4vpmggWP5MU70QO6,44,156,97,27,24,10,42,1,357,51.0,18,0.0,23,97,21,24,133,10,6,42,1,165,192,0
1256,28568,AHkapH9QrrJ7u3LaJauuxoDD2RWC3zpf,5Gyp41oLVo7Gg7vF4vpmggWP5MU70QO6,13,8,6,2,3,0,3,0,22,3.142857142857143,2,0.0,0,6,1,3,8,0,1,3,0,10,12,0
1257,28607,9CRp8j1wgGbGaOcSurkiNrWOLPDhf4In,5Gyp41oLVo7Gg7vF4vpmggWP5MU70QO6,11,15,5,0,2,0,3,0,25,3.5714285714285716,2,0.0,0,5,0,2,15,0,0,3,0,7,18,0
1258,28610,hkI32MAgHvJ4T3I3Up79daEJ8l4sKHaC,5Gyp41oLVo7Gg7vF4vpmggWP5MU70QO6,18,14,7,3,6,3,7,1,41,5.857142857142857,3,0.0,4,7,2,6,10,3,1,7,1,19,22,0
1259,28633,4ZT746t8DiUlfdfcjqyaZJkio3erWKNc,5Gyp41oLVo7Gg7vF4vpmggWP5MU70QO6,6,4,2,0,3,0,3,0,12,1.7142857142857142,1,0.0,1,2,0,3,3,0,0,3,0,6,6,1
1260,28636,EiO5bky9R1Iqlpv4ItUpPBUgGb1eJItE,5Gyp41oLVo7Gg7vF4vpmggWP5MU70QO6,29,99,63,1,22,139,54,0,378,54.0,14,0.0,10,63,1,22,89,139,0,54,0,96,282,0
1261,28640,FFlICu8a1PeaY8oKBFESJAT3q6I5h6Xu,5Gyp41oLVo7Gg7vF4vpmggWP5MU70QO6,32,67,31,16,10,20,15,1,160,22.857142857142858,5,0.0,16,31,9,10,51,20,7,15,1,66,94,0
1262,28643,qzwoKNXvzaDCrQhr2gKh5368mKxrHA8O,5Gyp41oLVo7Gg7vF4vpmggWP5MU70QO6,10,6,4,2,2,0,5,0,19,2.7142857142857144,1,0.0,1,4,1,2,5,0,1,5,0,8,11,1
1263,28667,1YsC73tsWGiQDhyPcroSv5S1b65G3rWX,5Gyp41oLVo7Gg7vF4vpmggWP5MU70QO6,10,6,3,0,2,1,5,0,17,2.4285714285714284,2,0.0,0,3,0,2,6,1,0,5,0,5,12,1
1264,28671,0vzaI9g7CKCHfy8YoHkcGVFFgOW49jnb,5Gyp41oLVo7Gg7vF4vpmggWP5MU70QO6,13,17,8,0,9,1,4,1,40,5.714285714285714,2,0.0,0,8,0,9,17,1,0,4,1,17,23,1
1265,28715,LgPlpopSU02baX8XsEJO6rWixplusEKm,5Gyp41oLVo7Gg7vF4vpmggWP5MU70QO6,4,2,1,0,0,0,2,0,5,0.7142857142857143,1,0.0,0,1,0,0,2,0,0,2,0,1,4,1
1266,28732,8hZKWjYrckVlJBg63KWqw5hJHkhK9cfW,5Gyp41oLVo7Gg7vF4vpmggWP5MU70QO6,8,8,3,4,2,7,3,0,27,3.857142857142857,2,0.0,2,3,2,2,6,7,2,3,0,9,18,1
1267,28760,fol611Bi6YnD4zjFVUOPJixEwpbUH6yt,5Gyp41oLVo7Gg7vF4vpmggWP5MU70QO6,6,5,3,0,2,0,3,0,13,1.8571428571428572,2,0.0,0,3,0,2,5,0,0,3,0,5,8,1
1268,28763,FKoq4lPDlg9drsZxrDcZxTmLcsNctbfa,5Gyp41oLVo7Gg7vF4vpmggWP5MU70QO6,8,7,6,0,4,0,2,0,19,2.7142857142857144,1,0.0,0,6,0,4,7,0,0,2,0,10,9,1
1269,28780,mdVjkXaBdB9YW6Ol7L167d1GVkUMVcrc,5Gyp41oLVo7Gg7vF4vpmggWP5MU70QO6,29,71,22,18,7,6,16,0,140,20.0,5,0.0,6,22,9,7,65,6,9,16,0,44,96,0
1270,28788,frVA77S2ve21UyKXpi7aZkvcgdjXAJyT,5Gyp41oLVo7Gg7vF4vpmggWP5MU70QO6,28,75,41,17,18,12,29,2,194,27.714285714285715,5,0.0,16,41,9,18,59,12,8,29,2,84,110,1
1271,28796,PzbAAQBdNIO5q0hDkxJETX7v12Y9h0xH,5Gyp41oLVo7Gg7vF4vpmggWP5MU70QO6,48,94,47,40,30,10,14,0,235,33.57142857142857,9,0.0,24,47,29,30,70,10,11,14,0,130,105,0
1272,28860,c08HsQcychm8AwpMV8YSi2xSr7I0E7bE,5Gyp41oLVo7Gg7vF4vpmggWP5MU70QO6,11,10,6,0,3,3,6,1,29,4.142857142857143,2,0.0,0,6,0,3,10,3,0,6,1,9,20,1
1273,28878,mu7Zdr1ChN6xNMWE8Otd7Si7TQhm7pEQ,5Gyp41oLVo7Gg7vF4vpmggWP5MU70QO6,21,33,19,0,15,0,36,0,103,14.714285714285714,8,0.0,0,19,0,15,33,0,0,36,0,34,69,0
1274,28890,yQYMLm30GwIRmqXNc4Jn3nUgA6vXILUA,5Gyp41oLVo7Gg7vF4vpmggWP5MU70QO6,64,245,105,75,42,90,54,11,622,88.85714285714286,20,0.0,46,105,55,42,199,90,20,54,11,248,374,0
1275,28891,ic6pjUfgxHe0ndQH7kHuGrLDFqrjZins,5Gyp41oLVo7Gg7vF4vpmggWP5MU70QO6,23,38,27,0,10,40,18,1,134,19.142857142857142,5,0.0,4,27,0,10,34,40,0,18,1,41,93,1
1276,28945,uhXQuUUUVKIwun4V8mG56AtnRcH7YsHS,5Gyp41oLVo7Gg7vF4vpmggWP5MU70QO6,55,127,71,32,65,37,39,1,372,53.142857142857146,12,0.0,51,71,25,65,76,37,7,39,1,212,160,0
1277,28985,Sd54wuYLJGE9pQgAE1cFvsQCM2O9iNXw,5Gyp41oLVo7Gg7vF4vpmggWP5MU70QO6,12,14,8,4,4,0,11,0,41,5.857142857142857,3,0.0,4,8,2,4,10,0,2,11,0,18,23,1
1278,28986,wT7a5vDiVzDXkRsNiuW9QKVvWByJ0Qi5,5Gyp41oLVo7Gg7vF4vpmggWP5MU70QO6,5,2,1,0,1,4,3,0,11,1.5714285714285714,2,0.0,0,1,0,1,2,4,0,3,0,2,9,1
1279,29037,qRW1NJFi20MzuEcmYfBMGU0039ucrG2e,5Gyp41oLVo7Gg7vF4vpmggWP5MU70QO6,11,7,5,0,4,0,2,0,18,2.5714285714285716,2,0.0,0,5,0,4,7,0,0,2,0,9,9,1
1280,29055,mkvSz33MEIqqx5kghC6tYYiyjKCjfl96,5Gyp41oLVo7Gg7vF4vpmggWP5MU70QO6,25,77,5,18,12,20,10,0,142,20.285714285714285,5,0.0,24,5,12,12,53,20,6,10,0,53,89,1
1281,29068,TgbjfjUFSMyIygN3wQCm7khTpUBgPmir,5Gyp41oLVo7Gg7vF4vpmggWP5MU70QO6,7,3,3,0,3,0,6,0,15,2.142857142857143,3,0.0,0,3,0,3,3,0,0,6,0,6,9,1
1282,29093,SFygdEesOWeEamKu8iZBsgHneiDiai0R,5Gyp41oLVo7Gg7vF4vpmggWP5MU70QO6,17,44,3,18,5,23,13,1,107,15.285714285714286,4,0.0,16,3,15,5,28,23,3,13,1,39,68,1
1283,29104,ttGeClEg7U7l2A1yOwZnUOxTG4fiBvUu,5Gyp41oLVo7Gg7vF4vpmggWP5MU70QO6,31,74,31,12,10,24,24,2,177,25.285714285714285,5,0.0,30,31,8,10,44,24,4,24,2,79,98,0
1284,29127,9Deod69Pavn4hLb5cpG0UIDdFFESLD48,5Gyp41oLVo7Gg7vF4vpmggWP5MU70QO6,40,103,68,36,24,12,29,0,272,38.857142857142854,10,0.0,18,68,30,24,85,12,6,29,0,140,132,0
1285,29145,2b2oMscZ1TebdXSExRxc1Bj8PyIwjK6W,5Gyp41oLVo7Gg7vF4vpmggWP5MU70QO6,14,12,7,2,3,6,10,5,45,6.428571428571429,2,0.0,1,7,1,3,11,6,1,10,5,12,33,1
1286,29187,mdSCcL6byi6i0rQq7vUuOfZa5NPcjPwa,5Gyp41oLVo7Gg7vF4vpmggWP5MU70QO6,12,18,9,0,2,0,12,1,42,6.0,4,0.0,2,9,0,2,16,0,0,12,1,13,29,1
1287,29195,yYQocPsuMZkLILVBlIi2Rx8RiVGy4Kig,5Gyp41oLVo7Gg7vF4vpmggWP5MU70QO6,15,25,12,8,4,1,8,0,58,8.285714285714286,4,0.0,8,12,4,4,17,1,4,8,0,28,30,1
1288,29225,uOfATV0WsL0BPHDdVyS70rl0sYjdudpd,5Gyp41oLVo7Gg7vF4vpmggWP5MU70QO6,14,22,13,0,6,0,12,0,53,7.571428571428571,3,0.0,3,13,0,6,19,0,0,12,0,22,31,1
1289,29240,1Olz0ty9MvTmtUb0M52tOOOcEs0aIaEY,5Gyp41oLVo7Gg7vF4vpmggWP5MU70QO6,1,0,0,0,0,0,1,0,1,0.14285714285714285,1,0.0,0,0,0,0,0,0,0,1,0,0,1,1
1290,29250,kl6dUylPscrmRxWR7PKwfLKeebQbD2NE,5Gyp41oLVo7Gg7vF4vpmggWP5MU70QO6,25,37,19,45,6,1,18,0,126,18.0,4,0.0,7,19,26,6,30,1,19,18,0,58,68,1
1291,29262,idKVU6p7Q7GgRNB8N8uPXj3SONpH1Rke,5Gyp41oLVo7Gg7vF4vpmggWP5MU70QO6,1,0,0,0,0,0,1,0,1,0.14285714285714285,1,0.0,0,0,0,0,0,0,0,1,0,0,1,1
1292,29294,bZSiNUbAIuydDBd77IMAJ15Hy6k2A1kT,5Gyp41oLVo7Gg7vF4vpmggWP5MU70QO6,35,60,34,0,35,0,14,0,143,20.428571428571427,7,0.0,13,34,0,35,47,0,0,14,0,82,61,0
1293,29367,dm4zpyltgmDIt6SIOPnfzTRvAHU2zRpp,5Gyp41oLVo7Gg7vF4vpmggWP5MU70QO6,20,44,18,17,11,1,15,1,107,15.285714285714286,4,0.0,12,18,10,11,32,1,7,15,1,51,56,1
1294,29394,37lByEE8WN5dPOAL2dEzbVefMVMHIaPH,5Gyp41oLVo7Gg7vF4vpmggWP5MU70QO6,8,4,3,0,2,0,3,0,12,1.7142857142857142,2,0.0,0,3,0,2,4,0,0,3,0,5,7,1
1295,29464,98wdVgRpIzzxv6FEBv2es1MV8Ls3L0ff,5Gyp41oLVo7Gg7vF4vpmggWP5MU70QO6,2,0,0,0,0,0,2,0,2,0.2857142857142857,1,0.0,0,0,0,0,0,0,0,2,0,0,2,1
1296,29467,rwMpuxSfD7Lu5aEL6nFb4pXB5iDR4ILs,5Gyp41oLVo7Gg7vF4vpmggWP5MU70QO6,19,22,8,11,8,0,7,0,56,8.0,5,0.0,10,8,6,8,12,0,5,7,0,32,24,1
1297,29473,eZT1tCGv7ql9L5dEX3d6J5TryJHsMnpT,5Gyp41oLVo7Gg7vF4vpmggWP5MU70QO6,20,65,32,41,6,27,13,0,184,26.285714285714285,5,0.0,19,32,32,6,46,27,9,13,0,89,95,1
1298,29546,iO6L3vok1fllqPx0z6YlAf4W2nodktEN,5Gyp41oLVo7Gg7vF4vpmggWP5MU70QO6,7,9,0,0,0,0,3,0,12,1.7142857142857142,2,0.0,0,0,0,0,9,0,0,3,0,0,12,1
1299,29548,t1wUeepuMaeBvweqDP1pkKhuC8LiCavy,5Gyp41oLVo7Gg7vF4vpmggWP5MU70QO6,1,0,0,0,0,0,1,0,1,0.14285714285714285,1,0.0,0,0,0,0,0,0,0,1,0,0,1,1
1300,29559,TZGLsnS0OskuSmNrW3qdgst3uvhaNLjD,5Gyp41oLVo7Gg7vF4vpmggWP5MU70QO6,26,55,5,25,2,7,16,0,110,15.714285714285714,10,0.0,11,5,15,2,44,7,10,16,0,33,77,0
1301,29566,sT9hGAnww95aeGvqwQpJlS3ORhWDT49F,5Gyp41oLVo7Gg7vF4vpmggWP5MU70QO6,49,158,80,45,46,36,20,0,385,55.0,13,0.0,47,80,39,46,111,36,6,20,0,212,173,0
1302,29577,7wwHSUUi5ouCvH7RjsBJGH89ztv8nsnA,5Gyp41oLVo7Gg7vF4vpmggWP5MU70QO6,32,85,41,45,23,7,15,1,217,31.0,8,0.0,27,41,32,23,58,7,13,15,1,123,94,0
1303,29633,dsdOD3NrPkc2eTt8dL4TaCyvJ5rogMJq,3VkHkmOtom3jM2wCu94xgzzu1d6Dn7or,13,40,2,9,3,3,2,0,59,8.428571428571429,3,0.0,12,2,8,3,28,3,1,2,0,25,34,0
1304,29667,pg03VLobZ1zAAslEUdBaTgGu7kih28vz,3VkHkmOtom3jM2wCu94xgzzu1d6Dn7or,9,9,5,0,4,2,5,0,25,3.5714285714285716,2,0.0,0,5,0,4,9,2,0,5,0,9,16,1
1305,29671,WAn6J5qLSuupwso8SwtC7r0DqitXUS7t,3VkHkmOtom3jM2wCu94xgzzu1d6Dn7or,75,168,87,45,80,41,20,0,441,63.0,9,0.0,66,87,38,80,102,41,7,20,0,271,170,0
1306,29732,X1cnM6NzueQKdaGAohdVsBX0QRaVauMf,3VkHkmOtom3jM2wCu94xgzzu1d6Dn7or,88,308,107,100,63,71,20,2,671,95.85714285714286,7,0.0,121,107,95,63,187,71,5,20,2,386,285,1
1307,29735,fO58OblePrlYqNXkY14ASaYtA3H6kwGM,3VkHkmOtom3jM2wCu94xgzzu1d6Dn7or,49,90,51,59,2,42,4,0,248,35.42857142857143,4,0.0,35,51,53,2,55,42,6,4,0,141,107,0
1308,29770,DqvbpPfr9acXSV6QO6M6ES8wMSG8SUrG,3VkHkmOtom3jM2wCu94xgzzu1d6Dn7or,60,45,6,0,29,0,9,0,89,12.714285714285714,7,0.0,0,6,0,29,45,0,0,9,0,35,54,0
1309,29777,8XstJLDa8agdHppUFVVZbvtgkIjc1hSo,3VkHkmOtom3jM2wCu94xgzzu1d6Dn7or,75,239,87,46,65,17,57,10,521,74.42857142857143,16,0.0,51,87,37,65,188,17,9,57,10,240,281,0
1310,29780,tvzs5lw4yebuwJVV8CY40WNCneNIfwfG,3VkHkmOtom3jM2wCu94xgzzu1d6Dn7or,18,24,11,3,7,2,23,1,71,10.142857142857142,6,0.0,5,11,3,7,19,2,0,23,1,26,45,1
1311,29798,dZ0Tp80YaLSVwZx2HA5LGLVQa5b5xsfa,3VkHkmOtom3jM2wCu94xgzzu1d6Dn7or,4,6,2,0,3,0,1,0,12,1.7142857142857142,2,0.0,3,2,0,3,3,0,0,1,0,8,4,1
1312,29806,mFEkB6ZRZ9NSA8FsafZjEjQoXSnz45rD,3VkHkmOtom3jM2wCu94xgzzu1d6Dn7or,7,4,2,0,1,0,5,0,12,1.7142857142857142,2,0.0,0,2,0,1,4,0,0,5,0,3,9,0
1313,29825,KSfQPUyfWWfWDmmi6m3KXcKzxz89wkwt,3VkHkmOtom3jM2wCu94xgzzu1d6Dn7or,81,212,36,52,65,29,38,3,435,62.142857142857146,9,0.0,59,36,46,65,153,29,6,38,3,206,229,0
1314,29858,2jLM7Yi5RJYMPqOXOcapsjfy9JxX4cwG,3VkHkmOtom3jM2wCu94xgzzu1d6Dn7or,95,177,56,81,70,5,36,2,427,61.0,17,0.0,99,56,60,70,78,5,21,36,2,285,142,0
1315,29898,rwVFzRApiQw3vAU5Rpa6do3mD0uc5CXG,3VkHkmOtom3jM2wCu94xgzzu1d6Dn7or,68,219,69,110,59,21,51,2,531,75.85714285714286,16,0.0,101,69,93,59,118,21,17,51,2,322,209,0
1316,29936,XVEoTrdeHB4XjrmhKuWAwbiVsL2RLQJk,3VkHkmOtom3jM2wCu94xgzzu1d6Dn7or,54,157,88,0,21,18,12,0,296,42.285714285714285,18,0.0,2,88,0,21,155,18,0,12,0,111,185,0
1317,29968,QmiSyu11fn1nDX0iNcInUfGfKZJu6upP,3VkHkmOtom3jM2wCu94xgzzu1d6Dn7or,67,150,93,29,61,32,17,9,391,55.857142857142854,17,0.0,50,93,27,61,100,32,2,17,9,231,160,0
1318,29999,5kqorcxIJejDFcc1de7q3uie94xFSgMJ,3VkHkmOtom3jM2wCu94xgzzu1d6Dn7or,60,274,117,121,0,55,39,0,606,86.57142857142857,10,0.0,98,117,119,0,176,55,2,39,0,334,272,0
1319,30007,gDo9M8HDbXmLQPxqqLTsn9N4ZUEPKvcn,3VkHkmOtom3jM2wCu94xgzzu1d6Dn7or,42,145,50,30,32,15,16,0,288,41.142857142857146,4,0.0,36,50,25,32,109,15,5,16,0,143,145,0
1320,30011,Slk5JcZSYHmDLQZXaNVmcMDmjJ16kBhI,3VkHkmOtom3jM2wCu94xgzzu1d6Dn7or,65,243,9,83,15,38,58,19,465,66.42857142857143,15,0.0,85,9,78,15,158,38,5,58,19,187,278,0
1321,30099,1v41istydAF4xDubBoWMWYIs9r6KOsSl,3VkHkmOtom3jM2wCu94xgzzu1d6Dn7or,63,169,43,59,62,31,26,1,391,55.857142857142854,11,0.0,104,43,48,62,65,31,11,26,1,257,134,0
1322,30128,Ovk8jBBHwwhBttek79ARCgIpAVxMH1wF,3VkHkmOtom3jM2wCu94xgzzu1d6Dn7or,84,214,68,107,47,35,27,10,508,72.57142857142857,15,0.0,96,68,106,47,118,35,1,27,10,317,191,0
1323,30131,r5nHhhPp8wNqkUKwaWfUvmNqly1MZrKz,3VkHkmOtom3jM2wCu94xgzzu1d6Dn7or,49,134,28,37,16,41,20,1,277,39.57142857142857,9,0.0,31,28,36,16,103,41,1,20,1,111,166,0
1324,30142,3rQp9Pg1jh14kwWG2t2nthBHhNXGFa82,3VkHkmOtom3jM2wCu94xgzzu1d6Dn7or,84,143,60,47,62,5,17,1,335,47.857142857142854,10,0.0,60,60,44,62,83,5,3,17,1,226,109,0
1325,30155,JS66kD0s0JzvdxjXoj25UPnuGjR15s0e,3VkHkmOtom3jM2wCu94xgzzu1d6Dn7or,87,253,89,59,87,51,20,7,566,80.85714285714286,9,0.0,139,89,52,87,114,51,7,20,7,367,199,0
1326,30172,m7jLYh84m9f53uDPmmpRCKYuGkwpenOB,3VkHkmOtom3jM2wCu94xgzzu1d6Dn7or,57,100,62,13,41,5,22,2,245,35.0,10,0.0,10,62,10,41,90,5,3,22,2,123,122,0
1327,30175,qxtccqDGdpmW3MuPEOxMGh1ykxuH1P3R,3VkHkmOtom3jM2wCu94xgzzu1d6Dn7or,1,0,0,0,0,0,1,0,1,0.14285714285714285,1,0.0,0,0,0,0,0,0,0,1,0,0,1,1
1328,30188,HIt61VCQ5zz5HCTk7oYfdjcKhSUyK2YR,3VkHkmOtom3jM2wCu94xgzzu1d6Dn7or,37,83,24,53,27,2,15,2,206,29.428571428571427,8,0.0,46,24,45,27,37,2,8,15,2,142,64,1
1329,30244,6qeY7D4uPIs5tgq1S8ChR85fAeSaBpIZ,3VkHkmOtom3jM2wCu94xgzzu1d6Dn7or,22,70,33,7,22,89,20,0,241,34.42857142857143,5,0.0,25,33,7,22,45,89,0,20,0,87,154,1
1330,30280,Afqa0e6snHIpElZH8llhZ4r1dJaGoZZy,3VkHkmOtom3jM2wCu94xgzzu1d6Dn7or,10,8,5,0,5,0,3,0,21,3.0,1,0.0,0,5,0,5,8,0,0,3,0,10,11,1
1331,30337,NyeTkq313QL5kAKn6ZnLblvLSgZR58bd,3VkHkmOtom3jM2wCu94xgzzu1d6Dn7or,9,9,4,0,2,3,18,0,36,5.142857142857143,6,0.0,0,4,0,2,9,3,0,18,0,6,30,1
1332,30349,kjmB7rYJ6COKWLfV3I2XFdbyEP1GXHRT,3VkHkmOtom3jM2wCu94xgzzu1d6Dn7or,9,7,0,0,0,4,11,1,23,3.2857142857142856,2,0.0,2,0,0,0,5,4,0,11,1,2,21,0
1333,30381,artMcWhuxDvKZlHhCoLq6TeOK3memzwM,3VkHkmOtom3jM2wCu94xgzzu1d6Dn7or,6,5,3,0,2,0,3,0,13,1.8571428571428572,1,0.0,0,3,0,2,5,0,0,3,0,5,8,1
1334,30383,I5NS9TaNpjWXja9K1FgfoAA30bpJOAs7,3VkHkmOtom3jM2wCu94xgzzu1d6Dn7or,51,224,21,26,7,44,38,7,367,52.42857142857143,11,0.0,68,21,25,7,156,44,1,38,7,121,246,0
1335,30398,5Fp6zT5AKFMQmNFvYerZcjV0FupJGrAT,3VkHkmOtom3jM2wCu94xgzzu1d6Dn7or,62,202,102,33,59,64,20,0,480,68.57142857142857,10,0.0,67,102,29,59,135,64,4,20,0,257,223,0
1336,30407,RJwnOph0p8T6UAPo7WZFtHqjtt1K7VgK,3VkHkmOtom3jM2wCu94xgzzu1d6Dn7or,97,210,113,91,78,43,67,2,604,86.28571428571429,15,0.0,56,113,83,78,154,43,8,67,2,330,274,0
1337,30411,SZ5q3TqDiWq8s23sHXWpsG5po2IH5JPk,3VkHkmOtom3jM2wCu94xgzzu1d6Dn7or,48,122,5,39,4,0,13,0,183,26.142857142857142,11,0.0,25,5,32,4,97,0,7,13,0,66,117,0
1338,30433,sHKJOZO850rbGXrdoemFGCG92qkecGY0,3VkHkmOtom3jM2wCu94xgzzu1d6Dn7or,67,221,35,59,13,3,10,0,341,48.714285714285715,11,0.0,71,35,53,13,150,3,6,10,0,172,169,0
1339,30439,ctdO04zd7K8QUa5HFdH2dxaEs6nEQGcX,3VkHkmOtom3jM2wCu94xgzzu1d6Dn7or,66,165,26,46,21,8,13,4,283,40.42857142857143,6,0.0,99,26,45,21,66,8,1,13,4,191,92,1
1340,30442,IDNwyiCMAiwxgw0U0b9BrtE0TLcWOqS0,3VkHkmOtom3jM2wCu94xgzzu1d6Dn7or,4,2,1,0,0,0,2,0,5,0.7142857142857143,1,0.0,0,1,0,0,2,0,0,2,0,1,4,1
1341,30469,wkfBzItw0JCH6ZUz2WUZn7ngJ5M4Oksy,3VkHkmOtom3jM2wCu94xgzzu1d6Dn7or,6,2,1,0,1,0,4,0,8,1.1428571428571428,1,0.0,0,1,0,1,2,0,0,4,0,2,6,1
1342,30474,mrf0o1UB2V4aDgKrZVpLlOVi6iROZ8B8,3VkHkmOtom3jM2wCu94xgzzu1d6Dn7or,24,42,10,19,12,17,35,1,136,19.428571428571427,3,0.0,18,10,16,12,24,17,3,35,1,56,80,1
1343,30479,YqCc1EVkrnp1zeYgFSXXp9IfOfsT1x10,3VkHkmOtom3jM2wCu94xgzzu1d6Dn7or,1,0,0,0,0,0,1,0,1,0.14285714285714285,1,0.0,0,0,0,0,0,0,0,1,0,0,1,1
1344,30486,FELnhQR0c7GZZX82ioYJEZsqujOrfyf7,3VkHkmOtom3jM2wCu94xgzzu1d6Dn7or,77,130,49,76,40,25,28,2,350,50.0,8,0.0,41,49,62,40,89,25,14,28,2,192,158,0
1345,30533,DHyGbluRYDb9YK4sD54nYIDtRwaCVU4f,3VkHkmOtom3jM2wCu94xgzzu1d6Dn7or,94,190,85,60,55,39,35,7,471,67.28571428571429,12,0.0,65,85,56,55,125,39,4,35,7,261,210,0
1346,30622,3w3oVzXQmE457clbfwy8fl67WyFwWeZX,3VkHkmOtom3jM2wCu94xgzzu1d6Dn7or,20,48,21,26,9,12,18,3,137,19.571428571428573,3,0.0,4,21,22,9,44,12,4,18,3,56,81,1
1347,30635,l5LfU8gApOG72AnBkdAbfOLQLwFH7Zo2,3VkHkmOtom3jM2wCu94xgzzu1d6Dn7or,96,176,92,90,79,17,32,4,490,70.0,12,0.0,61,92,81,79,115,17,9,32,4,313,177,0
1348,30636,6DSuISWcDoqSW3Fjsz6tgWgsz6o5ZWJK,3VkHkmOtom3jM2wCu94xgzzu1d6Dn7or,59,186,70,27,45,3,72,1,404,57.714285714285715,11,0.0,64,70,25,45,122,3,2,72,1,204,200,0
1349,30656,NtU1IyW3HJl1pm4Tp4BEiaKIm4SZ64WI,7GRhBDsirIGkRZBtSMEzNTyDr2JQm4xx,11,8,6,0,5,0,2,0,21,3.0,1,0.0,0,6,0,5,8,0,0,2,0,11,10,1
1350,30658,Sk4DUKJRImF6lijTnkABuH01jDj9zcnP,7GRhBDsirIGkRZBtSMEzNTyDr2JQm4xx,29,54,20,18,11,4,3,0,110,15.714285714285714,2,0.0,29,20,9,11,25,4,9,3,0,69,41,0
1351,30659,3maFRlOOd3EYa40kgTAIu1lm1eFDh0j4,7GRhBDsirIGkRZBtSMEzNTyDr2JQm4xx,7,4,2,0,1,1,8,0,16,2.2857142857142856,1,0.0,0,2,0,1,4,1,0,8,0,3,13,0
1352,30660,RUwvt9IgBwxYizmuYQEH8XKuThZiqYF8,7GRhBDsirIGkRZBtSMEzNTyDr2JQm4xx,25,20,12,4,8,0,9,0,53,7.571428571428571,1,0.0,3,12,3,8,17,0,1,9,0,26,27,0
1353,30663,xeya2cHcAbAMxP30XnqxgcIBc9AC6RUk,7GRhBDsirIGkRZBtSMEzNTyDr2JQm4xx,30,66,13,16,10,3,2,0,110,15.714285714285714,1,0.0,26,13,8,10,40,3,8,2,0,57,53,0
1354,30668,OXZ6du3ugmpMvD1ZOwbzOlvOjr4PkR7j,7GRhBDsirIGkRZBtSMEzNTyDr2JQm4xx,2,0,0,0,0,0,4,0,4,0.5714285714285714,3,0.0,0,0,0,0,0,0,0,4,0,0,4,0
1355,30669,qerVuOcN5RDlT8Xm5Md7fl5nWFxIxkMg,7GRhBDsirIGkRZBtSMEzNTyDr2JQm4xx,11,8,4,0,3,0,2,0,17,2.4285714285714284,1,0.0,0,4,0,3,8,0,0,2,0,7,10,1
1356,30673,hMsNCldAkGadwgGX6yjkMuu7X3GLTjYs,7GRhBDsirIGkRZBtSMEzNTyDr2JQm4xx,47,49,18,30,16,0,8,0,121,17.285714285714285,1,0.0,26,18,16,16,23,0,14,8,0,76,45,0
1357,30676,H98nROYI5ks5CHxEsgYii9bCzrDc1klK,7GRhBDsirIGkRZBtSMEzNTyDr2JQm4xx,26,27,22,2,16,0,2,0,69,9.857142857142858,1,0.0,2,22,1,16,25,0,1,2,0,41,28,0
1358,30682,qNcXXMS6gofQ1zxFTFUpTVwHS32UZFmm,7GRhBDsirIGkRZBtSMEzNTyDr2JQm4xx,18,21,9,0,10,0,5,0,45,6.428571428571429,2,0.0,9,9,0,10,12,0,0,5,0,28,17,1
1359,30683,MvaDWypMmkxHk7Ock5CxxQuhKgqiD605,7GRhBDsirIGkRZBtSMEzNTyDr2JQm4xx,1,0,0,0,0,0,1,0,1,0.14285714285714285,1,0.0,0,0,0,0,0,0,0,1,0,0,1,1
1360,30684,kkNrpXfkeU300G4R897Q9HTV5p9hVKGz,7GRhBDsirIGkRZBtSMEzNTyDr2JQm4xx,1,0,0,0,0,0,1,0,1,0.14285714285714285,1,0.0,0,0,0,0,0,0,0,1,0,0,1,1
1361,30685,4sj7W3cGgiwnZG5WoCWQsakUkJaFReoi,7GRhBDsirIGkRZBtSMEzNTyDr2JQm4xx,21,28,0,12,3,12,6,0,61,8.714285714285714,1,0.0,15,0,7,3,13,12,5,6,0,25,36,0
1362,30700,uAXW7zeSaEEtMIdMcVsYpUquscAKUnr7,7GRhBDsirIGkRZBtSMEzNTyDr2JQm4xx,9,19,6,0,3,0,4,0,32,4.571428571428571,2,0.0,1,6,0,3,18,0,0,4,0,10,22,1
1363,30706,2aVoBs6PX62Evhzhd5ZYUQ5juZY4Z8Ua,7GRhBDsirIGkRZBtSMEzNTyDr2JQm4xx,101,334,7,157,61,17,7,0,583,83.28571428571429,7,0.0,167,7,109,61,167,17,48,7,0,344,239,0
1364,30707,HieynNXGTcRrvcPwh1BycmrnVEVwSnTe,7GRhBDsirIGkRZBtSMEzNTyDr2JQm4xx,3,0,0,0,0,0,4,0,4,0.5714285714285714,1,0.0,0,0,0,0,0,0,0,4,0,0,4,1
1365,30711,1XvURm7yGc5tr3i493QgWxpiog16HjjL,7GRhBDsirIGkRZBtSMEzNTyDr2JQm4xx,1,0,0,0,0,0,1,0,1,0.14285714285714285,1,0.0,0,0,0,0,0,0,0,1,0,0,1,1
1366,30712,0tL89xWcZEpMYz2wwgMI1fL3hUww7LB1,7GRhBDsirIGkRZBtSMEzNTyDr2JQm4xx,9,5,1,0,1,0,5,0,12,1.7142857142857142,1,0.0,0,1,0,1,5,0,0,5,0,2,10,1
1367,30714,4cbLQfIw8Oe5QJLksNPGddAvTWPccsWm,7GRhBDsirIGkRZBtSMEzNTyDr2JQm4xx,1,0,0,0,0,0,1,0,1,0.14285714285714285,1,0.0,0,0,0,0,0,0,0,1,0,0,1,1
1368,30718,R2bf9dlDhtEUgfKzXR1GPBa12LhUfZ8W,7GRhBDsirIGkRZBtSMEzNTyDr2JQm4xx,59,93,54,15,62,5,2,0,231,33.0,2,0.0,34,54,14,62,59,5,1,2,0,164,67,0
1369,30725,KKucKF6t4sZFfWrdZzwn5P82gPTUtVUB,7GRhBDsirIGkRZBtSMEzNTyDr2JQm4xx,1,0,0,0,0,0,1,0,1,0.14285714285714285,1,0.0,0,0,0,0,0,0,0,1,0,0,1,1
1370,30726,hY0CpdrgIS3oleTusy8P7kOvruPJKF3n,7GRhBDsirIGkRZBtSMEzNTyDr2JQm4xx,27,50,1,0,1,12,19,3,86,12.285714285714286,1,0.0,7,1,0,1,43,12,0,19,3,9,77,0
1371,30727,ti4xCNRvk7jmkirx440k5R1VXr1Il2pA,7GRhBDsirIGkRZBtSMEzNTyDr2JQm4xx,2,0,0,0,0,0,3,0,3,0.42857142857142855,1,0.0,0,0,0,0,0,0,0,3,0,0,3,1
1372,30749,EzcskHbN4FkKLdpIaSUaIKRBG0Df45oD,7GRhBDsirIGkRZBtSMEzNTyDr2JQm4xx,5,2,1,0,1,0,2,0,6,0.8571428571428571,1,0.0,0,1,0,1,2,0,0,2,0,2,4,0
1373,30759,vocq2qTAQIpXo7NloCyQjKAwRekZv7g6,5X6FeZozNMgE2VRi3MJYjkkFK8SETtu2,16,81,23,10,7,14,20,1,156,22.285714285714285,5,0.0,25,23,10,7,56,14,0,20,1,65,91,1
1374,30764,KanwbfDrW8kxJGgebHYUwn7eXlMzxejx,SpATywNh6bZuzm8s1ceuBUnMUAeoAHHw,25,65,41,0,0,0,16,1,123,17.571428571428573,2,0.0,20,41,0,0,45,0,0,16,1,61,62,0
1375,30778,vocq2qTAQIpXo7NloCyQjKAwRekZv7g6,A3fsA9Zfv1X2fVEQhTw51lKENdNrEqT3,5,5,3,0,0,0,3,0,11,1.5714285714285714,2,0.0,0,3,0,0,5,0,0,3,0,3,8,1
1376,30785,rf4oo5VCac1USN0w21Ny3OOp1AZe5MC5,RXDvfPUBYFlVdlueBFbLW0mhhAyGEqpt,59,30,18,65,12,2,3,0,130,18.571428571428573,1,0.0,11,18,65,12,19,2,0,3,0,106,24,1
1377,30794,Px6gq8I7FxGPVyAUXddechLbGi5DqbHP,SpATywNh6bZuzm8s1ceuBUnMUAeoAHHw,5,3,0,0,0,0,2,0,5,0.7142857142857143,1,0.0,0,0,0,0,3,0,0,2,0,0,5,0
1378,30804,xVvNMYPAdkOMbR8cyTeqVHpVoO8wZQ2b,SpATywNh6bZuzm8s1ceuBUnMUAeoAHHw,48,67,31,63,14,0,8,0,183,26.142857142857142,3,0.0,30,31,49,14,37,0,14,8,0,124,59,1
1379,30813,9mbf3ur4VQ377zp6wWXm0F44HQK66rP5,SpATywNh6bZuzm8s1ceuBUnMUAeoAHHw,21,47,4,23,2,0,11,0,87,12.428571428571429,5,0.0,11,4,19,2,36,0,4,11,0,36,51,0
1380,30817,tZijFtzNclgTMdwkMQrTBxI1LQ4YUcIA,SpATywNh6bZuzm8s1ceuBUnMUAeoAHHw,2,0,0,0,0,0,2,0,2,0.2857142857142857,1,0.0,0,0,0,0,0,0,0,2,0,0,2,1
1381,30818,aRrVk5Mj3FLAOkeQfPKXeuOPNpHy5HUB,RXDvfPUBYFlVdlueBFbLW0mhhAyGEqpt,12,13,8,10,5,0,3,0,39,5.571428571428571,3,0.0,1,8,9,5,12,0,1,3,0,23,16,0
1382,30819,RA66CdkyaZBWcwFww8Jk434ejvfq5mi3,SpATywNh6bZuzm8s1ceuBUnMUAeoAHHw,15,12,6,17,3,2,3,0,43,6.142857142857143,1,0.0,4,6,15,3,8,2,2,3,0,28,15,0
1383,30823,jLGWqcJWbPwbqDpaLuVE2buM1VcjzYrZ,A3fsA9Zfv1X2fVEQhTw51lKENdNrEqT3,73,45,35,134,26,0,4,0,244,34.857142857142854,4,0.0,2,35,122,26,43,0,12,4,0,185,59,0
1384,30831,BRyXI2jlP9arzZoLjKD1qwawYxBWQDfb,5X6FeZozNMgE2VRi3MJYjkkFK8SETtu2,17,22,7,19,9,0,6,0,63,9.0,2,0.0,13,7,18,9,9,0,1,6,0,47,16,1
1385,30847,gXLitrmdBVXj6hOavgwX5Kv8nSH9hE13,A3fsA9Zfv1X2fVEQhTw51lKENdNrEqT3,6,3,2,0,2,0,1,0,8,1.1428571428571428,1,0.0,0,2,0,2,3,0,0,1,0,4,4,1
1386,30856,4LLdV2zTWS697dAsOgAPJZPFwfNnrjt6,RXDvfPUBYFlVdlueBFbLW0mhhAyGEqpt,42,37,25,56,20,7,9,5,159,22.714285714285715,3,0.0,8,25,51,20,29,7,5,9,5,104,55,1
1387,30875,7xwH0IGxUu9oyiAWk7HpSQpakcHGIuLy,G8EPVSXsOYB5YQWZGiz1aVq5Pgr2GrQu,81,147,2,204,12,5,27,26,423,60.42857142857143,3,0.0,25,2,175,12,122,5,29,27,26,214,209,0
1388,30876,oUNptzxKR6Tg3LMdUCW3RAFgD2fbf3ju,SpATywNh6bZuzm8s1ceuBUnMUAeoAHHw,13,14,0,0,0,0,2,0,16,2.2857142857142856,1,0.0,0,0,0,0,14,0,0,2,0,0,16,0
1389,30915,8HJiZoOTUArj8ouKObToEc9cbZd1p0Hh,SpATywNh6bZuzm8s1ceuBUnMUAeoAHHw,36,47,24,22,13,0,7,0,113,16.142857142857142,3,0.0,9,24,21,13,38,0,1,7,0,67,46,1
1390,30929,9rkUO9AmZpdcwHkQIT6O3wGbPIgRHhIC,7GRhBDsirIGkRZBtSMEzNTyDr2JQm4xx,3,2,1,0,0,0,2,0,5,0.7142857142857143,1,0.0,0,1,0,0,2,0,0,2,0,1,4,1
1391,30935,VJHbWvAWybz77B40hY0AnZI5qx2EBxFd,SpATywNh6bZuzm8s1ceuBUnMUAeoAHHw,12,9,0,0,0,1,5,1,16,2.2857142857142856,1,0.0,0,0,0,0,9,1,0,5,1,0,16,1
1392,30954,nwtHcoMSMQeJaqDcIan7rd572O7TnAbe,SpATywNh6bZuzm8s1ceuBUnMUAeoAHHw,12,32,14,0,0,1,13,1,61,8.714285714285714,2,0.0,6,14,0,0,26,1,0,13,1,20,41,1
1393,30956,c1367E6Oj62TEXxGVpjanEuma6l30slZ,SpATywNh6bZuzm8s1ceuBUnMUAeoAHHw,17,13,7,15,5,0,4,0,44,6.285714285714286,2,0.0,4,7,14,5,9,0,1,4,0,30,14,1
1394,30958,pUAD8nrBU2agaJjO2oyqax3esP7bDAod,SpATywNh6bZuzm8s1ceuBUnMUAeoAHHw,23,39,4,9,4,0,7,0,63,9.0,4,0.0,2,4,9,4,37,0,0,7,0,19,44,0
1395,30960,HFSA5mZu8SjtTZt5y8xxQ1NSNLuijpbs,SpATywNh6bZuzm8s1ceuBUnMUAeoAHHw,34,40,31,18,22,0,9,0,120,17.142857142857142,3,0.0,4,31,17,22,36,0,1,9,0,74,46,0
1396,30969,8tVilTDlazfHpulhk6UMP8XQcjzE96hh,SpATywNh6bZuzm8s1ceuBUnMUAeoAHHw,8,4,3,0,3,0,3,0,13,1.8571428571428572,1,0.0,0,3,0,3,4,0,0,3,0,6,7,1
1397,30974,Jtu9eyRuUZ3eoiMeBPyruGhl6SYuWTeV,SpATywNh6bZuzm8s1ceuBUnMUAeoAHHw,24,33,0,26,0,9,10,2,80,11.428571428571429,2,0.0,11,0,25,0,22,9,1,10,2,36,44,1
1398,30977,n3dfmjOaJZ6J4GfeFM8ghGfKc9Mr8r4f,SpATywNh6bZuzm8s1ceuBUnMUAeoAHHw,16,28,12,17,6,0,4,0,67,9.571428571428571,5,0.0,10,12,15,6,18,0,2,4,0,43,24,1
1399,30986,8KSstsh3YYhIzd54fsYY1T96OfiCGWLi,SpATywNh6bZuzm8s1ceuBUnMUAeoAHHw,10,35,12,17,0,0,22,0,86,12.285714285714286,5,0.0,14,12,15,0,21,0,2,22,0,41,45,0
1400,30988,CRT8cgYCFunKga5R1j2C55Lv6W5lDPpk,A3fsA9Zfv1X2fVEQhTw51lKENdNrEqT3,9,4,3,0,3,0,3,0,13,1.8571428571428572,1,0.0,0,3,0,3,4,0,0,3,0,6,7,1
1401,30989,tHNSnLtZK1vGs5MVrEoD7S1mcW3GtFm4,G8EPVSXsOYB5YQWZGiz1aVq5Pgr2GrQu,37,40,13,66,5,0,2,0,126,18.0,2,0.0,18,13,43,5,22,0,23,2,0,79,47,0
1402,30996,WNlTer437rP0ycEd1BKVfCjGSSopiPqX,SpATywNh6bZuzm8s1ceuBUnMUAeoAHHw,26,61,2,13,0,51,21,3,151,21.571428571428573,4,0.0,14,2,13,0,47,51,0,21,3,29,122,0
1403,31002,EfteYUnYYLq9uOBoKEC0F2UwFqIZoKtW,RXDvfPUBYFlVdlueBFbLW0mhhAyGEqpt,24,22,16,0,14,0,2,0,54,7.714285714285714,3,0.0,2,16,0,14,20,0,0,2,0,32,22,0
1404,31021,t069DROGMOy4O12B9Ty0yznUmNUBGFUp,SpATywNh6bZuzm8s1ceuBUnMUAeoAHHw,7,3,2,0,2,0,2,0,9,1.2857142857142858,1,0.0,0,2,0,2,3,0,0,2,0,4,5,1
1405,31033,uUSTKM8g1hIskJbYHh1UiIQ6epHTSTNR,SpATywNh6bZuzm8s1ceuBUnMUAeoAHHw,3,4,2,0,0,0,2,0,8,1.1428571428571428,2,0.0,0,2,0,0,4,0,0,2,0,2,6,0
1406,31037,RdgmuKDafp9WprcWAoiQpEVTFO65q45I,SpATywNh6bZuzm8s1ceuBUnMUAeoAHHw,19,67,4,16,3,1,8,0,99,14.142857142857142,3,0.0,12,4,15,3,55,1,1,8,0,34,65,0
1407,31056,oqq9xRnlYeqOhAsbS4FyM4hs04sEJX6q,5X6FeZozNMgE2VRi3MJYjkkFK8SETtu2,4,6,3,0,0,0,2,0,11,1.5714285714285714,2,0.0,0,3,0,0,6,0,0,2,0,3,8,1
1408,31103,ryJmWExgm9yTclw7BCk3i7dcrSS7nazZ,bWdj2GDclj5ofokWjzoa5jAwMkxCykd6,1,0,0,0,0,0,1,0,1,0.14285714285714285,1,0.0,0,0,0,0,0,0,0,1,0,0,1,1
1409,31114,NGCjg1L5IFyOkl1pLM5r5gRwzJYb60Ux,RXDvfPUBYFlVdlueBFbLW0mhhAyGEqpt,10,14,1,0,1,0,6,0,22,3.142857142857143,1,0.0,0,1,0,1,14,0,0,6,0,2,20,0
1410,31116,zvONfuJex2FW0S3q02qmyYC9aBQXin0x,SpATywNh6bZuzm8s1ceuBUnMUAeoAHHw,2,0,0,0,0,0,2,0,2,0.2857142857142857,1,0.0,0,0,0,0,0,0,0,2,0,0,2,1
1411,31134,VbzTq4oG2Bxw9gO7S4JkRgwsnSWStKWu,SpATywNh6bZuzm8s1ceuBUnMUAeoAHHw,15,24,5,12,5,0,2,0,48,6.857142857142857,5,0.0,5,5,12,5,19,0,0,2,0,27,21,0
1412,31148,qHG1oWpzWvpmEhIIZP6X7w56WP8YkNuv,SpATywNh6bZuzm8s1ceuBUnMUAeoAHHw,1,0,0,0,0,0,2,0,2,0.2857142857142857,2,0.0,0,0,0,0,0,0,0,2,0,0,2,1
1413,31152,AdsXlEjQFIksauSrVM6XkycFKpsPMY96,G8EPVSXsOYB5YQWZGiz1aVq5Pgr2GrQu,1,0,0,0,0,0,1,0,1,0.14285714285714285,1,0.0,0,0,0,0,0,0,0,1,0,0,1,0
1414,31153,rIlg2veK76CYPAY7z09GokFHQqwC8sW7,SpATywNh6bZuzm8s1ceuBUnMUAeoAHHw,27,35,3,12,2,0,5,0,57,8.142857142857142,5,0.0,8,3,12,2,27,0,0,5,0,25,32,0
1415,31167,4bLrsVDvLnrTqHqeIpcqQPyvl02eai7n,A3fsA9Zfv1X2fVEQhTw51lKENdNrEqT3,43,17,15,88,10,0,7,0,137,19.571428571428573,1,0.0,2,15,75,10,15,0,13,7,0,102,35,1
1416,31186,71r0cSGOl797B6z3Ozx79KsmcnthtUKF,RXDvfPUBYFlVdlueBFbLW0mhhAyGEqpt,45,84,16,46,12,38,8,0,204,29.142857142857142,4,0.0,22,16,44,12,62,38,2,8,0,94,110,0
1417,31190,kXddmLayC1d9WaJe3TKDiaTRDePETcmW,5X6FeZozNMgE2VRi3MJYjkkFK8SETtu2,1,0,0,0,0,0,1,0,1,0.14285714285714285,1,0.0,0,0,0,0,0,0,0,1,0,0,1,1
1418,31194,tmChInaMXXu9irUncZR3i9YkdWc4vJk2,bWdj2GDclj5ofokWjzoa5jAwMkxCykd6,13,6,4,0,4,1,6,1,22,3.142857142857143,1,0.0,0,4,0,4,6,1,0,6,1,8,14,1
1419,31202,LmENAtavcDqxVrPN7j8xNGTLxeQMLi2E,SpATywNh6bZuzm8s1ceuBUnMUAeoAHHw,57,73,50,56,29,30,13,0,251,35.857142857142854,4,0.0,12,50,51,29,61,30,5,13,0,142,109,0
1420,31204,YOx6Tvp6HBSp6Lo310sbWxV28yIh3XN8,G8EPVSXsOYB5YQWZGiz1aVq5Pgr2GrQu,40,37,25,0,17,1,13,0,93,13.285714285714286,4,0.0,4,25,0,17,33,1,0,13,0,46,47,0
1421,31205,JzHC5tjVySaXz4V3Y0e4piHyrkmeSqU5,SpATywNh6bZuzm8s1ceuBUnMUAeoAHHw,31,26,24,0,19,1,4,0,74,10.571428571428571,2,0.0,0,24,0,19,26,1,0,4,0,43,31,0
1422,31206,0BcL7ZtEYe3RI9nGI6Aco1FB9QlygugP,G8EPVSXsOYB5YQWZGiz1aVq5Pgr2GrQu,11,6,4,8,1,0,10,3,32,4.571428571428571,2,0.0,0,4,7,1,6,0,1,10,3,12,20,1
1423,31212,il1jb11meB8GElsqKZc5yFOH5MUNs2Pa,G8EPVSXsOYB5YQWZGiz1aVq5Pgr2GrQu,34,21,0,80,0,1,18,1,121,17.285714285714285,2,0.0,2,0,70,0,19,1,10,18,1,72,49,0
1424,31220,s6iksgptFmyh2vfiarKdJkiKnp6RLi3f,SpATywNh6bZuzm8s1ceuBUnMUAeoAHHw,10,11,6,0,2,27,9,0,55,7.857142857142857,4,0.0,1,6,0,2,10,27,0,9,0,9,46,0
1425,31235,RgbUdG1GQBwET95sOwD6asbZ70PPcqWM,SpATywNh6bZuzm8s1ceuBUnMUAeoAHHw,47,73,34,27,27,0,4,0,165,23.571428571428573,2,0.0,34,34,21,27,39,0,6,4,0,116,49,1
1426,31242,Qn3OccgDXQpcut9yLA9jXfau6FPbS72n,SpATywNh6bZuzm8s1ceuBUnMUAeoAHHw,20,29,0,11,0,11,12,0,63,9.0,5,0.0,4,0,11,0,25,11,0,12,0,15,48,0
1427,31254,m8tZWvMesr1zQS0esJJogsiMlXHxe2Cd,SpATywNh6bZuzm8s1ceuBUnMUAeoAHHw,1,1,0,0,0,0,0,0,1,0.14285714285714285,1,0.0,0,0,0,0,1,0,0,0,0,0,1,1
1428,31273,llEGY9nmTOZhiXi105AGZUS4gAhSawAh,SpATywNh6bZuzm8s1ceuBUnMUAeoAHHw,34,39,18,31,11,0,9,0,108,15.428571428571429,5,0.0,6,18,26,11,33,0,5,9,0,61,47,0
1429,31276,XydvMA0BgL1Al10q3L0D2wz1Y6wVb2rC,SpATywNh6bZuzm8s1ceuBUnMUAeoAHHw,27,44,27,0,21,0,9,0,101,14.428571428571429,2,0.0,0,27,0,21,44,0,0,9,0,48,53,0
1430,31280,juUpKesViORjdDJidJ4RSlxH0qwbmcck,SpATywNh6bZuzm8s1ceuBUnMUAeoAHHw,27,39,20,0,15,0,3,0,77,11.0,6,0.0,0,20,0,15,39,0,0,3,0,35,42,0
1431,31285,U04y5vFf0AfyJVGIOJHlryTyRQEOm5pT,A3fsA9Zfv1X2fVEQhTw51lKENdNrEqT3,5,2,1,0,1,0,2,0,6,0.8571428571428571,1,0.0,0,1,0,1,2,0,0,2,0,2,4,1
1432,31292,ikF95Qfsm5YUIhe2VDD6pkwaNOjQrQVG,5X6FeZozNMgE2VRi3MJYjkkFK8SETtu2,5,2,1,0,1,0,2,0,6,0.8571428571428571,1,0.0,0,1,0,1,2,0,0,2,0,2,4,1
1433,31313,vAwmKvW9O3gDJNDrzxbIT5kjf2troQFn,SpATywNh6bZuzm8s1ceuBUnMUAeoAHHw,12,7,6,0,4,0,1,0,18,2.5714285714285716,1,0.0,0,6,0,4,7,0,0,1,0,10,8,1
1434,31316,sl67PTvziUv3kTFj6qEnYHRaFoNTaM8y,SpATywNh6bZuzm8s1ceuBUnMUAeoAHHw,23,18,15,0,12,0,3,0,48,6.857142857142857,2,0.0,0,15,0,12,18,0,0,3,0,27,21,0
1435,31356,zIHhHIwIbH6mJbe3ZAvW2ovaPewaq0E0,SpATywNh6bZuzm8s1ceuBUnMUAeoAHHw,36,45,17,21,10,34,15,1,143,20.428571428571427,3,0.0,12,17,20,10,33,34,1,15,1,59,84,0
1436,31360,QVtQEOECDBxqQMPDJLsWNOlhwI5DCP74,SpATywNh6bZuzm8s1ceuBUnMUAeoAHHw,28,34,8,36,4,22,4,0,108,15.428571428571429,2,0.0,13,8,31,4,21,22,5,4,0,56,52,0
1437,31371,YkxwabMuriYpqC21021WUsYLLutSSx4O,SpATywNh6bZuzm8s1ceuBUnMUAeoAHHw,38,52,25,46,9,0,5,0,137,19.571428571428573,7,0.0,22,25,41,9,30,0,5,5,0,97,40,0
1438,31375,G0jh1TPX9Mh6rk1y3utHKZiSI9nuHlJZ,SpATywNh6bZuzm8s1ceuBUnMUAeoAHHw,52,70,36,39,14,7,6,0,172,24.571428571428573,2,0.0,27,36,36,14,43,7,3,6,0,113,59,0
1439,31389,QAV02IL7ajntDdHVirqabwTRIN1Sa6iz,SpATywNh6bZuzm8s1ceuBUnMUAeoAHHw,32,43,1,30,0,0,13,2,89,12.714285714285714,5,0.0,6,1,29,0,37,0,1,13,2,36,53,0
1440,31392,p6Izm60d3R0uvZiSe15AoVnOEu77nAhg,SpATywNh6bZuzm8s1ceuBUnMUAeoAHHw,17,19,11,15,8,0,1,0,54,7.714285714285714,3,0.0,4,11,12,8,15,0,3,1,0,35,19,0
1441,31393,r34rPDX6ByafwVaTkz0clTKu9qISzj8Y,RXDvfPUBYFlVdlueBFbLW0mhhAyGEqpt,11,5,4,0,4,0,2,0,15,2.142857142857143,1,0.0,0,4,0,4,5,0,0,2,0,8,7,0
1442,31397,CGQBVll6e8XrZqlx2vLhIruhp3CAtM89,SpATywNh6bZuzm8s1ceuBUnMUAeoAHHw,23,36,18,15,9,2,4,0,84,12.0,2,0.0,10,18,14,9,26,2,1,4,0,51,33,0
1443,31399,VBP5PzVQEKJYFH0y5ffEek5WfP9EW7uc,SpATywNh6bZuzm8s1ceuBUnMUAeoAHHw,20,12,7,5,5,0,5,0,34,4.857142857142857,2,0.0,2,7,5,5,10,0,0,5,0,19,15,0
1444,31400,S9MHz2GfayML2H9BuRARNQ0WUO9mAJgZ,SpATywNh6bZuzm8s1ceuBUnMUAeoAHHw,31,35,20,13,9,4,12,1,94,13.428571428571429,6,0.0,5,20,10,9,30,4,3,12,1,44,50,0
1445,31413,SH0aDKwXzCQh4OYU9lg9pT5oeYUI6Uqk,bWdj2GDclj5ofokWjzoa5jAwMkxCykd6,1,0,0,0,0,0,1,0,1,0.14285714285714285,1,0.0,0,0,0,0,0,0,0,1,0,0,1,1
1446,31415,6pb2LEsVjBBvAGI7h0XcyCiR12k7UvwH,bWdj2GDclj5ofokWjzoa5jAwMkxCykd6,8,16,1,11,0,2,6,0,36,5.142857142857143,2,0.0,0,1,8,0,16,2,3,6,0,9,27,1
1447,31445,l7cIWSn2QdqLoOKMFO8yNQGKfk999nJh,SpATywNh6bZuzm8s1ceuBUnMUAeoAHHw,16,28,14,2,7,0,4,0,55,7.857142857142857,3,0.0,1,14,2,7,27,0,0,4,0,24,31,0
1448,31461,xiUWvWEihscVybXMyohV1BQnGMd6dznz,G8EPVSXsOYB5YQWZGiz1aVq5Pgr2GrQu,8,6,2,0,1,0,4,0,13,1.8571428571428572,1,0.0,0,2,0,1,6,0,0,4,0,3,10,1
1449,31485,TJFpdHl1wQVU7Cnvm5Co4MJsJuGM9yMG,G8EPVSXsOYB5YQWZGiz1aVq5Pgr2GrQu,12,8,5,30,0,0,3,0,46,6.571428571428571,3,0.0,0,5,29,0,8,0,1,3,0,34,12,0
1450,31500,EQgg3GYPXWNLa9U010kt5ZSvruPXJLGA,SpATywNh6bZuzm8s1ceuBUnMUAeoAHHw,38,44,26,39,15,3,9,0,136,19.428571428571427,5,0.0,7,26,32,15,37,3,7,9,0,80,56,0
1451,31503,YwFTXHSC31SX1LraRWOGlHPt5rdaD4Vy,SpATywNh6bZuzm8s1ceuBUnMUAeoAHHw,43,110,61,33,18,7,20,1,250,35.714285714285715,4,0.0,33,61,33,18,77,7,0,20,1,145,105,0
1452,31544,NqCDW2Wa7d0wWx7VYLXJDwB6ylSM8NEL,G8EPVSXsOYB5YQWZGiz1aVq5Pgr2GrQu,75,106,41,111,0,0,8,0,266,38.0,7,0.0,51,41,81,0,55,0,30,8,0,173,93,0
1453,31549,xI8Nr9tpm5UYMfkPTEK7ZnHqHm9s1zwr,5X6FeZozNMgE2VRi3MJYjkkFK8SETtu2,11,15,1,10,3,0,3,0,32,4.571428571428571,2,0.0,5,1,10,3,10,0,0,3,0,19,13,1
1454,31556,EUH6YdpZbHrgFPsGzhB2GBpcW28Zm8MI,SpATywNh6bZuzm8s1ceuBUnMUAeoAHHw,3,0,0,0,0,1,2,0,3,0.42857142857142855,1,0.0,0,0,0,0,0,1,0,2,0,0,3,1
1455,31560,jjkN8jWOYOEAYsDrxyK6cmAsmAkCK35N,SpATywNh6bZuzm8s1ceuBUnMUAeoAHHw,2,0,0,0,0,0,2,0,2,0.2857142857142857,1,0.0,0,0,0,0,0,0,0,2,0,0,2,1
1456,31570,xiUWvWEihscVybXMyohV1BQnGMd6dznz,bWdj2GDclj5ofokWjzoa5jAwMkxCykd6,5,4,1,0,2,0,2,0,9,1.2857142857142858,1,0.0,2,1,0,2,2,0,0,2,0,5,4,1
1457,31626,u9ct741hHXVhfVaAyqKR4FkuKqd1yywt,5X6FeZozNMgE2VRi3MJYjkkFK8SETtu2,30,40,15,93,8,0,9,1,166,23.714285714285715,2,0.0,15,15,78,8,25,0,15,9,1,116,50,1
1458,31655,MDJK2KVw2sHLHwyALdBdwbko7CJt3B5W,SpATywNh6bZuzm8s1ceuBUnMUAeoAHHw,15,26,13,17,6,1,3,0,66,9.428571428571429,1,0.0,12,13,14,6,14,1,3,3,0,45,21,1
1459,31661,e1CSwKLgflGiW7QjzYRNEoHjbDEH3F2k,SpATywNh6bZuzm8s1ceuBUnMUAeoAHHw,4,3,1,0,0,0,2,0,6,0.8571428571428571,1,0.0,0,1,0,0,3,0,0,2,0,1,5,1
1460,31682,YTga640T6i241jGBhxN7pUtNHHrQTFGS,5X6FeZozNMgE2VRi3MJYjkkFK8SETtu2,1,0,0,0,0,0,2,0,2,0.2857142857142857,2,0.0,0,0,0,0,0,0,0,2,0,0,2,1
1461,31691,TUAvpbJIqPqAXiWUMr89vm0HdACTuiA8,SpATywNh6bZuzm8s1ceuBUnMUAeoAHHw,25,39,4,23,3,0,7,0,76,10.857142857142858,3,0.0,4,4,23,3,35,0,0,7,0,34,42,0
1462,31699,Qy8CH3HeVFKSAKB7lN9KLpldaNyLNVBG,SpATywNh6bZuzm8s1ceuBUnMUAeoAHHw,33,69,25,25,9,18,16,4,166,23.714285714285715,2,0.0,38,25,19,9,31,18,6,16,4,91,75,0
1463,31728,mpNBMReKZvwryUvgjwY0cwVFK7aOune8,SpATywNh6bZuzm8s1ceuBUnMUAeoAHHw,35,37,23,24,11,3,14,0,112,16.0,5,0.0,4,23,22,11,33,3,2,14,0,60,52,0
1464,31739,xM8lVcqU5uqtxPXKRkobTl3b50GvL7Y6,G8EPVSXsOYB5YQWZGiz1aVq5Pgr2GrQu,4,1,1,0,0,0,3,0,5,0.7142857142857143,1,0.0,0,1,0,0,1,0,0,3,0,1,4,1
1465,31752,wPzdadJQCMqeSkdOMEDoRKUnWYSrFakI,SpATywNh6bZuzm8s1ceuBUnMUAeoAHHw,6,3,1,0,1,0,2,0,7,1.0,1,0.0,0,1,0,1,3,0,0,2,0,2,5,1
1466,31783,vIRjdLIHX9c1cFPQvvVL2i5iSd9iyYFO,bWdj2GDclj5ofokWjzoa5jAwMkxCykd6,5,3,0,0,0,1,2,0,6,0.8571428571428571,1,0.0,0,0,0,0,3,1,0,2,0,0,6,0
1467,31795,7hgrCmgcIS5jUcjMit9fbVMwjtk3kZoQ,A3fsA9Zfv1X2fVEQhTw51lKENdNrEqT3,148,128,63,309,26,83,64,3,676,96.57142857142857,4,0.0,9,63,244,26,119,83,65,64,3,342,334,0
1468,31804,lHdOeTUXYVL6iAgJVxxf5RxusHAIMUqu,SpATywNh6bZuzm8s1ceuBUnMUAeoAHHw,34,33,21,27,11,0,11,0,103,14.714285714285714,3,0.0,7,21,27,11,26,0,0,11,0,66,37,0
1469,31806,Oy358ZwdDb0AucMXZWcENmoGqtYaKoro,5X6FeZozNMgE2VRi3MJYjkkFK8SETtu2,8,11,3,0,3,0,3,0,20,2.857142857142857,2,0.0,5,3,0,3,6,0,0,3,0,11,9,1
1470,31818,7xwH0IGxUu9oyiAWk7HpSQpakcHGIuLy,SpATywNh6bZuzm8s1ceuBUnMUAeoAHHw,6,12,2,0,2,0,4,0,20,2.857142857142857,2,0.0,0,2,0,2,12,0,0,4,0,4,16,0
1471,31834,8nijJeJQ3xDzhCTAr7Z0RTVPHqfdjajs,SpATywNh6bZuzm8s1ceuBUnMUAeoAHHw,18,12,10,5,7,0,8,1,43,6.142857142857143,1,0.0,0,10,5,7,12,0,0,8,1,22,21,0
1472,31842,NdwHkfPAGY642SdmHZmzVw6m0frBuabE,A3fsA9Zfv1X2fVEQhTw51lKENdNrEqT3,1,0,0,0,0,0,1,0,1,0.14285714285714285,1,0.0,0,0,0,0,0,0,0,1,0,0,1,1
1473,31850,FHnafb4WtG7KIA4g5wSxwyrxJnQm1rLA,SpATywNh6bZuzm8s1ceuBUnMUAeoAHHw,13,28,6,0,2,0,7,1,44,6.285714285714286,3,0.0,0,6,0,2,28,0,0,7,1,8,36,0
1474,31853,KaKtAqB6wZUiYOmsdmlOHr8tGIxhLHqA,SpATywNh6bZuzm8s1ceuBUnMUAeoAHHw,18,27,10,16,5,0,11,0,69,9.857142857142858,1,0.0,9,10,12,5,18,0,4,11,0,36,33,0
1475,31861,yqRjX5x5mZ97nU5DkAkyboMSXTOKxqGq,A3fsA9Zfv1X2fVEQhTw51lKENdNrEqT3,2,0,0,0,0,0,3,0,3,0.42857142857142855,2,0.0,0,0,0,0,0,0,0,3,0,0,3,1
1476,31878,VXwRO03Gu4QrNRkeAj0lYc8T94Ap4aw5,SpATywNh6bZuzm8s1ceuBUnMUAeoAHHw,10,12,1,0,1,0,1,0,15,2.142857142857143,1,0.0,0,1,0,1,12,0,0,1,0,2,13,0
1477,31890,sk0kQOUwAh1v0YADh5vJvida6bS0Nrut,SpATywNh6bZuzm8s1ceuBUnMUAeoAHHw,22,31,3,39,0,7,9,0,89,12.714285714285714,3,0.0,14,3,36,0,17,7,3,9,0,53,36,1
1478,31938,RhP34FulOqviNgYNHriUPZSAmxJIhLoG,SpATywNh6bZuzm8s1ceuBUnMUAeoAHHw,4,3,1,0,0,0,2,0,6,0.8571428571428571,1,0.0,0,1,0,0,3,0,0,2,0,1,5,1
1479,31941,FICzrXMfesudq4nhzQP6bu1HcoWb8Dvz,RXDvfPUBYFlVdlueBFbLW0mhhAyGEqpt,6,2,2,0,1,0,2,0,7,1.0,1,0.0,0,2,0,1,2,0,0,2,0,3,4,1
1480,31954,uF7MMiNuAhfDpnPmpDdXphXG8nc4K2eb,SpATywNh6bZuzm8s1ceuBUnMUAeoAHHw,35,29,15,39,10,4,6,1,104,14.857142857142858,2,0.0,11,15,34,10,18,4,5,6,1,70,34,0
1481,31989,UcALsB3dLy3PVgkCMPXFbGXL5qreVuCZ,bWdj2GDclj5ofokWjzoa5jAwMkxCykd6,4,0,0,0,0,1,3,1,5,0.7142857142857143,1,0.0,0,0,0,0,0,1,0,3,1,0,5,1
1482,32014,t8eDuPU4MsZrMH2MoE1n7JeYLVBJZOGD,SpATywNh6bZuzm8s1ceuBUnMUAeoAHHw,21,33,12,20,1,2,9,1,78,11.142857142857142,2,0.0,14,12,18,1,19,2,2,9,1,45,33,0
1483,32036,0cTpxJTmQX3vdhwTGFk6XNSGmyhZVjmQ,A3fsA9Zfv1X2fVEQhTw51lKENdNrEqT3,9,4,3,0,3,0,6,0,16,2.2857142857142856,2,0.0,0,3,0,3,4,0,0,6,0,6,10,1
1484,32050,Riab3VyglmNWp0Owd5qXDcD82NpeagyQ,A3fsA9Zfv1X2fVEQhTw51lKENdNrEqT3,3,0,0,0,0,0,4,0,4,0.5714285714285714,1,0.0,0,0,0,0,0,0,0,4,0,0,4,0
1485,32052,2H4u8GVrslTygmZOsXRsjmcwUzRVI1ow,SpATywNh6bZuzm8s1ceuBUnMUAeoAHHw,6,14,10,0,0,0,5,0,29,4.142857142857143,4,0.0,0,10,0,0,14,0,0,5,0,10,19,0
1486,32077,c5VQ7usVz15dB8BPhVLpOqLw5w7gBiZC,SpATywNh6bZuzm8s1ceuBUnMUAeoAHHw,2,0,0,0,0,0,2,0,2,0.2857142857142857,1,0.0,0,0,0,0,0,0,0,2,0,0,2,1
1487,32098,NoD6YMXskGBRHNBn1mSKWYblJxZC5tcQ,A3fsA9Zfv1X2fVEQhTw51lKENdNrEqT3,85,125,58,24,42,3,23,1,276,39.42857142857143,5,0.0,1,58,20,42,124,3,4,23,1,121,155,0
1488,32122,ZvU0YqNTtgKWTlVIbqvnVys23p5WRiDJ,SpATywNh6bZuzm8s1ceuBUnMUAeoAHHw,10,10,7,0,3,13,0,0,33,4.714285714285714,2,0.0,0,7,0,3,10,13,0,0,0,10,23,0
1489,32131,zXFkIw8DuFccBrwnvphRo3Cgz2Rm6ssF,SpATywNh6bZuzm8s1ceuBUnMUAeoAHHw,8,3,2,0,1,1,6,0,13,1.8571428571428572,1,0.0,0,2,0,1,3,1,0,6,0,3,10,1
1490,32157,bvPCU5RqjygEgnyzflwAQn5yVX8FneOX,bWdj2GDclj5ofokWjzoa5jAwMkxCykd6,4,2,1,0,0,0,2,0,5,0.7142857142857143,1,0.0,0,1,0,0,2,0,0,2,0,1,4,1
1491,32168,RHl3DsvAX7TisJ7qBptmgrrtDAQvH7mr,SpATywNh6bZuzm8s1ceuBUnMUAeoAHHw,15,16,7,22,0,0,4,0,49,7.0,3,0.0,6,7,21,0,10,0,1,4,0,34,15,0
1492,32185,xVQ88VrIuIA75ygDlevnROobNkwcFnsc,5X6FeZozNMgE2VRi3MJYjkkFK8SETtu2,6,5,2,0,1,0,3,0,11,1.5714285714285714,3,0.0,0,2,0,1,5,0,0,3,0,3,8,1
1493,32207,a1hltiyDilurEIFnwffjQJuCpkjLjysQ,A3fsA9Zfv1X2fVEQhTw51lKENdNrEqT3,1,0,0,0,0,0,1,0,1,0.14285714285714285,1,0.0,0,0,0,0,0,0,0,1,0,0,1,1
1494,32208,bNZH4hUHavni696ZcBLvxZCrBSALUDxX,SpATywNh6bZuzm8s1ceuBUnMUAeoAHHw,15,15,1,12,1,2,4,0,35,5.0,4,0.0,2,1,11,1,13,2,1,4,0,15,20,0
1495,32211,EjR7iUwsiJVzqJrC7t3D1JWVRCEYToml,SpATywNh6bZuzm8s1ceuBUnMUAeoAHHw,7,18,0,0,0,4,2,0,24,3.4285714285714284,1,0.0,10,0,0,0,8,4,0,2,0,10,14,0
1496,32224,F6Z891neSaKlQQ7AswDi5tVrGxLhStNq,SpATywNh6bZuzm8s1ceuBUnMUAeoAHHw,8,8,1,0,1,0,4,0,14,2.0,2,0.0,0,1,0,1,8,0,0,4,0,2,12,1
1497,32226,4TtGjmtd4ISORDD5okRgx7kXAcGUW8IN,SpATywNh6bZuzm8s1ceuBUnMUAeoAHHw,18,26,15,13,7,0,18,0,79,11.285714285714286,6,0.0,2,15,10,7,24,0,3,18,0,34,45,0
1498,32234,jfy4hnEgaFTKN19h4DEcVSUHQ69g3McY,SpATywNh6bZuzm8s1ceuBUnMUAeoAHHw,26,22,16,0,12,0,8,0,58,8.285714285714286,1,0.0,0,16,0,12,22,0,0,8,0,28,30,1
1499,32244,jN0wpnfaU5DsLxvEqII5WFiC356NJUbF,SpATywNh6bZuzm8s1ceuBUnMUAeoAHHw,17,22,11,9,1,0,12,1,56,8.0,2,0.0,4,11,8,1,18,0,1,12,1,24,32,1
1500,32256,pNgLScEwGgq81vg0a0cEXKNs5eG2UXph,SpATywNh6bZuzm8s1ceuBUnMUAeoAHHw,16,19,9,14,4,0,1,0,47,6.714285714285714,1,0.0,9,9,13,4,10,0,1,1,0,35,12,1
1501,32263,kAQFM0dEgOQIxOG9jTMe5puRtNxZZWMN,bWdj2GDclj5ofokWjzoa5jAwMkxCykd6,37,22,0,92,0,0,3,0,117,16.714285714285715,3,0.0,6,0,77,0,16,0,15,3,0,83,34,0
1502,32264,JJuYhhMtwjDb5sLEitOV6r0dnSA7ABFH,bWdj2GDclj5ofokWjzoa5jAwMkxCykd6,1,0,0,0,0,0,1,0,1,0.14285714285714285,1,0.0,0,0,0,0,0,0,0,1,0,0,1,1
1503,32269,kCqsvQZpasUHfVJzYbijAKww9O0shrRg,RXDvfPUBYFlVdlueBFbLW0mhhAyGEqpt,24,30,3,18,3,0,12,0,66,9.428571428571429,5,0.0,0,3,16,3,30,0,2,12,0,22,44,0
1504,32279,coj5NqErnlD9ozminSGxVugmS0slNqs1,A3fsA9Zfv1X2fVEQhTw51lKENdNrEqT3,2,0,0,0,0,0,2,0,2,0.2857142857142857,1,0.0,0,0,0,0,0,0,0,2,0,0,2,1
1505,32284,wkkLqkPlDLOrNrbR4UCtQIDxtXcGov1B,SpATywNh6bZuzm8s1ceuBUnMUAeoAHHw,13,15,0,14,0,0,2,0,31,4.428571428571429,2,0.0,3,0,13,0,12,0,1,2,0,16,15,1
1506,32288,8rXJHeqrLpho5nIQgbDcpBTvBrVnGged,SpATywNh6bZuzm8s1ceuBUnMUAeoAHHw,14,19,1,11,0,1,10,0,42,6.0,3,0.0,5,1,9,0,14,1,2,10,0,15,27,0
1507,32309,MZpeXlPtlAGSfwuC5xwB1U0DIOZvGtVZ,SpATywNh6bZuzm8s1ceuBUnMUAeoAHHw,19,46,3,19,1,8,10,3,90,12.857142857142858,3,0.0,14,3,16,1,32,8,3,10,3,34,56,0
1508,32314,SSlieJULaqRb1C7jSzOwyPvbJnH3adQv,SpATywNh6bZuzm8s1ceuBUnMUAeoAHHw,5,2,1,0,1,0,2,0,6,0.8571428571428571,1,0.0,0,1,0,1,2,0,0,2,0,2,4,0
1509,32319,PZyZDM2uyBRGPZg3kQscavWjpR2bFYiU,SpATywNh6bZuzm8s1ceuBUnMUAeoAHHw,5,4,2,0,0,0,4,0,10,1.4285714285714286,2,0.0,0,2,0,0,4,0,0,4,0,2,8,0
1510,32346,rrZSZFoEgH3bOKdkZ0UyNzOq7Pdyx5G0,SpATywNh6bZuzm8s1ceuBUnMUAeoAHHw,14,43,0,24,0,0,2,0,69,9.857142857142858,2,0.0,21,0,17,0,22,0,7,2,0,38,31,0
1511,32358,nOWwmMm8RUDfPfoqvXy3xmkIL6qZiu0a,7GRhBDsirIGkRZBtSMEzNTyDr2JQm4xx,3,2,1,0,0,0,1,0,4,0.5714285714285714,1,0.0,0,1,0,0,2,0,0,1,0,1,3,0
1512,32359,aLRP3ahB5SIcOn5vpM1VPEh9ib2QIioX,SpATywNh6bZuzm8s1ceuBUnMUAeoAHHw,29,40,20,12,15,0,2,0,89,12.714285714285714,1,0.0,2,20,11,15,38,0,1,2,0,48,41,0
1513,32370,GOdZPKxg9MdVj14btOWyItDawZqHjDVK,SpATywNh6bZuzm8s1ceuBUnMUAeoAHHw,1,0,0,0,0,0,1,0,1,0.14285714285714285,1,0.0,0,0,0,0,0,0,0,1,0,0,1,1
1514,32385,rIb3lxEaK77vmLDTqDgCNFDZAYjyvbtK,7GRhBDsirIGkRZBtSMEzNTyDr2JQm4xx,43,57,21,40,22,21,11,0,172,24.571428571428573,4,0.0,29,21,37,22,28,21,3,11,0,109,63,1
1515,32396,89fRk1YEdJUeQGPjVnsGQ0GQ8bLBbWd5,SpATywNh6bZuzm8s1ceuBUnMUAeoAHHw,1,0,0,0,0,0,2,0,2,0.2857142857142857,1,0.0,0,0,0,0,0,0,0,2,0,0,2,1
1516,32399,c1hCF7HTdRs4Y6rOtE1XyYf2lHzz2oi1,A3fsA9Zfv1X2fVEQhTw51lKENdNrEqT3,32,18,1,66,2,0,3,0,90,12.857142857142858,1,0.0,1,1,61,2,17,0,5,3,0,65,25,1
1517,32403,Y1JlPlROA4JTEL6KTk03lVA5AU6bTZzS,SpATywNh6bZuzm8s1ceuBUnMUAeoAHHw,57,67,33,67,19,1,11,0,198,28.285714285714285,5,0.0,12,33,58,19,55,1,9,11,0,122,76,0
1518,32409,9iGaqBGS5kkoXjLd87hUL2eIJMVUVKfU,G8EPVSXsOYB5YQWZGiz1aVq5Pgr2GrQu,20,22,9,36,0,0,10,0,77,11.0,3,0.0,0,9,36,0,22,0,0,10,0,45,32,0
1519,32421,FW47VC0lzmys2S4k8Ky52JrXCSFDeyeP,bWdj2GDclj5ofokWjzoa5jAwMkxCykd6,20,18,8,26,6,1,7,1,67,9.571428571428571,1,0.0,8,8,22,6,10,1,4,7,1,44,23,1
1520,32426,gGSMkNgPdXpBQgdZzyjzifomyCxFSNyt,bWdj2GDclj5ofokWjzoa5jAwMkxCykd6,21,19,3,28,1,8,4,0,63,9.0,3,0.0,4,3,24,1,15,8,4,4,0,32,31,0
1521,32434,KDcZpMgh43fWN3yQZLS7ca0RsmMFrFC9,SpATywNh6bZuzm8s1ceuBUnMUAeoAHHw,15,62,2,0,2,0,9,0,75,10.714285714285714,6,0.0,3,2,0,2,59,0,0,9,0,7,68,0
1522,32436,QqE2Xjwy9gUzOvFdkDqAwAaNZLBZkxvd,SpATywNh6bZuzm8s1ceuBUnMUAeoAHHw,28,46,4,32,4,20,14,0,120,17.142857142857142,6,0.0,4,4,26,4,42,20,6,14,0,38,82,0
1523,32448,PFladZHBxKsed81P3VF9JVKRBqF9WnYc,SpATywNh6bZuzm8s1ceuBUnMUAeoAHHw,21,21,11,11,6,0,4,0,53,7.571428571428571,2,0.0,5,11,10,6,16,0,1,4,0,32,21,0
1524,32464,QAguKdvn52pCJKW91rO3BCY8l8ZCAdvQ,A3fsA9Zfv1X2fVEQhTw51lKENdNrEqT3,45,46,34,24,21,3,16,1,145,20.714285714285715,3,0.0,2,34,19,21,44,3,5,16,1,76,69,0
1525,32481,lQl2XdAeRVWLDaT8AEiVu5dRdtWn15nB,G8EPVSXsOYB5YQWZGiz1aVq5Pgr2GrQu,55,62,2,31,3,0,11,1,110,15.714285714285714,2,0.0,9,2,24,3,53,0,7,11,1,38,72,0
1526,32484,QqE2Xjwy9gUzOvFdkDqAwAaNZLBZkxvd,A3fsA9Zfv1X2fVEQhTw51lKENdNrEqT3,28,35,3,0,3,8,8,0,57,8.142857142857142,3,0.0,1,3,0,3,34,8,0,8,0,7,50,0
1527,32488,wctOEAfOfHjaIn2ukTVBg3NDDfP2Pt1c,5X6FeZozNMgE2VRi3MJYjkkFK8SETtu2,4,5,2,0,0,0,4,0,11,1.5714285714285714,2,0.0,0,2,0,0,5,0,0,4,0,2,9,1
1528,32492,5NsbP59FWlyl4NFONUzt3drLLr5EFRFj,G8EPVSXsOYB5YQWZGiz1aVq5Pgr2GrQu,4,3,2,0,0,0,1,0,6,0.8571428571428571,1,0.0,0,2,0,0,3,0,0,1,0,2,4,1
1529,32501,mOJqDc22cg6Tc62XCr7iPStv8YxEXhpp,SpATywNh6bZuzm8s1ceuBUnMUAeoAHHw,16,34,17,2,5,0,8,0,66,9.428571428571429,3,0.0,3,17,2,5,31,0,0,8,0,27,39,0
1530,32540,HSjU01iBnfvM2G4XxxIf0I2L8a5YKkxl,G8EPVSXsOYB5YQWZGiz1aVq5Pgr2GrQu,22,4,2,102,1,0,6,0,115,16.428571428571427,1,0.0,0,2,92,1,4,0,10,6,0,95,20,1
1531,32557,Wjr4gEVxD7mA3Z7r2t3nCQSUbpX54OOZ,SpATywNh6bZuzm8s1ceuBUnMUAeoAHHw,4,2,0,0,0,0,2,0,4,0.5714285714285714,1,0.0,0,0,0,0,2,0,0,2,0,0,4,1
1532,32577,fNAZ3rWuqq8OkAKKKUzZOQQ9DpAle4lu,SpATywNh6bZuzm8s1ceuBUnMUAeoAHHw,35,52,28,23,12,0,9,0,124,17.714285714285715,4,0.0,13,28,22,12,39,0,1,9,0,75,49,0
1533,32591,RIjNzTzWwuMpVu0vcsF9N8cORAAtLFQn,5X6FeZozNMgE2VRi3MJYjkkFK8SETtu2,3,10,0,0,0,0,2,0,12,1.7142857142857142,2,0.0,1,0,0,0,9,0,0,2,0,1,11,1
1534,32602,Ly65lkxGurCaK23EMf3qmWsOuD8e8vVr,5X6FeZozNMgE2VRi3MJYjkkFK8SETtu2,31,29,9,55,11,24,4,1,133,19.0,2,0.0,16,9,52,11,13,24,3,4,1,88,45,0
1535,32605,qsZvEBpmKtR7CWAJRnu6MxEuwHlYua64,A3fsA9Zfv1X2fVEQhTw51lKENdNrEqT3,11,6,5,0,5,0,2,0,18,2.5714285714285716,1,0.0,0,5,0,5,6,0,0,2,0,10,8,1
1536,32616,MVcepYvxjrdyzudBtT6xf978LVM5p04U,SpATywNh6bZuzm8s1ceuBUnMUAeoAHHw,31,23,13,16,9,8,10,1,80,11.428571428571429,2,0.0,2,13,13,9,21,8,3,10,1,37,43,0
1537,32642,dCHgtAVwX12C1h73zUIzcSalawnmf1Ly,5X6FeZozNMgE2VRi3MJYjkkFK8SETtu2,5,2,1,0,1,0,2,0,6,0.8571428571428571,1,0.0,0,1,0,1,2,0,0,2,0,2,4,0
1538,32647,vBbIZDmFTh3FCbK0DEiE7jyE0eCpDvg4,RXDvfPUBYFlVdlueBFbLW0mhhAyGEqpt,46,33,18,87,13,0,4,0,155,22.142857142857142,1,0.0,9,18,83,13,24,0,4,4,0,123,32,0
1539,32682,81lJT3F2fPa9QkCp8pe9hQda3s6sqwFw,SpATywNh6bZuzm8s1ceuBUnMUAeoAHHw,5,2,1,0,1,0,2,0,6,0.8571428571428571,1,0.0,0,1,0,1,2,0,0,2,0,2,4,1
1540,32685,MaXB6YBpSNUvXtEuCcY3Jwa8jwvsWVE8,G8EPVSXsOYB5YQWZGiz1aVq5Pgr2GrQu,5,3,1,0,1,0,1,0,6,0.8571428571428571,1,0.0,0,1,0,1,3,0,0,1,0,2,4,0
1541,32694,bVveXRWwKdTb7eqX4rWDKBUhdf8PtEkw,SpATywNh6bZuzm8s1ceuBUnMUAeoAHHw,14,30,8,15,1,0,1,0,55,7.857142857142857,7,0.0,3,8,12,1,27,0,3,1,0,24,31,0
1542,32711,i5sxjfIaHjwYnZjZ10HPMUmgQCjmnGnv,SpATywNh6bZuzm8s1ceuBUnMUAeoAHHw,17,55,20,8,10,21,16,3,133,19.0,2,0.0,23,20,8,10,32,21,0,16,3,61,72,0
1543,32725,NHPpKvbnrSpxM8e1DORBWJbRCpmrxZw8,G8EPVSXsOYB5YQWZGiz1aVq5Pgr2GrQu,5,5,2,0,1,1,1,0,10,1.4285714285714286,1,0.0,2,2,0,1,3,1,0,1,0,5,5,0
1544,32738,AaS8GsfaaiK26oA6b0QdGhs8opVCkjvV,5X6FeZozNMgE2VRi3MJYjkkFK8SETtu2,2,0,0,0,0,0,2,0,2,0.2857142857142857,1,0.0,0,0,0,0,0,0,0,2,0,0,2,1
1545,32790,mPCmohVETKOBEAkMNdnfTJW7kVWg1ArQ,5X6FeZozNMgE2VRi3MJYjkkFK8SETtu2,1,0,0,0,0,0,1,0,1,0.14285714285714285,1,0.0,0,0,0,0,0,0,0,1,0,0,1,1
1546,32844,b1eRrhapWSjtM2Ih9Xn0eBEZAyjqmlvI,SpATywNh6bZuzm8s1ceuBUnMUAeoAHHw,30,41,26,22,9,5,15,2,120,17.142857142857142,5,0.0,4,26,19,9,37,5,3,15,2,58,62,0
1547,32863,sKtqWeRv0wdA3L7xK3bpYs1OPqE06BS0,SpATywNh6bZuzm8s1ceuBUnMUAeoAHHw,4,2,1,0,1,0,1,0,5,0.7142857142857143,1,0.0,0,1,0,1,2,0,0,1,0,2,3,1
1548,32874,67ZqfHh3zcLqo5qUacGllEiszIkOne95,G8EPVSXsOYB5YQWZGiz1aVq5Pgr2GrQu,36,85,58,0,51,0,26,0,220,31.428571428571427,6,0.0,0,58,0,51,85,0,0,26,0,109,111,0
1549,32880,4Zj3rSr4SVLur34IbcdhBk6xi5qGX4FT,A3fsA9Zfv1X2fVEQhTw51lKENdNrEqT3,2,0,0,0,0,0,2,0,2,0.2857142857142857,1,0.0,0,0,0,0,0,0,0,2,0,0,2,1
1550,32883,l99Zcol89MEEF7ym4ZK8FY1ESaelZnlP,SpATywNh6bZuzm8s1ceuBUnMUAeoAHHw,26,26,16,10,9,10,7,1,79,11.285714285714286,2,0.0,5,16,9,9,21,10,1,7,1,39,40,1
1551,32891,yInJev2CVKf0hE352QQBnfHh6HRrGN4N,SpATywNh6bZuzm8s1ceuBUnMUAeoAHHw,7,4,3,0,2,0,1,0,10,1.4285714285714286,1,0.0,0,3,0,2,4,0,0,1,0,5,5,1
1552,32901,4JyZWYWxxqGCPr9dTz7bgpLcCXWs003A,SpATywNh6bZuzm8s1ceuBUnMUAeoAHHw,54,178,78,70,25,7,44,0,402,57.42857142857143,9,0.0,67,78,63,25,111,7,7,44,0,233,169,0
1553,32910,C5UZjhK8Hk16c49ZEIDZjaPkOGF8vpVr,G8EPVSXsOYB5YQWZGiz1aVq5Pgr2GrQu,14,28,14,0,2,2,5,1,52,7.428571428571429,1,0.0,0,14,0,2,28,2,0,5,1,16,36,1
1554,32928,sCoQh17BXp4WNRE2P5HolZcCCCZZqqMT,SpATywNh6bZuzm8s1ceuBUnMUAeoAHHw,10,10,0,5,0,0,2,0,17,2.4285714285714284,4,0.0,2,0,5,0,8,0,0,2,0,7,10,1
1555,32938,zZwP4suQybM1gcslFDQ5UITiG9iZ789v,SpATywNh6bZuzm8s1ceuBUnMUAeoAHHw,6,10,6,0,0,0,4,0,20,2.857142857142857,3,0.0,0,6,0,0,10,0,0,4,0,6,14,0
1556,32944,QKx78QTSpSsgDUOeao6DG0scNkDycWWw,bWdj2GDclj5ofokWjzoa5jAwMkxCykd6,10,7,3,0,3,2,4,1,20,2.857142857142857,1,0.0,2,3,0,3,5,2,0,4,1,8,12,1
1557,32959,rwYtVwtpIXZswHnkH0HuiJPA0dz7YY0K,RXDvfPUBYFlVdlueBFbLW0mhhAyGEqpt,13,11,2,0,2,0,5,0,20,2.857142857142857,2,0.0,0,2,0,2,11,0,0,5,0,4,16,1
1558,32988,mZVWUPFbkuZINQtykHT2ZyZY5zMXgvJ7,SpATywNh6bZuzm8s1ceuBUnMUAeoAHHw,17,28,9,18,4,2,12,0,73,10.428571428571429,2,0.0,2,9,15,4,26,2,3,12,0,30,43,0
1559,33001,ZFpXjzvya7Y5x9HmUsgToer6v1L16WM2,SpATywNh6bZuzm8s1ceuBUnMUAeoAHHw,29,52,31,21,15,0,15,0,134,19.142857142857142,6,0.0,9,31,18,15,43,0,3,15,0,73,61,0
1560,33002,xeJGzWUjx44ZoqgxXXQMDl4oymPhxaNW,bWdj2GDclj5ofokWjzoa5jAwMkxCykd6,1,0,0,0,0,0,1,0,1,0.14285714285714285,1,0.0,0,0,0,0,0,0,0,1,0,0,1,1
1561,33017,GFBEJrga7DM4UEcrt340p3oRNaL97Gn4,SpATywNh6bZuzm8s1ceuBUnMUAeoAHHw,30,27,16,15,10,6,10,0,84,12.0,2,0.0,6,16,13,10,21,6,2,10,0,45,39,0
1562,33018,gi1cGXmBNmpbe6lA2hzKFh8EEd7gQMCM,SpATywNh6bZuzm8s1ceuBUnMUAeoAHHw,7,11,2,0,0,0,2,0,15,2.142857142857143,2,0.0,4,2,0,0,7,0,0,2,0,6,9,0
1563,33023,XzkMRCsMMuNT5Al9kV5PMqeThOnNDLN6,7GRhBDsirIGkRZBtSMEzNTyDr2JQm4xx,5,6,2,0,0,0,2,0,10,1.4285714285714286,1,0.0,0,2,0,0,6,0,0,2,0,2,8,1
1564,33032,pZUzbLssBaqgpMaS6P8QU9NPm4T9bYZn,A3fsA9Zfv1X2fVEQhTw51lKENdNrEqT3,22,27,20,0,12,0,9,0,68,9.714285714285714,3,0.0,1,20,0,12,26,0,0,9,0,33,35,1
1565,33049,gi1cGXmBNmpbe6lA2hzKFh8EEd7gQMCM,5X6FeZozNMgE2VRi3MJYjkkFK8SETtu2,1,0,0,0,0,0,1,0,1,0.14285714285714285,1,0.0,0,0,0,0,0,0,0,1,0,0,1,1
1566,33050,rALCIi3DuIdQyJaY6En5rKpCFJjvIHQe,SpATywNh6bZuzm8s1ceuBUnMUAeoAHHw,7,3,2,0,1,0,7,1,14,2.0,2,0.0,1,2,0,1,2,0,0,7,1,4,10,1
1567,33058,fNAZ3rWuqq8OkAKKKUzZOQQ9DpAle4lu,RXDvfPUBYFlVdlueBFbLW0mhhAyGEqpt,41,48,31,104,15,2,4,0,204,29.142857142857142,2,0.0,9,31,91,15,39,2,13,4,0,146,58,0
1568,33062,ZVmjT1rppq7ilCPRRtmAl1wo0gOugsCt,RXDvfPUBYFlVdlueBFbLW0mhhAyGEqpt,26,44,11,50,6,5,8,0,124,17.714285714285715,6,0.0,4,11,46,6,40,5,4,8,0,67,57,0
1569,33087,jaMKMvlU4KDCkm4HrM0MWVH43rDA8rY1,5X6FeZozNMgE2VRi3MJYjkkFK8SETtu2,5,2,1,0,1,0,3,0,7,1.0,2,0.0,0,1,0,1,2,0,0,3,0,2,5,1
1570,33088,kpIACQKuTNWV6fjF4g1htB9bVtHJR1X6,A3fsA9Zfv1X2fVEQhTw51lKENdNrEqT3,7,9,2,0,1,0,3,0,15,2.142857142857143,2,0.0,0,2,0,1,9,0,0,3,0,3,12,0
1571,33093,Yf3ElbSSbwyhjAhOrCYCRfmhcQeNbhGe,SpATywNh6bZuzm8s1ceuBUnMUAeoAHHw,8,6,4,0,1,1,3,0,15,2.142857142857143,1,0.0,0,4,0,1,6,1,0,3,0,5,10,1
1572,33097,RJ1FVW8gXQIpK321uzh2Sh69ojlsqnvg,bWdj2GDclj5ofokWjzoa5jAwMkxCykd6,14,27,12,14,5,0,7,0,65,9.285714285714286,2,0.0,7,12,11,5,20,0,3,7,0,35,30,0
1573,33113,PjZvizXDkcC0c394BYUQIpEWacrPH7EJ,SpATywNh6bZuzm8s1ceuBUnMUAeoAHHw,19,17,0,29,0,0,9,0,55,7.857142857142857,3,0.0,4,0,26,0,13,0,3,9,0,30,25,1
1574,33133,06aGzysIv9Mn9nTndk3LjWWIGMMHY5p5,A3fsA9Zfv1X2fVEQhTw51lKENdNrEqT3,2,0,0,0,0,0,2,0,2,0.2857142857142857,1,0.0,0,0,0,0,0,0,0,2,0,0,2,1
1575,33145,UUY3BPLR7A3Xa6FGsztMCn6xCbxtdCYu,SpATywNh6bZuzm8s1ceuBUnMUAeoAHHw,29,34,17,22,7,0,7,0,87,12.428571428571429,4,0.0,12,17,19,7,22,0,3,7,0,55,32,0
1576,33146,aFVLxK4Hau9wDglF79kWvvimpoa2MXNc,SpATywNh6bZuzm8s1ceuBUnMUAeoAHHw,22,23,16,13,7,0,6,0,65,9.285714285714286,3,0.0,2,16,12,7,21,0,1,6,0,37,28,1
1577,33156,NgffOurIf9EDLm5SB7efcduZd82QhoOU,RXDvfPUBYFlVdlueBFbLW0mhhAyGEqpt,12,24,6,6,8,1,3,0,48,6.857142857142857,3,0.0,12,6,6,8,12,1,0,3,0,32,16,0
1578,33167,vMr1CEZaNupiDJLnYazOeogaMOoVPtGu,SpATywNh6bZuzm8s1ceuBUnMUAeoAHHw,8,10,6,0,3,0,3,0,22,3.142857142857143,2,0.0,0,6,0,3,10,0,0,3,0,9,13,0
1579,33168,9JOIbfI4KnzV1NdU7sH8tM8NLWIOBzCF,5X6FeZozNMgE2VRi3MJYjkkFK8SETtu2,14,11,7,0,4,1,6,0,29,4.142857142857143,2,0.0,0,7,0,4,11,1,0,6,0,11,18,1
1580,33187,yiWok4eQ5hgdJ8eYi2O0qHhy67Y9EA3E,SpATywNh6bZuzm8s1ceuBUnMUAeoAHHw,33,38,18,35,12,0,4,0,107,15.285714285714286,3,0.0,5,18,29,12,33,0,6,4,0,64,43,0
1581,33199,r9mrNmOIUUDf7AorDYXKUl4G7R8wfHcf,SpATywNh6bZuzm8s1ceuBUnMUAeoAHHw,21,14,9,15,5,2,9,0,54,7.714285714285714,3,0.0,2,9,15,5,12,2,0,9,0,31,23,0
1582,33234,we9tWnySpl1G7k7FqyXPj8wmC2gUYK0W,A3fsA9Zfv1X2fVEQhTw51lKENdNrEqT3,40,123,20,95,1,5,13,0,257,36.714285714285715,4,0.0,3,20,74,1,120,5,21,13,0,98,159,0
1583,33256,we9tWnySpl1G7k7FqyXPj8wmC2gUYK0W,5X6FeZozNMgE2VRi3MJYjkkFK8SETtu2,21,38,2,14,4,1,6,0,65,9.285714285714286,5,0.0,7,2,13,4,31,1,1,6,0,26,39,0
1584,33271,tD36vn1aCu8pvS184dpJPyASEvtRWzdE,SpATywNh6bZuzm8s1ceuBUnMUAeoAHHw,25,19,10,35,7,0,3,0,74,10.571428571428571,2,0.0,5,10,31,7,14,0,4,3,0,53,21,0
1585,33280,1vY5OZ1u5dkB4jIpVDeMNw33uHVvYDm0,G8EPVSXsOYB5YQWZGiz1aVq5Pgr2GrQu,52,88,39,0,32,0,4,0,163,23.285714285714285,3,0.0,2,39,0,32,86,0,0,4,0,73,90,0
1586,33303,Xd1D2NT89CxigSKUZtesNm0ASQy2UOok,5X6FeZozNMgE2VRi3MJYjkkFK8SETtu2,4,2,1,0,1,0,1,0,5,0.7142857142857143,1,0.0,0,1,0,1,2,0,0,1,0,2,3,1
1587,33321,vIBcYbs1BLdmaaP30fcE2FS7kB7v7QRn,RXDvfPUBYFlVdlueBFbLW0mhhAyGEqpt,3,2,1,0,0,0,1,0,4,0.5714285714285714,1,0.0,0,1,0,0,2,0,0,1,0,1,3,1
1588,33325,jXgMhQKbkiBaFyvNHAIM6AePvnnTFQC0,SpATywNh6bZuzm8s1ceuBUnMUAeoAHHw,17,29,17,12,0,5,12,0,75,10.714285714285714,7,0.0,5,17,11,0,24,5,1,12,0,33,42,0
1589,33337,096xYyhB9kL7G6lT7J9rVrXyGNwUToLF,bWdj2GDclj5ofokWjzoa5jAwMkxCykd6,1,0,0,0,0,0,2,0,2,0.2857142857142857,1,0.0,0,0,0,0,0,0,0,2,0,0,2,0
1590,33338,d5hgUNbUFsJ3QWa3NXhPxhtqZKrkuHi4,SpATywNh6bZuzm8s1ceuBUnMUAeoAHHw,34,33,18,31,8,0,6,0,96,13.714285714285714,3,0.0,11,18,27,8,22,0,4,6,0,64,32,0
1591,33366,fYLWMGJsW3Aq1nrs0wiSji5Q7ysltFRD,SpATywNh6bZuzm8s1ceuBUnMUAeoAHHw,5,3,2,0,1,0,1,0,7,1.0,1,0.0,0,2,0,1,3,0,0,1,0,3,4,1
1592,33367,LnKkSZayo1wLV2Hw9QpVLPVlZlTuJ9NQ,SpATywNh6bZuzm8s1ceuBUnMUAeoAHHw,18,23,5,22,2,2,6,0,60,8.571428571428571,2,0.0,8,5,20,2,15,2,2,6,0,35,25,0
1593,33383,8iImyyS3GD4CMDnaLhe4nYGG4OYOw3ov,5X6FeZozNMgE2VRi3MJYjkkFK8SETtu2,2,0,0,0,0,0,2,0,2,0.2857142857142857,1,0.0,0,0,0,0,0,0,0,2,0,0,2,1
1594,33392,WczGVRZMmNzgMggUe3ZQ1bOs2IuTwUWO,RXDvfPUBYFlVdlueBFbLW0mhhAyGEqpt,66,99,3,145,9,18,20,6,300,42.857142857142854,6,0.0,28,3,134,9,71,18,11,20,6,174,126,0
1595,33400,R3LdCHGJ0oYuX8fUQhI8dRkzUs6gLWrE,SpATywNh6bZuzm8s1ceuBUnMUAeoAHHw,19,24,12,38,1,8,10,2,95,13.571428571428571,3,0.0,5,12,32,1,19,8,6,10,2,50,45,0
1596,33401,qV3ci4HSmOh0O2gqYUVjaVHqqz2r9u2d,G8EPVSXsOYB5YQWZGiz1aVq5Pgr2GrQu,30,34,3,62,2,2,16,1,120,17.142857142857142,2,0.0,0,3,51,2,34,2,11,16,1,56,64,1
1597,33407,9JeL7tgnIZOgdZSlSf2iznMdgXHHfyfp,SpATywNh6bZuzm8s1ceuBUnMUAeoAHHw,3,0,0,0,0,0,5,0,5,0.7142857142857143,1,0.0,0,0,0,0,0,0,0,5,0,0,5,1
1598,33416,viuKt4GgrX0rYL5EpHoxJbsiC9TblSuk,SpATywNh6bZuzm8s1ceuBUnMUAeoAHHw,21,27,15,0,8,38,10,0,98,14.0,4,0.0,6,15,0,8,21,38,0,10,0,29,69,0
1599,33418,DhR1dVNu38f3nLpjw93piUdYWwpJko8O,SpATywNh6bZuzm8s1ceuBUnMUAeoAHHw,44,46,23,21,16,0,3,0,109,15.571428571428571,2,0.0,6,23,21,16,40,0,0,3,0,66,43,0
1600,33425,TiIBZzk8mSsTxaXRp2od0vsYA3E53d4W,G8EPVSXsOYB5YQWZGiz1aVq5Pgr2GrQu,10,8,2,0,1,2,7,1,21,3.0,1,0.0,1,2,0,1,7,2,0,7,1,4,17,0
1601,33426,SbSUciasvLhHVTorJDvZBPRhwTmOgntH,SpATywNh6bZuzm8s1ceuBUnMUAeoAHHw,52,85,21,89,13,1,15,0,224,32.0,6,0.0,36,21,80,13,49,1,9,15,0,150,74,0
1602,33428,YlMrjX7ibus8JFFbvjYaUFTOz92jaztw,SpATywNh6bZuzm8s1ceuBUnMUAeoAHHw,18,31,15,12,7,0,3,0,68,9.714285714285714,3,0.0,11,15,12,7,20,0,0,3,0,45,23,0
1603,33475,0KNVWAChIRBDwntcO5Dr5l3KgkUsRh3O,SpATywNh6bZuzm8s1ceuBUnMUAeoAHHw,4,3,0,0,0,0,1,0,4,0.5714285714285714,1,0.0,0,0,0,0,3,0,0,1,0,0,4,0
1604,33478,6elPfoQqoXapHUr4bMvtkwGvYr52KIX8,A3fsA9Zfv1X2fVEQhTw51lKENdNrEqT3,40,27,11,50,10,0,10,0,108,15.428571428571429,3,0.0,0,11,42,10,27,0,8,10,0,63,45,0
1605,33493,1vY5OZ1u5dkB4jIpVDeMNw33uHVvYDm0,SpATywNh6bZuzm8s1ceuBUnMUAeoAHHw,27,36,19,0,11,0,5,0,71,10.142857142857142,3,0.0,0,19,0,11,36,0,0,5,0,30,41,0
1606,33495,JPJY1WqUvz4liBz4XkK3wlVfpnOL0ou5,A3fsA9Zfv1X2fVEQhTw51lKENdNrEqT3,14,10,8,0,4,0,7,0,29,4.142857142857143,1,0.0,0,8,0,4,10,0,0,7,0,12,17,1
1607,33513,H2Rgqo3kRDsNdbNVEDl0788s9SSdLM8P,7GRhBDsirIGkRZBtSMEzNTyDr2JQm4xx,10,15,1,2,2,0,2,0,22,3.142857142857143,1,0.0,5,1,1,2,10,0,1,2,0,9,13,1
1608,33520,qmYTrueiQKfoQnGxjqfwlMlw7HOR9CKj,A3fsA9Zfv1X2fVEQhTw51lKENdNrEqT3,22,13,8,80,3,0,4,0,108,15.428571428571429,3,0.0,4,8,68,3,9,0,12,4,0,83,25,0
1609,33533,WO3YPzdDqV1ST6B0Mqs4I1kcRrnmBAmm,bWdj2GDclj5ofokWjzoa5jAwMkxCykd6,1,0,0,0,0,0,3,0,3,0.42857142857142855,1,0.0,0,0,0,0,0,0,0,3,0,0,3,0
1610,33548,096xYyhB9kL7G6lT7J9rVrXyGNwUToLF,SpATywNh6bZuzm8s1ceuBUnMUAeoAHHw,23,23,20,0,0,0,3,0,46,6.571428571428571,1,0.0,0,20,0,0,23,0,0,3,0,20,26,0
1611,33579,wFWVvTUKN4Nj5vWrbX5PVi6EvLKq8sqa,SpATywNh6bZuzm8s1ceuBUnMUAeoAHHw,22,19,10,17,5,0,7,4,62,8.857142857142858,3,0.0,5,10,14,5,14,0,3,7,4,34,28,0
1612,33601,B9KqNNxXBxHFUsJnQKQysblL3f8zF7sg,7GRhBDsirIGkRZBtSMEzNTyDr2JQm4xx,34,83,4,0,15,0,4,0,106,15.142857142857142,3,0.0,48,4,0,15,35,0,0,4,0,67,39,0
1613,33603,U4egSBuIz4Tp2aExbhUIhaem6H1lHi4I,5X6FeZozNMgE2VRi3MJYjkkFK8SETtu2,4,3,1,0,0,0,6,0,10,1.4285714285714286,4,0.0,0,1,0,0,3,0,0,6,0,1,9,1
1614,33606,ZnX7TVb7MRgZ03kXc2dvy6H2fx2hKiTB,G8EPVSXsOYB5YQWZGiz1aVq5Pgr2GrQu,6,6,0,0,1,0,3,0,10,1.4285714285714286,1,0.0,2,0,0,1,4,0,0,3,0,3,7,1
1615,33612,884KSEusRiMlLTSulMFf41A22MivDNwN,A3fsA9Zfv1X2fVEQhTw51lKENdNrEqT3,26,67,9,0,4,0,13,0,93,13.285714285714286,4,0.0,0,9,0,4,67,0,0,13,0,13,80,0
1616,33626,0nurC1CJC0crrXKGvfCOGeDuwbw5nhmi,SpATywNh6bZuzm8s1ceuBUnMUAeoAHHw,8,9,6,0,1,0,6,0,22,3.142857142857143,1,0.0,0,6,0,1,9,0,0,6,0,7,15,0
1617,33639,3bwizzI2zhkZarj0AirZFGuMorcba8W4,SpATywNh6bZuzm8s1ceuBUnMUAeoAHHw,35,43,25,24,12,10,14,0,128,18.285714285714285,6,0.0,10,25,18,12,33,10,6,14,0,65,63,1
1618,33643,InrAmtl2MgoSpFoohTtv1oXbh4bisxXW,bWdj2GDclj5ofokWjzoa5jAwMkxCykd6,33,33,6,126,1,1,10,0,177,25.285714285714285,3,0.0,5,6,107,1,28,1,19,10,0,119,58,0
1619,33658,TD22TgKgdIWZaUQs2l8DFuWLFK83eNHv,A3fsA9Zfv1X2fVEQhTw51lKENdNrEqT3,13,13,11,0,11,3,7,1,46,6.571428571428571,1,0.0,1,11,0,11,12,3,0,7,1,23,23,1
1620,33666,RCdcltNaQLfcoxT7YKTjQxAYUbCmzzKd,A3fsA9Zfv1X2fVEQhTw51lKENdNrEqT3,15,26,21,0,13,13,14,0,87,12.428571428571429,7,0.0,1,21,0,13,25,13,0,14,0,35,52,0
1621,33739,gdn2XK07FW9va0I0cqCJx123li1climD,3VkHkmOtom3jM2wCu94xgzzu1d6Dn7or,11,8,6,0,5,1,4,0,24,3.4285714285714284,2,0.0,0,6,0,5,8,1,0,4,0,11,13,1
1622,33775,B1A1Rk1i9RwjdQC3OufTERem5rR8AT54,3VkHkmOtom3jM2wCu94xgzzu1d6Dn7or,71,119,46,49,32,11,37,18,312,44.57142857142857,18,0.0,46,46,49,32,73,11,0,37,18,173,139,0
1623,33802,rgfuJRvILCyoZ3ACpGqTeELGaXbZOX9A,3VkHkmOtom3jM2wCu94xgzzu1d6Dn7or,97,200,77,97,67,5,67,1,514,73.42857142857143,16,0.0,70,77,97,67,130,5,0,67,1,311,203,0
1624,33805,3Xw7sSY5dpZPjwkazu6UTwQ4M7Pr8Xfi,3VkHkmOtom3jM2wCu94xgzzu1d6Dn7or,16,31,16,0,7,0,19,0,73,10.428571428571429,7,0.0,0,16,0,7,31,0,0,19,0,23,50,0
1625,33907,LPI0fLr9LjLyZaDgsGVsvoyyhyLXX0iz,3VkHkmOtom3jM2wCu94xgzzu1d6Dn7or,5,3,0,0,2,0,5,0,10,1.4285714285714286,2,0.0,0,0,0,2,3,0,0,5,0,2,8,1
1626,33911,YoEOoHSSJvpnm9mKUUaYYw17z3Oqeke4,3VkHkmOtom3jM2wCu94xgzzu1d6Dn7or,5,1,0,0,0,0,13,1,15,2.142857142857143,2,0.0,0,0,0,0,1,0,0,13,1,0,15,1
1627,33956,ooiLFMC6LmFwALnsQsV41Hy63EhHYfZI,3VkHkmOtom3jM2wCu94xgzzu1d6Dn7or,24,49,13,12,16,21,11,1,123,17.571428571428573,4,0.0,29,13,12,16,20,21,0,11,1,70,53,1
1628,34006,aZ1jaFsPkThraNBN6FchjwyZAyj6hSy3,3VkHkmOtom3jM2wCu94xgzzu1d6Dn7or,1,0,0,0,0,0,1,0,1,0.14285714285714285,1,0.0,0,0,0,0,0,0,0,1,0,0,1,1
1629,34025,2NbgOs46HWMRNsVHOWRPOpKO7ulJjEac,3VkHkmOtom3jM2wCu94xgzzu1d6Dn7or,1,0,0,0,0,0,1,0,1,0.14285714285714285,1,0.0,0,0,0,0,0,0,0,1,0,0,1,1
1630,34081,aXVVveJT1EMTrK18orLW4FdAnq2Nzu9u,3VkHkmOtom3jM2wCu94xgzzu1d6Dn7or,6,5,1,0,2,1,3,1,13,1.8571428571428572,1,0.0,4,1,0,2,1,1,0,3,1,7,6,1
1631,34150,tsrLQC0lV1sZ8LCxoRmunUV9mkqpjmjC,3VkHkmOtom3jM2wCu94xgzzu1d6Dn7or,7,4,1,0,0,1,7,1,14,2.0,2,0.0,0,1,0,0,4,1,0,7,1,1,13,1
1632,34164,FZWt1vapJFvo3kXFvlr3Pcq5dqSsXIdl,3VkHkmOtom3jM2wCu94xgzzu1d6Dn7or,65,189,64,76,61,37,39,1,467,66.71428571428571,9,0.0,93,64,70,61,96,37,6,39,1,288,179,0
1633,34168,Rjq3XI3sJgbsQzOAqulSUkFuGk4UEX7x,3VkHkmOtom3jM2wCu94xgzzu1d6Dn7or,62,156,35,42,68,12,12,0,325,46.42857142857143,9,0.0,111,35,39,68,45,12,3,12,0,253,72,1
1634,34195,2pj9dHHbYoDCs5MS65snrPL5uR3OD5Lh,3VkHkmOtom3jM2wCu94xgzzu1d6Dn7or,96,408,184,69,94,64,123,0,942,134.57142857142858,21,0.0,121,184,57,94,287,64,12,123,0,456,486,0
1635,34217,RKAPccQbF04WFjvpPrrz3H1bcBykoWKC,3VkHkmOtom3jM2wCu94xgzzu1d6Dn7or,1,0,0,0,0,0,2,0,2,0.2857142857142857,1,0.0,0,0,0,0,0,0,0,2,0,0,2,1
1636,34228,I1UyztOe06FJeROTPzN6DbCbmc8CXQ91,3VkHkmOtom3jM2wCu94xgzzu1d6Dn7or,21,27,12,11,10,6,21,2,89,12.714285714285714,2,0.0,8,12,8,10,19,6,3,21,2,38,51,1
1637,34248,FtP5J6LR9t3GWYYm2BB6BaIAep1tOlB2,3VkHkmOtom3jM2wCu94xgzzu1d6Dn7or,27,26,14,15,14,2,3,0,74,10.571428571428571,2,0.0,9,14,12,14,17,2,3,3,0,49,25,1
1638,34277,NxFyNsgKtERXuEF6F8exx7Gs202RXGOk,3VkHkmOtom3jM2wCu94xgzzu1d6Dn7or,5,3,1,0,2,0,2,0,8,1.1428571428571428,1,0.0,0,1,0,2,3,0,0,2,0,3,5,1
1639,34297,ROEJI4wPM4hl5HJvXJtuG7qEVHlU64nL,3VkHkmOtom3jM2wCu94xgzzu1d6Dn7or,1,0,0,0,0,0,1,0,1,0.14285714285714285,1,0.0,0,0,0,0,0,0,0,1,0,0,1,1
1640,34408,YRvoydpc37Vpysmtw8O9rzowfgsZu7lO,3VkHkmOtom3jM2wCu94xgzzu1d6Dn7or,80,88,42,44,28,14,12,2,230,32.857142857142854,7,0.0,35,42,40,28,53,14,4,12,2,145,85,0
1641,34422,4TE0YwEikT84fXsOy3F1reADl0bBBf10,3VkHkmOtom3jM2wCu94xgzzu1d6Dn7or,15,41,13,6,2,6,8,0,76,10.857142857142858,5,0.0,6,13,5,2,35,6,1,8,0,26,50,1
1642,34450,f1RdhphkihsZPXjGaeUcF80F5PgPD1Mj,3VkHkmOtom3jM2wCu94xgzzu1d6Dn7or,5,2,1,0,1,0,5,0,9,1.2857142857142858,2,0.0,0,1,0,1,2,0,0,5,0,2,7,1
1643,34480,MKNBl3hhuuRZuBxyPOWBVV1OHzyXBuxg,3VkHkmOtom3jM2wCu94xgzzu1d6Dn7or,63,152,57,68,43,42,35,0,397,56.714285714285715,5,0.0,33,57,65,43,119,42,3,35,0,198,199,0
1644,34559,4iE8erzNZza1Ul4e6hPr0spJlerWRU2v,3VkHkmOtom3jM2wCu94xgzzu1d6Dn7or,75,232,90,46,44,46,37,12,507,72.42857142857143,11,0.0,76,90,44,44,156,46,2,37,12,254,253,0
1645,34574,eU7O6SlQ9Aa2vwin8Uq1FASqW5nuEsaN,3VkHkmOtom3jM2wCu94xgzzu1d6Dn7or,5,6,3,0,1,0,3,0,13,1.8571428571428572,3,0.0,0,3,0,1,6,0,0,3,0,4,9,1
1646,34602,bS2IOWKbnbandmSXQXzI1vhjNhpDoKfN,7GRhBDsirIGkRZBtSMEzNTyDr2JQm4xx,4,5,3,0,1,7,0,0,16,2.2857142857142856,1,0.0,2,3,0,1,3,7,0,0,0,6,10,1
1647,34706,qZhmmNUvkNXdf3u04DTUQOFEBxxO10p4,5X6FeZozNMgE2VRi3MJYjkkFK8SETtu2,37,36,9,40,18,0,5,0,108,15.428571428571429,3,0.0,20,9,36,18,16,0,4,5,0,83,25,0
1648,34750,dZiWNJzMYOhdEdmTnxnlGn0TB2qVPzZP,7GRhBDsirIGkRZBtSMEzNTyDr2JQm4xx,6,3,2,0,2,0,1,0,8,1.1428571428571428,1,0.0,0,2,0,2,3,0,0,1,0,4,4,1
1649,34758,phhASQ029vNNdFMJmgP5NypplnmnI83R,7GRhBDsirIGkRZBtSMEzNTyDr2JQm4xx,10,7,4,68,0,0,1,0,80,11.428571428571429,2,0.0,2,4,62,0,5,0,6,1,0,68,12,0
1650,34792,dIopyk7eN7utmmbDdsk2JIW9Z0tySqPS,7GRhBDsirIGkRZBtSMEzNTyDr2JQm4xx,9,8,0,10,2,0,1,0,21,3.0,1,0.0,4,0,8,2,4,0,2,1,0,14,7,0
1651,34846,zVTKdKxLJYjz5XCh3vZ8AWdcMxkpEsE1,7GRhBDsirIGkRZBtSMEzNTyDr2JQm4xx,20,23,11,0,7,1,7,0,49,7.0,2,0.0,1,11,0,7,22,1,0,7,0,19,30,1
1652,34876,8Iba92MciDzfCVuZ0K5vCkx7lFQmElPx,5X6FeZozNMgE2VRi3MJYjkkFK8SETtu2,2,0,0,0,0,0,2,0,2,0.2857142857142857,1,0.0,0,0,0,0,0,0,0,2,0,0,2,1
1653,34882,zykXzhSqjaQF2TOV7bisEs6kRKezoegb,5X6FeZozNMgE2VRi3MJYjkkFK8SETtu2,17,14,7,10,5,9,4,0,49,7.0,2,0.0,2,7,8,5,12,9,2,4,0,22,27,1
1654,34883,C4q4gNQYEpjKh7pq1qjN8i3L7uSpUX9d,7GRhBDsirIGkRZBtSMEzNTyDr2JQm4xx,25,59,13,0,16,0,1,0,89,12.714285714285714,1,0.0,23,13,0,16,36,0,0,1,0,52,37,0
1655,34936,CUk1cSByLM0WdwmPEC4VGIc51EiVS5sq,5X6FeZozNMgE2VRi3MJYjkkFK8SETtu2,4,2,1,0,0,0,2,0,5,0.7142857142857143,1,0.0,0,1,0,0,2,0,0,2,0,1,4,0
1656,34942,hWZOZWrbvyzscOAFXsJvbbMN6COKZZlo,5X6FeZozNMgE2VRi3MJYjkkFK8SETtu2,6,10,1,0,1,0,10,1,23,3.2857142857142856,2,0.0,2,1,0,1,8,0,0,10,1,4,19,0
1657,34944,g2ieOC0GwkKqaZWeJNXowTArkXtXRKC6,5X6FeZozNMgE2VRi3MJYjkkFK8SETtu2,5,3,1,0,0,0,3,0,7,1.0,1,0.0,0,1,0,0,3,0,0,3,0,1,6,1
1658,34968,ganxR6HGA35mA8rG8lqwM374IiEISz9t,5X6FeZozNMgE2VRi3MJYjkkFK8SETtu2,38,45,11,42,23,7,27,3,158,22.571428571428573,7,0.0,29,11,38,23,16,7,4,27,3,101,57,0
1659,35033,xLkn5A65RKV3kvWji4FrgPZOEBlW1QGF,5X6FeZozNMgE2VRi3MJYjkkFK8SETtu2,5,2,1,0,1,0,2,0,6,0.8571428571428571,1,0.0,0,1,0,1,2,0,0,2,0,2,4,1
1660,35039,URPpxYyCEjr1OE9SkqYA4izrGFGWLVkB,7GRhBDsirIGkRZBtSMEzNTyDr2JQm4xx,24,21,5,18,6,1,5,1,57,8.142857142857142,1,0.0,9,5,9,6,12,1,9,5,1,29,28,1
1661,35139,Xr28fYjVCLAzrdEH9JR11PVrZPTquhGC,5X6FeZozNMgE2VRi3MJYjkkFK8SETtu2,1,0,0,0,0,0,1,0,1,0.14285714285714285,1,0.0,0,0,0,0,0,0,0,1,0,0,1,1
1662,35141,LgFsEu5TARkqPf6cgrTX0NqpOzewq5Lk,5X6FeZozNMgE2VRi3MJYjkkFK8SETtu2,7,7,3,0,1,0,3,0,14,2.0,2,0.0,0,3,0,1,7,0,0,3,0,4,10,0
1663,35142,V1VqVvaNADQhdwUg7X6GrtUrah1AYvnF,5X6FeZozNMgE2VRi3MJYjkkFK8SETtu2,21,33,4,17,7,7,9,2,79,11.285714285714286,4,0.0,12,4,17,7,21,7,0,9,2,40,39,0
1664,35143,7eHsOwDNMYF4417CWrgdB8gK0Wr4kfqA,7GRhBDsirIGkRZBtSMEzNTyDr2JQm4xx,21,68,16,14,15,3,6,0,122,17.428571428571427,5,0.0,42,16,12,15,26,3,2,6,0,85,37,0
1665,35219,NloNzaDH3veeVFXcbcubNhXbjetvTiHo,3VkHkmOtom3jM2wCu94xgzzu1d6Dn7or,69,74,47,0,43,0,17,1,182,26.0,11,0.0,13,47,0,43,61,0,0,17,1,103,79,1
1666,35226,VrcAU2QLiPqVHHKHjhnkgJoQe1xmnYFr,3VkHkmOtom3jM2wCu94xgzzu1d6Dn7or,1,0,0,0,0,0,1,0,1,0.14285714285714285,1,0.0,0,0,0,0,0,0,0,1,0,0,1,1
1667,35244,Cg295oxP98ulacOMxj82Z33zofvX8NDO,3VkHkmOtom3jM2wCu94xgzzu1d6Dn7or,11,18,3,0,5,0,7,0,33,4.714285714285714,3,0.0,8,3,0,5,10,0,0,7,0,16,17,0
1668,35252,AQZEINvP5VjnvKTOLYKEEEE98JV5srZS,3VkHkmOtom3jM2wCu94xgzzu1d6Dn7or,1,0,0,0,0,0,1,0,1,0.14285714285714285,1,0.0,0,0,0,0,0,0,0,1,0,0,1,1
1669,35260,3YYhb9GPUHHEjFq4nmovkLqSAc47hw87,3VkHkmOtom3jM2wCu94xgzzu1d6Dn7or,44,171,44,48,0,52,23,3,341,48.714285714285715,6,0.0,54,44,43,0,117,52,5,23,3,141,200,1
1670,35262,Q3GN20FdAaB1MZlGBgPmcNQhTBDLwGfM,3VkHkmOtom3jM2wCu94xgzzu1d6Dn7or,4,11,4,0,0,0,3,0,18,2.5714285714285716,6,0.0,0,4,0,0,11,0,0,3,0,4,14,0
1671,35266,YQloiHp4EDEAnQ7UnBm1Re3dyFVVFj8Z,3VkHkmOtom3jM2wCu94xgzzu1d6Dn7or,69,221,7,62,71,2,53,4,420,60.0,9,0.0,109,7,54,71,112,2,8,53,4,241,179,0
1672,35271,EGnr1DIwxVClT1AEp500AEDbsdeKCZPX,3VkHkmOtom3jM2wCu94xgzzu1d6Dn7or,35,44,16,26,16,2,8,0,112,16.0,4,0.0,21,16,22,16,23,2,4,8,0,75,37,1
1673,35282,5ZXd1XQgfLUmCPlMx8OnxXzNyNKOWDdZ,3VkHkmOtom3jM2wCu94xgzzu1d6Dn7or,1,0,0,0,0,0,1,0,1,0.14285714285714285,1,0.0,0,0,0,0,0,0,0,1,0,0,1,1
1674,35288,JpPOjxQ25IFbccGav6d5GeYc4gSRLmTh,3VkHkmOtom3jM2wCu94xgzzu1d6Dn7or,2,0,0,0,0,0,5,0,5,0.7142857142857143,1,0.0,0,0,0,0,0,0,0,5,0,0,5,1
1675,35303,G5gPqpN0Dlyu1X04lWjkXJjbYNBs8e1L,3VkHkmOtom3jM2wCu94xgzzu1d6Dn7or,47,170,31,47,63,2,30,2,345,49.285714285714285,7,0.0,105,31,44,63,65,2,3,30,2,243,102,0
1676,35309,i2lUV72IHqqXWYqLFMWv3y4XGmlq2lXa,3VkHkmOtom3jM2wCu94xgzzu1d6Dn7or,49,144,83,104,0,52,33,2,418,59.714285714285715,14,0.0,40,83,99,0,104,52,5,33,2,222,196,0
1677,35319,3rgatvueGycmzmQ7x6De7keieQ0tMDvZ,3VkHkmOtom3jM2wCu94xgzzu1d6Dn7or,62,85,6,26,26,21,25,3,192,27.428571428571427,8,0.0,31,6,26,26,54,21,0,25,3,89,103,0
1678,35334,oIZupP8mtjvTucUgRpisbdhVhywamlH4,3VkHkmOtom3jM2wCu94xgzzu1d6Dn7or,31,68,30,44,20,15,12,0,189,27.0,9,0.0,21,30,38,20,47,15,6,12,0,109,80,1
1679,35338,J7Z2kbIusBdg4vDNSEXsBqvF3Z5aB0VS,3VkHkmOtom3jM2wCu94xgzzu1d6Dn7or,7,4,1,0,0,2,20,4,31,4.428571428571429,1,0.0,0,1,0,0,4,2,0,20,4,1,30,1
1680,35345,V5yC8Sc1UiRa5SVlGIrYAvwTvYKzzr9V,3VkHkmOtom3jM2wCu94xgzzu1d6Dn7or,5,2,1,0,1,0,2,0,6,0.8571428571428571,1,0.0,0,1,0,1,2,0,0,2,0,2,4,1
1681,35364,F7LLRj3C3OHWoTHHOtX1hOxCNCJMv4e2,3VkHkmOtom3jM2wCu94xgzzu1d6Dn7or,9,6,2,7,3,1,3,0,22,3.142857142857143,1,0.0,3,2,6,3,3,1,1,3,0,14,8,1
1682,35366,GYZiEWORkvdb98HTlXPlZY67c9EwOLPh,3VkHkmOtom3jM2wCu94xgzzu1d6Dn7or,39,139,58,1,29,1,16,6,250,35.714285714285715,2,0.0,9,58,1,29,130,1,0,16,6,97,153,1
1683,35371,9A1ZQrzcYlbBSb63MFLqCvCueyg4FsvP,3VkHkmOtom3jM2wCu94xgzzu1d6Dn7or,1,0,0,0,0,0,1,0,1,0.14285714285714285,1,0.0,0,0,0,0,0,0,0,1,0,0,1,1
1684,35379,swFSBeVvTnBYaeb15rO3Azeazpu85Bvg,3VkHkmOtom3jM2wCu94xgzzu1d6Dn7or,6,2,0,0,0,0,7,0,9,1.2857142857142858,1,0.0,0,0,0,0,2,0,0,7,0,0,9,1
1685,35380,1yNvYTbjWPtGip8F7Y4Mte6NTH0OJtD0,3VkHkmOtom3jM2wCu94xgzzu1d6Dn7or,26,38,11,13,14,9,23,3,111,15.857142857142858,3,0.0,21,11,13,14,17,9,0,23,3,59,52,1
1686,35385,YYPEucCdDZvSoz6R7Fuc1GsZB3bn6s7b,3VkHkmOtom3jM2wCu94xgzzu1d6Dn7or,25,55,10,7,15,12,9,0,108,15.428571428571429,5,0.0,24,10,7,15,31,12,0,9,0,56,52,1
1687,35393,sg4VVv9cgk6nt80dZvUKhL5H7RMgLm0l,3VkHkmOtom3jM2wCu94xgzzu1d6Dn7or,95,123,58,59,42,62,33,0,377,53.857142857142854,10,0.0,47,58,55,42,76,62,4,33,0,202,175,0
1688,35411,WVDlpVdT5mqaYV2jwUU0OJMNLxqJCz3F,3VkHkmOtom3jM2wCu94xgzzu1d6Dn7or,2,0,0,0,0,0,3,0,3,0.42857142857142855,1,0.0,0,0,0,0,0,0,0,3,0,0,3,1
1689,35413,tCaITUvSbtVWtN97HSN8SiFnJq6fQQbA,3VkHkmOtom3jM2wCu94xgzzu1d6Dn7or,7,2,1,0,1,0,6,1,11,1.5714285714285714,2,0.0,0,1,0,1,2,0,0,6,1,2,9,1
1690,35414,qjwWMZIT8GPuhKM2uz6F9PBHE6dfIr5u,3VkHkmOtom3jM2wCu94xgzzu1d6Dn7or,2,0,0,0,0,0,2,0,2,0.2857142857142857,1,0.0,0,0,0,0,0,0,0,2,0,0,2,1
1691,35415,hXeJsHYt7Lw33OwJ9XWEmEMIulVpOLUH,3VkHkmOtom3jM2wCu94xgzzu1d6Dn7or,7,9,3,1,2,5,3,0,23,3.2857142857142856,3,0.0,3,3,1,2,6,5,0,3,0,9,14,1
1692,35444,RCs47yV8g50jkPyVnv7MaTTXpYxAFYTV,7GRhBDsirIGkRZBtSMEzNTyDr2JQm4xx,2,0,0,0,0,0,2,0,2,0.2857142857142857,1,0.0,0,0,0,0,0,0,0,2,0,0,2,1
1693,35463,JtMmp5BCDQnYE7CMI3NvnX4aRCZsQW9K,7GRhBDsirIGkRZBtSMEzNTyDr2JQm4xx,1,0,0,0,0,0,1,0,1,0.14285714285714285,1,0.0,0,0,0,0,0,0,0,1,0,0,1,0
1694,35508,3T6lo0hNKqGF8AeLHQEHxxeYIjJqOuY5,7GRhBDsirIGkRZBtSMEzNTyDr2JQm4xx,1,0,0,0,0,0,1,0,1,0.14285714285714285,1,0.0,0,0,0,0,0,0,0,1,0,0,1,1
1695,35514,m3BtjHPB6UJjyfA5xn0d2GYhJL5pNCbr,7GRhBDsirIGkRZBtSMEzNTyDr2JQm4xx,7,3,2,0,2,0,2,0,9,1.2857142857142858,1,0.0,0,2,0,2,3,0,0,2,0,4,5,1
1696,35607,2LWu6JMOYyxkKMq63i00WbtT7iPpdOSr,7GRhBDsirIGkRZBtSMEzNTyDr2JQm4xx,2,0,0,0,0,0,2,0,2,0.2857142857142857,1,0.0,0,0,0,0,0,0,0,2,0,0,2,1
1697,35608,nH0kSZNGQd9lZaOsssfRVpCIHD2KW4j6,7GRhBDsirIGkRZBtSMEzNTyDr2JQm4xx,23,22,7,53,10,1,3,0,96,13.714285714285714,2,0.0,12,7,49,10,10,1,4,3,0,78,18,1
1698,35634,U3LNfYcdRIeU9qhiaPG7Yg8NuZRGOnSS,7GRhBDsirIGkRZBtSMEzNTyDr2JQm4xx,3,0,0,0,0,0,6,0,6,0.8571428571428571,2,0.0,0,0,0,0,0,0,0,6,0,0,6,1
1699,35641,V4bFVaM4pBFZgsA7pP7LuDbbkkFXZJkm,7GRhBDsirIGkRZBtSMEzNTyDr2JQm4xx,7,4,1,0,1,0,2,0,8,1.1428571428571428,1,0.0,0,1,0,1,4,0,0,2,0,2,6,1
1700,35652,8rRjFsPi04nQAO9F6yKNcWF37hukO3JR,7GRhBDsirIGkRZBtSMEzNTyDr2JQm4xx,55,99,43,84,43,3,8,0,280,40.0,1,0.0,51,43,74,43,48,3,10,8,0,211,69,0
1701,35662,ISNkLbVsU7lMqk5vdrFnPCVx4y3a9MZD,7GRhBDsirIGkRZBtSMEzNTyDr2JQm4xx,6,5,1,4,1,0,1,0,12,1.7142857142857142,1,0.0,2,1,3,1,3,0,1,1,0,7,5,1
1702,35686,skJn7dtfSekFrPHRHs9swZ9AtSUKi36u,7GRhBDsirIGkRZBtSMEzNTyDr2JQm4xx,57,146,53,54,32,61,16,0,362,51.714285714285715,2,0.0,80,53,48,32,66,61,6,16,0,213,149,0
1703,35696,Vtwq7W3DodckYgwQIiThiTk1zWdBpMl0,7GRhBDsirIGkRZBtSMEzNTyDr2JQm4xx,2,2,0,0,1,0,0,0,3,0.42857142857142855,1,0.0,2,0,0,1,0,0,0,0,0,3,0,1
1704,35725,BqXfJC2PEXaOut3jaDziE5COnZJ5tCVg,7GRhBDsirIGkRZBtSMEzNTyDr2JQm4xx,46,52,21,41,21,2,0,0,137,19.571428571428573,3,0.0,30,21,21,21,22,2,20,0,0,93,44,1
1705,35826,GMULrMSqUlOdEP2r4yoabrka9qt4yKGP,7GRhBDsirIGkRZBtSMEzNTyDr2JQm4xx,21,29,9,0,10,0,1,0,49,7.0,1,0.0,19,9,0,10,10,0,0,1,0,38,11,0
1706,35861,DhtCawfOEQUsJbImq8OS7DKZj4eiXUQq,7GRhBDsirIGkRZBtSMEzNTyDr2JQm4xx,6,1,1,0,1,0,4,0,7,1.0,1,0.0,0,1,0,1,1,0,0,4,0,2,5,1
1707,35881,712ruuJBHxwe16Nyde1AP6y2j0cVhIJD,7GRhBDsirIGkRZBtSMEzNTyDr2JQm4xx,16,12,0,18,0,0,1,0,31,4.428571428571429,1,0.0,5,0,18,0,7,0,0,1,0,23,8,0
1708,37584,06eFfwi64z4CVxg9kYU89F0UCK6M3gh2,G8EPVSXsOYB5YQWZGiz1aVq5Pgr2GrQu,13,17,1,10,1,0,3,0,32,4.571428571428571,1,0.0,9,1,5,1,8,0,5,3,0,16,16,1
1709,37587,9RND50Xx7veKeepJEVVvFKwUGiemuZp5,G8EPVSXsOYB5YQWZGiz1aVq5Pgr2GrQu,3,2,1,0,0,0,1,0,4,0.5714285714285714,1,0.0,0,1,0,0,2,0,0,1,0,1,3,1
1710,37610,v7t0p3xAszbLv0yg1dCcAEjixfvU7JCE,SpATywNh6bZuzm8s1ceuBUnMUAeoAHHw,21,28,14,14,7,0,5,0,68,9.714285714285714,2,0.0,9,14,13,7,19,0,1,5,0,43,25,0
1711,37636,08uQSEeVi17JB9WOQMIOM89vv6wgWS2O,SpATywNh6bZuzm8s1ceuBUnMUAeoAHHw,17,22,3,16,2,0,3,0,46,6.571428571428571,2,0.0,6,3,15,2,16,0,1,3,0,26,20,1
1712,37666,zeUi2UnQZPPF6bRQXw2s8LZ41ZOdqRAa,SpATywNh6bZuzm8s1ceuBUnMUAeoAHHw,19,23,15,7,7,11,5,0,68,9.714285714285714,5,0.0,2,15,7,7,21,11,0,5,0,31,37,0
1713,37690,1Ti3XKNP5gzLh1si7Apz4GKt53UijsKr,SpATywNh6bZuzm8s1ceuBUnMUAeoAHHw,18,23,8,14,5,0,2,0,52,7.428571428571429,2,0.0,5,8,12,5,18,0,2,2,0,30,22,0
1714,37691,FisqRa6EMb5EsK7GdBjEQwdg4YXD4Xed,bWdj2GDclj5ofokWjzoa5jAwMkxCykd6,11,9,5,16,1,0,3,0,34,4.857142857142857,2,0.0,1,5,11,1,8,0,5,3,0,18,16,1
1715,37706,5D134KQAUnU8gDw5hYnvC82YSO8giiEU,SpATywNh6bZuzm8s1ceuBUnMUAeoAHHw,18,10,7,5,5,0,2,0,29,4.142857142857143,1,0.0,2,7,5,5,8,0,0,2,0,19,10,0
1716,37710,t89Lbc9NyQ1awHKwpUunu51m4E6DMYhk,SpATywNh6bZuzm8s1ceuBUnMUAeoAHHw,4,3,1,0,0,0,1,0,5,0.7142857142857143,1,0.0,0,1,0,0,3,0,0,1,0,1,4,0
1717,37713,7fOZzyBcCx06Vw2a40A0eroSD5VkDcNa,SpATywNh6bZuzm8s1ceuBUnMUAeoAHHw,18,27,17,12,9,25,4,0,94,13.428571428571429,3,0.0,4,17,10,9,23,25,2,4,0,40,54,0
1718,37761,bzoYFRQVu6SapCnsZ0DOXeU3JXiLIJu3,SpATywNh6bZuzm8s1ceuBUnMUAeoAHHw,1,0,0,0,0,0,1,0,1,0.14285714285714285,1,0.0,0,0,0,0,0,0,0,1,0,0,1,0
1719,37883,9Uee7oEuuMmgPx2IzPfFkWgkHZyPbWr0,SpATywNh6bZuzm8s1ceuBUnMUAeoAHHw,53,87,53,29,32,0,11,0,212,30.285714285714285,4,0.0,21,53,25,32,66,0,4,11,0,131,81,0
1720,37894,qPQsrCDbNr80CImeaDwXdvYkweQdyVus,RXDvfPUBYFlVdlueBFbLW0mhhAyGEqpt,5,7,4,0,1,0,1,0,13,1.8571428571428572,2,0.0,0,4,0,1,7,0,0,1,0,5,8,0
1721,37905,lV4ifbsehEXWBwQOY9bU762jcRSMFY5M,SpATywNh6bZuzm8s1ceuBUnMUAeoAHHw,30,25,15,13,10,2,8,1,74,10.571428571428571,2,0.0,2,15,12,10,23,2,1,8,1,39,35,0
1722,37926,mUOanMUrsiycv8pF8RX4xyc7qtUXAMUs,bWdj2GDclj5ofokWjzoa5jAwMkxCykd6,3,1,1,0,1,0,0,0,3,0.42857142857142855,1,0.0,0,1,0,1,1,0,0,0,0,2,1,1
1723,37932,UYyUkvxHd4tIc6aiQcuHfsTYHPlQXaAb,G8EPVSXsOYB5YQWZGiz1aVq5Pgr2GrQu,29,27,16,63,6,0,4,1,117,16.714285714285715,1,0.0,8,16,48,6,19,0,15,4,1,78,39,1
1724,37992,lFmplH6KaQigIQOByvMn1p8i4p6OLLhs,SpATywNh6bZuzm8s1ceuBUnMUAeoAHHw,17,13,8,18,6,0,1,0,46,6.571428571428571,1,0.0,2,8,16,6,11,0,2,1,0,32,14,1
1725,37993,pYcnIzYPgb3xzrOvmR9y0UUIZo4gqKuO,SpATywNh6bZuzm8s1ceuBUnMUAeoAHHw,21,27,18,11,8,0,2,0,66,9.428571428571429,2,0.0,6,18,8,8,21,0,3,2,0,40,26,0
1726,38049,7n0QZ7z1Xa9itNmJQbQwoSvEI6n7oD9f,G8EPVSXsOYB5YQWZGiz1aVq5Pgr2GrQu,6,6,3,0,1,4,2,2,18,2.5714285714285716,1,0.0,0,3,0,1,6,4,0,2,2,4,14,0
1727,38117,udxFfabXtaVUvVlT3wEleIvfDBGe9yE2,SpATywNh6bZuzm8s1ceuBUnMUAeoAHHw,13,31,1,12,0,0,4,0,48,6.857142857142857,3,0.0,13,1,11,0,18,0,1,4,0,25,23,0
1728,38119,53oi8zKKD3qFJiM7JZLKGYnyxQCMyuUV,SpATywNh6bZuzm8s1ceuBUnMUAeoAHHw,7,7,5,0,3,0,2,0,17,2.4285714285714284,1,0.0,0,5,0,3,7,0,0,2,0,8,9,0
1729,38158,i1weaEaafaiWi31Ms4bwoF6JM4IRf714,SpATywNh6bZuzm8s1ceuBUnMUAeoAHHw,37,31,21,30,15,0,3,0,100,14.285714285714286,1,0.0,5,21,24,15,26,0,6,3,0,65,35,0
1730,38247,jSpQCS8wUT6MHpQaGbLVjdDCTF3dAoT8,SpATywNh6bZuzm8s1ceuBUnMUAeoAHHw,14,12,10,0,6,0,2,0,30,4.285714285714286,1,0.0,0,10,0,6,12,0,0,2,0,16,14,0
1731,38268,JDTEn5xJLcPCagcpPFhmwRsZ0N8AbJZ6,A3fsA9Zfv1X2fVEQhTw51lKENdNrEqT3,1,0,0,0,0,0,3,0,3,0.42857142857142855,1,0.0,0,0,0,0,0,0,0,3,0,0,3,1
1732,38416,3koO9aMoYp8zzErC814zevxBi6TaaAOF,SpATywNh6bZuzm8s1ceuBUnMUAeoAHHw,18,19,13,18,4,6,6,3,69,9.857142857142858,1,0.0,5,13,15,4,14,6,3,6,3,37,32,0
1733,38491,UEGgGFOddxp081siu8g5s2awm2LAgg2C,SpATywNh6bZuzm8s1ceuBUnMUAeoAHHw,12,14,0,8,0,0,3,0,25,3.5714285714285716,1,0.0,5,0,7,0,9,0,1,3,0,12,13,0
1734,38521,WRiHtWJX61VUGyAGQFSHJ3czdrgqxeQW,G8EPVSXsOYB5YQWZGiz1aVq5Pgr2GrQu,4,3,1,0,0,2,4,0,10,1.4285714285714286,3,0.0,0,1,0,0,3,2,0,4,0,1,9,1
1735,38533,pqUcxq00SFcjmnxHDdHJfvpMD3HzyhM8,A3fsA9Zfv1X2fVEQhTw51lKENdNrEqT3,6,10,6,0,2,0,1,0,19,2.7142857142857144,5,0.0,0,6,0,2,10,0,0,1,0,8,11,0
1736,38560,op5Oi3uTeIRoABlsMVgAwjAoITQ3GmAH,SpATywNh6bZuzm8s1ceuBUnMUAeoAHHw,12,14,5,0,2,0,5,0,26,3.7142857142857144,3,0.0,0,5,0,2,14,0,0,5,0,7,19,1
1737,38603,BK89tGWFvtCB5b9BaDDNxW929HW7wR4P,G8EPVSXsOYB5YQWZGiz1aVq5Pgr2GrQu,12,10,7,0,5,0,0,0,22,3.142857142857143,3,0.0,0,7,0,5,10,0,0,0,0,12,10,0
1738,38686,pNgLScEwGgq81vg0a0cEXKNs5eG2UXph,A3fsA9Zfv1X2fVEQhTw51lKENdNrEqT3,17,8,5,24,2,0,1,0,40,5.714285714285714,1,0.0,2,5,24,2,6,0,0,1,0,33,7,1
1739,38701,E4KzNEU3ybRlAOiHqHHsGQEXiaxyHgoT,RXDvfPUBYFlVdlueBFbLW0mhhAyGEqpt,16,16,8,20,5,0,5,0,54,7.714285714285714,2,0.0,5,8,18,5,11,0,2,5,0,36,18,0
1740,38799,RzMIvT7jMzqf1FBzeYDC0G8NjaFmpbg8,SpATywNh6bZuzm8s1ceuBUnMUAeoAHHw,9,6,5,0,4,0,1,0,16,2.2857142857142856,1,0.0,0,5,0,4,6,0,0,1,0,9,7,0
1741,38854,Xi85gYtmIKPj1CmvXveeSMqfVqnWSguE,bWdj2GDclj5ofokWjzoa5jAwMkxCykd6,2,0,0,0,0,18,3,0,21,3.0,1,0.0,0,0,0,0,0,18,0,3,0,0,21,0
1742,38855,uEJhWNudTN4AiJAcLu3Q22sgnPRHYbuv,G8EPVSXsOYB5YQWZGiz1aVq5Pgr2GrQu,83,223,87,0,52,0,24,0,386,55.142857142857146,6,0.0,43,87,0,52,180,0,0,24,0,182,204,0
1743,38870,jaeRBfNSkyTpFxAZieHe5vTAkzlHFDmm,A3fsA9Zfv1X2fVEQhTw51lKENdNrEqT3,28,29,17,110,1,8,6,0,171,24.428571428571427,1,0.0,2,17,94,1,27,8,16,6,0,114,57,1
1744,38920,0a9a6o0rpJD7kzJZwGRL9kB3jevQvRa8,SpATywNh6bZuzm8s1ceuBUnMUAeoAHHw,6,3,0,0,0,0,3,1,7,1.0,1,0.0,0,0,0,0,3,0,0,3,1,0,7,0
1745,38949,7HiGv3GGo0SXqM9pqC4B8FvUEghdfkna,A3fsA9Zfv1X2fVEQhTw51lKENdNrEqT3,33,21,13,100,6,1,7,0,148,21.142857142857142,1,0.0,3,13,86,6,18,1,14,7,0,108,40,0
1746,39095,Lc5TZPB93C58CDuO8VjF5g6g9boxDaHr,SpATywNh6bZuzm8s1ceuBUnMUAeoAHHw,29,51,2,31,1,17,11,1,114,16.285714285714285,1,0.0,5,2,28,1,46,17,3,11,1,36,78,1
1747,39114,2nqqGgbA0MihvBXBZoRijk6wA6yRTkC8,SpATywNh6bZuzm8s1ceuBUnMUAeoAHHw,17,24,11,7,5,14,1,0,62,8.857142857142858,2,0.0,1,11,6,5,23,14,1,1,0,23,39,1
1748,39140,zVX5LPwTGC1SEitxSfv31cubNXKJSEc2,SpATywNh6bZuzm8s1ceuBUnMUAeoAHHw,2,0,0,0,0,0,3,0,3,0.42857142857142855,1,0.0,0,0,0,0,0,0,0,3,0,0,3,0
1749,39141,ILzL3Mkktf2JWNBXHKy152QukNojyWoV,SpATywNh6bZuzm8s1ceuBUnMUAeoAHHw,11,8,4,0,2,0,4,0,18,2.5714285714285716,1,0.0,0,4,0,2,8,0,0,4,0,6,12,1
1750,39154,BGVVwabO5K2aC65VwhxWT01Y18m3Nzj6,SpATywNh6bZuzm8s1ceuBUnMUAeoAHHw,26,57,2,10,2,40,9,12,132,18.857142857142858,2,0.0,3,2,9,2,54,40,1,9,12,16,116,0
1751,39164,7GjcmlDBrfMQgiPOO8hsiYQuQLOINerQ,SpATywNh6bZuzm8s1ceuBUnMUAeoAHHw,10,9,6,0,2,0,3,0,20,2.857142857142857,2,0.0,0,6,0,2,9,0,0,3,0,8,12,0
1752,39177,HzHckETSltPKPBe9aHJBFKMPGsxyznRF,RXDvfPUBYFlVdlueBFbLW0mhhAyGEqpt,39,58,29,98,23,5,8,0,221,31.571428571428573,2,0.0,25,29,86,23,33,5,12,8,0,163,58,0
1753,39195,E4KzNEU3ybRlAOiHqHHsGQEXiaxyHgoT,G8EPVSXsOYB5YQWZGiz1aVq5Pgr2GrQu,16,15,7,18,3,0,2,0,45,6.428571428571429,1,0.0,7,7,13,3,8,0,5,2,0,30,15,0
1754,39279,MbSy3vYucWpXbJ8XgmPxO6zrZOjC9oUB,SpATywNh6bZuzm8s1ceuBUnMUAeoAHHw,13,13,8,0,5,0,2,0,28,4.0,1,0.0,0,8,0,5,13,0,0,2,0,13,15,1
1755,39328,iJftBP3zncmjUCwGWSZ77IUrDb3Dt8rz,A3fsA9Zfv1X2fVEQhTw51lKENdNrEqT3,5,5,3,0,1,0,1,0,10,1.4285714285714286,1,0.0,0,3,0,1,5,0,0,1,0,4,6,0
1756,39355,z3YnX73v2uoVHmuLGzQD2gKKBoJqIQxK,A3fsA9Zfv1X2fVEQhTw51lKENdNrEqT3,14,19,17,0,13,0,5,0,54,7.714285714285714,2,0.0,1,17,0,13,18,0,0,5,0,31,23,1
1757,39493,Sw0laYN5mow6XiHfrWCJl4qnRcU0Nesb,SpATywNh6bZuzm8s1ceuBUnMUAeoAHHw,33,24,18,28,11,0,2,0,83,11.857142857142858,2,0.0,4,18,26,11,20,0,2,2,0,59,24,0
1758,39518,jeuXS3tUDyyNfvbrveLA3P9Aday4J2bg,SpATywNh6bZuzm8s1ceuBUnMUAeoAHHw,18,14,9,12,6,0,2,0,43,6.142857142857143,1,0.0,2,9,11,6,12,0,1,2,0,28,15,0
1759,39521,KkCL9hhbl4No8xC8Kgerd95M1LSlSYMD,G8EPVSXsOYB5YQWZGiz1aVq5Pgr2GrQu,28,32,0,90,0,5,4,0,131,18.714285714285715,1,0.0,20,0,76,0,12,5,14,4,0,96,35,0
1760,39523,U2HBhhMvJdYJzypYvAaM7auP4hEAIFmE,SpATywNh6bZuzm8s1ceuBUnMUAeoAHHw,14,16,11,0,5,2,8,1,43,6.142857142857143,3,0.0,0,11,0,5,16,2,0,8,1,16,27,0
1761,39528,UPv4XJg0qIN0z1e32NPBqipWdQJZCo5I,G8EPVSXsOYB5YQWZGiz1aVq5Pgr2GrQu,54,87,64,94,23,0,20,0,288,41.142857142857146,3,0.0,0,64,76,23,87,0,18,20,0,163,125,0
1762,39531,ZicPLcC85bFypm3Kcvbq59RwoYBxR8MH,A3fsA9Zfv1X2fVEQhTw51lKENdNrEqT3,20,5,3,72,0,0,1,0,81,11.571428571428571,1,0.0,1,3,63,0,4,0,9,1,0,67,14,1
1763,39635,xcD6YWhnGA2xukGmX4eaYrm6VS9ffz1H,SpATywNh6bZuzm8s1ceuBUnMUAeoAHHw,25,45,20,21,5,0,9,0,100,14.285714285714286,2,0.0,16,20,19,5,29,0,2,9,0,60,40,0
1764,39650,6FzXe5nPWUHRxntREHsQRnp7x1pxuhUz,SpATywNh6bZuzm8s1ceuBUnMUAeoAHHw,19,23,10,7,4,0,6,0,50,7.142857142857143,2,0.0,6,10,7,4,17,0,0,6,0,27,23,0
1765,39708,eHl6vKLwTQcSxYHb6DIMnO9xh3WNvHJf,SpATywNh6bZuzm8s1ceuBUnMUAeoAHHw,19,13,11,7,10,0,2,0,43,6.142857142857143,1,0.0,2,11,7,10,11,0,0,2,0,30,13,0
1766,39737,qRawfA1fPOcB5hZkORgH0hm8Ghubmgi1,A3fsA9Zfv1X2fVEQhTw51lKENdNrEqT3,9,9,1,0,1,4,2,0,17,2.4285714285714284,1,0.0,0,1,0,1,9,4,0,2,0,2,15,0
1767,39766,Bq3dgySLNxUfP2DnFVHYyEWwaDcd9ALN,A3fsA9Zfv1X2fVEQhTw51lKENdNrEqT3,13,11,9,0,5,0,1,0,26,3.7142857142857144,1,0.0,0,9,0,5,11,0,0,1,0,14,12,1
1768,39803,VdNVtOVHu3uq36SFu7mu40diveL7bnVd,A3fsA9Zfv1X2fVEQhTw51lKENdNrEqT3,1,0,0,0,0,0,1,0,1,0.14285714285714285,1,0.0,0,0,0,0,0,0,0,1,0,0,1,1
1769,39845,xwqLmgu4yZxUsX04FDtQMDL3awvB0E5w,SpATywNh6bZuzm8s1ceuBUnMUAeoAHHw,17,10,7,16,5,0,1,0,39,5.571428571428571,1,0.0,2,7,13,5,8,0,3,1,0,27,12,0
1770,39878,pLB7K8hva7hpUpPIa0JWEXpoyBHIkbAO,SpATywNh6bZuzm8s1ceuBUnMUAeoAHHw,20,11,8,15,5,1,4,1,45,6.428571428571429,1,0.0,2,8,13,5,9,1,2,4,1,28,17,1
1771,39922,2GATpIfDBYFyTgYmFkr0bda9mVfNXuAl,SpATywNh6bZuzm8s1ceuBUnMUAeoAHHw,23,24,11,10,8,15,3,0,71,10.142857142857142,3,0.0,2,11,10,8,22,15,0,3,0,31,40,0
1772,39962,p3Cz4BAZGaZT08I2Dwew8OwWDC6PUWgc,SpATywNh6bZuzm8s1ceuBUnMUAeoAHHw,18,11,8,13,5,0,1,0,38,5.428571428571429,1,0.0,2,8,11,5,9,0,2,1,0,26,12,1
1773,40036,vUH5NhW2dOJJ7pGM4nFysRqnPlXzFZdY,SpATywNh6bZuzm8s1ceuBUnMUAeoAHHw,12,11,1,15,0,0,1,0,28,4.0,1,0.0,2,1,13,0,9,0,2,1,0,16,12,0
1774,40125,znkDmOOvUgN8z7Q2bDidRTpqlGavufFM,SpATywNh6bZuzm8s1ceuBUnMUAeoAHHw,22,26,11,8,5,0,12,0,62,8.857142857142858,4,0.0,7,11,8,5,19,0,0,12,0,31,31,0
1775,40165,Vcn2Ncl6KVYaVVug7iW4LScBfpTMatic,RXDvfPUBYFlVdlueBFbLW0mhhAyGEqpt,3,2,0,0,0,0,1,0,3,0.42857142857142855,1,0.0,0,0,0,0,2,0,0,1,0,0,3,1
1776,40224,sV3jtFrXfncSgh7Xsq4nWcxj42E0NrUb,SpATywNh6bZuzm8s1ceuBUnMUAeoAHHw,17,16,8,0,8,0,8,0,40,5.714285714285714,3,0.0,0,8,0,8,16,0,0,8,0,16,24,0
1777,40272,FWTxDnNzcugqXGOfXWOseyRKl3gd7tL9,SpATywNh6bZuzm8s1ceuBUnMUAeoAHHw,7,9,1,0,1,0,1,0,12,1.7142857142857142,1,0.0,0,1,0,1,9,0,0,1,0,2,10,0
1778,40287,O1a4fHzT6b5r4IWUDa3zddRbshvfRlE4,A3fsA9Zfv1X2fVEQhTw51lKENdNrEqT3,6,5,4,0,3,0,3,0,15,2.142857142857143,2,0.0,0,4,0,3,5,0,0,3,0,7,8,1
1779,40330,e8tjBT4TkBUZGDf1oULgV0xlcUpSchNd,SpATywNh6bZuzm8s1ceuBUnMUAeoAHHw,4,6,1,0,0,0,1,0,8,1.1428571428571428,1,0.0,3,1,0,0,3,0,0,1,0,4,4,0
1780,40335,xLE9ZE3BmJvIiYogSmZ2Qwy8Pm6jvutZ,SpATywNh6bZuzm8s1ceuBUnMUAeoAHHw,3,2,0,0,0,0,1,0,3,0.42857142857142855,1,0.0,0,0,0,0,2,0,0,1,0,0,3,0
1781,40347,cC2qlM5WjvVF4gXhZ3ctfElOjyJIEAhi,SpATywNh6bZuzm8s1ceuBUnMUAeoAHHw,8,6,3,0,1,0,7,0,17,2.4285714285714284,2,0.0,0,3,0,1,6,0,0,7,0,4,13,1
1782,40385,uuGoGterx4QfmHoDE6WqQfMDG8gm4WOd,SpATywNh6bZuzm8s1ceuBUnMUAeoAHHw,13,12,7,0,3,1,2,0,25,3.5714285714285716,1,0.0,4,7,0,3,8,1,0,2,0,14,11,1
1783,40392,zT5Abo7SNHsAkCFKMvhJJJDWNu2sl4mh,SpATywNh6bZuzm8s1ceuBUnMUAeoAHHw,5,7,0,0,0,0,6,0,13,1.8571428571428572,2,0.0,0,0,0,0,7,0,0,6,0,0,13,0
1784,40441,b11C6Y0UpRSFGpKvHTlz5TF2Rt9ScBoX,SpATywNh6bZuzm8s1ceuBUnMUAeoAHHw,4,2,1,0,0,0,7,0,10,1.4285714285714286,2,0.0,1,1,0,0,1,0,0,7,0,2,8,0
1785,40584,mC2fzvwPaO34Kq32ibCwzrJ2EjHwbRrb,RXDvfPUBYFlVdlueBFbLW0mhhAyGEqpt,7,7,5,0,1,0,1,0,14,2.0,1,0.0,1,5,0,1,6,0,0,1,0,7,7,1
1786,40648,zUbaOnwFf34fsU2q7dIMt7fpEzRZebx6,SpATywNh6bZuzm8s1ceuBUnMUAeoAHHw,20,27,16,18,10,1,4,0,76,10.857142857142858,1,0.0,6,16,15,10,21,1,3,4,0,47,29,1
1787,40704,qmYTrueiQKfoQnGxjqfwlMlw7HOR9CKj,bWdj2GDclj5ofokWjzoa5jAwMkxCykd6,4,9,5,0,0,0,3,0,17,2.4285714285714284,1,0.0,0,5,0,0,9,0,0,3,0,5,12,0
1788,40780,EO0fRulUc32LbMOOGfwwNWyNgnF8pKY9,RXDvfPUBYFlVdlueBFbLW0mhhAyGEqpt,14,9,7,0,3,0,4,0,23,3.2857142857142856,1,0.0,1,7,0,3,8,0,0,4,0,11,12,1
1789,40782,eEl2lnEvtyQyZa1YqA2JcBHBfdkh8SHK,SpATywNh6bZuzm8s1ceuBUnMUAeoAHHw,6,3,2,0,1,0,2,0,8,1.1428571428571428,1,0.0,0,2,0,1,3,0,0,2,0,3,5,1
1790,40802,DFKzgJXlXxnZVHESIM4fYC543XX9ZfDV,SpATywNh6bZuzm8s1ceuBUnMUAeoAHHw,5,4,3,0,1,0,2,0,10,1.4285714285714286,1,0.0,0,3,0,1,4,0,0,2,0,4,6,1
1791,40869,8gfCGxZ6lFjZr89RwPF8oXZs1Qn6Pq6X,A3fsA9Zfv1X2fVEQhTw51lKENdNrEqT3,2,0,0,0,0,0,2,0,2,0.2857142857142857,1,0.0,0,0,0,0,0,0,0,2,0,0,2,1
1792,40973,BasnDhJkjNSRVUOCCIoBniAgNajwACiL,SpATywNh6bZuzm8s1ceuBUnMUAeoAHHw,26,44,2,28,1,0,15,0,90,12.857142857142858,4,0.0,8,2,25,1,36,0,3,15,0,36,54,0
1793,41045,1YzM2x4RT6wZpTpcb29oadjFh2hfD86U,5X6FeZozNMgE2VRi3MJYjkkFK8SETtu2,1,0,0,0,0,0,1,0,1,0.14285714285714285,1,0.0,0,0,0,0,0,0,0,1,0,0,1,1
1794,41126,XDK8k8ZxjLQNRum2tucg5KMs9y8pIx4l,5X6FeZozNMgE2VRi3MJYjkkFK8SETtu2,4,3,1,0,0,0,2,0,6,0.8571428571428571,1,0.0,0,1,0,0,3,0,0,2,0,1,5,1
1795,41151,CpJFUzNBBad8gxGQfFWcVCTdakqtlRdi,5X6FeZozNMgE2VRi3MJYjkkFK8SETtu2,1,0,0,0,0,0,1,0,1,0.14285714285714285,1,0.0,0,0,0,0,0,0,0,1,0,0,1,1
1796,41295,UyrB62TC80PvjIx5mHAqyBQJHo9hnImU,5X6FeZozNMgE2VRi3MJYjkkFK8SETtu2,9,7,3,0,1,2,5,1,19,2.7142857142857144,1,0.0,0,3,0,1,7,2,0,5,1,4,15,1
1797,41347,qXJ6UuggRRYAIHwmdSldGzLBmAnY5Oc1,5X6FeZozNMgE2VRi3MJYjkkFK8SETtu2,12,9,6,0,4,0,4,0,23,3.2857142857142856,1,0.0,0,6,0,4,9,0,0,4,0,10,13,1
1798,41418,eTCGzxAsblGqwnuTAWtbbANcNVoq2Yog,5X6FeZozNMgE2VRi3MJYjkkFK8SETtu2,1,0,0,0,0,0,1,0,1,0.14285714285714285,1,0.0,0,0,0,0,0,0,0,1,0,0,1,1
1799,41424,Gn1QSm7WrSyhbej7tThohiyBKeBu1xtD,7GRhBDsirIGkRZBtSMEzNTyDr2JQm4xx,24,26,15,8,14,0,2,0,65,9.285714285714286,2,0.0,8,15,7,14,18,0,1,2,0,44,21,0
1800,41434,eFbaGNJkrGgLy9I6zgZvwaIK40Fpk2dV,5X6FeZozNMgE2VRi3MJYjkkFK8SETtu2,1,0,0,0,0,0,2,0,2,0.2857142857142857,1,0.0,0,0,0,0,0,0,0,2,0,0,2,1
1801,41454,zWECTl7pig27m6EXN2th2ITKXEX5E7bm,5X6FeZozNMgE2VRi3MJYjkkFK8SETtu2,40,115,26,45,39,5,13,1,244,34.857142857142854,4,0.0,78,26,34,39,37,5,11,13,1,177,67,1
1802,41543,mEZvWvBBGXXfy0WF2DjKoOVWnqlpKunY,5X6FeZozNMgE2VRi3MJYjkkFK8SETtu2,5,2,1,0,1,0,2,0,6,0.8571428571428571,1,0.0,0,1,0,1,2,0,0,2,0,2,4,1
1803,41576,096xYyhB9kL7G6lT7J9rVrXyGNwUToLF,5X6FeZozNMgE2VRi3MJYjkkFK8SETtu2,11,28,9,0,1,0,7,0,45,6.428571428571429,4,0.0,17,9,0,1,11,0,0,7,0,27,18,0
1804,41700,qGFsPZahffV69lg1cIg3IHQ7WbMNcFwi,5X6FeZozNMgE2VRi3MJYjkkFK8SETtu2,1,0,0,0,0,0,1,0,1,0.14285714285714285,1,0.0,0,0,0,0,0,0,0,1,0,0,1,1
1805,41732,b5exMMDqGOTUdj3bRJOK1OHepqmGIGuy,5X6FeZozNMgE2VRi3MJYjkkFK8SETtu2,7,3,2,0,2,0,2,0,9,1.2857142857142858,1,0.0,0,2,0,2,3,0,0,2,0,4,5,1
1806,41808,Qqy3TZdyBKfhf7zgHIRI72ZJ5QbTtpkb,5X6FeZozNMgE2VRi3MJYjkkFK8SETtu2,4,0,0,0,0,1,4,1,6,0.8571428571428571,1,0.0,0,0,0,0,0,1,0,4,1,0,6,1
1807,41852,7d4b3SNxdjjzi8g8AEaVqA0FYKHzinDf,5Gyp41oLVo7Gg7vF4vpmggWP5MU70QO6,4,2,1,0,1,0,1,0,5,0.7142857142857143,1,0.0,0,1,0,1,2,0,0,1,0,2,3,1
1808,41872,mFpiELMd2y5tbkdxs4m8pKS7gXHb7bIO,5Gyp41oLVo7Gg7vF4vpmggWP5MU70QO6,21,25,17,19,8,6,3,0,78,11.142857142857142,2,0.0,5,17,16,8,20,6,3,3,0,46,32,1
1809,41901,xtF1xbFnW4uDdF6Vg0b6lAnaZxcIz0Ve,5Gyp41oLVo7Gg7vF4vpmggWP5MU70QO6,28,61,45,12,23,0,14,0,155,22.142857142857142,4,0.0,3,45,9,23,58,0,3,14,0,80,75,1
1810,41914,v1AqHfMoNhUox9GyIOrxftKibIp07zrt,5Gyp41oLVo7Gg7vF4vpmggWP5MU70QO6,1,0,0,0,0,0,1,0,1,0.14285714285714285,1,0.0,0,0,0,0,0,0,0,1,0,0,1,1
1811,41919,6h7iIssCCu9aON4ETl9Y3uiCltL5Vdbt,5Gyp41oLVo7Gg7vF4vpmggWP5MU70QO6,5,2,1,0,0,0,3,0,6,0.8571428571428571,1,0.0,0,1,0,0,2,0,0,3,0,1,5,1
1812,41937,ZECsrQDWNf4nPUfo4HpZsLiXc2swEQ6q,5Gyp41oLVo7Gg7vF4vpmggWP5MU70QO6,12,16,8,0,4,2,6,1,37,5.285714285714286,3,0.0,5,8,0,4,11,2,0,6,1,17,20,1
1813,41941,yq5rHqpCTagxs6XCaAXxmCSySzn2U3u8,5Gyp41oLVo7Gg7vF4vpmggWP5MU70QO6,48,108,57,65,1,4,44,0,279,39.857142857142854,13,0.0,30,57,53,1,78,4,12,44,0,141,138,0
1814,41943,fd2e5NJVnyVwHFHuiTOOM639ZY1uThtn,5Gyp41oLVo7Gg7vF4vpmggWP5MU70QO6,49,118,53,39,21,93,29,4,357,51.0,9,0.0,37,53,30,21,81,93,9,29,4,141,216,0
1815,41961,f0sVZyDIDK6aEjBJcynnEa0a1FRP4E3Q,5Gyp41oLVo7Gg7vF4vpmggWP5MU70QO6,62,450,178,46,111,29,54,3,871,124.42857142857143,17,0.0,210,178,30,111,240,29,16,54,3,529,342,0
1816,41982,9bv4TssyKs6woXSaEFvigyhEyIkdO1mQ,5Gyp41oLVo7Gg7vF4vpmggWP5MU70QO6,32,97,50,18,20,56,35,8,284,40.57142857142857,11,0.0,19,50,13,20,78,56,5,35,8,102,182,1
1817,41990,QCeQLHdKBbgocZCY3ZvshdQQP5rGGQRl,5Gyp41oLVo7Gg7vF4vpmggWP5MU70QO6,1,0,0,0,0,0,1,0,1,0.14285714285714285,1,0.0,0,0,0,0,0,0,0,1,0,0,1,1
1818,41996,BJDnbFOtylN7pvasNOrTjNGeFmTJRbJY,5Gyp41oLVo7Gg7vF4vpmggWP5MU70QO6,32,87,35,21,20,168,27,2,360,51.42857142857143,10,0.0,24,35,14,20,63,168,7,27,2,93,267,0
1819,42034,W6MGFBQ1Tov9lOeRQ8QlzHUMCDNEGRDq,5Gyp41oLVo7Gg7vF4vpmggWP5MU70QO6,49,129,37,66,12,0,20,0,264,37.714285714285715,6,0.0,18,37,59,12,111,0,7,20,0,126,138,1
1820,42045,lx4ZbPAl8lgZM7WAQwN5AzxQuHINUnnn,5Gyp41oLVo7Gg7vF4vpmggWP5MU70QO6,1,0,0,0,0,0,1,0,1,0.14285714285714285,1,0.0,0,0,0,0,0,0,0,1,0,0,1,1
1821,42050,L4oP8uZsX378RlX4CoGsRHdcJ2TspQbn,5Gyp41oLVo7Gg7vF4vpmggWP5MU70QO6,13,17,8,4,4,0,10,0,43,6.142857142857143,3,0.0,5,8,2,4,12,0,2,10,0,19,24,1
1822,42051,xh6Z87zHYO5TmTHmULL6ExXhMxQxPAzM,5Gyp41oLVo7Gg7vF4vpmggWP5MU70QO6,6,2,1,0,1,0,4,1,9,1.2857142857142858,1,0.0,0,1,0,1,2,0,0,4,1,2,7,1
1823,42054,DTdnrUWYQy6SZeB3v1jpsLGbeokB7hvq,5Gyp41oLVo7Gg7vF4vpmggWP5MU70QO6,14,7,6,6,4,3,6,1,33,4.714285714285714,1,0.0,1,6,3,4,6,3,3,6,1,14,19,1
1824,42059,fECdKG9engCN4PBWVnIUSeu4ChydnH9z,5Gyp41oLVo7Gg7vF4vpmggWP5MU70QO6,1,0,0,0,0,0,1,0,1,0.14285714285714285,1,0.0,0,0,0,0,0,0,0,1,0,0,1,1
1825,42096,HLBGWKgO3KQzLSRnEwchUSbXffZaQqeI,5Gyp41oLVo7Gg7vF4vpmggWP5MU70QO6,10,12,5,0,3,1,8,0,29,4.142857142857143,3,0.0,1,5,0,3,11,1,0,8,0,9,20,1
1826,42114,92weGHcUONTaSKRvvp9KGrCydTp17laF,5Gyp41oLVo7Gg7vF4vpmggWP5MU70QO6,1,0,0,0,0,0,1,0,1,0.14285714285714285,1,0.0,0,0,0,0,0,0,0,1,0,0,1,1
1827,42116,QM2QMYgltxQbwQVbv1JDjhjnw8gL0lR3,5Gyp41oLVo7Gg7vF4vpmggWP5MU70QO6,1,0,0,0,0,0,1,0,1,0.14285714285714285,1,0.0,0,0,0,0,0,0,0,1,0,0,1,1
1828,42149,p97VEQO2qWZmGa3xI7ijdv1FZbQKFwFm,5Gyp41oLVo7Gg7vF4vpmggWP5MU70QO6,5,3,1,0,1,0,1,0,6,0.8571428571428571,1,0.0,0,1,0,1,3,0,0,1,0,2,4,1
1829,42177,FbFzxcgOenGEHKMXxCSjDnrIiqrr6PFf,5Gyp41oLVo7Gg7vF4vpmggWP5MU70QO6,12,8,6,0,3,0,3,0,20,2.857142857142857,2,0.0,0,6,0,3,8,0,0,3,0,9,11,1
1830,42183,cRBP8bFCVMf6rvRdef3FrHPLSFuaFxMf,5Gyp41oLVo7Gg7vF4vpmggWP5MU70QO6,8,8,5,0,3,0,2,0,18,2.5714285714285716,2,0.0,1,5,0,3,7,0,0,2,0,9,9,1
1831,42274,pT3VeIuIzx4VMyEDCdSdiiTQryYF6ywz,5Gyp41oLVo7Gg7vF4vpmggWP5MU70QO6,6,4,2,0,1,0,4,0,11,1.5714285714285714,1,0.0,0,2,0,1,4,0,0,4,0,3,8,1
1832,42283,coeWNI3IAD901oWcF5eFxb3gewasuU9G,5Gyp41oLVo7Gg7vF4vpmggWP5MU70QO6,37,148,38,0,52,0,9,0,247,35.285714285714285,3,0.0,44,38,0,52,104,0,0,9,0,134,113,1
1833,42292,fo11APiMDJF2DjuYtDFoBE2X6zRUvD0O,5Gyp41oLVo7Gg7vF4vpmggWP5MU70QO6,24,78,40,34,1,0,26,0,179,25.571428571428573,7,0.0,21,40,26,1,57,0,8,26,0,88,91,0
1834,42351,Ov4skeGBwbiO8tM202AvGyzidAgLuRFD,5Gyp41oLVo7Gg7vF4vpmggWP5MU70QO6,1,0,0,0,0,0,2,0,2,0.2857142857142857,2,0.0,0,0,0,0,0,0,0,2,0,0,2,1
1835,42372,voXfmBYgeQMvGbDBGbeoknkDIyLOK6Zz,5Gyp41oLVo7Gg7vF4vpmggWP5MU70QO6,33,70,35,30,4,4,12,1,156,22.285714285714285,5,0.0,33,35,15,4,37,4,15,12,1,87,69,1
1836,42443,95wnVruHwJbQJ8XTksUIsLyn3QwBy0na,5Gyp41oLVo7Gg7vF4vpmggWP5MU70QO6,10,12,6,0,2,2,4,1,27,3.857142857142857,1,0.0,2,6,0,2,10,2,0,4,1,10,17,1
1837,42492,F5WXvUA8z1Vfdvlva1pujweut7tGE04r,5Gyp41oLVo7Gg7vF4vpmggWP5MU70QO6,5,1,1,0,1,0,7,0,10,1.4285714285714286,3,0.0,0,1,0,1,1,0,0,7,0,2,8,0
1838,42517,1fleh7lPd7aghMITlPRITTq0TKiljgoj,5Gyp41oLVo7Gg7vF4vpmggWP5MU70QO6,6,1,1,0,1,0,3,0,6,0.8571428571428571,1,0.0,0,1,0,1,1,0,0,3,0,2,4,0
1839,42545,16IaVArf7HDzubrwCdp5gqSN8A4lsrys,5Gyp41oLVo7Gg7vF4vpmggWP5MU70QO6,1,0,0,0,0,0,1,0,1,0.14285714285714285,1,0.0,0,0,0,0,0,0,0,1,0,0,1,1
1840,42548,1nSBEgn3dOnqesibXizOKGsR7hL9hjON,5Gyp41oLVo7Gg7vF4vpmggWP5MU70QO6,1,0,0,0,0,0,1,0,1,0.14285714285714285,1,0.0,0,0,0,0,0,0,0,1,0,0,1,1
1841,42604,VN7mIYOy9t6d92ozIKhBx0dLnBa4IRt3,5Gyp41oLVo7Gg7vF4vpmggWP5MU70QO6,16,38,21,3,7,1,16,0,86,12.285714285714286,6,0.0,9,21,1,7,29,1,2,16,0,38,48,0
1842,42641,EJ32Am2qz9sXqSHBy8iFLimLcPtCtc2g,5Gyp41oLVo7Gg7vF4vpmggWP5MU70QO6,11,16,7,0,4,0,8,0,35,5.0,3,0.0,0,7,0,4,16,0,0,8,0,11,24,1
1843,42663,MqQtReyruUVIU2LCfa5IIMpo9Hk5W0pq,5Gyp41oLVo7Gg7vF4vpmggWP5MU70QO6,3,0,0,0,0,0,3,0,3,0.42857142857142855,1,0.0,0,0,0,0,0,0,0,3,0,0,3,1
1844,42695,gKCfVXJeSOrE1xgSflOmwDFTFpuPrSlq,5Gyp41oLVo7Gg7vF4vpmggWP5MU70QO6,3,0,0,0,0,0,8,0,8,1.1428571428571428,3,0.0,0,0,0,0,0,0,0,8,0,0,8,1
1845,42759,RiuaU3j9glvJbW4ph026KXgBcE6tugPM,5Gyp41oLVo7Gg7vF4vpmggWP5MU70QO6,26,67,1,2,0,15,11,1,97,13.857142857142858,8,0.0,3,1,2,0,64,15,0,11,1,6,91,0
1846,42778,AQEdyfxMIDbf98PU42NTmTHCLAkjalfX,5Gyp41oLVo7Gg7vF4vpmggWP5MU70QO6,30,73,33,35,31,0,28,2,202,28.857142857142858,8,0.0,16,33,27,31,57,0,8,28,2,107,95,1
1847,42804,RFxR0SFPPvCWJDegU9vXnrDZ6RWwU07I,5Gyp41oLVo7Gg7vF4vpmggWP5MU70QO6,12,6,5,0,4,0,2,0,17,2.4285714285714284,1,0.0,0,5,0,4,6,0,0,2,0,9,8,1
1848,42847,sMynuMhoZTpmWI7JIgM7Zcgv9Nw77yWq,5Gyp41oLVo7Gg7vF4vpmggWP5MU70QO6,15,26,8,0,12,4,3,0,53,7.571428571428571,3,0.0,15,8,0,12,11,4,0,3,0,35,18,1
1849,42849,QBJjc55FhlsfcHHPW6AJvjfSIeMCCMEA,5Gyp41oLVo7Gg7vF4vpmggWP5MU70QO6,47,207,107,14,55,55,100,16,554,79.14285714285714,6,0.0,55,107,7,55,152,55,7,100,16,224,330,0
1850,42879,G5JFEd58i47FiqQxatEMibk5NL9uoQb2,5Gyp41oLVo7Gg7vF4vpmggWP5MU70QO6,5,32,25,0,1,0,2,0,60,8.571428571428571,10,0.0,0,25,0,1,32,0,0,2,0,26,34,1
1851,42886,YvjOOH17h0dXnr4Jwtv0jh1sSu9lkIZ7,5Gyp41oLVo7Gg7vF4vpmggWP5MU70QO6,7,3,2,0,2,0,2,0,9,1.2857142857142858,1,0.0,0,2,0,2,3,0,0,2,0,4,5,1
1852,42890,o6LWaGPsxwJxS9EHFcEz9dTihcviVEZr,5Gyp41oLVo7Gg7vF4vpmggWP5MU70QO6,29,19,16,0,10,0,12,1,58,8.285714285714286,2,0.0,2,16,0,10,17,0,0,12,1,28,30,0
1853,42910,kNaRHbDUPinoBQZENYvK7XkUGi7EGGIq,5Gyp41oLVo7Gg7vF4vpmggWP5MU70QO6,1,0,0,0,0,0,1,0,1,0.14285714285714285,1,0.0,0,0,0,0,0,0,0,1,0,0,1,1
1854,42937,r0Dep3QHNNWSPLkR08tICGVj5Fu7r77t,5Gyp41oLVo7Gg7vF4vpmggWP5MU70QO6,16,22,12,20,8,5,5,0,72,10.285714285714286,3,0.0,5,12,13,8,17,5,7,5,0,38,34,1
1855,42953,7SKW5Orp373hN42axMDs0xsTTPv4lnRr,5Gyp41oLVo7Gg7vF4vpmggWP5MU70QO6,5,3,0,0,1,0,2,0,6,0.8571428571428571,1,0.0,0,0,0,1,3,0,0,2,0,1,5,1
1856,43017,2uoMQOxqyRzmIYFGnyAflqy5t44QW2xE,5Gyp41oLVo7Gg7vF4vpmggWP5MU70QO6,16,16,9,0,6,0,11,1,43,6.142857142857143,4,0.0,1,9,0,6,15,0,0,11,1,16,27,1
1857,43048,a3dzyTdn4now8y79XAfczGTWvF7aosfb,5Gyp41oLVo7Gg7vF4vpmggWP5MU70QO6,8,11,3,0,3,1,7,0,25,3.5714285714285716,2,0.0,4,3,0,3,7,1,0,7,0,10,15,1
1858,43065,IYu26HWwnsP56tFrQgfK192g0xDPZe1A,5Gyp41oLVo7Gg7vF4vpmggWP5MU70QO6,10,22,13,0,9,2,18,0,64,9.142857142857142,5,0.0,1,13,0,9,21,2,0,18,0,23,41,1
1859,43141,9qWqwR5w0yLR2UZuxUx8CDb7A7u6scn0,5Gyp41oLVo7Gg7vF4vpmggWP5MU70QO6,52,130,53,33,26,0,17,0,259,37.0,9,0.0,47,53,31,26,83,0,2,17,0,157,102,0
1860,43205,DKfxzcRdq8FKoADcuGRfLXk0rRDap8VU,5Gyp41oLVo7Gg7vF4vpmggWP5MU70QO6,6,4,3,0,1,0,3,0,11,1.5714285714285714,1,0.0,0,3,0,1,4,0,0,3,0,4,7,1
1861,43264,Ox4dr3G3uxC6QxBwSIKQ4VzVwJeV3qcV,5Gyp41oLVo7Gg7vF4vpmggWP5MU70QO6,7,4,2,0,3,0,2,0,11,1.5714285714285714,1,0.0,1,2,0,3,3,0,0,2,0,6,5,1
1862,43320,ZNcLOAJ2r3H5DqhbGk1CiPtwI7ixaCeK,5Gyp41oLVo7Gg7vF4vpmggWP5MU70QO6,26,56,26,0,29,0,7,0,118,16.857142857142858,7,0.0,21,26,0,29,35,0,0,7,0,76,42,0
1863,43327,cN6OZq4ak5IqzN7Lw32XLOS12DhlWO8Q,5Gyp41oLVo7Gg7vF4vpmggWP5MU70QO6,50,205,106,78,59,142,36,20,646,92.28571428571429,8,0.0,73,106,52,59,132,142,26,36,20,290,356,0
1864,43337,T9uDhME1dGR0Q6Kbd7JPvChNdx9zfhaO,5Gyp41oLVo7Gg7vF4vpmggWP5MU70QO6,12,18,4,0,5,2,6,0,35,5.0,4,0.0,2,4,0,5,16,2,0,6,0,11,24,1
1865,43354,AXWWqNDiRDejTjo5V7yUaMbjtzXKhlP0,5Gyp41oLVo7Gg7vF4vpmggWP5MU70QO6,17,34,19,5,6,15,13,0,92,13.142857142857142,6,0.0,4,19,3,6,30,15,2,13,0,32,60,0
1866,43358,F2owRK2SDPW5FCDK4TxmBVHsTtJ44Nxq,5Gyp41oLVo7Gg7vF4vpmggWP5MU70QO6,10,18,6,0,2,0,7,0,33,4.714285714285714,4,0.0,0,6,0,2,18,0,0,7,0,8,25,0
1867,43393,OkJ0lKmMXuQ2MGftQ8Isfw1JciMpapRC,3VkHkmOtom3jM2wCu94xgzzu1d6Dn7or,5,4,1,0,1,0,2,0,8,1.1428571428571428,2,0.0,0,1,0,1,4,0,0,2,0,2,6,0
1868,43396,kg8jNAL6XWkd0183giUa3Jrg1KPQArtq,3VkHkmOtom3jM2wCu94xgzzu1d6Dn7or,1,0,0,0,0,0,1,0,1,0.14285714285714285,1,0.0,0,0,0,0,0,0,0,1,0,0,1,1
1869,43403,s6iksgptFmyh2vfiarKdJkiKnp6RLi3f,3VkHkmOtom3jM2wCu94xgzzu1d6Dn7or,23,51,17,2,10,123,65,3,271,38.714285714285715,15,0.0,6,17,2,10,45,123,0,65,3,35,236,1
1870,43421,zBnztQ47zRqd4YOqbZ7Bu4GeZ14n28YJ,3VkHkmOtom3jM2wCu94xgzzu1d6Dn7or,23,65,36,0,6,136,26,66,335,47.857142857142854,17,0.0,7,36,0,6,58,136,0,26,66,49,286,0
1871,43424,HRl1WtPVy480F3Uj29p44N7x6MhEkdO9,3VkHkmOtom3jM2wCu94xgzzu1d6Dn7or,7,5,3,0,0,3,7,0,18,2.5714285714285716,1,0.0,0,3,0,0,5,3,0,7,0,3,15,1
1872,43455,xePL2kxKaHs0bBt3C0iPKQ07cHzaWqkv,3VkHkmOtom3jM2wCu94xgzzu1d6Dn7or,1,0,0,0,0,0,1,0,1,0.14285714285714285,1,0.0,0,0,0,0,0,0,0,1,0,0,1,0
1873,43485,bHQY2mMklvQ96laeCvMnjAaOQZ9Z2fPl,5Gyp41oLVo7Gg7vF4vpmggWP5MU70QO6,1,0,0,0,0,0,1,0,1,0.14285714285714285,1,0.0,0,0,0,0,0,0,0,1,0,0,1,1
1874,43504,HafUKAP7RZbyh0jr3nHP7uNe6aFcE0ez,5Gyp41oLVo7Gg7vF4vpmggWP5MU70QO6,15,13,9,7,5,26,18,1,79,11.285714285714286,3,0.0,3,9,5,5,10,26,2,18,1,22,57,1
1875,43551,EIVlhBzHfz8g1ct2tpEW2E3ZS1tK3zYR,5Gyp41oLVo7Gg7vF4vpmggWP5MU70QO6,11,13,8,0,2,0,3,0,26,3.7142857142857144,3,0.0,0,8,0,2,13,0,0,3,0,10,16,1
1876,43565,6psynBJggS27dEPXlSIkWTKXOmBHQev3,5Gyp41oLVo7Gg7vF4vpmggWP5MU70QO6,1,0,0,0,0,0,1,0,1,0.14285714285714285,1,0.0,0,0,0,0,0,0,0,1,0,0,1,1
1877,43577,OZ02Yntpt8Hg8thsFgejT4NSsPYtVPPm,5Gyp41oLVo7Gg7vF4vpmggWP5MU70QO6,15,17,11,0,2,6,8,1,45,6.428571428571429,3,0.0,2,11,0,2,15,6,0,8,1,15,30,0
1878,43601,QRnkoghgCrSC0XTwYvvkCebLikYjnOiH,5Gyp41oLVo7Gg7vF4vpmggWP5MU70QO6,13,10,7,0,4,0,6,0,27,3.857142857142857,3,0.0,0,7,0,4,10,0,0,6,0,11,16,1
1879,43606,osZvJiYa9aDEaQ0aoDErqlo32Q2tqr88,5Gyp41oLVo7Gg7vF4vpmggWP5MU70QO6,7,3,2,0,2,0,3,0,10,1.4285714285714286,2,0.0,0,2,0,2,3,0,0,3,0,4,6,1
1880,43623,rc6SQY1f7UMU2z1RqzTVgOSasulrCJ3h,5Gyp41oLVo7Gg7vF4vpmggWP5MU70QO6,14,18,10,5,4,3,6,1,47,6.714285714285714,2,0.0,3,10,3,4,15,3,2,6,1,20,27,1
1881,43653,79QUI05RY9ZPkyZ2QTF4ldf0I0DmjbaG,7GRhBDsirIGkRZBtSMEzNTyDr2JQm4xx,10,13,10,0,5,2,5,0,35,5.0,2,0.0,0,10,0,5,13,2,0,5,0,15,20,1
1882,43659,TuM6W4EyKz1gShBWtvBuMmOw1xwF4xlS,7GRhBDsirIGkRZBtSMEzNTyDr2JQm4xx,6,8,4,0,4,2,3,0,21,3.0,2,0.0,2,4,0,4,6,2,0,3,0,10,11,0
1883,43667,YwEhgJrFq2w9QJl2yCPd9xaL0Uk6VujF,7GRhBDsirIGkRZBtSMEzNTyDr2JQm4xx,9,2,1,14,0,0,10,0,27,3.857142857142857,1,0.0,1,1,13,0,1,0,1,10,0,15,12,0
1884,43672,tCqgfXrL2rXAh5RJpLuMHSLSRwrclyuQ,7GRhBDsirIGkRZBtSMEzNTyDr2JQm4xx,11,22,8,10,1,0,1,0,42,6.0,2,0.0,5,8,9,1,17,0,1,1,0,23,19,0
1885,43674,zkqKiyV6OvwyKPkyCN37KC4hTRCpZYCH,7GRhBDsirIGkRZBtSMEzNTyDr2JQm4xx,5,3,2,0,1,0,1,0,7,1.0,1,0.0,0,2,0,1,3,0,0,1,0,3,4,0
1886,43685,Up0igPeMCPcrrFPZ1HsfM8Bq5rwAfYwv,7GRhBDsirIGkRZBtSMEzNTyDr2JQm4xx,7,8,3,0,1,0,2,0,14,2.0,2,0.0,2,3,0,1,6,0,0,2,0,6,8,0
1887,43689,E32xhKZZWx3RSJgehFSxMt99fqnIjiGq,7GRhBDsirIGkRZBtSMEzNTyDr2JQm4xx,17,25,1,12,1,0,1,0,40,5.714285714285714,1,0.0,11,1,6,1,14,0,6,1,0,19,21,1
1888,43697,ta4rrlwAs90RPkpFC9k1ckRd8n8Nkgxn,7GRhBDsirIGkRZBtSMEzNTyDr2JQm4xx,6,1,1,0,1,0,3,0,6,0.8571428571428571,1,0.0,0,1,0,1,1,0,0,3,0,2,4,1
1889,43700,z4NoXHrcgkhn7BypZflRO6Tgobh52UXj,7GRhBDsirIGkRZBtSMEzNTyDr2JQm4xx,31,36,13,36,18,0,5,0,108,15.428571428571429,2,0.0,20,13,23,18,16,0,13,5,0,74,34,0
1890,43709,3FE77xUt9GRriuZnel52RMR4IDPpAzkP,7GRhBDsirIGkRZBtSMEzNTyDr2JQm4xx,1,0,0,0,0,0,1,0,1,0.14285714285714285,1,0.0,0,0,0,0,0,0,0,1,0,0,1,1
1891,43713,KjugBA6V5bkEA5fAIbJoGnSUlDhZoaIH,7GRhBDsirIGkRZBtSMEzNTyDr2JQm4xx,22,45,7,22,4,0,9,0,87,12.428571428571429,4,0.0,19,7,18,4,26,0,4,9,0,48,39,0
1892,43719,PmDYoqv5aFPg9sMLkKbqOq2AMGxS1MTS,7GRhBDsirIGkRZBtSMEzNTyDr2JQm4xx,1,0,0,0,0,0,1,0,1,0.14285714285714285,1,0.0,0,0,0,0,0,0,0,1,0,0,1,1
1893,43726,kdSq236IYQMsCu2OjWxBROoAPTYOBg4Z,7GRhBDsirIGkRZBtSMEzNTyDr2JQm4xx,1,0,0,0,0,0,1,0,1,0.14285714285714285,1,0.0,0,0,0,0,0,0,0,1,0,0,1,1
1894,43732,0OpVcmwG6bVPxKzOCpgJ9F6MfBtuGolr,7GRhBDsirIGkRZBtSMEzNTyDr2JQm4xx,1,0,0,0,0,0,2,0,2,0.2857142857142857,1,0.0,0,0,0,0,0,0,0,2,0,0,2,1
1895,43739,U8C1raMgKT2mT8ZLyOUP6V5o8qd1qKWo,7GRhBDsirIGkRZBtSMEzNTyDr2JQm4xx,6,2,1,0,1,2,3,0,9,1.2857142857142858,1,0.0,0,1,0,1,2,2,0,3,0,2,7,1
1896,43740,e117XIPebSFWPuYXHTMQJ6xgFjjQ6u7z,7GRhBDsirIGkRZBtSMEzNTyDr2JQm4xx,7,2,1,0,1,0,8,0,12,1.7142857142857142,1,0.0,0,1,0,1,2,0,0,8,0,2,10,1
1897,44015,NHPpKvbnrSpxM8e1DORBWJbRCpmrxZw8,fbPkOYLVPtPgIt0MxizjfFJov3JbHyAi,6,3,2,0,1,4,2,0,12,1.7142857142857142,1,0.0,0,2,0,1,3,4,0,2,0,3,9,1
1898,44024,LeyaS1WvDVnHnV6ZSeQmCJao8bkVjN1j,fbPkOYLVPtPgIt0MxizjfFJov3JbHyAi,14,10,7,0,5,0,5,0,27,3.857142857142857,1,0.0,0,7,0,5,10,0,0,5,0,12,15,1
1899,44119,hp1PeKFcESsUtrkTKF98ATmX1KKCPvia,fbPkOYLVPtPgIt0MxizjfFJov3JbHyAi,25,30,15,25,13,23,1,0,107,15.285714285714286,1,0.0,14,15,22,13,16,23,3,1,0,64,43,0
1900,44131,dzaUNwKZy91BtYj96fOhuSgIlp9lXQDU,fbPkOYLVPtPgIt0MxizjfFJov3JbHyAi,27,34,21,16,7,7,6,0,91,13.0,3,0.0,7,21,15,7,27,7,1,6,0,50,41,0
1901,44173,kNdT4Mob6J1VkdvqbhmS4aPzbDLqNeYP,fbPkOYLVPtPgIt0MxizjfFJov3JbHyAi,6,3,2,0,1,0,2,0,8,1.1428571428571428,1,0.0,0,2,0,1,3,0,0,2,0,3,5,1
1902,44259,v5DL1tRN6AvAeQThFmEHNCo6sn5M6uIG,fbPkOYLVPtPgIt0MxizjfFJov3JbHyAi,9,15,6,3,4,2,3,0,33,4.714285714285714,1,0.0,7,6,3,4,8,2,0,3,0,20,13,1
1903,44294,RTkGQ4UmTL2ed98p2vxbPQoTurdG2SAC,fbPkOYLVPtPgIt0MxizjfFJov3JbHyAi,9,8,5,0,3,0,3,0,19,2.7142857142857144,1,0.0,0,5,0,3,8,0,0,3,0,8,11,1
1904,44309,LLsy8k18PLzqaAWgeu3HZsydISuZ18ow,fbPkOYLVPtPgIt0MxizjfFJov3JbHyAi,9,6,3,2,2,0,1,0,14,2.0,2,0.0,1,3,2,2,5,0,0,1,0,8,6,1
1905,45530,BQi6o3YIDMuHZg7pBKL2EQvhTIhuaxJ1,RXDvfPUBYFlVdlueBFbLW0mhhAyGEqpt,14,17,3,0,2,0,5,0,27,3.857142857142857,3,0.0,0,3,0,2,17,0,0,5,0,5,22,1
1906,46068,H3iVkRV8UPZvsbvYrU1dnbX51IlHemsF,RXDvfPUBYFlVdlueBFbLW0mhhAyGEqpt,4,3,1,0,0,0,1,0,5,0.7142857142857143,1,0.0,0,1,0,0,3,0,0,1,0,1,4,0
1907,46437,TOrqBZDp9GjgXoTZI9iOS0r8wbO7CyB1,RXDvfPUBYFlVdlueBFbLW0mhhAyGEqpt,10,6,5,0,4,4,0,0,19,2.7142857142857144,2,0.0,0,5,0,4,6,4,0,0,0,9,10,0
1908,46479,xSwC5YVwlqQI12zsRbCFcdEzFRC8jvLt,fbPkOYLVPtPgIt0MxizjfFJov3JbHyAi,14,23,1,5,0,0,2,0,31,4.428571428571429,1,0.0,10,1,4,0,13,0,1,2,0,15,16,1
1909,46509,wUS4QMZENKgcJOovrFGfoZniw3fDJWWg,fbPkOYLVPtPgIt0MxizjfFJov3JbHyAi,7,5,3,0,1,0,4,0,13,1.8571428571428572,2,0.0,1,3,0,1,4,0,0,4,0,5,8,0
1910,46661,o7nB1nybhMcFgLy31X3R6RDOK94b1Iaa,5Gyp41oLVo7Gg7vF4vpmggWP5MU70QO6,8,9,3,0,2,0,5,0,19,2.7142857142857144,3,0.0,0,3,0,2,9,0,0,5,0,5,14,1
1911,46664,QUziVS4xrQYwYNmSVfW4Gr6JhKHA7cng,5Gyp41oLVo7Gg7vF4vpmggWP5MU70QO6,6,2,1,0,2,0,3,0,8,1.1428571428571428,1,0.0,1,1,0,2,1,0,0,3,0,4,4,1
1912,46698,6Gh3ATf3p6EBV7qTZIQP6wSoiBFYiazs,5Gyp41oLVo7Gg7vF4vpmggWP5MU70QO6,1,0,0,0,0,0,2,0,2,0.2857142857142857,2,0.0,0,0,0,0,0,0,0,2,0,0,2,1
1913,46737,6TxDc7fD2fI8AN5IlU88vTpwWW8nL4ZZ,5Gyp41oLVo7Gg7vF4vpmggWP5MU70QO6,12,28,11,0,4,0,9,0,52,7.428571428571429,2,0.0,0,11,0,4,28,0,0,9,0,15,37,1
1914,46765,htY6bwn9PbTbKM6i8WPOSsPcKrupS5Q1,5Gyp41oLVo7Gg7vF4vpmggWP5MU70QO6,1,0,0,0,0,0,1,0,1,0.14285714285714285,1,0.0,0,0,0,0,0,0,0,1,0,0,1,1
1915,46768,vpbGg04otyd7XcBF7UVpzyiov8ktcq0f,5Gyp41oLVo7Gg7vF4vpmggWP5MU70QO6,1,0,0,0,0,0,1,0,1,0.14285714285714285,1,0.0,0,0,0,0,0,0,0,1,0,0,1,1
1916,46794,ByDjTuY0oLVzrle7JgW0XGlu5bLAo5Uj,5Gyp41oLVo7Gg7vF4vpmggWP5MU70QO6,30,90,46,13,23,46,35,2,255,36.42857142857143,15,0.0,18,46,10,23,72,46,3,35,2,97,158,1
1917,46822,YFuusgPWJ2SCmrCsLMI6TFGMGcuGX75Z,5Gyp41oLVo7Gg7vF4vpmggWP5MU70QO6,1,0,0,0,0,0,2,0,2,0.2857142857142857,2,0.0,0,0,0,0,0,0,0,2,0,0,2,1
1918,46837,iX8db0h4bK73Weo8AP1BXtlfn6xSOf6w,5Gyp41oLVo7Gg7vF4vpmggWP5MU70QO6,15,28,11,12,7,40,10,0,108,15.428571428571429,2,0.0,12,11,6,7,16,40,6,10,0,36,72,0
1919,46847,6kTNzUuSYm6xoi9ZsoRODiZYLMX87MvV,5Gyp41oLVo7Gg7vF4vpmggWP5MU70QO6,1,0,0,0,0,0,1,0,1,0.14285714285714285,1,0.0,0,0,0,0,0,0,0,1,0,0,1,1
1920,46919,2uLHED4iY9VmLy5RW7Mfy2sLsR8ze3u7,5Gyp41oLVo7Gg7vF4vpmggWP5MU70QO6,8,8,1,0,1,0,6,0,16,2.2857142857142856,2,0.0,0,1,0,1,8,0,0,6,0,2,14,1
1921,46948,bUUHjOrv9lYLGdFvQvIJrOvIH31QCvbc,5Gyp41oLVo7Gg7vF4vpmggWP5MU70QO6,8,5,3,0,2,0,3,0,13,1.8571428571428572,2,0.0,0,3,0,2,5,0,0,3,0,5,8,0
1922,46961,4svUc6E37y245S00EaI9qAs0H0nzXOuh,5Gyp41oLVo7Gg7vF4vpmggWP5MU70QO6,8,18,6,0,1,7,7,0,39,5.571428571428571,4,0.0,0,6,0,1,18,7,0,7,0,7,32,1
1923,46964,aq6RzL3Xg5EYCsH3vPkd60PgfB0ApzuH,5Gyp41oLVo7Gg7vF4vpmggWP5MU70QO6,20,20,9,38,0,0,2,0,69,9.857142857142858,2,0.0,8,9,28,0,12,0,10,2,0,45,24,1
1924,46980,YGd4irzc5KMR1PH2KdOtbCkghLMZ2dPk,5Gyp41oLVo7Gg7vF4vpmggWP5MU70QO6,13,23,9,4,6,0,13,0,55,7.857142857142857,6,0.0,10,9,2,6,13,0,2,13,0,27,28,1
1925,46997,AzXEcnexrLYeOcX5AxPYhxZ1Dd0ERW2m,5Gyp41oLVo7Gg7vF4vpmggWP5MU70QO6,9,11,7,2,4,1,2,0,27,3.857142857142857,2,0.0,2,7,1,4,9,1,1,2,0,14,13,1
1926,47055,AtIH4YI3eYIPCQxtOLtZgwyhSnXOdn2e,5Gyp41oLVo7Gg7vF4vpmggWP5MU70QO6,15,19,11,0,7,0,11,1,49,7.0,2,0.0,1,11,0,7,18,0,0,11,1,19,30,0
1927,47087,VJF9Wd2OOsxD5fVkB2g1Pjv9fzWYEV2v,5Gyp41oLVo7Gg7vF4vpmggWP5MU70QO6,12,11,7,0,5,3,11,2,39,5.571428571428571,1,0.0,1,7,0,5,10,3,0,11,2,13,26,1
1928,47132,nC6UOgoIicf8pr79f2rdG7NgUQiopW9Q,5Gyp41oLVo7Gg7vF4vpmggWP5MU70QO6,11,13,7,0,5,0,6,0,31,4.428571428571429,5,0.0,0,7,0,5,13,0,0,6,0,12,19,1
1929,47179,0pGeUoaCZ47IZ5k3CgcpVvZsDT3jBkhR,5Gyp41oLVo7Gg7vF4vpmggWP5MU70QO6,1,0,0,0,0,0,1,0,1,0.14285714285714285,1,0.0,0,0,0,0,0,0,0,1,0,0,1,1
1930,47194,lKIuwUNGHfNRCFJGM4oJVNYNDuHHcNkj,5Gyp41oLVo7Gg7vF4vpmggWP5MU70QO6,1,0,0,0,0,0,1,0,1,0.14285714285714285,1,0.0,0,0,0,0,0,0,0,1,0,0,1,1
1931,47238,kC7JLQowN0BSKnzXXKRn5vuXi1nnM0dA,5Gyp41oLVo7Gg7vF4vpmggWP5MU70QO6,1,0,0,0,0,0,1,0,1,0.14285714285714285,1,0.0,0,0,0,0,0,0,0,1,0,0,1,1
1932,47273,oCCIMS9TsKBtXrDfjAHhMW7YOC3o0In0,5Gyp41oLVo7Gg7vF4vpmggWP5MU70QO6,8,7,3,0,4,1,3,0,18,2.5714285714285716,2,0.0,2,3,0,4,5,1,0,3,0,9,9,1
1933,47298,Xi5jJx0Z2MOBm1fPpYwlvuzwElYhyszd,5Gyp41oLVo7Gg7vF4vpmggWP5MU70QO6,8,9,2,2,0,0,6,0,19,2.7142857142857144,4,0.0,0,2,1,0,9,0,1,6,0,3,16,1
1934,47310,OX9vhsWD6JWYlhteOhuS18578YVCyA0P,5Gyp41oLVo7Gg7vF4vpmggWP5MU70QO6,8,5,2,6,1,0,3,0,17,2.4285714285714284,1,0.0,2,2,3,1,3,0,3,3,0,8,9,1
1935,47324,BLOM2xPWAdh8xbTkgox63v8VU5UwaQgE,5Gyp41oLVo7Gg7vF4vpmggWP5MU70QO6,29,85,36,7,11,26,22,4,191,27.285714285714285,9,0.0,18,36,5,11,67,26,2,22,4,70,121,0
1936,47327,tq5rSafpJQn5saVcMLWCPKYcu2G69rbK,5Gyp41oLVo7Gg7vF4vpmggWP5MU70QO6,1,0,0,0,0,0,1,0,1,0.14285714285714285,1,0.0,0,0,0,0,0,0,0,1,0,0,1,1
1937,47370,NHPpKvbnrSpxM8e1DORBWJbRCpmrxZw8,5Gyp41oLVo7Gg7vF4vpmggWP5MU70QO6,64,265,152,104,38,123,60,0,742,106.0,17,0.0,59,152,92,38,206,123,12,60,0,341,401,0
1938,47408,ZN49F0EHMnIHNnexZhXG9gL1H8w3Wds6,5Gyp41oLVo7Gg7vF4vpmggWP5MU70QO6,14,12,5,6,2,2,7,1,35,5.0,1,0.0,5,5,3,2,7,2,3,7,1,15,20,1
1939,47449,6pDumvu8BZSGMSLuGPFtyDgiupPPSlqU,5Gyp41oLVo7Gg7vF4vpmggWP5MU70QO6,2,0,0,0,0,0,2,0,2,0.2857142857142857,1,0.0,0,0,0,0,0,0,0,2,0,0,2,1
1940,47488,IaQmpIIrLIlpbhmM5T9fAOSrDWknoNOg,5Gyp41oLVo7Gg7vF4vpmggWP5MU70QO6,15,26,11,14,4,16,12,0,83,11.857142857142858,2,0.0,10,11,7,4,16,16,7,12,0,32,51,1
1941,47500,BAafvt8EkPI2TrQ9EWOz7Ripfor4zZf6,5Gyp41oLVo7Gg7vF4vpmggWP5MU70QO6,11,5,3,2,2,52,5,0,69,9.857142857142858,2,0.0,1,3,1,2,4,52,1,5,0,7,62,1
1942,47509,GulRMWFcPY5JE8HNbJPRyRdVqJqL2eEA,5Gyp41oLVo7Gg7vF4vpmggWP5MU70QO6,53,137,53,68,32,19,32,1,342,48.857142857142854,11,0.0,41,53,63,32,96,19,5,32,1,189,153,0
1943,47538,dQweEcdBCmNmUPOeO7X4TTmH8zuMq2aJ,5Gyp41oLVo7Gg7vF4vpmggWP5MU70QO6,3,2,1,0,0,0,1,0,4,0.5714285714285714,1,0.0,0,1,0,0,2,0,0,1,0,1,3,1
1944,47555,Z8nVRi3NcoaJdLoyeCeCpGK9mlRKkx1Z,5Gyp41oLVo7Gg7vF4vpmggWP5MU70QO6,1,0,0,0,0,0,1,0,1,0.14285714285714285,1,0.0,0,0,0,0,0,0,0,1,0,0,1,1
1945,47556,A5njsag2BUpIwHbVkBfhIH4eOQjUBmSJ,5Gyp41oLVo7Gg7vF4vpmggWP5MU70QO6,19,49,23,18,8,8,19,0,125,17.857142857142858,6,0.0,13,23,12,8,36,8,6,19,0,56,69,1
1946,47590,jcXoYFaI9QPcliotiwIgOLeObkrSUvNn,5Gyp41oLVo7Gg7vF4vpmggWP5MU70QO6,6,2,1,0,1,0,5,0,9,1.2857142857142858,1,0.0,0,1,0,1,2,0,0,5,0,2,7,1
1947,47596,EFMEoi5W4mceo8rjft5LKrYvvT3E2eat,5Gyp41oLVo7Gg7vF4vpmggWP5MU70QO6,17,19,11,0,11,20,4,0,65,9.285714285714286,2,0.0,4,11,0,11,15,20,0,4,0,26,39,1
1948,47671,3FnNr9vIYZumFxJHz1azU06JI7Pm6hh3,5Gyp41oLVo7Gg7vF4vpmggWP5MU70QO6,7,9,5,0,3,0,4,0,21,3.0,3,0.0,0,5,0,3,9,0,0,4,0,8,13,1
1949,47691,Onp8u1IlkiXCdEq7Tg9xltw0KEKQAxrs,7GRhBDsirIGkRZBtSMEzNTyDr2JQm4xx,2,0,0,0,0,0,2,0,2,0.2857142857142857,1,0.0,0,0,0,0,0,0,0,2,0,0,2,1
1950,47695,GK9sxY4922aacfUwQrGGaZo1AzrN2tZV,7GRhBDsirIGkRZBtSMEzNTyDr2JQm4xx,2,0,0,0,0,0,2,0,2,0.2857142857142857,1,0.0,0,0,0,0,0,0,0,2,0,0,2,1
1951,47706,P59zgxkiZZAY4L2oDvB0C7gvcL7QBtyx,7GRhBDsirIGkRZBtSMEzNTyDr2JQm4xx,29,45,5,76,4,0,3,0,133,19.0,3,0.0,18,5,65,4,27,0,11,3,0,92,41,0
1952,47708,Kx0yh1NYg9bLebA77hJUfctp68sztPRl,7GRhBDsirIGkRZBtSMEzNTyDr2JQm4xx,1,0,0,0,0,0,1,0,1,0.14285714285714285,1,0.0,0,0,0,0,0,0,0,1,0,0,1,1
1953,47711,GH3PC1SBnD0QirB2kfSpXzY7ZEDaORGK,7GRhBDsirIGkRZBtSMEzNTyDr2JQm4xx,8,13,4,0,2,1,1,0,21,3.0,1,0.0,4,4,0,2,9,1,0,1,0,10,11,1
1954,47712,ilWzYGLWBh9DSc1MV8g2C4Go5wDNgUHX,7GRhBDsirIGkRZBtSMEzNTyDr2JQm4xx,8,8,4,4,1,2,2,0,21,3.0,2,0.0,2,4,2,1,6,2,2,2,0,9,12,1
1955,47719,yG8wEEmCuC5YTy4CQDGA5I639Z9JzSu0,7GRhBDsirIGkRZBtSMEzNTyDr2JQm4xx,9,8,3,0,3,0,2,0,16,2.2857142857142856,2,0.0,0,3,0,3,8,0,0,2,0,6,10,1
1956,47732,Zi0zviSNJjQgRnDqltYXCKQ56bOQDRq9,7GRhBDsirIGkRZBtSMEzNTyDr2JQm4xx,1,0,0,0,0,0,1,0,1,0.14285714285714285,1,0.0,0,0,0,0,0,0,0,1,0,0,1,1
1957,47737,kqS8BwWN9R1093oeblGkvtCsQJ68Gh0G,7GRhBDsirIGkRZBtSMEzNTyDr2JQm4xx,3,2,1,0,0,0,2,0,5,0.7142857142857143,1,0.0,0,1,0,0,2,0,0,2,0,1,4,1
1958,47772,mMS5utPEE0kau31EdquwgaN1e0nxF2V4,fbPkOYLVPtPgIt0MxizjfFJov3JbHyAi,3,2,1,0,0,0,1,0,4,0.5714285714285714,1,0.0,0,1,0,0,2,0,0,1,0,1,3,1
1959,47824,wwifhf2JKuRRsCekTCD33hbtOjxoHPnW,fbPkOYLVPtPgIt0MxizjfFJov3JbHyAi,4,3,2,0,0,11,2,0,18,2.5714285714285716,2,0.0,0,2,0,0,3,11,0,2,0,2,16,1
1960,47846,DUdBmTRQYTDfiJ48gpt3WzQELlnWqHAt,fbPkOYLVPtPgIt0MxizjfFJov3JbHyAi,5,4,3,0,0,7,1,0,15,2.142857142857143,2,0.0,0,3,0,0,4,7,0,1,0,3,12,1
1961,47850,EA93zC2FZSfWuUTy2fGF8qAEwUDl0X8s,fbPkOYLVPtPgIt0MxizjfFJov3JbHyAi,48,52,28,50,15,5,5,0,155,22.142857142857142,2,0.0,17,28,42,15,35,5,8,5,0,102,53,1
1962,47853,ZZRh21sVolimyM3CDUIIgG9cuzaZauji,fbPkOYLVPtPgIt0MxizjfFJov3JbHyAi,7,5,2,2,1,0,1,0,11,1.5714285714285714,1,0.0,1,2,2,1,4,0,0,1,0,6,5,1
1963,47894,Rz28tFT5qYZaEQ78Ly3OdJx8TpvsmLBy,bWdj2GDclj5ofokWjzoa5jAwMkxCykd6,15,11,0,50,0,14,5,0,80,11.428571428571429,2,0.0,2,0,47,0,9,14,3,5,0,49,31,0
1964,47900,t8SjYilFMTCG5Wi1o6mcbWFbM7fvPbYd,SpATywNh6bZuzm8s1ceuBUnMUAeoAHHw,30,45,22,7,14,23,6,1,118,16.857142857142858,4,0.0,17,22,7,14,28,23,0,6,1,60,58,0
1965,47911,rupuJPHZYcCjzgb5zuSbBK0ZcJQy8q7D,SpATywNh6bZuzm8s1ceuBUnMUAeoAHHw,1,0,0,0,0,0,1,0,1,0.14285714285714285,1,0.0,0,0,0,0,0,0,0,1,0,0,1,1
1966,47938,szUZ2QsyqJuXPgyS49q35y1kTVrrBlKT,SpATywNh6bZuzm8s1ceuBUnMUAeoAHHw,16,49,24,15,0,16,5,1,110,15.714285714285714,2,0.0,19,24,14,0,30,16,1,5,1,57,53,0
1967,48018,xecOK3aJ3hCti9mz2pAAcwSq9d1S8ATw,SpATywNh6bZuzm8s1ceuBUnMUAeoAHHw,14,27,1,13,1,0,6,0,48,6.857142857142857,1,0.0,10,1,12,1,17,0,1,6,0,24,24,0
1968,48041,SmONSyS4YgG4Afnv6ZxU81t7p4CQPV5P,bWdj2GDclj5ofokWjzoa5jAwMkxCykd6,5,9,4,0,2,1,3,0,19,2.7142857142857144,1,0.0,0,4,0,2,9,1,0,3,0,6,13,1
1969,48081,zCdZvanEH4w4mJiogg5VcFWhPxVyZDYs,RXDvfPUBYFlVdlueBFbLW0mhhAyGEqpt,30,30,19,50,14,0,4,0,117,16.714285714285715,3,0.0,7,19,48,14,23,0,2,4,0,88,29,0
1970,48093,23GFMJXBCJBMscnU5tVwAanleKYVql9b,SpATywNh6bZuzm8s1ceuBUnMUAeoAHHw,32,42,27,32,12,66,46,7,232,33.142857142857146,4,0.0,2,27,29,12,40,66,3,46,7,70,162,0
1971,48097,TsDe3YkshVWrWCP25fGXNXAufSbXrOSR,SpATywNh6bZuzm8s1ceuBUnMUAeoAHHw,6,2,1,0,1,1,4,0,9,1.2857142857142858,1,0.0,0,1,0,1,2,1,0,4,0,2,7,1
1972,48114,rzXoVvb6RM0hS48T1GDjFso4hKBDuhsd,bWdj2GDclj5ofokWjzoa5jAwMkxCykd6,11,18,12,0,3,0,4,0,37,5.285714285714286,3,0.0,2,12,0,3,16,0,0,4,0,17,20,0
1973,48121,aDXyYOZH6u3WRzJTxPdI3vxwfFxiKOmm,SpATywNh6bZuzm8s1ceuBUnMUAeoAHHw,21,30,13,18,6,0,5,0,72,10.285714285714286,1,0.0,5,13,15,6,25,0,3,5,0,39,33,1
1974,48188,ZuzQyeRHP6ylyX1kz2ZCSK5JTnFY7jgw,5X6FeZozNMgE2VRi3MJYjkkFK8SETtu2,5,3,1,0,1,0,2,0,7,1.0,1,0.0,0,1,0,1,3,0,0,2,0,2,5,1
1975,48204,pl9XUoy865SinWI51RNAlmhqaJHEhs94,SpATywNh6bZuzm8s1ceuBUnMUAeoAHHw,32,41,19,42,9,4,8,1,124,17.714285714285715,2,0.0,18,19,35,9,23,4,7,8,1,81,43,1
1976,48254,nazeZS8BdRMOGGuVriyb5M21Pn5Qng36,5X6FeZozNMgE2VRi3MJYjkkFK8SETtu2,4,5,2,0,0,0,2,0,9,1.2857142857142858,2,0.0,0,2,0,0,5,0,0,2,0,2,7,1
1977,48261,wi7Ze896VO17gMeNUgqgfOVbxlFbfvaK,SpATywNh6bZuzm8s1ceuBUnMUAeoAHHw,21,18,11,12,6,2,5,1,55,7.857142857142857,2,0.0,4,11,9,6,14,2,3,5,1,30,25,0
1978,48307,xqNT9GHVIeGkzMPTfiXtvyG6m6zaY6B9,A3fsA9Zfv1X2fVEQhTw51lKENdNrEqT3,4,2,0,0,0,0,3,0,5,0.7142857142857143,1,0.0,0,0,0,0,2,0,0,3,0,0,5,1
1979,48325,vkfHpP1V5bzhsiIUQc7ID6uM0xIbyM6G,bWdj2GDclj5ofokWjzoa5jAwMkxCykd6,1,0,0,0,0,0,1,0,1,0.14285714285714285,1,0.0,0,0,0,0,0,0,0,1,0,0,1,1
1980,48370,3HC1D1DG8BjKUNFZlgm7gcIQVOGrzi6J,SpATywNh6bZuzm8s1ceuBUnMUAeoAHHw,14,11,8,0,6,0,2,0,27,3.857142857142857,2,0.0,0,8,0,6,11,0,0,2,0,14,13,0
1981,48371,vPzTKxBGOgQvPyttxcPLEgk5w088HTzb,SpATywNh6bZuzm8s1ceuBUnMUAeoAHHw,28,25,19,0,12,1,9,1,67,9.571428571428571,3,0.0,0,19,0,12,25,1,0,9,1,31,36,1
1982,48372,WjTYaS8yfbxyQCBRfgx2LHwT0DLPXKM5,SpATywNh6bZuzm8s1ceuBUnMUAeoAHHw,1,0,0,0,0,0,2,0,2,0.2857142857142857,1,0.0,0,0,0,0,0,0,0,2,0,0,2,1
1983,48386,5jz6qtmzJGoTjjzPCohz2U8oEp7qiszP,SpATywNh6bZuzm8s1ceuBUnMUAeoAHHw,34,42,18,27,10,4,7,0,108,15.428571428571429,4,0.0,8,18,25,10,34,4,2,7,0,61,47,0
1984,48436,aPM6Pkx8yXzDO1Wq6YMG1wXnFkTU2WLX,bWdj2GDclj5ofokWjzoa5jAwMkxCykd6,7,7,0,0,0,0,1,0,8,1.1428571428571428,1,0.0,0,0,0,0,7,0,0,1,0,0,8,1
1985,48446,QIQR6VwK3cpUKM5lDzadEKeQATM23w8z,A3fsA9Zfv1X2fVEQhTw51lKENdNrEqT3,51,31,1,132,0,0,4,0,168,24.0,3,0.0,4,1,120,0,27,0,12,4,0,125,43,1
1986,48484,HsuSSkmNEe51pmwRC4MuavuxD1n89icY,SpATywNh6bZuzm8s1ceuBUnMUAeoAHHw,19,32,17,18,8,17,9,0,101,14.428571428571429,4,0.0,5,17,15,8,27,17,3,9,0,45,56,1
1987,48492,Av4RUzIKiBksZoh2Q0L0akgGSwn9yOvk,SpATywNh6bZuzm8s1ceuBUnMUAeoAHHw,33,30,26,15,16,8,2,0,97,13.857142857142858,3,0.0,2,26,13,16,28,8,2,2,0,57,40,0
1988,48505,wLHIcBw64LujKVlhQPCCWdqoNNExSslB,RXDvfPUBYFlVdlueBFbLW0mhhAyGEqpt,5,2,1,0,1,0,4,0,8,1.1428571428571428,2,0.0,0,1,0,1,2,0,0,4,0,2,6,1
1989,48529,hkwn5MNEUKXaOvo8i7hJxIoCohTDhE10,SpATywNh6bZuzm8s1ceuBUnMUAeoAHHw,42,72,42,56,26,0,6,2,204,29.142857142857142,5,0.0,21,42,51,26,51,0,5,6,2,140,64,0
1990,48545,chixnlC2a6qKHlbNdDwMmrvvgJUNDKKd,SpATywNh6bZuzm8s1ceuBUnMUAeoAHHw,1,0,0,0,0,0,1,0,1,0.14285714285714285,1,0.0,0,0,0,0,0,0,0,1,0,0,1,1
1991,48570,VTFDw2vJ6rzCiyEGWQUVkoldm7wzhtYa,SpATywNh6bZuzm8s1ceuBUnMUAeoAHHw,36,30,21,0,15,0,6,0,72,10.285714285714286,4,0.0,4,21,0,15,26,0,0,6,0,40,32,1
1992,48585,QIbN4GxDISz9UsvJoNIOWyqRfTxBq16y,SpATywNh6bZuzm8s1ceuBUnMUAeoAHHw,6,2,1,0,1,0,3,0,7,1.0,1,0.0,0,1,0,1,2,0,0,3,0,2,5,1
1993,48587,v6QLYqOum8NXSX8h0M5DMTP0vkr2qfHa,SpATywNh6bZuzm8s1ceuBUnMUAeoAHHw,35,39,27,35,18,14,17,0,150,21.428571428571427,3,0.0,6,27,33,18,33,14,2,17,0,84,66,0
1994,48597,iFAEvIlnSy7QTK0C8wy8Gm8EC4q4g73z,G8EPVSXsOYB5YQWZGiz1aVq5Pgr2GrQu,8,6,3,0,2,0,4,0,15,2.142857142857143,1,0.0,0,3,0,2,6,0,0,4,0,5,10,1
1995,48617,LSvU72CFq1TrHd9SCZOiKQ0qcV2oa2Ok,A3fsA9Zfv1X2fVEQhTw51lKENdNrEqT3,5,2,0,0,0,0,4,0,6,0.8571428571428571,1,0.0,0,0,0,0,2,0,0,4,0,0,6,0
1996,48630,oymhnrhhZTojmhR9U4GGxnwHZLmXRmW8,SpATywNh6bZuzm8s1ceuBUnMUAeoAHHw,7,11,8,0,0,0,3,0,22,3.142857142857143,3,0.0,0,8,0,0,11,0,0,3,0,8,14,1
1997,48643,RCdcltNaQLfcoxT7YKTjQxAYUbCmzzKd,SpATywNh6bZuzm8s1ceuBUnMUAeoAHHw,34,40,27,31,16,9,10,0,133,19.0,5,0.0,7,27,30,16,33,9,1,10,0,80,53,0
1998,48693,AnsnVs5AVUHmSDONSrxZt8MIRHsOXvcc,SpATywNh6bZuzm8s1ceuBUnMUAeoAHHw,33,25,16,16,11,0,4,0,72,10.285714285714286,2,0.0,5,16,15,11,20,0,1,4,0,47,25,0
1999,48701,z4snJqWxxByo4wMmQ2g1knGwZpMDrb1I,SpATywNh6bZuzm8s1ceuBUnMUAeoAHHw,11,18,15,0,14,0,0,0,47,6.714285714285714,3,0.0,0,15,0,14,18,0,0,0,0,29,18,0
2000,48702,ryiQYyVYMdwKFXJfIVJiBqI3D0XwNLw1,bWdj2GDclj5ofokWjzoa5jAwMkxCykd6,13,19,8,34,6,0,7,0,74,10.571428571428571,2,0.0,5,8,34,6,14,0,0,7,0,53,21,0
2001,48709,QQWLbKtU9foRAK01shKWj5BlhSa8NZ5K,5X6FeZozNMgE2VRi3MJYjkkFK8SETtu2,39,88,33,56,33,5,10,1,226,32.285714285714285,5,0.0,48,33,44,33,40,5,12,10,1,158,68,1
2002,48716,EJmjPRM04Uqau3e0OiUKVcHUyavQV9Hd,SpATywNh6bZuzm8s1ceuBUnMUAeoAHHw,19,23,4,8,3,0,4,0,42,6.0,4,0.0,0,4,7,3,23,0,1,4,0,14,28,0
2003,48724,oxWNSOCXM5YtqWviH5bNOZtEWIiiD3Ad,SpATywNh6bZuzm8s1ceuBUnMUAeoAHHw,25,51,3,34,0,6,15,3,112,16.0,5,0.0,7,3,28,0,44,6,6,15,3,38,74,0
2004,48746,gVGj2LhiiokanFRHheozHOjuzmD8hKxS,G8EPVSXsOYB5YQWZGiz1aVq5Pgr2GrQu,10,9,5,0,4,0,3,0,21,3.0,2,0.0,1,5,0,4,8,0,0,3,0,10,11,1
2005,48768,PtsRHtEUtNnLmH8gts61dMI3tx9jCckb,SpATywNh6bZuzm8s1ceuBUnMUAeoAHHw,8,9,5,0,2,0,3,0,19,2.7142857142857144,1,0.0,2,5,0,2,7,0,0,3,0,9,10,1
2006,48821,ZjsIVK1LVT8DmeiV5guDcHEGev6AFTMV,SpATywNh6bZuzm8s1ceuBUnMUAeoAHHw,8,4,3,0,2,0,2,0,11,1.5714285714285714,1,0.0,0,3,0,2,4,0,0,2,0,5,6,1
2007,48840,aGUfx90yhbQwlGokMP50QqeVLCer1QZu,5X6FeZozNMgE2VRi3MJYjkkFK8SETtu2,9,13,0,11,5,6,5,0,40,5.714285714285714,1,0.0,9,0,9,5,4,6,2,5,0,23,17,1
2008,48851,U2YEyQJ6vRjLD9a41Fy3cKvRrxCg3qKu,SpATywNh6bZuzm8s1ceuBUnMUAeoAHHw,26,57,31,16,9,8,17,0,138,19.714285714285715,4,0.0,2,31,14,9,55,8,2,17,0,56,82,0
2009,48873,FgYPvBwLri7YiFI9og6clP9FuKJ08jX7,G8EPVSXsOYB5YQWZGiz1aVq5Pgr2GrQu,6,6,3,0,1,0,1,0,11,1.5714285714285714,2,0.0,0,3,0,1,6,0,0,1,0,4,7,1
2010,48877,Ni0IPlzVi6gdiGgs6dhBnA0GIuFxEzjB,5X6FeZozNMgE2VRi3MJYjkkFK8SETtu2,1,0,0,0,0,0,1,0,1,0.14285714285714285,1,0.0,0,0,0,0,0,0,0,1,0,0,1,1
2011,48910,oORy78WPGzz21oydfrdMfNTEPAbNPQ4N,SpATywNh6bZuzm8s1ceuBUnMUAeoAHHw,22,18,13,0,8,0,10,0,49,7.0,3,0.0,0,13,0,8,18,0,0,10,0,21,28,0
2012,48912,Ke3m1XBYFaKY25GJE6kMuwQnyabdYG4B,bWdj2GDclj5ofokWjzoa5jAwMkxCykd6,1,0,0,0,0,0,2,0,2,0.2857142857142857,1,0.0,0,0,0,0,0,0,0,2,0,0,2,1
2013,48923,rJ7deFT9ohZCOevrsW5L4Px2yVgiatFT,A3fsA9Zfv1X2fVEQhTw51lKENdNrEqT3,5,3,2,0,1,0,1,0,7,1.0,1,0.0,0,2,0,1,3,0,0,1,0,3,4,1
2014,48957,7xLRAUzJSfSBonILgUC8oEWPnbxwGYvj,RXDvfPUBYFlVdlueBFbLW0mhhAyGEqpt,4,4,2,0,2,0,0,0,8,1.1428571428571428,1,0.0,0,2,0,2,4,0,0,0,0,4,4,1
2015,48958,CFwBanDE4eguHX9lcM62Yx5Bex6437kC,SpATywNh6bZuzm8s1ceuBUnMUAeoAHHw,5,4,3,0,0,0,4,0,11,1.5714285714285714,2,0.0,0,3,0,0,4,0,0,4,0,3,8,0
2016,48968,3Y0bPm3E3Ch9XQ8h4cbV56DUaTL5U5qc,SpATywNh6bZuzm8s1ceuBUnMUAeoAHHw,18,36,5,19,3,36,6,0,105,15.0,7,0.0,7,5,15,3,29,36,4,6,0,30,75,0
2017,48974,Ze9kgklMuT1yRhjZzYqZ128xNCVJ9Ing,SpATywNh6bZuzm8s1ceuBUnMUAeoAHHw,4,2,1,0,1,0,0,0,4,0.5714285714285714,1,0.0,0,1,0,1,2,0,0,0,0,2,2,0
2018,48988,n0HFF3TwqKuBMzzkdLCbvb8Mji5ZUnVX,bWdj2GDclj5ofokWjzoa5jAwMkxCykd6,19,26,3,0,2,0,6,0,37,5.285714285714286,4,0.0,0,3,0,2,26,0,0,6,0,5,32,0
2019,49040,tNcQJSYfIwP0RRLCMvpsyr5j06z8N8iO,SpATywNh6bZuzm8s1ceuBUnMUAeoAHHw,1,0,0,0,0,0,1,0,1,0.14285714285714285,1,0.0,0,0,0,0,0,0,0,1,0,0,1,1
2020,49055,VnqjPsNMop8FSxKaE0aFC1bL7RnYPDau,bWdj2GDclj5ofokWjzoa5jAwMkxCykd6,2,0,0,0,0,0,2,0,2,0.2857142857142857,1,0.0,0,0,0,0,0,0,0,2,0,0,2,1
2021,49074,xVBb6KTthksx7yA35KzlYaPb1gJ7b3SK,SpATywNh6bZuzm8s1ceuBUnMUAeoAHHw,6,5,1,0,1,0,2,0,9,1.2857142857142858,1,0.0,0,1,0,1,5,0,0,2,0,2,7,1
2022,49079,uqA5Smdw6BACOcL0f2tmxwTTxZXBpZpE,A3fsA9Zfv1X2fVEQhTw51lKENdNrEqT3,4,4,3,0,0,0,1,0,8,1.1428571428571428,1,0.0,0,3,0,0,4,0,0,1,0,3,5,1
2023,49082,21PlIQxHvCIRuT4YC0IvZYCzvQ1GOkuQ,SpATywNh6bZuzm8s1ceuBUnMUAeoAHHw,13,17,3,10,1,0,3,0,34,4.857142857142857,3,0.0,2,3,9,1,15,0,1,3,0,15,19,1
2024,49086,G7CuAdMTwHj5eYhpu5z9RBNQZMziV4KR,SpATywNh6bZuzm8s1ceuBUnMUAeoAHHw,15,10,8,0,6,0,6,0,30,4.285714285714286,3,0.0,0,8,0,6,10,0,0,6,0,14,16,0
2025,49113,1uHLOYSfEFwzZFuLCsgyZIWEkaqBo7Qo,bWdj2GDclj5ofokWjzoa5jAwMkxCykd6,1,0,0,0,0,0,1,0,1,0.14285714285714285,1,0.0,0,0,0,0,0,0,0,1,0,0,1,1
2026,49123,hZuqApg1u2xIALq7aPkxAemxANyM5ZQO,SpATywNh6bZuzm8s1ceuBUnMUAeoAHHw,17,8,6,9,5,0,3,0,31,4.428571428571429,1,0.0,2,6,8,5,6,0,1,3,0,21,10,0
2027,49125,XOaJO8KF8vdUACh2JbMQ3VMKBQSpUCWY,5X6FeZozNMgE2VRi3MJYjkkFK8SETtu2,28,111,36,26,14,6,17,1,211,30.142857142857142,8,0.0,32,36,22,14,79,6,4,17,1,104,107,0
2028,49126,ODO6YJv7WKlywuU0ERlwS65mjmQLwAAN,G8EPVSXsOYB5YQWZGiz1aVq5Pgr2GrQu,13,8,6,0,6,0,2,0,22,3.142857142857143,1,0.0,0,6,0,6,8,0,0,2,0,12,10,1
2029,49136,q52eSaqWMZ3OyThwrFYZptxsSeXg1MmQ,5X6FeZozNMgE2VRi3MJYjkkFK8SETtu2,5,2,1,0,1,0,3,0,7,1.0,1,0.0,0,1,0,1,2,0,0,3,0,2,5,1
2030,49142,nlq4r6xc3rTUqTwcYhL6wudXdN6RIE52,5X6FeZozNMgE2VRi3MJYjkkFK8SETtu2,10,18,5,0,15,0,2,0,40,5.714285714285714,2,0.0,11,5,0,15,7,0,0,2,0,31,9,1
2031,49144,sLXZuSYSyseCIVyzHGWGjauvNb9Bdi86,SpATywNh6bZuzm8s1ceuBUnMUAeoAHHw,24,13,11,0,10,0,4,0,38,5.428571428571429,2,0.0,0,11,0,10,13,0,0,4,0,21,17,0
2032,49169,DiWBcd8PLPtmWnfb34O6eK5u6IIpJyne,bWdj2GDclj5ofokWjzoa5jAwMkxCykd6,6,2,1,0,1,0,3,0,7,1.0,1,0.0,0,1,0,1,2,0,0,3,0,2,5,1
2033,49173,1n5WyoQB7crKqtXBR0SIfThQpW2Y5gVs,SpATywNh6bZuzm8s1ceuBUnMUAeoAHHw,11,10,6,11,3,0,2,0,32,4.571428571428571,2,0.0,2,6,11,3,8,0,0,2,0,22,10,0
2034,49176,NPHytleW9ri0zHSbUOwP2d33PRO3w2MK,SpATywNh6bZuzm8s1ceuBUnMUAeoAHHw,4,5,2,0,0,6,2,0,15,2.142857142857143,2,0.0,0,2,0,0,5,6,0,2,0,2,13,0
2035,49181,XlmFJwnIeWSyzdPHIMvNTxkRpr6ZopMK,SpATywNh6bZuzm8s1ceuBUnMUAeoAHHw,5,3,2,0,1,0,1,0,7,1.0,1,0.0,0,2,0,1,3,0,0,1,0,3,4,1
2036,49183,TNa2CwMEhRRkLaiFBsLLeLu23oFHBijc,SpATywNh6bZuzm8s1ceuBUnMUAeoAHHw,3,5,0,0,0,0,2,0,7,1.0,2,0.0,0,0,0,0,5,0,0,2,0,0,7,0
2037,49210,vAuEkfFLmRAZzPWBMIHGpWEOUfjnGK8C,SpATywNh6bZuzm8s1ceuBUnMUAeoAHHw,8,10,2,0,2,0,2,0,16,2.2857142857142856,1,0.0,1,2,0,2,9,0,0,2,0,5,11,1
2038,49238,Zi3R72s2HAt1ldLoA4VSH4SbCoNpJ8zo,SpATywNh6bZuzm8s1ceuBUnMUAeoAHHw,2,0,0,0,0,0,2,0,2,0.2857142857142857,1,0.0,0,0,0,0,0,0,0,2,0,0,2,1
2039,49253,b1eRrhapWSjtM2Ih9Xn0eBEZAyjqmlvI,5X6FeZozNMgE2VRi3MJYjkkFK8SETtu2,15,26,12,10,10,0,5,0,63,9.0,4,0.0,9,12,10,10,17,0,0,5,0,41,22,1
2040,49254,Hw8jmGp4VI4tAz6cfKhHDOeLB2t7MJ9z,SpATywNh6bZuzm8s1ceuBUnMUAeoAHHw,1,0,0,0,0,0,1,0,1,0.14285714285714285,1,0.0,0,0,0,0,0,0,0,1,0,0,1,1
2041,49271,L1EklyJfiTl8KTmYGUWKSBRLYXBLn3BW,SpATywNh6bZuzm8s1ceuBUnMUAeoAHHw,2,4,1,0,0,0,0,0,5,0.7142857142857143,4,0.0,0,1,0,0,4,0,0,0,0,1,4,0
2042,49276,vrm9Sqb4UFaJQirEdRETMq8oV2HNeZJI,bWdj2GDclj5ofokWjzoa5jAwMkxCykd6,10,25,12,0,12,0,4,0,53,7.571428571428571,3,0.0,2,12,0,12,23,0,0,4,0,26,27,0
2043,49278,uYpCxSEThfkQLmmlnpb36cNb0AbKmnXu,bWdj2GDclj5ofokWjzoa5jAwMkxCykd6,12,5,2,0,4,1,7,1,20,2.857142857142857,1,0.0,2,2,0,4,3,1,0,7,1,8,12,1
2044,49280,CGjJFqZQSngbEn6BLTOwdJsdGHCnhvU8,SpATywNh6bZuzm8s1ceuBUnMUAeoAHHw,30,33,10,40,6,11,16,4,120,17.142857142857142,4,0.0,4,10,31,6,29,11,9,16,4,51,69,1
2045,49295,cQq1I450zzmO4zcHgKJLXcCXQBX0VHxW,SpATywNh6bZuzm8s1ceuBUnMUAeoAHHw,6,3,1,0,1,0,3,0,8,1.1428571428571428,1,0.0,0,1,0,1,3,0,0,3,0,2,6,1
2046,49302,3uU9hzp6POZeWb9TkpjJweQiyjZgKmLY,SpATywNh6bZuzm8s1ceuBUnMUAeoAHHw,27,35,22,16,10,6,8,2,99,14.142857142857142,3,0.0,7,22,13,10,28,6,3,8,2,52,47,0
2047,49316,SY8PjWAcViY3TAxvifjZF4drAUdDweaG,RXDvfPUBYFlVdlueBFbLW0mhhAyGEqpt,6,4,3,0,3,0,1,0,11,1.5714285714285714,1,0.0,0,3,0,3,4,0,0,1,0,6,5,1
2048,49340,YbDGggh5B2xVgz44wTEzgnuIROY324O4,RXDvfPUBYFlVdlueBFbLW0mhhAyGEqpt,1,0,0,0,0,0,2,0,2,0.2857142857142857,1,0.0,0,0,0,0,0,0,0,2,0,0,2,1
2049,49384,829nD15I0zFbxTlo9Kk4QZLCipO4Bdiu,RXDvfPUBYFlVdlueBFbLW0mhhAyGEqpt,2,0,0,0,0,0,3,0,3,0.42857142857142855,1,0.0,0,0,0,0,0,0,0,3,0,0,3,1
2050,49396,5gZxPym3HmEvBCZNbF2vxyjqjuAZOTpQ,5X6FeZozNMgE2VRi3MJYjkkFK8SETtu2,15,29,10,16,14,0,4,0,73,10.428571428571429,3,0.0,16,10,13,14,13,0,3,4,0,53,20,1
2051,49401,rb0bCeAP0PjUKM6QZmb5eDbdcmhSPRHl,5X6FeZozNMgE2VRi3MJYjkkFK8SETtu2,4,2,1,0,1,0,3,0,7,1.0,2,0.0,0,1,0,1,2,0,0,3,0,2,5,1
2052,49415,5gZxPym3HmEvBCZNbF2vxyjqjuAZOTpQ,bWdj2GDclj5ofokWjzoa5jAwMkxCykd6,8,15,8,0,4,0,7,0,34,4.857142857142857,3,0.0,0,8,0,4,15,0,0,7,0,12,22,1
2053,49423,S9Zsax2BYcPzUt4rHtigt6S1ZlRCRjuu,SpATywNh6bZuzm8s1ceuBUnMUAeoAHHw,23,34,18,10,8,0,8,0,78,11.142857142857142,5,0.0,2,18,10,8,32,0,0,8,0,38,40,0
2054,49432,omzzgaeT6ZY9tvDfseVuJqPQ1kKVGR2Z,SpATywNh6bZuzm8s1ceuBUnMUAeoAHHw,46,82,34,56,15,19,18,5,229,32.714285714285715,2,0.0,43,34,45,15,39,19,11,18,5,137,92,1
2055,49439,cKY5fIoDoYK1EL9DOwETOjepsO48aQ9E,bWdj2GDclj5ofokWjzoa5jAwMkxCykd6,9,9,6,0,6,0,3,0,24,3.4285714285714284,1,0.0,2,6,0,6,7,0,0,3,0,14,10,1
2056,49458,hJo1MgKiPZFXuH2ko6hqPTd9dbjMQKDO,5X6FeZozNMgE2VRi3MJYjkkFK8SETtu2,9,15,5,10,3,0,6,0,39,5.571428571428571,4,0.0,4,5,8,3,11,0,2,6,0,20,19,1
2057,49483,T761UltC8HrAVgHTpcJuQFf7vNJ3Ud9J,5X6FeZozNMgE2VRi3MJYjkkFK8SETtu2,17,32,16,12,9,0,7,1,77,11.0,3,0.0,4,16,10,9,28,0,2,7,1,39,38,1
2058,49511,H1nbdkC904EOh8jWeVVcV5piaqMVBsli,SpATywNh6bZuzm8s1ceuBUnMUAeoAHHw,14,12,0,12,0,0,4,0,28,4.0,2,0.0,2,0,11,0,10,0,1,4,0,13,15,0
2059,49513,I15DoIEv5oOQwZnGe2Nztxp5iKM5K2pr,SpATywNh6bZuzm8s1ceuBUnMUAeoAHHw,7,12,0,0,0,3,4,0,19,2.7142857142857144,1,0.0,0,0,0,0,12,3,0,4,0,0,19,0
2060,49541,NblSZLprYLuCPJABpiPhGyWCznOG5gpM,SpATywNh6bZuzm8s1ceuBUnMUAeoAHHw,6,5,4,0,2,0,0,0,11,1.5714285714285714,1,0.0,0,4,0,2,5,0,0,0,0,6,5,1
2061,49543,0OsY8LWQHJyrf2iZ6AGYuDrpmW3bfvqO,SpATywNh6bZuzm8s1ceuBUnMUAeoAHHw,29,43,27,0,16,8,19,3,116,16.571428571428573,6,0.0,3,27,0,16,40,8,0,19,3,46,70,0
2062,49553,bFQZxr4iRVJaZh2fO7R9dida2Y7glw1T,SpATywNh6bZuzm8s1ceuBUnMUAeoAHHw,19,18,12,10,6,0,3,0,49,7.0,3,0.0,3,12,10,6,15,0,0,3,0,31,18,0
2063,49576,oynYdl2jV0AqFEflzqlk35JIgkfhOwM5,SpATywNh6bZuzm8s1ceuBUnMUAeoAHHw,1,0,0,0,0,0,1,0,1,0.14285714285714285,1,0.0,0,0,0,0,0,0,0,1,0,0,1,1
2064,49604,OXUkoQAJTqhVghuHGRHk1iSAl7CHffoQ,SpATywNh6bZuzm8s1ceuBUnMUAeoAHHw,6,4,1,0,1,0,2,0,8,1.1428571428571428,1,0.0,1,1,0,1,3,0,0,2,0,3,5,1
2065,49610,G43uBjhkBEsnK2sHC51NOglfCGNDkydQ,SpATywNh6bZuzm8s1ceuBUnMUAeoAHHw,3,2,1,0,0,0,1,0,4,0.5714285714285714,1,0.0,0,1,0,0,2,0,0,1,0,1,3,1
2066,49611,00SOCgKq1H6iYExhbauCeUrQFSjIMetG,SpATywNh6bZuzm8s1ceuBUnMUAeoAHHw,7,6,4,0,2,1,4,1,18,2.5714285714285716,1,0.0,0,4,0,2,6,1,0,4,1,6,12,0
2067,49620,twg5LqeyEPdLZyjl4T3Yb1man7ZRuOed,SpATywNh6bZuzm8s1ceuBUnMUAeoAHHw,35,66,2,15,2,0,9,0,94,13.428571428571429,4,0.0,9,2,14,2,57,0,1,9,0,27,67,0
2068,49626,LiONc59joHBCh6XOJp7hfXs4mjQEsGy4,SpATywNh6bZuzm8s1ceuBUnMUAeoAHHw,18,26,17,18,7,0,4,0,72,10.285714285714286,3,0.0,2,17,17,7,24,0,1,4,0,43,29,1
2069,49630,Nvud1QIhR4FBjW055r9HSxywupZk5GAR,SpATywNh6bZuzm8s1ceuBUnMUAeoAHHw,8,6,1,0,1,0,1,0,9,1.2857142857142858,1,0.0,0,1,0,1,6,0,0,1,0,2,7,1
2070,49633,lcYZKeyU0m8T0hVxudGSh4HqQiun1Pb4,SpATywNh6bZuzm8s1ceuBUnMUAeoAHHw,3,2,0,0,0,0,2,0,4,0.5714285714285714,1,0.0,0,0,0,0,2,0,0,2,0,0,4,1
2071,49650,Y3zuofaAdrsNcwq0tuYyHFkAsBUWoV8a,SpATywNh6bZuzm8s1ceuBUnMUAeoAHHw,17,23,8,7,3,0,6,0,47,6.714285714285714,2,0.0,3,8,7,3,20,0,0,6,0,21,26,0
2072,49654,1bKMONcV6Mq58szdlIajPdFyqaw4BvrA,SpATywNh6bZuzm8s1ceuBUnMUAeoAHHw,3,2,0,0,0,0,1,0,3,0.42857142857142855,1,0.0,0,0,0,0,2,0,0,1,0,0,3,1
2073,49655,H1nbdkC904EOh8jWeVVcV5piaqMVBsli,G8EPVSXsOYB5YQWZGiz1aVq5Pgr2GrQu,13,16,1,0,0,0,12,0,29,4.142857142857143,4,0.0,0,1,0,0,16,0,0,12,0,1,28,0
2074,49656,BoK7CAUaCFqnLgmWLxeOHg8YkXUSeCtc,SpATywNh6bZuzm8s1ceuBUnMUAeoAHHw,10,16,8,0,5,0,6,0,35,5.0,3,0.0,0,8,0,5,16,0,0,6,0,13,22,0
2075,49667,FMXygMEgHnu3skJkjoCo0OvyQsjB0C7q,SpATywNh6bZuzm8s1ceuBUnMUAeoAHHw,9,11,1,0,1,0,14,1,28,4.0,1,0.0,0,1,0,1,11,0,0,14,1,2,26,1
2076,49679,GF5Rflu9cCcL8EFuacKpsHdGIeCCsr9m,SpATywNh6bZuzm8s1ceuBUnMUAeoAHHw,32,90,10,14,7,3,16,1,141,20.142857142857142,7,0.0,3,10,11,7,87,3,3,16,1,31,110,0
2077,49691,bVLtn3iBc4ibW8xWVzLLM3Hs9gCB0qb7,SpATywNh6bZuzm8s1ceuBUnMUAeoAHHw,29,29,0,30,0,0,9,0,68,9.714285714285714,2,0.0,7,0,26,0,22,0,4,9,0,33,35,0
2078,49694,cszgTMCcWdEja3BpEwPP5MtLXTMUMJXE,SpATywNh6bZuzm8s1ceuBUnMUAeoAHHw,14,8,6,0,5,0,1,0,20,2.857142857142857,1,0.0,0,6,0,5,8,0,0,1,0,11,9,0
2079,49705,Lce2TIYgGhTbahYzTHHK4e5KxnEianpx,G8EPVSXsOYB5YQWZGiz1aVq5Pgr2GrQu,3,2,1,0,0,0,1,0,4,0.5714285714285714,1,0.0,0,1,0,0,2,0,0,1,0,1,3,1
2080,49710,LzTBHDjLePaTqbybIwaptvUgkC0hWYCZ,SpATywNh6bZuzm8s1ceuBUnMUAeoAHHw,35,44,22,45,12,0,16,0,139,19.857142857142858,5,0.0,12,22,38,12,32,0,7,16,0,84,55,0
2081,49732,fiLsrcAU0ZFm61T8xhRUwb5p8PN605CT,G8EPVSXsOYB5YQWZGiz1aVq5Pgr2GrQu,1,0,0,0,0,0,1,0,1,0.14285714285714285,1,0.0,0,0,0,0,0,0,0,1,0,0,1,1
2082,49749,EwhKhClSv2Ps16I3uKtjdSj1YI7rGPIh,SpATywNh6bZuzm8s1ceuBUnMUAeoAHHw,23,31,20,37,11,0,13,0,112,16.0,3,0.0,5,20,32,11,26,0,5,13,0,68,44,0
2083,49766,Lce2TIYgGhTbahYzTHHK4e5KxnEianpx,SpATywNh6bZuzm8s1ceuBUnMUAeoAHHw,3,2,1,0,0,0,1,0,4,0.5714285714285714,1,0.0,0,1,0,0,2,0,0,1,0,1,3,1
2084,49836,0vUwtohBIGCms6pa9p1s0k5cJHWURa4P,SpATywNh6bZuzm8s1ceuBUnMUAeoAHHw,13,14,1,12,0,0,1,0,28,4.0,1,0.0,4,1,11,0,10,0,1,1,0,16,12,0
2085,49863,rVswAzjMLz5uIPbCwAU1SliCQFpiAqey,SpATywNh6bZuzm8s1ceuBUnMUAeoAHHw,14,11,9,0,7,0,2,0,29,4.142857142857143,2,0.0,0,9,0,7,11,0,0,2,0,16,13,0
2086,49871,8Z72cXdX2QzZC5Cee7T0dly3YHU3SU43,SpATywNh6bZuzm8s1ceuBUnMUAeoAHHw,4,2,1,0,1,0,3,0,7,1.0,2,0.0,0,1,0,1,2,0,0,3,0,2,5,1
2087,49876,SvdoxHaqv4If8vTEQE4Ye6pIzdBuUEi9,SpATywNh6bZuzm8s1ceuBUnMUAeoAHHw,5,2,0,0,1,0,2,0,5,0.7142857142857143,1,0.0,0,0,0,1,2,0,0,2,0,1,4,1
2088,49883,m5Ev3sP4lHJ0ibeJ0LosEcT9fpQ7nqsa,SpATywNh6bZuzm8s1ceuBUnMUAeoAHHw,21,26,0,14,0,0,9,3,52,7.428571428571429,4,0.0,2,0,12,0,24,0,2,9,3,14,38,0
2089,49896,PrE64zhEuNh83grWL2cXaZZPY2nI1xUf,RXDvfPUBYFlVdlueBFbLW0mhhAyGEqpt,1,0,0,0,0,0,1,0,1,0.14285714285714285,1,0.0,0,0,0,0,0,0,0,1,0,0,1,1
2090,49918,ydYJlUXOoM7xCFpD6o4c1fr3yZVc0YKb,SpATywNh6bZuzm8s1ceuBUnMUAeoAHHw,17,26,9,14,3,0,4,5,61,8.714285714285714,1,0.0,16,9,12,3,10,0,2,4,5,40,21,0
2091,49937,S1lONT2J4pj3m6ZnKfCaXABaqydhFYAZ,RXDvfPUBYFlVdlueBFbLW0mhhAyGEqpt,1,0,0,0,0,0,1,0,1,0.14285714285714285,1,0.0,0,0,0,0,0,0,0,1,0,0,1,1
2092,49946,LNdimqsJkOxQDP9dT4IGwewg9YvH7zfV,G8EPVSXsOYB5YQWZGiz1aVq5Pgr2GrQu,49,52,30,82,16,0,8,0,188,26.857142857142858,3,0.0,12,30,73,16,40,0,9,8,0,131,57,0
2093,49954,wUH86mMJYdGCZbgyy3OXf5PGskcw9ISy,RXDvfPUBYFlVdlueBFbLW0mhhAyGEqpt,11,9,1,15,2,0,2,0,29,4.142857142857143,1,0.0,2,1,12,2,7,0,3,2,0,17,12,1
2094,49967,7tmNprOSiahGzByaY8XiUnCFEIQfWwuf,bWdj2GDclj5ofokWjzoa5jAwMkxCykd6,3,9,3,0,0,0,4,0,16,2.2857142857142856,3,0.0,0,3,0,0,9,0,0,4,0,3,13,0
2095,49971,2rGTh1SgxK2LtCqPtAjekJLf0W67MrW9,SpATywNh6bZuzm8s1ceuBUnMUAeoAHHw,7,11,2,10,0,0,1,0,24,3.4285714285714284,1,0.0,8,2,9,0,3,0,1,1,0,19,5,1
2096,49987,ctfOhdlbQGiOVF89Y090EmsAqQEvSWmz,SpATywNh6bZuzm8s1ceuBUnMUAeoAHHw,4,2,0,0,0,0,4,0,6,0.8571428571428571,3,0.0,0,0,0,0,2,0,0,4,0,0,6,0
2097,49989,5fAHYcqH6noZyKsfWFiBARbB61J6LxWy,SpATywNh6bZuzm8s1ceuBUnMUAeoAHHw,16,35,1,0,2,0,4,0,42,6.0,3,0.0,0,1,0,2,35,0,0,4,0,3,39,0
2098,49990,uG5tavnQGh6e9leaVUY69Y8QlorpIOvo,SpATywNh6bZuzm8s1ceuBUnMUAeoAHHw,13,10,8,0,5,0,2,0,25,3.5714285714285716,2,0.0,0,8,0,5,10,0,0,2,0,13,12,0
2099,49999,46mPOafwambmi8gI5RDfSSG6CkqbcJr8,SpATywNh6bZuzm8s1ceuBUnMUAeoAHHw,14,24,17,12,0,0,4,0,57,8.142857142857142,2,0.0,3,17,9,0,21,0,3,4,0,29,28,0
2100,50013,hEuZWxjCrAC3cKN1nvhR1u2fd2M80LCS,5X6FeZozNMgE2VRi3MJYjkkFK8SETtu2,9,23,2,11,4,0,2,0,42,6.0,1,0.0,11,2,9,4,12,0,2,2,0,26,16,1
2101,50039,Ib4hBLihYWrsRQnVhSZKjb9Z8z0NZ4FI,SpATywNh6bZuzm8s1ceuBUnMUAeoAHHw,17,38,2,12,1,0,1,0,54,7.714285714285714,4,0.0,9,2,10,1,29,0,2,1,0,22,32,1
2102,50046,Pot71eWzAwlFIQ6WGEu1vr9IkLdwRub9,SpATywNh6bZuzm8s1ceuBUnMUAeoAHHw,21,31,18,28,5,23,11,0,116,16.571428571428573,5,0.0,4,18,26,5,27,23,2,11,0,53,63,0
2103,50047,gUDPkL7pRDCcGo7yRjnN9pFohqG3UESN,G8EPVSXsOYB5YQWZGiz1aVq5Pgr2GrQu,12,15,2,6,4,0,6,0,33,4.714285714285714,1,0.0,8,2,3,4,7,0,3,6,0,17,16,1
2104,50067,nYSFDE8RCbcZhD46fRSvPHUvA1ahfupi,bWdj2GDclj5ofokWjzoa5jAwMkxCykd6,13,15,0,0,0,42,8,0,65,9.285714285714286,2,0.0,0,0,0,0,15,42,0,8,0,0,65,1
2105,50077,HNEdRWA988TWNlPkPkScnQdIH5zRazOo,SpATywNh6bZuzm8s1ceuBUnMUAeoAHHw,2,2,1,0,0,7,0,0,10,1.4285714285714286,4,0.0,0,1,0,0,2,7,0,0,0,1,9,0
2106,50083,0lcODMnOtMqKwcOQQi0MUEWuUnIKYPe1,A3fsA9Zfv1X2fVEQhTw51lKENdNrEqT3,4,3,2,0,0,0,1,0,6,0.8571428571428571,1,0.0,0,2,0,0,3,0,0,1,0,2,4,1
2107,50092,rPKaOWNl9cYkLvtQk035CJPYGwPAMUtv,SpATywNh6bZuzm8s1ceuBUnMUAeoAHHw,8,11,3,10,0,0,2,0,26,3.7142857142857144,2,0.0,5,3,10,0,6,0,0,2,0,18,8,0
2108,50099,sDoPeRFIl4sblcl7cpIozq9zgLVwKPZK,SpATywNh6bZuzm8s1ceuBUnMUAeoAHHw,5,3,1,0,0,0,2,0,6,0.8571428571428571,1,0.0,0,1,0,0,3,0,0,2,0,1,5,0
2109,50100,5u5MqcjfkyBtFhEFfICuuKJJdSbQMwNN,SpATywNh6bZuzm8s1ceuBUnMUAeoAHHw,13,16,10,2,6,0,3,0,37,5.285714285714286,2,0.0,2,10,1,6,14,0,1,3,0,19,18,1
2110,50131,6k0P72adqZC6N7qhsceaS6tnkuUG2bub,SpATywNh6bZuzm8s1ceuBUnMUAeoAHHw,8,7,2,12,0,0,1,0,22,3.142857142857143,1,0.0,2,2,10,0,5,0,2,1,0,14,8,0
2111,50143,kmn6CGih1FILZybV8MrApq46D7xH5npO,SpATywNh6bZuzm8s1ceuBUnMUAeoAHHw,9,7,1,0,1,0,1,0,10,1.4285714285714286,1,0.0,0,1,0,1,7,0,0,1,0,2,8,0
2112,50148,KlVBCKeUNzJiPeVUbSEa3YQZCx8yfOft,SpATywNh6bZuzm8s1ceuBUnMUAeoAHHw,16,13,7,2,3,0,5,0,30,4.285714285714286,2,0.0,1,7,2,3,12,0,0,5,0,13,17,0
2113,50158,PPK7S6McpqG1xker7o77HjrFULvz49Xg,SpATywNh6bZuzm8s1ceuBUnMUAeoAHHw,11,11,0,34,0,0,2,0,47,6.714285714285714,1,0.0,4,0,32,0,7,0,2,2,0,36,11,1
2114,50175,CfX84b3AnOREjEgHXp5gQV78osBjxVJV,RXDvfPUBYFlVdlueBFbLW0mhhAyGEqpt,43,60,0,103,2,12,17,3,197,28.142857142857142,4,0.0,16,0,97,2,44,12,6,17,3,115,82,0
2115,50181,abmp6NHOG5DtC0bkxrbMKfrj8pBrMR65,SpATywNh6bZuzm8s1ceuBUnMUAeoAHHw,5,2,1,0,1,0,2,0,6,0.8571428571428571,1,0.0,0,1,0,1,2,0,0,2,0,2,4,1
2116,50193,FakQTw0mcCCNaYTf0r7ShnVJd2c9Q8vo,SpATywNh6bZuzm8s1ceuBUnMUAeoAHHw,10,5,4,0,4,0,1,0,14,2.0,1,0.0,0,4,0,4,5,0,0,1,0,8,6,1
2117,50271,Gur5FuhE9EyV9K1F0qLPk7AenhoY8PBS,5X6FeZozNMgE2VRi3MJYjkkFK8SETtu2,16,50,10,0,18,0,16,0,94,13.428571428571429,6,0.0,18,10,0,18,32,0,0,16,0,46,48,1
2118,50280,8kmVwd95niwmuvSIAWJVA4Pqx2tMb8kH,bWdj2GDclj5ofokWjzoa5jAwMkxCykd6,3,3,0,0,0,0,1,0,4,0.5714285714285714,1,0.0,1,0,0,0,2,0,0,1,0,1,3,1
2119,50283,cxmD5n6LDACjvuY8YvfXaGJ22S8l6lkc,5X6FeZozNMgE2VRi3MJYjkkFK8SETtu2,4,6,3,0,0,0,4,0,13,1.8571428571428572,4,0.0,0,3,0,0,6,0,0,4,0,3,10,1
2120,50315,1D9YAtx0zyELGBYY8fk5ML3KqjBc5hJQ,bWdj2GDclj5ofokWjzoa5jAwMkxCykd6,1,0,0,0,0,0,1,0,1,0.14285714285714285,1,0.0,0,0,0,0,0,0,0,1,0,0,1,1
2121,50318,nrol5VxiNERghlxTlRYzcM0aTVUVOtUp,SpATywNh6bZuzm8s1ceuBUnMUAeoAHHw,33,103,57,54,25,5,23,1,268,38.285714285714285,4,0.0,33,57,42,25,70,5,12,23,1,157,111,0
2122,50319,7eLlsseV075nalpvk2K7Ka9Wx9qMiOW4,SpATywNh6bZuzm8s1ceuBUnMUAeoAHHw,11,14,13,0,9,1,3,0,40,5.714285714285714,5,0.0,0,13,0,9,14,1,0,3,0,22,18,0
2123,50324,OIups6Cq9XY2CbwOPuI31XrOSt1FeD7G,SpATywNh6bZuzm8s1ceuBUnMUAeoAHHw,20,25,0,28,0,0,3,0,56,8.0,3,0.0,6,0,25,0,19,0,3,3,0,31,25,0
2124,50348,4clLK6Y8CprtsnOm6pLtpUpbGTeCufAu,SpATywNh6bZuzm8s1ceuBUnMUAeoAHHw,30,44,24,12,15,0,3,0,98,14.0,5,0.0,2,24,11,15,42,0,1,3,0,52,46,0
2125,50355,0ALNyWoY1JWb8XE08BRj6HWmYvNPawi2,G8EPVSXsOYB5YQWZGiz1aVq5Pgr2GrQu,28,30,11,52,8,0,3,0,104,14.857142857142858,1,0.0,17,11,35,8,13,0,17,3,0,71,33,1
2126,50357,wXFfHtwd9smrvhh9NQW7SmEEo1001LDW,bWdj2GDclj5ofokWjzoa5jAwMkxCykd6,9,6,4,0,1,7,5,2,25,3.5714285714285716,2,0.0,0,4,0,1,6,7,0,5,2,5,20,0
2127,50364,aielGp4BBBM8UMDsf9Gagm7MaWHEZpD2,SpATywNh6bZuzm8s1ceuBUnMUAeoAHHw,5,3,1,0,1,0,1,0,6,0.8571428571428571,1,0.0,0,1,0,1,3,0,0,1,0,2,4,1
2128,50365,daRNgrfSmtLtouStkwCortm8nv14xS31,SpATywNh6bZuzm8s1ceuBUnMUAeoAHHw,10,14,11,2,0,0,1,0,28,4.0,3,0.0,1,11,2,0,13,0,0,1,0,14,14,1
2129,50374,hAzZgxrFOBoGWYS4hUaB1UgnpeWilVGC,SpATywNh6bZuzm8s1ceuBUnMUAeoAHHw,23,32,17,16,8,0,9,0,82,11.714285714285714,3,0.0,2,17,13,8,30,0,3,9,0,40,42,1
2130,50407,6EQbt9V437dKT6gP8U14lbyP7vlX0oqM,RXDvfPUBYFlVdlueBFbLW0mhhAyGEqpt,1,0,0,0,0,0,1,0,1,0.14285714285714285,1,0.0,0,0,0,0,0,0,0,1,0,0,1,1
2131,50416,Xdag5jOmE7uWC3FmBvgPc5F7lO3QNcPW,SpATywNh6bZuzm8s1ceuBUnMUAeoAHHw,7,8,4,0,1,0,3,0,16,2.2857142857142856,2,0.0,0,4,0,1,8,0,0,3,0,5,11,0
2132,50439,uZmZE9etGnvk5b9puVa5txx5eNz1U4Ni,5X6FeZozNMgE2VRi3MJYjkkFK8SETtu2,4,2,1,0,1,0,1,0,5,0.7142857142857143,1,0.0,0,1,0,1,2,0,0,1,0,2,3,1
2133,50461,Mk1WltctY1vlvTjvcoOEN36uI9KP8emp,SpATywNh6bZuzm8s1ceuBUnMUAeoAHHw,18,39,20,0,9,0,10,0,78,11.142857142857142,6,0.0,0,20,0,9,39,0,0,10,0,29,49,0
2134,50489,oN94SUDmQJB7NjOsdtFUBlHSFjNSal96,G8EPVSXsOYB5YQWZGiz1aVq5Pgr2GrQu,1,0,0,0,0,0,1,0,1,0.14285714285714285,1,0.0,0,0,0,0,0,0,0,1,0,0,1,1
2135,50496,Crsle3QdAPcjxEbhDM61m0114QeooRDa,5X6FeZozNMgE2VRi3MJYjkkFK8SETtu2,4,2,1,0,0,0,2,0,5,0.7142857142857143,1,0.0,0,1,0,0,2,0,0,2,0,1,4,1
2136,50497,4en36s6M5dWiGXaOz7Ao485PkasQppcC,RXDvfPUBYFlVdlueBFbLW0mhhAyGEqpt,24,22,9,32,11,24,8,0,106,15.142857142857142,1,0.0,12,9,30,11,10,24,2,8,0,62,44,0
2137,50500,RwMUq7SCIYrULeTtIYQzgTGTjkIjUHL3,SpATywNh6bZuzm8s1ceuBUnMUAeoAHHw,41,49,22,18,13,0,8,0,110,15.714285714285714,4,0.0,5,22,17,13,44,0,1,8,0,57,53,0
2138,50501,E7wBgQCkgD4tkfXLdP9URnDZqb2ubvF0,SpATywNh6bZuzm8s1ceuBUnMUAeoAHHw,32,55,4,35,3,0,7,0,104,14.857142857142858,5,0.0,6,4,31,3,49,0,4,7,0,44,60,0
2139,50513,W0kdPH6yQ2qysuOIkIgCmrFyFZhFfIKL,SpATywNh6bZuzm8s1ceuBUnMUAeoAHHw,32,46,24,11,5,17,9,2,114,16.285714285714285,3,0.0,15,24,11,5,31,17,0,9,2,55,59,0
2140,50537,faeF4I5p3gAJMB1p4LfYVeCLQZKervYV,5X6FeZozNMgE2VRi3MJYjkkFK8SETtu2,5,2,1,0,1,0,2,0,6,0.8571428571428571,2,0.0,0,1,0,1,2,0,0,2,0,2,4,1
2141,50540,RS564zscXajJOiW9woDtEu4M9LDaNEPd,SpATywNh6bZuzm8s1ceuBUnMUAeoAHHw,14,15,7,0,6,0,3,0,31,4.428571428571429,2,0.0,0,7,0,6,15,0,0,3,0,13,18,1
2142,50573,8ksQz9dz4s7ijHzYWnxMOGz2bplP7OAs,SpATywNh6bZuzm8s1ceuBUnMUAeoAHHw,4,3,1,0,0,0,1,0,5,0.7142857142857143,1,0.0,0,1,0,0,3,0,0,1,0,1,4,1
2143,50627,JhEVXqMF0fvMmfagf4Ea7erW2ArgVAj9,SpATywNh6bZuzm8s1ceuBUnMUAeoAHHw,12,27,8,14,0,7,4,0,60,8.571428571428571,3,0.0,3,8,14,0,24,7,0,4,0,25,35,1
2144,50660,6jPw8ZwEXjLpnrxZT6HkwOQ20NkEyvU7,SpATywNh6bZuzm8s1ceuBUnMUAeoAHHw,21,26,7,15,5,0,3,0,56,8.0,4,0.0,2,7,12,5,24,0,3,3,0,26,30,0
2145,50677,cgc8DGkd3Jwqn7jWLS8pFiVfUMBb7Shb,5X6FeZozNMgE2VRi3MJYjkkFK8SETtu2,9,34,4,0,1,3,10,0,52,7.428571428571429,3,0.0,11,4,0,1,23,3,0,10,0,16,36,1
2146,50679,tqvOTiQbipkIXQL7CIR5dckxV83rng9S,G8EPVSXsOYB5YQWZGiz1aVq5Pgr2GrQu,47,45,33,82,12,26,19,1,218,31.142857142857142,5,0.0,1,33,73,12,44,26,9,19,1,119,99,0
2147,50683,iVwNFnYcHwv8JroRNWkaHfHv9TTNdn1b,G8EPVSXsOYB5YQWZGiz1aVq5Pgr2GrQu,11,6,2,0,1,0,17,1,27,3.857142857142857,1,0.0,0,2,0,1,6,0,0,17,1,3,24,1
2148,50707,Aa2R9ra7UkMT71HsVEpaQpVn5z60q5tc,G8EPVSXsOYB5YQWZGiz1aVq5Pgr2GrQu,9,9,8,0,4,0,5,0,26,3.7142857142857144,3,0.0,0,8,0,4,9,0,0,5,0,12,14,1
2149,50723,85CdJb1zpoAUDtR6sIsTNXjrVvfGwx1A,SpATywNh6bZuzm8s1ceuBUnMUAeoAHHw,30,30,15,22,6,4,8,1,86,12.285714285714286,2,0.0,11,15,22,6,19,4,0,8,1,54,32,0
2150,50754,FJxbzfYvIetXhjzEILF0NWt1RCss96LW,A3fsA9Zfv1X2fVEQhTw51lKENdNrEqT3,9,8,4,0,4,0,0,0,16,2.2857142857142856,2,0.0,0,4,0,4,8,0,0,0,0,8,8,0
2151,50765,oVaUms2Ssh1VCspWlUtFJRhg5TUrapsx,SpATywNh6bZuzm8s1ceuBUnMUAeoAHHw,1,0,0,0,0,0,1,0,1,0.14285714285714285,1,0.0,0,0,0,0,0,0,0,1,0,0,1,1
2152,50832,KH1qoBE3q99uPmQbxyBhuyXhrxNuFdJJ,5X6FeZozNMgE2VRi3MJYjkkFK8SETtu2,1,0,0,0,0,0,1,0,1,0.14285714285714285,1,0.0,0,0,0,0,0,0,0,1,0,0,1,1
2153,50833,KH1qoBE3q99uPmQbxyBhuyXhrxNuFdJJ,bWdj2GDclj5ofokWjzoa5jAwMkxCykd6,1,0,0,0,0,0,1,0,1,0.14285714285714285,1,0.0,0,0,0,0,0,0,0,1,0,0,1,1
2154,50884,4msuvQN1KfMGlp99mEfZpxIIpoD4IGXo,5Gyp41oLVo7Gg7vF4vpmggWP5MU70QO6,6,1,1,0,1,0,3,0,6,0.8571428571428571,1,0.0,0,1,0,1,1,0,0,3,0,2,4,1
2155,50891,oDr5oRs7FIygz2lqxkuhCjkxvDWb5L6G,5Gyp41oLVo7Gg7vF4vpmggWP5MU70QO6,13,21,8,10,6,0,3,0,48,6.857142857142857,3,0.0,6,8,5,6,15,0,5,3,0,25,23,1
2156,50894,1U7cDhSu4UGlxuwxcjk5lRzaNoaFm88d,5Gyp41oLVo7Gg7vF4vpmggWP5MU70QO6,7,1,1,0,1,3,4,1,11,1.5714285714285714,1,0.0,0,1,0,1,1,3,0,4,1,2,9,1
2157,50909,kyUPY0MEVeZNvkmrQxOn0CHNXLZiD03b,5Gyp41oLVo7Gg7vF4vpmggWP5MU70QO6,13,17,9,0,3,0,15,1,45,6.428571428571429,4,0.0,0,9,0,3,17,0,0,15,1,12,33,0
2158,50919,MwsjD881hF2KUCEG3rXUPSq3GKMfMo2d,5Gyp41oLVo7Gg7vF4vpmggWP5MU70QO6,7,10,6,0,1,0,3,0,20,2.857142857142857,3,0.0,1,6,0,1,9,0,0,3,0,8,12,1
2159,50933,irhRnOsJYuxpNg5XBOqsIO4PAoGU2IoY,5Gyp41oLVo7Gg7vF4vpmggWP5MU70QO6,1,0,0,0,0,0,1,0,1,0.14285714285714285,1,0.0,0,0,0,0,0,0,0,1,0,0,1,1
2160,50950,U04y5vFf0AfyJVGIOJHlryTyRQEOm5pT,5Gyp41oLVo7Gg7vF4vpmggWP5MU70QO6,5,8,3,0,0,0,5,0,16,2.2857142857142856,3,0.0,0,3,0,0,8,0,0,5,0,3,13,0
2161,50994,eNQdUjKgDpXjtgshKzAH2kpRxsIu20wI,5Gyp41oLVo7Gg7vF4vpmggWP5MU70QO6,1,0,0,0,0,0,1,0,1,0.14285714285714285,1,0.0,0,0,0,0,0,0,0,1,0,0,1,1
2162,51046,K1pykS4XBq4CMEnRPAkBRQ0KuHn2G2FR,5Gyp41oLVo7Gg7vF4vpmggWP5MU70QO6,5,2,1,0,1,0,2,0,6,0.8571428571428571,1,0.0,0,1,0,1,2,0,0,2,0,2,4,1
2163,51052,0ElvyB1MiVzz5klxXQkmAKR1rTFeqHn9,5Gyp41oLVo7Gg7vF4vpmggWP5MU70QO6,11,15,7,8,3,0,4,0,37,5.285714285714286,4,0.0,4,7,6,3,11,0,2,4,0,20,17,0
2164,51055,6A60zadtj8FKi84VaMeYcSvKWRtVJvs6,5Gyp41oLVo7Gg7vF4vpmggWP5MU70QO6,41,139,34,34,34,353,48,3,645,92.14285714285714,15,0.0,18,34,25,34,121,353,9,48,3,111,534,1
2165,51056,sfsOsmVwJBxu6Zuz5Ndm1WMj56nnjiUs,5Gyp41oLVo7Gg7vF4vpmggWP5MU70QO6,9,8,0,6,0,0,3,0,17,2.4285714285714284,2,0.0,2,0,6,0,6,0,0,3,0,8,9,1
2166,51059,vSL0kRsKOWBMpC6pqEAxri0eLNug5E20,5Gyp41oLVo7Gg7vF4vpmggWP5MU70QO6,1,0,0,0,0,0,2,0,2,0.2857142857142857,1,0.0,0,0,0,0,0,0,0,2,0,0,2,1
2167,51136,NYceLerQzC2X1tSR9IDfk2VrbeTPT1db,5Gyp41oLVo7Gg7vF4vpmggWP5MU70QO6,18,32,11,12,13,0,4,0,72,10.285714285714286,2,0.0,15,11,6,13,17,0,6,4,0,45,27,1
2168,51150,bsTh1xFON0PPXlEOexejfdceRZ4CC8Hx,5Gyp41oLVo7Gg7vF4vpmggWP5MU70QO6,12,16,7,16,2,0,6,0,47,6.714285714285714,4,0.0,6,7,13,2,10,0,3,6,0,28,19,1
2169,51176,x14nioYZXOgcIkIJTp88ZtYltIrxA4Dy,5Gyp41oLVo7Gg7vF4vpmggWP5MU70QO6,1,0,0,0,0,0,2,0,2,0.2857142857142857,1,0.0,0,0,0,0,0,0,0,2,0,0,2,1
2170,51187,3eKiIXhRJU4AcaSK2OGxb5hm0pCKaHgd,5Gyp41oLVo7Gg7vF4vpmggWP5MU70QO6,9,3,2,0,2,0,6,1,14,2.0,1,0.0,0,2,0,2,3,0,0,6,1,4,10,1
2171,51215,HNZ8UVJXOjsBf9vs7pgIklpz5V5PnTac,5Gyp41oLVo7Gg7vF4vpmggWP5MU70QO6,5,3,1,0,1,0,1,0,6,0.8571428571428571,1,0.0,0,1,0,1,3,0,0,1,0,2,4,1
2172,51233,FbmJNri4rSwVM6BXSopSVdPwLJqrwwJ5,5Gyp41oLVo7Gg7vF4vpmggWP5MU70QO6,5,6,0,0,0,0,5,0,11,1.5714285714285714,4,0.0,0,0,0,0,6,0,0,5,0,0,11,1
2173,51242,lVwgv61cg8fkhW9rg5b1PIPnuUWxb0Vk,5Gyp41oLVo7Gg7vF4vpmggWP5MU70QO6,9,3,3,0,3,13,8,4,34,4.857142857142857,2,0.0,0,3,0,3,3,13,0,8,4,6,28,1
2174,51306,JxLtKAnMek98G5fWpyeTaKlh0zheuNnU,5Gyp41oLVo7Gg7vF4vpmggWP5MU70QO6,12,11,5,4,4,0,3,0,27,3.857142857142857,2,0.0,2,5,2,4,9,0,2,3,0,13,14,1
2175,51338,mTt9TVaQ6qcDrpUsX6Vyc0IYv4BlJlMi,5Gyp41oLVo7Gg7vF4vpmggWP5MU70QO6,1,0,0,0,0,0,1,0,1,0.14285714285714285,1,0.0,0,0,0,0,0,0,0,1,0,0,1,1
2176,51345,R3GQusqS3T8BBP6hUdls7DaRD06v0PCL,5Gyp41oLVo7Gg7vF4vpmggWP5MU70QO6,1,0,0,0,0,0,1,0,1,0.14285714285714285,1,0.0,0,0,0,0,0,0,0,1,0,0,1,1
2177,51384,ueh8Q0J414FE7Xmjqeh6AbzlK27RwSRw,5Gyp41oLVo7Gg7vF4vpmggWP5MU70QO6,1,0,0,0,0,0,1,0,1,0.14285714285714285,1,0.0,0,0,0,0,0,0,0,1,0,0,1,1
2178,51422,umh1eDwHp9o5woAgDLq7irEaHM3qlWx2,5Gyp41oLVo7Gg7vF4vpmggWP5MU70QO6,40,60,37,26,19,6,12,1,161,23.0,3,0.0,18,37,17,19,42,6,9,12,1,91,70,0
2179,51426,acXed7EOVLnzsuab64PTBE3RVCDYaMyv,5Gyp41oLVo7Gg7vF4vpmggWP5MU70QO6,7,7,2,0,2,0,5,0,16,2.2857142857142856,1,0.0,0,2,0,2,7,0,0,5,0,4,12,1
2180,51477,aZ9nebrSuYWjxv43atpyEZvrYwCfGfkB,5Gyp41oLVo7Gg7vF4vpmggWP5MU70QO6,7,4,3,0,1,0,2,0,10,1.4285714285714286,1,0.0,0,3,0,1,4,0,0,2,0,4,6,1
2181,51478,2HoTvbB5XhoxXrJjJBwk94t2kQYx0MlB,5Gyp41oLVo7Gg7vF4vpmggWP5MU70QO6,8,7,3,0,2,0,2,0,14,2.0,2,0.0,0,3,0,2,7,0,0,2,0,5,9,1
2182,51487,mU2fAUtLp5jLgHGiFf5pygTKY9O9K5i4,5Gyp41oLVo7Gg7vF4vpmggWP5MU70QO6,7,3,2,0,2,0,3,0,10,1.4285714285714286,1,0.0,0,2,0,2,3,0,0,3,0,4,6,1
2183,51495,yXQSmgRTBARynLVxQn0bjGRHaQjsMjoL,5Gyp41oLVo7Gg7vF4vpmggWP5MU70QO6,8,3,2,0,2,0,3,0,10,1.4285714285714286,1,0.0,0,2,0,2,3,0,0,3,0,4,6,1
2184,51511,wZxGcsfZmDyO3eZaMEp8V4Qxwmu1n6lt,5Gyp41oLVo7Gg7vF4vpmggWP5MU70QO6,56,112,47,66,43,11,20,4,303,43.285714285714285,8,0.0,44,47,54,43,68,11,12,20,4,188,115,0
2185,51517,Q4toQWMz5O0YPhQzU0icjhFgXM41EKSX,5Gyp41oLVo7Gg7vF4vpmggWP5MU70QO6,28,69,32,15,10,2,17,0,145,20.714285714285715,7,0.0,9,32,14,10,60,2,1,17,0,65,80,0
2186,51529,WhgcVmTFWo1dBarNNCAJnFUhFulnMlzP,5Gyp41oLVo7Gg7vF4vpmggWP5MU70QO6,1,0,0,0,0,0,1,0,1,0.14285714285714285,1,0.0,0,0,0,0,0,0,0,1,0,0,1,1
2187,51534,VZInThaP5bjFkTwTO2BoGxMGNvXGtUPg,5Gyp41oLVo7Gg7vF4vpmggWP5MU70QO6,7,4,3,0,2,0,2,0,11,1.5714285714285714,1,0.0,0,3,0,2,4,0,0,2,0,5,6,1
2188,51548,SH3THvT9ATqMny80GD63EuK5GGnf8XMU,5Gyp41oLVo7Gg7vF4vpmggWP5MU70QO6,5,9,0,0,0,1,8,0,18,2.5714285714285716,3,0.0,0,0,0,0,9,1,0,8,0,0,18,0
2189,51558,L39ZdOzVu52b5Nu8u3TuFdomCuDfGlbZ,5Gyp41oLVo7Gg7vF4vpmggWP5MU70QO6,21,21,16,2,9,0,5,0,53,7.571428571428571,2,0.0,1,16,1,9,20,0,1,5,0,27,26,1
2190,51574,A2TslyZ8TwcXRoKLLIx5H8X0qnPIGM93,5Gyp41oLVo7Gg7vF4vpmggWP5MU70QO6,4,3,0,0,0,0,2,0,5,0.7142857142857143,1,0.0,0,0,0,0,3,0,0,2,0,0,5,1
2191,51584,O1qqAub9LnJtRCJpB6uaaoNbBqZAzzPH,5Gyp41oLVo7Gg7vF4vpmggWP5MU70QO6,1,0,0,0,0,0,1,0,1,0.14285714285714285,1,0.0,0,0,0,0,0,0,0,1,0,0,1,1
2192,51602,AMvvVmOhJFXdorQhUjG7zbr0lpdmWFD7,5Gyp41oLVo7Gg7vF4vpmggWP5MU70QO6,13,10,7,0,4,0,6,0,27,3.857142857142857,2,0.0,0,7,0,4,10,0,0,6,0,11,16,1
2193,51607,dELrNUPf0LYnYKGiwZPbUyeEFznLuQat,5Gyp41oLVo7Gg7vF4vpmggWP5MU70QO6,5,2,1,0,1,0,2,0,6,0.8571428571428571,1,0.0,0,1,0,1,2,0,0,2,0,2,4,1
2194,51638,M6bmfgIp9dYLX3Zc75Ti7JeaGAhKkIIV,5Gyp41oLVo7Gg7vF4vpmggWP5MU70QO6,1,0,0,0,0,0,1,0,1,0.14285714285714285,1,0.0,0,0,0,0,0,0,0,1,0,0,1,1
2195,51689,wWbWyhQVaGyU5DEhZSbsADk6ecdZdZP3,5Gyp41oLVo7Gg7vF4vpmggWP5MU70QO6,1,0,0,0,0,0,1,0,1,0.14285714285714285,1,0.0,0,0,0,0,0,0,0,1,0,0,1,1
2196,51702,MDlXnb9rsG8JWVZUQtg4346WwlX7yiGH,5Gyp41oLVo7Gg7vF4vpmggWP5MU70QO6,6,2,1,0,2,0,3,0,8,1.1428571428571428,1,0.0,1,1,0,2,1,0,0,3,0,4,4,1
2197,51747,R6mWJ0ZeHkZWWi0xlkZZqK7iozuGXemG,5Gyp41oLVo7Gg7vF4vpmggWP5MU70QO6,9,4,3,0,3,0,19,0,29,4.142857142857143,3,0.0,1,3,0,3,3,0,0,19,0,7,22,1
2198,51800,SPVEPDWe7wKH8038B3lBhW6PSWSX6ArY,5Gyp41oLVo7Gg7vF4vpmggWP5MU70QO6,6,2,0,0,0,0,5,0,7,1.0,1,0.0,0,0,0,0,2,0,0,5,0,0,7,1
2199,51804,sfdgnQL9ZJy8iQoJsTh6pz33V1sjsZlD,5Gyp41oLVo7Gg7vF4vpmggWP5MU70QO6,11,29,14,0,0,25,14,1,83,11.857142857142858,2,0.0,3,14,0,0,26,25,0,14,1,17,66,1
2200,51816,YeRXVpkXvCF1S4W69VvqHCshoTfoJYx1,5Gyp41oLVo7Gg7vF4vpmggWP5MU70QO6,13,42,17,10,11,0,7,0,87,12.428571428571429,3,0.0,18,17,5,11,24,0,5,7,0,51,36,1
2201,51856,BHFxB9WSZUNA3bSbhXGfFvM0uldWsWSG,5Gyp41oLVo7Gg7vF4vpmggWP5MU70QO6,5,2,1,0,1,0,3,0,7,1.0,2,0.0,0,1,0,1,2,0,0,3,0,2,5,0
2202,51868,24686CbCuct6ibY6FEwXzhohAw2vtXBO,5Gyp41oLVo7Gg7vF4vpmggWP5MU70QO6,21,30,16,4,6,0,12,0,68,9.714285714285714,8,0.0,4,16,3,6,26,0,1,12,0,29,39,0
2203,51895,NzIOG5NJMUxeeqfkFuzJNfvgPL3Ojtwv,5Gyp41oLVo7Gg7vF4vpmggWP5MU70QO6,13,15,6,2,3,5,7,0,38,5.428571428571429,2,0.0,2,6,1,3,13,5,1,7,0,12,26,1
2204,51911,Ci9FGx4bWbxBIrvlwmLcaPnUTvif70a3,5Gyp41oLVo7Gg7vF4vpmggWP5MU70QO6,29,95,35,18,16,0,12,0,176,25.142857142857142,6,0.0,19,35,13,16,76,0,5,12,0,83,93,0
2205,51969,TZKmI0qv9Bws9wg22BGw0ShlF2CcTiea,5Gyp41oLVo7Gg7vF4vpmggWP5MU70QO6,11,10,4,8,2,2,12,1,39,5.571428571428571,1,0.0,6,4,4,2,4,2,4,12,1,16,23,1
2206,51976,IFxa36yYyTY0IScgqpr2YDZw1IrRnsiL,5Gyp41oLVo7Gg7vF4vpmggWP5MU70QO6,1,0,0,0,0,0,1,0,1,0.14285714285714285,1,0.0,0,0,0,0,0,0,0,1,0,0,1,1
2207,52001,rigObVsPw012mTLP7Xer1eLUaWsRqL0B,5Gyp41oLVo7Gg7vF4vpmggWP5MU70QO6,6,3,1,0,1,0,3,0,8,1.1428571428571428,1,0.0,0,1,0,1,3,0,0,3,0,2,6,1
2208,52012,1h7W4wzmG1Na13n5PFihFy3BFCvI9aUF,5Gyp41oLVo7Gg7vF4vpmggWP5MU70QO6,1,0,0,0,0,0,1,0,1,0.14285714285714285,1,0.0,0,0,0,0,0,0,0,1,0,0,1,1
2209,52013,UZj9qZ6lkWkIz7HEEFyBh5LFRNaz4SI2,5Gyp41oLVo7Gg7vF4vpmggWP5MU70QO6,5,2,1,0,1,0,3,0,7,1.0,1,0.0,0,1,0,1,2,0,0,3,0,2,5,1
2210,52015,o2EBQAVUG9zZ1N0mYC2wQkN5KDw2JsF9,5Gyp41oLVo7Gg7vF4vpmggWP5MU70QO6,1,0,0,0,0,0,1,0,1,0.14285714285714285,1,0.0,0,0,0,0,0,0,0,1,0,0,1,1
2211,52045,wL2WUNjeovd8v5fP8dkNYd0gn970jWmX,5Gyp41oLVo7Gg7vF4vpmggWP5MU70QO6,2,0,0,0,0,0,3,0,3,0.42857142857142855,1,0.0,0,0,0,0,0,0,0,3,0,0,3,1
2212,52073,SkqVAXXmBdrKaGu9COTBqlBrc4qsyWY0,5Gyp41oLVo7Gg7vF4vpmggWP5MU70QO6,11,9,3,2,2,1,8,0,25,3.5714285714285716,1,0.0,1,3,1,2,8,1,1,8,0,7,18,1
2213,52085,HuABcLMtHr6Y0RrPlzNhzgc87JaxJbDJ,5Gyp41oLVo7Gg7vF4vpmggWP5MU70QO6,5,2,1,0,1,0,2,0,6,0.8571428571428571,1,0.0,0,1,0,1,2,0,0,2,0,2,4,1
2214,52087,KZZhGQ4nBwlSXt2YkCYPVvuv8CEYCuv3,5Gyp41oLVo7Gg7vF4vpmggWP5MU70QO6,4,3,0,0,0,0,3,0,6,0.8571428571428571,1,0.0,0,0,0,0,3,0,0,3,0,0,6,1
2215,52096,5U79KRZxDDBIetuxjK0KXphUhzbxTzjr,5Gyp41oLVo7Gg7vF4vpmggWP5MU70QO6,10,15,7,0,2,0,3,0,27,3.857142857142857,2,0.0,3,7,0,2,12,0,0,3,0,12,15,1
2216,52097,TFz5IhIRCPFI3OwAYAZbVriTl2Kets7l,5Gyp41oLVo7Gg7vF4vpmggWP5MU70QO6,5,2,1,0,1,0,2,0,6,0.8571428571428571,1,0.0,0,1,0,1,2,0,0,2,0,2,4,1
2217,52126,MQvE5A8L0POnIFXzu10gx5cCAfVoSlB2,5Gyp41oLVo7Gg7vF4vpmggWP5MU70QO6,1,0,0,0,0,0,1,0,1,0.14285714285714285,1,0.0,0,0,0,0,0,0,0,1,0,0,1,1
2218,52128,CVNZnTiRds77aV88t7oO5JnyjLjE4gZ5,5Gyp41oLVo7Gg7vF4vpmggWP5MU70QO6,8,7,3,0,3,0,8,1,22,3.142857142857143,3,0.0,1,3,0,3,6,0,0,8,1,7,15,0
2219,52158,jtsBBwr9OFgAX0CtUxYKA8zuhME346wi,5Gyp41oLVo7Gg7vF4vpmggWP5MU70QO6,2,0,0,0,0,0,2,0,2,0.2857142857142857,1,0.0,0,0,0,0,0,0,0,2,0,0,2,0
2220,52180,xDcaASSFJhBnk43vPD1Z15YLfQOMVMNF,5Gyp41oLVo7Gg7vF4vpmggWP5MU70QO6,4,2,1,0,0,0,2,0,5,0.7142857142857143,1,0.0,0,1,0,0,2,0,0,2,0,1,4,1
2221,52183,k0RJg96Fpv2wERmrbwPIzHi2sDkVUGP1,5Gyp41oLVo7Gg7vF4vpmggWP5MU70QO6,31,87,48,26,18,26,23,1,229,32.714285714285715,10,0.0,22,48,24,18,65,26,2,23,1,112,117,1
2222,52199,sBOxdNnpJUq7xjCMDQDk623huheAshBl,5Gyp41oLVo7Gg7vF4vpmggWP5MU70QO6,11,13,6,0,3,0,5,1,28,4.0,2,0.0,0,6,0,3,13,0,0,5,1,9,19,1
2223,52208,5xBdESmY1nBvhCHUEPjhjxgP4SUV3nyi,5Gyp41oLVo7Gg7vF4vpmggWP5MU70QO6,1,0,0,0,0,0,1,0,1,0.14285714285714285,1,0.0,0,0,0,0,0,0,0,1,0,0,1,1
2224,52225,ZOdzp19tU4985pZGAlB8kRKe52hHtzEJ,5Gyp41oLVo7Gg7vF4vpmggWP5MU70QO6,2,0,0,0,0,0,2,0,2,0.2857142857142857,1,0.0,0,0,0,0,0,0,0,2,0,0,2,1
2225,52235,6r9w9XrCXpAInFHxfDIxOD9m18cX5jcd,5Gyp41oLVo7Gg7vF4vpmggWP5MU70QO6,1,0,0,0,0,0,1,0,1,0.14285714285714285,1,0.0,0,0,0,0,0,0,0,1,0,0,1,1
2226,52243,BwaZCJgJk3McTWZaifCsx9alpiilOhBE,5Gyp41oLVo7Gg7vF4vpmggWP5MU70QO6,10,21,11,0,1,34,17,1,85,12.142857142857142,5,0.0,4,11,0,1,17,34,0,17,1,16,69,1
2227,52247,KqGR4psq39mn0SAoxpJqPFEQt3ilwYa8,5Gyp41oLVo7Gg7vF4vpmggWP5MU70QO6,5,3,1,0,1,0,2,0,7,1.0,1,0.0,0,1,0,1,3,0,0,2,0,2,5,1
2228,52274,ChLYb6LYBFg2XNE33gE0X7v4FlbTtzEZ,5Gyp41oLVo7Gg7vF4vpmggWP5MU70QO6,1,0,0,0,0,0,1,0,1,0.14285714285714285,1,0.0,0,0,0,0,0,0,0,1,0,0,1,1
2229,52320,6QJrVrU15RwYswqP91jLfBByHdY6ePwM,5Gyp41oLVo7Gg7vF4vpmggWP5MU70QO6,9,7,3,0,3,4,6,0,23,3.2857142857142856,2,0.0,1,3,0,3,6,4,0,6,0,7,16,1
2230,52329,0M1738scr3UPDiDGNVEZtY01qtS2Scga,5Gyp41oLVo7Gg7vF4vpmggWP5MU70QO6,8,3,2,0,2,0,3,0,10,1.4285714285714286,1,0.0,0,2,0,2,3,0,0,3,0,4,6,1
2231,52332,ECIKY7UVyqdc5rfdBpc5OKQ4L4XJnBZ3,5Gyp41oLVo7Gg7vF4vpmggWP5MU70QO6,7,2,1,0,1,0,8,1,13,1.8571428571428572,1,0.0,0,1,0,1,2,0,0,8,1,2,11,1
2232,52359,0t3Bc6GJdFKSDrPfrCWxDJ33tvFzV4Gw,5Gyp41oLVo7Gg7vF4vpmggWP5MU70QO6,5,6,0,0,0,0,5,0,11,1.5714285714285714,1,0.0,0,0,0,0,6,0,0,5,0,0,11,1
2233,52451,EcvMrbxqb9Hu5or0mXUSfB1IsR9KbRvG,5X6FeZozNMgE2VRi3MJYjkkFK8SETtu2,5,5,1,0,1,0,2,0,9,1.2857142857142858,1,0.0,3,1,0,1,2,0,0,2,0,5,4,1
2234,52495,knUloC1tBi2LXsmD9KzPebmyzGJ327i5,5X6FeZozNMgE2VRi3MJYjkkFK8SETtu2,5,16,11,0,4,0,2,0,33,4.714285714285714,5,0.0,0,11,0,4,16,0,0,2,0,15,18,1
2235,52504,dTE2gkSy9lx7HiJblz4dkkDKbW2NyCb8,5X6FeZozNMgE2VRi3MJYjkkFK8SETtu2,34,49,9,79,18,0,3,0,158,22.571428571428573,3,0.0,36,9,58,18,13,0,21,3,0,121,37,1
2236,52511,YTuPtoiiUgMUEO0EcQhHENEgNCcauWbW,5X6FeZozNMgE2VRi3MJYjkkFK8SETtu2,3,2,1,0,0,0,1,0,4,0.5714285714285714,1,0.0,0,1,0,0,2,0,0,1,0,1,3,1
2237,52622,lRuRgYuxlfG4wGoaGOQqJl3BAifyNcHA,5X6FeZozNMgE2VRi3MJYjkkFK8SETtu2,1,0,0,0,0,0,1,0,1,0.14285714285714285,1,0.0,0,0,0,0,0,0,0,1,0,0,1,1
2238,52630,up9RsivyokQDdIY9XjceWgPIaWSXiHeb,5X6FeZozNMgE2VRi3MJYjkkFK8SETtu2,15,16,2,12,5,0,2,0,37,5.285714285714286,2,0.0,7,2,12,5,9,0,0,2,0,26,11,1
2239,52789,OO7beVHPObBfPwHA9jIrdvSr48hMom1m,7GRhBDsirIGkRZBtSMEzNTyDr2JQm4xx,3,9,2,0,2,0,0,0,13,1.8571428571428572,6,0.0,0,2,0,2,9,0,0,0,0,4,9,0
2240,52964,AOjqu8OTCPaKqT40dsKKHuXenHhl1lM6,5X6FeZozNMgE2VRi3MJYjkkFK8SETtu2,1,0,0,0,0,0,1,0,1,0.14285714285714285,1,0.0,0,0,0,0,0,0,0,1,0,0,1,1
2241,53046,t8qBiDTvOvYmrxcVIErRuEOf38tywm6t,bWdj2GDclj5ofokWjzoa5jAwMkxCykd6,21,31,26,2,5,20,8,1,93,13.285714285714286,3,0.0,0,26,1,5,31,20,1,8,1,32,61,1
2242,53049,8cVIhj7cvR0q9dzupEColmwPbOHZ624c,SpATywNh6bZuzm8s1ceuBUnMUAeoAHHw,20,13,9,12,5,0,4,0,43,6.142857142857143,1,0.0,2,9,11,5,11,0,1,4,0,27,16,0
2243,53119,AwKhkfPOqEnTXG1Cn8Gmf8HHhYnwnTgu,SpATywNh6bZuzm8s1ceuBUnMUAeoAHHw,7,5,1,0,1,0,1,0,8,1.1428571428571428,1,0.0,0,1,0,1,5,0,0,1,0,2,6,1
2244,53170,BBcMLJIRqEjAV0Iy0PZLL6aDRdsecvdG,G8EPVSXsOYB5YQWZGiz1aVq5Pgr2GrQu,21,33,2,12,4,1,9,0,61,8.714285714285714,1,0.0,7,2,11,4,26,1,1,9,0,24,37,1
2245,53194,5y4YA2mbDcwuEjNHeStgjLfqN1rsKZgP,SpATywNh6bZuzm8s1ceuBUnMUAeoAHHw,23,62,3,35,1,0,3,0,104,14.857142857142858,2,0.0,34,3,30,1,28,0,5,3,0,68,36,0
2246,53209,GOcyurvQpr52NaTeXKp3vF6yg377GcU5,SpATywNh6bZuzm8s1ceuBUnMUAeoAHHw,12,34,1,22,0,0,3,2,62,8.857142857142858,1,0.0,4,1,22,0,30,0,0,3,2,27,35,0
2247,53360,boitIxZvCZ9przAKAQqxtWTvavMJkqzn,SpATywNh6bZuzm8s1ceuBUnMUAeoAHHw,33,28,21,16,14,0,3,0,82,11.714285714285714,3,0.0,4,21,15,14,24,0,1,3,0,54,28,0
2248,53381,hJ48EYDAUcnIubJFw4NRxQxCK6ApJIxf,SpATywNh6bZuzm8s1ceuBUnMUAeoAHHw,7,5,2,13,0,0,1,0,21,3.0,1,0.0,2,2,11,0,3,0,2,1,0,15,6,1
2249,53453,A4vEkOAwhpQEgLFKtjOc7tdIxawwQcIi,SpATywNh6bZuzm8s1ceuBUnMUAeoAHHw,6,10,7,0,2,0,3,0,22,3.142857142857143,1,0.0,0,7,0,2,10,0,0,3,0,9,13,1
2250,53462,9rLNySnV0yxkzZA7V8enLIbzXZCrF6IJ,RXDvfPUBYFlVdlueBFbLW0mhhAyGEqpt,7,8,4,0,2,1,3,11,29,4.142857142857143,1,0.0,0,4,0,2,8,1,0,3,11,6,23,0
2251,53501,5vi4PfMqn3pILscFmPde7WIp5OpFzjzt,SpATywNh6bZuzm8s1ceuBUnMUAeoAHHw,19,17,8,42,1,3,3,0,74,10.571428571428571,2,0.0,6,8,38,1,11,3,4,3,0,53,21,0
2252,53669,j79CPp6e09l3A1MeqgSV5ajYlxbk9Ixy,A3fsA9Zfv1X2fVEQhTw51lKENdNrEqT3,8,3,2,14,0,0,1,0,20,2.857142857142857,1,0.0,0,2,14,0,3,0,0,1,0,16,4,1
2253,53721,lSVRjk6dkgEmIe9I21hvsRF98Lf2IKdM,SpATywNh6bZuzm8s1ceuBUnMUAeoAHHw,20,18,11,9,6,0,4,0,48,6.857142857142857,1,0.0,2,11,9,6,16,0,0,4,0,28,20,1
2254,53766,KIPXc8MOqmnlmMqnIzIeaBqliIw9pS44,SpATywNh6bZuzm8s1ceuBUnMUAeoAHHw,5,3,2,0,1,1,1,0,8,1.1428571428571428,1,0.0,0,2,0,1,3,1,0,1,0,3,5,1
2255,53792,p62iTg6ZpvzODJCBLH2d7SVfdoSWuy8j,RXDvfPUBYFlVdlueBFbLW0mhhAyGEqpt,39,29,13,39,9,0,4,0,94,13.428571428571429,3,0.0,8,13,39,9,21,0,0,4,0,69,25,0
2256,53916,BsBj37bM37sYKQjSXV07xFL8gbIptVn8,bWdj2GDclj5ofokWjzoa5jAwMkxCykd6,4,2,0,0,0,0,2,0,4,0.5714285714285714,1,0.0,0,0,0,0,2,0,0,2,0,0,4,1
2257,54035,6UfIu5SKHPYfwZxBxJpGSqhLHKhbdsl0,SpATywNh6bZuzm8s1ceuBUnMUAeoAHHw,3,2,1,0,0,0,2,0,5,0.7142857142857143,1,0.0,0,1,0,0,2,0,0,2,0,1,4,0
2258,54045,A9hKsxxgL4q5b7FGmUZTmhhYJ9IUDrBm,SpATywNh6bZuzm8s1ceuBUnMUAeoAHHw,2,0,0,0,0,0,3,0,3,0.42857142857142855,2,0.0,0,0,0,0,0,0,0,3,0,0,3,0
2259,54086,uIIavYxNuEJ6NG2Ex383dBZvdILceLZJ,SpATywNh6bZuzm8s1ceuBUnMUAeoAHHw,8,11,5,0,3,0,4,0,23,3.2857142857142856,3,0.0,0,5,0,3,11,0,0,4,0,8,15,0
2260,54093,1rAHmNrxrqnzHEQFMlydmQ968LsZW0oG,RXDvfPUBYFlVdlueBFbLW0mhhAyGEqpt,1,0,0,0,0,0,1,0,1,0.14285714285714285,1,0.0,0,0,0,0,0,0,0,1,0,0,1,1
2261,54112,GASbwPXxwryodKV3AqYKdU5jEaEhIE7r,SpATywNh6bZuzm8s1ceuBUnMUAeoAHHw,17,16,1,6,1,0,10,0,34,4.857142857142857,4,0.0,0,1,5,1,16,0,1,10,0,7,27,0
2262,54120,S9bleRJbl0xJFa4yPXuTgULWJ67nbMqi,SpATywNh6bZuzm8s1ceuBUnMUAeoAHHw,5,9,4,0,3,0,1,0,17,2.4285714285714284,1,0.0,0,4,0,3,9,0,0,1,0,7,10,0
2263,54151,6f80AuCxgLhEz4q3r0Z7Tne4jeBhxVpZ,SpATywNh6bZuzm8s1ceuBUnMUAeoAHHw,20,21,10,20,5,0,4,0,60,8.571428571428571,1,0.0,7,10,16,5,14,0,4,4,0,38,22,0
2264,54156,QYaJtD7z5M6YcGNpdHV2JTsxqV4tXm9a,SpATywNh6bZuzm8s1ceuBUnMUAeoAHHw,14,13,8,11,0,0,2,0,34,4.857142857142857,1,0.0,2,8,10,0,11,0,1,2,0,20,14,0
2265,54189,cN6OZq4ak5IqzN7Lw32XLOS12DhlWO8Q,A3fsA9Zfv1X2fVEQhTw51lKENdNrEqT3,7,5,3,0,0,3,4,0,15,2.142857142857143,1,0.0,0,3,0,0,5,3,0,4,0,3,12,0
2266,54193,smg4SHkT0uQ59GP6Camalxkw6c32vtzM,SpATywNh6bZuzm8s1ceuBUnMUAeoAHHw,22,23,0,22,0,0,6,0,51,7.285714285714286,2,0.0,5,0,20,0,18,0,2,6,0,25,26,0
2267,54196,4mLn5YrkZbnxPXEuAYTSn9TKZyVmWQjo,SpATywNh6bZuzm8s1ceuBUnMUAeoAHHw,10,10,1,0,1,0,2,0,14,2.0,1,0.0,0,1,0,1,10,0,0,2,0,2,12,0
2268,54256,wtEiMTsSGyqVYmzAUWtaJeXU5b3t5li0,SpATywNh6bZuzm8s1ceuBUnMUAeoAHHw,14,21,6,26,0,0,1,0,54,7.714285714285714,1,0.0,14,6,20,0,7,0,6,1,0,40,14,0
2269,54326,Fq6XRhpyARqo3e2KmYQqUPcebNvG6D8A,SpATywNh6bZuzm8s1ceuBUnMUAeoAHHw,7,4,0,1,0,0,3,0,8,1.1428571428571428,1,0.0,0,0,1,0,4,0,0,3,0,1,7,1
2270,54403,IiprEhfBJUF3Volv4Wt8hDKs67azhw4N,SpATywNh6bZuzm8s1ceuBUnMUAeoAHHw,20,22,1,17,3,14,2,0,59,8.428571428571429,2,0.0,7,1,14,3,15,14,3,2,0,25,34,0
2271,54539,obFplu8p0J5bdsesTSoaj6Bc4UGbTB6M,A3fsA9Zfv1X2fVEQhTw51lKENdNrEqT3,1,0,0,0,0,0,1,0,1,0.14285714285714285,1,0.0,0,0,0,0,0,0,0,1,0,0,1,1
2272,54589,TFbXWoitMnOMl2WspWQeF8K8fD3FgeDB,fbPkOYLVPtPgIt0MxizjfFJov3JbHyAi,1,0,0,0,0,0,1,0,1,0.14285714285714285,1,0.0,0,0,0,0,0,0,0,1,0,0,1,1
2273,54594,5U0rvr3pqkKVd5Jhr1Idago4kekvZ7Qd,fbPkOYLVPtPgIt0MxizjfFJov3JbHyAi,1,0,0,0,0,0,1,0,1,0.14285714285714285,1,0.0,0,0,0,0,0,0,0,1,0,0,1,1
2274,54599,36RjzRPygGsRdCxzhcBfbwPaas6Hv1AB,fbPkOYLVPtPgIt0MxizjfFJov3JbHyAi,10,18,0,7,1,1,4,1,32,4.571428571428571,1,0.0,5,0,5,1,13,1,2,4,1,11,21,1
2275,54601,U7Pbnvw6ous6eMpEApyMcKGIm8NhiIVb,fbPkOYLVPtPgIt0MxizjfFJov3JbHyAi,1,0,0,0,0,0,1,0,1,0.14285714285714285,1,0.0,0,0,0,0,0,0,0,1,0,0,1,1
2276,54609,zqJYLp2Za4wDRWdLkC6hOzbgm2qW4Dc0,fbPkOYLVPtPgIt0MxizjfFJov3JbHyAi,1,0,0,0,0,0,1,0,1,0.14285714285714285,1,0.0,0,0,0,0,0,0,0,1,0,0,1,1
2277,54611,w50jSI5RjqfAgmbAtDpAViImkLRNEU1B,fbPkOYLVPtPgIt0MxizjfFJov3JbHyAi,2,0,0,0,0,0,2,0,2,0.2857142857142857,1,0.0,0,0,0,0,0,0,0,2,0,0,2,1
2278,54612,3AcdZj2eRws1eHnIlNRTeIlmDqR0IPnY,fbPkOYLVPtPgIt0MxizjfFJov3JbHyAi,1,0,0,0,0,0,1,0,1,0.14285714285714285,1,0.0,0,0,0,0,0,0,0,1,0,0,1,1
2279,54613,KHpSQIE01XQJLtU5vhXvwADIT0s4ocMd,fbPkOYLVPtPgIt0MxizjfFJov3JbHyAi,2,0,0,0,0,0,4,0,4,0.5714285714285714,1,0.0,0,0,0,0,0,0,0,4,0,0,4,1
2280,54623,LDoffeIzXBaEA3EoYd9Gp4Kl36LUuUJD,fbPkOYLVPtPgIt0MxizjfFJov3JbHyAi,11,9,6,5,4,0,7,0,31,4.428571428571429,1,0.0,1,6,3,4,8,0,2,7,0,14,17,1
2281,54626,qowpjfcpUK1iU9rrtJ9U3WvarOVtt4V0,fbPkOYLVPtPgIt0MxizjfFJov3JbHyAi,1,0,0,0,0,0,2,0,2,0.2857142857142857,1,0.0,0,0,0,0,0,0,0,2,0,0,2,1
2282,54631,cZaJE9WXhMzWTnSMxu0NdfVeWxOkn7lj,fbPkOYLVPtPgIt0MxizjfFJov3JbHyAi,2,0,0,0,0,0,2,0,2,0.2857142857142857,1,0.0,0,0,0,0,0,0,0,2,0,0,2,1
2283,54632,WYnjjnMJs3hcSus3wsuOF4Oq6comfAXw,fbPkOYLVPtPgIt0MxizjfFJov3JbHyAi,35,33,23,0,13,0,7,0,76,10.857142857142858,1,0.0,0,23,0,13,33,0,0,7,0,36,40,1
2284,54633,dTyQ7W3SS3T02L83rAdjVWHrGRV4tFve,fbPkOYLVPtPgIt0MxizjfFJov3JbHyAi,8,4,2,0,3,0,1,0,10,1.4285714285714286,1,0.0,0,2,0,3,4,0,0,1,0,5,5,1
2285,54638,Mdfw3Q8oYP333LBMIERuMcnF8vYJNJ5b,fbPkOYLVPtPgIt0MxizjfFJov3JbHyAi,11,6,5,0,5,0,4,0,20,2.857142857142857,1,0.0,0,5,0,5,6,0,0,4,0,10,10,1
2286,54640,DVOHqEW2vUL1QpZynG6huVjAWwl1vI6M,fbPkOYLVPtPgIt0MxizjfFJov3JbHyAi,3,2,0,0,0,0,1,0,3,0.42857142857142855,1,0.0,0,0,0,0,2,0,0,1,0,0,3,1
2287,54642,1SXEIjzcoG8fdGB2rpSblj2HngER2yeu,fbPkOYLVPtPgIt0MxizjfFJov3JbHyAi,2,0,0,0,0,0,3,0,3,0.42857142857142855,1,0.0,0,0,0,0,0,0,0,3,0,0,3,1
2288,54644,X8FsaAv2Du3OE8bDKmARRecRJlZv4Av6,fbPkOYLVPtPgIt0MxizjfFJov3JbHyAi,2,0,0,0,0,0,4,0,4,0.5714285714285714,1,0.0,0,0,0,0,0,0,0,4,0,0,4,1
2289,54647,iNOoAvHUSfXxnF08qxfzfj0WmtUTTaRF,fbPkOYLVPtPgIt0MxizjfFJov3JbHyAi,11,8,6,0,5,0,9,1,29,4.142857142857143,2,0.0,1,6,0,5,7,0,0,9,1,12,17,1
2290,54649,MOIvgRd1Za1CsX2aG6XCAFZF5Iim3dN2,fbPkOYLVPtPgIt0MxizjfFJov3JbHyAi,1,0,0,0,0,0,1,0,1,0.14285714285714285,1,0.0,0,0,0,0,0,0,0,1,0,0,1,1
2291,54650,HvF4MJdW9mM4Uba858ulPV9LRY45bMal,fbPkOYLVPtPgIt0MxizjfFJov3JbHyAi,7,5,1,0,1,0,2,0,9,1.2857142857142858,1,0.0,0,1,0,1,5,0,0,2,0,2,7,1
2292,54651,i2JNGTgmf1lOGK2KnwkVCH8cCTETzhrF,fbPkOYLVPtPgIt0MxizjfFJov3JbHyAi,2,0,0,0,0,0,2,0,2,0.2857142857142857,1,0.0,0,0,0,0,0,0,0,2,0,0,2,1
2293,54653,N3bEDA47IlbzAbjhdudWg0K3fl1rro1B,fbPkOYLVPtPgIt0MxizjfFJov3JbHyAi,2,0,0,0,0,0,2,0,2,0.2857142857142857,1,0.0,0,0,0,0,0,0,0,2,0,0,2,1
2294,54655,LAwGJ37pqq1lJyt65gGidYJTzcBCIYfb,fbPkOYLVPtPgIt0MxizjfFJov3JbHyAi,6,2,1,0,1,0,3,0,7,1.0,1,0.0,0,1,0,1,2,0,0,3,0,2,5,1
2295,54656,vGZ3iFC7cl51KRfkdZMl5JdMbTFw6ygX,fbPkOYLVPtPgIt0MxizjfFJov3JbHyAi,5,4,0,0,0,0,2,0,6,0.8571428571428571,1,0.0,0,0,0,0,4,0,0,2,0,0,6,1
2296,54658,68Dxo5Uz0aGDvHTFGMu5vw31QRJ7GnRc,fbPkOYLVPtPgIt0MxizjfFJov3JbHyAi,8,6,4,0,4,0,1,0,15,2.142857142857143,1,0.0,0,4,0,4,6,0,0,1,0,8,7,1
2297,54662,2oTvbzieHn2y5oozeOgSnruqE6N0BtR5,fbPkOYLVPtPgIt0MxizjfFJov3JbHyAi,4,3,2,0,0,7,1,0,13,1.8571428571428572,1,0.0,0,2,0,0,3,7,0,1,0,2,11,1
2298,54669,bYjPoNbc5ILh7K7s9YR8HLOMNJGN6Ums,SpATywNh6bZuzm8s1ceuBUnMUAeoAHHw,30,40,35,0,30,0,2,0,107,15.285714285714286,1,0.0,1,35,0,30,39,0,0,2,0,66,41,0
2299,54691,goA9z819kccFvSfjnBmFLW5zxeJMJD6F,A3fsA9Zfv1X2fVEQhTw51lKENdNrEqT3,1,0,0,0,0,0,1,0,1,0.14285714285714285,1,0.0,0,0,0,0,0,0,0,1,0,0,1,1
2300,54713,GtuEelYfNaXxzKOllxbFfafnobOPHIGx,bWdj2GDclj5ofokWjzoa5jAwMkxCykd6,6,2,1,0,1,0,3,0,7,1.0,1,0.0,0,1,0,1,2,0,0,3,0,2,5,0
2301,54714,GtuEelYfNaXxzKOllxbFfafnobOPHIGx,A3fsA9Zfv1X2fVEQhTw51lKENdNrEqT3,3,2,1,0,0,0,1,0,4,0.5714285714285714,1,0.0,0,1,0,0,2,0,0,1,0,1,3,1
2302,54747,s2cJROUkYxvmOCaBfdTAC4ldoFLwdJSw,A3fsA9Zfv1X2fVEQhTw51lKENdNrEqT3,5,2,1,0,1,0,4,0,8,1.1428571428571428,2,0.0,0,1,0,1,2,0,0,4,0,2,6,1
2303,54753,8XalsjWgV9vFGi86xQSXkMYKuQx0bDjR,SpATywNh6bZuzm8s1ceuBUnMUAeoAHHw,2,0,0,0,0,0,2,0,2,0.2857142857142857,1,0.0,0,0,0,0,0,0,0,2,0,0,2,1
2304,54772,YfpBRnRxCpR1TK7m0C7otuwPOThrM107,A3fsA9Zfv1X2fVEQhTw51lKENdNrEqT3,8,2,2,0,2,0,3,0,9,1.2857142857142858,1,0.0,0,2,0,2,2,0,0,3,0,4,5,1
2305,54784,KQPXidcwG060yQGJPDlINxK2yFVflTSt,SpATywNh6bZuzm8s1ceuBUnMUAeoAHHw,1,0,0,0,0,0,1,0,1,0.14285714285714285,1,0.0,0,0,0,0,0,0,0,1,0,0,1,1
2306,54786,MgEz8Kh24CoQLmplPmrXNZfiSa5njivf,bWdj2GDclj5ofokWjzoa5jAwMkxCykd6,13,27,3,74,4,2,6,0,116,16.571428571428573,2,0.0,16,3,72,4,11,2,2,6,0,95,21,1
2307,54806,CyhW9ceUO9NYz6xFgPeXoLjeNitx4OvW,5X6FeZozNMgE2VRi3MJYjkkFK8SETtu2,1,0,0,0,0,0,1,0,1,0.14285714285714285,1,0.0,0,0,0,0,0,0,0,1,0,0,1,1
2308,54831,oMY23DevzUsmhDrGNgzC3AgbyiZkq9X2,bWdj2GDclj5ofokWjzoa5jAwMkxCykd6,18,11,1,0,1,0,8,1,22,3.142857142857143,1,0.0,0,1,0,1,11,0,0,8,1,2,20,0
2309,54832,XTByA0ecuKljeTXiSoi3vawyiYSNo5Ez,SpATywNh6bZuzm8s1ceuBUnMUAeoAHHw,38,151,76,23,33,21,14,0,318,45.42857142857143,3,0.0,63,76,22,33,88,21,1,14,0,194,124,0
2310,54836,pVK8kwJmTtFRhseEFXqi0Vcn8D0v4GEA,bWdj2GDclj5ofokWjzoa5jAwMkxCykd6,50,32,18,178,7,7,4,1,247,35.285714285714285,2,0.0,12,18,174,7,20,7,4,4,1,211,36,1
2311,54850,nEzidwd1f4tZP3mnFNbL1NYH0VtiIG9o,SpATywNh6bZuzm8s1ceuBUnMUAeoAHHw,1,0,0,0,0,0,1,0,1,0.14285714285714285,1,0.0,0,0,0,0,0,0,0,1,0,0,1,1
2312,54867,5PKcR4qIlFoFDgQbZBaaE6PaBQr3UBHF,A3fsA9Zfv1X2fVEQhTw51lKENdNrEqT3,33,22,13,56,8,1,20,0,120,17.142857142857142,1,0.0,2,13,51,8,20,1,5,20,0,74,46,1
2313,54893,MZomFQTbHAKaDGd0B9fv7KQ9MRsZJ7m6,7GRhBDsirIGkRZBtSMEzNTyDr2JQm4xx,5,3,2,0,2,1,2,0,10,1.4285714285714286,1,0.0,0,2,0,2,3,1,0,2,0,4,6,1
2314,54931,x89YyfX1v9jrCXDDiy9HsPZFNZWRlfiG,SpATywNh6bZuzm8s1ceuBUnMUAeoAHHw,15,11,1,8,0,0,3,0,23,3.2857142857142856,2,0.0,0,1,8,0,11,0,0,3,0,9,14,0
2315,54936,BY9YLSZcQDQQEQ3MNU6DAt6np51iLH0O,A3fsA9Zfv1X2fVEQhTw51lKENdNrEqT3,7,5,1,0,1,0,1,0,8,1.1428571428571428,1,0.0,0,1,0,1,5,0,0,1,0,2,6,1
2316,54970,YbQfcgwKrjskWW3wyOzQUUJYzdeHmY82,A3fsA9Zfv1X2fVEQhTw51lKENdNrEqT3,4,5,2,0,0,0,3,0,10,1.4285714285714286,2,0.0,2,2,0,0,3,0,0,3,0,4,6,0
2317,54981,Zyf4Fx2Q4VGwgsd2tRc1f9GIxHAqsh1E,SpATywNh6bZuzm8s1ceuBUnMUAeoAHHw,4,3,0,0,0,0,2,0,5,0.7142857142857143,1,0.0,0,0,0,0,3,0,0,2,0,0,5,1
2318,54983,9TfZcuW9XFphtEgwQrccxCFHKScgn5mj,SpATywNh6bZuzm8s1ceuBUnMUAeoAHHw,2,0,0,0,0,0,2,0,2,0.2857142857142857,1,0.0,0,0,0,0,0,0,0,2,0,0,2,1
2319,54997,IJWUl0dWQiuiW9w5y2FbSbROivrhPUri,G8EPVSXsOYB5YQWZGiz1aVq5Pgr2GrQu,8,9,5,0,1,3,5,0,23,3.2857142857142856,2,0.0,1,5,0,1,8,3,0,5,0,7,16,0
2320,55002,crL8XlHfgGxCO2yU3loQgEUYoD6TDz3m,SpATywNh6bZuzm8s1ceuBUnMUAeoAHHw,2,0,0,0,0,0,2,0,2,0.2857142857142857,1,0.0,0,0,0,0,0,0,0,2,0,0,2,1
2321,55003,PnDN2WssnANedhxbDqo06cZR8VfXOHcf,SpATywNh6bZuzm8s1ceuBUnMUAeoAHHw,20,46,16,36,0,75,16,1,190,27.142857142857142,6,0.0,20,16,31,0,26,75,5,16,1,67,123,0
2322,55008,D4QPb866p0LB9x0Ul2B3bay8zRlCxMSN,SpATywNh6bZuzm8s1ceuBUnMUAeoAHHw,1,0,0,0,0,0,1,0,1,0.14285714285714285,1,0.0,0,0,0,0,0,0,0,1,0,0,1,1
2323,55011,44NSfhUNLUI5lCBFMkEs9Un2s2Oz0cz0,SpATywNh6bZuzm8s1ceuBUnMUAeoAHHw,12,19,0,15,0,2,7,1,44,6.285714285714286,1,0.0,12,0,13,0,7,2,2,7,1,25,19,1
2324,55032,VT9jjElVjpMsf2zIziMAJWphCCTuBSUt,A3fsA9Zfv1X2fVEQhTw51lKENdNrEqT3,39,13,9,62,8,0,10,0,102,14.571428571428571,1,0.0,4,9,55,8,9,0,7,10,0,76,26,1
2325,55046,OsjipUObm67JsyJjOy7xHoa32L8CSYg5,7GRhBDsirIGkRZBtSMEzNTyDr2JQm4xx,36,47,4,28,11,0,9,0,99,14.142857142857142,3,0.0,25,4,28,11,22,0,0,9,0,68,31,1
2326,55055,p7kSnjO0uUcIRggHewx0HDSWkZbQpZMf,A3fsA9Zfv1X2fVEQhTw51lKENdNrEqT3,1,0,0,0,0,0,1,0,1,0.14285714285714285,1,0.0,0,0,0,0,0,0,0,1,0,0,1,1
2327,55057,95rBh3nA5ryqebDyyAi8HuMMGjJOTX7y,SpATywNh6bZuzm8s1ceuBUnMUAeoAHHw,34,32,24,12,21,9,7,0,105,15.0,2,0.0,7,24,12,21,25,9,0,7,0,64,41,0
2328,55068,gKSJfTKRpPRCZVoRPeT84zeHU3dzpwjK,SpATywNh6bZuzm8s1ceuBUnMUAeoAHHw,1,0,0,0,0,0,1,0,1,0.14285714285714285,1,0.0,0,0,0,0,0,0,0,1,0,0,1,1
2329,55073,5bLca2NVfaOvMosrC3znHH0bACGNInJI,SpATywNh6bZuzm8s1ceuBUnMUAeoAHHw,14,21,7,19,5,1,2,0,55,7.857142857142857,1,0.0,13,7,18,5,8,1,1,2,0,43,12,0
2330,55086,PfTpx7WgTJY6IpNokJ2POml34GMs7LTI,A3fsA9Zfv1X2fVEQhTw51lKENdNrEqT3,40,16,13,70,9,0,3,0,111,15.857142857142858,1,0.0,1,13,68,9,15,0,2,3,0,91,20,0
2331,55096,UvQMiNijSBGXihS0IyD8hVQt9aLPd6yp,SpATywNh6bZuzm8s1ceuBUnMUAeoAHHw,6,1,1,0,1,0,3,0,6,0.8571428571428571,1,0.0,0,1,0,1,1,0,0,3,0,2,4,1
2332,55102,tC06tDcyfiakkQ82nvNuQ9hOr0id1lp4,A3fsA9Zfv1X2fVEQhTw51lKENdNrEqT3,1,0,0,0,0,0,1,0,1,0.14285714285714285,1,0.0,0,0,0,0,0,0,0,1,0,0,1,1
2333,55108,oASR1hbK6DD6OJfTJCDKLW9l2vPgw7kR,SpATywNh6bZuzm8s1ceuBUnMUAeoAHHw,5,7,5,0,0,0,2,0,14,2.0,2,0.0,0,5,0,0,7,0,0,2,0,5,9,0
2334,55118,o32R7MADzv6ZJXN2A9yz9F4MgrJJw9Qs,G8EPVSXsOYB5YQWZGiz1aVq5Pgr2GrQu,1,0,0,0,0,0,1,0,1,0.14285714285714285,1,0.0,0,0,0,0,0,0,0,1,0,0,1,1
2335,55150,YEb4IhQ2RxrCQodPIxBL4Z2QiEDyCZuY,SpATywNh6bZuzm8s1ceuBUnMUAeoAHHw,5,2,1,0,1,0,2,0,6,0.8571428571428571,1,0.0,0,1,0,1,2,0,0,2,0,2,4,0
2336,55157,yUIi2GUBxhysS9d9StVXyKUpISr6ANil,bWdj2GDclj5ofokWjzoa5jAwMkxCykd6,20,22,13,18,7,0,14,0,74,10.571428571428571,1,0.0,6,13,18,7,16,0,0,14,0,44,30,0
2337,55167,gKSJfTKRpPRCZVoRPeT84zeHU3dzpwjK,A3fsA9Zfv1X2fVEQhTw51lKENdNrEqT3,1,0,0,0,0,0,1,0,1,0.14285714285714285,1,0.0,0,0,0,0,0,0,0,1,0,0,1,1
2338,55184,oVT1DSRDmSOI9P6Fvaw4mU7McCnHmOfz,bWdj2GDclj5ofokWjzoa5jAwMkxCykd6,5,2,1,0,1,0,5,0,9,1.2857142857142858,2,0.0,0,1,0,1,2,0,0,5,0,2,7,1
2339,55218,9DhjEr6688N0pGcvfzUDBy2Ch8BrzD6G,SpATywNh6bZuzm8s1ceuBUnMUAeoAHHw,12,35,1,15,0,2,8,1,62,8.857142857142858,2,0.0,26,1,14,0,9,2,1,8,1,41,21,0
2340,55224,fUiHjsgVTGx2gqPb2ZvmjVRjbdS9ZqmA,SpATywNh6bZuzm8s1ceuBUnMUAeoAHHw,45,58,21,43,11,23,8,2,166,23.714285714285715,2,0.0,19,21,41,11,39,23,2,8,2,92,74,0
2341,55249,RvNTpDpHJXpHBPiVPs0LJQO0QVfwQmLZ,RXDvfPUBYFlVdlueBFbLW0mhhAyGEqpt,6,1,1,0,1,0,4,0,7,1.0,1,0.0,0,1,0,1,1,0,0,4,0,2,5,1
2342,55259,YJeMkd3jz6x14dPiy98P6Q1CUjEPbHyt,bWdj2GDclj5ofokWjzoa5jAwMkxCykd6,2,0,0,0,0,0,2,0,2,0.2857142857142857,1,0.0,0,0,0,0,0,0,0,2,0,0,2,1
2343,55263,M1VrwOWjiMnBueo7ci4JBR246P3AJPFN,bWdj2GDclj5ofokWjzoa5jAwMkxCykd6,1,0,0,0,0,0,1,0,1,0.14285714285714285,1,0.0,0,0,0,0,0,0,0,1,0,0,1,1
2344,55268,yRP1A8CWHIiqi7L2SKgryjvGOEaUovOk,SpATywNh6bZuzm8s1ceuBUnMUAeoAHHw,10,20,1,16,0,0,1,0,38,5.428571428571429,1,0.0,8,1,14,0,12,0,2,1,0,23,15,0
2345,55279,pt3wm9HtultYr0UCBIWH5P5prgTkt7m0,G8EPVSXsOYB5YQWZGiz1aVq5Pgr2GrQu,59,80,6,239,4,18,15,2,364,52.0,4,0.0,14,6,210,4,66,18,29,15,2,234,130,0
2346,55291,cPtFlYsoyEEkZNxOdkt9K062078YOujz,SpATywNh6bZuzm8s1ceuBUnMUAeoAHHw,1,0,0,0,0,0,1,0,1,0.14285714285714285,1,0.0,0,0,0,0,0,0,0,1,0,0,1,1
2347,55302,6IS7EPvZH5qwgjP7B7wKKNHDapbUNZzo,A3fsA9Zfv1X2fVEQhTw51lKENdNrEqT3,3,3,1,0,0,0,2,0,6,0.8571428571428571,1,0.0,0,1,0,0,3,0,0,2,0,1,5,1
2348,55311,9WckfdNtlzlT2DpQl1LIa5W8ikOsv83Y,bWdj2GDclj5ofokWjzoa5jAwMkxCykd6,5,2,1,0,1,0,3,0,7,1.0,1,0.0,0,1,0,1,2,0,0,3,0,2,5,1
2349,55314,pzjrdD7q4o4JUPPOqQkw5fcoOUkIlkAh,5X6FeZozNMgE2VRi3MJYjkkFK8SETtu2,41,193,58,5,53,0,28,1,338,48.285714285714285,9,0.0,53,58,4,53,140,0,1,28,1,168,170,1
2350,55315,C3empNgjHCzi0FFc7gzcI9FqKZfB0kwl,A3fsA9Zfv1X2fVEQhTw51lKENdNrEqT3,2,0,0,0,0,0,2,0,2,0.2857142857142857,1,0.0,0,0,0,0,0,0,0,2,0,0,2,1
2351,55335,YPEupTuOqSGieSSneZcv3AcUcSBCtbGY,RXDvfPUBYFlVdlueBFbLW0mhhAyGEqpt,7,6,0,0,0,0,4,0,10,1.4285714285714286,2,0.0,0,0,0,0,6,0,0,4,0,0,10,1
2352,55338,CJvQb9Hij1vi5CpddEhAGwqZhdqybXGg,RXDvfPUBYFlVdlueBFbLW0mhhAyGEqpt,1,0,0,0,0,0,1,0,1,0.14285714285714285,1,0.0,0,0,0,0,0,0,0,1,0,0,1,1
2353,55341,rF503HYO0yfDhY1PybydCUAwDRRpCv4q,RXDvfPUBYFlVdlueBFbLW0mhhAyGEqpt,26,26,0,0,0,0,2,0,28,4.0,1,0.0,0,0,0,0,26,0,0,2,0,0,28,0
2354,55354,Gi2X0hiarDyo35MZ1XLA1tAuH6cjnWrV,SpATywNh6bZuzm8s1ceuBUnMUAeoAHHw,1,0,0,0,0,0,1,0,1,0.14285714285714285,1,0.0,0,0,0,0,0,0,0,1,0,0,1,1
2355,55355,4F0UQjd75R1TirjycGkNWhHj6ZRjyPGA,bWdj2GDclj5ofokWjzoa5jAwMkxCykd6,1,0,0,0,0,0,1,0,1,0.14285714285714285,1,0.0,0,0,0,0,0,0,0,1,0,0,1,1
2356,55392,zJYvwWT1PjHkUzbH163Gl1FetfzZr9EA,RXDvfPUBYFlVdlueBFbLW0mhhAyGEqpt,1,0,0,0,0,0,1,0,1,0.14285714285714285,1,0.0,0,0,0,0,0,0,0,1,0,0,1,1
2357,55398,46OTr627jSWtC8wrPe4BZiyNeqDxFeE3,SpATywNh6bZuzm8s1ceuBUnMUAeoAHHw,1,1,0,0,0,0,0,0,1,0.14285714285714285,1,0.0,0,0,0,0,1,0,0,0,0,0,1,0
2358,55410,RTJrnitsd8G1VoV2K19FA0I93mo0ia0Z,5X6FeZozNMgE2VRi3MJYjkkFK8SETtu2,5,2,1,0,1,0,2,0,6,0.8571428571428571,1,0.0,0,1,0,1,2,0,0,2,0,2,4,1
2359,55431,y1WcAm64t9lQRNAylqHIQuubzMG9DVdt,SpATywNh6bZuzm8s1ceuBUnMUAeoAHHw,29,17,14,0,13,0,3,0,47,6.714285714285714,2,0.0,0,14,0,13,17,0,0,3,0,27,20,1
2360,55454,rhsZYk7m5LBkn7LVFx16rCH37SmeAW9R,SpATywNh6bZuzm8s1ceuBUnMUAeoAHHw,14,10,5,13,3,0,2,0,33,4.714285714285714,1,0.0,4,5,12,3,6,0,1,2,0,24,9,1
2361,55459,M9P4K0uKZv2JIzPAa6CKLB4Oc6qrAVQc,bWdj2GDclj5ofokWjzoa5jAwMkxCykd6,5,2,1,0,1,0,2,0,6,0.8571428571428571,1,0.0,0,1,0,1,2,0,0,2,0,2,4,1
2362,55482,87SYGQjFYUtEWda0pG12bcNker0JGBy3,SpATywNh6bZuzm8s1ceuBUnMUAeoAHHw,7,13,0,0,0,0,1,0,14,2.0,2,0.0,1,0,0,0,12,0,0,1,0,1,13,1
2363,55496,1TS44EjfaevEY3Ojw6rE7X5JCr9Of15y,SpATywNh6bZuzm8s1ceuBUnMUAeoAHHw,9,12,8,0,4,0,10,0,34,4.857142857142857,1,0.0,0,8,0,4,12,0,0,10,0,12,22,1
2364,55507,lIve9zf9D7vTMXQs5hH3jAEjrPNCSDld,SpATywNh6bZuzm8s1ceuBUnMUAeoAHHw,23,25,0,12,0,2,1,0,40,5.714285714285714,1,0.0,3,0,12,0,22,2,0,1,0,15,25,1
2365,55509,bOjQp32RFEV06sLvBam0q4cSgCEI9Fx6,A3fsA9Zfv1X2fVEQhTw51lKENdNrEqT3,1,0,0,0,0,0,9,0,9,1.2857142857142858,1,0.0,0,0,0,0,0,0,0,9,0,0,9,1
2366,55510,kXQxyYCkkJ6U8ORD8v5rCtwPvreatPKB,SpATywNh6bZuzm8s1ceuBUnMUAeoAHHw,25,28,17,9,11,2,10,0,77,11.0,4,0.0,7,17,7,11,21,2,2,10,0,42,35,1
2367,55555,3GUakKniS7rRi1Az7W70DqXmiHk3dI25,SpATywNh6bZuzm8s1ceuBUnMUAeoAHHw,7,9,4,0,2,0,4,0,19,2.7142857142857144,1,0.0,0,4,0,2,9,0,0,4,0,6,13,1
2368,55574,kUTtwBKG3vzyymERNLukoy5hQ6c4zXj6,A3fsA9Zfv1X2fVEQhTw51lKENdNrEqT3,19,16,12,6,4,0,6,0,44,6.285714285714286,1,0.0,3,12,6,4,13,0,0,6,0,25,19,1
2369,55581,TctDXxVWte7oscV8OqkwV5s6zf8UI8b3,SpATywNh6bZuzm8s1ceuBUnMUAeoAHHw,17,9,5,19,3,1,5,1,43,6.142857142857143,1,0.0,3,5,16,3,6,1,3,5,1,27,16,1
2370,55587,dNMg8HqASFn9pIW9ZR7BiQy6ZwZupOce,A3fsA9Zfv1X2fVEQhTw51lKENdNrEqT3,6,8,3,0,2,0,9,0,22,3.142857142857143,3,0.0,0,3,0,2,8,0,0,9,0,5,17,1
2371,55589,dNMg8HqASFn9pIW9ZR7BiQy6ZwZupOce,bWdj2GDclj5ofokWjzoa5jAwMkxCykd6,7,5,1,0,1,0,5,0,12,1.7142857142857142,2,0.0,0,1,0,1,5,0,0,5,0,2,10,0
2372,55606,QuPJMxHrI2abilMygWFCmLFsgGUQO9Wm,bWdj2GDclj5ofokWjzoa5jAwMkxCykd6,5,4,3,0,2,0,1,0,10,1.4285714285714286,2,0.0,0,3,0,2,4,0,0,1,0,5,5,1
2373,55628,qIt5jgUMiC2NqsdfOpbvC5VZ3HQC5sYb,SpATywNh6bZuzm8s1ceuBUnMUAeoAHHw,12,15,7,18,6,0,2,0,48,6.857142857142857,1,0.0,6,7,16,6,9,0,2,2,0,35,13,0
2374,55634,j38sS48yyjSQUQ4EfqmBmZ0QyWUgAHfx,bWdj2GDclj5ofokWjzoa5jAwMkxCykd6,9,6,4,18,3,0,2,0,33,4.714285714285714,1,0.0,1,4,17,3,5,0,1,2,0,25,8,1
2375,55643,PerDvJFeT0tH6oOxg5UEB9YO1At9Z54E,SpATywNh6bZuzm8s1ceuBUnMUAeoAHHw,6,3,0,0,0,0,3,0,6,0.8571428571428571,1,0.0,0,0,0,0,3,0,0,3,0,0,6,1
2376,55679,xpqgjZbEokW0MRLke1FZWztUWsQSbcB5,A3fsA9Zfv1X2fVEQhTw51lKENdNrEqT3,11,8,2,0,2,0,7,0,19,2.7142857142857144,2,0.0,0,2,0,2,8,0,0,7,0,4,15,1
2377,55681,8YnnXA8oYVyEbPN7gW2C6PhP9To3oGEn,SpATywNh6bZuzm8s1ceuBUnMUAeoAHHw,10,9,5,0,2,1,7,1,25,3.5714285714285716,2,0.0,0,5,0,2,9,1,0,7,1,7,18,1
2378,55714,ycZVLmNiTgP7M4zqov9Nx3hYhdN2qhKF,A3fsA9Zfv1X2fVEQhTw51lKENdNrEqT3,4,3,1,0,0,0,2,0,6,0.8571428571428571,2,0.0,0,1,0,0,3,0,0,2,0,1,5,1
2379,55724,GPhUvJI07T5gQ3usvfVqtaObLXCifN5e,SpATywNh6bZuzm8s1ceuBUnMUAeoAHHw,13,14,9,0,2,0,8,0,33,4.714285714285714,1,0.0,0,9,0,2,14,0,0,8,0,11,22,1
2380,55731,ybcsmPlarjax7Mq4kzteIAIZbYqmFvSY,G8EPVSXsOYB5YQWZGiz1aVq5Pgr2GrQu,21,8,5,60,0,0,3,0,76,10.857142857142858,2,0.0,1,5,53,0,7,0,7,3,0,59,17,0
2381,55733,zVX5LPwTGC1SEitxSfv31cubNXKJSEc2,G8EPVSXsOYB5YQWZGiz1aVq5Pgr2GrQu,2,0,0,0,0,0,6,0,6,0.8571428571428571,2,0.0,0,0,0,0,0,0,0,6,0,0,6,0
2382,55794,H7LXKFyDxiZHnveNgHWLN7esK08pjn2X,SpATywNh6bZuzm8s1ceuBUnMUAeoAHHw,10,9,4,0,2,0,5,0,20,2.857142857142857,1,0.0,0,4,0,2,9,0,0,5,0,6,14,1
2383,55804,lP9Twn179TKTpTDJYyTSHNE9ichblI6t,SpATywNh6bZuzm8s1ceuBUnMUAeoAHHw,5,3,0,0,0,1,2,1,7,1.0,1,0.0,0,0,0,0,3,1,0,2,1,0,7,1
2384,55813,gykRbA7iJUFygOkXv9mNdsHLTYvvd4jI,bWdj2GDclj5ofokWjzoa5jAwMkxCykd6,1,0,0,0,0,0,1,0,1,0.14285714285714285,1,0.0,0,0,0,0,0,0,0,1,0,0,1,1
2385,55814,BomMRlBByw8amFeVspHb5AR3og0R9z55,A3fsA9Zfv1X2fVEQhTw51lKENdNrEqT3,11,6,5,0,5,0,2,0,18,2.5714285714285716,2,0.0,0,5,0,5,6,0,0,2,0,10,8,0
2386,55823,EQ7wf57Maxtqueh0jcALSwDsSR4NE6Fa,SpATywNh6bZuzm8s1ceuBUnMUAeoAHHw,1,0,0,0,0,0,3,0,3,0.42857142857142855,2,0.0,0,0,0,0,0,0,0,3,0,0,3,1
2387,55828,bXhvLL1DQzEIjyGvSUCfqx2LTtxg4cK2,7GRhBDsirIGkRZBtSMEzNTyDr2JQm4xx,11,9,6,0,1,0,4,0,20,2.857142857142857,2,0.0,1,6,0,1,8,0,0,4,0,8,12,1
2388,55832,K6KJIQIABvxIIjAmEcXXN0HZbm0ejZ38,5X6FeZozNMgE2VRi3MJYjkkFK8SETtu2,1,0,0,0,0,0,1,0,1,0.14285714285714285,1,0.0,0,0,0,0,0,0,0,1,0,0,1,1
2389,55833,Oucq99GMqVclKZUxDVtfJKcfgITW3NjA,A3fsA9Zfv1X2fVEQhTw51lKENdNrEqT3,2,0,0,0,0,0,4,0,4,0.5714285714285714,1,0.0,0,0,0,0,0,0,0,4,0,0,4,1
2390,55852,zC2jRq3r9EI7fiKmdxBaoujmdY4A8FN5,G8EPVSXsOYB5YQWZGiz1aVq5Pgr2GrQu,26,13,1,57,2,8,3,0,84,12.0,2,0.0,0,1,51,2,13,8,6,3,0,54,30,0
2391,55860,PmH4XgxtQe1CNb3l16TlTY5tyEhuC40E,SpATywNh6bZuzm8s1ceuBUnMUAeoAHHw,25,34,15,21,7,7,10,0,94,13.428571428571429,4,0.0,4,15,17,7,30,7,4,10,0,43,51,0
2392,55878,eCmkxWG61kjkyysYDawv54wjgppgcySc,SpATywNh6bZuzm8s1ceuBUnMUAeoAHHw,1,0,0,0,0,0,1,0,1,0.14285714285714285,1,0.0,0,0,0,0,0,0,0,1,0,0,1,0
2393,55888,Td90IqNnmmKtRdkISxoRwDL7f9FPwSv2,SpATywNh6bZuzm8s1ceuBUnMUAeoAHHw,5,2,0,0,0,0,3,0,5,0.7142857142857143,1,0.0,0,0,0,0,2,0,0,3,0,0,5,1
2394,55895,4fvgkYf9yGvIrlkwVwtH59EjCP57A9bP,5X6FeZozNMgE2VRi3MJYjkkFK8SETtu2,4,0,0,0,0,0,3,1,4,0.5714285714285714,1,0.0,0,0,0,0,0,0,0,3,1,0,4,1
2395,55918,JOqHNkiAQMopMtNnxSpHdAOKSp68V43j,A3fsA9Zfv1X2fVEQhTw51lKENdNrEqT3,5,4,2,0,0,0,2,0,8,1.1428571428571428,1,0.0,0,2,0,0,4,0,0,2,0,2,6,1
2396,55919,3gDYjjrgNInoS1KtNVg2GeRehkqftCKB,A3fsA9Zfv1X2fVEQhTw51lKENdNrEqT3,1,0,0,0,0,0,1,0,1,0.14285714285714285,1,0.0,0,0,0,0,0,0,0,1,0,0,1,1
2397,55928,ar4cwuAwjqKFHUFshoX4Vj4edt6iUva1,bWdj2GDclj5ofokWjzoa5jAwMkxCykd6,11,26,15,0,7,0,9,0,57,8.142857142857142,5,0.0,0,15,0,7,26,0,0,9,0,22,35,0
2398,55933,sNbuAEBvvCL9s1FspvGXLJVjQkFzxwpw,SpATywNh6bZuzm8s1ceuBUnMUAeoAHHw,2,0,0,0,0,0,2,0,2,0.2857142857142857,1,0.0,0,0,0,0,0,0,0,2,0,0,2,1
2399,55939,eraZwBr2l3pA9iqFftNgMFAP4UbJfK86,SpATywNh6bZuzm8s1ceuBUnMUAeoAHHw,4,2,0,0,0,0,2,0,4,0.5714285714285714,1,0.0,0,0,0,0,2,0,0,2,0,0,4,1
2400,55943,3tuGhYafSc9w18aR98dZeFrIlLzhyEje,A3fsA9Zfv1X2fVEQhTw51lKENdNrEqT3,7,3,2,0,2,0,2,0,9,1.2857142857142858,1,0.0,0,2,0,2,3,0,0,2,0,4,5,1
2401,55967,EK7Y6jLbcTIHEzN8KJHD55mY3w7SjZfJ,SpATywNh6bZuzm8s1ceuBUnMUAeoAHHw,15,28,0,13,0,0,4,0,45,6.428571428571429,1,0.0,8,0,12,0,20,0,1,4,0,20,25,1
2402,55977,PHqZ7C2u7hY0lcq8mwdcP007MajzouMM,RXDvfPUBYFlVdlueBFbLW0mhhAyGEqpt,2,0,0,0,0,0,2,0,2,0.2857142857142857,1,0.0,0,0,0,0,0,0,0,2,0,0,2,1
2403,55978,JVRk883TChkd8D0ZSH6CEb3OUHD06lXQ,SpATywNh6bZuzm8s1ceuBUnMUAeoAHHw,20,19,8,6,5,0,4,0,42,6.0,2,0.0,4,8,6,5,15,0,0,4,0,23,19,0
2404,55991,7tM0glf5iOjFrrOx11jEjeXPWGg1qnPf,RXDvfPUBYFlVdlueBFbLW0mhhAyGEqpt,1,0,0,0,0,0,1,0,1,0.14285714285714285,1,0.0,0,0,0,0,0,0,0,1,0,0,1,1
2405,56004,o9m1fMq17KjyGUhfLHLXFO5hoKQ5jU6O,A3fsA9Zfv1X2fVEQhTw51lKENdNrEqT3,6,5,1,0,0,0,3,0,9,1.2857142857142858,2,0.0,0,1,0,0,5,0,0,3,0,1,8,1
2406,56013,D6ad06f016ECiyDyXUNBTRBzQthq5sAJ,SpATywNh6bZuzm8s1ceuBUnMUAeoAHHw,1,0,0,0,0,0,1,0,1,0.14285714285714285,1,0.0,0,0,0,0,0,0,0,1,0,0,1,1
2407,56015,LAEQbw9BPtGnPbKTCBR9cl7L97VwZuUc,RXDvfPUBYFlVdlueBFbLW0mhhAyGEqpt,5,2,1,0,1,0,2,0,6,0.8571428571428571,1,0.0,0,1,0,1,2,0,0,2,0,2,4,0
2408,56019,e7lf1Tkn34jQw0oCMzBHIbD6A6hPfd7D,bWdj2GDclj5ofokWjzoa5jAwMkxCykd6,4,2,1,0,1,0,2,0,6,0.8571428571428571,1,0.0,0,1,0,1,2,0,0,2,0,2,4,1
2409,56031,QOTn8ztUNlHS3hl3hqCv4ofIiB3cOmPL,SpATywNh6bZuzm8s1ceuBUnMUAeoAHHw,9,5,3,0,2,0,2,0,12,1.7142857142857142,1,0.0,0,3,0,2,5,0,0,2,0,5,7,0
2410,56058,c162xBeHQ1ehzoWsokUc8kKEtu9gLIte,SpATywNh6bZuzm8s1ceuBUnMUAeoAHHw,28,37,19,15,9,1,7,1,89,12.714285714285714,2,0.0,15,19,12,9,22,1,3,7,1,55,34,0
2411,56062,pKCzqYDvJAlWQNOnHiIQZJLfMk8J7wCX,G8EPVSXsOYB5YQWZGiz1aVq5Pgr2GrQu,14,9,4,28,2,0,5,0,48,6.857142857142857,1,0.0,0,4,24,2,9,0,4,5,0,30,18,0
2412,56068,x2PUZGLlLCFDK8N0W0vdLLE67kNzX1k4,SpATywNh6bZuzm8s1ceuBUnMUAeoAHHw,6,5,2,0,1,0,3,0,11,1.5714285714285714,1,0.0,2,2,0,1,3,0,0,3,0,5,6,1
2413,56078,kKj1FlDO03hIJs4qO2fYyQxEzv7HbwXh,SpATywNh6bZuzm8s1ceuBUnMUAeoAHHw,1,0,0,0,0,0,1,0,1,0.14285714285714285,1,0.0,0,0,0,0,0,0,0,1,0,0,1,1
2414,56094,ZjIWRRmDJF0oSBD8UTF25mPP93G9gAQR,SpATywNh6bZuzm8s1ceuBUnMUAeoAHHw,10,9,3,0,3,0,2,0,17,2.4285714285714284,1,0.0,0,3,0,3,9,0,0,2,0,6,11,1
2415,56095,CXsZzvE3iylo5KzyiPoa1X1kRLwsS4Km,bWdj2GDclj5ofokWjzoa5jAwMkxCykd6,1,0,0,0,0,0,1,0,1,0.14285714285714285,1,0.0,0,0,0,0,0,0,0,1,0,0,1,1
2416,56098,CXsZzvE3iylo5KzyiPoa1X1kRLwsS4Km,A3fsA9Zfv1X2fVEQhTw51lKENdNrEqT3,1,0,0,0,0,0,1,0,1,0.14285714285714285,1,0.0,0,0,0,0,0,0,0,1,0,0,1,1
2417,56104,WZLkW7B5dsHccBcGjqVOiLakE0tHruAV,SpATywNh6bZuzm8s1ceuBUnMUAeoAHHw,4,11,0,0,0,0,1,0,12,1.7142857142857142,1,0.0,0,0,0,0,11,0,0,1,0,0,12,1
2418,56114,PmaZVK1XohXhK9MuIDoeUlsnQ3xunZ0o,SpATywNh6bZuzm8s1ceuBUnMUAeoAHHw,3,3,0,0,0,0,1,0,4,0.5714285714285714,1,0.0,0,0,0,0,3,0,0,1,0,0,4,1
2419,56137,XpVd5uEcP2Yxg4lfroDNkVY0jgpcLPLq,SpATywNh6bZuzm8s1ceuBUnMUAeoAHHw,18,14,6,10,4,0,3,0,37,5.285714285714286,1,0.0,2,6,10,4,12,0,0,3,0,22,15,0
2420,56138,0K6JPqiivQzicxY4EV4nqMLCL3a08A97,7GRhBDsirIGkRZBtSMEzNTyDr2JQm4xx,2,0,0,0,0,0,2,0,2,0.2857142857142857,1,0.0,0,0,0,0,0,0,0,2,0,0,2,1
2421,56153,YgnjU1hWSGf8038ZkUT6S1YfeICauUtf,SpATywNh6bZuzm8s1ceuBUnMUAeoAHHw,24,32,17,13,10,0,2,0,74,10.571428571428571,2,0.0,6,17,12,10,26,0,1,2,0,45,29,0
2422,56157,TExe4YVB8RdIX9n7bjL5aFk2EIxQvn6S,SpATywNh6bZuzm8s1ceuBUnMUAeoAHHw,12,19,6,20,0,0,6,1,52,7.428571428571429,1,0.0,12,6,18,0,7,0,2,6,1,36,16,1
2423,56160,e3Xx0LWeS8euUOsFo80XF3J80EQ2D87p,SpATywNh6bZuzm8s1ceuBUnMUAeoAHHw,3,2,0,0,0,0,2,0,4,0.5714285714285714,1,0.0,0,0,0,0,2,0,0,2,0,0,4,0
2424,56169,TNAUZUlDZyGbJQN7wls2QRBe2Cw7eeSK,bWdj2GDclj5ofokWjzoa5jAwMkxCykd6,19,23,1,54,0,15,7,0,100,14.285714285714286,3,0.0,15,1,48,0,8,15,6,7,0,64,36,0
2425,56189,sMMDk03UePJILkRIn5YDW5tA5us6h51J,SpATywNh6bZuzm8s1ceuBUnMUAeoAHHw,3,2,1,0,0,0,1,0,4,0.5714285714285714,1,0.0,0,1,0,0,2,0,0,1,0,1,3,1
2426,56190,i4SeHiwnbIIoq9LoP3weAeDXl7e5RBtg,5X6FeZozNMgE2VRi3MJYjkkFK8SETtu2,16,17,4,10,4,1,12,0,48,6.857142857142857,3,0.0,11,4,10,4,6,1,0,12,0,29,19,1
2427,56204,xbYSqp0T7Uu69VoCNyfTCvQcS3HV3UeU,5X6FeZozNMgE2VRi3MJYjkkFK8SETtu2,8,7,3,0,1,2,11,1,25,3.5714285714285716,3,0.0,0,3,0,1,7,2,0,11,1,4,21,1
2428,56216,UGrzFFoMUY8lyETY7WUVQiSf705Madpt,SpATywNh6bZuzm8s1ceuBUnMUAeoAHHw,28,32,23,8,19,0,6,0,88,12.571428571428571,4,0.0,2,23,8,19,30,0,0,6,0,52,36,0
2429,56221,mxDmiNiZbTWbG5eX6cuqeU6lZnYbJUhB,SpATywNh6bZuzm8s1ceuBUnMUAeoAHHw,13,25,5,0,2,1,9,0,42,6.0,3,0.0,12,5,0,2,13,1,0,9,0,19,23,0
2430,56237,PlHOy9sO4wpd56kVnMDoRd2P9dW85wrW,A3fsA9Zfv1X2fVEQhTw51lKENdNrEqT3,11,10,4,0,3,0,7,0,24,3.4285714285714284,1,0.0,0,4,0,3,10,0,0,7,0,7,17,1
2431,56249,I7F56XqyQ8b5GpiGlOus1XQv70VVeUq9,bWdj2GDclj5ofokWjzoa5jAwMkxCykd6,1,0,0,0,0,0,1,0,1,0.14285714285714285,1,0.0,0,0,0,0,0,0,0,1,0,0,1,1
2432,56250,bTuE0djIq5F990AHAk85k9A06v19Matb,5X6FeZozNMgE2VRi3MJYjkkFK8SETtu2,4,2,0,0,0,0,2,0,4,0.5714285714285714,2,0.0,0,0,0,0,2,0,0,2,0,0,4,1
2433,56260,GLN4A8S1FfCje62RkokqBLEULjMYf2Jo,SpATywNh6bZuzm8s1ceuBUnMUAeoAHHw,5,3,1,0,1,0,1,0,6,0.8571428571428571,1,0.0,0,1,0,1,3,0,0,1,0,2,4,0
2434,56273,ZHGiV2heRgfndFJprqNP0m9NCX5puCJj,G8EPVSXsOYB5YQWZGiz1aVq5Pgr2GrQu,14,10,8,0,7,0,2,1,28,4.0,1,0.0,0,8,0,7,10,0,0,2,1,15,13,1
2435,56274,aJc8aUAetxPPGWFRPX4YOEm2nyZUaAWd,A3fsA9Zfv1X2fVEQhTw51lKENdNrEqT3,11,10,8,0,7,0,3,0,28,4.0,1,0.0,0,8,0,7,10,0,0,3,0,15,13,1
2436,56283,eCJEYxlte8R6sbqh66Nohv34rvkne1DG,SpATywNh6bZuzm8s1ceuBUnMUAeoAHHw,19,19,10,7,6,0,3,0,45,6.428571428571429,2,0.0,5,10,7,6,14,0,0,3,0,28,17,1
2437,56328,lyFNL8kV6VicGW73AnKGdsGcS116jdQS,bWdj2GDclj5ofokWjzoa5jAwMkxCykd6,1,0,0,0,0,0,1,0,1,0.14285714285714285,1,0.0,0,0,0,0,0,0,0,1,0,0,1,1
2438,56334,6A5mn3Pn8IBDZpMvNejUh5y2X9g7rQUJ,SpATywNh6bZuzm8s1ceuBUnMUAeoAHHw,25,34,2,54,0,0,6,0,96,13.714285714285714,3,0.0,10,2,51,0,24,0,3,6,0,63,33,0
2439,56349,iHZWk8DNCHWjtlySjApOGtqjEWRSrx2m,RXDvfPUBYFlVdlueBFbLW0mhhAyGEqpt,7,5,0,0,0,0,5,0,10,1.4285714285714286,1,0.0,0,0,0,0,5,0,0,5,0,0,10,1
2440,56351,9EUUO7h64xEMsIYSdMrVOb4PBS93f8Du,SpATywNh6bZuzm8s1ceuBUnMUAeoAHHw,5,3,2,0,1,0,1,0,7,1.0,1,0.0,0,2,0,1,3,0,0,1,0,3,4,1
2441,56356,3R3Nczg72kfMEiApN4orlcWVqV3FRVsF,bWdj2GDclj5ofokWjzoa5jAwMkxCykd6,1,0,0,0,0,0,1,0,1,0.14285714285714285,1,0.0,0,0,0,0,0,0,0,1,0,0,1,1
2442,56397,1KCmpfcoDnRnd9ITYAgYi4eQPwc5jiJz,SpATywNh6bZuzm8s1ceuBUnMUAeoAHHw,4,5,1,0,0,0,2,0,8,1.1428571428571428,1,0.0,0,1,0,0,5,0,0,2,0,1,7,1
2443,56410,m7ppZFqoqxq4drq32V7wzPII9oNFXP01,SpATywNh6bZuzm8s1ceuBUnMUAeoAHHw,20,27,16,13,7,2,7,0,72,10.285714285714286,3,0.0,6,16,11,7,21,2,2,7,0,40,32,0
2444,56417,cUqw8BeU1kIPdLrPk0kldw6H3haT1GKW,A3fsA9Zfv1X2fVEQhTw51lKENdNrEqT3,7,11,2,0,2,0,1,0,16,2.2857142857142856,1,0.0,0,2,0,2,11,0,0,1,0,4,12,1
2445,56428,x6upZ5zLvcOLWKUXPUe1AXIpYEyiR7aS,SpATywNh6bZuzm8s1ceuBUnMUAeoAHHw,1,0,0,0,0,0,1,0,1,0.14285714285714285,1,0.0,0,0,0,0,0,0,0,1,0,0,1,1
2446,56436,2B1Sa19tBbYgocD2xlB5fX7K09dmclmZ,SpATywNh6bZuzm8s1ceuBUnMUAeoAHHw,6,10,1,0,0,0,2,0,13,1.8571428571428572,3,0.0,0,1,0,0,10,0,0,2,0,1,12,1
2447,56455,RcsMEES0IQ1NHP2Ss1VxXk92ez6mhLug,SpATywNh6bZuzm8s1ceuBUnMUAeoAHHw,8,8,5,6,0,0,3,0,22,3.142857142857143,2,0.0,0,5,5,0,8,0,1,3,0,10,12,0
2448,56464,mUGiOApqSIPNJJAxx9ku1Ubhn4j7vYNp,SpATywNh6bZuzm8s1ceuBUnMUAeoAHHw,19,18,9,9,5,2,3,0,46,6.571428571428571,1,0.0,7,9,9,5,11,2,0,3,0,30,16,0
2449,56482,OlI6IKs7zmyB25QZ2wZTzJXcjSSlBlit,RXDvfPUBYFlVdlueBFbLW0mhhAyGEqpt,7,2,0,0,0,1,7,1,11,1.5714285714285714,1,0.0,0,0,0,0,2,1,0,7,1,0,11,1
2450,56502,YAaB5kbzMpno3yyQhEjSC43PC6r4FUut,A3fsA9Zfv1X2fVEQhTw51lKENdNrEqT3,1,0,0,0,0,0,1,0,1,0.14285714285714285,1,0.0,0,0,0,0,0,0,0,1,0,0,1,1
2451,56505,K9sZStDxVlzslbizXAYcyYp63PWAyvJs,bWdj2GDclj5ofokWjzoa5jAwMkxCykd6,2,0,0,0,0,24,2,0,26,3.7142857142857144,1,0.0,0,0,0,0,0,24,0,2,0,0,26,1
2452,56511,KI8HKTaed6ftbRs8hxS2QLp9yDQHigXN,bWdj2GDclj5ofokWjzoa5jAwMkxCykd6,6,3,1,0,1,10,7,0,22,3.142857142857143,3,0.0,0,1,0,1,3,10,0,7,0,2,20,0
2453,56516,yreSFZev8w2vccLGmUPWniYPFTHUVYuW,SpATywNh6bZuzm8s1ceuBUnMUAeoAHHw,12,11,1,20,1,0,1,0,34,4.857142857142857,1,0.0,4,1,19,1,7,0,1,1,0,25,9,1
2454,56517,Rz28tFT5qYZaEQ78Ly3OdJx8TpvsmLBy,A3fsA9Zfv1X2fVEQhTw51lKENdNrEqT3,3,2,0,0,0,0,4,0,6,0.8571428571428571,2,0.0,0,0,0,0,2,0,0,4,0,0,6,0
2455,56533,1quHb10fObuEEg4CZXYAqSIkbHHSbI1d,5X6FeZozNMgE2VRi3MJYjkkFK8SETtu2,13,25,1,2,4,1,9,0,42,6.0,5,0.0,10,1,2,4,15,1,0,9,0,17,25,1
2456,56539,BRyXI2jlP9arzZoLjKD1qwawYxBWQDfb,A3fsA9Zfv1X2fVEQhTw51lKENdNrEqT3,6,4,2,0,2,0,2,0,10,1.4285714285714286,1,0.0,0,2,0,2,4,0,0,2,0,4,6,1
2457,56551,SRtsJqUL9xISAo9TMC6eKPCvdTaj4XO3,SpATywNh6bZuzm8s1ceuBUnMUAeoAHHw,10,9,4,8,0,0,3,0,24,3.4285714285714284,2,0.0,0,4,8,0,9,0,0,3,0,12,12,0
2458,56552,C5GTwEweg1bPhFzl7GnQQbIddyn0y9WS,RXDvfPUBYFlVdlueBFbLW0mhhAyGEqpt,5,23,14,0,9,0,0,0,46,6.571428571428571,1,0.0,2,14,0,9,21,0,0,0,0,25,21,1
2459,56557,HFlkUxGHWB77t9TiRXSaNCP8d3isxGAz,SpATywNh6bZuzm8s1ceuBUnMUAeoAHHw,1,0,0,0,0,0,1,0,1,0.14285714285714285,1,0.0,0,0,0,0,0,0,0,1,0,0,1,1
2460,56562,dtFae9PjMozKIdBzv7AdkzVzJFKFs05y,RXDvfPUBYFlVdlueBFbLW0mhhAyGEqpt,12,21,7,0,5,0,2,0,35,5.0,1,0.0,6,7,0,5,15,0,0,2,0,18,17,1
2461,56564,WFaX2lVFQ02ZdYk8UYpSsb64zjahxJD4,SpATywNh6bZuzm8s1ceuBUnMUAeoAHHw,5,3,0,0,0,0,3,0,6,0.8571428571428571,1,0.0,0,0,0,0,3,0,0,3,0,0,6,1
2462,56566,6qgQAmX6y5wh5nEPRINOiKrZNoTl5yfT,G8EPVSXsOYB5YQWZGiz1aVq5Pgr2GrQu,59,96,51,8,42,2,7,0,206,29.428571428571427,4,0.0,36,51,7,42,60,2,1,7,0,136,70,0
2463,56569,2HbabEHSEnqM0bBaiJs30PG9549v5yOk,5X6FeZozNMgE2VRi3MJYjkkFK8SETtu2,1,0,0,0,0,0,1,0,1,0.14285714285714285,1,0.0,0,0,0,0,0,0,0,1,0,0,1,1
2464,56570,LSVa2jpU1dF8RnC5rzovm0tv2cSNIe8I,SpATywNh6bZuzm8s1ceuBUnMUAeoAHHw,31,97,48,0,33,0,18,0,196,28.0,5,0.0,0,48,0,33,97,0,0,18,0,81,115,1
2465,56579,XkKS323fFxBVezQ5JyIgzxHDxEKEwwEf,SpATywNh6bZuzm8s1ceuBUnMUAeoAHHw,9,8,3,2,2,0,4,2,21,3.0,1,0.0,2,3,2,2,6,0,0,4,2,9,12,1
2466,56585,1ek5QqaGzN6P33dWOwYmxFbMxKwWe19o,SpATywNh6bZuzm8s1ceuBUnMUAeoAHHw,1,0,0,0,0,0,1,0,1,0.14285714285714285,1,0.0,0,0,0,0,0,0,0,1,0,0,1,1
2467,56593,5Gu4g9dtF1zjfzBwHRDyoDsx2MPMINMH,A3fsA9Zfv1X2fVEQhTw51lKENdNrEqT3,82,14,6,258,2,0,1,0,281,40.142857142857146,1,0.0,6,6,253,2,8,0,5,1,0,267,14,0
2468,56603,LmbFtDSfLFeyNU7nFqQJsMI7iXLM51md,SpATywNh6bZuzm8s1ceuBUnMUAeoAHHw,1,0,0,0,0,0,1,0,1,0.14285714285714285,1,0.0,0,0,0,0,0,0,0,1,0,0,1,0
2469,56617,hhlID9e9RXNsuOHzHvfjbzrkpQmbpeir,SpATywNh6bZuzm8s1ceuBUnMUAeoAHHw,8,8,6,2,1,0,2,0,19,2.7142857142857144,2,0.0,0,6,1,1,8,0,1,2,0,8,11,1
2470,56624,7g1Vw1VTMIZv2SNnFwKfmXrRUvuPdRJF,SpATywNh6bZuzm8s1ceuBUnMUAeoAHHw,4,10,0,0,0,0,1,0,11,1.5714285714285714,3,0.0,0,0,0,0,10,0,0,1,0,0,11,1
2471,56630,v05YX233WSCgECpF2N4rdvc18pCg2iqt,SpATywNh6bZuzm8s1ceuBUnMUAeoAHHw,14,9,5,16,3,0,3,0,36,5.142857142857143,2,0.0,3,5,14,3,6,0,2,3,0,25,11,0
2472,56642,7ttzq6sOsWQ5eEpZriKP7OLuIb0DcSbF,SpATywNh6bZuzm8s1ceuBUnMUAeoAHHw,18,13,9,17,6,0,1,0,46,6.571428571428571,1,0.0,2,9,14,6,11,0,3,1,0,31,15,0
2473,56653,A0M3i5nfjroJ4PM9wmVXYOoLY3tY0fag,SpATywNh6bZuzm8s1ceuBUnMUAeoAHHw,2,5,0,0,0,0,0,0,5,0.7142857142857143,2,0.0,0,0,0,0,5,0,0,0,0,0,5,0
2474,56657,QjRqlcg02MPH1ssCHCoMGSYCtFlPbtU9,A3fsA9Zfv1X2fVEQhTw51lKENdNrEqT3,1,0,1,0,0,0,0,0,1,0.14285714285714285,1,0.0,0,1,0,0,0,0,0,0,0,1,0,1
2475,56721,SK7IxqKpOFb3vAlYnYjFjD4PVuXVBlrm,SpATywNh6bZuzm8s1ceuBUnMUAeoAHHw,20,68,5,18,4,0,9,0,104,14.857142857142858,3,0.0,13,5,14,4,55,0,4,9,0,36,68,0
2476,56733,i9CWvduTcskommMHOeHEvsItP05JGHxW,SpATywNh6bZuzm8s1ceuBUnMUAeoAHHw,31,34,15,23,9,0,2,0,83,11.857142857142858,2,0.0,6,15,20,9,28,0,3,2,0,50,33,0
2477,56741,GXi0JiFESUZlctzkqcyy8vfaIeTzKOhp,SpATywNh6bZuzm8s1ceuBUnMUAeoAHHw,14,7,6,0,5,0,2,0,20,2.857142857142857,1,0.0,0,6,0,5,7,0,0,2,0,11,9,1
2478,56758,3X0JLX6UvJnnRb5GkwbFJgAokE5g69D0,A3fsA9Zfv1X2fVEQhTw51lKENdNrEqT3,7,7,2,0,0,0,1,0,10,1.4285714285714286,1,0.0,0,2,0,0,7,0,0,1,0,2,8,1
2479,56787,73lhhrOcE2srJj5BkIzSweWSnQRZBT2o,bWdj2GDclj5ofokWjzoa5jAwMkxCykd6,25,42,28,72,0,0,3,0,145,20.714285714285715,2,0.0,10,28,54,0,32,0,18,3,0,92,53,1
2480,56824,1NMKAl678ZBpdBkhXfYTAgEyYygMZz0x,SpATywNh6bZuzm8s1ceuBUnMUAeoAHHw,11,11,1,0,1,0,2,0,15,2.142857142857143,1,0.0,0,1,0,1,11,0,0,2,0,2,13,1
2481,56826,ilWzYGLWBh9DSc1MV8g2C4Go5wDNgUHX,A3fsA9Zfv1X2fVEQhTw51lKENdNrEqT3,130,57,42,294,28,52,19,1,493,70.42857142857143,3,0.0,10,42,237,28,47,52,57,19,1,317,176,0
2482,56865,y64BqR5f4fJBfwxF4aLt14ViHkvnjGLs,5X6FeZozNMgE2VRi3MJYjkkFK8SETtu2,23,23,11,42,2,0,5,0,83,11.857142857142858,2,0.0,5,11,36,2,18,0,6,5,0,54,29,1
2483,56898,i0LHbVo0MUWeo1slrPpQRlCoWzknlhLR,5X6FeZozNMgE2VRi3MJYjkkFK8SETtu2,1,0,0,0,0,0,1,0,1,0.14285714285714285,1,0.0,0,0,0,0,0,0,0,1,0,0,1,1
2484,56959,qZhmmNUvkNXdf3u04DTUQOFEBxxO10p4,A3fsA9Zfv1X2fVEQhTw51lKENdNrEqT3,3,2,1,0,0,0,2,0,5,0.7142857142857143,1,0.0,0,1,0,0,2,0,0,2,0,1,4,1
2485,56993,CMLvVcsPjeGzJkj3tZzcZ06brb5LMupf,5X6FeZozNMgE2VRi3MJYjkkFK8SETtu2,1,0,0,0,0,0,1,0,1,0.14285714285714285,1,0.0,0,0,0,0,0,0,0,1,0,0,1,1
2486,56999,vbTgITzq6jZRj0oUV5gFotgOlwSXnjML,G8EPVSXsOYB5YQWZGiz1aVq5Pgr2GrQu,40,40,7,84,2,5,7,0,145,20.714285714285715,2,0.0,4,7,74,2,36,5,10,7,0,87,58,0
2487,57008,ZtLnEkCqeRnvyqFQdbYPmQSGK8YkXNE8,SpATywNh6bZuzm8s1ceuBUnMUAeoAHHw,6,3,1,0,1,0,2,1,8,1.1428571428571428,1,0.0,0,1,0,1,3,0,0,2,1,2,6,0
2488,57059,cYibpCaMUGq0WjgUWfTv0iIvJ7QbFj5E,A3fsA9Zfv1X2fVEQhTw51lKENdNrEqT3,2,0,0,0,0,0,2,0,2,0.2857142857142857,1,0.0,0,0,0,0,0,0,0,2,0,0,2,1
2489,57064,vAq6n4okEOzm4Q7527tzA1bof68awv28,G8EPVSXsOYB5YQWZGiz1aVq5Pgr2GrQu,5,4,0,0,0,0,4,0,8,1.1428571428571428,1,0.0,0,0,0,0,4,0,0,4,0,0,8,1
2490,57265,NFGYUC7dcOkWJh2BiZLJheVSucAvXvpt,bWdj2GDclj5ofokWjzoa5jAwMkxCykd6,5,8,0,0,0,2,3,0,13,1.8571428571428572,4,0.0,0,0,0,0,8,2,0,3,0,0,13,0
2491,57327,RdOaDfHEeBBslFA96Ipf8QaGmA7wq7Rz,SpATywNh6bZuzm8s1ceuBUnMUAeoAHHw,17,25,3,15,1,0,7,0,51,7.285714285714286,3,0.0,6,3,12,1,19,0,3,7,0,22,29,0
2492,57345,SmBAgHRNeYWZKP2SpqpKXwVR3YhUZnjq,SpATywNh6bZuzm8s1ceuBUnMUAeoAHHw,24,27,0,30,0,4,4,0,65,9.285714285714286,2,0.0,7,0,26,0,20,4,4,4,0,33,32,0
2493,57639,D5gDQ8hFb4klemeBiodWmMPe9KIvqw9O,5X6FeZozNMgE2VRi3MJYjkkFK8SETtu2,6,4,1,0,1,0,1,0,7,1.0,1,0.0,0,1,0,1,4,0,0,1,0,2,5,1
2494,57657,r4CghvxKbP3R549p5B3LTdvr7lbYRqXF,G8EPVSXsOYB5YQWZGiz1aVq5Pgr2GrQu,44,46,23,84,17,0,1,0,171,24.428571428571427,1,0.0,21,23,57,17,25,0,27,1,0,118,53,0
2495,57716,oDMwcP97XCFhatRKDALyEk29j0A66Zee,SpATywNh6bZuzm8s1ceuBUnMUAeoAHHw,6,2,1,0,1,0,2,0,6,0.8571428571428571,1,0.0,0,1,0,1,2,0,0,2,0,2,4,1
2496,57761,tS5yd0InBPlA0CVUCBIjrGWKHeeeibf9,A3fsA9Zfv1X2fVEQhTw51lKENdNrEqT3,4,3,2,0,0,0,1,0,6,0.8571428571428571,1,0.0,0,2,0,0,3,0,0,1,0,2,4,0
2497,57789,xayicpjClPkwcfGTr3r84hb5pfZk0nB8,5X6FeZozNMgE2VRi3MJYjkkFK8SETtu2,10,14,6,0,10,0,2,0,32,4.571428571428571,2,0.0,6,6,0,10,8,0,0,2,0,22,10,1
2498,57796,oieeinmRIRZuvg1KZp8yYpFAojV2pQvR,SpATywNh6bZuzm8s1ceuBUnMUAeoAHHw,1,0,0,0,0,0,1,0,1,0.14285714285714285,1,0.0,0,0,0,0,0,0,0,1,0,0,1,1
2499,57817,bZSiNUbAIuydDBd77IMAJ15Hy6k2A1kT,5X6FeZozNMgE2VRi3MJYjkkFK8SETtu2,5,2,1,0,1,0,2,0,6,0.8571428571428571,2,0.0,0,1,0,1,2,0,0,2,0,2,4,1
2500,57987,sqasMoGc0IU5lpNZsO5KtcLYxSWllMxq,RXDvfPUBYFlVdlueBFbLW0mhhAyGEqpt,8,6,1,8,1,2,1,0,19,2.7142857142857144,1,0.0,1,1,7,1,5,2,1,1,0,10,9,0
2501,57989,ncKGr6xR4Vhs3wPeU0aqO1sSEow8LN64,5X6FeZozNMgE2VRi3MJYjkkFK8SETtu2,1,0,0,0,0,0,1,0,1,0.14285714285714285,1,0.0,0,0,0,0,0,0,0,1,0,0,1,1
2502,58013,Bf025FfgNrlcqN8gYGnmBAhjBy0v5Xmo,bWdj2GDclj5ofokWjzoa5jAwMkxCykd6,7,4,3,0,2,0,1,0,10,1.4285714285714286,1,0.0,0,3,0,2,4,0,0,1,0,5,5,1
2503,58214,nZTn5dZMRyIKKNGuMbIWH6lpWaWoYX62,5X6FeZozNMgE2VRi3MJYjkkFK8SETtu2,1,0,0,0,0,0,1,0,1,0.14285714285714285,1,0.0,0,0,0,0,0,0,0,1,0,0,1,1
2504,58223,nZTn5dZMRyIKKNGuMbIWH6lpWaWoYX62,A3fsA9Zfv1X2fVEQhTw51lKENdNrEqT3,5,4,1,0,0,0,1,0,6,0.8571428571428571,1,0.0,0,1,0,0,4,0,0,1,0,1,5,1
2505,58235,L4PW9E8umRTJy4rgt9ZPyCVXzCxIYlU4,SpATywNh6bZuzm8s1ceuBUnMUAeoAHHw,9,10,3,12,0,29,9,3,66,9.428571428571429,4,0.0,6,3,11,0,4,29,1,9,3,20,46,0
2506,58282,Gqs4K8SBL8tl8fMHpBqpJerrgEsieHU3,SpATywNh6bZuzm8s1ceuBUnMUAeoAHHw,30,31,23,10,15,5,5,0,89,12.714285714285714,5,0.0,2,23,10,15,29,5,0,5,0,50,39,0
2507,58330,pMYwmEYG5tY3CdCDf2JdvCMAnvvBZ6Wf,5X6FeZozNMgE2VRi3MJYjkkFK8SETtu2,5,2,0,0,0,0,3,0,5,0.7142857142857143,1,0.0,0,0,0,0,2,0,0,3,0,0,5,1
2508,58333,e3wUoJuzsENUfMiDHKcPh8dxiNI0W3xf,G8EPVSXsOYB5YQWZGiz1aVq5Pgr2GrQu,32,44,3,32,3,4,11,2,99,14.142857142857142,4,0.0,16,3,17,3,28,4,15,11,2,39,60,0
2509,58334,ROctVkWGGi4RH8QWmC2p1iWZZ8pihPaJ,SpATywNh6bZuzm8s1ceuBUnMUAeoAHHw,14,23,3,3,2,0,2,0,33,4.714285714285714,2,0.0,0,3,3,2,23,0,0,2,0,8,25,0
2510,58419,WuM67GwQW9M3d1mnuGHuvAdo907S9qb5,bWdj2GDclj5ofokWjzoa5jAwMkxCykd6,1,0,0,0,0,0,1,0,1,0.14285714285714285,1,0.0,0,0,0,0,0,0,0,1,0,0,1,1
2511,58430,Ymf9IGFQ8uCjyMPNR9dFL9vuwfZDvaPV,SpATywNh6bZuzm8s1ceuBUnMUAeoAHHw,17,29,0,12,1,14,8,0,64,9.142857142857142,4,0.0,4,0,11,1,25,14,1,8,0,16,48,0
2512,58458,fgzbUfrTxXYCuiFYTG1cTemcEJUl36an,SpATywNh6bZuzm8s1ceuBUnMUAeoAHHw,13,35,0,11,0,0,8,0,54,7.714285714285714,4,0.0,4,0,11,0,31,0,0,8,0,15,39,0
2513,58535,tdWhb9WfoB7e0A5Gjo7JvSpPeeCoQg77,SpATywNh6bZuzm8s1ceuBUnMUAeoAHHw,12,7,4,7,2,0,2,0,22,3.142857142857143,1,0.0,2,4,7,2,5,0,0,2,0,15,7,0
2514,58578,3mm3mJxVS0eLh8IUtBxaLL8aknBAQjDa,5X6FeZozNMgE2VRi3MJYjkkFK8SETtu2,2,0,0,0,0,0,2,0,2,0.2857142857142857,1,0.0,0,0,0,0,0,0,0,2,0,0,2,1
2515,58626,AsYvTZR1ylqWCh3nfRxgHS2CzZpeou5v,SpATywNh6bZuzm8s1ceuBUnMUAeoAHHw,34,44,21,21,13,1,9,0,109,15.571428571428571,3,0.0,4,21,20,13,40,1,1,9,0,58,51,0
2516,58661,t8qBiDTvOvYmrxcVIErRuEOf38tywm6t,SpATywNh6bZuzm8s1ceuBUnMUAeoAHHw,10,17,13,0,5,0,3,0,38,5.428571428571429,2,0.0,0,13,0,5,17,0,0,3,0,18,20,0
2517,58690,y9A8XMlmfPaglBBuQFjiuxUOvb1WQu2v,A3fsA9Zfv1X2fVEQhTw51lKENdNrEqT3,8,7,3,0,2,0,2,0,14,2.0,2,0.0,0,3,0,2,7,0,0,2,0,5,9,1
2518,58724,QEq8GPuIzTapWcXcWLs8dzh5C4ugJ6qX,G8EPVSXsOYB5YQWZGiz1aVq5Pgr2GrQu,49,50,26,65,21,0,6,0,168,24.0,3,0.0,19,26,61,21,31,0,4,6,0,127,41,0
2519,58739,IUn6MADAjAYkGlJisA1WiDvCeNlJd5Xd,bWdj2GDclj5ofokWjzoa5jAwMkxCykd6,7,5,2,20,1,0,1,0,29,4.142857142857143,1,0.0,1,2,20,1,4,0,0,1,0,24,5,1
2520,58783,cG2zraudtV44kPzel5abcAzgwVOUaAs4,5X6FeZozNMgE2VRi3MJYjkkFK8SETtu2,1,0,0,0,0,0,1,0,1,0.14285714285714285,1,0.0,0,0,0,0,0,0,0,1,0,0,1,1
2521,58831,f1TK7a3kaFF32JoXcfjlq2WtR27QUBak,SpATywNh6bZuzm8s1ceuBUnMUAeoAHHw,4,4,0,0,0,2,2,0,8,1.1428571428571428,1,0.0,0,0,0,0,4,2,0,2,0,0,8,1
2522,58888,Oh4qObC7j4dz8QtvEnVVjGNXqScAv0Td,5X6FeZozNMgE2VRi3MJYjkkFK8SETtu2,6,1,1,0,1,0,3,0,6,0.8571428571428571,1,0.0,0,1,0,1,1,0,0,3,0,2,4,1
2523,58922,6HIBebNSnNEoSeekVShzxF3x0IcbgohT,SpATywNh6bZuzm8s1ceuBUnMUAeoAHHw,19,18,1,0,1,0,1,0,21,3.0,1,0.0,0,1,0,1,18,0,0,1,0,2,19,1
2524,58948,McYATdhZDDMDpni6a4GbjI06ustMpvdV,5X6FeZozNMgE2VRi3MJYjkkFK8SETtu2,1,0,0,0,0,0,1,0,1,0.14285714285714285,1,0.0,0,0,0,0,0,0,0,1,0,0,1,1
2525,58996,w9HBKKfn4YUOWYdwRHKe80SIWiO37ZMJ,SpATywNh6bZuzm8s1ceuBUnMUAeoAHHw,20,18,10,12,4,0,13,0,57,8.142857142857142,4,0.0,2,10,11,4,16,0,1,13,0,27,30,0
2526,59018,Sz4iN9vM7plSJObu2Kgng7aJijtNNsts,A3fsA9Zfv1X2fVEQhTw51lKENdNrEqT3,5,5,1,0,1,0,1,0,8,1.1428571428571428,1,0.0,0,1,0,1,5,0,0,1,0,2,6,1
2527,59019,EI0cegDgsKeutsMjmgvKh2Wn3MmJa02W,5X6FeZozNMgE2VRi3MJYjkkFK8SETtu2,10,10,2,10,3,0,5,1,31,4.428571428571429,2,0.0,7,2,8,3,3,0,2,5,1,20,11,1
2528,59080,0wpgF8T87E4lIPjqoh0AkxyomANfbalw,5X6FeZozNMgE2VRi3MJYjkkFK8SETtu2,4,7,1,0,3,0,1,0,12,1.7142857142857142,1,0.0,2,1,0,3,5,0,0,1,0,6,6,1
2529,59087,QscGDFmAAH7jp4ntcbRqVptjZvFSEe7R,A3fsA9Zfv1X2fVEQhTw51lKENdNrEqT3,24,12,10,18,8,0,2,0,50,7.142857142857143,1,0.0,0,10,15,8,12,0,3,2,0,33,17,1
2530,59118,bEjkLIwm3iSyqTCwCLyh4lFO7vLzJeAj,SpATywNh6bZuzm8s1ceuBUnMUAeoAHHw,15,11,9,2,8,0,5,0,35,5.0,2,0.0,2,9,2,8,9,0,0,5,0,21,14,0
2531,59249,pgtfwPx3gBWk0s41FLIY8xNKvQvpnNYF,3VkHkmOtom3jM2wCu94xgzzu1d6Dn7or,82,188,77,75,94,44,15,2,495,70.71428571428571,12,0.0,104,77,71,94,84,44,4,15,2,346,149,0
2532,59259,K5WcXRk24XKmzfaggLfniRGhO7RrNYwU,3VkHkmOtom3jM2wCu94xgzzu1d6Dn7or,78,159,36,99,65,3,10,0,372,53.142857142857146,7,0.0,94,36,97,65,65,3,2,10,0,292,80,1
2533,59276,FVpwwdfn5Fmsfw0r1O3qv4L0FFnFaxUj,3VkHkmOtom3jM2wCu94xgzzu1d6Dn7or,1,0,0,0,0,0,2,0,2,0.2857142857142857,1,0.0,0,0,0,0,0,0,0,2,0,0,2,1
2534,59285,t0CXTWQ7WrgANKqIJnC4VUgKY5pjWYTr,3VkHkmOtom3jM2wCu94xgzzu1d6Dn7or,80,173,37,89,38,3,17,0,357,51.0,5,0.0,75,37,86,38,98,3,3,17,0,236,121,0
2535,59371,J37M26A4eu1dMNTJ4awU72BCV3pCgIgT,3VkHkmOtom3jM2wCu94xgzzu1d6Dn7or,55,141,48,28,37,9,16,12,291,41.57142857142857,5,0.0,35,48,22,37,106,9,6,16,12,142,149,0
2536,59389,BNeTtjRGqsezTEUWeyt7EBI5qiv9cGji,3VkHkmOtom3jM2wCu94xgzzu1d6Dn7or,1,0,0,0,0,0,1,0,1,0.14285714285714285,1,0.0,0,0,0,0,0,0,0,1,0,0,1,1
2537,59410,JqvGTplcVBLcq3YzEUVslmYGYOBREBZ1,3VkHkmOtom3jM2wCu94xgzzu1d6Dn7or,97,273,81,56,97,5,128,2,642,91.71428571428571,14,0.0,152,81,53,97,121,5,3,128,2,383,259,0
2538,59413,9IjA9lMcgPRYgobq8S0NcHZogVy6IOVi,3VkHkmOtom3jM2wCu94xgzzu1d6Dn7or,74,309,144,53,103,59,76,30,774,110.57142857142857,12,0.0,108,144,50,103,201,59,3,76,30,405,369,0
2539,59437,XUOiAiVbOv4JfR1kIXNyEruHxINz3Y5I,3VkHkmOtom3jM2wCu94xgzzu1d6Dn7or,7,1,1,0,1,0,6,1,10,1.4285714285714286,1,0.0,0,1,0,1,1,0,0,6,1,2,8,1
2540,59443,QWrnRw291WsDcGS3VosiRVOQFgq2dbZQ,3VkHkmOtom3jM2wCu94xgzzu1d6Dn7or,12,15,4,6,8,10,4,0,47,6.714285714285714,1,0.0,7,4,5,8,8,10,1,4,0,24,23,1
2541,59487,D78BRYJsTSEX9IhXU6pf9xLZreK4ME7H,3VkHkmOtom3jM2wCu94xgzzu1d6Dn7or,9,4,3,0,3,0,2,0,12,1.7142857142857142,1,0.0,0,3,0,3,4,0,0,2,0,6,6,1
2542,59500,lKNIOq5vN7FRlYNC363ARiDM2gYoUpfn,3VkHkmOtom3jM2wCu94xgzzu1d6Dn7or,18,46,10,11,22,24,10,1,124,17.714285714285715,2,0.0,33,10,9,22,13,24,2,10,1,74,50,1
2543,59525,JUlFmLEwsyE4h3GDjsDeEysCFVVb6Ze2,3VkHkmOtom3jM2wCu94xgzzu1d6Dn7or,1,0,0,0,0,0,1,0,1,0.14285714285714285,1,0.0,0,0,0,0,0,0,0,1,0,0,1,1
2544,59535,oskMvT9bm6tPbKr8z5m10beXtEHnygWp,3VkHkmOtom3jM2wCu94xgzzu1d6Dn7or,1,0,0,0,0,0,1,0,1,0.14285714285714285,1,0.0,0,0,0,0,0,0,0,1,0,0,1,1
2545,59542,ZdlJq1JbshoI9Xf2NcT388yoIk0LZFLR,3VkHkmOtom3jM2wCu94xgzzu1d6Dn7or,79,317,192,74,132,129,52,4,900,128.57142857142858,14,0.0,99,192,65,132,218,129,9,52,4,488,412,0
2546,59551,xms5yIfb8WmEpuH25dLflwHtkLnnKylG,3VkHkmOtom3jM2wCu94xgzzu1d6Dn7or,1,0,0,0,0,0,2,0,2,0.2857142857142857,2,0.0,0,0,0,0,0,0,0,2,0,0,2,1
2547,59565,p6rhKi68oPL0R5Po6jCCT1ruCe2sOWtP,3VkHkmOtom3jM2wCu94xgzzu1d6Dn7or,36,160,69,45,31,24,42,13,384,54.857142857142854,6,0.0,42,69,39,31,118,24,6,42,13,181,203,1
2548,59583,I7vOFLC3FBK6C2KcR371tMerIHOoM2go,3VkHkmOtom3jM2wCu94xgzzu1d6Dn7or,64,103,34,38,35,3,26,1,240,34.285714285714285,7,0.0,53,34,35,35,50,3,3,26,1,157,83,0
2549,59609,QJffKxs9lkFscQquMcfEw8hYo0ArYTkN,3VkHkmOtom3jM2wCu94xgzzu1d6Dn7or,42,49,26,1,24,18,11,6,135,19.285714285714285,3,0.0,12,26,1,24,37,18,0,11,6,63,72,1
2550,59614,cx5rc4XY3hf1uYzYIQcJ7om0rl1JmFnU,3VkHkmOtom3jM2wCu94xgzzu1d6Dn7or,8,16,7,0,4,0,4,0,31,4.428571428571429,2,0.0,2,7,0,4,14,0,0,4,0,13,18,1
2551,59657,oPDqUc1jMpRM1as5x92xQnWubkfyCZaR,3VkHkmOtom3jM2wCu94xgzzu1d6Dn7or,4,0,0,0,0,1,5,0,6,0.8571428571428571,2,0.0,0,0,0,0,0,1,0,5,0,0,6,1
2552,59662,GiK7Ro1CDK9bHpGz5NngB6VWgh04QYTF,3VkHkmOtom3jM2wCu94xgzzu1d6Dn7or,20,16,8,22,6,0,3,0,55,7.857142857142857,2,0.0,4,8,15,6,12,0,7,3,0,33,22,0
2553,59714,cYe4n4c9KPDfBEWjGIRj6ImLxtmj3FnE,3VkHkmOtom3jM2wCu94xgzzu1d6Dn7or,9,32,1,4,9,0,6,0,52,7.428571428571429,2,0.0,20,1,4,9,12,0,0,6,0,34,18,1
2554,59805,QjlpOVp2OfPr6el2UDKT8w3k8QqgbbR1,3VkHkmOtom3jM2wCu94xgzzu1d6Dn7or,7,3,2,0,2,0,2,0,9,1.2857142857142858,1,0.0,0,2,0,2,3,0,0,2,0,4,5,1
2555,59845,L19Rl61HvBd0dIlkC1jenj6WtHv9JPjx,3VkHkmOtom3jM2wCu94xgzzu1d6Dn7or,97,243,66,45,90,8,22,0,474,67.71428571428571,8,0.0,131,66,44,90,112,8,1,22,0,331,143,0
2556,59846,ahJ0XLttM9xeZ1eTvMINaiNiTsROIFbM,3VkHkmOtom3jM2wCu94xgzzu1d6Dn7or,1,0,0,0,0,0,1,0,1,0.14285714285714285,1,0.0,0,0,0,0,0,0,0,1,0,0,1,1
2557,59876,QJeDHnX9duNDaVhX1YBFrEjM07OpQY6u,3VkHkmOtom3jM2wCu94xgzzu1d6Dn7or,65,108,47,62,46,8,26,7,304,43.42857142857143,8,0.0,47,47,59,46,61,8,3,26,7,199,105,1
2558,59897,6vz0sqO547t2p3a0mSKkVI0plinQft8Y,3VkHkmOtom3jM2wCu94xgzzu1d6Dn7or,7,6,2,0,0,2,4,0,14,2.0,1,0.0,0,2,0,0,6,2,0,4,0,2,12,1
2559,60001,iwmwNweMTR2XxM8DDVCIW8FV8YpeIUk1,3VkHkmOtom3jM2wCu94xgzzu1d6Dn7or,1,0,0,0,0,0,1,0,1,0.14285714285714285,1,0.0,0,0,0,0,0,0,0,1,0,0,1,0
2560,60011,aq6RzL3Xg5EYCsH3vPkd60PgfB0ApzuH,3VkHkmOtom3jM2wCu94xgzzu1d6Dn7or,58,72,37,101,0,2,15,1,228,32.57142857142857,4,0.0,29,37,74,0,43,2,27,15,1,140,88,0
2561,60203,ntJs93C1h80peQsrk4sMYD3xVOjdEHeo,7GRhBDsirIGkRZBtSMEzNTyDr2JQm4xx,19,52,17,13,18,0,8,0,108,15.428571428571429,5,0.0,30,17,12,18,22,0,1,8,0,77,31,0
2562,60338,eLYgTX3CtOgrxGxhjtnNhmto5eBGG5mu,5X6FeZozNMgE2VRi3MJYjkkFK8SETtu2,1,0,0,0,0,0,1,0,1,0.14285714285714285,1,0.0,0,0,0,0,0,0,0,1,0,0,1,1
2563,60384,6PG8IjYnq0BnsuI9UCP9KSi4JIWeYzk9,5X6FeZozNMgE2VRi3MJYjkkFK8SETtu2,7,5,1,0,2,4,6,1,19,2.7142857142857144,1,0.0,3,1,0,2,2,4,0,6,1,6,13,1
2564,60419,mZP93anQs7Q6391iFwgUyfSw444ov2HX,5X6FeZozNMgE2VRi3MJYjkkFK8SETtu2,9,14,7,0,0,1,5,0,27,3.857142857142857,1,0.0,4,7,0,0,10,1,0,5,0,11,16,0
2565,60474,vjrdb3dcIFRPzYBjbX9bQR9vxorLVp2R,5X6FeZozNMgE2VRi3MJYjkkFK8SETtu2,6,4,2,0,1,0,4,0,11,1.5714285714285714,2,0.0,0,2,0,1,4,0,0,4,0,3,8,1
2566,60528,MvqSmpyUgimv8LaGxWMIruwa3ijANQg7,7GRhBDsirIGkRZBtSMEzNTyDr2JQm4xx,3,4,2,0,0,0,2,0,8,1.1428571428571428,1,0.0,0,2,0,0,4,0,0,2,0,2,6,0
2567,60582,rxoO7csZGXeNzFVWfGDQB1CjrR87Fi1E,7GRhBDsirIGkRZBtSMEzNTyDr2JQm4xx,2,0,0,0,0,0,3,0,3,0.42857142857142855,1,0.0,0,0,0,0,0,0,0,3,0,0,3,1
2568,60626,XXBE2gEIFzpOALYcvsQaoms0hFg2JiRj,5X6FeZozNMgE2VRi3MJYjkkFK8SETtu2,7,18,3,2,5,0,4,0,32,4.571428571428571,2,0.0,6,3,2,5,12,0,0,4,0,16,16,0
2569,60633,J2mZhHnfnDU9Z2NM0dfjKg8jCciGVkrO,5X6FeZozNMgE2VRi3MJYjkkFK8SETtu2,1,0,0,0,0,0,2,0,2,0.2857142857142857,2,0.0,0,0,0,0,0,0,0,2,0,0,2,1
2570,60723,QgvoRraMo579WBSQvu2KL1PVI0ztp4eg,7GRhBDsirIGkRZBtSMEzNTyDr2JQm4xx,12,18,6,0,5,0,1,0,30,4.285714285714286,1,0.0,3,6,0,5,15,0,0,1,0,14,16,0
2571,60750,KIzKwTc9s5nLMeFkLowp0YY73nAebF3x,5X6FeZozNMgE2VRi3MJYjkkFK8SETtu2,1,0,0,0,0,0,1,0,1,0.14285714285714285,1,0.0,0,0,0,0,0,0,0,1,0,0,1,1
2572,60775,6jsGEWL0U9hBDrcwX1Jhf47LKTflSRAd,5Gyp41oLVo7Gg7vF4vpmggWP5MU70QO6,9,6,4,0,2,0,6,0,18,2.5714285714285716,3,0.0,0,4,0,2,6,0,0,6,0,6,12,1
2573,60783,o7l3PNeVIF0KFbKUxAraXosVaTUbHolk,5Gyp41oLVo7Gg7vF4vpmggWP5MU70QO6,17,35,16,0,3,14,9,1,78,11.142857142857142,5,0.0,0,16,0,3,35,14,0,9,1,19,59,0
2574,60842,WOMVOuYGnWcZ0JUVdlAJuK7IMUPymW9W,5Gyp41oLVo7Gg7vF4vpmggWP5MU70QO6,5,2,1,0,1,0,2,0,6,0.8571428571428571,1,0.0,0,1,0,1,2,0,0,2,0,2,4,1
2575,60849,8n73BBd3mvRJq2a0KZ4WJWTYj65s8f61,5Gyp41oLVo7Gg7vF4vpmggWP5MU70QO6,17,26,10,6,7,9,4,0,62,8.857142857142858,2,0.0,6,10,3,7,20,9,3,4,0,26,36,1
2576,60867,6MPgAabkihjgEiW7WAmGKWYKFdGXICpQ,5Gyp41oLVo7Gg7vF4vpmggWP5MU70QO6,12,17,6,4,3,3,10,2,45,6.428571428571429,1,0.0,4,6,3,3,13,3,1,10,2,16,29,1
2577,60882,jFlacyEy6lTVCBjW1JtG8q0M3te6pg5n,5Gyp41oLVo7Gg7vF4vpmggWP5MU70QO6,15,13,7,3,5,5,3,1,37,5.285714285714286,1,0.0,5,7,2,5,8,5,1,3,1,19,18,1
2578,60955,M3my6svOw1PavchA0YdMglvZWFkBWiG6,7GRhBDsirIGkRZBtSMEzNTyDr2JQm4xx,8,4,2,0,2,3,5,0,16,2.2857142857142856,1,0.0,1,2,0,2,3,3,0,5,0,5,11,1
2579,60958,hcKYo6bLhlANvHE0FxLuR4YY8jocfBwJ,5X6FeZozNMgE2VRi3MJYjkkFK8SETtu2,1,0,0,0,0,0,2,0,2,0.2857142857142857,2,0.0,0,0,0,0,0,0,0,2,0,0,2,1
2580,61021,ML7lqxkr8UE3GSzEAbC41OZ48awqIWDQ,5X6FeZozNMgE2VRi3MJYjkkFK8SETtu2,19,34,2,9,12,0,4,0,61,8.714285714285714,2,0.0,20,2,8,12,14,0,1,4,0,42,19,1
2581,61042,hJwtwnOzJaTrAeP4eXJAEwz2xbKsgc4M,5X6FeZozNMgE2VRi3MJYjkkFK8SETtu2,1,0,0,0,0,0,7,0,7,1.0,6,0.0,0,0,0,0,0,0,0,7,0,0,7,0
2582,61053,n6MSfSRQxQ2tFGWCXdV4l1HaMuqMUtGk,5X6FeZozNMgE2VRi3MJYjkkFK8SETtu2,2,0,0,0,0,0,2,0,2,0.2857142857142857,1,0.0,0,0,0,0,0,0,0,2,0,0,2,1
2583,61078,32y2lN481foloAGLc2nySQzWPV3H4zBA,5X6FeZozNMgE2VRi3MJYjkkFK8SETtu2,52,64,17,70,11,33,23,6,224,32.0,3,0.0,33,17,61,11,31,33,9,23,6,122,102,0
2584,61107,WdSoXtOMswCwqhOj9IeHsSFtlZ2Gh4td,5X6FeZozNMgE2VRi3MJYjkkFK8SETtu2,6,3,2,0,1,0,2,1,9,1.2857142857142858,1,0.0,0,2,0,1,3,0,0,2,1,3,6,1
2585,61111,v6Wfy2XnikKgnCNfehO3TIQzyPp7MzcN,5X6FeZozNMgE2VRi3MJYjkkFK8SETtu2,3,2,0,0,0,0,2,0,4,0.5714285714285714,1,0.0,0,0,0,0,2,0,0,2,0,0,4,1
2586,61117,Bv9FSXvHlE6wLC4E4yrAKqe3BQhrrtfx,5X6FeZozNMgE2VRi3MJYjkkFK8SETtu2,9,12,2,0,2,0,4,0,20,2.857142857142857,3,0.0,0,2,0,2,12,0,0,4,0,4,16,1
2587,61118,pGlV0XYWRjXFSIdN56x9p6AvQyXwsZVS,7GRhBDsirIGkRZBtSMEzNTyDr2JQm4xx,8,19,12,0,0,1,7,0,39,5.571428571428571,5,0.0,0,12,0,0,19,1,0,7,0,12,27,0
2588,61172,UMRdBsbRudHs8ingA4ke7ICTKEQFr49p,5X6FeZozNMgE2VRi3MJYjkkFK8SETtu2,3,2,1,0,0,0,3,0,6,0.8571428571428571,2,0.0,0,1,0,0,2,0,0,3,0,1,5,1
2589,61185,n7VbclmNFgHca9uIA7XLlwfjpU3yKU9I,5X6FeZozNMgE2VRi3MJYjkkFK8SETtu2,1,0,0,0,0,0,1,0,1,0.14285714285714285,1,0.0,0,0,0,0,0,0,0,1,0,0,1,1
2590,61219,x7KkvyitGXFvQqFgPSjCNkOjX6xpeh38,5X6FeZozNMgE2VRi3MJYjkkFK8SETtu2,1,0,0,0,0,0,1,0,1,0.14285714285714285,1,0.0,0,0,0,0,0,0,0,1,0,0,1,1
2591,61232,ce2xgxgKPugRCQfAePYG4Tetc1mQMFo7,5X6FeZozNMgE2VRi3MJYjkkFK8SETtu2,12,9,1,0,3,0,11,2,26,3.7142857142857144,2,0.0,4,1,0,3,5,0,0,11,2,8,18,0
2592,61240,c9jABEJQla4i8vH29nKPFM4cx5bWdrLS,5X6FeZozNMgE2VRi3MJYjkkFK8SETtu2,6,4,3,0,2,0,1,0,10,1.4285714285714286,1,0.0,0,3,0,2,4,0,0,1,0,5,5,1
2593,61245,o2ZQJxCanJ3w0ltDKvU6h1ywkqWgYJ6P,5X6FeZozNMgE2VRi3MJYjkkFK8SETtu2,1,0,0,0,0,0,1,0,1,0.14285714285714285,1,0.0,0,0,0,0,0,0,0,1,0,0,1,1
2594,61247,NcQnTEbHZILfo8rybQg3CkBD2Sky9WEj,5X6FeZozNMgE2VRi3MJYjkkFK8SETtu2,1,0,0,0,0,0,1,0,1,0.14285714285714285,1,0.0,0,0,0,0,0,0,0,1,0,0,1,1
2595,61264,JEpliMmXtCD1f20f9cDXpO6iC4w7XAsT,3VkHkmOtom3jM2wCu94xgzzu1d6Dn7or,11,15,4,3,3,11,4,1,41,5.857142857142857,1,0.0,7,4,3,3,8,11,0,4,1,17,24,1
2596,61273,vdrctU6z84HquJbn26DyEa3NVX5vLhQL,3VkHkmOtom3jM2wCu94xgzzu1d6Dn7or,47,109,66,68,0,11,59,12,325,46.42857142857143,9,0.0,41,66,66,0,68,11,2,59,12,173,152,0
2597,61280,3ekpb9qQNnBvDGQePlspHv7VLn9RhUhL,3VkHkmOtom3jM2wCu94xgzzu1d6Dn7or,64,225,96,51,58,16,73,2,521,74.42857142857143,12,0.0,87,96,45,58,138,16,6,73,2,286,235,0
2598,61283,5aPAA192VwNTYk7841taL2eEoPM52Jfz,3VkHkmOtom3jM2wCu94xgzzu1d6Dn7or,53,197,34,47,13,1,16,0,308,44.0,4,0.0,84,34,44,13,113,1,3,16,0,175,133,0
2599,61287,vetJW7RuToyhRheyNbhLwQDgLf24lCFq,3VkHkmOtom3jM2wCu94xgzzu1d6Dn7or,71,189,86,41,62,19,26,4,427,61.0,9,0.0,53,86,40,62,136,19,1,26,4,241,186,0
2600,61288,zdy1QpN6U4yT7fJKj0iIeDZ8SZMHSUli,3VkHkmOtom3jM2wCu94xgzzu1d6Dn7or,25,115,59,1,0,8,19,3,205,29.285714285714285,8,0.0,6,59,1,0,109,8,0,19,3,66,139,1
2601,61289,hWqlzSeDUWvRgDnoegNqlT5f17ELTuKs,3VkHkmOtom3jM2wCu94xgzzu1d6Dn7or,1,0,0,0,0,0,1,0,1,0.14285714285714285,1,0.0,0,0,0,0,0,0,0,1,0,0,1,1
2602,61292,j7TgGntsKaHCn37V8wIZU588nsiRvQRv,3VkHkmOtom3jM2wCu94xgzzu1d6Dn7or,5,3,1,0,1,0,2,0,7,1.0,1,0.0,1,1,0,1,2,0,0,2,0,3,4,1
2603,61296,R23hQIkxpjGDipcAUB8Dm9M15B8oN1UL,3VkHkmOtom3jM2wCu94xgzzu1d6Dn7or,4,2,1,0,1,0,2,0,6,0.8571428571428571,1,0.0,0,1,0,1,2,0,0,2,0,2,4,1
2604,61297,IUA6p2JLyLSZjGDsPJmwHTr1A8GTMvVI,3VkHkmOtom3jM2wCu94xgzzu1d6Dn7or,1,0,0,0,0,0,1,0,1,0.14285714285714285,1,0.0,0,0,0,0,0,0,0,1,0,0,1,1
2605,61302,UoGg1lPcQINyRstNoDBUCvVALukMvBmE,3VkHkmOtom3jM2wCu94xgzzu1d6Dn7or,12,27,7,5,9,9,8,1,66,9.428571428571429,1,0.0,17,7,5,9,10,9,0,8,1,38,28,1
2606,61303,ANJ7A7TrnpRJsv1mG7Zq08b8gsBzPJqI,3VkHkmOtom3jM2wCu94xgzzu1d6Dn7or,18,16,5,1,6,8,5,0,41,5.857142857142857,2,0.0,1,5,1,6,15,8,0,5,0,13,28,1
2607,61309,XMft5aKdR2QyFQr0WCozlGeSY245StJA,3VkHkmOtom3jM2wCu94xgzzu1d6Dn7or,14,7,6,0,6,0,1,0,20,2.857142857142857,1,0.0,0,6,0,6,7,0,0,1,0,12,8,1
2608,61322,3BjF53t2QMAE7ObQUT7JSiEn9PG6iUMa,3VkHkmOtom3jM2wCu94xgzzu1d6Dn7or,51,112,57,43,41,1,26,0,280,40.0,8,0.0,33,57,39,41,79,1,4,26,0,170,110,0
2609,61330,8SxkVH1KXschEM8m0GUMD8LyRo49iJfX,3VkHkmOtom3jM2wCu94xgzzu1d6Dn7or,5,2,1,0,1,0,3,0,7,1.0,1,0.0,0,1,0,1,2,0,0,3,0,2,5,1
2610,61337,PBX3b8Kr9EgCK8wPL1p1l8ywBkxFbxYJ,3VkHkmOtom3jM2wCu94xgzzu1d6Dn7or,7,9,4,0,3,0,2,0,18,2.5714285714285716,1,0.0,0,4,0,3,9,0,0,2,0,7,11,1
2611,61338,7Bmm9GcoXo4ZVWS3KQRfYLX18LcqBOIZ,3VkHkmOtom3jM2wCu94xgzzu1d6Dn7or,25,28,18,7,17,4,10,1,85,12.142857142857142,2,0.0,4,18,6,17,24,4,1,10,1,45,40,1
2612,61339,aG1yf2MaLqi6uq33RqoMaXdTZU0rd74j,3VkHkmOtom3jM2wCu94xgzzu1d6Dn7or,1,0,0,0,0,0,1,0,1,0.14285714285714285,1,0.0,0,0,0,0,0,0,0,1,0,0,1,1
2613,61343,grEUheAl7r2qUdLFFy9nEMsG9X5GQrvY,3VkHkmOtom3jM2wCu94xgzzu1d6Dn7or,7,3,0,0,1,3,37,2,46,6.571428571428571,6,0.0,0,0,0,1,3,3,0,37,2,1,45,1
2614,61352,pdAqVvKgeCIaihAcxhTXOYjPQxxjaa8K,3VkHkmOtom3jM2wCu94xgzzu1d6Dn7or,27,43,26,0,9,19,12,3,112,16.0,7,0.0,0,26,0,9,43,19,0,12,3,35,77,0
2615,61358,m049rAeyoDiszWWKcpCd8SSBaFdNVXp5,3VkHkmOtom3jM2wCu94xgzzu1d6Dn7or,4,4,1,0,2,0,1,0,8,1.1428571428571428,1,0.0,2,1,0,2,2,0,0,1,0,5,3,1
2616,61361,v2BQnPPIdaQjY7RJTTV8xwj4C0h9I3eb,3VkHkmOtom3jM2wCu94xgzzu1d6Dn7or,4,2,1,0,1,0,2,0,6,0.8571428571428571,2,0.0,0,1,0,1,2,0,0,2,0,2,4,1
2617,61369,983eChF7TXCDNFahN1r3Vh0veTcz2k4r,3VkHkmOtom3jM2wCu94xgzzu1d6Dn7or,31,99,25,27,32,20,15,0,218,31.142857142857142,7,0.0,58,25,25,32,41,20,2,15,0,140,78,1
2618,61378,muRdAe2fZ5hc80crolkh8NalL0e0B6VK,3VkHkmOtom3jM2wCu94xgzzu1d6Dn7or,22,62,17,20,27,10,6,0,142,20.285714285714285,2,0.0,40,17,18,27,22,10,2,6,0,102,40,0
2619,61383,Nmas2ArombYYvowRmyUSQPWFycG8cFpP,3VkHkmOtom3jM2wCu94xgzzu1d6Dn7or,9,15,6,5,8,3,4,0,41,5.857142857142857,1,0.0,8,6,4,8,7,3,1,4,0,26,15,1
2620,61409,mDwdQwCw7B1nTYkcQqHPipLA4xUDSqaA,3VkHkmOtom3jM2wCu94xgzzu1d6Dn7or,12,7,5,0,4,0,3,0,19,2.7142857142857144,2,0.0,0,5,0,4,7,0,0,3,0,9,10,1
2621,61413,7MbcYCJMqsDkqF86OrGyQBYf6d8IyUP2,3VkHkmOtom3jM2wCu94xgzzu1d6Dn7or,6,1,1,0,1,0,4,0,7,1.0,1,0.0,0,1,0,1,1,0,0,4,0,2,5,1
2622,61414,cpwynrsc92vzcpcvaowjPQ8oLt1LV2qH,3VkHkmOtom3jM2wCu94xgzzu1d6Dn7or,8,11,1,0,4,1,5,0,22,3.142857142857143,2,0.0,0,1,0,4,11,1,0,5,0,5,17,1
2623,61415,C0CJOketxybQKnmXYZM4O9Q98wL6vPo7,3VkHkmOtom3jM2wCu94xgzzu1d6Dn7or,18,52,11,13,18,6,5,0,105,15.0,1,0.0,33,11,10,18,19,6,3,5,0,72,33,0
2624,61422,5v4FcTvaejU15T2ItxUWpcwwFvA20Pjq,3VkHkmOtom3jM2wCu94xgzzu1d6Dn7or,14,8,7,0,7,0,1,0,23,3.2857142857142856,1,0.0,0,7,0,7,8,0,0,1,0,14,9,1
2625,61424,OB72EsCF8FIJeTl5alitCf5PMpMSzMkw,3VkHkmOtom3jM2wCu94xgzzu1d6Dn7or,18,17,13,0,9,0,3,0,42,6.0,3,0.0,0,13,0,9,17,0,0,3,0,22,20,1
2626,61435,o70jYwhoKCmnPM1c3Oxa7KjxPlFBaR5Y,3VkHkmOtom3jM2wCu94xgzzu1d6Dn7or,13,9,5,0,4,3,9,1,31,4.428571428571429,2,0.0,2,5,0,4,7,3,0,9,1,11,20,1
2627,61436,daGaQWvd8jWD5XDvCZOsKViIYZg7WMm2,3VkHkmOtom3jM2wCu94xgzzu1d6Dn7or,20,27,6,12,8,14,4,0,71,10.142857142857142,3,0.0,7,6,11,8,20,14,1,4,0,32,39,1
2628,61441,uCB5uEbohrhji79dydXW4G40PBAqm3fB,3VkHkmOtom3jM2wCu94xgzzu1d6Dn7or,4,2,1,0,0,0,2,0,5,0.7142857142857143,1,0.0,0,1,0,0,2,0,0,2,0,1,4,1
2629,61442,7KmSj9gPWQW08MBykakmpuPR1HhDrt95,3VkHkmOtom3jM2wCu94xgzzu1d6Dn7or,3,0,0,0,0,0,4,0,4,0.5714285714285714,1,0.0,0,0,0,0,0,0,0,4,0,0,4,1
2630,61443,phZKknvLtktzxGbSqd3jYoZNzB4llO7e,3VkHkmOtom3jM2wCu94xgzzu1d6Dn7or,17,43,22,14,9,46,23,3,160,22.857142857142858,4,0.0,9,22,12,9,34,46,2,23,3,52,108,1
2631,61445,XEl6l3YNAqiK2bbAqUBja025BsmiOy3u,3VkHkmOtom3jM2wCu94xgzzu1d6Dn7or,6,4,0,0,1,0,2,0,7,1.0,1,0.0,0,0,0,1,4,0,0,2,0,1,6,1
2632,61453,NRS1MhesGO7zUR8hdwEPUCbOfwrM8vqe,3VkHkmOtom3jM2wCu94xgzzu1d6Dn7or,1,0,0,0,0,0,1,0,1,0.14285714285714285,1,0.0,0,0,0,0,0,0,0,1,0,0,1,1
2633,61454,9RGlF1zN4LpcMozL1W04PrZshJESSRMc,3VkHkmOtom3jM2wCu94xgzzu1d6Dn7or,21,54,21,18,9,13,8,0,123,17.571428571428573,4,0.0,20,21,16,9,34,13,2,8,0,66,57,0
2634,61458,s62wGhBGz9HXss3L6a4JWxa0i5RWwlaT,3VkHkmOtom3jM2wCu94xgzzu1d6Dn7or,16,28,13,5,10,14,9,0,79,11.285714285714286,1,0.0,6,13,4,10,22,14,1,9,0,33,46,1
2635,61463,JgSF96URyx4xETuoqSIyFv46Qndmj1Nf,3VkHkmOtom3jM2wCu94xgzzu1d6Dn7or,5,3,0,0,0,0,5,0,8,1.1428571428571428,2,0.0,0,0,0,0,3,0,0,5,0,0,8,1
2636,61472,xEf6ArYJDQPvlIL0dlKzw54A012YoV5b,3VkHkmOtom3jM2wCu94xgzzu1d6Dn7or,8,6,2,0,3,0,2,0,13,1.8571428571428572,1,0.0,0,2,0,3,6,0,0,2,0,5,8,1
2637,61476,tj4EHeHo9HuoGvU4vkCjfii6Us385itQ,3VkHkmOtom3jM2wCu94xgzzu1d6Dn7or,6,2,1,0,1,0,9,1,14,2.0,1,0.0,0,1,0,1,2,0,0,9,1,2,12,1
2638,61477,QclfSjcpKfuYDuPZ2QSbL6dQsQJRlpNz,3VkHkmOtom3jM2wCu94xgzzu1d6Dn7or,1,0,0,0,0,0,1,0,1,0.14285714285714285,1,0.0,0,0,0,0,0,0,0,1,0,0,1,1
2639,61487,YfLkHn3sP8pusiYlKK6o5F2jXKBNkL8d,3VkHkmOtom3jM2wCu94xgzzu1d6Dn7or,73,318,105,70,97,79,38,1,708,101.14285714285714,13,0.0,145,105,63,97,173,79,7,38,1,410,298,0
2640,61490,6LOq8KkmV5c0FKxzWJqIgAOWRnnZZoko,3VkHkmOtom3jM2wCu94xgzzu1d6Dn7or,8,18,7,0,4,1,8,1,39,5.571428571428571,4,0.0,0,7,0,4,18,1,0,8,1,11,28,1
2641,61491,QJLvLq3gePlOhM8YM9FYb5Ju7geKwvAe,3VkHkmOtom3jM2wCu94xgzzu1d6Dn7or,4,2,1,0,0,0,2,0,5,0.7142857142857143,1,0.0,0,1,0,0,2,0,0,2,0,1,4,1
2642,61494,a4RYqILKcnu8c617gYSbD0KQIm9DqZnc,3VkHkmOtom3jM2wCu94xgzzu1d6Dn7or,14,22,1,9,2,0,10,0,44,6.285714285714286,1,0.0,7,1,8,2,15,0,1,10,0,18,26,1
2643,61504,n3nLIdaq5tMG7W5fYlQfmpVKio954PQo,3VkHkmOtom3jM2wCu94xgzzu1d6Dn7or,56,137,39,38,48,31,22,1,316,45.142857142857146,7,0.0,80,39,32,48,57,31,6,22,1,199,117,0
2644,61505,TDWwQzWRFKSB58lhGmZfTgWh2AXj0IEg,3VkHkmOtom3jM2wCu94xgzzu1d6Dn7or,1,0,0,0,0,0,1,0,1,0.14285714285714285,1,0.0,0,0,0,0,0,0,0,1,0,0,1,1
2645,61515,V42fQnxEvfLIX0xediorVPrFT3AqjWxV,3VkHkmOtom3jM2wCu94xgzzu1d6Dn7or,11,13,7,0,5,0,3,0,28,4.0,2,0.0,3,7,0,5,10,0,0,3,0,15,13,1
2646,61525,PoH1dyt4rU4L6DwgAxdBCMIsFGeifqpi,3VkHkmOtom3jM2wCu94xgzzu1d6Dn7or,5,5,2,0,1,2,3,0,13,1.8571428571428572,1,0.0,0,2,0,1,5,2,0,3,0,3,10,1
2647,61527,0zObXmoXHP7rszDYuu8m5842mUKzCfEP,3VkHkmOtom3jM2wCu94xgzzu1d6Dn7or,14,23,12,7,7,48,22,9,128,18.285714285714285,2,0.0,3,12,6,7,20,48,1,22,9,28,100,1
2648,61546,wwbn6fxolJbKMPkZNKyvhoEMjxJa1TwV,3VkHkmOtom3jM2wCu94xgzzu1d6Dn7or,6,11,4,0,3,0,2,0,20,2.857142857142857,2,0.0,4,4,0,3,7,0,0,2,0,11,9,1
2649,61550,dJoaCvWN3EHhsbVDKX0go1Uowy9lNb0x,3VkHkmOtom3jM2wCu94xgzzu1d6Dn7or,25,33,21,10,16,1,5,0,86,12.285714285714286,3,0.0,6,21,9,16,27,1,1,5,0,52,34,1
2650,61551,wusaIU5qw1H9frm0uNri3Vm4KGQ9haEv,3VkHkmOtom3jM2wCu94xgzzu1d6Dn7or,21,51,21,9,12,15,19,2,129,18.428571428571427,3,0.0,12,21,8,12,39,15,1,19,2,53,76,1
2651,61557,sT9hGAnww95aeGvqwQpJlS3ORhWDT49F,3VkHkmOtom3jM2wCu94xgzzu1d6Dn7or,24,59,23,13,16,4,13,0,128,18.285714285714285,5,0.0,19,23,12,16,40,4,1,13,0,70,58,0
2652,61564,LPE2LOhMecA7VGBvL2FJKN8PdPw13cWH,3VkHkmOtom3jM2wCu94xgzzu1d6Dn7or,6,2,1,0,1,0,7,0,11,1.5714285714285714,2,0.0,0,1,0,1,2,0,0,7,0,2,9,1
2653,61566,RWCpdR1QB6n8j1h0KpkVY43KpnLl1nGl,3VkHkmOtom3jM2wCu94xgzzu1d6Dn7or,2,0,0,0,0,0,2,0,2,0.2857142857142857,1,0.0,0,0,0,0,0,0,0,2,0,0,2,1
2654,61567,IJw5Z6gzTBCnSJikgjAAPcSAKOBBnV80,3VkHkmOtom3jM2wCu94xgzzu1d6Dn7or,4,2,1,0,1,0,1,0,5,0.7142857142857143,1,0.0,0,1,0,1,2,0,0,1,0,2,3,1
2655,61574,EttKeSyg9r0EcjglXuiRsuMNde5ZPNQV,3VkHkmOtom3jM2wCu94xgzzu1d6Dn7or,1,0,0,0,0,0,1,0,1,0.14285714285714285,1,0.0,0,0,0,0,0,0,0,1,0,0,1,1
2656,61576,avQyhVbbLRU4xSqnn8C1NdzgvYmkJMZ5,3VkHkmOtom3jM2wCu94xgzzu1d6Dn7or,11,23,10,7,12,1,2,0,55,7.857142857142857,4,0.0,12,10,6,12,11,1,1,2,0,40,15,1
2657,61583,PB9Q9zUiehL1k7ymOn3dwnmL6aMiqjzW,3VkHkmOtom3jM2wCu94xgzzu1d6Dn7or,52,77,49,0,47,3,17,0,193,27.571428571428573,12,0.0,0,49,0,47,77,3,0,17,0,96,97,0
2658,61592,BAErsYTdltqVQgh0VALINL0pm3QcxIG4,SpATywNh6bZuzm8s1ceuBUnMUAeoAHHw,29,34,2,44,0,0,4,0,84,12.0,1,0.0,7,2,40,0,27,0,4,4,0,49,35,0
2659,61594,gAvRDaA2RH7LeyEqnpEQ7DzPuz3btZqk,SpATywNh6bZuzm8s1ceuBUnMUAeoAHHw,23,27,18,11,0,13,2,0,71,10.142857142857142,3,0.0,4,18,11,0,23,13,0,2,0,33,38,0
2660,61595,3rZRyyAqQR0LHT7iXSTyhR4wZI7IzOpN,SpATywNh6bZuzm8s1ceuBUnMUAeoAHHw,24,28,2,24,2,0,4,0,60,8.571428571428571,2,0.0,8,2,20,2,20,0,4,4,0,32,28,0
2661,61601,gLjUrp9o3bBy4JIhHE7DImScxZdU76o3,bWdj2GDclj5ofokWjzoa5jAwMkxCykd6,46,32,21,120,8,0,1,0,182,26.0,5,0.0,7,21,106,8,25,0,14,1,0,142,40,0
2662,61613,gF4BAuOIIfmyUL9KgVWqdIaoDpcXFfvU,SpATywNh6bZuzm8s1ceuBUnMUAeoAHHw,10,16,9,0,0,0,5,1,31,4.428571428571429,1,0.0,1,9,0,0,15,0,0,5,1,10,21,1
2663,61621,DalyYw8MkLaUQVgRjoRWxfyFlojIr1rE,SpATywNh6bZuzm8s1ceuBUnMUAeoAHHw,7,2,0,0,0,1,5,1,9,1.2857142857142858,1,0.0,0,0,0,0,2,1,0,5,1,0,9,1
2664,61630,mEaBiGskXMI8aCGx7L64re12PFHqkWG3,5X6FeZozNMgE2VRi3MJYjkkFK8SETtu2,1,0,0,0,0,0,1,0,1,0.14285714285714285,1,0.0,0,0,0,0,0,0,0,1,0,0,1,1
2665,61633,nAYvdcBZT3LBrha8JRPtv9HcsoTpFg23,SpATywNh6bZuzm8s1ceuBUnMUAeoAHHw,7,5,1,19,0,0,1,0,26,3.7142857142857144,1,0.0,2,1,17,0,3,0,2,1,0,20,6,0
2666,61683,e2DCnBsdIMfs4frEMfrVflupqPP0kjPk,SpATywNh6bZuzm8s1ceuBUnMUAeoAHHw,4,3,2,0,2,0,1,0,8,1.1428571428571428,1,0.0,0,2,0,2,3,0,0,1,0,4,4,1
2667,61685,Iy2ElCZpRw3zxSRKsJzk7TkINwbfRI7p,A3fsA9Zfv1X2fVEQhTw51lKENdNrEqT3,2,0,0,0,0,0,2,0,2,0.2857142857142857,1,0.0,0,0,0,0,0,0,0,2,0,0,2,1
2668,61700,BtXHQTU4PSU1WxWZavlraTV0sQL99KBJ,SpATywNh6bZuzm8s1ceuBUnMUAeoAHHw,26,160,55,39,3,4,24,1,286,40.857142857142854,5,0.0,59,55,34,3,101,4,5,24,1,151,135,0
2669,61718,dfQzarPyX3ZOG61gPJJguJUtLjMr4a3c,5X6FeZozNMgE2VRi3MJYjkkFK8SETtu2,10,11,1,0,2,4,14,1,33,4.714285714285714,2,0.0,2,1,0,2,9,4,0,14,1,5,28,1
2670,61720,g5Zuj0nrhTe9a8GO1yZuWyTfnljIqqOF,SpATywNh6bZuzm8s1ceuBUnMUAeoAHHw,1,0,0,0,0,0,1,0,1,0.14285714285714285,1,0.0,0,0,0,0,0,0,0,1,0,0,1,1
2671,61757,lH1Zg2rCl3kv8uXAu0T77rdY9bAtw7jj,A3fsA9Zfv1X2fVEQhTw51lKENdNrEqT3,1,0,0,0,0,0,1,0,1,0.14285714285714285,1,0.0,0,0,0,0,0,0,0,1,0,0,1,1
2672,61768,6ewbhsgJh7NTFUpGTc6v0or3nCOYP5Dz,A3fsA9Zfv1X2fVEQhTw51lKENdNrEqT3,7,4,3,0,3,0,3,0,13,1.8571428571428572,1,0.0,0,3,0,3,4,0,0,3,0,6,7,1
2673,61769,8OaIpodRGkGBtSK5GRdmOhSTzFcjSPbv,SpATywNh6bZuzm8s1ceuBUnMUAeoAHHw,4,2,0,0,0,0,2,1,5,0.7142857142857143,1,0.0,0,0,0,0,2,0,0,2,1,0,5,1
2674,61783,9y6ouBDNmbaFfULhDrj0DUptWL9j98bK,A3fsA9Zfv1X2fVEQhTw51lKENdNrEqT3,8,4,3,0,2,0,3,0,12,1.7142857142857142,1,0.0,0,3,0,2,4,0,0,3,0,5,7,1
2675,61786,CE534SSZ9CscDvjbZWQWNUmxhQozf8Uw,SpATywNh6bZuzm8s1ceuBUnMUAeoAHHw,27,20,12,28,8,0,1,0,69,9.857142857142858,1,0.0,6,12,24,8,14,0,4,1,0,50,19,0
2676,61792,0uyw0Qpq6NMqAKkX4nFU1z9zeAKJ6uAx,SpATywNh6bZuzm8s1ceuBUnMUAeoAHHw,1,0,0,0,0,0,2,0,2,0.2857142857142857,2,0.0,0,0,0,0,0,0,0,2,0,0,2,1
2677,61798,C912XMR2YQ2SiCcqNj7moioYbFr61u4G,SpATywNh6bZuzm8s1ceuBUnMUAeoAHHw,35,74,37,28,21,18,12,0,190,27.142857142857142,5,0.0,11,37,24,21,63,18,4,12,0,93,97,0
2678,61830,kwuXJ2OlYPv73Qvs7nhCrPuljDf9YYGy,SpATywNh6bZuzm8s1ceuBUnMUAeoAHHw,33,48,17,48,3,17,19,1,153,21.857142857142858,3,0.0,19,17,41,3,29,17,7,19,1,80,73,0
2679,61873,GjYrFH6x4o6vyLHEw4EuuSJvAfuLPk1y,SpATywNh6bZuzm8s1ceuBUnMUAeoAHHw,9,12,8,0,0,1,5,0,26,3.7142857142857144,1,0.0,1,8,0,0,11,1,0,5,0,9,17,0
2680,61879,fHEcWln3a2mF8YT5C7MBT2amDZFG7e3O,bWdj2GDclj5ofokWjzoa5jAwMkxCykd6,6,3,2,0,2,0,1,0,8,1.1428571428571428,1,0.0,0,2,0,2,3,0,0,1,0,4,4,1
2681,61887,BCPOhUa2LrfH93ebCE15VbF0VEWEyi7T,A3fsA9Zfv1X2fVEQhTw51lKENdNrEqT3,2,0,0,0,0,0,3,0,3,0.42857142857142855,2,0.0,0,0,0,0,0,0,0,3,0,0,3,1
2682,61891,Ahk1LGYY70CyZ8ESdZW417bRWfeRmJfs,bWdj2GDclj5ofokWjzoa5jAwMkxCykd6,1,0,0,0,0,0,1,0,1,0.14285714285714285,1,0.0,0,0,0,0,0,0,0,1,0,0,1,1
2683,61894,Jpxsd7AQ90urdftfAf3y5kTy6w3x8OIk,bWdj2GDclj5ofokWjzoa5jAwMkxCykd6,7,7,3,0,1,0,4,0,15,2.142857142857143,2,0.0,0,3,0,1,7,0,0,4,0,4,11,0
2684,61898,9yCiTXZqdk1Eqh0c2zCIzdE0Lnr56YUk,bWdj2GDclj5ofokWjzoa5jAwMkxCykd6,7,2,1,0,1,21,8,0,33,4.714285714285714,1,0.0,0,1,0,1,2,21,0,8,0,2,31,1
2685,61902,q2vdNmhZGOp0NF57Oy2lI01Qgjw4Vdei,SpATywNh6bZuzm8s1ceuBUnMUAeoAHHw,11,15,9,1,5,0,2,0,32,4.571428571428571,2,0.0,2,9,1,5,13,0,0,2,0,17,15,1
2686,61904,zt8D4cN45BQ8WOokF7iya4FQJ1n05JY2,SpATywNh6bZuzm8s1ceuBUnMUAeoAHHw,4,4,3,0,0,0,2,0,9,1.2857142857142858,1,0.0,0,3,0,0,4,0,0,2,0,3,6,0
2687,61913,SELnldPPHeEehfXeLln8ZyG56a4eP0sK,bWdj2GDclj5ofokWjzoa5jAwMkxCykd6,10,10,7,0,5,0,3,0,25,3.5714285714285716,1,0.0,1,7,0,5,9,0,0,3,0,13,12,1
2688,61932,Bt8fhv7JWMS0R0BH7KVe6T8wFL5ltC7B,SpATywNh6bZuzm8s1ceuBUnMUAeoAHHw,1,0,0,0,0,0,1,0,1,0.14285714285714285,1,0.0,0,0,0,0,0,0,0,1,0,0,1,0
2689,61938,rf0PAlVV7dAbnB4kixwqY56KcswtG4PA,SpATywNh6bZuzm8s1ceuBUnMUAeoAHHw,45,92,20,50,15,0,13,4,194,27.714285714285715,3,0.0,14,20,42,15,78,0,8,13,4,91,103,0
2690,61940,gaDguOzhGUiRAlt47AbgfmnftuQ8EhI2,SpATywNh6bZuzm8s1ceuBUnMUAeoAHHw,33,43,27,43,17,3,1,0,134,19.142857142857142,4,0.0,8,27,37,17,35,3,6,1,0,89,45,1
2691,61966,CGa05qeYRddNsilbgdI6KEuTUktkBAbB,A3fsA9Zfv1X2fVEQhTw51lKENdNrEqT3,11,7,3,0,2,4,15,0,31,4.428571428571429,1,0.0,0,3,0,2,7,4,0,15,0,5,26,1
2692,61982,mVfMHNhmAc9wpidT4yWiDxyeVB96h1nE,5X6FeZozNMgE2VRi3MJYjkkFK8SETtu2,1,0,0,0,0,0,1,0,1,0.14285714285714285,1,0.0,0,0,0,0,0,0,0,1,0,0,1,1
2693,61988,FX39OUMp2fc5cOhN2hgQkfpLfm3Fwtwz,SpATywNh6bZuzm8s1ceuBUnMUAeoAHHw,1,0,0,0,0,0,1,0,1,0.14285714285714285,1,0.0,0,0,0,0,0,0,0,1,0,0,1,1
2694,62007,n9EKrEMijwWCzLds970XMB69EdoGIA9c,SpATywNh6bZuzm8s1ceuBUnMUAeoAHHw,3,2,1,0,0,0,2,0,5,0.7142857142857143,1,0.0,0,1,0,0,2,0,0,2,0,1,4,0
2695,62020,RYtiMEnLizT9o6Yga3jfTWdH35jeH8Bp,SpATywNh6bZuzm8s1ceuBUnMUAeoAHHw,41,84,35,111,12,9,16,2,269,38.42857142857143,3,0.0,29,35,104,12,55,9,7,16,2,180,89,0
2696,62025,PDbQl9kvVSEqhb3jM3LOTLEyGnuh6urj,SpATywNh6bZuzm8s1ceuBUnMUAeoAHHw,24,21,15,0,11,0,3,0,50,7.142857142857143,3,0.0,0,15,0,11,21,0,0,3,0,26,24,0
2697,62026,CGa05qeYRddNsilbgdI6KEuTUktkBAbB,bWdj2GDclj5ofokWjzoa5jAwMkxCykd6,2,0,0,0,0,0,2,0,2,0.2857142857142857,1,0.0,0,0,0,0,0,0,0,2,0,0,2,1
2698,62027,NcracMTfiaTPMbO6SSDnt9CDc4SnvBs9,bWdj2GDclj5ofokWjzoa5jAwMkxCykd6,24,15,8,32,2,0,8,0,65,9.285714285714286,2,0.0,3,8,32,2,12,0,0,8,0,45,20,0
2699,62042,ml2yAwYHzufxZ6xJCtzUFr2eNYyPECGG,SpATywNh6bZuzm8s1ceuBUnMUAeoAHHw,12,17,4,15,0,0,3,0,39,5.571428571428571,2,0.0,9,4,13,0,8,0,2,3,0,26,13,1
2700,62055,a1efNowRcq2gF4IVdG8KeX19HTVYcbsT,SpATywNh6bZuzm8s1ceuBUnMUAeoAHHw,8,6,3,0,2,0,3,0,14,2.0,1,0.0,0,3,0,2,6,0,0,3,0,5,9,0
2701,62059,9ehdZJgt67O7mOenLhkYXTuYl4yTUru4,SpATywNh6bZuzm8s1ceuBUnMUAeoAHHw,1,0,0,0,0,0,1,0,1,0.14285714285714285,1,0.0,0,0,0,0,0,0,0,1,0,0,1,0
2702,62063,vWtXB9fnfyjB9iyhwPt2xcqr2iv2ZY0B,SpATywNh6bZuzm8s1ceuBUnMUAeoAHHw,1,0,0,0,0,0,1,0,1,0.14285714285714285,1,0.0,0,0,0,0,0,0,0,1,0,0,1,1
2703,62075,gRHI1NeWW3c6BFrZIrJSlWu9NHDjRltm,bWdj2GDclj5ofokWjzoa5jAwMkxCykd6,1,0,0,0,0,0,1,0,1,0.14285714285714285,1,0.0,0,0,0,0,0,0,0,1,0,0,1,1
2704,62088,bLPEpCuYsmeWbTY9JjZOVLY19KeTEHtM,A3fsA9Zfv1X2fVEQhTw51lKENdNrEqT3,6,4,1,2,0,1,2,0,10,1.4285714285714286,1,0.0,0,1,2,0,4,1,0,2,0,3,7,1
2705,62101,uJIh67cllxQLgAhipzdDZMEunDbuBxvF,SpATywNh6bZuzm8s1ceuBUnMUAeoAHHw,6,7,3,0,0,1,3,0,14,2.0,1,0.0,3,3,0,0,4,1,0,3,0,6,8,0
2706,62111,ty20JLEucwjTjC7HbP2Y2gtbJGr1vzD6,SpATywNh6bZuzm8s1ceuBUnMUAeoAHHw,1,0,0,0,0,0,1,0,1,0.14285714285714285,1,0.0,0,0,0,0,0,0,0,1,0,0,1,1
2707,62128,R2cga9JVVM2tXEVs2saYswslfxAU4nMk,A3fsA9Zfv1X2fVEQhTw51lKENdNrEqT3,4,1,1,0,0,0,2,0,4,0.5714285714285714,2,0.0,0,1,0,0,1,0,0,2,0,1,3,1
2708,62129,i045qgxm9LaqFzlH53qyz9yZHDVsE7Hd,bWdj2GDclj5ofokWjzoa5jAwMkxCykd6,9,6,4,0,3,8,4,0,25,3.5714285714285716,1,0.0,0,4,0,3,6,8,0,4,0,7,18,0
2709,62169,9t1Jq485XoOlmuEU542k0g35doAqmykj,SpATywNh6bZuzm8s1ceuBUnMUAeoAHHw,5,3,2,0,0,0,3,0,8,1.1428571428571428,1,0.0,0,2,0,0,3,0,0,3,0,2,6,0
2710,62184,M0jptr5D68D6baUayyF6SculX0moohK0,5X6FeZozNMgE2VRi3MJYjkkFK8SETtu2,1,0,0,0,0,0,1,0,1,0.14285714285714285,1,0.0,0,0,0,0,0,0,0,1,0,0,1,1
2711,62203,PsNVk3Md7dMGBd7LIUOcdD27KZ5BQNaX,SpATywNh6bZuzm8s1ceuBUnMUAeoAHHw,4,2,0,0,0,0,2,0,4,0.5714285714285714,1,0.0,0,0,0,0,2,0,0,2,0,0,4,1
2712,62213,QbN1rcT6X70kGcCCu9qHO2zQXGCyhPMc,SpATywNh6bZuzm8s1ceuBUnMUAeoAHHw,20,18,13,9,8,0,1,0,49,7.0,1,0.0,2,13,9,8,16,0,0,1,0,32,17,1
2713,62237,6uGfB9iS03wfmd1xUXhuaJ677E1IqurA,A3fsA9Zfv1X2fVEQhTw51lKENdNrEqT3,7,4,3,0,2,0,2,0,11,1.5714285714285714,1,0.0,0,3,0,2,4,0,0,2,0,5,6,1
2714,62244,FFy9L7p4obidKBTk4qOOmRiOMU1mIx1C,SpATywNh6bZuzm8s1ceuBUnMUAeoAHHw,1,0,0,0,0,0,1,0,1,0.14285714285714285,1,0.0,0,0,0,0,0,0,0,1,0,0,1,0
2715,62254,X4KSPkBIdPEeXdEy4Fa5NvixCQZdfNj3,SpATywNh6bZuzm8s1ceuBUnMUAeoAHHw,7,5,4,0,0,0,3,0,12,1.7142857142857142,1,0.0,0,4,0,0,5,0,0,3,0,4,8,1
2716,62264,ayXSJHlkjoyFUB4Y9YHZnlOXt35wvwwu,A3fsA9Zfv1X2fVEQhTw51lKENdNrEqT3,23,52,29,0,23,0,11,0,115,16.428571428571427,3,0.0,0,29,0,23,52,0,0,11,0,52,63,1
2717,62267,e0Ue3uuVlmEePOF8zM1ckf1RsP4Zsuxv,bWdj2GDclj5ofokWjzoa5jAwMkxCykd6,6,2,1,0,1,1,3,1,9,1.2857142857142858,1,0.0,0,1,0,1,2,1,0,3,1,2,7,1
2718,62272,k7GcrgNM8NrAzS9cqFwxMdS1Vs120F2Y,A3fsA9Zfv1X2fVEQhTw51lKENdNrEqT3,7,5,1,0,0,0,2,0,8,1.1428571428571428,1,0.0,0,1,0,0,5,0,0,2,0,1,7,0
2719,62284,6PXZHdG3e34wBLMiUtuXkQDClu7qjM54,A3fsA9Zfv1X2fVEQhTw51lKENdNrEqT3,28,39,13,30,11,0,6,0,99,14.142857142857142,1,0.0,0,13,25,11,39,0,5,6,0,49,50,0
2720,62296,6iPl0SuUXO0i0LHkQ72lY7Z3ARsCLoWd,SpATywNh6bZuzm8s1ceuBUnMUAeoAHHw,9,8,2,0,2,0,5,0,17,2.4285714285714284,1,0.0,0,2,0,2,8,0,0,5,0,4,13,1
2721,62297,WmzYkzlMNuHgERGSMthySa2d3K7cWcp2,A3fsA9Zfv1X2fVEQhTw51lKENdNrEqT3,16,15,12,0,11,0,4,0,42,6.0,1,0.0,0,12,0,11,15,0,0,4,0,23,19,1
2722,62312,l4QykzFcC41mVGOdUpTYCbuYnqmkZCXe,SpATywNh6bZuzm8s1ceuBUnMUAeoAHHw,13,18,3,0,3,0,4,0,28,4.0,3,0.0,0,3,0,3,18,0,0,4,0,6,22,0
2723,62328,sw3OXyPqqSkej4mWR3KJTUD97lZa8Tx0,bWdj2GDclj5ofokWjzoa5jAwMkxCykd6,5,6,0,0,0,0,3,0,9,1.2857142857142858,2,0.0,0,0,0,0,6,0,0,3,0,0,9,0
2724,62335,o4bCCaWBA9uHbyXIM2IOJcgIkEya6ZFa,SpATywNh6bZuzm8s1ceuBUnMUAeoAHHw,15,17,6,16,3,0,2,0,44,6.285714285714286,1,0.0,7,6,15,3,10,0,1,2,0,31,13,0
2725,62349,YBtKAFQt6fk6EIukc4Ut5J2kdzYxomaP,SpATywNh6bZuzm8s1ceuBUnMUAeoAHHw,5,6,2,0,0,0,3,0,11,1.5714285714285714,1,0.0,0,2,0,0,6,0,0,3,0,2,9,1
2726,62350,5iW3vlcO8vpNOCUFgKYYNPtpsdBe3kdD,SpATywNh6bZuzm8s1ceuBUnMUAeoAHHw,5,5,1,0,0,0,2,0,8,1.1428571428571428,1,0.0,2,1,0,0,3,0,0,2,0,3,5,1
2727,62356,wjS8ie6ACTxewSCQo7zpBy0tu4z4RYPD,SpATywNh6bZuzm8s1ceuBUnMUAeoAHHw,23,24,1,14,0,0,9,0,48,6.857142857142857,4,0.0,4,1,13,0,20,0,1,9,0,18,30,0
2728,62360,g1maG24WsPdpEOMuZUsxQc7SlEYHJjT4,bWdj2GDclj5ofokWjzoa5jAwMkxCykd6,10,14,7,0,3,0,7,1,32,4.571428571428571,2,0.0,0,7,0,3,14,0,0,7,1,10,22,0
2729,62373,coay6DHChZspTIiqVyUpf7Vdo7lLxepM,A3fsA9Zfv1X2fVEQhTw51lKENdNrEqT3,5,3,2,0,2,0,9,0,16,2.2857142857142856,1,0.0,0,2,0,2,3,0,0,9,0,4,12,1
2730,62381,m2GM5nfba5AfGmEJzump9yjCc3h5OBqL,SpATywNh6bZuzm8s1ceuBUnMUAeoAHHw,7,8,4,0,3,0,1,0,16,2.2857142857142856,1,0.0,0,4,0,3,8,0,0,1,0,7,9,1
2731,62402,yTWMOTSwApx7g1lIaGFcROXS4h3ETTZ1,SpATywNh6bZuzm8s1ceuBUnMUAeoAHHw,6,3,1,0,1,0,2,0,7,1.0,1,0.0,0,1,0,1,3,0,0,2,0,2,5,1
2732,62418,xv4Co45Jkfnr7XgY6wKaXH06aRG1xbQV,5X6FeZozNMgE2VRi3MJYjkkFK8SETtu2,11,8,6,2,4,0,3,0,23,3.2857142857142856,3,0.0,0,6,2,4,8,0,0,3,0,12,11,0
2733,62425,2AUmJLK3ogn8OSTOrZM181baCczbYXkL,SpATywNh6bZuzm8s1ceuBUnMUAeoAHHw,1,0,0,0,0,0,1,0,1,0.14285714285714285,1,0.0,0,0,0,0,0,0,0,1,0,0,1,1
2734,62428,Y5CSlxjOPHMFV7ik3pSpx6t0PJdYKnrH,SpATywNh6bZuzm8s1ceuBUnMUAeoAHHw,32,34,22,13,15,0,8,0,92,13.142857142857142,3,0.0,5,22,10,15,29,0,3,8,0,52,40,0
2735,62437,vhnbHBui7nCh3pAshTJ2BoFD1CEurx5q,SpATywNh6bZuzm8s1ceuBUnMUAeoAHHw,8,7,1,0,1,0,3,0,12,1.7142857142857142,1,0.0,0,1,0,1,7,0,0,3,0,2,10,0
2736,62443,ogzXep3azQvjQ2uIPIxw4TZLNiUXYlgD,A3fsA9Zfv1X2fVEQhTw51lKENdNrEqT3,6,13,9,0,0,0,2,0,24,3.4285714285714284,1,0.0,2,9,0,0,11,0,0,2,0,11,13,0
2737,62457,k3z8wjqNUcBUtJc11ZY5CI3syE6W1pg9,SpATywNh6bZuzm8s1ceuBUnMUAeoAHHw,6,4,3,0,1,0,2,0,10,1.4285714285714286,1,0.0,0,3,0,1,4,0,0,2,0,4,6,0
2738,62458,j8vYdYwa9gvt7hkF8dykZR2D4h75QsII,SpATywNh6bZuzm8s1ceuBUnMUAeoAHHw,32,28,16,23,9,3,4,0,83,11.857142857142858,3,0.0,8,16,18,9,20,3,5,4,0,51,32,1
2739,62467,n8L9wTZCh5rXNBzkkTit4t034Y491eKa,SpATywNh6bZuzm8s1ceuBUnMUAeoAHHw,25,48,2,31,2,0,7,1,91,13.0,1,0.0,11,2,29,2,37,0,2,7,1,44,47,0
2740,62473,f6KqnppFPlkp6t9yk3tSYaItqJ9vCGLv,SpATywNh6bZuzm8s1ceuBUnMUAeoAHHw,17,8,6,0,6,0,7,1,28,4.0,2,0.0,0,6,0,6,8,0,0,7,1,12,16,1
2741,62485,sEiuytxgvtmcXA3wvuyEX6jl9ipM75JD,A3fsA9Zfv1X2fVEQhTw51lKENdNrEqT3,38,20,15,46,14,0,1,0,96,13.714285714285714,1,0.0,0,15,39,14,20,0,7,1,0,68,28,0
2742,62490,GWSq56qmQUucFgSgP2raEZeoKP7Athee,SpATywNh6bZuzm8s1ceuBUnMUAeoAHHw,22,27,2,19,2,6,7,0,63,9.0,3,0.0,4,2,18,2,23,6,1,7,0,26,37,0
2743,62495,cviEHKkObdnrsdhgu782x2qKQLthxxXP,SpATywNh6bZuzm8s1ceuBUnMUAeoAHHw,1,0,0,0,0,0,1,0,1,0.14285714285714285,1,0.0,0,0,0,0,0,0,0,1,0,0,1,1
2744,62496,sXsuKZQK6v2jgcNJf2x8mPlA2ABOffAD,bWdj2GDclj5ofokWjzoa5jAwMkxCykd6,3,2,0,0,0,0,1,0,3,0.42857142857142855,1,0.0,0,0,0,0,2,0,0,1,0,0,3,1
2745,62514,ggEr2STKTwtSSUdtGCmiPr3DBu3TJ34B,A3fsA9Zfv1X2fVEQhTw51lKENdNrEqT3,4,3,0,0,0,0,1,0,4,0.5714285714285714,1,0.0,0,0,0,0,3,0,0,1,0,0,4,1
2746,62530,l7f4vHvlZkxCYoU9qM63V45bmndBSeZQ,SpATywNh6bZuzm8s1ceuBUnMUAeoAHHw,12,12,2,26,0,0,2,0,42,6.0,2,0.0,5,2,24,0,7,0,2,2,0,31,11,0
2747,62557,7FBwqoodmzhvrGGLuwBjRrxsykocUv8u,bWdj2GDclj5ofokWjzoa5jAwMkxCykd6,6,4,2,0,1,0,2,0,9,1.2857142857142858,1,0.0,1,2,0,1,3,0,0,2,0,4,5,1
2748,62563,PrE64zhEuNh83grWL2cXaZZPY2nI1xUf,bWdj2GDclj5ofokWjzoa5jAwMkxCykd6,1,0,0,0,0,0,1,0,1,0.14285714285714285,1,0.0,0,0,0,0,0,0,0,1,0,0,1,1
2749,62565,oxtnm7X5FHQqXVLLooUhCWZ3R8fCCDoE,SpATywNh6bZuzm8s1ceuBUnMUAeoAHHw,7,3,2,0,2,0,2,0,9,1.2857142857142858,1,0.0,0,2,0,2,3,0,0,2,0,4,5,0
2750,62566,CO3sprBt7zms4eyX8oyF4N8qFejqwRFV,5X6FeZozNMgE2VRi3MJYjkkFK8SETtu2,93,128,47,21,80,0,9,0,285,40.714285714285715,6,0.0,69,47,19,80,59,0,2,9,0,215,70,1
2751,62576,ogmMRCX7tMP9zl6WROraIuGWloPIZQ3P,SpATywNh6bZuzm8s1ceuBUnMUAeoAHHw,34,34,22,17,15,9,3,0,100,14.285714285714286,3,0.0,7,22,15,15,27,9,2,3,0,59,41,1
2752,62589,EdUaZuk8ESEyWYRZCWJ8ZQBbz43WEgwY,A3fsA9Zfv1X2fVEQhTw51lKENdNrEqT3,7,3,2,0,2,0,2,0,9,1.2857142857142858,1,0.0,0,2,0,2,3,0,0,2,0,4,5,1
2753,62593,fBjkk55LEjUXpgvkPNjyZGCtR2am4TcN,SpATywNh6bZuzm8s1ceuBUnMUAeoAHHw,30,25,18,9,10,0,6,0,68,9.714285714285714,3,0.0,2,18,9,10,23,0,0,6,0,39,29,0
2754,62620,lmeMhWa8hXVoeC6vmJbPTxkNCUltvvzl,5X6FeZozNMgE2VRi3MJYjkkFK8SETtu2,5,2,1,0,1,0,5,0,9,1.2857142857142858,2,0.0,0,1,0,1,2,0,0,5,0,2,7,1
2755,62641,CiIoUCLeseImRUfekH5MRA89dX7Bqx1s,SpATywNh6bZuzm8s1ceuBUnMUAeoAHHw,9,12,1,0,0,0,7,1,21,3.0,1,0.0,0,1,0,0,12,0,0,7,1,1,20,0
2756,62642,uoDWDjctsplt3HhO40cJ31SItxonwlgR,SpATywNh6bZuzm8s1ceuBUnMUAeoAHHw,6,4,3,0,1,0,1,0,9,1.2857142857142858,1,0.0,0,3,0,1,4,0,0,1,0,4,5,1
2757,62648,tUrqZSUN7RW61T1PpyF2X9YW8Ok3vUek,A3fsA9Zfv1X2fVEQhTw51lKENdNrEqT3,5,3,2,0,1,0,1,0,7,1.0,1,0.0,0,2,0,1,3,0,0,1,0,3,4,1
2758,62652,KfoZ69zTNu1FkbuybYuVyLqWQTXsDAu5,A3fsA9Zfv1X2fVEQhTw51lKENdNrEqT3,6,3,2,0,2,0,1,0,8,1.1428571428571428,1,0.0,0,2,0,2,3,0,0,1,0,4,4,1
2759,62655,8qABUnBBHxxZkfUhEQNUn5NNMSRrqvPC,SpATywNh6bZuzm8s1ceuBUnMUAeoAHHw,14,15,8,12,0,0,3,0,38,5.428571428571429,3,0.0,2,8,11,0,13,0,1,3,0,21,17,1
2760,62664,6rvhZ1qSfYtmyLXdh13xI1z8Ly1xy1X7,A3fsA9Zfv1X2fVEQhTw51lKENdNrEqT3,11,7,5,0,3,0,3,1,19,2.7142857142857144,1,0.0,0,5,0,3,7,0,0,3,1,8,11,1
2761,62691,vLDUFKClgtT31VAwcYV5sIfp3TdS79BU,A3fsA9Zfv1X2fVEQhTw51lKENdNrEqT3,25,32,4,52,2,0,10,0,100,14.285714285714286,3,0.0,0,4,45,2,32,0,7,10,0,51,49,1
2762,62695,N0Sos51WanCzoSGKDmMPzQtMlLxY3bFb,A3fsA9Zfv1X2fVEQhTw51lKENdNrEqT3,94,70,47,138,28,3,38,0,324,46.285714285714285,6,0.0,5,47,122,28,65,3,16,38,0,202,122,0
2763,62704,HwmOe48TnHpxGJFpJY55xag3SIXvxDtW,SpATywNh6bZuzm8s1ceuBUnMUAeoAHHw,3,0,0,0,0,0,3,0,3,0.42857142857142855,1,0.0,0,0,0,0,0,0,0,3,0,0,3,1
2764,62716,Q21gO7wmi4OQk1e1YfdnwYevUUmHUJft,5X6FeZozNMgE2VRi3MJYjkkFK8SETtu2,5,5,3,0,3,0,3,0,14,2.0,2,0.0,0,3,0,3,5,0,0,3,0,6,8,1
2765,62728,Ve2CzncgteRmVYAwotsiyIfRd71Uy29E,SpATywNh6bZuzm8s1ceuBUnMUAeoAHHw,7,5,0,2,0,2,2,0,11,1.5714285714285714,1,0.0,3,0,2,0,2,2,0,2,0,5,6,1
2766,62741,SMph1YQCIZlmphiUl0TLsRAe6lO4LFpT,bWdj2GDclj5ofokWjzoa5jAwMkxCykd6,6,2,1,0,1,0,4,0,8,1.1428571428571428,1,0.0,0,1,0,1,2,0,0,4,0,2,6,0
2767,62753,TRu3o7re8Hct8XLR9vEEV1PqQQjCMyIk,SpATywNh6bZuzm8s1ceuBUnMUAeoAHHw,13,38,4,0,1,0,24,0,67,9.571428571428571,2,0.0,1,4,0,1,37,0,0,24,0,6,61,0
2768,62780,7lWGgkVC73zkYVnYZAzOXyCIO3N3M6br,SpATywNh6bZuzm8s1ceuBUnMUAeoAHHw,24,27,11,9,7,0,3,0,57,8.142857142857142,3,0.0,2,11,8,7,25,0,1,3,0,28,29,0
2769,62788,N24rIsVu8N2zgaIu1cFWHYg7IEXvRm7B,SpATywNh6bZuzm8s1ceuBUnMUAeoAHHw,21,19,3,52,0,7,7,0,88,12.571428571428571,1,0.0,7,3,52,0,12,7,0,7,0,62,26,0
2770,62797,1OhYjs584O7cQTJvOonaydB6tDuRCwGL,SpATywNh6bZuzm8s1ceuBUnMUAeoAHHw,1,0,0,0,0,0,1,0,1,0.14285714285714285,1,0.0,0,0,0,0,0,0,0,1,0,0,1,1
2771,62810,jkLf5s9Tdb22fUhtxgRjd7TDlKmc2OGK,A3fsA9Zfv1X2fVEQhTw51lKENdNrEqT3,9,5,4,0,3,0,1,0,13,1.8571428571428572,1,0.0,0,4,0,3,5,0,0,1,0,7,6,1
2772,62834,TfNQptQajWTQqzlzDAn72SRQxELYzNd4,SpATywNh6bZuzm8s1ceuBUnMUAeoAHHw,1,0,0,0,0,0,2,0,2,0.2857142857142857,2,0.0,0,0,0,0,0,0,0,2,0,0,2,0
2773,62835,Wx4OW1b1MfVESAexiltid2V2dN7xsH1D,SpATywNh6bZuzm8s1ceuBUnMUAeoAHHw,13,36,2,0,1,0,4,0,43,6.142857142857143,5,0.0,0,2,0,1,36,0,0,4,0,3,40,0
2774,62899,o3ye5hXMUgVndWGmjUO0YDQyBTnAFl5e,SpATywNh6bZuzm8s1ceuBUnMUAeoAHHw,1,0,0,0,0,0,1,0,1,0.14285714285714285,1,0.0,0,0,0,0,0,0,0,1,0,0,1,1
2775,62936,l6huwkyakLvA9G4ixwxpAcJxBdbbcmJP,SpATywNh6bZuzm8s1ceuBUnMUAeoAHHw,34,36,20,29,14,0,6,0,105,15.0,2,0.0,6,20,25,14,30,0,4,6,0,65,40,0
2776,62938,eLqag6twmL6nT6SLVrpY07QGG3bytKwe,SpATywNh6bZuzm8s1ceuBUnMUAeoAHHw,3,4,1,0,0,0,2,0,7,1.0,2,0.0,0,1,0,0,4,0,0,2,0,1,6,0
2777,62955,fHcFG25wfoThOxprF90lZQv51IcnKwVi,A3fsA9Zfv1X2fVEQhTw51lKENdNrEqT3,1,0,0,0,0,0,1,0,1,0.14285714285714285,1,0.0,0,0,0,0,0,0,0,1,0,0,1,1
2778,62985,SDq3f6KWdckVLJCSJxIwedwz5gfJhoTJ,SpATywNh6bZuzm8s1ceuBUnMUAeoAHHw,3,2,1,0,0,0,1,0,4,0.5714285714285714,1,0.0,0,1,0,0,2,0,0,1,0,1,3,1
2779,62987,rPCeZQYVVNgo8SwvznMXuxYDPy2tLzTl,bWdj2GDclj5ofokWjzoa5jAwMkxCykd6,8,4,1,6,1,0,2,0,14,2.0,1,0.0,1,1,5,1,3,0,1,2,0,8,6,0
2780,62990,6TtfboxYzA2v82ZY0ZrDHWT36KPZi8LG,A3fsA9Zfv1X2fVEQhTw51lKENdNrEqT3,6,3,1,0,1,0,2,0,7,1.0,1,0.0,0,1,0,1,3,0,0,2,0,2,5,1
2781,63008,MjjHVlUuOHpErRpbxsSv5C4Ujl4db690,bWdj2GDclj5ofokWjzoa5jAwMkxCykd6,1,0,0,0,0,0,1,0,1,0.14285714285714285,1,0.0,0,0,0,0,0,0,0,1,0,0,1,1
2782,63017,CJUKQmzJ66PH4IqEGPhfRE6a1iKmCA2J,SpATywNh6bZuzm8s1ceuBUnMUAeoAHHw,5,5,2,0,1,0,3,0,11,1.5714285714285714,1,0.0,0,2,0,1,5,0,0,3,0,3,8,0
2783,63019,W2ohBuN5JfRDGloM0s99vkGQJHKKrtyK,SpATywNh6bZuzm8s1ceuBUnMUAeoAHHw,4,2,0,0,0,0,2,0,4,0.5714285714285714,1,0.0,0,0,0,0,2,0,0,2,0,0,4,0
2784,63021,h6BCw3lF3hfMo5lMia90jbFn8R4SWDoH,bWdj2GDclj5ofokWjzoa5jAwMkxCykd6,5,2,1,0,1,0,2,0,6,0.8571428571428571,1,0.0,0,1,0,1,2,0,0,2,0,2,4,1
2785,63025,JSINmVzUIC6vntWsWg4ycbpyoaRbhs6q,SpATywNh6bZuzm8s1ceuBUnMUAeoAHHw,4,6,0,0,0,0,1,0,7,1.0,1,0.0,0,0,0,0,6,0,0,1,0,0,7,1
2786,63047,LWWGMAVHUf3PF6BlKef9Rc6itscQOf6h,A3fsA9Zfv1X2fVEQhTw51lKENdNrEqT3,8,9,2,0,2,0,5,0,18,2.5714285714285716,1,0.0,1,2,0,2,8,0,0,5,0,5,13,0
2787,63072,TvDWPoJyTprTu0vxto5NxLIJOfQBmxVE,7GRhBDsirIGkRZBtSMEzNTyDr2JQm4xx,21,26,12,6,9,1,10,0,64,9.142857142857142,3,0.0,7,12,3,9,19,1,3,10,0,31,33,0
2788,63082,IkcvB8sOwGvLINRAnWtwQaMkImc3j5J1,SpATywNh6bZuzm8s1ceuBUnMUAeoAHHw,11,8,7,0,7,0,3,0,25,3.5714285714285716,1,0.0,0,7,0,7,8,0,0,3,0,14,11,1
2789,63087,5SW8vE01d3BlXE9ngOPkuvhZYzh2PoXk,SpATywNh6bZuzm8s1ceuBUnMUAeoAHHw,1,0,0,0,0,0,1,0,1,0.14285714285714285,1,0.0,0,0,0,0,0,0,0,1,0,0,1,1
2790,63100,WYoMb9pjSPIkNMKnbh6vDtB0LRCn2aRR,A3fsA9Zfv1X2fVEQhTw51lKENdNrEqT3,6,5,3,0,1,0,3,0,12,1.7142857142857142,1,0.0,0,3,0,1,5,0,0,3,0,4,8,1
2791,63103,Hxi6d4DzV7K1jcnZIhXlJzpIYDP4sYeZ,SpATywNh6bZuzm8s1ceuBUnMUAeoAHHw,6,0,0,0,0,6,6,1,13,1.8571428571428572,1,0.0,0,0,0,0,0,6,0,6,1,0,13,0
2792,63124,8nlNDsWSaxHCvsMKtqhBs81sknEiTCeb,A3fsA9Zfv1X2fVEQhTw51lKENdNrEqT3,67,42,34,4,31,0,2,0,113,16.142857142857142,2,0.0,0,34,3,31,42,0,1,2,0,68,45,0
2793,63129,8nlNDsWSaxHCvsMKtqhBs81sknEiTCeb,5X6FeZozNMgE2VRi3MJYjkkFK8SETtu2,56,83,28,0,63,0,8,0,182,26.0,7,0.0,49,28,0,63,34,0,0,8,0,140,42,0
2794,63142,3GR5S0zuvKrN9Rve6lwut3ksRMKirOvu,SpATywNh6bZuzm8s1ceuBUnMUAeoAHHw,1,0,0,0,0,0,1,0,1,0.14285714285714285,1,0.0,0,0,0,0,0,0,0,1,0,0,1,0
2795,63187,CTfjOlWW4k8IhTEXOJYJ7bo74K8z07kZ,A3fsA9Zfv1X2fVEQhTw51lKENdNrEqT3,1,0,0,0,0,0,1,0,1,0.14285714285714285,1,0.0,0,0,0,0,0,0,0,1,0,0,1,0
2796,63227,B2dhxt3kePkYjJgrT7zCaVH7s7VuJwMd,A3fsA9Zfv1X2fVEQhTw51lKENdNrEqT3,8,4,3,0,3,0,1,0,11,1.5714285714285714,1,0.0,0,3,0,3,4,0,0,1,0,6,5,1
2797,63266,97ov4fTuLcUGM3NRcbowYBsVQSUEYP2S,A3fsA9Zfv1X2fVEQhTw51lKENdNrEqT3,2,0,0,0,0,0,2,0,2,0.2857142857142857,1,0.0,0,0,0,0,0,0,0,2,0,0,2,1
2798,63271,DHenWrxVzReZszxo1qw3Im0Zj99tiAII,A3fsA9Zfv1X2fVEQhTw51lKENdNrEqT3,25,13,3,82,1,0,3,0,102,14.571428571428571,1,0.0,7,3,69,1,6,0,13,3,0,80,22,0
2799,63301,NOKImnD6AK3k9IbTXegWVhq8o6CU7Nqb,5X6FeZozNMgE2VRi3MJYjkkFK8SETtu2,5,2,1,0,1,0,2,0,6,0.8571428571428571,1,0.0,0,1,0,1,2,0,0,2,0,2,4,1
2800,63313,EY7vkfJ7gquIHvxtRnRiXcTTf5pHgdjX,A3fsA9Zfv1X2fVEQhTw51lKENdNrEqT3,13,21,2,0,2,0,3,0,28,4.0,2,0.0,0,2,0,2,21,0,0,3,0,4,24,1
2801,63322,Q7wqVDqz10tk4xe6QnkzI1dJqMLzdK4Z,7GRhBDsirIGkRZBtSMEzNTyDr2JQm4xx,17,24,10,4,9,0,4,0,51,7.285714285714286,2,0.0,12,10,2,9,12,0,2,4,0,33,18,0
2802,63383,KDzfaWgTSBqeMJLFLmFuh4CMLsva9aWu,A3fsA9Zfv1X2fVEQhTw51lKENdNrEqT3,67,26,1,144,1,0,9,1,182,26.0,2,0.0,3,1,129,1,23,0,15,9,1,134,48,0
2803,63422,6vO1t7bAvkyNzwmqVxy2KURwXULJdtv2,A3fsA9Zfv1X2fVEQhTw51lKENdNrEqT3,12,5,1,28,0,0,1,0,35,5.0,1,0.0,0,1,24,0,5,0,4,1,0,25,10,1
2804,63461,4TtGjmtd4ISORDD5okRgx7kXAcGUW8IN,7GRhBDsirIGkRZBtSMEzNTyDr2JQm4xx,57,82,33,64,33,27,29,1,269,38.42857142857143,7,0.0,47,33,51,33,35,27,13,29,1,164,105,0
2805,63488,VYo3NyZyhfOpyU6dELs63jcxK1pOYgip,A3fsA9Zfv1X2fVEQhTw51lKENdNrEqT3,5,1,1,0,0,0,7,0,9,1.2857142857142858,1,0.0,0,1,0,0,1,0,0,7,0,1,8,0
2806,63576,7MQqMUzAoBFEcqTatVu5Epa9H5xTJ6XT,A3fsA9Zfv1X2fVEQhTw51lKENdNrEqT3,106,51,43,218,34,0,13,0,359,51.285714285714285,3,0.0,3,43,179,34,48,0,39,13,0,259,100,0
2807,63596,koNIIdoqi1yUhLIZAXp5I3Fl17qrPzNm,A3fsA9Zfv1X2fVEQhTw51lKENdNrEqT3,8,7,0,0,0,0,3,0,10,1.4285714285714286,1,0.0,0,0,0,0,7,0,0,3,0,0,10,1
2808,63605,Oq6ytGesBgZJoERFNPZjhX7GxTg6Xu0N,A3fsA9Zfv1X2fVEQhTw51lKENdNrEqT3,16,21,3,0,5,0,3,0,32,4.571428571428571,1,0.0,0,3,0,5,21,0,0,3,0,8,24,0
2809,63607,Z4Qw4SArt1e9s7GCjrn46q6LGr0U6QAS,A3fsA9Zfv1X2fVEQhTw51lKENdNrEqT3,1,0,0,0,0,0,1,0,1,0.14285714285714285,1,0.0,0,0,0,0,0,0,0,1,0,0,1,1
2810,63610,E8bimkwa2NguL8hrnTueXaCb8pmMf9l4,A3fsA9Zfv1X2fVEQhTw51lKENdNrEqT3,1,0,0,0,0,0,1,0,1,0.14285714285714285,1,0.0,0,0,0,0,0,0,0,1,0,0,1,1
2811,63620,it01smNZGBSxfN1xuqQJBeHc2ONqrDBW,A3fsA9Zfv1X2fVEQhTw51lKENdNrEqT3,14,12,2,0,2,1,8,1,26,3.7142857142857144,3,0.0,1,2,0,2,11,1,0,8,1,5,21,1
2812,63687,dtbXtMjPqeEvzoZBFe2y9uSDcjL0lnx2,A3fsA9Zfv1X2fVEQhTw51lKENdNrEqT3,34,32,12,0,8,0,7,0,59,8.428571428571429,3,0.0,0,12,0,8,32,0,0,7,0,20,39,0
2813,63689,CgV8h6fVQX3XsDvfyJSvNIv0BWBLNKWC,A3fsA9Zfv1X2fVEQhTw51lKENdNrEqT3,1,0,0,0,0,0,1,0,1,0.14285714285714285,1,0.0,0,0,0,0,0,0,0,1,0,0,1,1
2814,63703,GulRMWFcPY5JE8HNbJPRyRdVqJqL2eEA,A3fsA9Zfv1X2fVEQhTw51lKENdNrEqT3,8,7,1,0,1,0,6,0,15,2.142857142857143,1,0.0,0,1,0,1,7,0,0,6,0,2,13,0
2815,63843,a6scXvKGCEGtZzcyo2e8X5h7SntETXd0,A3fsA9Zfv1X2fVEQhTw51lKENdNrEqT3,43,43,19,42,17,1,6,1,129,18.428571428571427,1,0.0,1,19,41,17,42,1,1,6,1,78,51,0
2816,63903,4RiemE5r88jWq9gaL0lVYzjeUhWq3sNP,A3fsA9Zfv1X2fVEQhTw51lKENdNrEqT3,1,0,0,0,0,0,1,0,1,0.14285714285714285,1,0.0,0,0,0,0,0,0,0,1,0,0,1,1
2817,63909,k57D5r1HBQsYTFYwjCvC4VLOFbsyC3KY,5X6FeZozNMgE2VRi3MJYjkkFK8SETtu2,3,2,1,0,0,0,1,0,4,0.5714285714285714,1,0.0,0,1,0,0,2,0,0,1,0,1,3,1
2818,63921,JgSF96URyx4xETuoqSIyFv46Qndmj1Nf,5X6FeZozNMgE2VRi3MJYjkkFK8SETtu2,6,7,2,0,1,0,5,0,15,2.142857142857143,3,0.0,0,2,0,1,7,0,0,5,0,3,12,1
2819,64022,GSVK27iuI3PAZqwurTaJZ7s4wwjamYAo,A3fsA9Zfv1X2fVEQhTw51lKENdNrEqT3,5,2,1,0,1,0,2,0,6,0.8571428571428571,1,0.0,0,1,0,1,2,0,0,2,0,2,4,1
2820,64077,mXlrU28Kv8cfLAxq0MxNoannB4pjWEly,5X6FeZozNMgE2VRi3MJYjkkFK8SETtu2,10,10,5,3,5,0,2,0,25,3.5714285714285716,1,0.0,4,5,3,5,6,0,0,2,0,17,8,1
2821,64081,lHeM4AOiziJNI87uU55rrS382KB11VeQ,5X6FeZozNMgE2VRi3MJYjkkFK8SETtu2,1,0,0,0,0,0,1,0,1,0.14285714285714285,1,0.0,0,0,0,0,0,0,0,1,0,0,1,1
2822,64107,D0c1Dv0mb5pX9YfP3iB7fNf1CKquBRcj,A3fsA9Zfv1X2fVEQhTw51lKENdNrEqT3,2,0,0,0,0,0,2,0,2,0.2857142857142857,1,0.0,0,0,0,0,0,0,0,2,0,0,2,1
2823,64121,o45RIQZX8Ed2OnEzyGdVHATs1znjDfJY,A3fsA9Zfv1X2fVEQhTw51lKENdNrEqT3,5,2,0,0,0,1,4,0,7,1.0,2,0.0,0,0,0,0,2,1,0,4,0,0,7,1
2824,64151,3ioSZYAXMViIN47K3FwYb4YRv6Ucf2yK,A3fsA9Zfv1X2fVEQhTw51lKENdNrEqT3,1,0,0,0,0,0,1,0,1,0.14285714285714285,1,0.0,0,0,0,0,0,0,0,1,0,0,1,1
2825,64155,g1jy8yGB1FqGK09piS6JHmRh3fD1ZENx,A3fsA9Zfv1X2fVEQhTw51lKENdNrEqT3,1,0,0,0,0,0,1,0,1,0.14285714285714285,1,0.0,0,0,0,0,0,0,0,1,0,0,1,1
2826,64180,i2J6aqN1hjSmK6hlxQNLieqUjCtUZ1CB,5X6FeZozNMgE2VRi3MJYjkkFK8SETtu2,5,2,1,0,1,0,2,0,6,0.8571428571428571,1,0.0,0,1,0,1,2,0,0,2,0,2,4,1
2827,64207,KXpPNhmbAuFPVQDoTiad8XvdETYdDx1U,3VkHkmOtom3jM2wCu94xgzzu1d6Dn7or,21,30,18,8,12,1,4,1,74,10.571428571428571,3,0.0,6,18,7,12,24,1,1,4,1,43,31,0
2828,64313,gA3Xtx3mNrjoOeU8dGKyOoRAXgsBF1H9,3VkHkmOtom3jM2wCu94xgzzu1d6Dn7or,1,0,0,0,0,0,1,0,1,0.14285714285714285,1,0.0,0,0,0,0,0,0,0,1,0,0,1,1
2829,64318,abr7PsiExob7MGbkn4ZddaHwWS9BsVqH,3VkHkmOtom3jM2wCu94xgzzu1d6Dn7or,7,9,1,0,3,0,16,0,29,4.142857142857143,3,0.0,6,1,0,3,3,0,0,16,0,10,19,1
2830,64329,LSVa2jpU1dF8RnC5rzovm0tv2cSNIe8I,3VkHkmOtom3jM2wCu94xgzzu1d6Dn7or,39,57,22,20,18,6,12,0,135,19.285714285714285,5,0.0,14,22,19,18,43,6,1,12,0,73,62,0
2831,64335,g9lPvOzsSzINNTOU3e0WeqFWLYzy22Mt,3VkHkmOtom3jM2wCu94xgzzu1d6Dn7or,4,13,6,0,0,0,4,0,23,3.2857142857142856,5,0.0,0,6,0,0,13,0,0,4,0,6,17,1
2832,64352,wGNx6AKYlNdlUcU0SMOdNBG7bFkc1XEp,3VkHkmOtom3jM2wCu94xgzzu1d6Dn7or,97,237,120,60,104,17,33,4,575,82.14285714285714,12,0.0,95,120,55,104,142,17,5,33,4,374,201,0
2833,64370,c5xiLcSWAYPvXfuhPurcqOprSOGccHJS,3VkHkmOtom3jM2wCu94xgzzu1d6Dn7or,3,2,1,0,0,0,1,0,4,0.5714285714285714,1,0.0,0,1,0,0,2,0,0,1,0,1,3,1
2834,64373,3ppgfLiwMAHRPirVicx5QjeMUZaKkLmg,3VkHkmOtom3jM2wCu94xgzzu1d6Dn7or,2,0,0,0,0,0,6,0,6,0.8571428571428571,1,0.0,0,0,0,0,0,0,0,6,0,0,6,1
2835,64388,5o6riWtpxdBNBYGW08EacpQpAKp3IxEg,3VkHkmOtom3jM2wCu94xgzzu1d6Dn7or,1,0,0,0,0,0,1,0,1,0.14285714285714285,1,0.0,0,0,0,0,0,0,0,1,0,0,1,1
2836,64429,mmgvXxQPxWioLfZY5VD0SZnXZDUD442V,3VkHkmOtom3jM2wCu94xgzzu1d6Dn7or,3,0,0,0,0,1,3,0,4,0.5714285714285714,1,0.0,0,0,0,0,0,1,0,3,0,0,4,1
2837,64462,ZDVmuYiPoGm0gu1bR2BaE1soF6dU5v1W,3VkHkmOtom3jM2wCu94xgzzu1d6Dn7or,1,0,0,0,0,0,1,0,1,0.14285714285714285,1,0.0,0,0,0,0,0,0,0,1,0,0,1,1
2838,64463,BqrlUNDkAkHNnXp0FPZ73CSR3ngoq4bK,3VkHkmOtom3jM2wCu94xgzzu1d6Dn7or,5,7,4,0,3,0,1,0,15,2.142857142857143,1,0.0,1,4,0,3,6,0,0,1,0,8,7,1
2839,64470,omogDjehriHed7WOB06lowOCzWJT5HFG,3VkHkmOtom3jM2wCu94xgzzu1d6Dn7or,68,133,68,44,55,5,16,0,321,45.857142857142854,5,0.0,54,68,33,55,79,5,11,16,0,210,111,0
2840,64515,gbH0MMJ5rSAuwZ5qtlTmwRCxGiZQV4Al,3VkHkmOtom3jM2wCu94xgzzu1d6Dn7or,26,47,28,16,21,16,7,0,135,19.285714285714285,6,0.0,13,28,14,21,34,16,2,7,0,76,59,1
2841,64526,vhKK0CTAExtKMqOJm8URni5QBMk7gE0I,3VkHkmOtom3jM2wCu94xgzzu1d6Dn7or,1,0,0,0,0,0,1,0,1,0.14285714285714285,1,0.0,0,0,0,0,0,0,0,1,0,0,1,1
2842,64576,heDdYQu76fXvzO7TstIKbUaE92RZRujB,3VkHkmOtom3jM2wCu94xgzzu1d6Dn7or,3,7,1,0,0,0,1,0,9,1.2857142857142858,1,0.0,3,1,0,0,4,0,0,1,0,4,5,1
2843,64606,gRdV8TKfYOuiXGGwKnVS8SiUiAxajq1L,3VkHkmOtom3jM2wCu94xgzzu1d6Dn7or,8,5,3,0,2,0,5,0,15,2.142857142857143,2,0.0,0,3,0,2,5,0,0,5,0,5,10,1
2844,64631,w5zixBvtWXGohLO8Tn359nHeHgY2Uldn,3VkHkmOtom3jM2wCu94xgzzu1d6Dn7or,1,0,0,0,0,0,1,0,1,0.14285714285714285,1,0.0,0,0,0,0,0,0,0,1,0,0,1,1
2845,64672,8A7IRDfvatDnOXvyKv9N9weTLfOEiofD,3VkHkmOtom3jM2wCu94xgzzu1d6Dn7or,1,0,0,0,0,0,1,0,1,0.14285714285714285,1,0.0,0,0,0,0,0,0,0,1,0,0,1,1
2846,64701,frevGWOFyf2Wo6uQjpFNvZnyWeFbKP0E,3VkHkmOtom3jM2wCu94xgzzu1d6Dn7or,60,46,21,67,20,1,16,0,171,24.428571428571427,3,0.0,20,21,52,20,26,1,15,16,0,113,58,0
2847,64726,aORi8ctsRQPynx7huvSDB7SBijD2EamN,3VkHkmOtom3jM2wCu94xgzzu1d6Dn7or,1,0,0,0,0,0,1,0,1,0.14285714285714285,1,0.0,0,0,0,0,0,0,0,1,0,0,1,1
2848,64773,r0dFqjGI7dV5UI6Lt9zOJKOw8pPh1H9m,3VkHkmOtom3jM2wCu94xgzzu1d6Dn7or,66,257,99,30,77,18,54,16,551,78.71428571428571,8,0.0,92,99,26,77,165,18,4,54,16,294,257,0
2849,64780,w55bKoINycyJ2ymux6x0NB1MmB6QG3Dm,3VkHkmOtom3jM2wCu94xgzzu1d6Dn7or,20,28,15,18,9,5,10,2,87,12.428571428571429,3,0.0,7,15,17,9,21,5,1,10,2,48,39,1
2850,64820,LqxH2deSYujtWmr5bbm2moMw49DPD3vh,3VkHkmOtom3jM2wCu94xgzzu1d6Dn7or,1,0,0,0,0,0,1,0,1,0.14285714285714285,1,0.0,0,0,0,0,0,0,0,1,0,0,1,1
2851,65659,BGZaaH5HDVuGvqaegp5MyJblPEuJpcXP,5X6FeZozNMgE2VRi3MJYjkkFK8SETtu2,15,42,11,28,6,10,6,2,105,15.0,2,0.0,17,11,22,6,25,10,6,6,2,56,49,0
2852,65795,XmvpcofboBRS9uAJYfRa3wpjPdvquqfs,5X6FeZozNMgE2VRi3MJYjkkFK8SETtu2,6,2,0,0,0,0,11,0,13,1.8571428571428572,2,0.0,0,0,0,0,2,0,0,11,0,0,13,1
2853,65839,OdMr7dE5UlAme9Tp979vREBvY5CV50po,5X6FeZozNMgE2VRi3MJYjkkFK8SETtu2,27,40,15,20,17,0,6,0,98,14.0,3,0.0,20,15,20,17,20,0,0,6,0,72,26,0
2854,65885,pcZtZEZYp6uimFg9bhkzSKY573TnBG4p,5X6FeZozNMgE2VRi3MJYjkkFK8SETtu2,11,23,3,17,0,0,3,0,46,6.571428571428571,1,0.0,19,3,15,0,4,0,2,3,0,37,9,1
2855,66553,X1KDcg6FJGcjALhOEz460JY2SzJ27Ewm,RXDvfPUBYFlVdlueBFbLW0mhhAyGEqpt,10,8,5,4,2,0,5,0,24,3.4285714285714284,1,0.0,2,5,3,2,6,0,1,5,0,12,12,1
2856,66574,PizUKf6mRUas66X3VMYXf9aygnN1CUCf,RXDvfPUBYFlVdlueBFbLW0mhhAyGEqpt,16,17,12,0,7,0,2,0,38,5.428571428571429,1,0.0,4,12,0,7,13,0,0,2,0,23,15,1
2857,66584,ZRcEnEYSSBQbkjzMu7sidjbxasfrmw8l,RXDvfPUBYFlVdlueBFbLW0mhhAyGEqpt,6,8,6,0,0,0,3,0,17,2.4285714285714284,2,0.0,0,6,0,0,8,0,0,3,0,6,11,1
2858,66587,Jag1EXQWfAuTRiCgcVLyhRRkdOL9RtSD,bWdj2GDclj5ofokWjzoa5jAwMkxCykd6,4,2,1,0,0,0,2,0,5,0.7142857142857143,1,0.0,0,1,0,0,2,0,0,2,0,1,4,1
2859,66605,XUPBJ1mitGxAzzRukKqjQOzBGJw166yc,G8EPVSXsOYB5YQWZGiz1aVq5Pgr2GrQu,6,13,4,0,0,0,4,0,21,3.0,2,0.0,0,4,0,0,13,0,0,4,0,4,17,1
2860,66646,qZhmmNUvkNXdf3u04DTUQOFEBxxO10p4,G8EPVSXsOYB5YQWZGiz1aVq5Pgr2GrQu,20,17,6,28,4,0,2,0,57,8.142857142857142,2,0.0,5,6,26,4,12,0,2,2,0,41,16,1
2861,66711,VS8f8oTxWcbwLqrK393hBZWMoBFa1gFJ,SpATywNh6bZuzm8s1ceuBUnMUAeoAHHw,3,2,0,0,0,0,1,0,3,0.42857142857142855,1,0.0,0,0,0,0,2,0,0,1,0,0,3,0
2862,66713,LMGbvXS3ZBgtTcKCRLMcqBHrfADBxwXe,G8EPVSXsOYB5YQWZGiz1aVq5Pgr2GrQu,13,19,1,1,4,0,1,0,26,3.7142857142857144,1,0.0,7,1,1,4,12,0,0,1,0,13,13,0
2863,66747,p2gF3LN3ZgatpYPMj263kKzwr7f9hjKm,SpATywNh6bZuzm8s1ceuBUnMUAeoAHHw,6,3,1,0,1,0,2,0,7,1.0,1,0.0,0,1,0,1,3,0,0,2,0,2,5,0
2864,66862,grxgFxuiaSTlMIk1kWcHwbLAYZVnIvkA,RXDvfPUBYFlVdlueBFbLW0mhhAyGEqpt,1,0,0,0,0,0,1,0,1,0.14285714285714285,1,0.0,0,0,0,0,0,0,0,1,0,0,1,1
2865,66922,wEaTyOJwwvOCk7eUttQISK5WPXL7ANNV,RXDvfPUBYFlVdlueBFbLW0mhhAyGEqpt,45,83,27,71,15,30,22,8,256,36.57142857142857,2,0.0,25,27,67,15,58,30,4,22,8,134,122,0
2866,66928,UnlpBoCCKa1g59dweQPJmefdPMpfSVLe,G8EPVSXsOYB5YQWZGiz1aVq5Pgr2GrQu,81,67,34,192,19,0,11,0,323,46.142857142857146,4,0.0,24,34,160,19,43,0,32,11,0,237,86,1
2867,66967,TZMHSuVEUzvE9F9oFUPDubVVCOh0OUwA,SpATywNh6bZuzm8s1ceuBUnMUAeoAHHw,7,6,3,0,2,0,1,0,12,1.7142857142857142,1,0.0,0,3,0,2,6,0,0,1,0,5,7,1
2868,67017,R8e7xg0PB3WHpeFUd7XjboUcUmtjBoqn,G8EPVSXsOYB5YQWZGiz1aVq5Pgr2GrQu,13,10,0,20,0,0,4,0,34,4.857142857142857,1,0.0,4,0,15,0,6,0,5,4,0,19,15,1
2869,67062,lsez2NExtDzqmHTj1WxlkldAKydbGpGz,SpATywNh6bZuzm8s1ceuBUnMUAeoAHHw,17,20,2,13,2,0,4,0,41,5.857142857142857,2,0.0,3,2,11,2,17,0,2,4,0,18,23,0
2870,67179,5Zxu05K7VSTA0XR5o51TQgeWQSwtutqu,SpATywNh6bZuzm8s1ceuBUnMUAeoAHHw,10,7,4,12,1,0,1,0,25,3.5714285714285716,1,0.0,2,4,11,1,5,0,1,1,0,18,7,1
2871,67251,hfSXPDFaR2dzrQsij0JMBqqFRCNkzN0i,bWdj2GDclj5ofokWjzoa5jAwMkxCykd6,6,3,1,0,1,0,2,1,8,1.1428571428571428,1,0.0,0,1,0,1,3,0,0,2,1,2,6,1
2872,67274,ywsBc3bK8Vte1Tvgz902Tgp2J7M95FMX,RXDvfPUBYFlVdlueBFbLW0mhhAyGEqpt,6,3,1,0,0,0,4,0,8,1.1428571428571428,1,0.0,0,1,0,0,3,0,0,4,0,1,7,1
2873,67315,gc2449Ag0boGNd6nrwcfyjhFar24UaYH,RXDvfPUBYFlVdlueBFbLW0mhhAyGEqpt,18,10,10,0,7,0,0,0,27,3.857142857142857,1,0.0,0,10,0,7,10,0,0,0,0,17,10,1
2874,67399,dX8G0MwLqG7R1v0a5bVLBBEO2QeJVwW8,SpATywNh6bZuzm8s1ceuBUnMUAeoAHHw,5,3,2,0,1,0,1,0,7,1.0,1,0.0,0,2,0,1,3,0,0,1,0,3,4,1
2875,67403,s42YRljOqExiv71QhA2soTLfn9kHZdPI,bWdj2GDclj5ofokWjzoa5jAwMkxCykd6,4,9,6,0,0,0,4,0,19,2.7142857142857144,1,0.0,0,6,0,0,9,0,0,4,0,6,13,1
2876,67407,s42YRljOqExiv71QhA2soTLfn9kHZdPI,G8EPVSXsOYB5YQWZGiz1aVq5Pgr2GrQu,1,0,0,0,0,0,1,0,1,0.14285714285714285,1,0.0,0,0,0,0,0,0,0,1,0,0,1,1
2877,67410,SUuO92fg900YcWp4Zs3wbFF13otrTK0v,SpATywNh6bZuzm8s1ceuBUnMUAeoAHHw,1,0,0,0,0,0,1,0,1,0.14285714285714285,1,0.0,0,0,0,0,0,0,0,1,0,0,1,0
2878,67426,VFYk1GyeJyGqK1t09cLe0E5m7KsULmvc,G8EPVSXsOYB5YQWZGiz1aVq5Pgr2GrQu,3,4,2,0,0,0,2,0,8,1.1428571428571428,2,0.0,0,2,0,0,4,0,0,2,0,2,6,1
2879,67432,FdsEBC0mHy1vT6x3hjK3QpB4Q1Uhf4Gh,SpATywNh6bZuzm8s1ceuBUnMUAeoAHHw,15,18,0,15,0,0,5,0,38,5.428571428571429,3,0.0,2,0,12,0,16,0,3,5,0,14,24,0
2880,67570,I1340YsGXK2BIG96XRWppOvFniqpKDu7,RXDvfPUBYFlVdlueBFbLW0mhhAyGEqpt,34,61,21,69,15,3,4,0,173,24.714285714285715,3,0.0,16,21,63,15,45,3,6,4,0,115,58,0
2881,67641,8QtgTaOo9DCjgt6kc4Db1wXfaWgbOe0I,SpATywNh6bZuzm8s1ceuBUnMUAeoAHHw,3,2,1,0,0,0,1,0,4,0.5714285714285714,1,0.0,0,1,0,0,2,0,0,1,0,1,3,1
2882,67642,BwXR7IzUtCAN8pzY1XJl6dbItwnWn8P1,SpATywNh6bZuzm8s1ceuBUnMUAeoAHHw,6,14,7,0,0,0,4,0,25,3.5714285714285716,2,0.0,3,7,0,0,11,0,0,4,0,10,15,0
2883,67802,IEfUasRNK7F4OXmh9ZRgY5RLlk7j6VcY,bWdj2GDclj5ofokWjzoa5jAwMkxCykd6,4,4,3,0,0,0,1,0,8,1.1428571428571428,1,0.0,0,3,0,0,4,0,0,1,0,3,5,1
2884,67852,3Aezv8lgcVyIW4Uwgi3KMiL4RZSkwke5,SpATywNh6bZuzm8s1ceuBUnMUAeoAHHw,6,11,9,0,3,0,4,0,27,3.857142857142857,2,0.0,0,9,0,3,11,0,0,4,0,12,15,1
2885,67877,3kPbFQO63O023TRazY2t5V1M3b8brUv8,SpATywNh6bZuzm8s1ceuBUnMUAeoAHHw,11,17,0,4,0,0,4,0,25,3.5714285714285716,1,0.0,0,0,3,0,17,0,1,4,0,3,22,1
2886,67918,pzHaWUcmzb5LgLjIjpaBYBq7daMNFpyk,SpATywNh6bZuzm8s1ceuBUnMUAeoAHHw,18,27,1,15,0,2,11,0,56,8.0,3,0.0,10,1,12,0,17,2,3,11,0,23,33,1
2887,67930,x6K6gEN1bi7EtUHqEXEFGztPxJcTq3NW,SpATywNh6bZuzm8s1ceuBUnMUAeoAHHw,19,19,11,15,5,0,5,0,55,7.857142857142857,2,0.0,3,11,12,5,16,0,3,5,0,31,24,1
2888,68011,Y0dtU5bUn0PrrnfgvOUCPfb1rktwn4CX,SpATywNh6bZuzm8s1ceuBUnMUAeoAHHw,11,11,8,0,4,0,2,0,25,3.5714285714285716,1,0.0,0,8,0,4,11,0,0,2,0,12,13,1
2889,68059,V87r8ov3AJYZnaKsWbASGu8Ya7b0fguH,SpATywNh6bZuzm8s1ceuBUnMUAeoAHHw,3,2,1,0,0,0,2,0,5,0.7142857142857143,1,0.0,0,1,0,0,2,0,0,2,0,1,4,1
2890,68218,Lbpr3xWnQcIYr1qRkqlNlsrYRpIeuPh8,SpATywNh6bZuzm8s1ceuBUnMUAeoAHHw,6,6,4,0,1,0,0,0,11,1.5714285714285714,1,0.0,0,4,0,1,6,0,0,0,0,5,6,1
2891,68490,hjbzzLF0uZqUL22zLBiQhzq51chcw6mb,SpATywNh6bZuzm8s1ceuBUnMUAeoAHHw,32,28,15,32,9,0,2,0,86,12.285714285714286,1,0.0,11,15,27,9,17,0,5,2,0,62,24,1
2892,68522,iSIDy53M1GeZpXt46JkUT1CVMnifiRBT,G8EPVSXsOYB5YQWZGiz1aVq5Pgr2GrQu,6,12,6,0,1,0,3,0,22,3.142857142857143,1,0.0,3,6,0,1,9,0,0,3,0,10,12,1
2893,68531,hZR4MwcYec4g0GoOyJFngJGEyWOySpv2,RXDvfPUBYFlVdlueBFbLW0mhhAyGEqpt,2,2,1,0,0,9,0,0,12,1.7142857142857142,1,0.0,0,1,0,0,2,9,0,0,0,1,11,0
2894,68665,9LD2dY2JJUiq4N2gerCXLTVCO162xgQP,G8EPVSXsOYB5YQWZGiz1aVq5Pgr2GrQu,44,103,26,144,15,2,8,0,298,42.57142857142857,4,0.0,4,26,144,15,99,2,0,8,0,189,109,1
2895,68676,OvG0QIZOPiV3oa4UqFgxzNEprO7pKVmV,SpATywNh6bZuzm8s1ceuBUnMUAeoAHHw,36,36,17,10,10,1,10,0,84,12.0,2,0.0,4,17,10,10,32,1,0,10,0,41,43,0
2896,68711,fFCTtQQCOOjijvFKvRDQiA777EKDq9kt,RXDvfPUBYFlVdlueBFbLW0mhhAyGEqpt,10,10,3,7,3,0,2,0,25,3.5714285714285716,1,0.0,3,3,7,3,7,0,0,2,0,16,9,1
2897,68867,mJAgtJKHxy28GsPIeuAEUCIOXmHzCywF,A3fsA9Zfv1X2fVEQhTw51lKENdNrEqT3,3,2,1,0,0,0,1,0,4,0.5714285714285714,1,0.0,0,1,0,0,2,0,0,1,0,1,3,0
2898,68889,jagu0OJDhWTGFhfCMk0ghqluLpW3kzdC,A3fsA9Zfv1X2fVEQhTw51lKENdNrEqT3,29,5,3,84,3,6,12,0,113,16.142857142857142,2,0.0,1,3,71,3,4,6,13,12,0,78,35,1
2899,68894,SG7N8DhpCuhIu06IIzLX0CSolbyIDsIx,SpATywNh6bZuzm8s1ceuBUnMUAeoAHHw,3,2,1,0,0,0,1,0,4,0.5714285714285714,1,0.0,0,1,0,0,2,0,0,1,0,1,3,1
2900,68969,koujvnfMBhMkCgSrbEaysh2AE5Gpg2YT,G8EPVSXsOYB5YQWZGiz1aVq5Pgr2GrQu,22,23,10,40,6,0,2,0,81,11.571428571428571,2,0.0,11,10,33,6,12,0,7,2,0,60,21,0
2901,69095,dK22lzU3sHpxa7kQiSzhTpdq8w2wdIKM,G8EPVSXsOYB5YQWZGiz1aVq5Pgr2GrQu,29,52,1,46,3,9,18,1,130,18.571428571428573,4,0.0,27,1,36,3,25,9,10,18,1,67,63,0
2902,69131,8Ir6rIjO15kuvM3s5xrQH1rB1m97Mcy9,SpATywNh6bZuzm8s1ceuBUnMUAeoAHHw,3,4,2,0,0,3,2,0,11,1.5714285714285714,2,0.0,0,2,0,0,4,3,0,2,0,2,9,0
2903,69147,cRQPwEYCK3Iw8dKAOD2ODiUgaKZ6yPed,SpATywNh6bZuzm8s1ceuBUnMUAeoAHHw,7,9,2,4,1,0,2,0,18,2.5714285714285716,1,0.0,3,2,3,1,6,0,1,2,0,9,9,1
2904,69161,3X0JLX6UvJnnRb5GkwbFJgAokE5g69D0,SpATywNh6bZuzm8s1ceuBUnMUAeoAHHw,12,15,1,5,0,0,2,0,23,3.2857142857142856,1,0.0,2,1,5,0,13,0,0,2,0,8,15,0
2905,69192,agX8fi6SsMsbGjpTUuXM1FgToYG9zbAn,SpATywNh6bZuzm8s1ceuBUnMUAeoAHHw,31,44,24,27,16,0,2,0,113,16.142857142857142,2,0.0,18,24,26,16,26,0,1,2,0,84,29,0
2906,69259,7bRPtq6P8Xywkbl391z1cfKif2lsM9WW,SpATywNh6bZuzm8s1ceuBUnMUAeoAHHw,3,2,1,0,0,0,1,0,4,0.5714285714285714,1,0.0,0,1,0,0,2,0,0,1,0,1,3,1
2907,69297,X9IKf8GgqS6dvoKX3VBo51mIr8yb4uFC,bWdj2GDclj5ofokWjzoa5jAwMkxCykd6,2,0,0,0,0,3,2,0,5,0.7142857142857143,1,0.0,0,0,0,0,0,3,0,2,0,0,5,1
2908,69308,YtPY6V9gKVYBGYaBakDnRKgXM0SCPhH8,RXDvfPUBYFlVdlueBFbLW0mhhAyGEqpt,48,33,19,54,15,0,6,0,127,18.142857142857142,3,0.0,11,19,54,15,22,0,0,6,0,99,28,0
2909,69397,egpXv13dykaiU64GCgTaQGg1ErRD7Rsb,SpATywNh6bZuzm8s1ceuBUnMUAeoAHHw,1,0,0,0,0,0,1,0,1,0.14285714285714285,1,0.0,0,0,0,0,0,0,0,1,0,0,1,0
2910,69400,FlAkKX6ow9SvOzk0dTWPWgnX5766zY29,SpATywNh6bZuzm8s1ceuBUnMUAeoAHHw,7,8,5,0,1,0,2,0,16,2.2857142857142856,2,0.0,0,5,0,1,8,0,0,2,0,6,10,1
2911,69462,SzqR1lIvSkqy1yQXOqGRgT5uhu7VR5Jw,SpATywNh6bZuzm8s1ceuBUnMUAeoAHHw,15,18,13,0,8,0,4,0,43,6.142857142857143,3,0.0,0,13,0,8,18,0,0,4,0,21,22,0
2912,69550,rY4HuopoXNauFhpb4SYxSCmQkbvhS34C,SpATywNh6bZuzm8s1ceuBUnMUAeoAHHw,45,55,36,25,24,5,7,0,152,21.714285714285715,2,0.0,14,36,22,24,41,5,3,7,0,96,56,0
2913,69612,kgME9COu6f9ljQ8FhJeUQLVyeGDbkeLG,A3fsA9Zfv1X2fVEQhTw51lKENdNrEqT3,3,2,0,0,0,0,8,0,10,1.4285714285714286,2,0.0,0,0,0,0,2,0,0,8,0,0,10,0
2914,69823,pD1s3J2DAVHqxnTOsnHBHGIq9d5lcpqD,SpATywNh6bZuzm8s1ceuBUnMUAeoAHHw,21,27,14,11,6,0,2,0,60,8.571428571428571,1,0.0,4,14,10,6,23,0,1,2,0,34,26,0
2915,69828,RI0oJHr7vWXzPLP3ybfgZBQolmA0lbjl,SpATywNh6bZuzm8s1ceuBUnMUAeoAHHw,19,18,8,9,5,0,3,0,43,6.142857142857143,2,0.0,2,8,8,5,16,0,1,3,0,23,20,0
2916,69868,gV1Y6A8RpgDuAD47r6UGF54v9TD2f7uU,SpATywNh6bZuzm8s1ceuBUnMUAeoAHHw,12,7,5,0,4,0,2,0,18,2.5714285714285716,1,0.0,0,5,0,4,7,0,0,2,0,9,9,0
2917,70066,wKNO0Jje7WXvAVQ9yfigFflnCrR4q8AL,A3fsA9Zfv1X2fVEQhTw51lKENdNrEqT3,7,10,4,0,3,0,2,0,19,2.7142857142857144,1,0.0,0,4,0,3,10,0,0,2,0,7,12,1
2918,70080,lhSfCfPZnDk6mpF0h6gOX9NA2ZuZUrvg,SpATywNh6bZuzm8s1ceuBUnMUAeoAHHw,16,31,2,0,1,0,5,0,39,5.571428571428571,3,0.0,0,2,0,1,31,0,0,5,0,3,36,0
2919,70117,Unmtjjmp5vQtsUKiq2OfCGrdrro6CfzN,SpATywNh6bZuzm8s1ceuBUnMUAeoAHHw,14,29,9,27,0,98,20,0,183,26.142857142857142,6,0.0,9,9,27,0,20,98,0,20,0,45,138,0
2920,70184,wfgih84xA5GX8u9QHkcXZJABO675HdY1,3VkHkmOtom3jM2wCu94xgzzu1d6Dn7or,8,5,3,0,2,0,4,0,14,2.0,1,0.0,0,3,0,2,5,0,0,4,0,5,9,1
2921,70185,vRrdeghS9EQMMpi4QScjKFq8mUdoNIFC,3VkHkmOtom3jM2wCu94xgzzu1d6Dn7or,11,25,8,9,6,23,15,1,87,12.428571428571429,6,0.0,12,8,6,6,13,23,3,15,1,32,55,1
2922,70187,rZIQ6zXXqp8rIbAh3assmnLbZtesRTC3,3VkHkmOtom3jM2wCu94xgzzu1d6Dn7or,10,19,8,1,4,0,9,0,41,5.857142857142857,3,0.0,1,8,1,4,18,0,0,9,0,14,27,1
2923,70190,Yd5zGIdfRVjsKVvUqU0Kt9qhRzmstpyR,3VkHkmOtom3jM2wCu94xgzzu1d6Dn7or,1,0,0,0,0,0,1,0,1,0.14285714285714285,1,0.0,0,0,0,0,0,0,0,1,0,0,1,1
2924,70193,sHAYvl1dLfmvHVukxJjADxIc0aa6JDK3,3VkHkmOtom3jM2wCu94xgzzu1d6Dn7or,20,64,19,14,8,22,14,2,143,20.428571428571427,5,0.0,20,19,12,8,44,22,2,14,2,59,84,1
2925,70194,NLJiRsXygk1AOHXbn7On7wrRn6XDaaQv,3VkHkmOtom3jM2wCu94xgzzu1d6Dn7or,32,111,52,40,26,72,28,1,330,47.142857142857146,5,0.0,24,52,30,26,87,72,10,28,1,132,198,1
2926,70207,UGYGSfRkJhOkgkdlCI6YSCshpNvwBF31,3VkHkmOtom3jM2wCu94xgzzu1d6Dn7or,30,97,34,26,26,36,46,1,266,38.0,6,0.0,28,34,24,26,69,36,2,46,1,112,154,0
2927,70209,ZUw0LYpLdAJKOcR9I1RaOT65e1Pt1j4a,3VkHkmOtom3jM2wCu94xgzzu1d6Dn7or,12,18,6,8,7,7,4,0,50,7.142857142857143,1,0.0,8,6,7,7,10,7,1,4,0,28,22,1
2928,70211,dvhsNwzNVzFTV5yfSmTM5e1a1EPOb8Ea,3VkHkmOtom3jM2wCu94xgzzu1d6Dn7or,6,5,2,0,1,0,4,0,12,1.7142857142857142,1,0.0,1,2,0,1,4,0,0,4,0,4,8,1
2929,70214,8eA5IS6Vn6RndGmKQ0JBmF923RsdRLP8,3VkHkmOtom3jM2wCu94xgzzu1d6Dn7or,1,0,0,0,0,0,1,0,1,0.14285714285714285,1,0.0,0,0,0,0,0,0,0,1,0,0,1,1
2930,70215,C8sKreRCy05fqxE0b2IRNRcgeAaK4kyW,3VkHkmOtom3jM2wCu94xgzzu1d6Dn7or,13,10,6,0,5,0,3,0,24,3.4285714285714284,3,0.0,0,6,0,5,10,0,0,3,0,11,13,1
2931,70216,eJLAKFPtAeth3Br6K30Tc61aatMUaXTu,3VkHkmOtom3jM2wCu94xgzzu1d6Dn7or,4,0,0,0,0,1,4,0,5,0.7142857142857143,1,0.0,0,0,0,0,0,1,0,4,0,0,5,1
2932,70217,VGvFre4X4qO429b6IKhowwkalHckrjkx,3VkHkmOtom3jM2wCu94xgzzu1d6Dn7or,1,0,0,0,0,0,1,0,1,0.14285714285714285,1,0.0,0,0,0,0,0,0,0,1,0,0,1,1
2933,70218,jD0UeNY9hJbk1PhtJSrh0jfo0FXBK4QE,3VkHkmOtom3jM2wCu94xgzzu1d6Dn7or,6,5,2,0,1,0,2,0,10,1.4285714285714286,1,0.0,0,2,0,1,5,0,0,2,0,3,7,1
2934,70222,dDGa4ygDIORPTxpWiC8uM2JjUI6DLTKR,3VkHkmOtom3jM2wCu94xgzzu1d6Dn7or,45,293,95,86,0,71,68,8,621,88.71428571428571,8,0.0,134,95,80,0,159,71,6,68,8,309,312,0
2935,70229,Jp1T2WVhjU6GdNvl7ZnDDYxQSrlz2FK0,3VkHkmOtom3jM2wCu94xgzzu1d6Dn7or,33,114,36,35,24,20,12,2,243,34.714285714285715,4,0.0,30,36,33,24,84,20,2,12,2,123,120,1
2936,70244,tNi3Zh7tytIDOpzRPgVjOrJz00QBqqDn,3VkHkmOtom3jM2wCu94xgzzu1d6Dn7or,1,0,0,0,0,0,2,0,2,0.2857142857142857,1,0.0,0,0,0,0,0,0,0,2,0,0,2,1
2937,70246,n64wka2sSaJq5DaA5JslbLBFoS4230k9,3VkHkmOtom3jM2wCu94xgzzu1d6Dn7or,14,16,7,0,6,1,14,0,44,6.285714285714286,1,0.0,4,7,0,6,12,1,0,14,0,17,27,1
2938,70248,gscO81uyFXakN6G7EORyf3gCaOhqQGKx,3VkHkmOtom3jM2wCu94xgzzu1d6Dn7or,8,12,7,0,3,7,11,1,41,5.857142857142857,1,0.0,0,7,0,3,12,7,0,11,1,10,31,1
2939,70251,0HuSQpwX1iWYzYyMmZ0529M9saU0hwj8,3VkHkmOtom3jM2wCu94xgzzu1d6Dn7or,5,1,1,0,1,0,4,0,7,1.0,1,0.0,0,1,0,1,1,0,0,4,0,2,5,1
2940,70253,dtUZ7Km4hQshJPZtpZL6oMxkrl1azThU,3VkHkmOtom3jM2wCu94xgzzu1d6Dn7or,1,0,0,0,0,0,1,0,1,0.14285714285714285,1,0.0,0,0,0,0,0,0,0,1,0,0,1,1
2941,70259,1aeZlGsApAjNHF2sTtN2ykYhmZIwHRj3,3VkHkmOtom3jM2wCu94xgzzu1d6Dn7or,15,38,7,12,8,7,18,1,91,13.0,2,0.0,20,7,9,8,18,7,3,18,1,44,47,1
2942,70270,Qu8QUkvr1KTlBexOowWu8oGayNCHenCY,3VkHkmOtom3jM2wCu94xgzzu1d6Dn7or,4,6,1,0,0,0,2,0,9,1.2857142857142858,1,0.0,0,1,0,0,6,0,0,2,0,1,8,1
2943,70273,TSm2R7cUPaXhbTrj1LddmwVL7dduRSSa,3VkHkmOtom3jM2wCu94xgzzu1d6Dn7or,11,5,3,0,2,1,13,2,26,3.7142857142857144,1,0.0,0,3,0,2,5,1,0,13,2,5,21,1
2944,70276,lFdHWGqsbM8uredLqtykcOMiqpT9vQZh,3VkHkmOtom3jM2wCu94xgzzu1d6Dn7or,20,12,10,0,9,0,4,0,35,5.0,2,0.0,0,10,0,9,12,0,0,4,0,19,16,1
2945,70284,BcgzvHoQgHyOCpoLwekWJ52M6u8p1BNv,3VkHkmOtom3jM2wCu94xgzzu1d6Dn7or,6,3,2,0,2,0,1,0,8,1.1428571428571428,1,0.0,0,2,0,2,3,0,0,1,0,4,4,1
2946,70287,hRVlNOTS6jXxXFoegXsRTavsZxsubLWH,3VkHkmOtom3jM2wCu94xgzzu1d6Dn7or,1,0,0,0,0,0,1,0,1,0.14285714285714285,1,0.0,0,0,0,0,0,0,0,1,0,0,1,1
2947,70299,HUdGvoMbBNNA1ZqsKSrSpFS4asnWhnvB,3VkHkmOtom3jM2wCu94xgzzu1d6Dn7or,78,139,47,58,55,33,20,1,353,50.42857142857143,4,0.0,73,47,51,55,66,33,7,20,1,226,127,0
2948,70304,aKsC7UhttF7Nkw8b5fbIrqYUfZaSStLM,3VkHkmOtom3jM2wCu94xgzzu1d6Dn7or,13,46,2,9,10,11,5,1,84,12.0,1,0.0,22,2,7,10,24,11,2,5,1,41,43,1
2949,70307,dMNoKAXoN62rKBeF7DLHss80bKinXTuJ,3VkHkmOtom3jM2wCu94xgzzu1d6Dn7or,1,0,0,0,0,0,1,0,1,0.14285714285714285,1,0.0,0,0,0,0,0,0,0,1,0,0,1,1
2950,70317,HIBuQQWRKjdUStZhe7V5BYz6wgihMKqV,3VkHkmOtom3jM2wCu94xgzzu1d6Dn7or,29,67,17,20,20,17,7,0,148,21.142857142857142,4,0.0,31,17,20,20,36,17,0,7,0,88,60,0
2951,70323,BnP6SRuNadhjBLDhTSpRuYXuZ6HAwvxW,3VkHkmOtom3jM2wCu94xgzzu1d6Dn7or,19,47,13,7,18,8,7,1,101,14.428571428571429,2,0.0,23,13,5,18,24,8,2,7,1,59,42,1
2952,70326,sZITkO7Sh1MA53F3zZx2CU20b5I5kt4P,3VkHkmOtom3jM2wCu94xgzzu1d6Dn7or,15,15,5,0,4,0,11,0,35,5.0,2,0.0,0,5,0,4,15,0,0,11,0,9,26,1
2953,70333,xjWkEdO0xALsCMyXVJLQ76Q1mnSHD20m,3VkHkmOtom3jM2wCu94xgzzu1d6Dn7or,28,67,23,38,13,21,5,0,167,23.857142857142858,5,0.0,15,23,37,13,52,21,1,5,0,88,79,0
2954,70337,4qqXsY3Nc9wmkdhweEho3hjfk0nn3MKk,3VkHkmOtom3jM2wCu94xgzzu1d6Dn7or,11,13,6,3,5,4,2,0,33,4.714285714285714,2,0.0,5,6,3,5,8,4,0,2,0,19,14,1
2955,70343,SIKFAHBZ2fVNjKQ3C1KlOBy1R3yMHlgk,3VkHkmOtom3jM2wCu94xgzzu1d6Dn7or,5,2,1,0,2,0,3,0,8,1.1428571428571428,1,0.0,0,1,0,2,2,0,0,3,0,3,5,1
2956,70344,GHtuONp0s9mJs9ViX96arxU4OpI3IP64,3VkHkmOtom3jM2wCu94xgzzu1d6Dn7or,1,0,0,0,0,0,1,0,1,0.14285714285714285,1,0.0,0,0,0,0,0,0,0,1,0,0,1,1
2957,70347,8h8kudlb5lUeOe03JJgIlAsgTzCK6jP5,3VkHkmOtom3jM2wCu94xgzzu1d6Dn7or,65,143,46,52,45,33,40,1,360,51.42857142857143,11,0.0,71,46,51,45,72,33,1,40,1,213,147,0
2958,70353,BQ3eBJK5uTZKVqw2FUWvJbXxk4Z7jeq1,3VkHkmOtom3jM2wCu94xgzzu1d6Dn7or,10,19,7,9,7,4,12,0,58,8.285714285714286,1,0.0,9,7,6,7,10,4,3,12,0,29,29,1
2959,70358,tkWTBuD8nrYklSlgsF9aKVPineGUm2wd,3VkHkmOtom3jM2wCu94xgzzu1d6Dn7or,1,0,0,0,0,0,2,0,2,0.2857142857142857,2,0.0,0,0,0,0,0,0,0,2,0,0,2,1
2960,70361,wQATXyXcLqQpcDtwYaqTkn0go5xZGZIB,3VkHkmOtom3jM2wCu94xgzzu1d6Dn7or,1,0,0,0,0,0,1,0,1,0.14285714285714285,1,0.0,0,0,0,0,0,0,0,1,0,0,1,1
2961,70364,d11XQPw4CaDnMkkvSEo4JqU6avErSb1R,fbPkOYLVPtPgIt0MxizjfFJov3JbHyAi,4,0,0,0,0,8,3,1,12,1.7142857142857142,1,0.0,0,0,0,0,0,8,0,3,1,0,12,1
2962,70405,0mn9lI6rmOQgtsjwJJCZKT5aBtKrZOEC,fbPkOYLVPtPgIt0MxizjfFJov3JbHyAi,3,2,0,0,0,0,1,0,3,0.42857142857142855,1,0.0,0,0,0,0,2,0,0,1,0,0,3,1
2963,70483,F8PplJ0MdSBFJMkvQSa7z6RMAQvcxOkt,fbPkOYLVPtPgIt0MxizjfFJov3JbHyAi,5,6,3,0,1,1,1,0,12,1.7142857142857142,1,0.0,2,3,0,1,4,1,0,1,0,6,6,0
2964,70621,w0u223fmMcj8R0XYvkRYTxBWPO2H34gs,fbPkOYLVPtPgIt0MxizjfFJov3JbHyAi,2,0,0,0,0,0,3,0,3,0.42857142857142855,1,0.0,0,0,0,0,0,0,0,3,0,0,3,0
2965,70692,6qrT2bYbFD0verDQZWOnrOjhEccqo56g,fbPkOYLVPtPgIt0MxizjfFJov3JbHyAi,30,75,35,12,16,38,13,0,189,27.0,4,0.0,32,35,12,16,43,38,0,13,0,95,94,0
2966,71013,pHnPjZi5mLgI5QDOW2G2xaXlZsc2fDRf,5X6FeZozNMgE2VRi3MJYjkkFK8SETtu2,17,33,12,17,13,0,8,1,84,12.0,4,0.0,14,12,15,13,19,0,2,8,1,54,30,1
2967,71116,gMihFFRgCbvgH3cTGh2cgQ4GULLM91Yq,SpATywNh6bZuzm8s1ceuBUnMUAeoAHHw,4,2,0,0,0,0,2,0,4,0.5714285714285714,1,0.0,0,0,0,0,2,0,0,2,0,0,4,0
2968,71139,loLM1q927UBCE6cjZ1Vielkh2VBpufUl,A3fsA9Zfv1X2fVEQhTw51lKENdNrEqT3,3,2,1,0,0,0,1,0,4,0.5714285714285714,1,0.0,0,1,0,0,2,0,0,1,0,1,3,1
2969,71166,FixP7IuJ80KsWtzMzcQsJZKOjLxDKZgC,5X6FeZozNMgE2VRi3MJYjkkFK8SETtu2,1,0,0,0,0,0,1,0,1,0.14285714285714285,1,0.0,0,0,0,0,0,0,0,1,0,0,1,1
2970,71280,YUT6CW7iSh1xoUpF2nfmR8w0ThlxeIYe,SpATywNh6bZuzm8s1ceuBUnMUAeoAHHw,15,17,0,13,0,15,12,0,57,8.142857142857142,2,0.0,5,0,12,0,12,15,1,12,0,17,40,0
2971,71309,04MTc9DP7u70zt8WMvntZYPfTFQUHhtX,SpATywNh6bZuzm8s1ceuBUnMUAeoAHHw,3,2,0,0,0,0,1,0,3,0.42857142857142855,1,0.0,0,0,0,0,2,0,0,1,0,0,3,0
2972,71361,fnAQHOrM0aOC0GQVDcBG5sVn1wNxVUAt,SpATywNh6bZuzm8s1ceuBUnMUAeoAHHw,20,17,9,11,5,0,2,0,44,6.285714285714286,2,0.0,5,9,9,5,12,0,2,2,0,28,16,0
2973,71426,onsmNYIoPFEi185f5ZLsQXD70I3K25Cb,bWdj2GDclj5ofokWjzoa5jAwMkxCykd6,4,7,2,0,0,0,1,0,10,1.4285714285714286,1,0.0,2,2,0,0,5,0,0,1,0,4,6,1
2974,71558,nqvxWBh8RMlOMSpTtlC0WlRIvQffkk6Q,SpATywNh6bZuzm8s1ceuBUnMUAeoAHHw,13,6,4,12,3,0,2,0,27,3.857142857142857,1,0.0,2,4,10,3,4,0,2,2,0,19,8,0
2975,71611,KWdhtnEkrke9rgi3l1csNclNjZVhn1s4,SpATywNh6bZuzm8s1ceuBUnMUAeoAHHw,9,14,0,0,0,0,3,0,17,2.4285714285714284,2,0.0,0,0,0,0,14,0,0,3,0,0,17,1
2976,71640,jj6BKJzz2LfNkxpbRScKRBOb519d4fcM,5X6FeZozNMgE2VRi3MJYjkkFK8SETtu2,3,2,0,0,0,0,9,0,11,1.5714285714285714,4,0.0,0,0,0,0,2,0,0,9,0,0,11,0
2977,71690,MELwpFsIi2XkPIOGygAX1FgCz7x3lucR,5X6FeZozNMgE2VRi3MJYjkkFK8SETtu2,1,0,0,0,0,0,1,0,1,0.14285714285714285,1,0.0,0,0,0,0,0,0,0,1,0,0,1,1
2978,71761,IVf9pr5nElMkd4OXzOFEQ79wv07lJihp,5X6FeZozNMgE2VRi3MJYjkkFK8SETtu2,3,0,0,0,0,21,4,0,25,3.5714285714285716,1,0.0,0,0,0,0,0,21,0,4,0,0,25,1
2979,71829,n1JdH8HPXOUoCHQIEd4YCo0nlAshsKdG,SpATywNh6bZuzm8s1ceuBUnMUAeoAHHw,10,10,0,14,0,0,3,0,27,3.857142857142857,2,0.0,2,0,12,0,8,0,2,3,0,14,13,0
2980,71836,BVpzzXeXh42vyU3wE9rUQpEUs8P1ZpSo,SpATywNh6bZuzm8s1ceuBUnMUAeoAHHw,5,9,4,0,0,0,2,0,15,2.142857142857143,2,0.0,2,4,0,0,7,0,0,2,0,6,9,0
2981,71865,nvXkSuJjNwPy4x4PN83PXogIa9iXtJsm,A3fsA9Zfv1X2fVEQhTw51lKENdNrEqT3,2,0,0,0,0,0,2,0,2,0.2857142857142857,1,0.0,0,0,0,0,0,0,0,2,0,0,2,1
2982,71880,YaP2AuckukEZITP3IVvIt6Z8ci6RHew7,5X6FeZozNMgE2VRi3MJYjkkFK8SETtu2,24,38,12,39,18,0,10,0,117,16.714285714285715,3,0.0,21,12,32,18,17,0,7,10,0,83,34,1
2983,71999,Pe5WMotTf5HMq3hNpICq7pbnjQeqT1z5,SpATywNh6bZuzm8s1ceuBUnMUAeoAHHw,18,13,8,11,5,0,1,0,38,5.428571428571429,1,0.0,4,8,10,5,9,0,1,1,0,27,11,0
2984,72086,0LMHRy44jwjr4gUThAzfzfGCUeg2Lm1J,SpATywNh6bZuzm8s1ceuBUnMUAeoAHHw,6,7,4,0,2,0,1,0,14,2.0,1,0.0,2,4,0,2,5,0,0,1,0,8,6,1
2985,72116,QeJMYd11is6DqiF8uVkla2ZwnHb26tuu,RXDvfPUBYFlVdlueBFbLW0mhhAyGEqpt,1,0,0,0,0,0,1,0,1,0.14285714285714285,1,0.0,0,0,0,0,0,0,0,1,0,0,1,0
2986,72222,Fdt86Xu5OLPdaOgl6M1XDpiJ3zar7SU6,RXDvfPUBYFlVdlueBFbLW0mhhAyGEqpt,2,0,0,0,0,0,4,0,4,0.5714285714285714,1,0.0,0,0,0,0,0,0,0,4,0,0,4,1
2987,72280,Daw06K1PSOXldo19kBgHP5sewulb7Vu5,RXDvfPUBYFlVdlueBFbLW0mhhAyGEqpt,12,12,0,0,0,4,5,2,23,3.2857142857142856,1,0.0,0,0,0,0,12,4,0,5,2,0,23,1
2988,72333,uqA5Smdw6BACOcL0f2tmxwTTxZXBpZpE,bWdj2GDclj5ofokWjzoa5jAwMkxCykd6,5,4,0,0,0,0,2,0,6,0.8571428571428571,1,0.0,0,0,0,0,4,0,0,2,0,0,6,1
2989,72392,dQQ8UnfzoKHmhQlZOaaW0cB14DhE2hvY,A3fsA9Zfv1X2fVEQhTw51lKENdNrEqT3,3,2,1,0,0,0,1,0,4,0.5714285714285714,1,0.0,0,1,0,0,2,0,0,1,0,1,3,0
2990,72428,s8yyjhcg4BVOip4HSP4txOTTHFJ4aWPU,5X6FeZozNMgE2VRi3MJYjkkFK8SETtu2,1,0,0,0,0,0,2,0,2,0.2857142857142857,1,0.0,0,0,0,0,0,0,0,2,0,0,2,1
2991,72476,gpgk1aIkjyvlgo7OYZtMXPlVgE39gvnr,SpATywNh6bZuzm8s1ceuBUnMUAeoAHHw,7,8,3,0,0,0,6,0,17,2.4285714285714284,2,0.0,0,3,0,0,8,0,0,6,0,3,14,0
2992,72533,kPw5nR6GIfIGfnUDhfrz9sq3P6l2CmOK,RXDvfPUBYFlVdlueBFbLW0mhhAyGEqpt,3,4,2,0,0,0,2,0,8,1.1428571428571428,2,0.0,0,2,0,0,4,0,0,2,0,2,6,1
2993,72560,9czpFwHJ3FpE9rgLseKKVivLeSQjwoKI,SpATywNh6bZuzm8s1ceuBUnMUAeoAHHw,4,3,1,0,1,0,0,0,5,0.7142857142857143,1,0.0,0,1,0,1,3,0,0,0,0,2,3,1
2994,72572,2QSRX6tWhC0oLYllnKUwIH2KIoHl3tDb,SpATywNh6bZuzm8s1ceuBUnMUAeoAHHw,16,13,0,9,0,1,5,1,29,4.142857142857143,1,0.0,2,0,8,0,11,1,1,5,1,10,19,1
2995,72812,xgPoMcAyqtOnl7aMAll1Vnr6k8ioz2It,SpATywNh6bZuzm8s1ceuBUnMUAeoAHHw,1,0,0,0,0,0,1,0,1,0.14285714285714285,1,0.0,0,0,0,0,0,0,0,1,0,0,1,1
2996,72935,EOrD3HkA0FfCJhrA6AxTfDE3tsE6V3D0,5X6FeZozNMgE2VRi3MJYjkkFK8SETtu2,5,6,1,0,3,0,3,0,13,1.8571428571428572,1,0.0,4,1,0,3,2,0,0,3,0,8,5,1
2997,73001,NlHO5hXiy7TmVTHiRgExH6y7p9gJG1YF,A3fsA9Zfv1X2fVEQhTw51lKENdNrEqT3,3,2,1,0,0,0,2,0,5,0.7142857142857143,1,0.0,0,1,0,0,2,0,0,2,0,1,4,1
2998,73013,Sle0t5zy0VbRjUdpojBY9wV6zuG12LCM,5X6FeZozNMgE2VRi3MJYjkkFK8SETtu2,1,0,0,0,0,0,1,0,1,0.14285714285714285,1,0.0,0,0,0,0,0,0,0,1,0,0,1,1
2999,73039,NlHO5hXiy7TmVTHiRgExH6y7p9gJG1YF,5X6FeZozNMgE2VRi3MJYjkkFK8SETtu2,7,7,4,0,2,0,4,0,17,2.4285714285714284,3,0.0,0,4,0,2,7,0,0,4,0,6,11,1
3000,73050,Hj6wuu6IJzCenxWAs1sLyWNMm32YIpDq,SpATywNh6bZuzm8s1ceuBUnMUAeoAHHw,15,22,12,0,5,0,6,0,45,6.428571428571429,2,0.0,0,12,0,5,22,0,0,6,0,17,28,1
3001,73075,y1PyjNePB0NOk56DVMODQe87hVVXR5yE,5X6FeZozNMgE2VRi3MJYjkkFK8SETtu2,2,0,0,0,0,0,7,0,7,1.0,2,0.0,0,0,0,0,0,0,0,7,0,0,7,1
3002,73079,Oe7zyPdqUKEu4xpqbiVxJiAwdUxxeOQv,bWdj2GDclj5ofokWjzoa5jAwMkxCykd6,7,5,4,0,2,1,4,2,18,2.5714285714285716,1,0.0,1,4,0,2,4,1,0,4,2,7,11,1
3003,73101,AeXY5V6bNirN94d0GfQQQX1fFim1uqSr,SpATywNh6bZuzm8s1ceuBUnMUAeoAHHw,2,0,0,0,0,0,8,0,8,1.1428571428571428,3,0.0,0,0,0,0,0,0,0,8,0,0,8,0
3004,73110,TOybu3VTl57Gwz61jxLAAYZF2xYkGB5M,SpATywNh6bZuzm8s1ceuBUnMUAeoAHHw,6,4,2,0,1,0,1,0,8,1.1428571428571428,1,0.0,0,2,0,1,4,0,0,1,0,3,5,1
3005,73147,wbFZf0vBGr8ZagqGAnXAxrCWXPqmHozC,5X6FeZozNMgE2VRi3MJYjkkFK8SETtu2,1,0,0,0,0,0,1,0,1,0.14285714285714285,1,0.0,0,0,0,0,0,0,0,1,0,0,1,1
3006,73190,kbMv7EO3A91wuEPFHCa22AOeSwxNJKSp,5X6FeZozNMgE2VRi3MJYjkkFK8SETtu2,7,13,1,0,1,0,2,0,17,2.4285714285714284,2,0.0,2,1,0,1,11,0,0,2,0,4,13,1
3007,73203,jd8MXn6vqDpoHFl1TCHyXimPI4EsaYkX,3VkHkmOtom3jM2wCu94xgzzu1d6Dn7or,9,7,3,0,1,2,8,3,24,3.4285714285714284,1,0.0,0,3,0,1,7,2,0,8,3,4,20,1
3008,73206,9zMytBTVoe6Tn7dJKaX3NNcggrjEkcTk,3VkHkmOtom3jM2wCu94xgzzu1d6Dn7or,20,22,13,0,13,0,6,0,54,7.714285714285714,3,0.0,2,13,0,13,20,0,0,6,0,28,26,1
3009,73211,9vbi0qVB5xQ2wSMCh1OrppOawp7UFwsK,3VkHkmOtom3jM2wCu94xgzzu1d6Dn7or,12,17,9,0,4,14,19,3,66,9.428571428571429,2,0.0,2,9,0,4,15,14,0,19,3,15,51,1
3010,73227,rq47UXDAYzP0huW4VpeI8U2jckeqLc26,3VkHkmOtom3jM2wCu94xgzzu1d6Dn7or,5,0,0,0,0,6,7,4,17,2.4285714285714284,2,0.0,0,0,0,0,0,6,0,7,4,0,17,1
3011,73230,h8BwrBZ61dHhi5fhxZzTUeeYh9J3sER4,3VkHkmOtom3jM2wCu94xgzzu1d6Dn7or,1,0,0,0,0,0,1,0,1,0.14285714285714285,1,0.0,0,0,0,0,0,0,0,1,0,0,1,0
3012,73232,Z6A9SVqRdCrhqu0rHQmWfwtwx80YGT5M,3VkHkmOtom3jM2wCu94xgzzu1d6Dn7or,1,0,0,0,0,0,1,0,1,0.14285714285714285,1,0.0,0,0,0,0,0,0,0,1,0,0,1,1
3013,73236,dozFnSZsUs00J9MX4ct7e6ZtU5sdV69O,3VkHkmOtom3jM2wCu94xgzzu1d6Dn7or,8,10,3,0,3,0,2,0,18,2.5714285714285716,1,0.0,2,3,0,3,8,0,0,2,0,8,10,1
3014,73238,O7BkYKGPbSCKVITR1KG0UTtUy6cDdabs,3VkHkmOtom3jM2wCu94xgzzu1d6Dn7or,14,23,5,6,12,1,8,0,55,7.857142857142857,2,0.0,18,5,5,12,5,1,1,8,0,40,15,1
3015,73240,r3f7wHZSFd07HF32hSE8PkUZaySPvN4d,3VkHkmOtom3jM2wCu94xgzzu1d6Dn7or,8,7,3,0,3,2,9,1,25,3.5714285714285716,1,0.0,2,3,0,3,5,2,0,9,1,8,17,1
3016,73244,JFezdq3HQwoFzokOD81lnmoMmkvol7xQ,3VkHkmOtom3jM2wCu94xgzzu1d6Dn7or,19,39,1,14,10,13,55,4,136,19.428571428571427,7,0.0,16,1,13,10,23,13,1,55,4,40,96,0
3017,73248,R2cga9JVVM2tXEVs2saYswslfxAU4nMk,3VkHkmOtom3jM2wCu94xgzzu1d6Dn7or,59,82,42,28,34,6,28,0,220,31.428571428571427,9,0.0,31,42,28,34,51,6,0,28,0,135,85,0
3018,73252,m1zn7AvLnmlCJ9brb0HZdSG0FeKaLUqp,3VkHkmOtom3jM2wCu94xgzzu1d6Dn7or,18,47,12,18,11,15,15,0,118,16.857142857142858,1,0.0,22,12,16,11,25,15,2,15,0,61,57,1
3019,73256,pbaqjkvaUNQsMIN40YaHH4YISJL3nrdi,3VkHkmOtom3jM2wCu94xgzzu1d6Dn7or,1,0,0,0,0,0,2,0,2,0.2857142857142857,1,0.0,0,0,0,0,0,0,0,2,0,0,2,1
3020,73261,N5TKMxyWKdkFzZA279Rfen1L0QsEHnKY,3VkHkmOtom3jM2wCu94xgzzu1d6Dn7or,1,0,0,0,0,0,1,0,1,0.14285714285714285,1,0.0,0,0,0,0,0,0,0,1,0,0,1,1
3021,73278,cnKN4D3R34GcHxNlrqbidGHEbLO4eEid,3VkHkmOtom3jM2wCu94xgzzu1d6Dn7or,5,2,1,0,1,0,2,0,6,0.8571428571428571,1,0.0,0,1,0,1,2,0,0,2,0,2,4,1
3022,73281,5SOdJYPnvYxeS4UBSuKkVojxVP4sxLEw,3VkHkmOtom3jM2wCu94xgzzu1d6Dn7or,8,2,1,0,1,0,10,1,15,2.142857142857143,1,0.0,0,1,0,1,2,0,0,10,1,2,13,1
3023,73283,PDFZvgAb72rGPlFZqaletmZsr46HXIyJ,3VkHkmOtom3jM2wCu94xgzzu1d6Dn7or,1,0,0,0,0,0,1,0,1,0.14285714285714285,1,0.0,0,0,0,0,0,0,0,1,0,0,1,1
3024,73295,M8V2y9Z5sWfpduzlKwp3srW2j2nT8uwk,3VkHkmOtom3jM2wCu94xgzzu1d6Dn7or,67,150,31,67,54,17,13,0,332,47.42857142857143,7,0.0,87,31,64,54,63,17,3,13,0,236,96,0
3025,73299,K3jSJcWKnTiEzZJnp0Ou8365M9lH5Ih1,3VkHkmOtom3jM2wCu94xgzzu1d6Dn7or,1,0,0,0,0,0,1,0,1,0.14285714285714285,1,0.0,0,0,0,0,0,0,0,1,0,0,1,1
3026,73302,Cgp6Fjg1TRpzTbhJh6918E6BFXkTGrsR,3VkHkmOtom3jM2wCu94xgzzu1d6Dn7or,64,94,21,71,31,86,21,2,326,46.57142857142857,5,0.0,35,21,66,31,59,86,5,21,2,153,173,0
3027,73308,jIYo67IJxGwYwwBEl2YZhnVAM20w2MgR,3VkHkmOtom3jM2wCu94xgzzu1d6Dn7or,9,5,3,0,3,0,3,0,14,2.0,2,0.0,0,3,0,3,5,0,0,3,0,6,8,1
3028,73310,R1SqdpVYyj7bWmKgOM9V6ZIx9N5AUoG4,3VkHkmOtom3jM2wCu94xgzzu1d6Dn7or,5,2,1,0,1,0,4,0,8,1.1428571428571428,1,0.0,0,1,0,1,2,0,0,4,0,2,6,1
3029,73313,mzy01fDwJBwMUlHWMoXH7OMrYxJe1zvH,3VkHkmOtom3jM2wCu94xgzzu1d6Dn7or,5,11,5,0,2,0,2,0,20,2.857142857142857,1,0.0,0,5,0,2,11,0,0,2,0,7,13,1
3030,73317,nZBEO25QEEdKJsNDjWc27BQlFlOJqVIP,3VkHkmOtom3jM2wCu94xgzzu1d6Dn7or,1,0,0,0,0,0,1,0,1,0.14285714285714285,1,0.0,0,0,0,0,0,0,0,1,0,0,1,1
3031,73318,Ay92zmnnqi5ek8HqbeSzTmVXrof1x39k,3VkHkmOtom3jM2wCu94xgzzu1d6Dn7or,1,0,0,0,0,0,1,0,1,0.14285714285714285,1,0.0,0,0,0,0,0,0,0,1,0,0,1,1
3032,73334,2ENDZhPlfPQ7xqwHjrfLuuWg5Duw7ZBj,3VkHkmOtom3jM2wCu94xgzzu1d6Dn7or,6,12,4,2,3,0,2,0,23,3.2857142857142856,2,0.0,3,4,2,3,9,0,0,2,0,12,11,1
3033,73337,te0V0ywwiaO8UKeN3BcfBiTjsNYrZi3v,3VkHkmOtom3jM2wCu94xgzzu1d6Dn7or,8,4,3,0,3,0,1,0,11,1.5714285714285714,1,0.0,0,3,0,3,4,0,0,1,0,6,5,1
3034,73340,zNnqmF2sQm5pVrk4EjykARlvIbp0hTq0,3VkHkmOtom3jM2wCu94xgzzu1d6Dn7or,9,11,5,5,2,1,4,0,28,4.0,1,0.0,2,5,4,2,9,1,1,4,0,13,15,1
3035,73341,ADMIFDZbPY9hQL0eY7HQGU4BfyaHLhHb,3VkHkmOtom3jM2wCu94xgzzu1d6Dn7or,1,0,0,0,0,0,1,0,1,0.14285714285714285,1,0.0,0,0,0,0,0,0,0,1,0,0,1,1
3036,73345,kO0z920NpjGq3cakMSbDokznFh1eCAnW,3VkHkmOtom3jM2wCu94xgzzu1d6Dn7or,1,0,0,0,0,0,1,0,1,0.14285714285714285,1,0.0,0,0,0,0,0,0,0,1,0,0,1,1
3037,73348,xDyboMn2OhWuXmtjJNkeQw53zYuRLVzY,3VkHkmOtom3jM2wCu94xgzzu1d6Dn7or,10,6,4,0,3,0,8,0,21,3.0,1,0.0,0,4,0,3,6,0,0,8,0,7,14,1
3038,73357,knD21VtknSqFu1mOSObOT0TPlZT8RhxA,3VkHkmOtom3jM2wCu94xgzzu1d6Dn7or,7,4,2,0,1,0,6,0,13,1.8571428571428572,1,0.0,0,2,0,1,4,0,0,6,0,3,10,1
3039,73359,uC9oS0wlvLniEnxIoGOAeAvh5sdHUknJ,3VkHkmOtom3jM2wCu94xgzzu1d6Dn7or,1,0,0,0,0,0,1,0,1,0.14285714285714285,1,0.0,0,0,0,0,0,0,0,1,0,0,1,1
3040,73366,63k2apv6Vp9s0xPXNwa5FAgRK25JC0lA,3VkHkmOtom3jM2wCu94xgzzu1d6Dn7or,18,15,12,0,9,0,2,0,38,5.428571428571429,4,0.0,0,12,0,9,15,0,0,2,0,21,17,1
3041,73369,UN3Q60QibxjdS87vGRCzXIIbFljeUB0v,3VkHkmOtom3jM2wCu94xgzzu1d6Dn7or,1,0,0,0,0,0,1,0,1,0.14285714285714285,1,0.0,0,0,0,0,0,0,0,1,0,0,1,1
3042,73374,986WgoFI0AZSDPIvWwBI8MUZveW4E4Xu,3VkHkmOtom3jM2wCu94xgzzu1d6Dn7or,33,60,22,38,11,18,14,1,164,23.428571428571427,3,0.0,12,22,35,11,48,18,3,14,1,80,84,0
3043,73382,rsiMGvEJZqczqD08x9MQAR0kFgDd2l1B,3VkHkmOtom3jM2wCu94xgzzu1d6Dn7or,1,0,0,0,0,0,1,0,1,0.14285714285714285,1,0.0,0,0,0,0,0,0,0,1,0,0,1,1
3044,73398,0SJa4sq43fjfzXheW19DL0aDJrxMILdx,3VkHkmOtom3jM2wCu94xgzzu1d6Dn7or,64,143,70,30,41,0,23,0,307,43.857142857142854,9,0.0,49,70,29,41,94,0,1,23,0,189,118,0
3045,73404,b5cuBi91panGPWP50qpw7aKYdBMxoKav,3VkHkmOtom3jM2wCu94xgzzu1d6Dn7or,4,2,1,0,0,0,3,0,6,0.8571428571428571,1,0.0,0,1,0,0,2,0,0,3,0,1,5,1
3046,73406,GQSZs8nrUHTGbP9vFHBPJ8hfphwSqg4w,3VkHkmOtom3jM2wCu94xgzzu1d6Dn7or,4,2,1,0,1,0,1,0,5,0.7142857142857143,1,0.0,0,1,0,1,2,0,0,1,0,2,3,1
3047,73417,L5pA3H7m2qYFia4DHW15gmoKoflabQUC,3VkHkmOtom3jM2wCu94xgzzu1d6Dn7or,45,96,43,39,27,0,19,0,224,32.0,5,0.0,24,43,37,27,72,0,2,19,0,131,93,1
3048,73420,pWVshvgu2I0zZvqKEaUa3vMzUz2E4uP3,3VkHkmOtom3jM2wCu94xgzzu1d6Dn7or,1,0,0,0,0,0,1,0,1,0.14285714285714285,1,0.0,0,0,0,0,0,0,0,1,0,0,1,1
3049,73426,9w2MJQeZHeyFkqwhaftUSXLuvPN6lDkw,3VkHkmOtom3jM2wCu94xgzzu1d6Dn7or,1,0,0,0,0,0,1,0,1,0.14285714285714285,1,0.0,0,0,0,0,0,0,0,1,0,0,1,1
3050,73494,oqEIAtGTt4InlQEThHndS9WQldZK5nao,fbPkOYLVPtPgIt0MxizjfFJov3JbHyAi,14,14,6,5,7,0,1,0,33,4.714285714285714,1,0.0,6,6,5,7,8,0,0,1,0,24,9,0
3051,73495,2yHDApK48Bpxk4ycdhvNjswXV9pG17S8,fbPkOYLVPtPgIt0MxizjfFJov3JbHyAi,1,0,0,0,0,0,1,0,1,0.14285714285714285,1,0.0,0,0,0,0,0,0,0,1,0,0,1,1
3052,73496,qAeLkkvoXaT45canBik0DwIUrhYxKAAw,fbPkOYLVPtPgIt0MxizjfFJov3JbHyAi,13,13,9,0,10,0,2,0,34,4.857142857142857,1,0.0,3,9,0,10,10,0,0,2,0,22,12,1
3053,73497,73wvSugERlgXlzZkjMla01pxZjIWCzPw,fbPkOYLVPtPgIt0MxizjfFJov3JbHyAi,1,0,0,0,0,0,1,0,1,0.14285714285714285,1,0.0,0,0,0,0,0,0,0,1,0,0,1,1
3054,73502,UGYGSfRkJhOkgkdlCI6YSCshpNvwBF31,fbPkOYLVPtPgIt0MxizjfFJov3JbHyAi,6,5,4,0,1,0,1,0,11,1.5714285714285714,1,0.0,0,4,0,1,5,0,0,1,0,5,6,1
3055,73504,50aSuabL02e7lLNBHTRXsMQnBChV2lSX,fbPkOYLVPtPgIt0MxizjfFJov3JbHyAi,4,3,1,0,0,0,1,0,5,0.7142857142857143,1,0.0,0,1,0,0,3,0,0,1,0,1,4,1
3056,73505,bhD9bouqHgaUVRbs8dGQRsEiqOqvpuYM,fbPkOYLVPtPgIt0MxizjfFJov3JbHyAi,1,0,0,0,0,0,1,0,1,0.14285714285714285,1,0.0,0,0,0,0,0,0,0,1,0,0,1,1
3057,73506,Rx3G6WDqhxXAFzDE5dP0dCkALUmrsPnH,fbPkOYLVPtPgIt0MxizjfFJov3JbHyAi,23,32,15,12,15,11,5,0,90,12.857142857142858,1,0.0,11,15,10,15,21,11,2,5,0,51,39,1
3058,73508,YNIWjVVReCMnb4p25EmH6YanIJI1UWGe,fbPkOYLVPtPgIt0MxizjfFJov3JbHyAi,6,3,1,0,1,0,2,0,7,1.0,1,0.0,0,1,0,1,3,0,0,2,0,2,5,1
3059,73509,OOIu03NBEHePUSUIFa86FGFP5M136EAn,fbPkOYLVPtPgIt0MxizjfFJov3JbHyAi,3,6,0,0,0,0,1,0,7,1.0,1,0.0,0,0,0,0,6,0,0,1,0,0,7,1
3060,73511,9iX0A4Y0q2thIU9usJFlwmiE8DoNTRvB,fbPkOYLVPtPgIt0MxizjfFJov3JbHyAi,12,9,5,4,3,0,2,0,23,3.2857142857142856,1,0.0,2,5,4,3,7,0,0,2,0,14,9,1
3061,73516,vLjohboP8EuarkC6oMKBUVa7YmHcZWmk,fbPkOYLVPtPgIt0MxizjfFJov3JbHyAi,6,1,1,0,1,0,4,0,7,1.0,1,0.0,0,1,0,1,1,0,0,4,0,2,5,1
3062,73518,mEXms676UX2nEtOWi785T3a9YDRXn6eo,fbPkOYLVPtPgIt0MxizjfFJov3JbHyAi,14,9,8,0,6,0,1,0,24,3.4285714285714284,1,0.0,0,8,0,6,9,0,0,1,0,14,10,1
3063,73519,BjBet1XrpmufRo3nJSBrADvKxDiooNdd,fbPkOYLVPtPgIt0MxizjfFJov3JbHyAi,10,10,6,0,3,10,6,1,36,5.142857142857143,1,0.0,1,6,0,3,9,10,0,6,1,10,26,1
3064,73520,XRprdFoWtySQSNhPZow4aE4x8DdY6QhU,fbPkOYLVPtPgIt0MxizjfFJov3JbHyAi,7,3,2,0,2,0,2,0,9,1.2857142857142858,1,0.0,0,2,0,2,3,0,0,2,0,4,5,1
3065,73525,YYAhVs5wmP4F74gdoBHpFlxdJmuG5pXA,fbPkOYLVPtPgIt0MxizjfFJov3JbHyAi,1,0,0,0,0,0,1,0,1,0.14285714285714285,1,0.0,0,0,0,0,0,0,0,1,0,0,1,1
3066,73526,OxEmYoAPQNdxXumQAaCmWKRfombYnFvQ,fbPkOYLVPtPgIt0MxizjfFJov3JbHyAi,5,3,1,0,1,0,2,0,7,1.0,1,0.0,0,1,0,1,3,0,0,2,0,2,5,1
3067,73528,mBIkr9FKQiN1ufY0GShlq8gtUf6KY3Wf,fbPkOYLVPtPgIt0MxizjfFJov3JbHyAi,1,0,0,0,0,0,1,0,1,0.14285714285714285,1,0.0,0,0,0,0,0,0,0,1,0,0,1,1
3068,73529,9OIml0SV4dEAJAFAwgEIKnYzkcxrQvU3,fbPkOYLVPtPgIt0MxizjfFJov3JbHyAi,1,0,0,0,0,0,1,0,1,0.14285714285714285,1,0.0,0,0,0,0,0,0,0,1,0,0,1,1
3069,73536,cAGDrQKi6UBwqQTSWSVc30OIcWrPac5g,fbPkOYLVPtPgIt0MxizjfFJov3JbHyAi,1,0,0,0,0,0,1,0,1,0.14285714285714285,1,0.0,0,0,0,0,0,0,0,1,0,0,1,1
3070,73539,2LWu6JMOYyxkKMq63i00WbtT7iPpdOSr,fbPkOYLVPtPgIt0MxizjfFJov3JbHyAi,10,13,5,6,3,0,8,0,35,5.0,1,0.0,5,5,4,3,8,0,2,8,0,17,18,1
3071,73542,WlsAmr4q7aQixI2ydMQ1hllbYNweh5Yc,fbPkOYLVPtPgIt0MxizjfFJov3JbHyAi,5,4,0,0,0,0,5,0,9,1.2857142857142858,1,0.0,1,0,0,0,3,0,0,5,0,1,8,1
3072,73543,qCHnpaFMgw6f0BW7hG9Qa9zJ3b9yr9G8,fbPkOYLVPtPgIt0MxizjfFJov3JbHyAi,5,1,1,0,1,0,2,0,5,0.7142857142857143,1,0.0,0,1,0,1,1,0,0,2,0,2,3,1
3073,73545,Khrg4vJLRO2BLXCnotgKckm2alLmBqlG,fbPkOYLVPtPgIt0MxizjfFJov3JbHyAi,1,0,0,0,0,0,1,0,1,0.14285714285714285,1,0.0,0,0,0,0,0,0,0,1,0,0,1,1
3074,73546,ffYbnIyANDjzLf3ELTXl50wDF2eVsyNm,fbPkOYLVPtPgIt0MxizjfFJov3JbHyAi,7,8,0,0,0,0,3,0,11,1.5714285714285714,2,0.0,0,0,0,0,8,0,0,3,0,0,11,1
3075,73549,zQW97Cs28pPZNFmFrSf1IuV78UQZFOY4,fbPkOYLVPtPgIt0MxizjfFJov3JbHyAi,7,6,2,0,2,0,3,0,13,1.8571428571428572,1,0.0,2,2,0,2,4,0,0,3,0,6,7,1
3076,73550,k5oVYco32vQ3DmUE6ZDHecga51LfmXuY,fbPkOYLVPtPgIt0MxizjfFJov3JbHyAi,5,3,1,0,1,0,2,0,7,1.0,1,0.0,0,1,0,1,3,0,0,2,0,2,5,1
3077,73552,h7q8BDRJv6YwUTxA0nYbUskOJqg41gHy,3VkHkmOtom3jM2wCu94xgzzu1d6Dn7or,1,0,0,0,0,0,1,0,1,0.14285714285714285,1,0.0,0,0,0,0,0,0,0,1,0,0,1,1
3078,73571,AheFqUnyunvQI5u1wgqcNuJg3W7Wljz8,3VkHkmOtom3jM2wCu94xgzzu1d6Dn7or,18,20,10,20,7,14,3,0,74,10.571428571428571,1,0.0,5,10,16,7,15,14,4,3,0,38,36,1
3079,73575,CFUx7WKUxHEsW0H7zKcUairzxQEPJJ9t,3VkHkmOtom3jM2wCu94xgzzu1d6Dn7or,12,9,5,0,6,8,10,1,39,5.571428571428571,1,0.0,3,5,0,6,6,8,0,10,1,14,25,1
3080,73581,v4mnpN1ZzmBWLe7g9zIGsloagGKXr7Sw,3VkHkmOtom3jM2wCu94xgzzu1d6Dn7or,53,99,48,56,32,33,40,9,317,45.285714285714285,10,0.0,26,48,50,32,73,33,6,40,9,156,161,0
3081,73584,nRWRN1VFS4Bx83JlgThpaau0M5l9PhDv,3VkHkmOtom3jM2wCu94xgzzu1d6Dn7or,4,4,1,0,1,0,1,0,7,1.0,1,0.0,0,1,0,1,4,0,0,1,0,2,5,1
3082,73585,U11KhdeSf7Ds7XggaiHnRtu6k7OIQmFC,3VkHkmOtom3jM2wCu94xgzzu1d6Dn7or,5,3,1,0,1,2,2,1,10,1.4285714285714286,1,0.0,0,1,0,1,3,2,0,2,1,2,8,0
3083,73590,Nt3cbsiz8P6NnQBf5AuW9IadrwZqmTm2,3VkHkmOtom3jM2wCu94xgzzu1d6Dn7or,10,19,3,7,9,0,1,0,39,5.571428571428571,1,0.0,15,3,6,9,4,0,1,1,0,33,6,0
3084,73599,fCHWLC8lBZgcpthEq6o0NTnCmXmHDago,3VkHkmOtom3jM2wCu94xgzzu1d6Dn7or,1,0,0,0,0,0,2,0,2,0.2857142857142857,1,0.0,0,0,0,0,0,0,0,2,0,0,2,1
3085,73601,uISGM4LqBUfXPHskRZuSs9XeQkD4VUeT,3VkHkmOtom3jM2wCu94xgzzu1d6Dn7or,8,14,4,0,1,0,5,1,25,3.5714285714285716,1,0.0,0,4,0,1,14,0,0,5,1,5,20,1
3086,73602,5ZyvCd3AP7a8azCiLN5JfLAP53iZpAyD,3VkHkmOtom3jM2wCu94xgzzu1d6Dn7or,1,0,0,0,0,0,1,0,1,0.14285714285714285,1,0.0,0,0,0,0,0,0,0,1,0,0,1,1
3087,73604,eOxm8XEI11Xs6eiBi1Nu5QzIagZXwEm9,3VkHkmOtom3jM2wCu94xgzzu1d6Dn7or,11,10,6,0,4,0,5,0,25,3.5714285714285716,3,0.0,0,6,0,4,10,0,0,5,0,10,15,1
3088,73609,4JVunCIVvMuOsnD3wm7ZujOEI1ZSDCNJ,3VkHkmOtom3jM2wCu94xgzzu1d6Dn7or,1,0,0,0,0,0,1,0,1,0.14285714285714285,1,0.0,0,0,0,0,0,0,0,1,0,0,1,1
3089,73611,6ajy2Xo0RPItlR9bxIFl8dIymIKOcLWj,3VkHkmOtom3jM2wCu94xgzzu1d6Dn7or,10,12,3,5,2,1,6,1,30,4.285714285714286,2,0.0,4,3,5,2,8,1,0,6,1,14,16,0
3090,73612,GMJria24VEYJwthC8X1pUN8GkDnMmvbg,3VkHkmOtom3jM2wCu94xgzzu1d6Dn7or,1,0,0,0,0,0,1,0,1,0.14285714285714285,1,0.0,0,0,0,0,0,0,0,1,0,0,1,1
3091,73617,8dCm5ykoggbuw6B52chvXPMcB3CvbDNd,3VkHkmOtom3jM2wCu94xgzzu1d6Dn7or,1,0,0,0,0,0,1,0,1,0.14285714285714285,1,0.0,0,0,0,0,0,0,0,1,0,0,1,1
3092,73622,KKZGEplHAZHJaar0wTXBKGAPnvAmcV8C,3VkHkmOtom3jM2wCu94xgzzu1d6Dn7or,1,0,0,0,0,0,1,0,1,0.14285714285714285,1,0.0,0,0,0,0,0,0,0,1,0,0,1,1
3093,73623,O7rdwueb8EOnoWTm58cGX7VWoWsu2Ef2,3VkHkmOtom3jM2wCu94xgzzu1d6Dn7or,5,2,1,0,1,0,2,0,6,0.8571428571428571,1,0.0,0,1,0,1,2,0,0,2,0,2,4,1
3094,73630,j8ZdsvT8MT6TX0QqCYipGET178fHxNme,3VkHkmOtom3jM2wCu94xgzzu1d6Dn7or,2,0,0,0,0,0,2,0,2,0.2857142857142857,1,0.0,0,0,0,0,0,0,0,2,0,0,2,1
3095,73631,hZyRWM8r2Wur33dMoFmMYzW3jbY706vJ,3VkHkmOtom3jM2wCu94xgzzu1d6Dn7or,8,16,6,0,7,0,10,1,40,5.714285714285714,2,0.0,7,6,0,7,9,0,0,10,1,20,20,1
3096,73634,vuqFPhnjwQKBPhmOAdfWdPVUnftTeBnB,3VkHkmOtom3jM2wCu94xgzzu1d6Dn7or,5,2,0,0,1,2,3,0,8,1.1428571428571428,2,0.0,0,0,0,1,2,2,0,3,0,1,7,0
3097,73642,lYPmLriKoOtOY3Z7HGFZO5NVsNqoAoKk,3VkHkmOtom3jM2wCu94xgzzu1d6Dn7or,7,8,3,0,3,0,2,0,16,2.2857142857142856,2,0.0,3,3,0,3,5,0,0,2,0,9,7,1
3098,73654,WUAwaEskSQZLXog8ztw0hK4kyOuc1bFw,3VkHkmOtom3jM2wCu94xgzzu1d6Dn7or,5,9,2,0,1,1,3,0,16,2.2857142857142856,2,0.0,4,2,0,1,5,1,0,3,0,7,9,1
3099,73661,aakRkEs35rIopwbwvTlrZnDDdPavpR3N,3VkHkmOtom3jM2wCu94xgzzu1d6Dn7or,68,67,27,50,22,0,5,0,171,24.428571428571427,2,0.0,25,27,49,22,42,0,1,5,0,123,48,0
3100,73662,PQESuxv4e41P5YT6QHXabQPITVM48wey,3VkHkmOtom3jM2wCu94xgzzu1d6Dn7or,13,27,5,6,8,8,12,5,71,10.142857142857142,1,0.0,11,5,5,8,16,8,1,12,5,29,42,1
3101,73663,YOs6ux6EWxgiQyrj54reczfd5GQ0XsKa,3VkHkmOtom3jM2wCu94xgzzu1d6Dn7or,1,0,0,0,0,0,2,0,2,0.2857142857142857,1,0.0,0,0,0,0,0,0,0,2,0,0,2,1
3102,73664,TKhSwLlLUW07V4Zy6fEEB6PQLFKHNLl4,3VkHkmOtom3jM2wCu94xgzzu1d6Dn7or,6,1,1,0,1,0,5,0,8,1.1428571428571428,1,0.0,0,1,0,1,1,0,0,5,0,2,6,1
3103,73666,fJdUKH8czX92V7yfMeG7e087z1xbQDMc,3VkHkmOtom3jM2wCu94xgzzu1d6Dn7or,94,170,64,86,55,12,16,0,403,57.57142857142857,12,0.0,60,64,75,55,110,12,11,16,0,254,149,0
3104,73667,kIHi48IR2QZ9J9hQnL1Ja49z6Z4606Rk,3VkHkmOtom3jM2wCu94xgzzu1d6Dn7or,7,3,2,0,2,0,5,0,12,1.7142857142857142,1,0.0,0,2,0,2,3,0,0,5,0,4,8,1
3105,73671,QC1BA9gfkKnyyyTIN6kJlhn9JDxOqLvx,3VkHkmOtom3jM2wCu94xgzzu1d6Dn7or,17,52,10,25,17,7,7,0,118,16.857142857142858,2,0.0,37,10,25,17,15,7,0,7,0,89,29,1
3106,73674,rsf9v14pDD4ud2Coca160pyP6fjYq3oQ,3VkHkmOtom3jM2wCu94xgzzu1d6Dn7or,21,44,13,11,21,4,11,1,105,15.0,2,0.0,27,13,11,21,17,4,0,11,1,72,33,1
3107,73685,lLrAVEWQ2x5apL4fu1w1v7KTH1d0J6qB,3VkHkmOtom3jM2wCu94xgzzu1d6Dn7or,5,2,1,0,0,0,5,0,8,1.1428571428571428,1,0.0,0,1,0,0,2,0,0,5,0,1,7,1
3108,73687,gDULbPgIPZbnvXYXX6gO0n1O9A1rzVCQ,3VkHkmOtom3jM2wCu94xgzzu1d6Dn7or,6,2,1,0,1,0,4,0,8,1.1428571428571428,1,0.0,0,1,0,1,2,0,0,4,0,2,6,1
3109,73690,muvF5wkfrbWIpy4qvfHaaVq9NJuDH4m3,3VkHkmOtom3jM2wCu94xgzzu1d6Dn7or,1,0,0,0,0,0,1,0,1,0.14285714285714285,1,0.0,0,0,0,0,0,0,0,1,0,0,1,1
3110,73695,3MCx9ifi5b3ADtCHN4ZbVLOjeVGRf8YZ,3VkHkmOtom3jM2wCu94xgzzu1d6Dn7or,11,4,1,0,3,0,5,1,14,2.0,1,0.0,0,1,0,3,4,0,0,5,1,4,10,1
3111,73707,rYvSXMUkS6EklQLnrQ2Wy21uJvBI6Xec,3VkHkmOtom3jM2wCu94xgzzu1d6Dn7or,6,4,2,4,1,1,2,0,14,2.0,1,0.0,1,2,3,1,3,1,1,2,0,7,7,1
3112,73713,S2Jvj0BMWrUdwvYyrlC2Nc5Yv2Vt2kH1,3VkHkmOtom3jM2wCu94xgzzu1d6Dn7or,5,5,1,0,0,0,6,0,12,1.7142857142857142,3,0.0,0,1,0,0,5,0,0,6,0,1,11,1
3113,73715,JxLtKAnMek98G5fWpyeTaKlh0zheuNnU,3VkHkmOtom3jM2wCu94xgzzu1d6Dn7or,14,24,11,6,6,1,4,0,52,7.428571428571429,2,0.0,6,11,5,6,18,1,1,4,0,28,24,1
3114,73716,axnpovA8lCh1wXce3rIHB8faN3xr7hGy,3VkHkmOtom3jM2wCu94xgzzu1d6Dn7or,1,0,0,0,0,0,1,0,1,0.14285714285714285,1,0.0,0,0,0,0,0,0,0,1,0,0,1,1
3115,73723,H3KVva2JTKkPzY4Y9DqQmDABTZNfRCVw,3VkHkmOtom3jM2wCu94xgzzu1d6Dn7or,5,2,1,0,1,2,5,0,11,1.5714285714285714,1,0.0,0,1,0,1,2,2,0,5,0,2,9,1
3116,73725,fKyVxj9gIMpHVAVz3ay8pzjOLuqLzptR,3VkHkmOtom3jM2wCu94xgzzu1d6Dn7or,4,3,1,0,1,1,1,0,7,1.0,1,0.0,1,1,0,1,2,1,0,1,0,3,4,1
3117,73739,y3PPOxRJ4p0YKSweB5X6zh0D55cH80aD,3VkHkmOtom3jM2wCu94xgzzu1d6Dn7or,7,39,6,0,2,0,23,0,70,10.0,3,0.0,4,6,0,2,35,0,0,23,0,12,58,1
3118,73740,gph8VkJd7s0DFKNUtkJpFFmI5CFliEg5,3VkHkmOtom3jM2wCu94xgzzu1d6Dn7or,10,10,3,0,2,1,4,0,20,2.857142857142857,1,0.0,1,3,0,2,9,1,0,4,0,6,14,1
3119,73741,OsiBTMHF52Tb90yx6bNrwujKW9Ty8Vgc,3VkHkmOtom3jM2wCu94xgzzu1d6Dn7or,12,23,10,4,8,10,9,0,64,9.142857142857142,3,0.0,7,10,4,8,16,10,0,9,0,29,35,1
3120,73743,cGVoxMV3C2x2s10xZorcuauBzHRjYcK5,3VkHkmOtom3jM2wCu94xgzzu1d6Dn7or,5,4,0,0,0,0,7,0,11,1.5714285714285714,2,0.0,2,0,0,0,2,0,0,7,0,2,9,1
3121,73752,u7hSziEA8AItNZdMGptoIA8ysXHdaLFj,3VkHkmOtom3jM2wCu94xgzzu1d6Dn7or,15,30,6,1,2,0,8,0,47,6.714285714285714,3,0.0,4,6,1,2,26,0,0,8,0,13,34,1
3122,73766,F3I0tBwAnj15WhwXGuHYoPcDGPAf3HtZ,3VkHkmOtom3jM2wCu94xgzzu1d6Dn7or,23,51,17,4,11,3,8,0,94,13.428571428571429,6,0.0,6,17,3,11,45,3,1,8,0,37,57,1
3123,73777,MFwpmZbEHI9Y2cwhDbAPo04ZaiioDaCz,3VkHkmOtom3jM2wCu94xgzzu1d6Dn7or,4,2,0,0,0,0,2,0,4,0.5714285714285714,1,0.0,0,0,0,0,2,0,0,2,0,0,4,1
3124,73780,UUChwaVAZ1oKveTt0Vj8xyjjfyHU0i0A,3VkHkmOtom3jM2wCu94xgzzu1d6Dn7or,1,0,0,0,0,0,1,0,1,0.14285714285714285,1,0.0,0,0,0,0,0,0,0,1,0,0,1,1
3125,73784,1Q1RccUywWVMfWnesxO4lgaUR4eFFO72,3VkHkmOtom3jM2wCu94xgzzu1d6Dn7or,41,150,8,28,10,7,21,1,225,32.142857142857146,6,0.0,55,8,26,10,95,7,2,21,1,99,126,0
3126,73785,xCkK7k1NUxNOOD7sYQMaMHcf5E0nRUdO,3VkHkmOtom3jM2wCu94xgzzu1d6Dn7or,5,7,3,0,1,0,3,0,14,2.0,1,0.0,0,3,0,1,7,0,0,3,0,4,10,1
3127,73904,TMzaU5DW9rklHO5S86JO0t475aLHlncW,SpATywNh6bZuzm8s1ceuBUnMUAeoAHHw,36,56,25,33,15,0,11,1,141,20.142857142857142,5,0.0,27,25,30,15,29,0,3,11,1,97,44,1
3128,73905,4Y6ySID5iQf80xGHEGKPq13tPSHHOAOF,SpATywNh6bZuzm8s1ceuBUnMUAeoAHHw,15,36,12,17,5,0,1,0,71,10.142857142857142,1,0.0,16,12,15,5,20,0,2,1,0,48,23,1
3129,73915,CPXJLPoqpAOiv8Mv4U7wyesIpIX2ZEAc,SpATywNh6bZuzm8s1ceuBUnMUAeoAHHw,1,0,0,0,0,0,1,0,1,0.14285714285714285,1,0.0,0,0,0,0,0,0,0,1,0,0,1,1
3130,73953,7VDn6ntyPpx1GsPLNVgZQF03WDWTuKJo,bWdj2GDclj5ofokWjzoa5jAwMkxCykd6,11,9,5,14,0,0,1,0,29,4.142857142857143,2,0.0,2,5,11,0,7,0,3,1,0,18,11,0
3131,73957,q5R81Yw8uRP3FrwNvV49L9qc5ag0j7J9,5X6FeZozNMgE2VRi3MJYjkkFK8SETtu2,4,3,1,0,0,0,3,0,7,1.0,2,0.0,0,1,0,0,3,0,0,3,0,1,6,1
3132,73991,XnmbufyRkGbBNj2S65IEmwgm9FwmHwEd,SpATywNh6bZuzm8s1ceuBUnMUAeoAHHw,8,4,4,0,4,4,8,1,25,3.5714285714285716,1,0.0,0,4,0,4,4,4,0,8,1,8,17,1
3133,73997,LsKfrBRYdD4gggczcaha9PBojfMCU4hy,SpATywNh6bZuzm8s1ceuBUnMUAeoAHHw,16,21,16,9,10,0,8,0,64,9.142857142857142,2,0.0,0,16,7,10,21,0,2,8,0,33,31,1
3134,73998,ej4gQoO7wYuk4hf1qDoakX8UCNofUE33,SpATywNh6bZuzm8s1ceuBUnMUAeoAHHw,4,3,2,0,0,0,2,0,7,1.0,1,0.0,0,2,0,0,3,0,0,2,0,2,5,1
3135,74021,EPmLjBxeWpwhjwoRgtmLV8RkhFOu2zzj,A3fsA9Zfv1X2fVEQhTw51lKENdNrEqT3,10,5,4,0,3,0,3,0,15,2.142857142857143,1,0.0,0,4,0,3,5,0,0,3,0,7,8,1
3136,74048,vQAS0obh0bWlfi2VaK7gKWVKUzPkWalY,A3fsA9Zfv1X2fVEQhTw51lKENdNrEqT3,2,0,0,0,0,0,2,0,2,0.2857142857142857,1,0.0,0,0,0,0,0,0,0,2,0,0,2,1
3137,74053,SjOzZscJIO4ulmLmX1Ejwn4Qjdb7qmSK,SpATywNh6bZuzm8s1ceuBUnMUAeoAHHw,7,5,1,0,1,0,2,0,9,1.2857142857142858,1,0.0,0,1,0,1,5,0,0,2,0,2,7,1
3138,74062,1cBYtB7KOC3ODHrTHPWmdxuvdPQZ4YhT,SpATywNh6bZuzm8s1ceuBUnMUAeoAHHw,12,17,14,3,4,0,3,0,41,5.857142857142857,2,0.0,0,14,3,4,17,0,0,3,0,21,20,0
3139,74092,fs1l75tl2rJ0qd1qJKuhVRR2VwK6Slkd,SpATywNh6bZuzm8s1ceuBUnMUAeoAHHw,1,0,0,0,0,0,1,0,1,0.14285714285714285,1,0.0,0,0,0,0,0,0,0,1,0,0,1,1
3140,74101,Uvr135kFC9KlMOM943bFXvTUT71uSm4O,G8EPVSXsOYB5YQWZGiz1aVq5Pgr2GrQu,5,13,9,0,5,0,4,0,31,4.428571428571429,1,0.0,0,9,0,5,13,0,0,4,0,14,17,0
3141,74104,7TkkuA0EEQqi6jLSaHSvDaS7U5kNSv36,SpATywNh6bZuzm8s1ceuBUnMUAeoAHHw,23,31,16,18,6,6,3,0,80,11.428571428571429,1,0.0,4,16,14,6,27,6,4,3,0,40,40,0
3142,74135,LFLcxwCrNiuinAjspGRRRup0s9DizBlW,G8EPVSXsOYB5YQWZGiz1aVq5Pgr2GrQu,7,3,2,0,2,0,4,0,11,1.5714285714285714,2,0.0,0,2,0,2,3,0,0,4,0,4,7,1
3143,74145,AYn8itqWLXLy37nOctHXi3n4YvQOz54J,bWdj2GDclj5ofokWjzoa5jAwMkxCykd6,3,0,0,0,0,9,3,1,13,1.8571428571428572,2,0.0,0,0,0,0,0,9,0,3,1,0,13,1
3144,74150,HjIrUt1Ax8b3fBkdKQupL2gDMbKYgLrZ,RXDvfPUBYFlVdlueBFbLW0mhhAyGEqpt,22,15,11,38,6,2,4,1,77,11.0,1,0.0,2,11,31,6,13,2,7,4,1,50,27,1
3145,74178,74Dywe4dn2al60hXONYhqNpcRQDf18AP,A3fsA9Zfv1X2fVEQhTw51lKENdNrEqT3,2,0,0,0,0,0,2,0,2,0.2857142857142857,1,0.0,0,0,0,0,0,0,0,2,0,0,2,1
3146,74180,EUS0PtlDQBOBMfXoJzMCULHFCBIf0VV4,SpATywNh6bZuzm8s1ceuBUnMUAeoAHHw,5,2,1,0,1,0,2,0,6,0.8571428571428571,1,0.0,0,1,0,1,2,0,0,2,0,2,4,1
3147,74189,jjXwu6JpFQ9AzYn6ZMlMU16MF4VF7IC7,SpATywNh6bZuzm8s1ceuBUnMUAeoAHHw,4,3,2,0,0,0,1,0,6,0.8571428571428571,1,0.0,0,2,0,0,3,0,0,1,0,2,4,1
3148,74218,Hzo5Ctg10ZQey5IjMeCvl0CH7lPNTM5X,bWdj2GDclj5ofokWjzoa5jAwMkxCykd6,2,0,0,0,0,0,2,0,2,0.2857142857142857,1,0.0,0,0,0,0,0,0,0,2,0,0,2,1
3149,74222,FsDHYzf7kXddjaitMOVxbo2SbZ3MpAze,A3fsA9Zfv1X2fVEQhTw51lKENdNrEqT3,7,3,2,0,2,0,6,0,13,1.8571428571428572,1,0.0,0,2,0,2,3,0,0,6,0,4,9,1
3150,74249,7n0QZ7z1Xa9itNmJQbQwoSvEI6n7oD9f,SpATywNh6bZuzm8s1ceuBUnMUAeoAHHw,8,3,2,0,2,0,3,0,10,1.4285714285714286,1,0.0,0,2,0,2,3,0,0,3,0,4,6,0
3151,74299,GUEWTq9dWLLDLVWGGRMdJ9TNmItGCjS4,5X6FeZozNMgE2VRi3MJYjkkFK8SETtu2,80,254,78,154,78,45,23,0,632,90.28571428571429,6,0.0,125,78,127,78,129,45,27,23,0,408,224,1
3152,74300,MgS6WK9esRya9QyP2ZOjbNdLSIL7NuM9,SpATywNh6bZuzm8s1ceuBUnMUAeoAHHw,11,26,9,17,0,0,6,0,58,8.285714285714286,3,0.0,9,9,13,0,17,0,4,6,0,31,27,0
3153,74301,WCAIb19YcAzAlp07XtATiiwpdzMqbAbp,7GRhBDsirIGkRZBtSMEzNTyDr2JQm4xx,4,3,2,0,0,0,1,0,6,0.8571428571428571,1,0.0,0,2,0,0,3,0,0,1,0,2,4,0
3154,74306,h5KJmuIyQGH66BE7hBmcyhhaiLqOmsLZ,G8EPVSXsOYB5YQWZGiz1aVq5Pgr2GrQu,24,38,5,24,5,0,8,0,80,11.428571428571429,3,0.0,5,5,21,5,33,0,3,8,0,36,44,0
3155,74308,cynSK4pVMg8QkEFbKcs3bJdr6KIkWo0k,bWdj2GDclj5ofokWjzoa5jAwMkxCykd6,5,2,1,0,1,0,2,0,6,0.8571428571428571,1,0.0,0,1,0,1,2,0,0,2,0,2,4,1
3156,74326,TueMDIMX3gvaGFBwrGkCX4Me136y3V2Q,G8EPVSXsOYB5YQWZGiz1aVq5Pgr2GrQu,11,13,9,0,1,0,5,0,28,4.0,2,0.0,0,9,0,1,13,0,0,5,0,10,18,1
3157,74334,ovvuiEhj0QBv4xi11GVjXr8JhlCgaPmd,SpATywNh6bZuzm8s1ceuBUnMUAeoAHHw,13,12,7,11,3,5,6,0,44,6.285714285714286,2,0.0,5,7,10,3,7,5,1,6,0,25,19,0
3158,74386,QlvFciinGDGt7csjDmjYPPZqFlKAzfUP,SpATywNh6bZuzm8s1ceuBUnMUAeoAHHw,29,48,19,44,7,0,4,0,122,17.428571428571427,2,0.0,24,19,34,7,24,0,10,4,0,84,38,0
3159,74422,wQR8RZQNRkM3a3DVwBNXhaadMjbVENc0,bWdj2GDclj5ofokWjzoa5jAwMkxCykd6,1,0,0,0,0,0,1,0,1,0.14285714285714285,1,0.0,0,0,0,0,0,0,0,1,0,0,1,0
3160,74437,Anr82PPgHyVjFu2RaZRNpr3IKYwAUnAW,bWdj2GDclj5ofokWjzoa5jAwMkxCykd6,1,0,0,0,0,0,1,0,1,0.14285714285714285,1,0.0,0,0,0,0,0,0,0,1,0,0,1,1
3161,74499,lmeMhWa8hXVoeC6vmJbPTxkNCUltvvzl,A3fsA9Zfv1X2fVEQhTw51lKENdNrEqT3,35,9,7,64,4,1,7,1,93,13.285714285714286,1,0.0,1,7,55,4,8,1,9,7,1,67,26,1
3162,74507,pjJJuxaXEuw09zVn6xAhWQF9JKw7sgKR,5X6FeZozNMgE2VRi3MJYjkkFK8SETtu2,2,0,0,0,0,0,2,0,2,0.2857142857142857,1,0.0,0,0,0,0,0,0,0,2,0,0,2,1
3163,74518,xhevg6JjK2rrYOm315OyMAnP1ijNPsHG,SpATywNh6bZuzm8s1ceuBUnMUAeoAHHw,1,0,0,0,0,0,1,0,1,0.14285714285714285,1,0.0,0,0,0,0,0,0,0,1,0,0,1,1
3164,74519,XgD1QVsWWGLho1UFxzA4qhUNghhl4Er9,RXDvfPUBYFlVdlueBFbLW0mhhAyGEqpt,6,4,1,0,1,0,2,0,8,1.1428571428571428,1,0.0,0,1,0,1,4,0,0,2,0,2,6,1
3165,74529,YfLkHn3sP8pusiYlKK6o5F2jXKBNkL8d,SpATywNh6bZuzm8s1ceuBUnMUAeoAHHw,19,42,20,10,9,7,10,0,98,14.0,5,0.0,6,20,10,9,36,7,0,10,0,45,53,0
3166,74535,VSis3GPLe3g5PXWWtZzI0G79Q5DGCKD1,SpATywNh6bZuzm8s1ceuBUnMUAeoAHHw,1,0,0,0,0,0,1,0,1,0.14285714285714285,1,0.0,0,0,0,0,0,0,0,1,0,0,1,0
3167,74555,Q8RGPBI5Ez4dcsYeaCg7LkbJmto9C3oj,SpATywNh6bZuzm8s1ceuBUnMUAeoAHHw,14,15,6,24,4,0,9,3,61,8.714285714285714,2,0.0,9,6,21,4,6,0,3,9,3,40,21,0
3168,74573,OK8QGV0tYeSvHoJprBbFr837PnoinpOg,5X6FeZozNMgE2VRi3MJYjkkFK8SETtu2,1,0,0,0,0,0,1,0,1,0.14285714285714285,1,0.0,0,0,0,0,0,0,0,1,0,0,1,1
3169,74581,GUEWTq9dWLLDLVWGGRMdJ9TNmItGCjS4,SpATywNh6bZuzm8s1ceuBUnMUAeoAHHw,1,0,0,0,0,0,1,0,1,0.14285714285714285,1,0.0,0,0,0,0,0,0,0,1,0,0,1,1
3170,74582,RwE9FiLrBLNeexkGLu7IRwAZMt3TO12Z,bWdj2GDclj5ofokWjzoa5jAwMkxCykd6,5,2,0,0,0,0,3,1,6,0.8571428571428571,1,0.0,0,0,0,0,2,0,0,3,1,0,6,1
3171,74583,Srs2zxwdsKPZud9M0i8SAhTaQwEf4X4V,5X6FeZozNMgE2VRi3MJYjkkFK8SETtu2,8,7,2,0,2,9,7,0,27,3.857142857142857,2,0.0,1,2,0,2,6,9,0,7,0,5,22,1
3172,74589,BXD72vLG7gPEbE6jX5yHvh6FjDG3GoKK,SpATywNh6bZuzm8s1ceuBUnMUAeoAHHw,6,5,2,0,1,0,2,0,10,1.4285714285714286,1,0.0,0,2,0,1,5,0,0,2,0,3,7,1
3173,74608,U3R4m4eLMm2lirgI7HLueBKsNpxhFpn9,7GRhBDsirIGkRZBtSMEzNTyDr2JQm4xx,60,52,28,61,9,0,5,0,155,22.142857142857142,1,0.0,19,28,61,9,33,0,0,5,0,117,38,1
3174,74611,oulkc1tf0Kd1NPyUx3LDpZLt1fzzxHYa,SpATywNh6bZuzm8s1ceuBUnMUAeoAHHw,4,5,0,0,0,0,1,0,6,0.8571428571428571,1,0.0,0,0,0,0,5,0,0,1,0,0,6,1
3175,74618,RtmYmukzSU8h3Uq6suOYxJKRcISOQfvL,RXDvfPUBYFlVdlueBFbLW0mhhAyGEqpt,19,19,16,0,12,0,3,0,50,7.142857142857143,3,0.0,0,16,0,12,19,0,0,3,0,28,22,0
3176,74622,zPAVoNOooAkEz0VkTeYjPUYyBUMYQvD0,A3fsA9Zfv1X2fVEQhTw51lKENdNrEqT3,10,14,2,0,3,0,11,0,30,4.285714285714286,2,0.0,1,2,0,3,13,0,0,11,0,6,24,1
3177,74635,3Mo4KKxt5XsXFl1wmKukaZclKwhABriO,bWdj2GDclj5ofokWjzoa5jAwMkxCykd6,1,0,0,0,0,0,1,0,1,0.14285714285714285,1,0.0,0,0,0,0,0,0,0,1,0,0,1,1
3178,74643,2VA4csxIMQCx8OPT1JNIuyOwjieGR5SH,A3fsA9Zfv1X2fVEQhTw51lKENdNrEqT3,4,3,0,0,0,0,4,0,7,1.0,1,0.0,0,0,0,0,3,0,0,4,0,0,7,1
3179,74653,HL0jm7zWkHTTtUFklIJxsfljBDgcIEre,SpATywNh6bZuzm8s1ceuBUnMUAeoAHHw,10,23,1,19,0,3,4,0,50,7.142857142857143,2,0.0,7,1,17,0,16,3,2,4,0,25,25,1
3180,74658,xFE5tfvhHqpc8q4ByUwGnIzhZrTnJEgg,SpATywNh6bZuzm8s1ceuBUnMUAeoAHHw,1,0,0,0,0,0,1,0,1,0.14285714285714285,1,0.0,0,0,0,0,0,0,0,1,0,0,1,1
3181,74668,QNugDWVi5qk9oRx0FjSG4WF2CyPqMBfw,bWdj2GDclj5ofokWjzoa5jAwMkxCykd6,7,8,3,0,1,4,5,0,21,3.0,1,0.0,2,3,0,1,6,4,0,5,0,6,15,1
3182,74669,QYUKXD6RJtSdizcdlNjQSBFOXbEQl1FA,SpATywNh6bZuzm8s1ceuBUnMUAeoAHHw,6,11,6,0,0,5,3,0,25,3.5714285714285716,2,0.0,0,6,0,0,11,5,0,3,0,6,19,1
3183,74670,YviwWEN6zon2XUnzizUs5e4hMfvZTKyo,SpATywNh6bZuzm8s1ceuBUnMUAeoAHHw,8,6,1,8,1,0,1,0,17,2.4285714285714284,1,0.0,0,1,6,1,6,0,2,1,0,8,9,1
3184,74703,vSL0kRsKOWBMpC6pqEAxri0eLNug5E20,RXDvfPUBYFlVdlueBFbLW0mhhAyGEqpt,17,32,8,0,3,0,9,0,52,7.428571428571429,2,0.0,0,8,0,3,32,0,0,9,0,11,41,0
3185,74706,zT1WyWGnYCfKfATU7zQU9FVr4gxBMiyV,SpATywNh6bZuzm8s1ceuBUnMUAeoAHHw,15,19,6,10,3,0,3,0,41,5.857142857142857,2,0.0,10,6,8,3,9,0,2,3,0,27,14,0
3186,74717,tBy7E7qZZZ98Oih5sTNUdDZRIpZZM98z,SpATywNh6bZuzm8s1ceuBUnMUAeoAHHw,11,13,3,27,0,0,2,0,45,6.428571428571429,2,0.0,7,3,21,0,6,0,6,2,0,31,14,0
3187,74726,PIxnueIZLpBbMAAHbhlsEVGPkWRYGpMI,A3fsA9Zfv1X2fVEQhTw51lKENdNrEqT3,16,14,2,0,2,0,2,0,20,2.857142857142857,1,0.0,0,2,0,2,14,0,0,2,0,4,16,1
3188,74729,Y0Kg8VlywQM3MgkPLCaUvRZWlzcWLHyc,SpATywNh6bZuzm8s1ceuBUnMUAeoAHHw,1,0,0,0,0,0,1,0,1,0.14285714285714285,1,0.0,0,0,0,0,0,0,0,1,0,0,1,1
3189,74733,nd2ZHSI1Tvo1sLaItC7AKiAwHujqev1a,SpATywNh6bZuzm8s1ceuBUnMUAeoAHHw,10,10,0,0,0,0,1,0,11,1.5714285714285714,1,0.0,0,0,0,0,10,0,0,1,0,0,11,1
3190,74736,sgWvC8NRvYtrmKjALzTvn9SNvnbzDMjJ,SpATywNh6bZuzm8s1ceuBUnMUAeoAHHw,16,22,9,14,4,0,1,0,50,7.142857142857143,1,0.0,2,9,14,4,20,0,0,1,0,29,21,1
3191,74748,usRZSdDsUQfZaciTJTskV4NLSeP1lHRl,bWdj2GDclj5ofokWjzoa5jAwMkxCykd6,1,0,0,0,0,0,1,0,1,0.14285714285714285,1,0.0,0,0,0,0,0,0,0,1,0,0,1,1
3192,74751,KLtOKXGj6O1GoIRtB8vhhhK5KJkUm486,bWdj2GDclj5ofokWjzoa5jAwMkxCykd6,7,6,4,0,3,0,4,0,17,2.4285714285714284,1,0.0,0,4,0,3,6,0,0,4,0,7,10,0
3193,74792,DSoedfH3iEqkDSoEfnR9hPK9fGA03nvE,A3fsA9Zfv1X2fVEQhTw51lKENdNrEqT3,4,2,1,0,0,0,2,0,5,0.7142857142857143,1,0.0,0,1,0,0,2,0,0,2,0,1,4,1
3194,74801,L0e1YP7bRzjNsIzxzTyXlM0Ldh6xltNG,SpATywNh6bZuzm8s1ceuBUnMUAeoAHHw,18,38,11,18,5,0,1,0,73,10.428571428571429,1,0.0,4,11,15,5,34,0,3,1,0,35,38,0
3195,74804,W5ldkM4f1g9HIanLGU1MLQs0qq4p7MDp,SpATywNh6bZuzm8s1ceuBUnMUAeoAHHw,7,4,3,0,3,0,2,0,12,1.7142857142857142,1,0.0,0,3,0,3,4,0,0,2,0,6,6,1
3196,74830,j4PVQUrpIpKorlkT4iYTyeVfeRGmPqGp,SpATywNh6bZuzm8s1ceuBUnMUAeoAHHw,5,2,1,0,1,0,2,0,6,0.8571428571428571,1,0.0,0,1,0,1,2,0,0,2,0,2,4,1
3197,74836,lFMbkCaY0FKfyGbh1VOL30jTZ1USVgB2,G8EPVSXsOYB5YQWZGiz1aVq5Pgr2GrQu,2,1,0,0,0,0,1,0,2,0.2857142857142857,1,0.0,0,0,0,0,1,0,0,1,0,0,2,1
3198,74838,Sje8JOaJAnSqtfzZ1Y40tJOmrRNipQT0,SpATywNh6bZuzm8s1ceuBUnMUAeoAHHw,10,7,6,0,6,0,1,0,20,2.857142857142857,1,0.0,0,6,0,6,7,0,0,1,0,12,8,1
3199,74841,lFMbkCaY0FKfyGbh1VOL30jTZ1USVgB2,RXDvfPUBYFlVdlueBFbLW0mhhAyGEqpt,9,6,5,0,3,0,0,0,14,2.0,2,0.0,0,5,0,3,6,0,0,0,0,8,6,0
3200,74857,IqTYyD7L0euRgN3diEzqrprrc2W9uyF6,5X6FeZozNMgE2VRi3MJYjkkFK8SETtu2,6,5,3,0,1,0,5,0,14,2.0,2,0.0,0,3,0,1,5,0,0,5,0,4,10,0
3201,74859,y2Imh6d65IyLlUtE9DWkdIauRQxTWtdJ,bWdj2GDclj5ofokWjzoa5jAwMkxCykd6,4,2,1,0,1,0,4,0,8,1.1428571428571428,2,0.0,0,1,0,1,2,0,0,4,0,2,6,1
3202,74882,uFxbwM61ZWFC5xnxVOlmiGXCTyHmK3HX,RXDvfPUBYFlVdlueBFbLW0mhhAyGEqpt,11,12,10,0,6,0,2,0,30,4.285714285714286,1,0.0,0,10,0,6,12,0,0,2,0,16,14,1
3203,74905,x29OOChdmJGXK62DnUpwKbwJurqULmnD,G8EPVSXsOYB5YQWZGiz1aVq5Pgr2GrQu,4,2,0,0,0,0,2,0,4,0.5714285714285714,1,0.0,0,0,0,0,2,0,0,2,0,0,4,1
3204,74918,Y0dbTriNAgSzbrnkzFHfTSZPt5kDzGfo,SpATywNh6bZuzm8s1ceuBUnMUAeoAHHw,27,38,2,26,2,5,8,0,81,11.571428571428571,5,0.0,5,2,21,2,33,5,5,8,0,30,51,0
3205,74928,Jnn7sdYOabtjWgIFBUHReK25x6A3dZtZ,SpATywNh6bZuzm8s1ceuBUnMUAeoAHHw,8,5,3,0,2,0,3,0,13,1.8571428571428572,1,0.0,0,3,0,2,5,0,0,3,0,5,8,1
3206,74935,7n6VTEPIznuedo1nynk3WFAbvlKYIs72,SpATywNh6bZuzm8s1ceuBUnMUAeoAHHw,35,30,21,19,10,0,9,0,89,12.714285714285714,5,0.0,2,21,16,10,28,0,3,9,0,49,40,0
3207,74981,Oa5Z9qxxvzPY6Y4pD2DPDPqyzdKPou5A,RXDvfPUBYFlVdlueBFbLW0mhhAyGEqpt,4,2,0,0,0,0,2,0,4,0.5714285714285714,2,0.0,0,0,0,0,2,0,0,2,0,0,4,1
3208,75011,CDVTgNquYdsNoldLURSKppemY0oOGcjg,SpATywNh6bZuzm8s1ceuBUnMUAeoAHHw,13,16,0,12,0,0,3,0,31,4.428571428571429,2,0.0,2,0,11,0,14,0,1,3,0,13,18,0
3209,75046,JxLtKAnMek98G5fWpyeTaKlh0zheuNnU,A3fsA9Zfv1X2fVEQhTw51lKENdNrEqT3,11,14,7,0,4,0,4,0,29,4.142857142857143,3,0.0,0,7,0,4,14,0,0,4,0,11,18,1
3210,75054,dtbXtMjPqeEvzoZBFe2y9uSDcjL0lnx2,RXDvfPUBYFlVdlueBFbLW0mhhAyGEqpt,13,17,1,0,0,0,3,0,21,3.0,2,0.0,1,1,0,0,16,0,0,3,0,2,19,0
3211,75107,40pBsSLPvPjLL6yRnjAUeGaxtQZ4QL41,G8EPVSXsOYB5YQWZGiz1aVq5Pgr2GrQu,18,6,3,52,0,0,3,0,64,9.142857142857142,1,0.0,0,3,42,0,6,0,10,3,0,45,19,0
3212,75113,5EOGhyHOLLtbW0eEa8Dnfl5My4kdYkdc,SpATywNh6bZuzm8s1ceuBUnMUAeoAHHw,34,32,21,13,13,0,5,0,84,12.0,4,0.0,4,21,13,13,28,0,0,5,0,51,33,0
3213,75124,531vsi7OXuLQll24T9I8HukbHEYIaMhq,5X6FeZozNMgE2VRi3MJYjkkFK8SETtu2,38,115,36,0,47,0,15,2,215,30.714285714285715,6,0.0,56,36,0,47,59,0,0,15,2,139,76,1
3214,75143,KKE8q8DWecTGi2Mp6eRnxhZGGD7eG4J3,SpATywNh6bZuzm8s1ceuBUnMUAeoAHHw,18,14,9,12,5,0,3,1,44,6.285714285714286,1,0.0,4,9,12,5,10,0,0,3,1,30,14,1
3215,75154,uaT99v8EKasFxQFGqwtqtcH5x05oT3wD,A3fsA9Zfv1X2fVEQhTw51lKENdNrEqT3,39,17,12,106,9,0,3,0,147,21.0,2,0.0,3,12,95,9,14,0,11,3,0,119,28,1
3216,75171,ncmpqlY7PLQpJ9wJX1Qi5Ff2s3Hx5jkY,SpATywNh6bZuzm8s1ceuBUnMUAeoAHHw,10,9,4,0,3,0,2,0,18,2.5714285714285716,1,0.0,0,4,0,3,9,0,0,2,0,7,11,0
3217,75177,QEb4WbyR4NDG0zRGDFN1M8r5HQfWJubr,SpATywNh6bZuzm8s1ceuBUnMUAeoAHHw,2,0,0,0,0,0,2,0,2,0.2857142857142857,1,0.0,0,0,0,0,0,0,0,2,0,0,2,1
3218,75185,QlvFciinGDGt7csjDmjYPPZqFlKAzfUP,bWdj2GDclj5ofokWjzoa5jAwMkxCykd6,1,0,0,0,0,0,1,0,1,0.14285714285714285,1,0.0,0,0,0,0,0,0,0,1,0,0,1,1
3219,75188,QlvFciinGDGt7csjDmjYPPZqFlKAzfUP,G8EPVSXsOYB5YQWZGiz1aVq5Pgr2GrQu,1,0,0,0,0,0,1,0,1,0.14285714285714285,1,0.0,0,0,0,0,0,0,0,1,0,0,1,1
3220,75194,VrOVkNqg4QPgl4uZ5ris338QuHMKoadT,A3fsA9Zfv1X2fVEQhTw51lKENdNrEqT3,10,10,2,0,2,0,4,0,18,2.5714285714285716,2,0.0,0,2,0,2,10,0,0,4,0,4,14,1
3221,75195,9zNI4EpVujSV8TU9o7NY46vrkl8qX3Ys,G8EPVSXsOYB5YQWZGiz1aVq5Pgr2GrQu,12,18,6,0,4,0,7,1,36,5.142857142857143,1,0.0,10,6,0,4,8,0,0,7,1,20,16,0
3222,75202,U3LNfYcdRIeU9qhiaPG7Yg8NuZRGOnSS,A3fsA9Zfv1X2fVEQhTw51lKENdNrEqT3,1,0,0,0,0,0,2,0,2,0.2857142857142857,1,0.0,0,0,0,0,0,0,0,2,0,0,2,1
3223,75206,ZXWRS3Ah3Q3TKxtUJXxAAlsPTxzCg1Vz,SpATywNh6bZuzm8s1ceuBUnMUAeoAHHw,9,10,4,9,0,5,4,0,32,4.571428571428571,2,0.0,2,4,9,0,8,5,0,4,0,15,17,0
3224,75215,Zi4TkBqsB6TMu9rM1cOGrFhYXBZRNO2C,5X6FeZozNMgE2VRi3MJYjkkFK8SETtu2,11,15,4,12,0,0,2,0,33,4.714285714285714,2,0.0,9,4,12,0,6,0,0,2,0,25,8,1
3225,75240,UHvuo1o7uLLkfJ8EjLzALZaYP37eI8Lz,SpATywNh6bZuzm8s1ceuBUnMUAeoAHHw,14,12,0,10,0,0,3,0,25,3.5714285714285716,1,0.0,3,0,9,0,9,0,1,3,0,12,13,1
3226,75259,ssAF4hr9aUQpAUC0wxSDumowVhiC0dd4,SpATywNh6bZuzm8s1ceuBUnMUAeoAHHw,46,48,23,54,13,9,11,3,161,23.0,1,0.0,13,23,46,13,35,9,8,11,3,95,66,1
3227,75271,qVDHsjIzoOtZnTwpJtbJGpvapy4sRYpW,bWdj2GDclj5ofokWjzoa5jAwMkxCykd6,5,6,3,0,0,0,1,0,10,1.4285714285714286,1,0.0,1,3,0,0,5,0,0,1,0,4,6,1
3228,75298,9oXrBkovZPfJ4ibbiV0HjplK7CRHY8mi,SpATywNh6bZuzm8s1ceuBUnMUAeoAHHw,7,6,4,0,2,0,3,0,15,2.142857142857143,1,0.0,0,4,0,2,6,0,0,3,0,6,9,1
3229,75382,O0pFwh56sT4vz63TrFMWxlTyZHTENk1t,SpATywNh6bZuzm8s1ceuBUnMUAeoAHHw,30,40,2,29,1,33,11,0,116,16.571428571428573,5,0.0,8,2,27,1,32,33,2,11,0,38,78,0
3230,75410,qOdvQbvioEpbzeT9YpY834XPs5VGo10v,bWdj2GDclj5ofokWjzoa5jAwMkxCykd6,12,44,11,0,8,0,12,0,75,10.714285714285714,1,0.0,2,11,0,8,42,0,0,12,0,21,54,1
3231,75412,MYsCU1zkMrWxPhV1b7wSL5LZIo1zGyhU,5X6FeZozNMgE2VRi3MJYjkkFK8SETtu2,64,85,31,0,64,0,6,0,186,26.571428571428573,5,0.0,48,31,0,64,37,0,0,6,0,143,43,0
3232,75439,wQLt542srbWeB4HTlvAdzx5vfYyzvgLZ,SpATywNh6bZuzm8s1ceuBUnMUAeoAHHw,1,0,0,0,0,0,1,0,1,0.14285714285714285,1,0.0,0,0,0,0,0,0,0,1,0,0,1,1
3233,75496,Sp10s5NIaBhXFj443MxH6F0GWEmP333T,G8EPVSXsOYB5YQWZGiz1aVq5Pgr2GrQu,7,2,1,0,1,1,4,1,10,1.4285714285714286,1,0.0,0,1,0,1,2,1,0,4,1,2,8,1
3234,75508,RHl3DsvAX7TisJ7qBptmgrrtDAQvH7mr,bWdj2GDclj5ofokWjzoa5jAwMkxCykd6,3,2,1,0,0,0,1,0,4,0.5714285714285714,1,0.0,0,1,0,0,2,0,0,1,0,1,3,1
3235,75509,Y7Pi7uKjChwCBFftO7ZsD2oE8A4VzjzU,A3fsA9Zfv1X2fVEQhTw51lKENdNrEqT3,9,4,3,0,3,3,4,0,17,2.4285714285714284,1,0.0,0,3,0,3,4,3,0,4,0,6,11,1
3236,75557,514TWhkGGUhLu2MdvTnb8eiBH3DCFHzg,SpATywNh6bZuzm8s1ceuBUnMUAeoAHHw,11,12,7,0,3,0,3,0,25,3.5714285714285716,2,0.0,0,7,0,3,12,0,0,3,0,10,15,0
3237,75565,A8uNxAeXRi6PUyfK3nbO106vNrsfyDAv,SpATywNh6bZuzm8s1ceuBUnMUAeoAHHw,6,4,1,0,0,0,2,0,7,1.0,1,0.0,0,1,0,0,4,0,0,2,0,1,6,0
3238,75573,vBRB2wzjfLfTulqF3dU7hDmET3IzOawt,bWdj2GDclj5ofokWjzoa5jAwMkxCykd6,10,2,1,18,1,3,6,1,32,4.571428571428571,2,0.0,1,1,18,1,1,3,0,6,1,21,11,1
3239,75589,TMHqfvRh4sdR4QsSw1ieP3y9mhiCGpqQ,SpATywNh6bZuzm8s1ceuBUnMUAeoAHHw,8,7,0,6,0,0,1,0,14,2.0,2,0.0,0,0,5,0,7,0,1,1,0,5,9,1
3240,75599,yBKc8UQ3yoU6nYnfaJz62fH80CgKFtOX,SpATywNh6bZuzm8s1ceuBUnMUAeoAHHw,20,20,13,18,8,0,8,0,67,9.571428571428571,2,0.0,2,13,15,8,18,0,3,8,0,38,29,0
3241,75611,24ovPvI68P1C2dGG4gkqfUxBKf1IL89V,SpATywNh6bZuzm8s1ceuBUnMUAeoAHHw,11,21,9,0,6,0,7,2,45,6.428571428571429,2,0.0,0,9,0,6,21,0,0,7,2,15,30,1
3242,75619,qwKwEhJ5oWm5TB1Q6emluPsrjHPCR2z1,SpATywNh6bZuzm8s1ceuBUnMUAeoAHHw,14,16,10,0,5,0,3,0,34,4.857142857142857,1,0.0,0,10,0,5,16,0,0,3,0,15,19,1
3243,75648,XHMa1LBfQu91lFwoLLSBhVEMIFmosCzB,SpATywNh6bZuzm8s1ceuBUnMUAeoAHHw,1,0,0,0,0,1,0,0,1,0.14285714285714285,1,0.0,0,0,0,0,0,1,0,0,0,0,1,1
3244,75651,RhmWa0TYSXDmOaY5G85GAKnAuCxk1qKo,SpATywNh6bZuzm8s1ceuBUnMUAeoAHHw,4,3,0,0,0,0,2,0,5,0.7142857142857143,1,0.0,1,0,0,0,2,0,0,2,0,1,4,1
3245,75671,dMFoSIxUWk2fcxfoWi4OaQOdeGkifmCW,SpATywNh6bZuzm8s1ceuBUnMUAeoAHHw,5,3,1,0,1,0,4,1,10,1.4285714285714286,1,0.0,0,1,0,1,3,0,0,4,1,2,8,1
3246,75673,I6LvRAT5lrglfRc7HjtOiHjECPtrYMcD,SpATywNh6bZuzm8s1ceuBUnMUAeoAHHw,23,25,10,4,7,0,5,0,51,7.285714285714286,3,0.0,0,10,4,7,25,0,0,5,0,21,30,1
3247,75688,69sBnrnn4yw4d4R753Fg9iMe8dCubVq5,SpATywNh6bZuzm8s1ceuBUnMUAeoAHHw,1,0,0,0,0,2,0,0,2,0.2857142857142857,1,0.0,0,0,0,0,0,2,0,0,0,0,2,1
3248,75699,88AD1l4wNMBju3FfWmP2xvwRYAECtTFg,A3fsA9Zfv1X2fVEQhTw51lKENdNrEqT3,12,14,10,0,8,0,3,0,35,5.0,2,0.0,1,10,0,8,13,0,0,3,0,19,16,1
3249,75741,3x63reHnPUEpxvneROppT18TTVHKvgH3,bWdj2GDclj5ofokWjzoa5jAwMkxCykd6,9,10,5,0,2,0,2,0,19,2.7142857142857144,1,0.0,0,5,0,2,10,0,0,2,0,7,12,1
3250,75756,K6L1htYb2XLFpKYYjszwZ8APtHLo7llK,A3fsA9Zfv1X2fVEQhTw51lKENdNrEqT3,10,6,2,0,2,0,12,0,22,3.142857142857143,1,0.0,0,2,0,2,6,0,0,12,0,4,18,0
3251,75792,dhPF0MOUpHT5OZTFAONgRdkH1ZwnZtFz,SpATywNh6bZuzm8s1ceuBUnMUAeoAHHw,32,27,20,32,17,0,7,0,103,14.714285714285714,3,0.0,4,20,28,17,23,0,4,7,0,69,34,0
3252,75794,1e18v1lfFGXUg6bMvYW1VQwzbnQ49fgM,RXDvfPUBYFlVdlueBFbLW0mhhAyGEqpt,57,49,27,94,23,0,3,0,196,28.0,2,0.0,19,27,90,23,30,0,4,3,0,159,37,0
3253,75797,IvlwoG4PXINReT5X8sWXharZr5MVyyC3,SpATywNh6bZuzm8s1ceuBUnMUAeoAHHw,1,0,0,0,0,0,3,0,3,0.42857142857142855,1,0.0,0,0,0,0,0,0,0,3,0,0,3,1
3254,75811,rtqeFROD6qkcnco9ZNqDeOxQ39FXT7YO,5X6FeZozNMgE2VRi3MJYjkkFK8SETtu2,8,5,2,0,2,0,1,0,10,1.4285714285714286,1,0.0,0,2,0,2,5,0,0,1,0,4,6,1
3255,75819,q7Qa5My2QzcPtmlYo4s3YA0ocpkv6szX,SpATywNh6bZuzm8s1ceuBUnMUAeoAHHw,4,2,1,0,1,0,2,0,6,0.8571428571428571,1,0.0,0,1,0,1,2,0,0,2,0,2,4,1
3256,75832,kXWvTXCpsmsgWxo8yHGfBfacmUg5iCPe,A3fsA9Zfv1X2fVEQhTw51lKENdNrEqT3,21,10,7,54,4,0,8,1,84,12.0,1,0.0,2,7,46,4,8,0,8,8,1,59,25,1
3257,75833,BIODZjcB7SHUrj4P9eqU1KvIgG0hvgIb,5X6FeZozNMgE2VRi3MJYjkkFK8SETtu2,7,5,2,0,1,0,4,0,12,1.7142857142857142,1,0.0,0,2,0,1,5,0,0,4,0,3,9,1
3258,75835,MhPFQAgWNzlZ6Teq1DlKr26Z8E6wW1AP,SpATywNh6bZuzm8s1ceuBUnMUAeoAHHw,5,3,1,0,1,0,1,0,6,0.8571428571428571,1,0.0,0,1,0,1,3,0,0,1,0,2,4,1
3259,75911,vuslHI1UxdeXKs1vDUvKXYQqg3X9k91E,bWdj2GDclj5ofokWjzoa5jAwMkxCykd6,7,5,3,0,0,0,5,0,13,1.8571428571428572,1,0.0,0,3,0,0,5,0,0,5,0,3,10,1
3260,75913,9Z0HPERi08W8BXnB1twUjHrPBLbHzKgR,SpATywNh6bZuzm8s1ceuBUnMUAeoAHHw,5,2,1,0,1,0,2,0,6,0.8571428571428571,1,0.0,0,1,0,1,2,0,0,2,0,2,4,1
3261,75914,HF98YPKzT8oi2j9flZW9kstZcvL3ZimG,5X6FeZozNMgE2VRi3MJYjkkFK8SETtu2,47,141,31,79,24,0,5,0,280,40.0,3,0.0,39,31,62,24,102,0,17,5,0,156,124,0
3262,75915,TfNQptQajWTQqzlzDAn72SRQxELYzNd4,bWdj2GDclj5ofokWjzoa5jAwMkxCykd6,1,0,0,0,0,0,1,0,1,0.14285714285714285,1,0.0,0,0,0,0,0,0,0,1,0,0,1,0
3263,75921,uCB5uEbohrhji79dydXW4G40PBAqm3fB,SpATywNh6bZuzm8s1ceuBUnMUAeoAHHw,4,2,1,0,1,0,1,0,5,0.7142857142857143,1,0.0,0,1,0,1,2,0,0,1,0,2,3,1
3264,75925,ADzA6LTxD4Ild5QEYX1CEp1PkDr0ZeEm,SpATywNh6bZuzm8s1ceuBUnMUAeoAHHw,2,0,0,0,0,0,2,0,2,0.2857142857142857,1,0.0,0,0,0,0,0,0,0,2,0,0,2,1
3265,75943,vcUiIaz3mBJL4s6AIIwTtvU1UwMpvaHI,A3fsA9Zfv1X2fVEQhTw51lKENdNrEqT3,6,3,0,0,0,0,3,2,8,1.1428571428571428,1,0.0,0,0,0,0,3,0,0,3,2,0,8,1
3266,75950,vRfp4R3Ka5ikFbaOY5bQDke3cTfTq6Oz,RXDvfPUBYFlVdlueBFbLW0mhhAyGEqpt,16,32,3,0,3,2,5,0,45,6.428571428571429,2,0.0,0,3,0,3,32,2,0,5,0,6,39,0
3267,75955,m1ZHf0Vy9SZyKEONoAW39ljflZCTH7Li,bWdj2GDclj5ofokWjzoa5jAwMkxCykd6,10,8,5,0,3,2,5,0,23,3.2857142857142856,1,0.0,0,5,0,3,8,2,0,5,0,8,15,1
3268,75969,8Dno8ERd119JayTOKlG7uDmGtkfLJOke,SpATywNh6bZuzm8s1ceuBUnMUAeoAHHw,1,0,0,0,0,0,1,0,1,0.14285714285714285,1,0.0,0,0,0,0,0,0,0,1,0,0,1,0
3269,75980,mDHr8WvVVX9KSvXMqxtLvZ6vP4uuNF6E,A3fsA9Zfv1X2fVEQhTw51lKENdNrEqT3,1,0,0,0,0,0,1,0,1,0.14285714285714285,1,0.0,0,0,0,0,0,0,0,1,0,0,1,1
3270,76007,ttoFK5oOPrxtfVxJpGPFCiEs8J6AbuAg,5X6FeZozNMgE2VRi3MJYjkkFK8SETtu2,22,47,7,20,10,1,16,0,101,14.428571428571429,7,0.0,12,7,17,10,35,1,3,16,0,46,55,0
3271,76037,tRnGjKGiLuFimS9EZkzjSZra5GMl2o1g,SpATywNh6bZuzm8s1ceuBUnMUAeoAHHw,3,0,0,0,0,0,3,0,3,0.42857142857142855,1,0.0,0,0,0,0,0,0,0,3,0,0,3,1
3272,76038,6RuWsSvS3Ngnjl37PzNAaaGn8Jd9a1lW,bWdj2GDclj5ofokWjzoa5jAwMkxCykd6,11,10,1,0,1,0,2,0,14,2.0,1,0.0,0,1,0,1,10,0,0,2,0,2,12,0
3273,76056,XN63dEiQWhNWbJsINnN40CVdwEcsGjr2,SpATywNh6bZuzm8s1ceuBUnMUAeoAHHw,13,17,10,0,4,0,10,0,41,5.857142857142857,2,0.0,0,10,0,4,17,0,0,10,0,14,27,0
3274,76062,uS20ZmLoHmLQWbUhtUHWfWagVEF63NYz,bWdj2GDclj5ofokWjzoa5jAwMkxCykd6,6,2,1,0,1,0,4,0,8,1.1428571428571428,1,0.0,0,1,0,1,2,0,0,4,0,2,6,1
3275,76081,7Xbcyzr5w9UbFD6viSl5LziGgJLlGTSQ,bWdj2GDclj5ofokWjzoa5jAwMkxCykd6,15,8,1,46,3,0,2,0,60,8.571428571428571,1,0.0,2,1,46,3,6,0,0,2,0,52,8,1
3276,76084,guWBfmwWMYvgsjzJYUwSED8H7qksX2UV,SpATywNh6bZuzm8s1ceuBUnMUAeoAHHw,4,2,1,0,0,0,2,0,5,0.7142857142857143,1,0.0,0,1,0,0,2,0,0,2,0,1,4,1
3277,76090,Rqbm8kzAkzPtCEeD6EKvXOVzxPg0CACh,A3fsA9Zfv1X2fVEQhTw51lKENdNrEqT3,2,0,0,0,0,0,2,0,2,0.2857142857142857,1,0.0,0,0,0,0,0,0,0,2,0,0,2,1
3278,76095,Ok3OwUFvWjyWfSr7mibP3P1PetaYX4Au,5X6FeZozNMgE2VRi3MJYjkkFK8SETtu2,6,3,2,0,2,0,1,0,8,1.1428571428571428,1,0.0,0,2,0,2,3,0,0,1,0,4,4,1
3279,76132,BPj9vbHlIMSVYvgR55UNazxp9lZNYkPR,5X6FeZozNMgE2VRi3MJYjkkFK8SETtu2,6,4,2,0,1,0,2,0,9,1.2857142857142858,1,0.0,1,2,0,1,3,0,0,2,0,4,5,1
3280,76140,Bn7S5b6FwWRas4u7d1h2YD3tnpE2VYTv,A3fsA9Zfv1X2fVEQhTw51lKENdNrEqT3,4,2,0,0,0,0,2,0,4,0.5714285714285714,1,0.0,0,0,0,0,2,0,0,2,0,0,4,1
3281,76152,GLC3kBoUw2roKtv7ldNh1bz31DGBmr9Y,bWdj2GDclj5ofokWjzoa5jAwMkxCykd6,2,0,0,0,0,0,2,0,2,0.2857142857142857,1,0.0,0,0,0,0,0,0,0,2,0,0,2,1
3282,76156,iJpmOShuYA1JTXBfbyoGmjolTr8PtDht,SpATywNh6bZuzm8s1ceuBUnMUAeoAHHw,1,0,0,0,0,0,1,0,1,0.14285714285714285,1,0.0,0,0,0,0,0,0,0,1,0,0,1,1
3283,76197,509hMngiUm6zrKoE3SecqGuN8tx0I6r6,5X6FeZozNMgE2VRi3MJYjkkFK8SETtu2,1,0,0,0,0,0,1,0,1,0.14285714285714285,1,0.0,0,0,0,0,0,0,0,1,0,0,1,1
3284,76200,sDXyFyXccb2aUhA7HkeYGp29lIhqBqSo,G8EPVSXsOYB5YQWZGiz1aVq5Pgr2GrQu,6,1,1,0,1,0,3,0,6,0.8571428571428571,1,0.0,0,1,0,1,1,0,0,3,0,2,4,1
3285,76204,4J0kxAUfVeKtOX3m9APp3FIJE103B8gP,A3fsA9Zfv1X2fVEQhTw51lKENdNrEqT3,1,0,0,0,0,0,1,0,1,0.14285714285714285,1,0.0,0,0,0,0,0,0,0,1,0,0,1,1
3286,76219,PrDfsHArpCrtmsMMMZhp4he169gdCY7N,SpATywNh6bZuzm8s1ceuBUnMUAeoAHHw,1,0,0,0,0,0,1,0,1,0.14285714285714285,1,0.0,0,0,0,0,0,0,0,1,0,0,1,1
3287,76238,FYdTGqTHtRATfo802agJiucYRW9Mfn1L,RXDvfPUBYFlVdlueBFbLW0mhhAyGEqpt,11,12,1,0,2,0,1,0,16,2.2857142857142856,1,0.0,2,1,0,2,10,0,0,1,0,5,11,1
3288,76247,FYdTGqTHtRATfo802agJiucYRW9Mfn1L,A3fsA9Zfv1X2fVEQhTw51lKENdNrEqT3,1,0,0,0,0,0,1,0,1,0.14285714285714285,1,0.0,0,0,0,0,0,0,0,1,0,0,1,1
3289,76252,BCPhbcVTukJPsOtUJJbyOWvpso8GiEV1,A3fsA9Zfv1X2fVEQhTw51lKENdNrEqT3,9,4,2,0,1,0,4,0,11,1.5714285714285714,1,0.0,0,2,0,1,4,0,0,4,0,3,8,1
3290,76261,wzJUcvl4LpGNAis186Xl9ztjI1WNWkac,bWdj2GDclj5ofokWjzoa5jAwMkxCykd6,2,0,0,0,0,0,2,0,2,0.2857142857142857,1,0.0,0,0,0,0,0,0,0,2,0,0,2,1
3291,76307,59KrgCJlOEHQHzBNjsHoSd6BkQVArDrc,bWdj2GDclj5ofokWjzoa5jAwMkxCykd6,7,6,4,0,2,0,4,0,16,2.2857142857142856,2,0.0,0,4,0,2,6,0,0,4,0,6,10,1
3292,76314,0htS0wNp12VQ7YgJ628sRK5TB1tJHlRO,7GRhBDsirIGkRZBtSMEzNTyDr2JQm4xx,1,0,0,0,0,0,1,0,1,0.14285714285714285,1,0.0,0,0,0,0,0,0,0,1,0,0,1,1
3293,76317,E9EDiL5FdsaYLmbLpW4Gm4jZTeooFwDr,7GRhBDsirIGkRZBtSMEzNTyDr2JQm4xx,1,0,0,0,0,0,1,0,1,0.14285714285714285,1,0.0,0,0,0,0,0,0,0,1,0,0,1,1
3294,76321,1GdR4GHc7WTO0QsI1Bs0LMr9EaBXC7so,7GRhBDsirIGkRZBtSMEzNTyDr2JQm4xx,3,0,0,0,0,0,5,0,5,0.7142857142857143,1,0.0,0,0,0,0,0,0,0,5,0,0,5,1
3295,76330,uGMYI14ArIwBL21cXHEeuuGvmctFBZzg,7GRhBDsirIGkRZBtSMEzNTyDr2JQm4xx,1,0,0,0,0,0,1,0,1,0.14285714285714285,1,0.0,0,0,0,0,0,0,0,1,0,0,1,1
3296,76339,1QZw8OliUS350g6ycU0wsVijkhxnDnRS,7GRhBDsirIGkRZBtSMEzNTyDr2JQm4xx,1,0,0,0,0,0,1,0,1,0.14285714285714285,1,0.0,0,0,0,0,0,0,0,1,0,0,1,1
3297,76345,wUp74pHXepx3D052YhA66zL4rpbyPwEw,7GRhBDsirIGkRZBtSMEzNTyDr2JQm4xx,4,3,1,0,1,0,1,0,6,0.8571428571428571,1,0.0,0,1,0,1,3,0,0,1,0,2,4,1
3298,76370,LjHLegep3fnzz3EMIdyj4iJ3mzoK4FmA,7GRhBDsirIGkRZBtSMEzNTyDr2JQm4xx,15,11,6,0,5,0,6,0,28,4.0,3,0.0,2,6,0,5,9,0,0,6,0,13,15,1
3299,76374,DsHgWZRTJ1y1l15smwhB78ZQq3d8dyKP,7GRhBDsirIGkRZBtSMEzNTyDr2JQm4xx,1,0,0,0,0,0,2,0,2,0.2857142857142857,1,0.0,0,0,0,0,0,0,0,2,0,0,2,1
3300,76387,0BEjwSez7vKiynnyukTltmd8Na9BnWzy,5Gyp41oLVo7Gg7vF4vpmggWP5MU70QO6,1,0,0,0,0,0,1,0,1,0.14285714285714285,1,0.0,0,0,0,0,0,0,0,1,0,0,1,1
3301,76391,HQ6Oij7snrzV4x54wZo5vjyO2QZb8Y0Z,5Gyp41oLVo7Gg7vF4vpmggWP5MU70QO6,5,4,1,0,1,0,1,0,7,1.0,1,0.0,0,1,0,1,4,0,0,1,0,2,5,1
3302,76458,tb9QbEZD9qc7nDQo9yLy9jGuyLWLODk7,5Gyp41oLVo7Gg7vF4vpmggWP5MU70QO6,24,85,34,37,0,55,20,1,232,33.142857142857146,5,0.0,34,34,22,0,51,55,15,20,1,90,142,0
3303,76482,e3FZ4cy0BMFRPYHEGpC2DZzHOCgKNd5m,5Gyp41oLVo7Gg7vF4vpmggWP5MU70QO6,20,44,23,22,10,14,6,1,120,17.142857142857142,3,0.0,11,23,11,10,33,14,11,6,1,55,65,0
3304,76550,OQhykRRofImPS0jiCYxNywc0tLc7ikaM,5Gyp41oLVo7Gg7vF4vpmggWP5MU70QO6,6,4,2,0,2,0,1,0,9,1.2857142857142858,1,0.0,0,2,0,2,4,0,0,1,0,4,5,1
3305,76583,Hnsg2RdEy94EzQKO2WfhQn1bhDkIZpuP,5Gyp41oLVo7Gg7vF4vpmggWP5MU70QO6,19,43,16,2,14,0,9,0,84,12.0,5,0.0,17,16,1,14,26,0,1,9,0,48,36,0
3306,76593,8paXbOE4gObsOIM9rBBbCsc1bMlzuvtH,5Gyp41oLVo7Gg7vF4vpmggWP5MU70QO6,16,21,12,4,3,0,4,0,44,6.285714285714286,1,0.0,5,12,2,3,16,0,2,4,0,22,22,1
3307,76596,Nw53y0bWjQvb2zl999IyNN2G9MT9XOop,5Gyp41oLVo7Gg7vF4vpmggWP5MU70QO6,11,15,5,10,3,5,3,0,41,5.857142857142857,1,0.0,6,5,5,3,9,5,5,3,0,19,22,1
3308,76613,WbXBGjs8sOcGx4CLMFMe3JyADMNhLK2e,5Gyp41oLVo7Gg7vF4vpmggWP5MU70QO6,11,6,3,0,1,0,8,1,19,2.7142857142857144,1,0.0,0,3,0,1,6,0,0,8,1,4,15,0
3309,76640,FHXNJ1i7fXBkpQ5rOJBQER41F3GL5sKV,5Gyp41oLVo7Gg7vF4vpmggWP5MU70QO6,17,69,28,4,10,19,22,0,152,21.714285714285715,8,0.0,16,28,3,10,53,19,1,22,0,57,95,0
3310,76642,47uToBKcQtCVF2p3hcnSb3h9oSt1ZhSG,5Gyp41oLVo7Gg7vF4vpmggWP5MU70QO6,7,4,1,0,1,1,3,1,11,1.5714285714285714,1,0.0,0,1,0,1,4,1,0,3,1,2,9,1
3311,76647,1gk6fKIXti5rzjyDgWxKhuedyICV0p5X,5Gyp41oLVo7Gg7vF4vpmggWP5MU70QO6,12,11,5,4,2,1,8,2,33,4.714285714285714,2,0.0,4,5,2,2,7,1,2,8,2,13,20,1
3312,76665,Nr4xgaqWlp3GY7Luca1HZwWSVTgxpORh,5Gyp41oLVo7Gg7vF4vpmggWP5MU70QO6,24,39,17,30,5,14,10,1,116,16.571428571428573,3,0.0,16,17,15,5,23,14,15,10,1,53,63,0
3313,76682,V2erUkv5vzN8XdSa2UBX4Q5nQZ4WhwfM,5Gyp41oLVo7Gg7vF4vpmggWP5MU70QO6,7,3,2,0,2,0,2,0,9,1.2857142857142858,1,0.0,0,2,0,2,3,0,0,2,0,4,5,1
3314,76702,nj1PuY2gDNPPcTJQ2NAceOcYKhH7fwXk,5Gyp41oLVo7Gg7vF4vpmggWP5MU70QO6,13,11,6,8,1,0,4,0,30,4.285714285714286,2,0.0,1,6,4,1,10,0,4,4,0,12,18,1
3315,76753,alnogGpZqhBWQHh6ZLeZUIXk896ksLOu,5Gyp41oLVo7Gg7vF4vpmggWP5MU70QO6,1,0,0,0,0,0,2,0,2,0.2857142857142857,2,0.0,0,0,0,0,0,0,0,2,0,0,2,1
3316,76774,ytL2gjGFWHT8Kt6MdY9ZHORs13f68L7a,5Gyp41oLVo7Gg7vF4vpmggWP5MU70QO6,25,96,32,6,3,21,11,3,172,24.571428571428573,2,0.0,23,32,3,3,73,21,3,11,3,61,111,1
3317,76803,ifp0kFKVEjabvSUFUy1aEpz5TmZrm8tB,5Gyp41oLVo7Gg7vF4vpmggWP5MU70QO6,18,33,17,0,9,0,15,0,74,10.571428571428571,4,0.0,3,17,0,9,30,0,0,15,0,29,45,0
3318,76820,m0VKHGN6a79sZImpQa7H4uF4wJYbxAYi,5Gyp41oLVo7Gg7vF4vpmggWP5MU70QO6,1,0,0,0,0,0,1,0,1,0.14285714285714285,1,0.0,0,0,0,0,0,0,0,1,0,0,1,1
3319,76872,Jv27viGuUxRFb9UWcE6lp57hLy6cCG7A,5Gyp41oLVo7Gg7vF4vpmggWP5MU70QO6,19,20,13,12,5,1,8,1,60,8.571428571428571,2,0.0,3,13,6,5,17,1,6,8,1,27,33,1
3320,76879,wKAdhm3Zap3PKniBFWpslE0VTdwM0zmM,5Gyp41oLVo7Gg7vF4vpmggWP5MU70QO6,5,2,1,0,1,0,2,0,6,0.8571428571428571,1,0.0,0,1,0,1,2,0,0,2,0,2,4,1
3321,76883,NzOkvZmnsBJyJ2xXTHp6VjlL2eW3yjsX,5Gyp41oLVo7Gg7vF4vpmggWP5MU70QO6,13,17,8,0,1,0,6,0,32,4.571428571428571,3,0.0,0,8,0,1,17,0,0,6,0,9,23,1
3322,77126,qg6GOCuPcDwehPMMAEed7GZuAdyiaV9B,7GRhBDsirIGkRZBtSMEzNTyDr2JQm4xx,11,19,1,2,1,0,6,0,29,4.142857142857143,2,0.0,1,1,1,1,18,0,1,6,0,4,25,1
3323,77249,u9jaziCv45aKAk6eSyae9cCaWxg1Ifs1,5Gyp41oLVo7Gg7vF4vpmggWP5MU70QO6,1,0,0,0,0,0,1,0,1,0.14285714285714285,1,0.0,0,0,0,0,0,0,0,1,0,0,1,1
3324,77261,LdWHb8FNIpHWtvU3SK0SLgspyLdHqtIM,5Gyp41oLVo7Gg7vF4vpmggWP5MU70QO6,5,2,1,0,1,0,2,0,6,0.8571428571428571,1,0.0,0,1,0,1,2,0,0,2,0,2,4,1
3325,77277,aHRdc7lsBBp8F9aMkgntONfsLpIf0i6y,fbPkOYLVPtPgIt0MxizjfFJov3JbHyAi,1,0,0,0,0,0,1,0,1,0.14285714285714285,1,0.0,0,0,0,0,0,0,0,1,0,0,1,1
3326,77278,y7yLjFt2yMwjL5qqPUFP5MHo49CCR80j,fbPkOYLVPtPgIt0MxizjfFJov3JbHyAi,27,18,9,34,7,3,6,0,77,11.0,1,0.0,8,9,29,7,10,3,5,6,0,53,24,0
3327,77281,5oCzuebE5sOiXyHq7QSKzWptS8CHUxep,fbPkOYLVPtPgIt0MxizjfFJov3JbHyAi,9,6,3,0,3,0,2,0,14,2.0,1,0.0,2,3,0,3,4,0,0,2,0,8,6,0
3328,77282,W4naaQuAv3aawg9lsjDcMFTQoI118ZQn,fbPkOYLVPtPgIt0MxizjfFJov3JbHyAi,1,0,0,0,0,0,1,0,1,0.14285714285714285,1,0.0,0,0,0,0,0,0,0,1,0,0,1,1
3329,77283,XDPvGyFLLEYwbNEQik2MM4yiADs5rrYJ,fbPkOYLVPtPgIt0MxizjfFJov3JbHyAi,23,38,22,10,12,0,4,0,86,12.285714285714286,2,0.0,11,22,9,12,27,0,1,4,0,54,32,0
3330,77285,BH3sq4av71sodHdOzBwY6UiwkUVXYWOx,fbPkOYLVPtPgIt0MxizjfFJov3JbHyAi,8,7,3,0,2,0,3,0,15,2.142857142857143,1,0.0,0,3,0,2,7,0,0,3,0,5,10,1
3331,77287,FCXkOVtASvwM4OqelAOjh7n6TzPCCzLb,fbPkOYLVPtPgIt0MxizjfFJov3JbHyAi,1,0,0,0,0,0,1,0,1,0.14285714285714285,1,0.0,0,0,0,0,0,0,0,1,0,0,1,1
3332,77288,p8VqUZMwo4dVi11PeKi9f5Uakn25Nqf5,fbPkOYLVPtPgIt0MxizjfFJov3JbHyAi,8,6,2,4,2,0,2,0,16,2.2857142857142856,1,0.0,1,2,4,2,5,0,0,2,0,9,7,0
3333,77289,OcFLLEI56U80V98vNeJ7LrlE5FWxkkpp,fbPkOYLVPtPgIt0MxizjfFJov3JbHyAi,9,8,3,0,2,0,3,0,16,2.2857142857142856,1,0.0,0,3,0,2,8,0,0,3,0,5,11,1
3334,77291,lQduia23vRF72bXB1H9gO7pdoAy9qGnz,fbPkOYLVPtPgIt0MxizjfFJov3JbHyAi,5,2,1,0,1,0,2,0,6,0.8571428571428571,1,0.0,0,1,0,1,2,0,0,2,0,2,4,1
3335,77294,YFQErQbDsOlFAlTBuFeWAKVDvvEvYguk,fbPkOYLVPtPgIt0MxizjfFJov3JbHyAi,9,4,3,0,3,0,6,0,16,2.2857142857142856,1,0.0,0,3,0,3,4,0,0,6,0,6,10,0
3336,77297,q59kWYGMUTfJqmsqtRwBMfXE68tP6L48,fbPkOYLVPtPgIt0MxizjfFJov3JbHyAi,1,0,0,0,0,0,1,0,1,0.14285714285714285,1,0.0,0,0,0,0,0,0,0,1,0,0,1,1
3337,77298,OWM7Ktiez7wU7sodg9xzACIp4wv3kCc5,fbPkOYLVPtPgIt0MxizjfFJov3JbHyAi,5,2,1,0,1,0,2,0,6,0.8571428571428571,1,0.0,0,1,0,1,2,0,0,2,0,2,4,1
3338,77301,kcJYaSG2iDHPRMbR56Fp0LwYxyzgRAMf,fbPkOYLVPtPgIt0MxizjfFJov3JbHyAi,5,4,2,0,2,0,2,0,10,1.4285714285714286,1,0.0,0,2,0,2,4,0,0,2,0,4,6,1
3339,77302,KRi80h1uK84snC5HvtQKWlsjwt9i3oa5,fbPkOYLVPtPgIt0MxizjfFJov3JbHyAi,14,12,8,4,6,0,3,0,33,4.714285714285714,2,0.0,2,8,4,6,10,0,0,3,0,20,13,1
3340,77303,Hh6CQ9eQF89j5a5Oi2NUf2uAs2DZd4QT,fbPkOYLVPtPgIt0MxizjfFJov3JbHyAi,5,2,1,0,1,0,2,0,6,0.8571428571428571,1,0.0,0,1,0,1,2,0,0,2,0,2,4,0
3341,77308,7QxUkfg7QVTBIqdfOWyDlZ5XM4HOAGBi,fbPkOYLVPtPgIt0MxizjfFJov3JbHyAi,1,0,0,0,0,0,1,0,1,0.14285714285714285,1,0.0,0,0,0,0,0,0,0,1,0,0,1,1
3342,77309,mzUp1IeYnFf8cMiU7U7STGbGqEYTJKv7,fbPkOYLVPtPgIt0MxizjfFJov3JbHyAi,8,3,2,0,2,0,3,0,10,1.4285714285714286,1,0.0,0,2,0,2,3,0,0,3,0,4,6,1
3343,77850,embp7e5rTedl4SQPXvv0NKkthNGlazF4,SpATywNh6bZuzm8s1ceuBUnMUAeoAHHw,23,53,22,12,14,9,21,6,137,19.571428571428573,4,0.0,6,22,11,14,47,9,1,21,6,53,84,0
3344,77866,oTQ81PqeruuETb6SukxAp0sOazRUpE32,5X6FeZozNMgE2VRi3MJYjkkFK8SETtu2,1,0,0,0,0,0,1,0,1,0.14285714285714285,1,0.0,0,0,0,0,0,0,0,1,0,0,1,1
3345,77948,HAqiq102XDB03bRDdmGODD1MUBTXSItL,G8EPVSXsOYB5YQWZGiz1aVq5Pgr2GrQu,5,4,2,0,1,0,1,0,8,1.1428571428571428,1,0.0,0,2,0,1,4,0,0,1,0,3,5,1
3346,78031,6eF1373FWTXebI6SSmAHBYvERI9OPpVD,5X6FeZozNMgE2VRi3MJYjkkFK8SETtu2,4,2,1,0,0,0,6,0,9,1.2857142857142858,3,0.0,0,1,0,0,2,0,0,6,0,1,8,1
3347,78106,hu8eak1Xmf8voE8pnxPzkSD2dZP9Sipf,bWdj2GDclj5ofokWjzoa5jAwMkxCykd6,2,0,0,0,0,0,7,0,7,1.0,3,0.0,0,0,0,0,0,0,0,7,0,0,7,0
3348,78134,CNb0Sul2DOkX3VhMOeM6DWqvlrGgHagf,SpATywNh6bZuzm8s1ceuBUnMUAeoAHHw,18,24,11,14,7,0,1,0,57,8.142857142857142,1,0.0,5,11,12,7,19,0,2,1,0,35,22,1
3349,78171,wMCI1PhSc7dgaQ1Qp894BNH0MKlDhGE0,5X6FeZozNMgE2VRi3MJYjkkFK8SETtu2,1,0,0,0,0,0,1,0,1,0.14285714285714285,1,0.0,0,0,0,0,0,0,0,1,0,0,1,1
3350,78188,CNb0Sul2DOkX3VhMOeM6DWqvlrGgHagf,bWdj2GDclj5ofokWjzoa5jAwMkxCykd6,5,4,3,0,2,10,1,0,20,2.857142857142857,1,0.0,0,3,0,2,4,10,0,1,0,5,15,1
3351,78326,VhJqWY1s8NggIUb1uIcah3mgkAeL4PFu,5X6FeZozNMgE2VRi3MJYjkkFK8SETtu2,1,0,0,0,0,0,1,0,1,0.14285714285714285,1,0.0,0,0,0,0,0,0,0,1,0,0,1,0
3352,78349,EfoxsYvaiqTPtWZL7NNMHTBPpoZQt5UK,5X6FeZozNMgE2VRi3MJYjkkFK8SETtu2,1,0,0,0,0,0,1,0,1,0.14285714285714285,1,0.0,0,0,0,0,0,0,0,1,0,0,1,1
3353,78367,DC7ZPAOAq4kNVVbfZX7lyJLqoL2DWXgr,SpATywNh6bZuzm8s1ceuBUnMUAeoAHHw,5,5,3,0,2,0,1,0,11,1.5714285714285714,1,0.0,0,3,0,2,5,0,0,1,0,5,6,1
3354,78369,0IbJQ4JZw38po4OGlmKDFjW0GOhUHJWw,5X6FeZozNMgE2VRi3MJYjkkFK8SETtu2,4,3,1,0,0,0,3,0,7,1.0,1,0.0,0,1,0,0,3,0,0,3,0,1,6,1
3355,78377,prctO66liDrlGVTKAk1UIHOjT2rY6cZg,5X6FeZozNMgE2VRi3MJYjkkFK8SETtu2,9,8,2,11,4,0,3,0,28,4.0,2,0.0,5,2,9,4,3,0,2,3,0,20,8,1
3356,78417,IA94V4Giz1ScEF7hFgZ0OnUwltaLmI18,5X6FeZozNMgE2VRi3MJYjkkFK8SETtu2,4,9,3,0,0,0,4,0,16,2.2857142857142856,3,0.0,0,3,0,0,9,0,0,4,0,3,13,1
3357,78429,HLfj9ZxtIK3gYbcHFCAqaNCGqWLq7h1g,SpATywNh6bZuzm8s1ceuBUnMUAeoAHHw,12,17,1,9,0,0,0,0,27,3.857142857142857,2,0.0,5,1,9,0,12,0,0,0,0,15,12,0
3358,78452,ukfWsseqqJzHHxAFnLMKYh1SZzExeQ1z,SpATywNh6bZuzm8s1ceuBUnMUAeoAHHw,1,0,0,0,0,0,2,0,2,0.2857142857142857,1,0.0,0,0,0,0,0,0,0,2,0,0,2,1
3359,78603,7u0QfTKQg4itZK9m8foLXkIGwUxxHMsT,SpATywNh6bZuzm8s1ceuBUnMUAeoAHHw,19,14,10,9,6,0,3,0,42,6.0,2,0.0,2,10,8,6,12,0,1,3,0,26,16,0
3360,78663,4dVGo2nGpdhjYgYbTYmjlligu2kflHn7,5X6FeZozNMgE2VRi3MJYjkkFK8SETtu2,12,19,4,13,0,0,3,0,39,5.571428571428571,1,0.0,8,4,13,0,11,0,0,3,0,25,14,1
3361,78715,5Zgwu2mRcsc21AmNDehMpm5vDwlgKfhs,SpATywNh6bZuzm8s1ceuBUnMUAeoAHHw,25,17,16,0,11,0,3,0,47,6.714285714285714,1,0.0,0,16,0,11,17,0,0,3,0,27,20,1
3362,78797,5NRnaGcpNIGEuH61FLOcxB7Rjs6WPiNk,SpATywNh6bZuzm8s1ceuBUnMUAeoAHHw,24,25,13,9,7,0,14,1,69,9.857142857142858,2,0.0,6,13,8,7,19,0,1,14,1,34,35,0
3363,78848,oZKhsAromYlsN9MhR64yAv55dJDSDM8L,G8EPVSXsOYB5YQWZGiz1aVq5Pgr2GrQu,5,8,3,0,0,0,2,0,13,1.8571428571428572,2,0.0,0,3,0,0,8,0,0,2,0,3,10,1
3364,78930,E96VmAw6m1AOHRckdqiq2ASKbnHBlpAb,G8EPVSXsOYB5YQWZGiz1aVq5Pgr2GrQu,82,148,38,142,26,10,8,0,372,53.142857142857146,3,0.0,69,38,92,26,79,10,50,8,0,225,147,0
3365,78953,AZZvRPcRkLSa6vwofzfwsEULTUhiKy0E,SpATywNh6bZuzm8s1ceuBUnMUAeoAHHw,11,21,2,0,1,0,3,0,27,3.857142857142857,2,0.0,2,2,0,1,19,0,0,3,0,5,22,0
3366,78971,d1mccaMvv72HL0M2QdKzu9aosPAbZ4Jm,SpATywNh6bZuzm8s1ceuBUnMUAeoAHHw,14,23,1,9,1,0,1,0,35,5.0,2,0.0,3,1,8,1,20,0,1,1,0,13,22,0
3367,79085,jByBG50ghoSer5UP92qpkAfDGFpraaH7,RXDvfPUBYFlVdlueBFbLW0mhhAyGEqpt,1,0,0,0,0,0,1,0,1,0.14285714285714285,1,0.0,0,0,0,0,0,0,0,1,0,0,1,1
3368,79088,oA5bEHkRJtiDJKnesmAjUtrhTVSOkHe2,SpATywNh6bZuzm8s1ceuBUnMUAeoAHHw,5,3,2,0,1,0,1,0,7,1.0,1,0.0,0,2,0,1,3,0,0,1,0,3,4,1
3369,79106,7Xbcyzr5w9UbFD6viSl5LziGgJLlGTSQ,5X6FeZozNMgE2VRi3MJYjkkFK8SETtu2,19,51,4,27,13,0,11,0,106,15.142857142857142,3,0.0,20,4,22,13,31,0,5,11,0,59,47,1
3370,79112,NCq7uMk20xis3HUzEQcWP2K284TvGGUT,5X6FeZozNMgE2VRi3MJYjkkFK8SETtu2,14,16,6,12,8,0,1,0,43,6.142857142857143,1,0.0,9,6,10,8,7,0,2,1,0,33,10,1
3371,79150,1anSA7G3nrsDO0JSarewPnqCvjcLjtpi,SpATywNh6bZuzm8s1ceuBUnMUAeoAHHw,23,25,8,12,5,1,3,0,54,7.714285714285714,2,0.0,7,8,11,5,18,1,1,3,0,31,23,0
3372,79164,wGfXRYqHkdAo1fVEEY9NvW8qy6M9m0mI,A3fsA9Zfv1X2fVEQhTw51lKENdNrEqT3,1,0,0,0,0,0,1,0,1,0.14285714285714285,1,0.0,0,0,0,0,0,0,0,1,0,0,1,1
3373,79211,Ja905y236QEClSbNQNnPtVvburZ1SbjM,5X6FeZozNMgE2VRi3MJYjkkFK8SETtu2,9,16,6,0,6,0,3,0,31,4.428571428571429,1,0.0,4,6,0,6,12,0,0,3,0,16,15,1
3374,79213,kuV0mzlgGFUIK4wXcwcPFRatONM4P10L,SpATywNh6bZuzm8s1ceuBUnMUAeoAHHw,3,2,1,0,0,0,1,0,4,0.5714285714285714,1,0.0,0,1,0,0,2,0,0,1,0,1,3,0
3375,79268,V1B34PKYcESnicIbQVUA4gpuU2uOqNWz,SpATywNh6bZuzm8s1ceuBUnMUAeoAHHw,10,6,5,0,3,0,1,0,15,2.142857142857143,1,0.0,0,5,0,3,6,0,0,1,0,8,7,1
3376,79322,b9hN1tjIpM67gB8PuwPQ3u561lqo1V2f,RXDvfPUBYFlVdlueBFbLW0mhhAyGEqpt,5,2,1,0,0,0,3,0,6,0.8571428571428571,1,0.0,0,1,0,0,2,0,0,3,0,1,5,0
3377,79340,UA8vU3s92g3lXc62U363PEO0xor6Mpeg,5X6FeZozNMgE2VRi3MJYjkkFK8SETtu2,9,21,6,0,12,0,4,0,43,6.142857142857143,4,0.0,11,6,0,12,10,0,0,4,0,29,14,0
3378,79391,Q3913BpDariYbEj8ZlFy9MQJV1rZlZAJ,SpATywNh6bZuzm8s1ceuBUnMUAeoAHHw,9,27,2,17,0,0,3,0,49,7.0,2,0.0,11,2,16,0,16,0,1,3,0,29,20,1
3379,79465,se9ZVl8DNkiCW8i2nP0p3krrUcQqYC47,5X6FeZozNMgE2VRi3MJYjkkFK8SETtu2,5,3,2,0,1,0,1,0,7,1.0,1,0.0,0,2,0,1,3,0,0,1,0,3,4,1
3380,79481,IHB272IdBeuDM3MeGjnOfHr8AhA89HNb,RXDvfPUBYFlVdlueBFbLW0mhhAyGEqpt,6,4,3,0,1,0,1,0,9,1.2857142857142858,1,0.0,0,3,0,1,4,0,0,1,0,4,5,1
3381,79509,G0i0hCTwH2K62ld1aO6Hf5Ntp0ahokSh,SpATywNh6bZuzm8s1ceuBUnMUAeoAHHw,2,0,0,0,0,0,2,0,2,0.2857142857142857,1,0.0,0,0,0,0,0,0,0,2,0,0,2,0
3382,79519,NUQJxbePNRtXQQBXCQFchv4ww5sWUrml,SpATywNh6bZuzm8s1ceuBUnMUAeoAHHw,9,8,1,0,1,0,6,0,16,2.2857142857142856,3,0.0,0,1,0,1,8,0,0,6,0,2,14,0
3383,79526,iF24oNq097ygA95BwYxAfvpVnpWVn9EH,5X6FeZozNMgE2VRi3MJYjkkFK8SETtu2,1,0,0,0,0,0,1,0,1,0.14285714285714285,1,0.0,0,0,0,0,0,0,0,1,0,0,1,1
3384,79548,xt59FC0u82DgUh4CRpEaJwaXZlH1aLO1,SpATywNh6bZuzm8s1ceuBUnMUAeoAHHw,7,15,9,0,4,0,8,0,36,5.142857142857143,1,0.0,0,9,0,4,15,0,0,8,0,13,23,0
3385,79571,NpWI6qpknO723dhhdi9gGeQ3D9TLPFRi,5X6FeZozNMgE2VRi3MJYjkkFK8SETtu2,1,0,0,0,0,0,1,0,1,0.14285714285714285,1,0.0,0,0,0,0,0,0,0,1,0,0,1,1
3386,79619,Z21gQGlXtQP1JO0odoLDtH3q2Pa791DY,bWdj2GDclj5ofokWjzoa5jAwMkxCykd6,1,0,0,0,0,0,1,0,1,0.14285714285714285,1,0.0,0,0,0,0,0,0,0,1,0,0,1,1
3387,79638,Ilrg7TMz0MlMLaAx4PALASUPnlbAGSuF,5X6FeZozNMgE2VRi3MJYjkkFK8SETtu2,19,34,11,24,9,2,11,1,92,13.142857142857142,1,0.0,18,11,21,9,16,2,3,11,1,59,33,1
3388,79697,ZbdgVvxsxyG1aqBQ8n6eLVu27gWAZvhX,5X6FeZozNMgE2VRi3MJYjkkFK8SETtu2,1,0,0,0,0,0,1,0,1,0.14285714285714285,1,0.0,0,0,0,0,0,0,0,1,0,0,1,1
3389,79756,1HYKmgHGaA0bHjLTmo1qNMwzAVv6AZom,5X6FeZozNMgE2VRi3MJYjkkFK8SETtu2,7,3,2,0,2,0,2,0,9,1.2857142857142858,1,0.0,0,2,0,2,3,0,0,2,0,4,5,1
3390,79761,ffg9VbmMkFKj2DfO61ClA5PDHr5Xa6gN,SpATywNh6bZuzm8s1ceuBUnMUAeoAHHw,5,3,1,0,1,0,1,0,6,0.8571428571428571,1,0.0,0,1,0,1,3,0,0,1,0,2,4,0
3391,79818,dCAqk9uHiS99GMTcJQtThG8XWnwwbp5Q,SpATywNh6bZuzm8s1ceuBUnMUAeoAHHw,21,52,5,16,4,1,10,1,89,12.714285714285714,2,0.0,4,5,13,4,48,1,3,10,1,26,63,1
3392,79831,7kTdvih7UMOiFKC9aXRp88JppGP4qSKH,SpATywNh6bZuzm8s1ceuBUnMUAeoAHHw,17,15,10,0,6,0,5,0,36,5.142857142857143,4,0.0,0,10,0,6,15,0,0,5,0,16,20,1
3393,80019,YOBshYgk5gyR7XdL7ay26cecY2tdQtWp,SpATywNh6bZuzm8s1ceuBUnMUAeoAHHw,23,43,17,40,0,7,6,0,113,16.142857142857142,4,0.0,21,17,31,0,22,7,9,6,0,69,44,0
3394,80088,IAOTVxG7e06ArppQIZcVBCeppiZS52Zi,5X6FeZozNMgE2VRi3MJYjkkFK8SETtu2,1,0,0,0,0,0,1,0,1,0.14285714285714285,1,0.0,0,0,0,0,0,0,0,1,0,0,1,1
3395,80195,aZzurUzXBMxrnGRFBA3YxJsNpq6Cyxbm,SpATywNh6bZuzm8s1ceuBUnMUAeoAHHw,6,5,4,0,0,0,1,0,10,1.4285714285714286,1,0.0,0,4,0,0,5,0,0,1,0,4,6,0
3396,80216,GkgOdr5534YC0rxEW6eOGTvUI1TnqsRC,SpATywNh6bZuzm8s1ceuBUnMUAeoAHHw,3,2,1,0,0,0,1,0,4,0.5714285714285714,1,0.0,0,1,0,0,2,0,0,1,0,1,3,1
3397,80247,eYRBHvvJOtQ80CX15zmkpE9dCWbRpi7K,SpATywNh6bZuzm8s1ceuBUnMUAeoAHHw,4,4,2,0,0,0,1,0,7,1.0,1,0.0,1,2,0,0,3,0,0,1,0,3,4,0
3398,80319,4cRZxyVNjv13lU3nu2aK2rwyndExVCGa,SpATywNh6bZuzm8s1ceuBUnMUAeoAHHw,3,4,0,0,0,0,1,0,5,0.7142857142857143,1,0.0,0,0,0,0,4,0,0,1,0,0,5,0
3399,80378,TkpjYbWxittbt5GHuJXRBWRI2DvksTLd,5X6FeZozNMgE2VRi3MJYjkkFK8SETtu2,15,26,8,16,7,0,5,0,62,8.857142857142858,3,0.0,13,8,15,7,13,0,1,5,0,43,19,1
3400,80393,S8OVDYMWVqlXct5SL79m7HIG5CpKKYZc,SpATywNh6bZuzm8s1ceuBUnMUAeoAHHw,5,6,1,0,0,0,2,0,9,1.2857142857142858,1,0.0,0,1,0,0,6,0,0,2,0,1,8,0
3401,80401,HvSvcoWOvHQVexdtTmLoxzS1YOl5a4vw,5X6FeZozNMgE2VRi3MJYjkkFK8SETtu2,2,0,0,0,0,0,2,0,2,0.2857142857142857,1,0.0,0,0,0,0,0,0,0,2,0,0,2,1
3402,80411,GC4OF9yGz21AkcWehLa95SfLGyYuVKMP,SpATywNh6bZuzm8s1ceuBUnMUAeoAHHw,11,20,4,12,1,0,1,0,38,5.428571428571429,1,0.0,12,4,12,1,8,0,0,1,0,29,9,0
3403,80416,R6Y7ivYHIWSne9pzpaFDgE5diurqEzNu,5X6FeZozNMgE2VRi3MJYjkkFK8SETtu2,5,3,1,0,1,0,2,0,7,1.0,1,0.0,0,1,0,1,3,0,0,2,0,2,5,1
3404,80472,2tSCGGcBbyusCnHqpGiQkgQi3re0uZxB,G8EPVSXsOYB5YQWZGiz1aVq5Pgr2GrQu,4,10,0,0,0,1,3,0,14,2.0,1,0.0,0,0,0,0,10,1,0,3,0,0,14,1
3405,80606,2cQfWhwRUGUv48S47s2aDWYzSM5LRy6r,RXDvfPUBYFlVdlueBFbLW0mhhAyGEqpt,7,5,1,0,1,0,1,0,8,1.1428571428571428,1,0.0,0,1,0,1,5,0,0,1,0,2,6,1
3406,80609,mDJsiogBkxNlOJSXjjSgpZwxWEVieV90,5X6FeZozNMgE2VRi3MJYjkkFK8SETtu2,8,7,3,0,1,8,9,3,31,4.428571428571429,1,0.0,0,3,0,1,7,8,0,9,3,4,27,1
3407,80653,hvadU2QyWcfZwJKaR7Pak0PcPESSEDA5,5X6FeZozNMgE2VRi3MJYjkkFK8SETtu2,17,51,14,16,7,0,7,0,95,13.571428571428571,4,0.0,30,14,15,7,21,0,1,7,0,66,29,1
3408,80695,oYTEOpmw5jxcBYfklhItyovgp6ogAm6R,5X6FeZozNMgE2VRi3MJYjkkFK8SETtu2,7,8,4,0,2,2,6,1,23,3.2857142857142856,1,0.0,0,4,0,2,8,2,0,6,1,6,17,1
3409,80748,H6iwP0B7nHcYZaQbDpLJEx2H7FXYxL7S,RXDvfPUBYFlVdlueBFbLW0mhhAyGEqpt,37,36,18,84,8,4,12,0,162,23.142857142857142,3,0.0,16,18,64,8,20,4,20,12,0,106,56,0
3410,80800,a98Mt6r9LLCkAEPo2R3JVMN20OhIPoaG,SpATywNh6bZuzm8s1ceuBUnMUAeoAHHw,7,8,4,0,3,0,2,0,17,2.4285714285714284,4,0.0,0,4,0,3,8,0,0,2,0,7,10,1
3411,80890,9iv095QjZS4Q7X9b663JhI4Y5VIooOZJ,fbPkOYLVPtPgIt0MxizjfFJov3JbHyAi,8,3,2,0,1,1,7,2,16,2.2857142857142856,1,0.0,0,2,0,1,3,1,0,7,2,3,13,1
3412,80946,vjWysxVywi2MULjlX1Qte1HQfNPVqWDQ,5Gyp41oLVo7Gg7vF4vpmggWP5MU70QO6,1,0,0,0,0,0,1,0,1,0.14285714285714285,1,0.0,0,0,0,0,0,0,0,1,0,0,1,1
3413,80950,Ae7xevRD6ByEfUnyzvdQZ9mTmnPx254z,5Gyp41oLVo7Gg7vF4vpmggWP5MU70QO6,6,3,2,0,2,1,1,0,9,1.2857142857142858,1,0.0,0,2,0,2,3,1,0,1,0,4,5,1
3414,80962,CoVj6ijZvTIcDVOtOc471oXSuWKGkHMO,5Gyp41oLVo7Gg7vF4vpmggWP5MU70QO6,5,3,1,0,1,0,1,0,6,0.8571428571428571,1,0.0,0,1,0,1,3,0,0,1,0,2,4,1
3415,80995,MQ6AdIC7bHvsizvN9kYggZoqQjRC5tC3,5Gyp41oLVo7Gg7vF4vpmggWP5MU70QO6,5,0,0,0,0,0,4,1,5,0.7142857142857143,1,0.0,0,0,0,0,0,0,0,4,1,0,5,1
3416,80998,uKZ87zwhOlE6XjyVFr8vmJl9wOD1B9qQ,5Gyp41oLVo7Gg7vF4vpmggWP5MU70QO6,7,3,2,0,2,0,3,0,10,1.4285714285714286,1,0.0,0,2,0,2,3,0,0,3,0,4,6,1
3417,81040,Lq0T06X3CZi6ALtJCjo66DBN2OiVwbTv,5Gyp41oLVo7Gg7vF4vpmggWP5MU70QO6,3,0,0,0,0,0,3,0,3,0.42857142857142855,1,0.0,0,0,0,0,0,0,0,3,0,0,3,1
3418,81058,mo4Y7ec4CusrBe4cUkQewDgGhC6GhVtU,5Gyp41oLVo7Gg7vF4vpmggWP5MU70QO6,11,8,3,0,2,2,8,0,23,3.2857142857142856,2,0.0,0,3,0,2,8,2,0,8,0,5,18,1
3419,81072,U9j28kbZjF4W0VB5A2yieyyacPtOxvwt,5Gyp41oLVo7Gg7vF4vpmggWP5MU70QO6,22,89,56,6,2,0,12,1,166,23.714285714285715,3,0.0,21,56,3,2,68,0,3,12,1,82,84,0
3420,81080,lxeK6Le1R4xCd6kmC9TYS6QBdiNvyBxi,5Gyp41oLVo7Gg7vF4vpmggWP5MU70QO6,8,8,4,5,1,0,2,0,20,2.857142857142857,2,0.0,2,4,3,1,6,0,2,2,0,10,10,1
3421,81139,7oFdtO9FKJf8IdNZ1BS1BE66okU1XkZm,5Gyp41oLVo7Gg7vF4vpmggWP5MU70QO6,13,9,3,10,2,1,5,1,31,4.428571428571429,1,0.0,5,3,5,2,4,1,5,5,1,15,16,1
3422,81141,GYJjQ2lIayjypo2gIyakZnP2wWPyzF1D,5Gyp41oLVo7Gg7vF4vpmggWP5MU70QO6,1,0,0,0,0,0,1,0,1,0.14285714285714285,1,0.0,0,0,0,0,0,0,0,1,0,0,1,1
3423,81151,sRTon1VBBuP0uvdQE1lWLIce29YVBv8J,5Gyp41oLVo7Gg7vF4vpmggWP5MU70QO6,1,0,0,0,0,0,1,0,1,0.14285714285714285,1,0.0,0,0,0,0,0,0,0,1,0,0,1,1
3424,81211,oZKhsAromYlsN9MhR64yAv55dJDSDM8L,5Gyp41oLVo7Gg7vF4vpmggWP5MU70QO6,1,0,0,0,0,0,1,0,1,0.14285714285714285,1,0.0,0,0,0,0,0,0,0,1,0,0,1,1
3425,81225,k1Dqj4gjuYT6jK12QjlW65nZnFEwD9C2,5Gyp41oLVo7Gg7vF4vpmggWP5MU70QO6,3,0,0,0,0,0,3,0,3,0.42857142857142855,1,0.0,0,0,0,0,0,0,0,3,0,0,3,1
3426,81305,BNnfyIl3FBzkPpjJdH0jx7hkSuYPxmtm,5Gyp41oLVo7Gg7vF4vpmggWP5MU70QO6,10,5,3,0,2,1,5,0,16,2.2857142857142856,2,0.0,0,3,0,2,5,1,0,5,0,5,11,0
3427,81308,ymqaajgnjDJ2uzLF9mfDPmtZpL3ypXbN,5Gyp41oLVo7Gg7vF4vpmggWP5MU70QO6,7,3,2,0,2,0,3,0,10,1.4285714285714286,1,0.0,0,2,0,2,3,0,0,3,0,4,6,0
3428,81320,x5FLCm41jTiuXo4N8MtDfFRkxPsx9X7V,5Gyp41oLVo7Gg7vF4vpmggWP5MU70QO6,1,0,0,0,0,0,1,0,1,0.14285714285714285,1,0.0,0,0,0,0,0,0,0,1,0,0,1,1
3429,81329,VHwbRcPg3VDETaEVsJMANgQMwkomvLqN,5Gyp41oLVo7Gg7vF4vpmggWP5MU70QO6,30,85,45,27,1,53,18,3,232,33.142857142857146,7,0.0,20,45,22,1,65,53,5,18,3,88,144,0
3430,81341,ISRJxWtuG9U7GF6GcMl2UZgUHAWLyOgM,5Gyp41oLVo7Gg7vF4vpmggWP5MU70QO6,13,12,7,0,3,0,10,0,32,4.571428571428571,3,0.0,0,7,0,3,12,0,0,10,0,10,22,0
3431,81365,IbX9gv2vZSEMbkKys5TaEZGJbRA9UsC2,5Gyp41oLVo7Gg7vF4vpmggWP5MU70QO6,27,72,14,4,8,0,13,2,113,16.142857142857142,2,0.0,24,14,2,8,48,0,2,13,2,48,65,1
3432,81370,qmyjMBwztkMP5U1GBP3R4mtgUJIqaUcw,5Gyp41oLVo7Gg7vF4vpmggWP5MU70QO6,26,24,14,2,14,1,7,1,63,9.0,1,0.0,9,14,1,14,15,1,1,7,1,38,25,1
3433,81372,aeihE5fwFEllY8qfmQ5jU27rfKEU6Bkh,5Gyp41oLVo7Gg7vF4vpmggWP5MU70QO6,8,13,5,0,0,0,6,0,24,3.4285714285714284,3,0.0,0,5,0,0,13,0,0,6,0,5,19,1
3434,81375,MgBJbfRXH0QNEJmIiGY28SpmFvbhxSoF,5Gyp41oLVo7Gg7vF4vpmggWP5MU70QO6,37,93,32,8,21,2,21,1,178,25.428571428571427,4,0.0,19,32,4,21,74,2,4,21,1,76,102,0
3435,81388,aJMNcTer76nTaYZZR58xtdmLr8BYq1Op,5Gyp41oLVo7Gg7vF4vpmggWP5MU70QO6,1,0,0,0,0,0,1,0,1,0.14285714285714285,1,0.0,0,0,0,0,0,0,0,1,0,0,1,1
3436,81408,PHEq3ilhX7xFu8QukpW7ETpYepJHfFjo,5Gyp41oLVo7Gg7vF4vpmggWP5MU70QO6,26,51,26,20,6,23,24,14,164,23.428571428571427,7,0.0,14,26,13,6,37,23,7,24,14,59,105,0
3437,81417,S03j7b0vJ1rT6MN0S4HFY4GZTa97680X,5Gyp41oLVo7Gg7vF4vpmggWP5MU70QO6,16,41,16,0,10,63,21,4,155,22.142857142857142,5,0.0,10,16,0,10,31,63,0,21,4,36,119,1
3438,81425,la0M1c91h799fPQIw73JrRQfyaSu3lyA,5Gyp41oLVo7Gg7vF4vpmggWP5MU70QO6,7,3,2,0,2,0,5,0,12,1.7142857142857142,2,0.0,0,2,0,2,3,0,0,5,0,4,8,1
3439,81454,h48GX1o84DB4k0RmPuw70oay4JNlSZy6,5Gyp41oLVo7Gg7vF4vpmggWP5MU70QO6,4,0,0,0,0,0,6,0,6,0.8571428571428571,2,0.0,0,0,0,0,0,0,0,6,0,0,6,1
3440,81487,zXSweX2QVu58ribAOKB8UtMWETtQQw6R,5Gyp41oLVo7Gg7vF4vpmggWP5MU70QO6,7,3,2,0,2,0,2,0,9,1.2857142857142858,1,0.0,0,2,0,2,3,0,0,2,0,4,5,1
3441,81553,NNTbkWufZqd6OEZ4OfeDtmQCNI4vEzJo,5Gyp41oLVo7Gg7vF4vpmggWP5MU70QO6,8,5,3,0,0,1,12,1,22,3.142857142857143,2,0.0,0,3,0,0,5,1,0,12,1,3,19,0
3442,81580,MrbDYJV3aW9Xqd3Cf1F4pa7wKvEtnSNA,5Gyp41oLVo7Gg7vF4vpmggWP5MU70QO6,8,3,2,0,2,0,3,1,11,1.5714285714285714,1,0.0,0,2,0,2,3,0,0,3,1,4,7,1
3443,81592,UJda6rUqw07lTq8Jm7yRYWGaMX7fJVQp,5Gyp41oLVo7Gg7vF4vpmggWP5MU70QO6,1,0,0,0,0,0,1,0,1,0.14285714285714285,1,0.0,0,0,0,0,0,0,0,1,0,0,1,1
3444,81600,AZxIIh3OaBX0VeUwrvZCAokjIRSsH9yN,5Gyp41oLVo7Gg7vF4vpmggWP5MU70QO6,10,21,10,4,4,0,5,0,44,6.285714285714286,4,0.0,6,10,3,4,15,0,1,5,0,23,21,1
3445,81603,5VTFVrr5jpBcsZ05P95Kl903JuI71aZk,5Gyp41oLVo7Gg7vF4vpmggWP5MU70QO6,10,12,5,12,0,0,2,0,31,4.428571428571429,1,0.0,6,5,6,0,6,0,6,2,0,17,14,1
3446,81614,P9foP4jof7zTMN45RE5uaKtBnTwp6aMz,5Gyp41oLVo7Gg7vF4vpmggWP5MU70QO6,10,5,3,0,2,3,6,0,19,2.7142857142857144,1,0.0,0,3,0,2,5,3,0,6,0,5,14,1
3447,81632,TsVPbOaAsUuyIbJk2LJGJpINdbxfUBlF,5Gyp41oLVo7Gg7vF4vpmggWP5MU70QO6,10,12,5,2,4,10,13,0,46,6.571428571428571,2,0.0,6,5,1,4,6,10,1,13,0,16,30,1
3448,81646,7Uc4Whr2YqGTWUQ6jLjOCx7X8xoW6IGX,5Gyp41oLVo7Gg7vF4vpmggWP5MU70QO6,1,0,0,0,0,0,1,0,1,0.14285714285714285,1,0.0,0,0,0,0,0,0,0,1,0,0,1,1
3449,81669,2Cg2mHDWfiLELDYENQblfmUTX7x6Jf1J,5Gyp41oLVo7Gg7vF4vpmggWP5MU70QO6,23,40,20,13,7,4,15,1,100,14.285714285714286,4,0.0,10,20,12,7,30,4,1,15,1,49,51,1
3450,81687,DV9cmKY91lk8lKsMUmLIMP1KsHFcyZMK,5Gyp41oLVo7Gg7vF4vpmggWP5MU70QO6,5,1,0,0,0,0,3,1,5,0.7142857142857143,1,0.0,0,0,0,0,1,0,0,3,1,0,5,0
3451,81748,VDkowRNw2Ze5Lp3OFXVRaDJYFNTBDDQm,5Gyp41oLVo7Gg7vF4vpmggWP5MU70QO6,42,102,43,46,16,14,15,1,237,33.857142857142854,8,0.0,33,43,36,16,69,14,10,15,1,128,109,0
3452,81780,OH8WnAV2MBaaFDQHpnLQPXNjc3Qpxqk2,5Gyp41oLVo7Gg7vF4vpmggWP5MU70QO6,6,4,1,0,2,0,2,0,9,1.2857142857142858,1,0.0,1,1,0,2,3,0,0,2,0,4,5,1
3453,81799,45yfbnarXLY6Jtgynu1Xeg2zt9QQstcT,5Gyp41oLVo7Gg7vF4vpmggWP5MU70QO6,27,65,29,23,12,3,13,0,145,20.714285714285715,6,0.0,20,29,17,12,45,3,6,13,0,78,67,1
3454,81832,bN6kBVDkYHGdix1w3bk33yFgAVX3hMWw,5Gyp41oLVo7Gg7vF4vpmggWP5MU70QO6,1,0,0,0,0,0,1,0,1,0.14285714285714285,1,0.0,0,0,0,0,0,0,0,1,0,0,1,1
3455,81890,uQIdowlaeNEkKpZhFG9A3TFJBFgU4S0F,5Gyp41oLVo7Gg7vF4vpmggWP5MU70QO6,1,0,0,0,0,0,1,0,1,0.14285714285714285,1,0.0,0,0,0,0,0,0,0,1,0,0,1,1
3456,81901,TAJlYOA3wqCFdRnwld2vXU13SLIYwfc5,5Gyp41oLVo7Gg7vF4vpmggWP5MU70QO6,8,7,4,0,2,0,2,0,15,2.142857142857143,1,0.0,0,4,0,2,7,0,0,2,0,6,9,1
3457,81904,kgc4sYOGBLet1obN5653ebiNM8WxlTwl,5Gyp41oLVo7Gg7vF4vpmggWP5MU70QO6,2,0,0,0,0,0,2,0,2,0.2857142857142857,1,0.0,0,0,0,0,0,0,0,2,0,0,2,1
3458,81908,NcEpl157R9804FU8cPtpCcaWHzDDnaT9,5Gyp41oLVo7Gg7vF4vpmggWP5MU70QO6,11,7,4,0,4,0,2,0,17,2.4285714285714284,2,0.0,1,4,0,4,6,0,0,2,0,9,8,1
3459,81916,TzkQAoEYP1E815cLCMz9zInNnb8kYGLK,5Gyp41oLVo7Gg7vF4vpmggWP5MU70QO6,2,0,0,0,0,0,2,0,2,0.2857142857142857,1,0.0,0,0,0,0,0,0,0,2,0,0,2,1
3460,81919,HhgCtxOWA8hhcRNBS4AoxJTtsUvncdy2,5Gyp41oLVo7Gg7vF4vpmggWP5MU70QO6,13,11,7,0,4,3,4,0,29,4.142857142857143,3,0.0,1,7,0,4,10,3,0,4,0,12,17,1
3461,81939,lA0pTjAWZU3lRO7AFotws1B2CDNPLkh1,5Gyp41oLVo7Gg7vF4vpmggWP5MU70QO6,1,0,0,0,0,0,1,0,1,0.14285714285714285,1,0.0,0,0,0,0,0,0,0,1,0,0,1,1
3462,81944,IICLCU8feiN4Ddj1IniboUMZ0TdS44vO,5Gyp41oLVo7Gg7vF4vpmggWP5MU70QO6,13,16,6,0,3,0,6,0,31,4.428571428571429,2,0.0,8,6,0,3,8,0,0,6,0,17,14,0
3463,81981,k5oVYco32vQ3DmUE6ZDHecga51LfmXuY,5Gyp41oLVo7Gg7vF4vpmggWP5MU70QO6,1,0,0,0,0,0,1,0,1,0.14285714285714285,1,0.0,0,0,0,0,0,0,0,1,0,0,1,1
3464,81992,I0dPBQTgu6D9eXliUlbcjdGy6QSaLkYM,5Gyp41oLVo7Gg7vF4vpmggWP5MU70QO6,7,5,2,0,2,0,2,0,11,1.5714285714285714,1,0.0,0,2,0,2,5,0,0,2,0,4,7,1
3465,81996,Uf8FY0gZoVytp6K7SsDRXVZeOCL2hDEX,5Gyp41oLVo7Gg7vF4vpmggWP5MU70QO6,7,6,0,0,0,1,6,0,13,1.8571428571428572,2,0.0,0,0,0,0,6,1,0,6,0,0,13,0
3466,82001,Pqioqz8K6HnqHiY5C1wkqbUUaUlFBHvC,5Gyp41oLVo7Gg7vF4vpmggWP5MU70QO6,1,0,0,0,0,0,1,0,1,0.14285714285714285,1,0.0,0,0,0,0,0,0,0,1,0,0,1,1
3467,82003,yzBFB71TahEfYRhZug3yE5qLPzRJCqH9,5Gyp41oLVo7Gg7vF4vpmggWP5MU70QO6,9,7,3,0,0,3,18,3,34,4.857142857142857,1,0.0,2,3,0,0,5,3,0,18,3,5,29,1
3468,82010,ppKilowTGDD739bC3UNeZEuj8p6ssexh,5Gyp41oLVo7Gg7vF4vpmggWP5MU70QO6,11,10,6,0,4,0,9,0,29,4.142857142857143,1,0.0,2,6,0,4,8,0,0,9,0,12,17,1
3469,82030,dzYm1dRe7J2rj7JrdKLsOqkjQnJrIFXt,5Gyp41oLVo7Gg7vF4vpmggWP5MU70QO6,9,8,0,2,0,0,1,0,11,1.5714285714285714,1,0.0,1,0,1,0,7,0,1,1,0,2,9,1
3470,82054,njqa0JNTmCp6NkFmaSbsVlfwuihmQkk3,5Gyp41oLVo7Gg7vF4vpmggWP5MU70QO6,1,0,0,0,0,0,1,0,1,0.14285714285714285,1,0.0,0,0,0,0,0,0,0,1,0,0,1,1
3471,82072,gFgZpGYEekWdTED1EzQF6f6Wo7CuRRyn,5Gyp41oLVo7Gg7vF4vpmggWP5MU70QO6,6,4,2,0,1,1,2,0,10,1.4285714285714286,1,0.0,1,2,0,1,3,1,0,2,0,4,6,1
3472,82089,HuLHCkffx7NTEjFGXpjyYhc55925sZcQ,5Gyp41oLVo7Gg7vF4vpmggWP5MU70QO6,6,7,4,0,3,0,6,0,20,2.857142857142857,2,0.0,0,4,0,3,7,0,0,6,0,7,13,1
3473,82098,rXyS7LJgT9wTWohW72cqEKZVaojJdgOo,5Gyp41oLVo7Gg7vF4vpmggWP5MU70QO6,38,86,37,24,22,6,12,2,189,27.0,2,0.0,32,37,12,22,54,6,12,12,2,103,86,0
3474,82099,iLqxZ0n7bus10HRNLa55JPyT9ijWURXL,5Gyp41oLVo7Gg7vF4vpmggWP5MU70QO6,1,0,0,0,0,0,1,0,1,0.14285714285714285,1,0.0,0,0,0,0,0,0,0,1,0,0,1,1
3475,82103,LCMyKiD5XwFaOzPllkjjv2ZtPOIZ7Aze,5Gyp41oLVo7Gg7vF4vpmggWP5MU70QO6,1,0,0,0,0,0,1,0,1,0.14285714285714285,1,0.0,0,0,0,0,0,0,0,1,0,0,1,1
3476,82104,tTX1lbaFQ9AIQUV0Tqh2bCFjGLODMzEt,5Gyp41oLVo7Gg7vF4vpmggWP5MU70QO6,12,9,5,0,4,1,8,2,29,4.142857142857143,1,0.0,1,5,0,4,8,1,0,8,2,10,19,1
3477,82127,WNyPeYGhB3VWWEsNYr4aXv1YBtMhLTLV,5Gyp41oLVo7Gg7vF4vpmggWP5MU70QO6,2,0,0,0,0,0,2,0,2,0.2857142857142857,1,0.0,0,0,0,0,0,0,0,2,0,0,2,1
3478,82151,RPsysYLHG9V8ibC4agPmUkz49odzJ61i,5Gyp41oLVo7Gg7vF4vpmggWP5MU70QO6,16,22,9,11,5,22,13,1,83,11.857142857142858,5,0.0,7,9,8,5,15,22,3,13,1,29,54,1
3479,82154,KM1Xkrs286QEvxM8WAk4Jd10TrYlc7Rx,5Gyp41oLVo7Gg7vF4vpmggWP5MU70QO6,32,76,34,23,21,0,6,0,160,22.857142857142858,6,0.0,24,34,17,21,52,0,6,6,0,96,64,0
3480,82172,nISFYFLVxWXpIygYi9nQdNZcU3Bl9oR3,5Gyp41oLVo7Gg7vF4vpmggWP5MU70QO6,11,5,4,0,4,0,2,0,15,2.142857142857143,1,0.0,0,4,0,4,5,0,0,2,0,8,7,1
3481,82207,8DpbAnJnDX6ulNJx11NZ0LzLIVAWDea8,5Gyp41oLVo7Gg7vF4vpmggWP5MU70QO6,9,13,6,0,3,0,10,0,32,4.571428571428571,3,0.0,0,6,0,3,13,0,0,10,0,9,23,1
3482,82217,9Lei0nsIXUCzdSXtfo9QaQokApGicEaa,5Gyp41oLVo7Gg7vF4vpmggWP5MU70QO6,2,0,0,0,0,0,2,0,2,0.2857142857142857,1,0.0,0,0,0,0,0,0,0,2,0,0,2,1
3483,82228,htbkPO8S6I2SzX8h4P5Po5peKcu2DxE4,5Gyp41oLVo7Gg7vF4vpmggWP5MU70QO6,4,2,0,0,0,0,2,0,4,0.5714285714285714,1,0.0,0,0,0,0,2,0,0,2,0,0,4,0
3484,82240,ByV6tIWuv38n5iexvQLd8FEkPnLBxNOm,5Gyp41oLVo7Gg7vF4vpmggWP5MU70QO6,2,0,0,0,0,0,2,0,2,0.2857142857142857,1,0.0,0,0,0,0,0,0,0,2,0,0,2,1
3485,82278,6mJ65eKOiDJ0B2UMjBjMI3Dy4vxZcYQe,5Gyp41oLVo7Gg7vF4vpmggWP5MU70QO6,12,8,4,4,2,0,5,0,23,3.2857142857142856,1,0.0,3,4,2,2,5,0,2,5,0,11,12,1
3486,82290,ECYTLQ3E4TdzC2nQqMnkqHLn0MsC8UH2,5Gyp41oLVo7Gg7vF4vpmggWP5MU70QO6,4,3,1,0,0,0,2,0,6,0.8571428571428571,1,0.0,0,1,0,0,3,0,0,2,0,1,5,1
3487,82300,W0m8271d1PwWD9jcR5ad8muDNmmDz2n0,fbPkOYLVPtPgIt0MxizjfFJov3JbHyAi,7,4,3,0,2,0,1,0,10,1.4285714285714286,1,0.0,0,3,0,2,4,0,0,1,0,5,5,1
3488,82320,PZsNp0sdZSh88V88314df0SFpq2hITu9,7GRhBDsirIGkRZBtSMEzNTyDr2JQm4xx,26,43,24,0,16,3,6,0,92,13.142857142857142,3,0.0,1,24,0,16,42,3,0,6,0,41,51,1
3489,82344,V9A9B2T9pRTU3AqvpqzuKs4MfRcAEte2,5X6FeZozNMgE2VRi3MJYjkkFK8SETtu2,7,6,4,0,3,0,2,0,15,2.142857142857143,2,0.0,0,4,0,3,6,0,0,2,0,7,8,1
3490,82355,4Kx1Tk1FEFaPAhJJ1qabZH7R2QRjZNC4,5X6FeZozNMgE2VRi3MJYjkkFK8SETtu2,1,0,0,0,0,0,1,0,1,0.14285714285714285,1,0.0,0,0,0,0,0,0,0,1,0,0,1,1
3491,82397,WS43utSG33bYCMf9KzrbX5AdwBBQGbjp,5X6FeZozNMgE2VRi3MJYjkkFK8SETtu2,3,0,0,0,0,0,3,0,3,0.42857142857142855,1,0.0,0,0,0,0,0,0,0,3,0,0,3,1
3492,82416,skcEk7TV3jhSAknl5Kr7UawZFeqJNMzy,5X6FeZozNMgE2VRi3MJYjkkFK8SETtu2,7,4,2,0,2,0,4,0,12,1.7142857142857142,2,0.0,1,2,0,2,3,0,0,4,0,5,7,1
3493,82446,IlqVxR80wUI0K0Uw1aDlvKmr7WqFGjmy,5X6FeZozNMgE2VRi3MJYjkkFK8SETtu2,3,0,0,0,0,0,3,0,3,0.42857142857142855,2,0.0,0,0,0,0,0,0,0,3,0,0,3,1
3494,82499,0OF3EYrcXkzgoCZbflhPO2AMF0v3ygiD,5X6FeZozNMgE2VRi3MJYjkkFK8SETtu2,12,9,5,0,6,0,3,0,23,3.2857142857142856,2,0.0,2,5,0,6,7,0,0,3,0,13,10,0
3495,82538,T9Yj58iibT0MvC77ImCHQBcge8nlbEl0,5X6FeZozNMgE2VRi3MJYjkkFK8SETtu2,5,5,3,0,0,0,2,0,10,1.4285714285714286,2,0.0,0,3,0,0,5,0,0,2,0,3,7,0
3496,82561,cO0cRAd5oEVU09nlVPmxoB7bdGQ326BX,5X6FeZozNMgE2VRi3MJYjkkFK8SETtu2,1,0,0,0,0,0,1,0,1,0.14285714285714285,1,0.0,0,0,0,0,0,0,0,1,0,0,1,1
3497,82606,ieYbeKnQ9Q6nxVAutigoFXyNAyGepcVf,SpATywNh6bZuzm8s1ceuBUnMUAeoAHHw,19,13,9,12,5,0,1,0,40,5.714285714285714,1,0.0,3,9,11,5,10,0,1,1,0,28,12,0
3498,82645,CSh5hGbaSFu2yCb31iVMOVwKocrH471Q,RXDvfPUBYFlVdlueBFbLW0mhhAyGEqpt,9,10,6,0,2,0,6,0,24,3.4285714285714284,3,0.0,1,6,0,2,9,0,0,6,0,9,15,0
3499,82712,XDPvGyFLLEYwbNEQik2MM4yiADs5rrYJ,5X6FeZozNMgE2VRi3MJYjkkFK8SETtu2,4,2,1,0,1,0,2,0,6,0.8571428571428571,1,0.0,0,1,0,1,2,0,0,2,0,2,4,1
3500,82800,WufveCbPHF6lzhxB6Nzdvlmo0sd1ku5b,RXDvfPUBYFlVdlueBFbLW0mhhAyGEqpt,1,0,0,0,0,0,1,0,1,0.14285714285714285,1,0.0,0,0,0,0,0,0,0,1,0,0,1,1
3501,82809,CSh5hGbaSFu2yCb31iVMOVwKocrH471Q,bWdj2GDclj5ofokWjzoa5jAwMkxCykd6,3,2,0,0,0,0,1,0,3,0.42857142857142855,1,0.0,0,0,0,0,2,0,0,1,0,0,3,1
3502,82815,IYjgMeQycDQkXIpTAZqsKVDfOfuGTmr6,G8EPVSXsOYB5YQWZGiz1aVq5Pgr2GrQu,23,6,1,102,0,0,1,0,110,15.714285714285714,1,0.0,0,1,86,0,6,0,16,1,0,87,23,1
3503,82917,pxOSZxPvXphO2EXTM2iH7EY4Bz2Gx8pL,RXDvfPUBYFlVdlueBFbLW0mhhAyGEqpt,3,0,0,0,0,3,2,0,5,0.7142857142857143,1,0.0,0,0,0,0,0,3,0,2,0,0,5,1
3504,82980,KJHVgwvyEGSqeXuZ6P7l6YnOOdmnECg0,G8EPVSXsOYB5YQWZGiz1aVq5Pgr2GrQu,10,21,2,0,0,10,16,0,49,7.0,3,0.0,0,2,0,0,21,10,0,16,0,2,47,1
3505,83034,JfftjOGdDbpgbrupi0Gwr899R0jzXikJ,RXDvfPUBYFlVdlueBFbLW0mhhAyGEqpt,5,3,2,0,1,0,1,0,7,1.0,1,0.0,0,2,0,1,3,0,0,1,0,3,4,1
3506,83156,wSQurJctKIVWroKFEwLtZd7EI4FKyqnr,G8EPVSXsOYB5YQWZGiz1aVq5Pgr2GrQu,6,4,2,10,0,0,4,0,20,2.857142857142857,1,0.0,1,2,9,0,3,0,1,4,0,12,8,0
3507,83170,TOdJr6wpv1Do14qMOudEcAu5ZtPnzG5P,G8EPVSXsOYB5YQWZGiz1aVq5Pgr2GrQu,3,2,0,0,0,0,1,0,3,0.42857142857142855,1,0.0,0,0,0,0,2,0,0,1,0,0,3,0
3508,83207,cpPSwRiyzrnBZYcFR4yyg60XVFgQxQi4,5X6FeZozNMgE2VRi3MJYjkkFK8SETtu2,2,0,0,0,0,0,2,0,2,0.2857142857142857,1,0.0,0,0,0,0,0,0,0,2,0,0,2,1
3509,83227,EUmZ5qzjwgko2PIWEnctkvYh7APnUrX9,bWdj2GDclj5ofokWjzoa5jAwMkxCykd6,5,5,2,0,1,0,0,0,8,1.1428571428571428,2,0.0,0,2,0,1,5,0,0,0,0,3,5,0
3510,83234,amoOfSkysWrIhdnr1E3AIL1FF64JqedD,G8EPVSXsOYB5YQWZGiz1aVq5Pgr2GrQu,1,0,0,0,0,0,1,0,1,0.14285714285714285,1,0.0,0,0,0,0,0,0,0,1,0,0,1,1
3511,83283,PBR461hkZjzKwEmSOTgV69v6hIW4qt59,RXDvfPUBYFlVdlueBFbLW0mhhAyGEqpt,24,19,9,16,4,1,7,1,57,8.142857142857142,1,0.0,3,9,16,4,16,1,0,7,1,32,25,1
3512,83331,tZgqnNO14y5iwFiuSmSN0mwYH2PCGkQ9,5X6FeZozNMgE2VRi3MJYjkkFK8SETtu2,2,0,0,0,0,0,2,0,2,0.2857142857142857,1,0.0,0,0,0,0,0,0,0,2,0,0,2,1
3513,83343,gFQthJ0fgeQ9ZBHD40PszFOUEAsK6l6q,RXDvfPUBYFlVdlueBFbLW0mhhAyGEqpt,2,0,0,0,0,0,2,0,2,0.2857142857142857,1,0.0,0,0,0,0,0,0,0,2,0,0,2,1
3514,83411,sw7EOsxnjfyxD0QxJsjO2WXRMXBWJD2E,bWdj2GDclj5ofokWjzoa5jAwMkxCykd6,1,1,0,0,0,0,0,0,1,0.14285714285714285,1,0.0,0,0,0,0,1,0,0,0,0,0,1,1
3515,83414,YZ6ePHRxhdDlYW5sZ3zGIsdrka7l3wAZ,RXDvfPUBYFlVdlueBFbLW0mhhAyGEqpt,13,12,6,0,3,2,8,0,31,4.428571428571429,1,0.0,3,6,0,3,9,2,0,8,0,12,19,1
3516,83448,KRLjLXKoKEagD4g49Zuzvz0geq7JPqfn,5X6FeZozNMgE2VRi3MJYjkkFK8SETtu2,5,2,1,0,0,0,4,0,7,1.0,1,0.0,0,1,0,0,2,0,0,4,0,1,6,1
3517,83531,g1LVeBlQiVCOcKiTDDTy4PafQkGd4pbr,SpATywNh6bZuzm8s1ceuBUnMUAeoAHHw,12,12,7,13,1,0,1,0,34,4.857142857142857,1,0.0,3,7,13,1,9,0,0,1,0,24,10,1
3518,83613,puN480TO3qbGXrXmM5qoOdmstQ51OC6E,bWdj2GDclj5ofokWjzoa5jAwMkxCykd6,3,0,0,0,0,1,3,0,4,0.5714285714285714,2,0.0,0,0,0,0,0,1,0,3,0,0,4,0
3519,83623,H6I6nkJ6DtlIXdQ1opNRFdSYIFjksvYQ,SpATywNh6bZuzm8s1ceuBUnMUAeoAHHw,11,6,4,0,4,0,1,0,15,2.142857142857143,1,0.0,0,4,0,4,6,0,0,1,0,8,7,1
3520,83655,gGPwEyB8WM9RKY8d6MZCxjfZZkbEQNgr,5X6FeZozNMgE2VRi3MJYjkkFK8SETtu2,1,0,0,0,0,0,1,0,1,0.14285714285714285,1,0.0,0,0,0,0,0,0,0,1,0,0,1,1
3521,83793,YCIW1D7RWQYUKFuPMYan9yYkXr9VpOGv,G8EPVSXsOYB5YQWZGiz1aVq5Pgr2GrQu,11,13,8,0,7,4,6,1,39,5.571428571428571,1,0.0,4,8,0,7,9,4,0,6,1,19,20,1
3522,83835,dTKOgYhMZbwlt2pFccvIYlq8JuGDHG7Q,RXDvfPUBYFlVdlueBFbLW0mhhAyGEqpt,4,3,0,0,0,0,2,0,5,0.7142857142857143,1,0.0,0,0,0,0,3,0,0,2,0,0,5,1
3523,83895,e12uQn96OlYfknMdqSXCXdImglIj4IRR,RXDvfPUBYFlVdlueBFbLW0mhhAyGEqpt,1,0,0,0,0,0,1,0,1,0.14285714285714285,1,0.0,0,0,0,0,0,0,0,1,0,0,1,1
3524,83909,lQbf9gXsN1R7oTfmD8ApJzd1F5wN4xv1,RXDvfPUBYFlVdlueBFbLW0mhhAyGEqpt,14,8,7,0,5,0,2,0,22,3.142857142857143,1,0.0,0,7,0,5,8,0,0,2,0,12,10,1
3525,83919,mFpiELMd2y5tbkdxs4m8pKS7gXHb7bIO,RXDvfPUBYFlVdlueBFbLW0mhhAyGEqpt,12,13,6,16,6,0,1,0,42,6.0,1,0.0,3,6,13,6,10,0,3,1,0,28,14,1
3526,83938,oHe1wMZnf3Xtw691VYSqBDjM0Y2gPZAD,5X6FeZozNMgE2VRi3MJYjkkFK8SETtu2,2,0,0,0,0,0,2,0,2,0.2857142857142857,1,0.0,0,0,0,0,0,0,0,2,0,0,2,1
3527,83979,sTq9v868sPUgTaUUmCiFRadbl8t0UoCG,SpATywNh6bZuzm8s1ceuBUnMUAeoAHHw,19,16,10,8,5,0,4,0,43,6.142857142857143,1,0.0,2,10,8,5,14,0,0,4,0,25,18,1
3528,83991,HBNOGDmQrCA8ZCNHwMOm4mGR9448iscJ,5X6FeZozNMgE2VRi3MJYjkkFK8SETtu2,7,12,2,1,5,0,3,0,23,3.2857142857142856,1,0.0,7,2,1,5,5,0,0,3,0,15,8,1
3529,84030,0mQ8vyh0MNjPYyaHoBBFRDIFwsi9hZxK,G8EPVSXsOYB5YQWZGiz1aVq5Pgr2GrQu,6,6,3,0,0,0,2,0,11,1.5714285714285714,1,0.0,0,3,0,0,6,0,0,2,0,3,8,1
3530,84159,n51reZ5FTJkHLnQwBqURrmxGDzwEsEjy,SpATywNh6bZuzm8s1ceuBUnMUAeoAHHw,35,51,25,37,11,1,15,0,140,20.0,4,0.0,17,25,28,11,34,1,9,15,0,81,59,0
3531,84161,n51reZ5FTJkHLnQwBqURrmxGDzwEsEjy,G8EPVSXsOYB5YQWZGiz1aVq5Pgr2GrQu,6,2,0,0,0,0,4,0,6,0.8571428571428571,1,0.0,0,0,0,0,2,0,0,4,0,0,6,0
3532,84176,Xv4cOEYZEExzsBdbjc8lrCLUZHXLo5uk,SpATywNh6bZuzm8s1ceuBUnMUAeoAHHw,2,0,1,0,0,28,2,0,31,4.428571428571429,2,0.0,0,1,0,0,0,28,0,2,0,1,30,0
3533,84181,hmcgRc8JOAvEq0tlG5ocKNmIcTSbfNMw,5X6FeZozNMgE2VRi3MJYjkkFK8SETtu2,9,6,3,0,1,0,12,2,24,3.4285714285714284,2,0.0,0,3,0,1,6,0,0,12,2,4,20,1
3534,84268,MaxCNnPaLK24RRWF9HKJTqddyOCcvhNc,fbPkOYLVPtPgIt0MxizjfFJov3JbHyAi,7,5,3,0,2,0,1,0,11,1.5714285714285714,1,0.0,1,3,0,2,4,0,0,1,0,6,5,1
3535,84279,IKnWhfStgn6HzF4rCtxpMA6vaE95bkoN,fbPkOYLVPtPgIt0MxizjfFJov3JbHyAi,3,2,1,0,0,0,1,0,4,0.5714285714285714,1,0.0,0,1,0,0,2,0,0,1,0,1,3,1
3536,84285,6dxWIDqaYjsp7lwDHFYen9IBERKYGMUl,fbPkOYLVPtPgIt0MxizjfFJov3JbHyAi,3,1,1,0,1,0,0,0,3,0.42857142857142855,1,0.0,0,1,0,1,1,0,0,0,0,2,1,1
3537,84531,UwNh19bGTGX7YEBtcKZFqxDpmh2gUs3A,SpATywNh6bZuzm8s1ceuBUnMUAeoAHHw,20,32,18,10,8,0,11,0,79,11.285714285714286,5,0.0,5,18,10,8,27,0,0,11,0,41,38,0
3538,84824,CCr7XJJW4dK2W5QL9m4z2ZC42b4ulnok,SpATywNh6bZuzm8s1ceuBUnMUAeoAHHw,18,20,15,0,8,0,6,0,49,7.0,2,0.0,0,15,0,8,20,0,0,6,0,23,26,0
3539,85101,eUiPnt4yNOhbT6A4YKzKQWtxymmKMqK8,SpATywNh6bZuzm8s1ceuBUnMUAeoAHHw,5,2,2,0,1,0,2,0,7,1.0,2,0.0,0,2,0,1,2,0,0,2,0,3,4,0
3540,85161,bjM6n8DVZxyRbCs3zMbeKGW5iCOjCuf2,SpATywNh6bZuzm8s1ceuBUnMUAeoAHHw,24,24,16,15,10,0,2,0,67,9.571428571428571,6,0.0,2,16,13,10,22,0,2,2,0,41,26,0
3541,85214,t5GAapz2qu7QW3ZA52Mo1qG5gvWMLT4H,SpATywNh6bZuzm8s1ceuBUnMUAeoAHHw,3,2,1,0,0,0,1,0,4,0.5714285714285714,1,0.0,0,1,0,0,2,0,0,1,0,1,3,0
3542,85295,Zp1ZZPWn2kKT7nmilqO0Enc4rubJRG8n,SpATywNh6bZuzm8s1ceuBUnMUAeoAHHw,9,11,0,0,0,0,3,0,14,2.0,2,0.0,0,0,0,0,11,0,0,3,0,0,14,0
3543,85434,NcEpl157R9804FU8cPtpCcaWHzDDnaT9,3VkHkmOtom3jM2wCu94xgzzu1d6Dn7or,18,11,7,0,9,0,2,0,29,4.142857142857143,1,0.0,3,7,0,9,8,0,0,2,0,19,10,1
3544,85529,FGDAOKCQeh2COlf4gWhhsBCjdm5IkOal,3VkHkmOtom3jM2wCu94xgzzu1d6Dn7or,15,27,1,14,4,6,6,3,61,8.714285714285714,2,0.0,5,1,11,4,22,6,3,6,3,21,40,1
3545,85532,2n3uQwvGODQH4qmEUpmLUpr9RcDmEzfa,3VkHkmOtom3jM2wCu94xgzzu1d6Dn7or,16,13,7,0,6,0,7,0,33,4.714285714285714,1,0.0,4,7,0,6,9,0,0,7,0,17,16,1
3546,85566,y0ATBl8yDJnpmNzHNjpBIQ57CPs3LH6g,3VkHkmOtom3jM2wCu94xgzzu1d6Dn7or,8,6,1,4,2,1,1,0,15,2.142857142857143,1,0.0,1,1,3,2,5,1,1,1,0,7,8,1
3547,85609,daRNgrfSmtLtouStkwCortm8nv14xS31,3VkHkmOtom3jM2wCu94xgzzu1d6Dn7or,13,21,14,0,0,1,7,3,46,6.571428571428571,6,0.0,0,14,0,0,21,1,0,7,3,14,32,1
3548,85622,nn6jPlyrAIUIfYmerqepUfWdtAla0t7z,3VkHkmOtom3jM2wCu94xgzzu1d6Dn7or,1,0,0,0,0,0,1,0,1,0.14285714285714285,1,0.0,0,0,0,0,0,0,0,1,0,0,1,1
3549,85647,adsofsgiOwHfX7QscwvevqNp9Uv4CLo9,3VkHkmOtom3jM2wCu94xgzzu1d6Dn7or,7,2,1,0,1,0,6,0,10,1.4285714285714286,2,0.0,0,1,0,1,2,0,0,6,0,2,8,1
3550,85655,TusMPaNX8e6lAdKqrk2YZunhumeGuKss,3VkHkmOtom3jM2wCu94xgzzu1d6Dn7or,9,14,6,0,3,1,11,1,36,5.142857142857143,1,0.0,1,6,0,3,13,1,0,11,1,10,26,1
3551,85682,9W0hzIqg3d3SzHPxHA9rdc1qeF58DGnz,3VkHkmOtom3jM2wCu94xgzzu1d6Dn7or,55,75,24,44,34,0,20,0,197,28.142857142857142,3,0.0,44,24,35,34,31,0,9,20,0,137,60,1
3552,85706,0bRU3XUyuTRq2qF8MuiGBvstwQnWOcTL,3VkHkmOtom3jM2wCu94xgzzu1d6Dn7or,14,15,4,8,2,5,13,0,47,6.714285714285714,2,0.0,8,4,6,2,7,5,2,13,0,20,27,1
3553,85709,qhmgArW8a15UOGQrFTosGi03wE1TjPeN,3VkHkmOtom3jM2wCu94xgzzu1d6Dn7or,5,7,1,0,3,0,2,0,13,1.8571428571428572,1,0.0,5,1,0,3,2,0,0,2,0,9,4,1
3554,85765,BxzeEtLTtyqT2N1wOyGgAZOqrYSFmc9w,3VkHkmOtom3jM2wCu94xgzzu1d6Dn7or,10,33,11,3,6,2,10,0,65,9.285714285714286,2,0.0,17,11,3,6,16,2,0,10,0,37,28,0
3555,85785,5GVGPrErUniOXoCARApOCu7A41eMjYCN,3VkHkmOtom3jM2wCu94xgzzu1d6Dn7or,9,15,8,0,3,0,4,0,30,4.285714285714286,2,0.0,0,8,0,3,15,0,0,4,0,11,19,1
3556,85814,wy2vY5aiYwg0C5zglGAXrG2vaWLSbGC9,3VkHkmOtom3jM2wCu94xgzzu1d6Dn7or,1,0,0,0,0,0,1,0,1,0.14285714285714285,1,0.0,0,0,0,0,0,0,0,1,0,0,1,0
3557,85823,QBVMiTddprVHVCuwpdN5G4YkLbvf6jNG,3VkHkmOtom3jM2wCu94xgzzu1d6Dn7or,14,44,20,0,4,0,7,0,75,10.714285714285714,3,0.0,3,20,0,4,41,0,0,7,0,27,48,1
3558,85838,tU02Y4LN7vwr546RBpAZKZPf8ZcDxVkR,3VkHkmOtom3jM2wCu94xgzzu1d6Dn7or,1,0,0,0,0,0,1,0,1,0.14285714285714285,1,0.0,0,0,0,0,0,0,0,1,0,0,1,1
3559,85894,GhT3L3BlZcRJQklHCjpGRwGxiZWYsOhL,3VkHkmOtom3jM2wCu94xgzzu1d6Dn7or,64,131,40,46,54,4,12,0,287,41.0,8,0.0,70,40,44,54,61,4,2,12,0,208,79,0
3560,85942,rkXypKKijSCgNkdsUitujuud51W3iT9z,3VkHkmOtom3jM2wCu94xgzzu1d6Dn7or,32,34,19,20,14,8,9,1,105,15.0,2,0.0,8,19,18,14,26,8,2,9,1,59,46,0
3561,85959,v5AGeSJAXp4KXlmz8iqonrrJtCVn5C1s,3VkHkmOtom3jM2wCu94xgzzu1d6Dn7or,1,0,0,0,0,0,1,0,1,0.14285714285714285,1,0.0,0,0,0,0,0,0,0,1,0,0,1,1
3562,85965,eVsh2PvhGosDbgLKjO5vTcXmt553P6t2,3VkHkmOtom3jM2wCu94xgzzu1d6Dn7or,37,50,14,32,20,7,5,1,129,18.428571428571427,2,0.0,34,14,32,20,16,7,0,5,1,100,29,1
3563,85982,kqDqbU5eyXy2rfhHbl8FwFgfUq7w77zy,3VkHkmOtom3jM2wCu94xgzzu1d6Dn7or,7,5,3,0,2,0,5,0,15,2.142857142857143,2,0.0,0,3,0,2,5,0,0,5,0,5,10,0
3564,85998,LSNtbovTcgFnEMpuzvsjNhH7WJWF5QKQ,3VkHkmOtom3jM2wCu94xgzzu1d6Dn7or,15,24,4,6,9,0,10,0,53,7.571428571428571,2,0.0,19,4,6,9,5,0,0,10,0,38,15,1
3565,86087,0B5UC4zYQ9vCeDhBDIKJCGXVsyRds3Qg,3VkHkmOtom3jM2wCu94xgzzu1d6Dn7or,1,0,0,0,0,0,1,0,1,0.14285714285714285,1,0.0,0,0,0,0,0,0,0,1,0,0,1,1
3566,86212,HbSMY2nbJO0smuDvXqFVrZ4a2ObiucPS,3VkHkmOtom3jM2wCu94xgzzu1d6Dn7or,68,241,54,47,99,9,48,4,502,71.71428571428571,5,0.0,165,54,40,99,76,9,7,48,4,358,144,0
3567,86292,4kkWjBt7B7bmXLtwav57q4XM0lEHf94s,3VkHkmOtom3jM2wCu94xgzzu1d6Dn7or,1,0,0,0,0,0,2,0,2,0.2857142857142857,1,0.0,0,0,0,0,0,0,0,2,0,0,2,1
3568,86308,rSv3OR7jCKwfSFp62c6q16303WTPlIxJ,3VkHkmOtom3jM2wCu94xgzzu1d6Dn7or,4,3,2,0,2,0,1,0,8,1.1428571428571428,1,0.0,0,2,0,2,3,0,0,1,0,4,4,1
3569,86312,H7N61Yol2XG6wyMnfL2nuTS8QWac9JzQ,3VkHkmOtom3jM2wCu94xgzzu1d6Dn7or,64,120,31,67,34,37,53,7,349,49.857142857142854,8,0.0,49,31,54,34,71,37,13,53,7,168,181,0
3570,86467,FjCtMN4WglGS4lMQQqXj5JLoBzJsvRvD,3VkHkmOtom3jM2wCu94xgzzu1d6Dn7or,16,9,6,0,8,0,5,0,28,4.0,1,0.0,2,6,0,8,7,0,0,5,0,16,12,1
3571,86488,ZGyMg7rbLHWRogBAey2xT34v9UyIo90H,3VkHkmOtom3jM2wCu94xgzzu1d6Dn7or,1,0,0,0,0,0,1,0,1,0.14285714285714285,1,0.0,0,0,0,0,0,0,0,1,0,0,1,1
3572,86516,nJMJoh9Afu7XIAXPPKQYptCnctYQcc7F,3VkHkmOtom3jM2wCu94xgzzu1d6Dn7or,69,132,48,64,41,20,28,0,333,47.57142857142857,6,0.0,59,48,63,41,73,20,1,28,0,211,122,0
3573,86521,4UpTY7turz6kUjS8aIK7ZcBu6trtflcP,3VkHkmOtom3jM2wCu94xgzzu1d6Dn7or,5,3,0,0,1,0,3,0,7,1.0,1,0.0,1,0,0,1,2,0,0,3,0,2,5,1
3574,86565,CvLT3YILCbLXFQ58IMX32bp5ZEG9n5SA,3VkHkmOtom3jM2wCu94xgzzu1d6Dn7or,1,0,0,0,0,0,1,0,1,0.14285714285714285,1,0.0,0,0,0,0,0,0,0,1,0,0,1,1
3575,86697,o8kHR47syKKEbYoWQpVJ0TZ0kXlfuaxo,3VkHkmOtom3jM2wCu94xgzzu1d6Dn7or,20,40,15,12,10,9,14,3,103,14.714285714285714,4,0.0,10,15,11,10,30,9,1,14,3,46,57,1
3576,86701,WDS64nhmHwlf65CqTzFkZi8usz3vW8uG,3VkHkmOtom3jM2wCu94xgzzu1d6Dn7or,26,56,22,12,23,21,18,2,154,22.0,6,0.0,28,22,11,23,28,21,1,18,2,84,70,1
3577,86716,88xEaCKi28LUY3tcrbwFpAmHOL0vcOsT,3VkHkmOtom3jM2wCu94xgzzu1d6Dn7or,5,2,1,0,1,0,4,0,8,1.1428571428571428,1,0.0,0,1,0,1,2,0,0,4,0,2,6,1
3578,86718,7FjZmoBV65DUuLOO4Ql2IC3wfSwmf2yZ,3VkHkmOtom3jM2wCu94xgzzu1d6Dn7or,3,0,0,0,0,0,6,0,6,0.8571428571428571,1,0.0,0,0,0,0,0,0,0,6,0,0,6,1
3579,86746,laZtrdxzAU1QbcDNiYt367rO7zb5NT6r,3VkHkmOtom3jM2wCu94xgzzu1d6Dn7or,43,43,3,15,27,4,12,0,104,14.857142857142858,4,0.0,10,3,13,27,33,4,2,12,0,53,51,1
3580,86838,ajNOW5AXfH78DqTXcU1iD05dzS5R5r68,3VkHkmOtom3jM2wCu94xgzzu1d6Dn7or,5,2,1,0,1,2,2,0,8,1.1428571428571428,1,0.0,0,1,0,1,2,2,0,2,0,2,6,1
3581,86920,dlY4SLb04pXb8FpioE0PFiOnxRP0zsB6,bWdj2GDclj5ofokWjzoa5jAwMkxCykd6,18,24,12,28,10,0,12,0,86,12.285714285714286,1,0.0,7,12,27,10,17,0,1,12,0,56,30,0
3582,86924,azWWltiu0kGq6xVNQvuXbRB1jFWFhQiW,SpATywNh6bZuzm8s1ceuBUnMUAeoAHHw,8,2,1,0,1,9,8,1,22,3.142857142857143,1,0.0,0,1,0,1,2,9,0,8,1,2,20,1
3583,86925,dNB9ZoXQ4IxShr9VGNYfbvHSzaJrjM2G,SpATywNh6bZuzm8s1ceuBUnMUAeoAHHw,6,2,1,0,1,0,3,0,7,1.0,1,0.0,0,1,0,1,2,0,0,3,0,2,5,1
3584,86959,hnwcoA7O4v4hJGof4lKuyaYl8MzIunje,RXDvfPUBYFlVdlueBFbLW0mhhAyGEqpt,1,0,0,0,0,0,1,0,1,0.14285714285714285,1,0.0,0,0,0,0,0,0,0,1,0,0,1,1
3585,86978,w4c5I9GnSWI6sLkTNrP2S1NFytPszceZ,SpATywNh6bZuzm8s1ceuBUnMUAeoAHHw,2,0,0,0,0,0,2,0,2,0.2857142857142857,1,0.0,0,0,0,0,0,0,0,2,0,0,2,1
3586,86996,hXvrvs517Cljnw9n8TIqf0EZFGKj5tLN,5X6FeZozNMgE2VRi3MJYjkkFK8SETtu2,1,0,0,0,0,0,1,0,1,0.14285714285714285,1,0.0,0,0,0,0,0,0,0,1,0,0,1,1
3587,87014,7rP408Gy6dVEeyQ5Me3hr5GFRnqOotmL,5X6FeZozNMgE2VRi3MJYjkkFK8SETtu2,14,15,6,17,8,0,1,0,47,6.714285714285714,1,0.0,8,6,16,8,7,0,1,1,0,38,9,1
3588,87025,VjwlU2NuV92v39dW9G2CTHWhjQLOkz09,SpATywNh6bZuzm8s1ceuBUnMUAeoAHHw,6,2,1,6,0,0,4,0,13,1.8571428571428572,1,0.0,1,1,5,0,1,0,1,4,0,7,6,1
3589,87041,CyaWOS6YRjNFYn2xWAzIcRZhnN3MiwBK,bWdj2GDclj5ofokWjzoa5jAwMkxCykd6,2,0,0,0,0,0,3,0,3,0.42857142857142855,1,0.0,0,0,0,0,0,0,0,3,0,0,3,1
3590,87044,BcU9hDrDz2F2xEd3tqF67ZptaAdextzP,SpATywNh6bZuzm8s1ceuBUnMUAeoAHHw,6,3,2,0,1,0,2,0,8,1.1428571428571428,1,0.0,0,2,0,1,3,0,0,2,0,3,5,1
3591,87057,SWjmkEB4DVctTeY4CrwF2QrGDf4olJAZ,RXDvfPUBYFlVdlueBFbLW0mhhAyGEqpt,40,49,27,44,13,13,4,0,150,21.428571428571427,1,0.0,14,27,40,13,35,13,4,4,0,94,56,0
3592,87082,w37wSK655FONLskeVHZ1T8H2i8llhkAq,G8EPVSXsOYB5YQWZGiz1aVq5Pgr2GrQu,4,2,1,0,1,0,1,0,5,0.7142857142857143,1,0.0,0,1,0,1,2,0,0,1,0,2,3,1
3593,87092,cvLRW70I7pg14FqJq72xv9mGj0ykphI3,RXDvfPUBYFlVdlueBFbLW0mhhAyGEqpt,2,0,0,0,0,0,2,0,2,0.2857142857142857,1,0.0,0,0,0,0,0,0,0,2,0,0,2,1
3594,87111,fDs5TBVrvPHEIMLkBACIVQ2YkCdHCFLD,SpATywNh6bZuzm8s1ceuBUnMUAeoAHHw,30,18,13,36,9,0,1,0,77,11.0,1,0.0,4,13,30,9,14,0,6,1,0,56,21,1
3595,87127,dNFEIzn0depAU4oAUIlHxTqSNcin3JsM,SpATywNh6bZuzm8s1ceuBUnMUAeoAHHw,22,36,19,20,8,3,4,0,90,12.857142857142858,1,0.0,5,19,16,8,31,3,4,4,0,48,42,0
3596,87133,O6WL6sxvoPCZnvTLyTPxdXbnpOz3wcJ4,A3fsA9Zfv1X2fVEQhTw51lKENdNrEqT3,10,11,2,0,0,0,1,0,14,2.0,1,0.0,0,2,0,0,11,0,0,1,0,2,12,0
3597,87172,2IZplhFWCKQEDbE9J9WJIgAOtpboZ9NN,SpATywNh6bZuzm8s1ceuBUnMUAeoAHHw,9,6,2,16,0,0,2,0,26,3.7142857142857144,1,0.0,2,2,13,0,4,0,3,2,0,17,9,0
3598,87239,A2D3C1FcNOBr8y076zlBriwfkHqZpxS1,bWdj2GDclj5ofokWjzoa5jAwMkxCykd6,5,4,1,0,1,0,3,0,9,1.2857142857142858,1,0.0,0,1,0,1,4,0,0,3,0,2,7,1
3599,87256,d1MkRkjya7ojtBlNRk0Ce9ymSIOXU3g7,5X6FeZozNMgE2VRi3MJYjkkFK8SETtu2,2,0,0,0,0,0,2,0,2,0.2857142857142857,1,0.0,0,0,0,0,0,0,0,2,0,0,2,1
3600,87281,8fWrC0LYUq5E0gzy0gw2GD73h6o6q5AG,SpATywNh6bZuzm8s1ceuBUnMUAeoAHHw,6,6,2,0,1,0,2,0,11,1.5714285714285714,2,0.0,0,2,0,1,6,0,0,2,0,3,8,0
3601,87299,FAoxohux4KAbCMqDQtj7sPQxwJsqSUyC,SpATywNh6bZuzm8s1ceuBUnMUAeoAHHw,9,7,4,0,2,0,3,0,16,2.2857142857142856,1,0.0,1,4,0,2,6,0,0,3,0,7,9,1
3602,87340,wZ8eZfOlrtOXqI3tTYpJnSmt7Os4oaRx,RXDvfPUBYFlVdlueBFbLW0mhhAyGEqpt,5,4,2,0,0,2,2,1,11,1.5714285714285714,1,0.0,0,2,0,0,4,2,0,2,1,2,9,1
3603,87349,FrSJpsrFHBf3i9duciIn6pd6hWdG8OCf,SpATywNh6bZuzm8s1ceuBUnMUAeoAHHw,9,5,4,0,3,0,1,0,13,1.8571428571428572,1,0.0,0,4,0,3,5,0,0,1,0,7,6,1
3604,87383,7zKNYNlQe19MsOrdmzXSTtaqDWKHEPlA,SpATywNh6bZuzm8s1ceuBUnMUAeoAHHw,4,3,0,0,0,0,2,0,5,0.7142857142857143,1,0.0,0,0,0,0,3,0,0,2,0,0,5,0
3605,87421,lWBSCWTjFeDriAjRZOz3KVaFyBg77dro,bWdj2GDclj5ofokWjzoa5jAwMkxCykd6,1,0,0,0,0,0,2,0,2,0.2857142857142857,1,0.0,0,0,0,0,0,0,0,2,0,0,2,1
3606,87440,MvkQjmVQSq3aFQKnqlTw1GsAe1sz0UUt,RXDvfPUBYFlVdlueBFbLW0mhhAyGEqpt,7,6,2,0,1,0,4,1,14,2.0,1,0.0,1,2,0,1,5,0,0,4,1,4,10,1
3607,87477,aFTPPSrpKJeQuDqH9FpABVz42ARJX2Kq,SpATywNh6bZuzm8s1ceuBUnMUAeoAHHw,8,4,2,0,2,1,7,0,16,2.2857142857142856,1,0.0,0,2,0,2,4,1,0,7,0,4,12,0
3608,87508,xXDqyIqXIbFjQafgcDr19GZJ6qivDzJJ,SpATywNh6bZuzm8s1ceuBUnMUAeoAHHw,1,0,0,0,0,0,1,0,1,0.14285714285714285,1,0.0,0,0,0,0,0,0,0,1,0,0,1,1
3609,87512,BZDgBaeH4hpBLNYHUpEIDhiLF0fTz03H,SpATywNh6bZuzm8s1ceuBUnMUAeoAHHw,1,0,0,0,0,0,1,0,1,0.14285714285714285,1,0.0,0,0,0,0,0,0,0,1,0,0,1,1
3610,87534,NLUFE7ndaVQ8A2tkIa8xBpPqWZbahAYT,RXDvfPUBYFlVdlueBFbLW0mhhAyGEqpt,1,0,0,0,0,0,1,0,1,0.14285714285714285,1,0.0,0,0,0,0,0,0,0,1,0,0,1,1
3611,87577,D5tphcPtrm2Mbn1NpKk68I5EI1kP65wT,SpATywNh6bZuzm8s1ceuBUnMUAeoAHHw,1,0,0,0,0,0,1,0,1,0.14285714285714285,1,0.0,0,0,0,0,0,0,0,1,0,0,1,0
3612,87583,HNexnUMIVuihEumD8iCCcXwKN5sDVlaT,SpATywNh6bZuzm8s1ceuBUnMUAeoAHHw,5,2,1,0,1,0,2,0,6,0.8571428571428571,1,0.0,0,1,0,1,2,0,0,2,0,2,4,1
3613,87596,omogDjehriHed7WOB06lowOCzWJT5HFG,SpATywNh6bZuzm8s1ceuBUnMUAeoAHHw,2,0,0,0,0,0,3,0,3,0.42857142857142855,1,0.0,0,0,0,0,0,0,0,3,0,0,3,1
3614,87652,CeA39yEXem4lTmymvIZvr20kWcsmIjJE,SpATywNh6bZuzm8s1ceuBUnMUAeoAHHw,13,15,5,29,0,0,1,0,50,7.142857142857143,1,0.0,8,5,28,0,7,0,1,1,0,41,9,0
3615,87653,nMHyPhMUwBV2X9BZYL9XoLMstUlTViSe,RXDvfPUBYFlVdlueBFbLW0mhhAyGEqpt,48,59,38,116,23,13,18,11,278,39.714285714285715,2,0.0,13,38,103,23,46,13,13,18,11,177,101,1
3616,87671,4x6GtPVJRzG6NeLl0iwOroVi4VyJ90BC,5X6FeZozNMgE2VRi3MJYjkkFK8SETtu2,11,19,6,0,13,0,3,0,41,5.857142857142857,1,0.0,12,6,0,13,7,0,0,3,0,31,10,1
3617,87686,Qan5qFXAXs8GLcj3GbJmOFAYcVVfTLN4,G8EPVSXsOYB5YQWZGiz1aVq5Pgr2GrQu,6,4,1,0,1,0,2,0,8,1.1428571428571428,1,0.0,0,1,0,1,4,0,0,2,0,2,6,1
3618,87691,9vlKLLRVHTgTa2OMtndxw1oJeJABVSGY,RXDvfPUBYFlVdlueBFbLW0mhhAyGEqpt,4,3,1,0,1,0,1,0,6,0.8571428571428571,1,0.0,0,1,0,1,3,0,0,1,0,2,4,0
3619,87724,LC5o73xONnaYfCUJGUgN0IxEKcRaag3p,SpATywNh6bZuzm8s1ceuBUnMUAeoAHHw,5,5,2,0,1,0,2,0,10,1.4285714285714286,2,0.0,0,2,0,1,5,0,0,2,0,3,7,1
3620,87747,3eCrefA6S0GFWcJo3ZhXIr7YDAOe11ar,SpATywNh6bZuzm8s1ceuBUnMUAeoAHHw,10,24,6,0,4,0,9,0,43,6.142857142857143,1,0.0,0,6,0,4,24,0,0,9,0,10,33,1
3621,87751,Yz0bwUTqexNxC4HobmGskCKKLAbIJfs7,SpATywNh6bZuzm8s1ceuBUnMUAeoAHHw,7,9,3,0,2,0,3,0,17,2.4285714285714284,1,0.0,0,3,0,2,9,0,0,3,0,5,12,0
3622,87775,Tk65NSEWZoGK32sB9eYUeC558zBlLPIW,RXDvfPUBYFlVdlueBFbLW0mhhAyGEqpt,21,27,16,0,11,0,3,0,57,8.142857142857142,1,0.0,2,16,0,11,25,0,0,3,0,29,28,0
3623,87778,XRprdFoWtySQSNhPZow4aE4x8DdY6QhU,5X6FeZozNMgE2VRi3MJYjkkFK8SETtu2,1,0,0,0,0,0,1,0,1,0.14285714285714285,1,0.0,0,0,0,0,0,0,0,1,0,0,1,1
3624,87799,1RoXT5oo7vXl8wsABrWJayraZG4Kbt0j,G8EPVSXsOYB5YQWZGiz1aVq5Pgr2GrQu,7,6,1,0,1,0,2,0,10,1.4285714285714286,1,0.0,0,1,0,1,6,0,0,2,0,2,8,1
3625,87801,ybCLsk9Msj6dJWTi2FpV3ALPCproUUQQ,SpATywNh6bZuzm8s1ceuBUnMUAeoAHHw,37,85,37,17,22,0,5,0,166,23.714285714285715,2,0.0,0,37,15,22,85,0,2,5,0,74,92,1
3626,87802,3JEt0I9b0JhZhM0RD2D5jI5S8zjjeHFo,SpATywNh6bZuzm8s1ceuBUnMUAeoAHHw,9,23,0,0,0,0,8,1,32,4.571428571428571,2,0.0,3,0,0,0,20,0,0,8,1,3,29,0
3627,87810,LUqnLB6pHqixI8DskOSCGDCSJG5xMI09,5X6FeZozNMgE2VRi3MJYjkkFK8SETtu2,1,0,0,0,0,0,1,0,1,0.14285714285714285,1,0.0,0,0,0,0,0,0,0,1,0,0,1,1
3628,87829,VfnlXxgrKiV5S4yyfjofuTKy4kFmuejg,G8EPVSXsOYB5YQWZGiz1aVq5Pgr2GrQu,12,14,5,0,4,1,2,1,27,3.857142857142857,1,0.0,8,5,0,4,6,1,0,2,1,17,10,1
3629,87847,1fleh7lPd7aghMITlPRITTq0TKiljgoj,SpATywNh6bZuzm8s1ceuBUnMUAeoAHHw,5,2,1,0,1,0,2,0,6,0.8571428571428571,1,0.0,0,1,0,1,2,0,0,2,0,2,4,1
3630,87850,6jOnaSO84O48bNZ0vcTgSwev3DFkgwRP,SpATywNh6bZuzm8s1ceuBUnMUAeoAHHw,26,20,10,43,4,12,3,1,93,13.285714285714286,2,0.0,9,10,39,4,11,12,4,3,1,62,31,1
3631,87855,lDTrM1jNBMje9jFcFb97CQaIN7Du94MZ,SpATywNh6bZuzm8s1ceuBUnMUAeoAHHw,5,5,1,0,1,0,1,0,8,1.1428571428571428,1,0.0,1,1,0,1,4,0,0,1,0,3,5,1
3632,87860,Uggn85R7OMhc9c2ThQoRc9ji4ASPnsWa,SpATywNh6bZuzm8s1ceuBUnMUAeoAHHw,45,74,32,24,16,0,12,0,158,22.571428571428573,6,0.0,29,32,23,16,45,0,1,12,0,100,58,0
3633,87862,u451eR3YoMJd6QtNuJrcpr5u8rFRmkMn,5X6FeZozNMgE2VRi3MJYjkkFK8SETtu2,52,69,18,98,20,0,16,0,221,31.571428571428573,3,0.0,45,18,81,20,24,0,17,16,0,164,57,0
3634,87908,QpmV03oJO6WK2YZdkJ97NR0SlUMknV6U,5X6FeZozNMgE2VRi3MJYjkkFK8SETtu2,2,0,0,0,0,0,2,0,2,0.2857142857142857,1,0.0,0,0,0,0,0,0,0,2,0,0,2,1
3635,87909,QpmV03oJO6WK2YZdkJ97NR0SlUMknV6U,bWdj2GDclj5ofokWjzoa5jAwMkxCykd6,2,0,0,0,0,0,2,0,2,0.2857142857142857,1,0.0,0,0,0,0,0,0,0,2,0,0,2,1
3636,87912,j9L0wsMRR1iguKEo2FSLNGEw5WM5csHy,SpATywNh6bZuzm8s1ceuBUnMUAeoAHHw,14,26,10,11,1,0,2,0,50,7.142857142857143,2,0.0,4,10,11,1,22,0,0,2,0,26,24,0
3637,88021,6SxHc7KyNhODmzDiMYRH8E1DtbUhu3YG,5X6FeZozNMgE2VRi3MJYjkkFK8SETtu2,5,2,1,0,1,0,2,0,6,0.8571428571428571,1,0.0,0,1,0,1,2,0,0,2,0,2,4,1
3638,88034,DZjkP3yl2SFuyGy8c50KQgIUMnSURcDF,RXDvfPUBYFlVdlueBFbLW0mhhAyGEqpt,1,0,0,0,0,0,1,0,1,0.14285714285714285,1,0.0,0,0,0,0,0,0,0,1,0,0,1,1
3639,88040,VLhzRXmIp41Zu0NqJ5vPW4W5QyiaokHv,SpATywNh6bZuzm8s1ceuBUnMUAeoAHHw,5,7,0,0,0,0,2,0,9,1.2857142857142858,1,0.0,2,0,0,0,5,0,0,2,0,2,7,1
3640,88051,x44blDMbARj16T0tLu8ojXSHZTWR98Zp,bWdj2GDclj5ofokWjzoa5jAwMkxCykd6,9,7,3,12,4,0,4,0,30,4.285714285714286,1,0.0,3,3,11,4,4,0,1,4,0,21,9,1
3641,88068,Cggympwsvs9lEOL8A1q6sfs1arXxKmUB,5X6FeZozNMgE2VRi3MJYjkkFK8SETtu2,1,0,0,0,0,0,1,0,1,0.14285714285714285,1,0.0,0,0,0,0,0,0,0,1,0,0,1,1
3642,88080,p1UnKsqDeljdQieYNfT9XXKdwcveIfRm,SpATywNh6bZuzm8s1ceuBUnMUAeoAHHw,8,3,1,0,1,0,8,0,13,1.8571428571428572,1,0.0,0,1,0,1,3,0,0,8,0,2,11,1
3643,88096,dCAqk9uHiS99GMTcJQtThG8XWnwwbp5Q,RXDvfPUBYFlVdlueBFbLW0mhhAyGEqpt,1,0,0,0,0,0,1,0,1,0.14285714285714285,1,0.0,0,0,0,0,0,0,0,1,0,0,1,1
3644,88118,syeSTCgAAH8tJhWRmtnRajndKM83APue,SpATywNh6bZuzm8s1ceuBUnMUAeoAHHw,8,13,3,0,1,3,6,0,26,3.7142857142857144,1,0.0,0,3,0,1,13,3,0,6,0,4,22,1
3645,88162,OOFBOlM6ZaTILAeCWdXI68slSU6cTlKl,bWdj2GDclj5ofokWjzoa5jAwMkxCykd6,5,2,1,0,1,0,2,0,6,0.8571428571428571,1,0.0,0,1,0,1,2,0,0,2,0,2,4,1
3646,88172,mB36rXDIKgGQROGEKlrDrvsLRYA6xyWr,A3fsA9Zfv1X2fVEQhTw51lKENdNrEqT3,35,31,11,102,3,8,11,4,170,24.285714285714285,2,0.0,1,11,89,3,30,8,13,11,4,104,66,0
3647,88193,aQvvfNyOjWznHFpUuaLIM1cVrgSp2dSp,SpATywNh6bZuzm8s1ceuBUnMUAeoAHHw,28,49,0,25,0,0,5,0,79,11.285714285714286,1,0.0,16,0,20,0,33,0,5,5,0,36,43,0
3648,88197,Gvc7BFl5Q4FP2VRb1ZvRJI4nuqv9yacP,SpATywNh6bZuzm8s1ceuBUnMUAeoAHHw,7,9,4,2,0,0,10,0,25,3.5714285714285716,2,0.0,2,4,2,0,7,0,0,10,0,8,17,0
3649,88216,M8C9BDFICk4ida59GU0jjp556zazDEi1,RXDvfPUBYFlVdlueBFbLW0mhhAyGEqpt,44,32,17,80,14,4,4,0,151,21.571428571428573,2,0.0,14,17,77,14,18,4,3,4,0,122,29,1
3650,88240,G143rLMrX7l1MbfJDLLZvhDYBv8wXrHZ,SpATywNh6bZuzm8s1ceuBUnMUAeoAHHw,11,19,0,0,0,0,2,0,21,3.0,2,0.0,0,0,0,0,19,0,0,2,0,0,21,1
3651,88254,1YjqOVdQNZSxHR5EL885UCWZImOftZfX,A3fsA9Zfv1X2fVEQhTw51lKENdNrEqT3,9,5,1,0,0,5,17,4,32,4.571428571428571,1,0.0,1,1,0,0,4,5,0,17,4,2,30,1
3652,88270,Vnhhp2QbBiDiUTTHmXkksXuO8NCNMbjj,5X6FeZozNMgE2VRi3MJYjkkFK8SETtu2,6,5,3,0,1,0,4,0,13,1.8571428571428572,3,0.0,0,3,0,1,5,0,0,4,0,4,9,1
3653,88330,73QuojUN1r54MVaUa0AAHmlRM5mMnLEl,5X6FeZozNMgE2VRi3MJYjkkFK8SETtu2,7,2,1,0,1,1,7,1,13,1.8571428571428572,2,0.0,0,1,0,1,2,1,0,7,1,2,11,1
3654,88356,6XBUPIMF9YyCO5fIWCayNsSq26b3yJ4M,5X6FeZozNMgE2VRi3MJYjkkFK8SETtu2,1,0,0,0,0,0,1,0,1,0.14285714285714285,1,0.0,0,0,0,0,0,0,0,1,0,0,1,1
3655,88366,HaeOUOjzB2fPZhdNdMNjxk0y1liPSCWx,5X6FeZozNMgE2VRi3MJYjkkFK8SETtu2,5,25,10,0,1,44,0,0,80,11.428571428571429,5,0.0,6,10,0,1,19,44,0,0,0,17,63,1
3656,88448,mxddHclG25pfuH7gTFa9o1qSfjDhR7YF,5X6FeZozNMgE2VRi3MJYjkkFK8SETtu2,1,0,0,0,0,0,1,0,1,0.14285714285714285,1,0.0,0,0,0,0,0,0,0,1,0,0,1,0
3657,88499,e1tGkDeO91uaKlWrCNpqIEILyijCT8bK,5X6FeZozNMgE2VRi3MJYjkkFK8SETtu2,2,0,0,0,0,0,2,0,2,0.2857142857142857,1,0.0,0,0,0,0,0,0,0,2,0,0,2,1
3658,88673,IxMkPCHATmDvTKBlflfVXyQShfliRdlM,5X6FeZozNMgE2VRi3MJYjkkFK8SETtu2,5,2,1,0,1,0,2,0,6,0.8571428571428571,1,0.0,0,1,0,1,2,0,0,2,0,2,4,1
3659,88719,pg03VLobZ1zAAslEUdBaTgGu7kih28vz,5Gyp41oLVo7Gg7vF4vpmggWP5MU70QO6,4,2,1,0,1,0,1,0,5,0.7142857142857143,1,0.0,0,1,0,1,2,0,0,1,0,2,3,1
3660,88723,8jXdpNwELe6zYEmw5Rus9z5EN32mrGga,5Gyp41oLVo7Gg7vF4vpmggWP5MU70QO6,9,8,5,5,3,0,2,0,23,3.2857142857142856,2,0.0,1,5,3,3,7,0,2,2,0,12,11,1
3661,88737,BLJFHLXwnjQQljzDRwovyptBBJZjkDcS,5Gyp41oLVo7Gg7vF4vpmggWP5MU70QO6,13,11,6,1,4,3,11,2,38,5.428571428571429,2,0.0,1,6,1,4,10,3,0,11,2,12,26,1
3662,88740,7ptXQapperKtaGrSTwmS9x9gqTb4bTDI,5Gyp41oLVo7Gg7vF4vpmggWP5MU70QO6,10,6,5,0,2,2,2,0,17,2.4285714285714284,1,0.0,0,5,0,2,6,2,0,2,0,7,10,1
3663,88765,caCvefNLGLcBW48WUUaJPgAfWsyggEZb,5Gyp41oLVo7Gg7vF4vpmggWP5MU70QO6,1,0,0,0,0,0,1,0,1,0.14285714285714285,1,0.0,0,0,0,0,0,0,0,1,0,0,1,1
3664,88773,UO55TBSgJfKr60l5scHuOub5iflx3Maf,5Gyp41oLVo7Gg7vF4vpmggWP5MU70QO6,10,15,3,2,1,0,4,0,25,3.5714285714285716,2,0.0,7,3,1,1,8,0,1,4,0,12,13,1
3665,88829,Wz7BSBOI9rzgAwf2xVcld90BewMcWv25,fbPkOYLVPtPgIt0MxizjfFJov3JbHyAi,4,4,2,0,1,0,0,0,7,1.0,1,0.0,0,2,0,1,4,0,0,0,0,3,4,1
3666,88913,VqFdL7sovT6KD4YxyAdkx4XloDErf9k9,3VkHkmOtom3jM2wCu94xgzzu1d6Dn7or,23,40,11,18,13,5,5,0,92,13.142857142857142,3,0.0,25,11,17,13,15,5,1,5,0,66,26,0
3667,88920,sdqc2y9DWl93NKMvbx9lW9R0YYYxepka,3VkHkmOtom3jM2wCu94xgzzu1d6Dn7or,1,0,0,0,0,0,1,0,1,0.14285714285714285,1,0.0,0,0,0,0,0,0,0,1,0,0,1,1
3668,88939,D8J1nI1EMIfxo0mlTd1mZqxYvHDgdtVN,3VkHkmOtom3jM2wCu94xgzzu1d6Dn7or,1,0,0,0,0,0,1,0,1,0.14285714285714285,1,0.0,0,0,0,0,0,0,0,1,0,0,1,1
3669,88942,ruRvK6xh08hM5obkIdTVFj8V6xKv9gAQ,3VkHkmOtom3jM2wCu94xgzzu1d6Dn7or,1,0,0,0,0,0,4,0,4,0.5714285714285714,3,0.0,0,0,0,0,0,0,0,4,0,0,4,1
3670,88957,MsfGrNrzFeYLyfgHv6fE9lzMoRZiYs4m,3VkHkmOtom3jM2wCu94xgzzu1d6Dn7or,1,0,0,0,0,0,1,0,1,0.14285714285714285,1,0.0,0,0,0,0,0,0,0,1,0,0,1,1
3671,88960,vZILdgB6chBV3sIhY57RY2DipE34OVxR,3VkHkmOtom3jM2wCu94xgzzu1d6Dn7or,5,2,1,0,1,0,2,0,6,0.8571428571428571,1,0.0,0,1,0,1,2,0,0,2,0,2,4,1
3672,88962,rPKaOWNl9cYkLvtQk035CJPYGwPAMUtv,3VkHkmOtom3jM2wCu94xgzzu1d6Dn7or,5,3,1,0,1,0,2,0,7,1.0,1,0.0,0,1,0,1,3,0,0,2,0,2,5,1
3673,88965,gdcobmieC3Ff6Q7hc3dCmmYDsI9EpdmQ,3VkHkmOtom3jM2wCu94xgzzu1d6Dn7or,2,0,0,0,0,0,2,0,2,0.2857142857142857,1,0.0,0,0,0,0,0,0,0,2,0,0,2,1
3674,88971,mYcxP1C6GzqDzJNSFsSIMcFhAxyoYhvK,3VkHkmOtom3jM2wCu94xgzzu1d6Dn7or,5,2,1,0,1,0,2,0,6,0.8571428571428571,1,0.0,0,1,0,1,2,0,0,2,0,2,4,1
3675,88978,QkdU1z3YFvdeUK9lKehYyofsDutrm196,3VkHkmOtom3jM2wCu94xgzzu1d6Dn7or,5,2,1,0,0,0,9,0,12,1.7142857142857142,3,0.0,0,1,0,0,2,0,0,9,0,1,11,1
3676,88980,tYGYApAbiouSDaBs5DxcmJXHZSECIczt,3VkHkmOtom3jM2wCu94xgzzu1d6Dn7or,12,12,4,7,5,4,10,1,43,6.142857142857143,1,0.0,6,4,5,5,6,4,2,10,1,20,23,1
3677,88987,xEO4GPJebjg7xhxiGuwc39UYVbG4emqY,3VkHkmOtom3jM2wCu94xgzzu1d6Dn7or,8,14,5,2,5,3,3,0,32,4.571428571428571,3,0.0,5,5,1,5,9,3,1,3,0,16,16,0
3678,89006,oFV3lZVV98jNWr0uxjR1vxGfYSIB6mGU,3VkHkmOtom3jM2wCu94xgzzu1d6Dn7or,46,109,37,29,28,20,29,4,256,36.57142857142857,8,0.0,54,37,26,28,55,20,3,29,4,145,111,0
3679,89008,PLpsHvMijSqOKJuUu2T2zn0qTwgJZotU,3VkHkmOtom3jM2wCu94xgzzu1d6Dn7or,13,9,6,0,4,0,5,0,24,3.4285714285714284,2,0.0,0,6,0,4,9,0,0,5,0,10,14,1
3680,89017,xzTqSrdjtUHkgaGbesHv186lResjuXWp,3VkHkmOtom3jM2wCu94xgzzu1d6Dn7or,12,21,6,4,6,6,10,5,58,8.285714285714286,1,0.0,7,6,4,6,14,6,0,10,5,23,35,1
3681,89020,aFeyHJPu8zSmMmTziyeMNC1i70M5I2vP,3VkHkmOtom3jM2wCu94xgzzu1d6Dn7or,1,0,0,0,0,0,2,0,2,0.2857142857142857,1,0.0,0,0,0,0,0,0,0,2,0,0,2,1
3682,89022,0EA3uMknftqYxSVx43ou0vCzaSu2ZG24,3VkHkmOtom3jM2wCu94xgzzu1d6Dn7or,76,228,57,38,81,62,25,7,498,71.14285714285714,9,0.0,137,57,36,81,91,62,2,25,7,311,187,0
3683,89024,Z5NfPb4561WriHAzyAXkrN83hjTYfERn,3VkHkmOtom3jM2wCu94xgzzu1d6Dn7or,3,2,0,0,0,0,1,0,3,0.42857142857142855,1,0.0,0,0,0,0,2,0,0,1,0,0,3,1
3684,89026,eLW5o2pwNW5Z1WJm2PfI2FWflrW07F9T,3VkHkmOtom3jM2wCu94xgzzu1d6Dn7or,6,6,3,0,3,0,1,0,13,1.8571428571428572,1,0.0,0,3,0,3,6,0,0,1,0,6,7,1
3685,89027,rcSMC4zEWtftoShgGrNBnYyLIVFbdZAy,3VkHkmOtom3jM2wCu94xgzzu1d6Dn7or,5,2,0,0,0,0,4,0,6,0.8571428571428571,1,0.0,0,0,0,0,2,0,0,4,0,0,6,1
3686,89030,GZEmn2jDYiPNelTXdP84Wl4gxgVXz7UQ,3VkHkmOtom3jM2wCu94xgzzu1d6Dn7or,11,18,10,4,8,1,2,0,43,6.142857142857143,1,0.0,6,10,4,8,12,1,0,2,0,28,15,1
3687,89039,f7gUgesfNWd7PesJ9pRzAOW79Rfl1Nuf,3VkHkmOtom3jM2wCu94xgzzu1d6Dn7or,1,0,0,0,0,0,1,0,1,0.14285714285714285,1,0.0,0,0,0,0,0,0,0,1,0,0,1,1
3688,89042,EmyQCcrU6TABDlKEh2qs1MjprmbM3Cy7,3VkHkmOtom3jM2wCu94xgzzu1d6Dn7or,7,3,2,0,2,0,2,0,9,1.2857142857142858,1,0.0,0,2,0,2,3,0,0,2,0,4,5,1
3689,89047,z9vRp0iWPqmwk23agQn4gv9jKJ6FsTPG,3VkHkmOtom3jM2wCu94xgzzu1d6Dn7or,5,3,1,0,1,0,2,0,7,1.0,1,0.0,1,1,0,1,2,0,0,2,0,3,4,1
3690,89056,GDEKKJX6Db0GPPQtzslZZNCyRC2mvNvT,3VkHkmOtom3jM2wCu94xgzzu1d6Dn7or,1,0,0,0,0,0,1,0,1,0.14285714285714285,1,0.0,0,0,0,0,0,0,0,1,0,0,1,1
3691,89057,F66gWtRl6Obe8acgieKHbkqG0sRobxl7,3VkHkmOtom3jM2wCu94xgzzu1d6Dn7or,8,7,4,0,2,0,8,0,21,3.0,1,0.0,0,4,0,2,7,0,0,8,0,6,15,1
3692,89061,x3VqeY3osMgmSkOXJP5ZgpjwHRUese7H,3VkHkmOtom3jM2wCu94xgzzu1d6Dn7or,1,0,0,0,0,0,1,0,1,0.14285714285714285,1,0.0,0,0,0,0,0,0,0,1,0,0,1,1
3693,89062,qnUAuPnj6DwltWzjBartDw9eofEGHaaS,3VkHkmOtom3jM2wCu94xgzzu1d6Dn7or,10,15,1,0,0,1,8,4,29,4.142857142857143,1,0.0,0,1,0,0,15,1,0,8,4,1,28,1
3694,89079,fu0f20KU28Bd4xE03nYnaxnydSL4s6JV,3VkHkmOtom3jM2wCu94xgzzu1d6Dn7or,23,68,24,18,17,26,14,1,168,24.0,3,0.0,28,24,16,17,40,26,2,14,1,85,83,1
3695,89083,Ap3Bj4ZOZRonAHU28sY8JyQfpdwv4c0W,3VkHkmOtom3jM2wCu94xgzzu1d6Dn7or,70,112,32,49,43,52,23,2,313,44.714285714285715,4,0.0,49,32,49,43,63,52,0,23,2,173,140,0
3696,89087,CrCSKbuHhWd6DSDGUirLXpNaUBFOcIKn,3VkHkmOtom3jM2wCu94xgzzu1d6Dn7or,7,4,1,0,2,0,10,1,18,2.5714285714285716,1,0.0,0,1,0,2,4,0,0,10,1,3,15,1
3697,89088,ytSSVOcAZTgFAsRYUxOPt2SQ2Vi2FToh,3VkHkmOtom3jM2wCu94xgzzu1d6Dn7or,6,5,4,0,4,0,2,0,15,2.142857142857143,1,0.0,0,4,0,4,5,0,0,2,0,8,7,1
3698,89094,nDo1MAGdksnvqTNyWgHF0jKf62RVJeoU,3VkHkmOtom3jM2wCu94xgzzu1d6Dn7or,9,5,2,1,3,0,3,0,14,2.0,1,0.0,3,2,1,3,2,0,0,3,0,9,5,1
3699,89104,c8bYDsPDbQZnRsC1UfWB7pa6WYwE7c3G,3VkHkmOtom3jM2wCu94xgzzu1d6Dn7or,27,53,26,9,17,1,32,4,142,20.285714285714285,5,0.0,17,26,9,17,36,1,0,32,4,69,73,1
3700,89131,mW6yRunZZHpqfDbYPXDkbbBYilBG5bIS,3VkHkmOtom3jM2wCu94xgzzu1d6Dn7or,7,12,5,0,0,1,7,1,26,3.7142857142857144,1,0.0,5,5,0,0,7,1,0,7,1,10,16,1
3701,89133,uLR6x2fVRcTH9Bp0FaJwa31x1uL6PpTF,3VkHkmOtom3jM2wCu94xgzzu1d6Dn7or,5,6,1,0,1,0,2,0,10,1.4285714285714286,2,0.0,0,1,0,1,6,0,0,2,0,2,8,0
3702,89138,FTJVq9TWMdAK3okD5xbyDXGZ8r3m7Y4p,3VkHkmOtom3jM2wCu94xgzzu1d6Dn7or,25,74,15,39,3,7,28,12,178,25.428571428571427,3,0.0,21,15,32,3,53,7,7,28,12,71,107,0
3703,89146,CPts08aA0DaKXFMj3CNw4GA7s6LvsTi1,3VkHkmOtom3jM2wCu94xgzzu1d6Dn7or,1,0,0,0,0,0,2,0,2,0.2857142857142857,1,0.0,0,0,0,0,0,0,0,2,0,0,2,1
3704,89326,wNXelOaGj6HkY91hCddHRdOCiLagph7q,SpATywNh6bZuzm8s1ceuBUnMUAeoAHHw,28,29,0,48,0,0,10,0,87,12.428571428571429,3,0.0,6,0,42,0,23,0,6,10,0,48,39,0
3705,89462,bX1EJ8H8O7LvPaK2JoRVQC0BaLpmhHE6,SpATywNh6bZuzm8s1ceuBUnMUAeoAHHw,14,11,6,10,3,0,7,0,37,5.285714285714286,2,0.0,3,6,9,3,8,0,1,7,0,21,16,0
3706,89571,YuqMJYvTgiTQGQOAOb2fKJpGas8AG3Wr,SpATywNh6bZuzm8s1ceuBUnMUAeoAHHw,3,2,1,0,0,0,1,0,4,0.5714285714285714,1,0.0,0,1,0,0,2,0,0,1,0,1,3,0
3707,89595,6OfXNoCI7Waq7DTFUWFiUcQXC3Cg0WKC,SpATywNh6bZuzm8s1ceuBUnMUAeoAHHw,7,6,1,0,1,0,1,0,9,1.2857142857142858,1,0.0,0,1,0,1,6,0,0,1,0,2,7,1
3708,89701,BawZLFtQaV6cG6ZH5ggA2jwB1HVUhop0,SpATywNh6bZuzm8s1ceuBUnMUAeoAHHw,3,2,1,0,0,0,1,0,4,0.5714285714285714,1,0.0,0,1,0,0,2,0,0,1,0,1,3,1
3709,89732,pdAqVvKgeCIaihAcxhTXOYjPQxxjaa8K,RXDvfPUBYFlVdlueBFbLW0mhhAyGEqpt,6,4,2,0,1,0,2,0,9,1.2857142857142858,1,0.0,0,2,0,1,4,0,0,2,0,3,6,1
3710,89860,Hie5jI1V7aqUGyRciLGioIx6C3WNaVxM,SpATywNh6bZuzm8s1ceuBUnMUAeoAHHw,1,0,0,0,0,0,1,0,1,0.14285714285714285,1,0.0,0,0,0,0,0,0,0,1,0,0,1,1
3711,90026,RyilkQdPLBJZ4lFr5oZI0Ei4sfkfiESh,SpATywNh6bZuzm8s1ceuBUnMUAeoAHHw,6,2,3,0,3,0,0,0,8,1.1428571428571428,1,0.0,0,3,0,3,2,0,0,0,0,6,2,0
3712,90058,OFJM9gLiEJFta7GOEBOgZlB17rEajfDQ,G8EPVSXsOYB5YQWZGiz1aVq5Pgr2GrQu,9,5,0,14,0,0,1,0,20,2.857142857142857,1,0.0,0,0,13,0,5,0,1,1,0,13,7,0
3713,90116,T7izEMyckZ14Dpb0HXCCbCEgRCtemG2v,RXDvfPUBYFlVdlueBFbLW0mhhAyGEqpt,16,14,5,0,4,0,0,0,23,3.2857142857142856,1,0.0,1,5,0,4,13,0,0,0,0,10,13,1
3714,90121,PD0QXI0Ip2PVwJ6kJaKkkINkj7BvGZMC,bWdj2GDclj5ofokWjzoa5jAwMkxCykd6,2,0,0,0,0,0,3,0,3,0.42857142857142855,1,0.0,0,0,0,0,0,0,0,3,0,0,3,1
3715,90145,vFTyJ5TiVtOMNTDle7WFtHDAgvur1Shs,RXDvfPUBYFlVdlueBFbLW0mhhAyGEqpt,14,9,4,16,3,1,1,0,34,4.857142857142857,1,0.0,2,4,15,3,7,1,1,1,0,24,10,1
3716,90163,oSabIe7L5topw6hwV4H4ZV0Ug7ZVNxfV,SpATywNh6bZuzm8s1ceuBUnMUAeoAHHw,4,3,1,0,0,0,2,0,6,0.8571428571428571,1,0.0,0,1,0,0,3,0,0,2,0,1,5,0
3717,90301,nNRUhTxrQUyQlj0B4LUbcGCoMBsVhXak,SpATywNh6bZuzm8s1ceuBUnMUAeoAHHw,6,12,7,0,1,1,4,0,25,3.5714285714285716,3,0.0,0,7,0,1,12,1,0,4,0,8,17,1
3718,90384,HOZheAyAGMSpb5Rm4jAeFCDd0CkpsnTU,SpATywNh6bZuzm8s1ceuBUnMUAeoAHHw,5,7,0,0,0,17,2,0,26,3.7142857142857144,1,0.0,0,0,0,0,7,17,0,2,0,0,26,1
3719,90388,af1GfUKSTAzLFQRgO3DNnNJQEXmJbieP,SpATywNh6bZuzm8s1ceuBUnMUAeoAHHw,14,9,5,15,3,0,2,0,34,4.857142857142857,1,0.0,4,5,14,3,5,0,1,2,0,26,8,0
3720,90401,U8woUOpngQnqlgGzBG9Q1wRVWIkAfJH5,bWdj2GDclj5ofokWjzoa5jAwMkxCykd6,3,2,0,0,0,14,2,0,18,2.5714285714285716,2,0.0,0,0,0,0,2,14,0,2,0,0,18,0
3721,90654,bA5X6ch4ADNfhanzi2mM69bwbihODbQ4,G8EPVSXsOYB5YQWZGiz1aVq5Pgr2GrQu,33,46,25,57,11,0,7,1,147,21.0,1,0.0,17,25,50,11,29,0,7,7,1,103,44,0
3722,90688,j8vYdYwa9gvt7hkF8dykZR2D4h75QsII,RXDvfPUBYFlVdlueBFbLW0mhhAyGEqpt,13,8,7,0,5,0,1,0,21,3.0,1,0.0,0,7,0,5,8,0,0,1,0,12,9,1
3723,90999,CwyOL3RMOVLomxrxyN9D4jPa9R0iWrS5,G8EPVSXsOYB5YQWZGiz1aVq5Pgr2GrQu,22,26,15,22,12,7,3,0,85,12.142857142857142,2,0.0,7,15,19,12,19,7,3,3,0,53,32,0
3724,91092,mXfwwTIVjHMqoVKAh2iEQbinKUCJHwTp,SpATywNh6bZuzm8s1ceuBUnMUAeoAHHw,3,2,1,0,0,0,1,0,4,0.5714285714285714,1,0.0,0,1,0,0,2,0,0,1,0,1,3,1
3725,91113,LDDV5GLR4T4AoJ4swm7PTuKciMVwXQ01,G8EPVSXsOYB5YQWZGiz1aVq5Pgr2GrQu,10,9,1,0,1,0,4,0,15,2.142857142857143,2,0.0,0,1,0,1,9,0,0,4,0,2,13,0
3726,91152,ogzXep3azQvjQ2uIPIxw4TZLNiUXYlgD,RXDvfPUBYFlVdlueBFbLW0mhhAyGEqpt,4,2,1,0,0,0,3,0,6,0.8571428571428571,1,0.0,0,1,0,0,2,0,0,3,0,1,5,1
3727,91185,bUI06hErQBLCI8IpvZBPVsO5ApTPyNZ8,bWdj2GDclj5ofokWjzoa5jAwMkxCykd6,4,3,1,0,0,0,1,0,5,0.7142857142857143,1,0.0,0,1,0,0,3,0,0,1,0,1,4,1
3728,91211,YlWJRLkP5QIlBcoTrKDrquHDRSLUHmOs,SpATywNh6bZuzm8s1ceuBUnMUAeoAHHw,29,34,1,29,1,14,10,14,103,14.714285714285714,3,0.0,10,1,26,1,24,14,3,10,14,38,65,0
3729,91383,BcJnhjzA1hw0WNze9uWUZQ49uBAiBHyH,SpATywNh6bZuzm8s1ceuBUnMUAeoAHHw,12,23,0,0,0,5,4,0,32,4.571428571428571,1,0.0,2,0,0,0,21,5,0,4,0,2,30,0
3730,91480,3NG42RQfrkx04BX4rgjNYVd7JioduuEW,SpATywNh6bZuzm8s1ceuBUnMUAeoAHHw,19,49,18,15,6,0,4,0,92,13.142857142857142,4,0.0,4,18,15,6,45,0,0,4,0,43,49,0
3731,91603,OrOKqOyaP0czIUaPleazM6NqAyXT5eRh,5Gyp41oLVo7Gg7vF4vpmggWP5MU70QO6,19,18,13,0,4,5,5,0,45,6.428571428571429,1,0.0,5,13,0,4,13,5,0,5,0,22,23,1
3732,91605,dNMg8HqASFn9pIW9ZR7BiQy6ZwZupOce,5Gyp41oLVo7Gg7vF4vpmggWP5MU70QO6,7,5,3,0,2,0,1,0,11,1.5714285714285714,2,0.0,1,3,0,2,4,0,0,1,0,6,5,0
3733,91624,lxP21JAeoGw4N8j8NgjQVcD64XYgvMHQ,5Gyp41oLVo7Gg7vF4vpmggWP5MU70QO6,6,4,3,0,0,0,3,0,10,1.4285714285714286,2,0.0,0,3,0,0,4,0,0,3,0,3,7,1
3734,91628,zMEKIcvm3yoz2YgvYxTVeyAzLndjTkwj,5Gyp41oLVo7Gg7vF4vpmggWP5MU70QO6,5,3,1,0,1,0,2,0,7,1.0,1,0.0,0,1,0,1,3,0,0,2,0,2,5,1
3735,91637,fsCIF7QhnxjK2RaGiibg5w66TDPP1pF7,5Gyp41oLVo7Gg7vF4vpmggWP5MU70QO6,4,2,0,0,0,0,2,0,4,0.5714285714285714,1,0.0,0,0,0,0,2,0,0,2,0,0,4,1
3736,91669,MRhqA2nXZ6Bkpg88Ka2eWnXnKoeC7n0Y,5Gyp41oLVo7Gg7vF4vpmggWP5MU70QO6,6,3,2,0,2,0,1,0,8,1.1428571428571428,1,0.0,0,2,0,2,3,0,0,1,0,4,4,1
3737,91690,uhHENxmla59SMNiIiDg6NjH3hc1bZQJz,5Gyp41oLVo7Gg7vF4vpmggWP5MU70QO6,13,30,0,2,2,0,4,0,38,5.428571428571429,3,0.0,4,0,1,2,26,0,1,4,0,7,31,1
3738,91715,74WSVlQKxYvszzuF50fKag40iRLOP9cx,5Gyp41oLVo7Gg7vF4vpmggWP5MU70QO6,28,78,31,8,8,0,9,3,137,19.571428571428573,4,0.0,25,31,4,8,53,0,4,9,3,68,69,1
3739,91719,n7WRFuvONxPzIz6h3G7EbhWA5QePb4uZ,5Gyp41oLVo7Gg7vF4vpmggWP5MU70QO6,12,11,8,0,6,0,3,0,28,4.0,3,0.0,0,8,0,6,11,0,0,3,0,14,14,0
3740,91735,jyKgXj3mAd5dyUJrfpYQZpBWgDXWTcbw,5Gyp41oLVo7Gg7vF4vpmggWP5MU70QO6,5,2,1,0,1,0,2,0,6,0.8571428571428571,1,0.0,0,1,0,1,2,0,0,2,0,2,4,1
3741,91773,0artPLh8IkCTAf124kxiUrz2J9bSLV97,5Gyp41oLVo7Gg7vF4vpmggWP5MU70QO6,2,0,0,0,0,0,2,0,2,0.2857142857142857,1,0.0,0,0,0,0,0,0,0,2,0,0,2,0
3742,91777,lfRqSKrZDdqhfB8Fp83G9pBOvFDy0kAs,5Gyp41oLVo7Gg7vF4vpmggWP5MU70QO6,8,18,9,0,2,6,11,0,46,6.571428571428571,7,0.0,0,9,0,2,18,6,0,11,0,11,35,0
3743,91798,dDzkrJVHCsvOOmSt9G6FWEYBUJ2tIHDw,5Gyp41oLVo7Gg7vF4vpmggWP5MU70QO6,14,9,7,8,2,3,12,1,42,6.0,2,0.0,0,7,6,2,9,3,2,12,1,15,27,1
3744,91807,ntnoRdM6rDaqd1odDyhFp4fAU79Gu4an,5Gyp41oLVo7Gg7vF4vpmggWP5MU70QO6,10,19,5,8,3,0,1,0,36,5.142857142857143,1,0.0,7,5,4,3,12,0,4,1,0,19,17,1
3745,91823,Tt8rzXFwAosNigtX0xm5nR0SMGNRi2Kk,5Gyp41oLVo7Gg7vF4vpmggWP5MU70QO6,6,2,1,0,1,0,3,0,7,1.0,1,0.0,0,1,0,1,2,0,0,3,0,2,5,1
3746,91826,V44Q36yyz0HxZhlrCwrLJjYwv8UzqoCn,5Gyp41oLVo7Gg7vF4vpmggWP5MU70QO6,26,28,17,0,12,0,5,0,62,8.857142857142858,2,0.0,3,17,0,12,25,0,0,5,0,32,30,1
3747,91853,jQSZrKmukoAGdD1PsGnzsjQnImWdBkqA,5Gyp41oLVo7Gg7vF4vpmggWP5MU70QO6,22,34,15,8,6,3,10,7,83,11.857142857142858,2,0.0,11,15,4,6,23,3,4,10,7,36,47,1
3748,91864,5ehf4EFN8WhDbvmb2WvfZwpaBD0cj1oj,5Gyp41oLVo7Gg7vF4vpmggWP5MU70QO6,2,0,0,0,0,0,3,0,3,0.42857142857142855,1,0.0,0,0,0,0,0,0,0,3,0,0,3,1
3749,91879,XpB3605ywsIMWFpcEpdm73TORVPiMuYf,5Gyp41oLVo7Gg7vF4vpmggWP5MU70QO6,4,3,2,0,0,0,1,0,6,0.8571428571428571,1,0.0,0,2,0,0,3,0,0,1,0,2,4,1
3750,91892,tlqjd2GOMGyjV0WHX1kZcOYXZIhFMnzY,5Gyp41oLVo7Gg7vF4vpmggWP5MU70QO6,6,3,1,0,1,0,2,0,7,1.0,1,0.0,0,1,0,1,3,0,0,2,0,2,5,1
3751,91895,3zntAItqSvNfO7Qv4LVxV45RnL0KWMa7,5Gyp41oLVo7Gg7vF4vpmggWP5MU70QO6,1,0,0,0,0,0,1,0,1,0.14285714285714285,1,0.0,0,0,0,0,0,0,0,1,0,0,1,1
3752,91904,Z9As9pIqQc1shsmV7QPe0LhImYacdXo2,5Gyp41oLVo7Gg7vF4vpmggWP5MU70QO6,8,3,2,0,2,0,3,1,11,1.5714285714285714,1,0.0,0,2,0,2,3,0,0,3,1,4,7,1
3753,91908,XYvhn7FKYwBLHO6LnI73nj3pDqSLOeJp,5Gyp41oLVo7Gg7vF4vpmggWP5MU70QO6,4,5,1,0,0,0,2,0,8,1.1428571428571428,1,0.0,3,1,0,0,2,0,0,2,0,4,4,1
3754,91935,sNbuAEBvvCL9s1FspvGXLJVjQkFzxwpw,5Gyp41oLVo7Gg7vF4vpmggWP5MU70QO6,23,40,24,13,9,10,15,1,112,16.0,6,0.0,5,24,8,9,35,10,5,15,1,46,66,1
3755,91938,1Xc4n8u7ThoxZMaQ0iucIboQyIl4jSHq,5Gyp41oLVo7Gg7vF4vpmggWP5MU70QO6,17,32,18,8,11,22,14,8,113,16.142857142857142,3,0.0,6,18,4,11,26,22,4,14,8,39,74,1
3756,91950,V5AS4ngknDMHs5ddf49SxlAoYguZsiN3,5Gyp41oLVo7Gg7vF4vpmggWP5MU70QO6,18,28,6,5,7,4,11,1,62,8.857142857142858,4,0.0,4,6,4,7,24,4,1,11,1,21,41,1
3757,92067,u4wFfZnbsYhKH8Kj4PUHUKy301RbBINb,3VkHkmOtom3jM2wCu94xgzzu1d6Dn7or,1,0,0,0,0,0,1,0,1,0.14285714285714285,1,0.0,0,0,0,0,0,0,0,1,0,0,1,1
3758,92113,hwyfFUZaszlgzhQ0A8GM8jJZSkMg0szI,3VkHkmOtom3jM2wCu94xgzzu1d6Dn7or,4,2,1,0,1,0,2,0,6,0.8571428571428571,1,0.0,0,1,0,1,2,0,0,2,0,2,4,1
3759,92142,ANTZV9I3pvsw3UZvyJti5aBzyESopoxF,3VkHkmOtom3jM2wCu94xgzzu1d6Dn7or,8,7,3,0,2,0,2,0,14,2.0,1,0.0,0,3,0,2,7,0,0,2,0,5,9,1
3760,92150,rAtBVPfi6wGHmo9go039lvWtKolaTQH4,3VkHkmOtom3jM2wCu94xgzzu1d6Dn7or,74,151,68,28,42,58,18,1,366,52.285714285714285,11,0.0,46,68,28,42,105,58,0,18,1,184,182,0
3761,92161,fCjzUD7j2qaTRuZP23QBRuNrEm9lCAvx,3VkHkmOtom3jM2wCu94xgzzu1d6Dn7or,3,2,0,0,0,0,1,0,3,0.42857142857142855,1,0.0,0,0,0,0,2,0,0,1,0,0,3,1
3762,92163,YVWYprrD49kz6eRpc0V63TWwuTo8nH9t,3VkHkmOtom3jM2wCu94xgzzu1d6Dn7or,10,9,4,22,0,2,2,0,39,5.571428571428571,1,0.0,4,4,19,0,5,2,3,2,0,27,12,1
3763,92178,qPy3iBoPzSROdvTXJHBPRLMGPMlGfgit,3VkHkmOtom3jM2wCu94xgzzu1d6Dn7or,1,0,0,0,0,0,1,0,1,0.14285714285714285,1,0.0,0,0,0,0,0,0,0,1,0,0,1,1
3764,92188,TKni4XynpXoISkd4OYGZxkhhQF48YfLJ,3VkHkmOtom3jM2wCu94xgzzu1d6Dn7or,5,3,1,0,1,0,2,0,7,1.0,1,0.0,0,1,0,1,3,0,0,2,0,2,5,1
3765,92196,m3riDkeaP3qLddM2Qy9128A1o8BoTU63,3VkHkmOtom3jM2wCu94xgzzu1d6Dn7or,1,0,0,0,0,0,1,0,1,0.14285714285714285,1,0.0,0,0,0,0,0,0,0,1,0,0,1,1
3766,92223,C839Pw1k25lShX6OME8tsROGVFmKHsQj,3VkHkmOtom3jM2wCu94xgzzu1d6Dn7or,13,16,11,0,0,0,7,0,34,4.857142857142857,3,0.0,2,11,0,0,14,0,0,7,0,13,21,1
3767,92271,2ACry9yVQLDO9NzG6c6rzYJoZ71i5zub,3VkHkmOtom3jM2wCu94xgzzu1d6Dn7or,5,2,1,0,1,0,2,0,6,0.8571428571428571,1,0.0,0,1,0,1,2,0,0,2,0,2,4,1
3768,92321,mBxJVmcIB5QiI5q4IOOyIq2i5l94DEiQ,3VkHkmOtom3jM2wCu94xgzzu1d6Dn7or,1,0,0,0,0,0,1,0,1,0.14285714285714285,1,0.0,0,0,0,0,0,0,0,1,0,0,1,1
3769,92326,feFmEKXFbNOyVfG6zt996K6iCOib8Z3O,3VkHkmOtom3jM2wCu94xgzzu1d6Dn7or,2,0,0,0,0,2,1,0,3,0.42857142857142855,1,0.0,0,0,0,0,0,2,0,1,0,0,3,1
3770,92329,J5hhd28AnEjvxP8BdwPWr3oDmUVPlSav,3VkHkmOtom3jM2wCu94xgzzu1d6Dn7or,6,8,5,0,0,0,2,0,15,2.142857142857143,1,0.0,0,5,0,0,8,0,0,2,0,5,10,1
3771,92423,rRrJj9JVQXtSLrAD2dEx3ajCynQpJX6X,3VkHkmOtom3jM2wCu94xgzzu1d6Dn7or,2,0,0,0,0,0,2,0,2,0.2857142857142857,1,0.0,0,0,0,0,0,0,0,2,0,0,2,1
3772,92504,pVihbVWlZf7SUBA6zEJSZ77SByxCCfVO,3VkHkmOtom3jM2wCu94xgzzu1d6Dn7or,4,2,1,0,1,0,1,0,5,0.7142857142857143,1,0.0,0,1,0,1,2,0,0,1,0,2,3,0
3773,92521,TlD076gGGGyiK5wb6YLxBzvK2DMAYIeX,3VkHkmOtom3jM2wCu94xgzzu1d6Dn7or,14,24,11,0,6,0,8,0,49,7.0,5,0.0,0,11,0,6,24,0,0,8,0,17,32,1
3774,92529,kvTwPCctpVXcm8cUo5wo3JOt6rO0CW0u,3VkHkmOtom3jM2wCu94xgzzu1d6Dn7or,46,121,20,34,35,57,25,2,294,42.0,6,0.0,30,20,27,35,91,57,7,25,2,112,182,1
3775,92535,012CixIdJBhXRc28Z2dnvOp7AzVdh4jR,3VkHkmOtom3jM2wCu94xgzzu1d6Dn7or,10,7,3,0,3,0,7,1,21,3.0,2,0.0,2,3,0,3,5,0,0,7,1,8,13,1
3776,92655,d0yHDlJTRwNIUBveZBHoUOAhhLLmBYWM,3VkHkmOtom3jM2wCu94xgzzu1d6Dn7or,1,0,0,0,0,0,1,0,1,0.14285714285714285,1,0.0,0,0,0,0,0,0,0,1,0,0,1,1
3777,92657,lPH6xIq6FfRsodLF4Ki11A2wICp83caG,3VkHkmOtom3jM2wCu94xgzzu1d6Dn7or,24,108,13,0,2,0,8,0,131,18.714285714285715,6,0.0,10,13,0,2,98,0,0,8,0,25,106,1
3778,92689,4Odot1ifQmo934dHmroVBJ0rHAodK4A5,3VkHkmOtom3jM2wCu94xgzzu1d6Dn7or,12,19,8,4,6,5,18,2,62,8.857142857142858,4,0.0,6,8,4,6,13,5,0,18,2,24,38,1
3779,92743,fBOKrkySPMr7N6TO5KbfFY7Qb8CUYtAU,3VkHkmOtom3jM2wCu94xgzzu1d6Dn7or,1,0,0,0,0,0,1,0,1,0.14285714285714285,1,0.0,0,0,0,0,0,0,0,1,0,0,1,1
3780,92883,TY1XSpzUxZYHUqU0tQYtstvuwKCsGYpR,G8EPVSXsOYB5YQWZGiz1aVq5Pgr2GrQu,26,18,15,0,14,2,3,1,53,7.571428571428571,1,0.0,2,15,0,14,16,2,0,3,1,31,22,1
3781,92942,erkNYBqLpKRElyeL8GeAgO43CMazg6Rt,SpATywNh6bZuzm8s1ceuBUnMUAeoAHHw,5,7,4,0,0,0,4,0,15,2.142857142857143,1,0.0,1,4,0,0,6,0,0,4,0,5,10,1
3782,93008,OdMr7dE5UlAme9Tp979vREBvY5CV50po,SpATywNh6bZuzm8s1ceuBUnMUAeoAHHw,28,31,25,7,18,0,4,0,85,12.142857142857142,3,0.0,2,25,7,18,29,0,0,4,0,52,33,0
3783,93122,YYCI1ivPCDRa3x25VBUTnS1EqXk51k7P,SpATywNh6bZuzm8s1ceuBUnMUAeoAHHw,5,3,2,0,1,0,2,0,8,1.1428571428571428,1,0.0,0,2,0,1,3,0,0,2,0,3,5,0
3784,93243,IsU1RKSKxT8SmvRzyXcC6emxRwMddmTJ,G8EPVSXsOYB5YQWZGiz1aVq5Pgr2GrQu,21,19,1,0,1,0,1,0,22,3.142857142857143,1,0.0,0,1,0,1,19,0,0,1,0,2,20,0
3785,93394,grc1pAXqdUQaBlZrZyROqjuEtg08nen2,A3fsA9Zfv1X2fVEQhTw51lKENdNrEqT3,5,3,1,0,1,0,1,0,6,0.8571428571428571,1,0.0,0,1,0,1,3,0,0,1,0,2,4,0
3786,93539,hZR4MwcYec4g0GoOyJFngJGEyWOySpv2,SpATywNh6bZuzm8s1ceuBUnMUAeoAHHw,10,14,9,0,1,37,10,0,71,10.142857142857142,5,0.0,0,9,0,1,14,37,0,10,0,10,61,0
3787,93620,HJ2Te0AnFOdWtPQ1mbU0gvcfD3BsPlu2,SpATywNh6bZuzm8s1ceuBUnMUAeoAHHw,18,39,24,12,5,2,5,0,87,12.428571428571429,2,0.0,8,24,10,5,31,2,2,5,0,47,40,0
3788,93689,KXi2lu4GlKmrO1lJTLg3t4l701rvNXNZ,A3fsA9Zfv1X2fVEQhTw51lKENdNrEqT3,8,7,5,0,3,0,3,0,18,2.5714285714285716,1,0.0,0,5,0,3,7,0,0,3,0,8,10,0
3789,93874,mSs5bB1Rxg3xYWjWjJY9pVTt7WAiMgyu,SpATywNh6bZuzm8s1ceuBUnMUAeoAHHw,4,4,2,0,0,2,10,0,18,2.5714285714285716,2,0.0,0,2,0,0,4,2,0,10,0,2,16,0
3790,94073,60AYcG1Aqq07FBEqNwevaiEWsxsSm68V,SpATywNh6bZuzm8s1ceuBUnMUAeoAHHw,35,27,15,23,8,7,6,1,87,12.428571428571429,1,0.0,7,15,20,8,20,7,3,6,1,50,37,1
3791,94311,Gl03eSeNtb7juYcfyy4T6xQkEEhQalIx,SpATywNh6bZuzm8s1ceuBUnMUAeoAHHw,4,2,1,0,1,0,0,0,4,0.5714285714285714,1,0.0,0,1,0,1,2,0,0,0,0,2,2,1
3792,94408,kdTkyJM1xm4AQ2tXVSlZpNtOhQ8qhZ4V,SpATywNh6bZuzm8s1ceuBUnMUAeoAHHw,39,44,24,30,14,0,4,0,116,16.571428571428573,2,0.0,12,24,25,14,32,0,5,4,0,75,41,0
3793,94486,gl2YVlebVAvCcxsYaIoTwLj5l1IGqntH,SpATywNh6bZuzm8s1ceuBUnMUAeoAHHw,7,6,4,0,0,0,1,0,11,1.5714285714285714,1,0.0,0,4,0,0,6,0,0,1,0,4,7,0
3794,94551,G424CP05HwI8jLfxKeXUJBAhe03V6D2B,3VkHkmOtom3jM2wCu94xgzzu1d6Dn7or,24,47,14,10,17,43,15,1,147,21.0,4,0.0,25,14,9,17,22,43,1,15,1,65,82,1
3795,94574,A41hdT15T7mumzDW53QCDXRUsOilvTI0,3VkHkmOtom3jM2wCu94xgzzu1d6Dn7or,8,9,6,0,3,2,7,0,27,3.857142857142857,2,0.0,0,6,0,3,9,2,0,7,0,9,18,1
3796,94626,BTv7PWmhDfp3JmOONhTjhUiL7MjjMTTR,3VkHkmOtom3jM2wCu94xgzzu1d6Dn7or,1,0,0,0,0,0,1,0,1,0.14285714285714285,1,0.0,0,0,0,0,0,0,0,1,0,0,1,1
3797,94627,7fFZLbLMI7Ucj1mdrBxpY9hCEcczhOLF,3VkHkmOtom3jM2wCu94xgzzu1d6Dn7or,9,14,5,0,5,0,3,0,27,3.857142857142857,1,0.0,4,5,0,5,10,0,0,3,0,14,13,0
3798,94640,umB57zvkjlup9uMOCbyoPHxCz5TDBKHU,3VkHkmOtom3jM2wCu94xgzzu1d6Dn7or,6,4,2,0,1,0,4,0,11,1.5714285714285714,1,0.0,0,2,0,1,4,0,0,4,0,3,8,1
3799,94651,sv2NeuLE6EuaEeLqlDnQ62bMEYW4pvkK,3VkHkmOtom3jM2wCu94xgzzu1d6Dn7or,1,0,0,0,0,0,1,0,1,0.14285714285714285,1,0.0,0,0,0,0,0,0,0,1,0,0,1,1
3800,94688,ahmR8OdgsTm8Ih7Td8OamAHkU2FrzbwI,3VkHkmOtom3jM2wCu94xgzzu1d6Dn7or,7,5,1,1,2,0,3,0,12,1.7142857142857142,1,0.0,3,1,1,2,2,0,0,3,0,7,5,1
3801,94701,Mj5FdiZEH35rYomX6fNs6Oa9daue9DlK,3VkHkmOtom3jM2wCu94xgzzu1d6Dn7or,2,0,0,0,0,0,2,0,2,0.2857142857142857,1,0.0,0,0,0,0,0,0,0,2,0,0,2,1
3802,94707,Xy5IHkH9GSUKsyMgAP7rZCdXgMgkb9b0,3VkHkmOtom3jM2wCu94xgzzu1d6Dn7or,1,0,0,0,0,0,1,0,1,0.14285714285714285,1,0.0,0,0,0,0,0,0,0,1,0,0,1,1
3803,94749,XZEP2kTALjdUPEf4KYPbZV36rJ4HppdG,3VkHkmOtom3jM2wCu94xgzzu1d6Dn7or,8,5,2,0,2,2,7,1,19,2.7142857142857144,1,0.0,0,2,0,2,5,2,0,7,1,4,15,1
3804,94750,NK5owDN3QRUt6YxvDCACv2xFFTAKIpGm,3VkHkmOtom3jM2wCu94xgzzu1d6Dn7or,1,0,0,0,0,0,1,0,1,0.14285714285714285,1,0.0,0,0,0,0,0,0,0,1,0,0,1,1
3805,94751,AiDVWQDPcNj5mF9HYJkbcDakLs2tu9iF,3VkHkmOtom3jM2wCu94xgzzu1d6Dn7or,1,0,0,0,0,0,2,0,2,0.2857142857142857,1,0.0,0,0,0,0,0,0,0,2,0,0,2,1
3806,94783,6a6P2Rm5bfBMnFhUjMkzJ4XXR5CJYmx6,3VkHkmOtom3jM2wCu94xgzzu1d6Dn7or,2,0,0,0,0,0,2,0,2,0.2857142857142857,1,0.0,0,0,0,0,0,0,0,2,0,0,2,1
3807,94789,ByGtgrhwjqag1hRRpomltO3m2pMuKwns,3VkHkmOtom3jM2wCu94xgzzu1d6Dn7or,1,0,0,0,0,0,2,0,2,0.2857142857142857,1,0.0,0,0,0,0,0,0,0,2,0,0,2,1
3808,94814,ynUoPu6CisCKYPNn8uCqIJp2I8pANQG7,3VkHkmOtom3jM2wCu94xgzzu1d6Dn7or,1,0,0,0,0,0,1,0,1,0.14285714285714285,1,0.0,0,0,0,0,0,0,0,1,0,0,1,1
3809,94821,yKJzKtteWnpiFP2nGuf1wimq3ANhZIS3,3VkHkmOtom3jM2wCu94xgzzu1d6Dn7or,1,0,0,0,0,0,1,0,1,0.14285714285714285,1,0.0,0,0,0,0,0,0,0,1,0,0,1,1
3810,94832,oNQaCuO2rlrLriXUbP7yibkLZ8kZEP0A,3VkHkmOtom3jM2wCu94xgzzu1d6Dn7or,15,31,12,5,10,5,5,0,68,9.714285714285714,3,0.0,9,12,5,10,22,5,0,5,0,36,32,1
3811,94855,JiNN6rHoPfwH1fuAk6q9tmTGqAFVjob4,3VkHkmOtom3jM2wCu94xgzzu1d6Dn7or,9,16,6,6,0,4,4,0,36,5.142857142857143,3,0.0,2,6,5,0,14,4,1,4,0,13,23,1
3812,94871,e1rHEAAgGrGghOyUOhnEIg0DWKbNO0d0,3VkHkmOtom3jM2wCu94xgzzu1d6Dn7or,12,29,4,6,3,8,6,1,57,8.142857142857142,1,0.0,8,4,5,3,21,8,1,6,1,20,37,1
3813,94883,G14xjTwMWbfsqTNiU3Ie1utHyPegqSvR,fbPkOYLVPtPgIt0MxizjfFJov3JbHyAi,1,0,0,0,0,0,1,0,1,0.14285714285714285,1,0.0,0,0,0,0,0,0,0,1,0,0,1,1
3814,94884,4dQbvsCaWQeeEpeCSiFVC9vhr2vn0RzD,fbPkOYLVPtPgIt0MxizjfFJov3JbHyAi,1,0,0,0,0,0,1,0,1,0.14285714285714285,1,0.0,0,0,0,0,0,0,0,1,0,0,1,1
3815,94885,1YxknoiTrSwQgclDlSAh4oMYHRyARhLv,fbPkOYLVPtPgIt0MxizjfFJov3JbHyAi,1,0,0,0,0,0,1,0,1,0.14285714285714285,1,0.0,0,0,0,0,0,0,0,1,0,0,1,1
3816,94887,NR0o4tRLL7So8UOrYr7iGrs6QElxoJxc,fbPkOYLVPtPgIt0MxizjfFJov3JbHyAi,5,2,1,0,1,0,3,0,7,1.0,1,0.0,0,1,0,1,2,0,0,3,0,2,5,1
3817,94888,bKxdZbIkgORsJN5JxYEpk6KGebUY8txM,fbPkOYLVPtPgIt0MxizjfFJov3JbHyAi,1,0,0,0,0,0,2,0,2,0.2857142857142857,1,0.0,0,0,0,0,0,0,0,2,0,0,2,1
3818,94891,9o9UHix1oGrunPK94561fjm7xlCyDzFC,fbPkOYLVPtPgIt0MxizjfFJov3JbHyAi,5,2,1,0,1,0,3,0,7,1.0,1,0.0,0,1,0,1,2,0,0,3,0,2,5,1
3819,94894,4n8D50YV3iUiSO6m3uW0Qx1bYmY1TKAP,fbPkOYLVPtPgIt0MxizjfFJov3JbHyAi,2,0,0,0,0,0,2,0,2,0.2857142857142857,1,0.0,0,0,0,0,0,0,0,2,0,0,2,1
3820,94895,8bCYaG7AP6aJY8s59sJr7EKW3GfZIzLQ,fbPkOYLVPtPgIt0MxizjfFJov3JbHyAi,1,0,0,0,0,0,1,0,1,0.14285714285714285,1,0.0,0,0,0,0,0,0,0,1,0,0,1,1
3821,94896,ykaUPJW4Nc9r2mv4b25QxgdHgIcQ63RQ,fbPkOYLVPtPgIt0MxizjfFJov3JbHyAi,5,4,0,0,0,0,2,0,6,0.8571428571428571,2,0.0,0,0,0,0,4,0,0,2,0,0,6,1
3822,94898,BxwiRwBCEgoMKzWOQQLk1jKrscukKpaC,fbPkOYLVPtPgIt0MxizjfFJov3JbHyAi,1,0,0,0,0,0,1,0,1,0.14285714285714285,1,0.0,0,0,0,0,0,0,0,1,0,0,1,1
3823,94905,HZUsNd9h6RIz72e7pYwO9LrQc6XgUw0C,fbPkOYLVPtPgIt0MxizjfFJov3JbHyAi,3,2,0,0,0,0,1,0,3,0.42857142857142855,1,0.0,0,0,0,0,2,0,0,1,0,0,3,1
3824,94911,B2XgVkwdGRNNRFw8S2rr86bubvgqLhLz,fbPkOYLVPtPgIt0MxizjfFJov3JbHyAi,2,0,0,0,0,0,5,0,5,0.7142857142857143,1,0.0,0,0,0,0,0,0,0,5,0,0,5,1
3825,95235,NDVe8xbt1XP1cAtDQ6t1Ohv3MmGzysIT,5Gyp41oLVo7Gg7vF4vpmggWP5MU70QO6,6,4,2,0,1,0,2,0,9,1.2857142857142858,1,0.0,1,2,0,1,3,0,0,2,0,4,5,1
3826,95237,SSpeewBDHUNKkvUJM5ASinNHvMXIOEwr,5Gyp41oLVo7Gg7vF4vpmggWP5MU70QO6,2,0,0,0,0,1,1,0,2,0.2857142857142857,1,0.0,0,0,0,0,0,1,0,1,0,0,2,1
3827,95254,YIoKCUIP4Rx4Vrk0MaySMDs3xqxsTZ0O,5Gyp41oLVo7Gg7vF4vpmggWP5MU70QO6,9,14,6,0,3,1,8,2,34,4.857142857142857,5,0.0,4,6,0,3,10,1,0,8,2,13,21,1
3828,95256,N9CQxvUgrnP9XQfIy0jBWdzeDSO6XRnQ,5Gyp41oLVo7Gg7vF4vpmggWP5MU70QO6,1,0,0,0,0,0,1,0,1,0.14285714285714285,1,0.0,0,0,0,0,0,0,0,1,0,0,1,1
3829,95278,gNPcbdnUndGrtQG9Vob7XSu4f95PgGqS,5Gyp41oLVo7Gg7vF4vpmggWP5MU70QO6,1,0,0,0,0,0,1,0,1,0.14285714285714285,1,0.0,0,0,0,0,0,0,0,1,0,0,1,1
3830,95294,eLddk0FueVUEJUwpfOsyoO4vLUtPFHIZ,5Gyp41oLVo7Gg7vF4vpmggWP5MU70QO6,1,0,0,0,0,0,1,0,1,0.14285714285714285,1,0.0,0,0,0,0,0,0,0,1,0,0,1,1
3831,95386,lVwgv61cg8fkhW9rg5b1PIPnuUWxb0Vk,A3fsA9Zfv1X2fVEQhTw51lKENdNrEqT3,55,39,33,32,20,34,11,0,169,24.142857142857142,6,0.0,0,33,32,20,39,34,0,11,0,85,84,0
3832,95425,79rw5BhFSnhvdIaVsXl3jeEXJRviIjGz,A3fsA9Zfv1X2fVEQhTw51lKENdNrEqT3,37,15,11,82,6,0,4,0,118,16.857142857142858,1,0.0,1,11,73,6,14,0,9,4,0,91,27,0
3833,95521,OF90Hu2g8vPUjKHCP4ULPYNMvRFKxBj6,SpATywNh6bZuzm8s1ceuBUnMUAeoAHHw,3,2,1,0,0,0,1,0,4,0.5714285714285714,1,0.0,0,1,0,0,2,0,0,1,0,1,3,0
3834,95605,UaSh8dwx8gnofYbXlmpqj9uYDbpJ89pX,A3fsA9Zfv1X2fVEQhTw51lKENdNrEqT3,10,17,1,0,1,8,4,0,31,4.428571428571429,3,0.0,0,1,0,1,17,8,0,4,0,2,29,1
3835,95814,pK3w2ljSu5UCiWTsVPCK8fUfSVn5X9S6,SpATywNh6bZuzm8s1ceuBUnMUAeoAHHw,18,13,9,4,5,0,1,0,32,4.571428571428571,1,0.0,2,9,4,5,11,0,0,1,0,20,12,1
3836,95958,Ar7wri6od2sIMOfx95hPmMwDttR4wtOC,A3fsA9Zfv1X2fVEQhTw51lKENdNrEqT3,30,19,12,46,5,0,2,0,84,12.0,2,0.0,1,12,42,5,18,0,4,2,0,60,24,0
3837,96116,liXvDig5u9dxIPwxTVIf3BkkLMQ16JFo,SpATywNh6bZuzm8s1ceuBUnMUAeoAHHw,4,2,1,0,1,0,1,0,5,0.7142857142857143,1,0.0,0,1,0,1,2,0,0,1,0,2,3,1
3838,96142,caI3PSZVJV9vybgXT1YDETSgX6OiKqyu,3VkHkmOtom3jM2wCu94xgzzu1d6Dn7or,6,5,0,0,0,0,8,1,14,2.0,2,0.0,0,0,0,0,5,0,0,8,1,0,14,1
3839,96144,YpILOnilrSXnYyzJyzvQfqbAFoUoBYq3,3VkHkmOtom3jM2wCu94xgzzu1d6Dn7or,7,19,7,5,3,0,4,0,38,5.428571428571429,1,0.0,7,7,4,3,12,0,1,4,0,21,17,1
3840,96149,WmkLZEHqvZSSHNuXpTIzYz9aXCoaAXEu,3VkHkmOtom3jM2wCu94xgzzu1d6Dn7or,4,2,0,0,0,0,2,0,4,0.5714285714285714,1,0.0,0,0,0,0,2,0,0,2,0,0,4,1
3841,96150,JPJEHkb7ceKbmMXu7q2vUQVG2Q0sFzMb,3VkHkmOtom3jM2wCu94xgzzu1d6Dn7or,1,0,0,0,0,0,1,0,1,0.14285714285714285,1,0.0,0,0,0,0,0,0,0,1,0,0,1,1
3842,96155,QbAmjeEWtsgDhz2dPpwm3A1TlqFNj1sk,3VkHkmOtom3jM2wCu94xgzzu1d6Dn7or,8,22,8,0,4,0,8,1,43,6.142857142857143,1,0.0,4,8,0,4,18,0,0,8,1,16,27,1
3843,96159,jdxhRXQlunGkgGozr0CmSVt4az5rQW1H,3VkHkmOtom3jM2wCu94xgzzu1d6Dn7or,3,2,0,0,0,2,1,0,5,0.7142857142857143,1,0.0,0,0,0,0,2,2,0,1,0,0,5,1
3844,96160,UEaboZzcqfS9Ix6BTl77zBz0w31ARcd9,3VkHkmOtom3jM2wCu94xgzzu1d6Dn7or,6,2,1,0,1,0,3,1,8,1.1428571428571428,1,0.0,0,1,0,1,2,0,0,3,1,2,6,1
3845,96168,GaHk8zyhEc7E6fQfTPctcyBcPQTBz1Ic,3VkHkmOtom3jM2wCu94xgzzu1d6Dn7or,1,0,0,0,0,0,2,0,2,0.2857142857142857,1,0.0,0,0,0,0,0,0,0,2,0,0,2,1
3846,96170,dtRLDQ2C6USVHbasT68RGoAenkwQj9YN,3VkHkmOtom3jM2wCu94xgzzu1d6Dn7or,7,2,1,0,1,1,12,0,17,2.4285714285714284,1,0.0,0,1,0,1,2,1,0,12,0,2,15,1
3847,96178,4dGHYVA6cJ7in6fqz7m3ZCazfFSrt5aw,3VkHkmOtom3jM2wCu94xgzzu1d6Dn7or,1,0,0,0,0,0,1,0,1,0.14285714285714285,1,0.0,0,0,0,0,0,0,0,1,0,0,1,1
3848,96179,f8NPAWkxxIvVYrmhTynJqnvnh4B34pcB,3VkHkmOtom3jM2wCu94xgzzu1d6Dn7or,3,2,1,0,0,0,1,0,4,0.5714285714285714,1,0.0,0,1,0,0,2,0,0,1,0,1,3,1
3849,96184,15MhnITb8yOg5Tgp8NKzSsWNl4TmQTrz,3VkHkmOtom3jM2wCu94xgzzu1d6Dn7or,1,0,0,0,0,0,1,0,1,0.14285714285714285,1,0.0,0,0,0,0,0,0,0,1,0,0,1,1
3850,96189,Z8FM9znorSGd2gIh0wpgciHb3gMeceeW,3VkHkmOtom3jM2wCu94xgzzu1d6Dn7or,1,0,0,0,0,0,2,0,2,0.2857142857142857,1,0.0,0,0,0,0,0,0,0,2,0,0,2,1
3851,96196,PPCyXqVBaGhYGnTiTJ4simhaairGHZIQ,3VkHkmOtom3jM2wCu94xgzzu1d6Dn7or,10,4,3,0,3,0,3,0,13,1.8571428571428572,1,0.0,0,3,0,3,4,0,0,3,0,6,7,1
3852,96200,bUJoVvQlhtk0G1tPgtXus9a6SddEpZ7c,3VkHkmOtom3jM2wCu94xgzzu1d6Dn7or,4,2,1,0,0,0,3,0,6,0.8571428571428571,2,0.0,0,1,0,0,2,0,0,3,0,1,5,1
3853,96203,8VMZMnJmdorfW3qbwQWE21Qr8kT0OjAq,3VkHkmOtom3jM2wCu94xgzzu1d6Dn7or,5,3,1,0,1,0,2,0,7,1.0,1,0.0,1,1,0,1,2,0,0,2,0,3,4,1
3854,96205,yOuSbLU4N1OMhsuKJoYnGYyoodl7Ts9u,3VkHkmOtom3jM2wCu94xgzzu1d6Dn7or,6,6,4,0,1,0,5,0,16,2.2857142857142856,1,0.0,0,4,0,1,6,0,0,5,0,5,11,1
3855,96227,VN7mIYOy9t6d92ozIKhBx0dLnBa4IRt3,3VkHkmOtom3jM2wCu94xgzzu1d6Dn7or,1,0,0,0,0,0,1,0,1,0.14285714285714285,1,0.0,0,0,0,0,0,0,0,1,0,0,1,1
3856,96232,kxygIhpaaZ3PJ4cUkB7uXqGox4OFtNxP,3VkHkmOtom3jM2wCu94xgzzu1d6Dn7or,61,169,54,64,32,18,25,1,363,51.857142857142854,6,0.0,44,54,60,32,125,18,4,25,1,190,173,0
3857,96233,itYp3FmXXqMtnnygyLsLYbk4Lj2Ne9y3,3VkHkmOtom3jM2wCu94xgzzu1d6Dn7or,1,0,0,0,0,0,1,0,1,0.14285714285714285,1,0.0,0,0,0,0,0,0,0,1,0,0,1,1
3858,96235,AvWqyaIKZiUzZlauikMvpqeQuQERwQok,3VkHkmOtom3jM2wCu94xgzzu1d6Dn7or,1,0,0,0,0,0,1,0,1,0.14285714285714285,1,0.0,0,0,0,0,0,0,0,1,0,0,1,1
3859,96238,wER6uLDxr0UZEAgeUPfX1ygued6Mtiwe,3VkHkmOtom3jM2wCu94xgzzu1d6Dn7or,6,3,1,0,1,0,6,0,11,1.5714285714285714,1,0.0,0,1,0,1,3,0,0,6,0,2,9,1
3860,96239,I3y8UhgjOmrKX2NiYCp9q6amv1bHjqBJ,3VkHkmOtom3jM2wCu94xgzzu1d6Dn7or,8,9,6,4,3,0,4,0,26,3.7142857142857144,2,0.0,1,6,3,3,8,0,1,4,0,13,13,1
3861,96249,qCCudDhDBVL7mBCyOnFJL2iRzzfhvt3U,3VkHkmOtom3jM2wCu94xgzzu1d6Dn7or,6,5,3,0,2,0,3,0,13,1.8571428571428572,1,0.0,0,3,0,2,5,0,0,3,0,5,8,1
3862,96252,vEtredLP6JeGTP1tI36oIC1lr6fbi8FG,3VkHkmOtom3jM2wCu94xgzzu1d6Dn7or,2,0,0,0,0,0,4,0,4,0.5714285714285714,1,0.0,0,0,0,0,0,0,0,4,0,0,4,1
3863,96262,Js2oj014Od6Evf51SQQ2ab956nBOgw7H,3VkHkmOtom3jM2wCu94xgzzu1d6Dn7or,1,0,0,0,0,0,1,0,1,0.14285714285714285,1,0.0,0,0,0,0,0,0,0,1,0,0,1,1
3864,96263,514TWhkGGUhLu2MdvTnb8eiBH3DCFHzg,3VkHkmOtom3jM2wCu94xgzzu1d6Dn7or,1,0,0,0,0,0,1,0,1,0.14285714285714285,1,0.0,0,0,0,0,0,0,0,1,0,0,1,1
3865,96266,oZELzmce26r0RkjZ0m6xDljWh8jSqTN4,3VkHkmOtom3jM2wCu94xgzzu1d6Dn7or,35,44,32,0,0,0,10,0,86,12.285714285714286,4,0.0,0,32,0,0,44,0,0,10,0,32,54,1
3866,96267,qkelwAXFbtM6rFKwOjkD6SqPuqMw9quR,3VkHkmOtom3jM2wCu94xgzzu1d6Dn7or,6,4,1,0,2,0,4,0,11,1.5714285714285714,1,0.0,2,1,0,2,2,0,0,4,0,5,6,1
3867,96275,PKmEAIBeprGq9oDbNdLfSyZfGsm9X211,3VkHkmOtom3jM2wCu94xgzzu1d6Dn7or,7,7,2,0,3,0,3,0,15,2.142857142857143,1,0.0,4,2,0,3,3,0,0,3,0,9,6,1
3868,96281,dJNMH0TAT59fJcke62Qm11VvwJlqoLnV,3VkHkmOtom3jM2wCu94xgzzu1d6Dn7or,5,2,1,0,1,3,3,0,10,1.4285714285714286,1,0.0,0,1,0,1,2,3,0,3,0,2,8,1
3869,96284,65SOEzC3tEVRfnwr4FWDkxslKFgyYKS5,3VkHkmOtom3jM2wCu94xgzzu1d6Dn7or,4,2,1,0,1,0,1,0,5,0.7142857142857143,1,0.0,0,1,0,1,2,0,0,1,0,2,3,1
3870,96285,CXUNKyJ74zshCjh6SwH6czHjX2gsHXo9,3VkHkmOtom3jM2wCu94xgzzu1d6Dn7or,8,4,1,0,1,0,7,0,13,1.8571428571428572,1,0.0,0,1,0,1,4,0,0,7,0,2,11,1
3871,96287,7mGdRiMzSbTybRB8CqLZKk01SINUa2wl,3VkHkmOtom3jM2wCu94xgzzu1d6Dn7or,6,17,6,0,5,0,4,0,32,4.571428571428571,1,0.0,5,6,0,5,12,0,0,4,0,16,16,1
3872,96291,OXYbE9lnceDjkHqL3j7DavnHu44aYICK,3VkHkmOtom3jM2wCu94xgzzu1d6Dn7or,9,5,2,0,1,8,20,4,40,5.714285714285714,1,0.0,0,2,0,1,5,8,0,20,4,3,37,1
3873,96293,5HOuH8aTViql1ay76pIsM5aWtb8sbk3t,3VkHkmOtom3jM2wCu94xgzzu1d6Dn7or,16,22,5,9,11,8,3,0,58,8.285714285714286,1,0.0,16,5,8,11,6,8,1,3,0,40,18,1
3874,96304,7VIT9JPp8XCGpLntesoOkNBJZdDnphRq,3VkHkmOtom3jM2wCu94xgzzu1d6Dn7or,1,0,0,0,0,0,1,0,1,0.14285714285714285,1,0.0,0,0,0,0,0,0,0,1,0,0,1,1
3875,96313,PVd30adlkZ856ALhBHv5eYeSe8xUebRv,3VkHkmOtom3jM2wCu94xgzzu1d6Dn7or,20,23,0,0,8,0,10,0,41,5.857142857142857,3,0.0,3,0,0,8,20,0,0,10,0,11,30,0
3876,96327,BWz3V22DqG4m59HybtARfMozxr4oxBiZ,3VkHkmOtom3jM2wCu94xgzzu1d6Dn7or,4,7,0,0,0,0,3,0,10,1.4285714285714286,1,0.0,0,0,0,0,7,0,0,3,0,0,10,1
3877,96328,yOIhIWmER9QfxNzVZ9qWzk3TtbueQdVp,3VkHkmOtom3jM2wCu94xgzzu1d6Dn7or,5,7,1,0,2,2,3,0,15,2.142857142857143,1,0.0,3,1,0,2,4,2,0,3,0,6,9,1
3878,96329,gg6GnzSIxzlLDmks8csmFGSQRPWeznPP,3VkHkmOtom3jM2wCu94xgzzu1d6Dn7or,4,3,0,0,0,0,5,0,8,1.1428571428571428,1,0.0,0,0,0,0,3,0,0,5,0,0,8,1
3879,96331,FdG2SbK8srygyvvvCNd0FilB9Es4Aw9q,3VkHkmOtom3jM2wCu94xgzzu1d6Dn7or,69,134,40,84,47,0,19,0,324,46.285714285714285,5,0.0,92,40,80,47,42,0,4,19,0,259,65,1
3880,96343,p9ADfMtOwrR3Jjw60Ob5CTQ2SVZ8InwM,3VkHkmOtom3jM2wCu94xgzzu1d6Dn7or,4,2,1,0,1,0,1,0,5,0.7142857142857143,1,0.0,0,1,0,1,2,0,0,1,0,2,3,1
3881,96345,kGiwkpye34paJt0E8ZP4DxvIGSOY6Bp8,3VkHkmOtom3jM2wCu94xgzzu1d6Dn7or,2,0,0,0,0,0,2,0,2,0.2857142857142857,1,0.0,0,0,0,0,0,0,0,2,0,0,2,0
3882,96346,SUyWlx9XAmZ1ZEMTEpbOhdH9FV7d7AwX,3VkHkmOtom3jM2wCu94xgzzu1d6Dn7or,17,26,5,17,9,6,9,0,72,10.285714285714286,2,0.0,15,5,15,9,11,6,2,9,0,44,28,1
3883,96353,lVKECvqxjl8Mk7xzhLwSaYRUApxIVVNf,3VkHkmOtom3jM2wCu94xgzzu1d6Dn7or,1,0,0,0,0,0,1,0,1,0.14285714285714285,1,0.0,0,0,0,0,0,0,0,1,0,0,1,1
3884,96354,HqOw6yjK73pA4yJXwGiuK5xAqvDl7hv2,3VkHkmOtom3jM2wCu94xgzzu1d6Dn7or,7,5,1,0,1,1,13,4,25,3.5714285714285716,3,0.0,2,1,0,1,3,1,0,13,4,4,21,0
3885,96365,t6vD6AYAFEhQMgu5MLEovLAyepLBZv30,3VkHkmOtom3jM2wCu94xgzzu1d6Dn7or,1,0,0,0,0,0,1,0,1,0.14285714285714285,1,0.0,0,0,0,0,0,0,0,1,0,0,1,1
3886,96373,fYctGxkVAPh34WQ0NVTZHAd2a6Iryb4D,3VkHkmOtom3jM2wCu94xgzzu1d6Dn7or,1,0,0,0,0,0,1,0,1,0.14285714285714285,1,0.0,0,0,0,0,0,0,0,1,0,0,1,1
3887,96382,hluzPB1y7zkKLSSzVkJvXfWNLyDAuRho,3VkHkmOtom3jM2wCu94xgzzu1d6Dn7or,6,4,3,0,3,0,1,0,11,1.5714285714285714,1,0.0,0,3,0,3,4,0,0,1,0,6,5,1
3888,96401,Un3EzEE4Sz8i5Z84q9e50URbIAEkkVSB,5Gyp41oLVo7Gg7vF4vpmggWP5MU70QO6,13,16,8,17,5,0,2,0,48,6.857142857142857,2,0.0,5,8,12,5,11,0,5,2,0,30,18,1
3889,96405,KUYY5Rqotmoetp2jjazu6cGkVx3pqz6d,5Gyp41oLVo7Gg7vF4vpmggWP5MU70QO6,27,63,14,21,14,0,19,1,132,18.857142857142858,7,0.0,12,14,15,14,51,0,6,19,1,55,77,1
3890,96444,lDlatmKJdo0qBYapZcbWQLsUydBhY3xU,5Gyp41oLVo7Gg7vF4vpmggWP5MU70QO6,3,0,0,0,0,0,3,0,3,0.42857142857142855,1,0.0,0,0,0,0,0,0,0,3,0,0,3,1
3891,96446,gscO81uyFXakN6G7EORyf3gCaOhqQGKx,5Gyp41oLVo7Gg7vF4vpmggWP5MU70QO6,6,4,3,0,1,0,1,0,9,1.2857142857142858,1,0.0,0,3,0,1,4,0,0,1,0,4,5,1
3892,96458,LV1nIAvjptPun2V4leWKwnP3KZdMJc2a,5Gyp41oLVo7Gg7vF4vpmggWP5MU70QO6,5,7,2,0,0,0,5,0,14,2.0,1,0.0,1,2,0,0,6,0,0,5,0,3,11,1
3893,96520,VG5bA35PGkMDO1KNnYhrFcOHkVOY1NtY,3VkHkmOtom3jM2wCu94xgzzu1d6Dn7or,9,19,1,10,0,7,11,1,49,7.0,2,0.0,2,1,8,0,17,7,2,11,1,11,38,1
3894,96522,kKj1FlDO03hIJs4qO2fYyQxEzv7HbwXh,3VkHkmOtom3jM2wCu94xgzzu1d6Dn7or,9,6,2,0,1,0,4,1,14,2.0,1,0.0,0,2,0,1,6,0,0,4,1,3,11,1
3895,96524,W8okOCr8x8pY5E81B83539j1pFhitUMq,3VkHkmOtom3jM2wCu94xgzzu1d6Dn7or,3,1,0,0,0,0,3,0,4,0.5714285714285714,1,0.0,0,0,0,0,1,0,0,3,0,0,4,1
3896,96525,dwtg9A6LugmDZ5duYp9HulbrLf0NjOJH,3VkHkmOtom3jM2wCu94xgzzu1d6Dn7or,16,17,5,19,4,2,3,1,51,7.285714285714286,1,0.0,4,5,16,4,13,2,3,3,1,29,22,1
3897,96527,BIuaj0JMJBIdhO8MEgNTHmWapQlWsal0,3VkHkmOtom3jM2wCu94xgzzu1d6Dn7or,1,0,0,0,0,0,1,0,1,0.14285714285714285,1,0.0,0,0,0,0,0,0,0,1,0,0,1,1
3898,96532,v9O5halsKUv53gKg9koQBCw6L2IPGs2n,3VkHkmOtom3jM2wCu94xgzzu1d6Dn7or,2,0,0,0,0,0,2,0,2,0.2857142857142857,1,0.0,0,0,0,0,0,0,0,2,0,0,2,1
3899,96537,GdWpPGRpew3mdaEJ8CztRU45JrR7axlv,3VkHkmOtom3jM2wCu94xgzzu1d6Dn7or,1,0,0,0,0,0,1,0,1,0.14285714285714285,1,0.0,0,0,0,0,0,0,0,1,0,0,1,1
3900,96539,ms6xfKdleOkvOvwF7IgWafwJkOK422hV,3VkHkmOtom3jM2wCu94xgzzu1d6Dn7or,4,2,1,0,0,0,2,0,5,0.7142857142857143,1,0.0,0,1,0,0,2,0,0,2,0,1,4,1
3901,96551,1Su0fVG6Gi9jw62IGpYtFJkh1mWH5fcC,3VkHkmOtom3jM2wCu94xgzzu1d6Dn7or,8,6,0,0,0,2,18,5,31,4.428571428571429,1,0.0,0,0,0,0,6,2,0,18,5,0,31,1
3902,96553,PLC3pMF29QbxxtVOXplTvspzXElysW1A,3VkHkmOtom3jM2wCu94xgzzu1d6Dn7or,5,5,3,0,2,0,2,0,12,1.7142857142857142,2,0.0,0,3,0,2,5,0,0,2,0,5,7,1
3903,96554,ym7kGg5ui15HWNyuMI6m7sQaMRNp6TJn,3VkHkmOtom3jM2wCu94xgzzu1d6Dn7or,5,3,1,0,1,0,2,0,7,1.0,1,0.0,1,1,0,1,2,0,0,2,0,3,4,1
3904,96557,mAtPYhgVQEdXuexaQz1O6am3axcwvcQv,3VkHkmOtom3jM2wCu94xgzzu1d6Dn7or,6,16,6,0,2,0,3,0,27,3.857142857142857,3,0.0,0,6,0,2,16,0,0,3,0,8,19,1
3905,96572,5kMWoPZVnOlCdDv2aBIV7LFqiD7AOPMi,3VkHkmOtom3jM2wCu94xgzzu1d6Dn7or,5,6,1,0,2,0,3,0,12,1.7142857142857142,1,0.0,2,1,0,2,4,0,0,3,0,5,7,1
3906,96573,egpXv13dykaiU64GCgTaQGg1ErRD7Rsb,3VkHkmOtom3jM2wCu94xgzzu1d6Dn7or,1,0,0,0,0,0,1,0,1,0.14285714285714285,1,0.0,0,0,0,0,0,0,0,1,0,0,1,1
3907,96574,PXxCtbmVtxEeyK5pz3blfoRYSpiEgn9z,3VkHkmOtom3jM2wCu94xgzzu1d6Dn7or,5,2,1,0,1,0,2,0,6,0.8571428571428571,1,0.0,0,1,0,1,2,0,0,2,0,2,4,1
3908,96590,nVR6dwapzxrYZVkIMGiVw3CgFu50vE99,3VkHkmOtom3jM2wCu94xgzzu1d6Dn7or,8,2,1,0,1,0,8,1,13,1.8571428571428572,1,0.0,0,1,0,1,2,0,0,8,1,2,11,1
3909,96591,pkXHoiBE5KVw2DqtLUl3ylE2T0vC8QHo,3VkHkmOtom3jM2wCu94xgzzu1d6Dn7or,1,0,0,0,0,0,2,0,2,0.2857142857142857,1,0.0,0,0,0,0,0,0,0,2,0,0,2,0
3910,96596,z0RvqjPPDctlehk93QbsTkC9mdJE5bcB,3VkHkmOtom3jM2wCu94xgzzu1d6Dn7or,6,6,1,0,2,0,4,0,13,1.8571428571428572,1,0.0,3,1,0,2,3,0,0,4,0,6,7,1
3911,96597,qoxPKfkHxJeAIo04LboW9EiXaMAiwKC4,3VkHkmOtom3jM2wCu94xgzzu1d6Dn7or,1,0,0,0,0,0,1,0,1,0.14285714285714285,1,0.0,0,0,0,0,0,0,0,1,0,0,1,1
3912,96606,Nx1xmPxU2RlIvjZppz8vBPHelTvW59ca,3VkHkmOtom3jM2wCu94xgzzu1d6Dn7or,5,2,1,0,0,0,5,0,8,1.1428571428571428,1,0.0,0,1,0,0,2,0,0,5,0,1,7,1
3913,96613,SmwM4tXKNze1zNIsPMRc2eNlAs4eoeOB,3VkHkmOtom3jM2wCu94xgzzu1d6Dn7or,57,126,49,27,41,0,12,3,258,36.857142857142854,5,0.0,39,49,25,41,87,0,2,12,3,154,104,1
3914,96618,ABbPtVE9vR3q9TnGdVr0jhQS05eL9aJw,3VkHkmOtom3jM2wCu94xgzzu1d6Dn7or,4,10,0,0,0,0,2,0,12,1.7142857142857142,1,0.0,4,0,0,0,6,0,0,2,0,4,8,1
3915,96640,DPsmKaIBv5J6hnXaTvzHdr4bLJTjOCyc,3VkHkmOtom3jM2wCu94xgzzu1d6Dn7or,6,5,2,0,2,0,5,2,16,2.2857142857142856,1,0.0,0,2,0,2,5,0,0,5,2,4,12,1
3916,96641,sORoVXXDgl7FhK0kOm8ff9nMx0CSL3ax,3VkHkmOtom3jM2wCu94xgzzu1d6Dn7or,2,0,0,0,0,0,6,0,6,0.8571428571428571,1,0.0,0,0,0,0,0,0,0,6,0,0,6,1
3917,96642,UMj7qRVoOO3EkcdC2vK59zqDHYCN3YZ7,3VkHkmOtom3jM2wCu94xgzzu1d6Dn7or,6,2,1,0,1,0,14,0,18,2.5714285714285716,2,0.0,0,1,0,1,2,0,0,14,0,2,16,1
3918,96658,LK8u1EXzDY1NrnXiE5JB2LK2Ot6N6D1F,3VkHkmOtom3jM2wCu94xgzzu1d6Dn7or,2,0,0,0,0,0,2,0,2,0.2857142857142857,1,0.0,0,0,0,0,0,0,0,2,0,0,2,1
3919,96669,ox9NKatEBLgYaNb1N5o0nmPeS8YpJB89,SpATywNh6bZuzm8s1ceuBUnMUAeoAHHw,3,2,0,0,0,0,1,0,3,0.42857142857142855,1,0.0,0,0,0,0,2,0,0,1,0,0,3,1
3920,96677,xOjhmcafCtLT2q16oVNZpjeZh4FUCy6U,A3fsA9Zfv1X2fVEQhTw51lKENdNrEqT3,12,11,9,0,7,0,3,0,30,4.285714285714286,1,0.0,0,9,0,7,11,0,0,3,0,16,14,1
3921,96686,qpd1RINX0ghAugS9ZiQmRvWMQe2xJWfG,RXDvfPUBYFlVdlueBFbLW0mhhAyGEqpt,1,0,0,0,0,0,2,0,2,0.2857142857142857,1,0.0,0,0,0,0,0,0,0,2,0,0,2,1
3922,96695,plWW2jbmbdQAaG18LPwZIwpV7ZE0ypXp,SpATywNh6bZuzm8s1ceuBUnMUAeoAHHw,33,56,34,39,17,19,9,3,177,25.285714285714285,2,0.0,9,34,33,17,47,19,6,9,3,93,84,0
3923,96701,D6fP4TUPeMrRaZv1s9hIwWRvTnUOqwXl,SpATywNh6bZuzm8s1ceuBUnMUAeoAHHw,4,2,1,0,0,0,2,0,5,0.7142857142857143,1,0.0,0,1,0,0,2,0,0,2,0,1,4,1
3924,96719,l7f4vHvlZkxCYoU9qM63V45bmndBSeZQ,G8EPVSXsOYB5YQWZGiz1aVq5Pgr2GrQu,67,13,7,257,1,0,2,0,280,40.0,1,0.0,0,7,199,1,13,0,58,2,0,207,73,1
3925,96724,Vqh7IxciNu3w4ryq9DwYRMQWb1h8f16V,SpATywNh6bZuzm8s1ceuBUnMUAeoAHHw,30,33,15,24,10,0,3,0,85,12.142857142857142,1,0.0,7,15,21,10,26,0,3,3,0,53,32,1
3926,96728,BOb6BiUk5x51duyreHhUz5u1LJUpA9P4,bWdj2GDclj5ofokWjzoa5jAwMkxCykd6,14,11,5,18,7,8,12,1,62,8.857142857142858,1,0.0,4,5,17,7,7,8,1,12,1,33,29,1
3927,96732,RHsk3gHUm8VEfb9FwEFf8vBDNKZZ0LWe,A3fsA9Zfv1X2fVEQhTw51lKENdNrEqT3,2,0,0,0,0,0,4,0,4,0.5714285714285714,1,0.0,0,0,0,0,0,0,0,4,0,0,4,1
3928,96767,HVjDCDKIJj1upsVXxBXkt7RhefGcCnlo,5X6FeZozNMgE2VRi3MJYjkkFK8SETtu2,6,0,0,0,0,0,7,1,8,1.1428571428571428,1,0.0,0,0,0,0,0,0,0,7,1,0,8,1
3929,96790,2qs5o4ShoJi8U8TmD1cNHDzshN8FK6oF,RXDvfPUBYFlVdlueBFbLW0mhhAyGEqpt,1,0,0,0,0,0,1,0,1,0.14285714285714285,1,0.0,0,0,0,0,0,0,0,1,0,0,1,1
3930,96797,ruXsBlJCykTUOLzthXWdDIn2j4fWrsqb,SpATywNh6bZuzm8s1ceuBUnMUAeoAHHw,26,18,13,1,10,0,4,0,46,6.571428571428571,2,0.0,2,13,1,10,16,0,0,4,0,26,20,1
3931,96868,em6ahWcMRmenNOPIHJ0IxuoaSlBI3zdC,SpATywNh6bZuzm8s1ceuBUnMUAeoAHHw,8,9,6,0,4,0,7,0,26,3.7142857142857144,2,0.0,0,6,0,4,9,0,0,7,0,10,16,1
3932,96895,Ip3irZsxFvOeGg8WSppVhJArbPhoH3qm,A3fsA9Zfv1X2fVEQhTw51lKENdNrEqT3,6,4,2,0,1,0,1,0,8,1.1428571428571428,1,0.0,0,2,0,1,4,0,0,1,0,3,5,1
3933,96900,U74IyVXcSeKcVNZXE9AVeORjHrqTX1QT,A3fsA9Zfv1X2fVEQhTw51lKENdNrEqT3,11,10,1,0,1,2,12,1,27,3.857142857142857,1,0.0,0,1,0,1,10,2,0,12,1,2,25,1
3934,96905,loMeJnte2hFeHZBJ0Bg6siKOtraEIBl0,SpATywNh6bZuzm8s1ceuBUnMUAeoAHHw,7,8,5,0,2,0,3,0,18,2.5714285714285716,1,0.0,0,5,0,2,8,0,0,3,0,7,11,1
3935,96908,OF2M41yRlwCyz2O0q40BYZxOHi0g0vah,SpATywNh6bZuzm8s1ceuBUnMUAeoAHHw,2,0,0,0,0,0,2,0,2,0.2857142857142857,1,0.0,0,0,0,0,0,0,0,2,0,0,2,1
3936,96916,zvew9uiEAc86Yp9YluqFrNFVBMozMu7i,bWdj2GDclj5ofokWjzoa5jAwMkxCykd6,1,0,0,0,0,0,1,0,1,0.14285714285714285,1,0.0,0,0,0,0,0,0,0,1,0,0,1,1
3937,96926,f65jLVnOZmyS7NngLSsomvGh5edmSblj,SpATywNh6bZuzm8s1ceuBUnMUAeoAHHw,1,0,0,0,0,0,1,0,1,0.14285714285714285,1,0.0,0,0,0,0,0,0,0,1,0,0,1,1
3938,96929,uaGHWOyiH6GRJNYQ5wYQgdGgJiyGijb7,SpATywNh6bZuzm8s1ceuBUnMUAeoAHHw,18,24,5,6,3,0,5,0,43,6.142857142857143,2,0.0,2,5,5,3,22,0,1,5,0,15,28,0
3939,96933,mgC2SKl3BkBHgSzUjS94KW5V0rxosMWt,SpATywNh6bZuzm8s1ceuBUnMUAeoAHHw,7,7,3,2,1,0,1,0,14,2.0,1,0.0,3,3,1,1,4,0,1,1,0,8,6,0
3940,96957,YPgg2F1CAgvl8C6YTtaiELfvzhMGfPjI,A3fsA9Zfv1X2fVEQhTw51lKENdNrEqT3,1,0,0,0,0,0,1,0,1,0.14285714285714285,1,0.0,0,0,0,0,0,0,0,1,0,0,1,1
3941,96982,1BEo7fZ8J0CF8e5039UrK6WkzsnT15rN,A3fsA9Zfv1X2fVEQhTw51lKENdNrEqT3,1,0,0,0,0,0,1,0,1,0.14285714285714285,1,0.0,0,0,0,0,0,0,0,1,0,0,1,1
3942,97010,zFfZShI4wofndTbpmWxWI7MWPBQc6ezg,A3fsA9Zfv1X2fVEQhTw51lKENdNrEqT3,2,0,0,0,0,0,2,0,2,0.2857142857142857,1,0.0,0,0,0,0,0,0,0,2,0,0,2,0
3943,97017,MSXFOc30HZVbYZtATkSJwT5euFO05BA1,5X6FeZozNMgE2VRi3MJYjkkFK8SETtu2,1,0,0,0,0,0,1,0,1,0.14285714285714285,1,0.0,0,0,0,0,0,0,0,1,0,0,1,1
3944,97064,cpRbfaNv5usLp7El18VnnTqxc7iB3VdC,A3fsA9Zfv1X2fVEQhTw51lKENdNrEqT3,2,0,0,0,0,0,2,0,2,0.2857142857142857,1,0.0,0,0,0,0,0,0,0,2,0,0,2,0
3945,97102,RJ2AN96oZxuBCR52LgUmQpj4g9Y4mcD4,A3fsA9Zfv1X2fVEQhTw51lKENdNrEqT3,1,0,0,0,0,0,1,0,1,0.14285714285714285,1,0.0,0,0,0,0,0,0,0,1,0,0,1,1
3946,97152,JGnVyZ53gH9wjqC3YYjpGEbabkw7ZVhR,A3fsA9Zfv1X2fVEQhTw51lKENdNrEqT3,6,4,3,0,1,0,4,0,12,1.7142857142857142,1,0.0,0,3,0,1,4,0,0,4,0,4,8,1
3947,97159,5DIcniD9kRbDupVPBNugV5by0SZHtD2e,A3fsA9Zfv1X2fVEQhTw51lKENdNrEqT3,1,0,0,0,0,0,3,0,3,0.42857142857142855,1,0.0,0,0,0,0,0,0,0,3,0,0,3,1
3948,97165,YE22fRNdaFtk3nhWfjSOMHWERX5O7Ymi,7GRhBDsirIGkRZBtSMEzNTyDr2JQm4xx,16,14,1,0,0,0,3,0,18,2.5714285714285716,1,0.0,0,1,0,0,14,0,0,3,0,1,17,1
3949,97172,9ZsKIy2cZdyg37tMFhcfbfMbCgb1Euwl,A3fsA9Zfv1X2fVEQhTw51lKENdNrEqT3,5,2,1,0,1,0,2,0,6,0.8571428571428571,1,0.0,0,1,0,1,2,0,0,2,0,2,4,1
3950,97198,NCbFqYNTEfc5vPQvAyBwDtnbS3ENYJY7,A3fsA9Zfv1X2fVEQhTw51lKENdNrEqT3,1,0,0,0,0,0,1,0,1,0.14285714285714285,1,0.0,0,0,0,0,0,0,0,1,0,0,1,1
3951,97224,PKH12j56WyhhHbwNNO7EjzMEo1oeOneA,A3fsA9Zfv1X2fVEQhTw51lKENdNrEqT3,4,7,0,0,0,0,1,0,8,1.1428571428571428,1,0.0,0,0,0,0,7,0,0,1,0,0,8,1
3952,97233,Jpxsd7AQ90urdftfAf3y5kTy6w3x8OIk,A3fsA9Zfv1X2fVEQhTw51lKENdNrEqT3,2,0,0,0,0,0,2,0,2,0.2857142857142857,2,0.0,0,0,0,0,0,0,0,2,0,0,2,1
3953,97332,5MXvp0QvzlvNUKeivxKIinvGCr9tUfSF,5X6FeZozNMgE2VRi3MJYjkkFK8SETtu2,4,2,1,0,1,0,1,0,5,0.7142857142857143,1,0.0,0,1,0,1,2,0,0,1,0,2,3,1
3954,97350,s7ckXc9uqf8Feg3vkW3n7xahOUlBlKla,A3fsA9Zfv1X2fVEQhTw51lKENdNrEqT3,18,41,1,0,1,0,4,0,47,6.714285714285714,1,0.0,0,1,0,1,41,0,0,4,0,2,45,1
3955,97355,TLSHokviSrCaXoZpssG6riwyfhdocRcz,A3fsA9Zfv1X2fVEQhTw51lKENdNrEqT3,3,0,0,0,0,0,3,0,3,0.42857142857142855,1,0.0,0,0,0,0,0,0,0,3,0,0,3,0
3956,97410,TzuMwfaAW66vzYCJbLJUrM2CQWUNVBwC,A3fsA9Zfv1X2fVEQhTw51lKENdNrEqT3,4,2,1,0,1,0,1,0,5,0.7142857142857143,1,0.0,0,1,0,1,2,0,0,1,0,2,3,1
3957,97459,gtKTzkXHwS41ljYVmjlLLf4WyQSkK02q,A3fsA9Zfv1X2fVEQhTw51lKENdNrEqT3,3,3,2,0,0,0,1,0,6,0.8571428571428571,2,0.0,0,2,0,0,3,0,0,1,0,2,4,0
3958,97533,LzIeScVJDrRe6pKpJZPOE5digO2qGiFj,A3fsA9Zfv1X2fVEQhTw51lKENdNrEqT3,114,83,66,274,42,0,6,0,471,67.28571428571429,4,0.0,5,66,242,42,78,0,32,6,0,355,116,0
3959,97546,ecpi7DZ71ZRx6H6XAh885uO1l0O5kvOG,5X6FeZozNMgE2VRi3MJYjkkFK8SETtu2,3,4,1,0,0,0,1,0,6,0.8571428571428571,1,0.0,2,1,0,0,2,0,0,1,0,3,3,1
3960,97578,tJSuuWZXDdoXjZXIctAWwDLD7oHTWJ9T,7GRhBDsirIGkRZBtSMEzNTyDr2JQm4xx,1,0,0,0,0,0,1,0,1,0.14285714285714285,1,0.0,0,0,0,0,0,0,0,1,0,0,1,1
3961,97634,hGCwfWh9ySQVbALdmRR0HUMpPic5OOrw,A3fsA9Zfv1X2fVEQhTw51lKENdNrEqT3,4,2,0,0,0,0,2,0,4,0.5714285714285714,1,0.0,0,0,0,0,2,0,0,2,0,0,4,0
3962,97690,EmgNBDQJ8EX1zHweYbszHLZL5Ix1zd1R,5X6FeZozNMgE2VRi3MJYjkkFK8SETtu2,2,0,0,0,0,0,2,0,2,0.2857142857142857,1,0.0,0,0,0,0,0,0,0,2,0,0,2,1
3963,97719,0OpVcmwG6bVPxKzOCpgJ9F6MfBtuGolr,A3fsA9Zfv1X2fVEQhTw51lKENdNrEqT3,1,0,0,0,0,0,2,0,2,0.2857142857142857,1,0.0,0,0,0,0,0,0,0,2,0,0,2,1
3964,97789,rUoEyfIkacNKFckMvyv3DLlxAp35p4TH,A3fsA9Zfv1X2fVEQhTw51lKENdNrEqT3,1,0,0,0,0,0,1,0,1,0.14285714285714285,1,0.0,0,0,0,0,0,0,0,1,0,0,1,1
3965,97802,UE0j9MGy4QtlCAV0dPJenzIfee02vh9K,5X6FeZozNMgE2VRi3MJYjkkFK8SETtu2,2,0,0,0,0,0,2,0,2,0.2857142857142857,1,0.0,0,0,0,0,0,0,0,2,0,0,2,1
3966,97810,hRSdlrMEn8a0TvCiHu323STjlE2OMxnW,A3fsA9Zfv1X2fVEQhTw51lKENdNrEqT3,2,0,0,0,0,0,2,0,2,0.2857142857142857,1,0.0,0,0,0,0,0,0,0,2,0,0,2,1
3967,97840,Ffohn9JNnGJQD2IavzMTS00ubnVtcb2T,A3fsA9Zfv1X2fVEQhTw51lKENdNrEqT3,54,39,30,60,17,0,8,0,154,22.0,4,0.0,1,30,54,17,38,0,6,8,0,102,52,0
3968,97893,txRaMeFRdTsCsziGBMMxzL5gSPIB7mbk,A3fsA9Zfv1X2fVEQhTw51lKENdNrEqT3,1,0,0,0,0,0,1,0,1,0.14285714285714285,1,0.0,0,0,0,0,0,0,0,1,0,0,1,1
3969,97926,ljhf5g1EQ7jx5ix8jB5hWiDB2kvoIcKv,3VkHkmOtom3jM2wCu94xgzzu1d6Dn7or,1,0,0,0,0,0,1,0,1,0.14285714285714285,1,0.0,0,0,0,0,0,0,0,1,0,0,1,1
3970,97935,HOh9uzKRHmixUSVl017qRO1fRhTakF2v,3VkHkmOtom3jM2wCu94xgzzu1d6Dn7or,1,0,0,0,0,0,1,0,1,0.14285714285714285,1,0.0,0,0,0,0,0,0,0,1,0,0,1,1
3971,97975,koG1j5O2D3Y4q0uVrIDera1nTAOOAZou,3VkHkmOtom3jM2wCu94xgzzu1d6Dn7or,1,0,0,0,0,0,1,0,1,0.14285714285714285,1,0.0,0,0,0,0,0,0,0,1,0,0,1,1
3972,98070,21S9MbpvSLw6ivno28dfYq6qQvy9jenJ,3VkHkmOtom3jM2wCu94xgzzu1d6Dn7or,1,0,0,0,0,0,1,0,1,0.14285714285714285,1,0.0,0,0,0,0,0,0,0,1,0,0,1,1
3973,98113,RoxLW3Wy1f0epWfgJFiZuhsVWdjFJxPT,3VkHkmOtom3jM2wCu94xgzzu1d6Dn7or,1,0,0,0,0,0,1,0,1,0.14285714285714285,1,0.0,0,0,0,0,0,0,0,1,0,0,1,1
3974,98116,ZUXSgoWa1Zgiwa3VeN9bfT2KJSPhTmyf,3VkHkmOtom3jM2wCu94xgzzu1d6Dn7or,1,0,0,0,0,0,1,0,1,0.14285714285714285,1,0.0,0,0,0,0,0,0,0,1,0,0,1,1
3975,98158,xv47Ihv1zjQOXkOaD45qDKOAj5WMwi8W,3VkHkmOtom3jM2wCu94xgzzu1d6Dn7or,9,17,5,9,5,7,7,0,50,7.142857142857143,2,0.0,10,5,6,5,7,7,3,7,0,26,24,1
3976,98166,fowR3ytWz16XiEoFapC5W8FuRvJmFQ5B,3VkHkmOtom3jM2wCu94xgzzu1d6Dn7or,2,1,0,0,0,2,1,0,4,0.5714285714285714,1,0.0,0,0,0,0,1,2,0,1,0,0,4,1
3977,98206,7n74l0OP83bbF4PlH4IxmN5kXcszgFDZ,3VkHkmOtom3jM2wCu94xgzzu1d6Dn7or,11,6,5,0,5,0,5,0,21,3.0,1,0.0,0,5,0,5,6,0,0,5,0,10,11,0
3978,98225,YUXH2bCoGQTPdapQbBa2WhLdBiH2D8Uj,3VkHkmOtom3jM2wCu94xgzzu1d6Dn7or,1,0,0,0,0,0,1,0,1,0.14285714285714285,1,0.0,0,0,0,0,0,0,0,1,0,0,1,1
3979,98231,S0tBPyosNVcd5iV87PahIGIe14TwUuJG,3VkHkmOtom3jM2wCu94xgzzu1d6Dn7or,4,3,1,0,2,0,1,0,7,1.0,1,0.0,0,1,0,2,3,0,0,1,0,3,4,1
3980,98250,Yhzt57ERvxf6GSoktyXqqveoccrAAX58,3VkHkmOtom3jM2wCu94xgzzu1d6Dn7or,1,0,0,0,0,0,1,0,1,0.14285714285714285,1,0.0,0,0,0,0,0,0,0,1,0,0,1,0
3981,98283,Rpqg9P88bPENhqF4ssy9Vus2UdJpa2gS,3VkHkmOtom3jM2wCu94xgzzu1d6Dn7or,39,141,45,52,29,26,19,3,315,45.0,7,0.0,41,45,50,29,100,26,2,19,3,165,150,1
3982,98330,eHgUt0UwvV0VhzTIYRH6GzapRWyNHi93,3VkHkmOtom3jM2wCu94xgzzu1d6Dn7or,3,2,0,0,0,0,1,0,3,0.42857142857142855,1,0.0,0,0,0,0,2,0,0,1,0,0,3,0
3983,98354,zjfRXzwfNIBGbyKSYoRe2YGJ584ezl3u,3VkHkmOtom3jM2wCu94xgzzu1d6Dn7or,4,0,0,0,0,2,4,0,6,0.8571428571428571,1,0.0,0,0,0,0,0,2,0,4,0,0,6,1
3984,98414,cePZXTMU8bX7HNyM6y6bVRMghrWRlwbt,3VkHkmOtom3jM2wCu94xgzzu1d6Dn7or,8,7,4,0,1,0,8,0,20,2.857142857142857,4,0.0,0,4,0,1,7,0,0,8,0,5,15,0
3985,98453,ZSzUjI43nc7UP7nA90at0ILPF5htFxqb,3VkHkmOtom3jM2wCu94xgzzu1d6Dn7or,9,4,3,0,3,0,7,0,17,2.4285714285714284,2,0.0,0,3,0,3,4,0,0,7,0,6,11,1
3986,98497,sYzJwN5kchvV5MDWtabtkHuh04wAlcRP,3VkHkmOtom3jM2wCu94xgzzu1d6Dn7or,6,5,3,0,2,0,6,0,16,2.2857142857142856,1,0.0,0,3,0,2,5,0,0,6,0,5,11,1
3987,98537,JdnAKegVyobYzWIb05yj4GZ7Vu8KLm6L,3VkHkmOtom3jM2wCu94xgzzu1d6Dn7or,18,33,9,8,12,19,24,0,105,15.0,1,0.0,19,9,7,12,14,19,1,24,0,47,58,1
3988,98625,XPiygQf4f2L0UgTrmMFFqxeKe6BZR3ej,3VkHkmOtom3jM2wCu94xgzzu1d6Dn7or,1,0,0,0,0,0,1,0,1,0.14285714285714285,1,0.0,0,0,0,0,0,0,0,1,0,0,1,1
3989,98758,iNmVC3DKFHfjgZSKABDd7IUAUNxDakXU,3VkHkmOtom3jM2wCu94xgzzu1d6Dn7or,7,9,4,2,4,0,1,0,20,2.857142857142857,1,0.0,4,4,2,4,5,0,0,1,0,14,6,1
3990,98760,rWol7hEiEuUpnZ0ibUv4aNnaeGzwARsw,3VkHkmOtom3jM2wCu94xgzzu1d6Dn7or,2,0,0,0,0,0,3,0,3,0.42857142857142855,1,0.0,0,0,0,0,0,0,0,3,0,0,3,1
3991,98778,Fb4URbfUO5USbMNTAtAoU1u178CKFwVo,3VkHkmOtom3jM2wCu94xgzzu1d6Dn7or,8,7,3,0,2,1,9,1,23,3.2857142857142856,2,0.0,0,3,0,2,7,1,0,9,1,5,18,1
3992,98794,oJ0e8Gg5W4q19gCqNR0VDu9RrnQl36js,3VkHkmOtom3jM2wCu94xgzzu1d6Dn7or,1,0,0,0,0,0,1,0,1,0.14285714285714285,1,0.0,0,0,0,0,0,0,0,1,0,0,1,1
3993,98810,bmM3jdkdNUNaPSRsgAKKNTDhfyA7XqWJ,3VkHkmOtom3jM2wCu94xgzzu1d6Dn7or,1,0,0,0,0,0,1,0,1,0.14285714285714285,1,0.0,0,0,0,0,0,0,0,1,0,0,1,1
3994,98816,6cHPiLDy925kya7u5yKBPmN9vGck1Edm,3VkHkmOtom3jM2wCu94xgzzu1d6Dn7or,7,7,2,0,4,0,2,0,15,2.142857142857143,1,0.0,2,2,0,4,5,0,0,2,0,8,7,1
3995,98836,i90DEJVTzM2ogFaLIi9atsn1Hoj1WpWL,3VkHkmOtom3jM2wCu94xgzzu1d6Dn7or,4,2,1,0,1,0,1,0,5,0.7142857142857143,1,0.0,0,1,0,1,2,0,0,1,0,2,3,0
3996,98837,srCmPgynCXjAmKOXXpaqGyGvobGqB8iu,3VkHkmOtom3jM2wCu94xgzzu1d6Dn7or,46,146,1,77,4,0,15,1,244,34.857142857142854,3,0.0,70,1,77,4,76,0,0,15,1,152,92,0
3997,98868,OvtFK9fZDazZHSZfHJFNzZShaT3svtVk,3VkHkmOtom3jM2wCu94xgzzu1d6Dn7or,4,2,0,0,1,0,1,0,4,0.5714285714285714,1,0.0,0,0,0,1,2,0,0,1,0,1,3,1
3998,98918,DUI5Pj6CvQUDnDmnbtTuT3AqIQLmCvbp,3VkHkmOtom3jM2wCu94xgzzu1d6Dn7or,1,0,0,0,0,0,2,0,2,0.2857142857142857,2,0.0,0,0,0,0,0,0,0,2,0,0,2,1
3999,98943,3GTJVwpejfuxIInftaaUc0uuiqyYtFQY,3VkHkmOtom3jM2wCu94xgzzu1d6Dn7or,1,0,0,0,0,0,1,0,1,0.14285714285714285,1,0.0,0,0,0,0,0,0,0,1,0,0,1,1
4000,99237,LHfLvP0G4hEksRdVPdjxg85LuBgQzx3S,bWdj2GDclj5ofokWjzoa5jAwMkxCykd6,13,9,0,38,1,52,12,1,113,16.142857142857142,2,0.0,5,0,36,1,4,52,2,12,1,42,71,0
4001,99336,3gXjYz3VFr0TvsDYUgKtksPt5WrPBmEo,SpATywNh6bZuzm8s1ceuBUnMUAeoAHHw,9,7,4,0,4,0,1,0,16,2.2857142857142856,1,0.0,0,4,0,4,7,0,0,1,0,8,8,0
4002,99464,VFYk1GyeJyGqK1t09cLe0E5m7KsULmvc,SpATywNh6bZuzm8s1ceuBUnMUAeoAHHw,3,6,3,0,0,0,3,0,12,1.7142857142857142,3,0.0,0,3,0,0,6,0,0,3,0,3,9,1
4003,100105,MKNBl3hhuuRZuBxyPOWBVV1OHzyXBuxg,SpATywNh6bZuzm8s1ceuBUnMUAeoAHHw,6,10,7,0,0,0,3,0,20,2.857142857142857,3,0.0,0,7,0,0,10,0,0,3,0,7,13,0
4004,100294,G7KJV0aUuu9N2GhQ0BQmtfVIkYBSsISM,SpATywNh6bZuzm8s1ceuBUnMUAeoAHHw,21,22,14,6,7,0,3,0,52,7.428571428571429,1,0.0,4,14,6,7,18,0,0,3,0,31,21,1
4005,100518,6DFg8IrvITdyV3FmRQrzgnl2oAgir5Pb,SpATywNh6bZuzm8s1ceuBUnMUAeoAHHw,1,0,0,0,0,0,1,0,1,0.14285714285714285,1,0.0,0,0,0,0,0,0,0,1,0,0,1,0
4006,100640,NfAbLg5OeUTUtF15GhHCETvzoFPtTDPd,SpATywNh6bZuzm8s1ceuBUnMUAeoAHHw,21,23,0,14,0,0,11,0,48,6.857142857142857,3,0.0,4,0,12,0,19,0,2,11,0,16,32,1
4007,100872,ES4n41HdZ3mzmajBMbCDY4C23oBD6LSY,RXDvfPUBYFlVdlueBFbLW0mhhAyGEqpt,12,17,7,0,4,0,1,0,29,4.142857142857143,2,0.0,0,7,0,4,17,0,0,1,0,11,18,1
4008,101045,PCtqctDcjJHl3GW7yk0aug87eqbAmlqT,SpATywNh6bZuzm8s1ceuBUnMUAeoAHHw,6,9,0,0,0,0,1,0,10,1.4285714285714286,1,0.0,2,0,0,0,7,0,0,1,0,2,8,1
4009,101186,gtKTzkXHwS41ljYVmjlLLf4WyQSkK02q,bWdj2GDclj5ofokWjzoa5jAwMkxCykd6,3,2,1,0,0,0,1,0,4,0.5714285714285714,1,0.0,0,1,0,0,2,0,0,1,0,1,3,1
4010,101198,OCAzb1VfLGBRFoguhxZLxVaO4EgntnGi,A3fsA9Zfv1X2fVEQhTw51lKENdNrEqT3,5,3,2,0,1,0,1,0,7,1.0,1,0.0,0,2,0,1,3,0,0,1,0,3,4,1
4011,101223,MwRVXLIjs7ObnboXYRMgXHQa3UWpN5i5,SpATywNh6bZuzm8s1ceuBUnMUAeoAHHw,5,3,2,0,1,0,1,0,7,1.0,1,0.0,0,2,0,1,3,0,0,1,0,3,4,1
4012,101482,nronI72HtraF0IcAJUYxB4sbj9I4wtB0,5Gyp41oLVo7Gg7vF4vpmggWP5MU70QO6,1,0,0,0,0,0,2,0,2,0.2857142857142857,2,0.0,0,0,0,0,0,0,0,2,0,0,2,1
4013,101499,BlsuyeKFU2VPMMTGFaCoOuSyV94B6SeF,5Gyp41oLVo7Gg7vF4vpmggWP5MU70QO6,53,86,47,59,35,32,8,0,267,38.142857142857146,6,0.0,32,47,51,35,54,32,8,8,0,165,102,1
4014,101550,2QctE6rdo1LaDqkwQYQqmOphoXEtx5W7,5Gyp41oLVo7Gg7vF4vpmggWP5MU70QO6,9,3,2,0,2,0,4,0,11,1.5714285714285714,1,0.0,0,2,0,2,3,0,0,4,0,4,7,1
4015,101568,enqsupbW6wxalV5Pbbu4T32tHcMW8xiC,5Gyp41oLVo7Gg7vF4vpmggWP5MU70QO6,25,75,39,13,11,48,19,1,206,29.428571428571427,7,0.0,12,39,9,11,63,48,4,19,1,71,135,1
4016,101573,FPBRzkUZqIAMp3UsJRTJkXS9jn8UZe1l,5Gyp41oLVo7Gg7vF4vpmggWP5MU70QO6,9,4,3,0,3,0,2,0,12,1.7142857142857142,1,0.0,0,3,0,3,4,0,0,2,0,6,6,0
4017,101583,ydIfB5lDuQMdwnqw1Trec6MMfLMb9KME,5Gyp41oLVo7Gg7vF4vpmggWP5MU70QO6,12,10,6,8,4,0,2,0,30,4.285714285714286,1,0.0,3,6,4,4,7,0,4,2,0,17,13,1
4018,101616,bEuPOC49XiMJoVnxjmWOZSVu0LizKFOH,5Gyp41oLVo7Gg7vF4vpmggWP5MU70QO6,5,2,1,0,0,0,8,0,11,1.5714285714285714,2,0.0,0,1,0,0,2,0,0,8,0,1,10,1
4019,101635,BCypREe4Ez2M1svs4InXmDIOnQLgYrig,5Gyp41oLVo7Gg7vF4vpmggWP5MU70QO6,8,6,4,0,2,0,5,0,17,2.4285714285714284,2,0.0,0,4,0,2,6,0,0,5,0,6,11,1
4020,101639,NQ6Ix2SwcCnLtpnFtqWhpEREZe69Ceqp,5Gyp41oLVo7Gg7vF4vpmggWP5MU70QO6,1,0,0,0,0,0,2,0,2,0.2857142857142857,1,0.0,0,0,0,0,0,0,0,2,0,0,2,1
4021,101661,gqWGF9rxxCriQOVTyLfwVi3tPoi4EhzT,5Gyp41oLVo7Gg7vF4vpmggWP5MU70QO6,9,8,5,0,3,0,4,1,21,3.0,3,0.0,0,5,0,3,8,0,0,4,1,8,13,1
4022,101663,W6X8KDI3G9j93D0rZr6DFtxw1WAxSuwU,5Gyp41oLVo7Gg7vF4vpmggWP5MU70QO6,16,26,10,6,6,0,6,0,54,7.714285714285714,4,0.0,7,10,3,6,19,0,3,6,0,26,28,1
4023,101671,Y898vhbvBH5PVqBuh6kbj4egN3sSjMe8,5Gyp41oLVo7Gg7vF4vpmggWP5MU70QO6,6,8,0,0,0,0,2,0,10,1.4285714285714286,1,0.0,0,0,0,0,8,0,0,2,0,0,10,1
4024,101674,pmP1vo676Ls6u06kxeOxjGCjZN5T0bfn,5Gyp41oLVo7Gg7vF4vpmggWP5MU70QO6,1,0,0,0,0,0,1,0,1,0.14285714285714285,1,0.0,0,0,0,0,0,0,0,1,0,0,1,1
4025,101728,mrfbSPt6TRewduryCGdIQWJOC0FeSD76,5Gyp41oLVo7Gg7vF4vpmggWP5MU70QO6,12,20,9,8,3,4,6,1,51,7.285714285714286,2,0.0,8,9,4,3,12,4,4,6,1,24,27,1
4026,101756,MRApUnubAkEydoHvwvXziKhUNAJ5kOVI,5Gyp41oLVo7Gg7vF4vpmggWP5MU70QO6,7,3,2,0,2,0,3,0,10,1.4285714285714286,2,0.0,0,2,0,2,3,0,0,3,0,4,6,1
4027,101779,i3olLzTCOSy296QHUWxv6nRzfUo2ruGH,5Gyp41oLVo7Gg7vF4vpmggWP5MU70QO6,1,0,0,0,0,0,1,0,1,0.14285714285714285,1,0.0,0,0,0,0,0,0,0,1,0,0,1,1
4028,101783,HkE1O3IHrApBWxDCZuUezytwH5GZVstp,5Gyp41oLVo7Gg7vF4vpmggWP5MU70QO6,13,13,5,4,3,0,5,0,30,4.285714285714286,1,0.0,6,5,2,3,7,0,2,5,0,16,14,1
4029,101793,rH7q7jS4VvGmPHmUzUNov2L5WHt7pNcn,5Gyp41oLVo7Gg7vF4vpmggWP5MU70QO6,5,2,1,0,1,0,3,0,7,1.0,1,0.0,0,1,0,1,2,0,0,3,0,2,5,1
4030,101819,FJyrOX14z7chWU6pIsUghN5yUhlIZ5Lj,5Gyp41oLVo7Gg7vF4vpmggWP5MU70QO6,1,0,0,0,0,0,1,0,1,0.14285714285714285,1,0.0,0,0,0,0,0,0,0,1,0,0,1,1
4031,101824,UKG5GO5JWRjFVRMggOgvDIxPiEZzBxAO,5Gyp41oLVo7Gg7vF4vpmggWP5MU70QO6,1,0,0,0,0,0,1,0,1,0.14285714285714285,1,0.0,0,0,0,0,0,0,0,1,0,0,1,1
4032,101846,KKVIEI2lseDGpdoOhUIkkmAMhzuJw0y5,5Gyp41oLVo7Gg7vF4vpmggWP5MU70QO6,7,3,1,0,1,0,4,1,10,1.4285714285714286,1,0.0,0,1,0,1,3,0,0,4,1,2,8,1
4033,101852,JntXNtR3vyFADq0v1flreEKkRmGG9OQK,5Gyp41oLVo7Gg7vF4vpmggWP5MU70QO6,22,16,9,10,5,0,7,0,47,6.714285714285714,1,0.0,6,9,5,5,10,0,5,7,0,25,22,1
4034,101853,7v9i9hr7bP6Iw58vTdCD27LyevNIEkA0,5Gyp41oLVo7Gg7vF4vpmggWP5MU70QO6,51,108,54,42,22,88,32,2,348,49.714285714285715,12,0.0,31,54,32,22,77,88,10,32,2,139,209,0
4035,101945,Lzsz8G97Oqbb3ZBCI5dR9gHrqQ1EH7Ym,5Gyp41oLVo7Gg7vF4vpmggWP5MU70QO6,6,2,1,0,1,0,3,0,7,1.0,1,0.0,0,1,0,1,2,0,0,3,0,2,5,0
4036,101957,FH9y1iT4NiENr1hZ0odOLcMokM3ip1r3,5Gyp41oLVo7Gg7vF4vpmggWP5MU70QO6,8,6,4,0,3,0,2,0,15,2.142857142857143,1,0.0,0,4,0,3,6,0,0,2,0,7,8,1
4037,101959,nLVkMUicIATb5XjlrKkVLbPcf3PrrUv6,5Gyp41oLVo7Gg7vF4vpmggWP5MU70QO6,6,3,2,0,1,0,2,0,8,1.1428571428571428,1,0.0,0,2,0,1,3,0,0,2,0,3,5,1
4038,101984,N7MQqLeQQF4zDfQyfO9HoW1eUpwnTNGv,5Gyp41oLVo7Gg7vF4vpmggWP5MU70QO6,14,20,8,6,4,1,9,1,49,7.0,2,0.0,7,8,3,4,13,1,3,9,1,22,27,1
4039,102021,w35jVHOcytQq9jyvpFqBkMTF83ecmDQt,5Gyp41oLVo7Gg7vF4vpmggWP5MU70QO6,6,5,2,0,2,0,1,0,10,1.4285714285714286,1,0.0,0,2,0,2,5,0,0,1,0,4,6,1
4040,102033,9zKrezPpbRQghh43axqe2AhYxsX9HaSm,5Gyp41oLVo7Gg7vF4vpmggWP5MU70QO6,6,1,1,0,1,0,4,0,7,1.0,1,0.0,0,1,0,1,1,0,0,4,0,2,5,1
4041,102039,wkfBzItw0JCH6ZUz2WUZn7ngJ5M4Oksy,5Gyp41oLVo7Gg7vF4vpmggWP5MU70QO6,1,0,0,0,0,0,1,0,1,0.14285714285714285,1,0.0,0,0,0,0,0,0,0,1,0,0,1,0
4042,102073,hQ3wXP6mBT1mdkbdxuqfF7CldpTNzHCb,5Gyp41oLVo7Gg7vF4vpmggWP5MU70QO6,8,9,6,0,4,0,5,0,24,3.4285714285714284,1,0.0,0,6,0,4,9,0,0,5,0,10,14,1
4043,102075,5Rbvag4nzKt7RfTqiThTliUWaR0ZVWak,5Gyp41oLVo7Gg7vF4vpmggWP5MU70QO6,8,4,3,0,2,2,4,0,15,2.142857142857143,1,0.0,0,3,0,2,4,2,0,4,0,5,10,0
4044,102095,NTXOThvxlWD2gbdn8wqKgJboye8yTWns,5Gyp41oLVo7Gg7vF4vpmggWP5MU70QO6,35,64,36,26,15,64,31,3,239,34.142857142857146,7,0.0,11,36,20,15,53,64,6,31,3,82,157,1
4045,102103,E3buKjLKPbTtMoTsNy649dTZInvDO3Br,5Gyp41oLVo7Gg7vF4vpmggWP5MU70QO6,6,4,1,0,1,1,3,0,10,1.4285714285714286,1,0.0,0,1,0,1,4,1,0,3,0,2,8,1
4046,102125,VrTC4DzeZDftHgYWy5VUiE9qe8zwjPC5,5Gyp41oLVo7Gg7vF4vpmggWP5MU70QO6,4,0,0,0,0,0,4,0,4,0.5714285714285714,1,0.0,0,0,0,0,0,0,0,4,0,0,4,1
4047,102173,spcUWaGtojfez6ZdF6aqlTnU3zU2dqpy,5Gyp41oLVo7Gg7vF4vpmggWP5MU70QO6,7,2,0,0,1,0,6,1,10,1.4285714285714286,1,0.0,1,0,0,1,1,0,0,6,1,2,8,0
4048,102205,1rAHmNrxrqnzHEQFMlydmQ968LsZW0oG,5Gyp41oLVo7Gg7vF4vpmggWP5MU70QO6,23,27,12,7,6,16,6,1,75,10.714285714285714,1,0.0,11,12,5,6,16,16,2,6,1,34,41,1
4049,102233,Ji3E9fwS2PKUvbBJBVDClDaYO8g6Sw4n,5Gyp41oLVo7Gg7vF4vpmggWP5MU70QO6,5,1,0,0,0,1,5,0,7,1.0,1,0.0,0,0,0,0,1,1,0,5,0,0,7,1
4050,102236,1cbn6mbdbvkgaRHmtNkyztYkaJcKUMeq,5Gyp41oLVo7Gg7vF4vpmggWP5MU70QO6,23,46,14,22,6,19,20,1,128,18.285714285714285,5,0.0,17,14,14,6,29,19,8,20,1,51,77,0
4051,102241,0XiyXLikhDT45itTHi1q8aFcQzTuNpcn,5Gyp41oLVo7Gg7vF4vpmggWP5MU70QO6,1,0,0,0,0,0,1,0,1,0.14285714285714285,1,0.0,0,0,0,0,0,0,0,1,0,0,1,1
4052,102255,2gGDk563x9KJO0S3Jx29RAwBwaKlH8vL,5Gyp41oLVo7Gg7vF4vpmggWP5MU70QO6,7,2,0,0,0,1,14,2,19,2.7142857142857144,4,0.0,0,0,0,0,2,1,0,14,2,0,19,0
4053,102278,9by6FuLW9p6hAe2x8b5HjrOAjJeqk2av,5Gyp41oLVo7Gg7vF4vpmggWP5MU70QO6,25,33,14,10,11,2,8,2,80,11.428571428571429,2,0.0,13,14,8,11,20,2,2,8,2,46,34,0
4054,102286,lT1QwzmucjSEwJOaziaqa5blNPSytnWj,5Gyp41oLVo7Gg7vF4vpmggWP5MU70QO6,5,2,1,0,1,0,2,0,6,0.8571428571428571,1,0.0,0,1,0,1,2,0,0,2,0,2,4,1
4055,102788,1Ld3jQU8M0eiaLBshs8gjcgQEfdlgHyZ,7GRhBDsirIGkRZBtSMEzNTyDr2JQm4xx,1,0,0,0,0,0,1,0,1,0.14285714285714285,1,0.0,0,0,0,0,0,0,0,1,0,0,1,1
4056,102793,vkfHpP1V5bzhsiIUQc7ID6uM0xIbyM6G,7GRhBDsirIGkRZBtSMEzNTyDr2JQm4xx,100,117,41,68,43,27,5,3,304,43.42857142857143,2,0.0,66,41,42,43,51,27,26,5,3,192,112,0
4057,102811,RB20dIuqLJFw6YFQJDaxn0RCCLFzH3SF,7GRhBDsirIGkRZBtSMEzNTyDr2JQm4xx,1,0,0,0,0,0,2,0,2,0.2857142857142857,1,0.0,0,0,0,0,0,0,0,2,0,0,2,1
4058,102820,BIDc5dTJG5lHpfFnujtGp6gtwz3CxgK6,7GRhBDsirIGkRZBtSMEzNTyDr2JQm4xx,24,33,18,0,13,1,7,1,73,10.428571428571429,1,0.0,7,18,0,13,26,1,0,7,1,38,35,0
4059,102821,AFkbXbLmebwTS1tBVemZz9PyT76Wxqt3,7GRhBDsirIGkRZBtSMEzNTyDr2JQm4xx,51,35,15,30,19,0,3,0,102,14.571428571428571,2,0.0,18,15,19,19,17,0,11,3,0,71,31,0
4060,102824,WmG8kTcU8MK2hNkFFl9oxdCyXNm8K8Ej,7GRhBDsirIGkRZBtSMEzNTyDr2JQm4xx,1,0,0,0,0,0,1,0,1,0.14285714285714285,1,0.0,0,0,0,0,0,0,0,1,0,0,1,1
4061,102828,UudVkHSQDj0JlXrwnDsZ4pzCiaI82KlC,7GRhBDsirIGkRZBtSMEzNTyDr2JQm4xx,1,0,0,0,0,0,2,0,2,0.2857142857142857,2,0.0,0,0,0,0,0,0,0,2,0,0,2,1
4062,102829,FznSklAKG5wChcaIMKrWsEd2Qt5oet2J,7GRhBDsirIGkRZBtSMEzNTyDr2JQm4xx,11,5,2,0,2,8,12,0,29,4.142857142857143,1,0.0,0,2,0,2,5,8,0,12,0,4,25,1
4063,102846,bdMrZhKfGRsdtUANxFUkk3RURjlPnIxr,7GRhBDsirIGkRZBtSMEzNTyDr2JQm4xx,2,0,0,0,0,0,3,0,3,0.42857142857142855,1,0.0,0,0,0,0,0,0,0,3,0,0,3,1
4064,102852,4vfYv7K7jyRMAXbqr9d4SobwqmYMG1ZR,7GRhBDsirIGkRZBtSMEzNTyDr2JQm4xx,1,0,0,0,0,0,1,0,1,0.14285714285714285,1,0.0,0,0,0,0,0,0,0,1,0,0,1,1
4065,102855,pYasYOOyUapjKdoqnDhFpArs52eNDPLb,7GRhBDsirIGkRZBtSMEzNTyDr2JQm4xx,3,2,1,0,0,0,1,0,4,0.5714285714285714,1,0.0,0,1,0,0,2,0,0,1,0,1,3,1
4066,102867,jSPgiXDCISXGmLFuOlDszBfMRRboKynI,A3fsA9Zfv1X2fVEQhTw51lKENdNrEqT3,8,4,3,0,3,0,1,0,11,1.5714285714285714,1,0.0,0,3,0,3,4,0,0,1,0,6,5,1
4067,102926,qoU1vhHFDDec5VkeyGO4XQ5CxMj2dkga,SpATywNh6bZuzm8s1ceuBUnMUAeoAHHw,1,0,0,0,0,0,1,0,1,0.14285714285714285,1,0.0,0,0,0,0,0,0,0,1,0,0,1,1
4068,103004,9tN6QbOi425qNnZ8oxcgeFVfUtI2koh7,RXDvfPUBYFlVdlueBFbLW0mhhAyGEqpt,7,7,4,0,1,0,1,0,13,1.8571428571428572,1,0.0,0,4,0,1,7,0,0,1,0,5,8,0
4069,103011,A3hbg0sRzJCuZelHR2utUpF4kEQMHGoX,A3fsA9Zfv1X2fVEQhTw51lKENdNrEqT3,6,5,4,0,2,0,3,0,14,2.0,1,0.0,0,4,0,2,5,0,0,3,0,6,8,1
4070,103046,4dcb5500hUVpclJ4asFWqYt7G3CBRrnY,SpATywNh6bZuzm8s1ceuBUnMUAeoAHHw,1,0,0,0,0,0,1,0,1,0.14285714285714285,1,0.0,0,0,0,0,0,0,0,1,0,0,1,1
4071,103131,KKoJVU8RPVKYX0YtUEw7IyEbFA7WdrnE,SpATywNh6bZuzm8s1ceuBUnMUAeoAHHw,23,33,16,14,8,0,4,0,75,10.714285714285714,4,0.0,4,16,12,8,29,0,2,4,0,40,35,0
4072,103220,8c2gk77rfHeG4kEZpifVHT547X2ayTNE,A3fsA9Zfv1X2fVEQhTw51lKENdNrEqT3,4,3,2,0,0,0,2,0,7,1.0,1,0.0,0,2,0,0,3,0,0,2,0,2,5,1
4073,103230,W6MGFBQ1Tov9lOeRQ8QlzHUMCDNEGRDq,5X6FeZozNMgE2VRi3MJYjkkFK8SETtu2,4,5,1,0,0,0,3,0,9,1.2857142857142858,1,0.0,0,1,0,0,5,0,0,3,0,1,8,1
4074,103291,3xICsH6EXuYyV8kexin75XnVadi3rENN,SpATywNh6bZuzm8s1ceuBUnMUAeoAHHw,3,4,2,0,0,0,2,0,8,1.1428571428571428,2,0.0,0,2,0,0,4,0,0,2,0,2,6,1
4075,103432,i874kieazKCC94ZTypW847QbJAZunYk3,5X6FeZozNMgE2VRi3MJYjkkFK8SETtu2,5,1,1,0,0,0,3,0,5,0.7142857142857143,1,0.0,0,1,0,0,1,0,0,3,0,1,4,1
4076,103695,gMeZHtHbmrRB8drlaFHRYNGQ6Z4lgho8,5X6FeZozNMgE2VRi3MJYjkkFK8SETtu2,1,0,0,0,0,0,1,0,1,0.14285714285714285,1,0.0,0,0,0,0,0,0,0,1,0,0,1,1
4077,103770,EReWp6ilgaQY61GGX2jAkIc5IQisheJq,A3fsA9Zfv1X2fVEQhTw51lKENdNrEqT3,9,4,3,0,2,3,5,0,17,2.4285714285714284,1,0.0,0,3,0,2,4,3,0,5,0,5,12,1
4078,103842,At5CmMT40Lj8XDlMUQSu8tvnJD3w6cR2,SpATywNh6bZuzm8s1ceuBUnMUAeoAHHw,22,30,9,4,7,0,5,0,55,7.857142857142857,4,0.0,0,9,4,7,30,0,0,5,0,20,35,0
4079,103852,VJiHrUKuVkG2Wd7Jui04ER4qa9ZGvV1t,SpATywNh6bZuzm8s1ceuBUnMUAeoAHHw,20,20,10,13,5,0,1,0,49,7.0,1,0.0,2,10,11,5,18,0,2,1,0,28,21,1
4080,103859,ksRqzHMX68VFuQOjp1W3rk6L1KS1Cbms,5X6FeZozNMgE2VRi3MJYjkkFK8SETtu2,4,2,0,0,1,0,1,0,4,0.5714285714285714,1,0.0,0,0,0,1,2,0,0,1,0,1,3,1
4081,103989,ApFdQQBcLqTLoA4wIvtlnnwFs4FrlVS1,5X6FeZozNMgE2VRi3MJYjkkFK8SETtu2,3,0,0,0,0,0,4,0,4,0.5714285714285714,2,0.0,0,0,0,0,0,0,0,4,0,0,4,1
4082,104047,2po0f8XMp90hBVf5i62LOZgd10Lmz8YN,5X6FeZozNMgE2VRi3MJYjkkFK8SETtu2,1,0,0,0,0,0,1,0,1,0.14285714285714285,1,0.0,0,0,0,0,0,0,0,1,0,0,1,1
4083,104102,Lf0mThPYOrtlCzgRGBCVTPy1hiGUII8h,5X6FeZozNMgE2VRi3MJYjkkFK8SETtu2,14,31,18,0,8,1,13,1,72,10.285714285714286,2,0.0,6,18,0,8,25,1,0,13,1,32,40,1
4084,104113,7EU7vMf2b4Xv6MdI3zbAqQNQTiRVSvYt,5X6FeZozNMgE2VRi3MJYjkkFK8SETtu2,1,0,0,0,0,0,1,0,1,0.14285714285714285,1,0.0,0,0,0,0,0,0,0,1,0,0,1,1
4085,104176,sOwWyC9rA1InGJbwGE813L3Z5VYELzm2,5X6FeZozNMgE2VRi3MJYjkkFK8SETtu2,1,0,0,0,0,0,1,0,1,0.14285714285714285,1,0.0,0,0,0,0,0,0,0,1,0,0,1,1
4086,104212,Ds7wEX5jkiySqTwaoWI1jYLPSf2vDAGt,5X6FeZozNMgE2VRi3MJYjkkFK8SETtu2,1,0,0,0,0,0,1,0,1,0.14285714285714285,1,0.0,0,0,0,0,0,0,0,1,0,0,1,1
4087,104293,mKHQM9iW9olu6z2WamdxK7ySH3UwX3JX,RXDvfPUBYFlVdlueBFbLW0mhhAyGEqpt,7,8,3,0,1,2,1,0,15,2.142857142857143,1,0.0,3,3,0,1,5,2,0,1,0,7,8,1
4088,104438,KJtTFVCUZxFPCdrcl94b8VUY3eA2PtX6,SpATywNh6bZuzm8s1ceuBUnMUAeoAHHw,21,17,10,5,6,3,4,1,46,6.571428571428571,2,0.0,5,10,5,6,12,3,0,4,1,26,20,0
4089,104454,S6zuEdHkGvIDnx9FvNNHc7xwyevTBNEw,G8EPVSXsOYB5YQWZGiz1aVq5Pgr2GrQu,4,3,1,0,0,0,1,0,5,0.7142857142857143,1,0.0,0,1,0,0,3,0,0,1,0,1,4,0
4090,104544,gUXmx34tXzFZkM4gYbNbIwLhuZfANkS1,A3fsA9Zfv1X2fVEQhTw51lKENdNrEqT3,4,3,2,0,0,0,1,0,6,0.8571428571428571,1,0.0,0,2,0,0,3,0,0,1,0,2,4,1
4091,104643,OUOJlObKrXM0JmEUq0o8KzZHzr8jy9dn,SpATywNh6bZuzm8s1ceuBUnMUAeoAHHw,1,0,0,0,0,0,1,0,1,0.14285714285714285,1,0.0,0,0,0,0,0,0,0,1,0,0,1,1
4092,104803,GHw9ck750jm0mkRym0HeCGrJelDoub5a,SpATywNh6bZuzm8s1ceuBUnMUAeoAHHw,26,50,28,8,15,3,9,0,113,16.142857142857142,1,0.0,14,28,7,15,36,3,1,9,0,64,49,0
4093,104921,xBMlDE0EhLrV6UTu12C10f1Ev99CwT31,SpATywNh6bZuzm8s1ceuBUnMUAeoAHHw,20,12,10,0,8,0,1,0,31,4.428571428571429,1,0.0,0,10,0,8,12,0,0,1,0,18,13,1
4094,105048,skA6GV4QKGFVtxye7Nlz906gXUD3qCvf,SpATywNh6bZuzm8s1ceuBUnMUAeoAHHw,9,12,0,0,0,0,1,0,13,1.8571428571428572,1,0.0,0,0,0,0,12,0,0,1,0,0,13,1
4095,105213,f6fUoSUJslaShApLLQ3C3hAE39t0Ewco,A3fsA9Zfv1X2fVEQhTw51lKENdNrEqT3,1,0,0,0,0,0,1,0,1,0.14285714285714285,1,0.0,0,0,0,0,0,0,0,1,0,0,1,1
4096,105348,jyuEVmbrPcyGnV7pufxSb0rPrKJZItsk,SpATywNh6bZuzm8s1ceuBUnMUAeoAHHw,18,18,12,8,8,0,4,0,50,7.142857142857143,1,0.0,4,12,7,8,14,0,1,4,0,31,19,1
4097,105476,pMxyBMX7n5deuUC9YyUONEJJAyoPl0BG,SpATywNh6bZuzm8s1ceuBUnMUAeoAHHw,7,7,0,0,0,0,2,0,9,1.2857142857142858,2,0.0,0,0,0,0,7,0,0,2,0,0,9,1
4098,105583,Cb1oMMLwTjTacmho2xz7pvU7NsoZgScq,A3fsA9Zfv1X2fVEQhTw51lKENdNrEqT3,4,2,1,0,0,0,2,0,5,0.7142857142857143,1,0.0,0,1,0,0,2,0,0,2,0,1,4,1
4099,105621,Z2LpxeyN5IUym4huJGBt4liqsVm2EQ7Q,SpATywNh6bZuzm8s1ceuBUnMUAeoAHHw,13,22,1,9,0,0,3,0,35,5.0,2,0.0,5,1,8,0,17,0,1,3,0,14,21,0
4100,105761,nykkKhG5AxCe9Czq7wPmsDcTY6IOvKIH,5X6FeZozNMgE2VRi3MJYjkkFK8SETtu2,7,6,1,2,2,0,2,0,13,1.8571428571428572,1,0.0,2,1,2,2,4,0,0,2,0,7,6,1
4101,105801,khmHazlC1lBTqllIsTqLn3G01U4sjYKo,5X6FeZozNMgE2VRi3MJYjkkFK8SETtu2,6,3,1,0,2,0,3,0,9,1.2857142857142858,1,0.0,1,1,0,2,2,0,0,3,0,4,5,1
4102,105863,G86VNHc8vSSjCeTTfojU4Lj6kJiGcQPq,5X6FeZozNMgE2VRi3MJYjkkFK8SETtu2,5,3,1,0,1,0,2,0,7,1.0,1,0.0,0,1,0,1,3,0,0,2,0,2,5,1
4103,105894,Msm7VbQnHSrKXxwAtvM1UL3x4iRGks4I,5X6FeZozNMgE2VRi3MJYjkkFK8SETtu2,1,0,0,0,0,0,1,0,1,0.14285714285714285,1,0.0,0,0,0,0,0,0,0,1,0,0,1,1
4104,105954,RmlyieNXfVrGM9LWnpgNxfz0WPjjsgcE,5X6FeZozNMgE2VRi3MJYjkkFK8SETtu2,14,17,9,2,12,0,1,0,41,5.857142857142857,1,0.0,6,9,2,12,11,0,0,1,0,29,12,1
4105,106292,eaf2dBLOkAjzSJFeSL5LIO99DDxG9xBE,SpATywNh6bZuzm8s1ceuBUnMUAeoAHHw,5,18,1,0,0,0,6,0,25,3.5714285714285716,3,0.0,0,1,0,0,18,0,0,6,0,1,24,0
4106,106302,CHiI46TzJ7KTopzqYzHnHLTSqsLCQupU,SpATywNh6bZuzm8s1ceuBUnMUAeoAHHw,1,0,0,0,0,0,1,0,1,0.14285714285714285,1,0.0,0,0,0,0,0,0,0,1,0,0,1,0
4107,106312,nvXkSuJjNwPy4x4PN83PXogIa9iXtJsm,bWdj2GDclj5ofokWjzoa5jAwMkxCykd6,6,2,2,0,2,0,7,0,13,1.8571428571428572,1,0.0,0,2,0,2,2,0,0,7,0,4,9,1
4108,106355,w2dtGgNPRzxwneFGubkorQo36PxfqqeK,SpATywNh6bZuzm8s1ceuBUnMUAeoAHHw,5,0,0,0,0,0,4,1,5,0.7142857142857143,1,0.0,0,0,0,0,0,0,0,4,1,0,5,1
4109,106377,pIUA4CxUOhlZMOg4cOlVb2la0FCnmRD3,A3fsA9Zfv1X2fVEQhTw51lKENdNrEqT3,11,8,7,0,6,0,1,0,22,3.142857142857143,1,0.0,0,7,0,6,8,0,0,1,0,13,9,1
4110,106380,aiUFQFUA2cfQeIiWYfzvV70Kxs8bzZjl,A3fsA9Zfv1X2fVEQhTw51lKENdNrEqT3,4,2,1,0,1,0,2,0,6,0.8571428571428571,1,0.0,0,1,0,1,2,0,0,2,0,2,4,1
4111,106398,tJSuuWZXDdoXjZXIctAWwDLD7oHTWJ9T,bWdj2GDclj5ofokWjzoa5jAwMkxCykd6,2,0,0,0,0,0,2,0,2,0.2857142857142857,1,0.0,0,0,0,0,0,0,0,2,0,0,2,1
4112,106418,4vGASaaJ1gif3X9ohNHSGBizcSlajzrR,G8EPVSXsOYB5YQWZGiz1aVq5Pgr2GrQu,2,0,0,0,0,0,2,0,2,0.2857142857142857,1,0.0,0,0,0,0,0,0,0,2,0,0,2,0
4113,106438,NyEijNa9dfqUApw5iyHdD9FPGDdLrbLb,RXDvfPUBYFlVdlueBFbLW0mhhAyGEqpt,28,21,16,0,11,1,5,0,54,7.714285714285714,1,0.0,0,16,0,11,21,1,0,5,0,27,27,1
4114,106440,FiDLmZS7SZoCB8c2FPrLrdnRZi9p4XPX,bWdj2GDclj5ofokWjzoa5jAwMkxCykd6,8,7,3,0,3,0,2,1,16,2.2857142857142856,1,0.0,3,3,0,3,4,0,0,2,1,9,7,0
4115,106451,lKD6NXfkh6Hzqg1qAGXl1PKKyBvPYL7k,SpATywNh6bZuzm8s1ceuBUnMUAeoAHHw,2,0,0,0,0,0,2,0,2,0.2857142857142857,1,0.0,0,0,0,0,0,0,0,2,0,0,2,1
4116,106457,VtALT7PCDyJDsdPo6puj2SULDyuNrsZ2,5X6FeZozNMgE2VRi3MJYjkkFK8SETtu2,2,0,0,0,0,0,2,0,2,0.2857142857142857,1,0.0,0,0,0,0,0,0,0,2,0,0,2,1
4117,106466,CNb0Sul2DOkX3VhMOeM6DWqvlrGgHagf,A3fsA9Zfv1X2fVEQhTw51lKENdNrEqT3,1,0,0,0,0,0,1,0,1,0.14285714285714285,1,0.0,0,0,0,0,0,0,0,1,0,0,1,1
4118,106496,bP02cfOIFimMsMVUcFl4uLZksud3wO6q,RXDvfPUBYFlVdlueBFbLW0mhhAyGEqpt,1,0,0,0,0,0,1,0,1,0.14285714285714285,1,0.0,0,0,0,0,0,0,0,1,0,0,1,1
4119,106505,SSjMJy46FRxCnKuhMLxzF4UfAx5Jlk65,A3fsA9Zfv1X2fVEQhTw51lKENdNrEqT3,7,11,3,0,1,0,7,0,22,3.142857142857143,1,0.0,0,3,0,1,11,0,0,7,0,4,18,1
4120,106506,wywFtc7buIqNEURngjXjEkiYAf5BIbLx,bWdj2GDclj5ofokWjzoa5jAwMkxCykd6,11,9,2,26,4,0,6,1,48,6.857142857142857,2,0.0,4,2,25,4,5,0,1,6,1,35,13,1
4121,106528,58p1CjrP7XDWRfO9BWpFsEFnKaKNXYOr,SpATywNh6bZuzm8s1ceuBUnMUAeoAHHw,5,9,0,0,0,0,2,0,11,1.5714285714285714,1,0.0,6,0,0,0,3,0,0,2,0,6,5,0
4122,106540,aRBsP3RNC28m05qU4AuLdcShaMIKbk0T,RXDvfPUBYFlVdlueBFbLW0mhhAyGEqpt,2,0,0,0,0,0,2,0,2,0.2857142857142857,1,0.0,0,0,0,0,0,0,0,2,0,0,2,1
4123,106550,dstTpT2BjfmJxSzmJpU00abOAObDPwAz,5X6FeZozNMgE2VRi3MJYjkkFK8SETtu2,1,0,0,0,0,0,1,0,1,0.14285714285714285,1,0.0,0,0,0,0,0,0,0,1,0,0,1,1
4124,106587,eJuJSF1kb4boRbrBsR9P3vZW2Mag1arE,SpATywNh6bZuzm8s1ceuBUnMUAeoAHHw,11,13,0,7,0,0,3,0,23,3.2857142857142856,2,0.0,5,0,7,0,8,0,0,3,0,12,11,1
4125,106592,QycygN4wUJdorVPgO5PJQhHEi2M0czTF,bWdj2GDclj5ofokWjzoa5jAwMkxCykd6,4,4,0,0,0,0,2,0,6,0.8571428571428571,2,0.0,0,0,0,0,4,0,0,2,0,0,6,1
4126,106599,rbxTporlOqtSqZOyiDbvbMHveyvkICoI,A3fsA9Zfv1X2fVEQhTw51lKENdNrEqT3,1,0,0,0,0,0,2,0,2,0.2857142857142857,1,0.0,0,0,0,0,0,0,0,2,0,0,2,1
4127,106627,ScIuqHs55u32PpI8ATvWh59ifl2MpG45,SpATywNh6bZuzm8s1ceuBUnMUAeoAHHw,34,27,20,9,16,0,4,0,76,10.857142857142858,1,0.0,1,20,8,16,26,0,1,4,0,45,31,1
4128,106659,RMG4hzng4Wp3OF1KXSagJtTgEvPUSiPj,A3fsA9Zfv1X2fVEQhTw51lKENdNrEqT3,2,0,0,0,0,0,5,0,5,0.7142857142857143,1,0.0,0,0,0,0,0,0,0,5,0,0,5,1
4129,106699,edEL8C4u3SeG3jN4X4AKp0GVosDARXCS,SpATywNh6bZuzm8s1ceuBUnMUAeoAHHw,1,0,0,0,0,0,1,0,1,0.14285714285714285,1,0.0,0,0,0,0,0,0,0,1,0,0,1,1
4130,106730,bUlVBXqXRojGcrtmo2UOxhIzd8vCtLry,RXDvfPUBYFlVdlueBFbLW0mhhAyGEqpt,24,33,19,0,14,2,6,0,74,10.571428571428571,3,0.0,0,19,0,14,33,2,0,6,0,33,41,1
4131,106736,VbQhjd0ThHRRAU7zAe9C6rWO0bsprcst,SpATywNh6bZuzm8s1ceuBUnMUAeoAHHw,1,0,0,0,0,0,1,0,1,0.14285714285714285,1,0.0,0,0,0,0,0,0,0,1,0,0,1,1
4132,106766,Nsm5QAhxA1QCdT1zW4z4WaVJyYPTmGcO,RXDvfPUBYFlVdlueBFbLW0mhhAyGEqpt,1,0,0,0,0,0,1,0,1,0.14285714285714285,1,0.0,0,0,0,0,0,0,0,1,0,0,1,1
4133,106769,H40umhtRkpIQB1fzDkKwom1MRBMPCSA7,RXDvfPUBYFlVdlueBFbLW0mhhAyGEqpt,6,4,1,0,1,0,2,0,8,1.1428571428571428,1,0.0,0,1,0,1,4,0,0,2,0,2,6,1
4134,106774,y6i20DJpIul6LihHwgZcWxbdAap5GcBP,5X6FeZozNMgE2VRi3MJYjkkFK8SETtu2,1,0,0,0,0,0,4,0,4,0.5714285714285714,2,0.0,0,0,0,0,0,0,0,4,0,0,4,1
4135,106801,jmBcV5GzgEvFPXiOm3lIcsMGTfagH1ak,SpATywNh6bZuzm8s1ceuBUnMUAeoAHHw,1,0,0,0,0,0,1,0,1,0.14285714285714285,1,0.0,0,0,0,0,0,0,0,1,0,0,1,1
4136,106806,vUowOWE9grUVnUy6A9M0f4pOETawtkpU,bWdj2GDclj5ofokWjzoa5jAwMkxCykd6,2,0,0,0,0,0,2,0,2,0.2857142857142857,1,0.0,0,0,0,0,0,0,0,2,0,0,2,1
4137,106808,9ReKyoH1pwgMi23AYKJMYTsoBlnJmYH9,SpATywNh6bZuzm8s1ceuBUnMUAeoAHHw,2,0,0,0,0,0,3,0,3,0.42857142857142855,1,0.0,0,0,0,0,0,0,0,3,0,0,3,1
4138,106823,goH3eL8vc5HDpMZExF8B0A1ykP7H7H0A,A3fsA9Zfv1X2fVEQhTw51lKENdNrEqT3,9,5,3,0,3,0,1,0,12,1.7142857142857142,1,0.0,0,3,0,3,5,0,0,1,0,6,6,1
4139,106860,6lERIt9LK72b4gBh1gc6JqDmon4igZIH,A3fsA9Zfv1X2fVEQhTw51lKENdNrEqT3,47,62,40,60,21,43,24,13,263,37.57142857142857,3,0.0,5,40,50,21,57,43,10,24,13,116,147,0
4140,106870,7QrJe5BY6GVg5UADev8ewJVu7PPlVQrU,SpATywNh6bZuzm8s1ceuBUnMUAeoAHHw,9,7,3,0,2,0,3,0,15,2.142857142857143,2,0.0,0,3,0,2,7,0,0,3,0,5,10,1
4141,106896,LGIto3qFAmkLm07XwtWQCNPbarZXKMyq,SpATywNh6bZuzm8s1ceuBUnMUAeoAHHw,11,16,1,0,1,0,3,0,21,3.0,1,0.0,0,1,0,1,16,0,0,3,0,2,19,1
4142,106897,yrxUCbkwiU0Qgu0wZMF5MylHBneN7zri,SpATywNh6bZuzm8s1ceuBUnMUAeoAHHw,11,26,6,0,3,1,5,0,41,5.857142857142857,3,0.0,0,6,0,3,26,1,0,5,0,9,32,0
4143,106907,Nqn3ANjR8SmFf4pF0O8Kve4CiSpmex7G,A3fsA9Zfv1X2fVEQhTw51lKENdNrEqT3,4,6,1,0,1,0,1,0,9,1.2857142857142858,1,0.0,2,1,0,1,4,0,0,1,0,4,5,0
4144,106910,QXuvnwuKGvhNAY9NohmlAFZHlIFa6rI7,RXDvfPUBYFlVdlueBFbLW0mhhAyGEqpt,1,0,0,0,0,0,2,0,2,0.2857142857142857,1,0.0,0,0,0,0,0,0,0,2,0,0,2,1
4145,106945,V8hRrBfC4m6o5SRifZvjczGfigxmUHIL,G8EPVSXsOYB5YQWZGiz1aVq5Pgr2GrQu,1,0,0,0,0,0,1,0,1,0.14285714285714285,1,0.0,0,0,0,0,0,0,0,1,0,0,1,1
4146,106958,JVX13yi9NtZIvDKYUG9hgCWS9Rbsc8S6,SpATywNh6bZuzm8s1ceuBUnMUAeoAHHw,1,0,0,0,0,0,1,0,1,0.14285714285714285,1,0.0,0,0,0,0,0,0,0,1,0,0,1,1
4147,106970,eNA8Do3VklggbxHrm6LTfg4Q8kccaQmP,bWdj2GDclj5ofokWjzoa5jAwMkxCykd6,5,2,1,0,1,0,2,0,6,0.8571428571428571,1,0.0,0,1,0,1,2,0,0,2,0,2,4,0
4148,106972,GKYpiWZuICG4mzHDIMBAcMJwYd14l50I,A3fsA9Zfv1X2fVEQhTw51lKENdNrEqT3,5,3,1,0,1,0,2,0,7,1.0,1,0.0,1,1,0,1,2,0,0,2,0,3,4,1
4149,106981,reBpiAvYdQFwXMmy7qYcpfedR98eE5B4,bWdj2GDclj5ofokWjzoa5jAwMkxCykd6,8,3,2,0,2,1,3,1,12,1.7142857142857142,1,0.0,0,2,0,2,3,1,0,3,1,4,8,1
4150,106984,9yJM3R19OwcfPlxfVtLgyGlcFgNllk8L,SpATywNh6bZuzm8s1ceuBUnMUAeoAHHw,1,0,0,0,0,0,1,0,1,0.14285714285714285,1,0.0,0,0,0,0,0,0,0,1,0,0,1,1
4151,106996,LCXXQFy8KIoQNTdeO89e9nW5ZJ3hEpFD,SpATywNh6bZuzm8s1ceuBUnMUAeoAHHw,17,30,10,16,3,2,6,1,68,9.714285714285714,2,0.0,18,10,15,3,12,2,1,6,1,46,22,1
4152,107022,1sAyB3nxbs73TCz7P8ePgbTuRyvUJi7o,bWdj2GDclj5ofokWjzoa5jAwMkxCykd6,1,0,0,0,0,0,1,0,1,0.14285714285714285,1,0.0,0,0,0,0,0,0,0,1,0,0,1,1
4153,107025,ggEr2STKTwtSSUdtGCmiPr3DBu3TJ34B,G8EPVSXsOYB5YQWZGiz1aVq5Pgr2GrQu,61,7,0,112,0,0,1,0,120,17.142857142857142,1,0.0,0,0,112,0,7,0,0,1,0,112,8,1
4154,107056,Y5AX6ZQ5Ugwn3sD9xwZmBQdLr2GbgKTx,SpATywNh6bZuzm8s1ceuBUnMUAeoAHHw,6,1,1,0,1,0,7,0,10,1.4285714285714286,1,0.0,0,1,0,1,1,0,0,7,0,2,8,1
4155,107100,Kpn2SZmmiazR6DCkcb8B8TXM52qr9chW,3VkHkmOtom3jM2wCu94xgzzu1d6Dn7or,23,53,13,14,8,1,11,0,100,14.285714285714286,3,0.0,12,13,12,8,41,1,2,11,0,45,55,0
4156,107105,3kXcB21kCQHJG7kYLFPH8fKSXD349Vv9,3VkHkmOtom3jM2wCu94xgzzu1d6Dn7or,1,0,0,0,0,0,1,0,1,0.14285714285714285,1,0.0,0,0,0,0,0,0,0,1,0,0,1,1
4157,107115,pVNffwJrTxorKOdHeVlhpeq6y9qcrAtJ,3VkHkmOtom3jM2wCu94xgzzu1d6Dn7or,1,0,0,0,0,0,1,0,1,0.14285714285714285,1,0.0,0,0,0,0,0,0,0,1,0,0,1,1
4158,107133,Ze3H0pXAe85g74vQ9AmzNNSc5F7API8z,3VkHkmOtom3jM2wCu94xgzzu1d6Dn7or,5,2,1,0,1,0,4,0,8,1.1428571428571428,1,0.0,0,1,0,1,2,0,0,4,0,2,6,1
4159,107287,6evgHaxfeHX9D3uq6P8QUq1lpm69q4m2,3VkHkmOtom3jM2wCu94xgzzu1d6Dn7or,1,0,0,0,0,0,1,0,1,0.14285714285714285,1,0.0,0,0,0,0,0,0,0,1,0,0,1,1
4160,107297,Fqm3zeQ6YZlDv445nsgyUgVTYPRvPI6D,3VkHkmOtom3jM2wCu94xgzzu1d6Dn7or,20,38,9,4,8,4,7,0,70,10.0,4,0.0,9,9,3,8,29,4,1,7,0,29,41,0
4161,107314,keO4wKyYYjh8FIG3opHOkpLp1NA3BjTu,3VkHkmOtom3jM2wCu94xgzzu1d6Dn7or,8,8,5,0,3,1,14,0,31,4.428571428571429,2,0.0,0,5,0,3,8,1,0,14,0,8,23,1
4162,107392,6mSUG9eU1fdbtH5agWJN7q80r8UxSswV,3VkHkmOtom3jM2wCu94xgzzu1d6Dn7or,53,95,38,31,29,67,32,5,297,42.42857142857143,7,0.0,39,38,28,29,56,67,3,32,5,134,163,0
4163,107419,3rBmxyGX2x2EitMnfKeDWUsWZG6ahhDU,3VkHkmOtom3jM2wCu94xgzzu1d6Dn7or,12,32,2,8,1,0,16,0,59,8.428571428571429,3,0.0,11,2,7,1,21,0,1,16,0,21,38,1
4164,107434,q97bLehCsTDUKkQQDzWfdPKlUvACWFSd,3VkHkmOtom3jM2wCu94xgzzu1d6Dn7or,5,2,0,0,1,0,2,0,5,0.7142857142857143,1,0.0,0,0,0,1,2,0,0,2,0,1,4,1
4165,107450,Dt6JY8BmXySjN4txv1zU8kuHucv28fNq,3VkHkmOtom3jM2wCu94xgzzu1d6Dn7or,5,7,1,0,1,0,2,0,11,1.5714285714285714,1,0.0,2,1,0,1,5,0,0,2,0,4,7,1
4166,107483,rLo3MEn7Uk9eN6YOnjWT2bPs8hjx3rxx,3VkHkmOtom3jM2wCu94xgzzu1d6Dn7or,6,6,0,0,0,0,3,0,9,1.2857142857142858,1,0.0,0,0,0,0,6,0,0,3,0,0,9,1
4167,107512,LN2S04kUws0xhVBF22TjcUWxHmKEc3c0,3VkHkmOtom3jM2wCu94xgzzu1d6Dn7or,9,4,3,0,3,0,2,0,12,1.7142857142857142,2,0.0,0,3,0,3,4,0,0,2,0,6,6,1
4168,107513,EgPkwyKVzxQ3pMHnSPdDYGGUpTrdw5Rz,3VkHkmOtom3jM2wCu94xgzzu1d6Dn7or,1,0,0,0,0,0,1,0,1,0.14285714285714285,1,0.0,0,0,0,0,0,0,0,1,0,0,1,1
4169,107520,7tVOKMnTpVsQTNIR9VucG6vEKmeogiVL,3VkHkmOtom3jM2wCu94xgzzu1d6Dn7or,1,0,0,0,0,0,1,0,1,0.14285714285714285,1,0.0,0,0,0,0,0,0,0,1,0,0,1,1
4170,107539,M4YIohCADYfWDtmAFcr9Yo4DF18taWXd,3VkHkmOtom3jM2wCu94xgzzu1d6Dn7or,2,0,0,0,0,0,4,0,4,0.5714285714285714,1,0.0,0,0,0,0,0,0,0,4,0,0,4,1
4171,107548,abgvpo0SPpX42r2UvEpLyr3GGXwjdhN9,3VkHkmOtom3jM2wCu94xgzzu1d6Dn7or,4,2,0,0,0,0,4,0,6,0.8571428571428571,1,0.0,0,0,0,0,2,0,0,4,0,0,6,1
4172,107574,SRZHKsTuyx5cQQZdrPPgGMMi0YaWb7iW,3VkHkmOtom3jM2wCu94xgzzu1d6Dn7or,4,2,1,0,1,0,1,0,5,0.7142857142857143,1,0.0,0,1,0,1,2,0,0,1,0,2,3,1
4173,107596,ruJd1NvBaJjebdW0awtZ6qUCgWGn6X0g,3VkHkmOtom3jM2wCu94xgzzu1d6Dn7or,4,3,2,0,0,0,1,0,6,0.8571428571428571,1,0.0,0,2,0,0,3,0,0,1,0,2,4,1
4174,107597,rgYT38Kqk0cxbhUKs5hjGenYt4lCQq7h,3VkHkmOtom3jM2wCu94xgzzu1d6Dn7or,4,4,1,0,2,0,2,0,9,1.2857142857142858,1,0.0,2,1,0,2,2,0,0,2,0,5,4,0
4175,107599,aMt9h42fT1FmAn3plylyUOkSwsvgU17x,3VkHkmOtom3jM2wCu94xgzzu1d6Dn7or,1,0,0,0,0,0,1,0,1,0.14285714285714285,1,0.0,0,0,0,0,0,0,0,1,0,0,1,1
4176,107651,HMUZFtMvMF2blrnHw0lfzyMPHvoaVYfd,3VkHkmOtom3jM2wCu94xgzzu1d6Dn7or,10,18,4,0,0,6,7,3,38,5.428571428571429,1,0.0,0,4,0,0,18,6,0,7,3,4,34,1
4177,107709,XAmpKwge1guxudWVDooHHyz3OE0r4wbg,3VkHkmOtom3jM2wCu94xgzzu1d6Dn7or,1,0,0,0,0,0,1,0,1,0.14285714285714285,1,0.0,0,0,0,0,0,0,0,1,0,0,1,1
4178,107729,ZbrAFgZBdj5Q6yNC28mh9Wq6moLpUHyJ,3VkHkmOtom3jM2wCu94xgzzu1d6Dn7or,11,3,3,0,3,2,17,0,28,4.0,1,0.0,0,3,0,3,3,2,0,17,0,6,22,1
4179,107811,amzSaAhEVYiJCoRiDu6cd5BYPiTTwZ6j,3VkHkmOtom3jM2wCu94xgzzu1d6Dn7or,5,2,0,0,1,0,3,0,6,0.8571428571428571,1,0.0,0,0,0,1,2,0,0,3,0,1,5,1
4180,107891,95fHgWNvJpmp0iW9cV37RjqKyhMGAGKz,3VkHkmOtom3jM2wCu94xgzzu1d6Dn7or,1,0,0,0,0,0,1,0,1,0.14285714285714285,1,0.0,0,0,0,0,0,0,0,1,0,0,1,1
4181,107956,ERmCWTdvUnD8SHuJiSyZie0niDeQ1UlO,3VkHkmOtom3jM2wCu94xgzzu1d6Dn7or,5,8,3,0,0,0,2,0,13,1.8571428571428572,1,0.0,0,3,0,0,8,0,0,2,0,3,10,1
4182,107957,IFxthWLazhxD7CvT8D736tU2RfMY0bzi,3VkHkmOtom3jM2wCu94xgzzu1d6Dn7or,14,19,5,14,9,7,4,0,58,8.285714285714286,1,0.0,13,5,11,9,6,7,3,4,0,38,20,1
4183,107960,6IfJ9QgODO64U1dhYUGyAtcV0JIrduov,3VkHkmOtom3jM2wCu94xgzzu1d6Dn7or,8,2,1,0,1,0,15,1,20,2.857142857142857,1,0.0,0,1,0,1,2,0,0,15,1,2,18,1
4184,108421,Z8VFKUoySr9L7FZfGeoeDWQqxwnJbTos,SpATywNh6bZuzm8s1ceuBUnMUAeoAHHw,14,20,2,12,0,0,6,0,40,5.714285714285714,4,0.0,2,2,11,0,18,0,1,6,0,15,25,0
4185,108658,FAjTaGnsfZLBQS9slQbYMPpuh5mcYxue,SpATywNh6bZuzm8s1ceuBUnMUAeoAHHw,17,17,7,24,1,4,4,0,57,8.142857142857142,2,0.0,7,7,19,1,10,4,5,4,0,34,23,0
4186,109134,V9A9B2T9pRTU3AqvpqzuKs4MfRcAEte2,A3fsA9Zfv1X2fVEQhTw51lKENdNrEqT3,1,0,0,0,0,0,1,0,1,0.14285714285714285,1,0.0,0,0,0,0,0,0,0,1,0,0,1,1
4187,109229,txSjWYX3TEWx5QLOiaADcbFdCZMHt7yE,A3fsA9Zfv1X2fVEQhTw51lKENdNrEqT3,6,4,1,0,1,0,1,0,7,1.0,1,0.0,0,1,0,1,4,0,0,1,0,2,5,0
4188,109342,obFxfGLSP12hWUYqYGw1SR5lINNLUPlg,SpATywNh6bZuzm8s1ceuBUnMUAeoAHHw,14,15,7,0,5,6,2,0,35,5.0,1,0.0,2,7,0,5,13,6,0,2,0,14,21,1
4189,109536,Cv1aavObJnuABKfipF6OGePzg0BnGPFs,SpATywNh6bZuzm8s1ceuBUnMUAeoAHHw,7,4,2,5,0,0,4,0,15,2.142857142857143,1,0.0,2,2,5,0,2,0,0,4,0,9,6,1
4190,109697,pGYP47am2d3xk9zOKdaE6fuoOc52iQiA,A3fsA9Zfv1X2fVEQhTw51lKENdNrEqT3,1,0,0,0,0,0,1,0,1,0.14285714285714285,1,0.0,0,0,0,0,0,0,0,1,0,0,1,1
4191,109908,HCwGALsXdQRvdnW9Y1SicRkbFYJcehRz,G8EPVSXsOYB5YQWZGiz1aVq5Pgr2GrQu,30,16,8,62,4,0,2,0,92,13.142857142857142,1,0.0,2,8,56,4,14,0,6,2,0,70,22,0
4192,109982,DmULS2tEq0maGheqJ8Xg7VkvUxmleIug,SpATywNh6bZuzm8s1ceuBUnMUAeoAHHw,1,0,0,0,0,0,1,0,1,0.14285714285714285,1,0.0,0,0,0,0,0,0,0,1,0,0,1,0
4193,110080,hcKYo6bLhlANvHE0FxLuR4YY8jocfBwJ,3VkHkmOtom3jM2wCu94xgzzu1d6Dn7or,1,0,0,0,0,0,1,0,1,0.14285714285714285,1,0.0,0,0,0,0,0,0,0,1,0,0,1,1
4194,110160,tQTTqm9DjemtPNF3ORI2L4M8osQnAURf,3VkHkmOtom3jM2wCu94xgzzu1d6Dn7or,1,0,0,0,0,0,1,0,1,0.14285714285714285,1,0.0,0,0,0,0,0,0,0,1,0,0,1,1
4195,110172,dgw4tTSPoodEIw3NArkQfHVLNlyVpfo8,3VkHkmOtom3jM2wCu94xgzzu1d6Dn7or,6,8,3,0,1,0,6,0,18,2.5714285714285716,4,0.0,0,3,0,1,8,0,0,6,0,4,14,1
4196,110201,uuX226ZRzkH40ob6OQauhckMXaHIVvO6,3VkHkmOtom3jM2wCu94xgzzu1d6Dn7or,1,0,0,0,0,0,1,0,1,0.14285714285714285,1,0.0,0,0,0,0,0,0,0,1,0,0,1,1
4197,110273,CJsNiGCsxs0gSxnKzYmVgd6irEKAgYWb,3VkHkmOtom3jM2wCu94xgzzu1d6Dn7or,4,2,0,0,1,0,1,0,4,0.5714285714285714,1,0.0,0,0,0,1,2,0,0,1,0,1,3,1
4198,110314,Kw4j4zV2G17wNG0fvJSniJC0vpSp4WB3,3VkHkmOtom3jM2wCu94xgzzu1d6Dn7or,3,7,1,0,0,0,2,0,10,1.4285714285714286,1,0.0,2,1,0,0,5,0,0,2,0,3,7,1
4199,110315,KWgayNex9Wt525YiePdZOaMt6mX0X0eu,3VkHkmOtom3jM2wCu94xgzzu1d6Dn7or,6,5,1,0,2,1,4,1,14,2.0,1,0.0,3,1,0,2,2,1,0,4,1,6,8,1
4200,110324,ypGN2wgc9crA4zEJXwMWXNDHD4O5YyyW,3VkHkmOtom3jM2wCu94xgzzu1d6Dn7or,4,2,1,0,1,0,1,0,5,0.7142857142857143,1,0.0,0,1,0,1,2,0,0,1,0,2,3,1
4201,110335,pjAfJHyO8N5jQipO1PMinHg7bhzVpnp5,3VkHkmOtom3jM2wCu94xgzzu1d6Dn7or,2,0,0,0,0,0,2,0,2,0.2857142857142857,1,0.0,0,0,0,0,0,0,0,2,0,0,2,1
4202,110373,qiegS2hNiYigSBc2IvMkXPpA0hNqDPGC,3VkHkmOtom3jM2wCu94xgzzu1d6Dn7or,6,5,2,0,1,1,2,0,11,1.5714285714285714,1,0.0,0,2,0,1,5,1,0,2,0,3,8,1
4203,110382,DD3RB9vWEpLhfNx2699s29qSfhYix0qh,3VkHkmOtom3jM2wCu94xgzzu1d6Dn7or,1,0,0,0,0,0,1,0,1,0.14285714285714285,1,0.0,0,0,0,0,0,0,0,1,0,0,1,1
4204,110391,MQZdAEEmvpjWGuI3HotP9v7Hv3drJgho,3VkHkmOtom3jM2wCu94xgzzu1d6Dn7or,1,0,0,0,0,0,1,0,1,0.14285714285714285,1,0.0,0,0,0,0,0,0,0,1,0,0,1,1
4205,110405,dklUB6yC0xsZG5YlRHgQDJ8HWL9EGj2b,3VkHkmOtom3jM2wCu94xgzzu1d6Dn7or,1,0,0,0,0,0,2,0,2,0.2857142857142857,1,0.0,0,0,0,0,0,0,0,2,0,0,2,1
4206,110420,lk3lGbNCFxoPG1OVILbfGp3s2wN91K2M,3VkHkmOtom3jM2wCu94xgzzu1d6Dn7or,9,6,4,0,3,0,2,0,15,2.142857142857143,2,0.0,0,4,0,3,6,0,0,2,0,7,8,1
4207,110431,Eoq6GI8WvhBY8jGaKSz9pwBaAPOaKefs,3VkHkmOtom3jM2wCu94xgzzu1d6Dn7or,17,10,1,0,7,0,3,0,21,3.0,2,0.0,1,1,0,7,9,0,0,3,0,9,12,1
4208,110442,VPZdopz81m6GMrIZPFm4nryG685J1OxT,3VkHkmOtom3jM2wCu94xgzzu1d6Dn7or,1,0,0,0,0,0,1,0,1,0.14285714285714285,1,0.0,0,0,0,0,0,0,0,1,0,0,1,1
4209,110561,JRJaGujKrM28bu4l5ufPAodjLHbLI1ND,3VkHkmOtom3jM2wCu94xgzzu1d6Dn7or,5,2,1,0,1,0,2,0,6,0.8571428571428571,1,0.0,0,1,0,1,2,0,0,2,0,2,4,1
4210,110647,lYs6uTLhEyomcaec07g09oLWhf3wcIzp,3VkHkmOtom3jM2wCu94xgzzu1d6Dn7or,6,2,1,0,1,0,3,0,7,1.0,1,0.0,0,1,0,1,2,0,0,3,0,2,5,1
4211,110649,5txttxupjDZ5RVkKM8mUX5AwlfTmH5yF,3VkHkmOtom3jM2wCu94xgzzu1d6Dn7or,1,0,0,0,0,0,1,0,1,0.14285714285714285,1,0.0,0,0,0,0,0,0,0,1,0,0,1,1
4212,110690,hIVUDhb4i3nVGfAV6do3ugshBCuhX9Mx,3VkHkmOtom3jM2wCu94xgzzu1d6Dn7or,1,0,0,0,0,0,1,0,1,0.14285714285714285,1,0.0,0,0,0,0,0,0,0,1,0,0,1,1
4213,110701,MDJK2KVw2sHLHwyALdBdwbko7CJt3B5W,3VkHkmOtom3jM2wCu94xgzzu1d6Dn7or,18,33,15,7,16,5,4,0,80,11.428571428571429,2,0.0,15,15,7,16,18,5,0,4,0,53,27,0
4214,110719,91sZGqEx9uDXZlwTbnZ3tvnn10BqfT5E,3VkHkmOtom3jM2wCu94xgzzu1d6Dn7or,18,41,4,11,16,20,9,1,102,14.571428571428571,1,0.0,35,4,10,16,6,20,1,9,1,65,37,1
4215,110839,Hc0D2UkydjyUi3vnnsfmiB8lOnMbIWKo,3VkHkmOtom3jM2wCu94xgzzu1d6Dn7or,89,282,74,104,101,8,41,9,619,88.42857142857143,4,0.0,177,74,87,101,105,8,17,41,9,439,180,1
4216,110946,h7Gk9Pr4tHraGHEA4N989G6mMEttrQ7F,3VkHkmOtom3jM2wCu94xgzzu1d6Dn7or,1,0,0,0,0,0,1,0,1,0.14285714285714285,1,0.0,0,0,0,0,0,0,0,1,0,0,1,1
4217,110952,385eoDvq5L7kSzlslamm7bGDDIFQKNoc,3VkHkmOtom3jM2wCu94xgzzu1d6Dn7or,71,141,71,97,49,51,36,1,446,63.714285714285715,9,0.0,39,71,81,49,102,51,16,36,1,240,206,0
4218,111009,DiP7fLvMTHut4vp8IPCEmth5BO8Y3xyZ,3VkHkmOtom3jM2wCu94xgzzu1d6Dn7or,79,122,66,76,50,23,18,5,360,51.42857142857143,3,0.0,38,66,73,50,84,23,3,18,5,227,133,0
4219,111011,dBwvitRj8tl4oRvKTVIguzs8yzvyjBHl,3VkHkmOtom3jM2wCu94xgzzu1d6Dn7or,67,238,103,69,52,16,54,8,540,77.14285714285714,9,0.0,87,103,67,52,151,16,2,54,8,309,231,0
4220,111044,4WnXFlVVsDRP9zMYu9GhBkmRaEDuNfCw,3VkHkmOtom3jM2wCu94xgzzu1d6Dn7or,1,0,0,0,0,0,2,0,2,0.2857142857142857,1,0.0,0,0,0,0,0,0,0,2,0,0,2,1
4221,111051,FxaU1aiaJfFcWvu1nipWOIaSeSTieKCJ,3VkHkmOtom3jM2wCu94xgzzu1d6Dn7or,10,10,3,0,2,3,14,1,33,4.714285714285714,1,0.0,0,3,0,2,10,3,0,14,1,5,28,1
4222,111098,gCOl0XKZgn7U20rgDk2nqeymvoIH6h2A,3VkHkmOtom3jM2wCu94xgzzu1d6Dn7or,1,0,0,0,0,0,1,0,1,0.14285714285714285,1,0.0,0,0,0,0,0,0,0,1,0,0,1,1
4223,111134,UtAqhqB3FX1II4t3OmHm0AmqSdhnUJww,3VkHkmOtom3jM2wCu94xgzzu1d6Dn7or,74,53,24,26,23,1,13,1,141,20.142857142857142,1,0.0,22,24,25,23,31,1,1,13,1,94,47,0
4224,111202,J4alNwqJn6WPGLv0oNVXgfBnikipd1X1,3VkHkmOtom3jM2wCu94xgzzu1d6Dn7or,69,92,47,98,28,22,30,0,317,45.285714285714285,1,0.0,32,47,86,28,60,22,12,30,0,193,124,1
4225,111247,frTI0FocLiDe4yupewVASUS2u4VqwYIi,3VkHkmOtom3jM2wCu94xgzzu1d6Dn7or,1,0,0,0,0,0,1,0,1,0.14285714285714285,1,0.0,0,0,0,0,0,0,0,1,0,0,1,1
4226,111278,u4XgrwL7SekHV6NpCL6rWztzww1pNSow,3VkHkmOtom3jM2wCu94xgzzu1d6Dn7or,1,0,0,0,0,0,1,0,1,0.14285714285714285,1,0.0,0,0,0,0,0,0,0,1,0,0,1,1
4227,111281,DAhW5rh28SUHtuiMbPZb9rI9MdH1t7pB,3VkHkmOtom3jM2wCu94xgzzu1d6Dn7or,1,0,0,0,0,0,1,0,1,0.14285714285714285,1,0.0,0,0,0,0,0,0,0,1,0,0,1,1
4228,111298,Edq6Echk8wEs8ShX5RBw5c8Yx8ANHVje,3VkHkmOtom3jM2wCu94xgzzu1d6Dn7or,65,158,72,31,53,16,40,8,378,54.0,8,0.0,37,72,25,53,121,16,6,40,8,187,191,0
4229,111324,JVjtBSreKMlUtn69yisEBp2mMBmVSbkl,3VkHkmOtom3jM2wCu94xgzzu1d6Dn7or,1,0,0,0,0,0,1,0,1,0.14285714285714285,1,0.0,0,0,0,0,0,0,0,1,0,0,1,1
4230,111381,qy4bKhXqNBlINsljPVNLHwKIsvlS56JE,3VkHkmOtom3jM2wCu94xgzzu1d6Dn7or,1,0,0,0,0,0,1,0,1,0.14285714285714285,1,0.0,0,0,0,0,0,0,0,1,0,0,1,1
4231,111383,KuvsFrN97YK5My2eYxIvxOJQK3uGLMZl,3VkHkmOtom3jM2wCu94xgzzu1d6Dn7or,8,4,3,0,3,0,2,0,12,1.7142857142857142,2,0.0,0,3,0,3,4,0,0,2,0,6,6,0
4232,111410,q71qOWfICaVfg6Zw64BA0tNHU6xbZhD6,3VkHkmOtom3jM2wCu94xgzzu1d6Dn7or,2,0,0,0,0,0,5,0,5,0.7142857142857143,1,0.0,0,0,0,0,0,0,0,5,0,0,5,1
4233,111420,gYURfn1wGFkYpvwmL9xjcpaVpwUtS21C,3VkHkmOtom3jM2wCu94xgzzu1d6Dn7or,5,9,4,0,2,0,3,0,18,2.5714285714285716,1,0.0,0,4,0,2,9,0,0,3,0,6,12,1
4234,111423,n0aD0wlRo2epwn74jquTDUFpiwWF99mc,3VkHkmOtom3jM2wCu94xgzzu1d6Dn7or,28,95,35,39,18,22,31,0,240,34.285714285714285,3,0.0,37,35,32,18,58,22,7,31,0,122,118,0
4235,111486,ph5wiKq9PFfSU2tf3ynRG351nJE4IJkg,3VkHkmOtom3jM2wCu94xgzzu1d6Dn7or,6,5,0,0,1,0,5,0,11,1.5714285714285714,1,0.0,3,0,0,1,2,0,0,5,0,4,7,1
4236,111507,GYAhe7QkBFzfyQOufZzJyKbMW1Ol7QR2,3VkHkmOtom3jM2wCu94xgzzu1d6Dn7or,63,95,27,48,32,1,9,0,212,30.285714285714285,3,0.0,54,27,48,32,41,1,0,9,0,161,51,0
4237,111509,Qg58L4tshpaHzP1wdPOKDyrMxGfjR0JY,3VkHkmOtom3jM2wCu94xgzzu1d6Dn7or,1,0,0,0,0,0,1,0,1,0.14285714285714285,1,0.0,0,0,0,0,0,0,0,1,0,0,1,1
4238,111511,MiNPEyHmjvHg1wNBdSa8s4LNXdy6iLx3,3VkHkmOtom3jM2wCu94xgzzu1d6Dn7or,7,2,1,0,1,1,6,1,12,1.7142857142857142,1,0.0,0,1,0,1,2,1,0,6,1,2,10,0
4239,111556,7IxTaoybgqwYaeApepZlCbtcTpX0V2Zq,3VkHkmOtom3jM2wCu94xgzzu1d6Dn7or,17,37,20,3,17,8,7,0,92,13.142857142857142,4,0.0,9,20,2,17,28,8,1,7,0,48,44,1
4240,111564,zUobDCRhz2JvPr18gEcZcSJ3b1q6D65b,3VkHkmOtom3jM2wCu94xgzzu1d6Dn7or,9,13,8,2,4,2,7,0,36,5.142857142857143,2,0.0,2,8,2,4,11,2,0,7,0,16,20,1
4241,111582,3p1ktBOq5CZcyAsD0nHTLBZZjpK9i1Gn,3VkHkmOtom3jM2wCu94xgzzu1d6Dn7or,1,0,0,0,0,0,1,0,1,0.14285714285714285,1,0.0,0,0,0,0,0,0,0,1,0,0,1,1
4242,111583,CaPxrejcLjdFG5dqioKl8ehEL4wq8JH2,3VkHkmOtom3jM2wCu94xgzzu1d6Dn7or,9,8,5,0,3,9,19,1,45,6.428571428571429,3,0.0,1,5,0,3,7,9,0,19,1,9,36,1
4243,111600,P10HaDx6l8IuAsJbV4kOql1OHfzQ01pK,3VkHkmOtom3jM2wCu94xgzzu1d6Dn7or,6,4,2,0,1,3,3,0,13,1.8571428571428572,1,0.0,0,2,0,1,4,3,0,3,0,3,10,1
4244,111617,uudNxB4rLeWW9Hko0kaY7p0fpljb07CO,3VkHkmOtom3jM2wCu94xgzzu1d6Dn7or,1,0,0,0,0,0,1,0,1,0.14285714285714285,1,0.0,0,0,0,0,0,0,0,1,0,0,1,1
4245,111676,xLLYMOxgSGV4lCmifoUg1VooBZRaCvj1,3VkHkmOtom3jM2wCu94xgzzu1d6Dn7or,1,0,0,0,0,0,1,0,1,0.14285714285714285,1,0.0,0,0,0,0,0,0,0,1,0,0,1,1
4246,111706,X8NuLmgGRaFMI5zNKihuJdLjGBr35knv,3VkHkmOtom3jM2wCu94xgzzu1d6Dn7or,6,3,2,0,1,0,3,0,9,1.2857142857142858,1,0.0,0,2,0,1,3,0,0,3,0,3,6,1
4247,111736,dRP0ir8plXgy7LWTvwwfAqySkmmXoOPk,3VkHkmOtom3jM2wCu94xgzzu1d6Dn7or,7,3,1,0,2,0,2,0,8,1.1428571428571428,1,0.0,0,1,0,2,3,0,0,2,0,3,5,1
4248,111744,MlhSM0XKuMJ0bCO7z2w3vdKbHEE7ba20,3VkHkmOtom3jM2wCu94xgzzu1d6Dn7or,8,6,1,0,2,2,5,5,21,3.0,1,0.0,2,1,0,2,4,2,0,5,5,5,16,1
4249,111768,Ve3uoVQNDVK9QV5oetJsvI3CTxMOaW16,3VkHkmOtom3jM2wCu94xgzzu1d6Dn7or,7,7,4,0,3,0,3,0,17,2.4285714285714284,1,0.0,0,4,0,3,7,0,0,3,0,7,10,1
4250,111770,ZSlBckdwoYlTvZClIIiOXz0ZMgxNYGfM,3VkHkmOtom3jM2wCu94xgzzu1d6Dn7or,1,0,0,0,0,0,1,0,1,0.14285714285714285,1,0.0,0,0,0,0,0,0,0,1,0,0,1,1
4251,111785,GebdA7Vo87ReyKP2A7BXi3CttXQIgfXb,3VkHkmOtom3jM2wCu94xgzzu1d6Dn7or,1,0,0,0,0,0,1,0,1,0.14285714285714285,1,0.0,0,0,0,0,0,0,0,1,0,0,1,1
4252,111850,SZCjuQFEoPPVPSbhIibtzJ6PkWJhxivD,3VkHkmOtom3jM2wCu94xgzzu1d6Dn7or,4,2,1,0,1,0,1,0,5,0.7142857142857143,1,0.0,0,1,0,1,2,0,0,1,0,2,3,0
4253,111860,2ZN7cPIeVdD0KZCT2ktom7Ut5usBqNmS,3VkHkmOtom3jM2wCu94xgzzu1d6Dn7or,9,16,2,0,0,0,8,1,27,3.857142857142857,1,0.0,4,2,0,0,12,0,0,8,1,6,21,1
4254,111869,UyGxbLGpzWj9nUt4zlv3JQ4QXzLJV2bP,3VkHkmOtom3jM2wCu94xgzzu1d6Dn7or,1,0,0,0,0,0,1,0,1,0.14285714285714285,1,0.0,0,0,0,0,0,0,0,1,0,0,1,1
4255,111930,3DfsQ9gyILzjZd3Nv6DJhAXnVcPbzdjq,3VkHkmOtom3jM2wCu94xgzzu1d6Dn7or,14,12,4,0,5,4,8,3,36,5.142857142857143,1,0.0,5,4,0,5,7,4,0,8,3,14,22,1
4256,111936,pKAupmA8Zsx6hWHvCVolaq97GTNR8NMr,3VkHkmOtom3jM2wCu94xgzzu1d6Dn7or,8,2,1,0,1,1,5,1,11,1.5714285714285714,1,0.0,0,1,0,1,2,1,0,5,1,2,9,1
4257,111938,fsiWcpaBqhmZ0C1onKGiGw90SPlP8tG1,3VkHkmOtom3jM2wCu94xgzzu1d6Dn7or,5,9,2,2,2,1,1,0,17,2.4285714285714284,1,0.0,3,2,2,2,6,1,0,1,0,9,8,1
4258,111943,f2V0oICuYr1XUKhIx9tXBvYEtmo9HOKI,3VkHkmOtom3jM2wCu94xgzzu1d6Dn7or,10,30,6,6,11,3,6,0,62,8.857142857142858,1,0.0,21,6,5,11,9,3,1,6,0,43,19,1
4259,111944,Exx3Un9q1uCMXWbbyyaAPCkg6gWu2oBK,3VkHkmOtom3jM2wCu94xgzzu1d6Dn7or,1,0,0,0,0,0,1,0,1,0.14285714285714285,1,0.0,0,0,0,0,0,0,0,1,0,0,1,1
4260,111947,WvM5M1NFRJzPyKi5SvQNN6PHxvm7x8f1,3VkHkmOtom3jM2wCu94xgzzu1d6Dn7or,8,4,1,0,1,1,6,1,14,2.0,2,0.0,1,1,0,1,3,1,0,6,1,3,11,1
4261,111953,skpJtZYiMDDMx1OrlY5mDzZ4vLhPTUr0,3VkHkmOtom3jM2wCu94xgzzu1d6Dn7or,70,166,67,40,66,17,17,0,373,53.285714285714285,12,0.0,72,67,40,66,94,17,0,17,0,245,128,0
4262,111955,Estdjd6V12yYbDglfRGOJrJgPUySsORQ,3VkHkmOtom3jM2wCu94xgzzu1d6Dn7or,4,0,0,0,0,1,3,0,4,0.5714285714285714,1,0.0,0,0,0,0,0,1,0,3,0,0,4,1
4263,111958,UIl4zQsYWbldMZPjUNpW4NT1FiQSwWSq,3VkHkmOtom3jM2wCu94xgzzu1d6Dn7or,8,7,4,0,2,0,9,1,23,3.2857142857142856,1,0.0,0,4,0,2,7,0,0,9,1,6,17,1
4264,111960,8ySChdMhILkWrFidrAeAcbpscZk12bIK,3VkHkmOtom3jM2wCu94xgzzu1d6Dn7or,7,3,2,0,2,0,5,0,12,1.7142857142857142,1,0.0,0,2,0,2,3,0,0,5,0,4,8,1
4265,111961,wxlTuL6FVeoyKGq1xWxdRI4GRTsaG1Ha,3VkHkmOtom3jM2wCu94xgzzu1d6Dn7or,4,6,2,0,0,0,2,0,10,1.4285714285714286,1,0.0,3,2,0,0,3,0,0,2,0,5,5,1
4266,111971,h6o87K2TwGFARqnbFLA8ALKnrMFFMZSS,3VkHkmOtom3jM2wCu94xgzzu1d6Dn7or,7,6,0,0,1,1,4,0,12,1.7142857142857142,2,0.0,1,0,0,1,5,1,0,4,0,2,10,1
4267,111977,UT72iLyPsiKxDVBpTr4IKm3K6RJA6lY0,3VkHkmOtom3jM2wCu94xgzzu1d6Dn7or,2,0,0,0,0,0,6,0,6,0.8571428571428571,1,0.0,0,0,0,0,0,0,0,6,0,0,6,1
4268,111981,y0iWjLNC6UZ1t5vHgtgjLHxXYlZwkmmB,3VkHkmOtom3jM2wCu94xgzzu1d6Dn7or,6,2,0,0,0,0,4,0,6,0.8571428571428571,1,0.0,0,0,0,0,2,0,0,4,0,0,6,1
4269,111984,G0nwXlWZMERhq2ON5nxnxNtoRAERGxUq,3VkHkmOtom3jM2wCu94xgzzu1d6Dn7or,14,8,7,0,7,0,1,0,23,3.2857142857142856,1,0.0,0,7,0,7,8,0,0,1,0,14,9,1
4270,111985,Zc2H7AOkStouMPrWXTVWTTQu8hKuh8Ix,3VkHkmOtom3jM2wCu94xgzzu1d6Dn7or,21,30,23,0,22,0,5,0,80,11.428571428571429,1,0.0,3,23,0,22,27,0,0,5,0,48,32,1
4271,111991,LqcGRzWXAOTgfy7uWLpn5rWutSneazTK,3VkHkmOtom3jM2wCu94xgzzu1d6Dn7or,2,0,0,0,0,0,4,0,4,0.5714285714285714,1,0.0,0,0,0,0,0,0,0,4,0,0,4,1
4272,112000,7gdV7KHFxHCq7uneNPZ2mJZzAKbnphff,3VkHkmOtom3jM2wCu94xgzzu1d6Dn7or,7,7,4,0,2,0,11,0,24,3.4285714285714284,2,0.0,0,4,0,2,7,0,0,11,0,6,18,1
4273,112013,W6dP7nTf9BNP7aV0CbJYvRNsUWmdVpbc,3VkHkmOtom3jM2wCu94xgzzu1d6Dn7or,1,0,0,0,0,0,1,0,1,0.14285714285714285,1,0.0,0,0,0,0,0,0,0,1,0,0,1,1
4274,112019,76pKCefEfcfpKWQtQXjk4oYjnkzOZxgt,3VkHkmOtom3jM2wCu94xgzzu1d6Dn7or,3,8,2,0,0,0,1,0,11,1.5714285714285714,1,0.0,2,2,0,0,6,0,0,1,0,4,7,1
4275,112022,KVo59motAkvZvNOOD8FGbdMlYFkMnvCS,3VkHkmOtom3jM2wCu94xgzzu1d6Dn7or,1,0,0,0,0,0,2,0,2,0.2857142857142857,1,0.0,0,0,0,0,0,0,0,2,0,0,2,1
4276,112030,CP3nhN9EdmeKw6zajWsPWDgJI2wN23yd,3VkHkmOtom3jM2wCu94xgzzu1d6Dn7or,1,0,0,0,0,0,1,0,1,0.14285714285714285,1,0.0,0,0,0,0,0,0,0,1,0,0,1,1
4277,112031,BdfiHqmY8y0Rb9j3NkCjTbrPRsqwK9UA,3VkHkmOtom3jM2wCu94xgzzu1d6Dn7or,1,0,0,0,0,0,1,0,1,0.14285714285714285,1,0.0,0,0,0,0,0,0,0,1,0,0,1,1
4278,112037,YBkzZZhOJVCrbhYhnWEKCK1kCty9skX4,3VkHkmOtom3jM2wCu94xgzzu1d6Dn7or,4,2,1,0,1,0,1,0,5,0.7142857142857143,1,0.0,0,1,0,1,2,0,0,1,0,2,3,1
4279,112038,cPOTZdhRHkdjEi5m6KG2HFGdYqzepY5d,3VkHkmOtom3jM2wCu94xgzzu1d6Dn7or,2,0,0,0,0,0,2,0,2,0.2857142857142857,1,0.0,0,0,0,0,0,0,0,2,0,0,2,1
4280,112039,wrcYJrLAOsQKdwZZIoFJl5xvtnZ7aQv7,3VkHkmOtom3jM2wCu94xgzzu1d6Dn7or,4,0,0,0,0,0,4,0,4,0.5714285714285714,1,0.0,0,0,0,0,0,0,0,4,0,0,4,1
4281,112040,qMFAmPw34z5IViYTtA1Kkpcn2uEg1WBM,3VkHkmOtom3jM2wCu94xgzzu1d6Dn7or,1,0,0,0,0,0,1,0,1,0.14285714285714285,1,0.0,0,0,0,0,0,0,0,1,0,0,1,1
4282,112061,pXhlODqjUGiHEnVqqJV8aw6jGGC44Z9b,3VkHkmOtom3jM2wCu94xgzzu1d6Dn7or,4,2,1,0,0,0,2,0,5,0.7142857142857143,1,0.0,0,1,0,0,2,0,0,2,0,1,4,1
4283,112109,ATfemq9ZbNbnnT9IBiRcbfRhEk6fLmjZ,3VkHkmOtom3jM2wCu94xgzzu1d6Dn7or,6,2,1,0,1,0,4,1,9,1.2857142857142858,1,0.0,0,1,0,1,2,0,0,4,1,2,7,1
4284,112120,UWAUal0Hpb3RbEmfIAwz3lm4E3yvYQMV,3VkHkmOtom3jM2wCu94xgzzu1d6Dn7or,1,0,0,0,0,0,1,0,1,0.14285714285714285,1,0.0,0,0,0,0,0,0,0,1,0,0,1,1
4285,112145,c5JhVDkXO4Xl1o4x0X5wpbuFHZccHbBn,3VkHkmOtom3jM2wCu94xgzzu1d6Dn7or,8,2,1,0,1,0,6,0,10,1.4285714285714286,1,0.0,0,1,0,1,2,0,0,6,0,2,8,1
4286,112161,JcCpItFxuZKtVIsbgPaRDIeLN2ik56pZ,3VkHkmOtom3jM2wCu94xgzzu1d6Dn7or,1,0,0,0,0,0,1,0,1,0.14285714285714285,1,0.0,0,0,0,0,0,0,0,1,0,0,1,1
4287,112171,T1xwSBpIR06eshHrqOHizSKkKz8v47RI,3VkHkmOtom3jM2wCu94xgzzu1d6Dn7or,8,9,4,0,3,0,4,0,20,2.857142857142857,1,0.0,2,4,0,3,7,0,0,4,0,9,11,1
4288,112176,94L6G6uqjoIozyLQIsc4GEWmNn1tQth5,3VkHkmOtom3jM2wCu94xgzzu1d6Dn7or,1,0,0,0,0,0,1,0,1,0.14285714285714285,1,0.0,0,0,0,0,0,0,0,1,0,0,1,1
4289,112177,BNU2wGZhV5dmPLymeUzZGTZPF40H3QyF,3VkHkmOtom3jM2wCu94xgzzu1d6Dn7or,31,20,19,0,19,0,1,0,59,8.428571428571429,1,0.0,0,19,0,19,20,0,0,1,0,38,21,1
4290,112184,2f8w2JPFYWYlQ8YCbFTA0pgMRO6fzXen,3VkHkmOtom3jM2wCu94xgzzu1d6Dn7or,5,2,1,0,1,0,2,0,6,0.8571428571428571,1,0.0,0,1,0,1,2,0,0,2,0,2,4,1
4291,112205,V525N9mtqrNpraRU1F9QVCqUQEU1WfxW,3VkHkmOtom3jM2wCu94xgzzu1d6Dn7or,6,1,1,0,1,0,4,0,7,1.0,1,0.0,0,1,0,1,1,0,0,4,0,2,5,1
4292,112243,syN7254OdJ7LnC3HWyjnPHaGfR8Du2Io,3VkHkmOtom3jM2wCu94xgzzu1d6Dn7or,2,0,0,0,0,0,4,0,4,0.5714285714285714,1,0.0,0,0,0,0,0,0,0,4,0,0,4,0
4293,112289,kGF8CGQ426uE7xF8JEXhsJ2gcirqmBoI,3VkHkmOtom3jM2wCu94xgzzu1d6Dn7or,4,2,1,0,1,5,2,0,11,1.5714285714285714,1,0.0,0,1,0,1,2,5,0,2,0,2,9,1
4294,112306,RgykpghwGJQQimxBR8odeQ7kA01zSs4z,3VkHkmOtom3jM2wCu94xgzzu1d6Dn7or,24,53,17,17,15,10,14,1,127,18.142857142857142,4,0.0,26,17,15,15,27,10,2,14,1,73,54,1
4295,112308,GEP9PIxkZLOm5AbT7V1aSC88PhAcNGOk,3VkHkmOtom3jM2wCu94xgzzu1d6Dn7or,7,2,1,0,1,1,4,3,12,1.7142857142857142,1,0.0,0,1,0,1,2,1,0,4,3,2,10,1
4296,112334,FRAAuV41f0A1JwZFXkz0IPkuaO4bvD0Y,3VkHkmOtom3jM2wCu94xgzzu1d6Dn7or,1,0,0,0,0,0,1,0,1,0.14285714285714285,1,0.0,0,0,0,0,0,0,0,1,0,0,1,1
4297,112347,AOKKHTTFDt3cG76lqD8M5js5DVaXEufq,5Gyp41oLVo7Gg7vF4vpmggWP5MU70QO6,4,2,1,0,0,4,4,0,11,1.5714285714285714,1,0.0,0,1,0,0,2,4,0,4,0,1,10,1
4298,112380,MpSNV24HikKcci8LVDCzB6LlDUQPkZS7,5Gyp41oLVo7Gg7vF4vpmggWP5MU70QO6,6,5,3,0,0,0,3,0,11,1.5714285714285714,1,0.0,0,3,0,0,5,0,0,3,0,3,8,1
4299,112382,azxaSvsDmT4A6SNOsI1Fhg8dajvIGqlD,5Gyp41oLVo7Gg7vF4vpmggWP5MU70QO6,13,13,9,2,4,0,5,0,33,4.714285714285714,4,0.0,0,9,1,4,13,0,1,5,0,14,19,1
4300,112414,gvbilxxJzio6bU0Dq93ZcoCjsIZMrKzu,5Gyp41oLVo7Gg7vF4vpmggWP5MU70QO6,10,9,4,2,2,1,2,0,20,2.857142857142857,1,0.0,3,4,1,2,6,1,1,2,0,10,10,1
4301,112458,GJLKw6tfNJPMqBJIRYwRi9vEhQle2nLj,5Gyp41oLVo7Gg7vF4vpmggWP5MU70QO6,12,12,8,0,5,2,17,2,46,6.571428571428571,3,0.0,1,8,0,5,11,2,0,17,2,14,32,1
4302,112508,TUwVrd2hmfW6VyLzKbv0bNRWMKGDOGOV,5Gyp41oLVo7Gg7vF4vpmggWP5MU70QO6,14,79,30,4,2,0,34,0,149,21.285714285714285,13,0.0,5,30,2,2,74,0,2,34,0,39,110,0
4303,112536,3qTlPtBsk5txTgIAC0TiKjYYcFuLtWKe,5Gyp41oLVo7Gg7vF4vpmggWP5MU70QO6,12,18,7,2,2,0,3,0,32,4.571428571428571,2,0.0,2,7,1,2,16,0,1,3,0,12,20,1
4304,112546,UnBwSmlOPbYUmVq2fUKodPbT52jzjDn0,5Gyp41oLVo7Gg7vF4vpmggWP5MU70QO6,15,32,21,8,12,0,10,0,83,11.857142857142858,5,0.0,6,21,5,12,26,0,3,10,0,44,39,0
4305,112557,59KrgCJlOEHQHzBNjsHoSd6BkQVArDrc,5Gyp41oLVo7Gg7vF4vpmggWP5MU70QO6,6,5,1,0,1,0,2,0,9,1.2857142857142858,1,0.0,0,1,0,1,5,0,0,2,0,2,7,1
4306,112571,AbYBYWZBb1Rg8bMbPOYcN6TCnE8uQX0y,5Gyp41oLVo7Gg7vF4vpmggWP5MU70QO6,7,7,3,0,2,0,2,0,14,2.0,1,0.0,0,3,0,2,7,0,0,2,0,5,9,1
4307,112572,u3SPm1HFwlhJpJKaAvQIjwvJr5QcuOph,5Gyp41oLVo7Gg7vF4vpmggWP5MU70QO6,1,0,0,0,0,0,1,0,1,0.14285714285714285,1,0.0,0,0,0,0,0,0,0,1,0,0,1,1
4308,112577,ycgZ98qvYlJIVifUUXet21FpEE8fnXg5,5Gyp41oLVo7Gg7vF4vpmggWP5MU70QO6,9,10,4,0,2,0,16,0,32,4.571428571428571,2,0.0,0,4,0,2,10,0,0,16,0,6,26,1
4309,112606,KnZXEOdCUZ4HTOZmg6haJiVPAqpJWDbk,5Gyp41oLVo7Gg7vF4vpmggWP5MU70QO6,5,2,1,0,1,0,2,0,6,0.8571428571428571,1,0.0,0,1,0,1,2,0,0,2,0,2,4,1
4310,112613,1Y5Tu6sRC67MVvT6PQzUkrnGn5Ec34mK,5Gyp41oLVo7Gg7vF4vpmggWP5MU70QO6,17,32,15,2,8,24,12,0,93,13.285714285714286,5,0.0,7,15,1,8,25,24,1,12,0,31,62,0
4311,112620,WDppciaQaSX4rO2Po407OBe8xDSe4iCL,5Gyp41oLVo7Gg7vF4vpmggWP5MU70QO6,19,46,25,20,11,0,4,0,106,15.142857142857142,3,0.0,14,25,11,11,32,0,9,4,0,61,45,1
4312,112631,78H6quizWzTs7OxtmaQJ1vJz0xUti4uS,5Gyp41oLVo7Gg7vF4vpmggWP5MU70QO6,2,0,0,0,0,0,2,0,2,0.2857142857142857,1,0.0,0,0,0,0,0,0,0,2,0,0,2,1
4313,112634,uqXaJBjlB2fR1jGFPXdDLi7hSsdUaco6,5Gyp41oLVo7Gg7vF4vpmggWP5MU70QO6,9,5,3,0,2,4,7,1,22,3.142857142857143,1,0.0,0,3,0,2,5,4,0,7,1,5,17,0
4314,112638,oxOn4BZLLdvCRFIc1Ac5np9t8DXUQ5bE,5Gyp41oLVo7Gg7vF4vpmggWP5MU70QO6,25,38,26,13,19,23,8,2,129,18.428571428571427,7,0.0,10,26,10,19,28,23,3,8,2,65,64,1
4315,112644,RdOTPiN7khNeleO1Yo3Wax3dSMd9rcAA,5Gyp41oLVo7Gg7vF4vpmggWP5MU70QO6,5,2,1,0,1,0,2,0,6,0.8571428571428571,1,0.0,0,1,0,1,2,0,0,2,0,2,4,1
4316,112666,iyh1hSFiFvKLuqtG3iw5CBCRHjFynFH1,5Gyp41oLVo7Gg7vF4vpmggWP5MU70QO6,6,3,1,0,1,0,2,0,7,1.0,1,0.0,0,1,0,1,3,0,0,2,0,2,5,1
4317,112686,HBbfTF7IDrJPTIg3LtdtLpoFRQM4pUsW,5Gyp41oLVo7Gg7vF4vpmggWP5MU70QO6,18,22,11,4,5,0,4,0,46,6.571428571428571,1,0.0,6,11,2,5,16,0,2,4,0,24,22,1
4318,112702,5AZvkrXdjv7Dh9hOSSXBk98ktGISqlYy,5Gyp41oLVo7Gg7vF4vpmggWP5MU70QO6,28,88,52,35,15,66,10,1,267,38.142857142857146,7,0.0,21,52,24,15,67,66,11,10,1,112,155,1
4319,112740,draxLlMrAsTi83twWbn61IUhSde1kOLx,5Gyp41oLVo7Gg7vF4vpmggWP5MU70QO6,6,2,2,0,1,0,5,0,10,1.4285714285714286,1,0.0,0,2,0,1,2,0,0,5,0,3,7,1
4320,112745,Ux0tez3CsVGjSwIIoA3MCOtaqdDdHQZ5,5Gyp41oLVo7Gg7vF4vpmggWP5MU70QO6,6,3,2,0,2,0,1,0,8,1.1428571428571428,1,0.0,0,2,0,2,3,0,0,1,0,4,4,1
4321,112746,h9inoGjnAUSg7BVY5rswRJ2sMSxAeY3N,5Gyp41oLVo7Gg7vF4vpmggWP5MU70QO6,6,3,2,0,1,0,2,0,8,1.1428571428571428,1,0.0,1,2,0,1,2,0,0,2,0,4,4,1
4322,112752,DfqU2HhaUqxdDt3bmcLzGFwFca0Bl6XL,5Gyp41oLVo7Gg7vF4vpmggWP5MU70QO6,8,8,4,0,0,1,6,1,20,2.857142857142857,2,0.0,2,4,0,0,6,1,0,6,1,6,14,1
4323,112771,I6X17ieof2IwIzaSbSDCN7B2bWXgcxJJ,5Gyp41oLVo7Gg7vF4vpmggWP5MU70QO6,6,2,1,0,1,0,4,0,8,1.1428571428571428,1,0.0,0,1,0,1,2,0,0,4,0,2,6,1
4324,112772,C7lNu4ULRhNvP0ezS2pr2jPc61wQ63IS,5Gyp41oLVo7Gg7vF4vpmggWP5MU70QO6,13,33,8,22,1,4,5,0,73,10.428571428571429,4,0.0,10,8,12,1,23,4,10,5,0,31,42,1
4325,112776,O0PH77enO9wX8k8hSC8xBawp8RimvZAe,5Gyp41oLVo7Gg7vF4vpmggWP5MU70QO6,7,4,1,0,3,0,3,0,11,1.5714285714285714,1,0.0,2,1,0,3,2,0,0,3,0,6,5,1
4326,112795,xPk7hfp3dMT8dxmNb6qTwC6VC8rmmQZe,5Gyp41oLVo7Gg7vF4vpmggWP5MU70QO6,15,13,9,0,6,0,2,0,30,4.285714285714286,1,0.0,0,9,0,6,13,0,0,2,0,15,15,1
4327,112842,ud8Y2EsnBupML3rKElwJORvnGy1H8SMp,5Gyp41oLVo7Gg7vF4vpmggWP5MU70QO6,13,17,8,16,3,3,7,1,55,7.857142857142857,4,0.0,3,8,12,3,14,3,4,7,1,26,29,1
4328,112864,o9yxG8Em98EZmBRbh1vFPl35WJ9Ht8S0,5Gyp41oLVo7Gg7vF4vpmggWP5MU70QO6,11,7,3,6,2,0,3,4,25,3.5714285714285716,1,0.0,3,3,3,2,4,0,3,3,4,11,14,1
4329,112880,yBSrnVhS1DeBYwGR5nHsoDkoqPgdpPDL,5Gyp41oLVo7Gg7vF4vpmggWP5MU70QO6,1,0,0,0,0,0,1,0,1,0.14285714285714285,1,0.0,0,0,0,0,0,0,0,1,0,0,1,1
4330,112938,u82lBhpDxJIwlZISEntCxj1zgVFdW0vT,5Gyp41oLVo7Gg7vF4vpmggWP5MU70QO6,1,0,0,0,0,0,2,0,2,0.2857142857142857,2,0.0,0,0,0,0,0,0,0,2,0,0,2,1
4331,112973,z5Xd8FxyLpXnR1XrLiNvHInD8fa31hZG,5Gyp41oLVo7Gg7vF4vpmggWP5MU70QO6,5,2,1,0,1,0,3,0,7,1.0,2,0.0,0,1,0,1,2,0,0,3,0,2,5,1
4332,113000,jNRA434lMAMZjPiQhPmaP5pXlW3ni5X9,5Gyp41oLVo7Gg7vF4vpmggWP5MU70QO6,6,9,2,2,0,0,2,0,15,2.142857142857143,3,0.0,1,2,1,0,8,0,1,2,0,4,11,1
4333,113005,suOeipVROVXXPGj0VZHJUUTxQ7mEMHZk,5Gyp41oLVo7Gg7vF4vpmggWP5MU70QO6,27,77,37,28,11,30,23,1,207,29.571428571428573,7,0.0,19,37,22,11,58,30,6,23,1,89,118,1
4334,113009,ZWLFs9GKrNhPN0D68ADGyrQdN3kTRIXt,5Gyp41oLVo7Gg7vF4vpmggWP5MU70QO6,36,111,58,24,21,27,19,2,262,37.42857142857143,7,0.0,35,58,18,21,76,27,6,19,2,132,130,1
4335,113021,szmVnhPypUPoSdN8Z8D02a6M8Gjrnwmf,5Gyp41oLVo7Gg7vF4vpmggWP5MU70QO6,30,63,31,14,17,0,22,3,150,21.428571428571427,4,0.0,19,31,7,17,44,0,7,22,3,74,76,1
4336,113036,uzKo5XybDLGWG8pNxiIda7r0TfSQ9SeA,5Gyp41oLVo7Gg7vF4vpmggWP5MU70QO6,23,72,31,8,11,0,16,0,138,19.714285714285715,8,0.0,26,31,5,11,46,0,3,16,0,73,65,1
4337,113055,4INqxCEsluwmbqvTup8Ug7EagwC5F45P,5Gyp41oLVo7Gg7vF4vpmggWP5MU70QO6,1,0,0,0,0,0,1,0,1,0.14285714285714285,1,0.0,0,0,0,0,0,0,0,1,0,0,1,1
4338,113072,Bv9FSXvHlE6wLC4E4yrAKqe3BQhrrtfx,5Gyp41oLVo7Gg7vF4vpmggWP5MU70QO6,29,84,47,13,20,24,22,1,211,30.142857142857142,10,0.0,21,47,8,20,63,24,5,22,1,96,115,1
4339,113094,zWyTWw9gp1aZ16WI7RPlDJzhTqGyXOcs,5Gyp41oLVo7Gg7vF4vpmggWP5MU70QO6,1,0,0,0,0,0,1,0,1,0.14285714285714285,1,0.0,0,0,0,0,0,0,0,1,0,0,1,1
4340,113104,FoiV6QUkVyZ8Sum7ovbYTbVuBO8X2ug8,5Gyp41oLVo7Gg7vF4vpmggWP5MU70QO6,19,50,22,10,11,0,14,0,107,15.285714285714286,4,0.0,8,22,5,11,42,0,5,14,0,46,61,0
4341,113191,Yr8wrZqxEJ6OVVfg3BfRt9Ybql4kj7Nn,5Gyp41oLVo7Gg7vF4vpmggWP5MU70QO6,5,3,2,0,0,0,2,0,7,1.0,1,0.0,0,2,0,0,3,0,0,2,0,2,5,1
4342,113200,kdvuBg0k4a0KCHoHiVrFpxzbEWbfFWlX,5Gyp41oLVo7Gg7vF4vpmggWP5MU70QO6,8,9,0,0,0,1,6,1,17,2.4285714285714284,1,0.0,1,0,0,0,8,1,0,6,1,1,16,1
4343,113202,nHLKdpZRS4alloVobYuoUtG1Y3j42RbN,5Gyp41oLVo7Gg7vF4vpmggWP5MU70QO6,8,3,2,0,2,0,3,0,10,1.4285714285714286,1,0.0,0,2,0,2,3,0,0,3,0,4,6,1
4344,113224,YnryKMU5NBkS3Ubsyb9gjAcDZ6iJfgwC,7GRhBDsirIGkRZBtSMEzNTyDr2JQm4xx,6,4,1,0,1,0,2,0,8,1.1428571428571428,1,0.0,1,1,0,1,3,0,0,2,0,3,5,1
4345,113246,W1essmAPC2jEQUEeOrORPOOmMSTDsByt,7GRhBDsirIGkRZBtSMEzNTyDr2JQm4xx,1,0,0,0,0,0,1,0,1,0.14285714285714285,1,0.0,0,0,0,0,0,0,0,1,0,0,1,1
4346,113257,tYXSIW41vEc1ilow8iQ6smCJvAodHkNV,7GRhBDsirIGkRZBtSMEzNTyDr2JQm4xx,3,2,0,0,0,0,2,0,4,0.5714285714285714,1,0.0,0,0,0,0,2,0,0,2,0,0,4,1
4347,113264,LVleI3qgj2oma5ID0p9Vm9qRM8p2ETLg,7GRhBDsirIGkRZBtSMEzNTyDr2JQm4xx,4,3,0,0,0,0,9,0,12,1.7142857142857142,2,0.0,0,0,0,0,3,0,0,9,0,0,12,1
4348,113276,eswvbpHhxCUZC3kUIoEHkNpn6ukXHFpo,7GRhBDsirIGkRZBtSMEzNTyDr2JQm4xx,14,13,5,10,4,0,2,0,34,4.857142857142857,1,0.0,6,5,7,4,7,0,3,2,0,22,12,0
4349,113365,m6EzzQ2Z50XD1FEkDIvr4FKtcZ3nQg48,3VkHkmOtom3jM2wCu94xgzzu1d6Dn7or,6,6,3,0,3,0,1,0,13,1.8571428571428572,1,0.0,0,3,0,3,6,0,0,1,0,6,7,1
4350,113379,CNgm4SAYt7ZcKmIbqzOE4huFdWyuHrBB,3VkHkmOtom3jM2wCu94xgzzu1d6Dn7or,6,7,1,0,1,0,4,0,13,1.8571428571428572,1,0.0,1,1,0,1,6,0,0,4,0,3,10,1
4351,113394,zYTtXhMaGZihyCwsnkPXNLHJNoCwrxEn,3VkHkmOtom3jM2wCu94xgzzu1d6Dn7or,5,4,1,0,1,2,3,0,11,1.5714285714285714,1,0.0,0,1,0,1,4,2,0,3,0,2,9,1
4352,113423,Z8jGpFPgxfYdQ45E2JmscYA650Gt6KRw,3VkHkmOtom3jM2wCu94xgzzu1d6Dn7or,2,0,0,0,0,0,2,0,2,0.2857142857142857,1,0.0,0,0,0,0,0,0,0,2,0,0,2,1
4353,113447,LgRwWVU7f3Uyf9tKge7xmIu4EdMB1jMm,3VkHkmOtom3jM2wCu94xgzzu1d6Dn7or,1,0,0,0,0,0,1,0,1,0.14285714285714285,1,0.0,0,0,0,0,0,0,0,1,0,0,1,1
4354,113499,weW7WCl1PLzcG7QeTcF7nAYRZFxpbb6T,3VkHkmOtom3jM2wCu94xgzzu1d6Dn7or,6,7,3,0,1,0,3,0,14,2.0,1,0.0,0,3,0,1,7,0,0,3,0,4,10,1
4355,113507,xhevg6JjK2rrYOm315OyMAnP1ijNPsHG,3VkHkmOtom3jM2wCu94xgzzu1d6Dn7or,7,3,2,0,2,0,3,0,10,1.4285714285714286,1,0.0,0,2,0,2,3,0,0,3,0,4,6,1
4356,113520,Orqz1MI6CD3UYQA2x7AoJrrzdXuNjXgT,3VkHkmOtom3jM2wCu94xgzzu1d6Dn7or,1,0,0,0,0,0,1,0,1,0.14285714285714285,1,0.0,0,0,0,0,0,0,0,1,0,0,1,1
4357,113678,ZobeGMKyIBgjnUNms43CrtMrVHf6iI1r,3VkHkmOtom3jM2wCu94xgzzu1d6Dn7or,64,114,47,50,46,0,24,5,286,40.857142857142854,5,0.0,32,47,46,46,82,0,4,24,5,171,115,0
4358,113723,fbJQhb9qJhxn4GPcwi4AErVjPsHJbyL7,3VkHkmOtom3jM2wCu94xgzzu1d6Dn7or,41,151,36,17,27,32,48,2,313,44.714285714285715,7,0.0,51,36,15,27,100,32,2,48,2,129,184,0
4359,113735,mBfdJcOP5Q4qScmvhx97yK7EXBtKqSR0,3VkHkmOtom3jM2wCu94xgzzu1d6Dn7or,4,3,0,0,0,0,4,0,7,1.0,1,0.0,0,0,0,0,3,0,0,4,0,0,7,0
4360,113761,IJTTEfs2CTbrV7pMtnuHrqGN5D8K4cmY,3VkHkmOtom3jM2wCu94xgzzu1d6Dn7or,3,3,0,0,0,0,1,0,4,0.5714285714285714,1,0.0,0,0,0,0,3,0,0,1,0,0,4,1
4361,113831,UqksMVZ1lLvn2u7s6dT9SU5OFeNJnaAy,5X6FeZozNMgE2VRi3MJYjkkFK8SETtu2,5,0,0,0,0,0,4,1,5,0.7142857142857143,2,0.0,0,0,0,0,0,0,0,4,1,0,5,0
4362,113891,9d8tCYKPfh5NHPKNlwRKmrZh3Cuf1Ls2,7GRhBDsirIGkRZBtSMEzNTyDr2JQm4xx,3,2,1,0,0,0,1,0,4,0.5714285714285714,1,0.0,0,1,0,0,2,0,0,1,0,1,3,0
4363,113895,YnqMJ9ZetFUbaqSHD6gLHyJT0CEwFNIZ,5X6FeZozNMgE2VRi3MJYjkkFK8SETtu2,62,135,36,61,37,3,31,0,303,43.285714285714285,8,0.0,73,36,53,37,62,3,8,31,0,199,104,1
4364,113921,cQJEH4N9NA86ElT2x4zkE6ToN6rVT4MQ,7GRhBDsirIGkRZBtSMEzNTyDr2JQm4xx,1,0,0,0,0,0,1,0,1,0.14285714285714285,1,0.0,0,0,0,0,0,0,0,1,0,0,1,1
4365,114015,DQbRxk8ac6yWVBibRdJM3Qxn0d1XOiuE,5X6FeZozNMgE2VRi3MJYjkkFK8SETtu2,6,3,1,0,2,0,4,0,10,1.4285714285714286,1,0.0,1,1,0,2,2,0,0,4,0,4,6,1
4366,114122,4Pd3e254V1ylErxapJL6FJZ2vSaLD95s,7GRhBDsirIGkRZBtSMEzNTyDr2JQm4xx,1,0,0,0,0,0,1,0,1,0.14285714285714285,1,0.0,0,0,0,0,0,0,0,1,0,0,1,0
4367,114180,TQ8OFVc2xBKvPKyjEssWVNNgqzlZ0PAa,5X6FeZozNMgE2VRi3MJYjkkFK8SETtu2,26,77,26,80,37,7,12,0,239,34.142857142857146,10,0.0,36,26,67,37,41,7,13,12,0,166,73,1
4368,114269,0x0DTAti5ubTkiTCaiKBYXVEL4Zs1kyR,5X6FeZozNMgE2VRi3MJYjkkFK8SETtu2,1,0,0,0,0,0,1,0,1,0.14285714285714285,1,0.0,0,0,0,0,0,0,0,1,0,0,1,1
4369,114295,54WqxClItaVjByzUIcBLUNfuvPRBRhiZ,5X6FeZozNMgE2VRi3MJYjkkFK8SETtu2,53,69,16,86,30,0,4,0,205,29.285714285714285,3,0.0,50,16,75,30,19,0,11,4,0,171,34,1
4370,114354,nwFT4lnmg30fCvHRB6tbALo9FpcanuLx,5X6FeZozNMgE2VRi3MJYjkkFK8SETtu2,19,74,16,20,25,2,15,0,152,21.714285714285715,6,0.0,35,16,16,25,39,2,4,15,0,92,60,1
4371,114378,kwtDMW6kCF4Dj4cVANDmT2RtqpyiMQZT,5X6FeZozNMgE2VRi3MJYjkkFK8SETtu2,22,83,8,29,21,1,17,16,175,25.0,7,0.0,41,8,26,21,42,1,3,17,16,96,79,1
4372,114393,P1HSpor3v4n3f5MCbT8ojUVfn1um6uI3,5X6FeZozNMgE2VRi3MJYjkkFK8SETtu2,9,7,1,0,1,5,8,1,23,3.2857142857142856,1,0.0,0,1,0,1,7,5,0,8,1,2,21,1
4373,114488,czTQ5ELSy91Dy79vk5MgxZdL9nunJtpb,5X6FeZozNMgE2VRi3MJYjkkFK8SETtu2,4,3,1,0,0,0,2,0,6,0.8571428571428571,1,0.0,0,1,0,0,3,0,0,2,0,1,5,1
4374,114559,KkSinTdG2PbGrJIRATMZos8HES46UawO,7GRhBDsirIGkRZBtSMEzNTyDr2JQm4xx,4,7,2,0,0,0,1,0,10,1.4285714285714286,1,0.0,2,2,0,0,5,0,0,1,0,4,6,0
4375,114615,dADOrE6FAWkIPcnZuLBj5KGmzjdxSunH,fbPkOYLVPtPgIt0MxizjfFJov3JbHyAi,15,21,12,3,8,33,5,1,83,11.857142857142858,3,0.0,5,12,3,8,16,33,0,5,1,28,55,0
4376,114616,VXYzZfu6ih0keHE9HAJ1SdpDOLcLAbwC,fbPkOYLVPtPgIt0MxizjfFJov3JbHyAi,2,0,0,0,0,0,2,0,2,0.2857142857142857,1,0.0,0,0,0,0,0,0,0,2,0,0,2,1
4377,114618,WRvlgY7ph3Ny0jrRnDAZFFFRQZCnVuX6,fbPkOYLVPtPgIt0MxizjfFJov3JbHyAi,1,0,0,0,0,0,1,0,1,0.14285714285714285,1,0.0,0,0,0,0,0,0,0,1,0,0,1,1
4378,114620,6T8cBNKGNp544PxJriaeroN36khQqLPz,fbPkOYLVPtPgIt0MxizjfFJov3JbHyAi,5,5,3,0,0,4,5,0,17,2.4285714285714284,2,0.0,0,3,0,0,5,4,0,5,0,3,14,1
4379,114628,O7KWuxai8l3iLaIsn7RnwycnICMA6q02,fbPkOYLVPtPgIt0MxizjfFJov3JbHyAi,10,7,5,0,4,0,4,0,20,2.857142857142857,1,0.0,0,5,0,4,7,0,0,4,0,9,11,1
4380,114630,7oMr9QCj97jPuJtMryw8HLKHPiNBVkWQ,fbPkOYLVPtPgIt0MxizjfFJov3JbHyAi,2,0,0,0,0,0,2,0,2,0.2857142857142857,1,0.0,0,0,0,0,0,0,0,2,0,0,2,1
4381,114631,317mJtMaUHETA3BjLJPMWdxWMX2D2sbB,fbPkOYLVPtPgIt0MxizjfFJov3JbHyAi,5,3,2,0,2,0,2,0,9,1.2857142857142858,1,0.0,0,2,0,2,3,0,0,2,0,4,5,1
4382,114632,feP8lvUh5Uqyd3T78g3lJHRfKMRKGTdu,fbPkOYLVPtPgIt0MxizjfFJov3JbHyAi,1,0,0,0,0,0,1,0,1,0.14285714285714285,1,0.0,0,0,0,0,0,0,0,1,0,0,1,1
4383,114636,5bxFzsGB3g2DhCNnlfoVA3bbijRi2jwN,fbPkOYLVPtPgIt0MxizjfFJov3JbHyAi,1,0,0,0,0,0,1,0,1,0.14285714285714285,1,0.0,0,0,0,0,0,0,0,1,0,0,1,1
4384,114641,dYC6Q6IXtOHRHCawBvKivQeuFVOWFZ5M,fbPkOYLVPtPgIt0MxizjfFJov3JbHyAi,1,0,0,0,0,0,1,0,1,0.14285714285714285,1,0.0,0,0,0,0,0,0,0,1,0,0,1,1
4385,114644,AtNMPzFEYACRMN0iwn9jbY3jXKyaOANn,fbPkOYLVPtPgIt0MxizjfFJov3JbHyAi,4,2,1,0,1,0,1,0,5,0.7142857142857143,1,0.0,0,1,0,1,2,0,0,1,0,2,3,1
4386,114646,80y9S8r32w7HjdSrNUEAoEBMUZWJtxmp,fbPkOYLVPtPgIt0MxizjfFJov3JbHyAi,1,0,0,0,0,0,1,0,1,0.14285714285714285,1,0.0,0,0,0,0,0,0,0,1,0,0,1,1
4387,114648,aqQTf2fLQrJTXefctm75awHMgV3chcLI,fbPkOYLVPtPgIt0MxizjfFJov3JbHyAi,4,2,1,0,0,4,2,0,9,1.2857142857142858,1,0.0,0,1,0,0,2,4,0,2,0,1,8,1
4388,114650,A8VDs8qMXoWf6TAFhFdXwBPwA0se80p0,fbPkOYLVPtPgIt0MxizjfFJov3JbHyAi,1,0,0,0,0,0,1,0,1,0.14285714285714285,1,0.0,0,0,0,0,0,0,0,1,0,0,1,1
4389,114653,a1rKHMbdvsiqyl2QdJJHwGTEOUsJeY1Z,fbPkOYLVPtPgIt0MxizjfFJov3JbHyAi,2,1,0,0,0,0,1,0,2,0.2857142857142857,1,0.0,0,0,0,0,1,0,0,1,0,0,2,1
4390,115137,1G63i1rmcnlHIJV8rQ5ZsMc8KSeXw42F,3VkHkmOtom3jM2wCu94xgzzu1d6Dn7or,29,124,51,16,28,33,20,0,272,38.857142857142854,6,0.0,41,51,14,28,83,33,2,20,0,134,138,1
4391,115138,YmdgsFslyipuqAvTNMUf5cKIo7lT9UI2,3VkHkmOtom3jM2wCu94xgzzu1d6Dn7or,6,7,3,0,2,0,7,0,19,2.7142857142857144,3,0.0,0,3,0,2,7,0,0,7,0,5,14,1
4392,115179,hT4tvsNw0lrlCX10WGvFW9mAmG3Fy4KO,3VkHkmOtom3jM2wCu94xgzzu1d6Dn7or,98,423,133,93,116,68,97,4,934,133.42857142857142,4,0.0,214,133,85,116,209,68,8,97,4,548,386,0
4393,115180,9teXZYkWVKqsq9cOvq45UGbDxrVqLaJM,3VkHkmOtom3jM2wCu94xgzzu1d6Dn7or,61,62,49,0,35,0,7,0,153,21.857142857142858,9,0.0,0,49,0,35,62,0,0,7,0,84,69,0
4394,115191,EZXIuLhOmjJIkshWdkSFxHC0xu6JDJcs,3VkHkmOtom3jM2wCu94xgzzu1d6Dn7or,64,134,56,36,52,37,15,1,331,47.285714285714285,9,0.0,63,56,33,52,71,37,3,15,1,204,127,0
4395,115301,0IAqLIVHc4D35uepZBxo4kkDcvat0q2X,3VkHkmOtom3jM2wCu94xgzzu1d6Dn7or,4,2,1,0,1,0,2,0,6,0.8571428571428571,1,0.0,0,1,0,1,2,0,0,2,0,2,4,0
4396,115324,XWGGygjalWfSSQzM8onkLHgnl96JFwDh,3VkHkmOtom3jM2wCu94xgzzu1d6Dn7or,57,81,3,21,41,0,6,0,152,21.714285714285715,2,0.0,29,3,18,41,52,0,3,6,0,91,61,1
4397,115418,8xcJse8MxIDPfdJXCHPrDNIK3GBUm9K8,3VkHkmOtom3jM2wCu94xgzzu1d6Dn7or,41,166,41,80,1,23,5,0,316,45.142857142857146,3,0.0,111,41,77,1,55,23,3,5,0,230,86,0
4398,115431,1Km02lmAiH8fmuk2UTlG1rnEWgsc67HL,3VkHkmOtom3jM2wCu94xgzzu1d6Dn7or,80,266,55,80,98,24,73,5,601,85.85714285714286,8,0.0,186,55,70,98,80,24,10,73,5,409,192,0
4399,115438,sTZs64XdymONYItS9gEdLuGM3ZO9ZhgW,3VkHkmOtom3jM2wCu94xgzzu1d6Dn7or,1,0,0,0,0,0,1,0,1,0.14285714285714285,1,0.0,0,0,0,0,0,0,0,1,0,0,1,0
4400,115441,mSXZKJ9e3RCTXopgrFUphpxYgeKp7tlG,3VkHkmOtom3jM2wCu94xgzzu1d6Dn7or,80,282,100,58,102,113,26,2,683,97.57142857142857,16,0.0,169,100,55,102,113,113,3,26,2,426,257,0
4401,115483,XlsotxACWnN0EqQWLUCPLI9pWBNgMgk1,3VkHkmOtom3jM2wCu94xgzzu1d6Dn7or,5,2,1,0,1,0,2,0,6,0.8571428571428571,1,0.0,0,1,0,1,2,0,0,2,0,2,4,1
4402,115564,Qjlt412VdjQrw004zXTfHyzbH6lTyzfQ,3VkHkmOtom3jM2wCu94xgzzu1d6Dn7or,10,9,5,0,5,0,7,0,26,3.7142857142857144,2,0.0,2,5,0,5,7,0,0,7,0,12,14,1
4403,115576,VPiBb86kd8BKC2TOTvwUFu9fx4vzCW4b,3VkHkmOtom3jM2wCu94xgzzu1d6Dn7or,80,176,48,111,36,20,31,5,427,61.0,11,0.0,66,48,103,36,110,20,8,31,5,253,174,0
4404,115609,NRvPF6FnE2qOoEKQlwRiAGDiz3Y2mfqX,3VkHkmOtom3jM2wCu94xgzzu1d6Dn7or,1,0,0,0,0,0,1,0,1,0.14285714285714285,1,0.0,0,0,0,0,0,0,0,1,0,0,1,1
4405,115619,CwyOL3RMOVLomxrxyN9D4jPa9R0iWrS5,3VkHkmOtom3jM2wCu94xgzzu1d6Dn7or,27,36,14,18,13,4,4,0,89,12.714285714285714,4,0.0,12,14,18,13,24,4,0,4,0,57,32,1
4406,115640,FhJZaEAvbnhYhzwxfd8m2nbSjrU4ykT8,3VkHkmOtom3jM2wCu94xgzzu1d6Dn7or,3,3,0,0,0,0,2,0,5,0.7142857142857143,1,0.0,0,0,0,0,3,0,0,2,0,0,5,1
4407,115683,aNJE1B7Om5LHj59YkXIa7Cp0ZqypQHhy,3VkHkmOtom3jM2wCu94xgzzu1d6Dn7or,31,58,27,30,13,4,14,0,146,20.857142857142858,9,0.0,9,27,23,13,49,4,7,14,0,72,74,0
4408,115706,uiGnKayGz8iGWXIMLQgmlJFJNvbGDTb9,3VkHkmOtom3jM2wCu94xgzzu1d6Dn7or,12,29,5,0,6,3,17,6,66,9.428571428571429,2,0.0,8,5,0,6,21,3,0,17,6,19,47,1
4409,115721,YUpIUaEv1EetQGMxsyjuTsiOSj9Pere8,3VkHkmOtom3jM2wCu94xgzzu1d6Dn7or,23,33,10,35,12,3,1,0,94,13.428571428571429,2,0.0,14,10,32,12,19,3,3,1,0,68,26,0
4410,115737,O2rUq90V5lR36PY1lXYAoUFT98vBmg1w,3VkHkmOtom3jM2wCu94xgzzu1d6Dn7or,78,208,54,53,71,48,16,1,451,64.42857142857143,11,0.0,87,54,48,71,121,48,5,16,1,260,191,0
4411,115748,Paf36JLTqfFno9Z8aWVtTee4y7179HfB,3VkHkmOtom3jM2wCu94xgzzu1d6Dn7or,26,73,32,4,22,0,7,0,138,19.714285714285715,2,0.0,3,32,3,22,70,0,1,7,0,60,78,1
4412,115779,EfhdW5rf6OZIEnzvBZeQWc7g2MskX2ds,3VkHkmOtom3jM2wCu94xgzzu1d6Dn7or,66,196,53,92,54,35,59,4,493,70.42857142857143,7,0.0,81,53,81,54,115,35,11,59,4,269,224,0
4413,115823,eV3NFjg3yWzKzkccXHxTnI0xouXOD2PQ,3VkHkmOtom3jM2wCu94xgzzu1d6Dn7or,13,20,6,6,8,4,12,1,57,8.142857142857142,1,0.0,12,6,5,8,8,4,1,12,1,31,26,1
4414,115838,VXnVR97kFloTTSU2ST7pLjCQ8tjcq63x,3VkHkmOtom3jM2wCu94xgzzu1d6Dn7or,59,99,45,28,47,23,7,0,249,35.57142857142857,9,0.0,41,45,27,47,58,23,1,7,0,160,89,0
4415,115867,BYQK3CvpfMxBRtirOERpPoB3xPzRoJk5,3VkHkmOtom3jM2wCu94xgzzu1d6Dn7or,91,201,74,61,73,65,19,0,493,70.42857142857143,5,0.0,98,74,51,73,103,65,10,19,0,296,197,0
4416,115970,eOYLxzCLLArdp3PTRMGdBtm1GUxdjDCw,3VkHkmOtom3jM2wCu94xgzzu1d6Dn7or,27,53,11,34,16,11,8,2,135,19.285714285714285,4,0.0,29,11,31,16,24,11,3,8,2,87,48,1
4417,115991,HABID5qfypKIwrRHvQPznrk9KmB4tWzT,3VkHkmOtom3jM2wCu94xgzzu1d6Dn7or,1,0,0,0,0,0,1,0,1,0.14285714285714285,1,0.0,0,0,0,0,0,0,0,1,0,0,1,1
4418,116029,T2XDhi3FWMYFAUuE0zIbikEnIxiJs2MQ,3VkHkmOtom3jM2wCu94xgzzu1d6Dn7or,4,2,0,0,0,0,3,0,5,0.7142857142857143,1,0.0,0,0,0,0,2,0,0,3,0,0,5,1
4419,116068,3dbaC3sJ9OJS1pU4dFxDkqiRGQ9yQgLt,3VkHkmOtom3jM2wCu94xgzzu1d6Dn7or,3,0,0,0,0,0,4,0,4,0.5714285714285714,1,0.0,0,0,0,0,0,0,0,4,0,0,4,1
4420,116154,bDqqR2hng29QNjexgLbMGRH4AJBfyli8,3VkHkmOtom3jM2wCu94xgzzu1d6Dn7or,19,43,20,0,9,9,12,0,93,13.285714285714286,5,0.0,2,20,0,9,41,9,0,12,0,31,62,1
4421,116193,Oa3Yn1JDw25rNnHn2BNCxgiCAj54mdbE,3VkHkmOtom3jM2wCu94xgzzu1d6Dn7or,64,369,72,106,80,17,41,2,687,98.14285714285714,11,0.0,165,72,99,80,204,17,7,41,2,416,271,0
4422,116212,iFP56GVsRn7PQgdfzS2a7d6uFo1EOk1i,3VkHkmOtom3jM2wCu94xgzzu1d6Dn7or,6,9,4,0,0,0,4,0,17,2.4285714285714284,2,0.0,0,4,0,0,9,0,0,4,0,4,13,1
4423,116215,3u2Og5WE9UAxrPpxqe06PZzIgysDZEr7,3VkHkmOtom3jM2wCu94xgzzu1d6Dn7or,5,2,1,0,1,0,3,0,7,1.0,1,0.0,0,1,0,1,2,0,0,3,0,2,5,0
4424,116272,Dv4nP0an2ZA48lmeMFn0PJPZ7mStVpc5,3VkHkmOtom3jM2wCu94xgzzu1d6Dn7or,13,156,7,6,7,6,17,0,199,28.428571428571427,3,0.0,27,7,5,7,129,6,1,17,0,46,153,1
4425,116321,mLWHIw1cHfgiEyo587m6rHem7nmVE3z4,3VkHkmOtom3jM2wCu94xgzzu1d6Dn7or,1,0,0,0,0,0,1,0,1,0.14285714285714285,1,0.0,0,0,0,0,0,0,0,1,0,0,1,1
4426,116351,4SEsrW6tKoIcrFOcEbAzlYSxkxqTdzcN,3VkHkmOtom3jM2wCu94xgzzu1d6Dn7or,2,0,0,0,0,0,2,0,2,0.2857142857142857,1,0.0,0,0,0,0,0,0,0,2,0,0,2,1
4427,116383,saxxTKR6QFum7HyMG9cYa0rXhe5D7UPC,3VkHkmOtom3jM2wCu94xgzzu1d6Dn7or,90,132,63,65,54,42,27,0,383,54.714285714285715,11,0.0,50,63,55,54,82,42,10,27,0,222,161,0
4428,116400,5sovUdBY4AsVUtXY7BWDVXxvHAPsWkZb,5Gyp41oLVo7Gg7vF4vpmggWP5MU70QO6,71,373,153,15,154,80,46,26,847,121.0,24,0.0,118,153,13,154,255,80,2,46,26,438,409,0
4429,116436,meJV5qRzmJA836PpWZKeoFo4ZX1xiQOS,5Gyp41oLVo7Gg7vF4vpmggWP5MU70QO6,8,7,5,0,2,0,2,0,16,2.2857142857142856,1,0.0,0,5,0,2,7,0,0,2,0,7,9,1
4430,116439,dR89kP4g2lR7wOxYCeRjTvTMOhrAu7It,5Gyp41oLVo7Gg7vF4vpmggWP5MU70QO6,7,4,2,0,3,0,2,0,11,1.5714285714285714,1,0.0,1,2,0,3,3,0,0,2,0,6,5,1
4431,116466,483NgTD1fHdeYX0RRzoyedDRsQpewqQG,5Gyp41oLVo7Gg7vF4vpmggWP5MU70QO6,21,32,15,0,8,0,3,0,58,8.285714285714286,2,0.0,2,15,0,8,30,0,0,3,0,25,33,1
4432,116487,bA4tnPZD0UU4XAL3OkL7nUjtkAzbgj9d,5Gyp41oLVo7Gg7vF4vpmggWP5MU70QO6,30,116,54,21,14,54,25,3,287,41.0,10,0.0,16,54,16,14,100,54,5,25,3,100,187,0
4433,116502,MLRJZ97UMA5raZKCNrieCiIqteBWSZH0,5Gyp41oLVo7Gg7vF4vpmggWP5MU70QO6,43,194,117,48,2,150,63,2,576,82.28571428571429,13,0.0,43,117,33,2,151,150,15,63,2,195,381,0
4434,116546,3CARVzZPaLSVsfLijIwBvqCibG90zhz6,5Gyp41oLVo7Gg7vF4vpmggWP5MU70QO6,8,5,3,2,2,0,2,0,14,2.0,1,0.0,1,3,1,2,4,0,1,2,0,7,7,1
4435,116550,UvYdE00Z5Ts8a6wK0WxKxxpGT2cAkrRh,5Gyp41oLVo7Gg7vF4vpmggWP5MU70QO6,25,40,16,8,8,51,14,2,139,19.857142857142858,4,0.0,8,16,4,8,32,51,4,14,2,36,103,0
4436,116624,5NDfsjI0ns1nf5WPi1FEheeMhNgCZqVH,5Gyp41oLVo7Gg7vF4vpmggWP5MU70QO6,27,73,26,25,21,16,17,1,179,25.571428571428573,8,0.0,30,26,18,21,43,16,7,17,1,95,84,1
4437,116640,Oyq7ji1m15xuxwPKjm7Gg05YiNCQEcyW,5Gyp41oLVo7Gg7vF4vpmggWP5MU70QO6,4,0,0,0,0,1,5,1,7,1.0,1,0.0,0,0,0,0,0,1,0,5,1,0,7,1
4438,116650,vQKXRGJivHAUfIMdau8F2EHQ9nob0SwQ,5Gyp41oLVo7Gg7vF4vpmggWP5MU70QO6,45,99,54,34,45,12,22,3,269,38.42857142857143,9,0.0,27,54,24,45,72,12,10,22,3,150,119,0
4439,116658,AH1MK3fQ3KuM7ZbwzZD8njF9VCSnOi9t,5Gyp41oLVo7Gg7vF4vpmggWP5MU70QO6,14,31,4,10,3,0,14,0,62,8.857142857142858,7,0.0,7,4,5,3,24,0,5,14,0,19,43,1
4440,116681,vBH0dHu4NmOj62y1ASafcuCscurKeDfE,5Gyp41oLVo7Gg7vF4vpmggWP5MU70QO6,33,80,39,39,14,75,14,0,261,37.285714285714285,5,0.0,28,39,32,14,52,75,7,14,0,113,148,1
4441,116697,Xf3PIvz3E8e2IZNJkOjmWhieMgnywNfX,5Gyp41oLVo7Gg7vF4vpmggWP5MU70QO6,25,21,16,1,12,0,3,0,53,7.571428571428571,2,0.0,1,16,1,12,20,0,0,3,0,30,23,1
4442,116708,OMEL4ay2FeLAUvBpF5PNfopRFoBTNYW8,5Gyp41oLVo7Gg7vF4vpmggWP5MU70QO6,12,22,11,4,4,0,7,0,48,6.857142857142857,6,0.0,4,11,3,4,18,0,1,7,0,22,26,1
4443,116760,hHbNJAgP7w8fISF0lwfjdp2aDNUBCyTs,5Gyp41oLVo7Gg7vF4vpmggWP5MU70QO6,2,0,0,0,0,0,2,0,2,0.2857142857142857,1,0.0,0,0,0,0,0,0,0,2,0,0,2,1
4444,116761,nmayyB5ucLchK32WlUH7RISaNWZAn8KC,5Gyp41oLVo7Gg7vF4vpmggWP5MU70QO6,1,0,0,0,0,0,1,0,1,0.14285714285714285,1,0.0,0,0,0,0,0,0,0,1,0,0,1,1
4445,116784,Pd5WM2e1UwTG0cR5DN1ccdVCJHomBlo2,5Gyp41oLVo7Gg7vF4vpmggWP5MU70QO6,34,41,29,2,16,8,16,1,113,16.142857142857142,2,0.0,2,29,1,16,39,8,1,16,1,48,65,0
4446,116795,eycoCMbNIztwvmFtziuM2ej6f7vevrZP,5Gyp41oLVo7Gg7vF4vpmggWP5MU70QO6,5,2,1,0,0,1,7,0,11,1.5714285714285714,2,0.0,1,1,0,0,1,1,0,7,0,2,9,1
4447,116834,OL27ZbeV6MemgtkLCwIDxu0rN9mfmCXH,5Gyp41oLVo7Gg7vF4vpmggWP5MU70QO6,1,0,0,0,0,0,1,0,1,0.14285714285714285,1,0.0,0,0,0,0,0,0,0,1,0,0,1,1
4448,116889,ilR9m4NYW0HKmYwgUbfrj7K8hPSHt8Dc,5Gyp41oLVo7Gg7vF4vpmggWP5MU70QO6,8,2,2,0,2,0,3,0,9,1.2857142857142858,1,0.0,0,2,0,2,2,0,0,3,0,4,5,1
4449,116933,SEGJwH5xjhu0GixnmBSSBGNuHPRYimOx,5Gyp41oLVo7Gg7vF4vpmggWP5MU70QO6,8,5,3,0,2,1,4,0,15,2.142857142857143,1,0.0,0,3,0,2,5,1,0,4,0,5,10,1
4450,116941,HABID5qfypKIwrRHvQPznrk9KmB4tWzT,5Gyp41oLVo7Gg7vF4vpmggWP5MU70QO6,10,6,3,0,2,0,5,1,17,2.4285714285714284,1,0.0,0,3,0,2,6,0,0,5,1,5,12,1
4451,116975,wTIGY3h7ssyDLNCDE3vIDjb84Wc0yl9L,5Gyp41oLVo7Gg7vF4vpmggWP5MU70QO6,19,22,11,2,8,1,6,1,51,7.285714285714286,1,0.0,9,11,1,8,13,1,1,6,1,29,22,1
4452,117002,oQx9Zi5ZyJMy0WMeLPYZjVccicVMhybt,5Gyp41oLVo7Gg7vF4vpmggWP5MU70QO6,1,0,0,0,0,0,1,0,1,0.14285714285714285,1,0.0,0,0,0,0,0,0,0,1,0,0,1,1
4453,117031,VRMac2IvvU9u3ZghC4UbOnKHM3J0I59c,5Gyp41oLVo7Gg7vF4vpmggWP5MU70QO6,6,3,2,0,2,0,1,0,8,1.1428571428571428,1,0.0,0,2,0,2,3,0,0,1,0,4,4,1
4454,117048,CWyQorKTdtJysACpC8OcqJBGDDmfcHTs,5Gyp41oLVo7Gg7vF4vpmggWP5MU70QO6,5,1,1,0,1,0,4,0,7,1.0,2,0.0,0,1,0,1,1,0,0,4,0,2,5,1
4455,117058,rfMb2j9N61xL4Y9I6C9nq7Nuc9rZsyAs,5Gyp41oLVo7Gg7vF4vpmggWP5MU70QO6,1,0,0,0,0,0,1,0,1,0.14285714285714285,1,0.0,0,0,0,0,0,0,0,1,0,0,1,1
4456,117078,sZ57TkysruoepeISYxmD5U3y7MWrY3Ss,5Gyp41oLVo7Gg7vF4vpmggWP5MU70QO6,6,1,1,0,1,1,4,0,8,1.1428571428571428,1,0.0,0,1,0,1,1,1,0,4,0,2,6,1
4457,117091,mXfwwTIVjHMqoVKAh2iEQbinKUCJHwTp,5Gyp41oLVo7Gg7vF4vpmggWP5MU70QO6,1,0,0,0,0,0,1,0,1,0.14285714285714285,1,0.0,0,0,0,0,0,0,0,1,0,0,1,1
4458,117111,ZKnlTaI7EAEevi7EMFgsiNYoZ62ldh8s,5Gyp41oLVo7Gg7vF4vpmggWP5MU70QO6,1,0,0,0,0,0,1,0,1,0.14285714285714285,1,0.0,0,0,0,0,0,0,0,1,0,0,1,1
4459,117130,SqXBoMVuJsxifEXIMI5YCscwwBFsTdU6,5Gyp41oLVo7Gg7vF4vpmggWP5MU70QO6,13,18,10,0,7,18,10,1,64,9.142857142857142,2,0.0,3,10,0,7,15,18,0,10,1,20,44,0
4460,117171,OaWKTG9fuUF2LaWt7IOwHUelI2GpkfJy,5Gyp41oLVo7Gg7vF4vpmggWP5MU70QO6,8,3,2,0,2,0,3,0,10,1.4285714285714286,1,0.0,0,2,0,2,3,0,0,3,0,4,6,1
4461,117190,8ZhJb3ZljNgrst8iUlAX82OG7V6bYnBq,5Gyp41oLVo7Gg7vF4vpmggWP5MU70QO6,9,10,6,0,3,0,3,0,22,3.142857142857143,2,0.0,0,6,0,3,10,0,0,3,0,9,13,1
4462,117195,BPLTF2By1jayxHugVACT0ruRLIH96sul,5Gyp41oLVo7Gg7vF4vpmggWP5MU70QO6,8,15,8,0,2,0,7,0,32,4.571428571428571,7,0.0,0,8,0,2,15,0,0,7,0,10,22,1
4463,117223,rxiyxsAAzCJUopsa649NtjV0kC762juL,5Gyp41oLVo7Gg7vF4vpmggWP5MU70QO6,15,16,7,4,2,11,8,1,49,7.0,2,0.0,7,7,2,2,9,11,2,8,1,18,31,1
4464,117235,u8Y97sSr2xWs294k9cdsB9u79pU8RMWs,5Gyp41oLVo7Gg7vF4vpmggWP5MU70QO6,1,0,0,0,0,0,1,0,1,0.14285714285714285,1,0.0,0,0,0,0,0,0,0,1,0,0,1,1
4465,117237,bzlTCtIUcO5BfACSIQwT3PRYSdK0QGTr,5Gyp41oLVo7Gg7vF4vpmggWP5MU70QO6,44,54,21,26,19,8,22,6,156,22.285714285714285,6,0.0,20,21,18,19,34,8,8,22,6,78,78,0
4466,117251,sk2v7bNpQgoO2yTSiMdsEtRjibjjXdbF,5Gyp41oLVo7Gg7vF4vpmggWP5MU70QO6,5,2,1,0,1,0,2,0,6,0.8571428571428571,1,0.0,0,1,0,1,2,0,0,2,0,2,4,1
4467,117252,DmtYVZArE2EvS9aiKUqKSMgZGIBgO1QS,5Gyp41oLVo7Gg7vF4vpmggWP5MU70QO6,23,27,13,8,8,1,8,1,66,9.428571428571429,3,0.0,6,13,4,8,21,1,4,8,1,31,35,0
4468,117287,ubm3uzS9QRP12uex4omSne4jYySpi1vE,5Gyp41oLVo7Gg7vF4vpmggWP5MU70QO6,6,3,1,0,1,0,5,0,10,1.4285714285714286,1,0.0,0,1,0,1,3,0,0,5,0,2,8,1
4469,117323,aNJE1B7Om5LHj59YkXIa7Cp0ZqypQHhy,5Gyp41oLVo7Gg7vF4vpmggWP5MU70QO6,9,9,5,0,3,0,7,0,24,3.4285714285714284,2,0.0,1,5,0,3,8,0,0,7,0,9,15,1
4470,117327,5dwhOYeq6DRSGIBZohMlMunxrKsjka7v,5Gyp41oLVo7Gg7vF4vpmggWP5MU70QO6,2,0,0,0,0,0,2,0,2,0.2857142857142857,1,0.0,0,0,0,0,0,0,0,2,0,0,2,1
4471,117370,3JEt0I9b0JhZhM0RD2D5jI5S8zjjeHFo,fbPkOYLVPtPgIt0MxizjfFJov3JbHyAi,4,2,1,0,0,0,2,0,5,0.7142857142857143,1,0.0,0,1,0,0,2,0,0,2,0,1,4,0
4472,117476,RwvuGEh3euIR11rktJrGBhzDqcQMkhOC,fbPkOYLVPtPgIt0MxizjfFJov3JbHyAi,3,4,2,0,0,0,2,0,8,1.1428571428571428,1,0.0,0,2,0,0,4,0,0,2,0,2,6,1
4473,117504,7nfwj1I7hYBfuxm4jUuStM2n17LzzRmj,SpATywNh6bZuzm8s1ceuBUnMUAeoAHHw,31,31,26,12,23,15,23,0,130,18.571428571428573,3,0.0,4,26,12,23,27,15,0,23,0,65,65,0
4474,117521,LU9kxt8aKnlOn8SnA2EuX2MLajf5Sg2a,5X6FeZozNMgE2VRi3MJYjkkFK8SETtu2,38,64,18,0,32,0,12,0,126,18.0,8,0.0,36,18,0,32,28,0,0,12,0,86,40,0
4475,117567,KlEAwfTXNSli6vdNdYlm5CYknLkxK1Br,SpATywNh6bZuzm8s1ceuBUnMUAeoAHHw,19,19,15,12,5,0,2,0,53,7.571428571428571,1,0.0,2,15,12,5,17,0,0,2,0,34,19,0
4476,117568,VK6VYsFJEy8hhWdKq52KmrJkO3b6jNbn,A3fsA9Zfv1X2fVEQhTw51lKENdNrEqT3,8,4,2,0,0,0,9,1,16,2.2857142857142856,1,0.0,0,2,0,0,4,0,0,9,1,2,14,0
4477,117589,GW3u4KgPsgAWkRER2WW6Fgp0OqlMuGFL,5X6FeZozNMgE2VRi3MJYjkkFK8SETtu2,11,9,1,12,3,0,2,0,27,3.857142857142857,1,0.0,7,1,11,3,2,0,1,2,0,22,5,1
4478,117609,hyhyxhn6qO7nii28PZygBx2DF5Qsnp6b,SpATywNh6bZuzm8s1ceuBUnMUAeoAHHw,11,9,7,0,5,0,2,0,23,3.2857142857142856,2,0.0,0,7,0,5,9,0,0,2,0,12,11,1
4479,117613,VEmnuZOsoHSPcS4ojGYL7wyh1ioGqsGt,SpATywNh6bZuzm8s1ceuBUnMUAeoAHHw,24,31,11,11,8,0,4,0,65,9.285714285714286,2,0.0,2,11,11,8,29,0,0,4,0,32,33,0
4480,117615,NdhfP9LezOw47EKstFkVNQYaCX8DmoQI,SpATywNh6bZuzm8s1ceuBUnMUAeoAHHw,26,56,4,31,1,0,13,0,105,15.0,7,0.0,10,4,27,1,46,0,4,13,0,42,63,0
4481,117655,MkluYfJDefHhcRPY3QsRGiWxg2BDcm18,SpATywNh6bZuzm8s1ceuBUnMUAeoAHHw,14,21,0,9,0,0,2,0,32,4.571428571428571,1,0.0,8,0,8,0,13,0,1,2,0,16,16,0
4482,117671,LvmRr9NACuniPuboiWpXG15NCOEyIfpb,SpATywNh6bZuzm8s1ceuBUnMUAeoAHHw,17,38,18,25,0,0,11,1,93,13.285714285714286,3,0.0,14,18,21,0,24,0,4,11,1,53,40,0
4483,117672,NdhfP9LezOw47EKstFkVNQYaCX8DmoQI,RXDvfPUBYFlVdlueBFbLW0mhhAyGEqpt,28,45,23,63,10,36,8,0,185,26.428571428571427,5,0.0,4,23,54,10,41,36,9,8,0,91,94,0
4484,117675,l64zD2DC6Q6fZRqMhhM1r4HOjVM4BOX7,SpATywNh6bZuzm8s1ceuBUnMUAeoAHHw,15,19,2,14,1,0,3,0,39,5.571428571428571,3,0.0,2,2,12,1,17,0,2,3,0,17,22,0
4485,117679,VE9HD5yzeCmqc2pNGfTQWsVbRdaqJBIV,SpATywNh6bZuzm8s1ceuBUnMUAeoAHHw,15,19,10,0,6,6,2,0,43,6.142857142857143,1,0.0,0,10,0,6,19,6,0,2,0,16,27,0
4486,117701,VgmFAu9L9uoZcxRAsErY5yMnCkdw48U0,SpATywNh6bZuzm8s1ceuBUnMUAeoAHHw,8,2,2,0,2,0,6,0,12,1.7142857142857142,2,0.0,0,2,0,2,2,0,0,6,0,4,8,0
4487,117723,B1Gq6e77yv7kkDqJ7SH2TygdPDzPBwQh,RXDvfPUBYFlVdlueBFbLW0mhhAyGEqpt,37,85,40,58,25,29,0,0,237,33.857142857142854,6,0.0,12,40,52,25,73,29,6,0,0,129,108,0
4488,117725,HPir8NcsI5RSXTzlx3oC2YqcMhZG1iu7,bWdj2GDclj5ofokWjzoa5jAwMkxCykd6,5,4,1,0,1,0,3,0,9,1.2857142857142858,1,0.0,0,1,0,1,4,0,0,3,0,2,7,0
4489,117734,cQJEH4N9NA86ElT2x4zkE6ToN6rVT4MQ,bWdj2GDclj5ofokWjzoa5jAwMkxCykd6,2,1,1,0,0,0,0,0,2,0.2857142857142857,1,0.0,0,1,0,0,1,0,0,0,0,1,1,0
4490,117742,FhtwGNNoWtYYBXhYRu77jAPRU1UPxpBL,SpATywNh6bZuzm8s1ceuBUnMUAeoAHHw,3,6,3,0,0,0,3,0,12,1.7142857142857142,3,0.0,0,3,0,0,6,0,0,3,0,3,9,0
4491,117774,jFYWygr5nLqLhHkXltZRkT0S1zQoLEVR,A3fsA9Zfv1X2fVEQhTw51lKENdNrEqT3,61,37,21,192,12,0,8,0,270,38.57142857142857,4,0.0,6,21,164,12,31,0,28,8,0,203,67,0
4492,117791,efPQEaUnbKTGcoOM9khi0sSrVhfE9TxE,bWdj2GDclj5ofokWjzoa5jAwMkxCykd6,3,2,1,0,0,0,1,0,4,0.5714285714285714,1,0.0,0,1,0,0,2,0,0,1,0,1,3,1
4493,117800,RJv5TI20pjqK3VtKSctdVBLm65ceGNPu,SpATywNh6bZuzm8s1ceuBUnMUAeoAHHw,36,45,28,40,12,10,11,1,147,21.0,7,0.0,8,28,37,12,37,10,3,11,1,85,62,0
4494,117842,68jxA2PUjT1NQfZbUcdmPfGR0u6r2zeM,5X6FeZozNMgE2VRi3MJYjkkFK8SETtu2,36,83,32,44,14,0,29,0,202,28.857142857142858,15,0.0,26,32,41,14,57,0,3,29,0,113,89,0
4495,117935,1R1zO9aMB7Mx1Lw84JzsChVEV5JpwmZv,SpATywNh6bZuzm8s1ceuBUnMUAeoAHHw,19,43,7,16,4,0,15,0,85,12.142857142857142,5,0.0,5,7,13,4,38,0,3,15,0,29,56,0
4496,118040,Eemq3hk1Q3P1Pw1UumR7jNQlYsAdhi76,SpATywNh6bZuzm8s1ceuBUnMUAeoAHHw,30,30,16,28,6,10,11,3,104,14.857142857142858,3,0.0,8,16,25,6,22,10,3,11,3,55,49,1
4497,118115,QXyZtQTzdxqnHSXK4hpAwUSj9MimJfEp,SpATywNh6bZuzm8s1ceuBUnMUAeoAHHw,17,17,12,16,6,0,3,0,54,7.714285714285714,1,0.0,2,12,13,6,15,0,3,3,0,33,21,0
4498,118118,l3b9HlsGDQW9AY17jLNuKVLgfuE5tsF4,SpATywNh6bZuzm8s1ceuBUnMUAeoAHHw,22,40,7,32,0,1,4,0,84,12.0,4,0.0,18,7,26,0,22,1,6,4,0,51,33,0
4499,118258,5rpYxIaCTDb4PhszkJWpACOx5VMpNGcQ,SpATywNh6bZuzm8s1ceuBUnMUAeoAHHw,19,14,8,11,5,5,2,0,45,6.428571428571429,1,0.0,5,8,10,5,9,5,1,2,0,28,17,0
4500,118314,ctfOhdlbQGiOVF89Y090EmsAqQEvSWmz,5X6FeZozNMgE2VRi3MJYjkkFK8SETtu2,1,0,0,0,0,0,1,0,1,0.14285714285714285,1,0.0,0,0,0,0,0,0,0,1,0,0,1,1
4501,118318,7hhGe4WcGEHypOzIVz3DLRx9GS52ozkE,RXDvfPUBYFlVdlueBFbLW0mhhAyGEqpt,6,6,4,0,1,7,3,0,21,3.0,1,0.0,0,4,0,1,6,7,0,3,0,5,16,0
4502,118326,yKuiBw79vz6YoDe6ZvtlnOfjIuGqFl4A,A3fsA9Zfv1X2fVEQhTw51lKENdNrEqT3,5,6,1,0,0,0,1,0,8,1.1428571428571428,1,0.0,0,1,0,0,6,0,0,1,0,1,7,1
4503,118329,vzFJcjAnysUIi1BVDTqBUXqQfeRMIRJD,5X6FeZozNMgE2VRi3MJYjkkFK8SETtu2,6,3,2,0,2,0,2,0,9,1.2857142857142858,1,0.0,0,2,0,2,3,0,0,2,0,4,5,0
4504,118339,cu2czfUbk8fdWWzCcDvTVYWH50Wg3XUq,SpATywNh6bZuzm8s1ceuBUnMUAeoAHHw,14,17,3,18,0,0,4,0,42,6.0,2,0.0,5,3,15,0,12,0,3,4,0,23,19,0
4505,118356,qq2zimIe7yMW71hAccGiqBqEtNw9FUIo,5X6FeZozNMgE2VRi3MJYjkkFK8SETtu2,1,0,0,0,0,0,1,0,1,0.14285714285714285,1,0.0,0,0,0,0,0,0,0,1,0,0,1,1
4506,118387,FlAkKX6ow9SvOzk0dTWPWgnX5766zY29,5X6FeZozNMgE2VRi3MJYjkkFK8SETtu2,14,34,5,13,9,0,3,0,64,9.142857142857142,3,0.0,12,5,13,9,22,0,0,3,0,39,25,1
4507,118393,LVTU4qA4F3wWkxH81iGfu4ZuIt77nyhh,SpATywNh6bZuzm8s1ceuBUnMUAeoAHHw,7,5,1,0,1,0,0,0,7,1.0,1,0.0,0,1,0,1,5,0,0,0,0,2,5,0
4508,118409,m0VKHGN6a79sZImpQa7H4uF4wJYbxAYi,5X6FeZozNMgE2VRi3MJYjkkFK8SETtu2,1,0,0,0,0,0,1,0,1,0.14285714285714285,1,0.0,0,0,0,0,0,0,0,1,0,0,1,1
4509,118412,wxgnNpyHS7Q1morNnvAZvs6kd9hIBHTd,5X6FeZozNMgE2VRi3MJYjkkFK8SETtu2,22,51,0,44,14,10,8,3,130,18.571428571428573,2,0.0,36,0,34,14,15,10,10,8,3,84,46,1
4510,118439,e09uq36QgLuBVK5DERoejsHeMH2uPMRM,5X6FeZozNMgE2VRi3MJYjkkFK8SETtu2,1,0,0,0,0,0,1,0,1,0.14285714285714285,1,0.0,0,0,0,0,0,0,0,1,0,0,1,1
4511,118459,ZMTgNYkbfDsBe4X8ZM8wJYJMTUYSz0bl,5X6FeZozNMgE2VRi3MJYjkkFK8SETtu2,4,3,0,0,0,0,2,0,5,0.7142857142857143,1,0.0,0,0,0,0,3,0,0,2,0,0,5,1
4512,118467,Lu93o5GXoxd6qTdHk7BshqxRhX67SrrE,SpATywNh6bZuzm8s1ceuBUnMUAeoAHHw,4,11,0,0,0,0,1,0,12,1.7142857142857142,1,0.0,0,0,0,0,11,0,0,1,0,0,12,0
4513,118492,zQVzVvuYje8Ojw7BZjrypxHWGjUQol9i,5X6FeZozNMgE2VRi3MJYjkkFK8SETtu2,4,5,2,0,1,0,3,0,11,1.5714285714285714,2,0.0,2,2,0,1,3,0,0,3,0,5,6,1
4514,118514,W3axEfDtpWFQrOsjh1ju6UWJlt7DtE7b,SpATywNh6bZuzm8s1ceuBUnMUAeoAHHw,6,4,0,8,0,0,2,0,14,2.0,1,0.0,1,0,6,0,3,0,2,2,0,7,7,1
4515,118520,JOqHNkiAQMopMtNnxSpHdAOKSp68V43j,5X6FeZozNMgE2VRi3MJYjkkFK8SETtu2,1,0,0,0,0,0,2,0,2,0.2857142857142857,1,0.0,0,0,0,0,0,0,0,2,0,0,2,1
4516,118602,MtBiVqpAnkXdNADfxYcv3MUEyfj2PI07,5X6FeZozNMgE2VRi3MJYjkkFK8SETtu2,1,0,0,0,0,0,1,0,1,0.14285714285714285,1,0.0,0,0,0,0,0,0,0,1,0,0,1,1
4517,118652,eNgDL8k9xOLyBlZ3UNlseJHly8SfPZZu,bWdj2GDclj5ofokWjzoa5jAwMkxCykd6,8,16,12,0,2,7,7,0,44,6.285714285714286,5,0.0,0,12,0,2,16,7,0,7,0,14,30,0
4518,118658,eJLeV7Xq2bhq90HDU7vo6Tpmzbd63FDZ,SpATywNh6bZuzm8s1ceuBUnMUAeoAHHw,13,13,8,0,4,0,4,0,29,4.142857142857143,4,0.0,0,8,0,4,13,0,0,4,0,12,17,0
4519,118687,c1BXmJNemroOPh6WUefTBD28s2WzSNwi,A3fsA9Zfv1X2fVEQhTw51lKENdNrEqT3,13,24,1,6,0,0,9,1,41,5.857142857142857,2,0.0,3,1,5,0,21,0,1,9,1,9,32,1
4520,118688,c1BXmJNemroOPh6WUefTBD28s2WzSNwi,SpATywNh6bZuzm8s1ceuBUnMUAeoAHHw,41,70,6,45,7,3,13,1,145,20.714285714285715,6,0.0,22,6,41,7,48,3,4,13,1,76,69,0
4521,118704,ZfIQYurnR6gJbWxLJ81cU3ZqzX4mpHm0,bWdj2GDclj5ofokWjzoa5jAwMkxCykd6,3,4,1,0,0,0,1,0,6,0.8571428571428571,2,0.0,0,1,0,0,4,0,0,1,0,1,5,0
4522,118705,rPluxrp33x1irahRnKiA3x2EKOheskK1,5X6FeZozNMgE2VRi3MJYjkkFK8SETtu2,69,186,71,81,72,9,28,0,447,63.857142857142854,15,0.0,92,71,70,72,94,9,11,28,0,305,142,0
4523,118748,grNuFIQJF1sOOkw8RJjaExhlwTJt52uU,G8EPVSXsOYB5YQWZGiz1aVq5Pgr2GrQu,35,63,36,20,8,6,16,1,150,21.428571428571427,4,0.0,15,36,16,8,48,6,4,16,1,75,75,0
4524,118787,bKVslXuzEQ1pv4c6iV5mVjs6X6avUbmL,A3fsA9Zfv1X2fVEQhTw51lKENdNrEqT3,1,0,0,0,0,0,1,0,1,0.14285714285714285,1,0.0,0,0,0,0,0,0,0,1,0,0,1,1
4525,118793,lrp5AGJUh69hKuCI5IYUEU19E2beipwd,bWdj2GDclj5ofokWjzoa5jAwMkxCykd6,5,5,1,0,0,0,2,0,8,1.1428571428571428,2,0.0,0,1,0,0,5,0,0,2,0,1,7,1
4526,118797,Lk947zUxODvAz9uAzr7LhEhqya4oVnNV,SpATywNh6bZuzm8s1ceuBUnMUAeoAHHw,6,4,0,0,0,0,3,0,7,1.0,1,0.0,0,0,0,0,4,0,0,3,0,0,7,0
4527,118805,c9mIdDAhRczXEb5UJiDqrnVR2zYNOBwR,A3fsA9Zfv1X2fVEQhTw51lKENdNrEqT3,1,0,0,0,0,0,1,0,1,0.14285714285714285,1,0.0,0,0,0,0,0,0,0,1,0,0,1,1
4528,118806,NbUyHCtjlZY38KWhmKKrrw2eE1rI3XlV,SpATywNh6bZuzm8s1ceuBUnMUAeoAHHw,37,22,20,0,19,0,1,0,62,8.857142857142858,1,0.0,0,20,0,19,22,0,0,1,0,39,23,0
4529,118880,bqWpav7ocOhCfb3xc4QgAvBDK5g8BmiZ,RXDvfPUBYFlVdlueBFbLW0mhhAyGEqpt,3,4,2,0,0,0,2,0,8,1.1428571428571428,2,0.0,0,2,0,0,4,0,0,2,0,2,6,0
4530,118884,c8WJAdYLV71mOx4ZXSglpCNd0dBUR3Om,SpATywNh6bZuzm8s1ceuBUnMUAeoAHHw,33,31,17,18,11,0,7,0,84,12.0,5,0.0,7,17,16,11,24,0,2,7,0,51,33,0
4531,118905,bqWpav7ocOhCfb3xc4QgAvBDK5g8BmiZ,5X6FeZozNMgE2VRi3MJYjkkFK8SETtu2,26,20,7,50,4,0,5,0,86,12.285714285714286,1,0.0,11,7,39,4,9,0,11,5,0,61,25,1
4532,119045,VXXH6vGXZQbtzT48oIYSMTaYkPq1TVm5,SpATywNh6bZuzm8s1ceuBUnMUAeoAHHw,4,2,1,0,1,0,0,0,4,0.5714285714285714,1,0.0,0,1,0,1,2,0,0,0,0,2,2,0
4533,119053,fS72R3kjN9mNNeiYurwm3Uc8w1dF6aYm,SpATywNh6bZuzm8s1ceuBUnMUAeoAHHw,21,24,16,12,6,2,5,0,65,9.285714285714286,3,0.0,6,16,9,6,18,2,3,5,0,37,28,0
4534,119116,syYCTgfx3QIfokZD3KllJs2hnCVUuN4D,G8EPVSXsOYB5YQWZGiz1aVq5Pgr2GrQu,34,87,34,0,22,0,5,0,148,21.142857142857142,3,0.0,0,34,0,22,87,0,0,5,0,56,92,1
4535,119128,OUbrW18OgibVb4I41eHFiFhkobpgjEP2,bWdj2GDclj5ofokWjzoa5jAwMkxCykd6,16,12,9,0,6,0,4,0,31,4.428571428571429,3,0.0,0,9,0,6,12,0,0,4,0,15,16,0
4536,119144,ppepyuI84wHcCSvA9T6Tm0AI9MVxK9O7,SpATywNh6bZuzm8s1ceuBUnMUAeoAHHw,19,14,7,16,5,4,4,1,51,7.285714285714286,1,0.0,6,7,13,5,8,4,3,4,1,31,20,0
4537,119158,y71lRBqIdu5iPiLn9Yi5PQm6GFIvgLwB,SpATywNh6bZuzm8s1ceuBUnMUAeoAHHw,9,19,9,12,0,0,4,0,44,6.285714285714286,2,0.0,6,9,9,0,13,0,3,4,0,24,20,0
4538,119181,mu7Zdr1ChN6xNMWE8Otd7Si7TQhm7pEQ,A3fsA9Zfv1X2fVEQhTw51lKENdNrEqT3,5,4,2,0,0,0,5,0,11,1.5714285714285714,1,0.0,0,2,0,0,4,0,0,5,0,2,9,1
4539,119189,OXg5CDewbDZIhWJ50yEsGOqULuWAjfkH,SpATywNh6bZuzm8s1ceuBUnMUAeoAHHw,35,37,17,12,11,5,9,1,92,13.142857142857142,4,0.0,16,17,12,11,21,5,0,9,1,56,36,0
4540,119210,MgBJbfRXH0QNEJmIiGY28SpmFvbhxSoF,SpATywNh6bZuzm8s1ceuBUnMUAeoAHHw,32,33,24,13,16,0,11,0,97,13.857142857142858,3,0.0,2,24,13,16,31,0,0,11,0,55,42,0
4541,119254,i0ksX07HnsV5rQlWqOr1uKEuc7yNU24c,SpATywNh6bZuzm8s1ceuBUnMUAeoAHHw,18,22,15,6,9,4,3,0,59,8.428571428571429,3,0.0,5,15,5,9,17,4,1,3,0,34,25,0
4542,119277,sBmxTL0paOf5h6iJST2iiGwB52qodqPr,bWdj2GDclj5ofokWjzoa5jAwMkxCykd6,6,4,2,0,0,0,3,0,9,1.2857142857142858,1,0.0,1,2,0,0,3,0,0,3,0,3,6,0
4543,119279,FOCwtnRC84DvGRNwirqX2TIHG72pPbnw,SpATywNh6bZuzm8s1ceuBUnMUAeoAHHw,5,4,3,0,0,0,1,0,8,1.1428571428571428,1,0.0,0,3,0,0,4,0,0,1,0,3,5,0
4544,119352,8EUVcR3i03tV4r6XHeEe98sUtzrKJPIp,SpATywNh6bZuzm8s1ceuBUnMUAeoAHHw,1,0,0,0,0,0,1,0,1,0.14285714285714285,1,0.0,0,0,0,0,0,0,0,1,0,0,1,0
4545,119354,dTKURyZ9dyqGbe4l7wsUGgSU85JHBAFq,SpATywNh6bZuzm8s1ceuBUnMUAeoAHHw,21,18,13,30,5,0,1,0,67,9.571428571428571,1,0.0,4,13,27,5,14,0,3,1,0,49,18,0
4546,119380,6CE4R3S7kL46D5t23wqANpKa4VUqa9S2,SpATywNh6bZuzm8s1ceuBUnMUAeoAHHw,17,15,0,19,1,0,1,0,36,5.142857142857143,1,0.0,3,0,16,1,12,0,3,1,0,20,16,1
4547,119386,nIvIddlMAmTQagaACOulbZ6PInxlyOy2,SpATywNh6bZuzm8s1ceuBUnMUAeoAHHw,1,0,0,0,0,0,1,0,1,0.14285714285714285,1,0.0,0,0,0,0,0,0,0,1,0,0,1,1
4548,119390,hZR4MwcYec4g0GoOyJFngJGEyWOySpv2,A3fsA9Zfv1X2fVEQhTw51lKENdNrEqT3,2,2,1,0,0,10,0,0,13,1.8571428571428572,1,0.0,0,1,0,0,2,10,0,0,0,1,12,0
4549,119391,mxHDkP66knN7zmdYEUQKDHYwEophbx3W,SpATywNh6bZuzm8s1ceuBUnMUAeoAHHw,19,27,1,7,1,0,2,0,38,5.428571428571429,2,0.0,4,1,7,1,23,0,0,2,0,13,25,0
4550,119490,83cBV2IXkwoW1nUaa1kxaJ98L3bxFsPn,RXDvfPUBYFlVdlueBFbLW0mhhAyGEqpt,6,13,7,0,0,0,6,2,28,4.0,3,0.0,1,7,0,0,12,0,0,6,2,8,20,1
4551,119506,KouA4JUz2i1n0FC6Xu2JucWPd7vnGUb0,SpATywNh6bZuzm8s1ceuBUnMUAeoAHHw,29,50,5,25,8,0,10,0,98,14.0,3,0.0,6,5,19,8,44,0,6,10,0,38,60,0
4552,119509,8MuGb55gUM18pukCITXgZoTSobqXs9G4,SpATywNh6bZuzm8s1ceuBUnMUAeoAHHw,4,3,0,0,0,0,1,0,4,0.5714285714285714,1,0.0,0,0,0,0,3,0,0,1,0,0,4,1
4553,119524,RRKT0H2BFDE1dQIQFr3IpZgVIVSJVg71,SpATywNh6bZuzm8s1ceuBUnMUAeoAHHw,33,31,16,20,7,10,10,1,95,13.571428571428571,4,0.0,4,16,16,7,27,10,4,10,1,43,52,0
4554,119543,Cf7GCeUZzG7WjvUIyGfwv9hfcwXPVq5G,G8EPVSXsOYB5YQWZGiz1aVq5Pgr2GrQu,89,139,6,238,1,0,15,0,399,57.0,6,0.0,11,6,207,1,128,0,31,15,0,225,174,0
4555,119567,Dl433WBzpFXMdRxwA66dmtxmpsyN7fkX,SpATywNh6bZuzm8s1ceuBUnMUAeoAHHw,11,15,2,0,1,0,5,0,23,3.2857142857142856,3,0.0,0,2,0,1,15,0,0,5,0,3,20,0
4556,119571,sZV7O4QepCcao3DEyr879t5mUWopWkVJ,SpATywNh6bZuzm8s1ceuBUnMUAeoAHHw,19,18,10,14,6,0,3,0,51,7.285714285714286,2,0.0,4,10,13,6,14,0,1,3,0,33,18,0
4557,119631,ltVEinCK1OZ9CXJhcqdDg6iZlAvKKTwQ,SpATywNh6bZuzm8s1ceuBUnMUAeoAHHw,8,7,4,0,2,0,5,0,18,2.5714285714285716,2,0.0,0,4,0,2,7,0,0,5,0,6,12,0
4558,119695,EGp6xRzNCnsCPDRg0mfvtfy8t2jZt4I9,SpATywNh6bZuzm8s1ceuBUnMUAeoAHHw,36,71,27,32,17,3,7,0,157,22.428571428571427,3,0.0,38,27,26,17,33,3,6,7,0,108,49,0
4559,119860,zvwdGnH0aGIXM4GZVb8XpCl4QdIDbhPS,G8EPVSXsOYB5YQWZGiz1aVq5Pgr2GrQu,26,37,23,0,21,0,2,0,83,11.857142857142858,1,0.0,12,23,0,21,25,0,0,2,0,56,27,1
4560,119863,C8zDhaG0vPsQegBtS55u3JZHiYuueFnE,A3fsA9Zfv1X2fVEQhTw51lKENdNrEqT3,3,2,0,0,0,0,4,0,6,0.8571428571428571,2,0.0,0,0,0,0,2,0,0,4,0,0,6,0
4561,119865,fl8sEptrcl2JvFWXejFcnsM7BqWtKl9w,SpATywNh6bZuzm8s1ceuBUnMUAeoAHHw,17,21,10,11,4,0,2,0,48,6.857142857142857,2,0.0,6,10,8,4,15,0,3,2,0,28,20,1
4562,119944,ico4mWfX6sj6OUii1pav0Sth51UYo7la,SpATywNh6bZuzm8s1ceuBUnMUAeoAHHw,19,21,15,9,10,0,2,0,57,8.142857142857142,2,0.0,4,15,8,10,17,0,1,2,0,37,20,1
4563,119986,EjqS3A2Iv9J8JTjinbKy3gdtrrXaSQyJ,A3fsA9Zfv1X2fVEQhTw51lKENdNrEqT3,26,43,17,42,0,0,1,0,103,14.714285714285714,1,0.0,3,17,39,0,40,0,3,1,0,59,44,1
4564,120065,fFuKiCeoQQwOgD8VAud2ta198Mbq05KK,A3fsA9Zfv1X2fVEQhTw51lKENdNrEqT3,6,4,2,0,1,0,2,0,9,1.2857142857142858,1,0.0,0,2,0,1,4,0,0,2,0,3,6,1
4565,120094,rn4nO5004kgupfgjaXh0qv5wJPGuOGCi,RXDvfPUBYFlVdlueBFbLW0mhhAyGEqpt,22,50,4,28,7,3,6,0,98,14.0,1,0.0,20,4,27,7,30,3,1,6,0,58,40,1
4566,120195,1LkX4t7QGG0LPbqqJvnwJmrweFNAYkvm,A3fsA9Zfv1X2fVEQhTw51lKENdNrEqT3,3,3,0,0,0,0,1,0,4,0.5714285714285714,2,0.0,0,0,0,0,3,0,0,1,0,0,4,1
4567,120223,nrDkIZH2wqEVh6i4pBxcbRBJIMc9s20b,G8EPVSXsOYB5YQWZGiz1aVq5Pgr2GrQu,33,14,1,102,0,0,4,0,121,17.285714285714285,2,0.0,4,1,96,0,10,0,6,4,0,101,20,0
4568,120235,RYd1k9DojojPZwrkV3NjsTI5OdZnPV9W,RXDvfPUBYFlVdlueBFbLW0mhhAyGEqpt,4,4,0,0,0,0,2,0,6,0.8571428571428571,1,0.0,0,0,0,0,4,0,0,2,0,0,6,1
4569,120239,80Av2RXrFoxNOdv7EQUM2TDOM0gyNH0J,SpATywNh6bZuzm8s1ceuBUnMUAeoAHHw,8,12,1,0,1,0,1,0,15,2.142857142857143,1,0.0,0,1,0,1,12,0,0,1,0,2,13,1
4570,120297,7xobbz91DmuqnSowtdCPvlArDkv1wvpY,bWdj2GDclj5ofokWjzoa5jAwMkxCykd6,20,17,2,36,4,0,13,1,73,10.428571428571429,1,0.0,6,2,32,4,11,0,4,13,1,44,29,0
4571,120324,BFpj8Vxul230N4kCbxR9rjWJ12ZQLtAV,RXDvfPUBYFlVdlueBFbLW0mhhAyGEqpt,10,8,1,0,1,0,1,0,11,1.5714285714285714,1,0.0,0,1,0,1,8,0,0,1,0,2,9,0
4572,120424,PazYalgu71qbC99y9FrRjNpcniWiR2x1,RXDvfPUBYFlVdlueBFbLW0mhhAyGEqpt,10,13,5,0,3,0,2,1,24,3.4285714285714284,1,0.0,0,5,0,3,13,0,0,2,1,8,16,1
4573,120499,5scsz5bGh8T1roTXhO7UpMXlEDKIsK9l,SpATywNh6bZuzm8s1ceuBUnMUAeoAHHw,38,57,24,35,15,3,6,0,140,20.0,3,0.0,14,24,30,15,43,3,5,6,0,83,57,1
4574,120686,u5ObOMoHUcvVsOQTGkiv0BRKKcn8v2w8,bWdj2GDclj5ofokWjzoa5jAwMkxCykd6,7,5,4,0,2,0,1,0,12,1.7142857142857142,1,0.0,0,4,0,2,5,0,0,1,0,6,6,1
4575,120788,qwhxcjW9iIMBAQoGSWDtst34AFkcFQoV,G8EPVSXsOYB5YQWZGiz1aVq5Pgr2GrQu,1,0,0,0,0,0,1,0,1,0.14285714285714285,1,0.0,0,0,0,0,0,0,0,1,0,0,1,0
4576,120808,OTAUIgoWBEWsq2kd8lnvB0dKpj3SXEdR,SpATywNh6bZuzm8s1ceuBUnMUAeoAHHw,7,9,6,0,3,0,2,0,20,2.857142857142857,2,0.0,0,6,0,3,9,0,0,2,0,9,11,1
4577,120815,qwhxcjW9iIMBAQoGSWDtst34AFkcFQoV,A3fsA9Zfv1X2fVEQhTw51lKENdNrEqT3,11,22,12,0,4,0,9,0,47,6.714285714285714,3,0.0,0,12,0,4,22,0,0,9,0,16,31,0
4578,120892,pAkhnLI0s5vboktZycO7Tobv6jbspULh,SpATywNh6bZuzm8s1ceuBUnMUAeoAHHw,29,53,39,0,23,0,13,1,129,18.428571428571427,6,0.0,0,39,0,23,53,0,0,13,1,62,67,1
4579,120909,aldLXGpzmiip2CUSDhqN8A5UpGMVUHxY,A3fsA9Zfv1X2fVEQhTw51lKENdNrEqT3,7,5,4,2,2,0,1,0,14,2.0,1,0.0,0,4,1,2,5,0,1,1,0,7,7,0
4580,120930,fHz7VQRoJHHTDfRPDpvJLuPlruuvrNnm,SpATywNh6bZuzm8s1ceuBUnMUAeoAHHw,3,0,0,0,0,0,3,0,3,0.42857142857142855,1,0.0,0,0,0,0,0,0,0,3,0,0,3,1
4581,120949,ONK0Esb7fhLc69POI06k3Sj1alNC6Fij,SpATywNh6bZuzm8s1ceuBUnMUAeoAHHw,30,24,16,25,12,5,19,0,101,14.428571428571429,6,0.0,8,16,23,12,16,5,2,19,0,59,42,0
4582,120973,VsZvGrXbL1e6v6hmpJQH8MldIkCBO9P7,RXDvfPUBYFlVdlueBFbLW0mhhAyGEqpt,38,62,27,82,12,0,6,0,189,27.0,1,0.0,14,27,78,12,48,0,4,6,0,131,58,0
4583,120975,KjHOE07fI9pBFKqiwhrvCwjITj7tyFWN,G8EPVSXsOYB5YQWZGiz1aVq5Pgr2GrQu,10,7,4,0,2,0,3,0,16,2.2857142857142856,1,0.0,0,4,0,2,7,0,0,3,0,6,10,1
4584,120982,JBjDnQZVwVLGdsvKJqTw57nrx9uYY0vn,A3fsA9Zfv1X2fVEQhTw51lKENdNrEqT3,8,5,2,0,1,0,6,1,15,2.142857142857143,1,0.0,0,2,0,1,5,0,0,6,1,3,12,0
4585,121023,TzRDOFjVsHxcJLvrJENTAv7iaJPhFHB5,SpATywNh6bZuzm8s1ceuBUnMUAeoAHHw,15,14,5,23,2,0,4,0,48,6.857142857142857,1,0.0,7,5,21,2,7,0,2,4,0,35,13,1
4586,121048,nwFT4lnmg30fCvHRB6tbALo9FpcanuLx,bWdj2GDclj5ofokWjzoa5jAwMkxCykd6,7,5,3,0,1,0,3,0,12,1.7142857142857142,2,0.0,0,3,0,1,5,0,0,3,0,4,8,0
4587,121100,8mYFryxeRH8GSnHog9hmhUPRk60LCyFI,SpATywNh6bZuzm8s1ceuBUnMUAeoAHHw,10,10,7,0,3,0,22,0,42,6.0,2,0.0,0,7,0,3,10,0,0,22,0,10,32,1
4588,121105,M8ur292SdHouJ1LnQyJMDkHJM5sUPxnX,SpATywNh6bZuzm8s1ceuBUnMUAeoAHHw,12,11,1,12,1,0,1,0,26,3.7142857142857144,1,0.0,0,1,9,1,11,0,3,1,0,11,15,0
4589,121134,4IxaKtzWvkfFEFZ43UhJQOyIahcBxrF2,SpATywNh6bZuzm8s1ceuBUnMUAeoAHHw,7,6,3,0,2,0,1,0,12,1.7142857142857142,1,0.0,0,3,0,2,6,0,0,1,0,5,7,1
4590,121191,MbmumbK7FHZlEn2oNe4YMQEQzBas1u6w,bWdj2GDclj5ofokWjzoa5jAwMkxCykd6,17,12,7,33,1,8,1,0,62,8.857142857142858,1,0.0,2,7,29,1,10,8,4,1,0,39,23,0
4591,121339,oKz0rKWQtHW8DkPwxTgdemWb21NvE4BO,SpATywNh6bZuzm8s1ceuBUnMUAeoAHHw,15,13,0,13,0,0,4,0,30,4.285714285714286,1,0.0,2,0,12,0,11,0,1,4,0,14,16,1
4592,121345,ePaTLgBKhclwas3ClxzVVmTCgYzhx4go,SpATywNh6bZuzm8s1ceuBUnMUAeoAHHw,11,10,1,13,0,7,6,0,37,5.285714285714286,3,0.0,2,1,11,0,8,7,2,6,0,14,23,0
4593,121656,aVeyGdrz6Ir4LmiLkJqBoRjG1lQ7MsV8,bWdj2GDclj5ofokWjzoa5jAwMkxCykd6,4,4,2,0,0,18,4,1,29,4.142857142857143,2,0.0,0,2,0,0,4,18,0,4,1,2,27,0
4594,121712,zdC6SE3iIVhpYTGT1Ftflp0F2V48NqFq,SpATywNh6bZuzm8s1ceuBUnMUAeoAHHw,3,2,1,0,0,0,1,0,4,0.5714285714285714,1,0.0,0,1,0,0,2,0,0,1,0,1,3,1
4595,121721,RNEuStAlTxZHIZFwvfCfasMOM5Hny2Pn,SpATywNh6bZuzm8s1ceuBUnMUAeoAHHw,31,34,4,57,2,3,10,4,114,16.285714285714285,3,0.0,11,4,46,2,23,3,11,10,4,63,51,1
4596,121731,wBp63rzsgy2LzOR2gkxDj87VT9Ja70XK,SpATywNh6bZuzm8s1ceuBUnMUAeoAHHw,3,2,1,0,0,0,1,0,4,0.5714285714285714,1,0.0,0,1,0,0,2,0,0,1,0,1,3,1
4597,121746,bFBipIvg3ynAbrvo3mXNRP6i8NWVQRYx,bWdj2GDclj5ofokWjzoa5jAwMkxCykd6,9,8,4,6,2,0,4,0,24,3.4285714285714284,1,0.0,2,4,6,2,6,0,0,4,0,14,10,1
4598,124668,oARKFBU8ybRND8XMVu96YEHeW22LRUke,5X6FeZozNMgE2VRi3MJYjkkFK8SETtu2,3,2,0,0,0,0,2,0,4,0.5714285714285714,1,0.0,0,0,0,0,2,0,0,2,0,0,4,1
4599,124685,qwhxcjW9iIMBAQoGSWDtst34AFkcFQoV,7GRhBDsirIGkRZBtSMEzNTyDr2JQm4xx,3,2,1,0,0,0,1,0,4,0.5714285714285714,1,0.0,0,1,0,0,2,0,0,1,0,1,3,0
4600,124717,Z5fT2dRmGZA6byuGIfmg4Qv99HwruaNQ,5X6FeZozNMgE2VRi3MJYjkkFK8SETtu2,1,0,0,0,0,0,1,0,1,0.14285714285714285,1,0.0,0,0,0,0,0,0,0,1,0,0,1,1
4601,124736,O5KBwdPnEkmA9netVr9aGipw3OlgkQS8,5X6FeZozNMgE2VRi3MJYjkkFK8SETtu2,9,5,1,0,1,1,13,1,22,3.142857142857143,2,0.0,0,1,0,1,5,1,0,13,1,2,20,1
4602,124845,r2BlY5kx3gPU1opGlfjFI0ngbnfS5jKE,5X6FeZozNMgE2VRi3MJYjkkFK8SETtu2,36,92,21,58,30,2,22,0,225,32.142857142857146,6,0.0,44,21,46,30,48,2,12,22,0,141,84,0
4603,124891,imMIajxyorSupzcO0ndqnctRXANxxhkV,5X6FeZozNMgE2VRi3MJYjkkFK8SETtu2,40,68,13,34,27,3,8,1,154,22.0,4,0.0,35,13,31,27,33,3,3,8,1,106,48,1
4604,124930,G9GKaCR68fEW2dhyNOCbPYXyvlYi1Jne,5X6FeZozNMgE2VRi3MJYjkkFK8SETtu2,15,9,1,14,4,1,4,1,34,4.857142857142857,1,0.0,7,1,12,4,2,1,2,4,1,24,10,1
4605,125098,69mjZoNGtUdd47OHaI2iQubsVwSBE5CT,5X6FeZozNMgE2VRi3MJYjkkFK8SETtu2,2,0,0,0,0,0,3,0,3,0.42857142857142855,1,0.0,0,0,0,0,0,0,0,3,0,0,3,1
4606,125099,OaNHFpAUQzcTX5ejR9Q1L6eDhuIDKh84,5X6FeZozNMgE2VRi3MJYjkkFK8SETtu2,7,3,2,0,2,0,2,0,9,1.2857142857142858,1,0.0,0,2,0,2,3,0,0,2,0,4,5,0
4607,125203,3JIXiiq1ThMv9bAgaUvatHYIhYMco1sB,5X6FeZozNMgE2VRi3MJYjkkFK8SETtu2,1,0,0,0,0,0,1,0,1,0.14285714285714285,1,0.0,0,0,0,0,0,0,0,1,0,0,1,1
4608,125241,6zXGZtvwHnFZCYFcS3Xzk5yrVH7CXdoJ,5X6FeZozNMgE2VRi3MJYjkkFK8SETtu2,1,0,0,0,0,0,1,0,1,0.14285714285714285,1,0.0,0,0,0,0,0,0,0,1,0,0,1,1
4609,125243,s0CuaMOyGbriaa9tGqsijSbS7imj3jdt,5X6FeZozNMgE2VRi3MJYjkkFK8SETtu2,2,0,0,0,0,0,2,0,2,0.2857142857142857,1,0.0,0,0,0,0,0,0,0,2,0,0,2,0
4610,125461,gk39jRVv7texY2FMD0lChVtgPwDbQSv3,5X6FeZozNMgE2VRi3MJYjkkFK8SETtu2,2,0,0,0,0,0,2,0,2,0.2857142857142857,1,0.0,0,0,0,0,0,0,0,2,0,0,2,1
4611,125616,NdhfP9LezOw47EKstFkVNQYaCX8DmoQI,5X6FeZozNMgE2VRi3MJYjkkFK8SETtu2,1,0,0,0,0,0,1,0,1,0.14285714285714285,1,0.0,0,0,0,0,0,0,0,1,0,0,1,1
4612,125736,GsteHvxrvXPKxVJCWABqfywywLIH4L0X,5X6FeZozNMgE2VRi3MJYjkkFK8SETtu2,1,0,0,0,0,0,1,0,1,0.14285714285714285,1,0.0,0,0,0,0,0,0,0,1,0,0,1,1
4613,125824,AI4dmnjzjVX0N3Qdp7jyisM4h3f0FBmq,5X6FeZozNMgE2VRi3MJYjkkFK8SETtu2,8,10,4,0,2,0,2,0,18,2.5714285714285716,1,0.0,3,4,0,2,7,0,0,2,0,9,9,1
4614,125940,66rxtelZjlVaBERuinHZ5AhHu9R6Idp5,5X6FeZozNMgE2VRi3MJYjkkFK8SETtu2,5,3,1,0,0,0,2,0,6,0.8571428571428571,1,0.0,0,1,0,0,3,0,0,2,0,1,5,1
4615,126030,qPWCKd8S50IaPeOGkgV300kLADUtBMrm,3VkHkmOtom3jM2wCu94xgzzu1d6Dn7or,20,20,12,0,7,0,7,0,46,6.571428571428571,5,0.0,1,12,0,7,19,0,0,7,0,20,26,0
4616,126045,fijBSDSom6Hh0o1zTcCBpz1hgxUnPhnS,3VkHkmOtom3jM2wCu94xgzzu1d6Dn7or,5,2,0,0,0,0,5,0,7,1.0,1,0.0,0,0,0,0,2,0,0,5,0,0,7,1
4617,126058,7P8NyH1p0F9cBZAFhaYgNYWEMQktUpKo,3VkHkmOtom3jM2wCu94xgzzu1d6Dn7or,1,0,0,0,0,0,1,0,1,0.14285714285714285,1,0.0,0,0,0,0,0,0,0,1,0,0,1,1
4618,126145,dmVv4oc5Gy8IXIoX1c6y61vCY7ZjC5c1,3VkHkmOtom3jM2wCu94xgzzu1d6Dn7or,67,257,72,84,50,6,79,12,560,80.0,14,0.0,81,72,80,50,176,6,4,79,12,283,277,0
4619,126171,RhrWEWr9BJgTwAMiLH281tMjmArdfWGz,3VkHkmOtom3jM2wCu94xgzzu1d6Dn7or,6,8,3,0,2,0,3,0,16,2.2857142857142856,2,0.0,0,3,0,2,8,0,0,3,0,5,11,1
4620,126189,9LD2dY2JJUiq4N2gerCXLTVCO162xgQP,3VkHkmOtom3jM2wCu94xgzzu1d6Dn7or,1,0,0,0,0,0,1,0,1,0.14285714285714285,1,0.0,0,0,0,0,0,0,0,1,0,0,1,1
4621,126298,rEySukj9OF9DmmmaiDf8JBIJol4y1hJW,3VkHkmOtom3jM2wCu94xgzzu1d6Dn7or,4,0,0,0,0,1,3,0,4,0.5714285714285714,1,0.0,0,0,0,0,0,1,0,3,0,0,4,1
4622,126303,6CwZcMqc6epDab0l1TVtEsvlUkvhqRTK,3VkHkmOtom3jM2wCu94xgzzu1d6Dn7or,5,2,0,0,1,1,4,4,12,1.7142857142857142,1,0.0,0,0,0,1,2,1,0,4,4,1,11,1
4623,126380,2bfj1ryOHyN2ug5mVjQDlKn26erJunPx,3VkHkmOtom3jM2wCu94xgzzu1d6Dn7or,8,14,7,0,5,0,9,0,35,5.0,2,0.0,2,7,0,5,12,0,0,9,0,14,21,1
4624,126389,xosHpCClxDIdr7jC4105d18bvd0ljH6o,3VkHkmOtom3jM2wCu94xgzzu1d6Dn7or,4,2,1,0,1,0,1,0,5,0.7142857142857143,1,0.0,0,1,0,1,2,0,0,1,0,2,3,1
4625,126529,wodz58MkHQadBU30zkgGJ03KFU838ic3,3VkHkmOtom3jM2wCu94xgzzu1d6Dn7or,1,0,0,0,0,0,2,0,2,0.2857142857142857,2,0.0,0,0,0,0,0,0,0,2,0,0,2,1
4626,126566,baN6nF8FXfpysY1rIAQ77TmCuv25YzZW,3VkHkmOtom3jM2wCu94xgzzu1d6Dn7or,1,0,0,0,0,0,1,0,1,0.14285714285714285,1,0.0,0,0,0,0,0,0,0,1,0,0,1,1
4627,126608,2mKDVFSaTvGjvKpmkVudIwKZKKgWuPtT,3VkHkmOtom3jM2wCu94xgzzu1d6Dn7or,9,4,3,0,3,0,5,0,15,2.142857142857143,1,0.0,0,3,0,3,4,0,0,5,0,6,9,1
4628,126652,pSX00XUyCx7VlmgWGN0d39OwC9BZ8bRV,fbPkOYLVPtPgIt0MxizjfFJov3JbHyAi,5,3,2,0,1,0,1,0,7,1.0,1,0.0,0,2,0,1,3,0,0,1,0,3,4,1
4629,126742,B1Gq6e77yv7kkDqJ7SH2TygdPDzPBwQh,fbPkOYLVPtPgIt0MxizjfFJov3JbHyAi,2,0,0,0,0,0,2,0,2,0.2857142857142857,1,0.0,0,0,0,0,0,0,0,2,0,0,2,1
4630,129012,H4tEokgMlszMZU1ZAtEtgm2cAVIuDe9k,3VkHkmOtom3jM2wCu94xgzzu1d6Dn7or,98,203,57,90,78,32,29,5,494,70.57142857142857,11,0.0,121,57,87,78,82,32,3,29,5,343,151,1
4631,129020,xd3R9FpcIKhYRXFLFLDzZPRPvMMXOj1o,3VkHkmOtom3jM2wCu94xgzzu1d6Dn7or,17,23,11,6,6,3,5,4,58,8.285714285714286,3,0.0,6,11,6,6,17,3,0,5,4,29,29,1
4632,129034,QPoypIc1fBONo2zEXZGrqFPP68plPMOG,3VkHkmOtom3jM2wCu94xgzzu1d6Dn7or,22,27,16,11,12,0,4,0,70,10.0,3,0.0,8,16,7,12,19,0,4,4,0,43,27,0
4633,129061,nHB64kOB4WkqVwzYXTNxA6Ua5OuQHxmI,3VkHkmOtom3jM2wCu94xgzzu1d6Dn7or,1,0,0,0,0,0,1,0,1,0.14285714285714285,1,0.0,0,0,0,0,0,0,0,1,0,0,1,1
4634,129098,J2Ryyq6g6TjnFue1VPNlM9zNmZVB3792,3VkHkmOtom3jM2wCu94xgzzu1d6Dn7or,10,16,8,0,4,0,5,0,33,4.714285714285714,3,0.0,3,8,0,4,13,0,0,5,0,15,18,1
4635,129108,b2ohpFiEgZaZsBBPqUMnfjpywCAbNR88,3VkHkmOtom3jM2wCu94xgzzu1d6Dn7or,56,103,34,51,21,43,12,0,264,37.714285714285715,3,0.0,28,34,51,21,75,43,0,12,0,134,130,0
4636,129202,nWqEZjeBvF0165As6jqET8hLOfVFKWbf,3VkHkmOtom3jM2wCu94xgzzu1d6Dn7or,2,0,0,0,0,0,3,0,3,0.42857142857142855,1,0.0,0,0,0,0,0,0,0,3,0,0,3,1
4637,129218,BDud1mxU3XXQ1MjhXRWgHusVav3PnqPN,3VkHkmOtom3jM2wCu94xgzzu1d6Dn7or,1,0,0,0,0,0,1,0,1,0.14285714285714285,1,0.0,0,0,0,0,0,0,0,1,0,0,1,1
4638,129404,Y1SqyJfqZFFczMWE0rhcGtRccr3y209e,3VkHkmOtom3jM2wCu94xgzzu1d6Dn7or,4,3,0,0,0,0,2,0,5,0.7142857142857143,1,0.0,1,0,0,0,2,0,0,2,0,1,4,0
4639,129407,TG3ZuEJuEwKy3hkCPL590sfXZmiZZmKY,3VkHkmOtom3jM2wCu94xgzzu1d6Dn7or,6,4,2,0,1,0,4,0,11,1.5714285714285714,2,0.0,0,2,0,1,4,0,0,4,0,3,8,1
4640,129412,WQBkuTNjtyUymeQ1faPduUvsPbZ8z9iy,3VkHkmOtom3jM2wCu94xgzzu1d6Dn7or,1,0,0,0,0,0,1,0,1,0.14285714285714285,1,0.0,0,0,0,0,0,0,0,1,0,0,1,1
4641,129478,d8eTRWMSYvWbG76uUcrxeacgOqbOV0Us,3VkHkmOtom3jM2wCu94xgzzu1d6Dn7or,10,6,5,0,4,0,2,0,17,2.4285714285714284,1,0.0,0,5,0,4,6,0,0,2,0,9,8,0
4642,129504,IZKkIC52B1S5icmdVH39329jtcYFvz5C,3VkHkmOtom3jM2wCu94xgzzu1d6Dn7or,1,0,0,0,0,0,1,0,1,0.14285714285714285,1,0.0,0,0,0,0,0,0,0,1,0,0,1,1
4643,129525,ykFKZMBVwdYfhaervJkzUsSpOvUY6zAv,3VkHkmOtom3jM2wCu94xgzzu1d6Dn7or,1,0,0,0,0,0,1,0,1,0.14285714285714285,1,0.0,0,0,0,0,0,0,0,1,0,0,1,1
4644,129576,bUyOVoZ9Hyd2m2r7LIQyI4wvcTKWeUpC,5Gyp41oLVo7Gg7vF4vpmggWP5MU70QO6,1,0,0,0,0,0,1,0,1,0.14285714285714285,1,0.0,0,0,0,0,0,0,0,1,0,0,1,1
4645,129586,2hFnq94PJL4XDwPjj8ZoE3JMQah41FEA,5Gyp41oLVo7Gg7vF4vpmggWP5MU70QO6,1,0,0,0,0,0,1,0,1,0.14285714285714285,1,0.0,0,0,0,0,0,0,0,1,0,0,1,1
4646,129606,l1rg3D8Gp1lv7dbBBYKvzTS3OZ5DRjWH,5Gyp41oLVo7Gg7vF4vpmggWP5MU70QO6,1,0,0,0,0,0,1,0,1,0.14285714285714285,1,0.0,0,0,0,0,0,0,0,1,0,0,1,1
4647,129655,2viub6InFwMLthqb8hJjmGF9NgF8w6Xs,5Gyp41oLVo7Gg7vF4vpmggWP5MU70QO6,6,5,0,0,0,0,3,0,8,1.1428571428571428,1,0.0,0,0,0,0,5,0,0,3,0,0,8,1
4648,129656,b7a8MINp9dmqKVbHeE4hG21HrnpB7u9G,5Gyp41oLVo7Gg7vF4vpmggWP5MU70QO6,22,38,24,19,8,3,10,0,102,14.571428571428571,5,0.0,7,24,13,8,31,3,6,10,0,52,50,0
4649,129761,rs4TcQqev4WGQPheqEKUDx5pHXZIAB6V,5Gyp41oLVo7Gg7vF4vpmggWP5MU70QO6,1,0,0,0,0,0,1,0,1,0.14285714285714285,1,0.0,0,0,0,0,0,0,0,1,0,0,1,1
4650,129842,el15cFEaxCdIHMAGefcdFdhRQ7MvBqC9,5Gyp41oLVo7Gg7vF4vpmggWP5MU70QO6,5,2,0,0,0,0,3,0,5,0.7142857142857143,1,0.0,0,0,0,0,2,0,0,3,0,0,5,0
4651,129845,Q6o5bW0qV0zSfYIpheiDZNlIXQMlvYYV,5Gyp41oLVo7Gg7vF4vpmggWP5MU70QO6,4,2,1,0,1,0,1,0,5,0.7142857142857143,1,0.0,0,1,0,1,2,0,0,1,0,2,3,1
4652,129868,H683tMkQp6lFNh1xHTfMz81b5h1W7bC1,5Gyp41oLVo7Gg7vF4vpmggWP5MU70QO6,13,15,12,0,1,0,4,0,32,4.571428571428571,3,0.0,0,12,0,1,15,0,0,4,0,13,19,1
4653,129870,DrolXxynktOsAUhkf2q3qgLe9PvqdRq3,5Gyp41oLVo7Gg7vF4vpmggWP5MU70QO6,6,5,3,0,1,0,2,0,11,1.5714285714285714,2,0.0,0,3,0,1,5,0,0,2,0,4,7,0
4654,129908,5kEshmgSAUGvBEOsnsKU8IViB0lkOwoD,5Gyp41oLVo7Gg7vF4vpmggWP5MU70QO6,13,27,12,0,9,0,5,0,53,7.571428571428571,3,0.0,5,12,0,9,22,0,0,5,0,26,27,0
4655,129910,SBNXBfto5KlwjjRWIWllPOHRdAIe9bjA,5Gyp41oLVo7Gg7vF4vpmggWP5MU70QO6,4,2,1,0,1,0,1,0,5,0.7142857142857143,1,0.0,0,1,0,1,2,0,0,1,0,2,3,1
4656,129917,tNz1Ij4PdCaNvy7fotw6BT1EaWCMciYH,5Gyp41oLVo7Gg7vF4vpmggWP5MU70QO6,7,2,1,0,1,5,5,1,15,2.142857142857143,1,0.0,0,1,0,1,2,5,0,5,1,2,13,1
4657,129952,bBdjMMZYfTKEWQmbqaPHvQg5nayvALN5,5Gyp41oLVo7Gg7vF4vpmggWP5MU70QO6,18,41,14,19,7,3,9,0,93,13.285714285714286,7,0.0,13,14,14,7,28,3,5,9,0,48,45,0
4658,129955,eCN2e5jTmvSB4oxzfYLyitV0JYfWmmDS,5Gyp41oLVo7Gg7vF4vpmggWP5MU70QO6,1,0,0,0,0,0,1,0,1,0.14285714285714285,1,0.0,0,0,0,0,0,0,0,1,0,0,1,1
4659,129969,Q6XyNzlE8rkF2yqmhzSLHfW6ZlWw606P,5Gyp41oLVo7Gg7vF4vpmggWP5MU70QO6,10,8,2,0,2,4,18,2,36,5.142857142857143,2,0.0,1,2,0,2,7,4,0,18,2,5,31,0
4660,129970,K97ztksPeTsMHohAca3SFDp9OflICmgg,5Gyp41oLVo7Gg7vF4vpmggWP5MU70QO6,10,3,2,0,2,5,7,1,20,2.857142857142857,1,0.0,0,2,0,2,3,5,0,7,1,4,16,1
4661,130036,pw2VRiQ4AyyioSYfxtFG0lrMfZvxwfmW,7GRhBDsirIGkRZBtSMEzNTyDr2JQm4xx,7,8,0,0,0,0,2,0,10,1.4285714285714286,1,0.0,0,0,0,0,8,0,0,2,0,0,10,0
4662,130061,kJKPmsgnAo2a0lGHjzSIUIt3KbVa9yEm,7GRhBDsirIGkRZBtSMEzNTyDr2JQm4xx,5,2,1,0,1,0,2,0,6,0.8571428571428571,1,0.0,0,1,0,1,2,0,0,2,0,2,4,1
4663,130067,X1uDfIBgkW4iN9gq82vUBXjiG0caTomy,7GRhBDsirIGkRZBtSMEzNTyDr2JQm4xx,9,6,3,2,1,2,4,0,18,2.5714285714285716,1,0.0,1,3,2,1,5,2,0,4,0,7,11,1
4664,130073,IGWRz8xQdPwjKqBNKTjONoXgcj0XdulM,7GRhBDsirIGkRZBtSMEzNTyDr2JQm4xx,56,63,5,73,17,4,12,0,174,24.857142857142858,5,0.0,34,5,56,17,29,4,17,12,0,112,62,0
4665,130079,HePRyod5aTSIcFeoVudB8huyR12d5o5i,7GRhBDsirIGkRZBtSMEzNTyDr2JQm4xx,7,5,1,0,1,0,2,0,9,1.2857142857142858,1,0.0,1,1,0,1,4,0,0,2,0,3,6,1
4666,130086,42XWMvZdooK2bfqSrGDd5b8CKP3qTWuq,7GRhBDsirIGkRZBtSMEzNTyDr2JQm4xx,1,0,0,0,0,0,1,0,1,0.14285714285714285,1,0.0,0,0,0,0,0,0,0,1,0,0,1,1
4667,130090,xhoMHYDn0DYj6NEexX867ukahPmWhSwf,7GRhBDsirIGkRZBtSMEzNTyDr2JQm4xx,78,69,36,0,55,0,9,0,169,24.142857142857142,3,0.0,27,36,0,55,42,0,0,9,0,118,51,1
4668,130097,vZKUVN7akOfrg3MUhYWywDO96JKSOuQ6,7GRhBDsirIGkRZBtSMEzNTyDr2JQm4xx,1,0,0,0,0,0,1,0,1,0.14285714285714285,1,0.0,0,0,0,0,0,0,0,1,0,0,1,1
4669,130151,oaoj9be4jW2Hot8wYgYrzLRvB0RU4KYy,7GRhBDsirIGkRZBtSMEzNTyDr2JQm4xx,40,67,29,85,26,0,8,0,215,30.714285714285715,2,0.0,35,29,61,26,32,0,24,8,0,151,64,0
4670,130203,LXcV10npJRfqlWppXMKHh0qKrwexnute,7GRhBDsirIGkRZBtSMEzNTyDr2JQm4xx,17,21,6,8,4,0,5,0,44,6.285714285714286,1,0.0,13,6,4,4,8,0,4,5,0,27,17,1
4671,130242,Zam8m971nnqnufY6B6yjQg8Ac9iYnqaH,7GRhBDsirIGkRZBtSMEzNTyDr2JQm4xx,5,2,1,0,1,0,2,0,6,0.8571428571428571,1,0.0,0,1,0,1,2,0,0,2,0,2,4,1
4672,130315,p4bGPX0iGz12ZxxYlsOIjappHLYmKQJV,7GRhBDsirIGkRZBtSMEzNTyDr2JQm4xx,1,0,0,0,0,0,1,0,1,0.14285714285714285,1,0.0,0,0,0,0,0,0,0,1,0,0,1,1
4673,130320,ZtUzakjuKRDqOWlwK060v0k740lpF7MK,7GRhBDsirIGkRZBtSMEzNTyDr2JQm4xx,1,0,0,0,0,0,1,0,1,0.14285714285714285,1,0.0,0,0,0,0,0,0,0,1,0,0,1,1
4674,130384,WieFM9Wzak9WsTtSRlJq61lD6faDgSUK,7GRhBDsirIGkRZBtSMEzNTyDr2JQm4xx,1,0,0,0,0,0,1,0,1,0.14285714285714285,1,0.0,0,0,0,0,0,0,0,1,0,0,1,1
4675,130390,fh0UainSPUU5TsARoOfplicce0ntsxfp,5Gyp41oLVo7Gg7vF4vpmggWP5MU70QO6,5,5,3,0,1,0,2,0,11,1.5714285714285714,1,0.0,1,3,0,1,4,0,0,2,0,5,6,1
4676,130407,hXDR8WbSHyxrkc04cKCPP35adA2b4olL,5Gyp41oLVo7Gg7vF4vpmggWP5MU70QO6,24,56,26,14,24,2,9,1,132,18.857142857142858,7,0.0,22,26,11,24,34,2,3,9,1,83,49,1
4677,130408,mjw3GUEcVXrTrbwLTyOBl0brkRiJJKl1,5Gyp41oLVo7Gg7vF4vpmggWP5MU70QO6,7,10,4,0,3,0,3,0,20,2.857142857142857,3,0.0,0,4,0,3,10,0,0,3,0,7,13,1
4678,130420,YrnAzMp4JcyXVbokCMtLBRAQ1vi4YZZE,5Gyp41oLVo7Gg7vF4vpmggWP5MU70QO6,14,37,19,0,10,6,16,1,89,12.714285714285714,7,0.0,1,19,0,10,36,6,0,16,1,30,59,1
4679,130440,MbuXqf7C13S68Qf0iCIWEHpPecEoxyR2,5Gyp41oLVo7Gg7vF4vpmggWP5MU70QO6,18,16,10,0,6,5,14,2,53,7.571428571428571,3,0.0,1,10,0,6,15,5,0,14,2,17,36,0
4680,130451,EyBRRLQ9lC714P9pZPb13KmtdxaOzX2x,5Gyp41oLVo7Gg7vF4vpmggWP5MU70QO6,11,12,4,0,4,1,7,0,28,4.0,3,0.0,1,4,0,4,11,1,0,7,0,9,19,1
4681,130473,XE05vZThEHf17O6FM08AySNf2qZFgNWa,5Gyp41oLVo7Gg7vF4vpmggWP5MU70QO6,30,57,31,17,23,0,4,0,132,18.857142857142858,2,0.0,22,31,15,23,35,0,2,4,0,91,41,1
4682,130482,7ZQaIDzSJzw00mkFN7jwyjy0u4cN8LCV,5Gyp41oLVo7Gg7vF4vpmggWP5MU70QO6,1,0,0,0,0,0,1,0,1,0.14285714285714285,1,0.0,0,0,0,0,0,0,0,1,0,0,1,1
4683,130550,nVktdU2hPjrulp1NoJo2DLy3TGZQ0Uld,5Gyp41oLVo7Gg7vF4vpmggWP5MU70QO6,9,19,10,0,6,9,4,0,48,6.857142857142857,4,0.0,0,10,0,6,19,9,0,4,0,16,32,0
4684,130556,1QdJpYXkKKN8xPym5F8yPuZvkOxYcl3M,5Gyp41oLVo7Gg7vF4vpmggWP5MU70QO6,28,129,69,30,6,134,27,8,403,57.57142857142857,6,0.0,34,69,23,6,95,134,7,27,8,132,271,1
4685,130580,gYi43xr3NINMe9pnjsgYTwfmSH3gyxRj,5Gyp41oLVo7Gg7vF4vpmggWP5MU70QO6,34,55,24,28,16,28,20,1,172,24.571428571428573,7,0.0,12,24,18,16,43,28,10,20,1,70,102,0
4686,130613,J8NkUmSvsrLHkKNXPhFg7o0pG3K7Aywh,5Gyp41oLVo7Gg7vF4vpmggWP5MU70QO6,23,28,13,8,12,15,4,0,80,11.428571428571429,3,0.0,10,13,6,12,18,15,2,4,0,41,39,1
4687,130638,hOR2bCCLFk6wxhHuPZBSgvjYinCMMey8,5Gyp41oLVo7Gg7vF4vpmggWP5MU70QO6,7,3,2,0,2,0,2,0,9,1.2857142857142858,1,0.0,0,2,0,2,3,0,0,2,0,4,5,1
4688,130641,W4K0rgt56uxlLcFDkCAN3yIGeiFMXHWm,5Gyp41oLVo7Gg7vF4vpmggWP5MU70QO6,7,6,4,0,0,1,4,0,15,2.142857142857143,2,0.0,0,4,0,0,6,1,0,4,0,4,11,1
4689,130651,wqJVfyaCwf6JZB5zIYeMip9GWXKaguK7,5Gyp41oLVo7Gg7vF4vpmggWP5MU70QO6,12,10,6,8,3,0,2,0,29,4.142857142857143,2,0.0,1,6,5,3,9,0,3,2,0,15,14,1
4690,130690,7fH8lDsmHFsCAcoTycb5mpkxuj5ii0on,5Gyp41oLVo7Gg7vF4vpmggWP5MU70QO6,7,5,3,0,2,0,4,0,14,2.0,2,0.0,0,3,0,2,5,0,0,4,0,5,9,1
4691,130700,JyOwpTqxlZyOZXFXAlv3kcbVV4zSYrRf,5Gyp41oLVo7Gg7vF4vpmggWP5MU70QO6,36,73,46,1,18,0,12,0,150,21.428571428571427,7,0.0,11,46,1,18,62,0,0,12,0,76,74,1
4692,130719,XNkmquOCIOKVQlufJYaGLATxv204FVab,5Gyp41oLVo7Gg7vF4vpmggWP5MU70QO6,43,200,104,42,56,76,48,2,528,75.42857142857143,9,0.0,57,104,37,56,143,76,5,48,2,254,274,0
4693,130757,aGaqi9cnQPCgRc9cproX6qrgPoZwH926,5Gyp41oLVo7Gg7vF4vpmggWP5MU70QO6,33,81,32,8,15,3,10,0,149,21.285714285714285,5,0.0,25,32,5,15,56,3,3,10,0,77,72,1
4694,130766,OqeQvPHDeSPpa3vUHatLW7ynQapzzDzU,5Gyp41oLVo7Gg7vF4vpmggWP5MU70QO6,1,0,0,0,0,0,1,0,1,0.14285714285714285,1,0.0,0,0,0,0,0,0,0,1,0,0,1,1
4695,130769,VoGvhaJGXYIgQr660bRlWV61m6ihBVHX,5Gyp41oLVo7Gg7vF4vpmggWP5MU70QO6,10,7,4,0,3,0,4,0,18,2.5714285714285716,3,0.0,1,4,0,3,6,0,0,4,0,8,10,1
4696,130778,nGgyxqebKuHTPdYhSowDx2GZk9erlH2Z,5Gyp41oLVo7Gg7vF4vpmggWP5MU70QO6,29,36,14,10,19,3,6,0,88,12.571428571428571,4,0.0,11,14,6,19,25,3,4,6,0,50,38,0
4697,130786,uHzYuHuQRXAr1exd4W7B5yQO5lg5Kd8d,5Gyp41oLVo7Gg7vF4vpmggWP5MU70QO6,23,51,29,16,11,28,12,2,149,21.285714285714285,5,0.0,10,29,13,11,41,28,3,12,2,63,86,0
4698,130790,koffG72zNzMWAAbo1kaArxxqPmsGQsJp,5Gyp41oLVo7Gg7vF4vpmggWP5MU70QO6,41,160,74,93,9,1,29,1,367,52.42857142857143,15,0.0,51,74,79,9,109,1,14,29,1,213,154,1
4699,130796,ow2oX1tGYY5hdod8Bena1bbGOlgMvREE,5Gyp41oLVo7Gg7vF4vpmggWP5MU70QO6,5,2,1,0,1,0,2,0,6,0.8571428571428571,1,0.0,0,1,0,1,2,0,0,2,0,2,4,1
4700,130830,WV3YkTyrIBT24sYf1NcBchbLSWfuPseq,5Gyp41oLVo7Gg7vF4vpmggWP5MU70QO6,54,211,115,74,56,98,25,1,580,82.85714285714286,15,0.0,59,115,65,56,152,98,9,25,1,295,285,0
4701,130874,uqeVvezN3jh1cA0k5AKW1dfEGJzBOqHc,5Gyp41oLVo7Gg7vF4vpmggWP5MU70QO6,4,2,1,0,0,0,2,0,5,0.7142857142857143,1,0.0,0,1,0,0,2,0,0,2,0,1,4,1
4702,130876,Smz6QVjudf9J3ZYU2ZIKVlB0HiqlM9Ly,5Gyp41oLVo7Gg7vF4vpmggWP5MU70QO6,13,27,15,3,5,0,11,0,61,8.714285714285714,3,0.0,4,15,2,5,23,0,1,11,0,26,35,1
4703,130884,ikX72CHxEGhdeCUCpL9omQYpqM8MqHTI,5Gyp41oLVo7Gg7vF4vpmggWP5MU70QO6,7,10,1,0,2,0,2,0,15,2.142857142857143,2,0.0,1,1,0,2,9,0,0,2,0,4,11,1
4704,130899,y8cUu1XxDUCcOgxzUYyZz3iICamX1w7w,5Gyp41oLVo7Gg7vF4vpmggWP5MU70QO6,30,60,39,39,11,17,26,3,195,27.857142857142858,4,0.0,6,39,33,11,54,17,6,26,3,89,106,1
4705,130917,PtpZzYnFVB0EAGJrLQw5AfTDLDGLSqgY,5Gyp41oLVo7Gg7vF4vpmggWP5MU70QO6,11,22,10,0,6,12,8,0,58,8.285714285714286,3,0.0,5,10,0,6,17,12,0,8,0,21,37,1
4706,130938,7RIgMHzHpMzY7qBXHPj6WiDKK3U9H2Wz,5Gyp41oLVo7Gg7vF4vpmggWP5MU70QO6,5,4,2,0,1,0,2,0,9,1.2857142857142858,2,0.0,0,2,0,1,4,0,0,2,0,3,6,1
4707,130974,aAZaBYI2B8G7c2icF8GyQQjSqvcS26rD,5Gyp41oLVo7Gg7vF4vpmggWP5MU70QO6,5,2,0,0,1,0,2,0,5,0.7142857142857143,1,0.0,0,0,0,1,2,0,0,2,0,1,4,1
4708,131000,yzyLIDnRMJLamhEVzGYQIek8GP4CsGht,5Gyp41oLVo7Gg7vF4vpmggWP5MU70QO6,1,0,0,0,0,0,1,0,1,0.14285714285714285,1,0.0,0,0,0,0,0,0,0,1,0,0,1,1
4709,131009,QIQR6VwK3cpUKM5lDzadEKeQATM23w8z,5Gyp41oLVo7Gg7vF4vpmggWP5MU70QO6,7,24,1,0,1,0,1,0,27,3.857142857142857,1,0.0,10,1,0,1,14,0,0,1,0,12,15,1
4710,131027,gK3XDdBxJJXAYJgDo42Lu6DpWYFShLP7,5Gyp41oLVo7Gg7vF4vpmggWP5MU70QO6,4,4,3,0,0,0,3,0,10,1.4285714285714286,1,0.0,0,3,0,0,4,0,0,3,0,3,7,1
4711,131094,BDLXGrCEFzv2QDIDPW2amzBLrTOOGTmn,5Gyp41oLVo7Gg7vF4vpmggWP5MU70QO6,7,2,1,0,1,0,9,0,13,1.8571428571428572,2,0.0,0,1,0,1,2,0,0,9,0,2,11,1
4712,131099,XGm7X3dJTvaV78gJb3qqWyYMOzb4KNWc,5Gyp41oLVo7Gg7vF4vpmggWP5MU70QO6,16,27,10,4,5,1,6,0,53,7.571428571428571,2,0.0,11,10,2,5,16,1,2,6,0,28,25,1
4713,131173,5Pu7cWcFtLFiRZTplFnKu2qWuQ4rAwRa,5Gyp41oLVo7Gg7vF4vpmggWP5MU70QO6,12,14,7,7,3,4,7,0,42,6.0,2,0.0,4,7,5,3,10,4,2,7,0,19,23,1
4714,131194,43KrXQWA5nPYKCMGBRnIKMf2ytZWgrcW,5Gyp41oLVo7Gg7vF4vpmggWP5MU70QO6,12,20,5,3,4,0,6,0,38,5.428571428571429,3,0.0,4,5,2,4,16,0,1,6,0,15,23,1
4715,131222,h39dpjdvVbPQ6zfRX7tyjmchh8nPem2g,5Gyp41oLVo7Gg7vF4vpmggWP5MU70QO6,6,2,1,0,1,0,3,0,7,1.0,1,0.0,0,1,0,1,2,0,0,3,0,2,5,1
4716,131246,bJt9TTbFDYmRC8qapqKfPz3fKvRwaX67,5Gyp41oLVo7Gg7vF4vpmggWP5MU70QO6,16,27,12,0,2,1,11,0,53,7.571428571428571,2,0.0,9,12,0,2,18,1,0,11,0,23,30,1
4717,131250,TNVJ3cJUpM3QJlElfPs5M5WdkwQ2pltF,5Gyp41oLVo7Gg7vF4vpmggWP5MU70QO6,9,11,4,0,2,0,2,0,19,2.7142857142857144,1,0.0,0,4,0,2,11,0,0,2,0,6,13,1
4718,131328,ts0EaKyAxTvfiWPI8iMTLKRxho1uLmjs,5Gyp41oLVo7Gg7vF4vpmggWP5MU70QO6,9,14,8,0,3,7,28,1,61,8.714285714285714,5,0.0,0,8,0,3,14,7,0,28,1,11,50,0
4719,131330,qB7uX9PTKvJKyMfI8P2VS08zJ3k1bFD8,5Gyp41oLVo7Gg7vF4vpmggWP5MU70QO6,9,7,4,0,3,0,2,0,16,2.2857142857142856,1,0.0,0,4,0,3,7,0,0,2,0,7,9,1
4720,131340,keyV9nPgTAWptajZXLslaeIkOfczLyJH,5Gyp41oLVo7Gg7vF4vpmggWP5MU70QO6,25,120,9,47,2,15,22,1,216,30.857142857142858,7,0.0,35,9,41,2,85,15,6,22,1,87,129,1
4721,131347,j8NiIVsE4clxUArccoUEv3yDo7sCD1t3,5Gyp41oLVo7Gg7vF4vpmggWP5MU70QO6,20,31,15,15,7,0,8,0,76,10.857142857142858,5,0.0,9,15,11,7,22,0,4,8,0,42,34,1
4722,131349,fyN7sTjm86IwKs15MRI9xS2BA1QeaB2u,5Gyp41oLVo7Gg7vF4vpmggWP5MU70QO6,8,15,8,0,4,2,5,0,34,4.857142857142857,2,0.0,0,8,0,4,15,2,0,5,0,12,22,1
4723,131355,W33EE7unOY54q9z4VEWWrUPkAAUnkTRs,5Gyp41oLVo7Gg7vF4vpmggWP5MU70QO6,16,25,10,0,8,0,4,0,47,6.714285714285714,3,0.0,6,10,0,8,19,0,0,4,0,24,23,1
4724,131361,jZTK26BTfBLHQKFhPE9kcyNEiSpfCkRJ,5Gyp41oLVo7Gg7vF4vpmggWP5MU70QO6,6,4,2,0,1,0,3,0,10,1.4285714285714286,2,0.0,0,2,0,1,4,0,0,3,0,3,7,1
4725,131378,4OmHGujA2hhASXOuyK0VTrDAmjgn5CTc,5Gyp41oLVo7Gg7vF4vpmggWP5MU70QO6,32,62,36,28,17,34,21,10,208,29.714285714285715,4,0.0,18,36,19,17,44,34,9,21,10,90,118,1
4726,131380,Y5zB0T2K5mJuSWoJzZha51yyGwLdXbtV,5Gyp41oLVo7Gg7vF4vpmggWP5MU70QO6,17,28,10,20,4,11,13,1,87,12.428571428571429,2,0.0,10,10,13,4,18,11,7,13,1,37,50,1
4727,131384,V5yRdaEPt7GW3hq3KhrUY9AEknMr09q2,5Gyp41oLVo7Gg7vF4vpmggWP5MU70QO6,7,4,3,0,1,0,2,0,10,1.4285714285714286,1,0.0,0,3,0,1,4,0,0,2,0,4,6,1
4728,131399,DnbEU5fJzs8Mmed27x4lbJX96rD7FcVo,5Gyp41oLVo7Gg7vF4vpmggWP5MU70QO6,11,8,5,8,3,5,4,0,33,4.714285714285714,2,0.0,1,5,5,3,7,5,3,4,0,14,19,0
4729,131403,hbzMHGarvLe3PTqWPbLXgPXbq3BgvYsO,5Gyp41oLVo7Gg7vF4vpmggWP5MU70QO6,30,66,10,26,0,3,45,2,152,21.714285714285715,9,0.0,11,10,22,0,55,3,4,45,2,43,109,1
4730,131412,Zl23fvvMHDHkGe16GjZx0L7tSLK1ARxE,5Gyp41oLVo7Gg7vF4vpmggWP5MU70QO6,16,18,8,9,4,3,9,2,53,7.571428571428571,2,0.0,5,8,6,4,13,3,3,9,2,23,30,1
4731,131504,6uVIhHqcI4x28sqhjQxrN6olj7DlNEsQ,5Gyp41oLVo7Gg7vF4vpmggWP5MU70QO6,21,32,10,22,6,7,4,1,82,11.714285714285714,3,0.0,7,10,16,6,25,7,6,4,1,39,43,1
4732,131522,DxPgV2DsHShM2ySjb2i9ObZkJr6k1o5D,5Gyp41oLVo7Gg7vF4vpmggWP5MU70QO6,42,68,35,34,16,20,20,9,202,28.857142857142858,9,0.0,12,35,26,16,56,20,8,20,9,89,113,0
4733,131595,tEv4BoLlr0dBgGPraxSbNQaBzkeTtB9W,5Gyp41oLVo7Gg7vF4vpmggWP5MU70QO6,41,88,21,34,20,14,18,1,196,28.0,4,0.0,13,21,27,20,75,14,7,18,1,81,115,1
4734,131602,wsHwZ3NkY1tqHKUuOn0buAOnr2acx1MP,5Gyp41oLVo7Gg7vF4vpmggWP5MU70QO6,2,0,0,0,0,0,2,0,2,0.2857142857142857,2,0.0,0,0,0,0,0,0,0,2,0,0,2,0
4735,131603,Xf8Rm9Od3sFpqFLzTqQbZGr496dUD0aI,5Gyp41oLVo7Gg7vF4vpmggWP5MU70QO6,5,3,1,0,2,0,2,0,8,1.1428571428571428,1,0.0,0,1,0,2,3,0,0,2,0,3,5,1
4736,131657,JhqXqTDDCNKGAy1ZAkKGroaTL2D3J2UP,5Gyp41oLVo7Gg7vF4vpmggWP5MU70QO6,24,24,15,16,7,0,2,0,64,9.142857142857142,3,0.0,6,15,11,7,18,0,5,2,0,39,25,1
4737,131694,pfOsJuHWb0tCShV2tfjxlenGYXv9QGCF,5Gyp41oLVo7Gg7vF4vpmggWP5MU70QO6,9,5,2,0,1,0,5,0,13,1.8571428571428572,2,0.0,0,2,0,1,5,0,0,5,0,3,10,1
4738,131695,bLGCO0LzqYqrv4E17LUKBZyDAIvTEUwU,5Gyp41oLVo7Gg7vF4vpmggWP5MU70QO6,4,2,1,0,1,0,1,0,5,0.7142857142857143,1,0.0,0,1,0,1,2,0,0,1,0,2,3,1
4739,131712,9APdRoqpAZVbJfuWp4zlzd8Py7KWCQpy,5Gyp41oLVo7Gg7vF4vpmggWP5MU70QO6,17,25,12,4,6,0,5,0,52,7.428571428571429,3,0.0,11,12,3,6,14,0,1,5,0,32,20,1
4740,131737,m7ppZFqoqxq4drq32V7wzPII9oNFXP01,5Gyp41oLVo7Gg7vF4vpmggWP5MU70QO6,34,197,78,30,23,42,14,0,384,54.857142857142854,7,0.0,47,78,23,23,150,42,7,14,0,171,213,1
4741,131739,R0QpoGjtADF0I1Axo5DlzbSL8vsaM736,5Gyp41oLVo7Gg7vF4vpmggWP5MU70QO6,10,8,6,0,3,0,2,0,19,2.7142857142857144,1,0.0,1,6,0,3,7,0,0,2,0,10,9,1
4742,131744,y1x8e9Sqq47SjNlkaBvMyt0S6tF2mWwv,5Gyp41oLVo7Gg7vF4vpmggWP5MU70QO6,4,3,1,0,0,0,2,0,6,0.8571428571428571,1,0.0,0,1,0,0,3,0,0,2,0,1,5,1
4743,131782,3EXQpH44dmXe1KuNCn9IRB8zLxVzdC0Z,5Gyp41oLVo7Gg7vF4vpmggWP5MU70QO6,24,34,18,11,9,0,7,0,79,11.285714285714286,5,0.0,10,18,7,9,24,0,4,7,0,44,35,1
4744,131805,SXd9BYBZPMmjo3TQYqcwaqxl3DiSUxvi,5Gyp41oLVo7Gg7vF4vpmggWP5MU70QO6,14,16,10,16,4,25,11,2,84,12.0,2,0.0,3,10,15,4,13,25,1,11,2,32,52,1
4745,131816,1c7Cukk2MxZbKsBARUEyyKrdP5ZLxBnR,5Gyp41oLVo7Gg7vF4vpmggWP5MU70QO6,26,105,11,22,2,19,13,1,173,24.714285714285715,4,0.0,27,11,19,2,78,19,3,13,1,59,114,1
4746,131820,5CW0dW9ZlVdln4ywkh3tNexTpuV4z0gh,5Gyp41oLVo7Gg7vF4vpmggWP5MU70QO6,11,11,5,0,3,12,10,1,42,6.0,2,0.0,0,5,0,3,11,12,0,10,1,8,34,1
4747,131855,M2AmcvqhvMtUlyRV6vMvvoM2IhrMmAwT,5Gyp41oLVo7Gg7vF4vpmggWP5MU70QO6,6,5,2,0,2,0,7,0,16,2.2857142857142856,3,0.0,0,2,0,2,5,0,0,7,0,4,12,1
4748,131873,bbm8yYJyAbMhdjy6Bh1qmHkJg51nIMGA,5Gyp41oLVo7Gg7vF4vpmggWP5MU70QO6,1,0,0,0,0,0,1,0,1,0.14285714285714285,1,0.0,0,0,0,0,0,0,0,1,0,0,1,1
4749,131879,8xYLLlbmIrGkd1CsLlZ6SUCUl7DASCOB,5Gyp41oLVo7Gg7vF4vpmggWP5MU70QO6,8,3,2,0,2,1,4,0,12,1.7142857142857142,1,0.0,0,2,0,2,3,1,0,4,0,4,8,1
4750,131892,zopUGlKgUg69s1rzZoMdsUvam179akTf,5Gyp41oLVo7Gg7vF4vpmggWP5MU70QO6,49,122,57,44,37,20,34,2,316,45.142857142857146,9,0.0,45,57,33,37,77,20,11,34,2,172,144,1
4751,131910,LYbJIF5P9Tku2dhEfjAlbdESdZCIX94V,5Gyp41oLVo7Gg7vF4vpmggWP5MU70QO6,18,45,26,2,8,0,9,0,90,12.857142857142858,6,0.0,8,26,1,8,37,0,1,9,0,43,47,1
4752,131944,F16OuTgaH1ZbsvG4bVnrHtSG2xmdMXNR,5Gyp41oLVo7Gg7vF4vpmggWP5MU70QO6,19,10,0,0,5,3,9,1,28,4.0,2,0.0,0,0,0,5,10,3,0,9,1,5,23,1
4753,131971,rEshrXNp0EMe0kgk6a6QvKN0GvvqP09g,5Gyp41oLVo7Gg7vF4vpmggWP5MU70QO6,5,1,1,0,0,0,3,0,5,0.7142857142857143,1,0.0,0,1,0,0,1,0,0,3,0,1,4,1
4754,131996,SXrnj1e7is63ySeBmVxcG3AQIXrfu0P1,5Gyp41oLVo7Gg7vF4vpmggWP5MU70QO6,10,6,4,0,3,0,3,0,16,2.2857142857142856,1,0.0,0,4,0,3,6,0,0,3,0,7,9,1
4755,132003,LwWEpDPDSnf5fex4u9elAVKzOCsEA2BH,5Gyp41oLVo7Gg7vF4vpmggWP5MU70QO6,3,3,1,0,0,0,1,0,5,0.7142857142857143,1,0.0,0,1,0,0,3,0,0,1,0,1,4,1
4756,132046,v1yqPjxvlDjDstQpp2P9NuO9mCUHsDtx,5Gyp41oLVo7Gg7vF4vpmggWP5MU70QO6,7,3,2,0,2,0,2,0,9,1.2857142857142858,1,0.0,0,2,0,2,3,0,0,2,0,4,5,1
4757,132050,A91LmigajlYmUThAUOB9zyztzjWVIi6k,5Gyp41oLVo7Gg7vF4vpmggWP5MU70QO6,1,0,0,0,0,0,1,0,1,0.14285714285714285,1,0.0,0,0,0,0,0,0,0,1,0,0,1,1
4758,132078,0ciTPUCdCl6053ofk1VnorJgHJzysGWh,5Gyp41oLVo7Gg7vF4vpmggWP5MU70QO6,7,4,3,0,3,0,3,0,13,1.8571428571428572,1,0.0,0,3,0,3,4,0,0,3,0,6,7,1
4759,132112,wodz58MkHQadBU30zkgGJ03KFU838ic3,5Gyp41oLVo7Gg7vF4vpmggWP5MU70QO6,11,15,7,0,4,0,5,0,31,4.428571428571429,3,0.0,2,7,0,4,13,0,0,5,0,13,18,1
4760,132143,dJDejiH7U6IIQkmZAYSYsbGTbsOmnz42,5Gyp41oLVo7Gg7vF4vpmggWP5MU70QO6,7,6,4,0,3,0,2,0,15,2.142857142857143,2,0.0,0,4,0,3,6,0,0,2,0,7,8,1
4761,132165,Eb1mIPZ0KhigdFpE9ChqAfIpfrjfpix8,5Gyp41oLVo7Gg7vF4vpmggWP5MU70QO6,19,69,26,14,1,8,24,1,143,20.428571428571427,5,0.0,17,26,10,1,52,8,4,24,1,54,89,0
4762,132180,8BQYtdVuq0mFTCN9duQN6kZR8TREJ89L,5Gyp41oLVo7Gg7vF4vpmggWP5MU70QO6,9,4,3,0,3,4,9,2,25,3.5714285714285716,2,0.0,0,3,0,3,4,4,0,9,2,6,19,1
4763,132200,MTBKFXeMl374P880k9VePnhSWnznGeS2,5Gyp41oLVo7Gg7vF4vpmggWP5MU70QO6,5,0,0,0,0,2,4,1,7,1.0,1,0.0,0,0,0,0,0,2,0,4,1,0,7,1
4764,132224,CUHsvexAAfaCEMKsM3644JTxXL5DgSss,5Gyp41oLVo7Gg7vF4vpmggWP5MU70QO6,7,2,1,0,1,1,9,0,14,2.0,1,0.0,0,1,0,1,2,1,0,9,0,2,12,1
4765,132248,9m85UD02jbhgpeincAAvgVQkzb9sCXlF,5Gyp41oLVo7Gg7vF4vpmggWP5MU70QO6,1,0,0,0,0,0,1,0,1,0.14285714285714285,1,0.0,0,0,0,0,0,0,0,1,0,0,1,1
4766,132281,kL9QKMHnydkmQKCDQRgleUAavzMbM8XG,5Gyp41oLVo7Gg7vF4vpmggWP5MU70QO6,31,66,40,14,25,7,6,1,159,22.714285714285715,9,0.0,18,40,9,25,48,7,5,6,1,92,67,1
4767,132325,tZjbcx0Le1zQWUOBuj8QARHWw1tgsE24,5Gyp41oLVo7Gg7vF4vpmggWP5MU70QO6,3,0,0,0,0,2,3,0,5,0.7142857142857143,1,0.0,0,0,0,0,0,2,0,3,0,0,5,1
4768,132337,nKmHMMCiSZTSjj45mRupTwWfpHzvUHK8,5Gyp41oLVo7Gg7vF4vpmggWP5MU70QO6,15,40,21,1,9,15,16,0,102,14.571428571428571,3,0.0,5,21,1,9,35,15,0,16,0,36,66,1
4769,132380,x0AlHvqNogu6fpjyTMPAv6SbVNr5iz8A,5Gyp41oLVo7Gg7vF4vpmggWP5MU70QO6,16,53,25,2,9,3,21,3,116,16.571428571428573,6,0.0,16,25,1,9,37,3,1,21,3,51,65,1
4770,132388,RP5IKI5SVXZdpe75SUsUdO2MLCTQcx9c,5Gyp41oLVo7Gg7vF4vpmggWP5MU70QO6,1,0,0,0,0,0,1,0,1,0.14285714285714285,1,0.0,0,0,0,0,0,0,0,1,0,0,1,1
4771,132406,Ax8ieqNjdDJL2m4TR7JMUbvxGU6T4Uzt,5Gyp41oLVo7Gg7vF4vpmggWP5MU70QO6,17,15,9,4,3,2,5,1,39,5.571428571428571,2,0.0,3,9,2,3,12,2,2,5,1,17,22,1
4772,132407,7uYtYieXVdovhdVtTxyxFreDB9cgs1c9,5Gyp41oLVo7Gg7vF4vpmggWP5MU70QO6,18,24,14,0,13,0,7,0,58,8.285714285714286,4,0.0,6,14,0,13,18,0,0,7,0,33,25,0
4773,132418,He3dmXXAyTEoh2CkYGl3GVTmezR6vfVu,5Gyp41oLVo7Gg7vF4vpmggWP5MU70QO6,14,15,6,0,4,0,4,0,29,4.142857142857143,4,0.0,1,6,0,4,14,0,0,4,0,11,18,1
4774,132419,eosk3dY7502Pbg6Dsnx0qWKWUpRTliXK,5Gyp41oLVo7Gg7vF4vpmggWP5MU70QO6,26,36,25,5,10,1,10,0,87,12.428571428571429,6,0.0,2,25,3,10,34,1,2,10,0,40,47,1
4775,132434,YPrwpvfXsBDGAl9mBUenTv0vxHRoreGY,5Gyp41oLVo7Gg7vF4vpmggWP5MU70QO6,1,0,0,0,0,0,1,0,1,0.14285714285714285,1,0.0,0,0,0,0,0,0,0,1,0,0,1,1
4776,132450,ko6uXLGpSTF08zVsdhFmDvgPNLaJOo1o,5Gyp41oLVo7Gg7vF4vpmggWP5MU70QO6,1,0,0,0,0,0,1,0,1,0.14285714285714285,1,0.0,0,0,0,0,0,0,0,1,0,0,1,1
4777,132479,kxygIhpaaZ3PJ4cUkB7uXqGox4OFtNxP,5Gyp41oLVo7Gg7vF4vpmggWP5MU70QO6,9,17,8,0,5,0,5,0,35,5.0,3,0.0,1,8,0,5,16,0,0,5,0,14,21,1
4778,132484,aLMJdr3poOybmwxdbLisljmwiTgCx40t,5Gyp41oLVo7Gg7vF4vpmggWP5MU70QO6,11,8,4,0,5,1,15,0,33,4.714285714285714,2,0.0,2,4,0,5,6,1,0,15,0,11,22,1
4779,132486,YNGYgoeSeYnXDcLFGpC8kMKhHO3mh1hj,5Gyp41oLVo7Gg7vF4vpmggWP5MU70QO6,32,46,20,14,13,15,6,0,114,16.285714285714285,2,0.0,14,20,9,13,32,15,5,6,0,56,58,1
4780,132523,92DRngBnz9eYlBng8rYmQ1zqJi3nHrTg,5Gyp41oLVo7Gg7vF4vpmggWP5MU70QO6,5,2,1,0,1,0,2,0,6,0.8571428571428571,1,0.0,0,1,0,1,2,0,0,2,0,2,4,1
4781,132541,Is3MGErrniCcO5dYPdwXFvVXWaYlygPn,5Gyp41oLVo7Gg7vF4vpmggWP5MU70QO6,26,84,40,19,15,34,30,4,226,32.285714285714285,7,0.0,26,40,11,15,58,34,8,30,4,92,134,1
4782,132543,vRQ3LtbERKPZ8Tl6Ek1qquKxg61fZYCA,5Gyp41oLVo7Gg7vF4vpmggWP5MU70QO6,8,7,5,0,4,0,3,0,19,2.7142857142857144,2,0.0,0,5,0,4,7,0,0,3,0,9,10,1
4783,132573,6Ypoz1HptUjxpuR7fZtuIow2vA2n53uM,5Gyp41oLVo7Gg7vF4vpmggWP5MU70QO6,5,4,2,0,1,0,2,0,9,1.2857142857142858,2,0.0,0,2,0,1,4,0,0,2,0,3,6,1
4784,132582,IrA5M9dNHysg7vRsj0oG84kl9SjifMt1,5Gyp41oLVo7Gg7vF4vpmggWP5MU70QO6,13,11,6,0,3,0,11,0,31,4.428571428571429,2,0.0,1,6,0,3,10,0,0,11,0,10,21,1
4785,132598,cYj2Kix5LwS34n1djiEF2yp2Z1EAdVvF,5Gyp41oLVo7Gg7vF4vpmggWP5MU70QO6,12,9,5,0,3,4,8,9,38,5.428571428571429,1,0.0,2,5,0,3,7,4,0,8,9,10,28,1
4786,132652,dhuAs0ipxVSTXv3LoNDtuzpwxQjaYkG4,5Gyp41oLVo7Gg7vF4vpmggWP5MU70QO6,5,2,1,0,1,0,3,0,7,1.0,1,0.0,0,1,0,1,2,0,0,3,0,2,5,1
4787,132665,oPz83Tur5MkzNcFWvDyvFHFtbqwdcnI2,5Gyp41oLVo7Gg7vF4vpmggWP5MU70QO6,9,8,4,0,4,1,1,0,18,2.5714285714285716,1,0.0,0,4,0,4,8,1,0,1,0,8,10,1
4788,132670,E3rUTd8QKBAWbDGNzVkauwwCc821vcEL,5Gyp41oLVo7Gg7vF4vpmggWP5MU70QO6,1,0,0,0,0,0,3,0,3,0.42857142857142855,3,0.0,0,0,0,0,0,0,0,3,0,0,3,1
4789,132718,lHM7vQGZOBeekTuCVhrRECtVqDAppRah,5Gyp41oLVo7Gg7vF4vpmggWP5MU70QO6,11,10,6,0,4,0,5,0,25,3.5714285714285716,1,0.0,1,6,0,4,9,0,0,5,0,11,14,1
4790,132747,zBiultU9CebUoD46IJPKuNDT62F2VJnh,5Gyp41oLVo7Gg7vF4vpmggWP5MU70QO6,6,3,2,0,2,0,1,0,8,1.1428571428571428,1,0.0,0,2,0,2,3,0,0,1,0,4,4,0
4791,132754,UJzmrw0Uok7c5QcFXwdJlJnRO18e46kw,5Gyp41oLVo7Gg7vF4vpmggWP5MU70QO6,49,99,43,59,24,34,26,2,287,41.0,9,0.0,25,43,48,24,74,34,11,26,2,140,147,1
4792,132780,yqcwkKO0v8H7BNYfyLRaSnVP0uvb1l7l,5Gyp41oLVo7Gg7vF4vpmggWP5MU70QO6,6,3,2,0,2,0,1,0,8,1.1428571428571428,1,0.0,0,2,0,2,3,0,0,1,0,4,4,1
4793,132836,dQCqpXh6bSjQMiiCmgsAGJibQooxCVHx,5Gyp41oLVo7Gg7vF4vpmggWP5MU70QO6,1,0,0,0,0,0,1,0,1,0.14285714285714285,1,0.0,0,0,0,0,0,0,0,1,0,0,1,1
4794,132843,C9NWzqG5VbpKyAa5BJ7vh1T8bQqRBluD,5Gyp41oLVo7Gg7vF4vpmggWP5MU70QO6,13,16,7,0,4,5,10,0,42,6.0,3,0.0,0,7,0,4,16,5,0,10,0,11,31,1
4795,132845,G2OMNMX7YizNWZt8n4FGjdU4ZDefPdme,5Gyp41oLVo7Gg7vF4vpmggWP5MU70QO6,7,3,2,0,2,0,3,0,10,1.4285714285714286,1,0.0,0,2,0,2,3,0,0,3,0,4,6,1
4796,132851,q8lkEz5ux7ymuY9onzKT3TgKTkowCnbu,5Gyp41oLVo7Gg7vF4vpmggWP5MU70QO6,21,24,10,4,11,4,10,1,64,9.142857142857142,2,0.0,11,10,3,11,13,4,1,10,1,35,29,1
4797,132854,3QRWazv1MB7UvBYZ0mTQZIXJueMGJ85k,5Gyp41oLVo7Gg7vF4vpmggWP5MU70QO6,15,58,24,35,0,13,23,6,159,22.714285714285715,5,0.0,18,24,25,0,40,13,10,23,6,67,92,1
4798,132870,0HvazwOy4SOde7XhFx88Am86BQsUAErP,5Gyp41oLVo7Gg7vF4vpmggWP5MU70QO6,24,58,12,23,5,2,18,12,130,18.571428571428573,3,0.0,17,12,15,5,41,2,8,18,12,49,81,1
4799,132899,tCaaBJWExrSBwfO7jaOkCN6P5oM8kOgT,5Gyp41oLVo7Gg7vF4vpmggWP5MU70QO6,28,54,36,40,13,0,10,1,154,22.0,3,0.0,13,36,24,13,41,0,16,10,1,86,68,0
4800,132956,cbKRb3sP1zVAfa9Zatv3RkWNfcW2zkBa,5Gyp41oLVo7Gg7vF4vpmggWP5MU70QO6,5,4,2,0,0,0,2,0,8,1.1428571428571428,1,0.0,0,2,0,0,4,0,0,2,0,2,6,1
4801,132961,SIYCK8ATsKzkptD3U3uig9bh8DBamXxY,5Gyp41oLVo7Gg7vF4vpmggWP5MU70QO6,20,35,15,0,18,0,7,0,75,10.714285714285714,4,0.0,15,15,0,18,20,0,0,7,0,48,27,0
4802,132971,DOaBjaIUR8EKUl1c6qN6cFAfQ2a4tFw5,5Gyp41oLVo7Gg7vF4vpmggWP5MU70QO6,1,0,0,0,0,0,1,0,1,0.14285714285714285,1,0.0,0,0,0,0,0,0,0,1,0,0,1,1
4803,133008,z9IJK1H3SfF2B12kwDvfcSB1ThWvraIJ,5Gyp41oLVo7Gg7vF4vpmggWP5MU70QO6,20,57,23,23,7,23,16,3,152,21.714285714285715,6,0.0,17,23,16,7,40,23,7,16,3,63,89,1
4804,133010,VzBpUg1iDEGcx0TVgzByc2Ga25gtHxK4,5Gyp41oLVo7Gg7vF4vpmggWP5MU70QO6,11,14,6,0,3,1,6,1,31,4.428571428571429,1,0.0,0,6,0,3,14,1,0,6,1,9,22,0
4805,133125,TigSXIZ3l1yiTHn0dCXNXs74pLSKNppc,5Gyp41oLVo7Gg7vF4vpmggWP5MU70QO6,30,71,40,34,23,11,16,4,199,28.428571428571427,9,0.0,21,40,25,23,50,11,9,16,4,109,90,1
4806,133131,TlWZZCkE66jOCXoa4aSVNx14pMBEd33v,5Gyp41oLVo7Gg7vF4vpmggWP5MU70QO6,8,4,2,0,1,0,4,1,12,1.7142857142857142,1,0.0,1,2,0,1,3,0,0,4,1,4,8,1
4807,133164,n7ad9aSATtX9NdHV2NBgff8LjuVUEyxS,5Gyp41oLVo7Gg7vF4vpmggWP5MU70QO6,9,2,2,0,1,2,10,1,18,2.5714285714285716,1,0.0,0,2,0,1,2,2,0,10,1,3,15,1
4808,133174,yfSRXUXIq6SsIbv2yHfkbd1lMI4MUQuG,5Gyp41oLVo7Gg7vF4vpmggWP5MU70QO6,10,7,4,1,2,0,5,0,19,2.7142857142857144,1,0.0,1,4,1,2,6,0,0,5,0,8,11,1
4809,133190,Z0BVFzsmuTfwpPZa3KK0vNiQpnGQvB7P,5Gyp41oLVo7Gg7vF4vpmggWP5MU70QO6,7,4,3,0,3,0,2,0,12,1.7142857142857142,1,0.0,0,3,0,3,4,0,0,2,0,6,6,1
4810,133193,qciW3eHpuKm9iUPQVKuwWV8dfW8XAZ18,5Gyp41oLVo7Gg7vF4vpmggWP5MU70QO6,19,53,27,0,7,13,16,0,116,16.571428571428573,12,0.0,6,27,0,7,47,13,0,16,0,40,76,1
4811,133200,BKfnFDMm8snkyQWQxLALiUCxnWj3j64N,5Gyp41oLVo7Gg7vF4vpmggWP5MU70QO6,4,2,1,0,0,0,2,0,5,0.7142857142857143,1,0.0,0,1,0,0,2,0,0,2,0,1,4,1
4812,133203,23oixcFTyMb5yEChATjRs45rlurHDtZg,5Gyp41oLVo7Gg7vF4vpmggWP5MU70QO6,5,1,1,0,0,1,4,0,7,1.0,1,0.0,0,1,0,0,1,1,0,4,0,1,6,1
4813,133226,BX8KZktSpp7qRNeftrJD7dKRaVhtg4o2,5Gyp41oLVo7Gg7vF4vpmggWP5MU70QO6,5,2,1,0,1,0,3,0,7,1.0,1,0.0,0,1,0,1,2,0,0,3,0,2,5,1
4814,133234,R8i15NDgSXCxnHS0gE9L3by2MtCSeEIc,5Gyp41oLVo7Gg7vF4vpmggWP5MU70QO6,6,4,3,0,1,0,1,0,9,1.2857142857142858,1,0.0,0,3,0,1,4,0,0,1,0,4,5,1
4815,133249,cjIjalOkynRvNiMkIirdnL3eRD5dBGGC,5Gyp41oLVo7Gg7vF4vpmggWP5MU70QO6,8,6,2,0,1,0,11,0,20,2.857142857142857,5,0.0,0,2,0,1,6,0,0,11,0,3,17,1
4816,133261,03LL3Qts3sw7LfZgogCHsUXr6C3yxlnd,5Gyp41oLVo7Gg7vF4vpmggWP5MU70QO6,10,3,3,0,3,0,8,1,18,2.5714285714285716,1,0.0,0,3,0,3,3,0,0,8,1,6,12,1
4817,133263,k7UuP7854KwiR2G5Rvk90CqeMYmrVmLp,5Gyp41oLVo7Gg7vF4vpmggWP5MU70QO6,14,32,14,16,6,15,9,0,92,13.142857142857142,2,0.0,11,14,12,6,21,15,4,9,0,43,49,1
4818,133345,azsfvKoTKLQ8ipwpPOtqZMAvWCpOjcns,5Gyp41oLVo7Gg7vF4vpmggWP5MU70QO6,8,4,3,0,2,0,3,0,12,1.7142857142857142,2,0.0,0,3,0,2,4,0,0,3,0,5,7,1
4819,133352,XgjQoYTAIZUQmEkeBN1q8wGOZcMHBH63,5Gyp41oLVo7Gg7vF4vpmggWP5MU70QO6,3,2,0,0,0,0,1,0,3,0.42857142857142855,1,0.0,0,0,0,0,2,0,0,1,0,0,3,1
4820,133357,tyqJZzEML3JHaVtb5u1xmf4a7Of5P3tA,5Gyp41oLVo7Gg7vF4vpmggWP5MU70QO6,9,6,4,0,2,0,4,0,16,2.2857142857142856,1,0.0,0,4,0,2,6,0,0,4,0,6,10,1
4821,133358,BD1myLDsp1cWJRs3OVKHuveNwgVTzT9S,5Gyp41oLVo7Gg7vF4vpmggWP5MU70QO6,8,9,3,0,2,0,3,0,17,2.4285714285714284,2,0.0,0,3,0,2,9,0,0,3,0,5,12,1
4822,133372,IAfLUodwXUDQZ7fHMTbvgcyqIHlBdURZ,5Gyp41oLVo7Gg7vF4vpmggWP5MU70QO6,6,3,1,0,1,0,3,0,8,1.1428571428571428,1,0.0,0,1,0,1,3,0,0,3,0,2,6,1
4823,133373,tmDCjfvFzsLXNJOsSalKtMeHilqBCK5i,5Gyp41oLVo7Gg7vF4vpmggWP5MU70QO6,9,6,3,0,2,0,5,0,16,2.2857142857142856,3,0.0,0,3,0,2,6,0,0,5,0,5,11,1
4824,133379,0d6GVIoz6wgxFRQyqZwP8S5bKktUshxJ,5Gyp41oLVo7Gg7vF4vpmggWP5MU70QO6,1,0,0,0,0,0,1,0,1,0.14285714285714285,1,0.0,0,0,0,0,0,0,0,1,0,0,1,1
4825,133402,T9568NbVeTbUTmE4rk1xM0kbLMHudWM2,5Gyp41oLVo7Gg7vF4vpmggWP5MU70QO6,4,2,1,0,1,0,1,0,5,0.7142857142857143,1,0.0,0,1,0,1,2,0,0,1,0,2,3,1
4826,133403,9NtQ7PjkuhRpKAXpOSS5PoVkdaWYCjac,5Gyp41oLVo7Gg7vF4vpmggWP5MU70QO6,1,0,0,0,0,0,2,0,2,0.2857142857142857,1,0.0,0,0,0,0,0,0,0,2,0,0,2,1
4827,133412,nnAFgrjzFRJhpmRSWYDef5PvUtf0piIv,5Gyp41oLVo7Gg7vF4vpmggWP5MU70QO6,6,1,1,0,1,0,4,0,7,1.0,1,0.0,0,1,0,1,1,0,0,4,0,2,5,1
4828,133424,8rI72y7lNYBVrRyE6hS0uBCfocFsM80l,5Gyp41oLVo7Gg7vF4vpmggWP5MU70QO6,22,59,19,6,11,2,10,0,107,15.285714285714286,3,0.0,20,19,6,11,39,2,0,10,0,56,51,1
4829,133508,bWkoiaX3qYePD2I6BiCrFyAyCl2ds7KU,5Gyp41oLVo7Gg7vF4vpmggWP5MU70QO6,1,0,0,0,0,0,1,0,1,0.14285714285714285,1,0.0,0,0,0,0,0,0,0,1,0,0,1,1
4830,133535,yjxhxXzkMkPSCxXcQ3QOPUmqjUCbiXsw,5Gyp41oLVo7Gg7vF4vpmggWP5MU70QO6,1,0,0,0,0,0,1,0,1,0.14285714285714285,1,0.0,0,0,0,0,0,0,0,1,0,0,1,1
4831,133551,cMU7RK63TPqPAq4a6icli8lzOkQ3VauZ,5Gyp41oLVo7Gg7vF4vpmggWP5MU70QO6,7,3,2,0,2,0,5,0,12,1.7142857142857142,2,0.0,0,2,0,2,3,0,0,5,0,4,8,1
4832,133575,VgX5Bev4AVzFoIGqTO3nKDRUm7GXUXqQ,5Gyp41oLVo7Gg7vF4vpmggWP5MU70QO6,15,32,16,6,5,4,10,2,75,10.714285714285714,2,0.0,6,16,4,5,26,4,2,10,2,31,44,1
4833,133615,2K5xqqC4Eq68C8x6EHoN1vuQVGlHvK86,5Gyp41oLVo7Gg7vF4vpmggWP5MU70QO6,12,22,13,32,4,12,4,0,87,12.428571428571429,1,0.0,6,13,19,4,16,12,13,4,0,42,45,1
4834,133635,geyYxnlqDtNpjstCYyrTeWLmk3gVcwKX,5Gyp41oLVo7Gg7vF4vpmggWP5MU70QO6,9,13,6,0,4,2,6,0,31,4.428571428571429,2,0.0,4,6,0,4,9,2,0,6,0,14,17,1
4835,133661,WpV2Wlof9MraqpUtf0YtVcSV1vZvNCQB,5Gyp41oLVo7Gg7vF4vpmggWP5MU70QO6,9,7,3,4,4,0,1,0,19,2.7142857142857144,1,0.0,3,3,2,4,4,0,2,1,0,12,7,1
4836,133694,6Rsqjmf5ottzWRdYfF7VLLIdh5beRdNj,5Gyp41oLVo7Gg7vF4vpmggWP5MU70QO6,1,0,0,0,0,0,1,0,1,0.14285714285714285,1,0.0,0,0,0,0,0,0,0,1,0,0,1,1
4837,133709,nE23LYiQpabdXkj6YvKSja9sZnHRizmo,5Gyp41oLVo7Gg7vF4vpmggWP5MU70QO6,12,39,13,0,9,6,9,1,77,11.0,3,0.0,9,13,0,9,30,6,0,9,1,31,46,1
4838,133712,t3ySM4Gbs4aIhGFWYbt2nw6OG5oriaOF,5Gyp41oLVo7Gg7vF4vpmggWP5MU70QO6,16,16,12,2,4,1,6,0,41,5.857142857142857,2,0.0,1,12,1,4,15,1,1,6,0,18,23,0
4839,133725,y1j2BJeUX3clfpIS8z8YGMmOflVcd268,5Gyp41oLVo7Gg7vF4vpmggWP5MU70QO6,6,6,3,0,1,0,5,0,15,2.142857142857143,3,0.0,0,3,0,1,6,0,0,5,0,4,11,1
4840,133727,cjAGPVLksLUH2S2TlVLen0Rma4ZtMpJ0,5Gyp41oLVo7Gg7vF4vpmggWP5MU70QO6,16,13,11,0,5,0,4,0,33,4.714285714285714,2,0.0,0,11,0,5,13,0,0,4,0,16,17,1
4841,133732,W1VI3sqHrUlEcaB1jLOlWmlomraJVsFV,5Gyp41oLVo7Gg7vF4vpmggWP5MU70QO6,10,7,5,0,4,8,9,2,35,5.0,1,0.0,0,5,0,4,7,8,0,9,2,9,26,1
4842,133761,wTjeh5kqsxGUEAu30OJ2FVzPxkqRYfsX,5Gyp41oLVo7Gg7vF4vpmggWP5MU70QO6,11,17,0,11,2,0,2,0,32,4.571428571428571,1,0.0,9,0,8,2,8,0,3,2,0,19,13,1
4843,133765,aldLXGpzmiip2CUSDhqN8A5UpGMVUHxY,5Gyp41oLVo7Gg7vF4vpmggWP5MU70QO6,13,29,18,5,7,0,7,0,66,9.428571428571429,4,0.0,5,18,3,7,24,0,2,7,0,33,33,1
4844,133770,faTFbhzc3mhNTFTqM92hVZkx0r9f7ol4,5Gyp41oLVo7Gg7vF4vpmggWP5MU70QO6,1,0,0,0,0,0,1,0,1,0.14285714285714285,1,0.0,0,0,0,0,0,0,0,1,0,0,1,1
4845,133773,ovvuiEhj0QBv4xi11GVjXr8JhlCgaPmd,5Gyp41oLVo7Gg7vF4vpmggWP5MU70QO6,24,41,23,34,11,0,18,0,127,18.142857142857142,4,0.0,15,23,24,11,26,0,10,18,0,73,54,0
4846,133778,X9IKf8GgqS6dvoKX3VBo51mIr8yb4uFC,5Gyp41oLVo7Gg7vF4vpmggWP5MU70QO6,1,0,0,0,0,0,1,0,1,0.14285714285714285,1,0.0,0,0,0,0,0,0,0,1,0,0,1,1
4847,133834,Ml4sacNrRuYKCZt13mrJhwNSftih0uvX,5Gyp41oLVo7Gg7vF4vpmggWP5MU70QO6,7,11,7,0,3,0,3,0,24,3.4285714285714284,2,0.0,1,7,0,3,10,0,0,3,0,11,13,1
4848,133875,DxH75iZ2vwK7RWdx8JWNqysBZPhRedJP,5Gyp41oLVo7Gg7vF4vpmggWP5MU70QO6,10,10,6,0,4,0,4,0,24,3.4285714285714284,2,0.0,0,6,0,4,10,0,0,4,0,10,14,1
4849,133982,xAn64qd6elbFZJJcszNUW2n3zQLlhEwM,5Gyp41oLVo7Gg7vF4vpmggWP5MU70QO6,1,0,0,0,0,0,1,0,1,0.14285714285714285,1,0.0,0,0,0,0,0,0,0,1,0,0,1,1
4850,134051,2mxSfvrV4dprNDPX9sOXqPpvnwSid2Cc,5Gyp41oLVo7Gg7vF4vpmggWP5MU70QO6,10,12,6,6,3,3,3,0,33,4.714285714285714,2,0.0,3,6,4,3,9,3,2,3,0,16,17,1
4851,134075,3Lm0MGQaaapsScRaTvcsyp7k33RXoGQK,5Gyp41oLVo7Gg7vF4vpmggWP5MU70QO6,5,2,2,0,2,0,2,0,8,1.1428571428571428,2,0.0,0,2,0,2,2,0,0,2,0,4,4,1
4852,134078,pMvI3GodgpgPSXQ0MPCwiqmmXOZLm2f3,5Gyp41oLVo7Gg7vF4vpmggWP5MU70QO6,8,3,2,0,2,0,4,0,11,1.5714285714285714,1,0.0,0,2,0,2,3,0,0,4,0,4,7,1
4853,134101,5uNVqz3akJM39GMi4L72zo2iwNTdRLcd,5Gyp41oLVo7Gg7vF4vpmggWP5MU70QO6,1,0,0,0,0,0,1,0,1,0.14285714285714285,1,0.0,0,0,0,0,0,0,0,1,0,0,1,1
4854,134103,5eLv42QNHH4xOv2fRiDesiSc1hAZtDPF,5Gyp41oLVo7Gg7vF4vpmggWP5MU70QO6,1,0,0,0,0,0,1,0,1,0.14285714285714285,1,0.0,0,0,0,0,0,0,0,1,0,0,1,1
4855,134114,vkVcAL32x89gCUbijn0COpSie0zSVcTg,5Gyp41oLVo7Gg7vF4vpmggWP5MU70QO6,12,19,8,1,6,6,10,1,51,7.285714285714286,5,0.0,1,8,1,6,18,6,0,10,1,16,35,1
4856,134120,nBPo5EhaP0gkjW850tZUTuZiIJfWNxJW,5Gyp41oLVo7Gg7vF4vpmggWP5MU70QO6,1,0,0,0,0,0,1,0,1,0.14285714285714285,1,0.0,0,0,0,0,0,0,0,1,0,0,1,1
4857,134150,m6zBjlzTm9i43E1MJ5Zz1er2kLxNazQn,5Gyp41oLVo7Gg7vF4vpmggWP5MU70QO6,4,2,1,0,1,0,1,0,5,0.7142857142857143,1,0.0,0,1,0,1,2,0,0,1,0,2,3,1
4858,134198,egpXv13dykaiU64GCgTaQGg1ErRD7Rsb,5Gyp41oLVo7Gg7vF4vpmggWP5MU70QO6,5,2,1,0,1,1,2,0,7,1.0,1,0.0,0,1,0,1,2,1,0,2,0,2,5,1
4859,134209,z4d2NsCc0hNwoqw5mRmP28xZ3tEFcThU,5Gyp41oLVo7Gg7vF4vpmggWP5MU70QO6,1,0,0,0,0,0,1,0,1,0.14285714285714285,1,0.0,0,0,0,0,0,0,0,1,0,0,1,1
4860,134215,3OiI63m3MT3NUNFqZaAImnuYkxAn963I,5Gyp41oLVo7Gg7vF4vpmggWP5MU70QO6,1,0,0,0,0,0,1,0,1,0.14285714285714285,1,0.0,0,0,0,0,0,0,0,1,0,0,1,1
4861,134220,jt9bBApOzSH9euvQei6FRx8YbWJCqV7e,5Gyp41oLVo7Gg7vF4vpmggWP5MU70QO6,36,90,49,21,26,100,24,8,318,45.42857142857143,4,0.0,27,49,14,26,63,100,7,24,8,116,202,1
4862,134276,Y3ZpN8DOQK8YTfD0eUtklxiZfpWuBIeU,5Gyp41oLVo7Gg7vF4vpmggWP5MU70QO6,11,16,8,2,5,0,5,0,36,5.142857142857143,5,0.0,1,8,1,5,15,0,1,5,0,15,21,1
4863,134284,suNv6s4qyxf9N0tzvwEfVP5WvS3f14Ct,5Gyp41oLVo7Gg7vF4vpmggWP5MU70QO6,10,9,4,0,2,1,12,0,28,4.0,1,0.0,3,4,0,2,6,1,0,12,0,9,19,1
4864,134306,O6XAdqAZFVBAUEpdhD9kWD0CFc9DXbDC,5Gyp41oLVo7Gg7vF4vpmggWP5MU70QO6,3,3,1,0,0,0,1,0,5,0.7142857142857143,1,0.0,0,1,0,0,3,0,0,1,0,1,4,0
4865,134308,CqWhDDeGW7h5JgvzJmQmXBexDHXnQAzm,5Gyp41oLVo7Gg7vF4vpmggWP5MU70QO6,11,23,13,7,9,0,5,0,57,8.142857142857142,3,0.0,6,13,5,9,17,0,2,5,0,33,24,1
4866,134387,4NJSDA3iz7Etb6QbBYbJSN7TbV2jAaSn,5Gyp41oLVo7Gg7vF4vpmggWP5MU70QO6,5,2,1,0,1,0,2,0,6,0.8571428571428571,1,0.0,0,1,0,1,2,0,0,2,0,2,4,1
4867,134407,qe6VOiR93QevgvLihSI3D1o8mQwi8vSS,5Gyp41oLVo7Gg7vF4vpmggWP5MU70QO6,18,33,17,27,4,22,10,1,114,16.285714285714285,2,0.0,5,17,22,4,28,22,5,10,1,48,66,1
4868,134417,5lbqOJbZSZ6HXtO2ffOGMTGFEi1gpAqu,5Gyp41oLVo7Gg7vF4vpmggWP5MU70QO6,13,14,5,8,3,2,5,0,37,5.285714285714286,4,0.0,3,5,5,3,11,2,3,5,0,16,21,0
4869,134422,2nldnsy5rbVYOoSRF9wOfZBPQ2SkCsmR,5Gyp41oLVo7Gg7vF4vpmggWP5MU70QO6,7,1,1,0,1,4,5,1,13,1.8571428571428572,2,0.0,0,1,0,1,1,4,0,5,1,2,11,1
4870,134423,8EJCCc65R0KMbJuROvvgWCHEphC2dl1r,5Gyp41oLVo7Gg7vF4vpmggWP5MU70QO6,8,19,1,0,0,1,4,1,26,3.7142857142857144,4,0.0,2,1,0,0,17,1,0,4,1,3,23,1
4871,134429,IR9p9WuPGPaaA4f6RkgkUYRRmOTg8aPE,5Gyp41oLVo7Gg7vF4vpmggWP5MU70QO6,5,5,3,0,0,0,2,0,10,1.4285714285714286,2,0.0,0,3,0,0,5,0,0,2,0,3,7,1
4872,134445,0NCTyOo901OVKDz27kIQS9Y956NzR3lw,5Gyp41oLVo7Gg7vF4vpmggWP5MU70QO6,1,0,0,0,0,0,1,0,1,0.14285714285714285,1,0.0,0,0,0,0,0,0,0,1,0,0,1,1
4873,134466,JsqrqubnjjSuqmmuivzKTDyASkdX1tsp,5Gyp41oLVo7Gg7vF4vpmggWP5MU70QO6,15,24,11,13,6,18,37,5,114,16.285714285714285,5,0.0,6,11,8,6,18,18,5,37,5,31,83,1
4874,134472,uPCPOUDpxWJduDoVPsy1fYZmO6054lHN,5Gyp41oLVo7Gg7vF4vpmggWP5MU70QO6,6,10,5,0,0,0,5,0,20,2.857142857142857,1,0.0,2,5,0,0,8,0,0,5,0,7,13,1
4875,134480,R2m4YrxCqiiAHfIiEC5uncyqARtSGS0y,5Gyp41oLVo7Gg7vF4vpmggWP5MU70QO6,19,38,16,4,6,2,10,1,77,11.0,3,0.0,14,16,2,6,24,2,2,10,1,38,39,1
4876,134531,4n0eavxCNp4F6LlqtEg5gsmyBVEbRBeE,5Gyp41oLVo7Gg7vF4vpmggWP5MU70QO6,5,6,2,0,0,0,2,0,10,1.4285714285714286,2,0.0,0,2,0,0,6,0,0,2,0,2,8,1
4877,134532,28yg84GTsqSiqbTwC56qeBzdvnj4wMZv,5Gyp41oLVo7Gg7vF4vpmggWP5MU70QO6,7,2,2,0,2,1,2,0,9,1.2857142857142858,1,0.0,0,2,0,2,2,1,0,2,0,4,5,1
4878,134541,avoglTQYC4DCKpMnGcRw7Ok57lEHfs0W,5Gyp41oLVo7Gg7vF4vpmggWP5MU70QO6,3,2,0,0,0,0,1,0,3,0.42857142857142855,1,0.0,0,0,0,0,2,0,0,1,0,0,3,1
4879,134556,80FzckKMcjX2YzXWS8il05lgsWZtocLs,5Gyp41oLVo7Gg7vF4vpmggWP5MU70QO6,4,3,1,0,1,0,1,0,6,0.8571428571428571,1,0.0,0,1,0,1,3,0,0,1,0,2,4,1
4880,134588,LPMhjI3h6mFXpXBZjU0jtQZvPuOgNRuf,5Gyp41oLVo7Gg7vF4vpmggWP5MU70QO6,13,8,4,20,2,0,3,0,37,5.285714285714286,1,0.0,3,4,13,2,5,0,7,3,0,22,15,1
4881,134595,gJUfHJ2wWISOJgd5TbsWe9Siq0yQvk0W,5Gyp41oLVo7Gg7vF4vpmggWP5MU70QO6,7,3,2,0,2,0,8,0,15,2.142857142857143,2,0.0,0,2,0,2,3,0,0,8,0,4,11,1
4882,134606,Prrs6qy7xXui2Ej7yuJXKp7kQw6K0nqs,5Gyp41oLVo7Gg7vF4vpmggWP5MU70QO6,1,0,0,0,0,0,2,0,2,0.2857142857142857,1,0.0,0,0,0,0,0,0,0,2,0,0,2,1
4883,134616,1YxknoiTrSwQgclDlSAh4oMYHRyARhLv,5Gyp41oLVo7Gg7vF4vpmggWP5MU70QO6,12,20,11,4,6,0,5,0,46,6.571428571428571,4,0.0,4,11,3,6,16,0,1,5,0,24,22,1
4884,134673,CdvI2pWKjGfqwnwuVxKzSINgvBVPDdaK,5Gyp41oLVo7Gg7vF4vpmggWP5MU70QO6,5,2,1,0,1,0,2,0,6,0.8571428571428571,1,0.0,0,1,0,1,2,0,0,2,0,2,4,1
4885,134682,AXqr0LdPJZsdJteg9sqYmDFslCYWC1PW,5Gyp41oLVo7Gg7vF4vpmggWP5MU70QO6,4,0,0,0,0,1,4,0,5,0.7142857142857143,1,0.0,0,0,0,0,0,1,0,4,0,0,5,1
4886,134688,98r1yyZ02P5Yb7DOkeUA6eb8RHK6juvp,5Gyp41oLVo7Gg7vF4vpmggWP5MU70QO6,40,51,21,29,3,0,15,0,119,17.0,4,0.0,25,21,25,3,26,0,4,15,0,74,45,0
4887,134769,DaPZ04CzdmZpYNv6D5HKU5y6m7fiHdwl,5Gyp41oLVo7Gg7vF4vpmggWP5MU70QO6,13,8,5,0,7,4,4,1,29,4.142857142857143,1,0.0,2,5,0,7,6,4,0,4,1,14,15,1
4888,134785,nHbx8yX1YYdHfiz0xMuE9LDMpuoeGBJU,5Gyp41oLVo7Gg7vF4vpmggWP5MU70QO6,1,0,0,0,0,0,1,0,1,0.14285714285714285,1,0.0,0,0,0,0,0,0,0,1,0,0,1,1
4889,134787,r7waeiZCMRqIGgK89BcNGxoITAFygxso,5Gyp41oLVo7Gg7vF4vpmggWP5MU70QO6,6,4,2,0,1,0,4,0,11,1.5714285714285714,1,0.0,0,2,0,1,4,0,0,4,0,3,8,1
4890,134796,Z4kedXjIF6f3uubwtldCvvLQcT4vIEro,5Gyp41oLVo7Gg7vF4vpmggWP5MU70QO6,5,4,2,0,1,0,2,0,9,1.2857142857142858,2,0.0,0,2,0,1,4,0,0,2,0,3,6,1
4891,134810,3C0mHGKR8yeSwkl2DOw1ueYpCB49HMxe,5Gyp41oLVo7Gg7vF4vpmggWP5MU70QO6,1,0,0,0,0,0,1,0,1,0.14285714285714285,1,0.0,0,0,0,0,0,0,0,1,0,0,1,1
4892,134811,5Dk7QJtqh7ATnN1jDaFE4dN4E1GugvAr,5Gyp41oLVo7Gg7vF4vpmggWP5MU70QO6,8,6,4,0,3,0,3,0,16,2.2857142857142856,2,0.0,0,4,0,3,6,0,0,3,0,7,9,1
4893,134872,PxG7IoSWl51ORQBfTGOZMHMVnXiWDk5u,5Gyp41oLVo7Gg7vF4vpmggWP5MU70QO6,6,5,3,0,2,0,4,0,14,2.0,1,0.0,0,3,0,2,5,0,0,4,0,5,9,1
4894,134875,8XstJLDa8agdHppUFVVZbvtgkIjc1hSo,5Gyp41oLVo7Gg7vF4vpmggWP5MU70QO6,15,44,23,10,8,2,17,0,104,14.857142857142858,11,0.0,4,23,5,8,40,2,5,17,0,40,64,1
4895,134885,Ybc642CAm4ubx0xh2F3kNoipp1rEZVzf,5Gyp41oLVo7Gg7vF4vpmggWP5MU70QO6,1,0,0,0,0,0,1,0,1,0.14285714285714285,1,0.0,0,0,0,0,0,0,0,1,0,0,1,1
4896,134896,EkpYyl5FvOIbAuPgHjdTptqbWAlVTTOe,5Gyp41oLVo7Gg7vF4vpmggWP5MU70QO6,1,0,0,0,0,0,1,0,1,0.14285714285714285,1,0.0,0,0,0,0,0,0,0,1,0,0,1,1
4897,134914,yNC8T7gdWO96Y2q3tzTQeJUMY0F51xnO,SpATywNh6bZuzm8s1ceuBUnMUAeoAHHw,9,9,4,9,0,0,3,0,25,3.5714285714285716,2,0.0,3,4,8,0,6,0,1,3,0,15,10,0
4898,135043,XoKIP4RGpnZk163890vUyWhLOIUSaapU,A3fsA9Zfv1X2fVEQhTw51lKENdNrEqT3,62,35,18,166,11,7,3,0,240,34.285714285714285,2,0.0,2,18,131,11,33,7,35,3,0,162,78,1
4899,135069,bgBLWArC7sr7mZdIi75AaJrBI0yN4gRx,SpATywNh6bZuzm8s1ceuBUnMUAeoAHHw,18,46,3,25,3,0,8,0,85,12.142857142857142,3,0.0,22,3,19,3,24,0,6,8,0,47,38,0
4900,135159,yAxjMvvPF3HDitgCGIcnFlXrbnOszGcQ,bWdj2GDclj5ofokWjzoa5jAwMkxCykd6,4,2,0,0,0,0,2,0,4,0.5714285714285714,1,0.0,0,0,0,0,2,0,0,2,0,0,4,1
4901,135321,x6BtQH70uuLHaxqzHA21U9wmfT0SxzD9,G8EPVSXsOYB5YQWZGiz1aVq5Pgr2GrQu,13,12,0,0,0,0,7,0,19,2.7142857142857144,3,0.0,0,0,0,0,12,0,0,7,0,0,19,1
4902,135333,Hmy7IERSuMBFx0LPTwulENadvjRMvkqo,SpATywNh6bZuzm8s1ceuBUnMUAeoAHHw,9,13,6,4,0,0,3,0,26,3.7142857142857144,1,0.0,4,6,3,0,9,0,1,3,0,13,13,1
4903,135527,kF53IpFKMxCV7VctlhpV2lrkHuEbgiU3,RXDvfPUBYFlVdlueBFbLW0mhhAyGEqpt,33,32,20,34,11,9,6,8,120,17.142857142857142,2,0.0,12,20,33,11,20,9,1,6,8,76,44,0
4904,135559,LPkDtPFF5RxOnDnsqEeKxwZe2JS0rusW,SpATywNh6bZuzm8s1ceuBUnMUAeoAHHw,5,6,2,0,2,0,1,0,11,1.5714285714285714,1,0.0,0,2,0,2,6,0,0,1,0,4,7,1
4905,135594,gikp9GqTKNuof6stdLjZVJv1OHEXFMyZ,G8EPVSXsOYB5YQWZGiz1aVq5Pgr2GrQu,16,32,16,13,0,0,1,0,62,8.857142857142858,2,0.0,14,16,8,0,18,0,5,1,0,38,24,0
4906,135625,OQFJERUfDkJREmuh848c2NVEfKc13k0Z,SpATywNh6bZuzm8s1ceuBUnMUAeoAHHw,3,2,1,0,0,0,2,0,5,0.7142857142857143,1,0.0,0,1,0,0,2,0,0,2,0,1,4,1
4907,135721,pvAe37z1FjLTGYdwlJFjXex25zlpyHtu,G8EPVSXsOYB5YQWZGiz1aVq5Pgr2GrQu,8,6,0,0,0,0,4,0,10,1.4285714285714286,2,0.0,0,0,0,0,6,0,0,4,0,0,10,1
4908,135766,lOkl9iaUDyjk0zbwJLRgFqBRBNNBSRwr,SpATywNh6bZuzm8s1ceuBUnMUAeoAHHw,25,53,1,14,1,0,6,0,75,10.714285714285714,3,0.0,9,1,14,1,44,0,0,6,0,25,50,0
4909,135807,mgLL2TOXKEK8di2v3UUyM4FMUqEuj4kl,SpATywNh6bZuzm8s1ceuBUnMUAeoAHHw,12,22,15,0,11,0,4,0,52,7.428571428571429,4,0.0,0,15,0,11,22,0,0,4,0,26,26,0
4910,135833,7g2GzVvD3LDPJ9xtZLHYL8K6mvN9vWmD,SpATywNh6bZuzm8s1ceuBUnMUAeoAHHw,10,8,0,5,0,0,2,0,15,2.142857142857143,2,0.0,0,0,5,0,8,0,0,2,0,5,10,0
4911,135839,ALhsVcYDfp1SfoZTdAG25el890E5rBOs,SpATywNh6bZuzm8s1ceuBUnMUAeoAHHw,9,19,5,0,3,0,3,0,30,4.285714285714286,2,0.0,0,5,0,3,19,0,0,3,0,8,22,1
4912,135850,8BfLX4VWbjk8AKJGATzTPj7dIWenapT9,5X6FeZozNMgE2VRi3MJYjkkFK8SETtu2,7,2,1,0,1,6,5,1,16,2.2857142857142856,1,0.0,0,1,0,1,2,6,0,5,1,2,14,1
4913,135853,XBCkMYdRHaBwbyaKg5wVLPpzX1Jqu9p0,A3fsA9Zfv1X2fVEQhTw51lKENdNrEqT3,8,5,3,0,2,0,3,0,13,1.8571428571428572,2,0.0,0,3,0,2,5,0,0,3,0,5,8,1
4914,135855,eydQH4GkYYah3jlT3RLO9bqY3W7KkeyU,SpATywNh6bZuzm8s1ceuBUnMUAeoAHHw,16,19,1,15,0,0,2,0,37,5.285714285714286,1,0.0,2,1,12,0,17,0,3,2,0,15,22,1
4915,135870,24fGHeKkFcKUohpd2rziJRSIJ4SrDKtC,SpATywNh6bZuzm8s1ceuBUnMUAeoAHHw,1,0,0,0,0,0,1,0,1,0.14285714285714285,1,0.0,0,0,0,0,0,0,0,1,0,0,1,0
4916,135949,LwkReFLt4qKjmPs2qOJfW5b8aCxwqX6W,SpATywNh6bZuzm8s1ceuBUnMUAeoAHHw,29,30,16,23,7,0,4,0,80,11.428571428571429,2,0.0,10,16,20,7,20,0,3,4,0,53,27,0
4917,135960,3CBjdaShVtIGJnXeJieywzhdVFld7ctv,bWdj2GDclj5ofokWjzoa5jAwMkxCykd6,8,12,8,56,3,0,1,0,80,11.428571428571429,5,0.0,1,8,55,3,11,0,1,1,0,67,13,1
4918,135961,7C9uw52M5by38Fl70ZT1JWeDrRlogBlC,SpATywNh6bZuzm8s1ceuBUnMUAeoAHHw,1,0,0,0,0,5,0,0,5,0.7142857142857143,1,0.0,0,0,0,0,0,5,0,0,0,0,5,1
4919,135966,xZnb7uXmxIWQ7sisovgxwTXG7X7Be4Tl,A3fsA9Zfv1X2fVEQhTw51lKENdNrEqT3,1,0,0,0,0,0,1,0,1,0.14285714285714285,1,0.0,0,0,0,0,0,0,0,1,0,0,1,1
4920,135974,aGEULe4U5LmUUpJzsyEy4WDvVRNa2tI4,SpATywNh6bZuzm8s1ceuBUnMUAeoAHHw,2,0,0,0,0,0,2,0,2,0.2857142857142857,1,0.0,0,0,0,0,0,0,0,2,0,0,2,1
4921,135989,raEniJ6EzR1YxtHjYjnp7R4NA13wfMDR,5X6FeZozNMgE2VRi3MJYjkkFK8SETtu2,23,36,1,40,4,1,6,0,88,12.571428571428571,1,0.0,26,1,35,4,10,1,5,6,0,66,22,1
4922,136007,fKIYKEAGjFjOVTaUhIbkE3jtMMjkLesA,bWdj2GDclj5ofokWjzoa5jAwMkxCykd6,6,5,2,0,3,0,2,0,12,1.7142857142857142,2,0.0,2,2,0,3,3,0,0,2,0,7,5,1
4923,136032,vX9PpvehRTgTkIr6tSKODV93gbmBGfye,SpATywNh6bZuzm8s1ceuBUnMUAeoAHHw,7,10,4,0,2,0,2,0,18,2.5714285714285716,1,0.0,0,4,0,2,10,0,0,2,0,6,12,0
4924,136038,P38VxMH253jjoDZHRNefTKyEAydphpb2,SpATywNh6bZuzm8s1ceuBUnMUAeoAHHw,18,19,13,11,8,0,4,0,55,7.857142857142857,3,0.0,2,13,10,8,17,0,1,4,0,33,22,1
4925,136087,vJoyr5IRehWaBOVbIIDwhxeWe6B6APfd,SpATywNh6bZuzm8s1ceuBUnMUAeoAHHw,5,3,2,0,2,0,2,0,9,1.2857142857142858,1,0.0,0,2,0,2,3,0,0,2,0,4,5,1
4926,136139,zUMa6hLi66lg2p8YxrG1ESZeR6OgI34u,SpATywNh6bZuzm8s1ceuBUnMUAeoAHHw,16,27,2,20,1,0,6,0,56,8.0,3,0.0,10,2,18,1,17,0,2,6,0,31,25,0
4927,136142,DyBJksrD7cQnd1w4SoDlp91ezRBSPAYk,5X6FeZozNMgE2VRi3MJYjkkFK8SETtu2,24,56,21,20,6,30,12,2,147,21.0,1,0.0,23,21,18,6,33,30,2,12,2,68,79,1
4928,136143,hnr1SrvwKs73pIl4Y8iA8BBWZr0Bh6Qj,G8EPVSXsOYB5YQWZGiz1aVq5Pgr2GrQu,3,2,0,0,0,0,1,0,3,0.42857142857142855,1,0.0,0,0,0,0,2,0,0,1,0,0,3,0
4929,136149,St6usTSSgX5U9v7wchuMWqmBKoCcDwN2,SpATywNh6bZuzm8s1ceuBUnMUAeoAHHw,27,32,1,24,1,0,8,0,66,9.428571428571429,2,0.0,6,1,23,1,26,0,1,8,0,31,35,0
4930,136152,FmYyMdFUePtcDBVgDdhDyxnbGBctrwZJ,SpATywNh6bZuzm8s1ceuBUnMUAeoAHHw,37,36,23,20,12,0,8,1,100,14.285714285714286,3,0.0,5,23,19,12,31,0,1,8,1,59,41,0
4931,136157,JVItRyTCnb3b4TFpkbmaBDRTUqAJVd1k,SpATywNh6bZuzm8s1ceuBUnMUAeoAHHw,7,3,1,0,1,0,3,1,9,1.2857142857142858,1,0.0,0,1,0,1,3,0,0,3,1,2,7,1
4932,136164,wXz4TbCpuPApw4hHC9Aow8xAscaoMUnc,5X6FeZozNMgE2VRi3MJYjkkFK8SETtu2,1,0,0,0,0,0,2,0,2,0.2857142857142857,2,0.0,0,0,0,0,0,0,0,2,0,0,2,0
4933,136176,aGEdGizI9oXgMerMCvDqcaaIvZBHQncC,SpATywNh6bZuzm8s1ceuBUnMUAeoAHHw,21,33,14,18,7,2,7,0,81,11.571428571428571,1,0.0,15,14,17,7,18,2,1,7,0,53,28,1
4934,136184,xxd1UUpRh1yQGgGLMyjshPknKZCNEYlg,SpATywNh6bZuzm8s1ceuBUnMUAeoAHHw,1,0,0,0,0,0,1,0,1,0.14285714285714285,1,0.0,0,0,0,0,0,0,0,1,0,0,1,0
4935,136186,2NUZ5sFwBGaVOU21jGvUQkuVbUQhglLS,SpATywNh6bZuzm8s1ceuBUnMUAeoAHHw,1,0,0,0,0,0,1,0,1,0.14285714285714285,1,0.0,0,0,0,0,0,0,0,1,0,0,1,1
4936,136193,ct3ZFc3dYzkZrA1pmvZdNHcuNKAGoE3e,SpATywNh6bZuzm8s1ceuBUnMUAeoAHHw,44,24,20,7,17,0,7,1,76,10.857142857142858,3,0.0,0,20,6,17,24,0,1,7,1,43,33,1
4937,136198,oibZPbiJJqoMwq4D1fIJH3UgEiqKbAw2,5X6FeZozNMgE2VRi3MJYjkkFK8SETtu2,1,0,0,0,0,0,1,0,1,0.14285714285714285,1,0.0,0,0,0,0,0,0,0,1,0,0,1,1
4938,136209,oGK3c8nk6Ftl3V2u1zOvslszD4LDLr3w,G8EPVSXsOYB5YQWZGiz1aVq5Pgr2GrQu,33,51,20,39,13,0,7,0,130,18.571428571428573,3,0.0,22,20,28,13,29,0,11,7,0,83,47,1
4939,136210,bIjd8KK4L7j9O8VoOs8qHKzlQRCxHLCH,SpATywNh6bZuzm8s1ceuBUnMUAeoAHHw,38,46,2,40,2,0,15,1,106,15.142857142857142,7,0.0,9,2,38,2,37,0,2,15,1,51,55,0
4940,136228,ZjYHCTVP9J8Ll4M7bRt1mvNwKg1uuKeM,A3fsA9Zfv1X2fVEQhTw51lKENdNrEqT3,17,43,22,0,16,0,13,1,95,13.571428571428571,2,0.0,0,22,0,16,43,0,0,13,1,38,57,0
4941,136230,FZEwaAUaiR6zemazrUHMMvDLCgHez3sb,SpATywNh6bZuzm8s1ceuBUnMUAeoAHHw,3,2,0,0,0,0,2,0,4,0.5714285714285714,1,0.0,0,0,0,0,2,0,0,2,0,0,4,1
4942,136239,Ovk8jBBHwwhBttek79ARCgIpAVxMH1wF,RXDvfPUBYFlVdlueBFbLW0mhhAyGEqpt,2,0,0,0,0,0,2,0,2,0.2857142857142857,1,0.0,0,0,0,0,0,0,0,2,0,0,2,1
4943,136247,8FGs2DlahZoB3KBpV3eIicZF3v5DtTbf,SpATywNh6bZuzm8s1ceuBUnMUAeoAHHw,30,49,27,28,5,0,8,0,117,16.714285714285715,3,0.0,15,27,18,5,34,0,10,8,0,65,52,0
4944,136253,GdGI6ZUeHNfDd16CDy7Y3YMvqdJfsIRh,5X6FeZozNMgE2VRi3MJYjkkFK8SETtu2,6,11,0,0,0,0,3,0,14,2.0,1,0.0,0,0,0,0,11,0,0,3,0,0,14,1
4945,136263,jyfYy8sfAOty2dpLhVOhL2aPccvug6UT,5X6FeZozNMgE2VRi3MJYjkkFK8SETtu2,14,11,4,14,5,4,4,1,43,6.142857142857143,1,0.0,7,4,12,5,4,4,2,4,1,28,15,1
4946,136264,u427dT2PrJSPY0vA5y1MW0KDFWyOjXZY,5X6FeZozNMgE2VRi3MJYjkkFK8SETtu2,2,0,0,0,0,0,2,0,2,0.2857142857142857,1,0.0,0,0,0,0,0,0,0,2,0,0,2,1
4947,136265,7fwVXF5ctPhb8pPmrNYDi2ycSDGABklq,SpATywNh6bZuzm8s1ceuBUnMUAeoAHHw,1,0,0,0,0,0,1,0,1,0.14285714285714285,1,0.0,0,0,0,0,0,0,0,1,0,0,1,1
4948,136277,XWv59N7sAYbp3z6NAMpnTA06Qc1dakFb,SpATywNh6bZuzm8s1ceuBUnMUAeoAHHw,1,0,0,0,0,0,1,0,1,0.14285714285714285,1,0.0,0,0,0,0,0,0,0,1,0,0,1,1
4949,136285,fIxQAi8V5pbdcqYQSrNcVmHhfSlfCyxT,bWdj2GDclj5ofokWjzoa5jAwMkxCykd6,10,8,4,0,3,0,5,0,20,2.857142857142857,1,0.0,0,4,0,3,8,0,0,5,0,7,13,1
4950,136290,uXyiNHzEVwnpCSssM0aWRjomS3dwzYaL,bWdj2GDclj5ofokWjzoa5jAwMkxCykd6,6,5,1,0,1,0,2,0,9,1.2857142857142858,1,0.0,0,1,0,1,5,0,0,2,0,2,7,1
4951,136310,Pjnlkp8XQVpplsjp936AKfGr0trx7Z15,A3fsA9Zfv1X2fVEQhTw51lKENdNrEqT3,2,0,0,0,0,0,2,0,2,0.2857142857142857,1,0.0,0,0,0,0,0,0,0,2,0,0,2,1
4952,136316,l8uPir1doTLOU3QiCXJvPr5i6VmozOBb,SpATywNh6bZuzm8s1ceuBUnMUAeoAHHw,4,2,1,0,1,0,1,0,5,0.7142857142857143,1,0.0,0,1,0,1,2,0,0,1,0,2,3,1
4953,136317,PSnfBRJFzUH9xyPpWKLqfkQbVy7w07sO,SpATywNh6bZuzm8s1ceuBUnMUAeoAHHw,13,20,1,16,0,0,4,0,41,5.857142857142857,1,0.0,8,1,13,0,12,0,3,4,0,22,19,1
4954,136353,xFOMKgrHGqKyL5uPk9RcNRWczzZxvoeN,RXDvfPUBYFlVdlueBFbLW0mhhAyGEqpt,1,0,0,0,0,0,1,0,1,0.14285714285714285,1,0.0,0,0,0,0,0,0,0,1,0,0,1,1
4955,136357,KCeIMOjpHLluvXS6RWqa6XtVXcPd3TxR,SpATywNh6bZuzm8s1ceuBUnMUAeoAHHw,1,0,0,0,0,0,1,0,1,0.14285714285714285,1,0.0,0,0,0,0,0,0,0,1,0,0,1,1
4956,136363,lhlon92qtIm50z28ydik0v6JhWIxsC1U,SpATywNh6bZuzm8s1ceuBUnMUAeoAHHw,62,105,56,64,30,0,20,1,276,39.42857142857143,4,0.0,36,56,50,30,69,0,14,20,1,172,104,0
4957,136375,QzQWYrrIVOUqhShDM2t03rN3byjq3J7w,SpATywNh6bZuzm8s1ceuBUnMUAeoAHHw,6,10,2,0,0,0,2,0,14,2.0,2,0.0,0,2,0,0,10,0,0,2,0,2,12,0
4958,136395,5KlLtazjcjJXBl2pdXu4H41a6obdv1J2,SpATywNh6bZuzm8s1ceuBUnMUAeoAHHw,8,5,3,0,2,0,4,0,14,2.0,1,0.0,0,3,0,2,5,0,0,4,0,5,9,1
4959,136398,gtKTzkXHwS41ljYVmjlLLf4WyQSkK02q,7GRhBDsirIGkRZBtSMEzNTyDr2JQm4xx,4,3,2,0,0,0,1,0,6,0.8571428571428571,1,0.0,0,2,0,0,3,0,0,1,0,2,4,1
4960,136413,SAZKFz2NUOxVKdkBgcAx84BjxoboQOlS,SpATywNh6bZuzm8s1ceuBUnMUAeoAHHw,16,21,4,10,2,0,9,0,46,6.571428571428571,3,0.0,2,4,10,2,19,0,0,9,0,18,28,0
4961,136463,8cfJnU0jXErKE14ASkG1nYCbKcKidUol,SpATywNh6bZuzm8s1ceuBUnMUAeoAHHw,8,7,4,0,3,0,4,0,18,2.5714285714285716,1,0.0,0,4,0,3,7,0,0,4,0,7,11,1
4962,136468,YVboeUnAYRezL6JF0VMVpiapYahgjIwn,SpATywNh6bZuzm8s1ceuBUnMUAeoAHHw,20,20,14,6,6,0,4,0,50,7.142857142857143,2,0.0,2,14,6,6,18,0,0,4,0,28,22,0
4963,136471,VDenzJIuXt8CZgPYymaTQtlPj7WCFclP,G8EPVSXsOYB5YQWZGiz1aVq5Pgr2GrQu,40,36,19,101,8,8,14,9,195,27.857142857142858,4,0.0,3,19,87,8,33,8,14,14,9,117,78,0
4964,136500,AAAvWauitKfXD0xRpNsfpOKQu223kCXG,bWdj2GDclj5ofokWjzoa5jAwMkxCykd6,8,5,4,0,2,0,1,0,12,1.7142857142857142,1,0.0,0,4,0,2,5,0,0,1,0,6,6,1
4965,136509,SZXfR7h2rkxFAPPaFk4ZqU1S4Hh3WECW,SpATywNh6bZuzm8s1ceuBUnMUAeoAHHw,18,24,0,21,0,0,6,0,51,7.285714285714286,1,0.0,10,0,20,0,14,0,1,6,0,30,21,0
4966,136515,ODBJIDcvWCzkG2XoiGFYE0mdoqG7tfRb,A3fsA9Zfv1X2fVEQhTw51lKENdNrEqT3,2,0,0,0,0,0,2,0,2,0.2857142857142857,1,0.0,0,0,0,0,0,0,0,2,0,0,2,1
4967,136524,i15PHia6n9agkYRoEhdWcUwrhqvX8pmC,bWdj2GDclj5ofokWjzoa5jAwMkxCykd6,4,3,0,0,0,0,2,0,5,0.7142857142857143,1,0.0,0,0,0,0,3,0,0,2,0,0,5,1
4968,136540,hZR4MwcYec4g0GoOyJFngJGEyWOySpv2,7GRhBDsirIGkRZBtSMEzNTyDr2JQm4xx,2,0,0,0,0,0,6,0,6,0.8571428571428571,2,0.0,0,0,0,0,0,0,0,6,0,0,6,0
4969,136547,LkEFlCqQYkjvIKgJmv3NaW67JKbg7cls,SpATywNh6bZuzm8s1ceuBUnMUAeoAHHw,36,23,18,18,14,0,3,0,76,10.857142857142858,1,0.0,1,18,18,14,22,0,0,3,0,51,25,0
4970,136564,JHhY30IKFzw4LWcyrHuTEglWNqRkqdDU,SpATywNh6bZuzm8s1ceuBUnMUAeoAHHw,7,3,1,6,0,0,2,0,12,1.7142857142857142,1,0.0,2,1,6,0,1,0,0,2,0,9,3,1
4971,136587,XvNNzv39b8VqKid0q4fV9ms2wVNAdWks,RXDvfPUBYFlVdlueBFbLW0mhhAyGEqpt,3,3,1,0,0,0,1,0,5,0.7142857142857143,1,0.0,0,1,0,0,3,0,0,1,0,1,4,1
4972,136592,JHhY30IKFzw4LWcyrHuTEglWNqRkqdDU,RXDvfPUBYFlVdlueBFbLW0mhhAyGEqpt,34,21,14,110,2,0,4,0,151,21.571428571428573,2,0.0,7,14,92,2,14,0,18,4,0,115,36,1
4973,136596,YqY5WPa8kwIoLBKGaVnXfSZOMvkSrEdU,SpATywNh6bZuzm8s1ceuBUnMUAeoAHHw,34,58,35,20,18,20,19,0,170,24.285714285714285,6,0.0,7,35,18,18,51,20,2,19,0,78,92,0
4974,136602,YqY5WPa8kwIoLBKGaVnXfSZOMvkSrEdU,A3fsA9Zfv1X2fVEQhTw51lKENdNrEqT3,3,2,1,0,0,0,1,0,4,0.5714285714285714,1,0.0,0,1,0,0,2,0,0,1,0,1,3,1
4975,136608,YiJlfkoFk5UHEgOEqTYEMOMrDPkHWWsr,G8EPVSXsOYB5YQWZGiz1aVq5Pgr2GrQu,5,2,1,0,1,0,5,0,9,1.2857142857142858,1,0.0,0,1,0,1,2,0,0,5,0,2,7,1
4976,136621,JFLfO8Ojp07FwLFnPoEnOEQ2cuPQxeUo,SpATywNh6bZuzm8s1ceuBUnMUAeoAHHw,6,3,1,0,1,0,2,0,7,1.0,1,0.0,0,1,0,1,3,0,0,2,0,2,5,1
4977,136623,MF5edVvM6lCZDxnMdHelos9TUh3KERjn,A3fsA9Zfv1X2fVEQhTw51lKENdNrEqT3,17,23,10,0,7,1,12,0,53,7.571428571428571,3,0.0,0,10,0,7,23,1,0,12,0,17,36,0
4978,136631,Ol2x0ZxbBMe9mHlTofrTcxHzfpLJITAv,SpATywNh6bZuzm8s1ceuBUnMUAeoAHHw,14,11,2,0,2,0,3,0,18,2.5714285714285716,2,0.0,0,2,0,2,11,0,0,3,0,4,14,1
4979,136650,o9SIyzF4ZVmP6xyBxbALfe2BPg3mc4Rf,RXDvfPUBYFlVdlueBFbLW0mhhAyGEqpt,6,3,1,0,1,0,2,0,7,1.0,1,0.0,0,1,0,1,3,0,0,2,0,2,5,1
4980,136673,St6usTSSgX5U9v7wchuMWqmBKoCcDwN2,A3fsA9Zfv1X2fVEQhTw51lKENdNrEqT3,9,11,0,0,0,1,8,1,21,3.0,2,0.0,0,0,0,0,11,1,0,8,1,0,21,1
4981,136679,oVbgF80NIAxYzCtFttiq6BjlrneHU8IM,5X6FeZozNMgE2VRi3MJYjkkFK8SETtu2,2,0,0,0,0,0,2,0,2,0.2857142857142857,1,0.0,0,0,0,0,0,0,0,2,0,0,2,1
4982,136725,HmthpKrRMRfAgIx5u0jDQnXVTODkBXAh,5X6FeZozNMgE2VRi3MJYjkkFK8SETtu2,6,4,0,0,0,0,3,0,7,1.0,2,0.0,0,0,0,0,4,0,0,3,0,0,7,1
4983,136731,8mWm5xzce8wK28AEpPpWzDCgRcswbNyu,SpATywNh6bZuzm8s1ceuBUnMUAeoAHHw,7,6,3,0,3,0,2,0,14,2.0,1,0.0,2,3,0,3,4,0,0,2,0,8,6,1
4984,136742,2p1NtqJLJU7uLfrCQDiRWD2YMKpjai8W,SpATywNh6bZuzm8s1ceuBUnMUAeoAHHw,14,8,5,6,3,1,10,0,33,4.714285714285714,2,0.0,0,5,5,3,8,1,1,10,0,13,20,1
4985,136743,PV4ahNYgW8Lcd9nNe0xrpkqG7Ws3zMb1,SpATywNh6bZuzm8s1ceuBUnMUAeoAHHw,36,36,25,15,11,0,13,0,100,14.285714285714286,3,0.0,4,25,13,11,32,0,2,13,0,53,47,0
4986,136755,Cun565mofxXDvKnAWY9DLeMetfYrusOd,5X6FeZozNMgE2VRi3MJYjkkFK8SETtu2,1,0,0,0,0,0,2,0,2,0.2857142857142857,1,0.0,0,0,0,0,0,0,0,2,0,0,2,1
4987,136758,Cun565mofxXDvKnAWY9DLeMetfYrusOd,SpATywNh6bZuzm8s1ceuBUnMUAeoAHHw,1,0,0,0,0,0,1,0,1,0.14285714285714285,1,0.0,0,0,0,0,0,0,0,1,0,0,1,1
4988,136771,9NQzSeXWhYO5onk53eYyqP6ECizmGBQ1,SpATywNh6bZuzm8s1ceuBUnMUAeoAHHw,1,0,0,0,0,0,1,0,1,0.14285714285714285,1,0.0,0,0,0,0,0,0,0,1,0,0,1,1
4989,136785,nsbeAj5BI7VK72NYmPa0cGgkMq0PU2h6,SpATywNh6bZuzm8s1ceuBUnMUAeoAHHw,12,9,7,0,6,0,1,0,23,3.2857142857142856,2,0.0,0,7,0,6,9,0,0,1,0,13,10,0
4990,136797,uXoi7oqvj5HXbvnVGMMeQOqZvw3BW3QM,G8EPVSXsOYB5YQWZGiz1aVq5Pgr2GrQu,46,53,3,100,4,0,13,2,175,25.0,4,0.0,17,3,87,4,36,0,13,13,2,111,64,0
4991,136799,HycevJIm7cBjf1oJ5QCBMMXEBTG8jyRF,G8EPVSXsOYB5YQWZGiz1aVq5Pgr2GrQu,5,6,2,0,2,0,1,0,11,1.5714285714285714,1,0.0,3,2,0,2,3,0,0,1,0,7,4,1
4992,136822,LKQx76DscP8cMaadDZLCOsushv3ygeRX,bWdj2GDclj5ofokWjzoa5jAwMkxCykd6,1,0,0,0,0,0,1,0,1,0.14285714285714285,1,0.0,0,0,0,0,0,0,0,1,0,0,1,1
4993,136838,U8h5v4h0FTivdwhWGH1jLw0ZcR0Q7clk,G8EPVSXsOYB5YQWZGiz1aVq5Pgr2GrQu,1,0,0,0,0,0,1,0,1,0.14285714285714285,1,0.0,0,0,0,0,0,0,0,1,0,0,1,1
4994,136841,LOj6EKhQZdloEcDYeBGg0mw1M8oTbRIG,SpATywNh6bZuzm8s1ceuBUnMUAeoAHHw,9,3,2,0,1,1,5,1,13,1.8571428571428572,1,0.0,0,2,0,1,3,1,0,5,1,3,10,1
4995,136860,5NKHIcFKbvZvjnI6x0vdD0R4rE65640c,SpATywNh6bZuzm8s1ceuBUnMUAeoAHHw,20,33,2,12,2,12,7,1,69,9.857142857142858,2,0.0,7,2,12,2,26,12,0,7,1,23,46,0
4996,136861,BoXSuGXDZEH8EQNVPHOVOXaNZkjSq3cI,SpATywNh6bZuzm8s1ceuBUnMUAeoAHHw,5,4,1,0,1,0,1,0,7,1.0,1,0.0,0,1,0,1,4,0,0,1,0,2,5,1
4997,136882,5KBUyFUobvfAu8D7u7bO9wAPV4vuXQZU,5X6FeZozNMgE2VRi3MJYjkkFK8SETtu2,4,3,0,0,0,0,3,0,6,0.8571428571428571,1,0.0,0,0,0,0,3,0,0,3,0,0,6,1
4998,136885,SsiBwdLtgBlftQTMaumuPfeXEp9eUN1X,SpATywNh6bZuzm8s1ceuBUnMUAeoAHHw,17,11,8,11,7,0,3,0,40,5.714285714285714,2,0.0,2,8,11,7,9,0,0,3,0,28,12,0
4999,136897,xNcMMIyB0y99dNaEOIqDnvCMrU2SAEOP,G8EPVSXsOYB5YQWZGiz1aVq5Pgr2GrQu,2,0,0,0,0,0,3,0,3,0.42857142857142855,3,0.0,0,0,0,0,0,0,0,3,0,0,3,0
5000,136902,3zCxXtKsxr4Va4aHW0QJdJglnVCQNojy,bWdj2GDclj5ofokWjzoa5jAwMkxCykd6,14,17,8,54,6,0,8,0,93,13.285714285714286,2,0.0,4,8,53,6,13,0,1,8,0,71,22,0
5001,136927,bEa4GPfWyDDoCQ0l4pJUKvEvdEIRkNUb,SpATywNh6bZuzm8s1ceuBUnMUAeoAHHw,7,8,3,0,2,0,3,0,16,2.2857142857142856,1,0.0,0,3,0,2,8,0,0,3,0,5,11,0
5002,136936,hh9sxcCkDcNCk3fgQSDTsATrvTypYDNd,SpATywNh6bZuzm8s1ceuBUnMUAeoAHHw,1,0,0,0,0,0,1,0,1,0.14285714285714285,1,0.0,0,0,0,0,0,0,0,1,0,0,1,1
5003,136958,hWIkfeUSCOyKe93IaOMW8L1TfkIW79I7,SpATywNh6bZuzm8s1ceuBUnMUAeoAHHw,1,0,0,0,0,0,1,0,1,0.14285714285714285,1,0.0,0,0,0,0,0,0,0,1,0,0,1,1
5004,136960,BJcIgaOnWdAOKf7jzUg9DKOlERmjwn2s,5X6FeZozNMgE2VRi3MJYjkkFK8SETtu2,1,0,0,0,0,0,1,0,1,0.14285714285714285,1,0.0,0,0,0,0,0,0,0,1,0,0,1,1
5005,136975,jAN47XfFw4MlopVK3qz6aOPpVjzNFA72,SpATywNh6bZuzm8s1ceuBUnMUAeoAHHw,28,16,14,0,13,0,4,0,47,6.714285714285714,2,0.0,0,14,0,13,16,0,0,4,0,27,20,1
5006,136984,KG9OHXXHmvu7A5D5AL2urTyy68HjxVcf,bWdj2GDclj5ofokWjzoa5jAwMkxCykd6,10,9,4,0,2,0,5,0,20,2.857142857142857,2,0.0,0,4,0,2,9,0,0,5,0,6,14,0
5007,136990,9BCEccsmIZjFkvP5Wn5sri87n0uRi11S,SpATywNh6bZuzm8s1ceuBUnMUAeoAHHw,39,43,23,33,10,0,6,0,115,16.428571428571427,4,0.0,15,23,26,10,28,0,7,6,0,74,41,0
5008,137002,lqaXGZwMzd5OqVUoM1LTFPECTwauskRk,bWdj2GDclj5ofokWjzoa5jAwMkxCykd6,21,2,2,34,0,9,9,1,57,8.142857142857142,2,0.0,0,2,26,0,2,9,8,9,1,28,29,1
5009,137013,DTg7EG4lfjPjfkpYaGZXFcsjykgIpZH4,SpATywNh6bZuzm8s1ceuBUnMUAeoAHHw,31,42,24,0,20,0,21,1,108,15.428571428571429,4,0.0,0,24,0,20,42,0,0,21,1,44,64,0
5010,137016,00bDiL0A6W9npxn52kzhmAfK2Yag1Gik,bWdj2GDclj5ofokWjzoa5jAwMkxCykd6,35,27,15,58,9,0,1,0,110,15.714285714285714,3,0.0,10,15,57,9,17,0,1,1,0,91,19,0
5011,137032,8WaKIrns0KwXg2bg0CbmKADdcmfehL2Q,5X6FeZozNMgE2VRi3MJYjkkFK8SETtu2,1,0,0,0,0,0,1,0,1,0.14285714285714285,1,0.0,0,0,0,0,0,0,0,1,0,0,1,1
5012,137033,xwVxmiN6s5Ty9myiVUNDBrV8mOb9D8yx,5X6FeZozNMgE2VRi3MJYjkkFK8SETtu2,1,0,0,0,0,0,1,0,1,0.14285714285714285,1,0.0,0,0,0,0,0,0,0,1,0,0,1,0
5013,137036,H11gBGo9MHSSmlSVhF8hMNcBAJe3AuL3,bWdj2GDclj5ofokWjzoa5jAwMkxCykd6,5,2,0,0,0,9,6,1,18,2.5714285714285716,1,0.0,0,0,0,0,2,9,0,6,1,0,18,0
5014,137061,3Jy6jx0sNeFLpP5Q6xPf2pYaHlNBhC9M,A3fsA9Zfv1X2fVEQhTw51lKENdNrEqT3,1,0,0,0,0,0,1,0,1,0.14285714285714285,1,0.0,0,0,0,0,0,0,0,1,0,0,1,1
5015,137076,g7u6ac7DR9jMW4aOouB4W8Gur81b4cDe,bWdj2GDclj5ofokWjzoa5jAwMkxCykd6,1,0,0,0,0,0,1,0,1,0.14285714285714285,1,0.0,0,0,0,0,0,0,0,1,0,0,1,0
5016,137077,xIsNJgqYQ4WcvbQ1A0Us7q1c1NYtR1tF,bWdj2GDclj5ofokWjzoa5jAwMkxCykd6,73,34,16,121,11,0,3,0,185,26.428571428571427,3,0.0,12,16,110,11,22,0,11,3,0,149,36,0
5017,137085,A7splZdp3CZV6tKUIRVHnnLOftJO8UXC,5X6FeZozNMgE2VRi3MJYjkkFK8SETtu2,1,0,0,0,0,0,1,0,1,0.14285714285714285,1,0.0,0,0,0,0,0,0,0,1,0,0,1,1
5018,137087,TFu3qaPZIYv7KLXu3pTvSATW0VeXRtF9,SpATywNh6bZuzm8s1ceuBUnMUAeoAHHw,1,0,0,0,0,0,1,0,1,0.14285714285714285,1,0.0,0,0,0,0,0,0,0,1,0,0,1,1
5019,137104,ISRJxWtuG9U7GF6GcMl2UZgUHAWLyOgM,5X6FeZozNMgE2VRi3MJYjkkFK8SETtu2,7,2,1,0,1,8,8,1,21,3.0,2,0.0,0,1,0,1,2,8,0,8,1,2,19,1
5020,137113,p9pL8JfmTYOMYYseo2SSQ9sWORIDdbKq,5X6FeZozNMgE2VRi3MJYjkkFK8SETtu2,6,6,4,0,2,0,9,0,21,3.0,1,0.0,0,4,0,2,6,0,0,9,0,6,15,1
5021,137179,fg94lpeYtceQf2gnwTTGybnIJZZS1MZL,SpATywNh6bZuzm8s1ceuBUnMUAeoAHHw,20,40,17,60,2,11,12,0,142,20.285714285714285,1,0.0,17,17,47,2,23,11,13,12,0,83,59,0
5022,137190,PmtrviA6hBub1PH85YXqVyZgghNsuc4g,SpATywNh6bZuzm8s1ceuBUnMUAeoAHHw,11,8,6,0,4,0,1,0,19,2.7142857142857144,3,0.0,1,6,0,4,7,0,0,1,0,11,8,1
5023,137199,p9pL8JfmTYOMYYseo2SSQ9sWORIDdbKq,SpATywNh6bZuzm8s1ceuBUnMUAeoAHHw,1,0,0,0,0,0,1,0,1,0.14285714285714285,1,0.0,0,0,0,0,0,0,0,1,0,0,1,1
5024,137200,EWCtjEAyugZmgyZfRj1CnWJoYkKUEbbn,A3fsA9Zfv1X2fVEQhTw51lKENdNrEqT3,9,10,0,0,0,0,3,0,13,1.8571428571428572,1,0.0,0,0,0,0,10,0,0,3,0,0,13,1
5025,137214,nmlYjXdaqWSjPWm2kQhmjZqjjBKhkQAm,A3fsA9Zfv1X2fVEQhTw51lKENdNrEqT3,47,74,33,0,26,0,5,0,138,19.714285714285715,4,0.0,0,33,0,26,74,0,0,5,0,59,79,1
5026,137247,cnKlhFP86QmSR2VWsPl9LF1ZQFaVjGih,SpATywNh6bZuzm8s1ceuBUnMUAeoAHHw,2,0,0,0,0,0,3,0,3,0.42857142857142855,1,0.0,0,0,0,0,0,0,0,3,0,0,3,1
5027,137249,QtcaqP1Oq08hvIX3wqGcQDC13eo6FjVm,bWdj2GDclj5ofokWjzoa5jAwMkxCykd6,4,2,1,0,0,0,2,0,5,0.7142857142857143,1,0.0,0,1,0,0,2,0,0,2,0,1,4,1
5028,137250,Cwj6oMWOpzGKPlqMvZWx3f8M3qp0flmr,G8EPVSXsOYB5YQWZGiz1aVq5Pgr2GrQu,29,23,19,22,15,0,13,0,92,13.142857142857142,4,0.0,0,19,19,15,23,0,3,13,0,53,39,0
5029,137340,7RIgMHzHpMzY7qBXHPj6WiDKK3U9H2Wz,fbPkOYLVPtPgIt0MxizjfFJov3JbHyAi,7,4,3,0,2,0,1,0,10,1.4285714285714286,1,0.0,0,3,0,2,4,0,0,1,0,5,5,1
5030,137427,g5cfvDvYqz1BC4LMGanzPaVPPBmwbapa,fbPkOYLVPtPgIt0MxizjfFJov3JbHyAi,5,4,2,0,1,0,1,0,8,1.1428571428571428,1,0.0,1,2,0,1,3,0,0,1,0,4,4,0
5031,137471,bRHB3zBOPKwppEH2jjC2WgssvXC1msz1,5Gyp41oLVo7Gg7vF4vpmggWP5MU70QO6,6,5,2,0,1,0,2,0,10,1.4285714285714286,1,0.0,3,2,0,1,2,0,0,2,0,6,4,1
5032,137490,Bg3IlobMeEnDXrcofRLwVsSu1ZqdXs37,5Gyp41oLVo7Gg7vF4vpmggWP5MU70QO6,1,0,0,0,0,0,1,0,1,0.14285714285714285,1,0.0,0,0,0,0,0,0,0,1,0,0,1,1
5033,137504,5pZkgPIxnBOORIliJ8n3jg55IKTU9MXC,5Gyp41oLVo7Gg7vF4vpmggWP5MU70QO6,19,37,25,7,7,4,15,3,98,14.0,4,0.0,6,25,5,7,31,4,2,15,3,43,55,1
5034,137508,2kNInSJ3uqvLvhYTOvaIkQm0oXn9XX4a,5Gyp41oLVo7Gg7vF4vpmggWP5MU70QO6,36,180,96,42,52,9,50,1,430,61.42857142857143,8,0.0,34,96,26,52,146,9,16,50,1,208,222,1
5035,137522,yFgrzwwjtpsjhKHIOZXuFR9O2ZYbMMNa,5Gyp41oLVo7Gg7vF4vpmggWP5MU70QO6,10,19,4,0,2,2,7,1,35,5.0,3,0.0,0,4,0,2,19,2,0,7,1,6,29,1
5036,137529,Zxs1RumGHONRCjjtlqlZeQ4V6CgOxVWH,5Gyp41oLVo7Gg7vF4vpmggWP5MU70QO6,1,0,0,0,0,0,1,0,1,0.14285714285714285,1,0.0,0,0,0,0,0,0,0,1,0,0,1,1
5037,137540,KHhx19dsa0jlK0KSwU5Y4cPoRyGsbykO,5Gyp41oLVo7Gg7vF4vpmggWP5MU70QO6,1,0,0,0,0,0,1,0,1,0.14285714285714285,1,0.0,0,0,0,0,0,0,0,1,0,0,1,1
5038,137592,VL0rdkFTRaRvYW02oZ1fEazY0Pyp6eKe,5Gyp41oLVo7Gg7vF4vpmggWP5MU70QO6,5,2,1,0,1,0,2,0,6,0.8571428571428571,1,0.0,0,1,0,1,2,0,0,2,0,2,4,1
5039,137623,lvaMHvq36xKtzAaVtM1gVToh26FqxOq2,5Gyp41oLVo7Gg7vF4vpmggWP5MU70QO6,17,27,9,12,3,0,8,1,60,8.571428571428571,1,0.0,7,9,6,3,20,0,6,8,1,25,35,1
5040,137628,EY8iKTJrEMSI2rdDZZ99LpQO14yMkcx7,5Gyp41oLVo7Gg7vF4vpmggWP5MU70QO6,21,41,23,6,12,13,16,4,115,16.428571428571427,3,0.0,6,23,3,12,35,13,3,16,4,44,71,1
5041,137632,rrBwc9DqMP8jnv9AB7ljubWYdmiLkI0q,5Gyp41oLVo7Gg7vF4vpmggWP5MU70QO6,1,0,0,0,0,0,1,0,1,0.14285714285714285,1,0.0,0,0,0,0,0,0,0,1,0,0,1,1
5042,137638,CQ2N12ploVcZUAUn102rtsaEWH0dRUqg,5Gyp41oLVo7Gg7vF4vpmggWP5MU70QO6,7,5,2,0,1,0,4,0,12,1.7142857142857142,1,0.0,0,2,0,1,5,0,0,4,0,3,9,1
5043,137651,ghyVPfJiysGexkLu74m61UB1GHHehYBW,5Gyp41oLVo7Gg7vF4vpmggWP5MU70QO6,8,5,3,0,3,1,3,0,15,2.142857142857143,1,0.0,1,3,0,3,4,1,0,3,0,7,8,1
5044,137682,rWeQbQybYpipcE4MtqdndKPuNPE34gTm,5Gyp41oLVo7Gg7vF4vpmggWP5MU70QO6,26,53,29,8,13,25,19,3,150,21.428571428571427,6,0.0,11,29,5,13,42,25,3,19,3,58,92,1
5045,137683,LvwHRWeYnZCL5LxnyQVxHpXzMFj4I2kd,5Gyp41oLVo7Gg7vF4vpmggWP5MU70QO6,1,0,0,0,0,0,1,0,1,0.14285714285714285,1,0.0,0,0,0,0,0,0,0,1,0,0,1,1
5046,137701,0QFADiD6IvsCiGKcRzsLQbDvaZGh6BVG,5Gyp41oLVo7Gg7vF4vpmggWP5MU70QO6,13,14,5,10,4,6,4,1,44,6.285714285714286,1,0.0,7,5,5,4,7,6,5,4,1,21,23,0
5047,137742,blQKCpClzsxilnQtKRruTVl5WFjEiUZ7,5Gyp41oLVo7Gg7vF4vpmggWP5MU70QO6,3,2,0,0,0,0,3,0,5,0.7142857142857143,1,0.0,1,0,0,0,1,0,0,3,0,1,4,1
5048,137795,qL8pzfxUmvBPhYspGX5TlcL0EdDEftN5,5Gyp41oLVo7Gg7vF4vpmggWP5MU70QO6,12,5,4,0,4,5,6,1,25,3.5714285714285716,1,0.0,0,4,0,4,5,5,0,6,1,8,17,1
5049,137804,Iy2c4LLD7WheZKvirMXjibEfTHkFFvkr,5Gyp41oLVo7Gg7vF4vpmggWP5MU70QO6,27,41,17,39,4,3,13,1,118,16.857142857142858,2,0.0,7,17,24,4,34,3,15,13,1,52,66,0
5050,137824,dADOrE6FAWkIPcnZuLBj5KGmzjdxSunH,5Gyp41oLVo7Gg7vF4vpmggWP5MU70QO6,5,2,1,0,1,2,6,0,12,1.7142857142857142,2,0.0,0,1,0,1,2,2,0,6,0,2,10,1
5051,137826,zOBIpcmftAStMdFAPFHRhNH5I6q8BynQ,5Gyp41oLVo7Gg7vF4vpmggWP5MU70QO6,2,0,0,0,0,0,3,0,3,0.42857142857142855,2,0.0,0,0,0,0,0,0,0,3,0,0,3,1
5052,137853,8AXj6lcLIX035dfDrWyWyYakHzYd5MDT,5Gyp41oLVo7Gg7vF4vpmggWP5MU70QO6,12,14,6,4,2,2,6,2,36,5.142857142857143,2,0.0,6,6,2,2,8,2,2,6,2,16,20,1
5053,137867,bUYYjtmXeuDpNg5r7ztprL0yQKhgzHDz,5Gyp41oLVo7Gg7vF4vpmggWP5MU70QO6,7,4,3,0,2,0,1,0,10,1.4285714285714286,1,0.0,0,3,0,2,4,0,0,1,0,5,5,1
5054,137881,kKps6h7sWc5sZeyAwx04ucbfq9EUC5TI,5Gyp41oLVo7Gg7vF4vpmggWP5MU70QO6,6,3,2,0,2,0,4,0,11,1.5714285714285714,1,0.0,0,2,0,2,3,0,0,4,0,4,7,1
5055,137907,HUdGvoMbBNNA1ZqsKSrSpFS4asnWhnvB,5Gyp41oLVo7Gg7vF4vpmggWP5MU70QO6,2,0,0,0,0,0,2,0,2,0.2857142857142857,1,0.0,0,0,0,0,0,0,0,2,0,0,2,1
5056,137909,q3oJZTJoJk5u14gJETUYRvW78tAwypRq,5Gyp41oLVo7Gg7vF4vpmggWP5MU70QO6,1,0,0,0,0,0,1,0,1,0.14285714285714285,1,0.0,0,0,0,0,0,0,0,1,0,0,1,1
5057,137910,xy8Pu3m8OtRxFLhTfix6XvZn0H18zyZc,5Gyp41oLVo7Gg7vF4vpmggWP5MU70QO6,8,6,4,0,2,0,3,0,15,2.142857142857143,2,0.0,0,4,0,2,6,0,0,3,0,6,9,1
5058,137938,d0Fkzc1s1K2YYTpSpPctaD4RWDrIXUTL,5Gyp41oLVo7Gg7vF4vpmggWP5MU70QO6,2,0,0,0,0,0,2,0,2,0.2857142857142857,1,0.0,0,0,0,0,0,0,0,2,0,0,2,1
5059,137953,mV4YsIiA8Oc8PxZhA2HzdmyhI1ZXRUSS,3VkHkmOtom3jM2wCu94xgzzu1d6Dn7or,76,150,57,85,40,0,19,0,351,50.142857142857146,6,0.0,29,57,78,40,121,0,7,19,0,204,147,1
5060,137966,NBV94ih7LcieajGdTDi3QH2JtZbXI2x1,3VkHkmOtom3jM2wCu94xgzzu1d6Dn7or,1,0,0,0,0,0,1,0,1,0.14285714285714285,1,0.0,0,0,0,0,0,0,0,1,0,0,1,1
5061,137997,qXIGeC2zEbEwKt7gMNBfCicZkRbanHO1,3VkHkmOtom3jM2wCu94xgzzu1d6Dn7or,10,6,2,3,2,3,7,1,24,3.4285714285714284,2,0.0,1,2,3,2,5,3,0,7,1,8,16,1
5062,138024,GEpbyyj6BQaV9LZDEZGPce9LJLPY7dNC,3VkHkmOtom3jM2wCu94xgzzu1d6Dn7or,1,0,0,0,0,0,1,0,1,0.14285714285714285,1,0.0,0,0,0,0,0,0,0,1,0,0,1,1
5063,138048,qb9Qr4ZV1ds9lE5SIWlnoMsvAsje2CsE,3VkHkmOtom3jM2wCu94xgzzu1d6Dn7or,84,197,68,63,67,91,57,15,558,79.71428571428571,6,0.0,100,68,60,67,97,91,3,57,15,295,263,0
5064,138049,Kt2RSgvwDX1UzjS7GFmQPOgcvgXVu2eH,3VkHkmOtom3jM2wCu94xgzzu1d6Dn7or,2,0,0,0,0,0,2,0,2,0.2857142857142857,1,0.0,0,0,0,0,0,0,0,2,0,0,2,1
5065,138090,3LYXSPIknSPP5L9tYGH6TdV4JRyff2yh,3VkHkmOtom3jM2wCu94xgzzu1d6Dn7or,1,0,0,0,0,0,1,0,1,0.14285714285714285,1,0.0,0,0,0,0,0,0,0,1,0,0,1,1
5066,138124,lcxEu4F2dIRGolbGM8J7dkDro6hPXvBJ,3VkHkmOtom3jM2wCu94xgzzu1d6Dn7or,83,136,80,37,49,22,39,7,370,52.857142857142854,10,0.0,34,80,37,49,102,22,0,39,7,200,170,0
5067,138139,qjVw5zdLNaHgDeIlRwuWiy2ktW0DybEV,3VkHkmOtom3jM2wCu94xgzzu1d6Dn7or,4,4,1,0,0,0,2,0,7,1.0,2,0.0,0,1,0,0,4,0,0,2,0,1,6,1
5068,138149,MtLecFHHqh9FK31xwdSHWGy7YvfdLTDA,3VkHkmOtom3jM2wCu94xgzzu1d6Dn7or,1,0,0,0,0,0,2,0,2,0.2857142857142857,1,0.0,0,0,0,0,0,0,0,2,0,0,2,1
5069,138153,mjUISFCMgCqY1IWingfuG4ekI9R53uIK,3VkHkmOtom3jM2wCu94xgzzu1d6Dn7or,49,72,39,0,24,0,8,0,143,20.428571428571427,4,0.0,0,39,0,24,72,0,0,8,0,63,80,0
5070,138173,XmTGlWu1nFYDf360lZ5nqwhv1GH6p6fl,7GRhBDsirIGkRZBtSMEzNTyDr2JQm4xx,3,0,0,0,0,0,4,0,4,0.5714285714285714,2,0.0,0,0,0,0,0,0,0,4,0,0,4,1
5071,138176,dFJ5slXqGymdZnNlAUvtsyJDritH7dGq,7GRhBDsirIGkRZBtSMEzNTyDr2JQm4xx,44,70,27,39,21,7,9,0,173,24.714285714285715,2,0.0,37,27,24,21,33,7,15,9,0,109,64,1
5072,138177,yGll7cBEK4l513wg08W8WjrXiINZSUwd,7GRhBDsirIGkRZBtSMEzNTyDr2JQm4xx,1,0,0,0,0,0,1,0,1,0.14285714285714285,1,0.0,0,0,0,0,0,0,0,1,0,0,1,1
5073,138189,AuvP8ZOL6WtgYZTed2Zwusm6F2UVjDCF,7GRhBDsirIGkRZBtSMEzNTyDr2JQm4xx,17,68,47,2,31,5,19,0,172,24.571428571428573,4,0.0,1,47,2,31,67,5,0,19,0,81,91,0
5074,138195,wn9ozQViYqj1KJxs4FuSKb0vCeNtcWYJ,7GRhBDsirIGkRZBtSMEzNTyDr2JQm4xx,1,0,0,0,0,0,1,0,1,0.14285714285714285,1,0.0,0,0,0,0,0,0,0,1,0,0,1,1
5075,138202,JvCyyatgxKHz9VFtDJVVBL31IMYHuDOZ,7GRhBDsirIGkRZBtSMEzNTyDr2JQm4xx,3,2,1,0,0,0,2,0,5,0.7142857142857143,1,0.0,0,1,0,0,2,0,0,2,0,1,4,1
5076,138203,SUOXvpdIRQJm9cEGkdcCVcGfiGC9WR0Q,7GRhBDsirIGkRZBtSMEzNTyDr2JQm4xx,1,0,0,0,0,0,1,0,1,0.14285714285714285,1,0.0,0,0,0,0,0,0,0,1,0,0,1,1
5077,138204,oanYJczRVsQsFyE3TEwPYW17rzmwBQIL,7GRhBDsirIGkRZBtSMEzNTyDr2JQm4xx,5,3,2,0,1,0,1,0,7,1.0,1,0.0,0,2,0,1,3,0,0,1,0,3,4,1
5078,138209,dSGnj6srDjb9PWIgErMSQXx2qQzyzYUX,7GRhBDsirIGkRZBtSMEzNTyDr2JQm4xx,1,0,0,0,0,0,1,0,1,0.14285714285714285,1,0.0,0,0,0,0,0,0,0,1,0,0,1,1
5079,138214,adfbW7xBPY784GRXAIq3fInFogIbD6ro,7GRhBDsirIGkRZBtSMEzNTyDr2JQm4xx,37,65,21,20,16,0,4,0,126,18.0,3,0.0,37,21,14,16,28,0,6,4,0,88,38,0
5080,138220,s1Q2cr9WUv6ymraZFi4Kx4UjpYZdQMAO,7GRhBDsirIGkRZBtSMEzNTyDr2JQm4xx,2,0,0,0,0,0,2,0,2,0.2857142857142857,1,0.0,0,0,0,0,0,0,0,2,0,0,2,0
5081,138226,xBRGHAvkTfDDok4cH7N9aC7OMTMv6n3O,7GRhBDsirIGkRZBtSMEzNTyDr2JQm4xx,1,0,0,0,0,0,1,0,1,0.14285714285714285,1,0.0,0,0,0,0,0,0,0,1,0,0,1,1
5082,138241,JEJrnVrKGVjrX2yiet4Z0AOP8Myw4oGI,bWdj2GDclj5ofokWjzoa5jAwMkxCykd6,1,0,0,0,0,0,1,0,1,0.14285714285714285,1,0.0,0,0,0,0,0,0,0,1,0,0,1,1
5083,138244,DKNUSy56RJeSuYO3Dp6WYMwUBdoAcQ0a,A3fsA9Zfv1X2fVEQhTw51lKENdNrEqT3,2,0,0,0,0,0,5,0,5,0.7142857142857143,2,0.0,0,0,0,0,0,0,0,5,0,0,5,1
5084,138245,23wd4TSvccQ5i0TXkpg2or3OurpyZgtJ,bWdj2GDclj5ofokWjzoa5jAwMkxCykd6,14,34,24,0,20,8,3,0,89,12.714285714285714,2,0.0,7,24,0,20,27,8,0,3,0,51,38,1
5085,138250,szmVnhPypUPoSdN8Z8D02a6M8Gjrnwmf,A3fsA9Zfv1X2fVEQhTw51lKENdNrEqT3,3,2,1,0,0,0,2,0,5,0.7142857142857143,1,0.0,0,1,0,0,2,0,0,2,0,1,4,1
5086,138251,xk5bwSTEAMNKyEU3iNkOO0oTip8zPc6K,SpATywNh6bZuzm8s1ceuBUnMUAeoAHHw,11,9,4,0,2,0,7,1,23,3.2857142857142856,1,0.0,4,4,0,2,5,0,0,7,1,10,13,1
5087,138254,KYRH4WW7qsAOiOmj346TRF2odLv2Stw0,A3fsA9Zfv1X2fVEQhTw51lKENdNrEqT3,1,0,0,0,0,0,1,0,1,0.14285714285714285,1,0.0,0,0,0,0,0,0,0,1,0,0,1,1
5088,138261,JL9rcevmVnCXKLKkXE87B1mrZmlYAcd1,SpATywNh6bZuzm8s1ceuBUnMUAeoAHHw,36,54,27,22,11,17,9,0,140,20.0,2,0.0,18,27,19,11,36,17,3,9,0,75,65,0
5089,138263,qlnTBDOgseVRcQc5nkjCE7nCQ5SaoF4b,SpATywNh6bZuzm8s1ceuBUnMUAeoAHHw,7,15,0,0,0,0,3,0,18,2.5714285714285716,1,0.0,4,0,0,0,11,0,0,3,0,4,14,0
5090,138287,UJP97i2EJO4yjxI3DoA9AGA9qgzPRSeL,SpATywNh6bZuzm8s1ceuBUnMUAeoAHHw,6,3,1,0,1,0,4,0,9,1.2857142857142858,1,0.0,0,1,0,1,3,0,0,4,0,2,7,0
5091,138295,Dt8GK32H2MKtd6RVUxAk9cGVg15c101a,SpATywNh6bZuzm8s1ceuBUnMUAeoAHHw,1,0,0,0,0,0,2,0,2,0.2857142857142857,1,0.0,0,0,0,0,0,0,0,2,0,0,2,1
5092,138343,ekYJdZlodJJPGitBh9pJscwF42WGcv9J,SpATywNh6bZuzm8s1ceuBUnMUAeoAHHw,23,24,8,55,1,0,7,0,95,13.571428571428571,2,0.0,16,8,52,1,8,0,3,7,0,77,18,1
5093,138355,ancEkQokkVyJAjklV2PDvj1zIb7dKLV4,SpATywNh6bZuzm8s1ceuBUnMUAeoAHHw,23,13,9,8,7,0,2,0,39,5.571428571428571,1,0.0,2,9,8,7,11,0,0,2,0,26,13,1
5094,138357,NWaycxyjC99lvvlBzZhN9tb7U8fdoRvb,SpATywNh6bZuzm8s1ceuBUnMUAeoAHHw,49,56,30,49,20,59,15,0,229,32.714285714285715,5,0.0,12,30,39,20,44,59,10,15,0,101,128,0
5095,138371,uq5cRZDN2ZW7GTU6WfEkZYQCsqLxl96C,SpATywNh6bZuzm8s1ceuBUnMUAeoAHHw,16,20,12,0,6,0,7,0,45,6.428571428571429,3,0.0,5,12,0,6,15,0,0,7,0,23,22,0
5096,138380,0I055s9vaRQ6PXqeLKyD6l9kPxlReBT2,bWdj2GDclj5ofokWjzoa5jAwMkxCykd6,1,0,0,0,0,0,1,0,1,0.14285714285714285,1,0.0,0,0,0,0,0,0,0,1,0,0,1,1
5097,138385,R6r85AVni0tNGUvDSXb5ztmJaVo4FSr1,G8EPVSXsOYB5YQWZGiz1aVq5Pgr2GrQu,44,46,2,0,2,0,4,0,54,7.714285714285714,4,0.0,0,2,0,2,46,0,0,4,0,4,50,0
5098,138387,vLDUFKClgtT31VAwcYV5sIfp3TdS79BU,SpATywNh6bZuzm8s1ceuBUnMUAeoAHHw,4,2,1,0,1,0,1,0,5,0.7142857142857143,1,0.0,0,1,0,1,2,0,0,1,0,2,3,1
5099,138411,MF5edVvM6lCZDxnMdHelos9TUh3KERjn,G8EPVSXsOYB5YQWZGiz1aVq5Pgr2GrQu,30,30,18,8,14,0,3,0,73,10.428571428571429,1,0.0,10,18,5,14,20,0,3,3,0,47,26,1
5100,138412,9BgQxlrJHLSftkwUDKA3hmgF0QPDtIyc,G8EPVSXsOYB5YQWZGiz1aVq5Pgr2GrQu,2,0,0,0,0,0,2,0,2,0.2857142857142857,1,0.0,0,0,0,0,0,0,0,2,0,0,2,1
5101,138414,5mNJWEGtR9vdITQL1nnAvZIW2PAaTXsY,bWdj2GDclj5ofokWjzoa5jAwMkxCykd6,6,7,1,0,1,0,3,0,12,1.7142857142857142,2,0.0,0,1,0,1,7,0,0,3,0,2,10,1
5102,138422,PBT0xI17u81InQO08yLXpu6kSLQPC6l6,SpATywNh6bZuzm8s1ceuBUnMUAeoAHHw,17,18,1,18,1,0,4,3,45,6.428571428571429,3,0.0,2,1,15,1,16,0,3,4,3,19,26,0
5103,138432,4iRTdFrWnotIGLB21xnhMmvH623uk9Hg,SpATywNh6bZuzm8s1ceuBUnMUAeoAHHw,42,39,25,33,13,5,6,0,121,17.285714285714285,3,0.0,9,25,33,13,30,5,0,6,0,80,41,0
5104,138471,fZ0oG5LBFzyKBjVittCXSe5AVrs1RLoH,bWdj2GDclj5ofokWjzoa5jAwMkxCykd6,8,5,3,0,2,0,4,1,15,2.142857142857143,1,0.0,0,3,0,2,5,0,0,4,1,5,10,1
5105,138479,SVARW24mXzqWXiwQp4WEGlIIe2iZEl67,SpATywNh6bZuzm8s1ceuBUnMUAeoAHHw,11,14,0,15,0,0,2,0,31,4.428571428571429,1,0.0,8,0,12,0,6,0,3,2,0,20,11,0
5106,138483,h3tZErnQrcWD68hy7YWeUF3OyjhWokHu,SpATywNh6bZuzm8s1ceuBUnMUAeoAHHw,1,0,0,0,0,0,1,0,1,0.14285714285714285,1,0.0,0,0,0,0,0,0,0,1,0,0,1,1
5107,138496,mSXZKJ9e3RCTXopgrFUphpxYgeKp7tlG,SpATywNh6bZuzm8s1ceuBUnMUAeoAHHw,47,54,33,24,15,0,9,0,135,19.285714285714285,5,0.0,12,33,23,15,42,0,1,9,0,83,52,0
5108,138503,hWYoTdCS0YLADoWfxXH71olbwetTTuPX,A3fsA9Zfv1X2fVEQhTw51lKENdNrEqT3,9,42,2,0,0,0,7,0,51,7.285714285714286,3,0.0,0,2,0,0,42,0,0,7,0,2,49,1
5109,138520,SVfMOf78rQIhc5bUdZbaTCmOKKmn1NJW,SpATywNh6bZuzm8s1ceuBUnMUAeoAHHw,10,5,4,0,3,0,2,0,14,2.0,1,0.0,0,4,0,3,5,0,0,2,0,7,7,1
5110,138536,dfuq1nLFAi23gUE5vCmhP6T2naLzIcA3,SpATywNh6bZuzm8s1ceuBUnMUAeoAHHw,1,0,0,0,0,0,1,0,1,0.14285714285714285,1,0.0,0,0,0,0,0,0,0,1,0,0,1,1
5111,138544,K5kT5J7jKlVkFTVXY5IK3L2ReisrBiVS,RXDvfPUBYFlVdlueBFbLW0mhhAyGEqpt,12,14,7,29,3,0,2,0,55,7.857142857142857,1,0.0,6,7,21,3,8,0,8,2,0,37,18,1
5112,138545,S5iRqyOmmXNAeHlaI33tGlS1KWic6aj1,bWdj2GDclj5ofokWjzoa5jAwMkxCykd6,6,9,2,0,4,0,4,0,19,2.7142857142857144,1,0.0,6,2,0,4,3,0,0,4,0,12,7,1
5113,138561,0jMvKl4f4yq4swqJtBTb4m7rvyBg43HC,SpATywNh6bZuzm8s1ceuBUnMUAeoAHHw,5,4,2,0,1,0,2,0,9,1.2857142857142858,1,0.0,0,2,0,1,4,0,0,2,0,3,6,1
5114,138569,H68GXqsnvE2fb3Idf2i1DH8yakiWVkwR,A3fsA9Zfv1X2fVEQhTw51lKENdNrEqT3,7,5,2,0,2,0,2,0,11,1.5714285714285714,1,0.0,0,2,0,2,5,0,0,2,0,4,7,1
5115,138583,lhWBAeHfXafZlHCmXNLhsmCoHIt1IQ7L,SpATywNh6bZuzm8s1ceuBUnMUAeoAHHw,5,2,1,0,1,0,3,0,7,1.0,1,0.0,0,1,0,1,2,0,0,3,0,2,5,1
5116,138589,7KTA3JttmyRh7woCe5mVgkjc6Qjso7i4,SpATywNh6bZuzm8s1ceuBUnMUAeoAHHw,1,0,0,0,0,0,1,0,1,0.14285714285714285,1,0.0,0,0,0,0,0,0,0,1,0,0,1,1
5117,138613,ONe4iInwtHkZ5gtlbWN831JopVHbaD8L,G8EPVSXsOYB5YQWZGiz1aVq5Pgr2GrQu,24,51,21,0,12,0,1,0,85,12.142857142857142,1,0.0,0,21,0,12,51,0,0,1,0,33,52,1
5118,138616,fUQHFT4QEMRSPqJAQlXlvlyNwca9Q0dU,A3fsA9Zfv1X2fVEQhTw51lKENdNrEqT3,7,4,0,0,0,0,3,0,7,1.0,1,0.0,0,0,0,0,4,0,0,3,0,0,7,1
5119,138626,fCpCrSs2mKjLscSCn1FHIkvQbSv4LbYE,bWdj2GDclj5ofokWjzoa5jAwMkxCykd6,1,0,0,0,0,0,1,0,1,0.14285714285714285,1,0.0,0,0,0,0,0,0,0,1,0,0,1,1
5120,138631,4D11IEAbvt5M4yzWoODDtOFh00iJuVTK,SpATywNh6bZuzm8s1ceuBUnMUAeoAHHw,25,41,1,19,1,0,3,0,65,9.285714285714286,2,0.0,18,1,17,1,23,0,2,3,0,37,28,0
5121,138632,UcanAXkT95ylp5ubNi37V7psHMFxiz1f,RXDvfPUBYFlVdlueBFbLW0mhhAyGEqpt,58,72,1,143,2,45,14,2,279,39.857142857142854,1,0.0,14,1,134,2,58,45,9,14,2,151,128,0
5122,138641,247FLfH4Mb594RFNNow4NoO1PsYj55Me,RXDvfPUBYFlVdlueBFbLW0mhhAyGEqpt,11,5,1,0,1,0,5,0,12,1.7142857142857142,1,0.0,0,1,0,1,5,0,0,5,0,2,10,1
5123,138644,klFfeIWt13kJyzZ8QBX8igiJe3NNykgD,SpATywNh6bZuzm8s1ceuBUnMUAeoAHHw,3,2,0,0,0,0,1,0,3,0.42857142857142855,1,0.0,0,0,0,0,2,0,0,1,0,0,3,1
5124,138649,xd3R9FpcIKhYRXFLFLDzZPRPvMMXOj1o,SpATywNh6bZuzm8s1ceuBUnMUAeoAHHw,41,56,33,38,0,17,15,2,161,23.0,2,0.0,18,33,35,0,38,17,3,15,2,86,75,0
5125,138695,dbtlJh8uWixqUAz5pHAMwXOZNVVUTuzi,SpATywNh6bZuzm8s1ceuBUnMUAeoAHHw,4,2,0,0,0,0,2,0,4,0.5714285714285714,1,0.0,0,0,0,0,2,0,0,2,0,0,4,1
5126,138699,p5RtwcA9vuKdWJZrb7lEE3M3hOjsWHJi,A3fsA9Zfv1X2fVEQhTw51lKENdNrEqT3,61,29,2,191,0,0,10,1,233,33.285714285714285,1,0.0,9,2,163,0,20,0,28,10,1,174,59,1
5127,138700,URDT7UEnATnBeUQYxPwZ1xbRtpHzMsBO,SpATywNh6bZuzm8s1ceuBUnMUAeoAHHw,47,38,26,19,17,0,7,0,107,15.285714285714286,5,0.0,2,26,16,17,36,0,3,7,0,61,46,0
5128,138707,F0EH5ewON9VykhUnDQqIKLqtLDoqhPsI,bWdj2GDclj5ofokWjzoa5jAwMkxCykd6,12,21,7,0,0,2,10,1,41,5.857142857142857,1,0.0,6,7,0,0,15,2,0,10,1,13,28,0
5129,138741,6bJug3laIIWWCaCLyBLU00ZUhfOCair3,G8EPVSXsOYB5YQWZGiz1aVq5Pgr2GrQu,2,0,0,0,0,0,2,0,2,0.2857142857142857,1,0.0,0,0,0,0,0,0,0,2,0,0,2,1
5130,138785,O1Ztz9KIKs4JpSImKRRrzfUM0dpj0hIe,SpATywNh6bZuzm8s1ceuBUnMUAeoAHHw,9,6,0,10,0,0,5,0,21,3.0,3,0.0,2,0,10,0,4,0,0,5,0,12,9,0
5131,138790,dw62ngoCoOUMjCVivRFAShXF5gbGsZWV,SpATywNh6bZuzm8s1ceuBUnMUAeoAHHw,5,4,1,0,1,0,2,0,8,1.1428571428571428,1,0.0,0,1,0,1,4,0,0,2,0,2,6,1
5132,138791,a19tMY1HS7MdnIZIQ0I2umOGQttKJ1uy,RXDvfPUBYFlVdlueBFbLW0mhhAyGEqpt,13,14,5,9,6,0,5,1,40,5.714285714285714,1,0.0,6,5,9,6,8,0,0,5,1,26,14,1
5133,138818,okqN4nBVKRYYrkYonKicKGOmPqVGYjZh,RXDvfPUBYFlVdlueBFbLW0mhhAyGEqpt,7,13,6,0,0,17,8,0,44,6.285714285714286,1,0.0,0,6,0,0,13,17,0,8,0,6,38,0
5134,138847,MAd8tH47KthSEzVrLAKG5qRX6SRuj7GJ,5X6FeZozNMgE2VRi3MJYjkkFK8SETtu2,17,44,8,16,13,0,5,0,86,12.285714285714286,4,0.0,30,8,14,13,14,0,2,5,0,65,21,1
5135,138865,AYiGvgKDaGiBpYEcJ7Espvi6dQy2aiFd,SpATywNh6bZuzm8s1ceuBUnMUAeoAHHw,25,43,7,13,1,0,7,0,71,10.142857142857142,5,0.0,12,7,13,1,31,0,0,7,0,33,38,0
5136,138887,LVgGKe8GEjU3xNkkgcLCws2DFML8rckJ,bWdj2GDclj5ofokWjzoa5jAwMkxCykd6,1,0,0,0,0,0,1,0,1,0.14285714285714285,1,0.0,0,0,0,0,0,0,0,1,0,0,1,1
5137,138891,a9MMqUpuUSR3IzgW99lgUm9PMVCCff15,SpATywNh6bZuzm8s1ceuBUnMUAeoAHHw,5,2,1,0,1,0,2,0,6,0.8571428571428571,1,0.0,0,1,0,1,2,0,0,2,0,2,4,1
5138,138900,bHqXWqN9pt89j5bH9fnt5jMZVOQZImRj,7GRhBDsirIGkRZBtSMEzNTyDr2JQm4xx,1,0,0,0,0,0,1,0,1,0.14285714285714285,1,0.0,0,0,0,0,0,0,0,1,0,0,1,1
5139,138909,a9MMqUpuUSR3IzgW99lgUm9PMVCCff15,A3fsA9Zfv1X2fVEQhTw51lKENdNrEqT3,5,2,1,0,1,0,2,0,6,0.8571428571428571,1,0.0,0,1,0,1,2,0,0,2,0,2,4,1
5140,138910,mIHD2jrknaRciO3CSsk0UVjwF79EIvXO,RXDvfPUBYFlVdlueBFbLW0mhhAyGEqpt,4,2,0,0,0,4,2,0,8,1.1428571428571428,1,0.0,0,0,0,0,2,4,0,2,0,0,8,1
5141,138918,TRryTScYmrJYu9foqAm7Z1ALNBOdlA1X,SpATywNh6bZuzm8s1ceuBUnMUAeoAHHw,14,29,0,12,0,0,9,2,52,7.428571428571429,2,0.0,17,0,11,0,12,0,1,9,2,28,24,1
5142,138941,OqoyGVhMdqCmcn9uCtXU2u6JDkNgnUSS,SpATywNh6bZuzm8s1ceuBUnMUAeoAHHw,29,22,18,0,16,0,4,0,60,8.571428571428571,2,0.0,0,18,0,16,22,0,0,4,0,34,26,1
5143,138946,b9kku2PsSG5AAAeEY7DQePn7yzD0gmyo,G8EPVSXsOYB5YQWZGiz1aVq5Pgr2GrQu,19,15,4,20,3,0,1,0,43,6.142857142857143,1,0.0,10,4,10,3,5,0,10,1,0,27,16,0
5144,138947,2Ueq99WOxFkvLjKvdAbi1TRY9isnfhGR,SpATywNh6bZuzm8s1ceuBUnMUAeoAHHw,1,0,0,0,0,0,1,0,1,0.14285714285714285,1,0.0,0,0,0,0,0,0,0,1,0,0,1,1
5145,138957,LDYjWqhrIxv22jlLe9In731UT9Ne6fvw,SpATywNh6bZuzm8s1ceuBUnMUAeoAHHw,8,4,2,11,0,0,3,0,20,2.857142857142857,1,0.0,2,2,10,0,2,0,1,3,0,14,6,1
5146,138958,SstKsQWEBJfXpsf5A46CO9g706uArlpY,RXDvfPUBYFlVdlueBFbLW0mhhAyGEqpt,5,3,0,0,0,1,2,0,6,0.8571428571428571,1,0.0,0,0,0,0,3,1,0,2,0,0,6,0
5147,138962,NKKgqSSwnJpenRYnE59UQVVdasPdam0Z,SpATywNh6bZuzm8s1ceuBUnMUAeoAHHw,20,18,10,14,5,5,11,2,65,9.285714285714286,3,0.0,5,10,11,5,13,5,3,11,2,31,34,1
5148,138973,v7pdrt6SOAQ5FMXohVYmR0yZQdsegJw7,bWdj2GDclj5ofokWjzoa5jAwMkxCykd6,8,8,2,0,2,0,5,0,17,2.4285714285714284,4,0.0,0,2,0,2,8,0,0,5,0,4,13,0
5149,138974,ouL32O71NoAWgx7epnnVebKIsbBDnj9P,SpATywNh6bZuzm8s1ceuBUnMUAeoAHHw,51,64,35,46,24,8,18,4,199,28.428571428571427,3,0.0,18,35,36,24,46,8,10,18,4,113,86,0
5150,138993,mLD9g4ezOv6SvPMWLaj047DaKrptKosJ,5X6FeZozNMgE2VRi3MJYjkkFK8SETtu2,1,0,0,0,0,0,1,0,1,0.14285714285714285,1,0.0,0,0,0,0,0,0,0,1,0,0,1,1
5151,138994,8zO55rr0YRpKXIkdnMjpGC4LQsXgWFT5,5X6FeZozNMgE2VRi3MJYjkkFK8SETtu2,1,0,0,0,0,0,1,0,1,0.14285714285714285,1,0.0,0,0,0,0,0,0,0,1,0,0,1,1
5152,139004,aKtqxPEfMnVhEPAMX3aHrnYTfbYN9i8f,A3fsA9Zfv1X2fVEQhTw51lKENdNrEqT3,1,0,0,0,0,0,1,0,1,0.14285714285714285,1,0.0,0,0,0,0,0,0,0,1,0,0,1,1
5153,139006,3wXMZkXBm1ATxVfwmh0YqzBsBRzhFw8P,SpATywNh6bZuzm8s1ceuBUnMUAeoAHHw,4,6,2,0,0,0,1,0,9,1.2857142857142858,1,0.0,3,2,0,0,3,0,0,1,0,5,4,0
5154,139013,ucdoEtZyBMBpMuHw7eldMzgNsB5u9NZD,A3fsA9Zfv1X2fVEQhTw51lKENdNrEqT3,2,0,0,0,0,0,5,0,5,0.7142857142857143,1,0.0,0,0,0,0,0,0,0,5,0,0,5,1
5155,139018,FbUvC9kIlbjOWJZkNuNKPe74SYVSmlJl,SpATywNh6bZuzm8s1ceuBUnMUAeoAHHw,6,3,2,0,2,0,1,0,8,1.1428571428571428,1,0.0,0,2,0,2,3,0,0,1,0,4,4,1
5156,139035,nd6sluT5nIbtyItOnd1zUbNlfRFXkzgp,5X6FeZozNMgE2VRi3MJYjkkFK8SETtu2,5,2,1,0,1,0,2,0,6,0.8571428571428571,1,0.0,0,1,0,1,2,0,0,2,0,2,4,1
5157,139049,2NNFHRZmwsPe1B99Qw8qhCzLBWZ750pt,bWdj2GDclj5ofokWjzoa5jAwMkxCykd6,10,9,4,0,2,3,14,3,35,5.0,1,0.0,2,4,0,2,7,3,0,14,3,8,27,1
5158,139057,nqLRPpborGO3IzbD5YxVONrZGqxfXpwO,A3fsA9Zfv1X2fVEQhTw51lKENdNrEqT3,5,5,1,0,1,0,1,0,8,1.1428571428571428,1,0.0,0,1,0,1,5,0,0,1,0,2,6,0
5159,139060,3RamXhwDB6su3FqsOEul2F9rEiIGtftu,bWdj2GDclj5ofokWjzoa5jAwMkxCykd6,4,3,1,0,1,0,6,0,11,1.5714285714285714,1,0.0,0,1,0,1,3,0,0,6,0,2,9,1
5160,139071,a7ZVMpb0c7CARO4liNTBsp4hgkFIkG4C,A3fsA9Zfv1X2fVEQhTw51lKENdNrEqT3,1,0,0,0,0,0,1,0,1,0.14285714285714285,1,0.0,0,0,0,0,0,0,0,1,0,0,1,1
5161,139073,r2VP84vIhleP2JRhufK44gQkfMu0ayYL,A3fsA9Zfv1X2fVEQhTw51lKENdNrEqT3,7,4,3,0,3,0,3,0,13,1.8571428571428572,1,0.0,0,3,0,3,4,0,0,3,0,6,7,1
5162,139075,a7ZVMpb0c7CARO4liNTBsp4hgkFIkG4C,5X6FeZozNMgE2VRi3MJYjkkFK8SETtu2,7,9,4,0,5,0,3,0,21,3.0,2,0.0,4,4,0,5,5,0,0,3,0,13,8,1
5163,139081,AUQbcN6sP8jOc3r7pDcomR6R8baoxLvG,RXDvfPUBYFlVdlueBFbLW0mhhAyGEqpt,46,92,49,50,9,4,5,0,209,29.857142857142858,3,0.0,15,49,46,9,77,4,4,5,0,119,90,0
5164,139085,heVJWbQBtCN8obfXQBAbcR0I5MnOvCPs,G8EPVSXsOYB5YQWZGiz1aVq5Pgr2GrQu,29,9,6,97,1,0,4,0,117,16.714285714285715,3,0.0,0,6,87,1,9,0,10,4,0,94,23,0
5165,139090,y8bZlCtdeIdFsLmd09IvS19n3aRTkHSW,bWdj2GDclj5ofokWjzoa5jAwMkxCykd6,6,6,1,0,1,0,2,0,10,1.4285714285714286,2,0.0,0,1,0,1,6,0,0,2,0,2,8,1
5166,139109,CbHE8hCSYPvdgYMpDUO4zyKrMGfMTSJS,5X6FeZozNMgE2VRi3MJYjkkFK8SETtu2,1,0,0,0,0,0,1,0,1,0.14285714285714285,1,0.0,0,0,0,0,0,0,0,1,0,0,1,1
5167,139119,FIYIY0le6IgAtT64SQdOQ9wlHEZCwQOO,A3fsA9Zfv1X2fVEQhTw51lKENdNrEqT3,5,2,1,0,1,0,3,0,7,1.0,1,0.0,0,1,0,1,2,0,0,3,0,2,5,1
5168,139120,bjR8VCa57HhC9FMIDzdply9YThOSMqPi,5X6FeZozNMgE2VRi3MJYjkkFK8SETtu2,6,3,1,0,1,0,2,0,7,1.0,1,0.0,0,1,0,1,3,0,0,2,0,2,5,0
5169,139135,qQva6iW8x8zRei3swvtJZM6WawbenNEN,G8EPVSXsOYB5YQWZGiz1aVq5Pgr2GrQu,15,6,5,0,5,1,9,2,28,4.0,1,0.0,1,5,0,5,5,1,0,9,2,11,17,1
5170,139144,CeskLH9m953bFnFMALF6StQidFq10Eca,SpATywNh6bZuzm8s1ceuBUnMUAeoAHHw,6,6,4,0,1,0,1,0,12,1.7142857142857142,1,0.0,1,4,0,1,5,0,0,1,0,6,6,1
5171,139149,UA8vU3s92g3lXc62U363PEO0xor6Mpeg,SpATywNh6bZuzm8s1ceuBUnMUAeoAHHw,38,29,23,2,19,0,3,0,76,10.857142857142858,2,0.0,3,23,2,19,26,0,0,3,0,47,29,0
5172,139170,gBe7EORYc8tWLPpy5CEZ7VaeCy9UzNag,SpATywNh6bZuzm8s1ceuBUnMUAeoAHHw,6,3,1,0,0,0,4,1,9,1.2857142857142858,1,0.0,0,1,0,0,3,0,0,4,1,1,8,1
5173,139181,arqk7DTh1VGICIY90l0CngaLIKuIO724,RXDvfPUBYFlVdlueBFbLW0mhhAyGEqpt,28,44,25,40,2,6,5,0,122,17.428571428571427,2,0.0,2,25,34,2,42,6,6,5,0,63,59,0
5174,139194,xSaKZnAMCNpefu5juxSqjRpkUhr14wlR,A3fsA9Zfv1X2fVEQhTw51lKENdNrEqT3,6,4,0,0,0,1,5,0,10,1.4285714285714286,1,0.0,0,0,0,0,4,1,0,5,0,0,10,1
5175,139196,XaDObnlcjPgfFvrsAMoLqKp3YSHBUNeu,5X6FeZozNMgE2VRi3MJYjkkFK8SETtu2,5,0,0,0,0,1,7,1,9,1.2857142857142858,1,0.0,0,0,0,0,0,1,0,7,1,0,9,1
5176,139241,mR38LOzPkDgy4Z7CZO92yHt4TSlNwfzC,A3fsA9Zfv1X2fVEQhTw51lKENdNrEqT3,10,8,1,0,0,0,10,1,20,2.857142857142857,1,0.0,0,1,0,0,8,0,0,10,1,1,19,1
5177,139257,UBhVC0WaVWM4P6ieHzAF19GMdFyBLfD4,SpATywNh6bZuzm8s1ceuBUnMUAeoAHHw,59,68,47,53,37,13,6,0,224,32.0,3,0.0,12,47,47,37,56,13,6,6,0,143,81,0
5178,139259,izfjE6NG3af26sY3NuLKpzoBmikc8i1O,bWdj2GDclj5ofokWjzoa5jAwMkxCykd6,9,4,3,0,2,0,3,0,12,1.7142857142857142,1,0.0,0,3,0,2,4,0,0,3,0,5,7,1
5179,139276,bPNiwUCUO5XdlJjasSfnyvxXSu8K1h7Q,RXDvfPUBYFlVdlueBFbLW0mhhAyGEqpt,1,0,0,0,0,0,1,0,1,0.14285714285714285,1,0.0,0,0,0,0,0,0,0,1,0,0,1,1
5180,139288,IWTpJo3Xdx5l8YSxAjWkfR932wmDoCRC,SpATywNh6bZuzm8s1ceuBUnMUAeoAHHw,5,7,2,0,1,2,3,0,15,2.142857142857143,1,0.0,0,2,0,1,7,2,0,3,0,3,12,1
5181,139293,SL3jxjEQk6v82n0aWfLP80T9svpvrAxv,5X6FeZozNMgE2VRi3MJYjkkFK8SETtu2,7,7,3,0,3,0,2,0,15,2.142857142857143,2,0.0,2,3,0,3,5,0,0,2,0,8,7,1
5182,139298,gejpeIdpjStfIOq4XQNQvvNIbDoDOFhN,bWdj2GDclj5ofokWjzoa5jAwMkxCykd6,5,2,1,0,1,0,4,0,8,1.1428571428571428,1,0.0,0,1,0,1,2,0,0,4,0,2,6,0
5183,139302,mFcnZc9xJHpcsnNSqrnt1TraJ39cAeOG,SpATywNh6bZuzm8s1ceuBUnMUAeoAHHw,9,8,1,0,1,0,3,0,13,1.8571428571428572,1,0.0,0,1,0,1,8,0,0,3,0,2,11,0
5184,139312,vlarE7zCdES78rsfbZ9s0PTdwVr1rAk4,A3fsA9Zfv1X2fVEQhTw51lKENdNrEqT3,6,14,1,0,1,0,3,0,19,2.7142857142857144,3,0.0,0,1,0,1,14,0,0,3,0,2,17,1
5185,139325,Wn6M5pDE1BQQohcN99ynI9TPsF44SXAJ,5X6FeZozNMgE2VRi3MJYjkkFK8SETtu2,9,6,4,0,3,0,1,0,14,2.0,1,0.0,0,4,0,3,6,0,0,1,0,7,7,1
5186,139337,yQGwQkQvYmsNm3l8iENxe5EfvwaWshI7,SpATywNh6bZuzm8s1ceuBUnMUAeoAHHw,1,0,0,0,0,0,1,0,1,0.14285714285714285,1,0.0,0,0,0,0,0,0,0,1,0,0,1,1
5187,139361,sA2rUsJ0NxTB8HUngN94aqlC0TKNyhII,A3fsA9Zfv1X2fVEQhTw51lKENdNrEqT3,7,0,0,0,0,1,8,1,10,1.4285714285714286,1,0.0,0,0,0,0,0,1,0,8,1,0,10,1
5188,139363,8CgFwutv1MXk0sIfiSIZYIfZCkRfaV3H,5X6FeZozNMgE2VRi3MJYjkkFK8SETtu2,5,2,1,0,1,0,2,0,6,0.8571428571428571,1,0.0,0,1,0,1,2,0,0,2,0,2,4,1
5189,139366,tRdx0tRHXkoW2WJ4mnzpdZfXXXIdX04T,SpATywNh6bZuzm8s1ceuBUnMUAeoAHHw,27,63,1,24,1,2,9,0,100,14.285714285714286,4,0.0,18,1,24,1,45,2,0,9,0,44,56,0
5190,139387,FlAkKX6ow9SvOzk0dTWPWgnX5766zY29,RXDvfPUBYFlVdlueBFbLW0mhhAyGEqpt,5,4,2,0,1,0,1,0,8,1.1428571428571428,1,0.0,0,2,0,1,4,0,0,1,0,3,5,1
5191,139391,iLtON4OdzeG1y617iqhiryM9G4xoGAr5,SpATywNh6bZuzm8s1ceuBUnMUAeoAHHw,23,26,3,17,1,2,9,4,62,8.857142857142858,2,0.0,5,3,14,1,21,2,3,9,4,23,39,0
5192,139417,Eu8Qqpqb0GF09dcSDaIzMqGOvyPF0qRO,SpATywNh6bZuzm8s1ceuBUnMUAeoAHHw,1,0,0,0,0,0,1,0,1,0.14285714285714285,1,0.0,0,0,0,0,0,0,0,1,0,0,1,0
5193,139427,RilPnDVnlT9lfSJkTtPGJBpYx1VNW6Lv,SpATywNh6bZuzm8s1ceuBUnMUAeoAHHw,7,5,3,0,2,0,4,0,14,2.0,1,0.0,0,3,0,2,5,0,0,4,0,5,9,0
5194,139450,Ae22hvALqv0MxUz0BtfyFRCZH8Unzasl,G8EPVSXsOYB5YQWZGiz1aVq5Pgr2GrQu,4,3,0,0,0,0,1,0,4,0.5714285714285714,1,0.0,0,0,0,0,3,0,0,1,0,0,4,1
5195,139461,h1ztb0p8BMq619bNmxNVQh8qv21IVm55,SpATywNh6bZuzm8s1ceuBUnMUAeoAHHw,33,26,21,0,13,0,7,0,67,9.571428571428571,3,0.0,0,21,0,13,26,0,0,7,0,34,33,0
5196,139463,htakCdKp1xnLFWo197VQ9qXnetvOXP4f,G8EPVSXsOYB5YQWZGiz1aVq5Pgr2GrQu,11,10,4,2,3,0,3,0,22,3.142857142857143,1,0.0,5,4,1,3,5,0,1,3,0,13,9,1
5197,139479,cDV3uv01OqR28HAw8WapmztMslx9jbkZ,A3fsA9Zfv1X2fVEQhTw51lKENdNrEqT3,2,0,0,0,0,0,3,0,3,0.42857142857142855,1,0.0,0,0,0,0,0,0,0,3,0,0,3,1
5198,139497,CQdAGcIvDdIBklDWFKtch5fpBdl4NTjN,SpATywNh6bZuzm8s1ceuBUnMUAeoAHHw,1,0,0,0,0,0,1,0,1,0.14285714285714285,1,0.0,0,0,0,0,0,0,0,1,0,0,1,1
5199,139502,hLHRmItIrBAAjPponbejbmcuRqVRIxcd,G8EPVSXsOYB5YQWZGiz1aVq5Pgr2GrQu,22,8,5,96,0,0,5,0,114,16.285714285714285,1,0.0,0,5,83,0,8,0,13,5,0,88,26,1
5200,139513,kQH8Ov2DffXYcWaAu4MH2EnCh6Qd1rUK,SpATywNh6bZuzm8s1ceuBUnMUAeoAHHw,2,0,0,0,0,0,2,0,2,0.2857142857142857,1,0.0,0,0,0,0,0,0,0,2,0,0,2,1
5201,139516,4CoGSxhhHWTO7EDjl5nO5mW4CLM3ADy3,SpATywNh6bZuzm8s1ceuBUnMUAeoAHHw,7,4,3,0,3,0,2,0,12,1.7142857142857142,1,0.0,0,3,0,3,4,0,0,2,0,6,6,0
5202,139529,eAoTqcSoJiOhBe2Vk1sWGAt0rJFMTxVe,5X6FeZozNMgE2VRi3MJYjkkFK8SETtu2,7,9,1,3,2,0,3,0,18,2.5714285714285716,1,0.0,7,1,3,2,2,0,0,3,0,13,5,1
5203,139551,EPVEir3f8DxjouE65Q4kYI9YaQMxGE89,SpATywNh6bZuzm8s1ceuBUnMUAeoAHHw,1,0,0,0,0,0,1,0,1,0.14285714285714285,1,0.0,0,0,0,0,0,0,0,1,0,0,1,1
5204,139559,6nz65mCAfg32rdc5I4EhrQzO2XWyRRBx,SpATywNh6bZuzm8s1ceuBUnMUAeoAHHw,7,3,2,0,2,0,2,0,9,1.2857142857142858,1,0.0,0,2,0,2,3,0,0,2,0,4,5,0
5205,139599,Fvf4nP4NQpA7TLxnLfVBCjH25x0B5J5v,A3fsA9Zfv1X2fVEQhTw51lKENdNrEqT3,6,1,1,0,1,0,4,0,7,1.0,1,0.0,0,1,0,1,1,0,0,4,0,2,5,0
5206,139603,mpVn51vIxcFHSSmrFHwBhXrXBYaAZHXF,A3fsA9Zfv1X2fVEQhTw51lKENdNrEqT3,22,11,2,24,2,1,16,1,57,8.142857142857142,2,0.0,0,2,20,2,11,1,4,16,1,24,33,1
5207,139610,9pq6iUHzjk4QDwVV6xT371Bi8wqYPvWa,5X6FeZozNMgE2VRi3MJYjkkFK8SETtu2,6,2,1,0,1,0,5,0,9,1.2857142857142858,2,0.0,0,1,0,1,2,0,0,5,0,2,7,1
5208,139616,kbYq8zrS6JfKuFI6mRE75tGmcW5U6pfr,SpATywNh6bZuzm8s1ceuBUnMUAeoAHHw,1,0,0,0,0,0,1,0,1,0.14285714285714285,1,0.0,0,0,0,0,0,0,0,1,0,0,1,1
5209,139636,ZiYtsb1Ak7GaNNWvoedvbdRDNHLU7j7m,RXDvfPUBYFlVdlueBFbLW0mhhAyGEqpt,1,0,0,0,0,0,1,0,1,0.14285714285714285,1,0.0,0,0,0,0,0,0,0,1,0,0,1,1
5210,139638,ZiYtsb1Ak7GaNNWvoedvbdRDNHLU7j7m,A3fsA9Zfv1X2fVEQhTw51lKENdNrEqT3,1,0,0,0,0,0,1,0,1,0.14285714285714285,1,0.0,0,0,0,0,0,0,0,1,0,0,1,1
5211,139670,oS7SUTBKh1bu6CNWHLkErC6YcVXZ37hg,SpATywNh6bZuzm8s1ceuBUnMUAeoAHHw,4,4,0,0,0,0,1,0,5,0.7142857142857143,1,0.0,0,0,0,0,4,0,0,1,0,0,5,0
5212,139675,Lk947zUxODvAz9uAzr7LhEhqya4oVnNV,A3fsA9Zfv1X2fVEQhTw51lKENdNrEqT3,4,0,0,0,0,0,7,1,8,1.1428571428571428,2,0.0,0,0,0,0,0,0,0,7,1,0,8,1
5213,139682,uhXQuUUUVKIwun4V8mG56AtnRcH7YsHS,A3fsA9Zfv1X2fVEQhTw51lKENdNrEqT3,6,1,1,0,0,1,6,0,9,1.2857142857142858,1,0.0,0,1,0,0,1,1,0,6,0,1,8,1
5214,139690,LUdeI1OPyNrX5I5cHCiKlVYRtO8YM2cA,SpATywNh6bZuzm8s1ceuBUnMUAeoAHHw,1,0,0,0,0,0,1,0,1,0.14285714285714285,1,0.0,0,0,0,0,0,0,0,1,0,0,1,1
5215,139710,wEM6o12i41X2Ow06y98SfdLhUndMStOe,SpATywNh6bZuzm8s1ceuBUnMUAeoAHHw,16,18,10,2,7,0,5,0,42,6.0,4,0.0,1,10,2,7,17,0,0,5,0,20,22,1
5216,139716,eluOlYcZJVTTjykOpIIga4LwzNLu5APk,bWdj2GDclj5ofokWjzoa5jAwMkxCykd6,1,0,0,0,0,0,1,0,1,0.14285714285714285,1,0.0,0,0,0,0,0,0,0,1,0,0,1,1
5217,139720,bKykRXJRwKOU9QAaF96MqPLjXHCHEd7I,SpATywNh6bZuzm8s1ceuBUnMUAeoAHHw,37,18,17,0,17,0,2,0,54,7.714285714285714,2,0.0,0,17,0,17,18,0,0,2,0,34,20,1
5218,139721,YI82gOPk3osjTxu9r38iyjq6I3W2WIaD,RXDvfPUBYFlVdlueBFbLW0mhhAyGEqpt,3,2,1,0,0,0,2,0,5,0.7142857142857143,2,0.0,0,1,0,0,2,0,0,2,0,1,4,0
5219,139760,qgQSG0aNbfBR28zJCPMHQYzbWLePLKUp,3VkHkmOtom3jM2wCu94xgzzu1d6Dn7or,1,0,0,0,0,0,1,0,1,0.14285714285714285,1,0.0,0,0,0,0,0,0,0,1,0,0,1,1
5220,139774,9MnIXVsvTDWVJ7Z8AvvQensotFfvlnnr,3VkHkmOtom3jM2wCu94xgzzu1d6Dn7or,1,0,0,0,0,0,1,0,1,0.14285714285714285,1,0.0,0,0,0,0,0,0,0,1,0,0,1,1
5221,139798,zf6I9KCPDTFVvRzyp9MXEc3K2I0azEBn,3VkHkmOtom3jM2wCu94xgzzu1d6Dn7or,1,0,0,0,0,0,2,0,2,0.2857142857142857,1,0.0,0,0,0,0,0,0,0,2,0,0,2,1
5222,139830,L1uEqjh9bbx3ogOtGkLvKNeCjzBYq8Tq,3VkHkmOtom3jM2wCu94xgzzu1d6Dn7or,20,64,17,26,0,21,6,0,134,19.142857142857142,4,0.0,42,17,25,0,22,21,1,6,0,84,50,1
5223,139922,fdtlxfecJaTaUhFaVnkgbPVAFcCJCGg3,3VkHkmOtom3jM2wCu94xgzzu1d6Dn7or,13,29,7,10,10,10,4,0,70,10.0,2,0.0,17,7,8,10,12,10,2,4,0,42,28,1
5224,139931,GNebghHXijuzxEsXtntIHVMx6jOB2h7A,3VkHkmOtom3jM2wCu94xgzzu1d6Dn7or,1,0,0,0,0,0,1,0,1,0.14285714285714285,1,0.0,0,0,0,0,0,0,0,1,0,0,1,1
5225,139933,CtmnSkOsrY9YY7Ca6ml9l0vbxEV8uB6o,3VkHkmOtom3jM2wCu94xgzzu1d6Dn7or,9,11,4,2,4,5,8,0,34,4.857142857142857,2,0.0,5,4,2,4,6,5,0,8,0,15,19,1
5226,140009,ddEC3CsG89EhQvHi1ngbvid0LNFnS4V6,3VkHkmOtom3jM2wCu94xgzzu1d6Dn7or,1,0,0,0,0,0,1,0,1,0.14285714285714285,1,0.0,0,0,0,0,0,0,0,1,0,0,1,1
5227,140016,eQCN30DKWc08tkJSA1YTQyesUPW0sBxe,3VkHkmOtom3jM2wCu94xgzzu1d6Dn7or,5,2,1,0,1,1,2,0,7,1.0,1,0.0,0,1,0,1,2,1,0,2,0,2,5,1
5228,140065,dFl7W8v50SymmEmQgkm3ydIWaA60KgIR,5X6FeZozNMgE2VRi3MJYjkkFK8SETtu2,6,3,2,0,2,0,1,0,8,1.1428571428571428,1,0.0,0,2,0,2,3,0,0,1,0,4,4,0
5229,140100,okqN4nBVKRYYrkYonKicKGOmPqVGYjZh,5X6FeZozNMgE2VRi3MJYjkkFK8SETtu2,25,94,24,0,8,0,31,0,157,22.428571428571427,5,0.0,29,24,0,8,65,0,0,31,0,61,96,0
5230,140185,FC4TBMak6GE4IpwU5zXd14C2OrRKgJpt,5X6FeZozNMgE2VRi3MJYjkkFK8SETtu2,9,8,3,0,1,1,8,1,22,3.142857142857143,1,0.0,0,3,0,1,8,1,0,8,1,4,18,1
5231,140242,jIzMRPWbR6wQjHcSJahgc6djKC15z8AV,5X6FeZozNMgE2VRi3MJYjkkFK8SETtu2,2,0,0,0,0,0,2,0,2,0.2857142857142857,1,0.0,0,0,0,0,0,0,0,2,0,0,2,0
5232,140247,R9YTqKiRQtfCswOmsq4jluMVxY0uToJG,7GRhBDsirIGkRZBtSMEzNTyDr2JQm4xx,25,20,13,23,3,1,7,1,68,9.714285714285714,2,0.0,6,13,18,3,14,1,5,7,1,40,28,0
5233,140274,fb2hdXt8pnk8ljm4Tpi5PWJyJ7R8YxLU,7GRhBDsirIGkRZBtSMEzNTyDr2JQm4xx,26,35,1,0,0,1,4,0,41,5.857142857142857,1,0.0,5,1,0,0,30,1,0,4,0,6,35,1
5234,140283,HePRyod5aTSIcFeoVudB8huyR12d5o5i,5X6FeZozNMgE2VRi3MJYjkkFK8SETtu2,5,3,1,0,1,0,2,0,7,1.0,1,0.0,1,1,0,1,2,0,0,2,0,3,4,1
5235,140338,vixag6bpwzwtdrSKIAHFpP8XohE3IVGO,7GRhBDsirIGkRZBtSMEzNTyDr2JQm4xx,10,10,6,15,0,6,3,0,40,5.714285714285714,1,0.0,3,6,12,0,7,6,3,3,0,21,19,0
5236,140347,aHSKyCYZ3S78IWGt7i6sBG1NSuBlIQiC,5X6FeZozNMgE2VRi3MJYjkkFK8SETtu2,2,0,0,0,0,0,3,0,3,0.42857142857142855,1,0.0,0,0,0,0,0,0,0,3,0,0,3,1
5237,140367,8mYK8nQ83ZErmFKnq8H8JUuesjrFIgSa,3VkHkmOtom3jM2wCu94xgzzu1d6Dn7or,83,126,56,68,41,37,53,6,387,55.285714285714285,11,0.0,42,56,58,41,84,37,10,53,6,197,190,0
5238,140372,2MeGOniySv4rbriRNtvstDvzzbUBuokH,3VkHkmOtom3jM2wCu94xgzzu1d6Dn7or,1,0,0,0,0,0,1,0,1,0.14285714285714285,1,0.0,0,0,0,0,0,0,0,1,0,0,1,0
5239,140383,X9p0TKSy4D9xN7rqEbdDvtJVgVqlCcpo,3VkHkmOtom3jM2wCu94xgzzu1d6Dn7or,1,0,0,0,0,0,1,0,1,0.14285714285714285,1,0.0,0,0,0,0,0,0,0,1,0,0,1,1
5240,140386,QBY91TeHUAzVGyJB2ZPPWccvYj8dHE9S,3VkHkmOtom3jM2wCu94xgzzu1d6Dn7or,1,0,0,0,0,0,1,0,1,0.14285714285714285,1,0.0,0,0,0,0,0,0,0,1,0,0,1,1
5241,140394,AWBtHXao8tWJheBWLlX6I03BGwcgqhr7,3VkHkmOtom3jM2wCu94xgzzu1d6Dn7or,15,15,7,0,4,2,19,0,47,6.714285714285714,2,0.0,3,7,0,4,12,2,0,19,0,14,33,1
5242,140412,W2usuZhdd6NOhI9FEyVJGuapulLbt0Ni,3VkHkmOtom3jM2wCu94xgzzu1d6Dn7or,1,0,0,0,0,0,2,0,2,0.2857142857142857,1,0.0,0,0,0,0,0,0,0,2,0,0,2,1
5243,140426,k0OsMx8Z5O4spyalEaxTLlgaPlQcGseN,3VkHkmOtom3jM2wCu94xgzzu1d6Dn7or,1,0,0,0,0,0,1,0,1,0.14285714285714285,1,0.0,0,0,0,0,0,0,0,1,0,0,1,1
5244,140434,6UoSDV0X1L9MlGVMan41YIDbZTXbLKRe,3VkHkmOtom3jM2wCu94xgzzu1d6Dn7or,8,14,0,0,1,5,9,1,30,4.285714285714286,2,0.0,3,0,0,1,11,5,0,9,1,4,26,1
5245,140440,QfR0jIBNgwDWAlolWFsw2k28xvZm81Li,3VkHkmOtom3jM2wCu94xgzzu1d6Dn7or,6,4,2,0,1,0,4,0,11,1.5714285714285714,2,0.0,0,2,0,1,4,0,0,4,0,3,8,1
5246,140442,M4ZErUfwHYj5OXVgTBrfDNh3oNvQb92M,3VkHkmOtom3jM2wCu94xgzzu1d6Dn7or,18,36,14,29,9,16,23,1,128,18.285714285714285,2,0.0,8,14,27,9,28,16,2,23,1,58,70,1
5247,140444,B7ak2ZV4xi81eSiTWPbE5WxB8UoL19b7,3VkHkmOtom3jM2wCu94xgzzu1d6Dn7or,1,0,0,0,0,0,1,0,1,0.14285714285714285,1,0.0,0,0,0,0,0,0,0,1,0,0,1,1
5248,140461,IOitTfHwo1kXI97YU6fliIcTu2VODhM7,3VkHkmOtom3jM2wCu94xgzzu1d6Dn7or,5,5,1,6,2,7,1,0,22,3.142857142857143,1,0.0,3,1,4,2,2,7,2,1,0,10,12,1
5249,140518,PMkZTQovf4dyR4mK2UbNwrhFIlkDMtO5,7GRhBDsirIGkRZBtSMEzNTyDr2JQm4xx,2,0,1,0,1,0,0,0,2,0.2857142857142857,1,0.0,0,1,0,1,0,0,0,0,0,2,0,1
5250,140526,hMlAqXOYa7gY3ygXTo1yQWN2YN8wqI1H,7GRhBDsirIGkRZBtSMEzNTyDr2JQm4xx,5,1,1,0,1,0,2,0,5,0.7142857142857143,1,0.0,0,1,0,1,1,0,0,2,0,2,3,1
5251,140538,ivQxpA3T4qXcNV0IuvLDkzJLb00vpKY1,7GRhBDsirIGkRZBtSMEzNTyDr2JQm4xx,6,6,5,0,5,0,1,0,17,2.4285714285714284,1,0.0,0,5,0,5,6,0,0,1,0,10,7,1
5252,140555,TfgVRC9skFsGu3qq14caEQmfjmrp7rot,7GRhBDsirIGkRZBtSMEzNTyDr2JQm4xx,4,2,0,0,0,0,2,0,4,0.5714285714285714,1,0.0,0,0,0,0,2,0,0,2,0,0,4,1
5253,140564,ZIMCP6WBWK3qXQfNStRYM5gxyC5A3FHs,7GRhBDsirIGkRZBtSMEzNTyDr2JQm4xx,6,6,2,0,2,0,1,0,11,1.5714285714285714,1,0.0,0,2,0,2,6,0,0,1,0,4,7,1
5254,140567,GcUfN5HIs7MIOMCOSkKXJjHKO0aQwdDB,7GRhBDsirIGkRZBtSMEzNTyDr2JQm4xx,1,0,0,0,0,0,1,0,1,0.14285714285714285,1,0.0,0,0,0,0,0,0,0,1,0,0,1,1
5255,140571,PQkWevD3d0oRYo5mywsIaSsfEsqdcqoj,7GRhBDsirIGkRZBtSMEzNTyDr2JQm4xx,1,0,0,0,0,0,1,0,1,0.14285714285714285,1,0.0,0,0,0,0,0,0,0,1,0,0,1,1
5256,140586,H7wQq68VgsnXYKOgXKXD2z0yXvbrWDzD,7GRhBDsirIGkRZBtSMEzNTyDr2JQm4xx,4,1,0,0,0,0,3,0,4,0.5714285714285714,1,0.0,0,0,0,0,1,0,0,3,0,0,4,1
5257,140606,RthO8kTkOrnZ3vUDn574hHyfG3vroBt1,7GRhBDsirIGkRZBtSMEzNTyDr2JQm4xx,3,2,1,0,0,0,2,0,5,0.7142857142857143,1,0.0,0,1,0,0,2,0,0,2,0,1,4,0
5258,140625,4f8jLRXqSCdB2uiZvxNaCELloSkIP9xi,7GRhBDsirIGkRZBtSMEzNTyDr2JQm4xx,26,24,12,10,11,2,6,0,65,9.285714285714286,1,0.0,11,12,5,11,13,2,5,6,0,39,26,1
5259,140631,ah26WailHR7EV3M12BWTgtjGcr75lRFT,7GRhBDsirIGkRZBtSMEzNTyDr2JQm4xx,41,84,19,121,10,4,3,0,241,34.42857142857143,3,0.0,41,19,105,10,43,4,16,3,0,175,66,1
5260,140632,ZgIRqTHKDbnMlUiyoVebquxs1Y8vzQoE,7GRhBDsirIGkRZBtSMEzNTyDr2JQm4xx,1,0,0,0,0,0,2,0,2,0.2857142857142857,1,0.0,0,0,0,0,0,0,0,2,0,0,2,1
5261,140640,WpH6LiZngGAOmL0pzdoYGfKbqcUQKXCx,7GRhBDsirIGkRZBtSMEzNTyDr2JQm4xx,1,0,0,0,0,0,1,0,1,0.14285714285714285,1,0.0,0,0,0,0,0,0,0,1,0,0,1,0
5262,140642,ykhGFpMDsllOl7GPw7P0ZWB0y2EKSHqD,7GRhBDsirIGkRZBtSMEzNTyDr2JQm4xx,2,0,0,0,0,0,6,0,6,0.8571428571428571,1,0.0,0,0,0,0,0,0,0,6,0,0,6,1
5263,140649,S8e3GdQkqIUsS8mmPO18XdoLgfzz9lmN,7GRhBDsirIGkRZBtSMEzNTyDr2JQm4xx,5,2,1,0,1,0,4,0,8,1.1428571428571428,1,0.0,0,1,0,1,2,0,0,4,0,2,6,1
5264,140666,DB1URyLII1znnmxnZlmmkOEalzIpmvtZ,7GRhBDsirIGkRZBtSMEzNTyDr2JQm4xx,2,0,0,0,0,0,2,0,2,0.2857142857142857,1,0.0,0,0,0,0,0,0,0,2,0,0,2,1
5265,140693,EurC1doc3uihnMqzQDbAhuG6797G4iw2,7GRhBDsirIGkRZBtSMEzNTyDr2JQm4xx,5,6,1,0,0,0,2,0,9,1.2857142857142858,1,0.0,0,1,0,0,6,0,0,2,0,1,8,1
5266,140704,th4zdTX2AjmI63dQaTjbmtQmRHWeQKT8,7GRhBDsirIGkRZBtSMEzNTyDr2JQm4xx,2,0,0,0,0,0,2,0,2,0.2857142857142857,1,0.0,0,0,0,0,0,0,0,2,0,0,2,1
5267,140708,loyRVr8UBWCy5Avm2TXeF6yiTZHXsnTV,7GRhBDsirIGkRZBtSMEzNTyDr2JQm4xx,1,0,0,0,0,0,1,0,1,0.14285714285714285,1,0.0,0,0,0,0,0,0,0,1,0,0,1,1
5268,140709,98UEGByxiN7tned6NDQeKfQDq4HCSGvQ,7GRhBDsirIGkRZBtSMEzNTyDr2JQm4xx,6,3,1,0,1,0,3,0,8,1.1428571428571428,1,0.0,0,1,0,1,3,0,0,3,0,2,6,1
5269,142587,DvIU0dGgUjhf9phNubhYOgC3dPrxcm0S,5Gyp41oLVo7Gg7vF4vpmggWP5MU70QO6,1,0,0,0,0,0,1,0,1,0.14285714285714285,1,0.0,0,0,0,0,0,0,0,1,0,0,1,1
5270,142589,l750mduiFiLPfRSsAl255O3mIZA6Ifby,5Gyp41oLVo7Gg7vF4vpmggWP5MU70QO6,7,3,2,0,2,0,2,0,9,1.2857142857142858,1,0.0,0,2,0,2,3,0,0,2,0,4,5,1
5271,142594,CYkbKNZ2lTPrZiFK1E4i1CflG2OM8gXX,5Gyp41oLVo7Gg7vF4vpmggWP5MU70QO6,7,3,2,0,2,0,3,0,10,1.4285714285714286,2,0.0,0,2,0,2,3,0,0,3,0,4,6,1
5272,142602,2Vqke266H027IIATfc2Fz8akv1wFvzRY,5Gyp41oLVo7Gg7vF4vpmggWP5MU70QO6,14,15,11,0,6,0,5,0,37,5.285714285714286,2,0.0,0,11,0,6,15,0,0,5,0,17,20,1
5273,142611,vrIS3rOFH8II8t7yTEWKp29B27kjVKhm,5Gyp41oLVo7Gg7vF4vpmggWP5MU70QO6,5,2,1,0,1,15,2,0,21,3.0,1,0.0,0,1,0,1,2,15,0,2,0,2,19,1
5274,142613,EC764qsGUcXuJJOqh2Cai0xBRNCMY6Db,5Gyp41oLVo7Gg7vF4vpmggWP5MU70QO6,10,10,6,3,3,0,4,0,26,3.7142857142857144,2,0.0,1,6,2,3,9,0,1,4,0,12,14,0
5275,142614,4G31JkuuWxQoMwYLKWmTZsOhrqR0raRg,5Gyp41oLVo7Gg7vF4vpmggWP5MU70QO6,10,8,6,0,4,0,8,0,26,3.7142857142857144,3,0.0,1,6,0,4,7,0,0,8,0,11,15,1
5276,142615,muFfPUIUTXBK2cEaqzvOvCev9GDghb1a,5Gyp41oLVo7Gg7vF4vpmggWP5MU70QO6,2,0,0,0,0,0,2,0,2,0.2857142857142857,1,0.0,0,0,0,0,0,0,0,2,0,0,2,1
5277,142622,hne1Z7uPNxHKtOSgT2rxpmt4dGtlsF3d,5Gyp41oLVo7Gg7vF4vpmggWP5MU70QO6,9,13,5,0,2,0,7,0,27,3.857142857142857,3,0.0,0,5,0,2,13,0,0,7,0,7,20,1
5278,142629,fNSiZi73xL4M2bPW8ibFW938cSZEdX30,5Gyp41oLVo7Gg7vF4vpmggWP5MU70QO6,21,33,11,18,10,9,13,1,95,13.571428571428571,2,0.0,20,11,14,10,13,9,4,13,1,55,40,1
5279,142630,tTC605LBGlqqGzWy1b2L3n60FKitrcCL,5Gyp41oLVo7Gg7vF4vpmggWP5MU70QO6,9,15,6,6,1,6,4,0,38,5.428571428571429,1,0.0,8,6,4,1,7,6,2,4,0,19,19,1
5280,142632,cX5D1rnP35ppe9dQPHhDf3VIzo5UxdFJ,5Gyp41oLVo7Gg7vF4vpmggWP5MU70QO6,9,3,1,0,2,8,5,1,20,2.857142857142857,1,0.0,0,1,0,2,3,8,0,5,1,3,17,0
5281,142637,CgsguvEs0KUN3Abw9Qjh5ZZT0chwXUSw,5Gyp41oLVo7Gg7vF4vpmggWP5MU70QO6,17,31,16,15,7,3,8,1,81,11.571428571428571,4,0.0,6,16,11,7,25,3,4,8,1,40,41,1
5282,142639,6uHUgcd0luimAyfwarvpGHSZOL8ry9Vt,5Gyp41oLVo7Gg7vF4vpmggWP5MU70QO6,6,2,1,0,1,4,3,0,11,1.5714285714285714,1,0.0,0,1,0,1,2,4,0,3,0,2,9,1
5283,142642,ycYxVdTkB3SPaEMcSsJvYXF9LydWvOSZ,5Gyp41oLVo7Gg7vF4vpmggWP5MU70QO6,7,3,2,0,2,0,2,0,9,1.2857142857142858,1,0.0,0,2,0,2,3,0,0,2,0,4,5,1
5284,142643,jE5pZWKJJZZlEfXyHAiktBUQo0d4xaxK,5Gyp41oLVo7Gg7vF4vpmggWP5MU70QO6,6,3,2,0,2,0,1,0,8,1.1428571428571428,1,0.0,0,2,0,2,3,0,0,1,0,4,4,1
5285,142645,G7XmOVqtfJTMn7q51nsv0n7UbKc4e4CM,5Gyp41oLVo7Gg7vF4vpmggWP5MU70QO6,6,3,1,0,1,0,2,0,7,1.0,1,0.0,0,1,0,1,3,0,0,2,0,2,5,1
5286,142648,2we3WxltFBT1dd0FjP3YZ8iHf2xpHEei,5Gyp41oLVo7Gg7vF4vpmggWP5MU70QO6,9,7,3,2,3,5,1,0,21,3.0,1,0.0,2,3,1,3,5,5,1,1,0,9,12,1
5287,142650,AbUJGk67ueUV6YWXpG4Dr2koeNrU2Sk8,5Gyp41oLVo7Gg7vF4vpmggWP5MU70QO6,9,5,3,0,3,0,6,0,17,2.4285714285714284,1,0.0,0,3,0,3,5,0,0,6,0,6,11,0
5288,142654,mFyBIO6GmLHqTEssxzuSwYKXW2BbEyYv,5Gyp41oLVo7Gg7vF4vpmggWP5MU70QO6,24,58,31,11,14,11,17,2,144,20.571428571428573,3,0.0,14,31,8,14,44,11,3,17,2,67,77,1
5289,142661,hiOP3eN8v82uBo9ostiizEL8wqrrZAlw,5Gyp41oLVo7Gg7vF4vpmggWP5MU70QO6,10,12,6,4,2,0,9,0,33,4.714285714285714,4,0.0,1,6,3,2,11,0,1,9,0,12,21,0
5290,142665,aFLYSsMOJD7vuJCmYWrO6tPDVX9VcXzM,5Gyp41oLVo7Gg7vF4vpmggWP5MU70QO6,10,4,4,0,4,0,4,0,16,2.2857142857142856,1,0.0,0,4,0,4,4,0,0,4,0,8,8,1
5291,142671,WkP0QgVAglpv2YQKKTMZ7oETLJdQSz9a,5Gyp41oLVo7Gg7vF4vpmggWP5MU70QO6,11,10,6,0,3,4,6,1,30,4.285714285714286,1,0.0,1,6,0,3,9,4,0,6,1,10,20,1
5292,142675,JjRfXgajKvMZPr7I7oY0ZFbLcw7QrsDQ,5Gyp41oLVo7Gg7vF4vpmggWP5MU70QO6,10,9,2,0,4,0,6,0,21,3.0,3,0.0,0,2,0,4,9,0,0,6,0,6,15,1
5293,142678,B9w98beRRwEepVMm1hNpO2ICgom7vEqz,5Gyp41oLVo7Gg7vF4vpmggWP5MU70QO6,9,4,3,0,3,1,2,0,13,1.8571428571428572,1,0.0,0,3,0,3,4,1,0,2,0,6,7,1
5294,142680,6HbKV4M7xaeeDEow2yyukNC03fVTirBq,5Gyp41oLVo7Gg7vF4vpmggWP5MU70QO6,11,9,5,4,2,0,4,0,24,3.4285714285714284,3,0.0,1,5,2,2,8,0,2,4,0,10,14,0
5295,142683,zbYgISHkDeuR3m4mVajxkvqM3fJPLNns,5Gyp41oLVo7Gg7vF4vpmggWP5MU70QO6,5,1,1,0,1,0,2,0,5,0.7142857142857143,1,0.0,0,1,0,1,1,0,0,2,0,2,3,1
5296,142687,Y5EybULOrY5dAmMMQWE7bK5wg4bsR2Lr,5Gyp41oLVo7Gg7vF4vpmggWP5MU70QO6,5,9,2,0,1,0,1,0,13,1.8571428571428572,1,0.0,1,2,0,1,8,0,0,1,0,4,9,0
5297,142688,1YsWewIFm5PEDWv9Iorbz6WsCa2ShDei,5Gyp41oLVo7Gg7vF4vpmggWP5MU70QO6,8,11,2,1,5,0,1,0,20,2.857142857142857,1,0.0,4,2,1,5,7,0,0,1,0,12,8,1
5298,142690,4Tr4zS1WTYozCucBhtide31lwvTCWT44,5Gyp41oLVo7Gg7vF4vpmggWP5MU70QO6,10,5,4,0,4,0,1,0,14,2.0,1,0.0,0,4,0,4,5,0,0,1,0,8,6,1
5299,142696,pl0spcF4S6FVauXWiyBjvc2XHDeBRL8g,5Gyp41oLVo7Gg7vF4vpmggWP5MU70QO6,2,0,0,0,0,0,2,0,2,0.2857142857142857,1,0.0,0,0,0,0,0,0,0,2,0,0,2,1
5300,142698,CjuSkkkDMjiox2iJcbNK1MsuuNgkIqjP,5Gyp41oLVo7Gg7vF4vpmggWP5MU70QO6,9,4,2,0,3,1,4,0,14,2.0,1,0.0,1,2,0,3,3,1,0,4,0,6,8,1
5301,142708,FYdTGqTHtRATfo802agJiucYRW9Mfn1L,5Gyp41oLVo7Gg7vF4vpmggWP5MU70QO6,5,1,0,0,0,1,4,1,7,1.0,1,0.0,0,0,0,0,1,1,0,4,1,0,7,1
5302,142711,TA5wGtPfX5pEtgy8pd6XjVDtVvbBFXJS,5Gyp41oLVo7Gg7vF4vpmggWP5MU70QO6,3,1,0,0,0,0,2,0,3,0.42857142857142855,1,0.0,0,0,0,0,1,0,0,2,0,0,3,1
5303,142714,4X3QJBWqjjzt1tnJuinj3TQdGHwFyiAK,5Gyp41oLVo7Gg7vF4vpmggWP5MU70QO6,8,10,5,0,1,9,14,0,39,5.571428571428571,2,0.0,0,5,0,1,10,9,0,14,0,6,33,1
5304,142716,uXRfDeihF0hkAkJm7sgGsGBDRqSDq177,5Gyp41oLVo7Gg7vF4vpmggWP5MU70QO6,17,22,12,9,3,4,8,1,59,8.428571428571429,2,0.0,3,12,6,3,19,4,3,8,1,24,35,1
5305,142720,H5g9tdQ8zdQuC8mE8S1kStQ5QeJRaiem,5Gyp41oLVo7Gg7vF4vpmggWP5MU70QO6,6,3,2,0,2,0,1,0,8,1.1428571428571428,1,0.0,0,2,0,2,3,0,0,1,0,4,4,1
5306,142725,VxTZo8wWibkIng7J8YPkqWh1rsEKvqTC,5Gyp41oLVo7Gg7vF4vpmggWP5MU70QO6,5,0,0,0,0,1,4,0,5,0.7142857142857143,1,0.0,0,0,0,0,0,1,0,4,0,0,5,1
5307,142726,NMrufuUkT7urywi2vIs65HiLUq0GodvJ,5Gyp41oLVo7Gg7vF4vpmggWP5MU70QO6,4,2,1,0,1,0,1,0,5,0.7142857142857143,1,0.0,0,1,0,1,2,0,0,1,0,2,3,1
5308,142743,oy7vCCTKK5fna0ybbPQX7ynHsvxgRuDK,5Gyp41oLVo7Gg7vF4vpmggWP5MU70QO6,6,3,1,0,0,1,6,1,12,1.7142857142857142,1,0.0,0,1,0,0,3,1,0,6,1,1,11,1
5309,142756,Pai5xZZogwpbc7doQ2htBCn8nqi1CTjY,5Gyp41oLVo7Gg7vF4vpmggWP5MU70QO6,7,5,0,0,2,0,3,0,10,1.4285714285714286,2,0.0,0,0,0,2,5,0,0,3,0,2,8,1
5310,142761,R4qKMABYuzGzDkYeHszjB6pRZL9tl5ny,5Gyp41oLVo7Gg7vF4vpmggWP5MU70QO6,7,3,2,0,2,0,2,0,9,1.2857142857142858,1,0.0,0,2,0,2,3,0,0,2,0,4,5,1
5311,142775,rgfuJRvILCyoZ3ACpGqTeELGaXbZOX9A,5Gyp41oLVo7Gg7vF4vpmggWP5MU70QO6,8,6,2,0,1,1,5,1,16,2.2857142857142856,2,0.0,1,2,0,1,5,1,0,5,1,4,12,1
5312,142776,reBeUISe7rc1WY8sQ6udqDmHIOz0Z3w1,5Gyp41oLVo7Gg7vF4vpmggWP5MU70QO6,7,7,4,0,0,0,5,0,16,2.2857142857142856,2,0.0,0,4,0,0,7,0,0,5,0,4,12,1
5313,142777,jaeRBfNSkyTpFxAZieHe5vTAkzlHFDmm,5Gyp41oLVo7Gg7vF4vpmggWP5MU70QO6,8,13,1,3,1,0,1,0,19,2.7142857142857144,1,0.0,5,1,2,1,8,0,1,1,0,9,10,1
5314,142781,7rMi9CYErKLdcmN52YXqLfN4IUEFfzqp,5Gyp41oLVo7Gg7vF4vpmggWP5MU70QO6,31,87,52,18,17,4,19,0,197,28.142857142857142,6,0.0,11,52,13,17,76,4,5,19,0,93,104,1
5315,142789,YvOc6FqXZMoL0NWYKBDQjwnxonb9FCcf,5Gyp41oLVo7Gg7vF4vpmggWP5MU70QO6,13,9,4,7,3,0,10,0,33,4.714285714285714,1,0.0,4,4,6,3,5,0,1,10,0,17,16,1
5316,142796,UGYGSfRkJhOkgkdlCI6YSCshpNvwBF31,5Gyp41oLVo7Gg7vF4vpmggWP5MU70QO6,6,4,3,0,1,0,4,0,12,1.7142857142857142,2,0.0,0,3,0,1,4,0,0,4,0,4,8,1
5317,142797,rxcoIfkD9VVmXpA0UtXShDFNu2PSOtTk,5Gyp41oLVo7Gg7vF4vpmggWP5MU70QO6,8,13,8,0,0,0,2,0,23,3.2857142857142856,2,0.0,3,8,0,0,10,0,0,2,0,11,12,1
5318,142799,HhtKltqRVKGPT0pzckxFN7OMUH29mJzZ,5Gyp41oLVo7Gg7vF4vpmggWP5MU70QO6,30,50,30,7,11,30,22,2,152,21.714285714285715,7,0.0,8,30,6,11,42,30,1,22,2,55,97,1
5319,142810,3iJrlZJEv2h7DgWBpz6wZtSXPXEy6IAY,5Gyp41oLVo7Gg7vF4vpmggWP5MU70QO6,18,20,9,10,6,0,3,0,48,6.857142857142857,3,0.0,4,9,8,6,16,0,2,3,0,27,21,1
5320,142823,dfEblZOFiIiaFeZyXpOIUKoMmCK8J7HL,5Gyp41oLVo7Gg7vF4vpmggWP5MU70QO6,8,8,6,0,5,0,4,0,23,3.2857142857142856,2,0.0,0,6,0,5,8,0,0,4,0,11,12,1
5321,142825,bgNkqNGrx7FitOdXoRt9UTv855kAW6gY,5Gyp41oLVo7Gg7vF4vpmggWP5MU70QO6,6,16,8,0,1,0,3,0,28,4.0,2,0.0,5,8,0,1,11,0,0,3,0,14,14,1
5322,142843,EGp6xRzNCnsCPDRg0mfvtfy8t2jZt4I9,5Gyp41oLVo7Gg7vF4vpmggWP5MU70QO6,7,2,2,0,2,0,2,0,8,1.1428571428571428,1,0.0,0,2,0,2,2,0,0,2,0,4,4,1
5323,142846,IdijTNmoKxS8ApF0ePQZeGoS4kBBjX5q,5Gyp41oLVo7Gg7vF4vpmggWP5MU70QO6,5,2,0,0,1,0,4,0,7,1.0,2,0.0,0,0,0,1,2,0,0,4,0,1,6,1
5324,142852,yf1aB46OA5i79BZV0LoP2pzfryVAMP40,5Gyp41oLVo7Gg7vF4vpmggWP5MU70QO6,15,24,9,12,5,12,8,1,71,10.142857142857142,1,0.0,7,9,9,5,17,12,3,8,1,30,41,1
5325,142857,JZBebi62a9RwiiOIt21SU1RBcvnza8RC,5Gyp41oLVo7Gg7vF4vpmggWP5MU70QO6,10,8,2,0,6,10,6,1,33,4.714285714285714,1,0.0,5,2,0,6,3,10,0,6,1,13,20,1
5326,142862,qEcUTYcalHCp49zQzZTHlJUj8t0KbQ92,5Gyp41oLVo7Gg7vF4vpmggWP5MU70QO6,8,11,3,12,1,0,6,0,33,4.714285714285714,1,0.0,8,3,7,1,3,0,5,6,0,19,14,1
5327,142863,17x2siC1tkQccDH5KO5mYK5I39ctZkuT,5Gyp41oLVo7Gg7vF4vpmggWP5MU70QO6,21,37,19,25,6,24,16,5,132,18.857142857142858,3,0.0,9,19,22,6,28,24,3,16,5,56,76,1
5328,142869,2IPy33epg4zq9YB4p13d1uH5WhrVK1hq,5Gyp41oLVo7Gg7vF4vpmggWP5MU70QO6,7,3,1,0,1,0,10,0,15,2.142857142857143,1,0.0,0,1,0,1,3,0,0,10,0,2,13,1
5329,142877,ejkcEmPsQaezsRVIpePgfD352Pc6uBAG,5Gyp41oLVo7Gg7vF4vpmggWP5MU70QO6,5,6,4,0,3,0,1,0,14,2.0,1,0.0,0,4,0,3,6,0,0,1,0,7,7,1
5330,142889,Z35TrSi7rwWFfkDazbEG4KvEH4YsLfS1,5Gyp41oLVo7Gg7vF4vpmggWP5MU70QO6,8,5,0,0,0,1,8,1,15,2.142857142857143,2,0.0,0,0,0,0,5,1,0,8,1,0,15,1
5331,142891,QiYTai3Y8W2gCapn7xLJdAzRDbxFfQca,5Gyp41oLVo7Gg7vF4vpmggWP5MU70QO6,9,5,3,2,1,0,4,0,15,2.142857142857143,1,0.0,1,3,1,1,4,0,1,4,0,6,9,1
5332,142898,RvcFqQHE1iJoF2RYg2gswnnM7mWagdpD,5Gyp41oLVo7Gg7vF4vpmggWP5MU70QO6,6,2,1,0,0,0,5,1,9,1.2857142857142858,1,0.0,1,1,0,0,1,0,0,5,1,2,7,1
5333,142901,OCvsImL93NRBONEN4tEiveIXUcVgu9yf,5Gyp41oLVo7Gg7vF4vpmggWP5MU70QO6,10,13,7,0,3,1,3,0,27,3.857142857142857,1,0.0,3,7,0,3,10,1,0,3,0,13,14,1
5334,142907,C16JYq0aDivmltqQa9Vqq9AdrdmyaECj,5Gyp41oLVo7Gg7vF4vpmggWP5MU70QO6,17,25,19,0,6,0,6,0,56,8.0,4,0.0,1,19,0,6,24,0,0,6,0,26,30,1
5335,142910,qfT7qYjjtHpH8xzKPZCww7GR87XA6mUH,5Gyp41oLVo7Gg7vF4vpmggWP5MU70QO6,5,2,1,0,1,0,2,0,6,0.8571428571428571,1,0.0,0,1,0,1,2,0,0,2,0,2,4,1
5336,142911,o9LhepAr6TkNIwClYXTvyGmD8wbvv9UD,5Gyp41oLVo7Gg7vF4vpmggWP5MU70QO6,12,14,7,0,3,4,8,2,38,5.428571428571429,1,0.0,3,7,0,3,11,4,0,8,2,13,25,1
5337,142922,JBXB6u6rdJ6u5Tg7LFBEhBjKSXKrDwPA,5Gyp41oLVo7Gg7vF4vpmggWP5MU70QO6,16,19,8,0,5,0,9,0,41,5.857142857142857,1,0.0,3,8,0,5,16,0,0,9,0,16,25,1
5338,142925,1DRhd5bBJuCd8ewdbmKKPmk22SDsnmZW,5Gyp41oLVo7Gg7vF4vpmggWP5MU70QO6,7,4,1,0,2,0,1,0,8,1.1428571428571428,1,0.0,0,1,0,2,4,0,0,1,0,3,5,1
5339,142937,gDo9M8HDbXmLQPxqqLTsn9N4ZUEPKvcn,5Gyp41oLVo7Gg7vF4vpmggWP5MU70QO6,8,6,4,0,1,0,2,0,13,1.8571428571428572,1,0.0,0,4,0,1,6,0,0,2,0,5,8,1
5340,142939,dmhkL35doRyRiXlb3XuDnJlpO05GLvg1,5Gyp41oLVo7Gg7vF4vpmggWP5MU70QO6,10,11,5,0,2,16,5,1,40,5.714285714285714,2,0.0,0,5,0,2,11,16,0,5,1,7,33,1
5341,142946,LSVa2jpU1dF8RnC5rzovm0tv2cSNIe8I,5Gyp41oLVo7Gg7vF4vpmggWP5MU70QO6,19,37,16,12,13,6,8,0,92,13.142857142857142,6,0.0,12,16,8,13,25,6,4,8,0,49,43,1
5342,142947,fle9OCfJL8TB5Ku46DhwngiGCvONNuEB,5Gyp41oLVo7Gg7vF4vpmggWP5MU70QO6,9,4,3,0,2,3,8,1,21,3.0,1,0.0,0,3,0,2,4,3,0,8,1,5,16,0
5343,142953,zuXPyOSeqv1Z9F86jQYRYxtPwfD1AoB3,5Gyp41oLVo7Gg7vF4vpmggWP5MU70QO6,5,4,3,0,2,0,1,0,10,1.4285714285714286,1,0.0,0,3,0,2,4,0,0,1,0,5,5,1
5344,142954,wqZdpQJ56pEKlaEZk0l8Q59mHuC7Ccfq,5Gyp41oLVo7Gg7vF4vpmggWP5MU70QO6,5,2,1,0,1,0,2,0,6,0.8571428571428571,1,0.0,0,1,0,1,2,0,0,2,0,2,4,1
5345,142955,LDoffeIzXBaEA3EoYd9Gp4Kl36LUuUJD,5Gyp41oLVo7Gg7vF4vpmggWP5MU70QO6,10,10,4,0,5,34,4,0,57,8.142857142857142,2,0.0,4,4,0,5,6,34,0,4,0,13,44,1
5346,142957,jT3pQSQPEBO5JBmeZgy8wpm0tZwiqHoI,5Gyp41oLVo7Gg7vF4vpmggWP5MU70QO6,6,2,1,0,1,0,5,0,9,1.2857142857142858,1,0.0,0,1,0,1,2,0,0,5,0,2,7,1
5347,142958,nWULEtY8mVT47elDfeZ33BhWjPFG2zXc,5Gyp41oLVo7Gg7vF4vpmggWP5MU70QO6,3,2,1,0,1,0,1,0,5,0.7142857142857143,1,0.0,0,1,0,1,2,0,0,1,0,2,3,1
5348,142962,fqjLnH3OTCihOU2gsb0OSNI1dFNVFkLM,5Gyp41oLVo7Gg7vF4vpmggWP5MU70QO6,9,13,1,0,1,9,3,0,27,3.857142857142857,2,0.0,0,1,0,1,13,9,0,3,0,2,25,1
5349,142965,wT2PCRFj23I7HDSSujNYjrYVx91GnsP3,5Gyp41oLVo7Gg7vF4vpmggWP5MU70QO6,1,0,0,0,0,0,1,0,1,0.14285714285714285,1,0.0,0,0,0,0,0,0,0,1,0,0,1,1
5350,142980,RbZEMS9VWFPa6Bw1eRa7DiuQ7kaKXjbF,5Gyp41oLVo7Gg7vF4vpmggWP5MU70QO6,5,4,2,5,0,0,1,0,12,1.7142857142857142,1,0.0,1,2,3,0,3,0,2,1,0,6,6,1
5351,142982,6WpUAvOn0104PVGU1qRupfdkikcVBl8O,5Gyp41oLVo7Gg7vF4vpmggWP5MU70QO6,6,6,2,0,1,0,2,0,11,1.5714285714285714,2,0.0,0,2,0,1,6,0,0,2,0,3,8,1
5352,142990,qvudCQW0qHQG0Qx7qWFtGoa7VWdIdmMz,5Gyp41oLVo7Gg7vF4vpmggWP5MU70QO6,12,16,6,4,3,0,4,0,33,4.714285714285714,2,0.0,2,6,3,3,14,0,1,4,0,14,19,1
5353,142995,4iCRMipwhTH06x1GiLZhC3aMUrEBiM5f,5Gyp41oLVo7Gg7vF4vpmggWP5MU70QO6,37,83,43,17,22,16,8,4,193,27.571428571428573,4,0.0,22,43,10,22,61,16,7,8,4,97,96,1
5354,142996,UMhqMBvNkRDXsJUWPwy4GcSQoSlGBO8t,5Gyp41oLVo7Gg7vF4vpmggWP5MU70QO6,19,37,17,14,6,0,9,0,83,11.857142857142858,3,0.0,10,17,10,6,27,0,4,9,0,43,40,1
5355,143000,UdESPSKgOrFyrYiZnI6WrGuVOhvRCwfS,5Gyp41oLVo7Gg7vF4vpmggWP5MU70QO6,15,12,7,2,6,1,4,0,32,4.571428571428571,1,0.0,2,7,1,6,10,1,1,4,0,16,16,1
5356,143013,jNFKLQDyusbF96R2XSxlZgGNyApuMVRT,5Gyp41oLVo7Gg7vF4vpmggWP5MU70QO6,9,4,2,0,2,0,4,0,12,1.7142857142857142,1,0.0,0,2,0,2,4,0,0,4,0,4,8,1
5357,143021,RMXdjy8Gra28DdVIoJYm0uLHHHz1ev3p,5Gyp41oLVo7Gg7vF4vpmggWP5MU70QO6,14,22,16,0,11,2,7,1,59,8.428571428571429,3,0.0,2,16,0,11,20,2,0,7,1,29,30,1
5358,143022,cCyIUKuvSVcuaNngx6IBU0qC1J3zOYfy,5Gyp41oLVo7Gg7vF4vpmggWP5MU70QO6,8,12,7,0,4,0,4,0,27,3.857142857142857,2,0.0,1,7,0,4,11,0,0,4,0,12,15,1
5359,143034,K2b5w6dQdpSuPpCln533WlJldy6cgW3p,5Gyp41oLVo7Gg7vF4vpmggWP5MU70QO6,18,9,7,2,4,0,6,1,29,4.142857142857143,2,0.0,0,7,1,4,9,0,1,6,1,12,17,1
5360,143043,xNbGpoUN6nuEw7SD5AAvKgLFHj0EfbXf,5Gyp41oLVo7Gg7vF4vpmggWP5MU70QO6,14,21,12,0,8,0,4,0,45,6.428571428571429,2,0.0,1,12,0,8,20,0,0,4,0,21,24,1
5361,143045,RpCB5287BqgdwCZkJwlXMkvyUhQODW89,5Gyp41oLVo7Gg7vF4vpmggWP5MU70QO6,1,0,0,0,0,0,1,0,1,0.14285714285714285,1,0.0,0,0,0,0,0,0,0,1,0,0,1,1
5362,143049,Pvv8yLPqgWNPXuVDQBtF0VAALIaMvqpu,5Gyp41oLVo7Gg7vF4vpmggWP5MU70QO6,1,0,0,0,0,0,1,0,1,0.14285714285714285,1,0.0,0,0,0,0,0,0,0,1,0,0,1,1
5363,143065,ldSLMGcwpXJME4390nV36CrMtKAbV74z,5Gyp41oLVo7Gg7vF4vpmggWP5MU70QO6,1,0,0,0,0,0,1,0,1,0.14285714285714285,1,0.0,0,0,0,0,0,0,0,1,0,0,1,1
5364,143068,fvEk8isN63xa8Boq4eAejcJ4CNYAHM9j,5Gyp41oLVo7Gg7vF4vpmggWP5MU70QO6,5,2,1,0,1,0,4,0,8,1.1428571428571428,1,0.0,0,1,0,1,2,0,0,4,0,2,6,1
5365,143076,LFoNU4BRd2Hz4cBJcaK2whvFNx8dsRxE,5Gyp41oLVo7Gg7vF4vpmggWP5MU70QO6,1,0,0,0,0,0,1,0,1,0.14285714285714285,1,0.0,0,0,0,0,0,0,0,1,0,0,1,1
5366,143077,c9KANAprbDpnTKiTdlu4hCvhWcBhVmkA,5Gyp41oLVo7Gg7vF4vpmggWP5MU70QO6,11,26,15,0,4,4,9,0,58,8.285714285714286,3,0.0,3,15,0,4,23,4,0,9,0,22,36,0
5367,143084,VhtnI0jXlmYjp8tocIt6NwYAhqIJcpfm,5Gyp41oLVo7Gg7vF4vpmggWP5MU70QO6,15,23,8,3,5,0,7,0,46,6.571428571428571,3,0.0,4,8,2,5,19,0,1,7,0,19,27,1
5368,143085,VkJtOMLeRLckBlBrcmBivRVG5Gn9VcP1,5Gyp41oLVo7Gg7vF4vpmggWP5MU70QO6,1,0,0,0,0,0,1,0,1,0.14285714285714285,1,0.0,0,0,0,0,0,0,0,1,0,0,1,1
5369,143089,o9EVHnUUU8I3f9dlC8NAcnHlKvZOnRmy,5Gyp41oLVo7Gg7vF4vpmggWP5MU70QO6,14,20,12,10,7,0,3,0,52,7.428571428571429,2,0.0,5,12,7,7,15,0,3,3,0,31,21,1
5370,143092,E6eRsum7azY2VkSoeGLIacPWSM4TI95Q,5Gyp41oLVo7Gg7vF4vpmggWP5MU70QO6,19,26,13,14,5,0,10,0,68,9.714285714285714,3,0.0,6,13,9,5,20,0,5,10,0,33,35,1
5371,143093,sXoPoJ8exd0R4iNQITJ21nyLilxwh5tY,5Gyp41oLVo7Gg7vF4vpmggWP5MU70QO6,13,12,5,15,3,0,7,0,42,6.0,3,0.0,4,5,11,3,8,0,4,7,0,23,19,1
5372,143095,igJ0f51d8a6Y1pQ5uln2duT0dGwsH0ZQ,5Gyp41oLVo7Gg7vF4vpmggWP5MU70QO6,11,13,6,0,5,0,3,0,27,3.857142857142857,2,0.0,5,6,0,5,8,0,0,3,0,16,11,1
5373,143104,6ApSpkhY40OyK6YY681fVCFC3lRd37r1,5Gyp41oLVo7Gg7vF4vpmggWP5MU70QO6,8,9,6,0,3,0,3,0,21,3.0,1,0.0,0,6,0,3,9,0,0,3,0,9,12,1
5374,143108,oNuwXj50Ar10v48RRIHz7AkiO77jEx2Q,5Gyp41oLVo7Gg7vF4vpmggWP5MU70QO6,8,6,3,0,2,0,5,0,16,2.2857142857142856,2,0.0,0,3,0,2,6,0,0,5,0,5,11,1
5375,143112,QKh6yCjm7KCBJwTgcTdbJMWujg3bWjbd,5Gyp41oLVo7Gg7vF4vpmggWP5MU70QO6,9,6,3,0,3,0,2,0,14,2.0,1,0.0,2,3,0,3,4,0,0,2,0,8,6,1
5376,143113,8JzafbS8byU6S2UgAbCtwWuNx4gr3Uhl,5Gyp41oLVo7Gg7vF4vpmggWP5MU70QO6,1,0,0,0,0,0,1,0,1,0.14285714285714285,1,0.0,0,0,0,0,0,0,0,1,0,0,1,1
5377,143115,4XBp4M0LgK0cKGGg2pjRyl6rZazBJm6K,5Gyp41oLVo7Gg7vF4vpmggWP5MU70QO6,3,2,0,0,0,0,1,0,3,0.42857142857142855,1,0.0,0,0,0,0,2,0,0,1,0,0,3,1
5378,143144,LOcIjzEQxkpusXXGGonKeazzQqmnIwRx,5Gyp41oLVo7Gg7vF4vpmggWP5MU70QO6,10,5,3,2,2,0,3,0,15,2.142857142857143,1,0.0,1,3,1,2,4,0,1,3,0,7,8,1
5379,143146,myIIBocNFelldmuN47bMrRiORGKDSj7S,5Gyp41oLVo7Gg7vF4vpmggWP5MU70QO6,21,33,18,24,7,1,11,1,95,13.571428571428571,5,0.0,9,18,22,7,24,1,2,11,1,56,39,0
5380,143147,pWu9eZBUQIsnvUmhD5XkUj4DL7Bo8m7Z,5Gyp41oLVo7Gg7vF4vpmggWP5MU70QO6,4,3,1,0,0,0,2,0,6,0.8571428571428571,2,0.0,0,1,0,0,3,0,0,2,0,1,5,1
5381,143148,Bt0YrpvyveynQfxqkzppqbivsu9tYRaK,5Gyp41oLVo7Gg7vF4vpmggWP5MU70QO6,1,0,0,0,0,0,1,0,1,0.14285714285714285,1,0.0,0,0,0,0,0,0,0,1,0,0,1,1
5382,143151,1tWXAXvyz9HkJmV83xaQq3fwkt1CNz8N,5Gyp41oLVo7Gg7vF4vpmggWP5MU70QO6,10,22,6,0,4,4,1,0,37,5.285714285714286,1,0.0,1,6,0,4,21,4,0,1,0,11,26,1
5383,143153,Go5c9muEuGHgZsLwObwsEKIQQ7mUzKJN,5Gyp41oLVo7Gg7vF4vpmggWP5MU70QO6,6,1,1,0,1,0,6,0,9,1.2857142857142858,1,0.0,0,1,0,1,1,0,0,6,0,2,7,1
5384,143155,AOy0e5xukkmuYjWQEwT6UCwFma8jpz06,5Gyp41oLVo7Gg7vF4vpmggWP5MU70QO6,4,4,1,0,1,0,1,0,7,1.0,1,0.0,0,1,0,1,4,0,0,1,0,2,5,1
5385,143160,OquQs3UlUuQySKKaB7T4hGbXWUMNQkYa,5Gyp41oLVo7Gg7vF4vpmggWP5MU70QO6,8,10,5,0,2,0,3,0,20,2.857142857142857,2,0.0,3,5,0,2,7,0,0,3,0,10,10,0
5386,143161,d1arTSE7SxbfzMjhdxvulgWFF4lWB4zh,5Gyp41oLVo7Gg7vF4vpmggWP5MU70QO6,5,2,1,0,1,0,2,0,6,0.8571428571428571,1,0.0,0,1,0,1,2,0,0,2,0,2,4,1
5387,143175,a0MTJMuyUHaGfgkAuJzZhYf5qRqDKT0G,5Gyp41oLVo7Gg7vF4vpmggWP5MU70QO6,10,5,3,0,1,2,6,1,18,2.5714285714285716,1,0.0,0,3,0,1,5,2,0,6,1,4,14,1
5388,143178,1qt3gH5lpss0VnR5LgXp1AGPTrEn5n0R,5Gyp41oLVo7Gg7vF4vpmggWP5MU70QO6,9,13,5,0,3,0,2,0,23,3.2857142857142856,1,0.0,0,5,0,3,13,0,0,2,0,8,15,1
5389,143185,OJF5d8tnOHv6TW0MMB3m0hQhsywDQQAw,5Gyp41oLVo7Gg7vF4vpmggWP5MU70QO6,3,2,1,0,0,0,1,0,4,0.5714285714285714,1,0.0,0,1,0,0,2,0,0,1,0,1,3,1
5390,143187,n1lmRh67H7bFW6LHVqBupk2D8FZ8NDby,5Gyp41oLVo7Gg7vF4vpmggWP5MU70QO6,13,17,10,9,5,8,3,0,52,7.428571428571429,1,0.0,4,10,6,5,13,8,3,3,0,25,27,1
5391,143196,j5XgrOAxRxENrCOne236prVqUgGjIY7N,5Gyp41oLVo7Gg7vF4vpmggWP5MU70QO6,10,23,13,0,5,0,6,0,47,6.714285714285714,3,0.0,5,13,0,5,18,0,0,6,0,23,24,1
5392,143198,SZ5q3TqDiWq8s23sHXWpsG5po2IH5JPk,5Gyp41oLVo7Gg7vF4vpmggWP5MU70QO6,9,12,1,6,1,0,1,0,21,3.0,2,0.0,2,1,4,1,10,0,2,1,0,8,13,1
5393,143200,xlb5sskrBWH1A6GjruCDDrxPv98p7c4g,5Gyp41oLVo7Gg7vF4vpmggWP5MU70QO6,9,4,3,0,2,0,3,0,12,1.7142857142857142,1,0.0,0,3,0,2,4,0,0,3,0,5,7,0
5394,143205,OMd5hO2BS5MFrbmAdRsf68WrTB16V1vi,5Gyp41oLVo7Gg7vF4vpmggWP5MU70QO6,11,28,7,8,11,25,6,0,85,12.142857142857142,3,0.0,6,7,6,11,22,25,2,6,0,30,55,1
5395,143208,UJPnRke0V5GQ6ioxh0USuF2sqgnLIYfk,5Gyp41oLVo7Gg7vF4vpmggWP5MU70QO6,7,3,2,0,1,12,4,3,25,3.5714285714285716,1,0.0,0,2,0,1,3,12,0,4,3,3,22,0
5396,143212,ZOXeaAo1YvHw7QB0bAA6QJadRJvaQbNE,5Gyp41oLVo7Gg7vF4vpmggWP5MU70QO6,22,40,20,5,14,36,10,1,126,18.0,2,0.0,14,20,3,14,26,36,2,10,1,51,75,1
5397,143219,dmVv4oc5Gy8IXIoX1c6y61vCY7ZjC5c1,5Gyp41oLVo7Gg7vF4vpmggWP5MU70QO6,8,21,6,0,0,0,4,0,31,4.428571428571429,1,0.0,7,6,0,0,14,0,0,4,0,13,18,1
5398,143227,i3TBGmeO4fvkD7YqpnTbNlRmmzyLScBH,5Gyp41oLVo7Gg7vF4vpmggWP5MU70QO6,5,4,3,0,0,0,2,0,9,1.2857142857142858,2,0.0,0,3,0,0,4,0,0,2,0,3,6,1
5399,143231,ZUlbVA3ANro9S1ne8l0m6JXZaMNDct1G,5Gyp41oLVo7Gg7vF4vpmggWP5MU70QO6,17,18,11,2,5,5,7,1,49,7.0,3,0.0,3,11,1,5,15,5,1,7,1,20,29,1
5400,143236,gCqmMW12TEdkpCuR8NZs1i7CPMU8t0Lj,5Gyp41oLVo7Gg7vF4vpmggWP5MU70QO6,1,0,0,0,0,0,1,0,1,0.14285714285714285,1,0.0,0,0,0,0,0,0,0,1,0,0,1,1
5401,143239,D0SRTJhzsGGnKbIKtAcGeOVG46CDAXxq,5Gyp41oLVo7Gg7vF4vpmggWP5MU70QO6,8,3,2,0,1,0,5,2,13,1.8571428571428572,1,0.0,0,2,0,1,3,0,0,5,2,3,10,1
5402,143245,ZGcbANp59jh5HoKYEi3osFbDIegBjaDx,5Gyp41oLVo7Gg7vF4vpmggWP5MU70QO6,1,0,0,0,0,0,1,0,1,0.14285714285714285,1,0.0,0,0,0,0,0,0,0,1,0,0,1,1
5403,143248,e4oqJIZiVVSrj74oA9qv5DL6x1BTE28k,5Gyp41oLVo7Gg7vF4vpmggWP5MU70QO6,17,36,13,0,18,5,9,0,81,11.571428571428571,2,0.0,11,13,0,18,25,5,0,9,0,42,39,1
5404,143250,aRWSlbYUgPWKJQUbaVqnmrHqZwSoAaW3,5Gyp41oLVo7Gg7vF4vpmggWP5MU70QO6,6,3,2,0,2,0,1,0,8,1.1428571428571428,1,0.0,0,2,0,2,3,0,0,1,0,4,4,1
5405,143252,DrIz3kDhvmSkfvrmxLfMPzccvUj4vYMn,5Gyp41oLVo7Gg7vF4vpmggWP5MU70QO6,5,1,1,0,1,0,2,0,5,0.7142857142857143,1,0.0,0,1,0,1,1,0,0,2,0,2,3,1
5406,143257,lBGrhUMcqy7UVFdaYHtWW7GeWS6IrzXi,5Gyp41oLVo7Gg7vF4vpmggWP5MU70QO6,6,10,1,0,0,0,2,0,13,1.8571428571428572,2,0.0,0,1,0,0,10,0,0,2,0,1,12,1
5407,143258,vehysrBoBzTFEiAZ5xY4pv6kepx8vbNH,5Gyp41oLVo7Gg7vF4vpmggWP5MU70QO6,6,3,2,0,2,0,1,0,8,1.1428571428571428,1,0.0,0,2,0,2,3,0,0,1,0,4,4,1
5408,143261,PNuCKnyPWCRVxphTjJ1pIquyKu0dURK7,5Gyp41oLVo7Gg7vF4vpmggWP5MU70QO6,7,7,2,0,3,0,1,0,13,1.8571428571428572,1,0.0,1,2,0,3,6,0,0,1,0,6,7,0
5409,143276,V4maDPP7ymXiWBoKzbNL9NLM8SbZBx64,5Gyp41oLVo7Gg7vF4vpmggWP5MU70QO6,6,2,1,0,1,0,3,0,7,1.0,1,0.0,0,1,0,1,2,0,0,3,0,2,5,1
5410,143277,lAQI1HA75fqdSp0agD1kegPEJvNWyfBy,5Gyp41oLVo7Gg7vF4vpmggWP5MU70QO6,15,16,7,5,7,4,4,0,43,6.142857142857143,2,0.0,5,7,3,7,11,4,2,4,0,22,21,1
5411,143279,hw2WVGzfZRXYWAzq8ZfYfakHEtBKUnie,5Gyp41oLVo7Gg7vF4vpmggWP5MU70QO6,10,4,3,3,2,0,3,0,15,2.142857142857143,2,0.0,1,3,2,2,3,0,1,3,0,8,7,1
5412,143290,E2BWJMlGAXYs00Msi7x11My9Zmuq9iIc,5Gyp41oLVo7Gg7vF4vpmggWP5MU70QO6,5,3,2,0,1,1,2,0,9,1.2857142857142858,1,0.0,0,2,0,1,3,1,0,2,0,3,6,1
5413,143302,Yce7TA6zcxabzTyAHw2EdJ3TEisyjXyi,5Gyp41oLVo7Gg7vF4vpmggWP5MU70QO6,8,11,3,2,1,3,2,0,22,3.142857142857143,1,0.0,5,3,2,1,6,3,0,2,0,11,11,1
5414,143306,vqyeWA2we44qvUIUFbVF8qhKfl0zvOXp,5Gyp41oLVo7Gg7vF4vpmggWP5MU70QO6,20,32,8,12,9,11,8,0,80,11.428571428571429,4,0.0,5,8,8,9,27,11,4,8,0,30,50,1
5415,143309,PnTAr4JQ7W1gITYEASL2GPQdvilj2Kny,5Gyp41oLVo7Gg7vF4vpmggWP5MU70QO6,6,3,2,0,2,0,1,0,8,1.1428571428571428,1,0.0,0,2,0,2,3,0,0,1,0,4,4,1
5416,143311,eKldxRzWRWCchzpFwuIYI37wgxRG6ly7,5Gyp41oLVo7Gg7vF4vpmggWP5MU70QO6,7,2,1,0,1,5,6,1,16,2.2857142857142856,1,0.0,0,1,0,1,2,5,0,6,1,2,14,1
5417,143319,NiiDqxBAdTsDc9DPcwgtqbrrDhEOlyZf,5Gyp41oLVo7Gg7vF4vpmggWP5MU70QO6,19,52,21,16,7,66,13,2,177,25.285714285714285,4,0.0,13,21,11,7,39,66,5,13,2,52,125,1
5418,143325,GXqFtrHuoRowCJYfCGHoX2k0m5Okzhop,5Gyp41oLVo7Gg7vF4vpmggWP5MU70QO6,14,9,0,12,3,7,5,0,36,5.142857142857143,1,0.0,3,0,7,3,6,7,5,5,0,13,23,1
5419,143326,d9pckuRFsv50kgCdQHKJsVIFdRPwkgpJ,5Gyp41oLVo7Gg7vF4vpmggWP5MU70QO6,7,5,3,0,2,0,2,0,12,1.7142857142857142,2,0.0,0,3,0,2,5,0,0,2,0,5,7,1
5420,143334,fRC3oUa2KFV7qXiPwvtscwTM49QCFBch,5Gyp41oLVo7Gg7vF4vpmggWP5MU70QO6,14,12,2,15,4,7,6,0,46,6.571428571428571,1,0.0,5,2,10,4,7,7,5,6,0,21,25,1
5421,143336,HfK03bfo5oHEIPN5TtTteaLYvLuA5TvQ,5Gyp41oLVo7Gg7vF4vpmggWP5MU70QO6,7,3,2,0,2,0,2,0,9,1.2857142857142858,1,0.0,0,2,0,2,3,0,0,2,0,4,5,1
5422,143342,thNUY2LiLdfoa2GF2Lwhr6spnxSoHgtr,5Gyp41oLVo7Gg7vF4vpmggWP5MU70QO6,9,5,2,0,2,7,6,0,22,3.142857142857143,2,0.0,0,2,0,2,5,7,0,6,0,4,18,1
5423,143349,yk7dNPuy2QkmAKDFHBIIPQEIBenZLmlw,5Gyp41oLVo7Gg7vF4vpmggWP5MU70QO6,7,7,2,0,4,0,1,0,14,2.0,1,0.0,2,2,0,4,5,0,0,1,0,8,6,1
5424,143351,T0S9RcfRRq60YsulXc3BYDvg0TOnLWiP,5Gyp41oLVo7Gg7vF4vpmggWP5MU70QO6,12,11,1,4,4,0,5,0,25,3.5714285714285716,3,0.0,4,1,2,4,7,0,2,5,0,11,14,1
5425,143354,mBlZxi6MP72QNzNmrNKi5CEb2ro3f1Wq,5Gyp41oLVo7Gg7vF4vpmggWP5MU70QO6,10,5,3,0,2,12,4,1,27,3.857142857142857,1,0.0,1,3,0,2,4,12,0,4,1,6,21,1
5426,143357,ES5t80qPSBsLdNwO5l4yvxva1043enzC,5Gyp41oLVo7Gg7vF4vpmggWP5MU70QO6,9,13,6,0,3,0,3,0,25,3.5714285714285716,3,0.0,2,6,0,3,11,0,0,3,0,11,14,1
5427,143359,skejDfGuPGYaPthvGkth4r5DzX8PSKgP,5Gyp41oLVo7Gg7vF4vpmggWP5MU70QO6,12,8,6,0,4,0,2,0,20,2.857142857142857,2,0.0,0,6,0,4,8,0,0,2,0,10,10,1
5428,143361,bAqGAqxg5V5Ftv9yeWvf8clZs7uLWIIu,5Gyp41oLVo7Gg7vF4vpmggWP5MU70QO6,12,16,7,8,3,0,5,0,39,5.571428571428571,1,0.0,3,7,6,3,13,0,2,5,0,19,20,1
5429,143363,gV52CTZaoNfCOT1aopCcdjXcqPjdhB8p,5Gyp41oLVo7Gg7vF4vpmggWP5MU70QO6,25,35,18,17,10,1,5,0,86,12.285714285714286,3,0.0,8,18,11,10,27,1,6,5,0,47,39,1
5430,143381,hcfKSKKQtScLfh5Yckcu4qVee0w7aEQG,5Gyp41oLVo7Gg7vF4vpmggWP5MU70QO6,6,4,2,0,1,0,4,0,11,1.5714285714285714,2,0.0,0,2,0,1,4,0,0,4,0,3,8,1
5431,143382,hjTlTldX3nv2rdUD7FZwX9ixWL4HYfi0,5Gyp41oLVo7Gg7vF4vpmggWP5MU70QO6,1,0,0,0,0,0,1,0,1,0.14285714285714285,1,0.0,0,0,0,0,0,0,0,1,0,0,1,1
5432,143394,xrw7VHX9gmfzucjRVukSBMEK0dnlpfLA,5Gyp41oLVo7Gg7vF4vpmggWP5MU70QO6,7,4,3,0,2,0,1,0,10,1.4285714285714286,1,0.0,0,3,0,2,4,0,0,1,0,5,5,1
5433,143408,02eB8ecCHjqNKo6qHUUGR29f8TPEGh0h,5Gyp41oLVo7Gg7vF4vpmggWP5MU70QO6,4,2,1,0,1,0,1,0,5,0.7142857142857143,1,0.0,0,1,0,1,2,0,0,1,0,2,3,1
5434,143411,CK1y4VjcDqbHCyc8j3ZyMmye3Kr0k5ek,5Gyp41oLVo7Gg7vF4vpmggWP5MU70QO6,14,13,5,13,3,1,12,1,48,6.857142857142857,2,0.0,6,5,9,3,7,1,4,12,1,23,25,1
5435,143417,7Y5C8uyNuEClb8hOu715XyJadaHTCp61,5Gyp41oLVo7Gg7vF4vpmggWP5MU70QO6,1,0,0,0,0,0,2,0,2,0.2857142857142857,1,0.0,0,0,0,0,0,0,0,2,0,0,2,1
5436,143419,Ht9x3o743lad1plxfsf7HdjIfMKPMZn4,5Gyp41oLVo7Gg7vF4vpmggWP5MU70QO6,5,2,1,0,1,0,2,0,6,0.8571428571428571,1,0.0,0,1,0,1,2,0,0,2,0,2,4,1
5437,143420,kPKbtFeSZycXMdPSVXWifyTfYCsLYpsm,5Gyp41oLVo7Gg7vF4vpmggWP5MU70QO6,6,6,3,0,1,0,1,0,11,1.5714285714285714,1,0.0,0,3,0,1,6,0,0,1,0,4,7,1
5438,143423,W3EB1elPrDjFWV4QIzuswTukmjxtHb6Z,5Gyp41oLVo7Gg7vF4vpmggWP5MU70QO6,7,5,0,0,2,0,4,0,11,1.5714285714285714,2,0.0,0,0,0,2,5,0,0,4,0,2,9,1
5439,143431,PVIjAE0m0OeJAYOHc5gIjzktRijtXdS4,5Gyp41oLVo7Gg7vF4vpmggWP5MU70QO6,14,14,9,2,7,13,3,0,48,6.857142857142857,2,0.0,1,9,2,7,13,13,0,3,0,19,29,1
5440,143436,Rp2fhqTorRTBr1g8D33XPBmW7cDKMNsw,5Gyp41oLVo7Gg7vF4vpmggWP5MU70QO6,10,5,4,0,3,0,2,0,14,2.0,1,0.0,0,4,0,3,5,0,0,2,0,7,7,1
5441,143442,TL1aA8ITe7VP42GX52yE5M5UsjXNCOS3,5Gyp41oLVo7Gg7vF4vpmggWP5MU70QO6,1,0,0,0,0,0,1,0,1,0.14285714285714285,1,0.0,0,0,0,0,0,0,0,1,0,0,1,1
5442,143444,rzXoVvb6RM0hS48T1GDjFso4hKBDuhsd,5Gyp41oLVo7Gg7vF4vpmggWP5MU70QO6,7,3,2,0,2,0,3,0,10,1.4285714285714286,2,0.0,0,2,0,2,3,0,0,3,0,4,6,0
5443,143445,tkWTBuD8nrYklSlgsF9aKVPineGUm2wd,5Gyp41oLVo7Gg7vF4vpmggWP5MU70QO6,8,21,1,0,0,4,5,0,31,4.428571428571429,2,0.0,3,1,0,0,18,4,0,5,0,4,27,1
5444,143459,1wBARDHHvsWKQHj7bq7lK3F0H1NiNW7P,5Gyp41oLVo7Gg7vF4vpmggWP5MU70QO6,20,56,32,10,3,31,12,1,145,20.714285714285715,4,0.0,15,32,8,3,41,31,2,12,1,58,87,0
5445,143461,HpI5z92WE9TCj3JyfZi0b0yrE9hT84vs,5Gyp41oLVo7Gg7vF4vpmggWP5MU70QO6,3,2,1,0,1,0,1,0,5,0.7142857142857143,1,0.0,0,1,0,1,2,0,0,1,0,2,3,0
5446,143464,EIwrlyeGDjeWjUXh7JHlTyUT60Atu46k,5Gyp41oLVo7Gg7vF4vpmggWP5MU70QO6,9,3,2,0,2,0,5,1,13,1.8571428571428572,2,0.0,0,2,0,2,3,0,0,5,1,4,9,1
5447,143465,Ym06EDwHzBxFYaLLU6Bmy2owSb22Fa89,5Gyp41oLVo7Gg7vF4vpmggWP5MU70QO6,11,5,3,4,1,2,8,1,24,3.4285714285714284,1,0.0,1,3,2,1,4,2,2,8,1,7,17,1
5448,143468,FCVHfcDbYsYWzYxezM7NdJuRbNG7Stcf,5Gyp41oLVo7Gg7vF4vpmggWP5MU70QO6,9,9,2,0,1,0,5,0,17,2.4285714285714284,2,0.0,0,2,0,1,9,0,0,5,0,3,14,1
5449,143470,aMqu8eCEf86pHiQHjiXQU7HNwgjJ7Ef9,5Gyp41oLVo7Gg7vF4vpmggWP5MU70QO6,7,10,3,2,2,0,1,0,18,2.5714285714285716,1,0.0,6,3,2,2,4,0,0,1,0,13,5,1
5450,143471,vSDrQ1d9geDui9ep7HEAuKTGkHAGrSj9,5Gyp41oLVo7Gg7vF4vpmggWP5MU70QO6,1,0,0,0,0,0,1,0,1,0.14285714285714285,1,0.0,0,0,0,0,0,0,0,1,0,0,1,1
5451,143472,B9Y7e8bNhkzxmAC9KQ9khaR6Z5USyAMX,5Gyp41oLVo7Gg7vF4vpmggWP5MU70QO6,17,20,9,14,4,10,11,1,69,9.857142857142858,3,0.0,8,9,9,4,12,10,5,11,1,30,39,0
5452,143477,xcA8OXOfvqanvgUzFy9rw3fowOqTxLUh,5Gyp41oLVo7Gg7vF4vpmggWP5MU70QO6,1,0,0,0,0,0,2,0,2,0.2857142857142857,1,0.0,0,0,0,0,0,0,0,2,0,0,2,1
5453,143488,SC4Tg58IhuJ0FTbgAqt8uHgpsrGP7oZS,5Gyp41oLVo7Gg7vF4vpmggWP5MU70QO6,5,1,1,0,1,0,2,0,5,0.7142857142857143,1,0.0,0,1,0,1,1,0,0,2,0,2,3,1
5454,143497,58zOxfIYcP2qNqBDKTQKJbiBMUfZrt1H,5Gyp41oLVo7Gg7vF4vpmggWP5MU70QO6,5,2,2,0,1,0,2,0,7,1.0,1,0.0,0,2,0,1,2,0,0,2,0,3,4,1
5455,143502,NG8XCq6OkKK4wXwAiK6pXXmZHFULWlRj,5Gyp41oLVo7Gg7vF4vpmggWP5MU70QO6,9,11,5,0,4,0,2,0,22,3.142857142857143,2,0.0,3,5,0,4,8,0,0,2,0,12,10,0
5456,143503,aSyCUcrUz5zbUWUCs7M3fNxeiJQvjetP,5Gyp41oLVo7Gg7vF4vpmggWP5MU70QO6,5,1,1,0,1,0,2,0,5,0.7142857142857143,1,0.0,0,1,0,1,1,0,0,2,0,2,3,1
5457,143516,H5zUL9xfz1fEoOcbR4FmFtG01oFL0kN2,5Gyp41oLVo7Gg7vF4vpmggWP5MU70QO6,7,6,3,0,3,0,3,0,15,2.142857142857143,1,0.0,0,3,0,3,6,0,0,3,0,6,9,1
5458,143520,XVDb9H5Pu5RcveZQUtB2uYNi9gcWY9Ky,5Gyp41oLVo7Gg7vF4vpmggWP5MU70QO6,12,15,6,0,4,0,2,0,27,3.857142857142857,2,0.0,2,6,0,4,13,0,0,2,0,12,15,1
5459,143526,o6ifuqP5xId6uZ3IOv5wNZtyqLX9zcSt,5Gyp41oLVo7Gg7vF4vpmggWP5MU70QO6,8,13,7,0,3,0,4,0,27,3.857142857142857,4,0.0,0,7,0,3,13,0,0,4,0,10,17,1
5460,143535,eoe8MCP3PcQfeT4TaH2o2CzTUaHJ13Dz,5Gyp41oLVo7Gg7vF4vpmggWP5MU70QO6,6,2,1,0,1,1,4,1,10,1.4285714285714286,1,0.0,0,1,0,1,2,1,0,4,1,2,8,1
5461,143538,n9Gury1tEYEuvNBPCLDIs6gucbc6RB21,5Gyp41oLVo7Gg7vF4vpmggWP5MU70QO6,11,8,3,0,2,8,10,2,33,4.714285714285714,3,0.0,0,3,0,2,8,8,0,10,2,5,28,1
5462,143539,J7s2RwINzhWkMnB419eeqE7UEMRUnC6K,5Gyp41oLVo7Gg7vF4vpmggWP5MU70QO6,10,7,4,2,2,1,4,0,20,2.857142857142857,1,0.0,1,4,1,2,6,1,1,4,0,8,12,1
5463,143543,KrwFmeOk1mDr3eJOjicE7v40zcLjCFgW,5Gyp41oLVo7Gg7vF4vpmggWP5MU70QO6,5,5,2,0,0,0,2,0,9,1.2857142857142858,2,0.0,0,2,0,0,5,0,0,2,0,2,7,1
5464,143544,Kpn2SZmmiazR6DCkcb8B8TXM52qr9chW,5Gyp41oLVo7Gg7vF4vpmggWP5MU70QO6,4,2,0,0,0,0,2,0,4,0.5714285714285714,2,0.0,0,0,0,0,2,0,0,2,0,0,4,1
5465,143547,O90JYkj1gGlHgM5UA1XQxOTlw7sPJoVW,5Gyp41oLVo7Gg7vF4vpmggWP5MU70QO6,1,0,0,0,0,0,2,0,2,0.2857142857142857,1,0.0,0,0,0,0,0,0,0,2,0,0,2,1
5466,143549,xw2vNsMYolKmmnXlGh5JB53RVkTtvaQu,5Gyp41oLVo7Gg7vF4vpmggWP5MU70QO6,14,19,7,2,4,7,9,1,49,7.0,2,0.0,7,7,1,4,12,7,1,9,1,19,30,1
5467,143557,vLcgnxkCcq9VvWpGGz0OyGsPIrIRA9U8,5Gyp41oLVo7Gg7vF4vpmggWP5MU70QO6,10,14,4,5,5,0,2,0,30,4.285714285714286,1,0.0,8,4,3,5,6,0,2,2,0,20,10,1
5468,143686,xhoMHYDn0DYj6NEexX867ukahPmWhSwf,bWdj2GDclj5ofokWjzoa5jAwMkxCykd6,13,7,6,0,5,0,1,0,19,2.7142857142857144,1,0.0,0,6,0,5,7,0,0,1,0,11,8,1
5469,143813,GJGZOa9ckBlFcfojmDXHYkGGywyzKOaN,SpATywNh6bZuzm8s1ceuBUnMUAeoAHHw,9,16,1,0,1,1,4,0,23,3.2857142857142856,2,0.0,0,1,0,1,16,1,0,4,0,2,21,1
5470,143822,kfS0nefl4PODD2Wbg3xDtahejAoyK8Co,RXDvfPUBYFlVdlueBFbLW0mhhAyGEqpt,50,48,34,76,12,56,5,0,231,33.0,4,0.0,8,34,57,12,40,56,19,5,0,111,120,0
5471,143903,Vd6Fw7jRvBeu91l91UPCADQJMohO1ulC,SpATywNh6bZuzm8s1ceuBUnMUAeoAHHw,9,9,2,0,2,0,3,0,16,2.2857142857142856,4,0.0,0,2,0,2,9,0,0,3,0,4,12,0
5472,143942,kS57PN5w4M8SePVOR15O2soQi4RHoCPq,SpATywNh6bZuzm8s1ceuBUnMUAeoAHHw,16,14,8,6,5,0,2,0,35,5.0,2,0.0,0,8,6,5,14,0,0,2,0,19,16,0
5473,144125,9T6sJuPiEkwFHn4VyREnKyR6Ni1hFol4,A3fsA9Zfv1X2fVEQhTw51lKENdNrEqT3,99,47,39,268,25,0,8,0,387,55.285714285714285,3,0.0,0,39,223,25,47,0,45,8,0,287,100,0
5474,144226,KkSinTdG2PbGrJIRATMZos8HES46UawO,A3fsA9Zfv1X2fVEQhTw51lKENdNrEqT3,10,13,6,0,4,0,2,0,25,3.5714285714285716,1,0.0,0,6,0,4,13,0,0,2,0,10,15,0
5475,144321,l9yVkoh4OzNZS3boMvfvu1qkbaccG6pv,SpATywNh6bZuzm8s1ceuBUnMUAeoAHHw,7,9,5,0,0,0,6,0,20,2.857142857142857,2,0.0,1,5,0,0,8,0,0,6,0,6,14,0
5476,144421,IH3Fpf227mcEx04r510MqQHERjzGveWM,A3fsA9Zfv1X2fVEQhTw51lKENdNrEqT3,45,25,22,72,12,0,2,0,133,19.0,2,0.0,1,22,57,12,24,0,15,2,0,92,41,1
5477,144595,ILvCdOvVnKq9RshqMB5c6cdDGIsepuiz,SpATywNh6bZuzm8s1ceuBUnMUAeoAHHw,10,15,3,0,2,0,2,0,22,3.142857142857143,2,0.0,0,3,0,2,15,0,0,2,0,5,17,0
5478,144649,uKGXhzbiDEpxCHjVlf9dmkGcQbxLosVe,A3fsA9Zfv1X2fVEQhTw51lKENdNrEqT3,10,5,4,0,3,0,2,0,14,2.0,1,0.0,0,4,0,3,5,0,0,2,0,7,7,1
5479,144681,ZbpLZuhcPXDt8MCBlzIEU31Qmn57Ldle,SpATywNh6bZuzm8s1ceuBUnMUAeoAHHw,3,2,1,0,0,0,1,0,4,0.5714285714285714,1,0.0,0,1,0,0,2,0,0,1,0,1,3,0
5480,144715,xQxCv7HVGUZGKsbGAuM07smPdylb1xSw,SpATywNh6bZuzm8s1ceuBUnMUAeoAHHw,15,15,0,9,0,0,4,0,28,4.0,3,0.0,2,0,9,0,13,0,0,4,0,11,17,1
5481,144719,xQxCv7HVGUZGKsbGAuM07smPdylb1xSw,A3fsA9Zfv1X2fVEQhTw51lKENdNrEqT3,31,17,1,106,0,0,6,0,130,18.571428571428573,2,0.0,3,1,95,0,14,0,11,6,0,99,31,1
5482,144806,7vmy4dx8h1nmyk40XB1bVEo0ZK716pcj,SpATywNh6bZuzm8s1ceuBUnMUAeoAHHw,11,12,2,11,0,0,4,0,29,4.142857142857143,2,0.0,4,2,11,0,8,0,0,4,0,17,12,0
5483,144963,BohRHH2vBIgnEZGZjM3WnHwJbVFmITRG,A3fsA9Zfv1X2fVEQhTw51lKENdNrEqT3,1,0,0,0,0,0,6,0,6,0.8571428571428571,2,0.0,0,0,0,0,0,0,0,6,0,0,6,1
5484,144985,UdRvlfQEjfzv2meiEECQoQ6VdSnYEWcK,RXDvfPUBYFlVdlueBFbLW0mhhAyGEqpt,1,0,0,0,0,0,1,0,1,0.14285714285714285,1,0.0,0,0,0,0,0,0,0,1,0,0,1,1
5485,145021,qwhxcjW9iIMBAQoGSWDtst34AFkcFQoV,bWdj2GDclj5ofokWjzoa5jAwMkxCykd6,7,6,3,0,2,0,2,0,13,1.8571428571428572,2,0.0,0,3,0,2,6,0,0,2,0,5,8,0
5486,145054,aRdmmgSzM3Ga3svQ0ZT0DvTgw1R0bnD6,SpATywNh6bZuzm8s1ceuBUnMUAeoAHHw,13,12,0,16,0,2,1,0,31,4.428571428571429,1,0.0,2,0,14,0,10,2,2,1,0,16,15,0
5487,145091,ung1DnQyYgd0tfz7mAKTwJrrm5UPHWt1,SpATywNh6bZuzm8s1ceuBUnMUAeoAHHw,1,0,0,0,0,0,1,0,1,0.14285714285714285,1,0.0,0,0,0,0,0,0,0,1,0,0,1,1
5488,145177,2HllbOBswZcfya5rDzlXYMHVB93oWjxb,SpATywNh6bZuzm8s1ceuBUnMUAeoAHHw,15,26,12,0,1,0,2,0,41,5.857142857142857,2,0.0,0,12,0,1,26,0,0,2,0,13,28,1
5489,145568,mJIoPjqDTjzZMwCDHGuOl5HDFi5poBoo,5X6FeZozNMgE2VRi3MJYjkkFK8SETtu2,1,0,0,0,0,0,1,0,1,0.14285714285714285,1,0.0,0,0,0,0,0,0,0,1,0,0,1,1
5490,145735,F4Ymj8M8QZRxfZ568RAeHEvyAX7UEtl3,5X6FeZozNMgE2VRi3MJYjkkFK8SETtu2,2,0,0,0,0,0,2,0,2,0.2857142857142857,1,0.0,0,0,0,0,0,0,0,2,0,0,2,1
5491,145807,RzKvPu4qwYnkKioYxIJem5I7hV4q5Zey,5X6FeZozNMgE2VRi3MJYjkkFK8SETtu2,2,0,0,0,0,0,14,0,14,2.0,2,0.0,0,0,0,0,0,0,0,14,0,0,14,0
5492,145912,iKD9MJsvnX9ciKcvGfAz7YdFPBkrBH2I,5X6FeZozNMgE2VRi3MJYjkkFK8SETtu2,2,0,0,0,0,0,2,0,2,0.2857142857142857,1,0.0,0,0,0,0,0,0,0,2,0,0,2,1
5493,146030,p0fw4v0FzqDHoIprXWv2PhAw9MEKisrS,3VkHkmOtom3jM2wCu94xgzzu1d6Dn7or,1,0,0,0,0,0,4,0,4,0.5714285714285714,1,0.0,0,0,0,0,0,0,0,4,0,0,4,0
5494,146088,5ZgKWEa42e4WFZ5q7dgOWe1eNOZx4GwM,3VkHkmOtom3jM2wCu94xgzzu1d6Dn7or,9,12,3,5,4,7,4,0,35,5.0,1,0.0,6,3,4,4,6,7,1,4,0,17,18,1
5495,146125,Bh1XqfOWD3l2FtZEwegqKxGpifXXNdJN,3VkHkmOtom3jM2wCu94xgzzu1d6Dn7or,9,16,7,0,5,4,4,0,36,5.142857142857143,1,0.0,4,7,0,5,12,4,0,4,0,16,20,1
5496,146129,9XyEVNM3WuxNMMtydG2KuKONQHNstdig,3VkHkmOtom3jM2wCu94xgzzu1d6Dn7or,6,2,1,0,1,0,4,1,9,1.2857142857142858,1,0.0,0,1,0,1,2,0,0,4,1,2,7,1
5497,146141,hF9wzZzzUNXUdemSIRccNUzFWcmYBmRA,3VkHkmOtom3jM2wCu94xgzzu1d6Dn7or,3,0,0,0,0,2,4,0,6,0.8571428571428571,2,0.0,0,0,0,0,0,2,0,4,0,0,6,1
5498,146150,hbRrVB0PrdEtXH8GGGBFfB3k36ebB3OX,3VkHkmOtom3jM2wCu94xgzzu1d6Dn7or,1,0,0,0,0,0,3,0,3,0.42857142857142855,1,0.0,0,0,0,0,0,0,0,3,0,0,3,1
5499,146153,BR3KNjegUloMzoYx4NUKOSSnRcwXdL8Z,3VkHkmOtom3jM2wCu94xgzzu1d6Dn7or,7,7,1,0,1,0,5,0,14,2.0,2,0.0,0,1,0,1,7,0,0,5,0,2,12,1
5500,146157,hMI82z3xwyibLI6HSTNSkdJkW2EbD9X5,3VkHkmOtom3jM2wCu94xgzzu1d6Dn7or,1,0,0,0,0,0,1,0,1,0.14285714285714285,1,0.0,0,0,0,0,0,0,0,1,0,0,1,1
5501,146204,Rm7NiSTRcB7r1obJzmNitfCOx35D0HWg,3VkHkmOtom3jM2wCu94xgzzu1d6Dn7or,5,2,1,0,1,0,2,0,6,0.8571428571428571,1,0.0,0,1,0,1,2,0,0,2,0,2,4,1
5502,146265,HAAd4i2Dbdg5zfCsIa6cyt0n4dIwRrHT,3VkHkmOtom3jM2wCu94xgzzu1d6Dn7or,1,0,0,0,0,0,1,0,1,0.14285714285714285,1,0.0,0,0,0,0,0,0,0,1,0,0,1,1
5503,146270,41XQah6d0f9hcRZOlQ9rAlVZvkLRx2th,3VkHkmOtom3jM2wCu94xgzzu1d6Dn7or,5,2,1,0,1,0,2,0,6,0.8571428571428571,1,0.0,0,1,0,1,2,0,0,2,0,2,4,1
5504,146286,BfyHpsFcf5SdJtDDEokJ2DaJODuDhRyN,3VkHkmOtom3jM2wCu94xgzzu1d6Dn7or,1,0,0,0,0,0,1,0,1,0.14285714285714285,1,0.0,0,0,0,0,0,0,0,1,0,0,1,0
5505,146381,B617XtuzfaazOCyEoxmlGt9BoJzuhRfF,3VkHkmOtom3jM2wCu94xgzzu1d6Dn7or,1,0,0,0,0,0,1,0,1,0.14285714285714285,1,0.0,0,0,0,0,0,0,0,1,0,0,1,1
5506,146386,6gBl9jZf9smJOKDJTr2au2myiSPXFYdj,3VkHkmOtom3jM2wCu94xgzzu1d6Dn7or,2,0,0,0,0,0,2,0,2,0.2857142857142857,1,0.0,0,0,0,0,0,0,0,2,0,0,2,1
5507,146406,srAtmjq13mrVXP6Fz4IrGLiyqwc9XE9D,3VkHkmOtom3jM2wCu94xgzzu1d6Dn7or,6,4,1,0,1,0,4,0,10,1.4285714285714286,1,0.0,2,1,0,1,2,0,0,4,0,4,6,1
5508,146416,TeUT01LyHIjK17Pt45AAodeVSkOVbecw,3VkHkmOtom3jM2wCu94xgzzu1d6Dn7or,2,0,0,0,0,0,3,0,3,0.42857142857142855,1,0.0,0,0,0,0,0,0,0,3,0,0,3,1
5509,146427,SxwYiL0K8imHewBqHVzk62D1lCszL0BN,3VkHkmOtom3jM2wCu94xgzzu1d6Dn7or,1,0,0,0,0,0,1,0,1,0.14285714285714285,1,0.0,0,0,0,0,0,0,0,1,0,0,1,1
5510,146429,7LQi4DdHoXorygBnRTdfQ002aWsmdA67,3VkHkmOtom3jM2wCu94xgzzu1d6Dn7or,66,156,41,73,36,1,26,0,333,47.57142857142857,10,0.0,58,41,71,36,98,1,2,26,0,206,127,0
5511,146461,3n6ajKAkQu8rgtUnNpdWOfMF8VSNsMVs,3VkHkmOtom3jM2wCu94xgzzu1d6Dn7or,4,0,0,0,0,9,3,0,12,1.7142857142857142,1,0.0,0,0,0,0,0,9,0,3,0,0,12,1
5512,146487,fTcFH58Cw752lPnCGf5x6q5eEon6zuX3,3VkHkmOtom3jM2wCu94xgzzu1d6Dn7or,4,4,1,0,0,0,1,0,6,0.8571428571428571,1,0.0,0,1,0,0,4,0,0,1,0,1,5,1
5513,146488,5Zai53b50WVBE5hKH1c6pfutFqTxzA73,3VkHkmOtom3jM2wCu94xgzzu1d6Dn7or,1,0,0,0,0,0,1,0,1,0.14285714285714285,1,0.0,0,0,0,0,0,0,0,1,0,0,1,1
5514,146501,RzFBvVoh5etyCpMS4xSy7pBkQzhnynt8,3VkHkmOtom3jM2wCu94xgzzu1d6Dn7or,8,4,2,0,1,0,7,0,14,2.0,2,0.0,0,2,0,1,4,0,0,7,0,3,11,1
5515,146537,5gHshx7kYLGiQqmHsTdONQBFgnspojH8,3VkHkmOtom3jM2wCu94xgzzu1d6Dn7or,1,0,0,0,0,0,2,0,2,0.2857142857142857,1,0.0,0,0,0,0,0,0,0,2,0,0,2,1
5516,146545,7oYfkKRqp5qH8msQgLOvvi2uWytP3BFJ,3VkHkmOtom3jM2wCu94xgzzu1d6Dn7or,1,0,0,0,0,0,2,0,2,0.2857142857142857,1,0.0,0,0,0,0,0,0,0,2,0,0,2,1
5517,146567,JnJRaNJGpEv1jND4E80Q1qrNA6h3u4XV,3VkHkmOtom3jM2wCu94xgzzu1d6Dn7or,5,3,1,0,1,0,2,0,7,1.0,1,0.0,0,1,0,1,3,0,0,2,0,2,5,1
5518,146589,cmPAv0G01upQaGYeDqwQ4S5qXOhzhpzv,7GRhBDsirIGkRZBtSMEzNTyDr2JQm4xx,36,66,9,32,15,9,2,0,133,19.0,2,0.0,50,9,16,15,16,9,16,2,0,90,43,1
5519,146605,9EKebTddhclJL55PjLiGQo9OLE0PGHsa,7GRhBDsirIGkRZBtSMEzNTyDr2JQm4xx,5,2,1,0,1,0,2,0,6,0.8571428571428571,1,0.0,0,1,0,1,2,0,0,2,0,2,4,1
5520,146626,6hX10Wu1E2KDRE7mYGP1VPoNRkdF7lrL,7GRhBDsirIGkRZBtSMEzNTyDr2JQm4xx,2,0,0,0,0,0,2,0,2,0.2857142857142857,1,0.0,0,0,0,0,0,0,0,2,0,0,2,1
5521,146630,OQs5DQZggGhucPRMJFFD3iwpCiRr1PsA,7GRhBDsirIGkRZBtSMEzNTyDr2JQm4xx,26,20,10,10,13,0,3,0,56,8.0,1,0.0,9,10,6,13,11,0,4,3,0,38,18,0
5522,146640,pTRc6CAadu6zTjX2qZFrcMkdMB0bHDuN,7GRhBDsirIGkRZBtSMEzNTyDr2JQm4xx,13,9,6,0,6,0,6,0,27,3.857142857142857,1,0.0,0,6,0,6,9,0,0,6,0,12,15,1
5523,146641,EgpDPflS4BhonvUv2cHFmcaZA6HKkGFU,7GRhBDsirIGkRZBtSMEzNTyDr2JQm4xx,1,0,0,0,0,0,1,0,1,0.14285714285714285,1,0.0,0,0,0,0,0,0,0,1,0,0,1,1
5524,146643,SdTaXBG7REox88XfdMpaUAB4YsjrXpUf,7GRhBDsirIGkRZBtSMEzNTyDr2JQm4xx,2,0,0,0,0,0,2,0,2,0.2857142857142857,1,0.0,0,0,0,0,0,0,0,2,0,0,2,1
5525,146646,h8QJMBO6w1y7T0vbgdE5PdsJTbaRhwO4,7GRhBDsirIGkRZBtSMEzNTyDr2JQm4xx,10,3,2,0,1,1,6,1,14,2.0,1,0.0,0,2,0,1,3,1,0,6,1,3,11,1
5526,146810,oOXpwQYARdFIxXrQ6sYVF4DXSqd0OmBs,3VkHkmOtom3jM2wCu94xgzzu1d6Dn7or,5,5,2,0,1,0,2,0,10,1.4285714285714286,2,0.0,0,2,0,1,5,0,0,2,0,3,7,1
5527,146816,PTKB8bd5qh2006KGct9uCgjhYN03wvoy,3VkHkmOtom3jM2wCu94xgzzu1d6Dn7or,9,37,17,3,10,3,16,0,86,12.285714285714286,6,0.0,9,17,3,10,28,3,0,16,0,39,47,1
5528,146818,yGll7cBEK4l513wg08W8WjrXiINZSUwd,3VkHkmOtom3jM2wCu94xgzzu1d6Dn7or,4,2,1,0,1,0,1,0,5,0.7142857142857143,1,0.0,0,1,0,1,2,0,0,1,0,2,3,1
5529,146820,IsadHJOwNaj1oDSfODX6YQ3zhU5rGmsp,3VkHkmOtom3jM2wCu94xgzzu1d6Dn7or,4,3,0,0,0,0,2,0,5,0.7142857142857143,1,0.0,0,0,0,0,3,0,0,2,0,0,5,1
5530,146831,Ztd12M7Z9bcBRNRSsNmIlBULfPhqrHyq,3VkHkmOtom3jM2wCu94xgzzu1d6Dn7or,17,38,5,13,16,0,4,0,76,10.857142857142858,1,0.0,26,5,10,16,12,0,3,4,0,57,19,1
5531,146840,Pdvh6UTK9FXuCE4WVrV5Y121aJBdVbkt,3VkHkmOtom3jM2wCu94xgzzu1d6Dn7or,5,9,5,0,2,0,5,0,21,3.0,2,0.0,0,5,0,2,9,0,0,5,0,7,14,1
5532,146842,tvlPmqHL9PXqDvjLJ02gNq4VLJb5A42f,3VkHkmOtom3jM2wCu94xgzzu1d6Dn7or,9,28,2,6,7,0,5,0,48,6.857142857142857,1,0.0,21,2,5,7,7,0,1,5,0,35,13,1
5533,146843,EUUfQTv6vUzkuoskuW3kW6Hpb2j0Ef88,3VkHkmOtom3jM2wCu94xgzzu1d6Dn7or,49,42,1,84,17,0,6,0,150,21.428571428571427,1,0.0,21,1,70,17,21,0,14,6,0,109,41,1
5534,146845,bmHkulbXG0BjFpKMImZMFiP0baUfbcTM,3VkHkmOtom3jM2wCu94xgzzu1d6Dn7or,14,40,6,6,7,8,5,0,72,10.285714285714286,2,0.0,18,6,6,7,22,8,0,5,0,37,35,0
5535,146848,3fP0Xga7TS7Jsjk4DeQ5kqvq5cbz44YC,3VkHkmOtom3jM2wCu94xgzzu1d6Dn7or,10,23,5,11,9,0,1,0,49,7.0,1,0.0,17,5,9,9,6,0,2,1,0,40,9,1
5536,146853,CNqk6cg6jWF1610X55efjYNNGXI0iRJg,3VkHkmOtom3jM2wCu94xgzzu1d6Dn7or,1,0,0,0,0,0,2,0,2,0.2857142857142857,2,0.0,0,0,0,0,0,0,0,2,0,0,2,1
5537,146862,GXaWQVeuF1AxK2nB4DS6IZdQ6sDVS1nk,3VkHkmOtom3jM2wCu94xgzzu1d6Dn7or,1,0,0,0,0,0,1,0,1,0.14285714285714285,1,0.0,0,0,0,0,0,0,0,1,0,0,1,1
5538,146863,tBFPasxeVyKNeSOXIs2AXEH5l7WLcUsl,3VkHkmOtom3jM2wCu94xgzzu1d6Dn7or,1,0,0,0,0,0,1,0,1,0.14285714285714285,1,0.0,0,0,0,0,0,0,0,1,0,0,1,1
5539,146864,oW9L7CxP0sDxYCxol70CUfkBpdozjWLb,3VkHkmOtom3jM2wCu94xgzzu1d6Dn7or,15,16,6,0,6,2,6,0,36,5.142857142857143,2,0.0,3,6,0,6,13,2,0,6,0,15,21,0
5540,146876,whXUFOJ70VhYM5aEzjMsCGcx2sy2vjyH,3VkHkmOtom3jM2wCu94xgzzu1d6Dn7or,2,0,0,0,0,0,2,0,2,0.2857142857142857,1,0.0,0,0,0,0,0,0,0,2,0,0,2,1
5541,146883,1JGeoCLOy0Ohd1AVNEEwdkSiGm93i5PR,3VkHkmOtom3jM2wCu94xgzzu1d6Dn7or,4,2,1,0,0,0,2,0,5,0.7142857142857143,1,0.0,0,1,0,0,2,0,0,2,0,1,4,1
5542,146887,jcXoYFaI9QPcliotiwIgOLeObkrSUvNn,3VkHkmOtom3jM2wCu94xgzzu1d6Dn7or,5,2,1,0,1,0,2,0,6,0.8571428571428571,1,0.0,0,1,0,1,2,0,0,2,0,2,4,1
5543,146898,EjT6fX5T9wBIN8gJ6jd6KRGiSiN1cqcA,3VkHkmOtom3jM2wCu94xgzzu1d6Dn7or,7,5,3,0,2,0,3,0,13,1.8571428571428572,2,0.0,0,3,0,2,5,0,0,3,0,5,8,1
5544,146953,TkwNaNrSLynIgxaNvilfhFA70R9L2fY3,RXDvfPUBYFlVdlueBFbLW0mhhAyGEqpt,3,4,2,0,0,0,2,0,8,1.1428571428571428,2,0.0,0,2,0,0,4,0,0,2,0,2,6,0
5545,147113,sL5jw3pLWZoRI7avI17oM60mfF67Acgz,RXDvfPUBYFlVdlueBFbLW0mhhAyGEqpt,1,0,0,0,0,0,1,0,1,0.14285714285714285,1,0.0,0,0,0,0,0,0,0,1,0,0,1,0
5546,147805,tftk2lpy46oUtFBoiUqZftLC1w52aVR4,5Gyp41oLVo7Gg7vF4vpmggWP5MU70QO6,4,2,0,0,0,0,3,0,5,0.7142857142857143,1,0.0,0,0,0,0,2,0,0,3,0,0,5,1
5547,147811,gXLitrmdBVXj6hOavgwX5Kv8nSH9hE13,5Gyp41oLVo7Gg7vF4vpmggWP5MU70QO6,2,0,0,0,0,0,2,0,2,0.2857142857142857,1,0.0,0,0,0,0,0,0,0,2,0,0,2,1
5548,147818,b2ohpFiEgZaZsBBPqUMnfjpywCAbNR88,5Gyp41oLVo7Gg7vF4vpmggWP5MU70QO6,1,0,0,0,0,0,1,0,1,0.14285714285714285,1,0.0,0,0,0,0,0,0,0,1,0,0,1,1
5549,147860,drueXeBWixFThYW148nki4eFPlnN0ceQ,5Gyp41oLVo7Gg7vF4vpmggWP5MU70QO6,4,2,1,0,0,0,2,0,5,0.7142857142857143,1,0.0,0,1,0,0,2,0,0,2,0,1,4,1
5550,147865,ZLrFhujCu1GYe9vslCLEfOmIFjQWSDsp,5Gyp41oLVo7Gg7vF4vpmggWP5MU70QO6,1,0,0,0,0,0,1,0,1,0.14285714285714285,1,0.0,0,0,0,0,0,0,0,1,0,0,1,1
5551,147894,rSiN1kTw2xbRsjF9BN3yUneRjJkZ8YKM,5Gyp41oLVo7Gg7vF4vpmggWP5MU70QO6,7,6,0,0,0,0,10,0,16,2.2857142857142856,3,0.0,0,0,0,0,6,0,0,10,0,0,16,1
5552,147902,dy6Zpf6SHivuEMzVbXysN6HLT1APxBtg,5Gyp41oLVo7Gg7vF4vpmggWP5MU70QO6,5,3,2,0,0,0,2,0,7,1.0,1,0.0,0,2,0,0,3,0,0,2,0,2,5,1
5553,147941,koVX8tCHV978kRzpSr9Kw3f0QZ9cjrGR,5Gyp41oLVo7Gg7vF4vpmggWP5MU70QO6,5,2,1,0,1,0,2,0,6,0.8571428571428571,1,0.0,0,1,0,1,2,0,0,2,0,2,4,1
5554,148007,vuVnTFCBfdzSvUffWnstx1XETLzOHwWp,5Gyp41oLVo7Gg7vF4vpmggWP5MU70QO6,1,0,0,0,0,0,2,0,2,0.2857142857142857,2,0.0,0,0,0,0,0,0,0,2,0,0,2,1
5555,148009,zCJfWd31cSL3nAYNdLVd2wJYEQhn4S1i,5Gyp41oLVo7Gg7vF4vpmggWP5MU70QO6,1,0,0,0,0,0,1,0,1,0.14285714285714285,1,0.0,0,0,0,0,0,0,0,1,0,0,1,1
5556,148010,szo3dxoUVFtnyPC8dDQr5oYgurANL0jM,5Gyp41oLVo7Gg7vF4vpmggWP5MU70QO6,1,0,0,0,0,0,1,0,1,0.14285714285714285,1,0.0,0,0,0,0,0,0,0,1,0,0,1,1
5557,148043,wpSpDcXHsdXkRVpbtm1hXwCRQFLPOV7G,5Gyp41oLVo7Gg7vF4vpmggWP5MU70QO6,5,2,1,0,1,0,2,0,6,0.8571428571428571,1,0.0,0,1,0,1,2,0,0,2,0,2,4,1
5558,148063,SB6c72YMu2I6UoxRlKmbFhpADSxoKwQc,5Gyp41oLVo7Gg7vF4vpmggWP5MU70QO6,14,28,12,14,13,5,8,0,80,11.428571428571429,3,0.0,12,12,9,13,16,5,5,8,0,46,34,1
5559,148083,kjrJbHri2dhD9BduhqLwj0qNbqxkh9F5,5Gyp41oLVo7Gg7vF4vpmggWP5MU70QO6,11,7,6,0,4,0,1,0,18,2.5714285714285716,1,0.0,0,6,0,4,7,0,0,1,0,10,8,1
5560,148191,h3GEL33ZjWW6TpuAxgoUiVq42WJkrtPw,5Gyp41oLVo7Gg7vF4vpmggWP5MU70QO6,17,16,10,4,4,16,8,1,59,8.428571428571429,1,0.0,5,10,2,4,11,16,2,8,1,21,38,1
5561,148202,o8kHR47syKKEbYoWQpVJ0TZ0kXlfuaxo,5Gyp41oLVo7Gg7vF4vpmggWP5MU70QO6,1,0,0,0,0,0,1,0,1,0.14285714285714285,1,0.0,0,0,0,0,0,0,0,1,0,0,1,1
5562,148208,Zp2S71jHE6ylpy0KCBMNtqgAseq1yfR6,5Gyp41oLVo7Gg7vF4vpmggWP5MU70QO6,5,2,1,0,1,0,2,0,6,0.8571428571428571,1,0.0,0,1,0,1,2,0,0,2,0,2,4,1
5563,148248,uVnx7FjvELGOuvTyZhK3CuRgHkmAxzaa,5Gyp41oLVo7Gg7vF4vpmggWP5MU70QO6,1,0,0,0,0,0,1,0,1,0.14285714285714285,1,0.0,0,0,0,0,0,0,0,1,0,0,1,1
5564,148286,YFMufLtcQ6iEP2bQyAB5uI0HLfSzIDX1,5Gyp41oLVo7Gg7vF4vpmggWP5MU70QO6,1,0,0,0,0,0,1,0,1,0.14285714285714285,1,0.0,0,0,0,0,0,0,0,1,0,0,1,1
5565,148296,rum49bxsKrsKz5qfYVoNEGa5FabtWndb,7GRhBDsirIGkRZBtSMEzNTyDr2JQm4xx,1,0,0,0,0,0,1,0,1,0.14285714285714285,1,0.0,0,0,0,0,0,0,0,1,0,0,1,1
5566,148297,mSs5bB1Rxg3xYWjWjJY9pVTt7WAiMgyu,7GRhBDsirIGkRZBtSMEzNTyDr2JQm4xx,7,3,2,0,2,0,3,0,10,1.4285714285714286,2,0.0,0,2,0,2,3,0,0,3,0,4,6,0
5567,148300,FKqGzWb3VsmU7jpYPJbCVaVAzRrOMrbY,7GRhBDsirIGkRZBtSMEzNTyDr2JQm4xx,13,14,3,6,4,25,8,0,60,8.571428571428571,1,0.0,8,3,5,4,6,25,1,8,0,20,40,0
5568,148306,YITKlH8EFDS1BDDcEfdQ73rlI4f37n9A,7GRhBDsirIGkRZBtSMEzNTyDr2JQm4xx,7,5,2,4,2,2,2,0,17,2.4285714285714284,1,0.0,1,2,4,2,4,2,0,2,0,9,8,1
5569,148308,AgkxRkUEeKaWJWeFdUfFP1oidzDmX3wN,7GRhBDsirIGkRZBtSMEzNTyDr2JQm4xx,8,6,4,0,2,0,2,0,14,2.0,1,0.0,1,4,0,2,5,0,0,2,0,7,7,1
5570,148309,MlTxi8RHVkOkUJvdeW5QueC8rHHUb8J8,7GRhBDsirIGkRZBtSMEzNTyDr2JQm4xx,2,0,0,0,0,0,2,0,2,0.2857142857142857,1,0.0,0,0,0,0,0,0,0,2,0,0,2,1
5571,148312,pDoh1uqWcgliQMNyRKRo96mBVZnNp096,7GRhBDsirIGkRZBtSMEzNTyDr2JQm4xx,2,0,0,0,0,0,2,0,2,0.2857142857142857,1,0.0,0,0,0,0,0,0,0,2,0,0,2,1
5572,148321,J55iMOtceEGJhbZdzVk7bzHO712hM6pj,7GRhBDsirIGkRZBtSMEzNTyDr2JQm4xx,8,7,4,0,3,1,4,0,19,2.7142857142857144,1,0.0,1,4,0,3,6,1,0,4,0,8,11,0
5573,148323,iTyaCKpU2BXn5y8oYGLNdArTQsPetqh8,7GRhBDsirIGkRZBtSMEzNTyDr2JQm4xx,2,0,0,0,0,0,3,0,3,0.42857142857142855,1,0.0,0,0,0,0,0,0,0,3,0,0,3,1
5574,148324,97rBQQfPK19vUmiWQp62BQGqA2mCgBut,7GRhBDsirIGkRZBtSMEzNTyDr2JQm4xx,5,2,1,0,1,2,5,0,11,1.5714285714285714,1,0.0,0,1,0,1,2,2,0,5,0,2,9,1
5575,148333,5ofq7JCTsrFWBDElbifdevFR6SqxchRB,7GRhBDsirIGkRZBtSMEzNTyDr2JQm4xx,1,0,0,0,0,0,1,0,1,0.14285714285714285,1,0.0,0,0,0,0,0,0,0,1,0,0,1,1
5576,148462,NFcWSxRIoQJ6uyBNNayVcsmUYxNvF0Hr,SpATywNh6bZuzm8s1ceuBUnMUAeoAHHw,6,4,0,0,0,0,5,0,9,1.2857142857142858,1,0.0,1,0,0,0,3,0,0,5,0,1,8,1
5577,148465,aISyThuiw10fsCPPUtqVz2ccwIDIESls,G8EPVSXsOYB5YQWZGiz1aVq5Pgr2GrQu,10,16,13,9,0,0,0,0,38,5.428571428571429,1,0.0,0,13,8,0,16,0,1,0,0,21,17,0
5578,148503,9CQfIvDiQz4gDArSnTXOgxNKUwJW75pD,SpATywNh6bZuzm8s1ceuBUnMUAeoAHHw,20,22,17,16,10,0,5,0,70,10.0,3,0.0,2,17,13,10,20,0,3,5,0,42,28,0
5579,148509,EJqwtsSz6hilFtXpX5lfE4At9whH7WUw,SpATywNh6bZuzm8s1ceuBUnMUAeoAHHw,3,1,0,0,0,0,3,0,4,0.5714285714285714,1,0.0,0,0,0,0,1,0,0,3,0,0,4,1
5580,148586,oYErMzphr0xt2i2tKTG42QELMDaumLkL,RXDvfPUBYFlVdlueBFbLW0mhhAyGEqpt,4,2,1,0,1,0,1,0,5,0.7142857142857143,1,0.0,0,1,0,1,2,0,0,1,0,2,3,1
5581,148596,FC3H56QIjzwzfAuLhWGinlpASokqCo9M,SpATywNh6bZuzm8s1ceuBUnMUAeoAHHw,17,35,19,13,0,9,14,1,91,13.0,4,0.0,6,19,11,0,29,9,2,14,1,36,55,0
5582,148598,sg4VVv9cgk6nt80dZvUKhL5H7RMgLm0l,SpATywNh6bZuzm8s1ceuBUnMUAeoAHHw,20,31,2,40,1,0,10,0,84,12.0,3,0.0,12,2,37,1,19,0,3,10,0,52,32,1
5583,148611,oGTSG0bYZEKmqMQUI2QOgfbr6I1mZJJh,SpATywNh6bZuzm8s1ceuBUnMUAeoAHHw,12,33,2,0,1,0,9,0,45,6.428571428571429,3,0.0,0,2,0,1,33,0,0,9,0,3,42,1
5584,148622,6RpP1knSR8iDNosichQ4lSzSXyvfFkNH,SpATywNh6bZuzm8s1ceuBUnMUAeoAHHw,9,6,4,0,3,3,11,3,30,4.285714285714286,1,0.0,0,4,0,3,6,3,0,11,3,7,23,1
5585,148625,230jUwlujvGZtNIXTT6Gi5AZGgeYapcT,SpATywNh6bZuzm8s1ceuBUnMUAeoAHHw,8,4,3,0,3,0,9,0,19,2.7142857142857144,1,0.0,0,3,0,3,4,0,0,9,0,6,13,1
5586,148650,9zA3LVN93nZSiZIUpOhwqziA6RcnSGOv,SpATywNh6bZuzm8s1ceuBUnMUAeoAHHw,14,20,3,6,1,0,1,0,31,4.428571428571429,1,0.0,0,3,5,1,20,0,1,1,0,9,22,1
5587,148654,sTxEoxueQ2iNvcjPH8BgpVT2Uz1KyXvb,A3fsA9Zfv1X2fVEQhTw51lKENdNrEqT3,5,3,2,0,0,0,3,0,8,1.1428571428571428,1,0.0,0,2,0,0,3,0,0,3,0,2,6,1
5588,148708,QffrhmaCXbaB9XOhV3NLOmPuRvGWA3G5,SpATywNh6bZuzm8s1ceuBUnMUAeoAHHw,4,2,1,0,0,0,2,0,5,0.7142857142857143,1,0.0,0,1,0,0,2,0,0,2,0,1,4,1
5589,148724,4YDp1nxKf6ZgyVxOrG2MY3nyG30jIlTN,SpATywNh6bZuzm8s1ceuBUnMUAeoAHHw,5,5,1,0,0,0,2,0,8,1.1428571428571428,1,0.0,0,1,0,0,5,0,0,2,0,1,7,1
5590,148773,f2RxaLdYf2Tr0XIXAiBwlA7VXVA1XDPz,SpATywNh6bZuzm8s1ceuBUnMUAeoAHHw,3,4,1,0,0,0,2,0,7,1.0,1,0.0,0,1,0,0,4,0,0,2,0,1,6,1
5591,148776,6EaK0gHFiSwbLJpDVBHv9ZNNoyIiEert,SpATywNh6bZuzm8s1ceuBUnMUAeoAHHw,12,13,6,10,0,0,3,0,32,4.571428571428571,2,0.0,4,6,10,0,9,0,0,3,0,20,12,0
5592,148777,SWaMMFaEgBIwWimOSjcPRySyg7Gfrl6L,G8EPVSXsOYB5YQWZGiz1aVq5Pgr2GrQu,31,50,20,90,4,3,13,0,180,25.714285714285715,3,0.0,11,20,72,4,39,3,18,13,0,107,73,1
5593,148790,aJHRT3LiLupkaY9OS8kHMvtwJmIsdmDj,5X6FeZozNMgE2VRi3MJYjkkFK8SETtu2,3,2,0,0,0,0,2,0,4,0.5714285714285714,1,0.0,0,0,0,0,2,0,0,2,0,0,4,1
5594,148793,2brfbtCm4kcVm5Xvz8Jw1eZfaRPhXxis,SpATywNh6bZuzm8s1ceuBUnMUAeoAHHw,5,2,1,0,1,0,3,1,8,1.1428571428571428,1,0.0,0,1,0,1,2,0,0,3,1,2,6,1
5595,148819,kuZwBvEdgeUtKZ495C2FptBbxEtLtmVH,5X6FeZozNMgE2VRi3MJYjkkFK8SETtu2,5,7,3,0,2,0,2,0,14,2.0,2,0.0,0,3,0,2,7,0,0,2,0,5,9,1
5596,148884,PjNJu1yveIzqM45IGKszKj86ZWx1BoKb,bWdj2GDclj5ofokWjzoa5jAwMkxCykd6,1,0,0,0,0,0,1,0,1,0.14285714285714285,1,0.0,0,0,0,0,0,0,0,1,0,0,1,1
5597,148911,xeWj4YSbf5BxF3thVawoQgzwU89sTfAT,G8EPVSXsOYB5YQWZGiz1aVq5Pgr2GrQu,22,19,14,0,9,3,16,1,62,8.857142857142858,2,0.0,0,14,0,9,19,3,0,16,1,23,39,1
5598,148934,HWbSEkrpOgvIJQ3i154EhtbcbMi0AO6e,SpATywNh6bZuzm8s1ceuBUnMUAeoAHHw,5,5,2,0,1,0,1,0,9,1.2857142857142858,1,0.0,0,2,0,1,5,0,0,1,0,3,6,1
5599,148942,ZCud3HVbJtHY8VV7DwTxNTWANdhPzMYh,bWdj2GDclj5ofokWjzoa5jAwMkxCykd6,1,0,0,0,0,0,1,0,1,0.14285714285714285,1,0.0,0,0,0,0,0,0,0,1,0,0,1,1
5600,148992,4OV0W0nOUO05rXo3pxbmiSLc9O458KIT,SpATywNh6bZuzm8s1ceuBUnMUAeoAHHw,15,14,0,41,0,0,9,0,64,9.142857142857142,2,0.0,9,0,38,0,5,0,3,9,0,47,17,0
5601,149002,6rY5gqjppQzPtOIlGOty1LtzqGK2wvGe,SpATywNh6bZuzm8s1ceuBUnMUAeoAHHw,6,4,1,0,1,0,2,0,8,1.1428571428571428,1,0.0,0,1,0,1,4,0,0,2,0,2,6,0
5602,149008,FpSzDAj37qdvKX5nxNGIEeNIprGz0pzn,SpATywNh6bZuzm8s1ceuBUnMUAeoAHHw,5,2,0,0,1,0,3,0,6,0.8571428571428571,1,0.0,0,0,0,1,2,0,0,3,0,1,5,1
5603,149014,5UJZmEar1AX3gQXOzkh3MnQcYdErI17M,bWdj2GDclj5ofokWjzoa5jAwMkxCykd6,3,4,2,0,0,0,2,0,8,1.1428571428571428,1,0.0,0,2,0,0,4,0,0,2,0,2,6,0
5604,149053,5cDuzRb0PcKkxzhRmOgPuiz1InwgLalt,5X6FeZozNMgE2VRi3MJYjkkFK8SETtu2,11,17,5,0,7,1,3,0,33,4.714285714285714,1,0.0,10,5,0,7,7,1,0,3,0,22,11,1
5605,149056,79sLgxKWhPrtGazd9PH6J4Tn1LGZboVt,SpATywNh6bZuzm8s1ceuBUnMUAeoAHHw,5,2,1,0,1,0,2,1,7,1.0,1,0.0,0,1,0,1,2,0,0,2,1,2,5,1
5606,149128,5ehf4EFN8WhDbvmb2WvfZwpaBD0cj1oj,SpATywNh6bZuzm8s1ceuBUnMUAeoAHHw,17,23,4,0,4,38,10,0,79,11.285714285714286,4,0.0,0,4,0,4,23,38,0,10,0,8,71,0
5607,149135,HDeZBhNQKtgQRWJ96cSCNvruJhAhiBb4,SpATywNh6bZuzm8s1ceuBUnMUAeoAHHw,1,0,0,0,0,0,1,0,1,0.14285714285714285,1,0.0,0,0,0,0,0,0,0,1,0,0,1,1
5608,149142,mWpCn0bY1MeiAVq9pPQtOc8MGk8PY2NJ,5X6FeZozNMgE2VRi3MJYjkkFK8SETtu2,27,76,11,46,18,0,4,0,155,22.142857142857142,2,0.0,34,11,37,18,42,0,9,4,0,100,55,1
5609,149162,NCvc3nvyx1PEfaFio0HFzoICqxsY9Kiv,SpATywNh6bZuzm8s1ceuBUnMUAeoAHHw,5,3,2,0,0,0,2,0,7,1.0,1,0.0,0,2,0,0,3,0,0,2,0,2,5,1
5610,149193,CttUHIFDXoWTFOldpxfPnv8kQdVn6WXf,G8EPVSXsOYB5YQWZGiz1aVq5Pgr2GrQu,2,0,0,0,0,0,2,0,2,0.2857142857142857,1,0.0,0,0,0,0,0,0,0,2,0,0,2,1
5611,149206,eph9VIYbQuJfMrz8nF876Qp2UCrBhVsi,SpATywNh6bZuzm8s1ceuBUnMUAeoAHHw,7,3,2,0,2,0,2,0,9,1.2857142857142858,1,0.0,0,2,0,2,3,0,0,2,0,4,5,1
5612,149253,xEGf9qcbsdcPFG6LbnSrabaHc27cQrPO,G8EPVSXsOYB5YQWZGiz1aVq5Pgr2GrQu,1,0,0,0,0,0,1,0,1,0.14285714285714285,1,0.0,0,0,0,0,0,0,0,1,0,0,1,1
5613,149321,FCLM3qdcpb60NUQFViwykzSTHS7GhoKF,bWdj2GDclj5ofokWjzoa5jAwMkxCykd6,1,0,0,0,0,0,1,0,1,0.14285714285714285,1,0.0,0,0,0,0,0,0,0,1,0,0,1,1
5614,149331,Sl8HkyBvr8NGjHxzN5bFwFxLwJOTbHKV,bWdj2GDclj5ofokWjzoa5jAwMkxCykd6,1,0,0,0,0,0,1,0,1,0.14285714285714285,1,0.0,0,0,0,0,0,0,0,1,0,0,1,1
5615,149345,GxZBUh8Rj9So22P1De1wjazGUEkYIxNL,SpATywNh6bZuzm8s1ceuBUnMUAeoAHHw,1,0,0,0,0,0,1,0,1,0.14285714285714285,1,0.0,0,0,0,0,0,0,0,1,0,0,1,1
5616,149364,C5JjdaA2TpnbGFuMIjvBUyS5u6COBRuh,5X6FeZozNMgE2VRi3MJYjkkFK8SETtu2,4,2,1,0,1,0,1,0,5,0.7142857142857143,1,0.0,0,1,0,1,2,0,0,1,0,2,3,1
5617,149401,bLwwrXuBpPds35XzYeL0YGMC0uDavcsO,G8EPVSXsOYB5YQWZGiz1aVq5Pgr2GrQu,21,27,4,42,3,1,10,0,87,12.428571428571429,1,0.0,12,4,36,3,15,1,6,10,0,55,32,1
5618,149417,Pdvh6UTK9FXuCE4WVrV5Y121aJBdVbkt,bWdj2GDclj5ofokWjzoa5jAwMkxCykd6,5,2,1,0,1,0,2,0,6,0.8571428571428571,1,0.0,0,1,0,1,2,0,0,2,0,2,4,1
5619,149420,vVmrtbXOR8LaWp48hajdNZIlFCL7http,SpATywNh6bZuzm8s1ceuBUnMUAeoAHHw,7,6,4,0,2,0,2,0,14,2.0,2,0.0,0,4,0,2,6,0,0,2,0,6,8,1
5620,149421,RAAQLpPenoCljHENtpqjvSXS8Gfv0T1E,A3fsA9Zfv1X2fVEQhTw51lKENdNrEqT3,1,0,0,0,0,0,1,0,1,0.14285714285714285,1,0.0,0,0,0,0,0,0,0,1,0,0,1,1
5621,149438,HhHFHVl0FdyFAQQ7F70xD2HQyGMqv85Q,5X6FeZozNMgE2VRi3MJYjkkFK8SETtu2,1,0,0,0,0,0,1,0,1,0.14285714285714285,1,0.0,0,0,0,0,0,0,0,1,0,0,1,1
5622,149440,HhHFHVl0FdyFAQQ7F70xD2HQyGMqv85Q,A3fsA9Zfv1X2fVEQhTw51lKENdNrEqT3,12,15,6,0,4,0,1,0,26,3.7142857142857144,1,0.0,0,6,0,4,15,0,0,1,0,10,16,1
5623,149450,MxG2Ev7XiiMWM1pXw5Ve1ZD2Aymhanp7,bWdj2GDclj5ofokWjzoa5jAwMkxCykd6,1,0,0,0,0,0,1,0,1,0.14285714285714285,1,0.0,0,0,0,0,0,0,0,1,0,0,1,1
5624,149455,QCIxkwrtd7EyHnigeiQpqn6l0kVuCgK4,bWdj2GDclj5ofokWjzoa5jAwMkxCykd6,7,3,2,0,2,0,2,0,9,1.2857142857142858,1,0.0,0,2,0,2,3,0,0,2,0,4,5,1
5625,149462,o69BaNn8nNwkn0WRwXTNaYgGrUvOyxv9,SpATywNh6bZuzm8s1ceuBUnMUAeoAHHw,20,19,1,5,1,27,8,0,61,8.714285714285714,3,0.0,1,1,5,1,18,27,0,8,0,8,53,0
5626,149468,xlweOOPqtNKKu7s1PmxHGdYFecoJy0tW,bWdj2GDclj5ofokWjzoa5jAwMkxCykd6,1,0,0,0,0,0,1,0,1,0.14285714285714285,1,0.0,0,0,0,0,0,0,0,1,0,0,1,1
5627,149489,u8XDmL2Jcc1UmsAKR6F96ZEMjyKd0OHk,5X6FeZozNMgE2VRi3MJYjkkFK8SETtu2,5,2,1,0,1,0,2,0,6,0.8571428571428571,1,0.0,0,1,0,1,2,0,0,2,0,2,4,1
5628,149502,FBX5RhepBD18ojig0DuZagEpl7jrwSAk,bWdj2GDclj5ofokWjzoa5jAwMkxCykd6,10,14,7,36,4,0,4,0,65,9.285714285714286,2,0.0,3,7,36,4,11,0,0,4,0,50,15,1
5629,149505,TgcCH3erWiZRHJcY2HABDtNaJwPoDafv,SpATywNh6bZuzm8s1ceuBUnMUAeoAHHw,24,31,4,25,3,0,12,0,75,10.714285714285714,4,0.0,14,4,22,3,17,0,3,12,0,43,32,1
5630,149560,2uhnOLzQkP0M6l7V6JeJRSNzF5FWIx9G,5X6FeZozNMgE2VRi3MJYjkkFK8SETtu2,5,2,1,0,1,0,2,0,6,0.8571428571428571,1,0.0,0,1,0,1,2,0,0,2,0,2,4,1
5631,149570,8958pt2z4OHwTl32JK0k9CAPziEN4Bzu,SpATywNh6bZuzm8s1ceuBUnMUAeoAHHw,1,0,0,0,0,0,1,0,1,0.14285714285714285,1,0.0,0,0,0,0,0,0,0,1,0,0,1,1
5632,149575,MDp7DOIvKcLxQwYa7iYETsW6UM7XLKe9,SpATywNh6bZuzm8s1ceuBUnMUAeoAHHw,4,3,2,0,0,0,1,0,6,0.8571428571428571,1,0.0,0,2,0,0,3,0,0,1,0,2,4,1
5633,149588,SdSbeWd4oEnIQjEokLws1yqSOv3sXqaR,bWdj2GDclj5ofokWjzoa5jAwMkxCykd6,1,0,0,0,0,0,1,0,1,0.14285714285714285,1,0.0,0,0,0,0,0,0,0,1,0,0,1,1
5634,149617,8aV4yRTVM0HzdlWjuQKHgiNXm0RErk1U,bWdj2GDclj5ofokWjzoa5jAwMkxCykd6,4,3,0,0,0,0,1,0,4,0.5714285714285714,1,0.0,0,0,0,0,3,0,0,1,0,0,4,0
5635,149633,tmwYxPndf0bBoBktnRObtCNzTZcFIFQq,SpATywNh6bZuzm8s1ceuBUnMUAeoAHHw,6,4,1,0,1,0,1,0,7,1.0,1,0.0,0,1,0,1,4,0,0,1,0,2,5,1
5636,149655,BvI5CiGNtYcKpjVG9fTMezMQs6vWmHfH,bWdj2GDclj5ofokWjzoa5jAwMkxCykd6,10,7,4,4,1,3,4,0,23,3.2857142857142856,1,0.0,0,4,2,1,7,3,2,4,0,7,16,1
5637,149659,PMp3RxnsqELMI5BiCmteZ8iF2l5wlW7H,5X6FeZozNMgE2VRi3MJYjkkFK8SETtu2,1,0,0,0,0,0,2,0,2,0.2857142857142857,1,0.0,0,0,0,0,0,0,0,2,0,0,2,1
5638,149682,cQ0KD7lyMK06WYdfiZiDvkcnrB91X6dF,RXDvfPUBYFlVdlueBFbLW0mhhAyGEqpt,42,41,4,100,4,0,5,0,154,22.0,4,0.0,10,4,94,4,31,0,6,5,0,112,42,0
5639,149692,7AAdXAGWvappN7B38jOB9fzxLSuIXADG,RXDvfPUBYFlVdlueBFbLW0mhhAyGEqpt,6,4,1,0,1,0,2,0,8,1.1428571428571428,1,0.0,0,1,0,1,4,0,0,2,0,2,6,0
5640,149702,oSiyWt4iiuWU3OGDrEk1CkOoayHN39wy,SpATywNh6bZuzm8s1ceuBUnMUAeoAHHw,5,2,1,0,1,0,2,0,6,0.8571428571428571,1,0.0,0,1,0,1,2,0,0,2,0,2,4,0
5641,149712,ovOrxCTVGxQyC9labPGJ3gKHEzv9s9aZ,SpATywNh6bZuzm8s1ceuBUnMUAeoAHHw,5,3,2,0,1,0,1,0,7,1.0,1,0.0,0,2,0,1,3,0,0,1,0,3,4,1
5642,149794,DpqUZKEZpIFvZzvEXk8oaJMRAbEfypNN,bWdj2GDclj5ofokWjzoa5jAwMkxCykd6,10,3,3,0,3,0,3,0,12,1.7142857142857142,1,0.0,0,3,0,3,3,0,0,3,0,6,6,1
5643,149795,YI86C9tMYiPNH60fwrrOqDqOHSDWv9QR,G8EPVSXsOYB5YQWZGiz1aVq5Pgr2GrQu,5,3,2,0,2,0,2,0,9,1.2857142857142858,1,0.0,0,2,0,2,3,0,0,2,0,4,5,1
5644,149816,U8u2oofRYkvAFc5S0d9MPpENNm076FZl,G8EPVSXsOYB5YQWZGiz1aVq5Pgr2GrQu,7,5,1,0,1,1,4,1,13,1.8571428571428572,1,0.0,0,1,0,1,5,1,0,4,1,2,11,0
5645,149853,EGrooJVAAIUP6U4I2p0rt4nL3Y713JTJ,bWdj2GDclj5ofokWjzoa5jAwMkxCykd6,7,9,4,0,1,0,4,0,18,2.5714285714285716,1,0.0,1,4,0,1,8,0,0,4,0,6,12,1
5646,149865,EWPkFJXEPcxVpISSGikSu1idwGgv3lJY,SpATywNh6bZuzm8s1ceuBUnMUAeoAHHw,8,5,3,0,2,0,3,0,13,1.8571428571428572,1,0.0,0,3,0,2,5,0,0,3,0,5,8,1
5647,149869,DV9cmKY91lk8lKsMUmLIMP1KsHFcyZMK,bWdj2GDclj5ofokWjzoa5jAwMkxCykd6,19,6,4,94,0,0,2,0,106,15.142857142857142,1,0.0,0,4,87,0,6,0,7,2,0,91,15,1
5648,149871,LuPgMCIdX2ugHzDAngaEsA394qOat0id,5X6FeZozNMgE2VRi3MJYjkkFK8SETtu2,1,0,0,0,0,0,1,0,1,0.14285714285714285,1,0.0,0,0,0,0,0,0,0,1,0,0,1,1
5649,149877,SANLEmv2xqr9UbPUpTzbFGNJfLVXFrzf,SpATywNh6bZuzm8s1ceuBUnMUAeoAHHw,7,9,1,0,1,0,2,0,13,1.8571428571428572,1,0.0,0,1,0,1,9,0,0,2,0,2,11,1
5650,149899,jcaD7HmCCQ4mKgrQNeo4NKmPRmKgoAZW,SpATywNh6bZuzm8s1ceuBUnMUAeoAHHw,2,0,0,0,0,0,2,0,2,0.2857142857142857,1,0.0,0,0,0,0,0,0,0,2,0,0,2,1
5651,149903,tNeYs5eBpBxsyX2sdRFHqDEmvM7JeehL,SpATywNh6bZuzm8s1ceuBUnMUAeoAHHw,6,3,1,0,1,0,4,0,9,1.2857142857142858,1,0.0,0,1,0,1,3,0,0,4,0,2,7,1
5652,149917,ChzNldCJWcjFbNJPk0sdV5CvUzj1IPeI,SpATywNh6bZuzm8s1ceuBUnMUAeoAHHw,2,0,0,0,0,0,2,0,2,0.2857142857142857,1,0.0,0,0,0,0,0,0,0,2,0,0,2,1
5653,149924,ICTHiMLsDNdLMg40eEErPhb0R1VUkY0B,SpATywNh6bZuzm8s1ceuBUnMUAeoAHHw,5,3,0,0,0,0,2,0,5,0.7142857142857143,1,0.0,0,0,0,0,3,0,0,2,0,0,5,1
5654,149925,3qTPc1fFRwuwUUC7TOpySJ2JiqYsj3j7,G8EPVSXsOYB5YQWZGiz1aVq5Pgr2GrQu,1,0,0,0,0,0,1,0,1,0.14285714285714285,1,0.0,0,0,0,0,0,0,0,1,0,0,1,1
5655,149939,Of6sdrvyVlVDF5GVtRDGN0xmyyFixkhD,SpATywNh6bZuzm8s1ceuBUnMUAeoAHHw,1,0,0,0,0,0,1,0,1,0.14285714285714285,1,0.0,0,0,0,0,0,0,0,1,0,0,1,1
5656,149950,byUmCtzRLWWrWRajFZnozMEalaeEKWAr,RXDvfPUBYFlVdlueBFbLW0mhhAyGEqpt,9,8,4,0,4,0,1,0,17,2.4285714285714284,1,0.0,2,4,0,4,6,0,0,1,0,10,7,1
5657,149971,6gWNl8crhOxwgA0Ij5LzJgWFSYDFCzaS,SpATywNh6bZuzm8s1ceuBUnMUAeoAHHw,1,0,0,0,0,0,1,0,1,0.14285714285714285,1,0.0,0,0,0,0,0,0,0,1,0,0,1,1
5658,150018,2XDpaAo3slMsrFQXFgtVX89IlqkzpX74,RXDvfPUBYFlVdlueBFbLW0mhhAyGEqpt,10,9,5,0,1,0,8,0,23,3.2857142857142856,2,0.0,0,5,0,1,9,0,0,8,0,6,17,1
5659,150044,OxJaeWpi7GqNZC9vZnlS2EIr7v2Sn1Az,RXDvfPUBYFlVdlueBFbLW0mhhAyGEqpt,1,0,0,0,0,0,1,0,1,0.14285714285714285,1,0.0,0,0,0,0,0,0,0,1,0,0,1,1
5660,150064,kFq2dX2idryINNQb9BQiBNQL0jaWL2j5,bWdj2GDclj5ofokWjzoa5jAwMkxCykd6,17,12,6,4,3,4,12,3,44,6.285714285714286,2,0.0,0,6,2,3,12,4,2,12,3,11,33,1
5661,150086,foZomfeiH5mdSFjeB6umSt6lwP9hfSDR,5X6FeZozNMgE2VRi3MJYjkkFK8SETtu2,2,0,0,0,0,0,4,0,4,0.5714285714285714,1,0.0,0,0,0,0,0,0,0,4,0,0,4,1
5662,150124,2ux7ss84pdjL26Mv3ZxbKmm47IXkqPAr,5Gyp41oLVo7Gg7vF4vpmggWP5MU70QO6,14,13,9,0,5,1,9,0,37,5.285714285714286,2,0.0,0,9,0,5,13,1,0,9,0,14,23,1
5663,150130,3UKnBgGmIdlU5zyDHb4w8rwI2yh5Hedu,5Gyp41oLVo7Gg7vF4vpmggWP5MU70QO6,1,0,0,0,0,0,1,0,1,0.14285714285714285,1,0.0,0,0,0,0,0,0,0,1,0,0,1,1
5664,150132,EAiClpyKaZse8fkxBRKv0DqS6nuRtZM9,5Gyp41oLVo7Gg7vF4vpmggWP5MU70QO6,27,44,20,2,14,0,19,0,99,14.142857142857142,1,0.0,12,20,1,14,32,0,1,19,0,47,52,1
5665,150140,69cOGwnqxePe9nAy9ETeoKKFcDvh4Fa2,5Gyp41oLVo7Gg7vF4vpmggWP5MU70QO6,1,0,0,0,0,0,1,0,1,0.14285714285714285,1,0.0,0,0,0,0,0,0,0,1,0,0,1,1
5666,150144,cW0B2vcjXS3ZZohkLuGOhkvF4B1TOcDs,5Gyp41oLVo7Gg7vF4vpmggWP5MU70QO6,7,2,1,0,2,25,8,1,39,5.571428571428571,4,0.0,0,1,0,2,2,25,0,8,1,3,36,1
5667,150147,E0Vc68zQyaBo1QGFDy3X2ztIvkjoKV3F,5Gyp41oLVo7Gg7vF4vpmggWP5MU70QO6,9,6,3,0,2,0,3,0,14,2.0,2,0.0,0,3,0,2,6,0,0,3,0,5,9,1
5668,150169,XWkUssXjFp3Qa0LKKWs5ZQhrpUTfMUOj,5Gyp41oLVo7Gg7vF4vpmggWP5MU70QO6,10,10,7,0,4,8,5,9,43,6.142857142857143,2,0.0,0,7,0,4,10,8,0,5,9,11,32,1
5669,150213,XcX7jntb9BOOUDGcODQiEKhoCORQSkKD,5Gyp41oLVo7Gg7vF4vpmggWP5MU70QO6,17,52,21,6,16,1,8,0,104,14.857142857142858,4,0.0,21,21,3,16,31,1,3,8,0,61,43,1
5670,150215,ZfFcPMi7CiWRckoSdTX421RgHPXLS5Fb,5Gyp41oLVo7Gg7vF4vpmggWP5MU70QO6,1,0,0,0,0,0,1,0,1,0.14285714285714285,1,0.0,0,0,0,0,0,0,0,1,0,0,1,1
5671,150225,5ku4QlS4ornNEZ2wdEoOkcf6KpaMZWez,5Gyp41oLVo7Gg7vF4vpmggWP5MU70QO6,5,2,1,0,1,0,2,0,6,0.8571428571428571,1,0.0,0,1,0,1,2,0,0,2,0,2,4,1
5672,150226,Vdzgbzphso2p85XrvyY36mZ2isT1PG4Q,5Gyp41oLVo7Gg7vF4vpmggWP5MU70QO6,1,0,0,0,0,0,1,0,1,0.14285714285714285,1,0.0,0,0,0,0,0,0,0,1,0,0,1,1
5673,150250,8loJZqV93UIB0LVEOgs0qIcfMBhyuVR4,5Gyp41oLVo7Gg7vF4vpmggWP5MU70QO6,3,0,0,0,0,6,2,0,8,1.1428571428571428,1,0.0,0,0,0,0,0,6,0,2,0,0,8,1
5674,150272,o61d02uP0OX8m0Pmj3Zu4on4UaOcYPIz,5Gyp41oLVo7Gg7vF4vpmggWP5MU70QO6,1,0,0,0,0,0,1,0,1,0.14285714285714285,1,0.0,0,0,0,0,0,0,0,1,0,0,1,1
5675,150292,2MvssppOXCyTsvOeL8Qha0XCY7xMr0VC,5Gyp41oLVo7Gg7vF4vpmggWP5MU70QO6,2,0,0,0,0,0,3,0,3,0.42857142857142855,1,0.0,0,0,0,0,0,0,0,3,0,0,3,1
5676,150318,Vnhhp2QbBiDiUTTHmXkksXuO8NCNMbjj,5Gyp41oLVo7Gg7vF4vpmggWP5MU70QO6,5,2,1,0,1,0,5,0,9,1.2857142857142858,2,0.0,0,1,0,1,2,0,0,5,0,2,7,1
5677,150328,cb7jNXqn7p6ZQ1oC4AT2clOPnv4dnr7A,5Gyp41oLVo7Gg7vF4vpmggWP5MU70QO6,1,0,0,0,0,0,1,0,1,0.14285714285714285,1,0.0,0,0,0,0,0,0,0,1,0,0,1,1
5678,150337,Zv5VeaMMbvjl8jJyhTVQ5nqNe4EbI3B0,5Gyp41oLVo7Gg7vF4vpmggWP5MU70QO6,4,0,0,0,0,0,4,1,5,0.7142857142857143,1,0.0,0,0,0,0,0,0,0,4,1,0,5,1
5679,150382,KkQ1P7pL98UFcX9bdxynk5hysiFETC0o,5Gyp41oLVo7Gg7vF4vpmggWP5MU70QO6,4,2,1,0,1,0,1,0,5,0.7142857142857143,1,0.0,0,1,0,1,2,0,0,1,0,2,3,1
5680,150383,lOEkFX2UjUz4RbKsCpQMNvAzZosP46Gx,5Gyp41oLVo7Gg7vF4vpmggWP5MU70QO6,4,2,0,0,0,0,3,0,5,0.7142857142857143,1,0.0,0,0,0,0,2,0,0,3,0,0,5,1
5681,150400,UaxJs1OVUxTunPQEqx3l4sqSKHUOSLXn,5Gyp41oLVo7Gg7vF4vpmggWP5MU70QO6,8,4,2,0,2,0,7,0,15,2.142857142857143,1,0.0,0,2,0,2,4,0,0,7,0,4,11,1
5682,150402,pDBDEaT1TkEAKx8A6rNzLrIDq6wvQxYq,5Gyp41oLVo7Gg7vF4vpmggWP5MU70QO6,25,27,18,0,7,9,9,0,70,10.0,4,0.0,2,18,0,7,25,9,0,9,0,27,43,1
5683,150413,FZEwaAUaiR6zemazrUHMMvDLCgHez3sb,5Gyp41oLVo7Gg7vF4vpmggWP5MU70QO6,1,0,0,0,0,0,2,0,2,0.2857142857142857,1,0.0,0,0,0,0,0,0,0,2,0,0,2,1
5684,150440,VILh645pfC7rghlyAmcYjXVWOqx9Ai6K,5Gyp41oLVo7Gg7vF4vpmggWP5MU70QO6,7,5,1,0,1,0,4,2,13,1.8571428571428572,4,0.0,0,1,0,1,5,0,0,4,2,2,11,1
5685,150444,FbUhEVU22eqpMzOoW1CIL4Y83nQcE2jK,5Gyp41oLVo7Gg7vF4vpmggWP5MU70QO6,6,7,2,0,1,0,2,0,12,1.7142857142857142,1,0.0,0,2,0,1,7,0,0,2,0,3,9,1
5686,150456,9bFD092MsvByWNxuJr10AnyxOuH020vI,5Gyp41oLVo7Gg7vF4vpmggWP5MU70QO6,25,26,11,56,2,1,7,1,104,14.857142857142858,2,0.0,7,11,44,2,19,1,12,7,1,64,40,1
5687,150457,giExKGHF0kvbnC4pJk3m0ErzorpAfn7y,5Gyp41oLVo7Gg7vF4vpmggWP5MU70QO6,22,37,18,12,5,2,12,8,94,13.428571428571429,3,0.0,14,18,6,5,23,2,6,12,8,43,51,1
5688,150461,CCNnpKzXeVHLfdNfS5ZIopm7zGj7TDdv,5Gyp41oLVo7Gg7vF4vpmggWP5MU70QO6,4,0,0,0,0,1,3,0,4,0.5714285714285714,1,0.0,0,0,0,0,0,1,0,3,0,0,4,1
5689,150500,5u2loU6SQHykZPE3DNYj8Ct9ALl8JuZN,5Gyp41oLVo7Gg7vF4vpmggWP5MU70QO6,6,2,1,0,1,0,4,1,9,1.2857142857142858,1,0.0,0,1,0,1,2,0,0,4,1,2,7,1
5690,150542,EQVGtOGC6NrveIndUoSckLgaBol5CW91,5Gyp41oLVo7Gg7vF4vpmggWP5MU70QO6,9,6,3,8,1,0,3,0,21,3.0,2,0.0,1,3,4,1,5,0,4,3,0,9,12,1
5691,150548,KU1Z77ni8AHRrRVsLFsNy9nUsxm1KBTF,5Gyp41oLVo7Gg7vF4vpmggWP5MU70QO6,5,2,1,0,1,0,2,0,6,0.8571428571428571,1,0.0,0,1,0,1,2,0,0,2,0,2,4,1
5692,150549,aAIVa75qVPzpOmZJw2HIa9VdDBLKFDiz,5Gyp41oLVo7Gg7vF4vpmggWP5MU70QO6,7,2,1,0,1,1,6,1,12,1.7142857142857142,2,0.0,0,1,0,1,2,1,0,6,1,2,10,1
5693,150588,Cyo1WobzoL4cOEv0dsCDxj6wLjJg2fCH,5Gyp41oLVo7Gg7vF4vpmggWP5MU70QO6,6,4,3,0,3,0,1,0,11,1.5714285714285714,1,0.0,0,3,0,3,4,0,0,1,0,6,5,1
5694,150609,N6gXZQzrkHr8bw4E0tsXv9b0W0XoVjeP,5Gyp41oLVo7Gg7vF4vpmggWP5MU70QO6,8,4,2,0,2,0,5,1,14,2.0,1,0.0,0,2,0,2,4,0,0,5,1,4,10,1
5695,150630,flCmHJf2qnOpqWD4LHvZSxE5EZr1mMwI,5Gyp41oLVo7Gg7vF4vpmggWP5MU70QO6,1,0,0,0,0,0,1,0,1,0.14285714285714285,1,0.0,0,0,0,0,0,0,0,1,0,0,1,1
5696,150699,UB3T1xdX46WHuJ9IUpYPsABhZbypMXdd,5Gyp41oLVo7Gg7vF4vpmggWP5MU70QO6,2,0,0,0,0,0,2,0,2,0.2857142857142857,1,0.0,0,0,0,0,0,0,0,2,0,0,2,1
5697,150716,hEw8FL1KT7bCC88Jn3Nko4dT9ob6cai1,5Gyp41oLVo7Gg7vF4vpmggWP5MU70QO6,9,7,1,0,1,0,5,0,14,2.0,2,0.0,0,1,0,1,7,0,0,5,0,2,12,0
5698,150719,cTB4X2bRT1xHu8we0D7DvB0Dk0LEvzWM,5Gyp41oLVo7Gg7vF4vpmggWP5MU70QO6,5,2,1,0,1,0,2,0,6,0.8571428571428571,1,0.0,0,1,0,1,2,0,0,2,0,2,4,1
5699,150741,E2Oyq6ihCiT5QQe2BJC2C3SHeqeC0PTM,5Gyp41oLVo7Gg7vF4vpmggWP5MU70QO6,4,0,0,0,0,0,4,0,4,0.5714285714285714,1,0.0,0,0,0,0,0,0,0,4,0,0,4,1
5700,150766,LbvWqiv4pS7aRXIXyFn0o9xR8kGvWO8j,5Gyp41oLVo7Gg7vF4vpmggWP5MU70QO6,7,3,2,0,2,0,2,0,9,1.2857142857142858,1,0.0,0,2,0,2,3,0,0,2,0,4,5,0
5701,150772,2p7BWGCBsWr2G3F8TRtrYfQBak778298,5Gyp41oLVo7Gg7vF4vpmggWP5MU70QO6,1,0,0,0,0,0,1,0,1,0.14285714285714285,1,0.0,0,0,0,0,0,0,0,1,0,0,1,1
5702,150797,xcTs8E0JdUV5Fa3zmLqi0jCmZBwpcQNb,5Gyp41oLVo7Gg7vF4vpmggWP5MU70QO6,1,0,0,0,0,0,1,0,1,0.14285714285714285,1,0.0,0,0,0,0,0,0,0,1,0,0,1,1
5703,150798,6Fzv6BHa892WsSiThSmgkOpA8ZIRBlsi,5Gyp41oLVo7Gg7vF4vpmggWP5MU70QO6,1,0,0,0,0,0,1,0,1,0.14285714285714285,1,0.0,0,0,0,0,0,0,0,1,0,0,1,1
5704,150810,rimZAbDroN4JHLy1FnUyyHIXythkaSlF,5Gyp41oLVo7Gg7vF4vpmggWP5MU70QO6,1,0,0,0,0,0,1,0,1,0.14285714285714285,1,0.0,0,0,0,0,0,0,0,1,0,0,1,1
5705,150820,aWpML43pNRTlN0bl6CyYnFSUHuMwTloH,5Gyp41oLVo7Gg7vF4vpmggWP5MU70QO6,8,5,2,0,2,0,4,0,13,1.8571428571428572,2,0.0,0,2,0,2,5,0,0,4,0,4,9,1
5706,150824,TvbOZN90Rb22qxeutrBmoxAH9AkWYGE0,5Gyp41oLVo7Gg7vF4vpmggWP5MU70QO6,8,3,1,0,1,1,5,1,12,1.7142857142857142,1,0.0,0,1,0,1,3,1,0,5,1,2,10,1
5707,150883,TDlQaHz2Iiso6vxYQwqnZwIeJCgOzjvG,5Gyp41oLVo7Gg7vF4vpmggWP5MU70QO6,8,7,2,10,0,0,2,0,21,3.0,1,0.0,3,2,5,0,4,0,5,2,0,10,11,1
5708,150920,iWEmpult7cdvgdjFW97TkROBvpRLqQNG,5Gyp41oLVo7Gg7vF4vpmggWP5MU70QO6,10,5,4,0,2,4,7,0,22,3.142857142857143,2,0.0,0,4,0,2,5,4,0,7,0,6,16,1
5709,150924,z0iuBBXe6NAwnTD1TjbGOHoZJjubB4QY,5Gyp41oLVo7Gg7vF4vpmggWP5MU70QO6,7,6,4,0,1,0,3,0,14,2.0,1,0.0,0,4,0,1,6,0,0,3,0,5,9,1
5710,150929,VtEfFHwCwR0CG3OZFyRUkRQlzB85HLcu,5Gyp41oLVo7Gg7vF4vpmggWP5MU70QO6,12,8,5,2,3,0,4,0,22,3.142857142857143,1,0.0,1,5,1,3,7,0,1,4,0,10,12,1
5711,150946,uakEazVAgtWyDmSE47vyFHnNC6Qf3U0X,5Gyp41oLVo7Gg7vF4vpmggWP5MU70QO6,2,0,0,0,0,0,2,0,2,0.2857142857142857,1,0.0,0,0,0,0,0,0,0,2,0,0,2,1
5712,150962,2opiscyEIUMZmPKePynNJqybmsfM3G0C,5Gyp41oLVo7Gg7vF4vpmggWP5MU70QO6,1,0,0,0,0,0,1,0,1,0.14285714285714285,1,0.0,0,0,0,0,0,0,0,1,0,0,1,1
5713,150977,xLGTIbdl9NaTSL16miIAzql2qWGFIhiP,5Gyp41oLVo7Gg7vF4vpmggWP5MU70QO6,7,4,3,0,2,0,3,0,12,1.7142857142857142,2,0.0,0,3,0,2,4,0,0,3,0,5,7,1
5714,150990,qgASLWQyU9k2ZqOsvlCG3fRTd4MLx6um,5Gyp41oLVo7Gg7vF4vpmggWP5MU70QO6,5,2,1,0,1,0,2,0,6,0.8571428571428571,1,0.0,0,1,0,1,2,0,0,2,0,2,4,1
5715,150991,zt8D4cN45BQ8WOokF7iya4FQJ1n05JY2,5Gyp41oLVo7Gg7vF4vpmggWP5MU70QO6,1,0,0,0,0,0,2,0,2,0.2857142857142857,1,0.0,0,0,0,0,0,0,0,2,0,0,2,0
5716,151002,MBVAkaXCYILTL9RsvJRxHQ8HQtjIMFqR,5Gyp41oLVo7Gg7vF4vpmggWP5MU70QO6,12,9,4,0,3,2,4,3,25,3.5714285714285716,1,0.0,3,4,0,3,6,2,0,4,3,10,15,1
5717,151032,Cgo3i5wPjnPlIDXy5ZtlFAfb9EGIh6Ho,5Gyp41oLVo7Gg7vF4vpmggWP5MU70QO6,10,19,7,4,2,0,7,0,39,5.571428571428571,2,0.0,2,7,2,2,17,0,2,7,0,13,26,1
5718,151104,Cahe3svEUsAtvhU4j36EhbbwAZFF7PRw,5Gyp41oLVo7Gg7vF4vpmggWP5MU70QO6,1,0,0,0,0,0,1,0,1,0.14285714285714285,1,0.0,0,0,0,0,0,0,0,1,0,0,1,1
5719,151116,IRKD6QQqE5UsB7CGCGf1VbjHjgbIZ5ik,5Gyp41oLVo7Gg7vF4vpmggWP5MU70QO6,12,9,8,0,4,0,1,0,22,3.142857142857143,1,0.0,0,8,0,4,9,0,0,1,0,12,10,1
5720,151117,OGSx3QXbJb2YyeaMiQfX8Io7pXUD2AtB,5Gyp41oLVo7Gg7vF4vpmggWP5MU70QO6,3,0,0,0,0,0,2,1,3,0.42857142857142855,1,0.0,0,0,0,0,0,0,0,2,1,0,3,1
5721,151123,PRurM3JVE5CgyeeLqPfYEy4me00WTdzZ,5Gyp41oLVo7Gg7vF4vpmggWP5MU70QO6,2,0,0,0,0,0,5,0,5,0.7142857142857143,1,0.0,0,0,0,0,0,0,0,5,0,0,5,1
5722,151157,ppIjeIXeEOowZa4er1vFyLGyuckaeG1L,5Gyp41oLVo7Gg7vF4vpmggWP5MU70QO6,1,0,0,0,0,0,2,0,2,0.2857142857142857,1,0.0,0,0,0,0,0,0,0,2,0,0,2,1
5723,151211,ZMqcGNZ6hflvNiblPBWALOYjNJzfGsw9,5Gyp41oLVo7Gg7vF4vpmggWP5MU70QO6,10,6,4,0,3,0,6,1,20,2.857142857142857,1,0.0,0,4,0,3,6,0,0,6,1,7,13,1
5724,151219,OCvBDvGVZRaHWTizVfivm6XtBJbQUiAu,5Gyp41oLVo7Gg7vF4vpmggWP5MU70QO6,12,14,7,7,4,0,7,0,39,5.571428571428571,3,0.0,2,7,4,4,12,0,3,7,0,17,22,1
5725,151259,zYGWXWLcT41N9I9BOKqVpDhJ5WG0y41g,5Gyp41oLVo7Gg7vF4vpmggWP5MU70QO6,20,13,12,0,10,1,3,1,40,5.714285714285714,1,0.0,0,12,0,10,13,1,0,3,1,22,18,1
5726,151301,nyRjmMZBGrtgSgXab1LYEUfPApgIXNxT,5Gyp41oLVo7Gg7vF4vpmggWP5MU70QO6,8,9,5,0,1,0,4,1,20,2.857142857142857,1,0.0,1,5,0,1,8,0,0,4,1,7,13,1
5727,151313,ztPOXhNtl56G3t97cXRwCL5RI1J4OFD7,5Gyp41oLVo7Gg7vF4vpmggWP5MU70QO6,1,0,0,0,0,0,2,0,2,0.2857142857142857,1,0.0,0,0,0,0,0,0,0,2,0,0,2,1
5728,151329,CQQcy0Bo0ukva0QKFtZhYCLjSZESjyrA,5Gyp41oLVo7Gg7vF4vpmggWP5MU70QO6,7,3,2,0,2,0,2,0,9,1.2857142857142858,1,0.0,0,2,0,2,3,0,0,2,0,4,5,1
5729,151335,GmmVywER1JF6omawNroxy8entDJKS1q8,5Gyp41oLVo7Gg7vF4vpmggWP5MU70QO6,10,8,5,0,2,2,4,1,22,3.142857142857143,1,0.0,2,5,0,2,6,2,0,4,1,9,13,1
5730,151370,m3riDkeaP3qLddM2Qy9128A1o8BoTU63,5Gyp41oLVo7Gg7vF4vpmggWP5MU70QO6,8,4,3,0,2,0,2,0,11,1.5714285714285714,1,0.0,0,3,0,2,4,0,0,2,0,5,6,1
5731,151381,pCJ601RaucAyYeKAjB6Wx4CXJkI6lR1v,5Gyp41oLVo7Gg7vF4vpmggWP5MU70QO6,1,0,0,0,0,0,1,0,1,0.14285714285714285,1,0.0,0,0,0,0,0,0,0,1,0,0,1,1
5732,151395,vriOkwsWVqJfzxJ8W7a8LLBlyXQZ3fG0,5Gyp41oLVo7Gg7vF4vpmggWP5MU70QO6,11,4,3,0,2,1,8,1,19,2.7142857142857144,1,0.0,0,3,0,2,4,1,0,8,1,5,14,1
5733,151444,XqxXHlwlYxd9RSTeUV9pBamG1DPgHOIg,5Gyp41oLVo7Gg7vF4vpmggWP5MU70QO6,1,0,0,0,0,0,1,0,1,0.14285714285714285,1,0.0,0,0,0,0,0,0,0,1,0,0,1,1
5734,151452,i2zvUf1J8DQ4RkSXNyPilWOV1qg13nU6,5Gyp41oLVo7Gg7vF4vpmggWP5MU70QO6,8,2,1,0,1,2,6,1,13,1.8571428571428572,1,0.0,0,1,0,1,2,2,0,6,1,2,11,1
5735,151474,e1obZM1bAHvfZHkoYcbAKIAxfJj6crMT,5Gyp41oLVo7Gg7vF4vpmggWP5MU70QO6,6,2,1,0,1,0,5,0,9,1.2857142857142858,1,0.0,0,1,0,1,2,0,0,5,0,2,7,1
5736,151497,skJn7dtfSekFrPHRHs9swZ9AtSUKi36u,5Gyp41oLVo7Gg7vF4vpmggWP5MU70QO6,1,0,0,0,0,0,1,0,1,0.14285714285714285,1,0.0,0,0,0,0,0,0,0,1,0,0,1,1
5737,151512,pyjnq4Vgp0Ue1K5a6sybK0KOMHIfkFg2,5Gyp41oLVo7Gg7vF4vpmggWP5MU70QO6,7,3,2,0,2,0,2,0,9,1.2857142857142858,2,0.0,0,2,0,2,3,0,0,2,0,4,5,1
5738,151555,qQRLEcAlg6T9U8qnTd9lkM0YuBTWzAFC,5Gyp41oLVo7Gg7vF4vpmggWP5MU70QO6,7,6,5,0,0,0,2,0,13,1.8571428571428572,1,0.0,0,5,0,0,6,0,0,2,0,5,8,1
5739,151561,8TlP9GD3t3ZkBfQqFdUNcmi2jEbrR8GT,5Gyp41oLVo7Gg7vF4vpmggWP5MU70QO6,10,7,5,0,4,0,6,0,22,3.142857142857143,2,0.0,0,5,0,4,7,0,0,6,0,9,13,1
5740,151574,gMepcFQRTN7lgKSmtSrn4XIeT7QqyXcl,5Gyp41oLVo7Gg7vF4vpmggWP5MU70QO6,10,7,3,0,2,3,7,0,22,3.142857142857143,2,0.0,3,3,0,2,4,3,0,7,0,8,14,1
5741,151603,vfamyv38RKSLNIrvpxjE1CUmutx8EQhb,5Gyp41oLVo7Gg7vF4vpmggWP5MU70QO6,7,3,2,0,2,0,2,0,9,1.2857142857142858,1,0.0,0,2,0,2,3,0,0,2,0,4,5,1
5742,151614,QeowjJjTtxojAhNbnbzRAgIFHoftB0wb,5Gyp41oLVo7Gg7vF4vpmggWP5MU70QO6,27,34,1,0,27,0,2,0,64,9.142857142857142,1,0.0,16,1,0,27,18,0,0,2,0,44,20,1
5743,151624,zIHhHIwIbH6mJbe3ZAvW2ovaPewaq0E0,5Gyp41oLVo7Gg7vF4vpmggWP5MU70QO6,37,82,35,0,20,2,10,1,150,21.428571428571427,3,0.0,15,35,0,20,67,2,0,10,1,70,80,1
5744,151645,BGqQxatBbJGg1InFei2J6ukObltYiaee,5Gyp41oLVo7Gg7vF4vpmggWP5MU70QO6,1,0,0,0,0,0,1,0,1,0.14285714285714285,1,0.0,0,0,0,0,0,0,0,1,0,0,1,1
5745,151650,0jwIHraHXkLHayCuy1koBhJBBpRul7ls,5Gyp41oLVo7Gg7vF4vpmggWP5MU70QO6,8,12,3,0,3,0,3,0,21,3.0,2,0.0,0,3,0,3,12,0,0,3,0,6,15,1
5746,151673,5GSOIk40DiaxFLDGO9CmF3s4EHBoQKBL,5Gyp41oLVo7Gg7vF4vpmggWP5MU70QO6,7,4,2,0,2,0,2,0,10,1.4285714285714286,1,0.0,0,2,0,2,4,0,0,2,0,4,6,1
5747,151677,AE2tdbLbxS64wcOz5nwhZPxxpeFVRBm8,5Gyp41oLVo7Gg7vF4vpmggWP5MU70QO6,6,3,2,0,2,0,2,0,9,1.2857142857142858,2,0.0,0,2,0,2,3,0,0,2,0,4,5,1
5748,151702,XVusSBM1iN4EPU3OTN6DbNp5XkkHOSNw,5Gyp41oLVo7Gg7vF4vpmggWP5MU70QO6,8,6,2,6,1,0,4,0,19,2.7142857142857144,1,0.0,3,2,3,1,3,0,3,4,0,9,10,1
5749,151705,7SuBh5oLILOH91rGG7eNhiJeOIevyQ8x,5Gyp41oLVo7Gg7vF4vpmggWP5MU70QO6,8,8,4,0,2,0,5,0,19,2.7142857142857144,1,0.0,0,4,0,2,8,0,0,5,0,6,13,1
5750,151737,Gcq3zQq7nrW11GPHgteepGdAD3QWdcjQ,5Gyp41oLVo7Gg7vF4vpmggWP5MU70QO6,6,3,2,0,2,0,2,0,9,1.2857142857142858,1,0.0,0,2,0,2,3,0,0,2,0,4,5,1
5751,151741,txSjWYX3TEWx5QLOiaADcbFdCZMHt7yE,5Gyp41oLVo7Gg7vF4vpmggWP5MU70QO6,9,5,3,0,2,0,4,0,14,2.0,1,0.0,0,3,0,2,5,0,0,4,0,5,9,1
5752,151745,BJXfeE05oCoqfG6dfkL7NvI6ach99v6o,5Gyp41oLVo7Gg7vF4vpmggWP5MU70QO6,11,16,8,0,8,0,7,0,39,5.571428571428571,3,0.0,4,8,0,8,12,0,0,7,0,20,19,1
5753,151770,dFw00KiVLqF6ijTvDd8ZTWBC93HPidxG,5Gyp41oLVo7Gg7vF4vpmggWP5MU70QO6,11,8,6,0,2,0,4,0,20,2.857142857142857,1,0.0,0,6,0,2,8,0,0,4,0,8,12,1
5754,151786,0nqj6iIWmYxLKHezCs5xwlB8hzJ9Rg2d,5Gyp41oLVo7Gg7vF4vpmggWP5MU70QO6,3,6,2,0,0,0,1,0,9,1.2857142857142858,2,0.0,0,2,0,0,6,0,0,1,0,2,7,1
5755,151799,GSkYUOcl4XzYMWSWhE6gXRGQ9kqPeXsi,5Gyp41oLVo7Gg7vF4vpmggWP5MU70QO6,7,5,3,0,3,0,3,0,14,2.0,2,0.0,0,3,0,3,5,0,0,3,0,6,8,1
5756,151802,XDivE5MTW4h2lu5IAUqNO8tyEE7Yd12k,5Gyp41oLVo7Gg7vF4vpmggWP5MU70QO6,1,0,0,0,0,0,1,0,1,0.14285714285714285,1,0.0,0,0,0,0,0,0,0,1,0,0,1,1
5757,151839,WS3JHNCirmqyl3FCjFTJGtt7sm7sHXD1,5Gyp41oLVo7Gg7vF4vpmggWP5MU70QO6,1,0,0,0,0,0,1,0,1,0.14285714285714285,1,0.0,0,0,0,0,0,0,0,1,0,0,1,1
5758,151848,c59bqAm33HlD1IRUizkYpbuOmhSlZKxz,5Gyp41oLVo7Gg7vF4vpmggWP5MU70QO6,18,29,14,20,6,0,3,0,72,10.285714285714286,3,0.0,10,14,12,6,19,0,8,3,0,42,30,0
5759,151851,oWiCn9WB0Vf7GiIarokSY3ZAcyaFBYwe,5Gyp41oLVo7Gg7vF4vpmggWP5MU70QO6,8,7,2,0,3,0,2,0,14,2.0,1,0.0,1,2,0,3,6,0,0,2,0,6,8,1
5760,151909,A6Hs6FgdHHIEd93aaJeyuHd0DKLVp4TC,5Gyp41oLVo7Gg7vF4vpmggWP5MU70QO6,1,0,0,0,0,0,1,0,1,0.14285714285714285,1,0.0,0,0,0,0,0,0,0,1,0,0,1,1
5761,151918,oTRd7t0ldKB6LIoIZRzWKZS6aziZbQCm,5Gyp41oLVo7Gg7vF4vpmggWP5MU70QO6,5,1,1,0,0,0,3,0,5,0.7142857142857143,1,0.0,0,1,0,0,1,0,0,3,0,1,4,1
5762,151933,aiiEmLNQSiolhZl1TXNarodE8iRQ1uLE,5Gyp41oLVo7Gg7vF4vpmggWP5MU70QO6,9,18,6,8,6,1,2,0,41,5.857142857142857,2,0.0,4,6,5,6,14,1,3,2,0,21,20,1
5763,151936,mdbXSl3hCFCVMuDJ0iaG5R41jsALVGcQ,5Gyp41oLVo7Gg7vF4vpmggWP5MU70QO6,1,0,0,0,0,0,1,0,1,0.14285714285714285,1,0.0,0,0,0,0,0,0,0,1,0,0,1,1
5764,151938,vfxTkrGlbFfxC6BbsVcu0C1Uj2f3Pj72,5Gyp41oLVo7Gg7vF4vpmggWP5MU70QO6,9,9,4,0,5,0,7,0,25,3.5714285714285716,1,0.0,2,4,0,5,7,0,0,7,0,11,14,1
5765,151940,znxZnyXtm1pjamqHGbXAqp2Ed6fvtKuD,5Gyp41oLVo7Gg7vF4vpmggWP5MU70QO6,1,0,0,0,0,0,1,0,1,0.14285714285714285,1,0.0,0,0,0,0,0,0,0,1,0,0,1,1
5766,151966,9jMHJUpmGoib0Ra2B7XTqz1ENGVtyEfI,5Gyp41oLVo7Gg7vF4vpmggWP5MU70QO6,7,9,4,0,1,0,1,0,15,2.142857142857143,1,0.0,4,4,0,1,5,0,0,1,0,9,6,1
5767,152027,uHRQj2YwOI5LAsC864CB2Tbx3zimAMyg,5Gyp41oLVo7Gg7vF4vpmggWP5MU70QO6,8,24,9,0,0,10,2,0,45,6.428571428571429,1,0.0,8,9,0,0,16,10,0,2,0,17,28,1
5768,152058,hpKSHIi4bRo1DEIvbfvzcRke2iP1vwgF,5Gyp41oLVo7Gg7vF4vpmggWP5MU70QO6,6,1,1,0,1,0,3,0,6,0.8571428571428571,1,0.0,0,1,0,1,1,0,0,3,0,2,4,1
5769,152070,IYltlIa655Ul4wh63KcHA7YpTNQSMVLE,5Gyp41oLVo7Gg7vF4vpmggWP5MU70QO6,10,20,8,0,7,0,4,0,39,5.571428571428571,1,0.0,9,8,0,7,11,0,0,4,0,24,15,1
5770,152076,F3kU8xdNifwVhzzpDIJtdulyqML1znNn,5Gyp41oLVo7Gg7vF4vpmggWP5MU70QO6,8,6,3,0,2,0,3,0,14,2.0,1,0.0,0,3,0,2,6,0,0,3,0,5,9,1
5771,152114,6Bz2zeEUATpI58ZQRDX1hHy6J89t4dQK,5Gyp41oLVo7Gg7vF4vpmggWP5MU70QO6,6,3,1,0,2,0,1,0,7,1.0,1,0.0,0,1,0,2,3,0,0,1,0,3,4,1
5772,152133,xZnb7uXmxIWQ7sisovgxwTXG7X7Be4Tl,5Gyp41oLVo7Gg7vF4vpmggWP5MU70QO6,1,0,0,0,0,0,1,0,1,0.14285714285714285,1,0.0,0,0,0,0,0,0,0,1,0,0,1,1
5773,152134,Nc3ZZeizgzMQ7ljgRcfUdDiH0EOAXMpI,5Gyp41oLVo7Gg7vF4vpmggWP5MU70QO6,11,5,3,7,2,0,3,0,20,2.857142857142857,1,0.0,1,3,5,2,4,0,2,3,0,11,9,1
5774,152155,HbR6yZSevBZ4UKfkvdM9rmYn4kVz8brA,5Gyp41oLVo7Gg7vF4vpmggWP5MU70QO6,6,7,4,0,0,0,5,0,16,2.2857142857142856,1,0.0,0,4,0,0,7,0,0,5,0,4,12,1
5775,152163,syOsxSZOACgbnBxkt1yNu9uBPLJQFluD,5Gyp41oLVo7Gg7vF4vpmggWP5MU70QO6,1,0,0,0,0,0,1,0,1,0.14285714285714285,1,0.0,0,0,0,0,0,0,0,1,0,0,1,1
5776,152169,Er5duxYmvCidXsitQ5JrRU2NhqugWM9n,5Gyp41oLVo7Gg7vF4vpmggWP5MU70QO6,6,6,3,0,0,0,2,0,11,1.5714285714285714,1,0.0,1,3,0,0,5,0,0,2,0,4,7,1
5777,152247,1a9ONolNdHfPzIvOLc3Ed7iRRpnKvMt7,5Gyp41oLVo7Gg7vF4vpmggWP5MU70QO6,10,5,4,0,3,0,5,2,19,2.7142857142857144,1,0.0,1,4,0,3,4,0,0,5,2,8,11,1
5778,152253,NQaRkMwNJWFXhN2DoUJm3UnH8xIwYVaH,5Gyp41oLVo7Gg7vF4vpmggWP5MU70QO6,8,10,2,0,3,0,3,0,18,2.5714285714285716,1,0.0,3,2,0,3,7,0,0,3,0,8,10,1
5779,152258,guhTAC2wGHeGVbnCgc8qjrM4m2j0yBgB,5Gyp41oLVo7Gg7vF4vpmggWP5MU70QO6,2,0,0,0,0,0,2,0,2,0.2857142857142857,1,0.0,0,0,0,0,0,0,0,2,0,0,2,1
5780,152261,5ZHcPycX71kTiy1OkbQ8m2LgrpLSnwdX,5Gyp41oLVo7Gg7vF4vpmggWP5MU70QO6,5,2,1,0,1,0,2,0,6,0.8571428571428571,1,0.0,0,1,0,1,2,0,0,2,0,2,4,1
5781,152270,OryrsMazzodnSHJ9vOTAfmrHnnogyu54,5Gyp41oLVo7Gg7vF4vpmggWP5MU70QO6,1,0,0,0,0,0,1,0,1,0.14285714285714285,1,0.0,0,0,0,0,0,0,0,1,0,0,1,1
5782,152290,La9OQauy1UvIOhhQdOQTkNOwvHK4jV3P,5Gyp41oLVo7Gg7vF4vpmggWP5MU70QO6,6,1,0,0,1,0,5,0,7,1.0,1,0.0,0,0,0,1,1,0,0,5,0,1,6,1
5783,152318,CwJlacazjIgIAUmauxBsaXoD9dcHccYO,5Gyp41oLVo7Gg7vF4vpmggWP5MU70QO6,14,19,7,24,4,2,10,0,66,9.428571428571429,1,0.0,10,7,14,4,9,2,10,10,0,35,31,1
5784,152323,9Vi5veC33YSf2pxAVQxxr05mLKSB17N2,5Gyp41oLVo7Gg7vF4vpmggWP5MU70QO6,10,12,6,4,6,0,2,0,30,4.285714285714286,1,0.0,5,6,2,6,7,0,2,2,0,19,11,1
5785,152346,DJbioQ5SfDLmvjZBFcvRe6hHQMvGv4XM,5Gyp41oLVo7Gg7vF4vpmggWP5MU70QO6,19,14,7,25,2,0,5,0,53,7.571428571428571,2,0.0,4,7,21,2,10,0,4,5,0,34,19,1
5786,152373,uQ8RFZZxkrASTM8MRJxF8TGJLfCzH2Qo,5Gyp41oLVo7Gg7vF4vpmggWP5MU70QO6,13,11,6,24,1,0,2,0,44,6.285714285714286,1,0.0,3,6,17,1,8,0,7,2,0,27,17,0
5787,152382,z6mKqvs4i5mBYDccEiyPrpSR9giHEwNf,5Gyp41oLVo7Gg7vF4vpmggWP5MU70QO6,1,0,0,0,0,0,1,0,1,0.14285714285714285,1,0.0,0,0,0,0,0,0,0,1,0,0,1,1
5788,152394,nKyehpqCzFKe7AQ0H2jeEWUcUDLPIpGO,5Gyp41oLVo7Gg7vF4vpmggWP5MU70QO6,7,4,3,0,3,0,2,0,12,1.7142857142857142,1,0.0,0,3,0,3,4,0,0,2,0,6,6,1
5789,152400,ODT1AC3wa6ys7gxuLnHmS8BkFzaQrA9t,5Gyp41oLVo7Gg7vF4vpmggWP5MU70QO6,7,4,2,0,1,0,3,0,10,1.4285714285714286,1,0.0,0,2,0,1,4,0,0,3,0,3,7,1
5790,152406,nmzQqvd0h7JcyHIrVLdmRJ7QIayUcwIs,5Gyp41oLVo7Gg7vF4vpmggWP5MU70QO6,10,4,3,0,3,0,3,0,13,1.8571428571428572,1,0.0,1,3,0,3,3,0,0,3,0,7,6,1
5791,152424,uW1QxDE1Emo9PgDLqa7HDYgVFWbLLrwd,5Gyp41oLVo7Gg7vF4vpmggWP5MU70QO6,4,2,1,0,1,0,2,0,6,0.8571428571428571,1,0.0,0,1,0,1,2,0,0,2,0,2,4,1
5792,152426,SdxEuBLh8sNfmF8jUHIs4F2rJk51GkSG,5Gyp41oLVo7Gg7vF4vpmggWP5MU70QO6,5,2,1,0,1,0,3,0,7,1.0,1,0.0,0,1,0,1,2,0,0,3,0,2,5,1
5793,152442,fRUiNuT9vqr8LocDhCAsx8sUOBNWvuDu,5Gyp41oLVo7Gg7vF4vpmggWP5MU70QO6,10,5,4,3,2,0,3,0,17,2.4285714285714284,1,0.0,1,4,2,2,4,0,1,3,0,9,8,1
5794,152450,98Xmwep7rMoNdRjjxMw7R5Q1iLZQOljL,5Gyp41oLVo7Gg7vF4vpmggWP5MU70QO6,10,9,5,0,5,0,4,0,23,3.2857142857142856,1,0.0,0,5,0,5,9,0,0,4,0,10,13,1
5795,152462,q5Mh1DiRxqFPerzFhySJn3OvdiZ2Qdjc,5Gyp41oLVo7Gg7vF4vpmggWP5MU70QO6,10,3,2,0,2,3,7,1,18,2.5714285714285716,2,0.0,0,2,0,2,3,3,0,7,1,4,14,1
5796,152465,8ngiQOsuSsE6kh3Xd6QPTnftoLXvq8kg,5Gyp41oLVo7Gg7vF4vpmggWP5MU70QO6,5,2,0,0,0,1,4,0,7,1.0,1,0.0,0,0,0,0,2,1,0,4,0,0,7,1
5797,152474,sNuvw1spatTiOI6DpTHKFQgkJLxj3SJB,5Gyp41oLVo7Gg7vF4vpmggWP5MU70QO6,8,6,4,0,3,5,3,0,21,3.0,1,0.0,0,4,0,3,6,5,0,3,0,7,14,1
5798,152483,HfDg6ZshQIIsqHP26E57zcevXCtObxuT,5Gyp41oLVo7Gg7vF4vpmggWP5MU70QO6,17,16,8,8,6,0,3,0,41,5.857142857142857,2,0.0,5,8,7,6,11,0,1,3,0,26,15,1
5799,152505,jDRAci5S9OVs0Bpi7WzecuNlYqhyG3Bh,5Gyp41oLVo7Gg7vF4vpmggWP5MU70QO6,4,2,1,0,1,1,1,0,6,0.8571428571428571,1,0.0,0,1,0,1,2,1,0,1,0,2,4,1
5800,152507,ikK35mgDGK5ja784wwliOZjgmMMhehV6,5Gyp41oLVo7Gg7vF4vpmggWP5MU70QO6,4,2,1,0,0,0,4,0,7,1.0,1,0.0,0,1,0,0,2,0,0,4,0,1,6,1
5801,152512,4aRIMbnJ1MTzkvhZECvseAcRbjetlYDH,5Gyp41oLVo7Gg7vF4vpmggWP5MU70QO6,14,20,10,0,6,4,18,2,60,8.571428571428571,1,0.0,4,10,0,6,16,4,0,18,2,20,40,1
5802,152533,TTAUaNpDZti7U0Kjn6qpJlzxCyZQx90l,5Gyp41oLVo7Gg7vF4vpmggWP5MU70QO6,1,0,0,0,0,0,1,0,1,0.14285714285714285,1,0.0,0,0,0,0,0,0,0,1,0,0,1,1
5803,152543,2EottGYE4ATYAfZTb7e9UBk04hnSGKC0,5Gyp41oLVo7Gg7vF4vpmggWP5MU70QO6,6,5,3,0,1,0,3,0,12,1.7142857142857142,1,0.0,0,3,0,1,5,0,0,3,0,4,8,1
5804,152561,rl0RdWbqEf676uDYZiC3mM5uJRCHF96R,5Gyp41oLVo7Gg7vF4vpmggWP5MU70QO6,4,5,4,0,4,0,2,0,15,2.142857142857143,4,0.0,0,4,0,4,5,0,0,2,0,8,7,0
5805,152574,INDzJmJAfnF9QC3J8iKsduqg5ZM7irgR,5Gyp41oLVo7Gg7vF4vpmggWP5MU70QO6,7,4,1,0,2,0,2,0,9,1.2857142857142858,1,0.0,0,1,0,2,4,0,0,2,0,3,6,1
5806,152620,a0DcOGLeLwsJrHdEijar1MaQPhCwfyFX,5Gyp41oLVo7Gg7vF4vpmggWP5MU70QO6,1,0,0,0,0,0,1,0,1,0.14285714285714285,1,0.0,0,0,0,0,0,0,0,1,0,0,1,1
5807,152627,bnW1DbN8HNsOfIMBlKslbLJxB4iy78sI,5Gyp41oLVo7Gg7vF4vpmggWP5MU70QO6,6,3,2,0,2,0,1,0,8,1.1428571428571428,1,0.0,0,2,0,2,3,0,0,1,0,4,4,1
5808,152634,cX7YBuX9CV7Gubtjtl9QcNLmo4OXvb3w,5Gyp41oLVo7Gg7vF4vpmggWP5MU70QO6,7,8,4,0,2,0,6,0,20,2.857142857142857,3,0.0,0,4,0,2,8,0,0,6,0,6,14,1
5809,152666,wVIlQjqMwCv7ElIiAFUCVThdNvZtGDDY,5Gyp41oLVo7Gg7vF4vpmggWP5MU70QO6,4,2,1,0,1,0,1,0,5,0.7142857142857143,1,0.0,0,1,0,1,2,0,0,1,0,2,3,1
5810,152679,yieHWJtKxAlre6lcLGlFmy8nVvAvYHNq,5Gyp41oLVo7Gg7vF4vpmggWP5MU70QO6,7,8,4,0,0,0,4,0,16,2.2857142857142856,1,0.0,1,4,0,0,7,0,0,4,0,5,11,1
5811,152690,GIcv0cCXnFkrCBMZ2gyZyitp5Csvo5Ak,5Gyp41oLVo7Gg7vF4vpmggWP5MU70QO6,9,4,2,0,1,2,7,1,17,2.4285714285714284,1,0.0,0,2,0,1,4,2,0,7,1,3,14,1
5812,152741,x29OOChdmJGXK62DnUpwKbwJurqULmnD,5Gyp41oLVo7Gg7vF4vpmggWP5MU70QO6,4,2,1,0,1,0,2,0,6,0.8571428571428571,1,0.0,0,1,0,1,2,0,0,2,0,2,4,1
5813,152747,LgJ5ZhF5tQkktd8PpEfF1ErKOOnQRsGH,5Gyp41oLVo7Gg7vF4vpmggWP5MU70QO6,7,3,2,0,2,0,2,0,9,1.2857142857142858,1,0.0,0,2,0,2,3,0,0,2,0,4,5,1
5814,152766,ooIWsP0fEF17mEtGXwAlb2bCuQl5BzHu,5Gyp41oLVo7Gg7vF4vpmggWP5MU70QO6,6,2,2,0,0,0,3,0,7,1.0,1,0.0,0,2,0,0,2,0,0,3,0,2,5,1
5815,152797,eHvQ2U78p4YZsMgDMMDOOzYAdsqzih5K,5Gyp41oLVo7Gg7vF4vpmggWP5MU70QO6,5,5,2,0,2,0,1,0,10,1.4285714285714286,1,0.0,2,2,0,2,3,0,0,1,0,6,4,1
5816,152839,myUAFxvFHyWAiYmHYoqBgQ9oSGcqfz50,5Gyp41oLVo7Gg7vF4vpmggWP5MU70QO6,1,0,0,0,0,0,1,0,1,0.14285714285714285,1,0.0,0,0,0,0,0,0,0,1,0,0,1,1
5817,152880,8Hm415bdFcwpFDq3GCBcLB32eZ08pGv6,5X6FeZozNMgE2VRi3MJYjkkFK8SETtu2,8,3,2,0,2,0,3,0,10,1.4285714285714286,1,0.0,0,2,0,2,3,0,0,3,0,4,6,1
5818,152895,U28zDecdJpM6GHGKP6A5ulmz5rhbfnrO,5X6FeZozNMgE2VRi3MJYjkkFK8SETtu2,8,8,4,0,0,0,2,0,14,2.0,1,0.0,0,4,0,0,8,0,0,2,0,4,10,1
5819,152905,vJkzpyJ0SKHdsZjXqrrJXheB0apoeMZe,5X6FeZozNMgE2VRi3MJYjkkFK8SETtu2,5,2,1,0,1,0,2,0,6,0.8571428571428571,1,0.0,0,1,0,1,2,0,0,2,0,2,4,1
5820,152928,pDrKPdaXWYW4w4iXEP1j5gnJPxx2TpIU,5X6FeZozNMgE2VRi3MJYjkkFK8SETtu2,1,0,0,0,0,0,1,0,1,0.14285714285714285,1,0.0,0,0,0,0,0,0,0,1,0,0,1,1
5821,152947,8CRgXCsGfpR9dPh02oBh23kfAkqyw4RQ,5X6FeZozNMgE2VRi3MJYjkkFK8SETtu2,2,0,0,0,0,0,2,0,2,0.2857142857142857,1,0.0,0,0,0,0,0,0,0,2,0,0,2,1
5822,153028,Z5LlhMEzK5ZFl6PY51s2Mt2xA8hbOdg8,5X6FeZozNMgE2VRi3MJYjkkFK8SETtu2,10,35,3,3,3,0,8,0,52,7.428571428571429,4,0.0,3,3,3,3,32,0,0,8,0,12,40,1
5823,153032,SunVurSWT2ON8oDyf5iEIbV6p9uzItF1,5X6FeZozNMgE2VRi3MJYjkkFK8SETtu2,4,2,0,0,0,0,3,0,5,0.7142857142857143,1,0.0,0,0,0,0,2,0,0,3,0,0,5,1
5824,153059,A2QvZbkv82OL2jQwgDFpwg2Cui3PLWb0,5X6FeZozNMgE2VRi3MJYjkkFK8SETtu2,8,12,2,0,5,0,3,0,22,3.142857142857143,1,0.0,6,2,0,5,6,0,0,3,0,13,9,0
5825,153100,b1z9qcijCspwmiMthrB1U99sapgpXD16,5X6FeZozNMgE2VRi3MJYjkkFK8SETtu2,9,8,2,0,4,0,2,0,16,2.2857142857142856,1,0.0,3,2,0,4,5,0,0,2,0,9,7,1
5826,153121,8I7HeVQkY0Ghn3WH0qZuBP62XiNRUFqR,5X6FeZozNMgE2VRi3MJYjkkFK8SETtu2,2,0,0,0,0,0,2,0,2,0.2857142857142857,1,0.0,0,0,0,0,0,0,0,2,0,0,2,1
5827,153143,lrzhiR0lqwM9mMtMpTIKNjxovQJrC4EF,5X6FeZozNMgE2VRi3MJYjkkFK8SETtu2,1,0,0,0,0,0,2,0,2,0.2857142857142857,1,0.0,0,0,0,0,0,0,0,2,0,0,2,1
5828,153151,Q3gIXSI0FAVHTJlJRiNvbhHhP7SCfem4,5X6FeZozNMgE2VRi3MJYjkkFK8SETtu2,5,2,1,0,1,0,2,0,6,0.8571428571428571,1,0.0,0,1,0,1,2,0,0,2,0,2,4,1
5829,153160,wFvodFqghxL7iISMFbYXkYNq6P6eK5gH,5X6FeZozNMgE2VRi3MJYjkkFK8SETtu2,1,0,0,0,0,0,2,0,2,0.2857142857142857,2,0.0,0,0,0,0,0,0,0,2,0,0,2,1
5830,153176,u87aVD0sE7LnY3BaUJepoCjM2Nidt8Dg,5X6FeZozNMgE2VRi3MJYjkkFK8SETtu2,1,0,0,0,0,0,1,0,1,0.14285714285714285,1,0.0,0,0,0,0,0,0,0,1,0,0,1,1
5831,153205,pvxjw4szSuluDWQ3DWPes9Mzs1MCvxjI,SpATywNh6bZuzm8s1ceuBUnMUAeoAHHw,21,15,9,12,4,8,8,1,57,8.142857142857142,1,0.0,5,9,11,4,10,8,1,8,1,29,28,1
5832,153230,9pfskqYp4pvR53OXPIHxfdcjDCQolJRR,SpATywNh6bZuzm8s1ceuBUnMUAeoAHHw,13,13,7,0,4,0,5,0,29,4.142857142857143,1,0.0,0,7,0,4,13,0,0,5,0,11,18,1
5833,153377,pShr7F4fdPHy76vFAX1gnyjDQNfbMT7w,SpATywNh6bZuzm8s1ceuBUnMUAeoAHHw,6,2,1,0,0,1,5,1,10,1.4285714285714286,1,0.0,0,1,0,0,2,1,0,5,1,1,9,1
5834,154004,Cf7GCeUZzG7WjvUIyGfwv9hfcwXPVq5G,SpATywNh6bZuzm8s1ceuBUnMUAeoAHHw,15,24,3,14,0,0,5,0,46,6.571428571428571,4,0.0,4,3,12,0,20,0,2,5,0,19,27,0
5835,154035,DHCzWncH94ErnybHPppeaE2nTRJmmMhY,SpATywNh6bZuzm8s1ceuBUnMUAeoAHHw,7,4,3,0,1,1,2,0,11,1.5714285714285714,1,0.0,0,3,0,1,4,1,0,2,0,4,7,1
5836,154133,zUPpTYisLLzFG12BVDvWrty0j8q1G6Si,SpATywNh6bZuzm8s1ceuBUnMUAeoAHHw,9,9,3,0,2,0,2,0,16,2.2857142857142856,2,0.0,0,3,0,2,9,0,0,2,0,5,11,0
5837,154208,SnMvZAwuUspzGESZwgJ4IDkT9epWcLq2,RXDvfPUBYFlVdlueBFbLW0mhhAyGEqpt,13,13,10,0,6,0,2,0,31,4.428571428571429,1,0.0,2,10,0,6,11,0,0,2,0,18,13,1
5838,154222,Csfk45aTs4wr0LJ69dzlrUlkEXjL89zd,bWdj2GDclj5ofokWjzoa5jAwMkxCykd6,23,9,5,50,1,2,5,1,73,10.428571428571429,2,0.0,3,5,45,1,6,2,5,5,1,54,19,0
5839,154230,H3O4gyMG4JZCCta11ycRXQMoTwg05Wu8,SpATywNh6bZuzm8s1ceuBUnMUAeoAHHw,4,1,0,0,0,0,4,0,5,0.7142857142857143,1,0.0,0,0,0,0,1,0,0,4,0,0,5,1
5840,154248,vMZukU2eTrxJbVM8jQ4bYVexnS3K2zdf,bWdj2GDclj5ofokWjzoa5jAwMkxCykd6,3,0,0,0,0,0,4,0,4,0.5714285714285714,1,0.0,0,0,0,0,0,0,0,4,0,0,4,1
5841,154272,CyBDBZRil6YI8WC6HxaXnpzYqE6gLNfL,A3fsA9Zfv1X2fVEQhTw51lKENdNrEqT3,1,0,0,0,0,0,1,0,1,0.14285714285714285,1,0.0,0,0,0,0,0,0,0,1,0,0,1,1
5842,154299,AcDeEJDUje4XRTI7mcV6fGOSh4iQh87e,5X6FeZozNMgE2VRi3MJYjkkFK8SETtu2,1,0,0,0,0,0,1,0,1,0.14285714285714285,1,0.0,0,0,0,0,0,0,0,1,0,0,1,1
5843,154302,6MMO6p1gWBmDJN4eS7QrAi6Zg4mTPljX,SpATywNh6bZuzm8s1ceuBUnMUAeoAHHw,5,3,1,0,1,0,1,0,6,0.8571428571428571,1,0.0,0,1,0,1,3,0,0,1,0,2,4,1
5844,154304,daNjsyZDfgvLE6mYr7BU5mjTXLNsBDii,SpATywNh6bZuzm8s1ceuBUnMUAeoAHHw,6,2,0,0,0,0,4,1,7,1.0,1,0.0,0,0,0,0,2,0,0,4,1,0,7,1
5845,154306,IXrLVJjodB615NE3nTgPKqPt8WaHKw26,5X6FeZozNMgE2VRi3MJYjkkFK8SETtu2,5,4,0,0,0,0,9,0,13,1.8571428571428572,3,0.0,0,0,0,0,4,0,0,9,0,0,13,1
5846,154309,iQAaSG6rDuzt2Sv1j0V2ZpmflXGImJaM,SpATywNh6bZuzm8s1ceuBUnMUAeoAHHw,28,20,17,0,14,0,2,0,53,7.571428571428571,1,0.0,0,17,0,14,20,0,0,2,0,31,22,1
5847,154316,j5n34dhJSAsFAv6KAw4rsAZTfhL07lCD,5X6FeZozNMgE2VRi3MJYjkkFK8SETtu2,2,0,0,0,0,0,3,0,3,0.42857142857142855,2,0.0,0,0,0,0,0,0,0,3,0,0,3,0
5848,154318,27pUZlupG1aVjIY0f9PLE1OvbJSBVMXw,SpATywNh6bZuzm8s1ceuBUnMUAeoAHHw,5,3,2,0,1,0,1,0,7,1.0,1,0.0,0,2,0,1,3,0,0,1,0,3,4,1
5849,154321,HoO8LKjjUMgJCeJcpwq1z7Z3nTHrSV55,5X6FeZozNMgE2VRi3MJYjkkFK8SETtu2,9,13,5,0,3,7,1,0,29,4.142857142857143,1,0.0,6,5,0,3,7,7,0,1,0,14,15,1
5850,154330,j5n34dhJSAsFAv6KAw4rsAZTfhL07lCD,A3fsA9Zfv1X2fVEQhTw51lKENdNrEqT3,1,0,0,0,0,0,1,0,1,0.14285714285714285,1,0.0,0,0,0,0,0,0,0,1,0,0,1,1
5851,154332,KQmd6JxNlcb9gfHTSXRQcfdSrHHAzfcG,5X6FeZozNMgE2VRi3MJYjkkFK8SETtu2,8,4,0,1,0,0,5,0,10,1.4285714285714286,1,0.0,1,0,1,0,3,0,0,5,0,2,8,1
5852,154336,6wr6dBOxcvGA1j07rybem8uoLQOkR2xX,SpATywNh6bZuzm8s1ceuBUnMUAeoAHHw,1,0,0,0,0,0,1,0,1,0.14285714285714285,1,0.0,0,0,0,0,0,0,0,1,0,0,1,1
5853,154341,zHI8MHuExufwDJ1uuBe75QQrzwho6OSZ,RXDvfPUBYFlVdlueBFbLW0mhhAyGEqpt,65,162,13,97,26,27,21,2,348,49.714285714285715,2,0.0,77,13,87,26,85,27,10,21,2,203,145,0
5854,154348,a6vqrMhHKzyWidqZtHap3qGcKb3WEBch,A3fsA9Zfv1X2fVEQhTw51lKENdNrEqT3,4,2,1,0,1,0,1,0,5,0.7142857142857143,1,0.0,0,1,0,1,2,0,0,1,0,2,3,1
5855,154377,0bzBCQH8D9DXq9uXmykneuVKZUsPAEIB,bWdj2GDclj5ofokWjzoa5jAwMkxCykd6,1,0,0,0,0,0,1,0,1,0.14285714285714285,1,0.0,0,0,0,0,0,0,0,1,0,0,1,1
5856,154386,XqlPY37hESY7wIIxbmRJf5T3alfyV4dl,RXDvfPUBYFlVdlueBFbLW0mhhAyGEqpt,1,0,0,0,0,0,1,0,1,0.14285714285714285,1,0.0,0,0,0,0,0,0,0,1,0,0,1,1
5857,154396,YJvyDY5DP7OYrdCjfLmpzctDWZWOOZ8F,SpATywNh6bZuzm8s1ceuBUnMUAeoAHHw,11,7,2,0,2,1,6,1,19,2.7142857142857144,2,0.0,0,2,0,2,7,1,0,6,1,4,15,1
5858,154397,3Aa3Am7eXOQ9i46JqJGoqVdbq443j86Q,5X6FeZozNMgE2VRi3MJYjkkFK8SETtu2,1,0,0,0,0,0,1,0,1,0.14285714285714285,1,0.0,0,0,0,0,0,0,0,1,0,0,1,1
5859,154415,sL5jw3pLWZoRI7avI17oM60mfF67Acgz,bWdj2GDclj5ofokWjzoa5jAwMkxCykd6,1,0,0,0,0,0,1,0,1,0.14285714285714285,1,0.0,0,0,0,0,0,0,0,1,0,0,1,0
5860,154436,VgwfEqq4zzESU4PqjsdqDnf6ZuDvfVVs,A3fsA9Zfv1X2fVEQhTw51lKENdNrEqT3,7,3,1,0,0,2,5,1,12,1.7142857142857142,1,0.0,0,1,0,0,3,2,0,5,1,1,11,1
5861,154452,ct3ZFc3dYzkZrA1pmvZdNHcuNKAGoE3e,G8EPVSXsOYB5YQWZGiz1aVq5Pgr2GrQu,1,0,0,0,0,0,1,0,1,0.14285714285714285,1,0.0,0,0,0,0,0,0,0,1,0,0,1,1
5862,154462,bhPYgMCLOyyitUb5vkMkP521Cgx8SoP8,bWdj2GDclj5ofokWjzoa5jAwMkxCykd6,12,9,6,6,3,0,6,0,30,4.285714285714286,1,0.0,0,6,3,3,9,0,3,6,0,12,18,1
5863,154465,iXy1VLqWL70M2DzueTojY5DBMUTLnXaY,G8EPVSXsOYB5YQWZGiz1aVq5Pgr2GrQu,38,6,0,112,0,0,2,0,120,17.142857142857142,1,0.0,0,0,91,0,6,0,21,2,0,91,29,1
5864,154492,eC4StSuQwImpW962lXYQQlRlP4Dxmsjm,SpATywNh6bZuzm8s1ceuBUnMUAeoAHHw,11,17,8,23,2,1,4,0,55,7.857142857142857,2,0.0,7,8,18,2,10,1,5,4,0,35,20,1
5865,154519,iAp4ykRY58SNvScBd1duZ1zo4LobCruL,RXDvfPUBYFlVdlueBFbLW0mhhAyGEqpt,10,14,5,0,2,0,2,0,23,3.2857142857142856,1,0.0,3,5,0,2,11,0,0,2,0,10,13,1
5866,154532,y4jCbRq0ZMCabQVeAWisCVju9AF82joj,bWdj2GDclj5ofokWjzoa5jAwMkxCykd6,5,2,1,0,1,0,2,1,7,1.0,1,0.0,0,1,0,1,2,0,0,2,1,2,5,1
5867,154545,fSmbrw0Ju6sDIYVnX3wBreBY5XT3qxJ6,RXDvfPUBYFlVdlueBFbLW0mhhAyGEqpt,8,5,3,0,2,0,5,0,15,2.142857142857143,1,0.0,0,3,0,2,5,0,0,5,0,5,10,1
5868,154570,EXZ81qqSldwR1xdBEwBZ7wmgbTHF86sl,A3fsA9Zfv1X2fVEQhTw51lKENdNrEqT3,12,16,11,0,4,4,6,0,41,5.857142857142857,1,0.0,0,11,0,4,16,4,0,6,0,15,26,0
5869,154572,IZjvzkwq6mW6mk7nIYbEArtjalxzWdW9,SpATywNh6bZuzm8s1ceuBUnMUAeoAHHw,16,14,7,15,4,0,1,0,41,5.857142857142857,1,0.0,5,7,15,4,9,0,0,1,0,31,10,1
5870,154630,PE4KBwh4ltl7dienGR8pJbew7yjFv3Vz,RXDvfPUBYFlVdlueBFbLW0mhhAyGEqpt,10,9,5,0,3,12,3,0,32,4.571428571428571,1,0.0,2,5,0,3,7,12,0,3,0,10,22,0
5871,154647,efygWYkxxUMOGInRZT4qEeuzMRlIpQq6,A3fsA9Zfv1X2fVEQhTw51lKENdNrEqT3,1,0,0,0,0,0,1,0,1,0.14285714285714285,1,0.0,0,0,0,0,0,0,0,1,0,0,1,1
5872,154652,0nScgbbn10u6m6AtEv5NZACOHoXfwiE1,bWdj2GDclj5ofokWjzoa5jAwMkxCykd6,4,2,1,0,0,0,2,0,5,0.7142857142857143,1,0.0,0,1,0,0,2,0,0,2,0,1,4,1
5873,154661,efygWYkxxUMOGInRZT4qEeuzMRlIpQq6,bWdj2GDclj5ofokWjzoa5jAwMkxCykd6,1,0,0,0,0,0,1,0,1,0.14285714285714285,1,0.0,0,0,0,0,0,0,0,1,0,0,1,1
5874,154662,5U79KRZxDDBIetuxjK0KXphUhzbxTzjr,SpATywNh6bZuzm8s1ceuBUnMUAeoAHHw,6,6,4,0,2,0,2,0,14,2.0,1,0.0,0,4,0,2,6,0,0,2,0,6,8,0
5875,154671,mjAv9AclbtbUXFdXjAFHT42UNJBkK7UO,5X6FeZozNMgE2VRi3MJYjkkFK8SETtu2,8,6,1,0,1,0,3,0,11,1.5714285714285714,1,0.0,0,1,0,1,6,0,0,3,0,2,9,1
5876,154687,MHJvZPnhmnZTjSPJQtFU0MT0vplye5Bv,SpATywNh6bZuzm8s1ceuBUnMUAeoAHHw,5,2,1,0,1,0,2,0,6,0.8571428571428571,1,0.0,0,1,0,1,2,0,0,2,0,2,4,0
5877,154730,QTkjMZ2x2XpQJLg858rH1nCjMIxPq1Ot,bWdj2GDclj5ofokWjzoa5jAwMkxCykd6,1,0,0,0,0,0,1,0,1,0.14285714285714285,1,0.0,0,0,0,0,0,0,0,1,0,0,1,1
5878,154754,2YvoGUTGx2dwzFxr98daOcUVN093Uexo,SpATywNh6bZuzm8s1ceuBUnMUAeoAHHw,6,9,0,0,0,0,3,0,12,1.7142857142857142,1,0.0,0,0,0,0,9,0,0,3,0,0,12,0
5879,154787,bWTCgLlWI05nNVcVRoVSZYxP5KtyHgRM,SpATywNh6bZuzm8s1ceuBUnMUAeoAHHw,1,0,0,0,0,0,1,0,1,0.14285714285714285,1,0.0,0,0,0,0,0,0,0,1,0,0,1,0
5880,154800,9bv4TssyKs6woXSaEFvigyhEyIkdO1mQ,G8EPVSXsOYB5YQWZGiz1aVq5Pgr2GrQu,6,3,2,0,2,0,1,0,8,1.1428571428571428,1,0.0,0,2,0,2,3,0,0,1,0,4,4,1
5881,154816,z99UWQHarVUXDSOuqNWR7PLwRKDFIaa2,SpATywNh6bZuzm8s1ceuBUnMUAeoAHHw,4,3,1,0,1,0,1,0,6,0.8571428571428571,1,0.0,1,1,0,1,2,0,0,1,0,3,3,1
5882,154819,9bv4TssyKs6woXSaEFvigyhEyIkdO1mQ,SpATywNh6bZuzm8s1ceuBUnMUAeoAHHw,15,11,4,21,0,0,2,0,38,5.428571428571429,1,0.0,6,4,20,0,5,0,1,2,0,30,8,1
5883,154847,OtGZHAMUloRDuFpftk1FK3bKwFDUoVzm,bWdj2GDclj5ofokWjzoa5jAwMkxCykd6,5,2,1,0,1,0,2,0,6,0.8571428571428571,1,0.0,0,1,0,1,2,0,0,2,0,2,4,1
5884,154867,GnGb3MjVBgYFavJRehOmmU05ktvVgJLM,SpATywNh6bZuzm8s1ceuBUnMUAeoAHHw,26,38,9,17,6,0,7,0,77,11.0,3,0.0,12,9,17,6,26,0,0,7,0,44,33,0
5885,154882,qZCURwy8JtTyuwzOv8VNGZdlPKRFUQ4x,bWdj2GDclj5ofokWjzoa5jAwMkxCykd6,1,0,0,0,0,0,1,0,1,0.14285714285714285,1,0.0,0,0,0,0,0,0,0,1,0,0,1,1
5886,154884,yIu3KUc7c2P1kltKfHrQV3zLqR8js3Nt,SpATywNh6bZuzm8s1ceuBUnMUAeoAHHw,17,9,7,5,6,0,2,0,29,4.142857142857143,1,0.0,1,7,4,6,8,0,1,2,0,18,11,1
5887,154885,TVSg46EJil4CAr2XoeKrOl5oJKlyMQop,SpATywNh6bZuzm8s1ceuBUnMUAeoAHHw,4,3,1,0,0,0,2,0,6,0.8571428571428571,1,0.0,0,1,0,0,3,0,0,2,0,1,5,0
5888,154888,bJlGVPYw5PozLrZ7sFyc3ZbkRaMzwvR4,5X6FeZozNMgE2VRi3MJYjkkFK8SETtu2,4,2,1,0,1,0,1,0,5,0.7142857142857143,1,0.0,0,1,0,1,2,0,0,1,0,2,3,1
5889,154890,ESVgLjevBgVMt5NWT7qc1LwRqq23pUi3,SpATywNh6bZuzm8s1ceuBUnMUAeoAHHw,13,15,7,13,4,1,1,0,41,5.857142857142857,1,0.0,4,7,10,4,11,1,3,1,0,25,16,0
5890,154932,edXPiPlXsxZWAwb1eG9vvJRlK1XmINAg,SpATywNh6bZuzm8s1ceuBUnMUAeoAHHw,1,0,0,0,0,0,1,0,1,0.14285714285714285,1,0.0,0,0,0,0,0,0,0,1,0,0,1,0
5891,154964,11vXtWJnN3H2cgEcJiLRnuxFRJzAe10n,bWdj2GDclj5ofokWjzoa5jAwMkxCykd6,1,0,0,0,0,0,1,0,1,0.14285714285714285,1,0.0,0,0,0,0,0,0,0,1,0,0,1,1
5892,154969,zWDepCfjbS7ISrpw6SZrVfUm7fvpWJYm,RXDvfPUBYFlVdlueBFbLW0mhhAyGEqpt,57,47,27,88,20,0,1,0,183,26.142857142857142,2,0.0,16,27,83,20,31,0,5,1,0,146,37,1
5893,154975,bmN2HbDrwDSmJ0Xp4dCDimKA67pr9rbv,A3fsA9Zfv1X2fVEQhTw51lKENdNrEqT3,4,2,0,0,0,0,2,0,4,0.5714285714285714,1,0.0,0,0,0,0,2,0,0,2,0,0,4,1
5894,155012,m7LPs49nHZUcvz2esAX8UbdKFZVSnWet,RXDvfPUBYFlVdlueBFbLW0mhhAyGEqpt,17,16,10,16,5,0,4,0,51,7.285714285714286,1,0.0,3,10,16,5,13,0,0,4,0,34,17,1
5895,155040,7BLSB26pFgDMSTV4x8nY66FLFZIw20Ig,SpATywNh6bZuzm8s1ceuBUnMUAeoAHHw,4,3,0,0,0,0,2,1,6,0.8571428571428571,1,0.0,1,0,0,0,2,0,0,2,1,1,5,1
5896,155041,oUmqIjzIqM0YLgZAwAfxKw9lIlJHSuxC,SpATywNh6bZuzm8s1ceuBUnMUAeoAHHw,42,49,21,43,12,0,13,0,138,19.714285714285715,2,0.0,26,21,36,12,23,0,7,13,0,95,43,0
5897,155056,hNPdZRGhrBNCKKHi19Tc0KVO04Qmubqr,SpATywNh6bZuzm8s1ceuBUnMUAeoAHHw,1,0,0,0,0,0,1,0,1,0.14285714285714285,1,0.0,0,0,0,0,0,0,0,1,0,0,1,1
5898,155059,0UQZhuiUnymjN9gGHDhi5njksg7urq3M,SpATywNh6bZuzm8s1ceuBUnMUAeoAHHw,7,6,2,0,2,0,3,0,13,1.8571428571428572,1,0.0,0,2,0,2,6,0,0,3,0,4,9,0
5899,155060,f6wHmVbM5ovn7AGXHgdzXq3eHvksX9VF,A3fsA9Zfv1X2fVEQhTw51lKENdNrEqT3,4,3,1,0,0,0,2,0,6,0.8571428571428571,1,0.0,0,1,0,0,3,0,0,2,0,1,5,1
5900,155065,aVCTqFxxjGJavhP7uYzlBoPGeSpDrJ0J,SpATywNh6bZuzm8s1ceuBUnMUAeoAHHw,5,4,1,0,1,0,1,0,7,1.0,1,0.0,0,1,0,1,4,0,0,1,0,2,5,0
5901,155070,UGYGSfRkJhOkgkdlCI6YSCshpNvwBF31,A3fsA9Zfv1X2fVEQhTw51lKENdNrEqT3,6,4,2,0,1,0,5,0,12,1.7142857142857142,1,0.0,0,2,0,1,4,0,0,5,0,3,9,1
5902,155080,bUAApLDRSsYoejMOs9wtzojFHzl0leoA,5X6FeZozNMgE2VRi3MJYjkkFK8SETtu2,8,20,10,0,7,0,3,0,40,5.714285714285714,5,0.0,1,10,0,7,19,0,0,3,0,18,22,1
5903,155087,UGYGSfRkJhOkgkdlCI6YSCshpNvwBF31,bWdj2GDclj5ofokWjzoa5jAwMkxCykd6,3,0,0,0,0,0,4,0,4,0.5714285714285714,1,0.0,0,0,0,0,0,0,0,4,0,0,4,0
5904,155092,3dD9gQSxLGK862CIf14a7AwmUeS49yRD,SpATywNh6bZuzm8s1ceuBUnMUAeoAHHw,4,2,1,0,1,0,1,0,5,0.7142857142857143,1,0.0,0,1,0,1,2,0,0,1,0,2,3,0
5905,155111,31aB1n1dsQQ1ksrWlX8ZehnLm4yKoPC4,SpATywNh6bZuzm8s1ceuBUnMUAeoAHHw,1,0,0,0,0,0,1,0,1,0.14285714285714285,1,0.0,0,0,0,0,0,0,0,1,0,0,1,0
5906,155155,LLekC5mtNTZwDXx4lqyHuAGXC1yYmPsa,SpATywNh6bZuzm8s1ceuBUnMUAeoAHHw,5,5,4,0,4,0,2,0,15,2.142857142857143,1,0.0,0,4,0,4,5,0,0,2,0,8,7,0
5907,155156,HdnrV7nditsFLVLpxc0QNpu4amVe8QVg,SpATywNh6bZuzm8s1ceuBUnMUAeoAHHw,1,0,0,0,0,0,3,0,3,0.42857142857142855,1,0.0,0,0,0,0,0,0,0,3,0,0,3,1
5908,155169,Eb5RWg3UkgZrmyRIPeFGfGNJ7vkOrNwq,SpATywNh6bZuzm8s1ceuBUnMUAeoAHHw,1,0,0,0,0,0,1,0,1,0.14285714285714285,1,0.0,0,0,0,0,0,0,0,1,0,0,1,1
5909,155194,NAJvTJBbpzTm4Ejnn68Kzje83d040jMj,5X6FeZozNMgE2VRi3MJYjkkFK8SETtu2,1,0,0,0,0,0,1,0,1,0.14285714285714285,1,0.0,0,0,0,0,0,0,0,1,0,0,1,1
5910,155217,7FfBjqz6byqYChvceuS9Jc7NHYR6f9E3,SpATywNh6bZuzm8s1ceuBUnMUAeoAHHw,1,0,0,0,0,0,1,0,1,0.14285714285714285,1,0.0,0,0,0,0,0,0,0,1,0,0,1,1
5911,155228,QZIRHdwFgibI2SBehTrmLAZxED1F4JL7,SpATywNh6bZuzm8s1ceuBUnMUAeoAHHw,3,2,1,0,0,0,1,0,4,0.5714285714285714,1,0.0,0,1,0,0,2,0,0,1,0,1,3,0
5912,155257,Mc1x8qc2ag2ssiz0qfYSRk8wfa0Gy5Kt,G8EPVSXsOYB5YQWZGiz1aVq5Pgr2GrQu,7,7,2,0,2,0,2,0,13,1.8571428571428572,1,0.0,0,2,0,2,7,0,0,2,0,4,9,1
5913,155259,DIn0cKF2NBuMvNyPjBbvqUIlAOozCZHa,SpATywNh6bZuzm8s1ceuBUnMUAeoAHHw,14,12,5,14,3,0,3,0,37,5.285714285714286,1,0.0,6,5,12,3,6,0,2,3,0,26,11,0
5914,155260,RYxlkEfybScjuURHdWSAT0EfdWxxzl53,G8EPVSXsOYB5YQWZGiz1aVq5Pgr2GrQu,4,3,2,0,0,0,1,0,6,0.8571428571428571,1,0.0,0,2,0,0,3,0,0,1,0,2,4,1
5915,155270,xcsswfe3yez02HFG13qFCOZgHBl5zUGi,SpATywNh6bZuzm8s1ceuBUnMUAeoAHHw,9,9,7,0,5,0,2,1,24,3.4285714285714284,1,0.0,0,7,0,5,9,0,0,2,1,12,12,0
5916,155276,GDK8eMRsCP5HvmKIuj8lRzbGyRDkL72s,G8EPVSXsOYB5YQWZGiz1aVq5Pgr2GrQu,54,26,16,205,8,0,11,0,266,38.0,1,0.0,10,16,174,8,16,0,31,11,0,208,58,0
5917,155278,vrdtE3c9uMTgSnAvUaVDDSMPyuNMNjJw,A3fsA9Zfv1X2fVEQhTw51lKENdNrEqT3,22,30,2,0,1,1,13,1,48,6.857142857142857,2,0.0,1,2,0,1,29,1,0,13,1,4,44,0
5918,155281,gam6NJWaaIRnsXzS5REeM5SpdSEqwYEM,G8EPVSXsOYB5YQWZGiz1aVq5Pgr2GrQu,2,0,0,0,0,0,2,0,2,0.2857142857142857,1,0.0,0,0,0,0,0,0,0,2,0,0,2,1
5919,155289,OPl7KyHzFf9FR7H5bJaIZJAJnuKijjNP,A3fsA9Zfv1X2fVEQhTw51lKENdNrEqT3,1,0,0,0,0,0,2,0,2,0.2857142857142857,1,0.0,0,0,0,0,0,0,0,2,0,0,2,1
5920,155294,AM0Pq0VaajXHw12VriykE7JoeiBR3Zq9,SpATywNh6bZuzm8s1ceuBUnMUAeoAHHw,1,0,0,0,0,0,1,0,1,0.14285714285714285,1,0.0,0,0,0,0,0,0,0,1,0,0,1,1
5921,155303,BPLTF2By1jayxHugVACT0ruRLIH96sul,SpATywNh6bZuzm8s1ceuBUnMUAeoAHHw,12,7,4,17,2,0,2,0,32,4.571428571428571,1,0.0,2,4,15,2,5,0,2,2,0,23,9,1
5922,155310,Mc1x8qc2ag2ssiz0qfYSRk8wfa0Gy5Kt,SpATywNh6bZuzm8s1ceuBUnMUAeoAHHw,2,0,0,0,0,0,2,0,2,0.2857142857142857,1,0.0,0,0,0,0,0,0,0,2,0,0,2,1
5923,155323,0B7Lg7kBiHggKw9Wk7X0Ew4GVuXGGcvN,A3fsA9Zfv1X2fVEQhTw51lKENdNrEqT3,7,10,3,0,1,0,5,0,19,2.7142857142857144,1,0.0,0,3,0,1,10,0,0,5,0,4,15,1
5924,155367,LSvU72CFq1TrHd9SCZOiKQ0qcV2oa2Ok,SpATywNh6bZuzm8s1ceuBUnMUAeoAHHw,3,4,0,0,0,0,3,0,7,1.0,2,0.0,0,0,0,0,4,0,0,3,0,0,7,1
5925,155384,eXLK6r8B7rhNuShaQfaa1NTqPuVY4VIk,SpATywNh6bZuzm8s1ceuBUnMUAeoAHHw,1,0,0,0,0,0,1,0,1,0.14285714285714285,1,0.0,0,0,0,0,0,0,0,1,0,0,1,1
5926,155391,mV4YsIiA8Oc8PxZhA2HzdmyhI1ZXRUSS,SpATywNh6bZuzm8s1ceuBUnMUAeoAHHw,1,0,0,0,0,0,1,0,1,0.14285714285714285,1,0.0,0,0,0,0,0,0,0,1,0,0,1,1
5927,155412,DTCznfsIfPRlvOLeQgZUHf8RkJdb61WR,5X6FeZozNMgE2VRi3MJYjkkFK8SETtu2,16,32,6,14,9,0,4,0,65,9.285714285714286,2,0.0,16,6,13,9,16,0,1,4,0,44,21,0
5928,155459,cuPQwSytidcCUilblyO4K9ALDT0iH8XK,SpATywNh6bZuzm8s1ceuBUnMUAeoAHHw,6,9,1,0,1,0,1,0,12,1.7142857142857142,1,0.0,0,1,0,1,9,0,0,1,0,2,10,0
5929,155477,6QvLuupNiStrzgd1XTxuVafPKhPqbm1k,SpATywNh6bZuzm8s1ceuBUnMUAeoAHHw,1,0,0,0,0,0,1,0,1,0.14285714285714285,1,0.0,0,0,0,0,0,0,0,1,0,0,1,1
5930,155580,RRM0TElcCY25pdcWRkMGxwCn30ehvK5c,SpATywNh6bZuzm8s1ceuBUnMUAeoAHHw,1,0,0,0,0,0,1,0,1,0.14285714285714285,1,0.0,0,0,0,0,0,0,0,1,0,0,1,0
5931,155610,UK0wMwBzvN90sgDmKYl9zi5a5BuEJyvZ,RXDvfPUBYFlVdlueBFbLW0mhhAyGEqpt,36,34,22,32,14,3,7,2,114,16.285714285714285,1,0.0,8,22,29,14,26,3,3,7,2,73,41,1
5932,155663,idXxMKeWJz1JyNZp33R8B6DMVoKa5csf,5X6FeZozNMgE2VRi3MJYjkkFK8SETtu2,13,15,3,20,5,0,3,0,46,6.571428571428571,3,0.0,8,3,16,5,7,0,4,3,0,32,14,1
5933,155826,VFaDw1WYcOtIcsxfLW3x5fsJ2JkUIOUZ,G8EPVSXsOYB5YQWZGiz1aVq5Pgr2GrQu,10,23,4,0,4,2,11,0,44,6.285714285714286,2,0.0,2,4,0,4,21,2,0,11,0,10,34,0
5934,155845,kAH6V7JzDoLq5AdXMqvLO78igpFvmPcb,SpATywNh6bZuzm8s1ceuBUnMUAeoAHHw,3,2,1,0,0,0,2,0,5,0.7142857142857143,1,0.0,0,1,0,0,2,0,0,2,0,1,4,1
5935,155915,tJ3sl9o76r3EHByeMBO5S5Oajse8uEcy,SpATywNh6bZuzm8s1ceuBUnMUAeoAHHw,18,20,2,28,2,0,5,0,57,8.142857142857142,2,0.0,4,2,25,2,16,0,3,5,0,33,24,0
5936,155964,nVB1o73xluQXZjoI2dUYHGxbCDG8qiCL,RXDvfPUBYFlVdlueBFbLW0mhhAyGEqpt,1,0,0,0,0,0,2,0,2,0.2857142857142857,2,0.0,0,0,0,0,0,0,0,2,0,0,2,0
5937,156049,LIH6u87VTR1542727Uc42mhP2iK5GaFP,5X6FeZozNMgE2VRi3MJYjkkFK8SETtu2,1,0,0,0,0,0,1,0,1,0.14285714285714285,1,0.0,0,0,0,0,0,0,0,1,0,0,1,1
5938,156077,nx1z63DgmeEAxW8gQgEbpcNs34kbRne4,5X6FeZozNMgE2VRi3MJYjkkFK8SETtu2,15,19,3,18,8,3,12,1,64,9.142857142857142,2,0.0,15,3,15,8,4,3,3,12,1,41,23,1
5939,156229,H7bZ54NuzkB5Nw5q0ZI1nld9qDoHNngL,5X6FeZozNMgE2VRi3MJYjkkFK8SETtu2,2,0,0,0,0,0,2,0,2,0.2857142857142857,2,0.0,0,0,0,0,0,0,0,2,0,0,2,0
5940,156308,ifnHK7elzUrx6FoT7eceCrEZMhAwQ98l,A3fsA9Zfv1X2fVEQhTw51lKENdNrEqT3,8,4,3,0,2,0,3,0,12,1.7142857142857142,1,0.0,0,3,0,2,4,0,0,3,0,5,7,1
5941,156323,WN48iLnvvEk85bn1Ax5lHk0fUlDw6OCg,SpATywNh6bZuzm8s1ceuBUnMUAeoAHHw,1,0,0,0,0,0,1,0,1,0.14285714285714285,1,0.0,0,0,0,0,0,0,0,1,0,0,1,1
5942,156435,45E6hpwDMHp9Q3Pt1xT8q04bbowKk87g,bWdj2GDclj5ofokWjzoa5jAwMkxCykd6,36,32,18,50,13,0,5,0,118,16.857142857142858,3,0.0,9,18,49,13,23,0,1,5,0,89,29,1
5943,156518,Atic9bcAYez6iPYGWH9qjmSkP3PGX2jq,RXDvfPUBYFlVdlueBFbLW0mhhAyGEqpt,17,23,14,10,4,11,4,0,66,9.428571428571429,2,0.0,1,14,10,4,22,11,0,4,0,29,37,1
5944,156612,QqE2Xjwy9gUzOvFdkDqAwAaNZLBZkxvd,5X6FeZozNMgE2VRi3MJYjkkFK8SETtu2,3,0,0,0,0,0,7,0,7,1.0,4,0.0,0,0,0,0,0,0,0,7,0,0,7,1
5945,156656,7IdpyRf57AcKqRM0ayoEIjOEGtDFURim,SpATywNh6bZuzm8s1ceuBUnMUAeoAHHw,4,3,0,0,0,0,2,0,5,0.7142857142857143,1,0.0,0,0,0,0,3,0,0,2,0,0,5,0
5946,156801,HoH1joiBpbDlKqg5IXGbrLHAYskumoZ0,A3fsA9Zfv1X2fVEQhTw51lKENdNrEqT3,4,3,1,0,0,0,2,0,6,0.8571428571428571,1,0.0,0,1,0,0,3,0,0,2,0,1,5,1
5947,156814,NUS8SY2k3f0DNpfQK2nVGgf0JlJGgonT,5X6FeZozNMgE2VRi3MJYjkkFK8SETtu2,1,0,0,0,0,0,1,0,1,0.14285714285714285,1,0.0,0,0,0,0,0,0,0,1,0,0,1,1
5948,156857,6Wl1wEYRYla7mkHoSYrGvmHM4YNCaD3n,3VkHkmOtom3jM2wCu94xgzzu1d6Dn7or,24,97,44,18,15,32,50,1,257,36.714285714285715,5,0.0,22,44,15,15,75,32,3,50,1,96,161,1
5949,156881,Nnfk32V9AUiBIlPGAKpXXGDwSTEb28r2,3VkHkmOtom3jM2wCu94xgzzu1d6Dn7or,1,0,0,0,0,0,2,0,2,0.2857142857142857,1,0.0,0,0,0,0,0,0,0,2,0,0,2,1
5950,156984,qI2TFhwq18nYOTCvta1laF36Rf50g4U5,3VkHkmOtom3jM2wCu94xgzzu1d6Dn7or,2,0,0,0,0,0,3,0,3,0.42857142857142855,1,0.0,0,0,0,0,0,0,0,3,0,0,3,1
5951,157010,WHFo5hRS2YZ5idgDwEWwHai4y5ZGv29k,3VkHkmOtom3jM2wCu94xgzzu1d6Dn7or,7,2,1,0,1,7,5,1,17,2.4285714285714284,1,0.0,0,1,0,1,2,7,0,5,1,2,15,1
5952,157019,9InyUG1HqccZWi5HVBzl2o4TV1KsASqo,3VkHkmOtom3jM2wCu94xgzzu1d6Dn7or,3,3,0,0,0,0,4,0,7,1.0,1,0.0,0,0,0,0,3,0,0,4,0,0,7,1
5953,157059,XMxNRap7k9Wk3QHHZRAATbBEOBshaiXR,3VkHkmOtom3jM2wCu94xgzzu1d6Dn7or,2,0,0,0,0,0,2,0,2,0.2857142857142857,1,0.0,0,0,0,0,0,0,0,2,0,0,2,1
5954,157061,Xf7hdurXZL8gf3FBiEK1cLryOJhCr0Cv,3VkHkmOtom3jM2wCu94xgzzu1d6Dn7or,11,17,5,5,5,10,13,1,56,8.0,3,0.0,10,5,4,5,7,10,1,13,1,24,32,0
5955,157062,63lqYGGtr9LJWJAQWQ0ApJu43pQGE26W,3VkHkmOtom3jM2wCu94xgzzu1d6Dn7or,9,3,2,0,2,0,5,1,13,1.8571428571428572,1,0.0,0,2,0,2,3,0,0,5,1,4,9,1
5956,157104,HhG2dCKpkSCA1aCq3JeL6EdAqYEZXpAC,3VkHkmOtom3jM2wCu94xgzzu1d6Dn7or,1,0,0,0,0,0,1,0,1,0.14285714285714285,1,0.0,0,0,0,0,0,0,0,1,0,0,1,1
5957,157141,wv5T3V7CEVt74uCfZX0bShz9AhS2hmJh,3VkHkmOtom3jM2wCu94xgzzu1d6Dn7or,1,0,0,0,0,0,3,0,3,0.42857142857142855,2,0.0,0,0,0,0,0,0,0,3,0,0,3,1
5958,157144,Q9vRNhatkLDJJU3tGkLQZvY6VPiyvyvp,3VkHkmOtom3jM2wCu94xgzzu1d6Dn7or,5,2,1,0,1,0,2,0,6,0.8571428571428571,1,0.0,0,1,0,1,2,0,0,2,0,2,4,1
5959,157249,6JlRZxC3M5GDCXBPRgqIBCezswNuact8,5X6FeZozNMgE2VRi3MJYjkkFK8SETtu2,2,0,0,0,0,0,2,0,2,0.2857142857142857,1,0.0,0,0,0,0,0,0,0,2,0,0,2,1
5960,157270,G6cW0d2bzLHgB0vreFbhNx3GSiMBKbtv,5X6FeZozNMgE2VRi3MJYjkkFK8SETtu2,5,5,2,0,1,0,2,0,10,1.4285714285714286,1,0.0,0,2,0,1,5,0,0,2,0,3,7,1
5961,157321,Zv5J5vZd6sts8D8tkpz93CdtunC9xapP,5X6FeZozNMgE2VRi3MJYjkkFK8SETtu2,1,0,0,0,0,0,1,0,1,0.14285714285714285,1,0.0,0,0,0,0,0,0,0,1,0,0,1,1
5962,157349,3RPGU51kghTa1yQ8sk1JkQkDTlLpjaeu,5X6FeZozNMgE2VRi3MJYjkkFK8SETtu2,2,0,0,0,0,0,7,0,7,1.0,3,0.0,0,0,0,0,0,0,0,7,0,0,7,1
5963,157427,WycpsYuTE6aqZnahZR7CdEWycxuFvS1v,5X6FeZozNMgE2VRi3MJYjkkFK8SETtu2,2,0,0,0,0,0,2,0,2,0.2857142857142857,1,0.0,0,0,0,0,0,0,0,2,0,0,2,1
5964,157520,JUDJxps7BFb6uV0z9D16sg9erfu9YhJk,5X6FeZozNMgE2VRi3MJYjkkFK8SETtu2,31,29,8,0,25,0,2,1,65,9.285714285714286,1,0.0,20,8,0,25,9,0,0,2,1,53,12,1
5965,157544,23qYgK59sBhKVlqVOyc6Eo1KSrAZuYOK,5X6FeZozNMgE2VRi3MJYjkkFK8SETtu2,1,0,0,0,0,0,1,0,1,0.14285714285714285,1,0.0,0,0,0,0,0,0,0,1,0,0,1,1
5966,157633,LWIOfEf4G2x8q0gnnLAngYfTwedbhqfN,5Gyp41oLVo7Gg7vF4vpmggWP5MU70QO6,10,14,6,4,4,23,4,2,57,8.142857142857142,2,0.0,1,6,2,4,13,23,2,4,2,13,44,1
5967,157669,WEnfjbLNrVMT3GFjQA4iWW3hf0GRPkfb,5Gyp41oLVo7Gg7vF4vpmggWP5MU70QO6,10,4,2,4,2,2,4,1,19,2.7142857142857144,1,0.0,2,2,3,2,2,2,1,4,1,9,10,1
5968,157718,IthMAYNztWJoCFBWzNdp86Bo47edo7Kr,5Gyp41oLVo7Gg7vF4vpmggWP5MU70QO6,9,6,5,0,3,0,3,0,17,2.4285714285714284,1,0.0,0,5,0,3,6,0,0,3,0,8,9,1
5969,157719,HTGHrKrt9bt2no7NEjeTqA36pNapNLke,5Gyp41oLVo7Gg7vF4vpmggWP5MU70QO6,8,6,3,2,1,0,2,0,14,2.0,1,0.0,2,3,1,1,4,0,1,2,0,7,7,1
5970,157736,R9r67sxIPOn54lhnIEKJJZdT5cvreYeI,5Gyp41oLVo7Gg7vF4vpmggWP5MU70QO6,4,2,0,0,1,0,2,0,5,0.7142857142857143,1,0.0,0,0,0,1,2,0,0,2,0,1,4,1
5971,157746,VXYzZfu6ih0keHE9HAJ1SdpDOLcLAbwC,5Gyp41oLVo7Gg7vF4vpmggWP5MU70QO6,5,2,1,0,1,0,4,0,8,1.1428571428571428,1,0.0,0,1,0,1,2,0,0,4,0,2,6,1
5972,157762,2DAo11CCHa1ykO991IcFGBvBlIWgvVCY,5Gyp41oLVo7Gg7vF4vpmggWP5MU70QO6,4,2,1,0,1,0,2,0,6,0.8571428571428571,2,0.0,0,1,0,1,2,0,0,2,0,2,4,1
5973,157772,70ji2rgpVjNQHb0uAYu1Dlkzz8Vozt3h,5Gyp41oLVo7Gg7vF4vpmggWP5MU70QO6,10,8,4,4,3,0,2,0,21,3.0,2,0.0,2,4,3,3,6,0,1,2,0,12,9,0
5974,157802,M5VVteWQySX3L3J4dk5RJz0FGibCUyC6,5Gyp41oLVo7Gg7vF4vpmggWP5MU70QO6,12,27,14,0,6,3,9,1,60,8.571428571428571,4,0.0,4,14,0,6,23,3,0,9,1,24,36,1
5975,157856,ztVA2w1PZ0cPjSAHpOBD7HJ0VZDDjFrc,5Gyp41oLVo7Gg7vF4vpmggWP5MU70QO6,5,3,2,0,2,0,2,0,9,1.2857142857142858,1,0.0,0,2,0,2,3,0,0,2,0,4,5,0
5976,157857,GP0VAUJvMCs1edl21WedxXJbyeSp4smq,5Gyp41oLVo7Gg7vF4vpmggWP5MU70QO6,8,5,4,0,2,0,3,0,14,2.0,2,0.0,0,4,0,2,5,0,0,3,0,6,8,1
5977,157895,5Sfx079BTP0V5IioYsBhlrfBGdWoPDWP,5Gyp41oLVo7Gg7vF4vpmggWP5MU70QO6,10,23,5,1,2,2,4,0,37,5.285714285714286,1,0.0,15,5,1,2,8,2,0,4,0,23,14,1
5978,157915,A6EtE2eKPjGPEsSDEue5cwGo2zp7DviG,5Gyp41oLVo7Gg7vF4vpmggWP5MU70QO6,5,3,1,0,1,0,2,0,7,1.0,1,0.0,0,1,0,1,3,0,0,2,0,2,5,1
5979,157916,FGJh9lbE5Tn49JmYTykhj6B5KNIkrzwf,5Gyp41oLVo7Gg7vF4vpmggWP5MU70QO6,1,0,0,0,0,0,1,0,1,0.14285714285714285,1,0.0,0,0,0,0,0,0,0,1,0,0,1,1
5980,157933,ZKYPDfjHbDNy826bRbgfwUg0sAVAo2R5,5Gyp41oLVo7Gg7vF4vpmggWP5MU70QO6,7,7,3,0,2,0,3,0,15,2.142857142857143,1,0.0,1,3,0,2,6,0,0,3,0,6,9,1
5981,157942,869csXTSxmz5a3Iq4YX4us05akITQ5bo,5Gyp41oLVo7Gg7vF4vpmggWP5MU70QO6,1,0,0,0,0,0,2,0,2,0.2857142857142857,1,0.0,0,0,0,0,0,0,0,2,0,0,2,1
5982,157948,UTQI3stNnZIKednJcKCTrHPD5NsTO42m,5Gyp41oLVo7Gg7vF4vpmggWP5MU70QO6,1,0,0,0,0,0,1,0,1,0.14285714285714285,1,0.0,0,0,0,0,0,0,0,1,0,0,1,1
5983,157954,bXli2OVtRnaQ20Z1gieE0Vtj83YMuZrL,5Gyp41oLVo7Gg7vF4vpmggWP5MU70QO6,7,3,2,0,1,0,9,0,15,2.142857142857143,1,0.0,0,2,0,1,3,0,0,9,0,3,12,1
5984,157989,OYQCjjV0jebV4LN4hg0D6dY6fyaV2c47,5Gyp41oLVo7Gg7vF4vpmggWP5MU70QO6,1,0,0,0,0,0,2,0,2,0.2857142857142857,1,0.0,0,0,0,0,0,0,0,2,0,0,2,1
5985,157996,CIiWe6ULrETFuvq6ceby0e46t5dQ6ZDk,5Gyp41oLVo7Gg7vF4vpmggWP5MU70QO6,5,2,1,0,1,1,3,0,8,1.1428571428571428,1,0.0,0,1,0,1,2,1,0,3,0,2,6,1
5986,157997,79FsGRj8oZJZd2OwJDKEfUqABiV1ZA7r,5Gyp41oLVo7Gg7vF4vpmggWP5MU70QO6,8,5,2,0,2,4,6,0,19,2.7142857142857144,1,0.0,1,2,0,2,4,4,0,6,0,5,14,1
5987,158002,vLcoMjl52bAkwS2Nrqx0BG2I0tRsoKBa,5Gyp41oLVo7Gg7vF4vpmggWP5MU70QO6,5,1,1,0,1,1,2,0,6,0.8571428571428571,1,0.0,0,1,0,1,1,1,0,2,0,2,4,1
5988,158024,8irCUZa4UAKsYYFeHrY9ttb5xgcL2ou7,5Gyp41oLVo7Gg7vF4vpmggWP5MU70QO6,12,7,6,0,3,0,2,0,18,2.5714285714285716,1,0.0,0,6,0,3,7,0,0,2,0,9,9,1
5989,158035,Io3VzTK6sP3a0ZVRKkRhFNz8A2ULjris,5Gyp41oLVo7Gg7vF4vpmggWP5MU70QO6,9,12,9,0,0,11,8,1,41,5.857142857142857,2,0.0,0,9,0,0,12,11,0,8,1,9,32,1
5990,158036,ZqvxyeZYRSzaK0NeAJVghR0lBOIaaZqV,5Gyp41oLVo7Gg7vF4vpmggWP5MU70QO6,12,20,11,10,7,0,1,0,49,7.0,1,0.0,7,11,6,7,13,0,4,1,0,31,18,1
5991,158065,BBJ3vKTyvStRa10Tpfc6k0oOhgY721Pq,5Gyp41oLVo7Gg7vF4vpmggWP5MU70QO6,1,0,0,0,0,0,1,0,1,0.14285714285714285,1,0.0,0,0,0,0,0,0,0,1,0,0,1,1
5992,158066,rBi9e8T21gI6VJkURQRxwM6NnqVXHHAq,5Gyp41oLVo7Gg7vF4vpmggWP5MU70QO6,9,8,6,0,4,0,2,0,20,2.857142857142857,1,0.0,1,6,0,4,7,0,0,2,0,11,9,1
5993,158093,ef6Fua3z8OcLsUmVPoEWH2QwTgDEN5UV,5Gyp41oLVo7Gg7vF4vpmggWP5MU70QO6,1,0,0,0,0,0,1,0,1,0.14285714285714285,1,0.0,0,0,0,0,0,0,0,1,0,0,1,1
5994,158119,WxVM9kOqNmenlQy1YKMo3yVYKYKkewCz,5Gyp41oLVo7Gg7vF4vpmggWP5MU70QO6,9,19,8,13,2,0,7,0,49,7.0,4,0.0,5,8,10,2,14,0,3,7,0,25,24,1
5995,158130,bSKPqUrgPKXVRzWsWyAdkxmj7bsvJTtN,5Gyp41oLVo7Gg7vF4vpmggWP5MU70QO6,20,35,18,15,10,0,9,0,87,12.428571428571429,3,0.0,9,18,10,10,26,0,5,9,0,47,40,1
5996,158145,NWcsS6t3wOq2pf5qHyOJUoZH0ORQTv1z,5Gyp41oLVo7Gg7vF4vpmggWP5MU70QO6,1,0,0,0,0,0,1,0,1,0.14285714285714285,1,0.0,0,0,0,0,0,0,0,1,0,0,1,1
5997,158148,uqbMFekfs67CmLzvJypjQ2YDZvOTDl5M,5Gyp41oLVo7Gg7vF4vpmggWP5MU70QO6,1,0,0,0,0,0,1,0,1,0.14285714285714285,1,0.0,0,0,0,0,0,0,0,1,0,0,1,1
5998,158177,Go1arppSMxFevdTxkc0brt4Bh3dCTs43,5Gyp41oLVo7Gg7vF4vpmggWP5MU70QO6,8,19,4,0,1,1,4,0,29,4.142857142857143,2,0.0,9,4,0,1,10,1,0,4,0,14,15,1
5999,158178,gy7pyC3wBMgheQXSZM4NwZVXK08J1Yb4,5Gyp41oLVo7Gg7vF4vpmggWP5MU70QO6,1,0,0,0,0,0,1,0,1,0.14285714285714285,1,0.0,0,0,0,0,0,0,0,1,0,0,1,1
6000,158190,ouZJjXOMfv0cgbezRQ2yVqJJVKJPFP9g,5Gyp41oLVo7Gg7vF4vpmggWP5MU70QO6,1,0,0,0,0,0,1,0,1,0.14285714285714285,1,0.0,0,0,0,0,0,0,0,1,0,0,1,1
6001,158203,HkcPmWCSdk3INCYsquWGQGZKijdTCD0w,5Gyp41oLVo7Gg7vF4vpmggWP5MU70QO6,1,0,0,0,0,0,1,0,1,0.14285714285714285,1,0.0,0,0,0,0,0,0,0,1,0,0,1,0
6002,158215,XPiygQf4f2L0UgTrmMFFqxeKe6BZR3ej,5Gyp41oLVo7Gg7vF4vpmggWP5MU70QO6,1,0,0,0,0,0,2,0,2,0.2857142857142857,2,0.0,0,0,0,0,0,0,0,2,0,0,2,1
6003,158217,5UGNuDKo01BQkwP5FIZp50YNYJe8fXVs,5Gyp41oLVo7Gg7vF4vpmggWP5MU70QO6,19,29,16,0,11,0,12,0,68,9.714285714285714,2,0.0,9,16,0,11,20,0,0,12,0,36,32,1
6004,158223,NvaDpy1hgf8rWDMhliIL6XiIMyJMBjqV,5Gyp41oLVo7Gg7vF4vpmggWP5MU70QO6,1,0,0,0,0,0,1,0,1,0.14285714285714285,1,0.0,0,0,0,0,0,0,0,1,0,0,1,1
6005,158248,Im0Jt8ZsNMpNfAcwspOxwhIuEx5EhBXC,5Gyp41oLVo7Gg7vF4vpmggWP5MU70QO6,1,0,0,0,0,0,1,0,1,0.14285714285714285,1,0.0,0,0,0,0,0,0,0,1,0,0,1,1
6006,158267,JlM44bI5crrtGE7iI2BHTiesGaSh9jLm,5Gyp41oLVo7Gg7vF4vpmggWP5MU70QO6,6,5,3,0,3,0,1,0,12,1.7142857142857142,1,0.0,0,3,0,3,5,0,0,1,0,6,6,1
6007,158304,s9zVSTKcBCSQqiONTkBdJFyXlfd2TpPb,5Gyp41oLVo7Gg7vF4vpmggWP5MU70QO6,14,15,9,0,6,1,4,0,35,5.0,2,0.0,1,9,0,6,14,1,0,4,0,16,19,1
6008,158306,e8QZ92AvjJI6opw2slSevZ0L8RtvMAlZ,5Gyp41oLVo7Gg7vF4vpmggWP5MU70QO6,7,3,2,0,2,0,2,0,9,1.2857142857142858,1,0.0,0,2,0,2,3,0,0,2,0,4,5,1
6009,158314,rqoGLMWp7ee8Ppu4OdHSBl6vmRxDZvKU,5Gyp41oLVo7Gg7vF4vpmggWP5MU70QO6,10,18,5,3,3,0,4,0,33,4.714285714285714,2,0.0,5,5,2,3,13,0,1,4,0,15,18,1
6010,158341,6uFOxAyka7QrtMUYdvjsolvFWloaK2QU,5Gyp41oLVo7Gg7vF4vpmggWP5MU70QO6,10,8,5,0,6,0,1,0,20,2.857142857142857,1,0.0,0,5,0,6,8,0,0,1,0,11,9,1
6011,158348,UqdIUFHnGaXiXqYDnRaaG3a8Ckuse0hd,5Gyp41oLVo7Gg7vF4vpmggWP5MU70QO6,4,2,1,0,1,0,1,0,5,0.7142857142857143,1,0.0,0,1,0,1,2,0,0,1,0,2,3,1
6012,158363,bXMaalfz1ZqHKnJWw6VXCAoemSeuw45Q,5Gyp41oLVo7Gg7vF4vpmggWP5MU70QO6,9,7,4,3,0,0,7,0,21,3.0,3,0.0,3,4,3,0,4,0,0,7,0,10,11,1
6013,158373,V0KwOaUHQenVt4j6XdWENbsPxRLl95xt,5Gyp41oLVo7Gg7vF4vpmggWP5MU70QO6,1,0,0,0,0,0,1,0,1,0.14285714285714285,1,0.0,0,0,0,0,0,0,0,1,0,0,1,1
6014,158387,b8ok99SfWosLE8bC830yWvnFESGW3si2,5Gyp41oLVo7Gg7vF4vpmggWP5MU70QO6,22,21,19,0,8,1,15,1,65,9.285714285714286,2,0.0,1,19,0,8,20,1,0,15,1,28,37,1
6015,158408,lECqbqrkQ3HlfeNWRN0jqJEeRHxVUCOh,5Gyp41oLVo7Gg7vF4vpmggWP5MU70QO6,30,44,18,10,20,10,17,1,120,17.142857142857142,5,0.0,14,18,8,20,30,10,2,17,1,60,60,1
6016,158414,GttyptGQfSjuAltdswFjfTtOCrx992oK,5Gyp41oLVo7Gg7vF4vpmggWP5MU70QO6,1,0,0,0,0,0,1,0,1,0.14285714285714285,1,0.0,0,0,0,0,0,0,0,1,0,0,1,1
6017,158456,crFFvCkJsUWvruc5uCB1uKzbtgTYoPqU,5Gyp41oLVo7Gg7vF4vpmggWP5MU70QO6,7,10,5,4,0,0,2,0,21,3.0,1,0.0,1,5,2,0,9,0,2,2,0,8,13,1
6018,158463,vpYgNvzZy52Oh1tIBbe2df7KZVnqAmZK,5Gyp41oLVo7Gg7vF4vpmggWP5MU70QO6,4,2,1,0,1,0,2,0,6,0.8571428571428571,2,0.0,0,1,0,1,2,0,0,2,0,2,4,1
6019,158464,THXvaeyPhVQwJsTFbHjyopJ1nNCELuyj,5Gyp41oLVo7Gg7vF4vpmggWP5MU70QO6,5,5,2,0,2,0,3,0,12,1.7142857142857142,2,0.0,0,2,0,2,5,0,0,3,0,4,8,1
6020,158479,9pT3HP4ciM7AgX5da5QzYZtPA6fxeste,5Gyp41oLVo7Gg7vF4vpmggWP5MU70QO6,11,17,8,7,2,11,5,0,50,7.142857142857143,3,0.0,1,8,5,2,16,11,2,5,0,16,34,1
6021,158487,L5aguIiqOewAgGrhJVNv8Wafy1P8kRt9,5Gyp41oLVo7Gg7vF4vpmggWP5MU70QO6,1,0,0,0,0,0,1,0,1,0.14285714285714285,1,0.0,0,0,0,0,0,0,0,1,0,0,1,1
6022,158496,fRucRBw44zpZn0NZGLJPqsXONojt7uSi,5Gyp41oLVo7Gg7vF4vpmggWP5MU70QO6,5,3,1,0,1,0,2,0,7,1.0,1,0.0,0,1,0,1,3,0,0,2,0,2,5,1
6023,158511,D0CsW9G2S7ulJStlNy1QB5IxfGgJKMqm,5Gyp41oLVo7Gg7vF4vpmggWP5MU70QO6,12,29,17,6,4,26,5,0,87,12.428571428571429,2,0.0,3,17,4,4,26,26,2,5,0,28,59,0
6024,158524,WOgGW6t7ivkfrL4Z5Ocp4QdCm4d6AMkz,5Gyp41oLVo7Gg7vF4vpmggWP5MU70QO6,7,4,1,0,2,0,1,0,8,1.1428571428571428,1,0.0,0,1,0,2,4,0,0,1,0,3,5,1
6025,158525,WE2BbGXOVoTrjhAJmFH0Or7kVd39V4vi,5Gyp41oLVo7Gg7vF4vpmggWP5MU70QO6,7,5,3,0,2,0,1,0,11,1.5714285714285714,1,0.0,1,3,0,2,4,0,0,1,0,6,5,1
6026,158535,PxyKXDtaR2mbq9weELx4ZBr6DLDWNqy9,5Gyp41oLVo7Gg7vF4vpmggWP5MU70QO6,6,3,2,0,2,0,1,0,8,1.1428571428571428,1,0.0,0,2,0,2,3,0,0,1,0,4,4,1
6027,158539,VXCd64m0Z7xUSwqq3nKNQ9weISoBu0LD,5Gyp41oLVo7Gg7vF4vpmggWP5MU70QO6,6,3,2,0,2,0,1,0,8,1.1428571428571428,1,0.0,0,2,0,2,3,0,0,1,0,4,4,1
6028,158559,PKljiaQmLbZG5ONmJlKJEPvGakMbHbYU,5Gyp41oLVo7Gg7vF4vpmggWP5MU70QO6,6,3,2,0,2,0,1,0,8,1.1428571428571428,1,0.0,0,2,0,2,3,0,0,1,0,4,4,1
6029,158561,RM5Si3x1ttYcDbiTcjvVOJ3RWIjU0zI5,5Gyp41oLVo7Gg7vF4vpmggWP5MU70QO6,6,4,3,0,2,0,1,0,10,1.4285714285714286,1,0.0,0,3,0,2,4,0,0,1,0,5,5,1
6030,158568,9FlBeR38sxQqTfTtonzJZ0Irx7qBpmor,5Gyp41oLVo7Gg7vF4vpmggWP5MU70QO6,7,6,2,0,2,0,2,0,12,1.7142857142857142,2,0.0,0,2,0,2,6,0,0,2,0,4,8,1
6031,158573,klui28KhyhClftadsamLTvXW9muuN6Qc,5Gyp41oLVo7Gg7vF4vpmggWP5MU70QO6,14,18,10,2,5,19,6,0,60,8.571428571428571,1,0.0,7,10,1,5,11,19,1,6,0,23,37,1
6032,158586,2zFsyHLRIVr61iaQkzpRvzQtauWJlCfW,5Gyp41oLVo7Gg7vF4vpmggWP5MU70QO6,1,0,0,0,0,0,4,0,4,0.5714285714285714,2,0.0,0,0,0,0,0,0,0,4,0,0,4,1
6033,158607,W7RgW1HKGO83Xx4btgMFqalp32Qehjoi,5Gyp41oLVo7Gg7vF4vpmggWP5MU70QO6,1,0,0,0,0,0,1,0,1,0.14285714285714285,1,0.0,0,0,0,0,0,0,0,1,0,0,1,1
6034,158611,VW2nlrlfxtuKc79c7VsAkYHSZK2oNi0Q,5Gyp41oLVo7Gg7vF4vpmggWP5MU70QO6,1,0,0,0,0,0,1,0,1,0.14285714285714285,1,0.0,0,0,0,0,0,0,0,1,0,0,1,1
6035,158637,hBjHZojv3ifn1BGe2j9vzNNV7zRAWgCr,5Gyp41oLVo7Gg7vF4vpmggWP5MU70QO6,6,5,2,0,0,3,3,0,13,1.8571428571428572,1,0.0,3,2,0,0,2,3,0,3,0,5,8,0
6036,158645,eb7ZybPnI910hHaYVoCo6nxLkIiXwzRa,5Gyp41oLVo7Gg7vF4vpmggWP5MU70QO6,11,26,13,8,4,18,3,0,72,10.285714285714286,1,0.0,4,13,6,4,22,18,2,3,0,27,45,1
6037,158651,UrSGv4civCcLiCxcgwsTEMeJJdN6l4Vv,5Gyp41oLVo7Gg7vF4vpmggWP5MU70QO6,10,6,3,2,1,0,9,1,22,3.142857142857143,1,0.0,2,3,1,1,4,0,1,9,1,7,15,1
6038,158676,czPkaZkbqFY5spUFhBAHMOHBEtbhDqHw,5Gyp41oLVo7Gg7vF4vpmggWP5MU70QO6,1,0,0,0,0,0,1,0,1,0.14285714285714285,1,0.0,0,0,0,0,0,0,0,1,0,0,1,1
6039,158693,PZ0JMRr6vxivy5yXBEs4L9qx3vBiHfoH,5Gyp41oLVo7Gg7vF4vpmggWP5MU70QO6,3,2,1,0,0,0,2,0,5,0.7142857142857143,1,0.0,0,1,0,0,2,0,0,2,0,1,4,1
6040,158698,4zrvABDjO8Ut5BB3dmSF06xVwPlHi7pK,5Gyp41oLVo7Gg7vF4vpmggWP5MU70QO6,24,40,4,28,11,15,5,0,103,14.714285714285714,4,0.0,7,4,19,11,33,15,9,5,0,41,62,1
6041,158701,qs5RIk0lD4q937ua1wEd8DEKzji32nQh,5Gyp41oLVo7Gg7vF4vpmggWP5MU70QO6,10,10,7,0,1,0,10,0,28,4.0,2,0.0,0,7,0,1,10,0,0,10,0,8,20,1
6042,158702,3BgmezVALuv9uoIS0qfmdL9i3MeTTmPt,5Gyp41oLVo7Gg7vF4vpmggWP5MU70QO6,6,1,1,0,1,0,3,0,6,0.8571428571428571,1,0.0,0,1,0,1,1,0,0,3,0,2,4,1
6043,158719,AfqKObEuXEhKe7HKfvuLG5yfR6wayO2s,5Gyp41oLVo7Gg7vF4vpmggWP5MU70QO6,4,2,1,0,1,3,1,0,8,1.1428571428571428,1,0.0,0,1,0,1,2,3,0,1,0,2,6,1
6044,158742,ZKCE8IiEiAnUeDcb4cE1R1Dd1dkSRr7l,5Gyp41oLVo7Gg7vF4vpmggWP5MU70QO6,1,0,0,0,0,0,1,0,1,0.14285714285714285,1,0.0,0,0,0,0,0,0,0,1,0,0,1,1
6045,158745,j6kVkVGKYZT7ozL2NE5rOIexD3a1ewYn,5Gyp41oLVo7Gg7vF4vpmggWP5MU70QO6,18,28,15,0,10,0,4,0,57,8.142857142857142,4,0.0,4,15,0,10,24,0,0,4,0,29,28,1
6046,158767,Y9GqNI8HKN8AZelF8dSXK2b9zuzFq9b9,5Gyp41oLVo7Gg7vF4vpmggWP5MU70QO6,1,0,0,0,0,0,1,0,1,0.14285714285714285,1,0.0,0,0,0,0,0,0,0,1,0,0,1,1
6047,158773,Qz8c2nguCNNLZ9pqTyROsw55vrPvMhBX,5Gyp41oLVo7Gg7vF4vpmggWP5MU70QO6,1,0,0,0,0,0,1,0,1,0.14285714285714285,1,0.0,0,0,0,0,0,0,0,1,0,0,1,1
6048,158786,xbOq1vQjtSXkblyY2nHeiP49AGiDrHEq,5Gyp41oLVo7Gg7vF4vpmggWP5MU70QO6,9,5,2,0,2,0,3,1,13,1.8571428571428572,1,0.0,0,2,0,2,5,0,0,3,1,4,9,1
6049,158787,cqgRy8cKV9KWJxlMsO4aIE8n8O67vbnc,5Gyp41oLVo7Gg7vF4vpmggWP5MU70QO6,1,0,0,0,0,0,1,0,1,0.14285714285714285,1,0.0,0,0,0,0,0,0,0,1,0,0,1,1
6050,158800,y4h2O96Qbtxic4CWRw5MpvxobIWcm5af,5Gyp41oLVo7Gg7vF4vpmggWP5MU70QO6,1,0,0,0,0,0,1,0,1,0.14285714285714285,1,0.0,0,0,0,0,0,0,0,1,0,0,1,0
6051,158801,aK8nJQFJ6r54m0ZnhsCvwO5IU3VoJh3J,5Gyp41oLVo7Gg7vF4vpmggWP5MU70QO6,6,3,2,0,2,0,1,0,8,1.1428571428571428,1,0.0,0,2,0,2,3,0,0,1,0,4,4,1
6052,158803,SkZlhcjqZI4qlpvHtuOmZh7bgPo5Ar9M,5Gyp41oLVo7Gg7vF4vpmggWP5MU70QO6,1,0,0,0,0,0,1,0,1,0.14285714285714285,1,0.0,0,0,0,0,0,0,0,1,0,0,1,1
6053,158816,QAaGqoCRVYYJLVC9SEo8gPzESLmuOfNy,5Gyp41oLVo7Gg7vF4vpmggWP5MU70QO6,7,7,5,0,4,0,2,0,18,2.5714285714285716,2,0.0,0,5,0,4,7,0,0,2,0,9,9,1
6054,158825,11kRNihr0NAT65KuJwbNyDYQBbxmyBN8,5Gyp41oLVo7Gg7vF4vpmggWP5MU70QO6,1,0,0,0,0,0,1,0,1,0.14285714285714285,1,0.0,0,0,0,0,0,0,0,1,0,0,1,1
6055,158836,IqTYyD7L0euRgN3diEzqrprrc2W9uyF6,5Gyp41oLVo7Gg7vF4vpmggWP5MU70QO6,1,0,0,0,0,0,1,0,1,0.14285714285714285,1,0.0,0,0,0,0,0,0,0,1,0,0,1,1
6056,158845,ttGUUk3v7K6K40muYhPlMRiZFKv5tO0S,5Gyp41oLVo7Gg7vF4vpmggWP5MU70QO6,10,22,7,0,5,19,6,2,61,8.714285714285714,2,0.0,11,7,0,5,11,19,0,6,2,23,38,1
6057,158852,O5FAv2WJ9y2Iw3ydNqVb8wtG4rpJE8Qp,5Gyp41oLVo7Gg7vF4vpmggWP5MU70QO6,5,2,1,0,1,0,2,0,6,0.8571428571428571,1,0.0,0,1,0,1,2,0,0,2,0,2,4,1
6058,158854,UEdPzk5lpERU6G2eKfLVYTTH6XB7mNs4,5Gyp41oLVo7Gg7vF4vpmggWP5MU70QO6,4,3,0,0,0,0,2,0,5,0.7142857142857143,1,0.0,0,0,0,0,3,0,0,2,0,0,5,1
6059,158879,u3uODDQpEAolitLmmjyCLIJGPgvL6DtJ,5Gyp41oLVo7Gg7vF4vpmggWP5MU70QO6,10,15,6,0,3,1,5,0,30,4.285714285714286,2,0.0,1,6,0,3,14,1,0,5,0,10,20,1
6060,158899,IU3vKWuiW6wCWOTUkaeGx6t4iWGP45U9,5Gyp41oLVo7Gg7vF4vpmggWP5MU70QO6,9,12,4,10,2,0,2,0,30,4.285714285714286,1,0.0,6,4,5,2,6,0,5,2,0,17,13,1
6061,158910,ZNtimub0Pnr6wqfsPPl3Sbndp7E26Wcv,5Gyp41oLVo7Gg7vF4vpmggWP5MU70QO6,5,5,0,0,0,0,2,0,7,1.0,1,0.0,0,0,0,0,5,0,0,2,0,0,7,1
6062,158946,pg6dNcT7XD6y7ZZgUgbDLgNz6s04xyRX,5Gyp41oLVo7Gg7vF4vpmggWP5MU70QO6,1,0,0,0,0,0,1,0,1,0.14285714285714285,1,0.0,0,0,0,0,0,0,0,1,0,0,1,1
6063,158958,uiNG5J16zJ9t1Kkj0d6RAfq7YahYnDSP,5Gyp41oLVo7Gg7vF4vpmggWP5MU70QO6,3,2,1,0,0,0,1,0,4,0.5714285714285714,1,0.0,0,1,0,0,2,0,0,1,0,1,3,1
6064,158966,aRBsP3RNC28m05qU4AuLdcShaMIKbk0T,5Gyp41oLVo7Gg7vF4vpmggWP5MU70QO6,4,2,0,0,1,0,2,0,5,0.7142857142857143,2,0.0,0,0,0,1,2,0,0,2,0,1,4,1
6065,158968,MJQ9fDBlASWun8zwf4Tzkw3mhN2vL079,5Gyp41oLVo7Gg7vF4vpmggWP5MU70QO6,6,4,3,0,3,0,1,0,11,1.5714285714285714,1,0.0,0,3,0,3,4,0,0,1,0,6,5,1
6066,158985,rm52Ts2OWqvT4Vv3xYPH49SI4hdPJFK7,5Gyp41oLVo7Gg7vF4vpmggWP5MU70QO6,6,5,3,0,1,0,2,0,11,1.5714285714285714,2,0.0,0,3,0,1,5,0,0,2,0,4,7,1
6067,158994,MkldcyT3fi43Q6hm3R8ytVSF6gTGp4B6,5Gyp41oLVo7Gg7vF4vpmggWP5MU70QO6,10,7,2,6,2,0,2,0,19,2.7142857142857144,1,0.0,3,2,4,2,4,0,2,2,0,11,8,1
6068,159020,ss112lznmTTi1F5ygDUn8Q7DXK4Lr60G,5Gyp41oLVo7Gg7vF4vpmggWP5MU70QO6,7,4,2,0,2,0,3,0,11,1.5714285714285714,1,0.0,0,2,0,2,4,0,0,3,0,4,7,1
6069,159079,SNiDuvy4k2MAVtt9cv0oUwtlEw7cNBTi,5Gyp41oLVo7Gg7vF4vpmggWP5MU70QO6,8,2,2,0,2,0,5,0,11,1.5714285714285714,1,0.0,0,2,0,2,2,0,0,5,0,4,7,0
6070,159082,wWgbRBmslbZN35SazWe1TBDDIPzRJTHP,5Gyp41oLVo7Gg7vF4vpmggWP5MU70QO6,1,0,0,0,0,0,1,0,1,0.14285714285714285,1,0.0,0,0,0,0,0,0,0,1,0,0,1,1
6071,159086,pMvcDr7ozoLQB2BowYw5E8bebetADaFB,5Gyp41oLVo7Gg7vF4vpmggWP5MU70QO6,1,0,0,0,0,0,1,0,1,0.14285714285714285,1,0.0,0,0,0,0,0,0,0,1,0,0,1,1
6072,159121,MCumU93NOEJEZgGjsdOCZ3frEeJLiSz8,5Gyp41oLVo7Gg7vF4vpmggWP5MU70QO6,7,10,4,0,2,0,4,0,20,2.857142857142857,2,0.0,4,4,0,2,6,0,0,4,0,10,10,1
6073,159247,o5uaFzVgRB6HZGhAqs7wLGbES9siaN1U,5Gyp41oLVo7Gg7vF4vpmggWP5MU70QO6,1,0,0,0,0,0,1,0,1,0.14285714285714285,1,0.0,0,0,0,0,0,0,0,1,0,0,1,1
6074,159250,uwiNEmfqjqQ8VnSzp11dqdzmq9E0v6wt,5Gyp41oLVo7Gg7vF4vpmggWP5MU70QO6,6,3,2,0,2,0,1,0,8,1.1428571428571428,1,0.0,0,2,0,2,3,0,0,1,0,4,4,1
6075,159293,DqSDsD0a7h5cIm6YV6lhbJNYg2dSjWOn,5Gyp41oLVo7Gg7vF4vpmggWP5MU70QO6,13,14,10,0,7,0,2,0,33,4.714285714285714,1,0.0,3,10,0,7,11,0,0,2,0,20,13,0
6076,159321,ExM9Lv23n8avgHjMrBycTC6XnL5xfxSf,5Gyp41oLVo7Gg7vF4vpmggWP5MU70QO6,6,3,2,0,2,0,1,0,8,1.1428571428571428,1,0.0,0,2,0,2,3,0,0,1,0,4,4,0
6077,159332,5x7PJKAlpwjJHVKa6EUCDUMMHmJ1P3I6,5Gyp41oLVo7Gg7vF4vpmggWP5MU70QO6,13,12,5,0,9,0,1,0,27,3.857142857142857,1,0.0,5,5,0,9,7,0,0,1,0,19,8,1
6078,159442,9zFbkWWvpkj5lTNTKw4CVexfRitoPB2s,5Gyp41oLVo7Gg7vF4vpmggWP5MU70QO6,10,7,5,0,4,0,3,0,19,2.7142857142857144,2,0.0,0,5,0,4,7,0,0,3,0,9,10,1
6079,159443,KFG6G55toGAeaWBt5UmyioW5n1NVxSjT,5Gyp41oLVo7Gg7vF4vpmggWP5MU70QO6,4,2,1,0,1,0,1,0,5,0.7142857142857143,1,0.0,0,1,0,1,2,0,0,1,0,2,3,1
6080,159470,iQo5RkVZ49BhRnWvwNkx46Qf4Btl7Mld,5Gyp41oLVo7Gg7vF4vpmggWP5MU70QO6,8,4,4,0,4,7,10,0,29,4.142857142857143,1,0.0,0,4,0,4,4,7,0,10,0,8,21,1
6081,159514,Rlh0CLP4VxcLN7b2ea5Tx2FXxIm69SzJ,5Gyp41oLVo7Gg7vF4vpmggWP5MU70QO6,1,0,0,0,0,0,3,0,3,0.42857142857142855,1,0.0,0,0,0,0,0,0,0,3,0,0,3,1
6082,159533,dBixMyB1zwngnxNe4g7FQP33nARkTGdD,5Gyp41oLVo7Gg7vF4vpmggWP5MU70QO6,11,8,4,3,1,0,2,0,18,2.5714285714285716,1,0.0,3,4,3,1,5,0,0,2,0,11,7,1
6083,159555,StVnBhGEHUacVEE9QqYiv43rhePbl3Ev,5Gyp41oLVo7Gg7vF4vpmggWP5MU70QO6,6,2,1,0,1,0,4,0,8,1.1428571428571428,1,0.0,0,1,0,1,2,0,0,4,0,2,6,1
6084,159621,5nF7gQcqoLIyo2zojM6XQZUTJgs5pdB5,5Gyp41oLVo7Gg7vF4vpmggWP5MU70QO6,6,5,2,2,1,0,2,0,12,1.7142857142857142,1,0.0,3,2,2,1,2,0,0,2,0,8,4,1
6085,159640,4bFhEzvRwZ7PdanfX4z6RakGNadHbLWJ,5Gyp41oLVo7Gg7vF4vpmggWP5MU70QO6,6,3,2,0,2,0,1,0,8,1.1428571428571428,1,0.0,0,2,0,2,3,0,0,1,0,4,4,1
6086,159668,r0yZNwEG828V0TMkCl61Reya5Y5HO5aR,5Gyp41oLVo7Gg7vF4vpmggWP5MU70QO6,29,108,31,42,26,28,18,0,253,36.142857142857146,8,0.0,27,31,24,26,81,28,18,18,0,108,145,1
6087,159701,A9rYFlzCgttvzhslfm7OUVPZpZiJJf0K,5Gyp41oLVo7Gg7vF4vpmggWP5MU70QO6,1,0,0,0,0,0,1,0,1,0.14285714285714285,1,0.0,0,0,0,0,0,0,0,1,0,0,1,1
6088,159714,DwNOCMUuBk1Sx3txS2QF8DIdqY152Zxm,5Gyp41oLVo7Gg7vF4vpmggWP5MU70QO6,1,0,0,0,0,0,1,0,1,0.14285714285714285,1,0.0,0,0,0,0,0,0,0,1,0,0,1,1
6089,159769,MDdhn4ypSdCL9rtPmmJxa6as45ud6vdU,5Gyp41oLVo7Gg7vF4vpmggWP5MU70QO6,7,3,2,0,2,0,2,0,9,1.2857142857142858,1,0.0,0,2,0,2,3,0,0,2,0,4,5,1
6090,159782,4D3Mr9GTnnSeHqe4k4RduVTIffzivKXV,5Gyp41oLVo7Gg7vF4vpmggWP5MU70QO6,16,19,8,0,9,0,1,0,37,5.285714285714286,1,0.0,9,8,0,9,10,0,0,1,0,26,11,1
6091,159833,9004rNJewJ39XaW2hk6oIhScWS9lZShw,5Gyp41oLVo7Gg7vF4vpmggWP5MU70QO6,22,18,10,14,4,1,6,1,54,7.714285714285714,2,0.0,6,10,9,4,12,1,5,6,1,29,25,1
6092,159837,wg2hD1uJp9o6wldft2AXmXetp4caKo6A,5Gyp41oLVo7Gg7vF4vpmggWP5MU70QO6,1,0,0,0,0,0,1,0,1,0.14285714285714285,1,0.0,0,0,0,0,0,0,0,1,0,0,1,1
6093,159900,UIvm4I88x5RkegSMmjCWI0Aa78hSxiI7,5Gyp41oLVo7Gg7vF4vpmggWP5MU70QO6,4,3,0,0,0,0,2,0,5,0.7142857142857143,1,0.0,0,0,0,0,3,0,0,2,0,0,5,1
6094,159915,PsnbKiLxwYQcdN1QgtL66LMiQGsGsFtT,5Gyp41oLVo7Gg7vF4vpmggWP5MU70QO6,6,3,2,0,2,0,1,0,8,1.1428571428571428,1,0.0,0,2,0,2,3,0,0,1,0,4,4,1
6095,159929,j1PmVnHtioi6Uez7oNPozWMLhg4Dtbeh,5Gyp41oLVo7Gg7vF4vpmggWP5MU70QO6,4,2,1,0,1,0,1,0,5,0.7142857142857143,1,0.0,0,1,0,1,2,0,0,1,0,2,3,1
6096,159934,8ySChdMhILkWrFidrAeAcbpscZk12bIK,5Gyp41oLVo7Gg7vF4vpmggWP5MU70QO6,9,5,2,0,2,0,7,2,18,2.5714285714285716,1,0.0,0,2,0,2,5,0,0,7,2,4,14,1
6097,159954,JVLI7A5lCC8vytnApAKqUt9UOeJAwcls,5Gyp41oLVo7Gg7vF4vpmggWP5MU70QO6,13,15,9,1,6,0,3,0,34,4.857142857142857,1,0.0,3,9,1,6,12,0,0,3,0,19,15,1
6098,159956,v5iApkmhvY5lJ00J4XwrZQIU8c5P9IaZ,5Gyp41oLVo7Gg7vF4vpmggWP5MU70QO6,4,0,0,0,0,1,8,0,9,1.2857142857142858,1,0.0,0,0,0,0,0,1,0,8,0,0,9,1
6099,159971,QI9EzexYPWHRHVCBGslgW0AvjHtPQ1QU,5Gyp41oLVo7Gg7vF4vpmggWP5MU70QO6,18,41,18,13,11,17,12,1,113,16.142857142857142,2,0.0,16,18,8,11,25,17,5,12,1,53,60,0
6100,159985,VXQ2SH5NpNeOdjfSqoTUSjd17dMyQU7B,5Gyp41oLVo7Gg7vF4vpmggWP5MU70QO6,5,2,1,0,1,0,3,0,7,1.0,1,0.0,0,1,0,1,2,0,0,3,0,2,5,0
6101,160002,M2SXUdkaWE8H9bWvYf0ecWlPhiTUs1C2,5Gyp41oLVo7Gg7vF4vpmggWP5MU70QO6,8,11,4,0,2,0,3,0,20,2.857142857142857,2,0.0,5,4,0,2,6,0,0,3,0,11,9,0
6102,160004,djqc16BoIC2pbpl3dfVzrOF8kdnGmVrv,5Gyp41oLVo7Gg7vF4vpmggWP5MU70QO6,6,2,1,0,1,1,3,0,8,1.1428571428571428,1,0.0,0,1,0,1,2,1,0,3,0,2,6,1
6103,160021,I53IHn49d9jA3ujannaQ1EL7fa34NUbN,5Gyp41oLVo7Gg7vF4vpmggWP5MU70QO6,1,0,0,0,0,0,2,0,2,0.2857142857142857,1,0.0,0,0,0,0,0,0,0,2,0,0,2,1
6104,160041,cTS1VRUiS4HLb1hYfBHS46ENH91IaUnD,5Gyp41oLVo7Gg7vF4vpmggWP5MU70QO6,9,5,3,0,1,1,9,3,22,3.142857142857143,1,0.0,1,3,0,1,4,1,0,9,3,5,17,1
6105,160071,x8IFjwCPBRlQP9uuBa1tGX8WpsXCLtes,5Gyp41oLVo7Gg7vF4vpmggWP5MU70QO6,12,6,3,0,3,1,5,1,19,2.7142857142857144,1,0.0,1,3,0,3,5,1,0,5,1,7,12,1
6106,160110,T98zNuyaq1c57UMY75g4KO1G5az00Coj,5Gyp41oLVo7Gg7vF4vpmggWP5MU70QO6,1,0,0,0,0,0,1,0,1,0.14285714285714285,1,0.0,0,0,0,0,0,0,0,1,0,0,1,1
6107,160116,QxsZiQs6l3WHXGZuWRTVrtDchLVSC6tb,5Gyp41oLVo7Gg7vF4vpmggWP5MU70QO6,1,0,0,0,0,0,1,0,1,0.14285714285714285,1,0.0,0,0,0,0,0,0,0,1,0,0,1,1
6108,160128,gbYUHxxKDGWDbytDUcXlcbADJemufrHf,5Gyp41oLVo7Gg7vF4vpmggWP5MU70QO6,1,0,0,0,0,0,1,0,1,0.14285714285714285,1,0.0,0,0,0,0,0,0,0,1,0,0,1,1
6109,160131,zIWANVeOfIJIdeHybRvCtwUcB98TTOpL,5Gyp41oLVo7Gg7vF4vpmggWP5MU70QO6,2,0,0,0,0,0,2,0,2,0.2857142857142857,1,0.0,0,0,0,0,0,0,0,2,0,0,2,1
6110,160135,sKzMNkDeHIi8syZ76swNfxxh91gZITsv,5Gyp41oLVo7Gg7vF4vpmggWP5MU70QO6,7,3,2,0,2,0,2,0,9,1.2857142857142858,1,0.0,0,2,0,2,3,0,0,2,0,4,5,1
6111,160139,bFjABbdR1dlTY9Y5AEt2waKTA1nARIIh,5Gyp41oLVo7Gg7vF4vpmggWP5MU70QO6,13,15,8,0,4,1,9,0,37,5.285714285714286,4,0.0,2,8,0,4,13,1,0,9,0,14,23,1
6112,160141,Dthitlv0F9zbzKpJAaiVYQaLDbO378Ad,5Gyp41oLVo7Gg7vF4vpmggWP5MU70QO6,8,5,3,0,1,0,4,0,13,1.8571428571428572,2,0.0,0,3,0,1,5,0,0,4,0,4,9,1
6113,160170,Lb9Gj7pPDc1QE23Bu2s3x3cOrKzxpjuK,5Gyp41oLVo7Gg7vF4vpmggWP5MU70QO6,13,19,13,0,7,0,10,1,50,7.142857142857143,4,0.0,0,13,0,7,19,0,0,10,1,20,30,1
6114,160205,4OkWc7AllK9B53ey36nbTO4aY8tdeeMj,5Gyp41oLVo7Gg7vF4vpmggWP5MU70QO6,6,4,2,0,1,0,5,0,12,1.7142857142857142,1,0.0,0,2,0,1,4,0,0,5,0,3,9,1
6115,160211,SJYgxGIZwGEovDKTbdgFGDB0NgYchbJQ,5Gyp41oLVo7Gg7vF4vpmggWP5MU70QO6,1,0,0,0,0,0,1,0,1,0.14285714285714285,1,0.0,0,0,0,0,0,0,0,1,0,0,1,1
6116,160234,9nglU8OgDtRacfs7a6WY4ICVbLFZTWEo,5Gyp41oLVo7Gg7vF4vpmggWP5MU70QO6,8,11,6,0,2,0,8,0,27,3.857142857142857,2,0.0,0,6,0,2,11,0,0,8,0,8,19,1
6117,160235,2jrpxtUIXsWPIVOxhzZkmXgvu9KlY2UV,5Gyp41oLVo7Gg7vF4vpmggWP5MU70QO6,10,7,4,0,1,2,10,1,25,3.5714285714285716,2,0.0,1,4,0,1,6,2,0,10,1,6,19,1
6118,160263,4DdK8TmenB23ZCgCZB7QoDxAHSAI2lo5,5Gyp41oLVo7Gg7vF4vpmggWP5MU70QO6,6,3,2,0,2,0,1,0,8,1.1428571428571428,1,0.0,0,2,0,2,3,0,0,1,0,4,4,1
6119,160267,lzRXPa2daOWcsGy08A8GxR3RWWZNjwrx,5Gyp41oLVo7Gg7vF4vpmggWP5MU70QO6,6,4,2,0,1,0,3,0,10,1.4285714285714286,2,0.0,0,2,0,1,4,0,0,3,0,3,7,1
6120,160270,CYT8FcwBIu8rFIWalrdbKzma2fAiNifJ,5Gyp41oLVo7Gg7vF4vpmggWP5MU70QO6,7,8,2,0,2,0,3,0,15,2.142857142857143,1,0.0,1,2,0,2,7,0,0,3,0,5,10,1
6121,160434,XBCkMYdRHaBwbyaKg5wVLPpzX1Jqu9p0,5X6FeZozNMgE2VRi3MJYjkkFK8SETtu2,1,0,0,0,0,0,1,0,1,0.14285714285714285,1,0.0,0,0,0,0,0,0,0,1,0,0,1,1
6122,160460,HE0yFYNeyW3jGh5EhXv7uoc6O18ATk5R,5X6FeZozNMgE2VRi3MJYjkkFK8SETtu2,5,2,1,0,1,0,2,0,6,0.8571428571428571,1,0.0,0,1,0,1,2,0,0,2,0,2,4,1
6123,160484,3dMTqy9UaX95tijarQCVCsrBbHtrB6FG,5X6FeZozNMgE2VRi3MJYjkkFK8SETtu2,7,2,1,0,1,1,6,2,13,1.8571428571428572,1,0.0,0,1,0,1,2,1,0,6,2,2,11,1
6124,160547,tux1nJHnpyqhcOoiw1MV4RnTUB7tHphL,3VkHkmOtom3jM2wCu94xgzzu1d6Dn7or,11,15,5,5,5,2,7,5,44,6.285714285714286,3,0.0,7,5,4,5,8,2,1,7,5,21,23,0
6125,160551,POGRFFRZzlPiBHiCHXnlCDCb459JTEzc,3VkHkmOtom3jM2wCu94xgzzu1d6Dn7or,16,38,12,8,14,2,4,0,78,11.142857142857142,2,0.0,13,12,7,14,25,2,1,4,0,46,32,1
6126,160553,e8LRAhAOFng89p8JJF7TiEnvKfbSN9ym,3VkHkmOtom3jM2wCu94xgzzu1d6Dn7or,16,13,7,8,5,5,9,0,47,6.714285714285714,1,0.0,4,7,6,5,9,5,2,9,0,22,25,1
6127,160559,yaIwB9oAZxRWa5unEH2OfjYBy42G5Xep,3VkHkmOtom3jM2wCu94xgzzu1d6Dn7or,10,12,7,0,4,3,4,0,30,4.285714285714286,1,0.0,0,7,0,4,12,3,0,4,0,11,19,1
6128,160560,W5xMb1oaLltJC8m8QRzmcqQd0MnYQ67p,3VkHkmOtom3jM2wCu94xgzzu1d6Dn7or,1,0,0,0,0,0,2,0,2,0.2857142857142857,1,0.0,0,0,0,0,0,0,0,2,0,0,2,1
6129,160570,V3DfmcB8Lep37Vh5JmHjDDVz1sJceKfd,3VkHkmOtom3jM2wCu94xgzzu1d6Dn7or,6,3,1,0,0,0,11,0,15,2.142857142857143,2,0.0,0,1,0,0,3,0,0,11,0,1,14,1
6130,160572,ufk8FCBpI5vYfstuZlggO1Y28eb7bImN,3VkHkmOtom3jM2wCu94xgzzu1d6Dn7or,48,98,46,7,33,9,18,5,216,30.857142857142858,5,0.0,39,46,6,33,59,9,1,18,5,124,92,1
6131,160573,ON99TJ0pKRUnztHDcW3atf1KvDAtOgg0,3VkHkmOtom3jM2wCu94xgzzu1d6Dn7or,4,2,1,0,1,3,1,0,8,1.1428571428571428,1,0.0,0,1,0,1,2,3,0,1,0,2,6,1
6132,160579,fYoTVrGjUKZwCkGEQxj8tszSZ9oEr7BE,3VkHkmOtom3jM2wCu94xgzzu1d6Dn7or,7,3,2,0,1,4,5,1,16,2.2857142857142856,2,0.0,0,2,0,1,3,4,0,5,1,3,13,1
6133,160583,FjNocaCbEZVV6QnFhI2aCTLxYn49ydPr,3VkHkmOtom3jM2wCu94xgzzu1d6Dn7or,4,4,2,0,0,0,2,0,8,1.1428571428571428,2,0.0,0,2,0,0,4,0,0,2,0,2,6,1
6134,160587,E5AOt738rPpvgttJUJXTmXlvkPdwDRTT,3VkHkmOtom3jM2wCu94xgzzu1d6Dn7or,12,11,8,0,6,0,5,0,30,4.285714285714286,2,0.0,0,8,0,6,11,0,0,5,0,14,16,1
6135,160588,lPSI3MXEDOIZcEaSDr27uEjSntA5zsxV,3VkHkmOtom3jM2wCu94xgzzu1d6Dn7or,8,6,5,0,5,17,31,3,67,9.571428571428571,1,0.0,0,5,0,5,6,17,0,31,3,10,57,1
6136,160589,8xxdjMOkKKpGpEkgXEKryo7pYxyFO4br,3VkHkmOtom3jM2wCu94xgzzu1d6Dn7or,13,34,7,13,7,2,6,0,69,9.857142857142858,3,0.0,14,7,12,7,20,2,1,6,0,40,29,1
6137,160597,NsRniELODLBwlHTlgOJXYbjQ6DHqlBm3,3VkHkmOtom3jM2wCu94xgzzu1d6Dn7or,5,2,1,0,0,1,4,0,8,1.1428571428571428,1,0.0,0,1,0,0,2,1,0,4,0,1,7,1
6138,160599,Lts94kduN78OeA0WwV6B3SZh72BhrePm,3VkHkmOtom3jM2wCu94xgzzu1d6Dn7or,1,0,0,0,0,0,1,0,1,0.14285714285714285,1,0.0,0,0,0,0,0,0,0,1,0,0,1,1
6139,160600,spo2AoBcB8z4JnQ75NfCsXxxs58G8kjU,3VkHkmOtom3jM2wCu94xgzzu1d6Dn7or,2,0,0,0,0,0,2,0,2,0.2857142857142857,1,0.0,0,0,0,0,0,0,0,2,0,0,2,1
6140,160614,IwiyUREIy0Si5m4yLyehVgcNCLgljmxe,3VkHkmOtom3jM2wCu94xgzzu1d6Dn7or,1,0,0,0,0,0,2,0,2,0.2857142857142857,1,0.0,0,0,0,0,0,0,0,2,0,0,2,1
6141,160616,Ur5YqRaNsaD6KYfRfGA2p4Zmd8kpRITc,3VkHkmOtom3jM2wCu94xgzzu1d6Dn7or,27,61,13,14,22,0,3,0,113,16.142857142857142,2,0.0,42,13,14,22,19,0,0,3,0,91,22,1
6142,160617,hNzlmKj8vgcJBX1sWWjxRKB2qdgZF0wZ,3VkHkmOtom3jM2wCu94xgzzu1d6Dn7or,6,4,0,0,0,3,4,1,12,1.7142857142857142,1,0.0,0,0,0,0,4,3,0,4,1,0,12,1
6143,160629,F3SHG1z7OgoLXdkanDOsekC6CBMSi06b,3VkHkmOtom3jM2wCu94xgzzu1d6Dn7or,10,3,2,0,2,0,5,1,13,1.8571428571428572,1,0.0,0,2,0,2,3,0,0,5,1,4,9,1
6144,160631,fLFbYqgYkQPvS88S70VXHaI22Kt7HIqv,3VkHkmOtom3jM2wCu94xgzzu1d6Dn7or,17,20,13,0,11,0,5,0,49,7.0,3,0.0,2,13,0,11,18,0,0,5,0,26,23,0
6145,160634,uO6B8AZ3RktSZCnxuirzwVNISGYsGx5x,3VkHkmOtom3jM2wCu94xgzzu1d6Dn7or,2,0,0,0,0,0,2,0,2,0.2857142857142857,1,0.0,0,0,0,0,0,0,0,2,0,0,2,1
6146,160642,GpiN6lsRAa2Ly5yBnG0V8l5XBa7RReG2,3VkHkmOtom3jM2wCu94xgzzu1d6Dn7or,1,0,0,0,0,0,1,0,1,0.14285714285714285,1,0.0,0,0,0,0,0,0,0,1,0,0,1,1
6147,160647,L9bMFFUO9ZxDqzJhL0R1CsTNOo0vgnOe,3VkHkmOtom3jM2wCu94xgzzu1d6Dn7or,6,2,1,0,1,0,3,0,7,1.0,1,0.0,0,1,0,1,2,0,0,3,0,2,5,1
6148,160648,vn23DIWRrAEzn9fZbpdnHWjE4KJK94Gq,3VkHkmOtom3jM2wCu94xgzzu1d6Dn7or,1,0,0,0,0,0,1,0,1,0.14285714285714285,1,0.0,0,0,0,0,0,0,0,1,0,0,1,1
6149,160652,zhVJXmFLaEK3d9mnR8DIEZwnQXcgBVPh,3VkHkmOtom3jM2wCu94xgzzu1d6Dn7or,11,10,5,2,3,2,7,0,29,4.142857142857143,2,0.0,2,5,2,3,8,2,0,7,0,12,17,1
6150,160655,FmXADKmYeGxuiSES1esCMAyjWM6jBoqK,3VkHkmOtom3jM2wCu94xgzzu1d6Dn7or,5,2,1,0,1,0,3,0,7,1.0,1,0.0,0,1,0,1,2,0,0,3,0,2,5,1
6151,160657,pIa1D3wCDIb9b1KWIrcaDbP4NnyOfk1s,3VkHkmOtom3jM2wCu94xgzzu1d6Dn7or,1,0,0,0,0,0,1,0,1,0.14285714285714285,1,0.0,0,0,0,0,0,0,0,1,0,0,1,1
6152,160659,y5YQp7RAOiS0YZDSM8UkvactNfPZluHS,3VkHkmOtom3jM2wCu94xgzzu1d6Dn7or,5,2,1,0,1,0,2,0,6,0.8571428571428571,1,0.0,0,1,0,1,2,0,0,2,0,2,4,1
6153,160660,PZyZDM2uyBRGPZg3kQscavWjpR2bFYiU,3VkHkmOtom3jM2wCu94xgzzu1d6Dn7or,5,4,1,0,1,0,1,0,7,1.0,1,0.0,0,1,0,1,4,0,0,1,0,2,5,1
6154,160661,aqVmdMiZpCTrV5e1kemczDugNWjSn9Qa,3VkHkmOtom3jM2wCu94xgzzu1d6Dn7or,4,2,1,0,1,0,1,0,5,0.7142857142857143,1,0.0,0,1,0,1,2,0,0,1,0,2,3,1
6155,160667,upDfebJXS3DnZDQaslj5x1jzbdhtsJRw,3VkHkmOtom3jM2wCu94xgzzu1d6Dn7or,5,2,1,0,1,0,2,0,6,0.8571428571428571,1,0.0,0,1,0,1,2,0,0,2,0,2,4,1
6156,160717,Jov3UvG5K4pASWh5oCQTME29q3GomczT,SpATywNh6bZuzm8s1ceuBUnMUAeoAHHw,5,2,1,0,1,0,3,0,7,1.0,1,0.0,0,1,0,1,2,0,0,3,0,2,5,1
6157,160726,8E88mVxxHiSEV3ReMbiLkIuYAxJ6YXeO,bWdj2GDclj5ofokWjzoa5jAwMkxCykd6,5,3,2,0,1,0,1,0,7,1.0,1,0.0,0,2,0,1,3,0,0,1,0,3,4,1
6158,160732,MzU3MmP4toJ6yskX1OF0at1dK7zTkzfY,SpATywNh6bZuzm8s1ceuBUnMUAeoAHHw,24,23,6,19,6,0,12,1,67,9.571428571428571,1,0.0,4,6,16,6,19,0,3,12,1,32,35,0
6159,160751,tqKMiWS5jNidhKBAfVWKPtrUsR6QJ6KL,SpATywNh6bZuzm8s1ceuBUnMUAeoAHHw,1,0,0,0,0,0,1,0,1,0.14285714285714285,1,0.0,0,0,0,0,0,0,0,1,0,0,1,1
6160,160754,8GLYZdO7UCSjonDyYGMLl1knruaKaWMX,SpATywNh6bZuzm8s1ceuBUnMUAeoAHHw,7,4,2,0,2,0,2,0,10,1.4285714285714286,1,0.0,0,2,0,2,4,0,0,2,0,4,6,1
6161,160766,WpwD79l1tHxSYGvzddD5jkm0kQD6YzUK,SpATywNh6bZuzm8s1ceuBUnMUAeoAHHw,34,36,2,33,1,1,6,1,80,11.428571428571429,2,0.0,0,2,31,1,36,1,2,6,1,34,46,0
6162,160782,ayXSJHlkjoyFUB4Y9YHZnlOXt35wvwwu,bWdj2GDclj5ofokWjzoa5jAwMkxCykd6,1,0,0,0,0,0,1,0,1,0.14285714285714285,1,0.0,0,0,0,0,0,0,0,1,0,0,1,0
6163,160795,rIZoWdOeGZeRfVMhTAsV9qUPMO6tuYZB,SpATywNh6bZuzm8s1ceuBUnMUAeoAHHw,8,4,2,0,2,0,2,0,10,1.4285714285714286,1,0.0,0,2,0,2,4,0,0,2,0,4,6,0
6164,160802,vaWLVKWyrsUzDV0qs20ZUq8M3VNW01Uk,SpATywNh6bZuzm8s1ceuBUnMUAeoAHHw,1,0,0,0,0,0,1,0,1,0.14285714285714285,1,0.0,0,0,0,0,0,0,0,1,0,0,1,1
6165,160806,NCIbndfMFM2iKF0OTJODt5hHOzzc7Cip,5X6FeZozNMgE2VRi3MJYjkkFK8SETtu2,5,2,1,0,1,0,2,0,6,0.8571428571428571,1,0.0,0,1,0,1,2,0,0,2,0,2,4,1
6166,160811,ycYabaRFVayOcZp1HtLrl0En4pTKGtZt,SpATywNh6bZuzm8s1ceuBUnMUAeoAHHw,1,0,0,0,0,0,1,0,1,0.14285714285714285,1,0.0,0,0,0,0,0,0,0,1,0,0,1,1
6167,160819,PMZJ7vxYEpwybeGWTMZuFimiDLzBBGfH,SpATywNh6bZuzm8s1ceuBUnMUAeoAHHw,4,2,1,0,1,0,1,0,5,0.7142857142857143,1,0.0,0,1,0,1,2,0,0,1,0,2,3,0
6168,160830,oob3uoRmVlrLelgs4IyBNCaSMyry4nil,SpATywNh6bZuzm8s1ceuBUnMUAeoAHHw,4,3,1,0,1,0,1,0,6,0.8571428571428571,1,0.0,0,1,0,1,3,0,0,1,0,2,4,0
6169,160841,uugcqDT99r37esUG18otF2qi3eWqvBzw,bWdj2GDclj5ofokWjzoa5jAwMkxCykd6,3,2,0,0,0,0,1,0,3,0.42857142857142855,1,0.0,0,0,0,0,2,0,0,1,0,0,3,1
6170,160843,OGCZFcT7KAxnQBI1KHMJM1XRttzsLllz,SpATywNh6bZuzm8s1ceuBUnMUAeoAHHw,1,0,0,0,0,0,1,0,1,0.14285714285714285,1,0.0,0,0,0,0,0,0,0,1,0,0,1,0
6171,160869,d6UIJk9NUDRN8JabPVMRicFHGb3nzVOP,SpATywNh6bZuzm8s1ceuBUnMUAeoAHHw,2,0,0,0,0,0,2,0,2,0.2857142857142857,1,0.0,0,0,0,0,0,0,0,2,0,0,2,1
6172,160873,tyipDckPuzvrGCZj8cKFnXKzo4Vg29Em,SpATywNh6bZuzm8s1ceuBUnMUAeoAHHw,3,0,0,0,0,0,4,0,4,0.5714285714285714,1,0.0,0,0,0,0,0,0,0,4,0,0,4,1
6173,160899,8PXiKfJoqz8Hmb7EnbWamVfqw2MPOhjw,SpATywNh6bZuzm8s1ceuBUnMUAeoAHHw,1,0,0,0,0,0,1,0,1,0.14285714285714285,1,0.0,0,0,0,0,0,0,0,1,0,0,1,1
6174,160908,UtNvwiEIu7iQRo2Po9FxglHJbAYaDW68,bWdj2GDclj5ofokWjzoa5jAwMkxCykd6,4,2,0,0,0,0,2,0,4,0.5714285714285714,1,0.0,0,0,0,0,2,0,0,2,0,0,4,0
6175,160916,Rgv9cfcWYCSiDg97xzG0SSFr5zlG94CN,SpATywNh6bZuzm8s1ceuBUnMUAeoAHHw,4,3,0,0,0,0,4,0,7,1.0,1,0.0,0,0,0,0,3,0,0,4,0,0,7,0
6176,160933,FST1alg2W8P1xoNNnUXxqeytGPkod2O2,bWdj2GDclj5ofokWjzoa5jAwMkxCykd6,2,0,0,0,0,0,4,0,4,0.5714285714285714,1,0.0,0,0,0,0,0,0,0,4,0,0,4,1
6177,160946,ncZpzPYvUtQjJgcrnY99CiTzo4JQVsl8,5X6FeZozNMgE2VRi3MJYjkkFK8SETtu2,6,6,4,0,2,0,4,0,16,2.2857142857142856,2,0.0,0,4,0,2,6,0,0,4,0,6,10,1
6178,160960,q5GRE4iMJnU5VlaBu2tBq8kc3M9ewWuy,bWdj2GDclj5ofokWjzoa5jAwMkxCykd6,7,5,3,0,2,0,4,0,14,2.0,1,0.0,0,3,0,2,5,0,0,4,0,5,9,1
6179,161007,1b3NSfxfxI6DroelosS7m4rEEtzhJZdR,SpATywNh6bZuzm8s1ceuBUnMUAeoAHHw,1,0,0,0,0,0,1,0,1,0.14285714285714285,1,0.0,0,0,0,0,0,0,0,1,0,0,1,1
6180,161026,CetRT5zy2dJHyaPU2zMnW0reXnT8Dv2y,SpATywNh6bZuzm8s1ceuBUnMUAeoAHHw,5,2,1,0,1,0,2,0,6,0.8571428571428571,1,0.0,0,1,0,1,2,0,0,2,0,2,4,0
6181,161038,O3s5tRj8DFxm9UNNiXCCBZ18BghuFmc4,SpATywNh6bZuzm8s1ceuBUnMUAeoAHHw,5,2,1,0,1,0,2,0,6,0.8571428571428571,1,0.0,0,1,0,1,2,0,0,2,0,2,4,1
6182,161065,2JYViuOLvusjF5jXM0OPt6GS91aIip1x,SpATywNh6bZuzm8s1ceuBUnMUAeoAHHw,7,11,5,0,2,0,2,0,20,2.857142857142857,1,0.0,0,5,0,2,11,0,0,2,0,7,13,1
6183,161093,arNPxppCkzMz1gGc2TmsQpnfYJBVyy0s,SpATywNh6bZuzm8s1ceuBUnMUAeoAHHw,2,0,0,0,0,0,2,0,2,0.2857142857142857,1,0.0,0,0,0,0,0,0,0,2,0,0,2,1
6184,161094,eQpeedcGPvRtB1QbHe05ACFjTUBxB0ZU,SpATywNh6bZuzm8s1ceuBUnMUAeoAHHw,48,80,38,51,22,68,39,0,298,42.57142857142857,4,0.0,26,38,44,22,54,68,7,39,0,130,168,0
6185,161097,SMrxJLFhYhaOOjtJi52Arp2l9UXKs7cW,SpATywNh6bZuzm8s1ceuBUnMUAeoAHHw,7,5,2,0,2,0,2,0,11,1.5714285714285714,1,0.0,0,2,0,2,5,0,0,2,0,4,7,0
6186,161100,xo7oGzW3nYlhgIgUWC4ru6wx9F159DbL,SpATywNh6bZuzm8s1ceuBUnMUAeoAHHw,6,5,3,0,1,0,2,0,11,1.5714285714285714,1,0.0,0,3,0,1,5,0,0,2,0,4,7,0
6187,161119,UAE7k3whY8BUnHHgiIeFo6Rzc8eEYhRN,A3fsA9Zfv1X2fVEQhTw51lKENdNrEqT3,5,3,1,0,1,0,2,0,7,1.0,1,0.0,0,1,0,1,3,0,0,2,0,2,5,1
6188,161131,qwqKZAQkfeWQ67eZcwQZ2Pew9z9DtY1Q,5X6FeZozNMgE2VRi3MJYjkkFK8SETtu2,4,0,0,0,0,0,3,1,4,0.5714285714285714,1,0.0,0,0,0,0,0,0,0,3,1,0,4,1
6189,161136,OqHA9mZmMht3i9Un3rbhhtIvmbOSfs4Z,SpATywNh6bZuzm8s1ceuBUnMUAeoAHHw,6,3,1,0,1,0,2,0,7,1.0,1,0.0,0,1,0,1,3,0,0,2,0,2,5,1
6190,161138,1yAfuEW0CNQiRXnPO0v79LFUyx4hhTWm,SpATywNh6bZuzm8s1ceuBUnMUAeoAHHw,2,0,0,0,0,0,2,0,2,0.2857142857142857,1,0.0,0,0,0,0,0,0,0,2,0,0,2,0
6191,161139,zX1TLWT3E7MpbG4kzvZO6rEOvxyi9iAE,A3fsA9Zfv1X2fVEQhTw51lKENdNrEqT3,8,4,3,0,3,0,1,0,11,1.5714285714285714,1,0.0,0,3,0,3,4,0,0,1,0,6,5,0
6192,161149,dxSpsLbxmhgsxHbYO6vXC8uZhMZfZoZS,SpATywNh6bZuzm8s1ceuBUnMUAeoAHHw,9,3,3,0,3,0,5,1,15,2.142857142857143,2,0.0,0,3,0,3,3,0,0,5,1,6,9,1
6193,161152,FKqGzWb3VsmU7jpYPJbCVaVAzRrOMrbY,SpATywNh6bZuzm8s1ceuBUnMUAeoAHHw,4,2,0,0,0,0,5,0,7,1.0,1,0.0,0,0,0,0,2,0,0,5,0,0,7,0
6194,161161,KiMSMY3t4vpg2Jm87S0dTTvy9nzys8P4,SpATywNh6bZuzm8s1ceuBUnMUAeoAHHw,6,4,1,0,1,0,2,0,8,1.1428571428571428,1,0.0,0,1,0,1,4,0,0,2,0,2,6,1
6195,161168,KVaAyVapZn7TCcVPpLWhPyp5FohYKlip,5X6FeZozNMgE2VRi3MJYjkkFK8SETtu2,6,10,2,0,3,0,4,1,20,2.857142857142857,1,0.0,7,2,0,3,3,0,0,4,1,12,8,1
6196,161212,CQ38E7dWWAGhaKdf2HW2bq2TNjrXL8X5,bWdj2GDclj5ofokWjzoa5jAwMkxCykd6,8,5,3,0,2,0,4,0,14,2.0,1,0.0,0,3,0,2,5,0,0,4,0,5,9,1
6197,161218,IoUEv205kL70u2MwbYRNexNGlv0hD8vn,SpATywNh6bZuzm8s1ceuBUnMUAeoAHHw,9,10,5,9,0,0,1,0,25,3.5714285714285716,1,0.0,4,5,8,0,6,0,1,1,0,17,8,1
6198,161220,zWs820lsV2FDqGxLhLdDwGTeCBmo6dtP,A3fsA9Zfv1X2fVEQhTw51lKENdNrEqT3,9,9,0,0,0,0,10,0,19,2.7142857142857144,2,0.0,0,0,0,0,9,0,0,10,0,0,19,0
6199,161234,9OJ5A7uGdzNYawJUDofemHIUlKea4Sz4,A3fsA9Zfv1X2fVEQhTw51lKENdNrEqT3,1,0,0,0,0,0,1,0,1,0.14285714285714285,1,0.0,0,0,0,0,0,0,0,1,0,0,1,1
6200,161259,Y3gsCZFaxymMatDWsWatKuPgHf7K4ip1,SpATywNh6bZuzm8s1ceuBUnMUAeoAHHw,2,0,0,0,0,0,2,0,2,0.2857142857142857,1,0.0,0,0,0,0,0,0,0,2,0,0,2,0
6201,161260,UCfUKOyK5uUjEk3TmCgOz7fzBa03NWgI,SpATywNh6bZuzm8s1ceuBUnMUAeoAHHw,2,0,0,0,0,0,2,0,2,0.2857142857142857,1,0.0,0,0,0,0,0,0,0,2,0,0,2,1
6202,161288,b2XDhIVbFblOcApbzil5AzxhyGQXvGyd,SpATywNh6bZuzm8s1ceuBUnMUAeoAHHw,2,0,0,0,0,0,2,0,2,0.2857142857142857,1,0.0,0,0,0,0,0,0,0,2,0,0,2,1
6203,161295,c1dkmvtCXqoLmdO0DrAflEy9543BIWEo,SpATywNh6bZuzm8s1ceuBUnMUAeoAHHw,1,0,0,0,0,0,1,0,1,0.14285714285714285,1,0.0,0,0,0,0,0,0,0,1,0,0,1,1
6204,161323,bJL9tMKUGb25WAZwIxllLNRiypLk0j5b,bWdj2GDclj5ofokWjzoa5jAwMkxCykd6,1,0,0,0,0,0,3,0,3,0.42857142857142855,1,0.0,0,0,0,0,0,0,0,3,0,0,3,1
6205,161347,3xYJeK1UnxabH81MSfXfKVYAvC2wbZN0,SpATywNh6bZuzm8s1ceuBUnMUAeoAHHw,2,0,0,0,0,0,2,0,2,0.2857142857142857,1,0.0,0,0,0,0,0,0,0,2,0,0,2,1
6206,161359,SwqoqjW0TNnc2WEyycy2rbxki7Ac08G0,bWdj2GDclj5ofokWjzoa5jAwMkxCykd6,1,0,0,0,0,0,1,0,1,0.14285714285714285,1,0.0,0,0,0,0,0,0,0,1,0,0,1,1
6207,161368,vkVcAL32x89gCUbijn0COpSie0zSVcTg,A3fsA9Zfv1X2fVEQhTw51lKENdNrEqT3,3,0,0,0,0,0,3,0,3,0.42857142857142855,1,0.0,0,0,0,0,0,0,0,3,0,0,3,1
6208,161411,wd0QkE7pIzOAfDrbcSy32eTspXTGk9O9,5X6FeZozNMgE2VRi3MJYjkkFK8SETtu2,1,0,0,0,0,0,1,0,1,0.14285714285714285,1,0.0,0,0,0,0,0,0,0,1,0,0,1,1
6209,161424,vVoYtG2vzUhg3qXoaTM1GNiznwKfFexh,A3fsA9Zfv1X2fVEQhTw51lKENdNrEqT3,10,7,2,0,2,0,4,1,16,2.2857142857142856,1,0.0,0,2,0,2,7,0,0,4,1,4,12,1
6210,161445,DeUewOzCdPyRhXnh51f0IFE7UZF18OTz,A3fsA9Zfv1X2fVEQhTw51lKENdNrEqT3,5,3,2,0,1,0,1,0,7,1.0,1,0.0,0,2,0,1,3,0,0,1,0,3,4,1
6211,161448,TqLkmogP9A8wj7y0peV7PS3deY5AXfKI,SpATywNh6bZuzm8s1ceuBUnMUAeoAHHw,1,0,0,0,0,0,1,0,1,0.14285714285714285,1,0.0,0,0,0,0,0,0,0,1,0,0,1,1
6212,161471,zaNSPOR4IS7zKdvjdYki2EBZZU490yUi,A3fsA9Zfv1X2fVEQhTw51lKENdNrEqT3,9,4,3,0,3,0,2,0,12,1.7142857142857142,1,0.0,0,3,0,3,4,0,0,2,0,6,6,0
6213,161486,04oY3yfeJmljGE9WXI2DTTCncGlWy3gp,A3fsA9Zfv1X2fVEQhTw51lKENdNrEqT3,9,6,5,0,4,0,5,0,20,2.857142857142857,1,0.0,0,5,0,4,6,0,0,5,0,9,11,0
6214,161492,oUmwVombS6NjLsRPIqFZmyPTr8sWT4gd,SpATywNh6bZuzm8s1ceuBUnMUAeoAHHw,13,9,1,4,1,0,4,2,21,3.0,1,0.0,2,1,3,1,7,0,1,4,2,7,14,1
6215,161507,YHCFD6ILIDjyRD7M7cIc3yLqAh9Ht9sk,SpATywNh6bZuzm8s1ceuBUnMUAeoAHHw,8,3,2,0,1,1,6,0,13,1.8571428571428572,1,0.0,0,2,0,1,3,1,0,6,0,3,10,1
6216,161520,MH2dufcdc5plwSw55pPAPhNOJ4cLMg4S,5X6FeZozNMgE2VRi3MJYjkkFK8SETtu2,1,0,0,0,0,0,1,0,1,0.14285714285714285,1,0.0,0,0,0,0,0,0,0,1,0,0,1,1
6217,161531,6HIBebNSnNEoSeekVShzxF3x0IcbgohT,bWdj2GDclj5ofokWjzoa5jAwMkxCykd6,1,0,0,0,0,0,1,0,1,0.14285714285714285,1,0.0,0,0,0,0,0,0,0,1,0,0,1,1
6218,161542,5BpbARnwXgpEbj3Ht3AkiPd8rcOlJGqp,A3fsA9Zfv1X2fVEQhTw51lKENdNrEqT3,14,9,7,0,7,3,8,0,34,4.857142857142857,1,0.0,0,7,0,7,9,3,0,8,0,14,20,1
6219,161544,uEpHGx8FG6Yf4rfXG6TIX7HmCKO0iTmF,bWdj2GDclj5ofokWjzoa5jAwMkxCykd6,3,0,0,0,0,0,3,0,3,0.42857142857142855,1,0.0,0,0,0,0,0,0,0,3,0,0,3,1
6220,161547,RLNntF5rFo8KXK4eTpLpYQEgboayIABF,5X6FeZozNMgE2VRi3MJYjkkFK8SETtu2,12,32,9,16,4,0,5,0,66,9.428571428571429,3,0.0,10,9,13,4,22,0,3,5,0,36,30,1
6221,161554,VpfhwAal2QDOMcATeWkcMC5JFfWpIreN,SpATywNh6bZuzm8s1ceuBUnMUAeoAHHw,7,4,3,0,3,0,2,0,12,1.7142857142857142,1,0.0,0,3,0,3,4,0,0,2,0,6,6,0
6222,161567,5BpbARnwXgpEbj3Ht3AkiPd8rcOlJGqp,bWdj2GDclj5ofokWjzoa5jAwMkxCykd6,2,0,0,0,0,0,2,0,2,0.2857142857142857,1,0.0,0,0,0,0,0,0,0,2,0,0,2,1
6223,161582,sz4V6qMGkd9m0sEXeHagyrfOWbrJXBoa,A3fsA9Zfv1X2fVEQhTw51lKENdNrEqT3,13,6,5,0,5,0,3,0,19,2.7142857142857144,1,0.0,0,5,0,5,6,0,0,3,0,10,9,1
6224,161624,70IALIEGaW8EtZk6S4KeyPiqgaOEQ4Zv,SpATywNh6bZuzm8s1ceuBUnMUAeoAHHw,2,0,0,0,0,0,4,0,4,0.5714285714285714,1,0.0,0,0,0,0,0,0,0,4,0,0,4,0
6225,161625,RK0jz5WZ1rbgqGh2azNn9bq0VP0jJWBp,SpATywNh6bZuzm8s1ceuBUnMUAeoAHHw,5,3,0,0,0,0,2,0,5,0.7142857142857143,1,0.0,0,0,0,0,3,0,0,2,0,0,5,1
6226,161642,zT5Abo7SNHsAkCFKMvhJJJDWNu2sl4mh,bWdj2GDclj5ofokWjzoa5jAwMkxCykd6,6,6,1,0,0,1,6,0,14,2.0,1,0.0,0,1,0,0,6,1,0,6,0,1,13,1
6227,161649,4GMbKnTV7f2uA3paM09GNAdyVnypDTbs,5X6FeZozNMgE2VRi3MJYjkkFK8SETtu2,23,38,2,34,10,0,5,0,89,12.714285714285714,2,0.0,26,2,31,10,12,0,3,5,0,69,20,1
6228,161651,duiafYmd83oRbyknFPTBEW7Isdk2COdZ,A3fsA9Zfv1X2fVEQhTw51lKENdNrEqT3,6,2,1,0,1,0,4,1,9,1.2857142857142858,2,0.0,0,1,0,1,2,0,0,4,1,2,7,1
6229,161663,BPNm4UxYP3nT4mXqQKvGW9qF5RBHsWqc,SpATywNh6bZuzm8s1ceuBUnMUAeoAHHw,4,2,1,0,0,0,2,0,5,0.7142857142857143,1,0.0,0,1,0,0,2,0,0,2,0,1,4,1
6230,161671,Rlp934Hm4YHO5gcLihEiFevqZ5FBvHF8,SpATywNh6bZuzm8s1ceuBUnMUAeoAHHw,15,30,1,0,1,0,4,0,36,5.142857142857143,2,0.0,0,1,0,1,30,0,0,4,0,2,34,0
6231,161688,m9Qm8mLtAjxJkCkfPktOdlTYWgPjs32n,A3fsA9Zfv1X2fVEQhTw51lKENdNrEqT3,1,0,0,0,0,0,1,0,1,0.14285714285714285,1,0.0,0,0,0,0,0,0,0,1,0,0,1,1
6232,161702,wT2PCRFj23I7HDSSujNYjrYVx91GnsP3,5X6FeZozNMgE2VRi3MJYjkkFK8SETtu2,9,6,4,0,3,0,2,0,15,2.142857142857143,1,0.0,1,4,0,3,5,0,0,2,0,8,7,1
6233,161731,dhx591nKY6SWOCES2fET5BrfIJeIVgiB,5X6FeZozNMgE2VRi3MJYjkkFK8SETtu2,6,1,1,0,1,0,4,0,7,1.0,1,0.0,0,1,0,1,1,0,0,4,0,2,5,1
6234,161736,QnyfwZyfjleoLWOw3jVeDLlIVv3UkBPV,A3fsA9Zfv1X2fVEQhTw51lKENdNrEqT3,66,23,13,168,3,18,28,2,255,36.42857142857143,1,0.0,9,13,146,3,14,18,22,28,2,171,84,0
6235,161781,WbYmIN32kCZgmPLiKiqZkBoi6u7qfnP4,A3fsA9Zfv1X2fVEQhTw51lKENdNrEqT3,15,8,6,8,5,2,5,1,35,5.0,1,0.0,0,6,7,5,8,2,1,5,1,18,17,1
6236,161809,IW1yqY6AJLLD0UdkPHoBC5FNys4RF3Rc,A3fsA9Zfv1X2fVEQhTw51lKENdNrEqT3,3,2,0,0,0,0,2,0,4,0.5714285714285714,2,0.0,0,0,0,0,2,0,0,2,0,0,4,0
6237,161816,UA9f9Gmzx7Ooogr5DsTel41RFjYGmpHY,A3fsA9Zfv1X2fVEQhTw51lKENdNrEqT3,9,9,4,0,3,0,2,0,18,2.5714285714285716,1,0.0,0,4,0,3,9,0,0,2,0,7,11,1
6238,161856,MDFjVXgtYzZVyK4QPMD7X2zkYyaEYCUs,A3fsA9Zfv1X2fVEQhTw51lKENdNrEqT3,2,0,0,0,0,0,2,0,2,0.2857142857142857,1,0.0,0,0,0,0,0,0,0,2,0,0,2,0
6239,161885,OpzkfHewiSMfOmQKF5XpZzGA1W0RFLn9,5X6FeZozNMgE2VRi3MJYjkkFK8SETtu2,1,0,0,0,0,0,1,0,1,0.14285714285714285,1,0.0,0,0,0,0,0,0,0,1,0,0,1,1
6240,161891,Tld0Cp8nhQFMldHTc4wNbAWPalDRQyks,A3fsA9Zfv1X2fVEQhTw51lKENdNrEqT3,7,4,1,0,1,0,5,0,11,1.5714285714285714,1,0.0,0,1,0,1,4,0,0,5,0,2,9,1
6241,161989,QTUZiw3Jw7W7WAfaSZy42tMMiSl9TyEf,5X6FeZozNMgE2VRi3MJYjkkFK8SETtu2,6,2,0,0,0,0,7,1,10,1.4285714285714286,1,0.0,0,0,0,0,2,0,0,7,1,0,10,1
6242,162029,OUbrW18OgibVb4I41eHFiFhkobpgjEP2,A3fsA9Zfv1X2fVEQhTw51lKENdNrEqT3,49,26,24,0,22,0,3,0,75,10.714285714285714,2,0.0,0,24,0,22,26,0,0,3,0,46,29,0
6243,162030,Xipj7T5lLiw1KZ1W0l4R2RMWExB1p24F,A3fsA9Zfv1X2fVEQhTw51lKENdNrEqT3,1,0,0,0,0,0,1,0,1,0.14285714285714285,1,0.0,0,0,0,0,0,0,0,1,0,0,1,1
6244,162066,UORxoPAW78CaMQ97e33lObwUPeUxu7Pe,5X6FeZozNMgE2VRi3MJYjkkFK8SETtu2,6,6,2,0,2,0,3,0,13,1.8571428571428572,1,0.0,0,2,0,2,6,0,0,3,0,4,9,1
6245,162101,OtKlBJczZZ9HdAGTiOJJ8MePX1GCshtH,A3fsA9Zfv1X2fVEQhTw51lKENdNrEqT3,10,7,5,0,3,0,2,0,17,2.4285714285714284,1,0.0,0,5,0,3,7,0,0,2,0,8,9,1
6246,162127,ganxR6HGA35mA8rG8lqwM374IiEISz9t,A3fsA9Zfv1X2fVEQhTw51lKENdNrEqT3,1,0,0,0,0,0,1,0,1,0.14285714285714285,1,0.0,0,0,0,0,0,0,0,1,0,0,1,1
6247,162180,H2y5GoDHJ4wmWVWaUEfJWp7KoPtATjtS,A3fsA9Zfv1X2fVEQhTw51lKENdNrEqT3,1,0,0,0,0,0,1,0,1,0.14285714285714285,1,0.0,0,0,0,0,0,0,0,1,0,0,1,0
6248,162274,WjvGLSVrYi9V0QdvJaEuJKf33hyIxl38,A3fsA9Zfv1X2fVEQhTw51lKENdNrEqT3,2,0,0,0,0,1,1,0,2,0.2857142857142857,1,0.0,0,0,0,0,0,1,0,1,0,0,2,1
6249,162284,vcAIQrvSpc5jpQ7bCbnjOGeJTYapI81O,5X6FeZozNMgE2VRi3MJYjkkFK8SETtu2,1,0,0,0,0,0,1,0,1,0.14285714285714285,1,0.0,0,0,0,0,0,0,0,1,0,0,1,1
6250,162327,IY2XGmMLdQpnN2CAArJJlJXjbbQc8pm5,A3fsA9Zfv1X2fVEQhTw51lKENdNrEqT3,1,0,0,0,0,0,1,0,1,0.14285714285714285,1,0.0,0,0,0,0,0,0,0,1,0,0,1,1
6251,162349,zk5xG4pcHt1p18byPNiVKqMo96VaCzrd,A3fsA9Zfv1X2fVEQhTw51lKENdNrEqT3,6,1,1,0,1,0,6,0,9,1.2857142857142858,1,0.0,0,1,0,1,1,0,0,6,0,2,7,0
6252,162440,nxaczHF9lQRqN1CMkR3TcgnQsmf5O5ak,3VkHkmOtom3jM2wCu94xgzzu1d6Dn7or,4,2,1,0,1,0,1,0,5,0.7142857142857143,1,0.0,0,1,0,1,2,0,0,1,0,2,3,1
6253,162447,ZVURpQaazMitnYFMAbkQuPrH9TNZf1sy,3VkHkmOtom3jM2wCu94xgzzu1d6Dn7or,1,0,0,0,0,0,1,0,1,0.14285714285714285,1,0.0,0,0,0,0,0,0,0,1,0,0,1,1
6254,162486,4o8oFRzfQkVEw0BIiqicQA8RmeOEgsqb,3VkHkmOtom3jM2wCu94xgzzu1d6Dn7or,1,0,0,0,0,0,1,0,1,0.14285714285714285,1,0.0,0,0,0,0,0,0,0,1,0,0,1,1
6255,162498,yF9MXH4yBFaNzkeHhEwugParmE2tjGJ2,3VkHkmOtom3jM2wCu94xgzzu1d6Dn7or,8,2,1,0,1,0,6,1,11,1.5714285714285714,1,0.0,0,1,0,1,2,0,0,6,1,2,9,1
6256,162516,ox17FQMF44gCKSCdMI3aDt3HMnQOA1En,3VkHkmOtom3jM2wCu94xgzzu1d6Dn7or,6,2,1,0,1,0,6,0,10,1.4285714285714286,1,0.0,0,1,0,1,2,0,0,6,0,2,8,1
6257,162524,ZMZpmEOYjqi3PuNrDa9qC7SMGAO1RfMn,3VkHkmOtom3jM2wCu94xgzzu1d6Dn7or,2,0,0,0,0,0,2,0,2,0.2857142857142857,1,0.0,0,0,0,0,0,0,0,2,0,0,2,1
6258,162525,VuKnRHYrKL9qTcfMl51bpkebPNNIYpjU,3VkHkmOtom3jM2wCu94xgzzu1d6Dn7or,1,0,0,0,0,0,2,0,2,0.2857142857142857,1,0.0,0,0,0,0,0,0,0,2,0,0,2,1
6259,162533,i1weaEaafaiWi31Ms4bwoF6JM4IRf714,3VkHkmOtom3jM2wCu94xgzzu1d6Dn7or,6,5,3,0,2,0,4,0,14,2.0,3,0.0,0,3,0,2,5,0,0,4,0,5,9,1
6260,162538,1oncQhszk7F9F86Iu7dLWHgiUY5z8CKs,3VkHkmOtom3jM2wCu94xgzzu1d6Dn7or,1,0,0,0,0,0,1,0,1,0.14285714285714285,1,0.0,0,0,0,0,0,0,0,1,0,0,1,1
6261,162569,jsfwkzqF5Uv9m2DunSrE74XnYh9ND3OD,3VkHkmOtom3jM2wCu94xgzzu1d6Dn7or,1,0,0,0,0,0,1,0,1,0.14285714285714285,1,0.0,0,0,0,0,0,0,0,1,0,0,1,1
6262,162575,D6eOCZGhdodEIUvZxH12PiS70TaJdmcx,3VkHkmOtom3jM2wCu94xgzzu1d6Dn7or,1,0,0,0,0,0,1,0,1,0.14285714285714285,1,0.0,0,0,0,0,0,0,0,1,0,0,1,1
6263,162577,HJCW8zUVg09Eg230mK668iH5yjSli4EE,3VkHkmOtom3jM2wCu94xgzzu1d6Dn7or,1,0,0,0,0,0,1,0,1,0.14285714285714285,1,0.0,0,0,0,0,0,0,0,1,0,0,1,1
6264,162578,B04bEh4wvZOg7i7EW9b9kKxk3PCLcFBb,3VkHkmOtom3jM2wCu94xgzzu1d6Dn7or,1,0,0,0,0,0,2,0,2,0.2857142857142857,1,0.0,0,0,0,0,0,0,0,2,0,0,2,1
6265,162582,D2R3pPwD7a1prmPsDdVzQ9z7yXwv1C89,3VkHkmOtom3jM2wCu94xgzzu1d6Dn7or,1,0,0,0,0,0,1,0,1,0.14285714285714285,1,0.0,0,0,0,0,0,0,0,1,0,0,1,1
6266,162593,WSCktYZqeZlAr4CBsNsYbm97xd94qsUC,3VkHkmOtom3jM2wCu94xgzzu1d6Dn7or,3,5,0,0,0,0,1,0,6,0.8571428571428571,1,0.0,0,0,0,0,5,0,0,1,0,0,6,1
6267,162688,TfMiuu9vyAM0w8qFqC2lCZDreJEc3tGS,fbPkOYLVPtPgIt0MxizjfFJov3JbHyAi,2,0,0,0,0,0,6,0,6,0.8571428571428571,1,0.0,0,0,0,0,0,0,0,6,0,0,6,1
6268,162724,FGdh9HPOiTAfXZsL6lEzMEnHg7J5TRwT,5Gyp41oLVo7Gg7vF4vpmggWP5MU70QO6,1,0,0,0,0,0,1,0,1,0.14285714285714285,1,0.0,0,0,0,0,0,0,0,1,0,0,1,1
6269,162771,ssRnwmrFPp2w8rauG68PQC7q5Dnmmn2N,5Gyp41oLVo7Gg7vF4vpmggWP5MU70QO6,8,4,3,0,3,0,1,0,11,1.5714285714285714,1,0.0,0,3,0,3,4,0,0,1,0,6,5,1
6270,162828,xBFzqYj7zL8zEp5CYjAk76ik08Duknlp,5Gyp41oLVo7Gg7vF4vpmggWP5MU70QO6,5,2,1,0,1,0,4,0,8,1.1428571428571428,2,0.0,0,1,0,1,2,0,0,4,0,2,6,1
6271,162833,0XEdPp3w1uBYDQWPrz9gkZoYIRnTvyMJ,5Gyp41oLVo7Gg7vF4vpmggWP5MU70QO6,5,2,1,0,1,0,2,0,6,0.8571428571428571,1,0.0,0,1,0,1,2,0,0,2,0,2,4,1
6272,162838,yarIIX8WmyVXpsrhL9pB32FFf4ft3jZw,5Gyp41oLVo7Gg7vF4vpmggWP5MU70QO6,7,7,2,0,2,0,4,0,15,2.142857142857143,1,0.0,4,2,0,2,3,0,0,4,0,8,7,1
6273,162858,QiOW9TXJhtJN4Upe2lgfNCol4hcsuoG0,5Gyp41oLVo7Gg7vF4vpmggWP5MU70QO6,1,0,0,0,0,0,1,0,1,0.14285714285714285,1,0.0,0,0,0,0,0,0,0,1,0,0,1,1
6274,162879,eOM17mBlMQlBTkfbWTDTGHBTm3dD6ouv,5Gyp41oLVo7Gg7vF4vpmggWP5MU70QO6,1,0,0,0,0,0,1,0,1,0.14285714285714285,1,0.0,0,0,0,0,0,0,0,1,0,0,1,1
6275,162893,Z5Lqu6KlNXkxDiGVdPztKUtmARQE8v4L,5Gyp41oLVo7Gg7vF4vpmggWP5MU70QO6,13,16,7,2,4,0,6,1,36,5.142857142857143,1,0.0,3,7,1,4,13,0,1,6,1,15,21,1
6276,162895,YM9Z89N137bY5qphnaUaFSAicUvT78c0,5Gyp41oLVo7Gg7vF4vpmggWP5MU70QO6,1,0,0,0,0,0,1,0,1,0.14285714285714285,1,0.0,0,0,0,0,0,0,0,1,0,0,1,1
6277,162918,TJqPE04kRYVY9YYt84lPRwnjVxee9Pon,5Gyp41oLVo7Gg7vF4vpmggWP5MU70QO6,12,12,5,0,7,2,7,1,34,4.857142857142857,1,0.0,5,5,0,7,7,2,0,7,1,17,17,0
6278,162926,9XHHoSauXri3orblmJ9JFLzfmtRELpUB,5Gyp41oLVo7Gg7vF4vpmggWP5MU70QO6,10,12,7,5,3,1,4,0,32,4.571428571428571,1,0.0,3,7,3,3,9,1,2,4,0,16,16,1
6279,162927,FqxZInDGuTXmPgpy2HmrKGvUbRHydqL9,5Gyp41oLVo7Gg7vF4vpmggWP5MU70QO6,5,4,0,0,0,0,3,0,7,1.0,3,0.0,0,0,0,0,4,0,0,3,0,0,7,0
6280,162945,VLFgC7A4MAFfXbNuQP4gI0ZzVKAF55Dd,5Gyp41oLVo7Gg7vF4vpmggWP5MU70QO6,2,0,0,0,0,0,2,0,2,0.2857142857142857,1,0.0,0,0,0,0,0,0,0,2,0,0,2,1
6281,163127,t8ZEhvFH2BnmQYnifk2af72nBHnXSrH4,5X6FeZozNMgE2VRi3MJYjkkFK8SETtu2,6,7,2,0,2,0,3,0,14,2.0,2,0.0,2,2,0,2,5,0,0,3,0,6,8,1
6282,163130,Mms6sMIkW4Omst3uLD38oJJ4C0ZCQcDW,5X6FeZozNMgE2VRi3MJYjkkFK8SETtu2,1,0,0,0,0,0,1,0,1,0.14285714285714285,1,0.0,0,0,0,0,0,0,0,1,0,0,1,1
6283,163144,aRhm894PfzFLkP3cntp8AtlxvYw2TjcZ,5X6FeZozNMgE2VRi3MJYjkkFK8SETtu2,1,0,0,0,0,0,1,0,1,0.14285714285714285,1,0.0,0,0,0,0,0,0,0,1,0,0,1,1
6284,163258,z2cHyYlWiw7oxTsa0shPd3Lc7pBNdjgZ,5X6FeZozNMgE2VRi3MJYjkkFK8SETtu2,3,2,0,0,0,0,1,0,3,0.42857142857142855,1,0.0,0,0,0,0,2,0,0,1,0,0,3,1
6285,163511,i0ksX07HnsV5rQlWqOr1uKEuc7yNU24c,bWdj2GDclj5ofokWjzoa5jAwMkxCykd6,4,2,1,0,0,0,2,0,5,0.7142857142857143,1,0.0,0,1,0,0,2,0,0,2,0,1,4,1
6286,163664,75QwID9vkHNyAC3jIqeF9fNTGOKWDCMd,SpATywNh6bZuzm8s1ceuBUnMUAeoAHHw,18,28,1,29,0,1,1,0,60,8.571428571428571,1,0.0,9,1,23,0,19,1,6,1,0,33,27,0
6287,163698,pDVnQJMhWdSLNejm9F2A6uzPWohSMQmu,G8EPVSXsOYB5YQWZGiz1aVq5Pgr2GrQu,7,9,2,0,2,0,2,0,15,2.142857142857143,2,0.0,0,2,0,2,9,0,0,2,0,4,11,1
6288,163724,0YUJjVhFBVhA8wNUqY2rEXkCnd7riq8C,G8EPVSXsOYB5YQWZGiz1aVq5Pgr2GrQu,48,71,20,56,15,1,3,0,166,23.714285714285715,3,0.0,33,20,28,15,38,1,28,3,0,96,70,1
6289,164057,YKkBpxb8WAuGDSQU1z7LvNmikgJLWtZj,SpATywNh6bZuzm8s1ceuBUnMUAeoAHHw,6,5,0,0,0,0,1,0,6,0.8571428571428571,1,0.0,0,0,0,0,5,0,0,1,0,0,6,1
6290,164099,T0RArQ3lSZeSD0MbnDejlzkMufYho8lt,bWdj2GDclj5ofokWjzoa5jAwMkxCykd6,1,1,0,0,0,0,0,0,1,0.14285714285714285,1,0.0,0,0,0,0,1,0,0,0,0,0,1,1
6291,164462,gD7dR7qYBA1tFY5jHEs9UR01plTA8iId,SpATywNh6bZuzm8s1ceuBUnMUAeoAHHw,7,4,3,0,2,0,1,0,10,1.4285714285714286,1,0.0,0,3,0,2,4,0,0,1,0,5,5,0
6292,164613,EBMQHva9lsULDK4s7iJrovR7inTeu6Ks,SpATywNh6bZuzm8s1ceuBUnMUAeoAHHw,3,2,1,0,0,0,1,0,4,0.5714285714285714,1,0.0,0,1,0,0,2,0,0,1,0,1,3,1
6293,165347,oaoj9be4jW2Hot8wYgYrzLRvB0RU4KYy,RXDvfPUBYFlVdlueBFbLW0mhhAyGEqpt,3,2,1,0,0,0,1,0,4,0.5714285714285714,1,0.0,0,1,0,0,2,0,0,1,0,1,3,1
6294,165832,DsEUYz6X9eluw7uMTIk0Bks5jShm3Kz4,3VkHkmOtom3jM2wCu94xgzzu1d6Dn7or,5,3,2,0,2,0,1,0,8,1.1428571428571428,1,0.0,0,2,0,2,3,0,0,1,0,4,4,1
6295,165846,Dz9gcg38PEU0fPFKHBbhZdSYwftI3l5X,3VkHkmOtom3jM2wCu94xgzzu1d6Dn7or,4,2,1,0,1,0,1,0,5,0.7142857142857143,1,0.0,0,1,0,1,2,0,0,1,0,2,3,1
6296,165856,KAuI6A5sA3ZNhLENslgd2DMjOIVYSO57,3VkHkmOtom3jM2wCu94xgzzu1d6Dn7or,4,2,1,0,1,0,1,0,5,0.7142857142857143,1,0.0,0,1,0,1,2,0,0,1,0,2,3,1
6297,165860,VcIThiQQYy7X3fiKdorfTP06QuBPs7wb,3VkHkmOtom3jM2wCu94xgzzu1d6Dn7or,1,0,0,0,0,0,1,0,1,0.14285714285714285,1,0.0,0,0,0,0,0,0,0,1,0,0,1,1
6298,165870,iJ66ruppQ2ZGC9u9YoS6QTRYWukYIDHU,3VkHkmOtom3jM2wCu94xgzzu1d6Dn7or,4,2,1,0,1,0,1,0,5,0.7142857142857143,1,0.0,0,1,0,1,2,0,0,1,0,2,3,1
6299,165887,7fjHAZUsGh8E9GJNOmIK1zgkCrHxz6Gk,3VkHkmOtom3jM2wCu94xgzzu1d6Dn7or,4,2,1,0,1,0,1,0,5,0.7142857142857143,1,0.0,0,1,0,1,2,0,0,1,0,2,3,1
6300,165891,yoZNAuzIqGqES06DFjFVEjyfKc4SxTA2,3VkHkmOtom3jM2wCu94xgzzu1d6Dn7or,4,2,1,0,1,0,1,0,5,0.7142857142857143,1,0.0,0,1,0,1,2,0,0,1,0,2,3,1
6301,165899,hv7ufOIfPrDN5pcGE1HpmOksTENQn7IA,3VkHkmOtom3jM2wCu94xgzzu1d6Dn7or,3,0,0,0,0,2,7,0,9,1.2857142857142858,1,0.0,0,0,0,0,0,2,0,7,0,0,9,1
6302,165901,gs5hsE793p6vIwUmTj73hL5b3aFfrcXj,3VkHkmOtom3jM2wCu94xgzzu1d6Dn7or,5,2,1,0,1,0,2,0,6,0.8571428571428571,1,0.0,0,1,0,1,2,0,0,2,0,2,4,1
6303,165904,ZR3eaF7l6jay1l4TTUpJmfveN2PkauBJ,3VkHkmOtom3jM2wCu94xgzzu1d6Dn7or,4,0,0,0,0,0,7,1,8,1.1428571428571428,2,0.0,0,0,0,0,0,0,0,7,1,0,8,1
6304,165906,GSPOB3yRCsx1EoYGjPY73PCVbsYZcZfm,3VkHkmOtom3jM2wCu94xgzzu1d6Dn7or,8,15,6,5,5,3,3,0,37,5.285714285714286,2,0.0,7,6,4,5,8,3,1,3,0,22,15,1
6305,165907,mGZldDR5Izkdgn7Vr6A8rGIFa3IGgTNq,3VkHkmOtom3jM2wCu94xgzzu1d6Dn7or,1,0,0,0,0,0,1,0,1,0.14285714285714285,1,0.0,0,0,0,0,0,0,0,1,0,0,1,1
6306,165909,kfJTMMKERAVHubqtM8uKI9oGQ8qEzoGo,3VkHkmOtom3jM2wCu94xgzzu1d6Dn7or,4,2,1,0,1,0,1,0,5,0.7142857142857143,1,0.0,0,1,0,1,2,0,0,1,0,2,3,1
6307,165919,IjFWXq6Kv9kQBKxl05fLnKmzdzXFPd2S,3VkHkmOtom3jM2wCu94xgzzu1d6Dn7or,1,0,0,0,0,0,2,0,2,0.2857142857142857,1,0.0,0,0,0,0,0,0,0,2,0,0,2,1
6308,165971,No3uaZVX8QfUWi2WuoYFYrVrLQNiuZit,fbPkOYLVPtPgIt0MxizjfFJov3JbHyAi,8,10,4,0,2,0,2,0,18,2.5714285714285716,1,0.0,1,4,0,2,9,0,0,2,0,7,11,0
6309,165972,1FTDLU0hMqcHLpAYkeifJZgSteMYLeP4,fbPkOYLVPtPgIt0MxizjfFJov3JbHyAi,10,5,4,0,3,0,2,0,14,2.0,1,0.0,0,4,0,3,5,0,0,2,0,7,7,1
6310,166050,dTKURyZ9dyqGbe4l7wsUGgSU85JHBAFq,fbPkOYLVPtPgIt0MxizjfFJov3JbHyAi,6,3,2,0,1,0,2,0,8,1.1428571428571428,1,0.0,0,2,0,1,3,0,0,2,0,3,5,0
6311,166077,rDqSuJj6Apw3Hgcfl96B8dsl8lD8BDlC,fbPkOYLVPtPgIt0MxizjfFJov3JbHyAi,23,27,11,9,14,12,7,0,80,11.428571428571429,2,0.0,12,11,7,14,15,12,2,7,0,44,36,1
6312,166080,MF5edVvM6lCZDxnMdHelos9TUh3KERjn,fbPkOYLVPtPgIt0MxizjfFJov3JbHyAi,74,84,36,64,29,0,18,0,231,33.0,2,0.0,35,36,52,29,49,0,12,18,0,152,79,1
6313,166086,jRCJSAPNhDe7WpHS8MGlUFkXUl5Z0C2H,fbPkOYLVPtPgIt0MxizjfFJov3JbHyAi,8,9,4,0,4,0,3,0,20,2.857142857142857,2,0.0,3,4,0,4,6,0,0,3,0,11,9,0
6314,166089,jTx5Aeic95quxv16xi3lPn6zbo3fKZ1n,fbPkOYLVPtPgIt0MxizjfFJov3JbHyAi,7,3,2,0,2,0,2,0,9,1.2857142857142858,1,0.0,0,2,0,2,3,0,0,2,0,4,5,1
6315,166091,H9oUp5XbVBfpayovEZIOezZu2OYGsjY0,fbPkOYLVPtPgIt0MxizjfFJov3JbHyAi,12,30,12,0,0,0,10,0,52,7.428571428571429,1,0.0,0,12,0,0,30,0,0,10,0,12,40,1
6316,166092,XORqJOT0dzDcZsLmbsjEYVk8CWEPk4Bk,fbPkOYLVPtPgIt0MxizjfFJov3JbHyAi,11,6,4,0,2,1,9,1,23,3.2857142857142856,1,0.0,0,4,0,2,6,1,0,9,1,6,17,1
6317,166094,llK8fagyfMYNfzir66LDw2wK1aEVZzh8,fbPkOYLVPtPgIt0MxizjfFJov3JbHyAi,19,46,13,16,16,0,4,0,95,13.571428571428571,1,0.0,26,13,13,16,20,0,3,4,0,68,27,1
6318,166095,3mfG7fNRo2Olskcz8rvhDW564qOg3V1b,fbPkOYLVPtPgIt0MxizjfFJov3JbHyAi,2,0,0,0,0,0,2,0,2,0.2857142857142857,1,0.0,0,0,0,0,0,0,0,2,0,0,2,0
6319,166096,d2dMin38z1mvwoR5boGKYx3URnEXiseW,fbPkOYLVPtPgIt0MxizjfFJov3JbHyAi,8,7,3,0,1,0,2,0,13,1.8571428571428572,1,0.0,0,3,0,1,7,0,0,2,0,4,9,1
6320,166100,UU4bZ9dkx8XaNni7IsKElRXyqQ5agPiC,fbPkOYLVPtPgIt0MxizjfFJov3JbHyAi,1,0,0,0,0,0,1,0,1,0.14285714285714285,1,0.0,0,0,0,0,0,0,0,1,0,0,1,1
6321,166107,MY0jNTZ6QiVUHDF60H245aO9uCKq6peP,fbPkOYLVPtPgIt0MxizjfFJov3JbHyAi,10,6,4,0,3,0,4,0,17,2.4285714285714284,1,0.0,0,4,0,3,6,0,0,4,0,7,10,0
6322,166108,KEfjzEESeytjI3UZJcAYJSJQvmTeL6zl,fbPkOYLVPtPgIt0MxizjfFJov3JbHyAi,7,14,2,0,1,0,7,0,24,3.4285714285714284,2,0.0,2,2,0,1,12,0,0,7,0,5,19,1
6323,166109,z13ImFZvHgYdPVf9Fj2iJ55SJuiyT2fz,fbPkOYLVPtPgIt0MxizjfFJov3JbHyAi,2,0,0,0,0,0,2,0,2,0.2857142857142857,1,0.0,0,0,0,0,0,0,0,2,0,0,2,1
6324,166110,KPqQrTHq7UqL5k1ntnRrXkQR7MK7NLYL,fbPkOYLVPtPgIt0MxizjfFJov3JbHyAi,2,0,0,0,0,0,3,0,3,0.42857142857142855,1,0.0,0,0,0,0,0,0,0,3,0,0,3,1
6325,166289,GQO5pvF9fB0ke4HvwJNUQnKPfOMPwhu0,G8EPVSXsOYB5YQWZGiz1aVq5Pgr2GrQu,26,24,4,44,4,0,0,0,76,10.857142857142858,1,0.0,20,4,22,4,4,0,22,0,0,50,26,1
6326,166361,QWw1s7G2LDYzdw5hFh2RBbUqb52YVk7z,G8EPVSXsOYB5YQWZGiz1aVq5Pgr2GrQu,10,8,1,0,1,0,2,0,12,1.7142857142857142,1,0.0,1,1,0,1,7,0,0,2,0,3,9,0
6327,166555,mFcnZc9xJHpcsnNSqrnt1TraJ39cAeOG,5X6FeZozNMgE2VRi3MJYjkkFK8SETtu2,1,0,0,0,0,0,1,0,1,0.14285714285714285,1,0.0,0,0,0,0,0,0,0,1,0,0,1,1
6328,166625,fHuAxntSH65MvOE5PclQWU3EYpgmCRYz,5X6FeZozNMgE2VRi3MJYjkkFK8SETtu2,5,4,1,2,2,0,1,0,10,1.4285714285714286,1,0.0,2,1,2,2,2,0,0,1,0,7,3,1
6329,166678,aVeyGdrz6Ir4LmiLkJqBoRjG1lQ7MsV8,5X6FeZozNMgE2VRi3MJYjkkFK8SETtu2,6,25,6,0,1,2,5,0,39,5.571428571428571,4,0.0,9,6,0,1,16,2,0,5,0,16,23,1
6330,166784,AjRTjBqF69K8qynYqEW0T141KyGuqhS2,5X6FeZozNMgE2VRi3MJYjkkFK8SETtu2,7,6,0,0,0,2,12,1,21,3.0,1,0.0,0,0,0,0,6,2,0,12,1,0,21,1
6331,167049,3PdoM9BEkfijbap7ECEFU1pWsZq0D9Xk,5X6FeZozNMgE2VRi3MJYjkkFK8SETtu2,7,3,2,0,2,0,2,0,9,1.2857142857142858,1,0.0,0,2,0,2,3,0,0,2,0,4,5,1
6332,167176,O9Nc67keKxqXJVVorKEL2XWb1MEj7Kbn,5X6FeZozNMgE2VRi3MJYjkkFK8SETtu2,9,12,3,5,4,0,4,0,28,4.0,3,0.0,2,3,4,4,10,0,1,4,0,13,15,1
6333,167217,j0gxXks7DZitzyeEGG2agLKFp30HqXVu,A3fsA9Zfv1X2fVEQhTw51lKENdNrEqT3,5,6,3,0,0,1,9,0,19,2.7142857142857144,1,0.0,0,3,0,0,6,1,0,9,0,3,16,1
6334,167334,0gocHINf7b8BcvWaTrMFBEJhugD8UJOT,bWdj2GDclj5ofokWjzoa5jAwMkxCykd6,5,4,2,0,0,0,2,0,8,1.1428571428571428,1,0.0,0,2,0,0,4,0,0,2,0,2,6,1
6335,167353,mtxEm66XLaiLgrwQ9kSbmVMuiNAGb6i1,G8EPVSXsOYB5YQWZGiz1aVq5Pgr2GrQu,1,0,0,0,0,0,1,0,1,0.14285714285714285,1,0.0,0,0,0,0,0,0,0,1,0,0,1,1
6336,167632,JRUKMEmBZ3p5F0JpSVHv1lQEiMQUvro3,5X6FeZozNMgE2VRi3MJYjkkFK8SETtu2,1,0,0,0,0,0,1,0,1,0.14285714285714285,1,0.0,0,0,0,0,0,0,0,1,0,0,1,1
6337,167635,VR79xuyJ7PSmMj6conPf0NxNjdhA8iEp,G8EPVSXsOYB5YQWZGiz1aVq5Pgr2GrQu,1,1,0,0,0,0,0,0,1,0.14285714285714285,1,0.0,0,0,0,0,1,0,0,0,0,0,1,1
6338,167825,w50jSI5RjqfAgmbAtDpAViImkLRNEU1B,3VkHkmOtom3jM2wCu94xgzzu1d6Dn7or,4,2,1,0,1,0,1,0,5,0.7142857142857143,1,0.0,0,1,0,1,2,0,0,1,0,2,3,1
6339,167829,DuWvyGHQTe2nAVAqbwb2iRzai9QwBpBF,3VkHkmOtom3jM2wCu94xgzzu1d6Dn7or,5,2,1,0,1,0,2,0,6,0.8571428571428571,1,0.0,0,1,0,1,2,0,0,2,0,2,4,1
6340,167831,nQbLT1SRMbfcvKaLKuoWeofpEsFofHcY,3VkHkmOtom3jM2wCu94xgzzu1d6Dn7or,1,0,0,0,0,0,1,0,1,0.14285714285714285,1,0.0,0,0,0,0,0,0,0,1,0,0,1,1
6341,167842,CSm8iwWsU0HeDh8Nvu0QaEq7r9rC3pXi,3VkHkmOtom3jM2wCu94xgzzu1d6Dn7or,9,8,5,0,2,1,6,1,23,3.2857142857142856,1,0.0,0,5,0,2,8,1,0,6,1,7,16,1
6342,167848,Zuvakat0rRsl2Y7xnpQctqOYcmuQFCGc,3VkHkmOtom3jM2wCu94xgzzu1d6Dn7or,1,0,0,0,0,0,1,0,1,0.14285714285714285,1,0.0,0,0,0,0,0,0,0,1,0,0,1,1
6343,167852,1zu13GwMTvm6JeRi49ExLCOijiwrPgw5,3VkHkmOtom3jM2wCu94xgzzu1d6Dn7or,5,2,1,0,1,0,2,0,6,0.8571428571428571,2,0.0,0,1,0,1,2,0,0,2,0,2,4,1
6344,167869,S8zVRxklnOsXuBIBhjrKY81fUiuiIbyw,3VkHkmOtom3jM2wCu94xgzzu1d6Dn7or,6,3,1,0,0,0,5,0,9,1.2857142857142858,1,0.0,0,1,0,0,3,0,0,5,0,1,8,1
6345,167871,TUwVrd2hmfW6VyLzKbv0bNRWMKGDOGOV,3VkHkmOtom3jM2wCu94xgzzu1d6Dn7or,6,6,0,0,1,1,6,0,14,2.0,1,0.0,1,0,0,1,5,1,0,6,0,2,12,1
6346,167882,H1QsOOzkt1rMgjxLE3KdQ1oVfKimRTem,3VkHkmOtom3jM2wCu94xgzzu1d6Dn7or,2,0,0,0,0,0,3,0,3,0.42857142857142855,1,0.0,0,0,0,0,0,0,0,3,0,0,3,1
6347,167890,uw0jy2Q66SqttJaNPd8OcJODmC4v7GbR,3VkHkmOtom3jM2wCu94xgzzu1d6Dn7or,4,3,2,0,2,0,1,0,8,1.1428571428571428,1,0.0,0,2,0,2,3,0,0,1,0,4,4,1
6348,167891,zHKQnUugeGJMuRQOZYGje2WBIE2vaEFJ,3VkHkmOtom3jM2wCu94xgzzu1d6Dn7or,8,2,1,0,1,1,7,1,13,1.8571428571428572,1,0.0,0,1,0,1,2,1,0,7,1,2,11,1
6349,167894,aifGgPMvFpWHsSTqQ6XTzhfaWNOf55n4,3VkHkmOtom3jM2wCu94xgzzu1d6Dn7or,1,0,0,0,0,0,1,0,1,0.14285714285714285,1,0.0,0,0,0,0,0,0,0,1,0,0,1,1
6350,167907,ItnribwFpyCbaqDIrXmSOMBQ0RW2u9U9,3VkHkmOtom3jM2wCu94xgzzu1d6Dn7or,5,2,1,0,1,0,2,0,6,0.8571428571428571,1,0.0,0,1,0,1,2,0,0,2,0,2,4,1
6351,167910,ry89y5X9JAYmkcmxHDurtFUIgbrGCIEa,3VkHkmOtom3jM2wCu94xgzzu1d6Dn7or,7,4,2,0,1,0,5,0,12,1.7142857142857142,1,0.0,0,2,0,1,4,0,0,5,0,3,9,1
6352,167928,LPTn0tVsaHx75448aym62vRvPscf1ZBA,3VkHkmOtom3jM2wCu94xgzzu1d6Dn7or,2,0,0,0,0,0,3,0,3,0.42857142857142855,1,0.0,0,0,0,0,0,0,0,3,0,0,3,1
6353,167930,7Z8klAybvAyZGIIsQrZrpQ783NMpvdq7,3VkHkmOtom3jM2wCu94xgzzu1d6Dn7or,18,25,6,20,5,1,4,1,62,8.857142857142858,2,0.0,6,6,18,5,19,1,2,4,1,35,27,1
6354,167937,kS0U8tHee4noGncNrIbRrvTmtI5gjObk,3VkHkmOtom3jM2wCu94xgzzu1d6Dn7or,11,8,2,6,3,3,7,2,31,4.428571428571429,1,0.0,5,2,5,3,3,3,1,7,2,15,16,1
6355,167945,rn5hy4kLEAdjSMx6pi3quUc9lK76cxan,3VkHkmOtom3jM2wCu94xgzzu1d6Dn7or,7,11,1,4,3,0,1,0,20,2.857142857142857,1,0.0,7,1,3,3,4,0,1,1,0,14,6,1
6356,168015,Rh1vKzdCidGYpOFdiiTOGFQrX9OfRVrK,fbPkOYLVPtPgIt0MxizjfFJov3JbHyAi,16,21,9,11,8,0,6,2,57,8.142857142857142,1,0.0,8,9,8,8,13,0,3,6,2,33,24,1
6357,168019,xRwztXzP34GXcx4vKCvLpNuDFYBUsz25,fbPkOYLVPtPgIt0MxizjfFJov3JbHyAi,1,0,0,0,0,0,1,0,1,0.14285714285714285,1,0.0,0,0,0,0,0,0,0,1,0,0,1,1
6358,168020,tvBsBGirmDJVH8dehRY8Wk9DejDqHNQp,fbPkOYLVPtPgIt0MxizjfFJov3JbHyAi,5,2,1,0,1,2,2,0,8,1.1428571428571428,1,0.0,0,1,0,1,2,2,0,2,0,2,6,1
6359,168021,NGkJealfvLzyvMkO29aSPohtdMh2i3ow,fbPkOYLVPtPgIt0MxizjfFJov3JbHyAi,7,5,3,0,2,2,3,0,15,2.142857142857143,1,0.0,0,3,0,2,5,2,0,3,0,5,10,1
6360,168023,VkRjQK2qlHCknrchQonihFBxiFQQVGQO,fbPkOYLVPtPgIt0MxizjfFJov3JbHyAi,11,30,10,6,11,0,15,3,75,10.714285714285714,1,0.0,14,10,4,11,16,0,2,15,3,39,36,1
6361,168028,FGJh9lbE5Tn49JmYTykhj6B5KNIkrzwf,fbPkOYLVPtPgIt0MxizjfFJov3JbHyAi,1,0,0,0,0,0,1,0,1,0.14285714285714285,1,0.0,0,0,0,0,0,0,0,1,0,0,1,1
6362,168031,Eap9EiKeyqyLbVGyO4A2zaijmfNVHLXY,fbPkOYLVPtPgIt0MxizjfFJov3JbHyAi,10,4,2,8,2,0,4,1,21,3.0,1,0.0,2,2,6,2,2,0,2,4,1,12,9,1
6363,168032,eyimxuVK1iUaBa5XIHzsJwFV7NapmCZJ,fbPkOYLVPtPgIt0MxizjfFJov3JbHyAi,8,5,0,0,0,3,5,1,14,2.0,1,0.0,0,0,0,0,5,3,0,5,1,0,14,1
6364,168034,8rCgh1V1FnOt1VMiZt2feZ4FTdc3fpeV,fbPkOYLVPtPgIt0MxizjfFJov3JbHyAi,2,0,0,0,0,0,2,0,2,0.2857142857142857,1,0.0,0,0,0,0,0,0,0,2,0,0,2,1
6365,168035,heWJRVg7rEQJKctb9hAqhrrVJgE71Gu9,fbPkOYLVPtPgIt0MxizjfFJov3JbHyAi,1,0,0,0,0,0,1,0,1,0.14285714285714285,1,0.0,0,0,0,0,0,0,0,1,0,0,1,1
6366,168036,MMquCyNjUMgS5b34ju97Oi2r6jesXYK3,fbPkOYLVPtPgIt0MxizjfFJov3JbHyAi,1,0,0,0,0,0,1,0,1,0.14285714285714285,1,0.0,0,0,0,0,0,0,0,1,0,0,1,1
6367,168039,ZIkd5954CfxEZXjGpH9BuNCIQkDTlhtL,3VkHkmOtom3jM2wCu94xgzzu1d6Dn7or,3,0,0,0,0,0,3,0,3,0.42857142857142855,1,0.0,0,0,0,0,0,0,0,3,0,0,3,1
6368,168044,agO2Ru00XubrL0e4kzGQoZWj9imREUZ9,3VkHkmOtom3jM2wCu94xgzzu1d6Dn7or,6,3,1,0,1,3,4,1,13,1.8571428571428572,1,0.0,0,1,0,1,3,3,0,4,1,2,11,1
6369,168050,wR7MeRMuDjqJzIdX6xUDIhHYl6LZetsZ,3VkHkmOtom3jM2wCu94xgzzu1d6Dn7or,1,0,0,0,0,0,1,0,1,0.14285714285714285,1,0.0,0,0,0,0,0,0,0,1,0,0,1,1
6370,168052,Tdt2jo6FSzEcoRXiY9yw2yu67hyh4xhY,3VkHkmOtom3jM2wCu94xgzzu1d6Dn7or,1,0,0,0,0,0,1,0,1,0.14285714285714285,1,0.0,0,0,0,0,0,0,0,1,0,0,1,1
6371,168059,2XEzBTMWqAbDwimqhpYNFpmeQsMJgIYu,3VkHkmOtom3jM2wCu94xgzzu1d6Dn7or,5,0,0,0,0,0,11,1,12,1.7142857142857142,1,0.0,0,0,0,0,0,0,0,11,1,0,12,1
6372,168060,cv8pP2C7zo3M4L5aHmjPvGod8iwTqQAC,3VkHkmOtom3jM2wCu94xgzzu1d6Dn7or,3,2,1,0,0,0,1,0,4,0.5714285714285714,1,0.0,0,1,0,0,2,0,0,1,0,1,3,1
6373,168061,vNkyXjtvXeXvTJ0R5l3MEzTPr3QeDydS,3VkHkmOtom3jM2wCu94xgzzu1d6Dn7or,1,0,0,0,0,0,1,0,1,0.14285714285714285,1,0.0,0,0,0,0,0,0,0,1,0,0,1,1
6374,168077,qdrCejGYeJq7RFcgxxMCapyK4zpMSCop,3VkHkmOtom3jM2wCu94xgzzu1d6Dn7or,5,2,1,0,1,0,2,0,6,0.8571428571428571,1,0.0,0,1,0,1,2,0,0,2,0,2,4,1
6375,168089,11NHL7hbUJDC0P19HwO6czO0KD8tCMmJ,3VkHkmOtom3jM2wCu94xgzzu1d6Dn7or,1,0,0,0,0,0,1,0,1,0.14285714285714285,1,0.0,0,0,0,0,0,0,0,1,0,0,1,1
6376,168096,VJ6kZoKlg9Zf0JikQy89C9wmuItXDaaY,3VkHkmOtom3jM2wCu94xgzzu1d6Dn7or,3,0,0,0,0,0,4,0,4,0.5714285714285714,1,0.0,0,0,0,0,0,0,0,4,0,0,4,1
6377,168099,uCdgNfsOxrpsY6xF4ndmj3Egun0Rh7Cv,3VkHkmOtom3jM2wCu94xgzzu1d6Dn7or,13,11,8,0,3,2,7,1,32,4.571428571428571,1,0.0,0,8,0,3,11,2,0,7,1,11,21,1
6378,168102,2fI4wWrvurl3ODzFoF1kViu5y8Lc1NgZ,3VkHkmOtom3jM2wCu94xgzzu1d6Dn7or,5,4,1,0,2,0,3,0,10,1.4285714285714286,1,0.0,2,1,0,2,2,0,0,3,0,5,5,1
6379,168112,TzgPm4FTPrcVn51KvJ9nPbASPBwJN49G,3VkHkmOtom3jM2wCu94xgzzu1d6Dn7or,2,0,0,0,0,0,3,0,3,0.42857142857142855,1,0.0,0,0,0,0,0,0,0,3,0,0,3,1
6380,168116,CAshoVKvqnHK81BNgbgwkueL8tfZXRMD,3VkHkmOtom3jM2wCu94xgzzu1d6Dn7or,21,54,25,0,9,0,37,0,125,17.857142857142858,2,0.0,0,25,0,9,54,0,0,37,0,34,91,1
6381,168118,vYehDPhgNQtlmHh1y514ycZEmEdAJ0r0,3VkHkmOtom3jM2wCu94xgzzu1d6Dn7or,1,0,0,0,0,0,1,0,1,0.14285714285714285,1,0.0,0,0,0,0,0,0,0,1,0,0,1,1
6382,168123,sm8Pt42lYmt5RjZttn9EWmBp0Dzh6yOg,3VkHkmOtom3jM2wCu94xgzzu1d6Dn7or,7,4,3,0,3,0,2,0,12,1.7142857142857142,1,0.0,0,3,0,3,4,0,0,2,0,6,6,1
6383,168127,7G8Rik8u1uuQIuR6kuVHJF82hy9UDWIA,3VkHkmOtom3jM2wCu94xgzzu1d6Dn7or,5,2,1,0,1,0,5,0,9,1.2857142857142858,2,0.0,0,1,0,1,2,0,0,5,0,2,7,1
6384,168130,q5SuICv9n6fk3Gj0UBboD0DygELcDR8L,3VkHkmOtom3jM2wCu94xgzzu1d6Dn7or,10,9,4,0,4,0,1,0,18,2.5714285714285716,1,0.0,0,4,0,4,9,0,0,1,0,8,10,1
6385,168131,uggm3AdsFLBy2JtnSepLESRXBJfVPM0R,3VkHkmOtom3jM2wCu94xgzzu1d6Dn7or,2,0,0,0,0,0,2,0,2,0.2857142857142857,1,0.0,0,0,0,0,0,0,0,2,0,0,2,1
6386,168135,GRgjzx7VHY5z0cMezCfvrpSTKqpE3kNZ,3VkHkmOtom3jM2wCu94xgzzu1d6Dn7or,3,0,0,0,0,0,4,0,4,0.5714285714285714,1,0.0,0,0,0,0,0,0,0,4,0,0,4,0
6387,168138,IQl7iITPplsUEK81vvRW6Jh5ZlBMnohA,3VkHkmOtom3jM2wCu94xgzzu1d6Dn7or,13,26,13,12,8,8,6,0,73,10.428571428571429,2,0.0,7,13,10,8,19,8,2,6,0,38,35,1
6388,168140,hYCidWQrwCkhGcNer5p8OhehcNSTshYJ,3VkHkmOtom3jM2wCu94xgzzu1d6Dn7or,1,0,0,0,0,0,1,0,1,0.14285714285714285,1,0.0,0,0,0,0,0,0,0,1,0,0,1,1
6389,168146,nASd4bkg9iOQ5C6KGA8KokEbNySckLI3,3VkHkmOtom3jM2wCu94xgzzu1d6Dn7or,7,3,2,0,2,0,5,0,12,1.7142857142857142,4,0.0,0,2,0,2,3,0,0,5,0,4,8,1
6390,168151,mB8CkewoHHgxRRhNB2wtIGdwD4mVURIG,3VkHkmOtom3jM2wCu94xgzzu1d6Dn7or,7,2,1,0,1,2,7,1,14,2.0,1,0.0,0,1,0,1,2,2,0,7,1,2,12,1
6391,168157,wEHix8LAp0DQBJzQzg9nQJbNHoAylxAV,3VkHkmOtom3jM2wCu94xgzzu1d6Dn7or,1,0,0,0,0,0,1,0,1,0.14285714285714285,1,0.0,0,0,0,0,0,0,0,1,0,0,1,1
6392,168159,JZE0ZjzMd9hpjhitnrIYN3nfbAe7Xg7V,3VkHkmOtom3jM2wCu94xgzzu1d6Dn7or,9,5,4,0,4,10,6,0,29,4.142857142857143,1,0.0,0,4,0,4,5,10,0,6,0,8,21,1
6393,168164,nMKMZ6d7UNyqp8l1Z23oE7NBRpj50POO,3VkHkmOtom3jM2wCu94xgzzu1d6Dn7or,4,0,0,0,0,0,5,0,5,0.7142857142857143,1,0.0,0,0,0,0,0,0,0,5,0,0,5,1
6394,168165,KuPMRa6zx9uVQzQiiJfjbnqpuKQ7ehe6,3VkHkmOtom3jM2wCu94xgzzu1d6Dn7or,1,0,0,0,0,0,1,0,1,0.14285714285714285,1,0.0,0,0,0,0,0,0,0,1,0,0,1,1
6395,168166,uEbUnTaquYcI9HiXWys2O7OIJAInX4uE,3VkHkmOtom3jM2wCu94xgzzu1d6Dn7or,5,4,2,0,1,0,3,0,10,1.4285714285714286,1,0.0,0,2,0,1,4,0,0,3,0,3,7,1
6396,168170,BwAkSOoid8hSIsM9tqJ6rtQwQQPGyL2E,3VkHkmOtom3jM2wCu94xgzzu1d6Dn7or,1,0,0,0,0,0,3,0,3,0.42857142857142855,1,0.0,0,0,0,0,0,0,0,3,0,0,3,1
6397,169709,ZjaO90YO6SbarxJ3Cmlj3CTm7IehtZpd,fbPkOYLVPtPgIt0MxizjfFJov3JbHyAi,1,0,0,0,0,0,1,0,1,0.14285714285714285,1,0.0,0,0,0,0,0,0,0,1,0,0,1,1
6398,169711,gzmN8VLkF6QCaC4IobudOv6PTgb6exUk,fbPkOYLVPtPgIt0MxizjfFJov3JbHyAi,5,3,2,0,1,0,1,0,7,1.0,1,0.0,0,2,0,1,3,0,0,1,0,3,4,1
6399,169712,on5DMrYwiqlqmQeDVhGtFBdUskUZZhIt,fbPkOYLVPtPgIt0MxizjfFJov3JbHyAi,1,0,0,0,0,0,1,0,1,0.14285714285714285,1,0.0,0,0,0,0,0,0,0,1,0,0,1,1
6400,169715,Uk2Y8qj9Cf6T7k2O1cxM5Fue4zKTF1K8,fbPkOYLVPtPgIt0MxizjfFJov3JbHyAi,16,9,4,13,3,3,7,1,40,5.714285714285714,1,0.0,2,4,11,3,7,3,2,7,1,20,20,1
6401,169717,TG3ZuEJuEwKy3hkCPL590sfXZmiZZmKY,fbPkOYLVPtPgIt0MxizjfFJov3JbHyAi,7,5,3,0,3,0,2,0,13,1.8571428571428572,1,0.0,0,3,0,3,5,0,0,2,0,6,7,1
6402,169718,1zErz13s8fNQRVaEvkOtvw6bLhr23yB4,fbPkOYLVPtPgIt0MxizjfFJov3JbHyAi,1,0,0,0,0,0,1,0,1,0.14285714285714285,1,0.0,0,0,0,0,0,0,0,1,0,0,1,1
6403,169719,3uqpbZSnLO1eJeHoknDZKcTUgItMaIsr,fbPkOYLVPtPgIt0MxizjfFJov3JbHyAi,1,0,0,0,0,0,1,0,1,0.14285714285714285,1,0.0,0,0,0,0,0,0,0,1,0,0,1,1
6404,169721,HNjmezOX8bu6iW67SYkfKBzixQs4v7AY,fbPkOYLVPtPgIt0MxizjfFJov3JbHyAi,2,0,0,0,0,0,2,0,2,0.2857142857142857,1,0.0,0,0,0,0,0,0,0,2,0,0,2,1
6405,169722,c7BQt6pwyr74vZa2XhmLGh7eET6ymX3O,fbPkOYLVPtPgIt0MxizjfFJov3JbHyAi,1,0,0,0,0,0,1,0,1,0.14285714285714285,1,0.0,0,0,0,0,0,0,0,1,0,0,1,1
6406,169723,3CWAStXWZfnymtslODBe0T4VwTot5qO9,fbPkOYLVPtPgIt0MxizjfFJov3JbHyAi,1,0,0,0,0,0,1,0,1,0.14285714285714285,1,0.0,0,0,0,0,0,0,0,1,0,0,1,1
6407,169729,z1u2jl8Hd3JcsLZgCFkCBR6j2KEKuIt6,fbPkOYLVPtPgIt0MxizjfFJov3JbHyAi,6,4,1,0,0,0,3,0,8,1.1428571428571428,1,0.0,0,1,0,0,4,0,0,3,0,1,7,1
6408,169732,BpDOkJmprkl3MzCUQelxcxGE9nfbBO8e,fbPkOYLVPtPgIt0MxizjfFJov3JbHyAi,3,0,0,0,0,4,5,0,9,1.2857142857142858,1,0.0,0,0,0,0,0,4,0,5,0,0,9,1
6409,169733,IvSFszPnr18KVZKYGSQ6sSbo1mXQ0RkU,fbPkOYLVPtPgIt0MxizjfFJov3JbHyAi,5,3,1,0,1,0,4,0,9,1.2857142857142858,1,0.0,0,1,0,1,3,0,0,4,0,2,7,1
6410,169741,bKVslXuzEQ1pv4c6iV5mVjs6X6avUbmL,5X6FeZozNMgE2VRi3MJYjkkFK8SETtu2,19,24,6,20,13,0,2,0,65,9.285714285714286,2,0.0,16,6,18,13,8,0,2,2,0,53,12,1
6411,169742,vBI9bFKpE2lZD2pCKedut3xzJe3InBGD,SpATywNh6bZuzm8s1ceuBUnMUAeoAHHw,34,34,15,29,10,0,8,0,96,13.714285714285714,4,0.0,8,15,26,10,26,0,3,8,0,59,37,0
6412,169760,sevSk5OvS8Sn7eCSBigrDJCqH5Hzftgi,5X6FeZozNMgE2VRi3MJYjkkFK8SETtu2,1,0,0,0,0,0,1,0,1,0.14285714285714285,1,0.0,0,0,0,0,0,0,0,1,0,0,1,1
6413,169797,npTxDxadULeYhHN8NazvZSh6FSHSOkNS,SpATywNh6bZuzm8s1ceuBUnMUAeoAHHw,6,4,3,0,2,0,3,0,12,1.7142857142857142,1,0.0,0,3,0,2,4,0,0,3,0,5,7,1
6414,169808,nq8bR2L0RLlBhmbma1mjdqiNKrD7Hg6k,5X6FeZozNMgE2VRi3MJYjkkFK8SETtu2,1,0,0,0,0,0,1,0,1,0.14285714285714285,1,0.0,0,0,0,0,0,0,0,1,0,0,1,1
6415,169813,T7I0bmVpFP7i0YadOfDRSUAzo81IilUz,A3fsA9Zfv1X2fVEQhTw51lKENdNrEqT3,6,5,2,0,2,0,1,0,10,1.4285714285714286,1,0.0,0,2,0,2,5,0,0,1,0,4,6,1
6416,169838,FzewIaS8n9FLjjmr86Fwneg2na5DKLsk,SpATywNh6bZuzm8s1ceuBUnMUAeoAHHw,5,2,1,0,1,0,5,0,9,1.2857142857142858,1,0.0,0,1,0,1,2,0,0,5,0,2,7,0
6417,169876,dVenSfS9klH4q58uxaLQn2gbJOk5CBgU,A3fsA9Zfv1X2fVEQhTw51lKENdNrEqT3,1,0,0,0,0,0,1,0,1,0.14285714285714285,1,0.0,0,0,0,0,0,0,0,1,0,0,1,1
6418,169887,BWSUybrP5WF5o86qBDzFhcxUudwFIkgM,SpATywNh6bZuzm8s1ceuBUnMUAeoAHHw,7,17,1,0,1,0,3,0,22,3.142857142857143,1,0.0,0,1,0,1,17,0,0,3,0,2,20,1
6419,169893,S6HlGgJHN4fE4VtlVBKQWpgIrEWuiqMi,SpATywNh6bZuzm8s1ceuBUnMUAeoAHHw,3,4,2,0,0,0,3,0,9,1.2857142857142858,2,0.0,0,2,0,0,4,0,0,3,0,2,7,1
6420,169898,BDOlU8SNOZffwyL4ZSOzluDyTbkYrcLY,A3fsA9Zfv1X2fVEQhTw51lKENdNrEqT3,2,0,0,0,0,0,3,0,3,0.42857142857142855,1,0.0,0,0,0,0,0,0,0,3,0,0,3,1
6421,169927,xTSfleEeHyuYGYALjmgY9nj7dgmrM7R4,5X6FeZozNMgE2VRi3MJYjkkFK8SETtu2,2,0,0,0,0,0,2,0,2,0.2857142857142857,1,0.0,0,0,0,0,0,0,0,2,0,0,2,1
6422,169965,yoLxxWVkkb8r6N5aDiWN8TSJAYwxngkl,SpATywNh6bZuzm8s1ceuBUnMUAeoAHHw,48,107,45,47,12,51,27,5,294,42.0,4,0.0,32,45,36,12,75,51,11,27,5,125,169,0
6423,169969,9dRmB3kQRyLzaAAPAp5pmf3CZroVQEBk,SpATywNh6bZuzm8s1ceuBUnMUAeoAHHw,18,21,12,0,5,2,8,3,51,7.285714285714286,1,0.0,2,12,0,5,19,2,0,8,3,19,32,1
6424,169997,6bQAu3lhZR1MLjYZGRxFtK6G9xGgxToy,A3fsA9Zfv1X2fVEQhTw51lKENdNrEqT3,4,2,1,0,1,0,1,0,5,0.7142857142857143,1,0.0,0,1,0,1,2,0,0,1,0,2,3,1
6425,170013,nVB1o73xluQXZjoI2dUYHGxbCDG8qiCL,5X6FeZozNMgE2VRi3MJYjkkFK8SETtu2,1,0,0,0,0,0,2,0,2,0.2857142857142857,2,0.0,0,0,0,0,0,0,0,2,0,0,2,1
6426,170016,nVB1o73xluQXZjoI2dUYHGxbCDG8qiCL,A3fsA9Zfv1X2fVEQhTw51lKENdNrEqT3,1,0,0,0,0,0,2,0,2,0.2857142857142857,2,0.0,0,0,0,0,0,0,0,2,0,0,2,1
6427,170078,S6Mv1aKyTUf7xcwwDYCs3vpkSwBRaGU9,SpATywNh6bZuzm8s1ceuBUnMUAeoAHHw,3,2,0,0,0,0,1,0,3,0.42857142857142855,1,0.0,0,0,0,0,2,0,0,1,0,0,3,0
6428,170079,Gc94ylq1l33qmAFqvJxQNCYabgxfLjbY,bWdj2GDclj5ofokWjzoa5jAwMkxCykd6,10,15,5,60,0,0,2,0,82,11.714285714285714,1,0.0,5,5,55,0,10,0,5,2,0,65,17,1
6429,170120,uSDVh18pcCwxI96mN9a9rvZLD88sOdeQ,RXDvfPUBYFlVdlueBFbLW0mhhAyGEqpt,2,0,0,0,0,0,2,0,2,0.2857142857142857,1,0.0,0,0,0,0,0,0,0,2,0,0,2,0
6430,170183,JJ2BrQ1QlR8nvrRwoiGYxLQ2LBkS2Wey,G8EPVSXsOYB5YQWZGiz1aVq5Pgr2GrQu,7,3,2,0,2,0,2,0,9,1.2857142857142858,1,0.0,0,2,0,2,3,0,0,2,0,4,5,1
6431,170184,JXFir7EgTVcRLR36C3eOl6MVr5FCwAGN,A3fsA9Zfv1X2fVEQhTw51lKENdNrEqT3,26,25,17,0,14,0,6,0,62,8.857142857142858,2,0.0,0,17,0,14,25,0,0,6,0,31,31,1
6432,170218,jkRVMwWglWyTDpeckcGigMAGHQXeoiC7,SpATywNh6bZuzm8s1ceuBUnMUAeoAHHw,6,4,3,0,3,0,1,0,11,1.5714285714285714,1,0.0,0,3,0,3,4,0,0,1,0,6,5,1
6433,170227,0rzsRgV74jtqobT7C3FDDTNVaVjJDj1m,SpATywNh6bZuzm8s1ceuBUnMUAeoAHHw,33,44,19,10,13,0,1,0,87,12.428571428571429,2,0.0,3,19,10,13,41,0,0,1,0,45,42,0
6434,170246,yLJyDzhntbH1XoSkElsVTG3uFtVGGuYx,SpATywNh6bZuzm8s1ceuBUnMUAeoAHHw,5,3,1,0,1,0,1,0,6,0.8571428571428571,1,0.0,0,1,0,1,3,0,0,1,0,2,4,1
6435,170259,F6PMIuaItZsVrgehXKA3QdyFlGSxSfCT,5X6FeZozNMgE2VRi3MJYjkkFK8SETtu2,8,13,1,6,5,0,2,0,27,3.857142857142857,1,0.0,8,1,6,5,5,0,0,2,0,20,7,1
6436,170266,OBC6Rr26MOMnvPdxf4UiZyK1TkKdkXdO,bWdj2GDclj5ofokWjzoa5jAwMkxCykd6,11,10,4,0,4,0,4,0,22,3.142857142857143,2,0.0,2,4,0,4,8,0,0,4,0,10,12,1
6437,170268,9IP5FYaoy3mLJ0e4bLrHDIO94Xx0pbLk,SpATywNh6bZuzm8s1ceuBUnMUAeoAHHw,6,8,4,0,0,0,1,0,13,1.8571428571428572,1,0.0,0,4,0,0,8,0,0,1,0,4,9,1
6438,170271,iLrqT1cSiRqHGveKnknegGGgRshrAyXQ,A3fsA9Zfv1X2fVEQhTw51lKENdNrEqT3,1,0,0,0,0,0,1,0,1,0.14285714285714285,1,0.0,0,0,0,0,0,0,0,1,0,0,1,0
6439,170295,Hu1q9BM1uNTUWAtdnE0dGgL9CPbL7g91,bWdj2GDclj5ofokWjzoa5jAwMkxCykd6,4,3,2,0,2,1,1,0,9,1.2857142857142858,1,0.0,0,2,0,2,3,1,0,1,0,4,5,0
6440,170297,QHac5ChQi0jjis2Aa8598hG063M0Aev9,A3fsA9Zfv1X2fVEQhTw51lKENdNrEqT3,1,0,0,0,0,0,1,0,1,0.14285714285714285,1,0.0,0,0,0,0,0,0,0,1,0,0,1,1
6441,170318,UZZ4oED4itrD9fuKBxKj9qNTxIOc56Fd,5X6FeZozNMgE2VRi3MJYjkkFK8SETtu2,3,2,0,0,0,0,2,0,4,0.5714285714285714,1,0.0,0,0,0,0,2,0,0,2,0,0,4,1
6442,170321,c9mIdDAhRczXEb5UJiDqrnVR2zYNOBwR,5X6FeZozNMgE2VRi3MJYjkkFK8SETtu2,4,1,1,0,0,0,2,0,4,0.5714285714285714,1,0.0,0,1,0,0,1,0,0,2,0,1,3,1
6443,170327,fOnqWC7nQb9W53LcQzCrEMI7ZvS9gv3y,5X6FeZozNMgE2VRi3MJYjkkFK8SETtu2,1,0,0,0,0,0,1,0,1,0.14285714285714285,1,0.0,0,0,0,0,0,0,0,1,0,0,1,0
6444,170357,ung1DnQyYgd0tfz7mAKTwJrrm5UPHWt1,A3fsA9Zfv1X2fVEQhTw51lKENdNrEqT3,1,0,0,0,0,0,1,0,1,0.14285714285714285,1,0.0,0,0,0,0,0,0,0,1,0,0,1,1
6445,170370,1d0o1TrUuYYpxTQO8Zc2bQiGJ5e5RjS7,SpATywNh6bZuzm8s1ceuBUnMUAeoAHHw,6,4,1,6,0,0,2,0,13,1.8571428571428572,1,0.0,0,1,5,0,4,0,1,2,0,6,7,1
6446,170383,kInpuD24WAXDN2oDvgEQpEim21sGlNtt,SpATywNh6bZuzm8s1ceuBUnMUAeoAHHw,1,0,0,0,0,0,2,0,2,0.2857142857142857,1,0.0,0,0,0,0,0,0,0,2,0,0,2,1
6447,170404,AHBTTwifTV4kFq5PYNWRmN0YYbgueA3K,5X6FeZozNMgE2VRi3MJYjkkFK8SETtu2,2,0,0,0,0,0,2,0,2,0.2857142857142857,1,0.0,0,0,0,0,0,0,0,2,0,0,2,0
6448,170424,iKgnPLhvVQse7oL8jh4sOm9046t6sK9B,5X6FeZozNMgE2VRi3MJYjkkFK8SETtu2,2,0,0,0,0,0,2,0,2,0.2857142857142857,1,0.0,0,0,0,0,0,0,0,2,0,0,2,1
6449,170437,KiFyZJyo9VTN2jnOIMRF0BEPiMc6llDh,SpATywNh6bZuzm8s1ceuBUnMUAeoAHHw,1,0,0,0,0,0,1,0,1,0.14285714285714285,1,0.0,0,0,0,0,0,0,0,1,0,0,1,1
6450,170446,68jxA2PUjT1NQfZbUcdmPfGR0u6r2zeM,SpATywNh6bZuzm8s1ceuBUnMUAeoAHHw,1,0,0,0,0,0,1,0,1,0.14285714285714285,1,0.0,0,0,0,0,0,0,0,1,0,0,1,1
6451,170452,68jxA2PUjT1NQfZbUcdmPfGR0u6r2zeM,bWdj2GDclj5ofokWjzoa5jAwMkxCykd6,1,0,0,0,0,0,1,0,1,0.14285714285714285,1,0.0,0,0,0,0,0,0,0,1,0,0,1,1
6452,170453,68jxA2PUjT1NQfZbUcdmPfGR0u6r2zeM,G8EPVSXsOYB5YQWZGiz1aVq5Pgr2GrQu,1,0,0,0,0,0,1,0,1,0.14285714285714285,1,0.0,0,0,0,0,0,0,0,1,0,0,1,1
6453,170454,68jxA2PUjT1NQfZbUcdmPfGR0u6r2zeM,A3fsA9Zfv1X2fVEQhTw51lKENdNrEqT3,1,0,0,0,0,0,1,0,1,0.14285714285714285,1,0.0,0,0,0,0,0,0,0,1,0,0,1,1
6454,170464,m8tZWvMesr1zQS0esJJogsiMlXHxe2Cd,bWdj2GDclj5ofokWjzoa5jAwMkxCykd6,1,0,0,0,0,0,1,0,1,0.14285714285714285,1,0.0,0,0,0,0,0,0,0,1,0,0,1,1
6455,170539,AM61RuK5BGw2QCAwj10qxPsGo5n0aSXg,SpATywNh6bZuzm8s1ceuBUnMUAeoAHHw,1,0,0,0,0,0,1,0,1,0.14285714285714285,1,0.0,0,0,0,0,0,0,0,1,0,0,1,1
6456,170558,40L77km5z19sJEVeJ6u4qpa9SAG2ZSIF,G8EPVSXsOYB5YQWZGiz1aVq5Pgr2GrQu,19,6,5,64,0,0,1,0,76,10.857142857142858,1,0.0,0,5,52,0,6,0,12,1,0,57,19,1
6457,170563,zaU4z26ajoscWieMrtG9dyjFX4jyC0Mh,SpATywNh6bZuzm8s1ceuBUnMUAeoAHHw,1,0,0,0,0,0,1,0,1,0.14285714285714285,1,0.0,0,0,0,0,0,0,0,1,0,0,1,1
6458,170568,aPM6Pkx8yXzDO1Wq6YMG1wXnFkTU2WLX,SpATywNh6bZuzm8s1ceuBUnMUAeoAHHw,1,0,0,0,0,0,1,0,1,0.14285714285714285,1,0.0,0,0,0,0,0,0,0,1,0,0,1,1
6459,170604,npbzydZfydGneeM7kdEFvQEFfvT3OFkh,SpATywNh6bZuzm8s1ceuBUnMUAeoAHHw,1,0,0,0,0,0,1,0,1,0.14285714285714285,1,0.0,0,0,0,0,0,0,0,1,0,0,1,1
6460,170606,jxxhPxoL1C2Q3sJ0zwG7rkjhVHAN9wuY,G8EPVSXsOYB5YQWZGiz1aVq5Pgr2GrQu,1,0,0,0,0,0,1,0,1,0.14285714285714285,1,0.0,0,0,0,0,0,0,0,1,0,0,1,1
6461,170608,jxxhPxoL1C2Q3sJ0zwG7rkjhVHAN9wuY,A3fsA9Zfv1X2fVEQhTw51lKENdNrEqT3,1,0,0,0,0,0,1,0,1,0.14285714285714285,1,0.0,0,0,0,0,0,0,0,1,0,0,1,1
6462,170618,TxlSnMAR26IaOfJh6C0k9qQhw2BgogEc,bWdj2GDclj5ofokWjzoa5jAwMkxCykd6,9,4,1,0,1,0,5,1,12,1.7142857142857142,1,0.0,0,1,0,1,4,0,0,5,1,2,10,1
6463,170641,lF2uzhIawwPthZ8YuZGuLgbGDHXIrPbI,A3fsA9Zfv1X2fVEQhTw51lKENdNrEqT3,6,4,2,0,2,1,1,0,10,1.4285714285714286,1,0.0,0,2,0,2,4,1,0,1,0,4,6,1
6464,170668,uxpPi5YjzalklY0lH8OBSyWxa4yOJr6b,A3fsA9Zfv1X2fVEQhTw51lKENdNrEqT3,1,0,0,0,0,0,1,0,1,0.14285714285714285,1,0.0,0,0,0,0,0,0,0,1,0,0,1,1
6465,170682,K3RmvehnU0yLuzkdfShsHIJB4RyDPmXO,bWdj2GDclj5ofokWjzoa5jAwMkxCykd6,4,6,0,0,0,0,2,0,8,1.1428571428571428,1,0.0,1,0,0,0,5,0,0,2,0,1,7,1
6466,170696,LJYBef7iIBiSZz8D7KTtMTsdkyd91gnR,5X6FeZozNMgE2VRi3MJYjkkFK8SETtu2,10,9,3,8,4,0,3,0,27,3.857142857142857,1,0.0,4,3,7,4,5,0,1,3,0,18,9,1
6467,170702,rZmq1xfHyezOQ1I4MHBeGbasPbzytcWo,7GRhBDsirIGkRZBtSMEzNTyDr2JQm4xx,5,3,1,0,1,0,3,0,8,1.1428571428571428,1,0.0,0,1,0,1,3,0,0,3,0,2,6,1
6468,170705,BAuOZksDAofxaiuwNawc5LNrXI2dqbAj,7GRhBDsirIGkRZBtSMEzNTyDr2JQm4xx,4,0,0,0,0,0,4,0,4,0.5714285714285714,1,0.0,0,0,0,0,0,0,0,4,0,0,4,1
6469,170726,ZKAk08L8Iriz8Uv5UOeqSbrNnzg1rlMz,7GRhBDsirIGkRZBtSMEzNTyDr2JQm4xx,7,3,2,8,0,0,2,0,15,2.142857142857143,1,0.0,0,2,8,0,3,0,0,2,0,10,5,0
6470,170729,DREmWIqc4qrvZwDSpHA26SV6hVqbkJG2,7GRhBDsirIGkRZBtSMEzNTyDr2JQm4xx,9,5,2,0,2,5,5,0,19,2.7142857142857144,1,0.0,0,2,0,2,5,5,0,5,0,4,15,0
6471,170733,MHt53JOUaGE51KCIrddgWHFrpxGB2EpZ,7GRhBDsirIGkRZBtSMEzNTyDr2JQm4xx,27,39,1,18,6,2,12,1,79,11.285714285714286,2,0.0,19,1,11,6,20,2,7,12,1,37,42,0
6472,170737,qr1Y8xuPrcpdzScNHYsirGXqasfUdOVa,7GRhBDsirIGkRZBtSMEzNTyDr2JQm4xx,2,0,0,0,0,0,2,0,2,0.2857142857142857,1,0.0,0,0,0,0,0,0,0,2,0,0,2,1
6473,170750,SafBDjMrdgI8ylQBKik25aaX2CxJ12jz,7GRhBDsirIGkRZBtSMEzNTyDr2JQm4xx,1,0,0,0,0,0,1,0,1,0.14285714285714285,1,0.0,0,0,0,0,0,0,0,1,0,0,1,1
6474,170777,NElV2n26Er7GqFUdQtsIGJE7FvU7cYME,5Gyp41oLVo7Gg7vF4vpmggWP5MU70QO6,6,3,1,0,1,0,2,1,8,1.1428571428571428,1,0.0,0,1,0,1,3,0,0,2,1,2,6,1
6475,170814,j7cKEzIFE4CxIsdlWhLymAub0pLUVNyX,5Gyp41oLVo7Gg7vF4vpmggWP5MU70QO6,8,5,3,0,2,0,4,0,14,2.0,1,0.0,0,3,0,2,5,0,0,4,0,5,9,1
6476,170819,KcmL8Zk4Ez99HWgGxzQ9DcI24ai75NjV,5Gyp41oLVo7Gg7vF4vpmggWP5MU70QO6,9,8,3,5,2,0,1,0,19,2.7142857142857144,1,0.0,4,3,3,2,4,0,2,1,0,12,7,1
6477,170831,DbO93Amt4Tjv1uRw8sUGPBiRutmMYEtj,5Gyp41oLVo7Gg7vF4vpmggWP5MU70QO6,13,9,1,0,5,1,7,1,24,3.4285714285714284,2,0.0,2,1,0,5,7,1,0,7,1,8,16,1
6478,170844,rDiZUR8IqJWXrAbcZYr2X23doFMMi6zI,5Gyp41oLVo7Gg7vF4vpmggWP5MU70QO6,7,7,4,0,2,0,1,0,14,2.0,1,0.0,0,4,0,2,7,0,0,1,0,6,8,1
6479,170859,1F6Z7dVChIrDg0fIBjrIJVhCuA2aRvKt,5Gyp41oLVo7Gg7vF4vpmggWP5MU70QO6,8,5,1,0,2,0,2,0,10,1.4285714285714286,1,0.0,1,1,0,2,4,0,0,2,0,4,6,1
6480,170874,16Rh83SGbwsKl4u12KoJxkqbYToorB8L,5Gyp41oLVo7Gg7vF4vpmggWP5MU70QO6,7,3,2,0,2,0,2,0,9,1.2857142857142858,1,0.0,0,2,0,2,3,0,0,2,0,4,5,1
6481,170888,6UmeN2LmLVTIBB0JmWuuEzp03JmJMIMk,5Gyp41oLVo7Gg7vF4vpmggWP5MU70QO6,5,3,2,0,1,0,1,0,7,1.0,1,0.0,0,2,0,1,3,0,0,1,0,3,4,1
6482,170892,xe9PdHtL47ijNdtrDmdC73RUGIc061NJ,5Gyp41oLVo7Gg7vF4vpmggWP5MU70QO6,7,14,7,0,0,0,4,0,25,3.5714285714285716,1,0.0,0,7,0,0,14,0,0,4,0,7,18,1
6483,170907,BLoa1RvSOgexbSH4hGzCihmBc8pXd0Db,5Gyp41oLVo7Gg7vF4vpmggWP5MU70QO6,14,13,8,0,4,7,7,1,40,5.714285714285714,2,0.0,2,8,0,4,11,7,0,7,1,14,26,1
6484,170934,K1Mr8ibRcxd3SAoDrX7638T2SELigCVm,5Gyp41oLVo7Gg7vF4vpmggWP5MU70QO6,17,18,10,10,4,13,7,2,64,9.142857142857142,2,0.0,3,10,8,4,15,13,2,7,2,25,39,1
6485,170957,J2UugGs6hVBOQWkbknVBYMLNhGLiI9aS,5Gyp41oLVo7Gg7vF4vpmggWP5MU70QO6,13,9,5,13,1,0,2,0,30,4.285714285714286,1,0.0,3,5,8,1,6,0,5,2,0,17,13,0
6486,170967,ZAxPvKt7nxIwMtWS73sUPoRTYD1C4K4s,5Gyp41oLVo7Gg7vF4vpmggWP5MU70QO6,16,9,6,2,4,0,5,0,26,3.7142857142857144,1,0.0,1,6,1,4,8,0,1,5,0,12,14,1
6487,171043,FBJBt2gVBj2QfyWMkz8U1ucypUDyZcGE,5Gyp41oLVo7Gg7vF4vpmggWP5MU70QO6,1,0,0,0,0,0,1,0,1,0.14285714285714285,1,0.0,0,0,0,0,0,0,0,1,0,0,1,1
6488,171063,8nSv6iVlspEmJhNJZhRrWeobuweFML73,5Gyp41oLVo7Gg7vF4vpmggWP5MU70QO6,4,2,1,0,1,0,4,0,8,1.1428571428571428,1,0.0,0,1,0,1,2,0,0,4,0,2,6,1
6489,171081,xXWa4DSZCmkNOniTZyQtEksuk96BYzru,5Gyp41oLVo7Gg7vF4vpmggWP5MU70QO6,4,2,0,0,0,0,3,0,5,0.7142857142857143,1,0.0,0,0,0,0,2,0,0,3,0,0,5,1
6490,171124,2eCfFbSmRHfXLNEqAQXwgq6fqbBiCxhL,5Gyp41oLVo7Gg7vF4vpmggWP5MU70QO6,13,22,9,12,2,0,3,0,48,6.857142857142857,3,0.0,7,9,10,2,15,0,2,3,0,28,20,1
6491,171164,lkpb1B28r0WoySNGL8tYf0anQJycU5Mu,5Gyp41oLVo7Gg7vF4vpmggWP5MU70QO6,7,5,3,0,2,0,2,0,12,1.7142857142857142,2,0.0,0,3,0,2,5,0,0,2,0,5,7,1
6492,171224,aLXOlEQWPWqccb0Upda6TUUDXRgu1qKZ,5Gyp41oLVo7Gg7vF4vpmggWP5MU70QO6,15,28,14,0,6,0,7,0,55,7.857142857142857,2,0.0,10,14,0,6,18,0,0,7,0,30,25,1
6493,171241,zikfbKKf6UwbalVzNX9BImZBlJFR20fk,5Gyp41oLVo7Gg7vF4vpmggWP5MU70QO6,13,29,11,0,0,3,9,1,53,7.571428571428571,1,0.0,13,11,0,0,16,3,0,9,1,24,29,1
6494,171290,1VJpXNJPzWFn2SXuVocsKvXImAZvB7bf,5Gyp41oLVo7Gg7vF4vpmggWP5MU70QO6,1,0,0,0,0,0,1,0,1,0.14285714285714285,1,0.0,0,0,0,0,0,0,0,1,0,0,1,1
6495,171323,MZAmGhAEWGPuVAzV6OtAggDJIouImErE,5Gyp41oLVo7Gg7vF4vpmggWP5MU70QO6,6,3,2,0,2,0,1,0,8,1.1428571428571428,1,0.0,0,2,0,2,3,0,0,1,0,4,4,1
6496,171327,94q4qnMa2LC25wamPAfS2ZimaITCFLoV,5Gyp41oLVo7Gg7vF4vpmggWP5MU70QO6,6,6,2,0,0,0,3,0,11,1.5714285714285714,2,0.0,0,2,0,0,6,0,0,3,0,2,9,0
6497,171328,pm85doNHXPjqLBCMZfpmajyMqA4KqeSF,5Gyp41oLVo7Gg7vF4vpmggWP5MU70QO6,4,3,1,0,0,0,2,0,6,0.8571428571428571,1,0.0,0,1,0,0,3,0,0,2,0,1,5,1
6498,171334,po02BHI8nF4qroi12z2tbBgRuT2ewh2W,5Gyp41oLVo7Gg7vF4vpmggWP5MU70QO6,8,5,4,0,4,0,1,0,14,2.0,1,0.0,0,4,0,4,5,0,0,1,0,8,6,1
6499,171358,X14gKVD1ZKu0qL0NchpqxwhoYSEpz9QI,5Gyp41oLVo7Gg7vF4vpmggWP5MU70QO6,28,31,16,24,10,12,16,10,119,17.0,4,0.0,9,16,20,10,22,12,4,16,10,55,64,1
6500,171362,6hq7AqI28Vviowv754yaCDqXhWGhIasa,5Gyp41oLVo7Gg7vF4vpmggWP5MU70QO6,10,19,9,0,4,0,2,0,34,4.857142857142857,1,0.0,7,9,0,4,12,0,0,2,0,20,14,0
6501,171386,cCDRpzTB8HHtN04WIxkJpUhVWagCQAze,5Gyp41oLVo7Gg7vF4vpmggWP5MU70QO6,11,8,5,0,4,2,5,1,25,3.5714285714285716,1,0.0,0,5,0,4,8,2,0,5,1,9,16,1
6502,171398,MAbPSnEy6ESOJbtOxM69x4qTaAjZoj0h,5Gyp41oLVo7Gg7vF4vpmggWP5MU70QO6,1,0,0,0,0,0,1,0,1,0.14285714285714285,1,0.0,0,0,0,0,0,0,0,1,0,0,1,1
6503,171421,eE4DAv5aHElS2DPaTad4VXPjk6A3xvPl,5Gyp41oLVo7Gg7vF4vpmggWP5MU70QO6,1,0,0,0,0,0,1,0,1,0.14285714285714285,1,0.0,0,0,0,0,0,0,0,1,0,0,1,1
6504,171446,g1Cr8oGjwnibXUxENrZW4o7CTbjhe1X9,5Gyp41oLVo7Gg7vF4vpmggWP5MU70QO6,9,7,3,2,2,0,3,0,17,2.4285714285714284,1,0.0,4,3,1,2,3,0,1,3,0,10,7,1
6505,171454,za2dBkPPLD9IPRBjooK7GJit2ulI5UgN,5Gyp41oLVo7Gg7vF4vpmggWP5MU70QO6,4,2,1,0,1,0,1,0,5,0.7142857142857143,1,0.0,0,1,0,1,2,0,0,1,0,2,3,1
6506,171458,b6Qe8q5Fclp7t6LX2p9zT67cdJXJuSE3,5Gyp41oLVo7Gg7vF4vpmggWP5MU70QO6,6,5,3,0,1,0,1,0,10,1.4285714285714286,1,0.0,0,3,0,1,5,0,0,1,0,4,6,1
6507,171470,ZBlB6Wg7Xnzn1aTO8CFqtYS2fTldmD0G,5Gyp41oLVo7Gg7vF4vpmggWP5MU70QO6,3,2,0,0,0,0,2,0,4,0.5714285714285714,1,0.0,0,0,0,0,2,0,0,2,0,0,4,1
6508,171494,bu1uIofAEXp6y759RqllOrvBV32SRihX,5Gyp41oLVo7Gg7vF4vpmggWP5MU70QO6,11,8,7,0,6,0,2,0,23,3.2857142857142856,1,0.0,0,7,0,6,8,0,0,2,0,13,10,1
6509,171509,ANC0sI5rGZOptNQXEXeynoEKn2Bpk1PU,5Gyp41oLVo7Gg7vF4vpmggWP5MU70QO6,19,24,11,13,6,0,2,0,56,8.0,1,0.0,10,11,9,6,14,0,4,2,0,36,20,1
6510,171537,aAOzFQFrcsF3yrT279qwdyVv9fLaubBQ,5Gyp41oLVo7Gg7vF4vpmggWP5MU70QO6,1,0,0,0,0,0,1,0,1,0.14285714285714285,1,0.0,0,0,0,0,0,0,0,1,0,0,1,1
6511,171540,KGKXtIu1hkHju7SCZs8gtmA9OwHIqK9w,5Gyp41oLVo7Gg7vF4vpmggWP5MU70QO6,5,4,2,0,2,0,5,0,13,1.8571428571428572,1,0.0,0,2,0,2,4,0,0,5,0,4,9,1
6512,171544,BCNID86vmrRX3R9DuKj7YIYUpL4fSJYm,5Gyp41oLVo7Gg7vF4vpmggWP5MU70QO6,8,5,3,0,2,0,7,0,17,2.4285714285714284,2,0.0,0,3,0,2,5,0,0,7,0,5,12,1
6513,171549,V2NRv3Sit8lMwet1uVs2Kp9JtB3zeCKG,5Gyp41oLVo7Gg7vF4vpmggWP5MU70QO6,4,2,1,0,1,0,1,0,5,0.7142857142857143,1,0.0,0,1,0,1,2,0,0,1,0,2,3,0
6514,171571,k9b7kQx2aSnkvqwGaVUq7WY7auu36Dlh,5Gyp41oLVo7Gg7vF4vpmggWP5MU70QO6,6,2,1,0,1,1,4,0,9,1.2857142857142858,1,0.0,0,1,0,1,2,1,0,4,0,2,7,1
6515,171592,Ru02EutTLrruwAny9ylOJgeAasEsHgbM,5Gyp41oLVo7Gg7vF4vpmggWP5MU70QO6,7,3,2,0,2,0,2,0,9,1.2857142857142858,1,0.0,0,2,0,2,3,0,0,2,0,4,5,1
6516,171598,5vJFPsrBBoU4mJIzAgQct6OtHErWZiWH,5Gyp41oLVo7Gg7vF4vpmggWP5MU70QO6,9,9,4,0,4,0,3,0,20,2.857142857142857,1,0.0,3,4,0,4,6,0,0,3,0,11,9,1
6517,171599,DYy3OcZHNqaAwRPZTK5mmyz2pajxcVFG,5Gyp41oLVo7Gg7vF4vpmggWP5MU70QO6,1,0,0,0,0,0,1,0,1,0.14285714285714285,1,0.0,0,0,0,0,0,0,0,1,0,0,1,1
6518,171601,iZHOjwd7SzBLuq5D09wXvvsBRsDWBAZv,5Gyp41oLVo7Gg7vF4vpmggWP5MU70QO6,1,0,0,0,0,0,1,0,1,0.14285714285714285,1,0.0,0,0,0,0,0,0,0,1,0,0,1,1
6519,171614,ouItlTj5Mb1NgXaWCx2kAeM4hlRK1Dxg,5Gyp41oLVo7Gg7vF4vpmggWP5MU70QO6,14,15,5,0,5,21,19,5,70,10.0,1,0.0,7,5,0,5,8,21,0,19,5,17,53,1
6520,171618,fmeeFnjhwYH2n4i1I5o29mG0vlPSXRPv,5Gyp41oLVo7Gg7vF4vpmggWP5MU70QO6,14,8,4,5,2,3,6,1,29,4.142857142857143,1,0.0,1,4,3,2,7,3,2,6,1,10,19,1
6521,171627,2semIfkfzXAn8VpP32yLN8VRWTW4LvFv,5Gyp41oLVo7Gg7vF4vpmggWP5MU70QO6,6,7,3,0,1,0,2,0,13,1.8571428571428572,1,0.0,0,3,0,1,7,0,0,2,0,4,9,1
6522,171631,9EXZe4rA73rjRwOXuPLFojXAu8sgDIhp,5Gyp41oLVo7Gg7vF4vpmggWP5MU70QO6,1,0,0,0,0,0,1,0,1,0.14285714285714285,1,0.0,0,0,0,0,0,0,0,1,0,0,1,1
6523,171691,OgdOPd05FB8JLqNf2tHQE32wi3JWR5UE,5Gyp41oLVo7Gg7vF4vpmggWP5MU70QO6,1,0,0,0,0,0,1,0,1,0.14285714285714285,1,0.0,0,0,0,0,0,0,0,1,0,0,1,1
6524,171698,wTl3XYUAYzqRMzZkwrXVjeSABzRutm4D,5Gyp41oLVo7Gg7vF4vpmggWP5MU70QO6,1,0,0,0,0,0,1,0,1,0.14285714285714285,1,0.0,0,0,0,0,0,0,0,1,0,0,1,1
6525,171748,cEuj1Vj3kd5U9dS7NtQ6BZ0f1gWSumY3,5Gyp41oLVo7Gg7vF4vpmggWP5MU70QO6,6,3,2,0,1,0,2,0,8,1.1428571428571428,1,0.0,0,2,0,1,3,0,0,2,0,3,5,1
6526,171778,hfDfEOXiIHuyd4ALvi6bYZuABJVi2R5C,5Gyp41oLVo7Gg7vF4vpmggWP5MU70QO6,11,10,7,0,5,0,8,0,30,4.285714285714286,1,0.0,0,7,0,5,10,0,0,8,0,12,18,1
6527,171808,DOUzBowgiBiSd0WY63LnmYU5H1Cyd4yG,5Gyp41oLVo7Gg7vF4vpmggWP5MU70QO6,4,2,1,0,1,0,1,0,5,0.7142857142857143,1,0.0,0,1,0,1,2,0,0,1,0,2,3,1
6528,171821,Xlh5ippHzZXKGtuFirBnUVeacsiFMGpO,5Gyp41oLVo7Gg7vF4vpmggWP5MU70QO6,24,31,11,15,8,2,7,0,74,10.571428571428571,1,0.0,16,11,11,8,15,2,4,7,0,46,28,1
6529,171838,SpJiooDi3NATxGKTLwjsTvo3USLI62CY,5Gyp41oLVo7Gg7vF4vpmggWP5MU70QO6,1,0,0,0,0,0,1,0,1,0.14285714285714285,1,0.0,0,0,0,0,0,0,0,1,0,0,1,1
6530,171842,vUswML4BOS4fQTYdJ1lhDZ3vYOA5s9Z9,5Gyp41oLVo7Gg7vF4vpmggWP5MU70QO6,1,0,0,0,0,0,1,0,1,0.14285714285714285,1,0.0,0,0,0,0,0,0,0,1,0,0,1,1
6531,171845,0mA7W6oH8rftuhpuksmenILG88c2ly8e,5Gyp41oLVo7Gg7vF4vpmggWP5MU70QO6,5,2,1,0,1,0,2,0,6,0.8571428571428571,1,0.0,0,1,0,1,2,0,0,2,0,2,4,0
6532,171850,ok0tlHkljrRyJLc4IxF19K0KxH1EmPpB,5Gyp41oLVo7Gg7vF4vpmggWP5MU70QO6,8,5,2,0,2,1,4,0,14,2.0,1,0.0,0,2,0,2,5,1,0,4,0,4,10,1
6533,171868,IOF8pS0IUBT5xGV0aUjNmWc3XN3KPDuB,5Gyp41oLVo7Gg7vF4vpmggWP5MU70QO6,3,3,1,0,0,0,1,0,5,0.7142857142857143,1,0.0,1,1,0,0,2,0,0,1,0,2,3,1
6534,171931,yNQJXdGIF6UXbO9gVDxTGblaDrQgDoSG,5Gyp41oLVo7Gg7vF4vpmggWP5MU70QO6,1,0,0,0,0,0,1,0,1,0.14285714285714285,1,0.0,0,0,0,0,0,0,0,1,0,0,1,1
6535,171982,K9G1vnDvIQqefCd1TXVzaB5mHYpxWwLV,5Gyp41oLVo7Gg7vF4vpmggWP5MU70QO6,6,2,1,0,1,0,4,0,8,1.1428571428571428,1,0.0,0,1,0,1,2,0,0,4,0,2,6,1
6536,172024,LYVTLxQ7DkIyGxqfGxrucEdheDHteZDT,5Gyp41oLVo7Gg7vF4vpmggWP5MU70QO6,8,9,4,0,5,0,1,0,19,2.7142857142857144,1,0.0,4,4,0,5,5,0,0,1,0,13,6,1
6537,172025,OD35qzGthshP80LHHJJjjzfdibBzRyRk,5Gyp41oLVo7Gg7vF4vpmggWP5MU70QO6,3,2,0,0,0,0,1,0,3,0.42857142857142855,1,0.0,0,0,0,0,2,0,0,1,0,0,3,1
6538,172044,5i9U6osFtARGJN7oErvhXsNBG4TY5tr6,5Gyp41oLVo7Gg7vF4vpmggWP5MU70QO6,10,6,3,6,2,0,2,0,19,2.7142857142857144,1,0.0,3,3,4,2,3,0,2,2,0,12,7,1
6539,172073,rqAQ39ogOkcjPbj0vGYhMl1MCDudE3TF,5Gyp41oLVo7Gg7vF4vpmggWP5MU70QO6,7,5,2,0,1,0,2,0,10,1.4285714285714286,1,0.0,0,2,0,1,5,0,0,2,0,3,7,1
6540,172079,JUXaUT76xGfe9CQCOTjnER9kYb6QPZYj,5Gyp41oLVo7Gg7vF4vpmggWP5MU70QO6,4,3,2,0,2,0,1,0,8,1.1428571428571428,1,0.0,0,2,0,2,3,0,0,1,0,4,4,1
6541,172109,M3wQgbZbbasIjodSdOQuP2oULc0pzjtd,5Gyp41oLVo7Gg7vF4vpmggWP5MU70QO6,8,5,3,0,2,0,3,0,13,1.8571428571428572,1,0.0,0,3,0,2,5,0,0,3,0,5,8,0
6542,172116,dw8UeboqdsSC29cEE9urly5h5PKlFfq8,5Gyp41oLVo7Gg7vF4vpmggWP5MU70QO6,1,0,0,0,0,0,1,0,1,0.14285714285714285,1,0.0,0,0,0,0,0,0,0,1,0,0,1,1
6543,172161,9DRj3AyeoqZYIgzePpOniNsOdPu9PJ5k,5Gyp41oLVo7Gg7vF4vpmggWP5MU70QO6,1,0,0,0,0,0,1,0,1,0.14285714285714285,1,0.0,0,0,0,0,0,0,0,1,0,0,1,1
6544,172162,kbRnk8jChBXXDiqQcJLnXCxKOzDJcEQL,5Gyp41oLVo7Gg7vF4vpmggWP5MU70QO6,5,2,1,0,1,0,2,0,6,0.8571428571428571,1,0.0,0,1,0,1,2,0,0,2,0,2,4,1
6545,172196,LEj3twDvm8YzuICCFE9K4bbYI9Q38Ol1,5Gyp41oLVo7Gg7vF4vpmggWP5MU70QO6,1,0,0,0,0,0,1,0,1,0.14285714285714285,1,0.0,0,0,0,0,0,0,0,1,0,0,1,1
6546,172204,UgIckIONRiYQsrSc5wzXuAP9VmdpXGB8,5Gyp41oLVo7Gg7vF4vpmggWP5MU70QO6,1,0,0,0,0,0,1,0,1,0.14285714285714285,1,0.0,0,0,0,0,0,0,0,1,0,0,1,1
6547,172208,CavZW7Z0WlWqhOFoQNMyOeE9Pj6P8ZHr,5Gyp41oLVo7Gg7vF4vpmggWP5MU70QO6,13,17,7,4,4,1,7,0,40,5.714285714285714,1,0.0,7,7,2,4,10,1,2,7,0,20,20,1
6548,172221,SpT1lJBmYgtY4qTLmB276cnQBIFA3YSB,5Gyp41oLVo7Gg7vF4vpmggWP5MU70QO6,6,0,0,0,0,0,6,1,7,1.0,1,0.0,0,0,0,0,0,0,0,6,1,0,7,1
6549,172245,Wuf3wFhPgxAHU2dsfRihBiOZfwQrF26A,5Gyp41oLVo7Gg7vF4vpmggWP5MU70QO6,2,0,0,0,0,0,10,0,10,1.4285714285714286,2,0.0,0,0,0,0,0,0,0,10,0,0,10,1
6550,172266,jDgR8hp3AGybm19tNOfLciB49pULFenE,5Gyp41oLVo7Gg7vF4vpmggWP5MU70QO6,5,4,1,0,1,0,1,0,7,1.0,1,0.0,0,1,0,1,4,0,0,1,0,2,5,1
6551,172269,XgVxftPVbIHL4AlzkoNcarSFDW4PqduV,5Gyp41oLVo7Gg7vF4vpmggWP5MU70QO6,1,0,0,0,0,0,1,0,1,0.14285714285714285,1,0.0,0,0,0,0,0,0,0,1,0,0,1,1
6552,172270,LP4glPC1eI0AUn2bsFmbsZm4O5jloMa1,5Gyp41oLVo7Gg7vF4vpmggWP5MU70QO6,16,21,9,2,6,0,5,1,44,6.285714285714286,2,0.0,10,9,1,6,11,0,1,5,1,26,18,1
6553,172273,0QuoKrP2mZHT58SMwYhNVh8QIa2Bx3jw,5Gyp41oLVo7Gg7vF4vpmggWP5MU70QO6,5,5,3,0,2,0,4,0,14,2.0,1,0.0,0,3,0,2,5,0,0,4,0,5,9,1
6554,172290,6A2JLpLWnCwUlo9pD1HHlgEwNLvzcllv,5Gyp41oLVo7Gg7vF4vpmggWP5MU70QO6,16,32,10,0,10,0,4,0,56,8.0,2,0.0,19,10,0,10,13,0,0,4,0,39,17,1
6555,172299,4n2Nl0tZzHoOppEWgxt4u2hY4geVVtJJ,5Gyp41oLVo7Gg7vF4vpmggWP5MU70QO6,1,0,0,0,0,0,1,0,1,0.14285714285714285,1,0.0,0,0,0,0,0,0,0,1,0,0,1,1
6556,172330,cJcuhtji0eqLhfXtnFSDlw6v5huTlvOS,5Gyp41oLVo7Gg7vF4vpmggWP5MU70QO6,9,8,4,0,2,0,4,0,18,2.5714285714285716,1,0.0,0,4,0,2,8,0,0,4,0,6,12,1
6557,172336,C7Kxgeum6WfhLueDjQns6qbe6TsxlPCK,5Gyp41oLVo7Gg7vF4vpmggWP5MU70QO6,1,0,0,0,0,0,1,0,1,0.14285714285714285,1,0.0,0,0,0,0,0,0,0,1,0,0,1,1
6558,172364,AJ07wanXtz0FO0onqW0kXx88fdVw4CUU,5Gyp41oLVo7Gg7vF4vpmggWP5MU70QO6,8,5,3,0,2,0,4,0,14,2.0,1,0.0,0,3,0,2,5,0,0,4,0,5,9,1
6559,172391,jVbyR2K2eRZglkuIyxRotkq1vJB87WuF,5Gyp41oLVo7Gg7vF4vpmggWP5MU70QO6,4,2,1,0,1,0,1,0,5,0.7142857142857143,1,0.0,0,1,0,1,2,0,0,1,0,2,3,1
6560,172393,ToHAGWzGsMuknDZcxMK3KQMB4qYRNYiR,5Gyp41oLVo7Gg7vF4vpmggWP5MU70QO6,4,2,1,0,0,0,2,0,5,0.7142857142857143,1,0.0,0,1,0,0,2,0,0,2,0,1,4,1
6561,172403,CCYjGlC3FnZWxpVxsninUJMYwb7GhaCL,5Gyp41oLVo7Gg7vF4vpmggWP5MU70QO6,10,6,4,0,2,0,4,0,16,2.2857142857142856,1,0.0,0,4,0,2,6,0,0,4,0,6,10,1
6562,172404,7KKCzQdQ8lXL2UI7NHtE6tx9MmBYSlHi,5Gyp41oLVo7Gg7vF4vpmggWP5MU70QO6,2,0,0,0,0,0,2,0,2,0.2857142857142857,2,0.0,0,0,0,0,0,0,0,2,0,0,2,1
6563,172407,Fvo2ym26Nb6MdSwJQ7nhdYr3i1DMB44W,5Gyp41oLVo7Gg7vF4vpmggWP5MU70QO6,8,12,0,4,0,0,6,0,22,3.142857142857143,1,0.0,6,0,2,0,6,0,2,6,0,8,14,1
6564,172435,Lz8ZDsT5UDCk6bIoizwb1zrh6ADfLJGp,5Gyp41oLVo7Gg7vF4vpmggWP5MU70QO6,8,2,1,0,1,3,7,1,15,2.142857142857143,2,0.0,0,1,0,1,2,3,0,7,1,2,13,1
6565,172452,hOcxouMMFbpEI2zTOGnFUWEG5s3cpCzo,5Gyp41oLVo7Gg7vF4vpmggWP5MU70QO6,6,2,1,0,1,0,4,1,9,1.2857142857142858,1,0.0,0,1,0,1,2,0,0,4,1,2,7,1
6566,172456,OeIZ0kLFk4McziHeHWjQ7xaXpzSyMdD7,5Gyp41oLVo7Gg7vF4vpmggWP5MU70QO6,9,4,2,0,3,2,5,1,17,2.4285714285714284,1,0.0,1,2,0,3,3,2,0,5,1,6,11,1
6567,172481,Dv4nP0an2ZA48lmeMFn0PJPZ7mStVpc5,5Gyp41oLVo7Gg7vF4vpmggWP5MU70QO6,13,46,12,4,2,0,7,0,71,10.142857142857142,3,0.0,2,12,2,2,44,0,2,7,0,18,53,1
6568,172485,wp0FEz5UfidQjtNkAoMN3675JDpXLboE,5Gyp41oLVo7Gg7vF4vpmggWP5MU70QO6,7,3,2,0,2,0,2,0,9,1.2857142857142858,1,0.0,0,2,0,2,3,0,0,2,0,4,5,1
6569,172523,LVDcSR91i9ppIWzVfGhXYeDNMblZuMMy,5Gyp41oLVo7Gg7vF4vpmggWP5MU70QO6,7,3,2,0,2,0,3,0,10,1.4285714285714286,1,0.0,0,2,0,2,3,0,0,3,0,4,6,1
6570,172763,o1UptbeOviyEjGY0uCAPQxZs9fzfyUsl,fbPkOYLVPtPgIt0MxizjfFJov3JbHyAi,1,0,0,0,0,0,1,0,1,0.14285714285714285,1,0.0,0,0,0,0,0,0,0,1,0,0,1,0
6571,172764,2Fiu2ToQOxpXAS5PdySG8JNslcQcfHbt,fbPkOYLVPtPgIt0MxizjfFJov3JbHyAi,7,3,2,0,2,0,2,0,9,1.2857142857142858,1,0.0,0,2,0,2,3,0,0,2,0,4,5,0
6572,172766,QkN5nvBbZszJiSQ2f66kudMZ2eWWY8sa,fbPkOYLVPtPgIt0MxizjfFJov3JbHyAi,13,31,14,0,11,0,12,0,68,9.714285714285714,1,0.0,7,14,0,11,24,0,0,12,0,32,36,0
6573,172770,A1zqAlol8cj15wsUw4Hy06zRYR65hqWX,fbPkOYLVPtPgIt0MxizjfFJov3JbHyAi,10,10,4,0,2,2,6,0,24,3.4285714285714284,1,0.0,0,4,0,2,10,2,0,6,0,6,18,1
6574,172773,Fyprxg8FSY1xRxMcSEB8g2qdW7HIqrOb,fbPkOYLVPtPgIt0MxizjfFJov3JbHyAi,4,2,1,0,1,3,2,0,9,1.2857142857142858,1,0.0,0,1,0,1,2,3,0,2,0,2,7,1
6575,172775,1ahaNbr5YZ3IpOgQelHrM05Cdnz4LKNQ,fbPkOYLVPtPgIt0MxizjfFJov3JbHyAi,12,11,6,3,6,0,4,0,30,4.285714285714286,1,0.0,4,6,3,6,7,0,0,4,0,19,11,1
6576,172776,1fw6Vhphihnnp4LoLcorlAZ7Ftif884W,fbPkOYLVPtPgIt0MxizjfFJov3JbHyAi,11,7,6,0,6,0,3,0,22,3.142857142857143,1,0.0,0,6,0,6,7,0,0,3,0,12,10,1
6577,172779,sAW5OueffXrHDi9OJn5sfKiFHR2Wetjn,fbPkOYLVPtPgIt0MxizjfFJov3JbHyAi,2,0,0,0,0,0,4,0,4,0.5714285714285714,1,0.0,0,0,0,0,0,0,0,4,0,0,4,1
6578,172780,GRZEBmREFPHaSEGbNTIsxYrZ7RqP41bT,fbPkOYLVPtPgIt0MxizjfFJov3JbHyAi,7,3,2,0,2,0,2,0,9,1.2857142857142858,1,0.0,0,2,0,2,3,0,0,2,0,4,5,1
6579,172781,rqEzbmzZimqrt0Sfmg3gp671kO3ZAOxK,fbPkOYLVPtPgIt0MxizjfFJov3JbHyAi,6,3,1,0,1,0,2,0,7,1.0,1,0.0,0,1,0,1,3,0,0,2,0,2,5,1
6580,172783,1lEtmFkqYNtAJd4xyiugkmcuZGqi1M5C,fbPkOYLVPtPgIt0MxizjfFJov3JbHyAi,1,0,0,0,0,0,1,0,1,0.14285714285714285,1,0.0,0,0,0,0,0,0,0,1,0,0,1,1
6581,172784,osbamwYgnI3KNh30lDpTfuiU6UKLtXa8,fbPkOYLVPtPgIt0MxizjfFJov3JbHyAi,5,3,1,0,2,0,3,0,9,1.2857142857142858,1,0.0,0,1,0,2,3,0,0,3,0,3,6,1
6582,172787,YY7yHizDn0UpGHVq4qoTfbulP3ev5TkC,fbPkOYLVPtPgIt0MxizjfFJov3JbHyAi,7,11,7,0,2,2,3,0,25,3.5714285714285716,1,0.0,0,7,0,2,11,2,0,3,0,9,16,1
6583,173304,g8m22R7W0Wo8v9RXY0TMbj5qf5RFgvht,5X6FeZozNMgE2VRi3MJYjkkFK8SETtu2,3,2,0,0,0,0,1,0,3,0.42857142857142855,1,0.0,0,0,0,0,2,0,0,1,0,0,3,1
6584,173310,Aoyawwq6v4aq2j3CtQEl64qkYlFXHmWo,5X6FeZozNMgE2VRi3MJYjkkFK8SETtu2,1,0,0,0,0,0,1,0,1,0.14285714285714285,1,0.0,0,0,0,0,0,0,0,1,0,0,1,1
6585,173403,bHdLnMReyagsGG6h5n2AGBcImmRnOGBp,5X6FeZozNMgE2VRi3MJYjkkFK8SETtu2,4,3,1,0,1,0,3,0,8,1.1428571428571428,1,0.0,0,1,0,1,3,0,0,3,0,2,6,1
6586,173413,pZclLMasmWwcOV7UoObjB05HxqI7cJ5M,5X6FeZozNMgE2VRi3MJYjkkFK8SETtu2,1,0,0,0,0,0,1,0,1,0.14285714285714285,1,0.0,0,0,0,0,0,0,0,1,0,0,1,1
6587,173488,n6zGNJI1hLWYjlMIVXYesa3jTXjLwizj,5X6FeZozNMgE2VRi3MJYjkkFK8SETtu2,4,2,1,0,1,0,2,0,6,0.8571428571428571,1,0.0,0,1,0,1,2,0,0,2,0,2,4,1
6588,173547,miazgiIYkCwTjtM7t2vFOCBUAD25ypEf,5X6FeZozNMgE2VRi3MJYjkkFK8SETtu2,2,0,0,0,0,0,2,0,2,0.2857142857142857,1,0.0,0,0,0,0,0,0,0,2,0,0,2,1
6589,173551,VfzK5aO28OrAOvVXtOq353z79D2I5ZHx,SpATywNh6bZuzm8s1ceuBUnMUAeoAHHw,16,18,10,0,5,0,2,0,35,5.0,1,0.0,5,10,0,5,13,0,0,2,0,20,15,0
6590,173637,VYzWVw0iVQTX593OMNoOorSLmzZeKXaW,5X6FeZozNMgE2VRi3MJYjkkFK8SETtu2,1,0,0,0,0,0,1,0,1,0.14285714285714285,1,0.0,0,0,0,0,0,0,0,1,0,0,1,1
6591,173837,mQIPwSx2V8b0TbdjDcVR3P8b5Z7qtGbP,5X6FeZozNMgE2VRi3MJYjkkFK8SETtu2,6,8,1,4,4,0,2,0,19,2.7142857142857144,1,0.0,6,1,4,4,2,0,0,2,0,15,4,1
6592,173987,8c8DYMmupcN8P2qPfMDQe6Ogszyz6VG1,5X6FeZozNMgE2VRi3MJYjkkFK8SETtu2,2,1,0,0,0,0,1,0,2,0.2857142857142857,1,0.0,0,0,0,0,1,0,0,1,0,0,2,1
6593,174079,sheZ4N1GIaslz5kJhHqpayTxVaB6yF6h,5X6FeZozNMgE2VRi3MJYjkkFK8SETtu2,1,0,0,0,0,0,1,0,1,0.14285714285714285,1,0.0,0,0,0,0,0,0,0,1,0,0,1,1
6594,174097,l3LjDqHkcoF39RE2r4Y8HQOp98eEYg6d,5X6FeZozNMgE2VRi3MJYjkkFK8SETtu2,1,0,0,0,0,0,1,0,1,0.14285714285714285,1,0.0,0,0,0,0,0,0,0,1,0,0,1,1
6595,174103,6F1lKjGTd159lFhX2roWh19Brj0u4Zbh,5X6FeZozNMgE2VRi3MJYjkkFK8SETtu2,1,0,0,0,0,0,1,0,1,0.14285714285714285,1,0.0,0,0,0,0,0,0,0,1,0,0,1,1
6596,174116,89IraAtUfhoGAQgzdMP1844g2s2iN4Ox,SpATywNh6bZuzm8s1ceuBUnMUAeoAHHw,6,4,3,0,1,0,1,0,9,1.2857142857142858,1,0.0,0,3,0,1,4,0,0,1,0,4,5,1
6597,174301,m03K9KziYA4aijvIDRK7t2E4lIAdgRz2,RXDvfPUBYFlVdlueBFbLW0mhhAyGEqpt,6,3,2,0,1,0,2,0,8,1.1428571428571428,1,0.0,0,2,0,1,3,0,0,2,0,3,5,1
6598,174467,vnBONRqvzvm1KY9GmYXYArKs5stTyMmI,SpATywNh6bZuzm8s1ceuBUnMUAeoAHHw,28,30,20,17,9,2,8,2,88,12.571428571428571,2,0.0,2,20,15,9,28,2,2,8,2,46,42,0
6599,174662,lLiIUuRVh7zWAyO13URKYp0g2hIHe8bt,5X6FeZozNMgE2VRi3MJYjkkFK8SETtu2,6,7,4,0,2,0,6,0,19,2.7142857142857144,2,0.0,0,4,0,2,7,0,0,6,0,6,13,1
6600,174663,DJXmR0KXC00UhtfnxnB0CPGhSlDcn5wL,5X6FeZozNMgE2VRi3MJYjkkFK8SETtu2,2,0,0,0,0,0,2,0,2,0.2857142857142857,1,0.0,0,0,0,0,0,0,0,2,0,0,2,1
6601,174699,Qn3OccgDXQpcut9yLA9jXfau6FPbS72n,G8EPVSXsOYB5YQWZGiz1aVq5Pgr2GrQu,1,0,0,0,0,0,1,0,1,0.14285714285714285,1,0.0,0,0,0,0,0,0,0,1,0,0,1,1
6602,174713,Bos3zEEnAcYzPXQktMkJJ0ak5mhGWCAf,5X6FeZozNMgE2VRi3MJYjkkFK8SETtu2,2,0,0,0,0,0,2,0,2,0.2857142857142857,1,0.0,0,0,0,0,0,0,0,2,0,0,2,1
6603,174878,fUQHFT4QEMRSPqJAQlXlvlyNwca9Q0dU,RXDvfPUBYFlVdlueBFbLW0mhhAyGEqpt,4,3,1,0,0,0,1,0,5,0.7142857142857143,1,0.0,0,1,0,0,3,0,0,1,0,1,4,1
6604,174911,A7SG5Yt68PpWuTq6repTaMGrRX2jTAUI,5X6FeZozNMgE2VRi3MJYjkkFK8SETtu2,21,77,28,31,20,50,20,3,229,32.714285714285715,3,0.0,38,28,22,20,39,50,9,20,3,108,121,0
6605,174950,mwYPrzi4Um5Na0nVSY9kyLDHIIMuUNwA,5X6FeZozNMgE2VRi3MJYjkkFK8SETtu2,5,2,1,0,1,0,2,0,6,0.8571428571428571,1,0.0,0,1,0,1,2,0,0,2,0,2,4,1
6606,174995,StcQZMEDAMldF4GFQUzkrPFNVNZnPaeq,5X6FeZozNMgE2VRi3MJYjkkFK8SETtu2,1,0,0,0,0,0,1,0,1,0.14285714285714285,1,0.0,0,0,0,0,0,0,0,1,0,0,1,1
6607,175025,LkBKnxnSHkOGgNJ9NivPrJlZnjpZUjRj,5X6FeZozNMgE2VRi3MJYjkkFK8SETtu2,2,0,0,0,0,0,3,0,3,0.42857142857142855,1,0.0,0,0,0,0,0,0,0,3,0,0,3,1
6608,175055,O3zeeuO5s75bVIeVANx1rSMNWDZJgeIr,5X6FeZozNMgE2VRi3MJYjkkFK8SETtu2,2,0,0,0,0,0,2,0,2,0.2857142857142857,1,0.0,0,0,0,0,0,0,0,2,0,0,2,1
6609,175077,nG6erQ4cKSx83WV5mn5rC7gtfnWhkEmP,5X6FeZozNMgE2VRi3MJYjkkFK8SETtu2,2,0,0,0,0,0,2,0,2,0.2857142857142857,1,0.0,0,0,0,0,0,0,0,2,0,0,2,1
6610,175246,kaNpWuIxNLxZkDfmjMzrYRVzuOgwIf0o,SpATywNh6bZuzm8s1ceuBUnMUAeoAHHw,1,0,0,0,0,0,1,0,1,0.14285714285714285,1,0.0,0,0,0,0,0,0,0,1,0,0,1,1
6611,175627,OXOYSOE5xESQ1Gjq8G2fhpSLV6URtrOK,5Gyp41oLVo7Gg7vF4vpmggWP5MU70QO6,4,3,1,0,0,0,4,0,8,1.1428571428571428,1,0.0,0,1,0,0,3,0,0,4,0,1,7,1
6612,175639,G218r5vAiYX0kE0Hge2wz8kLd1kzXR68,5Gyp41oLVo7Gg7vF4vpmggWP5MU70QO6,8,2,1,0,1,0,5,1,10,1.4285714285714286,1,0.0,0,1,0,1,2,0,0,5,1,2,8,1
6613,175641,zmQIE5mM7oLpM2IKO3AMgEeZhkuodsci,5Gyp41oLVo7Gg7vF4vpmggWP5MU70QO6,7,3,2,0,2,0,2,0,9,1.2857142857142858,1,0.0,0,2,0,2,3,0,0,2,0,4,5,1
6614,175675,6OEy5Qsip3QZp8NWdQCKQz0VG3aASwQd,5Gyp41oLVo7Gg7vF4vpmggWP5MU70QO6,9,4,1,0,2,0,6,1,14,2.0,1,0.0,1,1,0,2,3,0,0,6,1,4,10,0
6615,175688,2MXxsFodtPZQZbyoni7CUTGVtJgR6nz8,5Gyp41oLVo7Gg7vF4vpmggWP5MU70QO6,8,8,2,0,3,0,4,1,18,2.5714285714285716,1,0.0,3,2,0,3,5,0,0,4,1,8,10,1
6616,175709,OHv5eBJwDSofxA500UmLp6HtEa0aAaGY,5Gyp41oLVo7Gg7vF4vpmggWP5MU70QO6,7,3,2,0,2,0,2,0,9,1.2857142857142858,1,0.0,0,2,0,2,3,0,0,2,0,4,5,1
6617,175726,uCimH1JH6oHe0p4Vspf06pm160TYESmb,5Gyp41oLVo7Gg7vF4vpmggWP5MU70QO6,7,3,2,0,2,0,2,0,9,1.2857142857142858,1,0.0,0,2,0,2,3,0,0,2,0,4,5,1
6618,175737,DolNrwJKNdLotdaygIGHUrgpPWfyFClq,5Gyp41oLVo7Gg7vF4vpmggWP5MU70QO6,9,5,3,2,2,0,2,0,14,2.0,1,0.0,1,3,1,2,4,0,1,2,0,7,7,1
6619,175749,2IithoNfdrvM5eGRVjgTR9uolPixS4we,5Gyp41oLVo7Gg7vF4vpmggWP5MU70QO6,5,2,0,0,0,0,10,1,13,1.8571428571428572,1,0.0,0,0,0,0,2,0,0,10,1,0,13,1
6620,175768,2AHJHnjb8SXAMo7OtKtBYbb2sTZZwOZr,5Gyp41oLVo7Gg7vF4vpmggWP5MU70QO6,1,0,0,0,0,0,1,0,1,0.14285714285714285,1,0.0,0,0,0,0,0,0,0,1,0,0,1,1
6621,175770,kT1UDJ3b1RaguBPE2kXWbSAADTH3cQQD,5Gyp41oLVo7Gg7vF4vpmggWP5MU70QO6,11,9,8,0,8,0,7,0,32,4.571428571428571,1,0.0,0,8,0,8,9,0,0,7,0,16,16,1
6622,175773,UHhf3OS5KTsSmirrMDTBosghF0Ip6ptz,5Gyp41oLVo7Gg7vF4vpmggWP5MU70QO6,1,0,0,0,0,0,1,0,1,0.14285714285714285,1,0.0,0,0,0,0,0,0,0,1,0,0,1,1
6623,175774,aXwbww762RZoiNwx8tqGf3TROakJxF0X,5Gyp41oLVo7Gg7vF4vpmggWP5MU70QO6,1,0,0,0,0,0,1,0,1,0.14285714285714285,1,0.0,0,0,0,0,0,0,0,1,0,0,1,1
6624,175783,AnukCSBaHyReNig75Cna2HDQpC3ZFPPm,5Gyp41oLVo7Gg7vF4vpmggWP5MU70QO6,7,4,2,0,2,0,2,0,10,1.4285714285714286,1,0.0,0,2,0,2,4,0,0,2,0,4,6,1
6625,175812,vMjMvu2w7EqTJIdUYKacGvXxAvTKy2vm,5Gyp41oLVo7Gg7vF4vpmggWP5MU70QO6,1,0,0,0,0,0,1,0,1,0.14285714285714285,1,0.0,0,0,0,0,0,0,0,1,0,0,1,1
6626,175815,Sg92o0PEQpIFC9qNLkzOdhiftfF6FHXu,5Gyp41oLVo7Gg7vF4vpmggWP5MU70QO6,3,0,0,0,0,1,2,0,3,0.42857142857142855,1,0.0,0,0,0,0,0,1,0,2,0,0,3,1
6627,175837,3E1IiHuaaNr7V6JL7OW1lyuFpOSWkFGt,5Gyp41oLVo7Gg7vF4vpmggWP5MU70QO6,8,2,1,0,1,0,5,2,11,1.5714285714285714,1,0.0,0,1,0,1,2,0,0,5,2,2,9,1
6628,175905,ULWsHkINELJWirVgQ5povptML27OQ0Va,5Gyp41oLVo7Gg7vF4vpmggWP5MU70QO6,1,0,0,0,0,0,1,0,1,0.14285714285714285,1,0.0,0,0,0,0,0,0,0,1,0,0,1,1
6629,175913,TFGckN2p7irF2yrcTGKvlMtaBQ4cfPzU,5Gyp41oLVo7Gg7vF4vpmggWP5MU70QO6,7,2,1,0,1,1,4,1,10,1.4285714285714286,1,0.0,0,1,0,1,2,1,0,4,1,2,8,1
6630,175930,6nGA92YRip7jg71OkkPPooF7PcunylJo,5Gyp41oLVo7Gg7vF4vpmggWP5MU70QO6,1,0,0,0,0,0,1,0,1,0.14285714285714285,1,0.0,0,0,0,0,0,0,0,1,0,0,1,1
6631,175970,27QdoqoE4E9Ofii5y2HdEzNAfJST7pd2,5Gyp41oLVo7Gg7vF4vpmggWP5MU70QO6,6,4,1,0,1,0,3,0,9,1.2857142857142858,1,0.0,0,1,0,1,4,0,0,3,0,2,7,1
6632,175981,rHGDNXkG8lL5NzGEWERCUh2InM6QHuif,5Gyp41oLVo7Gg7vF4vpmggWP5MU70QO6,5,2,1,0,1,0,2,0,6,0.8571428571428571,1,0.0,0,1,0,1,2,0,0,2,0,2,4,1
6633,175994,L5pA3H7m2qYFia4DHW15gmoKoflabQUC,5Gyp41oLVo7Gg7vF4vpmggWP5MU70QO6,1,0,0,0,0,0,1,0,1,0.14285714285714285,1,0.0,0,0,0,0,0,0,0,1,0,0,1,1
6634,176001,BGCcw0fy5ZQWp2D5IsicQr89n1ir9IZ1,5Gyp41oLVo7Gg7vF4vpmggWP5MU70QO6,6,2,1,0,1,1,4,0,9,1.2857142857142858,1,0.0,0,1,0,1,2,1,0,4,0,2,7,1
6635,176020,Gjof7nwuuC0llLFQCxUKr52bfl2vEG8S,5Gyp41oLVo7Gg7vF4vpmggWP5MU70QO6,1,0,0,0,0,0,1,0,1,0.14285714285714285,1,0.0,0,0,0,0,0,0,0,1,0,0,1,1
6636,176034,YHML6rlViSGlLrxoBJcwm2Z7dntjADR7,5Gyp41oLVo7Gg7vF4vpmggWP5MU70QO6,10,13,5,0,4,0,4,0,26,3.7142857142857144,1,0.0,0,5,0,4,13,0,0,4,0,9,17,1
6637,176049,HoO8LKjjUMgJCeJcpwq1z7Z3nTHrSV55,5Gyp41oLVo7Gg7vF4vpmggWP5MU70QO6,1,0,0,0,0,0,1,0,1,0.14285714285714285,1,0.0,0,0,0,0,0,0,0,1,0,0,1,1
6638,176055,qV1S8QUOKPqreWUTjkx6WVJTN4pWj82J,5Gyp41oLVo7Gg7vF4vpmggWP5MU70QO6,1,0,0,0,0,0,1,0,1,0.14285714285714285,1,0.0,0,0,0,0,0,0,0,1,0,0,1,1
6639,176084,GZDQ8L9ZuAQpfRDMNlq0cQ9JgSDXkbdl,5Gyp41oLVo7Gg7vF4vpmggWP5MU70QO6,6,2,1,0,1,0,3,0,7,1.0,2,0.0,0,1,0,1,2,0,0,3,0,2,5,1
6640,176097,2qLjEwt5xNnoEg9w8OrKwqJNq7w6TcUE,5Gyp41oLVo7Gg7vF4vpmggWP5MU70QO6,1,0,0,0,0,0,1,0,1,0.14285714285714285,1,0.0,0,0,0,0,0,0,0,1,0,0,1,1
6641,176124,fwSNAXQt0hIgr6AkDrREt5ZXQgBknmEh,5Gyp41oLVo7Gg7vF4vpmggWP5MU70QO6,21,24,23,0,4,0,2,0,53,7.571428571428571,2,0.0,0,23,0,4,24,0,0,2,0,27,26,1
6642,176126,Ne25k1DU4nK81LWo7930HvBFWlFV2ZKt,5Gyp41oLVo7Gg7vF4vpmggWP5MU70QO6,10,5,3,0,4,0,5,0,17,2.4285714285714284,2,0.0,1,3,0,4,4,0,0,5,0,8,9,1
6643,176133,e6wP3becPmfG6HGdByUW00ZFxRLgAmgY,5Gyp41oLVo7Gg7vF4vpmggWP5MU70QO6,5,3,1,0,1,0,2,0,7,1.0,1,0.0,0,1,0,1,3,0,0,2,0,2,5,1
6644,176146,p4yxCxiqzIMRoAwoOyGnN7P9RZxypnFm,5Gyp41oLVo7Gg7vF4vpmggWP5MU70QO6,2,0,0,0,0,0,2,0,2,0.2857142857142857,1,0.0,0,0,0,0,0,0,0,2,0,0,2,0
6645,176171,uLKNUudVJDfzgTZMOzwyuzGBp4DvN0Tz,5Gyp41oLVo7Gg7vF4vpmggWP5MU70QO6,1,0,0,0,0,0,1,0,1,0.14285714285714285,1,0.0,0,0,0,0,0,0,0,1,0,0,1,1
6646,176192,44tKc1mf7lNbOwyGoI3ynKY4VpqC9O0k,5Gyp41oLVo7Gg7vF4vpmggWP5MU70QO6,1,0,0,0,0,0,1,0,1,0.14285714285714285,1,0.0,0,0,0,0,0,0,0,1,0,0,1,1
6647,176203,76U6Fp7U8Q2ccJndjwoG11QEiRczX2X3,5Gyp41oLVo7Gg7vF4vpmggWP5MU70QO6,1,0,0,0,0,0,1,0,1,0.14285714285714285,1,0.0,0,0,0,0,0,0,0,1,0,0,1,1
6648,176212,dor8frMpeKd5G3cE04cmbXxbireX88re,5Gyp41oLVo7Gg7vF4vpmggWP5MU70QO6,1,0,0,0,0,0,1,0,1,0.14285714285714285,1,0.0,0,0,0,0,0,0,0,1,0,0,1,1
6649,176214,yMKOk0dVftHnVR1CEiO9scq4ARXi4xK4,5Gyp41oLVo7Gg7vF4vpmggWP5MU70QO6,7,3,2,0,2,0,2,0,9,1.2857142857142858,1,0.0,0,2,0,2,3,0,0,2,0,4,5,1
6650,176223,RVzC5vQBqN30AW6Su7sjAfdP0iWczm3N,5Gyp41oLVo7Gg7vF4vpmggWP5MU70QO6,9,5,4,0,3,0,1,0,13,1.8571428571428572,1,0.0,0,4,0,3,5,0,0,1,0,7,6,1
6651,176248,Mj17Hk7aRKjaZReAMwyd4FAY5ldQsDAX,5Gyp41oLVo7Gg7vF4vpmggWP5MU70QO6,2,0,0,0,0,0,3,0,3,0.42857142857142855,1,0.0,0,0,0,0,0,0,0,3,0,0,3,1
6652,176264,4KtLnsvXpD29nfiYTBpcCcSvsc0fe43F,5Gyp41oLVo7Gg7vF4vpmggWP5MU70QO6,14,15,5,7,2,4,7,2,42,6.0,1,0.0,3,5,2,2,12,4,5,7,2,12,30,0
6653,176305,aF8xf13frnCZYncJXqcZ1YYKorqDTRSa,5Gyp41oLVo7Gg7vF4vpmggWP5MU70QO6,6,3,1,0,1,2,6,0,13,1.8571428571428572,1,0.0,0,1,0,1,3,2,0,6,0,2,11,1
6654,176413,D0DS3PcqkWtMhWmrWYDI3H9xnPeFgKco,5X6FeZozNMgE2VRi3MJYjkkFK8SETtu2,6,4,3,0,2,0,2,0,11,1.5714285714285714,1,0.0,0,3,0,2,4,0,0,2,0,5,6,1
6655,176451,oKu6VLpnoojteApzRKKjWrPb4vBoBjWk,5X6FeZozNMgE2VRi3MJYjkkFK8SETtu2,1,0,0,0,0,0,1,0,1,0.14285714285714285,1,0.0,0,0,0,0,0,0,0,1,0,0,1,1
6656,176454,O3FQHm8T0e3Sm0WiQAK4kR4V6HIDFaZD,5X6FeZozNMgE2VRi3MJYjkkFK8SETtu2,5,3,2,0,2,0,2,0,9,1.2857142857142858,1,0.0,0,2,0,2,3,0,0,2,0,4,5,1
6657,176457,0w96VyuRH6QOKeIyQlnOR4AwsQ0QEuXu,5X6FeZozNMgE2VRi3MJYjkkFK8SETtu2,1,0,0,0,0,0,1,0,1,0.14285714285714285,1,0.0,0,0,0,0,0,0,0,1,0,0,1,1
6658,176475,IfDHOpQPeanhI9RrYG5jJZhgxxW26HTd,5X6FeZozNMgE2VRi3MJYjkkFK8SETtu2,1,0,0,0,0,0,1,0,1,0.14285714285714285,1,0.0,0,0,0,0,0,0,0,1,0,0,1,0
6659,176552,KjugBA6V5bkEA5fAIbJoGnSUlDhZoaIH,5X6FeZozNMgE2VRi3MJYjkkFK8SETtu2,5,4,1,0,0,0,5,0,10,1.4285714285714286,1,0.0,0,1,0,0,4,0,0,5,0,1,9,0
6660,176595,VhtnI0jXlmYjp8tocIt6NwYAhqIJcpfm,RXDvfPUBYFlVdlueBFbLW0mhhAyGEqpt,1,0,0,0,0,0,1,0,1,0.14285714285714285,1,0.0,0,0,0,0,0,0,0,1,0,0,1,1
6661,176651,YqY5WPa8kwIoLBKGaVnXfSZOMvkSrEdU,5X6FeZozNMgE2VRi3MJYjkkFK8SETtu2,1,0,0,0,0,0,1,0,1,0.14285714285714285,1,0.0,0,0,0,0,0,0,0,1,0,0,1,1
6662,176706,RPNytg6jKosKSPSkg7bLhh3BAXDjaY9a,RXDvfPUBYFlVdlueBFbLW0mhhAyGEqpt,11,8,0,12,1,0,2,0,23,3.2857142857142856,2,0.0,2,0,12,1,6,0,0,2,0,15,8,1
6663,176714,mP0oq4UFI55XwGbomuLjnKyaYZ9Irhl8,RXDvfPUBYFlVdlueBFbLW0mhhAyGEqpt,1,0,0,0,0,0,1,0,1,0.14285714285714285,1,0.0,0,0,0,0,0,0,0,1,0,0,1,1
6664,176736,GHfo4pUmbP0HyeQVp8PPz8kn0kTFo6yb,SpATywNh6bZuzm8s1ceuBUnMUAeoAHHw,14,15,0,13,0,0,2,0,30,4.285714285714286,1,0.0,4,0,13,0,11,0,0,2,0,17,13,0
6665,176752,CLwGKZEkoE30u30h4sBCUDzwMF5kR7gp,5X6FeZozNMgE2VRi3MJYjkkFK8SETtu2,3,3,1,0,0,0,1,0,5,0.7142857142857143,1,0.0,0,1,0,0,3,0,0,1,0,1,4,0
6666,176794,irUhnQtLaQWO9Ilnw5LLg2nfVwuwwh1f,G8EPVSXsOYB5YQWZGiz1aVq5Pgr2GrQu,1,0,0,0,0,0,1,0,1,0.14285714285714285,1,0.0,0,0,0,0,0,0,0,1,0,0,1,1
6667,176822,BEwpQuUn0betGBYfWGax81LgeoTlg8LE,SpATywNh6bZuzm8s1ceuBUnMUAeoAHHw,12,10,0,12,0,0,1,0,23,3.2857142857142856,1,0.0,2,0,12,0,8,0,0,1,0,14,9,0
6668,176882,e6qJWnBH5Aakpza4HlA3Q0irc2hEFZ0M,G8EPVSXsOYB5YQWZGiz1aVq5Pgr2GrQu,1,0,0,0,0,0,1,0,1,0.14285714285714285,1,0.0,0,0,0,0,0,0,0,1,0,0,1,1
6669,176886,KTcmc9IfHm2rSJ5YQNSXr92mTVEV8NoQ,5X6FeZozNMgE2VRi3MJYjkkFK8SETtu2,7,13,0,0,3,0,2,0,18,2.5714285714285716,1,0.0,6,0,0,3,7,0,0,2,0,9,9,0
6670,176923,AMJBHnJeXp5B5SBQNlM30pAlrKlBFahS,G8EPVSXsOYB5YQWZGiz1aVq5Pgr2GrQu,6,5,1,0,0,0,1,0,7,1.0,1,0.0,0,1,0,0,5,0,0,1,0,1,6,1
6671,176947,xOtdHo3wrVhEHE7TFWr0saCeohN8PpCL,RXDvfPUBYFlVdlueBFbLW0mhhAyGEqpt,19,9,6,76,0,0,3,0,94,13.428571428571429,1,0.0,2,6,67,0,7,0,9,3,0,75,19,0
6672,177106,EPVEir3f8DxjouE65Q4kYI9YaQMxGE89,RXDvfPUBYFlVdlueBFbLW0mhhAyGEqpt,6,5,0,0,0,0,2,0,7,1.0,1,0.0,0,0,0,0,5,0,0,2,0,0,7,1
6673,177113,66JqxLLiEx06fBDzS4MuyYNc7nIpYGk9,A3fsA9Zfv1X2fVEQhTw51lKENdNrEqT3,7,4,3,0,2,0,1,0,10,1.4285714285714286,1,0.0,0,3,0,2,4,0,0,1,0,5,5,0
6674,177138,6d8C8yee0ddJ6Jgl51ehsW37Gh3pz3CL,RXDvfPUBYFlVdlueBFbLW0mhhAyGEqpt,15,23,9,0,9,0,5,1,47,6.714285714285714,1,0.0,2,9,0,9,21,0,0,5,1,20,27,1
6675,177238,hCQXqI8iQlGgI9I7RIJmpkxpbOJGkTCt,RXDvfPUBYFlVdlueBFbLW0mhhAyGEqpt,14,10,8,12,6,0,5,0,41,5.857142857142857,1,0.0,1,8,12,6,9,0,0,5,0,27,14,1
6676,177325,LchclclKlrYHOcXtmhi0Eqhs9daD9eJz,RXDvfPUBYFlVdlueBFbLW0mhhAyGEqpt,26,17,8,46,5,2,3,0,81,11.571428571428571,1,0.0,8,8,44,5,9,2,2,3,0,65,16,1
6677,177367,nIvIddlMAmTQagaACOulbZ6PInxlyOy2,5X6FeZozNMgE2VRi3MJYjkkFK8SETtu2,10,11,4,8,3,0,2,0,28,4.0,1,0.0,5,4,7,3,6,0,1,2,0,19,9,1
6678,177475,kg6Avyi36lrn1xiUPv7mqR2okQaeNtUx,5X6FeZozNMgE2VRi3MJYjkkFK8SETtu2,7,5,2,0,3,2,3,0,15,2.142857142857143,1,0.0,2,2,0,3,3,2,0,3,0,7,8,1
6679,177497,6AH2bS5pfPPDGjFaKt7vgWNStmoXDf9t,RXDvfPUBYFlVdlueBFbLW0mhhAyGEqpt,8,4,1,0,1,7,7,0,20,2.857142857142857,1,0.0,0,1,0,1,4,7,0,7,0,2,18,1
6680,177561,FmxPauZCcN5TsI90By7Uh5tN8Q2Qo10j,5X6FeZozNMgE2VRi3MJYjkkFK8SETtu2,1,0,0,0,0,0,1,0,1,0.14285714285714285,1,0.0,0,0,0,0,0,0,0,1,0,0,1,1
6681,178241,TY4t65XwSRMNK0q3MPTxoH0jDDniCwnz,3VkHkmOtom3jM2wCu94xgzzu1d6Dn7or,17,34,9,18,8,10,3,0,82,11.714285714285714,1,0.0,12,9,17,8,22,10,1,3,0,46,36,1
6682,178247,pAK3JL9nOUE6ElEWOzQCcrLzC9DIz75y,3VkHkmOtom3jM2wCu94xgzzu1d6Dn7or,1,0,0,0,0,0,1,0,1,0.14285714285714285,1,0.0,0,0,0,0,0,0,0,1,0,0,1,1
6683,178296,GGDBEvjaACiSZQampqxQz2sgcfzT2xkK,3VkHkmOtom3jM2wCu94xgzzu1d6Dn7or,2,0,0,0,0,0,2,0,2,0.2857142857142857,1,0.0,0,0,0,0,0,0,0,2,0,0,2,1
6684,178312,WzbBhY7PPwDbKcr5cy3SQJUMexrza6T3,3VkHkmOtom3jM2wCu94xgzzu1d6Dn7or,18,26,10,19,12,0,2,0,69,9.857142857142858,1,0.0,15,10,15,12,11,0,4,2,0,52,17,0
6685,178326,fXzX29qCY75dHs5GbBNWch9q4sEll7tc,3VkHkmOtom3jM2wCu94xgzzu1d6Dn7or,1,0,0,0,0,0,1,0,1,0.14285714285714285,1,0.0,0,0,0,0,0,0,0,1,0,0,1,1
6686,178333,95Q9KIbaZc3PIrmPnrRNws7TPRZmIUn3,3VkHkmOtom3jM2wCu94xgzzu1d6Dn7or,5,18,0,0,0,0,6,0,24,3.4285714285714284,1,0.0,0,0,0,0,18,0,0,6,0,0,24,1
6687,178336,2jQIZm4r1ZdKRG6ONVUMJuxDKPQlwLnX,3VkHkmOtom3jM2wCu94xgzzu1d6Dn7or,18,9,7,0,8,0,2,0,26,3.7142857142857144,1,0.0,1,7,0,8,8,0,0,2,0,16,10,1
6688,178339,3YNDQ9HlzmkqaiTl4QusF9pDU1NGEW6Y,3VkHkmOtom3jM2wCu94xgzzu1d6Dn7or,5,3,1,0,1,0,4,0,9,1.2857142857142858,1,0.0,1,1,0,1,2,0,0,4,0,3,6,1
6689,178357,LenizO7WIZrXvyQ6XIzz5famelwMYXXi,3VkHkmOtom3jM2wCu94xgzzu1d6Dn7or,5,3,1,0,1,0,3,0,8,1.1428571428571428,1,0.0,0,1,0,1,3,0,0,3,0,2,6,1
6690,178387,gdwF9XR8Xpzo8gL6dV1NzSZ7vu4bXRLw,3VkHkmOtom3jM2wCu94xgzzu1d6Dn7or,1,0,0,0,0,0,2,0,2,0.2857142857142857,1,0.0,0,0,0,0,0,0,0,2,0,0,2,0
6691,178390,KcIgH6BTbf5UYqPK5e0rO1gbcEdYcouv,3VkHkmOtom3jM2wCu94xgzzu1d6Dn7or,11,15,0,0,0,2,5,0,22,3.142857142857143,1,0.0,0,0,0,0,15,2,0,5,0,0,22,1
6692,178405,qSdRUaRT6TLZlucPzeApIsYGcjbAWzoN,3VkHkmOtom3jM2wCu94xgzzu1d6Dn7or,1,0,0,0,0,0,1,0,1,0.14285714285714285,1,0.0,0,0,0,0,0,0,0,1,0,0,1,1
6693,178413,gmvkP36dUhO1IjRmv1lLf6yGGtsBjVXA,3VkHkmOtom3jM2wCu94xgzzu1d6Dn7or,2,0,0,0,0,0,4,0,4,0.5714285714285714,1,0.0,0,0,0,0,0,0,0,4,0,0,4,1
6694,178435,zXaIFCKxfdY9z9fVBcdJ9CKQhYz4fcsP,3VkHkmOtom3jM2wCu94xgzzu1d6Dn7or,4,2,1,0,1,0,1,0,5,0.7142857142857143,1,0.0,0,1,0,1,2,0,0,1,0,2,3,0
6695,178467,Do66WCKDNxgmYoj93CHEnWXTvirOCxw7,3VkHkmOtom3jM2wCu94xgzzu1d6Dn7or,1,0,0,0,0,0,1,0,1,0.14285714285714285,1,0.0,0,0,0,0,0,0,0,1,0,0,1,1
6696,178484,DRegbZtztbDzfFAIDX6e5PDqboL8isDw,3VkHkmOtom3jM2wCu94xgzzu1d6Dn7or,1,0,0,0,0,0,1,0,1,0.14285714285714285,1,0.0,0,0,0,0,0,0,0,1,0,0,1,1
6697,178553,yV4UETFEi3JBAhsQHPqkVkaRjz4EU8w3,3VkHkmOtom3jM2wCu94xgzzu1d6Dn7or,1,0,0,0,0,0,1,0,1,0.14285714285714285,1,0.0,0,0,0,0,0,0,0,1,0,0,1,1
6698,178592,9CsgDhj3d2ihI7xcZwIVEoQTTeVHShPp,3VkHkmOtom3jM2wCu94xgzzu1d6Dn7or,1,0,0,0,0,0,1,0,1,0.14285714285714285,1,0.0,0,0,0,0,0,0,0,1,0,0,1,1
6699,178603,WlS78rUQAxTgHFyIAu04YS47iktWxxPR,3VkHkmOtom3jM2wCu94xgzzu1d6Dn7or,2,0,0,0,0,0,2,0,2,0.2857142857142857,1,0.0,0,0,0,0,0,0,0,2,0,0,2,1
6700,178620,mdnioLDSZ1Gz7WvAWQRWotu1cuvELoUd,3VkHkmOtom3jM2wCu94xgzzu1d6Dn7or,11,21,13,0,9,0,6,0,49,7.0,5,0.0,2,13,0,9,19,0,0,6,0,24,25,0
6701,178625,movdjrYCfnJMfd9wvIPPthaZq1W8AtQy,3VkHkmOtom3jM2wCu94xgzzu1d6Dn7or,1,0,0,0,0,0,1,0,1,0.14285714285714285,1,0.0,0,0,0,0,0,0,0,1,0,0,1,1
6702,178626,q7moRFMHVwQpRKPFnrQikrPXmZ6umVEi,3VkHkmOtom3jM2wCu94xgzzu1d6Dn7or,11,11,4,0,4,6,16,3,44,6.285714285714286,2,0.0,5,4,0,4,6,6,0,16,3,13,31,1
6703,178687,AuQrdDkaOVNdwuE2sCqLolxJPeSXxcim,3VkHkmOtom3jM2wCu94xgzzu1d6Dn7or,8,9,3,4,4,1,4,0,25,3.5714285714285716,1,0.0,4,3,3,4,5,1,1,4,0,14,11,1
6704,178693,tvIvEXoeBhrp2nV048Q2FjnK3OqpjH6r,3VkHkmOtom3jM2wCu94xgzzu1d6Dn7or,1,0,0,0,0,0,1,0,1,0.14285714285714285,1,0.0,0,0,0,0,0,0,0,1,0,0,1,1
6705,178733,DFb88DJyixpbyPmZwbM8rx6Jbqu1swUQ,3VkHkmOtom3jM2wCu94xgzzu1d6Dn7or,4,2,1,0,1,0,2,0,6,0.8571428571428571,1,0.0,0,1,0,1,2,0,0,2,0,2,4,1
6706,178752,2SS1m6X4PtlYKEeYaD96IeTATcPtQRmJ,3VkHkmOtom3jM2wCu94xgzzu1d6Dn7or,1,0,0,0,0,0,1,0,1,0.14285714285714285,1,0.0,0,0,0,0,0,0,0,1,0,0,1,1
6707,178777,5Wr4gytl06JTPjH70zxfV5nKBu21xgtb,3VkHkmOtom3jM2wCu94xgzzu1d6Dn7or,29,99,19,30,19,39,14,1,221,31.571428571428573,2,0.0,72,19,25,19,27,39,5,14,1,135,86,1
6708,178789,gqmyrnWST1YHRFuHufOpa1zW5qVaZveS,3VkHkmOtom3jM2wCu94xgzzu1d6Dn7or,1,0,0,0,0,0,1,0,1,0.14285714285714285,1,0.0,0,0,0,0,0,0,0,1,0,0,1,1
6709,178861,Y1ppxEgbx61jNTLCoOABIFXnW04QUYST,3VkHkmOtom3jM2wCu94xgzzu1d6Dn7or,7,4,3,0,3,0,4,0,14,2.0,1,0.0,0,3,0,3,4,0,0,4,0,6,8,1
6710,178871,G9zWjPylIHl2UsOBER9GZ5Kwh5iK59rh,3VkHkmOtom3jM2wCu94xgzzu1d6Dn7or,40,34,23,0,23,1,3,0,84,12.0,1,0.0,2,23,0,23,32,1,0,3,0,48,36,1
6711,178897,MinoPdD8UGZsXLdMkNi0JxgJ1fpYTHgX,3VkHkmOtom3jM2wCu94xgzzu1d6Dn7or,2,0,0,0,0,0,2,0,2,0.2857142857142857,1,0.0,0,0,0,0,0,0,0,2,0,0,2,1
6712,178969,B3pRT25SRFSWSiOB5wDWOCSu3VaxYqAo,3VkHkmOtom3jM2wCu94xgzzu1d6Dn7or,7,8,2,0,3,0,4,0,17,2.4285714285714284,2,0.0,2,2,0,3,6,0,0,4,0,7,10,1
6713,178972,dcYgKBzujpMIqe60unjrhnmHIEGafOxK,3VkHkmOtom3jM2wCu94xgzzu1d6Dn7or,1,0,0,0,0,0,1,0,1,0.14285714285714285,1,0.0,0,0,0,0,0,0,0,1,0,0,1,1
6714,178982,Z73UcSKohCDSYTgmUbDDz1j8bHwE1Twa,3VkHkmOtom3jM2wCu94xgzzu1d6Dn7or,1,0,0,0,0,0,1,0,1,0.14285714285714285,1,0.0,0,0,0,0,0,0,0,1,0,0,1,1
6715,178998,g0SgNwFw2DuaWnZ19sobU7oBg0SxPT5e,3VkHkmOtom3jM2wCu94xgzzu1d6Dn7or,1,0,0,0,0,0,1,0,1,0.14285714285714285,1,0.0,0,0,0,0,0,0,0,1,0,0,1,1
6716,179013,Zl3AWoVuBFcgdahcnPxWebf3SDADcUWC,3VkHkmOtom3jM2wCu94xgzzu1d6Dn7or,9,4,3,0,3,0,2,0,12,1.7142857142857142,1,0.0,0,3,0,3,4,0,0,2,0,6,6,1
6717,179020,KPuBLXcUz8uTnNFSL9u93FtuErrVvFEB,3VkHkmOtom3jM2wCu94xgzzu1d6Dn7or,1,0,0,0,0,0,2,0,2,0.2857142857142857,1,0.0,0,0,0,0,0,0,0,2,0,0,2,1
6718,179027,YNtLVTxLwTR7I2LNaRCT43IyBwbXZEUC,3VkHkmOtom3jM2wCu94xgzzu1d6Dn7or,4,4,1,0,2,0,1,0,8,1.1428571428571428,1,0.0,2,1,0,2,2,0,0,1,0,5,3,1
6719,179054,onzvyrzddloP4Y462nOOhxYjnUaQBd7J,3VkHkmOtom3jM2wCu94xgzzu1d6Dn7or,1,0,0,0,0,0,1,0,1,0.14285714285714285,1,0.0,0,0,0,0,0,0,0,1,0,0,1,1
6720,179058,LBO8Ewmz7y2U43TK4TJihTIxUkT7Ho7i,SpATywNh6bZuzm8s1ceuBUnMUAeoAHHw,15,10,7,0,5,0,2,1,25,3.5714285714285716,1,0.0,2,7,0,5,8,0,0,2,1,14,11,1
6721,179064,ypmSniAoMQdaD8bVBqpv9lhEdTHkgicw,G8EPVSXsOYB5YQWZGiz1aVq5Pgr2GrQu,18,18,9,0,6,0,5,0,38,5.428571428571429,1,0.0,0,9,0,6,18,0,0,5,0,15,23,1
6722,179073,dY4JdXVvpIHPKR4Esa2rpHGx5DEmr1uS,SpATywNh6bZuzm8s1ceuBUnMUAeoAHHw,1,0,0,0,0,0,1,0,1,0.14285714285714285,1,0.0,0,0,0,0,0,0,0,1,0,0,1,1
6723,179118,5OSDqmARPywzyw7TNCUkjUu4ZhXmVumi,SpATywNh6bZuzm8s1ceuBUnMUAeoAHHw,16,11,4,52,0,0,2,0,69,9.857142857142858,1,0.0,6,4,43,0,5,0,9,2,0,53,16,1
6724,179132,w5KgLMMXp0mTj0PVIHIOHr2nxhzUfABT,SpATywNh6bZuzm8s1ceuBUnMUAeoAHHw,22,24,18,8,16,0,1,0,67,9.571428571428571,2,0.0,3,18,7,16,21,0,1,1,0,44,23,1
6725,179183,Gmz5iMjiwcyTx4KusyWM0rOecmUutZaf,5X6FeZozNMgE2VRi3MJYjkkFK8SETtu2,1,0,0,0,0,0,1,0,1,0.14285714285714285,1,0.0,0,0,0,0,0,0,0,1,0,0,1,1
6726,179204,rUqdqKrP6jEVFmWXIFav09cIY8KEIESp,SpATywNh6bZuzm8s1ceuBUnMUAeoAHHw,2,0,0,0,0,0,2,0,2,0.2857142857142857,1,0.0,0,0,0,0,0,0,0,2,0,0,2,1
6727,179209,R23hQIkxpjGDipcAUB8Dm9M15B8oN1UL,SpATywNh6bZuzm8s1ceuBUnMUAeoAHHw,8,5,3,0,2,0,4,0,14,2.0,2,0.0,0,3,0,2,5,0,0,4,0,5,9,1
6728,179211,R23hQIkxpjGDipcAUB8Dm9M15B8oN1UL,bWdj2GDclj5ofokWjzoa5jAwMkxCykd6,6,4,2,0,1,0,3,0,10,1.4285714285714286,2,0.0,0,2,0,1,4,0,0,3,0,3,7,0
6729,179212,R23hQIkxpjGDipcAUB8Dm9M15B8oN1UL,A3fsA9Zfv1X2fVEQhTw51lKENdNrEqT3,6,4,2,0,1,0,4,0,11,1.5714285714285714,3,0.0,0,2,0,1,4,0,0,4,0,3,8,0
6730,179231,hQH8EkY3K9ePEt9jn5ZdKTUudKlRBEnW,5X6FeZozNMgE2VRi3MJYjkkFK8SETtu2,7,9,1,0,1,0,4,0,15,2.142857142857143,1,0.0,0,1,0,1,9,0,0,4,0,2,13,0
6731,179236,phUbJgbIGGa7ctfmqKFL5A4ez8Y8gbBs,G8EPVSXsOYB5YQWZGiz1aVq5Pgr2GrQu,17,28,16,12,12,0,4,0,72,10.285714285714286,1,0.0,8,16,9,12,20,0,3,4,0,45,27,0
6732,179238,4iRTdFrWnotIGLB21xnhMmvH623uk9Hg,G8EPVSXsOYB5YQWZGiz1aVq5Pgr2GrQu,1,0,0,0,0,0,1,0,1,0.14285714285714285,1,0.0,0,0,0,0,0,0,0,1,0,0,1,1
6733,179254,scd3kJGQZMfO9m14NZd9uOrxe7XoIWpn,SpATywNh6bZuzm8s1ceuBUnMUAeoAHHw,8,6,5,5,2,0,4,0,22,3.142857142857143,2,0.0,0,5,4,2,6,0,1,4,0,11,11,0
6734,179297,fXMmjwDSkIUd9lGJ9H4HzqxK2pgc19EB,SpATywNh6bZuzm8s1ceuBUnMUAeoAHHw,5,2,1,0,1,0,2,0,6,0.8571428571428571,1,0.0,0,1,0,1,2,0,0,2,0,2,4,1
6735,179341,UxzzvgJEwkSNbVO46V5QcfFfzC8qCW9S,RXDvfPUBYFlVdlueBFbLW0mhhAyGEqpt,6,7,0,0,0,20,3,0,30,4.285714285714286,1,0.0,0,0,0,0,7,20,0,3,0,0,30,1
6736,179344,qEQGNCv0DTznAP1gMwDRVGTAjB8ymoH3,RXDvfPUBYFlVdlueBFbLW0mhhAyGEqpt,1,0,0,0,0,0,1,0,1,0.14285714285714285,1,0.0,0,0,0,0,0,0,0,1,0,0,1,0
6737,179348,RNNuxsM5xlYyyu9stwQmqEuw1Q1FUKuB,SpATywNh6bZuzm8s1ceuBUnMUAeoAHHw,2,0,0,0,0,0,2,0,2,0.2857142857142857,1,0.0,0,0,0,0,0,0,0,2,0,0,2,1
6738,179442,2B47LMmmv8eUBezceflRv3RF5vIZnhHm,SpATywNh6bZuzm8s1ceuBUnMUAeoAHHw,7,3,2,0,2,0,2,0,9,1.2857142857142858,1,0.0,0,2,0,2,3,0,0,2,0,4,5,1
6739,179463,ijCx69zLzcwindM6K7tyzp56xpGOIFVa,5X6FeZozNMgE2VRi3MJYjkkFK8SETtu2,1,0,0,0,0,0,2,0,2,0.2857142857142857,1,0.0,0,0,0,0,0,0,0,2,0,0,2,1
6740,179471,bFBipIvg3ynAbrvo3mXNRP6i8NWVQRYx,5X6FeZozNMgE2VRi3MJYjkkFK8SETtu2,1,0,0,0,0,0,1,0,1,0.14285714285714285,1,0.0,0,0,0,0,0,0,0,1,0,0,1,1
6741,179543,kjvNUIKnKel06xDJXlSvyzBwMUnrsU4r,SpATywNh6bZuzm8s1ceuBUnMUAeoAHHw,5,3,1,0,1,0,2,0,7,1.0,1,0.0,0,1,0,1,3,0,0,2,0,2,5,0
6742,179544,tWKTzoE9MrJMRUpo6ULAcb4uIpfbisw7,bWdj2GDclj5ofokWjzoa5jAwMkxCykd6,5,5,1,0,2,0,2,0,10,1.4285714285714286,1,0.0,3,1,0,2,2,0,0,2,0,6,4,1
6743,179568,hcWxPPFXJZEtM1yKNtZ1ZD1nYFNlYmMq,A3fsA9Zfv1X2fVEQhTw51lKENdNrEqT3,9,7,5,0,2,0,2,0,16,2.2857142857142856,1,0.0,0,5,0,2,7,0,0,2,0,7,9,1
6744,179573,dytCdr5a5mu9Lr4Kt80AVLD7WwBUELzE,5X6FeZozNMgE2VRi3MJYjkkFK8SETtu2,7,3,2,0,2,0,2,0,9,1.2857142857142858,1,0.0,0,2,0,2,3,0,0,2,0,4,5,1
6745,179590,wzsW7csdv8zU4NLhCRJbm0sFHzlDcvr8,SpATywNh6bZuzm8s1ceuBUnMUAeoAHHw,1,0,0,0,0,0,1,0,1,0.14285714285714285,1,0.0,0,0,0,0,0,0,0,1,0,0,1,1
6746,179593,rin2tkCacWBK9y40n870snOw1zz1mc0B,RXDvfPUBYFlVdlueBFbLW0mhhAyGEqpt,10,15,1,0,2,0,2,0,20,2.857142857142857,1,0.0,2,1,0,2,13,0,0,2,0,5,15,1
6747,179597,ZS9S4XJPiV9wcpaOuoDes9YJua1kN5R2,bWdj2GDclj5ofokWjzoa5jAwMkxCykd6,7,4,1,0,1,0,4,1,11,1.5714285714285714,1,0.0,1,1,0,1,3,0,0,4,1,3,8,1
6748,179604,TGiJnSEfOlHtpx1NmAAE5E7Ka91RcY3D,SpATywNh6bZuzm8s1ceuBUnMUAeoAHHw,1,0,0,0,0,0,1,0,1,0.14285714285714285,1,0.0,0,0,0,0,0,0,0,1,0,0,1,1
6749,179620,KNNMSW3oLxGqEqv2czanNkhQgdUkOWgY,5X6FeZozNMgE2VRi3MJYjkkFK8SETtu2,1,0,0,0,0,0,1,0,1,0.14285714285714285,1,0.0,0,0,0,0,0,0,0,1,0,0,1,1
6750,179630,KNNMSW3oLxGqEqv2czanNkhQgdUkOWgY,G8EPVSXsOYB5YQWZGiz1aVq5Pgr2GrQu,3,4,1,0,0,0,1,0,6,0.8571428571428571,1,0.0,0,1,0,0,4,0,0,1,0,1,5,1
6751,179704,gHRMftxFMfKG8FHWISkllbscPcwviNm3,SpATywNh6bZuzm8s1ceuBUnMUAeoAHHw,2,0,0,0,0,0,4,0,4,0.5714285714285714,1,0.0,0,0,0,0,0,0,0,4,0,0,4,1
6752,179712,gHRMftxFMfKG8FHWISkllbscPcwviNm3,5X6FeZozNMgE2VRi3MJYjkkFK8SETtu2,2,0,0,0,0,0,2,0,2,0.2857142857142857,1,0.0,0,0,0,0,0,0,0,2,0,0,2,1
6753,179789,5IM8g7YMOYo5qH7Yu3x31T3JkVOH9iqe,bWdj2GDclj5ofokWjzoa5jAwMkxCykd6,5,3,1,4,1,0,2,0,11,1.5714285714285714,1,0.0,1,1,3,1,2,0,1,2,0,6,5,1
6754,179809,FrcNdFNfLYMOg5fdBzjs15qKbgtHEYZH,bWdj2GDclj5ofokWjzoa5jAwMkxCykd6,4,3,1,0,0,0,1,0,5,0.7142857142857143,1,0.0,0,1,0,0,3,0,0,1,0,1,4,1
6755,179817,bMSiq9HxrbA3t78b0Doz2ZoPAzWxGeLd,SpATywNh6bZuzm8s1ceuBUnMUAeoAHHw,6,3,2,0,2,0,1,0,8,1.1428571428571428,1,0.0,0,2,0,2,3,0,0,1,0,4,4,1
6756,179833,4k7x6DcNdq1PRhbqFmfcKoI6JpPSJsyb,RXDvfPUBYFlVdlueBFbLW0mhhAyGEqpt,1,0,0,0,0,0,1,0,1,0.14285714285714285,1,0.0,0,0,0,0,0,0,0,1,0,0,1,1
6757,179837,nhm9yHarbp8XLLlD9eddGGK5srTsgarU,G8EPVSXsOYB5YQWZGiz1aVq5Pgr2GrQu,5,2,1,0,1,0,2,0,6,0.8571428571428571,1,0.0,0,1,0,1,2,0,0,2,0,2,4,1
6758,179868,oCWJvRJFiv4PFQbuiqaN5xYpzbjSLgTp,5X6FeZozNMgE2VRi3MJYjkkFK8SETtu2,1,0,0,0,0,0,1,0,1,0.14285714285714285,1,0.0,0,0,0,0,0,0,0,1,0,0,1,1
6759,179873,o3O6sFZEm4uYUPzBaiRjRHoiv6fwyQLX,SpATywNh6bZuzm8s1ceuBUnMUAeoAHHw,1,0,0,0,0,0,1,0,1,0.14285714285714285,1,0.0,0,0,0,0,0,0,0,1,0,0,1,1
6760,179881,duZhJuYE4OhwtoOCCnEJC29StAlCNOa3,SpATywNh6bZuzm8s1ceuBUnMUAeoAHHw,2,0,0,0,0,0,2,0,2,0.2857142857142857,1,0.0,0,0,0,0,0,0,0,2,0,0,2,1
6761,179894,hPO4i6aLLS5ySVSpaJ1gi3UEL1wMdcjH,5X6FeZozNMgE2VRi3MJYjkkFK8SETtu2,1,0,0,0,0,0,1,0,1,0.14285714285714285,1,0.0,0,0,0,0,0,0,0,1,0,0,1,1
6762,179895,hPO4i6aLLS5ySVSpaJ1gi3UEL1wMdcjH,RXDvfPUBYFlVdlueBFbLW0mhhAyGEqpt,1,0,0,0,0,0,1,0,1,0.14285714285714285,1,0.0,0,0,0,0,0,0,0,1,0,0,1,1
6763,179951,DldKY1CwDXbGRaTjHVPFy7M2k54ir3Sa,SpATywNh6bZuzm8s1ceuBUnMUAeoAHHw,8,7,3,0,3,0,6,0,19,2.7142857142857144,1,0.0,0,3,0,3,7,0,0,6,0,6,13,1
6764,179969,nCZrnJjbpsSoXVwiEhCJqTYAOI3F94p9,A3fsA9Zfv1X2fVEQhTw51lKENdNrEqT3,1,1,0,0,0,0,0,0,1,0.14285714285714285,1,0.0,0,0,0,0,1,0,0,0,0,0,1,1
6765,179979,bf8aEyd6FsvtZHaXW2U9ZnLIJNgziVh0,SpATywNh6bZuzm8s1ceuBUnMUAeoAHHw,6,8,0,0,0,0,2,0,10,1.4285714285714286,1,0.0,0,0,0,0,8,0,0,2,0,0,10,1
6766,179980,XD7r9EdkeFNawRwVnSFsvsZq5B2P09f1,SpATywNh6bZuzm8s1ceuBUnMUAeoAHHw,1,0,0,0,0,0,3,0,3,0.42857142857142855,1,0.0,0,0,0,0,0,0,0,3,0,0,3,1
6767,179990,jSMK0akNGSFm4KfOYXgrnzc6M6L4GOjs,bWdj2GDclj5ofokWjzoa5jAwMkxCykd6,7,2,0,0,0,1,6,1,10,1.4285714285714286,1,0.0,0,0,0,0,2,1,0,6,1,0,10,1
6768,180007,d61Mq2WOkbOPuslLwPbE2HIvs5VJCHXC,A3fsA9Zfv1X2fVEQhTw51lKENdNrEqT3,1,0,0,0,0,0,1,0,1,0.14285714285714285,1,0.0,0,0,0,0,0,0,0,1,0,0,1,1
6769,180020,9fZ9ajTU1tyQz56pupAA6Mj4GXhRGs70,RXDvfPUBYFlVdlueBFbLW0mhhAyGEqpt,1,0,0,0,0,0,1,0,1,0.14285714285714285,1,0.0,0,0,0,0,0,0,0,1,0,0,1,1
6770,180037,QHMb7P7jQNCBcOLFOpsx5OnkXdlEixMX,SpATywNh6bZuzm8s1ceuBUnMUAeoAHHw,6,4,2,0,1,0,4,0,11,1.5714285714285714,2,0.0,0,2,0,1,4,0,0,4,0,3,8,1
6771,180046,oj4B9Eiq2DhD93IZ9QqW6z1NcyEBJDg5,RXDvfPUBYFlVdlueBFbLW0mhhAyGEqpt,6,5,3,0,2,1,3,0,14,2.0,1,0.0,0,3,0,2,5,1,0,3,0,5,9,1
6772,180062,1v1hnAW2fjxDgMlfMAcBqTKOh6UMFrVl,5X6FeZozNMgE2VRi3MJYjkkFK8SETtu2,1,0,0,0,0,0,1,0,1,0.14285714285714285,1,0.0,0,0,0,0,0,0,0,1,0,0,1,1
6773,180063,7iiJKJH1gn2zCei1ljdqO2u1S02IW6Ni,5X6FeZozNMgE2VRi3MJYjkkFK8SETtu2,2,0,0,0,0,0,2,0,2,0.2857142857142857,1,0.0,0,0,0,0,0,0,0,2,0,0,2,1
6774,180204,Ie7mkAUCVVaLYxvosre748ADQJqirOJg,5X6FeZozNMgE2VRi3MJYjkkFK8SETtu2,7,4,1,0,1,0,2,0,8,1.1428571428571428,1,0.0,0,1,0,1,4,0,0,2,0,2,6,1
6775,180249,skO1w4xAP0rDa1qcY4cgOn68z6G9pTRm,5X6FeZozNMgE2VRi3MJYjkkFK8SETtu2,2,0,0,0,0,0,3,0,3,0.42857142857142855,1,0.0,0,0,0,0,0,0,0,3,0,0,3,1
6776,180261,AyhJARh0xhxObM9zhvUdDxlTCtu309eW,5X6FeZozNMgE2VRi3MJYjkkFK8SETtu2,4,2,1,0,1,0,1,0,5,0.7142857142857143,1,0.0,0,1,0,1,2,0,0,1,0,2,3,1
6777,180319,ocTIjxG8zBs0mQRpUtpuAKc7MDpzU7Sd,5X6FeZozNMgE2VRi3MJYjkkFK8SETtu2,5,4,2,0,1,0,1,0,8,1.1428571428571428,1,0.0,1,2,0,1,3,0,0,1,0,4,4,1
6778,180333,VdbwmsrhEaf1Ntx0Uu4hETHXAIfCfgPp,5Gyp41oLVo7Gg7vF4vpmggWP5MU70QO6,2,0,0,0,0,0,2,0,2,0.2857142857142857,1,0.0,0,0,0,0,0,0,0,2,0,0,2,1
6779,180346,Dzw21RObfNeqcKRhrcWOWYYLAAShj0W4,5Gyp41oLVo7Gg7vF4vpmggWP5MU70QO6,1,0,0,0,0,0,1,0,1,0.14285714285714285,1,0.0,0,0,0,0,0,0,0,1,0,0,1,1
6780,180360,se9ZVl8DNkiCW8i2nP0p3krrUcQqYC47,5Gyp41oLVo7Gg7vF4vpmggWP5MU70QO6,5,3,2,0,0,0,2,0,7,1.0,2,0.0,0,2,0,0,3,0,0,2,0,2,5,1
6781,180365,9QuW9ZLhtCdoIktgbqTL0ZL84tEvEWfk,5Gyp41oLVo7Gg7vF4vpmggWP5MU70QO6,5,2,2,0,2,0,2,0,8,1.1428571428571428,2,0.0,0,2,0,2,2,0,0,2,0,4,4,1
6782,180369,XXSXfhCw9mGganakCzSbMGrDeFQxXvty,5Gyp41oLVo7Gg7vF4vpmggWP5MU70QO6,4,4,2,0,0,1,1,0,8,1.1428571428571428,1,0.0,0,2,0,0,4,1,0,1,0,2,6,1
6783,180385,6kVQKwQyT547HfghY5j8ZYVsAOaPndJb,5Gyp41oLVo7Gg7vF4vpmggWP5MU70QO6,5,2,0,0,0,0,4,0,6,0.8571428571428571,1,0.0,0,0,0,0,2,0,0,4,0,0,6,1
6784,180404,zc3yobCT7g704IntVUdzizx4jyscourR,5Gyp41oLVo7Gg7vF4vpmggWP5MU70QO6,8,8,6,0,5,12,2,0,33,4.714285714285714,1,0.0,1,6,0,5,7,12,0,2,0,12,21,1
6785,180408,YTqFGKydGa9t3OpX1V9OLIPq0MJ9XJx3,5Gyp41oLVo7Gg7vF4vpmggWP5MU70QO6,11,10,6,3,3,0,2,0,24,3.4285714285714284,1,0.0,1,6,2,3,9,0,1,2,0,12,12,1
6786,180409,vpMPPz3PltCcHRnbpX25nnc9Umi2LOSS,5Gyp41oLVo7Gg7vF4vpmggWP5MU70QO6,15,13,7,6,4,9,4,6,49,7.0,1,0.0,3,7,4,4,10,9,2,4,6,18,31,1
6787,180422,6dc6EewVUNfgITT5R0ncyzJuV0RcJz2q,5Gyp41oLVo7Gg7vF4vpmggWP5MU70QO6,11,8,4,9,1,0,2,0,24,3.4285714285714284,1,0.0,3,4,6,1,5,0,3,2,0,14,10,1
6788,180428,hdCB9NYvijkht4G4yPpTVpMi2HQucz4x,5Gyp41oLVo7Gg7vF4vpmggWP5MU70QO6,5,2,1,0,1,0,2,0,6,0.8571428571428571,1,0.0,0,1,0,1,2,0,0,2,0,2,4,1
6789,180449,pm4QAvD55kGSf5JZpnTAByS2n0xgOUT4,5Gyp41oLVo7Gg7vF4vpmggWP5MU70QO6,12,8,5,0,4,1,4,0,22,3.142857142857143,2,0.0,1,5,0,4,7,1,0,4,0,10,12,1
6790,180457,dFabA08S2MisFGsUf420mmCXMOVQ9987,5Gyp41oLVo7Gg7vF4vpmggWP5MU70QO6,1,0,0,0,0,0,2,0,2,0.2857142857142857,1,0.0,0,0,0,0,0,0,0,2,0,0,2,1
6791,180465,v0j16a4LE6aPOzv0omm2uC56r3JNzrm2,5Gyp41oLVo7Gg7vF4vpmggWP5MU70QO6,7,3,1,0,2,0,2,0,8,1.1428571428571428,1,0.0,0,1,0,2,3,0,0,2,0,3,5,1
6792,180466,p04QzukP32kpPk8EGoBhDUGJJQqJUoNz,5Gyp41oLVo7Gg7vF4vpmggWP5MU70QO6,1,0,0,0,0,0,1,0,1,0.14285714285714285,1,0.0,0,0,0,0,0,0,0,1,0,0,1,1
6793,180470,kCpIxmgqcIr7LDiV8CMd5u1iUng7rZ5o,5Gyp41oLVo7Gg7vF4vpmggWP5MU70QO6,7,2,1,0,1,0,5,0,9,1.2857142857142858,1,0.0,0,1,0,1,2,0,0,5,0,2,7,1
6794,180471,vRDqP5xcXUHdZPGQ9k1Y2zmDGUpZ7MaA,5Gyp41oLVo7Gg7vF4vpmggWP5MU70QO6,3,3,0,0,0,0,1,0,4,0.5714285714285714,1,0.0,0,0,0,0,3,0,0,1,0,0,4,1
6795,180480,oISxv33lwptGFBahWRvD6klRjmHxu37p,5Gyp41oLVo7Gg7vF4vpmggWP5MU70QO6,6,1,1,0,0,1,7,1,11,1.5714285714285714,1,0.0,0,1,0,0,1,1,0,7,1,1,10,1
6796,180491,MdyAi5wz0BPn55uzdxK3YSomKT9HZ1dV,5Gyp41oLVo7Gg7vF4vpmggWP5MU70QO6,7,3,2,0,2,0,3,1,11,1.5714285714285714,1,0.0,0,2,0,2,3,0,0,3,1,4,7,1
6797,180501,2hb1nLylJ3pK33F1eNFi4G1Jg39Nh6nj,5Gyp41oLVo7Gg7vF4vpmggWP5MU70QO6,4,2,1,0,1,0,1,0,5,0.7142857142857143,1,0.0,0,1,0,1,2,0,0,1,0,2,3,1
6798,180525,Caf5ukME6sc80BSrYSlVzcSKAp8RAaQ2,5Gyp41oLVo7Gg7vF4vpmggWP5MU70QO6,3,0,0,0,0,0,4,0,4,0.5714285714285714,1,0.0,0,0,0,0,0,0,0,4,0,0,4,1
6799,180545,2fJnw6CwlD9kPbDbGOr5T9g4ChtEFbIV,5Gyp41oLVo7Gg7vF4vpmggWP5MU70QO6,10,5,3,6,2,0,2,0,18,2.5714285714285716,1,0.0,1,3,4,2,4,0,2,2,0,10,8,1
6800,180549,nNkPxgK73MqMApsYtxu6v9AnfWusfhDn,5Gyp41oLVo7Gg7vF4vpmggWP5MU70QO6,7,5,2,0,2,0,2,0,11,1.5714285714285714,1,0.0,0,2,0,2,5,0,0,2,0,4,7,1
6801,180573,AXjXLUPDRZg18lUnclQU86YQs1DGA11X,5Gyp41oLVo7Gg7vF4vpmggWP5MU70QO6,12,15,7,9,4,10,4,1,50,7.142857142857143,1,0.0,6,7,6,4,9,10,3,4,1,23,27,1
6802,180581,p8OxzMqwupG8Wxjqf7hR8Y85upVCYHhC,5Gyp41oLVo7Gg7vF4vpmggWP5MU70QO6,4,2,1,0,1,0,1,0,5,0.7142857142857143,1,0.0,0,1,0,1,2,0,0,1,0,2,3,1
6803,180615,qLscbApWydA7z1h7Ht7RN2UnF0mvGZpF,5Gyp41oLVo7Gg7vF4vpmggWP5MU70QO6,4,2,1,0,1,0,1,0,5,0.7142857142857143,1,0.0,0,1,0,1,2,0,0,1,0,2,3,1
6804,180616,EIaoEsmMCElUVPCCMKJTeZSwe5Tpb9nu,5Gyp41oLVo7Gg7vF4vpmggWP5MU70QO6,11,10,6,14,2,0,4,0,36,5.142857142857143,2,0.0,1,6,11,2,9,0,3,4,0,20,16,1
6805,180621,G4gv3psLUg6DraQbf90HcUcwjZl74koo,5Gyp41oLVo7Gg7vF4vpmggWP5MU70QO6,7,3,2,0,1,0,4,0,10,1.4285714285714286,1,0.0,0,2,0,1,3,0,0,4,0,3,7,1
6806,180623,O3hYI537zr7fPNSahntbmZkF0gMAGE4h,5Gyp41oLVo7Gg7vF4vpmggWP5MU70QO6,1,0,0,0,0,0,1,0,1,0.14285714285714285,1,0.0,0,0,0,0,0,0,0,1,0,0,1,1
6807,180625,bsalGAvHbAyi2zQkMdMuno7PqVBrE5qV,5Gyp41oLVo7Gg7vF4vpmggWP5MU70QO6,5,2,1,0,1,0,2,0,6,0.8571428571428571,1,0.0,0,1,0,1,2,0,0,2,0,2,4,1
6808,180627,2ZUUEzlqPIZRVja8Yw3ZMtVqM8WoUnTW,5Gyp41oLVo7Gg7vF4vpmggWP5MU70QO6,15,18,8,13,3,5,6,3,56,8.0,1,0.0,9,8,9,3,9,5,4,6,3,29,27,1
6809,180638,QFH4wolhcweAHadUiy5aIW0unRYxm1jI,5Gyp41oLVo7Gg7vF4vpmggWP5MU70QO6,4,2,1,0,0,0,2,0,5,0.7142857142857143,1,0.0,0,1,0,0,2,0,0,2,0,1,4,1
6810,180639,hqSRPxpI43WtMHTwEnMUolUcTbcIJWPD,5Gyp41oLVo7Gg7vF4vpmggWP5MU70QO6,13,15,7,16,0,0,4,0,42,6.0,1,0.0,5,7,11,0,10,0,5,4,0,23,19,1
6811,180666,OV8ydTO9DA2HDljMOebORxkzQvud47yg,5Gyp41oLVo7Gg7vF4vpmggWP5MU70QO6,7,3,2,0,1,3,4,0,13,1.8571428571428572,1,0.0,0,2,0,1,3,3,0,4,0,3,10,1
6812,180685,ZCzGn7UyXXjv72SOnujYeGTtd5gijp5N,5Gyp41oLVo7Gg7vF4vpmggWP5MU70QO6,9,7,2,9,1,3,3,1,26,3.7142857142857144,1,0.0,5,2,6,1,2,3,3,3,1,14,12,1
6813,180698,cmBGPhEo7zyHufHh12hBiHKxlPiadEZH,5Gyp41oLVo7Gg7vF4vpmggWP5MU70QO6,7,4,0,0,1,0,4,1,10,1.4285714285714286,1,0.0,0,0,0,1,4,0,0,4,1,1,9,0
6814,180716,WEqUhplW7x1SpLabVjNcI5M4HsCYjumg,5Gyp41oLVo7Gg7vF4vpmggWP5MU70QO6,4,5,2,0,0,0,1,0,8,1.1428571428571428,1,0.0,0,2,0,0,5,0,0,1,0,2,6,1
6815,180719,IcZ6i6v1x93Zo65F5bywQyN2mFUqZ0pV,5Gyp41oLVo7Gg7vF4vpmggWP5MU70QO6,2,0,0,0,0,6,1,0,7,1.0,1,0.0,0,0,0,0,0,6,0,1,0,0,7,1
6816,180723,XpCDhn34CsjM8KU9xQLESEPM4fYlChby,5Gyp41oLVo7Gg7vF4vpmggWP5MU70QO6,8,4,2,0,1,1,4,0,12,1.7142857142857142,1,0.0,0,2,0,1,4,1,0,4,0,3,9,1
6817,180741,iJ82QfZ5cjEE893M5bH0BgxBT4c25nXE,5Gyp41oLVo7Gg7vF4vpmggWP5MU70QO6,1,0,0,0,0,0,2,0,2,0.2857142857142857,2,0.0,0,0,0,0,0,0,0,2,0,0,2,1
6818,180744,TOybu3VTl57Gwz61jxLAAYZF2xYkGB5M,5Gyp41oLVo7Gg7vF4vpmggWP5MU70QO6,14,16,10,0,9,3,8,3,49,7.0,1,0.0,3,10,0,9,13,3,0,8,3,22,27,1
6819,180754,lDJqver3AFFUyXISNdqvZpmq6OeWVl0r,5Gyp41oLVo7Gg7vF4vpmggWP5MU70QO6,1,0,0,0,0,0,2,0,2,0.2857142857142857,1,0.0,0,0,0,0,0,0,0,2,0,0,2,1
6820,180759,YZvjSAhv73aSPxCkFsL6a9U6nSCuWb5C,5Gyp41oLVo7Gg7vF4vpmggWP5MU70QO6,5,2,1,0,1,0,2,0,6,0.8571428571428571,1,0.0,0,1,0,1,2,0,0,2,0,2,4,1
6821,180784,AsAtWFxD8bumrqIWR5awNAWKQt2RUSUJ,5Gyp41oLVo7Gg7vF4vpmggWP5MU70QO6,4,2,1,0,1,0,1,0,5,0.7142857142857143,1,0.0,0,1,0,1,2,0,0,1,0,2,3,1
6822,180789,Nt4mZsjfM4IZ7anEZxuZk7e6qxizotdE,5Gyp41oLVo7Gg7vF4vpmggWP5MU70QO6,21,34,27,14,7,1,2,0,85,12.142857142857142,2,0.0,2,27,9,7,32,1,5,2,0,45,40,1
6823,180821,ELsX3So3MEP4M02HSkl7LgWbVXNEckun,5Gyp41oLVo7Gg7vF4vpmggWP5MU70QO6,7,3,1,0,2,4,2,0,12,1.7142857142857142,1,0.0,0,1,0,2,3,4,0,2,0,3,9,1
6824,180824,t6VI3IanHtDke9IUrIN6nN2LpiVCDOFR,5Gyp41oLVo7Gg7vF4vpmggWP5MU70QO6,4,5,3,0,0,0,1,0,9,1.2857142857142858,1,0.0,0,3,0,0,5,0,0,1,0,3,6,1
6825,180843,0rbXUlrgFDVR0QpsFzdCtuKCZmFaVq4v,5Gyp41oLVo7Gg7vF4vpmggWP5MU70QO6,1,0,0,0,0,0,1,0,1,0.14285714285714285,1,0.0,0,0,0,0,0,0,0,1,0,0,1,1
6826,180854,5xDTEdGInGFTZn3PwlXNraXRYICzcVem,5Gyp41oLVo7Gg7vF4vpmggWP5MU70QO6,7,4,3,0,2,0,1,0,10,1.4285714285714286,1,0.0,0,3,0,2,4,0,0,1,0,5,5,1
6827,180864,NrFu06k2xTVsBcsU6J8BlqDNgeYTHuT3,5Gyp41oLVo7Gg7vF4vpmggWP5MU70QO6,5,1,1,0,1,0,3,0,6,0.8571428571428571,1,0.0,0,1,0,1,1,0,0,3,0,2,4,1
6828,180871,CNnvEGwKATmmBRimIHsh9gqRuWKpHbRS,5Gyp41oLVo7Gg7vF4vpmggWP5MU70QO6,6,3,1,0,1,0,3,0,8,1.1428571428571428,1,0.0,0,1,0,1,3,0,0,3,0,2,6,1
6829,180875,O1JCj9IRlzuPnXGSMFH3o6nPheXmI0dk,5Gyp41oLVo7Gg7vF4vpmggWP5MU70QO6,8,7,4,0,2,0,2,0,15,2.142857142857143,2,0.0,1,4,0,2,6,0,0,2,0,7,8,1
6830,180893,IZuOLlG7HUowwCKYPaGqcIFnzKRG5W4h,5Gyp41oLVo7Gg7vF4vpmggWP5MU70QO6,17,15,10,0,7,0,4,0,36,5.142857142857143,2,0.0,2,10,0,7,13,0,0,4,0,19,17,1
6831,180897,X2rYZmjNSta2MgyewfHiGDRqM0GJtlTs,5Gyp41oLVo7Gg7vF4vpmggWP5MU70QO6,14,10,5,21,3,0,2,0,41,5.857142857142857,1,0.0,4,5,13,3,6,0,8,2,0,25,16,1
6832,180916,r0hi0ZJd8UuUZLbhRuT99HexLH6eSRnQ,5Gyp41oLVo7Gg7vF4vpmggWP5MU70QO6,1,0,0,0,0,0,1,0,1,0.14285714285714285,1,0.0,0,0,0,0,0,0,0,1,0,0,1,1
6833,180920,fNnHBhGnywsG6LHW9M0Nx0qEbrvDjBO7,5Gyp41oLVo7Gg7vF4vpmggWP5MU70QO6,1,0,0,0,0,0,1,0,1,0.14285714285714285,1,0.0,0,0,0,0,0,0,0,1,0,0,1,1
6834,180925,NoYPpFxcK6tcx8jsBNJXYeJWPofFfMTW,5Gyp41oLVo7Gg7vF4vpmggWP5MU70QO6,4,3,1,0,0,0,2,0,6,0.8571428571428571,1,0.0,0,1,0,0,3,0,0,2,0,1,5,1
6835,180968,nVmPrup4WIX4cDkqM2yvhc3E0JOk5euN,5Gyp41oLVo7Gg7vF4vpmggWP5MU70QO6,14,26,8,8,8,47,10,14,121,17.285714285714285,2,0.0,11,8,6,8,15,47,2,10,14,33,88,1
6836,180974,BkjpawhkYLwXRm8TkP8sUAuZJZtPDlsW,5Gyp41oLVo7Gg7vF4vpmggWP5MU70QO6,7,3,2,0,2,0,3,0,10,1.4285714285714286,1,0.0,0,2,0,2,3,0,0,3,0,4,6,1
6837,180995,5ZSp0tU9aRE4uiUWHP8Ae2WfrW4oZyzA,5Gyp41oLVo7Gg7vF4vpmggWP5MU70QO6,6,4,2,0,1,0,2,0,9,1.2857142857142858,1,0.0,1,2,0,1,3,0,0,2,0,4,5,1
6838,181013,oVXEwzWOnz5Sf1Z310ZehdO5ZKy4uuD6,5Gyp41oLVo7Gg7vF4vpmggWP5MU70QO6,12,26,15,0,3,0,7,0,51,7.285714285714286,2,0.0,1,15,0,3,25,0,0,7,0,19,32,1
6839,181056,jaMIs7YXs87q8CsWLCKUUMpBiCYuq5u4,5Gyp41oLVo7Gg7vF4vpmggWP5MU70QO6,7,3,2,0,2,0,4,0,11,1.5714285714285714,1,0.0,0,2,0,2,3,0,0,4,0,4,7,1
6840,181066,2ZB75XaxDHECeG9sXD5ayYvXNr27JTjj,5Gyp41oLVo7Gg7vF4vpmggWP5MU70QO6,1,0,0,0,0,0,1,0,1,0.14285714285714285,1,0.0,0,0,0,0,0,0,0,1,0,0,1,1
6841,181110,5khGTvLU6yjmXaeHpWJGWa1iZGzL5YGz,5Gyp41oLVo7Gg7vF4vpmggWP5MU70QO6,19,34,24,0,10,0,4,0,72,10.285714285714286,1,0.0,2,24,0,10,32,0,0,4,0,36,36,1
6842,181111,J9Wf06bYC2mfaRnTcRT9MBC53a9bvAMe,5Gyp41oLVo7Gg7vF4vpmggWP5MU70QO6,12,14,10,0,3,0,4,0,31,4.428571428571429,1,0.0,2,10,0,3,12,0,0,4,0,15,16,1
6843,181125,nj0GeuvjREGyDQcup3h5G1wINhoiYYrm,5Gyp41oLVo7Gg7vF4vpmggWP5MU70QO6,9,3,2,0,2,2,5,0,14,2.0,1,0.0,0,2,0,2,3,2,0,5,0,4,10,1
6844,181130,uurBymt1lyDtglBoVIFUaumdRGJ7o8GH,5Gyp41oLVo7Gg7vF4vpmggWP5MU70QO6,7,2,1,0,1,5,7,2,18,2.5714285714285716,1,0.0,0,1,0,1,2,5,0,7,2,2,16,1
6845,181141,piQRkV9tfktADXclBB7xQYTpIWhw5NQu,5Gyp41oLVo7Gg7vF4vpmggWP5MU70QO6,10,11,8,0,2,0,2,0,23,3.2857142857142856,2,0.0,0,8,0,2,11,0,0,2,0,10,13,1
6846,181157,Q4IvbcNWdBPmlOeKoLaoLQatAn7Hl55o,5Gyp41oLVo7Gg7vF4vpmggWP5MU70QO6,12,7,6,0,2,0,3,0,18,2.5714285714285716,1,0.0,0,6,0,2,7,0,0,3,0,8,10,1
6847,181185,kvFxm6h3ndggPRl7hrJAQaZ5vmCMmjlt,5Gyp41oLVo7Gg7vF4vpmggWP5MU70QO6,5,2,0,0,1,0,2,1,6,0.8571428571428571,1,0.0,0,0,0,1,2,0,0,2,1,1,5,1
6848,181195,1zErz13s8fNQRVaEvkOtvw6bLhr23yB4,5Gyp41oLVo7Gg7vF4vpmggWP5MU70QO6,10,12,10,7,1,0,2,0,32,4.571428571428571,1,0.0,1,10,5,1,11,0,2,2,0,17,15,1
6849,181226,uT6DjukxZLvo9BEaU3ExjxzUc2OZ2h85,5Gyp41oLVo7Gg7vF4vpmggWP5MU70QO6,9,8,4,10,2,0,3,0,27,3.857142857142857,1,0.0,3,4,7,2,5,0,3,3,0,16,11,1
6850,181234,ppwn795jM3X8HLmfBGWlJ1RCSK9HLpNe,5Gyp41oLVo7Gg7vF4vpmggWP5MU70QO6,8,4,3,0,2,0,3,0,12,1.7142857142857142,1,0.0,0,3,0,2,4,0,0,3,0,5,7,1
6851,181239,YSDr4kp8xy1IJOjF6U6TmfojxhpzvfoE,5Gyp41oLVo7Gg7vF4vpmggWP5MU70QO6,8,3,2,0,2,1,5,2,15,2.142857142857143,1,0.0,0,2,0,2,3,1,0,5,2,4,11,1
6852,181258,bDOMCQV7nFdKo0pDqOPr3ECLpgkdBCSt,5Gyp41oLVo7Gg7vF4vpmggWP5MU70QO6,18,13,8,1,7,1,9,1,40,5.714285714285714,2,0.0,3,8,1,7,10,1,0,9,1,19,21,1
6853,181288,mDjnFW2H7nFisiWlxOrJTsR30uwjlL59,5Gyp41oLVo7Gg7vF4vpmggWP5MU70QO6,15,9,8,0,4,0,3,0,24,3.4285714285714284,1,0.0,0,8,0,4,9,0,0,3,0,12,12,1
6854,181300,u5ObOMoHUcvVsOQTGkiv0BRKKcn8v2w8,5Gyp41oLVo7Gg7vF4vpmggWP5MU70QO6,7,3,2,0,2,0,2,0,9,1.2857142857142858,1,0.0,0,2,0,2,3,0,0,2,0,4,5,1
6855,181416,6eFLenmSuEaK2yDqVHC9OonKyhwGkbDc,5Gyp41oLVo7Gg7vF4vpmggWP5MU70QO6,2,0,0,0,0,0,2,0,2,0.2857142857142857,1,0.0,0,0,0,0,0,0,0,2,0,0,2,1
6856,181433,ZgSCBb788XyHHe00tk3N5n3DNv5SRct9,5Gyp41oLVo7Gg7vF4vpmggWP5MU70QO6,6,6,0,0,0,0,2,0,8,1.1428571428571428,1,0.0,0,0,0,0,6,0,0,2,0,0,8,1
6857,181435,DQwc8pejbnheXq1m3QxoKvet1LFQ88Od,5Gyp41oLVo7Gg7vF4vpmggWP5MU70QO6,10,8,5,0,3,0,4,0,20,2.857142857142857,1,0.0,0,5,0,3,8,0,0,4,0,8,12,1
6858,181438,5LW4mjF9q34UvMTZjLS5Sqba8UzHsR4B,5Gyp41oLVo7Gg7vF4vpmggWP5MU70QO6,6,3,1,0,1,0,2,0,7,1.0,1,0.0,0,1,0,1,3,0,0,2,0,2,5,1
6859,181447,CHhRHW1xvsEWXIP2d0gkl8piD067lkvn,5Gyp41oLVo7Gg7vF4vpmggWP5MU70QO6,4,2,1,0,1,0,1,0,5,0.7142857142857143,1,0.0,0,1,0,1,2,0,0,1,0,2,3,1
6860,181466,1uHovACZmOb4Xg0f8FhkliZEuRitP24W,5Gyp41oLVo7Gg7vF4vpmggWP5MU70QO6,10,7,6,0,3,0,1,0,17,2.4285714285714284,1,0.0,0,6,0,3,7,0,0,1,0,9,8,1
6861,181467,aV4MH8Zz9KrPRpKW0wkxeTpdmDua621E,5Gyp41oLVo7Gg7vF4vpmggWP5MU70QO6,1,0,0,0,0,0,1,0,1,0.14285714285714285,1,0.0,0,0,0,0,0,0,0,1,0,0,1,1
6862,181569,HFlkUxGHWB77t9TiRXSaNCP8d3isxGAz,5Gyp41oLVo7Gg7vF4vpmggWP5MU70QO6,13,7,6,0,2,0,5,2,22,3.142857142857143,1,0.0,0,6,0,2,7,0,0,5,2,8,14,1
6863,181580,9DPHcUOWUV8IQnJfLjMYUBV9Ko2uH3w5,5Gyp41oLVo7Gg7vF4vpmggWP5MU70QO6,6,3,2,0,2,0,3,0,10,1.4285714285714286,1,0.0,0,2,0,2,3,0,0,3,0,4,6,1
6864,181584,iKVtXLZY6XC1Ozhvwt3XfCzLYHoRf4Le,5Gyp41oLVo7Gg7vF4vpmggWP5MU70QO6,6,1,1,0,1,0,3,0,6,0.8571428571428571,1,0.0,0,1,0,1,1,0,0,3,0,2,4,0
6865,181586,6qpmxN3N2yoZzMmasQOl4q0O494Ovdgi,5Gyp41oLVo7Gg7vF4vpmggWP5MU70QO6,1,0,0,0,0,0,1,0,1,0.14285714285714285,1,0.0,0,0,0,0,0,0,0,1,0,0,1,1
6866,181593,fwOgm19i9S3by4kH60ptT6BbQyrVR3WL,5Gyp41oLVo7Gg7vF4vpmggWP5MU70QO6,9,13,7,0,1,0,4,1,26,3.7142857142857144,1,0.0,0,7,0,1,13,0,0,4,1,8,18,1
6867,181612,mzwsSG8Ktfv1WZqjqew1AgaQEM1GX6IP,5Gyp41oLVo7Gg7vF4vpmggWP5MU70QO6,20,39,15,0,10,28,16,1,109,15.571428571428571,1,0.0,8,15,0,10,31,28,0,16,1,33,76,1
6868,181631,Nw5m8lebM1Lxi9RkpjTadGBacKl5bV7H,5Gyp41oLVo7Gg7vF4vpmggWP5MU70QO6,1,0,0,0,0,0,2,0,2,0.2857142857142857,1,0.0,0,0,0,0,0,0,0,2,0,0,2,1
6869,181647,LD6dgwMbAWHuMQHG0naXfcUBkMX3mcrC,5Gyp41oLVo7Gg7vF4vpmggWP5MU70QO6,8,6,4,16,0,0,3,0,29,4.142857142857143,1,0.0,1,4,8,0,5,0,8,3,0,13,16,1
6870,181666,cXxLX3weIMxSwYSoT8P8ZKKNMlGVjCNy,5Gyp41oLVo7Gg7vF4vpmggWP5MU70QO6,1,0,0,0,0,0,1,0,1,0.14285714285714285,1,0.0,0,0,0,0,0,0,0,1,0,0,1,1
6871,181705,O4qtZeWI5SwQrozkAvEbFYqe7vdk37bO,5Gyp41oLVo7Gg7vF4vpmggWP5MU70QO6,9,6,4,0,2,0,3,0,15,2.142857142857143,1,0.0,0,4,0,2,6,0,0,3,0,6,9,1
6872,181706,KPAskVsVbArHW91A7Qm73UM5PoCX0SEG,5Gyp41oLVo7Gg7vF4vpmggWP5MU70QO6,12,8,3,2,3,1,5,0,22,3.142857142857143,1,0.0,4,3,1,3,4,1,1,5,0,11,11,1
6873,181711,rlOA9rzwAqUsSQUxvWoyo9NkAlJS9jq0,5Gyp41oLVo7Gg7vF4vpmggWP5MU70QO6,7,3,1,0,1,1,4,0,10,1.4285714285714286,1,0.0,0,1,0,1,3,1,0,4,0,2,8,1
6874,181725,GyWTABuPpZEqO585EnNTIpM2B2faPYN3,5Gyp41oLVo7Gg7vF4vpmggWP5MU70QO6,4,3,2,0,2,0,1,0,8,1.1428571428571428,1,0.0,0,2,0,2,3,0,0,1,0,4,4,1
6875,181726,nZgoOk2D7MZGiXntucp8f1hhA6rT4Hgo,5Gyp41oLVo7Gg7vF4vpmggWP5MU70QO6,15,20,6,7,5,3,5,1,47,6.714285714285714,1,0.0,11,6,5,5,9,3,2,5,1,27,20,1
6876,181739,EonY9rxOz92zkguacFYNy9LDZUxPvKP6,5Gyp41oLVo7Gg7vF4vpmggWP5MU70QO6,9,6,4,3,2,0,2,0,17,2.4285714285714284,1,0.0,1,4,2,2,5,0,1,2,0,9,8,1
6877,181748,5BUswz1byqYFdKib2By2QrOXer7Jj6do,5Gyp41oLVo7Gg7vF4vpmggWP5MU70QO6,4,2,1,0,0,0,4,0,7,1.0,1,0.0,0,1,0,0,2,0,0,4,0,1,6,1
6878,181750,KGXFn1n0h5LwrdyZxyMenRRVTJ2x6Rjd,5Gyp41oLVo7Gg7vF4vpmggWP5MU70QO6,4,2,0,0,1,0,1,0,4,0.5714285714285714,1,0.0,0,0,0,1,2,0,0,1,0,1,3,1
6879,181762,NGkgB52eZIjL1l9fMcFvWPBwWPAe9rvH,5Gyp41oLVo7Gg7vF4vpmggWP5MU70QO6,7,6,4,0,1,0,2,0,13,1.8571428571428572,1,0.0,0,4,0,1,6,0,0,2,0,5,8,1
6880,181818,8uqydEYLMBuGG3VmuAAb8Fc8GUVVDVBb,5Gyp41oLVo7Gg7vF4vpmggWP5MU70QO6,7,3,2,0,2,0,2,0,9,1.2857142857142858,1,0.0,0,2,0,2,3,0,0,2,0,4,5,1
6881,181822,Ju2SQJE2BqRVGeDZMui7MZtceq6FlFez,5Gyp41oLVo7Gg7vF4vpmggWP5MU70QO6,6,1,1,0,1,0,3,0,6,0.8571428571428571,1,0.0,0,1,0,1,1,0,0,3,0,2,4,1
6882,181823,aDHCSq5YufHdEsMSuYYdrG98PaZ1BG7V,5Gyp41oLVo7Gg7vF4vpmggWP5MU70QO6,1,0,0,0,0,0,2,0,2,0.2857142857142857,1,0.0,0,0,0,0,0,0,0,2,0,0,2,1
6883,181832,F2CZ6Iyzsz2icKGcipaMSpZVmnUO4oC3,5Gyp41oLVo7Gg7vF4vpmggWP5MU70QO6,12,16,4,0,1,0,8,1,30,4.285714285714286,1,0.0,5,4,0,1,11,0,0,8,1,10,20,1
6884,181862,26Ci83ax9ggNzZ5zmbdpF3sLapFM1xLv,5Gyp41oLVo7Gg7vF4vpmggWP5MU70QO6,1,0,0,0,0,0,1,0,1,0.14285714285714285,1,0.0,0,0,0,0,0,0,0,1,0,0,1,1
6885,181868,CU3P6lJfWMkPlregl6AgalycBN1UXKCI,5Gyp41oLVo7Gg7vF4vpmggWP5MU70QO6,8,5,2,0,2,1,4,1,15,2.142857142857143,1,0.0,0,2,0,2,5,1,0,4,1,4,11,1
6886,181870,a1HLwBKYYR0WpSeS8QuvfBbxDgqGIB2F,5Gyp41oLVo7Gg7vF4vpmggWP5MU70QO6,1,0,0,0,0,0,2,0,2,0.2857142857142857,1,0.0,0,0,0,0,0,0,0,2,0,0,2,1
6887,181872,4Er7jyS82PpyIJ1GVZiHCRbQI0ysQvgx,5Gyp41oLVo7Gg7vF4vpmggWP5MU70QO6,14,17,8,6,2,19,11,2,65,9.285714285714286,1,0.0,7,8,4,2,10,19,2,11,2,21,44,1
6888,181878,mFn79ciJdfvDwevzTSoEVfLGV9PijzfL,5Gyp41oLVo7Gg7vF4vpmggWP5MU70QO6,4,2,1,0,1,0,1,0,5,0.7142857142857143,1,0.0,0,1,0,1,2,0,0,1,0,2,3,1
6889,181891,UnYWhkEUM28aufKl6iE422jz3645yuzl,5Gyp41oLVo7Gg7vF4vpmggWP5MU70QO6,1,0,0,0,0,0,1,0,1,0.14285714285714285,1,0.0,0,0,0,0,0,0,0,1,0,0,1,1
6890,181925,woOVTWY9QIEZxnUvH9kgVqMAANkeoDdW,5Gyp41oLVo7Gg7vF4vpmggWP5MU70QO6,1,0,0,0,0,0,1,0,1,0.14285714285714285,1,0.0,0,0,0,0,0,0,0,1,0,0,1,1
6891,181930,RdPbOoj1tSvRDq7tNhQTJcA4ojiLiLWa,5Gyp41oLVo7Gg7vF4vpmggWP5MU70QO6,13,21,9,9,7,0,2,0,48,6.857142857142857,2,0.0,5,9,6,7,16,0,3,2,0,27,21,1
6892,181944,paTMSyIYccWRvSekJsb5JXCiuZJwgllx,5Gyp41oLVo7Gg7vF4vpmggWP5MU70QO6,1,0,0,0,0,0,1,0,1,0.14285714285714285,1,0.0,0,0,0,0,0,0,0,1,0,0,1,1
6893,181951,zKuu0G4RnvAcXMNiMRIMiJEZsUKC7Le7,5Gyp41oLVo7Gg7vF4vpmggWP5MU70QO6,4,2,1,0,1,0,2,0,6,0.8571428571428571,1,0.0,0,1,0,1,2,0,0,2,0,2,4,1
6894,181968,HQ5tnzuUQ94xK6c7cghGoPyRlzEcu26K,5Gyp41oLVo7Gg7vF4vpmggWP5MU70QO6,7,3,2,0,2,0,3,0,10,1.4285714285714286,1,0.0,0,2,0,2,3,0,0,3,0,4,6,1
6895,181970,0pIqHSKuDCSg4zJWaYLKFpCLPhGoteyk,5Gyp41oLVo7Gg7vF4vpmggWP5MU70QO6,11,11,5,6,3,0,3,0,28,4.0,1,0.0,4,5,3,3,7,0,3,3,0,15,13,1
6896,181983,qvXX30e2GzSZOZjOYJYzckyY0LoUWSEL,5Gyp41oLVo7Gg7vF4vpmggWP5MU70QO6,9,8,2,0,2,1,5,1,19,2.7142857142857144,1,0.0,5,2,0,2,3,1,0,5,1,9,10,1
6897,181985,Doz9EqVz2rDPpnfDU5uayT06yOJEViYw,5Gyp41oLVo7Gg7vF4vpmggWP5MU70QO6,8,3,2,0,2,1,5,0,13,1.8571428571428572,1,0.0,0,2,0,2,3,1,0,5,0,4,9,1
6898,181988,KKt1JC1nzbMVlXS5edz6S15kzLg0gQOL,5Gyp41oLVo7Gg7vF4vpmggWP5MU70QO6,2,0,0,0,0,0,2,0,2,0.2857142857142857,1,0.0,0,0,0,0,0,0,0,2,0,0,2,1
6899,182031,gcBrw9IbRpVyrCuK81SDliRBWaiEwt3S,5Gyp41oLVo7Gg7vF4vpmggWP5MU70QO6,1,0,0,0,0,0,1,0,1,0.14285714285714285,1,0.0,0,0,0,0,0,0,0,1,0,0,1,1
6900,182039,Q9kdHcV1kbonm0KnIW9OSERwU5lfVZ8s,5Gyp41oLVo7Gg7vF4vpmggWP5MU70QO6,6,6,2,0,3,0,1,0,12,1.7142857142857142,1,0.0,1,2,0,3,5,0,0,1,0,6,6,1
6901,182050,VKQwP2UGxFr8cW02yW69JgEmp944MwNR,5Gyp41oLVo7Gg7vF4vpmggWP5MU70QO6,1,0,0,0,0,0,1,0,1,0.14285714285714285,1,0.0,0,0,0,0,0,0,0,1,0,0,1,1
6902,182070,1YSmilr2ajm5pFk4iAawwfB3mRapy4GR,5Gyp41oLVo7Gg7vF4vpmggWP5MU70QO6,4,4,2,0,2,0,1,0,9,1.2857142857142858,1,0.0,0,2,0,2,4,0,0,1,0,4,5,1
6903,182072,FfUXMT7mZqZTunyhx99wOtQUuUI4jlLj,5Gyp41oLVo7Gg7vF4vpmggWP5MU70QO6,7,5,2,0,4,0,1,0,12,1.7142857142857142,1,0.0,1,2,0,4,4,0,0,1,0,7,5,1
6904,182075,QVjEwhKJ4IaQVAen5cqn3R8peuziaXvN,5Gyp41oLVo7Gg7vF4vpmggWP5MU70QO6,4,2,0,0,0,0,2,0,4,0.5714285714285714,1,0.0,0,0,0,0,2,0,0,2,0,0,4,1
6905,182084,XZQ1LXoj3dsDPYD030v9JTWJcyoUhfK4,5Gyp41oLVo7Gg7vF4vpmggWP5MU70QO6,10,5,3,0,1,2,7,1,19,2.7142857142857144,2,0.0,0,3,0,1,5,2,0,7,1,4,15,1
6906,182088,w9Op2paOObvbeexRevdwj22JnTTWTNbu,5Gyp41oLVo7Gg7vF4vpmggWP5MU70QO6,10,5,4,0,2,0,5,1,17,2.4285714285714284,1,0.0,0,4,0,2,5,0,0,5,1,6,11,1
6907,182094,3URMlJ8WFfbFx3SvBMPqUCA5oJqCky66,5Gyp41oLVo7Gg7vF4vpmggWP5MU70QO6,8,6,4,4,1,0,1,0,16,2.2857142857142856,1,0.0,1,4,2,1,5,0,2,1,0,8,8,0
6908,182097,I7kDXvBJVlkmv06VEWaRnFxAqKlFNhUE,5Gyp41oLVo7Gg7vF4vpmggWP5MU70QO6,4,2,1,0,1,0,2,0,6,0.8571428571428571,1,0.0,0,1,0,1,2,0,0,2,0,2,4,1
6909,182194,csxsIreB4z2fEbPvSHNv03dBFq18io5H,3VkHkmOtom3jM2wCu94xgzzu1d6Dn7or,1,0,0,0,0,0,1,0,1,0.14285714285714285,1,0.0,0,0,0,0,0,0,0,1,0,0,1,1
6910,182195,0DzldTHKdoH90kklIAjpWyAEe6XDDjyM,3VkHkmOtom3jM2wCu94xgzzu1d6Dn7or,2,0,0,0,0,0,2,0,2,0.2857142857142857,1,0.0,0,0,0,0,0,0,0,2,0,0,2,1
6911,182198,fjRMOtvjigMsGnlSnPUPaprtvPnBtbuW,3VkHkmOtom3jM2wCu94xgzzu1d6Dn7or,9,13,3,0,4,6,9,1,36,5.142857142857143,1,0.0,3,3,0,4,10,6,0,9,1,10,26,1
6912,182205,bTczPD51Suiv53Xy2FmFzTweP9qA2PXP,3VkHkmOtom3jM2wCu94xgzzu1d6Dn7or,6,6,3,0,2,0,5,0,16,2.2857142857142856,1,0.0,0,3,0,2,6,0,0,5,0,5,11,1
6913,182209,fN5vmNHpVQShrSJGsQfUHVmKVlpKBGSR,3VkHkmOtom3jM2wCu94xgzzu1d6Dn7or,1,0,0,0,0,0,1,0,1,0.14285714285714285,1,0.0,0,0,0,0,0,0,0,1,0,0,1,1
6914,182220,kh2vzlwluJq9JmVuODuzJ0gIlWmSWoqB,3VkHkmOtom3jM2wCu94xgzzu1d6Dn7or,6,13,6,0,0,2,2,0,23,3.2857142857142856,1,0.0,0,6,0,0,13,2,0,2,0,6,17,1
6915,182227,cHLzyoSNKubGg47lLtnMJYW3dvB9xzcx,3VkHkmOtom3jM2wCu94xgzzu1d6Dn7or,7,5,2,0,1,2,7,0,17,2.4285714285714284,1,0.0,1,2,0,1,4,2,0,7,0,4,13,1
6916,182230,0IVbCZxyYgDvtApqm5aKQEhPY2ayA5sy,3VkHkmOtom3jM2wCu94xgzzu1d6Dn7or,5,2,0,0,0,1,5,0,8,1.1428571428571428,1,0.0,0,0,0,0,2,1,0,5,0,0,8,0
6917,182232,VfHC2SKhHbKGj4ZnO1yfFM7GCtKBBAcC,3VkHkmOtom3jM2wCu94xgzzu1d6Dn7or,1,0,0,0,0,0,2,0,2,0.2857142857142857,1,0.0,0,0,0,0,0,0,0,2,0,0,2,1
6918,182233,jwgcgdUXLu2gXFgpv8mLrXcrkYyNakoU,3VkHkmOtom3jM2wCu94xgzzu1d6Dn7or,6,0,0,0,0,3,8,2,13,1.8571428571428572,1,0.0,0,0,0,0,0,3,0,8,2,0,13,1
6919,182234,Ckbaflkb87MSikjOjkyAMqpueoAF2UNu,3VkHkmOtom3jM2wCu94xgzzu1d6Dn7or,6,3,2,0,2,0,1,0,8,1.1428571428571428,1,0.0,0,2,0,2,3,0,0,1,0,4,4,1
6920,182236,yWtKP7X5IakNbcOVZXYdks1Jj5UCg7ph,3VkHkmOtom3jM2wCu94xgzzu1d6Dn7or,7,2,1,0,1,0,6,2,12,1.7142857142857142,1,0.0,0,1,0,1,2,0,0,6,2,2,10,1
6921,182242,u6YQGD67yzQraOCkQvpFkxe73vsSHBNh,3VkHkmOtom3jM2wCu94xgzzu1d6Dn7or,1,0,0,0,0,0,2,0,2,0.2857142857142857,1,0.0,0,0,0,0,0,0,0,2,0,0,2,1
6922,182244,YwOmwhLK2jRByqckCXHjjfeOrEZhOyRH,3VkHkmOtom3jM2wCu94xgzzu1d6Dn7or,11,13,7,0,4,0,14,2,40,5.714285714285714,1,0.0,0,7,0,4,13,0,0,14,2,11,29,1
6923,182252,gok0oMg5xY1pC9HgrOtGpZy6NUwXLxlf,3VkHkmOtom3jM2wCu94xgzzu1d6Dn7or,4,0,0,0,0,0,4,0,4,0.5714285714285714,1,0.0,0,0,0,0,0,0,0,4,0,0,4,0
6924,182255,eWbah1mPfqGGn0g78J9fkAub7UxJt3bI,3VkHkmOtom3jM2wCu94xgzzu1d6Dn7or,5,2,1,0,1,0,3,0,7,1.0,1,0.0,0,1,0,1,2,0,0,3,0,2,5,1
6925,182258,P4QefYxxQlboHx5mmTzC7fQ3zDmvVItg,3VkHkmOtom3jM2wCu94xgzzu1d6Dn7or,9,15,1,0,2,0,8,1,27,3.857142857142857,1,0.0,2,1,0,2,13,0,0,8,1,5,22,1
6926,182261,QhGVkY0v83zB7Ydq0uVaVQ4ZFO6GOJw4,3VkHkmOtom3jM2wCu94xgzzu1d6Dn7or,2,0,0,0,0,0,4,0,4,0.5714285714285714,1,0.0,0,0,0,0,0,0,0,4,0,0,4,1
6927,182270,1BBLLCnuLnP5mi368OTjrHinvVTwPvbC,3VkHkmOtom3jM2wCu94xgzzu1d6Dn7or,4,2,1,0,1,0,1,0,5,0.7142857142857143,1,0.0,0,1,0,1,2,0,0,1,0,2,3,1
6928,182271,2fqSxqAVilSfIg4sQ6fD6J1JY6ZshTCe,3VkHkmOtom3jM2wCu94xgzzu1d6Dn7or,1,0,0,0,0,0,3,0,3,0.42857142857142855,1,0.0,0,0,0,0,0,0,0,3,0,0,3,1
6929,182276,JwpnWAbXqqokshNbyxBH2QHaOUPb8wrj,3VkHkmOtom3jM2wCu94xgzzu1d6Dn7or,8,4,3,0,3,0,1,0,11,1.5714285714285714,1,0.0,0,3,0,3,4,0,0,1,0,6,5,1
6930,182282,JuasymbBrE2UlWNEAFWaoRL2BZwC7SNr,3VkHkmOtom3jM2wCu94xgzzu1d6Dn7or,11,7,4,0,3,0,5,0,19,2.7142857142857144,1,0.0,0,4,0,3,7,0,0,5,0,7,12,1
6931,182283,EtDvowReST2EpXduL96uQJrkBnjRSfnj,3VkHkmOtom3jM2wCu94xgzzu1d6Dn7or,7,4,1,0,0,0,11,2,18,2.5714285714285716,1,0.0,0,1,0,0,4,0,0,11,2,1,17,1
6932,182288,e8fSlTZ73gVJQ2o5lZEoqxY5iG8EDdMh,3VkHkmOtom3jM2wCu94xgzzu1d6Dn7or,13,23,4,0,2,0,6,0,35,5.0,1,0.0,0,4,0,2,23,0,0,6,0,6,29,1
6933,182751,s4TEJX3ZSvr4kBLGdjg6CpTOCIceK5wi,SpATywNh6bZuzm8s1ceuBUnMUAeoAHHw,4,2,1,0,1,0,2,0,6,0.8571428571428571,1,0.0,0,1,0,1,2,0,0,2,0,2,4,1
6934,183258,cwjdhzGq04zCTXyAv16dQv37UeRHYh5B,G8EPVSXsOYB5YQWZGiz1aVq5Pgr2GrQu,1,0,0,0,0,0,1,0,1,0.14285714285714285,1,0.0,0,0,0,0,0,0,0,1,0,0,1,1
6935,184214,dCqryZS5yEyDDbYzWpFyoRjFGlVzafA6,5Gyp41oLVo7Gg7vF4vpmggWP5MU70QO6,1,0,0,0,0,0,1,0,1,0.14285714285714285,1,0.0,0,0,0,0,0,0,0,1,0,0,1,1
6936,184230,YRDulTOgIWgR8cFwTAVhhuxX46WtWav7,5Gyp41oLVo7Gg7vF4vpmggWP5MU70QO6,1,0,0,0,0,0,1,0,1,0.14285714285714285,1,0.0,0,0,0,0,0,0,0,1,0,0,1,1
6937,184232,l4WlJO3Jpy27BdnSHSbIwrtjpEVcxPiy,5Gyp41oLVo7Gg7vF4vpmggWP5MU70QO6,1,0,0,0,0,0,1,0,1,0.14285714285714285,1,0.0,0,0,0,0,0,0,0,1,0,0,1,1
6938,184234,p0nAYIAgPKFrrLkwnZeKFQeORCcXOdHl,5Gyp41oLVo7Gg7vF4vpmggWP5MU70QO6,6,4,1,0,2,0,4,0,11,1.5714285714285714,1,0.0,3,1,0,2,1,0,0,4,0,6,5,0
6939,184237,Im8OZq4WKyr1B9dfjSkTtMelhAH9uWSr,5Gyp41oLVo7Gg7vF4vpmggWP5MU70QO6,1,0,0,0,0,0,1,0,1,0.14285714285714285,1,0.0,0,0,0,0,0,0,0,1,0,0,1,1
6940,184245,YWrHRbNreHJe5iW4BiuBi4YwZG4tk5wx,5Gyp41oLVo7Gg7vF4vpmggWP5MU70QO6,2,0,0,0,0,0,2,0,2,0.2857142857142857,1,0.0,0,0,0,0,0,0,0,2,0,0,2,1
6941,184249,walJZXHwF3doVDD3RPNhbAoeSNaLgA4Q,5Gyp41oLVo7Gg7vF4vpmggWP5MU70QO6,5,2,1,0,1,0,2,0,6,0.8571428571428571,1,0.0,0,1,0,1,2,0,0,2,0,2,4,1
6942,184250,OanBSNHIQYRj4Jp2lzBNtY4pt9ANozmk,5Gyp41oLVo7Gg7vF4vpmggWP5MU70QO6,1,0,0,0,0,0,1,0,1,0.14285714285714285,1,0.0,0,0,0,0,0,0,0,1,0,0,1,1
6943,184273,ryDHfI9VlxEuq9P95xmWnlvLcWdFOBP8,5Gyp41oLVo7Gg7vF4vpmggWP5MU70QO6,6,4,2,0,2,0,2,0,10,1.4285714285714286,1,0.0,0,2,0,2,4,0,0,2,0,4,6,1
6944,184278,ZgpGN88lumfbDP2hVF7RLkOIiFODCDmG,5Gyp41oLVo7Gg7vF4vpmggWP5MU70QO6,2,0,0,0,0,0,3,0,3,0.42857142857142855,1,0.0,0,0,0,0,0,0,0,3,0,0,3,1
6945,184295,EWfAZDd5nGbae5ofnAGOF6BMPZ0hsMJq,5Gyp41oLVo7Gg7vF4vpmggWP5MU70QO6,8,3,2,0,2,1,3,1,12,1.7142857142857142,1,0.0,0,2,0,2,3,1,0,3,1,4,8,1
6946,184296,8ibAJIwvLEy17ev0RSqd01LfNuuU9R2K,5Gyp41oLVo7Gg7vF4vpmggWP5MU70QO6,7,2,0,0,0,1,10,3,16,2.2857142857142856,1,0.0,0,0,0,0,2,1,0,10,3,0,16,1
6947,184301,UKkBInQa7yMHkp5JLcsLsu2Rm6Gu6A10,5Gyp41oLVo7Gg7vF4vpmggWP5MU70QO6,6,3,1,0,1,0,2,0,7,1.0,1,0.0,0,1,0,1,3,0,0,2,0,2,5,1
6948,184307,8DCbMujrfIKOkxYBkibXx1DGndULJunM,5Gyp41oLVo7Gg7vF4vpmggWP5MU70QO6,9,4,3,0,3,0,2,0,12,1.7142857142857142,1,0.0,0,3,0,3,4,0,0,2,0,6,6,1
6949,184316,q1KW22sJlHuJafxKSNMxbZpto7Ue0rxt,5Gyp41oLVo7Gg7vF4vpmggWP5MU70QO6,6,4,1,0,2,0,4,0,11,1.5714285714285714,2,0.0,1,1,0,2,3,0,0,4,0,4,7,1
6950,184319,QoKkWqCz9JSPf2G2l4XrJl2BfFSq9X9B,5Gyp41oLVo7Gg7vF4vpmggWP5MU70QO6,10,8,1,6,0,3,3,0,21,3.0,1,0.0,3,1,3,0,5,3,3,3,0,7,14,1
6951,184325,kw3mSAPGy3lSGYVAwXkjqmqc5eU6galb,5Gyp41oLVo7Gg7vF4vpmggWP5MU70QO6,8,2,2,0,2,0,3,0,9,1.2857142857142858,1,0.0,0,2,0,2,2,0,0,3,0,4,5,1
6952,184329,NmSXtLcHGAQSNZGaHvLyDA6YnNQ58Zgp,5Gyp41oLVo7Gg7vF4vpmggWP5MU70QO6,6,5,2,0,2,0,1,0,10,1.4285714285714286,1,0.0,0,2,0,2,5,0,0,1,0,4,6,1
6953,184335,Gmb2KsL7DF4Lrnaw4YolO7TYaAfk1p9f,5Gyp41oLVo7Gg7vF4vpmggWP5MU70QO6,5,2,1,0,1,0,2,0,6,0.8571428571428571,1,0.0,0,1,0,1,2,0,0,2,0,2,4,1
6954,184344,k1KgfoARLKPwBKFYb9gSMt5WKTItv1kf,5Gyp41oLVo7Gg7vF4vpmggWP5MU70QO6,1,0,0,0,0,0,1,0,1,0.14285714285714285,1,0.0,0,0,0,0,0,0,0,1,0,0,1,1
6955,184349,hQ8hWOlIxDaeW0eIxILffazvx4MDF3wh,5Gyp41oLVo7Gg7vF4vpmggWP5MU70QO6,11,7,5,0,3,0,5,0,20,2.857142857142857,1,0.0,0,5,0,3,7,0,0,5,0,8,12,1
6956,184365,SSGF4jRiMix13YJuADGKuMPfmpw8sSJ7,5Gyp41oLVo7Gg7vF4vpmggWP5MU70QO6,6,3,1,0,1,0,2,0,7,1.0,1,0.0,0,1,0,1,3,0,0,2,0,2,5,1
6957,184379,LAvAjJZzTQAVTvztETb4BVDPuM9nBGU0,5Gyp41oLVo7Gg7vF4vpmggWP5MU70QO6,5,2,1,0,1,0,3,0,7,1.0,2,0.0,0,1,0,1,2,0,0,3,0,2,5,1
6958,184387,Cn5P4KbozwRH67Dsuo8o4HEAMCURG2rp,5Gyp41oLVo7Gg7vF4vpmggWP5MU70QO6,7,1,1,0,1,1,7,1,12,1.7142857142857142,2,0.0,0,1,0,1,1,1,0,7,1,2,10,1
6959,184392,0oQAWSzD0k4f4Ywi9nSJ6FaMaY6F6i7R,5Gyp41oLVo7Gg7vF4vpmggWP5MU70QO6,8,4,3,0,2,0,2,0,11,1.5714285714285714,1,0.0,0,3,0,2,4,0,0,2,0,5,6,1
6960,184393,fbcZHP0ECdlDyz0JOOtSmEtQuMV1LPFH,5Gyp41oLVo7Gg7vF4vpmggWP5MU70QO6,17,22,9,2,5,0,5,0,43,6.142857142857143,1,0.0,1,9,1,5,21,0,1,5,0,16,27,1
6961,184395,IlqSSQgfWr44lC84b9J1DRytAl95LFXm,5Gyp41oLVo7Gg7vF4vpmggWP5MU70QO6,6,5,2,0,1,0,2,0,10,1.4285714285714286,1,0.0,0,2,0,1,5,0,0,2,0,3,7,1
6962,184397,t5GAapz2qu7QW3ZA52Mo1qG5gvWMLT4H,5Gyp41oLVo7Gg7vF4vpmggWP5MU70QO6,1,0,0,0,0,0,1,0,1,0.14285714285714285,1,0.0,0,0,0,0,0,0,0,1,0,0,1,0
6963,184402,tkxwTpjNIcKspgIQFJ1HEHtxSp5ThNsq,5Gyp41oLVo7Gg7vF4vpmggWP5MU70QO6,7,5,3,0,3,2,4,0,17,2.4285714285714284,1,0.0,0,3,0,3,5,2,0,4,0,6,11,1
6964,184412,iNLMSYCSok03nU0WcNw4JJFtx0ifAHYV,5Gyp41oLVo7Gg7vF4vpmggWP5MU70QO6,1,0,0,0,0,0,1,0,1,0.14285714285714285,1,0.0,0,0,0,0,0,0,0,1,0,0,1,1
6965,184430,8s81mHP6Lgrzs5sdzveYdMrxd3ZB96kc,3VkHkmOtom3jM2wCu94xgzzu1d6Dn7or,1,0,0,0,0,0,1,0,1,0.14285714285714285,1,0.0,0,0,0,0,0,0,0,1,0,0,1,1
6966,184516,DTsOT0NTIRutfokoKq4yB8bQe3U1fEsD,3VkHkmOtom3jM2wCu94xgzzu1d6Dn7or,1,0,0,0,0,0,2,0,2,0.2857142857142857,1,0.0,0,0,0,0,0,0,0,2,0,0,2,1
6967,184528,lw6h3s1CoSuypoW7FPPIbDq7fjqWqDdP,3VkHkmOtom3jM2wCu94xgzzu1d6Dn7or,7,2,1,0,1,0,5,1,10,1.4285714285714286,1,0.0,0,1,0,1,2,0,0,5,1,2,8,1
6968,184613,YJAiqoz1F4UNiXHedBcWRmbBhQHxGtrm,3VkHkmOtom3jM2wCu94xgzzu1d6Dn7or,7,4,0,0,0,2,6,1,13,1.8571428571428572,1,0.0,0,0,0,0,4,2,0,6,1,0,13,1
6969,184711,exoKDO0f3lmtTfq6L6YJCwhFZBgMaXfc,3VkHkmOtom3jM2wCu94xgzzu1d6Dn7or,1,0,0,0,0,0,1,0,1,0.14285714285714285,1,0.0,0,0,0,0,0,0,0,1,0,0,1,1
6970,184791,vYxMlW5ssFbn7RCYrcmg1cCFSeVOM9i4,3VkHkmOtom3jM2wCu94xgzzu1d6Dn7or,1,0,0,0,0,0,2,0,2,0.2857142857142857,1,0.0,0,0,0,0,0,0,0,2,0,0,2,0
6971,184793,pHfVmP0MtByC9SkdM1AzMOfjrOpx3mAn,3VkHkmOtom3jM2wCu94xgzzu1d6Dn7or,1,0,0,0,0,0,2,0,2,0.2857142857142857,1,0.0,0,0,0,0,0,0,0,2,0,0,2,1
6972,186916,n8LY1ToQ2P6PD0SRP8PZWwJUYWAdiNKb,3VkHkmOtom3jM2wCu94xgzzu1d6Dn7or,1,0,0,0,0,0,1,0,1,0.14285714285714285,1,0.0,0,0,0,0,0,0,0,1,0,0,1,1
6973,186946,IUpvJjgbl643UyF8wULi6B9PKWsV1bsS,3VkHkmOtom3jM2wCu94xgzzu1d6Dn7or,1,0,0,0,0,0,1,0,1,0.14285714285714285,1,0.0,0,0,0,0,0,0,0,1,0,0,1,1
6974,186948,Y3GsHv1t2an649bMll1LdxvN2SIICjxG,3VkHkmOtom3jM2wCu94xgzzu1d6Dn7or,1,0,0,0,0,0,1,0,1,0.14285714285714285,1,0.0,0,0,0,0,0,0,0,1,0,0,1,1
6975,186952,u0TAxOeMDUcz4HYUXhtuwFdKGuCQJPP6,3VkHkmOtom3jM2wCu94xgzzu1d6Dn7or,5,7,3,0,3,0,2,0,15,2.142857142857143,2,0.0,2,3,0,3,5,0,0,2,0,8,7,1
6976,186956,cMYfCr1GMHTzG7ZiciGrwM5l2A1AGHh9,3VkHkmOtom3jM2wCu94xgzzu1d6Dn7or,1,0,0,0,0,0,1,0,1,0.14285714285714285,1,0.0,0,0,0,0,0,0,0,1,0,0,1,1
6977,186959,lhe0217AMihRJNo4Bspb4FRLARjvGGyQ,3VkHkmOtom3jM2wCu94xgzzu1d6Dn7or,1,0,0,0,0,0,1,0,1,0.14285714285714285,1,0.0,0,0,0,0,0,0,0,1,0,0,1,1
6978,187005,FHIf7MUGEVUr0CqbuDIIiBw1QO6ZVxVj,3VkHkmOtom3jM2wCu94xgzzu1d6Dn7or,1,0,0,0,0,0,1,0,1,0.14285714285714285,1,0.0,0,0,0,0,0,0,0,1,0,0,1,1
6979,187018,Znmmp6V6FvAQ161tQ3t8Ufq1JqeABV0W,3VkHkmOtom3jM2wCu94xgzzu1d6Dn7or,1,0,0,0,0,0,1,0,1,0.14285714285714285,1,0.0,0,0,0,0,0,0,0,1,0,0,1,1
6980,187036,r235FEYMvkwQSN0TLkhdWY41ThJsKZPI,3VkHkmOtom3jM2wCu94xgzzu1d6Dn7or,13,12,4,0,4,0,9,0,29,4.142857142857143,1,0.0,0,4,0,4,12,0,0,9,0,8,21,1
6981,187037,UOOcBtVsAebNsOt57VwKXO1YgfAVMWii,3VkHkmOtom3jM2wCu94xgzzu1d6Dn7or,7,4,2,0,1,0,6,0,13,1.8571428571428572,1,0.0,0,2,0,1,4,0,0,6,0,3,10,1
6982,187070,36E8EgprLSCZHQtlY5yjvPm97JUh2cfX,3VkHkmOtom3jM2wCu94xgzzu1d6Dn7or,1,0,0,0,0,0,1,0,1,0.14285714285714285,1,0.0,0,0,0,0,0,0,0,1,0,0,1,1
6983,187075,uBzcfb44icLfh2f5mW4iYyj6hSWSmS38,3VkHkmOtom3jM2wCu94xgzzu1d6Dn7or,9,15,6,0,5,2,15,4,47,6.714285714285714,2,0.0,5,6,0,5,10,2,0,15,4,16,31,1
6984,187090,s89uavZ3km9aogxJ45C1gOIn37jOvzBC,fbPkOYLVPtPgIt0MxizjfFJov3JbHyAi,9,8,4,0,3,0,3,0,18,2.5714285714285716,1,0.0,0,4,0,3,8,0,0,3,0,7,11,1
6985,187093,TlbmE7XsXOxA9LAHMAGK9zsRJszf1Jcd,fbPkOYLVPtPgIt0MxizjfFJov3JbHyAi,18,23,18,0,1,1,3,0,46,6.571428571428571,1,0.0,4,18,0,1,19,1,0,3,0,23,23,1
6986,187096,nW9f9CiPiXdcUNUj5HdltqeG1yplsOpj,fbPkOYLVPtPgIt0MxizjfFJov3JbHyAi,1,0,0,0,0,0,1,0,1,0.14285714285714285,1,0.0,0,0,0,0,0,0,0,1,0,0,1,1
6987,187097,FVIxcL3KNPZgRk3VAWTB53BK2VJRJoNW,fbPkOYLVPtPgIt0MxizjfFJov3JbHyAi,8,5,1,8,1,0,2,0,17,2.4285714285714284,1,0.0,1,1,6,1,4,0,2,2,0,9,8,1
6988,187099,kXSl6jg4QHUvxsqBcAJXHeR9Ubl1gwbF,fbPkOYLVPtPgIt0MxizjfFJov3JbHyAi,1,0,0,0,0,0,1,0,1,0.14285714285714285,1,0.0,0,0,0,0,0,0,0,1,0,0,1,1
6989,187101,FlAkKX6ow9SvOzk0dTWPWgnX5766zY29,fbPkOYLVPtPgIt0MxizjfFJov3JbHyAi,1,0,0,0,0,0,1,0,1,0.14285714285714285,1,0.0,0,0,0,0,0,0,0,1,0,0,1,1
6990,187102,e40FG7MgJJlfB40dPeqwApGpeo4I5srR,fbPkOYLVPtPgIt0MxizjfFJov3JbHyAi,8,7,3,0,2,0,2,0,14,2.0,1,0.0,0,3,0,2,7,0,0,2,0,5,9,1
6991,187105,9DE0a3KJcJqzkMoD4VYpnCDg9cCk5hV4,fbPkOYLVPtPgIt0MxizjfFJov3JbHyAi,2,0,0,0,0,0,2,0,2,0.2857142857142857,1,0.0,0,0,0,0,0,0,0,2,0,0,2,1
6992,187107,rG7M6TKyUFqXw8w8ui7NRfruQr8bRWFG,fbPkOYLVPtPgIt0MxizjfFJov3JbHyAi,5,2,1,0,1,0,2,0,6,0.8571428571428571,1,0.0,0,1,0,1,2,0,0,2,0,2,4,1
6993,187111,5Pwkqnt6BX10vyfbMPXwyyxMRo64zs7g,fbPkOYLVPtPgIt0MxizjfFJov3JbHyAi,1,0,0,0,0,0,1,0,1,0.14285714285714285,1,0.0,0,0,0,0,0,0,0,1,0,0,1,1
6994,187115,4XcgNL1U2xG3iw9wdTEeH4HKfjTMhScM,fbPkOYLVPtPgIt0MxizjfFJov3JbHyAi,6,3,2,0,2,0,1,0,8,1.1428571428571428,1,0.0,0,2,0,2,3,0,0,1,0,4,4,1
6995,187230,hyOYv4rmSRnv16UkVW9gdxwUgBZxYdhv,5Gyp41oLVo7Gg7vF4vpmggWP5MU70QO6,8,5,4,0,4,0,1,0,14,2.0,1,0.0,0,4,0,4,5,0,0,1,0,8,6,1
6996,187260,vzQWE9ulRkQ7hUrO1Cw0UEGI4ALwL8Jg,5Gyp41oLVo7Gg7vF4vpmggWP5MU70QO6,5,4,3,0,2,0,2,0,11,1.5714285714285714,1,0.0,0,3,0,2,4,0,0,2,0,5,6,1
6997,187263,VoWsW4btdFhDkZDVEDrYE0OgkSDO7WLH,5Gyp41oLVo7Gg7vF4vpmggWP5MU70QO6,11,18,5,7,5,0,5,0,40,5.714285714285714,1,0.0,13,5,4,5,5,0,3,5,0,27,13,1
6998,187281,tI0Ei8jknXkjHOveohv83xyWyLEH72Bz,5Gyp41oLVo7Gg7vF4vpmggWP5MU70QO6,1,0,0,0,0,0,1,0,1,0.14285714285714285,1,0.0,0,0,0,0,0,0,0,1,0,0,1,1
6999,187292,PHXAtnilhkAfYARsAg1caWvqdybDG9wd,5Gyp41oLVo7Gg7vF4vpmggWP5MU70QO6,1,0,0,0,0,0,1,0,1,0.14285714285714285,1,0.0,0,0,0,0,0,0,0,1,0,0,1,1
7000,187293,y6skA61OxQXi41KVikPwH48hFkcuo8s0,5Gyp41oLVo7Gg7vF4vpmggWP5MU70QO6,2,0,0,0,0,1,1,0,2,0.2857142857142857,1,0.0,0,0,0,0,0,1,0,1,0,0,2,1
7001,187296,rtpXqjUa2W2r0HFNo4cTJ57QxTOXAUvW,5Gyp41oLVo7Gg7vF4vpmggWP5MU70QO6,6,7,0,0,0,0,2,0,9,1.2857142857142858,1,0.0,0,0,0,0,7,0,0,2,0,0,9,1
7002,187298,X7FeDRCspdh7NOzhLrJrdldfEZBgFA5Q,5Gyp41oLVo7Gg7vF4vpmggWP5MU70QO6,2,0,0,0,0,0,3,0,3,0.42857142857142855,1,0.0,0,0,0,0,0,0,0,3,0,0,3,1
7003,187320,DUrwR1Re5QIiLZZaDVxG0FXYJXyscHgC,5Gyp41oLVo7Gg7vF4vpmggWP5MU70QO6,1,0,0,0,0,0,2,0,2,0.2857142857142857,1,0.0,0,0,0,0,0,0,0,2,0,0,2,1
7004,187327,031MrYvOJqNjV16O5cUmmCo9dFy2kyYH,5Gyp41oLVo7Gg7vF4vpmggWP5MU70QO6,5,2,1,0,1,0,3,0,7,1.0,2,0.0,0,1,0,1,2,0,0,3,0,2,5,1
7005,187346,X8WCNt6loaLNoumdckfUSubkNRieo8NK,5Gyp41oLVo7Gg7vF4vpmggWP5MU70QO6,10,7,3,8,2,0,2,0,22,3.142857142857143,1,0.0,3,3,5,2,4,0,3,2,0,13,9,1
7006,187368,PehE9hSoHmU2qayrquECF2Z72j2CCoBa,5Gyp41oLVo7Gg7vF4vpmggWP5MU70QO6,11,6,3,6,3,0,2,0,20,2.857142857142857,1,0.0,2,3,4,3,4,0,2,2,0,12,8,1
7007,187402,1uOPQAhAVE7yRowaAKEn61VPIsM6sMCc,5Gyp41oLVo7Gg7vF4vpmggWP5MU70QO6,1,0,0,0,0,0,1,0,1,0.14285714285714285,1,0.0,0,0,0,0,0,0,0,1,0,0,1,1
7008,187436,XJpybRSv6nblPDjgevLWB1Ktkzr6kyjz,5Gyp41oLVo7Gg7vF4vpmggWP5MU70QO6,7,3,2,0,2,0,3,0,10,1.4285714285714286,1,0.0,0,2,0,2,3,0,0,3,0,4,6,0
7009,187461,kHMfLm6GLGyN2t8DdFTcaIg1JDY9sN2O,5Gyp41oLVo7Gg7vF4vpmggWP5MU70QO6,4,2,1,0,1,0,1,0,5,0.7142857142857143,1,0.0,0,1,0,1,2,0,0,1,0,2,3,1
7010,187531,bNDMI0LSeZpYXzR656IEJ9nN2Bo4tKbR,5Gyp41oLVo7Gg7vF4vpmggWP5MU70QO6,7,4,2,0,2,0,2,0,10,1.4285714285714286,1,0.0,1,2,0,2,3,0,0,2,0,5,5,1
7011,187539,ZzaZO5citAcoeYBQ4xnco2bMgq0deP0c,5Gyp41oLVo7Gg7vF4vpmggWP5MU70QO6,6,3,2,0,2,0,2,0,9,1.2857142857142858,1,0.0,0,2,0,2,3,0,0,2,0,4,5,1
7012,187559,UvSwBvBH1lyOipF4wGbdNVoeT8lJP5aY,5Gyp41oLVo7Gg7vF4vpmggWP5MU70QO6,8,6,4,0,5,0,3,0,18,2.5714285714285716,1,0.0,1,4,0,5,5,0,0,3,0,10,8,1
7013,187588,rOtdN0YIXzc9Q3VhwhOR72jeW5lVoqLk,5Gyp41oLVo7Gg7vF4vpmggWP5MU70QO6,1,0,0,0,0,0,1,0,1,0.14285714285714285,1,0.0,0,0,0,0,0,0,0,1,0,0,1,1
7014,187634,oVtSGZ3Qh0AOmlaUwqXBN2XqCeY3aZXg,5Gyp41oLVo7Gg7vF4vpmggWP5MU70QO6,8,5,2,2,2,0,1,0,12,1.7142857142857142,1,0.0,1,2,1,2,4,0,1,1,0,6,6,1
7015,187642,hBqYoPWGXo4KdSE3ypv2nDXmsYrpwKgj,5Gyp41oLVo7Gg7vF4vpmggWP5MU70QO6,1,0,0,0,0,0,1,0,1,0.14285714285714285,1,0.0,0,0,0,0,0,0,0,1,0,0,1,1
7016,187646,8TnzjeqjtzBIk5Ql7fkT5COqEK4SmduG,5Gyp41oLVo7Gg7vF4vpmggWP5MU70QO6,5,2,1,0,1,0,2,0,6,0.8571428571428571,1,0.0,0,1,0,1,2,0,0,2,0,2,4,1
7017,187666,gEQJ3UM0yClKwkCWvNfY56DY3nmyC9PH,5Gyp41oLVo7Gg7vF4vpmggWP5MU70QO6,1,0,0,0,0,0,1,0,1,0.14285714285714285,1,0.0,0,0,0,0,0,0,0,1,0,0,1,1
7018,187685,4YD7ENfnhFTRFL7ILKgGgEPnhlw4hbFM,5Gyp41oLVo7Gg7vF4vpmggWP5MU70QO6,16,21,8,8,7,0,2,0,46,6.571428571428571,1,0.0,9,8,5,7,12,0,3,2,0,29,17,1
7019,187743,dDNJlkechDaI59ozHemH2ci9sMXgZuGy,5Gyp41oLVo7Gg7vF4vpmggWP5MU70QO6,1,0,0,0,0,0,1,0,1,0.14285714285714285,1,0.0,0,0,0,0,0,0,0,1,0,0,1,1
7020,187778,TFGsSi9KLgFMzGuAkbmIBjdVI0bCDL1L,5Gyp41oLVo7Gg7vF4vpmggWP5MU70QO6,9,13,4,2,1,0,2,0,22,3.142857142857143,1,0.0,2,4,1,1,11,0,1,2,0,8,14,1
7021,187792,LfsAkbTX7fJr35wgA2mTq5FGmS91YLIg,5Gyp41oLVo7Gg7vF4vpmggWP5MU70QO6,1,0,0,0,0,0,1,0,1,0.14285714285714285,1,0.0,0,0,0,0,0,0,0,1,0,0,1,1
7022,187795,clbUGnOQsN7CuaV7idGJ2LVbYN3t8qC3,5Gyp41oLVo7Gg7vF4vpmggWP5MU70QO6,1,0,0,0,0,0,1,0,1,0.14285714285714285,1,0.0,0,0,0,0,0,0,0,1,0,0,1,0
7023,187811,svIGNMVQDEQItjiVEcEkS0o4Jv6ND7Cf,5Gyp41oLVo7Gg7vF4vpmggWP5MU70QO6,10,10,5,0,5,1,5,1,27,3.857142857142857,1,0.0,0,5,0,5,10,1,0,5,1,10,17,1
7024,187844,RgHRxvakRmUixgorlOGDqgR6MDRVkg1a,5Gyp41oLVo7Gg7vF4vpmggWP5MU70QO6,6,6,2,0,1,0,3,0,12,1.7142857142857142,1,0.0,0,2,0,1,6,0,0,3,0,3,9,1
7025,187857,0wd79ct9K0tXadEnPdbTVwaGgB8OZiGG,5Gyp41oLVo7Gg7vF4vpmggWP5MU70QO6,4,2,1,0,1,0,2,0,6,0.8571428571428571,1,0.0,0,1,0,1,2,0,0,2,0,2,4,1
7026,187904,CXsyB1ZLXRIghLjiAkglC0ZPywZoViBf,5Gyp41oLVo7Gg7vF4vpmggWP5MU70QO6,16,19,13,0,4,6,13,1,56,8.0,1,0.0,2,13,0,4,17,6,0,13,1,19,37,1
7027,187926,1zhWSkL1LgbM9Ql0JYjCdksX2L8b6ju3,5Gyp41oLVo7Gg7vF4vpmggWP5MU70QO6,1,0,0,0,0,0,1,0,1,0.14285714285714285,1,0.0,0,0,0,0,0,0,0,1,0,0,1,1
7028,187932,FwweMXtSQjX7f97OVLsz3BQNG8M83X1n,5Gyp41oLVo7Gg7vF4vpmggWP5MU70QO6,5,2,1,0,1,0,2,0,6,0.8571428571428571,1,0.0,0,1,0,1,2,0,0,2,0,2,4,1
7029,187949,sb7hNSICYIB8DwdqmDVZhADtdsUmB6A8,5Gyp41oLVo7Gg7vF4vpmggWP5MU70QO6,4,2,1,0,1,0,2,0,6,0.8571428571428571,1,0.0,0,1,0,1,2,0,0,2,0,2,4,1
7030,187957,rkTpZfWEwpYaYW4DQ2jc028n8OL8yZxV,5Gyp41oLVo7Gg7vF4vpmggWP5MU70QO6,2,0,0,0,0,0,2,0,2,0.2857142857142857,1,0.0,0,0,0,0,0,0,0,2,0,0,2,1
7031,187974,jEi13xq4MqrYBERiBNsPcCHETD8jUjLz,5Gyp41oLVo7Gg7vF4vpmggWP5MU70QO6,12,8,6,0,3,0,4,0,21,3.0,1,0.0,0,6,0,3,8,0,0,4,0,9,12,1
7032,188034,EZ3Ou5LoxQTuPntDejOm1oOPtMjZiZw9,5Gyp41oLVo7Gg7vF4vpmggWP5MU70QO6,1,0,0,0,0,0,1,0,1,0.14285714285714285,1,0.0,0,0,0,0,0,0,0,1,0,0,1,1
7033,188042,LLPFOetEZAXeG8yuEAYd66ngAGbEUiF6,5Gyp41oLVo7Gg7vF4vpmggWP5MU70QO6,1,0,0,0,0,0,1,0,1,0.14285714285714285,1,0.0,0,0,0,0,0,0,0,1,0,0,1,1
7034,188057,OVHybOodwAI8dJTggwddA43nUNgwwGTK,5Gyp41oLVo7Gg7vF4vpmggWP5MU70QO6,15,13,8,0,5,0,1,0,27,3.857142857142857,1,0.0,4,8,0,5,9,0,0,1,0,17,10,1
7035,188059,LdFBcSrOERy4lkOWuGPkFS72yiaKyYyW,5Gyp41oLVo7Gg7vF4vpmggWP5MU70QO6,5,2,0,0,1,0,2,0,5,0.7142857142857143,1,0.0,0,0,0,1,2,0,0,2,0,1,4,1
7036,188066,eI5x3pfKI3nJIhgLZUUaCzO9j8tp1lJj,5Gyp41oLVo7Gg7vF4vpmggWP5MU70QO6,5,2,1,0,1,0,2,0,6,0.8571428571428571,1,0.0,0,1,0,1,2,0,0,2,0,2,4,1
7037,188079,vigCNwN0hx9Veb8D37LCQqqHmlPvVayo,5Gyp41oLVo7Gg7vF4vpmggWP5MU70QO6,14,16,9,9,4,0,3,0,41,5.857142857142857,1,0.0,4,9,6,4,12,0,3,3,0,23,18,1
7038,188082,jG3lTvAWrNAXi6KwS9dxU6MbGOx8WqRE,5Gyp41oLVo7Gg7vF4vpmggWP5MU70QO6,6,3,2,0,2,0,1,0,8,1.1428571428571428,1,0.0,0,2,0,2,3,0,0,1,0,4,4,1
7039,188667,aTM8g4rbVmgmqSlbdFoile3z2S6Tt4FV,3VkHkmOtom3jM2wCu94xgzzu1d6Dn7or,1,0,0,0,0,0,1,0,1,0.14285714285714285,1,0.0,0,0,0,0,0,0,0,1,0,0,1,1
7040,188678,sH2wlo6XXe7iJmjEIjVMN0eUnM6tyJrb,3VkHkmOtom3jM2wCu94xgzzu1d6Dn7or,4,2,1,0,1,0,1,0,5,0.7142857142857143,1,0.0,0,1,0,1,2,0,0,1,0,2,3,1
7041,188679,xMj985YGbnpmmaLLf9WHP3PHD8Af4HUa,3VkHkmOtom3jM2wCu94xgzzu1d6Dn7or,1,0,0,0,0,0,1,0,1,0.14285714285714285,1,0.0,0,0,0,0,0,0,0,1,0,0,1,1
7042,188689,ZlP72meXD3MdCpVYscW7cYVXmtXePojB,3VkHkmOtom3jM2wCu94xgzzu1d6Dn7or,4,2,0,0,0,0,2,0,4,0.5714285714285714,1,0.0,0,0,0,0,2,0,0,2,0,0,4,1
7043,188691,L5NduWAYcxynKXLIOf08sDGftk9wzQ6a,3VkHkmOtom3jM2wCu94xgzzu1d6Dn7or,7,7,4,0,2,0,3,0,16,2.2857142857142856,1,0.0,0,4,0,2,7,0,0,3,0,6,10,1
7044,188695,9O96GqJH5wK5Lu00wbAHcbR9RNQjfzP1,3VkHkmOtom3jM2wCu94xgzzu1d6Dn7or,7,2,1,0,1,1,4,0,9,1.2857142857142858,1,0.0,0,1,0,1,2,1,0,4,0,2,7,1
7045,188698,rjraeIoacuZJEw35Q8asy1sJ9D9vEPiU,3VkHkmOtom3jM2wCu94xgzzu1d6Dn7or,6,3,2,0,2,0,1,0,8,1.1428571428571428,1,0.0,0,2,0,2,3,0,0,1,0,4,4,1
7046,188710,splT3XbfuNvWu28Dz9nWIGEpMd1DYNNo,3VkHkmOtom3jM2wCu94xgzzu1d6Dn7or,1,0,0,0,0,0,1,0,1,0.14285714285714285,1,0.0,0,0,0,0,0,0,0,1,0,0,1,1
7047,188714,bRgauaxPr4eJDwen7ojFfhAEKTnn9yFa,3VkHkmOtom3jM2wCu94xgzzu1d6Dn7or,1,0,0,0,0,0,1,0,1,0.14285714285714285,1,0.0,0,0,0,0,0,0,0,1,0,0,1,1
7048,188719,Zcbku4ieBV7AjIPd5zWNQcljOJs6g3Xk,3VkHkmOtom3jM2wCu94xgzzu1d6Dn7or,4,2,0,0,0,0,2,0,4,0.5714285714285714,1,0.0,0,0,0,0,2,0,0,2,0,0,4,1
7049,188720,7mVnYRjKjtjH4lCP8tpUYIXKOYP4l6H9,3VkHkmOtom3jM2wCu94xgzzu1d6Dn7or,1,0,0,0,0,0,1,0,1,0.14285714285714285,1,0.0,0,0,0,0,0,0,0,1,0,0,1,1
7050,188726,rZc2RAebLP79KgIUARgq5IMQoQmvVjH0,3VkHkmOtom3jM2wCu94xgzzu1d6Dn7or,4,2,1,0,1,1,2,0,7,1.0,1,0.0,0,1,0,1,2,1,0,2,0,2,5,1
7051,188727,Rzuj7A1RYOdarZSozArynV32jCljcZEN,3VkHkmOtom3jM2wCu94xgzzu1d6Dn7or,1,0,0,0,0,0,2,0,2,0.2857142857142857,1,0.0,0,0,0,0,0,0,0,2,0,0,2,1
7052,188732,vBjMYxwVlP5OYa8uYuqiCgpy75HFIP5o,3VkHkmOtom3jM2wCu94xgzzu1d6Dn7or,1,0,0,0,0,0,1,0,1,0.14285714285714285,1,0.0,0,0,0,0,0,0,0,1,0,0,1,1
7053,188739,yWB3oqN8VRbhir0dM7XZbbGBMnznKciY,3VkHkmOtom3jM2wCu94xgzzu1d6Dn7or,5,2,1,0,1,0,3,0,7,1.0,2,0.0,0,1,0,1,2,0,0,3,0,2,5,1
7054,188744,RNarHXCsXWnc05ZCkRAoQLrCNIb9VXi5,3VkHkmOtom3jM2wCu94xgzzu1d6Dn7or,4,0,0,0,0,1,4,0,5,0.7142857142857143,1,0.0,0,0,0,0,0,1,0,4,0,0,5,1
7055,188745,RoQbop3klQZPIZTg1SEfKkCL3LxQQhrV,3VkHkmOtom3jM2wCu94xgzzu1d6Dn7or,6,1,1,0,1,0,5,0,8,1.1428571428571428,1,0.0,0,1,0,1,1,0,0,5,0,2,6,1
7056,188749,b1pOJDRxchXRoHUP49kKgMPNUJQLDSFZ,3VkHkmOtom3jM2wCu94xgzzu1d6Dn7or,10,6,4,0,3,0,3,0,16,2.2857142857142856,2,0.0,0,4,0,3,6,0,0,3,0,7,9,1
7057,188751,5tnLlHsyI6MqxnioivKTlNYEDjp4V4vl,3VkHkmOtom3jM2wCu94xgzzu1d6Dn7or,1,0,0,0,0,0,1,0,1,0.14285714285714285,1,0.0,0,0,0,0,0,0,0,1,0,0,1,1
7058,188752,LjklIQUhoK4K00yUFAEC0freV6RrtxfR,3VkHkmOtom3jM2wCu94xgzzu1d6Dn7or,1,0,0,0,0,0,1,0,1,0.14285714285714285,1,0.0,0,0,0,0,0,0,0,1,0,0,1,1
7059,188754,AWPvoaf0NtkyVV1p6r7SYTG5Gvv7rGNT,3VkHkmOtom3jM2wCu94xgzzu1d6Dn7or,1,0,0,0,0,0,1,0,1,0.14285714285714285,1,0.0,0,0,0,0,0,0,0,1,0,0,1,1
7060,188755,darIhG4UCSePcsT0dEJiHgaBq3otU8BD,3VkHkmOtom3jM2wCu94xgzzu1d6Dn7or,10,9,4,0,4,0,4,0,21,3.0,1,0.0,0,4,0,4,9,0,0,4,0,8,13,1
7061,188757,ulwzTcDf885NzrQCnoAeOKukwcIYM706,3VkHkmOtom3jM2wCu94xgzzu1d6Dn7or,1,0,0,0,0,0,2,0,2,0.2857142857142857,1,0.0,0,0,0,0,0,0,0,2,0,0,2,1
7062,188764,d29SpTzCOUSFg4yoYIxugcDveKRHlP4X,3VkHkmOtom3jM2wCu94xgzzu1d6Dn7or,1,0,0,0,0,0,2,0,2,0.2857142857142857,1,0.0,0,0,0,0,0,0,0,2,0,0,2,1
7063,188770,OOIu03NBEHePUSUIFa86FGFP5M136EAn,3VkHkmOtom3jM2wCu94xgzzu1d6Dn7or,4,2,1,0,1,0,1,0,5,0.7142857142857143,1,0.0,0,1,0,1,2,0,0,1,0,2,3,1
7064,188775,F8qH9FhQxX1wyTqzz3NU6nn0vfU0Riaf,3VkHkmOtom3jM2wCu94xgzzu1d6Dn7or,1,0,0,0,0,0,2,0,2,0.2857142857142857,1,0.0,0,0,0,0,0,0,0,2,0,0,2,0
7065,188777,y29CZe6BOX13f7fC7kXCzau5XL3ikH2J,3VkHkmOtom3jM2wCu94xgzzu1d6Dn7or,7,13,3,4,2,1,3,0,26,3.7142857142857144,1,0.0,5,3,3,2,8,1,1,3,0,13,13,1
7066,188778,xouPBfvCRjC5qv0HhQUKHIvhiPXfSbC9,3VkHkmOtom3jM2wCu94xgzzu1d6Dn7or,1,0,0,0,0,0,1,0,1,0.14285714285714285,1,0.0,0,0,0,0,0,0,0,1,0,0,1,1
7067,188787,UReFV1njNbexHxuOzGA2haECZtOzrAcs,3VkHkmOtom3jM2wCu94xgzzu1d6Dn7or,1,0,0,0,0,0,3,0,3,0.42857142857142855,1,0.0,0,0,0,0,0,0,0,3,0,0,3,1
7068,188792,m9kIF4xaVs2jU90mPDi3ysOgcd3rSMnE,3VkHkmOtom3jM2wCu94xgzzu1d6Dn7or,5,2,1,0,0,1,4,1,9,1.2857142857142858,1,0.0,0,1,0,0,2,1,0,4,1,1,8,1
7069,188793,rqoTUvotmiNzdNCmRA9XS33Bbc1NhTY9,3VkHkmOtom3jM2wCu94xgzzu1d6Dn7or,1,0,0,0,0,0,1,0,1,0.14285714285714285,1,0.0,0,0,0,0,0,0,0,1,0,0,1,1
7070,188799,yiJGRK3xKyZBczA9ZbC1g2ylL4nqHGee,3VkHkmOtom3jM2wCu94xgzzu1d6Dn7or,1,0,0,0,0,0,1,0,1,0.14285714285714285,1,0.0,0,0,0,0,0,0,0,1,0,0,1,1
7071,188807,l3nwiPsYiJl8Jihg077VE2FevaMxVbbu,3VkHkmOtom3jM2wCu94xgzzu1d6Dn7or,1,0,0,0,0,0,2,0,2,0.2857142857142857,1,0.0,0,0,0,0,0,0,0,2,0,0,2,0
7072,188840,td7Rsvww2Tt0cH9lZ6XoML9gQC1cSfIX,3VkHkmOtom3jM2wCu94xgzzu1d6Dn7or,1,0,0,0,0,0,1,0,1,0.14285714285714285,1,0.0,0,0,0,0,0,0,0,1,0,0,1,1
7073,188851,rcYKJ5kjivcqXxXUOJfTfslXTxt2wfkn,3VkHkmOtom3jM2wCu94xgzzu1d6Dn7or,4,2,1,0,0,0,3,0,6,0.8571428571428571,1,0.0,0,1,0,0,2,0,0,3,0,1,5,1
7074,188853,wtio4JmjBMuVClIbchDARr9kyIJKAWEa,3VkHkmOtom3jM2wCu94xgzzu1d6Dn7or,7,5,3,0,2,0,10,0,20,2.857142857142857,2,0.0,0,3,0,2,5,0,0,10,0,5,15,1
7075,188858,mH61okzOj3nEQ6Gv9aNpPBLjVL70RpBn,3VkHkmOtom3jM2wCu94xgzzu1d6Dn7or,1,0,0,0,0,0,1,0,1,0.14285714285714285,1,0.0,0,0,0,0,0,0,0,1,0,0,1,1
7076,188865,vp1rSNrizZff7tUEd2ybQWgYnsShgQzv,3VkHkmOtom3jM2wCu94xgzzu1d6Dn7or,7,2,1,0,1,0,8,2,14,2.0,1,0.0,0,1,0,1,2,0,0,8,2,2,12,1
7077,188869,qBJ5PlbiZTWOtW6qGRSzRxvflmQBdjbb,3VkHkmOtom3jM2wCu94xgzzu1d6Dn7or,1,0,0,0,0,0,1,0,1,0.14285714285714285,1,0.0,0,0,0,0,0,0,0,1,0,0,1,1
7078,188870,dAqrHPlMsXnPrglFnOZUeJrfWBb2qFZV,3VkHkmOtom3jM2wCu94xgzzu1d6Dn7or,1,0,0,0,0,0,1,0,1,0.14285714285714285,1,0.0,0,0,0,0,0,0,0,1,0,0,1,1
7079,188874,DJynUihFAWLqwBwk0pennAA3avYVlCnF,3VkHkmOtom3jM2wCu94xgzzu1d6Dn7or,5,0,0,0,0,1,5,1,7,1.0,1,0.0,0,0,0,0,0,1,0,5,1,0,7,1
7080,188879,BBWLa1LZvewDO9YK0u9Z0B5T3bzbyiLf,3VkHkmOtom3jM2wCu94xgzzu1d6Dn7or,1,0,0,0,0,0,1,0,1,0.14285714285714285,1,0.0,0,0,0,0,0,0,0,1,0,0,1,1
7081,188888,bj0WQuo9k1NIQkZ0EsnldydphhQRtUU6,3VkHkmOtom3jM2wCu94xgzzu1d6Dn7or,1,0,0,0,0,0,1,0,1,0.14285714285714285,1,0.0,0,0,0,0,0,0,0,1,0,0,1,1
7082,188892,YChfYjTEUmhFkScAd2qetCpOX19sz6WE,3VkHkmOtom3jM2wCu94xgzzu1d6Dn7or,4,2,0,0,1,0,1,0,4,0.5714285714285714,1,0.0,0,0,0,1,2,0,0,1,0,1,3,1
7083,188893,uErAtHHsF7lUzMfmcWuYTMcknda2v0F3,3VkHkmOtom3jM2wCu94xgzzu1d6Dn7or,4,2,0,0,0,0,2,0,4,0.5714285714285714,1,0.0,0,0,0,0,2,0,0,2,0,0,4,1
7084,188894,UygsTzsH7LWIOF2Htqvd4hLBNuIWqzyo,3VkHkmOtom3jM2wCu94xgzzu1d6Dn7or,7,13,3,0,0,0,8,4,28,4.0,1,0.0,0,3,0,0,13,0,0,8,4,3,25,1
7085,188895,aHOEE3Y86XSWbE1tAyDbE6Omr8cU9YfA,3VkHkmOtom3jM2wCu94xgzzu1d6Dn7or,1,0,0,0,0,0,1,0,1,0.14285714285714285,1,0.0,0,0,0,0,0,0,0,1,0,0,1,1
7086,188897,nZHDVGR2taFZ428UJIwMv53Rp94HbGnD,3VkHkmOtom3jM2wCu94xgzzu1d6Dn7or,9,5,3,0,2,4,10,1,25,3.5714285714285716,1,0.0,0,3,0,2,5,4,0,10,1,5,20,1
7087,188901,sq1wms76ewmJJMe5ABai2PQvpDuHzEFV,3VkHkmOtom3jM2wCu94xgzzu1d6Dn7or,5,4,1,0,1,0,1,0,7,1.0,1,0.0,0,1,0,1,4,0,0,1,0,2,5,1
7088,188902,U7T3zMiIGD6CAu6Tho01ck6PNG7rHFeb,3VkHkmOtom3jM2wCu94xgzzu1d6Dn7or,6,2,1,0,1,0,5,0,9,1.2857142857142858,1,0.0,0,1,0,1,2,0,0,5,0,2,7,1
7089,188903,GX8WUrDq59F3CPnzbsGBWLnaNb0wRVvg,3VkHkmOtom3jM2wCu94xgzzu1d6Dn7or,1,0,0,0,0,0,1,0,1,0.14285714285714285,1,0.0,0,0,0,0,0,0,0,1,0,0,1,1
7090,188909,C6CV9306M5utMUkPKkFqON6CMK7fT8vu,3VkHkmOtom3jM2wCu94xgzzu1d6Dn7or,5,2,1,0,1,0,2,0,6,0.8571428571428571,1,0.0,0,1,0,1,2,0,0,2,0,2,4,1
7091,188912,HqnHXfcoPap10Q0R8W8VaOhOdgU9xtH8,3VkHkmOtom3jM2wCu94xgzzu1d6Dn7or,10,43,11,0,0,6,12,0,72,10.285714285714286,1,0.0,12,11,0,0,31,6,0,12,0,23,49,1
7092,188915,2LmcdGGyubwVGXWuy0QUZiM05pluo5Uu,A3fsA9Zfv1X2fVEQhTw51lKENdNrEqT3,6,3,1,0,1,0,2,0,7,1.0,1,0.0,0,1,0,1,3,0,0,2,0,2,5,1
7093,188928,TJJeYBVqqJqVT0UpmMwKMknr7rLf2JfH,SpATywNh6bZuzm8s1ceuBUnMUAeoAHHw,4,2,0,0,0,0,2,0,4,0.5714285714285714,1,0.0,0,0,0,0,2,0,0,2,0,0,4,0
7094,188939,fwigvr5rkdA8owdUaAWu3mvJTkQAe70u,SpATywNh6bZuzm8s1ceuBUnMUAeoAHHw,27,34,14,21,7,2,7,1,86,12.285714285714286,1,0.0,19,14,18,7,15,2,3,7,1,58,28,1
7095,188956,LkRJ16T8XCnnHBkhkeRcewOdTN84VrPQ,SpATywNh6bZuzm8s1ceuBUnMUAeoAHHw,24,26,18,7,12,1,9,1,74,10.571428571428571,2,0.0,0,18,6,12,26,1,1,9,1,36,38,1
7096,188958,tkdlCe7V8Pa5PG46xexcM5NKFN2Osmho,SpATywNh6bZuzm8s1ceuBUnMUAeoAHHw,1,0,0,0,0,0,1,0,1,0.14285714285714285,1,0.0,0,0,0,0,0,0,0,1,0,0,1,1
7097,188982,a6vqrMhHKzyWidqZtHap3qGcKb3WEBch,5X6FeZozNMgE2VRi3MJYjkkFK8SETtu2,4,2,0,0,0,0,2,0,4,0.5714285714285714,1,0.0,0,0,0,0,2,0,0,2,0,0,4,1
7098,189014,k8okMXrxZcPMYpHTLdFHYiE4mVlekvm7,G8EPVSXsOYB5YQWZGiz1aVq5Pgr2GrQu,1,0,0,0,0,0,1,0,1,0.14285714285714285,1,0.0,0,0,0,0,0,0,0,1,0,0,1,1
7099,189026,T2tyjiaDe9s4tWUugE6FZTShWofnfMqo,A3fsA9Zfv1X2fVEQhTw51lKENdNrEqT3,6,5,0,0,0,0,3,0,8,1.1428571428571428,1,0.0,0,0,0,0,5,0,0,3,0,0,8,1
7100,189029,UcAhBIdVZpMELDlnTcMm9mzDJ1F9Jhg3,bWdj2GDclj5ofokWjzoa5jAwMkxCykd6,1,0,0,0,0,0,1,0,1,0.14285714285714285,1,0.0,0,0,0,0,0,0,0,1,0,0,1,1
7101,189031,EFGFzlNARADgFL4TG0kEwOZD1FUUWtee,SpATywNh6bZuzm8s1ceuBUnMUAeoAHHw,2,0,0,0,0,0,2,0,2,0.2857142857142857,1,0.0,0,0,0,0,0,0,0,2,0,0,2,1
7102,189035,JxaxaQTFSPBMnjiqX4WWqfIhdnR1vwXm,A3fsA9Zfv1X2fVEQhTw51lKENdNrEqT3,2,0,0,0,0,0,2,0,2,0.2857142857142857,1,0.0,0,0,0,0,0,0,0,2,0,0,2,1
7103,189055,orwxChSuq5ic7EHtUR6sECjEFNRwZzJm,A3fsA9Zfv1X2fVEQhTw51lKENdNrEqT3,5,4,1,0,0,2,3,0,10,1.4285714285714286,1,0.0,0,1,0,0,4,2,0,3,0,1,9,1
7104,189100,Cm9j8BFZp2zEHVq9X01HroWeJ3dkpIrl,A3fsA9Zfv1X2fVEQhTw51lKENdNrEqT3,7,4,1,0,1,0,2,0,8,1.1428571428571428,1,0.0,0,1,0,1,4,0,0,2,0,2,6,1
7105,189101,ArELmgPEmECqFMy1ajmS1kJdFsdtRbNE,SpATywNh6bZuzm8s1ceuBUnMUAeoAHHw,15,14,8,0,6,0,1,0,29,4.142857142857143,1,0.0,5,8,0,6,9,0,0,1,0,19,10,0
7106,189104,NumNFW5RaIHDi6n0KLy5Cf1kLDxHgZZ0,G8EPVSXsOYB5YQWZGiz1aVq5Pgr2GrQu,9,5,1,0,1,0,3,1,11,1.5714285714285714,1,0.0,0,1,0,1,5,0,0,3,1,2,9,1
7107,189144,eC4StSuQwImpW962lXYQQlRlP4Dxmsjm,5X6FeZozNMgE2VRi3MJYjkkFK8SETtu2,2,0,0,0,0,0,2,0,2,0.2857142857142857,1,0.0,0,0,0,0,0,0,0,2,0,0,2,1
7108,189166,LielUY2CViAshyTPFVeBFjcM9c8YHKw6,A3fsA9Zfv1X2fVEQhTw51lKENdNrEqT3,1,0,0,0,0,0,1,0,1,0.14285714285714285,1,0.0,0,0,0,0,0,0,0,1,0,0,1,1
7109,189176,Vve0UwhmiGWZN8bT2t4sC82sMWi2ZyY8,bWdj2GDclj5ofokWjzoa5jAwMkxCykd6,1,0,0,0,0,0,1,0,1,0.14285714285714285,1,0.0,0,0,0,0,0,0,0,1,0,0,1,1
7110,189204,eqcIPqJ4kM9TX6g3B8LCR2xTH3GBiOV4,bWdj2GDclj5ofokWjzoa5jAwMkxCykd6,10,21,2,0,3,1,8,0,35,5.0,1,0.0,7,2,0,3,14,1,0,8,0,12,23,0
7111,189221,8BLT2rbjNDvBkr2B6AQHpQ2yNooLf1CU,SpATywNh6bZuzm8s1ceuBUnMUAeoAHHw,14,22,11,11,0,3,3,1,51,7.285714285714286,1,0.0,7,11,10,0,15,3,1,3,1,28,23,1
7112,189224,V1EykxyqrSjJS8SrSU1L9A5qCk92mw9z,SpATywNh6bZuzm8s1ceuBUnMUAeoAHHw,1,0,0,0,0,0,1,0,1,0.14285714285714285,1,0.0,0,0,0,0,0,0,0,1,0,0,1,1
7113,189240,wtLaiBBHm4ZyQYh1Opif8R3gnmb4Cvts,SpATywNh6bZuzm8s1ceuBUnMUAeoAHHw,4,2,0,0,0,0,3,0,5,0.7142857142857143,1,0.0,0,0,0,0,2,0,0,3,0,0,5,1
7114,189248,VdLJh4DfNZNkgOb0QpZj77Lyif7Ai4W9,RXDvfPUBYFlVdlueBFbLW0mhhAyGEqpt,11,5,3,0,2,4,7,2,23,3.2857142857142856,1,0.0,0,3,0,2,5,4,0,7,2,5,18,1
7115,189261,0gEKH5fAOErqWMh035fBnqeaSHHzAI1h,SpATywNh6bZuzm8s1ceuBUnMUAeoAHHw,10,13,1,0,1,0,2,0,17,2.4285714285714284,1,0.0,0,1,0,1,13,0,0,2,0,2,15,1
7116,189296,6F27RWjto0oD6ZIVyhnSCbWEW4VbK6IA,SpATywNh6bZuzm8s1ceuBUnMUAeoAHHw,3,2,0,0,0,0,2,0,4,0.5714285714285714,1,0.0,0,0,0,0,2,0,0,2,0,0,4,1
7117,189307,WUH5fKgyK0ITY5YtWCIxwze8XvwwESM5,SpATywNh6bZuzm8s1ceuBUnMUAeoAHHw,1,0,0,0,0,0,1,0,1,0.14285714285714285,1,0.0,0,0,0,0,0,0,0,1,0,0,1,0
7118,189314,4D9TO74zb0mHkwi6G9vwCLqeflT8BNm5,A3fsA9Zfv1X2fVEQhTw51lKENdNrEqT3,2,0,0,0,0,0,2,0,2,0.2857142857142857,1,0.0,0,0,0,0,0,0,0,2,0,0,2,1
7119,189315,S17aPL792XOLE6jr4NEbeenFmW9zR5X6,G8EPVSXsOYB5YQWZGiz1aVq5Pgr2GrQu,5,5,1,0,2,0,2,0,10,1.4285714285714286,1,0.0,2,1,0,2,3,0,0,2,0,5,5,1
7120,189344,YWw2gZwiDNwUjZ7f1BeLAIZfUbRw3PAN,SpATywNh6bZuzm8s1ceuBUnMUAeoAHHw,1,0,0,0,0,0,1,0,1,0.14285714285714285,1,0.0,0,0,0,0,0,0,0,1,0,0,1,1
7121,189355,iNXUknYcsccIKS8GgjuItiXxtSErv2BI,5X6FeZozNMgE2VRi3MJYjkkFK8SETtu2,5,2,1,0,1,0,3,0,7,1.0,1,0.0,0,1,0,1,2,0,0,3,0,2,5,1
7122,189359,lezsrBjf0N9oe6E8V7oxUkPkJAqZJMFU,SpATywNh6bZuzm8s1ceuBUnMUAeoAHHw,29,41,15,51,8,18,3,0,136,19.428571428571427,1,0.0,23,15,44,8,18,18,7,3,0,90,46,1
7123,189392,qxH8TzH3Qy4v2W6mNWhfk8EgD86MOhcy,5X6FeZozNMgE2VRi3MJYjkkFK8SETtu2,6,16,6,0,5,0,1,0,28,4.0,1,0.0,9,6,0,5,7,0,0,1,0,20,8,0
7124,189411,pSOYMJsNqMeLYStOpMCnSgntzZEejN1H,SpATywNh6bZuzm8s1ceuBUnMUAeoAHHw,5,2,1,0,1,0,3,0,7,1.0,1,0.0,0,1,0,1,2,0,0,3,0,2,5,1
7125,189414,Fs7AuQHyElzq194Dj7MYCCNmslBhiNQY,SpATywNh6bZuzm8s1ceuBUnMUAeoAHHw,12,8,4,3,3,0,2,0,20,2.857142857142857,1,0.0,3,4,3,3,5,0,0,2,0,13,7,1
7126,189417,WhcQ2FUhqplSbWBB55CQvv33YcQFAk48,SpATywNh6bZuzm8s1ceuBUnMUAeoAHHw,7,4,2,0,2,0,2,0,10,1.4285714285714286,1,0.0,0,2,0,2,4,0,0,2,0,4,6,1
7127,189426,6F1lKjGTd159lFhX2roWh19Brj0u4Zbh,A3fsA9Zfv1X2fVEQhTw51lKENdNrEqT3,1,0,0,0,0,0,1,0,1,0.14285714285714285,1,0.0,0,0,0,0,0,0,0,1,0,0,1,1
7128,189428,zWECTl7pig27m6EXN2th2ITKXEX5E7bm,RXDvfPUBYFlVdlueBFbLW0mhhAyGEqpt,1,0,0,0,0,0,1,0,1,0.14285714285714285,1,0.0,0,0,0,0,0,0,0,1,0,0,1,1
7129,189469,zQBqlqVriI6RZpOMpudm8qiUGV6Qrl0L,SpATywNh6bZuzm8s1ceuBUnMUAeoAHHw,1,0,0,0,0,0,1,0,1,0.14285714285714285,1,0.0,0,0,0,0,0,0,0,1,0,0,1,1
7130,189483,XSd0vlKD52NpLLSqBdFFlVoviwsj4dHQ,SpATywNh6bZuzm8s1ceuBUnMUAeoAHHw,9,12,2,0,3,1,2,0,20,2.857142857142857,2,0.0,4,2,0,3,8,1,0,2,0,9,11,1
7131,189513,W44EUSPSAj1fZWLor5hD25joUoQF1Axq,A3fsA9Zfv1X2fVEQhTw51lKENdNrEqT3,6,4,1,0,1,0,1,0,7,1.0,1,0.0,0,1,0,1,4,0,0,1,0,2,5,1
7132,189517,9RPQjNQK3P9Ja7ZwojZIq3WA9I1ozBKB,SpATywNh6bZuzm8s1ceuBUnMUAeoAHHw,13,20,4,13,3,0,2,0,42,6.0,1,0.0,4,4,11,3,16,0,2,2,0,22,20,1
7133,189535,Xv0DoRVy2WPaq7NGSTl3PflvzGmHzjVJ,A3fsA9Zfv1X2fVEQhTw51lKENdNrEqT3,1,0,0,0,0,0,1,0,1,0.14285714285714285,1,0.0,0,0,0,0,0,0,0,1,0,0,1,1
7134,189564,0ARaDpddi8AQoUPzaSyC1U7MaF3V9mc5,SpATywNh6bZuzm8s1ceuBUnMUAeoAHHw,2,0,0,0,0,0,2,0,2,0.2857142857142857,1,0.0,0,0,0,0,0,0,0,2,0,0,2,1
7135,189570,BRlaUe6oMRYCNox0BajKnWHes3A3ujyM,A3fsA9Zfv1X2fVEQhTw51lKENdNrEqT3,4,3,1,0,0,0,2,0,6,0.8571428571428571,1,0.0,0,1,0,0,3,0,0,2,0,1,5,1
7136,189578,R1bxWlGh7IgBDoLkIUXA6O3TLQlfheKE,A3fsA9Zfv1X2fVEQhTw51lKENdNrEqT3,11,4,3,0,3,2,7,1,20,2.857142857142857,1,0.0,0,3,0,3,4,2,0,7,1,6,14,1
7137,189581,aU6SEeOgxLKetBRDwfHMDunWavvfr54M,bWdj2GDclj5ofokWjzoa5jAwMkxCykd6,1,0,0,0,0,0,1,0,1,0.14285714285714285,1,0.0,0,0,0,0,0,0,0,1,0,0,1,1
7138,189589,LeXQg2ZWiiKYpRH0t3zM93yLIzACb2NU,bWdj2GDclj5ofokWjzoa5jAwMkxCykd6,5,2,1,0,1,0,2,0,6,0.8571428571428571,1,0.0,0,1,0,1,2,0,0,2,0,2,4,1
7139,189604,w5CgC7bTQWAEvwLpFNtMT9iZ9U07da4R,SpATywNh6bZuzm8s1ceuBUnMUAeoAHHw,2,0,0,0,0,0,2,0,2,0.2857142857142857,1,0.0,0,0,0,0,0,0,0,2,0,0,2,1
7140,189616,iemTWWDkC6AhVJDU5o3Oh9sLScAldw3C,bWdj2GDclj5ofokWjzoa5jAwMkxCykd6,1,0,0,0,0,0,1,0,1,0.14285714285714285,1,0.0,0,0,0,0,0,0,0,1,0,0,1,1
7141,189634,vosSqm6sHHL9cDsr1jZBTefbeiLRlWcO,A3fsA9Zfv1X2fVEQhTw51lKENdNrEqT3,5,2,1,0,1,0,2,0,6,0.8571428571428571,1,0.0,0,1,0,1,2,0,0,2,0,2,4,1
7142,189637,GDIp2MOPceIb6QfEayZpWsXwU7IpnE1m,SpATywNh6bZuzm8s1ceuBUnMUAeoAHHw,4,2,0,0,0,0,2,0,4,0.5714285714285714,1,0.0,0,0,0,0,2,0,0,2,0,0,4,1
7143,189639,5qPjBVti4pvxDDFGs1UFTjnAG1OLcLcB,A3fsA9Zfv1X2fVEQhTw51lKENdNrEqT3,10,5,3,0,3,0,2,0,13,1.8571428571428572,1,0.0,0,3,0,3,5,0,0,2,0,6,7,1
7144,189647,0a9LRwLYq2zam4NcdU9Yh5C7IQvHBC1m,A3fsA9Zfv1X2fVEQhTw51lKENdNrEqT3,1,0,0,0,0,0,1,0,1,0.14285714285714285,1,0.0,0,0,0,0,0,0,0,1,0,0,1,1
7145,189697,3qxjUYnIYNKewMm8FEnsaaY7IZkJWvME,5X6FeZozNMgE2VRi3MJYjkkFK8SETtu2,1,0,0,0,0,0,1,0,1,0.14285714285714285,1,0.0,0,0,0,0,0,0,0,1,0,0,1,1
7146,189703,QI8v3mXYSOMc3klfons1psjYNmKqRAVM,A3fsA9Zfv1X2fVEQhTw51lKENdNrEqT3,2,0,0,0,0,0,4,0,4,0.5714285714285714,1,0.0,0,0,0,0,0,0,0,4,0,0,4,1
7147,189708,aK3nMtEDxGhnhy1C4yOyjUdvZihlJeoh,A3fsA9Zfv1X2fVEQhTw51lKENdNrEqT3,1,0,0,0,0,0,1,0,1,0.14285714285714285,1,0.0,0,0,0,0,0,0,0,1,0,0,1,1
7148,189712,T6EWQ7jVP89JlHzj41KN1gEtGYevpSQM,5X6FeZozNMgE2VRi3MJYjkkFK8SETtu2,1,0,0,0,0,0,1,0,1,0.14285714285714285,1,0.0,0,0,0,0,0,0,0,1,0,0,1,1
7149,189767,ZkfFwyK1OgVihBxVb6PuDCZttx0mY0GH,A3fsA9Zfv1X2fVEQhTw51lKENdNrEqT3,1,0,0,0,0,0,1,0,1,0.14285714285714285,1,0.0,0,0,0,0,0,0,0,1,0,0,1,1
7150,189777,i8UchDPQpO6cT8iNPbZCYc4wYFSv7DDx,A3fsA9Zfv1X2fVEQhTw51lKENdNrEqT3,9,6,3,0,4,0,7,0,20,2.857142857142857,1,0.0,0,3,0,4,6,0,0,7,0,7,13,0
7151,189797,yKVUx6ByOYe4vvSVP89s2ieWg1LfovnR,A3fsA9Zfv1X2fVEQhTw51lKENdNrEqT3,2,0,0,0,0,0,2,0,2,0.2857142857142857,1,0.0,0,0,0,0,0,0,0,2,0,0,2,1
7152,189809,h3uJUtBmEvmKgQr2Q8BC6FJ5GRugm894,A3fsA9Zfv1X2fVEQhTw51lKENdNrEqT3,24,4,2,72,0,4,9,0,91,13.0,1,0.0,2,2,59,0,2,4,13,9,0,63,28,1
7153,189814,SbMax8GBkfTumaOTkpcv6oaDlJ6SvOgc,A3fsA9Zfv1X2fVEQhTw51lKENdNrEqT3,71,76,38,0,32,0,1,0,147,21.0,1,0.0,5,38,0,32,71,0,0,1,0,75,72,1
7154,189870,BSHxCHMWX8I6UW8kFOVjbPaWq5D6kjuy,5X6FeZozNMgE2VRi3MJYjkkFK8SETtu2,18,33,0,22,11,0,1,0,67,9.571428571428571,1,0.0,25,0,17,11,8,0,5,1,0,53,14,1
7155,189885,EuByZSROH9lLZ2dnd4GXxahw8RdkgjTd,A3fsA9Zfv1X2fVEQhTw51lKENdNrEqT3,14,8,6,0,5,0,4,0,23,3.2857142857142856,1,0.0,0,6,0,5,8,0,0,4,0,11,12,1
7156,189905,H7bZ54NuzkB5Nw5q0ZI1nld9qDoHNngL,A3fsA9Zfv1X2fVEQhTw51lKENdNrEqT3,1,0,0,0,0,0,1,0,1,0.14285714285714285,1,0.0,0,0,0,0,0,0,0,1,0,0,1,1
7157,189945,AgRvWbkxdNzxJRN0PXihkXLvLsb4uQIe,A3fsA9Zfv1X2fVEQhTw51lKENdNrEqT3,1,0,0,0,0,0,2,0,2,0.2857142857142857,1,0.0,0,0,0,0,0,0,0,2,0,0,2,1
7158,189998,m7QOSCdmTCzPuCv2XL75peqogyn8U25P,A3fsA9Zfv1X2fVEQhTw51lKENdNrEqT3,1,0,0,0,0,0,1,0,1,0.14285714285714285,1,0.0,0,0,0,0,0,0,0,1,0,0,1,1
7159,190038,d5ntYWn3uMz5PPmk3AvSW9B6md5cTatS,5X6FeZozNMgE2VRi3MJYjkkFK8SETtu2,1,0,0,0,0,0,4,0,4,0.5714285714285714,1,0.0,0,0,0,0,0,0,0,4,0,0,4,1
7160,190060,tMNGYXIFQLxoZULQtNFAcBIfN5Bk8aTB,A3fsA9Zfv1X2fVEQhTw51lKENdNrEqT3,6,3,1,0,1,0,2,0,7,1.0,1,0.0,0,1,0,1,3,0,0,2,0,2,5,1
7161,190087,PihvdfGGc52TsY4zSIdQS0pOxHIYaXwm,5X6FeZozNMgE2VRi3MJYjkkFK8SETtu2,4,2,0,0,0,0,2,0,4,0.5714285714285714,1,0.0,0,0,0,0,2,0,0,2,0,0,4,1
7162,190111,SBDjqcJAy98nKfERlylEgYbif3PemxS8,A3fsA9Zfv1X2fVEQhTw51lKENdNrEqT3,7,4,1,0,1,0,2,0,8,1.1428571428571428,1,0.0,0,1,0,1,4,0,0,2,0,2,6,1
7163,190162,0D6hqHK4bxIFi4VUAoCI5xw3MhWFUe8Q,5X6FeZozNMgE2VRi3MJYjkkFK8SETtu2,1,0,0,0,0,0,1,0,1,0.14285714285714285,1,0.0,0,0,0,0,0,0,0,1,0,0,1,1
7164,190254,AA7aVbrpQJ2zUau6VJLFiC8rutvLHi1m,A3fsA9Zfv1X2fVEQhTw51lKENdNrEqT3,2,0,0,0,0,0,2,0,2,0.2857142857142857,1,0.0,0,0,0,0,0,0,0,2,0,0,2,1
7165,190260,FPU0FjwogBJWUFzSjAMeAixgRBEtWUQi,3VkHkmOtom3jM2wCu94xgzzu1d6Dn7or,1,0,0,0,0,0,1,0,1,0.14285714285714285,1,0.0,0,0,0,0,0,0,0,1,0,0,1,1
7166,190269,y1EuJtYnpVYfd8F8xgK5tkHJLKj7p6FS,3VkHkmOtom3jM2wCu94xgzzu1d6Dn7or,7,2,1,0,0,1,5,1,10,1.4285714285714286,1,0.0,0,1,0,0,2,1,0,5,1,1,9,1
7167,190302,iRYbwr9W1H6DYIBL51n44HsYl060IwS1,3VkHkmOtom3jM2wCu94xgzzu1d6Dn7or,1,0,0,0,0,0,2,0,2,0.2857142857142857,1,0.0,0,0,0,0,0,0,0,2,0,0,2,1
7168,190312,RJKpx6tNa7aoTd7Dq5omUo61ITI2lGfj,3VkHkmOtom3jM2wCu94xgzzu1d6Dn7or,2,0,0,0,0,0,2,0,2,0.2857142857142857,1,0.0,0,0,0,0,0,0,0,2,0,0,2,1
7169,190314,iHg8Id8i74Y8JXzsZVVzjwPwX7H1Yl2W,3VkHkmOtom3jM2wCu94xgzzu1d6Dn7or,5,6,3,0,2,0,2,0,13,1.8571428571428572,2,0.0,0,3,0,2,6,0,0,2,0,5,8,1
7170,190318,6v60lWWjEmdiDD5aePepNjhBVO7dpc3H,3VkHkmOtom3jM2wCu94xgzzu1d6Dn7or,1,0,0,0,0,0,1,0,1,0.14285714285714285,1,0.0,0,0,0,0,0,0,0,1,0,0,1,1
7171,190338,9nRMm1PA3GIKd2fFGQBMEaDBV01scEDf,3VkHkmOtom3jM2wCu94xgzzu1d6Dn7or,19,15,12,2,6,1,4,2,42,6.0,1,0.0,1,12,2,6,14,1,0,4,2,21,21,1
7172,190348,fh7ZqgEvblupIZ9gbXHWPWPg5ZbZYMBJ,3VkHkmOtom3jM2wCu94xgzzu1d6Dn7or,1,0,0,0,0,0,1,0,1,0.14285714285714285,1,0.0,0,0,0,0,0,0,0,1,0,0,1,1
7173,190351,tVCyYdomAGfUjkZNKBHMqBkEaPWuCBi2,3VkHkmOtom3jM2wCu94xgzzu1d6Dn7or,1,0,0,0,0,0,1,0,1,0.14285714285714285,1,0.0,0,0,0,0,0,0,0,1,0,0,1,1
7174,190375,YGxQDme0yci5ICjRYEy6Me4N0nnZ0g9H,3VkHkmOtom3jM2wCu94xgzzu1d6Dn7or,1,0,0,0,0,0,2,0,2,0.2857142857142857,1,0.0,0,0,0,0,0,0,0,2,0,0,2,1
7175,190385,H5zUL9xfz1fEoOcbR4FmFtG01oFL0kN2,3VkHkmOtom3jM2wCu94xgzzu1d6Dn7or,4,2,1,0,0,0,2,0,5,0.7142857142857143,1,0.0,0,1,0,0,2,0,0,2,0,1,4,1
7176,190390,ett4RSqrxzIV8EYuhd1Xe4BYirxYbVDx,3VkHkmOtom3jM2wCu94xgzzu1d6Dn7or,1,0,0,0,0,0,1,0,1,0.14285714285714285,1,0.0,0,0,0,0,0,0,0,1,0,0,1,1
7177,190396,pwfdkJeIkLiqUQGNzUx1pEX5wP825mQj,3VkHkmOtom3jM2wCu94xgzzu1d6Dn7or,6,2,1,0,1,0,3,0,7,1.0,1,0.0,0,1,0,1,2,0,0,3,0,2,5,1
7178,190422,QhYcOEapN0nrffEwA6S7jQzZwToRePP8,3VkHkmOtom3jM2wCu94xgzzu1d6Dn7or,1,0,0,0,0,0,1,0,1,0.14285714285714285,1,0.0,0,0,0,0,0,0,0,1,0,0,1,1
7179,190442,zEaDEiE5fac9Y3NT8JaitlDl9a7ILbFn,3VkHkmOtom3jM2wCu94xgzzu1d6Dn7or,2,0,0,0,0,0,2,0,2,0.2857142857142857,1,0.0,0,0,0,0,0,0,0,2,0,0,2,0
7180,190476,cRTomtLEROB1eaNXB5ZOtN4GQZr71pEL,3VkHkmOtom3jM2wCu94xgzzu1d6Dn7or,1,0,0,0,0,0,1,0,1,0.14285714285714285,1,0.0,0,0,0,0,0,0,0,1,0,0,1,1
7181,190494,1rPI5jPhWfm6V8JZPzv2QRjwb8MNdqfD,3VkHkmOtom3jM2wCu94xgzzu1d6Dn7or,5,5,1,0,1,0,2,0,9,1.2857142857142858,1,0.0,3,1,0,1,2,0,0,2,0,5,4,1
7182,190495,Sf3D8cErqs9DUAq0Pdl9EdinO2VNyspc,3VkHkmOtom3jM2wCu94xgzzu1d6Dn7or,6,2,1,0,1,0,7,0,11,1.5714285714285714,1,0.0,0,1,0,1,2,0,0,7,0,2,9,1
7183,190506,5VWGQewJqmIYi1Ik1BTl5hZ5SDvaKZYy,3VkHkmOtom3jM2wCu94xgzzu1d6Dn7or,2,0,0,0,0,0,2,0,2,0.2857142857142857,1,0.0,0,0,0,0,0,0,0,2,0,0,2,1
7184,190515,CcHGoKJpqBRdD4QQg44nMVlMI2t2Fpdm,3VkHkmOtom3jM2wCu94xgzzu1d6Dn7or,10,6,3,0,3,6,6,1,25,3.5714285714285716,1,0.0,0,3,0,3,6,6,0,6,1,6,19,1
7185,190553,lBQWW3wz0MqhTNb2ZYkj36Re3eW068si,3VkHkmOtom3jM2wCu94xgzzu1d6Dn7or,1,0,0,0,0,0,1,0,1,0.14285714285714285,1,0.0,0,0,0,0,0,0,0,1,0,0,1,1
7186,190575,LmecgoK4LtwGlXVk4sMRxfP8aYkIhIm1,3VkHkmOtom3jM2wCu94xgzzu1d6Dn7or,5,2,1,0,1,0,2,0,6,0.8571428571428571,2,0.0,0,1,0,1,2,0,0,2,0,2,4,1
7187,190613,7cqhc9pbFpFjRpzwiG6jM1Uoeo0Yvjlm,3VkHkmOtom3jM2wCu94xgzzu1d6Dn7or,1,0,0,0,0,0,1,0,1,0.14285714285714285,1,0.0,0,0,0,0,0,0,0,1,0,0,1,1
7188,190627,KZVYUX0K5z0mdYc6KiQ6PojuarFpgkXq,3VkHkmOtom3jM2wCu94xgzzu1d6Dn7or,1,0,0,0,0,0,1,0,1,0.14285714285714285,1,0.0,0,0,0,0,0,0,0,1,0,0,1,1
7189,190646,i3sXJ1o3wIKSeiueKBCqui2G08946p1M,3VkHkmOtom3jM2wCu94xgzzu1d6Dn7or,1,0,0,0,0,0,1,0,1,0.14285714285714285,1,0.0,0,0,0,0,0,0,0,1,0,0,1,0
7190,190667,FbSHedxpIyx1zxNDmX3MtyNonypZQZwK,3VkHkmOtom3jM2wCu94xgzzu1d6Dn7or,1,0,0,0,0,0,1,0,1,0.14285714285714285,1,0.0,0,0,0,0,0,0,0,1,0,0,1,1
7191,190694,9rioKXPzXXz4G8DVkVea9icy6ke5RJAY,3VkHkmOtom3jM2wCu94xgzzu1d6Dn7or,1,0,0,0,0,0,1,0,1,0.14285714285714285,1,0.0,0,0,0,0,0,0,0,1,0,0,1,1
7192,190706,n0ANfyYsFaoG5WIUnaVoMaXuxxDLkEbk,3VkHkmOtom3jM2wCu94xgzzu1d6Dn7or,1,0,0,0,0,0,1,0,1,0.14285714285714285,1,0.0,0,0,0,0,0,0,0,1,0,0,1,1
7193,192612,db5WgqPhrbqgj9ILL28Zz7dJymWXcTmf,5Gyp41oLVo7Gg7vF4vpmggWP5MU70QO6,6,4,2,0,3,0,1,0,10,1.4285714285714286,1,0.0,1,2,0,3,3,0,0,1,0,6,4,1
7194,192634,DLUoSYMNxFQ2JZq5aNI4WnqKHEvAL4iR,5Gyp41oLVo7Gg7vF4vpmggWP5MU70QO6,7,3,2,0,2,0,2,0,9,1.2857142857142858,1,0.0,0,2,0,2,3,0,0,2,0,4,5,1
7195,192673,n4M3KtYoeVmBGwZqRhMtailPtqxiFNvM,5Gyp41oLVo7Gg7vF4vpmggWP5MU70QO6,5,2,1,0,1,0,3,0,7,1.0,1,0.0,0,1,0,1,2,0,0,3,0,2,5,0
7196,192690,xUPmWxTSsgICosGfzeoEXWep7y1BlUbF,5Gyp41oLVo7Gg7vF4vpmggWP5MU70QO6,1,0,0,0,0,0,1,0,1,0.14285714285714285,1,0.0,0,0,0,0,0,0,0,1,0,0,1,1
7197,192711,WII37BmFoYIjNgFNtCbYIDPeE9zOv47P,5Gyp41oLVo7Gg7vF4vpmggWP5MU70QO6,6,3,1,0,1,0,2,0,7,1.0,1,0.0,0,1,0,1,3,0,0,2,0,2,5,1
7198,192720,sV8Z2WoHSkq80AVgpDh4TBiipVVqEZ0U,5Gyp41oLVo7Gg7vF4vpmggWP5MU70QO6,10,6,3,0,2,2,6,1,20,2.857142857142857,1,0.0,2,3,0,2,4,2,0,6,1,7,13,0
7199,192748,6VNnJJ4TaCdKjrqjqfj7OP1FN8TgmlZx,5Gyp41oLVo7Gg7vF4vpmggWP5MU70QO6,6,5,1,0,2,0,2,0,10,1.4285714285714286,1,0.0,2,1,0,2,3,0,0,2,0,5,5,1
7200,192769,fsmpK8LD6WXenVxwQRsdTaVF7iZvaL2a,5Gyp41oLVo7Gg7vF4vpmggWP5MU70QO6,1,0,0,0,0,0,1,0,1,0.14285714285714285,1,0.0,0,0,0,0,0,0,0,1,0,0,1,1
7201,192775,h7zakr8SYSWro2uSacwrnlrgLZRsJAp8,5Gyp41oLVo7Gg7vF4vpmggWP5MU70QO6,1,0,0,0,0,0,1,0,1,0.14285714285714285,1,0.0,0,0,0,0,0,0,0,1,0,0,1,1
7202,192776,evrdwGhLAFWdgr0Clw2EFTM91w358eNP,5Gyp41oLVo7Gg7vF4vpmggWP5MU70QO6,1,0,0,0,0,0,1,0,1,0.14285714285714285,1,0.0,0,0,0,0,0,0,0,1,0,0,1,1
7203,192787,0bUXSF08LRKDrVerYGdbNNCRev5JedUi,5Gyp41oLVo7Gg7vF4vpmggWP5MU70QO6,12,7,5,0,4,1,4,0,21,3.0,1,0.0,0,5,0,4,7,1,0,4,0,9,12,1
7204,192792,irKkgWRUKv49jC7s6aHyZzH6m4GOBvj9,5Gyp41oLVo7Gg7vF4vpmggWP5MU70QO6,8,3,2,0,1,3,5,1,15,2.142857142857143,1,0.0,0,2,0,1,3,3,0,5,1,3,12,1
7205,192795,Qr56xJpKpx3PDtASRPf6XQoHmcGp3CKT,5Gyp41oLVo7Gg7vF4vpmggWP5MU70QO6,1,0,0,0,0,0,1,0,1,0.14285714285714285,1,0.0,0,0,0,0,0,0,0,1,0,0,1,1
7206,192798,7TbPOgQeqKxGhL5FETq1KXoyVDxkmhqf,5Gyp41oLVo7Gg7vF4vpmggWP5MU70QO6,9,10,1,0,0,0,6,1,18,2.5714285714285716,1,0.0,0,1,0,0,10,0,0,6,1,1,17,1
7207,192829,zqttlX0xeafyYu24Jt1h1c3dNmT1HiFC,5Gyp41oLVo7Gg7vF4vpmggWP5MU70QO6,2,0,0,0,0,0,2,0,2,0.2857142857142857,1,0.0,0,0,0,0,0,0,0,2,0,0,2,1
7208,192833,Hck0wChL86T7abzSrVcQpZ8hTWtosfXi,5Gyp41oLVo7Gg7vF4vpmggWP5MU70QO6,9,8,5,2,3,0,2,0,20,2.857142857142857,1,0.0,2,5,1,3,6,0,1,2,0,11,9,1
7209,192840,yrQAfD3ZnjZwlSwqGP3wxDAQpIia9vdY,5Gyp41oLVo7Gg7vF4vpmggWP5MU70QO6,4,2,1,0,1,0,2,0,6,0.8571428571428571,1,0.0,0,1,0,1,2,0,0,2,0,2,4,1
7210,192845,uNfKRPlxZfk1Bc9EZEEUlymSMEcLJL9L,5Gyp41oLVo7Gg7vF4vpmggWP5MU70QO6,4,2,1,0,0,0,2,0,5,0.7142857142857143,1,0.0,0,1,0,0,2,0,0,2,0,1,4,1
7211,192867,oeoxZo8En0mbPMY65RbcLH1DMoOBjdc7,5Gyp41oLVo7Gg7vF4vpmggWP5MU70QO6,9,17,4,0,4,0,2,0,27,3.857142857142857,1,0.0,0,4,0,4,17,0,0,2,0,8,19,1
7212,192887,SjjWcqrMCT8lboQ8wTyc2EHHc8C5Iiu7,5Gyp41oLVo7Gg7vF4vpmggWP5MU70QO6,2,0,0,0,0,0,2,0,2,0.2857142857142857,1,0.0,0,0,0,0,0,0,0,2,0,0,2,1
7213,192888,Mui53ZJj4fcTfsQUEi2bGhqknX4URISh,5Gyp41oLVo7Gg7vF4vpmggWP5MU70QO6,1,0,0,0,0,0,1,0,1,0.14285714285714285,1,0.0,0,0,0,0,0,0,0,1,0,0,1,1
7214,192897,idXOfa0UbHb2LgeTVNs25uJI6fFlL5At,5Gyp41oLVo7Gg7vF4vpmggWP5MU70QO6,2,0,0,0,0,0,2,0,2,0.2857142857142857,1,0.0,0,0,0,0,0,0,0,2,0,0,2,1
7215,192911,OfhCijoP0ZzvUzP2bFEF0mClPkmO92rU,5Gyp41oLVo7Gg7vF4vpmggWP5MU70QO6,7,3,2,0,2,0,2,0,9,1.2857142857142858,1,0.0,0,2,0,2,3,0,0,2,0,4,5,1
7216,192937,ujMqpxku4NSt0Wfta8V9ix1DgUcSpA6x,5Gyp41oLVo7Gg7vF4vpmggWP5MU70QO6,1,0,0,0,0,0,2,0,2,0.2857142857142857,1,0.0,0,0,0,0,0,0,0,2,0,0,2,1
7217,192948,IA3DXrRHbGqcPE8YntwXU3NYDZWBtMkD,5Gyp41oLVo7Gg7vF4vpmggWP5MU70QO6,2,0,0,0,0,0,2,0,2,0.2857142857142857,1,0.0,0,0,0,0,0,0,0,2,0,0,2,0
7218,192950,3U6KXt42y6FXXGo0GSzuDgsIRbrKRXyc,5Gyp41oLVo7Gg7vF4vpmggWP5MU70QO6,1,0,0,0,0,0,1,0,1,0.14285714285714285,1,0.0,0,0,0,0,0,0,0,1,0,0,1,1
7219,192962,p6mKHr5aRUQ8rsAM1ROUYWdXYBjQ7P7e,5Gyp41oLVo7Gg7vF4vpmggWP5MU70QO6,8,10,2,0,2,0,1,0,15,2.142857142857143,1,0.0,0,2,0,2,10,0,0,1,0,4,11,1
7220,192975,PIsLLpnsV9nrkg4TDwm54OVXzabsrTGs,5Gyp41oLVo7Gg7vF4vpmggWP5MU70QO6,5,2,1,0,0,0,3,1,7,1.0,1,0.0,0,1,0,0,2,0,0,3,1,1,6,1
7221,193009,SaCuUEx4yVWy7KEZ7c1LumXyYr79w4Rm,5Gyp41oLVo7Gg7vF4vpmggWP5MU70QO6,10,7,3,0,2,0,10,1,23,3.2857142857142856,1,0.0,1,3,0,2,6,0,0,10,1,6,17,1
7222,193391,Nj4h6U82iZbXhwqv4yzJTbTvwrq7ssZF,7GRhBDsirIGkRZBtSMEzNTyDr2JQm4xx,1,0,0,0,0,0,1,0,1,0.14285714285714285,1,0.0,0,0,0,0,0,0,0,1,0,0,1,1
7223,193411,5n7LHcPXoY0VQSveRQkdV1m8S1A4dqOZ,7GRhBDsirIGkRZBtSMEzNTyDr2JQm4xx,1,0,0,0,0,0,1,0,1,0.14285714285714285,1,0.0,0,0,0,0,0,0,0,1,0,0,1,1
7224,193413,RyJBTIZudHI18CHfqwWV9lrFHUkffvwx,7GRhBDsirIGkRZBtSMEzNTyDr2JQm4xx,6,2,1,0,1,0,3,0,7,1.0,1,0.0,0,1,0,1,2,0,0,3,0,2,5,0
7225,193418,SVf0SC9Fgx76juSVltwPFVkOfd5kIODF,7GRhBDsirIGkRZBtSMEzNTyDr2JQm4xx,2,0,0,0,0,0,2,0,2,0.2857142857142857,1,0.0,0,0,0,0,0,0,0,2,0,0,2,1
7226,193425,fp5rkOav6sQ2B0u2StsAV5mj6jUgMf4H,7GRhBDsirIGkRZBtSMEzNTyDr2JQm4xx,15,18,8,0,5,0,10,0,41,5.857142857142857,2,0.0,7,8,0,5,11,0,0,10,0,20,21,1
7227,193432,qtMwEGTQkwmsGD2BFQVyNlbYllHBhi9y,7GRhBDsirIGkRZBtSMEzNTyDr2JQm4xx,10,7,1,0,1,0,2,0,11,1.5714285714285714,1,0.0,0,1,0,1,7,0,0,2,0,2,9,1
7228,193439,HhFzRGJNOKJeEtotgjejPm9oQpRfjChn,7GRhBDsirIGkRZBtSMEzNTyDr2JQm4xx,1,0,0,0,0,0,2,0,2,0.2857142857142857,1,0.0,0,0,0,0,0,0,0,2,0,0,2,1
7229,193442,cZuRrLbkJ49uRRQDd7INWq8WLolfeTSw,7GRhBDsirIGkRZBtSMEzNTyDr2JQm4xx,1,0,0,0,0,0,1,0,1,0.14285714285714285,1,0.0,0,0,0,0,0,0,0,1,0,0,1,1
7230,193451,OUhmXCQX6q2wXNYlJfg8VMHiBpb32Qjg,7GRhBDsirIGkRZBtSMEzNTyDr2JQm4xx,8,10,3,0,3,0,2,0,18,2.5714285714285716,1,0.0,0,3,0,3,10,0,0,2,0,6,12,0
7231,193648,0lEKKJq7wgGTJZ13dxv0HcjHfYwzJrxA,5X6FeZozNMgE2VRi3MJYjkkFK8SETtu2,1,0,0,0,0,0,1,0,1,0.14285714285714285,1,0.0,0,0,0,0,0,0,0,1,0,0,1,1
7232,193710,mS4pmtwcndXVt9jKYDUH076p6bBZMe2Y,5X6FeZozNMgE2VRi3MJYjkkFK8SETtu2,5,2,1,0,1,0,2,0,6,0.8571428571428571,1,0.0,0,1,0,1,2,0,0,2,0,2,4,1
7233,194058,UasrjB6Lz57MSXiyP9hy734A5ulOXRm3,5X6FeZozNMgE2VRi3MJYjkkFK8SETtu2,6,1,1,0,1,0,3,0,6,0.8571428571428571,1,0.0,0,1,0,1,1,0,0,3,0,2,4,1
7234,194069,RGBg5OBpyocoeZ6vgulRvdHAe4GhCDz5,5X6FeZozNMgE2VRi3MJYjkkFK8SETtu2,1,0,0,0,0,0,1,0,1,0.14285714285714285,1,0.0,0,0,0,0,0,0,0,1,0,0,1,1
7235,194139,r0yAsNzYkqEPYi6zNhQfzuueDjmcyFRr,5X6FeZozNMgE2VRi3MJYjkkFK8SETtu2,1,0,0,0,0,0,1,0,1,0.14285714285714285,1,0.0,0,0,0,0,0,0,0,1,0,0,1,1
7236,194153,5jJlZ63WvPN0vjGcWOkJ1QjGnKioIAQM,5X6FeZozNMgE2VRi3MJYjkkFK8SETtu2,3,3,0,0,0,0,1,0,4,0.5714285714285714,1,0.0,0,0,0,0,3,0,0,1,0,0,4,1
7237,194362,NSeMeg6h5JDvAoSbt1mktNuQe2nQivm2,5X6FeZozNMgE2VRi3MJYjkkFK8SETtu2,26,18,6,30,3,0,3,0,60,8.571428571428571,1,0.0,9,6,29,3,9,0,1,3,0,47,13,1
7238,194475,EUmZ5qzjwgko2PIWEnctkvYh7APnUrX9,5X6FeZozNMgE2VRi3MJYjkkFK8SETtu2,1,0,0,0,0,0,1,0,1,0.14285714285714285,1,0.0,0,0,0,0,0,0,0,1,0,0,1,1
7239,194682,fOtwdZktYnpxoylqFRzXhWQ4IRQZkjMB,A3fsA9Zfv1X2fVEQhTw51lKENdNrEqT3,5,3,2,0,1,0,1,0,7,1.0,1,0.0,0,2,0,1,3,0,0,1,0,3,4,1
7240,195588,W0l0kkHKvJN0FIadhzrU1LfDb4EzwebA,5X6FeZozNMgE2VRi3MJYjkkFK8SETtu2,2,0,0,0,0,0,3,0,3,0.42857142857142855,1,0.0,0,0,0,0,0,0,0,3,0,0,3,1
7241,195650,juzfwxHXCKii6ul7funGUBQbDVPCyrBB,5X6FeZozNMgE2VRi3MJYjkkFK8SETtu2,1,0,0,0,0,0,1,0,1,0.14285714285714285,1,0.0,0,0,0,0,0,0,0,1,0,0,1,1
7242,195684,bLcbvKDRM6lji8wmeDJkPOBB2b9eyXBH,5X6FeZozNMgE2VRi3MJYjkkFK8SETtu2,1,0,0,0,0,0,1,0,1,0.14285714285714285,1,0.0,0,0,0,0,0,0,0,1,0,0,1,1
7243,195722,pXGBcTffNYWAUeYw1RFCIuTgQsIvI4OJ,5X6FeZozNMgE2VRi3MJYjkkFK8SETtu2,5,2,1,0,1,0,2,0,6,0.8571428571428571,1,0.0,0,1,0,1,2,0,0,2,0,2,4,1
7244,195775,P1HfpLPKTOaNYsIahqDQlk4Js6s95Iqe,5X6FeZozNMgE2VRi3MJYjkkFK8SETtu2,1,0,0,0,0,0,1,0,1,0.14285714285714285,1,0.0,0,0,0,0,0,0,0,1,0,0,1,1
7245,195776,8FprsZIzUCPJ79Vm84XE1F16D42ydNJH,5X6FeZozNMgE2VRi3MJYjkkFK8SETtu2,1,0,0,0,0,0,1,0,1,0.14285714285714285,1,0.0,0,0,0,0,0,0,0,1,0,0,1,1
7246,196258,84Vtl9WYpWByLNGFNOb9qCQNJXmBTqXr,bWdj2GDclj5ofokWjzoa5jAwMkxCykd6,1,0,0,0,0,0,3,0,3,0.42857142857142855,1,0.0,0,0,0,0,0,0,0,3,0,0,3,1
7247,196262,cLn3Dpp0aQbPutL8r0rwRDwKL8qRpPtI,G8EPVSXsOYB5YQWZGiz1aVq5Pgr2GrQu,8,6,0,0,1,0,1,0,8,1.1428571428571428,1,0.0,0,0,0,1,6,0,0,1,0,1,7,1
7248,196269,haLWbgznwe0aHmDz0IMvty9PTNybgUSv,SpATywNh6bZuzm8s1ceuBUnMUAeoAHHw,1,0,0,0,0,0,1,0,1,0.14285714285714285,1,0.0,0,0,0,0,0,0,0,1,0,0,1,1
7249,196282,tiAmX1K64h27ePNFGBqIfOBXXekJTi6c,SpATywNh6bZuzm8s1ceuBUnMUAeoAHHw,36,80,24,20,14,0,3,0,141,20.142857142857142,1,0.0,15,24,20,14,65,0,0,3,0,73,68,1
7250,196300,dDrnWkPOwheElmX20c1gnDUNBZ1InueN,SpATywNh6bZuzm8s1ceuBUnMUAeoAHHw,1,0,0,0,0,0,1,0,1,0.14285714285714285,1,0.0,0,0,0,0,0,0,0,1,0,0,1,1
7251,196305,UAQ3dboSsAg7pJwESQdTYyBThwTnTM7A,SpATywNh6bZuzm8s1ceuBUnMUAeoAHHw,8,9,6,0,3,0,2,0,20,2.857142857142857,1,0.0,0,6,0,3,9,0,0,2,0,9,11,0
7252,196306,X6Lezij464ccKeng4uwKJTPF9kfTAT6Z,SpATywNh6bZuzm8s1ceuBUnMUAeoAHHw,31,51,21,0,14,0,12,0,98,14.0,1,0.0,0,21,0,14,51,0,0,12,0,35,63,1
7253,196307,X6Lezij464ccKeng4uwKJTPF9kfTAT6Z,RXDvfPUBYFlVdlueBFbLW0mhhAyGEqpt,49,71,35,0,20,4,9,0,139,19.857142857142858,1,0.0,1,35,0,20,70,4,0,9,0,56,83,1
7254,196336,F8NourXmuPtch9jRX8wdUzHLenRNVyCk,SpATywNh6bZuzm8s1ceuBUnMUAeoAHHw,2,0,0,0,0,0,2,0,2,0.2857142857142857,1,0.0,0,0,0,0,0,0,0,2,0,0,2,1
7255,196451,NxxDPJKBrjin9P0mTarKicUlILWB39Ed,A3fsA9Zfv1X2fVEQhTw51lKENdNrEqT3,9,4,3,0,3,0,3,0,13,1.8571428571428572,1,0.0,0,3,0,3,4,0,0,3,0,6,7,1
7256,196471,pCnoO6udDE2lNvhk435CUTW5xV3lxyMY,SpATywNh6bZuzm8s1ceuBUnMUAeoAHHw,17,32,2,22,2,11,10,1,80,11.428571428571429,1,0.0,13,2,17,2,19,11,5,10,1,34,46,0
7257,196493,akSMeLHCyBB67hfZDkn0NDR7Yy6L2FBq,5X6FeZozNMgE2VRi3MJYjkkFK8SETtu2,1,0,0,0,0,0,1,0,1,0.14285714285714285,1,0.0,0,0,0,0,0,0,0,1,0,0,1,1
7258,196507,AQ1HoOz5Jszv3gSTSyYNhVdJQFocvCtg,SpATywNh6bZuzm8s1ceuBUnMUAeoAHHw,1,0,0,0,0,0,1,0,1,0.14285714285714285,1,0.0,0,0,0,0,0,0,0,1,0,0,1,1
7259,196513,5pSf6XO1vHmSL6ykl0l21eWE2uvRzMTK,5X6FeZozNMgE2VRi3MJYjkkFK8SETtu2,1,0,0,0,0,0,1,0,1,0.14285714285714285,1,0.0,0,0,0,0,0,0,0,1,0,0,1,1
7260,196536,qCS4l8ob3EJw4urGwrYd9lZ7UNzXvZIE,SpATywNh6bZuzm8s1ceuBUnMUAeoAHHw,1,0,0,0,0,0,1,0,1,0.14285714285714285,1,0.0,0,0,0,0,0,0,0,1,0,0,1,1
7261,196565,YqxhOSST3QFN8TGdKOnOvd7Qo3x5cybT,SpATywNh6bZuzm8s1ceuBUnMUAeoAHHw,5,2,1,0,1,0,2,0,6,0.8571428571428571,1,0.0,0,1,0,1,2,0,0,2,0,2,4,1
7262,196595,3vnu5JUiIQfwcWSSeAtE6dAgHCr6iqRo,G8EPVSXsOYB5YQWZGiz1aVq5Pgr2GrQu,1,0,0,0,0,0,1,0,1,0.14285714285714285,1,0.0,0,0,0,0,0,0,0,1,0,0,1,1
7263,196596,3vnu5JUiIQfwcWSSeAtE6dAgHCr6iqRo,A3fsA9Zfv1X2fVEQhTw51lKENdNrEqT3,2,0,0,0,0,0,2,0,2,0.2857142857142857,1,0.0,0,0,0,0,0,0,0,2,0,0,2,1
7264,196601,3nd0w9cZzH1zDSzYM8nVIRaV4Lm6kaLu,G8EPVSXsOYB5YQWZGiz1aVq5Pgr2GrQu,8,4,3,0,2,0,2,0,11,1.5714285714285714,1,0.0,0,3,0,2,4,0,0,2,0,5,6,1
7265,196614,ajdXJNtmFj3djCMALYMagt4EstfNGU3t,A3fsA9Zfv1X2fVEQhTw51lKENdNrEqT3,7,3,2,0,2,0,3,0,10,1.4285714285714286,1,0.0,0,2,0,2,3,0,0,3,0,4,6,1
7266,196623,MTBFJm3bIEaE6OQdIPJiDEIIoJhDDIeA,bWdj2GDclj5ofokWjzoa5jAwMkxCykd6,2,0,0,0,0,0,5,0,5,0.7142857142857143,1,0.0,0,0,0,0,0,0,0,5,0,0,5,1
7267,196632,dO8ttSgZeYstM22uaeoinK9ApzwNbtvt,bWdj2GDclj5ofokWjzoa5jAwMkxCykd6,1,0,0,0,0,0,1,0,1,0.14285714285714285,1,0.0,0,0,0,0,0,0,0,1,0,0,1,1
7268,196657,Z5hJjHEs9vVOECSboB00kryTTWAg0llD,A3fsA9Zfv1X2fVEQhTw51lKENdNrEqT3,8,2,1,0,1,0,8,2,14,2.0,1,0.0,0,1,0,1,2,0,0,8,2,2,12,1
7269,196672,fGQQbYTikGmxkwGX9ObcXKMW9Jbs5Gag,SpATywNh6bZuzm8s1ceuBUnMUAeoAHHw,8,9,1,0,1,0,3,0,14,2.0,1,0.0,3,1,0,1,6,0,0,3,0,5,9,1
7270,196692,UcZBtTCWAGtCSktUpbQvdWSPIBBv8Gr5,SpATywNh6bZuzm8s1ceuBUnMUAeoAHHw,12,10,1,17,0,0,3,0,31,4.428571428571429,1,0.0,2,1,16,0,8,0,1,3,0,19,12,0
7271,196695,bLDIg7orV5sh30oIBmQ342IswZTJ8Q5l,SpATywNh6bZuzm8s1ceuBUnMUAeoAHHw,9,6,4,0,2,0,4,0,16,2.2857142857142856,1,0.0,0,4,0,2,6,0,0,4,0,6,10,1
7272,196701,xqjSceutXm0Ow6i5RJNNfbOkv3g0VYZN,G8EPVSXsOYB5YQWZGiz1aVq5Pgr2GrQu,1,0,0,0,0,0,1,0,1,0.14285714285714285,1,0.0,0,0,0,0,0,0,0,1,0,0,1,1
7273,196705,bZa2cKnNlVdaH2zh1KBEDwy94lOurAbl,A3fsA9Zfv1X2fVEQhTw51lKENdNrEqT3,6,4,2,0,1,0,2,0,9,1.2857142857142858,1,0.0,0,2,0,1,4,0,0,2,0,3,6,1
7274,196710,7gxdF7npc77h7z0KnU9ezGYqtBJqY4fQ,SpATywNh6bZuzm8s1ceuBUnMUAeoAHHw,7,2,1,0,1,0,6,0,10,1.4285714285714286,1,0.0,0,1,0,1,2,0,0,6,0,2,8,0
7275,196731,Pdvh6UTK9FXuCE4WVrV5Y121aJBdVbkt,A3fsA9Zfv1X2fVEQhTw51lKENdNrEqT3,47,26,19,42,11,6,6,2,112,16.0,1,0.0,3,19,40,11,23,6,2,6,2,73,39,1
7276,196733,uezUPAEnUXcq0NFGSBeQpbbQT3cqmDAT,SpATywNh6bZuzm8s1ceuBUnMUAeoAHHw,6,7,2,0,2,0,4,0,15,2.142857142857143,1,0.0,0,2,0,2,7,0,0,4,0,4,11,1
7277,196737,oOZsAqJaDOJSFMbRG35wrloFbTEIc8dR,5X6FeZozNMgE2VRi3MJYjkkFK8SETtu2,2,0,0,0,0,0,2,0,2,0.2857142857142857,1,0.0,0,0,0,0,0,0,0,2,0,0,2,1
7278,196742,6OBDZBJWfzsxgHkTnhPzN431QvCxfANm,SpATywNh6bZuzm8s1ceuBUnMUAeoAHHw,8,6,3,0,2,0,3,0,14,2.0,1,0.0,0,3,0,2,6,0,0,3,0,5,9,1
7279,196780,RthO8kTkOrnZ3vUDn574hHyfG3vroBt1,SpATywNh6bZuzm8s1ceuBUnMUAeoAHHw,36,25,23,8,17,0,10,0,83,11.857142857142858,1,0.0,0,23,6,17,25,0,2,10,0,46,37,1
7280,196806,bxQOsXuG5NC6VnG6YiODH6WuXuneq0dF,SpATywNh6bZuzm8s1ceuBUnMUAeoAHHw,5,2,1,0,1,0,2,0,6,0.8571428571428571,1,0.0,0,1,0,1,2,0,0,2,0,2,4,1
7281,196809,5O3ZOoVLu7tCWnWkJSW2V8ftVrXqVxvg,A3fsA9Zfv1X2fVEQhTw51lKENdNrEqT3,7,4,1,0,1,0,4,0,10,1.4285714285714286,1,0.0,0,1,0,1,4,0,0,4,0,2,8,1
7282,196823,RthO8kTkOrnZ3vUDn574hHyfG3vroBt1,bWdj2GDclj5ofokWjzoa5jAwMkxCykd6,1,0,0,0,0,0,1,0,1,0.14285714285714285,1,0.0,0,0,0,0,0,0,0,1,0,0,1,1
7283,196824,RthO8kTkOrnZ3vUDn574hHyfG3vroBt1,5X6FeZozNMgE2VRi3MJYjkkFK8SETtu2,1,0,0,0,0,0,1,0,1,0.14285714285714285,1,0.0,0,0,0,0,0,0,0,1,0,0,1,1
7284,196844,5qqD2T2EPDkmG2MZPytXSe6fK2Jo7BmS,SpATywNh6bZuzm8s1ceuBUnMUAeoAHHw,1,0,0,0,0,0,1,0,1,0.14285714285714285,1,0.0,0,0,0,0,0,0,0,1,0,0,1,1
7285,196846,OYWBopBO2n38CA6GRAaDJRfIHV9b0dQs,5X6FeZozNMgE2VRi3MJYjkkFK8SETtu2,1,0,0,0,0,0,1,0,1,0.14285714285714285,1,0.0,0,0,0,0,0,0,0,1,0,0,1,1
7286,196853,lCyf3TRKW0i3K1mBgKz23OONMdCWqNsI,A3fsA9Zfv1X2fVEQhTw51lKENdNrEqT3,1,0,0,0,0,0,1,0,1,0.14285714285714285,1,0.0,0,0,0,0,0,0,0,1,0,0,1,1
7287,196870,KnW2kJ7r9bHFOiSNCXRF5RLyLQjhYTtF,SpATywNh6bZuzm8s1ceuBUnMUAeoAHHw,2,0,0,0,0,0,2,0,2,0.2857142857142857,1,0.0,0,0,0,0,0,0,0,2,0,0,2,1
7288,196879,olMbWc9RSQc0Tu4bEWQzOnwezTDWcrs8,SpATywNh6bZuzm8s1ceuBUnMUAeoAHHw,5,2,1,0,1,0,2,0,6,0.8571428571428571,1,0.0,0,1,0,1,2,0,0,2,0,2,4,1
7289,196884,esy4b6bETmasLl5DFctrDy15ZWYpffCf,G8EPVSXsOYB5YQWZGiz1aVq5Pgr2GrQu,1,0,0,0,0,0,1,0,1,0.14285714285714285,1,0.0,0,0,0,0,0,0,0,1,0,0,1,1
7290,196890,9iPKlVFwenbwmn1nXcYJERwuTRxTRQK5,5X6FeZozNMgE2VRi3MJYjkkFK8SETtu2,4,2,1,0,1,0,2,0,6,0.8571428571428571,1,0.0,0,1,0,1,2,0,0,2,0,2,4,1
7291,196895,9iPKlVFwenbwmn1nXcYJERwuTRxTRQK5,A3fsA9Zfv1X2fVEQhTw51lKENdNrEqT3,1,0,0,0,0,0,1,0,1,0.14285714285714285,1,0.0,0,0,0,0,0,0,0,1,0,0,1,1
7292,196907,wXz4TbCpuPApw4hHC9Aow8xAscaoMUnc,A3fsA9Zfv1X2fVEQhTw51lKENdNrEqT3,1,0,0,0,0,0,1,0,1,0.14285714285714285,1,0.0,0,0,0,0,0,0,0,1,0,0,1,1
7293,196914,DcV7U0eIIh5HACuGyVVgSsAMkcu77YoX,SpATywNh6bZuzm8s1ceuBUnMUAeoAHHw,2,0,0,0,0,0,2,0,2,0.2857142857142857,1,0.0,0,0,0,0,0,0,0,2,0,0,2,1
7294,196923,EGJ0Z8XNH50h8WP7Cnpy6YQaaehVY90R,bWdj2GDclj5ofokWjzoa5jAwMkxCykd6,6,1,1,0,1,0,3,0,6,0.8571428571428571,1,0.0,0,1,0,1,1,0,0,3,0,2,4,1
7295,196934,RNEuStAlTxZHIZFwvfCfasMOM5Hny2Pn,G8EPVSXsOYB5YQWZGiz1aVq5Pgr2GrQu,1,0,0,0,0,0,1,0,1,0.14285714285714285,1,0.0,0,0,0,0,0,0,0,1,0,0,1,1
7296,196947,qREvGviufJ3VVxNkA2MjB1npr7InnyIq,RXDvfPUBYFlVdlueBFbLW0mhhAyGEqpt,1,0,0,0,0,0,1,0,1,0.14285714285714285,1,0.0,0,0,0,0,0,0,0,1,0,0,1,1
7297,196950,cF44PnrtdTjFKWs1ZjUvQj5VSTPqnlKA,SpATywNh6bZuzm8s1ceuBUnMUAeoAHHw,2,0,0,0,0,0,2,0,2,0.2857142857142857,1,0.0,0,0,0,0,0,0,0,2,0,0,2,1
7298,196952,Ep4sRinGGd3gfdKOkqpq2EkPdP58g9jj,G8EPVSXsOYB5YQWZGiz1aVq5Pgr2GrQu,1,0,0,0,0,0,1,0,1,0.14285714285714285,1,0.0,0,0,0,0,0,0,0,1,0,0,1,1
7299,196991,L60eSOdOjLwIo5deBWfwh8FwoeNxsxnx,SpATywNh6bZuzm8s1ceuBUnMUAeoAHHw,3,2,0,0,0,0,2,0,4,0.5714285714285714,1,0.0,0,0,0,0,2,0,0,2,0,0,4,1
7300,197006,9Nmjm4BvnbKTQ3ZZwECYdKy9zBNGmQNW,bWdj2GDclj5ofokWjzoa5jAwMkxCykd6,1,0,0,0,0,0,1,0,1,0.14285714285714285,1,0.0,0,0,0,0,0,0,0,1,0,0,1,1
7301,197007,9Nmjm4BvnbKTQ3ZZwECYdKy9zBNGmQNW,RXDvfPUBYFlVdlueBFbLW0mhhAyGEqpt,1,0,0,0,0,0,1,0,1,0.14285714285714285,1,0.0,0,0,0,0,0,0,0,1,0,0,1,1
7302,197032,UEQN2HGxEQ2XAToBZQskm8PnDddiQLUX,3VkHkmOtom3jM2wCu94xgzzu1d6Dn7or,8,4,2,0,1,0,3,0,10,1.4285714285714286,1,0.0,0,2,0,1,4,0,0,3,0,3,7,1
7303,197042,b368QIVjprjeB2VvkSphHxBQ1vMMPCnN,3VkHkmOtom3jM2wCu94xgzzu1d6Dn7or,1,0,0,0,0,0,1,0,1,0.14285714285714285,1,0.0,0,0,0,0,0,0,0,1,0,0,1,1
7304,197065,7wafENWJse7aLGqZkSyB60mvQb04ubG3,3VkHkmOtom3jM2wCu94xgzzu1d6Dn7or,7,1,1,0,1,0,6,0,9,1.2857142857142858,1,0.0,0,1,0,1,1,0,0,6,0,2,7,1
7305,197091,MkuOhOGQZMKVoaai2QMWHpcffMs2EIo9,3VkHkmOtom3jM2wCu94xgzzu1d6Dn7or,10,13,3,2,1,0,3,1,23,3.2857142857142856,1,0.0,1,3,2,1,12,0,0,3,1,7,16,1
7306,197093,hU0vMLUveVfvdzQOepSoXd0xPBO7HZY4,3VkHkmOtom3jM2wCu94xgzzu1d6Dn7or,6,6,1,0,0,4,5,1,17,2.4285714285714284,1,0.0,0,1,0,0,6,4,0,5,1,1,16,1
7307,197110,DyCEpdQiIAZj6yZylLF5ezLKYJiUKony,3VkHkmOtom3jM2wCu94xgzzu1d6Dn7or,7,2,1,0,1,1,9,1,15,2.142857142857143,1,0.0,0,1,0,1,2,1,0,9,1,2,13,1
7308,197112,nyCtoNdidkfUkWKecIRLfZNmg6o2kghj,3VkHkmOtom3jM2wCu94xgzzu1d6Dn7or,1,0,0,0,0,0,1,0,1,0.14285714285714285,1,0.0,0,0,0,0,0,0,0,1,0,0,1,1
7309,197156,S91ugK7RyjPXdIklMWItqmg7JB7T9PzZ,3VkHkmOtom3jM2wCu94xgzzu1d6Dn7or,7,3,2,0,2,0,2,0,9,1.2857142857142858,1,0.0,0,2,0,2,3,0,0,2,0,4,5,1
7310,197161,om0KjvovtBK0gZUSboAPRv5A6Jkm00Ei,3VkHkmOtom3jM2wCu94xgzzu1d6Dn7or,1,0,0,0,0,0,1,0,1,0.14285714285714285,1,0.0,0,0,0,0,0,0,0,1,0,0,1,1
7311,197196,kXKedIAlLk4nnLOObHVKEfusEbZyfe2f,3VkHkmOtom3jM2wCu94xgzzu1d6Dn7or,4,2,1,0,1,0,1,0,5,0.7142857142857143,1,0.0,0,1,0,1,2,0,0,1,0,2,3,1
7312,197221,iMSX1uHcSxcasOlc9agP5kI5TmyEQeiD,3VkHkmOtom3jM2wCu94xgzzu1d6Dn7or,1,0,0,0,0,0,1,0,1,0.14285714285714285,1,0.0,0,0,0,0,0,0,0,1,0,0,1,1
7313,197222,bGTCuLlM7XNGsLwApvdGmFukokfLu8F6,3VkHkmOtom3jM2wCu94xgzzu1d6Dn7or,1,0,0,0,0,0,1,0,1,0.14285714285714285,1,0.0,0,0,0,0,0,0,0,1,0,0,1,1
7314,197238,PSIpPoYTh8FnRkdm6jqihrIpnQnKF64y,3VkHkmOtom3jM2wCu94xgzzu1d6Dn7or,6,2,1,0,1,0,6,0,10,1.4285714285714286,1,0.0,0,1,0,1,2,0,0,6,0,2,8,1
7315,197265,0bTIvFPWlzp2dye0hIyZeexgN1LOjDU7,3VkHkmOtom3jM2wCu94xgzzu1d6Dn7or,5,6,3,0,4,0,2,0,15,2.142857142857143,1,0.0,0,3,0,4,6,0,0,2,0,7,8,1
7316,197274,pgd9bEAcOWgYToOxgTtzDobYZggS41Kp,3VkHkmOtom3jM2wCu94xgzzu1d6Dn7or,1,0,0,0,0,0,1,0,1,0.14285714285714285,1,0.0,0,0,0,0,0,0,0,1,0,0,1,1
7317,197284,lA8ZN74fx6NMNuhu16jepJP11Qw4Kgx2,3VkHkmOtom3jM2wCu94xgzzu1d6Dn7or,1,0,0,0,0,0,2,0,2,0.2857142857142857,1,0.0,0,0,0,0,0,0,0,2,0,0,2,1
7318,197289,3dVMClOA1muAVees6Vf9EBxcxFuosktC,3VkHkmOtom3jM2wCu94xgzzu1d6Dn7or,1,0,0,0,0,0,2,0,2,0.2857142857142857,1,0.0,0,0,0,0,0,0,0,2,0,0,2,1
7319,197340,e9AdEIjRVhyvhp0203NpitM74rcVK0BB,3VkHkmOtom3jM2wCu94xgzzu1d6Dn7or,5,5,2,0,3,0,3,0,13,1.8571428571428572,1,0.0,2,2,0,3,3,0,0,3,0,7,6,1
7320,197401,IhZdPOtOeXyg0OwsQIkD0XHc4IVBLzMp,3VkHkmOtom3jM2wCu94xgzzu1d6Dn7or,1,0,0,0,0,0,1,0,1,0.14285714285714285,1,0.0,0,0,0,0,0,0,0,1,0,0,1,1
7321,197462,8tnOMyXbXKGJjP9QLxPmUvVpjznov0vV,3VkHkmOtom3jM2wCu94xgzzu1d6Dn7or,4,0,0,0,0,0,4,0,4,0.5714285714285714,1,0.0,0,0,0,0,0,0,0,4,0,0,4,1
7322,197479,Xw2tDCOd1ii30IR6RwFNApooN5ycfzY2,3VkHkmOtom3jM2wCu94xgzzu1d6Dn7or,1,0,0,0,0,0,1,0,1,0.14285714285714285,1,0.0,0,0,0,0,0,0,0,1,0,0,1,1
7323,199106,SiuLrWlkxnvAIxxemPagy5NF7ku6UPbb,3VkHkmOtom3jM2wCu94xgzzu1d6Dn7or,1,0,0,0,0,0,1,0,1,0.14285714285714285,1,0.0,0,0,0,0,0,0,0,1,0,0,1,1
7324,199107,je9A6l6tP7wnbFhNJD7vbbHTYhqshuqB,3VkHkmOtom3jM2wCu94xgzzu1d6Dn7or,1,0,0,0,0,0,2,0,2,0.2857142857142857,1,0.0,0,0,0,0,0,0,0,2,0,0,2,1
7325,199140,pOty3QQDllRwRazWobs7f0vqF0FmSOua,3VkHkmOtom3jM2wCu94xgzzu1d6Dn7or,5,4,1,0,2,0,3,0,10,1.4285714285714286,1,0.0,0,1,0,2,4,0,0,3,0,3,7,1
7326,199154,OmnGU6PMoN6e39FHFSUGdW5cfWtL8mqG,3VkHkmOtom3jM2wCu94xgzzu1d6Dn7or,2,0,0,0,0,0,2,0,2,0.2857142857142857,1,0.0,0,0,0,0,0,0,0,2,0,0,2,1
7327,199160,7xkNb6KJSLd7yj2URUDx5hnJcWKsFiLF,3VkHkmOtom3jM2wCu94xgzzu1d6Dn7or,5,2,1,0,1,0,2,0,6,0.8571428571428571,1,0.0,0,1,0,1,2,0,0,2,0,2,4,1
7328,199166,nJP0RkZArz7wt5CxQJwMSO1fszv6Y5BK,3VkHkmOtom3jM2wCu94xgzzu1d6Dn7or,1,0,0,0,0,0,1,0,1,0.14285714285714285,1,0.0,0,0,0,0,0,0,0,1,0,0,1,1
7329,199168,24FeJHCcaxGLJuxScZB7YwqwrlHIVJm5,3VkHkmOtom3jM2wCu94xgzzu1d6Dn7or,6,2,1,0,1,0,6,0,10,1.4285714285714286,1,0.0,0,1,0,1,2,0,0,6,0,2,8,1
7330,199174,OdYISCyCgpEqvbE1G8dyalKevNPP8czy,3VkHkmOtom3jM2wCu94xgzzu1d6Dn7or,8,7,3,0,2,0,6,1,19,2.7142857142857144,1,0.0,2,3,0,2,5,0,0,6,1,7,12,1
7331,199229,BUjlAGT73sG03Srb3M3It2PuOU8Q0k35,3VkHkmOtom3jM2wCu94xgzzu1d6Dn7or,18,19,10,0,9,0,1,0,39,5.571428571428571,1,0.0,3,10,0,9,16,0,0,1,0,22,17,1
7332,199236,LzhaTOq4fJ50XldNzYaXGXnICepz6ZYf,3VkHkmOtom3jM2wCu94xgzzu1d6Dn7or,1,0,0,0,0,0,2,0,2,0.2857142857142857,1,0.0,0,0,0,0,0,0,0,2,0,0,2,1
7333,199239,56UtPIpXd8ixbNQcWObTP7HxM6iN5elx,3VkHkmOtom3jM2wCu94xgzzu1d6Dn7or,1,0,0,0,0,0,2,0,2,0.2857142857142857,1,0.0,0,0,0,0,0,0,0,2,0,0,2,1
7334,199240,Z5NEEpjFeROWqiDp0HOSTktYCRzmsm1W,3VkHkmOtom3jM2wCu94xgzzu1d6Dn7or,3,4,0,0,0,0,2,0,6,0.8571428571428571,1,0.0,2,0,0,0,2,0,0,2,0,2,4,1
7335,199241,nLVkMUicIATb5XjlrKkVLbPcf3PrrUv6,3VkHkmOtom3jM2wCu94xgzzu1d6Dn7or,1,0,0,0,0,0,1,0,1,0.14285714285714285,1,0.0,0,0,0,0,0,0,0,1,0,0,1,1
7336,199251,x6sH9u50F7syAJPTHXIYL85GeymcvPzL,3VkHkmOtom3jM2wCu94xgzzu1d6Dn7or,1,0,0,0,0,0,1,0,1,0.14285714285714285,1,0.0,0,0,0,0,0,0,0,1,0,0,1,1
7337,199254,t3zvUCA13KEbypSsHPCNMLfju0mDYp54,3VkHkmOtom3jM2wCu94xgzzu1d6Dn7or,5,3,1,0,1,0,3,1,9,1.2857142857142858,1,0.0,0,1,0,1,3,0,0,3,1,2,7,1
7338,199258,izrdat4Yj85eaRHmVTCDNoz6YDxPaMtF,3VkHkmOtom3jM2wCu94xgzzu1d6Dn7or,4,2,1,0,1,0,2,0,6,0.8571428571428571,1,0.0,0,1,0,1,2,0,0,2,0,2,4,1
7339,199262,8UBuXoKnbGMq6Q0kIIWDMawKN4aOMWdt,3VkHkmOtom3jM2wCu94xgzzu1d6Dn7or,11,11,5,10,3,1,2,0,32,4.571428571428571,1,0.0,5,5,8,3,6,1,2,2,0,21,11,1
7340,199263,ZJJQNdxLDmBSvSNBsbDtRYzTStN0dM4J,3VkHkmOtom3jM2wCu94xgzzu1d6Dn7or,7,4,2,0,2,0,2,0,10,1.4285714285714286,1,0.0,1,2,0,2,3,0,0,2,0,5,5,1
7341,199268,g7DIn7NzgCH1p1YBvAIg5IvU7czfyOX2,3VkHkmOtom3jM2wCu94xgzzu1d6Dn7or,1,0,0,0,0,0,2,0,2,0.2857142857142857,1,0.0,0,0,0,0,0,0,0,2,0,0,2,1
7342,199269,Rc8vyRlCQCbmH4EGB961YSkmrRByTTea,3VkHkmOtom3jM2wCu94xgzzu1d6Dn7or,8,5,2,0,1,1,6,1,16,2.2857142857142856,1,0.0,1,2,0,1,4,1,0,6,1,4,12,1
7343,199279,ibyVg0BxZIPKqINiDIiPPKNrRCjhA1dh,3VkHkmOtom3jM2wCu94xgzzu1d6Dn7or,1,0,0,0,0,0,1,0,1,0.14285714285714285,1,0.0,0,0,0,0,0,0,0,1,0,0,1,1
7344,199289,Xfg9JFG3AAEpBrN4qCMcAzrG9oqclxVX,3VkHkmOtom3jM2wCu94xgzzu1d6Dn7or,5,3,1,0,1,0,4,0,9,1.2857142857142858,1,0.0,1,1,0,1,2,0,0,4,0,3,6,1
7345,199290,hKDpmQWfhp0c74MNjB0QfOimQ7UCOHJg,3VkHkmOtom3jM2wCu94xgzzu1d6Dn7or,11,20,5,6,9,4,9,0,53,7.571428571428571,1,0.0,13,5,4,9,7,4,2,9,0,31,22,1
7346,199295,5MAyxqAkQoCv9jWmfdBsZmxlxyfszUFL,3VkHkmOtom3jM2wCu94xgzzu1d6Dn7or,8,16,9,0,0,0,8,0,33,4.714285714285714,1,0.0,2,9,0,0,14,0,0,8,0,11,22,1
7347,199305,xI45WBcqRSFYdtQ43ysRc22u3JLJWNvD,3VkHkmOtom3jM2wCu94xgzzu1d6Dn7or,1,0,0,0,0,0,1,0,1,0.14285714285714285,1,0.0,0,0,0,0,0,0,0,1,0,0,1,1
7348,199307,6MWUDMLC3Hnx6DASyTWDKrqwJvaSqV7s,3VkHkmOtom3jM2wCu94xgzzu1d6Dn7or,1,0,0,0,0,0,1,0,1,0.14285714285714285,1,0.0,0,0,0,0,0,0,0,1,0,0,1,1
7349,199309,E9EDiL5FdsaYLmbLpW4Gm4jZTeooFwDr,3VkHkmOtom3jM2wCu94xgzzu1d6Dn7or,1,0,0,0,0,0,1,0,1,0.14285714285714285,1,0.0,0,0,0,0,0,0,0,1,0,0,1,1
7350,199312,srirlXn6abjaBVVW0BAYG4BR3V5mYUPA,3VkHkmOtom3jM2wCu94xgzzu1d6Dn7or,4,3,0,0,0,0,4,0,7,1.0,1,0.0,0,0,0,0,3,0,0,4,0,0,7,1
7351,199316,2GVls3TyRLjTcZJwoD8SWl4QqoVZQwlQ,3VkHkmOtom3jM2wCu94xgzzu1d6Dn7or,1,0,0,0,0,0,1,0,1,0.14285714285714285,1,0.0,0,0,0,0,0,0,0,1,0,0,1,1
7352,199319,YWz36L1YY4zp6wTHvv7N4sKmhgmOHm30,3VkHkmOtom3jM2wCu94xgzzu1d6Dn7or,1,0,0,0,0,0,1,0,1,0.14285714285714285,1,0.0,0,0,0,0,0,0,0,1,0,0,1,1
7353,199342,HWEmScBu6kOujSZdv1uqTj45KBzx6va1,3VkHkmOtom3jM2wCu94xgzzu1d6Dn7or,1,0,0,0,0,0,2,0,2,0.2857142857142857,1,0.0,0,0,0,0,0,0,0,2,0,0,2,1
7354,199363,CQEk00TcDoCDBANAoiHWBC0wD3a3tm2t,3VkHkmOtom3jM2wCu94xgzzu1d6Dn7or,4,2,1,0,1,0,1,0,5,0.7142857142857143,1,0.0,0,1,0,1,2,0,0,1,0,2,3,1
7355,199369,Ns60nnOcHzm6CwEshEoSzbGFnBGMdPbf,3VkHkmOtom3jM2wCu94xgzzu1d6Dn7or,1,0,0,0,0,0,1,0,1,0.14285714285714285,1,0.0,0,0,0,0,0,0,0,1,0,0,1,1
7356,199386,uNxZwlwcjCXOgxUE9EtXjrX9Cep7hKAG,3VkHkmOtom3jM2wCu94xgzzu1d6Dn7or,6,3,2,0,2,0,1,0,8,1.1428571428571428,1,0.0,0,2,0,2,3,0,0,1,0,4,4,1
7357,199419,aesfEl5dCp5H9uEcPNHUp7OzsLtD37Qr,3VkHkmOtom3jM2wCu94xgzzu1d6Dn7or,1,0,0,0,0,0,1,0,1,0.14285714285714285,1,0.0,0,0,0,0,0,0,0,1,0,0,1,1
7358,199423,KJoE9unyVuT2DeHS57E6xLFn5ZLvwVq9,3VkHkmOtom3jM2wCu94xgzzu1d6Dn7or,1,0,0,0,0,0,2,0,2,0.2857142857142857,1,0.0,0,0,0,0,0,0,0,2,0,0,2,1
7359,199446,PZtTTaYrd6B4cAH5tmOBvlRaiVcoBrXm,3VkHkmOtom3jM2wCu94xgzzu1d6Dn7or,7,6,0,4,2,2,7,0,21,3.0,1,0.0,3,0,3,2,3,2,1,7,0,8,13,1
7360,199447,M4srLYpsZNHwQDiipREYwVsfQ9vN7ZoW,3VkHkmOtom3jM2wCu94xgzzu1d6Dn7or,1,0,0,0,0,0,1,0,1,0.14285714285714285,1,0.0,0,0,0,0,0,0,0,1,0,0,1,1
7361,199490,DR0coD7ZBHQMFzqolW7VCZpfMQZOSwFT,3VkHkmOtom3jM2wCu94xgzzu1d6Dn7or,5,2,0,0,1,0,2,0,5,0.7142857142857143,1,0.0,0,0,0,1,2,0,0,2,0,1,4,1
7362,199501,d62Uk1Mhp2bbkE3cDJ4nv3oJFCyri7BK,5Gyp41oLVo7Gg7vF4vpmggWP5MU70QO6,1,0,0,0,0,0,1,0,1,0.14285714285714285,1,0.0,0,0,0,0,0,0,0,1,0,0,1,1
7363,199546,kNdT4Mob6J1VkdvqbhmS4aPzbDLqNeYP,5Gyp41oLVo7Gg7vF4vpmggWP5MU70QO6,7,5,3,0,0,0,4,0,12,1.7142857142857142,1,0.0,0,3,0,0,5,0,0,4,0,3,9,1
7364,199550,KuJKHOLN9aBUzPlq0QGnPrqYbHBlyCQo,5Gyp41oLVo7Gg7vF4vpmggWP5MU70QO6,6,3,2,0,1,0,2,0,8,1.1428571428571428,1,0.0,0,2,0,1,3,0,0,2,0,3,5,1
7365,199567,NKFg1XrxaHlNSaxBdS9mZqwYNutEatUN,5Gyp41oLVo7Gg7vF4vpmggWP5MU70QO6,6,4,2,0,1,0,3,0,10,1.4285714285714286,1,0.0,1,2,0,1,3,0,0,3,0,4,6,1
7366,199578,elygdCrncWcn7OVBrJtJE9XwX8vVnXuv,5Gyp41oLVo7Gg7vF4vpmggWP5MU70QO6,10,5,4,0,3,0,2,0,14,2.0,1,0.0,0,4,0,3,5,0,0,2,0,7,7,1
7367,199585,TTUjbbDzAqmAeHUBfmRKT3OMlCTJVckJ,5Gyp41oLVo7Gg7vF4vpmggWP5MU70QO6,7,3,2,0,2,0,2,0,9,1.2857142857142858,1,0.0,0,2,0,2,3,0,0,2,0,4,5,1
7368,199601,Vh6koZSt1BGKgPAtYZGyVcQyArmS9YIg,5Gyp41oLVo7Gg7vF4vpmggWP5MU70QO6,15,13,7,8,3,0,2,0,33,4.714285714285714,1,0.0,4,7,7,3,9,0,1,2,0,21,12,1
7369,199607,c530IAX94rud3KYXrAnFqCf1qhIa2Krd,5Gyp41oLVo7Gg7vF4vpmggWP5MU70QO6,6,6,1,0,0,0,2,0,9,1.2857142857142858,1,0.0,0,1,0,0,6,0,0,2,0,1,8,1
7370,199635,jm7nchDCGNkzIbLvW4KORNHkW3D0Ma5N,5Gyp41oLVo7Gg7vF4vpmggWP5MU70QO6,1,0,0,0,0,0,1,0,1,0.14285714285714285,1,0.0,0,0,0,0,0,0,0,1,0,0,1,1
7371,199672,Ir0bQdDk1WYdGh3nD12MnfxMZwmCyvqY,5Gyp41oLVo7Gg7vF4vpmggWP5MU70QO6,5,2,1,0,1,3,3,0,10,1.4285714285714286,1,0.0,0,1,0,1,2,3,0,3,0,2,8,1
7372,199676,6AdntZ1YwSpIzfN8IkKhUxEEVllXQtUz,5Gyp41oLVo7Gg7vF4vpmggWP5MU70QO6,1,0,0,0,0,0,1,0,1,0.14285714285714285,1,0.0,0,0,0,0,0,0,0,1,0,0,1,1
7373,199701,LcrUg06CUMdhHcZmdzv0RIRRX4y16mTE,5Gyp41oLVo7Gg7vF4vpmggWP5MU70QO6,5,2,1,0,1,0,3,0,7,1.0,1,0.0,0,1,0,1,2,0,0,3,0,2,5,1
7374,199721,ixjSfLZyzKPW5rzdlNMYGdodlMV78vkC,5Gyp41oLVo7Gg7vF4vpmggWP5MU70QO6,7,3,2,0,2,0,2,0,9,1.2857142857142858,1,0.0,0,2,0,2,3,0,0,2,0,4,5,1
7375,199723,2HBnl1pMr4wAnZxFzwkIUnuIa96G1Ecq,5Gyp41oLVo7Gg7vF4vpmggWP5MU70QO6,1,0,0,0,0,0,1,0,1,0.14285714285714285,1,0.0,0,0,0,0,0,0,0,1,0,0,1,1
7376,199770,V4DFRRm44qhSrvCEIFd4pjLSSWKcBxUl,5Gyp41oLVo7Gg7vF4vpmggWP5MU70QO6,10,11,2,0,1,2,9,1,26,3.7142857142857144,2,0.0,0,2,0,1,11,2,0,9,1,3,23,0
7377,199802,8zuZeBODltlYx6gcd6dPnNXLDXb8sH6b,5Gyp41oLVo7Gg7vF4vpmggWP5MU70QO6,1,0,0,0,0,0,1,0,1,0.14285714285714285,1,0.0,0,0,0,0,0,0,0,1,0,0,1,1
7378,199815,RIXSuS9h1XpYRMLAK5sqek3oEF8Sik9A,5Gyp41oLVo7Gg7vF4vpmggWP5MU70QO6,1,0,0,0,0,0,1,0,1,0.14285714285714285,1,0.0,0,0,0,0,0,0,0,1,0,0,1,1
7379,199830,zqMb5GcH4NLBJytjLvjEwIumSES5DKBS,5Gyp41oLVo7Gg7vF4vpmggWP5MU70QO6,4,2,0,0,0,0,3,0,5,0.7142857142857143,2,0.0,0,0,0,0,2,0,0,3,0,0,5,1
7380,199837,e5WBFaW97P5SB4u9kJ6uPxmLMsZkxgHF,5Gyp41oLVo7Gg7vF4vpmggWP5MU70QO6,2,0,0,0,0,0,2,0,2,0.2857142857142857,1,0.0,0,0,0,0,0,0,0,2,0,0,2,1
7381,199848,F1JFhxE9defmDqDZ43P468elvks5NkEB,5Gyp41oLVo7Gg7vF4vpmggWP5MU70QO6,1,0,0,0,0,0,1,0,1,0.14285714285714285,1,0.0,0,0,0,0,0,0,0,1,0,0,1,1
7382,199849,8tWMGcZPhvNTS06JyFfXdfvoax4LQs0G,5Gyp41oLVo7Gg7vF4vpmggWP5MU70QO6,5,2,1,0,0,0,3,0,6,0.8571428571428571,1,0.0,0,1,0,0,2,0,0,3,0,1,5,1
7383,199887,sEqqQzJgfFwEJ59pjhsH9YLQDd58mQLD,5Gyp41oLVo7Gg7vF4vpmggWP5MU70QO6,1,0,0,0,0,0,1,0,1,0.14285714285714285,1,0.0,0,0,0,0,0,0,0,1,0,0,1,1
7384,199966,UXmVmknHAyMhqmhIGaA9GmsQ8nc5udTu,5Gyp41oLVo7Gg7vF4vpmggWP5MU70QO6,1,0,0,0,0,0,1,0,1,0.14285714285714285,1,0.0,0,0,0,0,0,0,0,1,0,0,1,1
7385,199977,HCwB0C2JKEdLvoVwTd75X8I8tYIzHhIM,5Gyp41oLVo7Gg7vF4vpmggWP5MU70QO6,1,0,0,0,0,0,1,0,1,0.14285714285714285,1,0.0,0,0,0,0,0,0,0,1,0,0,1,1
7386,199995,zCpagk9PxfOocuFuBu0Ac85RSLgivgoq,5Gyp41oLVo7Gg7vF4vpmggWP5MU70QO6,1,0,0,0,0,0,1,0,1,0.14285714285714285,1,0.0,0,0,0,0,0,0,0,1,0,0,1,1
7387,200023,ta4s7Ul83oGtj5gRUZr1SGBrSbL1ESRg,5Gyp41oLVo7Gg7vF4vpmggWP5MU70QO6,7,3,2,0,2,0,2,0,9,1.2857142857142858,1,0.0,0,2,0,2,3,0,0,2,0,4,5,1
7388,200033,y20f09CxhvS55Wblm8XZJQuRockZgjId,5Gyp41oLVo7Gg7vF4vpmggWP5MU70QO6,1,0,0,0,0,0,1,0,1,0.14285714285714285,1,0.0,0,0,0,0,0,0,0,1,0,0,1,1
7389,200040,toiqn6LPCS99iRSdrd2LEPmUKg5mrnoq,5Gyp41oLVo7Gg7vF4vpmggWP5MU70QO6,4,3,1,0,1,0,1,0,6,0.8571428571428571,1,0.0,0,1,0,1,3,0,0,1,0,2,4,1
7390,200067,3YQpliwjSA8AK3ol8NDBXglcswt2oFEG,5Gyp41oLVo7Gg7vF4vpmggWP5MU70QO6,15,34,14,4,8,6,18,1,85,12.142857142857142,1,0.0,10,14,2,8,24,6,2,18,1,34,51,1
7391,200077,rCsUqWLhKle1EqenEkn3BmRW45I7EKcI,5Gyp41oLVo7Gg7vF4vpmggWP5MU70QO6,1,0,0,0,0,0,1,0,1,0.14285714285714285,1,0.0,0,0,0,0,0,0,0,1,0,0,1,1
7392,200085,7DufOZH7uJb86RSw7kwej322YsuvsAOn,5Gyp41oLVo7Gg7vF4vpmggWP5MU70QO6,7,3,2,0,2,0,2,0,9,1.2857142857142858,1,0.0,0,2,0,2,3,0,0,2,0,4,5,0
7393,200088,wxOgTM0U8atO7FTCY8VhNuh0fylTpPFX,5Gyp41oLVo7Gg7vF4vpmggWP5MU70QO6,1,0,0,0,0,0,1,0,1,0.14285714285714285,1,0.0,0,0,0,0,0,0,0,1,0,0,1,1
7394,200106,J4CQZgZBlOmytRfPs9vqhW9gDDIzfvcP,5Gyp41oLVo7Gg7vF4vpmggWP5MU70QO6,2,0,0,0,0,0,4,0,4,0.5714285714285714,1,0.0,0,0,0,0,0,0,0,4,0,0,4,1
7395,200108,4OVJ3xihQbiVQL93GzejnSZNc6TEGKTV,5Gyp41oLVo7Gg7vF4vpmggWP5MU70QO6,1,0,0,0,0,0,1,0,1,0.14285714285714285,1,0.0,0,0,0,0,0,0,0,1,0,0,1,1
7396,200120,nWKh3KZfWpFp8N0w0wAnq7QosofiiWHZ,5Gyp41oLVo7Gg7vF4vpmggWP5MU70QO6,4,7,1,0,0,0,2,0,10,1.4285714285714286,1,0.0,5,1,0,0,2,0,0,2,0,6,4,1
7397,200158,OBrE671jmAa0zcKhOwZbsgknJEYhO9ZQ,fbPkOYLVPtPgIt0MxizjfFJov3JbHyAi,9,5,4,0,4,0,0,0,13,1.8571428571428572,1,0.0,0,4,0,4,5,0,0,0,0,8,5,1
7398,200183,ajSnZNRHXRc8Lp3Apzl9jhBHJ93vaNPi,fbPkOYLVPtPgIt0MxizjfFJov3JbHyAi,2,0,0,0,0,0,2,0,2,0.2857142857142857,1,0.0,0,0,0,0,0,0,0,2,0,0,2,1
7399,200187,aGnJR132vfJUJhCgWPqNCfjSqAKTceP7,fbPkOYLVPtPgIt0MxizjfFJov3JbHyAi,4,2,0,0,0,0,2,0,4,0.5714285714285714,1,0.0,0,0,0,0,2,0,0,2,0,0,4,1
7400,200190,GMz0p3R0olFf93OHzhoRfm6K9FYjtVBr,fbPkOYLVPtPgIt0MxizjfFJov3JbHyAi,1,0,0,0,0,0,1,0,1,0.14285714285714285,1,0.0,0,0,0,0,0,0,0,1,0,0,1,1
7401,200195,aDECjDNmXQqgYm6JtRqkv0Su4uv6syvb,fbPkOYLVPtPgIt0MxizjfFJov3JbHyAi,7,5,2,0,3,0,3,0,13,1.8571428571428572,1,0.0,2,2,0,3,3,0,0,3,0,7,6,1
7402,200196,kerB5RBuhvb9QV0DhYFh8GpXXRfYT6uv,fbPkOYLVPtPgIt0MxizjfFJov3JbHyAi,1,0,0,0,0,0,1,0,1,0.14285714285714285,1,0.0,0,0,0,0,0,0,0,1,0,0,1,1
7403,200197,9LWdgptEOEdv2w8R0wKWL5CMrKtWuBl6,fbPkOYLVPtPgIt0MxizjfFJov3JbHyAi,1,0,0,0,0,0,1,0,1,0.14285714285714285,1,0.0,0,0,0,0,0,0,0,1,0,0,1,1
7404,200200,UW5vT7Adnn4gq5148M0Kd0fNJNqIxYNZ,fbPkOYLVPtPgIt0MxizjfFJov3JbHyAi,2,0,0,0,0,0,3,0,3,0.42857142857142855,1,0.0,0,0,0,0,0,0,0,3,0,0,3,1
7405,200214,t7fmofRfEDFaZ2tcdJoy6YnZtr04n4TA,5Gyp41oLVo7Gg7vF4vpmggWP5MU70QO6,2,0,0,0,0,0,2,0,2,0.2857142857142857,1,0.0,0,0,0,0,0,0,0,2,0,0,2,1
7406,200265,8ojbEZcVo2OtR30EqyHwuNwkgTMa7xeO,5Gyp41oLVo7Gg7vF4vpmggWP5MU70QO6,1,0,0,0,0,0,1,0,1,0.14285714285714285,1,0.0,0,0,0,0,0,0,0,1,0,0,1,1
7407,200310,2qmRjwcRaJSCoGstnt322AsuzCqrXoxT,5Gyp41oLVo7Gg7vF4vpmggWP5MU70QO6,7,6,2,0,4,0,2,0,14,2.0,1,0.0,3,2,0,4,3,0,0,2,0,9,5,1
7408,200335,FOtv6xDKHzFqDhbDD4xQWlZpphWR2KSb,5Gyp41oLVo7Gg7vF4vpmggWP5MU70QO6,10,8,5,0,6,0,1,0,20,2.857142857142857,1,0.0,2,5,0,6,6,0,0,1,0,13,7,1
7409,200346,B9qFxcRNIbCTDthnIzWFOAMqHaN5yHtV,5Gyp41oLVo7Gg7vF4vpmggWP5MU70QO6,1,0,0,0,0,0,1,0,1,0.14285714285714285,1,0.0,0,0,0,0,0,0,0,1,0,0,1,1
7410,200350,rsvoGlABSxMfCZAMU5AdZU7fKJUkZXC9,5Gyp41oLVo7Gg7vF4vpmggWP5MU70QO6,1,0,0,0,0,0,1,0,1,0.14285714285714285,1,0.0,0,0,0,0,0,0,0,1,0,0,1,1
7411,200370,yUDBZYpD5ZCQiJA6cgTmTyE1UqJsgt3l,5Gyp41oLVo7Gg7vF4vpmggWP5MU70QO6,1,0,0,0,0,0,1,0,1,0.14285714285714285,1,0.0,0,0,0,0,0,0,0,1,0,0,1,1
7412,200391,yKhFnQAdnTFnHpBqMNeexFC5CORiLzu5,5Gyp41oLVo7Gg7vF4vpmggWP5MU70QO6,13,13,10,0,7,0,6,0,36,5.142857142857143,1,0.0,0,10,0,7,13,0,0,6,0,17,19,1
7413,200424,2FKmhUQkD4Jl8hWDPtmkKeErEkvByKdi,5Gyp41oLVo7Gg7vF4vpmggWP5MU70QO6,1,0,0,0,0,0,1,0,1,0.14285714285714285,1,0.0,0,0,0,0,0,0,0,1,0,0,1,1
7414,200455,G8jgnHTeLf1hE7XVTYSEeVS9aL3UBLQd,5Gyp41oLVo7Gg7vF4vpmggWP5MU70QO6,2,0,0,0,0,0,2,0,2,0.2857142857142857,1,0.0,0,0,0,0,0,0,0,2,0,0,2,0
7415,200474,tuwFpVRxydP7ukF3l7WQ2j9F6pGAbPqc,5Gyp41oLVo7Gg7vF4vpmggWP5MU70QO6,12,6,5,0,3,3,3,0,20,2.857142857142857,1,0.0,0,5,0,3,6,3,0,3,0,8,12,1
7416,200479,IPInQHBD1Sob6EZGyGGciiLir6vAFL6F,5Gyp41oLVo7Gg7vF4vpmggWP5MU70QO6,5,5,1,0,2,1,1,0,10,1.4285714285714286,1,0.0,0,1,0,2,5,1,0,1,0,3,7,1
7417,200486,hUoOQP103jtoSjE8huNXPy5FlXS050j3,5Gyp41oLVo7Gg7vF4vpmggWP5MU70QO6,5,4,1,0,0,0,2,0,7,1.0,1,0.0,0,1,0,0,4,0,0,2,0,1,6,1
7418,200517,n7yQ1FvfAXqDnBpszfIUjZkrvw3J2aJC,5Gyp41oLVo7Gg7vF4vpmggWP5MU70QO6,5,2,1,0,1,0,2,0,6,0.8571428571428571,1,0.0,0,1,0,1,2,0,0,2,0,2,4,0
7419,200585,ZpIPcydiES9PFQvbCzLJLin5Jt1uIJC6,5Gyp41oLVo7Gg7vF4vpmggWP5MU70QO6,3,2,1,0,0,0,1,0,4,0.5714285714285714,1,0.0,0,1,0,0,2,0,0,1,0,1,3,1
7420,200587,MymZPJWcJvHuJMrRYcmywxRVhQFAj4Sr,5Gyp41oLVo7Gg7vF4vpmggWP5MU70QO6,4,0,0,0,0,0,4,0,4,0.5714285714285714,1,0.0,0,0,0,0,0,0,0,4,0,0,4,1
7421,200613,F7AXONZ3TpGkisi8zy5Q1Qe95Pxbm1oq,5Gyp41oLVo7Gg7vF4vpmggWP5MU70QO6,3,0,0,0,0,1,2,0,3,0.42857142857142855,1,0.0,0,0,0,0,0,1,0,2,0,0,3,1
7422,200668,DuhdXcjzufckORvT0wE8ArWYujylxbnx,5Gyp41oLVo7Gg7vF4vpmggWP5MU70QO6,1,0,0,0,0,0,1,0,1,0.14285714285714285,1,0.0,0,0,0,0,0,0,0,1,0,0,1,1
7423,200704,CqFrhuoYEjE6MH9AuUp4nwHEmwAlC9zU,5Gyp41oLVo7Gg7vF4vpmggWP5MU70QO6,6,3,2,5,1,0,1,0,12,1.7142857142857142,1,0.0,0,2,3,1,3,0,2,1,0,6,6,1
7424,200707,zv1MTlqEl4Nw73cGpyMcdRKThLliUAlA,5Gyp41oLVo7Gg7vF4vpmggWP5MU70QO6,4,2,0,0,0,0,2,0,4,0.5714285714285714,1,0.0,0,0,0,0,2,0,0,2,0,0,4,1
7425,200749,heWJRVg7rEQJKctb9hAqhrrVJgE71Gu9,5Gyp41oLVo7Gg7vF4vpmggWP5MU70QO6,13,7,5,4,3,0,3,0,22,3.142857142857143,1,0.0,1,5,2,3,6,0,2,3,0,11,11,1
7426,200761,QNA44zjiZdozxT5YpeINlRZRlMKPMkhp,5Gyp41oLVo7Gg7vF4vpmggWP5MU70QO6,6,7,6,0,4,0,1,0,18,2.5714285714285716,1,0.0,0,6,0,4,7,0,0,1,0,10,8,1
7427,200782,hyOYv4rmSRnv16UkVW9gdxwUgBZxYdhv,7GRhBDsirIGkRZBtSMEzNTyDr2JQm4xx,5,2,1,0,1,0,2,0,6,0.8571428571428571,1,0.0,0,1,0,1,2,0,0,2,0,2,4,1
7428,200800,7nzr7mwsX3K7BiOtdIcVBSR6zEXVIYI1,7GRhBDsirIGkRZBtSMEzNTyDr2JQm4xx,4,3,1,0,0,0,2,0,6,0.8571428571428571,1,0.0,0,1,0,0,3,0,0,2,0,1,5,1
7429,200806,4h79uMcS1iYROsRps1078ngx78w376cH,7GRhBDsirIGkRZBtSMEzNTyDr2JQm4xx,2,0,0,0,0,0,3,0,3,0.42857142857142855,1,0.0,0,0,0,0,0,0,0,3,0,0,3,0
7430,200817,vDNo4mQAZOC4PWVxrxTTUTLEt0bpNinW,7GRhBDsirIGkRZBtSMEzNTyDr2JQm4xx,12,6,5,0,5,0,1,0,17,2.4285714285714284,1,0.0,0,5,0,5,6,0,0,1,0,10,7,1
7431,200829,JLn36xalC1eIUd4jm6gux9oEgx3gpDxA,7GRhBDsirIGkRZBtSMEzNTyDr2JQm4xx,2,0,0,0,0,0,2,0,2,0.2857142857142857,1,0.0,0,0,0,0,0,0,0,2,0,0,2,1
