,enrollment_id,username,course_id,no_of_objects1,bno_access1,bno_pageclose1,bno_problem1,bno_video1,bno_discussion1,bno_navigate1,bno_wiki1,bno_total1,bno_avg1,no_of_active_days1,time_consumption1,browser_access1,browser_pageclose1,browser_problem1,browser_video1,server_access1,server_discussion1,server_problem1,server_navigate1,server_wiki1,bno_browser1,bno_server1,label
0,34,OeLBIzS0gNQ56euxy5b66gAZMzQCGE7n,7GRhBDsirIGkRZBtSMEzNTyDr2JQm4xx,10,12,5,4,3,0,7,1,32,4.571428571428571,4,-2046176.0,1,5,3,3,11,0,1,7,1,12,20,0
1,66,cGrHiRjztN9fSltHujpfWaaWfYWiidiG,7GRhBDsirIGkRZBtSMEzNTyDr2JQm4xx,32,125,30,62,11,68,17,0,313,44.714285714285715,5,0.0,58,30,46,11,67,68,16,17,0,145,168,0
2,89,Po17baTutQqG3KBkMaahpxQ7IpjhFfZa,7GRhBDsirIGkRZBtSMEzNTyDr2JQm4xx,16,35,2,17,13,0,5,0,72,10.285714285714286,3,0.0,20,2,14,13,15,0,3,5,0,49,23,1
3,145,TZOWoG0yzTTzAfx5K054mpl5rZTlZIcZ,7GRhBDsirIGkRZBtSMEzNTyDr2JQm4xx,31,69,23,56,10,25,5,2,190,27.142857142857142,4,0.0,22,23,52,10,47,25,4,5,2,107,83,1
4,163,jJZ8z8M2beLy33Z7JJbNFq1bQd8o43FV,7GRhBDsirIGkRZBtSMEzNTyDr2JQm4xx,4,2,0,0,0,0,2,0,4,0.5714285714285714,1,0.0,0,0,0,0,2,0,0,2,0,0,4,1
5,312,BCPhbcVTukJPsOtUJJbyOWvpso8GiEV1,7GRhBDsirIGkRZBtSMEzNTyDr2JQm4xx,35,106,39,80,14,290,37,3,569,81.28571428571429,7,0.0,48,39,68,14,58,290,12,37,3,169,400,0
6,508,hbwWiZJx2DqUaUjG4c2EvTFTwMA32fWP,7GRhBDsirIGkRZBtSMEzNTyDr2JQm4xx,6,3,2,0,1,0,3,0,9,1.2857142857142858,1,0.0,0,2,0,1,3,0,0,3,0,3,6,1
7,571,cuuYGTWWAmhidQoRHdGzANriCatcPrlK,7GRhBDsirIGkRZBtSMEzNTyDr2JQm4xx,32,70,29,44,21,14,7,0,185,26.428571428571427,3,0.0,33,29,39,21,37,14,5,7,0,122,63,0
8,578,eER8RoiVQhlBLlO4WV7kKfWOx4XE0E9c,7GRhBDsirIGkRZBtSMEzNTyDr2JQm4xx,11,18,7,4,5,0,4,0,38,5.428571428571429,3,0.0,8,7,3,5,10,0,1,4,0,23,15,1
9,618,M5ID2aNMWGm5ShsGkFPYgTgN2UReXK8g,7GRhBDsirIGkRZBtSMEzNTyDr2JQm4xx,28,38,14,57,16,1,2,0,128,18.285714285714285,1,0.0,21,14,48,16,17,1,9,2,0,99,29,1
10,694,DVxZxPUgYsodJVtjUg4HG3ZucfJoWgwo,7GRhBDsirIGkRZBtSMEzNTyDr2JQm4xx,41,46,14,101,15,0,18,0,194,27.714285714285715,5,0.0,21,14,95,15,25,0,6,18,0,145,49,1
11,755,qVDHsjIzoOtZnTwpJtbJGpvapy4sRYpW,7GRhBDsirIGkRZBtSMEzNTyDr2JQm4xx,35,79,31,45,14,12,22,1,204,29.142857142857142,3,0.0,43,31,42,14,36,12,3,22,1,130,74,1
12,849,se5zs87qj8m5HDpiAuY9fHW8e8hfOFuJ,7GRhBDsirIGkRZBtSMEzNTyDr2JQm4xx,32,114,47,46,17,59,17,1,301,43.0,2,0.0,49,47,42,17,65,59,4,17,1,155,146,0
13,948,iYWLR7w0j5yEEe1bCu5IYYyXjnXbv448,7GRhBDsirIGkRZBtSMEzNTyDr2JQm4xx,25,41,14,40,11,1,2,0,109,15.571428571428571,2,0.0,24,14,36,11,17,1,4,2,0,85,24,0
14,1042,ypoGZw2r9uT31DVWRK8Ak5IwBPQDf2ZW,7GRhBDsirIGkRZBtSMEzNTyDr2JQm4xx,24,42,16,33,9,0,4,0,104,14.857142857142858,2,0.0,19,16,28,9,23,0,5,4,0,72,32,1
15,1130,aaJeZnIT5e0GpVZyGMksW5aGfCnXK0Ln,7GRhBDsirIGkRZBtSMEzNTyDr2JQm4xx,28,64,0,45,0,28,15,2,154,22.0,1,0.0,42,0,36,0,22,28,9,15,2,78,76,1
16,1194,WFh9KL1sDhp4NpPSjJuGtUwdjU2As3jU,7GRhBDsirIGkRZBtSMEzNTyDr2JQm4xx,2,0,0,0,0,0,2,0,2,0.2857142857142857,1,0.0,0,0,0,0,0,0,0,2,0,0,2,1
17,1197,x9GXQQjoWNWecF7wnG4Lnubsxy4Sbicl,7GRhBDsirIGkRZBtSMEzNTyDr2JQm4xx,36,77,28,92,16,8,18,0,239,34.142857142857146,2,0.0,43,28,78,16,34,8,14,18,0,165,74,1
18,1293,2CIqPxwfpdleLKAwuxTPlDujU1ToKMCe,7GRhBDsirIGkRZBtSMEzNTyDr2JQm4xx,35,82,34,56,11,73,42,3,301,43.0,7,0.0,35,34,46,11,47,73,10,42,3,126,175,0
19,1304,CSh5hGbaSFu2yCb31iVMOVwKocrH471Q,7GRhBDsirIGkRZBtSMEzNTyDr2JQm4xx,5,8,4,0,1,0,4,0,17,2.4285714285714284,4,0.0,0,4,0,1,8,0,0,4,0,5,12,1
20,1327,2cWT2r9kI6XDpveso7mwMhmCGJDMpJ6X,7GRhBDsirIGkRZBtSMEzNTyDr2JQm4xx,27,52,1,68,5,6,14,1,147,21.0,1,0.0,23,1,59,5,29,6,9,14,1,88,59,1
21,1334,BdwcZr5MO8X0sPJO0Tqucc1g1g6IA4vq,7GRhBDsirIGkRZBtSMEzNTyDr2JQm4xx,7,7,1,2,1,0,2,0,13,1.8571428571428572,1,0.0,2,1,2,1,5,0,0,2,0,6,7,0
22,1396,4pgEahxP0BMucPOaES4iKt1glSEl2goc,7GRhBDsirIGkRZBtSMEzNTyDr2JQm4xx,35,111,31,56,16,26,29,4,273,39.0,3,0.0,54,31,46,16,57,26,10,29,4,147,126,0
23,1434,M3xTB6LenTJvMpybZKparVtRZKzrRM1R,7GRhBDsirIGkRZBtSMEzNTyDr2JQm4xx,1,0,0,0,0,0,1,0,1,0.14285714285714285,1,0.0,0,0,0,0,0,0,0,1,0,0,1,1
24,1436,hmtOqZVjWQ6rLJb3YkFWytQIy20ogszh,7GRhBDsirIGkRZBtSMEzNTyDr2JQm4xx,26,17,9,54,7,4,9,0,100,14.285714285714286,1,0.0,6,9,46,7,11,4,8,9,0,68,32,1
25,1644,P18honwQPPbELUE86qFIATuZK3YDtjvG,7GRhBDsirIGkRZBtSMEzNTyDr2JQm4xx,4,2,1,0,1,0,1,0,5,0.7142857142857143,1,0.0,0,1,0,1,2,0,0,1,0,2,3,1
26,1739,MSwjf2I17FAgMFqknSNlHHVpwcQKsxyQ,7GRhBDsirIGkRZBtSMEzNTyDr2JQm4xx,5,8,2,0,1,0,3,0,14,2.0,1,0.0,2,2,0,1,6,0,0,3,0,5,9,1
27,1765,8nlNDsWSaxHCvsMKtqhBs81sknEiTCeb,7GRhBDsirIGkRZBtSMEzNTyDr2JQm4xx,16,19,12,0,11,0,4,0,46,6.571428571428571,5,0.0,3,12,0,11,16,0,0,4,0,26,20,0
28,1771,jImHfNEIObE674KdIbKVj7cCJ4ufqzHJ,7GRhBDsirIGkRZBtSMEzNTyDr2JQm4xx,25,50,19,30,0,156,20,1,276,39.42857142857143,4,0.0,21,19,27,0,29,156,3,20,1,67,209,0
29,1775,mIe8dQN3qDFpsTsivIoOXC4yOCPP2RyG,7GRhBDsirIGkRZBtSMEzNTyDr2JQm4xx,6,2,0,0,0,1,5,0,8,1.1428571428571428,1,0.0,0,0,0,0,2,1,0,5,0,0,8,0
30,1808,Slk5JcZSYHmDLQZXaNVmcMDmjJ16kBhI,fbPkOYLVPtPgIt0MxizjfFJov3JbHyAi,19,114,3,40,6,29,16,3,211,30.142857142857142,4,0.0,46,3,32,6,68,29,8,16,3,87,124,1
31,1809,oo6yDppb7lwtVg5iRhFytpMjmAuhJrAW,fbPkOYLVPtPgIt0MxizjfFJov3JbHyAi,16,41,22,3,9,134,30,5,244,34.857142857142854,4,0.0,10,22,3,9,31,134,0,30,5,44,200,0
32,1814,KVMcZ0CphnUUs4jbRYRdgMvMogJko09j,fbPkOYLVPtPgIt0MxizjfFJov3JbHyAi,15,21,12,9,14,6,11,0,73,10.428571428571429,1,0.0,8,12,8,14,13,6,1,11,0,42,31,0
33,1836,XlDfnhryafmarvecZhKZMWL7AupGjwi4,fbPkOYLVPtPgIt0MxizjfFJov3JbHyAi,5,11,4,0,1,0,1,0,17,2.4285714285714284,1,0.0,0,4,0,1,11,0,0,1,0,5,12,1
34,1846,82UlWF6Fm1gkNum7nNbVw0yOV1BUdNoS,fbPkOYLVPtPgIt0MxizjfFJov3JbHyAi,4,2,1,0,1,18,2,0,24,3.4285714285714284,1,0.0,0,1,0,1,2,18,0,2,0,2,22,1
35,1848,JfQVgXDVu1NGs9lcRBOD4w6V7BSaZCc2,fbPkOYLVPtPgIt0MxizjfFJov3JbHyAi,26,31,15,14,10,26,14,0,110,15.714285714285714,4,0.0,10,15,13,10,21,26,1,14,0,48,62,0
36,1850,62aEkx5hiqjq7miMyrFwVbP7Jkesq4eo,fbPkOYLVPtPgIt0MxizjfFJov3JbHyAi,9,4,3,0,3,0,2,0,12,1.7142857142857142,1,0.0,0,3,0,3,4,0,0,2,0,6,6,0
37,1854,sjBn8oayOINN3T3JZLXHY4beCfaHLSkq,fbPkOYLVPtPgIt0MxizjfFJov3JbHyAi,27,47,16,21,17,19,7,1,128,18.285714285714285,2,0.0,26,16,19,17,21,19,2,7,1,78,50,0
38,1855,cy2CnLMLxJkryBCEHSwR3ZMTpAjnoO1C,fbPkOYLVPtPgIt0MxizjfFJov3JbHyAi,19,97,8,7,0,380,66,0,558,79.71428571428571,5,0.0,11,8,7,0,86,380,0,66,0,26,532,0
39,1857,3LBSAbcxxmlIGNLvUbxOBHP17eWw2EWo,fbPkOYLVPtPgIt0MxizjfFJov3JbHyAi,10,8,5,0,4,0,2,0,19,2.7142857142857144,2,0.0,0,5,0,4,8,0,0,2,0,9,10,0
40,1866,mrzCfkgyM6KyC9H5Ok54xCLYWyp2COiw,fbPkOYLVPtPgIt0MxizjfFJov3JbHyAi,9,7,3,0,3,17,3,1,34,4.857142857142857,1,0.0,2,3,0,3,5,17,0,3,1,8,26,1
41,1868,euJ8gpxfARpnWjt9X8Fyxm47A6A32cKl,fbPkOYLVPtPgIt0MxizjfFJov3JbHyAi,23,55,25,10,7,77,18,1,193,27.571428571428573,5,0.0,4,25,8,7,51,77,2,18,1,44,149,0
42,1885,9sckfYHCSe28pCKnT8xoBCq2thEZcsel,fbPkOYLVPtPgIt0MxizjfFJov3JbHyAi,11,34,3,5,3,0,4,0,49,7.0,2,0.0,5,3,4,3,29,0,1,4,0,15,34,1
43,1889,9lZ5nNFJAuEwr4dRJLRoTk52o5oWJaUg,fbPkOYLVPtPgIt0MxizjfFJov3JbHyAi,26,38,15,11,13,45,9,2,133,19.0,3,0.0,17,15,11,13,21,45,0,9,2,56,77,0
44,1892,h8BwrBZ61dHhi5fhxZzTUeeYh9J3sER4,fbPkOYLVPtPgIt0MxizjfFJov3JbHyAi,19,17,13,0,11,5,7,0,53,7.571428571428571,2,0.0,1,13,0,11,16,5,0,7,0,25,28,0
45,1900,FELnhQR0c7GZZX82ioYJEZsqujOrfyf7,fbPkOYLVPtPgIt0MxizjfFJov3JbHyAi,11,8,5,0,3,23,6,2,47,6.714285714285714,2,0.0,1,5,0,3,7,23,0,6,2,9,38,1
46,1905,rH9yibot6cCOaAZphZeWIT7V2pydvksO,fbPkOYLVPtPgIt0MxizjfFJov3JbHyAi,4,2,1,0,1,0,1,0,5,0.7142857142857143,1,0.0,0,1,0,1,2,0,0,1,0,2,3,1
47,1908,uJfbc9I7P24gwBxCb4NuFSYLPcQJXbJC,fbPkOYLVPtPgIt0MxizjfFJov3JbHyAi,22,59,28,7,25,41,41,4,205,29.285714285714285,4,0.0,21,28,5,25,38,41,2,41,4,79,126,0
48,1914,Ms0MC4W5moiGJLWP7iE3FImeH9CHN4KT,fbPkOYLVPtPgIt0MxizjfFJov3JbHyAi,15,19,10,0,5,3,7,2,46,6.571428571428571,3,0.0,4,10,0,5,15,3,0,7,2,19,27,0
49,1924,bRmU4ghbgx16XrcSMiRmwAVngSF9Tm10,fbPkOYLVPtPgIt0MxizjfFJov3JbHyAi,7,6,4,0,3,0,2,0,15,2.142857142857143,2,0.0,0,4,0,3,6,0,0,2,0,7,8,0
50,1925,UHEdqIfQMlcBmdDDlAACqjd4uHB22PZR,fbPkOYLVPtPgIt0MxizjfFJov3JbHyAi,4,5,2,0,0,0,1,0,8,1.1428571428571428,2,0.0,0,2,0,0,5,0,0,1,0,2,6,0
51,1927,KGKXtIu1hkHju7SCZs8gtmA9OwHIqK9w,fbPkOYLVPtPgIt0MxizjfFJov3JbHyAi,30,148,99,1,25,235,60,2,570,81.42857142857143,7,0.0,18,99,1,25,130,235,0,60,2,143,427,0
52,1930,7Qi8MZVdpAWF6Jx24ApQvOp3KudDuUEC,fbPkOYLVPtPgIt0MxizjfFJov3JbHyAi,11,13,8,0,5,0,3,0,29,4.142857142857143,2,0.0,0,8,0,5,13,0,0,3,0,13,16,1
53,1937,vtrHNbtnxRGyZem1sSOdKIp109fZtSKY,fbPkOYLVPtPgIt0MxizjfFJov3JbHyAi,9,11,3,0,2,20,14,1,51,7.285714285714286,1,0.0,0,3,0,2,11,20,0,14,1,5,46,0
54,1944,FPtAc2MhfpwZkpPIx5xZqPDLAMDq2xlZ,fbPkOYLVPtPgIt0MxizjfFJov3JbHyAi,24,44,13,17,7,30,17,2,130,18.571428571428573,4,0.0,11,13,13,7,33,30,4,17,2,44,86,0
55,1946,oNX40hvUpCseO8BHKhGJvG2jyQpYKQyk,fbPkOYLVPtPgIt0MxizjfFJov3JbHyAi,6,4,3,0,3,0,1,0,11,1.5714285714285714,1,0.0,0,3,0,3,4,0,0,1,0,6,5,0
56,3978,h8n9HekAuyT08sLL5qmdMZ3BdSJVR4QF,fbPkOYLVPtPgIt0MxizjfFJov3JbHyAi,14,32,18,0,4,92,23,2,171,24.428571428571427,7,0.0,2,18,0,4,30,92,0,23,2,24,147,0
57,3979,2GATpIfDBYFyTgYmFkr0bda9mVfNXuAl,fbPkOYLVPtPgIt0MxizjfFJov3JbHyAi,20,62,21,12,16,0,13,0,124,17.714285714285715,4,0.0,15,21,12,16,47,0,0,13,0,64,60,0
58,3980,7CTS8g5RByDUjwfG52XdQusTnAWGmBhD,fbPkOYLVPtPgIt0MxizjfFJov3JbHyAi,7,5,3,0,3,0,5,0,16,2.2857142857142856,2,0.0,0,3,0,3,5,0,0,5,0,6,10,1
59,3981,fbTCtGbhuEEqIHlqmw0iRyoH7wNTYXlV,fbPkOYLVPtPgIt0MxizjfFJov3JbHyAi,7,3,2,0,2,0,3,0,10,1.4285714285714286,1,0.0,0,2,0,2,3,0,0,3,0,4,6,1
60,3983,eQnxTOv5tF733HrH1v8IIfXTQQ20WB86,fbPkOYLVPtPgIt0MxizjfFJov3JbHyAi,5,2,1,0,1,7,4,0,15,2.142857142857143,1,0.0,0,1,0,1,2,7,0,4,0,2,13,1
61,3984,oY9JHCaqebrwbBFVvySUXQvzoRiFSB12,fbPkOYLVPtPgIt0MxizjfFJov3JbHyAi,8,5,2,0,2,3,6,1,19,2.7142857142857144,1,0.0,2,2,0,2,3,3,0,6,1,6,13,1
62,3985,d4cb9OZbLbDBqzuhcJemwCaulhBw3XcA,fbPkOYLVPtPgIt0MxizjfFJov3JbHyAi,15,38,10,16,8,15,1,0,88,12.571428571428571,1,0.0,13,10,14,8,25,15,2,1,0,45,43,1
63,3996,w2cvWGtYDFIPnh2ovYoWa5sxrg1Qp0H1,fbPkOYLVPtPgIt0MxizjfFJov3JbHyAi,4,2,1,0,1,0,3,0,7,1.0,1,0.0,0,1,0,1,2,0,0,3,0,2,5,1
64,3997,ZoqTlt1YSWNa9KffVPpNehpQugTpP3Na,fbPkOYLVPtPgIt0MxizjfFJov3JbHyAi,18,14,9,0,8,0,12,0,43,6.142857142857143,2,0.0,0,9,0,8,14,0,0,12,0,17,26,1
65,3998,q4Yehmjs3jQT9rXdV6cXhcGjESMqINf5,fbPkOYLVPtPgIt0MxizjfFJov3JbHyAi,29,49,30,16,18,14,11,1,139,19.857142857142858,5,0.0,10,30,14,18,39,14,2,11,1,72,67,0
66,4004,guY4SSn1fy4TWThod7s2lBFrUtiOX15g,fbPkOYLVPtPgIt0MxizjfFJov3JbHyAi,17,10,7,0,6,0,4,0,27,3.857142857142857,3,0.0,0,7,0,6,10,0,0,4,0,13,14,1
67,4007,tfoakS3EMOjWuYWNRSgWZTjBxe3Mf9Te,fbPkOYLVPtPgIt0MxizjfFJov3JbHyAi,1,0,0,0,0,0,2,0,2,0.2857142857142857,2,0.0,0,0,0,0,0,0,0,2,0,0,2,0
68,4008,54s32diFNl04mUbmkn3h7tEt4XEhQ65w,fbPkOYLVPtPgIt0MxizjfFJov3JbHyAi,6,4,2,0,2,0,2,0,10,1.4285714285714286,1,0.0,1,2,0,2,3,0,0,2,0,5,5,0
69,4009,yQdl23AC4WuqLN6qLaK80XdAyoAoH1QK,fbPkOYLVPtPgIt0MxizjfFJov3JbHyAi,9,3,2,0,2,1,10,1,19,2.7142857142857144,1,0.0,0,2,0,2,3,1,0,10,1,4,15,1
70,4011,cHr4Ma0WfX0OLiO7JvZC8s1q3EauwDjN,fbPkOYLVPtPgIt0MxizjfFJov3JbHyAi,11,24,11,0,8,6,16,2,67,9.571428571428571,3,0.0,0,11,0,8,24,6,0,16,2,19,48,1
71,4012,bZSiNUbAIuydDBd77IMAJ15Hy6k2A1kT,fbPkOYLVPtPgIt0MxizjfFJov3JbHyAi,1,0,0,0,0,0,1,0,1,0.14285714285714285,1,0.0,0,0,0,0,0,0,0,1,0,0,1,1
72,4020,s7dtbhPs1iKqu788xCkGZggRAum1oJgW,fbPkOYLVPtPgIt0MxizjfFJov3JbHyAi,7,2,1,0,1,1,5,2,12,1.7142857142857142,1,0.0,0,1,0,1,2,1,0,5,2,2,10,1
73,4023,A98oANyiAwfle2kQ1TjJxeaYVrk9o9i7,fbPkOYLVPtPgIt0MxizjfFJov3JbHyAi,11,33,13,4,8,98,15,2,173,24.714285714285715,2,0.0,11,13,3,8,22,98,1,15,2,35,138,1
74,4027,WYF6gnZ4xRpre5Df26WMDKWFofwrAPRG,fbPkOYLVPtPgIt0MxizjfFJov3JbHyAi,11,57,0,4,0,19,19,1,100,14.285714285714286,6,0.0,7,0,4,0,50,19,0,19,1,11,89,1
75,4032,rLDet26H0uxPJ5dsCZ5fa0WL1GxwPxuK,fbPkOYLVPtPgIt0MxizjfFJov3JbHyAi,8,5,3,0,2,9,3,0,22,3.142857142857143,2,0.0,0,3,0,2,5,9,0,3,0,5,17,1
76,4033,OkJ0lKmMXuQ2MGftQ8Isfw1JciMpapRC,fbPkOYLVPtPgIt0MxizjfFJov3JbHyAi,5,3,2,0,2,2,2,0,11,1.5714285714285714,1,0.0,0,2,0,2,3,2,0,2,0,4,7,0
77,4034,rGQNVCuxfrzbvnkFPCMdRGiz6QMgyFzA,fbPkOYLVPtPgIt0MxizjfFJov3JbHyAi,6,5,2,0,3,0,1,0,11,1.5714285714285714,1,0.0,2,2,0,3,3,0,0,1,0,7,4,1
78,4037,87Lm8BclRnYN39dmpTmFhTgJtRlJLHVz,fbPkOYLVPtPgIt0MxizjfFJov3JbHyAi,5,2,1,0,1,0,2,0,6,0.8571428571428571,1,0.0,0,1,0,1,2,0,0,2,0,2,4,1
79,4038,RZRLmBfJaLV1U3x2iNOo982VF2lx4M5E,fbPkOYLVPtPgIt0MxizjfFJov3JbHyAi,3,8,0,0,0,25,3,0,36,5.142857142857143,4,0.0,0,0,0,0,8,25,0,3,0,0,36,0
80,4041,mmBEzZ1YFdSzzY513HhhaTI5HINoZNej,fbPkOYLVPtPgIt0MxizjfFJov3JbHyAi,6,3,0,0,0,0,5,0,8,1.1428571428571428,1,0.0,0,0,0,0,3,0,0,5,0,0,8,1
81,4043,AzVXW4kCWHtvQbdNXdZjm5qxnXDAkj3A,fbPkOYLVPtPgIt0MxizjfFJov3JbHyAi,7,5,2,0,2,0,2,0,11,1.5714285714285714,1,0.0,2,2,0,2,3,0,0,2,0,6,5,1
82,4045,hC8ztRi3EjwyWcSJecvgX15KmWpaGcdW,fbPkOYLVPtPgIt0MxizjfFJov3JbHyAi,2,0,0,0,0,0,13,0,13,1.8571428571428572,3,0.0,0,0,0,0,0,0,0,13,0,0,13,1
83,4047,lHHgniZkyeFRjJGU3HLkOi9ieHbZHJUQ,fbPkOYLVPtPgIt0MxizjfFJov3JbHyAi,4,2,0,0,0,0,2,0,4,0.5714285714285714,1,0.0,0,0,0,0,2,0,0,2,0,0,4,1
84,4049,L9qMLlGWAeAI6zWAZIyJtn0wISNa3dxg,fbPkOYLVPtPgIt0MxizjfFJov3JbHyAi,4,2,1,0,1,0,2,0,6,0.8571428571428571,2,0.0,0,1,0,1,2,0,0,2,0,2,4,1
85,4050,0MTpVXdT8ASYCb3Z08epLhiKNkl8GgEQ,fbPkOYLVPtPgIt0MxizjfFJov3JbHyAi,16,13,7,11,8,0,4,0,43,6.142857142857143,1,0.0,5,7,9,8,8,0,2,4,0,29,14,1
86,4051,cT78xvKkV1UFGcRKty0V03Jr4RRPh50F,fbPkOYLVPtPgIt0MxizjfFJov3JbHyAi,11,14,5,4,3,0,12,3,41,5.857142857142857,1,0.0,3,5,3,3,11,0,1,12,3,14,27,1
87,4053,AOW4X6UkiHewUAs5OuRwOBQZ55uoQosX,fbPkOYLVPtPgIt0MxizjfFJov3JbHyAi,8,4,2,0,1,2,8,1,18,2.5714285714285716,3,0.0,0,2,0,1,4,2,0,8,1,3,15,1
88,4055,rAB3GdBf2kyPvfhSALJZpfL3o8n2yfaM,fbPkOYLVPtPgIt0MxizjfFJov3JbHyAi,5,2,1,0,1,0,2,0,6,0.8571428571428571,1,0.0,0,1,0,1,2,0,0,2,0,2,4,1
89,4057,FsCZ2JlPdTOKccvkXXkGRkEo9MNtfR49,fbPkOYLVPtPgIt0MxizjfFJov3JbHyAi,4,2,1,0,1,0,1,0,5,0.7142857142857143,1,0.0,0,1,0,1,2,0,0,1,0,2,3,1
90,4058,CZqROpwtMfkuBimM2AQHyYwmYC0nRQMX,fbPkOYLVPtPgIt0MxizjfFJov3JbHyAi,2,0,0,0,0,0,6,0,6,0.8571428571428571,1,0.0,0,0,0,0,0,0,0,6,0,0,6,1
91,4059,k7E3UdMFCxZGbJkrqWFVZo27sTFlZitl,fbPkOYLVPtPgIt0MxizjfFJov3JbHyAi,2,0,0,0,0,0,4,0,4,0.5714285714285714,1,0.0,0,0,0,0,0,0,0,4,0,0,4,1
92,4063,DYy3OcZHNqaAwRPZTK5mmyz2pajxcVFG,fbPkOYLVPtPgIt0MxizjfFJov3JbHyAi,7,15,10,0,7,3,2,0,37,5.285714285714286,2,0.0,2,10,0,7,13,3,0,2,0,19,18,1
93,4067,etwrJvnLVRKl99lXJcTlVgF9a5u8b4IB,fbPkOYLVPtPgIt0MxizjfFJov3JbHyAi,4,2,1,0,1,0,1,0,5,0.7142857142857143,1,0.0,0,1,0,1,2,0,0,1,0,2,3,1
94,4068,Xtya7Ut5RfqXdKIJyeRno0pknCSJ0KQ9,fbPkOYLVPtPgIt0MxizjfFJov3JbHyAi,5,2,1,0,1,0,4,0,8,1.1428571428571428,1,0.0,0,1,0,1,2,0,0,4,0,2,6,1
95,4069,cvrniaRluzl5M2YhJj6gzVR22hfoNS7o,fbPkOYLVPtPgIt0MxizjfFJov3JbHyAi,5,2,1,0,1,0,3,0,7,1.0,1,0.0,0,1,0,1,2,0,0,3,0,2,5,1
96,4073,muLa1Vo0bC9fvm6n6sXrTQPXWjmeflat,fbPkOYLVPtPgIt0MxizjfFJov3JbHyAi,2,0,0,0,0,0,2,0,2,0.2857142857142857,1,0.0,0,0,0,0,0,0,0,2,0,0,2,0
97,4074,pPhnCYGqjbUED63FvqrsKWCb9oPSb13A,fbPkOYLVPtPgIt0MxizjfFJov3JbHyAi,8,6,4,0,3,4,5,0,22,3.142857142857143,1,0.0,0,4,0,3,6,4,0,5,0,7,15,1
98,4075,p9RSc47fxU5KZrLFjwRWdfPjsbrYYsbL,fbPkOYLVPtPgIt0MxizjfFJov3JbHyAi,17,36,11,20,10,26,16,1,120,17.142857142857142,4,0.0,12,11,16,10,24,26,4,16,1,49,71,1
99,4076,xyBRzNYMnXahEQBoehtwEHCPr5ttcqSy,fbPkOYLVPtPgIt0MxizjfFJov3JbHyAi,9,7,3,0,4,0,4,0,18,2.5714285714285716,1,0.0,3,3,0,4,4,0,0,4,0,10,8,1
100,4078,yZ6537rd8avkULuEwmDtoeWv0g2tI9No,fbPkOYLVPtPgIt0MxizjfFJov3JbHyAi,6,5,4,0,4,5,2,0,20,2.857142857142857,1,0.0,0,4,0,4,5,5,0,2,0,8,12,1
101,4079,k6RJ44LpfDefc4BqSfb5Ks3bqRLzpbPs,fbPkOYLVPtPgIt0MxizjfFJov3JbHyAi,4,2,1,0,1,0,2,0,6,0.8571428571428571,1,0.0,0,1,0,1,2,0,0,2,0,2,4,1
102,4080,wGCry3EmryoBv7Csae49tbGzHF0lQra2,fbPkOYLVPtPgIt0MxizjfFJov3JbHyAi,7,4,2,0,1,5,9,0,21,3.0,1,0.0,0,2,0,1,4,5,0,9,0,3,18,1
103,4082,Intzo0A8tpMyd3IA01YG1BctRIdPWdNV,fbPkOYLVPtPgIt0MxizjfFJov3JbHyAi,10,22,1,4,0,25,6,0,58,8.285714285714286,2,0.0,4,1,3,0,18,25,1,6,0,8,50,0
104,4085,kjoYyxOsZaiCA9S8PMK5B69QLaH15SYn,fbPkOYLVPtPgIt0MxizjfFJov3JbHyAi,10,19,12,0,6,21,9,0,67,9.571428571428571,4,0.0,0,12,0,6,19,21,0,9,0,18,49,1
105,4086,99KAycUWIde0VU3hu66xpS6f8Dw5XMUf,fbPkOYLVPtPgIt0MxizjfFJov3JbHyAi,6,3,0,0,0,9,5,1,18,2.5714285714285716,1,0.0,0,0,0,0,3,9,0,5,1,0,18,1
106,4087,kyUPY0MEVeZNvkmrQxOn0CHNXLZiD03b,fbPkOYLVPtPgIt0MxizjfFJov3JbHyAi,11,15,7,0,2,9,8,0,41,5.857142857142857,3,0.0,2,7,0,2,13,9,0,8,0,11,30,0
107,4089,xHHwDRtwZQVvSchbI5GuritLImybQBlY,fbPkOYLVPtPgIt0MxizjfFJov3JbHyAi,18,51,41,0,37,13,8,0,150,21.428571428571427,3,0.0,0,41,0,37,51,13,0,8,0,78,72,1
108,4092,FWBo1Ve6aUEc5FnBNwSlwL8Ejasy32Ah,fbPkOYLVPtPgIt0MxizjfFJov3JbHyAi,10,59,1,0,1,31,8,3,103,14.714285714285714,6,0.0,3,1,0,1,56,31,0,8,3,5,98,1
109,4094,aHy0SOLp5TIYEPrUDsA19thlT8zgE9kw,fbPkOYLVPtPgIt0MxizjfFJov3JbHyAi,7,3,2,0,2,0,2,0,9,1.2857142857142858,1,0.0,0,2,0,2,3,0,0,2,0,4,5,1
110,4096,7f5BucMg0feISwFBvqaHF0DKL8QG4WFt,fbPkOYLVPtPgIt0MxizjfFJov3JbHyAi,6,8,3,0,2,2,6,0,21,3.0,3,0.0,0,3,0,2,8,2,0,6,0,5,16,1
111,4098,7t6XdKZrxDN4lQnu2mS0b8xNunzNVAPj,fbPkOYLVPtPgIt0MxizjfFJov3JbHyAi,6,3,2,0,2,0,1,0,8,1.1428571428571428,1,0.0,0,2,0,2,3,0,0,1,0,4,4,1
112,4099,Rp1QUon6WyfjWJdUcBo02v2P6oL5StoN,fbPkOYLVPtPgIt0MxizjfFJov3JbHyAi,29,70,38,10,27,132,36,9,322,46.0,6,0.0,19,38,8,27,51,132,2,36,9,92,230,0
113,4100,biOEnvJNbNmJmtnLohBToN5g3ppQrMj4,fbPkOYLVPtPgIt0MxizjfFJov3JbHyAi,19,40,15,0,10,23,10,3,101,14.428571428571429,2,0.0,0,15,0,10,40,23,0,10,3,25,76,0
114,4102,DQcZziMBGJTQn4VwY66mMsTqydvYxO88,fbPkOYLVPtPgIt0MxizjfFJov3JbHyAi,12,22,14,1,5,4,8,0,54,7.714285714285714,4,0.0,1,14,1,5,21,4,0,8,0,21,33,1
115,4104,cT38CQfUVEuJ2lsb0Hk89Z8ENzEcFYoN,fbPkOYLVPtPgIt0MxizjfFJov3JbHyAi,11,12,3,4,4,17,15,5,60,8.571428571428571,1,0.0,6,3,3,4,6,17,1,15,5,16,44,1
116,4107,hXZgc5Oc8L3KNvO8ElQE29RF6Exzr76M,fbPkOYLVPtPgIt0MxizjfFJov3JbHyAi,18,133,7,10,7,18,19,0,194,27.714285714285715,7,0.0,27,7,10,7,106,18,0,19,0,51,143,1
117,4109,UTHVC9ResLri50kLlwVRolzN0EU0QbSV,fbPkOYLVPtPgIt0MxizjfFJov3JbHyAi,7,9,3,0,4,0,3,0,19,2.7142857142857144,1,0.0,4,3,0,4,5,0,0,3,0,11,8,1
118,4110,IhZdPOtOeXyg0OwsQIkD0XHc4IVBLzMp,fbPkOYLVPtPgIt0MxizjfFJov3JbHyAi,7,8,3,0,3,15,1,0,30,4.285714285714286,1,0.0,3,3,0,3,5,15,0,1,0,9,21,1
119,4115,JxLtKAnMek98G5fWpyeTaKlh0zheuNnU,fbPkOYLVPtPgIt0MxizjfFJov3JbHyAi,9,14,8,0,5,2,6,0,35,5.0,3,0.0,0,8,0,5,14,2,0,6,0,13,22,1
120,4118,lJBDlJfqpfLWNzA9gJNRBPGPdfnA8FjE,fbPkOYLVPtPgIt0MxizjfFJov3JbHyAi,11,14,4,5,5,0,10,0,38,5.428571428571429,2,0.0,6,4,4,5,8,0,1,10,0,19,19,1
121,4119,NDGD5kd43PPvwOqGnZbnmRA4IWxJUUWC,fbPkOYLVPtPgIt0MxizjfFJov3JbHyAi,11,10,6,0,5,13,5,1,40,5.714285714285714,1,0.0,0,6,0,5,10,13,0,5,1,11,29,1
122,4120,PLiz4R37f42hgWuNrDCM4We21NotfdFu,fbPkOYLVPtPgIt0MxizjfFJov3JbHyAi,10,8,3,0,3,0,4,0,18,2.5714285714285716,1,0.0,0,3,0,3,8,0,0,4,0,6,12,1
123,4123,v5fgLzwSp4csuplvg9kjWtplfkZ2GwCX,fbPkOYLVPtPgIt0MxizjfFJov3JbHyAi,28,47,25,23,14,48,21,1,179,25.571428571428573,6,0.0,8,25,22,14,39,48,1,21,1,69,110,1
124,4128,QFQlbn421RXpUzVVaKhkxpBlvQfTJy18,fbPkOYLVPtPgIt0MxizjfFJov3JbHyAi,1,0,0,0,0,0,2,0,2,0.2857142857142857,2,0.0,0,0,0,0,0,0,0,2,0,0,2,1
125,4131,IeoenmsgL9uI9DnVMbUVvL3IGBjOCvft,fbPkOYLVPtPgIt0MxizjfFJov3JbHyAi,7,22,10,0,6,6,4,0,48,6.857142857142857,2,0.0,1,10,0,6,21,6,0,4,0,17,31,1
126,4132,0EnifHYs46yDInpwwIuVTnoLaWAcGzwI,fbPkOYLVPtPgIt0MxizjfFJov3JbHyAi,2,0,0,0,0,0,7,0,7,1.0,1,0.0,0,0,0,0,0,0,0,7,0,0,7,1
127,4139,KGmMkFplDRCxys7XWInR8BCBSZINLZGV,fbPkOYLVPtPgIt0MxizjfFJov3JbHyAi,7,3,2,0,2,0,6,0,13,1.8571428571428572,1,0.0,0,2,0,2,3,0,0,6,0,4,9,1
128,4142,lnvoZ2tnJVetz4XYfY83aKXEsZTCt6TJ,fbPkOYLVPtPgIt0MxizjfFJov3JbHyAi,5,2,1,0,1,0,2,0,6,0.8571428571428571,1,0.0,0,1,0,1,2,0,0,2,0,2,4,1
129,4144,8FXCmdqVnzf3TYAPHoGg8tXyARiNLHCI,fbPkOYLVPtPgIt0MxizjfFJov3JbHyAi,14,31,22,0,12,5,18,1,89,12.714285714285714,2,0.0,2,22,0,12,29,5,0,18,1,36,53,1
130,4151,Ke8VwfqDMnQ67aDANakOnH0vYOFJh9kP,fbPkOYLVPtPgIt0MxizjfFJov3JbHyAi,5,2,0,0,0,0,4,0,6,0.8571428571428571,1,0.0,0,0,0,0,2,0,0,4,0,0,6,1
131,4153,9bv4TssyKs6woXSaEFvigyhEyIkdO1mQ,fbPkOYLVPtPgIt0MxizjfFJov3JbHyAi,22,58,26,5,18,6,21,1,135,19.285714285714285,6,0.0,16,26,5,18,42,6,0,21,1,65,70,1
132,4154,P7HoHyQzVXLghYr6m3MYTEIsDQbHfDfp,fbPkOYLVPtPgIt0MxizjfFJov3JbHyAi,5,2,1,0,1,2,3,0,9,1.2857142857142858,1,0.0,0,1,0,1,2,2,0,3,0,2,7,1
133,4156,7wnX5auEB03UpnNYej7D6uFMFlr0UMF4,fbPkOYLVPtPgIt0MxizjfFJov3JbHyAi,26,47,12,24,17,43,19,1,163,23.285714285714285,4,0.0,22,12,18,17,25,43,6,19,1,69,94,1
134,4158,i2lUV72IHqqXWYqLFMWv3y4XGmlq2lXa,fbPkOYLVPtPgIt0MxizjfFJov3JbHyAi,6,13,7,0,0,0,9,0,29,4.142857142857143,4,0.0,2,7,0,0,11,0,0,9,0,9,20,0
135,4159,K7x1FBngM9kl9ILUtVAk9JDodBBRiKnk,fbPkOYLVPtPgIt0MxizjfFJov3JbHyAi,5,2,0,0,1,0,2,0,5,0.7142857142857143,1,0.0,0,0,0,1,2,0,0,2,0,1,4,1
136,4165,PQXXfcguNvwGC13fUA8grymIl8Xku68T,fbPkOYLVPtPgIt0MxizjfFJov3JbHyAi,8,5,4,0,1,4,9,1,24,3.4285714285714284,1,0.0,0,4,0,1,5,4,0,9,1,5,19,1
137,4166,bUnyK1hKhmXoEcHzbj5c3xR9U7XUAY5Y,fbPkOYLVPtPgIt0MxizjfFJov3JbHyAi,11,17,4,0,4,4,0,0,29,4.142857142857143,2,0.0,3,4,0,4,14,4,0,0,0,11,18,1
138,4167,1LwHP3062AHKmQwDl3FPlP3B3adaBvx7,fbPkOYLVPtPgIt0MxizjfFJov3JbHyAi,13,7,4,0,4,0,9,1,25,3.5714285714285716,3,0.0,0,4,0,4,7,0,0,9,1,8,17,1
139,4189,DMRT6aSto1hsV85RHmev1d5IWcNMIFEq,SpATywNh6bZuzm8s1ceuBUnMUAeoAHHw,15,21,10,6,2,19,7,0,65,9.285714285714286,4,0.0,7,10,6,2,14,19,0,7,0,25,40,0
140,4191,s0DIFg7W3dnddXITKcNP8LHUkKIQHugk,A3fsA9Zfv1X2fVEQhTw51lKENdNrEqT3,11,5,3,0,3,0,3,1,15,2.142857142857143,1,0.0,0,3,0,3,5,0,0,3,1,6,9,0
141,4240,bN6JhUz4s97Xsh7eq2ZH1ilTMaKJDuUF,A3fsA9Zfv1X2fVEQhTw51lKENdNrEqT3,44,83,41,62,25,39,19,2,271,38.714285714285715,4,0.0,3,41,50,25,80,39,12,19,2,119,152,1
142,4257,7FYMj2bFfaTXHKfoaKa59KqAPXY4BWgD,SpATywNh6bZuzm8s1ceuBUnMUAeoAHHw,14,16,10,13,3,0,3,0,45,6.428571428571429,1,0.0,2,10,12,3,14,0,1,3,0,27,18,0
143,4264,I91CCtQfetYUPwkEXIvTFBP6tbrp1spN,SpATywNh6bZuzm8s1ceuBUnMUAeoAHHw,7,3,2,0,1,1,3,1,11,1.5714285714285714,1,0.0,0,2,0,1,3,1,0,3,1,3,8,0
144,4315,BQkLFspAkEwZRgeuoSbQxFTr6POAaRzP,SpATywNh6bZuzm8s1ceuBUnMUAeoAHHw,9,13,2,23,0,5,3,3,49,7.0,1,0.0,9,2,20,0,4,5,3,3,3,31,18,0
145,4363,TQnfaXCRCgVZx9kYYn4s6Q3eXGXW2mAu,SpATywNh6bZuzm8s1ceuBUnMUAeoAHHw,13,19,1,16,0,76,9,2,123,17.571428571428573,2,0.0,6,1,13,0,13,76,3,9,2,20,103,0
146,4367,5I2aLwWP8vG6g175Y3fJi9X9n53v6aCn,SpATywNh6bZuzm8s1ceuBUnMUAeoAHHw,17,63,39,26,13,150,35,3,329,47.0,5,0.0,12,39,19,13,51,150,7,35,3,83,246,1
147,4380,5GeMwmyzCXMcMYfcWdKaXbpNNdL8bmPq,bWdj2GDclj5ofokWjzoa5jAwMkxCykd6,20,34,15,42,6,34,22,1,154,22.0,5,0.0,7,15,34,6,27,34,8,22,1,62,92,0
148,4385,wzrtLsMLUwSE1eXDXVMESg2JjrWZl4JD,SpATywNh6bZuzm8s1ceuBUnMUAeoAHHw,4,4,1,0,0,0,1,0,6,0.8571428571428571,1,0.0,0,1,0,0,4,0,0,1,0,1,5,0
149,4438,3IgwuZBiVdgdYRQ9ySaEvpMizbjCJFS0,SpATywNh6bZuzm8s1ceuBUnMUAeoAHHw,17,31,11,8,4,38,18,1,111,15.857142857142858,4,0.0,11,11,8,4,20,38,0,18,1,34,77,0
150,4460,oxOzo82Nq65tcwE6AZvxglw3lN8SeywJ,bWdj2GDclj5ofokWjzoa5jAwMkxCykd6,17,30,15,104,9,0,8,0,166,23.714285714285715,2,0.0,7,15,98,9,23,0,6,8,0,129,37,1
151,4471,lEIFkqeT396JMSPUyiaHNMN8g7bQ1x9p,RXDvfPUBYFlVdlueBFbLW0mhhAyGEqpt,2,0,0,0,0,0,3,0,3,0.42857142857142855,1,0.0,0,0,0,0,0,0,0,3,0,0,3,0
152,4492,800Nw5pvfdV7zCXCGav7KOLaYLAdOKht,SpATywNh6bZuzm8s1ceuBUnMUAeoAHHw,16,63,2,17,1,48,63,1,195,27.857142857142858,6,0.0,14,2,17,1,49,48,0,63,1,34,161,0
153,4494,wONMmUHIYwPBmEB9lgpOY3KCldKiuZFl,G8EPVSXsOYB5YQWZGiz1aVq5Pgr2GrQu,16,18,13,0,6,7,22,2,68,9.714285714285714,4,0.0,0,13,0,6,18,7,0,22,2,19,49,0
154,4557,s4xNNQ4RZ35amMfmvZawsu7u8CabnIey,A3fsA9Zfv1X2fVEQhTw51lKENdNrEqT3,46,33,22,78,12,79,29,2,255,36.42857142857143,3,0.0,4,22,61,12,29,79,17,29,2,99,156,0
155,4558,oxOzo82Nq65tcwE6AZvxglw3lN8SeywJ,A3fsA9Zfv1X2fVEQhTw51lKENdNrEqT3,6,5,2,0,1,0,3,0,11,1.5714285714285714,1,0.0,0,2,0,1,5,0,0,3,0,3,8,1
156,4562,sOkc0wEXSSLpxtxlqjZObJqg94IyLpuY,bWdj2GDclj5ofokWjzoa5jAwMkxCykd6,17,37,1,40,0,17,20,1,116,16.571428571428573,5,0.0,6,1,38,0,31,17,2,20,1,45,71,1
157,4576,alnogGpZqhBWQHh6ZLeZUIXk896ksLOu,RXDvfPUBYFlVdlueBFbLW0mhhAyGEqpt,14,29,1,2,1,4,15,3,55,7.857142857142857,3,0.0,2,1,2,1,27,4,0,15,3,6,49,1
158,4580,PUW0i4IuafllkJEtV0GCqmTDeLHkDmH3,A3fsA9Zfv1X2fVEQhTw51lKENdNrEqT3,39,66,2,77,2,191,44,2,384,54.857142857142854,6,0.0,2,2,59,2,64,191,18,44,2,65,319,0
159,4639,3OcDTnCwcizCpcOtz2UR6tflsBOvlv2R,SpATywNh6bZuzm8s1ceuBUnMUAeoAHHw,16,38,2,18,1,1,24,2,86,12.285714285714286,4,0.0,9,2,16,1,29,1,2,24,2,28,58,0
160,4654,DsHgWZRTJ1y1l15smwhB78ZQq3d8dyKP,SpATywNh6bZuzm8s1ceuBUnMUAeoAHHw,16,69,2,27,2,26,23,3,152,21.714285714285715,5,0.0,19,2,23,2,50,26,4,23,3,46,106,0
161,4668,r5RSR6lot2jmkfKvV1hMDjuwwaPyA58W,SpATywNh6bZuzm8s1ceuBUnMUAeoAHHw,10,12,5,0,3,0,6,0,26,3.7142857142857144,1,0.0,0,5,0,3,12,0,0,6,0,8,18,0
162,4678,SXmv5BCLsa8KcmJ2wx7Xg5CRI8Gu1aDd,bWdj2GDclj5ofokWjzoa5jAwMkxCykd6,10,32,15,0,7,19,10,0,83,11.857142857142858,2,0.0,0,15,0,7,32,19,0,10,0,22,61,0
163,4682,a59vIKGy87nbLYAxp6cxkmNDzOYhSXnX,SpATywNh6bZuzm8s1ceuBUnMUAeoAHHw,16,24,17,18,9,0,10,0,78,11.142857142857142,3,0.0,2,17,15,9,22,0,3,10,0,43,35,1
164,4699,7xdvqdjwrTcnpU47VRFtnMnSYVyjOAaR,SpATywNh6bZuzm8s1ceuBUnMUAeoAHHw,10,13,2,12,0,0,2,0,29,4.142857142857143,2,0.0,2,2,12,0,11,0,0,2,0,16,13,0
165,4701,eg4vjaGd0e6Yp3fu5azU2ZqedIZ6GBxl,SpATywNh6bZuzm8s1ceuBUnMUAeoAHHw,15,32,2,14,0,1,15,2,66,9.428571428571429,4,0.0,14,2,10,0,18,1,4,15,2,26,40,0
166,4703,C8ZlatATbcer8D4Z8pCX4rv1Rcx870po,RXDvfPUBYFlVdlueBFbLW0mhhAyGEqpt,12,15,5,0,2,0,12,0,34,4.857142857142857,3,0.0,0,5,0,2,15,0,0,12,0,7,27,0
167,4810,2LtuchYgE8Pco2t6mZeF2PkyT5iYJ1L1,SpATywNh6bZuzm8s1ceuBUnMUAeoAHHw,11,10,0,6,0,29,3,0,48,6.857142857142857,1,0.0,2,0,6,0,8,29,0,3,0,8,40,0
168,4828,f2h2VLvmMjqsSE1GgoTjiV7kOBQ7ba5D,SpATywNh6bZuzm8s1ceuBUnMUAeoAHHw,16,29,8,19,5,11,6,0,78,11.142857142857142,2,0.0,18,8,17,5,11,11,2,6,0,48,30,0
169,4862,9k6Repn2h6zXTygwvpy8LAM7GzTSYQBm,G8EPVSXsOYB5YQWZGiz1aVq5Pgr2GrQu,63,88,48,102,32,8,10,2,290,41.42857142857143,3,0.0,34,48,79,32,54,8,23,10,2,193,97,0
170,4866,GmHJt2279LUj6P2OGQD6V5Y1W95kmZpl,SpATywNh6bZuzm8s1ceuBUnMUAeoAHHw,12,31,4,7,0,0,13,0,55,7.857142857142857,3,0.0,0,4,7,0,31,0,0,13,0,11,44,1
171,4870,T2tyjiaDe9s4tWUugE6FZTShWofnfMqo,bWdj2GDclj5ofokWjzoa5jAwMkxCykd6,9,21,2,58,1,9,4,1,96,13.714285714285714,2,0.0,12,2,56,1,9,9,2,4,1,71,25,0
172,4885,sOkc0wEXSSLpxtxlqjZObJqg94IyLpuY,A3fsA9Zfv1X2fVEQhTw51lKENdNrEqT3,16,27,1,0,1,5,14,0,48,6.857142857142857,4,0.0,0,1,0,1,27,5,0,14,0,2,46,0
173,4918,QDpN8D19Mr8RZumTONWpZNlCWcHCCTbH,A3fsA9Zfv1X2fVEQhTw51lKENdNrEqT3,1,0,0,0,0,0,1,0,1,0.14285714285714285,1,0.0,0,0,0,0,0,0,0,1,0,0,1,0
174,4945,ySy2zYThCkVZr5MjEXuKxq60wfOynxkJ,SpATywNh6bZuzm8s1ceuBUnMUAeoAHHw,14,33,0,19,0,24,20,2,98,14.0,3,0.0,4,0,16,0,29,24,3,20,2,20,78,0
175,4946,SVwfCRY50hd9Fz0klab9XqT7QROcyhqY,SpATywNh6bZuzm8s1ceuBUnMUAeoAHHw,5,4,3,0,1,0,1,0,9,1.2857142857142858,1,0.0,0,3,0,1,4,0,0,1,0,4,5,0
176,4950,QIQydLQKNp8IAhwJcWzcTMkwBUNbfwOF,SpATywNh6bZuzm8s1ceuBUnMUAeoAHHw,14,32,2,14,0,12,9,1,70,10.0,4,0.0,15,2,14,0,17,12,0,9,1,31,39,0
177,4991,meJV5qRzmJA836PpWZKeoFo4ZX1xiQOS,RXDvfPUBYFlVdlueBFbLW0mhhAyGEqpt,15,21,9,8,5,5,4,0,52,7.428571428571429,3,0.0,2,9,8,5,19,5,0,4,0,24,28,1
178,5020,7kNYuUNvdIVdadzDsnKIKM0Ln3KLHYo2,SpATywNh6bZuzm8s1ceuBUnMUAeoAHHw,18,52,17,20,6,25,41,5,166,23.714285714285715,5,0.0,17,17,16,6,35,25,4,41,5,56,110,1
179,5022,QCXbyb2FyuLlETPxf3u27tgIYTs9gTM4,SpATywNh6bZuzm8s1ceuBUnMUAeoAHHw,17,30,8,20,3,31,11,1,104,14.857142857142858,3,0.0,16,8,16,3,14,31,4,11,1,43,61,0
180,5031,6Qw49dxLKsjbapN7r9Da43ajoDW7rCxT,G8EPVSXsOYB5YQWZGiz1aVq5Pgr2GrQu,15,39,25,8,3,365,40,12,492,70.28571428571429,7,0.0,4,25,4,3,35,365,4,40,12,36,456,0
181,5096,rsMqzQV4BJo2NdhTX79HDXS5zRZgLPX5,SpATywNh6bZuzm8s1ceuBUnMUAeoAHHw,14,11,7,19,4,1,3,0,45,6.428571428571429,1,0.0,4,7,18,4,7,1,1,3,0,33,12,0
182,5142,B6vCUtkVL8SVuEEWctSPinCUr9rxihnh,G8EPVSXsOYB5YQWZGiz1aVq5Pgr2GrQu,7,9,3,0,3,2,2,0,19,2.7142857142857144,1,0.0,5,3,0,3,4,2,0,2,0,11,8,0
183,5153,JiVwV8l6zLIAeTDli3uYE3CMxT1oG8Me,SpATywNh6bZuzm8s1ceuBUnMUAeoAHHw,13,17,3,18,1,0,10,0,49,7.0,3,0.0,6,3,15,1,11,0,3,10,0,25,24,0
184,5173,d6aHeIWZcsirh8eDlHrmG2KrUzDWnJuj,A3fsA9Zfv1X2fVEQhTw51lKENdNrEqT3,10,4,3,0,3,0,3,0,13,1.8571428571428572,1,0.0,0,3,0,3,4,0,0,3,0,6,7,1
185,5217,EP1XQRGS4HZOG1hdGzNZdD1HFhJcHpos,RXDvfPUBYFlVdlueBFbLW0mhhAyGEqpt,39,26,1,74,0,12,7,0,120,17.142857142857142,2,0.0,8,1,70,0,18,12,4,7,0,79,41,0
186,5224,vEkraIjbJw9RkPvqczZeJYSVVtpO2PkE,G8EPVSXsOYB5YQWZGiz1aVq5Pgr2GrQu,10,9,4,0,6,0,9,0,28,4.0,2,0.0,5,4,0,6,4,0,0,9,0,15,13,1
187,5259,hdKqkkWKrDzbKE9btGChBqiCfsTwp68E,bWdj2GDclj5ofokWjzoa5jAwMkxCykd6,10,17,8,4,3,0,12,0,44,6.285714285714286,4,0.0,1,8,3,3,16,0,1,12,0,15,29,0
188,5303,o9EVHnUUU8I3f9dlC8NAcnHlKvZOnRmy,bWdj2GDclj5ofokWjzoa5jAwMkxCykd6,11,9,1,24,1,0,1,0,36,5.142857142857143,1,0.0,3,1,21,1,6,0,3,1,0,26,10,0
189,5305,o9EVHnUUU8I3f9dlC8NAcnHlKvZOnRmy,A3fsA9Zfv1X2fVEQhTw51lKENdNrEqT3,35,24,0,40,0,16,11,1,92,13.142857142857142,3,0.0,1,0,39,0,23,16,1,11,1,40,52,0
190,5310,OMEL4ay2FeLAUvBpF5PNfopRFoBTNYW8,SpATywNh6bZuzm8s1ceuBUnMUAeoAHHw,10,16,0,11,0,0,2,0,29,4.142857142857143,2,0.0,7,0,10,0,9,0,1,2,0,17,12,0
191,5319,hDWTDNoM8bIQS3Q25EYxxHniqW2wmxDn,bWdj2GDclj5ofokWjzoa5jAwMkxCykd6,9,6,3,0,2,1,4,1,17,2.4285714285714284,1,0.0,0,3,0,2,6,1,0,4,1,5,12,0
192,5332,DJ09O49b2a0ZKXkFKbGfN66X8003c5sz,SpATywNh6bZuzm8s1ceuBUnMUAeoAHHw,6,15,9,0,1,0,5,0,30,4.285714285714286,4,0.0,0,9,0,1,15,0,0,5,0,10,20,1
193,5345,Kssd3yKtVgKi0ua0svvR8GgbZwRwIJMZ,SpATywNh6bZuzm8s1ceuBUnMUAeoAHHw,14,33,0,6,0,13,10,2,64,9.142857142857142,3,0.0,11,0,6,0,22,13,0,10,2,17,47,0
194,5363,WXWUGznWk133hcEltnw7lYbm2oVZoXLf,SpATywNh6bZuzm8s1ceuBUnMUAeoAHHw,18,68,12,15,4,17,25,24,165,23.571428571428573,2,0.0,4,12,14,4,64,17,1,25,24,34,131,1
195,5390,NL3IFunZJHMkqSLqiaHHbVIge1Bdgn26,G8EPVSXsOYB5YQWZGiz1aVq5Pgr2GrQu,26,61,23,36,12,26,17,2,177,25.285714285714285,2,0.0,29,23,27,12,32,26,9,17,2,91,86,0
196,5392,Tj9gyzxktEEAGnL07HQ3qbd2V0oCt16o,SpATywNh6bZuzm8s1ceuBUnMUAeoAHHw,17,57,16,11,3,75,39,8,209,29.857142857142858,5,0.0,12,16,10,3,45,75,1,39,8,41,168,0
197,5397,I6gFU4rZZ1rIaEMk0n0tBNQZ2tGcnjLw,SpATywNh6bZuzm8s1ceuBUnMUAeoAHHw,16,31,14,21,10,0,9,0,85,12.142857142857142,3,0.0,16,14,18,10,15,0,3,9,0,58,27,0
198,5414,4qM7n65VbCTp8lq3dbzhDmImmEZcwgn8,A3fsA9Zfv1X2fVEQhTw51lKENdNrEqT3,19,39,2,0,1,28,26,2,98,14.0,3,0.0,3,2,0,1,36,28,0,26,2,6,92,0
199,5454,3ZzNkdWgGb47Go07PRKPf0XZ6jjhVCB4,bWdj2GDclj5ofokWjzoa5jAwMkxCykd6,10,19,8,16,7,0,6,0,56,8.0,3,0.0,6,8,14,7,13,0,2,6,0,35,21,0
200,5458,YOkiW0yIzjAwppKQnKaeEhWktVPNCIFb,A3fsA9Zfv1X2fVEQhTw51lKENdNrEqT3,19,9,5,36,4,1,2,0,57,8.142857142857142,2,0.0,1,5,29,4,8,1,7,2,0,39,18,1
201,5472,OLX98cHycOH1FdInwYYk8PZBVFPyIkIG,SpATywNh6bZuzm8s1ceuBUnMUAeoAHHw,14,22,6,10,3,0,4,0,45,6.428571428571429,2,0.0,15,6,10,3,7,0,0,4,0,34,11,0
202,5486,TMdqZjFm6eGvpWCVvOj8xDCqkoxEsWlO,RXDvfPUBYFlVdlueBFbLW0mhhAyGEqpt,10,11,7,0,3,0,2,0,23,3.2857142857142856,2,0.0,0,7,0,3,11,0,0,2,0,10,13,1
203,5499,F2owRK2SDPW5FCDK4TxmBVHsTtJ44Nxq,SpATywNh6bZuzm8s1ceuBUnMUAeoAHHw,9,15,0,9,0,0,2,1,27,3.857142857142857,1,0.0,11,0,8,0,4,0,1,2,1,19,8,1
204,5511,YTuPtoiiUgMUEO0EcQhHENEgNCcauWbW,SpATywNh6bZuzm8s1ceuBUnMUAeoAHHw,1,0,0,0,0,0,2,0,2,0.2857142857142857,2,0.0,0,0,0,0,0,0,0,2,0,0,2,1
205,5535,0N8Aw17N0N8m1sn7piRGEu1YkeZIgvRo,SpATywNh6bZuzm8s1ceuBUnMUAeoAHHw,8,5,4,0,4,0,1,0,14,2.0,1,0.0,0,4,0,4,5,0,0,1,0,8,6,0
206,5554,C6xrhZPOmVH2gCVNP26gSSPka2CcwgB5,A3fsA9Zfv1X2fVEQhTw51lKENdNrEqT3,21,12,10,16,7,0,9,0,54,7.714285714285714,3,0.0,2,10,15,7,10,0,1,9,0,34,20,1
207,5568,w1PJeTTskG2DF1TtLUpuz9MkqxNdq5EB,bWdj2GDclj5ofokWjzoa5jAwMkxCykd6,16,31,7,74,3,0,15,3,133,19.0,1,0.0,15,7,72,3,16,0,2,15,3,97,36,1
208,5573,GdXLROZTUYTypGrrX0BjPE53M0Un36D7,SpATywNh6bZuzm8s1ceuBUnMUAeoAHHw,17,52,13,16,5,44,23,5,158,22.571428571428573,3,0.0,26,13,16,5,26,44,0,23,5,60,98,1
209,5582,kKBIfyZmN22zBj263eKBa0SA1U5xYMsR,SpATywNh6bZuzm8s1ceuBUnMUAeoAHHw,13,26,4,11,0,159,18,5,223,31.857142857142858,3,0.0,2,4,10,0,24,159,1,18,5,16,207,0
210,5605,k2w7Fl2HRg9SZoDIHFnK8RXCKuBBE2y7,bWdj2GDclj5ofokWjzoa5jAwMkxCykd6,20,43,18,28,6,180,33,2,310,44.285714285714285,6,0.0,7,18,24,6,36,180,4,33,2,55,255,0
211,5620,ZOxTwY2wRpdYn3qbKBoyT1PgdUitZ7Hl,RXDvfPUBYFlVdlueBFbLW0mhhAyGEqpt,26,32,18,8,7,10,11,0,86,12.285714285714286,2,0.0,0,18,8,7,32,10,0,11,0,33,53,1
212,5645,UCDPR1k7RkPBDIde3KiukiosB55WbRVo,A3fsA9Zfv1X2fVEQhTw51lKENdNrEqT3,8,5,2,0,2,0,2,0,11,1.5714285714285714,2,0.0,0,2,0,2,5,0,0,2,0,4,7,1
213,5692,KtQYnyrETXqJCvCxj7ZUnFcjZBBdiT7G,SpATywNh6bZuzm8s1ceuBUnMUAeoAHHw,18,18,8,16,4,10,8,1,65,9.285714285714286,1,0.0,5,8,14,4,13,10,2,8,1,31,34,0
214,5726,tzyyAYK7Q2hNPhv988H6lH5D7hdM24rK,SpATywNh6bZuzm8s1ceuBUnMUAeoAHHw,12,9,4,12,3,0,1,0,29,4.142857142857143,1,0.0,4,4,12,3,5,0,0,1,0,23,6,0
215,5745,PpMDt0ql3KtH4YMuxusWOnbL4LfspwvV,A3fsA9Zfv1X2fVEQhTw51lKENdNrEqT3,13,11,9,0,8,0,2,0,30,4.285714285714286,2,0.0,0,9,0,8,11,0,0,2,0,17,13,1
216,5775,TO8Y79YghtROlTlvlXU7LRtpWyGNF6ec,SpATywNh6bZuzm8s1ceuBUnMUAeoAHHw,13,18,7,25,4,0,1,0,55,7.857142857142857,1,0.0,8,7,21,4,10,0,4,1,0,40,15,1
217,5778,A3AW3c7i1MF6oyHBEYvrXWvBxZwqeuYh,SpATywNh6bZuzm8s1ceuBUnMUAeoAHHw,13,10,2,15,1,21,12,2,63,9.0,2,0.0,2,2,12,1,8,21,3,12,2,17,46,0
218,5782,hjUSUM6roI2mLGkMAqBjE0uxFRBSMYHJ,A3fsA9Zfv1X2fVEQhTw51lKENdNrEqT3,37,38,31,50,17,2,8,0,146,20.857142857142858,3,0.0,0,31,39,17,38,2,11,8,0,87,59,1
219,5796,8tzllCaQFf5FO2XcYgqoYiMGBjUwujYx,SpATywNh6bZuzm8s1ceuBUnMUAeoAHHw,9,14,1,0,1,0,5,3,24,3.4285714285714284,1,0.0,2,1,0,1,12,0,0,5,3,4,20,1
220,5859,pGMnNtuqcZlCojrlW4Qh2PIHblJQmotx,SpATywNh6bZuzm8s1ceuBUnMUAeoAHHw,16,20,6,15,3,1,5,1,51,7.285714285714286,1,0.0,13,6,14,3,7,1,1,5,1,36,15,1
221,5904,L4jaFu0vxNsfaC1OhafSk08ztmq6goZk,SpATywNh6bZuzm8s1ceuBUnMUAeoAHHw,10,25,8,0,4,0,8,0,45,6.428571428571429,3,0.0,0,8,0,4,25,0,0,8,0,12,33,0
222,5925,sc5S8mzwcw7LbcetViv5Dahuhyet4uF1,A3fsA9Zfv1X2fVEQhTw51lKENdNrEqT3,29,16,7,74,2,4,10,2,115,16.428571428571427,1,0.0,6,7,64,2,10,4,10,10,2,79,36,1
223,6000,2mD1u3b1vLrSJM0DZTrsvLcZVBVwwd27,RXDvfPUBYFlVdlueBFbLW0mhhAyGEqpt,14,9,9,0,7,2,4,0,31,4.428571428571429,2,0.0,0,9,0,7,9,2,0,4,0,16,15,0
224,6010,gEPTO2jN7POX6QtJlMdktFPT74irRyFu,SpATywNh6bZuzm8s1ceuBUnMUAeoAHHw,15,27,13,16,9,18,6,0,89,12.714285714285714,6,0.0,8,13,14,9,19,18,2,6,0,44,45,0
225,6060,1gK3jCeXNxEbn9wGz2jRwqB6S5hBMDkt,bWdj2GDclj5ofokWjzoa5jAwMkxCykd6,19,42,17,82,12,27,10,1,191,27.285714285714285,1,0.0,8,17,78,12,34,27,4,10,1,115,76,1
226,6075,4pJCNd3c3ApEtuK2GDe7eGNzOhsu04W5,G8EPVSXsOYB5YQWZGiz1aVq5Pgr2GrQu,32,70,40,66,2,260,51,5,494,70.57142857142857,7,0.0,8,40,48,2,62,260,18,51,5,98,396,0
227,6102,DJPrQ8k1R0aSF2q32X8eWoHfRxJjw6WA,SpATywNh6bZuzm8s1ceuBUnMUAeoAHHw,14,16,11,0,6,1,11,7,52,7.428571428571429,1,0.0,1,11,0,6,15,1,0,11,7,18,34,1
228,6105,lVM3D8yPmd62Fdb29hI2YI0VPwlNvI4t,A3fsA9Zfv1X2fVEQhTw51lKENdNrEqT3,2,0,0,0,0,0,7,0,7,1.0,3,0.0,0,0,0,0,0,0,0,7,0,0,7,1
229,6108,WWWH5rGgnKzcRMEBKWqCKBbIYZVZp9Wi,SpATywNh6bZuzm8s1ceuBUnMUAeoAHHw,5,2,1,0,1,0,2,0,6,0.8571428571428571,1,0.0,0,1,0,1,2,0,0,2,0,2,4,0
230,6114,PIxnueIZLpBbMAAHbhlsEVGPkWRYGpMI,RXDvfPUBYFlVdlueBFbLW0mhhAyGEqpt,14,17,1,0,0,1,11,0,30,4.285714285714286,2,0.0,0,1,0,0,17,1,0,11,0,1,29,0
231,6123,onsmNYIoPFEi185f5ZLsQXD70I3K25Cb,A3fsA9Zfv1X2fVEQhTw51lKENdNrEqT3,23,41,24,0,14,8,9,1,97,13.857142857142858,1,0.0,2,24,0,14,39,8,0,9,1,40,57,1
232,6140,IBg4xmPqhTfP3qhSQ0m2yOJeGxXoGyqu,RXDvfPUBYFlVdlueBFbLW0mhhAyGEqpt,48,50,29,123,16,193,78,12,501,71.57142857142857,7,0.0,17,29,116,16,33,193,7,78,12,178,323,0
233,6168,H2ZjrPimYfiWwdYkdNOPsZZk83kbIBCz,bWdj2GDclj5ofokWjzoa5jAwMkxCykd6,4,2,0,0,0,0,3,0,5,0.7142857142857143,1,0.0,0,0,0,0,2,0,0,3,0,0,5,1
234,6185,rowlJHASOW6yJNtP0z67l2i9CtJCMokD,SpATywNh6bZuzm8s1ceuBUnMUAeoAHHw,13,14,1,18,0,0,11,3,47,6.714285714285714,3,0.0,4,1,15,0,10,0,3,11,3,20,27,0
235,6192,uFKxt8ud4wgPXsnEMlnj4koWPrsJIWsU,SpATywNh6bZuzm8s1ceuBUnMUAeoAHHw,15,35,6,16,1,15,17,1,91,13.0,4,0.0,10,6,15,1,25,15,1,17,1,32,59,0
236,6271,q2xQCstASp96wpspi8iqsuaqJ7gzfsux,A3fsA9Zfv1X2fVEQhTw51lKENdNrEqT3,24,14,11,34,0,0,1,0,60,8.571428571428571,1,0.0,0,11,30,0,14,0,4,1,0,41,19,0
237,6273,pP1hwdPGxzBA8F4ZSgJiv9MEvr2pc047,SpATywNh6bZuzm8s1ceuBUnMUAeoAHHw,14,52,3,9,0,51,43,2,160,22.857142857142858,4,0.0,15,3,9,0,37,51,0,43,2,27,133,1
238,6306,Q8L1mPYwfiwtGo48PB0N9B5ppVi0px10,SpATywNh6bZuzm8s1ceuBUnMUAeoAHHw,17,37,16,18,6,4,18,0,99,14.142857142857142,2,0.0,16,16,15,6,21,4,3,18,0,53,46,0
239,6317,3Bw18YJt9vJt2emNNJ6GnWW50YrVLdEa,bWdj2GDclj5ofokWjzoa5jAwMkxCykd6,7,3,1,0,0,0,7,0,11,1.5714285714285714,2,0.0,0,1,0,0,3,0,0,7,0,1,10,0
240,6347,TAjGGV7oJgeUhPcj5Eum0tnVYrY7qjOE,RXDvfPUBYFlVdlueBFbLW0mhhAyGEqpt,22,24,12,50,5,1,11,0,103,14.714285714285714,3,0.0,7,12,42,5,17,1,8,11,0,66,37,0
241,6357,Aay6TeSPyFLmKNsg9Z4tXGnlIddPmJBP,SpATywNh6bZuzm8s1ceuBUnMUAeoAHHw,4,6,0,0,0,0,1,0,7,1.0,1,0.0,0,0,0,0,6,0,0,1,0,0,7,1
242,6368,Fa7tOqP1WKllvNDMgvUWmTzPr8J8vhy8,A3fsA9Zfv1X2fVEQhTw51lKENdNrEqT3,42,16,12,64,9,0,6,0,107,15.285714285714286,3,0.0,1,12,58,9,15,0,6,6,0,80,27,1
243,6424,SmSrrYBj6KLZ39TqXb57CVWv6gX6sF7Q,SpATywNh6bZuzm8s1ceuBUnMUAeoAHHw,18,31,8,18,3,3,14,8,85,12.142857142857142,1,0.0,17,8,15,3,14,3,3,14,8,43,42,0
244,6435,nFeXukK9uLZggTwgBm3mDIxskaBXISqn,SpATywNh6bZuzm8s1ceuBUnMUAeoAHHw,11,22,7,16,0,0,2,0,47,6.714285714285714,6,0.0,2,7,14,0,20,0,2,2,0,23,24,1
245,6448,yau38b5UXLNmzsSxrtZsXYfKt6l52ZSP,A3fsA9Zfv1X2fVEQhTw51lKENdNrEqT3,10,23,1,0,0,0,3,0,27,3.857142857142857,2,0.0,1,1,0,0,22,0,0,3,0,2,25,0
246,6466,GUIjXzC11NU91af1UN0XPnms1Mnty0es,G8EPVSXsOYB5YQWZGiz1aVq5Pgr2GrQu,9,5,4,0,3,0,3,0,15,2.142857142857143,1,0.0,0,4,0,3,5,0,0,3,0,7,8,1
247,6488,aYhMdR5xaez3fr0lBrD6kCxYiCOyculR,RXDvfPUBYFlVdlueBFbLW0mhhAyGEqpt,28,76,45,10,5,1388,58,111,1693,241.85714285714286,7,0.0,10,45,5,5,66,1388,5,58,111,65,1628,0
248,6516,1CrVBOpFvr6rOy553Xrye0bjPdL11eu8,RXDvfPUBYFlVdlueBFbLW0mhhAyGEqpt,45,72,37,61,14,11,17,2,214,30.571428571428573,5,0.0,9,37,57,14,63,11,4,17,2,117,97,0
249,6517,7u3azzypzNqPYEFxf0DcbGOgDVhkOXos,A3fsA9Zfv1X2fVEQhTw51lKENdNrEqT3,32,9,6,44,4,0,15,1,79,11.285714285714286,3,0.0,1,6,42,4,8,0,2,15,1,53,26,0
250,6528,97yjJniO9qlZAjgn3gm4HXnkbwnHzt9O,SpATywNh6bZuzm8s1ceuBUnMUAeoAHHw,8,6,2,0,2,0,4,0,14,2.0,1,0.0,0,2,0,2,6,0,0,4,0,4,10,1
251,6535,tuBxNlu8Vf06uK8sXGF2P17UeyGdHKNN,SpATywNh6bZuzm8s1ceuBUnMUAeoAHHw,12,14,9,4,3,0,4,0,34,4.857142857142857,2,0.0,0,9,3,3,14,0,1,4,0,15,19,1
252,6574,09vierxoREaD4msGgreYQSyOiGeSiZdQ,SpATywNh6bZuzm8s1ceuBUnMUAeoAHHw,9,20,12,0,7,0,3,0,42,6.0,2,0.0,0,12,0,7,20,0,0,3,0,19,23,0
253,6587,Y89GJdSZUpoYFMgx00SCe6qFoYoXIpUj,A3fsA9Zfv1X2fVEQhTw51lKENdNrEqT3,24,37,1,40,0,0,2,0,80,11.428571428571429,1,0.0,0,1,37,0,37,0,3,2,0,38,42,0
254,6643,lDflzmK9F6H42Kj6EtaBezWOcB4UUWiV,SpATywNh6bZuzm8s1ceuBUnMUAeoAHHw,18,22,12,6,7,4,12,1,64,9.142857142857142,4,0.0,6,12,6,7,16,4,0,12,1,31,33,0
255,6685,mfQ48K9Gnf187sLZBiTNegL6UkMDsKbJ,SpATywNh6bZuzm8s1ceuBUnMUAeoAHHw,11,12,1,0,0,0,7,1,21,3.0,1,0.0,3,1,0,0,9,0,0,7,1,4,17,0
256,6760,yh14zaFitCUTgvBPqRXiaZ6cUijtktL4,A3fsA9Zfv1X2fVEQhTw51lKENdNrEqT3,4,7,0,0,0,0,3,0,10,1.4285714285714286,1,0.0,3,0,0,0,4,0,0,3,0,3,7,1
257,6816,dSloiolTuQA1YnIVrIEZb5m23cL24cRw,A3fsA9Zfv1X2fVEQhTw51lKENdNrEqT3,26,43,3,34,2,5,14,1,102,14.571428571428571,2,0.0,5,3,29,2,38,5,5,14,1,39,63,1
258,6824,e12uQn96OlYfknMdqSXCXdImglIj4IRR,bWdj2GDclj5ofokWjzoa5jAwMkxCykd6,12,18,10,0,6,24,22,4,84,12.0,1,0.0,2,10,0,6,16,24,0,22,4,18,66,0
259,6835,05hxkbgK0IX5639oITtQjU5YEEUBb8L1,SpATywNh6bZuzm8s1ceuBUnMUAeoAHHw,11,20,1,0,1,0,7,1,30,4.285714285714286,1,0.0,2,1,0,1,18,0,0,7,1,4,26,0
260,6838,AyhJARh0xhxObM9zhvUdDxlTCtu309eW,SpATywNh6bZuzm8s1ceuBUnMUAeoAHHw,13,22,13,12,7,63,5,0,122,17.428571428571427,3,0.0,4,13,12,7,18,63,0,5,0,36,86,1
261,6881,jzWvwaTexkgbyBrPkQbXDb98Viqx6cSS,G8EPVSXsOYB5YQWZGiz1aVq5Pgr2GrQu,19,18,5,30,4,5,9,1,72,10.285714285714286,3,0.0,11,5,23,4,7,5,7,9,1,43,29,1
262,6914,5XorWInOikFQGiy06qBvCZ6iOgBDDoJu,SpATywNh6bZuzm8s1ceuBUnMUAeoAHHw,12,16,10,0,8,0,6,0,40,5.714285714285714,2,0.0,2,10,0,8,14,0,0,6,0,20,20,0
263,6938,a6f3gPi6axX0cfBnUGVliBDQrPx92l1r,A3fsA9Zfv1X2fVEQhTw51lKENdNrEqT3,40,62,40,134,33,1,5,0,275,39.285714285714285,3,0.0,9,40,114,33,53,1,20,5,0,196,79,1
264,6956,ykaUPJW4Nc9r2mv4b25QxgdHgIcQ63RQ,SpATywNh6bZuzm8s1ceuBUnMUAeoAHHw,8,18,3,15,0,13,1,0,50,7.142857142857143,2,0.0,13,3,14,0,5,13,1,1,0,30,20,0
265,6969,YfVqOdQV9ZXJgq8aC5ARPHksMFUwqOvU,SpATywNh6bZuzm8s1ceuBUnMUAeoAHHw,13,11,7,0,4,4,14,0,40,5.714285714285714,1,0.0,0,7,0,4,11,4,0,14,0,11,29,1
266,6981,Pp5JJMKWhHjqXDQq6vl852N5LskPEcDA,bWdj2GDclj5ofokWjzoa5jAwMkxCykd6,16,27,7,54,8,0,3,0,99,14.142857142857142,2,0.0,18,7,49,8,9,0,5,3,0,82,17,1
267,6983,7fC3V6ivG07wUIMOmiYFzSlyjWvbYnYf,A3fsA9Zfv1X2fVEQhTw51lKENdNrEqT3,35,26,2,90,2,2,9,0,131,18.714285714285715,3,0.0,2,2,72,2,24,2,18,9,0,78,53,0
268,6985,Pp5JJMKWhHjqXDQq6vl852N5LskPEcDA,A3fsA9Zfv1X2fVEQhTw51lKENdNrEqT3,4,2,1,0,1,0,2,0,6,0.8571428571428571,1,0.0,0,1,0,1,2,0,0,2,0,2,4,1
269,6989,QXMWMAYLhXvptULktpThtcXNRQ6JansN,SpATywNh6bZuzm8s1ceuBUnMUAeoAHHw,16,41,16,8,4,15,25,0,109,15.571428571428571,6,0.0,12,16,8,4,29,15,0,25,0,40,69,0
270,7020,43QhXZfKBBZHpTmjLSVuTzbc6djzr40d,SpATywNh6bZuzm8s1ceuBUnMUAeoAHHw,13,34,1,12,1,11,13,0,72,10.285714285714286,2,0.0,8,1,11,1,26,11,1,13,0,21,51,0
271,7085,UrENN1zIfJIc4hCxDDWe8c7coKokiTdF,A3fsA9Zfv1X2fVEQhTw51lKENdNrEqT3,6,4,3,0,3,0,1,0,11,1.5714285714285714,2,0.0,0,3,0,3,4,0,0,1,0,6,5,1
272,7107,oBmksukoqTKiKpWhco7hv7dHpVNhiTm0,SpATywNh6bZuzm8s1ceuBUnMUAeoAHHw,11,10,0,7,0,0,4,0,21,3.0,1,0.0,3,0,7,0,7,0,0,4,0,10,11,1
273,7119,03YAuQnjuYjTWwgHqE1110CZpZwknRbj,RXDvfPUBYFlVdlueBFbLW0mhhAyGEqpt,48,25,16,113,9,1,8,1,173,24.714285714285715,1,0.0,8,16,108,9,17,1,5,8,1,141,32,0
274,7138,tJ7FzaUMbzSP2K4BtZobNqzCoEbllcH1,RXDvfPUBYFlVdlueBFbLW0mhhAyGEqpt,36,93,52,66,2,442,159,890,1704,243.42857142857142,7,0.0,9,52,65,2,84,442,1,159,890,128,1576,0
275,7143,ahFkMpqRNclNalhsRFgKmc75UZfOTdgQ,SpATywNh6bZuzm8s1ceuBUnMUAeoAHHw,18,19,10,10,3,5,12,2,61,8.714285714285714,3,0.0,7,10,9,3,12,5,1,12,2,29,32,1
276,7151,2QwHrFxGcIFGuR6TyUnlExhchaRL2Ipx,SpATywNh6bZuzm8s1ceuBUnMUAeoAHHw,16,55,7,19,2,14,17,1,115,16.428571428571427,7,0.0,24,7,17,2,31,14,2,17,1,50,65,0
277,7225,WixZusYrasZzR9owXlaQpXrbIZeJOheR,SpATywNh6bZuzm8s1ceuBUnMUAeoAHHw,12,10,5,0,3,3,6,1,28,4.0,2,0.0,3,5,0,3,7,3,0,6,1,11,17,0
278,7246,WixZusYrasZzR9owXlaQpXrbIZeJOheR,RXDvfPUBYFlVdlueBFbLW0mhhAyGEqpt,1,0,0,0,0,0,1,0,1,0.14285714285714285,1,0.0,0,0,0,0,0,0,0,1,0,0,1,1
279,7283,K5Sy6doI03r5uctdEcvObhW1bpzNGROt,G8EPVSXsOYB5YQWZGiz1aVq5Pgr2GrQu,26,31,15,22,6,7,17,1,99,14.142857142857142,2,0.0,1,15,16,6,30,7,6,17,1,38,61,0
280,7304,VSEOcWZYpZiKC2PUmidzj4VqbBnc3GAo,A3fsA9Zfv1X2fVEQhTw51lKENdNrEqT3,25,11,4,52,0,6,39,0,112,16.0,5,0.0,4,4,46,0,7,6,6,39,0,54,58,0
281,7332,5kqorcxIJejDFcc1de7q3uie94xFSgMJ,SpATywNh6bZuzm8s1ceuBUnMUAeoAHHw,16,42,20,9,3,3,8,0,85,12.142857142857142,3,0.0,14,20,9,3,28,3,0,8,0,46,39,0
282,7337,J5FkxM9o8L4y51xbaKwQjZuay8KpJMzH,SpATywNh6bZuzm8s1ceuBUnMUAeoAHHw,15,31,0,18,0,13,10,1,73,10.428571428571429,4,0.0,17,0,15,0,14,13,3,10,1,32,41,1
283,7345,B9KqNNxXBxHFUsJnQKQysblL3f8zF7sg,bWdj2GDclj5ofokWjzoa5jAwMkxCykd6,9,11,2,0,2,0,3,0,18,2.5714285714285716,2,0.0,3,2,0,2,8,0,0,3,0,7,11,0
284,7348,5a7fehAo0Ol3kwHzhNqAYRGEzPLIE5FD,SpATywNh6bZuzm8s1ceuBUnMUAeoAHHw,14,15,9,11,5,2,7,0,49,7.0,2,0.0,2,9,10,5,13,2,1,7,0,26,23,1
285,7364,84Vq27rxsidbGJFxLO0cd5e2CSiXRChu,A3fsA9Zfv1X2fVEQhTw51lKENdNrEqT3,24,32,22,0,10,3,15,2,84,12.0,5,0.0,2,22,0,10,30,3,0,15,2,34,50,1
286,7380,y4ROZxtUW2SffaQ3DMgCK81r0GDNLnMO,SpATywNh6bZuzm8s1ceuBUnMUAeoAHHw,17,16,7,9,3,2,7,1,45,6.428571428571429,4,0.0,5,7,8,3,11,2,1,7,1,23,22,0
287,7387,u82lBhpDxJIwlZISEntCxj1zgVFdW0vT,SpATywNh6bZuzm8s1ceuBUnMUAeoAHHw,18,106,46,20,18,103,32,2,327,46.714285714285715,6,0.0,44,46,15,18,62,103,5,32,2,123,204,0
288,7402,XESEnxXOxYn0sEg8u7X5S27rymbaMzNA,SpATywNh6bZuzm8s1ceuBUnMUAeoAHHw,14,15,8,12,5,0,9,0,49,7.0,3,0.0,2,8,10,5,13,0,2,9,0,25,24,0
289,7405,thbVK5OkB13GLXnOCtBegvQeqDmjraYm,SpATywNh6bZuzm8s1ceuBUnMUAeoAHHw,16,19,8,12,4,2,4,0,49,7.0,1,0.0,9,8,11,4,10,2,1,4,0,32,17,0
290,7425,AV3xIWfwsQ5uGH8Qf1BwlVsUBUI5kjl1,SpATywNh6bZuzm8s1ceuBUnMUAeoAHHw,8,11,2,0,1,0,8,0,22,3.142857142857143,2,0.0,0,2,0,1,11,0,0,8,0,3,19,1
291,7445,mawBMWVaMDuwBgxqJlSNvSnxuZmWfWRW,SpATywNh6bZuzm8s1ceuBUnMUAeoAHHw,16,44,21,10,5,4,16,0,100,14.285714285714286,5,0.0,6,21,9,5,38,4,1,16,0,41,59,0
292,7456,1CrVBOpFvr6rOy553Xrye0bjPdL11eu8,A3fsA9Zfv1X2fVEQhTw51lKENdNrEqT3,42,36,20,36,11,3,11,0,117,16.714285714285715,3,0.0,5,20,36,11,31,3,0,11,0,72,45,0
293,7470,zwtc7XYkGr4Bhsl8UEIZlPO0o9lpzfSZ,A3fsA9Zfv1X2fVEQhTw51lKENdNrEqT3,40,45,20,58,11,0,10,0,144,20.571428571428573,4,0.0,1,20,54,11,44,0,4,10,0,86,58,0
294,7477,5DIcniD9kRbDupVPBNugV5by0SZHtD2e,SpATywNh6bZuzm8s1ceuBUnMUAeoAHHw,10,19,3,0,2,2,12,2,40,5.714285714285714,3,0.0,0,3,0,2,19,2,0,12,2,5,35,0
295,7484,ZghgmsFKGlL396BKFJoJeIy2X7crdnN0,SpATywNh6bZuzm8s1ceuBUnMUAeoAHHw,17,47,15,27,4,36,22,4,155,22.142857142857142,2,0.0,26,15,21,4,21,36,6,22,4,66,89,0
296,7489,uUSTKM8g1hIskJbYHh1UiIQ6epHTSTNR,bWdj2GDclj5ofokWjzoa5jAwMkxCykd6,16,30,15,30,5,3,12,0,95,13.571428571428571,5,0.0,3,15,28,5,27,3,2,12,0,51,44,1
297,7490,uUSTKM8g1hIskJbYHh1UiIQ6epHTSTNR,G8EPVSXsOYB5YQWZGiz1aVq5Pgr2GrQu,83,90,32,182,17,3,11,1,336,48.0,2,0.0,53,32,127,17,37,3,55,11,1,229,107,0
298,7494,CSp8QkNZa6B12LzJipxPFgC5w6lKLtbn,RXDvfPUBYFlVdlueBFbLW0mhhAyGEqpt,19,42,4,19,5,0,5,0,75,10.714285714285714,1,0.0,9,4,17,5,33,0,2,5,0,35,40,0
299,7497,guprsx2yFQ5jOFQRa2OmDTvoe1Qtus0L,SpATywNh6bZuzm8s1ceuBUnMUAeoAHHw,8,7,3,0,2,0,3,0,15,2.142857142857143,1,0.0,0,3,0,2,7,0,0,3,0,5,10,1
300,7500,BQwuBUR4WYRdCAVoQUNUZK3Ln34YX0iv,SpATywNh6bZuzm8s1ceuBUnMUAeoAHHw,18,38,21,13,12,15,26,6,131,18.714285714285715,4,0.0,10,21,11,12,28,15,2,26,6,54,77,1
301,7505,1sFJ1Szdx1WU21TgC1PRv3tkQ09H4qed,SpATywNh6bZuzm8s1ceuBUnMUAeoAHHw,1,0,0,0,0,0,1,0,1,0.14285714285714285,1,0.0,0,0,0,0,0,0,0,1,0,0,1,1
302,7524,UNtI3N6D9AZsFIjfiItWfMe73uBfp0VS,SpATywNh6bZuzm8s1ceuBUnMUAeoAHHw,14,18,8,17,5,0,8,0,56,8.0,3,0.0,9,8,16,5,9,0,1,8,0,38,18,0
303,7541,CGIwACA114zcxKI2ZiGPCkXleQcVHz2y,SpATywNh6bZuzm8s1ceuBUnMUAeoAHHw,13,24,4,11,1,18,9,1,68,9.714285714285714,3,0.0,12,4,11,1,12,18,0,9,1,28,40,0
304,7543,fGIeAB7IRJCHxzCo8u4GLaPKxQfHeCdi,SpATywNh6bZuzm8s1ceuBUnMUAeoAHHw,17,57,26,16,11,0,23,0,133,19.0,3,0.0,8,26,14,11,49,0,2,23,0,59,74,0
305,7551,dnay2jAX3cgskuo0IcUq4nB4ZOtSKU5x,SpATywNh6bZuzm8s1ceuBUnMUAeoAHHw,15,30,11,14,5,0,6,0,66,9.428571428571429,3,0.0,7,11,13,5,23,0,1,6,0,36,30,0
306,7554,eO5CgKdvPHZfZ8krv7wlSTYp2EdmZAmV,RXDvfPUBYFlVdlueBFbLW0mhhAyGEqpt,26,66,4,12,5,2,16,6,111,15.857142857142858,2,0.0,12,4,12,5,54,2,0,16,6,33,78,1
307,7586,40eiF3ZEuOYP1RP6XBUcW4OUQFmNxf9i,SpATywNh6bZuzm8s1ceuBUnMUAeoAHHw,18,16,8,17,3,5,10,2,61,8.714285714285714,2,0.0,4,8,14,3,12,5,3,10,2,29,32,0
308,7587,wEaTyOJwwvOCk7eUttQISK5WPXL7ANNV,SpATywNh6bZuzm8s1ceuBUnMUAeoAHHw,16,22,9,21,3,14,9,2,80,11.428571428571429,2,0.0,5,9,18,3,17,14,3,9,2,35,45,0
309,7616,PcrKUgtxZcGXBYkLOmECh99m3fhAOabf,SpATywNh6bZuzm8s1ceuBUnMUAeoAHHw,14,54,23,21,5,3,8,0,114,16.285714285714285,1,0.0,12,23,17,5,42,3,4,8,0,57,57,0
310,7623,uRIMG7KJWhHO81Kf9MvAfUFzZC6juL3s,bWdj2GDclj5ofokWjzoa5jAwMkxCykd6,12,13,6,50,4,9,3,0,85,12.142857142857142,3,0.0,4,6,48,4,9,9,2,3,0,62,23,0
311,7649,cauH4YekuRKFsHZgdw9jChinljVOhzCP,SpATywNh6bZuzm8s1ceuBUnMUAeoAHHw,4,2,0,0,0,0,2,0,4,0.5714285714285714,1,0.0,0,0,0,0,2,0,0,2,0,0,4,1
312,7651,HL6JESJ9UfnK7mtp7EsklcgEKja4gTaC,RXDvfPUBYFlVdlueBFbLW0mhhAyGEqpt,41,51,2,58,9,10,5,0,135,19.285714285714285,1,0.0,25,2,56,9,26,10,2,5,0,92,43,1
313,7656,v9Jp2iBPSFTVxP8FrUe1odwfz8Hd1wS3,SpATywNh6bZuzm8s1ceuBUnMUAeoAHHw,15,20,9,6,4,27,9,0,75,10.714285714285714,3,0.0,8,9,6,4,12,27,0,9,0,27,48,0
314,7659,1KSlK2xXHUc3PjC1CsQEQaomGBagqDXf,A3fsA9Zfv1X2fVEQhTw51lKENdNrEqT3,12,6,5,0,5,0,1,0,17,2.4285714285714284,2,0.0,0,5,0,5,6,0,0,1,0,10,7,1
315,7670,NKzNFHK6LaJqjMec69ZX5HfBigF4yyJV,SpATywNh6bZuzm8s1ceuBUnMUAeoAHHw,15,12,6,6,4,6,10,1,45,6.428571428571429,1,0.0,5,6,6,4,7,6,0,10,1,21,24,0
316,7677,HPp2Yy992FcBIXDjeQl0bEftbV1QFRDS,SpATywNh6bZuzm8s1ceuBUnMUAeoAHHw,18,34,11,23,3,19,13,3,106,15.142857142857142,2,0.0,16,11,19,3,18,19,4,13,3,49,57,0
317,7683,uydIb4MWCn95KWcEhKwj3VRfjvxXo8Nj,A3fsA9Zfv1X2fVEQhTw51lKENdNrEqT3,28,93,51,20,2,490,108,4,768,109.71428571428571,7,0.0,8,51,18,2,85,490,2,108,4,79,689,0
318,7694,a6f3gPi6axX0cfBnUGVliBDQrPx92l1r,SpATywNh6bZuzm8s1ceuBUnMUAeoAHHw,11,18,14,9,9,0,4,0,54,7.714285714285714,3,0.0,0,14,7,9,18,0,2,4,0,30,24,0
319,7701,f81JJCqMlkJdA9lV7uQBviuGlLm2CDkR,SpATywNh6bZuzm8s1ceuBUnMUAeoAHHw,15,37,2,25,2,12,11,0,89,12.714285714285714,2,0.0,15,2,19,2,22,12,6,11,0,38,51,0
320,7720,LyBG9vpZvAGsIKFzeD4gB6XRCVzk12fF,A3fsA9Zfv1X2fVEQhTw51lKENdNrEqT3,13,7,6,10,4,0,5,0,32,4.571428571428571,1,0.0,0,6,9,4,7,0,1,5,0,19,13,1
321,7729,xkt3K6JWpnfeixDBdwkLXaHgXuuGt35v,A3fsA9Zfv1X2fVEQhTw51lKENdNrEqT3,36,24,17,54,9,2,12,0,118,16.857142857142858,3,0.0,1,17,49,9,23,2,5,12,0,76,42,1
322,7731,ZD844NRFhgHqwskHd8pIBuIwDiTAY4NC,SpATywNh6bZuzm8s1ceuBUnMUAeoAHHw,14,16,11,21,8,4,2,0,62,8.857142857142858,1,0.0,3,11,17,8,13,4,4,2,0,39,23,0
323,7766,3kfsZtV93tVXeg8YtF9PTasYswVdOeLx,SpATywNh6bZuzm8s1ceuBUnMUAeoAHHw,16,33,20,20,7,2,15,0,97,13.857142857142858,5,0.0,4,20,16,7,29,2,4,15,0,47,50,0
324,7767,GcInGCXKYnNWAnYbqUyxJe7hi4ZjhElg,RXDvfPUBYFlVdlueBFbLW0mhhAyGEqpt,12,11,4,8,4,0,4,0,31,4.428571428571429,2,0.0,2,4,8,4,9,0,0,4,0,18,13,1
325,7771,Rdvgrardg53H2oeCgmOt8vFxIUu5nogb,SpATywNh6bZuzm8s1ceuBUnMUAeoAHHw,15,23,12,14,7,1,5,0,62,8.857142857142858,3,0.0,4,12,11,7,19,1,3,5,0,34,28,0
326,7774,EQU3KQKmF0NpNwQmPmUw90ptahwADmIz,SpATywNh6bZuzm8s1ceuBUnMUAeoAHHw,13,36,3,0,1,3,20,1,64,9.142857142857142,3,0.0,13,3,0,1,23,3,0,20,1,17,47,1
327,7778,moK1GdnqoYxhSRCf5a95lgXdVNdzYrjs,A3fsA9Zfv1X2fVEQhTw51lKENdNrEqT3,37,56,6,44,5,10,39,0,160,22.857142857142858,4,0.0,1,6,42,5,55,10,2,39,0,54,106,0
328,7781,h1PVCD4diCwozuU4ZjcMLdFycUmYpSIc,G8EPVSXsOYB5YQWZGiz1aVq5Pgr2GrQu,30,22,8,58,4,1,11,1,105,15.0,1,0.0,10,8,42,4,12,1,16,11,1,64,41,0
329,7786,7aA6BrVZipLHOrozlrYBMEmfMq4MXahq,RXDvfPUBYFlVdlueBFbLW0mhhAyGEqpt,45,162,54,87,38,25,44,3,413,59.0,6,0.0,22,54,76,38,140,25,11,44,3,190,223,0
330,7789,pdotXwlXOl4cuEJn7TjzheQq2EZaH9qB,SpATywNh6bZuzm8s1ceuBUnMUAeoAHHw,5,3,0,0,0,0,2,0,5,0.7142857142857143,1,0.0,0,0,0,0,3,0,0,2,0,0,5,1
331,7793,z2zhro5MCTuNkAWXNKBS5L7zEtJc0Vs9,SpATywNh6bZuzm8s1ceuBUnMUAeoAHHw,16,76,23,18,7,175,62,14,375,53.57142857142857,5,0.0,22,23,15,7,54,175,3,62,14,67,308,0
332,7820,tcrOs8a5NYKg0fcf0qJ4buK5RKIEFS5o,RXDvfPUBYFlVdlueBFbLW0mhhAyGEqpt,43,29,13,107,8,0,4,0,161,23.0,2,0.0,7,13,102,8,22,0,5,4,0,130,31,0
333,7831,SozLQk8695JG7fvj1Enp26s5ACJQjjq5,SpATywNh6bZuzm8s1ceuBUnMUAeoAHHw,17,16,9,10,4,20,12,1,72,10.285714285714286,1,0.0,2,9,9,4,14,20,1,12,1,24,48,0
334,7844,cSB2xmj1Zot5hgCLSHhxDNISJzHyYsXf,SpATywNh6bZuzm8s1ceuBUnMUAeoAHHw,9,13,3,0,1,0,10,0,27,3.857142857142857,2,0.0,0,3,0,1,13,0,0,10,0,4,23,1
335,7869,34oDxV5jJfVaGWSsgPNGJP2ott7rJu7I,SpATywNh6bZuzm8s1ceuBUnMUAeoAHHw,13,45,25,14,20,0,3,0,107,15.285714285714286,1,0.0,12,25,14,20,33,0,0,3,0,71,36,0
336,7872,ZosutOeXAHBSIvZIuIxhmKGfV7JZESP5,SpATywNh6bZuzm8s1ceuBUnMUAeoAHHw,14,10,4,1,4,1,25,1,46,6.571428571428571,2,0.0,5,4,1,4,5,1,0,25,1,14,32,0
337,7916,TIvBCmMDquWj2iwTixxUP6A3HzcrQyq3,SpATywNh6bZuzm8s1ceuBUnMUAeoAHHw,18,38,15,14,4,48,67,5,191,27.285714285714285,6,0.0,7,15,11,4,31,48,3,67,5,37,154,0
338,7932,Dm0fTQ5hQ4vZLMdCz8HpFheMP2yCMt3n,SpATywNh6bZuzm8s1ceuBUnMUAeoAHHw,6,6,4,0,3,0,3,1,17,2.4285714285714284,1,0.0,0,4,0,3,6,0,0,3,1,7,10,0
339,7971,Y7KMNxUWz3B2grUtFCf2FgfpqFMvSy0l,G8EPVSXsOYB5YQWZGiz1aVq5Pgr2GrQu,6,0,0,0,0,9,6,0,15,2.142857142857143,1,0.0,0,0,0,0,0,9,0,6,0,0,15,0
340,8012,jagu0OJDhWTGFhfCMk0ghqluLpW3kzdC,SpATywNh6bZuzm8s1ceuBUnMUAeoAHHw,15,13,7,14,3,1,9,0,47,6.714285714285714,2,0.0,3,7,11,3,10,1,3,9,0,24,23,0
341,8035,Q7WmsII1N0h11nYfhimDkafAIQtH8FBe,A3fsA9Zfv1X2fVEQhTw51lKENdNrEqT3,27,16,11,0,9,3,12,2,53,7.571428571428571,1,0.0,3,11,0,9,13,3,0,12,2,23,30,1
342,8040,IjI8O6qhXWrzvoHGjD0jKSLTrkjwywnZ,SpATywNh6bZuzm8s1ceuBUnMUAeoAHHw,12,22,0,21,0,31,7,0,81,11.571428571428571,2,0.0,16,0,18,0,6,31,3,7,0,34,47,0
343,8042,XDPvGyFLLEYwbNEQik2MM4yiADs5rrYJ,SpATywNh6bZuzm8s1ceuBUnMUAeoAHHw,5,5,2,0,1,5,1,0,14,2.0,1,0.0,2,2,0,1,3,5,0,1,0,5,9,1
344,8048,lPfsYctvOlk2KshSTR0YzF9fsG0sDcXm,SpATywNh6bZuzm8s1ceuBUnMUAeoAHHw,18,28,9,27,4,7,8,1,84,12.0,2,0.0,16,9,21,4,12,7,6,8,1,50,34,0
345,8054,3nOS3JEH08BgwunQqioyEFfja4qIND4p,SpATywNh6bZuzm8s1ceuBUnMUAeoAHHw,4,2,1,0,1,0,1,0,5,0.7142857142857143,1,0.0,0,1,0,1,2,0,0,1,0,2,3,1
346,8090,cXITZ8Hjmr6myIyBLbDLY8s8nux0OPPJ,SpATywNh6bZuzm8s1ceuBUnMUAeoAHHw,6,7,2,0,0,0,6,0,15,2.142857142857143,1,0.0,0,2,0,0,7,0,0,6,0,2,13,1
347,8108,D8ad6YCP4S8e1UHCQjU17HMPa0udSxjF,A3fsA9Zfv1X2fVEQhTw51lKENdNrEqT3,37,10,8,64,5,12,17,2,118,16.857142857142858,2,0.0,1,8,60,5,9,12,4,17,2,74,44,1
348,8145,ZDVmuYiPoGm0gu1bR2BaE1soF6dU5v1W,A3fsA9Zfv1X2fVEQhTw51lKENdNrEqT3,6,13,9,0,0,0,2,0,24,3.4285714285714284,1,0.0,0,9,0,0,13,0,0,2,0,9,15,1
349,8148,nx1z63DgmeEAxW8gQgEbpcNs34kbRne4,A3fsA9Zfv1X2fVEQhTw51lKENdNrEqT3,4,1,1,0,0,0,3,0,5,0.7142857142857143,1,0.0,0,1,0,0,1,0,0,3,0,1,4,1
350,8166,eOxm8XEI11Xs6eiBi1Nu5QzIagZXwEm9,SpATywNh6bZuzm8s1ceuBUnMUAeoAHHw,16,28,18,19,3,80,11,0,159,22.714285714285715,6,0.0,3,18,17,3,25,80,2,11,0,41,118,0
351,8168,jtxvuHBV8ZOgNnNCL1A1WerzR2TVfFNy,A3fsA9Zfv1X2fVEQhTw51lKENdNrEqT3,40,21,15,62,11,0,2,0,111,15.857142857142858,1,0.0,3,15,52,11,18,0,10,2,0,81,30,1
352,8188,XpMzbdWNf7VknZxctjGvDzxNpyCLWCaP,SpATywNh6bZuzm8s1ceuBUnMUAeoAHHw,17,27,8,16,4,1,12,2,70,10.0,2,0.0,13,8,15,4,14,1,1,12,2,40,30,1
353,8243,VAe2acDlYib7o05H0M3tg4gQoc5gLI96,SpATywNh6bZuzm8s1ceuBUnMUAeoAHHw,8,6,2,0,0,0,5,1,14,2.0,1,0.0,1,2,0,0,5,0,0,5,1,3,11,1
354,8254,rD3x5Ovuza1MLiqkvaHksaL42hepSLSa,bWdj2GDclj5ofokWjzoa5jAwMkxCykd6,7,18,8,0,1,1,12,0,40,5.714285714285714,4,0.0,0,8,0,1,18,1,0,12,0,9,31,1
355,8257,ANOp8mWNHTZUswLhYddMTdBChUriYZaX,RXDvfPUBYFlVdlueBFbLW0mhhAyGEqpt,38,121,2,122,6,10,28,3,292,41.714285714285715,3,0.0,32,2,111,6,89,10,11,28,3,151,141,0
356,8284,X9u2Hncxz9A6DpGBhCZ5wulJhsMdyVac,RXDvfPUBYFlVdlueBFbLW0mhhAyGEqpt,3,0,0,0,0,0,3,0,3,0.42857142857142855,1,0.0,0,0,0,0,0,0,0,3,0,0,3,1
357,8291,ljmWZCzWPqv1RXsn1q2wpsQtrnA1zct2,bWdj2GDclj5ofokWjzoa5jAwMkxCykd6,16,29,0,194,2,46,19,1,291,41.57142857142857,3,0.0,9,0,186,2,20,46,8,19,1,197,94,1
358,8301,KdYI01F9Xc7qTt82weazWGHtHsUvxDB7,SpATywNh6bZuzm8s1ceuBUnMUAeoAHHw,15,24,1,15,1,13,8,1,63,9.0,3,0.0,11,1,12,1,13,13,3,8,1,25,38,1
359,8305,kpS5tMAHQr9yJyfVB9Mkc4TlfmouYjNE,SpATywNh6bZuzm8s1ceuBUnMUAeoAHHw,14,42,20,0,10,2,20,2,96,13.714285714285714,1,0.0,0,20,0,10,42,2,0,20,2,30,66,0
360,8312,cYibpCaMUGq0WjgUWfTv0iIvJ7QbFj5E,SpATywNh6bZuzm8s1ceuBUnMUAeoAHHw,17,22,8,20,3,35,32,0,120,17.142857142857142,7,0.0,9,8,17,3,13,35,3,32,0,37,83,0
361,8348,f6fUoSUJslaShApLLQ3C3hAE39t0Ewco,SpATywNh6bZuzm8s1ceuBUnMUAeoAHHw,7,10,2,0,1,0,4,0,17,2.4285714285714284,1,0.0,0,2,0,1,10,0,0,4,0,3,14,1
362,8378,ZipuPEeCqze6LFrYfkIZBU7ronXF3JAb,SpATywNh6bZuzm8s1ceuBUnMUAeoAHHw,15,19,8,11,4,0,6,1,49,7.0,1,0.0,9,8,10,4,10,0,1,6,1,31,18,0
363,8381,XDUz0oVcNwke0CqAlFlmwOWSA32SgeFl,SpATywNh6bZuzm8s1ceuBUnMUAeoAHHw,11,22,1,4,1,0,10,0,38,5.428571428571429,6,0.0,1,1,4,1,21,0,0,10,0,7,31,0
364,8408,NYt3HW4iIDKFfkoDHUmE2GfhEi6C8Rqu,bWdj2GDclj5ofokWjzoa5jAwMkxCykd6,8,7,4,0,0,6,10,1,28,4.0,3,0.0,0,4,0,0,7,6,0,10,1,4,24,1
365,8410,kWUbu8oK1dFJKpHhiF15MwcSzNzv8GaS,A3fsA9Zfv1X2fVEQhTw51lKENdNrEqT3,4,2,1,0,1,0,1,0,5,0.7142857142857143,1,0.0,0,1,0,1,2,0,0,1,0,2,3,1
366,8424,ukCIrv5h45nbdIEPPmMlvipT87B8fFE7,RXDvfPUBYFlVdlueBFbLW0mhhAyGEqpt,24,23,19,0,13,2,5,0,62,8.857142857142858,3,0.0,0,19,0,13,23,2,0,5,0,32,30,0
367,8427,sOkc0wEXSSLpxtxlqjZObJqg94IyLpuY,SpATywNh6bZuzm8s1ceuBUnMUAeoAHHw,14,48,2,9,0,34,29,0,122,17.428571428571427,5,0.0,15,2,8,0,33,34,1,29,0,25,97,0
368,8443,ITkxDxE80MnM3R1P6Tny4qeXU1QIqBHa,A3fsA9Zfv1X2fVEQhTw51lKENdNrEqT3,35,25,15,74,3,34,18,1,170,24.285714285714285,4,0.0,2,15,59,3,23,34,15,18,1,79,91,1
369,8449,TTJoWZMu9qE69gK338lM1DPPuzOJjTS2,SpATywNh6bZuzm8s1ceuBUnMUAeoAHHw,15,27,1,20,1,5,7,1,62,8.857142857142858,2,0.0,5,1,17,1,22,5,3,7,1,24,38,1
370,8457,jcXoYFaI9QPcliotiwIgOLeObkrSUvNn,SpATywNh6bZuzm8s1ceuBUnMUAeoAHHw,11,16,0,14,0,3,2,0,35,5.0,2,0.0,5,0,13,0,11,3,1,2,0,18,17,0
371,8478,UY6XF5Ob1mgKcqmlUI5FgYfIUUIUAwxR,SpATywNh6bZuzm8s1ceuBUnMUAeoAHHw,17,48,13,15,6,4,22,3,111,15.857142857142858,4,0.0,18,13,12,6,30,4,3,22,3,49,62,0
372,8504,2cKDRLsZWRQVPO7xdF2dpJ6vw1EsD7pk,bWdj2GDclj5ofokWjzoa5jAwMkxCykd6,13,24,5,102,2,0,2,0,135,19.285714285714285,3,0.0,2,5,96,2,22,0,6,2,0,105,30,1
373,8505,DpXkrIHIAIPNESKyvFah0WhpVT5PHFeL,SpATywNh6bZuzm8s1ceuBUnMUAeoAHHw,12,17,7,11,0,17,8,2,62,8.857142857142858,3,0.0,6,7,10,0,11,17,1,8,2,23,39,0
374,8510,2cKDRLsZWRQVPO7xdF2dpJ6vw1EsD7pk,A3fsA9Zfv1X2fVEQhTw51lKENdNrEqT3,5,7,2,0,2,0,1,0,12,1.7142857142857142,1,0.0,0,2,0,2,7,0,0,1,0,4,8,1
375,8516,WFBeS5f6wWn1eFBxyujnTFuvM6fqEpDk,A3fsA9Zfv1X2fVEQhTw51lKENdNrEqT3,7,3,2,0,2,0,2,0,9,1.2857142857142858,1,0.0,0,2,0,2,3,0,0,2,0,4,5,1
376,8517,4tj4DQ4XnBvn4uM9Mw2kTJbN1KPDkno4,SpATywNh6bZuzm8s1ceuBUnMUAeoAHHw,17,44,17,20,3,13,24,8,129,18.428571428571427,5,0.0,16,17,19,3,28,13,1,24,8,55,74,0
377,8522,aLRP3ahB5SIcOn5vpM1VPEh9ib2QIioX,bWdj2GDclj5ofokWjzoa5jAwMkxCykd6,5,8,0,0,0,19,4,0,31,4.428571428571429,2,0.0,0,0,0,0,8,19,0,4,0,0,31,1
378,8523,0Vj24SN7QK68fxZGEj9b6pGHh8nTXfGG,A3fsA9Zfv1X2fVEQhTw51lKENdNrEqT3,28,10,6,56,1,0,5,0,78,11.142857142857142,4,0.0,1,6,52,1,9,0,4,5,0,60,18,0
379,8526,HBfe50okXo4yGURKfz5xhaX3ToIkoF7Q,bWdj2GDclj5ofokWjzoa5jAwMkxCykd6,18,62,28,38,10,48,17,1,204,29.142857142857142,6,0.0,7,28,34,10,55,48,4,17,1,79,125,1
380,8540,83bogZlv4TVHMx4MUYOU3yEQWNYHnGAe,G8EPVSXsOYB5YQWZGiz1aVq5Pgr2GrQu,3,4,0,0,0,0,1,0,5,0.7142857142857143,1,0.0,1,0,0,0,3,0,0,1,0,1,4,1
381,8553,aGkT5uzDJUsKsLNIW3C8wBL1bUhJSBfn,SpATywNh6bZuzm8s1ceuBUnMUAeoAHHw,13,21,2,10,2,0,3,0,38,5.428571428571429,4,0.0,3,2,8,2,18,0,2,3,0,15,23,0
382,8570,ApFdQQBcLqTLoA4wIvtlnnwFs4FrlVS1,RXDvfPUBYFlVdlueBFbLW0mhhAyGEqpt,27,26,16,22,0,1,12,1,78,11.142857142857142,3,0.0,7,16,22,0,19,1,0,12,1,45,33,0
383,8574,7jkKKf5Pb7FrtJ3WnuF11G7ePioUPJm3,A3fsA9Zfv1X2fVEQhTw51lKENdNrEqT3,44,23,18,68,12,6,6,0,133,19.0,1,0.0,1,18,58,12,22,6,10,6,0,89,44,1
384,8582,x0VzAeYdlywtGLqE1HF68qQMYZTLfsw9,SpATywNh6bZuzm8s1ceuBUnMUAeoAHHw,16,34,16,6,7,1,10,1,75,10.714285714285714,3,0.0,11,16,6,7,23,1,0,10,1,40,35,0
385,8585,28jQkMYgDOh7TIBKdGn62G1sm2slN0BP,A3fsA9Zfv1X2fVEQhTw51lKENdNrEqT3,28,24,16,56,10,0,5,0,111,15.857142857142858,2,0.0,0,16,49,10,24,0,7,5,0,75,36,0
386,8586,Xci1viGBABzXjikcwwlwGEGBfmePUlzw,SpATywNh6bZuzm8s1ceuBUnMUAeoAHHw,13,35,15,0,2,5,15,2,74,10.571428571428571,4,0.0,13,15,0,2,22,5,0,15,2,30,44,1
387,8616,GexMn1szbSD50sX3ghgNlwAzziO50D2R,SpATywNh6bZuzm8s1ceuBUnMUAeoAHHw,18,36,14,11,6,23,13,2,105,15.0,2,0.0,12,14,11,6,24,23,0,13,2,43,62,0
388,8628,nQgK4glIoTighvWZSrb5cpZqSgT49IUz,SpATywNh6bZuzm8s1ceuBUnMUAeoAHHw,14,16,5,12,3,2,3,0,41,5.857142857142857,2,0.0,9,5,12,3,7,2,0,3,0,29,12,0
389,8636,2tNnsKlcvz4IV4xQh5sF75J9zNq5DtzC,SpATywNh6bZuzm8s1ceuBUnMUAeoAHHw,14,21,7,18,3,21,4,0,74,10.571428571428571,1,0.0,12,7,15,3,9,21,3,4,0,37,37,1
390,8640,g2XbJogybHS3UQDYBcO0HoCO8HfG7ABm,A3fsA9Zfv1X2fVEQhTw51lKENdNrEqT3,36,50,0,36,0,5,17,3,111,15.857142857142858,3,0.0,3,0,36,0,47,5,0,17,3,39,72,1
391,8641,3dlrFJzmVyUebS1oyKqPiquAJj3CweSU,SpATywNh6bZuzm8s1ceuBUnMUAeoAHHw,17,24,13,14,4,0,12,1,68,9.714285714285714,3,0.0,4,13,11,4,20,0,3,12,1,32,36,1
392,8649,uQjl8NGtIQkRfoe9edBiMgtYYmdkzVXR,bWdj2GDclj5ofokWjzoa5jAwMkxCykd6,17,38,22,34,5,8,27,3,137,19.571428571428573,6,0.0,3,22,30,5,35,8,4,27,3,60,77,0
393,8652,15n53eqSRMLQKZaiigI2Vgclm7aKceka,A3fsA9Zfv1X2fVEQhTw51lKENdNrEqT3,18,19,3,0,2,1,11,2,38,5.428571428571429,2,0.0,0,3,0,2,19,1,0,11,2,5,33,0
394,8660,CxUPOQRaQMGLmbOcfniIQOhh24PXLDR6,A3fsA9Zfv1X2fVEQhTw51lKENdNrEqT3,46,58,28,79,10,5,18,2,200,28.571428571428573,5,0.0,6,28,63,10,52,5,16,18,2,107,93,0
395,8677,k6Ev3pOofJatsjXYv6yHRgeWPlAQcaXL,SpATywNh6bZuzm8s1ceuBUnMUAeoAHHw,16,10,6,9,3,1,5,1,35,5.0,1,0.0,2,6,9,3,8,1,0,5,1,20,15,1
396,8683,xlLP2MUG9CBaax1U0Ai47Er5upBZhMpV,SpATywNh6bZuzm8s1ceuBUnMUAeoAHHw,15,29,11,11,4,1,7,0,63,9.0,4,0.0,13,11,10,4,16,1,1,7,0,38,25,1
397,8690,NuBf7vtWvcfQjgrelnmNuJu6a5WC9FFT,SpATywNh6bZuzm8s1ceuBUnMUAeoAHHw,18,53,23,54,8,26,40,3,207,29.571428571428573,5,0.0,17,23,47,8,36,26,7,40,3,95,112,0
398,8734,fxq584v5hQmVOHgm4uohGT9XrYo1FGMS,SpATywNh6bZuzm8s1ceuBUnMUAeoAHHw,16,59,23,27,4,5,16,1,135,19.285714285714285,5,0.0,12,23,22,4,47,5,5,16,1,61,74,0
399,8741,XWElpBT4PKnC5pi96PLjtYP5u9l1rrKm,SpATywNh6bZuzm8s1ceuBUnMUAeoAHHw,15,50,5,8,2,4,28,2,99,14.142857142857142,4,0.0,8,5,8,2,42,4,0,28,2,23,76,0
400,8748,IZ5pWpBLzW50MjCCGxCjTz4w6DVz2MU3,A3fsA9Zfv1X2fVEQhTw51lKENdNrEqT3,4,2,1,0,1,0,2,0,6,0.8571428571428571,1,0.0,0,1,0,1,2,0,0,2,0,2,4,0
401,8752,tsTDNHtkzUQqr6Le5CiKzEb1J3ub8XpE,G8EPVSXsOYB5YQWZGiz1aVq5Pgr2GrQu,23,25,3,34,1,0,4,0,67,9.571428571428571,3,0.0,7,3,27,1,18,0,7,4,0,38,29,0
402,8766,V8icfAYA9I8myBnRTjbheMwStuoZOBk5,SpATywNh6bZuzm8s1ceuBUnMUAeoAHHw,17,66,28,16,10,18,27,4,169,24.142857142857142,4,0.0,23,28,14,10,43,18,2,27,4,75,94,1
403,8772,NLUFE7ndaVQ8A2tkIa8xBpPqWZbahAYT,SpATywNh6bZuzm8s1ceuBUnMUAeoAHHw,17,30,12,27,6,12,19,1,107,15.285714285714286,3,0.0,10,12,21,6,20,12,6,19,1,49,58,0
404,8778,hkmT0j8GDy3ymXnKaIcUDPdFkebvKRou,SpATywNh6bZuzm8s1ceuBUnMUAeoAHHw,18,53,26,22,11,8,17,1,138,19.714285714285715,4,0.0,12,26,18,11,41,8,4,17,1,67,71,0
405,8783,V9A9B2T9pRTU3AqvpqzuKs4MfRcAEte2,RXDvfPUBYFlVdlueBFbLW0mhhAyGEqpt,28,36,22,12,8,0,21,1,100,14.285714285714286,4,0.0,4,22,10,8,32,0,2,21,1,44,56,1
406,8790,hShFZH2IARrzxZjv2Hbws9rmf9bt3f58,SpATywNh6bZuzm8s1ceuBUnMUAeoAHHw,7,8,2,0,1,0,5,0,16,2.2857142857142856,2,0.0,0,2,0,1,8,0,0,5,0,3,13,0
407,8820,sqKEuRhvHf94SnQ2C0IdhOfhaSrrM6tg,SpATywNh6bZuzm8s1ceuBUnMUAeoAHHw,17,76,3,25,4,19,28,2,157,22.428571428571427,5,0.0,27,3,21,4,49,19,4,28,2,55,102,0
408,8833,BX9KMh9DUbDRkGw8SYAs3wHv0hHJ990Z,SpATywNh6bZuzm8s1ceuBUnMUAeoAHHw,13,18,10,17,5,0,4,0,54,7.714285714285714,2,0.0,4,10,14,5,14,0,3,4,0,33,21,0
409,8882,NAmyRYUXoAoJaF1WmEUzfZdW5j2jsFh1,SpATywNh6bZuzm8s1ceuBUnMUAeoAHHw,13,8,5,14,2,0,8,0,37,5.285714285714286,1,0.0,2,5,12,2,6,0,2,8,0,21,16,0
410,8894,8IuzZOXaXVUql9pLZtNuJIyLoDJ8ZL4V,bWdj2GDclj5ofokWjzoa5jAwMkxCykd6,6,2,0,0,0,0,7,0,9,1.2857142857142858,1,0.0,0,0,0,0,2,0,0,7,0,0,9,1
411,8908,9lksmcPg7FQE2FGQIA9VvWum1Z9DYrHM,SpATywNh6bZuzm8s1ceuBUnMUAeoAHHw,13,14,8,0,4,3,7,0,36,5.142857142857143,1,0.0,3,8,0,4,11,3,0,7,0,15,21,1
412,8915,RlIzEuK7g6sugNWIIhijiyryQft8qZof,SpATywNh6bZuzm8s1ceuBUnMUAeoAHHw,16,16,9,10,3,4,6,0,48,6.857142857142857,2,0.0,4,9,9,3,12,4,1,6,0,25,23,1
413,8939,awz7o49PrUBSNrYng5ZPMFSJBn6RXWK1,G8EPVSXsOYB5YQWZGiz1aVq5Pgr2GrQu,48,90,48,60,32,2,17,0,249,35.57142857142857,6,0.0,13,48,45,32,77,2,15,17,0,138,111,0
414,8943,dQggCBdg5KVSltApPCgVZB7TTUQzzzoI,RXDvfPUBYFlVdlueBFbLW0mhhAyGEqpt,6,7,4,0,1,0,3,0,15,2.142857142857143,2,0.0,0,4,0,1,7,0,0,3,0,5,10,1
415,8972,3NITGQuylcrTi63aoWqnzXuF5Rtf7QVq,SpATywNh6bZuzm8s1ceuBUnMUAeoAHHw,16,35,12,15,13,11,22,0,108,15.428571428571429,3,0.0,7,12,14,13,28,11,1,22,0,46,62,1
416,8978,WCRryRCEKP6zK3AUHtR5dzBwncEtNUH8,G8EPVSXsOYB5YQWZGiz1aVq5Pgr2GrQu,53,116,30,106,11,4,29,2,298,42.57142857142857,5,0.0,42,30,64,11,74,4,42,29,2,147,151,0
417,8986,Ucr48Rnt4CA9YgbeIcM1jITCIMHtgMC0,A3fsA9Zfv1X2fVEQhTw51lKENdNrEqT3,3,0,0,0,0,0,6,0,6,0.8571428571428571,2,0.0,0,0,0,0,0,0,0,6,0,0,6,1
418,9001,lvwGRCEVK5ut59266fZHM9ppN9a4Qw6i,SpATywNh6bZuzm8s1ceuBUnMUAeoAHHw,5,2,1,0,1,0,2,0,6,0.8571428571428571,1,0.0,0,1,0,1,2,0,0,2,0,2,4,1
419,9007,WDMP5c2Ubx8vVSFegA0mXeU23cYb0qCY,RXDvfPUBYFlVdlueBFbLW0mhhAyGEqpt,14,12,1,8,0,4,5,0,30,4.285714285714286,1,0.0,1,1,8,0,11,4,0,5,0,10,20,0
420,9035,ANOp8mWNHTZUswLhYddMTdBChUriYZaX,SpATywNh6bZuzm8s1ceuBUnMUAeoAHHw,14,38,0,24,0,12,13,2,89,12.714285714285714,3,0.0,11,0,19,0,27,12,5,13,2,30,59,0
421,9043,aiXR63FJxLzLjxOw200I9QHjcVwt5TEN,SpATywNh6bZuzm8s1ceuBUnMUAeoAHHw,14,26,0,25,0,29,13,1,94,13.428571428571429,1,0.0,14,0,21,0,12,29,4,13,1,35,59,1
422,9136,UqGW2x76mENodjXkUPPKnojGcrLxXcJN,SpATywNh6bZuzm8s1ceuBUnMUAeoAHHw,14,36,19,19,12,0,9,0,95,13.571428571428571,4,0.0,9,19,17,12,27,0,2,9,0,57,38,0
423,9149,8SekjqaLbfUPHiuX7ZCPwYfF03sn6XJi,RXDvfPUBYFlVdlueBFbLW0mhhAyGEqpt,45,63,24,95,14,0,10,0,206,29.428571428571427,5,0.0,14,24,93,14,49,0,2,10,0,145,61,1
424,9159,9DysAmMC3i4TW1eruWnww7wyDSDGRjXp,A3fsA9Zfv1X2fVEQhTw51lKENdNrEqT3,2,0,0,0,0,0,2,0,2,0.2857142857142857,1,0.0,0,0,0,0,0,0,0,2,0,0,2,1
425,9206,Gdklwa0GJ75FwxPq1eHDC2rS99nIOtyi,bWdj2GDclj5ofokWjzoa5jAwMkxCykd6,18,19,10,38,7,12,7,2,95,13.571428571428571,1,0.0,6,10,29,7,13,12,9,7,2,52,43,1
426,9220,lnpRXkDrSwjGYP4CoWLvjg5xZj4SSBHh,SpATywNh6bZuzm8s1ceuBUnMUAeoAHHw,18,71,24,15,5,82,23,2,222,31.714285714285715,5,0.0,15,24,14,5,56,82,1,23,2,58,164,0
427,9232,b3doS3mx4rZAsWrCVosVej8UMBCaG0ZM,SpATywNh6bZuzm8s1ceuBUnMUAeoAHHw,10,7,5,0,3,0,3,0,18,2.5714285714285716,1,0.0,0,5,0,3,7,0,0,3,0,8,10,1
428,9246,oolYEp2BotSva2yfmUYiIDYQiMjym92z,SpATywNh6bZuzm8s1ceuBUnMUAeoAHHw,8,6,4,0,3,0,3,0,16,2.2857142857142856,2,0.0,0,4,0,3,6,0,0,3,0,7,9,0
429,9257,XQsLTRxBgT09jhwR2kw4g3k34p5O8kHV,A3fsA9Zfv1X2fVEQhTw51lKENdNrEqT3,14,13,9,0,6,1,4,0,33,4.714285714285714,3,0.0,0,9,0,6,13,1,0,4,0,15,18,1
430,9260,OXDIjQPBiuWpB7PdzfniEtiITaq40Kxq,SpATywNh6bZuzm8s1ceuBUnMUAeoAHHw,17,17,7,19,4,2,7,1,57,8.142857142857142,2,0.0,8,7,17,4,9,2,2,7,1,36,21,1
431,9272,8lhedVUrxjbKOOXrDoKpLvh9BgBDrVND,SpATywNh6bZuzm8s1ceuBUnMUAeoAHHw,17,35,9,17,5,7,21,5,99,14.142857142857142,2,0.0,5,9,14,5,30,7,3,21,5,33,66,0
432,9273,Mu4L96Qo7KWrVAKYK2IsPfV4EjP9aNL4,G8EPVSXsOYB5YQWZGiz1aVq5Pgr2GrQu,14,9,5,2,4,13,12,1,46,6.571428571428571,2,0.0,4,5,1,4,5,13,1,12,1,14,32,1
433,9275,Mu4L96Qo7KWrVAKYK2IsPfV4EjP9aNL4,SpATywNh6bZuzm8s1ceuBUnMUAeoAHHw,16,20,12,23,5,10,13,0,83,11.857142857142858,3,0.0,2,12,19,5,18,10,4,13,0,38,45,1
434,9295,Xj0ZJ92JN6F4CNXTzd0Bvhi4bYi9S3VP,SpATywNh6bZuzm8s1ceuBUnMUAeoAHHw,14,14,6,11,4,6,14,2,57,8.142857142857142,3,0.0,4,6,11,4,10,6,0,14,2,25,32,0
435,9315,MjPA7JgM9XbkzRn3BICo8xJPG5qfeCcD,bWdj2GDclj5ofokWjzoa5jAwMkxCykd6,8,17,13,0,12,0,7,0,49,7.0,5,0.0,0,13,0,12,17,0,0,7,0,25,24,1
436,9327,tJN8ZYcrD7OwnBb01xCqUSDOnzwFRPdf,SpATywNh6bZuzm8s1ceuBUnMUAeoAHHw,11,33,4,18,0,11,17,0,83,11.857142857142858,5,0.0,10,4,15,0,23,11,3,17,0,29,54,0
437,9328,3SP9iNDvUt8m67ZMqC5DpQRe6ekkTpsP,SpATywNh6bZuzm8s1ceuBUnMUAeoAHHw,1,0,0,0,0,0,12,0,12,1.7142857142857142,2,0.0,0,0,0,0,0,0,0,12,0,0,12,1
438,9335,hsFDq5MhfyyJ0opvBTTLO0xNuy1mKh4f,SpATywNh6bZuzm8s1ceuBUnMUAeoAHHw,16,21,8,8,3,0,7,0,47,6.714285714285714,3,0.0,6,8,8,3,15,0,0,7,0,25,22,1
439,9339,4GxaPPzHsA8XSeyZ6ySVKPYJkeTDhbmO,A3fsA9Zfv1X2fVEQhTw51lKENdNrEqT3,11,2,2,0,2,5,15,3,29,4.142857142857143,1,0.0,0,2,0,2,2,5,0,15,3,4,25,1
440,9347,dQweEcdBCmNmUPOeO7X4TTmH8zuMq2aJ,bWdj2GDclj5ofokWjzoa5jAwMkxCykd6,17,65,23,74,1,30,17,0,210,30.0,3,0.0,17,23,57,1,48,30,17,17,0,98,112,1
441,9357,aSYSmBNLMzBrel3rF1bQSMOfc7OKhL4q,SpATywNh6bZuzm8s1ceuBUnMUAeoAHHw,10,8,1,20,0,0,2,0,31,4.428571428571429,1,0.0,3,1,16,0,5,0,4,2,0,20,11,1
442,9358,I2ghGumCKIaVsnJOGZA0xyJzTnEm5KtW,RXDvfPUBYFlVdlueBFbLW0mhhAyGEqpt,23,22,13,0,7,11,3,0,56,8.0,2,0.0,5,13,0,7,17,11,0,3,0,25,31,1
443,9362,EoYFOaJU19EU8QGJeHpIRqrgzpIVI4Qd,bWdj2GDclj5ofokWjzoa5jAwMkxCykd6,9,13,5,28,3,0,8,0,57,8.142857142857142,3,0.0,4,5,27,3,9,0,1,8,0,39,18,1
444,9389,UGnGGFIGvpoYWCshdaVb9HHg3HECfvUa,A3fsA9Zfv1X2fVEQhTw51lKENdNrEqT3,9,4,3,0,3,0,4,0,14,2.0,1,0.0,0,3,0,3,4,0,0,4,0,6,8,1
445,9419,JZCy2v8CZ2nSCAUiBMrG3NWUkCCn6jiz,G8EPVSXsOYB5YQWZGiz1aVq5Pgr2GrQu,14,17,1,6,2,0,6,1,33,4.714285714285714,1,0.0,9,1,5,2,8,0,1,6,1,17,16,1
446,9460,zOr0niRplBKfkwpPHNykN96u1FhzegfK,G8EPVSXsOYB5YQWZGiz1aVq5Pgr2GrQu,37,58,27,0,14,42,25,1,167,23.857142857142858,6,0.0,2,27,0,14,56,42,0,25,1,43,124,0
447,9468,JnhPqAOFLEpgEufKhwt0tmkUNhkNteVd,SpATywNh6bZuzm8s1ceuBUnMUAeoAHHw,13,19,4,13,1,0,7,0,44,6.285714285714286,3,0.0,5,4,12,1,14,0,1,7,0,22,22,1
448,9510,20lTdK7j1fcbNyoe9mD2q7qXvA5Z8HOD,SpATywNh6bZuzm8s1ceuBUnMUAeoAHHw,16,42,18,11,11,3,7,1,93,13.285714285714286,2,0.0,7,18,10,11,35,3,1,7,1,46,47,0
449,9517,fN4I0M2Yv3uPvseFkDyQdSg5ZokzJaMj,RXDvfPUBYFlVdlueBFbLW0mhhAyGEqpt,48,43,23,130,10,19,10,10,245,35.0,4,0.0,11,23,118,10,32,19,12,10,10,162,83,1
450,9533,xdUSsALCLmQFNaGX8BEyTR2RhmvhWdsB,SpATywNh6bZuzm8s1ceuBUnMUAeoAHHw,15,22,2,20,1,4,25,0,74,10.571428571428571,4,0.0,6,2,16,1,16,4,4,25,0,25,49,0
451,9549,RV3mgnFEm5em6PXoEJeQNSKFCpjzfVyy,bWdj2GDclj5ofokWjzoa5jAwMkxCykd6,4,0,0,0,0,114,20,0,134,19.142857142857142,5,0.0,0,0,0,0,0,114,0,20,0,0,134,0
452,9624,GD8FRA1y66qb4KlW9w61HoAU1TWGpDoa,G8EPVSXsOYB5YQWZGiz1aVq5Pgr2GrQu,37,61,26,58,8,916,86,119,1274,182.0,7,0.0,12,26,43,8,49,916,15,86,119,89,1185,0
453,9636,zcw6JFT1cBTyKAWUWt6eG4jvVYxHMSLq,SpATywNh6bZuzm8s1ceuBUnMUAeoAHHw,11,8,6,9,3,8,5,0,39,5.571428571428571,2,0.0,0,6,7,3,8,8,2,5,0,16,23,0
454,9643,UzwJVyLJF6Ih9iHYPyYWMullgIr89o5m,SpATywNh6bZuzm8s1ceuBUnMUAeoAHHw,14,28,14,6,2,2,9,0,61,8.714285714285714,4,0.0,7,14,6,2,21,2,0,9,0,29,32,0
455,9655,66U3TkcZA1aSl7HKRun9CzahgGH85zQD,SpATywNh6bZuzm8s1ceuBUnMUAeoAHHw,15,42,14,8,4,10,9,0,87,12.428571428571429,3,0.0,18,14,8,4,24,10,0,9,0,44,43,0
456,9663,C4q4gNQYEpjKh7pq1qjN8i3L7uSpUX9d,bWdj2GDclj5ofokWjzoa5jAwMkxCykd6,18,43,27,84,17,1,10,0,182,26.0,2,0.0,4,27,80,17,39,1,4,10,0,128,54,0
457,9672,Bi4hHmeTLwTbUCScu9tC6ZZN7frLUhVP,A3fsA9Zfv1X2fVEQhTw51lKENdNrEqT3,43,18,14,40,10,15,13,0,110,15.714285714285714,2,0.0,1,14,40,10,17,15,0,13,0,65,45,0
458,9720,0dBn4alo7QBTd62VD5XO0yNMbQ5QN2OQ,bWdj2GDclj5ofokWjzoa5jAwMkxCykd6,6,10,3,0,0,0,3,0,16,2.2857142857142856,2,0.0,0,3,0,0,10,0,0,3,0,3,13,1
459,9724,YwojqO58bCgaotjJoOTtpKH2oiEFOZyB,bWdj2GDclj5ofokWjzoa5jAwMkxCykd6,11,20,13,0,12,1,7,0,53,7.571428571428571,5,0.0,4,13,0,12,16,1,0,7,0,29,24,1
460,9767,Bv9FSXvHlE6wLC4E4yrAKqe3BQhrrtfx,A3fsA9Zfv1X2fVEQhTw51lKENdNrEqT3,9,18,2,0,0,0,5,0,25,3.5714285714285716,3,0.0,0,2,0,0,18,0,0,5,0,2,23,1
461,9783,CZfXDHVnNPClikyXrFzPhkQoFiILzXmF,SpATywNh6bZuzm8s1ceuBUnMUAeoAHHw,12,15,1,8,0,0,3,0,27,3.857142857142857,2,0.0,6,1,8,0,9,0,0,3,0,15,12,0
462,9784,WnYAypmYi03odcBC7NgJFsh1FzqrpNw6,SpATywNh6bZuzm8s1ceuBUnMUAeoAHHw,3,2,0,0,0,0,1,0,3,0.42857142857142855,1,0.0,0,0,0,0,2,0,0,1,0,0,3,0
463,9790,yUvG5Vqh097epwWCIkZetr2ZlwvQRcLL,SpATywNh6bZuzm8s1ceuBUnMUAeoAHHw,12,14,4,10,1,0,5,0,34,4.857142857142857,3,0.0,5,4,9,1,9,0,1,5,0,19,15,0
464,9793,B2ahwtOo16YsNrAQ9LRd2yjP18Ni9l2c,SpATywNh6bZuzm8s1ceuBUnMUAeoAHHw,12,15,1,11,0,0,6,0,33,4.714285714285714,2,0.0,3,1,9,0,12,0,2,6,0,13,20,0
465,9797,Dnyzk8ev480byt0tTEIN8mPtG79PwCH1,RXDvfPUBYFlVdlueBFbLW0mhhAyGEqpt,15,19,17,0,9,11,3,0,59,8.428571428571429,4,0.0,0,17,0,9,19,11,0,3,0,26,33,1
466,9812,fARr9B8lZ63xDV7GkxAczvRhzY3xBLi6,RXDvfPUBYFlVdlueBFbLW0mhhAyGEqpt,17,20,0,1,0,22,3,0,46,6.571428571428571,2,0.0,1,0,1,0,19,22,0,3,0,2,44,1
467,9823,hEw8FL1KT7bCC88Jn3Nko4dT9ob6cai1,A3fsA9Zfv1X2fVEQhTw51lKENdNrEqT3,10,9,1,0,1,0,1,0,12,1.7142857142857142,1,0.0,0,1,0,1,9,0,0,1,0,2,10,0
468,9839,bunHowa0BgtekXN64zdm8G1L1XdN8gBZ,bWdj2GDclj5ofokWjzoa5jAwMkxCykd6,2,0,0,0,0,0,2,0,2,0.2857142857142857,1,0.0,0,0,0,0,0,0,0,2,0,0,2,1
469,9852,1wIqcRX58Bpw6RXvGnbxsc6WbPwWGwXd,SpATywNh6bZuzm8s1ceuBUnMUAeoAHHw,5,12,3,0,0,0,3,0,18,2.5714285714285716,2,0.0,3,3,0,0,9,0,0,3,0,6,12,0
470,9869,0RNr6P08D2zaPSoifoE3KvUeNCFcBSvA,SpATywNh6bZuzm8s1ceuBUnMUAeoAHHw,16,27,8,13,3,17,7,1,76,10.857142857142858,3,0.0,11,8,10,3,16,17,3,7,1,32,44,0
471,9873,u4s0SPiIkynucY7ReF58TL89R2q4zw1x,SpATywNh6bZuzm8s1ceuBUnMUAeoAHHw,9,21,12,0,5,0,3,0,41,5.857142857142857,3,0.0,0,12,0,5,21,0,0,3,0,17,24,1
472,9876,vn6QiPL2hNfbQVlbP4Lnj04J2ZQusfUk,A3fsA9Zfv1X2fVEQhTw51lKENdNrEqT3,7,10,7,0,0,0,4,0,21,3.0,2,0.0,1,7,0,0,9,0,0,4,0,8,13,1
473,9904,OfMabADNCpK7MfQ7IaqBsUw8RvPeHL0S,RXDvfPUBYFlVdlueBFbLW0mhhAyGEqpt,48,52,28,109,12,3,17,0,221,31.571428571428573,4,0.0,11,28,104,12,41,3,5,17,0,155,66,0
474,9923,CRrOxkmi8hXpA4NrCBnJ87Z2odaZzKo5,SpATywNh6bZuzm8s1ceuBUnMUAeoAHHw,18,36,15,23,7,5,10,1,97,13.857142857142858,2,0.0,18,15,19,7,18,5,4,10,1,59,38,1
475,9928,ylxIxsQV8oDzYk1f9bdd1UWiUi1ODLbL,SpATywNh6bZuzm8s1ceuBUnMUAeoAHHw,15,57,1,25,0,24,27,3,137,19.571428571428573,6,0.0,26,1,20,0,31,24,5,27,3,47,90,0
476,9929,oaL3pbpAfEH9L4o42G6X4xjme1kXt2tm,SpATywNh6bZuzm8s1ceuBUnMUAeoAHHw,13,16,7,10,4,0,3,0,40,5.714285714285714,2,0.0,2,7,10,4,14,0,0,3,0,23,17,0
477,9943,KXKbDyPytrUZAnNaQjyZgMFkA2w3Wpvj,SpATywNh6bZuzm8s1ceuBUnMUAeoAHHw,12,20,11,0,3,10,14,2,60,8.571428571428571,2,0.0,6,11,0,3,14,10,0,14,2,20,40,1
478,9946,Jd5OP6GIsguRdsq9k3eSYNENmzhPbdGe,G8EPVSXsOYB5YQWZGiz1aVq5Pgr2GrQu,4,2,1,0,1,0,1,0,5,0.7142857142857143,1,0.0,0,1,0,1,2,0,0,1,0,2,3,0
479,9949,IUn6MADAjAYkGlJisA1WiDvCeNlJd5Xd,SpATywNh6bZuzm8s1ceuBUnMUAeoAHHw,15,13,6,12,5,8,6,0,50,7.142857142857143,2,0.0,5,6,10,5,8,8,2,6,0,26,24,0
480,9953,KeGByI8uvXcUVBvZaFAzVTfOuPfjSv5Y,SpATywNh6bZuzm8s1ceuBUnMUAeoAHHw,8,6,0,0,0,32,10,5,53,7.571428571428571,1,0.0,0,0,0,0,6,32,0,10,5,0,53,1
481,9963,YleydB3G0OM4jGw8hrXeA6aAbHfKvakN,SpATywNh6bZuzm8s1ceuBUnMUAeoAHHw,16,26,12,12,3,0,8,0,61,8.714285714285714,6,0.0,8,12,12,3,18,0,0,8,0,35,26,1
482,9988,GVRJN4wkoooaXJUVmwnX983A87KsrZPK,SpATywNh6bZuzm8s1ceuBUnMUAeoAHHw,14,13,8,8,3,28,4,0,64,9.142857142857142,4,0.0,2,8,8,3,11,28,0,4,0,21,43,0
483,10015,gFtSwrFBdsFWgLyqjSCzwaUhlQmEHgOq,SpATywNh6bZuzm8s1ceuBUnMUAeoAHHw,10,16,11,0,6,0,5,0,38,5.428571428571429,4,0.0,0,11,0,6,16,0,0,5,0,17,21,0
484,10016,5z0TnHJcRYhCDHjnNu4kmaWirO8lucwr,SpATywNh6bZuzm8s1ceuBUnMUAeoAHHw,14,17,1,9,1,0,5,0,33,4.714285714285714,3,0.0,3,1,8,1,14,0,1,5,0,13,20,1
485,10024,FELnhQR0c7GZZX82ioYJEZsqujOrfyf7,bWdj2GDclj5ofokWjzoa5jAwMkxCykd6,10,6,4,0,2,6,6,0,24,3.4285714285714284,1,0.0,0,4,0,2,6,6,0,6,0,6,18,1
486,10025,SozAkRr5kfRi3urQaoczmRXQoW70onBa,A3fsA9Zfv1X2fVEQhTw51lKENdNrEqT3,10,5,1,0,1,0,6,1,14,2.0,1,0.0,0,1,0,1,5,0,0,6,1,2,12,1
487,10035,FELnhQR0c7GZZX82ioYJEZsqujOrfyf7,A3fsA9Zfv1X2fVEQhTw51lKENdNrEqT3,9,2,1,0,1,17,8,1,30,4.285714285714286,2,0.0,0,1,0,1,2,17,0,8,1,2,28,1
488,10059,UOOsauq1lFlLECbNF7MRjSfLxlpKxsoG,SpATywNh6bZuzm8s1ceuBUnMUAeoAHHw,17,16,9,14,5,2,15,2,63,9.0,4,0.0,5,9,13,5,11,2,1,15,2,32,31,0
489,10062,e0buQlxlHVWdQd03EOAehldJOI8AeFTm,SpATywNh6bZuzm8s1ceuBUnMUAeoAHHw,16,32,11,11,6,0,15,0,75,10.714285714285714,5,0.0,11,11,10,6,21,0,1,15,0,38,37,1
490,10101,30Velr3UVYghs85WZNOKXFcrgzOgBsfI,SpATywNh6bZuzm8s1ceuBUnMUAeoAHHw,14,9,5,12,3,63,3,0,95,13.571428571428571,1,0.0,2,5,12,3,7,63,0,3,0,22,73,0
491,10103,yS4oyG8z71VcMw1yy9w2LWRiDWgGhtKA,SpATywNh6bZuzm8s1ceuBUnMUAeoAHHw,14,28,14,18,6,1,6,0,73,10.428571428571429,3,0.0,5,14,15,6,23,1,3,6,0,40,33,0
492,10132,ILMhPMpEir8VP8Uy0NQI7guQFniKAiGh,SpATywNh6bZuzm8s1ceuBUnMUAeoAHHw,18,27,11,6,5,4,11,1,65,9.285714285714286,4,0.0,11,11,6,5,16,4,0,11,1,33,32,0
493,10149,KG1VMsurgFKqkMv9nVqkO9ppjva59kYw,SpATywNh6bZuzm8s1ceuBUnMUAeoAHHw,8,6,2,0,1,4,4,1,18,2.5714285714285716,1,0.0,0,2,0,1,6,4,0,4,1,3,15,0
494,10157,CUHsvexAAfaCEMKsM3644JTxXL5DgSss,SpATywNh6bZuzm8s1ceuBUnMUAeoAHHw,11,10,7,0,4,0,2,0,23,3.2857142857142856,2,0.0,1,7,0,4,9,0,0,2,0,12,11,1
495,10173,ewZzdypyl0fDIzKshXnlZXjyO7oizoCq,SpATywNh6bZuzm8s1ceuBUnMUAeoAHHw,16,11,5,18,3,1,4,0,42,6.0,1,0.0,5,5,15,3,6,1,3,4,0,28,14,1
496,10183,rf43ZHojMqXQ775bmX3nnHgQ62d9XvGK,SpATywNh6bZuzm8s1ceuBUnMUAeoAHHw,14,35,16,16,3,3,7,0,80,11.428571428571429,4,0.0,10,16,14,3,25,3,2,7,0,43,37,1
497,10188,2rS9ufrltSIJVkQHjlKCjTvqcoR7anzz,A3fsA9Zfv1X2fVEQhTw51lKENdNrEqT3,34,45,1,68,1,0,7,0,122,17.428571428571427,2,0.0,7,1,56,1,38,0,12,7,0,65,57,1
498,10189,sY8CcZG79KJSl2UAc47IiYJD1k5ghqCN,SpATywNh6bZuzm8s1ceuBUnMUAeoAHHw,18,43,19,16,8,11,16,2,115,16.428571428571427,5,0.0,13,19,14,8,30,11,2,16,2,54,61,1
499,10197,tqvOTiQbipkIXQL7CIR5dckxV83rng9S,SpATywNh6bZuzm8s1ceuBUnMUAeoAHHw,16,20,8,15,3,17,12,1,76,10.857142857142858,1,0.0,8,8,13,3,12,17,2,12,1,32,44,0
500,10201,MB156dsmOWVhw7SmCPNYcmBUK9V54bIt,SpATywNh6bZuzm8s1ceuBUnMUAeoAHHw,11,22,0,9,0,0,8,0,39,5.571428571428571,2,0.0,4,0,9,0,18,0,0,8,0,13,26,1
501,10217,VWRhwnsbyy7kINpd5Pldlp01a86tVlAt,SpATywNh6bZuzm8s1ceuBUnMUAeoAHHw,15,120,32,28,9,1,19,0,209,29.857142857142858,4,0.0,44,32,21,9,76,1,7,19,0,106,103,0
502,10220,L4Uo99RvQ1cxFdSSaMag731dHicuHxV2,SpATywNh6bZuzm8s1ceuBUnMUAeoAHHw,14,40,2,31,0,10,18,6,107,15.285714285714286,2,0.0,13,2,23,0,27,10,8,18,6,38,69,0
503,10226,DHenWrxVzReZszxo1qw3Im0Zj99tiAII,bWdj2GDclj5ofokWjzoa5jAwMkxCykd6,12,15,8,0,8,22,15,5,73,10.428571428571429,4,0.0,2,8,0,8,13,22,0,15,5,18,55,1
504,10243,YdCaKimqYb8kuFiHEtjPDsCbtIch1tfO,SpATywNh6bZuzm8s1ceuBUnMUAeoAHHw,6,3,2,0,2,0,1,0,8,1.1428571428571428,1,0.0,0,2,0,2,3,0,0,1,0,4,4,0
505,10266,8Q42Hi4bJP7SqbH4XystURHk2B8tBI5i,G8EPVSXsOYB5YQWZGiz1aVq5Pgr2GrQu,29,30,20,34,16,0,5,0,105,15.0,4,0.0,0,20,29,16,30,0,5,5,0,65,40,0
506,10285,GIsRCDxWVYGm4So2chhYPzgj7oVxCsSB,SpATywNh6bZuzm8s1ceuBUnMUAeoAHHw,7,4,1,0,1,0,5,0,11,1.5714285714285714,2,0.0,0,1,0,1,4,0,0,5,0,2,9,1
507,10321,njb10SfHXKB30cApzPJzWBcqA8VQx0HA,A3fsA9Zfv1X2fVEQhTw51lKENdNrEqT3,3,0,0,0,0,0,3,0,3,0.42857142857142855,1,0.0,0,0,0,0,0,0,0,3,0,0,3,1
508,10338,j2MboDReb1SoSFb2jmGT6OHiYADxn3PT,A3fsA9Zfv1X2fVEQhTw51lKENdNrEqT3,4,3,0,0,0,0,2,0,5,0.7142857142857143,1,0.0,0,0,0,0,3,0,0,2,0,0,5,1
509,10345,cRvonGDWMKfxHYP6TdkGqL61F16M4yAA,SpATywNh6bZuzm8s1ceuBUnMUAeoAHHw,11,8,4,0,3,5,6,1,27,3.857142857142857,2,0.0,0,4,0,3,8,5,0,6,1,7,20,1
510,10385,4SjsVB9NX97jh5FCSnOdHgEUANJ1svZm,SpATywNh6bZuzm8s1ceuBUnMUAeoAHHw,7,3,2,0,2,0,2,0,9,1.2857142857142858,1,0.0,0,2,0,2,3,0,0,2,0,4,5,0
511,10394,EF3EfvSrA0c1KnpZ3bhY87a1rscondwY,SpATywNh6bZuzm8s1ceuBUnMUAeoAHHw,16,32,16,23,6,0,10,0,87,12.428571428571429,2,0.0,11,16,19,6,21,0,4,10,0,52,35,0
512,10399,D2M0lUAbb3NbvYyEfkDkoqJ8mQHTb4db,G8EPVSXsOYB5YQWZGiz1aVq5Pgr2GrQu,22,36,16,54,8,2,7,1,124,17.714285714285715,2,0.0,15,16,49,8,21,2,5,7,1,88,36,0
513,10402,CQOn4KWCA0duDCOSP1DQzvXZ3yAfq1zW,RXDvfPUBYFlVdlueBFbLW0mhhAyGEqpt,48,59,37,128,14,62,22,11,333,47.57142857142857,6,0.0,9,37,117,14,50,62,11,22,11,177,156,0
514,10420,Eu9HoDt3WhECHgcXaERosbI6lMj7Hipb,bWdj2GDclj5ofokWjzoa5jAwMkxCykd6,18,52,22,44,15,20,16,1,170,24.285714285714285,2,0.0,19,22,36,15,33,20,8,16,1,92,78,0
515,10437,N0P6Yrg1zRuUPyVufFpM0ZExnJnGTKKG,SpATywNh6bZuzm8s1ceuBUnMUAeoAHHw,14,16,0,23,0,1,8,1,49,7.0,4,0.0,6,0,18,0,10,1,5,8,1,24,25,0
516,10445,wXYPFlL861BbeAt6BcFbVApC7BUFADjk,A3fsA9Zfv1X2fVEQhTw51lKENdNrEqT3,4,2,1,0,1,0,1,0,5,0.7142857142857143,1,0.0,0,1,0,1,2,0,0,1,0,2,3,1
517,10454,6tpE26inQQeNPyhZ0HoRMm7l4NlMiWJC,SpATywNh6bZuzm8s1ceuBUnMUAeoAHHw,15,37,1,23,0,13,30,5,109,15.571428571428571,4,0.0,14,1,21,0,23,13,2,30,5,36,73,0
518,10463,uhU9XFMHqXe19d0SBpTzsSNqTtdSMXBT,SpATywNh6bZuzm8s1ceuBUnMUAeoAHHw,15,22,6,14,3,31,7,1,84,12.0,3,0.0,15,6,13,3,7,31,1,7,1,37,47,1
519,10471,l7T8dOWG1cEtOxAxVcD5zNV6vn1g4oYM,G8EPVSXsOYB5YQWZGiz1aVq5Pgr2GrQu,13,20,1,32,0,7,6,0,66,9.428571428571429,4,0.0,6,1,27,0,14,7,5,6,0,34,32,1
520,10491,egnijdxL4Cz1CfzoCQSNIgWry6KIzA7P,SpATywNh6bZuzm8s1ceuBUnMUAeoAHHw,14,19,5,16,3,0,5,0,48,6.857142857142857,5,0.0,2,5,13,3,17,0,3,5,0,23,25,0
521,10507,rf43ZHojMqXQ775bmX3nnHgQ62d9XvGK,bWdj2GDclj5ofokWjzoa5jAwMkxCykd6,7,14,7,0,0,0,6,0,27,3.857142857142857,2,0.0,1,7,0,0,13,0,0,6,0,8,19,0
522,10525,w8NGfLpAxSvlcPdxr1N6ClRtnCD7UkJu,A3fsA9Zfv1X2fVEQhTw51lKENdNrEqT3,2,0,0,0,0,0,3,0,3,0.42857142857142855,2,0.0,0,0,0,0,0,0,0,3,0,0,3,0
523,10537,4zppanuK6US9rtvd04IL60AQkgDx5lm5,RXDvfPUBYFlVdlueBFbLW0mhhAyGEqpt,12,33,0,0,0,0,5,0,38,5.428571428571429,1,0.0,0,0,0,0,33,0,0,5,0,0,38,1
524,10560,m4jrmeR3FtkOUCbFelK4w5ennRkxlxWD,A3fsA9Zfv1X2fVEQhTw51lKENdNrEqT3,16,25,15,0,12,0,4,0,56,8.0,2,0.0,0,15,0,12,25,0,0,4,0,27,29,0
525,10563,IQCtPVNPylpjpNjZtQrr88vV5qPansN0,SpATywNh6bZuzm8s1ceuBUnMUAeoAHHw,12,8,4,8,3,3,1,0,27,3.857142857142857,1,0.0,3,4,8,3,5,3,0,1,0,18,9,0
526,10569,54BZa2PEVowNqI6EO6NzeCnkR49ry3oS,SpATywNh6bZuzm8s1ceuBUnMUAeoAHHw,12,18,1,17,1,10,8,1,56,8.0,3,0.0,2,1,13,1,16,10,4,8,1,17,39,0
527,10574,NFgPnsok64XIrx8pioLRAIHoliaoDIvn,SpATywNh6bZuzm8s1ceuBUnMUAeoAHHw,10,26,3,8,0,8,9,0,54,7.714285714285714,2,0.0,8,3,8,0,18,8,0,9,0,19,35,0
528,10607,ySOA4rbQpe1GOPfJP5VkUnJIGjlF7GXO,SpATywNh6bZuzm8s1ceuBUnMUAeoAHHw,13,21,0,12,0,4,12,4,53,7.571428571428571,2,0.0,8,0,11,0,13,4,1,12,4,19,34,1
529,10612,BTSZE2PXdA7MkOyBKPCnqqHRa0lxJtHO,SpATywNh6bZuzm8s1ceuBUnMUAeoAHHw,13,45,1,24,1,0,6,0,77,11.0,4,0.0,18,1,21,1,27,0,3,6,0,41,36,0
530,10641,Q5TmTVdy8nnH2vTL73s67ZseaCMO3k91,SpATywNh6bZuzm8s1ceuBUnMUAeoAHHw,15,12,9,12,4,0,10,0,47,6.714285714285714,4,0.0,2,9,12,4,10,0,0,10,0,27,20,0
531,10659,DLCsXj6afYeXedkEor8cSwWpPMWMukEN,A3fsA9Zfv1X2fVEQhTw51lKENdNrEqT3,2,0,0,0,0,0,2,0,2,0.2857142857142857,1,0.0,0,0,0,0,0,0,0,2,0,0,2,1
532,10705,CeupRRMHE9iQJGvyrBKaDsPPM9lhEl5t,SpATywNh6bZuzm8s1ceuBUnMUAeoAHHw,13,15,1,14,1,10,9,0,50,7.142857142857143,3,0.0,4,1,11,1,11,10,3,9,0,17,33,0
533,10738,uyomj5PLSD8MuBnIm3UXNOM2zJB1f3kv,bWdj2GDclj5ofokWjzoa5jAwMkxCykd6,18,57,9,52,5,23,15,0,161,23.0,3,0.0,17,9,43,5,40,23,9,15,0,74,87,1
534,10766,puC0Dx9PufKMVxVv15STTWR0hwd8EG3K,A3fsA9Zfv1X2fVEQhTw51lKENdNrEqT3,6,3,2,0,1,0,2,0,8,1.1428571428571428,1,0.0,0,2,0,1,3,0,0,2,0,3,5,1
535,10809,gzv7fk7jLAAb6tXwbmA5ceisqqnvcETz,SpATywNh6bZuzm8s1ceuBUnMUAeoAHHw,8,2,1,0,1,1,6,1,12,1.7142857142857142,1,0.0,0,1,0,1,2,1,0,6,1,2,10,0
536,10819,v21GnAmoo56SIXGBSOh9jDiYo8T7Od29,SpATywNh6bZuzm8s1ceuBUnMUAeoAHHw,12,19,7,3,3,0,3,0,35,5.0,3,0.0,8,7,3,3,11,0,0,3,0,21,14,0
537,10822,xYLJB56SVkFUOdT5vN3Qq6OYNlnP0Fjc,RXDvfPUBYFlVdlueBFbLW0mhhAyGEqpt,22,64,29,26,10,8,23,7,167,23.857142857142858,2,0.0,0,29,22,10,64,8,4,23,7,61,106,0
538,10853,2uZ2ZHQBnnVrb5vAtTu1AloVYtZL1MXg,G8EPVSXsOYB5YQWZGiz1aVq5Pgr2GrQu,71,235,76,120,29,29,43,11,543,77.57142857142857,5,0.0,65,76,84,29,170,29,36,43,11,254,289,0
539,10869,fuprfcX49r5QcUYvMQnvvzEf76cx4sRp,bWdj2GDclj5ofokWjzoa5jAwMkxCykd6,1,0,0,0,0,0,1,0,1,0.14285714285714285,1,0.0,0,0,0,0,0,0,0,1,0,0,1,1
540,10876,4vKI2gaXrHATS50fqVyDxXcmRy0MrgJS,A3fsA9Zfv1X2fVEQhTw51lKENdNrEqT3,28,49,30,2,19,8,19,3,130,18.571428571428573,3,0.0,12,30,2,19,37,8,0,19,3,63,67,1
541,10891,L5fA3BAe6FOUhd5mq4cXOYYHxtSuGgKM,SpATywNh6bZuzm8s1ceuBUnMUAeoAHHw,18,39,18,17,8,12,15,2,111,15.857142857142858,3,0.0,14,18,15,8,25,12,2,15,2,55,56,0
542,10917,Bf9it9d08iLIslwAMDaZjQzh1Kdl2qhf,SpATywNh6bZuzm8s1ceuBUnMUAeoAHHw,1,0,0,0,0,0,2,0,2,0.2857142857142857,1,0.0,0,0,0,0,0,0,0,2,0,0,2,0
543,10922,Bf9it9d08iLIslwAMDaZjQzh1Kdl2qhf,A3fsA9Zfv1X2fVEQhTw51lKENdNrEqT3,5,3,0,0,0,0,2,0,5,0.7142857142857143,1,0.0,0,0,0,0,3,0,0,2,0,0,5,0
544,10990,xxd1UUpRh1yQGgGLMyjshPknKZCNEYlg,A3fsA9Zfv1X2fVEQhTw51lKENdNrEqT3,44,39,19,54,10,0,9,0,131,18.714285714285715,4,0.0,4,19,47,10,35,0,7,9,0,80,51,0
545,11001,4vKI2gaXrHATS50fqVyDxXcmRy0MrgJS,bWdj2GDclj5ofokWjzoa5jAwMkxCykd6,15,57,33,26,14,42,23,1,196,28.0,5,0.0,5,33,24,14,52,42,2,23,1,76,120,0
546,11008,nKH0niV76APk64AIPNglQ4nJBpaxE108,A3fsA9Zfv1X2fVEQhTw51lKENdNrEqT3,1,0,0,0,0,0,1,0,1,0.14285714285714285,1,0.0,0,0,0,0,0,0,0,1,0,0,1,1
547,11029,1PM9jc7cZ3C091LId9Ek5VaVwRreQ0TH,A3fsA9Zfv1X2fVEQhTw51lKENdNrEqT3,5,3,1,0,1,0,2,0,7,1.0,1,0.0,0,1,0,1,3,0,0,2,0,2,5,1
548,11036,0kTYCEXFiuNuYfSpCOb8HIL3aF9nkrGc,SpATywNh6bZuzm8s1ceuBUnMUAeoAHHw,17,21,6,11,3,12,10,1,64,9.142857142857142,2,0.0,13,6,10,3,8,12,1,10,1,32,32,0
549,11068,E6SywimuBT6ZGpGjcedDyV1LTcQRc9ds,A3fsA9Zfv1X2fVEQhTw51lKENdNrEqT3,45,26,21,90,14,24,18,2,195,27.857142857142858,2,0.0,2,21,75,14,24,24,15,18,2,112,83,1
550,11092,WFURYJe5F7dgP6i0YwgNFeyKSFpNu7xS,A3fsA9Zfv1X2fVEQhTw51lKENdNrEqT3,17,17,9,0,7,0,4,0,37,5.285714285714286,2,0.0,0,9,0,7,17,0,0,4,0,16,21,1
551,11113,tDwPtwMZBHQrqhm9RKWd7GW4j1pmFbeZ,A3fsA9Zfv1X2fVEQhTw51lKENdNrEqT3,2,0,0,0,0,0,5,0,5,0.7142857142857143,1,0.0,0,0,0,0,0,0,0,5,0,0,5,1
552,11136,iVrbldNmEASAlMSnUTWFx7qcEdScVNde,SpATywNh6bZuzm8s1ceuBUnMUAeoAHHw,10,14,9,0,7,0,5,0,35,5.0,1,0.0,0,9,0,7,14,0,0,5,0,16,19,1
553,11165,xebgVIBazn8SEoqG6RUzBHRE4EbzaN4t,A3fsA9Zfv1X2fVEQhTw51lKENdNrEqT3,8,2,1,0,1,1,8,1,14,2.0,1,0.0,0,1,0,1,2,1,0,8,1,2,12,1
554,11179,gryVUwWLvrsNv4F8O3kiEBAQILnJg7OT,SpATywNh6bZuzm8s1ceuBUnMUAeoAHHw,13,24,0,13,0,31,18,4,90,12.857142857142858,5,0.0,11,0,12,0,13,31,1,18,4,23,67,0
555,11198,HbdIEiZ1jslj2pBp8czn7lhBbxLYjtpj,SpATywNh6bZuzm8s1ceuBUnMUAeoAHHw,4,2,1,0,1,0,1,0,5,0.7142857142857143,1,0.0,0,1,0,1,2,0,0,1,0,2,3,1
556,11225,Vmvdv9k8S1ONPkUHSdXPEenyx7UNVISW,SpATywNh6bZuzm8s1ceuBUnMUAeoAHHw,15,29,1,12,0,20,11,3,76,10.857142857142858,2,0.0,10,1,9,0,19,20,3,11,3,20,56,1
557,11331,eqaDSMjkkLr4V8zwKAYzNF193Wm3l9Pg,A3fsA9Zfv1X2fVEQhTw51lKENdNrEqT3,1,0,0,0,0,0,1,0,1,0.14285714285714285,1,0.0,0,0,0,0,0,0,0,1,0,0,1,1
558,11344,SHXTFVyrdbzmF1pJEIvr2zpR8jK358bb,SpATywNh6bZuzm8s1ceuBUnMUAeoAHHw,13,19,2,20,0,25,7,1,74,10.571428571428571,3,0.0,8,2,16,0,11,25,4,7,1,26,48,1
559,11355,Z5t6AGEyADeSVHWZTgBW4lR5XMnM5VWU,SpATywNh6bZuzm8s1ceuBUnMUAeoAHHw,2,0,0,0,0,0,2,0,2,0.2857142857142857,1,0.0,0,0,0,0,0,0,0,2,0,0,2,0
560,11356,KXkOWXgIJuvmtvaUVHrKWAaqrFaY5cx8,SpATywNh6bZuzm8s1ceuBUnMUAeoAHHw,1,0,0,0,0,0,1,0,1,0.14285714285714285,1,0.0,0,0,0,0,0,0,0,1,0,0,1,1
561,11357,WJKEaeH3ob9wscd3i5dXEY7kRPHMEwVj,bWdj2GDclj5ofokWjzoa5jAwMkxCykd6,4,2,0,0,0,0,2,0,4,0.5714285714285714,1,0.0,0,0,0,0,2,0,0,2,0,0,4,1
562,11362,13fzVwLJSsgGzTLwjEHCuvf0Ks8dgxYZ,SpATywNh6bZuzm8s1ceuBUnMUAeoAHHw,18,33,12,16,4,12,36,7,120,17.142857142857142,5,0.0,10,12,12,4,23,12,4,36,7,38,82,1
563,11389,PqLnOjm8gCkS4EhgcnGtGCfdwzyBuNjz,A3fsA9Zfv1X2fVEQhTw51lKENdNrEqT3,10,3,2,0,2,0,8,2,17,2.4285714285714284,1,0.0,0,2,0,2,3,0,0,8,2,4,13,1
564,11403,HYCkyEJhW9QtzilmanJKsxRLSBi9UGoV,A3fsA9Zfv1X2fVEQhTw51lKENdNrEqT3,1,0,0,0,0,0,1,0,1,0.14285714285714285,1,0.0,0,0,0,0,0,0,0,1,0,0,1,1
565,11410,YEYkPWHcftKd8bKe1Q9b21lzhv1SChRM,SpATywNh6bZuzm8s1ceuBUnMUAeoAHHw,16,16,8,11,3,5,10,1,54,7.714285714285714,2,0.0,5,8,11,3,11,5,0,10,1,27,27,1
566,11425,82UlWF6Fm1gkNum7nNbVw0yOV1BUdNoS,bWdj2GDclj5ofokWjzoa5jAwMkxCykd6,9,11,6,0,1,11,8,1,38,5.428571428571429,2,0.0,1,6,0,1,10,11,0,8,1,8,30,0
567,11428,82UlWF6Fm1gkNum7nNbVw0yOV1BUdNoS,A3fsA9Zfv1X2fVEQhTw51lKENdNrEqT3,17,23,16,0,9,36,18,3,105,15.0,5,0.0,0,16,0,9,23,36,0,18,3,25,80,0
568,11463,uFcd6yCTniScAvbMiWJYRQ8Du52ubELm,RXDvfPUBYFlVdlueBFbLW0mhhAyGEqpt,20,33,6,10,3,6,5,0,63,9.0,3,0.0,0,6,10,3,33,6,0,5,0,19,44,0
569,11475,UJiJ4PvH4qodyDnURbFXyi5LWwaSKUwb,RXDvfPUBYFlVdlueBFbLW0mhhAyGEqpt,51,41,19,124,8,7,18,5,222,31.714285714285715,2,0.0,8,19,116,8,33,7,8,18,5,151,71,0
570,11478,RGf4k3THi4AV4qsAjc1UEOWiIeDYcchf,A3fsA9Zfv1X2fVEQhTw51lKENdNrEqT3,34,46,31,50,17,20,9,0,173,24.714285714285715,4,0.0,6,31,39,17,40,20,11,9,0,93,80,0
571,11509,sQVxVjeT9NfPAT9IdDUsY0RSB3XrvO2y,SpATywNh6bZuzm8s1ceuBUnMUAeoAHHw,15,29,14,21,0,9,15,1,89,12.714285714285714,2,0.0,13,14,18,0,16,9,3,15,1,45,44,0
572,11515,iIwpETh60BkJfJQJqvWucH2tzh64j0U3,SpATywNh6bZuzm8s1ceuBUnMUAeoAHHw,18,49,18,20,6,4,17,3,117,16.714285714285715,4,0.0,8,18,18,6,41,4,2,17,3,50,67,0
573,11522,MOJ1BiwMK7lBUiFS9DTwwPvbUWIkdFFP,A3fsA9Zfv1X2fVEQhTw51lKENdNrEqT3,26,53,27,0,22,0,11,0,113,16.142857142857142,6,0.0,0,27,0,22,53,0,0,11,0,49,64,1
574,11547,NKnL5oTIIxOmPf0Ep5iKaKIecNheR2t7,SpATywNh6bZuzm8s1ceuBUnMUAeoAHHw,11,12,8,0,5,0,3,0,28,4.0,1,0.0,1,8,0,5,11,0,0,3,0,14,14,0
575,11555,7OkCZWJW1Ow4wpTBUq53amL13pV2vy2v,G8EPVSXsOYB5YQWZGiz1aVq5Pgr2GrQu,6,6,1,0,0,0,13,0,20,2.857142857142857,4,0.0,0,1,0,0,6,0,0,13,0,1,19,0
576,11677,FduexGuoL0tC7LqIuSFtIm03lXvHHbSw,SpATywNh6bZuzm8s1ceuBUnMUAeoAHHw,9,8,1,0,1,0,9,0,19,2.7142857142857144,1,0.0,0,1,0,1,8,0,0,9,0,2,17,1
577,11690,37daqGAbA6x2VvXkiqdWX1nBv2Tqqgte,G8EPVSXsOYB5YQWZGiz1aVq5Pgr2GrQu,48,198,88,76,16,71,52,1,502,71.71428571428571,6,0.0,27,88,62,16,171,71,14,52,1,193,309,0
578,11741,n3cFXGx3rjoPJPOmeF5tlnmkFmFFJI7p,A3fsA9Zfv1X2fVEQhTw51lKENdNrEqT3,5,2,1,0,1,0,2,0,6,0.8571428571428571,1,0.0,0,1,0,1,2,0,0,2,0,2,4,1
579,11811,YRnTGuoAQA7UM3uV59YNXUYN4n1CR9jv,SpATywNh6bZuzm8s1ceuBUnMUAeoAHHw,13,10,5,10,3,1,3,0,32,4.571428571428571,2,0.0,3,5,8,3,7,1,2,3,0,19,13,0
580,11827,McYATdhZDDMDpni6a4GbjI06ustMpvdV,G8EPVSXsOYB5YQWZGiz1aVq5Pgr2GrQu,1,0,0,0,0,0,1,0,1,0.14285714285714285,1,0.0,0,0,0,0,0,0,0,1,0,0,1,1
581,11841,4GMbKnTV7f2uA3paM09GNAdyVnypDTbs,A3fsA9Zfv1X2fVEQhTw51lKENdNrEqT3,32,13,1,44,1,0,8,0,67,9.571428571428571,2,0.0,3,1,42,1,10,0,2,8,0,47,20,0
582,11862,n42jeLyeDpoJPwT1pkhXRyhzHjUnC2KC,SpATywNh6bZuzm8s1ceuBUnMUAeoAHHw,13,16,0,12,0,1,6,0,35,5.0,1,0.0,7,0,9,0,9,1,3,6,0,16,19,1
583,11892,QkpDyGn4qqqwpxvXRrFsAsKSrEtfkQJQ,SpATywNh6bZuzm8s1ceuBUnMUAeoAHHw,13,12,5,6,3,4,1,0,31,4.428571428571429,1,0.0,6,5,6,3,6,4,0,1,0,20,11,0
584,11895,Er0phLmicWoU9yr3sUBC2BCne0YIK1vQ,A3fsA9Zfv1X2fVEQhTw51lKENdNrEqT3,14,13,7,0,4,0,16,0,40,5.714285714285714,4,0.0,0,7,0,4,13,0,0,16,0,11,29,1
585,11896,UzuB1gScsXJ6b46FForXq5x2wnZw4QoH,SpATywNh6bZuzm8s1ceuBUnMUAeoAHHw,18,33,15,13,9,6,12,2,90,12.857142857142858,1,0.0,12,15,12,9,21,6,1,12,2,48,42,0
586,11900,8xT75XL9dKm7CwLmOxtys3bmWBh3OJmY,RXDvfPUBYFlVdlueBFbLW0mhhAyGEqpt,38,46,1,24,1,0,2,0,74,10.571428571428571,2,0.0,17,1,24,1,29,0,0,2,0,43,31,0
587,11920,uarVJhEs6XLW7Dw1D7iBgEK6zPe65WwX,A3fsA9Zfv1X2fVEQhTw51lKENdNrEqT3,15,16,13,0,2,0,5,0,36,5.142857142857143,2,0.0,1,13,0,2,15,0,0,5,0,16,20,1
588,11922,gKme5KJOgqJrjNwDUsRPKwK3QFyN7vPD,RXDvfPUBYFlVdlueBFbLW0mhhAyGEqpt,46,69,38,107,19,4,6,1,244,34.857142857142854,4,0.0,17,38,101,19,52,4,6,6,1,175,69,0
589,12011,q36eiA77bwwsXGg05ifhgnTFDpR9Ar4V,bWdj2GDclj5ofokWjzoa5jAwMkxCykd6,16,33,15,108,4,16,3,0,179,25.571428571428573,1,0.0,13,15,104,4,20,16,4,3,0,136,43,0
590,12053,7m381KBoEq7nybFxitllQlgHOa7YYR1i,SpATywNh6bZuzm8s1ceuBUnMUAeoAHHw,15,27,9,15,4,7,10,0,72,10.285714285714286,4,0.0,2,9,14,4,25,7,1,10,0,29,43,0
591,12141,4n0eavxCNp4F6LlqtEg5gsmyBVEbRBeE,G8EPVSXsOYB5YQWZGiz1aVq5Pgr2GrQu,66,138,53,112,45,0,10,0,358,51.142857142857146,4,0.0,76,53,81,45,62,0,31,10,0,255,103,1
592,12223,ysTOTg8n91NBng8BrzlEom4lR6CnDwPC,SpATywNh6bZuzm8s1ceuBUnMUAeoAHHw,16,28,9,17,3,12,23,7,99,14.142857142857142,3,0.0,8,9,16,3,20,12,1,23,7,36,63,1
593,12246,I0uHaMvDeJM1w1AenEVj8xWzg3OizAzv,G8EPVSXsOYB5YQWZGiz1aVq5Pgr2GrQu,5,2,0,0,0,0,3,0,5,0.7142857142857143,1,0.0,0,0,0,0,2,0,0,3,0,0,5,1
594,12287,zZK4lWrYYn5bTLcjHRRO0XA8xNwpu7OT,RXDvfPUBYFlVdlueBFbLW0mhhAyGEqpt,43,28,13,88,11,1,8,7,156,22.285714285714285,2,0.0,13,13,80,11,15,1,8,8,7,117,39,0
595,12316,8SG0IoRU1kfooCNm4CWXEAnDe54VjVcy,A3fsA9Zfv1X2fVEQhTw51lKENdNrEqT3,11,5,4,0,4,0,4,1,18,2.5714285714285716,1,0.0,0,4,0,4,5,0,0,4,1,8,10,1
596,12330,9iGaqBGS5kkoXjLd87hUL2eIJMVUVKfU,A3fsA9Zfv1X2fVEQhTw51lKENdNrEqT3,18,18,5,52,0,0,4,0,79,11.285714285714286,1,0.0,1,5,49,0,17,0,3,4,0,55,24,0
597,12356,GW78UVODV1oPxxynjXG1U7em3gdA8wQF,SpATywNh6bZuzm8s1ceuBUnMUAeoAHHw,13,8,6,3,3,0,4,0,24,3.4285714285714284,2,0.0,0,6,3,3,8,0,0,4,0,12,12,0
598,12363,5wKAjfQ5T37M2WWxYAwMeUeLhDScm1Z0,bWdj2GDclj5ofokWjzoa5jAwMkxCykd6,4,2,0,0,0,31,19,0,52,7.428571428571429,3,0.0,0,0,0,0,2,31,0,19,0,0,52,0
599,12372,Dx1ZzKpwFtwNhE9gdaLaohssqGyqrqjD,A3fsA9Zfv1X2fVEQhTw51lKENdNrEqT3,33,23,15,30,10,0,4,0,82,11.714285714285714,1,0.0,2,15,24,10,21,0,6,4,0,51,31,1
600,12381,zZsHSLX7Hk1sqhZYCfBgGlYJnqetGIKf,SpATywNh6bZuzm8s1ceuBUnMUAeoAHHw,9,10,1,0,0,4,6,1,22,3.142857142857143,2,0.0,0,1,0,0,10,4,0,6,1,1,21,1
601,12383,7OkCZWJW1Ow4wpTBUq53amL13pV2vy2v,SpATywNh6bZuzm8s1ceuBUnMUAeoAHHw,14,37,0,14,2,87,33,7,180,25.714285714285715,3,0.0,11,0,13,2,26,87,1,33,7,26,154,0
602,12410,wXFfHtwd9smrvhh9NQW7SmEEo1001LDW,A3fsA9Zfv1X2fVEQhTw51lKENdNrEqT3,19,21,13,0,7,2,20,1,64,9.142857142857142,4,0.0,1,13,0,7,20,2,0,20,1,21,43,1
603,12412,s24Qk0ZpAXR97ldBDtgP8DE6rT8or69U,SpATywNh6bZuzm8s1ceuBUnMUAeoAHHw,11,31,1,18,0,0,6,0,56,8.0,3,0.0,8,1,17,0,23,0,1,6,0,26,30,0
604,12442,HbmZzALzRW0CJmaD07o1oMpvJwGgfjK4,SpATywNh6bZuzm8s1ceuBUnMUAeoAHHw,4,4,0,0,0,2,2,1,9,1.2857142857142858,1,0.0,0,0,0,0,4,2,0,2,1,0,9,1
605,12445,CqxK3XGagGgLgWXJIkp8qfeo0SWv94XW,RXDvfPUBYFlVdlueBFbLW0mhhAyGEqpt,48,124,71,101,18,123,38,23,498,71.14285714285714,7,0.0,33,71,84,18,91,123,17,38,23,206,292,0
606,12464,NSrMJ69WS92LaJ6a09xOpViELCrjji8S,SpATywNh6bZuzm8s1ceuBUnMUAeoAHHw,12,25,5,15,0,24,13,0,82,11.714285714285714,6,0.0,2,5,13,0,23,24,2,13,0,20,62,0
607,12480,q54oCvxsY1LE19jtoD23qGpHSrkdhUlF,A3fsA9Zfv1X2fVEQhTw51lKENdNrEqT3,34,23,0,66,0,1,14,0,104,14.857142857142858,1,0.0,2,0,62,0,21,1,4,14,0,64,40,1
608,12522,MRCD9XxqQVpIexf9EdSwdaoHW691k7OH,SpATywNh6bZuzm8s1ceuBUnMUAeoAHHw,12,18,9,10,0,0,3,0,40,5.714285714285714,1,0.0,5,9,8,0,13,0,2,3,0,22,18,1
609,12569,4Z7n4wdauhlOTY95FN6j39vUUWT0ZgYl,SpATywNh6bZuzm8s1ceuBUnMUAeoAHHw,16,53,22,24,7,0,13,0,119,17.0,6,0.0,16,22,18,7,37,0,6,13,0,63,56,1
610,12580,kB76SiSV4uYN77hHUOgf3IbLpFWkgJbj,SpATywNh6bZuzm8s1ceuBUnMUAeoAHHw,9,4,1,0,1,1,10,1,18,2.5714285714285716,2,0.0,0,1,0,1,4,1,0,10,1,2,16,0
611,12583,JRuzCriX6hvuTQ943ttXKlmrFVyfxMHr,SpATywNh6bZuzm8s1ceuBUnMUAeoAHHw,12,20,12,5,3,0,5,0,45,6.428571428571429,4,0.0,0,12,4,3,20,0,1,5,0,19,26,0
612,12586,jfC6fPTH59GZUrxarremx8AmMC8XNgfG,SpATywNh6bZuzm8s1ceuBUnMUAeoAHHw,5,3,1,0,1,0,1,0,6,0.8571428571428571,1,0.0,0,1,0,1,3,0,0,1,0,2,4,1
613,12588,XQTN1LOe7iul8RvZ4acTOpEntRORT1SG,SpATywNh6bZuzm8s1ceuBUnMUAeoAHHw,6,6,0,0,0,0,2,0,8,1.1428571428571428,1,0.0,2,0,0,0,4,0,0,2,0,2,6,1
614,12600,NO22WSq5lVGwq6WPEcqalEaMjYIZxX3u,bWdj2GDclj5ofokWjzoa5jAwMkxCykd6,7,23,0,9,1,0,5,0,38,5.428571428571429,1,0.0,13,0,8,1,10,0,1,5,0,22,16,1
615,12649,TexDHGk8F5I6X0NlqVQwzJ9MMWpLdMbB,SpATywNh6bZuzm8s1ceuBUnMUAeoAHHw,8,15,6,0,2,2,2,0,27,3.857142857142857,2,0.0,4,6,0,2,11,2,0,2,0,12,15,0
616,12742,arTGhRrKZksM4iY72XDJ8i8oBmMABS0m,SpATywNh6bZuzm8s1ceuBUnMUAeoAHHw,14,29,5,4,0,57,9,1,105,15.0,4,0.0,10,5,4,0,19,57,0,9,1,19,86,0
617,12745,rRt0QHymEdl6Kph5VPgdVUvepB7ZBNXt,SpATywNh6bZuzm8s1ceuBUnMUAeoAHHw,16,42,16,14,6,2,15,0,95,13.571428571428571,3,0.0,6,16,13,6,36,2,1,15,0,41,54,0
618,12750,i67qzouvUD7nINgK6d1xrH4pvufZqbFd,SpATywNh6bZuzm8s1ceuBUnMUAeoAHHw,6,9,0,0,0,1,1,0,11,1.5714285714285714,1,0.0,1,0,0,0,8,1,0,1,0,1,10,0
619,12753,79Po0Awyh8Z7ruF9y6agajWClv9uUoPL,SpATywNh6bZuzm8s1ceuBUnMUAeoAHHw,11,53,0,0,1,6,13,1,74,10.571428571428571,2,0.0,2,0,0,1,51,6,0,13,1,3,71,1
620,12805,P0uW8e7uWJsgVO5MWg1krlEvXljM181Y,G8EPVSXsOYB5YQWZGiz1aVq5Pgr2GrQu,1,0,0,0,0,0,2,0,2,0.2857142857142857,1,0.0,0,0,0,0,0,0,0,2,0,0,2,1
621,12808,idxWUfEs3kYL0r7IC35umYY3ZJQ22Zab,SpATywNh6bZuzm8s1ceuBUnMUAeoAHHw,5,4,1,0,1,0,2,0,8,1.1428571428571428,1,0.0,0,1,0,1,4,0,0,2,0,2,6,1
622,12813,L3khlyhxkzKPVeEgnV2Dt5jl6Pe5Thm4,RXDvfPUBYFlVdlueBFbLW0mhhAyGEqpt,20,27,17,25,9,1,7,0,86,12.285714285714286,3,0.0,8,17,22,9,19,1,3,7,0,56,30,1
623,12845,syrttArug8Mpzs9L0IHsvBtATawYF9J2,SpATywNh6bZuzm8s1ceuBUnMUAeoAHHw,5,3,1,0,1,0,1,0,6,0.8571428571428571,1,0.0,0,1,0,1,3,0,0,1,0,2,4,1
624,12883,KKz5C2CIERGp4d0g7P8ZO1hnR4NT39t2,SpATywNh6bZuzm8s1ceuBUnMUAeoAHHw,10,7,5,4,2,0,2,0,20,2.857142857142857,1,0.0,1,5,3,2,6,0,1,2,0,11,9,0
625,12888,lMy0A59BRo4770ALzvOjsBS5HJkCRV78,A3fsA9Zfv1X2fVEQhTw51lKENdNrEqT3,37,49,3,50,0,17,41,2,162,23.142857142857142,5,0.0,4,3,48,0,45,17,2,41,2,55,107,1
626,12892,P0uW8e7uWJsgVO5MWg1krlEvXljM181Y,bWdj2GDclj5ofokWjzoa5jAwMkxCykd6,9,8,1,4,1,0,4,0,18,2.5714285714285716,1,0.0,1,1,3,1,7,0,1,4,0,6,12,1
627,12948,f7pgA2Hp0s8DkqzKuvE0Kw8QRuoBh3Zv,A3fsA9Zfv1X2fVEQhTw51lKENdNrEqT3,27,10,5,36,1,9,7,0,68,9.714285714285714,2,0.0,1,5,36,1,9,9,0,7,0,43,25,0
628,12956,lEIFkqeT396JMSPUyiaHNMN8g7bQ1x9p,SpATywNh6bZuzm8s1ceuBUnMUAeoAHHw,9,16,13,0,13,3,7,0,52,7.428571428571429,2,0.0,3,13,0,13,13,3,0,7,0,29,23,0
629,12976,KpbHdGVlZIWVraCiFee7Cav2rNnqqrsJ,SpATywNh6bZuzm8s1ceuBUnMUAeoAHHw,12,7,4,10,3,7,2,0,33,4.714285714285714,1,0.0,2,4,10,3,5,7,0,2,0,19,14,1
630,12993,8r4M2l7ATXMXEQUCAknekZVeyUGIpRyK,SpATywNh6bZuzm8s1ceuBUnMUAeoAHHw,13,52,8,15,5,2,17,0,99,14.142857142857142,6,0.0,8,8,12,5,44,2,3,17,0,33,66,1
631,13023,MAktGJIumyskhJp25e79u9tVhauVJ2c6,SpATywNh6bZuzm8s1ceuBUnMUAeoAHHw,16,17,8,18,4,9,7,0,63,9.0,2,0.0,6,8,15,4,11,9,3,7,0,33,30,0
632,13109,YW2vWUP3xrebFWQq20TaENvqpb9ZdJV6,SpATywNh6bZuzm8s1ceuBUnMUAeoAHHw,17,16,7,16,3,1,15,1,59,8.428571428571429,3,0.0,2,7,13,3,14,1,3,15,1,25,34,0
633,13135,nF3fyodzvP9Kt8uvHxBDafFDSHuZ38jd,SpATywNh6bZuzm8s1ceuBUnMUAeoAHHw,17,41,10,20,7,45,18,4,145,20.714285714285715,3,0.0,6,10,16,7,35,45,4,18,4,39,106,1
634,13143,igeK6rUQT7Ehyj7yY5oAEj8DvOITiuBO,SpATywNh6bZuzm8s1ceuBUnMUAeoAHHw,15,37,15,21,5,3,10,0,91,13.0,4,0.0,13,15,18,5,24,3,3,10,0,51,40,0
635,13147,p9Pgf9XUtcr2kL39MqLlMakadbFqlUtX,RXDvfPUBYFlVdlueBFbLW0mhhAyGEqpt,14,41,28,0,11,9,14,2,105,15.0,2,0.0,2,28,0,11,39,9,0,14,2,41,64,1
636,13159,gMZKWOenFyVb6m3mcpDQmzDRcu1zvYbF,G8EPVSXsOYB5YQWZGiz1aVq5Pgr2GrQu,11,17,8,50,5,0,6,0,86,12.285714285714286,2,0.0,6,8,47,5,11,0,3,6,0,66,20,1
637,13206,GSkYUOcl4XzYMWSWhE6gXRGQ9kqPeXsi,RXDvfPUBYFlVdlueBFbLW0mhhAyGEqpt,45,28,15,84,8,0,5,0,140,20.0,3,0.0,8,15,82,8,20,0,2,5,0,113,27,1
638,13207,PMDa1SUjeddLyhfDscbnAxL67GyZb6sD,SpATywNh6bZuzm8s1ceuBUnMUAeoAHHw,6,14,3,0,0,8,4,0,29,4.142857142857143,3,0.0,1,3,0,0,13,8,0,4,0,4,25,0
639,13212,pR0rEzd43YPn1ujQN1oHxqL0z3U4G8ju,SpATywNh6bZuzm8s1ceuBUnMUAeoAHHw,7,6,1,0,1,0,2,0,10,1.4285714285714286,1,0.0,2,1,0,1,4,0,0,2,0,4,6,1
640,13240,m52orXncJIuZMWO7LnwS1hFqDU5X5m24,SpATywNh6bZuzm8s1ceuBUnMUAeoAHHw,16,21,3,29,1,35,18,2,109,15.571428571428571,4,0.0,10,3,23,1,11,35,6,18,2,37,72,0
641,13259,KovPBJesZmgqVCWR3DXdtvcd4XyHL9BT,SpATywNh6bZuzm8s1ceuBUnMUAeoAHHw,15,27,0,25,0,36,15,7,110,15.714285714285714,3,0.0,11,0,20,0,16,36,5,15,7,31,79,0
642,13290,bDOMCQV7nFdKo0pDqOPr3ECLpgkdBCSt,A3fsA9Zfv1X2fVEQhTw51lKENdNrEqT3,27,44,2,38,0,1,6,0,91,13.0,1,0.0,2,2,35,0,42,1,3,6,0,39,52,1
643,13338,UidTeyEs50r1zTQVJtstLvLcMUKrNN3b,SpATywNh6bZuzm8s1ceuBUnMUAeoAHHw,10,9,0,2,0,2,6,1,20,2.857142857142857,1,0.0,4,0,2,0,5,2,0,6,1,6,14,0
644,13358,Aw7PeIkLW9CDHbPpPSjrFUdtBaUuHUXm,bWdj2GDclj5ofokWjzoa5jAwMkxCykd6,19,78,27,82,6,77,62,4,336,48.0,5,0.0,32,27,71,6,46,77,11,62,4,136,200,0
645,13398,bqWpav7ocOhCfb3xc4QgAvBDK5g8BmiZ,SpATywNh6bZuzm8s1ceuBUnMUAeoAHHw,13,27,15,12,2,55,13,1,125,17.857142857142858,3,0.0,7,15,9,2,20,55,3,13,1,33,92,0
646,13402,mGb99e4ZiyyEapZp3B98Pssar5eWGHEz,G8EPVSXsOYB5YQWZGiz1aVq5Pgr2GrQu,5,2,1,0,1,0,2,0,6,0.8571428571428571,1,0.0,0,1,0,1,2,0,0,2,0,2,4,1
647,13430,j0gxXks7DZitzyeEGG2agLKFp30HqXVu,bWdj2GDclj5ofokWjzoa5jAwMkxCykd6,10,35,11,0,4,15,16,2,83,11.857142857142858,2,0.0,9,11,0,4,26,15,0,16,2,24,59,0
648,13469,OLmaTq1VRWq8uhF6WwamKt59rXmIqMgh,SpATywNh6bZuzm8s1ceuBUnMUAeoAHHw,11,10,5,0,3,4,9,0,31,4.428571428571429,2,0.0,0,5,0,3,10,4,0,9,0,8,23,1
649,13479,sfuANiSFq72qS7aoKnyvPaRtXw7bLFiY,SpATywNh6bZuzm8s1ceuBUnMUAeoAHHw,13,17,8,10,3,0,4,0,42,6.0,4,0.0,4,8,10,3,13,0,0,4,0,25,17,1
650,13491,KKBYOCb35hszQy5vSfsxbAFYFgilEECF,SpATywNh6bZuzm8s1ceuBUnMUAeoAHHw,13,7,5,9,4,0,10,0,35,5.0,4,0.0,2,5,9,4,5,0,0,10,0,20,15,1
651,13518,OcFLLEI56U80V98vNeJ7LrlE5FWxkkpp,SpATywNh6bZuzm8s1ceuBUnMUAeoAHHw,16,18,9,11,4,14,13,0,69,9.857142857142858,2,0.0,6,9,10,4,12,14,1,13,0,29,40,0
652,13525,J1f9rNzR7t1WQhWY7vU0QrkaWuS9xCeR,bWdj2GDclj5ofokWjzoa5jAwMkxCykd6,17,12,7,34,6,27,21,1,108,15.428571428571429,2,0.0,3,7,31,6,9,27,3,21,1,47,61,1
653,13530,7dPYuxC1NExRQjXFHnhWbTviIyBFUDmL,SpATywNh6bZuzm8s1ceuBUnMUAeoAHHw,5,13,6,0,1,0,2,0,22,3.142857142857143,7,0.0,0,6,0,1,13,0,0,2,0,7,15,1
654,13552,IGnubmoC2Z3kyMhnm5cfb5h7HnKkMEVq,G8EPVSXsOYB5YQWZGiz1aVq5Pgr2GrQu,5,6,2,0,1,3,4,0,16,2.2857142857142856,1,0.0,0,2,0,1,6,3,0,4,0,3,13,1
655,13578,7XgWWxsOrwxcFjioh5NncRGrx77dSS5r,SpATywNh6bZuzm8s1ceuBUnMUAeoAHHw,5,10,0,0,0,0,3,0,13,1.8571428571428572,2,0.0,2,0,0,0,8,0,0,3,0,2,11,0
656,13594,sZYvW7O1yC1PAj5iYABgZ056jCM2PsNq,SpATywNh6bZuzm8s1ceuBUnMUAeoAHHw,7,10,8,0,2,0,4,0,24,3.4285714285714284,2,0.0,0,8,0,2,10,0,0,4,0,10,14,0
657,13684,XkKS323fFxBVezQ5JyIgzxHDxEKEwwEf,A3fsA9Zfv1X2fVEQhTw51lKENdNrEqT3,14,10,7,2,5,3,4,0,31,4.428571428571429,1,0.0,0,7,2,5,10,3,0,4,0,14,17,0
658,13703,FaZLW3HiYLflnTCxi4BN21oHHvNYhtue,SpATywNh6bZuzm8s1ceuBUnMUAeoAHHw,14,34,14,18,4,1,9,0,80,11.428571428571429,7,0.0,9,14,15,4,25,1,3,9,0,42,38,1
659,13714,e4xoItGqdt7VvYzxou1Pv23rnKAXXXsC,SpATywNh6bZuzm8s1ceuBUnMUAeoAHHw,16,24,3,9,2,6,9,2,55,7.857142857142857,1,0.0,7,3,8,2,17,6,1,9,2,20,35,1
660,13720,9JsNhrsWtCheE46kbgKiC6TCsPPGBSze,SpATywNh6bZuzm8s1ceuBUnMUAeoAHHw,5,3,2,0,1,1,2,0,9,1.2857142857142858,1,0.0,0,2,0,1,3,1,0,2,0,3,6,1
661,13751,wfHTtk8oy0CiP4p3waBMhlIvxeVIbZqk,SpATywNh6bZuzm8s1ceuBUnMUAeoAHHw,16,32,12,6,4,0,12,0,66,9.428571428571429,3,0.0,4,12,6,4,28,0,0,12,0,26,40,0
662,13764,fdJXQSSucuzaRljy096jXgInnW2TakHQ,SpATywNh6bZuzm8s1ceuBUnMUAeoAHHw,15,30,20,0,10,37,18,2,117,16.714285714285715,4,0.0,3,20,0,10,27,37,0,18,2,33,84,0
663,13780,EikisME12XnhqTfgnKK3O8hmfAWTmSd3,G8EPVSXsOYB5YQWZGiz1aVq5Pgr2GrQu,34,31,19,52,12,4,10,1,129,18.428571428571427,2,0.0,9,19,45,12,22,4,7,10,1,85,44,0
664,13788,xYZJv26kEF7oZiNSoEZMnXHo33iYNlMJ,A3fsA9Zfv1X2fVEQhTw51lKENdNrEqT3,10,9,4,0,2,0,3,0,18,2.5714285714285716,2,0.0,1,4,0,2,8,0,0,3,0,7,11,1
665,14683,EK8cH2rqaeWCMjTFz8xL65N7r32HerY9,7GRhBDsirIGkRZBtSMEzNTyDr2JQm4xx,44,96,38,51,15,77,26,1,304,43.42857142857143,6,0.0,36,38,43,15,60,77,8,26,1,132,172,0
666,14818,UgETwjVUoQXyxwFA12B4jwRDb3R4sQSN,7GRhBDsirIGkRZBtSMEzNTyDr2JQm4xx,36,61,27,70,20,1,14,0,193,27.571428571428573,5,0.0,28,27,62,20,33,1,8,14,0,137,56,1
667,14829,QZIRHdwFgibI2SBehTrmLAZxED1F4JL7,7GRhBDsirIGkRZBtSMEzNTyDr2JQm4xx,6,5,2,0,2,0,1,0,10,1.4285714285714286,1,0.0,0,2,0,2,5,0,0,1,0,4,6,1
668,14846,5Xet5BwM6xDYh8pbaupnwmiq9T6jy7TC,7GRhBDsirIGkRZBtSMEzNTyDr2JQm4xx,34,41,10,55,11,14,11,0,142,20.285714285714285,2,0.0,31,10,46,11,10,14,9,11,0,98,44,1
669,14851,SDvatKCgfdtv12UzJLxR0GYxgD4pUkgT,7GRhBDsirIGkRZBtSMEzNTyDr2JQm4xx,5,3,1,0,1,0,1,0,6,0.8571428571428571,1,0.0,0,1,0,1,3,0,0,1,0,2,4,1
670,14990,5VgPwWusKQIJc1LutXp6JyAv3fzKgfIX,7GRhBDsirIGkRZBtSMEzNTyDr2JQm4xx,30,57,23,37,21,1,8,0,147,21.0,4,0.0,31,23,35,21,26,1,2,8,0,110,37,1
671,15016,yZ9FndAKqVsKwZtO1B2JJJblefdbhZ02,7GRhBDsirIGkRZBtSMEzNTyDr2JQm4xx,31,36,10,52,13,18,10,0,139,19.857142857142858,2,0.0,25,10,52,13,11,18,0,10,0,100,39,1
672,15107,HFGNqnAY2MWiYF3III5EKx6o7tu1uiwJ,7GRhBDsirIGkRZBtSMEzNTyDr2JQm4xx,37,76,35,69,17,26,20,1,244,34.857142857142854,5,0.0,22,35,59,17,54,26,10,20,1,133,111,1
673,15164,ziRAzdRuzlLfb854mAvEaRYGuXqnCERH,7GRhBDsirIGkRZBtSMEzNTyDr2JQm4xx,25,61,21,54,0,2,12,0,150,21.428571428571427,2,0.0,34,21,45,0,27,2,9,12,0,100,50,0
674,15178,28PHU9suTM8EqUKsQwsvQ03DzFXi0yDl,7GRhBDsirIGkRZBtSMEzNTyDr2JQm4xx,5,6,3,0,1,0,4,0,14,2.0,2,0.0,0,3,0,1,6,0,0,4,0,4,10,0
675,15282,FRiuKxH98VzIG6N65WQEkvVSqVJx6TSd,7GRhBDsirIGkRZBtSMEzNTyDr2JQm4xx,30,68,14,59,16,0,4,0,161,23.0,2,0.0,49,14,58,16,19,0,1,4,0,137,24,1
676,15318,5ApoT0ZoLbVQmiV8xOjwVDUBfTF6QDuq,7GRhBDsirIGkRZBtSMEzNTyDr2JQm4xx,24,40,17,35,15,20,20,2,149,21.285714285714285,2,0.0,19,17,29,15,21,20,6,20,2,80,69,1
677,15397,iWIAGeS3ATYiVCcaQcig63Lt0fYY4o8o,7GRhBDsirIGkRZBtSMEzNTyDr2JQm4xx,6,4,3,0,3,0,1,0,11,1.5714285714285714,1,0.0,0,3,0,3,4,0,0,1,0,6,5,0
678,15445,hrmgRr5TKkTKcJMaNH4IpBZoiQT9X6aI,7GRhBDsirIGkRZBtSMEzNTyDr2JQm4xx,10,16,0,0,1,2,5,0,24,3.4285714285714284,1,0.0,9,0,0,1,7,2,0,5,0,10,14,0
679,15484,2OBbYlHxjDvtkcifhxwhxMZlYPhEHOro,7GRhBDsirIGkRZBtSMEzNTyDr2JQm4xx,5,2,1,0,1,0,3,0,7,1.0,1,0.0,0,1,0,1,2,0,0,3,0,2,5,0
680,15541,ILkUjE8LhIAQFlZwnOqsyA4K0QvAbnzA,7GRhBDsirIGkRZBtSMEzNTyDr2JQm4xx,12,42,10,4,6,0,13,0,75,10.714285714285714,3,0.0,25,10,3,6,17,0,1,13,0,44,31,0
681,15577,WeG9Rj8lv2ekdTamRkXPOfgW6N9lzyds,7GRhBDsirIGkRZBtSMEzNTyDr2JQm4xx,33,37,13,54,10,0,7,0,121,17.285714285714285,2,0.0,21,13,49,10,16,0,5,7,0,93,28,1
682,15593,917a11esEUG2kjEBnxsgADWhvlUYEWb2,7GRhBDsirIGkRZBtSMEzNTyDr2JQm4xx,5,1,1,0,0,0,8,0,10,1.4285714285714286,1,0.0,0,1,0,0,1,0,0,8,0,1,9,1
683,15596,Jag1EXQWfAuTRiCgcVLyhRRkdOL9RtSD,7GRhBDsirIGkRZBtSMEzNTyDr2JQm4xx,11,12,6,2,4,17,17,0,58,8.285714285714286,4,0.0,1,6,2,4,11,17,0,17,0,13,45,1
684,15634,oco4sYAQqzdnYEwLykTSM4qmOTgkFoAN,7GRhBDsirIGkRZBtSMEzNTyDr2JQm4xx,33,32,13,46,11,11,15,1,129,18.428571428571427,2,0.0,15,13,37,11,17,11,9,15,1,76,53,0
685,15637,syrttArug8Mpzs9L0IHsvBtATawYF9J2,7GRhBDsirIGkRZBtSMEzNTyDr2JQm4xx,7,7,2,0,1,0,1,0,11,1.5714285714285714,1,0.0,2,2,0,1,5,0,0,1,0,5,6,1
686,15829,tD36vn1aCu8pvS184dpJPyASEvtRWzdE,7GRhBDsirIGkRZBtSMEzNTyDr2JQm4xx,15,17,9,22,7,2,1,0,58,8.285714285714286,1,0.0,6,9,18,7,11,2,4,1,0,40,18,0
687,15836,Ms0MC4W5moiGJLWP7iE3FImeH9CHN4KT,7GRhBDsirIGkRZBtSMEzNTyDr2JQm4xx,4,2,1,0,0,0,2,0,5,0.7142857142857143,1,0.0,0,1,0,0,2,0,0,2,0,1,4,0
688,15867,itOUYtUQXKtiNJoDhHvixGSCtswgEapf,7GRhBDsirIGkRZBtSMEzNTyDr2JQm4xx,23,35,16,13,15,1,10,0,90,12.857142857142858,2,0.0,15,16,11,15,20,1,2,10,0,57,33,1
689,16009,Slk5JcZSYHmDLQZXaNVmcMDmjJ16kBhI,7GRhBDsirIGkRZBtSMEzNTyDr2JQm4xx,21,29,0,24,2,0,2,0,57,8.142857142857142,1,0.0,16,0,23,2,13,0,1,2,0,41,16,0
690,16137,qG2WjxxVTjr5YeDGnwFvACGaHzeUu9HC,7GRhBDsirIGkRZBtSMEzNTyDr2JQm4xx,10,3,2,0,2,1,7,1,16,2.2857142857142856,2,0.0,0,2,0,2,3,1,0,7,1,4,12,1
691,16217,ESzAGDiQvgaXvzXTziuj7JqXtnuQhUld,7GRhBDsirIGkRZBtSMEzNTyDr2JQm4xx,10,13,6,0,3,0,7,0,29,4.142857142857143,2,0.0,0,6,0,3,13,0,0,7,0,9,20,1
692,16235,fV5QpAWiywuCcKLCcDbuJBbZ43MyivgG,7GRhBDsirIGkRZBtSMEzNTyDr2JQm4xx,15,16,3,12,2,3,8,1,45,6.428571428571429,1,0.0,7,3,9,2,9,3,3,8,1,21,24,1
693,16242,CtBdHmlYqpaYTMEPBvno3lS1o4khTfTp,7GRhBDsirIGkRZBtSMEzNTyDr2JQm4xx,34,46,12,49,16,12,13,4,152,21.714285714285715,2,0.0,26,12,43,16,20,12,6,13,4,97,55,1
694,16326,vEWkXCfBtnzPc8huJqQsoGlEGR1bS2AS,7GRhBDsirIGkRZBtSMEzNTyDr2JQm4xx,16,36,20,18,17,7,4,0,102,14.571428571428571,2,0.0,10,20,14,17,26,7,4,4,0,61,41,1
695,16350,jPtottuCTEl2a1fB4pqDjwAHNeUWQz5o,7GRhBDsirIGkRZBtSMEzNTyDr2JQm4xx,35,90,34,46,16,8,22,2,218,31.142857142857142,3,0.0,49,34,41,16,41,8,5,22,2,140,78,0
696,16384,DmRnf6emOOeLa4MI9vNggFDmgXu8cRIO,7GRhBDsirIGkRZBtSMEzNTyDr2JQm4xx,37,49,22,80,17,20,15,1,204,29.142857142857142,2,0.0,21,22,68,17,28,20,12,15,1,128,76,0
697,16467,pz4WzmrapGULqEk99lfOZVzJbwiC2Cl1,7GRhBDsirIGkRZBtSMEzNTyDr2JQm4xx,27,62,2,42,4,13,8,0,131,18.714285714285715,1,0.0,26,2,41,4,36,13,1,8,0,73,58,1
698,16587,3l2AMuYrLjfvMGOYSOdPeQAMIHP0QDGn,7GRhBDsirIGkRZBtSMEzNTyDr2JQm4xx,11,16,6,4,4,9,5,0,44,6.285714285714286,2,0.0,8,6,3,4,8,9,1,5,0,21,23,0
699,16669,D222lqyFrC2b1DAJCNvtq2cDPE2yWdSh,7GRhBDsirIGkRZBtSMEzNTyDr2JQm4xx,29,50,14,44,16,5,11,1,141,20.142857142857142,2,0.0,23,14,41,16,27,5,3,11,1,94,47,1
700,16792,fbDgsipajp0xhHFfXN21wQyuQBNdN7hy,7GRhBDsirIGkRZBtSMEzNTyDr2JQm4xx,32,47,21,59,15,6,8,2,158,22.571428571428573,2,0.0,18,21,52,15,29,6,7,8,2,106,52,0
701,16880,JxLtKAnMek98G5fWpyeTaKlh0zheuNnU,7GRhBDsirIGkRZBtSMEzNTyDr2JQm4xx,5,2,1,0,1,0,2,0,6,0.8571428571428571,1,0.0,0,1,0,1,2,0,0,2,0,2,4,1
702,16987,Ar7wri6od2sIMOfx95hPmMwDttR4wtOC,7GRhBDsirIGkRZBtSMEzNTyDr2JQm4xx,13,8,4,4,2,6,8,1,33,4.714285714285714,1,0.0,1,4,3,2,7,6,1,8,1,10,23,0
703,17060,WX5bge9EFbPypYuObEiSD1Gyvh8Z866G,7GRhBDsirIGkRZBtSMEzNTyDr2JQm4xx,9,6,4,0,2,2,3,0,17,2.4285714285714284,1,0.0,0,4,0,2,6,2,0,3,0,6,11,1
704,17102,queJQcMYiH8jxjXTFMi1fslIxDDACkNw,7GRhBDsirIGkRZBtSMEzNTyDr2JQm4xx,6,5,0,0,0,0,6,0,11,1.5714285714285714,2,0.0,1,0,0,0,4,0,0,6,0,1,10,1
705,17124,xOB7vl3l1Tpb0i0cSWni40BfJ5FBclms,7GRhBDsirIGkRZBtSMEzNTyDr2JQm4xx,31,97,12,72,6,2,39,2,230,32.857142857142854,3,0.0,33,12,62,6,64,2,10,39,2,113,117,0
706,17240,g2VgGARpgGy9rA8aDCffqfXvItMu95Qi,7GRhBDsirIGkRZBtSMEzNTyDr2JQm4xx,33,52,27,47,12,17,23,1,179,25.571428571428573,2,0.0,5,27,41,12,47,17,6,23,1,85,94,0
707,17242,OcmM4lAJy1xB9HSsEUxVtaUQ7oE5dcTp,7GRhBDsirIGkRZBtSMEzNTyDr2JQm4xx,23,37,10,30,6,0,3,0,86,12.285714285714286,3,0.0,20,10,25,6,17,0,5,3,0,61,25,0
708,17257,E4fUiWo3de6EW3llrqGI6KBrgWgpa0OH,7GRhBDsirIGkRZBtSMEzNTyDr2JQm4xx,25,27,0,52,7,4,2,0,92,13.142857142857142,1,0.0,19,0,48,7,8,4,4,2,0,74,18,1
709,17485,7fC3V6ivG07wUIMOmiYFzSlyjWvbYnYf,7GRhBDsirIGkRZBtSMEzNTyDr2JQm4xx,2,0,0,0,0,2,1,0,3,0.42857142857142855,1,0.0,0,0,0,0,0,2,0,1,0,0,3,0
710,17545,DGDF7EtBLvOTcfUxrOsvdCg2Ar6LlSc6,7GRhBDsirIGkRZBtSMEzNTyDr2JQm4xx,13,33,16,0,1,0,6,0,56,8.0,3,0.0,0,16,0,1,33,0,0,6,0,17,39,0
711,17634,UA8vU3s92g3lXc62U363PEO0xor6Mpeg,7GRhBDsirIGkRZBtSMEzNTyDr2JQm4xx,16,18,8,0,9,0,3,0,38,5.428571428571429,2,0.0,6,8,0,9,12,0,0,3,0,23,15,0
712,19583,EWAoo7AAzLTKxICthBrlzvoQ4jKqTV5Z,fbPkOYLVPtPgIt0MxizjfFJov3JbHyAi,3,2,0,0,0,2,1,0,5,0.7142857142857143,1,0.0,0,0,0,0,2,2,0,1,0,0,5,1
713,19585,eUVqEtQR3HLmXjNHTc0FXKT2InqoH24Q,fbPkOYLVPtPgIt0MxizjfFJov3JbHyAi,4,7,2,0,2,0,2,0,13,1.8571428571428572,3,0.0,0,2,0,2,7,0,0,2,0,4,9,1
714,19590,iES59bXqTODmGXmysyfu1geM8lUv5mwl,fbPkOYLVPtPgIt0MxizjfFJov3JbHyAi,7,7,2,0,2,0,8,0,19,2.7142857142857144,1,0.0,2,2,0,2,5,0,0,8,0,6,13,1
715,19594,4x6w2QLFfXQ2dHDa4fBCOvJ1UYg7yE69,fbPkOYLVPtPgIt0MxizjfFJov3JbHyAi,11,12,6,5,3,12,13,2,53,7.571428571428571,3,0.0,1,6,4,3,11,12,1,13,2,14,39,1
716,19596,lhkiaYX6n9dxQvsKk8vp6UZQBNlsuGnH,fbPkOYLVPtPgIt0MxizjfFJov3JbHyAi,26,77,31,44,23,75,40,1,291,41.57142857142857,2,0.0,33,31,29,23,44,75,15,40,1,116,175,0
717,19605,BPDxtvSmkKR4nTdKjes8gGxzoOprTkK2,fbPkOYLVPtPgIt0MxizjfFJov3JbHyAi,6,2,1,0,1,2,4,1,11,1.5714285714285714,1,0.0,0,1,0,1,2,2,0,4,1,2,9,1
718,19608,CJhqdTUUI9IhUemITUcGqZ2FNfX5tFcn,fbPkOYLVPtPgIt0MxizjfFJov3JbHyAi,3,1,0,0,0,0,2,0,3,0.42857142857142855,1,0.0,0,0,0,0,1,0,0,2,0,0,3,1
719,19613,hPhvZr1dLTLTcIKq5t7vAfQqTozZXlRI,fbPkOYLVPtPgIt0MxizjfFJov3JbHyAi,16,8,7,0,7,0,1,0,23,3.2857142857142856,1,0.0,0,7,0,7,8,0,0,1,0,14,9,1
720,19614,3tr9vOqNQBlqx7G8lEAeoRN3dN5LTQt8,fbPkOYLVPtPgIt0MxizjfFJov3JbHyAi,6,5,3,0,2,0,3,1,14,2.0,1,0.0,0,3,0,2,5,0,0,3,1,5,9,1
721,19618,oJ9j9ejTgKixczg3tSE8Sg8DPI7YQpJq,fbPkOYLVPtPgIt0MxizjfFJov3JbHyAi,10,17,8,0,4,14,3,0,46,6.571428571428571,2,0.0,4,8,0,4,13,14,0,3,0,16,30,0
722,19619,BcKYeHv4ZKY4DeUPw2M71hKVyOhypokT,fbPkOYLVPtPgIt0MxizjfFJov3JbHyAi,20,17,9,0,8,16,8,1,59,8.428571428571429,1,0.0,0,9,0,8,17,16,0,8,1,17,42,1
723,19625,TvUBYMbHTCcIGUIFw5l8y3Oo0Axsdspt,fbPkOYLVPtPgIt0MxizjfFJov3JbHyAi,7,10,7,0,5,0,3,0,25,3.5714285714285716,2,0.0,0,7,0,5,10,0,0,3,0,12,13,1
724,19628,eqpnrsO3UPO24LQNWGKYtfRd0DQ0MPDl,fbPkOYLVPtPgIt0MxizjfFJov3JbHyAi,13,18,1,9,3,18,15,1,65,9.285714285714286,2,0.0,9,1,7,3,9,18,2,15,1,20,45,1
725,19632,QOCecwQRgvCytTVCFa2MB091bctR2VxO,fbPkOYLVPtPgIt0MxizjfFJov3JbHyAi,6,3,2,0,2,10,1,0,18,2.5714285714285716,1,0.0,0,2,0,2,3,10,0,1,0,4,14,1
726,19635,fz559cnktTQw4xrHI1wICm1ao7bugAZA,fbPkOYLVPtPgIt0MxizjfFJov3JbHyAi,5,3,1,0,1,0,2,0,7,1.0,1,0.0,0,1,0,1,3,0,0,2,0,2,5,1
727,19637,8MQx62NrM26CEa5RRkhFUh36AiGGNx6S,fbPkOYLVPtPgIt0MxizjfFJov3JbHyAi,12,26,3,0,4,0,9,1,43,6.142857142857143,2,0.0,2,3,0,4,24,0,0,9,1,9,34,0
728,19645,bazJXiq7ucQvx12BgvEogiLDadc2i22I,fbPkOYLVPtPgIt0MxizjfFJov3JbHyAi,6,6,2,0,2,0,3,0,13,1.8571428571428572,2,0.0,2,2,0,2,4,0,0,3,0,6,7,1
729,19647,95Gw2yhEY17itkROcjsEWWGhFV0TNXNK,fbPkOYLVPtPgIt0MxizjfFJov3JbHyAi,24,28,14,14,9,4,8,0,77,11.0,1,0.0,11,14,14,9,17,4,0,8,0,48,29,1
730,19651,czkVdqv8QRpY6SHliMvW81P6eofNIUuP,fbPkOYLVPtPgIt0MxizjfFJov3JbHyAi,6,2,1,0,1,0,3,0,7,1.0,1,0.0,0,1,0,1,2,0,0,3,0,2,5,1
731,19652,UJay3MfkIPCa65Or9jDxIJTFTpNpxKv0,fbPkOYLVPtPgIt0MxizjfFJov3JbHyAi,5,10,3,0,0,0,4,0,17,2.4285714285714284,1,0.0,2,3,0,0,8,0,0,4,0,5,12,1
732,19653,RZO451egqNvgwYLVc2DT5RZC5jtK41Wn,fbPkOYLVPtPgIt0MxizjfFJov3JbHyAi,25,26,11,18,10,0,8,1,74,10.571428571428571,3,0.0,12,11,18,10,14,0,0,8,1,51,23,0
733,19662,tvh0r7BXEnkkRFvEGDSaxc2cnDAVPflf,fbPkOYLVPtPgIt0MxizjfFJov3JbHyAi,27,58,26,21,11,62,30,3,211,30.142857142857142,6,0.0,12,26,18,11,46,62,3,30,3,67,144,1
734,19663,dqE1PGrWExsbP4JkEoKdSn4p50FzqbEb,fbPkOYLVPtPgIt0MxizjfFJov3JbHyAi,7,8,5,0,4,0,2,0,19,2.7142857142857144,2,0.0,0,5,0,4,8,0,0,2,0,9,10,1
735,19664,IAvuP4GGmvnNj3Zisz3jDfo3mSmXiJSb,fbPkOYLVPtPgIt0MxizjfFJov3JbHyAi,25,77,33,34,32,1,8,1,186,26.571428571428573,4,0.0,37,33,28,32,40,1,6,8,1,130,56,1
736,19666,3mpQrDEY6qYqlUT3nGLIM1V0MOlZAk6h,fbPkOYLVPtPgIt0MxizjfFJov3JbHyAi,8,11,7,0,5,0,3,0,26,3.7142857142857144,2,0.0,1,7,0,5,10,0,0,3,0,13,13,1
737,19669,5CV53T145kru57HDn4DelXde0UjT6xqn,fbPkOYLVPtPgIt0MxizjfFJov3JbHyAi,5,6,1,0,1,0,5,0,13,1.8571428571428572,1,0.0,3,1,0,1,3,0,0,5,0,5,8,1
738,19670,CiNjO5C17d45NfmPbNPGATJqInGPv9eX,fbPkOYLVPtPgIt0MxizjfFJov3JbHyAi,2,0,0,0,0,0,8,0,8,1.1428571428571428,2,0.0,0,0,0,0,0,0,0,8,0,0,8,1
739,19672,Thuw3SvsWAczQHNEJLdc52dNwXNFxJ27,fbPkOYLVPtPgIt0MxizjfFJov3JbHyAi,1,0,0,0,0,0,1,0,1,0.14285714285714285,1,0.0,0,0,0,0,0,0,0,1,0,0,1,1
740,19673,5IM8g7YMOYo5qH7Yu3x31T3JkVOH9iqe,fbPkOYLVPtPgIt0MxizjfFJov3JbHyAi,10,18,6,0,3,5,4,0,36,5.142857142857143,2,0.0,0,6,0,3,18,5,0,4,0,9,27,1
741,19676,gWLNrui4xJ6xOW9BQTEyWRBtLNqndryz,fbPkOYLVPtPgIt0MxizjfFJov3JbHyAi,5,3,1,0,1,3,4,0,12,1.7142857142857142,1,0.0,0,1,0,1,3,3,0,4,0,2,10,1
742,19677,rl1ijjmPoVXrn0BLw0LMwhU2iQWvim3X,fbPkOYLVPtPgIt0MxizjfFJov3JbHyAi,26,65,35,14,22,46,9,0,191,27.285714285714285,3,0.0,25,35,13,22,40,46,1,9,0,95,96,0
743,19680,PLKfIj5PWmJ1pq6F2TAT2ZidBGAMa6pt,fbPkOYLVPtPgIt0MxizjfFJov3JbHyAi,24,85,32,16,20,34,21,6,214,30.571428571428573,3,0.0,34,32,13,20,51,34,3,21,6,99,115,1
744,19681,XY4zkM1XF8dydjqcvDmQyLNW1UDj6PeN,fbPkOYLVPtPgIt0MxizjfFJov3JbHyAi,16,22,11,17,7,4,6,0,67,9.571428571428571,2,0.0,7,11,15,7,15,4,2,6,0,40,27,1
745,19682,jq3G4vNjVUo5sqAQquCFzqcPQiyiVAd4,fbPkOYLVPtPgIt0MxizjfFJov3JbHyAi,9,10,6,6,4,2,3,0,31,4.428571428571429,2,0.0,1,6,5,4,9,2,1,3,0,16,15,1
746,19683,EqwF2QzEhw4NgIj4YX1bMoLFO7jCzOVt,fbPkOYLVPtPgIt0MxizjfFJov3JbHyAi,11,5,3,13,4,0,5,0,30,4.285714285714286,1,0.0,2,3,8,4,3,0,5,5,0,17,13,1
747,19684,mya8TfxNbiDk3y9Od8avdqRP3ecWgTII,fbPkOYLVPtPgIt0MxizjfFJov3JbHyAi,4,3,2,0,2,19,2,0,28,4.0,2,0.0,0,2,0,2,3,19,0,2,0,4,24,1
748,19686,CnbF8r7iTFBimMMahtVgMZeVp9U8TCPU,fbPkOYLVPtPgIt0MxizjfFJov3JbHyAi,8,14,3,0,2,5,4,1,29,4.142857142857143,1,0.0,2,3,0,2,12,5,0,4,1,7,22,1
749,19688,RxXRKZYpbfKbF79XwFGwONhlZ3CWNuKc,fbPkOYLVPtPgIt0MxizjfFJov3JbHyAi,1,0,0,0,0,0,1,0,1,0.14285714285714285,1,0.0,0,0,0,0,0,0,0,1,0,0,1,1
750,19691,j4HDn7pHd4SauRXrARz1vjrq9gR7efiY,fbPkOYLVPtPgIt0MxizjfFJov3JbHyAi,10,22,9,0,7,0,9,0,47,6.714285714285714,1,0.0,2,9,0,7,20,0,0,9,0,18,29,1
751,19697,94kd1qvIZ0nokZPS6BCV8qxXnL5MM2jB,fbPkOYLVPtPgIt0MxizjfFJov3JbHyAi,27,248,114,22,71,30,39,1,525,75.0,5,0.0,35,114,17,71,213,30,5,39,1,237,288,0
752,19700,WfC8bzRtjtkKnUrmorui57fDTiw7ripx,fbPkOYLVPtPgIt0MxizjfFJov3JbHyAi,1,0,0,0,0,0,1,0,1,0.14285714285714285,1,0.0,0,0,0,0,0,0,0,1,0,0,1,1
753,19703,PNFwnD5V878zriXX4URfko4zocKM6AxT,fbPkOYLVPtPgIt0MxizjfFJov3JbHyAi,7,5,3,0,2,1,1,0,12,1.7142857142857142,1,0.0,0,3,0,2,5,1,0,1,0,5,7,1
754,19704,5WAIxgqU8QRTpOrU8O3vmj4h4ZKof8jn,fbPkOYLVPtPgIt0MxizjfFJov3JbHyAi,6,6,2,0,2,3,1,0,14,2.0,1,0.0,3,2,0,2,3,3,0,1,0,7,7,1
755,19706,ZgQ15hhI1Ucp5464waJfnBAlAZitQ6GS,fbPkOYLVPtPgIt0MxizjfFJov3JbHyAi,17,20,9,11,11,0,8,0,59,8.428571428571429,2,0.0,9,9,9,11,11,0,2,8,0,38,21,1
756,19707,mFpiELMd2y5tbkdxs4m8pKS7gXHb7bIO,fbPkOYLVPtPgIt0MxizjfFJov3JbHyAi,6,3,2,0,2,0,1,0,8,1.1428571428571428,1,0.0,0,2,0,2,3,0,0,1,0,4,4,1
757,19710,2mdoNlBiXpgUVSmoihAheHl3NISmi738,fbPkOYLVPtPgIt0MxizjfFJov3JbHyAi,23,33,15,14,18,0,2,0,82,11.714285714285714,2,0.0,16,15,13,18,17,0,1,2,0,62,20,1
758,19711,qqdJa21dgyzvCuC2gEGuhgU9JUiH4Miw,fbPkOYLVPtPgIt0MxizjfFJov3JbHyAi,9,12,5,6,5,5,4,0,37,5.285714285714286,1,0.0,5,5,4,5,7,5,2,4,0,19,18,1
759,19712,YviwWEN6zon2XUnzizUs5e4hMfvZTKyo,fbPkOYLVPtPgIt0MxizjfFJov3JbHyAi,9,15,7,0,4,4,8,0,38,5.428571428571429,3,0.0,0,7,0,4,15,4,0,8,0,11,27,1
760,19716,VDczqRqblkMPJmrAoZEhPuTYAP3s4BVi,fbPkOYLVPtPgIt0MxizjfFJov3JbHyAi,8,6,4,0,3,0,5,0,18,2.5714285714285716,2,0.0,0,4,0,3,6,0,0,5,0,7,11,1
761,19717,vs0vqlNXzuHsqVxOsB15kGfpvGf2pUt3,fbPkOYLVPtPgIt0MxizjfFJov3JbHyAi,1,0,0,0,0,0,1,0,1,0.14285714285714285,1,0.0,0,0,0,0,0,0,0,1,0,0,1,1
762,19718,E4lbnSGpFm0DLoI5I2cB98rKNvfek7Pe,fbPkOYLVPtPgIt0MxizjfFJov3JbHyAi,9,3,2,0,2,0,6,1,14,2.0,1,0.0,0,2,0,2,3,0,0,6,1,4,10,1
763,19724,iaR2pnkwyNY3r5zTqD1W39STthtx49ji,fbPkOYLVPtPgIt0MxizjfFJov3JbHyAi,6,1,1,0,1,0,3,0,6,0.8571428571428571,1,0.0,0,1,0,1,1,0,0,3,0,2,4,1
764,19727,bL3u5qIjoppYFsMUfGswfFLujxnAggge,fbPkOYLVPtPgIt0MxizjfFJov3JbHyAi,25,62,31,9,29,43,23,2,199,28.428571428571427,5,0.0,18,31,9,29,44,43,0,23,2,87,112,0
765,19729,GP9uxCl0w0ORUxGcBwBhHCA6EDx2EOSR,fbPkOYLVPtPgIt0MxizjfFJov3JbHyAi,9,4,3,0,3,3,7,1,21,3.0,1,0.0,0,3,0,3,4,3,0,7,1,6,15,1
766,19739,XyD01HhzMuHzP5ArHNJFexoSZMamD6Wh,fbPkOYLVPtPgIt0MxizjfFJov3JbHyAi,5,5,3,0,1,0,2,0,11,1.5714285714285714,1,0.0,1,3,0,1,4,0,0,2,0,5,6,1
767,19741,IMwEerHys6R3vOnp3J0coaa20HaLBM5L,fbPkOYLVPtPgIt0MxizjfFJov3JbHyAi,2,0,0,0,0,0,4,0,4,0.5714285714285714,1,0.0,0,0,0,0,0,0,0,4,0,0,4,1
768,19749,0artPLh8IkCTAf124kxiUrz2J9bSLV97,fbPkOYLVPtPgIt0MxizjfFJov3JbHyAi,9,9,5,0,3,0,2,0,19,2.7142857142857144,2,0.0,2,5,0,3,7,0,0,2,0,10,9,1
769,19755,jMt06vkBXL8VPGQpBPqacOfIuLzrVTe6,fbPkOYLVPtPgIt0MxizjfFJov3JbHyAi,3,2,0,0,0,0,1,0,3,0.42857142857142855,1,0.0,0,0,0,0,2,0,0,1,0,0,3,1
770,19760,fKydOJi1gInT4LhNbAI1K5Nn83QpbQ9b,fbPkOYLVPtPgIt0MxizjfFJov3JbHyAi,5,2,1,0,1,0,10,0,14,2.0,2,0.0,0,1,0,1,2,0,0,10,0,2,12,1
771,19761,2ZVrSpja22JYuBdqG7iHOipKnnGEm2ou,fbPkOYLVPtPgIt0MxizjfFJov3JbHyAi,27,38,16,21,14,19,24,2,134,19.142857142857142,1,0.0,15,16,16,14,23,19,5,24,2,61,73,0
772,19765,oZrYS5rqR18A77jULvm9aJ8bGsP88f4h,fbPkOYLVPtPgIt0MxizjfFJov3JbHyAi,19,31,16,4,11,1,13,1,77,11.0,3,0.0,8,16,3,11,23,1,1,13,1,38,39,0
773,19774,R0JUZ056kzFL6PD0dHwCASPDjJEFALuj,fbPkOYLVPtPgIt0MxizjfFJov3JbHyAi,14,46,21,3,10,18,13,2,113,16.142857142857142,4,0.0,12,21,3,10,34,18,0,13,2,46,67,1
774,19775,tA1lc3vnumj95Nh6FWr8EK0wWDHGYnC2,fbPkOYLVPtPgIt0MxizjfFJov3JbHyAi,8,2,2,0,2,0,13,0,19,2.7142857142857144,1,0.0,0,2,0,2,2,0,0,13,0,4,15,1
775,19787,Uud6ejfxjo2wR9C9pIlBSyKMyMrHfe52,fbPkOYLVPtPgIt0MxizjfFJov3JbHyAi,18,15,14,0,11,20,3,0,63,9.0,2,0.0,0,14,0,11,15,20,0,3,0,25,38,1
776,19856,cNw6DSimidnnJTy63mT8fC6ow4HuQb5s,fbPkOYLVPtPgIt0MxizjfFJov3JbHyAi,11,14,8,0,6,1,6,0,35,5.0,1,0.0,3,8,0,6,11,1,0,6,0,17,18,0
777,19864,xpAxjSreQEJGjM28FJsQcyiEt1VA8RXl,fbPkOYLVPtPgIt0MxizjfFJov3JbHyAi,23,45,12,31,9,11,8,0,116,16.571428571428573,5,0.0,10,12,30,9,35,11,1,8,0,61,55,0
778,19880,7cdSr9CqRrEGZIWG84xbV4x3Kafz72lh,fbPkOYLVPtPgIt0MxizjfFJov3JbHyAi,1,0,0,0,0,0,1,0,1,0.14285714285714285,1,0.0,0,0,0,0,0,0,0,1,0,0,1,1
779,19883,oBB4V7EIN8ossAzWm6ldlqIytEJdobH7,fbPkOYLVPtPgIt0MxizjfFJov3JbHyAi,10,13,9,0,6,3,9,1,41,5.857142857142857,2,0.0,0,9,0,6,13,3,0,9,1,15,26,1
780,19890,IVtvtdZLBtL9DhFAioWkcCx38OrFXpXg,fbPkOYLVPtPgIt0MxizjfFJov3JbHyAi,10,37,21,7,0,33,15,1,114,16.285714285714285,6,0.0,5,21,5,0,32,33,2,15,1,31,83,0
781,19915,qFnFxVZ0kWnoJ6Z9EGCtfX2XIxJ2ju5D,fbPkOYLVPtPgIt0MxizjfFJov3JbHyAi,7,3,2,0,2,0,6,0,13,1.8571428571428572,1,0.0,0,2,0,2,3,0,0,6,0,4,9,0
782,19922,1qrewX2JRhRs3lyeTFWMYnwQw6V9CpLd,fbPkOYLVPtPgIt0MxizjfFJov3JbHyAi,9,6,4,0,3,0,2,0,15,2.142857142857143,1,0.0,0,4,0,3,6,0,0,2,0,7,8,1
783,19923,a0YvhqmPpF6B62CVp5XUUUyQ2cFSSLDq,fbPkOYLVPtPgIt0MxizjfFJov3JbHyAi,6,4,3,0,3,4,2,0,16,2.2857142857142856,1,0.0,0,3,0,3,4,4,0,2,0,6,10,1
784,19924,OT5T42YlAbCtocwISa5ev3ROMYVra29q,fbPkOYLVPtPgIt0MxizjfFJov3JbHyAi,5,2,1,0,1,3,3,0,10,1.4285714285714286,1,0.0,0,1,0,1,2,3,0,3,0,2,8,1
785,19925,u82lBhpDxJIwlZISEntCxj1zgVFdW0vT,fbPkOYLVPtPgIt0MxizjfFJov3JbHyAi,1,0,0,0,0,0,3,0,3,0.42857142857142855,1,0.0,0,0,0,0,0,0,0,3,0,0,3,1
786,19929,rVO8IsFZOLqwyY7i49TyObO4q8Yse38O,fbPkOYLVPtPgIt0MxizjfFJov3JbHyAi,17,16,0,19,1,0,2,0,38,5.428571428571429,1,0.0,7,0,16,1,9,0,3,2,0,24,14,1
787,21469,5oy5I8Xh5KkzBBzgBTkYXJ5uADqnzeVC,7GRhBDsirIGkRZBtSMEzNTyDr2JQm4xx,31,72,17,50,14,14,5,0,172,24.571428571428573,2,0.0,41,17,40,14,31,14,10,5,0,112,60,0
788,21478,43nq30xhRsgmZVAWkH8Zjb7IyZDGRDeY,7GRhBDsirIGkRZBtSMEzNTyDr2JQm4xx,35,86,31,38,17,41,18,0,231,33.0,4,0.0,38,31,35,17,48,41,3,18,0,121,110,0
789,21499,L74tKRZpBi1qsh0NM3EwE5D87acCLK8s,7GRhBDsirIGkRZBtSMEzNTyDr2JQm4xx,54,68,25,89,9,0,15,0,206,29.428571428571427,2,0.0,34,25,81,9,34,0,8,15,0,149,57,0
790,22007,eovSKdG09ZHYTXNtS1zUIy1RfsRsCibs,7GRhBDsirIGkRZBtSMEzNTyDr2JQm4xx,33,82,26,49,17,24,24,1,223,31.857142857142858,3,0.0,53,26,38,17,29,24,11,24,1,134,89,0
791,22130,lw56FfuS5fUETVCyRkCnysAZop6MzvUe,7GRhBDsirIGkRZBtSMEzNTyDr2JQm4xx,4,6,1,0,0,0,3,0,10,1.4285714285714286,1,0.0,2,1,0,0,4,0,0,3,0,3,7,0
792,22218,qpd1RINX0ghAugS9ZiQmRvWMQe2xJWfG,7GRhBDsirIGkRZBtSMEzNTyDr2JQm4xx,28,85,4,36,4,8,5,0,142,20.285714285714285,3,0.0,50,4,36,4,35,8,0,5,0,94,48,1
793,22649,kpDqfPKqqQYJmKMTzN1Sox48V4ZPJuXL,SpATywNh6bZuzm8s1ceuBUnMUAeoAHHw,17,24,9,14,4,5,11,0,67,9.571428571428571,2,0.0,9,9,11,4,15,5,3,11,0,33,34,1
794,22676,CMoV5dPTzwxV3W6HJJmvW8wSnp90ZPh2,SpATywNh6bZuzm8s1ceuBUnMUAeoAHHw,10,10,7,0,5,0,5,0,27,3.857142857142857,3,0.0,0,7,0,5,10,0,0,5,0,12,15,0
795,22715,3cB0rEpxJxC0jjqfQ9EPT6ntxFajOXrx,SpATywNh6bZuzm8s1ceuBUnMUAeoAHHw,16,45,17,22,6,25,16,1,132,18.857142857142858,4,0.0,9,17,16,6,36,25,6,16,1,48,84,0
796,22738,83J9IXuPcwdDBJoFENdSQFWzvgELVzeu,G8EPVSXsOYB5YQWZGiz1aVq5Pgr2GrQu,24,98,31,70,6,22,17,2,246,35.142857142857146,2,0.0,42,31,55,6,56,22,15,17,2,134,112,1
797,22741,ooFElJ4ZPOLTBMQwigtvKfnHk0DNrR2R,SpATywNh6bZuzm8s1ceuBUnMUAeoAHHw,6,3,2,0,2,0,1,0,8,1.1428571428571428,1,0.0,0,2,0,2,3,0,0,1,0,4,4,1
798,22747,5GeMwmyzCXMcMYfcWdKaXbpNNdL8bmPq,A3fsA9Zfv1X2fVEQhTw51lKENdNrEqT3,6,2,1,0,1,0,5,0,9,1.2857142857142858,2,0.0,0,1,0,1,2,0,0,5,0,2,7,1
799,22757,LJYBef7iIBiSZz8D7KTtMTsdkyd91gnR,SpATywNh6bZuzm8s1ceuBUnMUAeoAHHw,9,19,10,0,4,0,9,0,42,6.0,2,0.0,0,10,0,4,19,0,0,9,0,14,28,0
800,22766,BImVQpNaWI5ZZjLENiRV2V2LYkbW88m0,RXDvfPUBYFlVdlueBFbLW0mhhAyGEqpt,39,44,22,52,12,0,2,0,132,18.857142857142858,2,0.0,11,22,50,12,33,0,2,2,0,95,37,0
801,22777,jpXIq3stqWScWG27acYJbNKpdTmc6kli,A3fsA9Zfv1X2fVEQhTw51lKENdNrEqT3,6,7,3,0,0,9,9,0,28,4.0,2,0.0,0,3,0,0,7,9,0,9,0,3,25,1
802,22787,XCY83tv4aCv2fMTPmH1QE6tZOtr7KzJT,G8EPVSXsOYB5YQWZGiz1aVq5Pgr2GrQu,48,91,36,112,0,5,18,3,265,37.857142857142854,3,0.0,43,36,83,0,48,5,29,18,3,162,103,0
803,22876,yZi2eaDxP9Hsc5TkKYLN2LUYSBmbQGTr,SpATywNh6bZuzm8s1ceuBUnMUAeoAHHw,14,21,7,15,3,0,2,0,48,6.857142857142857,1,0.0,13,7,12,3,8,0,3,2,0,35,13,0
804,22877,qjNUBrpwN8flYc0VorTlQJNEWSbIR2KA,A3fsA9Zfv1X2fVEQhTw51lKENdNrEqT3,37,56,7,58,3,6,14,0,144,20.571428571428573,2,0.0,4,7,51,3,52,6,7,14,0,65,79,1
805,22880,ti1hbICHLqROy8Y7XhKRxGlLqF2ITiDH,RXDvfPUBYFlVdlueBFbLW0mhhAyGEqpt,40,48,31,109,21,0,13,0,222,31.714285714285715,2,0.0,14,31,93,21,34,0,16,13,0,159,63,0
806,22899,AoDbGxsdtQ88iavwLYzXC5a1sZ4YMkt5,SpATywNh6bZuzm8s1ceuBUnMUAeoAHHw,16,21,7,18,4,12,8,0,70,10.0,2,0.0,12,7,15,4,9,12,3,8,0,38,32,1
807,22915,dLoTMfurIDgppPqjn68MhR8oLIGjxbCC,bWdj2GDclj5ofokWjzoa5jAwMkxCykd6,5,4,3,0,1,0,1,0,9,1.2857142857142858,1,0.0,0,3,0,1,4,0,0,1,0,4,5,1
808,22934,I4EJkH4zClhTB2lKNgq7Q2fKtUYoVDSA,A3fsA9Zfv1X2fVEQhTw51lKENdNrEqT3,13,30,3,0,2,3,17,2,57,8.142857142857142,3,0.0,0,3,0,2,30,3,0,17,2,5,52,1
809,22937,7mQeRnk4E67KJHDHSAp1BOWEWVuxMvA2,SpATywNh6bZuzm8s1ceuBUnMUAeoAHHw,5,4,2,0,0,0,4,1,11,1.5714285714285714,1,0.0,0,2,0,0,4,0,0,4,1,2,9,1
810,22985,Dkp4ht4oz2wUhu9UvNTwrqC02rtqcSZH,SpATywNh6bZuzm8s1ceuBUnMUAeoAHHw,4,2,1,0,1,0,2,0,6,0.8571428571428571,1,0.0,0,1,0,1,2,0,0,2,0,2,4,1
811,22998,nCARlKCtX8cCYdg9wv53tMq1HV8fOfAB,RXDvfPUBYFlVdlueBFbLW0mhhAyGEqpt,24,48,0,24,1,2,12,1,88,12.571428571428571,1,0.0,4,0,24,1,44,2,0,12,1,29,59,1
812,23011,Qi3PLuC7w2Yo9hFgq37MObjY8icnRdc6,A3fsA9Zfv1X2fVEQhTw51lKENdNrEqT3,37,33,13,82,3,24,23,2,180,25.714285714285715,5,0.0,1,13,63,3,32,24,19,23,2,80,100,0
813,23016,jZn0klM9Bk084k9gvux7E5DK1oO1FwuJ,SpATywNh6bZuzm8s1ceuBUnMUAeoAHHw,11,15,9,2,4,0,4,0,34,4.857142857142857,2,0.0,0,9,2,4,15,0,0,4,0,15,19,0
814,23032,UInMBEH8f1h2vxXVslRsWyLOTv8ggYq3,RXDvfPUBYFlVdlueBFbLW0mhhAyGEqpt,25,31,13,0,8,0,5,0,57,8.142857142857142,2,0.0,0,13,0,8,31,0,0,5,0,21,36,0
815,23035,e09uq36QgLuBVK5DERoejsHeMH2uPMRM,SpATywNh6bZuzm8s1ceuBUnMUAeoAHHw,1,0,0,0,0,0,1,0,1,0.14285714285714285,1,0.0,0,0,0,0,0,0,0,1,0,0,1,1
816,23038,0DzldTHKdoH90kklIAjpWyAEe6XDDjyM,SpATywNh6bZuzm8s1ceuBUnMUAeoAHHw,13,36,4,19,0,3,15,1,78,11.142857142857142,5,0.0,11,4,16,0,25,3,3,15,1,31,47,0
817,23072,Pb0Dj6dRtTGmcuNxvaHjmGw0iPTyjSsN,bWdj2GDclj5ofokWjzoa5jAwMkxCykd6,6,2,1,0,1,0,4,0,8,1.1428571428571428,1,0.0,0,1,0,1,2,0,0,4,0,2,6,1
818,23075,CUMuKIhvWkMSk50Or6FhgPf1tk7jntYp,SpATywNh6bZuzm8s1ceuBUnMUAeoAHHw,7,13,4,0,0,0,6,0,23,3.2857142857142856,2,0.0,6,4,0,0,7,0,0,6,0,10,13,0
819,23097,5wbqpjsRycE3Ij1gukLWuLp8it7vr80U,SpATywNh6bZuzm8s1ceuBUnMUAeoAHHw,15,54,14,6,0,58,15,2,149,21.285714285714285,2,0.0,31,14,6,0,23,58,0,15,2,51,98,1
820,23121,9S5uoFAiVHVF4D2DNR23wCkbQZ8LhtES,SpATywNh6bZuzm8s1ceuBUnMUAeoAHHw,12,11,2,6,1,0,3,0,23,3.2857142857142856,1,0.0,2,2,6,1,9,0,0,3,0,11,12,0
821,23142,6j5Aoj3JOkcTRkyfXNVtTy229CS4uihi,G8EPVSXsOYB5YQWZGiz1aVq5Pgr2GrQu,67,90,29,130,20,1,12,3,285,40.714285714285715,6,0.0,37,29,100,20,53,1,30,12,3,186,99,0
822,23183,HycevJIm7cBjf1oJ5QCBMMXEBTG8jyRF,A3fsA9Zfv1X2fVEQhTw51lKENdNrEqT3,23,27,20,0,7,0,12,0,66,9.428571428571429,2,0.0,1,20,0,7,26,0,0,12,0,28,38,0
823,23185,HycevJIm7cBjf1oJ5QCBMMXEBTG8jyRF,bWdj2GDclj5ofokWjzoa5jAwMkxCykd6,6,3,0,4,0,0,6,0,13,1.8571428571428572,3,0.0,1,0,3,0,2,0,1,6,0,4,9,0
824,23197,BDdKHYPp1edgylVPYUBHaWJ6W3VobGdR,SpATywNh6bZuzm8s1ceuBUnMUAeoAHHw,15,40,19,16,8,9,9,0,101,14.428571428571429,2,0.0,12,19,14,8,28,9,2,9,0,53,48,1
825,23201,mE5coXp72CvzVrqwpPF6wLVZrHDH0Vlq,SpATywNh6bZuzm8s1ceuBUnMUAeoAHHw,15,40,14,20,5,0,23,9,111,15.857142857142858,3,0.0,17,14,17,5,23,0,3,23,9,53,58,0
826,23206,ieR2oDuOBOWrOSx08B7vLKsdvt41Kjgw,bWdj2GDclj5ofokWjzoa5jAwMkxCykd6,7,11,0,0,1,4,4,1,21,3.0,2,0.0,2,0,0,1,9,4,0,4,1,3,18,1
827,23299,FuoDsqlUs6ZIyTkMTIVnWx4xFWKln8DR,SpATywNh6bZuzm8s1ceuBUnMUAeoAHHw,13,25,10,12,6,0,4,0,57,8.142857142857142,3,0.0,6,10,12,6,19,0,0,4,0,34,23,0
828,23316,QdSH85e6TVvHCb4lCpuXbYzwkD8QbL3t,G8EPVSXsOYB5YQWZGiz1aVq5Pgr2GrQu,14,27,8,8,5,1,5,0,54,7.714285714285714,3,0.0,3,8,5,5,24,1,3,5,0,21,33,0
829,23322,w2sKd0cOObBRKhbutYISAGM6GUL3hKiJ,A3fsA9Zfv1X2fVEQhTw51lKENdNrEqT3,1,0,0,0,0,0,2,0,2,0.2857142857142857,1,0.0,0,0,0,0,0,0,0,2,0,0,2,1
830,23329,v8AEmfj5ScfNiqWSiB9twce4e05jQ9FQ,SpATywNh6bZuzm8s1ceuBUnMUAeoAHHw,4,4,1,0,1,0,1,0,7,1.0,1,0.0,0,1,0,1,4,0,0,1,0,2,5,1
831,23332,V1z8w9SjLbULVqlANveH3qv7vwfEbAs7,A3fsA9Zfv1X2fVEQhTw51lKENdNrEqT3,43,39,25,58,10,5,41,0,178,25.428571428571427,6,0.0,3,25,52,10,36,5,6,41,0,90,88,0
832,23391,X8qfNjsHrwR5R67KkU9t7FXc6jQSGsyo,bWdj2GDclj5ofokWjzoa5jAwMkxCykd6,19,32,2,40,5,60,19,0,158,22.571428571428573,3,0.0,6,2,35,5,26,60,5,19,0,48,110,1
833,23403,GWG8afsUfRei9CIZYg1Y2sBsF64D5J9k,A3fsA9Zfv1X2fVEQhTw51lKENdNrEqT3,16,16,10,0,8,0,2,0,36,5.142857142857143,1,0.0,0,10,0,8,16,0,0,2,0,18,18,0
834,23410,yGTKMCuyZTpBDN6edeGIEf8UqO2mMowi,SpATywNh6bZuzm8s1ceuBUnMUAeoAHHw,14,12,6,18,3,0,2,0,41,5.857142857142857,1,0.0,4,6,15,3,8,0,3,2,0,28,13,1
835,23443,2XRKCevyRsuXIpuLiEj19nm5B7ajsjxd,SpATywNh6bZuzm8s1ceuBUnMUAeoAHHw,13,11,7,0,4,1,9,1,33,4.714285714285714,1,0.0,0,7,0,4,11,1,0,9,1,11,22,1
836,23454,mP7U4YN4Z2p45M3a970DvaALst8JAKLF,SpATywNh6bZuzm8s1ceuBUnMUAeoAHHw,5,2,1,0,1,0,4,0,8,1.1428571428571428,1,0.0,0,1,0,1,2,0,0,4,0,2,6,1
837,23458,cAyxesGtWW4tBzueSc3JcCfBcF1iSxzo,SpATywNh6bZuzm8s1ceuBUnMUAeoAHHw,4,2,1,0,0,0,4,0,7,1.0,1,0.0,0,1,0,0,2,0,0,4,0,1,6,0
838,23502,wNbKFPX6oYsfVEr8buyWthBblPuPZGxv,A3fsA9Zfv1X2fVEQhTw51lKENdNrEqT3,1,0,0,0,0,0,1,0,1,0.14285714285714285,1,0.0,0,0,0,0,0,0,0,1,0,0,1,0
839,23530,CfoeUJ6vk7a3PuEp1yrQNFUplkLjQYge,SpATywNh6bZuzm8s1ceuBUnMUAeoAHHw,4,2,0,0,0,1,2,0,5,0.7142857142857143,1,0.0,0,0,0,0,2,1,0,2,0,0,5,0
840,23557,M6VmJD8JYDR5w6GV5uzAgWpIXM5eanml,SpATywNh6bZuzm8s1ceuBUnMUAeoAHHw,17,29,17,10,6,4,10,0,76,10.857142857142858,2,0.0,5,17,9,6,24,4,1,10,0,37,39,0
841,23576,mRXmcsJQnNw2mccUFVukDwZxk7roAYf4,SpATywNh6bZuzm8s1ceuBUnMUAeoAHHw,9,9,4,0,2,0,13,3,31,4.428571428571429,1,0.0,0,4,0,2,9,0,0,13,3,6,25,1
842,23589,mptZxS2IRXAopBdChMP75EgVt5rtRsUT,SpATywNh6bZuzm8s1ceuBUnMUAeoAHHw,8,12,5,0,1,0,4,0,22,3.142857142857143,4,0.0,0,5,0,1,12,0,0,4,0,6,16,1
843,23601,jKWIhuXmlYFBIapfd4E50TBTHed3oveP,A3fsA9Zfv1X2fVEQhTw51lKENdNrEqT3,13,15,7,0,5,0,2,0,29,4.142857142857143,2,0.0,0,7,0,5,15,0,0,2,0,12,17,1
844,23616,VADc1m6JjTG2LuLkbhEfhADWJMHaDmqK,SpATywNh6bZuzm8s1ceuBUnMUAeoAHHw,5,8,4,0,0,3,3,0,18,2.5714285714285716,2,0.0,0,4,0,0,8,3,0,3,0,4,14,0
845,23621,HRaTe8gWBsDiLkzfbQMnooVDWfwWVb7m,SpATywNh6bZuzm8s1ceuBUnMUAeoAHHw,17,55,5,20,2,46,53,15,196,28.0,5,0.0,10,5,17,2,45,46,3,53,15,34,162,0
846,23629,1GEou0jUAwSZvf4K9js5E10dDnbmQpAC,bWdj2GDclj5ofokWjzoa5jAwMkxCykd6,6,2,1,0,1,0,6,0,10,1.4285714285714286,1,0.0,0,1,0,1,2,0,0,6,0,2,8,1
847,23634,hs0BkyfSJv3crs4cIvcxkt53zip5FMPg,SpATywNh6bZuzm8s1ceuBUnMUAeoAHHw,14,16,10,12,4,1,4,0,47,6.714285714285714,3,0.0,3,10,12,4,13,1,0,4,0,29,18,1
848,23642,04gG5zVwZ7Vr68t1LtjimV9KPqGTDxDK,SpATywNh6bZuzm8s1ceuBUnMUAeoAHHw,18,39,15,20,3,43,37,1,158,22.571428571428573,5,0.0,9,15,16,3,30,43,4,37,1,43,115,0
849,23651,35E85h2ExBPeTd1VmxNX0GKo8krIMsCP,RXDvfPUBYFlVdlueBFbLW0mhhAyGEqpt,16,26,14,0,4,0,8,0,52,7.428571428571429,3,0.0,2,14,0,4,24,0,0,8,0,20,32,1
850,23667,1NMKv7RE12uBMKwNJI30Cx8Z5ltMGoee,SpATywNh6bZuzm8s1ceuBUnMUAeoAHHw,14,19,11,8,8,0,2,0,48,6.857142857142857,1,0.0,6,11,8,8,13,0,0,2,0,33,15,0
851,23672,F9d8ehlFxvqouYiZgUKxdbX5NI44Sbpl,SpATywNh6bZuzm8s1ceuBUnMUAeoAHHw,17,26,14,20,6,17,18,1,102,14.571428571428571,1,0.0,6,14,17,6,20,17,3,18,1,43,59,1
852,23724,wQU3lY7mCoAWFqnxNLhiEFrdAWtS5Hh9,SpATywNh6bZuzm8s1ceuBUnMUAeoAHHw,13,13,6,2,4,0,6,0,31,4.428571428571429,3,0.0,0,6,2,4,13,0,0,6,0,12,19,0
853,23747,x3sZblYMoUvQJbk7l9GY688n7RQqaQct,A3fsA9Zfv1X2fVEQhTw51lKENdNrEqT3,7,7,1,0,0,0,1,0,9,1.2857142857142858,1,0.0,0,1,0,0,7,0,0,1,0,1,8,1
854,23776,JoruyAOmEeM1qjcSEWRUjLvQUHpNPZGp,SpATywNh6bZuzm8s1ceuBUnMUAeoAHHw,14,32,0,12,0,24,13,1,82,11.714285714285714,1,0.0,10,0,9,0,22,24,3,13,1,19,63,1
855,23839,xHZbSROhwP4RRQerUVWvcNTfOGc2DHWf,bWdj2GDclj5ofokWjzoa5jAwMkxCykd6,8,17,7,0,1,22,16,0,63,9.0,6,0.0,0,7,0,1,17,22,0,16,0,8,55,0
856,23845,TSxGfcluByCTxwgFYbniUiwGZJ5ZTUOD,RXDvfPUBYFlVdlueBFbLW0mhhAyGEqpt,3,0,0,0,0,0,3,0,3,0.42857142857142855,1,0.0,0,0,0,0,0,0,0,3,0,0,3,1
857,23859,XNb7KU6KeHuNJzclGX2ePynnmu8yxV3v,SpATywNh6bZuzm8s1ceuBUnMUAeoAHHw,4,2,0,0,0,0,6,0,8,1.1428571428571428,1,0.0,0,0,0,0,2,0,0,6,0,0,8,0
858,23884,GJmfZNR8PZRpI11B5boI8G7Sd4djdQgk,SpATywNh6bZuzm8s1ceuBUnMUAeoAHHw,12,14,6,19,3,0,2,0,44,6.285714285714286,1,0.0,3,6,16,3,11,0,3,2,0,28,16,1
859,23913,6MGET4duNnhYB7elJoLURxwHMKRGtg9y,bWdj2GDclj5ofokWjzoa5jAwMkxCykd6,6,8,3,0,3,0,3,0,17,2.4285714285714284,1,0.0,3,3,0,3,5,0,0,3,0,9,8,1
860,23962,5pjAdY5K4FfgQPLSzQKwXaKF78ph9a0y,RXDvfPUBYFlVdlueBFbLW0mhhAyGEqpt,46,135,60,92,30,27,30,0,374,53.42857142857143,5,0.0,21,60,84,30,114,27,8,30,0,195,179,0
861,23977,tkDslnD6NXbenEreFtnV2nvNZ4GDJajz,RXDvfPUBYFlVdlueBFbLW0mhhAyGEqpt,4,1,0,0,0,0,3,0,4,0.5714285714285714,1,0.0,0,0,0,0,1,0,0,3,0,0,4,1
862,23984,HAPPxnLUjIhcauBZnnWBFk3JE6gETTxa,SpATywNh6bZuzm8s1ceuBUnMUAeoAHHw,15,13,5,12,3,1,6,2,42,6.0,1,0.0,6,5,11,3,7,1,1,6,2,25,17,1
863,24000,tML4IQ8jFiP4YuH9NbvzKQFqAdof0qcO,SpATywNh6bZuzm8s1ceuBUnMUAeoAHHw,15,34,0,18,0,66,18,1,137,19.571428571428573,4,0.0,12,0,15,0,22,66,3,18,1,27,110,0
864,24021,wPWqnGAkrR45TEYOXZpjGrKRubMl9rFP,SpATywNh6bZuzm8s1ceuBUnMUAeoAHHw,12,24,0,9,0,25,8,0,66,9.428571428571429,4,0.0,6,0,9,0,18,25,0,8,0,15,51,0
865,24024,OIPBfPb9802WcbHz02njDB4ysP5ao9fe,SpATywNh6bZuzm8s1ceuBUnMUAeoAHHw,12,9,0,11,0,2,5,2,29,4.142857142857143,1,0.0,4,0,10,0,5,2,1,5,2,14,15,0
866,24122,4e4wTy2Vsuz8jVFYgJOgi1kIGDWREiPH,bWdj2GDclj5ofokWjzoa5jAwMkxCykd6,11,26,9,0,1,1,22,6,65,9.285714285714286,3,0.0,2,9,0,1,24,1,0,22,6,12,53,0
867,24132,je9A6l6tP7wnbFhNJD7vbbHTYhqshuqB,SpATywNh6bZuzm8s1ceuBUnMUAeoAHHw,8,20,6,0,2,1,4,0,33,4.714285714285714,2,0.0,9,6,0,2,11,1,0,4,0,17,16,1
868,24135,yntNdGOvrRZS9CTrjjNKRRz96Mc1JGbf,bWdj2GDclj5ofokWjzoa5jAwMkxCykd6,5,7,1,46,2,0,1,0,57,8.142857142857142,1,0.0,5,1,46,2,2,0,0,1,0,54,3,1
869,24287,Ms0MC4W5moiGJLWP7iE3FImeH9CHN4KT,bWdj2GDclj5ofokWjzoa5jAwMkxCykd6,15,43,12,16,4,6,14,1,96,13.714285714285714,5,0.0,12,12,13,4,31,6,3,14,1,41,55,0
870,24303,pYcnIzYPgb3xzrOvmR9y0UUIZo4gqKuO,RXDvfPUBYFlVdlueBFbLW0mhhAyGEqpt,50,95,56,92,19,5,19,3,289,41.285714285714285,6,0.0,19,56,81,19,76,5,11,19,3,175,114,0
871,24304,UzwJVyLJF6Ih9iHYPyYWMullgIr89o5m,RXDvfPUBYFlVdlueBFbLW0mhhAyGEqpt,46,91,46,67,19,10,21,0,254,36.285714285714285,6,0.0,19,46,65,19,72,10,2,21,0,149,105,0
872,24332,NY9lbGArbud0VjFCO45IgKzDykuc5Wkn,SpATywNh6bZuzm8s1ceuBUnMUAeoAHHw,4,2,1,0,1,0,2,0,6,0.8571428571428571,1,0.0,0,1,0,1,2,0,0,2,0,2,4,1
873,24358,IIdYSsTHK0XdI7wZc5S09iVifP1zJLzN,SpATywNh6bZuzm8s1ceuBUnMUAeoAHHw,14,47,24,14,0,15,28,1,129,18.428571428571427,4,0.0,11,24,11,0,36,15,3,28,1,46,83,1
874,24370,nuKEM7FMFD9npzL9DafH3T1pYgMoLJoQ,SpATywNh6bZuzm8s1ceuBUnMUAeoAHHw,11,20,11,7,5,0,6,0,49,7.0,4,0.0,0,11,6,5,20,0,1,6,0,22,27,0
875,24383,Ialz252wY3knIVjOtCWLYcvvPO6EGRFT,SpATywNh6bZuzm8s1ceuBUnMUAeoAHHw,11,17,2,16,0,4,3,0,42,6.0,2,0.0,8,2,15,0,9,4,1,3,0,25,17,0
876,24394,Zhz7dkJdB0wauB8JtGSDj0NsuH0ZH8Cd,SpATywNh6bZuzm8s1ceuBUnMUAeoAHHw,6,5,3,0,2,0,3,0,13,1.8571428571428572,1,0.0,0,3,0,2,5,0,0,3,0,5,8,1
877,24481,MlSRfdfvLbnwipGT1vckZAUcsWbqV0Nz,bWdj2GDclj5ofokWjzoa5jAwMkxCykd6,5,2,1,0,1,0,2,0,6,0.8571428571428571,1,0.0,0,1,0,1,2,0,0,2,0,2,4,0
878,24532,Hxi6d4DzV7K1jcnZIhXlJzpIYDP4sYeZ,G8EPVSXsOYB5YQWZGiz1aVq5Pgr2GrQu,32,33,0,138,3,0,5,0,179,25.571428571428573,2,0.0,20,0,130,3,13,0,8,5,0,153,26,0
879,24629,ja7eUjcxSqFnoRSNZAdtMUdo5WLyuwNj,RXDvfPUBYFlVdlueBFbLW0mhhAyGEqpt,17,16,10,0,6,0,8,3,43,6.142857142857143,3,0.0,2,10,0,6,14,0,0,8,3,18,25,1
880,24645,0JvlwMe8wRQNeLJu71UvJCaEJca2naUP,bWdj2GDclj5ofokWjzoa5jAwMkxCykd6,11,17,12,0,7,4,13,0,53,7.571428571428571,3,0.0,0,12,0,7,17,4,0,13,0,19,34,0
881,24656,LpLPysd45mBlrVFCgTTBBbMGnlXmZLO1,7GRhBDsirIGkRZBtSMEzNTyDr2JQm4xx,33,106,31,41,10,29,22,4,243,34.714285714285715,4,0.0,46,31,39,10,60,29,2,22,4,126,117,1
882,24674,99qhCmy07rsquumjTFRELTtrLHpQpj07,bWdj2GDclj5ofokWjzoa5jAwMkxCykd6,7,7,3,0,2,0,3,0,15,2.142857142857143,2,0.0,0,3,0,2,7,0,0,3,0,5,10,0
883,24729,z9sj5HIJml1DMOMfRKKBQ7IvS2IoE424,7GRhBDsirIGkRZBtSMEzNTyDr2JQm4xx,18,55,18,0,2,4,9,5,93,13.285714285714286,2,0.0,19,18,0,2,36,4,0,9,5,39,54,1
884,24760,NVJD7a4veZi4dOPtkddbSAsIN5dFV8jt,SpATywNh6bZuzm8s1ceuBUnMUAeoAHHw,17,19,9,17,4,19,27,4,99,14.142857142857142,2,0.0,6,9,16,4,13,19,1,27,4,35,64,0
885,24775,FeUvHE3xENj0OT6fhaRqvHDDKwwtsMRR,SpATywNh6bZuzm8s1ceuBUnMUAeoAHHw,16,30,14,9,7,0,8,0,68,9.714285714285714,4,0.0,10,14,9,7,20,0,0,8,0,40,28,0
886,24841,GfRp1O86gI5zJJh8SIJ1bczUJPWlAqoK,7GRhBDsirIGkRZBtSMEzNTyDr2JQm4xx,31,95,28,40,7,16,23,2,211,30.142857142857142,6,0.0,12,28,32,7,83,16,8,23,2,79,132,1
887,24860,FPPbdZs5zRERbNXCB9udITtxlck6dBd9,SpATywNh6bZuzm8s1ceuBUnMUAeoAHHw,14,31,1,10,0,33,10,4,89,12.714285714285714,3,0.0,7,1,9,0,24,33,1,10,4,17,72,0
888,24875,97rJErYjCaSZkM2sQr4Hy3em0yNLLl9Z,7GRhBDsirIGkRZBtSMEzNTyDr2JQm4xx,27,117,47,41,12,78,13,0,308,44.0,1,0.0,42,47,40,12,75,78,1,13,0,141,167,0
889,24928,TG3ztGx3Y2jZOJDYHqGnCtBQf1aN9Xf7,7GRhBDsirIGkRZBtSMEzNTyDr2JQm4xx,15,36,15,12,11,2,17,1,94,13.428571428571429,3,0.0,14,15,10,11,22,2,2,17,1,50,44,1
890,24975,KKySZH8Vhrdd4z2bRf8FAPkHeGpE3JpX,7GRhBDsirIGkRZBtSMEzNTyDr2JQm4xx,17,29,3,16,1,0,9,0,58,8.285714285714286,3,0.0,5,3,15,1,24,0,1,9,0,24,34,1
891,25008,AlPSASl29ys7OO31KpYSADARO0IiSNGm,SpATywNh6bZuzm8s1ceuBUnMUAeoAHHw,9,10,6,0,3,0,3,0,22,3.142857142857143,2,0.0,0,6,0,3,10,0,0,3,0,9,13,1
892,25128,5ysSxswt94Gjj7n5OSEcRzDBWhgbKFUg,SpATywNh6bZuzm8s1ceuBUnMUAeoAHHw,11,10,7,2,4,0,3,0,26,3.7142857142857144,2,0.0,0,7,2,4,10,0,0,3,0,13,13,0
893,25140,s4t4u8r9weCt43Z5PXbFAgqmS5WJ6hj5,G8EPVSXsOYB5YQWZGiz1aVq5Pgr2GrQu,6,6,0,8,0,0,1,0,15,2.142857142857143,1,0.0,4,0,4,0,2,0,4,1,0,8,7,1
894,25196,3Oka5GvBd9TakXRvr9D5vxoJEhxwuxJA,RXDvfPUBYFlVdlueBFbLW0mhhAyGEqpt,14,19,13,33,0,10,11,5,91,13.0,3,0.0,0,13,28,0,19,10,5,11,5,41,50,0
895,25206,36GRXkIW2SpIWQz7gvMq2JRXacytqSzV,SpATywNh6bZuzm8s1ceuBUnMUAeoAHHw,18,20,8,13,4,2,10,1,58,8.285714285714286,1,0.0,7,8,13,4,13,2,0,10,1,32,26,0
896,25236,JmXGzVVfQa5TXaQwtZdggsgBkbZbIeH5,bWdj2GDclj5ofokWjzoa5jAwMkxCykd6,19,29,13,56,6,2,10,1,117,16.714285714285715,5,0.0,7,13,53,6,22,2,3,10,1,79,38,0
897,25306,ETzcC9n39CwhBb4MTbqq1Ng4NqGIoiPj,7GRhBDsirIGkRZBtSMEzNTyDr2JQm4xx,4,2,1,0,1,0,1,0,5,0.7142857142857143,1,0.0,0,1,0,1,2,0,0,1,0,2,3,1
898,25356,fi7yn2cMGfx1Smhd75ueCIU0DN0YeZ9i,7GRhBDsirIGkRZBtSMEzNTyDr2JQm4xx,12,14,9,6,5,0,3,0,37,5.285714285714286,1,0.0,2,9,6,5,12,0,0,3,0,22,15,1
899,25416,RyJBTIZudHI18CHfqwWV9lrFHUkffvwx,SpATywNh6bZuzm8s1ceuBUnMUAeoAHHw,16,14,6,10,3,6,3,0,42,6.0,1,0.0,2,6,9,3,12,6,1,3,0,20,22,1
900,25481,nXaqEEEC1RuDpdV8FF2KPpkhT6oc7g9j,bWdj2GDclj5ofokWjzoa5jAwMkxCykd6,13,14,5,84,4,6,3,1,117,16.714285714285715,1,0.0,8,5,83,4,6,6,1,3,1,100,17,1
901,25504,QwlvYaP7UrFUsGUYZvCsolFqg7cM2XS7,7GRhBDsirIGkRZBtSMEzNTyDr2JQm4xx,35,95,45,49,16,8,27,3,243,34.714285714285715,2,0.0,36,45,40,16,59,8,9,27,3,137,106,1
902,25508,ymIU6ycPRruHx8VRvXTFr9yvjJtz8pmG,SpATywNh6bZuzm8s1ceuBUnMUAeoAHHw,8,6,2,6,1,9,1,0,25,3.5714285714285716,1,0.0,2,2,6,1,4,9,0,1,0,11,14,0
903,25510,SXQudUQxotVyHX3jIj58IdonMUWj4z4L,SpATywNh6bZuzm8s1ceuBUnMUAeoAHHw,17,32,13,19,7,21,25,3,120,17.142857142857142,2,0.0,10,13,15,7,22,21,4,25,3,45,75,0
904,25630,F1N61tazho7ZYPRPggPaCszBndAmmJFa,7GRhBDsirIGkRZBtSMEzNTyDr2JQm4xx,1,0,0,0,0,0,1,0,1,0.14285714285714285,1,0.0,0,0,0,0,0,0,0,1,0,0,1,1
905,25633,LeLXLvHK2djzEG514AFcju6wr7gFXkH2,SpATywNh6bZuzm8s1ceuBUnMUAeoAHHw,17,61,24,21,7,76,46,10,245,35.0,5,0.0,18,24,18,7,43,76,3,46,10,67,178,1
906,25637,zrKKa8AP5la65fKoXkp4sUMfYYb2eAtF,G8EPVSXsOYB5YQWZGiz1aVq5Pgr2GrQu,9,16,2,0,1,0,10,0,29,4.142857142857143,3,0.0,0,2,0,1,16,0,0,10,0,3,26,1
907,25652,HrUHfBacH3u3gfsauI41ANlvNzWZshRh,A3fsA9Zfv1X2fVEQhTw51lKENdNrEqT3,40,18,11,72,9,0,2,0,112,16.0,2,0.0,1,11,66,9,17,0,6,2,0,87,25,0
908,25658,HlYiU2TA92it9HWOPDlsBmlpdZ7J7QTJ,bWdj2GDclj5ofokWjzoa5jAwMkxCykd6,8,7,3,0,1,1,7,1,20,2.857142857142857,3,0.0,0,3,0,1,7,1,0,7,1,4,16,1
909,25765,E31WqWw5nCEWlSKgmhsOSj5j4T79ypCl,SpATywNh6bZuzm8s1ceuBUnMUAeoAHHw,17,55,23,28,7,3,15,1,132,18.857142857142858,3,0.0,24,23,22,7,31,3,6,15,1,76,56,0
910,25837,b5Gj1OyeYKLhLlGsleyNSSJpbJ2lneFj,SpATywNh6bZuzm8s1ceuBUnMUAeoAHHw,16,14,5,13,3,0,11,1,47,6.714285714285714,2,0.0,7,5,13,3,7,0,0,11,1,28,19,1
911,25844,o9m1fMq17KjyGUhfLHLXFO5hoKQ5jU6O,SpATywNh6bZuzm8s1ceuBUnMUAeoAHHw,10,23,1,0,0,0,7,0,31,4.428571428571429,3,0.0,5,1,0,0,18,0,0,7,0,6,25,1
912,25864,koGmxwg6FRa19ZshKXnyLXLosS5G7cau,7GRhBDsirIGkRZBtSMEzNTyDr2JQm4xx,29,120,1,75,10,1,20,5,232,33.142857142857146,3,0.0,66,1,65,10,54,1,10,20,5,142,90,1
913,25883,HrUHfBacH3u3gfsauI41ANlvNzWZshRh,SpATywNh6bZuzm8s1ceuBUnMUAeoAHHw,14,24,12,5,4,3,8,1,57,8.142857142857142,3,0.0,6,12,5,4,18,3,0,8,1,27,30,0
914,25888,81OLbBMdpNpbkVstjKtzJy0bjbBi99mi,SpATywNh6bZuzm8s1ceuBUnMUAeoAHHw,2,0,0,0,0,0,2,0,2,0.2857142857142857,1,0.0,0,0,0,0,0,0,0,2,0,0,2,1
915,25901,pIkx6nDAjTla5NYVEsjhMXOIu5zXDzmO,SpATywNh6bZuzm8s1ceuBUnMUAeoAHHw,14,12,6,0,3,3,8,1,33,4.714285714285714,2,0.0,0,6,0,3,12,3,0,8,1,9,24,0
916,25952,TzT0azKrocJxLmhFJi2IdfFfROivFDi7,7GRhBDsirIGkRZBtSMEzNTyDr2JQm4xx,7,7,0,0,0,0,4,1,12,1.7142857142857142,1,0.0,0,0,0,0,7,0,0,4,1,0,12,1
917,25963,3Ew3yAxjSntFFYCyahG9TNwPBtEjhvBu,SpATywNh6bZuzm8s1ceuBUnMUAeoAHHw,1,0,0,0,0,0,1,0,1,0.14285714285714285,1,0.0,0,0,0,0,0,0,0,1,0,0,1,1
918,25994,2jj1hSNZOKn7YixrkMYiulmQRlxNCAKp,SpATywNh6bZuzm8s1ceuBUnMUAeoAHHw,7,5,0,4,0,0,1,0,10,1.4285714285714286,1,0.0,0,0,4,0,5,0,0,1,0,4,6,1
919,26148,JqvGTplcVBLcq3YzEUVslmYGYOBREBZ1,SpATywNh6bZuzm8s1ceuBUnMUAeoAHHw,12,13,5,11,2,0,5,0,36,5.142857142857143,2,0.0,4,5,9,2,9,0,2,5,0,20,16,0
920,26208,USLTnsAwagwK2c83KXd1SNEeENnzkTTo,7GRhBDsirIGkRZBtSMEzNTyDr2JQm4xx,10,6,4,0,3,23,20,0,56,8.0,5,0.0,0,4,0,3,6,23,0,20,0,7,49,0
921,26236,b3xaxczfVryBkeC1YPbXWEZUleYIZAnq,SpATywNh6bZuzm8s1ceuBUnMUAeoAHHw,16,24,8,21,4,15,13,1,86,12.285714285714286,2,0.0,15,8,18,4,9,15,3,13,1,45,41,1
922,26286,d5fIWN5kvqsn40aHFJvoDDo4RHSEcHNo,SpATywNh6bZuzm8s1ceuBUnMUAeoAHHw,7,5,0,3,0,0,1,0,9,1.2857142857142858,1,0.0,0,0,3,0,5,0,0,1,0,3,6,1
923,26297,UjnOd8eB67vR87Hc1uvDJpBawBhqSd4C,SpATywNh6bZuzm8s1ceuBUnMUAeoAHHw,11,35,7,31,1,0,5,0,79,11.285714285714286,4,0.0,21,7,27,1,14,0,4,5,0,56,23,1
924,26310,vuslHI1UxdeXKs1vDUvKXYQqg3X9k91E,7GRhBDsirIGkRZBtSMEzNTyDr2JQm4xx,7,3,2,0,2,0,3,0,10,1.4285714285714286,3,0.0,0,2,0,2,3,0,0,3,0,4,6,1
925,26322,XMtcnsDNasKCOMBWrsjCVH5NONQyEryR,A3fsA9Zfv1X2fVEQhTw51lKENdNrEqT3,45,31,24,70,21,1,10,1,158,22.571428571428573,2,0.0,2,24,60,21,29,1,10,10,1,107,51,0
926,26326,drIV8ws6G2eFjZA06SdUOTyJLvhyaXrd,SpATywNh6bZuzm8s1ceuBUnMUAeoAHHw,10,9,5,6,0,0,3,0,23,3.2857142857142856,2,0.0,2,5,6,0,7,0,0,3,0,13,10,0
927,26407,Do8hbesbT6OBtmo3AMshqQTnDUWGEYzY,bWdj2GDclj5ofokWjzoa5jAwMkxCykd6,15,25,14,38,9,6,5,0,97,13.857142857142858,3,0.0,2,14,35,9,23,6,3,5,0,60,37,0
928,26411,XGWArK05Wzjd8AdGaPxkShZOu2YZKkZ4,SpATywNh6bZuzm8s1ceuBUnMUAeoAHHw,11,18,8,0,3,3,6,0,38,5.428571428571429,2,0.0,0,8,0,3,18,3,0,6,0,11,27,0
929,26435,N0Sos51WanCzoSGKDmMPzQtMlLxY3bFb,bWdj2GDclj5ofokWjzoa5jAwMkxCykd6,13,26,15,0,6,14,41,2,104,14.857142857142858,5,0.0,0,15,0,6,26,14,0,41,2,21,83,0
930,26499,5dvfr5EjWeXuIobwrgh7MVbCslwNXi21,SpATywNh6bZuzm8s1ceuBUnMUAeoAHHw,9,5,2,0,1,0,5,0,13,1.8571428571428572,1,0.0,0,2,0,1,5,0,0,5,0,3,10,0
931,26511,wdK5DIKl9qd73hM1uOx3ufcKj0J9AcRr,SpATywNh6bZuzm8s1ceuBUnMUAeoAHHw,14,36,25,15,16,1,5,0,98,14.0,3,0.0,5,25,13,16,31,1,2,5,0,59,39,1
932,26593,yYrk7RmkclaZIv32ppfmidCUMKYlGdCg,7GRhBDsirIGkRZBtSMEzNTyDr2JQm4xx,34,38,10,61,11,13,10,1,144,20.571428571428573,2,0.0,26,10,53,11,12,13,8,10,1,100,44,1
933,26625,chwuEH1iMc682zjOmO4zFwwfUl1drv8Q,RXDvfPUBYFlVdlueBFbLW0mhhAyGEqpt,44,31,11,59,11,0,6,0,118,16.857142857142858,5,0.0,14,11,58,11,17,0,1,6,0,94,24,0
934,26678,OsS1Y0pb3ORCYhSo3uyNzAmfIGWlMI5F,SpATywNh6bZuzm8s1ceuBUnMUAeoAHHw,9,28,5,0,3,10,11,5,62,8.857142857142858,1,0.0,4,5,0,3,24,10,0,11,5,12,50,1
935,26704,OF8cZCIXPsuM4CdS1yd3vA1SWWYblMbf,SpATywNh6bZuzm8s1ceuBUnMUAeoAHHw,16,17,7,12,3,0,3,0,42,6.0,1,0.0,8,7,12,3,9,0,0,3,0,30,12,0
936,26733,M507IlBQp64NkSWnSkchjsahApLaE1kJ,7GRhBDsirIGkRZBtSMEzNTyDr2JQm4xx,4,2,1,0,1,0,1,0,5,0.7142857142857143,1,0.0,0,1,0,1,2,0,0,1,0,2,3,1
937,26769,QKh6yCjm7KCBJwTgcTdbJMWujg3bWjbd,SpATywNh6bZuzm8s1ceuBUnMUAeoAHHw,16,39,13,16,5,12,13,0,98,14.0,3,0.0,11,13,14,5,28,12,2,13,0,43,55,0
938,26806,v3af5rWc4AOfzZv6mvaIgDKPH5PLVH0T,RXDvfPUBYFlVdlueBFbLW0mhhAyGEqpt,16,27,16,0,3,45,18,2,111,15.857142857142858,1,0.0,0,16,0,3,27,45,0,18,2,19,92,0
939,26878,zNRtwNQkiCM9OW1nTIM2OGHUm9Iu3JVP,RXDvfPUBYFlVdlueBFbLW0mhhAyGEqpt,40,44,3,87,2,4,6,2,148,21.142857142857142,3,0.0,11,3,81,2,33,4,6,6,2,97,51,0
940,26879,nE23LYiQpabdXkj6YvKSja9sZnHRizmo,A3fsA9Zfv1X2fVEQhTw51lKENdNrEqT3,5,10,0,0,0,0,3,0,13,1.8571428571428572,3,0.0,0,0,0,0,10,0,0,3,0,0,13,0
941,26899,SKqtOWa2uBCWLrCYlzFMjf1B70kuA2m8,SpATywNh6bZuzm8s1ceuBUnMUAeoAHHw,17,21,11,14,3,10,9,0,68,9.714285714285714,1,0.0,6,11,12,3,15,10,2,9,0,32,36,0
942,26917,y4PYMDG8u2c0Sgi9Ir3ypCxWz9jGy1hk,7GRhBDsirIGkRZBtSMEzNTyDr2JQm4xx,2,0,0,0,0,0,2,0,2,0.2857142857142857,1,0.0,0,0,0,0,0,0,0,2,0,0,2,1
943,26923,PQxAX7A8tQB7sGIcC9YvDjqPxTwtHPvm,SpATywNh6bZuzm8s1ceuBUnMUAeoAHHw,16,30,3,16,1,2,16,1,69,9.857142857142858,3,0.0,9,3,14,1,21,2,2,16,1,27,42,0
944,26946,DsHgWZRTJ1y1l15smwhB78ZQq3d8dyKP,A3fsA9Zfv1X2fVEQhTw51lKENdNrEqT3,2,0,0,0,0,0,2,0,2,0.2857142857142857,2,0.0,0,0,0,0,0,0,0,2,0,0,2,0
945,27049,NyRX8nPDWLIgLtE9cch3ACh6oFi0cOSx,SpATywNh6bZuzm8s1ceuBUnMUAeoAHHw,4,7,0,0,0,0,1,0,8,1.1428571428571428,1,0.0,0,0,0,0,7,0,0,1,0,0,8,0
946,27064,ZMTcKQbBQl56kBXzK6ZZeR0SWzh1XSjd,A3fsA9Zfv1X2fVEQhTw51lKENdNrEqT3,10,10,7,0,4,1,8,0,30,4.285714285714286,2,0.0,0,7,0,4,10,1,0,8,0,11,19,0
947,27116,Y1uVq657IWCue4abNsh62IVHKtmwsQHQ,G8EPVSXsOYB5YQWZGiz1aVq5Pgr2GrQu,25,26,14,8,8,0,7,0,63,9.0,2,0.0,9,14,4,8,17,0,4,7,0,35,28,0
948,27161,TNArortVQm3F09odJ2W3xdM27lVc5PiX,7GRhBDsirIGkRZBtSMEzNTyDr2JQm4xx,35,40,10,39,13,0,11,0,113,16.142857142857142,4,0.0,15,10,36,13,25,0,3,11,0,74,39,1
949,27164,q0GZFChoVOuhzxYur1QICnKH6imiHQh6,SpATywNh6bZuzm8s1ceuBUnMUAeoAHHw,3,2,0,0,0,0,2,0,4,0.5714285714285714,1,0.0,0,0,0,0,2,0,0,2,0,0,4,0
950,27169,TMLHDEunctUbbn16KffZHzQrVcud2Q9Y,bWdj2GDclj5ofokWjzoa5jAwMkxCykd6,7,6,3,0,2,0,3,0,14,2.0,1,0.0,0,3,0,2,6,0,0,3,0,5,9,0
951,27176,cs1e0x90m3RHg7MlT1h0YOwuL4MzngHW,7GRhBDsirIGkRZBtSMEzNTyDr2JQm4xx,12,16,5,1,0,3,9,1,35,5.0,1,0.0,11,5,1,0,5,3,0,9,1,17,18,1
952,27178,3GyWUBVi0ZEtgDniG78bG37zc4UZrPNu,RXDvfPUBYFlVdlueBFbLW0mhhAyGEqpt,49,71,31,105,11,11,14,1,244,34.857142857142854,3,0.0,15,31,101,11,56,11,4,14,1,158,86,1
953,27186,dI0jOfzj8SJw9E2PkA63bWlxL71OLyUr,bWdj2GDclj5ofokWjzoa5jAwMkxCykd6,2,0,0,0,0,0,3,0,3,0.42857142857142855,1,0.0,0,0,0,0,0,0,0,3,0,0,3,0
954,27187,imtJFGBCtMAkOvvJ09P5N0sgBTGSUYzd,SpATywNh6bZuzm8s1ceuBUnMUAeoAHHw,4,2,1,0,1,0,1,0,5,0.7142857142857143,1,0.0,0,1,0,1,2,0,0,1,0,2,3,0
955,27223,amNosdi6Uiilljdy8esSBA3F29NKPLUW,SpATywNh6bZuzm8s1ceuBUnMUAeoAHHw,15,16,10,14,5,0,10,0,55,7.857142857142857,2,0.0,2,10,14,5,14,0,0,10,0,31,24,1
956,27268,KmrafWa5j0EoSlyTehpuPHeKeDiU4jD1,SpATywNh6bZuzm8s1ceuBUnMUAeoAHHw,14,28,14,16,5,3,3,0,69,9.857142857142858,1,0.0,10,14,15,5,18,3,1,3,0,44,25,1
957,27305,mvWG8WfFoikkAB9Wg1mtbCZJVje4NMeg,bWdj2GDclj5ofokWjzoa5jAwMkxCykd6,14,29,13,18,9,34,12,1,116,16.571428571428573,4,0.0,7,13,17,9,22,34,1,12,1,46,70,0
958,27316,oJmCgDBYDqQXUsH41PFzwJxrFZzGvukQ,7GRhBDsirIGkRZBtSMEzNTyDr2JQm4xx,2,0,0,0,0,2,1,0,3,0.42857142857142855,1,0.0,0,0,0,0,0,2,0,1,0,0,3,1
959,27324,fJRilHVpgCFPzgCMD6Xh8rgK6259Z6TQ,7GRhBDsirIGkRZBtSMEzNTyDr2JQm4xx,10,13,5,10,4,4,3,0,39,5.571428571428571,2,0.0,4,5,8,4,9,4,2,3,0,21,18,1
960,27332,rz8gqb0xki7JyRvmBK5JfOlM8YmBiT6q,SpATywNh6bZuzm8s1ceuBUnMUAeoAHHw,17,34,12,21,4,3,8,1,83,11.857142857142858,5,0.0,17,12,18,4,17,3,3,8,1,51,32,0
961,27336,uHeTIz8GkglZUts3zio1tGR2aBoYwiQE,A3fsA9Zfv1X2fVEQhTw51lKENdNrEqT3,43,16,14,58,13,11,7,1,120,17.142857142857142,1,0.0,1,14,54,13,15,11,4,7,1,82,38,1
962,27364,VxTZo8wWibkIng7J8YPkqWh1rsEKvqTC,7GRhBDsirIGkRZBtSMEzNTyDr2JQm4xx,4,7,5,0,5,0,1,0,18,2.5714285714285716,7,0.0,0,5,0,5,7,0,0,1,0,10,8,0
963,27404,HDD1g3rYbRszzNZAvMB0irAHbU4W6xUO,SpATywNh6bZuzm8s1ceuBUnMUAeoAHHw,16,41,14,23,7,15,17,5,122,17.428571428571427,3,0.0,17,14,19,7,24,15,4,17,5,57,65,1
964,27429,IYFIdswDKEsO4j14D9vS4fhZEQBqA7vK,SpATywNh6bZuzm8s1ceuBUnMUAeoAHHw,8,17,11,0,7,0,6,0,41,5.857142857142857,3,0.0,0,11,0,7,17,0,0,6,0,18,23,0
965,27449,M8C9BDFICk4ida59GU0jjp556zazDEi1,SpATywNh6bZuzm8s1ceuBUnMUAeoAHHw,14,52,14,14,6,1,8,0,95,13.571428571428571,5,0.0,20,14,13,6,32,1,1,8,0,53,42,0
966,27462,CYUGDG4GDnccqiwcMR066vcF013j1TMy,7GRhBDsirIGkRZBtSMEzNTyDr2JQm4xx,1,0,0,0,0,0,1,0,1,0.14285714285714285,1,0.0,0,0,0,0,0,0,0,1,0,0,1,1
967,27535,VQ4FtoMJj29hpPrAQ6LMEGesAofjErC4,G8EPVSXsOYB5YQWZGiz1aVq5Pgr2GrQu,36,91,11,92,9,10,24,0,237,33.857142857142854,6,0.0,5,11,80,9,86,10,12,24,0,105,132,0
968,27536,p7V6MquT5r2C7VmRzYjQEOsKx7s5gJug,SpATywNh6bZuzm8s1ceuBUnMUAeoAHHw,8,12,7,0,7,0,1,0,27,3.857142857142857,1,0.0,0,7,0,7,12,0,0,1,0,14,13,0
969,30658,Sk4DUKJRImF6lijTnkABuH01jDj9zcnP,7GRhBDsirIGkRZBtSMEzNTyDr2JQm4xx,10,10,4,0,1,0,9,1,25,3.5714285714285716,2,0.0,4,4,0,1,6,0,0,9,1,9,16,0
970,30673,hMsNCldAkGadwgGX6yjkMuu7X3GLTjYs,7GRhBDsirIGkRZBtSMEzNTyDr2JQm4xx,4,2,1,0,1,0,1,0,5,0.7142857142857143,1,0.0,0,1,0,1,2,0,0,1,0,2,3,0
971,30676,H98nROYI5ks5CHxEsgYii9bCzrDc1klK,7GRhBDsirIGkRZBtSMEzNTyDr2JQm4xx,6,9,5,0,3,1,2,0,20,2.857142857142857,1,0.0,2,5,0,3,7,1,0,2,0,10,10,0
972,30700,uAXW7zeSaEEtMIdMcVsYpUquscAKUnr7,7GRhBDsirIGkRZBtSMEzNTyDr2JQm4xx,25,74,44,8,13,0,6,0,145,20.714285714285715,1,0.0,14,44,7,13,60,0,1,6,0,78,67,1
973,30718,R2bf9dlDhtEUgfKzXR1GPBa12LhUfZ8W,7GRhBDsirIGkRZBtSMEzNTyDr2JQm4xx,13,17,7,8,6,0,3,0,41,5.857142857142857,1,0.0,9,7,7,6,8,0,1,3,0,29,12,0
974,30778,vocq2qTAQIpXo7NloCyQjKAwRekZv7g6,A3fsA9Zfv1X2fVEQhTw51lKENdNrEqT3,46,42,21,68,11,38,31,3,214,30.571428571428573,2,0.0,1,21,55,11,41,38,13,31,3,88,126,1
975,30804,xVvNMYPAdkOMbR8cyTeqVHpVoO8wZQ2b,SpATywNh6bZuzm8s1ceuBUnMUAeoAHHw,4,2,0,0,0,0,2,0,4,0.5714285714285714,1,0.0,0,0,0,0,2,0,0,2,0,0,4,1
976,30813,9mbf3ur4VQ377zp6wWXm0F44HQK66rP5,SpATywNh6bZuzm8s1ceuBUnMUAeoAHHw,7,9,2,0,2,0,3,0,16,2.2857142857142856,2,0.0,0,2,0,2,9,0,0,3,0,4,12,0
977,30823,jLGWqcJWbPwbqDpaLuVE2buM1VcjzYrZ,A3fsA9Zfv1X2fVEQhTw51lKENdNrEqT3,38,16,12,80,9,0,3,0,120,17.142857142857142,2,0.0,1,12,67,9,15,0,13,3,0,89,31,0
978,30856,4LLdV2zTWS697dAsOgAPJZPFwfNnrjt6,RXDvfPUBYFlVdlueBFbLW0mhhAyGEqpt,4,3,2,0,2,0,1,0,8,1.1428571428571428,1,0.0,0,2,0,2,3,0,0,1,0,4,4,1
979,30875,7xwH0IGxUu9oyiAWk7HpSQpakcHGIuLy,G8EPVSXsOYB5YQWZGiz1aVq5Pgr2GrQu,24,85,18,44,18,90,21,3,279,39.857142857142854,4,0.0,28,18,37,18,57,90,7,21,3,101,178,0
980,30876,oUNptzxKR6Tg3LMdUCW3RAFgD2fbf3ju,SpATywNh6bZuzm8s1ceuBUnMUAeoAHHw,17,29,3,15,2,9,13,1,72,10.285714285714286,3,0.0,7,3,14,2,22,9,1,13,1,26,46,0
981,30884,XVh0ciKNvtUkxzspZoTcqEEmyNc2FeL5,7GRhBDsirIGkRZBtSMEzNTyDr2JQm4xx,3,3,1,0,0,0,1,0,5,0.7142857142857143,1,0.0,0,1,0,0,3,0,0,1,0,1,4,1
982,30915,8HJiZoOTUArj8ouKObToEc9cbZd1p0Hh,SpATywNh6bZuzm8s1ceuBUnMUAeoAHHw,13,25,9,5,3,2,8,0,52,7.428571428571429,4,0.0,11,9,5,3,14,2,0,8,0,28,24,1
983,30926,JODIGhSXEMOFdMb0BMfI1hphmGCcGiv9,7GRhBDsirIGkRZBtSMEzNTyDr2JQm4xx,29,25,10,42,12,1,4,0,94,13.428571428571429,1,0.0,14,10,37,12,11,1,5,4,0,73,21,1
984,30929,9rkUO9AmZpdcwHkQIT6O3wGbPIgRHhIC,7GRhBDsirIGkRZBtSMEzNTyDr2JQm4xx,15,10,3,16,0,1,8,1,39,5.571428571428571,2,0.0,3,3,14,0,7,1,2,8,1,20,19,1
985,30931,QX72AQjqYFwDzN5BrvMTm1brfdxDPl0n,7GRhBDsirIGkRZBtSMEzNTyDr2JQm4xx,24,44,16,20,13,0,3,1,97,13.857142857142858,2,0.0,20,16,19,13,24,0,1,3,1,68,29,1
986,30958,pUAD8nrBU2agaJjO2oyqax3esP7bDAod,SpATywNh6bZuzm8s1ceuBUnMUAeoAHHw,18,31,8,9,4,39,38,11,140,20.0,3,0.0,4,8,9,4,27,39,0,38,11,25,115,0
987,30986,8KSstsh3YYhIzd54fsYY1T96OfiCGWLi,SpATywNh6bZuzm8s1ceuBUnMUAeoAHHw,13,50,12,18,2,9,26,2,119,17.0,4,0.0,28,12,15,2,22,9,3,26,2,57,62,0
988,30996,WNlTer437rP0ycEd1BKVfCjGSSopiPqX,SpATywNh6bZuzm8s1ceuBUnMUAeoAHHw,17,41,20,14,7,61,45,8,196,28.0,3,0.0,8,20,11,7,33,61,3,45,8,46,150,0
989,31002,EfteYUnYYLq9uOBoKEC0F2UwFqIZoKtW,RXDvfPUBYFlVdlueBFbLW0mhhAyGEqpt,45,36,23,92,14,2,7,0,174,24.857142857142858,3,0.0,10,23,87,14,26,2,5,7,0,134,40,0
990,31123,UrqgguXQUa7JPAQb45jcbkHT0yjSwZHu,7GRhBDsirIGkRZBtSMEzNTyDr2JQm4xx,8,2,0,0,0,4,18,0,24,3.4285714285714284,2,0.0,0,0,0,0,2,4,0,18,0,0,24,1
991,31153,rIlg2veK76CYPAY7z09GokFHQqwC8sW7,SpATywNh6bZuzm8s1ceuBUnMUAeoAHHw,13,15,1,15,2,0,3,0,36,5.142857142857143,2,0.0,5,1,13,2,10,0,2,3,0,21,15,0
992,31167,4bLrsVDvLnrTqHqeIpcqQPyvl02eai7n,A3fsA9Zfv1X2fVEQhTw51lKENdNrEqT3,17,9,9,0,9,0,8,0,35,5.0,2,0.0,0,9,0,9,9,0,0,8,0,18,17,1
993,31186,71r0cSGOl797B6z3Ozx79KsmcnthtUKF,RXDvfPUBYFlVdlueBFbLW0mhhAyGEqpt,47,136,33,83,24,54,30,20,380,54.285714285714285,3,0.0,34,33,73,24,102,54,10,30,20,164,216,0
994,31205,JzHC5tjVySaXz4V3Y0e4piHyrkmeSqU5,SpATywNh6bZuzm8s1ceuBUnMUAeoAHHw,18,115,23,16,5,148,81,7,395,56.42857142857143,6,0.0,4,23,15,5,111,148,1,81,7,47,348,0
995,31220,s6iksgptFmyh2vfiarKdJkiKnp6RLi3f,SpATywNh6bZuzm8s1ceuBUnMUAeoAHHw,10,17,12,0,7,19,3,0,58,8.285714285714286,1,0.0,0,12,0,7,17,19,0,3,0,19,39,0
996,31250,oqq9xRnlYeqOhAsbS4FyM4hs04sEJX6q,7GRhBDsirIGkRZBtSMEzNTyDr2JQm4xx,13,20,11,0,0,2,5,1,39,5.571428571428571,2,0.0,4,11,0,0,16,2,0,5,1,15,24,1
997,31254,m8tZWvMesr1zQS0esJJogsiMlXHxe2Cd,SpATywNh6bZuzm8s1ceuBUnMUAeoAHHw,14,27,9,15,4,2,2,0,59,8.428571428571429,1,0.0,11,9,13,4,16,2,2,2,0,37,22,1
998,31273,llEGY9nmTOZhiXi105AGZUS4gAhSawAh,SpATywNh6bZuzm8s1ceuBUnMUAeoAHHw,14,26,10,18,5,1,2,0,62,8.857142857142858,1,0.0,5,10,15,5,21,1,3,2,0,35,27,0
999,31313,vAwmKvW9O3gDJNDrzxbIT5kjf2troQFn,SpATywNh6bZuzm8s1ceuBUnMUAeoAHHw,15,14,6,10,3,3,11,1,48,6.857142857142857,4,0.0,2,6,10,3,12,3,0,11,1,21,27,1
1000,31316,sl67PTvziUv3kTFj6qEnYHRaFoNTaM8y,SpATywNh6bZuzm8s1ceuBUnMUAeoAHHw,14,42,12,14,5,0,5,0,78,11.142857142857142,3,0.0,23,12,13,5,19,0,1,5,0,53,25,0
1001,31356,zIHhHIwIbH6mJbe3ZAvW2ovaPewaq0E0,SpATywNh6bZuzm8s1ceuBUnMUAeoAHHw,17,33,11,13,4,61,13,1,136,19.428571428571427,5,0.0,10,11,12,4,23,61,1,13,1,37,99,0
1002,31360,QVtQEOECDBxqQMPDJLsWNOlhwI5DCP74,SpATywNh6bZuzm8s1ceuBUnMUAeoAHHw,17,19,9,17,4,53,14,1,117,16.714285714285715,3,0.0,6,9,16,4,13,53,1,14,1,35,82,0
1003,31371,YkxwabMuriYpqC21021WUsYLLutSSx4O,SpATywNh6bZuzm8s1ceuBUnMUAeoAHHw,14,14,6,12,3,0,6,0,41,5.857142857142857,2,0.0,6,6,9,3,8,0,3,6,0,24,17,0
1004,31389,QAV02IL7ajntDdHVirqabwTRIN1Sa6iz,SpATywNh6bZuzm8s1ceuBUnMUAeoAHHw,13,83,2,13,0,0,25,0,123,17.571428571428573,6,0.0,14,2,13,0,69,0,0,25,0,29,94,0
1005,31397,CGQBVll6e8XrZqlx2vLhIruhp3CAtM89,SpATywNh6bZuzm8s1ceuBUnMUAeoAHHw,6,9,5,0,3,3,6,0,26,3.7142857142857144,2,0.0,0,5,0,3,9,3,0,6,0,8,18,0
1006,31399,VBP5PzVQEKJYFH0y5ffEek5WfP9EW7uc,SpATywNh6bZuzm8s1ceuBUnMUAeoAHHw,17,17,11,8,3,1,9,1,50,7.142857142857143,3,0.0,2,11,7,3,15,1,1,9,1,23,27,0
1007,31400,S9MHz2GfayML2H9BuRARNQ0WUO9mAJgZ,SpATywNh6bZuzm8s1ceuBUnMUAeoAHHw,15,22,11,18,4,1,10,0,66,9.428571428571429,4,0.0,6,11,15,4,16,1,3,10,0,36,30,0
1008,31415,6pb2LEsVjBBvAGI7h0XcyCiR12k7UvwH,bWdj2GDclj5ofokWjzoa5jAwMkxCykd6,14,14,6,36,5,4,4,1,70,10.0,2,0.0,5,6,34,5,9,4,2,4,1,50,20,1
1009,31445,l7cIWSn2QdqLoOKMFO8yNQGKfk999nJh,SpATywNh6bZuzm8s1ceuBUnMUAeoAHHw,10,8,7,0,6,0,2,0,23,3.2857142857142856,1,0.0,0,7,0,6,8,0,0,2,0,13,10,0
1010,31459,1xFsl22T8LEiEJ3kwPWguQfPNcGWZ8JV,7GRhBDsirIGkRZBtSMEzNTyDr2JQm4xx,12,10,1,0,0,1,10,1,23,3.2857142857142856,4,0.0,1,1,0,0,9,1,0,10,1,2,21,1
1011,31485,TJFpdHl1wQVU7Cnvm5Co4MJsJuGM9yMG,G8EPVSXsOYB5YQWZGiz1aVq5Pgr2GrQu,29,55,26,66,14,17,24,4,206,29.428571428571427,2,0.0,19,26,46,14,36,17,20,24,4,105,101,0
1012,31494,koNIIdoqi1yUhLIZAXp5I3Fl17qrPzNm,7GRhBDsirIGkRZBtSMEzNTyDr2JQm4xx,1,0,0,0,0,0,1,0,1,0.14285714285714285,1,0.0,0,0,0,0,0,0,0,1,0,0,1,1
1013,31500,EQgg3GYPXWNLa9U010kt5ZSvruPXJLGA,SpATywNh6bZuzm8s1ceuBUnMUAeoAHHw,16,25,9,21,3,20,10,3,91,13.0,3,0.0,11,9,18,3,14,20,3,10,3,41,50,0
1014,31573,VWrks7JFbeZpwdWqwwZkJoHpmfIv7cqz,7GRhBDsirIGkRZBtSMEzNTyDr2JQm4xx,25,32,16,39,13,1,2,0,103,14.714285714285714,3,0.0,10,16,37,13,22,1,2,2,0,76,27,0
1015,31642,Vr0kaKAkI4p2upUYNB1MMKsTShBZob66,7GRhBDsirIGkRZBtSMEzNTyDr2JQm4xx,29,50,22,56,10,63,3,0,204,29.142857142857142,5,0.0,22,22,45,10,28,63,11,3,0,99,105,1
1016,31691,TUAvpbJIqPqAXiWUMr89vm0HdACTuiA8,SpATywNh6bZuzm8s1ceuBUnMUAeoAHHw,14,26,0,23,1,2,6,0,58,8.285714285714286,3,0.0,7,0,19,1,19,2,4,6,0,27,31,0
1017,31728,mpNBMReKZvwryUvgjwY0cwVFK7aOune8,SpATywNh6bZuzm8s1ceuBUnMUAeoAHHw,18,21,10,21,5,7,18,2,84,12.0,4,0.0,6,10,17,5,15,7,4,18,2,38,46,0
1018,31739,xM8lVcqU5uqtxPXKRkobTl3b50GvL7Y6,G8EPVSXsOYB5YQWZGiz1aVq5Pgr2GrQu,3,2,0,0,0,0,1,0,3,0.42857142857142855,1,0.0,0,0,0,0,2,0,0,1,0,0,3,1
1019,31804,lHdOeTUXYVL6iAgJVxxf5RxusHAIMUqu,SpATywNh6bZuzm8s1ceuBUnMUAeoAHHw,17,45,14,15,5,18,16,1,114,16.285714285714285,5,0.0,20,14,15,5,25,18,0,16,1,54,60,0
1020,31878,VXwRO03Gu4QrNRkeAj0lYc8T94Ap4aw5,SpATywNh6bZuzm8s1ceuBUnMUAeoAHHw,12,29,1,14,0,7,4,0,55,7.857142857142857,2,0.0,16,1,14,0,13,7,0,4,0,31,24,0
1021,31984,uDOAJpmX4dISx06kO0710v1O7qHbWnTL,7GRhBDsirIGkRZBtSMEzNTyDr2JQm4xx,1,0,0,0,0,0,1,0,1,0.14285714285714285,1,0.0,0,0,0,0,0,0,0,1,0,0,1,1
1022,32014,t8eDuPU4MsZrMH2MoE1n7JeYLVBJZOGD,SpATywNh6bZuzm8s1ceuBUnMUAeoAHHw,17,25,11,17,4,10,12,2,81,11.571428571428571,3,0.0,10,11,16,4,15,10,1,12,2,41,40,0
1023,32052,2H4u8GVrslTygmZOsXRsjmcwUzRVI1ow,SpATywNh6bZuzm8s1ceuBUnMUAeoAHHw,12,23,19,6,8,0,8,0,64,9.142857142857142,3,0.0,0,19,5,8,23,0,1,8,0,32,32,0
1024,32114,MOcMwRKo0dtFqZ5xWBgRzquuZGKtQyf4,7GRhBDsirIGkRZBtSMEzNTyDr2JQm4xx,39,95,27,43,14,1,15,0,195,27.857142857142858,5,0.0,37,27,40,14,58,1,3,15,0,118,77,1
1025,32118,WMPYVFkG1npps8BU0n5fJtN4LOF8N9L7,7GRhBDsirIGkRZBtSMEzNTyDr2JQm4xx,5,7,2,0,0,0,2,0,11,1.5714285714285714,2,0.0,2,2,0,0,5,0,0,2,0,4,7,1
1026,32122,ZvU0YqNTtgKWTlVIbqvnVys23p5WRiDJ,SpATywNh6bZuzm8s1ceuBUnMUAeoAHHw,10,30,16,0,3,45,8,0,102,14.571428571428571,3,0.0,0,16,0,3,30,45,0,8,0,19,83,0
1027,32208,bNZH4hUHavni696ZcBLvxZCrBSALUDxX,SpATywNh6bZuzm8s1ceuBUnMUAeoAHHw,12,18,2,6,2,20,7,0,55,7.857142857142857,6,0.0,1,2,5,2,17,20,1,7,0,10,45,0
1028,32211,EjR7iUwsiJVzqJrC7t3D1JWVRCEYToml,SpATywNh6bZuzm8s1ceuBUnMUAeoAHHw,10,19,0,18,0,5,3,0,45,6.428571428571429,1,0.0,9,0,15,0,10,5,3,3,0,24,21,0
1029,32226,4TtGjmtd4ISORDD5okRgx7kXAcGUW8IN,SpATywNh6bZuzm8s1ceuBUnMUAeoAHHw,17,32,13,11,5,4,33,5,103,14.714285714285714,6,0.0,13,13,9,5,19,4,2,33,5,40,63,0
1030,32241,kIttG9NXpnCAK6Uau8oyBBFc61rFQfTE,7GRhBDsirIGkRZBtSMEzNTyDr2JQm4xx,8,14,4,4,3,2,2,0,29,4.142857142857143,2,0.0,1,4,3,3,13,2,1,2,0,11,18,1
1031,32244,jN0wpnfaU5DsLxvEqII5WFiC356NJUbF,SpATywNh6bZuzm8s1ceuBUnMUAeoAHHw,12,7,2,13,0,1,15,1,39,5.571428571428571,2,0.0,2,2,11,0,5,1,2,15,1,15,24,1
1032,32256,pNgLScEwGgq81vg0a0cEXKNs5eG2UXph,SpATywNh6bZuzm8s1ceuBUnMUAeoAHHw,15,13,7,12,4,0,3,0,39,5.571428571428571,2,0.0,4,7,12,4,9,0,0,3,0,27,12,1
1033,32261,L6TEQcXe2Cfo7rlXEZ1k4dVXCx2fwc1Y,7GRhBDsirIGkRZBtSMEzNTyDr2JQm4xx,8,9,2,0,1,0,2,0,14,2.0,1,0.0,4,2,0,1,5,0,0,2,0,7,7,1
1034,32263,kAQFM0dEgOQIxOG9jTMe5puRtNxZZWMN,bWdj2GDclj5ofokWjzoa5jAwMkxCykd6,15,20,1,108,1,2,5,0,137,19.571428571428573,3,0.0,5,1,105,1,15,2,3,5,0,112,25,0
1035,32280,onsmNYIoPFEi185f5ZLsQXD70I3K25Cb,7GRhBDsirIGkRZBtSMEzNTyDr2JQm4xx,6,4,3,0,2,0,2,0,11,1.5714285714285714,1,0.0,0,3,0,2,4,0,0,2,0,5,6,1
1036,32284,wkkLqkPlDLOrNrbR4UCtQIDxtXcGov1B,SpATywNh6bZuzm8s1ceuBUnMUAeoAHHw,15,13,0,19,0,0,9,1,42,6.0,2,0.0,4,0,16,0,9,0,3,9,1,20,22,1
1037,32288,8rXJHeqrLpho5nIQgbDcpBTvBrVnGged,SpATywNh6bZuzm8s1ceuBUnMUAeoAHHw,14,18,9,19,4,0,4,0,54,7.714285714285714,2,0.0,6,9,16,4,12,0,3,4,0,35,19,0
1038,32309,MZpeXlPtlAGSfwuC5xwB1U0DIOZvGtVZ,SpATywNh6bZuzm8s1ceuBUnMUAeoAHHw,15,26,3,16,4,6,10,1,66,9.428571428571429,4,0.0,8,3,12,4,18,6,4,10,1,27,39,0
1039,32319,PZyZDM2uyBRGPZg3kQscavWjpR2bFYiU,SpATywNh6bZuzm8s1ceuBUnMUAeoAHHw,2,0,0,0,0,0,2,0,2,0.2857142857142857,1,0.0,0,0,0,0,0,0,0,2,0,0,2,0
1040,32346,rrZSZFoEgH3bOKdkZ0UyNzOq7Pdyx5G0,SpATywNh6bZuzm8s1ceuBUnMUAeoAHHw,8,4,3,0,3,0,2,0,12,1.7142857142857142,1,0.0,0,3,0,3,4,0,0,2,0,6,6,0
1041,32358,nOWwmMm8RUDfPfoqvXy3xmkIL6qZiu0a,7GRhBDsirIGkRZBtSMEzNTyDr2JQm4xx,13,18,1,9,0,9,18,1,56,8.0,2,0.0,2,1,7,0,16,9,2,18,1,10,46,0
1042,32359,aLRP3ahB5SIcOn5vpM1VPEh9ib2QIioX,SpATywNh6bZuzm8s1ceuBUnMUAeoAHHw,10,32,1,17,0,0,15,0,65,9.285714285714286,6,0.0,8,1,14,0,24,0,3,15,0,23,42,0
1043,32385,rIb3lxEaK77vmLDTqDgCNFDZAYjyvbtK,7GRhBDsirIGkRZBtSMEzNTyDr2JQm4xx,15,15,6,6,3,0,4,0,34,4.857142857142857,2,0.0,5,6,6,3,10,0,0,4,0,20,14,1
1044,32426,gGSMkNgPdXpBQgdZzyjzifomyCxFSNyt,bWdj2GDclj5ofokWjzoa5jAwMkxCykd6,15,43,25,36,11,12,24,2,153,21.857142857142858,5,0.0,4,25,35,11,39,12,1,24,2,75,78,0
1045,32436,QqE2Xjwy9gUzOvFdkDqAwAaNZLBZkxvd,SpATywNh6bZuzm8s1ceuBUnMUAeoAHHw,13,30,0,15,0,0,11,0,56,8.0,6,0.0,5,0,12,0,25,0,3,11,0,17,39,0
1046,32464,QAguKdvn52pCJKW91rO3BCY8l8ZCAdvQ,A3fsA9Zfv1X2fVEQhTw51lKENdNrEqT3,4,4,1,0,0,0,2,0,7,1.0,2,0.0,0,1,0,0,4,0,0,2,0,1,6,0
1047,32484,QqE2Xjwy9gUzOvFdkDqAwAaNZLBZkxvd,A3fsA9Zfv1X2fVEQhTw51lKENdNrEqT3,17,37,2,0,2,0,13,0,54,7.714285714285714,5,0.0,0,2,0,2,37,0,0,13,0,4,50,0
1048,32501,mOJqDc22cg6Tc62XCr7iPStv8YxEXhpp,SpATywNh6bZuzm8s1ceuBUnMUAeoAHHw,18,64,27,19,10,71,30,4,225,32.142857142857146,4,0.0,18,27,16,10,46,71,3,30,4,71,154,0
1049,32512,wtJKiskMN99Zm4elrGO0NchnwPdR8XuA,7GRhBDsirIGkRZBtSMEzNTyDr2JQm4xx,1,0,0,0,0,0,1,0,1,0.14285714285714285,1,0.0,0,0,0,0,0,0,0,1,0,0,1,1
1050,32577,fNAZ3rWuqq8OkAKKKUzZOQQ9DpAle4lu,SpATywNh6bZuzm8s1ceuBUnMUAeoAHHw,18,66,20,22,5,3,31,2,149,21.285714285714285,5,0.0,30,20,19,5,36,3,3,31,2,74,75,0
1051,32616,MVcepYvxjrdyzudBtT6xf978LVM5p04U,SpATywNh6bZuzm8s1ceuBUnMUAeoAHHw,16,22,9,20,6,13,8,3,81,11.571428571428571,1,0.0,11,9,16,6,11,13,4,8,3,42,39,0
1052,32685,MaXB6YBpSNUvXtEuCcY3Jwa8jwvsWVE8,G8EPVSXsOYB5YQWZGiz1aVq5Pgr2GrQu,4,3,1,0,1,0,1,0,6,0.8571428571428571,1,0.0,0,1,0,1,3,0,0,1,0,2,4,0
1053,32805,mPCmohVETKOBEAkMNdnfTJW7kVWg1ArQ,7GRhBDsirIGkRZBtSMEzNTyDr2JQm4xx,1,0,0,0,0,0,1,0,1,0.14285714285714285,1,0.0,0,0,0,0,0,0,0,1,0,0,1,1
1054,32844,b1eRrhapWSjtM2Ih9Xn0eBEZAyjqmlvI,SpATywNh6bZuzm8s1ceuBUnMUAeoAHHw,17,106,44,31,6,84,46,10,327,46.714285714285715,6,0.0,37,44,23,6,69,84,8,46,10,110,217,0
1055,32891,yInJev2CVKf0hE352QQBnfHh6HRrGN4N,SpATywNh6bZuzm8s1ceuBUnMUAeoAHHw,6,7,3,0,2,0,2,0,14,2.0,2,0.0,0,3,0,2,7,0,0,2,0,5,9,1
1056,32901,4JyZWYWxxqGCPr9dTz7bgpLcCXWs003A,SpATywNh6bZuzm8s1ceuBUnMUAeoAHHw,18,33,14,27,6,3,21,3,107,15.285714285714286,2,0.0,15,14,26,6,18,3,1,21,3,61,46,0
1057,32931,8d3h1mcAmphWja0z3YCYQ3jOAHgKDV8O,7GRhBDsirIGkRZBtSMEzNTyDr2JQm4xx,6,4,1,6,1,0,1,0,13,1.8571428571428572,1,0.0,1,1,5,1,3,0,1,1,0,8,5,1
1058,32938,zZwP4suQybM1gcslFDQ5UITiG9iZ789v,SpATywNh6bZuzm8s1ceuBUnMUAeoAHHw,17,56,34,14,9,5,16,4,138,19.714285714285715,5,0.0,8,34,10,9,48,5,4,16,4,61,77,0
1059,32988,mZVWUPFbkuZINQtykHT2ZyZY5zMXgvJ7,SpATywNh6bZuzm8s1ceuBUnMUAeoAHHw,7,2,1,0,1,0,6,2,12,1.7142857142857142,1,0.0,0,1,0,1,2,0,0,6,2,2,10,0
1060,33001,ZFpXjzvya7Y5x9HmUsgToer6v1L16WM2,SpATywNh6bZuzm8s1ceuBUnMUAeoAHHw,10,9,4,10,1,2,7,0,33,4.714285714285714,1,0.0,2,4,10,1,7,2,0,7,0,17,16,0
1061,33017,GFBEJrga7DM4UEcrt340p3oRNaL97Gn4,SpATywNh6bZuzm8s1ceuBUnMUAeoAHHw,17,27,14,19,6,109,39,8,222,31.714285714285715,4,0.0,4,14,16,6,23,109,3,39,8,40,182,0
1062,33023,XzkMRCsMMuNT5Al9kV5PMqeThOnNDLN6,7GRhBDsirIGkRZBtSMEzNTyDr2JQm4xx,3,2,1,0,0,2,1,0,6,0.8571428571428571,1,0.0,0,1,0,0,2,2,0,1,0,1,5,1
1063,33050,rALCIi3DuIdQyJaY6En5rKpCFJjvIHQe,SpATywNh6bZuzm8s1ceuBUnMUAeoAHHw,6,7,3,0,1,0,7,0,18,2.5714285714285716,2,0.0,0,3,0,1,7,0,0,7,0,4,14,1
1064,33058,fNAZ3rWuqq8OkAKKKUzZOQQ9DpAle4lu,RXDvfPUBYFlVdlueBFbLW0mhhAyGEqpt,11,17,12,0,3,0,12,0,44,6.285714285714286,3,0.0,0,12,0,3,17,0,0,12,0,15,29,0
1065,33062,ZVmjT1rppq7ilCPRRtmAl1wo0gOugsCt,RXDvfPUBYFlVdlueBFbLW0mhhAyGEqpt,14,11,6,26,3,14,5,0,65,9.285714285714286,2,0.0,3,6,21,3,8,14,5,5,0,33,32,0
1066,33088,kpIACQKuTNWV6fjF4g1htB9bVtHJR1X6,A3fsA9Zfv1X2fVEQhTw51lKENdNrEqT3,2,0,0,0,0,0,2,0,2,0.2857142857142857,1,0.0,0,0,0,0,0,0,0,2,0,0,2,0
1067,33113,PjZvizXDkcC0c394BYUQIpEWacrPH7EJ,SpATywNh6bZuzm8s1ceuBUnMUAeoAHHw,13,18,0,20,0,6,7,0,51,7.285714285714286,2,0.0,9,0,18,0,9,6,2,7,0,27,24,1
1068,33121,pKcgftm88lERht9rjtO6yDT8uF9jnp1z,7GRhBDsirIGkRZBtSMEzNTyDr2JQm4xx,35,105,50,79,27,6,14,2,283,40.42857142857143,5,0.0,44,50,73,27,61,6,6,14,2,194,89,1
1069,33146,aFVLxK4Hau9wDglF79kWvvimpoa2MXNc,SpATywNh6bZuzm8s1ceuBUnMUAeoAHHw,16,17,6,18,3,51,6,1,102,14.571428571428571,1,0.0,6,6,15,3,11,51,3,6,1,30,72,1
1070,33173,poxISkj7mtTTcUTxHuC9BFrrsaF9KDef,7GRhBDsirIGkRZBtSMEzNTyDr2JQm4xx,30,69,23,54,20,5,5,0,176,25.142857142857142,3,0.0,42,23,48,20,27,5,6,5,0,133,43,1
1071,33187,yiWok4eQ5hgdJ8eYi2O0qHhy67Y9EA3E,SpATywNh6bZuzm8s1ceuBUnMUAeoAHHw,2,0,0,0,0,0,2,0,2,0.2857142857142857,1,0.0,0,0,0,0,0,0,0,2,0,0,2,0
1072,33199,r9mrNmOIUUDf7AorDYXKUl4G7R8wfHcf,SpATywNh6bZuzm8s1ceuBUnMUAeoAHHw,17,21,12,21,5,1,8,3,71,10.142857142857142,1,0.0,5,12,18,5,16,1,3,8,3,40,31,0
1073,33234,we9tWnySpl1G7k7FqyXPj8wmC2gUYK0W,A3fsA9Zfv1X2fVEQhTw51lKENdNrEqT3,7,4,0,0,0,1,7,0,12,1.7142857142857142,2,0.0,0,0,0,0,4,1,0,7,0,0,12,0
1074,33280,1vY5OZ1u5dkB4jIpVDeMNw33uHVvYDm0,G8EPVSXsOYB5YQWZGiz1aVq5Pgr2GrQu,44,176,57,98,55,49,28,11,474,67.71428571428571,5,0.0,51,57,69,55,125,49,29,28,11,232,242,0
1075,33321,vIBcYbs1BLdmaaP30fcE2FS7kB7v7QRn,RXDvfPUBYFlVdlueBFbLW0mhhAyGEqpt,8,10,6,0,1,0,7,0,24,3.4285714285714284,2,0.0,0,6,0,1,10,0,0,7,0,7,17,1
1076,33338,d5hgUNbUFsJ3QWa3NXhPxhtqZKrkuHi4,SpATywNh6bZuzm8s1ceuBUnMUAeoAHHw,15,14,6,8,3,0,5,0,36,5.142857142857143,3,0.0,6,6,8,3,8,0,0,5,0,23,13,0
1077,33366,fYLWMGJsW3Aq1nrs0wiSji5Q7ysltFRD,SpATywNh6bZuzm8s1ceuBUnMUAeoAHHw,10,8,4,0,2,0,7,0,21,3.0,2,0.0,0,4,0,2,8,0,0,7,0,6,15,1
1078,33375,BkBVFyB4tBI41wvM1Ppa7iaH93pA565M,7GRhBDsirIGkRZBtSMEzNTyDr2JQm4xx,3,0,0,0,0,12,2,0,14,2.0,1,0.0,0,0,0,0,0,12,0,2,0,0,14,1
1079,33416,viuKt4GgrX0rYL5EpHoxJbsiC9TblSuk,SpATywNh6bZuzm8s1ceuBUnMUAeoAHHw,14,110,46,0,13,100,35,0,304,43.42857142857143,5,0.0,14,46,0,13,96,100,0,35,0,73,231,0
1080,33428,YlMrjX7ibus8JFFbvjYaUFTOz92jaztw,SpATywNh6bZuzm8s1ceuBUnMUAeoAHHw,10,15,10,0,5,22,2,0,54,7.714285714285714,2,0.0,1,10,0,5,14,22,0,2,0,16,38,0
1081,33475,0KNVWAChIRBDwntcO5Dr5l3KgkUsRh3O,SpATywNh6bZuzm8s1ceuBUnMUAeoAHHw,10,12,2,2,1,3,2,0,22,3.142857142857143,1,0.0,3,2,2,1,9,3,0,2,0,8,14,0
1082,33493,1vY5OZ1u5dkB4jIpVDeMNw33uHVvYDm0,SpATywNh6bZuzm8s1ceuBUnMUAeoAHHw,17,64,21,9,3,3,13,0,113,16.142857142857142,3,0.0,25,21,9,3,39,3,0,13,0,58,55,0
1083,33513,H2Rgqo3kRDsNdbNVEDl0788s9SSdLM8P,7GRhBDsirIGkRZBtSMEzNTyDr2JQm4xx,25,52,1,22,8,1,7,1,92,13.142857142857142,3,0.0,33,1,22,8,19,1,0,7,1,64,28,1
1084,33520,qmYTrueiQKfoQnGxjqfwlMlw7HOR9CKj,A3fsA9Zfv1X2fVEQhTw51lKENdNrEqT3,4,2,0,0,0,0,3,0,5,0.7142857142857143,1,0.0,0,0,0,0,2,0,0,3,0,0,5,0
1085,33577,YZSZ4TOtqHUreAioK1x0YBDmIRumwoti,7GRhBDsirIGkRZBtSMEzNTyDr2JQm4xx,6,4,1,4,1,0,1,0,11,1.5714285714285714,1,0.0,1,1,3,1,3,0,1,1,0,6,5,1
1086,33601,B9KqNNxXBxHFUsJnQKQysblL3f8zF7sg,7GRhBDsirIGkRZBtSMEzNTyDr2JQm4xx,12,31,4,0,3,0,5,0,43,6.142857142857143,4,0.0,8,4,0,3,23,0,0,5,0,15,28,0
1087,33639,3bwizzI2zhkZarj0AirZFGuMorcba8W4,SpATywNh6bZuzm8s1ceuBUnMUAeoAHHw,17,38,16,19,6,21,23,4,127,18.142857142857142,3,0.0,8,16,16,6,30,21,3,23,4,46,81,1
1088,33643,InrAmtl2MgoSpFoohTtv1oXbh4bisxXW,bWdj2GDclj5ofokWjzoa5jAwMkxCykd6,13,18,9,12,3,2,17,2,63,9.0,4,0.0,1,9,10,3,17,2,2,17,2,23,40,0
1089,33666,RCdcltNaQLfcoxT7YKTjQxAYUbCmzzKd,A3fsA9Zfv1X2fVEQhTw51lKENdNrEqT3,5,4,3,0,1,0,1,0,9,1.2857142857142858,1,0.0,0,3,0,1,4,0,0,1,0,4,5,0
1090,34602,bS2IOWKbnbandmSXQXzI1vhjNhpDoKfN,7GRhBDsirIGkRZBtSMEzNTyDr2JQm4xx,4,1,0,0,0,0,4,0,5,0.7142857142857143,1,0.0,0,0,0,0,1,0,0,4,0,0,5,1
1091,34883,C4q4gNQYEpjKh7pq1qjN8i3L7uSpUX9d,7GRhBDsirIGkRZBtSMEzNTyDr2JQm4xx,10,16,0,12,1,0,1,0,30,4.285714285714286,1,0.0,6,0,10,1,10,0,2,1,0,17,13,0
1092,34897,I7MInQU0IyHrO5RwKExwH0rTfGFmb00M,7GRhBDsirIGkRZBtSMEzNTyDr2JQm4xx,7,11,4,6,6,0,2,0,29,4.142857142857143,2,0.0,6,4,5,6,5,0,1,2,0,21,8,1
1093,35143,7eHsOwDNMYF4417CWrgdB8gK0Wr4kfqA,7GRhBDsirIGkRZBtSMEzNTyDr2JQm4xx,28,53,27,38,9,2,17,1,147,21.0,2,0.0,17,27,31,9,36,2,7,17,1,84,63,0
1094,35608,nH0kSZNGQd9lZaOsssfRVpCIHD2KW4j6,7GRhBDsirIGkRZBtSMEzNTyDr2JQm4xx,28,30,13,55,14,3,1,0,116,16.571428571428573,1,0.0,15,13,51,14,15,3,4,1,0,93,23,1
1095,35634,U3LNfYcdRIeU9qhiaPG7Yg8NuZRGOnSS,7GRhBDsirIGkRZBtSMEzNTyDr2JQm4xx,1,0,0,0,0,0,1,0,1,0.14285714285714285,1,0.0,0,0,0,0,0,0,0,1,0,0,1,1
1096,35696,Vtwq7W3DodckYgwQIiThiTk1zWdBpMl0,7GRhBDsirIGkRZBtSMEzNTyDr2JQm4xx,1,0,0,0,0,0,1,0,1,0.14285714285714285,1,0.0,0,0,0,0,0,0,0,1,0,0,1,1
1097,37552,gL9BFkziNrTyhzKvF4GTh7vW4ctCxqfr,SpATywNh6bZuzm8s1ceuBUnMUAeoAHHw,12,12,4,12,3,0,2,0,33,4.714285714285714,2,0.0,2,4,10,3,10,0,2,2,0,19,14,0
1098,37553,AVMp8F9T45cyhHDRnad5d9bxFkDP4PTv,A3fsA9Zfv1X2fVEQhTw51lKENdNrEqT3,35,17,2,68,1,1,9,1,99,14.142857142857142,2,0.0,2,2,60,1,15,1,8,9,1,65,34,1
1099,37581,mwc0YjZS72xD4dO6Zk7KmFewdh7PWkAS,SpATywNh6bZuzm8s1ceuBUnMUAeoAHHw,7,8,3,0,2,0,3,0,16,2.2857142857142856,4,0.0,0,3,0,2,8,0,0,3,0,5,11,0
1100,37584,06eFfwi64z4CVxg9kYU89F0UCK6M3gh2,G8EPVSXsOYB5YQWZGiz1aVq5Pgr2GrQu,12,10,1,0,3,0,3,0,17,2.4285714285714284,1,0.0,3,1,0,3,7,0,0,3,0,7,10,1
1101,37586,rVtxqWpWg55yh0PkkVeeVKt0oQv342j9,G8EPVSXsOYB5YQWZGiz1aVq5Pgr2GrQu,8,7,6,0,6,0,4,0,23,3.2857142857142856,2,0.0,0,6,0,6,7,0,0,4,0,12,11,0
1102,37587,9RND50Xx7veKeepJEVVvFKwUGiemuZp5,G8EPVSXsOYB5YQWZGiz1aVq5Pgr2GrQu,9,8,3,0,2,0,3,0,16,2.2857142857142856,2,0.0,0,3,0,2,8,0,0,3,0,5,11,1
1103,37588,XY4zkM1XF8dydjqcvDmQyLNW1UDj6PeN,A3fsA9Zfv1X2fVEQhTw51lKENdNrEqT3,37,31,13,60,7,0,6,0,117,16.714285714285715,2,0.0,3,13,51,7,28,0,9,6,0,74,43,1
1104,37610,v7t0p3xAszbLv0yg1dCcAEjixfvU7JCE,SpATywNh6bZuzm8s1ceuBUnMUAeoAHHw,18,41,17,18,6,14,37,3,136,19.428571428571427,3,0.0,14,17,14,6,27,14,4,37,3,51,85,0
1105,37611,unrsquMc9aFN95z680VOYlXL0dwyjnVg,bWdj2GDclj5ofokWjzoa5jAwMkxCykd6,12,30,10,36,3,1,9,1,90,12.857142857142858,5,0.0,6,10,34,3,24,1,2,9,1,53,37,1
1106,37625,6lLAZ0WiQMBHvxtAmgARKrfLfmbRRaSM,A3fsA9Zfv1X2fVEQhTw51lKENdNrEqT3,1,0,0,0,0,0,1,0,1,0.14285714285714285,1,0.0,0,0,0,0,0,0,0,1,0,0,1,1
1107,37629,KxrIXB4R6FFhAWrOx18fBUJq6eOomhrO,bWdj2GDclj5ofokWjzoa5jAwMkxCykd6,5,2,1,0,1,0,4,0,8,1.1428571428571428,2,0.0,0,1,0,1,2,0,0,4,0,2,6,1
1108,37636,08uQSEeVi17JB9WOQMIOM89vv6wgWS2O,SpATywNh6bZuzm8s1ceuBUnMUAeoAHHw,15,14,2,17,1,2,12,2,50,7.142857142857143,2,0.0,5,2,15,1,9,2,2,12,2,23,27,1
1109,37644,9irvFFpWGWd3HRZTxsfDJTqmA07T10ig,SpATywNh6bZuzm8s1ceuBUnMUAeoAHHw,7,2,1,0,1,3,4,1,12,1.7142857142857142,1,0.0,0,1,0,1,2,3,0,4,1,2,10,1
1110,37666,zeUi2UnQZPPF6bRQXw2s8LZ41ZOdqRAa,SpATywNh6bZuzm8s1ceuBUnMUAeoAHHw,16,19,10,6,4,5,9,1,54,7.714285714285714,3,0.0,3,10,6,4,16,5,0,9,1,23,31,0
1111,37683,fmWFGOtr4qK1lNBCrTOCxVLVNU6IZ5bU,bWdj2GDclj5ofokWjzoa5jAwMkxCykd6,1,0,0,0,0,0,1,0,1,0.14285714285714285,1,0.0,0,0,0,0,0,0,0,1,0,0,1,1
1112,37688,GcLKL1EMGPSsuLaGpCB2Rrlv3EuS2ngA,SpATywNh6bZuzm8s1ceuBUnMUAeoAHHw,6,2,1,0,1,0,3,0,7,1.0,1,0.0,0,1,0,1,2,0,0,3,0,2,5,1
1113,37690,1Ti3XKNP5gzLh1si7Apz4GKt53UijsKr,SpATywNh6bZuzm8s1ceuBUnMUAeoAHHw,16,20,8,15,3,0,9,0,55,7.857142857142857,2,0.0,9,8,15,3,11,0,0,9,0,35,20,0
1114,37691,FisqRa6EMb5EsK7GdBjEQwdg4YXD4Xed,bWdj2GDclj5ofokWjzoa5jAwMkxCykd6,17,51,29,78,7,22,13,0,200,28.571428571428573,4,0.0,8,29,70,7,43,22,8,13,0,114,86,1
1115,37706,5D134KQAUnU8gDw5hYnvC82YSO8giiEU,SpATywNh6bZuzm8s1ceuBUnMUAeoAHHw,17,21,5,9,3,1,7,1,47,6.714285714285714,2,0.0,11,5,8,3,10,1,1,7,1,27,20,0
1116,37708,YQZ85qW2KiDmX9GD2Tq3oRYH6ucmQmKe,RXDvfPUBYFlVdlueBFbLW0mhhAyGEqpt,15,19,11,8,6,0,4,0,48,6.857142857142857,2,0.0,1,11,7,6,18,0,1,4,0,25,23,1
1117,37710,t89Lbc9NyQ1awHKwpUunu51m4E6DMYhk,SpATywNh6bZuzm8s1ceuBUnMUAeoAHHw,13,18,6,13,1,7,7,1,53,7.571428571428571,2,0.0,7,6,11,1,11,7,2,7,1,25,28,0
1118,37713,7fOZzyBcCx06Vw2a40A0eroSD5VkDcNa,SpATywNh6bZuzm8s1ceuBUnMUAeoAHHw,17,22,11,15,5,10,11,1,75,10.714285714285714,3,0.0,9,11,11,5,13,10,4,11,1,36,39,0
1119,37722,NuWa1wNN62sioyREqwjInndithPqIOD8,A3fsA9Zfv1X2fVEQhTw51lKENdNrEqT3,5,3,2,0,1,0,3,0,9,1.2857142857142858,1,0.0,0,2,0,1,3,0,0,3,0,3,6,1
1120,37737,m7GeMdFl22gaxUtAD72z73B5tIK1shlq,SpATywNh6bZuzm8s1ceuBUnMUAeoAHHw,13,7,5,0,4,0,7,2,25,3.5714285714285716,3,0.0,0,5,0,4,7,0,0,7,2,9,16,1
1121,37761,bzoYFRQVu6SapCnsZ0DOXeU3JXiLIJu3,SpATywNh6bZuzm8s1ceuBUnMUAeoAHHw,16,15,5,13,3,13,7,3,59,8.428571428571429,2,0.0,8,5,13,3,7,13,0,7,3,29,30,0
1122,37764,b9kodEhA94IDSBT3ykY4QWiqr6rjyws0,SpATywNh6bZuzm8s1ceuBUnMUAeoAHHw,2,0,0,0,0,0,2,0,2,0.2857142857142857,1,0.0,0,0,0,0,0,0,0,2,0,0,2,1
1123,37769,gsdvPbnmqv3G3TICTRxTHCvyG0vd5lw3,G8EPVSXsOYB5YQWZGiz1aVq5Pgr2GrQu,32,42,22,56,8,1,14,1,144,20.571428571428573,1,0.0,16,22,37,8,26,1,19,14,1,83,61,1
1124,37782,MT2eJtF59AVNdUs7mwFqputROb2HgEm3,SpATywNh6bZuzm8s1ceuBUnMUAeoAHHw,13,9,5,13,3,3,1,0,34,4.857142857142857,1,0.0,3,5,13,3,6,3,0,1,0,24,10,0
1125,37784,BarsBzOr7FgzlrusMqrDFOsYw63YD64d,A3fsA9Zfv1X2fVEQhTw51lKENdNrEqT3,6,3,0,0,0,5,6,2,16,2.2857142857142856,1,0.0,0,0,0,0,3,5,0,6,2,0,16,1
1126,37788,y1rNC08s1iP76iivJMPjmiTg1SiPQTDp,SpATywNh6bZuzm8s1ceuBUnMUAeoAHHw,8,10,0,4,0,2,2,0,18,2.5714285714285716,1,0.0,0,0,4,0,10,2,0,2,0,4,14,1
1127,37831,fmoIo5oPDyRcnHhnGH8MKyUTeXZvimIR,SpATywNh6bZuzm8s1ceuBUnMUAeoAHHw,17,42,21,13,6,58,34,1,175,25.0,5,0.0,3,21,11,6,39,58,2,34,1,41,134,0
1128,37834,nEvQSo5dnPEv9AKi5Mbvgqg4cF9OoMSW,SpATywNh6bZuzm8s1ceuBUnMUAeoAHHw,16,13,7,7,3,4,10,1,45,6.428571428571429,1,0.0,3,7,6,3,10,4,1,10,1,19,26,1
1129,37873,dpBOLaUWFOAehWXZrpwiocVfiOMhN5GL,SpATywNh6bZuzm8s1ceuBUnMUAeoAHHw,16,30,7,24,7,5,8,0,81,11.571428571428571,1,0.0,17,7,19,7,13,5,5,8,0,50,31,0
1130,37883,9Uee7oEuuMmgPx2IzPfFkWgkHZyPbWr0,SpATywNh6bZuzm8s1ceuBUnMUAeoAHHw,14,22,13,9,7,0,2,0,53,7.571428571428571,4,0.0,7,13,9,7,15,0,0,2,0,36,17,0
1131,37887,5vUuq5ZeDCNce4LmvH0naoUjpb3qbNOp,bWdj2GDclj5ofokWjzoa5jAwMkxCykd6,8,15,6,18,3,0,5,0,47,6.714285714285714,3,0.0,3,6,16,3,12,0,2,5,0,28,19,1
1132,37893,UOoqOWQxtJ6HvrytZgfqguIfOgaBqbBw,SpATywNh6bZuzm8s1ceuBUnMUAeoAHHw,7,5,1,0,1,0,2,0,9,1.2857142857142858,1,0.0,0,1,0,1,5,0,0,2,0,2,7,1
1133,37894,qPQsrCDbNr80CImeaDwXdvYkweQdyVus,RXDvfPUBYFlVdlueBFbLW0mhhAyGEqpt,13,5,5,0,2,1,5,1,19,2.7142857142857144,1,0.0,0,5,0,2,5,1,0,5,1,7,12,0
1134,37904,313ZU7SnTnilkzRb4b84vNDTmwgTEy5n,G8EPVSXsOYB5YQWZGiz1aVq5Pgr2GrQu,1,0,0,0,0,0,2,0,2,0.2857142857142857,1,0.0,0,0,0,0,0,0,0,2,0,0,2,1
1135,37905,lV4ifbsehEXWBwQOY9bU762jcRSMFY5M,SpATywNh6bZuzm8s1ceuBUnMUAeoAHHw,16,22,10,10,3,0,7,0,52,7.428571428571429,2,0.0,4,10,10,3,18,0,0,7,0,27,25,0
1136,37908,JWUvlcN404PLe0TeFXcH9piP650rZWof,SpATywNh6bZuzm8s1ceuBUnMUAeoAHHw,9,36,9,0,2,1,16,0,64,9.142857142857142,4,0.0,0,9,0,2,36,1,0,16,0,11,53,1
1137,37913,iBI4oBYQahSrgJM5NHLRivWj4vPgILKH,G8EPVSXsOYB5YQWZGiz1aVq5Pgr2GrQu,9,10,4,0,4,0,2,0,20,2.857142857142857,2,0.0,5,4,0,4,5,0,0,2,0,13,7,1
1138,37926,mUOanMUrsiycv8pF8RX4xyc7qtUXAMUs,bWdj2GDclj5ofokWjzoa5jAwMkxCykd6,15,25,11,52,11,0,3,0,102,14.571428571428571,3,0.0,10,11,47,11,15,0,5,3,0,79,23,1
1139,37929,Trm6c0xRzFyegURuKBBdNUenucp5uZb9,G8EPVSXsOYB5YQWZGiz1aVq5Pgr2GrQu,8,21,8,0,3,1,8,0,41,5.857142857142857,1,0.0,7,8,0,3,14,1,0,8,0,18,23,1
1140,37932,UYyUkvxHd4tIc6aiQcuHfsTYHPlQXaAb,G8EPVSXsOYB5YQWZGiz1aVq5Pgr2GrQu,25,18,15,14,14,0,5,5,71,10.142857142857142,1,0.0,2,15,11,14,16,0,3,5,5,42,29,1
1141,37949,QRq9SneqdOEdNrPCbzGfNOJsUrpMzzSX,A3fsA9Zfv1X2fVEQhTw51lKENdNrEqT3,6,2,1,0,0,1,6,1,11,1.5714285714285714,1,0.0,0,1,0,0,2,1,0,6,1,1,10,1
1142,37958,O3fc8NICaVWUo8M4PzoZRSLRDAOYKQm9,G8EPVSXsOYB5YQWZGiz1aVq5Pgr2GrQu,6,12,0,6,0,0,2,0,20,2.857142857142857,2,0.0,3,0,4,0,9,0,2,2,0,7,13,1
1143,37961,lI4gYBH1elniUs6lU536XKdTVOMiS4n1,SpATywNh6bZuzm8s1ceuBUnMUAeoAHHw,16,37,11,11,3,0,21,2,85,12.142857142857142,3,0.0,7,11,11,3,30,0,0,21,2,32,53,1
1144,37963,zyXPxdyvET7shVCE1kkdKwMY47AukbuA,G8EPVSXsOYB5YQWZGiz1aVq5Pgr2GrQu,13,11,2,0,2,12,10,1,38,5.428571428571429,2,0.0,2,2,0,2,9,12,0,10,1,6,32,0
1145,37968,o4fNZaSYX3UHutrkuKOAdzPPx4q40e5R,G8EPVSXsOYB5YQWZGiz1aVq5Pgr2GrQu,4,5,0,0,0,0,2,0,7,1.0,2,0.0,0,0,0,0,5,0,0,2,0,0,7,1
1146,37972,k0lvFNaTVHTtB1XHBZ8229ej4v1r4rPk,A3fsA9Zfv1X2fVEQhTw51lKENdNrEqT3,13,11,5,0,2,3,11,1,33,4.714285714285714,2,0.0,0,5,0,2,11,3,0,11,1,7,26,0
1147,37977,0w9tP8TINgzfbBeYFJprB82ry0PjYiWn,A3fsA9Zfv1X2fVEQhTw51lKENdNrEqT3,8,9,1,0,1,0,2,0,13,1.8571428571428572,1,0.0,0,1,0,1,9,0,0,2,0,2,11,1
1148,37992,lFmplH6KaQigIQOByvMn1p8i4p6OLLhs,SpATywNh6bZuzm8s1ceuBUnMUAeoAHHw,14,13,5,16,3,0,4,0,41,5.857142857142857,1,0.0,6,5,13,3,7,0,3,4,0,27,14,1
1149,37993,pYcnIzYPgb3xzrOvmR9y0UUIZo4gqKuO,SpATywNh6bZuzm8s1ceuBUnMUAeoAHHw,18,46,26,12,13,7,15,1,120,17.142857142857142,3,0.0,12,26,10,13,34,7,2,15,1,61,59,0
1150,37997,Y65j88wkyz5DKML6XOG6DUVrzLQhWfST,A3fsA9Zfv1X2fVEQhTw51lKENdNrEqT3,1,0,0,0,0,0,1,0,1,0.14285714285714285,1,0.0,0,0,0,0,0,0,0,1,0,0,1,1
1151,38005,u82lBhpDxJIwlZISEntCxj1zgVFdW0vT,RXDvfPUBYFlVdlueBFbLW0mhhAyGEqpt,1,0,0,0,0,0,1,0,1,0.14285714285714285,1,0.0,0,0,0,0,0,0,0,1,0,0,1,1
1152,38028,vxPhImq7e3kAhm2TgSi6LMfFEt4O2oEs,G8EPVSXsOYB5YQWZGiz1aVq5Pgr2GrQu,1,0,0,0,0,0,1,0,1,0.14285714285714285,1,0.0,0,0,0,0,0,0,0,1,0,0,1,1
1153,38049,7n0QZ7z1Xa9itNmJQbQwoSvEI6n7oD9f,G8EPVSXsOYB5YQWZGiz1aVq5Pgr2GrQu,27,17,11,22,9,4,8,3,74,10.571428571428571,1,0.0,2,11,18,9,15,4,4,8,3,40,34,0
1154,38066,3JBai7u7WOgX09HExPUwVpNowvdvIz4R,SpATywNh6bZuzm8s1ceuBUnMUAeoAHHw,8,14,3,0,3,0,6,0,26,3.7142857142857144,1,0.0,0,3,0,3,14,0,0,6,0,6,20,1
1155,38077,ltTao4EsmrwmN0pXNyC05GxRX7ymLAGM,SpATywNh6bZuzm8s1ceuBUnMUAeoAHHw,15,41,1,21,1,23,15,2,104,14.857142857142858,2,0.0,10,1,15,1,31,23,6,15,2,27,77,1
1156,38080,OF5BECbAO5zdcqQHFPvLM1mTcTskbMIs,SpATywNh6bZuzm8s1ceuBUnMUAeoAHHw,5,2,1,0,1,0,2,0,6,0.8571428571428571,1,0.0,0,1,0,1,2,0,0,2,0,2,4,1
1157,38096,EjRGtyRd7Px8PMzWSSey4NzmMFY5f6ai,A3fsA9Zfv1X2fVEQhTw51lKENdNrEqT3,7,5,0,0,0,0,3,0,8,1.1428571428571428,1,0.0,1,0,0,0,4,0,0,3,0,1,7,1
1158,38115,iVCEmNfeCwWMGAqNUnWf3L8wEjKUErLk,SpATywNh6bZuzm8s1ceuBUnMUAeoAHHw,13,10,7,8,6,0,2,0,33,4.714285714285714,1,0.0,2,7,7,6,8,0,1,2,0,22,11,1
1159,38117,udxFfabXtaVUvVlT3wEleIvfDBGe9yE2,SpATywNh6bZuzm8s1ceuBUnMUAeoAHHw,14,41,1,12,0,30,20,3,107,15.285714285714286,3,0.0,11,1,12,0,30,30,0,20,3,24,83,0
1160,38119,53oi8zKKD3qFJiM7JZLKGYnyxQCMyuUV,SpATywNh6bZuzm8s1ceuBUnMUAeoAHHw,17,17,9,3,3,0,10,0,42,6.0,2,0.0,2,9,3,3,15,0,0,10,0,17,25,0
1161,38128,UwkR7Vh4zbozAucPqUcQw4h7SMZr9zo0,G8EPVSXsOYB5YQWZGiz1aVq5Pgr2GrQu,31,51,14,46,12,3,22,3,151,21.571428571428573,1,0.0,18,14,35,12,33,3,11,22,3,79,72,1
1162,38133,cqdnmjbJq0lDv2xgeKuzXqVr5xQytWr0,SpATywNh6bZuzm8s1ceuBUnMUAeoAHHw,14,29,12,12,5,5,12,2,77,11.0,2,0.0,10,12,10,5,19,5,2,12,2,37,40,1
1163,38138,mInRZ91i4VWL94xI1UV5JCnlg7Y6Us1i,SpATywNh6bZuzm8s1ceuBUnMUAeoAHHw,9,9,3,19,1,2,3,0,37,5.285714285714286,1,0.0,5,3,16,1,4,2,3,3,0,25,12,1
1164,38143,NuIu6w9t8Lc1HMDSYdxabpGimNAWlvNQ,SpATywNh6bZuzm8s1ceuBUnMUAeoAHHw,1,0,0,0,0,0,3,0,3,0.42857142857142855,1,0.0,0,0,0,0,0,0,0,3,0,0,3,1
1165,38158,i1weaEaafaiWi31Ms4bwoF6JM4IRf714,SpATywNh6bZuzm8s1ceuBUnMUAeoAHHw,17,33,14,14,6,0,12,0,79,11.285714285714286,3,0.0,10,14,10,6,23,0,4,12,0,40,39,0
1166,38221,cANiCKhLAefO0FGisAnCzMrx1JIRd95C,SpATywNh6bZuzm8s1ceuBUnMUAeoAHHw,1,0,0,0,0,0,1,0,1,0.14285714285714285,1,0.0,0,0,0,0,0,0,0,1,0,0,1,1
1167,38230,iazFnp0WwUGX79mDdFk78xSp9PPvWXim,G8EPVSXsOYB5YQWZGiz1aVq5Pgr2GrQu,9,2,1,0,1,5,9,1,19,2.7142857142857144,1,0.0,0,1,0,1,2,5,0,9,1,2,17,1
1168,38233,ysJor7TWBYA7e95uEgB7VNWumWxuU518,SpATywNh6bZuzm8s1ceuBUnMUAeoAHHw,17,19,10,8,4,7,4,1,53,7.571428571428571,1,0.0,7,10,8,4,12,7,0,4,1,29,24,1
1169,38246,LTRNxyAcyQ3kCcXCEOrswo8s3Qc2KMU6,SpATywNh6bZuzm8s1ceuBUnMUAeoAHHw,9,21,3,0,2,0,9,0,35,5.0,4,0.0,0,3,0,2,21,0,0,9,0,5,30,1
1170,38247,jSpQCS8wUT6MHpQaGbLVjdDCTF3dAoT8,SpATywNh6bZuzm8s1ceuBUnMUAeoAHHw,18,41,16,24,8,22,20,1,132,18.857142857142858,3,0.0,18,16,20,8,23,22,4,20,1,62,70,0
1171,38253,sfuANiSFq72qS7aoKnyvPaRtXw7bLFiY,RXDvfPUBYFlVdlueBFbLW0mhhAyGEqpt,29,17,12,24,10,0,2,0,65,9.285714285714286,2,0.0,3,12,24,10,14,0,0,2,0,49,16,1
1172,38268,JDTEn5xJLcPCagcpPFhmwRsZ0N8AbJZ6,A3fsA9Zfv1X2fVEQhTw51lKENdNrEqT3,28,23,15,32,12,0,5,0,87,12.428571428571429,2,0.0,0,15,25,12,23,0,7,5,0,52,35,1
1173,38270,Dw8R0agU0UT0CHCyap3lEB834WRdn2Bl,SpATywNh6bZuzm8s1ceuBUnMUAeoAHHw,12,65,24,5,14,0,24,0,132,18.857142857142858,6,0.0,0,24,5,14,65,0,0,24,0,43,89,1
1174,38298,5FKi7MQVDgjqvQXvzQgvsTDVCkGiyjdK,SpATywNh6bZuzm8s1ceuBUnMUAeoAHHw,15,12,9,8,8,0,22,2,61,8.714285714285714,3,0.0,3,9,8,8,9,0,0,22,2,28,33,0
1175,38314,AVyodBv8C1SQfOiSO7xOfqn4Ds4wiCRY,A3fsA9Zfv1X2fVEQhTw51lKENdNrEqT3,17,14,1,0,0,15,10,1,41,5.857142857142857,2,0.0,0,1,0,0,14,15,0,10,1,1,40,1
1176,38327,rB1ONc72srD5rc2RXozcacnvBYqDF9fo,SpATywNh6bZuzm8s1ceuBUnMUAeoAHHw,14,25,1,9,3,1,5,0,44,6.285714285714286,2,0.0,14,1,9,3,11,1,0,5,0,27,17,1
1177,38328,XwPjxWDcCDaPkH71IgDdIxnm3Wz6b30d,SpATywNh6bZuzm8s1ceuBUnMUAeoAHHw,7,5,4,0,3,0,2,0,14,2.0,1,0.0,0,4,0,3,5,0,0,2,0,7,7,1
1178,38346,0KKudduxSM0i9qq9j381LmD3t0z9aJ9R,SpATywNh6bZuzm8s1ceuBUnMUAeoAHHw,14,29,2,10,0,5,18,1,65,9.285714285714286,5,0.0,14,2,10,0,15,5,0,18,1,26,39,0
1179,38356,DJeWlgB4cP1RQ3JZLa1wZwd4zgAbYOxv,SpATywNh6bZuzm8s1ceuBUnMUAeoAHHw,10,15,11,0,6,0,3,0,35,5.0,2,0.0,1,11,0,6,14,0,0,3,0,18,17,1
1180,38373,tiRtyjdLAEYu3JNWmyxWqeCTg4ly9Ea3,A3fsA9Zfv1X2fVEQhTw51lKENdNrEqT3,1,0,0,0,0,0,1,0,1,0.14285714285714285,1,0.0,0,0,0,0,0,0,0,1,0,0,1,1
1181,38379,bA9VLpiTLkvmdt5uyFO2FBNAiu4jehWj,SpATywNh6bZuzm8s1ceuBUnMUAeoAHHw,6,2,1,0,1,0,3,1,8,1.1428571428571428,1,0.0,0,1,0,1,2,0,0,3,1,2,6,1
1182,38386,MAkHN0TS4uaTPgKLso4eQ3LTCDiU28De,A3fsA9Zfv1X2fVEQhTw51lKENdNrEqT3,5,2,1,0,1,0,7,0,11,1.5714285714285714,2,0.0,0,1,0,1,2,0,0,7,0,2,9,1
1183,38396,4hVUUGEGYiw6Bdgp8UlEBQC8ko8eVYqV,G8EPVSXsOYB5YQWZGiz1aVq5Pgr2GrQu,10,17,1,6,1,0,2,0,27,3.857142857142857,2,0.0,6,1,4,1,11,0,2,2,0,12,15,1
1184,38414,sDWigCKujHowENc4QsnIRZ8UQl2larGF,RXDvfPUBYFlVdlueBFbLW0mhhAyGEqpt,6,9,2,0,1,0,1,0,13,1.8571428571428572,1,0.0,1,2,0,1,8,0,0,1,0,4,9,1
1185,38416,3koO9aMoYp8zzErC814zevxBi6TaaAOF,SpATywNh6bZuzm8s1ceuBUnMUAeoAHHw,14,16,1,25,0,37,11,5,95,13.571428571428571,2,0.0,6,1,20,0,10,37,5,11,5,27,68,0
1186,38436,v9mjKPlqj9n2M1xFKzFtpQVo3yi6HxGV,A3fsA9Zfv1X2fVEQhTw51lKENdNrEqT3,12,25,13,0,5,1,9,0,53,7.571428571428571,3,0.0,5,13,0,5,20,1,0,9,0,23,30,1
1187,38441,iwk5jwRoUXpb7apwoAzA2sr9pA9dpqVB,bWdj2GDclj5ofokWjzoa5jAwMkxCykd6,2,0,0,0,0,0,6,0,6,0.8571428571428571,2,0.0,0,0,0,0,0,0,0,6,0,0,6,1
1188,38442,r6bvKJ2a2G72TbQZE3LacWwmKi7rGXEx,G8EPVSXsOYB5YQWZGiz1aVq5Pgr2GrQu,8,11,3,0,3,0,2,0,19,2.7142857142857144,1,0.0,0,3,0,3,11,0,0,2,0,6,13,1
1189,38444,hBkBlAVjz5BY7zZnohogA0eA3ndLKNkg,SpATywNh6bZuzm8s1ceuBUnMUAeoAHHw,16,26,9,4,3,0,21,1,64,9.142857142857142,3,0.0,5,9,4,3,21,0,0,21,1,21,43,1
1190,38462,VUqbVeGCU5BsVYNffcOAJ9BDqeO65P9U,G8EPVSXsOYB5YQWZGiz1aVq5Pgr2GrQu,34,9,6,126,3,9,8,1,162,23.142857142857142,1,0.0,0,6,105,3,9,9,21,8,1,114,48,1
1191,38468,SHRanMph56qnHJKMofxrIA8VyLg99gvL,SpATywNh6bZuzm8s1ceuBUnMUAeoAHHw,16,47,22,12,9,1,29,0,120,17.142857142857142,6,0.0,9,22,10,9,38,1,2,29,0,50,70,0
1192,38469,kOr03XnYLBaytLqdfTXgh6ll5b7wmEto,SpATywNh6bZuzm8s1ceuBUnMUAeoAHHw,16,18,8,18,3,2,4,0,53,7.571428571428571,2,0.0,8,8,15,3,10,2,3,4,0,34,19,0
1193,38478,wYSxpzhDGDxqe5tb8zcGOA1V0q1ivqUs,SpATywNh6bZuzm8s1ceuBUnMUAeoAHHw,9,14,5,0,2,0,2,0,23,3.2857142857142856,1,0.0,8,5,0,2,6,0,0,2,0,15,8,1
1194,38487,G9YOnYlxMjTyBQskKi3FlOCiDMxWpomt,SpATywNh6bZuzm8s1ceuBUnMUAeoAHHw,11,11,5,5,3,0,2,0,26,3.7142857142857144,1,0.0,1,5,4,3,10,0,1,2,0,13,13,1
1195,38491,UEGgGFOddxp081siu8g5s2awm2LAgg2C,SpATywNh6bZuzm8s1ceuBUnMUAeoAHHw,5,5,0,0,0,0,2,0,7,1.0,1,0.0,2,0,0,0,3,0,0,2,0,2,5,0
1196,38510,OsVYZ2chBGfS6TvOshYA5qBASHIKNM7Z,SpATywNh6bZuzm8s1ceuBUnMUAeoAHHw,18,26,15,16,6,35,14,2,114,16.285714285714285,4,0.0,2,15,14,6,24,35,2,14,2,37,77,1
1197,38516,5zW7QL5PVg4tmiZ3UmDwoFtZ0u1EHg1C,G8EPVSXsOYB5YQWZGiz1aVq5Pgr2GrQu,1,0,0,0,0,0,1,0,1,0.14285714285714285,1,0.0,0,0,0,0,0,0,0,1,0,0,1,1
1198,38521,WRiHtWJX61VUGyAGQFSHJ3czdrgqxeQW,G8EPVSXsOYB5YQWZGiz1aVq5Pgr2GrQu,1,0,0,0,0,0,3,0,3,0.42857142857142855,3,0.0,0,0,0,0,0,0,0,3,0,0,3,1
1199,38524,0utD2vP6cBRtrip5Htxbgl8CGlMSWQLX,SpATywNh6bZuzm8s1ceuBUnMUAeoAHHw,6,1,1,0,1,2,5,0,10,1.4285714285714286,3,0.0,0,1,0,1,1,2,0,5,0,2,8,1
1200,38533,pqUcxq00SFcjmnxHDdHJfvpMD3HzyhM8,A3fsA9Zfv1X2fVEQhTw51lKENdNrEqT3,9,7,4,0,1,1,7,0,20,2.857142857142857,4,0.0,0,4,0,1,7,1,0,7,0,5,15,0
1201,38542,kzXC5gLwxzrAZMym3dLm7LbQsy5flpkC,SpATywNh6bZuzm8s1ceuBUnMUAeoAHHw,1,0,0,0,0,0,1,0,1,0.14285714285714285,1,0.0,0,0,0,0,0,0,0,1,0,0,1,1
1202,38559,fd1NhQTFxl8TsBhiRc4F6bEwrFxQh7qC,bWdj2GDclj5ofokWjzoa5jAwMkxCykd6,5,2,1,0,1,0,2,0,6,0.8571428571428571,1,0.0,0,1,0,1,2,0,0,2,0,2,4,1
1203,38560,op5Oi3uTeIRoABlsMVgAwjAoITQ3GmAH,SpATywNh6bZuzm8s1ceuBUnMUAeoAHHw,17,25,11,15,5,0,6,0,62,8.857142857142858,1,0.0,12,11,13,5,13,0,2,6,0,41,21,1
1204,38566,LU9kxt8aKnlOn8SnA2EuX2MLajf5Sg2a,A3fsA9Zfv1X2fVEQhTw51lKENdNrEqT3,9,5,2,0,3,0,2,0,12,1.7142857142857142,1,0.0,1,2,0,3,4,0,0,2,0,6,6,1
1205,38569,5Rbvag4nzKt7RfTqiThTliUWaR0ZVWak,RXDvfPUBYFlVdlueBFbLW0mhhAyGEqpt,29,32,25,29,12,21,20,17,156,22.285714285714285,3,0.0,3,25,27,12,29,21,2,20,17,67,89,1
1206,38603,BK89tGWFvtCB5b9BaDDNxW929HW7wR4P,G8EPVSXsOYB5YQWZGiz1aVq5Pgr2GrQu,12,11,3,8,3,0,3,0,28,4.0,2,0.0,5,3,5,3,6,0,3,3,0,16,12,0
1207,38604,piuFZPcLrtqUCR4Mz7Dvqp0k5ELkq8NC,G8EPVSXsOYB5YQWZGiz1aVq5Pgr2GrQu,11,12,7,0,7,0,5,0,31,4.428571428571429,1,0.0,3,7,0,7,9,0,0,5,0,17,14,1
1208,38608,J0IJ83RVowrJWkvIAkcS1VNIhpCHoyob,A3fsA9Zfv1X2fVEQhTw51lKENdNrEqT3,5,1,1,0,1,0,2,0,5,0.7142857142857143,1,0.0,0,1,0,1,1,0,0,2,0,2,3,1
1209,38624,1eeJGwVZl6tkgP8o5hxfgeveRzoyzGC1,SpATywNh6bZuzm8s1ceuBUnMUAeoAHHw,17,12,7,10,3,5,5,1,43,6.142857142857143,2,0.0,2,7,8,3,10,5,2,5,1,20,23,1
1210,38626,vmk0Cb97y6KFP4NN2aQejQh8kNwAKs9K,SpATywNh6bZuzm8s1ceuBUnMUAeoAHHw,5,5,0,0,0,0,2,0,7,1.0,2,0.0,0,0,0,0,5,0,0,2,0,0,7,1
1211,38648,74izHUTVIKwdbm5ACRGoK7PWOEfmZhU5,bWdj2GDclj5ofokWjzoa5jAwMkxCykd6,6,4,2,10,1,0,1,0,18,2.5714285714285716,1,0.0,1,2,9,1,3,0,1,1,0,13,5,0
1212,38650,k1hHR6rkUwES1hOj6qPmM0zEpPF3eP6v,SpATywNh6bZuzm8s1ceuBUnMUAeoAHHw,7,4,3,0,3,0,2,0,12,1.7142857142857142,1,0.0,0,3,0,3,4,0,0,2,0,6,6,1
1213,38654,wJIBDD9rPqnYMIKUazC26GmZhLI0Mfvr,RXDvfPUBYFlVdlueBFbLW0mhhAyGEqpt,26,44,23,0,14,12,18,3,114,16.285714285714285,4,0.0,9,23,0,14,35,12,0,18,3,46,68,1
1214,38678,TZQB6KsadY5lwvd9JKuw3u0s2cwQm2RY,A3fsA9Zfv1X2fVEQhTw51lKENdNrEqT3,1,0,0,0,0,0,1,0,1,0.14285714285714285,1,0.0,0,0,0,0,0,0,0,1,0,0,1,1
1215,38683,7uDVcwukNss0paMtTOJXNPZUXWP9vYuG,A3fsA9Zfv1X2fVEQhTw51lKENdNrEqT3,5,2,1,0,1,0,2,0,6,0.8571428571428571,1,0.0,0,1,0,1,2,0,0,2,0,2,4,1
1216,38686,pNgLScEwGgq81vg0a0cEXKNs5eG2UXph,A3fsA9Zfv1X2fVEQhTw51lKENdNrEqT3,44,28,14,88,9,9,10,1,159,22.714285714285715,3,0.0,2,14,88,9,26,9,0,10,1,113,46,1
1217,38691,dCqryZS5yEyDDbYzWpFyoRjFGlVzafA6,SpATywNh6bZuzm8s1ceuBUnMUAeoAHHw,12,36,14,5,6,0,5,0,66,9.428571428571429,4,0.0,14,14,4,6,22,0,1,5,0,38,28,0
1218,38701,E4KzNEU3ybRlAOiHqHHsGQEXiaxyHgoT,RXDvfPUBYFlVdlueBFbLW0mhhAyGEqpt,50,64,29,131,19,34,17,19,313,44.714285714285715,2,0.0,26,29,118,19,38,34,13,17,19,192,121,0
1219,38718,KtiXcHNNiby4TrKgvBuU25mstwPooCPe,SpATywNh6bZuzm8s1ceuBUnMUAeoAHHw,16,24,7,16,3,0,5,0,55,7.857142857142857,2,0.0,14,7,14,3,10,0,2,5,0,38,17,1
1220,38728,afat5vUgkwgUU0apBrv11YGTyd4OwYTu,SpATywNh6bZuzm8s1ceuBUnMUAeoAHHw,4,0,0,0,0,1,3,0,4,0.5714285714285714,1,0.0,0,0,0,0,0,1,0,3,0,0,4,1
1221,38737,afat5vUgkwgUU0apBrv11YGTyd4OwYTu,A3fsA9Zfv1X2fVEQhTw51lKENdNrEqT3,2,0,0,0,0,0,2,0,2,0.2857142857142857,1,0.0,0,0,0,0,0,0,0,2,0,0,2,1
1222,38739,nPRsjektHdbQkeAf1fIK4JbhrESPbPsA,A3fsA9Zfv1X2fVEQhTw51lKENdNrEqT3,5,4,0,0,0,21,3,0,28,4.0,2,0.0,0,0,0,0,4,21,0,3,0,0,28,1
1223,38742,0kgVI4xJnG62oDVcCEoC6XWb9EsWLjc0,bWdj2GDclj5ofokWjzoa5jAwMkxCykd6,1,0,0,0,0,0,1,0,1,0.14285714285714285,1,0.0,0,0,0,0,0,0,0,1,0,0,1,1
1224,38763,8YWaMVS3w7XpLYfFIo5KA8X2u5rBj2lm,bWdj2GDclj5ofokWjzoa5jAwMkxCykd6,1,0,0,0,0,0,1,0,1,0.14285714285714285,1,0.0,0,0,0,0,0,0,0,1,0,0,1,1
1225,38768,7mwJyfao5KIX49E5WhJbQSfLSpyhsypU,SpATywNh6bZuzm8s1ceuBUnMUAeoAHHw,2,0,0,0,0,0,2,0,2,0.2857142857142857,1,0.0,0,0,0,0,0,0,0,2,0,0,2,1
1226,38796,krjhlLET7SMyK6bykccAT1LqXqo0aBBB,A3fsA9Zfv1X2fVEQhTw51lKENdNrEqT3,1,0,0,0,0,0,1,0,1,0.14285714285714285,1,0.0,0,0,0,0,0,0,0,1,0,0,1,1
1227,38799,RzMIvT7jMzqf1FBzeYDC0G8NjaFmpbg8,SpATywNh6bZuzm8s1ceuBUnMUAeoAHHw,6,3,2,0,2,0,1,0,8,1.1428571428571428,1,0.0,0,2,0,2,3,0,0,1,0,4,4,0
1228,38828,RtAy5lws7b5k9geORbL2U1lmgZpp3fVx,SpATywNh6bZuzm8s1ceuBUnMUAeoAHHw,9,8,1,0,1,0,5,0,15,2.142857142857143,1,0.0,0,1,0,1,8,0,0,5,0,2,13,1
1229,38840,cXYtpsZ2fQmsdTOBAQ6nuO3uUXQTXgSe,SpATywNh6bZuzm8s1ceuBUnMUAeoAHHw,2,0,0,0,0,0,2,0,2,0.2857142857142857,1,0.0,0,0,0,0,0,0,0,2,0,0,2,1
1230,38845,BuxVbSmnOVgkaYnbyCiqICvSSomeF2JH,G8EPVSXsOYB5YQWZGiz1aVq5Pgr2GrQu,10,9,1,2,1,1,8,0,22,3.142857142857143,1,0.0,1,1,1,1,8,1,1,8,0,4,18,1
1231,38854,Xi85gYtmIKPj1CmvXveeSMqfVqnWSguE,bWdj2GDclj5ofokWjzoa5jAwMkxCykd6,8,9,6,0,3,16,5,0,39,5.571428571428571,3,0.0,0,6,0,3,9,16,0,5,0,9,30,0
1232,38855,uEJhWNudTN4AiJAcLu3Q22sgnPRHYbuv,G8EPVSXsOYB5YQWZGiz1aVq5Pgr2GrQu,45,45,17,120,11,2,10,0,205,29.285714285714285,2,0.0,12,17,108,11,33,2,12,10,0,148,57,0
1233,38857,9803qM4isShkjkoVAPID7DQVAjFPwCDe,A3fsA9Zfv1X2fVEQhTw51lKENdNrEqT3,2,0,0,0,0,0,8,0,8,1.1428571428571428,2,0.0,0,0,0,0,0,0,0,8,0,0,8,1
1234,38870,jaeRBfNSkyTpFxAZieHe5vTAkzlHFDmm,A3fsA9Zfv1X2fVEQhTw51lKENdNrEqT3,18,9,7,0,6,5,10,1,38,5.428571428571429,1,0.0,0,7,0,6,9,5,0,10,1,13,25,1
1235,38878,gSi0VgWgYBTsmYmeH4PYrjNlMDLA1S2c,SpATywNh6bZuzm8s1ceuBUnMUAeoAHHw,12,14,1,7,3,1,7,3,36,5.142857142857143,2,0.0,2,1,6,3,12,1,1,7,3,12,24,1
1236,38882,KbRlzY47exomwt4drbIiBF6s4vNevAUk,bWdj2GDclj5ofokWjzoa5jAwMkxCykd6,8,5,4,0,3,0,1,0,13,1.8571428571428572,1,0.0,0,4,0,3,5,0,0,1,0,7,6,1
1237,38894,lxM1uzj9RbEKW6MEHQHbWmFRP8lCwFlm,RXDvfPUBYFlVdlueBFbLW0mhhAyGEqpt,5,2,1,0,1,0,2,0,6,0.8571428571428571,1,0.0,0,1,0,1,2,0,0,2,0,2,4,1
1238,38899,uOTUidrDT0SJfarFY02mqsETfS65OeG7,SpATywNh6bZuzm8s1ceuBUnMUAeoAHHw,1,0,0,0,0,0,1,0,1,0.14285714285714285,1,0.0,0,0,0,0,0,0,0,1,0,0,1,1
1239,38905,Zfldpr4XdX0KviQz44l3WyKQ1DUv2CZO,bWdj2GDclj5ofokWjzoa5jAwMkxCykd6,5,2,1,0,1,0,4,0,8,1.1428571428571428,2,0.0,0,1,0,1,2,0,0,4,0,2,6,1
1240,38907,arTGhRrKZksM4iY72XDJ8i8oBmMABS0m,bWdj2GDclj5ofokWjzoa5jAwMkxCykd6,7,4,0,0,0,1,4,1,10,1.4285714285714286,1,0.0,0,0,0,0,4,1,0,4,1,0,10,1
1241,38920,0a9a6o0rpJD7kzJZwGRL9kB3jevQvRa8,SpATywNh6bZuzm8s1ceuBUnMUAeoAHHw,13,21,1,14,0,0,19,3,58,8.285714285714286,3,0.0,7,1,11,0,14,0,3,19,3,19,39,0
1242,38935,Bv9FSXvHlE6wLC4E4yrAKqe3BQhrrtfx,bWdj2GDclj5ofokWjzoa5jAwMkxCykd6,5,5,0,40,0,0,1,0,46,6.571428571428571,1,0.0,1,0,39,0,4,0,1,1,0,40,6,1
1243,38949,7HiGv3GGo0SXqM9pqC4B8FvUEghdfkna,A3fsA9Zfv1X2fVEQhTw51lKENdNrEqT3,18,28,5,0,3,2,15,0,53,7.571428571428571,3,0.0,0,5,0,3,28,2,0,15,0,8,45,0
1244,38975,pYuNHmli0QywI9Z1zHRuk8HH63MuG9ox,SpATywNh6bZuzm8s1ceuBUnMUAeoAHHw,7,4,3,0,1,0,2,0,10,1.4285714285714286,1,0.0,0,3,0,1,4,0,0,2,0,4,6,1
1245,38998,GxuI91smqBqnZvedxTapokE0d2tIuvjB,SpATywNh6bZuzm8s1ceuBUnMUAeoAHHw,11,12,1,16,0,0,3,1,33,4.714285714285714,1,0.0,5,1,14,0,7,0,2,3,1,20,13,1
1246,39003,kdrVEJc2I4GXXrnMfkE91hbE8pwDL5M5,SpATywNh6bZuzm8s1ceuBUnMUAeoAHHw,16,16,2,9,2,0,5,1,35,5.0,2,0.0,2,2,9,2,14,0,0,5,1,15,20,0
1247,39004,v74bXrlUV6ca8Hla1JfufyayJvtXjR7H,SpATywNh6bZuzm8s1ceuBUnMUAeoAHHw,6,3,1,0,1,0,2,0,7,1.0,1,0.0,0,1,0,1,3,0,0,2,0,2,5,1
1248,39023,t66hZYQIW0VPLqiRabyUSn9c1rXaD96i,G8EPVSXsOYB5YQWZGiz1aVq5Pgr2GrQu,9,12,4,0,5,0,3,1,25,3.5714285714285716,1,0.0,6,4,0,5,6,0,0,3,1,15,10,1
1249,39030,sUk3OLEiiNZtlo4krMYRLjkp5xwgbsPl,RXDvfPUBYFlVdlueBFbLW0mhhAyGEqpt,1,0,0,0,0,0,1,0,1,0.14285714285714285,1,0.0,0,0,0,0,0,0,0,1,0,0,1,1
1250,39031,3aJcxnpBDknIFELx5q7A1ed9nLB6csNj,A3fsA9Zfv1X2fVEQhTw51lKENdNrEqT3,8,4,3,0,3,0,1,0,11,1.5714285714285714,1,0.0,0,3,0,3,4,0,0,1,0,6,5,1
1251,39056,T4lMOZ9NGQ0RS4ue5IeZuDcW1ySIGZ9u,bWdj2GDclj5ofokWjzoa5jAwMkxCykd6,19,14,5,74,3,3,7,1,107,15.285714285714286,2,0.0,4,5,67,3,10,3,7,7,1,79,28,1
1252,39075,XyYnnl4AI9tScnU7RGEEZZNUDhUKeoxB,SpATywNh6bZuzm8s1ceuBUnMUAeoAHHw,4,3,2,0,1,0,3,0,9,1.2857142857142858,1,0.0,0,2,0,1,3,0,0,3,0,3,6,1
1253,39081,blQFA8HzhNQeb8MMYJXyJW6sPMdvZQKn,SpATywNh6bZuzm8s1ceuBUnMUAeoAHHw,13,14,5,6,4,1,1,0,31,4.428571428571429,1,0.0,8,5,6,4,6,1,0,1,0,23,8,1
1254,39083,1r2nGZGkg8GEqN3RApjS0ItoQ0nF4xaw,SpATywNh6bZuzm8s1ceuBUnMUAeoAHHw,1,0,0,0,0,0,2,0,2,0.2857142857142857,2,0.0,0,0,0,0,0,0,0,2,0,0,2,1
1255,39088,UvSPzXNBScAU9ByvT8o3qVBXbi67b3h8,G8EPVSXsOYB5YQWZGiz1aVq5Pgr2GrQu,5,5,1,0,1,0,1,0,8,1.1428571428571428,1,0.0,0,1,0,1,5,0,0,1,0,2,6,1
1256,39091,CJISoHtkGNnkB0CRrvBDw2uUj4sPNv5j,bWdj2GDclj5ofokWjzoa5jAwMkxCykd6,5,8,1,0,0,0,3,0,12,1.7142857142857142,3,0.0,0,1,0,0,8,0,0,3,0,1,11,1
1257,39095,Lc5TZPB93C58CDuO8VjF5g6g9boxDaHr,SpATywNh6bZuzm8s1ceuBUnMUAeoAHHw,15,33,1,22,0,45,17,1,119,17.0,2,0.0,15,1,19,0,18,45,3,17,1,35,84,1
1258,39098,N1NANPOEzVcSgsnoCvLHz8IcJu1p6TeM,bWdj2GDclj5ofokWjzoa5jAwMkxCykd6,1,0,0,0,0,0,1,0,1,0.14285714285714285,1,0.0,0,0,0,0,0,0,0,1,0,0,1,1
1259,39114,2nqqGgbA0MihvBXBZoRijk6wA6yRTkC8,SpATywNh6bZuzm8s1ceuBUnMUAeoAHHw,14,26,13,16,6,15,3,0,79,11.285714285714286,2,0.0,6,13,14,6,20,15,2,3,0,39,40,1
1260,39121,UflKWNcvi2MA5nN1C1yYIrKHClWLnxXf,SpATywNh6bZuzm8s1ceuBUnMUAeoAHHw,3,0,0,0,0,7,3,0,10,1.4285714285714286,2,0.0,0,0,0,0,0,7,0,3,0,0,10,1
1261,39134,wjTC7wnlKcnUR3GStNksYXKWSSmG8wiR,SpATywNh6bZuzm8s1ceuBUnMUAeoAHHw,9,5,4,0,3,0,5,0,17,2.4285714285714284,1,0.0,0,4,0,3,5,0,0,5,0,7,10,1
1262,39140,zVX5LPwTGC1SEitxSfv31cubNXKJSEc2,SpATywNh6bZuzm8s1ceuBUnMUAeoAHHw,2,0,0,0,0,0,2,0,2,0.2857142857142857,1,0.0,0,0,0,0,0,0,0,2,0,0,2,0
1263,39141,ILzL3Mkktf2JWNBXHKy152QukNojyWoV,SpATywNh6bZuzm8s1ceuBUnMUAeoAHHw,6,2,1,0,1,0,3,0,7,1.0,1,0.0,0,1,0,1,2,0,0,3,0,2,5,1
1264,39145,AVMp8F9T45cyhHDRnad5d9bxFkDP4PTv,bWdj2GDclj5ofokWjzoa5jAwMkxCykd6,1,0,0,0,0,0,1,0,1,0.14285714285714285,1,0.0,0,0,0,0,0,0,0,1,0,0,1,1
1265,39149,4UqKAySXvYrQJCWmxoUDAB7q5gWLAioi,SpATywNh6bZuzm8s1ceuBUnMUAeoAHHw,5,2,1,0,1,0,2,0,6,0.8571428571428571,1,0.0,0,1,0,1,2,0,0,2,0,2,4,1
1266,39154,BGVVwabO5K2aC65VwhxWT01Y18m3Nzj6,SpATywNh6bZuzm8s1ceuBUnMUAeoAHHw,15,40,1,14,1,86,11,3,156,22.285714285714285,3,0.0,14,1,13,1,26,86,1,11,3,29,127,0
1267,39157,1NMKv7RE12uBMKwNJI30Cx8Z5ltMGoee,RXDvfPUBYFlVdlueBFbLW0mhhAyGEqpt,1,0,0,0,0,0,1,0,1,0.14285714285714285,1,0.0,0,0,0,0,0,0,0,1,0,0,1,1
1268,39164,7GjcmlDBrfMQgiPOO8hsiYQuQLOINerQ,SpATywNh6bZuzm8s1ceuBUnMUAeoAHHw,15,30,10,20,3,0,6,0,69,9.857142857142858,2,0.0,16,10,17,3,14,0,3,6,0,46,23,0
1269,39173,ZzLLcAQUfjtXFFVyip2u00anhVLGCjVt,SpATywNh6bZuzm8s1ceuBUnMUAeoAHHw,6,3,1,0,1,0,2,0,7,1.0,1,0.0,0,1,0,1,3,0,0,2,0,2,5,1
1270,39177,HzHckETSltPKPBe9aHJBFKMPGsxyznRF,RXDvfPUBYFlVdlueBFbLW0mhhAyGEqpt,47,96,60,127,29,20,14,0,346,49.42857142857143,4,0.0,23,60,119,29,73,20,8,14,0,231,115,0
1271,39195,E4KzNEU3ybRlAOiHqHHsGQEXiaxyHgoT,G8EPVSXsOYB5YQWZGiz1aVq5Pgr2GrQu,6,13,2,8,2,3,1,0,29,4.142857142857143,1,0.0,8,2,6,2,5,3,2,1,0,18,11,0
1272,39200,mhEXeYR4fhAtV2BL9wCEhGJhQCxsqkvm,SpATywNh6bZuzm8s1ceuBUnMUAeoAHHw,10,8,3,0,5,0,11,0,27,3.857142857142857,1,0.0,5,3,0,5,3,0,0,11,0,13,14,1
1273,39228,46Kekotwda3n13NUXnmxT29j0BxeYz12,SpATywNh6bZuzm8s1ceuBUnMUAeoAHHw,5,2,1,0,1,0,2,0,6,0.8571428571428571,1,0.0,0,1,0,1,2,0,0,2,0,2,4,1
1274,39251,hmgBnYFDyZngu0mjeUhp0xYSYQ6O53Mz,SpATywNh6bZuzm8s1ceuBUnMUAeoAHHw,1,0,0,0,0,0,1,0,1,0.14285714285714285,1,0.0,0,0,0,0,0,0,0,1,0,0,1,1
1275,39253,eBPwvAxm4arXAr6DDABCeVRfgkKzrVG9,A3fsA9Zfv1X2fVEQhTw51lKENdNrEqT3,38,53,2,60,3,3,17,1,139,19.857142857142858,2,0.0,6,2,56,3,47,3,4,17,1,67,72,1
1276,39257,PATQ2JDuYcR1iRnRPNzs82w3vSQnScOh,A3fsA9Zfv1X2fVEQhTw51lKENdNrEqT3,1,0,0,0,0,0,1,0,1,0.14285714285714285,1,0.0,0,0,0,0,0,0,0,1,0,0,1,1
1277,39262,1w8EW76qmBSgQ2s8Jb4yoPsNX01KUcoD,SpATywNh6bZuzm8s1ceuBUnMUAeoAHHw,4,2,1,0,1,0,1,0,5,0.7142857142857143,1,0.0,0,1,0,1,2,0,0,1,0,2,3,1
1278,39271,MuWLBiVwYCkYNKOHYGJD8tH8opD9K24n,G8EPVSXsOYB5YQWZGiz1aVq5Pgr2GrQu,11,15,0,8,1,5,7,1,37,5.285714285714286,1,0.0,9,0,7,1,6,5,1,7,1,17,20,1
1279,39279,MbSy3vYucWpXbJ8XgmPxO6zrZOjC9oUB,SpATywNh6bZuzm8s1ceuBUnMUAeoAHHw,16,35,20,16,10,0,11,0,92,13.142857142857142,4,0.0,6,20,13,10,29,0,3,11,0,49,43,1
1280,39285,YqUtlfMe9rLKsCC9IaplFVEXt8vH7Xc8,SpATywNh6bZuzm8s1ceuBUnMUAeoAHHw,7,15,1,0,0,0,2,0,18,2.5714285714285716,1,0.0,4,1,0,0,11,0,0,2,0,5,13,1
1281,39321,zFmjJfAeKUvggwuYYEK06j1MuKf2V5Jp,G8EPVSXsOYB5YQWZGiz1aVq5Pgr2GrQu,8,2,1,0,1,0,5,1,10,1.4285714285714286,1,0.0,0,1,0,1,2,0,0,5,1,2,8,1
1282,39328,iJftBP3zncmjUCwGWSZ77IUrDb3Dt8rz,A3fsA9Zfv1X2fVEQhTw51lKENdNrEqT3,36,21,14,70,11,0,4,0,120,17.142857142857142,2,0.0,1,14,54,11,20,0,16,4,0,80,40,0
1283,39355,z3YnX73v2uoVHmuLGzQD2gKKBoJqIQxK,A3fsA9Zfv1X2fVEQhTw51lKENdNrEqT3,39,28,21,90,17,9,5,0,170,24.285714285714285,3,0.0,5,21,72,17,23,9,18,5,0,115,55,1
1284,39364,yl2extq9BiirsP1wIY2qyqtEIn2eAosn,A3fsA9Zfv1X2fVEQhTw51lKENdNrEqT3,12,15,7,0,1,2,8,1,34,4.857142857142857,1,0.0,1,7,0,1,14,2,0,8,1,9,25,1
1285,39369,nACUst6Z3nbYOefsNnWJBD4yiz9OCgPb,A3fsA9Zfv1X2fVEQhTw51lKENdNrEqT3,2,0,0,0,0,0,2,0,2,0.2857142857142857,1,0.0,0,0,0,0,0,0,0,2,0,0,2,1
1286,39386,xcD6YWhnGA2xukGmX4eaYrm6VS9ffz1H,A3fsA9Zfv1X2fVEQhTw51lKENdNrEqT3,1,0,0,0,0,0,1,0,1,0.14285714285714285,1,0.0,0,0,0,0,0,0,0,1,0,0,1,1
1287,39408,mC2fzvwPaO34Kq32ibCwzrJ2EjHwbRrb,A3fsA9Zfv1X2fVEQhTw51lKENdNrEqT3,13,46,20,0,13,0,7,0,86,12.285714285714286,2,0.0,0,20,0,13,46,0,0,7,0,33,53,1
1288,39416,NiOuJ51IxTtojHMts8OdX2AfCH09G7vK,SpATywNh6bZuzm8s1ceuBUnMUAeoAHHw,7,3,2,0,2,0,4,0,11,1.5714285714285714,1,0.0,0,2,0,2,3,0,0,4,0,4,7,1
1289,39435,eOxm8XEI11Xs6eiBi1Nu5QzIagZXwEm9,A3fsA9Zfv1X2fVEQhTw51lKENdNrEqT3,1,0,0,0,0,0,1,0,1,0.14285714285714285,1,0.0,0,0,0,0,0,0,0,1,0,0,1,1
1290,39437,YaP2AuckukEZITP3IVvIt6Z8ci6RHew7,A3fsA9Zfv1X2fVEQhTw51lKENdNrEqT3,14,20,18,0,13,1,6,1,59,8.428571428571429,1,0.0,0,18,0,13,20,1,0,6,1,31,28,1
1291,39438,PCU2OsmEUaGQvWJWbob5pKb7iiPbQ7ze,SpATywNh6bZuzm8s1ceuBUnMUAeoAHHw,17,29,5,8,4,2,29,1,78,11.142857142857142,5,0.0,11,5,8,4,18,2,0,29,1,28,50,1
1292,39445,P8w9ro0HOkoKzPyzFHSnLuYXXRtV1BHH,RXDvfPUBYFlVdlueBFbLW0mhhAyGEqpt,15,25,11,0,6,0,5,0,47,6.714285714285714,2,0.0,0,11,0,6,25,0,0,5,0,17,30,1
1293,39461,6Trp4kpO6fwwtbebtvF77MGUNovs9zvp,SpATywNh6bZuzm8s1ceuBUnMUAeoAHHw,15,12,8,14,6,0,5,0,45,6.428571428571429,2,0.0,3,8,13,6,9,0,1,5,0,30,15,1
1294,39480,CFP5BToaLlKEM1IV3uFEyj5nP0RKpJGG,RXDvfPUBYFlVdlueBFbLW0mhhAyGEqpt,14,20,11,0,6,5,8,0,50,7.142857142857143,1,0.0,0,11,0,6,20,5,0,8,0,17,33,1
1295,39481,evkJ1tKmVFYbszWTpTeoBUR5H84hykAY,SpATywNh6bZuzm8s1ceuBUnMUAeoAHHw,13,38,10,13,2,2,15,0,80,11.428571428571429,4,0.0,11,10,10,2,27,2,3,15,0,33,47,0
1296,39493,Sw0laYN5mow6XiHfrWCJl4qnRcU0Nesb,SpATywNh6bZuzm8s1ceuBUnMUAeoAHHw,14,17,9,14,3,0,5,0,48,6.857142857142857,4,0.0,3,9,13,3,14,0,1,5,0,28,20,0
1297,39498,iVCEmNfeCwWMGAqNUnWf3L8wEjKUErLk,A3fsA9Zfv1X2fVEQhTw51lKENdNrEqT3,1,0,0,0,0,0,1,0,1,0.14285714285714285,1,0.0,0,0,0,0,0,0,0,1,0,0,1,1
1298,39518,jeuXS3tUDyyNfvbrveLA3P9Aday4J2bg,SpATywNh6bZuzm8s1ceuBUnMUAeoAHHw,14,13,7,12,3,0,5,0,40,5.714285714285714,3,0.0,3,7,12,3,10,0,0,5,0,25,15,0
1299,39521,KkCL9hhbl4No8xC8Kgerd95M1LSlSYMD,G8EPVSXsOYB5YQWZGiz1aVq5Pgr2GrQu,29,77,4,50,2,14,32,2,181,25.857142857142858,3,0.0,30,4,38,2,47,14,12,32,2,74,107,0
1300,39522,WMPYVFkG1npps8BU0n5fJtN4LOF8N9L7,A3fsA9Zfv1X2fVEQhTw51lKENdNrEqT3,1,0,0,0,0,0,1,0,1,0.14285714285714285,1,0.0,0,0,0,0,0,0,0,1,0,0,1,1
1301,39523,U2HBhhMvJdYJzypYvAaM7auP4hEAIFmE,SpATywNh6bZuzm8s1ceuBUnMUAeoAHHw,15,11,6,12,2,1,3,1,36,5.142857142857143,1,0.0,2,6,12,2,9,1,0,3,1,22,14,0
1302,39528,UPv4XJg0qIN0z1e32NPBqipWdQJZCo5I,G8EPVSXsOYB5YQWZGiz1aVq5Pgr2GrQu,63,104,59,96,30,0,33,2,324,46.285714285714285,5,0.0,26,59,74,30,78,0,22,33,2,189,135,0
1303,39531,ZicPLcC85bFypm3Kcvbq59RwoYBxR8MH,A3fsA9Zfv1X2fVEQhTw51lKENdNrEqT3,32,18,8,50,2,1,20,2,101,14.428571428571429,4,0.0,4,8,45,2,14,1,5,20,2,59,42,1
1304,39532,cULoH8ZJIqrdeB8ADfKnnQ8THzmbMgQV,RXDvfPUBYFlVdlueBFbLW0mhhAyGEqpt,1,0,0,0,0,0,1,0,1,0.14285714285714285,1,0.0,0,0,0,0,0,0,0,1,0,0,1,1
1305,39542,rVLakh088SHEy7dbxY22je6HzyBvqGMw,A3fsA9Zfv1X2fVEQhTw51lKENdNrEqT3,5,2,1,0,1,0,2,0,6,0.8571428571428571,1,0.0,0,1,0,1,2,0,0,2,0,2,4,1
1306,39551,iwZaMWnVmB8vAWyB7qgI9UDj7NG1VyL9,G8EPVSXsOYB5YQWZGiz1aVq5Pgr2GrQu,17,28,14,14,4,1,1,0,62,8.857142857142858,2,0.0,3,14,12,4,25,1,2,1,0,33,29,1
1307,39566,Tgv3JnuulONnAU5nEHKsBYsIQCqMFPi1,SpATywNh6bZuzm8s1ceuBUnMUAeoAHHw,14,29,4,22,2,0,5,0,62,8.857142857142858,2,0.0,8,4,18,2,21,0,4,5,0,32,30,1
1308,39591,fqudw8MOLcF9t0i6q2XPWF2TIejKMZHF,SpATywNh6bZuzm8s1ceuBUnMUAeoAHHw,7,3,2,0,2,0,2,0,9,1.2857142857142858,1,0.0,0,2,0,2,3,0,0,2,0,4,5,1
1309,39602,il53m0D8iMReEupAF0qvTcyM0rInz34F,bWdj2GDclj5ofokWjzoa5jAwMkxCykd6,6,2,1,0,1,0,3,0,7,1.0,1,0.0,0,1,0,1,2,0,0,3,0,2,5,1
1310,39603,BYn6cWVQSMORsIVShYVRAnnkHpLyiUv8,A3fsA9Zfv1X2fVEQhTw51lKENdNrEqT3,14,8,6,0,4,0,4,0,22,3.142857142857143,2,0.0,0,6,0,4,8,0,0,4,0,10,12,1
1311,39610,5JJq364DIcWk9Vho0reVJETDCFza3l8p,SpATywNh6bZuzm8s1ceuBUnMUAeoAHHw,17,35,12,13,4,8,12,0,84,12.0,3,0.0,17,12,11,4,18,8,2,12,0,44,40,1
1312,39635,xcD6YWhnGA2xukGmX4eaYrm6VS9ffz1H,SpATywNh6bZuzm8s1ceuBUnMUAeoAHHw,16,37,19,16,7,11,10,0,100,14.285714285714286,4,0.0,11,19,14,7,26,11,2,10,0,51,49,0
1313,39643,IueU0b60sjtimOacIi9j88xjmyRWizli,G8EPVSXsOYB5YQWZGiz1aVq5Pgr2GrQu,9,8,5,0,3,0,10,0,26,3.7142857142857144,2,0.0,0,5,0,3,8,0,0,10,0,8,18,0
1314,39650,6FzXe5nPWUHRxntREHsQRnp7x1pxuhUz,SpATywNh6bZuzm8s1ceuBUnMUAeoAHHw,15,34,12,10,5,0,6,0,67,9.571428571428571,3,0.0,13,12,10,5,21,0,0,6,0,40,27,0
1315,39665,XZfHeQwgEwa34fwsEe2zig6GAMNgCcPL,SpATywNh6bZuzm8s1ceuBUnMUAeoAHHw,16,48,19,5,9,4,20,1,106,15.142857142857142,3,0.0,11,19,4,9,37,4,1,20,1,43,63,1
1316,39667,eSr3zMoztxzII0MHEvdbKbrYmBK0ecDT,SpATywNh6bZuzm8s1ceuBUnMUAeoAHHw,9,13,6,0,3,2,4,0,28,4.0,2,0.0,0,6,0,3,13,2,0,4,0,9,19,1
1317,39692,s8yyjhcg4BVOip4HSP4txOTTHFJ4aWPU,bWdj2GDclj5ofokWjzoa5jAwMkxCykd6,1,0,0,0,0,0,4,0,4,0.5714285714285714,2,0.0,0,0,0,0,0,0,0,4,0,0,4,1
1318,39696,yvSkslbVS47eGhtXe3MSajZNXyqoO8P1,SpATywNh6bZuzm8s1ceuBUnMUAeoAHHw,16,14,9,12,4,3,9,0,51,7.285714285714286,1,0.0,2,9,11,4,12,3,1,9,0,26,25,1
1319,39708,eHl6vKLwTQcSxYHb6DIMnO9xh3WNvHJf,SpATywNh6bZuzm8s1ceuBUnMUAeoAHHw,14,12,7,8,6,4,4,0,41,5.857142857142857,2,0.0,3,7,8,6,9,4,0,4,0,24,17,0
1320,39712,wVfyl6WgFur5urtfx8TypP7osjiRs72N,SpATywNh6bZuzm8s1ceuBUnMUAeoAHHw,6,3,0,0,0,5,3,0,11,1.5714285714285714,1,0.0,1,0,0,0,2,5,0,3,0,1,10,1
1321,39737,qRawfA1fPOcB5hZkORgH0hm8Ghubmgi1,A3fsA9Zfv1X2fVEQhTw51lKENdNrEqT3,2,0,0,0,0,1,2,0,3,0.42857142857142855,1,0.0,0,0,0,0,0,1,0,2,0,0,3,0
1322,39748,Y6PIDel0N3JB5RPAU8dzX7ZliiFlTqHS,SpATywNh6bZuzm8s1ceuBUnMUAeoAHHw,10,15,0,0,0,2,9,0,26,3.7142857142857144,3,0.0,0,0,0,0,15,2,0,9,0,0,26,1
1323,39750,g6zfMiS5ibUHTabfgiFKHajbGLSVfwvj,SpATywNh6bZuzm8s1ceuBUnMUAeoAHHw,17,27,15,12,3,15,14,1,87,12.428571428571429,3,0.0,6,15,10,3,21,15,2,14,1,34,53,1
1324,39758,wIj7H8utbODHp6xu3FxVq3czUnyCOoPI,A3fsA9Zfv1X2fVEQhTw51lKENdNrEqT3,40,23,13,100,7,2,8,1,154,22.0,1,0.0,6,13,84,7,17,2,16,8,1,110,44,1
1325,39766,Bq3dgySLNxUfP2DnFVHYyEWwaDcd9ALN,A3fsA9Zfv1X2fVEQhTw51lKENdNrEqT3,21,14,10,0,9,0,4,0,37,5.285714285714286,3,0.0,0,10,0,9,14,0,0,4,0,19,18,1
1326,39785,LIcmzVFUc9QeLs85yNk05hYWndHHL2L3,A3fsA9Zfv1X2fVEQhTw51lKENdNrEqT3,10,6,5,0,5,0,4,2,22,3.142857142857143,1,0.0,0,5,0,5,6,0,0,4,2,10,12,1
1327,39793,suOeipVROVXXPGj0VZHJUUTxQ7mEMHZk,A3fsA9Zfv1X2fVEQhTw51lKENdNrEqT3,10,5,4,0,3,0,2,0,14,2.0,1,0.0,0,4,0,3,5,0,0,2,0,7,7,1
1328,39795,ePUeHwknBJGR0K3G08IRIZccLLyuYW03,SpATywNh6bZuzm8s1ceuBUnMUAeoAHHw,2,0,0,0,0,0,2,0,2,0.2857142857142857,1,0.0,0,0,0,0,0,0,0,2,0,0,2,1
1329,39803,VdNVtOVHu3uq36SFu7mu40diveL7bnVd,A3fsA9Zfv1X2fVEQhTw51lKENdNrEqT3,4,2,1,0,1,0,1,0,5,0.7142857142857143,1,0.0,0,1,0,1,2,0,0,1,0,2,3,1
1330,39804,KSzd6DMLdMMhFe5tf0DcSjOsxB002C2u,SpATywNh6bZuzm8s1ceuBUnMUAeoAHHw,9,10,4,0,2,1,15,2,34,4.857142857142857,1,0.0,0,4,0,2,10,1,0,15,2,6,28,1
1331,39840,eTm1NthBlqTXH0yqAhllYK6AeYLcvZS4,SpATywNh6bZuzm8s1ceuBUnMUAeoAHHw,14,16,8,20,4,2,2,0,52,7.428571428571429,3,0.0,3,8,17,4,13,2,3,2,0,32,20,1
1332,39841,9BRoND09uAkQha4X7ED5IFkfUaItyWWP,SpATywNh6bZuzm8s1ceuBUnMUAeoAHHw,4,3,1,0,1,0,1,0,6,0.8571428571428571,1,0.0,1,1,0,1,2,0,0,1,0,3,3,1
1333,39845,xwqLmgu4yZxUsX04FDtQMDL3awvB0E5w,SpATywNh6bZuzm8s1ceuBUnMUAeoAHHw,11,23,9,0,3,0,10,0,45,6.428571428571429,4,0.0,7,9,0,3,16,0,0,10,0,19,26,0
1334,39859,bgVZEKpin3FcOsrwuoniLCnRgCNbZTOm,G8EPVSXsOYB5YQWZGiz1aVq5Pgr2GrQu,17,21,16,30,8,0,4,0,79,11.285714285714286,3,0.0,0,16,24,8,21,0,6,4,0,48,31,1
1335,39878,pLB7K8hva7hpUpPIa0JWEXpoyBHIkbAO,SpATywNh6bZuzm8s1ceuBUnMUAeoAHHw,16,25,11,18,4,5,6,0,69,9.857142857142858,1,0.0,11,11,16,4,14,5,2,6,0,42,27,1
1336,39908,Ubjq3ZPvBATiaU1sX2JibbPoyNs9VBpQ,SpATywNh6bZuzm8s1ceuBUnMUAeoAHHw,1,0,0,0,0,0,1,0,1,0.14285714285714285,1,0.0,0,0,0,0,0,0,0,1,0,0,1,1
1337,39917,ElXKVW194Vk4gMqfG0BJNLqGRaVlSemx,bWdj2GDclj5ofokWjzoa5jAwMkxCykd6,1,0,0,0,0,0,1,0,1,0.14285714285714285,1,0.0,0,0,0,0,0,0,0,1,0,0,1,1
1338,39922,2GATpIfDBYFyTgYmFkr0bda9mVfNXuAl,SpATywNh6bZuzm8s1ceuBUnMUAeoAHHw,11,27,2,12,0,10,7,0,58,8.285714285714286,5,0.0,2,2,12,0,25,10,0,7,0,16,42,0
1339,39939,AVWcvCCDqAG8PgmRAI5YyxSBbxSiVsy5,SpATywNh6bZuzm8s1ceuBUnMUAeoAHHw,4,2,1,0,1,0,1,0,5,0.7142857142857143,1,0.0,0,1,0,1,2,0,0,1,0,2,3,1
1340,39942,ddMTOiTV5HSxEMNnjSDeiKLzuF1YmYcT,SpATywNh6bZuzm8s1ceuBUnMUAeoAHHw,4,3,2,0,0,0,1,0,6,0.8571428571428571,1,0.0,0,2,0,0,3,0,0,1,0,2,4,1
1341,39946,CkKaHAvtocTb1rem1r8BN1SLAQUDW1pY,bWdj2GDclj5ofokWjzoa5jAwMkxCykd6,6,1,1,0,1,1,4,0,8,1.1428571428571428,1,0.0,0,1,0,1,1,1,0,4,0,2,6,1
1342,39958,Peb8kjmFqGQvYDTvo4JTH8WhAEOnPF2h,SpATywNh6bZuzm8s1ceuBUnMUAeoAHHw,15,18,6,9,4,2,4,0,43,6.142857142857143,2,0.0,10,6,8,4,8,2,1,4,0,28,15,1
1343,39962,p3Cz4BAZGaZT08I2Dwew8OwWDC6PUWgc,SpATywNh6bZuzm8s1ceuBUnMUAeoAHHw,14,18,7,5,3,2,4,0,39,5.571428571428571,3,0.0,7,7,5,3,11,2,0,4,0,22,17,1
1344,39979,a3HtyjZsIXy0rlfdz7IVbfqFoPB13M3i,G8EPVSXsOYB5YQWZGiz1aVq5Pgr2GrQu,9,28,2,4,2,0,1,0,37,5.285714285714286,4,0.0,6,2,3,2,22,0,1,1,0,13,24,1
1345,39994,CFP5BToaLlKEM1IV3uFEyj5nP0RKpJGG,A3fsA9Zfv1X2fVEQhTw51lKENdNrEqT3,1,0,0,0,0,0,1,0,1,0.14285714285714285,1,0.0,0,0,0,0,0,0,0,1,0,0,1,1
1346,40026,JlRuZgjmv2hzO83ouspiZFc9FxGockFl,RXDvfPUBYFlVdlueBFbLW0mhhAyGEqpt,11,13,4,0,0,0,3,0,20,2.857142857142857,3,0.0,0,4,0,0,13,0,0,3,0,4,16,1
1347,40036,vUH5NhW2dOJJ7pGM4nFysRqnPlXzFZdY,SpATywNh6bZuzm8s1ceuBUnMUAeoAHHw,11,15,1,13,1,0,2,0,32,4.571428571428571,2,0.0,2,1,11,1,13,0,2,2,0,15,17,0
1348,40067,p2NSaI2ihMq1kpyPoZO7VVEhFNMs1UZl,G8EPVSXsOYB5YQWZGiz1aVq5Pgr2GrQu,41,45,0,223,1,8,18,1,296,42.285714285714285,2,0.0,19,0,184,1,26,8,39,18,1,204,92,0
1349,40073,gT1aUgmAT0anYSW9us4nwhFYETF9WL3j,bWdj2GDclj5ofokWjzoa5jAwMkxCykd6,5,3,1,0,1,0,2,0,7,1.0,1,0.0,1,1,0,1,2,0,0,2,0,3,4,1
1350,40085,QWkN0K04zy6ocvNBygFS9V3b4yJPON6O,A3fsA9Zfv1X2fVEQhTw51lKENdNrEqT3,5,2,1,0,1,0,2,0,6,0.8571428571428571,2,0.0,0,1,0,1,2,0,0,2,0,2,4,1
1351,40097,Rf6xXor9EmVmU5Nrbaea2KpXMtqjkHJb,SpATywNh6bZuzm8s1ceuBUnMUAeoAHHw,14,20,9,22,5,4,2,0,62,8.857142857142858,1,0.0,5,9,18,5,15,4,4,2,0,37,25,0
1352,40105,D2f4XnvAFD8ZIkDvhpGbd6yCstJua9ut,G8EPVSXsOYB5YQWZGiz1aVq5Pgr2GrQu,1,0,0,0,0,0,1,0,1,0.14285714285714285,1,0.0,0,0,0,0,0,0,0,1,0,0,1,1
1353,40112,09EE7Mkw9FE0hqOEryjnyXTu6FbIkdRQ,SpATywNh6bZuzm8s1ceuBUnMUAeoAHHw,7,4,3,0,3,0,2,0,12,1.7142857142857142,2,0.0,0,3,0,3,4,0,0,2,0,6,6,1
1354,40123,KjOosnYqFuW1JYNSfMjuIU0UyjDNXuGi,SpATywNh6bZuzm8s1ceuBUnMUAeoAHHw,7,5,2,0,1,0,3,0,11,1.5714285714285714,2,0.0,1,2,0,1,4,0,0,3,0,4,7,1
1355,40125,znkDmOOvUgN8z7Q2bDidRTpqlGavufFM,SpATywNh6bZuzm8s1ceuBUnMUAeoAHHw,16,42,18,9,7,1,20,6,103,14.714285714285714,6,0.0,2,18,9,7,40,1,0,20,6,36,67,0
1356,40141,ysFko0fUHMpyKjTDsgomHFNCaIAr5cN9,A3fsA9Zfv1X2fVEQhTw51lKENdNrEqT3,1,0,0,0,0,0,1,0,1,0.14285714285714285,1,0.0,0,0,0,0,0,0,0,1,0,0,1,1
1357,40143,OZ02Yntpt8Hg8thsFgejT4NSsPYtVPPm,bWdj2GDclj5ofokWjzoa5jAwMkxCykd6,11,8,3,42,1,5,8,1,68,9.714285714285714,4,0.0,1,3,40,1,7,5,2,8,1,45,23,1
1358,40165,Vcn2Ncl6KVYaVVug7iW4LScBfpTMatic,RXDvfPUBYFlVdlueBFbLW0mhhAyGEqpt,10,23,1,0,1,4,13,1,43,6.142857142857143,2,0.0,5,1,0,1,18,4,0,13,1,7,36,1
1359,40178,JhXfd0Tlc69bJyZdJPZXaAHtjoBDG89W,A3fsA9Zfv1X2fVEQhTw51lKENdNrEqT3,20,37,2,14,1,1,17,1,73,10.428571428571429,4,0.0,5,2,10,1,32,1,4,17,1,18,55,0
1360,40185,abA1IbdNqvgGPTwvaYtddvUoLjzJEWlN,A3fsA9Zfv1X2fVEQhTw51lKENdNrEqT3,36,23,0,52,0,5,14,2,96,13.714285714285714,1,0.0,3,0,49,0,20,5,3,14,2,52,44,1
1361,40192,plUweHzNEQ6tYmm8ypkjZ9ZgEhzpu5iN,SpATywNh6bZuzm8s1ceuBUnMUAeoAHHw,14,14,7,12,3,0,4,0,40,5.714285714285714,2,0.0,2,7,9,3,12,0,3,4,0,21,19,1
1362,40195,8auKgQ1pXJtaAwUgQOq3AnlP8yJ8xKs8,SpATywNh6bZuzm8s1ceuBUnMUAeoAHHw,5,10,1,0,0,0,2,0,13,1.8571428571428572,2,0.0,0,1,0,0,10,0,0,2,0,1,12,1
1363,40206,5HnJOsNDqfUbmuHMu8iG6iEtOPev7Xxw,SpATywNh6bZuzm8s1ceuBUnMUAeoAHHw,6,3,1,0,1,0,3,0,8,1.1428571428571428,2,0.0,0,1,0,1,3,0,0,3,0,2,6,1
1364,40207,mVPS8qtXmBYw6oQCHhHlXYGOl1msXZRm,SpATywNh6bZuzm8s1ceuBUnMUAeoAHHw,15,19,7,18,3,0,2,0,49,7.0,1,0.0,4,7,15,3,15,0,3,2,0,29,20,1
1365,40208,5X4lGySxqBLFYnW7eAhu5WWLC7wvzcF3,A3fsA9Zfv1X2fVEQhTw51lKENdNrEqT3,39,33,15,72,11,0,1,0,132,18.857142857142858,1,0.0,1,15,63,11,32,0,9,1,0,90,42,1
1366,40223,cuLVLzIr2y459RDZRcVR3FYe8DHl8ZjT,SpATywNh6bZuzm8s1ceuBUnMUAeoAHHw,1,0,0,0,0,0,1,0,1,0.14285714285714285,1,0.0,0,0,0,0,0,0,0,1,0,0,1,1
1367,40224,sV3jtFrXfncSgh7Xsq4nWcxj42E0NrUb,SpATywNh6bZuzm8s1ceuBUnMUAeoAHHw,10,12,3,0,4,0,14,0,33,4.714285714285714,4,0.0,0,3,0,4,12,0,0,14,0,7,26,0
1368,40233,tBcWnrptNiGaZgy4k51BltzcKki801j1,bWdj2GDclj5ofokWjzoa5jAwMkxCykd6,1,0,0,0,0,0,1,0,1,0.14285714285714285,1,0.0,0,0,0,0,0,0,0,1,0,0,1,1
1369,40237,tBcWnrptNiGaZgy4k51BltzcKki801j1,A3fsA9Zfv1X2fVEQhTw51lKENdNrEqT3,1,0,0,0,0,0,1,0,1,0.14285714285714285,1,0.0,0,0,0,0,0,0,0,1,0,0,1,1
1370,40243,3LBUjm1FFFdQL8moOjwGZJaqcxdpVPTx,SpATywNh6bZuzm8s1ceuBUnMUAeoAHHw,10,14,1,0,1,4,9,0,29,4.142857142857143,2,0.0,4,1,0,1,10,4,0,9,0,6,23,1
1371,40258,vosTvFxoRyJk1cDtxUw2GTYeGEnrXcMJ,G8EPVSXsOYB5YQWZGiz1aVq5Pgr2GrQu,8,6,2,0,2,0,2,0,12,1.7142857142857142,1,0.0,0,2,0,2,6,0,0,2,0,4,8,0
1372,40272,FWTxDnNzcugqXGOfXWOseyRKl3gd7tL9,SpATywNh6bZuzm8s1ceuBUnMUAeoAHHw,9,12,2,0,1,0,3,0,18,2.5714285714285716,1,0.0,0,2,0,1,12,0,0,3,0,3,15,0
1373,40287,O1a4fHzT6b5r4IWUDa3zddRbshvfRlE4,A3fsA9Zfv1X2fVEQhTw51lKENdNrEqT3,35,21,16,62,2,0,5,0,106,15.142857142857142,2,0.0,2,16,53,2,19,0,9,5,0,73,33,1
1374,40310,qp5IXQZrLJFd9bS1JJL98d9ZDAq70kXN,SpATywNh6bZuzm8s1ceuBUnMUAeoAHHw,15,25,7,29,4,0,2,0,67,9.571428571428571,1,0.0,14,7,23,4,11,0,6,2,0,48,19,1
1375,40317,5FLIDnIga6PY7pJGfcQdTEADTcQg0s9O,G8EPVSXsOYB5YQWZGiz1aVq5Pgr2GrQu,4,2,1,0,0,0,3,0,6,0.8571428571428571,1,0.0,0,1,0,0,2,0,0,3,0,1,5,1
1376,40326,0JjJbtKs8dmrQQZXRwO3ezBCv1FqT0mM,SpATywNh6bZuzm8s1ceuBUnMUAeoAHHw,5,2,1,0,1,0,2,0,6,0.8571428571428571,1,0.0,0,1,0,1,2,0,0,2,0,2,4,1
1377,40330,e8tjBT4TkBUZGDf1oULgV0xlcUpSchNd,SpATywNh6bZuzm8s1ceuBUnMUAeoAHHw,14,37,16,0,6,0,22,2,83,11.857142857142858,4,0.0,3,16,0,6,34,0,0,22,2,25,58,0
1378,40335,xLE9ZE3BmJvIiYogSmZ2Qwy8Pm6jvutZ,SpATywNh6bZuzm8s1ceuBUnMUAeoAHHw,15,39,3,23,1,4,24,0,94,13.428571428571429,5,0.0,13,3,19,1,26,4,4,24,0,36,58,0
1379,40338,xoJqrbCgOTk6mALoHnYupKuyUFnXAEAL,SpATywNh6bZuzm8s1ceuBUnMUAeoAHHw,13,19,1,28,0,1,4,0,53,7.571428571428571,1,0.0,13,1,20,0,6,1,8,4,0,34,19,1
1380,40347,cC2qlM5WjvVF4gXhZ3ctfElOjyJIEAhi,SpATywNh6bZuzm8s1ceuBUnMUAeoAHHw,15,26,11,15,5,14,9,1,81,11.571428571428571,3,0.0,12,11,12,5,14,14,3,9,1,40,41,1
1381,40370,wD600Vm6nYpRlm6dPdneFPtwC1POqb2E,A3fsA9Zfv1X2fVEQhTw51lKENdNrEqT3,1,0,0,0,0,0,1,0,1,0.14285714285714285,1,0.0,0,0,0,0,0,0,0,1,0,0,1,1
1382,40385,uuGoGterx4QfmHoDE6WqQfMDG8gm4WOd,SpATywNh6bZuzm8s1ceuBUnMUAeoAHHw,6,4,3,0,2,0,2,0,11,1.5714285714285714,2,0.0,0,3,0,2,4,0,0,2,0,5,6,1
1383,40388,ZuoiR8ZSgQ4EIp0UPK1kvYAuneCl6lTF,G8EPVSXsOYB5YQWZGiz1aVq5Pgr2GrQu,18,23,4,24,4,0,1,0,56,8.0,1,0.0,18,4,13,4,5,0,11,1,0,39,17,1
1384,40392,zT5Abo7SNHsAkCFKMvhJJJDWNu2sl4mh,SpATywNh6bZuzm8s1ceuBUnMUAeoAHHw,12,28,9,11,0,3,18,1,70,10.0,5,0.0,12,9,10,0,16,3,1,18,1,31,39,0
1385,40395,55BMoXCnWKUmNoRDU7bcdmqWNuK9JpZ6,bWdj2GDclj5ofokWjzoa5jAwMkxCykd6,9,10,0,20,1,7,7,2,47,6.714285714285714,2,0.0,4,0,20,1,6,7,0,7,2,25,22,1
1386,40403,Anr82PPgHyVjFu2RaZRNpr3IKYwAUnAW,SpATywNh6bZuzm8s1ceuBUnMUAeoAHHw,5,7,4,0,1,0,2,0,14,2.0,1,0.0,0,4,0,1,7,0,0,2,0,5,9,1
1387,40410,lkFGShqBa18inWINppsv8Kl48gyf85dR,bWdj2GDclj5ofokWjzoa5jAwMkxCykd6,12,23,10,40,8,7,2,0,90,12.857142857142858,1,0.0,9,10,37,8,14,7,3,2,0,64,26,1
1388,40416,0Cx8S0i9vAPm7jZ8jXLUkrYp9xGpIHIS,bWdj2GDclj5ofokWjzoa5jAwMkxCykd6,3,2,1,0,0,0,2,0,5,0.7142857142857143,2,0.0,0,1,0,0,2,0,0,2,0,1,4,1
1389,40422,D35qeoxZpbN67fSLA7wfpVWpoAtTKXOD,SpATywNh6bZuzm8s1ceuBUnMUAeoAHHw,13,12,8,5,5,3,3,0,36,5.142857142857143,1,0.0,2,8,5,5,10,3,0,3,0,20,16,1
1390,40425,JuFQ1S3Curjho2OVO8cP3KLv8ROaeaOy,G8EPVSXsOYB5YQWZGiz1aVq5Pgr2GrQu,18,12,7,20,5,0,1,0,45,6.428571428571429,1,0.0,4,7,20,5,8,0,0,1,0,36,9,1
1391,40428,RSvPQSF8RarDsP4aI3ftScWWjvINqjc5,A3fsA9Zfv1X2fVEQhTw51lKENdNrEqT3,4,8,4,0,3,0,1,0,16,2.2857142857142856,3,0.0,0,4,0,3,8,0,0,1,0,7,9,1
1392,40433,fVDgOkqeY2Y5uks1gBAvSdrqz781Wr7g,SpATywNh6bZuzm8s1ceuBUnMUAeoAHHw,7,8,4,0,3,0,4,0,19,2.7142857142857144,1,0.0,1,4,0,3,7,0,0,4,0,8,11,1
1393,40441,b11C6Y0UpRSFGpKvHTlz5TF2Rt9ScBoX,SpATywNh6bZuzm8s1ceuBUnMUAeoAHHw,7,5,2,0,1,0,8,1,17,2.4285714285714284,2,0.0,2,2,0,1,3,0,0,8,1,5,12,0
1394,40462,9hqCAq1z2NOCYAE7PjnGwKxGA9KHvl0W,A3fsA9Zfv1X2fVEQhTw51lKENdNrEqT3,10,5,0,0,0,2,8,1,16,2.2857142857142856,1,0.0,0,0,0,0,5,2,0,8,1,0,16,1
1395,40502,PzBfPYmnOZYwUEXwnCaNraevSYiEicsw,G8EPVSXsOYB5YQWZGiz1aVq5Pgr2GrQu,10,11,6,0,1,2,10,2,32,4.571428571428571,1,0.0,1,6,0,1,10,2,0,10,2,8,24,1
1396,40509,Hz1gD3xapoX9NB1k77xvttI5SLCsWFqX,A3fsA9Zfv1X2fVEQhTw51lKENdNrEqT3,5,3,1,0,0,1,3,0,8,1.1428571428571428,1,0.0,0,1,0,0,3,1,0,3,0,1,7,1
1397,40537,KUjjznPFpWdBg0GS5p0fa4zyp2j0nULG,A3fsA9Zfv1X2fVEQhTw51lKENdNrEqT3,5,2,1,0,1,0,2,0,6,0.8571428571428571,1,0.0,0,1,0,1,2,0,0,2,0,2,4,1
1398,40584,mC2fzvwPaO34Kq32ibCwzrJ2EjHwbRrb,RXDvfPUBYFlVdlueBFbLW0mhhAyGEqpt,20,35,19,19,7,0,4,0,84,12.0,2,0.0,9,19,17,7,26,0,2,4,0,52,32,1
1399,40602,TxbcY6S66ftou9eniDMFpBcA0Q86cCVI,SpATywNh6bZuzm8s1ceuBUnMUAeoAHHw,1,0,0,0,0,0,1,0,1,0.14285714285714285,1,0.0,0,0,0,0,0,0,0,1,0,0,1,1
1400,40605,MiPYsLH8kYorLuTY5qJyDrWlYhyksO0w,bWdj2GDclj5ofokWjzoa5jAwMkxCykd6,1,0,0,0,0,0,1,0,1,0.14285714285714285,1,0.0,0,0,0,0,0,0,0,1,0,0,1,1
1401,40607,MiPYsLH8kYorLuTY5qJyDrWlYhyksO0w,A3fsA9Zfv1X2fVEQhTw51lKENdNrEqT3,15,21,1,2,1,0,13,0,38,5.428571428571429,2,0.0,0,1,2,1,21,0,0,13,0,4,34,1
1402,40643,4hVUUGEGYiw6Bdgp8UlEBQC8ko8eVYqV,SpATywNh6bZuzm8s1ceuBUnMUAeoAHHw,6,3,1,0,1,0,2,0,7,1.0,1,0.0,0,1,0,1,3,0,0,2,0,2,5,1
1403,40648,zUbaOnwFf34fsU2q7dIMt7fpEzRZebx6,SpATywNh6bZuzm8s1ceuBUnMUAeoAHHw,5,7,3,0,2,0,1,0,13,1.8571428571428572,1,0.0,3,3,0,2,4,0,0,1,0,8,5,1
1404,40662,C1sQeK9WfNApOsknFeDtbZSozuem8vKZ,A3fsA9Zfv1X2fVEQhTw51lKENdNrEqT3,5,2,1,0,1,0,3,0,7,1.0,1,0.0,0,1,0,1,2,0,0,3,0,2,5,1
1405,40664,oGGlzK2ht4ljgfC5PRL55MAob4FKnRhp,bWdj2GDclj5ofokWjzoa5jAwMkxCykd6,2,0,0,0,0,0,2,0,2,0.2857142857142857,1,0.0,0,0,0,0,0,0,0,2,0,0,2,1
1406,40667,oGGlzK2ht4ljgfC5PRL55MAob4FKnRhp,A3fsA9Zfv1X2fVEQhTw51lKENdNrEqT3,2,0,0,0,0,0,2,0,2,0.2857142857142857,1,0.0,0,0,0,0,0,0,0,2,0,0,2,1
1407,40702,eulwUG3HQzG3rg0A6GIWynY1beyNKKbn,SpATywNh6bZuzm8s1ceuBUnMUAeoAHHw,13,23,9,13,6,0,4,0,55,7.857142857142857,3,0.0,3,9,11,6,20,0,2,4,0,29,26,1
1408,40704,qmYTrueiQKfoQnGxjqfwlMlw7HOR9CKj,bWdj2GDclj5ofokWjzoa5jAwMkxCykd6,7,4,0,0,0,12,10,0,26,3.7142857142857144,3,0.0,0,0,0,0,4,12,0,10,0,0,26,0
1409,40726,Y4FZdizgCfP48VyOuflC2D2a2JpAW4dz,G8EPVSXsOYB5YQWZGiz1aVq5Pgr2GrQu,6,2,1,0,1,0,3,0,7,1.0,1,0.0,0,1,0,1,2,0,0,3,0,2,5,1
1410,40737,G9SE33A9SwXRkrAwDpEWoUsFMADETyBJ,SpATywNh6bZuzm8s1ceuBUnMUAeoAHHw,2,0,0,0,0,0,3,0,3,0.42857142857142855,1,0.0,0,0,0,0,0,0,0,3,0,0,3,1
1411,40746,l7T8dOWG1cEtOxAxVcD5zNV6vn1g4oYM,bWdj2GDclj5ofokWjzoa5jAwMkxCykd6,2,0,0,0,0,0,4,0,4,0.5714285714285714,2,0.0,0,0,0,0,0,0,0,4,0,0,4,1
1412,40749,1UUWIp3PiN0CT0O96IXxrt6TRVFJmFUz,A3fsA9Zfv1X2fVEQhTw51lKENdNrEqT3,7,1,0,0,0,2,9,2,14,2.0,1,0.0,0,0,0,0,1,2,0,9,2,0,14,1
1413,40761,1Pk7jZ6bfmKYXcNnRyEd7kPSZWAEJN0N,A3fsA9Zfv1X2fVEQhTw51lKENdNrEqT3,1,0,0,0,0,0,1,0,1,0.14285714285714285,1,0.0,0,0,0,0,0,0,0,1,0,0,1,1
1414,40768,NlHO5hXiy7TmVTHiRgExH6y7p9gJG1YF,SpATywNh6bZuzm8s1ceuBUnMUAeoAHHw,15,14,6,23,3,0,3,0,49,7.0,2,0.0,5,6,19,3,9,0,4,3,0,33,16,1
1415,40780,EO0fRulUc32LbMOOGfwwNWyNgnF8pKY9,RXDvfPUBYFlVdlueBFbLW0mhhAyGEqpt,22,17,11,14,5,3,10,5,65,9.285714285714286,3,0.0,1,11,11,5,16,3,3,10,5,28,37,1
1416,40782,eEl2lnEvtyQyZa1YqA2JcBHBfdkh8SHK,SpATywNh6bZuzm8s1ceuBUnMUAeoAHHw,9,17,1,0,1,0,4,0,23,3.2857142857142856,3,0.0,1,1,0,1,16,0,0,4,0,3,20,1
1417,40802,DFKzgJXlXxnZVHESIM4fYC543XX9ZfDV,SpATywNh6bZuzm8s1ceuBUnMUAeoAHHw,10,6,4,0,3,0,4,0,17,2.4285714285714284,3,0.0,0,4,0,3,6,0,0,4,0,7,10,1
1418,40823,BXn2aG9clWntQARvXpqDawWoxN1Iz4WO,A3fsA9Zfv1X2fVEQhTw51lKENdNrEqT3,20,27,13,0,8,0,7,0,55,7.857142857142857,4,0.0,0,13,0,8,27,0,0,7,0,21,34,1
1419,40824,0NGZq9HZW5KOrSfzSGGipuN20pCRDMWu,A3fsA9Zfv1X2fVEQhTw51lKENdNrEqT3,9,8,1,0,1,0,2,0,12,1.7142857142857142,1,0.0,0,1,0,1,8,0,0,2,0,2,10,1
1420,40835,pwTSmyT1ONwSAvUKrgRYh4Mr4sMKfCZD,SpATywNh6bZuzm8s1ceuBUnMUAeoAHHw,1,0,0,0,0,0,1,0,1,0.14285714285714285,1,0.0,0,0,0,0,0,0,0,1,0,0,1,1
1421,40857,9VkUnpQ2wwfpxrKU7ACzLosNtkitvYWk,bWdj2GDclj5ofokWjzoa5jAwMkxCykd6,9,14,0,62,0,3,2,0,81,11.571428571428571,3,0.0,3,0,58,0,11,3,4,2,0,61,20,1
1422,40867,rV9ZZTHmhxb84QCeG9gPkzE5xk42RTz0,SpATywNh6bZuzm8s1ceuBUnMUAeoAHHw,14,16,1,15,0,1,7,1,41,5.857142857142857,2,0.0,6,1,13,0,10,1,2,7,1,20,21,1
1423,40869,8gfCGxZ6lFjZr89RwPF8oXZs1Qn6Pq6X,A3fsA9Zfv1X2fVEQhTw51lKENdNrEqT3,17,1,1,46,0,0,5,0,53,7.571428571428571,2,0.0,0,1,41,0,1,0,5,5,0,42,11,1
1424,40896,o4j0NDzLh6XqpDKcvRg8Lx9N4HUYeTuP,RXDvfPUBYFlVdlueBFbLW0mhhAyGEqpt,1,0,0,0,0,0,1,0,1,0.14285714285714285,1,0.0,0,0,0,0,0,0,0,1,0,0,1,1
1425,40900,f6iCNPPMIJtA2FTvaT2H53upAxoDRLhb,SpATywNh6bZuzm8s1ceuBUnMUAeoAHHw,10,20,7,0,1,1,10,1,40,5.714285714285714,2,0.0,3,7,0,1,17,1,0,10,1,11,29,1
1426,40938,DJeWlgB4cP1RQ3JZLa1wZwd4zgAbYOxv,A3fsA9Zfv1X2fVEQhTw51lKENdNrEqT3,1,0,0,0,0,0,1,0,1,0.14285714285714285,1,0.0,0,0,0,0,0,0,0,1,0,0,1,1
1427,40940,qMeUlyVNhm3N1xROQ1pyK2NlohyIqF1x,G8EPVSXsOYB5YQWZGiz1aVq5Pgr2GrQu,1,0,0,0,0,0,1,0,1,0.14285714285714285,1,0.0,0,0,0,0,0,0,0,1,0,0,1,1
1428,40951,ah2KXEU3IJN3pCxNzFybzDR3Qrtpz7ty,SpATywNh6bZuzm8s1ceuBUnMUAeoAHHw,1,0,0,0,0,0,1,0,1,0.14285714285714285,1,0.0,0,0,0,0,0,0,0,1,0,0,1,1
1429,40964,gnxZfu6FrSp4wr4QPorHabuGoagxpXKv,SpATywNh6bZuzm8s1ceuBUnMUAeoAHHw,1,0,0,0,0,0,1,0,1,0.14285714285714285,1,0.0,0,0,0,0,0,0,0,1,0,0,1,1
1430,40966,xHfGdYj0sYZXXCzkQp0eF5wBXW7C2C6R,A3fsA9Zfv1X2fVEQhTw51lKENdNrEqT3,5,2,1,0,1,0,3,0,7,1.0,1,0.0,0,1,0,1,2,0,0,3,0,2,5,1
1431,40973,BasnDhJkjNSRVUOCCIoBniAgNajwACiL,SpATywNh6bZuzm8s1ceuBUnMUAeoAHHw,12,23,1,15,0,0,5,0,44,6.285714285714286,1,0.0,10,1,15,0,13,0,0,5,0,26,18,0
1432,40979,zeUi2UnQZPPF6bRQXw2s8LZ41ZOdqRAa,G8EPVSXsOYB5YQWZGiz1aVq5Pgr2GrQu,8,9,6,0,2,1,3,0,21,3.0,2,0.0,0,6,0,2,9,1,0,3,0,8,13,1
1433,40982,4IpWwTUOGPzGOpKLy9nKXcEDTyxApVd3,G8EPVSXsOYB5YQWZGiz1aVq5Pgr2GrQu,1,0,0,0,0,0,1,0,1,0.14285714285714285,1,0.0,0,0,0,0,0,0,0,1,0,0,1,1
1434,40984,xvXNoM4EBB4fcdWfVRuECibdILksVZE5,SpATywNh6bZuzm8s1ceuBUnMUAeoAHHw,4,2,0,0,0,0,3,0,5,0.7142857142857143,1,0.0,0,0,0,0,2,0,0,3,0,0,5,1
1435,40986,ikVmCxeXCKQtR8OPUUdHoGQCjATpEVdj,SpATywNh6bZuzm8s1ceuBUnMUAeoAHHw,14,17,9,15,5,0,2,0,48,6.857142857142857,3,0.0,7,9,13,5,10,0,2,2,0,34,14,1
1436,40991,WPAkKut2lu615mRXcePqeHjf7ZV10lWd,SpATywNh6bZuzm8s1ceuBUnMUAeoAHHw,13,14,9,10,4,0,2,0,39,5.571428571428571,3,0.0,2,9,9,4,12,0,1,2,0,24,15,1
1437,41120,XpdeGVr67ypvPB6NlvDXEjF8wDCu5FS9,7GRhBDsirIGkRZBtSMEzNTyDr2JQm4xx,1,0,0,0,0,0,1,0,1,0.14285714285714285,1,0.0,0,0,0,0,0,0,0,1,0,0,1,1
1438,41424,Gn1QSm7WrSyhbej7tThohiyBKeBu1xtD,7GRhBDsirIGkRZBtSMEzNTyDr2JQm4xx,32,41,17,66,11,0,9,0,144,20.571428571428573,5,0.0,18,17,56,11,23,0,10,9,0,102,42,0
1439,41589,JXidMLGzH1hCHEXJsiJMrwBekkp4L4vD,7GRhBDsirIGkRZBtSMEzNTyDr2JQm4xx,12,10,5,8,3,0,5,0,31,4.428571428571429,2,0.0,2,5,6,3,8,0,2,5,0,16,15,1
1440,41805,kuZwBvEdgeUtKZ495C2FptBbxEtLtmVH,7GRhBDsirIGkRZBtSMEzNTyDr2JQm4xx,1,0,0,0,0,0,1,0,1,0.14285714285714285,1,0.0,0,0,0,0,0,0,0,1,0,0,1,1
1441,43653,79QUI05RY9ZPkyZ2QTF4ldf0I0DmjbaG,7GRhBDsirIGkRZBtSMEzNTyDr2JQm4xx,17,54,28,0,3,8,18,0,111,15.857142857142858,2,0.0,9,28,0,3,45,8,0,18,0,40,71,1
1442,43672,tCqgfXrL2rXAh5RJpLuMHSLSRwrclyuQ,7GRhBDsirIGkRZBtSMEzNTyDr2JQm4xx,27,109,33,58,19,15,11,0,245,35.0,4,0.0,42,33,46,19,67,15,12,11,0,140,105,0
1443,43685,Up0igPeMCPcrrFPZ1HsfM8Bq5rwAfYwv,7GRhBDsirIGkRZBtSMEzNTyDr2JQm4xx,2,0,0,0,0,0,2,0,2,0.2857142857142857,1,0.0,0,0,0,0,0,0,0,2,0,0,2,0
1444,43700,z4NoXHrcgkhn7BypZflRO6Tgobh52UXj,7GRhBDsirIGkRZBtSMEzNTyDr2JQm4xx,9,11,4,4,0,0,3,0,22,3.142857142857143,1,0.0,2,4,4,0,9,0,0,3,0,10,12,0
1445,43732,0OpVcmwG6bVPxKzOCpgJ9F6MfBtuGolr,7GRhBDsirIGkRZBtSMEzNTyDr2JQm4xx,1,0,0,0,0,0,1,0,1,0.14285714285714285,1,0.0,0,0,0,0,0,0,0,1,0,0,1,1
1446,43991,i936MfG3syIHVH4tehF88pJA63b8Vu78,fbPkOYLVPtPgIt0MxizjfFJov3JbHyAi,9,4,2,0,2,3,6,3,20,2.857142857142857,1,0.0,0,2,0,2,4,3,0,6,3,4,16,1
1447,43992,6UtqqjImjevYXkMdkukuwyWXLWcDEFFu,fbPkOYLVPtPgIt0MxizjfFJov3JbHyAi,11,29,11,6,9,5,13,2,75,10.714285714285714,2,0.0,4,11,4,9,25,5,2,13,2,28,47,1
1448,43998,e19ZEr9Yh5ILe0m8l9rWehMDuEWywMUJ,fbPkOYLVPtPgIt0MxizjfFJov3JbHyAi,1,0,0,0,0,0,1,0,1,0.14285714285714285,1,0.0,0,0,0,0,0,0,0,1,0,0,1,1
1449,44007,oPl0NnurlzpABskP5WrrITS0Jx7a7lgG,fbPkOYLVPtPgIt0MxizjfFJov3JbHyAi,9,12,6,0,6,0,5,1,30,4.285714285714286,1,0.0,4,6,0,6,8,0,0,5,1,16,14,1
1450,44008,uISGM4LqBUfXPHskRZuSs9XeQkD4VUeT,fbPkOYLVPtPgIt0MxizjfFJov3JbHyAi,16,29,16,6,6,36,16,1,110,15.714285714285714,3,0.0,5,16,5,6,24,36,1,16,1,32,78,1
1451,44009,inUZ2nCJKLY6kdHcpjk8OuyitRFog1f3,fbPkOYLVPtPgIt0MxizjfFJov3JbHyAi,3,2,0,0,0,0,2,0,4,0.5714285714285714,1,0.0,0,0,0,0,2,0,0,2,0,0,4,1
1452,44010,DQ9W5Vuawh3t7n6xTYzvjArLiUFtCoJH,fbPkOYLVPtPgIt0MxizjfFJov3JbHyAi,8,3,2,0,2,0,3,0,10,1.4285714285714286,1,0.0,0,2,0,2,3,0,0,3,0,4,6,1
1453,44012,3ovcvN6GJrfjQxnw4eUnC7Zf5NE35SVV,fbPkOYLVPtPgIt0MxizjfFJov3JbHyAi,4,2,0,0,0,2,6,0,10,1.4285714285714286,1,0.0,0,0,0,0,2,2,0,6,0,0,10,1
1454,44015,NHPpKvbnrSpxM8e1DORBWJbRCpmrxZw8,fbPkOYLVPtPgIt0MxizjfFJov3JbHyAi,8,11,6,0,5,42,5,0,69,9.857142857142858,2,0.0,2,6,0,5,9,42,0,5,0,13,56,1
1455,44017,axLHybd4Fc2iEZmnM9YqehKaeSBFTLUD,fbPkOYLVPtPgIt0MxizjfFJov3JbHyAi,2,0,0,0,0,0,2,0,2,0.2857142857142857,1,0.0,0,0,0,0,0,0,0,2,0,0,2,1
1456,44019,Oqf2KMc671oV8Cn8nfq2WN2xhEjMkCKi,fbPkOYLVPtPgIt0MxizjfFJov3JbHyAi,4,2,1,0,0,5,2,0,10,1.4285714285714286,1,0.0,0,1,0,0,2,5,0,2,0,1,9,1
1457,44021,9XnnqdyPvtBGS8L2kTzLO0S9Zq2a4kse,fbPkOYLVPtPgIt0MxizjfFJov3JbHyAi,4,5,0,0,0,0,1,0,6,0.8571428571428571,1,0.0,0,0,0,0,5,0,0,1,0,0,6,1
1458,44024,LeyaS1WvDVnHnV6ZSeQmCJao8bkVjN1j,fbPkOYLVPtPgIt0MxizjfFJov3JbHyAi,9,5,4,0,3,0,8,0,20,2.857142857142857,1,0.0,0,4,0,3,5,0,0,8,0,7,13,1
1459,44027,yfYI5syGDPun1q5rrD5IBdKLVoUhhItT,fbPkOYLVPtPgIt0MxizjfFJov3JbHyAi,11,5,4,0,4,0,4,0,17,2.4285714285714284,1,0.0,0,4,0,4,5,0,0,4,0,8,9,1
1460,44028,1brUgjk7oe1eohq9hpdKTnGa8wSkRKBL,fbPkOYLVPtPgIt0MxizjfFJov3JbHyAi,7,2,1,0,1,1,4,1,10,1.4285714285714286,1,0.0,0,1,0,1,2,1,0,4,1,2,8,1
1461,44032,g4BqtfArPu1P6dUgMW0j2r9GyrSqWjFl,fbPkOYLVPtPgIt0MxizjfFJov3JbHyAi,5,0,0,0,0,1,8,1,10,1.4285714285714286,1,0.0,0,0,0,0,0,1,0,8,1,0,10,1
1462,44034,qWEVgbmp31Yz7gV3k18he9mUiT0ZSaYx,fbPkOYLVPtPgIt0MxizjfFJov3JbHyAi,7,9,3,0,5,4,4,0,25,3.5714285714285716,1,0.0,4,3,0,5,5,4,0,4,0,12,13,1
1463,44036,jdE4Va4LkoFtXkdUlWOZzY1NPPK6qDDa,fbPkOYLVPtPgIt0MxizjfFJov3JbHyAi,9,3,2,0,2,1,8,1,17,2.4285714285714284,1,0.0,0,2,0,2,3,1,0,8,1,4,13,1
1464,44040,Rbjg9UrMjdBRLHwge6hMq2hF3DaLKFjG,fbPkOYLVPtPgIt0MxizjfFJov3JbHyAi,11,14,3,4,7,15,22,2,67,9.571428571428571,1,0.0,10,3,3,7,4,15,1,22,2,23,44,1
1465,44041,sg4VVv9cgk6nt80dZvUKhL5H7RMgLm0l,fbPkOYLVPtPgIt0MxizjfFJov3JbHyAi,9,9,6,0,3,8,3,0,29,4.142857142857143,2,0.0,1,6,0,3,8,8,0,3,0,10,19,1
1466,44044,h6WpsYrDbnnoeExgTZXkYo7GgIA3j8KF,fbPkOYLVPtPgIt0MxizjfFJov3JbHyAi,10,10,5,0,4,0,6,0,25,3.5714285714285716,1,0.0,3,5,0,4,7,0,0,6,0,12,13,1
1467,44046,76y1AbpXIG79W81ou4lYi6BwTmlPjyTW,fbPkOYLVPtPgIt0MxizjfFJov3JbHyAi,5,2,1,0,1,1,2,0,7,1.0,1,0.0,0,1,0,1,2,1,0,2,0,2,5,1
1468,44049,SnBsSMsyPBAPsHuU9YoDtuue1sZbKZBQ,fbPkOYLVPtPgIt0MxizjfFJov3JbHyAi,5,0,0,0,0,0,8,1,9,1.2857142857142858,2,0.0,0,0,0,0,0,0,0,8,1,0,9,1
1469,44052,BIBVHKjUSrjc5BHdvfhhLGTavi1WeSbD,fbPkOYLVPtPgIt0MxizjfFJov3JbHyAi,12,6,3,0,3,1,5,1,19,2.7142857142857144,1,0.0,1,3,0,3,5,1,0,5,1,7,12,1
1470,44054,nkBKSO0ZKz2Wst869GlQp6mO590hIJEZ,fbPkOYLVPtPgIt0MxizjfFJov3JbHyAi,1,0,0,0,0,0,1,0,1,0.14285714285714285,1,0.0,0,0,0,0,0,0,0,1,0,0,1,1
1471,44057,ZEbYOmWwQ4Xr4MxJtDQOJ8jnLIcd8Z5c,fbPkOYLVPtPgIt0MxizjfFJov3JbHyAi,5,2,1,0,1,0,2,0,6,0.8571428571428571,1,0.0,0,1,0,1,2,0,0,2,0,2,4,1
1472,44058,4ZVrwOJI0OZGv0iKNXpa2OrPWHTNPSKw,fbPkOYLVPtPgIt0MxizjfFJov3JbHyAi,7,5,3,0,2,3,2,0,15,2.142857142857143,1,0.0,0,3,0,2,5,3,0,2,0,5,10,1
1473,44060,HCuNeFLBULV55TbURLgBOnM01N7eaTIk,fbPkOYLVPtPgIt0MxizjfFJov3JbHyAi,8,19,10,0,8,5,24,0,66,9.428571428571429,2,0.0,0,10,0,8,19,5,0,24,0,18,48,1
1474,44062,eFC0KaZbDiJdIgbG1CR6r5jTa1z0727j,fbPkOYLVPtPgIt0MxizjfFJov3JbHyAi,11,18,11,10,9,0,5,0,53,7.571428571428571,2,0.0,3,11,7,9,15,0,3,5,0,30,23,0
1475,44063,l8chSgqUsX2ezoBZ8RO3OXA3HMPgq6Xo,fbPkOYLVPtPgIt0MxizjfFJov3JbHyAi,5,3,1,0,1,0,1,0,6,0.8571428571428571,1,0.0,0,1,0,1,3,0,0,1,0,2,4,1
1476,44069,sZ59BwHHS40O9b1LKGG4hE0LdlqpaIwv,fbPkOYLVPtPgIt0MxizjfFJov3JbHyAi,17,8,7,0,7,0,3,0,25,3.5714285714285716,1,0.0,0,7,0,7,8,0,0,3,0,14,11,1
1477,44070,eQaWyowDKjzkRJdrveWWiGAaGDkIAln1,fbPkOYLVPtPgIt0MxizjfFJov3JbHyAi,7,6,3,0,4,0,2,0,15,2.142857142857143,1,0.0,2,3,0,4,4,0,0,2,0,9,6,1
1478,44071,ZAJHLqPx7azIGtI8JwkpIz4DspMCXCFT,fbPkOYLVPtPgIt0MxizjfFJov3JbHyAi,1,0,0,0,0,0,1,0,1,0.14285714285714285,1,0.0,0,0,0,0,0,0,0,1,0,0,1,1
1479,44072,xCjpMcUUR38rFwI6LVi9moe3PuSjGvgc,fbPkOYLVPtPgIt0MxizjfFJov3JbHyAi,4,2,1,0,1,0,1,0,5,0.7142857142857143,1,0.0,0,1,0,1,2,0,0,1,0,2,3,1
1480,44076,R134yB2E94tOXCDag3zVHNWrBuFFRNfi,fbPkOYLVPtPgIt0MxizjfFJov3JbHyAi,6,3,2,0,2,0,1,0,8,1.1428571428571428,1,0.0,0,2,0,2,3,0,0,1,0,4,4,1
1481,44079,L5pA3H7m2qYFia4DHW15gmoKoflabQUC,fbPkOYLVPtPgIt0MxizjfFJov3JbHyAi,9,7,4,0,3,3,7,1,25,3.5714285714285716,1,0.0,1,4,0,3,6,3,0,7,1,8,17,1
1482,44081,yRofSAhoibifpAqTO7qW5tQEYNWfWlsG,fbPkOYLVPtPgIt0MxizjfFJov3JbHyAi,10,19,4,0,3,0,10,1,37,5.285714285714286,2,0.0,13,4,0,3,6,0,0,10,1,20,17,1
1483,44083,KSfQPUyfWWfWDmmi6m3KXcKzxz89wkwt,fbPkOYLVPtPgIt0MxizjfFJov3JbHyAi,1,0,0,0,0,0,1,0,1,0.14285714285714285,1,0.0,0,0,0,0,0,0,0,1,0,0,1,1
1484,44084,kk72YEo7gxDpJjFfV60A1en59PCJ8Z09,fbPkOYLVPtPgIt0MxizjfFJov3JbHyAi,7,6,3,0,1,7,6,1,24,3.4285714285714284,1,0.0,0,3,0,1,6,7,0,6,1,4,20,1
1485,44093,9lvfANZJ7eXEtCdLExkxtGg3Vbd7Wyxt,fbPkOYLVPtPgIt0MxizjfFJov3JbHyAi,6,2,1,0,0,11,5,1,20,2.857142857142857,1,0.0,0,1,0,0,2,11,0,5,1,1,19,1
1486,44095,o61d02uP0OX8m0Pmj3Zu4on4UaOcYPIz,fbPkOYLVPtPgIt0MxizjfFJov3JbHyAi,13,8,5,3,3,3,5,2,29,4.142857142857143,2,0.0,1,5,2,3,7,3,1,5,2,11,18,0
1487,44097,2OnGZLO6PGk0y08tYvyYb6lXWyUABkGv,fbPkOYLVPtPgIt0MxizjfFJov3JbHyAi,9,8,4,0,3,0,6,2,23,3.2857142857142856,1,0.0,0,4,0,3,8,0,0,6,2,7,16,1
1488,44102,WpYtemwKZQxcuLGpndx0lQojfh6o5GOv,fbPkOYLVPtPgIt0MxizjfFJov3JbHyAi,4,4,0,0,0,0,1,0,5,0.7142857142857143,1,0.0,0,0,0,0,4,0,0,1,0,0,5,1
1489,44111,nWTDOg4ZYpkavWBGTPbOIHQSMseHgPvt,fbPkOYLVPtPgIt0MxizjfFJov3JbHyAi,8,4,2,0,2,0,3,0,11,1.5714285714285714,1,0.0,0,2,0,2,4,0,0,3,0,4,7,1
1490,44112,CKlck1NtRiTrxKTlx9u8mNsXnR4Cg2LR,fbPkOYLVPtPgIt0MxizjfFJov3JbHyAi,9,10,5,0,2,4,8,1,30,4.285714285714286,1,0.0,2,5,0,2,8,4,0,8,1,9,21,1
1491,44115,rQagJMIJxMWHybJu2qCbngkHoaC1bCF5,fbPkOYLVPtPgIt0MxizjfFJov3JbHyAi,2,0,0,0,0,0,2,0,2,0.2857142857142857,1,0.0,0,0,0,0,0,0,0,2,0,0,2,1
1492,44118,GmEmBf7c8vVD8NQKlYsc3CbTgcWxYLfx,fbPkOYLVPtPgIt0MxizjfFJov3JbHyAi,4,4,2,0,2,0,1,0,9,1.2857142857142858,1,0.0,0,2,0,2,4,0,0,1,0,4,5,1
1493,44119,hp1PeKFcESsUtrkTKF98ATmX1KKCPvia,fbPkOYLVPtPgIt0MxizjfFJov3JbHyAi,4,6,0,0,0,1,1,0,8,1.1428571428571428,1,0.0,0,0,0,0,6,1,0,1,0,0,8,0
1494,44122,bYjPoNbc5ILh7K7s9YR8HLOMNJGN6Ums,fbPkOYLVPtPgIt0MxizjfFJov3JbHyAi,9,5,4,0,4,1,2,0,16,2.2857142857142856,1,0.0,0,4,0,4,5,1,0,2,0,8,8,1
1495,44123,xl4s40OnU4HrS2dTDEZu2keSj0YY1fmn,fbPkOYLVPtPgIt0MxizjfFJov3JbHyAi,11,25,16,0,8,17,7,1,74,10.571428571428571,3,0.0,0,16,0,8,25,17,0,7,1,24,50,1
1496,44131,dzaUNwKZy91BtYj96fOhuSgIlp9lXQDU,fbPkOYLVPtPgIt0MxizjfFJov3JbHyAi,4,2,1,0,1,6,2,0,12,1.7142857142857142,2,0.0,0,1,0,1,2,6,0,2,0,2,10,0
1497,44133,0bPKxjIIw0GaiIYeAS2yIr8ZqMELBNL4,fbPkOYLVPtPgIt0MxizjfFJov3JbHyAi,6,11,4,0,0,0,1,0,16,2.2857142857142856,1,0.0,3,4,0,0,8,0,0,1,0,7,9,1
1498,44134,aTtRtpFY1HDjnosUur6O1bYAGBELKNkH,fbPkOYLVPtPgIt0MxizjfFJov3JbHyAi,1,0,0,0,0,0,1,0,1,0.14285714285714285,1,0.0,0,0,0,0,0,0,0,1,0,0,1,1
1499,44135,ZD66lyh6v0XhCV6q1X0pQAccOqFGi52W,fbPkOYLVPtPgIt0MxizjfFJov3JbHyAi,3,2,0,0,0,0,1,0,3,0.42857142857142855,1,0.0,0,0,0,0,2,0,0,1,0,0,3,1
1500,44139,9CGgLBDhAl2a4vPzbTBoeDjYbqCZREDz,fbPkOYLVPtPgIt0MxizjfFJov3JbHyAi,6,5,3,0,3,0,1,0,12,1.7142857142857142,1,0.0,0,3,0,3,5,0,0,1,0,6,6,1
1501,44141,MykUjAz2RHfOismfBj3t8dCwbOEsrgDq,fbPkOYLVPtPgIt0MxizjfFJov3JbHyAi,5,4,2,0,1,0,3,0,10,1.4285714285714286,1,0.0,0,2,0,1,4,0,0,3,0,3,7,1
1502,44144,8ZsouqUolTSghSnsdTjJFuPUeDFeagv6,fbPkOYLVPtPgIt0MxizjfFJov3JbHyAi,1,0,0,0,0,0,1,0,1,0.14285714285714285,1,0.0,0,0,0,0,0,0,0,1,0,0,1,1
1503,44148,hd8cWgeUYWb4NyjYBEC7ZVh5Gsq9Y3Ff,fbPkOYLVPtPgIt0MxizjfFJov3JbHyAi,18,13,11,0,9,0,10,0,43,6.142857142857143,1,0.0,0,11,0,9,13,0,0,10,0,20,23,1
1504,44151,WRW8ZNpfTVG6ItpEWtCFOCrLdAppQEhA,fbPkOYLVPtPgIt0MxizjfFJov3JbHyAi,11,11,4,0,5,0,5,0,25,3.5714285714285716,1,0.0,6,4,0,5,5,0,0,5,0,15,10,1
1505,44152,ckUgzG88eR58uy370LgSc7zPpsWm2L4O,fbPkOYLVPtPgIt0MxizjfFJov3JbHyAi,10,8,5,0,4,7,4,0,28,4.0,1,0.0,0,5,0,4,8,7,0,4,0,9,19,1
1506,44155,ufy4LHvMWo0whrRq15door8x99FGdY4J,fbPkOYLVPtPgIt0MxizjfFJov3JbHyAi,21,65,32,21,10,17,5,0,150,21.428571428571427,4,0.0,25,32,17,10,40,17,4,5,0,84,66,1
1507,44159,tfcOvcMIVTpughZ66Us0P1WhX9cxijTo,fbPkOYLVPtPgIt0MxizjfFJov3JbHyAi,6,3,2,0,2,3,2,0,12,1.7142857142857142,1,0.0,0,2,0,2,3,3,0,2,0,4,8,1
1508,44161,VmHFwT6SFcmG2hmz0LuDgYb6XJYcUUSp,fbPkOYLVPtPgIt0MxizjfFJov3JbHyAi,5,2,1,0,1,3,2,0,9,1.2857142857142858,1,0.0,0,1,0,1,2,3,0,2,0,2,7,1
1509,44163,QHPITLtk56ZUotelsryOYmh753HhRll9,fbPkOYLVPtPgIt0MxizjfFJov3JbHyAi,6,3,2,0,2,0,1,0,8,1.1428571428571428,1,0.0,0,2,0,2,3,0,0,1,0,4,4,1
1510,44165,VBgEdkbZzukrjHaMBzmoJMWNefIhR359,fbPkOYLVPtPgIt0MxizjfFJov3JbHyAi,6,4,2,0,1,0,2,0,9,1.2857142857142858,1,0.0,0,2,0,1,4,0,0,2,0,3,6,1
1511,44168,b6tYxnTOArtoyrdJ0MLgwMZ9LCbErJm6,fbPkOYLVPtPgIt0MxizjfFJov3JbHyAi,8,5,3,0,2,1,5,1,17,2.4285714285714284,1,0.0,0,3,0,2,5,1,0,5,1,5,12,1
1512,44169,gMeKwVdV7xHR9zrsQTTuP5xOz4aKMsCh,fbPkOYLVPtPgIt0MxizjfFJov3JbHyAi,9,6,5,0,4,4,6,0,25,3.5714285714285716,1,0.0,0,5,0,4,6,4,0,6,0,9,16,1
1513,44170,wfBPTMOVZ2z78mcsSkE5pUWw8ps1YZeD,fbPkOYLVPtPgIt0MxizjfFJov3JbHyAi,7,7,2,0,3,0,3,0,15,2.142857142857143,1,0.0,2,2,0,3,5,0,0,3,0,7,8,1
1514,44173,kNdT4Mob6J1VkdvqbhmS4aPzbDLqNeYP,fbPkOYLVPtPgIt0MxizjfFJov3JbHyAi,11,14,6,0,4,3,8,1,36,5.142857142857143,1,0.0,3,6,0,4,11,3,0,8,1,13,23,1
1515,44176,8TCCmIoVZzZAPAuNITv5aLi5oDEbcxb0,fbPkOYLVPtPgIt0MxizjfFJov3JbHyAi,7,5,3,0,2,0,8,1,19,2.7142857142857144,1,0.0,0,3,0,2,5,0,0,8,1,5,14,1
1516,44177,MikH0dwnUPgwm1pOxLfLikTx2rTYR4VE,fbPkOYLVPtPgIt0MxizjfFJov3JbHyAi,6,2,1,0,1,0,5,1,10,1.4285714285714286,1,0.0,0,1,0,1,2,0,0,5,1,2,8,1
1517,44180,1MF1O9UiGEPKiN9XxCO7tMvYDB1feEh9,fbPkOYLVPtPgIt0MxizjfFJov3JbHyAi,7,2,1,0,1,0,7,1,12,1.7142857142857142,1,0.0,0,1,0,1,2,0,0,7,1,2,10,1
1518,44183,xdClWt95AonMUbXmVncDz7pyQAF4u9BG,fbPkOYLVPtPgIt0MxizjfFJov3JbHyAi,5,2,1,0,1,0,3,0,7,1.0,1,0.0,0,1,0,1,2,0,0,3,0,2,5,1
1519,44189,1eQmYbeMjDeGW0fORE6JAUI81WibJPEv,fbPkOYLVPtPgIt0MxizjfFJov3JbHyAi,1,0,0,0,0,0,1,0,1,0.14285714285714285,1,0.0,0,0,0,0,0,0,0,1,0,0,1,1
1520,44190,RJAPKuvNhyLyzVhUoacg3kyQMrusLDCW,fbPkOYLVPtPgIt0MxizjfFJov3JbHyAi,20,41,23,0,9,0,10,2,85,12.142857142857142,2,0.0,13,23,0,9,28,0,0,10,2,45,40,1
1521,44191,MkhWkWrDBg7jFp3XklVC8uZQ46nAon3u,fbPkOYLVPtPgIt0MxizjfFJov3JbHyAi,17,36,14,0,6,3,6,2,67,9.571428571428571,1,0.0,6,14,0,6,30,3,0,6,2,26,41,1
1522,44192,c1zULVJb8UrzwaeCwQXbXVIx3xb2chrp,fbPkOYLVPtPgIt0MxizjfFJov3JbHyAi,6,4,3,0,1,0,8,0,16,2.2857142857142856,3,0.0,1,3,0,1,3,0,0,8,0,5,11,0
1523,44197,ZqSAxgvVLUFu6IOm5zNZalNXouYaP76y,fbPkOYLVPtPgIt0MxizjfFJov3JbHyAi,18,23,12,9,9,6,5,1,65,9.285714285714286,2,0.0,9,12,7,9,14,6,2,5,1,37,28,1
1524,44198,H1kvrsGGsPor5huYrdsnL3Isag4wSKlt,fbPkOYLVPtPgIt0MxizjfFJov3JbHyAi,22,16,7,11,8,0,1,0,43,6.142857142857143,1,0.0,8,7,11,8,8,0,0,1,0,34,9,1
1525,44199,K28hkwMS8Ua9nbLnLUJX6puRWq44TrF0,fbPkOYLVPtPgIt0MxizjfFJov3JbHyAi,4,2,1,0,1,0,1,0,5,0.7142857142857143,1,0.0,0,1,0,1,2,0,0,1,0,2,3,1
1526,44200,UeDs0IsM5JGu9WKbkZDo576REb7pnQUn,fbPkOYLVPtPgIt0MxizjfFJov3JbHyAi,1,0,0,0,0,0,1,0,1,0.14285714285714285,1,0.0,0,0,0,0,0,0,0,1,0,0,1,1
1527,44204,VndQ6jKo03PwXryVilJVgpCAmWUkBbqD,fbPkOYLVPtPgIt0MxizjfFJov3JbHyAi,8,3,2,0,2,0,5,0,12,1.7142857142857142,1,0.0,0,2,0,2,3,0,0,5,0,4,8,1
1528,44205,xeper6lTTTduQkRnWSDeRoAUobRsjfTO,fbPkOYLVPtPgIt0MxizjfFJov3JbHyAi,12,10,5,2,4,15,4,1,41,5.857142857142857,1,0.0,3,5,2,4,7,15,0,4,1,14,27,1
1529,44206,pmP1vo676Ls6u06kxeOxjGCjZN5T0bfn,fbPkOYLVPtPgIt0MxizjfFJov3JbHyAi,7,5,2,0,2,0,2,0,11,1.5714285714285714,1,0.0,0,2,0,2,5,0,0,2,0,4,7,1
1530,44207,jWewOVeTfMYYPxwOYqT1SGXzvovpIvz3,fbPkOYLVPtPgIt0MxizjfFJov3JbHyAi,5,2,1,0,1,0,5,0,9,1.2857142857142858,1,0.0,0,1,0,1,2,0,0,5,0,2,7,1
1531,44210,3tTsLPRBksgsW30Yifh6MWgLDquCQM2g,fbPkOYLVPtPgIt0MxizjfFJov3JbHyAi,8,3,2,0,2,0,3,2,12,1.7142857142857142,1,0.0,0,2,0,2,3,0,0,3,2,4,8,1
1532,44211,u1AyJHfZVkCbqmaTVxNT62X9SEOZHm4M,fbPkOYLVPtPgIt0MxizjfFJov3JbHyAi,7,4,2,0,1,0,4,0,11,1.5714285714285714,1,0.0,0,2,0,1,4,0,0,4,0,3,8,1
1533,44214,90af6u7O75fWjzbthnMq7awDtdd9TeI9,fbPkOYLVPtPgIt0MxizjfFJov3JbHyAi,7,6,3,0,2,3,1,0,15,2.142857142857143,1,0.0,0,3,0,2,6,3,0,1,0,5,10,1
1534,44218,hJGj3kQ93iSqrSQuFovt8Qk2BphLpPcg,fbPkOYLVPtPgIt0MxizjfFJov3JbHyAi,2,0,0,0,0,0,6,0,6,0.8571428571428571,1,0.0,0,0,0,0,0,0,0,6,0,0,6,1
1535,44220,hy5uxKEcxvtHS3tlaeM1vWwbo38Hj0n0,fbPkOYLVPtPgIt0MxizjfFJov3JbHyAi,11,11,5,0,4,12,6,0,38,5.428571428571429,1,0.0,3,5,0,4,8,12,0,6,0,12,26,0
1536,44221,JBImmJkUH6RU5EuKvs04Gb9Ih8CxmZjg,fbPkOYLVPtPgIt0MxizjfFJov3JbHyAi,2,0,0,0,0,0,6,0,6,0.8571428571428571,1,0.0,0,0,0,0,0,0,0,6,0,0,6,1
1537,44222,cztDDQRMLEL2fROQpw4ZlOpH3qNEy4bb,fbPkOYLVPtPgIt0MxizjfFJov3JbHyAi,1,0,0,0,0,0,1,0,1,0.14285714285714285,1,0.0,0,0,0,0,0,0,0,1,0,0,1,1
1538,44223,1RzKq1UsN4x78Mgw0Ly9Is8DkKOORlnQ,fbPkOYLVPtPgIt0MxizjfFJov3JbHyAi,2,0,0,0,0,0,7,0,7,1.0,1,0.0,0,0,0,0,0,0,0,7,0,0,7,1
1539,44224,zpieVPimuNuvyfb8XZsK7ZjTM6u74cRF,fbPkOYLVPtPgIt0MxizjfFJov3JbHyAi,6,2,1,0,1,0,2,0,6,0.8571428571428571,1,0.0,0,1,0,1,2,0,0,2,0,2,4,1
1540,44226,VYNucadxJwAl4oUfBMF6a5hY4ZvYaLjQ,fbPkOYLVPtPgIt0MxizjfFJov3JbHyAi,12,18,8,6,8,3,11,1,55,7.857142857142857,2,0.0,6,8,6,8,12,3,0,11,1,28,27,1
1541,44231,AQMZ0ecVv6yIj8PNV5GC8bjPJquyjuSz,fbPkOYLVPtPgIt0MxizjfFJov3JbHyAi,18,47,19,14,13,23,13,1,130,18.571428571428573,4,0.0,19,19,12,13,28,23,2,13,1,63,67,1
1542,44234,UDo4onvYbb2pCnzrdvVIV4SfsdccpEQm,fbPkOYLVPtPgIt0MxizjfFJov3JbHyAi,4,3,1,0,1,2,1,0,8,1.1428571428571428,1,0.0,0,1,0,1,3,2,0,1,0,2,6,1
1543,44235,NotCBcEqqDsUQXSDLm2TrhVN2AkQ1PWh,fbPkOYLVPtPgIt0MxizjfFJov3JbHyAi,2,0,0,0,0,0,5,0,5,0.7142857142857143,1,0.0,0,0,0,0,0,0,0,5,0,0,5,1
1544,44238,9qv2s3k2hG6Dn32V5Dxzc9l86R5tLy2Y,fbPkOYLVPtPgIt0MxizjfFJov3JbHyAi,8,12,6,0,4,0,3,0,25,3.5714285714285716,2,0.0,1,6,0,4,11,0,0,3,0,11,14,1
1545,44241,RlfgxVU45fTUQ2rrZmOGyzpDUuAkm82S,fbPkOYLVPtPgIt0MxizjfFJov3JbHyAi,8,8,0,0,1,2,11,1,23,3.2857142857142856,1,0.0,2,0,0,1,6,2,0,11,1,3,20,1
1546,44245,Qs9VQJkriDZBH3FlG0bgTumvMa49MEaO,fbPkOYLVPtPgIt0MxizjfFJov3JbHyAi,9,13,7,0,4,3,8,1,36,5.142857142857143,3,0.0,0,7,0,4,13,3,0,8,1,11,25,0
1547,44246,kf48MnOeHkW7v0hNxfQUaCVe32or0xVe,fbPkOYLVPtPgIt0MxizjfFJov3JbHyAi,8,4,3,0,2,0,3,0,12,1.7142857142857142,1,0.0,0,3,0,2,4,0,0,3,0,5,7,1
1548,44247,0zumY6pgP7xEn5eA1MMsT2riPT41hmwE,fbPkOYLVPtPgIt0MxizjfFJov3JbHyAi,11,9,5,0,4,0,2,0,20,2.857142857142857,2,0.0,1,5,0,4,8,0,0,2,0,10,10,1
1549,44249,d6iEuc9ggOjxGIdMWyLvfDI4lEqo5BAX,fbPkOYLVPtPgIt0MxizjfFJov3JbHyAi,8,10,6,0,4,1,3,0,24,3.4285714285714284,2,0.0,1,6,0,4,9,1,0,3,0,11,13,1
1550,44250,g1tIXPWfZhmnEZEG9z52U31YrMwRUSiT,fbPkOYLVPtPgIt0MxizjfFJov3JbHyAi,8,11,7,0,4,13,8,0,43,6.142857142857143,1,0.0,0,7,0,4,11,13,0,8,0,11,32,1
1551,44254,DxX4QPcfDwxjWtFJm5EFgLobXDWqAEqS,fbPkOYLVPtPgIt0MxizjfFJov3JbHyAi,6,4,3,0,3,6,2,0,18,2.5714285714285716,1,0.0,0,3,0,3,4,6,0,2,0,6,12,1
1552,44255,zVdtg8NVS1UKsR7hBTuXsHvQ0Y2M8ZjR,fbPkOYLVPtPgIt0MxizjfFJov3JbHyAi,6,3,2,0,2,0,2,0,9,1.2857142857142858,1,0.0,0,2,0,2,3,0,0,2,0,4,5,1
1553,44259,v5DL1tRN6AvAeQThFmEHNCo6sn5M6uIG,fbPkOYLVPtPgIt0MxizjfFJov3JbHyAi,5,7,4,0,2,6,8,0,27,3.857142857142857,2,0.0,0,4,0,2,7,6,0,8,0,6,21,1
1554,44261,JaD7mqaE0bkEF64A4nrAbGGFeYQR80Ys,fbPkOYLVPtPgIt0MxizjfFJov3JbHyAi,15,27,1,12,6,0,9,0,55,7.857142857142857,3,0.0,16,1,10,6,11,0,2,9,0,33,22,1
1555,44262,EWKyvUI6fjHJ7AQcKlSBWUO2bca5ubo6,fbPkOYLVPtPgIt0MxizjfFJov3JbHyAi,19,31,11,11,12,6,30,1,102,14.571428571428571,1,0.0,13,11,9,12,18,6,2,30,1,45,57,1
1556,44266,8LoJ3UkmcZEmQsx5Wwgf18vm50gv36wN,fbPkOYLVPtPgIt0MxizjfFJov3JbHyAi,21,32,17,6,9,52,15,1,132,18.857142857142858,3,0.0,9,17,6,9,23,52,0,15,1,41,91,1
1557,44268,Fm9D7fGEScpbD1TbGjzCqweaOK1CX2Mr,fbPkOYLVPtPgIt0MxizjfFJov3JbHyAi,5,3,1,0,1,0,9,0,14,2.0,1,0.0,0,1,0,1,3,0,0,9,0,2,12,1
1558,44269,uDkm2sS75pRjgqry4uezxxAPyhgOOrpN,fbPkOYLVPtPgIt0MxizjfFJov3JbHyAi,6,16,1,0,1,4,2,0,24,3.4285714285714284,1,0.0,2,1,0,1,14,4,0,2,0,4,20,1
1559,44271,1V3TxSEX8RFiuvxHNXCh1zQbhpFBX9Tf,fbPkOYLVPtPgIt0MxizjfFJov3JbHyAi,2,0,0,0,0,0,3,0,3,0.42857142857142855,1,0.0,0,0,0,0,0,0,0,3,0,0,3,1
1560,44273,v4VtiypZ3gKvKYOCZEjKIfSgOk6hH0T6,fbPkOYLVPtPgIt0MxizjfFJov3JbHyAi,6,3,2,0,2,0,3,0,10,1.4285714285714286,1,0.0,0,2,0,2,3,0,0,3,0,4,6,1
1561,44276,oVGH1nEV79R6JEth0UtmMIUIu6BZjaDG,fbPkOYLVPtPgIt0MxizjfFJov3JbHyAi,7,11,3,0,2,9,7,0,32,4.571428571428571,1,0.0,0,3,0,2,11,9,0,7,0,5,27,1
1562,44278,0vLnRe5y9b9pBloxjGZQUFmqmEJONAkl,fbPkOYLVPtPgIt0MxizjfFJov3JbHyAi,6,4,2,0,2,0,1,0,9,1.2857142857142858,1,0.0,0,2,0,2,4,0,0,1,0,4,5,1
1563,44281,ocGAaC1x5z02wnoRsT01upUCTbjuENeN,fbPkOYLVPtPgIt0MxizjfFJov3JbHyAi,12,12,6,0,5,9,8,3,43,6.142857142857143,1,0.0,0,6,0,5,12,9,0,8,3,11,32,1
1564,44292,3ny9mc45r6qJQOOxmh4xg5QHGygeiHbu,fbPkOYLVPtPgIt0MxizjfFJov3JbHyAi,9,6,2,1,2,0,2,0,13,1.8571428571428572,1,0.0,1,2,1,2,5,0,0,2,0,6,7,1
1565,44293,XpTBA5oDkoJbl0jjlH57SraU2q4zBLWW,fbPkOYLVPtPgIt0MxizjfFJov3JbHyAi,5,0,0,0,0,3,4,1,8,1.1428571428571428,1,0.0,0,0,0,0,0,3,0,4,1,0,8,1
1566,44294,RTkGQ4UmTL2ed98p2vxbPQoTurdG2SAC,fbPkOYLVPtPgIt0MxizjfFJov3JbHyAi,13,11,7,0,5,2,2,0,27,3.857142857142857,2,0.0,0,7,0,5,11,2,0,2,0,12,15,1
1567,44298,ABJgMBFFKl294n68xTf25Os1AW439ijN,fbPkOYLVPtPgIt0MxizjfFJov3JbHyAi,1,0,0,0,0,0,1,0,1,0.14285714285714285,1,0.0,0,0,0,0,0,0,0,1,0,0,1,1
1568,44300,oO4ZerJgmfSMeyHkgVIxV4spEvg9yQJk,fbPkOYLVPtPgIt0MxizjfFJov3JbHyAi,6,3,2,0,2,0,1,0,8,1.1428571428571428,1,0.0,0,2,0,2,3,0,0,1,0,4,4,1
1569,44301,3zvHKS6M4U1m424fRhI52J9JeELqakS5,fbPkOYLVPtPgIt0MxizjfFJov3JbHyAi,4,5,1,0,0,0,3,0,9,1.2857142857142858,2,0.0,0,1,0,0,5,0,0,3,0,1,8,1
1570,44305,speERHm9QGPSObf8TcqRV8vukGx9NoGR,fbPkOYLVPtPgIt0MxizjfFJov3JbHyAi,4,3,2,0,0,0,5,0,10,1.4285714285714286,1,0.0,0,2,0,0,3,0,0,5,0,2,8,1
1571,44307,nxuexUreiYSzpSapqT3MF6tzgH9I1i5D,fbPkOYLVPtPgIt0MxizjfFJov3JbHyAi,5,2,1,0,1,0,3,0,7,1.0,1,0.0,0,1,0,1,2,0,0,3,0,2,5,1
1572,44309,LLsy8k18PLzqaAWgeu3HZsydISuZ18ow,fbPkOYLVPtPgIt0MxizjfFJov3JbHyAi,9,9,5,0,5,8,2,0,29,4.142857142857143,1,0.0,2,5,0,5,7,8,0,2,0,12,17,1
1573,45311,b28qvpjrNqMA0awJsB8hLMAyVGCoQbbk,G8EPVSXsOYB5YQWZGiz1aVq5Pgr2GrQu,7,6,1,0,2,0,5,0,14,2.0,2,0.0,4,1,0,2,2,0,0,5,0,7,7,1
1574,45351,YUDUYDMwNH7HxjxwbXkgNGbRIGFCEsrp,RXDvfPUBYFlVdlueBFbLW0mhhAyGEqpt,1,0,0,0,0,0,1,0,1,0.14285714285714285,1,0.0,0,0,0,0,0,0,0,1,0,0,1,1
1575,45360,n2Bw3Z0s4Gtstp5ZMzZilJIZC4rZeeNT,RXDvfPUBYFlVdlueBFbLW0mhhAyGEqpt,1,0,0,0,0,0,1,0,1,0.14285714285714285,1,0.0,0,0,0,0,0,0,0,1,0,0,1,0
1576,45377,j1jdy8OF5VQw4rqSYOkbK2pQplvvvz37,RXDvfPUBYFlVdlueBFbLW0mhhAyGEqpt,1,0,0,0,0,0,3,0,3,0.42857142857142855,1,0.0,0,0,0,0,0,0,0,3,0,0,3,1
1577,45465,S2JQaGbkoCWVoXxNa4G5dVj0cKlAhzdj,G8EPVSXsOYB5YQWZGiz1aVq5Pgr2GrQu,1,0,0,0,0,0,1,0,1,0.14285714285714285,1,0.0,0,0,0,0,0,0,0,1,0,0,1,1
1578,45528,a6zSl0gjLWH0dh3jFMjFS9ulsRXPRoyp,G8EPVSXsOYB5YQWZGiz1aVq5Pgr2GrQu,12,12,6,12,1,1,8,1,41,5.857142857142857,2,0.0,3,6,10,1,9,1,2,8,1,20,21,1
1579,45530,BQi6o3YIDMuHZg7pBKL2EQvhTIhuaxJ1,RXDvfPUBYFlVdlueBFbLW0mhhAyGEqpt,13,10,0,0,0,0,6,0,16,2.2857142857142856,2,0.0,0,0,0,0,10,0,0,6,0,0,16,1
1580,45577,JXWz1gOpRnT7ZzNBuPorM6sgihC1HCez,G8EPVSXsOYB5YQWZGiz1aVq5Pgr2GrQu,19,24,10,0,10,4,7,0,55,7.857142857142857,3,0.0,10,10,0,10,14,4,0,7,0,30,25,1
1581,45591,cANiCKhLAefO0FGisAnCzMrx1JIRd95C,G8EPVSXsOYB5YQWZGiz1aVq5Pgr2GrQu,15,10,0,20,0,0,9,0,39,5.571428571428571,2,0.0,0,0,16,0,10,0,4,9,0,16,23,1
1582,45614,aCMLJ0A5ki1G82R2CtOxjr8OrznWuiC4,RXDvfPUBYFlVdlueBFbLW0mhhAyGEqpt,11,13,1,0,1,1,6,1,23,3.2857142857142856,2,0.0,1,1,0,1,12,1,0,6,1,3,20,0
1583,45699,K1CIuuqKM8wD54LStvCDz7Yn5t0CkHIq,RXDvfPUBYFlVdlueBFbLW0mhhAyGEqpt,2,0,0,0,0,0,2,0,2,0.2857142857142857,2,0.0,0,0,0,0,0,0,0,2,0,0,2,1
1584,45831,VmamyIiK1jSOxNtAs2j1qAN0wTVBPgfx,RXDvfPUBYFlVdlueBFbLW0mhhAyGEqpt,1,0,0,0,0,0,2,0,2,0.2857142857142857,1,0.0,0,0,0,0,0,0,0,2,0,0,2,1
1585,45843,0DHsJAElXb9hqHUPTXAQocHtOXvWXP78,G8EPVSXsOYB5YQWZGiz1aVq5Pgr2GrQu,1,0,0,0,0,0,1,0,1,0.14285714285714285,1,0.0,0,0,0,0,0,0,0,1,0,0,1,1
1586,45847,CpJFUzNBBad8gxGQfFWcVCTdakqtlRdi,G8EPVSXsOYB5YQWZGiz1aVq5Pgr2GrQu,1,0,0,0,0,0,1,0,1,0.14285714285714285,1,0.0,0,0,0,0,0,0,0,1,0,0,1,1
1587,45896,xTXd8tIpTtdrquABXzBf4mWdlBXfSN1C,RXDvfPUBYFlVdlueBFbLW0mhhAyGEqpt,1,0,0,0,0,0,1,0,1,0.14285714285714285,1,0.0,0,0,0,0,0,0,0,1,0,0,1,1
1588,45921,0Uvd29I2Jn8OHG2XWh0gsDCQWSV0omOU,G8EPVSXsOYB5YQWZGiz1aVq5Pgr2GrQu,13,12,2,6,2,0,3,0,25,3.5714285714285716,3,0.0,3,2,3,2,9,0,3,3,0,10,15,1
1589,46035,0Zq8B7S84C5PTvA0nNf1DjHNx9AarY36,G8EPVSXsOYB5YQWZGiz1aVq5Pgr2GrQu,6,4,1,0,2,8,6,1,22,3.142857142857143,2,0.0,2,1,0,2,2,8,0,6,1,5,17,1
1590,46037,OQeiYxdljaHZZUTeWOEaPzOq9rygakd3,RXDvfPUBYFlVdlueBFbLW0mhhAyGEqpt,21,33,25,23,15,0,7,0,103,14.714285714285714,3,0.0,2,25,20,15,31,0,3,7,0,62,41,1
1591,46053,gvkM0LsKRQYuvgC8Hpf4C14gSdMpspZj,RXDvfPUBYFlVdlueBFbLW0mhhAyGEqpt,1,0,0,0,0,0,1,0,1,0.14285714285714285,1,0.0,0,0,0,0,0,0,0,1,0,0,1,1
1592,46068,H3iVkRV8UPZvsbvYrU1dnbX51IlHemsF,RXDvfPUBYFlVdlueBFbLW0mhhAyGEqpt,1,0,0,0,0,0,1,0,1,0.14285714285714285,1,0.0,0,0,0,0,0,0,0,1,0,0,1,0
1593,46092,98ZYW8gcU4Hxzep6tki6R3HQndcbamAh,RXDvfPUBYFlVdlueBFbLW0mhhAyGEqpt,1,0,0,0,0,0,1,0,1,0.14285714285714285,1,0.0,0,0,0,0,0,0,0,1,0,0,1,1
1594,46102,sGJu15oKkQx4W6qHl6Xom6U8DHxzhJdN,G8EPVSXsOYB5YQWZGiz1aVq5Pgr2GrQu,1,0,0,0,0,0,1,0,1,0.14285714285714285,1,0.0,0,0,0,0,0,0,0,1,0,0,1,1
1595,46115,TY20DTNTajpRAyDCw2XYDvuFZloaGUMy,RXDvfPUBYFlVdlueBFbLW0mhhAyGEqpt,11,19,9,0,0,5,10,1,44,6.285714285714286,2,0.0,9,9,0,0,10,5,0,10,1,18,26,1
1596,46215,MEUnkhrmqL9ON8PWbJJQFcg86E54kgxb,RXDvfPUBYFlVdlueBFbLW0mhhAyGEqpt,1,0,0,0,0,0,1,0,1,0.14285714285714285,1,0.0,0,0,0,0,0,0,0,1,0,0,1,1
1597,46249,khWVYmdWxnvqYtc79BZbIfd9BwoftBF7,RXDvfPUBYFlVdlueBFbLW0mhhAyGEqpt,1,0,0,0,0,0,1,0,1,0.14285714285714285,1,0.0,0,0,0,0,0,0,0,1,0,0,1,1
1598,46269,ciDlATwKIeO3pzuVf93RXkCmSkEbDZee,RXDvfPUBYFlVdlueBFbLW0mhhAyGEqpt,18,42,1,12,1,0,9,1,66,9.428571428571429,3,0.0,4,1,10,1,38,0,2,9,1,16,50,1
1599,46337,Rsrb1XM1aPdEAzSt1ydc7TbF7ep7aOyM,G8EPVSXsOYB5YQWZGiz1aVq5Pgr2GrQu,1,0,0,0,0,0,2,0,2,0.2857142857142857,1,0.0,0,0,0,0,0,0,0,2,0,0,2,1
1600,46359,6prInvUnT1ahW1Psrbr1FgolDYnjdXNy,RXDvfPUBYFlVdlueBFbLW0mhhAyGEqpt,1,0,0,0,0,0,1,0,1,0.14285714285714285,1,0.0,0,0,0,0,0,0,0,1,0,0,1,1
1601,46423,mufweOLZc5URTsjF5U8S2NwmI2DUiqcr,G8EPVSXsOYB5YQWZGiz1aVq5Pgr2GrQu,1,0,0,0,0,0,1,0,1,0.14285714285714285,1,0.0,0,0,0,0,0,0,0,1,0,0,1,1
1602,46437,TOrqBZDp9GjgXoTZI9iOS0r8wbO7CyB1,RXDvfPUBYFlVdlueBFbLW0mhhAyGEqpt,3,0,0,0,0,0,4,0,4,0.5714285714285714,2,0.0,0,0,0,0,0,0,0,4,0,0,4,0
1603,46509,wUS4QMZENKgcJOovrFGfoZniw3fDJWWg,fbPkOYLVPtPgIt0MxizjfFJov3JbHyAi,15,20,12,1,7,0,11,0,51,7.285714285714286,3,0.0,5,12,1,7,15,0,0,11,0,25,26,0
1604,46542,pSw6NR4rsSse1CEq7lXuqdp47AxBAOW4,fbPkOYLVPtPgIt0MxizjfFJov3JbHyAi,1,0,0,0,0,0,1,0,1,0.14285714285714285,1,0.0,0,0,0,0,0,0,0,1,0,0,1,1
1605,46551,kWet01DzGE5Z1z6FwJt5yEexIuvkBhsh,fbPkOYLVPtPgIt0MxizjfFJov3JbHyAi,6,19,2,0,4,16,3,0,44,6.285714285714286,2,0.0,8,2,0,4,11,16,0,3,0,14,30,0
1606,46572,ot3QeXNrfLK0N6qyT4MMuMtdNheYtJct,fbPkOYLVPtPgIt0MxizjfFJov3JbHyAi,2,0,0,0,0,0,2,0,2,0.2857142857142857,2,0.0,0,0,0,0,0,0,0,2,0,0,2,1
1607,46591,XQCUbONg6Qt5ssh0BzFokuANDDKZfnIv,fbPkOYLVPtPgIt0MxizjfFJov3JbHyAi,6,5,3,0,2,0,4,0,14,2.0,1,0.0,0,3,0,2,5,0,0,4,0,5,9,1
1608,47748,kBcjUv7wCsLl51XfcJpKl8Rz4VIbTmWw,fbPkOYLVPtPgIt0MxizjfFJov3JbHyAi,21,17,6,7,8,3,7,1,49,7.0,1,0.0,9,6,7,8,8,3,0,7,1,30,19,1
1609,47750,0qPh5PrlrJCeTfTUrI9BQO9zneoMXi60,fbPkOYLVPtPgIt0MxizjfFJov3JbHyAi,9,12,3,0,4,1,5,1,26,3.7142857142857144,1,0.0,7,3,0,4,5,1,0,5,1,14,12,1
1610,47752,sssMJa5iFnCjQwIkqzgCnBND3LRzFTaw,fbPkOYLVPtPgIt0MxizjfFJov3JbHyAi,1,0,0,0,0,0,1,0,1,0.14285714285714285,1,0.0,0,0,0,0,0,0,0,1,0,0,1,1
1611,47753,vAnQOM98uBV9N4zlyAfd54z2JCZnwUx8,fbPkOYLVPtPgIt0MxizjfFJov3JbHyAi,21,41,14,24,13,0,9,0,101,14.428571428571429,3,0.0,8,14,19,13,33,0,5,9,0,54,47,1
1612,47758,Br3boNa1GOtMS8whgjxC8vFojVZKIJ8q,fbPkOYLVPtPgIt0MxizjfFJov3JbHyAi,7,3,2,0,2,0,5,0,12,1.7142857142857142,1,0.0,0,2,0,2,3,0,0,5,0,4,8,1
1613,47760,jWh61XkRTjwdqASpqvrGaFWBIry4gjxu,fbPkOYLVPtPgIt0MxizjfFJov3JbHyAi,2,0,0,0,0,0,7,0,7,1.0,1,0.0,0,0,0,0,0,0,0,7,0,0,7,1
1614,47764,3ekpb9qQNnBvDGQePlspHv7VLn9RhUhL,fbPkOYLVPtPgIt0MxizjfFJov3JbHyAi,1,0,0,0,0,0,1,0,1,0.14285714285714285,1,0.0,0,0,0,0,0,0,0,1,0,0,1,1
1615,47770,KO9zYaiac2CNagQLdx3aJ9c2fXXMgIJX,fbPkOYLVPtPgIt0MxizjfFJov3JbHyAi,13,44,9,4,6,4,11,1,79,11.285714285714286,3,0.0,3,9,3,6,41,4,1,11,1,21,58,0
1616,47772,mMS5utPEE0kau31EdquwgaN1e0nxF2V4,fbPkOYLVPtPgIt0MxizjfFJov3JbHyAi,6,3,2,0,2,0,1,0,8,1.1428571428571428,1,0.0,0,2,0,2,3,0,0,1,0,4,4,1
1617,47776,zHeujEYh5L6paRQ7acJHcEFwTj5egykX,fbPkOYLVPtPgIt0MxizjfFJov3JbHyAi,5,6,2,0,0,0,3,0,11,1.5714285714285714,3,0.0,0,2,0,0,6,0,0,3,0,2,9,1
1618,47777,H2nT05aeA6Q1zZKHa66kquyct5PT5SXn,fbPkOYLVPtPgIt0MxizjfFJov3JbHyAi,9,9,3,0,3,8,2,0,25,3.5714285714285716,1,0.0,2,3,0,3,7,8,0,2,0,8,17,1
1619,47779,rVswAzjMLz5uIPbCwAU1SliCQFpiAqey,fbPkOYLVPtPgIt0MxizjfFJov3JbHyAi,6,4,3,0,2,0,2,0,11,1.5714285714285714,1,0.0,0,3,0,2,4,0,0,2,0,5,6,1
1620,47780,bhGqExUGpWPVtLHOBczGOZtP5NSlb2iV,fbPkOYLVPtPgIt0MxizjfFJov3JbHyAi,5,2,1,0,1,0,2,0,6,0.8571428571428571,1,0.0,0,1,0,1,2,0,0,2,0,2,4,1
1621,47783,LnBIzyfbdwaIzv1AmzgfFWCAT33UKIqQ,fbPkOYLVPtPgIt0MxizjfFJov3JbHyAi,5,3,1,0,1,0,4,0,9,1.2857142857142858,1,0.0,1,1,0,1,2,0,0,4,0,3,6,1
1622,47787,W3kCxGrfIFukJWUU9IJiC14IoMB2PgEG,fbPkOYLVPtPgIt0MxizjfFJov3JbHyAi,7,7,5,0,0,15,5,0,32,4.571428571428571,1,0.0,0,5,0,0,7,15,0,5,0,5,27,1
1623,47789,2LJu3awzGTK6KEvbTKsHaTWm40Uc2FME,fbPkOYLVPtPgIt0MxizjfFJov3JbHyAi,5,2,1,0,1,0,2,0,6,0.8571428571428571,1,0.0,0,1,0,1,2,0,0,2,0,2,4,1
1624,47790,0ieVgiGrluCsPP0YL5BydyAhM42qWcB4,fbPkOYLVPtPgIt0MxizjfFJov3JbHyAi,7,3,2,0,2,0,3,0,10,1.4285714285714286,1,0.0,0,2,0,2,3,0,0,3,0,4,6,1
1625,47793,hllwiqbKGoyJt5Tb2KABSErcKGSjkpFC,fbPkOYLVPtPgIt0MxizjfFJov3JbHyAi,1,0,0,0,0,0,1,0,1,0.14285714285714285,1,0.0,0,0,0,0,0,0,0,1,0,0,1,1
1626,47794,lQ3NA8rIFeBdMYWA2lzeVtp3TG4uBQXU,fbPkOYLVPtPgIt0MxizjfFJov3JbHyAi,14,39,23,7,21,30,7,0,127,18.142857142857142,4,0.0,7,23,5,21,32,30,2,7,0,56,71,1
1627,47802,0QSMkT1dSojdga3gOUuLnnXcPZoPeqgp,fbPkOYLVPtPgIt0MxizjfFJov3JbHyAi,5,2,1,0,1,0,2,0,6,0.8571428571428571,1,0.0,0,1,0,1,2,0,0,2,0,2,4,0
1628,47805,C1NrIu2z9b7sPd2GgrgPvw1qImibSsqR,fbPkOYLVPtPgIt0MxizjfFJov3JbHyAi,1,0,0,0,0,0,1,0,1,0.14285714285714285,1,0.0,0,0,0,0,0,0,0,1,0,0,1,1
1629,47806,uXSmZuPz2xNXPk2qFBcPykAtedr98vP4,fbPkOYLVPtPgIt0MxizjfFJov3JbHyAi,9,6,3,2,3,0,2,0,16,2.2857142857142856,1,0.0,1,3,2,3,5,0,0,2,0,9,7,1
1630,47809,LwiFBYAg8FxzttVYXUksrgMfJRvI4SFJ,fbPkOYLVPtPgIt0MxizjfFJov3JbHyAi,11,25,12,0,0,0,10,1,48,6.857142857142857,3,0.0,8,12,0,0,17,0,0,10,1,20,28,1
1631,47810,ZQszEDvefL66DoX1xrFttL5Z99UGUgJi,fbPkOYLVPtPgIt0MxizjfFJov3JbHyAi,12,14,10,0,6,22,11,2,65,9.285714285714286,2,0.0,0,10,0,6,14,22,0,11,2,16,49,0
1632,47812,FQ1LFgTnlxgM163pJYQ8F6cnOancinCK,fbPkOYLVPtPgIt0MxizjfFJov3JbHyAi,13,17,1,6,3,7,3,0,37,5.285714285714286,2,0.0,7,1,5,3,10,7,1,3,0,16,21,1
1633,47824,wwifhf2JKuRRsCekTCD33hbtOjxoHPnW,fbPkOYLVPtPgIt0MxizjfFJov3JbHyAi,4,4,1,0,0,0,2,0,7,1.0,1,0.0,0,1,0,0,4,0,0,2,0,1,6,1
1634,47826,6cy8BWaUGaMCAOjojQczbStvsRKYISdK,fbPkOYLVPtPgIt0MxizjfFJov3JbHyAi,10,15,10,9,9,0,2,0,45,6.428571428571429,2,0.0,3,10,6,9,12,0,3,2,0,28,17,1
1635,47838,bJNzzdFbeXF3gRIHxGK6VlbnTQeUffyz,fbPkOYLVPtPgIt0MxizjfFJov3JbHyAi,6,1,0,0,0,3,6,1,11,1.5714285714285714,1,0.0,0,0,0,0,1,3,0,6,1,0,11,1
1636,47839,ymWpwD3GRW9ut1JiVBQeAWpoDiatjwOa,fbPkOYLVPtPgIt0MxizjfFJov3JbHyAi,12,16,7,2,5,13,7,0,50,7.142857142857143,2,0.0,5,7,2,5,11,13,0,7,0,19,31,1
1637,47850,EA93zC2FZSfWuUTy2fGF8qAEwUDl0X8s,fbPkOYLVPtPgIt0MxizjfFJov3JbHyAi,23,30,15,14,14,0,8,0,81,11.571428571428571,2,0.0,9,15,11,14,21,0,3,8,0,49,32,1
1638,47853,ZZRh21sVolimyM3CDUIIgG9cuzaZauji,fbPkOYLVPtPgIt0MxizjfFJov3JbHyAi,24,50,21,34,12,34,14,3,168,24.0,2,0.0,18,21,24,12,32,34,10,14,3,75,93,1
1639,47938,szUZ2QsyqJuXPgyS49q35y1kTVrrBlKT,SpATywNh6bZuzm8s1ceuBUnMUAeoAHHw,13,26,11,22,0,7,5,0,71,10.142857142857142,3,0.0,11,11,17,0,15,7,5,5,0,39,32,0
1640,48018,xecOK3aJ3hCti9mz2pAAcwSq9d1S8ATw,SpATywNh6bZuzm8s1ceuBUnMUAeoAHHw,14,41,11,38,6,1,10,0,107,15.285714285714286,3,0.0,19,11,38,6,22,1,0,10,0,74,33,0
1641,48081,zCdZvanEH4w4mJiogg5VcFWhPxVyZDYs,RXDvfPUBYFlVdlueBFbLW0mhhAyGEqpt,39,39,1,112,1,6,3,0,162,23.142857142857142,1,0.0,9,1,110,1,30,6,2,3,0,121,41,0
1642,48093,23GFMJXBCJBMscnU5tVwAanleKYVql9b,SpATywNh6bZuzm8s1ceuBUnMUAeoAHHw,18,58,36,15,25,116,21,3,274,39.142857142857146,4,0.0,13,36,14,25,45,116,1,21,3,88,186,0
1643,48114,rzXoVvb6RM0hS48T1GDjFso4hKBDuhsd,bWdj2GDclj5ofokWjzoa5jAwMkxCykd6,1,0,0,0,0,0,1,0,1,0.14285714285714285,1,0.0,0,0,0,0,0,0,0,1,0,0,1,0
1644,48121,aDXyYOZH6u3WRzJTxPdI3vxwfFxiKOmm,SpATywNh6bZuzm8s1ceuBUnMUAeoAHHw,11,20,7,0,5,0,4,0,36,5.142857142857143,2,0.0,0,7,0,5,20,0,0,4,0,12,24,1
1645,48204,pl9XUoy865SinWI51RNAlmhqaJHEhs94,SpATywNh6bZuzm8s1ceuBUnMUAeoAHHw,17,16,6,18,3,1,9,1,54,7.714285714285714,1,0.0,8,6,15,3,8,1,3,9,1,32,22,1
1646,48246,ieR2oDuOBOWrOSx08B7vLKsdvt41Kjgw,A3fsA9Zfv1X2fVEQhTw51lKENdNrEqT3,11,21,0,0,0,0,6,0,27,3.857142857142857,2,0.0,0,0,0,0,21,0,0,6,0,0,27,0
1647,48261,wi7Ze896VO17gMeNUgqgfOVbxlFbfvaK,SpATywNh6bZuzm8s1ceuBUnMUAeoAHHw,17,51,23,11,11,3,17,2,118,16.857142857142858,2,0.0,13,23,10,11,38,3,1,17,2,57,61,0
1648,48370,3HC1D1DG8BjKUNFZlgm7gcIQVOGrzi6J,SpATywNh6bZuzm8s1ceuBUnMUAeoAHHw,7,6,5,0,3,0,1,0,15,2.142857142857143,1,0.0,0,5,0,3,6,0,0,1,0,8,7,0
1649,48372,WjTYaS8yfbxyQCBRfgx2LHwT0DLPXKM5,SpATywNh6bZuzm8s1ceuBUnMUAeoAHHw,8,7,6,0,0,0,7,10,30,4.285714285714286,1,0.0,0,6,0,0,7,0,0,7,10,6,24,1
1650,48386,5jz6qtmzJGoTjjzPCohz2U8oEp7qiszP,SpATywNh6bZuzm8s1ceuBUnMUAeoAHHw,16,34,12,23,3,17,11,2,102,14.571428571428571,3,0.0,12,12,19,3,22,17,4,11,2,46,56,0
1651,48587,v6QLYqOum8NXSX8h0M5DMTP0vkr2qfHa,SpATywNh6bZuzm8s1ceuBUnMUAeoAHHw,2,0,0,0,0,0,2,0,2,0.2857142857142857,1,0.0,0,0,0,0,0,0,0,2,0,0,2,0
1652,48617,LSvU72CFq1TrHd9SCZOiKQ0qcV2oa2Ok,A3fsA9Zfv1X2fVEQhTw51lKENdNrEqT3,11,20,1,0,1,2,4,0,28,4.0,2,0.0,0,1,0,1,20,2,0,4,0,2,26,0
1653,48643,RCdcltNaQLfcoxT7YKTjQxAYUbCmzzKd,SpATywNh6bZuzm8s1ceuBUnMUAeoAHHw,15,22,9,12,4,25,6,1,79,11.285714285714286,3,0.0,9,9,12,4,13,25,0,6,1,34,45,0
1654,48693,AnsnVs5AVUHmSDONSrxZt8MIRHsOXvcc,SpATywNh6bZuzm8s1ceuBUnMUAeoAHHw,16,11,7,15,3,12,6,4,58,8.285714285714286,2,0.0,2,7,14,3,9,12,1,6,4,26,32,0
1655,48701,z4snJqWxxByo4wMmQ2g1knGwZpMDrb1I,SpATywNh6bZuzm8s1ceuBUnMUAeoAHHw,14,38,18,20,13,9,8,0,106,15.142857142857142,5,0.0,6,18,17,13,32,9,3,8,0,54,52,0
1656,48724,oxWNSOCXM5YtqWviH5bNOZtEWIiiD3Ad,SpATywNh6bZuzm8s1ceuBUnMUAeoAHHw,13,22,0,18,0,6,8,1,55,7.857142857142857,2,0.0,13,0,15,0,9,6,3,8,1,28,27,0
1657,48851,U2YEyQJ6vRjLD9a41Fy3cKvRrxCg3qKu,SpATywNh6bZuzm8s1ceuBUnMUAeoAHHw,17,29,16,18,7,38,24,1,133,19.0,2,0.0,6,16,14,7,23,38,4,24,1,43,90,0
1658,48873,FgYPvBwLri7YiFI9og6clP9FuKJ08jX7,G8EPVSXsOYB5YQWZGiz1aVq5Pgr2GrQu,1,0,0,0,0,0,1,0,1,0.14285714285714285,1,0.0,0,0,0,0,0,0,0,1,0,0,1,1
1659,48910,oORy78WPGzz21oydfrdMfNTEPAbNPQ4N,SpATywNh6bZuzm8s1ceuBUnMUAeoAHHw,13,11,4,13,3,0,6,0,37,5.285714285714286,2,0.0,4,4,11,3,7,0,2,6,0,22,15,0
1660,48957,7xLRAUzJSfSBonILgUC8oEWPnbxwGYvj,RXDvfPUBYFlVdlueBFbLW0mhhAyGEqpt,10,10,1,0,0,1,5,1,18,2.5714285714285716,1,0.0,0,1,0,0,10,1,0,5,1,1,17,1
1661,48958,CFwBanDE4eguHX9lcM62Yx5Bex6437kC,SpATywNh6bZuzm8s1ceuBUnMUAeoAHHw,5,2,1,0,1,3,3,0,10,1.4285714285714286,2,0.0,0,1,0,1,2,3,0,3,0,2,8,0
1662,48968,3Y0bPm3E3Ch9XQ8h4cbV56DUaTL5U5qc,SpATywNh6bZuzm8s1ceuBUnMUAeoAHHw,17,56,22,18,4,67,18,2,187,26.714285714285715,5,0.0,18,22,15,4,38,67,3,18,2,59,128,0
1663,49082,21PlIQxHvCIRuT4YC0IvZYCzvQ1GOkuQ,SpATywNh6bZuzm8s1ceuBUnMUAeoAHHw,15,13,1,23,2,3,4,1,47,6.714285714285714,2,0.0,5,1,19,2,8,3,4,4,1,27,20,1
1664,49086,G7CuAdMTwHj5eYhpu5z9RBNQZMziV4KR,SpATywNh6bZuzm8s1ceuBUnMUAeoAHHw,11,15,10,0,9,4,12,3,53,7.571428571428571,2,0.0,0,10,0,9,15,4,0,12,3,19,34,0
1665,49173,1n5WyoQB7crKqtXBR0SIfThQpW2Y5gVs,SpATywNh6bZuzm8s1ceuBUnMUAeoAHHw,18,40,18,9,9,16,10,1,103,14.714285714285714,1,0.0,14,18,9,9,26,16,0,10,1,50,53,0
1666,49176,NPHytleW9ri0zHSbUOwP2d33PRO3w2MK,SpATywNh6bZuzm8s1ceuBUnMUAeoAHHw,8,6,1,17,0,10,7,0,41,5.857142857142857,1,0.0,5,1,15,0,1,10,2,7,0,21,20,0
1667,49181,XlmFJwnIeWSyzdPHIMvNTxkRpr6ZopMK,SpATywNh6bZuzm8s1ceuBUnMUAeoAHHw,14,28,14,21,6,4,5,0,78,11.142857142857142,4,0.0,8,14,17,6,20,4,4,5,0,45,33,1
1668,49183,TNa2CwMEhRRkLaiFBsLLeLu23oFHBijc,SpATywNh6bZuzm8s1ceuBUnMUAeoAHHw,12,20,0,14,0,16,10,2,62,8.857142857142858,1,0.0,10,0,13,0,10,16,1,10,2,23,39,0
1669,49202,l70wRZ2DS0s6LjbT7C4gRoGrF27x9p2H,A3fsA9Zfv1X2fVEQhTw51lKENdNrEqT3,8,7,0,0,0,2,7,0,16,2.2857142857142856,1,0.0,1,0,0,0,6,2,0,7,0,1,15,1
1670,49238,Zi3R72s2HAt1ldLoA4VSH4SbCoNpJ8zo,SpATywNh6bZuzm8s1ceuBUnMUAeoAHHw,6,3,2,0,2,0,1,0,8,1.1428571428571428,1,0.0,0,2,0,2,3,0,0,1,0,4,4,1
1671,49271,L1EklyJfiTl8KTmYGUWKSBRLYXBLn3BW,SpATywNh6bZuzm8s1ceuBUnMUAeoAHHw,5,0,0,0,0,0,4,1,5,0.7142857142857143,1,0.0,0,0,0,0,0,0,0,4,1,0,5,0
1672,49276,vrm9Sqb4UFaJQirEdRETMq8oV2HNeZJI,bWdj2GDclj5ofokWjzoa5jAwMkxCykd6,9,8,0,0,0,21,5,1,35,5.0,2,0.0,0,0,0,0,8,21,0,5,1,0,35,0
1673,49302,3uU9hzp6POZeWb9TkpjJweQiyjZgKmLY,SpATywNh6bZuzm8s1ceuBUnMUAeoAHHw,15,23,11,14,6,1,4,1,60,8.571428571428571,3,0.0,8,11,13,6,15,1,1,4,1,38,22,0
1674,49423,S9Zsax2BYcPzUt4rHtigt6S1ZlRCRjuu,SpATywNh6bZuzm8s1ceuBUnMUAeoAHHw,15,38,13,10,5,7,11,0,84,12.0,3,0.0,8,13,10,5,30,7,0,11,0,36,48,0
1675,49460,cvdLaf0MdwYwJIsGvs9mqC9xuvaOoxKF,A3fsA9Zfv1X2fVEQhTw51lKENdNrEqT3,6,3,2,0,2,0,2,0,9,1.2857142857142858,1,0.0,0,2,0,2,3,0,0,2,0,4,5,1
1676,49511,H1nbdkC904EOh8jWeVVcV5piaqMVBsli,SpATywNh6bZuzm8s1ceuBUnMUAeoAHHw,15,14,2,12,1,2,5,0,36,5.142857142857143,2,0.0,6,2,12,1,8,2,0,5,0,21,15,0
1677,49543,0OsY8LWQHJyrf2iZ6AGYuDrpmW3bfvqO,SpATywNh6bZuzm8s1ceuBUnMUAeoAHHw,16,31,12,18,3,0,10,0,74,10.571428571428571,1,0.0,11,12,15,3,20,0,3,10,0,41,33,0
1678,49604,OXUkoQAJTqhVghuHGRHk1iSAl7CHffoQ,SpATywNh6bZuzm8s1ceuBUnMUAeoAHHw,1,0,0,0,0,0,1,0,1,0.14285714285714285,1,0.0,0,0,0,0,0,0,0,1,0,0,1,1
1679,49620,twg5LqeyEPdLZyjl4T3Yb1man7ZRuOed,SpATywNh6bZuzm8s1ceuBUnMUAeoAHHw,16,44,18,8,8,0,13,0,91,13.0,2,0.0,13,18,8,8,31,0,0,13,0,47,44,0
1680,49630,Nvud1QIhR4FBjW055r9HSxywupZk5GAR,SpATywNh6bZuzm8s1ceuBUnMUAeoAHHw,5,4,1,0,0,0,1,0,6,0.8571428571428571,1,0.0,0,1,0,0,4,0,0,1,0,1,5,1
1681,49650,Y3zuofaAdrsNcwq0tuYyHFkAsBUWoV8a,SpATywNh6bZuzm8s1ceuBUnMUAeoAHHw,16,23,10,15,3,32,23,8,114,16.285714285714285,3,0.0,2,10,14,3,21,32,1,23,8,29,85,0
1682,49654,1bKMONcV6Mq58szdlIajPdFyqaw4BvrA,SpATywNh6bZuzm8s1ceuBUnMUAeoAHHw,6,3,1,0,1,0,2,0,7,1.0,1,0.0,0,1,0,1,3,0,0,2,0,2,5,1
1683,49655,H1nbdkC904EOh8jWeVVcV5piaqMVBsli,G8EPVSXsOYB5YQWZGiz1aVq5Pgr2GrQu,10,4,2,0,1,0,8,1,16,2.2857142857142856,2,0.0,0,2,0,1,4,0,0,8,1,3,13,0
1684,49656,BoK7CAUaCFqnLgmWLxeOHg8YkXUSeCtc,SpATywNh6bZuzm8s1ceuBUnMUAeoAHHw,12,14,6,8,3,0,2,0,33,4.714285714285714,1,0.0,2,6,6,3,12,0,2,2,0,17,16,0
1685,49694,cszgTMCcWdEja3BpEwPP5MtLXTMUMJXE,SpATywNh6bZuzm8s1ceuBUnMUAeoAHHw,12,8,5,12,3,0,1,0,29,4.142857142857143,1,0.0,2,5,12,3,6,0,0,1,0,22,7,0
1686,49710,LzTBHDjLePaTqbybIwaptvUgkC0hWYCZ,SpATywNh6bZuzm8s1ceuBUnMUAeoAHHw,18,32,13,20,5,4,10,1,85,12.142857142857142,2,0.0,13,13,18,5,19,4,2,10,1,49,36,0
1687,49749,EwhKhClSv2Ps16I3uKtjdSj1YI7rGPIh,SpATywNh6bZuzm8s1ceuBUnMUAeoAHHw,3,2,0,0,0,0,1,0,3,0.42857142857142855,1,0.0,0,0,0,0,2,0,0,1,0,0,3,0
1688,49803,3FwKlBDtKGlNAYyQNzHL1qfkuXpNOPVW,A3fsA9Zfv1X2fVEQhTw51lKENdNrEqT3,43,13,11,78,9,3,6,1,121,17.285714285714285,1,0.0,1,11,64,9,12,3,14,6,1,85,36,0
1689,49836,0vUwtohBIGCms6pa9p1s0k5cJHWURa4P,SpATywNh6bZuzm8s1ceuBUnMUAeoAHHw,12,9,0,18,0,0,6,1,34,4.857142857142857,1,0.0,4,0,15,0,5,0,3,6,1,19,15,0
1690,49883,m5Ev3sP4lHJ0ibeJ0LosEcT9fpQ7nqsa,SpATywNh6bZuzm8s1ceuBUnMUAeoAHHw,15,21,2,12,1,0,8,1,45,6.428571428571429,3,0.0,4,2,11,1,17,0,1,8,1,18,27,0
1691,49946,LNdimqsJkOxQDP9dT4IGwewg9YvH7zfV,G8EPVSXsOYB5YQWZGiz1aVq5Pgr2GrQu,56,67,21,80,13,3,7,0,191,27.285714285714285,4,0.0,38,21,55,13,29,3,25,7,0,127,64,0
1692,49967,7tmNprOSiahGzByaY8XiUnCFEIQfWwuf,bWdj2GDclj5ofokWjzoa5jAwMkxCykd6,8,15,6,0,0,1,8,1,31,4.428571428571429,4,0.0,3,6,0,0,12,1,0,8,1,9,22,0
1693,49987,ctfOhdlbQGiOVF89Y090EmsAqQEvSWmz,SpATywNh6bZuzm8s1ceuBUnMUAeoAHHw,13,14,0,22,0,2,7,1,46,6.571428571428571,1,0.0,5,0,18,0,9,2,4,7,1,23,23,0
1694,49990,uG5tavnQGh6e9leaVUY69Y8QlorpIOvo,SpATywNh6bZuzm8s1ceuBUnMUAeoAHHw,7,7,5,0,4,0,3,0,19,2.7142857142857144,1,0.0,0,5,0,4,7,0,0,3,0,9,10,0
1695,49999,46mPOafwambmi8gI5RDfSSG6CkqbcJr8,SpATywNh6bZuzm8s1ceuBUnMUAeoAHHw,15,12,6,21,2,0,5,0,46,6.571428571428571,1,0.0,4,6,17,2,8,0,4,5,0,29,17,0
1696,50039,Ib4hBLihYWrsRQnVhSZKjb9Z8z0NZ4FI,SpATywNh6bZuzm8s1ceuBUnMUAeoAHHw,16,30,1,22,1,2,10,1,67,9.571428571428571,3,0.0,16,1,18,1,14,2,4,10,1,36,31,1
1697,50067,nYSFDE8RCbcZhD46fRSvPHUvA1ahfupi,bWdj2GDclj5ofokWjzoa5jAwMkxCykd6,6,3,2,0,2,0,1,0,8,1.1428571428571428,1,0.0,0,2,0,2,3,0,0,1,0,4,4,1
1698,50077,HNEdRWA988TWNlPkPkScnQdIH5zRazOo,SpATywNh6bZuzm8s1ceuBUnMUAeoAHHw,16,28,13,9,6,26,7,1,90,12.857142857142858,3,0.0,8,13,9,6,20,26,0,7,1,36,54,0
1699,50083,0lcODMnOtMqKwcOQQi0MUEWuUnIKYPe1,A3fsA9Zfv1X2fVEQhTw51lKENdNrEqT3,36,37,0,76,1,0,8,0,122,17.428571428571427,1,0.0,5,0,64,1,32,0,12,8,0,70,52,1
1700,50092,rPKaOWNl9cYkLvtQk035CJPYGwPAMUtv,SpATywNh6bZuzm8s1ceuBUnMUAeoAHHw,14,30,12,18,3,0,6,0,69,9.857142857142858,4,0.0,6,12,15,3,24,0,3,6,0,36,33,0
1701,50131,6k0P72adqZC6N7qhsceaS6tnkuUG2bub,SpATywNh6bZuzm8s1ceuBUnMUAeoAHHw,11,17,8,18,3,5,10,0,61,8.714285714285714,2,0.0,5,8,15,3,12,5,3,10,0,31,30,0
1702,50175,CfX84b3AnOREjEgHXp5gQV78osBjxVJV,RXDvfPUBYFlVdlueBFbLW0mhhAyGEqpt,5,6,0,0,0,2,1,0,9,1.2857142857142858,1,0.0,2,0,0,0,4,2,0,1,0,2,7,0
1703,50254,rf43ZHojMqXQ775bmX3nnHgQ62d9XvGK,A3fsA9Zfv1X2fVEQhTw51lKENdNrEqT3,23,24,12,0,9,4,8,0,57,8.142857142857142,2,0.0,0,12,0,9,24,4,0,8,0,21,36,1
1704,50315,1D9YAtx0zyELGBYY8fk5ML3KqjBc5hJQ,bWdj2GDclj5ofokWjzoa5jAwMkxCykd6,1,0,0,0,0,0,1,0,1,0.14285714285714285,1,0.0,0,0,0,0,0,0,0,1,0,0,1,1
1705,50324,OIups6Cq9XY2CbwOPuI31XrOSt1FeD7G,SpATywNh6bZuzm8s1ceuBUnMUAeoAHHw,5,6,1,0,1,0,1,0,9,1.2857142857142858,1,0.0,0,1,0,1,6,0,0,1,0,2,7,0
1706,50357,wXFfHtwd9smrvhh9NQW7SmEEo1001LDW,bWdj2GDclj5ofokWjzoa5jAwMkxCykd6,15,16,7,48,4,14,5,0,94,13.428571428571429,2,0.0,5,7,44,4,11,14,4,5,0,60,34,0
1707,50416,Xdag5jOmE7uWC3FmBvgPc5F7lO3QNcPW,SpATywNh6bZuzm8s1ceuBUnMUAeoAHHw,17,17,8,15,3,28,8,1,80,11.428571428571429,2,0.0,3,8,14,3,14,28,1,8,1,28,52,0
1708,50461,Mk1WltctY1vlvTjvcoOEN36uI9KP8emp,SpATywNh6bZuzm8s1ceuBUnMUAeoAHHw,14,69,30,5,8,0,13,0,125,17.857142857142858,4,0.0,2,30,4,8,67,0,1,13,0,44,81,0
1709,50500,RwMUq7SCIYrULeTtIYQzgTGTjkIjUHL3,SpATywNh6bZuzm8s1ceuBUnMUAeoAHHw,17,27,2,26,3,3,14,7,82,11.714285714285714,4,0.0,6,2,19,3,21,3,7,14,7,30,52,0
1710,50508,9VvuC4slhZy3KdxqSDDnJl1JHYWZF5th,A3fsA9Zfv1X2fVEQhTw51lKENdNrEqT3,10,14,6,0,1,20,26,2,69,9.857142857142858,2,0.0,2,6,0,1,12,20,0,26,2,9,60,1
1711,50528,faeF4I5p3gAJMB1p4LfYVeCLQZKervYV,A3fsA9Zfv1X2fVEQhTw51lKENdNrEqT3,6,5,0,0,0,0,2,0,7,1.0,1,0.0,0,0,0,0,5,0,0,2,0,0,7,1
1712,50546,8rXJHeqrLpho5nIQgbDcpBTvBrVnGged,A3fsA9Zfv1X2fVEQhTw51lKENdNrEqT3,13,8,6,0,3,0,7,0,24,3.4285714285714284,1,0.0,0,6,0,3,8,0,0,7,0,9,15,1
1713,50660,6jPw8ZwEXjLpnrxZT6HkwOQ20NkEyvU7,SpATywNh6bZuzm8s1ceuBUnMUAeoAHHw,16,34,4,17,3,114,16,1,189,27.0,3,0.0,11,4,15,3,23,114,2,16,1,33,156,0
1714,50679,tqvOTiQbipkIXQL7CIR5dckxV83rng9S,G8EPVSXsOYB5YQWZGiz1aVq5Pgr2GrQu,6,9,5,0,4,6,6,0,30,4.285714285714286,2,0.0,0,5,0,4,9,6,0,6,0,9,21,0
1715,50782,spcUWaGtojfez6ZdF6aqlTnU3zU2dqpy,A3fsA9Zfv1X2fVEQhTw51lKENdNrEqT3,11,6,4,0,2,0,6,1,19,2.7142857142857144,1,0.0,0,4,0,2,6,0,0,6,1,6,13,0
1716,52789,OO7beVHPObBfPwHA9jIrdvSr48hMom1m,7GRhBDsirIGkRZBtSMEzNTyDr2JQm4xx,10,10,6,2,5,0,1,0,24,3.4285714285714284,1,0.0,1,6,2,5,9,0,0,1,0,14,10,0
1717,53046,t8qBiDTvOvYmrxcVIErRuEOf38tywm6t,bWdj2GDclj5ofokWjzoa5jAwMkxCykd6,17,37,21,98,5,12,12,0,185,26.428571428571427,4,0.0,7,21,92,5,30,12,6,12,0,125,60,1
1718,53048,8gk5kBMYT20pCB4wpUHe3xKwSYDbtvzS,SpATywNh6bZuzm8s1ceuBUnMUAeoAHHw,14,14,6,15,1,21,5,2,64,9.142857142857142,1,0.0,5,6,14,1,9,21,1,5,2,26,38,1
1719,53049,8cVIhj7cvR0q9dzupEColmwPbOHZ624c,SpATywNh6bZuzm8s1ceuBUnMUAeoAHHw,16,17,7,14,4,13,8,3,66,9.428571428571429,1,0.0,4,7,13,4,13,13,1,8,3,28,38,0
1720,53070,3Ph0mVs6YY4X7VkfoALrDqpzMeDhFoCj,A3fsA9Zfv1X2fVEQhTw51lKENdNrEqT3,36,40,19,42,12,0,9,0,122,17.428571428571427,3,0.0,0,19,39,12,40,0,3,9,0,70,52,1
1721,53119,AwKhkfPOqEnTXG1Cn8Gmf8HHhYnwnTgu,SpATywNh6bZuzm8s1ceuBUnMUAeoAHHw,15,20,10,18,4,21,6,0,79,11.285714285714286,2,0.0,6,10,15,4,14,21,3,6,0,35,44,1
1722,53139,nNXdLwc4WRmQjF7qTMoDc98hNmIFSp8j,SpATywNh6bZuzm8s1ceuBUnMUAeoAHHw,5,5,2,0,0,0,1,0,8,1.1428571428571428,1,0.0,1,2,0,0,4,0,0,1,0,3,5,1
1723,53140,Jf77UYIvUtofHBGpvQMQ0qUfMZBh9rRJ,A3fsA9Zfv1X2fVEQhTw51lKENdNrEqT3,1,0,0,0,0,0,1,0,1,0.14285714285714285,1,0.0,0,0,0,0,0,0,0,1,0,0,1,1
1724,53163,MxIyDpIx03wSGr0H52jiRE3GZR3Xt5iM,SpATywNh6bZuzm8s1ceuBUnMUAeoAHHw,6,3,2,0,2,0,1,0,8,1.1428571428571428,1,0.0,0,2,0,2,3,0,0,1,0,4,4,1
1725,53170,BBcMLJIRqEjAV0Iy0PZLL6aDRdsecvdG,G8EPVSXsOYB5YQWZGiz1aVq5Pgr2GrQu,6,4,1,0,0,0,2,0,7,1.0,1,0.0,0,1,0,0,4,0,0,2,0,1,6,1
1726,53194,5y4YA2mbDcwuEjNHeStgjLfqN1rsKZgP,SpATywNh6bZuzm8s1ceuBUnMUAeoAHHw,15,61,2,29,0,2,23,1,118,16.857142857142858,5,0.0,33,2,23,0,28,2,6,23,1,58,60,0
1727,53209,GOcyurvQpr52NaTeXKp3vF6yg377GcU5,SpATywNh6bZuzm8s1ceuBUnMUAeoAHHw,11,8,3,15,1,14,11,1,53,7.571428571428571,4,0.0,2,3,15,1,6,14,0,11,1,21,32,0
1728,53223,xv3zPM1UCM9DtQrJ8sbmGYaRlj8FtrlB,SpATywNh6bZuzm8s1ceuBUnMUAeoAHHw,8,11,2,0,1,1,8,1,24,3.4285714285714284,2,0.0,0,2,0,1,11,1,0,8,1,3,21,1
1729,53247,tHPSGx00vsFzhzr0zwBlWWarqJT4wPHF,A3fsA9Zfv1X2fVEQhTw51lKENdNrEqT3,8,3,2,6,1,0,4,0,16,2.2857142857142856,2,0.0,0,2,6,1,3,0,0,4,0,9,7,1
1730,53295,yo1PAd1hBwimD9OOoxvyi6mwQC5bfK9g,bWdj2GDclj5ofokWjzoa5jAwMkxCykd6,6,6,3,0,1,0,4,0,14,2.0,2,0.0,0,3,0,1,6,0,0,4,0,4,10,1
1731,53360,boitIxZvCZ9przAKAQqxtWTvavMJkqzn,SpATywNh6bZuzm8s1ceuBUnMUAeoAHHw,14,15,8,10,3,2,5,0,43,6.142857142857143,3,0.0,3,8,10,3,12,2,0,5,0,24,19,0
1732,53368,mf00J2vS5aNSPGjL8Bq3W8G35vnnAtUS,SpATywNh6bZuzm8s1ceuBUnMUAeoAHHw,18,26,7,21,4,2,12,2,74,10.571428571428571,2,0.0,11,7,17,4,15,2,4,12,2,39,35,1
1733,53381,hJ48EYDAUcnIubJFw4NRxQxCK6ApJIxf,SpATywNh6bZuzm8s1ceuBUnMUAeoAHHw,10,11,0,12,0,4,5,0,32,4.571428571428571,1,0.0,4,0,12,0,7,4,0,5,0,16,16,1
1734,53421,oyKGOSyMOi0AM9nt7p8h8Y1cF1HEnPtq,SpATywNh6bZuzm8s1ceuBUnMUAeoAHHw,1,0,0,0,0,0,1,0,1,0.14285714285714285,1,0.0,0,0,0,0,0,0,0,1,0,0,1,1
1735,53453,A4vEkOAwhpQEgLFKtjOc7tdIxawwQcIi,SpATywNh6bZuzm8s1ceuBUnMUAeoAHHw,16,42,22,10,12,3,13,0,102,14.571428571428571,2,0.0,8,22,8,12,34,3,2,13,0,50,52,1
1736,53462,9rLNySnV0yxkzZA7V8enLIbzXZCrF6IJ,RXDvfPUBYFlVdlueBFbLW0mhhAyGEqpt,49,41,28,74,13,8,10,0,174,24.857142857142858,2,0.0,7,28,70,13,34,8,4,10,0,118,56,0
1737,53483,t20VhGjJQwmwXV8X5LeBQDucO3YuiMru,SpATywNh6bZuzm8s1ceuBUnMUAeoAHHw,2,0,0,0,0,4,1,0,5,0.7142857142857143,1,0.0,0,0,0,0,0,4,0,1,0,0,5,0
1738,53484,WyWFczdn2Y2i2D9wUJkB93D49zn2CheK,SpATywNh6bZuzm8s1ceuBUnMUAeoAHHw,1,0,0,0,0,0,1,0,1,0.14285714285714285,1,0.0,0,0,0,0,0,0,0,1,0,0,1,0
1739,53565,0HsU2yFVHR5yKm9Hke3oyrM0twIu2eg3,bWdj2GDclj5ofokWjzoa5jAwMkxCykd6,4,2,0,0,0,0,2,0,4,0.5714285714285714,1,0.0,0,0,0,0,2,0,0,2,0,0,4,1
1740,53587,VDscv2ylkQ5hVjxSl7FzkFmJDmBcIaMr,A3fsA9Zfv1X2fVEQhTw51lKENdNrEqT3,27,11,5,76,3,0,3,0,98,14.0,1,0.0,5,5,72,3,6,0,4,3,0,85,13,1
1741,53596,fHnWrc914HQUCHZRKa2nPteHkVOkvlJI,SpATywNh6bZuzm8s1ceuBUnMUAeoAHHw,14,28,2,14,1,5,9,0,59,8.428571428571429,2,0.0,12,2,13,1,16,5,1,9,0,28,31,0
1742,53649,dtP0jNvfsrthiSc4EbxmbNOv0Ufz6AhB,RXDvfPUBYFlVdlueBFbLW0mhhAyGEqpt,1,0,0,0,0,0,1,0,1,0.14285714285714285,1,0.0,0,0,0,0,0,0,0,1,0,0,1,1
1743,53666,uxWS9amhXxmjOvqXmZExJSg0LcMFBAvq,RXDvfPUBYFlVdlueBFbLW0mhhAyGEqpt,11,5,4,0,3,0,20,1,33,4.714285714285714,2,0.0,0,4,0,3,5,0,0,20,1,7,26,1
1744,53718,Ar22lkOE5FvesxoMKtYhm8Cbv4MUQUYF,SpATywNh6bZuzm8s1ceuBUnMUAeoAHHw,7,1,1,0,1,0,4,0,7,1.0,1,0.0,0,1,0,1,1,0,0,4,0,2,5,1
1745,53721,lSVRjk6dkgEmIe9I21hvsRF98Lf2IKdM,SpATywNh6bZuzm8s1ceuBUnMUAeoAHHw,14,22,12,9,6,3,5,0,57,8.142857142857142,1,0.0,5,12,9,6,17,3,0,5,0,32,25,1
1746,53766,KIPXc8MOqmnlmMqnIzIeaBqliIw9pS44,SpATywNh6bZuzm8s1ceuBUnMUAeoAHHw,17,25,13,9,7,8,13,4,79,11.285714285714286,2,0.0,7,13,9,7,18,8,0,13,4,36,43,1
1747,53786,L5GEhRbHdd9onnNJ8EJkvOQW3HytY3G8,SpATywNh6bZuzm8s1ceuBUnMUAeoAHHw,2,0,0,0,0,0,2,0,2,0.2857142857142857,1,0.0,0,0,0,0,0,0,0,2,0,0,2,1
1748,53792,p62iTg6ZpvzODJCBLH2d7SVfdoSWuy8j,RXDvfPUBYFlVdlueBFbLW0mhhAyGEqpt,24,41,25,9,16,1,10,2,104,14.857142857142858,2,0.0,5,25,9,16,36,1,0,10,2,55,49,0
1749,53805,sytW49I21SJ70ElOkXGU5SHeeHl1E3fL,A3fsA9Zfv1X2fVEQhTw51lKENdNrEqT3,7,3,2,0,1,0,5,0,11,1.5714285714285714,2,0.0,0,2,0,1,3,0,0,5,0,3,8,1
1750,53835,8rXJHeqrLpho5nIQgbDcpBTvBrVnGged,bWdj2GDclj5ofokWjzoa5jAwMkxCykd6,5,4,2,0,1,0,3,0,10,1.4285714285714286,1,0.0,0,2,0,1,4,0,0,3,0,3,7,1
1751,53865,jKfEyfk0HFbzE5vAszOX5qLRWBhzLYt2,A3fsA9Zfv1X2fVEQhTw51lKENdNrEqT3,1,0,0,0,0,0,1,0,1,0.14285714285714285,1,0.0,0,0,0,0,0,0,0,1,0,0,1,1
1752,54054,W3FcEvxr2cIwq2NIdATNIqtjoGLetLLn,bWdj2GDclj5ofokWjzoa5jAwMkxCykd6,4,2,1,0,1,0,1,0,5,0.7142857142857143,1,0.0,0,1,0,1,2,0,0,1,0,2,3,1
1753,54086,uIIavYxNuEJ6NG2Ex383dBZvdILceLZJ,SpATywNh6bZuzm8s1ceuBUnMUAeoAHHw,4,2,1,0,1,0,1,0,5,0.7142857142857143,1,0.0,0,1,0,1,2,0,0,1,0,2,3,0
1754,54100,ULxriJOFgcYW8OKrxzYPWeTN4MYJZpRj,SpATywNh6bZuzm8s1ceuBUnMUAeoAHHw,11,32,3,6,2,0,6,0,49,7.0,4,0.0,3,3,6,2,29,0,0,6,0,14,35,1
1755,54105,On4dVQn2MRHkwqRorWIyGST4bzaBJgjb,SpATywNh6bZuzm8s1ceuBUnMUAeoAHHw,6,3,2,0,2,0,1,0,8,1.1428571428571428,1,0.0,0,2,0,2,3,0,0,1,0,4,4,1
1756,54107,puAOKUG4MdJZvu6TGCieg6bgD5WGJ0qf,bWdj2GDclj5ofokWjzoa5jAwMkxCykd6,15,13,8,68,0,34,7,1,131,18.714285714285715,1,0.0,3,8,65,0,10,34,3,7,1,76,55,1
1757,54112,GASbwPXxwryodKV3AqYKdU5jEaEhIE7r,SpATywNh6bZuzm8s1ceuBUnMUAeoAHHw,12,10,0,5,0,0,9,2,26,3.7142857142857144,2,0.0,2,0,4,0,8,0,1,9,2,6,20,0
1758,54120,S9bleRJbl0xJFa4yPXuTgULWJ67nbMqi,SpATywNh6bZuzm8s1ceuBUnMUAeoAHHw,12,18,12,8,9,0,2,0,49,7.0,2,0.0,3,12,8,9,15,0,0,2,0,32,17,0
1759,54151,6f80AuCxgLhEz4q3r0Z7Tne4jeBhxVpZ,SpATywNh6bZuzm8s1ceuBUnMUAeoAHHw,18,62,21,18,8,22,32,5,168,24.0,2,0.0,14,21,15,8,48,22,3,32,5,58,110,0
1760,54156,QYaJtD7z5M6YcGNpdHV2JTsxqV4tXm9a,SpATywNh6bZuzm8s1ceuBUnMUAeoAHHw,14,17,10,6,0,0,6,0,39,5.571428571428571,2,0.0,5,10,6,0,12,0,0,6,0,21,18,0
1761,54189,cN6OZq4ak5IqzN7Lw32XLOS12DhlWO8Q,A3fsA9Zfv1X2fVEQhTw51lKENdNrEqT3,42,54,28,86,11,18,9,1,207,29.571428571428573,1,0.0,6,28,68,11,48,18,18,9,1,113,94,0
1762,54193,smg4SHkT0uQ59GP6Camalxkw6c32vtzM,SpATywNh6bZuzm8s1ceuBUnMUAeoAHHw,15,27,7,8,5,0,7,0,54,7.714285714285714,2,0.0,5,7,7,5,22,0,1,7,0,24,30,0
1763,54196,4mLn5YrkZbnxPXEuAYTSn9TKZyVmWQjo,SpATywNh6bZuzm8s1ceuBUnMUAeoAHHw,6,12,1,0,1,0,1,0,15,2.142857142857143,1,0.0,0,1,0,1,12,0,0,1,0,2,13,0
1764,54209,ke8J6J68PMmqZ8rK8FCDUgXlLZQpLLZW,bWdj2GDclj5ofokWjzoa5jAwMkxCykd6,18,29,11,100,8,7,8,1,164,23.428571428571427,3,0.0,7,11,93,8,22,7,7,8,1,119,45,1
1765,54230,RJ1FVW8gXQIpK321uzh2Sh69ojlsqnvg,A3fsA9Zfv1X2fVEQhTw51lKENdNrEqT3,10,5,3,0,2,2,11,2,25,3.5714285714285716,1,0.0,0,3,0,2,5,2,0,11,2,5,20,0
1766,54403,IiprEhfBJUF3Volv4Wt8hDKs67azhw4N,SpATywNh6bZuzm8s1ceuBUnMUAeoAHHw,15,27,1,18,0,52,20,4,122,17.428571428571427,5,0.0,8,1,15,0,19,52,3,20,4,24,98,0
1767,54406,WK8aAMlHaWKAnJlGkt1oHqYhwnCNU9kd,SpATywNh6bZuzm8s1ceuBUnMUAeoAHHw,2,0,0,0,0,4,3,0,7,1.0,1,0.0,0,0,0,0,0,4,0,3,0,0,7,1
1768,54441,jWzOKFReJZdfMoypRkZGX0AJ4yOxVurG,SpATywNh6bZuzm8s1ceuBUnMUAeoAHHw,17,48,12,29,3,13,22,1,128,18.285714285714285,4,0.0,30,12,22,3,18,13,7,22,1,67,61,1
1769,54454,xPyi5tVWLdzwESKbVSwWQTZrKjlUSal4,A3fsA9Zfv1X2fVEQhTw51lKENdNrEqT3,7,4,1,0,1,0,6,0,12,1.7142857142857142,2,0.0,0,1,0,1,4,0,0,6,0,2,10,1
1770,54466,X0qRVbMFwtmOOuQv50UvryYfYmnstiNp,RXDvfPUBYFlVdlueBFbLW0mhhAyGEqpt,9,9,0,0,0,0,2,0,11,1.5714285714285714,3,0.0,0,0,0,0,9,0,0,2,0,0,11,1
1771,54474,2cQfWhwRUGUv48S47s2aDWYzSM5LRy6r,SpATywNh6bZuzm8s1ceuBUnMUAeoAHHw,14,23,1,18,0,0,12,1,55,7.857142857142857,4,0.0,6,1,15,0,17,0,3,12,1,22,33,1
1772,54513,wD600Vm6nYpRlm6dPdneFPtwC1POqb2E,SpATywNh6bZuzm8s1ceuBUnMUAeoAHHw,13,32,14,20,5,0,9,0,80,11.428571428571429,3,0.0,8,14,16,5,24,0,4,9,0,43,37,1
1773,54560,PuyGNo8qc6xk0x7N225chheH1U0jpEmh,SpATywNh6bZuzm8s1ceuBUnMUAeoAHHw,13,18,7,10,0,0,8,0,43,6.142857142857143,1,0.0,7,7,8,0,11,0,2,8,0,22,21,0
1774,54631,cZaJE9WXhMzWTnSMxu0NdfVeWxOkn7lj,fbPkOYLVPtPgIt0MxizjfFJov3JbHyAi,6,3,1,0,1,0,2,0,7,1.0,1,0.0,0,1,0,1,3,0,0,2,0,2,5,1
1775,54662,2oTvbzieHn2y5oozeOgSnruqE6N0BtR5,fbPkOYLVPtPgIt0MxizjfFJov3JbHyAi,7,7,5,0,0,4,3,0,19,2.7142857142857144,1,0.0,0,5,0,0,7,4,0,3,0,5,14,1
1776,54714,GtuEelYfNaXxzKOllxbFfafnobOPHIGx,A3fsA9Zfv1X2fVEQhTw51lKENdNrEqT3,6,5,1,0,0,5,3,0,14,2.0,1,0.0,0,1,0,0,5,5,0,3,0,1,13,1
1777,54802,CyhW9ceUO9NYz6xFgPeXoLjeNitx4OvW,7GRhBDsirIGkRZBtSMEzNTyDr2JQm4xx,1,0,0,0,0,0,1,0,1,0.14285714285714285,1,0.0,0,0,0,0,0,0,0,1,0,0,1,1
1778,54874,zmKR9B5NLIRfAmSKdCbaIDXMZT9PoZip,7GRhBDsirIGkRZBtSMEzNTyDr2JQm4xx,1,0,0,0,0,0,1,0,1,0.14285714285714285,1,0.0,0,0,0,0,0,0,0,1,0,0,1,1
1779,54893,MZomFQTbHAKaDGd0B9fv7KQ9MRsZJ7m6,7GRhBDsirIGkRZBtSMEzNTyDr2JQm4xx,1,0,0,0,0,0,1,0,1,0.14285714285714285,1,0.0,0,0,0,0,0,0,0,1,0,0,1,1
1780,54970,YbQfcgwKrjskWW3wyOzQUUJYzdeHmY82,A3fsA9Zfv1X2fVEQhTw51lKENdNrEqT3,42,38,15,50,10,0,9,0,122,17.428571428571427,2,0.0,3,15,48,10,35,0,2,9,0,76,46,0
1781,55003,PnDN2WssnANedhxbDqo06cZR8VfXOHcf,SpATywNh6bZuzm8s1ceuBUnMUAeoAHHw,8,15,3,16,0,0,1,0,35,5.0,1,0.0,10,3,15,0,5,0,1,1,0,28,7,0
1782,55046,OsjipUObm67JsyJjOy7xHoa32L8CSYg5,7GRhBDsirIGkRZBtSMEzNTyDr2JQm4xx,1,0,0,0,0,0,2,0,2,0.2857142857142857,2,0.0,0,0,0,0,0,0,0,2,0,0,2,1
1783,55086,PfTpx7WgTJY6IpNokJ2POml34GMs7LTI,A3fsA9Zfv1X2fVEQhTw51lKENdNrEqT3,19,4,3,42,2,0,1,0,52,7.428571428571429,1,0.0,0,3,39,2,4,0,3,1,0,44,8,0
1784,55102,tC06tDcyfiakkQ82nvNuQ9hOr0id1lp4,A3fsA9Zfv1X2fVEQhTw51lKENdNrEqT3,24,12,10,0,9,17,4,1,53,7.571428571428571,1,0.0,0,10,0,9,12,17,0,4,1,19,34,1
1785,55108,oASR1hbK6DD6OJfTJCDKLW9l2vPgw7kR,SpATywNh6bZuzm8s1ceuBUnMUAeoAHHw,14,17,9,10,6,0,2,0,44,6.285714285714286,1,0.0,6,9,10,6,11,0,0,2,0,31,13,0
1786,55162,gKSJfTKRpPRCZVoRPeT84zeHU3dzpwjK,7GRhBDsirIGkRZBtSMEzNTyDr2JQm4xx,1,0,0,0,0,0,1,0,1,0.14285714285714285,1,0.0,0,0,0,0,0,0,0,1,0,0,1,1
1787,55222,sl5gnvWQxJCaKuNiDBTD8Gtex2riuepC,7GRhBDsirIGkRZBtSMEzNTyDr2JQm4xx,12,17,1,3,1,0,2,0,24,3.4285714285714284,1,0.0,3,1,3,1,14,0,0,2,0,8,16,1
1788,55268,yRP1A8CWHIiqi7L2SKgryjvGOEaUovOk,SpATywNh6bZuzm8s1ceuBUnMUAeoAHHw,13,22,3,21,1,1,9,2,59,8.428571428571429,2,0.0,8,3,17,1,14,1,4,9,2,29,30,0
1789,55324,b9PnER5aWf7HLwZ7RJ62h9NvkqSBL8ua,7GRhBDsirIGkRZBtSMEzNTyDr2JQm4xx,1,0,0,0,0,0,1,0,1,0.14285714285714285,1,0.0,0,0,0,0,0,0,0,1,0,0,1,1
1790,55335,YPEupTuOqSGieSSneZcv3AcUcSBCtbGY,RXDvfPUBYFlVdlueBFbLW0mhhAyGEqpt,8,6,0,13,1,0,2,0,22,3.142857142857143,1,0.0,3,0,13,1,3,0,0,2,0,17,5,1
1791,55362,xkt3K6JWpnfeixDBdwkLXaHgXuuGt35v,7GRhBDsirIGkRZBtSMEzNTyDr2JQm4xx,30,60,24,51,15,0,9,0,159,22.714285714285715,5,0.0,23,24,45,15,37,0,6,9,0,107,52,1
1792,55394,4mCA51pF01hkyB9Dsn8cU0qpfh1iqOVS,7GRhBDsirIGkRZBtSMEzNTyDr2JQm4xx,5,2,0,0,1,0,2,0,5,0.7142857142857143,1,0.0,0,0,0,1,2,0,0,2,0,1,4,1
1793,55398,46OTr627jSWtC8wrPe4BZiyNeqDxFeE3,SpATywNh6bZuzm8s1ceuBUnMUAeoAHHw,12,20,3,24,2,0,6,0,55,7.857142857142857,2,0.0,5,3,19,2,15,0,5,6,0,29,26,0
1794,55482,87SYGQjFYUtEWda0pG12bcNker0JGBy3,SpATywNh6bZuzm8s1ceuBUnMUAeoAHHw,13,26,1,12,0,11,9,1,60,8.571428571428571,3,0.0,5,1,12,0,21,11,0,9,1,18,42,1
1795,55543,pUCIPJW1P8mn7ehxRb7s9lkHivSStKgb,7GRhBDsirIGkRZBtSMEzNTyDr2JQm4xx,12,13,2,0,2,0,5,0,22,3.142857142857143,2,0.0,0,2,0,2,13,0,0,5,0,4,18,1
1796,55554,iN5LRJ62Fzny0HSOI77UB3W5oJ1HoHwK,7GRhBDsirIGkRZBtSMEzNTyDr2JQm4xx,2,0,0,0,0,0,3,0,3,0.42857142857142855,1,0.0,0,0,0,0,0,0,0,3,0,0,3,1
1797,55606,QuPJMxHrI2abilMygWFCmLFsgGUQO9Wm,bWdj2GDclj5ofokWjzoa5jAwMkxCykd6,12,17,11,10,6,17,8,1,70,10.0,2,0.0,1,11,8,6,16,17,2,8,1,26,44,1
1798,55676,0KWLX80Me9j0YMYrLboMuYM0mrVWxRud,7GRhBDsirIGkRZBtSMEzNTyDr2JQm4xx,32,50,24,42,5,40,18,2,181,25.857142857142858,1,0.0,18,24,36,5,32,40,6,18,2,83,98,0
1799,55731,ybcsmPlarjax7Mq4kzteIAIZbYqmFvSY,G8EPVSXsOYB5YQWZGiz1aVq5Pgr2GrQu,13,18,9,68,0,2,5,0,102,14.571428571428571,3,0.0,1,9,67,0,17,2,1,5,0,77,25,0
1800,55813,gykRbA7iJUFygOkXv9mNdsHLTYvvd4jI,bWdj2GDclj5ofokWjzoa5jAwMkxCykd6,11,22,1,78,1,35,22,7,166,23.714285714285715,1,0.0,5,1,77,1,17,35,1,22,7,84,82,1
1801,55818,EQ7wf57Maxtqueh0jcALSwDsSR4NE6Fa,7GRhBDsirIGkRZBtSMEzNTyDr2JQm4xx,1,0,0,0,0,0,1,0,1,0.14285714285714285,1,0.0,0,0,0,0,0,0,0,1,0,0,1,1
1802,55828,bXhvLL1DQzEIjyGvSUCfqx2LTtxg4cK2,7GRhBDsirIGkRZBtSMEzNTyDr2JQm4xx,34,55,22,40,18,61,15,1,212,30.285714285714285,3,0.0,27,22,32,18,28,61,8,15,1,99,113,1
1803,55852,zC2jRq3r9EI7fiKmdxBaoujmdY4A8FN5,G8EPVSXsOYB5YQWZGiz1aVq5Pgr2GrQu,10,7,1,6,0,2,7,2,25,3.5714285714285716,1,0.0,1,1,5,0,6,2,1,7,2,7,18,0
1804,55918,JOqHNkiAQMopMtNnxSpHdAOKSp68V43j,A3fsA9Zfv1X2fVEQhTw51lKENdNrEqT3,31,10,7,54,3,4,4,0,82,11.714285714285714,1,0.0,1,7,47,3,9,4,7,4,0,58,24,1
1805,55967,EK7Y6jLbcTIHEzN8KJHD55mY3w7SjZfJ,SpATywNh6bZuzm8s1ceuBUnMUAeoAHHw,15,32,10,11,4,50,8,0,115,16.428571428571427,1,0.0,15,10,10,4,17,50,1,8,0,39,76,1
1806,55978,JVRk883TChkd8D0ZSH6CEb3OUHD06lXQ,SpATywNh6bZuzm8s1ceuBUnMUAeoAHHw,17,27,14,20,8,2,11,3,85,12.142857142857142,2,0.0,10,14,17,8,17,2,3,11,3,49,36,0
1807,55979,P7MRSD3CXumEAUVQkOjfu7iyOA6WzwhX,7GRhBDsirIGkRZBtSMEzNTyDr2JQm4xx,7,8,3,4,3,0,1,0,19,2.7142857142857144,1,0.0,1,3,4,3,7,0,0,1,0,11,8,0
1808,56003,UqClTQDqKMNYDPHUpaTnYqiluGgaVwby,7GRhBDsirIGkRZBtSMEzNTyDr2JQm4xx,25,31,15,25,8,7,5,0,91,13.0,2,0.0,13,15,20,8,18,7,5,5,0,56,35,1
1809,56004,o9m1fMq17KjyGUhfLHLXFO5hoKQ5jU6O,A3fsA9Zfv1X2fVEQhTw51lKENdNrEqT3,1,0,0,0,0,0,1,0,1,0.14285714285714285,1,0.0,0,0,0,0,0,0,0,1,0,0,1,1
1810,56058,c162xBeHQ1ehzoWsokUc8kKEtu9gLIte,SpATywNh6bZuzm8s1ceuBUnMUAeoAHHw,14,11,5,9,4,0,4,0,33,4.714285714285714,1,0.0,5,5,9,4,6,0,0,4,0,23,10,0
1811,56062,pKCzqYDvJAlWQNOnHiIQZJLfMk8J7wCX,G8EPVSXsOYB5YQWZGiz1aVq5Pgr2GrQu,13,18,4,30,4,11,11,8,86,12.285714285714286,1,0.0,14,4,26,4,4,11,4,11,8,48,38,0
1812,56078,kKj1FlDO03hIJs4qO2fYyQxEzv7HbwXh,SpATywNh6bZuzm8s1ceuBUnMUAeoAHHw,15,26,10,10,5,0,3,0,54,7.714285714285714,2,0.0,11,10,9,5,15,0,1,3,0,35,19,1
1813,56081,Ybi3cFvDqy1VWHiDJ2n2dPI1NwP5ZaHo,7GRhBDsirIGkRZBtSMEzNTyDr2JQm4xx,1,0,0,0,0,0,1,0,1,0.14285714285714285,1,0.0,0,0,0,0,0,0,0,1,0,0,1,1
1814,56090,CXsZzvE3iylo5KzyiPoa1X1kRLwsS4Km,7GRhBDsirIGkRZBtSMEzNTyDr2JQm4xx,2,0,0,0,0,0,2,0,2,0.2857142857142857,1,0.0,0,0,0,0,0,0,0,2,0,0,2,1
1815,56114,PmaZVK1XohXhK9MuIDoeUlsnQ3xunZ0o,SpATywNh6bZuzm8s1ceuBUnMUAeoAHHw,6,6,1,0,1,0,5,0,13,1.8571428571428572,2,0.0,0,1,0,1,6,0,0,5,0,2,11,1
1816,56138,0K6JPqiivQzicxY4EV4nqMLCL3a08A97,7GRhBDsirIGkRZBtSMEzNTyDr2JQm4xx,19,29,17,22,13,3,7,0,91,13.0,2,0.0,11,17,19,13,18,3,3,7,0,60,31,1
1817,56154,hcrd0JfkIltpZTYyzvBezmjxNHV3TQ2P,7GRhBDsirIGkRZBtSMEzNTyDr2JQm4xx,31,53,16,51,22,16,6,0,164,23.428571428571427,2,0.0,33,16,46,22,20,16,5,6,0,117,47,1
1818,56169,TNAUZUlDZyGbJQN7wls2QRBe2Cw7eeSK,bWdj2GDclj5ofokWjzoa5jAwMkxCykd6,2,0,0,0,0,0,2,0,2,0.2857142857142857,1,0.0,0,0,0,0,0,0,0,2,0,0,2,0
1819,56189,sMMDk03UePJILkRIn5YDW5tA5us6h51J,SpATywNh6bZuzm8s1ceuBUnMUAeoAHHw,18,20,10,12,4,1,11,1,59,8.428571428571429,2,0.0,4,10,10,4,16,1,2,11,1,28,31,1
1820,56221,mxDmiNiZbTWbG5eX6cuqeU6lZnYbJUhB,SpATywNh6bZuzm8s1ceuBUnMUAeoAHHw,9,13,5,0,0,4,16,1,39,5.571428571428571,2,0.0,1,5,0,0,12,4,0,16,1,6,33,0
1821,56234,qYhoMsNGFfjRIDh2DmSOTAEOExxbLNsi,7GRhBDsirIGkRZBtSMEzNTyDr2JQm4xx,8,8,4,0,1,1,5,0,19,2.7142857142857144,1,0.0,1,4,0,1,7,1,0,5,0,6,13,1
1822,56237,PlHOy9sO4wpd56kVnMDoRd2P9dW85wrW,A3fsA9Zfv1X2fVEQhTw51lKENdNrEqT3,3,0,0,0,0,0,6,0,6,0.8571428571428571,1,0.0,0,0,0,0,0,0,0,6,0,0,6,1
1823,56242,aJc8aUAetxPPGWFRPX4YOEm2nyZUaAWd,7GRhBDsirIGkRZBtSMEzNTyDr2JQm4xx,8,12,6,4,5,0,4,0,31,4.428571428571429,1,0.0,2,6,3,5,10,0,1,4,0,16,15,1
1824,56351,9EUUO7h64xEMsIYSdMrVOb4PBS93f8Du,SpATywNh6bZuzm8s1ceuBUnMUAeoAHHw,8,4,2,0,2,0,2,0,10,1.4285714285714286,1,0.0,0,2,0,2,4,0,0,2,0,4,6,1
1825,56363,JLoCQORXjvwdLxTSzHD1j5idBdhZN6jK,7GRhBDsirIGkRZBtSMEzNTyDr2JQm4xx,5,0,0,0,0,2,7,0,9,1.2857142857142858,1,0.0,0,0,0,0,0,2,0,7,0,0,9,1
1826,56380,4GCUZawdASarA3TMg6HAfW2kyE7xYxA6,7GRhBDsirIGkRZBtSMEzNTyDr2JQm4xx,2,0,0,0,0,0,2,0,2,0.2857142857142857,1,0.0,0,0,0,0,0,0,0,2,0,0,2,1
1827,56410,m7ppZFqoqxq4drq32V7wzPII9oNFXP01,SpATywNh6bZuzm8s1ceuBUnMUAeoAHHw,14,17,10,8,4,4,5,0,48,6.857142857142857,1,0.0,2,10,8,4,15,4,0,5,0,24,24,0
1828,56464,mUGiOApqSIPNJJAxx9ku1Ubhn4j7vYNp,SpATywNh6bZuzm8s1ceuBUnMUAeoAHHw,13,37,0,11,0,27,7,0,82,11.714285714285714,2,0.0,9,0,10,0,28,27,1,7,0,19,63,0
1829,56502,YAaB5kbzMpno3yyQhEjSC43PC6r4FUut,A3fsA9Zfv1X2fVEQhTw51lKENdNrEqT3,1,0,0,0,0,0,1,0,1,0.14285714285714285,1,0.0,0,0,0,0,0,0,0,1,0,0,1,1
1830,56505,K9sZStDxVlzslbizXAYcyYp63PWAyvJs,bWdj2GDclj5ofokWjzoa5jAwMkxCykd6,10,25,11,26,9,3,8,0,82,11.714285714285714,2,0.0,7,11,23,9,18,3,3,8,0,50,32,1
1831,56507,yh14zaFitCUTgvBPqRXiaZ6cUijtktL4,7GRhBDsirIGkRZBtSMEzNTyDr2JQm4xx,5,7,0,2,0,0,1,0,10,1.4285714285714286,1,0.0,1,0,2,0,6,0,0,1,0,3,7,1
1832,56516,yreSFZev8w2vccLGmUPWniYPFTHUVYuW,SpATywNh6bZuzm8s1ceuBUnMUAeoAHHw,16,20,4,21,3,10,7,1,66,9.428571428571429,1,0.0,15,4,18,3,5,10,3,7,1,40,26,1
1833,56566,6qgQAmX6y5wh5nEPRINOiKrZNoTl5yfT,G8EPVSXsOYB5YQWZGiz1aVq5Pgr2GrQu,85,115,32,170,28,43,11,0,399,57.0,4,0.0,72,32,106,28,43,43,64,11,0,238,161,0
1834,56617,hhlID9e9RXNsuOHzHvfjbzrkpQmbpeir,SpATywNh6bZuzm8s1ceuBUnMUAeoAHHw,14,19,12,8,5,9,6,1,60,8.571428571428571,4,0.0,3,12,8,5,16,9,0,6,1,28,32,1
1835,56628,nx5QFDeL3HGj8P6Q50AF1WAJHhbCqdYM,7GRhBDsirIGkRZBtSMEzNTyDr2JQm4xx,1,0,0,0,0,0,1,0,1,0.14285714285714285,1,0.0,0,0,0,0,0,0,0,1,0,0,1,1
1836,56636,PdrdE0IIRUHKPZyUMDrlUIJ0Ny8UuZco,A3fsA9Zfv1X2fVEQhTw51lKENdNrEqT3,37,31,17,62,7,1,13,1,132,18.857142857142858,3,0.0,4,17,58,7,27,1,4,13,1,86,46,1
1837,56642,7ttzq6sOsWQ5eEpZriKP7OLuIb0DcSbF,SpATywNh6bZuzm8s1ceuBUnMUAeoAHHw,15,14,6,18,3,3,3,0,47,6.714285714285714,1,0.0,7,6,15,3,7,3,3,3,0,31,16,0
1838,56652,uHeTIz8GkglZUts3zio1tGR2aBoYwiQE,bWdj2GDclj5ofokWjzoa5jAwMkxCykd6,18,36,17,86,12,36,6,1,194,27.714285714285715,2,0.0,9,17,83,12,27,36,3,6,1,121,73,1
1839,56653,A0M3i5nfjroJ4PM9wmVXYOoLY3tY0fag,SpATywNh6bZuzm8s1ceuBUnMUAeoAHHw,5,10,3,0,1,1,1,0,16,2.2857142857142856,1,0.0,0,3,0,1,10,1,0,1,0,4,12,0
1840,56758,3X0JLX6UvJnnRb5GkwbFJgAokE5g69D0,A3fsA9Zfv1X2fVEQhTw51lKENdNrEqT3,6,8,5,0,1,0,2,0,16,2.2857142857142856,1,0.0,0,5,0,1,8,0,0,2,0,6,10,1
1841,56787,73lhhrOcE2srJj5BkIzSweWSnQRZBT2o,bWdj2GDclj5ofokWjzoa5jAwMkxCykd6,13,46,26,42,0,0,10,0,124,17.714285714285715,6,0.0,10,26,40,0,36,0,2,10,0,76,48,1
1842,56824,1NMKAl678ZBpdBkhXfYTAgEyYygMZz0x,SpATywNh6bZuzm8s1ceuBUnMUAeoAHHw,7,16,1,0,1,1,1,0,20,2.857142857142857,1,0.0,5,1,0,1,11,1,0,1,0,7,13,1
1843,56826,ilWzYGLWBh9DSc1MV8g2C4Go5wDNgUHX,A3fsA9Zfv1X2fVEQhTw51lKENdNrEqT3,16,13,12,0,12,7,4,0,48,6.857142857142857,1,0.0,0,12,0,12,13,7,0,4,0,24,24,0
1844,56867,qDignCY8ZSbFAHDmfGr6um90qnmxvInL,bWdj2GDclj5ofokWjzoa5jAwMkxCykd6,6,6,3,0,2,1,4,1,17,2.4285714285714284,1,0.0,0,3,0,2,6,1,0,4,1,5,12,1
1845,56959,qZhmmNUvkNXdf3u04DTUQOFEBxxO10p4,A3fsA9Zfv1X2fVEQhTw51lKENdNrEqT3,4,2,0,0,0,0,2,0,4,0.5714285714285714,2,0.0,0,0,0,0,2,0,0,2,0,0,4,1
1846,56999,vbTgITzq6jZRj0oUV5gFotgOlwSXnjML,G8EPVSXsOYB5YQWZGiz1aVq5Pgr2GrQu,1,0,0,0,0,0,1,0,1,0.14285714285714285,1,0.0,0,0,0,0,0,0,0,1,0,0,1,0
1847,57029,I7IIrHAh1LzzCf8lcvI92o8deFulzAh8,SpATywNh6bZuzm8s1ceuBUnMUAeoAHHw,2,0,0,0,0,0,2,0,2,0.2857142857142857,1,0.0,0,0,0,0,0,0,0,2,0,0,2,1
1848,57044,I7IIrHAh1LzzCf8lcvI92o8deFulzAh8,bWdj2GDclj5ofokWjzoa5jAwMkxCykd6,1,0,0,0,0,0,1,0,1,0.14285714285714285,1,0.0,0,0,0,0,0,0,0,1,0,0,1,1
1849,57196,9hgjLw4OD5u1XjZx0s9EMRnEguVXBlYy,A3fsA9Zfv1X2fVEQhTw51lKENdNrEqT3,11,5,4,0,4,0,2,0,15,2.142857142857143,1,0.0,0,4,0,4,5,0,0,2,0,8,7,1
1850,57250,3Jq0rhguTOZ7fja70sOOKUPAPqu7fQyT,SpATywNh6bZuzm8s1ceuBUnMUAeoAHHw,14,20,13,11,5,41,11,0,101,14.428571428571429,2,0.0,2,13,9,5,18,41,2,11,0,29,72,0
1851,57277,bt7h6JIDcUKzJSKeXMoVM1LEqwbXUCBJ,SpATywNh6bZuzm8s1ceuBUnMUAeoAHHw,12,48,3,14,0,1,16,0,82,11.714285714285714,3,0.0,9,3,12,0,39,1,2,16,0,24,58,0
1852,57323,xayicpjClPkwcfGTr3r84hb5pfZk0nB8,RXDvfPUBYFlVdlueBFbLW0mhhAyGEqpt,23,18,15,2,12,6,4,3,60,8.571428571428571,1,0.0,0,15,2,12,18,6,0,4,3,29,31,1
1853,57327,RdOaDfHEeBBslFA96Ipf8QaGmA7wq7Rz,SpATywNh6bZuzm8s1ceuBUnMUAeoAHHw,16,27,15,13,4,1,7,0,67,9.571428571428571,3,0.0,7,15,10,4,20,1,3,7,0,36,31,0
1854,57329,XyoP35cBUiKk44G72mbtEXCBjk8FmHfo,bWdj2GDclj5ofokWjzoa5jAwMkxCykd6,2,0,0,0,0,0,2,0,2,0.2857142857142857,1,0.0,0,0,0,0,0,0,0,2,0,0,2,1
1855,57345,SmBAgHRNeYWZKP2SpqpKXwVR3YhUZnjq,SpATywNh6bZuzm8s1ceuBUnMUAeoAHHw,12,11,0,18,0,12,7,0,48,6.857142857142857,2,0.0,6,0,15,0,5,12,3,7,0,21,27,0
1856,57525,OLSxCkluLildKVrVnzRIsj47tt9tVHj9,bWdj2GDclj5ofokWjzoa5jAwMkxCykd6,2,0,0,0,0,0,2,0,2,0.2857142857142857,1,0.0,0,0,0,0,0,0,0,2,0,0,2,1
1857,57657,r4CghvxKbP3R549p5B3LTdvr7lbYRqXF,G8EPVSXsOYB5YQWZGiz1aVq5Pgr2GrQu,22,38,15,20,4,25,15,2,119,17.0,1,0.0,16,15,12,4,22,25,8,15,2,47,72,0
1858,57761,tS5yd0InBPlA0CVUCBIjrGWKHeeeibf9,A3fsA9Zfv1X2fVEQhTw51lKENdNrEqT3,29,21,10,48,3,6,8,0,96,13.714285714285714,2,0.0,4,10,45,3,17,6,3,8,0,62,34,0
1859,57907,4lfVtIfwsnJZLFeonBqOpKEgIshst3Yq,SpATywNh6bZuzm8s1ceuBUnMUAeoAHHw,5,3,2,0,2,0,3,0,10,1.4285714285714286,2,0.0,0,2,0,2,3,0,0,3,0,4,6,0
1860,57910,se9ZVl8DNkiCW8i2nP0p3krrUcQqYC47,A3fsA9Zfv1X2fVEQhTw51lKENdNrEqT3,21,14,10,0,7,2,9,0,42,6.0,3,0.0,0,10,0,7,14,2,0,9,0,17,25,0
1861,57952,Axw4HBt3l6GD2DONFf7w1tmix5Mk5VUT,A3fsA9Zfv1X2fVEQhTw51lKENdNrEqT3,13,13,6,0,2,5,10,2,38,5.428571428571429,1,0.0,0,6,0,2,13,5,0,10,2,8,30,1
1862,57987,sqasMoGc0IU5lpNZsO5KtcLYxSWllMxq,RXDvfPUBYFlVdlueBFbLW0mhhAyGEqpt,46,52,12,68,13,18,22,8,193,27.571428571428573,2,0.0,19,12,65,13,33,18,3,22,8,109,84,0
1863,58013,Bf025FfgNrlcqN8gYGnmBAhjBy0v5Xmo,bWdj2GDclj5ofokWjzoa5jAwMkxCykd6,10,19,13,0,6,1,10,0,49,7.0,2,0.0,2,13,0,6,17,1,0,10,0,21,28,1
1864,58142,G2OV1K6QAb8ZlrDRCrLDF7tfA5J7JUDN,SpATywNh6bZuzm8s1ceuBUnMUAeoAHHw,14,20,7,22,3,2,4,0,58,8.285714285714286,1,0.0,8,7,19,3,12,2,3,4,0,37,21,1
1865,58217,v1amutsyDOYm3WMqvptGI8JyXdvsTElC,SpATywNh6bZuzm8s1ceuBUnMUAeoAHHw,15,29,7,21,2,3,15,2,79,11.285714285714286,2,0.0,9,7,18,2,20,3,3,15,2,36,43,1
1866,58282,Gqs4K8SBL8tl8fMHpBqpJerrgEsieHU3,SpATywNh6bZuzm8s1ceuBUnMUAeoAHHw,15,28,2,11,0,11,11,1,64,9.142857142857142,3,0.0,9,2,11,0,19,11,0,11,1,22,42,0
1867,58305,skJn7dtfSekFrPHRHs9swZ9AtSUKi36u,A3fsA9Zfv1X2fVEQhTw51lKENdNrEqT3,10,12,9,0,2,9,7,0,39,5.571428571428571,3,0.0,0,9,0,2,12,9,0,7,0,11,28,1
1868,58334,ROctVkWGGi4RH8QWmC2p1iWZZ8pihPaJ,SpATywNh6bZuzm8s1ceuBUnMUAeoAHHw,13,25,8,22,2,14,6,0,77,11.0,3,0.0,9,8,19,2,16,14,3,6,0,38,39,0
1869,58341,MU4dVyJTD7iIRSTZIdJZ9VoLOxogfKQN,SpATywNh6bZuzm8s1ceuBUnMUAeoAHHw,10,11,7,0,1,1,7,1,28,4.0,3,0.0,1,7,0,1,10,1,0,7,1,9,19,0
1870,58348,n2LjMxx7cFpUJ3R3HfCHwCtJjfcc1KR0,G8EPVSXsOYB5YQWZGiz1aVq5Pgr2GrQu,26,34,23,36,15,2,10,0,120,17.142857142857142,2,0.0,7,23,29,15,27,2,7,10,0,74,46,0
1871,58430,Ymf9IGFQ8uCjyMPNR9dFL9vuwfZDvaPV,SpATywNh6bZuzm8s1ceuBUnMUAeoAHHw,14,47,4,17,3,12,14,0,97,13.857142857142858,3,0.0,11,4,15,3,36,12,2,14,0,33,64,0
1872,58458,fgzbUfrTxXYCuiFYTG1cTemcEJUl36an,SpATywNh6bZuzm8s1ceuBUnMUAeoAHHw,18,44,23,9,5,5,19,1,106,15.142857142857142,3,0.0,5,23,9,5,39,5,0,19,1,42,64,0
1873,58509,HRP0Ut3HnZWoD62izV4kICPH3gchormt,SpATywNh6bZuzm8s1ceuBUnMUAeoAHHw,14,10,6,2,3,0,3,0,24,3.4285714285714284,1,0.0,0,6,2,3,10,0,0,3,0,11,13,0
1874,58535,tdWhb9WfoB7e0A5Gjo7JvSpPeeCoQg77,SpATywNh6bZuzm8s1ceuBUnMUAeoAHHw,14,23,9,16,3,0,5,0,56,8.0,1,0.0,5,9,15,3,18,0,1,5,0,32,24,0
1875,58626,AsYvTZR1ylqWCh3nfRxgHS2CzZpeou5v,SpATywNh6bZuzm8s1ceuBUnMUAeoAHHw,17,39,16,21,4,20,24,3,127,18.142857142857142,3,0.0,17,16,19,4,22,20,2,24,3,56,71,0
1876,58628,BvTWqNCI5Vv3DyY42Ht6x5bgcNEbXEjw,SpATywNh6bZuzm8s1ceuBUnMUAeoAHHw,14,18,7,8,4,0,3,0,40,5.714285714285714,4,0.0,2,7,8,4,16,0,0,3,0,21,19,1
1877,58661,t8qBiDTvOvYmrxcVIErRuEOf38tywm6t,SpATywNh6bZuzm8s1ceuBUnMUAeoAHHw,17,22,14,14,4,8,8,1,71,10.142857142857142,3,0.0,3,14,11,4,19,8,3,8,1,32,39,0
1878,58724,QEq8GPuIzTapWcXcWLs8dzh5C4ugJ6qX,G8EPVSXsOYB5YQWZGiz1aVq5Pgr2GrQu,43,99,43,80,25,17,11,2,277,39.57142857142857,3,0.0,44,43,55,25,55,17,25,11,2,167,110,0
1879,58851,HcP22z9Adhad0eR6ILSXQ1kzpXBgJlCr,bWdj2GDclj5ofokWjzoa5jAwMkxCykd6,4,3,0,0,0,0,3,0,6,0.8571428571428571,2,0.0,0,0,0,0,3,0,0,3,0,0,6,1
1880,58876,KynvXtYIsEUZo4QPbGVWVhUBwzeS3e9w,SpATywNh6bZuzm8s1ceuBUnMUAeoAHHw,6,3,2,0,2,0,1,0,8,1.1428571428571428,1,0.0,0,2,0,2,3,0,0,1,0,4,4,1
1881,58922,6HIBebNSnNEoSeekVShzxF3x0IcbgohT,SpATywNh6bZuzm8s1ceuBUnMUAeoAHHw,1,0,0,0,0,0,1,0,1,0.14285714285714285,1,0.0,0,0,0,0,0,0,0,1,0,0,1,1
1882,58996,w9HBKKfn4YUOWYdwRHKe80SIWiO37ZMJ,SpATywNh6bZuzm8s1ceuBUnMUAeoAHHw,13,20,14,0,8,1,13,0,56,8.0,4,0.0,1,14,0,8,19,1,0,13,0,23,33,0
1883,58997,1zErz13s8fNQRVaEvkOtvw6bLhr23yB4,bWdj2GDclj5ofokWjzoa5jAwMkxCykd6,5,12,6,0,2,0,4,0,24,3.4285714285714284,2,0.0,0,6,0,2,12,0,0,4,0,8,16,0
1884,59056,HPaDTzk2xymxbpoa0VdcxdHl3uFfOfZk,A3fsA9Zfv1X2fVEQhTw51lKENdNrEqT3,2,0,0,0,0,0,4,0,4,0.5714285714285714,2,0.0,0,0,0,0,0,0,0,4,0,0,4,1
1885,59132,3LOMe6pmkiIt95Dd5LqCGi1tBreM2BMk,A3fsA9Zfv1X2fVEQhTw51lKENdNrEqT3,4,3,0,0,0,0,1,0,4,0.5714285714285714,1,0.0,0,0,0,0,3,0,0,1,0,0,4,0
1886,59137,kqS8BwWN9R1093oeblGkvtCsQJ68Gh0G,bWdj2GDclj5ofokWjzoa5jAwMkxCykd6,4,2,1,0,1,0,1,0,5,0.7142857142857143,1,0.0,0,1,0,1,2,0,0,1,0,2,3,1
1887,60203,ntJs93C1h80peQsrk4sMYD3xVOjdEHeo,7GRhBDsirIGkRZBtSMEzNTyDr2JQm4xx,32,53,15,58,12,5,7,0,150,21.428571428571427,2,0.0,36,15,55,12,17,5,3,7,0,118,32,0
1888,60420,5hts9kMf50L6rxwk0MtgECu1e5TGRRGY,7GRhBDsirIGkRZBtSMEzNTyDr2JQm4xx,10,11,3,0,2,7,4,0,27,3.857142857142857,1,0.0,5,3,0,2,6,7,0,4,0,10,17,1
1889,61118,pGlV0XYWRjXFSIdN56x9p6AvQyXwsZVS,7GRhBDsirIGkRZBtSMEzNTyDr2JQm4xx,3,2,1,0,0,0,1,0,4,0.5714285714285714,1,0.0,0,1,0,0,2,0,0,1,0,1,3,0
1890,61594,gAvRDaA2RH7LeyEqnpEQ7DzPuz3btZqk,SpATywNh6bZuzm8s1ceuBUnMUAeoAHHw,11,16,6,8,0,7,5,1,43,6.142857142857143,3,0.0,9,6,7,0,7,7,1,5,1,22,21,0
1891,61595,3rZRyyAqQR0LHT7iXSTyhR4wZI7IzOpN,SpATywNh6bZuzm8s1ceuBUnMUAeoAHHw,10,9,1,12,1,0,1,0,24,3.4285714285714284,1,0.0,4,1,12,1,5,0,0,1,0,18,6,0
1892,61601,gLjUrp9o3bBy4JIhHE7DImScxZdU76o3,bWdj2GDclj5ofokWjzoa5jAwMkxCykd6,14,13,6,16,5,0,2,0,42,6.0,3,0.0,5,6,15,5,8,0,1,2,0,31,11,0
1893,61613,gF4BAuOIIfmyUL9KgVWqdIaoDpcXFfvU,SpATywNh6bZuzm8s1ceuBUnMUAeoAHHw,5,5,2,0,0,0,3,0,10,1.4285714285714286,1,0.0,0,2,0,0,5,0,0,3,0,2,8,1
1894,61633,nAYvdcBZT3LBrha8JRPtv9HcsoTpFg23,SpATywNh6bZuzm8s1ceuBUnMUAeoAHHw,7,5,1,16,0,0,2,0,24,3.4285714285714284,1,0.0,2,1,14,0,3,0,2,2,0,17,7,0
1895,61645,SFn8cPDrlBEOeUqlExt2aQA0JeO7ehU8,7GRhBDsirIGkRZBtSMEzNTyDr2JQm4xx,7,3,2,0,2,0,3,0,10,1.4285714285714286,1,0.0,0,2,0,2,3,0,0,3,0,4,6,1
1896,61783,9y6ouBDNmbaFfULhDrj0DUptWL9j98bK,A3fsA9Zfv1X2fVEQhTw51lKENdNrEqT3,9,4,2,0,2,0,5,0,13,1.8571428571428572,1,0.0,0,2,0,2,4,0,0,5,0,4,9,1
1897,61786,CE534SSZ9CscDvjbZWQWNUmxhQozf8Uw,SpATywNh6bZuzm8s1ceuBUnMUAeoAHHw,3,2,1,0,0,0,1,0,4,0.5714285714285714,1,0.0,0,1,0,0,2,0,0,1,0,1,3,0
1898,61807,6ewbhsgJh7NTFUpGTc6v0or3nCOYP5Dz,7GRhBDsirIGkRZBtSMEzNTyDr2JQm4xx,1,0,0,0,0,0,1,0,1,0.14285714285714285,1,0.0,0,0,0,0,0,0,0,1,0,0,1,1
1899,61841,Oqve774ifHTeH2UMCaBdRSrpGoboQSMz,7GRhBDsirIGkRZBtSMEzNTyDr2JQm4xx,2,0,0,0,0,0,2,0,2,0.2857142857142857,1,0.0,0,0,0,0,0,0,0,2,0,0,2,1
1900,61871,P3kOv3cSNYdczGGa8D095f64NMPEAkCq,7GRhBDsirIGkRZBtSMEzNTyDr2JQm4xx,13,17,1,10,0,2,10,2,42,6.0,1,0.0,6,1,8,0,11,2,2,10,2,15,27,0
1901,61873,GjYrFH6x4o6vyLHEw4EuuSJvAfuLPk1y,SpATywNh6bZuzm8s1ceuBUnMUAeoAHHw,4,4,3,0,3,0,1,0,11,1.5714285714285714,1,0.0,0,3,0,3,4,0,0,1,0,6,5,0
1902,61901,kMbNfi6zi59dGBz5Mew0yipwDJ0jO4S2,7GRhBDsirIGkRZBtSMEzNTyDr2JQm4xx,34,72,31,34,32,6,15,2,192,27.428571428571427,3,0.0,31,31,29,32,41,6,5,15,2,123,69,1
1903,62017,2YGBvXv59qjJLs5KOOScSmZh8Ujmphvd,7GRhBDsirIGkRZBtSMEzNTyDr2JQm4xx,7,12,5,0,1,1,2,0,21,3.0,2,0.0,4,5,0,1,8,1,0,2,0,10,11,1
1904,62027,NcracMTfiaTPMbO6SSDnt9CDc4SnvBs9,bWdj2GDclj5ofokWjzoa5jAwMkxCykd6,20,16,8,60,5,8,9,1,107,15.285714285714286,3,0.0,5,8,58,5,11,8,2,9,1,76,31,0
1905,62069,2Hz2Bz07sxK2sow8U4zT67rsa0lMVzzp,7GRhBDsirIGkRZBtSMEzNTyDr2JQm4xx,1,0,0,0,0,0,1,0,1,0.14285714285714285,1,0.0,0,0,0,0,0,0,0,1,0,0,1,1
1906,62071,gRHI1NeWW3c6BFrZIrJSlWu9NHDjRltm,7GRhBDsirIGkRZBtSMEzNTyDr2JQm4xx,1,0,0,0,0,0,1,0,1,0.14285714285714285,1,0.0,0,0,0,0,0,0,0,1,0,0,1,1
1907,62101,uJIh67cllxQLgAhipzdDZMEunDbuBxvF,SpATywNh6bZuzm8s1ceuBUnMUAeoAHHw,14,12,8,0,3,5,6,1,35,5.0,1,0.0,2,8,0,3,10,5,0,6,1,13,22,0
1908,62140,WmzYkzlMNuHgERGSMthySa2d3K7cWcp2,7GRhBDsirIGkRZBtSMEzNTyDr2JQm4xx,12,7,5,0,4,0,4,0,20,2.857142857142857,1,0.0,0,5,0,4,7,0,0,4,0,9,11,1
1909,62169,9t1Jq485XoOlmuEU542k0g35doAqmykj,SpATywNh6bZuzm8s1ceuBUnMUAeoAHHw,7,8,5,0,2,0,2,0,17,2.4285714285714284,1,0.0,0,5,0,2,8,0,0,2,0,7,10,0
1910,62213,QbN1rcT6X70kGcCCu9qHO2zQXGCyhPMc,SpATywNh6bZuzm8s1ceuBUnMUAeoAHHw,15,17,12,12,6,0,4,0,51,7.285714285714286,1,0.0,3,12,9,6,14,0,3,4,0,30,21,1
1911,62214,P9ocaJAKrVY3fEwlpYkQdiICF2x4gV0B,7GRhBDsirIGkRZBtSMEzNTyDr2JQm4xx,5,6,3,0,2,1,1,0,13,1.8571428571428572,1,0.0,1,3,0,2,5,1,0,1,0,6,7,0
1912,62334,mxPD6RdGoMu7JHsQZE9N0YGZHXBsDKre,7GRhBDsirIGkRZBtSMEzNTyDr2JQm4xx,6,1,1,0,1,0,4,0,7,1.0,1,0.0,0,1,0,1,1,0,0,4,0,2,5,1
1913,62349,YBtKAFQt6fk6EIukc4Ut5J2kdzYxomaP,SpATywNh6bZuzm8s1ceuBUnMUAeoAHHw,4,2,1,0,1,0,1,0,5,0.7142857142857143,1,0.0,0,1,0,1,2,0,0,1,0,2,3,1
1914,62356,wjS8ie6ACTxewSCQo7zpBy0tu4z4RYPD,SpATywNh6bZuzm8s1ceuBUnMUAeoAHHw,14,25,1,24,0,1,20,1,72,10.285714285714286,3,0.0,6,1,20,0,19,1,4,20,1,27,45,0
1915,62368,4ct6kljhf27XSdXxxeVXKJL0lQ4aKOK7,7GRhBDsirIGkRZBtSMEzNTyDr2JQm4xx,17,39,3,10,0,0,14,0,66,9.428571428571429,2,0.0,5,3,8,0,34,0,2,14,0,16,50,1
1916,62396,jGKZSsHerE5dciVNZBuJOf3EyWVEldkX,7GRhBDsirIGkRZBtSMEzNTyDr2JQm4xx,1,0,0,0,0,0,1,0,1,0.14285714285714285,1,0.0,0,0,0,0,0,0,0,1,0,0,1,1
1917,62410,rORIPSFi0Cq6NYeD2hhC73kNxeeqmFyP,7GRhBDsirIGkRZBtSMEzNTyDr2JQm4xx,3,2,0,0,0,0,1,0,3,0.42857142857142855,1,0.0,0,0,0,0,2,0,0,1,0,0,3,1
1918,62428,Y5CSlxjOPHMFV7ik3pSpx6t0PJdYKnrH,SpATywNh6bZuzm8s1ceuBUnMUAeoAHHw,12,10,6,2,3,5,3,0,29,4.142857142857143,2,0.0,3,6,2,3,7,5,0,3,0,14,15,0
1919,62437,vhnbHBui7nCh3pAshTJ2BoFD1CEurx5q,SpATywNh6bZuzm8s1ceuBUnMUAeoAHHw,15,27,4,13,4,1,12,5,66,9.428571428571429,4,0.0,5,4,11,4,22,1,2,12,5,24,42,0
1920,62458,j8vYdYwa9gvt7hkF8dykZR2D4h75QsII,SpATywNh6bZuzm8s1ceuBUnMUAeoAHHw,13,18,6,25,1,4,7,1,62,8.857142857142858,2,0.0,9,6,21,1,9,4,4,7,1,37,25,1
1921,62484,l0WeYpTymokLlVEEJTixsYdgJaxPgZqy,7GRhBDsirIGkRZBtSMEzNTyDr2JQm4xx,1,0,0,0,0,0,1,0,1,0.14285714285714285,1,0.0,0,0,0,0,0,0,0,1,0,0,1,1
1922,62490,GWSq56qmQUucFgSgP2raEZeoKP7Athee,SpATywNh6bZuzm8s1ceuBUnMUAeoAHHw,13,14,0,17,0,8,8,1,48,6.857142857142857,3,0.0,4,0,16,0,10,8,1,8,1,20,28,0
1923,62514,ggEr2STKTwtSSUdtGCmiPr3DBu3TJ34B,A3fsA9Zfv1X2fVEQhTw51lKENdNrEqT3,7,4,1,6,0,0,1,0,12,1.7142857142857142,1,0.0,0,1,6,0,4,0,0,1,0,7,5,1
1924,62530,l7f4vHvlZkxCYoU9qM63V45bmndBSeZQ,SpATywNh6bZuzm8s1ceuBUnMUAeoAHHw,8,7,2,10,0,0,3,0,22,3.142857142857143,1,0.0,2,2,9,0,5,0,1,3,0,13,9,0
1925,62557,7FBwqoodmzhvrGGLuwBjRrxsykocUv8u,bWdj2GDclj5ofokWjzoa5jAwMkxCykd6,14,8,3,22,3,2,9,1,48,6.857142857142857,1,0.0,4,3,21,3,4,2,1,9,1,31,17,1
1926,62611,i2NIot2usiDyEsWQY7zT18X1uj2FHoWH,7GRhBDsirIGkRZBtSMEzNTyDr2JQm4xx,31,38,8,71,12,0,2,0,131,18.714285714285715,1,0.0,30,8,62,12,8,0,9,2,0,112,19,1
1927,62642,uoDWDjctsplt3HhO40cJ31SItxonwlgR,SpATywNh6bZuzm8s1ceuBUnMUAeoAHHw,8,8,3,0,2,1,3,0,17,2.4285714285714284,2,0.0,1,3,0,2,7,1,0,3,0,6,11,1
1928,62648,tUrqZSUN7RW61T1PpyF2X9YW8Ok3vUek,A3fsA9Zfv1X2fVEQhTw51lKENdNrEqT3,4,2,1,0,1,0,1,0,5,0.7142857142857143,1,0.0,0,1,0,1,2,0,0,1,0,2,3,1
1929,62655,8qABUnBBHxxZkfUhEQNUn5NNMSRrqvPC,SpATywNh6bZuzm8s1ceuBUnMUAeoAHHw,12,38,16,23,0,0,6,0,83,11.857142857142858,4,0.0,16,16,20,0,22,0,3,6,0,52,31,1
1930,62695,N0Sos51WanCzoSGKDmMPzQtMlLxY3bFb,A3fsA9Zfv1X2fVEQhTw51lKENdNrEqT3,45,67,35,48,13,66,51,4,284,40.57142857142857,5,0.0,6,35,46,13,61,66,2,51,4,100,184,0
1931,62751,RjUWkdPtbuKazr3SZ8iaujuOx2ne7ey1,7GRhBDsirIGkRZBtSMEzNTyDr2JQm4xx,6,2,1,0,1,0,3,1,8,1.1428571428571428,1,0.0,0,1,0,1,2,0,0,3,1,2,6,0
1932,62780,7lWGgkVC73zkYVnYZAzOXyCIO3N3M6br,SpATywNh6bZuzm8s1ceuBUnMUAeoAHHw,11,17,5,14,2,1,4,0,43,6.142857142857143,3,0.0,6,5,11,2,11,1,3,4,0,24,19,0
1933,62788,N24rIsVu8N2zgaIu1cFWHYg7IEXvRm7B,SpATywNh6bZuzm8s1ceuBUnMUAeoAHHw,6,3,1,0,1,0,2,0,7,1.0,1,0.0,0,1,0,1,3,0,0,2,0,2,5,0
1934,62790,wLyViiqrdSPB3KP8OihPcsmMpcPB2yFu,7GRhBDsirIGkRZBtSMEzNTyDr2JQm4xx,6,3,1,0,1,0,2,0,7,1.0,1,0.0,0,1,0,1,3,0,0,2,0,2,5,1
1935,62822,LJYBef7iIBiSZz8D7KTtMTsdkyd91gnR,7GRhBDsirIGkRZBtSMEzNTyDr2JQm4xx,1,0,0,0,0,0,1,0,1,0.14285714285714285,1,0.0,0,0,0,0,0,0,0,1,0,0,1,1
1936,62834,TfNQptQajWTQqzlzDAn72SRQxELYzNd4,SpATywNh6bZuzm8s1ceuBUnMUAeoAHHw,14,32,2,21,1,31,6,1,94,13.428571428571429,2,0.0,12,2,18,1,20,31,3,6,1,33,61,0
1937,62888,mne1Bu1F2f0U7iravmS4eQYQtLTkVvPe,7GRhBDsirIGkRZBtSMEzNTyDr2JQm4xx,1,0,0,0,0,0,1,0,1,0.14285714285714285,1,0.0,0,0,0,0,0,0,0,1,0,0,1,1
1938,62900,eS5XywA64oauZkENyWLpeVNsSbZFhj1k,7GRhBDsirIGkRZBtSMEzNTyDr2JQm4xx,4,2,1,0,1,0,1,0,5,0.7142857142857143,1,0.0,0,1,0,1,2,0,0,1,0,2,3,0
1939,62902,ukCIrv5h45nbdIEPPmMlvipT87B8fFE7,7GRhBDsirIGkRZBtSMEzNTyDr2JQm4xx,1,0,0,0,0,0,1,0,1,0.14285714285714285,1,0.0,0,0,0,0,0,0,0,1,0,0,1,1
1940,62936,l6huwkyakLvA9G4ixwxpAcJxBdbbcmJP,SpATywNh6bZuzm8s1ceuBUnMUAeoAHHw,17,31,10,24,4,2,12,1,84,12.0,3,0.0,17,10,18,4,14,2,6,12,1,49,35,0
1941,62938,eLqag6twmL6nT6SLVrpY07QGG3bytKwe,SpATywNh6bZuzm8s1ceuBUnMUAeoAHHw,10,16,3,0,2,1,9,1,32,4.571428571428571,3,0.0,0,3,0,2,16,1,0,9,1,5,27,0
1942,62970,RS564zscXajJOiW9woDtEu4M9LDaNEPd,7GRhBDsirIGkRZBtSMEzNTyDr2JQm4xx,17,18,8,0,6,0,3,0,35,5.0,2,0.0,0,8,0,6,18,0,0,3,0,14,21,1
1943,62985,SDq3f6KWdckVLJCSJxIwedwz5gfJhoTJ,SpATywNh6bZuzm8s1ceuBUnMUAeoAHHw,18,37,16,18,3,12,14,1,101,14.428571428571429,4,0.0,15,16,15,3,22,12,3,14,1,49,52,1
1944,63072,TvDWPoJyTprTu0vxto5NxLIJOfQBmxVE,7GRhBDsirIGkRZBtSMEzNTyDr2JQm4xx,38,101,2,38,6,7,18,1,173,24.714285714285715,4,0.0,23,2,30,6,78,7,8,18,1,61,112,0
1945,63161,CcZ2EQGxkq4lhEIujCU8FZkit7DT7C79,7GRhBDsirIGkRZBtSMEzNTyDr2JQm4xx,2,0,0,0,0,0,2,0,2,0.2857142857142857,1,0.0,0,0,0,0,0,0,0,2,0,0,2,0
1946,63242,jzQypdHgDGImzo6sjFmv4z8itS7CTk6P,7GRhBDsirIGkRZBtSMEzNTyDr2JQm4xx,27,68,1,70,9,4,15,2,169,24.142857142857142,3,0.0,26,1,62,9,42,4,8,15,2,98,71,1
1947,63271,DHenWrxVzReZszxo1qw3Im0Zj99tiAII,A3fsA9Zfv1X2fVEQhTw51lKENdNrEqT3,24,17,13,0,9,3,7,1,50,7.142857142857143,4,0.0,0,13,0,9,17,3,0,7,1,22,28,0
1948,63299,HvCZ1bV9L7D0erySzp1UH1mW8tuWfYPw,7GRhBDsirIGkRZBtSMEzNTyDr2JQm4xx,31,67,21,43,12,18,9,0,170,24.285714285714285,2,0.0,24,21,34,12,43,18,9,9,0,91,79,1
1949,63379,jSPgiXDCISXGmLFuOlDszBfMRRboKynI,7GRhBDsirIGkRZBtSMEzNTyDr2JQm4xx,3,2,0,0,0,0,1,0,3,0.42857142857142855,1,0.0,0,0,0,0,2,0,0,1,0,0,3,1
1950,63427,OcEwAP7KVM22YlzUoPdivyTSWtkZ4qVM,7GRhBDsirIGkRZBtSMEzNTyDr2JQm4xx,2,0,0,0,0,0,3,0,3,0.42857142857142855,1,0.0,0,0,0,0,0,0,0,3,0,0,3,1
1951,63461,4TtGjmtd4ISORDD5okRgx7kXAcGUW8IN,7GRhBDsirIGkRZBtSMEzNTyDr2JQm4xx,19,20,9,8,8,0,11,0,56,8.0,3,0.0,8,9,6,8,12,0,2,11,0,31,25,0
1952,63687,dtbXtMjPqeEvzoZBFe2y9uSDcjL0lnx2,A3fsA9Zfv1X2fVEQhTw51lKENdNrEqT3,25,90,35,8,24,10,23,1,191,27.285714285714285,3,0.0,2,35,6,24,88,10,2,23,1,67,124,0
1953,63703,GulRMWFcPY5JE8HNbJPRyRdVqJqL2eEA,A3fsA9Zfv1X2fVEQhTw51lKENdNrEqT3,6,2,0,0,0,0,5,0,7,1.0,1,0.0,0,0,0,0,2,0,0,5,0,0,7,0
1954,63903,4RiemE5r88jWq9gaL0lVYzjeUhWq3sNP,A3fsA9Zfv1X2fVEQhTw51lKENdNrEqT3,9,4,3,0,3,0,2,0,12,1.7142857142857142,1,0.0,0,3,0,3,4,0,0,2,0,6,6,1
1955,65718,aPDsc8X2fcDutxzM0D9vmuKFKeVLb7iC,7GRhBDsirIGkRZBtSMEzNTyDr2JQm4xx,6,8,1,6,3,0,4,0,22,3.142857142857143,1,0.0,4,1,5,3,4,0,1,4,0,13,9,1
1956,65754,d7lqWAJ8cu1e9f8Lb1eNhG3YSdhF0Qy7,7GRhBDsirIGkRZBtSMEzNTyDr2JQm4xx,33,104,40,46,21,30,35,3,279,39.857142857142854,3,0.0,54,40,39,21,50,30,7,35,3,154,125,1
1957,66544,GsuSgvyvG4oCfnW3UaGKEeHZUImW7ybU,SpATywNh6bZuzm8s1ceuBUnMUAeoAHHw,12,30,4,13,3,1,6,0,57,8.142857142857142,4,0.0,9,4,12,3,21,1,1,6,0,28,29,1
1958,66553,X1KDcg6FJGcjALhOEz460JY2SzJ27Ewm,RXDvfPUBYFlVdlueBFbLW0mhhAyGEqpt,17,23,8,16,3,0,21,0,71,10.142857142857142,2,0.0,6,8,16,3,17,0,0,21,0,33,38,1
1959,66554,alnogGpZqhBWQHh6ZLeZUIXk896ksLOu,bWdj2GDclj5ofokWjzoa5jAwMkxCykd6,17,33,3,108,2,2,20,1,169,24.142857142857142,3,0.0,9,3,105,2,24,2,3,20,1,119,50,1
1960,66562,RbUxQb46RHLKt8MRdcRI6KFNQeGEWd4E,bWdj2GDclj5ofokWjzoa5jAwMkxCykd6,12,4,3,0,3,10,7,1,28,4.0,2,0.0,0,3,0,3,4,10,0,7,1,6,22,1
1961,66566,6PpQXjJomANl40NJZt5It7FhFUddOBZF,SpATywNh6bZuzm8s1ceuBUnMUAeoAHHw,16,19,8,12,3,23,7,1,73,10.428571428571429,2,0.0,6,8,9,3,13,23,3,7,1,26,47,1
1962,66567,Z5BNOGX3uaOaDJtXljja6tBV5seZD36x,SpATywNh6bZuzm8s1ceuBUnMUAeoAHHw,6,4,3,0,2,0,2,0,11,1.5714285714285714,1,0.0,0,3,0,2,4,0,0,2,0,5,6,1
1963,66572,IaHdA1JSOZlnXxW2Ea0M59RXapC6MjXI,SpATywNh6bZuzm8s1ceuBUnMUAeoAHHw,12,70,9,23,1,37,16,3,159,22.714285714285715,3,0.0,56,9,21,1,14,37,2,16,3,87,72,0
1964,66573,ES3MJj3KCIAnVbhhUwdNjoq2AG6ouBZT,SpATywNh6bZuzm8s1ceuBUnMUAeoAHHw,10,9,4,0,3,8,3,0,27,3.857142857142857,2,0.0,0,4,0,3,9,8,0,3,0,7,20,1
1965,66574,PizUKf6mRUas66X3VMYXf9aygnN1CUCf,RXDvfPUBYFlVdlueBFbLW0mhhAyGEqpt,27,31,22,0,10,11,8,3,85,12.142857142857142,1,0.0,3,22,0,10,28,11,0,8,3,35,50,1
1966,66583,L3sYIZrtCe33arrsIgJGTKImw4yL48kj,G8EPVSXsOYB5YQWZGiz1aVq5Pgr2GrQu,4,2,1,0,1,0,1,0,5,0.7142857142857143,1,0.0,0,1,0,1,2,0,0,1,0,2,3,0
1967,66584,ZRcEnEYSSBQbkjzMu7sidjbxasfrmw8l,RXDvfPUBYFlVdlueBFbLW0mhhAyGEqpt,24,40,20,31,2,2,7,0,102,14.571428571428571,3,0.0,5,20,29,2,35,2,2,7,0,56,46,1
1968,66587,Jag1EXQWfAuTRiCgcVLyhRRkdOL9RtSD,bWdj2GDclj5ofokWjzoa5jAwMkxCykd6,13,13,9,68,6,2,8,0,106,15.142857142857142,2,0.0,1,9,67,6,12,2,1,8,0,83,23,1
1969,66591,9EN3Z35raOUcrGDeovMj0gdxUNnPCeKU,SpATywNh6bZuzm8s1ceuBUnMUAeoAHHw,3,2,0,0,0,0,2,0,4,0.5714285714285714,1,0.0,0,0,0,0,2,0,0,2,0,0,4,1
1970,66598,nLUyFOoii85Kc6SiGICnU7SPdHRw1h9a,SpATywNh6bZuzm8s1ceuBUnMUAeoAHHw,9,5,2,0,1,15,5,3,31,4.428571428571429,1,0.0,2,2,0,1,3,15,0,5,3,5,26,1
1971,66605,XUPBJ1mitGxAzzRukKqjQOzBGJw166yc,G8EPVSXsOYB5YQWZGiz1aVq5Pgr2GrQu,10,6,5,0,4,0,3,0,18,2.5714285714285716,2,0.0,0,5,0,4,6,0,0,3,0,9,9,1
1972,66615,fxrAFCrsLimQV1XJURgnMX9KS4WUkexG,G8EPVSXsOYB5YQWZGiz1aVq5Pgr2GrQu,14,5,4,28,3,0,3,0,43,6.142857142857143,1,0.0,0,4,25,3,5,0,3,3,0,32,11,1
1973,66616,aQkZtyhfWM4x1GodnKorBxGkYsdqjpct,G8EPVSXsOYB5YQWZGiz1aVq5Pgr2GrQu,25,23,16,0,12,1,5,0,57,8.142857142857142,3,0.0,0,16,0,12,23,1,0,5,0,28,29,1
1974,66617,bXR5OQsnMadJ3r7Y5b33xdbV7KcP5Zyw,bWdj2GDclj5ofokWjzoa5jAwMkxCykd6,8,9,6,0,5,0,3,0,23,3.2857142857142856,2,0.0,1,6,0,5,8,0,0,3,0,12,11,1
1975,66618,wyLapvNSkzqLsQoXZV3N6mjrWCECacth,RXDvfPUBYFlVdlueBFbLW0mhhAyGEqpt,49,44,24,101,16,8,8,0,201,28.714285714285715,3,0.0,13,24,95,16,31,8,6,8,0,148,53,1
1976,66621,5TeLMYHqzQAKUmQpWnvEv2hxOy9X1UKJ,SpATywNh6bZuzm8s1ceuBUnMUAeoAHHw,17,32,16,22,5,7,14,3,99,14.142857142857142,2,0.0,11,16,17,5,21,7,5,14,3,49,50,1
1977,66635,8fOucDZ8PgruKfhbtaGML7zYng8oMl2j,SpATywNh6bZuzm8s1ceuBUnMUAeoAHHw,5,2,1,0,1,0,3,0,7,1.0,1,0.0,0,1,0,1,2,0,0,3,0,2,5,1
1978,66637,ddHByaCLR2ByNnOPbXOAqZ6eqJzLVO7n,bWdj2GDclj5ofokWjzoa5jAwMkxCykd6,5,3,1,0,1,0,4,0,9,1.2857142857142858,1,0.0,0,1,0,1,3,0,0,4,0,2,7,1
1979,66644,102hMvC6gN7rty2ashlvDMHaB3ep6GZh,SpATywNh6bZuzm8s1ceuBUnMUAeoAHHw,15,46,2,27,1,12,14,2,104,14.857142857142858,2,0.0,18,2,21,1,28,12,6,14,2,42,62,1
1980,66646,qZhmmNUvkNXdf3u04DTUQOFEBxxO10p4,G8EPVSXsOYB5YQWZGiz1aVq5Pgr2GrQu,70,74,31,176,17,0,5,0,303,43.285714285714285,2,0.0,35,31,134,17,39,0,42,5,0,217,86,1
1981,66650,j8DEcgUENzfnfHONFl2IMtBsrYZzGv40,bWdj2GDclj5ofokWjzoa5jAwMkxCykd6,8,4,2,42,1,0,2,0,51,7.285714285714286,1,0.0,2,2,41,1,2,0,1,2,0,46,5,1
1982,66654,AA7aVbrpQJ2zUau6VJLFiC8rutvLHi1m,bWdj2GDclj5ofokWjzoa5jAwMkxCykd6,7,17,4,0,0,1,6,0,28,4.0,1,0.0,0,4,0,0,17,1,0,6,0,4,24,1
1983,66657,bpLyNpLNqZrg4X6eObo787HrocrHo6XF,RXDvfPUBYFlVdlueBFbLW0mhhAyGEqpt,7,4,1,0,1,0,2,0,8,1.1428571428571428,1,0.0,0,1,0,1,4,0,0,2,0,2,6,1
1984,66658,NiYgf1FsQGPvHpxeTQuDCV5yUQ8cmKec,SpATywNh6bZuzm8s1ceuBUnMUAeoAHHw,1,0,0,0,0,0,1,0,1,0.14285714285714285,1,0.0,0,0,0,0,0,0,0,1,0,0,1,1
1985,66662,GHjtRW2SWnsNCYGrWfNWjwqhAcWXggqC,G8EPVSXsOYB5YQWZGiz1aVq5Pgr2GrQu,31,37,3,70,1,5,4,0,120,17.142857142857142,1,0.0,16,3,52,1,21,5,18,4,0,72,48,1
1986,66664,WpYtemwKZQxcuLGpndx0lQojfh6o5GOv,RXDvfPUBYFlVdlueBFbLW0mhhAyGEqpt,11,7,1,0,1,3,7,1,20,2.857142857142857,2,0.0,0,1,0,1,7,3,0,7,1,2,18,1
1987,66677,O65XWOLgEMKBGdUDD3HXTmDvI5lmhsk8,SpATywNh6bZuzm8s1ceuBUnMUAeoAHHw,8,7,4,0,1,0,6,0,18,2.5714285714285716,2,0.0,0,4,0,1,7,0,0,6,0,5,13,1
1988,66688,ehuVxu7A35eDUFqKYYT7us9o7kymvupC,SpATywNh6bZuzm8s1ceuBUnMUAeoAHHw,8,6,4,0,4,0,6,1,21,3.0,2,0.0,1,4,0,4,5,0,0,6,1,9,12,1
1989,66691,4X8SsO11KgTMY23mHrkIQxUJcM5ft92O,SpATywNh6bZuzm8s1ceuBUnMUAeoAHHw,6,3,2,0,2,0,2,0,9,1.2857142857142858,1,0.0,0,2,0,2,3,0,0,2,0,4,5,1
1990,66695,9hMYmYnY4O2N6jg4p4MNxwDczZbVqp3T,RXDvfPUBYFlVdlueBFbLW0mhhAyGEqpt,15,17,10,0,5,0,5,0,37,5.285714285714286,3,0.0,2,10,0,5,15,0,0,5,0,17,20,1
1991,66703,pdhviBPVRpP6jkLxXzSmGnBMX5GRwslr,SpATywNh6bZuzm8s1ceuBUnMUAeoAHHw,9,24,13,0,0,1,12,0,50,7.142857142857143,1,0.0,0,13,0,0,24,1,0,12,0,13,37,1
1992,66704,DAjbimE4V5oFXI5ZD4kyBHNztDPF7CGC,G8EPVSXsOYB5YQWZGiz1aVq5Pgr2GrQu,5,4,1,0,2,0,3,0,10,1.4285714285714286,2,0.0,2,1,0,2,2,0,0,3,0,5,5,1
1993,66711,VS8f8oTxWcbwLqrK393hBZWMoBFa1gFJ,SpATywNh6bZuzm8s1ceuBUnMUAeoAHHw,18,26,12,20,4,2,20,1,85,12.142857142857142,4,0.0,8,12,16,4,18,2,4,20,1,40,45,0
1994,66713,LMGbvXS3ZBgtTcKCRLMcqBHrfADBxwXe,G8EPVSXsOYB5YQWZGiz1aVq5Pgr2GrQu,14,28,12,0,3,18,13,0,74,10.571428571428571,3,0.0,5,12,0,3,23,18,0,13,0,20,54,0
1995,66730,BaoCwxmOrD7InrgOrpoiCi2VVkCIKJfh,SpATywNh6bZuzm8s1ceuBUnMUAeoAHHw,17,24,6,20,3,3,12,1,69,9.857142857142858,2,0.0,16,6,17,3,8,3,3,12,1,42,27,1
1996,66732,e4qTXKc7Qs1Hoa2gaTnt5MCSxqsevbSQ,SpATywNh6bZuzm8s1ceuBUnMUAeoAHHw,1,0,0,0,0,0,1,0,1,0.14285714285714285,1,0.0,0,0,0,0,0,0,0,1,0,0,1,1
1997,66745,qt9pojYUdSU9dxSioMDEso1f0UH6has1,SpATywNh6bZuzm8s1ceuBUnMUAeoAHHw,13,34,13,20,3,1,5,0,76,10.857142857142858,3,0.0,7,13,17,3,27,1,3,5,0,40,36,1
1998,66747,p2gF3LN3ZgatpYPMj263kKzwr7f9hjKm,SpATywNh6bZuzm8s1ceuBUnMUAeoAHHw,4,1,0,0,0,0,6,0,7,1.0,1,0.0,0,0,0,0,1,0,0,6,0,0,7,0
1999,66756,aR3fk0CNwd9ygarvr0BOVu5p8WeU32I1,SpATywNh6bZuzm8s1ceuBUnMUAeoAHHw,17,21,7,10,4,9,8,1,60,8.571428571428571,2,0.0,11,7,9,4,10,9,1,8,1,31,29,1
2000,66776,1bINdBCm1VS5Qjqh6m0QvNj7bfNPAIxT,bWdj2GDclj5ofokWjzoa5jAwMkxCykd6,2,0,0,0,0,0,2,0,2,0.2857142857142857,2,0.0,0,0,0,0,0,0,0,2,0,0,2,1
2001,66778,c7cZPwJhMtLXXFSxYHM0ztf18Qe267SR,SpATywNh6bZuzm8s1ceuBUnMUAeoAHHw,11,16,9,0,7,0,3,0,35,5.0,2,0.0,1,9,0,7,15,0,0,3,0,17,18,1
2002,66779,r8TxqoZCuxs9o8OQbbHm8IWDrVmolNmN,SpATywNh6bZuzm8s1ceuBUnMUAeoAHHw,1,0,0,0,0,0,1,0,1,0.14285714285714285,1,0.0,0,0,0,0,0,0,0,1,0,0,1,1
2003,66780,OnyZH4F3oW4crdu4EYjgcCg5L4Cq5yIA,bWdj2GDclj5ofokWjzoa5jAwMkxCykd6,5,9,1,0,0,0,4,0,14,2.0,1,0.0,0,1,0,0,9,0,0,4,0,1,13,1
2004,66789,5ZyvCd3AP7a8azCiLN5JfLAP53iZpAyD,SpATywNh6bZuzm8s1ceuBUnMUAeoAHHw,3,0,0,0,0,0,4,0,4,0.5714285714285714,1,0.0,0,0,0,0,0,0,0,4,0,0,4,0
2005,66804,AlgEd5IzXHm0JGTUI9jbrnVeF8FATpV3,bWdj2GDclj5ofokWjzoa5jAwMkxCykd6,13,12,7,48,3,4,5,0,79,11.285714285714286,1,0.0,4,7,48,3,8,4,0,5,0,62,17,1
2006,66806,Qo1OAp8GglCOhKICbcJQhmG7Ih2RNYzD,SpATywNh6bZuzm8s1ceuBUnMUAeoAHHw,12,14,5,0,3,0,24,0,46,6.571428571428571,2,0.0,4,5,0,3,10,0,0,24,0,12,34,1
2007,66808,WMHcQA8MVYUjJWAMAB6fugsBuCZpVoIb,SpATywNh6bZuzm8s1ceuBUnMUAeoAHHw,14,22,6,13,2,9,14,4,70,10.0,1,0.0,16,6,12,2,6,9,1,14,4,36,34,1
2008,66810,nNPKgGT2Dns3AcXj6vzeFxTea7ZZLJPg,G8EPVSXsOYB5YQWZGiz1aVq5Pgr2GrQu,27,12,11,0,10,12,6,1,52,7.428571428571429,1,0.0,0,11,0,10,12,12,0,6,1,21,31,1
2009,66813,jtvqYfTt0YMo9BknX2A672jXhl21ashI,SpATywNh6bZuzm8s1ceuBUnMUAeoAHHw,7,5,1,0,1,0,1,0,8,1.1428571428571428,1,0.0,0,1,0,1,5,0,0,1,0,2,6,1
2010,66820,MvNnLQma2eBM9bCcMIR159XYSNp8VREs,bWdj2GDclj5ofokWjzoa5jAwMkxCykd6,6,2,1,0,1,1,6,0,11,1.5714285714285714,3,0.0,0,1,0,1,2,1,0,6,0,2,9,1
2011,66828,U0qAQ57V9wygm6bDtrNRCaS95QeQ2J6g,G8EPVSXsOYB5YQWZGiz1aVq5Pgr2GrQu,31,56,30,0,17,4,18,2,127,18.142857142857142,3,0.0,13,30,0,17,43,4,0,18,2,60,67,1
2012,66844,zPWIhn8QAXkwvZr0vXSWUOjtKdeOxnx0,SpATywNh6bZuzm8s1ceuBUnMUAeoAHHw,4,4,0,0,0,0,2,0,6,0.8571428571428571,1,0.0,0,0,0,0,4,0,0,2,0,0,6,1
2013,66854,9uGUU0TH4lqYEkuGLK9jp9MwW0oSvGiG,SpATywNh6bZuzm8s1ceuBUnMUAeoAHHw,1,0,0,0,0,0,1,0,1,0.14285714285714285,1,0.0,0,0,0,0,0,0,0,1,0,0,1,1
2014,66859,YD54LiXoRcgp9TgUQFqtUoAuCL64ULEG,RXDvfPUBYFlVdlueBFbLW0mhhAyGEqpt,1,0,0,0,0,0,1,0,1,0.14285714285714285,1,0.0,0,0,0,0,0,0,0,1,0,0,1,1
2015,66862,grxgFxuiaSTlMIk1kWcHwbLAYZVnIvkA,RXDvfPUBYFlVdlueBFbLW0mhhAyGEqpt,7,5,1,0,1,0,3,0,10,1.4285714285714286,1,0.0,0,1,0,1,5,0,0,3,0,2,8,1
2016,66871,TkGLgRow1Lh4XUIZJk3PPt8KzHEZuW9e,SpATywNh6bZuzm8s1ceuBUnMUAeoAHHw,12,12,8,1,7,0,4,0,32,4.571428571428571,2,0.0,2,8,1,7,10,0,0,4,0,18,14,1
2017,66878,9uGUU0TH4lqYEkuGLK9jp9MwW0oSvGiG,bWdj2GDclj5ofokWjzoa5jAwMkxCykd6,1,0,0,0,0,0,1,0,1,0.14285714285714285,1,0.0,0,0,0,0,0,0,0,1,0,0,1,1
2018,66880,tBWD1VTj6Jcj3AQ0AXY8eZtUzkjmoiNH,bWdj2GDclj5ofokWjzoa5jAwMkxCykd6,9,12,5,14,1,8,10,0,50,7.142857142857143,2,0.0,1,5,13,1,11,8,1,10,0,20,30,1
2019,66893,HBNOGDmQrCA8ZCNHwMOm4mGR9448iscJ,SpATywNh6bZuzm8s1ceuBUnMUAeoAHHw,6,2,0,0,0,0,13,0,15,2.142857142857143,3,0.0,0,0,0,0,2,0,0,13,0,0,15,0
2020,66900,SOap4GRyA4qmYvVJbfGh1nFSvLnlIhQw,SpATywNh6bZuzm8s1ceuBUnMUAeoAHHw,13,13,8,0,6,2,9,1,39,5.571428571428571,2,0.0,1,8,0,6,12,2,0,9,1,15,24,1
2021,66911,n0HFF3TwqKuBMzzkdLCbvb8Mji5ZUnVX,RXDvfPUBYFlVdlueBFbLW0mhhAyGEqpt,3,2,0,0,0,0,1,0,3,0.42857142857142855,1,0.0,0,0,0,0,2,0,0,1,0,0,3,1
2022,66922,wEaTyOJwwvOCk7eUttQISK5WPXL7ANNV,RXDvfPUBYFlVdlueBFbLW0mhhAyGEqpt,5,11,1,0,0,0,4,0,16,2.2857142857142856,3,0.0,1,1,0,0,10,0,0,4,0,2,14,0
2023,66928,UnlpBoCCKa1g59dweQPJmefdPMpfSVLe,G8EPVSXsOYB5YQWZGiz1aVq5Pgr2GrQu,43,86,35,86,24,21,13,1,266,38.0,4,0.0,31,35,53,24,55,21,33,13,1,143,123,1
2024,66937,LYK1SCUULDZfFbUf8SQuy4cGJ6KDov7Z,G8EPVSXsOYB5YQWZGiz1aVq5Pgr2GrQu,13,8,4,0,2,2,15,2,33,4.714285714285714,3,0.0,0,4,0,2,8,2,0,15,2,6,27,1
2025,66938,mLUKkahZJn2S9K7hZVXpun7HflxZlNfK,RXDvfPUBYFlVdlueBFbLW0mhhAyGEqpt,36,49,3,98,3,0,3,0,156,22.285714285714285,2,0.0,15,3,91,3,34,0,7,3,0,112,44,1
2026,66947,8OfBrECVDzmqJABpw3ayApk0DiWDa3gF,SpATywNh6bZuzm8s1ceuBUnMUAeoAHHw,1,0,0,0,0,0,1,0,1,0.14285714285714285,1,0.0,0,0,0,0,0,0,0,1,0,0,1,1
2027,66948,ylHVd8NK0xyUeGJijtfFcdu7sSX07hsS,SpATywNh6bZuzm8s1ceuBUnMUAeoAHHw,14,12,0,8,0,1,10,3,34,4.857142857142857,2,0.0,2,0,8,0,10,1,0,10,3,10,24,1
2028,66959,wpRLL3XDggpsn9xMAH6hM6LGULXpz3ki,SpATywNh6bZuzm8s1ceuBUnMUAeoAHHw,3,2,0,0,0,0,2,0,4,0.5714285714285714,1,0.0,0,0,0,0,2,0,0,2,0,0,4,1
2029,66965,FXFJNl5vYMfodb6wUkei0GFkJtJALVJo,SpATywNh6bZuzm8s1ceuBUnMUAeoAHHw,1,0,0,0,0,0,2,0,2,0.2857142857142857,1,0.0,0,0,0,0,0,0,0,2,0,0,2,1
2030,66967,TZMHSuVEUzvE9F9oFUPDubVVCOh0OUwA,SpATywNh6bZuzm8s1ceuBUnMUAeoAHHw,6,7,3,0,2,0,3,0,15,2.142857142857143,2,0.0,0,3,0,2,7,0,0,3,0,5,10,1
2031,66972,4mxqWsjuug2blsnsk9e2hDH5ZKMeIfme,SpATywNh6bZuzm8s1ceuBUnMUAeoAHHw,17,30,10,24,4,1,9,2,80,11.428571428571429,2,0.0,17,10,20,4,13,1,4,9,2,51,29,1
2032,66981,ApSfmGvydhCGgdp1GU2OyiUFr43yEuYJ,RXDvfPUBYFlVdlueBFbLW0mhhAyGEqpt,9,11,6,0,2,0,5,3,27,3.857142857142857,1,0.0,1,6,0,2,10,0,0,5,3,9,18,1
2033,66983,e7lti3fBvO8XZNtS4I7hMo5JFh6PqMCH,SpATywNh6bZuzm8s1ceuBUnMUAeoAHHw,9,6,0,0,0,1,8,1,16,2.2857142857142856,2,0.0,0,0,0,0,6,1,0,8,1,0,16,1
2034,66991,c5MkJ205AcjWsm07YpOktUEc4lrC6DvN,bWdj2GDclj5ofokWjzoa5jAwMkxCykd6,4,3,0,0,0,0,4,0,7,1.0,2,0.0,0,0,0,0,3,0,0,4,0,0,7,1
2035,66995,RE0yxLQPG2DsKP2fVObFsaZxTyIGWyd9,SpATywNh6bZuzm8s1ceuBUnMUAeoAHHw,1,0,0,0,0,0,1,0,1,0.14285714285714285,1,0.0,0,0,0,0,0,0,0,1,0,0,1,1
2036,67003,jK7giBjce5DH7ZDYgKKwuLGFjg8bBMY3,SpATywNh6bZuzm8s1ceuBUnMUAeoAHHw,1,0,0,0,0,0,1,0,1,0.14285714285714285,1,0.0,0,0,0,0,0,0,0,1,0,0,1,1
2037,67017,R8e7xg0PB3WHpeFUd7XjboUcUmtjBoqn,G8EPVSXsOYB5YQWZGiz1aVq5Pgr2GrQu,57,50,12,162,10,2,3,0,239,34.142857142857146,3,0.0,35,12,123,10,15,2,39,3,0,180,59,1
2038,67020,jWJjb2ULtCbg7TxaVgejXvNjReg1rWMJ,SpATywNh6bZuzm8s1ceuBUnMUAeoAHHw,4,2,0,0,0,0,5,0,7,1.0,2,0.0,0,0,0,0,2,0,0,5,0,0,7,1
2039,67027,a1PUZwDv53lPTEF9hvk5ypoKBKNjAetJ,SpATywNh6bZuzm8s1ceuBUnMUAeoAHHw,1,0,0,0,0,0,1,0,1,0.14285714285714285,1,0.0,0,0,0,0,0,0,0,1,0,0,1,1
2040,67028,Up0SfqXbbz6NGY2S4ku6GM2FOwYrzCdN,G8EPVSXsOYB5YQWZGiz1aVq5Pgr2GrQu,17,25,9,56,5,5,6,1,107,15.285714285714286,1,0.0,15,9,44,5,10,5,12,6,1,73,34,1
2041,67031,bhM1l0w4WfwmiUZ8JL3hioN6rh1txoNY,G8EPVSXsOYB5YQWZGiz1aVq5Pgr2GrQu,1,0,0,0,0,0,1,0,1,0.14285714285714285,1,0.0,0,0,0,0,0,0,0,1,0,0,1,1
2042,67032,YLfjSoU2JNGG7f9SEbr83b8mp8z1n7i3,SpATywNh6bZuzm8s1ceuBUnMUAeoAHHw,5,3,2,0,1,0,2,0,8,1.1428571428571428,1,0.0,0,2,0,1,3,0,0,2,0,3,5,1
2043,67057,YGm3RWWdh53qv43WofC48V9ZiIjgJjMn,bWdj2GDclj5ofokWjzoa5jAwMkxCykd6,7,13,6,6,2,0,5,0,32,4.571428571428571,1,0.0,1,6,5,2,12,0,1,5,0,14,18,0
2044,67062,lsez2NExtDzqmHTj1WxlkldAKydbGpGz,SpATywNh6bZuzm8s1ceuBUnMUAeoAHHw,11,15,0,13,0,0,4,0,32,4.571428571428571,3,0.0,4,0,12,0,11,0,1,4,0,16,16,0
2045,67064,rgWDWnR8cl7dIVcqtFoTnaVoLEy1VLxc,SpATywNh6bZuzm8s1ceuBUnMUAeoAHHw,8,12,4,0,2,0,3,0,21,3.0,3,0.0,0,4,0,2,12,0,0,3,0,6,15,1
2046,67084,t2CefH6ir3GuQXTz3Lok7bxtMew2Evw7,RXDvfPUBYFlVdlueBFbLW0mhhAyGEqpt,19,13,10,0,6,0,8,4,41,5.857142857142857,2,0.0,0,10,0,6,13,0,0,8,4,16,25,1
2047,67088,k6QLpQDqSxoScgN883dLN4OsoeXNCHXO,RXDvfPUBYFlVdlueBFbLW0mhhAyGEqpt,47,56,29,123,15,2,4,0,229,32.714285714285715,2,0.0,18,29,115,15,38,2,8,4,0,177,52,0
2048,67089,JrNueBhmifdFgGWHM8aWG8EzCwr3tqQr,SpATywNh6bZuzm8s1ceuBUnMUAeoAHHw,14,33,11,21,5,0,2,0,72,10.285714285714286,1,0.0,18,11,18,5,15,0,3,2,0,52,20,1
2049,67100,zpsnILpURwXmIVlozwqgT5YIvGr5WOxX,bWdj2GDclj5ofokWjzoa5jAwMkxCykd6,13,18,1,58,1,0,13,0,91,13.0,4,0.0,6,1,54,1,12,0,4,13,0,62,29,1
2050,67101,a3HtyjZsIXy0rlfdz7IVbfqFoPB13M3i,SpATywNh6bZuzm8s1ceuBUnMUAeoAHHw,10,24,1,11,0,0,2,0,38,5.428571428571429,2,0.0,2,1,11,0,22,0,0,2,0,14,24,1
2051,67108,37B6M9S02XwjLkdM8Uyceavdi8PgXeFK,SpATywNh6bZuzm8s1ceuBUnMUAeoAHHw,7,6,0,0,0,3,4,1,14,2.0,1,0.0,1,0,0,0,5,3,0,4,1,1,13,1
2052,67109,MoirjNgz2xCcf95deN6TNEo1dg7pa7Td,RXDvfPUBYFlVdlueBFbLW0mhhAyGEqpt,5,3,0,0,0,0,2,0,5,0.7142857142857143,1,0.0,0,0,0,0,3,0,0,2,0,0,5,1
2053,67113,3WF0lrMOUTt8kHZhSzrGOICZhAfsfzhb,SpATywNh6bZuzm8s1ceuBUnMUAeoAHHw,15,53,20,21,8,6,17,0,125,17.857142857142858,3,0.0,15,20,18,8,38,6,3,17,0,61,64,0
2054,67124,LFivYoM8eQkzo9oGvIWHE5E2ixWSM4Zt,SpATywNh6bZuzm8s1ceuBUnMUAeoAHHw,8,9,3,6,2,0,1,0,21,3.0,1,0.0,1,3,5,2,8,0,1,1,0,11,10,1
2055,67125,NEAc7vMacEwIBrIHn90danMCNJSj65mj,SpATywNh6bZuzm8s1ceuBUnMUAeoAHHw,5,2,1,0,1,0,3,0,7,1.0,1,0.0,0,1,0,1,2,0,0,3,0,2,5,1
2056,67135,HeVeuuFVpMfNb8W01LL9Sl7iyoZqremo,SpATywNh6bZuzm8s1ceuBUnMUAeoAHHw,6,2,1,0,0,0,5,1,9,1.2857142857142858,1,0.0,0,1,0,0,2,0,0,5,1,1,8,1
2057,67146,cAjVoc8wOYDE8lScDAhEgvHdzkmg6Oh2,SpATywNh6bZuzm8s1ceuBUnMUAeoAHHw,7,13,6,0,3,0,4,0,26,3.7142857142857144,4,0.0,0,6,0,3,13,0,0,4,0,9,17,1
2058,67147,4O78nHzzZKRW7OphkkAmy8uaIoFo0RWM,bWdj2GDclj5ofokWjzoa5jAwMkxCykd6,1,0,0,0,0,0,1,0,1,0.14285714285714285,1,0.0,0,0,0,0,0,0,0,1,0,0,1,1
2059,67148,zBl0JzlLEJg6YrWwxVeTxU6A3wSwUgq8,SpATywNh6bZuzm8s1ceuBUnMUAeoAHHw,7,19,0,0,0,1,2,0,22,3.142857142857143,1,0.0,0,0,0,0,19,1,0,2,0,0,22,1
2060,67162,G2vTTAEhPpy1uiGVOSc3WfzCmuUhZyw6,G8EPVSXsOYB5YQWZGiz1aVq5Pgr2GrQu,8,2,2,0,2,0,6,0,12,1.7142857142857142,2,0.0,0,2,0,2,2,0,0,6,0,4,8,1
2061,67172,IdbptVxItEcsF1HvcM0Mmm9AW3Imyhv4,SpATywNh6bZuzm8s1ceuBUnMUAeoAHHw,4,3,0,0,0,0,2,0,5,0.7142857142857143,1,0.0,0,0,0,0,3,0,0,2,0,0,5,1
2062,67179,5Zxu05K7VSTA0XR5o51TQgeWQSwtutqu,SpATywNh6bZuzm8s1ceuBUnMUAeoAHHw,13,9,5,6,1,2,5,1,29,4.142857142857143,2,0.0,2,5,6,1,7,2,0,5,1,14,15,1
2063,67186,2mFdcZdKuSUvueHyZE3zvpjXpyVcJptR,bWdj2GDclj5ofokWjzoa5jAwMkxCykd6,16,24,0,48,0,4,13,2,91,13.0,4,0.0,7,0,44,0,17,4,4,13,2,51,40,1
2064,67197,OvFsbGXgDD3DXdRTUFBoMvrSVsi4VT3x,SpATywNh6bZuzm8s1ceuBUnMUAeoAHHw,17,19,7,18,4,18,10,1,77,11.0,1,0.0,6,7,15,4,13,18,3,10,1,32,45,0
2065,67201,oYST4cfTE5cxIGh0kVtzNelTkJwqpSI4,bWdj2GDclj5ofokWjzoa5jAwMkxCykd6,2,0,0,0,0,0,2,0,2,0.2857142857142857,1,0.0,0,0,0,0,0,0,0,2,0,0,2,1
2066,67204,IJDnP8nIf6GZvQ8vvewi9Kan2f5aO9mE,SpATywNh6bZuzm8s1ceuBUnMUAeoAHHw,8,3,1,0,1,1,5,1,12,1.7142857142857142,1,0.0,0,1,0,1,3,1,0,5,1,2,10,1
2067,67208,urQLwPNeBD6YiDmQkO3zzeclg8J0Lcqs,SpATywNh6bZuzm8s1ceuBUnMUAeoAHHw,9,10,1,0,0,19,14,3,47,6.714285714285714,1,0.0,2,1,0,0,8,19,0,14,3,3,44,1
2068,67210,Mw3CgUU6IvX32BhuujNu75RHWA7Tzf9A,bWdj2GDclj5ofokWjzoa5jAwMkxCykd6,2,0,0,0,0,0,4,0,4,0.5714285714285714,1,0.0,0,0,0,0,0,0,0,4,0,0,4,1
2069,67216,fxBTxCWQMcuL1ujf7SabjHZ1ZIFJ9pkF,SpATywNh6bZuzm8s1ceuBUnMUAeoAHHw,10,4,3,0,2,10,12,1,32,4.571428571428571,1,0.0,0,3,0,2,4,10,0,12,1,5,27,1
2070,67218,2XkiS6Di6usC8n7ND637MKllSt6TChsJ,SpATywNh6bZuzm8s1ceuBUnMUAeoAHHw,14,25,9,12,2,1,9,0,58,8.285714285714286,4,0.0,10,9,10,2,15,1,2,9,0,31,27,1
2071,67225,i2lUV72IHqqXWYqLFMWv3y4XGmlq2lXa,G8EPVSXsOYB5YQWZGiz1aVq5Pgr2GrQu,2,0,0,0,0,0,2,0,2,0.2857142857142857,1,0.0,0,0,0,0,0,0,0,2,0,0,2,1
2072,67227,8QIwRllpGKgpURtcmS5hWJ0AInSKESf0,SpATywNh6bZuzm8s1ceuBUnMUAeoAHHw,7,6,2,0,2,0,5,0,15,2.142857142857143,2,0.0,0,2,0,2,6,0,0,5,0,4,11,1
2073,67233,sIyBSBxCvJj2SnsLY9k322Y8X6bvKHy5,bWdj2GDclj5ofokWjzoa5jAwMkxCykd6,2,0,0,0,0,0,2,0,2,0.2857142857142857,1,0.0,0,0,0,0,0,0,0,2,0,0,2,1
2074,67242,vy0D7u7Ahtj15h3nmn3LQzZAhD31JIs2,G8EPVSXsOYB5YQWZGiz1aVq5Pgr2GrQu,20,24,9,40,4,0,1,0,78,11.142857142857142,1,0.0,14,9,30,4,10,0,10,1,0,57,21,1
2075,67251,hfSXPDFaR2dzrQsij0JMBqqFRCNkzN0i,bWdj2GDclj5ofokWjzoa5jAwMkxCykd6,8,8,1,0,1,0,5,0,15,2.142857142857143,1,0.0,1,1,0,1,7,0,0,5,0,3,12,1
2076,67252,ZTdgLXHyPcHYh3Bqv5Ymq9ISFbVAj0an,SpATywNh6bZuzm8s1ceuBUnMUAeoAHHw,14,7,4,14,3,0,5,0,33,4.714285714285714,2,0.0,2,4,12,3,5,0,2,5,0,21,12,1
2077,67256,FZEwaAUaiR6zemazrUHMMvDLCgHez3sb,RXDvfPUBYFlVdlueBFbLW0mhhAyGEqpt,36,25,5,67,1,29,6,0,133,19.0,3,0.0,7,5,66,1,18,29,1,6,0,79,54,1
2078,67268,hZupBIfJ4ZGjbfVSNHt4j151AWxFYbOy,SpATywNh6bZuzm8s1ceuBUnMUAeoAHHw,15,20,9,7,6,1,5,0,48,6.857142857142857,2,0.0,8,9,7,6,12,1,0,5,0,30,18,1
2079,67271,1SJmhRDD4Bzcm6S9X3GSNxkp9PjEl8e5,G8EPVSXsOYB5YQWZGiz1aVq5Pgr2GrQu,25,27,12,34,8,4,2,0,87,12.428571428571429,1,0.0,11,12,24,8,16,4,10,2,0,55,32,0
2080,67274,ywsBc3bK8Vte1Tvgz902Tgp2J7M95FMX,RXDvfPUBYFlVdlueBFbLW0mhhAyGEqpt,19,20,13,0,4,12,18,5,72,10.285714285714286,2,0.0,0,13,0,4,20,12,0,18,5,17,55,1
2081,67292,grxgFxuiaSTlMIk1kWcHwbLAYZVnIvkA,SpATywNh6bZuzm8s1ceuBUnMUAeoAHHw,6,3,1,0,1,0,2,0,7,1.0,1,0.0,0,1,0,1,3,0,0,2,0,2,5,0
2082,67301,5ZZ7ac02MMtLItQmBAzvselJyRLR3oem,G8EPVSXsOYB5YQWZGiz1aVq5Pgr2GrQu,23,25,7,20,6,0,2,0,60,8.571428571428571,2,0.0,15,7,13,6,10,0,7,2,0,41,19,1
2083,67304,WYUvDmjrCchGW5prlJ6BZEDjHOYsgZsG,G8EPVSXsOYB5YQWZGiz1aVq5Pgr2GrQu,39,51,20,64,13,0,9,0,157,22.428571428571427,3,0.0,28,20,44,13,23,0,20,9,0,105,52,1
2084,67311,rRP9Jqic5Mwtv2NanjU01SwWXGZ8kuBu,SpATywNh6bZuzm8s1ceuBUnMUAeoAHHw,5,4,1,0,0,0,5,0,10,1.4285714285714286,2,0.0,0,1,0,0,4,0,0,5,0,1,9,1
2085,67315,gc2449Ag0boGNd6nrwcfyjhFar24UaYH,RXDvfPUBYFlVdlueBFbLW0mhhAyGEqpt,23,47,44,0,21,0,3,0,115,16.428571428571427,3,0.0,2,44,0,21,45,0,0,3,0,67,48,1
2086,67317,F5h4PBXJhKNor6Y20FkKW5ER39HKkW7z,SpATywNh6bZuzm8s1ceuBUnMUAeoAHHw,16,16,6,19,3,0,6,0,50,7.142857142857143,1,0.0,6,6,16,3,10,0,3,6,0,31,19,1
2087,67320,CJYyYE64ZjIblJNrc9qIS4a8OLIz3Slp,SpATywNh6bZuzm8s1ceuBUnMUAeoAHHw,1,0,0,0,0,0,1,0,1,0.14285714285714285,1,0.0,0,0,0,0,0,0,0,1,0,0,1,1
2088,67330,CXuXsLGeGwubGiU0pZVYOuy4zs49HMdw,SpATywNh6bZuzm8s1ceuBUnMUAeoAHHw,5,4,0,0,0,1,2,0,7,1.0,1,0.0,0,0,0,0,4,1,0,2,0,0,7,1
2089,67337,6JTisM1m4JxBhgrxr4NqMSmvvRfyxGKO,bWdj2GDclj5ofokWjzoa5jAwMkxCykd6,3,5,2,0,0,0,1,0,8,1.1428571428571428,1,0.0,2,2,0,0,3,0,0,1,0,4,4,1
2090,67339,3w3NoRuE9idoCLL2jfurkkC3vZE468Ey,G8EPVSXsOYB5YQWZGiz1aVq5Pgr2GrQu,7,8,3,0,3,0,4,0,18,2.5714285714285716,1,0.0,3,3,0,3,5,0,0,4,0,9,9,1
2091,67342,S8ozQPoki5gs21RwfromQBp1WzImlYaZ,SpATywNh6bZuzm8s1ceuBUnMUAeoAHHw,16,19,1,16,2,6,14,2,60,8.571428571428571,2,0.0,4,1,14,2,15,6,2,14,2,21,39,1
2092,67344,dWJvaQw3sMX6buidtTfwYxdEvR1DZxlK,bWdj2GDclj5ofokWjzoa5jAwMkxCykd6,6,2,1,0,1,0,6,0,10,1.4285714285714286,1,0.0,0,1,0,1,2,0,0,6,0,2,8,1
2093,67356,T6lJMwNIVHZiShXC2FiLzuiG8wkuUByo,SpATywNh6bZuzm8s1ceuBUnMUAeoAHHw,1,0,0,0,0,0,1,0,1,0.14285714285714285,1,0.0,0,0,0,0,0,0,0,1,0,0,1,1
2094,67369,gNMjI69u5dKUTa6c5HKwijZOxWQK60Ms,RXDvfPUBYFlVdlueBFbLW0mhhAyGEqpt,9,5,0,0,0,1,6,1,13,1.8571428571428572,1,0.0,0,0,0,0,5,1,0,6,1,0,13,1
2095,67370,xutmfomAAAlPAVNt9XPAtdu3rEswaJtg,G8EPVSXsOYB5YQWZGiz1aVq5Pgr2GrQu,12,16,7,28,4,0,5,0,60,8.571428571428571,1,0.0,8,7,23,4,8,0,5,5,0,42,18,1
2096,67378,ICAkQ3nKBh6NBvMxfnhNNqVJis2pQKso,SpATywNh6bZuzm8s1ceuBUnMUAeoAHHw,8,1,1,0,1,1,12,1,17,2.4285714285714284,1,0.0,0,1,0,1,1,1,0,12,1,2,15,1
2097,67379,YkDfLiDseHtCR7dJh5rdSPT60rVAbQA9,bWdj2GDclj5ofokWjzoa5jAwMkxCykd6,5,10,7,0,0,0,4,0,21,3.0,2,0.0,0,7,0,0,10,0,0,4,0,7,14,1
2098,67390,aQ6WrdDe9pTNwVW3vmaMOs1pxy5r3Dxa,RXDvfPUBYFlVdlueBFbLW0mhhAyGEqpt,36,47,27,38,18,32,8,2,172,24.571428571428573,4,0.0,8,27,31,18,39,32,7,8,2,84,88,1
2099,67398,gYz3DXiXiB2ygQdrSqkvFFqa3NbdbDQD,SpATywNh6bZuzm8s1ceuBUnMUAeoAHHw,1,0,0,0,0,0,1,0,1,0.14285714285714285,1,0.0,0,0,0,0,0,0,0,1,0,0,1,1
2100,67399,dX8G0MwLqG7R1v0a5bVLBBEO2QeJVwW8,SpATywNh6bZuzm8s1ceuBUnMUAeoAHHw,13,7,4,13,3,0,2,0,29,4.142857142857143,1,0.0,2,4,11,3,5,0,2,2,0,20,9,1
2101,67403,s42YRljOqExiv71QhA2soTLfn9kHZdPI,bWdj2GDclj5ofokWjzoa5jAwMkxCykd6,5,4,3,0,0,0,2,0,9,1.2857142857142858,1,0.0,0,3,0,0,4,0,0,2,0,3,6,1
2102,67407,s42YRljOqExiv71QhA2soTLfn9kHZdPI,G8EPVSXsOYB5YQWZGiz1aVq5Pgr2GrQu,5,3,2,0,0,0,2,0,7,1.0,1,0.0,0,2,0,0,3,0,0,2,0,2,5,1
2103,67410,SUuO92fg900YcWp4Zs3wbFF13otrTK0v,SpATywNh6bZuzm8s1ceuBUnMUAeoAHHw,9,10,0,11,0,0,4,0,25,3.5714285714285716,1,0.0,4,0,11,0,6,0,0,4,0,15,10,0
2104,67411,tvf3NtE6iYQ6D7C3fM47X9eIcuZU3rZg,SpATywNh6bZuzm8s1ceuBUnMUAeoAHHw,1,0,0,0,0,0,1,0,1,0.14285714285714285,1,0.0,0,0,0,0,0,0,0,1,0,0,1,1
2105,67415,JBvV2euLTmN1KOC1bV6ujBU9dbXkql5n,SpATywNh6bZuzm8s1ceuBUnMUAeoAHHw,7,3,1,0,2,0,3,0,9,1.2857142857142858,1,0.0,0,1,0,2,3,0,0,3,0,3,6,1
2106,67420,IQ0KwwSF7jAVaA1XdkRcnXVwTeEvf1Lv,G8EPVSXsOYB5YQWZGiz1aVq5Pgr2GrQu,6,7,2,0,1,0,2,0,12,1.7142857142857142,1,0.0,3,2,0,1,4,0,0,2,0,6,6,1
2107,67426,VFYk1GyeJyGqK1t09cLe0E5m7KsULmvc,G8EPVSXsOYB5YQWZGiz1aVq5Pgr2GrQu,54,118,57,100,41,13,17,1,347,49.57142857142857,3,0.0,8,57,86,41,110,13,14,17,1,192,155,1
2108,67428,oKLMQAZTIOtP37CLM9yXiFLXKHfYljGQ,SpATywNh6bZuzm8s1ceuBUnMUAeoAHHw,6,10,3,0,1,0,2,0,16,2.2857142857142856,2,0.0,0,3,0,1,10,0,0,2,0,4,12,1
2109,67430,RQJ9jLgqxRIRHJ3Dya9dRIuO3dlScgvn,SpATywNh6bZuzm8s1ceuBUnMUAeoAHHw,13,18,0,16,0,10,6,1,51,7.285714285714286,2,0.0,10,0,13,0,8,10,3,6,1,23,28,1
2110,67432,FdsEBC0mHy1vT6x3hjK3QpB4Q1Uhf4Gh,SpATywNh6bZuzm8s1ceuBUnMUAeoAHHw,12,13,0,12,0,1,10,0,36,5.142857142857143,3,0.0,2,0,10,0,11,1,2,10,0,12,24,0
2111,67453,BuFcLJJOy4ywnCaR2obicsAMubCpPv8W,G8EPVSXsOYB5YQWZGiz1aVq5Pgr2GrQu,14,34,8,0,6,1,14,1,64,9.142857142857142,1,0.0,3,8,0,6,31,1,0,14,1,17,47,1
2112,67459,Gb2kkDHyDR8EKKTcjBRaUmubTYuyJhiK,G8EPVSXsOYB5YQWZGiz1aVq5Pgr2GrQu,27,34,15,18,11,0,8,0,86,12.285714285714286,3,0.0,7,15,13,11,27,0,5,8,0,46,40,1
2113,67471,a6W98SSI7NFdfjtHnUJXqYQ7M2ljRDYt,SpATywNh6bZuzm8s1ceuBUnMUAeoAHHw,12,21,7,23,1,4,12,2,70,10.0,3,0.0,8,7,20,1,13,4,3,12,2,36,34,0
2114,67477,SivEvgGr7pG5rlJGO3LDvmVfpVlkOk9l,SpATywNh6bZuzm8s1ceuBUnMUAeoAHHw,11,17,3,0,1,0,7,1,29,4.142857142857143,3,0.0,1,3,0,1,16,0,0,7,1,5,24,1
2115,67502,aqNbKvnpDmE6ISe0Qz8K64tYcLrFHQcz,SpATywNh6bZuzm8s1ceuBUnMUAeoAHHw,6,3,2,0,2,0,1,0,8,1.1428571428571428,1,0.0,0,2,0,2,3,0,0,1,0,4,4,1
2116,67524,VaOhD86uWnK2TjloSi50DgiXbw9C3K0T,bWdj2GDclj5ofokWjzoa5jAwMkxCykd6,8,32,2,0,1,0,13,0,48,6.857142857142857,1,0.0,0,2,0,1,32,0,0,13,0,3,45,1
2117,67525,UwnKbl2ARSQ7IikE1xisJoI3ICSxWK5v,SpATywNh6bZuzm8s1ceuBUnMUAeoAHHw,3,2,1,0,0,0,2,0,5,0.7142857142857143,2,0.0,0,1,0,0,2,0,0,2,0,1,4,1
2118,67531,HXqJJTXStUqZG7I7cVStlMobVqz7irG0,SpATywNh6bZuzm8s1ceuBUnMUAeoAHHw,8,6,4,0,2,0,2,0,14,2.0,1,0.0,0,4,0,2,6,0,0,2,0,6,8,1
2119,67538,6IcVTIvgSxxMCCqvswEKCMSbCJJ6BHWS,RXDvfPUBYFlVdlueBFbLW0mhhAyGEqpt,25,33,19,28,11,3,4,0,98,14.0,2,0.0,7,19,25,11,26,3,3,4,0,62,36,1
2120,67541,wb1auupOEOByBWLVmCpIzBal9pmTApTW,bWdj2GDclj5ofokWjzoa5jAwMkxCykd6,16,19,8,78,8,18,5,2,138,19.714285714285715,2,0.0,7,8,75,8,12,18,3,5,2,98,40,1
2121,67544,gSzwbDlzeyvDrdHnrWsBTEKJeSjOW5Jb,RXDvfPUBYFlVdlueBFbLW0mhhAyGEqpt,16,17,9,0,5,0,17,0,48,6.857142857142857,2,0.0,2,9,0,5,15,0,0,17,0,16,32,1
2122,67552,Bfvp2pdOjaKzYdBNQKGPqSn1IHYZcfBw,SpATywNh6bZuzm8s1ceuBUnMUAeoAHHw,4,2,1,0,1,0,1,0,5,0.7142857142857143,1,0.0,0,1,0,1,2,0,0,1,0,2,3,1
2123,67553,YGhHDAwBdNiyL9eKoJUrnR1s8ObHumpL,SpATywNh6bZuzm8s1ceuBUnMUAeoAHHw,5,3,1,0,1,0,1,0,6,0.8571428571428571,1,0.0,0,1,0,1,3,0,0,1,0,2,4,1
2124,67559,q2OeaRVSMsymXTCsCZPucygIuEsf22CD,SpATywNh6bZuzm8s1ceuBUnMUAeoAHHw,1,0,0,0,0,0,1,0,1,0.14285714285714285,1,0.0,0,0,0,0,0,0,0,1,0,0,1,1
2125,67567,2famc4S1vDEuGFyXiIN218hXpJ7I8XBG,SpATywNh6bZuzm8s1ceuBUnMUAeoAHHw,5,2,1,0,1,2,2,0,8,1.1428571428571428,1,0.0,0,1,0,1,2,2,0,2,0,2,6,1
2126,67570,I1340YsGXK2BIG96XRWppOvFniqpKDu7,RXDvfPUBYFlVdlueBFbLW0mhhAyGEqpt,47,69,25,147,13,7,11,0,272,38.857142857142854,2,0.0,22,25,131,13,47,7,16,11,0,191,81,0
2127,67574,3bThVr1RhSpIoI7gmUCoVwEy4UIBaasx,RXDvfPUBYFlVdlueBFbLW0mhhAyGEqpt,5,2,1,0,1,9,3,0,16,2.2857142857142856,2,0.0,0,1,0,1,2,9,0,3,0,2,14,1
2128,67600,nSn0VSHBRSmwKbK0c8WkxsGEmgkNhPeq,SpATywNh6bZuzm8s1ceuBUnMUAeoAHHw,1,0,0,0,0,0,1,0,1,0.14285714285714285,1,0.0,0,0,0,0,0,0,0,1,0,0,1,1
2129,67609,VaOhD86uWnK2TjloSi50DgiXbw9C3K0T,SpATywNh6bZuzm8s1ceuBUnMUAeoAHHw,4,2,0,0,0,0,2,0,4,0.5714285714285714,1,0.0,0,0,0,0,2,0,0,2,0,0,4,1
2130,67623,Sqd3Eviij3ahMVLlwINw4LiDCg7rwrfy,RXDvfPUBYFlVdlueBFbLW0mhhAyGEqpt,8,6,4,0,3,0,1,0,14,2.0,1,0.0,0,4,0,3,6,0,0,1,0,7,7,1
2131,67629,BMgk3lhp6DaLc2hrRyAZS5f3pfgtil58,RXDvfPUBYFlVdlueBFbLW0mhhAyGEqpt,14,14,5,24,0,1,3,0,47,6.714285714285714,1,0.0,2,5,24,0,12,1,0,3,0,31,16,1
2132,67632,rztgByxlqb0NHiCkVNMSLs4z23c2EnGy,RXDvfPUBYFlVdlueBFbLW0mhhAyGEqpt,7,8,5,0,2,0,3,0,18,2.5714285714285716,3,0.0,1,5,0,2,7,0,0,3,0,8,10,1
2133,67641,8QtgTaOo9DCjgt6kc4Db1wXfaWgbOe0I,SpATywNh6bZuzm8s1ceuBUnMUAeoAHHw,16,22,9,15,3,0,16,0,65,9.285714285714286,3,0.0,7,9,13,3,15,0,2,16,0,32,33,1
2134,67642,BwXR7IzUtCAN8pzY1XJl6dbItwnWn8P1,SpATywNh6bZuzm8s1ceuBUnMUAeoAHHw,17,49,21,14,3,3,16,1,107,15.285714285714286,4,0.0,15,21,14,3,34,3,0,16,1,53,54,0
2135,67645,7qacCXNHfhtV3QzmLTTx2G76bXaJZKdF,SpATywNh6bZuzm8s1ceuBUnMUAeoAHHw,16,35,10,26,4,2,8,1,86,12.285714285714286,3,0.0,7,10,21,4,28,2,5,8,1,42,44,1
2136,67658,h5afPVcogbI1QW4dfwFBz4UIlWjjM3RW,SpATywNh6bZuzm8s1ceuBUnMUAeoAHHw,13,13,1,12,1,7,15,3,52,7.428571428571429,2,0.0,2,1,11,1,11,7,1,15,3,15,37,0
2137,67667,6uiFMn8grVARFSiZJzUXdXUiSRmDc7wn,SpATywNh6bZuzm8s1ceuBUnMUAeoAHHw,5,2,1,0,1,0,2,0,6,0.8571428571428571,1,0.0,0,1,0,1,2,0,0,2,0,2,4,1
2138,67673,kXJgNJrJLFK7Wt9KanP6QLSHH0toxORn,bWdj2GDclj5ofokWjzoa5jAwMkxCykd6,8,5,1,16,2,0,4,0,28,4.0,1,0.0,3,1,15,2,2,0,1,4,0,21,7,1
2139,67698,3T1Ajx8AzLKpkWsqnzq5ndyNCwXcvT6Q,G8EPVSXsOYB5YQWZGiz1aVq5Pgr2GrQu,9,10,3,4,2,0,1,0,20,2.857142857142857,1,0.0,6,3,2,2,4,0,2,1,0,13,7,1
2140,67700,Rj8CRmBx55LfZEmX69tsiuIQYQCOEvVu,bWdj2GDclj5ofokWjzoa5jAwMkxCykd6,4,6,1,0,1,0,2,0,10,1.4285714285714286,2,0.0,2,1,0,1,4,0,0,2,0,4,6,1
2141,67705,3cEo76QwJwldypMfZu21btn9IT8f6eL0,SpATywNh6bZuzm8s1ceuBUnMUAeoAHHw,15,27,3,22,2,5,8,4,71,10.142857142857142,1,0.0,15,3,19,2,12,5,3,8,4,39,32,1
2142,67729,KY9QavBrusW9AVV6DEyZrJ3FCnXy59JE,SpATywNh6bZuzm8s1ceuBUnMUAeoAHHw,9,19,10,0,3,0,12,0,44,6.285714285714286,3,0.0,0,10,0,3,19,0,0,12,0,13,31,1
2143,67732,2gXHY5qLgY96Nt3kImmboPawcy43EQXt,bWdj2GDclj5ofokWjzoa5jAwMkxCykd6,7,14,13,0,11,0,7,1,46,6.571428571428571,2,0.0,0,13,0,11,14,0,0,7,1,24,22,1
2144,67740,uCpSmjtsmbP6Tx3GZFwKoiUihKYXvJaM,SpATywNh6bZuzm8s1ceuBUnMUAeoAHHw,12,21,0,20,0,0,3,0,44,6.285714285714286,1,0.0,12,0,17,0,9,0,3,3,0,29,15,1
2145,67750,myyvmwvFjycfP5QErbd6tsUl0M6ndOJg,bWdj2GDclj5ofokWjzoa5jAwMkxCykd6,1,0,0,0,0,0,1,0,1,0.14285714285714285,1,0.0,0,0,0,0,0,0,0,1,0,0,1,1
2146,67751,myyvmwvFjycfP5QErbd6tsUl0M6ndOJg,SpATywNh6bZuzm8s1ceuBUnMUAeoAHHw,17,28,7,21,3,14,17,1,91,13.0,2,0.0,14,7,18,3,14,14,3,17,1,42,49,1
2147,67753,KY9QavBrusW9AVV6DEyZrJ3FCnXy59JE,bWdj2GDclj5ofokWjzoa5jAwMkxCykd6,5,2,1,0,1,0,2,0,6,0.8571428571428571,1,0.0,0,1,0,1,2,0,0,2,0,2,4,1
2148,67780,GlNbCQHDc8z8JZPiUwkPuJYi1fBEr1Uj,SpATywNh6bZuzm8s1ceuBUnMUAeoAHHw,8,27,9,0,0,0,5,0,41,5.857142857142857,2,0.0,8,9,0,0,19,0,0,5,0,17,24,1
2149,67782,0hRwE5vbowYRJTF6rcWCTgSh4yHA34bg,bWdj2GDclj5ofokWjzoa5jAwMkxCykd6,15,19,1,28,1,5,10,3,67,9.571428571428571,2,0.0,3,1,24,1,16,5,4,10,3,29,38,1
2150,67785,rqqNQl0bghaqvkPV1u2C08foWzi8FdRA,SpATywNh6bZuzm8s1ceuBUnMUAeoAHHw,12,13,5,11,3,0,2,0,34,4.857142857142857,2,0.0,4,5,10,3,9,0,1,2,0,22,12,1
2151,67791,knXx0VSX34ZZdw5j0pCDnRFFDbxG6IJ6,G8EPVSXsOYB5YQWZGiz1aVq5Pgr2GrQu,12,9,5,8,3,0,2,0,27,3.857142857142857,1,0.0,3,5,5,3,6,0,3,2,0,16,11,1
2152,67792,nhiUGENuXs75W6QlSu5vemDE5ZazLnGr,SpATywNh6bZuzm8s1ceuBUnMUAeoAHHw,11,13,5,13,2,0,4,0,37,5.285714285714286,2,0.0,6,5,11,2,7,0,2,4,0,24,13,1
2153,67795,ryJpL5sHkbmvdjizu6MIIT96L8Kj1MfG,SpATywNh6bZuzm8s1ceuBUnMUAeoAHHw,13,16,8,13,4,1,2,0,44,6.285714285714286,2,0.0,5,8,10,4,11,1,3,2,0,27,17,1
2154,67802,IEfUasRNK7F4OXmh9ZRgY5RLlk7j6VcY,bWdj2GDclj5ofokWjzoa5jAwMkxCykd6,9,11,6,6,3,0,4,0,30,4.285714285714286,2,0.0,1,6,6,3,10,0,0,4,0,16,14,1
2155,67805,3g0CiljEiblxCvXeNEcFARnThDq8TtPt,SpATywNh6bZuzm8s1ceuBUnMUAeoAHHw,17,42,16,13,9,15,8,1,104,14.857142857142858,5,0.0,12,16,12,9,30,15,1,8,1,49,55,0
2156,67814,7YAyDVo7GNQL9jwTCNlUB5NS22KP2Dmb,bWdj2GDclj5ofokWjzoa5jAwMkxCykd6,1,0,0,0,0,0,1,0,1,0.14285714285714285,1,0.0,0,0,0,0,0,0,0,1,0,0,1,1
2157,67826,arUYdy6tAdeT8uL5IVe1ucPvbGcQUSs0,RXDvfPUBYFlVdlueBFbLW0mhhAyGEqpt,45,32,19,89,14,2,8,1,165,23.571428571428573,3,0.0,10,19,82,14,22,2,7,8,1,125,40,0
2158,67828,8MQx62NrM26CEa5RRkhFUh36AiGGNx6S,SpATywNh6bZuzm8s1ceuBUnMUAeoAHHw,1,0,0,0,0,0,1,0,1,0.14285714285714285,1,0.0,0,0,0,0,0,0,0,1,0,0,1,1
2159,67840,liGkK11lmEt5l6sf4BenFBe3u0IYqC3Z,bWdj2GDclj5ofokWjzoa5jAwMkxCykd6,1,0,0,0,0,0,1,0,1,0.14285714285714285,1,0.0,0,0,0,0,0,0,0,1,0,0,1,1
2160,67844,e2v0YuUkw7VpGwXO9DL86A4Bv6MP4mEu,SpATywNh6bZuzm8s1ceuBUnMUAeoAHHw,6,3,1,0,1,0,3,0,8,1.1428571428571428,1,0.0,0,1,0,1,3,0,0,3,0,2,6,1
2161,67852,3Aezv8lgcVyIW4Uwgi3KMiL4RZSkwke5,SpATywNh6bZuzm8s1ceuBUnMUAeoAHHw,17,23,10,10,4,29,10,0,86,12.285714285714286,3,0.0,10,10,8,4,13,29,2,10,0,32,54,1
2162,67860,zILXfIGJjWXm6dA2MrEQWr2XeEUry8lN,G8EPVSXsOYB5YQWZGiz1aVq5Pgr2GrQu,7,2,1,0,1,0,4,0,8,1.1428571428571428,1,0.0,0,1,0,1,2,0,0,4,0,2,6,1
2163,67870,w3ElIgawNC8WwURVJSAJ04McneT8QIvi,G8EPVSXsOYB5YQWZGiz1aVq5Pgr2GrQu,22,22,19,48,10,3,4,0,106,15.142857142857142,2,0.0,0,19,38,10,22,3,10,4,0,67,39,1
2164,67877,3kPbFQO63O023TRazY2t5V1M3b8brUv8,SpATywNh6bZuzm8s1ceuBUnMUAeoAHHw,7,10,0,0,0,1,3,0,14,2.0,2,0.0,0,0,0,0,10,1,0,3,0,0,14,1
2165,67879,bRwq2z1Yz5KS0MW4CkmNDI34p59fmbas,RXDvfPUBYFlVdlueBFbLW0mhhAyGEqpt,5,3,1,0,0,0,2,0,6,0.8571428571428571,1,0.0,0,1,0,0,3,0,0,2,0,1,5,1
2166,67909,sFJi6moEGD2T3AyA8nWt11YDR7GEvwod,bWdj2GDclj5ofokWjzoa5jAwMkxCykd6,8,7,4,0,2,2,10,1,26,3.7142857142857144,2,0.0,0,4,0,2,7,2,0,10,1,6,20,1
2167,67912,P0LyrpZzGdWXSuU2oQCFUf1LzUdIEooV,SpATywNh6bZuzm8s1ceuBUnMUAeoAHHw,5,2,1,0,1,0,2,0,6,0.8571428571428571,1,0.0,0,1,0,1,2,0,0,2,0,2,4,1
2168,67916,kbnRP5v2Cp1hRovzbBsM6Gb1jKCIVIhL,bWdj2GDclj5ofokWjzoa5jAwMkxCykd6,5,8,2,0,2,0,5,0,17,2.4285714285714284,3,0.0,0,2,0,2,8,0,0,5,0,4,13,1
2169,67918,pzHaWUcmzb5LgLjIjpaBYBq7daMNFpyk,SpATywNh6bZuzm8s1ceuBUnMUAeoAHHw,13,12,1,20,0,0,18,0,51,7.285714285714286,3,0.0,2,1,16,0,10,0,4,18,0,19,32,1
2170,67921,QqqCImBc1OlgaSz0c9g0FVsZigKUtiqT,SpATywNh6bZuzm8s1ceuBUnMUAeoAHHw,6,1,1,0,1,0,3,0,6,0.8571428571428571,1,0.0,0,1,0,1,1,0,0,3,0,2,4,1
2171,67923,GDzMP0flkQ2hBX32d5dxAzabEDzF5Okt,SpATywNh6bZuzm8s1ceuBUnMUAeoAHHw,8,21,9,0,7,0,1,0,38,5.428571428571429,1,0.0,0,9,0,7,21,0,0,1,0,16,22,1
2172,67930,x6K6gEN1bi7EtUHqEXEFGztPxJcTq3NW,SpATywNh6bZuzm8s1ceuBUnMUAeoAHHw,16,23,10,16,3,0,8,0,60,8.571428571428571,3,0.0,4,10,14,3,19,0,2,8,0,31,29,1
2173,67931,OYfteiWNoHqPLaPu97Z12Qs0dcDVEU6S,SpATywNh6bZuzm8s1ceuBUnMUAeoAHHw,10,5,4,0,3,0,2,0,14,2.0,1,0.0,0,4,0,3,5,0,0,2,0,7,7,1
2174,67933,f517pkeTgS2hq8EkZsCwn6jk8FMpBlHa,bWdj2GDclj5ofokWjzoa5jAwMkxCykd6,5,5,3,0,2,0,2,0,12,1.7142857142857142,2,0.0,0,3,0,2,5,0,0,2,0,5,7,1
2175,67939,96BILLwhKLX5Hn5XJ4XGCvMlo8QDhAAj,bWdj2GDclj5ofokWjzoa5jAwMkxCykd6,1,0,0,0,0,0,1,0,1,0.14285714285714285,1,0.0,0,0,0,0,0,0,0,1,0,0,1,1
2176,67951,p9mlVtqvvgTSd0U238vycamcjMBfubit,SpATywNh6bZuzm8s1ceuBUnMUAeoAHHw,8,9,7,0,4,0,5,0,25,3.5714285714285716,1,0.0,0,7,0,4,9,0,0,5,0,11,14,1
2177,67956,laZtrdxzAU1QbcDNiYt367rO7zb5NT6r,SpATywNh6bZuzm8s1ceuBUnMUAeoAHHw,1,0,0,0,0,0,1,0,1,0.14285714285714285,1,0.0,0,0,0,0,0,0,0,1,0,0,1,1
2178,67974,5RgoX61rBJXf0CtdNHC5FjUHV0bRPnZt,SpATywNh6bZuzm8s1ceuBUnMUAeoAHHw,10,3,3,0,2,1,4,1,14,2.0,1,0.0,0,3,0,2,3,1,0,4,1,5,9,1
2179,67989,hSX8yZ4n5gfrq8om8peGXZoF496tHdJ6,SpATywNh6bZuzm8s1ceuBUnMUAeoAHHw,1,0,0,0,0,0,1,0,1,0.14285714285714285,1,0.0,0,0,0,0,0,0,0,1,0,0,1,1
2180,67995,LHXRg7L7kOMUaNixGAIsvmtlbCTLBkt1,G8EPVSXsOYB5YQWZGiz1aVq5Pgr2GrQu,12,10,1,26,0,0,5,0,42,6.0,1,0.0,1,1,23,0,9,0,3,5,0,25,17,1
2181,68000,zP7Uswh6CHfnx5kLYcdPpqokCtUDEMqC,SpATywNh6bZuzm8s1ceuBUnMUAeoAHHw,9,6,4,0,2,0,5,0,17,2.4285714285714284,1,0.0,0,4,0,2,6,0,0,5,0,6,11,1
2182,68003,hc3dSrci35Dy3FgQbfVD88Ol0CqYSCR2,RXDvfPUBYFlVdlueBFbLW0mhhAyGEqpt,39,34,20,56,13,5,1,0,129,18.428571428571427,1,0.0,12,20,53,13,22,5,3,1,0,98,31,1
2183,68011,Y0dtU5bUn0PrrnfgvOUCPfb1rktwn4CX,SpATywNh6bZuzm8s1ceuBUnMUAeoAHHw,4,2,1,0,1,0,1,0,5,0.7142857142857143,1,0.0,0,1,0,1,2,0,0,1,0,2,3,1
2184,68014,eSHpbUzZvfLR4whtzGnR3u58hC1o1DTb,SpATywNh6bZuzm8s1ceuBUnMUAeoAHHw,8,5,3,0,2,1,6,0,17,2.4285714285714284,2,0.0,0,3,0,2,5,1,0,6,0,5,12,1
2185,68031,bez5lZ7uTfbzlLF7Tc3pJJ6gxAYK8BMg,RXDvfPUBYFlVdlueBFbLW0mhhAyGEqpt,1,0,0,0,0,0,1,0,1,0.14285714285714285,1,0.0,0,0,0,0,0,0,0,1,0,0,1,1
2186,68033,g3VeqRwacliKE1TZTgZHIE5PL7TPQV85,SpATywNh6bZuzm8s1ceuBUnMUAeoAHHw,3,2,0,0,0,0,1,0,3,0.42857142857142855,1,0.0,0,0,0,0,2,0,0,1,0,0,3,1
2187,68043,mHfTvd1CfaCURBT44fgL7AymprwCoavs,SpATywNh6bZuzm8s1ceuBUnMUAeoAHHw,17,34,5,20,3,3,18,1,84,12.0,3,0.0,5,5,16,3,29,3,4,18,1,29,55,1
2188,68045,Qxy5KsClrN9vr6xM8xy9xnCXA2MaJ6Yo,SpATywNh6bZuzm8s1ceuBUnMUAeoAHHw,4,4,0,0,0,0,2,0,6,0.8571428571428571,1,0.0,0,0,0,0,4,0,0,2,0,0,6,1
2189,68057,zmlL73g2U1Ek37ZDQ2H6P7dwK1MBsxuX,SpATywNh6bZuzm8s1ceuBUnMUAeoAHHw,12,32,19,0,13,6,7,1,78,11.142857142857142,3,0.0,0,19,0,13,32,6,0,7,1,32,46,1
2190,68059,V87r8ov3AJYZnaKsWbASGu8Ya7b0fguH,SpATywNh6bZuzm8s1ceuBUnMUAeoAHHw,9,11,5,2,1,0,3,0,22,3.142857142857143,2,0.0,3,5,2,1,8,0,0,3,0,11,11,1
2191,68070,1VCQvdBqSLamldHF1ZwYh2NF4ESIqek2,bWdj2GDclj5ofokWjzoa5jAwMkxCykd6,1,0,0,0,0,0,1,0,1,0.14285714285714285,1,0.0,0,0,0,0,0,0,0,1,0,0,1,1
2192,68073,Q3zfa1BaaSk3KZquv3yDWk8LnczxvujV,SpATywNh6bZuzm8s1ceuBUnMUAeoAHHw,13,8,5,0,4,1,10,1,29,4.142857142857143,1,0.0,2,5,0,4,6,1,0,10,1,11,18,1
2193,68080,PwGj8ON4yrWpMaoZE0ES8sG2eAqFQNfN,bWdj2GDclj5ofokWjzoa5jAwMkxCykd6,8,11,6,0,3,17,7,2,46,6.571428571428571,3,0.0,0,6,0,3,11,17,0,7,2,9,37,1
2194,68106,13DcuqcvvZMyCe7b78EqeBeeWiXw335e,G8EPVSXsOYB5YQWZGiz1aVq5Pgr2GrQu,21,62,4,0,9,0,19,2,96,13.714285714285714,3,0.0,23,4,0,9,39,0,0,19,2,36,60,1
2195,68109,uFrJImuWBoPsyUWzay10wbSOjd0eMaSI,SpATywNh6bZuzm8s1ceuBUnMUAeoAHHw,15,15,5,18,3,1,10,0,52,7.428571428571429,2,0.0,10,5,15,3,5,1,3,10,0,33,19,1
2196,68117,MDJGW12z1ZhMFT2gTIbEYAqP2tu7pkDh,SpATywNh6bZuzm8s1ceuBUnMUAeoAHHw,17,20,11,12,5,0,14,1,63,9.0,2,0.0,2,11,12,5,18,0,0,14,1,30,33,0
2197,68119,Wigd4PnyDnjfDcFOxsTBcEnXo7kl9GSg,RXDvfPUBYFlVdlueBFbLW0mhhAyGEqpt,15,37,5,29,1,0,8,4,84,12.0,3,0.0,5,5,22,1,32,0,7,8,4,33,51,1
2198,68122,q1MlrkW0KNfJjOXajII1Q1GZBULc6aNj,SpATywNh6bZuzm8s1ceuBUnMUAeoAHHw,13,14,1,21,1,11,13,3,64,9.142857142857142,2,0.0,6,1,18,1,8,11,3,13,3,26,38,1
2199,68135,HStxcO1eYnD7c9LphwK9HrPR7VO3IHfm,SpATywNh6bZuzm8s1ceuBUnMUAeoAHHw,12,11,0,13,0,7,5,1,37,5.285714285714286,1,0.0,3,0,11,0,8,7,2,5,1,14,23,1
2200,68153,EY0G0vEEEoCokHenoT1cdgE4rcGAf4FL,G8EPVSXsOYB5YQWZGiz1aVq5Pgr2GrQu,4,2,1,0,1,0,1,0,5,0.7142857142857143,1,0.0,0,1,0,1,2,0,0,1,0,2,3,0
2201,68154,APkKPEpve0ecRJut2qy8IYwsafYtrJRq,bWdj2GDclj5ofokWjzoa5jAwMkxCykd6,3,2,0,0,0,0,3,0,5,0.7142857142857143,2,0.0,0,0,0,0,2,0,0,3,0,0,5,1
2202,68160,DYC2TKuAWipp9UNJIdqFLJgrkLj9mdOD,bWdj2GDclj5ofokWjzoa5jAwMkxCykd6,15,22,7,36,2,0,10,1,78,11.142857142857142,3,0.0,5,7,32,2,17,0,4,10,1,46,32,0
2203,68169,U8vo2wOZC3Q8EW1kIl6iwoIzgmQUZ4u1,bWdj2GDclj5ofokWjzoa5jAwMkxCykd6,1,0,0,0,0,0,1,0,1,0.14285714285714285,1,0.0,0,0,0,0,0,0,0,1,0,0,1,1
2204,68170,bpxaFadaQixJuWRVtAAq5miKiBM3zC6u,bWdj2GDclj5ofokWjzoa5jAwMkxCykd6,9,8,1,32,2,0,4,0,47,6.714285714285714,1,0.0,3,1,31,2,5,0,1,4,0,37,10,1
2205,68171,XNe46LXabpvEI4s4Cxqc45erOVco8nzW,RXDvfPUBYFlVdlueBFbLW0mhhAyGEqpt,38,26,15,42,7,16,9,3,118,16.857142857142858,2,0.0,7,15,35,7,19,16,7,9,3,64,54,0
2206,68177,y6oK2aw09rZ1km46IcOJlYdWLv4Nbbgi,G8EPVSXsOYB5YQWZGiz1aVq5Pgr2GrQu,3,5,1,0,1,0,1,0,8,1.1428571428571428,1,0.0,3,1,0,1,2,0,0,1,0,5,3,1
2207,68185,LGH5sOmtpw8WtitJ1dxQtTEBLQHqJEi1,SpATywNh6bZuzm8s1ceuBUnMUAeoAHHw,8,5,4,0,3,1,8,0,21,3.0,1,0.0,0,4,0,3,5,1,0,8,0,7,14,1
2208,68190,hWdLPP6trGxWYA1TuFBESlsN42OdBR5S,G8EPVSXsOYB5YQWZGiz1aVq5Pgr2GrQu,6,4,1,0,1,0,2,0,8,1.1428571428571428,1,0.0,0,1,0,1,4,0,0,2,0,2,6,1
2209,68192,TWLIxoyQjwriLBEzpRamZWHBF7mx1bZa,SpATywNh6bZuzm8s1ceuBUnMUAeoAHHw,6,11,0,0,0,0,4,0,15,2.142857142857143,2,0.0,1,0,0,0,10,0,0,4,0,1,14,1
2210,68199,rcnv42t7RT4fLoWqKHgTKDC8e00KMJQL,G8EPVSXsOYB5YQWZGiz1aVq5Pgr2GrQu,43,52,20,134,1,7,20,2,236,33.714285714285715,2,0.0,15,20,107,1,37,7,27,20,2,143,93,1
2211,68216,PiwCisYixMxmp8HVjRmlBlqNy6QSUUjE,SpATywNh6bZuzm8s1ceuBUnMUAeoAHHw,11,19,8,0,3,13,9,1,53,7.571428571428571,3,0.0,0,8,0,3,19,13,0,9,1,11,42,1
2212,68218,Lbpr3xWnQcIYr1qRkqlNlsrYRpIeuPh8,SpATywNh6bZuzm8s1ceuBUnMUAeoAHHw,9,21,4,0,2,0,9,0,36,5.142857142857143,4,0.0,2,4,0,2,19,0,0,9,0,8,28,1
2213,68219,PLTytqL5kLJdDGm9MvAFVaFDS2S7nPDO,SpATywNh6bZuzm8s1ceuBUnMUAeoAHHw,12,14,7,4,3,0,4,0,32,4.571428571428571,4,0.0,1,7,4,3,13,0,0,4,0,15,17,1
2214,68231,c21M8vKZ0MTakbncwKdeoIofnrY81cjv,SpATywNh6bZuzm8s1ceuBUnMUAeoAHHw,1,0,0,0,0,0,1,0,1,0.14285714285714285,1,0.0,0,0,0,0,0,0,0,1,0,0,1,1
2215,68232,afcoJmZ0nAGqrhElRzMbfqW6LhEtEJYc,bWdj2GDclj5ofokWjzoa5jAwMkxCykd6,7,8,4,0,3,0,4,0,19,2.7142857142857144,1,0.0,2,4,0,3,6,0,0,4,0,9,10,1
2216,68233,MulztkDP8i6NO9fvTruczDhNDdweXQmA,SpATywNh6bZuzm8s1ceuBUnMUAeoAHHw,7,6,5,0,1,0,1,0,13,1.8571428571428572,1,0.0,0,5,0,1,6,0,0,1,0,6,7,0
2217,68255,KkwBRsW7iwfoq3LjJ8XmEzXVsYBRv2GT,RXDvfPUBYFlVdlueBFbLW0mhhAyGEqpt,8,5,0,0,0,8,7,1,21,3.0,2,0.0,0,0,0,0,5,8,0,7,1,0,21,1
2218,68284,AffDAPGfOBWNdcJAjvPAA03wTtMubBsN,SpATywNh6bZuzm8s1ceuBUnMUAeoAHHw,14,7,4,9,3,0,3,0,26,3.7142857142857144,1,0.0,2,4,9,3,5,0,0,3,0,18,8,1
2219,68291,uuLKbFK5mMvYPMLqDF2i3zslYpeZQmHn,SpATywNh6bZuzm8s1ceuBUnMUAeoAHHw,3,0,0,0,0,1,3,0,4,0.5714285714285714,1,0.0,0,0,0,0,0,1,0,3,0,0,4,1
2220,68297,KGm62I3mVkjiGl4NGvCWbKWuafRNbMyV,SpATywNh6bZuzm8s1ceuBUnMUAeoAHHw,8,9,4,0,2,0,4,0,19,2.7142857142857144,2,0.0,1,4,0,2,8,0,0,4,0,7,12,0
2221,68301,NRKadp4j4jPDuLDbaa9Nm62h1VN187qT,SpATywNh6bZuzm8s1ceuBUnMUAeoAHHw,17,28,12,16,4,71,27,2,160,22.857142857142858,2,0.0,9,12,15,4,19,71,1,27,2,40,120,1
2222,68311,HbZIH6bmQW1HcPZo94YfjT1UBGLpCJBJ,SpATywNh6bZuzm8s1ceuBUnMUAeoAHHw,5,2,1,0,1,0,2,0,6,0.8571428571428571,1,0.0,0,1,0,1,2,0,0,2,0,2,4,1
2223,68315,egnijdxL4Cz1CfzoCQSNIgWry6KIzA7P,G8EPVSXsOYB5YQWZGiz1aVq5Pgr2GrQu,11,15,6,2,4,0,2,0,29,4.142857142857143,2,0.0,2,6,2,4,13,0,0,2,0,14,15,1
2224,68322,FfFp5bobRPRps1SNXZNMmjBhJWfjO7gk,RXDvfPUBYFlVdlueBFbLW0mhhAyGEqpt,5,2,1,0,1,0,2,0,6,0.8571428571428571,1,0.0,0,1,0,1,2,0,0,2,0,2,4,1
2225,68328,y9yy4SYGgNo4YF8eQGlTVidGNj2rzbsP,G8EPVSXsOYB5YQWZGiz1aVq5Pgr2GrQu,5,3,2,0,1,0,1,0,7,1.0,1,0.0,0,2,0,1,3,0,0,1,0,3,4,1
2226,68354,ojZgxZ6gEjMazXpFaRfu4Ae98N9ZNMRK,bWdj2GDclj5ofokWjzoa5jAwMkxCykd6,7,3,1,0,1,0,5,0,10,1.4285714285714286,2,0.0,1,1,0,1,2,0,0,5,0,3,7,1
2227,68355,Su5k7DFmddHd0lx2vnzPJZVUiGwHL7uO,SpATywNh6bZuzm8s1ceuBUnMUAeoAHHw,1,0,0,0,0,0,1,0,1,0.14285714285714285,1,0.0,0,0,0,0,0,0,0,1,0,0,1,1
2228,68358,MKeSX2kzyiQphau2C7yhMMzLx4acc2Cv,SpATywNh6bZuzm8s1ceuBUnMUAeoAHHw,9,11,6,0,3,0,2,0,22,3.142857142857143,1,0.0,0,6,0,3,11,0,0,2,0,9,13,1
2229,68366,KWreIfKGdz3TT4Efo15YH7GPido1RPFL,RXDvfPUBYFlVdlueBFbLW0mhhAyGEqpt,7,6,4,0,2,0,6,0,18,2.5714285714285716,2,0.0,0,4,0,2,6,0,0,6,0,6,12,1
2230,68367,sU7Jp2ENUb9Oqtzi9ZG3CKbDOgPtBcP1,SpATywNh6bZuzm8s1ceuBUnMUAeoAHHw,11,22,11,0,6,19,13,1,72,10.285714285714286,1,0.0,6,11,0,6,16,19,0,13,1,23,49,1
2231,68368,jzWvwaTexkgbyBrPkQbXDb98Viqx6cSS,bWdj2GDclj5ofokWjzoa5jAwMkxCykd6,11,7,3,22,2,0,1,0,35,5.0,1,0.0,3,3,21,2,4,0,1,1,0,29,6,1
2232,68381,tx4grxmlQgEoy6eADYfJTj1STA6T1B91,RXDvfPUBYFlVdlueBFbLW0mhhAyGEqpt,4,2,1,0,1,0,1,0,5,0.7142857142857143,2,0.0,0,1,0,1,2,0,0,1,0,2,3,1
2233,68391,GVe9EjZzf7ESYXvbkluFC1UhcDJcs9er,bWdj2GDclj5ofokWjzoa5jAwMkxCykd6,9,24,11,40,5,10,6,0,96,13.714285714285714,2,0.0,5,11,37,5,19,10,3,6,0,58,38,1
2234,68431,lrklBeCwIZ4DDBQy8VTt6d0eH3oNMMDo,G8EPVSXsOYB5YQWZGiz1aVq5Pgr2GrQu,10,12,8,0,4,0,6,0,30,4.285714285714286,2,0.0,0,8,0,4,12,0,0,6,0,12,18,1
2235,68434,Ebz4oSsfYjG2sZnxJFfxROe10fAGS03Z,bWdj2GDclj5ofokWjzoa5jAwMkxCykd6,8,3,2,0,1,3,6,1,16,2.2857142857142856,1,0.0,0,2,0,1,3,3,0,6,1,3,13,1
2236,68452,BmDa42DEGdvrNnigHMvPc7GGH9qDy89v,bWdj2GDclj5ofokWjzoa5jAwMkxCykd6,3,0,0,0,0,0,3,0,3,0.42857142857142855,1,0.0,0,0,0,0,0,0,0,3,0,0,3,1
2237,68460,dxAA51K7owVPQlCgekrtAuSBHXcBEsAY,SpATywNh6bZuzm8s1ceuBUnMUAeoAHHw,8,5,3,0,3,0,1,0,12,1.7142857142857142,2,0.0,0,3,0,3,5,0,0,1,0,6,6,0
2238,68466,ZDEv7xdHlbONQGNdkwzMgbMsJFIzjdrJ,bWdj2GDclj5ofokWjzoa5jAwMkxCykd6,5,3,2,0,1,0,2,0,8,1.1428571428571428,1,0.0,0,2,0,1,3,0,0,2,0,3,5,1
2239,68469,Xa3jTMZEURd4gE5fwojMlxo2QtjAxwez,bWdj2GDclj5ofokWjzoa5jAwMkxCykd6,2,0,0,0,0,0,3,0,3,0.42857142857142855,2,0.0,0,0,0,0,0,0,0,3,0,0,3,1
2240,68481,pXqbqKhLN9u2vMm4aIB5JwL5PRPhZDCp,SpATywNh6bZuzm8s1ceuBUnMUAeoAHHw,14,20,2,13,1,8,7,2,53,7.571428571428571,3,0.0,9,2,11,1,11,8,2,7,2,23,30,0
2241,68486,DudAvEFW2YcxyABZugZo1M6Olvw9DyeE,SpATywNh6bZuzm8s1ceuBUnMUAeoAHHw,6,1,1,0,1,0,3,0,6,0.8571428571428571,1,0.0,0,1,0,1,1,0,0,3,0,2,4,1
2242,68490,hjbzzLF0uZqUL22zLBiQhzq51chcw6mb,SpATywNh6bZuzm8s1ceuBUnMUAeoAHHw,14,29,14,15,6,1,4,0,69,9.857142857142858,1,0.0,9,14,11,6,20,1,4,4,0,40,29,1
2243,68495,MT2eJtF59AVNdUs7mwFqputROb2HgEm3,bWdj2GDclj5ofokWjzoa5jAwMkxCykd6,6,8,4,0,4,0,3,0,19,2.7142857142857144,2,0.0,2,4,0,4,6,0,0,3,0,10,9,0
2244,68504,nB3KwulRK6CdNkJMXAR7thY3WeV5E2Rs,bWdj2GDclj5ofokWjzoa5jAwMkxCykd6,5,2,1,0,1,1,4,0,9,1.2857142857142858,1,0.0,0,1,0,1,2,1,0,4,0,2,7,1
2245,68506,FjEPRVEQHV2jJGjIE0BfvDTSFq9OoqAS,SpATywNh6bZuzm8s1ceuBUnMUAeoAHHw,15,18,11,4,7,0,11,2,53,7.571428571428571,3,0.0,5,11,4,7,13,0,0,11,2,27,26,1
2246,68512,hg5y95p09bcGVElNVwoGOakcfzg7TGFk,bWdj2GDclj5ofokWjzoa5jAwMkxCykd6,6,5,3,0,2,0,6,0,16,2.2857142857142856,1,0.0,0,3,0,2,5,0,0,6,0,5,11,1
2247,68518,FwweMXtSQjX7f97OVLsz3BQNG8M83X1n,SpATywNh6bZuzm8s1ceuBUnMUAeoAHHw,7,2,1,0,1,0,4,0,8,1.1428571428571428,1,0.0,0,1,0,1,2,0,0,4,0,2,6,1
2248,68522,iSIDy53M1GeZpXt46JkUT1CVMnifiRBT,G8EPVSXsOYB5YQWZGiz1aVq5Pgr2GrQu,38,73,43,44,20,89,39,21,329,47.0,5,0.0,8,43,37,20,65,89,7,39,21,108,221,1
2249,68525,y0PkAopIdLmRFrkWC9eBHvWT77KfVWMh,RXDvfPUBYFlVdlueBFbLW0mhhAyGEqpt,1,0,0,0,0,0,1,0,1,0.14285714285714285,1,0.0,0,0,0,0,0,0,0,1,0,0,1,1
2250,68530,roxYJjIM3BSzWIDsW2TPAjzeyToX557n,SpATywNh6bZuzm8s1ceuBUnMUAeoAHHw,1,0,0,0,0,0,1,0,1,0.14285714285714285,1,0.0,0,0,0,0,0,0,0,1,0,0,1,1
2251,68531,hZR4MwcYec4g0GoOyJFngJGEyWOySpv2,RXDvfPUBYFlVdlueBFbLW0mhhAyGEqpt,17,11,7,8,4,3,11,0,44,6.285714285714286,2,0.0,1,7,6,4,10,3,2,11,0,18,26,0
2252,68546,op92WqXlATrimvc1hvYZEQwtjHkoChge,RXDvfPUBYFlVdlueBFbLW0mhhAyGEqpt,13,11,2,0,2,7,10,0,32,4.571428571428571,2,0.0,5,2,0,2,6,7,0,10,0,9,23,1
2253,68557,5yc0fnnf6Ve0yL1SBLUJVE35F9aXHffP,bWdj2GDclj5ofokWjzoa5jAwMkxCykd6,1,0,0,0,0,0,2,0,2,0.2857142857142857,1,0.0,0,0,0,0,0,0,0,2,0,0,2,1
2254,68570,w66Ys32IF7bg4QEY48rFtd8o9lijcjC3,SpATywNh6bZuzm8s1ceuBUnMUAeoAHHw,7,5,2,0,2,0,5,0,14,2.0,2,0.0,0,2,0,2,5,0,0,5,0,4,10,1
2255,68576,eC5OrlIfDx9Fw0Jh12C4RyvK1vDrMSLj,SpATywNh6bZuzm8s1ceuBUnMUAeoAHHw,11,12,1,0,0,2,9,1,25,3.5714285714285716,2,0.0,0,1,0,0,12,2,0,9,1,1,24,1
2256,68579,forPgRyluFqH5fyMZfnKJctNYjPII95b,SpATywNh6bZuzm8s1ceuBUnMUAeoAHHw,1,0,0,0,0,0,1,0,1,0.14285714285714285,1,0.0,0,0,0,0,0,0,0,1,0,0,1,1
2257,68583,forPgRyluFqH5fyMZfnKJctNYjPII95b,RXDvfPUBYFlVdlueBFbLW0mhhAyGEqpt,15,14,2,0,1,18,11,5,51,7.285714285714286,1,0.0,0,2,0,1,14,18,0,11,5,3,48,1
2258,68588,yIoYmR4ll93f7EHu29moXjbx4kT37xAM,bWdj2GDclj5ofokWjzoa5jAwMkxCykd6,18,27,4,70,7,7,16,2,133,19.0,2,0.0,10,4,64,7,17,7,6,16,2,85,48,1
2259,68591,b8js5e6thEnzYItgffCHQwfAl1iYfizN,SpATywNh6bZuzm8s1ceuBUnMUAeoAHHw,9,9,6,0,4,1,12,2,34,4.857142857142857,1,0.0,0,6,0,4,9,1,0,12,2,10,24,1
2260,68605,SZOXOmDilP1KR3OJXHpIlLf61tEoqX1S,G8EPVSXsOYB5YQWZGiz1aVq5Pgr2GrQu,4,2,1,0,1,0,1,0,5,0.7142857142857143,1,0.0,0,1,0,1,2,0,0,1,0,2,3,1
2261,68625,4QX0UVH2mWoWEvrk1Om8ECy2pBWoKhcm,SpATywNh6bZuzm8s1ceuBUnMUAeoAHHw,6,5,1,0,1,0,1,0,8,1.1428571428571428,1,0.0,1,1,0,1,4,0,0,1,0,3,5,1
2262,68629,M2AmcvqhvMtUlyRV6vMvvoM2IhrMmAwT,bWdj2GDclj5ofokWjzoa5jAwMkxCykd6,4,2,0,0,0,0,2,0,4,0.5714285714285714,2,0.0,0,0,0,0,2,0,0,2,0,0,4,1
2263,68637,M4sV24yJlA7UYO36nFDbwFj49msCFYqO,SpATywNh6bZuzm8s1ceuBUnMUAeoAHHw,1,0,0,0,0,0,1,0,1,0.14285714285714285,1,0.0,0,0,0,0,0,0,0,1,0,0,1,1
2264,68650,3blAUsZiu4FW1Jp6vOBSuHfrNCEPv1lZ,RXDvfPUBYFlVdlueBFbLW0mhhAyGEqpt,11,10,3,0,2,0,6,0,21,3.0,2,0.0,0,3,0,2,10,0,0,6,0,5,16,0
2265,68657,kouVFmC9KYKK6YQi2WuQuIKCuxGX5ljt,RXDvfPUBYFlVdlueBFbLW0mhhAyGEqpt,37,34,3,79,3,3,6,1,129,18.428571428571427,4,0.0,10,3,75,3,24,3,4,6,1,91,38,0
2266,68662,JZ0cPuTVmC70maYF6NIorZr3bOTKKvsS,SpATywNh6bZuzm8s1ceuBUnMUAeoAHHw,1,0,0,0,0,0,1,0,1,0.14285714285714285,1,0.0,0,0,0,0,0,0,0,1,0,0,1,1
2267,68664,DfCrd6VP4inLGSvbDnl7Xl7qOqvm6UpO,SpATywNh6bZuzm8s1ceuBUnMUAeoAHHw,4,2,1,0,1,0,1,0,5,0.7142857142857143,1,0.0,0,1,0,1,2,0,0,1,0,2,3,1
2268,68665,9LD2dY2JJUiq4N2gerCXLTVCO162xgQP,G8EPVSXsOYB5YQWZGiz1aVq5Pgr2GrQu,7,3,0,0,0,1,5,1,10,1.4285714285714286,1,0.0,0,0,0,0,3,1,0,5,1,0,10,1
2269,68667,13fzVwLJSsgGzTLwjEHCuvf0Ks8dgxYZ,RXDvfPUBYFlVdlueBFbLW0mhhAyGEqpt,1,0,0,0,0,0,1,0,1,0.14285714285714285,1,0.0,0,0,0,0,0,0,0,1,0,0,1,1
2270,68676,OvG0QIZOPiV3oa4UqFgxzNEprO7pKVmV,SpATywNh6bZuzm8s1ceuBUnMUAeoAHHw,17,12,5,8,3,4,11,1,44,6.285714285714286,3,0.0,2,5,8,3,10,4,0,11,1,18,26,0
2271,68687,lPU0lJqSA3OSdb8bK1yzncqCybAP9bUO,SpATywNh6bZuzm8s1ceuBUnMUAeoAHHw,16,59,31,18,7,29,18,0,162,23.142857142857142,2,0.0,9,31,16,7,50,29,2,18,0,63,99,1
2272,68688,s4immbICvRMkMxvZyJBqO325qtK1yhVk,G8EPVSXsOYB5YQWZGiz1aVq5Pgr2GrQu,3,3,0,0,0,0,1,0,4,0.5714285714285714,1,0.0,1,0,0,0,2,0,0,1,0,1,3,1
2273,68699,lyCFhIpUX9eBaODrOlziE1wpuE5i2FcV,bWdj2GDclj5ofokWjzoa5jAwMkxCykd6,2,0,0,0,0,0,2,0,2,0.2857142857142857,1,0.0,0,0,0,0,0,0,0,2,0,0,2,1
2274,68703,Th6GGIKucyCokdQsUn3aOeloTzqx0Qbo,SpATywNh6bZuzm8s1ceuBUnMUAeoAHHw,1,0,0,0,0,0,1,0,1,0.14285714285714285,1,0.0,0,0,0,0,0,0,0,1,0,0,1,1
2275,68704,5MOHfgPntZIsRWkQebauzpUgUSaHvhFJ,SpATywNh6bZuzm8s1ceuBUnMUAeoAHHw,12,25,14,9,2,9,9,0,68,9.714285714285714,4,0.0,1,14,7,2,24,9,2,9,0,24,44,0
2276,68705,yZYTsrvrgsLaQebVaD5W80s8tJxpcy3t,SpATywNh6bZuzm8s1ceuBUnMUAeoAHHw,7,8,4,0,3,0,3,0,18,2.5714285714285716,1,0.0,0,4,0,3,8,0,0,3,0,7,11,1
2277,68711,fFCTtQQCOOjijvFKvRDQiA777EKDq9kt,RXDvfPUBYFlVdlueBFbLW0mhhAyGEqpt,33,29,19,52,0,0,9,7,116,16.571428571428573,4,0.0,7,19,49,0,22,0,3,9,7,75,41,1
2278,68717,XB4WTxkP3vNmHXjALkkfZII5POid4TAu,SpATywNh6bZuzm8s1ceuBUnMUAeoAHHw,3,2,0,0,0,0,1,0,3,0.42857142857142855,1,0.0,0,0,0,0,2,0,0,1,0,0,3,1
2279,68720,XJxfWg6ep0iC8D7yOZX3PZy18MtrFPsI,SpATywNh6bZuzm8s1ceuBUnMUAeoAHHw,9,13,10,0,5,0,2,0,30,4.285714285714286,2,0.0,0,10,0,5,13,0,0,2,0,15,15,1
2280,68731,KgATxoqrB3vgLjFK8Jvt9HJ7S86x88Nt,SpATywNh6bZuzm8s1ceuBUnMUAeoAHHw,1,0,0,0,0,0,1,0,1,0.14285714285714285,1,0.0,0,0,0,0,0,0,0,1,0,0,1,1
2281,68732,pyElpGpHSNzEpZ3jrGlcGeNI8YUApbgQ,bWdj2GDclj5ofokWjzoa5jAwMkxCykd6,19,45,19,38,8,20,7,4,141,20.142857142857142,3,0.0,6,19,35,8,39,20,3,7,4,68,73,1
2282,68739,kNijCkWRNCwIOtL9mKx9mB8Vau6ujWr3,SpATywNh6bZuzm8s1ceuBUnMUAeoAHHw,8,6,3,0,2,0,3,0,14,2.0,1,0.0,2,3,0,2,4,0,0,3,0,7,7,1
2283,68750,gf8nHDqKPX2j100RHCT9dT19AZw0vESt,bWdj2GDclj5ofokWjzoa5jAwMkxCykd6,4,2,1,0,1,0,1,0,5,0.7142857142857143,1,0.0,0,1,0,1,2,0,0,1,0,2,3,1
2284,68771,2DRl1D33z6i9gsgW5IB0KBdkJJ1Zsu7a,RXDvfPUBYFlVdlueBFbLW0mhhAyGEqpt,1,0,0,0,0,0,1,0,1,0.14285714285714285,1,0.0,0,0,0,0,0,0,0,1,0,0,1,1
2285,68776,n5lHa6MzF6UuuHLbdbmhitfwFFej0cUG,bWdj2GDclj5ofokWjzoa5jAwMkxCykd6,1,0,0,0,0,0,1,0,1,0.14285714285714285,1,0.0,0,0,0,0,0,0,0,1,0,0,1,1
2286,68785,g2zZYnTJ1Pk3cSjsVP5SH4UjJdsbDJv7,SpATywNh6bZuzm8s1ceuBUnMUAeoAHHw,14,19,7,16,4,23,4,0,73,10.428571428571429,2,0.0,9,7,14,4,10,23,2,4,0,34,39,1
2287,68794,xqGP5lHPgGUPDIL6gt03S8kze9HpOEIL,SpATywNh6bZuzm8s1ceuBUnMUAeoAHHw,4,2,1,0,1,0,1,0,5,0.7142857142857143,1,0.0,0,1,0,1,2,0,0,1,0,2,3,1
2288,68799,8uISS2OyAivNghskvH7qzmmtfHvBWiyo,SpATywNh6bZuzm8s1ceuBUnMUAeoAHHw,8,13,5,0,3,1,7,1,30,4.285714285714286,2,0.0,5,5,0,3,8,1,0,7,1,13,17,1
2289,68803,8DvAxou540FD0LKoQccPN3Xyo1nrtg8U,bWdj2GDclj5ofokWjzoa5jAwMkxCykd6,6,3,0,0,1,0,2,0,6,0.8571428571428571,2,0.0,0,0,0,1,3,0,0,2,0,1,5,1
2290,68804,3o4QanEzrLxU7IR8E0SkDLt6uwLmz5BV,G8EPVSXsOYB5YQWZGiz1aVq5Pgr2GrQu,53,79,29,82,10,0,9,0,209,29.857142857142858,4,0.0,30,29,54,10,49,0,28,9,0,123,86,1
2291,68806,J4cKirSbcBOsAeFSIp9ObJYWVvlxjPLO,SpATywNh6bZuzm8s1ceuBUnMUAeoAHHw,8,17,4,0,4,0,7,0,32,4.571428571428571,2,0.0,0,4,0,4,17,0,0,7,0,8,24,1
2292,68811,JXT9wmO8lGZMBaQQK0U8pHKQIW1oOnDo,RXDvfPUBYFlVdlueBFbLW0mhhAyGEqpt,14,10,10,0,4,0,4,0,28,4.0,1,0.0,0,10,0,4,10,0,0,4,0,14,14,1
2293,68815,jEfIANn9M5UCRbhWqJtJFlsF2uyG4fk6,A3fsA9Zfv1X2fVEQhTw51lKENdNrEqT3,4,5,1,0,0,0,3,0,9,1.2857142857142858,1,0.0,0,1,0,0,5,0,0,3,0,1,8,1
2294,68833,tn5nSlJLNdxx4Uni5Dn3S8nwDR8GJibq,SpATywNh6bZuzm8s1ceuBUnMUAeoAHHw,16,16,9,20,5,6,5,1,62,8.857142857142858,1,0.0,5,9,17,5,11,6,3,5,1,36,26,0
2295,68839,ci6w9FxXwoWvsu2Aw9ojvjfPhjaGgaxN,SpATywNh6bZuzm8s1ceuBUnMUAeoAHHw,12,20,9,11,1,21,10,0,72,10.285714285714286,1,0.0,5,9,9,1,15,21,2,10,0,24,48,1
2296,68849,l21tCwOolR7RD0CZyqRiNHHeEZC1D67K,bWdj2GDclj5ofokWjzoa5jAwMkxCykd6,4,2,1,0,1,0,1,0,5,0.7142857142857143,1,0.0,0,1,0,1,2,0,0,1,0,2,3,1
2297,68858,nrnVeosxoYxlthTbtXiJng8EyjNCisBw,SpATywNh6bZuzm8s1ceuBUnMUAeoAHHw,12,14,0,17,0,1,11,5,48,6.857142857142857,1,0.0,4,0,13,0,10,1,4,11,5,17,31,1
2298,68867,mJAgtJKHxy28GsPIeuAEUCIOXmHzCywF,A3fsA9Zfv1X2fVEQhTw51lKENdNrEqT3,17,15,11,0,7,2,10,0,45,6.428571428571429,1,0.0,0,11,0,7,15,2,0,10,0,18,27,0
2299,68876,5IM8g7YMOYo5qH7Yu3x31T3JkVOH9iqe,SpATywNh6bZuzm8s1ceuBUnMUAeoAHHw,8,7,3,0,3,0,1,0,14,2.0,1,0.0,0,3,0,3,7,0,0,1,0,6,8,0
2300,68889,jagu0OJDhWTGFhfCMk0ghqluLpW3kzdC,A3fsA9Zfv1X2fVEQhTw51lKENdNrEqT3,7,6,3,0,2,0,10,0,21,3.0,3,0.0,0,3,0,2,6,0,0,10,0,5,16,1
2301,68894,SG7N8DhpCuhIu06IIzLX0CSolbyIDsIx,SpATywNh6bZuzm8s1ceuBUnMUAeoAHHw,7,5,3,0,2,0,2,0,12,1.7142857142857142,2,0.0,0,3,0,2,5,0,0,2,0,5,7,1
2302,68986,c7CZsOAhREk5r7i8Wn5QXe6C7ebs3xYP,A3fsA9Zfv1X2fVEQhTw51lKENdNrEqT3,2,0,0,0,0,0,3,0,3,0.42857142857142855,2,0.0,0,0,0,0,0,0,0,3,0,0,3,1
2303,69014,souC6CA0wrFXemJ5RC2IcVOFZKY3Ud6D,A3fsA9Zfv1X2fVEQhTw51lKENdNrEqT3,42,71,19,40,8,4,15,1,158,22.571428571428573,1,0.0,3,19,40,8,68,4,0,15,1,70,88,0
2304,69054,CJYdZ6F1UmkUhSW1DIBQ5YjVYvVCeBEf,A3fsA9Zfv1X2fVEQhTw51lKENdNrEqT3,6,3,1,0,1,0,2,0,7,1.0,1,0.0,0,1,0,1,3,0,0,2,0,2,5,1
2305,69080,WgYQBUzSJJLcj6PwA0d8MdNri6k7nN4s,A3fsA9Zfv1X2fVEQhTw51lKENdNrEqT3,2,0,0,0,0,0,2,0,2,0.2857142857142857,1,0.0,0,0,0,0,0,0,0,2,0,0,2,1
2306,69103,ZwACmcXP1dFceMUleNJ3flkTstESRohK,SpATywNh6bZuzm8s1ceuBUnMUAeoAHHw,8,5,3,0,2,0,2,0,12,1.7142857142857142,1,0.0,0,3,0,2,5,0,0,2,0,5,7,1
2307,69115,Vd6ebRuiLfwgqB5waj4eS9hJ1uyBDxCf,A3fsA9Zfv1X2fVEQhTw51lKENdNrEqT3,10,12,1,0,0,0,5,0,18,2.5714285714285716,1,0.0,0,1,0,0,12,0,0,5,0,1,17,1
2308,69116,8RAttpsmVeGyWHWVdhomVf58WbsxdKtJ,SpATywNh6bZuzm8s1ceuBUnMUAeoAHHw,9,6,5,0,5,0,2,0,18,2.5714285714285716,3,0.0,0,5,0,5,6,0,0,2,0,10,8,1
2309,69131,8Ir6rIjO15kuvM3s5xrQH1rB1m97Mcy9,SpATywNh6bZuzm8s1ceuBUnMUAeoAHHw,15,31,0,20,1,13,12,2,79,11.285714285714286,2,0.0,14,0,18,1,17,13,2,12,2,33,46,0
2310,69147,cRQPwEYCK3Iw8dKAOD2ODiUgaKZ6yPed,SpATywNh6bZuzm8s1ceuBUnMUAeoAHHw,11,19,0,4,0,1,6,1,31,4.428571428571429,1,0.0,8,0,3,0,11,1,1,6,1,11,20,1
2311,69161,3X0JLX6UvJnnRb5GkwbFJgAokE5g69D0,SpATywNh6bZuzm8s1ceuBUnMUAeoAHHw,15,27,14,6,6,1,7,0,61,8.714285714285714,3,0.0,8,14,6,6,19,1,0,7,0,34,27,0
2312,69165,4DUZBFD9Fwl71r8i0SB6pVZCzmNoxKnn,A3fsA9Zfv1X2fVEQhTw51lKENdNrEqT3,8,11,6,0,1,1,3,0,22,3.142857142857143,2,0.0,0,6,0,1,11,1,0,3,0,7,15,1
2313,69192,agX8fi6SsMsbGjpTUuXM1FgToYG9zbAn,SpATywNh6bZuzm8s1ceuBUnMUAeoAHHw,9,14,7,0,5,4,4,0,34,4.857142857142857,4,0.0,0,7,0,5,14,4,0,4,0,12,22,0
2314,69200,udnRYxurswpE4GUZcnc80kafg0hn3fpz,A3fsA9Zfv1X2fVEQhTw51lKENdNrEqT3,3,3,1,0,0,0,2,0,6,0.8571428571428571,1,0.0,0,1,0,0,3,0,0,2,0,1,5,0
2315,69293,ovvuiEhj0QBv4xi11GVjXr8JhlCgaPmd,A3fsA9Zfv1X2fVEQhTw51lKENdNrEqT3,9,3,3,0,3,0,2,0,11,1.5714285714285714,1,0.0,0,3,0,3,3,0,0,2,0,6,5,1
2316,69297,X9IKf8GgqS6dvoKX3VBo51mIr8yb4uFC,bWdj2GDclj5ofokWjzoa5jAwMkxCykd6,10,23,6,0,8,4,4,0,45,6.428571428571429,1,0.0,8,6,0,8,15,4,0,4,0,22,23,1
2317,69308,YtPY6V9gKVYBGYaBakDnRKgXM0SCPhH8,RXDvfPUBYFlVdlueBFbLW0mhhAyGEqpt,47,38,20,63,12,2,6,0,141,20.142857142857142,3,0.0,15,20,61,12,23,2,2,6,0,108,33,0
2318,69322,WfiWheCcfnYrlo1ljQjtyFUB6mwR6CMB,SpATywNh6bZuzm8s1ceuBUnMUAeoAHHw,7,2,1,0,0,0,6,1,10,1.4285714285714286,1,0.0,0,1,0,0,2,0,0,6,1,1,9,1
2319,69337,wMBHEwMS1ke1XCIE6pdAhfvU7lKPIoig,A3fsA9Zfv1X2fVEQhTw51lKENdNrEqT3,6,5,4,0,0,0,2,0,11,1.5714285714285714,1,0.0,0,4,0,0,5,0,0,2,0,4,7,1
2320,69367,UeHaetwViLI5gC5HiwzWUg3JwpoZmRrG,A3fsA9Zfv1X2fVEQhTw51lKENdNrEqT3,1,0,0,0,0,0,1,0,1,0.14285714285714285,1,0.0,0,0,0,0,0,0,0,1,0,0,1,1
2321,69396,x87E9Qmbnh2qCEUiaevhSD7rp8sUrupo,SpATywNh6bZuzm8s1ceuBUnMUAeoAHHw,2,0,0,0,0,0,2,0,2,0.2857142857142857,1,0.0,0,0,0,0,0,0,0,2,0,0,2,1
2322,69397,egpXv13dykaiU64GCgTaQGg1ErRD7Rsb,SpATywNh6bZuzm8s1ceuBUnMUAeoAHHw,10,7,6,2,5,0,1,0,21,3.0,1,0.0,0,6,2,5,7,0,0,1,0,13,8,0
2323,69445,raxo74HBCa6UxUGfmq3EGBBeCoVCmLfg,SpATywNh6bZuzm8s1ceuBUnMUAeoAHHw,12,26,3,21,1,3,10,1,65,9.285714285714286,1,0.0,11,3,18,1,15,3,3,10,1,33,32,1
2324,69550,rY4HuopoXNauFhpb4SYxSCmQkbvhS34C,SpATywNh6bZuzm8s1ceuBUnMUAeoAHHw,17,32,12,18,6,8,6,1,83,11.857142857142858,2,0.0,18,12,15,6,14,8,3,6,1,51,32,0
2325,69552,ZAi0jAKRdwQEtga2Yygb9adNtNc26TKH,A3fsA9Zfv1X2fVEQhTw51lKENdNrEqT3,1,0,0,0,0,0,1,0,1,0.14285714285714285,1,0.0,0,0,0,0,0,0,0,1,0,0,1,1
2326,69575,HnVGC3qJM46V1b2wdd4Z0HoEFuWu57RL,A3fsA9Zfv1X2fVEQhTw51lKENdNrEqT3,1,0,0,0,0,0,1,0,1,0.14285714285714285,1,0.0,0,0,0,0,0,0,0,1,0,0,1,1
2327,69598,KYXtOFYh9POr4cq75pjZ8a127l5uxf5U,SpATywNh6bZuzm8s1ceuBUnMUAeoAHHw,2,0,0,0,0,0,2,0,2,0.2857142857142857,1,0.0,0,0,0,0,0,0,0,2,0,0,2,1
2328,69600,ebvWYER6Bde0EUcNXXIX0vyTB9ur6Kqi,A3fsA9Zfv1X2fVEQhTw51lKENdNrEqT3,6,7,0,0,0,0,2,0,9,1.2857142857142858,2,0.0,0,0,0,0,7,0,0,2,0,0,9,1
2329,69612,kgME9COu6f9ljQ8FhJeUQLVyeGDbkeLG,A3fsA9Zfv1X2fVEQhTw51lKENdNrEqT3,1,0,0,0,0,0,1,0,1,0.14285714285714285,1,0.0,0,0,0,0,0,0,0,1,0,0,1,0
2330,69634,jnvcTpUtga8frGP2ONxrK4VjvbZCmOcF,A3fsA9Zfv1X2fVEQhTw51lKENdNrEqT3,1,0,0,0,0,0,1,0,1,0.14285714285714285,1,0.0,0,0,0,0,0,0,0,1,0,0,1,1
2331,69636,xZLWfpPSNmIdAksyQxOWlrAmgCyQKxwi,A3fsA9Zfv1X2fVEQhTw51lKENdNrEqT3,3,2,0,0,0,0,2,0,4,0.5714285714285714,1,0.0,0,0,0,0,2,0,0,2,0,0,4,1
2332,69642,V5AS4ngknDMHs5ddf49SxlAoYguZsiN3,A3fsA9Zfv1X2fVEQhTw51lKENdNrEqT3,29,9,6,48,2,0,7,1,73,10.428571428571429,2,0.0,1,6,43,2,8,0,5,7,1,52,21,0
2333,69731,mQNenLPD3Qc7tSPYw2VwygE2NmpBhKsk,A3fsA9Zfv1X2fVEQhTw51lKENdNrEqT3,10,3,2,0,2,1,5,3,16,2.2857142857142856,1,0.0,0,2,0,2,3,1,0,5,3,4,12,1
2334,69778,Lcc8QujJbkTuweBtBrKCB15IfiVLUIVq,A3fsA9Zfv1X2fVEQhTw51lKENdNrEqT3,20,21,15,0,10,0,3,0,49,7.0,2,0.0,1,15,0,10,20,0,0,3,0,26,23,1
2335,69813,UOpfm9RdmrM2DaZfYaiUthWSvj5wRhpf,A3fsA9Zfv1X2fVEQhTw51lKENdNrEqT3,9,4,2,0,1,1,12,0,20,2.857142857142857,2,0.0,0,2,0,1,4,1,0,12,0,3,17,1
2336,69823,pD1s3J2DAVHqxnTOsnHBHGIq9d5lcpqD,SpATywNh6bZuzm8s1ceuBUnMUAeoAHHw,14,30,9,9,3,3,5,0,59,8.428571428571429,2,0.0,11,9,9,3,19,3,0,5,0,32,27,0
2337,69868,gV1Y6A8RpgDuAD47r6UGF54v9TD2f7uU,SpATywNh6bZuzm8s1ceuBUnMUAeoAHHw,12,14,7,18,2,0,5,0,46,6.571428571428571,1,0.0,4,7,15,2,10,0,3,5,0,28,18,0
2338,69870,JosNAk0Jss8nuybl3t8YWavpQFNL43lY,A3fsA9Zfv1X2fVEQhTw51lKENdNrEqT3,13,8,6,0,5,0,7,0,26,3.7142857142857144,2,0.0,0,6,0,5,8,0,0,7,0,11,15,1
2339,69880,wJ6pUrPXT2xprnVlaCeorPmn4kCAli3G,A3fsA9Zfv1X2fVEQhTw51lKENdNrEqT3,24,23,16,0,10,28,9,0,86,12.285714285714286,3,0.0,0,16,0,10,23,28,0,9,0,26,60,1
2340,69906,qowpjfcpUK1iU9rrtJ9U3WvarOVtt4V0,SpATywNh6bZuzm8s1ceuBUnMUAeoAHHw,16,27,16,15,7,7,7,1,80,11.428571428571429,1,0.0,4,16,12,7,23,7,3,7,1,39,41,0
2341,69916,V80I9ihOq6qwBn52j4Qxq5UKfYpTJipj,A3fsA9Zfv1X2fVEQhTw51lKENdNrEqT3,1,0,0,0,0,0,1,0,1,0.14285714285714285,1,0.0,0,0,0,0,0,0,0,1,0,0,1,1
2342,69970,dYC6Q6IXtOHRHCawBvKivQeuFVOWFZ5M,SpATywNh6bZuzm8s1ceuBUnMUAeoAHHw,11,6,5,0,5,1,4,1,22,3.142857142857143,1,0.0,0,5,0,5,6,1,0,4,1,10,12,1
2343,69972,6AqVXM3NzhPR7CIRltoRCDhzdk8YVusO,SpATywNh6bZuzm8s1ceuBUnMUAeoAHHw,17,18,8,18,3,6,12,1,66,9.428571428571429,2,0.0,7,8,15,3,11,6,3,12,1,33,33,0
2344,70011,gfov2YfhzgUzN6Vbd3DOhS3J4f6Zpsmw,SpATywNh6bZuzm8s1ceuBUnMUAeoAHHw,6,4,2,0,2,0,2,0,10,1.4285714285714286,2,0.0,0,2,0,2,4,0,0,2,0,4,6,1
2345,70021,J782awhmjhWAohIOvWifbZTNvhSxGcmf,SpATywNh6bZuzm8s1ceuBUnMUAeoAHHw,10,13,5,0,4,0,6,0,28,4.0,1,0.0,0,5,0,4,13,0,0,6,0,9,19,1
2346,70066,wKNO0Jje7WXvAVQ9yfigFflnCrR4q8AL,A3fsA9Zfv1X2fVEQhTw51lKENdNrEqT3,9,7,4,0,2,0,8,0,21,3.0,2,0.0,0,4,0,2,7,0,0,8,0,6,15,1
2347,70080,lhSfCfPZnDk6mpF0h6gOX9NA2ZuZUrvg,SpATywNh6bZuzm8s1ceuBUnMUAeoAHHw,15,36,5,19,4,1,15,3,83,11.857142857142858,2,0.0,6,5,16,4,30,1,3,15,3,31,52,0
2348,70081,S0YS2NCKuZXB21pPEkAadXWVZsUyQWb2,SpATywNh6bZuzm8s1ceuBUnMUAeoAHHw,9,13,5,0,4,0,5,0,27,3.857142857142857,2,0.0,0,5,0,4,13,0,0,5,0,9,18,1
2349,70117,Unmtjjmp5vQtsUKiq2OfCGrdrro6CfzN,SpATywNh6bZuzm8s1ceuBUnMUAeoAHHw,17,86,43,12,5,133,28,1,308,44.0,5,0.0,28,43,12,5,58,133,0,28,1,88,220,0
2350,70383,Op31ey1e8ia2T8lQ6kca7MllnthYRRtp,fbPkOYLVPtPgIt0MxizjfFJov3JbHyAi,15,14,8,8,4,11,14,4,63,9.0,2,0.0,4,8,8,4,10,11,0,14,4,24,39,1
2351,70408,rPtP72DMEyNlpUomeqVVqrg44j30SIpW,fbPkOYLVPtPgIt0MxizjfFJov3JbHyAi,9,10,7,0,3,16,7,1,44,6.285714285714286,2,0.0,0,7,0,3,10,16,0,7,1,10,34,1
2352,70483,F8PplJ0MdSBFJMkvQSa7z6RMAQvcxOkt,fbPkOYLVPtPgIt0MxizjfFJov3JbHyAi,4,7,0,0,0,1,1,0,9,1.2857142857142858,2,0.0,0,0,0,0,7,1,0,1,0,0,9,0
2353,70619,EUbYS528SLpUvydqHGhniNAZDkRxQSUM,fbPkOYLVPtPgIt0MxizjfFJov3JbHyAi,1,0,0,0,0,0,1,0,1,0.14285714285714285,1,0.0,0,0,0,0,0,0,0,1,0,0,1,1
2354,70621,w0u223fmMcj8R0XYvkRYTxBWPO2H34gs,fbPkOYLVPtPgIt0MxizjfFJov3JbHyAi,10,8,6,9,5,0,3,0,31,4.428571428571429,2,0.0,1,6,6,5,7,0,3,3,0,18,13,0
2355,70628,cDndPN0bU03X7W27vQCXFKmVpa2a5fXn,fbPkOYLVPtPgIt0MxizjfFJov3JbHyAi,6,3,2,0,0,1,4,1,11,1.5714285714285714,1,0.0,0,2,0,0,3,1,0,4,1,2,9,1
2356,70630,6BV3xjXq9ekiRfYm3O3pN6jZMMACVAnm,fbPkOYLVPtPgIt0MxizjfFJov3JbHyAi,1,0,0,0,0,0,1,0,1,0.14285714285714285,1,0.0,0,0,0,0,0,0,0,1,0,0,1,0
2357,70631,zhUkf3kMMzWlXsKEezEHBm9LsgVJDdTP,fbPkOYLVPtPgIt0MxizjfFJov3JbHyAi,5,2,1,0,1,0,10,0,14,2.0,2,0.0,0,1,0,1,2,0,0,10,0,2,12,1
2358,70633,PnTAr4JQ7W1gITYEASL2GPQdvilj2Kny,fbPkOYLVPtPgIt0MxizjfFJov3JbHyAi,3,2,0,0,0,0,1,0,3,0.42857142857142855,1,0.0,0,0,0,0,2,0,0,1,0,0,3,1
2359,70634,HU8ThwxdRuW919irq38IcjLXhEvT4bai,fbPkOYLVPtPgIt0MxizjfFJov3JbHyAi,9,9,6,0,4,1,12,0,32,4.571428571428571,2,0.0,0,6,0,4,9,1,0,12,0,10,22,1
2360,70639,NjNUHcUgwvm9xYQvil0yjwq6PWKHWHr6,fbPkOYLVPtPgIt0MxizjfFJov3JbHyAi,7,3,2,0,1,4,13,0,23,3.2857142857142856,2,0.0,0,2,0,1,3,4,0,13,0,3,20,1
2361,70640,KqGhfmSqWtSa4SJELlmAXcwsyTwdeOL4,fbPkOYLVPtPgIt0MxizjfFJov3JbHyAi,7,6,4,0,4,0,2,0,16,2.2857142857142856,1,0.0,1,4,0,4,5,0,0,2,0,9,7,1
2362,70643,cdEsk1qpGnOY8M8xILMNOVhPCtmvS3gr,fbPkOYLVPtPgIt0MxizjfFJov3JbHyAi,7,3,2,0,2,0,4,0,11,1.5714285714285714,1,0.0,0,2,0,2,3,0,0,4,0,4,7,1
2363,70645,sikVclrYgcpS3p4V6eW44EtX4b5SsNLE,fbPkOYLVPtPgIt0MxizjfFJov3JbHyAi,11,30,1,3,8,4,3,0,49,7.0,1,0.0,20,1,3,8,10,4,0,3,0,32,17,1
2364,70650,kbSUu2Z40fu4lSlgv22Wu70hAt5BnJoC,fbPkOYLVPtPgIt0MxizjfFJov3JbHyAi,20,41,0,12,6,42,11,1,113,16.142857142857142,3,0.0,21,0,10,6,20,42,2,11,1,37,76,1
2365,70654,LAVkRDyEDRYFfA0FMc6U4JnWPWsDLjhi,fbPkOYLVPtPgIt0MxizjfFJov3JbHyAi,7,12,1,0,2,0,3,0,18,2.5714285714285716,1,0.0,2,1,0,2,10,0,0,3,0,5,13,1
2366,70660,J1bBTxr7xQhu6wEykZt3Bd9gSlmRIWmq,fbPkOYLVPtPgIt0MxizjfFJov3JbHyAi,2,0,0,0,0,0,3,0,3,0.42857142857142855,1,0.0,0,0,0,0,0,0,0,3,0,0,3,1
2367,70662,u3wB3K0Js3pmFsJGQpe7V7v42hnAvDay,fbPkOYLVPtPgIt0MxizjfFJov3JbHyAi,5,2,1,0,1,0,4,0,8,1.1428571428571428,2,0.0,0,1,0,1,2,0,0,4,0,2,6,1
2368,70663,EpLshGb6fxFM19N1QN5M0uUEP2YQoz65,fbPkOYLVPtPgIt0MxizjfFJov3JbHyAi,6,6,2,0,2,0,5,0,15,2.142857142857143,1,0.0,2,2,0,2,4,0,0,5,0,6,9,1
2369,70665,jWXtvduhcSeQYRX8KBGNnUGlWXZhf8j7,fbPkOYLVPtPgIt0MxizjfFJov3JbHyAi,7,4,2,0,1,0,9,0,16,2.2857142857142856,1,0.0,0,2,0,1,4,0,0,9,0,3,13,1
2370,70667,m6MSFO9wulR4Nf5CljOSKizOwoCC2JYl,fbPkOYLVPtPgIt0MxizjfFJov3JbHyAi,21,44,19,21,14,25,6,0,129,18.428571428571427,4,0.0,20,19,15,14,24,25,6,6,0,68,61,1
2371,70668,6Bdl0MkwJ5lZUJnVsPp6IjSTHrXnqeTx,fbPkOYLVPtPgIt0MxizjfFJov3JbHyAi,2,0,0,0,0,0,9,0,9,1.2857142857142858,1,0.0,0,0,0,0,0,0,0,9,0,0,9,1
2372,70671,RMxcBkJoAGieBk6NcKXJqusraN8qxLZ7,fbPkOYLVPtPgIt0MxizjfFJov3JbHyAi,1,0,0,0,0,0,1,0,1,0.14285714285714285,1,0.0,0,0,0,0,0,0,0,1,0,0,1,1
2373,70673,RyoftXJlSPPQnlnD7mk7JNhtKBWRLRWG,fbPkOYLVPtPgIt0MxizjfFJov3JbHyAi,2,0,0,0,0,0,5,0,5,0.7142857142857143,1,0.0,0,0,0,0,0,0,0,5,0,0,5,1
2374,70679,YXIqJ6spT3Ja1ygrmNWuBLibK013t0q5,fbPkOYLVPtPgIt0MxizjfFJov3JbHyAi,1,0,0,0,0,0,1,0,1,0.14285714285714285,1,0.0,0,0,0,0,0,0,0,1,0,0,1,1
2375,70680,I2YlhnUPXZKF2nHJmVrtwRFgGB2nHSiZ,fbPkOYLVPtPgIt0MxizjfFJov3JbHyAi,9,12,3,0,3,1,8,1,28,4.0,1,0.0,6,3,0,3,6,1,0,8,1,12,16,1
2376,70681,XSTWk85DGQnV3ClLFIpSnGKTu2dEFPYv,fbPkOYLVPtPgIt0MxizjfFJov3JbHyAi,6,1,1,0,1,0,8,0,11,1.5714285714285714,1,0.0,0,1,0,1,1,0,0,8,0,2,9,1
2377,70692,6qrT2bYbFD0verDQZWOnrOjhEccqo56g,fbPkOYLVPtPgIt0MxizjfFJov3JbHyAi,27,67,22,16,25,56,16,1,203,29.0,5,0.0,38,22,15,25,29,56,1,16,1,100,103,0
2378,70935,JiFgudQA4nZtHR8rdanNuKW7boGcferp,SpATywNh6bZuzm8s1ceuBUnMUAeoAHHw,11,10,7,0,6,0,3,0,26,3.7142857142857144,1,0.0,0,7,0,6,10,0,0,3,0,13,13,1
2379,71104,zxmge3ZElgX2vkJ2cCOzkeMQCnk45k6Y,G8EPVSXsOYB5YQWZGiz1aVq5Pgr2GrQu,3,2,1,0,0,0,1,0,4,0.5714285714285714,1,0.0,0,1,0,0,2,0,0,1,0,1,3,1
2380,71277,ZzEeIm98vbP9lRunZYePLW46UyhiVxbR,bWdj2GDclj5ofokWjzoa5jAwMkxCykd6,5,6,2,0,1,0,2,0,11,1.5714285714285714,1,0.0,0,2,0,1,6,0,0,2,0,3,8,1
2381,71279,YYCI1ivPCDRa3x25VBUTnS1EqXk51k7P,A3fsA9Zfv1X2fVEQhTw51lKENdNrEqT3,42,24,18,70,11,11,7,1,142,20.285714285714285,2,0.0,2,18,60,11,22,11,10,7,1,91,51,1
2382,71280,YUT6CW7iSh1xoUpF2nfmR8w0ThlxeIYe,SpATywNh6bZuzm8s1ceuBUnMUAeoAHHw,1,0,0,0,0,0,1,0,1,0.14285714285714285,1,0.0,0,0,0,0,0,0,0,1,0,0,1,0
2383,71358,WfFzDu02yVQhznDpti9qz88KkaHNMAz5,SpATywNh6bZuzm8s1ceuBUnMUAeoAHHw,10,5,5,0,5,0,9,0,24,3.4285714285714284,2,0.0,0,5,0,5,5,0,0,9,0,10,14,1
2384,71426,onsmNYIoPFEi185f5ZLsQXD70I3K25Cb,bWdj2GDclj5ofokWjzoa5jAwMkxCykd6,6,9,1,16,1,0,2,0,29,4.142857142857143,1,0.0,5,1,15,1,4,0,1,2,0,22,7,1
2385,71611,KWdhtnEkrke9rgi3l1csNclNjZVhn1s4,SpATywNh6bZuzm8s1ceuBUnMUAeoAHHw,15,84,4,17,0,58,29,15,207,29.571428571428573,4,0.0,4,4,14,0,80,58,3,29,15,22,185,1
2386,71759,foGsrANktd6dCLnplglYgW0LYGi2yeuV,bWdj2GDclj5ofokWjzoa5jAwMkxCykd6,4,2,1,0,1,0,2,0,6,0.8571428571428571,1,0.0,0,1,0,1,2,0,0,2,0,2,4,1
2387,71829,n1JdH8HPXOUoCHQIEd4YCo0nlAshsKdG,SpATywNh6bZuzm8s1ceuBUnMUAeoAHHw,17,10,6,19,3,1,7,1,47,6.714285714285714,1,0.0,2,6,16,3,8,1,3,7,1,27,20,0
2388,71865,nvXkSuJjNwPy4x4PN83PXogIa9iXtJsm,A3fsA9Zfv1X2fVEQhTw51lKENdNrEqT3,1,0,0,0,0,0,1,0,1,0.14285714285714285,1,0.0,0,0,0,0,0,0,0,1,0,0,1,1
2389,71892,AimQk6bFhhGPpMH9HY88V7PvSxxOwe07,SpATywNh6bZuzm8s1ceuBUnMUAeoAHHw,5,2,1,0,1,0,2,0,6,0.8571428571428571,1,0.0,0,1,0,1,2,0,0,2,0,2,4,1
2390,71961,LyDM0yrwn8zKtQsuxEGqFMxdhffaZNVY,A3fsA9Zfv1X2fVEQhTw51lKENdNrEqT3,9,10,1,0,1,0,4,0,16,2.2857142857142856,1,0.0,0,1,0,1,10,0,0,4,0,2,14,1
2391,71999,Pe5WMotTf5HMq3hNpICq7pbnjQeqT1z5,SpATywNh6bZuzm8s1ceuBUnMUAeoAHHw,14,12,9,4,5,15,5,0,50,7.142857142857143,2,0.0,1,9,4,5,11,15,0,5,0,19,31,0
2392,72086,0LMHRy44jwjr4gUThAzfzfGCUeg2Lm1J,SpATywNh6bZuzm8s1ceuBUnMUAeoAHHw,17,47,26,17,9,67,16,0,182,26.0,3,0.0,11,26,14,9,36,67,3,16,0,60,122,1
2393,72120,a8HvMkBRr1QnoDxivZVIhrkeiZFWplka,A3fsA9Zfv1X2fVEQhTw51lKENdNrEqT3,11,14,9,0,7,0,4,0,34,4.857142857142857,3,0.0,0,9,0,7,14,0,0,4,0,16,18,1
2394,72128,6oNhI3z3lPtYcSpGC1lnWpyyeDMBUOtK,SpATywNh6bZuzm8s1ceuBUnMUAeoAHHw,5,2,1,0,1,0,2,0,6,0.8571428571428571,1,0.0,0,1,0,1,2,0,0,2,0,2,4,1
2395,72133,2qQuu2Qhkw7hRYngnGfnNzXYklrDkMwy,SpATywNh6bZuzm8s1ceuBUnMUAeoAHHw,14,22,3,20,1,0,6,0,52,7.428571428571429,3,0.0,5,3,17,1,17,0,3,6,0,26,26,1
2396,72150,dDLv4oouOmVB45Y4hnRyV7IUqT7tMKiq,A3fsA9Zfv1X2fVEQhTw51lKENdNrEqT3,27,21,16,0,12,1,11,2,63,9.0,2,0.0,1,16,0,12,20,1,0,11,2,29,34,0
2397,72158,kiNfuRpgeROReVuBtap1KwDDZc9hG55i,A3fsA9Zfv1X2fVEQhTw51lKENdNrEqT3,9,2,1,0,1,0,6,1,11,1.5714285714285714,1,0.0,0,1,0,1,2,0,0,6,1,2,9,1
2398,72169,Lb7wmhbhC16FSS5Xq3dqazq7PwTHyvZu,bWdj2GDclj5ofokWjzoa5jAwMkxCykd6,4,2,1,0,1,0,1,0,5,0.7142857142857143,1,0.0,0,1,0,1,2,0,0,1,0,2,3,1
2399,72222,Fdt86Xu5OLPdaOgl6M1XDpiJ3zar7SU6,RXDvfPUBYFlVdlueBFbLW0mhhAyGEqpt,22,14,10,38,7,1,5,1,76,10.857142857142858,1,0.0,3,10,30,7,11,1,8,5,1,50,26,1
2400,72255,H9uyY7qx5i6ZDOUonFHaANKxCA5aZsQi,G8EPVSXsOYB5YQWZGiz1aVq5Pgr2GrQu,24,27,2,52,3,0,7,0,91,13.0,2,0.0,12,2,42,3,15,0,10,7,0,59,32,1
2401,72303,hrPjKcL9rUfM1fnC8qta4lu2HmlsBLv6,RXDvfPUBYFlVdlueBFbLW0mhhAyGEqpt,24,28,2,24,2,0,17,0,73,10.428571428571429,2,0.0,7,2,22,2,21,0,2,17,0,33,40,0
2402,72333,uqA5Smdw6BACOcL0f2tmxwTTxZXBpZpE,bWdj2GDclj5ofokWjzoa5jAwMkxCykd6,4,2,1,0,1,0,1,0,5,0.7142857142857143,1,0.0,0,1,0,1,2,0,0,1,0,2,3,1
2403,72392,dQQ8UnfzoKHmhQlZOaaW0cB14DhE2hvY,A3fsA9Zfv1X2fVEQhTw51lKENdNrEqT3,33,32,0,58,0,3,5,0,98,14.0,2,0.0,5,0,51,0,27,3,7,5,0,56,42,0
2404,72455,tAelht5FQdpcbtZQoKgvZA90XQy6zeRb,RXDvfPUBYFlVdlueBFbLW0mhhAyGEqpt,11,12,1,0,1,1,2,4,21,3.0,1,0.0,2,1,0,1,10,1,0,2,4,4,17,1
2405,72456,IP3TW53lg1ZMqNldZdGWMD6MaLDRhhOf,SpATywNh6bZuzm8s1ceuBUnMUAeoAHHw,14,10,6,15,3,0,3,0,37,5.285714285714286,2,0.0,2,6,14,3,8,0,1,3,0,25,12,1
2406,72476,gpgk1aIkjyvlgo7OYZtMXPlVgE39gvnr,SpATywNh6bZuzm8s1ceuBUnMUAeoAHHw,12,16,11,0,7,2,7,1,44,6.285714285714286,1,0.0,1,11,0,7,15,2,0,7,1,19,25,0
2407,72533,kPw5nR6GIfIGfnUDhfrz9sq3P6l2CmOK,RXDvfPUBYFlVdlueBFbLW0mhhAyGEqpt,21,30,18,16,10,14,5,0,93,13.285714285714286,2,0.0,5,18,14,10,25,14,2,5,0,47,46,1
2408,72564,R5b7anZZznZcISIbyICZwboB1D1ac57s,SpATywNh6bZuzm8s1ceuBUnMUAeoAHHw,4,1,0,0,0,0,3,0,4,0.5714285714285714,1,0.0,0,0,0,0,1,0,0,3,0,0,4,1
2409,72621,RDShgnILA5yAnXM7kXsfq5adI49HPdeC,A3fsA9Zfv1X2fVEQhTw51lKENdNrEqT3,1,0,0,0,0,0,1,0,1,0.14285714285714285,1,0.0,0,0,0,0,0,0,0,1,0,0,1,1
2410,72649,rPY59o3LLmGBPTPMGcA5vX57KVfmywv5,A3fsA9Zfv1X2fVEQhTw51lKENdNrEqT3,1,0,0,0,0,0,1,0,1,0.14285714285714285,1,0.0,0,0,0,0,0,0,0,1,0,0,1,1
2411,72667,9FaPBbsYKn0C9myyRYf9vYNhns2eJDpD,A3fsA9Zfv1X2fVEQhTw51lKENdNrEqT3,5,4,2,0,1,0,4,0,11,1.5714285714285714,2,0.0,0,2,0,1,4,0,0,4,0,3,8,1
2412,72686,JoqAGqbao71wc04PyVzx7SVvlZZ0knbI,A3fsA9Zfv1X2fVEQhTw51lKENdNrEqT3,30,19,6,50,3,36,6,0,120,17.142857142857142,3,0.0,3,6,49,3,16,36,1,6,0,61,59,0
2413,72758,IU4mzAYv3AON3EBKGRzZhQZqrR0hM5uu,SpATywNh6bZuzm8s1ceuBUnMUAeoAHHw,13,13,7,14,5,22,4,0,65,9.285714285714286,2,0.0,3,7,13,5,10,22,1,4,0,28,37,1
2414,72780,DLQjQ8KI2pm8VfJepKRqQrT7eYq3mD8r,RXDvfPUBYFlVdlueBFbLW0mhhAyGEqpt,27,26,20,0,12,2,9,1,70,10.0,1,0.0,3,20,0,12,23,2,0,9,1,35,35,0
2415,72936,oIV4CHUFSVzLmdvea6ZMZ3tpsiIb8a2U,RXDvfPUBYFlVdlueBFbLW0mhhAyGEqpt,20,29,2,16,3,0,4,1,55,7.857142857142857,1,0.0,7,2,14,3,22,0,2,4,1,26,29,0
2416,73001,NlHO5hXiy7TmVTHiRgExH6y7p9gJG1YF,A3fsA9Zfv1X2fVEQhTw51lKENdNrEqT3,8,6,4,0,4,0,2,0,16,2.2857142857142856,1,0.0,0,4,0,4,6,0,0,2,0,8,8,1
2417,73101,AeXY5V6bNirN94d0GfQQQX1fFim1uqSr,SpATywNh6bZuzm8s1ceuBUnMUAeoAHHw,1,0,0,0,0,0,2,0,2,0.2857142857142857,2,0.0,0,0,0,0,0,0,0,2,0,0,2,0
2418,73144,rSEfJyHxNlxmmbC9ORIbqcFKKq08QDrh,bWdj2GDclj5ofokWjzoa5jAwMkxCykd6,9,11,5,0,2,11,7,0,36,5.142857142857143,2,0.0,0,5,0,2,11,11,0,7,0,7,29,0
2419,73508,YNIWjVVReCMnb4p25EmH6YanIJI1UWGe,fbPkOYLVPtPgIt0MxizjfFJov3JbHyAi,4,2,0,0,0,0,4,0,6,0.8571428571428571,1,0.0,0,0,0,0,2,0,0,4,0,0,6,1
2420,73518,mEXms676UX2nEtOWi785T3a9YDRXn6eo,fbPkOYLVPtPgIt0MxizjfFJov3JbHyAi,6,2,1,0,1,3,3,1,11,1.5714285714285714,1,0.0,0,1,0,1,2,3,0,3,1,2,9,1
2421,73546,ffYbnIyANDjzLf3ELTXl50wDF2eVsyNm,fbPkOYLVPtPgIt0MxizjfFJov3JbHyAi,2,0,0,0,0,0,2,0,2,0.2857142857142857,1,0.0,0,0,0,0,0,0,0,2,0,0,2,1
2422,73906,oXeIIZJhS8XqLTW0ryKumqV3ZtrZlFuh,7GRhBDsirIGkRZBtSMEzNTyDr2JQm4xx,34,39,10,47,10,3,11,0,120,17.142857142857142,2,0.0,16,10,40,10,23,3,7,11,0,76,44,1
2423,73908,4sCPuVlkq4rBRlBYNyTR5EDg94co1oy4,7GRhBDsirIGkRZBtSMEzNTyDr2JQm4xx,28,44,16,34,12,0,3,0,109,15.571428571428571,2,0.0,25,16,28,12,19,0,6,3,0,81,28,1
2424,73928,VBP5PzVQEKJYFH0y5ffEek5WfP9EW7uc,7GRhBDsirIGkRZBtSMEzNTyDr2JQm4xx,17,16,10,10,8,0,4,0,48,6.857142857142857,2,0.0,3,10,9,8,13,0,1,4,0,30,18,1
2425,73935,ZjAnj7LejyrDjdytaW8xiEftNjkACZgi,7GRhBDsirIGkRZBtSMEzNTyDr2JQm4xx,31,48,22,43,16,0,10,2,141,20.142857142857142,2,0.0,19,22,40,16,29,0,3,10,2,97,44,1
2426,73953,7VDn6ntyPpx1GsPLNVgZQF03WDWTuKJo,bWdj2GDclj5ofokWjzoa5jAwMkxCykd6,18,55,31,62,9,22,13,0,192,27.428571428571427,3,0.0,8,31,55,9,47,22,7,13,0,103,89,0
2427,73956,ks4Bg3QCnzBSrFPW18QfINyVAhl01iQP,7GRhBDsirIGkRZBtSMEzNTyDr2JQm4xx,1,0,0,0,0,0,1,0,1,0.14285714285714285,1,0.0,0,0,0,0,0,0,0,1,0,0,1,1
2428,73959,UNKWHkTsZ3RudPGKkhB4ao4XLNWXegZ9,7GRhBDsirIGkRZBtSMEzNTyDr2JQm4xx,25,49,2,84,7,7,8,1,158,22.571428571428573,2,0.0,31,2,72,7,18,7,12,8,1,112,46,1
2429,73967,31aB1n1dsQQ1ksrWlX8ZehnLm4yKoPC4,7GRhBDsirIGkRZBtSMEzNTyDr2JQm4xx,1,0,0,0,0,0,2,0,2,0.2857142857142857,2,0.0,0,0,0,0,0,0,0,2,0,0,2,1
2430,73968,fwlGH5gehdOA0f9hZd0xb19Diqa5Heyh,7GRhBDsirIGkRZBtSMEzNTyDr2JQm4xx,4,2,1,0,0,0,3,0,6,0.8571428571428571,1,0.0,0,1,0,0,2,0,0,3,0,1,5,1
2431,73980,4sSRGcSDSLzxYWcglxw7d9PzYXxgOT88,7GRhBDsirIGkRZBtSMEzNTyDr2JQm4xx,5,4,1,0,0,1,2,0,8,1.1428571428571428,2,0.0,0,1,0,0,4,1,0,2,0,1,7,1
2432,73985,58MUEzrczRikT4gXBjyXknuMU1aGIyQK,7GRhBDsirIGkRZBtSMEzNTyDr2JQm4xx,1,0,0,0,0,0,1,0,1,0.14285714285714285,1,0.0,0,0,0,0,0,0,0,1,0,0,1,1
2433,74021,EPmLjBxeWpwhjwoRgtmLV8RkhFOu2zzj,A3fsA9Zfv1X2fVEQhTw51lKENdNrEqT3,2,0,0,0,0,0,2,0,2,0.2857142857142857,1,0.0,0,0,0,0,0,0,0,2,0,0,2,1
2434,74035,79Eh0WdhadJNiwxQWsLXR8INp63Y21nq,7GRhBDsirIGkRZBtSMEzNTyDr2JQm4xx,9,19,5,6,3,2,7,0,42,6.0,1,0.0,7,5,5,3,12,2,1,7,0,20,22,1
2435,74062,1cBYtB7KOC3ODHrTHPWmdxuvdPQZ4YhT,SpATywNh6bZuzm8s1ceuBUnMUAeoAHHw,4,2,1,0,1,0,1,0,5,0.7142857142857143,1,0.0,0,1,0,1,2,0,0,1,0,2,3,0
2436,74067,ve7Ft3pn5zWGBanwhSnSQvIFg9ZaO7O3,7GRhBDsirIGkRZBtSMEzNTyDr2JQm4xx,1,0,0,0,0,0,1,0,1,0.14285714285714285,1,0.0,0,0,0,0,0,0,0,1,0,0,1,1
2437,74101,Uvr135kFC9KlMOM943bFXvTUT71uSm4O,G8EPVSXsOYB5YQWZGiz1aVq5Pgr2GrQu,17,19,9,8,7,2,9,1,55,7.857142857142857,1,0.0,7,9,6,7,12,2,2,9,1,29,26,0
2438,74104,7TkkuA0EEQqi6jLSaHSvDaS7U5kNSv36,SpATywNh6bZuzm8s1ceuBUnMUAeoAHHw,18,43,13,25,4,7,20,5,117,16.714285714285715,4,0.0,14,13,23,4,29,7,2,20,5,54,63,0
2439,74107,0oxo9rZM5dGgpN8rq6aFGU3IpbIKGlK0,7GRhBDsirIGkRZBtSMEzNTyDr2JQm4xx,7,6,4,0,2,0,2,0,14,2.0,1,0.0,0,4,0,2,6,0,0,2,0,6,8,1
2440,74125,FxNNtpAKePULpDZjsrs8zCvX1MSFauHF,7GRhBDsirIGkRZBtSMEzNTyDr2JQm4xx,29,32,11,45,13,1,2,0,104,14.857142857142858,1,0.0,20,11,42,13,12,1,3,2,0,86,18,1
2441,74139,gVHbwM9IOrk1olFEuw0FAfVujUgJm8AG,7GRhBDsirIGkRZBtSMEzNTyDr2JQm4xx,30,61,19,52,11,14,19,2,178,25.428571428571427,2,0.0,40,19,47,11,21,14,5,19,2,117,61,0
2442,74149,mWao7cvXlyZJViXXeBzOOV4p4AC8rvCX,7GRhBDsirIGkRZBtSMEzNTyDr2JQm4xx,35,53,19,38,20,1,18,1,150,21.428571428571427,2,0.0,33,19,32,20,20,1,6,18,1,104,46,1
2443,74167,qEQGNCv0DTznAP1gMwDRVGTAjB8ymoH3,7GRhBDsirIGkRZBtSMEzNTyDr2JQm4xx,1,0,0,0,0,0,1,0,1,0.14285714285714285,1,0.0,0,0,0,0,0,0,0,1,0,0,1,1
2444,74213,Hzo5Ctg10ZQey5IjMeCvl0CH7lPNTM5X,7GRhBDsirIGkRZBtSMEzNTyDr2JQm4xx,2,0,0,0,0,0,4,0,4,0.5714285714285714,2,0.0,0,0,0,0,0,0,0,4,0,0,4,1
2445,74244,ipQCHpy6wiUwlX5KYwBvpzBdqgm7xLba,7GRhBDsirIGkRZBtSMEzNTyDr2JQm4xx,5,2,1,0,1,0,2,0,6,0.8571428571428571,1,0.0,0,1,0,1,2,0,0,2,0,2,4,1
2446,74301,WCAIb19YcAzAlp07XtATiiwpdzMqbAbp,7GRhBDsirIGkRZBtSMEzNTyDr2JQm4xx,21,26,12,39,4,0,2,0,83,11.857142857142858,1,0.0,13,12,35,4,13,0,4,2,0,64,19,0
2447,74334,ovvuiEhj0QBv4xi11GVjXr8JhlCgaPmd,SpATywNh6bZuzm8s1ceuBUnMUAeoAHHw,13,11,6,10,5,0,6,0,38,5.428571428571429,1,0.0,2,6,9,5,9,0,1,6,0,22,16,0
2448,74408,Ra9AxcPuu5j5vTOkoJFrcEzyHUcLxhn0,7GRhBDsirIGkRZBtSMEzNTyDr2JQm4xx,6,2,1,0,1,0,4,0,8,1.1428571428571428,1,0.0,0,1,0,1,2,0,0,4,0,2,6,1
2449,74468,rgJ7j684KtaDcmKD94RFdpwPnoKFUmIV,7GRhBDsirIGkRZBtSMEzNTyDr2JQm4xx,5,8,5,0,3,0,3,0,19,2.7142857142857144,2,0.0,0,5,0,3,8,0,0,3,0,8,11,1
2450,74473,GVRJN4wkoooaXJUVmwnX983A87KsrZPK,7GRhBDsirIGkRZBtSMEzNTyDr2JQm4xx,4,2,1,0,1,0,1,0,5,0.7142857142857143,1,0.0,0,1,0,1,2,0,0,1,0,2,3,1
2451,74509,QfBD8mMClwgY0rD8w1rSnRjdXKLH7oSP,7GRhBDsirIGkRZBtSMEzNTyDr2JQm4xx,2,0,0,0,0,0,3,0,3,0.42857142857142855,1,0.0,0,0,0,0,0,0,0,3,0,0,3,1
2452,74529,YfLkHn3sP8pusiYlKK6o5F2jXKBNkL8d,SpATywNh6bZuzm8s1ceuBUnMUAeoAHHw,17,46,17,6,7,9,20,3,108,15.428571428571429,7,0.0,8,17,6,7,38,9,0,20,3,38,70,0
2453,74555,Q8RGPBI5Ez4dcsYeaCg7LkbJmto9C3oj,SpATywNh6bZuzm8s1ceuBUnMUAeoAHHw,17,29,17,23,5,15,27,4,120,17.142857142857142,3,0.0,8,17,20,5,21,15,3,27,4,50,70,0
2454,74608,U3R4m4eLMm2lirgI7HLueBKsNpxhFpn9,7GRhBDsirIGkRZBtSMEzNTyDr2JQm4xx,27,25,10,26,5,0,3,0,69,9.857142857142858,2,0.0,12,10,26,5,13,0,0,3,0,53,16,1
2455,74618,RtmYmukzSU8h3Uq6suOYxJKRcISOQfvL,RXDvfPUBYFlVdlueBFbLW0mhhAyGEqpt,37,20,12,94,4,1,6,0,137,19.571428571428573,2,0.0,7,12,90,4,13,1,4,6,0,113,24,0
2456,74653,HL0jm7zWkHTTtUFklIJxsfljBDgcIEre,SpATywNh6bZuzm8s1ceuBUnMUAeoAHHw,12,31,3,14,1,5,6,0,60,8.571428571428571,3,0.0,8,3,13,1,23,5,1,6,0,25,35,1
2457,74669,QYUKXD6RJtSdizcdlNjQSBFOXbEQl1FA,SpATywNh6bZuzm8s1ceuBUnMUAeoAHHw,6,2,0,0,0,8,5,0,15,2.142857142857143,1,0.0,0,0,0,0,2,8,0,5,0,0,15,1
2458,74703,vSL0kRsKOWBMpC6pqEAxri0eLNug5E20,RXDvfPUBYFlVdlueBFbLW0mhhAyGEqpt,39,58,5,65,2,9,11,0,150,21.428571428571427,4,0.0,12,5,63,2,46,9,2,11,0,82,68,0
2459,74717,tBy7E7qZZZ98Oih5sTNUdDZRIpZZM98z,SpATywNh6bZuzm8s1ceuBUnMUAeoAHHw,9,28,7,12,0,0,4,0,51,7.285714285714286,2,0.0,17,7,9,0,11,0,3,4,0,33,18,0
2460,74736,sgWvC8NRvYtrmKjALzTvn9SNvnbzDMjJ,SpATywNh6bZuzm8s1ceuBUnMUAeoAHHw,6,5,3,0,1,0,2,0,11,1.5714285714285714,1,0.0,0,3,0,1,5,0,0,2,0,4,7,1
2461,74755,MLEFHCMFllWu55FD5Lk76TFNbtPRpP0W,7GRhBDsirIGkRZBtSMEzNTyDr2JQm4xx,21,27,2,16,1,0,12,2,60,8.571428571428571,1,0.0,8,2,13,1,19,0,3,12,2,24,36,0
2462,74792,DSoedfH3iEqkDSoEfnR9hPK9fGA03nvE,A3fsA9Zfv1X2fVEQhTw51lKENdNrEqT3,42,16,13,76,10,0,4,0,119,17.0,1,0.0,1,13,62,10,15,0,14,4,0,86,33,1
2463,74809,0UD2r7gmc85Ip6GdTUss7ocdGASnZDTz,7GRhBDsirIGkRZBtSMEzNTyDr2JQm4xx,14,15,8,8,6,0,7,0,44,6.285714285714286,2,0.0,2,8,6,6,13,0,2,7,0,22,22,1
2464,74818,knxAJpSFDgjN8jBmnCV7BB7s4fbgoTt1,7GRhBDsirIGkRZBtSMEzNTyDr2JQm4xx,7,3,2,4,0,1,4,0,14,2.0,1,0.0,1,2,3,0,2,1,1,4,0,6,8,1
2465,74841,lFMbkCaY0FKfyGbh1VOL30jTZ1USVgB2,RXDvfPUBYFlVdlueBFbLW0mhhAyGEqpt,20,19,10,16,10,0,2,0,57,8.142857142857142,2,0.0,8,10,16,10,11,0,0,2,0,44,13,0
2466,74881,user4NErzgNZOQPby0IMjoZc4clvyOrp,7GRhBDsirIGkRZBtSMEzNTyDr2JQm4xx,6,4,2,0,1,0,2,0,9,1.2857142857142858,1,0.0,1,2,0,1,3,0,0,2,0,4,5,1
2467,74882,uFxbwM61ZWFC5xnxVOlmiGXCTyHmK3HX,RXDvfPUBYFlVdlueBFbLW0mhhAyGEqpt,8,8,5,0,2,2,7,3,27,3.857142857142857,1,0.0,0,5,0,2,8,2,0,7,3,7,20,1
2468,74915,1f1vpzICnoH8kVwL3WpPvvH9Fnzvagoq,7GRhBDsirIGkRZBtSMEzNTyDr2JQm4xx,5,3,1,0,0,0,3,0,7,1.0,1,0.0,0,1,0,0,3,0,0,3,0,1,6,1
2469,75011,CDVTgNquYdsNoldLURSKppemY0oOGcjg,SpATywNh6bZuzm8s1ceuBUnMUAeoAHHw,14,24,1,9,1,3,6,2,46,6.571428571428571,1,0.0,7,1,9,1,17,3,0,6,2,18,28,0
2470,75054,dtbXtMjPqeEvzoZBFe2y9uSDcjL0lnx2,RXDvfPUBYFlVdlueBFbLW0mhhAyGEqpt,24,63,14,0,8,30,9,0,124,17.714285714285715,3,0.0,13,14,0,8,50,30,0,9,0,35,89,0
2471,75113,5EOGhyHOLLtbW0eEa8Dnfl5My4kdYkdc,SpATywNh6bZuzm8s1ceuBUnMUAeoAHHw,14,18,10,6,6,0,4,0,44,6.285714285714286,3,0.0,6,10,6,6,12,0,0,4,0,28,16,0
2472,75195,9zNI4EpVujSV8TU9o7NY46vrkl8qX3Ys,G8EPVSXsOYB5YQWZGiz1aVq5Pgr2GrQu,8,6,1,0,2,0,3,0,12,1.7142857142857142,1,0.0,2,1,0,2,4,0,0,3,0,5,7,0
2473,75206,ZXWRS3Ah3Q3TKxtUJXxAAlsPTxzCg1Vz,SpATywNh6bZuzm8s1ceuBUnMUAeoAHHw,5,3,2,0,1,2,1,0,9,1.2857142857142858,1,0.0,0,2,0,1,3,2,0,1,0,3,6,0
2474,75350,mFNGHC6aCmhHmhRXFCDO0uvnGnNYaro0,7GRhBDsirIGkRZBtSMEzNTyDr2JQm4xx,4,2,1,0,1,0,1,0,5,0.7142857142857143,1,0.0,0,1,0,1,2,0,0,1,0,2,3,1
2475,75440,0wpIasMdCfOA3dQLJWO9ecakBEpIFnbg,7GRhBDsirIGkRZBtSMEzNTyDr2JQm4xx,38,70,33,53,14,29,13,0,212,30.285714285714285,3,0.0,33,33,45,14,37,29,8,13,0,125,87,1
2476,75486,l7cIWSn2QdqLoOKMFO8yNQGKfk999nJh,7GRhBDsirIGkRZBtSMEzNTyDr2JQm4xx,13,18,7,0,3,3,8,1,40,5.714285714285714,2,0.0,8,7,0,3,10,3,0,8,1,18,22,0
2477,75557,514TWhkGGUhLu2MdvTnb8eiBH3DCFHzg,SpATywNh6bZuzm8s1ceuBUnMUAeoAHHw,15,19,3,13,0,3,12,1,51,7.285714285714286,2,0.0,6,3,11,0,13,3,2,12,1,20,31,0
2478,75565,A8uNxAeXRi6PUyfK3nbO106vNrsfyDAv,SpATywNh6bZuzm8s1ceuBUnMUAeoAHHw,17,19,10,16,4,12,13,0,74,10.571428571428571,3,0.0,7,10,15,4,12,12,1,13,0,36,38,0
2479,75599,yBKc8UQ3yoU6nYnfaJz62fH80CgKFtOX,SpATywNh6bZuzm8s1ceuBUnMUAeoAHHw,17,23,10,24,5,0,11,1,74,10.571428571428571,2,0.0,8,10,20,5,15,0,4,11,1,43,31,0
2480,75724,39HyRvZGGM2Q03BAuIzlN9IBewYhVnfo,7GRhBDsirIGkRZBtSMEzNTyDr2JQm4xx,9,8,2,2,4,0,5,0,21,3.0,1,0.0,6,2,2,4,2,0,0,5,0,14,7,0
2481,75741,3x63reHnPUEpxvneROppT18TTVHKvgH3,bWdj2GDclj5ofokWjzoa5jAwMkxCykd6,8,9,2,22,3,0,1,0,37,5.285714285714286,1,0.0,3,2,20,3,6,0,2,1,0,28,9,1
2482,75759,8wgkhDh9t3XtyzQtRpizifGx20DUK4F9,7GRhBDsirIGkRZBtSMEzNTyDr2JQm4xx,2,0,0,0,0,0,2,0,2,0.2857142857142857,1,0.0,0,0,0,0,0,0,0,2,0,0,2,1
2483,75770,FGD2s7sTUqsP3QU1o8nPIzNgmxXe4CYW,7GRhBDsirIGkRZBtSMEzNTyDr2JQm4xx,25,53,23,12,13,3,19,0,123,17.571428571428573,2,0.0,22,23,9,13,31,3,3,19,0,67,56,1
2484,75792,dhPF0MOUpHT5OZTFAONgRdkH1ZwnZtFz,SpATywNh6bZuzm8s1ceuBUnMUAeoAHHw,7,4,3,0,3,0,2,0,12,1.7142857142857142,1,0.0,0,3,0,3,4,0,0,2,0,6,6,0
2485,75890,Y89GJdSZUpoYFMgx00SCe6qFoYoXIpUj,7GRhBDsirIGkRZBtSMEzNTyDr2JQm4xx,1,0,0,0,0,0,1,0,1,0.14285714285714285,1,0.0,0,0,0,0,0,0,0,1,0,0,1,1
2486,75964,kiVzCvDoEqSB7iO0TU3ERoanC9pEAYCs,7GRhBDsirIGkRZBtSMEzNTyDr2JQm4xx,4,2,1,0,1,0,2,0,6,0.8571428571428571,1,0.0,0,1,0,1,2,0,0,2,0,2,4,1
2487,75969,8Dno8ERd119JayTOKlG7uDmGtkfLJOke,SpATywNh6bZuzm8s1ceuBUnMUAeoAHHw,6,3,2,0,2,0,1,0,8,1.1428571428571428,1,0.0,0,2,0,2,3,0,0,1,0,4,4,0
2488,75992,YvdTgocCzBmHhfLuAH349Li5za8uToFU,7GRhBDsirIGkRZBtSMEzNTyDr2JQm4xx,9,5,0,0,0,2,5,1,13,1.8571428571428572,1,0.0,0,0,0,0,5,2,0,5,1,0,13,1
2489,76038,6RuWsSvS3Ngnjl37PzNAaaGn8Jd9a1lW,bWdj2GDclj5ofokWjzoa5jAwMkxCykd6,10,51,5,0,5,1,19,0,81,11.571428571428571,4,0.0,2,5,0,5,49,1,0,19,0,12,69,0
2490,76070,4rBJgH2pAgasw5ZtgiBnBNfRcNJLZp5J,7GRhBDsirIGkRZBtSMEzNTyDr2JQm4xx,9,2,1,0,1,4,7,1,16,2.2857142857142856,1,0.0,0,1,0,1,2,4,0,7,1,2,14,1
2491,76119,FXen1VSms29mqypmBsJLgiCW5lwzRuUO,7GRhBDsirIGkRZBtSMEzNTyDr2JQm4xx,6,3,2,0,0,5,4,0,14,2.0,1,0.0,0,2,0,0,3,5,0,4,0,2,12,1
2492,76193,yhuEFjYPx53KuMNRSkVNQIkCv2xuEbeq,7GRhBDsirIGkRZBtSMEzNTyDr2JQm4xx,1,0,0,0,0,0,2,0,2,0.2857142857142857,1,0.0,0,0,0,0,0,0,0,2,0,0,2,1
2493,76245,FYdTGqTHtRATfo802agJiucYRW9Mfn1L,7GRhBDsirIGkRZBtSMEzNTyDr2JQm4xx,1,0,0,0,0,0,1,0,1,0.14285714285714285,1,0.0,0,0,0,0,0,0,0,1,0,0,1,1
2494,76261,wzJUcvl4LpGNAis186Xl9ztjI1WNWkac,bWdj2GDclj5ofokWjzoa5jAwMkxCykd6,6,5,0,0,1,0,9,0,15,2.142857142857143,1,0.0,3,0,0,1,2,0,0,9,0,4,11,1
2495,77126,qg6GOCuPcDwehPMMAEed7GZuAdyiaV9B,7GRhBDsirIGkRZBtSMEzNTyDr2JQm4xx,28,69,0,70,3,61,16,1,220,31.428571428571427,6,0.0,39,0,59,3,30,61,11,16,1,101,119,1
2496,77181,SFygdEesOWeEamKu8iZBsgHneiDiai0R,fbPkOYLVPtPgIt0MxizjfFJov3JbHyAi,3,2,0,0,0,0,1,0,3,0.42857142857142855,1,0.0,0,0,0,0,2,0,0,1,0,0,3,1
2497,77184,wf4sRCFbvakokDkU4vw1lmU1y8DrYHz0,fbPkOYLVPtPgIt0MxizjfFJov3JbHyAi,13,28,9,15,8,14,7,0,81,11.571428571428571,1,0.0,10,9,12,8,18,14,3,7,0,39,42,1
2498,77185,QQjzUMnFih1Op25f6SGBPhOGRMF8l0bA,fbPkOYLVPtPgIt0MxizjfFJov3JbHyAi,7,13,6,0,2,6,4,0,31,4.428571428571429,2,0.0,0,6,0,2,13,6,0,4,0,8,23,1
2499,77187,JGkH5G6iVBgcA8nzn9agd5N20Wo6tva5,fbPkOYLVPtPgIt0MxizjfFJov3JbHyAi,5,2,1,0,1,0,2,0,6,0.8571428571428571,1,0.0,0,1,0,1,2,0,0,2,0,2,4,1
2500,77197,4UvxElQD05jrzT8uj3rOHyCF67vFPUKP,fbPkOYLVPtPgIt0MxizjfFJov3JbHyAi,8,12,9,0,6,2,3,0,32,4.571428571428571,3,0.0,0,9,0,6,12,2,0,3,0,15,17,1
2501,77198,nctrJ6DXEbLac5Q8LCtyQd0IItjuRIih,fbPkOYLVPtPgIt0MxizjfFJov3JbHyAi,7,2,1,0,1,0,7,1,12,1.7142857142857142,1,0.0,0,1,0,1,2,0,0,7,1,2,10,1
2502,77302,KRi80h1uK84snC5HvtQKWlsjwt9i3oa5,fbPkOYLVPtPgIt0MxizjfFJov3JbHyAi,7,3,2,0,2,0,2,0,9,1.2857142857142858,1,0.0,0,2,0,2,3,0,0,2,0,4,5,1
2503,77850,embp7e5rTedl4SQPXvv0NKkthNGlazF4,SpATywNh6bZuzm8s1ceuBUnMUAeoAHHw,15,18,7,24,3,8,3,1,64,9.142857142857142,1,0.0,8,7,18,3,10,8,6,3,1,36,28,0
2504,77861,j6kVkVGKYZT7ozL2NE5rOIexD3a1ewYn,SpATywNh6bZuzm8s1ceuBUnMUAeoAHHw,17,29,12,11,3,64,12,3,134,19.142857142857142,5,0.0,9,12,11,3,20,64,0,12,3,35,99,1
2505,77902,k6QLpQDqSxoScgN883dLN4OsoeXNCHXO,A3fsA9Zfv1X2fVEQhTw51lKENdNrEqT3,20,13,11,0,9,0,3,0,36,5.142857142857143,2,0.0,0,11,0,9,13,0,0,3,0,20,16,1
2506,77930,I0nVBKgpf6bHOhRUWavCqORVydlrPxcM,SpATywNh6bZuzm8s1ceuBUnMUAeoAHHw,16,33,14,29,3,30,16,0,125,17.857142857142858,2,0.0,12,14,22,3,21,30,7,16,0,51,74,1
2507,78064,SfR30NvxnwHQ5GQOQOoN6OMoANxaB8dS,SpATywNh6bZuzm8s1ceuBUnMUAeoAHHw,13,16,8,18,3,0,4,0,49,7.0,2,0.0,5,8,15,3,11,0,3,4,0,31,18,0
2508,78106,hu8eak1Xmf8voE8pnxPzkSD2dZP9Sipf,bWdj2GDclj5ofokWjzoa5jAwMkxCykd6,8,9,0,20,0,4,7,0,40,5.714285714285714,2,0.0,2,0,18,0,7,4,2,7,0,20,20,0
2509,78134,CNb0Sul2DOkX3VhMOeM6DWqvlrGgHagf,SpATywNh6bZuzm8s1ceuBUnMUAeoAHHw,17,19,8,23,5,1,7,1,64,9.142857142857142,2,0.0,6,8,20,5,13,1,3,7,1,39,25,1
2510,78144,GcwFf1WfRMSdZDYsPn5itkdYlvMUCmT9,SpATywNh6bZuzm8s1ceuBUnMUAeoAHHw,16,23,7,13,3,1,8,2,57,8.142857142857142,3,0.0,3,7,12,3,20,1,1,8,2,25,32,0
2511,78188,CNb0Sul2DOkX3VhMOeM6DWqvlrGgHagf,bWdj2GDclj5ofokWjzoa5jAwMkxCykd6,2,0,0,0,0,0,2,0,2,0.2857142857142857,1,0.0,0,0,0,0,0,0,0,2,0,0,2,1
2512,78247,BLoa1RvSOgexbSH4hGzCihmBc8pXd0Db,A3fsA9Zfv1X2fVEQhTw51lKENdNrEqT3,29,23,11,14,9,6,11,5,79,11.285714285714286,1,0.0,0,11,12,9,23,6,2,11,5,32,47,1
2513,78356,l8Cml1vejHI8GVsgohdNxJJsxeTOpjUQ,SpATywNh6bZuzm8s1ceuBUnMUAeoAHHw,14,11,7,5,5,1,5,1,35,5.0,1,0.0,3,7,4,5,8,1,1,5,1,19,16,1
2514,78462,4N9xQarXAZMYyOjOJvMQmOHnVfoe0iL0,A3fsA9Zfv1X2fVEQhTw51lKENdNrEqT3,1,0,0,0,0,0,2,0,2,0.2857142857142857,1,0.0,0,0,0,0,0,0,0,2,0,0,2,1
2515,78478,CVkN7W2203PPB4rzsX0i8SBpQ0bSRkaq,SpATywNh6bZuzm8s1ceuBUnMUAeoAHHw,2,0,0,0,0,0,3,0,3,0.42857142857142855,1,0.0,0,0,0,0,0,0,0,3,0,0,3,1
2516,78546,Ckb71Ev9RlsIUvVDfkFS0AumQJilppvB,G8EPVSXsOYB5YQWZGiz1aVq5Pgr2GrQu,5,2,1,0,1,0,2,0,6,0.8571428571428571,1,0.0,0,1,0,1,2,0,0,2,0,2,4,1
2517,78603,7u0QfTKQg4itZK9m8foLXkIGwUxxHMsT,SpATywNh6bZuzm8s1ceuBUnMUAeoAHHw,15,11,5,6,4,0,4,0,30,4.285714285714286,1,0.0,5,5,6,4,6,0,0,4,0,20,10,0
2518,78648,fjIKsKO6rizBomnPFn2db56S1nui3RlN,A3fsA9Zfv1X2fVEQhTw51lKENdNrEqT3,27,19,15,12,10,8,6,1,71,10.142857142857142,1,0.0,2,15,9,10,17,8,3,6,1,36,35,1
2519,78715,5Zgwu2mRcsc21AmNDehMpm5vDwlgKfhs,SpATywNh6bZuzm8s1ceuBUnMUAeoAHHw,17,17,7,19,4,1,10,2,60,8.571428571428571,1,0.0,8,7,18,4,9,1,1,10,2,37,23,1
2520,78848,oZKhsAromYlsN9MhR64yAv55dJDSDM8L,G8EPVSXsOYB5YQWZGiz1aVq5Pgr2GrQu,14,12,4,10,3,0,7,1,37,5.285714285714286,2,0.0,6,4,7,3,6,0,3,7,1,20,17,1
2521,78910,R6RINUtJNooptLfHmBRIBRqFOknkjv0Y,A3fsA9Zfv1X2fVEQhTw51lKENdNrEqT3,12,34,15,0,13,5,23,0,90,12.857142857142858,4,0.0,0,15,0,13,34,5,0,23,0,28,62,1
2522,78953,AZZvRPcRkLSa6vwofzfwsEULTUhiKy0E,SpATywNh6bZuzm8s1ceuBUnMUAeoAHHw,18,68,27,18,8,83,44,3,251,35.857142857142854,6,0.0,20,27,15,8,48,83,3,44,3,70,181,0
2523,78971,d1mccaMvv72HL0M2QdKzu9aosPAbZ4Jm,SpATywNh6bZuzm8s1ceuBUnMUAeoAHHw,13,11,4,6,3,7,2,1,34,4.857142857142857,1,0.0,3,4,6,3,8,7,0,2,1,16,18,0
2524,79085,jByBG50ghoSer5UP92qpkAfDGFpraaH7,RXDvfPUBYFlVdlueBFbLW0mhhAyGEqpt,1,0,0,0,0,0,1,0,1,0.14285714285714285,1,0.0,0,0,0,0,0,0,0,1,0,0,1,1
2525,79114,oBHfkEBZPsjUqPWXyw1yW9Gipn9KMPDQ,SpATywNh6bZuzm8s1ceuBUnMUAeoAHHw,8,14,6,0,3,0,4,0,27,3.857142857142857,2,0.0,0,6,0,3,14,0,0,4,0,9,18,1
2526,79116,oeEXBADlWmjYmDN9P4tzDfKaayj6OdaD,G8EPVSXsOYB5YQWZGiz1aVq5Pgr2GrQu,29,47,17,62,6,3,7,3,145,20.714285714285715,1,0.0,28,17,40,6,19,3,22,7,3,91,54,1
2527,79164,wGfXRYqHkdAo1fVEEY9NvW8qy6M9m0mI,A3fsA9Zfv1X2fVEQhTw51lKENdNrEqT3,44,37,18,62,10,8,10,5,150,21.428571428571427,3,0.0,2,18,59,10,35,8,3,10,5,89,61,1
2528,79265,V1B34PKYcESnicIbQVUA4gpuU2uOqNWz,bWdj2GDclj5ofokWjzoa5jAwMkxCykd6,8,17,6,0,3,0,6,0,32,4.571428571428571,1,0.0,5,6,0,3,12,0,0,6,0,14,18,1
2529,79268,V1B34PKYcESnicIbQVUA4gpuU2uOqNWz,SpATywNh6bZuzm8s1ceuBUnMUAeoAHHw,9,11,10,0,5,3,7,1,37,5.285714285714286,1,0.0,0,10,0,5,11,3,0,7,1,15,22,1
2530,79322,b9hN1tjIpM67gB8PuwPQ3u561lqo1V2f,RXDvfPUBYFlVdlueBFbLW0mhhAyGEqpt,12,10,8,0,5,0,11,3,37,5.285714285714286,2,0.0,0,8,0,5,10,0,0,11,3,13,24,0
2531,79391,Q3913BpDariYbEj8ZlFy9MQJV1rZlZAJ,SpATywNh6bZuzm8s1ceuBUnMUAeoAHHw,3,2,0,0,0,0,1,0,3,0.42857142857142855,1,0.0,0,0,0,0,2,0,0,1,0,0,3,1
2532,79439,crl3o7sxyMWLnKWiaz3BBw0rhIdF3cXr,bWdj2GDclj5ofokWjzoa5jAwMkxCykd6,10,11,0,20,1,8,6,1,47,6.714285714285714,1,0.0,6,0,20,1,5,8,0,6,1,27,20,1
2533,79449,qwFDXKt0M8f2bQWHQ9IwMnRpFGf93NNf,SpATywNh6bZuzm8s1ceuBUnMUAeoAHHw,16,16,10,23,4,1,10,1,65,9.285714285714286,4,0.0,2,10,18,4,14,1,5,10,1,34,31,1
2534,79450,IKVKcza5vT9JehCbhoro1CRnVpL575lj,SpATywNh6bZuzm8s1ceuBUnMUAeoAHHw,15,9,5,3,3,0,4,0,24,3.4285714285714284,1,0.0,3,5,3,3,6,0,0,4,0,14,10,1
2535,79483,i39wrwOFUT4cBFVx9tMMQ3lQ2qJwZK9W,A3fsA9Zfv1X2fVEQhTw51lKENdNrEqT3,18,15,7,0,6,4,5,2,39,5.571428571428571,1,0.0,0,7,0,6,15,4,0,5,2,13,26,1
2536,79519,NUQJxbePNRtXQQBXCQFchv4ww5sWUrml,SpATywNh6bZuzm8s1ceuBUnMUAeoAHHw,14,13,0,2,1,2,12,1,31,4.428571428571429,2,0.0,0,0,2,1,13,2,0,12,1,3,28,0
2537,79548,xt59FC0u82DgUh4CRpEaJwaXZlH1aLO1,SpATywNh6bZuzm8s1ceuBUnMUAeoAHHw,9,11,7,0,5,0,8,0,31,4.428571428571429,2,0.0,1,7,0,5,10,0,0,8,0,13,18,0
2538,79668,7nUtazUwwSnnXJpIKdQBJGpXV6Po42DQ,bWdj2GDclj5ofokWjzoa5jAwMkxCykd6,19,25,2,127,4,0,15,0,173,24.714285714285715,2,0.0,6,2,121,4,19,0,6,15,0,133,40,1
2539,79735,e9EeV5SqA2AUMzzKRuYh9383pOYfTL5t,A3fsA9Zfv1X2fVEQhTw51lKENdNrEqT3,7,7,0,0,0,0,3,0,10,1.4285714285714286,1,0.0,0,0,0,0,7,0,0,3,0,0,10,1
2540,79761,ffg9VbmMkFKj2DfO61ClA5PDHr5Xa6gN,SpATywNh6bZuzm8s1ceuBUnMUAeoAHHw,11,20,14,2,7,0,5,0,48,6.857142857142857,3,0.0,0,14,2,7,20,0,0,5,0,23,25,0
2541,79801,Tdve80vJG7bg0NAfZoErDkCePh9ZdZtG,SpATywNh6bZuzm8s1ceuBUnMUAeoAHHw,9,8,5,0,3,0,4,1,21,3.0,1,0.0,1,5,0,3,7,0,0,4,1,9,12,1
2542,79809,5tD3trtPQ6jzqFRimP1PMPhgvFtRmfA4,SpATywNh6bZuzm8s1ceuBUnMUAeoAHHw,15,27,6,9,1,3,11,0,57,8.142857142857142,2,0.0,7,6,9,1,20,3,0,11,0,23,34,1
2543,79818,dCAqk9uHiS99GMTcJQtThG8XWnwwbp5Q,SpATywNh6bZuzm8s1ceuBUnMUAeoAHHw,12,26,1,19,0,2,4,0,52,7.428571428571429,2,0.0,11,1,16,0,15,2,3,4,0,28,24,1
2544,79822,WUz9eKwwTabZi4dE6GkJ03kYfBXiol2h,A3fsA9Zfv1X2fVEQhTw51lKENdNrEqT3,1,0,0,0,0,0,2,0,2,0.2857142857142857,1,0.0,0,0,0,0,0,0,0,2,0,0,2,1
2545,79831,7kTdvih7UMOiFKC9aXRp88JppGP4qSKH,SpATywNh6bZuzm8s1ceuBUnMUAeoAHHw,7,3,2,0,2,0,2,0,9,1.2857142857142858,1,0.0,0,2,0,2,3,0,0,2,0,4,5,1
2546,79878,ccvSRrE3qWZJWxhZblz5YcekpwGotPgS,SpATywNh6bZuzm8s1ceuBUnMUAeoAHHw,14,14,3,1,2,1,13,0,34,4.857142857142857,2,0.0,2,3,1,2,12,1,0,13,0,8,26,1
2547,79998,q3XMARasETEzJyvJUxEAfFYsH6Z5s8Zv,bWdj2GDclj5ofokWjzoa5jAwMkxCykd6,8,11,4,0,1,6,10,0,32,4.571428571428571,3,0.0,0,4,0,1,11,6,0,10,0,5,27,0
2548,80019,YOBshYgk5gyR7XdL7ay26cecY2tdQtWp,SpATywNh6bZuzm8s1ceuBUnMUAeoAHHw,6,10,5,0,0,0,5,0,20,2.857142857142857,1,0.0,1,5,0,0,9,0,0,5,0,6,14,0
2549,80040,4AJWWnsd8QGDSRF4HLmdDQcz8kiBAcGz,SpATywNh6bZuzm8s1ceuBUnMUAeoAHHw,8,12,8,0,4,0,5,0,29,4.142857142857143,1,0.0,1,8,0,4,11,0,0,5,0,13,16,1
2550,80163,qepVwgjKQRsdgtfeDxtXZatdyxHVESv4,SpATywNh6bZuzm8s1ceuBUnMUAeoAHHw,5,4,0,0,0,0,2,0,6,0.8571428571428571,1,0.0,0,0,0,0,4,0,0,2,0,0,6,1
2551,80393,S8OVDYMWVqlXct5SL79m7HIG5CpKKYZc,SpATywNh6bZuzm8s1ceuBUnMUAeoAHHw,10,8,6,0,4,0,2,0,20,2.857142857142857,1,0.0,0,6,0,4,8,0,0,2,0,10,10,0
2552,80411,GC4OF9yGz21AkcWehLa95SfLGyYuVKMP,SpATywNh6bZuzm8s1ceuBUnMUAeoAHHw,12,23,9,19,0,29,14,3,97,13.857142857142858,4,0.0,7,9,16,0,16,29,3,14,3,32,65,0
2553,80471,AZ8hE11Dcjz74P3tHeZJFdS8MoworAxL,G8EPVSXsOYB5YQWZGiz1aVq5Pgr2GrQu,10,15,0,0,0,5,9,0,29,4.142857142857143,1,0.0,2,0,0,0,13,5,0,9,0,2,27,0
2554,80472,2tSCGGcBbyusCnHqpGiQkgQi3re0uZxB,G8EPVSXsOYB5YQWZGiz1aVq5Pgr2GrQu,24,35,20,37,14,1,10,1,118,16.857142857142858,4,0.0,0,20,30,14,35,1,7,10,1,64,54,1
2555,80514,DdUTtw4QPNiBxHI38HgtVDIMn8onRmHc,A3fsA9Zfv1X2fVEQhTw51lKENdNrEqT3,9,7,4,0,3,0,2,0,16,2.2857142857142856,1,0.0,0,4,0,3,7,0,0,2,0,7,9,0
2556,80593,z9sj5HIJml1DMOMfRKKBQ7IvS2IoE424,A3fsA9Zfv1X2fVEQhTw51lKENdNrEqT3,1,0,0,0,0,0,2,0,2,0.2857142857142857,1,0.0,0,0,0,0,0,0,0,2,0,0,2,1
2557,80606,2cQfWhwRUGUv48S47s2aDWYzSM5LRy6r,RXDvfPUBYFlVdlueBFbLW0mhhAyGEqpt,15,13,0,0,0,0,5,0,18,2.5714285714285716,1,0.0,0,0,0,0,13,0,0,5,0,0,18,1
2558,80718,a5enjFKHyOqV9BlzZwj7DoNQQjSWFxve,SpATywNh6bZuzm8s1ceuBUnMUAeoAHHw,5,5,2,0,1,0,1,0,9,1.2857142857142858,1,0.0,2,2,0,1,3,0,0,1,0,5,4,1
2559,80725,eVZffGeL4uoEevrNNMdcmW6f0YwT8plW,bWdj2GDclj5ofokWjzoa5jAwMkxCykd6,4,2,1,0,1,0,2,0,6,0.8571428571428571,2,0.0,0,1,0,1,2,0,0,2,0,2,4,1
2560,80748,H6iwP0B7nHcYZaQbDpLJEx2H7FXYxL7S,RXDvfPUBYFlVdlueBFbLW0mhhAyGEqpt,19,19,6,32,2,0,4,2,65,9.285714285714286,2,0.0,4,6,28,2,15,0,4,4,2,40,25,0
2561,80800,a98Mt6r9LLCkAEPo2R3JVMN20OhIPoaG,SpATywNh6bZuzm8s1ceuBUnMUAeoAHHw,12,6,4,0,4,1,5,1,21,3.0,2,0.0,0,4,0,4,6,1,0,5,1,8,13,1
2562,80875,zgLhc8F17sS6o8GPDEBAA43SRssMOYHD,fbPkOYLVPtPgIt0MxizjfFJov3JbHyAi,8,5,2,0,1,1,5,1,15,2.142857142857143,1,0.0,0,2,0,1,5,1,0,5,1,3,12,1
2563,80891,1IMOvf9v1bRH0tUTRkiIkzGe833lnAgf,fbPkOYLVPtPgIt0MxizjfFJov3JbHyAi,2,0,0,0,0,0,2,0,2,0.2857142857142857,1,0.0,0,0,0,0,0,0,0,2,0,0,2,0
2564,80892,OqzJYk2L0XqYLfMs4LljNI8HpBsCF1TU,fbPkOYLVPtPgIt0MxizjfFJov3JbHyAi,23,25,13,13,10,10,6,1,78,11.142857142857142,4,0.0,6,13,11,10,19,10,2,6,1,40,38,1
2565,80896,F7beo1Qs8FACPdfc8t0SncgEfDkdNWKi,fbPkOYLVPtPgIt0MxizjfFJov3JbHyAi,8,9,4,0,2,2,16,2,35,5.0,1,0.0,2,4,0,2,7,2,0,16,2,8,27,1
2566,82399,viuKt4GgrX0rYL5EpHoxJbsiC9TblSuk,7GRhBDsirIGkRZBtSMEzNTyDr2JQm4xx,1,0,0,0,0,0,1,0,1,0.14285714285714285,1,0.0,0,0,0,0,0,0,0,1,0,0,1,1
2567,82645,CSh5hGbaSFu2yCb31iVMOVwKocrH471Q,RXDvfPUBYFlVdlueBFbLW0mhhAyGEqpt,8,27,16,0,2,0,6,0,51,7.285714285714286,4,0.0,0,16,0,2,27,0,0,6,0,18,33,0
2568,82797,BzvzyDIHLe9MZwFkiZf5BNkVkHrFZ1uP,SpATywNh6bZuzm8s1ceuBUnMUAeoAHHw,8,5,4,0,3,0,2,0,14,2.0,1,0.0,0,4,0,3,5,0,0,2,0,7,7,1
2569,82815,IYjgMeQycDQkXIpTAZqsKVDfOfuGTmr6,G8EPVSXsOYB5YQWZGiz1aVq5Pgr2GrQu,17,32,3,28,2,2,4,0,71,10.142857142857142,3,0.0,9,3,25,2,23,2,3,4,0,39,32,1
2570,82826,6PLrCNmfEwPk8NveiZ2kjz8b6TJ4tdFy,SpATywNh6bZuzm8s1ceuBUnMUAeoAHHw,15,26,0,20,0,7,12,6,71,10.142857142857142,1,0.0,12,0,17,0,14,7,3,12,6,29,42,1
2571,82980,KJHVgwvyEGSqeXuZ6P7l6YnOOdmnECg0,G8EPVSXsOYB5YQWZGiz1aVq5Pgr2GrQu,8,13,0,0,0,13,6,0,32,4.571428571428571,3,0.0,0,0,0,0,13,13,0,6,0,0,32,1
2572,83008,OifsLGRBGBgFFNsSrNDnK5W8Vbn9qLGX,bWdj2GDclj5ofokWjzoa5jAwMkxCykd6,5,7,0,0,0,0,0,0,7,1.0,1,0.0,0,0,0,0,7,0,0,0,0,0,7,1
2573,83034,JfftjOGdDbpgbrupi0Gwr899R0jzXikJ,RXDvfPUBYFlVdlueBFbLW0mhhAyGEqpt,11,17,10,0,4,0,5,0,36,5.142857142857143,3,0.0,0,10,0,4,17,0,0,5,0,14,22,1
2574,83174,5A8qgesuumI82DPHv10fhG2s0pO5oVZR,A3fsA9Zfv1X2fVEQhTw51lKENdNrEqT3,6,4,0,0,0,0,4,0,8,1.1428571428571428,2,0.0,0,0,0,0,4,0,0,4,0,0,8,1
2575,83211,Wr4SmSlfffOCt9SGCoEYbe3u98RIz0dN,A3fsA9Zfv1X2fVEQhTw51lKENdNrEqT3,42,40,31,42,21,0,7,0,141,20.142857142857142,2,0.0,3,31,42,21,37,0,0,7,0,97,44,1
2576,83290,V5AS4ngknDMHs5ddf49SxlAoYguZsiN3,SpATywNh6bZuzm8s1ceuBUnMUAeoAHHw,8,10,2,0,2,0,3,0,17,2.4285714285714284,1,0.0,0,2,0,2,10,0,0,3,0,4,13,1
2577,83513,FN4Q8gUJQiuKtRiPQS3gBMUWwSnDptW4,SpATywNh6bZuzm8s1ceuBUnMUAeoAHHw,14,26,12,17,5,0,3,0,63,9.0,2,0.0,9,12,14,5,17,0,3,3,0,40,23,1
2578,83577,ew5XZC7WSosl0QdXH45kYD3syMSGbOj6,A3fsA9Zfv1X2fVEQhTw51lKENdNrEqT3,22,30,12,0,10,0,2,0,54,7.714285714285714,2,0.0,4,12,0,10,26,0,0,2,0,26,28,1
2579,83613,puN480TO3qbGXrXmM5qoOdmstQ51OC6E,bWdj2GDclj5ofokWjzoa5jAwMkxCykd6,12,29,13,0,8,23,31,4,108,15.428571428571429,2,0.0,6,13,0,8,23,23,0,31,4,27,81,0
2580,83623,H6I6nkJ6DtlIXdQ1opNRFdSYIFjksvYQ,SpATywNh6bZuzm8s1ceuBUnMUAeoAHHw,17,23,10,19,3,34,13,1,103,14.714285714285714,5,0.0,6,10,16,3,17,34,3,13,1,35,68,1
2581,83890,hkZJZMuEk3eRSgWhjH7jPcJrlgv2RTNl,bWdj2GDclj5ofokWjzoa5jAwMkxCykd6,15,13,6,40,3,5,1,0,68,9.714285714285714,1,0.0,5,6,39,3,8,5,1,1,0,53,15,1
2582,83902,9fqjCwCWiE2ZIs1HrK3mm4R5MSyOKac5,A3fsA9Zfv1X2fVEQhTw51lKENdNrEqT3,13,24,11,0,7,0,6,0,48,6.857142857142857,1,0.0,0,11,0,7,24,0,0,6,0,18,30,1
2583,83909,lQbf9gXsN1R7oTfmD8ApJzd1F5wN4xv1,RXDvfPUBYFlVdlueBFbLW0mhhAyGEqpt,6,1,1,0,1,1,4,0,8,1.1428571428571428,1,0.0,0,1,0,1,1,1,0,4,0,2,6,1
2584,84034,lDJqver3AFFUyXISNdqvZpmq6OeWVl0r,A3fsA9Zfv1X2fVEQhTw51lKENdNrEqT3,5,2,1,0,1,0,2,0,6,0.8571428571428571,1,0.0,0,1,0,1,2,0,0,2,0,2,4,0
2585,84058,mMS5utPEE0kau31EdquwgaN1e0nxF2V4,SpATywNh6bZuzm8s1ceuBUnMUAeoAHHw,11,15,9,8,6,0,2,0,40,5.714285714285714,2,0.0,0,9,8,6,15,0,0,2,0,23,17,1
2586,84183,xXxqqh9yVGi9oZiE57nohuMrqKDnoyIS,A3fsA9Zfv1X2fVEQhTw51lKENdNrEqT3,8,5,3,0,1,0,3,0,12,1.7142857142857142,1,0.0,0,3,0,1,5,0,0,3,0,4,8,1
2587,84273,Mbzz4hCvkXsTjBUMTZvnUnOUU5DkeepD,fbPkOYLVPtPgIt0MxizjfFJov3JbHyAi,13,7,5,0,4,3,13,0,32,4.571428571428571,1,0.0,0,5,0,4,7,3,0,13,0,9,23,1
2588,84439,lmCPiW6l0WNp9Ttn0lhwFDs7FfVubtvY,SpATywNh6bZuzm8s1ceuBUnMUAeoAHHw,14,39,0,25,0,0,7,2,73,10.428571428571429,3,0.0,21,0,22,0,18,0,3,7,2,43,30,0
2589,84531,UwNh19bGTGX7YEBtcKZFqxDpmh2gUs3A,SpATywNh6bZuzm8s1ceuBUnMUAeoAHHw,14,26,13,18,8,1,3,0,69,9.857142857142858,2,0.0,8,13,15,8,18,1,3,3,0,44,25,0
2590,84696,HDx7XT9cwQtHtGFe0Ylk6QLaCz2f0GRa,bWdj2GDclj5ofokWjzoa5jAwMkxCykd6,6,4,2,0,2,9,3,0,20,2.857142857142857,1,0.0,1,2,0,2,3,9,0,3,0,5,15,1
2591,84733,9WmzxyamLAgd2LnrO6zydiN7WV3MNZZt,SpATywNh6bZuzm8s1ceuBUnMUAeoAHHw,15,11,6,14,5,27,9,2,74,10.571428571428571,2,0.0,4,6,14,5,7,27,0,9,2,29,45,1
2592,84768,DsHgWZRTJ1y1l15smwhB78ZQq3d8dyKP,bWdj2GDclj5ofokWjzoa5jAwMkxCykd6,10,54,4,24,5,2,13,0,102,14.571428571428571,5,0.0,6,4,23,5,48,2,1,13,0,38,64,1
2593,84824,CCr7XJJW4dK2W5QL9m4z2ZC42b4ulnok,SpATywNh6bZuzm8s1ceuBUnMUAeoAHHw,13,11,6,0,3,2,10,2,34,4.857142857142857,2,0.0,3,6,0,3,8,2,0,10,2,12,22,0
2594,84840,nMDev1avOgY53G2oqsCYhN7adTYqimPz,SpATywNh6bZuzm8s1ceuBUnMUAeoAHHw,14,15,6,13,4,0,3,0,41,5.857142857142857,2,0.0,6,6,12,4,9,0,1,3,0,28,13,1
2595,84856,IKpNQ2VJXcBrssoIsB3X4wtY2qE1YTKj,bWdj2GDclj5ofokWjzoa5jAwMkxCykd6,7,8,4,0,3,3,3,0,21,3.0,2,0.0,0,4,0,3,8,3,0,3,0,7,14,1
2596,84967,cnF5YfjX3CQt7JMSCL8P4leqdmCPbBni,A3fsA9Zfv1X2fVEQhTw51lKENdNrEqT3,3,2,0,0,0,0,1,0,3,0.42857142857142855,1,0.0,0,0,0,0,2,0,0,1,0,0,3,1
2597,85000,7ZT5u11YEDTZhD4NZDPzOcLz6uLhq9Bd,RXDvfPUBYFlVdlueBFbLW0mhhAyGEqpt,9,5,4,0,2,0,2,0,13,1.8571428571428572,1,0.0,0,4,0,2,5,0,0,2,0,6,7,1
2598,85143,cnF5YfjX3CQt7JMSCL8P4leqdmCPbBni,SpATywNh6bZuzm8s1ceuBUnMUAeoAHHw,13,19,3,19,1,1,7,2,52,7.428571428571429,2,0.0,2,3,17,1,17,1,2,7,2,23,29,1
2599,85253,XJf8gYhDJm1hrkVJvLQ4HKEnvPd3mIMq,G8EPVSXsOYB5YQWZGiz1aVq5Pgr2GrQu,5,9,1,0,0,3,4,0,17,2.4285714285714284,2,0.0,3,1,0,0,6,3,0,4,0,4,13,1
2600,85283,9WmzxyamLAgd2LnrO6zydiN7WV3MNZZt,RXDvfPUBYFlVdlueBFbLW0mhhAyGEqpt,4,2,1,0,1,0,1,0,5,0.7142857142857143,1,0.0,0,1,0,1,2,0,0,1,0,2,3,1
2601,85295,Zp1ZZPWn2kKT7nmilqO0Enc4rubJRG8n,SpATywNh6bZuzm8s1ceuBUnMUAeoAHHw,7,20,2,0,1,1,33,0,57,8.142857142857142,4,0.0,0,2,0,1,20,1,0,33,0,3,54,0
2602,85331,RZI7KROUR7i2T6MB71TuoKGbXE5WXiwO,SpATywNh6bZuzm8s1ceuBUnMUAeoAHHw,5,10,0,0,0,0,4,0,14,2.0,1,0.0,0,0,0,0,10,0,0,4,0,0,14,1
2603,86978,w4c5I9GnSWI6sLkTNrP2S1NFytPszceZ,SpATywNh6bZuzm8s1ceuBUnMUAeoAHHw,7,6,4,0,3,0,2,0,15,2.142857142857143,2,0.0,0,4,0,3,6,0,0,2,0,7,8,1
2604,87018,puN480TO3qbGXrXmM5qoOdmstQ51OC6E,A3fsA9Zfv1X2fVEQhTw51lKENdNrEqT3,26,28,20,0,14,2,17,1,82,11.714285714285714,1,0.0,1,20,0,14,27,2,0,17,1,35,47,0
2605,87044,BcU9hDrDz2F2xEd3tqF67ZptaAdextzP,SpATywNh6bZuzm8s1ceuBUnMUAeoAHHw,6,3,1,0,1,0,2,0,7,1.0,1,0.0,0,1,0,1,3,0,0,2,0,2,5,1
2606,87111,fDs5TBVrvPHEIMLkBACIVQ2YkCdHCFLD,SpATywNh6bZuzm8s1ceuBUnMUAeoAHHw,10,11,8,0,5,0,3,0,27,3.857142857142857,2,0.0,0,8,0,5,11,0,0,3,0,13,14,1
2607,87127,dNFEIzn0depAU4oAUIlHxTqSNcin3JsM,SpATywNh6bZuzm8s1ceuBUnMUAeoAHHw,14,62,18,20,1,18,26,4,149,21.285714285714285,5,0.0,7,18,17,1,55,18,3,26,4,43,106,0
2608,87281,8fWrC0LYUq5E0gzy0gw2GD73h6o6q5AG,SpATywNh6bZuzm8s1ceuBUnMUAeoAHHw,8,15,3,0,3,0,5,0,26,3.7142857142857144,3,0.0,0,3,0,3,15,0,0,5,0,6,20,0
2609,87383,7zKNYNlQe19MsOrdmzXSTtaqDWKHEPlA,SpATywNh6bZuzm8s1ceuBUnMUAeoAHHw,3,2,1,0,0,0,1,0,4,0.5714285714285714,1,0.0,0,1,0,0,2,0,0,1,0,1,3,0
2610,87440,MvkQjmVQSq3aFQKnqlTw1GsAe1sz0UUt,RXDvfPUBYFlVdlueBFbLW0mhhAyGEqpt,14,9,8,0,6,0,1,0,24,3.4285714285714284,1,0.0,0,8,0,6,9,0,0,1,0,14,10,1
2611,87630,IUn6MADAjAYkGlJisA1WiDvCeNlJd5Xd,A3fsA9Zfv1X2fVEQhTw51lKENdNrEqT3,1,0,0,0,0,0,1,0,1,0.14285714285714285,1,0.0,0,0,0,0,0,0,0,1,0,0,1,1
2612,87652,CeA39yEXem4lTmymvIZvr20kWcsmIjJE,SpATywNh6bZuzm8s1ceuBUnMUAeoAHHw,13,15,7,14,3,0,2,0,41,5.857142857142857,1,0.0,6,7,13,3,9,0,1,2,0,29,12,0
2613,87691,9vlKLLRVHTgTa2OMtndxw1oJeJABVSGY,RXDvfPUBYFlVdlueBFbLW0mhhAyGEqpt,48,77,33,144,16,15,7,2,294,42.0,2,0.0,14,33,123,16,63,15,21,7,2,186,108,0
2614,87695,oL1G89Phk4nduULmJ17br7A4xddcHdc4,A3fsA9Zfv1X2fVEQhTw51lKENdNrEqT3,5,2,1,0,1,0,5,0,9,1.2857142857142858,3,0.0,0,1,0,1,2,0,0,5,0,2,7,0
2615,87775,Tk65NSEWZoGK32sB9eYUeC558zBlLPIW,RXDvfPUBYFlVdlueBFbLW0mhhAyGEqpt,8,8,5,0,3,0,1,0,17,2.4285714285714284,1,0.0,2,5,0,3,6,0,0,1,0,10,7,0
2616,87802,3JEt0I9b0JhZhM0RD2D5jI5S8zjjeHFo,SpATywNh6bZuzm8s1ceuBUnMUAeoAHHw,7,2,1,0,1,1,5,1,11,1.5714285714285714,1,0.0,0,1,0,1,2,1,0,5,1,2,9,0
2617,87858,0LERVBlr0s6pvZPTHfS8Y74dmJWxJhcj,A3fsA9Zfv1X2fVEQhTw51lKENdNrEqT3,45,25,18,62,12,2,21,5,145,20.714285714285715,2,0.0,3,18,57,12,22,2,5,21,5,90,55,0
2618,87860,Uggn85R7OMhc9c2ThQoRc9ji4ASPnsWa,SpATywNh6bZuzm8s1ceuBUnMUAeoAHHw,17,51,19,20,8,15,17,2,132,18.857142857142858,4,0.0,19,19,17,8,32,15,3,17,2,63,69,0
2619,88097,dCAqk9uHiS99GMTcJQtThG8XWnwwbp5Q,A3fsA9Zfv1X2fVEQhTw51lKENdNrEqT3,4,3,0,0,0,0,2,0,5,0.7142857142857143,1,0.0,0,0,0,0,3,0,0,2,0,0,5,1
2620,88197,Gvc7BFl5Q4FP2VRb1ZvRJI4nuqv9yacP,SpATywNh6bZuzm8s1ceuBUnMUAeoAHHw,16,19,7,13,4,0,6,0,49,7.0,2,0.0,10,7,11,4,9,0,2,6,0,32,17,0
2621,88213,6mJ65eKOiDJ0B2UMjBjMI3Dy4vxZcYQe,A3fsA9Zfv1X2fVEQhTw51lKENdNrEqT3,6,6,2,0,0,0,1,0,9,1.2857142857142858,1,0.0,0,2,0,0,6,0,0,1,0,2,7,0
2622,88216,M8C9BDFICk4ida59GU0jjp556zazDEi1,RXDvfPUBYFlVdlueBFbLW0mhhAyGEqpt,15,10,5,21,4,0,2,0,42,6.0,1,0.0,4,5,21,4,6,0,0,2,0,34,8,1
2623,88421,QOc3KAKkR4oB1aPHWnnoHskpc1gxhWoJ,7GRhBDsirIGkRZBtSMEzNTyDr2JQm4xx,4,0,0,0,0,0,5,2,7,1.0,1,0.0,0,0,0,0,0,0,0,5,2,0,7,0
2624,88774,bu1uIofAEXp6y759RqllOrvBV32SRihX,fbPkOYLVPtPgIt0MxizjfFJov3JbHyAi,6,7,2,0,3,0,1,0,13,1.8571428571428572,1,0.0,2,2,0,3,5,0,0,1,0,7,6,1
2625,88776,vYczGhgY6hRrqG3zxTp11QHECk2atn6B,fbPkOYLVPtPgIt0MxizjfFJov3JbHyAi,1,0,0,0,0,0,1,0,1,0.14285714285714285,1,0.0,0,0,0,0,0,0,0,1,0,0,1,1
2626,88779,iNn3GY2iMNNtDv4o6NBexjhb9hKLROis,fbPkOYLVPtPgIt0MxizjfFJov3JbHyAi,8,3,2,0,2,1,7,0,15,2.142857142857143,1,0.0,0,2,0,2,3,1,0,7,0,4,11,1
2627,88781,qWMwjLnEJjczF5VTHIYJc2IYsIWCauLR,fbPkOYLVPtPgIt0MxizjfFJov3JbHyAi,1,0,0,0,0,0,1,0,1,0.14285714285714285,1,0.0,0,0,0,0,0,0,0,1,0,0,1,1
2628,88786,vSChBkDKZDj0rGwM1GtwFmYGnjiDkIOW,fbPkOYLVPtPgIt0MxizjfFJov3JbHyAi,7,3,2,0,2,0,3,0,10,1.4285714285714286,1,0.0,0,2,0,2,3,0,0,3,0,4,6,1
2629,88792,iSqOqP6glvJYYgjvVVmRA8ZoUSLDsK6d,fbPkOYLVPtPgIt0MxizjfFJov3JbHyAi,10,17,0,0,0,4,4,0,25,3.5714285714285716,1,0.0,0,0,0,0,17,4,0,4,0,0,25,1
2630,88794,kkbu1cG9inVmqEkdKJKJuXBK4YtOWY9c,fbPkOYLVPtPgIt0MxizjfFJov3JbHyAi,12,17,11,0,7,31,18,2,86,12.285714285714286,2,0.0,0,11,0,7,17,31,0,18,2,18,68,1
2631,88795,0Ak7DRLBwBUTJguUJwEJj8xSRI6vwPPn,fbPkOYLVPtPgIt0MxizjfFJov3JbHyAi,1,0,0,0,0,0,1,0,1,0.14285714285714285,1,0.0,0,0,0,0,0,0,0,1,0,0,1,1
2632,88796,UiiOcn6NP18L6Qa9IVzPK487RvBT0lsx,fbPkOYLVPtPgIt0MxizjfFJov3JbHyAi,9,7,2,2,3,0,6,0,20,2.857142857142857,2,0.0,3,2,2,3,4,0,0,6,0,10,10,1
2633,88798,ve5RU3FKgJWxFE29I7niN6ycQVJrJFg4,fbPkOYLVPtPgIt0MxizjfFJov3JbHyAi,1,0,0,0,0,0,1,0,1,0.14285714285714285,1,0.0,0,0,0,0,0,0,0,1,0,0,1,0
2634,88801,o7nB1nybhMcFgLy31X3R6RDOK94b1Iaa,fbPkOYLVPtPgIt0MxizjfFJov3JbHyAi,1,0,0,0,0,0,1,0,1,0.14285714285714285,1,0.0,0,0,0,0,0,0,0,1,0,0,1,1
2635,88807,7NFw5LeL3eVsvkPDcb0VUxu8lVItKrJ1,fbPkOYLVPtPgIt0MxizjfFJov3JbHyAi,6,1,1,0,1,0,3,0,6,0.8571428571428571,1,0.0,0,1,0,1,1,0,0,3,0,2,4,1
2636,88812,PeUQJJiLjuIkI3TtwdkKlVprakOI9tf7,fbPkOYLVPtPgIt0MxizjfFJov3JbHyAi,10,11,7,2,4,6,4,0,34,4.857142857142857,2,0.0,1,7,2,4,10,6,0,4,0,14,20,1
2637,88816,X6obkU5FlEZFIiOk6MXrjhBqZaDGxW04,fbPkOYLVPtPgIt0MxizjfFJov3JbHyAi,5,5,2,0,0,0,4,0,11,1.5714285714285714,1,0.0,2,2,0,0,3,0,0,4,0,4,7,1
2638,88817,8fvsCrC8dcOje6DxrGntnTxmufYXJCrq,fbPkOYLVPtPgIt0MxizjfFJov3JbHyAi,5,3,2,0,2,3,0,0,10,1.4285714285714286,1,0.0,0,2,0,2,3,3,0,0,0,4,6,1
2639,88819,b0RJDCT6ztjQgqXKC4k3XnnVgTiN1Yo8,fbPkOYLVPtPgIt0MxizjfFJov3JbHyAi,7,4,2,0,2,0,3,0,11,1.5714285714285714,1,0.0,1,2,0,2,3,0,0,3,0,5,6,1
2640,88827,HRqYDSGbWA4dSXQsJ8hpWgRfS7ylZUt3,fbPkOYLVPtPgIt0MxizjfFJov3JbHyAi,1,0,0,0,0,0,1,0,1,0.14285714285714285,1,0.0,0,0,0,0,0,0,0,1,0,0,1,1
2641,88829,Wz7BSBOI9rzgAwf2xVcld90BewMcWv25,fbPkOYLVPtPgIt0MxizjfFJov3JbHyAi,1,0,0,0,0,0,1,0,1,0.14285714285714285,1,0.0,0,0,0,0,0,0,0,1,0,0,1,1
2642,88830,OH8WnAV2MBaaFDQHpnLQPXNjc3Qpxqk2,fbPkOYLVPtPgIt0MxizjfFJov3JbHyAi,5,2,1,0,1,0,2,0,6,0.8571428571428571,1,0.0,0,1,0,1,2,0,0,2,0,2,4,1
2643,88831,54BZa2PEVowNqI6EO6NzeCnkR49ry3oS,fbPkOYLVPtPgIt0MxizjfFJov3JbHyAi,15,11,7,0,6,0,3,1,28,4.0,2,0.0,0,7,0,6,11,0,0,3,1,13,15,0
2644,88836,Q5WIg2xkKAnXbT25kMzwfPcqhoeXQ6O6,fbPkOYLVPtPgIt0MxizjfFJov3JbHyAi,5,4,1,0,0,0,6,0,11,1.5714285714285714,1,0.0,0,1,0,0,4,0,0,6,0,1,10,1
2645,88842,gqL1AoJbIkLDCmEi1SGH37fAu1Zdec1f,fbPkOYLVPtPgIt0MxizjfFJov3JbHyAi,4,2,1,0,1,1,2,0,7,1.0,1,0.0,0,1,0,1,2,1,0,2,0,2,5,1
2646,88844,ZDHeqiQjfEk7rIDSgnURnMSZOtUwJ10H,fbPkOYLVPtPgIt0MxizjfFJov3JbHyAi,2,0,0,0,0,0,5,0,5,0.7142857142857143,1,0.0,0,0,0,0,0,0,0,5,0,0,5,1
2647,88845,eIlDqSEsjE2VA3vAbhP1Z42JoYB6Ak2T,fbPkOYLVPtPgIt0MxizjfFJov3JbHyAi,5,2,1,0,1,0,6,0,10,1.4285714285714286,1,0.0,0,1,0,1,2,0,0,6,0,2,8,1
2648,88848,QNLtuhI0bPryV8RMsGGTDcbcPdbX4kMs,fbPkOYLVPtPgIt0MxizjfFJov3JbHyAi,2,0,0,0,0,0,3,0,3,0.42857142857142855,1,0.0,0,0,0,0,0,0,0,3,0,0,3,1
2649,88849,LSAqQ9qRJ6IA5mDIPLRj3aw5O17rNapz,fbPkOYLVPtPgIt0MxizjfFJov3JbHyAi,9,12,7,0,3,12,5,1,40,5.714285714285714,2,0.0,0,7,0,3,12,12,0,5,1,10,30,1
2650,88854,1kjyC7ahZCsVlNSBwjZNyonjDeeXb2jh,fbPkOYLVPtPgIt0MxizjfFJov3JbHyAi,9,16,7,0,5,103,9,3,143,20.428571428571427,4,0.0,4,7,0,5,12,103,0,9,3,16,127,0
2651,88857,bw9UxZPjqLSacLegO6BK4IbuCk1Em4xv,fbPkOYLVPtPgIt0MxizjfFJov3JbHyAi,8,5,2,0,3,3,4,1,18,2.5714285714285716,1,0.0,2,2,0,3,3,3,0,4,1,7,11,1
2652,89192,qdtUflOgjNtEwAQs5kfj08fBL21x3VNU,SpATywNh6bZuzm8s1ceuBUnMUAeoAHHw,1,0,0,0,0,0,2,0,2,0.2857142857142857,1,0.0,0,0,0,0,0,0,0,2,0,0,2,1
2653,89200,KgPlJUOxzo6K50clHm6VhLAZdTWxAeXA,bWdj2GDclj5ofokWjzoa5jAwMkxCykd6,9,10,4,0,4,0,6,0,24,3.4285714285714284,1,0.0,4,4,0,4,6,0,0,6,0,12,12,1
2654,89203,Uu9HJTuPU1AJpa1Ej1uv2nh5k9DxfLwn,SpATywNh6bZuzm8s1ceuBUnMUAeoAHHw,1,0,0,0,0,0,1,0,1,0.14285714285714285,1,0.0,0,0,0,0,0,0,0,1,0,0,1,1
2655,89218,7LucM9vSYQRj5WElUEHVyxCSXUCCbwlX,SpATywNh6bZuzm8s1ceuBUnMUAeoAHHw,10,12,0,0,0,0,12,1,25,3.5714285714285716,2,0.0,0,0,0,0,12,0,0,12,1,0,25,1
2656,89223,BWy2motGgrgIUCZ4P1YohdMfi2tPp47Y,RXDvfPUBYFlVdlueBFbLW0mhhAyGEqpt,5,5,2,0,1,0,1,0,9,1.2857142857142858,1,0.0,0,2,0,1,5,0,0,1,0,3,6,1
2657,89228,1ZTeBIrbRrFVlBGh19J78zN1bkBytKqn,SpATywNh6bZuzm8s1ceuBUnMUAeoAHHw,2,0,0,0,0,0,2,0,2,0.2857142857142857,1,0.0,0,0,0,0,0,0,0,2,0,0,2,1
2658,89233,8eAdemzlZoqb3LPXg3UGAyOaCroYfZmg,RXDvfPUBYFlVdlueBFbLW0mhhAyGEqpt,17,18,10,11,7,0,2,0,48,6.857142857142857,3,0.0,1,10,10,7,17,0,1,2,0,28,20,1
2659,89236,QM2pO4xP1MmCGymVeJBe4Ub355o8EWcr,bWdj2GDclj5ofokWjzoa5jAwMkxCykd6,5,3,1,0,1,0,2,0,7,1.0,1,0.0,0,1,0,1,3,0,0,2,0,2,5,1
2660,89237,h9qmMnJv0qklBUNKS7VMrlLJy4CMBo05,SpATywNh6bZuzm8s1ceuBUnMUAeoAHHw,5,4,2,0,0,0,3,0,9,1.2857142857142858,1,0.0,0,2,0,0,4,0,0,3,0,2,7,1
2661,89239,UGMWl4hUVp9QjwcWkjjH1sbPQBgn5xrQ,SpATywNh6bZuzm8s1ceuBUnMUAeoAHHw,3,1,0,0,0,0,2,0,3,0.42857142857142855,1,0.0,0,0,0,0,1,0,0,2,0,0,3,1
2662,89241,wegnaf6UPYTo0llSdU8mAv6LbtaJoiyd,SpATywNh6bZuzm8s1ceuBUnMUAeoAHHw,2,1,0,0,0,0,2,0,3,0.42857142857142855,1,0.0,0,0,0,0,1,0,0,2,0,0,3,1
2663,89250,RKKZYIeeZxcb4bVVzfjEMLxVYtQktlhB,G8EPVSXsOYB5YQWZGiz1aVq5Pgr2GrQu,1,0,0,0,0,0,1,0,1,0.14285714285714285,1,0.0,0,0,0,0,0,0,0,1,0,0,1,1
2664,89251,gleoXCfE3tA6f5uM3pUTeqQbfFckrfVd,RXDvfPUBYFlVdlueBFbLW0mhhAyGEqpt,1,0,0,0,0,0,1,0,1,0.14285714285714285,1,0.0,0,0,0,0,0,0,0,1,0,0,1,1
2665,89256,ChYzFAABctmbTCcKox1jjUslr0LvrjbV,SpATywNh6bZuzm8s1ceuBUnMUAeoAHHw,4,1,0,0,0,1,5,0,7,1.0,1,0.0,0,0,0,0,1,1,0,5,0,0,7,1
2666,89270,gEfSYt3WBpt849T4WTB0FbXbrRt5CLQv,SpATywNh6bZuzm8s1ceuBUnMUAeoAHHw,11,21,8,0,0,15,19,3,66,9.428571428571429,1,0.0,4,8,0,0,17,15,0,19,3,12,54,1
2667,89281,yKv3mdAWukUWum1t61vTABExIrvKJ0AU,SpATywNh6bZuzm8s1ceuBUnMUAeoAHHw,7,3,1,0,1,1,8,1,15,2.142857142857143,1,0.0,0,1,0,1,3,1,0,8,1,2,13,1
2668,89299,jBvTFD7LxuGGBRz8wehp1f9k2WItIuV7,SpATywNh6bZuzm8s1ceuBUnMUAeoAHHw,8,3,1,0,1,10,6,1,22,3.142857142857143,1,0.0,0,1,0,1,3,10,0,6,1,2,20,1
2669,89306,5NHJ5bwX3OLzU7LroLiUkr7DhCqHm7Yd,G8EPVSXsOYB5YQWZGiz1aVq5Pgr2GrQu,1,0,0,0,0,0,1,0,1,0.14285714285714285,1,0.0,0,0,0,0,0,0,0,1,0,0,1,1
2670,89318,gBSqr7imZMe4VvRAJjAvzXdfEDgvP8wY,SpATywNh6bZuzm8s1ceuBUnMUAeoAHHw,5,2,1,0,1,0,2,0,6,0.8571428571428571,1,0.0,0,1,0,1,2,0,0,2,0,2,4,1
2671,89324,BOna3ORacJGhjt4FcGMkKNwkDYsEjcvt,SpATywNh6bZuzm8s1ceuBUnMUAeoAHHw,14,22,12,0,6,0,7,0,47,6.714285714285714,3,0.0,0,12,0,6,22,0,0,7,0,18,29,1
2672,89326,wNXelOaGj6HkY91hCddHRdOCiLagph7q,SpATywNh6bZuzm8s1ceuBUnMUAeoAHHw,13,9,4,18,3,0,3,0,37,5.285714285714286,1,0.0,5,4,15,3,4,0,3,3,0,27,10,0
2673,89332,orWLR4UhuJawyT3Ov1vj8DpKoW3alfLI,SpATywNh6bZuzm8s1ceuBUnMUAeoAHHw,7,5,1,0,1,1,4,0,12,1.7142857142857142,1,0.0,0,1,0,1,5,1,0,4,0,2,10,1
2674,89333,NkHKHGQ1t9WfF0WY6b3ThoMuQiXODoZm,SpATywNh6bZuzm8s1ceuBUnMUAeoAHHw,17,34,13,18,7,0,34,2,108,15.428571428571429,2,0.0,4,13,15,7,30,0,3,34,2,39,69,1
2675,89336,Pmww0SJUHaKN8gulRmzkCa5ajmPTXJLo,SpATywNh6bZuzm8s1ceuBUnMUAeoAHHw,15,14,5,10,4,1,5,0,39,5.571428571428571,1,0.0,5,5,9,4,9,1,1,5,0,23,16,1
2676,89342,HkLybTJ0rEPGE4JvzzYK050V4PCx14xg,SpATywNh6bZuzm8s1ceuBUnMUAeoAHHw,12,18,10,4,4,0,9,0,45,6.428571428571429,2,0.0,0,10,4,4,18,0,0,9,0,18,27,1
2677,89366,DswbrMY6sPJD5b1m5ODFx580irKlb07k,SpATywNh6bZuzm8s1ceuBUnMUAeoAHHw,3,2,0,0,0,0,1,0,3,0.42857142857142855,1,0.0,0,0,0,0,2,0,0,1,0,0,3,1
2678,89369,aulAQhL9pTbme70JKMz61j88uhAKeUZs,SpATywNh6bZuzm8s1ceuBUnMUAeoAHHw,1,0,0,0,0,0,1,0,1,0.14285714285714285,1,0.0,0,0,0,0,0,0,0,1,0,0,1,1
2679,89373,PqxW0fs8xtO0oqw8MXcVBsN6WdOuPEkP,SpATywNh6bZuzm8s1ceuBUnMUAeoAHHw,16,15,8,8,5,1,9,1,47,6.714285714285714,1,0.0,6,8,7,5,9,1,1,9,1,26,21,1
2680,89380,5rjYFuFo5D0yRo1dV2LjaXf9wIi8Axa0,SpATywNh6bZuzm8s1ceuBUnMUAeoAHHw,3,2,0,0,0,2,5,0,9,1.2857142857142858,1,0.0,0,0,0,0,2,2,0,5,0,0,9,1
2681,89381,Ryr7edEzpzXZS735AEqOzJJJwXWQPdd0,SpATywNh6bZuzm8s1ceuBUnMUAeoAHHw,4,2,1,0,0,0,2,0,5,0.7142857142857143,1,0.0,0,1,0,0,2,0,0,2,0,1,4,1
2682,89383,bEdF35UbCc85Bz4pUhhoEkUONzXdnpDg,SpATywNh6bZuzm8s1ceuBUnMUAeoAHHw,11,6,0,14,0,8,5,1,34,4.857142857142857,1,0.0,2,0,11,0,4,8,3,5,1,13,21,1
2683,89390,3Ks5QZGHTPRjC7k0qconLYz2L7E6QNo7,SpATywNh6bZuzm8s1ceuBUnMUAeoAHHw,7,2,1,0,1,0,9,0,13,1.8571428571428572,1,0.0,0,1,0,1,2,0,0,9,0,2,11,1
2684,89393,ishZb4e9jFXg2QviC2ko889EaUZeTZU9,SpATywNh6bZuzm8s1ceuBUnMUAeoAHHw,15,40,15,28,8,19,21,1,132,18.857142857142858,4,0.0,20,15,23,8,20,19,5,21,1,66,66,1
2685,89395,3bFfBpBuKdxav891YoVnpf8j830LveoM,SpATywNh6bZuzm8s1ceuBUnMUAeoAHHw,8,10,8,0,7,0,3,0,28,4.0,1,0.0,0,8,0,7,10,0,0,3,0,15,13,1
2686,89407,5dwj8tU2wkUoDpYyu0cC8IGAIxW1A4P6,SpATywNh6bZuzm8s1ceuBUnMUAeoAHHw,13,7,4,15,3,0,2,0,31,4.428571428571429,1,0.0,2,4,13,3,5,0,2,2,0,22,9,1
2687,89411,xSMp0r4oxogHBl1WzBSO421fVgDtvwXN,SpATywNh6bZuzm8s1ceuBUnMUAeoAHHw,16,9,5,12,3,12,8,1,50,7.142857142857143,2,0.0,2,5,9,3,7,12,3,8,1,19,31,1
2688,89415,mzOGsK1l4jUAAFEU0Ebe2O2EryG7sXnC,SpATywNh6bZuzm8s1ceuBUnMUAeoAHHw,9,5,1,0,0,4,17,1,28,4.0,3,0.0,0,1,0,0,5,4,0,17,1,1,27,1
2689,89424,QwfRZLEwZGuNcU9jWD0umpLbrwVdhurg,bWdj2GDclj5ofokWjzoa5jAwMkxCykd6,2,0,0,0,0,0,2,0,2,0.2857142857142857,1,0.0,0,0,0,0,0,0,0,2,0,0,2,1
2690,89425,pp1wOcFtHNfcc3zqTz1uxK4VRHQ4zZyX,SpATywNh6bZuzm8s1ceuBUnMUAeoAHHw,6,6,4,0,3,0,3,0,16,2.2857142857142856,1,0.0,0,4,0,3,6,0,0,3,0,7,9,1
2691,89444,KxE6jjAaHiS10lURgTs1mFbTR6SMOswm,SpATywNh6bZuzm8s1ceuBUnMUAeoAHHw,9,11,5,0,4,0,5,0,25,3.5714285714285716,1,0.0,0,5,0,4,11,0,0,5,0,9,16,1
2692,89452,uqXaJBjlB2fR1jGFPXdDLi7hSsdUaco6,bWdj2GDclj5ofokWjzoa5jAwMkxCykd6,5,2,1,0,1,0,3,0,7,1.0,2,0.0,0,1,0,1,2,0,0,3,0,2,5,1
2693,89453,13KVd5Q0kPTyZsaU7eMkcHJocQWxd1Ax,SpATywNh6bZuzm8s1ceuBUnMUAeoAHHw,6,3,1,0,1,0,2,0,7,1.0,1,0.0,0,1,0,1,3,0,0,2,0,2,5,1
2694,89458,iIWDWKAN8CRJ0yZ5zDSccFCRQRwFgxP8,SpATywNh6bZuzm8s1ceuBUnMUAeoAHHw,9,11,2,0,2,0,5,0,20,2.857142857142857,2,0.0,0,2,0,2,11,0,0,5,0,4,16,1
2695,89462,bX1EJ8H8O7LvPaK2JoRVQC0BaLpmhHE6,SpATywNh6bZuzm8s1ceuBUnMUAeoAHHw,9,8,4,0,1,12,8,1,34,4.857142857142857,1,0.0,2,4,0,1,6,12,0,8,1,7,27,0
2696,89463,lV4ifbsehEXWBwQOY9bU762jcRSMFY5M,G8EPVSXsOYB5YQWZGiz1aVq5Pgr2GrQu,4,3,1,0,1,0,1,0,6,0.8571428571428571,1,0.0,0,1,0,1,3,0,0,1,0,2,4,1
2697,89466,IQDJ7vNX3TboLO3MBJIrKiI8pMYx3UfV,SpATywNh6bZuzm8s1ceuBUnMUAeoAHHw,3,0,0,0,0,2,3,0,5,0.7142857142857143,2,0.0,0,0,0,0,0,2,0,3,0,0,5,1
2698,89468,mqlH8gZPP9MOgmB9cgrLKBfSrQuIKKN0,SpATywNh6bZuzm8s1ceuBUnMUAeoAHHw,11,9,6,0,4,1,12,2,34,4.857142857142857,1,0.0,0,6,0,4,9,1,0,12,2,10,24,1
2699,89473,1xcKG4Eeqo6PRlQtqz4lRNBDzvKhe7qL,RXDvfPUBYFlVdlueBFbLW0mhhAyGEqpt,1,0,0,0,0,0,1,0,1,0.14285714285714285,1,0.0,0,0,0,0,0,0,0,1,0,0,1,1
2700,89474,4d7nO3w6797t7DH3QeDnTWHOfNO2pqQC,bWdj2GDclj5ofokWjzoa5jAwMkxCykd6,6,3,1,0,1,3,4,0,12,1.7142857142857142,1,0.0,0,1,0,1,3,3,0,4,0,2,10,1
2701,89476,rX7gdFv8DKFX0CCz7kGKG6ViXpNH34BO,SpATywNh6bZuzm8s1ceuBUnMUAeoAHHw,3,2,0,0,0,0,1,0,3,0.42857142857142855,1,0.0,0,0,0,0,2,0,0,1,0,0,3,0
2702,89489,yxJSlYQPHVk2OJMV54ToOtJy9WMHex3A,SpATywNh6bZuzm8s1ceuBUnMUAeoAHHw,9,8,6,0,5,0,3,0,22,3.142857142857143,1,0.0,0,6,0,5,8,0,0,3,0,11,11,1
2703,89495,5pjAdY5K4FfgQPLSzQKwXaKF78ph9a0y,SpATywNh6bZuzm8s1ceuBUnMUAeoAHHw,5,12,6,0,4,0,4,0,26,3.7142857142857144,2,0.0,0,6,0,4,12,0,0,4,0,10,16,1
2704,89507,mR9Awu9GGhq6cpZDsN1vhsOMBBjHJTwu,RXDvfPUBYFlVdlueBFbLW0mhhAyGEqpt,5,2,1,0,1,0,2,0,6,0.8571428571428571,1,0.0,0,1,0,1,2,0,0,2,0,2,4,1
2705,89516,EzpgLqOBulY4ZVl8QROIPzKxMW9zpKpw,RXDvfPUBYFlVdlueBFbLW0mhhAyGEqpt,1,0,0,0,0,0,1,0,1,0.14285714285714285,1,0.0,0,0,0,0,0,0,0,1,0,0,1,1
2706,89532,8irCUZa4UAKsYYFeHrY9ttb5xgcL2ou7,SpATywNh6bZuzm8s1ceuBUnMUAeoAHHw,8,4,3,0,3,0,1,0,11,1.5714285714285714,1,0.0,0,3,0,3,4,0,0,1,0,6,5,1
2707,89534,k9cA91Q0OJFR9AY1JvRoKP3p8rLkgPCD,bWdj2GDclj5ofokWjzoa5jAwMkxCykd6,18,33,2,82,5,0,16,1,139,19.857142857142858,1,0.0,12,2,73,5,21,0,9,16,1,92,47,1
2708,89540,rHj6Vmp3P9JbmX7QWrSBu45DuiDb8koF,SpATywNh6bZuzm8s1ceuBUnMUAeoAHHw,9,12,2,0,1,0,8,0,23,3.2857142857142856,2,0.0,0,2,0,1,12,0,0,8,0,3,20,1
2709,89560,fUNdgzfWSE4HzsYQQ7FDu5pyDUIMQ40m,G8EPVSXsOYB5YQWZGiz1aVq5Pgr2GrQu,31,98,42,60,22,4,5,0,231,33.0,2,0.0,25,42,46,22,73,4,14,5,0,135,96,1
2710,89561,4t1KNzzepvalCibuzOk5JUX041jKqU9v,SpATywNh6bZuzm8s1ceuBUnMUAeoAHHw,6,3,1,0,1,0,2,0,7,1.0,1,0.0,0,1,0,1,3,0,0,2,0,2,5,1
2711,89566,EDtcftLQ1x638xVsHSB1SBOPZ3SKRCar,G8EPVSXsOYB5YQWZGiz1aVq5Pgr2GrQu,18,69,0,42,8,0,4,0,123,17.571428571428573,2,0.0,33,0,30,8,36,0,12,4,0,71,52,1
2712,89571,YuqMJYvTgiTQGQOAOb2fKJpGas8AG3Wr,SpATywNh6bZuzm8s1ceuBUnMUAeoAHHw,7,8,0,0,1,0,2,0,11,1.5714285714285714,2,0.0,0,0,0,1,8,0,0,2,0,1,10,0
2713,89574,EJIkk1z1GAyTxouBU8smmsjhIBwzBhn1,G8EPVSXsOYB5YQWZGiz1aVq5Pgr2GrQu,1,0,0,0,0,0,1,0,1,0.14285714285714285,1,0.0,0,0,0,0,0,0,0,1,0,0,1,1
2714,89578,2fyY2ZIcA0PnrwGuxHsgvHzUiuyeQCT0,bWdj2GDclj5ofokWjzoa5jAwMkxCykd6,5,9,1,0,0,0,7,0,17,2.4285714285714284,2,0.0,0,1,0,0,9,0,0,7,0,1,16,1
2715,89579,Jeu98URtKOymkXqWZxWi1Dpseg2MOPzv,SpATywNh6bZuzm8s1ceuBUnMUAeoAHHw,8,3,2,0,2,1,4,0,12,1.7142857142857142,1,0.0,0,2,0,2,3,1,0,4,0,4,8,1
2716,89580,UhOcaLqs0mKdRyLwomBmAslkjoePthdJ,SpATywNh6bZuzm8s1ceuBUnMUAeoAHHw,6,0,0,0,0,1,5,1,7,1.0,1,0.0,0,0,0,0,0,1,0,5,1,0,7,1
2717,89584,oiThQK6e6zf4TZYBDNHB9rtiG2PNPeXO,SpATywNh6bZuzm8s1ceuBUnMUAeoAHHw,18,45,21,7,10,1,24,1,109,15.571428571428571,5,0.0,15,21,7,10,30,1,0,24,1,53,56,1
2718,89588,kbrfSPxlM4KkcRw6pTtSThBRf28etAVC,SpATywNh6bZuzm8s1ceuBUnMUAeoAHHw,11,7,1,0,1,2,7,1,19,2.7142857142857144,1,0.0,0,1,0,1,7,2,0,7,1,2,17,1
2719,89591,O6XTfrmBXPHHKFN07CLCPWqyMP9NsQuf,bWdj2GDclj5ofokWjzoa5jAwMkxCykd6,10,10,7,0,4,1,13,0,35,5.0,1,0.0,0,7,0,4,10,1,0,13,0,11,24,1
2720,89592,IkodCQwdqpqIcCcUv2ohgHFT9sJ1SLin,SpATywNh6bZuzm8s1ceuBUnMUAeoAHHw,5,2,1,0,1,0,2,0,6,0.8571428571428571,1,0.0,0,1,0,1,2,0,0,2,0,2,4,1
2721,89593,D8IYaZZCq2kwCopNPookpH1TvQs8o6b0,SpATywNh6bZuzm8s1ceuBUnMUAeoAHHw,11,8,3,0,2,4,8,1,26,3.7142857142857144,1,0.0,0,3,0,2,8,4,0,8,1,5,21,1
2722,89595,6OfXNoCI7Waq7DTFUWFiUcQXC3Cg0WKC,SpATywNh6bZuzm8s1ceuBUnMUAeoAHHw,12,7,4,18,3,0,1,0,33,4.714285714285714,1,0.0,2,4,15,3,5,0,3,1,0,24,9,1
2723,89598,ApFdQQBcLqTLoA4wIvtlnnwFs4FrlVS1,bWdj2GDclj5ofokWjzoa5jAwMkxCykd6,7,4,2,0,0,1,8,1,16,2.2857142857142856,3,0.0,0,2,0,0,4,1,0,8,1,2,14,1
2724,89602,a2CgRiICJuj7paJToANbolKFuh4xahGM,SpATywNh6bZuzm8s1ceuBUnMUAeoAHHw,1,0,0,0,0,0,1,0,1,0.14285714285714285,1,0.0,0,0,0,0,0,0,0,1,0,0,1,1
2725,89612,tYV9adHfuBbrO1GuvSyU9WLWt5LNmPTX,SpATywNh6bZuzm8s1ceuBUnMUAeoAHHw,11,11,4,0,2,8,7,1,33,4.714285714285714,2,0.0,1,4,0,2,10,8,0,7,1,7,26,1
2726,89618,q1qea15PiUc6DOfucwnleCxcnYIfvxHK,SpATywNh6bZuzm8s1ceuBUnMUAeoAHHw,5,6,0,0,0,0,4,1,11,1.5714285714285714,1,0.0,0,0,0,0,6,0,0,4,1,0,11,1
2727,89619,s6NTLcoRryN4aDfvO1qsCQXhze6kEfOl,G8EPVSXsOYB5YQWZGiz1aVq5Pgr2GrQu,6,0,0,0,0,0,7,1,8,1.1428571428571428,1,0.0,0,0,0,0,0,0,0,7,1,0,8,1
2728,89625,LUfJKoRDjcYKUaxb5bwr7doPqmv3K3xe,SpATywNh6bZuzm8s1ceuBUnMUAeoAHHw,16,13,7,21,4,0,5,0,50,7.142857142857143,1,0.0,4,7,18,4,9,0,3,5,0,33,17,1
2729,89628,K34V3e7xSbcwBnfPQw1X6hTJl6udnY0r,RXDvfPUBYFlVdlueBFbLW0mhhAyGEqpt,6,6,3,0,2,1,2,0,14,2.0,1,0.0,0,3,0,2,6,1,0,2,0,5,9,1
2730,89630,Z86ZMxsvWnnyZOKQGNVOWlv60hWLfFNN,G8EPVSXsOYB5YQWZGiz1aVq5Pgr2GrQu,8,10,1,0,1,1,4,0,17,2.4285714285714284,1,0.0,0,1,0,1,10,1,0,4,0,2,15,1
2731,89643,162MrslUTKGd3KlPrbeWS5Qw6KVPvj8q,SpATywNh6bZuzm8s1ceuBUnMUAeoAHHw,5,7,3,0,2,0,3,0,15,2.142857142857143,2,0.0,0,3,0,2,7,0,0,3,0,5,10,1
2732,89645,162MrslUTKGd3KlPrbeWS5Qw6KVPvj8q,bWdj2GDclj5ofokWjzoa5jAwMkxCykd6,6,7,3,0,2,1,2,0,15,2.142857142857143,1,0.0,0,3,0,2,7,1,0,2,0,5,10,1
2733,89655,Ev3g9egQXLhml9mOEMZMdMQN5Z5Fjc5k,G8EPVSXsOYB5YQWZGiz1aVq5Pgr2GrQu,6,3,2,0,2,0,2,0,9,1.2857142857142858,1,0.0,0,2,0,2,3,0,0,2,0,4,5,1
2734,89662,g8m22R7W0Wo8v9RXY0TMbj5qf5RFgvht,bWdj2GDclj5ofokWjzoa5jAwMkxCykd6,6,2,1,0,1,0,4,0,8,1.1428571428571428,1,0.0,0,1,0,1,2,0,0,4,0,2,6,1
2735,89668,EDtcftLQ1x638xVsHSB1SBOPZ3SKRCar,bWdj2GDclj5ofokWjzoa5jAwMkxCykd6,3,4,0,0,1,0,1,0,6,0.8571428571428571,1,0.0,2,0,0,1,2,0,0,1,0,3,3,1
2736,89671,wJC86gc3viBGM4vTuYg8647vhYAtlLLc,G8EPVSXsOYB5YQWZGiz1aVq5Pgr2GrQu,6,3,2,0,2,0,2,0,9,1.2857142857142858,1,0.0,0,2,0,2,3,0,0,2,0,4,5,1
2737,89673,I3y8UhgjOmrKX2NiYCp9q6amv1bHjqBJ,SpATywNh6bZuzm8s1ceuBUnMUAeoAHHw,2,0,0,0,0,0,2,0,2,0.2857142857142857,1,0.0,0,0,0,0,0,0,0,2,0,0,2,1
2738,89674,X1EwqmDy4MdORdVb79oGgVGVtNlVZgX3,SpATywNh6bZuzm8s1ceuBUnMUAeoAHHw,11,11,7,0,3,4,13,3,41,5.857142857142857,1,0.0,0,7,0,3,11,4,0,13,3,10,31,0
2739,89679,8MQx62NrM26CEa5RRkhFUh36AiGGNx6S,bWdj2GDclj5ofokWjzoa5jAwMkxCykd6,1,0,0,0,0,0,1,0,1,0.14285714285714285,1,0.0,0,0,0,0,0,0,0,1,0,0,1,1
2740,89680,xOGjXyyeq87fCMSZ9z7Yuds9sMvR7Ohh,bWdj2GDclj5ofokWjzoa5jAwMkxCykd6,7,5,1,0,2,1,4,2,15,2.142857142857143,1,0.0,3,1,0,2,2,1,0,4,2,6,9,1
2741,89683,JGkH5G6iVBgcA8nzn9agd5N20Wo6tva5,SpATywNh6bZuzm8s1ceuBUnMUAeoAHHw,7,5,3,0,2,0,2,0,12,1.7142857142857142,1,0.0,0,3,0,2,5,0,0,2,0,5,7,1
2742,89701,BawZLFtQaV6cG6ZH5ggA2jwB1HVUhop0,SpATywNh6bZuzm8s1ceuBUnMUAeoAHHw,4,3,1,0,1,0,1,0,6,0.8571428571428571,1,0.0,1,1,0,1,2,0,0,1,0,3,3,1
2743,89702,jsOwPYXTKA5LkdsyLdqfrvO6hpqy63Mk,SpATywNh6bZuzm8s1ceuBUnMUAeoAHHw,6,2,1,0,0,0,4,1,8,1.1428571428571428,1,0.0,0,1,0,0,2,0,0,4,1,1,7,1
2744,89711,Jm4nQ05ndX10jbofbWx6S0r9VXrqia6S,RXDvfPUBYFlVdlueBFbLW0mhhAyGEqpt,15,11,8,14,3,0,4,0,40,5.714285714285714,2,0.0,1,8,12,3,10,0,2,4,0,24,16,0
2745,89717,oyvbie49Qmum2sCNKvrecvOzGpEvkIP4,SpATywNh6bZuzm8s1ceuBUnMUAeoAHHw,16,52,13,16,4,6,8,1,100,14.285714285714286,2,0.0,19,13,13,4,33,6,3,8,1,49,51,1
2746,89722,TvtAHA9SMsJXnMoIbE5m05sk6M63p1ir,SpATywNh6bZuzm8s1ceuBUnMUAeoAHHw,16,14,5,22,3,44,7,1,96,13.714285714285714,1,0.0,8,5,19,3,6,44,3,7,1,35,61,1
2747,89732,pdAqVvKgeCIaihAcxhTXOYjPQxxjaa8K,RXDvfPUBYFlVdlueBFbLW0mhhAyGEqpt,16,29,15,0,8,0,4,0,56,8.0,1,0.0,0,15,0,8,29,0,0,4,0,23,33,1
2748,89751,CFwBanDE4eguHX9lcM62Yx5Bex6437kC,G8EPVSXsOYB5YQWZGiz1aVq5Pgr2GrQu,8,8,3,0,1,0,6,0,18,2.5714285714285716,2,0.0,1,3,0,1,7,0,0,6,0,5,13,0
2749,89756,5NinyROX9yWmUO2bbNeT57UVFrKKhh1e,bWdj2GDclj5ofokWjzoa5jAwMkxCykd6,8,3,2,0,2,7,7,1,22,3.142857142857143,1,0.0,0,2,0,2,3,7,0,7,1,4,18,1
2750,89761,z7RFKPeiml5DwwuxMd7W3zDeb96W3IO0,RXDvfPUBYFlVdlueBFbLW0mhhAyGEqpt,10,6,1,0,0,4,6,1,18,2.5714285714285716,1,0.0,0,1,0,0,6,4,0,6,1,1,17,1
2751,89768,F9x8grjHwXdHsc7U2XmuUJNLu8xnTwnR,bWdj2GDclj5ofokWjzoa5jAwMkxCykd6,6,2,1,0,1,0,3,0,7,1.0,2,0.0,0,1,0,1,2,0,0,3,0,2,5,1
2752,89769,CSJLoVtcCokkcrypV6hcHsBSCZUBCpjE,bWdj2GDclj5ofokWjzoa5jAwMkxCykd6,1,0,0,0,0,0,1,0,1,0.14285714285714285,1,0.0,0,0,0,0,0,0,0,1,0,0,1,1
2753,89790,TY6sQZiKCIo3eegNCTkjQ3fisPy9bRK1,SpATywNh6bZuzm8s1ceuBUnMUAeoAHHw,14,14,6,13,4,0,4,0,41,5.857142857142857,1,0.0,6,6,10,4,8,0,3,4,0,26,15,1
2754,89794,4Veu3UF7DzwSpX1OH30ULcMtQdVZ7ynq,SpATywNh6bZuzm8s1ceuBUnMUAeoAHHw,2,0,0,0,0,0,2,0,2,0.2857142857142857,1,0.0,0,0,0,0,0,0,0,2,0,0,2,1
2755,89803,md5EYhUly1ZvdBwm1DSKfst7q3ukcqZb,G8EPVSXsOYB5YQWZGiz1aVq5Pgr2GrQu,13,5,4,26,1,0,7,0,43,6.142857142857143,1,0.0,0,4,21,1,5,0,5,7,0,26,17,1
2756,89805,aLRP3ahB5SIcOn5vpM1VPEh9ib2QIioX,RXDvfPUBYFlVdlueBFbLW0mhhAyGEqpt,7,7,0,0,0,0,3,0,10,1.4285714285714286,1,0.0,0,0,0,0,7,0,0,3,0,0,10,1
2757,89815,hAvRuLAx7AEDY4wHRae0fvokMiSUSODR,SpATywNh6bZuzm8s1ceuBUnMUAeoAHHw,12,9,5,0,3,1,7,1,26,3.7142857142857144,1,0.0,0,5,0,3,9,1,0,7,1,8,18,1
2758,89820,9q1YIqGYM9tyKLlkxbnN8O6FbjsGmlHe,SpATywNh6bZuzm8s1ceuBUnMUAeoAHHw,12,10,0,6,0,0,4,2,22,3.142857142857143,1,0.0,4,0,6,0,6,0,0,4,2,10,12,1
2759,89821,hOSvBRM2cv2WmjSd4f7WDA9Dp5KsacO1,RXDvfPUBYFlVdlueBFbLW0mhhAyGEqpt,2,0,0,0,0,0,2,0,2,0.2857142857142857,1,0.0,0,0,0,0,0,0,0,2,0,0,2,1
2760,89834,lt4iWOuay8QhJ4JJzXkh1WtUiAfTTub9,G8EPVSXsOYB5YQWZGiz1aVq5Pgr2GrQu,29,39,9,10,8,2,7,1,76,10.857142857142858,2,0.0,12,9,9,8,27,2,1,7,1,38,38,0
2761,89848,aM0OXe9fMQycCDgfZRBso2FFVWDCpMzh,SpATywNh6bZuzm8s1ceuBUnMUAeoAHHw,6,3,2,0,2,0,1,0,8,1.1428571428571428,1,0.0,0,2,0,2,3,0,0,1,0,4,4,1
2762,89860,Hie5jI1V7aqUGyRciLGioIx6C3WNaVxM,SpATywNh6bZuzm8s1ceuBUnMUAeoAHHw,3,2,0,0,0,0,3,0,5,0.7142857142857143,1,0.0,0,0,0,0,2,0,0,3,0,0,5,1
2763,89862,0K4xNLo4N99mMtk7G0MOnorF2w7z0D9v,SpATywNh6bZuzm8s1ceuBUnMUAeoAHHw,7,4,0,0,0,4,4,1,13,1.8571428571428572,1,0.0,0,0,0,0,4,4,0,4,1,0,13,1
2764,89879,MfeGN5negD9kI6SBc6Puji7S43aQKdkb,SpATywNh6bZuzm8s1ceuBUnMUAeoAHHw,12,13,4,11,3,0,1,0,32,4.571428571428571,1,0.0,8,4,10,3,5,0,1,1,0,25,7,1
2765,89882,eCrgnRWcbj9qFyB1Y7Sof16QQaB01Zyn,SpATywNh6bZuzm8s1ceuBUnMUAeoAHHw,5,2,0,0,0,1,6,2,11,1.5714285714285714,1,0.0,0,0,0,0,2,1,0,6,2,0,11,1
2766,89884,V8mzud5EnZ6pyyl8PZ8V5xSQioudW4lS,SpATywNh6bZuzm8s1ceuBUnMUAeoAHHw,17,21,10,28,5,12,17,5,98,14.0,1,0.0,7,10,20,5,14,12,8,17,5,42,56,1
2767,89888,RFyhyx4ydAt8kwrNtnUfQ8908pWCv8M5,SpATywNh6bZuzm8s1ceuBUnMUAeoAHHw,5,2,1,0,1,4,2,0,10,1.4285714285714286,1,0.0,0,1,0,1,2,4,0,2,0,2,8,1
2768,89891,MrptC6k13DRD7ZeJDHvlsVV8mT19fxZF,SpATywNh6bZuzm8s1ceuBUnMUAeoAHHw,15,22,6,22,3,0,6,0,59,8.428571428571429,2,0.0,13,6,17,3,9,0,5,6,0,39,20,1
2769,89894,0aBA3ELzBRvBOUi1HyR68fXgk8gRhEIU,SpATywNh6bZuzm8s1ceuBUnMUAeoAHHw,10,7,4,0,1,1,8,5,26,3.7142857142857144,1,0.0,0,4,0,1,7,1,0,8,5,5,21,1
2770,89904,zOr0niRplBKfkwpPHNykN96u1FhzegfK,RXDvfPUBYFlVdlueBFbLW0mhhAyGEqpt,7,5,4,0,2,0,1,0,12,1.7142857142857142,1,0.0,0,4,0,2,5,0,0,1,0,6,6,1
2771,89905,5a50T7ZMXA2vPYLquN0RqbmeQaCoB8BF,SpATywNh6bZuzm8s1ceuBUnMUAeoAHHw,9,15,3,0,1,1,8,1,29,4.142857142857143,1,0.0,0,3,0,1,15,1,0,8,1,4,25,1
2772,89915,5JgomgwKuM4fVZ9Q4k6YVCtNM8AozehT,G8EPVSXsOYB5YQWZGiz1aVq5Pgr2GrQu,1,0,0,0,0,0,4,0,4,0.5714285714285714,1,0.0,0,0,0,0,0,0,0,4,0,0,4,1
2773,89924,W3ZCbN2PXgpguBAgrApub7dxzAkot7du,G8EPVSXsOYB5YQWZGiz1aVq5Pgr2GrQu,5,2,1,0,1,0,2,0,6,0.8571428571428571,1,0.0,0,1,0,1,2,0,0,2,0,2,4,1
2774,89934,SHyeADEp9dBkknD932WIgfilEMsUK5Yp,SpATywNh6bZuzm8s1ceuBUnMUAeoAHHw,12,18,1,10,0,15,22,2,68,9.714285714285714,3,0.0,0,1,7,0,18,15,3,22,2,8,60,0
2775,89936,PmZJAFj6wJkOD163WkhaJjRHdYOMjBZW,G8EPVSXsOYB5YQWZGiz1aVq5Pgr2GrQu,6,1,1,0,1,0,3,0,6,0.8571428571428571,1,0.0,0,1,0,1,1,0,0,3,0,2,4,1
2776,89949,dumOcYgAwS6Z3oz3fspRWkVIy9xvyAHF,RXDvfPUBYFlVdlueBFbLW0mhhAyGEqpt,18,21,17,0,2,2,5,4,51,7.285714285714286,1,0.0,0,17,0,2,21,2,0,5,4,19,32,0
2777,89958,3nOS3JEH08BgwunQqioyEFfja4qIND4p,RXDvfPUBYFlVdlueBFbLW0mhhAyGEqpt,13,12,10,0,4,2,1,0,29,4.142857142857143,1,0.0,0,10,0,4,12,2,0,1,0,14,15,1
2778,89974,NrKjQ2TY0jNxjlxFQqBMk613jEN7v6dJ,G8EPVSXsOYB5YQWZGiz1aVq5Pgr2GrQu,28,21,1,50,0,7,5,8,92,13.142857142857142,1,0.0,1,1,45,0,20,7,5,5,8,47,45,1
2779,89981,bjtjAbfCAjoDC0dQv8FIuhfAxmQlWFXq,SpATywNh6bZuzm8s1ceuBUnMUAeoAHHw,1,0,0,0,0,0,1,0,1,0.14285714285714285,1,0.0,0,0,0,0,0,0,0,1,0,0,1,1
2780,89989,SkGcRN6XF7Ju1v3VtnK0PLpmtvUvO3VU,SpATywNh6bZuzm8s1ceuBUnMUAeoAHHw,12,10,5,0,4,0,6,1,26,3.7142857142857144,1,0.0,0,5,0,4,10,0,0,6,1,9,17,1
2781,90001,7slcWSRDm7z3xCcURvkPzfUA6HpEf1rv,SpATywNh6bZuzm8s1ceuBUnMUAeoAHHw,13,8,6,0,4,1,11,3,33,4.714285714285714,1,0.0,0,6,0,4,8,1,0,11,3,10,23,1
2782,90007,LSvU72CFq1TrHd9SCZOiKQ0qcV2oa2Ok,bWdj2GDclj5ofokWjzoa5jAwMkxCykd6,6,5,1,0,1,0,3,0,10,1.4285714285714286,2,0.0,0,1,0,1,5,0,0,3,0,2,8,1
2783,90018,bjoQsxzy5xWbIlWJOK88FLxI1KzCehRN,bWdj2GDclj5ofokWjzoa5jAwMkxCykd6,1,0,0,0,0,0,1,0,1,0.14285714285714285,1,0.0,0,0,0,0,0,0,0,1,0,0,1,1
2784,90026,RyilkQdPLBJZ4lFr5oZI0Ei4sfkfiESh,SpATywNh6bZuzm8s1ceuBUnMUAeoAHHw,12,28,19,20,16,0,2,0,85,12.142857142857142,1,0.0,8,19,17,16,20,0,3,2,0,60,25,0
2785,90031,4dfnEKxHCmGabkBCiKHt5nKr3H7Bwo1x,SpATywNh6bZuzm8s1ceuBUnMUAeoAHHw,5,5,1,0,0,0,2,0,8,1.1428571428571428,2,0.0,0,1,0,0,5,0,0,2,0,1,7,0
2786,90036,FSLbHGHYGlPWdXBDC9WjMUDDSGRCqhaq,SpATywNh6bZuzm8s1ceuBUnMUAeoAHHw,5,6,1,0,0,0,1,0,8,1.1428571428571428,1,0.0,0,1,0,0,6,0,0,1,0,1,7,0
2787,90037,vXbuazCIyAq6baj5We5wdO94RIfbomSS,SpATywNh6bZuzm8s1ceuBUnMUAeoAHHw,11,11,7,0,4,0,5,1,28,4.0,1,0.0,0,7,0,4,11,0,0,5,1,11,17,1
2788,90038,fxZYes73ffCsV30TZKy38cwDGRpz9rUn,RXDvfPUBYFlVdlueBFbLW0mhhAyGEqpt,9,9,5,0,0,0,8,1,23,3.2857142857142856,1,0.0,2,5,0,0,7,0,0,8,1,7,16,0
2789,90043,lm5ZaZLPfaDrtGky2mMb4F6wcz9jTJq6,SpATywNh6bZuzm8s1ceuBUnMUAeoAHHw,5,3,1,0,1,0,1,0,6,0.8571428571428571,1,0.0,0,1,0,1,3,0,0,1,0,2,4,1
2790,90046,xAsW6FY0K65CydYHAmfVcUYiwrdudkde,RXDvfPUBYFlVdlueBFbLW0mhhAyGEqpt,12,11,9,0,7,0,1,0,28,4.0,1,0.0,1,9,0,7,10,0,0,1,0,17,11,1
2791,90048,Vn131dD12fh0kapodbBhio0q4dV4IYmG,G8EPVSXsOYB5YQWZGiz1aVq5Pgr2GrQu,4,2,1,0,1,0,1,0,5,0.7142857142857143,1,0.0,0,1,0,1,2,0,0,1,0,2,3,1
2792,90050,zKJi4lYCojHniGlUzfyvIjevdGsHA6Tj,RXDvfPUBYFlVdlueBFbLW0mhhAyGEqpt,1,0,0,0,0,0,1,0,1,0.14285714285714285,1,0.0,0,0,0,0,0,0,0,1,0,0,1,1
2793,90053,Fz2fUb8uF4DthRTOepts8mTN1u7KYtSZ,SpATywNh6bZuzm8s1ceuBUnMUAeoAHHw,10,7,3,0,3,0,5,0,18,2.5714285714285716,1,0.0,0,3,0,3,7,0,0,5,0,6,12,1
2794,90056,JaIi02fnjAZfoUxjYtpyJ7uZYWKdC5yF,bWdj2GDclj5ofokWjzoa5jAwMkxCykd6,10,32,1,52,4,1,6,1,97,13.857142857142858,1,0.0,10,1,50,4,22,1,2,6,1,65,32,1
2795,90058,OFJM9gLiEJFta7GOEBOgZlB17rEajfDQ,G8EPVSXsOYB5YQWZGiz1aVq5Pgr2GrQu,11,4,1,26,1,0,5,0,37,5.285714285714286,1,0.0,1,1,23,1,3,0,3,5,0,26,11,0
2796,90075,K9KQOSU4fRa8yZTo6p3wgevh5IisB83T,RXDvfPUBYFlVdlueBFbLW0mhhAyGEqpt,2,0,0,0,0,0,2,0,2,0.2857142857142857,1,0.0,0,0,0,0,0,0,0,2,0,0,2,1
2797,90095,pplAmbuLk2c8g7K4eYBlhKFfYSpZgbNo,G8EPVSXsOYB5YQWZGiz1aVq5Pgr2GrQu,1,0,0,0,0,0,1,0,1,0.14285714285714285,1,0.0,0,0,0,0,0,0,0,1,0,0,1,1
2798,90102,GN70rVGXob8SU4MUwDOnczNAPbVNEJYJ,SpATywNh6bZuzm8s1ceuBUnMUAeoAHHw,14,17,2,9,1,1,11,2,43,6.142857142857143,2,0.0,0,2,7,1,17,1,2,11,2,10,33,1
2799,90116,T7izEMyckZ14Dpb0HXCCbCEgRCtemG2v,RXDvfPUBYFlVdlueBFbLW0mhhAyGEqpt,18,27,1,0,1,12,9,14,64,9.142857142857142,3,0.0,2,1,0,1,25,12,0,9,14,4,60,1
2800,90121,PD0QXI0Ip2PVwJ6kJaKkkINkj7BvGZMC,bWdj2GDclj5ofokWjzoa5jAwMkxCykd6,8,1,1,0,1,6,5,1,15,2.142857142857143,1,0.0,0,1,0,1,1,6,0,5,1,2,13,1
2801,90124,NlgFEWO87VQbCzq3S6FQjH7bzvdUhuql,bWdj2GDclj5ofokWjzoa5jAwMkxCykd6,10,12,5,44,3,0,6,0,70,10.0,1,0.0,4,5,43,3,8,0,1,6,0,55,15,1
2802,90126,Q1m0mfQJyZWS3bGl8oxr6Sp3MEPl2r6y,RXDvfPUBYFlVdlueBFbLW0mhhAyGEqpt,9,3,2,0,1,2,6,2,16,2.2857142857142856,1,0.0,0,2,0,1,3,2,0,6,2,3,13,1
2803,90127,8inbpMs7MgzODmQl3BpmuUuKMVmeoVgB,RXDvfPUBYFlVdlueBFbLW0mhhAyGEqpt,4,0,0,0,0,0,9,0,9,1.2857142857142858,1,0.0,0,0,0,0,0,0,0,9,0,0,9,1
2804,90129,ErRtUnOkAfZfIgzAYrZFJqhMiEZstwA2,G8EPVSXsOYB5YQWZGiz1aVq5Pgr2GrQu,1,0,0,0,0,0,1,0,1,0.14285714285714285,1,0.0,0,0,0,0,0,0,0,1,0,0,1,1
2805,90133,s1Khmx0UXmesPVY2G1JDbBc7N2AstlLy,bWdj2GDclj5ofokWjzoa5jAwMkxCykd6,1,0,0,0,0,0,1,0,1,0.14285714285714285,1,0.0,0,0,0,0,0,0,0,1,0,0,1,1
2806,90140,jNfz1HF8kGQzQgXHBSG4Wy17SyrpVswM,RXDvfPUBYFlVdlueBFbLW0mhhAyGEqpt,19,30,18,0,12,1,11,1,73,10.428571428571429,1,0.0,0,18,0,12,30,1,0,11,1,30,43,1
2807,90144,clUDzV1xLWOCz6yJz1NXsCWqgZVFuU6d,SpATywNh6bZuzm8s1ceuBUnMUAeoAHHw,5,15,0,0,0,0,4,0,19,2.7142857142857144,1,0.0,0,0,0,0,15,0,0,4,0,0,19,0
2808,90145,vFTyJ5TiVtOMNTDle7WFtHDAgvur1Shs,RXDvfPUBYFlVdlueBFbLW0mhhAyGEqpt,47,42,26,73,18,9,2,0,170,24.285714285714285,1,0.0,11,26,65,18,31,9,8,2,0,120,50,1
2809,90154,pBNN08SB8Xk0wCmBzmhWqayfqNGQdsD0,G8EPVSXsOYB5YQWZGiz1aVq5Pgr2GrQu,5,2,1,0,1,0,3,0,7,1.0,1,0.0,0,1,0,1,2,0,0,3,0,2,5,1
2810,90159,uhbUne0Zqx7l0LKNWrxxR44WistJmxKI,G8EPVSXsOYB5YQWZGiz1aVq5Pgr2GrQu,6,9,1,0,0,0,6,0,16,2.2857142857142856,2,0.0,0,1,0,0,9,0,0,6,0,1,15,1
2811,90163,oSabIe7L5topw6hwV4H4ZV0Ug7ZVNxfV,SpATywNh6bZuzm8s1ceuBUnMUAeoAHHw,4,2,1,0,1,0,2,0,6,0.8571428571428571,1,0.0,0,1,0,1,2,0,0,2,0,2,4,0
2812,90164,EJkZzukbCIAgIlh7QDQUWfa1bYDEcyN6,SpATywNh6bZuzm8s1ceuBUnMUAeoAHHw,6,2,1,0,1,0,3,0,7,1.0,1,0.0,0,1,0,1,2,0,0,3,0,2,5,1
2813,90171,5rZEwm9dIq2r0OGFOO4xuxIdyDM4ihsM,G8EPVSXsOYB5YQWZGiz1aVq5Pgr2GrQu,4,3,0,0,0,0,4,0,7,1.0,1,0.0,0,0,0,0,3,0,0,4,0,0,7,1
2814,90181,dtnFILXxHCPYki6VgARxaWrGiWunvtDQ,bWdj2GDclj5ofokWjzoa5jAwMkxCykd6,3,3,0,0,0,0,1,0,4,0.5714285714285714,1,0.0,0,0,0,0,3,0,0,1,0,0,4,1
2815,90186,BizISzUat4hEvOv57S0DwyJf8vib0NUf,G8EPVSXsOYB5YQWZGiz1aVq5Pgr2GrQu,17,25,13,22,9,0,6,0,75,10.714285714285714,2,0.0,10,13,15,9,15,0,7,6,0,47,28,1
2816,90191,rb0bCeAP0PjUKM6QZmb5eDbdcmhSPRHl,bWdj2GDclj5ofokWjzoa5jAwMkxCykd6,1,0,0,0,0,0,1,0,1,0.14285714285714285,1,0.0,0,0,0,0,0,0,0,1,0,0,1,1
2817,90193,8DMqMykxY7va5LQM1D9Brc3KIasQ5uaX,SpATywNh6bZuzm8s1ceuBUnMUAeoAHHw,9,5,2,0,1,1,5,1,15,2.142857142857143,1,0.0,2,2,0,1,3,1,0,5,1,5,10,1
2818,90195,kS1KejA8lXABafXOlB6Mjw2acU9s1o0J,G8EPVSXsOYB5YQWZGiz1aVq5Pgr2GrQu,9,5,4,0,3,0,1,0,13,1.8571428571428572,2,0.0,0,4,0,3,5,0,0,1,0,7,6,1
2819,90197,W0qiE6YA9tIRl3nKsDWz4QDyI0fyNkAl,G8EPVSXsOYB5YQWZGiz1aVq5Pgr2GrQu,5,7,1,2,2,0,1,0,13,1.8571428571428572,1,0.0,5,1,1,2,2,0,1,1,0,9,4,1
2820,90198,EfKEF8uyLDaJrFfOiyHDnHogAmFLFMEz,SpATywNh6bZuzm8s1ceuBUnMUAeoAHHw,16,18,8,21,5,4,6,0,62,8.857142857142858,1,0.0,8,8,17,5,10,4,4,6,0,38,24,1
2821,90202,mb1hbQ7DEVC7kPqNe1ZOaERjsdGO9KG6,SpATywNh6bZuzm8s1ceuBUnMUAeoAHHw,6,1,1,0,1,0,3,0,6,0.8571428571428571,1,0.0,0,1,0,1,1,0,0,3,0,2,4,1
2822,90204,iwXjEgqbyIO3u8ruP2aohYqr4OGu36oj,bWdj2GDclj5ofokWjzoa5jAwMkxCykd6,1,0,0,0,0,0,1,0,1,0.14285714285714285,1,0.0,0,0,0,0,0,0,0,1,0,0,1,1
2823,90205,CDMI3gQZrAOAZ9Cf4jB5NzA4daPYwjjn,RXDvfPUBYFlVdlueBFbLW0mhhAyGEqpt,45,20,12,77,8,2,6,12,137,19.571428571428573,1,0.0,7,12,70,8,13,2,7,6,12,97,40,1
2824,90208,1oBn81XXDSWJtnCZIRPmhZcBWe7qP0iB,bWdj2GDclj5ofokWjzoa5jAwMkxCykd6,15,19,9,30,4,0,5,0,67,9.571428571428571,1,0.0,5,9,28,4,14,0,2,5,0,46,21,1
2825,90210,J3voZmUSvdysAYoBmB8pkqxDgJNK9RLm,SpATywNh6bZuzm8s1ceuBUnMUAeoAHHw,10,8,4,0,3,0,5,0,20,2.857142857142857,1,0.0,1,4,0,3,7,0,0,5,0,8,12,1
2826,90212,Kc2ZLOGfjK9xNvMUO1HfN3eAcuOUNA78,bWdj2GDclj5ofokWjzoa5jAwMkxCykd6,4,2,1,0,1,0,1,0,5,0.7142857142857143,1,0.0,0,1,0,1,2,0,0,1,0,2,3,0
2827,90213,flscvDNEOPPNPzScLBbNDP0ZzEaAlrV7,SpATywNh6bZuzm8s1ceuBUnMUAeoAHHw,3,2,1,0,0,0,1,0,4,0.5714285714285714,1,0.0,0,1,0,0,2,0,0,1,0,1,3,1
2828,90216,2YneJEOhCqieo20wPFwWEVhM7PP0cUkK,SpATywNh6bZuzm8s1ceuBUnMUAeoAHHw,6,5,2,0,1,0,3,0,11,1.5714285714285714,1,0.0,0,2,0,1,5,0,0,3,0,3,8,1
2829,90231,5rZEwm9dIq2r0OGFOO4xuxIdyDM4ihsM,SpATywNh6bZuzm8s1ceuBUnMUAeoAHHw,6,3,1,0,1,0,4,0,9,1.2857142857142858,1,0.0,0,1,0,1,3,0,0,4,0,2,7,1
2830,90234,TWBh4mQwoOKN7YTAA8WBkn32Y1dNu7yV,SpATywNh6bZuzm8s1ceuBUnMUAeoAHHw,3,3,1,0,0,0,1,0,5,0.7142857142857143,1,0.0,0,1,0,0,3,0,0,1,0,1,4,1
2831,90236,MqKzIfAUNs7agMDut61Vb2gr4UeXiv4L,SpATywNh6bZuzm8s1ceuBUnMUAeoAHHw,14,13,4,18,3,4,4,0,46,6.571428571428571,1,0.0,8,4,16,3,5,4,2,4,0,31,15,1
2832,90237,RkMMgfrDoCy0k6xciXBqfQqum2o9XEow,bWdj2GDclj5ofokWjzoa5jAwMkxCykd6,8,9,5,0,1,2,10,0,27,3.857142857142857,2,0.0,0,5,0,1,9,2,0,10,0,6,21,0
2833,90243,ufAesqkQpYzEnUzTTmFCVE5lhPwgEzNz,bWdj2GDclj5ofokWjzoa5jAwMkxCykd6,7,4,1,0,1,2,4,1,13,1.8571428571428572,1,0.0,1,1,0,1,3,2,0,4,1,3,10,1
2834,90257,ZPbUovw1YoDeaWUVrbGEj5A5WdIXTYjf,bWdj2GDclj5ofokWjzoa5jAwMkxCykd6,5,2,1,0,1,0,2,0,6,0.8571428571428571,1,0.0,0,1,0,1,2,0,0,2,0,2,4,1
2835,90264,SFTx34tVIUz5DNNfU98ofZLPwnaVsmDt,bWdj2GDclj5ofokWjzoa5jAwMkxCykd6,2,0,0,0,0,0,4,0,4,0.5714285714285714,1,0.0,0,0,0,0,0,0,0,4,0,0,4,1
2836,90265,BjHFvQWQadfUNfwyKUemgxPvpTYl6Oeu,SpATywNh6bZuzm8s1ceuBUnMUAeoAHHw,16,25,9,16,4,0,11,0,65,9.285714285714286,2,0.0,7,9,15,4,18,0,1,11,0,35,30,1
2837,90273,1A7feF5h8rReJF4PIjze7GoTvueVZhno,bWdj2GDclj5ofokWjzoa5jAwMkxCykd6,2,0,0,0,0,0,3,0,3,0.42857142857142855,1,0.0,0,0,0,0,0,0,0,3,0,0,3,1
2838,90281,0nJUVE3hT3v1fqbd9NpHDszm9KS6NNTn,SpATywNh6bZuzm8s1ceuBUnMUAeoAHHw,12,15,11,0,4,2,10,0,42,6.0,3,0.0,0,11,0,4,15,2,0,10,0,15,27,1
2839,90284,fhq6eq9rBvb40aWEwDCQV6m3MUswh0wF,SpATywNh6bZuzm8s1ceuBUnMUAeoAHHw,6,4,2,1,1,0,2,0,10,1.4285714285714286,1,0.0,1,2,1,1,3,0,0,2,0,5,5,1
2840,90299,iysEaAaeQU9ULnAIVWQxyonskhHfsgrB,bWdj2GDclj5ofokWjzoa5jAwMkxCykd6,1,0,0,0,0,0,1,0,1,0.14285714285714285,1,0.0,0,0,0,0,0,0,0,1,0,0,1,1
2841,90300,5w7iVX59M3R4nFK1Ak0et8WYZIQEnE4r,SpATywNh6bZuzm8s1ceuBUnMUAeoAHHw,5,4,1,0,1,1,8,0,15,2.142857142857143,3,0.0,2,1,0,1,2,1,0,8,0,4,11,1
2842,90301,nNRUhTxrQUyQlj0B4LUbcGCoMBsVhXak,SpATywNh6bZuzm8s1ceuBUnMUAeoAHHw,15,41,14,21,4,2,8,3,93,13.285714285714286,1,0.0,16,14,18,4,25,2,3,8,3,52,41,1
2843,90307,YSoWzxWxgklu4RCnOacbfcJC3S3J8kdF,bWdj2GDclj5ofokWjzoa5jAwMkxCykd6,4,2,1,0,0,0,2,0,5,0.7142857142857143,1,0.0,0,1,0,0,2,0,0,2,0,1,4,1
2844,90308,mf7XL5Qu5rUTCHBZ2HgPEiHdci32GQxj,SpATywNh6bZuzm8s1ceuBUnMUAeoAHHw,5,2,1,0,1,0,2,0,6,0.8571428571428571,1,0.0,0,1,0,1,2,0,0,2,0,2,4,1
2845,90319,BnT6Uo8UffnhlvQEwsGCaHRftIbYh6of,SpATywNh6bZuzm8s1ceuBUnMUAeoAHHw,9,13,5,0,3,0,2,0,23,3.2857142857142856,1,0.0,2,5,0,3,11,0,0,2,0,10,13,1
2846,90322,xnhot3CAENInz6vjTxOmSNIIldllQEtz,bWdj2GDclj5ofokWjzoa5jAwMkxCykd6,4,2,1,0,1,0,1,0,5,0.7142857142857143,1,0.0,0,1,0,1,2,0,0,1,0,2,3,1
2847,90328,ytG2DdLhfkfx34dUnTrzjRTBamVwR6Tt,G8EPVSXsOYB5YQWZGiz1aVq5Pgr2GrQu,4,2,0,0,0,0,2,0,4,0.5714285714285714,1,0.0,0,0,0,0,2,0,0,2,0,0,4,1
2848,90331,gSg4PIaWl0hBhOgVlpN9o8YrQn4pTOeq,RXDvfPUBYFlVdlueBFbLW0mhhAyGEqpt,3,0,0,0,0,9,2,0,11,1.5714285714285714,2,0.0,0,0,0,0,0,9,0,2,0,0,11,0
2849,90334,gSg4PIaWl0hBhOgVlpN9o8YrQn4pTOeq,bWdj2GDclj5ofokWjzoa5jAwMkxCykd6,5,2,1,0,1,0,2,0,6,0.8571428571428571,2,0.0,0,1,0,1,2,0,0,2,0,2,4,0
2850,90338,FniFp3wFmWOPWRnBcExVHfzUs5yEbBTd,G8EPVSXsOYB5YQWZGiz1aVq5Pgr2GrQu,1,0,0,0,0,0,1,0,1,0.14285714285714285,1,0.0,0,0,0,0,0,0,0,1,0,0,1,1
2851,90341,MSmZzIC0hTqFynGLQ4hbcd9aVVVROmvE,RXDvfPUBYFlVdlueBFbLW0mhhAyGEqpt,43,22,14,95,7,22,3,4,167,23.857142857142858,1,0.0,7,14,88,7,15,22,7,3,4,116,51,1
2852,90363,4GMbKnTV7f2uA3paM09GNAdyVnypDTbs,bWdj2GDclj5ofokWjzoa5jAwMkxCykd6,7,1,1,0,1,0,10,0,13,1.8571428571428572,1,0.0,0,1,0,1,1,0,0,10,0,2,11,1
2853,90365,XnbCTPxDHPmE6f3SM7gG3S4zRIik2pF4,SpATywNh6bZuzm8s1ceuBUnMUAeoAHHw,1,0,0,0,0,0,1,0,1,0.14285714285714285,1,0.0,0,0,0,0,0,0,0,1,0,0,1,1
2854,90368,aVj2n54Hek70fJUdNTLLf71YkfuWdwdm,bWdj2GDclj5ofokWjzoa5jAwMkxCykd6,7,12,5,0,5,0,4,0,26,3.7142857142857144,2,0.0,2,5,0,5,10,0,0,4,0,12,14,1
2855,90370,1cbn6mbdbvkgaRHmtNkyztYkaJcKUMeq,bWdj2GDclj5ofokWjzoa5jAwMkxCykd6,15,15,7,50,4,0,6,0,82,11.714285714285714,2,0.0,4,7,44,4,11,0,6,6,0,59,23,0
2856,90384,HOZheAyAGMSpb5Rm4jAeFCDd0CkpsnTU,SpATywNh6bZuzm8s1ceuBUnMUAeoAHHw,13,30,0,22,0,100,18,0,170,24.285714285714285,4,0.0,15,0,21,0,15,100,1,18,0,36,134,1
2857,90388,af1GfUKSTAzLFQRgO3DNnNJQEXmJbieP,SpATywNh6bZuzm8s1ceuBUnMUAeoAHHw,15,16,4,13,3,0,6,0,42,6.0,1,0.0,10,4,12,3,6,0,1,6,0,29,13,0
2858,90390,gZ5Dz1At6qO7ZUvRyINA6LQ2UEYea4Ji,SpATywNh6bZuzm8s1ceuBUnMUAeoAHHw,4,2,1,0,0,0,2,0,5,0.7142857142857143,1,0.0,0,1,0,0,2,0,0,2,0,1,4,0
2859,90398,U4FGCuNkJ0sAAh4fnj0EDvRbz5l6NaeB,RXDvfPUBYFlVdlueBFbLW0mhhAyGEqpt,5,4,1,0,1,0,1,0,7,1.0,1,0.0,0,1,0,1,4,0,0,1,0,2,5,1
2860,90401,U8woUOpngQnqlgGzBG9Q1wRVWIkAfJH5,bWdj2GDclj5ofokWjzoa5jAwMkxCykd6,7,15,0,0,0,0,7,0,22,3.142857142857143,3,0.0,0,0,0,0,15,0,0,7,0,0,22,0
2861,90406,eAZCjo0LfDvIGTflBEZPo5MmANUFycim,G8EPVSXsOYB5YQWZGiz1aVq5Pgr2GrQu,1,0,0,0,0,0,1,0,1,0.14285714285714285,1,0.0,0,0,0,0,0,0,0,1,0,0,1,1
2862,90415,ZYv52Mbq7iLq8T3oy7c5ln6ts5h7dtMY,bWdj2GDclj5ofokWjzoa5jAwMkxCykd6,2,0,0,0,0,0,2,0,2,0.2857142857142857,1,0.0,0,0,0,0,0,0,0,2,0,0,2,1
2863,90424,DtwqebReG8Q4J8W1z8GMg58bM2jjZyjN,SpATywNh6bZuzm8s1ceuBUnMUAeoAHHw,5,2,0,0,0,0,3,0,5,0.7142857142857143,1,0.0,0,0,0,0,2,0,0,3,0,0,5,1
2864,90427,MffUlJKjo94UllFioq799jfMhgBUKfBS,RXDvfPUBYFlVdlueBFbLW0mhhAyGEqpt,22,18,11,29,8,0,2,0,68,9.714285714285714,1,0.0,5,11,27,8,13,0,2,2,0,51,17,1
2865,90434,ajSnZNRHXRc8Lp3Apzl9jhBHJ93vaNPi,SpATywNh6bZuzm8s1ceuBUnMUAeoAHHw,8,6,1,0,1,14,5,0,27,3.857142857142857,1,0.0,0,1,0,1,6,14,0,5,0,2,25,1
2866,90438,h70SV9keTNnvlQQ1p9K83AbbtQXt9ALt,SpATywNh6bZuzm8s1ceuBUnMUAeoAHHw,11,18,12,0,9,0,7,0,46,6.571428571428571,1,0.0,4,12,0,9,14,0,0,7,0,25,21,1
2867,90441,QJPLyO9GsNSTHpL4UletoFcKnrwBbT1T,SpATywNh6bZuzm8s1ceuBUnMUAeoAHHw,15,27,13,23,6,0,3,0,72,10.285714285714286,2,0.0,10,13,18,6,17,0,5,3,0,47,25,1
2868,90447,SF4fH5sh7kP5eYY1hHp8Un6FMFdPAYUn,RXDvfPUBYFlVdlueBFbLW0mhhAyGEqpt,15,14,11,0,3,4,6,2,40,5.714285714285714,1,0.0,0,11,0,3,14,4,0,6,2,14,26,1
2869,90465,ZJZvmc4yPSLW7LhJST5KGAXq34PSa4bN,SpATywNh6bZuzm8s1ceuBUnMUAeoAHHw,9,6,4,0,2,1,5,1,19,2.7142857142857144,1,0.0,1,4,0,2,5,1,0,5,1,7,12,1
2870,90475,nA22SpKv9tvgwIZ0mm2k7ziqx1NGMQHb,SpATywNh6bZuzm8s1ceuBUnMUAeoAHHw,4,1,0,0,0,0,5,0,6,0.8571428571428571,1,0.0,0,0,0,0,1,0,0,5,0,0,6,1
2871,90476,Pr9ourxtng5DzY47on8h7xABMdbE3A0L,SpATywNh6bZuzm8s1ceuBUnMUAeoAHHw,2,0,0,0,0,0,2,0,2,0.2857142857142857,1,0.0,0,0,0,0,0,0,0,2,0,0,2,1
2872,90481,8cTpnP5XMC7urAa32DMaQfZt2CABz0xm,SpATywNh6bZuzm8s1ceuBUnMUAeoAHHw,2,0,0,0,0,0,2,0,2,0.2857142857142857,1,0.0,0,0,0,0,0,0,0,2,0,0,2,1
2873,90496,Xs5JYGOD3p8qnunCvDbRtmUT4YrLSZAt,G8EPVSXsOYB5YQWZGiz1aVq5Pgr2GrQu,2,0,0,0,0,0,2,0,2,0.2857142857142857,1,0.0,0,0,0,0,0,0,0,2,0,0,2,1
2874,90505,GQ6O8zYgypKOWgEHgpHaUgffzhyPlA4a,SpATywNh6bZuzm8s1ceuBUnMUAeoAHHw,11,23,9,0,5,0,10,0,47,6.714285714285714,2,0.0,0,9,0,5,23,0,0,10,0,14,33,1
2875,90509,6DhqODqzoN3QpHDTGOfm1J0Z2tXsvw8Q,RXDvfPUBYFlVdlueBFbLW0mhhAyGEqpt,11,9,5,0,1,1,6,1,23,3.2857142857142856,1,0.0,2,5,0,1,7,1,0,6,1,8,15,1
2876,90510,RI0pRWsSeNWCFuNbvYcUkrnZSxgLkzXM,G8EPVSXsOYB5YQWZGiz1aVq5Pgr2GrQu,4,2,1,0,1,0,1,0,5,0.7142857142857143,1,0.0,0,1,0,1,2,0,0,1,0,2,3,1
2877,90512,v5nYdsvl6GCjyW7kGrOo9PXd3XM536ac,bWdj2GDclj5ofokWjzoa5jAwMkxCykd6,8,7,3,36,3,0,1,0,50,7.142857142857143,1,0.0,3,3,36,3,4,0,0,1,0,45,5,1
2878,90522,SrT5cEoKhuuDcaYDitYZtr8rudf3aNHn,RXDvfPUBYFlVdlueBFbLW0mhhAyGEqpt,5,3,0,0,0,1,2,0,6,0.8571428571428571,1,0.0,0,0,0,0,3,1,0,2,0,0,6,1
2879,90533,979T9akr0rVByN7anKgrxGgT1cwuQ4G0,bWdj2GDclj5ofokWjzoa5jAwMkxCykd6,1,0,0,0,0,0,2,0,2,0.2857142857142857,1,0.0,0,0,0,0,0,0,0,2,0,0,2,1
2880,90536,87BoPwsFRJc93Ed9Le7qjm6Wu8pcwGb4,SpATywNh6bZuzm8s1ceuBUnMUAeoAHHw,14,13,8,15,5,0,7,0,48,6.857142857142857,1,0.0,4,8,12,5,9,0,3,7,0,29,19,1
2881,90541,f3Or6Lei7Xsh5kVuWwAXKtVQvHetVASw,SpATywNh6bZuzm8s1ceuBUnMUAeoAHHw,7,2,1,0,1,0,7,1,12,1.7142857142857142,1,0.0,0,1,0,1,2,0,0,7,1,2,10,1
2882,90542,oBmksukoqTKiKpWhco7hv7dHpVNhiTm0,RXDvfPUBYFlVdlueBFbLW0mhhAyGEqpt,2,0,0,0,0,0,2,0,2,0.2857142857142857,1,0.0,0,0,0,0,0,0,0,2,0,0,2,1
2883,90544,Wn0YHSgI2frE5VS0ME4PMnw7OIRxxODE,bWdj2GDclj5ofokWjzoa5jAwMkxCykd6,14,12,6,32,5,0,4,0,59,8.428571428571429,1,0.0,4,6,32,5,8,0,0,4,0,47,12,1
2884,90552,isJvm2sBgrZmIVBqIVzAr4eLhAZMDuWI,SpATywNh6bZuzm8s1ceuBUnMUAeoAHHw,2,0,0,0,0,4,1,0,5,0.7142857142857143,1,0.0,0,0,0,0,0,4,0,1,0,0,5,1
2885,90555,tn5nSlJLNdxx4Uni5Dn3S8nwDR8GJibq,bWdj2GDclj5ofokWjzoa5jAwMkxCykd6,20,41,21,114,10,16,15,2,219,31.285714285714285,3,0.0,7,21,109,10,34,16,5,15,2,147,72,1
2886,90557,86vaLs6Psnmr3RZvUAsRR8mS9F0SSYDy,RXDvfPUBYFlVdlueBFbLW0mhhAyGEqpt,1,0,0,0,0,0,1,0,1,0.14285714285714285,1,0.0,0,0,0,0,0,0,0,1,0,0,1,1
2887,90561,zoNJrqU9R3rbwqXOfdPMHYJWQ1mfYn8B,SpATywNh6bZuzm8s1ceuBUnMUAeoAHHw,9,6,3,0,3,0,4,0,16,2.2857142857142856,1,0.0,0,3,0,3,6,0,0,4,0,6,10,1
2888,90573,mnrOB2joseu3XXqZgB40ASUizDwax7xs,SpATywNh6bZuzm8s1ceuBUnMUAeoAHHw,16,23,7,22,4,1,9,0,66,9.428571428571429,1,0.0,12,7,18,4,11,1,4,9,0,41,25,1
2889,90574,SaJRa20OXDY1LCrTPWwAL4qw1OJoFlxd,SpATywNh6bZuzm8s1ceuBUnMUAeoAHHw,2,0,0,0,0,0,2,0,2,0.2857142857142857,1,0.0,0,0,0,0,0,0,0,2,0,0,2,1
2890,90580,lk8VGt0yosXmu7XbHzsqLBKwzzzp9GK0,SpATywNh6bZuzm8s1ceuBUnMUAeoAHHw,5,3,1,0,0,5,6,0,15,2.142857142857143,1,0.0,0,1,0,0,3,5,0,6,0,1,14,1
2891,90587,LdmiXWzPIjxgi3vXfrG7UNuf9aR1t25A,G8EPVSXsOYB5YQWZGiz1aVq5Pgr2GrQu,2,0,0,0,0,1,1,0,2,0.2857142857142857,1,0.0,0,0,0,0,0,1,0,1,0,0,2,1
2892,90591,dVnTQl9ANUhHsXIPIWBdmTgLVkOgcfeV,SpATywNh6bZuzm8s1ceuBUnMUAeoAHHw,8,5,0,0,0,1,6,1,13,1.8571428571428572,1,0.0,0,0,0,0,5,1,0,6,1,0,13,1
2893,90601,OA2ppL3NBxQQN7UDC41vrrAGRoypzEU8,SpATywNh6bZuzm8s1ceuBUnMUAeoAHHw,6,2,1,0,1,0,4,0,8,1.1428571428571428,1,0.0,0,1,0,1,2,0,0,4,0,2,6,1
2894,90602,OCAzb1VfLGBRFoguhxZLxVaO4EgntnGi,bWdj2GDclj5ofokWjzoa5jAwMkxCykd6,1,0,0,0,0,0,1,0,1,0.14285714285714285,1,0.0,0,0,0,0,0,0,0,1,0,0,1,1
2895,90606,k0hnEE00KysC1NJbTPcs2Jo2pXfE8XJY,RXDvfPUBYFlVdlueBFbLW0mhhAyGEqpt,8,6,1,0,1,0,3,0,11,1.5714285714285714,1,0.0,0,1,0,1,6,0,0,3,0,2,9,1
2896,90615,YfZkWYeVjjwTERIBF4VpFk8mjgVdzlCM,SpATywNh6bZuzm8s1ceuBUnMUAeoAHHw,9,7,4,0,1,5,14,1,32,4.571428571428571,1,0.0,0,4,0,1,7,5,0,14,1,5,27,1
2897,90621,RX2I20RYdT3gZCbZOCxQyWjgnFxuLLo0,SpATywNh6bZuzm8s1ceuBUnMUAeoAHHw,6,3,2,0,2,0,1,0,8,1.1428571428571428,1,0.0,0,2,0,2,3,0,0,1,0,4,4,1
2898,90623,yZoviGGxgr5NFf9klHeC5PfXfdVd14QP,bWdj2GDclj5ofokWjzoa5jAwMkxCykd6,11,9,6,0,4,0,9,0,28,4.0,3,0.0,0,6,0,4,9,0,0,9,0,10,18,1
2899,90626,mYdiJuyvQQSE4J489nl9NbGaNmN8t5fJ,SpATywNh6bZuzm8s1ceuBUnMUAeoAHHw,5,3,1,0,1,0,1,0,6,0.8571428571428571,1,0.0,0,1,0,1,3,0,0,1,0,2,4,1
2900,90629,7y90Jaoh9A6ecz0W5HFrSOzo0GUJhND0,bWdj2GDclj5ofokWjzoa5jAwMkxCykd6,5,3,1,0,0,1,4,0,9,1.2857142857142858,1,0.0,0,1,0,0,3,1,0,4,0,1,8,1
2901,90633,gIghghMxU1G3VEKF49uuB975s41nqI8g,SpATywNh6bZuzm8s1ceuBUnMUAeoAHHw,16,20,11,14,5,13,7,0,70,10.0,2,0.0,6,11,13,5,14,13,1,7,0,35,35,0
2902,90646,yZoviGGxgr5NFf9klHeC5PfXfdVd14QP,RXDvfPUBYFlVdlueBFbLW0mhhAyGEqpt,13,7,6,0,4,0,2,0,19,2.7142857142857144,1,0.0,0,6,0,4,7,0,0,2,0,10,9,1
2903,90648,Ct4CYJV4ldK3GNAcCiI1V5iy769QQWR5,RXDvfPUBYFlVdlueBFbLW0mhhAyGEqpt,8,16,0,0,0,0,5,0,21,3.0,1,0.0,3,0,0,0,13,0,0,5,0,3,18,1
2904,90651,4vJSIQ5zmHwvN98SbnaURZ3kwY3XSM5D,SpATywNh6bZuzm8s1ceuBUnMUAeoAHHw,1,0,0,0,0,0,1,0,1,0.14285714285714285,1,0.0,0,0,0,0,0,0,0,1,0,0,1,1
2905,90654,bA5X6ch4ADNfhanzi2mM69bwbihODbQ4,G8EPVSXsOYB5YQWZGiz1aVq5Pgr2GrQu,63,98,30,154,10,8,7,1,308,44.0,1,0.0,63,30,115,10,35,8,39,7,1,218,90,0
2906,90659,07a6x7KN30qug4fofBdEl2HySgB5YdgR,bWdj2GDclj5ofokWjzoa5jAwMkxCykd6,5,5,2,0,1,0,2,0,10,1.4285714285714286,2,0.0,0,2,0,1,5,0,0,2,0,3,7,1
2907,90660,YUNLPiSOifGnuGgTqdDXRMjnI0RJBa0e,bWdj2GDclj5ofokWjzoa5jAwMkxCykd6,10,11,6,0,4,3,9,0,33,4.714285714285714,1,0.0,2,6,0,4,9,3,0,9,0,12,21,1
2908,90667,XFmrH2WQYMYLXRE1Jm7VValFt236PUJr,G8EPVSXsOYB5YQWZGiz1aVq5Pgr2GrQu,10,13,1,10,1,0,1,0,26,3.7142857142857144,1,0.0,8,1,6,1,5,0,4,1,0,16,10,1
2909,90684,gBZJD6jZRMZdZxyaZgCjGPROu8WcWTne,G8EPVSXsOYB5YQWZGiz1aVq5Pgr2GrQu,13,25,10,8,8,17,6,2,76,10.857142857142858,1,0.0,12,10,6,8,13,17,2,6,2,36,40,0
2910,90686,tKsi1lDahv8YDRhfKnuEFzTSYneTazEo,RXDvfPUBYFlVdlueBFbLW0mhhAyGEqpt,10,9,5,0,5,3,4,0,26,3.7142857142857144,1,0.0,0,5,0,5,9,3,0,4,0,10,16,1
2911,90688,j8vYdYwa9gvt7hkF8dykZR2D4h75QsII,RXDvfPUBYFlVdlueBFbLW0mhhAyGEqpt,20,16,14,0,5,2,10,3,50,7.142857142857143,3,0.0,0,14,0,5,16,2,0,10,3,19,31,1
2912,90699,tKsi1lDahv8YDRhfKnuEFzTSYneTazEo,SpATywNh6bZuzm8s1ceuBUnMUAeoAHHw,4,1,1,0,1,0,1,0,4,0.5714285714285714,1,0.0,0,1,0,1,1,0,0,1,0,2,2,1
2913,90704,84Ouo0RSw7BvmNUER147KiTqxaHgRaR6,SpATywNh6bZuzm8s1ceuBUnMUAeoAHHw,7,5,3,0,2,0,6,0,16,2.2857142857142856,2,0.0,0,3,0,2,5,0,0,6,0,5,11,1
2914,90710,7fC3V6ivG07wUIMOmiYFzSlyjWvbYnYf,RXDvfPUBYFlVdlueBFbLW0mhhAyGEqpt,11,10,0,0,0,4,5,0,19,2.7142857142857144,1,0.0,0,0,0,0,10,4,0,5,0,0,19,0
2915,90715,BJT6wOznqaiCipmbeEqX4tC1TuhKxC7c,SpATywNh6bZuzm8s1ceuBUnMUAeoAHHw,14,34,14,0,6,3,13,1,71,10.142857142857142,3,0.0,3,14,0,6,31,3,0,13,1,23,48,1
2916,90717,Vmvdv9k8S1ONPkUHSdXPEenyx7UNVISW,bWdj2GDclj5ofokWjzoa5jAwMkxCykd6,19,35,4,68,2,50,18,2,179,25.571428571428573,4,0.0,8,4,61,2,27,50,7,18,2,75,104,1
2917,90719,5KhUU1d5DOX9YzVEFt1mBdZffexByyEY,SpATywNh6bZuzm8s1ceuBUnMUAeoAHHw,13,8,6,0,4,0,6,2,26,3.7142857142857144,1,0.0,0,6,0,4,8,0,0,6,2,10,16,1
2918,90724,5vkNIYp2bYY1LtZU7tLxethQegJYgNo1,bWdj2GDclj5ofokWjzoa5jAwMkxCykd6,14,10,5,74,3,0,7,0,99,14.142857142857142,2,0.0,3,5,69,3,7,0,5,7,0,80,19,1
2919,90731,Kq1HFxeACwjg0zmXbvWkQZ7IB9SIFprl,G8EPVSXsOYB5YQWZGiz1aVq5Pgr2GrQu,14,9,7,0,4,1,7,1,29,4.142857142857143,1,0.0,0,7,0,4,9,1,0,7,1,11,18,1
2920,90734,lHTZAvBbd0zcUoZ0ZCqy0WxYTp3sveXN,RXDvfPUBYFlVdlueBFbLW0mhhAyGEqpt,12,14,3,0,3,2,6,1,29,4.142857142857143,2,0.0,4,3,0,3,10,2,0,6,1,10,19,1
2921,90738,GvWa7qIm5RkYdVcaG192SG5MlRfjDYSk,SpATywNh6bZuzm8s1ceuBUnMUAeoAHHw,5,1,1,0,1,0,2,0,5,0.7142857142857143,1,0.0,0,1,0,1,1,0,0,2,0,2,3,1
2922,90744,2viub6InFwMLthqb8hJjmGF9NgF8w6Xs,bWdj2GDclj5ofokWjzoa5jAwMkxCykd6,4,9,3,0,2,0,1,0,15,2.142857142857143,3,0.0,0,3,0,2,9,0,0,1,0,5,10,1
2923,90745,3VPAWlfwG5nkf9ioSIdd0yq9SoYaPOsq,bWdj2GDclj5ofokWjzoa5jAwMkxCykd6,3,2,0,0,0,0,1,0,3,0.42857142857142855,1,0.0,0,0,0,0,2,0,0,1,0,0,3,1
2924,90751,LrnqEdfBj0D0yEwqlIwYFq7gG4yeMv2F,SpATywNh6bZuzm8s1ceuBUnMUAeoAHHw,12,26,9,19,3,1,5,0,63,9.0,1,0.0,15,9,17,3,11,1,2,5,0,44,19,1
2925,90759,ap9egrEAtqnjEf8GN2Q0V7LnZMXCwsuh,RXDvfPUBYFlVdlueBFbLW0mhhAyGEqpt,9,8,5,0,2,9,4,0,28,4.0,2,0.0,0,5,0,2,8,9,0,4,0,7,21,1
2926,90763,KLWMzt2lbmi8onKYKX9eWLl5lpM0wx0M,SpATywNh6bZuzm8s1ceuBUnMUAeoAHHw,3,2,1,0,0,0,2,0,5,0.7142857142857143,1,0.0,0,1,0,0,2,0,0,2,0,1,4,1
2927,90766,ypPkmbHBKQqVHaDjkpbJ8CKEoLgDbQlR,SpATywNh6bZuzm8s1ceuBUnMUAeoAHHw,6,3,1,0,1,0,3,0,8,1.1428571428571428,1,0.0,0,1,0,1,3,0,0,3,0,2,6,1
2928,90783,bpxaFadaQixJuWRVtAAq5miKiBM3zC6u,RXDvfPUBYFlVdlueBFbLW0mhhAyGEqpt,1,0,0,0,0,0,1,0,1,0.14285714285714285,1,0.0,0,0,0,0,0,0,0,1,0,0,1,1
2929,90793,5yUesVpQg6VbfIA01sOzitb9Qf8no8xc,bWdj2GDclj5ofokWjzoa5jAwMkxCykd6,4,2,1,0,1,0,1,0,5,0.7142857142857143,1,0.0,0,1,0,1,2,0,0,1,0,2,3,1
2930,90797,xkhW0o7SPQFIOs4D7mnb6RH3kX3k2QhW,SpATywNh6bZuzm8s1ceuBUnMUAeoAHHw,6,2,0,0,0,0,5,0,7,1.0,1,0.0,0,0,0,0,2,0,0,5,0,0,7,1
2931,90798,V95Tt6b4Z06nKuvQsXC9kpbsyH3YIGk4,SpATywNh6bZuzm8s1ceuBUnMUAeoAHHw,3,2,0,0,0,6,1,0,9,1.2857142857142858,1,0.0,0,0,0,0,2,6,0,1,0,0,9,1
2932,90807,DYC2TKuAWipp9UNJIdqFLJgrkLj9mdOD,SpATywNh6bZuzm8s1ceuBUnMUAeoAHHw,17,36,12,16,4,7,23,6,104,14.857142857142858,3,0.0,12,12,13,4,24,7,3,23,6,41,63,0
2933,90814,EzH5vTFvKXPmDbmZZs9qDP4fhOA2tS8t,SpATywNh6bZuzm8s1ceuBUnMUAeoAHHw,15,29,5,12,5,7,7,2,67,9.571428571428571,1,0.0,18,5,11,5,11,7,1,7,2,39,28,1
2934,90827,Nu895EVx5N8YMgmc6Rsn4OVZESOkiczT,bWdj2GDclj5ofokWjzoa5jAwMkxCykd6,4,3,1,0,1,0,1,0,6,0.8571428571428571,1,0.0,0,1,0,1,3,0,0,1,0,2,4,1
2935,90829,r1uzabdEU8Xrw9e89SInzZPTwxnUupS6,SpATywNh6bZuzm8s1ceuBUnMUAeoAHHw,16,11,6,22,5,1,7,1,53,7.571428571428571,1,0.0,4,6,17,5,7,1,5,7,1,32,21,1
2936,90834,FajLS6BmkKgqb4XY9XPhCU4sFK1uRQ8Y,SpATywNh6bZuzm8s1ceuBUnMUAeoAHHw,6,2,1,0,1,0,3,0,7,1.0,1,0.0,1,1,0,1,1,0,0,3,0,3,4,1
2937,90838,J5zz2fAd7wtYMISsvWzFdYy7sZtBfDuG,SpATywNh6bZuzm8s1ceuBUnMUAeoAHHw,11,17,7,0,3,7,9,1,44,6.285714285714286,1,0.0,8,7,0,3,9,7,0,9,1,18,26,1
2938,90840,b1jxzfFtNrlmaMGoYNWOYfEAHOoLdx2j,bWdj2GDclj5ofokWjzoa5jAwMkxCykd6,7,6,2,4,1,0,7,0,20,2.857142857142857,1,0.0,2,2,4,1,4,0,0,7,0,9,11,1
2939,90860,JNtIRj6hnKiaMOhcBlcWRjLc0QwYKSxo,RXDvfPUBYFlVdlueBFbLW0mhhAyGEqpt,5,2,1,0,1,0,2,0,6,0.8571428571428571,1,0.0,0,1,0,1,2,0,0,2,0,2,4,1
2940,90871,pS71kwyejWdfiaeMEH40zntKPU95klQC,SpATywNh6bZuzm8s1ceuBUnMUAeoAHHw,6,3,0,0,0,0,3,1,7,1.0,1,0.0,0,0,0,0,3,0,0,3,1,0,7,1
2941,90873,LoEfaid2dOKAK1Vb6WcaGJbgN3PRNGde,SpATywNh6bZuzm8s1ceuBUnMUAeoAHHw,4,2,1,0,1,0,2,0,6,0.8571428571428571,1,0.0,0,1,0,1,2,0,0,2,0,2,4,1
2942,90886,U6j39msbwkx5j8wcgHIrrZSEw6jir138,SpATywNh6bZuzm8s1ceuBUnMUAeoAHHw,5,4,2,0,2,0,2,0,10,1.4285714285714286,1,0.0,1,2,0,2,3,0,0,2,0,5,5,1
2943,90895,TRCrdidmG6eXWyA1xpJbOiCViWff58Ia,bWdj2GDclj5ofokWjzoa5jAwMkxCykd6,5,2,1,0,1,0,2,0,6,0.8571428571428571,1,0.0,0,1,0,1,2,0,0,2,0,2,4,1
2944,90898,KuNFtG4l08F89uoxUeo0jGAYIKWrBRbs,SpATywNh6bZuzm8s1ceuBUnMUAeoAHHw,11,8,4,5,3,0,2,0,22,3.142857142857143,2,0.0,1,4,4,3,7,0,1,2,0,12,10,1
2945,90900,ZlJV9a7edMx2HyEVyPzwwfS7y67dq8Ki,SpATywNh6bZuzm8s1ceuBUnMUAeoAHHw,7,6,4,0,4,0,2,0,16,2.2857142857142856,1,0.0,1,4,0,4,5,0,0,2,0,9,7,1
2946,90917,nazeZS8BdRMOGGuVriyb5M21Pn5Qng36,bWdj2GDclj5ofokWjzoa5jAwMkxCykd6,7,15,7,0,17,0,6,0,45,6.428571428571429,2,0.0,0,7,0,17,15,0,0,6,0,24,21,1
2947,90924,8dce3jvQILzvCt2gqdxC1GXJeAlwT2XG,SpATywNh6bZuzm8s1ceuBUnMUAeoAHHw,5,2,1,0,1,0,3,0,7,1.0,1,0.0,0,1,0,1,2,0,0,3,0,2,5,1
2948,90931,MhTSP1UwQzeoqedkBfla3LYw7KA6P5RM,bWdj2GDclj5ofokWjzoa5jAwMkxCykd6,3,2,0,0,0,0,2,0,4,0.5714285714285714,1,0.0,0,0,0,0,2,0,0,2,0,0,4,1
2949,90935,T6uKBu9byfRvxDh9TTWa54gKMCltkicT,G8EPVSXsOYB5YQWZGiz1aVq5Pgr2GrQu,4,4,3,0,3,0,1,0,11,1.5714285714285714,2,0.0,0,3,0,3,4,0,0,1,0,6,5,1
2950,90936,ElLz2aBJCCMb80RAglralkX1EvljkdsQ,SpATywNh6bZuzm8s1ceuBUnMUAeoAHHw,5,3,1,0,1,0,2,0,7,1.0,1,0.0,0,1,0,1,3,0,0,2,0,2,5,1
2951,90941,XTcsDe1fuCzXOnCFHuWkz7K8gAjPZJM4,bWdj2GDclj5ofokWjzoa5jAwMkxCykd6,2,0,0,0,0,0,5,0,5,0.7142857142857143,1,0.0,0,0,0,0,0,0,0,5,0,0,5,1
2952,90942,oh70wjHZNiJm6YMEO2zTeIrDQMUiqmDd,bWdj2GDclj5ofokWjzoa5jAwMkxCykd6,8,14,2,0,2,0,3,0,21,3.0,2,0.0,4,2,0,2,10,0,0,3,0,8,13,1
2953,90943,iz51PdaMdn80ICs5ffsXdIXAEkxQQqv2,SpATywNh6bZuzm8s1ceuBUnMUAeoAHHw,17,9,5,16,3,2,9,1,45,6.428571428571429,1,0.0,3,5,15,3,6,2,1,9,1,26,19,1
2954,90944,Sz8jNgPmKJ1IbqEEVQqTtQlVUDGarqh2,bWdj2GDclj5ofokWjzoa5jAwMkxCykd6,11,8,3,0,4,0,11,1,27,3.857142857142857,1,0.0,3,3,0,4,5,0,0,11,1,10,17,1
2955,90950,FwoYWsRBSR2prQ90dYeOBoYOgqUPkA0R,G8EPVSXsOYB5YQWZGiz1aVq5Pgr2GrQu,2,0,0,0,0,0,3,0,3,0.42857142857142855,2,0.0,0,0,0,0,0,0,0,3,0,0,3,1
2956,90952,YQuE8HipF2FTxF6yilCc6Hjt2hO1hf9q,bWdj2GDclj5ofokWjzoa5jAwMkxCykd6,7,5,1,0,2,2,6,2,18,2.5714285714285716,1,0.0,3,1,0,2,2,2,0,6,2,6,12,1
2957,90965,1YzhwwWLdVM4bzJMYH49O7nplNitMAxK,bWdj2GDclj5ofokWjzoa5jAwMkxCykd6,4,2,1,0,1,0,2,0,6,0.8571428571428571,1,0.0,0,1,0,1,2,0,0,2,0,2,4,1
2958,90971,0Any9bve5RgMfxHre7giBaaR9aLeQ2Lh,G8EPVSXsOYB5YQWZGiz1aVq5Pgr2GrQu,31,27,9,48,5,1,6,1,97,13.857142857142858,2,0.0,10,9,36,5,17,1,12,6,1,60,37,1
2959,90972,zZsHSLX7Hk1sqhZYCfBgGlYJnqetGIKf,RXDvfPUBYFlVdlueBFbLW0mhhAyGEqpt,4,3,1,0,1,4,1,0,10,1.4285714285714286,1,0.0,0,1,0,1,3,4,0,1,0,2,8,1
2960,90977,54WxhKjSN8T9wal7LR6RLgJ4OJYZ4MI7,SpATywNh6bZuzm8s1ceuBUnMUAeoAHHw,7,2,1,0,1,0,4,2,10,1.4285714285714286,1,0.0,0,1,0,1,2,0,0,4,2,2,8,1
2961,90981,WaDGEoZt5VlIPyIkYuUem7AfSknoei62,SpATywNh6bZuzm8s1ceuBUnMUAeoAHHw,5,3,2,0,2,0,2,0,9,1.2857142857142858,1,0.0,0,2,0,2,3,0,0,2,0,4,5,1
2962,90983,6bHj9PZ0VE3b8eSJI8u4oP72tokPXLXO,G8EPVSXsOYB5YQWZGiz1aVq5Pgr2GrQu,1,0,0,0,0,0,1,0,1,0.14285714285714285,1,0.0,0,0,0,0,0,0,0,1,0,0,1,1
2963,90985,1fUklgl0Md6ScDLqDSo4HCeoLeD6eKIu,SpATywNh6bZuzm8s1ceuBUnMUAeoAHHw,4,2,1,0,1,0,1,0,5,0.7142857142857143,1,0.0,0,1,0,1,2,0,0,1,0,2,3,1
2964,90988,088SASUPOVYUGhoEly8vlrkGvRBJoNwp,bWdj2GDclj5ofokWjzoa5jAwMkxCykd6,1,0,0,0,0,0,1,0,1,0.14285714285714285,1,0.0,0,0,0,0,0,0,0,1,0,0,1,1
2965,90993,o9jg8F69R1QHiPj2Cseo8eHEbgUVa0SI,SpATywNh6bZuzm8s1ceuBUnMUAeoAHHw,14,12,7,8,3,0,4,0,34,4.857142857142857,1,0.0,3,7,8,3,9,0,0,4,0,21,13,1
2966,90994,aRm0bLcx1zhfrL1xTMfT090YII1zkLc3,SpATywNh6bZuzm8s1ceuBUnMUAeoAHHw,9,7,3,0,0,9,7,1,27,3.857142857142857,1,0.0,0,3,0,0,7,9,0,7,1,3,24,1
2967,90999,CwyOL3RMOVLomxrxyN9D4jPa9R0iWrS5,G8EPVSXsOYB5YQWZGiz1aVq5Pgr2GrQu,6,2,0,0,1,0,4,0,7,1.0,3,0.0,0,0,0,1,2,0,0,4,0,1,6,0
2968,91026,MjeqDLbJZr4I90t51p6C9NVAFWnc6WKs,SpATywNh6bZuzm8s1ceuBUnMUAeoAHHw,4,2,1,0,1,0,1,0,5,0.7142857142857143,1,0.0,0,1,0,1,2,0,0,1,0,2,3,1
2969,91034,QFBztpG3zDUpKNEaUDnlRETY3MvJRJAi,SpATywNh6bZuzm8s1ceuBUnMUAeoAHHw,5,2,1,0,1,0,2,0,6,0.8571428571428571,1,0.0,0,1,0,1,2,0,0,2,0,2,4,1
2970,91042,NkVQGteS9t3nbfagAzHcxD3mnVkb9mPC,bWdj2GDclj5ofokWjzoa5jAwMkxCykd6,18,22,12,54,6,10,13,0,117,16.714285714285715,4,0.0,4,12,46,6,18,10,8,13,0,68,49,1
2971,91048,niLMw8MCObO7SSR2V1jNg9WQt5oSjDFJ,bWdj2GDclj5ofokWjzoa5jAwMkxCykd6,6,5,3,0,2,0,3,0,13,1.8571428571428572,2,0.0,0,3,0,2,5,0,0,3,0,5,8,1
2972,91051,xl5sOWFbG0Tv8T4ljEfZxFv4R7vezkE6,SpATywNh6bZuzm8s1ceuBUnMUAeoAHHw,7,1,1,0,1,0,5,1,9,1.2857142857142858,1,0.0,0,1,0,1,1,0,0,5,1,2,7,1
2973,91052,OoFskl7apYDC7BHDdb3sEQXj1CchwYwD,bWdj2GDclj5ofokWjzoa5jAwMkxCykd6,2,0,0,0,0,0,2,0,2,0.2857142857142857,1,0.0,0,0,0,0,0,0,0,2,0,0,2,1
2974,91056,Iji9dmQW7A2gOcEtvLASbynNxhfIM21F,bWdj2GDclj5ofokWjzoa5jAwMkxCykd6,5,2,1,0,1,0,3,0,7,1.0,1,0.0,0,1,0,1,2,0,0,3,0,2,5,1
2975,91069,YYUyHWUcinXU8cifTlXoJnuPjgxGAJi5,SpATywNh6bZuzm8s1ceuBUnMUAeoAHHw,1,0,0,0,0,0,1,0,1,0.14285714285714285,1,0.0,0,0,0,0,0,0,0,1,0,0,1,1
2976,91074,JpAMTeX7S86zOjUKZJzvXPct8ySEHYBj,G8EPVSXsOYB5YQWZGiz1aVq5Pgr2GrQu,6,3,1,0,1,0,4,0,9,1.2857142857142858,1,0.0,0,1,0,1,3,0,0,4,0,2,7,1
2977,91077,6LSxEzHekfBjzdBuVJRrkvGn3CBVWXBO,SpATywNh6bZuzm8s1ceuBUnMUAeoAHHw,12,14,6,0,4,1,5,1,31,4.428571428571429,1,0.0,2,6,0,4,12,1,0,5,1,12,19,1
2978,91085,WzyxlFqmZtRh9gdD2KRH7ykffyZqisUy,SpATywNh6bZuzm8s1ceuBUnMUAeoAHHw,13,26,2,17,1,2,9,0,57,8.142857142857142,1,0.0,9,2,15,1,17,2,2,9,0,27,30,1
2979,91091,UlE0oj4kFfHwymOFgqOZSWzrZZdGbIRC,SpATywNh6bZuzm8s1ceuBUnMUAeoAHHw,9,5,1,0,1,1,6,1,15,2.142857142857143,1,0.0,0,1,0,1,5,1,0,6,1,2,13,1
2980,91092,mXfwwTIVjHMqoVKAh2iEQbinKUCJHwTp,SpATywNh6bZuzm8s1ceuBUnMUAeoAHHw,9,23,11,0,9,6,9,0,58,8.285714285714286,1,0.0,0,11,0,9,23,6,0,9,0,20,38,1
2981,91113,LDDV5GLR4T4AoJ4swm7PTuKciMVwXQ01,G8EPVSXsOYB5YQWZGiz1aVq5Pgr2GrQu,14,5,4,18,3,1,6,1,38,5.428571428571429,1,0.0,0,4,15,3,5,1,3,6,1,22,16,0
2982,91123,b49trtJTjAjBwZY0yqpUQlVmAVV99Apg,SpATywNh6bZuzm8s1ceuBUnMUAeoAHHw,12,14,7,4,5,1,5,0,36,5.142857142857143,1,0.0,2,7,4,5,12,1,0,5,0,18,18,1
2983,91133,eYnqJ330oueH4EH7KeCLJxm6knixAbKs,SpATywNh6bZuzm8s1ceuBUnMUAeoAHHw,10,7,5,0,4,0,4,0,20,2.857142857142857,2,0.0,0,5,0,4,7,0,0,4,0,9,11,1
2984,91136,IVuLX03K95bXWOSaQ9TjOxhrrnD2P8LK,SpATywNh6bZuzm8s1ceuBUnMUAeoAHHw,16,14,7,11,4,0,6,1,43,6.142857142857143,1,0.0,4,7,11,4,10,0,0,6,1,26,17,1
2985,91139,Dw8R0agU0UT0CHCyap3lEB834WRdn2Bl,G8EPVSXsOYB5YQWZGiz1aVq5Pgr2GrQu,9,5,3,0,3,0,2,0,13,1.8571428571428572,1,0.0,1,3,0,3,4,0,0,2,0,7,6,1
2986,91149,SOPkGQWWnRmFTO7wOQhPDwNSzqEUHcJN,RXDvfPUBYFlVdlueBFbLW0mhhAyGEqpt,9,6,5,0,3,0,1,0,15,2.142857142857143,1,0.0,0,5,0,3,6,0,0,1,0,8,7,1
2987,91152,ogzXep3azQvjQ2uIPIxw4TZLNiUXYlgD,RXDvfPUBYFlVdlueBFbLW0mhhAyGEqpt,21,12,8,16,4,16,8,6,70,10.0,2,0.0,2,8,15,4,10,16,1,8,6,29,41,1
2988,91175,5q13Swk6MXZ4N9xLOgcxgjrrx1DdXb4Y,G8EPVSXsOYB5YQWZGiz1aVq5Pgr2GrQu,2,0,0,0,0,0,2,0,2,0.2857142857142857,1,0.0,0,0,0,0,0,0,0,2,0,0,2,1
2989,91177,CwCqnH1O0RObsR0eBW9cv5anjwotHyXi,SpATywNh6bZuzm8s1ceuBUnMUAeoAHHw,8,4,3,0,3,0,1,0,11,1.5714285714285714,1,0.0,0,3,0,3,4,0,0,1,0,6,5,1
2990,91180,MBIWth5fpiCntqhZOrmXyFENe8IPo1si,G8EPVSXsOYB5YQWZGiz1aVq5Pgr2GrQu,5,2,1,0,1,0,3,0,7,1.0,1,0.0,0,1,0,1,2,0,0,3,0,2,5,1
2991,91185,bUI06hErQBLCI8IpvZBPVsO5ApTPyNZ8,bWdj2GDclj5ofokWjzoa5jAwMkxCykd6,6,3,1,0,1,0,2,0,7,1.0,2,0.0,0,1,0,1,3,0,0,2,0,2,5,1
2992,91186,N3cFMZkDkwJjlqfThZ0MJktu3s2FDQhu,SpATywNh6bZuzm8s1ceuBUnMUAeoAHHw,14,12,6,10,4,0,5,0,37,5.285714285714286,1,0.0,2,6,10,4,10,0,0,5,0,22,15,1
2993,91195,sD1p5VuSw3mE3A3cEGdX778feL3umtle,G8EPVSXsOYB5YQWZGiz1aVq5Pgr2GrQu,1,0,0,0,0,0,2,0,2,0.2857142857142857,1,0.0,0,0,0,0,0,0,0,2,0,0,2,1
2994,91197,MfRaHJKkD3QtNBNxriSuNn50bOkDWFU2,G8EPVSXsOYB5YQWZGiz1aVq5Pgr2GrQu,4,4,1,0,2,0,1,0,8,1.1428571428571428,1,0.0,2,1,0,2,2,0,0,1,0,5,3,0
2995,91200,Zw1bdKbgaMzUzlqlieQSaucEQ8wggZlx,RXDvfPUBYFlVdlueBFbLW0mhhAyGEqpt,7,6,4,0,2,0,2,0,14,2.0,1,0.0,0,4,0,2,6,0,0,2,0,6,8,1
2996,91211,YlWJRLkP5QIlBcoTrKDrquHDRSLUHmOs,SpATywNh6bZuzm8s1ceuBUnMUAeoAHHw,14,21,0,17,0,24,7,1,70,10.0,3,0.0,10,0,15,0,11,24,2,7,1,25,45,0
2997,91224,0b8coo9JZwKqcLwikgVi0uCa0HK4ngVT,SpATywNh6bZuzm8s1ceuBUnMUAeoAHHw,7,7,3,0,3,0,2,0,15,2.142857142857143,1,0.0,2,3,0,3,5,0,0,2,0,8,7,1
2998,91227,wrG2kznqDzNLV2b2BDLa9oNAZZomHWM1,bWdj2GDclj5ofokWjzoa5jAwMkxCykd6,5,3,0,0,0,0,2,0,5,0.7142857142857143,1,0.0,0,0,0,0,3,0,0,2,0,0,5,1
2999,91234,Zw1bdKbgaMzUzlqlieQSaucEQ8wggZlx,SpATywNh6bZuzm8s1ceuBUnMUAeoAHHw,8,10,7,0,5,0,4,0,26,3.7142857142857144,2,0.0,0,7,0,5,10,0,0,4,0,12,14,1
3000,91237,JLChl7mOWMB1KaATZ4zO6thYfhhSEMFx,bWdj2GDclj5ofokWjzoa5jAwMkxCykd6,4,2,0,0,0,2,3,0,7,1.0,1,0.0,0,0,0,0,2,2,0,3,0,0,7,1
3001,91248,20Kk6BKHam3XYBZHLn3cb7mbeQ3wjB0A,SpATywNh6bZuzm8s1ceuBUnMUAeoAHHw,5,3,1,0,1,0,2,0,7,1.0,1,0.0,0,1,0,1,3,0,0,2,0,2,5,1
3002,91288,il7MvONte06QnYiXs4eT4KVZhcQaTvCn,bWdj2GDclj5ofokWjzoa5jAwMkxCykd6,2,0,0,0,0,0,2,0,2,0.2857142857142857,1,0.0,0,0,0,0,0,0,0,2,0,0,2,1
3003,91290,4BCWVZMgSyk2ZEk4MHhm6b7lpgXWTd1k,SpATywNh6bZuzm8s1ceuBUnMUAeoAHHw,16,27,21,10,11,12,13,1,95,13.571428571428571,3,0.0,0,21,7,11,27,12,3,13,1,39,56,0
3004,91292,f6cpMj2XDptMqY9BMDiLiCW1lYt1B5HJ,bWdj2GDclj5ofokWjzoa5jAwMkxCykd6,2,0,0,0,0,2,2,0,4,0.5714285714285714,1,0.0,0,0,0,0,0,2,0,2,0,0,4,1
3005,91295,R0mUc8n4TzKl7Gj3gQcARJOPoEK9YWes,SpATywNh6bZuzm8s1ceuBUnMUAeoAHHw,9,10,4,0,2,0,9,1,26,3.7142857142857144,1,0.0,0,4,0,2,10,0,0,9,1,6,20,1
3006,91298,q4LihsiR4OZ2DrDNHviQwvJKphS7fKLx,SpATywNh6bZuzm8s1ceuBUnMUAeoAHHw,5,3,1,0,1,0,3,0,8,1.1428571428571428,1,0.0,0,1,0,1,3,0,0,3,0,2,6,1
3007,91308,aUncRjNtcPfHDYIbstir1RL5J34mNVnM,SpATywNh6bZuzm8s1ceuBUnMUAeoAHHw,1,0,0,0,0,0,1,0,1,0.14285714285714285,1,0.0,0,0,0,0,0,0,0,1,0,0,1,1
3008,91309,i0UAMwrjj2eXydsjRtQeHBmAMB3Ngwx3,SpATywNh6bZuzm8s1ceuBUnMUAeoAHHw,3,3,1,0,0,0,1,0,5,0.7142857142857143,1,0.0,0,1,0,0,3,0,0,1,0,1,4,1
3009,91311,StzJzmbhGW7cEyMLQz7mJx8nKnB6WL4m,bWdj2GDclj5ofokWjzoa5jAwMkxCykd6,1,0,0,0,0,0,1,0,1,0.14285714285714285,1,0.0,0,0,0,0,0,0,0,1,0,0,1,1
3010,91313,SHYKz4VRgTlESEEhjzd6VibUsZchMKQH,G8EPVSXsOYB5YQWZGiz1aVq5Pgr2GrQu,6,5,2,0,2,0,3,0,12,1.7142857142857142,2,0.0,0,2,0,2,5,0,0,3,0,4,8,0
3011,91318,p1lN44XlRZ80wopUQc4ZNciWVb9r8nPI,RXDvfPUBYFlVdlueBFbLW0mhhAyGEqpt,18,26,10,26,3,0,4,0,69,9.857142857142858,2,0.0,4,10,22,3,22,0,4,4,0,39,30,1
3012,91321,qRCFXu9SKQXvPlpvjvNkgxm9VD5k2SNq,SpATywNh6bZuzm8s1ceuBUnMUAeoAHHw,15,19,8,17,3,1,9,0,57,8.142857142857142,3,0.0,8,8,15,3,11,1,2,9,0,34,23,1
3013,91342,za2dBkPPLD9IPRBjooK7GJit2ulI5UgN,bWdj2GDclj5ofokWjzoa5jAwMkxCykd6,1,0,0,0,0,0,1,0,1,0.14285714285714285,1,0.0,0,0,0,0,0,0,0,1,0,0,1,1
3014,91366,fE7crtUj4hDSQo6ITE7OJYFi4AN2F95M,RXDvfPUBYFlVdlueBFbLW0mhhAyGEqpt,9,7,0,9,1,0,1,0,18,2.5714285714285716,1,0.0,2,0,9,1,5,0,0,1,0,12,6,1
3015,91383,BcJnhjzA1hw0WNze9uWUZQ49uBAiBHyH,SpATywNh6bZuzm8s1ceuBUnMUAeoAHHw,8,9,2,0,2,0,4,0,17,2.4285714285714284,1,0.0,1,2,0,2,8,0,0,4,0,5,12,0
3016,91385,2GLZl96ZIgoKdw26t6xniq9LngPm9HvA,SpATywNh6bZuzm8s1ceuBUnMUAeoAHHw,8,3,2,0,2,0,3,0,10,1.4285714285714286,1,0.0,0,2,0,2,3,0,0,3,0,4,6,1
3017,91386,Id4UmIRRQiLXHoJYSjh5OCO1CRaFgQ2K,bWdj2GDclj5ofokWjzoa5jAwMkxCykd6,4,2,1,0,1,0,1,0,5,0.7142857142857143,1,0.0,0,1,0,1,2,0,0,1,0,2,3,1
3018,91389,j6Gbqu7tKtq8czp36zzxzHhI2ZEexibX,RXDvfPUBYFlVdlueBFbLW0mhhAyGEqpt,5,5,3,0,0,0,4,0,12,1.7142857142857142,2,0.0,0,3,0,0,5,0,0,4,0,3,9,1
3019,91393,pIUtN3HLfZAw0y37LPvuW9XkUHMVBvrO,bWdj2GDclj5ofokWjzoa5jAwMkxCykd6,1,0,0,0,0,0,1,0,1,0.14285714285714285,1,0.0,0,0,0,0,0,0,0,1,0,0,1,1
3020,91394,E7lyNwGYkG4o0UtCNjPSm6tmdy5hs4Mj,SpATywNh6bZuzm8s1ceuBUnMUAeoAHHw,7,1,1,0,1,0,5,0,8,1.1428571428571428,1,0.0,0,1,0,1,1,0,0,5,0,2,6,1
3021,91395,NzJuOfalEsOT54AavPrqSe3rsSE0cQkZ,bWdj2GDclj5ofokWjzoa5jAwMkxCykd6,1,0,0,0,0,0,1,0,1,0.14285714285714285,1,0.0,0,0,0,0,0,0,0,1,0,0,1,1
3022,91401,iM4WoC15lD8jmFLbUdaT8GwiDe76pgOg,G8EPVSXsOYB5YQWZGiz1aVq5Pgr2GrQu,2,0,0,0,0,0,2,0,2,0.2857142857142857,2,0.0,0,0,0,0,0,0,0,2,0,0,2,1
3023,91404,pSX4Dt8N2zVP05X1Tx0KEKzwWiZKDmer,SpATywNh6bZuzm8s1ceuBUnMUAeoAHHw,6,4,1,0,0,0,4,0,9,1.2857142857142858,2,0.0,0,1,0,0,4,0,0,4,0,1,8,1
3024,91405,piFN5eqEaJK1fUd2Yaiy8tquOTQSgzuN,RXDvfPUBYFlVdlueBFbLW0mhhAyGEqpt,2,0,0,0,0,0,3,0,3,0.42857142857142855,1,0.0,0,0,0,0,0,0,0,3,0,0,3,1
3025,91408,ov4pd0r7G3aHxyRJ3zd0jj3VwbkwbsuS,SpATywNh6bZuzm8s1ceuBUnMUAeoAHHw,8,2,1,0,1,2,11,1,18,2.5714285714285716,1,0.0,0,1,0,1,2,2,0,11,1,2,16,1
3026,91410,sEqMP3dTCfBAru35lgG6C0VuJq3LG5mE,SpATywNh6bZuzm8s1ceuBUnMUAeoAHHw,6,4,1,0,1,3,5,0,14,2.0,3,0.0,0,1,0,1,4,3,0,5,0,2,12,1
3027,91414,HSyljcmKCDSksgg7xJb6gUib0wBvYjVv,G8EPVSXsOYB5YQWZGiz1aVq5Pgr2GrQu,29,34,20,46,9,13,8,1,131,18.714285714285715,1,0.0,12,20,32,9,22,13,14,8,1,73,58,1
3028,91423,g6UH67YbvJtewLNXQNVZTYui0XC1Hxpo,bWdj2GDclj5ofokWjzoa5jAwMkxCykd6,7,12,7,0,1,5,6,0,31,4.428571428571429,1,0.0,1,7,0,1,11,5,0,6,0,9,22,1
3029,91429,Ocd58hpNcygqCXglTTmZd1ZSNvH3SCps,RXDvfPUBYFlVdlueBFbLW0mhhAyGEqpt,6,6,4,0,1,0,1,0,12,1.7142857142857142,1,0.0,0,4,0,1,6,0,0,1,0,5,7,1
3030,91430,vrpzudIR4dEiVdhwxbfDnInMv3JRRfJv,SpATywNh6bZuzm8s1ceuBUnMUAeoAHHw,5,3,1,0,1,0,1,0,6,0.8571428571428571,1,0.0,0,1,0,1,3,0,0,1,0,2,4,1
3031,91434,0CSUGuJXm53wz281T7wy30wWcjmP6Jhd,bWdj2GDclj5ofokWjzoa5jAwMkxCykd6,1,0,0,0,0,0,1,0,1,0.14285714285714285,1,0.0,0,0,0,0,0,0,0,1,0,0,1,1
3032,91438,FUkw8gvbqykqbH4tdSuG6VwP03f4pQvB,RXDvfPUBYFlVdlueBFbLW0mhhAyGEqpt,1,0,0,0,0,0,1,0,1,0.14285714285714285,1,0.0,0,0,0,0,0,0,0,1,0,0,1,1
3033,91442,XR5Z5kfmQ9E4GIPtNaMkJo2oa530uh94,SpATywNh6bZuzm8s1ceuBUnMUAeoAHHw,11,6,4,0,3,0,5,1,19,2.7142857142857144,1,0.0,0,4,0,3,6,0,0,5,1,7,12,1
3034,91456,pIUtN3HLfZAw0y37LPvuW9XkUHMVBvrO,SpATywNh6bZuzm8s1ceuBUnMUAeoAHHw,5,2,1,0,1,0,2,0,6,0.8571428571428571,1,0.0,0,1,0,1,2,0,0,2,0,2,4,1
3035,91460,qzjZHUzfivuSEB3h2CxO69AUVaBX51Ki,bWdj2GDclj5ofokWjzoa5jAwMkxCykd6,3,0,0,0,0,1,7,0,8,1.1428571428571428,2,0.0,0,0,0,0,0,1,0,7,0,0,8,1
3036,91474,XDng1mliVGDk6IontbBqBdoGZnODrUp1,SpATywNh6bZuzm8s1ceuBUnMUAeoAHHw,1,0,0,0,0,0,1,0,1,0.14285714285714285,1,0.0,0,0,0,0,0,0,0,1,0,0,1,0
3037,91477,Rhpf6lbWeFbBg91LchhBc713YgETI2ib,SpATywNh6bZuzm8s1ceuBUnMUAeoAHHw,11,10,0,14,0,2,6,2,34,4.857142857142857,1,0.0,4,0,13,0,6,2,1,6,2,17,17,1
3038,91478,mB7kFNAvy0IlvYKinAyQDJ9wbSStqolr,SpATywNh6bZuzm8s1ceuBUnMUAeoAHHw,9,3,1,0,1,15,7,6,33,4.714285714285714,1,0.0,0,1,0,1,3,15,0,7,6,2,31,1
3039,91480,3NG42RQfrkx04BX4rgjNYVd7JioduuEW,SpATywNh6bZuzm8s1ceuBUnMUAeoAHHw,17,53,22,14,7,12,16,1,125,17.857142857142858,3,0.0,19,22,13,7,34,12,1,16,1,61,64,0
3040,91484,Ja9aSTrbcYBJIk0knND32MhX73YVzDja,SpATywNh6bZuzm8s1ceuBUnMUAeoAHHw,15,31,6,19,3,5,7,1,72,10.285714285714286,1,0.0,23,6,17,3,8,5,2,7,1,49,23,1
3041,91498,Hh0poBt7neEeproKcOr3UwYd1l0mAkdY,SpATywNh6bZuzm8s1ceuBUnMUAeoAHHw,3,2,0,0,0,0,1,0,3,0.42857142857142855,1,0.0,0,0,0,0,2,0,0,1,0,0,3,1
3042,91499,MpyJrzGdf4KkfpgI13J4Ob9OCNumnSCn,G8EPVSXsOYB5YQWZGiz1aVq5Pgr2GrQu,19,22,8,38,8,0,4,1,81,11.571428571428571,3,0.0,1,8,34,8,21,0,4,4,1,51,30,1
3043,91503,Zx58r1nZicPZKjfYD5NgFYMSoAobbtxC,SpATywNh6bZuzm8s1ceuBUnMUAeoAHHw,12,11,7,0,5,0,5,0,28,4.0,1,0.0,1,7,0,5,10,0,0,5,0,13,15,1
3044,91510,NjgQeSBBMWIwQySsR5ymtqiugkMaOyYh,RXDvfPUBYFlVdlueBFbLW0mhhAyGEqpt,1,0,0,0,0,0,1,0,1,0.14285714285714285,1,0.0,0,0,0,0,0,0,0,1,0,0,1,1
3045,91512,IOj0PjWZoY0P8vGiPElep0GUuIa0VzfB,SpATywNh6bZuzm8s1ceuBUnMUAeoAHHw,8,2,1,0,1,0,5,1,10,1.4285714285714286,2,0.0,0,1,0,1,2,0,0,5,1,2,8,1
3046,91513,mlU6Sa4kvQqDwrJTiTVy3DXIlsysw3Tt,bWdj2GDclj5ofokWjzoa5jAwMkxCykd6,7,2,1,0,1,2,6,1,13,1.8571428571428572,1,0.0,0,1,0,1,2,2,0,6,1,2,11,0
3047,91521,1wUGa0IVsURQxQCvq0df7PLHs6Y2zNr7,bWdj2GDclj5ofokWjzoa5jAwMkxCykd6,5,5,0,0,0,0,7,0,12,1.7142857142857142,1,0.0,0,0,0,0,5,0,0,7,0,0,12,1
3048,91534,QM4BAIMqANq73zFQSTCtWv7Gn7ptHHhB,SpATywNh6bZuzm8s1ceuBUnMUAeoAHHw,7,3,2,0,1,0,6,0,12,1.7142857142857142,1,0.0,0,2,0,1,3,0,0,6,0,3,9,1
3049,91537,OiZVspQp0F9iJRMGMp4WIKFfxCHFzZhd,SpATywNh6bZuzm8s1ceuBUnMUAeoAHHw,1,0,0,0,0,0,1,0,1,0.14285714285714285,1,0.0,0,0,0,0,0,0,0,1,0,0,1,1
3050,91542,gpepovLBdtRKFzmC4QxqUbBL1lSM59qa,G8EPVSXsOYB5YQWZGiz1aVq5Pgr2GrQu,6,5,2,0,1,0,2,0,10,1.4285714285714286,1,0.0,0,2,0,1,5,0,0,2,0,3,7,1
3051,91555,nQTEVD6AAIYz8tW67vxXg9EsDxe19v25,SpATywNh6bZuzm8s1ceuBUnMUAeoAHHw,1,0,0,0,0,0,1,0,1,0.14285714285714285,1,0.0,0,0,0,0,0,0,0,1,0,0,1,1
3052,91558,JaxQCd7UV5o1rvWxAibMy6iOMU3fCV5H,SpATywNh6bZuzm8s1ceuBUnMUAeoAHHw,5,2,1,0,1,0,2,0,6,0.8571428571428571,1,0.0,0,1,0,1,2,0,0,2,0,2,4,1
3053,91574,Utp3WJ8WUPD5DMyG8PNbE11goCMql2Z7,SpATywNh6bZuzm8s1ceuBUnMUAeoAHHw,1,0,0,0,0,0,1,0,1,0.14285714285714285,1,0.0,0,0,0,0,0,0,0,1,0,0,1,1
3054,91587,gGccjvdbrNrajnyHrtaox144rWbV1SPy,SpATywNh6bZuzm8s1ceuBUnMUAeoAHHw,14,31,15,21,7,3,6,0,83,11.857142857142858,3,0.0,4,15,18,7,27,3,3,6,0,44,39,0
3055,91598,7T9YIDVeH18g5BhUfy7opy4UBmEqkepp,bWdj2GDclj5ofokWjzoa5jAwMkxCykd6,2,0,0,0,0,0,3,0,3,0.42857142857142855,1,0.0,0,0,0,0,0,0,0,3,0,0,3,1
3056,92831,B2UTUKN3bAFFBRPjVt44lFW6bWnjSKKh,G8EPVSXsOYB5YQWZGiz1aVq5Pgr2GrQu,10,10,1,0,1,0,3,0,15,2.142857142857143,1,0.0,0,1,0,1,10,0,0,3,0,2,13,1
3057,92837,bUI06hErQBLCI8IpvZBPVsO5ApTPyNZ8,A3fsA9Zfv1X2fVEQhTw51lKENdNrEqT3,7,0,0,0,0,10,7,1,18,2.5714285714285716,1,0.0,0,0,0,0,0,10,0,7,1,0,18,1
3058,92842,5fh1jlCU7jXB4QIW6qiZqp3idmC7zGIG,SpATywNh6bZuzm8s1ceuBUnMUAeoAHHw,9,5,3,0,2,1,6,1,18,2.5714285714285716,1,0.0,0,3,0,2,5,1,0,6,1,5,13,1
3059,92850,Q2m4p3E1xU5tjACIAMpsbnVuTeuD9Zj8,bWdj2GDclj5ofokWjzoa5jAwMkxCykd6,17,32,2,78,4,11,14,1,142,20.285714285714285,2,0.0,3,2,75,4,29,11,3,14,1,84,58,1
3060,92858,PO9UqxqUlWjKdLcKUuvXjpBUsCJBV13h,SpATywNh6bZuzm8s1ceuBUnMUAeoAHHw,16,29,3,8,2,6,6,1,55,7.857142857142857,3,0.0,15,3,8,2,14,6,0,6,1,28,27,0
3061,92869,1WP7C2GzJDZRslYYccdoHTPh8lrMzeDB,G8EPVSXsOYB5YQWZGiz1aVq5Pgr2GrQu,14,13,5,10,4,2,10,2,46,6.571428571428571,2,0.0,6,5,9,4,7,2,1,10,2,24,22,1
3062,92883,TY1XSpzUxZYHUqU0tQYtstvuwKCsGYpR,G8EPVSXsOYB5YQWZGiz1aVq5Pgr2GrQu,30,31,17,6,13,2,13,2,84,12.0,1,0.0,8,17,3,13,23,2,3,13,2,41,43,1
3063,92918,k8Gwazobmq79kvZvGEmSVe54OgHin1Sn,bWdj2GDclj5ofokWjzoa5jAwMkxCykd6,1,0,0,0,0,0,1,0,1,0.14285714285714285,1,0.0,0,0,0,0,0,0,0,1,0,0,1,1
3064,92920,k8Gwazobmq79kvZvGEmSVe54OgHin1Sn,RXDvfPUBYFlVdlueBFbLW0mhhAyGEqpt,1,0,0,0,0,0,1,0,1,0.14285714285714285,1,0.0,0,0,0,0,0,0,0,1,0,0,1,1
3065,92927,xKVU4KxHH7yw4gLTDP7X9Lm3WXZQ3SDL,SpATywNh6bZuzm8s1ceuBUnMUAeoAHHw,7,6,1,0,1,0,1,0,9,1.2857142857142858,1,0.0,0,1,0,1,6,0,0,1,0,2,7,1
3066,92929,0Rhh8KlMvGRxFbePsrW63o0GE8JJ4ZBr,bWdj2GDclj5ofokWjzoa5jAwMkxCykd6,1,0,0,0,0,0,1,0,1,0.14285714285714285,1,0.0,0,0,0,0,0,0,0,1,0,0,1,1
3067,92942,erkNYBqLpKRElyeL8GeAgO43CMazg6Rt,SpATywNh6bZuzm8s1ceuBUnMUAeoAHHw,7,4,3,0,1,0,5,0,13,1.8571428571428572,1,0.0,0,3,0,1,4,0,0,5,0,4,9,1
3068,92943,9HqwJ8d4m6K7QOSGhF3dVzXYAYpOl0vj,RXDvfPUBYFlVdlueBFbLW0mhhAyGEqpt,12,17,6,0,4,0,3,0,30,4.285714285714286,1,0.0,0,6,0,4,17,0,0,3,0,10,20,1
3069,92946,bab14MPTgN4CshxZkY1kRnkvwuN9o8mj,SpATywNh6bZuzm8s1ceuBUnMUAeoAHHw,7,6,3,0,0,0,4,0,13,1.8571428571428572,1,0.0,0,3,0,0,6,0,0,4,0,3,10,1
3070,92994,NOoY36GVhU97rerOUVOIRgnbHjJMMwCG,G8EPVSXsOYB5YQWZGiz1aVq5Pgr2GrQu,4,3,0,0,0,0,2,0,5,0.7142857142857143,1,0.0,0,0,0,0,3,0,0,2,0,0,5,1
3071,93001,0lnyhqsWvNqdzPtTAPrrtxMTUBGxwge7,bWdj2GDclj5ofokWjzoa5jAwMkxCykd6,19,26,16,60,4,21,13,1,141,20.142857142857142,2,0.0,3,16,54,4,23,21,6,13,1,77,64,1
3072,93003,jX688Ad4bKlzkVM1SgNhwbdpN9xeTtmq,SpATywNh6bZuzm8s1ceuBUnMUAeoAHHw,7,3,2,0,2,0,2,0,9,1.2857142857142858,1,0.0,0,2,0,2,3,0,0,2,0,4,5,1
3073,93008,OdMr7dE5UlAme9Tp979vREBvY5CV50po,SpATywNh6bZuzm8s1ceuBUnMUAeoAHHw,15,22,10,9,3,0,9,0,53,7.571428571428571,5,0.0,2,10,9,3,20,0,0,9,0,24,29,0
3074,93018,bvvXbZgPtHbMGEZyEKJpOMNTPWYUJwvY,SpATywNh6bZuzm8s1ceuBUnMUAeoAHHw,1,0,0,0,0,0,1,0,1,0.14285714285714285,1,0.0,0,0,0,0,0,0,0,1,0,0,1,1
3075,93021,O2zNu3OLMNHq2ZjC3tlYs2TX12EEuIAG,bWdj2GDclj5ofokWjzoa5jAwMkxCykd6,13,39,21,60,15,18,14,1,168,24.0,4,0.0,8,21,58,15,31,18,2,14,1,102,66,0
3076,93031,4ihKyViABUcTrutAyMvzpqSavA9xsDnC,SpATywNh6bZuzm8s1ceuBUnMUAeoAHHw,9,8,6,0,4,0,1,0,19,2.7142857142857144,1,0.0,1,6,0,4,7,0,0,1,0,11,8,1
3077,93036,m9qgZNgP3Zn0sGVjbTdK1WyVxg0SzTDj,SpATywNh6bZuzm8s1ceuBUnMUAeoAHHw,2,0,0,0,0,0,2,0,2,0.2857142857142857,1,0.0,0,0,0,0,0,0,0,2,0,0,2,1
3078,93045,WDD9a1qNUJX21r5OnYzYbe9snqA1PiYA,SpATywNh6bZuzm8s1ceuBUnMUAeoAHHw,10,11,9,0,5,0,5,0,30,4.285714285714286,2,0.0,0,9,0,5,11,0,0,5,0,14,16,1
3079,93046,0hRwE5vbowYRJTF6rcWCTgSh4yHA34bg,A3fsA9Zfv1X2fVEQhTw51lKENdNrEqT3,36,31,2,70,0,8,20,1,132,18.857142857142858,3,0.0,1,2,57,0,30,8,13,20,1,60,72,1
3080,93051,35QP8hkG1fMgJT5B2mWO7L1K5UDzKccP,RXDvfPUBYFlVdlueBFbLW0mhhAyGEqpt,1,0,0,0,0,0,1,0,1,0.14285714285714285,1,0.0,0,0,0,0,0,0,0,1,0,0,1,1
3081,93079,nVktdU2hPjrulp1NoJo2DLy3TGZQ0Uld,A3fsA9Zfv1X2fVEQhTw51lKENdNrEqT3,7,6,0,0,0,0,2,0,8,1.1428571428571428,1,0.0,0,0,0,0,6,0,0,2,0,0,8,0
3082,93100,FOMKrwD1FP5IWZmKryOBAWZkzJtszFo9,SpATywNh6bZuzm8s1ceuBUnMUAeoAHHw,6,3,2,0,1,0,4,0,10,1.4285714285714286,1,0.0,0,2,0,1,3,0,0,4,0,3,7,1
3083,93122,YYCI1ivPCDRa3x25VBUTnS1EqXk51k7P,SpATywNh6bZuzm8s1ceuBUnMUAeoAHHw,7,12,4,4,1,0,1,0,22,3.142857142857143,1,0.0,6,4,3,1,6,0,1,1,0,14,8,0
3084,93134,dtoXBrWvzofUQqyHToiF0PcYE9x06cjk,SpATywNh6bZuzm8s1ceuBUnMUAeoAHHw,13,16,7,0,3,1,9,1,37,5.285714285714286,2,0.0,2,7,0,3,14,1,0,9,1,12,25,1
3085,93138,qS74cvHEfXf7yNOdjRQHxs4K6Mb0fkmB,SpATywNh6bZuzm8s1ceuBUnMUAeoAHHw,5,5,3,0,0,0,7,0,15,2.142857142857143,1,0.0,0,3,0,0,5,0,0,7,0,3,12,1
3086,93146,ZBPGXZQPhYZwTG0U8gbjH8byD6eXCds5,SpATywNh6bZuzm8s1ceuBUnMUAeoAHHw,6,5,2,0,1,0,2,0,10,1.4285714285714286,1,0.0,0,2,0,1,5,0,0,2,0,3,7,1
3087,93155,nSGQJTGjP40uh7YNQd2M7oeyj4wFgY5k,SpATywNh6bZuzm8s1ceuBUnMUAeoAHHw,2,0,0,0,0,0,2,0,2,0.2857142857142857,1,0.0,0,0,0,0,0,0,0,2,0,0,2,1
3088,93172,9IDnKSSeA9OzPUrVvzlwiLBkpPo3uKJE,SpATywNh6bZuzm8s1ceuBUnMUAeoAHHw,11,14,9,0,6,0,12,2,43,6.142857142857143,1,0.0,0,9,0,6,14,0,0,12,2,15,28,1
3089,93195,ky5OAnymGB6zQeiaZNCLcaybyAjfTGVL,SpATywNh6bZuzm8s1ceuBUnMUAeoAHHw,15,22,8,11,2,12,9,0,64,9.142857142857142,1,0.0,11,8,10,2,11,12,1,9,0,31,33,1
3090,93201,tT3q39TssUZPXoxVdRzgRUu1SUheNubE,RXDvfPUBYFlVdlueBFbLW0mhhAyGEqpt,45,36,16,55,11,6,7,4,135,19.285714285714285,1,0.0,13,16,54,11,23,6,1,7,4,94,41,1
3091,93211,CANUVyVkYrlpItUerZN2eMCH6gNsEzSe,SpATywNh6bZuzm8s1ceuBUnMUAeoAHHw,12,16,2,0,1,0,10,3,32,4.571428571428571,3,0.0,0,2,0,1,16,0,0,10,3,3,29,1
3092,93219,fFsk9opmVFrs9gVmzPsOgmxgpsHLQliL,RXDvfPUBYFlVdlueBFbLW0mhhAyGEqpt,5,2,1,0,1,0,2,0,6,0.8571428571428571,1,0.0,0,1,0,1,2,0,0,2,0,2,4,1
3093,93227,ZBHFsE2c9ve1GkdeoBpHdlFbQkWYYfYc,A3fsA9Zfv1X2fVEQhTw51lKENdNrEqT3,4,5,1,0,0,0,2,0,8,1.1428571428571428,1,0.0,0,1,0,0,5,0,0,2,0,1,7,1
3094,93232,PoEjlZTjKWZ6BdoswaJwpEc5iphj2X1w,SpATywNh6bZuzm8s1ceuBUnMUAeoAHHw,1,0,0,0,0,0,1,0,1,0.14285714285714285,1,0.0,0,0,0,0,0,0,0,1,0,0,1,1
3095,93243,IsU1RKSKxT8SmvRzyXcC6emxRwMddmTJ,G8EPVSXsOYB5YQWZGiz1aVq5Pgr2GrQu,11,20,13,0,10,11,12,2,68,9.714285714285714,2,0.0,0,13,0,10,20,11,0,12,2,23,45,0
3096,93246,IAOTVxG7e06ArppQIZcVBCeppiZS52Zi,SpATywNh6bZuzm8s1ceuBUnMUAeoAHHw,10,7,2,0,2,1,7,1,20,2.857142857142857,2,0.0,0,2,0,2,7,1,0,7,1,4,16,1
3097,93271,RU7DM4q1MiWySLBD1tZoVnYmW4ZnJ0DL,RXDvfPUBYFlVdlueBFbLW0mhhAyGEqpt,1,0,0,0,0,0,1,0,1,0.14285714285714285,1,0.0,0,0,0,0,0,0,0,1,0,0,1,1
3098,93276,0e7xKBaDw3RmIMJpdHntjD8WC2jIp95k,SpATywNh6bZuzm8s1ceuBUnMUAeoAHHw,8,21,0,0,0,0,1,0,22,3.142857142857143,1,0.0,6,0,0,0,15,0,0,1,0,6,16,1
3099,93303,bHLTcAQFvIQJ6YaYh6r99cb370HZ5sPT,SpATywNh6bZuzm8s1ceuBUnMUAeoAHHw,1,0,0,0,0,0,1,0,1,0.14285714285714285,1,0.0,0,0,0,0,0,0,0,1,0,0,1,1
3100,93323,tyChfLhRWgtuzBYIo0LShbD6knUykDjv,G8EPVSXsOYB5YQWZGiz1aVq5Pgr2GrQu,23,14,10,66,6,11,8,1,116,16.571428571428573,1,0.0,4,10,56,6,10,11,10,8,1,76,40,1
3101,93330,HkYdxX3voGkfjdg703KviJnQhukKhxOh,G8EPVSXsOYB5YQWZGiz1aVq5Pgr2GrQu,1,0,0,0,0,0,2,0,2,0.2857142857142857,1,0.0,0,0,0,0,0,0,0,2,0,0,2,1
3102,93334,KFG6G55toGAeaWBt5UmyioW5n1NVxSjT,bWdj2GDclj5ofokWjzoa5jAwMkxCykd6,20,67,37,96,19,2,33,1,255,36.42857142857143,5,0.0,10,37,91,19,57,2,5,33,1,157,98,0
3103,93344,05Pe1SQ9Q2cBjcEFXjoLImyNIG21bK6A,RXDvfPUBYFlVdlueBFbLW0mhhAyGEqpt,2,0,0,0,0,0,2,0,2,0.2857142857142857,1,0.0,0,0,0,0,0,0,0,2,0,0,2,1
3104,93352,PR6nGGqGE6eMvOu04QC9agInMN1u3Vt7,A3fsA9Zfv1X2fVEQhTw51lKENdNrEqT3,23,16,14,0,13,0,3,0,46,6.571428571428571,1,0.0,0,14,0,13,16,0,0,3,0,27,19,1
3105,93367,hQNy1TJdPWXJGnnjdyetV1l4iHaSeol4,A3fsA9Zfv1X2fVEQhTw51lKENdNrEqT3,35,33,10,34,7,2,12,1,99,14.142857142857142,3,0.0,2,10,32,7,31,2,2,12,1,51,48,1
3106,93371,2XEzBTMWqAbDwimqhpYNFpmeQsMJgIYu,G8EPVSXsOYB5YQWZGiz1aVq5Pgr2GrQu,10,25,13,0,2,0,10,0,50,7.142857142857143,2,0.0,0,13,0,2,25,0,0,10,0,15,35,1
3107,93372,rdlkz4QUHd85FYWQkxx9tuSVm08spAcj,bWdj2GDclj5ofokWjzoa5jAwMkxCykd6,1,0,0,0,0,0,1,0,1,0.14285714285714285,1,0.0,0,0,0,0,0,0,0,1,0,0,1,1
3108,93389,CgiSBY8umD4OFxzPTCRENtvLfSjhJE4Q,A3fsA9Zfv1X2fVEQhTw51lKENdNrEqT3,1,0,0,0,0,0,1,0,1,0.14285714285714285,1,0.0,0,0,0,0,0,0,0,1,0,0,1,1
3109,93391,zFhrdwHMxq2geDsJ6rOF9PjKHNvVI11p,A3fsA9Zfv1X2fVEQhTw51lKENdNrEqT3,12,6,5,0,5,0,1,0,17,2.4285714285714284,1,0.0,0,5,0,5,6,0,0,1,0,10,7,1
3110,93394,grc1pAXqdUQaBlZrZyROqjuEtg08nen2,A3fsA9Zfv1X2fVEQhTw51lKENdNrEqT3,6,4,1,0,0,0,3,0,8,1.1428571428571428,1,0.0,0,1,0,0,4,0,0,3,0,1,7,0
3111,93398,EjONyt33Kb19bd7xhGUM8lVieVH4ABMt,SpATywNh6bZuzm8s1ceuBUnMUAeoAHHw,5,2,1,0,1,0,2,0,6,0.8571428571428571,1,0.0,0,1,0,1,2,0,0,2,0,2,4,1
3112,93406,wCSstPXY2jshjpNaBAQvMm9l3Kvl06VT,bWdj2GDclj5ofokWjzoa5jAwMkxCykd6,7,27,0,0,1,0,6,0,34,4.857142857142857,3,0.0,2,0,0,1,25,0,0,6,0,3,31,1
3113,93430,ThGblU6q4nWmu3ORXgM7eQc8q9vcBP4r,bWdj2GDclj5ofokWjzoa5jAwMkxCykd6,11,21,8,4,6,0,12,0,51,7.285714285714286,2,0.0,4,8,4,6,17,0,0,12,0,22,29,1
3114,93443,urLIpfHBZDaCypO84XCYKp0hFEe7SU3u,SpATywNh6bZuzm8s1ceuBUnMUAeoAHHw,1,0,0,0,0,0,1,0,1,0.14285714285714285,1,0.0,0,0,0,0,0,0,0,1,0,0,1,1
3115,93469,rBjcfaRB4ipdhdlaYne0HS9fWNfJaL2z,A3fsA9Zfv1X2fVEQhTw51lKENdNrEqT3,2,0,0,0,0,1,4,0,5,0.7142857142857143,1,0.0,0,0,0,0,0,1,0,4,0,0,5,1
3116,93474,lsFZ5c3HC6SK6E53cEs8WDQLHZpNYjV8,A3fsA9Zfv1X2fVEQhTw51lKENdNrEqT3,1,0,0,0,0,0,1,0,1,0.14285714285714285,1,0.0,0,0,0,0,0,0,0,1,0,0,1,1
3117,93502,rukBWzj11e0XTZm12B6q1NVFBvhUpKcw,A3fsA9Zfv1X2fVEQhTw51lKENdNrEqT3,34,22,0,44,0,1,5,0,72,10.285714285714286,1,0.0,2,0,41,0,20,1,3,5,0,43,29,1
3118,93508,ESEu5Ebb0Dwu6eqKhLWhzsorI0PztGwh,bWdj2GDclj5ofokWjzoa5jAwMkxCykd6,7,10,0,0,0,0,7,0,17,2.4285714285714284,1,0.0,0,0,0,0,10,0,0,7,0,0,17,1
3119,93516,dkuQt2AJ3psLoe6oAyOQ02agP8eEbROK,A3fsA9Zfv1X2fVEQhTw51lKENdNrEqT3,1,0,0,0,0,0,1,0,1,0.14285714285714285,1,0.0,0,0,0,0,0,0,0,1,0,0,1,1
3120,93532,d78tyy5GbLAmAIYTt0zQeNafrfAUEUnp,SpATywNh6bZuzm8s1ceuBUnMUAeoAHHw,1,0,0,0,0,0,1,0,1,0.14285714285714285,1,0.0,0,0,0,0,0,0,0,1,0,0,1,1
3121,93539,hZR4MwcYec4g0GoOyJFngJGEyWOySpv2,SpATywNh6bZuzm8s1ceuBUnMUAeoAHHw,16,50,32,10,20,21,27,0,160,22.857142857142858,5,0.0,7,32,8,20,43,21,2,27,0,67,93,0
3122,93540,uSL2RaFO9pFGmE8bYQrfyJmRnbBOdoyU,SpATywNh6bZuzm8s1ceuBUnMUAeoAHHw,15,19,0,17,0,31,6,1,74,10.571428571428571,1,0.0,2,0,15,0,17,31,2,6,1,17,57,1
3123,93541,ThGblU6q4nWmu3ORXgM7eQc8q9vcBP4r,SpATywNh6bZuzm8s1ceuBUnMUAeoAHHw,14,26,8,10,2,0,7,0,53,7.571428571428571,2,0.0,5,8,9,2,21,0,1,7,0,24,29,1
3124,93555,mG2KwufBG46hwF0tMEUG2jvsfUa3PSHf,SpATywNh6bZuzm8s1ceuBUnMUAeoAHHw,11,11,7,0,4,0,2,0,24,3.4285714285714284,1,0.0,1,7,0,4,10,0,0,2,0,12,12,0
3125,93571,XqasR5GIfOx9ytwr0b8Q6Z12NNCt5pqh,bWdj2GDclj5ofokWjzoa5jAwMkxCykd6,6,4,2,0,2,0,3,0,11,1.5714285714285714,2,0.0,0,2,0,2,4,0,0,3,0,4,7,0
3126,93574,we9tWnySpl1G7k7FqyXPj8wmC2gUYK0W,bWdj2GDclj5ofokWjzoa5jAwMkxCykd6,1,0,0,0,0,0,1,0,1,0.14285714285714285,1,0.0,0,0,0,0,0,0,0,1,0,0,1,1
3127,93575,kRwbDFbRADlNU7lsdYCaasRGNiEpQeeP,SpATywNh6bZuzm8s1ceuBUnMUAeoAHHw,8,7,3,0,3,0,1,0,14,2.0,1,0.0,0,3,0,3,7,0,0,1,0,6,8,1
3128,93597,i0nkxYulaHR9i5zqaHNFQeOz0iG2pS8U,A3fsA9Zfv1X2fVEQhTw51lKENdNrEqT3,9,13,6,0,2,0,4,0,25,3.5714285714285716,2,0.0,0,6,0,2,13,0,0,4,0,8,17,0
3129,93611,mG2KwufBG46hwF0tMEUG2jvsfUa3PSHf,RXDvfPUBYFlVdlueBFbLW0mhhAyGEqpt,22,15,13,0,9,0,1,0,38,5.428571428571429,1,0.0,1,13,0,9,14,0,0,1,0,23,15,0
3130,93620,HJ2Te0AnFOdWtPQ1mbU0gvcfD3BsPlu2,SpATywNh6bZuzm8s1ceuBUnMUAeoAHHw,17,31,18,8,3,13,16,1,90,12.857142857142858,3,0.0,6,18,8,3,25,13,0,16,1,35,55,0
3131,93625,MrZt24U8nbuIX2mCMw4lqKt5FUFOZURE,SpATywNh6bZuzm8s1ceuBUnMUAeoAHHw,1,0,0,0,0,0,1,0,1,0.14285714285714285,1,0.0,0,0,0,0,0,0,0,1,0,0,1,1
3132,93626,ae9lMjY6PaxC3JKoLUmKZvfdwEZiOBPx,G8EPVSXsOYB5YQWZGiz1aVq5Pgr2GrQu,5,2,1,0,1,0,2,0,6,0.8571428571428571,1,0.0,0,1,0,1,2,0,0,2,0,2,4,1
3133,93639,Pd0CZHVPAay5ceQzChjGxlgmgiQ8cqjG,G8EPVSXsOYB5YQWZGiz1aVq5Pgr2GrQu,5,2,1,0,1,0,4,0,8,1.1428571428571428,1,0.0,0,1,0,1,2,0,0,4,0,2,6,1
3134,93645,Qbhh4psghTMTs2MbZkpJwwkpxbM26vfP,SpATywNh6bZuzm8s1ceuBUnMUAeoAHHw,4,0,0,0,0,0,3,2,5,0.7142857142857143,1,0.0,0,0,0,0,0,0,0,3,2,0,5,1
3135,93657,QO30UexmdD88uyPYe6YK3wSk3JLKQBe3,A3fsA9Zfv1X2fVEQhTw51lKENdNrEqT3,8,2,1,0,1,1,10,1,16,2.2857142857142856,2,0.0,0,1,0,1,2,1,0,10,1,2,14,1
3136,93659,F731sqjciH519ML4GCaVvNQuuR5Oaq9t,A3fsA9Zfv1X2fVEQhTw51lKENdNrEqT3,4,2,1,0,1,0,2,0,6,0.8571428571428571,1,0.0,0,1,0,1,2,0,0,2,0,2,4,1
3137,93679,ju4nY4FL2KNi1hifJCQn8sVUqJICxh4O,SpATywNh6bZuzm8s1ceuBUnMUAeoAHHw,16,13,7,18,4,0,5,0,47,6.714285714285714,2,0.0,2,7,16,4,11,0,2,5,0,29,18,1
3138,93686,pXBkDxIpO7cvN4HkForKspl0UN1aLwbn,A3fsA9Zfv1X2fVEQhTw51lKENdNrEqT3,1,0,0,0,0,0,1,0,1,0.14285714285714285,1,0.0,0,0,0,0,0,0,0,1,0,0,1,1
3139,93689,KXi2lu4GlKmrO1lJTLg3t4l701rvNXNZ,A3fsA9Zfv1X2fVEQhTw51lKENdNrEqT3,45,34,22,44,13,9,18,3,143,20.428571428571427,6,0.0,4,22,42,13,30,9,2,18,3,81,62,0
3140,93702,5JlWaFjebQSvyUeyQLJ4C0BlriWkf8Hy,SpATywNh6bZuzm8s1ceuBUnMUAeoAHHw,14,23,1,17,2,0,4,0,47,6.714285714285714,2,0.0,15,1,15,2,8,0,2,4,0,33,14,1
3141,93706,OCOZunZP01no4Zh4NYF1FDXoOWZrc1Yv,G8EPVSXsOYB5YQWZGiz1aVq5Pgr2GrQu,16,14,4,0,5,1,8,1,33,4.714285714285714,1,0.0,6,4,0,5,8,1,0,8,1,15,18,1
3142,93724,VvbZjK8y9aernnsSHvAW377h2uAEkOuF,SpATywNh6bZuzm8s1ceuBUnMUAeoAHHw,6,0,0,0,0,1,5,1,7,1.0,1,0.0,0,0,0,0,0,1,0,5,1,0,7,1
3143,93748,qYBrztNE2m7Kv5jO5Me3GoAEoNnGgBEu,G8EPVSXsOYB5YQWZGiz1aVq5Pgr2GrQu,10,13,3,0,2,5,13,2,38,5.428571428571429,1,0.0,3,3,0,2,10,5,0,13,2,8,30,1
3144,93749,jqfntS6RKR0gZFQrp9eaCMToaEgoc2Xi,SpATywNh6bZuzm8s1ceuBUnMUAeoAHHw,1,0,0,0,0,0,1,0,1,0.14285714285714285,1,0.0,0,0,0,0,0,0,0,1,0,0,1,1
3145,93753,fCj90D5XHmebJ0IrbbuHaVfcb7tqMxkl,bWdj2GDclj5ofokWjzoa5jAwMkxCykd6,18,98,27,28,20,2,23,1,199,28.428571428571427,2,0.0,25,27,21,20,73,2,7,23,1,93,106,1
3146,93815,F7cOObRHTu5td8ezD8oRze1BhvyOKDSk,SpATywNh6bZuzm8s1ceuBUnMUAeoAHHw,8,6,3,0,1,0,2,0,12,1.7142857142857142,1,0.0,2,3,0,1,4,0,0,2,0,6,6,1
3147,93825,mEXFRacWKZUZ0ZrkucFcb0mHAIpc1jKZ,G8EPVSXsOYB5YQWZGiz1aVq5Pgr2GrQu,6,3,0,0,1,1,2,0,7,1.0,1,0.0,0,0,0,1,3,1,0,2,0,1,6,1
3148,93827,qKm0x9dl3CcMx4vyQxKmKiMsD63vzUte,bWdj2GDclj5ofokWjzoa5jAwMkxCykd6,1,0,0,0,0,0,1,0,1,0.14285714285714285,1,0.0,0,0,0,0,0,0,0,1,0,0,1,1
3149,93829,O9HNCpYyjeUf5Yv9cKak2CowRvtq7CSH,SpATywNh6bZuzm8s1ceuBUnMUAeoAHHw,12,16,9,0,4,0,12,1,42,6.0,3,0.0,1,9,0,4,15,0,0,12,1,14,28,1
3150,93832,60ov46MOFnBiXMZrd5NKEQiqC0SiurVf,A3fsA9Zfv1X2fVEQhTw51lKENdNrEqT3,9,9,1,0,1,0,7,0,18,2.5714285714285716,2,0.0,0,1,0,1,9,0,0,7,0,2,16,1
3151,93836,b3eTIICIpBOeQwbL52WcSz5BKSnmXD5x,SpATywNh6bZuzm8s1ceuBUnMUAeoAHHw,10,6,4,0,2,0,6,1,19,2.7142857142857144,1,0.0,0,4,0,2,6,0,0,6,1,6,13,1
3152,93838,fkbxkXpN20umRnEu1JAMVCW41OYjb7dl,A3fsA9Zfv1X2fVEQhTw51lKENdNrEqT3,6,3,1,0,0,1,5,0,10,1.4285714285714286,1,0.0,0,1,0,0,3,1,0,5,0,1,9,1
3153,93874,mSs5bB1Rxg3xYWjWjJY9pVTt7WAiMgyu,SpATywNh6bZuzm8s1ceuBUnMUAeoAHHw,9,19,10,0,3,34,24,0,90,12.857142857142858,4,0.0,0,10,0,3,19,34,0,24,0,13,77,0
3154,93877,SjBgrEi81Cf6wmEgkI03BQFCuncsAECU,SpATywNh6bZuzm8s1ceuBUnMUAeoAHHw,4,0,0,0,0,0,4,0,4,0.5714285714285714,1,0.0,0,0,0,0,0,0,0,4,0,0,4,0
3155,93909,5Ikem26Scse18GVLkwyf1cheWsOPE25C,SpATywNh6bZuzm8s1ceuBUnMUAeoAHHw,8,5,3,0,2,0,3,0,13,1.8571428571428572,2,0.0,0,3,0,2,5,0,0,3,0,5,8,1
3156,93912,EicwSyKru5cUE8FbnBvU3nlCh4zs6SDU,SpATywNh6bZuzm8s1ceuBUnMUAeoAHHw,1,0,0,0,0,0,1,0,1,0.14285714285714285,1,0.0,0,0,0,0,0,0,0,1,0,0,1,1
3157,93943,oNQaCuO2rlrLriXUbP7yibkLZ8kZEP0A,SpATywNh6bZuzm8s1ceuBUnMUAeoAHHw,13,11,5,12,3,0,2,0,33,4.714285714285714,2,0.0,2,5,12,3,9,0,0,2,0,22,11,1
3158,93964,0bPKxjIIw0GaiIYeAS2yIr8ZqMELBNL4,RXDvfPUBYFlVdlueBFbLW0mhhAyGEqpt,5,6,4,0,0,0,2,0,12,1.7142857142857142,2,0.0,0,4,0,0,6,0,0,2,0,4,8,0
3159,93996,xV4buLLcPPEcE2C8BKOwlQiGdSlriMdM,RXDvfPUBYFlVdlueBFbLW0mhhAyGEqpt,1,0,0,0,0,0,2,0,2,0.2857142857142857,1,0.0,0,0,0,0,0,0,0,2,0,0,2,1
3160,94003,aj6uF4XWV3XUUfOpWCk3NuntI2wXym6n,A3fsA9Zfv1X2fVEQhTw51lKENdNrEqT3,9,6,0,0,0,0,17,1,24,3.4285714285714284,1,0.0,0,0,0,0,6,0,0,17,1,0,24,1
3161,94042,75ii7mb7d3VTc7Qrw6mG6DwTa15X98oH,SpATywNh6bZuzm8s1ceuBUnMUAeoAHHw,4,5,2,0,0,0,2,0,9,1.2857142857142858,1,0.0,0,2,0,0,5,0,0,2,0,2,7,0
3162,94044,t88wfrSqhn6m3ghlAqrTBAHAFrsZ2sxt,bWdj2GDclj5ofokWjzoa5jAwMkxCykd6,10,8,4,0,2,15,12,0,41,5.857142857142857,2,0.0,0,4,0,2,8,15,0,12,0,6,35,1
3163,94053,x5ZyS8ChPKTwgxrKWhGeApVsRxKYNf86,bWdj2GDclj5ofokWjzoa5jAwMkxCykd6,1,0,0,0,0,0,1,0,1,0.14285714285714285,1,0.0,0,0,0,0,0,0,0,1,0,0,1,1
3164,94054,nNPe0gYBpuLKMy034NoRKs4SMhD1YQxV,G8EPVSXsOYB5YQWZGiz1aVq5Pgr2GrQu,12,7,6,0,5,0,2,0,20,2.857142857142857,1,0.0,0,6,0,5,7,0,0,2,0,11,9,1
3165,94055,OK36i7c8u9GmSfG9DXL0YN94pRFkcmzE,SpATywNh6bZuzm8s1ceuBUnMUAeoAHHw,16,19,10,12,3,1,6,0,51,7.285714285714286,2,0.0,4,10,11,3,15,1,1,6,0,28,23,1
3166,94073,60AYcG1Aqq07FBEqNwevaiEWsxsSm68V,SpATywNh6bZuzm8s1ceuBUnMUAeoAHHw,18,31,12,6,4,39,15,1,108,15.428571428571429,3,0.0,8,12,6,4,23,39,0,15,1,30,78,1
3167,94075,8msGv7I17o9HQpLUg1Ukk6N7MNl4HPMn,A3fsA9Zfv1X2fVEQhTw51lKENdNrEqT3,5,3,0,0,0,0,5,0,8,1.1428571428571428,1,0.0,1,0,0,0,2,0,0,5,0,1,7,1
3168,94105,Crjc5H6MpWbzy0UxdiisUjbxslQAKkU9,SpATywNh6bZuzm8s1ceuBUnMUAeoAHHw,16,24,9,10,4,2,8,1,58,8.285714285714286,2,0.0,9,9,9,4,15,2,1,8,1,31,27,0
3169,94112,DHDCrD1ELgYhngP3vqwv1nXGZcmsEo8S,G8EPVSXsOYB5YQWZGiz1aVq5Pgr2GrQu,1,0,0,0,0,0,1,0,1,0.14285714285714285,1,0.0,0,0,0,0,0,0,0,1,0,0,1,1
3170,94115,uCjPUqEQP5ztmFjHYApjKLEWGDYVXats,bWdj2GDclj5ofokWjzoa5jAwMkxCykd6,4,2,1,0,0,0,3,0,6,0.8571428571428571,1,0.0,0,1,0,0,2,0,0,3,0,1,5,1
3171,94117,dW2So4dhz8sFwZQzndBoTpsFa69MFo0q,SpATywNh6bZuzm8s1ceuBUnMUAeoAHHw,15,16,9,12,2,1,5,1,46,6.571428571428571,1,0.0,5,9,11,2,11,1,1,5,1,27,19,1
3172,94123,u3SPm1HFwlhJpJKaAvQIjwvJr5QcuOph,SpATywNh6bZuzm8s1ceuBUnMUAeoAHHw,5,2,1,0,1,0,2,0,6,0.8571428571428571,1,0.0,0,1,0,1,2,0,0,2,0,2,4,1
3173,94137,DHDCrD1ELgYhngP3vqwv1nXGZcmsEo8S,SpATywNh6bZuzm8s1ceuBUnMUAeoAHHw,1,0,0,0,0,0,2,0,2,0.2857142857142857,1,0.0,0,0,0,0,0,0,0,2,0,0,2,1
3174,94144,uJQbjSAUKl9mATLkoLUgrR5h8oVXq5wA,bWdj2GDclj5ofokWjzoa5jAwMkxCykd6,7,2,1,0,1,0,5,2,11,1.5714285714285714,1,0.0,0,1,0,1,2,0,0,5,2,2,9,1
3175,94146,kvf1WFygeLGKOFkoertca6J9TDxV9fcY,bWdj2GDclj5ofokWjzoa5jAwMkxCykd6,8,9,6,10,6,0,1,0,32,4.571428571428571,2,0.0,1,6,8,6,8,0,2,1,0,21,11,1
3176,94147,kvf1WFygeLGKOFkoertca6J9TDxV9fcY,A3fsA9Zfv1X2fVEQhTw51lKENdNrEqT3,10,7,6,0,6,0,1,0,20,2.857142857142857,2,0.0,0,6,0,6,7,0,0,1,0,12,8,1
3177,94165,SoWAM0SsQFATkJWX6mveBwbG0XzudUfF,RXDvfPUBYFlVdlueBFbLW0mhhAyGEqpt,6,3,2,0,1,0,3,0,9,1.2857142857142858,1,0.0,0,2,0,1,3,0,0,3,0,3,6,1
3178,94182,iFoaVRNiF8fcNT1I1ii4FKoAviHvnVwj,SpATywNh6bZuzm8s1ceuBUnMUAeoAHHw,1,0,0,0,0,0,1,0,1,0.14285714285714285,1,0.0,0,0,0,0,0,0,0,1,0,0,1,1
3179,94188,OFXXpJjmXQdJCa3neipnRUGCkhEYKOcL,SpATywNh6bZuzm8s1ceuBUnMUAeoAHHw,7,6,1,0,0,0,3,0,10,1.4285714285714286,1,0.0,0,1,0,0,6,0,0,3,0,1,9,0
3180,94196,BZpQDGkWvmHTN4poCEi9fdZmAWn1G3Rj,RXDvfPUBYFlVdlueBFbLW0mhhAyGEqpt,11,8,7,0,7,0,5,0,27,3.857142857142857,1,0.0,0,7,0,7,8,0,0,5,0,14,13,1
3181,94201,68BjCXfBFqeZ01fFx1csrFmvef5xs0w2,A3fsA9Zfv1X2fVEQhTw51lKENdNrEqT3,5,2,1,0,1,0,3,0,7,1.0,1,0.0,0,1,0,1,2,0,0,3,0,2,5,1
3182,94216,4cB4y17zVi4jfdrlreMIHGN1aQJHMMST,A3fsA9Zfv1X2fVEQhTw51lKENdNrEqT3,4,2,0,0,0,0,2,0,4,0.5714285714285714,1,0.0,0,0,0,0,2,0,0,2,0,0,4,1
3183,94230,dW2So4dhz8sFwZQzndBoTpsFa69MFo0q,A3fsA9Zfv1X2fVEQhTw51lKENdNrEqT3,1,0,0,0,0,0,1,0,1,0.14285714285714285,1,0.0,0,0,0,0,0,0,0,1,0,0,1,1
3184,94238,Zy1VvDhL0b8E5oL4KNZb2wbF72hVCk4q,bWdj2GDclj5ofokWjzoa5jAwMkxCykd6,1,0,0,0,0,0,1,0,1,0.14285714285714285,1,0.0,0,0,0,0,0,0,0,1,0,0,1,1
3185,94250,hhHp518gAY3TOdaw37KX2gsPHN1LkpFC,G8EPVSXsOYB5YQWZGiz1aVq5Pgr2GrQu,7,6,1,0,2,0,2,0,11,1.5714285714285714,1,0.0,2,1,0,2,4,0,0,2,0,5,6,1
3186,94252,jKLLTSaN1oSiVcsyuWIwr9NVnuZSs3oX,A3fsA9Zfv1X2fVEQhTw51lKENdNrEqT3,5,4,2,0,1,0,3,0,10,1.4285714285714286,1,0.0,0,2,0,1,4,0,0,3,0,3,7,1
3187,94254,r9IhUgJi3OB3rtBncFGHCU1M0fOjKF1s,SpATywNh6bZuzm8s1ceuBUnMUAeoAHHw,14,20,8,17,4,0,2,0,51,7.285714285714286,2,0.0,10,8,15,4,10,0,2,2,0,37,14,1
3188,94263,9BiLYY350hgtHO5tL7nbMfcZU0JcfZbs,A3fsA9Zfv1X2fVEQhTw51lKENdNrEqT3,7,7,2,0,1,0,6,0,16,2.2857142857142856,2,0.0,2,2,0,1,5,0,0,6,0,5,11,1
3189,94275,gxKNGjI9pNbjjsMSjrRysbX0ykCNYwqn,bWdj2GDclj5ofokWjzoa5jAwMkxCykd6,4,3,1,0,1,0,1,0,6,0.8571428571428571,1,0.0,0,1,0,1,3,0,0,1,0,2,4,1
3190,94283,PSQvTxj1y3we6BHzfg47qDUvmFQLocrD,A3fsA9Zfv1X2fVEQhTw51lKENdNrEqT3,1,0,0,0,0,0,1,0,1,0.14285714285714285,1,0.0,0,0,0,0,0,0,0,1,0,0,1,1
3191,94300,5Lcwdb3Myw57AK6P9mHbDDRptSFCTb8f,A3fsA9Zfv1X2fVEQhTw51lKENdNrEqT3,11,5,4,0,4,0,5,0,18,2.5714285714285716,1,0.0,0,4,0,4,5,0,0,5,0,8,10,1
3192,94311,Gl03eSeNtb7juYcfyy4T6xQkEEhQalIx,SpATywNh6bZuzm8s1ceuBUnMUAeoAHHw,10,10,3,14,2,0,1,0,30,4.285714285714286,3,0.0,2,3,10,2,8,0,4,1,0,17,13,1
3193,94322,7CHeHg2oDOu9Zq2LKINtBF6E413tCv88,SpATywNh6bZuzm8s1ceuBUnMUAeoAHHw,5,2,1,0,1,0,2,0,6,0.8571428571428571,1,0.0,0,1,0,1,2,0,0,2,0,2,4,1
3194,94328,plAreEiDkQpc8zc9xmMhqujDBy2S6jmC,SpATywNh6bZuzm8s1ceuBUnMUAeoAHHw,12,55,10,9,2,0,19,0,95,13.571428571428571,2,0.0,0,10,7,2,55,0,2,19,0,19,76,1
3195,94331,MreMBBpkQsLa4FQRsMj3EyXahyuFtEaB,SpATywNh6bZuzm8s1ceuBUnMUAeoAHHw,1,0,0,0,0,0,1,0,1,0.14285714285714285,1,0.0,0,0,0,0,0,0,0,1,0,0,1,1
3196,94358,9aS1NSJb2Hj0xHbbuoyhLmktYrjypxsy,G8EPVSXsOYB5YQWZGiz1aVq5Pgr2GrQu,6,0,0,0,0,0,6,1,7,1.0,1,0.0,0,0,0,0,0,0,0,6,1,0,7,1
3197,94376,uJRuDDw60tHrnuGJQZHSpoPAWASu6Wpf,SpATywNh6bZuzm8s1ceuBUnMUAeoAHHw,1,0,0,0,0,0,1,0,1,0.14285714285714285,1,0.0,0,0,0,0,0,0,0,1,0,0,1,0
3198,94382,au8A4X0QHQjQtIJwXFEgDKJdutxB5gYJ,SpATywNh6bZuzm8s1ceuBUnMUAeoAHHw,1,0,0,0,0,0,1,0,1,0.14285714285714285,1,0.0,0,0,0,0,0,0,0,1,0,0,1,1
3199,94383,OEUelCFKE8Wek74t5oKIe6H8MCi9M5Fi,RXDvfPUBYFlVdlueBFbLW0mhhAyGEqpt,1,0,0,0,0,0,1,0,1,0.14285714285714285,1,0.0,0,0,0,0,0,0,0,1,0,0,1,1
3200,94407,vCP75aDcEh5tNmLpxZodjHI02YfPV1g7,SpATywNh6bZuzm8s1ceuBUnMUAeoAHHw,2,0,0,0,0,0,7,0,7,1.0,2,0.0,0,0,0,0,0,0,0,7,0,0,7,1
3201,94408,kdTkyJM1xm4AQ2tXVSlZpNtOhQ8qhZ4V,SpATywNh6bZuzm8s1ceuBUnMUAeoAHHw,7,6,3,0,2,0,3,0,14,2.0,2,0.0,0,3,0,2,6,0,0,3,0,5,9,0
3202,94410,nTOZ6H8wygvPupRg4OwxXR9Zcu1XdDxE,RXDvfPUBYFlVdlueBFbLW0mhhAyGEqpt,1,0,0,0,0,0,1,0,1,0.14285714285714285,1,0.0,0,0,0,0,0,0,0,1,0,0,1,1
3203,94435,ZYJOgN8hxER8FBZMxsFqu3ZMgr4hrlRX,A3fsA9Zfv1X2fVEQhTw51lKENdNrEqT3,8,8,1,0,1,0,6,0,16,2.2857142857142856,1,0.0,0,1,0,1,8,0,0,6,0,2,14,1
3204,94443,FZWt1vapJFvo3kXFvlr3Pcq5dqSsXIdl,SpATywNh6bZuzm8s1ceuBUnMUAeoAHHw,7,8,5,0,4,0,3,0,20,2.857142857142857,2,0.0,0,5,0,4,8,0,0,3,0,9,11,1
3205,94449,YxWG3o8ByCvMoGHw8Fk45RhqzVf3tFyr,A3fsA9Zfv1X2fVEQhTw51lKENdNrEqT3,6,1,1,0,1,0,3,0,6,0.8571428571428571,1,0.0,0,1,0,1,1,0,0,3,0,2,4,1
3206,94454,HH9Roah3kzSupaHq1oHsqsjNMJy1K6WP,SpATywNh6bZuzm8s1ceuBUnMUAeoAHHw,6,8,1,0,1,0,2,0,12,1.7142857142857142,1,0.0,0,1,0,1,8,0,0,2,0,2,10,1
3207,94456,Yanv54bl6PB6cYN02rxbrTLlDFz7wAgw,A3fsA9Zfv1X2fVEQhTw51lKENdNrEqT3,2,0,0,0,0,0,2,0,2,0.2857142857142857,1,0.0,0,0,0,0,0,0,0,2,0,0,2,1
3208,94463,1dYxxqjVQ41eWA49zU6M54bp0RizbhKR,SpATywNh6bZuzm8s1ceuBUnMUAeoAHHw,6,5,3,0,1,0,3,0,12,1.7142857142857142,1,0.0,0,3,0,1,5,0,0,3,0,4,8,1
3209,94464,VvCLt24WQ5JOcwPfT9E7uWcGIgf1BHix,SpATywNh6bZuzm8s1ceuBUnMUAeoAHHw,14,15,10,14,5,2,3,0,49,7.0,1,0.0,3,10,11,5,12,2,3,3,0,29,20,1
3210,94486,gl2YVlebVAvCcxsYaIoTwLj5l1IGqntH,SpATywNh6bZuzm8s1ceuBUnMUAeoAHHw,5,6,2,4,0,0,1,0,13,1.8571428571428572,1,0.0,2,2,4,0,4,0,0,1,0,8,5,0
3211,94496,We4HBkPE9Li2HHwmAADy328h9IORRs2l,G8EPVSXsOYB5YQWZGiz1aVq5Pgr2GrQu,1,0,0,0,0,0,1,0,1,0.14285714285714285,1,0.0,0,0,0,0,0,0,0,1,0,0,1,1
3212,94914,JdoyFe3ty0dkGc2UNdH7TaneDWe8Wbb5,fbPkOYLVPtPgIt0MxizjfFJov3JbHyAi,4,2,1,0,1,0,2,0,6,0.8571428571428571,2,0.0,0,1,0,1,2,0,0,2,0,2,4,1
3213,94917,GGhAGkRWD8jJVxrhUk5siJ00MzWLACx9,fbPkOYLVPtPgIt0MxizjfFJov3JbHyAi,2,0,0,0,0,0,3,0,3,0.42857142857142855,1,0.0,0,0,0,0,0,0,0,3,0,0,3,1
3214,94918,kWBY2KD53mjK2UMWhmo4HB3TIG4iJtfA,fbPkOYLVPtPgIt0MxizjfFJov3JbHyAi,11,7,4,6,4,0,3,0,24,3.4285714285714284,1,0.0,2,4,5,4,5,0,1,3,0,15,9,1
3215,94919,nLVkMUicIATb5XjlrKkVLbPcf3PrrUv6,fbPkOYLVPtPgIt0MxizjfFJov3JbHyAi,6,3,2,0,1,0,2,0,8,1.1428571428571428,1,0.0,0,2,0,1,3,0,0,2,0,3,5,1
3216,94920,AP8Ylu2Hp0YwQapv0VHVFwlhcyAdQlKm,fbPkOYLVPtPgIt0MxizjfFJov3JbHyAi,5,2,1,0,1,2,2,0,8,1.1428571428571428,1,0.0,0,1,0,1,2,2,0,2,0,2,6,1
3217,94921,1befQ3fLzEOh8IrvCOjGmYb6nrbCw6Ba,fbPkOYLVPtPgIt0MxizjfFJov3JbHyAi,3,0,0,0,0,0,5,0,5,0.7142857142857143,1,0.0,0,0,0,0,0,0,0,5,0,0,5,1
3218,94922,21C2qWSN1ubnQXVLo4VQ89cKYqN6OnV0,fbPkOYLVPtPgIt0MxizjfFJov3JbHyAi,5,2,1,0,1,0,3,0,7,1.0,1,0.0,0,1,0,1,2,0,0,3,0,2,5,1
3219,94923,ZSOqN2ncEDCf8kkfE2fTiwunpGip3a3v,fbPkOYLVPtPgIt0MxizjfFJov3JbHyAi,6,3,2,0,2,0,2,0,9,1.2857142857142858,1,0.0,0,2,0,2,3,0,0,2,0,4,5,1
3220,94924,iPQOLnMFMpAtiKO2f4vUT5fNNyluHmyN,fbPkOYLVPtPgIt0MxizjfFJov3JbHyAi,1,0,0,0,0,0,1,0,1,0.14285714285714285,1,0.0,0,0,0,0,0,0,0,1,0,0,1,1
3221,94928,rrKLV6p6Omqho3GHHSoh0noB8Eyb4dBf,fbPkOYLVPtPgIt0MxizjfFJov3JbHyAi,8,3,2,0,2,3,6,1,17,2.4285714285714284,1,0.0,0,2,0,2,3,3,0,6,1,4,13,1
3222,94929,rrZSZFoEgH3bOKdkZ0UyNzOq7Pdyx5G0,fbPkOYLVPtPgIt0MxizjfFJov3JbHyAi,2,0,0,0,0,0,2,0,2,0.2857142857142857,1,0.0,0,0,0,0,0,0,0,2,0,0,2,1
3223,94930,m81QFtDkjk8PmvblUhrkX50T3OfNUlpC,fbPkOYLVPtPgIt0MxizjfFJov3JbHyAi,1,0,0,0,0,0,1,0,1,0.14285714285714285,1,0.0,0,0,0,0,0,0,0,1,0,0,1,1
3224,94931,YLWMEkP67YDwtagmvU5WKcZzKqdf99Vy,fbPkOYLVPtPgIt0MxizjfFJov3JbHyAi,7,5,2,0,1,0,4,0,12,1.7142857142857142,1,0.0,0,2,0,1,5,0,0,4,0,3,9,1
3225,94934,53AX9rmI3k6LH6bFgA3smsUSiak9PiH8,fbPkOYLVPtPgIt0MxizjfFJov3JbHyAi,9,15,5,5,2,1,3,0,31,4.428571428571429,1,0.0,3,5,5,2,12,1,0,3,0,15,16,1
3226,94938,ATZ830ERUxX8pXsrEHiyTC9qIj0J3xKL,fbPkOYLVPtPgIt0MxizjfFJov3JbHyAi,1,0,0,0,0,0,1,0,1,0.14285714285714285,1,0.0,0,0,0,0,0,0,0,1,0,0,1,1
3227,94941,PksTe80EnSZRP5IgVxGPpb2S7NuUyS61,fbPkOYLVPtPgIt0MxizjfFJov3JbHyAi,8,8,6,0,5,0,5,0,24,3.4285714285714284,1,0.0,0,6,0,5,8,0,0,5,0,11,13,1
3228,94943,2slXWNniikORlDrKt6rdY1XwdvOyFwgH,fbPkOYLVPtPgIt0MxizjfFJov3JbHyAi,6,3,2,0,2,0,1,0,8,1.1428571428571428,1,0.0,0,2,0,2,3,0,0,1,0,4,4,1
3229,94946,7uAP6PCGaUrEF1zOYcYy8DKDCb9pFsmY,fbPkOYLVPtPgIt0MxizjfFJov3JbHyAi,26,82,17,36,23,31,17,3,209,29.857142857142858,3,0.0,34,17,30,23,48,31,6,17,3,104,105,1
3230,94950,uf9uxJ0q9fqnk8v2mIZk18f6DfpdKvW8,fbPkOYLVPtPgIt0MxizjfFJov3JbHyAi,8,5,3,0,2,0,3,0,13,1.8571428571428572,1,0.0,0,3,0,2,5,0,0,3,0,5,8,1
3231,95384,9vMfKHFzhvmzdCBc05dqw5icnEdTUd5x,bWdj2GDclj5ofokWjzoa5jAwMkxCykd6,9,37,16,20,5,4,19,0,101,14.428571428571429,2,0.0,7,16,18,5,30,4,2,19,0,46,55,1
3232,95386,lVwgv61cg8fkhW9rg5b1PIPnuUWxb0Vk,A3fsA9Zfv1X2fVEQhTw51lKENdNrEqT3,43,37,25,76,13,226,44,10,431,61.57142857142857,7,0.0,4,25,58,13,33,226,18,44,10,100,331,0
3233,95398,SM6SmE3aMr36NQr3MbQQW1aFlehpkSNf,bWdj2GDclj5ofokWjzoa5jAwMkxCykd6,2,0,0,0,0,0,3,0,3,0.42857142857142855,1,0.0,0,0,0,0,0,0,0,3,0,0,3,1
3234,95425,79rw5BhFSnhvdIaVsXl3jeEXJRviIjGz,A3fsA9Zfv1X2fVEQhTw51lKENdNrEqT3,42,21,11,72,8,4,7,1,124,17.714285714285715,1,0.0,8,11,62,8,13,4,10,7,1,89,35,0
3235,95440,NT7bBO2hHEg05ci9UTFOwIHaUZMIdh9x,SpATywNh6bZuzm8s1ceuBUnMUAeoAHHw,9,13,4,14,1,0,2,0,34,4.857142857142857,1,0.0,7,4,12,1,6,0,2,2,0,24,10,1
3236,95461,M507IlBQp64NkSWnSkchjsahApLaE1kJ,A3fsA9Zfv1X2fVEQhTw51lKENdNrEqT3,6,3,2,0,2,0,1,0,8,1.1428571428571428,1,0.0,0,2,0,2,3,0,0,1,0,4,4,1
3237,95521,OF90Hu2g8vPUjKHCP4ULPYNMvRFKxBj6,SpATywNh6bZuzm8s1ceuBUnMUAeoAHHw,18,36,16,19,5,6,13,1,96,13.714285714285714,3,0.0,13,16,14,5,23,6,5,13,1,48,48,0
3238,95583,YaP2AuckukEZITP3IVvIt6Z8ci6RHew7,bWdj2GDclj5ofokWjzoa5jAwMkxCykd6,6,3,1,0,1,0,2,0,7,1.0,1,0.0,0,1,0,1,3,0,0,2,0,2,5,1
3239,95605,UaSh8dwx8gnofYbXlmpqj9uYDbpJ89pX,A3fsA9Zfv1X2fVEQhTw51lKENdNrEqT3,13,17,0,0,0,12,14,3,46,6.571428571428571,2,0.0,1,0,0,0,16,12,0,14,3,1,45,1
3240,95617,Daw06K1PSOXldo19kBgHP5sewulb7Vu5,A3fsA9Zfv1X2fVEQhTw51lKENdNrEqT3,4,2,1,0,1,0,2,0,6,0.8571428571428571,1,0.0,0,1,0,1,2,0,0,2,0,2,4,0
3241,95627,fxfoo3EegutxQePINTymJFzExTdNcKVI,SpATywNh6bZuzm8s1ceuBUnMUAeoAHHw,14,8,4,20,3,1,5,1,42,6.0,1,0.0,4,4,18,3,4,1,2,5,1,29,13,1
3242,95633,ZtofBugo33Zo9FroLN9tXtgl9O0zgDWY,SpATywNh6bZuzm8s1ceuBUnMUAeoAHHw,1,0,0,0,0,0,1,0,1,0.14285714285714285,1,0.0,0,0,0,0,0,0,0,1,0,0,1,0
3243,95726,9yvWwncWvyjvEU2gkB98t6ra5ZlqpOOe,SpATywNh6bZuzm8s1ceuBUnMUAeoAHHw,5,2,1,0,1,0,2,0,6,0.8571428571428571,1,0.0,0,1,0,1,2,0,0,2,0,2,4,1
3244,95852,nB9RnfPmq1WfPeBn5EUZt5ffKcXJEdE4,A3fsA9Zfv1X2fVEQhTw51lKENdNrEqT3,2,0,0,0,0,0,2,0,2,0.2857142857142857,2,0.0,0,0,0,0,0,0,0,2,0,0,2,1
3245,95901,jzWvwaTexkgbyBrPkQbXDb98Viqx6cSS,A3fsA9Zfv1X2fVEQhTw51lKENdNrEqT3,22,3,1,48,0,0,3,0,55,7.857142857142857,1,0.0,2,1,44,0,1,0,4,3,0,47,8,1
3246,96677,xOjhmcafCtLT2q16oVNZpjeZh4FUCy6U,A3fsA9Zfv1X2fVEQhTw51lKENdNrEqT3,1,0,0,0,0,0,1,0,1,0.14285714285714285,1,0.0,0,0,0,0,0,0,0,1,0,0,1,1
3247,96695,plWW2jbmbdQAaG18LPwZIwpV7ZE0ypXp,SpATywNh6bZuzm8s1ceuBUnMUAeoAHHw,7,1,1,0,1,0,4,1,8,1.1428571428571428,1,0.0,0,1,0,1,1,0,0,4,1,2,6,0
3248,96724,Vqh7IxciNu3w4ryq9DwYRMQWb1h8f16V,SpATywNh6bZuzm8s1ceuBUnMUAeoAHHw,15,18,6,22,4,23,9,3,85,12.142857142857142,1,0.0,6,6,19,4,12,23,3,9,3,35,50,1
3249,96732,RHsk3gHUm8VEfb9FwEFf8vBDNKZZ0LWe,A3fsA9Zfv1X2fVEQhTw51lKENdNrEqT3,11,6,4,0,3,5,5,2,25,3.5714285714285716,1,0.0,0,4,0,3,6,5,0,5,2,7,18,1
3250,96893,UAyWvSjTLiO8ve7HkUm43OX3XFSgIZD0,7GRhBDsirIGkRZBtSMEzNTyDr2JQm4xx,1,0,0,0,0,0,1,0,1,0.14285714285714285,1,0.0,0,0,0,0,0,0,0,1,0,0,1,1
3251,96895,Ip3irZsxFvOeGg8WSppVhJArbPhoH3qm,A3fsA9Zfv1X2fVEQhTw51lKENdNrEqT3,10,7,6,0,6,0,1,0,20,2.857142857142857,1,0.0,0,6,0,6,7,0,0,1,0,12,8,1
3252,96929,uaGHWOyiH6GRJNYQ5wYQgdGgJiyGijb7,SpATywNh6bZuzm8s1ceuBUnMUAeoAHHw,13,16,11,4,5,0,10,0,46,6.571428571428571,3,0.0,0,11,3,5,16,0,1,10,0,19,27,0
3253,96933,mgC2SKl3BkBHgSzUjS94KW5V0rxosMWt,SpATywNh6bZuzm8s1ceuBUnMUAeoAHHw,13,12,7,13,4,5,3,0,44,6.285714285714286,1,0.0,3,7,11,4,9,5,2,3,0,25,19,0
3254,96976,7pD3XwJqYTfsh0zZ4M07qj3DJAHtjtGm,7GRhBDsirIGkRZBtSMEzNTyDr2JQm4xx,1,0,0,0,0,0,1,0,1,0.14285714285714285,1,0.0,0,0,0,0,0,0,0,1,0,0,1,1
3255,96978,XoAmaAEiCQyqxGtldGa1yHbrXfsnSjbj,7GRhBDsirIGkRZBtSMEzNTyDr2JQm4xx,1,0,0,0,0,0,1,0,1,0.14285714285714285,1,0.0,0,0,0,0,0,0,0,1,0,0,1,1
3256,97014,MSXFOc30HZVbYZtATkSJwT5euFO05BA1,7GRhBDsirIGkRZBtSMEzNTyDr2JQm4xx,6,5,1,0,2,0,3,0,11,1.5714285714285714,1,0.0,3,1,0,2,2,0,0,3,0,6,5,1
3257,97068,XlT7X7Rn0fLTh36Iz42hC1Epd5u3ukUS,7GRhBDsirIGkRZBtSMEzNTyDr2JQm4xx,2,0,0,0,0,0,4,0,4,0.5714285714285714,1,0.0,0,0,0,0,0,0,0,4,0,0,4,1
3258,97102,RJ2AN96oZxuBCR52LgUmQpj4g9Y4mcD4,A3fsA9Zfv1X2fVEQhTw51lKENdNrEqT3,1,0,0,0,0,0,1,0,1,0.14285714285714285,1,0.0,0,0,0,0,0,0,0,1,0,0,1,1
3259,97104,pSX00XUyCx7VlmgWGN0d39OwC9BZ8bRV,7GRhBDsirIGkRZBtSMEzNTyDr2JQm4xx,1,0,0,0,0,0,1,0,1,0.14285714285714285,1,0.0,0,0,0,0,0,0,0,1,0,0,1,0
3260,97143,vcLosQzAVwhadotVELXCMAgXnlN9Qppp,7GRhBDsirIGkRZBtSMEzNTyDr2JQm4xx,12,4,3,0,1,8,7,1,24,3.4285714285714284,1,0.0,0,3,0,1,4,8,0,7,1,4,20,1
3261,97152,JGnVyZ53gH9wjqC3YYjpGEbabkw7ZVhR,A3fsA9Zfv1X2fVEQhTw51lKENdNrEqT3,1,0,0,0,0,0,1,0,1,0.14285714285714285,1,0.0,0,0,0,0,0,0,0,1,0,0,1,1
3262,97165,YE22fRNdaFtk3nhWfjSOMHWERX5O7Ymi,7GRhBDsirIGkRZBtSMEzNTyDr2JQm4xx,23,60,4,18,8,0,9,0,99,14.142857142857142,3,0.0,11,4,17,8,49,0,1,9,0,40,59,1
3263,97184,5DIcniD9kRbDupVPBNugV5by0SZHtD2e,7GRhBDsirIGkRZBtSMEzNTyDr2JQm4xx,1,0,0,0,0,0,1,0,1,0.14285714285714285,1,0.0,0,0,0,0,0,0,0,1,0,0,1,1
3264,97255,Ds7Ql2Fzh0y89y9XQaeLbThJFJ8LYIlx,7GRhBDsirIGkRZBtSMEzNTyDr2JQm4xx,1,0,0,0,0,0,1,0,1,0.14285714285714285,1,0.0,0,0,0,0,0,0,0,1,0,0,1,1
3265,97295,yrlVnbrSR0LAW13A08wi2wUW5yoGSw1G,7GRhBDsirIGkRZBtSMEzNTyDr2JQm4xx,5,6,3,0,0,0,1,0,10,1.4285714285714286,1,0.0,2,3,0,0,4,0,0,1,0,5,5,1
3266,97390,wHh7IyZg69gls07QnvzBvWbwxDpKJO6L,7GRhBDsirIGkRZBtSMEzNTyDr2JQm4xx,4,2,1,0,1,0,1,0,5,0.7142857142857143,1,0.0,0,1,0,1,2,0,0,1,0,2,3,1
3267,97437,YcAjMEQHzjEkIappgCA5LKxL8wrCHqZx,7GRhBDsirIGkRZBtSMEzNTyDr2JQm4xx,6,3,2,0,2,0,1,0,8,1.1428571428571428,1,0.0,0,2,0,2,3,0,0,1,0,4,4,1
3268,97447,DK4tMY4hv5jCEWYRZnAyqsGRGzDp2xfD,7GRhBDsirIGkRZBtSMEzNTyDr2JQm4xx,7,3,2,0,1,0,4,1,11,1.5714285714285714,1,0.0,0,2,0,1,3,0,0,4,1,3,8,1
3269,97459,gtKTzkXHwS41ljYVmjlLLf4WyQSkK02q,A3fsA9Zfv1X2fVEQhTw51lKENdNrEqT3,1,0,0,0,0,0,1,0,1,0.14285714285714285,1,0.0,0,0,0,0,0,0,0,1,0,0,1,0
3270,97468,LhMGo1H458StfoGsiIJMkiDJEIOqqbKe,7GRhBDsirIGkRZBtSMEzNTyDr2JQm4xx,1,0,0,0,0,0,1,0,1,0.14285714285714285,1,0.0,0,0,0,0,0,0,0,1,0,0,1,1
3271,97476,LDoKVa67JbCj3bIYTGTgWGEVPIBUkRDs,7GRhBDsirIGkRZBtSMEzNTyDr2JQm4xx,1,0,0,0,0,0,1,0,1,0.14285714285714285,1,0.0,0,0,0,0,0,0,0,1,0,0,1,1
3272,97478,9yD6wRS2N3SNxMC2ibpNMzfizxpTbLsY,7GRhBDsirIGkRZBtSMEzNTyDr2JQm4xx,4,2,1,0,1,0,1,0,5,0.7142857142857143,1,0.0,0,1,0,1,2,0,0,1,0,2,3,1
3273,97502,BVpzzXeXh42vyU3wE9rUQpEUs8P1ZpSo,7GRhBDsirIGkRZBtSMEzNTyDr2JQm4xx,3,2,1,0,0,0,1,0,4,0.5714285714285714,1,0.0,0,1,0,0,2,0,0,1,0,1,3,1
3274,97578,tJSuuWZXDdoXjZXIctAWwDLD7oHTWJ9T,7GRhBDsirIGkRZBtSMEzNTyDr2JQm4xx,1,0,0,0,0,0,2,0,2,0.2857142857142857,2,0.0,0,0,0,0,0,0,0,2,0,0,2,1
3275,97701,PlRR5bewxY5s5UPrV9qsB2qkDqRzxPQw,7GRhBDsirIGkRZBtSMEzNTyDr2JQm4xx,7,3,2,0,2,0,2,0,9,1.2857142857142858,1,0.0,0,2,0,2,3,0,0,2,0,4,5,1
3276,97805,tPYh43YRHAzuf09xESxSKtWvST0aCsjn,7GRhBDsirIGkRZBtSMEzNTyDr2JQm4xx,25,26,8,22,7,0,1,0,64,9.142857142857142,1,0.0,17,8,22,7,9,0,0,1,0,54,10,1
3277,97840,Ffohn9JNnGJQD2IavzMTS00ubnVtcb2T,A3fsA9Zfv1X2fVEQhTw51lKENdNrEqT3,43,19,14,60,10,0,6,0,109,15.571428571428571,3,0.0,1,14,52,10,18,0,8,6,0,77,32,0
3278,97846,DwUuHlykLcu2QOJPkMlSk4MpGYyYCYXn,7GRhBDsirIGkRZBtSMEzNTyDr2JQm4xx,4,0,0,0,0,0,4,1,5,0.7142857142857143,1,0.0,0,0,0,0,0,0,0,4,1,0,5,1
3279,98953,lcykm3uj0WkC2rJwnpw8jWVXHYstRrPs,bWdj2GDclj5ofokWjzoa5jAwMkxCykd6,2,0,0,0,0,0,2,0,2,0.2857142857142857,1,0.0,0,0,0,0,0,0,0,2,0,0,2,1
3280,98956,O2hEYcKpW3bz7TyhhkMeHOTvhvdMjulM,bWdj2GDclj5ofokWjzoa5jAwMkxCykd6,5,6,1,0,1,0,1,0,9,1.2857142857142858,1,0.0,0,1,0,1,6,0,0,1,0,2,7,1
3281,98966,oy7Pg8T5wy30VY5zamAkBAwv1iuWjap6,RXDvfPUBYFlVdlueBFbLW0mhhAyGEqpt,11,9,5,0,3,0,3,0,20,2.857142857142857,1,0.0,0,5,0,3,9,0,0,3,0,8,12,1
3282,98978,RbFI9SCNoIyFjKexw9cTU5NZ0thYBnL5,bWdj2GDclj5ofokWjzoa5jAwMkxCykd6,6,2,1,0,1,0,3,0,7,1.0,1,0.0,0,1,0,1,2,0,0,3,0,2,5,1
3283,98994,m30r8XAusN1tKwuw4RNeOZUufFJ19O18,RXDvfPUBYFlVdlueBFbLW0mhhAyGEqpt,1,0,0,0,0,0,1,0,1,0.14285714285714285,1,0.0,0,0,0,0,0,0,0,1,0,0,1,1
3284,98997,514TWhkGGUhLu2MdvTnb8eiBH3DCFHzg,A3fsA9Zfv1X2fVEQhTw51lKENdNrEqT3,10,11,6,0,3,1,3,0,24,3.4285714285714284,3,0.0,0,6,0,3,11,1,0,3,0,9,15,1
3285,99000,JqdbZyx8jQDjvl0RCDBDldcliaXwceyv,bWdj2GDclj5ofokWjzoa5jAwMkxCykd6,8,8,2,0,2,0,2,0,14,2.0,1,0.0,0,2,0,2,8,0,0,2,0,4,10,1
3286,99004,nqSx2YqVg8XBgQNFVkp5HECPuoyoztFf,SpATywNh6bZuzm8s1ceuBUnMUAeoAHHw,1,0,0,0,0,0,1,0,1,0.14285714285714285,1,0.0,0,0,0,0,0,0,0,1,0,0,1,1
3287,99008,udqxlb4h6NzlXvNGaijkJTXRrNX6DSPh,SpATywNh6bZuzm8s1ceuBUnMUAeoAHHw,1,0,0,0,0,0,1,0,1,0.14285714285714285,1,0.0,0,0,0,0,0,0,0,1,0,0,1,1
3288,99015,fe6JA2o6NTgNBdf1OgbAshmKUEnJCT1r,bWdj2GDclj5ofokWjzoa5jAwMkxCykd6,7,15,2,0,2,6,4,1,30,4.285714285714286,2,0.0,8,2,0,2,7,6,0,4,1,12,18,1
3289,99032,Ya8dmcUSDz09ym2vaNemTt41Djt01YaN,SpATywNh6bZuzm8s1ceuBUnMUAeoAHHw,5,5,1,0,1,0,2,0,9,1.2857142857142858,1,0.0,0,1,0,1,5,0,0,2,0,2,7,1
3290,99052,XzLXD7FWHRTDP7XVgC5p2Do9UmUukeQz,SpATywNh6bZuzm8s1ceuBUnMUAeoAHHw,3,3,0,0,0,0,1,0,4,0.5714285714285714,1,0.0,0,0,0,0,3,0,0,1,0,0,4,1
3291,99055,cR6ka5k7tAsfYo9cLOUPkpzWO6OItcGJ,SpATywNh6bZuzm8s1ceuBUnMUAeoAHHw,20,32,19,18,4,21,23,1,118,16.857142857142858,4,0.0,3,19,17,4,29,21,1,23,1,43,75,1
3292,99062,jP3AB3LItmtaoVvn4CaCoqw1w2QWhLKQ,G8EPVSXsOYB5YQWZGiz1aVq5Pgr2GrQu,27,41,0,106,2,1,14,1,165,23.571428571428573,1,0.0,20,0,84,2,21,1,22,14,1,106,59,1
3293,99068,T3sGbyIt0UjiteEMsVXGzcCDHseJZwlW,A3fsA9Zfv1X2fVEQhTw51lKENdNrEqT3,1,0,0,0,0,0,1,0,1,0.14285714285714285,1,0.0,0,0,0,0,0,0,0,1,0,0,1,1
3294,99071,Ein91FWFv0A9qDhWUbZlH2368EmphQmt,SpATywNh6bZuzm8s1ceuBUnMUAeoAHHw,11,10,1,15,0,0,3,0,29,4.142857142857143,1,0.0,5,1,12,0,5,0,3,3,0,18,11,1
3295,99093,XZ82RV9AD9npmDtj5hyoVvxIFU4kzejE,SpATywNh6bZuzm8s1ceuBUnMUAeoAHHw,5,3,1,0,1,0,1,0,6,0.8571428571428571,1,0.0,0,1,0,1,3,0,0,1,0,2,4,1
3296,99105,hCxVGafW6uZuzswuD2GRzZf6ODUAaVFJ,bWdj2GDclj5ofokWjzoa5jAwMkxCykd6,2,0,0,0,0,0,4,0,4,0.5714285714285714,1,0.0,0,0,0,0,0,0,0,4,0,0,4,0
3297,99124,DVOHqEW2vUL1QpZynG6huVjAWwl1vI6M,G8EPVSXsOYB5YQWZGiz1aVq5Pgr2GrQu,27,22,20,56,9,0,4,0,111,15.857142857142858,2,0.0,0,20,42,9,22,0,14,4,0,71,40,1
3298,99128,vGk4gKtQutULkRGPcSts7AdXqOR6DK2Z,RXDvfPUBYFlVdlueBFbLW0mhhAyGEqpt,10,9,7,0,4,0,3,0,23,3.2857142857142856,1,0.0,0,7,0,4,9,0,0,3,0,11,12,1
3299,99131,jVKznnDuZGyXtBgvnWMRtPXsgImk4qlt,SpATywNh6bZuzm8s1ceuBUnMUAeoAHHw,7,4,1,0,1,0,4,0,10,1.4285714285714286,1,0.0,0,1,0,1,4,0,0,4,0,2,8,1
3300,99138,eww5R49fPAYUK2L57nGKDp5FexxMvqZv,bWdj2GDclj5ofokWjzoa5jAwMkxCykd6,7,6,3,0,3,1,10,1,24,3.4285714285714284,1,0.0,2,3,0,3,4,1,0,10,1,8,16,1
3301,99147,1j3W4Jw1KafoLSgTmOItRSa20eh1CtOK,SpATywNh6bZuzm8s1ceuBUnMUAeoAHHw,1,0,0,0,0,0,1,0,1,0.14285714285714285,1,0.0,0,0,0,0,0,0,0,1,0,0,1,1
3302,99165,NojuWwUw3FQaTJhIEuVtN6uUtxeXYBaz,A3fsA9Zfv1X2fVEQhTw51lKENdNrEqT3,1,0,0,0,0,0,1,0,1,0.14285714285714285,1,0.0,0,0,0,0,0,0,0,1,0,0,1,1
3303,99182,N0P6Yrg1zRuUPyVufFpM0ZExnJnGTKKG,bWdj2GDclj5ofokWjzoa5jAwMkxCykd6,16,18,1,52,3,0,5,0,79,11.285714285714286,1,0.0,7,1,45,3,11,0,7,5,0,56,23,1
3304,99193,mS4KVP7r7MB15ORyOGtOcG2IZUAuYo4F,SpATywNh6bZuzm8s1ceuBUnMUAeoAHHw,4,3,1,0,0,0,2,0,6,0.8571428571428571,1,0.0,0,1,0,0,3,0,0,2,0,1,5,1
3305,99198,KUppVPuFnFs0vLCUrPJOIfquMy1mUooq,bWdj2GDclj5ofokWjzoa5jAwMkxCykd6,12,7,4,26,0,0,3,0,40,5.714285714285714,1,0.0,3,4,25,0,4,0,1,3,0,32,8,1
3306,99204,cKCzrCCCXe9nkBgWepq9AEXje7SITRTz,bWdj2GDclj5ofokWjzoa5jAwMkxCykd6,1,0,0,0,0,0,1,0,1,0.14285714285714285,1,0.0,0,0,0,0,0,0,0,1,0,0,1,1
3307,99206,cKCzrCCCXe9nkBgWepq9AEXje7SITRTz,G8EPVSXsOYB5YQWZGiz1aVq5Pgr2GrQu,1,0,0,0,0,0,1,0,1,0.14285714285714285,1,0.0,0,0,0,0,0,0,0,1,0,0,1,1
3308,99214,cKCzrCCCXe9nkBgWepq9AEXje7SITRTz,A3fsA9Zfv1X2fVEQhTw51lKENdNrEqT3,1,0,0,0,0,0,1,0,1,0.14285714285714285,1,0.0,0,0,0,0,0,0,0,1,0,0,1,1
3309,99221,wMqCiRTcG9DrOFV3mIQWVG2TWCqZLDsf,G8EPVSXsOYB5YQWZGiz1aVq5Pgr2GrQu,8,4,2,0,1,27,8,1,43,6.142857142857143,2,0.0,0,2,0,1,4,27,0,8,1,3,40,1
3310,99223,TBKTMcAi6pddCN8hy5SiGUXjC5YxeY5H,SpATywNh6bZuzm8s1ceuBUnMUAeoAHHw,8,2,1,0,1,0,6,0,10,1.4285714285714286,1,0.0,0,1,0,1,2,0,0,6,0,2,8,1
3311,99232,cdtMETRRUGW6e2sQh5Xd2C69HmYkARZ5,SpATywNh6bZuzm8s1ceuBUnMUAeoAHHw,7,6,0,0,0,1,3,0,10,1.4285714285714286,1,0.0,0,0,0,0,6,1,0,3,0,0,10,1
3312,99237,LHfLvP0G4hEksRdVPdjxg85LuBgQzx3S,bWdj2GDclj5ofokWjzoa5jAwMkxCykd6,3,4,1,0,0,0,2,0,7,1.0,1,0.0,2,1,0,0,2,0,0,2,0,3,4,0
3313,99243,T0WYTVwYJgFl0x8drZ3acqWyc5rt9vgS,A3fsA9Zfv1X2fVEQhTw51lKENdNrEqT3,1,0,0,0,0,0,1,0,1,0.14285714285714285,1,0.0,0,0,0,0,0,0,0,1,0,0,1,1
3314,99269,Ft3L9H2tidLSHsWi4FR179aCWB2oFssD,SpATywNh6bZuzm8s1ceuBUnMUAeoAHHw,9,3,2,0,2,0,5,0,12,1.7142857142857142,1,0.0,0,2,0,2,3,0,0,5,0,4,8,1
3315,99280,Zm35PP1kxKgQnBdrsL9FDU6gwqPBncBy,A3fsA9Zfv1X2fVEQhTw51lKENdNrEqT3,1,0,0,0,0,0,2,0,2,0.2857142857142857,1,0.0,0,0,0,0,0,0,0,2,0,0,2,1
3316,99292,KQNAn65G00s1hNhpNIZbIlQjdMIvn0te,G8EPVSXsOYB5YQWZGiz1aVq5Pgr2GrQu,2,0,0,0,0,2,1,0,3,0.42857142857142855,1,0.0,0,0,0,0,0,2,0,1,0,0,3,1
3317,99336,3gXjYz3VFr0TvsDYUgKtksPt5WrPBmEo,SpATywNh6bZuzm8s1ceuBUnMUAeoAHHw,15,41,19,14,5,0,13,0,92,13.142857142857142,6,0.0,10,19,13,5,31,0,1,13,0,47,45,0
3318,99371,7M1gTpajHgYWFRBJBTE3YPlAjNYb9gfx,G8EPVSXsOYB5YQWZGiz1aVq5Pgr2GrQu,1,0,0,0,0,0,1,0,1,0.14285714285714285,1,0.0,0,0,0,0,0,0,0,1,0,0,1,1
3319,99373,hJa6EP3vokxemW59iPrCWIQh0FEzTU7g,SpATywNh6bZuzm8s1ceuBUnMUAeoAHHw,10,11,1,17,1,0,2,0,32,4.571428571428571,1,0.0,6,1,15,1,5,0,2,2,0,23,9,1
3320,99376,aj90O66SXOM5h12FqdZrbSHiEhNvI2bA,SpATywNh6bZuzm8s1ceuBUnMUAeoAHHw,7,3,1,0,1,0,4,0,9,1.2857142857142858,1,0.0,1,1,0,1,2,0,0,4,0,3,6,1
3321,99400,q7MIcgFTiHmr8BKHm7XlaHNh6w8Fx7eG,A3fsA9Zfv1X2fVEQhTw51lKENdNrEqT3,1,0,0,0,0,0,1,0,1,0.14285714285714285,1,0.0,0,0,0,0,0,0,0,1,0,0,1,1
3322,99403,BSIRDTutz8KkNQ3VOx9kKk09R8urb0Ri,A3fsA9Zfv1X2fVEQhTw51lKENdNrEqT3,16,23,10,0,9,2,4,0,48,6.857142857142857,2,0.0,1,10,0,9,22,2,0,4,0,20,28,1
3323,99407,pC4iK2nDWej1Ecj7cZAC5BA8XCgOmZJi,bWdj2GDclj5ofokWjzoa5jAwMkxCykd6,3,0,0,0,0,1,2,0,3,0.42857142857142855,1,0.0,0,0,0,0,0,1,0,2,0,0,3,1
3324,99414,FbLnPRUJ3cO7BepRzJ4PsDHt79T7vpl0,SpATywNh6bZuzm8s1ceuBUnMUAeoAHHw,13,31,10,16,4,10,4,0,75,10.714285714285714,3,0.0,12,10,14,4,19,10,2,4,0,40,35,1
3325,99417,rAtBVPfi6wGHmo9go039lvWtKolaTQH4,SpATywNh6bZuzm8s1ceuBUnMUAeoAHHw,9,15,2,6,0,1,3,0,27,3.857142857142857,2,0.0,2,2,5,0,13,1,1,3,0,9,18,1
3326,99426,Uij5k6d5krJ4mWqsJUOAHKJ3rKlnctQu,A3fsA9Zfv1X2fVEQhTw51lKENdNrEqT3,1,0,0,0,0,0,1,0,1,0.14285714285714285,1,0.0,0,0,0,0,0,0,0,1,0,0,1,1
3327,99448,OLHje3sy9oD0UuSdVmOH9aE7DHL6V9Rf,G8EPVSXsOYB5YQWZGiz1aVq5Pgr2GrQu,2,0,0,0,0,0,3,0,3,0.42857142857142855,1,0.0,0,0,0,0,0,0,0,3,0,0,3,1
3328,99455,FBwWi8qV5T9PVUUQgTFb6EjAi12CMavu,SpATywNh6bZuzm8s1ceuBUnMUAeoAHHw,1,0,0,0,0,0,1,0,1,0.14285714285714285,1,0.0,0,0,0,0,0,0,0,1,0,0,1,1
3329,99464,VFYk1GyeJyGqK1t09cLe0E5m7KsULmvc,SpATywNh6bZuzm8s1ceuBUnMUAeoAHHw,15,30,17,4,9,6,7,1,74,10.571428571428571,3,0.0,0,17,3,9,30,6,1,7,1,29,45,1
3330,99470,H1SXscwZbeBIGdJtjznbLlFWKEefKgS4,A3fsA9Zfv1X2fVEQhTw51lKENdNrEqT3,9,7,3,0,3,0,4,0,17,2.4285714285714284,2,0.0,0,3,0,3,7,0,0,4,0,6,11,1
3331,99505,dDLv4oouOmVB45Y4hnRyV7IUqT7tMKiq,bWdj2GDclj5ofokWjzoa5jAwMkxCykd6,5,2,1,0,1,1,3,0,8,1.1428571428571428,1,0.0,0,1,0,1,2,1,0,3,0,2,6,1
3332,99527,4wk7mOQJdY2Tc4re4huOqsVY4BWqzpwG,SpATywNh6bZuzm8s1ceuBUnMUAeoAHHw,6,4,1,0,1,0,2,0,8,1.1428571428571428,1,0.0,0,1,0,1,4,0,0,2,0,2,6,1
3333,99558,qxVdjGWmrHaAXtxLFdUqWOB5LTvLLOy9,SpATywNh6bZuzm8s1ceuBUnMUAeoAHHw,13,15,1,3,0,8,7,0,34,4.857142857142857,1,0.0,6,1,3,0,9,8,0,7,0,10,24,1
3334,99566,WpcBrbawQCY5l6KXuhzbDIXB3ksftawE,SpATywNh6bZuzm8s1ceuBUnMUAeoAHHw,9,15,0,8,0,0,1,0,24,3.4285714285714284,1,0.0,10,0,8,0,5,0,0,1,0,18,6,1
3335,99568,oRL4hbvIrWhhsMx6uS8zWxFrJBWT9qS8,SpATywNh6bZuzm8s1ceuBUnMUAeoAHHw,8,2,1,0,1,1,6,1,12,1.7142857142857142,1,0.0,0,1,0,1,2,1,0,6,1,2,10,1
3336,99583,qe1lbudcDc26TUDIjWwsWCMadyJdvBEX,G8EPVSXsOYB5YQWZGiz1aVq5Pgr2GrQu,4,2,1,0,1,0,1,0,5,0.7142857142857143,1,0.0,0,1,0,1,2,0,0,1,0,2,3,1
3337,99663,9jzVaD1WPdcDwGhb2eIEjRQirdvM6f1C,bWdj2GDclj5ofokWjzoa5jAwMkxCykd6,1,0,0,0,0,0,1,0,1,0.14285714285714285,1,0.0,0,0,0,0,0,0,0,1,0,0,1,1
3338,99677,IL1F6pxCqZ5QZxZqthAXWrxFzw6RlKfD,SpATywNh6bZuzm8s1ceuBUnMUAeoAHHw,4,2,1,0,1,0,1,0,5,0.7142857142857143,1,0.0,0,1,0,1,2,0,0,1,0,2,3,1
3339,99682,MKYE6pEwq1YWgBTN9g77yl7jNJ14fFVC,SpATywNh6bZuzm8s1ceuBUnMUAeoAHHw,13,9,0,15,0,4,7,1,36,5.142857142857143,2,0.0,2,0,13,0,7,4,2,7,1,15,21,1
3340,99697,nGESIoGySD5XO5mI6jFhqZA6YIAniYb4,SpATywNh6bZuzm8s1ceuBUnMUAeoAHHw,5,2,0,0,0,0,3,1,6,0.8571428571428571,1,0.0,0,0,0,0,2,0,0,3,1,0,6,1
3341,99707,xg8dkQPzve0MzcpgxvEsbKyY4VwKrxAC,bWdj2GDclj5ofokWjzoa5jAwMkxCykd6,2,0,0,0,0,0,2,0,2,0.2857142857142857,1,0.0,0,0,0,0,0,0,0,2,0,0,2,1
3342,99721,i4u0VWs6ASAfOx6UbgpWUmxBkJHoZ0lf,SpATywNh6bZuzm8s1ceuBUnMUAeoAHHw,11,29,1,8,0,6,7,0,51,7.285714285714286,2,0.0,2,1,7,0,27,6,1,7,0,10,41,1
3343,99722,F5WXvUA8z1Vfdvlva1pujweut7tGE04r,A3fsA9Zfv1X2fVEQhTw51lKENdNrEqT3,6,3,1,0,0,2,4,1,11,1.5714285714285714,2,0.0,0,1,0,0,3,2,0,4,1,1,10,1
3344,99746,wfbRnjTCW6bqPFwlexPPeehj3HWJM2LV,SpATywNh6bZuzm8s1ceuBUnMUAeoAHHw,6,5,1,0,0,2,3,1,12,1.7142857142857142,1,0.0,0,1,0,0,5,2,0,3,1,1,11,1
3345,99776,s1C9M00kZ3td5Y1QHJpo6evzlHG7Bu17,A3fsA9Zfv1X2fVEQhTw51lKENdNrEqT3,1,0,0,0,0,0,1,0,1,0.14285714285714285,1,0.0,0,0,0,0,0,0,0,1,0,0,1,1
3346,99777,1umo7etGwkx7NcpFxVialzDD37NdyqRT,SpATywNh6bZuzm8s1ceuBUnMUAeoAHHw,13,14,6,12,4,1,3,0,40,5.714285714285714,2,0.0,6,6,12,4,8,1,0,3,0,28,12,0
3347,99801,Z4v9dtdXvLGvBdUbEHKilzESZFJ5MomJ,A3fsA9Zfv1X2fVEQhTw51lKENdNrEqT3,1,0,0,0,0,0,1,0,1,0.14285714285714285,1,0.0,0,0,0,0,0,0,0,1,0,0,1,1
3348,99803,wRn9VzYdznEJJbl33573ksufDlNbloBs,SpATywNh6bZuzm8s1ceuBUnMUAeoAHHw,1,0,0,0,0,0,1,0,1,0.14285714285714285,1,0.0,0,0,0,0,0,0,0,1,0,0,1,1
3349,99820,FW9yCFN4uGknAcdu3E5QkbxhIgnspzES,bWdj2GDclj5ofokWjzoa5jAwMkxCykd6,1,0,0,0,0,0,1,0,1,0.14285714285714285,1,0.0,0,0,0,0,0,0,0,1,0,0,1,1
3350,99830,l0hVKXTPSdIHJhYbRQF17YM8eZTkWoXS,SpATywNh6bZuzm8s1ceuBUnMUAeoAHHw,3,2,0,0,0,0,2,0,4,0.5714285714285714,1,0.0,0,0,0,0,2,0,0,2,0,0,4,1
3351,99841,l0hVKXTPSdIHJhYbRQF17YM8eZTkWoXS,bWdj2GDclj5ofokWjzoa5jAwMkxCykd6,1,0,0,0,0,0,1,0,1,0.14285714285714285,1,0.0,0,0,0,0,0,0,0,1,0,0,1,1
3352,99845,neKK2ykNimyF7kqeZQOYIIEzgIv0MPcH,RXDvfPUBYFlVdlueBFbLW0mhhAyGEqpt,5,2,1,0,1,0,2,0,6,0.8571428571428571,1,0.0,0,1,0,1,2,0,0,2,0,2,4,1
3353,99854,FQLZyFqiWjNudHf8Xwrwvb0mFmqAZa3g,SpATywNh6bZuzm8s1ceuBUnMUAeoAHHw,1,0,0,0,0,0,1,0,1,0.14285714285714285,1,0.0,0,0,0,0,0,0,0,1,0,0,1,1
3354,99860,Q8SrRVeWzJizOf34g4fWFcHi3GfFJHUN,SpATywNh6bZuzm8s1ceuBUnMUAeoAHHw,17,26,14,8,7,2,8,1,66,9.428571428571429,2,0.0,6,14,7,7,20,2,1,8,1,34,32,1
3355,99868,Qu1AvUJr7Rf2PLTyoAjhLhIJ5dIRQjGn,SpATywNh6bZuzm8s1ceuBUnMUAeoAHHw,8,7,6,0,2,0,2,0,17,2.4285714285714284,1,0.0,0,6,0,2,7,0,0,2,0,8,9,1
3356,99897,Qd7FMxYi2RP0CzetZmwspMbrYY8Z7160,G8EPVSXsOYB5YQWZGiz1aVq5Pgr2GrQu,2,0,0,0,0,0,2,0,2,0.2857142857142857,1,0.0,0,0,0,0,0,0,0,2,0,0,2,1
3357,99912,MW4oBOQoe8OTcAvm3yfi1VDCozBvyTdm,G8EPVSXsOYB5YQWZGiz1aVq5Pgr2GrQu,1,0,0,0,0,0,1,0,1,0.14285714285714285,1,0.0,0,0,0,0,0,0,0,1,0,0,1,1
3358,99931,T0V1MC6bsX3mZxJfTJfqpva6BwB6iZOI,RXDvfPUBYFlVdlueBFbLW0mhhAyGEqpt,4,0,0,0,0,0,3,1,4,0.5714285714285714,1,0.0,0,0,0,0,0,0,0,3,1,0,4,1
3359,99966,cUJIvx4QB7gYkEkbk184VKn3Y3N8dBd7,RXDvfPUBYFlVdlueBFbLW0mhhAyGEqpt,1,0,0,0,0,0,1,0,1,0.14285714285714285,1,0.0,0,0,0,0,0,0,0,1,0,0,1,1
3360,99979,oUNptzxKR6Tg3LMdUCW3RAFgD2fbf3ju,G8EPVSXsOYB5YQWZGiz1aVq5Pgr2GrQu,1,0,0,0,0,0,1,0,1,0.14285714285714285,1,0.0,0,0,0,0,0,0,0,1,0,0,1,1
3361,99981,irIVLRvkXyea4TMdg5wZQ17APoQLOStn,bWdj2GDclj5ofokWjzoa5jAwMkxCykd6,3,2,0,0,0,0,1,0,3,0.42857142857142855,1,0.0,0,0,0,0,2,0,0,1,0,0,3,1
3362,100046,uqIn0vdfJ1SDJCOeCVEAQPRFBBKQA2eB,RXDvfPUBYFlVdlueBFbLW0mhhAyGEqpt,1,0,0,0,0,0,1,0,1,0.14285714285714285,1,0.0,0,0,0,0,0,0,0,1,0,0,1,1
3363,100048,ZmILkESSKwaUf7dlv2MYezsPM9kEgn0g,SpATywNh6bZuzm8s1ceuBUnMUAeoAHHw,1,0,0,0,0,0,1,0,1,0.14285714285714285,1,0.0,0,0,0,0,0,0,0,1,0,0,1,1
3364,100065,C79HFTpOf1aC6aMRuXhus1qHumhqEAFk,SpATywNh6bZuzm8s1ceuBUnMUAeoAHHw,15,18,1,20,1,5,12,1,58,8.285714285714286,2,0.0,6,1,16,1,12,5,4,12,1,24,34,0
3365,100089,9MPGQ80LKMiZcqzI4e7ZT4LxgluBoFal,SpATywNh6bZuzm8s1ceuBUnMUAeoAHHw,12,14,2,0,1,0,6,2,25,3.5714285714285716,1,0.0,4,2,0,1,10,0,0,6,2,7,18,1
3366,100105,MKNBl3hhuuRZuBxyPOWBVV1OHzyXBuxg,SpATywNh6bZuzm8s1ceuBUnMUAeoAHHw,13,14,7,18,3,2,2,0,46,6.571428571428571,1,0.0,3,7,16,3,11,2,2,2,0,29,17,0
3367,100136,zhtf7EZUjW6s3Guz5lXD8KDXJ4lw9cuB,RXDvfPUBYFlVdlueBFbLW0mhhAyGEqpt,18,11,6,31,6,0,4,0,58,8.285714285714286,2,0.0,4,6,29,6,7,0,2,4,0,45,13,1
3368,100176,pfwNUWwL0srYZTJGvtMmP5xqlr01qeDv,bWdj2GDclj5ofokWjzoa5jAwMkxCykd6,4,2,0,0,0,0,9,0,11,1.5714285714285714,2,0.0,0,0,0,0,2,0,0,9,0,0,11,1
3369,100177,CD5yEeFA8Zn4o0HC0sLfKl1HGxKwer5w,A3fsA9Zfv1X2fVEQhTw51lKENdNrEqT3,1,0,0,0,0,0,2,0,2,0.2857142857142857,1,0.0,0,0,0,0,0,0,0,2,0,0,2,1
3370,100200,walE7JsvJqHl8yLz0PR8Oim32Lz4OIQ0,SpATywNh6bZuzm8s1ceuBUnMUAeoAHHw,14,17,0,14,0,20,20,1,72,10.285714285714286,2,0.0,8,0,13,0,9,20,1,20,1,21,51,1
3371,100208,oakvvUa4BMx0VOuNxMNhZr6bo8hbB626,SpATywNh6bZuzm8s1ceuBUnMUAeoAHHw,4,0,0,0,0,0,4,0,4,0.5714285714285714,1,0.0,0,0,0,0,0,0,0,4,0,0,4,1
3372,100216,iukICc3JPXkGjh0WhluWsphhopQF3KWw,SpATywNh6bZuzm8s1ceuBUnMUAeoAHHw,8,8,4,0,0,0,5,0,17,2.4285714285714284,1,0.0,0,4,0,0,8,0,0,5,0,4,13,1
3373,100243,CyLrnwOuvkEKQhwjogaYhZvzxTeqKBge,A3fsA9Zfv1X2fVEQhTw51lKENdNrEqT3,1,0,0,0,0,0,1,0,1,0.14285714285714285,1,0.0,0,0,0,0,0,0,0,1,0,0,1,1
3374,100244,3jzy20tHqZfBlzIZRWQh7hEsGbNNyC02,SpATywNh6bZuzm8s1ceuBUnMUAeoAHHw,5,2,1,0,1,0,2,0,6,0.8571428571428571,1,0.0,0,1,0,1,2,0,0,2,0,2,4,1
3375,100249,XyoP35cBUiKk44G72mbtEXCBjk8FmHfo,SpATywNh6bZuzm8s1ceuBUnMUAeoAHHw,15,12,6,18,3,3,5,0,47,6.714285714285714,2,0.0,2,6,14,3,10,3,4,5,0,25,22,1
3376,100257,8IdCnPo0KQab6PkHRu5Y6zvRlgGVQPUd,RXDvfPUBYFlVdlueBFbLW0mhhAyGEqpt,21,100,22,0,17,0,8,0,147,21.0,3,0.0,7,22,0,17,93,0,0,8,0,46,101,1
3377,100265,McYATdhZDDMDpni6a4GbjI06ustMpvdV,SpATywNh6bZuzm8s1ceuBUnMUAeoAHHw,2,0,0,0,0,1,1,0,2,0.2857142857142857,1,0.0,0,0,0,0,0,1,0,1,0,0,2,1
3378,100266,n2r6kyDnsWpbtliBFHcr0YWSTfVt0HhQ,G8EPVSXsOYB5YQWZGiz1aVq5Pgr2GrQu,2,0,0,0,0,0,2,0,2,0.2857142857142857,1,0.0,0,0,0,0,0,0,0,2,0,0,2,1
3379,100294,G7KJV0aUuu9N2GhQ0BQmtfVIkYBSsISM,SpATywNh6bZuzm8s1ceuBUnMUAeoAHHw,13,54,25,16,16,2,7,0,120,17.142857142857142,2,0.0,4,25,15,16,50,2,1,7,0,60,60,1
3380,100360,09033btLbIofAoxmgr9GoACTYHCpwfe7,SpATywNh6bZuzm8s1ceuBUnMUAeoAHHw,5,3,1,0,1,0,1,0,6,0.8571428571428571,1,0.0,0,1,0,1,3,0,0,1,0,2,4,1
3381,100375,FMxvsapRPXXXNxGG3GDsHR7zl4E2ofKu,A3fsA9Zfv1X2fVEQhTw51lKENdNrEqT3,1,0,0,0,0,0,2,0,2,0.2857142857142857,1,0.0,0,0,0,0,0,0,0,2,0,0,2,1
3382,100382,dDpqWlhYBkdNBy4JfnDE71OkEoQKGKDx,bWdj2GDclj5ofokWjzoa5jAwMkxCykd6,10,6,3,4,3,0,4,0,20,2.857142857142857,1,0.0,2,3,4,3,4,0,0,4,0,12,8,0
3383,100389,Q9YOU7BuWjkOYwh9pr1oIgYKYXPPRz5K,RXDvfPUBYFlVdlueBFbLW0mhhAyGEqpt,34,32,19,68,12,0,5,0,136,19.428571428571427,5,0.0,8,19,64,12,24,0,4,5,0,103,33,0
3384,100462,MRV5bQ8CaXcdaRHJL4krm33UMDJEAYUq,SpATywNh6bZuzm8s1ceuBUnMUAeoAHHw,1,0,0,0,0,0,1,0,1,0.14285714285714285,1,0.0,0,0,0,0,0,0,0,1,0,0,1,1
3385,100518,6DFg8IrvITdyV3FmRQrzgnl2oAgir5Pb,SpATywNh6bZuzm8s1ceuBUnMUAeoAHHw,15,27,5,14,2,8,13,1,70,10.0,2,0.0,6,5,11,2,21,8,3,13,1,24,46,0
3386,100563,IVE4TocWI6FDY4RoOKamDYCfOcH2PbRL,SpATywNh6bZuzm8s1ceuBUnMUAeoAHHw,12,26,0,15,0,25,5,0,71,10.142857142857142,1,0.0,18,0,15,0,8,25,0,5,0,33,38,1
3387,100566,O9Ff0eipZjXCZhuBVdpYtN4eMe1OZ5wo,SpATywNh6bZuzm8s1ceuBUnMUAeoAHHw,5,3,1,0,1,0,2,0,7,1.0,1,0.0,0,1,0,1,3,0,0,2,0,2,5,1
3388,100567,Is7lqncTs1EDN9QmzrTbcU6KnB0BCGNX,SpATywNh6bZuzm8s1ceuBUnMUAeoAHHw,11,11,5,0,3,1,9,1,30,4.285714285714286,2,0.0,3,5,0,3,8,1,0,9,1,11,19,1
3389,100592,1W42KMSdpCt6ldPd7y6qVJ23jr8xz7L8,SpATywNh6bZuzm8s1ceuBUnMUAeoAHHw,5,3,1,0,1,0,2,0,7,1.0,1,0.0,1,1,0,1,2,0,0,2,0,3,4,1
3390,100595,MdGTO2svRwIj7bz3FYKLlYB5eW0NcpSb,SpATywNh6bZuzm8s1ceuBUnMUAeoAHHw,16,17,7,20,4,0,5,1,54,7.714285714285714,1,0.0,5,7,16,4,12,0,4,5,1,32,22,0
3391,100611,qrBxOx4xvfJbTRNtYXFo4mMHRch3LE9R,A3fsA9Zfv1X2fVEQhTw51lKENdNrEqT3,1,0,0,0,0,0,1,0,1,0.14285714285714285,1,0.0,0,0,0,0,0,0,0,1,0,0,1,1
3392,100640,NfAbLg5OeUTUtF15GhHCETvzoFPtTDPd,SpATywNh6bZuzm8s1ceuBUnMUAeoAHHw,9,14,3,15,0,14,11,0,57,8.142857142857142,2,0.0,2,3,14,0,12,14,1,11,0,19,38,1
3393,100662,DfabbQQ3v42eWYnRYIQLMUYykm14gtcZ,A3fsA9Zfv1X2fVEQhTw51lKENdNrEqT3,1,0,0,0,0,0,1,0,1,0.14285714285714285,1,0.0,0,0,0,0,0,0,0,1,0,0,1,1
3394,100670,RApdsmrncG4ay8F6bpKxBswTJBXZ7CEo,SpATywNh6bZuzm8s1ceuBUnMUAeoAHHw,11,7,6,0,9,0,27,0,49,7.0,3,0.0,0,6,0,9,7,0,0,27,0,15,34,1
3395,100686,sFr2RCMewYMYiXOoTtSwzbAYMNnrzmY5,SpATywNh6bZuzm8s1ceuBUnMUAeoAHHw,9,3,3,0,2,0,3,0,11,1.5714285714285714,1,0.0,0,3,0,2,3,0,0,3,0,5,6,1
3396,100711,dGI6yveNenjFfT8c0PjNzk1ugu0VsvkU,SpATywNh6bZuzm8s1ceuBUnMUAeoAHHw,10,6,3,0,3,0,4,1,17,2.4285714285714284,1,0.0,1,3,0,3,5,0,0,4,1,7,10,1
3397,100731,vt827MYpYgT0JKXBC62SZ24Gxa8OJ87k,SpATywNh6bZuzm8s1ceuBUnMUAeoAHHw,4,3,0,0,0,0,2,0,5,0.7142857142857143,1,0.0,0,0,0,0,3,0,0,2,0,0,5,1
3398,100736,uJVJyY1XUciqhggpcXtgNPSVAHeYLBGB,G8EPVSXsOYB5YQWZGiz1aVq5Pgr2GrQu,9,14,4,0,0,0,4,0,22,3.142857142857143,2,0.0,0,4,0,0,14,0,0,4,0,4,18,1
3399,100740,MFMS4D6VcY65iaLs08cZFKnb6UYd2dkX,SpATywNh6bZuzm8s1ceuBUnMUAeoAHHw,1,0,0,0,0,0,1,0,1,0.14285714285714285,1,0.0,0,0,0,0,0,0,0,1,0,0,1,1
3400,100744,tMihxLso3qJJt2vQUNT2SznMjAGohiuT,SpATywNh6bZuzm8s1ceuBUnMUAeoAHHw,7,3,1,0,1,1,5,1,12,1.7142857142857142,1,0.0,0,1,0,1,3,1,0,5,1,2,10,1
3401,100749,1AsQo0zAkltKFUhbJK8sQo8EMtQlw4Zw,A3fsA9Zfv1X2fVEQhTw51lKENdNrEqT3,6,4,2,0,1,2,4,0,13,1.8571428571428572,3,0.0,0,2,0,1,4,2,0,4,0,3,10,1
3402,100754,UOjfyFlJmFc3i5kjWKRuDpWzrJIEqMHc,SpATywNh6bZuzm8s1ceuBUnMUAeoAHHw,2,0,0,0,0,0,2,0,2,0.2857142857142857,1,0.0,0,0,0,0,0,0,0,2,0,0,2,1
3403,100769,pjSCT01VrN3yLmICdcrZWQnnyzvIOi9x,SpATywNh6bZuzm8s1ceuBUnMUAeoAHHw,1,0,0,0,0,0,1,0,1,0.14285714285714285,1,0.0,0,0,0,0,0,0,0,1,0,0,1,1
3404,100794,Qj3zkBoKOajqBdArgJNrQ3sw89X3j0VX,SpATywNh6bZuzm8s1ceuBUnMUAeoAHHw,6,2,1,0,1,0,4,0,8,1.1428571428571428,1,0.0,0,1,0,1,2,0,0,4,0,2,6,1
3405,100859,xRb4cp7PVGLqlqc7BJgnld2XsE0F6wB3,SpATywNh6bZuzm8s1ceuBUnMUAeoAHHw,16,26,9,13,1,0,7,1,57,8.142857142857142,3,0.0,9,9,12,1,17,0,1,7,1,31,26,0
3406,100860,KFG6G55toGAeaWBt5UmyioW5n1NVxSjT,A3fsA9Zfv1X2fVEQhTw51lKENdNrEqT3,1,0,0,0,0,0,1,0,1,0.14285714285714285,1,0.0,0,0,0,0,0,0,0,1,0,0,1,1
3407,100863,VOKNou0BOm9l4CocxGjdRfkeAbtz86uT,SpATywNh6bZuzm8s1ceuBUnMUAeoAHHw,7,4,1,0,0,9,5,2,21,3.0,1,0.0,1,1,0,0,3,9,0,5,2,2,19,1
3408,100872,ES4n41HdZ3mzmajBMbCDY4C23oBD6LSY,RXDvfPUBYFlVdlueBFbLW0mhhAyGEqpt,9,7,5,0,2,0,3,0,17,2.4285714285714284,1,0.0,0,5,0,2,7,0,0,3,0,7,10,1
3409,100885,GpdW10m4i4o8zebocaIwKcYTi9ALrnVK,SpATywNh6bZuzm8s1ceuBUnMUAeoAHHw,1,0,0,0,0,0,2,0,2,0.2857142857142857,1,0.0,0,0,0,0,0,0,0,2,0,0,2,1
3410,100901,3ZkHeNhSscgbNC1k9L8lbe6SROwSZPLx,SpATywNh6bZuzm8s1ceuBUnMUAeoAHHw,4,0,0,0,0,1,8,0,9,1.2857142857142858,1,0.0,0,0,0,0,0,1,0,8,0,0,9,1
3411,100936,QAQOQC9orxaSCK47wTUjk6OT4uXNA4IV,RXDvfPUBYFlVdlueBFbLW0mhhAyGEqpt,1,0,0,0,0,0,1,0,1,0.14285714285714285,1,0.0,0,0,0,0,0,0,0,1,0,0,1,1
3412,100939,QJcScxtP8sOhNP5cvZ8cp3A76mQqjuPz,SpATywNh6bZuzm8s1ceuBUnMUAeoAHHw,5,2,1,0,1,0,2,0,6,0.8571428571428571,1,0.0,0,1,0,1,2,0,0,2,0,2,4,1
3413,100951,dpzYaESA6MCFHXGYe2bLHvSr1kNOP50p,SpATywNh6bZuzm8s1ceuBUnMUAeoAHHw,1,0,0,0,0,0,1,0,1,0.14285714285714285,1,0.0,0,0,0,0,0,0,0,1,0,0,1,1
3414,100967,pdDWSL0qqW5lqoVLDvyIeqmUWuTqLvQ6,bWdj2GDclj5ofokWjzoa5jAwMkxCykd6,2,0,0,0,0,0,2,0,2,0.2857142857142857,1,0.0,0,0,0,0,0,0,0,2,0,0,2,1
3415,100982,1QJEJ5a9sT1rwzf5IhaKshE565OOWiB4,G8EPVSXsOYB5YQWZGiz1aVq5Pgr2GrQu,6,5,2,0,2,0,1,0,10,1.4285714285714286,1,0.0,0,2,0,2,5,0,0,1,0,4,6,1
3416,100989,MaNbEqxyOcaRJ63ZfC9DudJtV0A5y3yK,SpATywNh6bZuzm8s1ceuBUnMUAeoAHHw,16,16,5,25,3,6,5,1,61,8.714285714285714,1,0.0,6,5,20,3,10,6,5,5,1,34,27,0
3417,100992,pdDWSL0qqW5lqoVLDvyIeqmUWuTqLvQ6,A3fsA9Zfv1X2fVEQhTw51lKENdNrEqT3,1,0,0,0,0,0,1,0,1,0.14285714285714285,1,0.0,0,0,0,0,0,0,0,1,0,0,1,1
3418,101003,XPA1Jv5NXHfUcU7CMUA4EKvCqSxl1bO3,RXDvfPUBYFlVdlueBFbLW0mhhAyGEqpt,1,0,0,0,0,0,1,0,1,0.14285714285714285,1,0.0,0,0,0,0,0,0,0,1,0,0,1,1
3419,101033,eWW5LWmp2L4jfpnZTKTrpHZw2NPytGoT,G8EPVSXsOYB5YQWZGiz1aVq5Pgr2GrQu,2,0,0,0,0,0,2,0,2,0.2857142857142857,1,0.0,0,0,0,0,0,0,0,2,0,0,2,1
3420,101041,R5b8KqsMsDfKAxdLfUK6LRx0WUFDD5Xb,bWdj2GDclj5ofokWjzoa5jAwMkxCykd6,10,19,0,10,0,3,4,1,37,5.285714285714286,2,0.0,5,0,9,0,14,3,1,4,1,14,23,1
3421,101044,0MInlyhRLhTct7ctvAmGIMuZ2WCCEQOJ,bWdj2GDclj5ofokWjzoa5jAwMkxCykd6,1,0,0,0,0,0,1,0,1,0.14285714285714285,1,0.0,0,0,0,0,0,0,0,1,0,0,1,1
3422,101045,PCtqctDcjJHl3GW7yk0aug87eqbAmlqT,SpATywNh6bZuzm8s1ceuBUnMUAeoAHHw,13,15,3,16,1,0,6,0,41,5.857142857142857,1,0.0,2,3,14,1,13,0,2,6,0,20,21,1
3423,101047,MhrFHIexWYn2dilUXh03cpnfpoe9tMBe,bWdj2GDclj5ofokWjzoa5jAwMkxCykd6,1,0,0,0,0,0,1,0,1,0.14285714285714285,1,0.0,0,0,0,0,0,0,0,1,0,0,1,1
3424,101059,H4F1BzGEbgWgPoxlFORCSmUf8fAP6V7l,RXDvfPUBYFlVdlueBFbLW0mhhAyGEqpt,13,12,4,6,1,0,7,0,30,4.285714285714286,2,0.0,2,4,6,1,10,0,0,7,0,13,17,1
3425,101074,D9nQsPz9172rPurdQOY1oS88oPJMaAUd,bWdj2GDclj5ofokWjzoa5jAwMkxCykd6,13,40,1,26,2,19,14,0,102,14.571428571428571,3,0.0,7,1,21,2,33,19,5,14,0,31,71,1
3426,101091,NbOkuaMYNn1DiAgigOMCG3fDUQt3bFUa,SpATywNh6bZuzm8s1ceuBUnMUAeoAHHw,13,42,14,13,0,33,13,1,116,16.571428571428573,3,0.0,21,14,13,0,21,33,0,13,1,48,68,1
3427,101098,Jxd0Gyi2eFjuuzujg1eSA5QBX1QonMfb,bWdj2GDclj5ofokWjzoa5jAwMkxCykd6,8,4,3,0,3,0,3,1,14,2.0,1,0.0,0,3,0,3,4,0,0,3,1,6,8,1
3428,101103,KxUegLpOtUB19LVwgBAOjYKSbicZaJLZ,SpATywNh6bZuzm8s1ceuBUnMUAeoAHHw,5,15,1,0,0,0,4,0,20,2.857142857142857,4,0.0,0,1,0,0,15,0,0,4,0,1,19,0
3429,101112,wnkgyfR4roxhmJZsqCCxH9EfyI2qd5YM,SpATywNh6bZuzm8s1ceuBUnMUAeoAHHw,5,3,2,0,2,0,3,0,10,1.4285714285714286,2,0.0,0,2,0,2,3,0,0,3,0,4,6,1
3430,101122,B0jVKFlvXfKwVR9pXnhJZcf2VbxqeEJP,RXDvfPUBYFlVdlueBFbLW0mhhAyGEqpt,7,3,2,0,2,0,2,0,9,1.2857142857142858,2,0.0,0,2,0,2,3,0,0,2,0,4,5,1
3431,101125,B0jVKFlvXfKwVR9pXnhJZcf2VbxqeEJP,A3fsA9Zfv1X2fVEQhTw51lKENdNrEqT3,1,0,0,0,0,0,1,0,1,0.14285714285714285,1,0.0,0,0,0,0,0,0,0,1,0,0,1,1
3432,101130,4TBbHxtdM6KlXwrDZvHlXfXL45mqy6bL,SpATywNh6bZuzm8s1ceuBUnMUAeoAHHw,10,30,8,0,2,0,10,0,50,7.142857142857143,3,0.0,1,8,0,2,29,0,0,10,0,11,39,1
3433,101137,nnpMilWm5u9YfSzlEw0i8QiLM3F4GePR,G8EPVSXsOYB5YQWZGiz1aVq5Pgr2GrQu,7,1,1,0,1,2,5,1,11,1.5714285714285714,1,0.0,0,1,0,1,1,2,0,5,1,2,9,1
3434,101141,2qEZpMTxWlr35xXuNBb8vvZZiY1soKKq,SpATywNh6bZuzm8s1ceuBUnMUAeoAHHw,5,5,0,0,0,0,4,0,9,1.2857142857142858,1,0.0,0,0,0,0,5,0,0,4,0,0,9,1
3435,101154,fnJf5uFFfrA3RuutRVGe8qQuGwat3ZCQ,SpATywNh6bZuzm8s1ceuBUnMUAeoAHHw,1,0,0,0,0,0,1,0,1,0.14285714285714285,1,0.0,0,0,0,0,0,0,0,1,0,0,1,1
3436,101186,gtKTzkXHwS41ljYVmjlLLf4WyQSkK02q,bWdj2GDclj5ofokWjzoa5jAwMkxCykd6,2,0,0,0,0,0,2,0,2,0.2857142857142857,1,0.0,0,0,0,0,0,0,0,2,0,0,2,1
3437,101189,yrhXE3OyNatOr3jElQ1DJhAKv2cy7Hqx,SpATywNh6bZuzm8s1ceuBUnMUAeoAHHw,1,0,0,0,0,0,1,0,1,0.14285714285714285,1,0.0,0,0,0,0,0,0,0,1,0,0,1,1
3438,101191,yrlVnbrSR0LAW13A08wi2wUW5yoGSw1G,bWdj2GDclj5ofokWjzoa5jAwMkxCykd6,1,0,0,0,0,0,1,0,1,0.14285714285714285,1,0.0,0,0,0,0,0,0,0,1,0,0,1,1
3439,101198,OCAzb1VfLGBRFoguhxZLxVaO4EgntnGi,A3fsA9Zfv1X2fVEQhTw51lKENdNrEqT3,15,11,8,0,6,4,14,1,44,6.285714285714286,2,0.0,0,8,0,6,11,4,0,14,1,14,30,1
3440,101201,YewrI0crAA2lhm09K28QZKb66KLxgFIr,SpATywNh6bZuzm8s1ceuBUnMUAeoAHHw,5,2,1,0,1,0,2,0,6,0.8571428571428571,1,0.0,0,1,0,1,2,0,0,2,0,2,4,1
3441,101219,NIlxh2g7VTAquieuVc9RGErPkOzbSh2Z,A3fsA9Zfv1X2fVEQhTw51lKENdNrEqT3,1,0,0,0,0,0,1,0,1,0.14285714285714285,1,0.0,0,0,0,0,0,0,0,1,0,0,1,1
3442,101223,MwRVXLIjs7ObnboXYRMgXHQa3UWpN5i5,SpATywNh6bZuzm8s1ceuBUnMUAeoAHHw,9,10,6,0,2,0,3,0,21,3.0,2,0.0,0,6,0,2,10,0,0,3,0,8,13,1
3443,101248,9FCTgAxdOH7TtkaWvHpzLeDt6G1gJ5Bo,bWdj2GDclj5ofokWjzoa5jAwMkxCykd6,14,8,4,20,4,0,8,0,44,6.285714285714286,1,0.0,3,4,19,4,5,0,1,8,0,30,14,1
3444,101259,lgjOCnqMh3jm1TNv306EqOQLtLVGnS97,SpATywNh6bZuzm8s1ceuBUnMUAeoAHHw,4,2,0,0,0,2,2,0,6,0.8571428571428571,1,0.0,0,0,0,0,2,2,0,2,0,0,6,1
3445,102824,WmG8kTcU8MK2hNkFFl9oxdCyXNm8K8Ej,7GRhBDsirIGkRZBtSMEzNTyDr2JQm4xx,1,0,0,0,0,0,1,0,1,0.14285714285714285,1,0.0,0,0,0,0,0,0,0,1,0,0,1,1
3446,102932,0zaZMwzUlPvudODMBJsoUQT9Stnqz6b0,SpATywNh6bZuzm8s1ceuBUnMUAeoAHHw,4,2,1,0,1,2,3,0,9,1.2857142857142858,1,0.0,0,1,0,1,2,2,0,3,0,2,7,1
3447,103011,A3hbg0sRzJCuZelHR2utUpF4kEQMHGoX,A3fsA9Zfv1X2fVEQhTw51lKENdNrEqT3,2,0,0,0,0,0,6,0,6,0.8571428571428571,2,0.0,0,0,0,0,0,0,0,6,0,0,6,1
3448,103131,KKoJVU8RPVKYX0YtUEw7IyEbFA7WdrnE,SpATywNh6bZuzm8s1ceuBUnMUAeoAHHw,14,16,4,24,2,0,4,0,50,7.142857142857143,1,0.0,6,4,20,2,10,0,4,4,0,32,18,0
3449,103133,pmbdGuMJDBIMvlssCxECy27GzvD3oiIB,SpATywNh6bZuzm8s1ceuBUnMUAeoAHHw,4,2,1,0,1,0,1,0,5,0.7142857142857143,1,0.0,0,1,0,1,2,0,0,1,0,2,3,1
3450,103220,8c2gk77rfHeG4kEZpifVHT547X2ayTNE,A3fsA9Zfv1X2fVEQhTw51lKENdNrEqT3,10,5,3,0,1,4,12,1,26,3.7142857142857144,2,0.0,0,3,0,1,5,4,0,12,1,4,22,1
3451,103291,3xICsH6EXuYyV8kexin75XnVadi3rENN,SpATywNh6bZuzm8s1ceuBUnMUAeoAHHw,7,4,3,0,2,0,2,0,11,1.5714285714285714,1,0.0,0,3,0,2,4,0,0,2,0,5,6,1
3452,103349,hNJz0qbOhrUgajUkzqSdDbybHkuRglfs,bWdj2GDclj5ofokWjzoa5jAwMkxCykd6,15,13,6,86,3,0,3,0,111,15.857142857142858,2,0.0,5,6,79,3,8,0,7,3,0,93,18,1
3453,103401,BfcoBJeBA5nEQ2BMwBPOzhifSeHVOPF7,A3fsA9Zfv1X2fVEQhTw51lKENdNrEqT3,7,4,0,0,0,4,6,3,17,2.4285714285714284,1,0.0,0,0,0,0,4,4,0,6,3,0,17,1
3454,103852,VJiHrUKuVkG2Wd7Jui04ER4qa9ZGvV1t,SpATywNh6bZuzm8s1ceuBUnMUAeoAHHw,17,26,11,8,3,4,6,1,59,8.428571428571429,3,0.0,6,11,7,3,20,4,1,6,1,27,32,1
3455,103903,0w9tP8TINgzfbBeYFJprB82ry0PjYiWn,SpATywNh6bZuzm8s1ceuBUnMUAeoAHHw,8,23,2,2,0,0,2,0,29,4.142857142857143,1,0.0,2,2,2,0,21,0,0,2,0,6,23,0
3456,103967,kjoYyxOsZaiCA9S8PMK5B69QLaH15SYn,SpATywNh6bZuzm8s1ceuBUnMUAeoAHHw,12,21,6,18,3,15,1,0,64,9.142857142857142,1,0.0,14,6,15,3,7,15,3,1,0,38,26,0
3457,104281,nQnbQ4USuQPKS5dsskLpLD6Vp5PD3y57,SpATywNh6bZuzm8s1ceuBUnMUAeoAHHw,5,2,1,0,1,1,3,0,8,1.1428571428571428,1,0.0,0,1,0,1,2,1,0,3,0,2,6,0
3458,104287,E4KzNEU3ybRlAOiHqHHsGQEXiaxyHgoT,SpATywNh6bZuzm8s1ceuBUnMUAeoAHHw,18,17,8,12,5,14,9,1,66,9.428571428571429,1,0.0,6,8,12,5,11,14,0,9,1,31,35,0
3459,104293,mKHQM9iW9olu6z2WamdxK7ySH3UwX3JX,RXDvfPUBYFlVdlueBFbLW0mhhAyGEqpt,10,6,5,0,2,1,8,1,23,3.2857142857142856,2,0.0,0,5,0,2,6,1,0,8,1,7,16,1
3460,104312,Q5TmTVdy8nnH2vTL73s67ZseaCMO3k91,bWdj2GDclj5ofokWjzoa5jAwMkxCykd6,1,0,0,0,0,0,1,0,1,0.14285714285714285,1,0.0,0,0,0,0,0,0,0,1,0,0,1,1
3461,104316,FdqXptfn5rlMpIwU40MbDz6o7uZKXv6A,SpATywNh6bZuzm8s1ceuBUnMUAeoAHHw,2,0,0,0,0,0,2,0,2,0.2857142857142857,1,0.0,0,0,0,0,0,0,0,2,0,0,2,1
3462,104331,sC7fymsB6mbxhnSeg6NeWpGdnl2lVglT,SpATywNh6bZuzm8s1ceuBUnMUAeoAHHw,17,27,11,19,5,0,8,3,73,10.428571428571429,1,0.0,12,11,17,5,15,0,2,8,3,45,28,0
3463,104345,2XkaIutgoPZ3laInMFqUtqSwL8hEETLH,SpATywNh6bZuzm8s1ceuBUnMUAeoAHHw,4,3,1,0,1,0,1,0,6,0.8571428571428571,1,0.0,0,1,0,1,3,0,0,1,0,2,4,1
3464,104346,wGfXRYqHkdAo1fVEEY9NvW8qy6M9m0mI,SpATywNh6bZuzm8s1ceuBUnMUAeoAHHw,7,5,2,0,2,0,2,0,11,1.5714285714285714,1,0.0,0,2,0,2,5,0,0,2,0,4,7,1
3465,104353,Nvx1FqKYM0wMKIIRgD0fWbHs2ulluJLe,SpATywNh6bZuzm8s1ceuBUnMUAeoAHHw,1,0,0,0,0,0,1,0,1,0.14285714285714285,1,0.0,0,0,0,0,0,0,0,1,0,0,1,0
3466,104388,hGNdlaqDmXk6lg7T5WbaNaGNDHY5myAS,SpATywNh6bZuzm8s1ceuBUnMUAeoAHHw,7,7,3,0,2,0,3,0,15,2.142857142857143,1,0.0,3,3,0,2,4,0,0,3,0,8,7,1
3467,104394,dlHDytKql5TohtYHxgnGbeQGgJYZWDGJ,A3fsA9Zfv1X2fVEQhTw51lKENdNrEqT3,1,0,0,0,0,0,1,0,1,0.14285714285714285,1,0.0,0,0,0,0,0,0,0,1,0,0,1,1
3468,104407,8XstJLDa8agdHppUFVVZbvtgkIjc1hSo,SpATywNh6bZuzm8s1ceuBUnMUAeoAHHw,6,4,2,0,1,1,3,0,11,1.5714285714285714,2,0.0,0,2,0,1,4,1,0,3,0,3,8,1
3469,104418,pcsiSS3QOPo0n8yKp6skJyBWeonG4c8P,bWdj2GDclj5ofokWjzoa5jAwMkxCykd6,4,5,3,0,2,6,1,0,17,2.4285714285714284,1,0.0,0,3,0,2,5,6,0,1,0,5,12,1
3470,104435,GEHMGUKZ7lJGT0NAhukMXCgY3uHGI1vW,SpATywNh6bZuzm8s1ceuBUnMUAeoAHHw,7,3,2,0,2,0,2,0,9,1.2857142857142858,1,0.0,0,2,0,2,3,0,0,2,0,4,5,1
3471,104438,KJtTFVCUZxFPCdrcl94b8VUY3eA2PtX6,SpATywNh6bZuzm8s1ceuBUnMUAeoAHHw,16,22,8,8,3,9,5,3,58,8.285714285714286,1,0.0,12,8,7,3,10,9,1,5,3,30,28,0
3472,104450,fa5L7BR4QPdW8LaRhyZa9SLAtcvpLQse,SpATywNh6bZuzm8s1ceuBUnMUAeoAHHw,9,3,2,0,2,0,5,1,13,1.8571428571428572,1,0.0,0,2,0,2,3,0,0,5,1,4,9,1
3473,104471,1MR6SIEh8IgMKrYcKoTYc2JC43hmTJbZ,A3fsA9Zfv1X2fVEQhTw51lKENdNrEqT3,6,3,0,0,0,2,5,0,10,1.4285714285714286,1,0.0,0,0,0,0,3,2,0,5,0,0,10,1
3474,104488,IYFrqEdSROOp3Z1UK2YOma0RYGRatAQT,A3fsA9Zfv1X2fVEQhTw51lKENdNrEqT3,4,2,1,0,1,0,1,0,5,0.7142857142857143,1,0.0,0,1,0,1,2,0,0,1,0,2,3,1
3475,104491,yEc0qGRUsnGavj0JPbk8pVtWktClrURk,A3fsA9Zfv1X2fVEQhTw51lKENdNrEqT3,1,0,0,0,0,0,1,0,1,0.14285714285714285,1,0.0,0,0,0,0,0,0,0,1,0,0,1,1
3476,104497,jKfEyfk0HFbzE5vAszOX5qLRWBhzLYt2,SpATywNh6bZuzm8s1ceuBUnMUAeoAHHw,1,0,0,0,0,0,1,0,1,0.14285714285714285,1,0.0,0,0,0,0,0,0,0,1,0,0,1,1
3477,104501,vZWQs3w0XkSs89Ucm6ojt59ZxMUAhe1V,A3fsA9Zfv1X2fVEQhTw51lKENdNrEqT3,11,7,3,0,1,2,16,1,30,4.285714285714286,1,0.0,0,3,0,1,7,2,0,16,1,4,26,1
3478,104510,1fqT0899kRcDDGHbdo7SAtzTiZ0jb6Gw,SpATywNh6bZuzm8s1ceuBUnMUAeoAHHw,5,4,1,0,1,0,4,0,10,1.4285714285714286,1,0.0,0,1,0,1,4,0,0,4,0,2,8,1
3479,104519,4BEj7gptNyb11PfZw5Zij4k5rhZkomv9,SpATywNh6bZuzm8s1ceuBUnMUAeoAHHw,16,25,7,15,3,0,4,0,54,7.714285714285714,1,0.0,16,7,14,3,9,0,1,4,0,40,14,1
3480,104520,AXWWqNDiRDejTjo5V7yUaMbjtzXKhlP0,A3fsA9Zfv1X2fVEQhTw51lKENdNrEqT3,9,5,4,0,3,0,2,0,14,2.0,1,0.0,0,4,0,3,5,0,0,2,0,7,7,1
3481,104529,pRsdTtgRf3HNRCFBVE8ZUsyswXD2QiAk,SpATywNh6bZuzm8s1ceuBUnMUAeoAHHw,6,3,1,0,1,0,2,0,7,1.0,1,0.0,0,1,0,1,3,0,0,2,0,2,5,1
3482,104544,gUXmx34tXzFZkM4gYbNbIwLhuZfANkS1,A3fsA9Zfv1X2fVEQhTw51lKENdNrEqT3,4,3,1,0,0,0,1,0,5,0.7142857142857143,1,0.0,0,1,0,0,3,0,0,1,0,1,4,1
3483,104549,XVzLVlcu5Oyf6iAJpPwexFxr52kUVMk6,SpATywNh6bZuzm8s1ceuBUnMUAeoAHHw,1,0,0,0,0,0,1,0,1,0.14285714285714285,1,0.0,0,0,0,0,0,0,0,1,0,0,1,1
3484,104552,nR9dAgKzSlgvrJWELbwHBtX83ee7HVxY,SpATywNh6bZuzm8s1ceuBUnMUAeoAHHw,7,4,3,0,3,0,2,0,12,1.7142857142857142,1,0.0,0,3,0,3,4,0,0,2,0,6,6,1
3485,104583,hd3AGD7h3p4wKWEGL7m8RwayFKIA3oY6,SpATywNh6bZuzm8s1ceuBUnMUAeoAHHw,9,10,5,0,5,1,1,0,22,3.142857142857143,1,0.0,2,5,0,5,8,1,0,1,0,12,10,1
3486,104638,pVcyz42RqwGdgjmvwllHMEUwVR1vdXWF,SpATywNh6bZuzm8s1ceuBUnMUAeoAHHw,9,13,5,0,3,0,2,0,23,3.2857142857142856,1,0.0,4,5,0,3,9,0,0,2,0,12,11,0
3487,104643,OUOJlObKrXM0JmEUq0o8KzZHzr8jy9dn,SpATywNh6bZuzm8s1ceuBUnMUAeoAHHw,1,0,0,0,0,0,1,0,1,0.14285714285714285,1,0.0,0,0,0,0,0,0,0,1,0,0,1,1
3488,104660,T118Cf7QnojriLhCFYL99xCQBHodaMMt,A3fsA9Zfv1X2fVEQhTw51lKENdNrEqT3,6,5,2,0,1,0,2,0,10,1.4285714285714286,1,0.0,0,2,0,1,5,0,0,2,0,3,7,1
3489,104679,b7OkWz3nq7Lb9oLoadHyvvkdfFcSwihz,bWdj2GDclj5ofokWjzoa5jAwMkxCykd6,1,0,0,0,0,0,1,0,1,0.14285714285714285,1,0.0,0,0,0,0,0,0,0,1,0,0,1,1
3490,104700,HTW0MXRsyGWqdNcPrMPEaXwWOjVd82Bo,SpATywNh6bZuzm8s1ceuBUnMUAeoAHHw,13,34,12,12,5,0,5,0,68,9.714285714285714,2,0.0,10,12,10,5,24,0,2,5,0,37,31,1
3491,104725,kOUbZbVS3Tp5fnMvFRgXRDdwa2qwOZPQ,SpATywNh6bZuzm8s1ceuBUnMUAeoAHHw,10,11,9,0,5,0,1,0,26,3.7142857142857144,1,0.0,1,9,0,5,10,0,0,1,0,15,11,1
3492,104729,EJ7udUHYDMabOR6DK8F5Y2Y2wljl56Yz,SpATywNh6bZuzm8s1ceuBUnMUAeoAHHw,13,22,6,11,1,5,6,1,52,7.428571428571429,1,0.0,14,6,10,1,8,5,1,6,1,31,21,1
3493,104732,Xp3hqJUxQ1JyPcuVR21XzaJTaS6J32IL,SpATywNh6bZuzm8s1ceuBUnMUAeoAHHw,5,2,1,0,1,0,2,0,6,0.8571428571428571,1,0.0,0,1,0,1,2,0,0,2,0,2,4,1
3494,104752,howLdYpe9Zal9CPA1BP3DgH0uhVpiT5i,SpATywNh6bZuzm8s1ceuBUnMUAeoAHHw,18,13,6,14,4,3,6,2,48,6.857142857142857,1,0.0,4,6,13,4,9,3,1,6,2,27,21,1
3495,104772,AaS8GsfaaiK26oA6b0QdGhs8opVCkjvV,A3fsA9Zfv1X2fVEQhTw51lKENdNrEqT3,31,17,12,54,0,7,6,0,96,13.714285714285714,1,0.0,2,12,47,0,15,7,7,6,0,61,35,1
3496,104790,EPmLjBxeWpwhjwoRgtmLV8RkhFOu2zzj,SpATywNh6bZuzm8s1ceuBUnMUAeoAHHw,2,0,0,0,0,0,2,0,2,0.2857142857142857,1,0.0,0,0,0,0,0,0,0,2,0,0,2,1
3497,104791,Xv7W8Uu75U6tMRhwrAaphCnFwKom9DXj,SpATywNh6bZuzm8s1ceuBUnMUAeoAHHw,2,0,0,0,0,0,2,0,2,0.2857142857142857,1,0.0,0,0,0,0,0,0,0,2,0,0,2,1
3498,104798,705a1tvxnZT7omctMx7Fjakho000VDxN,SpATywNh6bZuzm8s1ceuBUnMUAeoAHHw,3,2,0,0,0,0,1,0,3,0.42857142857142855,1,0.0,0,0,0,0,2,0,0,1,0,0,3,1
3499,104803,GHw9ck750jm0mkRym0HeCGrJelDoub5a,SpATywNh6bZuzm8s1ceuBUnMUAeoAHHw,12,17,10,0,4,1,3,0,35,5.0,1,0.0,5,10,0,4,12,1,0,3,0,19,16,0
3500,104805,O5Xv4tBkDAfcRTJRImpaIMgi7dTTYJal,SpATywNh6bZuzm8s1ceuBUnMUAeoAHHw,17,20,8,19,3,12,7,1,70,10.0,2,0.0,8,8,15,3,12,12,4,7,1,34,36,1
3501,104818,6i24nlUBlDMs5njijO1qqAg2zNti0ug9,SpATywNh6bZuzm8s1ceuBUnMUAeoAHHw,8,6,4,0,3,0,5,0,18,2.5714285714285716,1,0.0,0,4,0,3,6,0,0,5,0,7,11,1
3502,104826,1EoPeAPt0rQExpDMUB0Oh9LRcg1yhFWa,SpATywNh6bZuzm8s1ceuBUnMUAeoAHHw,1,0,0,0,0,0,1,0,1,0.14285714285714285,1,0.0,0,0,0,0,0,0,0,1,0,0,1,1
3503,104838,PzXoGwLC1Wc9fp2FSg9WCVxYfOKqR6tz,SpATywNh6bZuzm8s1ceuBUnMUAeoAHHw,9,14,9,0,0,0,5,0,28,4.0,2,0.0,0,9,0,0,14,0,0,5,0,9,19,1
3504,104843,8NRsKZ3hMeinWXhN3qtntd7OTP25jyWY,SpATywNh6bZuzm8s1ceuBUnMUAeoAHHw,4,3,1,0,1,0,2,0,7,1.0,1,0.0,0,1,0,1,3,0,0,2,0,2,5,1
3505,104847,gPygmoGilNQtwbFXETY0FWnDTdZxsr6L,bWdj2GDclj5ofokWjzoa5jAwMkxCykd6,5,4,1,0,2,0,2,0,9,1.2857142857142858,1,0.0,2,1,0,2,2,0,0,2,0,5,4,1
3506,104870,vO07VFd2DYWPdrvNiSqsqXFTXPKE00c4,SpATywNh6bZuzm8s1ceuBUnMUAeoAHHw,1,0,0,0,0,0,1,0,1,0.14285714285714285,1,0.0,0,0,0,0,0,0,0,1,0,0,1,1
3507,104888,7UoJlZNmkXe9KUxED9211lah5PpgHmBQ,A3fsA9Zfv1X2fVEQhTw51lKENdNrEqT3,8,4,2,0,2,0,3,0,11,1.5714285714285714,2,0.0,0,2,0,2,4,0,0,3,0,4,7,1
3508,104899,fYcx29YG0OyhjbzerOxQ4rwr3ES74fln,bWdj2GDclj5ofokWjzoa5jAwMkxCykd6,7,9,6,0,0,0,6,0,21,3.0,2,0.0,0,6,0,0,9,0,0,6,0,6,15,1
3509,104911,0lHtTzCCkTGgpl3mL2eT9kPoN3ydIlHv,bWdj2GDclj5ofokWjzoa5jAwMkxCykd6,5,2,1,0,1,0,2,0,6,0.8571428571428571,1,0.0,0,1,0,1,2,0,0,2,0,2,4,1
3510,104921,xBMlDE0EhLrV6UTu12C10f1Ev99CwT31,SpATywNh6bZuzm8s1ceuBUnMUAeoAHHw,10,16,8,0,3,0,3,0,30,4.285714285714286,1,0.0,0,8,0,3,16,0,0,3,0,11,19,1
3511,104937,nyhARUyj7ejuonDDMRnWtxhqKty5CGUe,A3fsA9Zfv1X2fVEQhTw51lKENdNrEqT3,1,0,0,0,0,0,1,0,1,0.14285714285714285,1,0.0,0,0,0,0,0,0,0,1,0,0,1,1
3512,104940,8yrIKDtnkYcLfERwrXrvcRGxHxbt2Jd3,A3fsA9Zfv1X2fVEQhTw51lKENdNrEqT3,2,0,0,0,0,0,2,0,2,0.2857142857142857,1,0.0,0,0,0,0,0,0,0,2,0,0,2,1
3513,104950,0NdMcTtal4BOZ1xlXUgTc3KVGUjBSUot,SpATywNh6bZuzm8s1ceuBUnMUAeoAHHw,16,15,10,21,3,13,10,6,78,11.142857142857142,1,0.0,4,10,18,3,11,13,3,10,6,35,43,1
3514,104951,0FkQyM0LbhhmKgkelCOZLJl6X4aMe6Y7,bWdj2GDclj5ofokWjzoa5jAwMkxCykd6,6,3,1,0,1,0,2,0,7,1.0,1,0.0,0,1,0,1,3,0,0,2,0,2,5,1
3515,104963,Gp514eONX8HiKW2kWtPnfdmsO2W1ys65,SpATywNh6bZuzm8s1ceuBUnMUAeoAHHw,7,8,0,0,0,1,5,0,14,2.0,1,0.0,0,0,0,0,8,1,0,5,0,0,14,1
3516,104983,as0OGPaqUNY2AJHdTO1ghRp7pegJOTda,A3fsA9Zfv1X2fVEQhTw51lKENdNrEqT3,13,7,5,0,4,0,7,0,23,3.2857142857142856,1,0.0,0,5,0,4,7,0,0,7,0,9,14,1
3517,105000,pRiGzDKgwOgFTBnFOQaqzu3UaMPe8uNF,SpATywNh6bZuzm8s1ceuBUnMUAeoAHHw,16,15,6,10,3,2,5,0,41,5.857142857142857,1,0.0,6,6,9,3,9,2,1,5,0,24,17,0
3518,105006,0fpX00EX1TEQvQDvfUOFFIekoZBhUJ55,SpATywNh6bZuzm8s1ceuBUnMUAeoAHHw,10,19,0,20,0,3,4,0,46,6.571428571428571,1,0.0,9,0,16,0,10,3,4,4,0,25,21,1
3519,105009,MoIyInVwEhZdoyGdxNDzoAKuJ4ab4usf,G8EPVSXsOYB5YQWZGiz1aVq5Pgr2GrQu,13,9,2,18,2,0,2,0,33,4.714285714285714,1,0.0,6,2,12,2,3,0,6,2,0,22,11,1
3520,105045,AsBtR21xGFKZ6c2LKvPTdlawgiUBcaPL,A3fsA9Zfv1X2fVEQhTw51lKENdNrEqT3,7,6,3,0,2,0,1,0,12,1.7142857142857142,1,0.0,0,3,0,2,6,0,0,1,0,5,7,1
3521,105048,skA6GV4QKGFVtxye7Nlz906gXUD3qCvf,SpATywNh6bZuzm8s1ceuBUnMUAeoAHHw,13,28,5,10,0,4,6,1,54,7.714285714285714,2,0.0,10,5,9,0,18,4,1,6,1,24,30,1
3522,105077,0V54aOwQrSAMewtMntBBMI7Ks56rZdIS,SpATywNh6bZuzm8s1ceuBUnMUAeoAHHw,8,3,2,0,2,0,3,0,10,1.4285714285714286,1,0.0,0,2,0,2,3,0,0,3,0,4,6,1
3523,105087,il5WSyfV8t3AlDaoTevF0gOGZQXdoXsc,SpATywNh6bZuzm8s1ceuBUnMUAeoAHHw,2,0,0,0,0,0,2,0,2,0.2857142857142857,1,0.0,0,0,0,0,0,0,0,2,0,0,2,1
3524,105102,Oh8nsiPPTE9TLZe9wGx8wAMkvZwDEBik,SpATywNh6bZuzm8s1ceuBUnMUAeoAHHw,7,6,3,0,3,0,2,0,14,2.0,2,0.0,0,3,0,3,6,0,0,2,0,6,8,1
3525,105118,Qs7Gy3lEvMM83esFdoZ1zZvUeRYTAxxM,bWdj2GDclj5ofokWjzoa5jAwMkxCykd6,4,2,1,0,1,0,3,0,7,1.0,2,0.0,0,1,0,1,2,0,0,3,0,2,5,1
3526,105127,Vr52BPz4QZ36FT4KFVQoT6q0kUFkYRGt,A3fsA9Zfv1X2fVEQhTw51lKENdNrEqT3,2,0,0,0,0,0,4,0,4,0.5714285714285714,1,0.0,0,0,0,0,0,0,0,4,0,0,4,1
3527,105140,BAa1TxCsHWVGWhK6xiubabaADa3eqEud,A3fsA9Zfv1X2fVEQhTw51lKENdNrEqT3,2,0,0,0,0,0,2,0,2,0.2857142857142857,1,0.0,0,0,0,0,0,0,0,2,0,0,2,1
3528,105147,B5KRIhKjqiTl7SsQUviM99Uk4X6GH6qt,SpATywNh6bZuzm8s1ceuBUnMUAeoAHHw,4,2,1,0,0,0,2,0,5,0.7142857142857143,1,0.0,0,1,0,0,2,0,0,2,0,1,4,1
3529,105169,Ruj4G7IwBWWMNjdkNO62PMD51YZNkIvC,SpATywNh6bZuzm8s1ceuBUnMUAeoAHHw,6,1,1,0,1,0,3,0,6,0.8571428571428571,1,0.0,0,1,0,1,1,0,0,3,0,2,4,1
3530,105174,ek3MzKxIa2dEtIB8F3GcpuahHmTwWTB6,SpATywNh6bZuzm8s1ceuBUnMUAeoAHHw,7,14,2,0,1,0,3,0,20,2.857142857142857,2,0.0,5,2,0,1,9,0,0,3,0,8,12,1
3531,105179,3ZE4TsW4kNV4MayVbDMw5du6BBHsJQ28,bWdj2GDclj5ofokWjzoa5jAwMkxCykd6,4,2,0,0,0,1,3,0,6,0.8571428571428571,1,0.0,0,0,0,0,2,1,0,3,0,0,6,1
3532,105193,3KmURJPHsPOw8V9aGbkBVqZ8GfDwNzjb,SpATywNh6bZuzm8s1ceuBUnMUAeoAHHw,7,3,2,0,2,0,2,0,9,1.2857142857142858,1,0.0,0,2,0,2,3,0,0,2,0,4,5,1
3533,105213,f6fUoSUJslaShApLLQ3C3hAE39t0Ewco,A3fsA9Zfv1X2fVEQhTw51lKENdNrEqT3,1,0,0,0,0,0,1,0,1,0.14285714285714285,1,0.0,0,0,0,0,0,0,0,1,0,0,1,1
3534,105215,XqjUxB8l2EDnNsPmb4GmXeJWVp4D1ShM,SpATywNh6bZuzm8s1ceuBUnMUAeoAHHw,5,4,0,0,0,1,3,0,8,1.1428571428571428,1,0.0,0,0,0,0,4,1,0,3,0,0,8,1
3535,105238,D49L08bhYMDNZcjv8FPy2UNVru9gYK6t,bWdj2GDclj5ofokWjzoa5jAwMkxCykd6,5,1,1,0,1,0,2,0,5,0.7142857142857143,1,0.0,0,1,0,1,1,0,0,2,0,2,3,1
3536,105258,iaVYLE1BI86xpC2ERUpI1xclzmGmTOg0,SpATywNh6bZuzm8s1ceuBUnMUAeoAHHw,4,2,0,0,0,0,2,0,4,0.5714285714285714,1,0.0,0,0,0,0,2,0,0,2,0,0,4,1
3537,105265,yvMe4l8GZJNWinwQEogjzWQJd9z0H33J,SpATywNh6bZuzm8s1ceuBUnMUAeoAHHw,8,7,5,0,1,2,3,1,19,2.7142857142857144,1,0.0,0,5,0,1,7,2,0,3,1,6,13,1
3538,105277,KUZLnWk3DnESTDfMbkIGdOBiU12ntmts,A3fsA9Zfv1X2fVEQhTw51lKENdNrEqT3,7,4,2,0,1,0,8,0,15,2.142857142857143,1,0.0,1,2,0,1,3,0,0,8,0,4,11,1
3539,105309,8yGhHOYnj9M6W9ULBEe6c9dxuWlFPuyX,SpATywNh6bZuzm8s1ceuBUnMUAeoAHHw,5,3,2,0,1,0,2,0,8,1.1428571428571428,1,0.0,0,2,0,1,3,0,0,2,0,3,5,1
3540,105313,drUu3tyovHqnF7EAaPHayHDYbWMe2Od6,A3fsA9Zfv1X2fVEQhTw51lKENdNrEqT3,1,0,0,0,0,0,1,0,1,0.14285714285714285,1,0.0,0,0,0,0,0,0,0,1,0,0,1,1
3541,105323,yiX0lNiEyuJnsK7G0Hy1jjUqzZwKTcF0,SpATywNh6bZuzm8s1ceuBUnMUAeoAHHw,15,23,2,12,1,15,11,2,66,9.428571428571429,5,0.0,3,2,11,1,20,15,1,11,2,17,49,1
3542,105325,afcoJmZ0nAGqrhElRzMbfqW6LhEtEJYc,A3fsA9Zfv1X2fVEQhTw51lKENdNrEqT3,10,5,4,0,4,0,2,0,15,2.142857142857143,1,0.0,0,4,0,4,5,0,0,2,0,8,7,1
3543,105329,e7lti3fBvO8XZNtS4I7hMo5JFh6PqMCH,A3fsA9Zfv1X2fVEQhTw51lKENdNrEqT3,3,2,0,0,0,0,2,0,4,0.5714285714285714,1,0.0,0,0,0,0,2,0,0,2,0,0,4,1
3544,105330,l1I3uQILh7eNNq6Rwc2qZc5y0kyUy4xt,SpATywNh6bZuzm8s1ceuBUnMUAeoAHHw,1,0,0,0,0,0,1,0,1,0.14285714285714285,1,0.0,0,0,0,0,0,0,0,1,0,0,1,1
3545,105337,DI0mr4BQNoklidHTIy9m8FuU69db5M3W,SpATywNh6bZuzm8s1ceuBUnMUAeoAHHw,6,6,2,0,1,0,2,0,11,1.5714285714285714,2,0.0,0,2,0,1,6,0,0,2,0,3,8,1
3546,105339,fa4GjkZRgCxI5T2nX0B0SnNvYjPJTUJZ,bWdj2GDclj5ofokWjzoa5jAwMkxCykd6,2,0,0,0,0,0,3,0,3,0.42857142857142855,1,0.0,0,0,0,0,0,0,0,3,0,0,3,1
3547,105346,8cxCnT3STAEth9x4HzjOcerWufkhGlX3,SpATywNh6bZuzm8s1ceuBUnMUAeoAHHw,10,3,2,0,2,4,7,1,19,2.7142857142857144,1,0.0,0,2,0,2,3,4,0,7,1,4,15,1
3548,105348,jyuEVmbrPcyGnV7pufxSb0rPrKJZItsk,SpATywNh6bZuzm8s1ceuBUnMUAeoAHHw,16,26,12,19,7,2,4,0,70,10.0,2,0.0,12,12,16,7,14,2,3,4,0,47,23,1
3549,105354,yPqVjRtl1ZeCcEk7haS4nj4BOuHk3MT1,A3fsA9Zfv1X2fVEQhTw51lKENdNrEqT3,1,0,0,0,0,0,2,0,2,0.2857142857142857,1,0.0,0,0,0,0,0,0,0,2,0,0,2,1
3550,105357,Q9q5caNwjGe6Mi6I72wyiS18BJTL4KH1,SpATywNh6bZuzm8s1ceuBUnMUAeoAHHw,11,15,4,16,0,0,4,0,39,5.571428571428571,1,0.0,8,4,14,0,7,0,2,4,0,26,13,1
3551,105362,IqTYyD7L0euRgN3diEzqrprrc2W9uyF6,A3fsA9Zfv1X2fVEQhTw51lKENdNrEqT3,14,8,6,0,5,4,5,1,29,4.142857142857143,2,0.0,0,6,0,5,8,4,0,5,1,11,18,1
3552,105369,ATdd6t2UWonXImy5O3tzf7AEJJ0cHqzx,SpATywNh6bZuzm8s1ceuBUnMUAeoAHHw,3,0,0,0,0,0,3,0,3,0.42857142857142855,1,0.0,0,0,0,0,0,0,0,3,0,0,3,1
3553,105392,m52MhXMTVGYF4Y9Pc8zOC6jKXo973eSz,SpATywNh6bZuzm8s1ceuBUnMUAeoAHHw,1,0,0,0,0,0,1,0,1,0.14285714285714285,1,0.0,0,0,0,0,0,0,0,1,0,0,1,1
3554,105410,vqSgORDp5PsEpveQVJoPh4dnJvR6AQkK,A3fsA9Zfv1X2fVEQhTw51lKENdNrEqT3,1,0,0,0,0,0,1,0,1,0.14285714285714285,1,0.0,0,0,0,0,0,0,0,1,0,0,1,1
3555,105420,biOEnvJNbNmJmtnLohBToN5g3ppQrMj4,SpATywNh6bZuzm8s1ceuBUnMUAeoAHHw,3,3,1,0,0,0,2,0,6,0.8571428571428571,1,0.0,0,1,0,0,3,0,0,2,0,1,5,1
3556,105421,DgZ8el6keJUnUjxjYHQCrfhij2kpBixa,bWdj2GDclj5ofokWjzoa5jAwMkxCykd6,7,9,3,0,1,0,1,0,14,2.0,1,0.0,0,3,0,1,9,0,0,1,0,4,10,0
3557,105425,EBjWbzPkmDW0GuiUkHj889OvqfrdDhI2,SpATywNh6bZuzm8s1ceuBUnMUAeoAHHw,9,8,5,4,0,0,3,0,20,2.857142857142857,1,0.0,1,5,4,0,7,0,0,3,0,10,10,1
3558,105428,h3LsKXMnT4HqL0yI33YFdQ7c6aiA632R,SpATywNh6bZuzm8s1ceuBUnMUAeoAHHw,15,24,7,9,3,10,3,2,58,8.285714285714286,1,0.0,15,7,9,3,9,10,0,3,2,34,24,1
3559,105434,3n6ajKAkQu8rgtUnNpdWOfMF8VSNsMVs,A3fsA9Zfv1X2fVEQhTw51lKENdNrEqT3,4,2,1,0,0,0,3,0,6,0.8571428571428571,2,0.0,0,1,0,0,2,0,0,3,0,1,5,1
3560,105436,wbX1noywm1bmZy8t47H8TCRwxZP7RsKK,bWdj2GDclj5ofokWjzoa5jAwMkxCykd6,1,0,0,0,0,0,1,0,1,0.14285714285714285,1,0.0,0,0,0,0,0,0,0,1,0,0,1,1
3561,105438,4bmL6hoAF72J4V8IxCYpOyypEujwyDUs,A3fsA9Zfv1X2fVEQhTw51lKENdNrEqT3,6,2,0,0,0,1,5,0,8,1.1428571428571428,1,0.0,0,0,0,0,2,1,0,5,0,0,8,1
3562,105442,1YSmilr2ajm5pFk4iAawwfB3mRapy4GR,A3fsA9Zfv1X2fVEQhTw51lKENdNrEqT3,4,2,1,0,1,0,1,0,5,0.7142857142857143,1,0.0,0,1,0,1,2,0,0,1,0,2,3,1
3563,105467,dEPUxcdyZTnKUVP0o2JXv6VWX3ETnwmr,bWdj2GDclj5ofokWjzoa5jAwMkxCykd6,6,2,1,0,0,0,4,0,7,1.0,1,0.0,1,1,0,0,1,0,0,4,0,2,5,1
3564,105476,pMxyBMX7n5deuUC9YyUONEJJAyoPl0BG,SpATywNh6bZuzm8s1ceuBUnMUAeoAHHw,7,5,0,0,0,0,2,0,7,1.0,1,0.0,0,0,0,0,5,0,0,2,0,0,7,1
3565,105477,uMcognJuP2U8fvNcuj2o9G4hdrHlzffM,SpATywNh6bZuzm8s1ceuBUnMUAeoAHHw,8,13,6,0,0,1,11,1,32,4.571428571428571,1,0.0,2,6,0,0,11,1,0,11,1,8,24,1
3566,105482,sVA3jWGeZiIVEsBLKNyDfSGu7oUE3Uyc,A3fsA9Zfv1X2fVEQhTw51lKENdNrEqT3,2,0,0,0,0,0,5,0,5,0.7142857142857143,3,0.0,0,0,0,0,0,0,0,5,0,0,5,1
3567,105494,RS3yqsxA8GMaO1hS4uSnfa6jOPVVMGWD,bWdj2GDclj5ofokWjzoa5jAwMkxCykd6,6,3,1,0,1,0,2,0,7,1.0,1,0.0,0,1,0,1,3,0,0,2,0,2,5,1
3568,105531,E9EKlY1j2c1T8yweLd0nuHvfVuBiMa1Z,SpATywNh6bZuzm8s1ceuBUnMUAeoAHHw,1,0,0,0,0,0,1,0,1,0.14285714285714285,1,0.0,0,0,0,0,0,0,0,1,0,0,1,1
3569,105536,JiGlqAbyZaZegus8dku8k8Xk9BHhTCdV,SpATywNh6bZuzm8s1ceuBUnMUAeoAHHw,8,2,1,0,1,5,7,1,17,2.4285714285714284,1,0.0,0,1,0,1,2,5,0,7,1,2,15,1
3570,105547,x3ZcCHvytIJQEMLj5E05tgfA0i9bCC3E,SpATywNh6bZuzm8s1ceuBUnMUAeoAHHw,1,0,0,0,0,0,1,0,1,0.14285714285714285,1,0.0,0,0,0,0,0,0,0,1,0,0,1,1
3571,105556,aa0arothpvvvORCnYecBgFktA9Cuu0Tk,SpATywNh6bZuzm8s1ceuBUnMUAeoAHHw,12,10,7,4,5,0,2,0,28,4.0,1,0.0,0,7,4,5,10,0,0,2,0,16,12,1
3572,105558,GbO46rd9u4nTIYKWQ4uqsc2u6MxCvlf3,A3fsA9Zfv1X2fVEQhTw51lKENdNrEqT3,6,3,2,0,0,0,3,0,8,1.1428571428571428,1,0.0,0,2,0,0,3,0,0,3,0,2,6,1
3573,105566,QsEau4BvaT6rjAper2QSXSr2L9nKgnZa,SpATywNh6bZuzm8s1ceuBUnMUAeoAHHw,1,0,0,0,0,0,1,0,1,0.14285714285714285,1,0.0,0,0,0,0,0,0,0,1,0,0,1,0
3574,105583,Cb1oMMLwTjTacmho2xz7pvU7NsoZgScq,A3fsA9Zfv1X2fVEQhTw51lKENdNrEqT3,6,3,2,0,2,0,1,0,8,1.1428571428571428,1,0.0,0,2,0,2,3,0,0,1,0,4,4,1
3575,105593,CVNZnTiRds77aV88t7oO5JnyjLjE4gZ5,A3fsA9Zfv1X2fVEQhTw51lKENdNrEqT3,8,6,3,0,3,0,1,0,13,1.8571428571428572,1,0.0,0,3,0,3,6,0,0,1,0,6,7,1
3576,105607,Z91ylcCa0QBPuZRAZnN7Bi8KMhEMk84I,SpATywNh6bZuzm8s1ceuBUnMUAeoAHHw,1,0,0,0,0,0,1,0,1,0.14285714285714285,1,0.0,0,0,0,0,0,0,0,1,0,0,1,1
3577,105612,kTfeD1yVO5Jc7Nzx4cKtELWtok3ws4tr,bWdj2GDclj5ofokWjzoa5jAwMkxCykd6,8,10,0,0,0,36,8,1,55,7.857142857142857,2,0.0,2,0,0,0,8,36,0,8,1,2,53,1
3578,105617,6ZG1BmPHf4xACRz5Wb0XhmecfqdoDBrw,SpATywNh6bZuzm8s1ceuBUnMUAeoAHHw,9,10,2,0,0,1,7,1,21,3.0,1,0.0,0,2,0,0,10,1,0,7,1,2,19,1
3579,105621,Z2LpxeyN5IUym4huJGBt4liqsVm2EQ7Q,SpATywNh6bZuzm8s1ceuBUnMUAeoAHHw,18,26,8,21,3,18,19,1,96,13.714285714285714,3,0.0,6,8,16,3,20,18,5,19,1,33,63,0
3580,105630,UU4MEikmCGklRVK3djHNSk7yxxkesa3p,bWdj2GDclj5ofokWjzoa5jAwMkxCykd6,12,15,10,0,4,4,15,0,48,6.857142857142857,2,0.0,0,10,0,4,15,4,0,15,0,14,34,1
3581,105631,RWrD2aL8EikwNOiemk8w8nKZlf66LQBh,SpATywNh6bZuzm8s1ceuBUnMUAeoAHHw,1,0,0,0,0,0,1,0,1,0.14285714285714285,1,0.0,0,0,0,0,0,0,0,1,0,0,1,1
3582,105635,6UsHFnhiB8wUPOMCvGQlekDt4oV3KUX3,A3fsA9Zfv1X2fVEQhTw51lKENdNrEqT3,5,3,2,0,0,0,7,1,13,1.8571428571428572,2,0.0,0,2,0,0,3,0,0,7,1,2,11,1
3583,105657,GRVPWiEvNASyREwGmbaFNHUClZD26ajQ,A3fsA9Zfv1X2fVEQhTw51lKENdNrEqT3,9,3,3,0,3,0,3,0,12,1.7142857142857142,1,0.0,0,3,0,3,3,0,0,3,0,6,6,1
3584,105659,HDn8BqQviq3qzBRDiLH1seTa1wZLl2Fv,SpATywNh6bZuzm8s1ceuBUnMUAeoAHHw,2,0,0,0,0,0,2,0,2,0.2857142857142857,1,0.0,0,0,0,0,0,0,0,2,0,0,2,1
3585,105674,pPG4IhCdtFDb0ApVQ8Cw5mvhtg1pBVlc,A3fsA9Zfv1X2fVEQhTw51lKENdNrEqT3,1,0,0,0,0,0,1,0,1,0.14285714285714285,1,0.0,0,0,0,0,0,0,0,1,0,0,1,1
3586,105683,RyhsCovpAO4Tu33MEtD28G55TyhpodT7,bWdj2GDclj5ofokWjzoa5jAwMkxCykd6,1,0,0,0,0,0,2,0,2,0.2857142857142857,1,0.0,0,0,0,0,0,0,0,2,0,0,2,1
3587,105686,ZMYniXzfaHfNUK3JevOZjrK1dOWNKOE7,A3fsA9Zfv1X2fVEQhTw51lKENdNrEqT3,2,0,0,0,0,0,2,0,2,0.2857142857142857,1,0.0,0,0,0,0,0,0,0,2,0,0,2,1
3588,105692,vP4adNJVoKfOfC59LI5B3RjnV290gjOc,SpATywNh6bZuzm8s1ceuBUnMUAeoAHHw,4,2,0,0,0,0,2,0,4,0.5714285714285714,1,0.0,0,0,0,0,2,0,0,2,0,0,4,1
3589,105705,Higp7tL2evAdDfwxJ7Fv3MD5xI1FILhG,bWdj2GDclj5ofokWjzoa5jAwMkxCykd6,1,0,0,0,0,0,1,0,1,0.14285714285714285,1,0.0,0,0,0,0,0,0,0,1,0,0,1,1
3590,105717,YGd4irzc5KMR1PH2KdOtbCkghLMZ2dPk,SpATywNh6bZuzm8s1ceuBUnMUAeoAHHw,9,6,4,10,0,0,2,0,22,3.142857142857143,1,0.0,2,4,9,0,4,0,1,2,0,15,7,1
3591,106440,FiDLmZS7SZoCB8c2FPrLrdnRZi9p4XPX,bWdj2GDclj5ofokWjzoa5jAwMkxCykd6,4,2,1,0,1,0,1,0,5,0.7142857142857143,1,0.0,0,1,0,1,2,0,0,1,0,2,3,0
3592,106860,6lERIt9LK72b4gBh1gc6JqDmon4igZIH,A3fsA9Zfv1X2fVEQhTw51lKENdNrEqT3,4,2,1,0,1,0,1,0,5,0.7142857142857143,1,0.0,0,1,0,1,2,0,0,1,0,2,3,0
3593,106897,yrxUCbkwiU0Qgu0wZMF5MylHBneN7zri,SpATywNh6bZuzm8s1ceuBUnMUAeoAHHw,10,15,8,5,5,0,2,0,35,5.0,1,0.0,0,8,5,5,15,0,0,2,0,18,17,0
3594,107984,ZvjGFQSLt8Pf81ZTzV1faPXh7hwFiT2P,bWdj2GDclj5ofokWjzoa5jAwMkxCykd6,5,2,1,0,1,0,2,0,6,0.8571428571428571,1,0.0,0,1,0,1,2,0,0,2,0,2,4,1
3595,108010,Yw9EoSKbruOuBH6aQRkV9fYbTLRt0cv4,RXDvfPUBYFlVdlueBFbLW0mhhAyGEqpt,17,26,14,0,4,33,8,11,96,13.714285714285714,2,0.0,3,14,0,4,23,33,0,8,11,21,75,0
3596,108016,oqv7kZUhC1l3nFsgavJo476khlgSwYid,SpATywNh6bZuzm8s1ceuBUnMUAeoAHHw,1,0,0,0,0,0,1,0,1,0.14285714285714285,1,0.0,0,0,0,0,0,0,0,1,0,0,1,1
3597,108020,0vxEa23unQMrxuymP5mTGCJs9sE8CeTU,SpATywNh6bZuzm8s1ceuBUnMUAeoAHHw,1,0,0,0,0,0,2,0,2,0.2857142857142857,1,0.0,0,0,0,0,0,0,0,2,0,0,2,1
3598,108024,0twK7rhgKGqeqt1sYkdUHMDWvjIusJRc,SpATywNh6bZuzm8s1ceuBUnMUAeoAHHw,7,3,2,0,2,0,2,0,9,1.2857142857142858,1,0.0,0,2,0,2,3,0,0,2,0,4,5,1
3599,108034,2jvZGTQOv5HI5u69PvJ98o1zG3YXhtLw,G8EPVSXsOYB5YQWZGiz1aVq5Pgr2GrQu,14,12,1,38,0,0,3,0,54,7.714285714285714,1,0.0,5,1,34,0,7,0,4,3,0,40,14,1
3600,108042,aF4i8JIBNexmNiVkNsVLybq4ZcEaP7YR,SpATywNh6bZuzm8s1ceuBUnMUAeoAHHw,6,2,1,0,1,0,3,0,7,1.0,1,0.0,0,1,0,1,2,0,0,3,0,2,5,1
3601,108050,eJGGi2xDKgvawXthli4R4Tq9NtEOUzLF,SpATywNh6bZuzm8s1ceuBUnMUAeoAHHw,1,0,0,0,0,0,1,0,1,0.14285714285714285,1,0.0,0,0,0,0,0,0,0,1,0,0,1,1
3602,108052,wBGtqMIqfQE0VLJPhcCJAUkBOhFNa6qW,SpATywNh6bZuzm8s1ceuBUnMUAeoAHHw,8,3,2,0,2,1,6,1,15,2.142857142857143,1,0.0,0,2,0,2,3,1,0,6,1,4,11,1
3603,108071,EboqTOLce3Kcnbr13rePsINEM3noHrcD,G8EPVSXsOYB5YQWZGiz1aVq5Pgr2GrQu,18,13,7,16,4,2,13,6,61,8.714285714285714,3,0.0,1,7,13,4,12,2,3,13,6,25,36,0
3604,108073,RMWokNypcdQUZgRk5KLBAzdNAXoaWUZf,G8EPVSXsOYB5YQWZGiz1aVq5Pgr2GrQu,6,6,1,0,0,1,4,0,12,1.7142857142857142,2,0.0,0,1,0,0,6,1,0,4,0,1,11,1
3605,108131,IBlECzoX8mSOCzZYc1uWUiXexIzVTXM2,SpATywNh6bZuzm8s1ceuBUnMUAeoAHHw,8,5,3,0,2,1,5,0,16,2.2857142857142856,1,0.0,0,3,0,2,5,1,0,5,0,5,11,1
3606,108136,JtMmp5BCDQnYE7CMI3NvnX4aRCZsQW9K,SpATywNh6bZuzm8s1ceuBUnMUAeoAHHw,1,0,0,0,0,0,1,0,1,0.14285714285714285,1,0.0,0,0,0,0,0,0,0,1,0,0,1,1
3607,108150,JtMmp5BCDQnYE7CMI3NvnX4aRCZsQW9K,G8EPVSXsOYB5YQWZGiz1aVq5Pgr2GrQu,1,0,0,0,0,0,1,0,1,0.14285714285714285,1,0.0,0,0,0,0,0,0,0,1,0,0,1,1
3608,108157,qkSLpyUXo3wNVtHKY2foszTLsaaG0zFf,SpATywNh6bZuzm8s1ceuBUnMUAeoAHHw,7,9,5,0,1,0,6,0,21,3.0,1,0.0,0,5,0,1,9,0,0,6,0,6,15,1
3609,108159,7wwnUxCzQI2wyfpl5OyzTa3WTS3Ri45e,A3fsA9Zfv1X2fVEQhTw51lKENdNrEqT3,6,3,1,0,1,0,5,0,10,1.4285714285714286,1,0.0,0,1,0,1,3,0,0,5,0,2,8,1
3610,108176,3uS5WA36Sj3PVBnvxWDx1MwVkWDCgzsS,SpATywNh6bZuzm8s1ceuBUnMUAeoAHHw,2,0,0,0,0,0,2,0,2,0.2857142857142857,1,0.0,0,0,0,0,0,0,0,2,0,0,2,1
3611,108194,BUjI8VQSt0tGyIQBRIK2BBh4HRC6a57H,SpATywNh6bZuzm8s1ceuBUnMUAeoAHHw,7,11,5,0,2,0,4,0,22,3.142857142857143,2,0.0,0,5,0,2,11,0,0,4,0,7,15,1
3612,108212,dbPMzxs1MK4eXxSu7capyuymr7qmuT7h,SpATywNh6bZuzm8s1ceuBUnMUAeoAHHw,13,13,4,12,3,0,3,0,35,5.0,1,0.0,7,4,11,3,6,0,1,3,0,25,10,1
3613,108216,vpqIMSPa2wuLU7jLHJxpKglWXRMFM5XG,G8EPVSXsOYB5YQWZGiz1aVq5Pgr2GrQu,10,6,3,0,3,0,3,0,15,2.142857142857143,1,0.0,1,3,0,3,5,0,0,3,0,7,8,1
3614,108224,Q5TmTVdy8nnH2vTL73s67ZseaCMO3k91,A3fsA9Zfv1X2fVEQhTw51lKENdNrEqT3,22,16,14,22,3,0,15,0,70,10.0,1,0.0,0,14,17,3,16,0,5,15,0,34,36,1
3615,108232,Vuj7KEezi5cbt5TkGTsUazylLOCSeSWW,G8EPVSXsOYB5YQWZGiz1aVq5Pgr2GrQu,6,7,1,0,1,1,5,0,15,2.142857142857143,1,0.0,4,1,0,1,3,1,0,5,0,6,9,1
3616,108238,kacdt9t6znrlEBdAnqrcK2PQA5VKsmyU,bWdj2GDclj5ofokWjzoa5jAwMkxCykd6,1,0,0,0,0,0,1,0,1,0.14285714285714285,1,0.0,0,0,0,0,0,0,0,1,0,0,1,1
3617,108248,GfEp1fhW8V7ekci3T3EdNbH3NBJ6ewC2,bWdj2GDclj5ofokWjzoa5jAwMkxCykd6,10,14,9,0,4,0,6,0,33,4.714285714285714,2,0.0,0,9,0,4,14,0,0,6,0,13,20,1
3618,108249,U86H0D53uFDssNj4hNXQwNhRzNF9WB0g,SpATywNh6bZuzm8s1ceuBUnMUAeoAHHw,10,3,2,0,2,0,4,0,11,1.5714285714285714,1,0.0,0,2,0,2,3,0,0,4,0,4,7,1
3619,108253,ZBWbhIaLqDYBcX3S1kBM4TsAR4PCNgfw,SpATywNh6bZuzm8s1ceuBUnMUAeoAHHw,1,0,0,0,0,0,1,0,1,0.14285714285714285,1,0.0,0,0,0,0,0,0,0,1,0,0,1,1
3620,108260,BKTGezJoHjleu4tXARXtOL0EOZtL4wb9,A3fsA9Zfv1X2fVEQhTw51lKENdNrEqT3,5,6,3,0,0,0,2,0,11,1.5714285714285714,1,0.0,0,3,0,0,6,0,0,2,0,3,8,1
3621,108287,vD0of5WrmeM0o4WJQ1K1mROO3xI4vaqL,A3fsA9Zfv1X2fVEQhTw51lKENdNrEqT3,8,11,9,0,0,0,3,0,23,3.2857142857142856,1,0.0,0,9,0,0,11,0,0,3,0,9,14,1
3622,108322,fDs5TBVrvPHEIMLkBACIVQ2YkCdHCFLD,G8EPVSXsOYB5YQWZGiz1aVq5Pgr2GrQu,1,0,0,0,0,0,1,0,1,0.14285714285714285,1,0.0,0,0,0,0,0,0,0,1,0,0,1,1
3623,108332,t3IeBt0q2KGXGh8PROvXa3GntwInvrsf,SpATywNh6bZuzm8s1ceuBUnMUAeoAHHw,12,19,5,15,3,5,6,0,53,7.571428571428571,1,0.0,14,5,14,3,5,5,1,6,0,36,17,1
3624,108334,OTVmyM3oMOEh3RPUJ9JvZ1cqJuClk9Op,bWdj2GDclj5ofokWjzoa5jAwMkxCykd6,6,5,2,0,1,0,3,0,11,1.5714285714285714,1,0.0,1,2,0,1,4,0,0,3,0,4,7,1
3625,108352,iqv1ZLT0r4OWnPHIoXugw2YP50zRTQ28,SpATywNh6bZuzm8s1ceuBUnMUAeoAHHw,8,4,3,0,2,0,2,0,11,1.5714285714285714,1,0.0,0,3,0,2,4,0,0,2,0,5,6,1
3626,108405,uyomj5PLSD8MuBnIm3UXNOM2zJB1f3kv,A3fsA9Zfv1X2fVEQhTw51lKENdNrEqT3,13,11,1,22,0,0,4,0,38,5.428571428571429,1,0.0,0,1,18,0,11,0,4,4,0,19,19,1
3627,108406,bQyZ6DmGQSg1Dv1lCa5q9TEfeZ36WEXr,SpATywNh6bZuzm8s1ceuBUnMUAeoAHHw,5,2,1,0,1,0,2,0,6,0.8571428571428571,1,0.0,0,1,0,1,2,0,0,2,0,2,4,1
3628,108412,SEiKj37VG0PEpKDpAqYMYNdcODsfurcu,SpATywNh6bZuzm8s1ceuBUnMUAeoAHHw,1,0,0,0,0,0,1,0,1,0.14285714285714285,1,0.0,0,0,0,0,0,0,0,1,0,0,1,1
3629,108421,Z8VFKUoySr9L7FZfGeoeDWQqxwnJbTos,SpATywNh6bZuzm8s1ceuBUnMUAeoAHHw,10,16,0,13,0,1,3,0,33,4.714285714285714,1,0.0,3,0,13,0,13,1,0,3,0,16,17,0
3630,108427,xVeg2852GnVdRuLPSlBP0iZfvv9oAoyC,SpATywNh6bZuzm8s1ceuBUnMUAeoAHHw,9,3,2,0,2,1,4,1,13,1.8571428571428572,1,0.0,0,2,0,2,3,1,0,4,1,4,9,1
3631,108446,d08ApNp1WFaPBGXKvD3xbJPFNLpPIfS7,A3fsA9Zfv1X2fVEQhTw51lKENdNrEqT3,1,0,0,0,0,0,1,0,1,0.14285714285714285,1,0.0,0,0,0,0,0,0,0,1,0,0,1,1
3632,108449,dclSFP3hreeLXdhyb5AYWKpQgF9cKZB8,A3fsA9Zfv1X2fVEQhTw51lKENdNrEqT3,1,0,0,0,0,0,2,0,2,0.2857142857142857,1,0.0,0,0,0,0,0,0,0,2,0,0,2,1
3633,108452,Da1XsE2lZHBZahEFVPSmxclehQ2xZK1j,RXDvfPUBYFlVdlueBFbLW0mhhAyGEqpt,1,0,0,0,0,0,2,0,2,0.2857142857142857,2,0.0,0,0,0,0,0,0,0,2,0,0,2,1
3634,108457,AeCrxYByugIwu4XUBpI0LhoTguBozLAa,A3fsA9Zfv1X2fVEQhTw51lKENdNrEqT3,41,26,13,74,10,0,4,0,127,18.142857142857142,2,0.0,1,13,66,10,25,0,8,4,0,90,37,1
3635,108519,Wz77TRcICZ17h9qFLsblYtkOSc4ixQ6c,G8EPVSXsOYB5YQWZGiz1aVq5Pgr2GrQu,11,8,3,0,3,1,6,1,22,3.142857142857143,1,0.0,3,3,0,3,5,1,0,6,1,9,13,1
3636,108541,vZzTgGwK0cR24BSm1xzdfANP52hj4iMk,bWdj2GDclj5ofokWjzoa5jAwMkxCykd6,2,0,0,0,0,0,2,0,2,0.2857142857142857,1,0.0,0,0,0,0,0,0,0,2,0,0,2,1
3637,108543,vZzTgGwK0cR24BSm1xzdfANP52hj4iMk,A3fsA9Zfv1X2fVEQhTw51lKENdNrEqT3,1,0,0,0,0,0,1,0,1,0.14285714285714285,1,0.0,0,0,0,0,0,0,0,1,0,0,1,1
3638,108545,RzzALWvRctgoyhkcvSWQNXbBdfBwiqD5,A3fsA9Zfv1X2fVEQhTw51lKENdNrEqT3,26,11,10,24,8,0,1,0,54,7.714285714285714,1,0.0,0,10,23,8,11,0,1,1,0,41,13,1
3639,108563,cJebZdZYNfcRFrDILULKtUjsVZucvQNZ,A3fsA9Zfv1X2fVEQhTw51lKENdNrEqT3,1,0,0,0,0,0,2,0,2,0.2857142857142857,1,0.0,0,0,0,0,0,0,0,2,0,0,2,1
3640,108568,nMLZADizXQkPbs7I128RAOQN3Z54bNq5,G8EPVSXsOYB5YQWZGiz1aVq5Pgr2GrQu,1,0,0,0,0,0,1,0,1,0.14285714285714285,1,0.0,0,0,0,0,0,0,0,1,0,0,1,1
3641,108580,T96tu0kAAtO9h4UaJoJi1p0l5O91f75g,SpATywNh6bZuzm8s1ceuBUnMUAeoAHHw,1,0,0,0,0,0,1,0,1,0.14285714285714285,1,0.0,0,0,0,0,0,0,0,1,0,0,1,1
3642,108593,b5A378d0kY1phoH7ZEYLGeRu5gSN3Jom,bWdj2GDclj5ofokWjzoa5jAwMkxCykd6,3,3,0,0,0,0,1,0,4,0.5714285714285714,1,0.0,0,0,0,0,3,0,0,1,0,0,4,1
3643,108610,fwSe9M4wVBk21yhnHfi9Elq0Dtd4QFmB,A3fsA9Zfv1X2fVEQhTw51lKENdNrEqT3,1,0,0,0,0,0,1,0,1,0.14285714285714285,1,0.0,0,0,0,0,0,0,0,1,0,0,1,1
3644,108613,8QplB1koC0Z3ESwyMSDlYtTT9MlUMn1q,SpATywNh6bZuzm8s1ceuBUnMUAeoAHHw,15,23,8,17,3,4,3,1,59,8.428571428571429,1,0.0,6,8,15,3,17,4,2,3,1,32,27,1
3645,108618,6pZAnEuoA7RiYeKYKN3oDQwjOWGfm51A,A3fsA9Zfv1X2fVEQhTw51lKENdNrEqT3,6,7,3,0,1,0,2,0,13,1.8571428571428572,1,0.0,0,3,0,1,7,0,0,2,0,4,9,1
3646,108642,kjQDeVPqENR6xvjjKnsVoxY8hUaoqktw,A3fsA9Zfv1X2fVEQhTw51lKENdNrEqT3,1,0,0,0,0,0,1,0,1,0.14285714285714285,1,0.0,0,0,0,0,0,0,0,1,0,0,1,1
3647,108643,hkTx4XunczsnVq4H9eVYRZURkkofvB6I,A3fsA9Zfv1X2fVEQhTw51lKENdNrEqT3,39,22,11,60,8,0,4,0,105,15.0,1,0.0,1,11,48,8,21,0,12,4,0,68,37,1
3648,108645,GC5D689aLkJhzPWQtqYm81ojaLgS2Wpz,A3fsA9Zfv1X2fVEQhTw51lKENdNrEqT3,6,1,0,0,0,0,4,1,6,0.8571428571428571,1,0.0,0,0,0,0,1,0,0,4,1,0,6,1
3649,108650,9RsO9nEnlOjxAtY8xl5lBuOHOGbVMyeg,A3fsA9Zfv1X2fVEQhTw51lKENdNrEqT3,11,9,5,0,4,0,3,0,21,3.0,1,0.0,0,5,0,4,9,0,0,3,0,9,12,1
3650,108658,FAjTaGnsfZLBQS9slQbYMPpuh5mcYxue,SpATywNh6bZuzm8s1ceuBUnMUAeoAHHw,8,3,1,10,0,0,4,1,19,2.7142857142857144,1,0.0,2,1,9,0,1,0,1,4,1,12,7,0
3651,108675,EQrILQPubl10Uf5lVjVEtCpelMBJDysL,A3fsA9Zfv1X2fVEQhTw51lKENdNrEqT3,4,2,1,0,1,0,1,0,5,0.7142857142857143,1,0.0,0,1,0,1,2,0,0,1,0,2,3,1
3652,108685,vUg72yuNvNQBasGeqPwQue3GKgSAK3Os,A3fsA9Zfv1X2fVEQhTw51lKENdNrEqT3,43,13,11,70,10,6,5,1,116,16.571428571428573,1,0.0,1,11,61,10,12,6,9,5,1,83,33,1
3653,108690,Ofc6ixmmoavYN92PkloL7C1g0H36jbU2,bWdj2GDclj5ofokWjzoa5jAwMkxCykd6,5,2,1,0,1,0,2,0,6,0.8571428571428571,1,0.0,0,1,0,1,2,0,0,2,0,2,4,1
3654,108691,ETnDIYS5Ij7vrZAmbXEAqG1htLhXjsuH,SpATywNh6bZuzm8s1ceuBUnMUAeoAHHw,2,0,0,0,0,0,3,0,3,0.42857142857142855,1,0.0,0,0,0,0,0,0,0,3,0,0,3,1
3655,108692,Ofc6ixmmoavYN92PkloL7C1g0H36jbU2,RXDvfPUBYFlVdlueBFbLW0mhhAyGEqpt,5,3,1,0,1,0,2,0,7,1.0,1,0.0,0,1,0,1,3,0,0,2,0,2,5,1
3656,108709,WVlATpkkXvQVe3Tvai8IoxKvCeKjRiIw,A3fsA9Zfv1X2fVEQhTw51lKENdNrEqT3,4,2,1,0,1,0,1,0,5,0.7142857142857143,1,0.0,0,1,0,1,2,0,0,1,0,2,3,1
3657,108716,vEKYOhRdGZ59kfXY6wTO63YZY4EqPYqX,A3fsA9Zfv1X2fVEQhTw51lKENdNrEqT3,1,0,0,0,0,0,2,0,2,0.2857142857142857,1,0.0,0,0,0,0,0,0,0,2,0,0,2,1
3658,108726,SjPvBG8Fb7d7fOOQdZd3mlZyesFaFzzS,SpATywNh6bZuzm8s1ceuBUnMUAeoAHHw,12,16,4,9,3,8,1,0,41,5.857142857142857,1,0.0,11,4,9,3,5,8,0,1,0,27,14,1
3659,108730,APkKPEpve0ecRJut2qy8IYwsafYtrJRq,A3fsA9Zfv1X2fVEQhTw51lKENdNrEqT3,1,0,0,0,0,0,1,0,1,0.14285714285714285,1,0.0,0,0,0,0,0,0,0,1,0,0,1,1
3660,108759,bhb17IwRClCqRNHE7gBYbr4QuZbINJH7,SpATywNh6bZuzm8s1ceuBUnMUAeoAHHw,8,2,1,0,1,0,4,1,9,1.2857142857142858,1,0.0,0,1,0,1,2,0,0,4,1,2,7,1
3661,108770,i91HA7YyZRSQdFHabHG3p2UNPo1UnEE9,SpATywNh6bZuzm8s1ceuBUnMUAeoAHHw,6,0,0,0,0,1,5,1,7,1.0,1,0.0,0,0,0,0,0,1,0,5,1,0,7,1
3662,108777,jqvna1BzHcNX8F2L51mHo8iTsRvtrp5h,G8EPVSXsOYB5YQWZGiz1aVq5Pgr2GrQu,5,2,0,0,0,0,3,1,6,0.8571428571428571,1,0.0,0,0,0,0,2,0,0,3,1,0,6,1
3663,108783,XJEGQFjl8bj0TlozEJx10miZtxUTAzR8,G8EPVSXsOYB5YQWZGiz1aVq5Pgr2GrQu,6,5,2,0,0,0,2,0,9,1.2857142857142858,1,0.0,0,2,0,0,5,0,0,2,0,2,7,1
3664,108788,lE2eUyNgAborZHVo0d0toAQgs9JY0elm,bWdj2GDclj5ofokWjzoa5jAwMkxCykd6,1,0,0,0,0,0,1,0,1,0.14285714285714285,1,0.0,0,0,0,0,0,0,0,1,0,0,1,1
3665,108794,YpN0FUGuAT4i4OgsV1AMvBTJ03FCi4h4,SpATywNh6bZuzm8s1ceuBUnMUAeoAHHw,13,19,6,19,3,0,1,0,48,6.857142857142857,1,0.0,11,6,18,3,8,0,1,1,0,38,10,1
3666,108802,G6Ra4LKWBFlkpiQLwJKXdjsFL1NYBNU7,SpATywNh6bZuzm8s1ceuBUnMUAeoAHHw,8,10,7,0,4,0,8,1,30,4.285714285714286,1,0.0,0,7,0,4,10,0,0,8,1,11,19,1
3667,108816,7tzKJch94HYBj1yvg1gEwizifcqZuqol,SpATywNh6bZuzm8s1ceuBUnMUAeoAHHw,14,16,8,9,5,11,6,2,57,8.142857142857142,1,0.0,7,8,9,5,9,11,0,6,2,29,28,1
3668,108817,JJML5NgT9kE9CQ1mkNivVNVP1TfRNDmZ,G8EPVSXsOYB5YQWZGiz1aVq5Pgr2GrQu,10,11,3,0,3,0,3,0,20,2.857142857142857,2,0.0,5,3,0,3,6,0,0,3,0,11,9,1
3669,108819,y2DmmWW7ijkXHglZV8tDd3ydHBY1lyEP,SpATywNh6bZuzm8s1ceuBUnMUAeoAHHw,11,7,2,12,1,6,5,1,34,4.857142857142857,1,0.0,4,2,12,1,3,6,0,5,1,19,15,1
3670,108823,ToFnQfVVYpsgtNup5oaVFrzJEXqZqLe7,SpATywNh6bZuzm8s1ceuBUnMUAeoAHHw,4,3,1,0,1,0,1,0,6,0.8571428571428571,1,0.0,0,1,0,1,3,0,0,1,0,2,4,1
3671,108832,fZ0FA06F54ZxAJdajcaJsw9dO9sZFuoy,SpATywNh6bZuzm8s1ceuBUnMUAeoAHHw,8,3,2,0,2,2,4,1,14,2.0,1,0.0,0,2,0,2,3,2,0,4,1,4,10,1
3672,108836,S2vZm8iaot7LbfQexObVqVFppwpxyTJj,RXDvfPUBYFlVdlueBFbLW0mhhAyGEqpt,13,9,1,0,1,2,7,2,22,3.142857142857143,1,0.0,0,1,0,1,9,2,0,7,2,2,20,1
3673,108840,Gmz5iMjiwcyTx4KusyWM0rOecmUutZaf,bWdj2GDclj5ofokWjzoa5jAwMkxCykd6,7,4,2,0,1,0,3,0,10,1.4285714285714286,1,0.0,0,2,0,1,4,0,0,3,0,3,7,1
3674,108848,Aj8S98OGNNNrJMemSZdPdZipwwjNd5vE,A3fsA9Zfv1X2fVEQhTw51lKENdNrEqT3,8,7,3,0,3,0,1,0,14,2.0,1,0.0,0,3,0,3,7,0,0,1,0,6,8,0
3675,108863,rFLx9fxaxLoqhUJucYhN0TS80ql3o0el,G8EPVSXsOYB5YQWZGiz1aVq5Pgr2GrQu,6,3,2,0,2,4,1,0,12,1.7142857142857142,1,0.0,0,2,0,2,3,4,0,1,0,4,8,1
3676,108870,EyBRRLQ9lC714P9pZPb13KmtdxaOzX2x,A3fsA9Zfv1X2fVEQhTw51lKENdNrEqT3,5,2,1,0,1,0,2,0,6,0.8571428571428571,1,0.0,0,1,0,1,2,0,0,2,0,2,4,1
3677,108881,wKWD0CLruBoVWyxPKWZ61pmQ3HoT2Bog,SpATywNh6bZuzm8s1ceuBUnMUAeoAHHw,4,2,0,0,0,0,2,0,4,0.5714285714285714,1,0.0,0,0,0,0,2,0,0,2,0,0,4,1
3678,108896,rFLx9fxaxLoqhUJucYhN0TS80ql3o0el,SpATywNh6bZuzm8s1ceuBUnMUAeoAHHw,6,3,2,0,2,14,1,0,22,3.142857142857143,1,0.0,0,2,0,2,3,14,0,1,0,4,18,1
3679,108911,IcSi6sLfpSlHjHhdlf5rd2h3NSptZDO1,A3fsA9Zfv1X2fVEQhTw51lKENdNrEqT3,1,0,0,0,0,0,2,0,2,0.2857142857142857,1,0.0,0,0,0,0,0,0,0,2,0,0,2,1
3680,108918,vSo169SOn6AJKRTPbSllZALjmnCkOElL,G8EPVSXsOYB5YQWZGiz1aVq5Pgr2GrQu,12,28,4,0,3,1,23,1,60,8.571428571428571,3,0.0,0,4,0,3,28,1,0,23,1,7,53,1
3681,108937,GrD7pvZobVcyydLOoZLt2XOTjKEE4rVN,A3fsA9Zfv1X2fVEQhTw51lKENdNrEqT3,1,0,0,0,0,0,1,0,1,0.14285714285714285,1,0.0,0,0,0,0,0,0,0,1,0,0,1,1
3682,108940,4JgrlxTTs75mHh4mrh8qrfNDEELryL3p,A3fsA9Zfv1X2fVEQhTw51lKENdNrEqT3,22,30,13,0,10,0,5,0,58,8.285714285714286,1,0.0,0,13,0,10,30,0,0,5,0,23,35,1
3683,108943,tBILMisvPJumSCkGoqvXZmjsWBPsAhcx,RXDvfPUBYFlVdlueBFbLW0mhhAyGEqpt,1,0,0,0,0,0,1,0,1,0.14285714285714285,1,0.0,0,0,0,0,0,0,0,1,0,0,1,1
3684,108949,jcbtaVIpxYLzIPm0BM5PQEVvcUjaS5Wk,SpATywNh6bZuzm8s1ceuBUnMUAeoAHHw,5,2,1,0,1,0,4,0,8,1.1428571428571428,2,0.0,0,1,0,1,2,0,0,4,0,2,6,1
3685,108954,kLrl7hvNIzvhv6K321CFhgLYEgDfA62M,A3fsA9Zfv1X2fVEQhTw51lKENdNrEqT3,3,3,1,0,0,0,1,0,5,0.7142857142857143,1,0.0,0,1,0,0,3,0,0,1,0,1,4,1
3686,108956,cQImh85eb0T3yUp3SL5f7uBssRRbM6Re,A3fsA9Zfv1X2fVEQhTw51lKENdNrEqT3,9,9,1,0,1,0,3,0,14,2.0,1,0.0,0,1,0,1,9,0,0,3,0,2,12,1
3687,108964,a5FYs3qIaiIKIJ0gF2U8byHoJI2aZV3O,SpATywNh6bZuzm8s1ceuBUnMUAeoAHHw,2,0,0,0,0,0,2,0,2,0.2857142857142857,1,0.0,0,0,0,0,0,0,0,2,0,0,2,1
3688,108986,YCpaFH59BZea33ilZmurVIrcGKs7kkSW,A3fsA9Zfv1X2fVEQhTw51lKENdNrEqT3,8,7,5,0,0,1,4,2,19,2.7142857142857144,1,0.0,0,5,0,0,7,1,0,4,2,5,14,1
3689,109051,QzYbn86ruFNwqcTxxFURk0zGhEatBUQQ,RXDvfPUBYFlVdlueBFbLW0mhhAyGEqpt,1,0,0,0,0,0,1,0,1,0.14285714285714285,1,0.0,0,0,0,0,0,0,0,1,0,0,1,1
3690,109052,YQuE8HipF2FTxF6yilCc6Hjt2hO1hf9q,A3fsA9Zfv1X2fVEQhTw51lKENdNrEqT3,14,6,4,0,3,3,9,2,27,3.857142857142857,1,0.0,0,4,0,3,6,3,0,9,2,7,20,1
3691,109053,L7J2caDjAzkqOGAjsx5a9Dl5Aldyaum1,G8EPVSXsOYB5YQWZGiz1aVq5Pgr2GrQu,20,15,10,40,5,0,6,0,76,10.857142857142858,1,0.0,5,10,35,5,10,0,5,6,0,55,21,1
3692,109068,XkjQH424HqtaqeKw3sfi1hEAdISSsUfo,SpATywNh6bZuzm8s1ceuBUnMUAeoAHHw,5,2,1,0,1,0,2,0,6,0.8571428571428571,1,0.0,0,1,0,1,2,0,0,2,0,2,4,1
3693,109076,rqibqLTSyQMTu8RtpalbPrVfa4YBNses,A3fsA9Zfv1X2fVEQhTw51lKENdNrEqT3,1,0,0,0,0,0,1,0,1,0.14285714285714285,1,0.0,0,0,0,0,0,0,0,1,0,0,1,1
3694,109083,eRuuxh46RK1wEtA4qinnmcAexePgrgfl,A3fsA9Zfv1X2fVEQhTw51lKENdNrEqT3,2,0,0,0,0,0,4,0,4,0.5714285714285714,1,0.0,0,0,0,0,0,0,0,4,0,0,4,1
3695,109094,W72vMFAqWF3rx04XbAdkI4z1Q7B2JuRi,A3fsA9Zfv1X2fVEQhTw51lKENdNrEqT3,6,2,1,0,1,1,3,0,8,1.1428571428571428,1,0.0,0,1,0,1,2,1,0,3,0,2,6,1
3696,109103,MZomFQTbHAKaDGd0B9fv7KQ9MRsZJ7m6,A3fsA9Zfv1X2fVEQhTw51lKENdNrEqT3,1,0,0,0,0,0,1,0,1,0.14285714285714285,1,0.0,0,0,0,0,0,0,0,1,0,0,1,1
3697,109113,PsjDYcq0jr7p5zzKT5Q6GyQwL0TaEGxZ,SpATywNh6bZuzm8s1ceuBUnMUAeoAHHw,1,0,0,0,0,0,1,0,1,0.14285714285714285,1,0.0,0,0,0,0,0,0,0,1,0,0,1,1
3698,109133,ktJXKKINyOPjiCF3mohYZXSugYepgG15,bWdj2GDclj5ofokWjzoa5jAwMkxCykd6,6,2,0,0,0,2,4,2,10,1.4285714285714286,1,0.0,0,0,0,0,2,2,0,4,2,0,10,1
3699,109134,V9A9B2T9pRTU3AqvpqzuKs4MfRcAEte2,A3fsA9Zfv1X2fVEQhTw51lKENdNrEqT3,10,21,13,0,10,0,9,0,53,7.571428571428571,2,0.0,0,13,0,10,21,0,0,9,0,23,30,1
3700,109141,cj6ogEjauZu0hDMlOaFW3lBaL32xGBVV,A3fsA9Zfv1X2fVEQhTw51lKENdNrEqT3,33,18,0,44,0,1,5,0,68,9.714285714285714,1,0.0,1,0,44,0,17,1,0,5,0,45,23,1
3701,109159,qflx2gEpsoPySBX8xNwFSgJhYyLnWK68,SpATywNh6bZuzm8s1ceuBUnMUAeoAHHw,5,2,1,0,1,0,2,0,6,0.8571428571428571,1,0.0,0,1,0,1,2,0,0,2,0,2,4,1
3702,109160,BjBet1XrpmufRo3nJSBrADvKxDiooNdd,SpATywNh6bZuzm8s1ceuBUnMUAeoAHHw,17,19,9,10,6,4,6,2,56,8.0,1,0.0,8,9,9,6,11,4,1,6,2,32,24,0
3703,109168,75JIeVMZStYpkimfm5Z5dMpV25aOohZB,A3fsA9Zfv1X2fVEQhTw51lKENdNrEqT3,1,0,0,0,0,0,1,0,1,0.14285714285714285,1,0.0,0,0,0,0,0,0,0,1,0,0,1,1
3704,109175,3HlwwUK8TRPXkUKapLyYM8Mklh9O7Jts,SpATywNh6bZuzm8s1ceuBUnMUAeoAHHw,1,0,0,0,0,0,1,0,1,0.14285714285714285,1,0.0,0,0,0,0,0,0,0,1,0,0,1,1
3705,109197,JWGtW72K75u0pLec4sms8rsOXm4SeKAG,SpATywNh6bZuzm8s1ceuBUnMUAeoAHHw,15,27,10,15,2,8,11,1,74,10.571428571428571,3,0.0,12,10,12,2,15,8,3,11,1,36,38,1
3706,109229,txSjWYX3TEWx5QLOiaADcbFdCZMHt7yE,A3fsA9Zfv1X2fVEQhTw51lKENdNrEqT3,8,5,0,0,0,0,4,3,12,1.7142857142857142,1,0.0,0,0,0,0,5,0,0,4,3,0,12,0
3707,109249,xHkJ6XK0y35MSFhta6m6oK3R3vwlFDsX,SpATywNh6bZuzm8s1ceuBUnMUAeoAHHw,6,3,1,0,1,0,2,0,7,1.0,1,0.0,0,1,0,1,3,0,0,2,0,2,5,1
3708,109255,N8EIkrIEEI0tSrQnptuBZRzWsVxCnAJ9,bWdj2GDclj5ofokWjzoa5jAwMkxCykd6,1,0,0,0,0,0,1,0,1,0.14285714285714285,1,0.0,0,0,0,0,0,0,0,1,0,0,1,1
3709,109285,PTDwgRsRPDT7EScAgKe30PHvW2ZEf3hf,SpATywNh6bZuzm8s1ceuBUnMUAeoAHHw,1,0,0,0,0,0,1,0,1,0.14285714285714285,1,0.0,0,0,0,0,0,0,0,1,0,0,1,1
3710,109288,J2q8zoWRny7YrAZZQIJQYIKpfAnrsg3t,SpATywNh6bZuzm8s1ceuBUnMUAeoAHHw,18,26,10,19,5,11,10,1,82,11.714285714285714,2,0.0,12,10,16,5,14,11,3,10,1,43,39,1
3711,109294,Qs7Gy3lEvMM83esFdoZ1zZvUeRYTAxxM,A3fsA9Zfv1X2fVEQhTw51lKENdNrEqT3,1,0,0,0,0,0,2,0,2,0.2857142857142857,1,0.0,0,0,0,0,0,0,0,2,0,0,2,1
3712,109308,giXuT5U1RtMqgo8IXt5j9x4mrlpr0AWq,bWdj2GDclj5ofokWjzoa5jAwMkxCykd6,10,22,2,28,3,0,17,0,72,10.285714285714286,4,0.0,6,2,26,3,16,0,2,17,0,37,35,1
3713,109309,WAUVjfvcVVKr4l1eRzgNNfyqoF4mUwKn,SpATywNh6bZuzm8s1ceuBUnMUAeoAHHw,17,20,12,17,5,0,7,0,61,8.714285714285714,1,0.0,4,12,15,5,16,0,2,7,0,36,25,1
3714,109323,h7wsu0U7FXIgaCVLolzif2WMIHfC12Bp,RXDvfPUBYFlVdlueBFbLW0mhhAyGEqpt,9,6,0,0,0,0,4,0,10,1.4285714285714286,2,0.0,0,0,0,0,6,0,0,4,0,0,10,1
3715,109342,obFxfGLSP12hWUYqYGw1SR5lINNLUPlg,SpATywNh6bZuzm8s1ceuBUnMUAeoAHHw,13,26,10,10,5,0,2,0,53,7.571428571428571,1,0.0,6,10,9,5,20,0,1,2,0,30,23,1
3716,109357,E3qy0Aw6hJTYQ75juho52GdWukHpC8PO,A3fsA9Zfv1X2fVEQhTw51lKENdNrEqT3,38,32,15,70,9,0,1,0,127,18.142857142857142,1,0.0,3,15,58,9,29,0,12,1,0,85,42,1
3717,109362,GzwlErGyP5vVrMuPju1CoSG91uAwN5Ll,A3fsA9Zfv1X2fVEQhTw51lKENdNrEqT3,1,0,0,0,0,0,1,0,1,0.14285714285714285,1,0.0,0,0,0,0,0,0,0,1,0,0,1,1
3718,109370,PgyyNRYpQtA302ymgWhOo3FWJ5ZVr14a,A3fsA9Zfv1X2fVEQhTw51lKENdNrEqT3,9,2,1,0,1,1,9,1,15,2.142857142857143,1,0.0,0,1,0,1,2,1,0,9,1,2,13,1
3719,109386,wRfMgDoh08sOJ1iN7xQ6xWeUhnvT3LS5,SpATywNh6bZuzm8s1ceuBUnMUAeoAHHw,5,2,1,0,1,0,4,0,8,1.1428571428571428,1,0.0,1,1,0,1,1,0,0,4,0,3,5,1
3720,109397,fwSe9M4wVBk21yhnHfi9Elq0Dtd4QFmB,bWdj2GDclj5ofokWjzoa5jAwMkxCykd6,5,3,1,0,1,0,2,0,7,1.0,1,0.0,0,1,0,1,3,0,0,2,0,2,5,1
3721,109399,r9Iw8qv5Gd0slmKCVr3aUz7TALROG0cf,bWdj2GDclj5ofokWjzoa5jAwMkxCykd6,1,0,0,0,0,0,1,0,1,0.14285714285714285,1,0.0,0,0,0,0,0,0,0,1,0,0,1,1
3722,109400,9uGUU0TH4lqYEkuGLK9jp9MwW0oSvGiG,A3fsA9Zfv1X2fVEQhTw51lKENdNrEqT3,9,4,1,0,1,10,8,2,26,3.7142857142857144,3,0.0,0,1,0,1,4,10,0,8,2,2,24,1
3723,109426,Sq3omHTGoSF2f0DuMM8gp5rI7SBr6tWj,A3fsA9Zfv1X2fVEQhTw51lKENdNrEqT3,20,8,8,0,8,0,4,0,28,4.0,2,0.0,0,8,0,8,8,0,0,4,0,16,12,1
3724,109429,HoFYxRSokx9ZKuDwytJP5rWsXC8CIKJC,A3fsA9Zfv1X2fVEQhTw51lKENdNrEqT3,30,7,4,44,2,3,9,1,70,10.0,1,0.0,1,4,42,2,6,3,2,9,1,49,21,1
3725,109431,1UiNR1aBQTbqc6GjmZAuykRrYIV3jOJO,SpATywNh6bZuzm8s1ceuBUnMUAeoAHHw,7,3,1,0,1,2,4,1,12,1.7142857142857142,1,0.0,1,1,0,1,2,2,0,4,1,3,9,1
3726,109442,uMcGJbFLkrWwli3FYGfWHtIVPBjXGyBh,SpATywNh6bZuzm8s1ceuBUnMUAeoAHHw,1,0,0,0,0,0,1,0,1,0.14285714285714285,1,0.0,0,0,0,0,0,0,0,1,0,0,1,1
3727,109459,AFA8ekqoAZiNztO6KW91x6d2D9lFcQ7X,RXDvfPUBYFlVdlueBFbLW0mhhAyGEqpt,5,1,0,0,1,0,5,0,7,1.0,1,0.0,0,0,0,1,1,0,0,5,0,1,6,1
3728,109468,An4Cs2oUOz8lYcIplHFLdygweoh5kMIV,A3fsA9Zfv1X2fVEQhTw51lKENdNrEqT3,8,5,1,0,1,0,2,0,9,1.2857142857142858,1,0.0,0,1,0,1,5,0,0,2,0,2,7,1
3729,109494,dvvW9sSxW5mjEruYpucTZ2qRrmMv8qM8,SpATywNh6bZuzm8s1ceuBUnMUAeoAHHw,4,2,1,0,0,1,2,0,6,0.8571428571428571,1,0.0,0,1,0,0,2,1,0,2,0,1,5,1
3730,109497,CB1M4aW1J3aRGdW8HkF8tezfCYyk7Eoq,RXDvfPUBYFlVdlueBFbLW0mhhAyGEqpt,12,8,6,0,5,0,4,0,23,3.2857142857142856,3,0.0,0,6,0,5,8,0,0,4,0,11,12,1
3731,109501,eAowQ45OiNPPsLkfxUtBSZ5lhWPhAgzz,SpATywNh6bZuzm8s1ceuBUnMUAeoAHHw,5,2,0,0,0,1,5,0,8,1.1428571428571428,1,0.0,0,0,0,0,2,1,0,5,0,0,8,1
3732,109507,IgPmhYztZgoutItcrcEcsnhrRrb2KvYs,A3fsA9Zfv1X2fVEQhTw51lKENdNrEqT3,9,17,3,0,1,0,6,0,27,3.857142857142857,1,0.0,0,3,0,1,17,0,0,6,0,4,23,1
3733,109508,pKS0bXWim4kclZTTgr34KULrUojenqdP,SpATywNh6bZuzm8s1ceuBUnMUAeoAHHw,1,0,0,0,0,0,1,0,1,0.14285714285714285,1,0.0,0,0,0,0,0,0,0,1,0,0,1,1
3734,109526,wZ6yWCylvqNezqFzx20ftEJc7jYDipih,A3fsA9Zfv1X2fVEQhTw51lKENdNrEqT3,16,9,7,0,5,0,8,0,29,4.142857142857143,2,0.0,1,7,0,5,8,0,0,8,0,13,16,1
3735,109536,Cv1aavObJnuABKfipF6OGePzg0BnGPFs,SpATywNh6bZuzm8s1ceuBUnMUAeoAHHw,7,4,2,8,0,1,11,0,26,3.7142857142857144,3,0.0,2,2,8,0,2,1,0,11,0,12,14,1
3736,109538,Cv1aavObJnuABKfipF6OGePzg0BnGPFs,A3fsA9Zfv1X2fVEQhTw51lKENdNrEqT3,4,2,2,0,0,0,4,0,8,1.1428571428571428,2,0.0,0,2,0,0,2,0,0,4,0,2,6,1
3737,109542,UzfhQlNSIoLM6AVYNl7JKilqEEtlOXJC,bWdj2GDclj5ofokWjzoa5jAwMkxCykd6,13,17,7,26,3,0,7,0,60,8.571428571428571,3,0.0,2,7,23,3,15,0,3,7,0,35,25,1
3738,109543,Cv1aavObJnuABKfipF6OGePzg0BnGPFs,bWdj2GDclj5ofokWjzoa5jAwMkxCykd6,2,0,0,0,0,0,5,0,5,0.7142857142857143,2,0.0,0,0,0,0,0,0,0,5,0,0,5,1
3739,109586,tnFgBBhxwl3ThYwRfbs1nBP0c5GsC0Nt,G8EPVSXsOYB5YQWZGiz1aVq5Pgr2GrQu,6,2,1,0,1,0,3,0,7,1.0,1,0.0,0,1,0,1,2,0,0,3,0,2,5,1
3740,109588,4QzNBqELMiYit65uUaxWvkflyE9kKEti,RXDvfPUBYFlVdlueBFbLW0mhhAyGEqpt,45,39,24,58,11,0,4,0,136,19.428571428571427,2,0.0,7,24,57,11,32,0,1,4,0,99,37,1
3741,109596,yH5UPr6OYjoduVn8gG4Lqcccv4nGJLGC,A3fsA9Zfv1X2fVEQhTw51lKENdNrEqT3,5,3,2,0,0,0,2,0,7,1.0,1,0.0,0,2,0,0,3,0,0,2,0,2,5,1
3742,109617,47U1Ft55cUwsb6d6kZ6WNRfAgXy0966b,A3fsA9Zfv1X2fVEQhTw51lKENdNrEqT3,20,12,8,18,5,0,3,0,46,6.571428571428571,1,0.0,0,8,16,5,12,0,2,3,0,29,17,1
3743,109630,OnyZH4F3oW4crdu4EYjgcCg5L4Cq5yIA,A3fsA9Zfv1X2fVEQhTw51lKENdNrEqT3,6,11,1,0,1,0,1,0,14,2.0,1,0.0,0,1,0,1,11,0,0,1,0,2,12,1
3744,109633,CxbJpiz9m1eHAB0gIyTtLs7Pvx86qvPB,A3fsA9Zfv1X2fVEQhTw51lKENdNrEqT3,15,26,15,0,7,4,9,0,61,8.714285714285714,2,0.0,0,15,0,7,26,4,0,9,0,22,39,1
3745,109635,S7YgWZv0zfBDCXesrYQobA6r2Ns5N7Tq,A3fsA9Zfv1X2fVEQhTw51lKENdNrEqT3,2,0,0,0,0,0,4,0,4,0.5714285714285714,1,0.0,0,0,0,0,0,0,0,4,0,0,4,1
3746,109645,t36cT9Msm4Hh3sPjMIr6iaOAbn6g4BQN,bWdj2GDclj5ofokWjzoa5jAwMkxCykd6,7,8,3,2,0,0,7,0,20,2.857142857142857,2,0.0,4,3,2,0,4,0,0,7,0,9,11,1
3747,109661,vlxKYuyoAuMqS1coFL9iKQUv0EZG5cjH,RXDvfPUBYFlVdlueBFbLW0mhhAyGEqpt,13,16,10,0,3,13,9,2,53,7.571428571428571,1,0.0,2,10,0,3,14,13,0,9,2,15,38,1
3748,109662,tVIaEH9O89RTqDCRllWVA85ShLX4ujE7,SpATywNh6bZuzm8s1ceuBUnMUAeoAHHw,7,12,6,0,1,0,6,0,25,3.5714285714285716,1,0.0,3,6,0,1,9,0,0,6,0,10,15,1
3749,109663,yNBmodc8EXXXXDprMuN3jSh3qPXFcpn8,SpATywNh6bZuzm8s1ceuBUnMUAeoAHHw,10,11,6,0,3,1,3,0,24,3.4285714285714284,1,0.0,0,6,0,3,11,1,0,3,0,9,15,1
3750,109677,Wq5vw9D8EzxIbQ18OklpNCvzPZVsfETA,G8EPVSXsOYB5YQWZGiz1aVq5Pgr2GrQu,6,2,1,0,1,0,2,0,6,0.8571428571428571,1,0.0,0,1,0,1,2,0,0,2,0,2,4,1
3751,109688,TQrIrIwuSwem0ov7co8TUDqNlQcIvB5k,SpATywNh6bZuzm8s1ceuBUnMUAeoAHHw,15,28,11,6,3,8,3,0,59,8.428571428571429,1,0.0,4,11,6,3,24,8,0,3,0,24,35,1
3752,109696,1IVW102tL25hf5DslCWoTGf8umKhKStK,A3fsA9Zfv1X2fVEQhTw51lKENdNrEqT3,9,4,3,0,3,0,2,0,12,1.7142857142857142,1,0.0,1,3,0,3,3,0,0,2,0,7,5,1
3753,109697,pGYP47am2d3xk9zOKdaE6fuoOc52iQiA,A3fsA9Zfv1X2fVEQhTw51lKENdNrEqT3,4,2,0,0,0,0,5,0,7,1.0,2,0.0,0,0,0,0,2,0,0,5,0,0,7,1
3754,109726,YsCj2vq22thtrABlGTiHQmd1Rq7WC2yD,G8EPVSXsOYB5YQWZGiz1aVq5Pgr2GrQu,1,0,0,0,0,0,1,0,1,0.14285714285714285,1,0.0,0,0,0,0,0,0,0,1,0,0,1,1
3755,109736,Pw5qvLGpB0h5kMFVFGpEeHaRx9RXaDPK,A3fsA9Zfv1X2fVEQhTw51lKENdNrEqT3,14,8,6,0,5,0,4,0,23,3.2857142857142856,2,0.0,0,6,0,5,8,0,0,4,0,11,12,1
3756,109762,Ag1hVTrJxORxsKul36O8LJkzu7JsNNWP,SpATywNh6bZuzm8s1ceuBUnMUAeoAHHw,14,21,9,10,7,0,6,2,55,7.857142857142857,2,0.0,7,9,9,7,14,0,1,6,2,32,23,1
3757,109765,MJcUUCn8PV6c1s6azIezqfn8QYa8QKmD,SpATywNh6bZuzm8s1ceuBUnMUAeoAHHw,1,0,0,0,0,0,1,0,1,0.14285714285714285,1,0.0,0,0,0,0,0,0,0,1,0,0,1,1
3758,109788,YK9goZgoN0rvofZU4YE46jMvnter3goc,G8EPVSXsOYB5YQWZGiz1aVq5Pgr2GrQu,8,7,3,0,2,1,3,0,16,2.2857142857142856,1,0.0,2,3,0,2,5,1,0,3,0,7,9,1
3759,109790,p7ttFbRCERCwhTg2CGSQKJTx8BwPrv0X,SpATywNh6bZuzm8s1ceuBUnMUAeoAHHw,16,15,7,12,3,0,5,0,42,6.0,1,0.0,8,7,12,3,7,0,0,5,0,30,12,1
3760,109797,BvGZp7WaxxtjkCv9TCLYGxFTwKxW9SN6,SpATywNh6bZuzm8s1ceuBUnMUAeoAHHw,1,0,0,0,0,0,1,0,1,0.14285714285714285,1,0.0,0,0,0,0,0,0,0,1,0,0,1,1
3761,109798,K1BSnyoMMyobTomJrER9oQIG5DUTaz3Q,SpATywNh6bZuzm8s1ceuBUnMUAeoAHHw,4,2,1,0,0,0,2,0,5,0.7142857142857143,1,0.0,0,1,0,0,2,0,0,2,0,1,4,1
3762,109817,S9Szq6g9ved8FvqRXhj5wFkk1JBdWVxm,SpATywNh6bZuzm8s1ceuBUnMUAeoAHHw,16,33,14,4,7,2,16,7,83,11.857142857142858,2,0.0,13,14,4,7,20,2,0,16,7,38,45,1
3763,109822,kNz6Otgr0OzNKmI1vQVj8WSVh9NxP9ty,A3fsA9Zfv1X2fVEQhTw51lKENdNrEqT3,13,5,3,0,3,7,10,3,31,4.428571428571429,2,0.0,1,3,0,3,4,7,0,10,3,7,24,1
3764,109838,5G14OqJhAMEtcEWhkGrUvPjxVR4dIAwN,SpATywNh6bZuzm8s1ceuBUnMUAeoAHHw,9,17,1,0,1,1,5,1,26,3.7142857142857144,1,0.0,12,1,0,1,5,1,0,5,1,14,12,1
3765,109844,hvsRGWJp5579jHaZrBOzJk6TUYpgGqDO,A3fsA9Zfv1X2fVEQhTw51lKENdNrEqT3,10,5,4,0,4,0,1,0,14,2.0,1,0.0,0,4,0,4,5,0,0,1,0,8,6,1
3766,109892,mbcohNJJNHml8jzBeHm74GmBbBH9udey,bWdj2GDclj5ofokWjzoa5jAwMkxCykd6,1,0,0,0,0,0,1,0,1,0.14285714285714285,1,0.0,0,0,0,0,0,0,0,1,0,0,1,1
3767,109897,YQYuuodMZUFMR21jPqGx2gjrHZSeRDRA,A3fsA9Zfv1X2fVEQhTw51lKENdNrEqT3,18,17,7,0,6,0,10,0,40,5.714285714285714,4,0.0,0,7,0,6,17,0,0,10,0,13,27,1
3768,109901,mbcohNJJNHml8jzBeHm74GmBbBH9udey,A3fsA9Zfv1X2fVEQhTw51lKENdNrEqT3,1,0,0,0,0,0,1,0,1,0.14285714285714285,1,0.0,0,0,0,0,0,0,0,1,0,0,1,1
3769,109908,HCwGALsXdQRvdnW9Y1SicRkbFYJcehRz,G8EPVSXsOYB5YQWZGiz1aVq5Pgr2GrQu,6,7,0,0,0,2,1,0,10,1.4285714285714286,1,0.0,0,0,0,0,7,2,0,1,0,0,10,0
3770,109914,y8NaQIDe3D7l0VzaS1fuEDzV6bcaTY0g,bWdj2GDclj5ofokWjzoa5jAwMkxCykd6,4,2,1,0,1,0,1,0,5,0.7142857142857143,1,0.0,0,1,0,1,2,0,0,1,0,2,3,1
3771,109927,CwyOL3RMOVLomxrxyN9D4jPa9R0iWrS5,bWdj2GDclj5ofokWjzoa5jAwMkxCykd6,12,14,9,16,5,0,9,0,53,7.571428571428571,1,0.0,2,9,16,5,12,0,0,9,0,32,21,1
3772,109942,69mjZoNGtUdd47OHaI2iQubsVwSBE5CT,A3fsA9Zfv1X2fVEQhTw51lKENdNrEqT3,7,9,4,0,2,0,4,0,19,2.7142857142857144,1,0.0,0,4,0,2,9,0,0,4,0,6,13,1
3773,109946,mdF4VSOHdhU4Fo37q40c5lLreOU7ezPS,A3fsA9Zfv1X2fVEQhTw51lKENdNrEqT3,8,5,3,0,0,1,8,1,18,2.5714285714285716,1,0.0,0,3,0,0,5,1,0,8,1,3,15,1
3774,109955,c5FmvWqHimPY3en4KzYtEePuWbXPcm4V,bWdj2GDclj5ofokWjzoa5jAwMkxCykd6,4,2,1,0,0,1,4,0,8,1.1428571428571428,1,0.0,0,1,0,0,2,1,0,4,0,1,7,1
3775,109956,HNOGJwV4rdRhqUou8hYUuOI1xR3yp1lD,SpATywNh6bZuzm8s1ceuBUnMUAeoAHHw,2,0,0,0,0,0,2,0,2,0.2857142857142857,1,0.0,0,0,0,0,0,0,0,2,0,0,2,1
3776,109982,DmULS2tEq0maGheqJ8Xg7VkvUxmleIug,SpATywNh6bZuzm8s1ceuBUnMUAeoAHHw,1,0,0,0,0,0,1,0,1,0.14285714285714285,1,0.0,0,0,0,0,0,0,0,1,0,0,1,0
3777,109983,5Dqq361dkHzqa5S9GQLfoF5pBVvOZxtV,SpATywNh6bZuzm8s1ceuBUnMUAeoAHHw,1,0,0,0,0,0,1,0,1,0.14285714285714285,1,0.0,0,0,0,0,0,0,0,1,0,0,1,1
3778,110026,KC30Cns1M10UV49aokZvWIXO8ZPauHoR,bWdj2GDclj5ofokWjzoa5jAwMkxCykd6,2,0,0,0,0,0,2,0,2,0.2857142857142857,1,0.0,0,0,0,0,0,0,0,2,0,0,2,1
3779,110029,KC30Cns1M10UV49aokZvWIXO8ZPauHoR,RXDvfPUBYFlVdlueBFbLW0mhhAyGEqpt,2,0,0,0,0,0,2,0,2,0.2857142857142857,1,0.0,0,0,0,0,0,0,0,2,0,0,2,1
3780,113276,eswvbpHhxCUZC3kUIoEHkNpn6ukXHFpo,7GRhBDsirIGkRZBtSMEzNTyDr2JQm4xx,1,0,0,0,0,0,2,0,2,0.2857142857142857,1,0.0,0,0,0,0,0,0,0,2,0,0,2,0
3781,113891,9d8tCYKPfh5NHPKNlwRKmrZh3Cuf1Ls2,7GRhBDsirIGkRZBtSMEzNTyDr2JQm4xx,9,17,5,0,2,0,4,0,28,4.0,1,0.0,9,5,0,2,8,0,0,4,0,16,12,0
3782,113991,z7I1QeH8tOlWf6s0Xi8QGEEG8QaCPAno,7GRhBDsirIGkRZBtSMEzNTyDr2JQm4xx,47,81,23,68,18,39,15,4,248,35.42857142857143,1,0.0,53,23,60,18,28,39,8,15,4,154,94,1
3783,114122,4Pd3e254V1ylErxapJL6FJZ2vSaLD95s,7GRhBDsirIGkRZBtSMEzNTyDr2JQm4xx,30,125,3,55,6,39,21,3,252,36.0,4,0.0,33,3,50,6,92,39,5,21,3,92,160,0
3784,114559,KkSinTdG2PbGrJIRATMZos8HES46UawO,7GRhBDsirIGkRZBtSMEzNTyDr2JQm4xx,24,58,14,3,11,0,6,0,92,13.142857142857142,2,0.0,24,14,3,11,34,0,0,6,0,52,40,0
3785,114615,dADOrE6FAWkIPcnZuLBj5KGmzjdxSunH,fbPkOYLVPtPgIt0MxizjfFJov3JbHyAi,14,33,15,17,13,4,4,0,86,12.285714285714286,4,0.0,12,15,16,13,21,4,1,4,0,56,30,0
3786,114620,6T8cBNKGNp544PxJriaeroN36khQqLPz,fbPkOYLVPtPgIt0MxizjfFJov3JbHyAi,9,6,4,0,2,11,5,0,28,4.0,1,0.0,0,4,0,2,6,11,0,5,0,6,22,1
3787,114648,aqQTf2fLQrJTXefctm75awHMgV3chcLI,fbPkOYLVPtPgIt0MxizjfFJov3JbHyAi,4,2,1,0,1,0,1,0,5,0.7142857142857143,1,0.0,0,1,0,1,2,0,0,1,0,2,3,1
3788,117367,z9oiQyplHlMmhFVKenfY0OjMOlRO24Ty,fbPkOYLVPtPgIt0MxizjfFJov3JbHyAi,6,6,2,0,2,0,1,0,11,1.5714285714285714,1,0.0,0,2,0,2,6,0,0,1,0,4,7,1
3789,117368,6AwbnbZTB5s1lrnTdEnSshjUPytTPXpI,fbPkOYLVPtPgIt0MxizjfFJov3JbHyAi,1,0,0,0,0,0,1,0,1,0.14285714285714285,1,0.0,0,0,0,0,0,0,0,1,0,0,1,1
3790,117370,3JEt0I9b0JhZhM0RD2D5jI5S8zjjeHFo,fbPkOYLVPtPgIt0MxizjfFJov3JbHyAi,8,10,6,0,4,3,5,0,28,4.0,3,0.0,1,6,0,4,9,3,0,5,0,11,17,0
3791,117377,ED2RRaLgnPevoSmZx4Qg8rLBDplQ4qIA,fbPkOYLVPtPgIt0MxizjfFJov3JbHyAi,5,2,1,0,1,0,2,0,6,0.8571428571428571,1,0.0,0,1,0,1,2,0,0,2,0,2,4,1
3792,117379,h77jUHQjzYddHbYwLAoFxVw2uSIfwhBs,fbPkOYLVPtPgIt0MxizjfFJov3JbHyAi,4,2,0,0,0,1,6,0,9,1.2857142857142858,1,0.0,0,0,0,0,2,1,0,6,0,0,9,1
3793,117380,RArjmmV02rd6h9pGPjgt5onR6MwVvvt1,fbPkOYLVPtPgIt0MxizjfFJov3JbHyAi,8,5,3,0,2,6,5,0,21,3.0,1,0.0,0,3,0,2,5,6,0,5,0,5,16,1
3794,117382,W4YcttFAI3GezJalLYSgr5LsB9fMfJw6,fbPkOYLVPtPgIt0MxizjfFJov3JbHyAi,5,2,1,0,1,0,2,0,6,0.8571428571428571,1,0.0,0,1,0,1,2,0,0,2,0,2,4,1
3795,117385,AuMjwLeYBChETH8L0EPQQLBqdJg4wXaV,fbPkOYLVPtPgIt0MxizjfFJov3JbHyAi,14,14,7,0,8,22,6,0,57,8.142857142857142,1,0.0,5,7,0,8,9,22,0,6,0,20,37,1
3796,117386,i0ksX07HnsV5rQlWqOr1uKEuc7yNU24c,fbPkOYLVPtPgIt0MxizjfFJov3JbHyAi,1,0,0,0,0,0,2,0,2,0.2857142857142857,1,0.0,0,0,0,0,0,0,0,2,0,0,2,1
3797,117389,mXfwwTIVjHMqoVKAh2iEQbinKUCJHwTp,fbPkOYLVPtPgIt0MxizjfFJov3JbHyAi,1,0,0,0,0,0,9,0,9,1.2857142857142858,1,0.0,0,0,0,0,0,0,0,9,0,0,9,0
3798,117396,pNEyURvIjTiESJT2evjPVs5QcamqwYsg,fbPkOYLVPtPgIt0MxizjfFJov3JbHyAi,1,0,0,0,0,0,1,0,1,0.14285714285714285,1,0.0,0,0,0,0,0,0,0,1,0,0,1,1
3799,117397,2XVXsblIDsQNrX8upAtO1F8OiAwOV3sC,fbPkOYLVPtPgIt0MxizjfFJov3JbHyAi,1,0,0,0,0,0,1,0,1,0.14285714285714285,1,0.0,0,0,0,0,0,0,0,1,0,0,1,1
3800,117399,bPCJkP9ZTzzi0I9DbpQGe5iKBkWKaKhH,fbPkOYLVPtPgIt0MxizjfFJov3JbHyAi,10,8,6,0,3,2,4,1,24,3.4285714285714284,1,0.0,0,6,0,3,8,2,0,4,1,9,15,1
3801,117405,fu0f20KU28Bd4xE03nYnaxnydSL4s6JV,fbPkOYLVPtPgIt0MxizjfFJov3JbHyAi,3,3,1,0,0,0,3,0,7,1.0,1,0.0,0,1,0,0,3,0,0,3,0,1,6,1
3802,117407,u3ha5zP0wtMcDDWbo2YVGmhJ5EihdJ7B,fbPkOYLVPtPgIt0MxizjfFJov3JbHyAi,1,0,0,0,0,0,1,0,1,0.14285714285714285,1,0.0,0,0,0,0,0,0,0,1,0,0,1,1
3803,117408,T7YlTqIDVTZFYEYihxD1Zij5IkDsmVZP,fbPkOYLVPtPgIt0MxizjfFJov3JbHyAi,8,11,3,0,3,6,3,0,26,3.7142857142857144,1,0.0,3,3,0,3,8,6,0,3,0,9,17,1
3804,117409,oZFc1qOsYmuXaa2y9yuDE2JOyaJ6tpRo,fbPkOYLVPtPgIt0MxizjfFJov3JbHyAi,8,9,6,0,2,0,4,0,21,3.0,3,0.0,0,6,0,2,9,0,0,4,0,8,13,1
3805,117410,Lpjd1s2Qa852YWnveC5CAHyEzqzKjCKM,fbPkOYLVPtPgIt0MxizjfFJov3JbHyAi,8,4,1,0,1,4,6,1,17,2.4285714285714284,2,0.0,0,1,0,1,4,4,0,6,1,2,15,1
3806,117420,sATu1yjmTMxfV1UwbY34TM5sGL4dFyhU,fbPkOYLVPtPgIt0MxizjfFJov3JbHyAi,4,6,1,0,0,0,3,0,10,1.4285714285714286,2,0.0,0,1,0,0,6,0,0,3,0,1,9,1
3807,117421,6o1ZSS0MBiJ4i90ElFoAvCZGSxQxxLtD,fbPkOYLVPtPgIt0MxizjfFJov3JbHyAi,1,0,0,0,0,0,1,0,1,0.14285714285714285,1,0.0,0,0,0,0,0,0,0,1,0,0,1,1
3808,117425,YjySOKJ8Qhep1ksiy3pkGK8hyQnj63Bg,fbPkOYLVPtPgIt0MxizjfFJov3JbHyAi,2,0,0,0,0,0,4,0,4,0.5714285714285714,1,0.0,0,0,0,0,0,0,0,4,0,0,4,1
3809,117426,1I29v8UmoBuouK5thDbwjYUDiAkrMElJ,fbPkOYLVPtPgIt0MxizjfFJov3JbHyAi,2,0,0,0,0,0,6,0,6,0.8571428571428571,1,0.0,0,0,0,0,0,0,0,6,0,0,6,1
3810,117429,pbZR4GJe7P6eoTNcArXxFSrGW6cVA8YU,fbPkOYLVPtPgIt0MxizjfFJov3JbHyAi,12,10,7,0,6,0,6,0,29,4.142857142857143,2,0.0,0,7,0,6,10,0,0,6,0,13,16,1
3811,117430,MmozMzpVuu7lJ9WhybOg7LnFJamucwNf,fbPkOYLVPtPgIt0MxizjfFJov3JbHyAi,5,3,1,0,1,0,2,0,7,1.0,1,0.0,0,1,0,1,3,0,0,2,0,2,5,1
3812,117432,CN6hYLtHy52UqiF5PRGtJEkOeeMIm2un,fbPkOYLVPtPgIt0MxizjfFJov3JbHyAi,7,3,2,0,2,0,4,0,11,1.5714285714285714,1,0.0,0,2,0,2,3,0,0,4,0,4,7,1
3813,117434,T6F7StAhzA9Nt1gx3xcfSamiwd1hA4kb,fbPkOYLVPtPgIt0MxizjfFJov3JbHyAi,2,0,0,0,0,0,2,0,2,0.2857142857142857,1,0.0,0,0,0,0,0,0,0,2,0,0,2,1
3814,117437,HOh9uzKRHmixUSVl017qRO1fRhTakF2v,fbPkOYLVPtPgIt0MxizjfFJov3JbHyAi,8,10,5,0,1,5,6,1,28,4.0,2,0.0,0,5,0,1,10,5,0,6,1,6,22,1
3815,117442,kyRDtUassKyWkKwd2NxuRMWbNGMmYQuD,fbPkOYLVPtPgIt0MxizjfFJov3JbHyAi,22,37,16,16,15,7,24,2,117,16.714285714285715,4,0.0,15,16,12,15,22,7,4,24,2,58,59,1
3816,117443,V44Q36yyz0HxZhlrCwrLJjYwv8UzqoCn,fbPkOYLVPtPgIt0MxizjfFJov3JbHyAi,6,3,2,0,2,0,2,0,9,1.2857142857142858,1,0.0,0,2,0,2,3,0,0,2,0,4,5,1
3817,117444,oWOfoMSwxFJkBlwLG8XI3GNMHdlBBaGM,fbPkOYLVPtPgIt0MxizjfFJov3JbHyAi,13,23,12,1,3,4,11,1,55,7.857142857142857,4,0.0,2,12,1,3,21,4,0,11,1,18,37,1
3818,117445,gkiUIfN50TiqMc6ruS3MmgF2p099c98R,fbPkOYLVPtPgIt0MxizjfFJov3JbHyAi,7,8,5,0,3,0,3,0,19,2.7142857142857144,1,0.0,0,5,0,3,8,0,0,3,0,8,11,1
3819,117446,Q3CFFFFeztddQPg34HzeWJOUWopSHXqI,fbPkOYLVPtPgIt0MxizjfFJov3JbHyAi,5,2,1,0,1,0,3,0,7,1.0,1,0.0,0,1,0,1,2,0,0,3,0,2,5,1
3820,117447,OvHFca8fZMJjxNBJonj6ZM9Jmu5uZHn1,fbPkOYLVPtPgIt0MxizjfFJov3JbHyAi,5,3,1,0,0,0,3,0,7,1.0,1,0.0,0,1,0,0,3,0,0,3,0,1,6,1
3821,117452,XD3SfNDDSMmRivtrECVvGAm4sTgAQhtN,fbPkOYLVPtPgIt0MxizjfFJov3JbHyAi,11,6,3,6,3,0,4,0,22,3.142857142857143,1,0.0,1,3,5,3,5,0,1,4,0,12,10,1
3822,117454,m6lnook0RtQLOadkyTjepku2EsfPQUkf,fbPkOYLVPtPgIt0MxizjfFJov3JbHyAi,1,0,0,0,0,0,1,0,1,0.14285714285714285,1,0.0,0,0,0,0,0,0,0,1,0,0,1,1
3823,117460,ZCWIo0rlDJYX4bFrxwqUtfFzcyFGtbPC,fbPkOYLVPtPgIt0MxizjfFJov3JbHyAi,7,5,1,0,1,0,1,0,8,1.1428571428571428,1,0.0,0,1,0,1,5,0,0,1,0,2,6,1
3824,117467,hDNiOFPvRB9cUydss5Qxpv78aI19HlnV,fbPkOYLVPtPgIt0MxizjfFJov3JbHyAi,10,5,3,0,4,0,4,0,16,2.2857142857142856,1,0.0,2,3,0,4,3,0,0,4,0,9,7,1
3825,117470,mT6waBgPTnOBUmAiQrY4keGZNquTpjJI,fbPkOYLVPtPgIt0MxizjfFJov3JbHyAi,7,5,0,0,0,1,6,1,13,1.8571428571428572,1,0.0,0,0,0,0,5,1,0,6,1,0,13,1
3826,117472,GaQzOXFZJNvUueucyW3BfG1sfbLN7TqZ,fbPkOYLVPtPgIt0MxizjfFJov3JbHyAi,6,2,1,0,1,0,3,0,7,1.0,1,0.0,0,1,0,1,2,0,0,3,0,2,5,1
3827,117476,RwvuGEh3euIR11rktJrGBhzDqcQMkhOC,fbPkOYLVPtPgIt0MxizjfFJov3JbHyAi,10,22,13,4,7,1,5,0,52,7.428571428571429,3,0.0,3,13,3,7,19,1,1,5,0,26,26,1
3828,117477,0VSuyC2fbUM3VIvEXql75XtNw7kg5Izm,fbPkOYLVPtPgIt0MxizjfFJov3JbHyAi,16,15,7,8,6,0,3,0,39,5.571428571428571,3,0.0,5,7,7,6,10,0,1,3,0,25,14,1
3829,117478,W7oz4HopNsS4RPNw2s87918URq124P2s,fbPkOYLVPtPgIt0MxizjfFJov3JbHyAi,4,2,0,0,0,1,5,0,8,1.1428571428571428,1,0.0,0,0,0,0,2,1,0,5,0,0,8,1
3830,117483,ckU7S9iTSheBHJPYCUZtMgrhgDvQPsUY,fbPkOYLVPtPgIt0MxizjfFJov3JbHyAi,6,3,2,0,2,0,1,0,8,1.1428571428571428,1,0.0,0,2,0,2,3,0,0,1,0,4,4,1
3831,117484,5bnbtuO3BHv5NYIfEbfBpvStPzGdNjte,fbPkOYLVPtPgIt0MxizjfFJov3JbHyAi,5,2,1,0,1,0,2,0,6,0.8571428571428571,1,0.0,0,1,0,1,2,0,0,2,0,2,4,1
3832,117485,V1BKbINyQwKyububdNQHUPGcGTvoZmLt,fbPkOYLVPtPgIt0MxizjfFJov3JbHyAi,7,3,2,0,2,0,5,0,12,1.7142857142857142,1,0.0,0,2,0,2,3,0,0,5,0,4,8,1
3833,117497,TZ8M7GqMqYnKB1lP0bgNhFJYSqdTmbQI,fbPkOYLVPtPgIt0MxizjfFJov3JbHyAi,7,13,6,0,3,0,3,0,25,3.5714285714285716,2,0.0,0,6,0,3,13,0,0,3,0,9,16,1
3834,117498,aRBsP3RNC28m05qU4AuLdcShaMIKbk0T,fbPkOYLVPtPgIt0MxizjfFJov3JbHyAi,5,2,1,0,1,0,2,0,6,0.8571428571428571,1,0.0,0,1,0,1,2,0,0,2,0,2,4,1
3835,117504,7nfwj1I7hYBfuxm4jUuStM2n17LzzRmj,SpATywNh6bZuzm8s1ceuBUnMUAeoAHHw,15,6,4,14,3,77,35,2,141,20.142857142857142,6,0.0,2,4,13,3,4,77,1,35,2,22,119,0
3836,117567,KlEAwfTXNSli6vdNdYlm5CYknLkxK1Br,SpATywNh6bZuzm8s1ceuBUnMUAeoAHHw,12,24,12,4,6,0,5,0,51,7.285714285714286,3,0.0,7,12,4,6,17,0,0,5,0,29,22,0
3837,117568,VK6VYsFJEy8hhWdKq52KmrJkO3b6jNbn,A3fsA9Zfv1X2fVEQhTw51lKENdNrEqT3,9,4,3,0,2,0,3,0,12,1.7142857142857142,2,0.0,0,3,0,2,4,0,0,3,0,5,7,0
3838,117610,ByImt5XiYRVr6hSHRVc9HRcRiIYkoT5Y,SpATywNh6bZuzm8s1ceuBUnMUAeoAHHw,9,5,1,0,1,0,8,3,18,2.5714285714285716,2,0.0,0,1,0,1,5,0,0,8,3,2,16,0
3839,117612,Kd69M9W1nim0woqVm1QxfVaSebsYtFIh,SpATywNh6bZuzm8s1ceuBUnMUAeoAHHw,4,3,1,0,1,0,1,0,6,0.8571428571428571,1,0.0,0,1,0,1,3,0,0,1,0,2,4,1
3840,117615,NdhfP9LezOw47EKstFkVNQYaCX8DmoQI,SpATywNh6bZuzm8s1ceuBUnMUAeoAHHw,14,25,2,20,2,0,9,0,58,8.285714285714286,3,0.0,2,2,16,2,23,0,4,9,0,22,36,0
3841,117671,LvmRr9NACuniPuboiWpXG15NCOEyIfpb,SpATywNh6bZuzm8s1ceuBUnMUAeoAHHw,7,10,5,0,1,0,7,0,23,3.2857142857142856,3,0.0,0,5,0,1,10,0,0,7,0,6,17,0
3842,117672,NdhfP9LezOw47EKstFkVNQYaCX8DmoQI,RXDvfPUBYFlVdlueBFbLW0mhhAyGEqpt,24,39,2,54,1,10,7,0,113,16.142857142857142,3,0.0,10,2,46,1,29,10,8,7,0,59,54,0
3843,117675,l64zD2DC6Q6fZRqMhhM1r4HOjVM4BOX7,SpATywNh6bZuzm8s1ceuBUnMUAeoAHHw,13,36,2,22,2,0,10,0,72,10.285714285714286,3,0.0,7,2,17,2,29,0,5,10,0,28,44,0
3844,117679,VE9HD5yzeCmqc2pNGfTQWsVbRdaqJBIV,SpATywNh6bZuzm8s1ceuBUnMUAeoAHHw,15,24,10,6,5,0,5,1,51,7.285714285714286,3,0.0,4,10,6,5,20,0,0,5,1,25,26,0
3845,117700,hKd0tEZKHss60gUM0z43MBrDD3KnSpLX,bWdj2GDclj5ofokWjzoa5jAwMkxCykd6,7,11,2,0,2,0,4,0,19,2.7142857142857144,2,0.0,0,2,0,2,11,0,0,4,0,4,15,1
3846,117713,BdtTUaUgpTqIzhF2tLHXM8NXK8k0XF8q,bWdj2GDclj5ofokWjzoa5jAwMkxCykd6,17,43,21,16,6,9,12,0,107,15.285714285714286,4,0.0,7,21,15,6,36,9,1,12,0,49,58,0
3847,117723,B1Gq6e77yv7kkDqJ7SH2TygdPDzPBwQh,RXDvfPUBYFlVdlueBFbLW0mhhAyGEqpt,49,57,34,74,10,56,14,8,253,36.142857142857146,2,0.0,9,34,67,10,48,56,7,14,8,120,133,0
3848,117725,HPir8NcsI5RSXTzlx3oC2YqcMhZG1iu7,bWdj2GDclj5ofokWjzoa5jAwMkxCykd6,8,6,2,0,2,0,12,1,23,3.2857142857142856,3,0.0,2,2,0,2,4,0,0,12,1,6,17,0
3849,117742,FhtwGNNoWtYYBXhYRu77jAPRU1UPxpBL,SpATywNh6bZuzm8s1ceuBUnMUAeoAHHw,5,2,1,0,1,5,2,0,11,1.5714285714285714,1,0.0,0,1,0,1,2,5,0,2,0,2,9,0
3850,117774,jFYWygr5nLqLhHkXltZRkT0S1zQoLEVR,A3fsA9Zfv1X2fVEQhTw51lKENdNrEqT3,37,16,10,66,8,1,10,0,111,15.857142857142858,2,0.0,3,10,57,8,13,1,9,10,0,78,33,0
3851,117784,CFQksue0mvvarj6k4PvTddPXnYjnyZ25,SpATywNh6bZuzm8s1ceuBUnMUAeoAHHw,11,12,0,9,0,19,5,1,46,6.571428571428571,1,0.0,0,0,7,0,12,19,2,5,1,7,39,1
3852,117800,RJv5TI20pjqK3VtKSctdVBLm65ceGNPu,SpATywNh6bZuzm8s1ceuBUnMUAeoAHHw,17,41,20,8,5,35,13,3,125,17.857142857142858,5,0.0,8,20,8,5,33,35,0,13,3,41,84,0
3853,117935,1R1zO9aMB7Mx1Lw84JzsChVEV5JpwmZv,SpATywNh6bZuzm8s1ceuBUnMUAeoAHHw,14,39,1,6,1,14,23,0,84,12.0,6,0.0,14,1,6,1,25,14,0,23,0,22,62,0
3854,118056,skJn7dtfSekFrPHRHs9swZ9AtSUKi36u,bWdj2GDclj5ofokWjzoa5jAwMkxCykd6,3,2,1,0,0,0,1,0,4,0.5714285714285714,1,0.0,0,1,0,0,2,0,0,1,0,1,3,1
3855,118084,hJwtwnOzJaTrAeP4eXJAEwz2xbKsgc4M,A3fsA9Zfv1X2fVEQhTw51lKENdNrEqT3,9,3,2,0,1,1,17,1,25,3.5714285714285716,6,0.0,0,2,0,1,3,1,0,17,1,3,22,0
3856,118085,hJwtwnOzJaTrAeP4eXJAEwz2xbKsgc4M,bWdj2GDclj5ofokWjzoa5jAwMkxCykd6,2,0,0,0,0,0,6,0,6,0.8571428571428571,3,0.0,0,0,0,0,0,0,0,6,0,0,6,0
3857,118091,hJwtwnOzJaTrAeP4eXJAEwz2xbKsgc4M,RXDvfPUBYFlVdlueBFbLW0mhhAyGEqpt,7,2,1,0,1,1,9,4,18,2.5714285714285716,3,0.0,0,1,0,1,2,1,0,9,4,2,16,1
3858,118118,l3b9HlsGDQW9AY17jLNuKVLgfuE5tsF4,SpATywNh6bZuzm8s1ceuBUnMUAeoAHHw,13,32,4,19,1,1,5,0,62,8.857142857142858,4,0.0,11,4,16,1,21,1,3,5,0,32,30,0
3859,118127,h4Ts0QZ9Axnf77ZfOuF03oUEp9wmSbSp,SpATywNh6bZuzm8s1ceuBUnMUAeoAHHw,17,12,7,7,4,1,7,1,39,5.571428571428571,1,0.0,3,7,7,4,9,1,0,7,1,21,18,1
3860,118130,0sa6kP9h4ahNr7Hzfeaa1Mssp5M7IVmw,SpATywNh6bZuzm8s1ceuBUnMUAeoAHHw,17,14,5,18,3,15,7,1,63,9.0,1,0.0,4,5,15,3,10,15,3,7,1,27,36,1
3861,118203,HX0eOrMEwIw9JyfkWs6Tn0Lny06N2ZVO,SpATywNh6bZuzm8s1ceuBUnMUAeoAHHw,16,39,15,21,7,22,15,0,119,17.0,3,0.0,16,15,17,7,23,22,4,15,0,55,64,0
3862,118239,4uAdkCJ4XUaD1NQGV93nNifOuyurJNKS,SpATywNh6bZuzm8s1ceuBUnMUAeoAHHw,7,2,1,0,1,1,7,2,14,2.0,1,0.0,0,1,0,1,2,1,0,7,2,2,12,0
3863,118258,5rpYxIaCTDb4PhszkJWpACOx5VMpNGcQ,SpATywNh6bZuzm8s1ceuBUnMUAeoAHHw,16,21,10,9,4,1,10,0,55,7.857142857142857,3,0.0,7,10,9,4,14,1,0,10,0,30,25,0
3864,118318,7hhGe4WcGEHypOzIVz3DLRx9GS52ozkE,RXDvfPUBYFlVdlueBFbLW0mhhAyGEqpt,47,53,34,69,24,16,10,0,206,29.428571428571427,3,0.0,15,34,64,24,38,16,5,10,0,137,69,0
3865,118339,cu2czfUbk8fdWWzCcDvTVYWH50Wg3XUq,SpATywNh6bZuzm8s1ceuBUnMUAeoAHHw,11,17,0,18,0,5,5,0,45,6.428571428571429,3,0.0,5,0,15,0,12,5,3,5,0,20,25,0
3866,118371,hZtYMC0K38gXqBKrTDOxWf2kSwG06wA4,RXDvfPUBYFlVdlueBFbLW0mhhAyGEqpt,49,81,41,68,10,47,21,4,272,38.857142857142854,3,0.0,11,41,66,10,70,47,2,21,4,128,144,0
3867,118422,ZNBGAlJve4TYJ3FcDlTLBdyuklADldDZ,bWdj2GDclj5ofokWjzoa5jAwMkxCykd6,1,0,0,0,0,0,1,0,1,0.14285714285714285,1,0.0,0,0,0,0,0,0,0,1,0,0,1,1
3868,118467,Lu93o5GXoxd6qTdHk7BshqxRhX67SrrE,SpATywNh6bZuzm8s1ceuBUnMUAeoAHHw,10,22,0,10,0,0,2,0,34,4.857142857142857,1,0.0,8,0,9,0,14,0,1,2,0,17,17,0
3869,118468,s18XVhMq5o50489RseclkjZSQF8K6sqD,G8EPVSXsOYB5YQWZGiz1aVq5Pgr2GrQu,22,46,1,14,1,9,9,0,80,11.428571428571429,3,0.0,13,1,7,1,33,9,7,9,0,22,58,1
3870,118508,TnL4ialg6Pf5M7cIMrmaVmE9VMhEtv14,RXDvfPUBYFlVdlueBFbLW0mhhAyGEqpt,17,16,2,16,3,0,5,0,42,6.0,2,0.0,4,2,15,3,12,0,1,5,0,24,18,1
3871,118514,W3axEfDtpWFQrOsjh1ju6UWJlt7DtE7b,SpATywNh6bZuzm8s1ceuBUnMUAeoAHHw,12,16,2,8,0,9,17,4,56,8.0,4,0.0,1,2,6,0,15,9,2,17,4,9,47,1
3872,118554,YBwTM3Bv2witVJ0Ed4zAbHn1UCLHLsEN,G8EPVSXsOYB5YQWZGiz1aVq5Pgr2GrQu,27,37,22,42,11,1,7,1,121,17.285714285714285,2,0.0,11,22,30,11,26,1,12,7,1,74,47,0
3873,118620,tKs772tHpR5tE8Ceee9VXQcqKPNhx6zt,SpATywNh6bZuzm8s1ceuBUnMUAeoAHHw,11,11,2,6,1,0,3,1,24,3.4285714285714284,2,0.0,3,2,5,1,8,0,1,3,1,11,13,1
3874,118652,eNgDL8k9xOLyBlZ3UNlseJHly8SfPZZu,bWdj2GDclj5ofokWjzoa5jAwMkxCykd6,13,66,36,90,0,42,27,1,262,37.42857142857143,5,0.0,16,36,86,0,50,42,4,27,1,138,124,0
3875,118687,c1BXmJNemroOPh6WUefTBD28s2WzSNwi,A3fsA9Zfv1X2fVEQhTw51lKENdNrEqT3,26,28,3,24,2,1,12,2,72,10.285714285714286,4,0.0,0,3,24,2,28,1,0,12,2,29,43,1
3876,118688,c1BXmJNemroOPh6WUefTBD28s2WzSNwi,SpATywNh6bZuzm8s1ceuBUnMUAeoAHHw,14,25,0,12,0,2,6,1,46,6.571428571428571,1,0.0,12,0,12,0,13,2,0,6,1,24,22,0
3877,118704,ZfIQYurnR6gJbWxLJ81cU3ZqzX4mpHm0,bWdj2GDclj5ofokWjzoa5jAwMkxCykd6,6,3,1,0,0,0,5,0,9,1.2857142857142858,1,0.0,0,1,0,0,3,0,0,5,0,1,8,0
3878,118735,f6FNE8vNtrL6TKWAyYNA5KZvLoAoDp49,SpATywNh6bZuzm8s1ceuBUnMUAeoAHHw,15,17,1,23,2,2,10,0,55,7.857142857142857,1,0.0,8,1,20,2,9,2,3,10,0,31,24,1
3879,118748,grNuFIQJF1sOOkw8RJjaExhlwTJt52uU,G8EPVSXsOYB5YQWZGiz1aVq5Pgr2GrQu,21,51,24,78,16,6,7,0,182,26.0,3,0.0,5,24,71,16,46,6,7,7,0,116,66,0
3880,118757,8x72g1EnsW8bYBL6HWtA15C4pKj2sPjA,G8EPVSXsOYB5YQWZGiz1aVq5Pgr2GrQu,5,3,1,0,1,0,2,0,7,1.0,1,0.0,0,1,0,1,3,0,0,2,0,2,5,1
3881,118792,bKVslXuzEQ1pv4c6iV5mVjs6X6avUbmL,SpATywNh6bZuzm8s1ceuBUnMUAeoAHHw,6,3,2,0,2,0,1,0,8,1.1428571428571428,1,0.0,0,2,0,2,3,0,0,1,0,4,4,1
3882,118793,lrp5AGJUh69hKuCI5IYUEU19E2beipwd,bWdj2GDclj5ofokWjzoa5jAwMkxCykd6,12,22,3,0,5,6,10,0,46,6.571428571428571,5,0.0,0,3,0,5,22,6,0,10,0,8,38,1
3883,118806,NbUyHCtjlZY38KWhmKKrrw2eE1rI3XlV,SpATywNh6bZuzm8s1ceuBUnMUAeoAHHw,1,0,0,0,0,0,1,0,1,0.14285714285714285,1,0.0,0,0,0,0,0,0,0,1,0,0,1,0
3884,118884,c8WJAdYLV71mOx4ZXSglpCNd0dBUR3Om,SpATywNh6bZuzm8s1ceuBUnMUAeoAHHw,14,13,7,14,3,0,5,0,42,6.0,2,0.0,2,7,11,3,11,0,3,5,0,23,19,0
3885,118934,9Nk7mnk1e8KYLiEHu7uBQQPnqWiwScVk,RXDvfPUBYFlVdlueBFbLW0mhhAyGEqpt,14,21,8,0,4,4,11,1,49,7.0,2,0.0,0,8,0,4,21,4,0,11,1,12,37,1
3886,118936,0PuPhUY9SiHUBSSrbkLAmF5o2IPgOmxV,SpATywNh6bZuzm8s1ceuBUnMUAeoAHHw,9,11,9,0,8,1,2,0,31,4.428571428571429,2,0.0,0,9,0,8,11,1,0,2,0,17,14,1
3887,118948,59I5in7ieFGusS8qxVtrv60LZ3ifOtyr,bWdj2GDclj5ofokWjzoa5jAwMkxCykd6,16,41,18,128,9,0,5,0,201,28.714285714285715,3,0.0,13,18,128,9,28,0,0,5,0,168,33,1
3888,118949,ELJa8A81VOfiqD4Bg0Px962sx2WBYvb0,SpATywNh6bZuzm8s1ceuBUnMUAeoAHHw,5,3,1,0,1,0,1,0,6,0.8571428571428571,1,0.0,0,1,0,1,3,0,0,1,0,2,4,0
3889,118951,TBPsTKQ0wiJelelFqXJF9QW001tGl6zy,A3fsA9Zfv1X2fVEQhTw51lKENdNrEqT3,9,4,0,0,0,0,11,1,16,2.2857142857142856,1,0.0,0,0,0,0,4,0,0,11,1,0,16,1
3890,118971,u2BXxIc4z9dAiJXDpFgnfPpgZoYcSTcc,bWdj2GDclj5ofokWjzoa5jAwMkxCykd6,6,9,5,0,2,0,6,0,22,3.142857142857143,3,0.0,0,5,0,2,9,0,0,6,0,7,15,1
3891,118997,mlU6Sa4kvQqDwrJTiTVy3DXIlsysw3Tt,A3fsA9Zfv1X2fVEQhTw51lKENdNrEqT3,35,22,0,92,0,12,9,1,136,19.428571428571427,2,0.0,2,0,75,0,20,12,17,9,1,77,59,1
3892,119004,3eP3vquJMvO37pCrMFuVqCWmbxwqBlGj,A3fsA9Zfv1X2fVEQhTw51lKENdNrEqT3,15,10,8,2,7,0,3,0,30,4.285714285714286,2,0.0,0,8,2,7,10,0,0,3,0,17,13,1
3893,119045,VXXH6vGXZQbtzT48oIYSMTaYkPq1TVm5,SpATywNh6bZuzm8s1ceuBUnMUAeoAHHw,8,3,2,0,2,0,5,1,13,1.8571428571428572,1,0.0,0,2,0,2,3,0,0,5,1,4,9,0
3894,119053,fS72R3kjN9mNNeiYurwm3Uc8w1dF6aYm,SpATywNh6bZuzm8s1ceuBUnMUAeoAHHw,17,31,15,12,6,14,12,1,91,13.0,4,0.0,10,15,9,6,21,14,3,12,1,40,51,0
3895,119081,GXJYNcNV7uKT2JtMLlsgpwRjSgogNoCV,SpATywNh6bZuzm8s1ceuBUnMUAeoAHHw,14,14,7,24,0,7,6,1,59,8.428571428571429,3,0.0,4,7,18,0,10,7,6,6,1,29,30,1
3896,119114,99Z3XYkjkHbSSUTlX3TBtdd4he2ej5Yp,SpATywNh6bZuzm8s1ceuBUnMUAeoAHHw,5,3,0,0,0,0,2,0,5,0.7142857142857143,1,0.0,0,0,0,0,3,0,0,2,0,0,5,1
3897,119122,2GmODuvdJOOWe3lnyYMmKWQOHBH828Cm,SpATywNh6bZuzm8s1ceuBUnMUAeoAHHw,12,15,4,18,3,0,2,0,42,6.0,1,0.0,10,4,17,3,5,0,1,2,0,34,8,1
3898,119128,OUbrW18OgibVb4I41eHFiFhkobpgjEP2,bWdj2GDclj5ofokWjzoa5jAwMkxCykd6,11,12,9,0,7,0,8,0,36,5.142857142857143,1,0.0,0,9,0,7,12,0,0,8,0,16,20,0
3899,119144,ppepyuI84wHcCSvA9T6Tm0AI9MVxK9O7,SpATywNh6bZuzm8s1ceuBUnMUAeoAHHw,17,32,12,18,5,14,12,1,94,13.428571428571429,3,0.0,14,12,15,5,18,14,3,12,1,46,48,0
3900,119158,y71lRBqIdu5iPiLn9Yi5PQm6GFIvgLwB,SpATywNh6bZuzm8s1ceuBUnMUAeoAHHw,12,19,8,10,2,0,5,0,44,6.285714285714286,1,0.0,6,8,9,2,13,0,1,5,0,25,19,0
3901,119168,ekf83KLNEhO9pLixPeJLFRG8dewqTHZv,A3fsA9Zfv1X2fVEQhTw51lKENdNrEqT3,41,39,16,72,7,1,17,2,154,22.0,1,0.0,4,16,57,7,35,1,15,17,2,84,70,1
3902,119181,mu7Zdr1ChN6xNMWE8Otd7Si7TQhm7pEQ,A3fsA9Zfv1X2fVEQhTw51lKENdNrEqT3,15,24,12,0,6,0,22,0,64,9.142857142857142,4,0.0,0,12,0,6,24,0,0,22,0,18,46,1
3903,119186,3RNLJ31M9nSB8CG0xpg62lnc8uIPaM9a,A3fsA9Zfv1X2fVEQhTw51lKENdNrEqT3,1,0,0,0,0,0,1,0,1,0.14285714285714285,1,0.0,0,0,0,0,0,0,0,1,0,0,1,1
3904,119189,OXg5CDewbDZIhWJ50yEsGOqULuWAjfkH,SpATywNh6bZuzm8s1ceuBUnMUAeoAHHw,16,28,8,9,4,0,5,0,54,7.714285714285714,2,0.0,18,8,9,4,10,0,0,5,0,39,15,0
3905,119210,MgBJbfRXH0QNEJmIiGY28SpmFvbhxSoF,SpATywNh6bZuzm8s1ceuBUnMUAeoAHHw,14,22,7,11,3,8,4,0,55,7.857142857142857,2,0.0,3,7,10,3,19,8,1,4,0,23,32,0
3906,119227,xxkjaaKQsdSI27nMseGDTa7U8FtH9OJW,SpATywNh6bZuzm8s1ceuBUnMUAeoAHHw,1,0,0,0,0,0,1,0,1,0.14285714285714285,1,0.0,0,0,0,0,0,0,0,1,0,0,1,0
3907,119254,i0ksX07HnsV5rQlWqOr1uKEuc7yNU24c,SpATywNh6bZuzm8s1ceuBUnMUAeoAHHw,17,32,14,10,4,26,16,2,104,14.857142857142858,4,0.0,8,14,8,4,24,26,2,16,2,34,70,0
3908,119277,sBmxTL0paOf5h6iJST2iiGwB52qodqPr,bWdj2GDclj5ofokWjzoa5jAwMkxCykd6,17,24,10,74,3,36,27,3,177,25.285714285714285,4,0.0,7,10,72,3,17,36,2,27,3,92,85,0
3909,119279,FOCwtnRC84DvGRNwirqX2TIHG72pPbnw,SpATywNh6bZuzm8s1ceuBUnMUAeoAHHw,3,2,1,0,0,0,1,0,4,0.5714285714285714,1,0.0,0,1,0,0,2,0,0,1,0,1,3,0
3910,119302,YRQYtB97mu5D5o5X26cOj03m1GAHWWGU,A3fsA9Zfv1X2fVEQhTw51lKENdNrEqT3,1,0,0,0,0,0,1,0,1,0.14285714285714285,1,0.0,0,0,0,0,0,0,0,1,0,0,1,1
3911,119311,o5C13ZWWgtJ11zB44EfcDF5SUBXAMxu8,SpATywNh6bZuzm8s1ceuBUnMUAeoAHHw,14,11,1,10,0,2,13,2,39,5.571428571428571,2,0.0,2,1,8,0,9,2,2,13,2,11,28,0
3912,119318,LKEJY5MvP0gj7M4NL5iRnXDBazXBKsOA,A3fsA9Zfv1X2fVEQhTw51lKENdNrEqT3,11,14,4,0,3,0,2,0,23,3.2857142857142856,1,0.0,0,4,0,3,14,0,0,2,0,7,16,1
3913,119333,om0KjvovtBK0gZUSboAPRv5A6Jkm00Ei,SpATywNh6bZuzm8s1ceuBUnMUAeoAHHw,1,0,0,0,0,0,1,0,1,0.14285714285714285,1,0.0,0,0,0,0,0,0,0,1,0,0,1,1
3914,119352,8EUVcR3i03tV4r6XHeEe98sUtzrKJPIp,SpATywNh6bZuzm8s1ceuBUnMUAeoAHHw,15,16,10,6,3,2,8,0,45,6.428571428571429,4,0.0,3,10,6,3,13,2,0,8,0,22,23,0
3915,119354,dTKURyZ9dyqGbe4l7wsUGgSU85JHBAFq,SpATywNh6bZuzm8s1ceuBUnMUAeoAHHw,8,4,3,0,3,0,1,0,11,1.5714285714285714,1,0.0,0,3,0,3,4,0,0,1,0,6,5,0
3916,119380,6CE4R3S7kL46D5t23wqANpKa4VUqa9S2,SpATywNh6bZuzm8s1ceuBUnMUAeoAHHw,6,7,0,0,0,0,2,0,9,1.2857142857142858,1,0.0,0,0,0,0,7,0,0,2,0,0,9,1
3917,119386,nIvIddlMAmTQagaACOulbZ6PInxlyOy2,SpATywNh6bZuzm8s1ceuBUnMUAeoAHHw,14,20,11,12,4,5,5,1,58,8.285714285714286,1,0.0,6,11,12,4,14,5,0,5,1,33,25,1
3918,119390,hZR4MwcYec4g0GoOyJFngJGEyWOySpv2,A3fsA9Zfv1X2fVEQhTw51lKENdNrEqT3,9,12,8,0,6,5,10,0,41,5.857142857142857,4,0.0,0,8,0,6,12,5,0,10,0,14,27,0
3919,119391,mxHDkP66knN7zmdYEUQKDHYwEophbx3W,SpATywNh6bZuzm8s1ceuBUnMUAeoAHHw,16,27,13,12,11,133,11,3,210,30.0,2,0.0,8,13,10,11,19,133,2,11,3,42,168,0
3920,119429,OTXI4wiLpFntQK2eNytsM7PA1sOBHBSJ,G8EPVSXsOYB5YQWZGiz1aVq5Pgr2GrQu,14,35,1,40,5,7,2,0,90,12.857142857142858,1,0.0,23,1,32,5,12,7,8,2,0,61,29,0
3921,119439,lzAfN1BunM1OtPEKsFi16ad7rFshkF39,A3fsA9Zfv1X2fVEQhTw51lKENdNrEqT3,10,5,3,0,2,0,7,0,17,2.4285714285714284,1,0.0,0,3,0,2,5,0,0,7,0,5,12,1
3922,119467,HTcH1TxkMChxNxwRHZ3kkRRHs5Azwnka,SpATywNh6bZuzm8s1ceuBUnMUAeoAHHw,12,44,6,24,0,10,17,0,101,14.428571428571429,2,0.0,14,6,20,0,30,10,4,17,0,40,61,0
3923,119487,pPq1reHOvROgjdMRqZ7zZoFjsUW0sHcE,SpATywNh6bZuzm8s1ceuBUnMUAeoAHHw,8,14,8,0,5,0,5,0,32,4.571428571428571,1,0.0,0,8,0,5,14,0,0,5,0,13,19,1
3924,119490,83cBV2IXkwoW1nUaa1kxaJ98L3bxFsPn,RXDvfPUBYFlVdlueBFbLW0mhhAyGEqpt,16,40,30,0,2,12,11,0,95,13.571428571428571,4,0.0,2,30,0,2,38,12,0,11,0,34,61,1
3925,119506,KouA4JUz2i1n0FC6Xu2JucWPd7vnGUb0,SpATywNh6bZuzm8s1ceuBUnMUAeoAHHw,16,56,12,10,5,1,20,0,104,14.857142857142858,6,0.0,3,12,10,5,53,1,0,20,0,30,74,0
3926,119522,VC4hf15u71ct6dl0hPNvhbtubU19kXe5,RXDvfPUBYFlVdlueBFbLW0mhhAyGEqpt,5,7,1,0,1,0,3,0,12,1.7142857142857142,1,0.0,2,1,0,1,5,0,0,3,0,4,8,1
3927,119524,RRKT0H2BFDE1dQIQFr3IpZgVIVSJVg71,SpATywNh6bZuzm8s1ceuBUnMUAeoAHHw,16,55,18,15,4,2,13,0,107,15.285714285714286,4,0.0,23,18,14,4,32,2,1,13,0,59,48,0
3928,119543,Cf7GCeUZzG7WjvUIyGfwv9hfcwXPVq5G,G8EPVSXsOYB5YQWZGiz1aVq5Pgr2GrQu,21,51,4,56,3,0,13,1,128,18.285714285714285,4,0.0,7,4,47,3,44,0,9,13,1,61,67,0
3929,119566,TeehsynnhYxXCw31hnpNtyZisOmQoW1M,A3fsA9Zfv1X2fVEQhTw51lKENdNrEqT3,12,11,9,0,7,0,5,0,32,4.571428571428571,1,0.0,0,9,0,7,11,0,0,5,0,16,16,1
3930,119567,Dl433WBzpFXMdRxwA66dmtxmpsyN7fkX,SpATywNh6bZuzm8s1ceuBUnMUAeoAHHw,8,7,1,0,1,0,3,0,12,1.7142857142857142,2,0.0,0,1,0,1,7,0,0,3,0,2,10,0
3931,119594,LKtddpPnbyASKztptrkj08yJIKu8wvyQ,SpATywNh6bZuzm8s1ceuBUnMUAeoAHHw,4,2,0,0,0,0,2,0,4,0.5714285714285714,1,0.0,0,0,0,0,2,0,0,2,0,0,4,1
3932,119618,nIvIddlMAmTQagaACOulbZ6PInxlyOy2,A3fsA9Zfv1X2fVEQhTw51lKENdNrEqT3,1,0,0,0,0,0,1,0,1,0.14285714285714285,1,0.0,0,0,0,0,0,0,0,1,0,0,1,1
3933,119619,nIvIddlMAmTQagaACOulbZ6PInxlyOy2,bWdj2GDclj5ofokWjzoa5jAwMkxCykd6,5,2,1,0,1,0,2,0,6,0.8571428571428571,1,0.0,0,1,0,1,2,0,0,2,0,2,4,1
3934,119631,ltVEinCK1OZ9CXJhcqdDg6iZlAvKKTwQ,SpATywNh6bZuzm8s1ceuBUnMUAeoAHHw,18,19,10,16,4,8,12,3,72,10.285714285714286,1,0.0,6,10,13,4,13,8,3,12,3,33,39,0
3935,119652,Zu9dYhL9acZhCeqBcc9hWzPmaWR78jEQ,SpATywNh6bZuzm8s1ceuBUnMUAeoAHHw,17,23,11,16,5,23,22,4,104,14.857142857142858,3,0.0,6,11,15,5,17,23,1,22,4,37,67,1
3936,119695,EGp6xRzNCnsCPDRg0mfvtfy8t2jZt4I9,SpATywNh6bZuzm8s1ceuBUnMUAeoAHHw,15,43,9,21,3,11,9,0,96,13.714285714285714,3,0.0,31,9,18,3,12,11,3,9,0,61,35,0
3937,119701,dkqBzIxmPMIDvZ06VSkMjfODuMzZmTP8,A3fsA9Zfv1X2fVEQhTw51lKENdNrEqT3,7,5,3,0,2,0,3,0,13,1.8571428571428572,3,0.0,0,3,0,2,5,0,0,3,0,5,8,1
3938,119745,UvgRbw5a5wuG6YWcUt1dwOeNyn0b7Smd,SpATywNh6bZuzm8s1ceuBUnMUAeoAHHw,5,2,1,0,1,0,2,0,6,0.8571428571428571,1,0.0,0,1,0,1,2,0,0,2,0,2,4,1
3939,119787,lWx0TIRF08ECAhAH5cUKSzERq6JEXGBg,A3fsA9Zfv1X2fVEQhTw51lKENdNrEqT3,1,0,0,0,0,0,1,0,1,0.14285714285714285,1,0.0,0,0,0,0,0,0,0,1,0,0,1,1
3940,119860,zvwdGnH0aGIXM4GZVb8XpCl4QdIDbhPS,G8EPVSXsOYB5YQWZGiz1aVq5Pgr2GrQu,45,54,32,60,18,29,15,3,211,30.142857142857142,5,0.0,15,32,54,18,39,29,6,15,3,119,92,1
3941,119863,C8zDhaG0vPsQegBtS55u3JZHiYuueFnE,A3fsA9Zfv1X2fVEQhTw51lKENdNrEqT3,22,26,3,14,1,3,19,3,69,9.857142857142858,3,0.0,0,3,12,1,26,3,2,19,3,16,53,0
3942,119865,fl8sEptrcl2JvFWXejFcnsM7BqWtKl9w,SpATywNh6bZuzm8s1ceuBUnMUAeoAHHw,14,12,6,4,3,0,6,2,33,4.714285714285714,1,0.0,2,6,3,3,10,0,1,6,2,14,19,1
3943,119866,VLCI0RtMsYSrwlXRiyKxAF4TijVOF7sG,SpATywNh6bZuzm8s1ceuBUnMUAeoAHHw,14,34,1,9,2,2,6,2,56,8.0,2,0.0,6,1,9,2,28,2,0,6,2,18,38,0
3944,119957,u08BFRXkclhXgm6zX4b6QASKB5vRi3vI,G8EPVSXsOYB5YQWZGiz1aVq5Pgr2GrQu,57,93,56,244,22,18,17,2,452,64.57142857142857,2,0.0,33,56,224,22,60,18,20,17,2,335,117,1
3945,119979,SplRKhPt7Yggv7MXNRiesXXwYzrLK9vJ,G8EPVSXsOYB5YQWZGiz1aVq5Pgr2GrQu,1,0,0,0,0,0,1,0,1,0.14285714285714285,1,0.0,0,0,0,0,0,0,0,1,0,0,1,1
3946,119986,EjqS3A2Iv9J8JTjinbKy3gdtrrXaSQyJ,A3fsA9Zfv1X2fVEQhTw51lKENdNrEqT3,3,2,1,0,0,0,1,0,4,0.5714285714285714,1,0.0,0,1,0,0,2,0,0,1,0,1,3,1
3947,120030,OCy6YOUNXmqhix568ujBGQdiiP42aDkJ,A3fsA9Zfv1X2fVEQhTw51lKENdNrEqT3,2,0,0,0,0,0,2,0,2,0.2857142857142857,1,0.0,0,0,0,0,0,0,0,2,0,0,2,1
3948,120065,fFuKiCeoQQwOgD8VAud2ta198Mbq05KK,A3fsA9Zfv1X2fVEQhTw51lKENdNrEqT3,19,23,10,0,8,4,9,1,55,7.857142857142857,2,0.0,0,10,0,8,23,4,0,9,1,18,37,1
3949,120079,L8OTKfJAxDSZZQ12fQtkWrcZUlsGAJb9,RXDvfPUBYFlVdlueBFbLW0mhhAyGEqpt,4,1,0,0,0,0,3,0,4,0.5714285714285714,1,0.0,0,0,0,0,1,0,0,3,0,0,4,1
3950,120090,ZOVfvlm206voHlGJ4V6McNGjtxTxB7JQ,bWdj2GDclj5ofokWjzoa5jAwMkxCykd6,4,2,1,0,1,0,1,0,5,0.7142857142857143,1,0.0,0,1,0,1,2,0,0,1,0,2,3,1
3951,120139,n82RJkzFXSSDMIdkMmtipPuRNBWDUBXQ,SpATywNh6bZuzm8s1ceuBUnMUAeoAHHw,15,27,13,14,5,0,6,0,65,9.285714285714286,2,0.0,5,13,12,5,22,0,2,6,0,35,30,1
3952,120168,oXcCXnNaPGvzw5MpNzQ49lDnTqlhdcyO,A3fsA9Zfv1X2fVEQhTw51lKENdNrEqT3,8,5,3,0,2,0,3,0,13,1.8571428571428572,2,0.0,0,3,0,2,5,0,0,3,0,5,8,1
3953,120195,1LkX4t7QGG0LPbqqJvnwJmrweFNAYkvm,A3fsA9Zfv1X2fVEQhTw51lKENdNrEqT3,10,6,0,0,0,0,7,2,15,2.142857142857143,1,0.0,0,0,0,0,6,0,0,7,2,0,15,1
3954,120215,UnBwSmlOPbYUmVq2fUKodPbT52jzjDn0,A3fsA9Zfv1X2fVEQhTw51lKENdNrEqT3,12,6,5,0,5,0,1,0,17,2.4285714285714284,1,0.0,0,5,0,5,6,0,0,1,0,10,7,0
3955,120223,nrDkIZH2wqEVh6i4pBxcbRBJIMc9s20b,G8EPVSXsOYB5YQWZGiz1aVq5Pgr2GrQu,41,87,3,102,4,0,20,0,216,30.857142857142858,4,0.0,32,3,87,4,55,0,15,20,0,126,90,0
3956,120232,RYd1k9DojojPZwrkV3NjsTI5OdZnPV9W,SpATywNh6bZuzm8s1ceuBUnMUAeoAHHw,11,19,0,12,2,0,3,0,36,5.142857142857143,1,0.0,2,0,12,2,17,0,0,3,0,16,20,0
3957,120235,RYd1k9DojojPZwrkV3NjsTI5OdZnPV9W,RXDvfPUBYFlVdlueBFbLW0mhhAyGEqpt,7,6,0,0,0,0,1,0,7,1.0,1,0.0,0,0,0,0,6,0,0,1,0,0,7,1
3958,120266,kV6dnmPo3GuG7esOG3uZN9iddNOehLbM,SpATywNh6bZuzm8s1ceuBUnMUAeoAHHw,13,22,1,7,0,4,10,2,46,6.571428571428571,2,0.0,5,1,7,0,17,4,0,10,2,13,33,1
3959,120275,wx3mAGKFM6cge9w8piWfsYKppmWVhkYO,A3fsA9Zfv1X2fVEQhTw51lKENdNrEqT3,8,8,4,0,2,0,4,0,18,2.5714285714285716,3,0.0,0,4,0,2,8,0,0,4,0,6,12,1
3960,120282,nWkYRwHsKkKnBVjIvOv2LYBdEyL0lZTL,A3fsA9Zfv1X2fVEQhTw51lKENdNrEqT3,6,9,1,0,1,0,2,0,13,1.8571428571428572,1,0.0,0,1,0,1,9,0,0,2,0,2,11,1
3961,120297,7xobbz91DmuqnSowtdCPvlArDkv1wvpY,bWdj2GDclj5ofokWjzoa5jAwMkxCykd6,6,3,1,0,1,1,4,1,11,1.5714285714285714,1,0.0,0,1,0,1,3,1,0,4,1,2,9,0
3962,120312,1cbn6mbdbvkgaRHmtNkyztYkaJcKUMeq,A3fsA9Zfv1X2fVEQhTw51lKENdNrEqT3,26,6,4,88,1,0,9,0,108,15.428571428571429,2,0.0,2,4,73,1,4,0,15,9,0,80,28,1
3963,120319,SslryCWQFxjgJq7Qzkpxu4WYyOvHjfIA,SpATywNh6bZuzm8s1ceuBUnMUAeoAHHw,4,2,0,0,0,0,2,0,4,0.5714285714285714,1,0.0,0,0,0,0,2,0,0,2,0,0,4,1
3964,120324,BFpj8Vxul230N4kCbxR9rjWJ12ZQLtAV,RXDvfPUBYFlVdlueBFbLW0mhhAyGEqpt,2,0,0,0,0,0,2,0,2,0.2857142857142857,1,0.0,0,0,0,0,0,0,0,2,0,0,2,0
3965,120452,5PCeecJ7dPIRTUfiwjNNMWT45OJxiKsA,SpATywNh6bZuzm8s1ceuBUnMUAeoAHHw,13,16,11,23,6,0,2,0,58,8.285714285714286,1,0.0,4,11,18,6,12,0,5,2,0,39,19,1
3966,120497,pb5Jjq3Ash9pKloUfJAc3dsHOjXwUSUN,SpATywNh6bZuzm8s1ceuBUnMUAeoAHHw,4,4,0,0,0,0,2,0,6,0.8571428571428571,1,0.0,0,0,0,0,4,0,0,2,0,0,6,1
3967,120499,5scsz5bGh8T1roTXhO7UpMXlEDKIsK9l,SpATywNh6bZuzm8s1ceuBUnMUAeoAHHw,16,20,7,17,4,7,5,1,61,8.714285714285714,1,0.0,7,7,15,4,13,7,2,5,1,33,28,1
3968,120666,NTsLMBrSdSgh32E5eAwn0TyewK2E1eGS,A3fsA9Zfv1X2fVEQhTw51lKENdNrEqT3,1,0,0,0,0,0,1,0,1,0.14285714285714285,1,0.0,0,0,0,0,0,0,0,1,0,0,1,1
3969,120674,cR6ka5k7tAsfYo9cLOUPkpzWO6OItcGJ,G8EPVSXsOYB5YQWZGiz1aVq5Pgr2GrQu,14,12,8,0,5,0,5,0,30,4.285714285714286,1,0.0,0,8,0,5,12,0,0,5,0,13,17,1
3970,120675,CaJSrSiICAfSlo2FFV44vmQh9prPvDrE,A3fsA9Zfv1X2fVEQhTw51lKENdNrEqT3,12,12,5,0,3,0,6,0,26,3.7142857142857144,1,0.0,0,5,0,3,12,0,0,6,0,8,18,1
3971,120703,4dodDlxC4kpDOhgavFhn4UZKBioEfZ2a,SpATywNh6bZuzm8s1ceuBUnMUAeoAHHw,15,42,1,20,1,18,28,5,115,16.428571428571427,2,0.0,25,1,17,1,17,18,3,28,5,44,71,1
3972,120722,1R1zO9aMB7Mx1Lw84JzsChVEV5JpwmZv,G8EPVSXsOYB5YQWZGiz1aVq5Pgr2GrQu,40,65,10,70,10,12,16,0,183,26.142857142857142,6,0.0,21,10,47,10,44,12,23,16,0,88,95,1
3973,120751,fTZGf1uwMtb2LTyvoTILgCp8LRW0SKIe,RXDvfPUBYFlVdlueBFbLW0mhhAyGEqpt,11,19,7,18,7,0,1,0,52,7.428571428571429,2,0.0,9,7,15,7,10,0,3,1,0,38,14,1
3974,120759,yTPVosjRFgkyQAyVowXjYrsQYKByzY4B,A3fsA9Zfv1X2fVEQhTw51lKENdNrEqT3,20,19,1,56,0,29,7,1,113,16.142857142857142,3,0.0,4,1,44,0,15,29,12,7,1,49,64,1
3975,120771,IvdoAzckjyWWCkzCy6V0BjWvOwMyZEwg,bWdj2GDclj5ofokWjzoa5jAwMkxCykd6,19,26,14,28,8,14,19,2,111,15.857142857142858,4,0.0,7,14,27,8,19,14,1,19,2,56,55,1
3976,120774,7hx1Kw9WXBMDyaoF5WfFzTdCBmNZ2uMk,SpATywNh6bZuzm8s1ceuBUnMUAeoAHHw,18,54,9,18,3,19,30,4,137,19.571428571428573,6,0.0,18,9,15,3,36,19,3,30,4,45,92,1
3977,120808,OTAUIgoWBEWsq2kd8lnvB0dKpj3SXEdR,SpATywNh6bZuzm8s1ceuBUnMUAeoAHHw,16,23,10,16,4,22,6,2,83,11.857142857142858,1,0.0,12,10,15,4,11,22,1,6,2,41,42,1
3978,120815,qwhxcjW9iIMBAQoGSWDtst34AFkcFQoV,A3fsA9Zfv1X2fVEQhTw51lKENdNrEqT3,10,19,9,0,1,1,6,0,36,5.142857142857143,3,0.0,0,9,0,1,19,1,0,6,0,10,26,0
3979,120818,hn9Zjyg7I7mBsVCg91jyZTDh6RPM5yRT,G8EPVSXsOYB5YQWZGiz1aVq5Pgr2GrQu,1,0,0,0,0,0,1,0,1,0.14285714285714285,1,0.0,0,0,0,0,0,0,0,1,0,0,1,0
3980,120835,EaFWRMbtKR52j7nbPydGVwuzgPsml9aN,A3fsA9Zfv1X2fVEQhTw51lKENdNrEqT3,5,5,2,0,0,0,8,0,15,2.142857142857143,2,0.0,0,2,0,0,5,0,0,8,0,2,13,1
3981,120854,fl8sEptrcl2JvFWXejFcnsM7BqWtKl9w,A3fsA9Zfv1X2fVEQhTw51lKENdNrEqT3,7,5,1,0,1,0,4,0,11,1.5714285714285714,2,0.0,0,1,0,1,5,0,0,4,0,2,9,1
3982,120891,ABAPRQWSFErhHUFQsJmCoj4Rpg4DtQ8w,A3fsA9Zfv1X2fVEQhTw51lKENdNrEqT3,13,44,20,0,13,0,10,0,87,12.428571428571429,2,0.0,1,20,0,13,43,0,0,10,0,34,53,1
3983,120892,pAkhnLI0s5vboktZycO7Tobv6jbspULh,SpATywNh6bZuzm8s1ceuBUnMUAeoAHHw,10,12,6,0,3,0,5,0,26,3.7142857142857144,5,0.0,0,6,0,3,12,0,0,5,0,9,17,1
3984,120894,dQweEcdBCmNmUPOeO7X4TTmH8zuMq2aJ,A3fsA9Zfv1X2fVEQhTw51lKENdNrEqT3,4,7,3,0,0,6,4,0,20,2.857142857142857,2,0.0,0,3,0,0,7,6,0,4,0,3,17,1
3985,120906,Z9nbZek76s4RBuA56w1WtME3e9ClZkaP,A3fsA9Zfv1X2fVEQhTw51lKENdNrEqT3,39,25,19,58,10,16,4,1,133,19.0,2,0.0,1,19,50,10,24,16,8,4,1,80,53,0
3986,120909,aldLXGpzmiip2CUSDhqN8A5UpGMVUHxY,A3fsA9Zfv1X2fVEQhTw51lKENdNrEqT3,17,19,15,0,4,0,2,0,40,5.714285714285714,3,0.0,2,15,0,4,17,0,0,2,0,21,19,0
3987,120928,sApH95kwlTdIi3RvuRD74A0dFhVPKais,SpATywNh6bZuzm8s1ceuBUnMUAeoAHHw,4,2,1,0,1,0,1,0,5,0.7142857142857143,1,0.0,0,1,0,1,2,0,0,1,0,2,3,1
3988,120949,ONK0Esb7fhLc69POI06k3Sj1alNC6Fij,SpATywNh6bZuzm8s1ceuBUnMUAeoAHHw,15,15,6,14,5,8,15,0,63,9.0,5,0.0,9,6,13,5,6,8,1,15,0,33,30,0
3989,120973,VsZvGrXbL1e6v6hmpJQH8MldIkCBO9P7,RXDvfPUBYFlVdlueBFbLW0mhhAyGEqpt,50,85,26,136,15,9,19,14,304,43.42857142857143,3,0.0,15,26,130,15,70,9,6,19,14,186,118,0
3990,120979,VsZvGrXbL1e6v6hmpJQH8MldIkCBO9P7,A3fsA9Zfv1X2fVEQhTw51lKENdNrEqT3,44,33,16,58,11,4,15,1,138,19.714285714285715,2,0.0,1,16,51,11,32,4,7,15,1,79,59,1
3991,120982,JBjDnQZVwVLGdsvKJqTw57nrx9uYY0vn,A3fsA9Zfv1X2fVEQhTw51lKENdNrEqT3,9,15,1,0,1,0,6,0,23,3.2857142857142856,2,0.0,0,1,0,1,15,0,0,6,0,2,21,0
3992,121048,nwFT4lnmg30fCvHRB6tbALo9FpcanuLx,bWdj2GDclj5ofokWjzoa5jAwMkxCykd6,1,0,0,0,0,0,2,0,2,0.2857142857142857,2,0.0,0,0,0,0,0,0,0,2,0,0,2,0
3993,121105,M8ur292SdHouJ1LnQyJMDkHJM5sUPxnX,SpATywNh6bZuzm8s1ceuBUnMUAeoAHHw,4,3,1,0,0,0,1,0,5,0.7142857142857143,1,0.0,0,1,0,0,3,0,0,1,0,1,4,0
3994,121136,kHp5QZURLzbWn4koqFYZnQmO0kliz5hb,SpATywNh6bZuzm8s1ceuBUnMUAeoAHHw,14,25,11,6,7,3,3,0,55,7.857142857142857,3,0.0,9,11,6,7,16,3,0,3,0,33,22,1
3995,121345,ePaTLgBKhclwas3ClxzVVmTCgYzhx4go,SpATywNh6bZuzm8s1ceuBUnMUAeoAHHw,17,30,3,23,0,23,16,0,95,13.571428571428571,3,0.0,8,3,18,0,22,23,5,16,0,29,66,0
3996,121415,5tRF7MIiw9rvKGI9GzHJVDzIS50Mqb8o,RXDvfPUBYFlVdlueBFbLW0mhhAyGEqpt,31,32,3,50,3,0,4,0,92,13.142857142857142,2,0.0,8,3,46,3,24,0,4,4,0,60,32,1
3997,121438,3w2Xuq08gulsgNUr7oA3MOaceNv4Akte,bWdj2GDclj5ofokWjzoa5jAwMkxCykd6,4,5,1,0,1,0,1,0,8,1.1428571428571428,1,0.0,0,1,0,1,5,0,0,1,0,2,6,1
3998,121446,Haz3G1DnETqwzmdUg5ALbCZo1Lv5wDs9,SpATywNh6bZuzm8s1ceuBUnMUAeoAHHw,4,2,1,0,1,0,2,0,6,0.8571428571428571,2,0.0,0,1,0,1,2,0,0,2,0,2,4,1
3999,121656,aVeyGdrz6Ir4LmiLkJqBoRjG1lQ7MsV8,bWdj2GDclj5ofokWjzoa5jAwMkxCykd6,7,25,7,4,0,0,7,0,43,6.142857142857143,5,0.0,8,7,3,0,17,0,1,7,0,18,25,0
4000,121711,5U79KRZxDDBIetuxjK0KXphUhzbxTzjr,A3fsA9Zfv1X2fVEQhTw51lKENdNrEqT3,5,2,1,0,1,0,2,0,6,0.8571428571428571,1,0.0,0,1,0,1,2,0,0,2,0,2,4,1
4001,121712,zdC6SE3iIVhpYTGT1Ftflp0F2V48NqFq,SpATywNh6bZuzm8s1ceuBUnMUAeoAHHw,16,38,12,12,5,3,6,1,77,11.0,1,0.0,25,12,11,5,13,3,1,6,1,53,24,1
4002,121721,RNEuStAlTxZHIZFwvfCfasMOM5Hny2Pn,SpATywNh6bZuzm8s1ceuBUnMUAeoAHHw,5,2,1,0,1,0,3,0,7,1.0,1,0.0,0,1,0,1,2,0,0,3,0,2,5,1
4003,121731,wBp63rzsgy2LzOR2gkxDj87VT9Ja70XK,SpATywNh6bZuzm8s1ceuBUnMUAeoAHHw,16,20,7,18,3,16,12,3,79,11.285714285714286,1,0.0,8,7,15,3,12,16,3,12,3,33,46,1
4004,121738,V6LNlp0n6EiMGFhm98i6D7Pk9T5LWptM,SpATywNh6bZuzm8s1ceuBUnMUAeoAHHw,5,3,1,0,1,0,1,0,6,0.8571428571428571,1,0.0,0,1,0,1,3,0,0,1,0,2,4,1
4005,121766,EbdsJCzME79IdKcgnIKOnAggJJmkpV77,G8EPVSXsOYB5YQWZGiz1aVq5Pgr2GrQu,20,11,9,28,7,0,7,0,62,8.857142857142858,1,0.0,1,9,21,7,10,0,7,7,0,38,24,0
4006,121768,Zt3P4JGoAgyqFxw766ynWY30ef3EfJ1u,SpATywNh6bZuzm8s1ceuBUnMUAeoAHHw,10,8,5,0,4,0,9,1,27,3.857142857142857,1,0.0,0,5,0,4,8,0,0,9,1,9,18,0
4007,121776,sOhMuZ2KPBl6wLWzfGcWvrQoSfIarVJv,SpATywNh6bZuzm8s1ceuBUnMUAeoAHHw,1,0,0,0,0,0,1,0,1,0.14285714285714285,1,0.0,0,0,0,0,0,0,0,1,0,0,1,1
4008,121789,XC5tRBKME8ONyczymYjZjR1MyrCYegPM,G8EPVSXsOYB5YQWZGiz1aVq5Pgr2GrQu,21,43,12,56,4,1,2,0,118,16.857142857142858,1,0.0,29,12,44,4,14,1,12,2,0,89,29,0
4009,121870,iY0UWsKzM76w2sBfvkSz2A0A6313cEPM,SpATywNh6bZuzm8s1ceuBUnMUAeoAHHw,10,18,1,3,0,0,1,0,23,3.2857142857142856,1,0.0,5,1,3,0,13,0,0,1,0,9,14,1
4010,121953,ahM4WE7sAySvmZ0R8lWqo09z8fOCvKFZ,SpATywNh6bZuzm8s1ceuBUnMUAeoAHHw,11,10,4,0,2,1,10,1,28,4.0,2,0.0,3,4,0,2,7,1,0,10,1,9,19,1
4011,122069,Cyazs2KNzeLH7rwO0YD9wLQWGHR2SXrB,RXDvfPUBYFlVdlueBFbLW0mhhAyGEqpt,4,2,1,0,1,0,1,0,5,0.7142857142857143,1,0.0,0,1,0,1,2,0,0,1,0,2,3,1
4012,124667,15vqe2Z6zLmyPR70QAa8Kn2V8zhvh9Uk,7GRhBDsirIGkRZBtSMEzNTyDr2JQm4xx,9,4,1,0,0,0,9,0,14,2.0,1,0.0,0,1,0,0,4,0,0,9,0,1,13,1
4013,124685,qwhxcjW9iIMBAQoGSWDtst34AFkcFQoV,7GRhBDsirIGkRZBtSMEzNTyDr2JQm4xx,9,18,7,4,2,0,5,0,36,5.142857142857143,3,0.0,1,7,3,2,17,0,1,5,0,13,23,0
4014,124687,eQeAZJfAlQDBFNhBayGkUGtYxXtMJqJ1,7GRhBDsirIGkRZBtSMEzNTyDr2JQm4xx,15,32,16,4,8,3,6,0,69,9.857142857142858,2,0.0,10,16,3,8,22,3,1,6,0,37,32,1
4015,124688,MTBFJm3bIEaE6OQdIPJiDEIIoJhDDIeA,7GRhBDsirIGkRZBtSMEzNTyDr2JQm4xx,24,19,8,30,10,3,6,0,76,10.857142857142858,1,0.0,9,8,28,10,10,3,2,6,0,55,21,0
4016,124723,pyk8IpgYoJC2oe3kCohOVZ3WNjOmgeaA,7GRhBDsirIGkRZBtSMEzNTyDr2JQm4xx,29,35,13,55,9,2,7,0,121,17.285714285714285,1,0.0,19,13,47,9,16,2,8,7,0,88,33,1
4017,124848,LsB37SHCi56YIWKTwUYRQPUU0IwClcqd,7GRhBDsirIGkRZBtSMEzNTyDr2JQm4xx,13,21,7,14,3,0,2,0,47,6.714285714285714,2,0.0,4,7,12,3,17,0,2,2,0,26,21,1
4018,124975,Z4Ol2MWosmvKrLpBOUDzuhHb0EYhkqtT,7GRhBDsirIGkRZBtSMEzNTyDr2JQm4xx,30,71,20,79,23,3,13,0,209,29.857142857142858,4,0.0,43,20,68,23,28,3,11,13,0,154,55,1
4019,125017,xVQ88VrIuIA75ygDlevnROobNkwcFnsc,7GRhBDsirIGkRZBtSMEzNTyDr2JQm4xx,3,2,0,0,0,0,1,0,3,0.42857142857142855,1,0.0,0,0,0,0,2,0,0,1,0,0,3,1
4020,125913,rPGMKO3AhLxN6LWflYbraX7SC5U9X2nK,7GRhBDsirIGkRZBtSMEzNTyDr2JQm4xx,10,4,1,4,2,10,12,2,35,5.0,2,0.0,2,1,3,2,2,10,1,12,2,8,27,1
4021,126611,AoOeu50PBcRJGzXnTeyvy2HLmQU50HHC,fbPkOYLVPtPgIt0MxizjfFJov3JbHyAi,4,2,1,0,1,0,1,0,5,0.7142857142857143,1,0.0,0,1,0,1,2,0,0,1,0,2,3,1
4022,126619,ITwd7xpRvyZSfkB4lL2L6OmpyXYVHZGs,fbPkOYLVPtPgIt0MxizjfFJov3JbHyAi,7,9,6,0,0,7,8,1,31,4.428571428571429,1,0.0,0,6,0,0,9,7,0,8,1,6,25,1
4023,126622,27Xik6MkaFL4yWSO9zEEJwVQHW9Np8S6,fbPkOYLVPtPgIt0MxizjfFJov3JbHyAi,17,9,8,0,8,2,6,0,33,4.714285714285714,2,0.0,0,8,0,8,9,2,0,6,0,16,17,1
4024,126623,TiN4z0dSpp09iMKqN066qAoKwqCoLlNB,fbPkOYLVPtPgIt0MxizjfFJov3JbHyAi,6,3,2,0,2,2,1,0,10,1.4285714285714286,1,0.0,0,2,0,2,3,2,0,1,0,4,6,1
4025,126624,YRDulTOgIWgR8cFwTAVhhuxX46WtWav7,fbPkOYLVPtPgIt0MxizjfFJov3JbHyAi,9,9,5,0,3,0,7,1,25,3.5714285714285716,1,0.0,1,5,0,3,8,0,0,7,1,9,16,1
4026,126630,EDMSGPNYA9U08P3iZyDo7po9ZIKNfhJJ,fbPkOYLVPtPgIt0MxizjfFJov3JbHyAi,8,9,2,6,5,0,5,0,27,3.857142857142857,1,0.0,6,2,4,5,3,0,2,5,0,17,10,1
4027,126632,yjkClXSb67ZKWAEvHxmMMyNPfAsPBpjl,fbPkOYLVPtPgIt0MxizjfFJov3JbHyAi,8,6,3,0,3,0,7,0,19,2.7142857142857144,1,0.0,2,3,0,3,4,0,0,7,0,8,11,1
4028,126633,KmIlNo2pbRKBzhZUiCgI2YhiW6w8iosj,fbPkOYLVPtPgIt0MxizjfFJov3JbHyAi,4,2,1,0,1,0,3,0,7,1.0,1,0.0,0,1,0,1,2,0,0,3,0,2,5,1
4029,126641,z8UfBjDXGrDWc9AMM6dseoK9YyEoRq02,fbPkOYLVPtPgIt0MxizjfFJov3JbHyAi,6,3,2,0,2,0,1,0,8,1.1428571428571428,1,0.0,0,2,0,2,3,0,0,1,0,4,4,1
4030,126645,sUFqKFuTqKGNKIqwb0vqeiIMtCX1CVCE,fbPkOYLVPtPgIt0MxizjfFJov3JbHyAi,10,3,3,0,3,0,3,1,13,1.8571428571428572,1,0.0,0,3,0,3,3,0,0,3,1,6,7,1
4031,126648,j9gdcEQiWF4hz17rFxv9vKJSxkrv7Ewo,fbPkOYLVPtPgIt0MxizjfFJov3JbHyAi,9,16,10,0,6,12,6,0,50,7.142857142857143,3,0.0,2,10,0,6,14,12,0,6,0,18,32,1
4032,126652,pSX00XUyCx7VlmgWGN0d39OwC9BZ8bRV,fbPkOYLVPtPgIt0MxizjfFJov3JbHyAi,5,2,1,0,1,3,2,1,10,1.4285714285714286,1,0.0,0,1,0,1,2,3,0,2,1,2,8,1
4033,126653,gGWMG6Gfcgv0VgsqH5vhbRzqRTXFEicG,fbPkOYLVPtPgIt0MxizjfFJov3JbHyAi,14,5,5,0,5,1,3,0,19,2.7142857142857144,1,0.0,0,5,0,5,5,1,0,3,0,10,9,1
4034,126655,qoqukLLERBRiJBIq9ZPYNUr2ljNWoAkB,fbPkOYLVPtPgIt0MxizjfFJov3JbHyAi,1,0,0,0,0,0,1,0,1,0.14285714285714285,1,0.0,0,0,0,0,0,0,0,1,0,0,1,1
4035,126664,BX9KMh9DUbDRkGw8SYAs3wHv0hHJ990Z,fbPkOYLVPtPgIt0MxizjfFJov3JbHyAi,4,2,1,0,1,0,1,0,5,0.7142857142857143,1,0.0,0,1,0,1,2,0,0,1,0,2,3,1
4036,126666,VD3NZWF3TQVEEWjdXtLLn0PBfH2lUBVv,fbPkOYLVPtPgIt0MxizjfFJov3JbHyAi,4,2,1,0,1,0,1,0,5,0.7142857142857143,1,0.0,0,1,0,1,2,0,0,1,0,2,3,1
4037,126667,CRnzue1RDSVRfMQMEjwDVoUKh1AdXpZz,fbPkOYLVPtPgIt0MxizjfFJov3JbHyAi,10,7,5,0,4,1,8,0,25,3.5714285714285716,2,0.0,0,5,0,4,7,1,0,8,0,9,16,1
4038,126671,XirdNKPxR3QK6AqsS5xwiQuah55CHklz,fbPkOYLVPtPgIt0MxizjfFJov3JbHyAi,5,3,2,0,1,0,1,0,7,1.0,1,0.0,0,2,0,1,3,0,0,1,0,3,4,1
4039,126677,cjIjalOkynRvNiMkIirdnL3eRD5dBGGC,fbPkOYLVPtPgIt0MxizjfFJov3JbHyAi,17,23,9,18,6,0,7,0,63,9.0,1,0.0,10,9,13,6,13,0,5,7,0,38,25,1
4040,126678,txSjWYX3TEWx5QLOiaADcbFdCZMHt7yE,fbPkOYLVPtPgIt0MxizjfFJov3JbHyAi,1,0,0,0,0,0,1,0,1,0.14285714285714285,1,0.0,0,0,0,0,0,0,0,1,0,0,1,1
4041,126679,GQHwUvP1dMnkB7BOvyel6l6pMIROCScP,fbPkOYLVPtPgIt0MxizjfFJov3JbHyAi,9,5,3,0,3,1,7,1,20,2.857142857142857,1,0.0,1,3,0,3,4,1,0,7,1,7,13,1
4042,126680,xnRmrsH4zMsCSnzjnexftwj0rbTRSH4o,fbPkOYLVPtPgIt0MxizjfFJov3JbHyAi,2,0,0,0,0,0,5,0,5,0.7142857142857143,1,0.0,0,0,0,0,0,0,0,5,0,0,5,1
4043,126681,Ed4keAaeu2f9Adr8MAUlkgc9PEPDZ5XH,fbPkOYLVPtPgIt0MxizjfFJov3JbHyAi,10,7,3,0,4,4,5,0,23,3.2857142857142856,1,0.0,3,3,0,4,4,4,0,5,0,10,13,1
4044,126683,1aQRKQfEUKBCXZxsytzFHSfkOMz94sSd,fbPkOYLVPtPgIt0MxizjfFJov3JbHyAi,5,2,1,0,1,0,3,0,7,1.0,1,0.0,0,1,0,1,2,0,0,3,0,2,5,1
4045,126685,kv9R1giIEQZwW9B0426lejYI0Lidtzlp,fbPkOYLVPtPgIt0MxizjfFJov3JbHyAi,1,0,0,0,0,0,1,0,1,0.14285714285714285,1,0.0,0,0,0,0,0,0,0,1,0,0,1,1
4046,126688,Ot1qGo61IYwNj80zMpFrqao7vUDTpF4u,fbPkOYLVPtPgIt0MxizjfFJov3JbHyAi,11,9,5,0,3,7,5,1,30,4.285714285714286,1,0.0,0,5,0,3,9,7,0,5,1,8,22,1
4047,126689,JYjqQWzRkQGlz0fASDON6Nnhdq6VSXiT,fbPkOYLVPtPgIt0MxizjfFJov3JbHyAi,1,0,0,0,0,0,1,0,1,0.14285714285714285,1,0.0,0,0,0,0,0,0,0,1,0,0,1,0
4048,126691,PUmV9uRuFVROTlnbrxJwOENyVx54i3f7,fbPkOYLVPtPgIt0MxizjfFJov3JbHyAi,4,2,1,0,1,0,1,0,5,0.7142857142857143,1,0.0,0,1,0,1,2,0,0,1,0,2,3,1
4049,126692,Sfke50zBDjAoEapgUNGacTteD024syFJ,fbPkOYLVPtPgIt0MxizjfFJov3JbHyAi,4,2,0,0,0,0,7,0,9,1.2857142857142858,1,0.0,0,0,0,0,2,0,0,7,0,0,9,1
4050,126697,ER1xz0N5sLgbnEZoIss9jV4E4vyRYggy,fbPkOYLVPtPgIt0MxizjfFJov3JbHyAi,11,25,9,0,7,18,4,0,63,9.0,2,0.0,2,9,0,7,23,18,0,4,0,18,45,1
4051,126699,AGXZupnvuozaRzZmgdrKKyAy6oGdUdjZ,fbPkOYLVPtPgIt0MxizjfFJov3JbHyAi,6,5,1,0,1,0,4,0,11,1.5714285714285714,1,0.0,2,1,0,1,3,0,0,4,0,4,7,1
4052,126701,ZflTj2bpwRqbD9BtY63IMMYDj3wgOSNe,fbPkOYLVPtPgIt0MxizjfFJov3JbHyAi,7,6,2,0,2,6,11,0,27,3.857142857142857,2,0.0,0,2,0,2,6,6,0,11,0,4,23,1
4053,126703,6HmdNYWkOfKPcsSkwkqnh7uY2Gqe1cX7,fbPkOYLVPtPgIt0MxizjfFJov3JbHyAi,5,7,4,0,2,3,2,0,18,2.5714285714285716,2,0.0,0,4,0,2,7,3,0,2,0,6,12,0
4054,126705,gVGEUb9jfMmddRlcGqXsnz4ZV26w6q4e,fbPkOYLVPtPgIt0MxizjfFJov3JbHyAi,1,0,0,0,0,0,1,0,1,0.14285714285714285,1,0.0,0,0,0,0,0,0,0,1,0,0,1,1
4055,126708,1i94xoT1OVM1lTP3R294JlD5odSrEcP5,fbPkOYLVPtPgIt0MxizjfFJov3JbHyAi,17,16,9,0,8,0,2,0,35,5.0,2,0.0,2,9,0,8,14,0,0,2,0,19,16,1
4056,126712,0Au7FrQGJI1dB5PAH0C5RtkL9GE7xsrQ,fbPkOYLVPtPgIt0MxizjfFJov3JbHyAi,17,10,9,0,9,0,2,0,30,4.285714285714286,1,0.0,0,9,0,9,10,0,0,2,0,18,12,1
4057,126715,Z7UOgoOv3zZwU9zvjSxLYTFWLOhyMpWi,fbPkOYLVPtPgIt0MxizjfFJov3JbHyAi,8,17,10,0,5,0,9,0,41,5.857142857142857,1,0.0,3,10,0,5,14,0,0,9,0,18,23,1
4058,126742,B1Gq6e77yv7kkDqJ7SH2TygdPDzPBwQh,fbPkOYLVPtPgIt0MxizjfFJov3JbHyAi,27,39,22,19,13,6,15,2,116,16.571428571428573,2,0.0,12,22,14,13,27,6,5,15,2,61,55,1
4059,126748,NDe8spAMYp0FsctHBGO44DCP0jh5ivtW,fbPkOYLVPtPgIt0MxizjfFJov3JbHyAi,5,3,1,0,1,15,1,0,21,3.0,1,0.0,0,1,0,1,3,15,0,1,0,2,19,1
4060,126750,bpsYUsj9C1SHgZpkPYxDXsRDOrg2cbuw,fbPkOYLVPtPgIt0MxizjfFJov3JbHyAi,8,9,5,0,3,2,4,0,23,3.2857142857142856,1,0.0,1,5,0,3,8,2,0,4,0,9,14,1
4061,126782,TbkRfFxVYcq9Rq8GnS46iBuAWkShuGej,fbPkOYLVPtPgIt0MxizjfFJov3JbHyAi,6,3,1,0,0,1,4,0,9,1.2857142857142858,2,0.0,0,1,0,0,3,1,0,4,0,1,8,0
4062,130073,IGWRz8xQdPwjKqBNKTjONoXgcj0XdulM,7GRhBDsirIGkRZBtSMEzNTyDr2JQm4xx,27,54,2,70,4,6,27,1,164,23.428571428571427,6,0.0,30,2,61,4,24,6,9,27,1,97,67,0
4063,134914,yNC8T7gdWO96Y2q3tzTQeJUMY0F51xnO,SpATywNh6bZuzm8s1ceuBUnMUAeoAHHw,11,15,9,2,5,0,6,0,37,5.285714285714286,2,0.0,2,9,2,5,13,0,0,6,0,18,19,0
4064,134957,oaNAVS5nMmZPkgC88QZyCkxZpo6GIFQk,G8EPVSXsOYB5YQWZGiz1aVq5Pgr2GrQu,3,2,0,0,0,0,1,0,3,0.42857142857142855,1,0.0,0,0,0,0,2,0,0,1,0,0,3,1
4065,135069,bgBLWArC7sr7mZdIi75AaJrBI0yN4gRx,SpATywNh6bZuzm8s1ceuBUnMUAeoAHHw,15,36,5,14,4,15,37,4,115,16.428571428571427,4,0.0,12,5,13,4,24,15,1,37,4,34,81,0
4066,135165,72z519PMt8GGBXLvF1FG0oMJuciCSWYJ,G8EPVSXsOYB5YQWZGiz1aVq5Pgr2GrQu,7,7,3,0,1,0,8,0,19,2.7142857142857144,4,0.0,0,3,0,1,7,0,0,8,0,4,15,1
4067,135236,8JTz84ZDdJm6tvsd7hgyCl1RB6wU6r2e,bWdj2GDclj5ofokWjzoa5jAwMkxCykd6,10,8,4,2,3,5,5,1,28,4.0,1,0.0,2,4,2,3,6,5,0,5,1,11,17,0
4068,135274,FJJqBn1iTJmAbav7Ov5Y4ycyF65fvY1E,SpATywNh6bZuzm8s1ceuBUnMUAeoAHHw,6,2,1,0,1,2,5,2,13,1.8571428571428572,1,0.0,0,1,0,1,2,2,0,5,2,2,11,0
4069,135289,eXv6ACzt62C4hMSoDSIQMvmz4LEnGBtm,A3fsA9Zfv1X2fVEQhTw51lKENdNrEqT3,12,5,4,0,3,0,5,0,17,2.4285714285714284,1,0.0,0,4,0,3,5,0,0,5,0,7,10,1
4070,135321,x6BtQH70uuLHaxqzHA21U9wmfT0SxzD9,G8EPVSXsOYB5YQWZGiz1aVq5Pgr2GrQu,3,0,0,0,0,0,5,0,5,0.7142857142857143,1,0.0,0,0,0,0,0,0,0,5,0,0,5,1
4071,135405,1R1zO9aMB7Mx1Lw84JzsChVEV5JpwmZv,bWdj2GDclj5ofokWjzoa5jAwMkxCykd6,5,12,3,0,3,0,4,0,22,3.142857142857143,4,0.0,4,3,0,3,8,0,0,4,0,10,12,1
4072,135559,LPkDtPFF5RxOnDnsqEeKxwZe2JS0rusW,SpATywNh6bZuzm8s1ceuBUnMUAeoAHHw,6,7,3,0,2,0,1,0,13,1.8571428571428572,1,0.0,0,3,0,2,7,0,0,1,0,5,8,1
4073,135578,WAeA3Wxi4ox0P2eDgiY2JLtPyMIFhfp0,bWdj2GDclj5ofokWjzoa5jAwMkxCykd6,13,12,6,0,6,2,9,1,36,5.142857142857143,1,0.0,2,6,0,6,10,2,0,9,1,14,22,1
4074,135593,rFiKT35F4vi8a7NpfY1bEgz4HT50lSZd,SpATywNh6bZuzm8s1ceuBUnMUAeoAHHw,6,6,1,0,1,0,3,0,11,1.5714285714285714,2,0.0,0,1,0,1,6,0,0,3,0,2,9,1
4075,135594,gikp9GqTKNuof6stdLjZVJv1OHEXFMyZ,G8EPVSXsOYB5YQWZGiz1aVq5Pgr2GrQu,24,24,11,48,0,0,2,0,85,12.142857142857142,2,0.0,11,11,35,0,13,0,13,2,0,57,28,0
4076,135636,Or5tbal17XyYWYBFOcz5Axiks4gsj2rC,SpATywNh6bZuzm8s1ceuBUnMUAeoAHHw,1,0,0,0,0,0,1,0,1,0.14285714285714285,1,0.0,0,0,0,0,0,0,0,1,0,0,1,1
4077,135644,9w2MJQeZHeyFkqwhaftUSXLuvPN6lDkw,SpATywNh6bZuzm8s1ceuBUnMUAeoAHHw,9,13,4,0,3,0,1,0,21,3.0,1,0.0,8,4,0,3,5,0,0,1,0,15,6,1
4078,135674,zILXfIGJjWXm6dA2MrEQWr2XeEUry8lN,A3fsA9Zfv1X2fVEQhTw51lKENdNrEqT3,11,9,6,0,3,0,7,0,25,3.5714285714285716,2,0.0,0,6,0,3,9,0,0,7,0,9,16,1
4079,135721,pvAe37z1FjLTGYdwlJFjXex25zlpyHtu,G8EPVSXsOYB5YQWZGiz1aVq5Pgr2GrQu,5,2,1,0,1,0,3,0,7,1.0,1,0.0,0,1,0,1,2,0,0,3,0,2,5,1
4080,135766,lOkl9iaUDyjk0zbwJLRgFqBRBNNBSRwr,SpATywNh6bZuzm8s1ceuBUnMUAeoAHHw,17,40,9,18,3,18,14,2,104,14.857142857142858,5,0.0,11,9,15,3,29,18,3,14,2,38,66,0
4081,135854,up6Dm3KbNQ1ouTMs5v0fwblubVxwKJMi,7GRhBDsirIGkRZBtSMEzNTyDr2JQm4xx,16,9,9,0,9,0,6,0,33,4.714285714285714,2,0.0,0,9,0,9,9,0,0,6,0,18,15,1
4082,135858,mTOoYxpCIgV1V8PFGNgwuxdFg8JU7kb9,7GRhBDsirIGkRZBtSMEzNTyDr2JQm4xx,12,3,2,0,2,1,7,1,16,2.2857142857142856,1,0.0,0,2,0,2,3,1,0,7,1,4,12,1
4083,136038,P38VxMH253jjoDZHRNefTKyEAydphpb2,SpATywNh6bZuzm8s1ceuBUnMUAeoAHHw,17,26,10,22,5,15,14,3,95,13.571428571428571,2,0.0,10,10,18,5,16,15,4,14,3,43,52,1
4084,136064,o3T0K8ec78cQHSHsSLzMA1PbvYi8mwTI,7GRhBDsirIGkRZBtSMEzNTyDr2JQm4xx,16,44,10,30,0,31,13,2,130,18.571428571428573,3,0.0,20,10,26,0,24,31,4,13,2,56,74,1
4085,136096,msM56OM0TrhCVyicpbYafJdknfubqkzk,7GRhBDsirIGkRZBtSMEzNTyDr2JQm4xx,8,9,2,6,2,1,3,1,24,3.4285714285714284,1,0.0,3,2,5,2,6,1,1,3,1,12,12,1
4086,136098,YQZ85qW2KiDmX9GD2Tq3oRYH6ucmQmKe,7GRhBDsirIGkRZBtSMEzNTyDr2JQm4xx,16,42,0,22,4,1,2,0,71,10.142857142857142,1,0.0,24,0,19,4,18,1,3,2,0,47,24,1
4087,136149,St6usTSSgX5U9v7wchuMWqmBKoCcDwN2,SpATywNh6bZuzm8s1ceuBUnMUAeoAHHw,5,2,1,0,1,0,2,0,6,0.8571428571428571,1,0.0,0,1,0,1,2,0,0,2,0,2,4,0
4088,136209,oGK3c8nk6Ftl3V2u1zOvslszD4LDLr3w,G8EPVSXsOYB5YQWZGiz1aVq5Pgr2GrQu,4,2,1,0,1,0,1,0,5,0.7142857142857143,1,0.0,0,1,0,1,2,0,0,1,0,2,3,1
4089,136230,FZEwaAUaiR6zemazrUHMMvDLCgHez3sb,SpATywNh6bZuzm8s1ceuBUnMUAeoAHHw,12,24,11,19,1,21,10,1,87,12.428571428571429,2,0.0,6,11,16,1,18,21,3,10,1,34,53,1
4090,136247,8FGs2DlahZoB3KBpV3eIicZF3v5DtTbf,SpATywNh6bZuzm8s1ceuBUnMUAeoAHHw,16,10,7,5,3,2,9,1,37,5.285714285714286,2,0.0,2,7,5,3,8,2,0,9,1,17,20,0
4091,136265,7fwVXF5ctPhb8pPmrNYDi2ycSDGABklq,SpATywNh6bZuzm8s1ceuBUnMUAeoAHHw,5,5,0,0,0,0,1,0,6,0.8571428571428571,1,0.0,0,0,0,0,5,0,0,1,0,0,6,1
4092,136312,DysXuoUoTtoCjfxHxEQdZhXHC6tNfwru,7GRhBDsirIGkRZBtSMEzNTyDr2JQm4xx,28,26,12,35,13,0,10,0,96,13.714285714285714,3,0.0,14,12,28,13,12,0,7,10,0,67,29,1
4093,136327,xFOMKgrHGqKyL5uPk9RcNRWczzZxvoeN,7GRhBDsirIGkRZBtSMEzNTyDr2JQm4xx,1,0,0,0,0,0,1,0,1,0.14285714285714285,1,0.0,0,0,0,0,0,0,0,1,0,0,1,1
4094,136398,gtKTzkXHwS41ljYVmjlLLf4WyQSkK02q,7GRhBDsirIGkRZBtSMEzNTyDr2JQm4xx,23,35,9,64,0,0,3,0,111,15.857142857142858,1,0.0,23,9,54,0,12,0,10,3,0,86,25,1
4095,136413,SAZKFz2NUOxVKdkBgcAx84BjxoboQOlS,SpATywNh6bZuzm8s1ceuBUnMUAeoAHHw,7,6,1,0,1,0,4,0,12,1.7142857142857142,1,0.0,0,1,0,1,6,0,0,4,0,2,10,0
4096,136445,qtck8S6SMYpkxbIZosuQoFSB26vuEbBy,7GRhBDsirIGkRZBtSMEzNTyDr2JQm4xx,2,0,0,0,0,0,2,0,2,0.2857142857142857,1,0.0,0,0,0,0,0,0,0,2,0,0,2,1
4097,136468,YVboeUnAYRezL6JF0VMVpiapYahgjIwn,SpATywNh6bZuzm8s1ceuBUnMUAeoAHHw,17,34,12,21,5,22,15,2,111,15.857142857142858,3,0.0,11,12,18,5,23,22,3,15,2,46,65,0
4098,136500,AAAvWauitKfXD0xRpNsfpOKQu223kCXG,bWdj2GDclj5ofokWjzoa5jAwMkxCykd6,6,3,2,0,2,0,2,0,9,1.2857142857142858,1,0.0,0,2,0,2,3,0,0,2,0,4,5,1
4099,136540,hZR4MwcYec4g0GoOyJFngJGEyWOySpv2,7GRhBDsirIGkRZBtSMEzNTyDr2JQm4xx,6,2,1,0,0,13,6,1,23,3.2857142857142856,2,0.0,0,1,0,0,2,13,0,6,1,1,22,0
4100,136564,JHhY30IKFzw4LWcyrHuTEglWNqRkqdDU,SpATywNh6bZuzm8s1ceuBUnMUAeoAHHw,8,3,1,10,0,0,4,0,18,2.5714285714285716,1,0.0,2,1,10,0,1,0,0,4,0,13,5,1
4101,136592,JHhY30IKFzw4LWcyrHuTEglWNqRkqdDU,RXDvfPUBYFlVdlueBFbLW0mhhAyGEqpt,38,16,8,114,3,1,6,0,148,21.142857142857142,1,0.0,7,8,103,3,9,1,11,6,0,121,27,1
4102,136596,YqY5WPa8kwIoLBKGaVnXfSZOMvkSrEdU,SpATywNh6bZuzm8s1ceuBUnMUAeoAHHw,15,16,9,8,5,13,3,0,54,7.714285714285714,2,0.0,5,9,8,5,11,13,0,3,0,27,27,0
4103,136602,YqY5WPa8kwIoLBKGaVnXfSZOMvkSrEdU,A3fsA9Zfv1X2fVEQhTw51lKENdNrEqT3,7,5,3,0,1,0,3,0,12,1.7142857142857142,2,0.0,0,3,0,1,5,0,0,3,0,4,8,1
4104,136635,jedE3nTKdlUnNjeeZxONdSIgUVRjrOri,7GRhBDsirIGkRZBtSMEzNTyDr2JQm4xx,8,4,2,4,2,2,2,0,16,2.2857142857142856,2,0.0,1,2,3,2,3,2,1,2,0,8,8,1
4105,136652,qU5mfkjhD9M0R49RmBMaCeXLeTqIOyhm,7GRhBDsirIGkRZBtSMEzNTyDr2JQm4xx,4,4,0,0,0,0,1,0,5,0.7142857142857143,1,0.0,0,0,0,0,4,0,0,1,0,0,5,1
4106,136673,St6usTSSgX5U9v7wchuMWqmBKoCcDwN2,A3fsA9Zfv1X2fVEQhTw51lKENdNrEqT3,5,3,0,0,0,3,3,0,9,1.2857142857142858,2,0.0,0,0,0,0,3,3,0,3,0,0,9,1
4107,136743,PV4ahNYgW8Lcd9nNe0xrpkqG7Ws3zMb1,SpATywNh6bZuzm8s1ceuBUnMUAeoAHHw,17,25,15,12,6,18,43,6,125,17.857142857142858,2,0.0,4,15,11,6,21,18,1,43,6,36,89,0
4108,136752,YUPaOsEEFOH7xpyMBcCkViDpUqkz1A5I,7GRhBDsirIGkRZBtSMEzNTyDr2JQm4xx,1,0,0,0,0,0,1,0,1,0.14285714285714285,1,0.0,0,0,0,0,0,0,0,1,0,0,1,1
4109,136785,nsbeAj5BI7VK72NYmPa0cGgkMq0PU2h6,SpATywNh6bZuzm8s1ceuBUnMUAeoAHHw,7,6,3,0,3,0,1,0,13,1.8571428571428572,2,0.0,0,3,0,3,6,0,0,1,0,6,7,0
4110,136797,uXoi7oqvj5HXbvnVGMMeQOqZvw3BW3QM,G8EPVSXsOYB5YQWZGiz1aVq5Pgr2GrQu,21,40,0,20,2,3,7,3,75,10.714285714285714,1,0.0,32,0,10,2,8,3,10,7,3,44,31,0
4111,136860,5NKHIcFKbvZvjnI6x0vdD0R4rE65640c,SpATywNh6bZuzm8s1ceuBUnMUAeoAHHw,16,27,2,26,1,4,23,2,85,12.142857142857142,3,0.0,10,2,21,1,17,4,5,23,2,34,51,0
4112,136874,P6rNkkuxGZS8wdNcuNCJoPQNsegCUIqx,7GRhBDsirIGkRZBtSMEzNTyDr2JQm4xx,2,0,0,0,0,0,2,0,2,0.2857142857142857,1,0.0,0,0,0,0,0,0,0,2,0,0,2,1
4113,136897,xNcMMIyB0y99dNaEOIqDnvCMrU2SAEOP,G8EPVSXsOYB5YQWZGiz1aVq5Pgr2GrQu,8,3,2,0,1,1,6,1,14,2.0,2,0.0,0,2,0,1,3,1,0,6,1,3,11,0
4114,136920,HjlZu5CgYZQVUJqRZv1KCIOR0lFMSkiS,7GRhBDsirIGkRZBtSMEzNTyDr2JQm4xx,10,9,0,10,0,0,7,0,26,3.7142857142857144,2,0.0,2,0,8,0,7,0,2,7,0,10,16,1
4115,136942,BJcIgaOnWdAOKf7jzUg9DKOlERmjwn2s,7GRhBDsirIGkRZBtSMEzNTyDr2JQm4xx,1,0,0,0,0,0,2,0,2,0.2857142857142857,1,0.0,0,0,0,0,0,0,0,2,0,0,2,1
4116,137016,00bDiL0A6W9npxn52kzhmAfK2Yag1Gik,bWdj2GDclj5ofokWjzoa5jAwMkxCykd6,9,6,3,0,0,19,7,1,36,5.142857142857143,1,0.0,2,3,0,0,4,19,0,7,1,5,31,0
4117,137077,xIsNJgqYQ4WcvbQ1A0Us7q1c1NYtR1tF,bWdj2GDclj5ofokWjzoa5jAwMkxCykd6,5,2,0,0,1,0,2,0,5,0.7142857142857143,1,0.0,0,0,0,1,2,0,0,2,0,1,4,0
4118,137214,nmlYjXdaqWSjPWm2kQhmjZqjjBKhkQAm,A3fsA9Zfv1X2fVEQhTw51lKENdNrEqT3,2,0,0,0,0,0,2,0,2,0.2857142857142857,1,0.0,0,0,0,0,0,0,0,2,0,0,2,1
4119,137290,RmlLLXW8yVeVv6IlxP4h82on7YcnLjlC,fbPkOYLVPtPgIt0MxizjfFJov3JbHyAi,5,2,0,0,0,0,19,1,22,3.142857142857143,1,0.0,0,0,0,0,2,0,0,19,1,0,22,1
4120,137292,1nw5LJsxTSlYBcpPAO0FPean8WSWknnT,fbPkOYLVPtPgIt0MxizjfFJov3JbHyAi,5,2,0,0,0,4,6,0,12,1.7142857142857142,1,0.0,0,0,0,0,2,4,0,6,0,0,12,1
4121,137296,bJ8AAxZ3JuvigCWd3VGvoJ2Ns2zJszXZ,fbPkOYLVPtPgIt0MxizjfFJov3JbHyAi,10,28,14,1,9,0,3,0,55,7.857142857142857,2,0.0,10,14,1,9,18,0,0,3,0,34,21,1
4122,137299,fQ2qYe5HNta8P0G8uXdGrvFPejbwucPN,fbPkOYLVPtPgIt0MxizjfFJov3JbHyAi,18,25,11,0,7,14,9,0,66,9.428571428571429,1,0.0,0,11,0,7,25,14,0,9,0,18,48,1
4123,137300,O5osNpvARQ134oncM7N5QGhst9sMjRtB,fbPkOYLVPtPgIt0MxizjfFJov3JbHyAi,4,2,1,0,1,7,1,0,12,1.7142857142857142,1,0.0,0,1,0,1,2,7,0,1,0,2,10,1
4124,137301,h774wdF6vIIcl50Js74gckwUtlv9SBGH,fbPkOYLVPtPgIt0MxizjfFJov3JbHyAi,21,55,26,5,17,8,8,0,119,17.0,3,0.0,11,26,4,17,44,8,1,8,0,58,61,1
4125,137304,fV9PFchRO9NFkeyKqjI60ieBb4YfIgSO,fbPkOYLVPtPgIt0MxizjfFJov3JbHyAi,4,3,0,0,0,16,4,0,23,3.2857142857142856,1,0.0,0,0,0,0,3,16,0,4,0,0,23,1
4126,137306,CTPK2LGRvMaPvlFasZdjTmXOqyM1Lmi8,fbPkOYLVPtPgIt0MxizjfFJov3JbHyAi,23,25,14,14,15,7,3,0,78,11.142857142857142,1,0.0,10,14,13,15,15,7,1,3,0,52,26,1
4127,137308,UAggpZPNL1hZ0kLwEDSUplsT3ghk1d6y,fbPkOYLVPtPgIt0MxizjfFJov3JbHyAi,5,2,1,0,1,0,2,0,6,0.8571428571428571,1,0.0,0,1,0,1,2,0,0,2,0,2,4,1
4128,137309,gL1o6jsIwD6Ip8uBaHnoUMfUbsYcrCmr,fbPkOYLVPtPgIt0MxizjfFJov3JbHyAi,7,3,2,0,2,3,3,1,14,2.0,1,0.0,0,2,0,2,3,3,0,3,1,4,10,1
4129,137313,n1ESpvyobZkFsfrWJhKOuY4URaa1sUc5,fbPkOYLVPtPgIt0MxizjfFJov3JbHyAi,5,2,1,0,1,0,4,0,8,1.1428571428571428,1,0.0,0,1,0,1,2,0,0,4,0,2,6,1
4130,137315,f0jKRSnLVIejbfFzT0M2iiXUyVwMVp4e,fbPkOYLVPtPgIt0MxizjfFJov3JbHyAi,5,3,2,0,2,0,2,0,9,1.2857142857142858,1,0.0,0,2,0,2,3,0,0,2,0,4,5,1
4131,137319,glXXkvEu5VWOG069hJZn4a1ogKzxsZqy,fbPkOYLVPtPgIt0MxizjfFJov3JbHyAi,2,0,0,0,0,0,6,0,6,0.8571428571428571,1,0.0,0,0,0,0,0,0,0,6,0,0,6,1
4132,137321,owHNspB8DrsecsPRNmUB7UBdqXOlW955,fbPkOYLVPtPgIt0MxizjfFJov3JbHyAi,7,8,3,0,2,0,1,0,14,2.0,1,0.0,0,3,0,2,8,0,0,1,0,5,9,1
4133,137323,iTjfGmkhI7qYgG8rBAfSzNVyjUvKbeUV,fbPkOYLVPtPgIt0MxizjfFJov3JbHyAi,4,2,1,0,1,0,1,0,5,0.7142857142857143,1,0.0,0,1,0,1,2,0,0,1,0,2,3,1
4134,137324,nyH7Jx4kN1AdDJdwkZQoUDqYoovHgbk5,fbPkOYLVPtPgIt0MxizjfFJov3JbHyAi,8,8,5,0,4,10,4,0,31,4.428571428571429,2,0.0,0,5,0,4,8,10,0,4,0,9,22,0
4135,137325,8WSLblwPqv9lrYeGgJiG7aFvD2e5FjPW,fbPkOYLVPtPgIt0MxizjfFJov3JbHyAi,2,0,0,0,0,0,2,0,2,0.2857142857142857,1,0.0,0,0,0,0,0,0,0,2,0,0,2,1
4136,137326,3cVj7hdkALbjY726IM3M6Ud07m4las2t,fbPkOYLVPtPgIt0MxizjfFJov3JbHyAi,9,3,2,0,2,4,6,1,18,2.5714285714285716,1,0.0,0,2,0,2,3,4,0,6,1,4,14,1
4137,137329,LnsTOCnKQwSd834VWj8Se5P6LDNk8RHo,fbPkOYLVPtPgIt0MxizjfFJov3JbHyAi,5,7,0,0,0,0,1,0,8,1.1428571428571428,1,0.0,0,0,0,0,7,0,0,1,0,0,8,1
4138,137331,5fdjSFb0UnHfjLD83iptHyG30XcBntML,fbPkOYLVPtPgIt0MxizjfFJov3JbHyAi,8,6,2,0,3,0,3,0,14,2.0,1,0.0,2,2,0,3,4,0,0,3,0,7,7,1
4139,137332,V5n4KmrCt6qTaNCHvn8AZsixldOhtrqM,fbPkOYLVPtPgIt0MxizjfFJov3JbHyAi,8,5,3,0,2,5,4,0,19,2.7142857142857144,2,0.0,0,3,0,2,5,5,0,4,0,5,14,1
4140,137335,b2ohpFiEgZaZsBBPqUMnfjpywCAbNR88,fbPkOYLVPtPgIt0MxizjfFJov3JbHyAi,10,11,4,0,4,0,2,0,21,3.0,1,0.0,0,4,0,4,11,0,0,2,0,8,13,1
4141,137336,D35Hr8NmMeH1abGin8hsVg1eeYI1rkMx,fbPkOYLVPtPgIt0MxizjfFJov3JbHyAi,19,15,11,0,9,0,5,2,42,6.0,1,0.0,0,11,0,9,15,0,0,5,2,20,22,1
4142,137339,Q4RfMohp0VyMzzF8aoHnH7xFgkQEGrSz,fbPkOYLVPtPgIt0MxizjfFJov3JbHyAi,5,2,1,0,1,0,3,0,7,1.0,1,0.0,0,1,0,1,2,0,0,3,0,2,5,1
4143,137340,7RIgMHzHpMzY7qBXHPj6WiDKK3U9H2Wz,fbPkOYLVPtPgIt0MxizjfFJov3JbHyAi,7,8,5,0,3,2,4,0,22,3.142857142857143,2,0.0,0,5,0,3,8,2,0,4,0,8,14,1
4144,137341,EVRzOGDcK6HIoRC4TyM175kAEkfMvm8k,fbPkOYLVPtPgIt0MxizjfFJov3JbHyAi,6,5,2,0,3,0,3,0,13,1.8571428571428572,1,0.0,2,2,0,3,3,0,0,3,0,7,6,1
4145,137342,G3uUdYmcbUGjsucepMY504O6KIKoDegj,fbPkOYLVPtPgIt0MxizjfFJov3JbHyAi,2,0,0,0,0,0,7,0,7,1.0,1,0.0,0,0,0,0,0,0,0,7,0,0,7,1
4146,137343,cquObqcJUxOFEWJ4OzhgFktpn4MuuvGh,fbPkOYLVPtPgIt0MxizjfFJov3JbHyAi,2,0,0,0,0,0,2,0,2,0.2857142857142857,1,0.0,0,0,0,0,0,0,0,2,0,0,2,1
4147,137345,MCZHS6CBpJ75tmAXNSc4ArD5vu4UQMmf,fbPkOYLVPtPgIt0MxizjfFJov3JbHyAi,2,0,0,0,0,0,6,0,6,0.8571428571428571,1,0.0,0,0,0,0,0,0,0,6,0,0,6,1
4148,137348,T5moiKfoqYwkBJrrQj3QEFYZxN8QkHfc,fbPkOYLVPtPgIt0MxizjfFJov3JbHyAi,8,5,2,0,1,9,6,1,24,3.4285714285714284,1,0.0,0,2,0,1,5,9,0,6,1,3,21,1
4149,137353,0yZD4fjReiCp5h9L5wxeZCsj4C8snJgU,fbPkOYLVPtPgIt0MxizjfFJov3JbHyAi,2,0,0,0,0,0,3,0,3,0.42857142857142855,1,0.0,0,0,0,0,0,0,0,3,0,0,3,1
4150,137355,UaIcSFKSsXMkLJoEB18mPucIS2F5HMZt,fbPkOYLVPtPgIt0MxizjfFJov3JbHyAi,4,2,1,0,0,0,2,0,5,0.7142857142857143,1,0.0,0,1,0,0,2,0,0,2,0,1,4,1
4151,137357,Dxumuu0iESds4rdkin6IFLqksHFKYmBa,fbPkOYLVPtPgIt0MxizjfFJov3JbHyAi,2,0,0,0,0,0,3,0,3,0.42857142857142855,1,0.0,0,0,0,0,0,0,0,3,0,0,3,1
4152,137358,htmCxkgAOIvbjO4xq8D0LMRC4XX4uXb4,fbPkOYLVPtPgIt0MxizjfFJov3JbHyAi,7,3,2,0,2,0,3,0,10,1.4285714285714286,1,0.0,0,2,0,2,3,0,0,3,0,4,6,1
4153,137361,c3Q7zBkcz9A9C9axYIiO1QysEG1V4UAO,fbPkOYLVPtPgIt0MxizjfFJov3JbHyAi,9,5,4,0,3,0,5,0,17,2.4285714285714284,1,0.0,0,4,0,3,5,0,0,5,0,7,10,1
4154,137370,qNDvS5AGNuAWPmsY8v3e0mmJNktcZlln,fbPkOYLVPtPgIt0MxizjfFJov3JbHyAi,7,8,2,0,2,0,7,0,19,2.7142857142857144,1,0.0,4,2,0,2,4,0,0,7,0,8,11,1
4155,137372,lOBLdw8F0Df8BSa1UipMpaST2r1WwJcV,fbPkOYLVPtPgIt0MxizjfFJov3JbHyAi,9,4,3,0,3,6,6,1,23,3.2857142857142856,1,0.0,0,3,0,3,4,6,0,6,1,6,17,1
4156,137373,sndae06qc0KQXBA5AxxztXDWy4HQwsmF,fbPkOYLVPtPgIt0MxizjfFJov3JbHyAi,10,15,6,10,7,0,5,0,43,6.142857142857143,1,0.0,6,6,6,7,9,0,4,5,0,25,18,1
4157,137375,CKl647uBpzhaV8Bs4OjoA2KfJg2713it,fbPkOYLVPtPgIt0MxizjfFJov3JbHyAi,9,11,4,4,5,0,3,0,27,3.857142857142857,1,0.0,6,4,3,5,5,0,1,3,0,18,9,1
4158,137377,Ep4Q95tKnG1eQgBqFXbKyAx3i4zRNHfc,fbPkOYLVPtPgIt0MxizjfFJov3JbHyAi,1,0,0,0,0,0,1,0,1,0.14285714285714285,1,0.0,0,0,0,0,0,0,0,1,0,0,1,1
4159,137379,QuG2234wZAOXxXJpYa4PWsH3trXo84qK,fbPkOYLVPtPgIt0MxizjfFJov3JbHyAi,8,4,3,0,3,0,1,0,11,1.5714285714285714,1,0.0,0,3,0,3,4,0,0,1,0,6,5,1
4160,137383,yukNWaYJAZyHIfSpFgr2lENAGZdY7HBJ,fbPkOYLVPtPgIt0MxizjfFJov3JbHyAi,7,5,3,0,2,8,1,0,19,2.7142857142857144,1,0.0,0,3,0,2,5,8,0,1,0,5,14,1
4161,137384,EKfl5y1NkN1Xn8ASWOcqUOIlKCaC7Rgd,fbPkOYLVPtPgIt0MxizjfFJov3JbHyAi,1,0,0,0,0,0,1,0,1,0.14285714285714285,1,0.0,0,0,0,0,0,0,0,1,0,0,1,1
4162,137386,5XQirr9i0TWpiYbsECZzYQuaZyvNkBXn,fbPkOYLVPtPgIt0MxizjfFJov3JbHyAi,6,7,1,0,1,0,2,0,11,1.5714285714285714,1,0.0,0,1,0,1,7,0,0,2,0,2,9,1
4163,137388,5FX74tSsqVOdvsPJFln5AHRuURmp41HT,fbPkOYLVPtPgIt0MxizjfFJov3JbHyAi,8,6,3,0,2,0,4,0,15,2.142857142857143,2,0.0,1,3,0,2,5,0,0,4,0,6,9,0
4164,137391,m6Zwht6K5r3XL6tnCyfbnnByGD7T5f2R,fbPkOYLVPtPgIt0MxizjfFJov3JbHyAi,5,2,1,0,1,0,2,0,6,0.8571428571428571,1,0.0,0,1,0,1,2,0,0,2,0,2,4,1
4165,137397,Qv1iNPNlhVNOmWMs92FkzrrHMbJaVyPk,fbPkOYLVPtPgIt0MxizjfFJov3JbHyAi,8,4,2,0,1,1,11,1,20,2.857142857142857,1,0.0,0,2,0,1,4,1,0,11,1,3,17,1
4166,137399,mqVpGUWCMkNcDZMRD2pJxKGV8oQAE2Qj,fbPkOYLVPtPgIt0MxizjfFJov3JbHyAi,8,4,3,0,2,0,4,0,13,1.8571428571428572,1,0.0,1,3,0,2,3,0,0,4,0,6,7,1
4167,137405,yLjINTUbScao5ufShTGxxbbMK1JbRcNK,fbPkOYLVPtPgIt0MxizjfFJov3JbHyAi,7,6,2,0,3,0,3,0,14,2.0,1,0.0,2,2,0,3,4,0,0,3,0,7,7,1
4168,137406,e4YalnUrFKcUfgQELCwKNGRSXvIfj3rn,fbPkOYLVPtPgIt0MxizjfFJov3JbHyAi,2,0,0,0,0,0,3,0,3,0.42857142857142855,1,0.0,0,0,0,0,0,0,0,3,0,0,3,1
4169,137407,xeJgmT2GlcKPs7xiwWbHClhY602CtyUx,fbPkOYLVPtPgIt0MxizjfFJov3JbHyAi,5,1,1,0,1,0,2,0,5,0.7142857142857143,1,0.0,0,1,0,1,1,0,0,2,0,2,3,1
4170,137408,7ZpK2Qdkfg6qjiDNvxUiqNClV9f1rdSE,fbPkOYLVPtPgIt0MxizjfFJov3JbHyAi,8,4,3,0,3,6,3,1,20,2.857142857142857,1,0.0,0,3,0,3,4,6,0,3,1,6,14,1
4171,137410,cp3YBtv3LBPQsC9KSWwASci6TDzE2JIe,fbPkOYLVPtPgIt0MxizjfFJov3JbHyAi,1,0,0,0,0,0,1,0,1,0.14285714285714285,1,0.0,0,0,0,0,0,0,0,1,0,0,1,1
4172,137411,RDChRApYRv6Sfe9dw6iFymmd1hK0JhGY,fbPkOYLVPtPgIt0MxizjfFJov3JbHyAi,1,0,0,0,0,0,1,0,1,0.14285714285714285,1,0.0,0,0,0,0,0,0,0,1,0,0,1,1
4173,137412,qZpXWzENd8vPQkANcwupj0acfmacGtsr,fbPkOYLVPtPgIt0MxizjfFJov3JbHyAi,16,9,8,0,8,0,1,0,26,3.7142857142857144,1,0.0,0,8,0,8,9,0,0,1,0,16,10,1
4174,137414,DTvfa3fS3ROp7pjogLjRtY4RzKRlF9Cy,fbPkOYLVPtPgIt0MxizjfFJov3JbHyAi,6,8,1,0,2,0,5,0,16,2.2857142857142856,1,0.0,3,1,0,2,5,0,0,5,0,6,10,1
4175,137415,zs8AbWxu3oihhi0RdSLs1xmLXXgmhkzY,fbPkOYLVPtPgIt0MxizjfFJov3JbHyAi,18,37,0,18,5,15,6,1,82,11.714285714285714,1,0.0,25,0,16,5,12,15,2,6,1,46,36,1
4176,137417,bCFz6hqpGZgCTv9FmzDlmLq86tdtyvtb,fbPkOYLVPtPgIt0MxizjfFJov3JbHyAi,6,4,1,0,1,2,3,0,11,1.5714285714285714,1,0.0,0,1,0,1,4,2,0,3,0,2,9,1
4177,137418,y71lRBqIdu5iPiLn9Yi5PQm6GFIvgLwB,fbPkOYLVPtPgIt0MxizjfFJov3JbHyAi,5,4,2,0,1,4,2,0,13,1.8571428571428572,1,0.0,0,2,0,1,4,4,0,2,0,3,10,1
4178,137420,vuqFPhnjwQKBPhmOAdfWdPVUnftTeBnB,fbPkOYLVPtPgIt0MxizjfFJov3JbHyAi,5,2,1,0,1,0,3,0,7,1.0,1,0.0,0,1,0,1,2,0,0,3,0,2,5,1
4179,137421,3y3fLWnaqy4gjWzUuftSoOxerFuYM9Ss,fbPkOYLVPtPgIt0MxizjfFJov3JbHyAi,7,4,2,0,2,0,2,0,10,1.4285714285714286,1,0.0,0,2,0,2,4,0,0,2,0,4,6,1
4180,137427,g5cfvDvYqz1BC4LMGanzPaVPPBmwbapa,fbPkOYLVPtPgIt0MxizjfFJov3JbHyAi,18,13,10,0,11,4,5,0,43,6.142857142857143,1,0.0,2,10,0,11,11,4,0,5,0,23,20,0
4181,137429,JdJ1SwT93OWgPbpS5GdJzD3RLASaE4SR,fbPkOYLVPtPgIt0MxizjfFJov3JbHyAi,6,6,2,0,2,1,1,0,12,1.7142857142857142,1,0.0,1,2,0,2,5,1,0,1,0,5,7,1
4182,137431,c9KdNBnieysx6xfzwOvt0c21meENYGDu,fbPkOYLVPtPgIt0MxizjfFJov3JbHyAi,1,0,0,0,0,0,4,0,4,0.5714285714285714,1,0.0,0,0,0,0,0,0,0,4,0,0,4,1
4183,137434,ibNm0O3c3f87o7PAtnGdJbl2Dgr9gb8M,fbPkOYLVPtPgIt0MxizjfFJov3JbHyAi,13,9,4,0,4,1,7,1,26,3.7142857142857144,1,0.0,0,4,0,4,9,1,0,7,1,8,18,1
4184,137438,fE8AsLCA0TCwN2lFIpEAgt949Oz2zi2M,fbPkOYLVPtPgIt0MxizjfFJov3JbHyAi,5,6,1,0,1,0,2,0,10,1.4285714285714286,1,0.0,4,1,0,1,2,0,0,2,0,6,4,1
4185,137440,zHooznrj1lbipo0SwGxaARgac1BP3h4H,fbPkOYLVPtPgIt0MxizjfFJov3JbHyAi,18,38,13,27,7,0,10,0,95,13.571428571428571,2,0.0,11,13,22,7,27,0,5,10,0,53,42,1
4186,137443,HHjw6PARN0UbkiffbOwvG4RULtVIyY0R,fbPkOYLVPtPgIt0MxizjfFJov3JbHyAi,9,7,5,0,4,14,3,0,33,4.714285714285714,1,0.0,0,5,0,4,7,14,0,3,0,9,24,1
4187,137446,qqhQVv0ytFz6QcrUJzKAl8hETJ9ZzkHe,fbPkOYLVPtPgIt0MxizjfFJov3JbHyAi,6,3,2,0,2,0,1,0,8,1.1428571428571428,1,0.0,0,2,0,2,3,0,0,1,0,4,4,1
4188,137449,NRHQ3tSUEv4DHf8jZg8RV7YWaKkLB0Yk,fbPkOYLVPtPgIt0MxizjfFJov3JbHyAi,7,3,1,0,1,0,9,0,14,2.0,1,0.0,0,1,0,1,3,0,0,9,0,2,12,1
4189,137451,aIezEPAtj2Pok0cm2TtbLS3CmQjoEYqT,fbPkOYLVPtPgIt0MxizjfFJov3JbHyAi,2,0,0,0,0,0,4,0,4,0.5714285714285714,1,0.0,0,0,0,0,0,0,0,4,0,0,4,1
4190,137453,gSg4PIaWl0hBhOgVlpN9o8YrQn4pTOeq,fbPkOYLVPtPgIt0MxizjfFJov3JbHyAi,9,12,7,0,2,1,4,0,26,3.7142857142857144,1,0.0,1,7,0,2,11,1,0,4,0,10,16,1
4191,138176,dFJ5slXqGymdZnNlAUvtsyJDritH7dGq,7GRhBDsirIGkRZBtSMEzNTyDr2JQm4xx,9,24,1,14,0,2,1,0,42,6.0,1,0.0,18,1,14,0,6,2,0,1,0,33,9,1
4192,138204,oanYJczRVsQsFyE3TEwPYW17rzmwBQIL,7GRhBDsirIGkRZBtSMEzNTyDr2JQm4xx,5,4,1,0,1,0,1,0,7,1.0,1,0.0,0,1,0,1,4,0,0,1,0,2,5,1
4193,138214,adfbW7xBPY784GRXAIq3fInFogIbD6ro,7GRhBDsirIGkRZBtSMEzNTyDr2JQm4xx,16,22,8,22,0,0,1,0,53,7.571428571428571,1,0.0,13,8,20,0,9,0,2,1,0,41,12,0
4194,138239,JEJrnVrKGVjrX2yiet4Z0AOP8Myw4oGI,7GRhBDsirIGkRZBtSMEzNTyDr2JQm4xx,1,0,0,0,0,0,1,0,1,0.14285714285714285,1,0.0,0,0,0,0,0,0,0,1,0,0,1,1
4195,138243,DKNUSy56RJeSuYO3Dp6WYMwUBdoAcQ0a,7GRhBDsirIGkRZBtSMEzNTyDr2JQm4xx,5,2,1,0,1,0,3,0,7,1.0,2,0.0,0,1,0,1,2,0,0,3,0,2,5,1
4196,138250,szmVnhPypUPoSdN8Z8D02a6M8Gjrnwmf,A3fsA9Zfv1X2fVEQhTw51lKENdNrEqT3,39,23,15,78,9,0,4,0,129,18.428571428571427,3,0.0,3,15,63,9,20,0,15,4,0,90,39,1
4197,138261,JL9rcevmVnCXKLKkXE87B1mrZmlYAcd1,SpATywNh6bZuzm8s1ceuBUnMUAeoAHHw,17,33,15,16,5,48,18,1,136,19.428571428571427,4,0.0,9,15,13,5,24,48,3,18,1,42,94,0
4198,138287,UJP97i2EJO4yjxI3DoA9AGA9qgzPRSeL,SpATywNh6bZuzm8s1ceuBUnMUAeoAHHw,10,15,3,5,0,0,7,8,38,5.428571428571429,3,0.0,0,3,5,0,15,0,0,7,8,8,30,0
4199,138385,R6r85AVni0tNGUvDSXb5ztmJaVo4FSr1,G8EPVSXsOYB5YQWZGiz1aVq5Pgr2GrQu,14,10,1,12,2,0,3,0,28,4.0,1,0.0,7,1,6,2,3,0,6,3,0,16,12,0
4200,138392,U1Nl2HcAAPdRP1Sw1krEueSkSr1F7plD,7GRhBDsirIGkRZBtSMEzNTyDr2JQm4xx,21,28,17,0,12,1,10,1,69,9.857142857142858,2,0.0,1,17,0,12,27,1,0,10,1,30,39,1
4201,138411,MF5edVvM6lCZDxnMdHelos9TUh3KERjn,G8EPVSXsOYB5YQWZGiz1aVq5Pgr2GrQu,1,0,0,0,0,0,1,0,1,0.14285714285714285,1,0.0,0,0,0,0,0,0,0,1,0,0,1,1
4202,138422,PBT0xI17u81InQO08yLXpu6kSLQPC6l6,SpATywNh6bZuzm8s1ceuBUnMUAeoAHHw,14,23,2,21,1,2,12,0,61,8.714285714285714,4,0.0,5,2,17,1,18,2,4,12,0,25,36,0
4203,138491,NXEwBXbU6vvce77sujWgRB6LivhFJvRb,7GRhBDsirIGkRZBtSMEzNTyDr2JQm4xx,6,6,3,0,1,0,4,0,14,2.0,3,0.0,0,3,0,1,6,0,0,4,0,4,10,1
4204,138496,mSXZKJ9e3RCTXopgrFUphpxYgeKp7tlG,SpATywNh6bZuzm8s1ceuBUnMUAeoAHHw,17,19,8,8,3,1,6,1,46,6.571428571428571,2,0.0,8,8,8,3,11,1,0,6,1,27,19,0
4205,138518,SVfMOf78rQIhc5bUdZbaTCmOKKmn1NJW,7GRhBDsirIGkRZBtSMEzNTyDr2JQm4xx,1,0,0,0,0,0,1,0,1,0.14285714285714285,1,0.0,0,0,0,0,0,0,0,1,0,0,1,1
4206,138554,Px8gWLqn4P0S59C09B0pkBi24hj9iKEG,7GRhBDsirIGkRZBtSMEzNTyDr2JQm4xx,7,3,0,0,0,0,8,0,11,1.5714285714285714,2,0.0,0,0,0,0,3,0,0,8,0,0,11,1
4207,138602,TlFcqTzRzzK0wdjPXKgY6Grw7xbgRspB,7GRhBDsirIGkRZBtSMEzNTyDr2JQm4xx,1,0,0,0,0,0,1,0,1,0.14285714285714285,1,0.0,0,0,0,0,0,0,0,1,0,0,1,1
4208,138613,ONe4iInwtHkZ5gtlbWN831JopVHbaD8L,G8EPVSXsOYB5YQWZGiz1aVq5Pgr2GrQu,2,0,0,0,0,0,2,0,2,0.2857142857142857,1,0.0,0,0,0,0,0,0,0,2,0,0,2,1
4209,138643,QiZHycbjNbbRnz73j2CxBu0cfmT0MxFq,7GRhBDsirIGkRZBtSMEzNTyDr2JQm4xx,2,0,0,0,0,0,2,0,2,0.2857142857142857,1,0.0,0,0,0,0,0,0,0,2,0,0,2,1
4210,138644,klFfeIWt13kJyzZ8QBX8igiJe3NNykgD,SpATywNh6bZuzm8s1ceuBUnMUAeoAHHw,11,22,11,18,3,9,3,0,66,9.428571428571429,3,0.0,7,11,15,3,15,9,3,3,0,36,30,1
4211,138800,OhEerYX6jubgMlujry1FJzH6tFAkAkV2,7GRhBDsirIGkRZBtSMEzNTyDr2JQm4xx,7,4,1,0,0,3,4,1,13,1.8571428571428572,1,0.0,0,1,0,0,4,3,0,4,1,1,12,1
4212,138818,okqN4nBVKRYYrkYonKicKGOmPqVGYjZh,RXDvfPUBYFlVdlueBFbLW0mhhAyGEqpt,6,9,4,0,0,0,12,0,25,3.5714285714285716,2,0.0,0,4,0,0,9,0,0,12,0,4,21,0
4213,138839,AYb0mQx5aj7cvHvgDba3CV4jlkuCTKMg,7GRhBDsirIGkRZBtSMEzNTyDr2JQm4xx,4,2,0,0,0,0,2,0,4,0.5714285714285714,1,0.0,0,0,0,0,2,0,0,2,0,0,4,1
4214,138865,AYiGvgKDaGiBpYEcJ7Espvi6dQy2aiFd,SpATywNh6bZuzm8s1ceuBUnMUAeoAHHw,12,39,4,10,0,2,4,1,60,8.571428571428571,3,0.0,13,4,10,0,26,2,0,4,1,27,33,0
4215,138900,bHqXWqN9pt89j5bH9fnt5jMZVOQZImRj,7GRhBDsirIGkRZBtSMEzNTyDr2JQm4xx,1,0,0,0,0,0,1,0,1,0.14285714285714285,1,0.0,0,0,0,0,0,0,0,1,0,0,1,1
4216,138947,2Ueq99WOxFkvLjKvdAbi1TRY9isnfhGR,SpATywNh6bZuzm8s1ceuBUnMUAeoAHHw,8,6,4,0,3,2,3,0,18,2.5714285714285716,2,0.0,2,4,0,3,4,2,0,3,0,9,9,1
4217,138957,LDYjWqhrIxv22jlLe9In731UT9Ne6fvw,SpATywNh6bZuzm8s1ceuBUnMUAeoAHHw,14,8,5,9,3,3,14,0,42,6.0,5,0.0,3,5,9,3,5,3,0,14,0,20,22,1
4218,138974,ouL32O71NoAWgx7epnnVebKIsbBDnj9P,SpATywNh6bZuzm8s1ceuBUnMUAeoAHHw,17,34,14,19,9,50,18,4,148,21.142857142857142,2,0.0,9,14,15,9,25,50,4,18,4,47,101,0
4219,139004,aKtqxPEfMnVhEPAMX3aHrnYTfbYN9i8f,A3fsA9Zfv1X2fVEQhTw51lKENdNrEqT3,6,3,0,0,0,3,5,0,11,1.5714285714285714,1,0.0,0,0,0,0,3,3,0,5,0,0,11,1
4220,139006,3wXMZkXBm1ATxVfwmh0YqzBsBRzhFw8P,SpATywNh6bZuzm8s1ceuBUnMUAeoAHHw,18,20,11,16,4,0,12,1,64,9.142857142857142,2,0.0,6,11,14,4,14,0,2,12,1,35,29,0
4221,139081,AUQbcN6sP8jOc3r7pDcomR6R8baoxLvG,RXDvfPUBYFlVdlueBFbLW0mhhAyGEqpt,51,89,56,151,23,10,20,2,351,50.142857142857146,4,0.0,22,56,137,23,67,10,14,20,2,238,113,0
4222,139085,heVJWbQBtCN8obfXQBAbcR0I5MnOvCPs,G8EPVSXsOYB5YQWZGiz1aVq5Pgr2GrQu,45,105,34,54,24,5,23,4,249,35.57142857142857,5,0.0,45,34,29,24,60,5,25,23,4,132,117,0
4223,139134,tS8frxV0M3TGWaoIiOl49ThYexkN4UpR,7GRhBDsirIGkRZBtSMEzNTyDr2JQm4xx,8,14,5,0,3,0,5,0,27,3.857142857142857,2,0.0,0,5,0,3,14,0,0,5,0,8,19,1
4224,139241,mR38LOzPkDgy4Z7CZO92yHt4TSlNwfzC,A3fsA9Zfv1X2fVEQhTw51lKENdNrEqT3,1,0,0,0,0,0,2,0,2,0.2857142857142857,1,0.0,0,0,0,0,0,0,0,2,0,0,2,1
4225,139243,St6usTSSgX5U9v7wchuMWqmBKoCcDwN2,7GRhBDsirIGkRZBtSMEzNTyDr2JQm4xx,2,0,0,0,0,0,2,0,2,0.2857142857142857,1,0.0,0,0,0,0,0,0,0,2,0,0,2,1
4226,139312,vlarE7zCdES78rsfbZ9s0PTdwVr1rAk4,A3fsA9Zfv1X2fVEQhTw51lKENdNrEqT3,12,20,1,0,0,1,8,3,33,4.714285714285714,2,0.0,0,1,0,0,20,1,0,8,3,1,32,1
4227,139354,QXg7RHDSlJliIBbIO3xqJ8cmekKDZLIJ,7GRhBDsirIGkRZBtSMEzNTyDr2JQm4xx,8,9,5,0,0,0,4,0,18,2.5714285714285716,1,0.0,1,5,0,0,8,0,0,4,0,6,12,1
4228,139391,iLtON4OdzeG1y617iqhiryM9G4xoGAr5,SpATywNh6bZuzm8s1ceuBUnMUAeoAHHw,15,37,13,30,3,33,25,4,145,20.714285714285715,2,0.0,18,13,26,3,19,33,4,25,4,60,85,0
4229,139479,cDV3uv01OqR28HAw8WapmztMslx9jbkZ,A3fsA9Zfv1X2fVEQhTw51lKENdNrEqT3,3,2,0,0,0,0,1,0,3,0.42857142857142855,1,0.0,0,0,0,0,2,0,0,1,0,0,3,1
4230,139497,CQdAGcIvDdIBklDWFKtch5fpBdl4NTjN,SpATywNh6bZuzm8s1ceuBUnMUAeoAHHw,17,25,12,18,4,0,5,1,65,9.285714285714286,1,0.0,10,12,14,4,15,0,4,5,1,40,25,1
4231,139575,j4fKJGSFGeDK8KfTLiburPdJXY2cNIyf,7GRhBDsirIGkRZBtSMEzNTyDr2JQm4xx,5,2,1,0,1,0,2,0,6,0.8571428571428571,1,0.0,0,1,0,1,2,0,0,2,0,2,4,1
4232,139625,NHjxa47feJ9sWQnmg6HoO6L78eHIRwnl,7GRhBDsirIGkRZBtSMEzNTyDr2JQm4xx,1,0,0,0,0,0,2,0,2,0.2857142857142857,1,0.0,0,0,0,0,0,0,0,2,0,0,2,0
4233,139640,S33lH053HmB7Cz0IWipiL27cwx1QXBWr,7GRhBDsirIGkRZBtSMEzNTyDr2JQm4xx,3,2,0,0,0,0,1,0,3,0.42857142857142855,1,0.0,0,0,0,0,2,0,0,1,0,0,3,1
4234,139657,eC4StSuQwImpW962lXYQQlRlP4Dxmsjm,7GRhBDsirIGkRZBtSMEzNTyDr2JQm4xx,2,0,0,0,0,0,2,0,2,0.2857142857142857,1,0.0,0,0,0,0,0,0,0,2,0,0,2,1
4235,139701,bDbKEMrZzcFQTQT7Qrji0QYF25s6ADsY,7GRhBDsirIGkRZBtSMEzNTyDr2JQm4xx,1,0,0,0,0,0,1,0,1,0.14285714285714285,1,0.0,0,0,0,0,0,0,0,1,0,0,1,1
4236,140333,bqWpav7ocOhCfb3xc4QgAvBDK5g8BmiZ,7GRhBDsirIGkRZBtSMEzNTyDr2JQm4xx,6,9,5,0,0,0,5,0,19,2.7142857142857144,2,0.0,0,5,0,0,9,0,0,5,0,5,14,1
4237,140338,vixag6bpwzwtdrSKIAHFpP8XohE3IVGO,7GRhBDsirIGkRZBtSMEzNTyDr2JQm4xx,36,81,32,78,13,41,21,0,266,38.0,3,0.0,21,32,65,13,60,41,13,21,0,131,135,0
4238,140362,DpqUZKEZpIFvZzvEXk8oaJMRAbEfypNN,7GRhBDsirIGkRZBtSMEzNTyDr2JQm4xx,18,11,8,0,9,0,3,0,31,4.428571428571429,1,0.0,3,8,0,9,8,0,0,3,0,20,11,1
4239,143586,o2z1lYhmt3dNuWADVCZXyE0sw3eHFzWq,G8EPVSXsOYB5YQWZGiz1aVq5Pgr2GrQu,12,3,2,6,1,1,6,1,20,2.857142857142857,1,0.0,0,2,5,1,3,1,1,6,1,8,12,1
4240,143589,z7uFh58nBoces7c1gc4iOr2l4NXGSjok,SpATywNh6bZuzm8s1ceuBUnMUAeoAHHw,11,14,6,13,0,0,8,0,41,5.857142857142857,1,0.0,4,6,13,0,10,0,0,8,0,23,18,0
4241,143599,43nq30xhRsgmZVAWkH8Zjb7IyZDGRDeY,A3fsA9Zfv1X2fVEQhTw51lKENdNrEqT3,6,4,1,0,0,0,3,0,8,1.1428571428571428,1,0.0,0,1,0,0,4,0,0,3,0,1,7,1
4242,143601,tXegIvrCsh9OUalSxRPl6DBhe0HWN5J1,bWdj2GDclj5ofokWjzoa5jAwMkxCykd6,4,2,0,0,0,0,4,0,6,0.8571428571428571,1,0.0,0,0,0,0,2,0,0,4,0,0,6,1
4243,143612,MKvKDEIiF4MpIyn9vn0Yw7gT3feDOAo3,bWdj2GDclj5ofokWjzoa5jAwMkxCykd6,3,2,0,0,0,0,1,0,3,0.42857142857142855,1,0.0,0,0,0,0,2,0,0,1,0,0,3,1
4244,143618,SAdK4BrTbltHilVBy10zBoad8iM8mXa4,G8EPVSXsOYB5YQWZGiz1aVq5Pgr2GrQu,12,19,10,0,10,12,9,0,60,8.571428571428571,1,0.0,2,10,0,10,17,12,0,9,0,22,38,0
4245,143632,BFi14w12zqsNleSplrknYhvmJy8GL2FY,bWdj2GDclj5ofokWjzoa5jAwMkxCykd6,18,27,8,44,5,0,5,0,89,12.714285714285714,2,0.0,9,8,37,5,18,0,7,5,0,59,30,1
4246,143636,HwdB7Xtsh4qUznoQGIINfFO0z6SlgPWN,G8EPVSXsOYB5YQWZGiz1aVq5Pgr2GrQu,7,3,2,0,1,0,4,0,10,1.4285714285714286,1,0.0,0,2,0,1,3,0,0,4,0,3,7,1
4247,143646,BQAHxDKbPTX2OmvOEbIJrtNWABd3lWzF,G8EPVSXsOYB5YQWZGiz1aVq5Pgr2GrQu,80,97,26,198,15,9,21,2,368,52.57142857142857,3,0.0,54,26,147,15,43,9,51,21,2,242,126,1
4248,143658,qCIGCxbEF5IZjc2KbYsE1TkH5yxiGth5,SpATywNh6bZuzm8s1ceuBUnMUAeoAHHw,15,27,2,12,1,1,12,0,55,7.857142857142857,5,0.0,8,2,11,1,19,1,1,12,0,22,33,1
4249,143662,rZhamd6VgzDuUbGwNlJUwteIExfrDmL0,SpATywNh6bZuzm8s1ceuBUnMUAeoAHHw,13,17,13,6,9,0,3,0,48,6.857142857142857,1,0.0,2,13,6,9,15,0,0,3,0,30,18,1
4250,143663,DtdInjZr4k2oFve3KkbkHNxJxR1ugIKn,SpATywNh6bZuzm8s1ceuBUnMUAeoAHHw,9,5,1,0,1,2,8,2,19,2.7142857142857144,2,0.0,1,1,0,1,4,2,0,8,2,3,16,1
4251,143674,7lzEjeizq2WryXPCFV63iiJ0sRC0XsD5,A3fsA9Zfv1X2fVEQhTw51lKENdNrEqT3,3,2,0,0,0,0,1,0,3,0.42857142857142855,1,0.0,0,0,0,0,2,0,0,1,0,0,3,1
4252,143678,P1PW7aZzx8NF90gRnrYjkf5ZxxKRlBng,SpATywNh6bZuzm8s1ceuBUnMUAeoAHHw,18,70,38,20,9,74,47,10,268,38.285714285714285,3,0.0,11,38,16,9,59,74,4,47,10,74,194,1
4253,143685,s2CLgeYgKwvHdG0n6HyjEsmd9rHYgz53,RXDvfPUBYFlVdlueBFbLW0mhhAyGEqpt,45,42,17,109,9,10,9,2,198,28.285714285714285,3,0.0,11,17,102,9,31,10,7,9,2,139,59,1
4254,143686,xhoMHYDn0DYj6NEexX867ukahPmWhSwf,bWdj2GDclj5ofokWjzoa5jAwMkxCykd6,10,12,5,0,5,0,4,0,26,3.7142857142857144,1,0.0,5,5,0,5,7,0,0,4,0,15,11,1
4255,143701,BCr2GOpOyeEKOuzlRV7PJCL1CEnRyr6Q,G8EPVSXsOYB5YQWZGiz1aVq5Pgr2GrQu,19,18,12,0,9,0,8,1,48,6.857142857142857,3,0.0,3,12,0,9,15,0,0,8,1,24,24,1
4256,143729,YITGGXKhxzNHdElox232lzcaZdJ61YFn,G8EPVSXsOYB5YQWZGiz1aVq5Pgr2GrQu,8,8,2,0,2,0,3,0,15,2.142857142857143,2,0.0,0,2,0,2,8,0,0,3,0,4,11,1
4257,143753,BFi14w12zqsNleSplrknYhvmJy8GL2FY,SpATywNh6bZuzm8s1ceuBUnMUAeoAHHw,6,10,3,0,1,0,2,0,16,2.2857142857142856,2,0.0,4,3,0,1,6,0,0,2,0,8,8,1
4258,143757,CNd98TtnFYCKW8sIKXbo0EVDlFn0r29F,SpATywNh6bZuzm8s1ceuBUnMUAeoAHHw,14,14,7,12,3,1,5,0,42,6.0,2,0.0,2,7,10,3,12,1,2,5,0,22,20,1
4259,143759,qjm8uLcDpLtNxtPMuyI6LdPbp6n70fuZ,bWdj2GDclj5ofokWjzoa5jAwMkxCykd6,6,2,1,0,0,0,4,1,8,1.1428571428571428,1,0.0,0,1,0,0,2,0,0,4,1,1,7,1
4260,143765,UI53aostODbFE1SZneA6yZKpOYnaewLS,G8EPVSXsOYB5YQWZGiz1aVq5Pgr2GrQu,19,8,7,20,6,0,2,0,43,6.142857142857143,1,0.0,0,7,15,6,8,0,5,2,0,28,15,1
4261,143775,kJR7SORW78mX9yl9TvMAdIrYcwnnZz4r,RXDvfPUBYFlVdlueBFbLW0mhhAyGEqpt,2,0,0,0,0,0,2,0,2,0.2857142857142857,1,0.0,0,0,0,0,0,0,0,2,0,0,2,1
4262,143785,OStdVLf6yEEZ6snmnFowdmcaKWpdnJbL,RXDvfPUBYFlVdlueBFbLW0mhhAyGEqpt,1,0,0,0,0,0,1,0,1,0.14285714285714285,1,0.0,0,0,0,0,0,0,0,1,0,0,1,1
4263,143812,ee58foeX64HQVEJT3urOlMI7BjSHbs8j,SpATywNh6bZuzm8s1ceuBUnMUAeoAHHw,15,20,1,12,0,0,14,3,50,7.142857142857143,4,0.0,5,1,11,0,15,0,1,14,3,17,33,1
4264,143813,GJGZOa9ckBlFcfojmDXHYkGGywyzKOaN,SpATywNh6bZuzm8s1ceuBUnMUAeoAHHw,14,18,0,17,0,22,14,3,74,10.571428571428571,3,0.0,9,0,15,0,9,22,2,14,3,24,50,1
4265,143822,kfS0nefl4PODD2Wbg3xDtahejAoyK8Co,RXDvfPUBYFlVdlueBFbLW0mhhAyGEqpt,46,26,15,81,12,27,6,1,168,24.0,1,0.0,9,15,74,12,17,27,7,6,1,110,58,0
4266,143829,wBxOvXavxcvDHQtsCbkdt1VRzmB8Qh9E,A3fsA9Zfv1X2fVEQhTw51lKENdNrEqT3,1,0,0,0,0,0,1,0,1,0.14285714285714285,1,0.0,0,0,0,0,0,0,0,1,0,0,1,1
4267,143836,GmLQtlg8yrQT4o49Mau9FkoR2KxlaFCK,A3fsA9Zfv1X2fVEQhTw51lKENdNrEqT3,3,0,0,0,0,1,5,0,6,0.8571428571428571,1,0.0,0,0,0,0,0,1,0,5,0,0,6,1
4268,143845,JlEwtKnXvqCWlVkvWLsPOkSZfN8DgLlO,SpATywNh6bZuzm8s1ceuBUnMUAeoAHHw,8,9,3,0,1,0,3,0,16,2.2857142857142856,1,0.0,1,3,0,1,8,0,0,3,0,5,11,1
4269,143846,i0sekElajxS5N9A9gI4ciPHJzCFHyEzA,SpATywNh6bZuzm8s1ceuBUnMUAeoAHHw,7,4,2,0,2,0,1,0,9,1.2857142857142858,1,0.0,0,2,0,2,4,0,0,1,0,4,5,1
4270,143852,6pc1PztS8sMKmk9TBeVVlDzbAlFBojkU,bWdj2GDclj5ofokWjzoa5jAwMkxCykd6,4,2,1,0,1,0,1,0,5,0.7142857142857143,1,0.0,0,1,0,1,2,0,0,1,0,2,3,1
4271,143871,i0Fe8GkgETgJLYZf4oG1MMDT0SsDr0Jw,bWdj2GDclj5ofokWjzoa5jAwMkxCykd6,8,8,4,0,2,0,3,0,17,2.4285714285714284,3,0.0,0,4,0,2,8,0,0,3,0,6,11,1
4272,143878,OMrkn9SYYoJHeW009nGi3tN8klhPSmaY,G8EPVSXsOYB5YQWZGiz1aVq5Pgr2GrQu,1,0,0,0,0,0,1,0,1,0.14285714285714285,1,0.0,0,0,0,0,0,0,0,1,0,0,1,1
4273,143885,ix15aF6FOEF1waZCSZt01VrPOuPGJ3yM,A3fsA9Zfv1X2fVEQhTw51lKENdNrEqT3,17,21,1,10,1,1,2,0,36,5.142857142857143,2,0.0,0,1,10,1,21,1,0,2,0,12,24,1
4274,143903,Vd6Fw7jRvBeu91l91UPCADQJMohO1ulC,SpATywNh6bZuzm8s1ceuBUnMUAeoAHHw,13,18,1,16,1,5,7,0,48,6.857142857142857,4,0.0,5,1,13,1,13,5,3,7,0,20,28,0
4275,143914,qDW8D89X9oTRJFDDcQZTLb3PUIxnDi04,A3fsA9Zfv1X2fVEQhTw51lKENdNrEqT3,7,4,1,0,1,0,2,0,8,1.1428571428571428,1,0.0,0,1,0,1,4,0,0,2,0,2,6,1
4276,143916,YGuMlMRO0oSJvGD54x9bLYiGJQjDsQL5,G8EPVSXsOYB5YQWZGiz1aVq5Pgr2GrQu,7,8,1,6,0,3,3,0,21,3.0,1,0.0,6,1,3,0,2,3,3,3,0,10,11,1
4277,143919,0Wa2kEuzurHwd29qlJEDljKGNBFtcml7,G8EPVSXsOYB5YQWZGiz1aVq5Pgr2GrQu,6,1,1,0,1,0,3,0,6,0.8571428571428571,1,0.0,0,1,0,1,1,0,0,3,0,2,4,1
4278,143922,kjGwgryJuZFnPYPKqBQ3NNskwkNfGn3d,A3fsA9Zfv1X2fVEQhTw51lKENdNrEqT3,1,0,0,0,0,0,2,0,2,0.2857142857142857,1,0.0,0,0,0,0,0,0,0,2,0,0,2,1
4279,143926,kjGwgryJuZFnPYPKqBQ3NNskwkNfGn3d,bWdj2GDclj5ofokWjzoa5jAwMkxCykd6,7,2,0,0,0,7,6,1,16,2.2857142857142856,1,0.0,0,0,0,0,2,7,0,6,1,0,16,1
4280,143942,kS57PN5w4M8SePVOR15O2soQi4RHoCPq,SpATywNh6bZuzm8s1ceuBUnMUAeoAHHw,14,20,6,20,3,0,1,0,50,7.142857142857143,1,0.0,7,6,19,3,13,0,1,1,0,35,15,0
4281,143954,8jktIbkTyfsrxSTzXB9djfwFIqhVk9sD,G8EPVSXsOYB5YQWZGiz1aVq5Pgr2GrQu,11,8,1,0,1,0,5,0,15,2.142857142857143,1,0.0,0,1,0,1,8,0,0,5,0,2,13,1
4282,143962,xqtF7kz0ECRMGC9cksHZcAo5S9h7Xs8O,A3fsA9Zfv1X2fVEQhTw51lKENdNrEqT3,3,3,2,0,0,0,1,0,6,0.8571428571428571,2,0.0,0,2,0,0,3,0,0,1,0,2,4,1
4283,143978,Bj8ATra8VoYTzA097NzbEns3tHpy9inW,SpATywNh6bZuzm8s1ceuBUnMUAeoAHHw,3,1,0,0,0,0,4,0,5,0.7142857142857143,2,0.0,0,0,0,0,1,0,0,4,0,0,5,1
4284,143985,VYyLsKD1rNE6IEMOVHtWy3gAcazZXSjf,SpATywNh6bZuzm8s1ceuBUnMUAeoAHHw,10,8,6,0,0,1,7,1,23,3.2857142857142856,1,0.0,0,6,0,0,8,1,0,7,1,6,17,1
4285,144002,ldTDPaSBa3R7vzg6xAgzmxomfcP7FtgG,G8EPVSXsOYB5YQWZGiz1aVq5Pgr2GrQu,7,3,0,0,0,0,4,1,8,1.1428571428571428,1,0.0,1,0,0,0,2,0,0,4,1,1,7,1
4286,144004,U62bUOUAMvRVibRWhVYvsfcC0FytLRv5,A3fsA9Zfv1X2fVEQhTw51lKENdNrEqT3,12,7,5,0,5,0,2,0,19,2.7142857142857144,2,0.0,0,5,0,5,7,0,0,2,0,10,9,1
4287,144031,LAQONTh6B8YO6fNJXryzQnYCV0hkbp2b,SpATywNh6bZuzm8s1ceuBUnMUAeoAHHw,15,21,12,8,4,0,7,0,52,7.428571428571429,3,0.0,5,12,7,4,16,0,1,7,0,28,24,1
4288,144074,JHhY30IKFzw4LWcyrHuTEglWNqRkqdDU,A3fsA9Zfv1X2fVEQhTw51lKENdNrEqT3,1,0,0,0,0,0,5,0,5,0.7142857142857143,1,0.0,0,0,0,0,0,0,0,5,0,0,5,1
4289,144077,0gS5Q732yxgOQo1BReYmVwLNG0PEmJtw,bWdj2GDclj5ofokWjzoa5jAwMkxCykd6,10,32,11,12,3,7,6,2,73,10.428571428571429,3,0.0,2,11,11,3,30,7,1,6,2,27,46,1
4290,144080,M8cV3FHZsXmaSmJz43zOWXbhj6ecftQ6,bWdj2GDclj5ofokWjzoa5jAwMkxCykd6,9,7,1,0,1,1,9,2,21,3.0,2,0.0,0,1,0,1,7,1,0,9,2,2,19,1
4291,144083,jVbyR2K2eRZglkuIyxRotkq1vJB87WuF,A3fsA9Zfv1X2fVEQhTw51lKENdNrEqT3,15,19,15,0,11,0,4,0,49,7.0,3,0.0,0,15,0,11,19,0,0,4,0,26,23,0
4292,144085,jVbyR2K2eRZglkuIyxRotkq1vJB87WuF,bWdj2GDclj5ofokWjzoa5jAwMkxCykd6,4,3,2,0,2,0,2,0,9,1.2857142857142858,2,0.0,0,2,0,2,3,0,0,2,0,4,5,1
4293,144106,Kky2aVSeER09Ccbe6jHNmsRuAd2julij,A3fsA9Zfv1X2fVEQhTw51lKENdNrEqT3,4,2,1,0,1,0,1,0,5,0.7142857142857143,1,0.0,0,1,0,1,2,0,0,1,0,2,3,1
4294,144110,ZkodedaetKv5naAeRDAkOlSxAXe0IboP,A3fsA9Zfv1X2fVEQhTw51lKENdNrEqT3,9,5,4,0,2,2,5,0,18,2.5714285714285716,1,0.0,0,4,0,2,5,2,0,5,0,6,12,1
4295,144123,VbTtM6XJ2ULINXtlzPV5CdmpUQ96Z4m1,A3fsA9Zfv1X2fVEQhTw51lKENdNrEqT3,2,0,0,0,0,0,2,0,2,0.2857142857142857,1,0.0,0,0,0,0,0,0,0,2,0,0,2,1
4296,144125,9T6sJuPiEkwFHn4VyREnKyR6Ni1hFol4,A3fsA9Zfv1X2fVEQhTw51lKENdNrEqT3,43,23,15,76,11,0,8,0,133,19.0,2,0.0,1,15,61,11,22,0,15,8,0,88,45,0
4297,144128,XFHjgUTOXGdMfDJPVsJ9fIgVszICPgyz,SpATywNh6bZuzm8s1ceuBUnMUAeoAHHw,4,2,0,0,0,0,2,0,4,0.5714285714285714,1,0.0,0,0,0,0,2,0,0,2,0,0,4,1
4298,144149,Q0aJXENLM8Ba7eSfqdpvheSc04S1CuaH,SpATywNh6bZuzm8s1ceuBUnMUAeoAHHw,2,0,0,0,0,0,2,0,2,0.2857142857142857,1,0.0,0,0,0,0,0,0,0,2,0,0,2,1
4299,144160,rukMFkuKsi65w6w0x0BTdkn9Ums9NFFL,RXDvfPUBYFlVdlueBFbLW0mhhAyGEqpt,1,0,0,0,0,0,1,0,1,0.14285714285714285,1,0.0,0,0,0,0,0,0,0,1,0,0,1,1
4300,144164,OD1pqN8En0iNd52vQpaf4DwGLH3W4dof,SpATywNh6bZuzm8s1ceuBUnMUAeoAHHw,5,2,1,0,1,0,3,0,7,1.0,2,0.0,0,1,0,1,2,0,0,3,0,2,5,1
4301,144179,L1IQ56wH1SqkL7PACuNGk2Nkhk5s11JQ,SpATywNh6bZuzm8s1ceuBUnMUAeoAHHw,7,3,2,0,2,0,2,0,9,1.2857142857142858,1,0.0,0,2,0,2,3,0,0,2,0,4,5,1
4302,144183,ZG0u2uQ1GPj4pTtPSRFTX9ZynYPgcWTk,G8EPVSXsOYB5YQWZGiz1aVq5Pgr2GrQu,14,22,2,22,1,0,2,0,49,7.0,2,0.0,12,2,15,1,10,0,7,2,0,30,19,1
4303,144192,soXc1elBesZE0RSRAIRToGxlZRocKEhG,G8EPVSXsOYB5YQWZGiz1aVq5Pgr2GrQu,18,12,7,22,2,1,8,1,53,7.571428571428571,2,0.0,0,7,17,2,12,1,5,8,1,26,27,1
4304,144193,vSPx0Rg8IfOWpaATb7kkPj0mZPaLkdwk,RXDvfPUBYFlVdlueBFbLW0mhhAyGEqpt,3,2,0,0,0,0,1,0,3,0.42857142857142855,1,0.0,0,0,0,0,2,0,0,1,0,0,3,1
4305,144197,8eAVRzls7MGQwc3WaPP7ONmygmpXQE3K,A3fsA9Zfv1X2fVEQhTw51lKENdNrEqT3,7,5,3,0,2,0,1,0,11,1.5714285714285714,1,0.0,0,3,0,2,5,0,0,1,0,5,6,1
4306,144202,CLjs31mL2a4HrNzVlnTt15ZnHVg4guKy,bWdj2GDclj5ofokWjzoa5jAwMkxCykd6,5,3,1,0,1,0,3,0,8,1.1428571428571428,2,0.0,1,1,0,1,2,0,0,3,0,3,5,1
4307,144207,q8Ghyemwk98Z0FJ5i93VufZPwN70TN9G,G8EPVSXsOYB5YQWZGiz1aVq5Pgr2GrQu,2,0,0,0,0,0,2,0,2,0.2857142857142857,1,0.0,0,0,0,0,0,0,0,2,0,0,2,1
4308,144221,KkSinTdG2PbGrJIRATMZos8HES46UawO,bWdj2GDclj5ofokWjzoa5jAwMkxCykd6,9,39,8,0,7,0,5,0,59,8.428571428571429,2,0.0,13,8,0,7,26,0,0,5,0,28,31,0
4309,144226,KkSinTdG2PbGrJIRATMZos8HES46UawO,A3fsA9Zfv1X2fVEQhTw51lKENdNrEqT3,21,33,15,0,12,2,4,1,67,9.571428571428571,2,0.0,0,15,0,12,33,2,0,4,1,27,40,0
4310,144228,tLK4qfNEt0O7kdBEQmDtMwddSX278qz9,SpATywNh6bZuzm8s1ceuBUnMUAeoAHHw,2,0,0,0,0,0,2,0,2,0.2857142857142857,1,0.0,0,0,0,0,0,0,0,2,0,0,2,1
4311,144239,YCrhaujUJb2ysdJEAlnTFggfP634EwtZ,A3fsA9Zfv1X2fVEQhTw51lKENdNrEqT3,1,0,0,0,0,0,1,0,1,0.14285714285714285,1,0.0,0,0,0,0,0,0,0,1,0,0,1,1
4312,144242,asiNuyAOWs6SCiRYMsJjoOdnVeDfmCWA,A3fsA9Zfv1X2fVEQhTw51lKENdNrEqT3,7,3,0,0,0,1,8,0,12,1.7142857142857142,1,0.0,0,0,0,0,3,1,0,8,0,0,12,1
4313,144264,1La5rp9ZSz9cfpqCRJiC01Rwvuq5VVrf,A3fsA9Zfv1X2fVEQhTw51lKENdNrEqT3,13,7,4,6,3,0,4,0,24,3.4285714285714284,1,0.0,2,4,5,3,5,0,1,4,0,14,10,0
4314,144273,myIIBocNFelldmuN47bMrRiORGKDSj7S,A3fsA9Zfv1X2fVEQhTw51lKENdNrEqT3,8,4,3,0,3,0,1,0,11,1.5714285714285714,1,0.0,0,3,0,3,4,0,0,1,0,6,5,1
4315,144279,QGuKTIBC2KLaYpPdOnB4nXCWgxMM1Dog,A3fsA9Zfv1X2fVEQhTw51lKENdNrEqT3,8,4,3,0,3,0,1,0,11,1.5714285714285714,1,0.0,0,3,0,3,4,0,0,1,0,6,5,0
4316,144307,xzsDRI5lJyx0VDWOgYiu4gtqXBQyCAlZ,SpATywNh6bZuzm8s1ceuBUnMUAeoAHHw,5,2,1,0,1,0,2,0,6,0.8571428571428571,1,0.0,0,1,0,1,2,0,0,2,0,2,4,1
4317,144321,l9yVkoh4OzNZS3boMvfvu1qkbaccG6pv,SpATywNh6bZuzm8s1ceuBUnMUAeoAHHw,13,26,15,4,7,0,5,0,57,8.142857142857142,4,0.0,8,15,3,7,18,0,1,5,0,33,24,0
4318,144328,1z8xVGdONRHgttCsFcaiTYfHNmdRXPsG,SpATywNh6bZuzm8s1ceuBUnMUAeoAHHw,8,8,3,0,2,0,2,0,15,2.142857142857143,1,0.0,2,3,0,2,6,0,0,2,0,7,8,1
4319,144352,15iBXbgbmcpqKkeTya1vwlvLo9VSZF3Q,G8EPVSXsOYB5YQWZGiz1aVq5Pgr2GrQu,14,7,6,34,4,0,3,0,54,7.714285714285714,1,0.0,1,6,29,4,6,0,5,3,0,40,14,1
4320,144367,j6kVkVGKYZT7ozL2NE5rOIexD3a1ewYn,bWdj2GDclj5ofokWjzoa5jAwMkxCykd6,8,6,2,18,3,0,1,0,30,4.285714285714286,1,0.0,3,2,16,3,3,0,2,1,0,24,6,1
4321,144376,rTLMEQB78zn1g6bt6KRypanGZ8QWPbQv,bWdj2GDclj5ofokWjzoa5jAwMkxCykd6,1,0,0,0,0,0,1,0,1,0.14285714285714285,1,0.0,0,0,0,0,0,0,0,1,0,0,1,1
4322,144389,BeS19JPMXzXPGfXk6YRJuHRmyxH0T7Wj,A3fsA9Zfv1X2fVEQhTw51lKENdNrEqT3,2,0,0,0,0,0,4,0,4,0.5714285714285714,1,0.0,0,0,0,0,0,0,0,4,0,0,4,1
4323,144393,15iBXbgbmcpqKkeTya1vwlvLo9VSZF3Q,SpATywNh6bZuzm8s1ceuBUnMUAeoAHHw,2,0,0,0,0,0,2,0,2,0.2857142857142857,1,0.0,0,0,0,0,0,0,0,2,0,0,2,1
4324,144406,Y4L4Q01m86olYens1XXjwQSIKQK0VXY8,SpATywNh6bZuzm8s1ceuBUnMUAeoAHHw,11,6,5,4,3,0,1,0,19,2.7142857142857144,1,0.0,0,5,3,3,6,0,1,1,0,11,8,1
4325,144421,IH3Fpf227mcEx04r510MqQHERjzGveWM,A3fsA9Zfv1X2fVEQhTw51lKENdNrEqT3,21,31,24,0,14,1,12,0,82,11.714285714285714,4,0.0,0,24,0,14,31,1,0,12,0,38,44,1
4326,144422,6ElmeAobgOVWMQKbfyTe96fhVbG33C2X,G8EPVSXsOYB5YQWZGiz1aVq5Pgr2GrQu,1,0,0,0,0,0,1,0,1,0.14285714285714285,1,0.0,0,0,0,0,0,0,0,1,0,0,1,1
4327,144429,tVItbLut2hv4GIKzxM0DVZ7s3PzDPaT6,RXDvfPUBYFlVdlueBFbLW0mhhAyGEqpt,1,0,0,0,0,0,1,0,1,0.14285714285714285,1,0.0,0,0,0,0,0,0,0,1,0,0,1,1
4328,144439,7WYyQ5o657nnaDs90V9cVaz7JKBLQO6T,bWdj2GDclj5ofokWjzoa5jAwMkxCykd6,12,10,4,34,4,0,6,0,58,8.285714285714286,1,0.0,4,4,33,4,6,0,1,6,0,45,13,1
4329,144443,OocLfrCOBb0PIIRDKMfTM554g3aeKj99,A3fsA9Zfv1X2fVEQhTw51lKENdNrEqT3,9,4,3,0,3,0,2,0,12,1.7142857142857142,1,0.0,0,3,0,3,4,0,0,2,0,6,6,1
4330,144455,uzKo5XybDLGWG8pNxiIda7r0TfSQ9SeA,A3fsA9Zfv1X2fVEQhTw51lKENdNrEqT3,10,7,6,0,6,0,1,0,20,2.857142857142857,1,0.0,0,6,0,6,7,0,0,1,0,12,8,1
4331,144460,QhamLDlsBIMrNG9NsQtpJBjMOuVLF7Tg,SpATywNh6bZuzm8s1ceuBUnMUAeoAHHw,1,0,0,0,0,0,1,0,1,0.14285714285714285,1,0.0,0,0,0,0,0,0,0,1,0,0,1,1
4332,144462,98Rmjqd0huhIhiHJIK65vNiEBdUVwDLb,bWdj2GDclj5ofokWjzoa5jAwMkxCykd6,1,0,0,0,0,0,1,0,1,0.14285714285714285,1,0.0,0,0,0,0,0,0,0,1,0,0,1,1
4333,144505,XYAJcmpULCxF9eHnylLtZOUd3WBca1G2,SpATywNh6bZuzm8s1ceuBUnMUAeoAHHw,6,4,1,0,1,0,4,0,10,1.4285714285714286,1,0.0,0,1,0,1,4,0,0,4,0,2,8,1
4334,144510,M8d3qfut8VxaqPRwVms9OlOmOpQg63xG,SpATywNh6bZuzm8s1ceuBUnMUAeoAHHw,18,56,11,18,4,29,21,4,143,20.428571428571427,2,0.0,23,11,15,4,33,29,3,21,4,53,90,1
4335,144511,XqxXHlwlYxd9RSTeUV9pBamG1DPgHOIg,G8EPVSXsOYB5YQWZGiz1aVq5Pgr2GrQu,7,9,3,4,2,0,2,0,20,2.857142857142857,1,0.0,4,3,3,2,5,0,1,2,0,12,8,1
4336,144515,g3liImBcMScJKznyarQ0IVXqD3a9da64,bWdj2GDclj5ofokWjzoa5jAwMkxCykd6,2,0,0,0,0,0,2,0,2,0.2857142857142857,1,0.0,0,0,0,0,0,0,0,2,0,0,2,1
4337,144523,a47rhYVhWUpsdxtGQACB0YgDJVPXyOje,G8EPVSXsOYB5YQWZGiz1aVq5Pgr2GrQu,15,10,0,18,0,1,5,1,35,5.0,1,0.0,6,0,14,0,4,1,4,5,1,20,15,1
4338,144538,E030rU1LpxP75gCwLYOV4Fo0HxMZiV04,bWdj2GDclj5ofokWjzoa5jAwMkxCykd6,4,2,1,0,1,0,1,0,5,0.7142857142857143,1,0.0,0,1,0,1,2,0,0,1,0,2,3,1
4339,144543,3myCXWasasCDpepMqlfZ17VF0Gt1zPNm,SpATywNh6bZuzm8s1ceuBUnMUAeoAHHw,8,9,3,0,2,0,5,0,19,2.7142857142857144,1,0.0,0,3,0,2,9,0,0,5,0,5,14,1
4340,144550,dRD1DS5DuggVygcG59W7832HdVYwtgOn,SpATywNh6bZuzm8s1ceuBUnMUAeoAHHw,11,12,3,0,3,1,8,1,28,4.0,3,0.0,0,3,0,3,12,1,0,8,1,6,22,0
4341,144554,a98Mt6r9LLCkAEPo2R3JVMN20OhIPoaG,G8EPVSXsOYB5YQWZGiz1aVq5Pgr2GrQu,12,9,8,0,8,1,13,3,42,6.0,1,0.0,0,8,0,8,9,1,0,13,3,16,26,1
4342,144565,aGxe7bEAMBiGMI7BWz3muh2QIgH75sEQ,SpATywNh6bZuzm8s1ceuBUnMUAeoAHHw,7,6,3,0,2,1,4,1,17,2.4285714285714284,1,0.0,0,3,0,2,6,1,0,4,1,5,12,1
4343,144576,K938KGiMd2B4Ec49syEZjpINF1qucFfC,RXDvfPUBYFlVdlueBFbLW0mhhAyGEqpt,8,6,5,0,3,0,1,0,15,2.142857142857143,1,0.0,0,5,0,3,6,0,0,1,0,8,7,1
4344,144588,TfgVRC9skFsGu3qq14caEQmfjmrp7rot,A3fsA9Zfv1X2fVEQhTw51lKENdNrEqT3,7,9,2,2,0,41,8,0,62,8.857142857142858,3,0.0,1,2,2,0,8,41,0,8,0,5,57,1
4345,144595,ILvCdOvVnKq9RshqMB5c6cdDGIsepuiz,SpATywNh6bZuzm8s1ceuBUnMUAeoAHHw,15,26,10,16,7,1,4,0,64,9.142857142857142,2,0.0,10,10,14,7,16,1,2,4,0,41,23,0
4346,144597,8sZcaktUJCX4PaAufyDgY0i3vpLY8cZl,SpATywNh6bZuzm8s1ceuBUnMUAeoAHHw,16,48,21,20,10,11,13,0,123,17.571428571428573,6,0.0,9,21,17,10,39,11,3,13,0,57,66,1
4347,144603,FKroAYBvJIjpEDPtuLwEtwENqpzITIVV,G8EPVSXsOYB5YQWZGiz1aVq5Pgr2GrQu,2,0,0,0,0,0,2,0,2,0.2857142857142857,1,0.0,0,0,0,0,0,0,0,2,0,0,2,1
4348,144617,pU8vRE1UHTj9vg59DuOCQhz7JoOflgLu,A3fsA9Zfv1X2fVEQhTw51lKENdNrEqT3,7,3,2,0,2,0,2,0,9,1.2857142857142858,1,0.0,0,2,0,2,3,0,0,2,0,4,5,1
4349,144618,MXpZg6Y3WvwOURUS1VvgXTxhk1pXKVY7,A3fsA9Zfv1X2fVEQhTw51lKENdNrEqT3,1,0,0,0,0,0,1,0,1,0.14285714285714285,1,0.0,0,0,0,0,0,0,0,1,0,0,1,1
4350,144629,BP5bWGw3QHuTeDApT0DMqwZyLZFJNObH,bWdj2GDclj5ofokWjzoa5jAwMkxCykd6,2,0,0,0,0,0,4,0,4,0.5714285714285714,2,0.0,0,0,0,0,0,0,0,4,0,0,4,1
4351,144631,HOzFChSOtA5eaxaGdVcuMk1vnx6fpMBO,A3fsA9Zfv1X2fVEQhTw51lKENdNrEqT3,8,6,5,0,5,0,1,0,17,2.4285714285714284,1,0.0,0,5,0,5,6,0,0,1,0,10,7,1
4352,144636,JUXaUT76xGfe9CQCOTjnER9kYb6QPZYj,SpATywNh6bZuzm8s1ceuBUnMUAeoAHHw,1,0,0,0,0,0,1,0,1,0.14285714285714285,1,0.0,0,0,0,0,0,0,0,1,0,0,1,1
4353,144640,BP5bWGw3QHuTeDApT0DMqwZyLZFJNObH,G8EPVSXsOYB5YQWZGiz1aVq5Pgr2GrQu,1,0,0,0,0,0,1,0,1,0.14285714285714285,1,0.0,0,0,0,0,0,0,0,1,0,0,1,1
4354,144641,BP5bWGw3QHuTeDApT0DMqwZyLZFJNObH,RXDvfPUBYFlVdlueBFbLW0mhhAyGEqpt,1,0,0,0,0,0,1,0,1,0.14285714285714285,1,0.0,0,0,0,0,0,0,0,1,0,0,1,1
4355,144643,BP5bWGw3QHuTeDApT0DMqwZyLZFJNObH,A3fsA9Zfv1X2fVEQhTw51lKENdNrEqT3,1,0,0,0,0,0,1,0,1,0.14285714285714285,1,0.0,0,0,0,0,0,0,0,1,0,0,1,0
4356,144649,uKGXhzbiDEpxCHjVlf9dmkGcQbxLosVe,A3fsA9Zfv1X2fVEQhTw51lKENdNrEqT3,25,23,5,68,2,0,4,0,102,14.571428571428571,1,0.0,16,5,68,2,7,0,0,4,0,91,11,1
4357,144672,0CSUGuJXm53wz281T7wy30wWcjmP6Jhd,A3fsA9Zfv1X2fVEQhTw51lKENdNrEqT3,1,0,0,0,0,0,1,0,1,0.14285714285714285,1,0.0,0,0,0,0,0,0,0,1,0,0,1,1
4358,144675,R6EtBVYzIOtYw5JSZPuQBl0alOVcbr6I,A3fsA9Zfv1X2fVEQhTw51lKENdNrEqT3,2,0,0,0,0,0,2,0,2,0.2857142857142857,2,0.0,0,0,0,0,0,0,0,2,0,0,2,1
4359,144681,ZbpLZuhcPXDt8MCBlzIEU31Qmn57Ldle,SpATywNh6bZuzm8s1ceuBUnMUAeoAHHw,5,6,3,0,1,0,5,0,15,2.142857142857143,3,0.0,0,3,0,1,6,0,0,5,0,4,11,0
4360,144684,3URMlJ8WFfbFx3SvBMPqUCA5oJqCky66,SpATywNh6bZuzm8s1ceuBUnMUAeoAHHw,1,0,0,0,0,0,1,0,1,0.14285714285714285,1,0.0,0,0,0,0,0,0,0,1,0,0,1,1
4361,144685,3URMlJ8WFfbFx3SvBMPqUCA5oJqCky66,A3fsA9Zfv1X2fVEQhTw51lKENdNrEqT3,1,0,0,0,0,0,1,0,1,0.14285714285714285,1,0.0,0,0,0,0,0,0,0,1,0,0,1,1
4362,144715,xQxCv7HVGUZGKsbGAuM07smPdylb1xSw,SpATywNh6bZuzm8s1ceuBUnMUAeoAHHw,17,20,10,12,3,3,11,2,61,8.714285714285714,2,0.0,6,10,12,3,14,3,0,11,2,31,30,1
4363,144717,dSEPqlVIJhcDJWr692RG1EpaZWCLqDyG,SpATywNh6bZuzm8s1ceuBUnMUAeoAHHw,18,23,15,17,8,0,10,1,74,10.571428571428571,2,0.0,3,15,14,8,20,0,3,10,1,40,34,1
4364,144718,4ZrtrSJyUYRfKbXFhTQGaeeh25vDmius,A3fsA9Zfv1X2fVEQhTw51lKENdNrEqT3,1,0,0,0,0,0,1,0,1,0.14285714285714285,1,0.0,0,0,0,0,0,0,0,1,0,0,1,1
4365,144719,xQxCv7HVGUZGKsbGAuM07smPdylb1xSw,A3fsA9Zfv1X2fVEQhTw51lKENdNrEqT3,43,17,12,50,9,0,4,0,92,13.142857142857142,1,0.0,3,12,48,9,14,0,2,4,0,72,20,1
4366,144725,AIfINm6P1sC5sVX3hdv80PZXLkhHXqk1,G8EPVSXsOYB5YQWZGiz1aVq5Pgr2GrQu,12,23,8,14,6,1,6,0,58,8.285714285714286,1,0.0,12,8,11,6,11,1,3,6,0,37,21,1
4367,144738,WQgX9jQZlUNhL3E2Z5eSuSFzKxNFacOF,SpATywNh6bZuzm8s1ceuBUnMUAeoAHHw,7,3,1,0,2,0,2,0,8,1.1428571428571428,1,0.0,0,1,0,2,3,0,0,2,0,3,5,1
4368,144767,D4wnvxE0dpHZJOcudMfhDCLWhQhwv6kG,RXDvfPUBYFlVdlueBFbLW0mhhAyGEqpt,5,2,1,0,1,0,3,0,7,1.0,1,0.0,0,1,0,1,2,0,0,3,0,2,5,1
4369,144783,tLtF2xuv7ODjuOISevnoALqvBz99SIrS,A3fsA9Zfv1X2fVEQhTw51lKENdNrEqT3,11,14,0,0,0,0,3,0,17,2.4285714285714284,2,0.0,0,0,0,0,14,0,0,3,0,0,17,1
4370,144786,pOHHE099KbMGj1W8GOyTSnGwPkWGlTwN,SpATywNh6bZuzm8s1ceuBUnMUAeoAHHw,6,3,2,0,2,0,1,0,8,1.1428571428571428,1,0.0,0,2,0,2,3,0,0,1,0,4,4,1
4371,144794,NSeMeg6h5JDvAoSbt1mktNuQe2nQivm2,SpATywNh6bZuzm8s1ceuBUnMUAeoAHHw,7,7,4,0,3,0,2,0,16,2.2857142857142856,3,0.0,0,4,0,3,7,0,0,2,0,7,9,1
4372,144796,kVjEgLBjlwxZOZHT9ChhdKAcv24WA2AK,A3fsA9Zfv1X2fVEQhTw51lKENdNrEqT3,5,4,0,0,0,0,3,0,7,1.0,1,0.0,0,0,0,0,4,0,0,3,0,0,7,1
4373,144799,mJTYU2VNehzj4vso65R9VtV3DFyktCio,A3fsA9Zfv1X2fVEQhTw51lKENdNrEqT3,1,0,0,0,0,0,1,0,1,0.14285714285714285,1,0.0,0,0,0,0,0,0,0,1,0,0,1,1
4374,144806,7vmy4dx8h1nmyk40XB1bVEo0ZK716pcj,SpATywNh6bZuzm8s1ceuBUnMUAeoAHHw,15,37,6,9,6,7,7,0,72,10.285714285714286,4,0.0,9,6,9,6,28,7,0,7,0,30,42,0
4375,144811,EORWbUeiO6FyoVtc0SbozxGi0vBVCOhI,RXDvfPUBYFlVdlueBFbLW0mhhAyGEqpt,7,6,0,0,0,1,9,0,16,2.2857142857142856,1,0.0,0,0,0,0,6,1,0,9,0,0,16,0
4376,144815,YB7yB7CNt6VhEWaKJG02XZ1X013EpWWP,SpATywNh6bZuzm8s1ceuBUnMUAeoAHHw,10,6,3,6,2,0,2,0,19,2.7142857142857144,1,0.0,0,3,6,2,6,0,0,2,0,11,8,1
4377,144837,w1HLpf01ff60tSyrkRwOPpdSlz3uqa1C,G8EPVSXsOYB5YQWZGiz1aVq5Pgr2GrQu,8,29,8,2,4,0,11,0,54,7.714285714285714,1,0.0,16,8,2,4,13,0,0,11,0,30,24,1
4378,144840,8EW2D448XGSlxAI534l0xtNnCA9hxB1o,SpATywNh6bZuzm8s1ceuBUnMUAeoAHHw,18,36,21,17,6,21,18,2,121,17.285714285714285,3,0.0,9,21,15,6,27,21,2,18,2,51,70,0
4379,144848,lWrAH12K4dJ1TRkFPwboUyykF2mRtmZq,SpATywNh6bZuzm8s1ceuBUnMUAeoAHHw,13,24,0,23,0,13,6,1,67,9.571428571428571,1,0.0,9,0,18,0,15,13,5,6,1,27,40,0
4380,144849,3Szk0pKijWd9ul5APNqiXkIk1r9cxADp,SpATywNh6bZuzm8s1ceuBUnMUAeoAHHw,14,21,2,5,1,3,13,5,50,7.142857142857143,3,0.0,3,2,4,1,18,3,1,13,5,10,40,1
4381,144857,nN9pe51IpLVxUmywITIZON7RGbeNZPas,SpATywNh6bZuzm8s1ceuBUnMUAeoAHHw,1,0,0,0,0,0,1,0,1,0.14285714285714285,1,0.0,0,0,0,0,0,0,0,1,0,0,1,1
4382,144869,wdtTKNG0uA9GskMOgg4nh6i8cQYwrWBl,A3fsA9Zfv1X2fVEQhTw51lKENdNrEqT3,2,0,0,0,0,0,2,0,2,0.2857142857142857,1,0.0,0,0,0,0,0,0,0,2,0,0,2,1
4383,144871,1R1zO9aMB7Mx1Lw84JzsChVEV5JpwmZv,A3fsA9Zfv1X2fVEQhTw51lKENdNrEqT3,12,13,3,0,2,0,7,0,25,3.5714285714285716,3,0.0,0,3,0,2,13,0,0,7,0,5,20,1
4384,144880,DPiNWGgyN27xfAyZbYcImdtWAWiA8G6T,A3fsA9Zfv1X2fVEQhTw51lKENdNrEqT3,2,0,0,0,0,0,6,0,6,0.8571428571428571,1,0.0,0,0,0,0,0,0,0,6,0,0,6,1
4385,144888,Fa0j89udkjEUrIyHxCII6V32n0NpiqGO,SpATywNh6bZuzm8s1ceuBUnMUAeoAHHw,4,5,0,0,0,0,2,0,7,1.0,1,0.0,1,0,0,0,4,0,0,2,0,1,6,1
4386,144889,y9hyyqGNd76OPDqzcsRztJJMWbz6UZny,bWdj2GDclj5ofokWjzoa5jAwMkxCykd6,5,2,1,0,1,0,2,0,6,0.8571428571428571,1,0.0,0,1,0,1,2,0,0,2,0,2,4,1
4387,144892,TBXYAxwexaNd47Tj9eT3p3QhXiwNSKj3,A3fsA9Zfv1X2fVEQhTw51lKENdNrEqT3,5,2,1,0,1,0,2,0,6,0.8571428571428571,1,0.0,0,1,0,1,2,0,0,2,0,2,4,1
4388,144900,k0mvvZulPoyJiICbYxKkU42hG2G5I80n,G8EPVSXsOYB5YQWZGiz1aVq5Pgr2GrQu,15,5,5,0,4,5,8,1,28,4.0,1,0.0,0,5,0,4,5,5,0,8,1,9,19,0
4389,144902,xbjVL5LPvdMl78h4grzGu4EO36e7wFtJ,G8EPVSXsOYB5YQWZGiz1aVq5Pgr2GrQu,17,24,14,14,9,0,4,0,65,9.285714285714286,1,0.0,7,14,13,9,17,0,1,4,0,43,22,1
4390,144906,ltWU63DD5GSM3zr2uNJoqVqAhziwXNdd,A3fsA9Zfv1X2fVEQhTw51lKENdNrEqT3,1,0,0,0,0,0,1,0,1,0.14285714285714285,1,0.0,0,0,0,0,0,0,0,1,0,0,1,1
4391,144910,3QwYnxvK4cR8IsGQGOLRPbhjjuJL7iw4,bWdj2GDclj5ofokWjzoa5jAwMkxCykd6,1,0,0,0,0,0,1,0,1,0.14285714285714285,1,0.0,0,0,0,0,0,0,0,1,0,0,1,1
4392,144913,xbjVL5LPvdMl78h4grzGu4EO36e7wFtJ,SpATywNh6bZuzm8s1ceuBUnMUAeoAHHw,16,14,5,18,2,5,6,1,51,7.285714285714286,1,0.0,7,5,15,2,7,5,3,6,1,29,22,1
4393,144917,qIeFceRzEPXi4DRrMYWrvBiuDgAZSOfu,SpATywNh6bZuzm8s1ceuBUnMUAeoAHHw,6,4,3,0,2,0,2,0,11,1.5714285714285714,1,0.0,0,3,0,2,4,0,0,2,0,5,6,1
4394,144929,j32U9Y949ZW1nXMwG0aPWZXCmluBzel9,A3fsA9Zfv1X2fVEQhTw51lKENdNrEqT3,2,0,0,0,0,0,2,0,2,0.2857142857142857,1,0.0,0,0,0,0,0,0,0,2,0,0,2,1
4395,144953,FDUH5NLrpwAq9aLqLXeux2jUy8LXyyH1,SpATywNh6bZuzm8s1ceuBUnMUAeoAHHw,4,2,0,0,0,0,2,0,4,0.5714285714285714,1,0.0,0,0,0,0,2,0,0,2,0,0,4,0
4396,144955,eE1Ts31Y4vQL30WuFQSepkqre5sjHOf7,A3fsA9Zfv1X2fVEQhTw51lKENdNrEqT3,1,0,0,0,0,0,1,0,1,0.14285714285714285,1,0.0,0,0,0,0,0,0,0,1,0,0,1,1
4397,144957,spFI1Ow5BGpTh0oHb0EunsXhby1WBBGm,A3fsA9Zfv1X2fVEQhTw51lKENdNrEqT3,2,0,0,0,0,0,2,0,2,0.2857142857142857,1,0.0,0,0,0,0,0,0,0,2,0,0,2,1
4398,144963,BohRHH2vBIgnEZGZjM3WnHwJbVFmITRG,A3fsA9Zfv1X2fVEQhTw51lKENdNrEqT3,1,0,0,0,0,0,4,0,4,0.5714285714285714,1,0.0,0,0,0,0,0,0,0,4,0,0,4,1
4399,144970,9fBHqnUYCnvcFTWqd4TwpElPXxWTxMR8,G8EPVSXsOYB5YQWZGiz1aVq5Pgr2GrQu,7,4,1,0,1,0,3,0,9,1.2857142857142858,2,0.0,0,1,0,1,4,0,0,3,0,2,7,1
4400,144985,UdRvlfQEjfzv2meiEECQoQ6VdSnYEWcK,RXDvfPUBYFlVdlueBFbLW0mhhAyGEqpt,17,21,12,30,10,6,5,0,84,12.0,2,0.0,6,12,22,10,15,6,8,5,0,50,34,1
4401,145015,MOcMwRKo0dtFqZ5xWBgRzquuZGKtQyf4,A3fsA9Zfv1X2fVEQhTw51lKENdNrEqT3,6,3,2,0,2,0,1,0,8,1.1428571428571428,1,0.0,0,2,0,2,3,0,0,1,0,4,4,1
4402,145021,qwhxcjW9iIMBAQoGSWDtst34AFkcFQoV,bWdj2GDclj5ofokWjzoa5jAwMkxCykd6,5,7,3,0,0,1,5,0,16,2.2857142857142856,2,0.0,0,3,0,0,7,1,0,5,0,3,13,0
4403,145032,9KLyc4q5evm7m8P2TqAkjsYxwe72QOQ1,bWdj2GDclj5ofokWjzoa5jAwMkxCykd6,7,6,2,0,3,0,2,0,13,1.8571428571428572,1,0.0,2,2,0,3,4,0,0,2,0,7,6,1
4404,145045,fAwXW6DQAyNHjMN17jlyBSVcZRO4da21,bWdj2GDclj5ofokWjzoa5jAwMkxCykd6,3,2,0,0,0,0,1,0,3,0.42857142857142855,1,0.0,0,0,0,0,2,0,0,1,0,0,3,1
4405,145049,OoYnFZVZGncVBxTvo4CMvSktXlZzaVm6,SpATywNh6bZuzm8s1ceuBUnMUAeoAHHw,1,0,0,0,0,0,1,0,1,0.14285714285714285,1,0.0,0,0,0,0,0,0,0,1,0,0,1,1
4406,145054,aRdmmgSzM3Ga3svQ0ZT0DvTgw1R0bnD6,SpATywNh6bZuzm8s1ceuBUnMUAeoAHHw,13,13,1,11,0,7,11,0,43,6.142857142857143,3,0.0,2,1,10,0,11,7,1,11,0,13,30,0
4407,145066,YOvd9uht0tZm889aIFQH8jd68xtH7inE,A3fsA9Zfv1X2fVEQhTw51lKENdNrEqT3,27,29,13,16,7,0,6,0,71,10.142857142857142,3,0.0,2,13,14,7,27,0,2,6,0,36,35,0
4408,145068,sytW49I21SJ70ElOkXGU5SHeeHl1E3fL,SpATywNh6bZuzm8s1ceuBUnMUAeoAHHw,5,4,2,0,1,0,2,0,9,1.2857142857142858,2,0.0,0,2,0,1,4,0,0,2,0,3,6,1
4409,145074,zKArdfpgac7e9qM8jxPrRvIXOkmrDk9Z,SpATywNh6bZuzm8s1ceuBUnMUAeoAHHw,6,2,1,0,1,0,3,0,7,1.0,1,0.0,0,1,0,1,2,0,0,3,0,2,5,1
4410,145075,aVjhXoDZEpZewbee7kboIyQDdDGbqzp9,G8EPVSXsOYB5YQWZGiz1aVq5Pgr2GrQu,2,0,0,0,0,0,2,0,2,0.2857142857142857,1,0.0,0,0,0,0,0,0,0,2,0,0,2,1
4411,145091,ung1DnQyYgd0tfz7mAKTwJrrm5UPHWt1,SpATywNh6bZuzm8s1ceuBUnMUAeoAHHw,1,0,0,0,0,0,2,0,2,0.2857142857142857,1,0.0,0,0,0,0,0,0,0,2,0,0,2,1
4412,145095,tXsXr7pk3kL9xbg1D57dnKxY4YjIc1Gu,SpATywNh6bZuzm8s1ceuBUnMUAeoAHHw,1,0,0,0,0,0,1,0,1,0.14285714285714285,1,0.0,0,0,0,0,0,0,0,1,0,0,1,1
4413,145097,oQl0xDZ6pRPXU9L7MUpc2rUtjHufKB7J,RXDvfPUBYFlVdlueBFbLW0mhhAyGEqpt,4,3,2,0,0,0,1,0,6,0.8571428571428571,1,0.0,0,2,0,0,3,0,0,1,0,2,4,1
4414,145103,DSKmSALREyqQ6TTRJZ71cZdSUivRfs4F,A3fsA9Zfv1X2fVEQhTw51lKENdNrEqT3,8,6,3,0,2,0,3,0,14,2.0,1,0.0,0,3,0,2,6,0,0,3,0,5,9,1
4415,145104,GIGWJmYKqXl2NDr50MFNWHRPBdEAyP24,SpATywNh6bZuzm8s1ceuBUnMUAeoAHHw,6,2,1,0,1,0,7,1,12,1.7142857142857142,2,0.0,0,1,0,1,2,0,0,7,1,2,10,1
4416,145105,RjP92xCHXSUOtRBYjOBBQtIX0x4y84M8,SpATywNh6bZuzm8s1ceuBUnMUAeoAHHw,5,2,1,0,1,0,3,0,7,1.0,1,0.0,0,1,0,1,2,0,0,3,0,2,5,1
4417,145131,y7ML2j3yhLTXFlpVgDfbFQ7iV1QJE8KN,A3fsA9Zfv1X2fVEQhTw51lKENdNrEqT3,8,4,0,0,0,0,8,1,13,1.8571428571428572,2,0.0,0,0,0,0,4,0,0,8,1,0,13,1
4418,145132,VtMJYS2BOcqNwb9vhCBVs8m6rwGm1W7t,A3fsA9Zfv1X2fVEQhTw51lKENdNrEqT3,9,4,3,0,3,0,2,0,12,1.7142857142857142,1,0.0,0,3,0,3,4,0,0,2,0,6,6,1
4419,145133,gcAX0pXem59fO2vK8c72MGTEEeEu58YB,SpATywNh6bZuzm8s1ceuBUnMUAeoAHHw,6,3,1,0,1,0,4,0,9,1.2857142857142858,3,0.0,0,1,0,1,3,0,0,4,0,2,7,1
4420,145138,RiLBe5rsNsQ05e1l2H5DyOu2jxJ20lju,SpATywNh6bZuzm8s1ceuBUnMUAeoAHHw,5,6,0,0,0,0,2,0,8,1.1428571428571428,1,0.0,0,0,0,0,6,0,0,2,0,0,8,1
4421,145141,sytW49I21SJ70ElOkXGU5SHeeHl1E3fL,G8EPVSXsOYB5YQWZGiz1aVq5Pgr2GrQu,1,0,0,0,0,0,1,0,1,0.14285714285714285,1,0.0,0,0,0,0,0,0,0,1,0,0,1,1
4422,145177,2HllbOBswZcfya5rDzlXYMHVB93oWjxb,SpATywNh6bZuzm8s1ceuBUnMUAeoAHHw,17,59,19,22,4,21,13,0,138,19.714285714285715,4,0.0,15,19,19,4,44,21,3,13,0,57,81,1
4423,145209,VDfyMtI3GxFkSIKeQUI9WFdkBVMRRXiz,SpATywNh6bZuzm8s1ceuBUnMUAeoAHHw,5,3,0,0,0,0,4,0,7,1.0,1,0.0,0,0,0,0,3,0,0,4,0,0,7,1
4424,145213,paYCysIECekGmZR2IMHuvcxiMIpmnCQ8,SpATywNh6bZuzm8s1ceuBUnMUAeoAHHw,7,5,0,0,0,1,2,0,8,1.1428571428571428,1,0.0,0,0,0,0,5,1,0,2,0,0,8,1
4425,145218,gBdCgqP4ofpM7Vyy2N6nMT9XqzCjM1Oh,SpATywNh6bZuzm8s1ceuBUnMUAeoAHHw,7,3,2,0,2,0,2,0,9,1.2857142857142858,1,0.0,0,2,0,2,3,0,0,2,0,4,5,1
4426,145221,twJpEV6sOcVGisdKOs7bOfiwkX5tFRQS,SpATywNh6bZuzm8s1ceuBUnMUAeoAHHw,10,12,1,0,1,3,6,1,24,3.4285714285714284,1,0.0,0,1,0,1,12,3,0,6,1,2,22,1
4427,145265,OpGwtUbMGweipJr0vMybah9tM3IHgiea,bWdj2GDclj5ofokWjzoa5jAwMkxCykd6,12,24,2,60,4,0,3,0,93,13.285714285714286,3,0.0,11,2,57,4,13,0,3,3,0,74,19,1
4428,145278,TxcS8XkQULHRvLzAPNlWKiWhaRYPoBRt,G8EPVSXsOYB5YQWZGiz1aVq5Pgr2GrQu,6,2,1,0,1,0,4,0,8,1.1428571428571428,1,0.0,0,1,0,1,2,0,0,4,0,2,6,1
4429,145288,qJfYTCfAKzghj5i0hFgmRNbo2RAMR1vj,A3fsA9Zfv1X2fVEQhTw51lKENdNrEqT3,1,0,0,0,0,0,1,0,1,0.14285714285714285,1,0.0,0,0,0,0,0,0,0,1,0,0,1,1
4430,145291,hnuoUj2kTW5DzBnYNuL5k21Q4R9tMedy,G8EPVSXsOYB5YQWZGiz1aVq5Pgr2GrQu,1,0,0,0,0,0,1,0,1,0.14285714285714285,1,0.0,0,0,0,0,0,0,0,1,0,0,1,1
4431,145292,rwtLVsXV0McQpa98tIZ3wTZOVSCGNjDc,A3fsA9Zfv1X2fVEQhTw51lKENdNrEqT3,2,0,0,0,0,0,2,0,2,0.2857142857142857,1,0.0,0,0,0,0,0,0,0,2,0,0,2,1
4432,145295,vBbCzoxWi1xTyTmmDeTUsTbUY4qjPd8y,G8EPVSXsOYB5YQWZGiz1aVq5Pgr2GrQu,21,26,8,36,7,7,5,1,90,12.857142857142858,2,0.0,16,8,26,7,10,7,10,5,1,57,33,1
4433,145299,Msbm8ecHOfoRqpOAXpgLpOJMSb42Fh1S,bWdj2GDclj5ofokWjzoa5jAwMkxCykd6,1,0,0,0,0,0,2,0,2,0.2857142857142857,2,0.0,0,0,0,0,0,0,0,2,0,0,2,1
4434,145317,xXaLTSrOfjZMoecs1p8kChNEzFzZxcjE,bWdj2GDclj5ofokWjzoa5jAwMkxCykd6,2,0,0,0,0,0,2,0,2,0.2857142857142857,1,0.0,0,0,0,0,0,0,0,2,0,0,2,1
4435,145341,Cgu1GLWn7izWpBdNFknarDBOnLjP2HFo,SpATywNh6bZuzm8s1ceuBUnMUAeoAHHw,1,0,0,0,0,0,1,0,1,0.14285714285714285,1,0.0,0,0,0,0,0,0,0,1,0,0,1,1
4436,145345,RjNr7pqr5wdbMZIOQUnJioAJdhoV1M2t,A3fsA9Zfv1X2fVEQhTw51lKENdNrEqT3,2,0,0,0,0,0,2,0,2,0.2857142857142857,1,0.0,0,0,0,0,0,0,0,2,0,0,2,1
4437,145356,yODUqFZFhl66c3de8GWk0KnGzndelUJ3,SpATywNh6bZuzm8s1ceuBUnMUAeoAHHw,5,4,0,0,0,0,2,0,6,0.8571428571428571,1,0.0,0,0,0,0,4,0,0,2,0,0,6,1
4438,145357,vBbCzoxWi1xTyTmmDeTUsTbUY4qjPd8y,bWdj2GDclj5ofokWjzoa5jAwMkxCykd6,12,11,5,18,4,0,5,0,43,6.142857142857143,2,0.0,3,5,18,4,8,0,0,5,0,30,13,1
4439,145372,N7bFFbLK2teqNFII1ql8vn5jRsylN8ml,A3fsA9Zfv1X2fVEQhTw51lKENdNrEqT3,2,0,0,0,0,0,3,0,3,0.42857142857142855,1,0.0,0,0,0,0,0,0,0,3,0,0,3,1
4440,145379,7DPRFpgqZz2tLX453UgkvNfatiWrVLIi,bWdj2GDclj5ofokWjzoa5jAwMkxCykd6,1,0,0,0,0,0,1,0,1,0.14285714285714285,1,0.0,0,0,0,0,0,0,0,1,0,0,1,1
4441,145406,DaYS7gf8DVgCD84ya5YqgMFFiGYw1ps2,SpATywNh6bZuzm8s1ceuBUnMUAeoAHHw,5,2,1,0,1,0,2,0,6,0.8571428571428571,1,0.0,0,1,0,1,2,0,0,2,0,2,4,1
4442,145432,KMY78k4PWHNGUKa8SpxqTI7uzFKhJIDC,bWdj2GDclj5ofokWjzoa5jAwMkxCykd6,1,0,0,0,0,0,1,0,1,0.14285714285714285,1,0.0,0,0,0,0,0,0,0,1,0,0,1,1
4443,145434,r0Dep3QHNNWSPLkR08tICGVj5Fu7r77t,A3fsA9Zfv1X2fVEQhTw51lKENdNrEqT3,4,2,0,0,0,0,3,0,5,0.7142857142857143,2,0.0,0,0,0,0,2,0,0,3,0,0,5,1
4444,145436,uO6I869Gu09HIUH9g2koYFrRZOQcNS34,SpATywNh6bZuzm8s1ceuBUnMUAeoAHHw,1,0,0,0,0,0,1,0,1,0.14285714285714285,1,0.0,0,0,0,0,0,0,0,1,0,0,1,1
4445,145438,sETZmDR5b3CheYe2K5IvWb1lrRsZmOT8,A3fsA9Zfv1X2fVEQhTw51lKENdNrEqT3,4,2,1,0,1,0,2,0,6,0.8571428571428571,1,0.0,0,1,0,1,2,0,0,2,0,2,4,1
4446,145443,YjyR7WtUqlaMl5G5DWaaUx9XfYg7ssrK,G8EPVSXsOYB5YQWZGiz1aVq5Pgr2GrQu,1,0,0,0,0,0,1,0,1,0.14285714285714285,1,0.0,0,0,0,0,0,0,0,1,0,0,1,1
4447,145450,YAsCREgt5tIqJEvOtaek3jtgsLn87nEr,SpATywNh6bZuzm8s1ceuBUnMUAeoAHHw,4,2,0,0,0,2,2,0,6,0.8571428571428571,1,0.0,0,0,0,0,2,2,0,2,0,0,6,1
4448,145454,kjrJbHri2dhD9BduhqLwj0qNbqxkh9F5,G8EPVSXsOYB5YQWZGiz1aVq5Pgr2GrQu,3,3,0,0,0,0,1,0,4,0.5714285714285714,1,0.0,0,0,0,0,3,0,0,1,0,0,4,1
4449,145465,IvdoAzckjyWWCkzCy6V0BjWvOwMyZEwg,A3fsA9Zfv1X2fVEQhTw51lKENdNrEqT3,21,18,15,14,1,1,6,0,55,7.857142857142857,2,0.0,0,15,13,1,18,1,1,6,0,29,26,1
4450,145469,cRlXLJdkIX4KH74JKLBjP86zQb3lppxR,bWdj2GDclj5ofokWjzoa5jAwMkxCykd6,5,2,1,0,1,0,2,0,6,0.8571428571428571,1,0.0,0,1,0,1,2,0,0,2,0,2,4,1
4451,145472,vUg72yuNvNQBasGeqPwQue3GKgSAK3Os,bWdj2GDclj5ofokWjzoa5jAwMkxCykd6,7,3,2,0,2,0,2,0,9,1.2857142857142858,2,0.0,0,2,0,2,3,0,0,2,0,4,5,1
4452,145526,SxwYiL0K8imHewBqHVzk62D1lCszL0BN,SpATywNh6bZuzm8s1ceuBUnMUAeoAHHw,1,0,0,0,0,0,1,0,1,0.14285714285714285,1,0.0,0,0,0,0,0,0,0,1,0,0,1,1
4453,145527,lmlSe7ne5kLVEzM7wObkzo8bsMDoN8xr,SpATywNh6bZuzm8s1ceuBUnMUAeoAHHw,10,5,4,0,3,0,3,0,15,2.142857142857143,1,0.0,0,4,0,3,5,0,0,3,0,7,8,1
4454,145573,azsfvKoTKLQ8ipwpPOtqZMAvWCpOjcns,7GRhBDsirIGkRZBtSMEzNTyDr2JQm4xx,11,4,3,0,3,0,4,0,14,2.0,1,0.0,0,3,0,3,4,0,0,4,0,6,8,1
4455,146936,c5MkJ205AcjWsm07YpOktUEc4lrC6DvN,RXDvfPUBYFlVdlueBFbLW0mhhAyGEqpt,1,0,0,0,0,0,1,0,1,0.14285714285714285,1,0.0,0,0,0,0,0,0,0,1,0,0,1,1
4456,146953,TkwNaNrSLynIgxaNvilfhFA70R9L2fY3,RXDvfPUBYFlVdlueBFbLW0mhhAyGEqpt,1,0,0,0,0,0,3,0,3,0.42857142857142855,1,0.0,0,0,0,0,0,0,0,3,0,0,3,0
4457,147072,8yNyyy8aPKd19nuqwaynaLkU67KuROpn,G8EPVSXsOYB5YQWZGiz1aVq5Pgr2GrQu,9,7,3,0,3,0,3,0,16,2.2857142857142856,2,0.0,0,3,0,3,7,0,0,3,0,6,10,1
4458,147073,aFc1dZRXyhduGfLgWKifgShSyZKIHAn2,G8EPVSXsOYB5YQWZGiz1aVq5Pgr2GrQu,1,0,0,0,0,0,1,0,1,0.14285714285714285,1,0.0,0,0,0,0,0,0,0,1,0,0,1,1
4459,147106,114X1vLT3OTzchhxfRGg24FTsgrs6Boi,G8EPVSXsOYB5YQWZGiz1aVq5Pgr2GrQu,1,0,0,0,0,0,1,0,1,0.14285714285714285,1,0.0,0,0,0,0,0,0,0,1,0,0,1,1
4460,147113,sL5jw3pLWZoRI7avI17oM60mfF67Acgz,RXDvfPUBYFlVdlueBFbLW0mhhAyGEqpt,1,0,0,0,0,0,2,0,2,0.2857142857142857,2,0.0,0,0,0,0,0,0,0,2,0,0,2,0
4461,147134,FmbW6BMW2tvli3L6T9qC97SAIzFg6ww1,G8EPVSXsOYB5YQWZGiz1aVq5Pgr2GrQu,1,0,0,0,0,0,1,0,1,0.14285714285714285,1,0.0,0,0,0,0,0,0,0,1,0,0,1,1
4462,147182,Z8r3kWGF2ZuWSy5TZGg00SEG4qfRh2Ag,RXDvfPUBYFlVdlueBFbLW0mhhAyGEqpt,1,0,0,0,0,0,1,0,1,0.14285714285714285,1,0.0,0,0,0,0,0,0,0,1,0,0,1,1
4463,147195,CabsQjb2Sd2I3ynTdtsErAG67rLex08f,RXDvfPUBYFlVdlueBFbLW0mhhAyGEqpt,1,0,0,0,0,0,1,0,1,0.14285714285714285,1,0.0,0,0,0,0,0,0,0,1,0,0,1,1
4464,147226,G6cW0d2bzLHgB0vreFbhNx3GSiMBKbtv,RXDvfPUBYFlVdlueBFbLW0mhhAyGEqpt,1,0,0,0,0,0,1,0,1,0.14285714285714285,1,0.0,0,0,0,0,0,0,0,1,0,0,1,1
4465,147256,mKHQM9iW9olu6z2WamdxK7ySH3UwX3JX,G8EPVSXsOYB5YQWZGiz1aVq5Pgr2GrQu,1,0,0,0,0,0,1,0,1,0.14285714285714285,1,0.0,0,0,0,0,0,0,0,1,0,0,1,1
4466,147302,yYdEa9txfr33mPdKZaxK9a9x3sCFYrvO,RXDvfPUBYFlVdlueBFbLW0mhhAyGEqpt,1,0,0,0,0,0,1,0,1,0.14285714285714285,1,0.0,0,0,0,0,0,0,0,1,0,0,1,1
4467,147396,fr3LtKJIFGCsR1nz5ebBpapeX9CBJz4r,RXDvfPUBYFlVdlueBFbLW0mhhAyGEqpt,1,0,0,0,0,0,1,0,1,0.14285714285714285,1,0.0,0,0,0,0,0,0,0,1,0,0,1,1
4468,147400,W0jA3kW6UFNLExCUVwSYpHHYwJL1vqo8,G8EPVSXsOYB5YQWZGiz1aVq5Pgr2GrQu,1,0,0,0,0,0,1,0,1,0.14285714285714285,1,0.0,0,0,0,0,0,0,0,1,0,0,1,1
4469,147402,hlub8IQ6xr3M5qQPn6YnEFWROpuhMcwL,RXDvfPUBYFlVdlueBFbLW0mhhAyGEqpt,1,0,0,0,0,0,1,0,1,0.14285714285714285,1,0.0,0,0,0,0,0,0,0,1,0,0,1,1
4470,147419,T7YlTqIDVTZFYEYihxD1Zij5IkDsmVZP,RXDvfPUBYFlVdlueBFbLW0mhhAyGEqpt,1,0,0,0,0,0,1,0,1,0.14285714285714285,1,0.0,0,0,0,0,0,0,0,1,0,0,1,1
4471,147428,qyJkLuZ2kSoWLr9To4rUoAUCy3t2DtqK,RXDvfPUBYFlVdlueBFbLW0mhhAyGEqpt,22,23,1,23,2,1,6,1,57,8.142857142857142,2,0.0,4,1,23,2,19,1,0,6,1,30,27,1
4472,147484,ly5oRv8hiewZ1JUIP5AGbwWRi69QKnfA,G8EPVSXsOYB5YQWZGiz1aVq5Pgr2GrQu,1,0,0,0,0,0,1,0,1,0.14285714285714285,1,0.0,0,0,0,0,0,0,0,1,0,0,1,1
4473,147496,fJRilHVpgCFPzgCMD6Xh8rgK6259Z6TQ,RXDvfPUBYFlVdlueBFbLW0mhhAyGEqpt,1,0,0,0,0,0,1,0,1,0.14285714285714285,1,0.0,0,0,0,0,0,0,0,1,0,0,1,1
4474,147511,GXuacM1G2BzxiXouSVLnDv1V97NGwCCe,G8EPVSXsOYB5YQWZGiz1aVq5Pgr2GrQu,1,0,0,0,0,0,1,0,1,0.14285714285714285,1,0.0,0,0,0,0,0,0,0,1,0,0,1,1
4475,147512,WnXohtCVTjGmg2VYZ7QMusUaSQiMqg1z,G8EPVSXsOYB5YQWZGiz1aVq5Pgr2GrQu,1,0,0,0,0,0,1,0,1,0.14285714285714285,1,0.0,0,0,0,0,0,0,0,1,0,0,1,1
4476,147519,nYcDj7802ShzcCKfMPZblsaYoLQlLfFa,RXDvfPUBYFlVdlueBFbLW0mhhAyGEqpt,1,0,0,0,0,0,2,0,2,0.2857142857142857,1,0.0,0,0,0,0,0,0,0,2,0,0,2,1
4477,147558,FgDDMWCPhLKDQm2tOcaDRFOiW3MmNhxn,RXDvfPUBYFlVdlueBFbLW0mhhAyGEqpt,1,0,0,0,0,0,1,0,1,0.14285714285714285,1,0.0,0,0,0,0,0,0,0,1,0,0,1,1
4478,147627,qtx0N6lbHC7rLYVDABZMZjBHS66niL8J,RXDvfPUBYFlVdlueBFbLW0mhhAyGEqpt,1,0,0,0,0,0,1,0,1,0.14285714285714285,1,0.0,0,0,0,0,0,0,0,1,0,0,1,1
4479,147631,V1B34PKYcESnicIbQVUA4gpuU2uOqNWz,G8EPVSXsOYB5YQWZGiz1aVq5Pgr2GrQu,1,0,0,0,0,0,1,0,1,0.14285714285714285,1,0.0,0,0,0,0,0,0,0,1,0,0,1,1
4480,147661,8Eqf4bSicFmRziRU1kFgF89C5yGB8WDX,RXDvfPUBYFlVdlueBFbLW0mhhAyGEqpt,1,0,0,0,0,0,2,0,2,0.2857142857142857,2,0.0,0,0,0,0,0,0,0,2,0,0,2,1
4481,147668,RXybWoyBfxb1StD4gTX3cQ7Ir2hHF7eD,G8EPVSXsOYB5YQWZGiz1aVq5Pgr2GrQu,1,0,0,0,0,0,1,0,1,0.14285714285714285,1,0.0,0,0,0,0,0,0,0,1,0,0,1,1
4482,147692,97s9Gq3v1SpdnbcXTUeP0PbnntkfF2Gl,G8EPVSXsOYB5YQWZGiz1aVq5Pgr2GrQu,1,0,0,0,0,0,1,0,1,0.14285714285714285,1,0.0,0,0,0,0,0,0,0,1,0,0,1,1
4483,147731,y25cTP8mHUkaHLXFWhaRvqNBGzTMte3f,RXDvfPUBYFlVdlueBFbLW0mhhAyGEqpt,1,0,0,0,0,0,1,0,1,0.14285714285714285,1,0.0,0,0,0,0,0,0,0,1,0,0,1,1
4484,148349,9ygD0mCVCT1xftgjX9ZtkVBAEBAxmXMV,fbPkOYLVPtPgIt0MxizjfFJov3JbHyAi,4,3,2,0,2,0,1,0,8,1.1428571428571428,1,0.0,0,2,0,2,3,0,0,1,0,4,4,1
4485,148350,c9Dj079MYKUiWTTvAk5TtHXcSaCd3TDw,fbPkOYLVPtPgIt0MxizjfFJov3JbHyAi,5,3,2,0,0,0,8,0,13,1.8571428571428572,1,0.0,0,2,0,0,3,0,0,8,0,2,11,1
4486,148353,kxG2Ez4bVR5aERCBG6xs61rr9emGwqKo,fbPkOYLVPtPgIt0MxizjfFJov3JbHyAi,1,0,0,0,0,0,1,0,1,0.14285714285714285,1,0.0,0,0,0,0,0,0,0,1,0,0,1,1
4487,148358,bgLrRcnTjnOSlAj1yyvNbcR2GZlKU2gU,fbPkOYLVPtPgIt0MxizjfFJov3JbHyAi,25,30,13,12,10,15,2,0,82,11.714285714285714,1,0.0,12,13,10,10,18,15,2,2,0,45,37,1
4488,148366,fi4TXeoZ9lfPojTLqkoAXZWQgcUwi3WY,fbPkOYLVPtPgIt0MxizjfFJov3JbHyAi,9,2,2,0,2,4,6,1,17,2.4285714285714284,1,0.0,0,2,0,2,2,4,0,6,1,4,13,1
4489,148367,CUHsvexAAfaCEMKsM3644JTxXL5DgSss,fbPkOYLVPtPgIt0MxizjfFJov3JbHyAi,5,3,2,0,2,0,2,0,9,1.2857142857142858,1,0.0,0,2,0,2,3,0,0,2,0,4,5,1
4490,148368,0oCNqxLZfnQykzt9jEtrYeCAvyN5aMiK,fbPkOYLVPtPgIt0MxizjfFJov3JbHyAi,2,0,0,0,0,0,5,0,5,0.7142857142857143,1,0.0,0,0,0,0,0,0,0,5,0,0,5,1
4491,148371,ULdF32fTmMpV957Ngz6P80D0kuxYFb2A,fbPkOYLVPtPgIt0MxizjfFJov3JbHyAi,1,0,0,0,0,0,1,0,1,0.14285714285714285,1,0.0,0,0,0,0,0,0,0,1,0,0,1,1
4492,148375,9LHCfUuBRybCFmCd7bbV3yZ92Mp8tv7j,fbPkOYLVPtPgIt0MxizjfFJov3JbHyAi,1,0,0,0,0,0,1,0,1,0.14285714285714285,1,0.0,0,0,0,0,0,0,0,1,0,0,1,1
4493,148378,KalDXAC9uFbnu9AKEx3pGk1aVT7IBvd6,fbPkOYLVPtPgIt0MxizjfFJov3JbHyAi,2,0,0,0,0,0,3,0,3,0.42857142857142855,1,0.0,0,0,0,0,0,0,0,3,0,0,3,1
4494,148379,MKj9RE36KMaNQttYmK1FP436E01YmNeZ,fbPkOYLVPtPgIt0MxizjfFJov3JbHyAi,2,0,0,0,0,0,2,0,2,0.2857142857142857,1,0.0,0,0,0,0,0,0,0,2,0,0,2,1
4495,148381,WYlT48XIScuGFSR7mYrH3M5CfjOCOMTP,fbPkOYLVPtPgIt0MxizjfFJov3JbHyAi,13,12,1,0,1,0,3,0,17,2.4285714285714284,1,0.0,0,1,0,1,12,0,0,3,0,2,15,1
4496,148382,qJEf5DGSDkSxZ1JIhipEbBFRbrhnAj1a,fbPkOYLVPtPgIt0MxizjfFJov3JbHyAi,6,8,2,0,1,0,2,0,13,1.8571428571428572,1,0.0,0,2,0,1,8,0,0,2,0,3,10,1
4497,148383,9TLjVfAVQirUv9D0iCSnjtMLWmZOKr0C,fbPkOYLVPtPgIt0MxizjfFJov3JbHyAi,7,3,2,0,2,0,4,0,11,1.5714285714285714,1,0.0,0,2,0,2,3,0,0,4,0,4,7,1
4498,148384,EQVGtOGC6NrveIndUoSckLgaBol5CW91,fbPkOYLVPtPgIt0MxizjfFJov3JbHyAi,1,0,0,0,0,0,1,0,1,0.14285714285714285,1,0.0,0,0,0,0,0,0,0,1,0,0,1,1
4499,148385,ciDinbfum1guAgZtUPEyI6UQ7y3ahoVh,fbPkOYLVPtPgIt0MxizjfFJov3JbHyAi,6,3,2,0,2,0,1,0,8,1.1428571428571428,1,0.0,0,2,0,2,3,0,0,1,0,4,4,1
4500,148388,idmrxuEoIjSYuzZhdG66vR2sh6aBS2ui,fbPkOYLVPtPgIt0MxizjfFJov3JbHyAi,2,0,0,0,0,0,2,0,2,0.2857142857142857,1,0.0,0,0,0,0,0,0,0,2,0,0,2,1
4501,148465,aISyThuiw10fsCPPUtqVz2ccwIDIESls,G8EPVSXsOYB5YQWZGiz1aVq5Pgr2GrQu,44,99,50,110,0,73,27,1,360,51.42857142857143,5,0.0,9,50,97,0,90,73,13,27,1,156,204,0
4502,148503,9CQfIvDiQz4gDArSnTXOgxNKUwJW75pD,SpATywNh6bZuzm8s1ceuBUnMUAeoAHHw,16,24,13,20,5,2,18,3,85,12.142857142857142,2,0.0,2,13,16,5,22,2,4,18,3,36,49,0
4503,148611,oGTSG0bYZEKmqMQUI2QOgfbr6I1mZJJh,SpATywNh6bZuzm8s1ceuBUnMUAeoAHHw,14,22,1,18,1,0,21,1,64,9.142857142857142,2,0.0,7,1,15,1,15,0,3,21,1,24,40,1
4504,148708,QffrhmaCXbaB9XOhV3NLOmPuRvGWA3G5,SpATywNh6bZuzm8s1ceuBUnMUAeoAHHw,16,7,4,9,3,0,5,1,29,4.142857142857143,1,0.0,2,4,9,3,5,0,0,5,1,18,11,1
4505,148724,4YDp1nxKf6ZgyVxOrG2MY3nyG30jIlTN,SpATywNh6bZuzm8s1ceuBUnMUAeoAHHw,13,21,10,10,6,0,8,0,55,7.857142857142857,2,0.0,2,10,9,6,19,0,1,8,0,27,28,1
4506,148773,f2RxaLdYf2Tr0XIXAiBwlA7VXVA1XDPz,SpATywNh6bZuzm8s1ceuBUnMUAeoAHHw,17,39,16,20,6,4,12,1,98,14.0,1,0.0,17,16,16,6,22,4,4,12,1,55,43,1
4507,148776,6EaK0gHFiSwbLJpDVBHv9ZNNoyIiEert,SpATywNh6bZuzm8s1ceuBUnMUAeoAHHw,8,13,4,8,0,0,3,0,28,4.0,1,0.0,4,4,8,0,9,0,0,3,0,16,12,0
4508,148992,4OV0W0nOUO05rXo3pxbmiSLc9O458KIT,SpATywNh6bZuzm8s1ceuBUnMUAeoAHHw,3,1,0,0,0,0,2,0,3,0.42857142857142855,1,0.0,0,0,0,0,1,0,0,2,0,0,3,0
4509,149014,5UJZmEar1AX3gQXOzkh3MnQcYdErI17M,bWdj2GDclj5ofokWjzoa5jAwMkxCykd6,6,5,3,0,2,7,2,0,19,2.7142857142857144,1,0.0,0,3,0,2,5,7,0,2,0,5,14,0
4510,149570,8958pt2z4OHwTl32JK0k9CAPziEN4Bzu,SpATywNh6bZuzm8s1ceuBUnMUAeoAHHw,5,3,0,0,0,11,4,0,18,2.5714285714285716,1,0.0,0,0,0,0,3,11,0,4,0,0,18,1
4511,149617,8aV4yRTVM0HzdlWjuQKHgiNXm0RErk1U,bWdj2GDclj5ofokWjzoa5jAwMkxCykd6,4,2,0,0,0,0,5,0,7,1.0,1,0.0,0,0,0,0,2,0,0,5,0,0,7,0
4512,149692,7AAdXAGWvappN7B38jOB9fzxLSuIXADG,RXDvfPUBYFlVdlueBFbLW0mhhAyGEqpt,5,2,1,0,1,0,2,0,6,0.8571428571428571,1,0.0,0,1,0,1,2,0,0,2,0,2,4,0
4513,149877,SANLEmv2xqr9UbPUpTzbFGNJfLVXFrzf,SpATywNh6bZuzm8s1ceuBUnMUAeoAHHw,15,21,1,21,0,38,9,1,91,13.0,1,0.0,7,1,17,0,14,38,4,9,1,25,66,1
4514,149950,byUmCtzRLWWrWRajFZnozMEalaeEKWAr,RXDvfPUBYFlVdlueBFbLW0mhhAyGEqpt,17,11,7,14,5,0,1,0,38,5.428571428571429,1,0.0,2,7,14,5,9,0,0,1,0,28,10,1
4515,153072,IOcEoixO9HVhIQeLNHKaS3iQynrmSTmV,7GRhBDsirIGkRZBtSMEzNTyDr2JQm4xx,34,118,28,55,3,24,26,3,257,36.714285714285715,3,0.0,76,28,43,3,42,24,12,26,3,150,107,0
4516,153205,pvxjw4szSuluDWQ3DWPes9Mzs1MCvxjI,SpATywNh6bZuzm8s1ceuBUnMUAeoAHHw,16,18,10,20,6,4,16,4,78,11.142857142857142,3,0.0,3,10,16,6,15,4,4,16,4,35,43,1
4517,153222,qGeBgOr7St26ZmQVIT5NibjBEisNw9ln,SpATywNh6bZuzm8s1ceuBUnMUAeoAHHw,17,17,11,11,5,2,8,1,55,7.857142857142857,3,0.0,2,11,10,5,15,2,1,8,1,28,27,1
4518,153304,AxjnggPTKyT2aYQCBpgnjenDZZbNsOpc,SpATywNh6bZuzm8s1ceuBUnMUAeoAHHw,8,6,1,2,0,0,1,0,10,1.4285714285714286,1,0.0,0,1,2,0,6,0,0,1,0,3,7,0
4519,153457,cYe4n4c9KPDfBEWjGIRj6ImLxtmj3FnE,SpATywNh6bZuzm8s1ceuBUnMUAeoAHHw,12,9,6,2,4,1,5,1,28,4.0,1,0.0,0,6,2,4,9,1,0,5,1,12,16,0
4520,153600,f1mXA42Iut2h3an7dNcb6e25YzQPcYho,SpATywNh6bZuzm8s1ceuBUnMUAeoAHHw,4,3,1,0,0,0,2,0,6,0.8571428571428571,1,0.0,0,1,0,0,3,0,0,2,0,1,5,1
4521,153638,npggYhQDuWIBT1CD0vElHVM5v5VjjGlP,SpATywNh6bZuzm8s1ceuBUnMUAeoAHHw,9,6,4,0,3,0,2,0,15,2.142857142857143,1,0.0,0,4,0,3,6,0,0,2,0,7,8,1
4522,153708,cX96KcLUG7eWbqHO7enIWngg59YqtKEY,SpATywNh6bZuzm8s1ceuBUnMUAeoAHHw,13,28,12,14,1,4,8,2,69,9.857142857142858,2,0.0,12,12,13,1,16,4,1,8,2,38,31,1
4523,153744,ttb5iuebPMlcVHZPAjxVbJ8njCe9OqDr,SpATywNh6bZuzm8s1ceuBUnMUAeoAHHw,9,10,3,0,3,0,5,0,21,3.0,2,0.0,0,3,0,3,10,0,0,5,0,6,15,1
4524,153775,NDTWRDiLyYPUSKAzpsOEnrkggSOfO91T,SpATywNh6bZuzm8s1ceuBUnMUAeoAHHw,14,40,23,20,10,0,5,0,98,14.0,2,0.0,9,23,17,10,31,0,3,5,0,59,39,1
4525,153860,ZNBGAlJve4TYJ3FcDlTLBdyuklADldDZ,A3fsA9Zfv1X2fVEQhTw51lKENdNrEqT3,4,2,1,0,1,0,1,0,5,0.7142857142857143,1,0.0,0,1,0,1,2,0,0,1,0,2,3,1
4526,153939,ECkqmAuIkv3ncN9wNJby8oOn15qTd9kR,bWdj2GDclj5ofokWjzoa5jAwMkxCykd6,2,0,0,0,0,0,2,0,2,0.2857142857142857,2,0.0,0,0,0,0,0,0,0,2,0,0,2,1
4527,153970,rK6GKHeyjKWUALwDzkIRQ6keCnDOngXi,SpATywNh6bZuzm8s1ceuBUnMUAeoAHHw,9,10,3,8,0,0,4,0,25,3.5714285714285716,2,0.0,6,3,8,0,4,0,0,4,0,17,8,1
4528,153981,PWSenA2xTFV9h2dRBUmJc6Dd5CU49Bfk,SpATywNh6bZuzm8s1ceuBUnMUAeoAHHw,8,3,3,0,2,0,3,0,11,1.5714285714285714,2,0.0,0,3,0,2,3,0,0,3,0,5,6,1
4529,154004,Cf7GCeUZzG7WjvUIyGfwv9hfcwXPVq5G,SpATywNh6bZuzm8s1ceuBUnMUAeoAHHw,13,30,0,15,0,9,7,0,61,8.714285714285714,4,0.0,3,0,14,0,27,9,1,7,0,17,44,0
4530,154035,DHCzWncH94ErnybHPppeaE2nTRJmmMhY,SpATywNh6bZuzm8s1ceuBUnMUAeoAHHw,17,53,18,25,7,29,10,4,146,20.857142857142858,1,0.0,28,18,20,7,25,29,5,10,4,73,73,1
4531,154133,zUPpTYisLLzFG12BVDvWrty0j8q1G6Si,SpATywNh6bZuzm8s1ceuBUnMUAeoAHHw,14,19,1,11,2,5,6,1,45,6.428571428571429,3,0.0,8,1,10,2,11,5,1,6,1,21,24,0
4532,154181,BXV7sGq2IrRSqCFuLKgoxpKYDPSPpUSj,A3fsA9Zfv1X2fVEQhTw51lKENdNrEqT3,1,0,0,0,0,0,1,0,1,0.14285714285714285,1,0.0,0,0,0,0,0,0,0,1,0,0,1,1
4533,154222,Csfk45aTs4wr0LJ69dzlrUlkEXjL89zd,bWdj2GDclj5ofokWjzoa5jAwMkxCykd6,4,2,1,0,1,3,2,0,9,1.2857142857142858,1,0.0,0,1,0,1,2,3,0,2,0,2,7,0
4534,154303,UsP8UHahXGHaChNTAHL4dZh6OmvP94L7,7GRhBDsirIGkRZBtSMEzNTyDr2JQm4xx,15,12,6,0,5,13,9,1,46,6.571428571428571,2,0.0,0,6,0,5,12,13,0,9,1,11,35,1
4535,154415,sL5jw3pLWZoRI7avI17oM60mfF67Acgz,bWdj2GDclj5ofokWjzoa5jAwMkxCykd6,1,0,0,0,0,0,1,0,1,0.14285714285714285,1,0.0,0,0,0,0,0,0,0,1,0,0,1,0
4536,154555,hUoOQP103jtoSjE8huNXPy5FlXS050j3,7GRhBDsirIGkRZBtSMEzNTyDr2JQm4xx,4,2,1,0,0,0,2,0,5,0.7142857142857143,1,0.0,0,1,0,0,2,0,0,2,0,1,4,1
4537,154572,IZjvzkwq6mW6mk7nIYbEArtjalxzWdW9,SpATywNh6bZuzm8s1ceuBUnMUAeoAHHw,4,2,1,0,1,0,1,0,5,0.7142857142857143,1,0.0,0,1,0,1,2,0,0,1,0,2,3,1
4538,154617,Z9nbZek76s4RBuA56w1WtME3e9ClZkaP,7GRhBDsirIGkRZBtSMEzNTyDr2JQm4xx,4,2,0,0,0,0,2,0,4,0.5714285714285714,1,0.0,0,0,0,0,2,0,0,2,0,0,4,1
4539,154691,ZnPDiA6jmqQOIbODvVYNoIgZSaO1dso9,7GRhBDsirIGkRZBtSMEzNTyDr2JQm4xx,5,2,1,0,1,0,2,0,6,0.8571428571428571,1,0.0,0,1,0,1,2,0,0,2,0,2,4,1
4540,154722,wEtddkCnDW67OGRvoryp7gzDvLpg5XYx,7GRhBDsirIGkRZBtSMEzNTyDr2JQm4xx,2,0,0,0,0,0,2,0,2,0.2857142857142857,1,0.0,0,0,0,0,0,0,0,2,0,0,2,1
4541,154784,Hz0LP3au6HFJJqiLBqYxNiliqJ4HLt82,7GRhBDsirIGkRZBtSMEzNTyDr2JQm4xx,2,0,0,0,0,0,2,0,2,0.2857142857142857,1,0.0,0,0,0,0,0,0,0,2,0,0,2,1
4542,154795,X7yAkPsl5rqRM0rJWJ1Nk7IUSPBbdZXP,7GRhBDsirIGkRZBtSMEzNTyDr2JQm4xx,2,0,0,0,0,0,3,0,3,0.42857142857142855,2,0.0,0,0,0,0,0,0,0,3,0,0,3,1
4543,154819,9bv4TssyKs6woXSaEFvigyhEyIkdO1mQ,SpATywNh6bZuzm8s1ceuBUnMUAeoAHHw,7,5,4,0,3,0,1,0,13,1.8571428571428572,1,0.0,0,4,0,3,5,0,0,1,0,7,6,1
4544,154867,GnGb3MjVBgYFavJRehOmmU05ktvVgJLM,SpATywNh6bZuzm8s1ceuBUnMUAeoAHHw,12,14,1,9,0,0,7,0,31,4.428571428571429,2,0.0,2,1,9,0,12,0,0,7,0,12,19,0
4545,154879,eLVxEJXOj5JCDBaPnfFyMxorDIkKR9kF,7GRhBDsirIGkRZBtSMEzNTyDr2JQm4xx,5,4,0,0,0,0,2,0,6,0.8571428571428571,1,0.0,0,0,0,0,4,0,0,2,0,0,6,1
4546,154900,MQZ83qOJRka3gcNvl5FCRvHenmiUnsd9,7GRhBDsirIGkRZBtSMEzNTyDr2JQm4xx,7,5,0,0,0,4,4,0,13,1.8571428571428572,1,0.0,1,0,0,0,4,4,0,4,0,1,12,1
4547,154958,uCkUGoRSr1o0e7C3DgvaHjtZmuIVbEoc,7GRhBDsirIGkRZBtSMEzNTyDr2JQm4xx,16,19,4,16,7,0,4,0,50,7.142857142857143,1,0.0,14,4,14,7,5,0,2,4,0,39,11,1
4548,154969,zWDepCfjbS7ISrpw6SZrVfUm7fvpWJYm,RXDvfPUBYFlVdlueBFbLW0mhhAyGEqpt,44,33,19,56,20,0,4,0,132,18.857142857142858,1,0.0,11,19,54,20,22,0,2,4,0,104,28,1
4549,154971,T6EWQ7jVP89JlHzj41KN1gEtGYevpSQM,7GRhBDsirIGkRZBtSMEzNTyDr2JQm4xx,20,27,16,5,10,1,1,0,60,8.571428571428571,1,0.0,10,16,5,10,17,1,0,1,0,41,19,1
4550,155081,erkNYBqLpKRElyeL8GeAgO43CMazg6Rt,7GRhBDsirIGkRZBtSMEzNTyDr2JQm4xx,4,0,0,0,0,0,4,0,4,0.5714285714285714,1,0.0,0,0,0,0,0,0,0,4,0,0,4,1
4551,155201,Yg9hgHRSCdpITsjHOmkyqEwp1aNMC9ra,7GRhBDsirIGkRZBtSMEzNTyDr2JQm4xx,4,2,0,0,0,0,4,0,6,0.8571428571428571,2,0.0,0,0,0,0,2,0,0,4,0,0,6,1
4552,155228,QZIRHdwFgibI2SBehTrmLAZxED1F4JL7,SpATywNh6bZuzm8s1ceuBUnMUAeoAHHw,7,8,3,0,1,0,2,0,14,2.0,2,0.0,0,3,0,1,8,0,0,2,0,4,10,0
4553,155249,6T4qq3cdISFF5pyvVKMrcmEINY6BysCY,7GRhBDsirIGkRZBtSMEzNTyDr2JQm4xx,1,0,0,0,0,0,1,0,1,0.14285714285714285,1,0.0,0,0,0,0,0,0,0,1,0,0,1,1
4554,155367,LSvU72CFq1TrHd9SCZOiKQ0qcV2oa2Ok,SpATywNh6bZuzm8s1ceuBUnMUAeoAHHw,3,2,0,0,0,0,1,0,3,0.42857142857142855,1,0.0,0,0,0,0,2,0,0,1,0,0,3,1
4555,155391,mV4YsIiA8Oc8PxZhA2HzdmyhI1ZXRUSS,SpATywNh6bZuzm8s1ceuBUnMUAeoAHHw,16,28,12,10,5,0,7,0,62,8.857142857142858,1,0.0,6,12,10,5,22,0,0,7,0,33,29,1
4556,155453,lmCPiW6l0WNp9Ttn0lhwFDs7FfVubtvY,bWdj2GDclj5ofokWjzoa5jAwMkxCykd6,5,6,0,0,0,0,1,0,7,1.0,1,0.0,0,0,0,0,6,0,0,1,0,0,7,1
4557,155553,bpGV6fnSXAO5YTgsxVkdmYC0rSgonD8Y,SpATywNh6bZuzm8s1ceuBUnMUAeoAHHw,5,5,1,0,1,0,1,0,8,1.1428571428571428,1,0.0,0,1,0,1,5,0,0,1,0,2,6,1
4558,155580,RRM0TElcCY25pdcWRkMGxwCn30ehvK5c,SpATywNh6bZuzm8s1ceuBUnMUAeoAHHw,2,0,0,0,0,0,2,0,2,0.2857142857142857,1,0.0,0,0,0,0,0,0,0,2,0,0,2,0
4559,155745,bcDgsH6ZU4RUVLG7I2fsAvcl6B7ySYCd,RXDvfPUBYFlVdlueBFbLW0mhhAyGEqpt,1,0,0,0,0,0,1,0,1,0.14285714285714285,1,0.0,0,0,0,0,0,0,0,1,0,0,1,1
4560,155826,VFaDw1WYcOtIcsxfLW3x5fsJ2JkUIOUZ,G8EPVSXsOYB5YQWZGiz1aVq5Pgr2GrQu,47,47,22,70,15,8,13,1,176,25.142857142857142,2,0.0,20,22,60,15,27,8,10,13,1,117,59,0
4561,156569,OLSxCkluLildKVrVnzRIsj47tt9tVHj9,A3fsA9Zfv1X2fVEQhTw51lKENdNrEqT3,1,0,0,0,0,0,1,0,1,0.14285714285714285,1,0.0,0,0,0,0,0,0,0,1,0,0,1,1
4562,156717,X535Iu5jdKv0ppLqkwhIGZajlbhLXvmn,bWdj2GDclj5ofokWjzoa5jAwMkxCykd6,6,2,1,0,1,0,3,0,7,1.0,1,0.0,0,1,0,1,2,0,0,3,0,2,5,1
4563,157347,5ehf4EFN8WhDbvmb2WvfZwpaBD0cj1oj,7GRhBDsirIGkRZBtSMEzNTyDr2JQm4xx,11,10,0,0,0,0,3,0,13,1.8571428571428572,2,0.0,0,0,0,0,10,0,0,3,0,0,13,1
4564,157488,abZjyy6CkJwLuRnRyGB2GrxhAkPifaxi,7GRhBDsirIGkRZBtSMEzNTyDr2JQm4xx,5,2,0,0,0,0,5,0,7,1.0,1,0.0,0,0,0,0,2,0,0,5,0,0,7,1
4565,160693,0bGwsopOrJy9wTuBbyPfl2hvYAxstsYA,7GRhBDsirIGkRZBtSMEzNTyDr2JQm4xx,1,0,0,0,0,0,1,0,1,0.14285714285714285,1,0.0,0,0,0,0,0,0,0,1,0,0,1,1
4566,160716,Jov3UvG5K4pASWh5oCQTME29q3GomczT,7GRhBDsirIGkRZBtSMEzNTyDr2JQm4xx,1,0,0,0,0,0,1,0,1,0.14285714285714285,1,0.0,0,0,0,0,0,0,0,1,0,0,1,1
4567,160726,8E88mVxxHiSEV3ReMbiLkIuYAxJ6YXeO,bWdj2GDclj5ofokWjzoa5jAwMkxCykd6,4,7,4,0,0,0,4,0,15,2.142857142857143,1,0.0,0,4,0,0,7,0,0,4,0,4,11,1
4568,160802,vaWLVKWyrsUzDV0qs20ZUq8M3VNW01Uk,SpATywNh6bZuzm8s1ceuBUnMUAeoAHHw,1,0,0,0,0,0,2,0,2,0.2857142857142857,1,0.0,0,0,0,0,0,0,0,2,0,0,2,1
4569,161011,1b3NSfxfxI6DroelosS7m4rEEtzhJZdR,7GRhBDsirIGkRZBtSMEzNTyDr2JQm4xx,1,0,0,0,0,0,1,0,1,0.14285714285714285,1,0.0,0,0,0,0,0,0,0,1,0,0,1,1
4570,161065,2JYViuOLvusjF5jXM0OPt6GS91aIip1x,SpATywNh6bZuzm8s1ceuBUnMUAeoAHHw,1,0,0,0,0,0,1,0,1,0.14285714285714285,1,0.0,0,0,0,0,0,0,0,1,0,0,1,1
4571,161171,rhgA2X0g2BW5I3tYIXFENYW4L8ORdfpR,7GRhBDsirIGkRZBtSMEzNTyDr2JQm4xx,14,11,2,28,3,0,2,0,46,6.571428571428571,1,0.0,6,2,25,3,5,0,3,2,0,36,10,1
4572,161244,F5WXvUA8z1Vfdvlva1pujweut7tGE04r,7GRhBDsirIGkRZBtSMEzNTyDr2JQm4xx,2,0,0,0,0,0,2,0,2,0.2857142857142857,1,0.0,0,0,0,0,0,0,0,2,0,0,2,1
4573,161310,B5jlZpEDxUNGCe4UQsaYbJ99Z8y5d2lN,7GRhBDsirIGkRZBtSMEzNTyDr2JQm4xx,9,4,3,0,3,0,2,0,12,1.7142857142857142,1,0.0,0,3,0,3,4,0,0,2,0,6,6,1
4574,161369,NMciPbdIeB9uIZwCMcw6mXU2i3BtnB5v,7GRhBDsirIGkRZBtSMEzNTyDr2JQm4xx,7,5,4,0,4,0,2,0,15,2.142857142857143,1,0.0,0,4,0,4,5,0,0,2,0,8,7,1
4575,161526,6HIBebNSnNEoSeekVShzxF3x0IcbgohT,7GRhBDsirIGkRZBtSMEzNTyDr2JQm4xx,1,0,0,0,0,0,1,0,1,0.14285714285714285,1,0.0,0,0,0,0,0,0,0,1,0,0,1,1
4576,161578,Xo1RSitSiG1YTKsWiGb48lb1j1pDp5LC,7GRhBDsirIGkRZBtSMEzNTyDr2JQm4xx,1,0,0,0,0,0,1,0,1,0.14285714285714285,1,0.0,0,0,0,0,0,0,0,1,0,0,1,1
4577,161642,zT5Abo7SNHsAkCFKMvhJJJDWNu2sl4mh,bWdj2GDclj5ofokWjzoa5jAwMkxCykd6,5,0,0,0,0,1,4,3,8,1.1428571428571428,1,0.0,0,0,0,0,0,1,0,4,3,0,8,1
4578,161670,IFqWOl32JJm0W3Ap2jxVCpJeXeLJlYDp,7GRhBDsirIGkRZBtSMEzNTyDr2JQm4xx,1,0,0,0,0,0,1,0,1,0.14285714285714285,1,0.0,0,0,0,0,0,0,0,1,0,0,1,1
4579,161671,Rlp934Hm4YHO5gcLihEiFevqZ5FBvHF8,SpATywNh6bZuzm8s1ceuBUnMUAeoAHHw,8,6,3,0,3,0,2,0,14,2.0,1,0.0,0,3,0,3,6,0,0,2,0,6,8,0
4580,161809,IW1yqY6AJLLD0UdkPHoBC5FNys4RF3Rc,A3fsA9Zfv1X2fVEQhTw51lKENdNrEqT3,10,5,1,0,0,1,12,1,20,2.857142857142857,1,0.0,0,1,0,0,5,1,0,12,1,1,19,0
4581,162029,OUbrW18OgibVb4I41eHFiFhkobpgjEP2,A3fsA9Zfv1X2fVEQhTw51lKENdNrEqT3,24,17,11,0,10,0,6,0,44,6.285714285714286,1,0.0,0,11,0,10,17,0,0,6,0,21,23,0
4582,162677,JJDWSR5T5OI58OQCJ2rXYW6lv04IiDvD,fbPkOYLVPtPgIt0MxizjfFJov3JbHyAi,11,4,2,0,3,10,5,1,25,3.5714285714285716,1,0.0,0,2,0,3,4,10,0,5,1,5,20,1
4583,163446,vYZLFtHzbRZEyiuRAYkPU2TurFaRRb3e,bWdj2GDclj5ofokWjzoa5jAwMkxCykd6,7,7,4,0,3,0,3,0,17,2.4285714285714284,3,0.0,1,4,0,3,6,0,0,3,0,8,9,1
4584,163447,CR6hbwvXPZHEYYcI4AAX4civM4Pp6Aex,bWdj2GDclj5ofokWjzoa5jAwMkxCykd6,7,2,1,0,1,0,4,0,8,1.1428571428571428,2,0.0,0,1,0,1,2,0,0,4,0,2,6,1
4585,163451,rUr3hxt1niPeDbjT1dWASqAoHDERYMHJ,bWdj2GDclj5ofokWjzoa5jAwMkxCykd6,16,12,4,44,2,5,2,0,69,9.857142857142858,2,0.0,4,4,41,2,8,5,3,2,0,51,18,0
4586,163452,CLgDvHjU8d0JuEtHgdUcLQg1OZ6hE3A8,RXDvfPUBYFlVdlueBFbLW0mhhAyGEqpt,19,18,10,18,7,0,5,0,58,8.285714285714286,2,0.0,4,10,18,7,14,0,0,5,0,39,19,1
4587,163456,QW07WKWuMa47F3DVH5YhQbGmBNCRc0FZ,SpATywNh6bZuzm8s1ceuBUnMUAeoAHHw,9,5,1,16,1,2,4,1,30,4.285714285714286,1,0.0,2,1,13,1,3,2,3,4,1,17,13,1
4588,163459,eq3avF6QxxFlcD9gaMIYsKSt5Td1igiD,SpATywNh6bZuzm8s1ceuBUnMUAeoAHHw,12,16,2,18,0,0,5,0,41,5.857142857142857,1,0.0,5,2,15,0,11,0,3,5,0,22,19,1
4589,163463,hFpufo5lTiocFSjp5de4hLz459xEY6dx,G8EPVSXsOYB5YQWZGiz1aVq5Pgr2GrQu,12,5,3,0,2,4,8,1,23,3.2857142857142856,1,0.0,0,3,0,2,5,4,0,8,1,5,18,1
4590,163468,GGdBzvTskjxKAvNdibnhPPkGKFTKpZaL,SpATywNh6bZuzm8s1ceuBUnMUAeoAHHw,4,3,0,0,0,0,3,0,6,0.8571428571428571,1,0.0,0,0,0,0,3,0,0,3,0,0,6,1
4591,163473,m580K62zl9ih2EBTcM6Y53ygfq7rAv69,RXDvfPUBYFlVdlueBFbLW0mhhAyGEqpt,1,0,0,0,0,0,1,0,1,0.14285714285714285,1,0.0,0,0,0,0,0,0,0,1,0,0,1,1
4592,163474,2sDQ5DmJB14fdhYiHWrjTNImvS7e7hHg,RXDvfPUBYFlVdlueBFbLW0mhhAyGEqpt,9,6,5,0,4,1,5,1,22,3.142857142857143,2,0.0,0,5,0,4,6,1,0,5,1,9,13,1
4593,163489,5IM8g7YMOYo5qH7Yu3x31T3JkVOH9iqe,RXDvfPUBYFlVdlueBFbLW0mhhAyGEqpt,8,12,4,0,2,0,1,0,19,2.7142857142857144,2,0.0,1,4,0,2,11,0,0,1,0,7,12,1
4594,163492,ni5dUdHYqNJ6ClZBex2HryO1vDE1ZkoU,SpATywNh6bZuzm8s1ceuBUnMUAeoAHHw,4,1,0,0,0,0,3,0,4,0.5714285714285714,1,0.0,0,0,0,0,1,0,0,3,0,0,4,1
4595,163495,ww05exVvqmTpHRLpMlcyyiyf25IJQarF,bWdj2GDclj5ofokWjzoa5jAwMkxCykd6,4,2,1,0,1,0,2,0,6,0.8571428571428571,1,0.0,0,1,0,1,2,0,0,2,0,2,4,1
4596,163498,KemVogD4rWuutYcMfAZRpTjVQNkGCf1a,bWdj2GDclj5ofokWjzoa5jAwMkxCykd6,6,6,2,0,2,0,1,0,11,1.5714285714285714,1,0.0,2,2,0,2,4,0,0,1,0,6,5,1
4597,163503,q1KcO9Dg3vZiLgj3uBWo2HFsUXBuH0Hl,RXDvfPUBYFlVdlueBFbLW0mhhAyGEqpt,12,8,1,21,1,0,2,0,33,4.714285714285714,1,0.0,2,1,17,1,6,0,4,2,0,21,12,1
4598,163511,i0ksX07HnsV5rQlWqOr1uKEuc7yNU24c,bWdj2GDclj5ofokWjzoa5jAwMkxCykd6,13,23,10,0,6,48,13,1,101,14.428571428571429,2,0.0,7,10,0,6,16,48,0,13,1,23,78,1
4599,163517,RAAFt7jgkqGMpy4rUVomxkKt5lfbto8C,SpATywNh6bZuzm8s1ceuBUnMUAeoAHHw,5,1,0,0,0,1,7,1,10,1.4285714285714286,2,0.0,0,0,0,0,1,1,0,7,1,0,10,1
4600,163520,gFwcy6HlQMHgKm8VCXe5qQxUXfgM5CMM,RXDvfPUBYFlVdlueBFbLW0mhhAyGEqpt,18,31,11,2,5,0,3,0,52,7.428571428571429,2,0.0,1,11,2,5,30,0,0,3,0,19,33,1
4601,163521,vvZAdi1giBsqNJd2MIMUF2BeNIuSYzIL,bWdj2GDclj5ofokWjzoa5jAwMkxCykd6,5,2,1,0,1,0,2,0,6,0.8571428571428571,1,0.0,0,1,0,1,2,0,0,2,0,2,4,1
4602,163522,0z2VYcRtlKJQ1Og2a3In5C7pwhw0mXLE,SpATywNh6bZuzm8s1ceuBUnMUAeoAHHw,17,51,26,17,10,178,26,4,312,44.57142857142857,4,0.0,12,26,15,10,39,178,2,26,4,63,249,1
4603,163524,Qp6nTYSBUXdSPjEoOGaLaIU4K702QdpX,SpATywNh6bZuzm8s1ceuBUnMUAeoAHHw,9,3,2,0,2,0,6,1,14,2.0,1,0.0,0,2,0,2,3,0,0,6,1,4,10,1
4604,163545,aNuWWNOgxdbqnpWne8VHd2WyMrEEuUHw,SpATywNh6bZuzm8s1ceuBUnMUAeoAHHw,13,13,0,24,0,3,5,6,51,7.285714285714286,1,0.0,6,0,19,0,7,3,5,5,6,25,26,1
4605,163548,MYL9KYDmBF9vDici6Dv3saVcxgkvpmKP,SpATywNh6bZuzm8s1ceuBUnMUAeoAHHw,8,2,2,0,2,0,3,0,9,1.2857142857142858,2,0.0,0,2,0,2,2,0,0,3,0,4,5,1
4606,163553,RfHHoRL5TB9R1ardH3KUBDMoKbTvmS64,G8EPVSXsOYB5YQWZGiz1aVq5Pgr2GrQu,9,2,1,0,1,2,8,1,15,2.142857142857143,1,0.0,0,1,0,1,2,2,0,8,1,2,13,1
4607,163556,x1RDUiG4hzdFvWaarIV1g7s3ecNKiDPi,bWdj2GDclj5ofokWjzoa5jAwMkxCykd6,6,5,1,0,1,6,3,0,16,2.2857142857142856,1,0.0,2,1,0,1,3,6,0,3,0,4,12,1
4608,163561,0QwOyzDB4SU53NQhq9XNeT5ngIq83qZV,SpATywNh6bZuzm8s1ceuBUnMUAeoAHHw,14,20,6,18,4,4,5,0,57,8.142857142857142,1,0.0,12,6,16,4,8,4,2,5,0,38,19,1
4609,163566,7OkCZWJW1Ow4wpTBUq53amL13pV2vy2v,bWdj2GDclj5ofokWjzoa5jAwMkxCykd6,1,0,0,0,0,0,1,0,1,0.14285714285714285,1,0.0,0,0,0,0,0,0,0,1,0,0,1,1
4610,163575,pUCG45Dx4PCk37xolhUilbrK2zyzqYUw,SpATywNh6bZuzm8s1ceuBUnMUAeoAHHw,5,2,1,0,1,0,2,0,6,0.8571428571428571,1,0.0,0,1,0,1,2,0,0,2,0,2,4,1
4611,163584,pUCG45Dx4PCk37xolhUilbrK2zyzqYUw,RXDvfPUBYFlVdlueBFbLW0mhhAyGEqpt,5,2,1,0,1,0,2,0,6,0.8571428571428571,1,0.0,0,1,0,1,2,0,0,2,0,2,4,1
4612,163587,LOW2vjVehrf0M1x4W4dAc3vEUlAV2GoS,SpATywNh6bZuzm8s1ceuBUnMUAeoAHHw,1,0,0,0,0,0,1,0,1,0.14285714285714285,1,0.0,0,0,0,0,0,0,0,1,0,0,1,1
4613,163591,pvAe37z1FjLTGYdwlJFjXex25zlpyHtu,SpATywNh6bZuzm8s1ceuBUnMUAeoAHHw,1,0,0,0,0,0,1,0,1,0.14285714285714285,1,0.0,0,0,0,0,0,0,0,1,0,0,1,1
4614,163594,cJ2sQIvcbMYmAtm7wZLrjdPU3A4J8Vmy,RXDvfPUBYFlVdlueBFbLW0mhhAyGEqpt,1,0,0,0,0,0,1,0,1,0.14285714285714285,1,0.0,0,0,0,0,0,0,0,1,0,0,1,1
4615,163602,1n5nYyRZ2V4rGDvhlysxQQrSnQWtjpF0,SpATywNh6bZuzm8s1ceuBUnMUAeoAHHw,5,2,0,0,0,0,4,0,6,0.8571428571428571,1,0.0,0,0,0,0,2,0,0,4,0,0,6,1
4616,163606,muDFJRueLAzQJIObWxRY78oBQLrrl8ME,RXDvfPUBYFlVdlueBFbLW0mhhAyGEqpt,5,1,1,0,1,0,2,0,5,0.7142857142857143,1,0.0,0,1,0,1,1,0,0,2,0,2,3,1
4617,163608,zgldUj8PQLoCMFvq4CFx27ajGTiUzuNA,SpATywNh6bZuzm8s1ceuBUnMUAeoAHHw,8,3,1,0,1,0,5,1,11,1.5714285714285714,1,0.0,0,1,0,1,3,0,0,5,1,2,9,1
4618,163610,shpNJBWz5XXztT7QSTTkv5TBZhc2j7a5,bWdj2GDclj5ofokWjzoa5jAwMkxCykd6,5,2,1,0,1,0,2,0,6,0.8571428571428571,1,0.0,0,1,0,1,2,0,0,2,0,2,4,1
4619,163620,BRQa1dSoPdGgh4T8YhbATcVtUAwS3CTv,G8EPVSXsOYB5YQWZGiz1aVq5Pgr2GrQu,1,0,0,0,0,0,1,0,1,0.14285714285714285,1,0.0,0,0,0,0,0,0,0,1,0,0,1,1
4620,163624,J4pjYRUS78455k3x6FlgE0qLyKCkWPB4,SpATywNh6bZuzm8s1ceuBUnMUAeoAHHw,4,3,1,0,1,0,4,0,9,1.2857142857142858,1,0.0,0,1,0,1,3,0,0,4,0,2,7,1
4621,163626,h1vKdFPTvdJ38bRqZwCXLGITqLqjjxQ8,bWdj2GDclj5ofokWjzoa5jAwMkxCykd6,2,0,0,0,0,0,5,0,5,0.7142857142857143,4,0.0,0,0,0,0,0,0,0,5,0,0,5,1
4622,163633,loY20pnf7suv2LWREXjC0h3XNawzaj7l,SpATywNh6bZuzm8s1ceuBUnMUAeoAHHw,15,13,4,13,3,0,5,0,38,5.428571428571429,1,0.0,5,4,11,3,8,0,2,5,0,23,15,1
4623,163657,3NITGQuylcrTi63aoWqnzXuF5Rtf7QVq,bWdj2GDclj5ofokWjzoa5jAwMkxCykd6,15,24,12,52,8,0,4,0,100,14.285714285714286,2,0.0,9,12,51,8,15,0,1,4,0,80,20,1
4624,163661,TC06DZHDGaAT9UQHd1v4hOYj6DcF04C0,SpATywNh6bZuzm8s1ceuBUnMUAeoAHHw,1,0,0,0,0,0,1,0,1,0.14285714285714285,1,0.0,0,0,0,0,0,0,0,1,0,0,1,1
4625,163664,75QwID9vkHNyAC3jIqeF9fNTGOKWDCMd,SpATywNh6bZuzm8s1ceuBUnMUAeoAHHw,15,27,1,24,1,2,17,3,75,10.714285714285714,3,0.0,10,1,18,1,17,2,6,17,3,30,45,0
4626,163665,mSLVZlcG3d9P9nR1btPulwDUjqta6d8Y,RXDvfPUBYFlVdlueBFbLW0mhhAyGEqpt,2,0,0,0,0,0,2,0,2,0.2857142857142857,1,0.0,0,0,0,0,0,0,0,2,0,0,2,1
4627,163668,BB5Nl9ZKGNNXpCTY1I2k14qOsWmBwuLj,SpATywNh6bZuzm8s1ceuBUnMUAeoAHHw,5,2,1,0,1,0,2,0,6,0.8571428571428571,1,0.0,0,1,0,1,2,0,0,2,0,2,4,1
4628,163670,zBcT1Z0xXooVqe1Y23Zi33CckLeXOFNF,RXDvfPUBYFlVdlueBFbLW0mhhAyGEqpt,1,0,0,0,0,0,1,0,1,0.14285714285714285,1,0.0,0,0,0,0,0,0,0,1,0,0,1,1
4629,163671,jMDxIZZpgmR8gnZ9CfiXAFFCthv2NGRW,SpATywNh6bZuzm8s1ceuBUnMUAeoAHHw,15,13,8,14,3,6,7,0,51,7.285714285714286,2,0.0,2,8,12,3,11,6,2,7,0,25,26,1
4630,163672,Xdw2Hwx0RPjHhvzIV1hR51APAU4mGupY,SpATywNh6bZuzm8s1ceuBUnMUAeoAHHw,5,5,2,0,2,0,1,0,10,1.4285714285714286,1,0.0,1,2,0,2,4,0,0,1,0,5,5,1
4631,163676,JoqAGqbao71wc04PyVzx7SVvlZZ0knbI,bWdj2GDclj5ofokWjzoa5jAwMkxCykd6,11,15,7,24,4,13,5,0,68,9.714285714285714,2,0.0,3,7,22,4,12,13,2,5,0,36,32,1
4632,163677,HcOpBFh3ZPBJu7PjBFffM3Zedw54RSXN,bWdj2GDclj5ofokWjzoa5jAwMkxCykd6,4,3,1,0,1,0,2,0,7,1.0,2,0.0,0,1,0,1,3,0,0,2,0,2,5,1
4633,163682,vqdEPdTaMaLXqSh5cxznXuMHlVEqT6bt,SpATywNh6bZuzm8s1ceuBUnMUAeoAHHw,12,29,22,0,8,0,9,1,69,9.857142857142858,2,0.0,0,22,0,8,29,0,0,9,1,30,39,0
4634,163688,cENALtdHRJFXtEKpdDktmgl2ZGC3sBgO,SpATywNh6bZuzm8s1ceuBUnMUAeoAHHw,12,9,1,17,0,0,4,0,31,4.428571428571429,1,0.0,4,1,15,0,5,0,2,4,0,20,11,1
4635,163690,komVuIpJ79AnXgdOwFqR0q8Eqk6fTXb3,SpATywNh6bZuzm8s1ceuBUnMUAeoAHHw,1,0,0,0,0,0,1,0,1,0.14285714285714285,1,0.0,0,0,0,0,0,0,0,1,0,0,1,1
4636,163694,sEHJPtMDHp3vOEZBdXoH3aRuuTFrugcC,G8EPVSXsOYB5YQWZGiz1aVq5Pgr2GrQu,10,22,13,0,8,2,5,0,50,7.142857142857143,2,0.0,4,13,0,8,18,2,0,5,0,25,25,1
4637,163698,pDVnQJMhWdSLNejm9F2A6uzPWohSMQmu,G8EPVSXsOYB5YQWZGiz1aVq5Pgr2GrQu,16,12,0,18,0,15,4,1,50,7.142857142857143,1,0.0,7,0,10,0,5,15,8,4,1,17,33,1
4638,163700,zUFpvfPNIssMYrypcxpRp9lQfW6g2Sf6,SpATywNh6bZuzm8s1ceuBUnMUAeoAHHw,7,7,0,0,0,6,11,0,24,3.4285714285714284,1,0.0,2,0,0,0,5,6,0,11,0,2,22,1
4639,163706,CrPF9cMk7uOWPFKqLXtVzkBmR606gvwU,SpATywNh6bZuzm8s1ceuBUnMUAeoAHHw,13,8,4,15,3,2,4,0,36,5.142857142857143,1,0.0,3,4,14,3,5,2,1,4,0,24,12,1
4640,163720,2nKcL79UGpRMTprt0KTar2VFqD9nuGkh,SpATywNh6bZuzm8s1ceuBUnMUAeoAHHw,2,0,0,0,0,0,2,0,2,0.2857142857142857,1,0.0,0,0,0,0,0,0,0,2,0,0,2,1
4641,163724,0YUJjVhFBVhA8wNUqY2rEXkCnd7riq8C,G8EPVSXsOYB5YQWZGiz1aVq5Pgr2GrQu,26,83,20,58,13,13,7,0,194,27.714285714285715,2,0.0,21,20,37,13,62,13,21,7,0,91,103,1
4642,163729,S6XUZDRPe3B3jFFcpBw3sZVQuamNJyiN,SpATywNh6bZuzm8s1ceuBUnMUAeoAHHw,10,6,2,0,2,0,11,1,22,3.142857142857143,1,0.0,0,2,0,2,6,0,0,11,1,4,18,1
4643,163741,D9KO1ppIRpnoCoycPkHQYcH9KJWpl4W7,bWdj2GDclj5ofokWjzoa5jAwMkxCykd6,4,3,1,0,1,0,1,0,6,0.8571428571428571,1,0.0,0,1,0,1,3,0,0,1,0,2,4,1
4644,163745,etVgnbIdb29nIYhfw4jRXWTSVqDVpgA6,bWdj2GDclj5ofokWjzoa5jAwMkxCykd6,5,2,1,0,1,0,2,0,6,0.8571428571428571,1,0.0,0,1,0,1,2,0,0,2,0,2,4,1
4645,163750,Cyn71axG1s2H4lOUgGzQPfwHEpQH7ztK,SpATywNh6bZuzm8s1ceuBUnMUAeoAHHw,15,19,8,12,4,12,3,0,58,8.285714285714286,2,0.0,8,8,12,4,11,12,0,3,0,32,26,1
4646,163768,RqamfvIhC4c7Es8bljx9jvwLrjWv2ac0,RXDvfPUBYFlVdlueBFbLW0mhhAyGEqpt,2,0,0,0,0,0,4,0,4,0.5714285714285714,1,0.0,0,0,0,0,0,0,0,4,0,0,4,1
4647,163778,btnHCoy9MQOM6yfSVhDpkIBjedtnrWxU,RXDvfPUBYFlVdlueBFbLW0mhhAyGEqpt,8,5,4,0,2,0,1,0,12,1.7142857142857142,1,0.0,0,4,0,2,5,0,0,1,0,6,6,1
4648,163779,NerpsmnngCHcZrL9Hd5ZneLeL3p095KD,SpATywNh6bZuzm8s1ceuBUnMUAeoAHHw,6,5,3,0,1,0,4,0,13,1.8571428571428572,1,0.0,0,3,0,1,5,0,0,4,0,4,9,1
4649,163786,SkZlhcjqZI4qlpvHtuOmZh7bgPo5Ar9M,bWdj2GDclj5ofokWjzoa5jAwMkxCykd6,2,0,0,0,0,0,2,0,2,0.2857142857142857,1,0.0,0,0,0,0,0,0,0,2,0,0,2,1
4650,163788,n3c2ApJ73TKxIh3DdiEwlTAkgOAhKXpG,SpATywNh6bZuzm8s1ceuBUnMUAeoAHHw,17,21,12,25,4,16,16,2,96,13.714285714285714,1,0.0,5,12,19,4,16,16,6,16,2,40,56,1
4651,163792,l2L8xysJvlmTPvgXglY4OYbhmyGaWoEy,RXDvfPUBYFlVdlueBFbLW0mhhAyGEqpt,16,8,6,42,3,0,11,1,71,10.142857142857142,1,0.0,2,6,34,3,6,0,8,11,1,45,26,1
4652,163795,YgSP6VTXTaMFsmPeWIUxWWzafDI82Gyz,SpATywNh6bZuzm8s1ceuBUnMUAeoAHHw,5,4,1,0,0,0,5,0,10,1.4285714285714286,3,0.0,0,1,0,0,4,0,0,5,0,1,9,1
4653,163797,Cmo75ZUENQku9o2Ve6I8FB5t9KDDKDgA,SpATywNh6bZuzm8s1ceuBUnMUAeoAHHw,4,4,1,0,1,0,2,0,8,1.1428571428571428,1,0.0,2,1,0,1,2,0,0,2,0,4,4,1
4654,163807,ejqIFmdt0kSod99aitO8eyB1a9BPL17H,SpATywNh6bZuzm8s1ceuBUnMUAeoAHHw,1,0,0,0,0,0,1,0,1,0.14285714285714285,1,0.0,0,0,0,0,0,0,0,1,0,0,1,1
4655,163815,Kp1vLJAjI5XcavfLMkR7KVaehYzBATxU,bWdj2GDclj5ofokWjzoa5jAwMkxCykd6,8,2,1,0,1,1,8,1,14,2.0,1,0.0,0,1,0,1,2,1,0,8,1,2,12,1
4656,163818,Jk2x4OpxMPaHdO7EMry509YRkCM2Yc2p,SpATywNh6bZuzm8s1ceuBUnMUAeoAHHw,12,10,4,16,0,8,7,1,46,6.571428571428571,1,0.0,6,4,14,0,4,8,2,7,1,24,22,1
4657,163843,6ifSGyv1OJBX59YUfupEGQzaFg12QLcw,RXDvfPUBYFlVdlueBFbLW0mhhAyGEqpt,20,29,23,0,2,0,11,0,65,9.285714285714286,3,0.0,0,23,0,2,29,0,0,11,0,25,40,1
4658,163848,KL1kUzCOuvYfkjBJ6sFRxEo1isQ1OD4Z,bWdj2GDclj5ofokWjzoa5jAwMkxCykd6,4,3,0,0,0,0,2,0,5,0.7142857142857143,1,0.0,0,0,0,0,3,0,0,2,0,0,5,1
4659,163856,xKB2JQIJ9xKYEvQWCbLYsbszDegqqoDj,bWdj2GDclj5ofokWjzoa5jAwMkxCykd6,4,3,1,0,1,0,1,0,6,0.8571428571428571,1,0.0,1,1,0,1,2,0,0,1,0,3,3,1
4660,163861,dIc7Ag2KIstBuuBNcnhZG1Qo98HOHtHH,SpATywNh6bZuzm8s1ceuBUnMUAeoAHHw,1,0,0,0,0,0,1,0,1,0.14285714285714285,1,0.0,0,0,0,0,0,0,0,1,0,0,1,1
4661,163872,bUOsk5wGaEvBO4I3alFT753psxzUkzse,RXDvfPUBYFlVdlueBFbLW0mhhAyGEqpt,5,2,1,0,1,0,2,0,6,0.8571428571428571,1,0.0,0,1,0,1,2,0,0,2,0,2,4,1
4662,163876,SSpeewBDHUNKkvUJM5ASinNHvMXIOEwr,SpATywNh6bZuzm8s1ceuBUnMUAeoAHHw,7,7,3,0,1,6,4,0,21,3.0,3,0.0,0,3,0,1,7,6,0,4,0,4,17,1
4663,163878,jX1wtG8uym7vm2Ny85W79HCXnEeqhUm4,SpATywNh6bZuzm8s1ceuBUnMUAeoAHHw,1,0,0,0,0,0,1,0,1,0.14285714285714285,1,0.0,0,0,0,0,0,0,0,1,0,0,1,1
4664,163891,GyWTABuPpZEqO585EnNTIpM2B2faPYN3,bWdj2GDclj5ofokWjzoa5jAwMkxCykd6,4,2,1,0,1,0,1,0,5,0.7142857142857143,1,0.0,0,1,0,1,2,0,0,1,0,2,3,1
4665,163897,HPHciqd0NAfLXfMlyuoYEVDWJNUonGj0,bWdj2GDclj5ofokWjzoa5jAwMkxCykd6,7,59,6,0,4,0,5,0,74,10.571428571428571,2,0.0,3,6,0,4,56,0,0,5,0,13,61,1
4666,163912,KAW52VBDXCvurEAry0tITiLWjcxVkV8S,RXDvfPUBYFlVdlueBFbLW0mhhAyGEqpt,41,34,20,96,13,2,4,0,169,24.142857142857142,1,0.0,9,20,86,13,25,2,10,4,0,128,41,1
4667,163913,aKmGG28IIMsmRYbcnkO5kp7ipo4I9wj0,SpATywNh6bZuzm8s1ceuBUnMUAeoAHHw,9,7,1,6,0,1,5,1,21,3.0,2,0.0,0,1,5,0,7,1,1,5,1,6,15,1
4668,163921,MSZ49Aqf4KMvK8xA9amgTCzlSE1z7F0F,bWdj2GDclj5ofokWjzoa5jAwMkxCykd6,2,0,0,0,0,0,2,0,2,0.2857142857142857,1,0.0,0,0,0,0,0,0,0,2,0,0,2,1
4669,163926,2K1Z8MHkxSfa3IoXQMOOkvPRYry0VFvS,bWdj2GDclj5ofokWjzoa5jAwMkxCykd6,10,9,4,0,1,1,8,1,24,3.4285714285714284,2,0.0,0,4,0,1,9,1,0,8,1,5,19,0
4670,163933,caAQbOI1NkkZKVF3oGPK3OdsY0lbDlYb,RXDvfPUBYFlVdlueBFbLW0mhhAyGEqpt,1,0,0,0,0,0,2,0,2,0.2857142857142857,1,0.0,0,0,0,0,0,0,0,2,0,0,2,1
4671,163943,MIuMzVdl8gwQZWh4ux7IRLhRo5aprHQC,SpATywNh6bZuzm8s1ceuBUnMUAeoAHHw,1,0,0,0,0,0,1,0,1,0.14285714285714285,1,0.0,0,0,0,0,0,0,0,1,0,0,1,1
4672,163953,YgxPec9PZk03SxcMpde0DWwnbgHU13wT,SpATywNh6bZuzm8s1ceuBUnMUAeoAHHw,1,0,0,0,0,0,1,0,1,0.14285714285714285,1,0.0,0,0,0,0,0,0,0,1,0,0,1,1
4673,163958,0bsBNQsCMEE2O55Mpr8lzwhfGggHG2nb,SpATywNh6bZuzm8s1ceuBUnMUAeoAHHw,5,2,1,0,1,0,2,0,6,0.8571428571428571,1,0.0,0,1,0,1,2,0,0,2,0,2,4,1
4674,163964,ncIBIt1kRS23NRG3HklaOrwS2ep1UY7z,SpATywNh6bZuzm8s1ceuBUnMUAeoAHHw,2,0,0,0,0,0,2,0,2,0.2857142857142857,1,0.0,0,0,0,0,0,0,0,2,0,0,2,1
4675,163969,0bsBNQsCMEE2O55Mpr8lzwhfGggHG2nb,G8EPVSXsOYB5YQWZGiz1aVq5Pgr2GrQu,5,2,1,0,1,0,2,0,6,0.8571428571428571,1,0.0,0,1,0,1,2,0,0,2,0,2,4,1
4676,163989,u4a9xsMW9UMqx1X32x8LQI0FlTLRy0KL,SpATywNh6bZuzm8s1ceuBUnMUAeoAHHw,2,0,0,0,0,9,1,0,10,1.4285714285714286,1,0.0,0,0,0,0,0,9,0,1,0,0,10,0
4677,163991,anEiPiaERCYvJFKhHPaXaVlQmETZOxzh,SpATywNh6bZuzm8s1ceuBUnMUAeoAHHw,1,0,0,0,0,0,2,0,2,0.2857142857142857,1,0.0,0,0,0,0,0,0,0,2,0,0,2,1
4678,163992,RiuaU3j9glvJbW4ph026KXgBcE6tugPM,RXDvfPUBYFlVdlueBFbLW0mhhAyGEqpt,1,0,0,0,0,0,1,0,1,0.14285714285714285,1,0.0,0,0,0,0,0,0,0,1,0,0,1,1
4679,164011,JRm4q27yt4AaEMn6KL3V0UaldpldX8N9,SpATywNh6bZuzm8s1ceuBUnMUAeoAHHw,6,1,1,0,1,0,4,0,7,1.0,2,0.0,0,1,0,1,1,0,0,4,0,2,5,1
4680,164016,2CKOPbc4gInQJsnnTPuzmf6nPJ7m7X0V,bWdj2GDclj5ofokWjzoa5jAwMkxCykd6,1,0,0,0,0,0,1,0,1,0.14285714285714285,1,0.0,0,0,0,0,0,0,0,1,0,0,1,1
4681,164019,zDzmXMYgrAR2y36omcEUWoshe9A93Rqa,G8EPVSXsOYB5YQWZGiz1aVq5Pgr2GrQu,3,2,0,0,0,0,4,0,6,0.8571428571428571,1,0.0,0,0,0,0,2,0,0,4,0,0,6,1
4682,164042,HmNDAe5361OzVlrz8LBClXTWLyGOsfB7,SpATywNh6bZuzm8s1ceuBUnMUAeoAHHw,11,12,3,0,2,9,14,0,40,5.714285714285714,2,0.0,0,3,0,2,12,9,0,14,0,5,35,1
4683,164055,eeroiGZDLkmy8hYlMjhf0wHZNeoAekbw,SpATywNh6bZuzm8s1ceuBUnMUAeoAHHw,9,19,7,0,2,1,7,0,36,5.142857142857143,4,0.0,0,7,0,2,19,1,0,7,0,9,27,1
4684,164057,YKkBpxb8WAuGDSQU1z7LvNmikgJLWtZj,SpATywNh6bZuzm8s1ceuBUnMUAeoAHHw,11,18,1,6,1,0,8,0,34,4.857142857142857,3,0.0,1,1,5,1,17,0,1,8,0,8,26,1
4685,164069,NoDqq3WQEPxb31LrvCuk6iDV8wGhNbVA,G8EPVSXsOYB5YQWZGiz1aVq5Pgr2GrQu,17,25,12,24,8,0,3,0,72,10.285714285714286,3,0.0,9,12,18,8,16,0,6,3,0,47,25,1
4686,164070,Rv6gVo5TL2yRLbTriDaWEPebl1P4Qs2d,SpATywNh6bZuzm8s1ceuBUnMUAeoAHHw,15,39,17,13,7,27,11,0,114,16.285714285714285,3,0.0,3,17,12,7,36,27,1,11,0,39,75,1
4687,164080,om0kp3yKpxrkFaqYJciQiQMcbCOWwtTu,SpATywNh6bZuzm8s1ceuBUnMUAeoAHHw,7,6,3,0,2,1,3,1,16,2.2857142857142856,1,0.0,1,3,0,2,5,1,0,3,1,6,10,1
4688,164082,p3rNyoksJ9TEfFEu0f5KZsbSwUZIEvsu,SpATywNh6bZuzm8s1ceuBUnMUAeoAHHw,15,11,4,10,3,2,5,3,38,5.428571428571429,1,0.0,3,4,8,3,8,2,2,5,3,18,20,1
4689,164084,sjjMSkWB5IXcRcDmE2j3kfDFuBFIoN8k,bWdj2GDclj5ofokWjzoa5jAwMkxCykd6,12,21,9,26,6,1,9,1,73,10.428571428571429,1,0.0,6,9,25,6,15,1,1,9,1,46,27,1
4690,164085,EstzqNEYeufsEWzgLWtGlb7e6FUCscoH,SpATywNh6bZuzm8s1ceuBUnMUAeoAHHw,1,0,0,0,0,0,1,0,1,0.14285714285714285,1,0.0,0,0,0,0,0,0,0,1,0,0,1,1
4691,164096,WZJCLDDXV5Wl4Svb3H2g8hACnctxCrNZ,G8EPVSXsOYB5YQWZGiz1aVq5Pgr2GrQu,9,6,2,8,1,0,4,1,22,3.142857142857143,1,0.0,4,2,6,1,2,0,2,4,1,13,9,1
4692,164099,T0RArQ3lSZeSD0MbnDejlzkMufYho8lt,bWdj2GDclj5ofokWjzoa5jAwMkxCykd6,12,11,8,0,8,0,7,2,36,5.142857142857143,2,0.0,0,8,0,8,11,0,0,7,2,16,20,1
4693,164103,LuPgMCIdX2ugHzDAngaEsA394qOat0id,bWdj2GDclj5ofokWjzoa5jAwMkxCykd6,6,9,4,0,0,0,8,0,21,3.0,2,0.0,0,4,0,0,9,0,0,8,0,4,17,1
4694,164104,e6HjcHFSQL7s0bn6pVFAYgFBkk1qs0K8,SpATywNh6bZuzm8s1ceuBUnMUAeoAHHw,4,4,0,0,0,0,2,0,6,0.8571428571428571,1,0.0,1,0,0,0,3,0,0,2,0,1,5,1
4695,164133,C800geUBh3GYBhoh4cW6ReKUGj5LAMGi,RXDvfPUBYFlVdlueBFbLW0mhhAyGEqpt,1,0,0,0,0,0,1,0,1,0.14285714285714285,1,0.0,0,0,0,0,0,0,0,1,0,0,1,1
4696,164145,sG64hLkOLC3BnIsKXDBdltBd6B2Qop5m,SpATywNh6bZuzm8s1ceuBUnMUAeoAHHw,10,11,8,0,5,2,4,0,30,4.285714285714286,2,0.0,0,8,0,5,11,2,0,4,0,13,17,1
4697,164147,jSIHGu9DhhauxAb5p4KNEdGcYL30YLp5,SpATywNh6bZuzm8s1ceuBUnMUAeoAHHw,6,2,1,0,1,0,7,0,11,1.5714285714285714,1,0.0,0,1,0,1,2,0,0,7,0,2,9,1
4698,164151,qxuL6lm7O1L6ePIrQ7pAlpyCErX7NoG2,G8EPVSXsOYB5YQWZGiz1aVq5Pgr2GrQu,2,0,0,0,0,0,2,0,2,0.2857142857142857,1,0.0,0,0,0,0,0,0,0,2,0,0,2,0
4699,164161,hf4d4QAFiVVt3bxQ1i3sb92NQtXr4NWg,RXDvfPUBYFlVdlueBFbLW0mhhAyGEqpt,7,5,3,0,1,0,3,0,12,1.7142857142857142,1,0.0,0,3,0,1,5,0,0,3,0,4,8,1
4700,164166,VNMcZCNkGFRxehwmtxH5s6s6Jm24lIUf,G8EPVSXsOYB5YQWZGiz1aVq5Pgr2GrQu,6,8,3,0,2,0,2,0,15,2.142857142857143,1,0.0,3,3,0,2,5,0,0,2,0,8,7,1
4701,164169,g8GaCwXJUf6SPnVxk3h41vOpn1g2rMNj,G8EPVSXsOYB5YQWZGiz1aVq5Pgr2GrQu,20,13,9,20,3,5,9,1,60,8.571428571428571,1,0.0,0,9,18,3,13,5,2,9,1,30,30,1
4702,164174,CVy4kNAaUGvRYYQgXmKQWG6L2OSWreYS,SpATywNh6bZuzm8s1ceuBUnMUAeoAHHw,10,12,1,0,2,1,6,1,23,3.2857142857142856,2,0.0,3,1,0,2,9,1,0,6,1,6,17,1
4703,164183,w4DmyCRPmcVeeul1i1ztSEkbof1km1Nb,bWdj2GDclj5ofokWjzoa5jAwMkxCykd6,5,2,1,0,1,0,2,0,6,0.8571428571428571,1,0.0,0,1,0,1,2,0,0,2,0,2,4,1
4704,164193,ciqNol40it2TXmTV6HAJsQTHc113ipRy,bWdj2GDclj5ofokWjzoa5jAwMkxCykd6,10,24,7,56,5,0,10,0,102,14.571428571428571,2,0.0,11,7,56,5,13,0,0,10,0,79,23,1
4705,164194,nGALou9220OOdyTmGQUn7ZDRMR4UkSXJ,SpATywNh6bZuzm8s1ceuBUnMUAeoAHHw,13,5,4,0,3,0,6,1,19,2.7142857142857144,1,0.0,0,4,0,3,5,0,0,6,1,7,12,1
4706,164206,2YuUQch1UOdzblixrhGJqRyfiL57cYEN,RXDvfPUBYFlVdlueBFbLW0mhhAyGEqpt,2,0,0,0,0,0,2,0,2,0.2857142857142857,1,0.0,0,0,0,0,0,0,0,2,0,0,2,1
4707,164227,DSUKhhpRDohNouwSJME8rOv0HnE7IUjD,G8EPVSXsOYB5YQWZGiz1aVq5Pgr2GrQu,5,1,1,0,1,1,2,0,6,0.8571428571428571,1,0.0,0,1,0,1,1,1,0,2,0,2,4,1
4708,164233,kuZwBvEdgeUtKZ495C2FptBbxEtLtmVH,G8EPVSXsOYB5YQWZGiz1aVq5Pgr2GrQu,9,6,3,0,0,0,7,0,16,2.2857142857142856,2,0.0,0,3,0,0,6,0,0,7,0,3,13,1
4709,164239,puEuN6Xf1uW7cjSgYlTKI73OSHVfNsuZ,SpATywNh6bZuzm8s1ceuBUnMUAeoAHHw,13,12,6,0,4,8,5,1,36,5.142857142857143,1,0.0,5,6,0,4,7,8,0,5,1,15,21,1
4710,164242,wFvodFqghxL7iISMFbYXkYNq6P6eK5gH,bWdj2GDclj5ofokWjzoa5jAwMkxCykd6,1,0,0,0,0,0,2,0,2,0.2857142857142857,1,0.0,0,0,0,0,0,0,0,2,0,0,2,1
4711,164251,vBJL7coMRkaE4FxkSvahGksjBaWY15De,bWdj2GDclj5ofokWjzoa5jAwMkxCykd6,5,2,1,0,1,2,2,0,8,1.1428571428571428,1,0.0,0,1,0,1,2,2,0,2,0,2,6,1
4712,164258,Or6EoLeKHgxe5lrewrc5kj5wcFrtEOsX,G8EPVSXsOYB5YQWZGiz1aVq5Pgr2GrQu,16,19,4,34,2,0,3,0,62,8.857142857142858,3,0.0,2,4,29,2,17,0,5,3,0,37,25,1
4713,164264,Kch5WBTMofTOaqsqvrCwdJnTOQRJP2KH,RXDvfPUBYFlVdlueBFbLW0mhhAyGEqpt,8,5,4,0,2,0,1,0,12,1.7142857142857142,1,0.0,0,4,0,2,5,0,0,1,0,6,6,1
4714,164274,oTNjNy2VCNhMEHkpw5RoIwGj6ModXkSd,SpATywNh6bZuzm8s1ceuBUnMUAeoAHHw,8,2,2,0,2,0,5,0,11,1.5714285714285714,1,0.0,0,2,0,2,2,0,0,5,0,4,7,1
4715,164282,wBacPbVnOV4SRh0JUUHmWhDIds03R7aM,bWdj2GDclj5ofokWjzoa5jAwMkxCykd6,15,23,14,66,5,0,11,0,119,17.0,5,0.0,3,14,63,5,20,0,3,11,0,85,34,1
4716,164286,kargVzTieknsOD52RwWWxzR3bhPo7xCn,bWdj2GDclj5ofokWjzoa5jAwMkxCykd6,2,0,0,0,0,0,2,0,2,0.2857142857142857,1,0.0,0,0,0,0,0,0,0,2,0,0,2,1
4717,164289,OimNh540xAgKAtol4nYQSyjwRKBWvHjV,bWdj2GDclj5ofokWjzoa5jAwMkxCykd6,9,23,8,0,4,1,9,2,47,6.714285714285714,2,0.0,0,8,0,4,23,1,0,9,2,12,35,1
4718,164305,wm5eo4PFQKBWWCDwO21MewWgtJRcPge6,SpATywNh6bZuzm8s1ceuBUnMUAeoAHHw,9,8,5,0,3,1,8,2,27,3.857142857142857,2,0.0,0,5,0,3,8,1,0,8,2,8,19,1
4719,164309,kIQJn1ZGNZIZ21dizjiWH4EHSNMGXOiq,SpATywNh6bZuzm8s1ceuBUnMUAeoAHHw,6,2,1,0,1,0,3,0,7,1.0,1,0.0,0,1,0,1,2,0,0,3,0,2,5,1
4720,164315,cYibpCaMUGq0WjgUWfTv0iIvJ7QbFj5E,bWdj2GDclj5ofokWjzoa5jAwMkxCykd6,1,0,0,0,0,0,1,0,1,0.14285714285714285,1,0.0,0,0,0,0,0,0,0,1,0,0,1,0
4721,164330,5JojY8Vvgh7rjfcAS5764ZRMTC8fo9QP,G8EPVSXsOYB5YQWZGiz1aVq5Pgr2GrQu,21,31,0,36,1,0,4,0,72,10.285714285714286,1,0.0,15,0,28,1,16,0,8,4,0,44,28,1
4722,164370,K6SnVyYj4JLYSaBAXjv9gYLyrrnyqRP0,SpATywNh6bZuzm8s1ceuBUnMUAeoAHHw,4,0,0,0,0,1,5,0,6,0.8571428571428571,1,0.0,0,0,0,0,0,1,0,5,0,0,6,1
4723,164371,5fUv2a4WMEi2Bc60cQo0Uzo1I7SufPfI,RXDvfPUBYFlVdlueBFbLW0mhhAyGEqpt,21,26,0,52,1,15,9,6,109,15.571428571428571,2,0.0,6,0,48,1,20,15,4,9,6,55,54,1
4724,164373,HIaaOq9UrLvo3UC4FIJStVsYhdTvdkJ9,SpATywNh6bZuzm8s1ceuBUnMUAeoAHHw,10,12,0,10,0,0,5,0,27,3.857142857142857,1,0.0,3,0,8,0,9,0,2,5,0,11,16,1
4725,164374,ocTIjxG8zBs0mQRpUtpuAKc7MDpzU7Sd,bWdj2GDclj5ofokWjzoa5jAwMkxCykd6,19,19,8,34,6,19,14,0,100,14.285714285714286,2,0.0,8,8,30,6,11,19,4,14,0,52,48,0
4726,164380,V3KgKcJl8bgXAGMp5c8bz9HnZzQfd0IE,SpATywNh6bZuzm8s1ceuBUnMUAeoAHHw,12,19,9,4,4,2,2,0,40,5.714285714285714,1,0.0,0,9,3,4,19,2,1,2,0,16,24,1
4727,164385,zhF9aamFaaPbw8uvKpkg1m1HOa3rg91T,RXDvfPUBYFlVdlueBFbLW0mhhAyGEqpt,23,17,12,0,8,0,6,0,43,6.142857142857143,2,0.0,0,12,0,8,17,0,0,6,0,20,23,1
4728,164389,9XEvRIJ3KorQF4OT61u2doOr3f5pwaHZ,bWdj2GDclj5ofokWjzoa5jAwMkxCykd6,3,3,1,0,0,0,1,0,5,0.7142857142857143,1,0.0,0,1,0,0,3,0,0,1,0,1,4,1
4729,164392,vfnNYDz3ao0khQiXn6s0MRVTGqDcFM0x,bWdj2GDclj5ofokWjzoa5jAwMkxCykd6,5,5,0,0,1,0,3,1,10,1.4285714285714286,1,0.0,3,0,0,1,2,0,0,3,1,4,6,1
4730,164393,gh8ZFa6DAiOnR8V5MntcWerJGzv2wFJI,SpATywNh6bZuzm8s1ceuBUnMUAeoAHHw,15,24,9,4,5,3,5,0,50,7.142857142857143,2,0.0,10,9,4,5,14,3,0,5,0,28,22,1
4731,164397,xmv8WUz0fQb7fJNMHkcUN733RgAFZjFP,bWdj2GDclj5ofokWjzoa5jAwMkxCykd6,5,10,1,0,1,0,6,0,18,2.5714285714285716,1,0.0,2,1,0,1,8,0,0,6,0,4,14,1
4732,164398,0dNy0sRvDF0sROrAnnVZV2SWJaZTZV2q,SpATywNh6bZuzm8s1ceuBUnMUAeoAHHw,3,2,0,0,0,0,1,0,3,0.42857142857142855,1,0.0,0,0,0,0,2,0,0,1,0,0,3,1
4733,164408,O7I8HNg1rvyItYLfAtm0x1WuepktYnst,SpATywNh6bZuzm8s1ceuBUnMUAeoAHHw,8,11,4,0,4,1,1,0,21,3.0,1,0.0,0,4,0,4,11,1,0,1,0,8,13,1
4734,164422,svMXR8fHg4TBhSD6JDFH6qsNGvdxTr0h,RXDvfPUBYFlVdlueBFbLW0mhhAyGEqpt,11,7,0,0,0,2,8,1,18,2.5714285714285716,1,0.0,0,0,0,0,7,2,0,8,1,0,18,1
4735,164439,g61tiKR5XFhd8PF4WUyM648Aa5Kvlcf3,G8EPVSXsOYB5YQWZGiz1aVq5Pgr2GrQu,6,1,1,0,1,4,4,0,11,1.5714285714285714,2,0.0,0,1,0,1,1,4,0,4,0,2,9,1
4736,164459,viXqqg0vx2jNkZn6Nty7fAz4j4zmpVoE,SpATywNh6bZuzm8s1ceuBUnMUAeoAHHw,17,34,13,23,3,30,16,2,121,17.285714285714285,5,0.0,9,13,18,3,25,30,5,16,2,43,78,0
4737,164462,gD7dR7qYBA1tFY5jHEs9UR01plTA8iId,SpATywNh6bZuzm8s1ceuBUnMUAeoAHHw,13,17,11,11,5,2,2,0,48,6.857142857142857,1,0.0,3,11,10,5,14,2,1,2,0,29,19,0
4738,164463,aczUQgOO0ASt0xksHzYEHmyu3n5i1eK4,SpATywNh6bZuzm8s1ceuBUnMUAeoAHHw,10,14,8,0,4,0,8,0,34,4.857142857142857,1,0.0,3,8,0,4,11,0,0,8,0,15,19,1
4739,164464,Xg16SpIo3MJ3Q7kbAScLhtP5JZXXJDfv,SpATywNh6bZuzm8s1ceuBUnMUAeoAHHw,8,6,4,0,3,0,3,0,16,2.2857142857142856,1,0.0,0,4,0,3,6,0,0,3,0,7,9,1
4740,164465,viXqqg0vx2jNkZn6Nty7fAz4j4zmpVoE,G8EPVSXsOYB5YQWZGiz1aVq5Pgr2GrQu,13,14,6,0,5,0,2,0,27,3.857142857142857,1,0.0,0,6,0,5,14,0,0,2,0,11,16,1
4741,164466,4IAsFbl3b7m8BHNHwE02AfsOFCbBUG0L,SpATywNh6bZuzm8s1ceuBUnMUAeoAHHw,6,4,2,0,2,0,1,0,9,1.2857142857142858,1,0.0,1,2,0,2,3,0,0,1,0,5,4,1
4742,164470,XF7WFiRmBAV2t6CIl4aiymZi2mf5tiFp,SpATywNh6bZuzm8s1ceuBUnMUAeoAHHw,9,3,2,0,2,0,6,0,13,1.8571428571428572,1,0.0,0,2,0,2,3,0,0,6,0,4,9,1
4743,164490,c6KChK06Rh7fb4zwLQYLlfB5pAi9XDtG,bWdj2GDclj5ofokWjzoa5jAwMkxCykd6,8,4,4,0,4,0,3,0,15,2.142857142857143,1,0.0,0,4,0,4,4,0,0,3,0,8,7,1
4744,164493,hjoHxSgIY6b9g4BQWlz8arItNzc0bPJL,G8EPVSXsOYB5YQWZGiz1aVq5Pgr2GrQu,5,2,1,0,1,0,2,0,6,0.8571428571428571,1,0.0,0,1,0,1,2,0,0,2,0,2,4,1
4745,164502,gjOO3qwnQCAatqMKu7gZIW5sztiBAppS,SpATywNh6bZuzm8s1ceuBUnMUAeoAHHw,1,0,0,0,0,0,1,0,1,0.14285714285714285,1,0.0,0,0,0,0,0,0,0,1,0,0,1,1
4746,164506,uydIb4MWCn95KWcEhKwj3VRfjvxXo8Nj,RXDvfPUBYFlVdlueBFbLW0mhhAyGEqpt,6,4,3,0,0,0,2,0,9,1.2857142857142858,1,0.0,0,3,0,0,4,0,0,2,0,3,6,1
4747,164510,mMPoHvW2FNyPz9OBdiCmgMl0cCEFfarc,SpATywNh6bZuzm8s1ceuBUnMUAeoAHHw,10,19,6,0,4,5,3,0,37,5.285714285714286,1,0.0,5,6,0,4,14,5,0,3,0,15,22,1
4748,164511,uydIb4MWCn95KWcEhKwj3VRfjvxXo8Nj,G8EPVSXsOYB5YQWZGiz1aVq5Pgr2GrQu,5,3,2,0,0,0,2,0,7,1.0,1,0.0,0,2,0,0,3,0,0,2,0,2,5,1
4749,164512,Pkfxv8tlzjsegGEz3Xh7AUnCzKYEVDxE,bWdj2GDclj5ofokWjzoa5jAwMkxCykd6,6,4,2,0,1,0,3,0,10,1.4285714285714286,1,0.0,0,2,0,1,4,0,0,3,0,3,7,1
4750,164521,VKk9JpwG9p3VFd3uL9koumwFrK1tXoky,RXDvfPUBYFlVdlueBFbLW0mhhAyGEqpt,10,5,4,0,3,0,2,0,14,2.0,1,0.0,0,4,0,3,5,0,0,2,0,7,7,1
4751,164540,jPMuHTmaLyG60VmyNtfExbwyn5kE5j3d,bWdj2GDclj5ofokWjzoa5jAwMkxCykd6,1,0,0,0,0,0,1,0,1,0.14285714285714285,1,0.0,0,0,0,0,0,0,0,1,0,0,1,1
4752,164543,SFDSK6D3ITcq2gCqSV4NXsxobQMiKjKb,bWdj2GDclj5ofokWjzoa5jAwMkxCykd6,5,2,1,0,1,0,3,0,7,1.0,1,0.0,0,1,0,1,2,0,0,3,0,2,5,1
4753,164548,w7L1HWyOfKnPicf69CWEIAgi9ciJCz91,SpATywNh6bZuzm8s1ceuBUnMUAeoAHHw,11,12,1,12,0,0,3,1,29,4.142857142857143,1,0.0,7,1,10,0,5,0,2,3,1,18,11,1
4754,164549,uDLEkuBy3ymjXkWGDerrVKjWfVpjtLcy,SpATywNh6bZuzm8s1ceuBUnMUAeoAHHw,13,18,4,10,3,0,3,2,40,5.714285714285714,1,0.0,10,4,9,3,8,0,1,3,2,26,14,1
4755,164551,Cs1l7tXWhg4bHVkjgKntjzb2IwXtRhyR,RXDvfPUBYFlVdlueBFbLW0mhhAyGEqpt,5,2,1,0,1,0,3,0,7,1.0,1,0.0,0,1,0,1,2,0,0,3,0,2,5,1
4756,164563,PFKfwO5QSawWdwaylbr1GRPNNNfcQLNj,SpATywNh6bZuzm8s1ceuBUnMUAeoAHHw,17,24,9,22,6,6,16,1,84,12.0,2,0.0,13,9,17,6,11,6,5,16,1,45,39,1
4757,164564,ldTrxeIYDfkDUNaJhbVmYcQDlmvbdP2w,bWdj2GDclj5ofokWjzoa5jAwMkxCykd6,10,3,2,0,2,0,6,0,13,1.8571428571428572,1,0.0,0,2,0,2,3,0,0,6,0,4,9,1
4758,164569,p5rebimhkI0boSbnQg3KGGgWIQAEeFXU,SpATywNh6bZuzm8s1ceuBUnMUAeoAHHw,5,4,2,0,1,2,2,0,11,1.5714285714285714,1,0.0,0,2,0,1,4,2,0,2,0,3,8,1
4759,164572,Vlk2b9egCmW1kemn8Fl1v1olMRLDZnR0,SpATywNh6bZuzm8s1ceuBUnMUAeoAHHw,7,4,3,0,2,0,3,0,12,1.7142857142857142,1,0.0,0,3,0,2,4,0,0,3,0,5,7,1
4760,164577,LzbTNpWVn6fl2StGvYLxuW4MppuRwiQH,G8EPVSXsOYB5YQWZGiz1aVq5Pgr2GrQu,13,10,1,28,0,0,1,0,40,5.714285714285714,1,0.0,0,1,24,0,10,0,4,1,0,25,15,1
4761,164579,qo9UDSPYx7cYCq1gHLr348Aal9eXzAVb,SpATywNh6bZuzm8s1ceuBUnMUAeoAHHw,5,2,1,0,1,0,2,0,6,0.8571428571428571,1,0.0,0,1,0,1,2,0,0,2,0,2,4,1
4762,164584,cd5M4uWjG6TOaf0Pz31O3hIF99iIERs5,RXDvfPUBYFlVdlueBFbLW0mhhAyGEqpt,5,6,1,0,0,1,2,0,10,1.4285714285714286,2,0.0,2,1,0,0,4,1,0,2,0,3,7,1
4763,164589,sXsn7NeZRfEp7S6T00dl609YN1DnViK8,bWdj2GDclj5ofokWjzoa5jAwMkxCykd6,5,2,1,0,1,0,2,0,6,0.8571428571428571,1,0.0,0,1,0,1,2,0,0,2,0,2,4,1
4764,164590,JHnOuSquWHAEnk5XcKmxcm446qLMalAz,SpATywNh6bZuzm8s1ceuBUnMUAeoAHHw,13,32,12,15,9,1,7,0,76,10.857142857142858,1,0.0,9,12,14,9,23,1,1,7,0,44,32,0
4765,164593,SufYsQHcxz6kvXSXszQU44Defcxsd4P8,RXDvfPUBYFlVdlueBFbLW0mhhAyGEqpt,20,27,18,14,8,2,10,6,85,12.142857142857142,4,0.0,3,18,14,8,24,2,0,10,6,43,42,1
4766,164595,Mjc1uhwVJSwBIY7NCmz9HAIqxkVGiNWp,SpATywNh6bZuzm8s1ceuBUnMUAeoAHHw,1,0,0,0,0,0,1,0,1,0.14285714285714285,1,0.0,0,0,0,0,0,0,0,1,0,0,1,1
4767,164597,WI9rk8aS11tBAJzjcX0JSIgomYYRQVjW,G8EPVSXsOYB5YQWZGiz1aVq5Pgr2GrQu,4,3,1,0,1,0,1,0,6,0.8571428571428571,1,0.0,0,1,0,1,3,0,0,1,0,2,4,1
4768,164607,2TfX1z2kNH0aJpmX3zI7D0BaWO1JZh1N,G8EPVSXsOYB5YQWZGiz1aVq5Pgr2GrQu,7,2,1,0,1,2,3,0,9,1.2857142857142858,1,0.0,0,1,0,1,2,2,0,3,0,2,7,1
4769,164613,EBMQHva9lsULDK4s7iJrovR7inTeu6Ks,SpATywNh6bZuzm8s1ceuBUnMUAeoAHHw,4,2,1,0,1,0,1,0,5,0.7142857142857143,1,0.0,0,1,0,1,2,0,0,1,0,2,3,1
4770,164627,rCsU9p98QKUXEKegYmRuzzYV8BmhIRdS,SpATywNh6bZuzm8s1ceuBUnMUAeoAHHw,1,0,0,0,0,0,1,0,1,0.14285714285714285,1,0.0,0,0,0,0,0,0,0,1,0,0,1,1
4771,164640,Oi8ENv1r0fh4xZfmyvx6AY0XCiLDaP57,SpATywNh6bZuzm8s1ceuBUnMUAeoAHHw,5,2,1,0,1,0,2,0,6,0.8571428571428571,1,0.0,0,1,0,1,2,0,0,2,0,2,4,1
4772,164641,mneYPOl2fXbFIQgZuY7V0tw2SDw7ktpW,SpATywNh6bZuzm8s1ceuBUnMUAeoAHHw,8,11,2,0,0,0,5,0,18,2.5714285714285716,3,0.0,0,2,0,0,11,0,0,5,0,2,16,1
4773,164643,YxEAEqB4R6GTRBWDvga1GWE0URAxGc6U,bWdj2GDclj5ofokWjzoa5jAwMkxCykd6,3,2,1,0,0,0,1,0,4,0.5714285714285714,1,0.0,0,1,0,0,2,0,0,1,0,1,3,1
4774,164646,iMWyVW74QNpkzwAJujvmKOU3siri8Fgn,RXDvfPUBYFlVdlueBFbLW0mhhAyGEqpt,21,22,9,15,9,0,3,0,58,8.285714285714286,2,0.0,11,9,15,9,11,0,0,3,0,44,14,1
4775,164653,NzAcUY76dhfwRLfnT8WUtgPXMkNyrCBL,SpATywNh6bZuzm8s1ceuBUnMUAeoAHHw,5,2,1,0,1,0,2,0,6,0.8571428571428571,1,0.0,0,1,0,1,2,0,0,2,0,2,4,1
4776,164659,xs8FwmyIICdFtTqViprbjnWxSS7J89Al,G8EPVSXsOYB5YQWZGiz1aVq5Pgr2GrQu,4,7,0,0,0,0,1,0,8,1.1428571428571428,1,0.0,3,0,0,0,4,0,0,1,0,3,5,1
4777,164660,yqw7ro5WJlrZH88vsKBmg60OfoWnl19q,SpATywNh6bZuzm8s1ceuBUnMUAeoAHHw,6,6,2,0,2,0,2,0,12,1.7142857142857142,2,0.0,0,2,0,2,6,0,0,2,0,4,8,1
4778,164673,5HX4czL6Sp8ee3UX2kWAHqmFW5CMMTjE,SpATywNh6bZuzm8s1ceuBUnMUAeoAHHw,1,0,0,0,0,0,1,0,1,0.14285714285714285,1,0.0,0,0,0,0,0,0,0,1,0,0,1,1
4779,164676,3SCBHiEI4HvwPrOQDNTIAqp1rZOAx5IK,SpATywNh6bZuzm8s1ceuBUnMUAeoAHHw,13,11,6,16,3,0,3,0,39,5.571428571428571,2,0.0,3,6,14,3,8,0,2,3,0,26,13,1
4780,164679,3SCBHiEI4HvwPrOQDNTIAqp1rZOAx5IK,G8EPVSXsOYB5YQWZGiz1aVq5Pgr2GrQu,27,9,5,142,0,0,5,0,161,23.0,3,0.0,0,5,124,0,9,0,18,5,0,129,32,1
4781,164683,RLJL0sLgyeMOTE7yAIublGPUVoAHuvDx,G8EPVSXsOYB5YQWZGiz1aVq5Pgr2GrQu,18,17,16,20,10,0,2,0,65,9.285714285714286,1,0.0,0,16,16,10,17,0,4,2,0,42,23,1
4782,164692,yc3vj6DBU7J8xD482LnMAUcmHp7gOl84,SpATywNh6bZuzm8s1ceuBUnMUAeoAHHw,1,0,0,0,0,0,1,0,1,0.14285714285714285,1,0.0,0,0,0,0,0,0,0,1,0,0,1,1
4783,164727,caSt06ZROuiH9pArEzpLM7jwlm2pIP8u,SpATywNh6bZuzm8s1ceuBUnMUAeoAHHw,1,0,0,0,0,0,3,0,3,0.42857142857142855,1,0.0,0,0,0,0,0,0,0,3,0,0,3,1
4784,164748,m5oXLk5fStXUe1mP1ujV3P2Gk727qBkB,SpATywNh6bZuzm8s1ceuBUnMUAeoAHHw,1,0,0,0,0,0,1,0,1,0.14285714285714285,1,0.0,0,0,0,0,0,0,0,1,0,0,1,1
4785,164756,tedGThhHMqVARfBh6zyzyocTKbTJYJpB,RXDvfPUBYFlVdlueBFbLW0mhhAyGEqpt,5,3,2,0,0,0,2,0,7,1.0,1,0.0,0,2,0,0,3,0,0,2,0,2,5,1
4786,164761,DhCQzcFGsfZK6cdFiI5FQU3kb44TMCVX,SpATywNh6bZuzm8s1ceuBUnMUAeoAHHw,3,0,0,0,0,1,2,0,3,0.42857142857142855,1,0.0,0,0,0,0,0,1,0,2,0,0,3,1
4787,164774,ztw81mUsVcWqQkxlUbURYmOFyO40Z11S,SpATywNh6bZuzm8s1ceuBUnMUAeoAHHw,1,0,0,0,0,0,1,0,1,0.14285714285714285,1,0.0,0,0,0,0,0,0,0,1,0,0,1,1
4788,164777,VGDu6m0Ea8YNSzlZeUPCdOS7FC8K56j0,SpATywNh6bZuzm8s1ceuBUnMUAeoAHHw,12,23,10,19,4,0,6,0,62,8.857142857142858,4,0.0,2,10,16,4,21,0,3,6,0,32,30,1
4789,164782,AZ1a6e6HDgHh4sN10TmubQgIG7lRhvX7,bWdj2GDclj5ofokWjzoa5jAwMkxCykd6,3,3,1,0,0,1,1,0,6,0.8571428571428571,1,0.0,0,1,0,0,3,1,0,1,0,1,5,1
4790,164783,HNOiqLBLlemqEjDq99MX1KCbGHtf7sfC,SpATywNh6bZuzm8s1ceuBUnMUAeoAHHw,5,2,1,0,1,0,3,0,7,1.0,1,0.0,0,1,0,1,2,0,0,3,0,2,5,1
4791,164784,vuyiZXIHubBxUI6I8fEoaPJZI5irtStd,SpATywNh6bZuzm8s1ceuBUnMUAeoAHHw,12,22,16,0,10,1,7,2,58,8.285714285714286,2,0.0,2,16,0,10,20,1,0,7,2,28,30,1
4792,164789,0drSvAjmQGn3JsM9rLj67sU9ycFdNRi4,SpATywNh6bZuzm8s1ceuBUnMUAeoAHHw,5,13,0,0,1,0,1,0,15,2.142857142857143,2,0.0,3,0,0,1,10,0,0,1,0,4,11,1
4793,164810,j9RRCN4Cgg3M5ymRYEPqwWpJ0OwCWsXl,G8EPVSXsOYB5YQWZGiz1aVq5Pgr2GrQu,1,0,0,0,0,0,1,0,1,0.14285714285714285,1,0.0,0,0,0,0,0,0,0,1,0,0,1,1
4794,164876,jqdafBVztOaU7B8oBuajiXxvz1FDItGv,SpATywNh6bZuzm8s1ceuBUnMUAeoAHHw,1,0,0,0,0,0,1,0,1,0.14285714285714285,1,0.0,0,0,0,0,0,0,0,1,0,0,1,1
4795,164881,R7ptDQN35cKkqrWYU1EoWDk89h01yGje,RXDvfPUBYFlVdlueBFbLW0mhhAyGEqpt,1,0,0,0,0,0,1,0,1,0.14285714285714285,1,0.0,0,0,0,0,0,0,0,1,0,0,1,1
4796,164889,DivG3ogmCJeK3pKkDuguqXmAxv3265HB,bWdj2GDclj5ofokWjzoa5jAwMkxCykd6,8,11,1,0,2,0,10,0,24,3.4285714285714284,2,0.0,2,1,0,2,9,0,0,10,0,5,19,1
4797,164895,fr5elk998a9p9TdUbECrRSQ9rGDS8c9D,SpATywNh6bZuzm8s1ceuBUnMUAeoAHHw,3,0,0,0,0,1,2,0,3,0.42857142857142855,1,0.0,0,0,0,0,0,1,0,2,0,0,3,1
4798,164900,vqI4nA1oYdvinhdwhAimFfTLZs6qGSC5,G8EPVSXsOYB5YQWZGiz1aVq5Pgr2GrQu,8,6,2,4,2,0,2,0,16,2.2857142857142856,1,0.0,3,2,3,2,3,0,1,2,0,10,6,1
4799,164909,DttwjifTB7tngrOzE4lsIB8DzMDnSPZc,SpATywNh6bZuzm8s1ceuBUnMUAeoAHHw,8,2,1,0,1,1,6,1,12,1.7142857142857142,1,0.0,0,1,0,1,2,1,0,6,1,2,10,0
4800,164914,VAF0Nhm4Uogjf17s6SveryaIcEEMWJow,SpATywNh6bZuzm8s1ceuBUnMUAeoAHHw,6,6,1,0,1,0,2,0,10,1.4285714285714286,1,0.0,0,1,0,1,6,0,0,2,0,2,8,1
4801,164918,R7wdnz7rd7yU47Qq2pD3NnafkKkL5gzl,bWdj2GDclj5ofokWjzoa5jAwMkxCykd6,3,2,0,0,0,0,1,0,3,0.42857142857142855,1,0.0,0,0,0,0,2,0,0,1,0,0,3,1
4802,164919,re5aCokPT0KNmuJHbgQvisAT0CcTxib5,SpATywNh6bZuzm8s1ceuBUnMUAeoAHHw,7,5,1,0,1,0,3,0,10,1.4285714285714286,2,0.0,0,1,0,1,5,0,0,3,0,2,8,1
4803,164922,JYJhzhhLcfWnYO62UZR1KbHHs0q9wRVk,bWdj2GDclj5ofokWjzoa5jAwMkxCykd6,10,3,2,0,2,2,8,2,19,2.7142857142857144,2,0.0,0,2,0,2,3,2,0,8,2,4,15,1
4804,164923,Zoez9P6Io2KASPtKsQZfhyeC8nEU9r7r,SpATywNh6bZuzm8s1ceuBUnMUAeoAHHw,9,3,2,0,2,1,6,0,14,2.0,1,0.0,0,2,0,2,3,1,0,6,0,4,10,1
4805,164927,qr1Y8xuPrcpdzScNHYsirGXqasfUdOVa,bWdj2GDclj5ofokWjzoa5jAwMkxCykd6,8,10,6,0,3,1,8,0,28,4.0,2,0.0,0,6,0,3,10,1,0,8,0,9,19,1
4806,164937,i39wrwOFUT4cBFVx9tMMQ3lQ2qJwZK9W,G8EPVSXsOYB5YQWZGiz1aVq5Pgr2GrQu,4,7,1,0,0,0,2,0,10,1.4285714285714286,1,0.0,0,1,0,0,7,0,0,2,0,1,9,1
4807,164942,OOJh2Yrr6RQf9QAHFBo7EBzeZ2OAmLfw,bWdj2GDclj5ofokWjzoa5jAwMkxCykd6,5,5,2,0,1,0,2,0,10,1.4285714285714286,2,0.0,0,2,0,1,5,0,0,2,0,3,7,1
4808,164944,stWyUqkAGnjcutkepILPjL3dk2mkjbHM,SpATywNh6bZuzm8s1ceuBUnMUAeoAHHw,1,0,0,0,0,0,1,0,1,0.14285714285714285,1,0.0,0,0,0,0,0,0,0,1,0,0,1,1
4809,164953,8lCrBaMkcXk8KsL7M8AYgjnsyFuSP4yK,RXDvfPUBYFlVdlueBFbLW0mhhAyGEqpt,9,10,7,0,3,0,3,0,23,3.2857142857142856,2,0.0,0,7,0,3,10,0,0,3,0,10,13,1
4810,164996,jXdIWOuPNFgWCy1owZ0YCDgHmNjNpxj3,A3fsA9Zfv1X2fVEQhTw51lKENdNrEqT3,1,0,0,0,0,0,1,0,1,0.14285714285714285,1,0.0,0,0,0,0,0,0,0,1,0,0,1,1
4811,165033,YtmzH8LgN5OvtPELquH1F749iO0gQ3Tb,A3fsA9Zfv1X2fVEQhTw51lKENdNrEqT3,2,0,0,0,0,0,2,0,2,0.2857142857142857,1,0.0,0,0,0,0,0,0,0,2,0,0,2,1
4812,165092,HA5bOUyNRCHCSCRIajqqX7k2ZeKuADcF,A3fsA9Zfv1X2fVEQhTw51lKENdNrEqT3,1,0,0,0,0,0,1,0,1,0.14285714285714285,1,0.0,0,0,0,0,0,0,0,1,0,0,1,1
4813,165093,S58o7T8J2JcEBTi3bdMATXeMdhJbXqYq,A3fsA9Zfv1X2fVEQhTw51lKENdNrEqT3,3,0,0,0,0,0,4,0,4,0.5714285714285714,1,0.0,0,0,0,0,0,0,0,4,0,0,4,1
4814,165138,iqnxkAIvXEPq7LutRrGOzst5meEvTsYz,SpATywNh6bZuzm8s1ceuBUnMUAeoAHHw,11,12,4,1,3,0,2,0,22,3.142857142857143,1,0.0,5,4,1,3,7,0,0,2,0,13,9,1
4815,165151,CXDFvBGg10x2RDdl5BC09Fv76dN9FJm7,G8EPVSXsOYB5YQWZGiz1aVq5Pgr2GrQu,17,22,9,16,3,2,1,0,53,7.571428571428571,1,0.0,7,9,9,3,15,2,7,1,0,28,25,1
4816,165191,gR8vpBOtEmg1p0U3mlFoyPZ2gKmD8M8k,A3fsA9Zfv1X2fVEQhTw51lKENdNrEqT3,1,0,0,0,0,0,1,0,1,0.14285714285714285,1,0.0,0,0,0,0,0,0,0,1,0,0,1,1
4817,165285,GFb1F59UyYIHTp4jDg01zdNYbr3jH9yn,A3fsA9Zfv1X2fVEQhTw51lKENdNrEqT3,1,0,0,0,0,0,1,0,1,0.14285714285714285,1,0.0,0,0,0,0,0,0,0,1,0,0,1,1
4818,165347,oaoj9be4jW2Hot8wYgYrzLRvB0RU4KYy,RXDvfPUBYFlVdlueBFbLW0mhhAyGEqpt,4,2,1,0,1,0,1,0,5,0.7142857142857143,1,0.0,0,1,0,1,2,0,0,1,0,2,3,1
4819,165443,Q9be6Sv8ddFyvZit7vIIJ8yY710RxCDU,A3fsA9Zfv1X2fVEQhTw51lKENdNrEqT3,2,0,0,0,0,0,3,0,3,0.42857142857142855,1,0.0,0,0,0,0,0,0,0,3,0,0,3,1
4820,165517,K96pKWxanyeEDM8caXTjQInVlZNIUXf3,SpATywNh6bZuzm8s1ceuBUnMUAeoAHHw,6,3,1,0,1,0,5,0,10,1.4285714285714286,1,0.0,0,1,0,1,3,0,0,5,0,2,8,1
4821,165533,CTzsOL49UPUArAP2sAfnnQhe79FdliFF,A3fsA9Zfv1X2fVEQhTw51lKENdNrEqT3,7,8,1,0,1,0,2,0,12,1.7142857142857142,1,0.0,2,1,0,1,6,0,0,2,0,4,8,1
4822,165544,cLRv4oHsLxWfkE6gs4eN6fO5y0RK8Odw,SpATywNh6bZuzm8s1ceuBUnMUAeoAHHw,10,10,1,8,0,0,2,0,21,3.0,1,0.0,5,1,8,0,5,0,0,2,0,14,7,1
4823,165574,JfftjOGdDbpgbrupi0Gwr899R0jzXikJ,G8EPVSXsOYB5YQWZGiz1aVq5Pgr2GrQu,8,5,2,0,2,2,4,1,16,2.2857142857142856,1,0.0,0,2,0,2,5,2,0,4,1,4,12,1
4824,165580,qoIGs6RP8XMC5yN9VowJtSVp77FsPrRk,bWdj2GDclj5ofokWjzoa5jAwMkxCykd6,14,12,5,4,4,1,5,4,35,5.0,1,0.0,1,5,4,4,11,1,0,5,4,14,21,1
4825,165660,Jxd0Gyi2eFjuuzujg1eSA5QBX1QonMfb,A3fsA9Zfv1X2fVEQhTw51lKENdNrEqT3,8,8,7,0,7,0,4,0,26,3.7142857142857144,1,0.0,0,7,0,7,8,0,0,4,0,14,12,1
4826,165668,e4SJlWpUdMlW0LkwuTE29pgj3noS6rgx,SpATywNh6bZuzm8s1ceuBUnMUAeoAHHw,1,0,0,0,0,0,1,0,1,0.14285714285714285,1,0.0,0,0,0,0,0,0,0,1,0,0,1,1
4827,165704,aBWIo3Zb0x1GrHxSSFQ0sr4ViufznfA6,bWdj2GDclj5ofokWjzoa5jAwMkxCykd6,2,0,0,0,0,0,3,0,3,0.42857142857142855,1,0.0,0,0,0,0,0,0,0,3,0,0,3,0
4828,165772,HpI5z92WE9TCj3JyfZi0b0yrE9hT84vs,A3fsA9Zfv1X2fVEQhTw51lKENdNrEqT3,1,0,0,0,0,0,1,0,1,0.14285714285714285,1,0.0,0,0,0,0,0,0,0,1,0,0,1,1
4829,166041,LShHu6uYlRN5bIHuJkopPqEfnHxBTC8i,fbPkOYLVPtPgIt0MxizjfFJov3JbHyAi,2,0,0,0,0,0,5,0,5,0.7142857142857143,1,0.0,0,0,0,0,0,0,0,5,0,0,5,1
4830,166043,N9J0YMMUvYV85FVJ0qX5eo6FonnNSF85,fbPkOYLVPtPgIt0MxizjfFJov3JbHyAi,2,0,0,0,0,0,2,0,2,0.2857142857142857,1,0.0,0,0,0,0,0,0,0,2,0,0,2,1
4831,166046,r0yZNwEG828V0TMkCl61Reya5Y5HO5aR,fbPkOYLVPtPgIt0MxizjfFJov3JbHyAi,4,3,1,0,1,0,1,0,6,0.8571428571428571,1,0.0,0,1,0,1,3,0,0,1,0,2,4,0
4832,166050,dTKURyZ9dyqGbe4l7wsUGgSU85JHBAFq,fbPkOYLVPtPgIt0MxizjfFJov3JbHyAi,4,2,1,0,1,0,1,0,5,0.7142857142857143,1,0.0,0,1,0,1,2,0,0,1,0,2,3,0
4833,166051,zys4H0zoKgEwqaSlxuoMh0ylzZsMRp6B,fbPkOYLVPtPgIt0MxizjfFJov3JbHyAi,8,2,2,0,2,0,3,0,9,1.2857142857142858,1,0.0,0,2,0,2,2,0,0,3,0,4,5,1
4834,166052,zRVD6VEUKDrryOP1TvtbSCWZetILcTFA,fbPkOYLVPtPgIt0MxizjfFJov3JbHyAi,5,3,1,0,1,0,2,0,7,1.0,1,0.0,1,1,0,1,2,0,0,2,0,3,4,1
4835,166054,aCi7yBADL9TO8ilUuxPHdQalGIRg3aJr,fbPkOYLVPtPgIt0MxizjfFJov3JbHyAi,6,1,1,0,1,3,4,0,10,1.4285714285714286,1,0.0,0,1,0,1,1,3,0,4,0,2,8,1
4836,166055,dMp1KIJnUk3pJLRma1sY50MtqbX92XeU,fbPkOYLVPtPgIt0MxizjfFJov3JbHyAi,4,2,1,0,0,0,2,0,5,0.7142857142857143,1,0.0,0,1,0,0,2,0,0,2,0,1,4,1
4837,166056,RXpyLiihGXUCA8h1EctnHTjiraMHD0a4,fbPkOYLVPtPgIt0MxizjfFJov3JbHyAi,7,5,3,0,2,4,2,0,16,2.2857142857142856,1,0.0,0,3,0,2,5,4,0,2,0,5,11,1
4838,166061,8gVI3RCzdwrb0srHH9NO7stO8AUu1uCR,fbPkOYLVPtPgIt0MxizjfFJov3JbHyAi,3,0,0,0,0,34,2,0,36,5.142857142857143,1,0.0,0,0,0,0,0,34,0,2,0,0,36,1
4839,166063,tJFzrDg5BaUKwBS7uJ8wgIWbLiKiPTve,fbPkOYLVPtPgIt0MxizjfFJov3JbHyAi,2,0,0,0,0,0,3,0,3,0.42857142857142855,1,0.0,0,0,0,0,0,0,0,3,0,0,3,1
4840,166064,lxeXZ87M0UdQbm9QL7lTn6YACn14X0PC,fbPkOYLVPtPgIt0MxizjfFJov3JbHyAi,11,6,5,0,4,0,2,0,17,2.4285714285714284,1,0.0,0,5,0,4,6,0,0,2,0,9,8,1
4841,166065,ijyyGxSCkTNXshxGrWCb96rdtgSJNssR,fbPkOYLVPtPgIt0MxizjfFJov3JbHyAi,7,3,2,0,2,0,2,0,9,1.2857142857142858,1,0.0,0,2,0,2,3,0,0,2,0,4,5,1
4842,166067,7fC3V6ivG07wUIMOmiYFzSlyjWvbYnYf,fbPkOYLVPtPgIt0MxizjfFJov3JbHyAi,1,0,0,0,0,0,1,0,1,0.14285714285714285,1,0.0,0,0,0,0,0,0,0,1,0,0,1,1
4843,166068,uUEAEHuEOlAvsHurjyTj6J9XqJZTLr4r,fbPkOYLVPtPgIt0MxizjfFJov3JbHyAi,10,10,5,3,7,0,2,0,27,3.857142857142857,1,0.0,4,5,2,7,6,0,1,2,0,18,9,1
4844,166069,icJiAKjBBiURMzSKaDbpsCD4jk8ynifx,fbPkOYLVPtPgIt0MxizjfFJov3JbHyAi,3,0,0,0,0,0,7,0,7,1.0,1,0.0,0,0,0,0,0,0,0,7,0,0,7,1
4845,166070,lUDEsCpeeCxZyURyjEd7RvRXvuIDJHXc,fbPkOYLVPtPgIt0MxizjfFJov3JbHyAi,8,6,4,0,3,0,3,0,16,2.2857142857142856,1,0.0,0,4,0,3,6,0,0,3,0,7,9,1
4846,166073,Sy0IBVghIdDN5uhsYaAtE4EZP4lbDR6C,fbPkOYLVPtPgIt0MxizjfFJov3JbHyAi,7,3,2,0,2,0,4,0,11,1.5714285714285714,2,0.0,0,2,0,2,3,0,0,4,0,4,7,1
4847,166076,tlV5mNtKN8OpE3fnEW9HsMaTsOyR1fSl,fbPkOYLVPtPgIt0MxizjfFJov3JbHyAi,2,0,0,0,0,0,2,0,2,0.2857142857142857,1,0.0,0,0,0,0,0,0,0,2,0,0,2,1
4848,166096,d2dMin38z1mvwoR5boGKYx3URnEXiseW,fbPkOYLVPtPgIt0MxizjfFJov3JbHyAi,7,5,2,0,2,23,4,0,36,5.142857142857143,1,0.0,2,2,0,2,3,23,0,4,0,6,30,1
4849,166952,V52G1wHOq5zd0Up8zjShFJCn7Er4GImu,SpATywNh6bZuzm8s1ceuBUnMUAeoAHHw,3,3,0,0,0,0,1,0,4,0.5714285714285714,1,0.0,0,0,0,0,3,0,0,1,0,0,4,1
4850,167244,Cie8MgBDvC4HVRvuqtFzP8SkWOhgrE8X,SpATywNh6bZuzm8s1ceuBUnMUAeoAHHw,10,26,18,0,7,0,6,0,57,8.142857142857142,1,0.0,3,18,0,7,23,0,0,6,0,28,29,1
4851,167779,BWZyBrJDBbkcDEXyE3CSVFoVlT2CRRku,A3fsA9Zfv1X2fVEQhTw51lKENdNrEqT3,1,0,0,0,0,0,1,0,1,0.14285714285714285,1,0.0,0,0,0,0,0,0,0,1,0,0,1,1
4852,169764,O8pydf8wdA8EjOBMj6o80eWX7PkIMpuy,7GRhBDsirIGkRZBtSMEzNTyDr2JQm4xx,7,1,1,0,1,1,4,1,9,1.2857142857142858,1,0.0,0,1,0,1,1,1,0,4,1,2,7,1
4853,169767,l1rg3D8Gp1lv7dbBBYKvzTS3OZ5DRjWH,7GRhBDsirIGkRZBtSMEzNTyDr2JQm4xx,11,15,6,0,3,0,2,0,26,3.7142857142857144,2,0.0,0,6,0,3,15,0,0,2,0,9,17,1
4854,169814,w7UkLHeAPhvA1M8odbbK7J9zzLA0KhPR,7GRhBDsirIGkRZBtSMEzNTyDr2JQm4xx,10,12,0,10,0,2,5,0,29,4.142857142857143,1,0.0,5,0,9,0,7,2,1,5,0,14,15,1
4855,169845,QFfUN9yxUlsMNYgpicOpe1up7xBAfW6Y,7GRhBDsirIGkRZBtSMEzNTyDr2JQm4xx,4,2,1,0,1,0,1,0,5,0.7142857142857143,1,0.0,0,1,0,1,2,0,0,1,0,2,3,1
4856,169853,Qi3PLuC7w2Yo9hFgq37MObjY8icnRdc6,7GRhBDsirIGkRZBtSMEzNTyDr2JQm4xx,14,25,9,14,1,2,4,0,55,7.857142857142857,1,0.0,6,9,12,1,19,2,2,4,0,28,27,1
4857,169963,i0ksX07HnsV5rQlWqOr1uKEuc7yNU24c,7GRhBDsirIGkRZBtSMEzNTyDr2JQm4xx,14,7,5,0,4,1,7,0,24,3.4285714285714284,1,0.0,1,5,0,4,6,1,0,7,0,10,14,1
4858,169984,f6KJlC1ScrQZtGOzsyUMpOtZeSqtR8rB,7GRhBDsirIGkRZBtSMEzNTyDr2JQm4xx,1,0,0,0,0,0,1,0,1,0.14285714285714285,1,0.0,0,0,0,0,0,0,0,1,0,0,1,1
4859,170023,c1BXmJNemroOPh6WUefTBD28s2WzSNwi,7GRhBDsirIGkRZBtSMEzNTyDr2JQm4xx,5,4,0,0,0,0,2,0,6,0.8571428571428571,1,0.0,1,0,0,0,3,0,0,2,0,1,5,1
4860,170043,n0HFF3TwqKuBMzzkdLCbvb8Mji5ZUnVX,7GRhBDsirIGkRZBtSMEzNTyDr2JQm4xx,5,2,1,0,1,0,2,0,6,0.8571428571428571,1,0.0,0,1,0,1,2,0,0,2,0,2,4,1
4861,170078,S6Mv1aKyTUf7xcwwDYCs3vpkSwBRaGU9,SpATywNh6bZuzm8s1ceuBUnMUAeoAHHw,3,2,0,0,0,0,1,0,3,0.42857142857142855,1,0.0,0,0,0,0,2,0,0,1,0,0,3,0
4862,170102,3v1JFL0HMqiuFdQBduyDYGcupFiSmqdG,7GRhBDsirIGkRZBtSMEzNTyDr2JQm4xx,21,26,7,14,7,0,4,0,58,8.285714285714286,2,0.0,18,7,12,7,8,0,2,4,0,44,14,1
4863,170198,W8psMt8K6E7obsinwdemXzpwbpxCP9R1,7GRhBDsirIGkRZBtSMEzNTyDr2JQm4xx,5,10,5,0,0,0,2,0,17,2.4285714285714284,1,0.0,1,5,0,0,9,0,0,2,0,6,11,1
4864,170248,9b2fchNyVZPjqpmxjleqzL9edi9EOH23,7GRhBDsirIGkRZBtSMEzNTyDr2JQm4xx,1,0,0,0,0,0,1,0,1,0.14285714285714285,1,0.0,0,0,0,0,0,0,0,1,0,0,1,1
4865,170272,CvkCRHPN9Kdm6u8tUG5peGiWArNJEfk8,7GRhBDsirIGkRZBtSMEzNTyDr2JQm4xx,22,27,7,33,14,3,7,1,92,13.142857142857142,1,0.0,19,7,28,14,8,3,5,7,1,68,24,1
4866,170436,68jxA2PUjT1NQfZbUcdmPfGR0u6r2zeM,7GRhBDsirIGkRZBtSMEzNTyDr2JQm4xx,1,0,0,0,0,0,3,0,3,0.42857142857142855,1,0.0,0,0,0,0,0,0,0,3,0,0,3,1
4867,170454,68jxA2PUjT1NQfZbUcdmPfGR0u6r2zeM,A3fsA9Zfv1X2fVEQhTw51lKENdNrEqT3,1,0,0,0,0,0,1,0,1,0.14285714285714285,1,0.0,0,0,0,0,0,0,0,1,0,0,1,1
4868,170543,Z4MdM7wvbK2oPoLlwXYYW0r3PZvWrL6Z,7GRhBDsirIGkRZBtSMEzNTyDr2JQm4xx,5,2,1,0,1,0,2,0,6,0.8571428571428571,1,0.0,0,1,0,1,2,0,0,2,0,2,4,1
4869,170558,40L77km5z19sJEVeJ6u4qpa9SAG2ZSIF,G8EPVSXsOYB5YQWZGiz1aVq5Pgr2GrQu,6,7,2,0,0,0,3,0,12,1.7142857142857142,1,0.0,4,2,0,0,3,0,0,3,0,6,6,1
4870,170628,1FJgNHNZRyIkv3hAgs29ZaCmWBTNZtcq,7GRhBDsirIGkRZBtSMEzNTyDr2JQm4xx,1,0,0,0,0,0,1,0,1,0.14285714285714285,1,0.0,0,0,0,0,0,0,0,1,0,0,1,1
4871,170635,dcCbaqbKHCs7CPRffWThbopWB8akROlP,7GRhBDsirIGkRZBtSMEzNTyDr2JQm4xx,8,3,1,0,1,0,5,3,13,1.8571428571428572,1,0.0,0,1,0,1,3,0,0,5,3,2,11,1
4872,170680,xfIXdIbpI0XdgPBSDtKqxzOIzP21Dq8x,7GRhBDsirIGkRZBtSMEzNTyDr2JQm4xx,1,0,0,0,0,0,1,0,1,0.14285714285714285,1,0.0,0,0,0,0,0,0,0,1,0,0,1,1
4873,170682,K3RmvehnU0yLuzkdfShsHIJB4RyDPmXO,bWdj2GDclj5ofokWjzoa5jAwMkxCykd6,4,3,1,0,1,0,1,0,6,0.8571428571428571,1,0.0,1,1,0,1,2,0,0,1,0,3,3,1
4874,172639,ZkfFwyK1OgVihBxVb6PuDCZttx0mY0GH,7GRhBDsirIGkRZBtSMEzNTyDr2JQm4xx,1,0,0,0,0,0,1,0,1,0.14285714285714285,1,0.0,0,0,0,0,0,0,0,1,0,0,1,1
4875,173146,p9UNvuDUoGgEq49Fv2ZMxggXXq1CzTMu,SpATywNh6bZuzm8s1ceuBUnMUAeoAHHw,13,35,10,10,2,4,8,1,70,10.0,1,0.0,20,10,10,2,15,4,0,8,1,42,28,1
4876,173471,zvLkVcjFtCYyIxQ5AgxEHNEKFJjc1e0w,SpATywNh6bZuzm8s1ceuBUnMUAeoAHHw,16,10,7,12,5,3,6,1,44,6.285714285714286,1,0.0,2,7,9,5,8,3,3,6,1,23,21,1
4877,173934,WI9rk8aS11tBAJzjcX0JSIgomYYRQVjW,RXDvfPUBYFlVdlueBFbLW0mhhAyGEqpt,16,16,0,0,0,2,9,3,30,4.285714285714286,1,0.0,0,0,0,0,16,2,0,9,3,0,30,0
4878,174116,89IraAtUfhoGAQgzdMP1844g2s2iN4Ox,SpATywNh6bZuzm8s1ceuBUnMUAeoAHHw,12,9,3,13,3,0,2,0,30,4.285714285714286,1,0.0,4,3,13,3,5,0,0,2,0,23,7,1
4879,174168,y4jCbRq0ZMCabQVeAWisCVju9AF82joj,SpATywNh6bZuzm8s1ceuBUnMUAeoAHHw,2,0,0,0,0,0,2,0,2,0.2857142857142857,1,0.0,0,0,0,0,0,0,0,2,0,0,2,1
4880,174377,BeoWdDFNsVFqWVq3B4qjYh8vNjNTgwSB,bWdj2GDclj5ofokWjzoa5jAwMkxCykd6,12,9,6,0,4,0,14,0,33,4.714285714285714,1,0.0,0,6,0,4,9,0,0,14,0,10,23,1
4881,174510,1JwhB7sCpqQuMWgVLCoQdnUSus34sW5p,SpATywNh6bZuzm8s1ceuBUnMUAeoAHHw,16,31,14,12,8,1,6,2,74,10.571428571428571,1,0.0,10,14,9,8,21,1,3,6,2,41,33,1
4882,174513,1JwhB7sCpqQuMWgVLCoQdnUSus34sW5p,A3fsA9Zfv1X2fVEQhTw51lKENdNrEqT3,8,10,1,0,0,0,3,0,14,2.0,1,0.0,0,1,0,0,10,0,0,3,0,1,13,1
4883,174665,6WpUAvOn0104PVGU1qRupfdkikcVBl8O,bWdj2GDclj5ofokWjzoa5jAwMkxCykd6,4,3,1,0,1,0,1,0,6,0.8571428571428571,1,0.0,0,1,0,1,3,0,0,1,0,2,4,1
4884,174692,xMCJ7gcgv1mN5rb4Qh9dpQVUc9zQ1NLX,SpATywNh6bZuzm8s1ceuBUnMUAeoAHHw,11,16,3,2,0,16,15,3,55,7.857142857142857,3,0.0,0,3,2,0,16,16,0,15,3,5,50,1
4885,174703,Nu3CWEbOlEVCvqetIYQvBCpTSFLSYvQK,SpATywNh6bZuzm8s1ceuBUnMUAeoAHHw,6,5,2,0,2,0,3,0,12,1.7142857142857142,1,0.0,0,2,0,2,5,0,0,3,0,4,8,1
4886,174878,fUQHFT4QEMRSPqJAQlXlvlyNwca9Q0dU,RXDvfPUBYFlVdlueBFbLW0mhhAyGEqpt,13,23,1,12,1,0,1,0,38,5.428571428571429,1,0.0,1,1,12,1,22,0,0,1,0,15,23,1
4887,175021,cpZrl3oP8x5CfyDGz9KAwfLq9wo2kZMm,RXDvfPUBYFlVdlueBFbLW0mhhAyGEqpt,8,5,1,0,1,0,2,0,9,1.2857142857142858,1,0.0,0,1,0,1,5,0,0,2,0,2,7,1
4888,175196,rtg3Ki4vk14kI9MkEBE0pkOCAO2AnCnU,bWdj2GDclj5ofokWjzoa5jAwMkxCykd6,18,25,16,106,4,6,10,1,168,24.0,2,0.0,4,16,103,4,21,6,3,10,1,127,41,1
4889,175379,9WmzxyamLAgd2LnrO6zydiN7WV3MNZZt,bWdj2GDclj5ofokWjzoa5jAwMkxCykd6,7,4,3,0,1,4,4,1,17,2.4285714285714284,1,0.0,0,3,0,1,4,4,0,4,1,4,13,1
4890,176576,1ZnERDT2WSNZGJeanMnjXX2EswCJEUwX,SpATywNh6bZuzm8s1ceuBUnMUAeoAHHw,6,5,2,0,2,0,4,0,13,1.8571428571428572,1,0.0,0,2,0,2,5,0,0,4,0,4,9,1
4891,176706,RPNytg6jKosKSPSkg7bLhh3BAXDjaY9a,RXDvfPUBYFlVdlueBFbLW0mhhAyGEqpt,11,7,3,6,2,0,2,0,20,2.857142857142857,1,0.0,1,3,6,2,6,0,0,2,0,12,8,1
4892,176714,mP0oq4UFI55XwGbomuLjnKyaYZ9Irhl8,RXDvfPUBYFlVdlueBFbLW0mhhAyGEqpt,1,0,0,0,0,0,1,0,1,0.14285714285714285,1,0.0,0,0,0,0,0,0,0,1,0,0,1,1
4893,177060,Et66VbQRwkFnF42twZ8Z4ErFWQLehmwC,A3fsA9Zfv1X2fVEQhTw51lKENdNrEqT3,1,0,0,0,0,0,1,0,1,0.14285714285714285,1,0.0,0,0,0,0,0,0,0,1,0,0,1,0
4894,177113,66JqxLLiEx06fBDzS4MuyYNc7nIpYGk9,A3fsA9Zfv1X2fVEQhTw51lKENdNrEqT3,13,12,8,0,6,0,2,0,28,4.0,1,0.0,0,8,0,6,12,0,0,2,0,14,14,0
4895,177460,NXEwBXbU6vvce77sujWgRB6LivhFJvRb,A3fsA9Zfv1X2fVEQhTw51lKENdNrEqT3,4,2,1,0,1,0,1,0,5,0.7142857142857143,1,0.0,0,1,0,1,2,0,0,1,0,2,3,1
4896,177501,K3eaSd5rYP9Gkimldqt40pigYQrGeLsH,bWdj2GDclj5ofokWjzoa5jAwMkxCykd6,10,8,4,14,3,0,2,0,31,4.428571428571429,1,0.0,2,4,13,3,6,0,1,2,0,22,9,1
4897,177668,p54dVByd9epbS397rAmrAwTW19iwa3UI,bWdj2GDclj5ofokWjzoa5jAwMkxCykd6,12,9,0,40,3,1,7,1,61,8.714285714285714,1,0.0,7,0,35,3,2,1,5,7,1,45,16,1
4898,177727,G4leME9fPSQLSwsbbKKP6ouczXxo1Wlw,SpATywNh6bZuzm8s1ceuBUnMUAeoAHHw,16,14,5,9,3,0,6,0,37,5.285714285714286,1,0.0,6,5,9,3,8,0,0,6,0,23,14,1
4899,177750,QjqGEc1MUmw3VEVWGhyD00LM60lNtKPh,SpATywNh6bZuzm8s1ceuBUnMUAeoAHHw,16,9,5,8,3,7,11,2,45,6.428571428571429,1,0.0,3,5,8,3,6,7,0,11,2,19,26,1
4900,177755,JHMFz2Gy459G1ldyhA75ALSO8YlPxA4n,A3fsA9Zfv1X2fVEQhTw51lKENdNrEqT3,6,5,2,0,1,0,2,0,10,1.4285714285714286,1,0.0,0,2,0,1,5,0,0,2,0,3,7,1
4901,177866,Pk6H5V6IGPh6QxXblrwO7oI0RG2f9ujy,A3fsA9Zfv1X2fVEQhTw51lKENdNrEqT3,8,8,6,0,4,0,2,0,20,2.857142857142857,1,0.0,1,6,0,4,7,0,0,2,0,11,9,1
4902,178047,g5hqByjT71l7XQpoHooh42h6aYalEjyF,RXDvfPUBYFlVdlueBFbLW0mhhAyGEqpt,5,2,1,0,1,0,2,0,6,0.8571428571428571,1,0.0,0,1,0,1,2,0,0,2,0,2,4,1
4903,178056,xk56WEVJEAYlfTe18KDPHjwyCpm6eESo,RXDvfPUBYFlVdlueBFbLW0mhhAyGEqpt,4,0,0,0,0,2,4,1,7,1.0,1,0.0,0,0,0,0,0,2,0,4,1,0,7,1
4904,178123,jpxpIqdWMtlxqJfj67lnudhyEHl6x8Bm,RXDvfPUBYFlVdlueBFbLW0mhhAyGEqpt,13,10,8,0,6,0,2,0,26,3.7142857142857144,1,0.0,2,8,0,6,8,0,0,2,0,16,10,1
4905,178135,7vNqxUIgpaCj3NnoU9xg00b9Tp3tF5Ri,SpATywNh6bZuzm8s1ceuBUnMUAeoAHHw,9,8,4,0,3,1,4,1,21,3.0,2,0.0,0,4,0,3,8,1,0,4,1,7,14,1
4906,179630,KNNMSW3oLxGqEqv2czanNkhQgdUkOWgY,G8EPVSXsOYB5YQWZGiz1aVq5Pgr2GrQu,4,2,1,0,1,0,1,0,5,0.7142857142857143,1,0.0,0,1,0,1,2,0,0,1,0,2,3,1
4907,179809,FrcNdFNfLYMOg5fdBzjs15qKbgtHEYZH,bWdj2GDclj5ofokWjzoa5jAwMkxCykd6,12,8,5,0,3,0,6,1,23,3.2857142857142856,2,0.0,1,5,0,3,7,0,0,6,1,9,14,1
4908,182110,74kxele4p3nZqMdSzyWOOH2cXxk0mF2n,fbPkOYLVPtPgIt0MxizjfFJov3JbHyAi,7,5,2,0,3,0,5,0,15,2.142857142857143,1,0.0,2,2,0,3,3,0,0,5,0,7,8,1
4909,182111,1RfSO2DiyVK1bsd1s7TaxenvqJaPeVpp,fbPkOYLVPtPgIt0MxizjfFJov3JbHyAi,5,2,1,0,1,0,3,0,7,1.0,1,0.0,0,1,0,1,2,0,0,3,0,2,5,1
4910,182114,FIhbLaUliLEAJsxsc7jKlH4XCeC9DPXv,fbPkOYLVPtPgIt0MxizjfFJov3JbHyAi,10,5,4,0,3,0,7,1,20,2.857142857142857,1,0.0,0,4,0,3,5,0,0,7,1,7,13,1
4911,182115,5O3cQgHyrDFUqJDA7J5HOtUVaVPsBSzt,fbPkOYLVPtPgIt0MxizjfFJov3JbHyAi,6,5,2,0,2,0,1,0,10,1.4285714285714286,1,0.0,0,2,0,2,5,0,0,1,0,4,6,1
4912,182117,17rg9STHXDHiRzS91SaQJyD9M8yu2605,fbPkOYLVPtPgIt0MxizjfFJov3JbHyAi,14,10,5,7,6,0,6,0,34,4.857142857142857,1,0.0,4,5,6,6,6,0,1,6,0,21,13,1
4913,182118,ytQygmlMNZc9yKIahmW7Nv1t8JgEizoV,fbPkOYLVPtPgIt0MxizjfFJov3JbHyAi,2,0,0,0,0,0,2,0,2,0.2857142857142857,1,0.0,0,0,0,0,0,0,0,2,0,0,2,1
4914,182124,sIANk8CDDpmYWYdg4Th4BflYvOf56CEK,fbPkOYLVPtPgIt0MxizjfFJov3JbHyAi,6,5,1,0,2,0,2,0,10,1.4285714285714286,1,0.0,2,1,0,2,3,0,0,2,0,5,5,1
4915,182125,aDT6m9laxK2gk5mLuphqqVgMaj2Iqzzo,fbPkOYLVPtPgIt0MxizjfFJov3JbHyAi,1,0,0,0,0,0,1,0,1,0.14285714285714285,1,0.0,0,0,0,0,0,0,0,1,0,0,1,1
4916,182128,FgihPmscVblrwMVdNFApI0UuOBmm5ZAb,fbPkOYLVPtPgIt0MxizjfFJov3JbHyAi,1,0,0,0,0,0,1,0,1,0.14285714285714285,1,0.0,0,0,0,0,0,0,0,1,0,0,1,1
4917,182134,NZSWYEaOe1aGzYbLbh5XgSdJLgnj2k8M,fbPkOYLVPtPgIt0MxizjfFJov3JbHyAi,7,3,2,0,2,0,10,0,17,2.4285714285714284,1,0.0,0,2,0,2,3,0,0,10,0,4,13,1
4918,182135,iejOj5OrmiAxzthyfxCU4HfOTTqB4wPz,fbPkOYLVPtPgIt0MxizjfFJov3JbHyAi,6,3,2,0,1,0,3,0,9,1.2857142857142858,1,0.0,0,2,0,1,3,0,0,3,0,3,6,1
4919,182138,QLWeBu2uxsDdky4Sdm2eq1MPlPyoR8PH,fbPkOYLVPtPgIt0MxizjfFJov3JbHyAi,2,0,0,0,0,0,8,0,8,1.1428571428571428,1,0.0,0,0,0,0,0,0,0,8,0,0,8,1
4920,182139,zlBC6rRu9jlWaXBFQagY5lGC2179zznK,fbPkOYLVPtPgIt0MxizjfFJov3JbHyAi,9,4,3,0,3,8,13,0,31,4.428571428571429,1,0.0,0,3,0,3,4,8,0,13,0,6,25,1
4921,182143,dX17jSABXDRMoXQfnDhuEq3sAW2GzYho,fbPkOYLVPtPgIt0MxizjfFJov3JbHyAi,6,1,1,0,1,0,5,0,8,1.1428571428571428,1,0.0,0,1,0,1,1,0,0,5,0,2,6,1
4922,182144,65phBvShfMs4BgpXceOfsAexAndxdKUb,fbPkOYLVPtPgIt0MxizjfFJov3JbHyAi,8,5,3,0,2,0,3,0,13,1.8571428571428572,1,0.0,0,3,0,2,5,0,0,3,0,5,8,1
4923,182145,s9ikAKfIHizdIit72lZmNDpOCL8RyNmr,fbPkOYLVPtPgIt0MxizjfFJov3JbHyAi,1,0,0,0,0,0,1,0,1,0.14285714285714285,1,0.0,0,0,0,0,0,0,0,1,0,0,1,1
4924,182146,je4a6LCViJiZST1Qe1r42SwknRjAiEHX,fbPkOYLVPtPgIt0MxizjfFJov3JbHyAi,9,6,4,0,3,2,7,0,22,3.142857142857143,1,0.0,0,4,0,3,6,2,0,7,0,7,15,1
4925,182147,w6ZOM4xdCTA9pBKt304kiLQIHLSshQf0,fbPkOYLVPtPgIt0MxizjfFJov3JbHyAi,9,4,3,0,3,0,5,0,15,2.142857142857143,1,0.0,0,3,0,3,4,0,0,5,0,6,9,1
4926,182152,eXbUPJJ8vgGBYCYeE2hEC0aNbKdSDbEs,fbPkOYLVPtPgIt0MxizjfFJov3JbHyAi,1,0,0,0,0,0,1,0,1,0.14285714285714285,1,0.0,0,0,0,0,0,0,0,1,0,0,1,1
4927,182154,0TrmohedmafnRfHAroMKgKRtGWbbpH4N,fbPkOYLVPtPgIt0MxizjfFJov3JbHyAi,2,0,0,0,0,0,6,0,6,0.8571428571428571,1,0.0,0,0,0,0,0,0,0,6,0,0,6,1
4928,182155,BoBgrmtQAbGEQdCkYjgMVVWzk508tw3x,fbPkOYLVPtPgIt0MxizjfFJov3JbHyAi,4,2,1,0,1,0,1,0,5,0.7142857142857143,1,0.0,0,1,0,1,2,0,0,1,0,2,3,1
4929,182156,DLmLcsmmZc2iMAWHNtxeaYm4TYub9M4W,fbPkOYLVPtPgIt0MxizjfFJov3JbHyAi,1,0,0,0,0,0,1,0,1,0.14285714285714285,1,0.0,0,0,0,0,0,0,0,1,0,0,1,1
4930,182159,ntaJKTMgiTQfD5Tbv9HcsBpNugCaYi0b,fbPkOYLVPtPgIt0MxizjfFJov3JbHyAi,1,0,0,0,0,0,2,0,2,0.2857142857142857,1,0.0,0,0,0,0,0,0,0,2,0,0,2,1
4931,182160,wKSiPD3ccCI47tDYWhx56Wd2BJP8ki2L,fbPkOYLVPtPgIt0MxizjfFJov3JbHyAi,9,7,3,0,3,5,4,1,23,3.2857142857142856,1,0.0,2,3,0,3,5,5,0,4,1,8,15,1
4932,182162,itIzAmwxr6fy2yhmRnAPbRxBE6DJmsTD,fbPkOYLVPtPgIt0MxizjfFJov3JbHyAi,23,27,14,17,15,0,2,0,75,10.714285714285714,1,0.0,12,14,14,15,15,0,3,2,0,55,20,1
4933,182318,dVj05AozpSMnDp2rhv4XKLX2a6Zq0Qtw,SpATywNh6bZuzm8s1ceuBUnMUAeoAHHw,2,0,0,0,0,0,2,0,2,0.2857142857142857,1,0.0,0,0,0,0,0,0,0,2,0,0,2,1
4934,182332,ssNBIPbMZoiJEHlxM1JuEFEFm67Micu2,SpATywNh6bZuzm8s1ceuBUnMUAeoAHHw,6,2,0,0,0,4,14,6,26,3.7142857142857144,1,0.0,0,0,0,0,2,4,0,14,6,0,26,1
4935,182346,yuwVVMBtTYqYgFk8HBT2CeCSsbPznS4I,SpATywNh6bZuzm8s1ceuBUnMUAeoAHHw,6,8,1,0,1,4,6,0,20,2.857142857142857,2,0.0,0,1,0,1,8,4,0,6,0,2,18,1
4936,182375,L7M3Ksh9UBx3xOMl31gqtqz6gfclvqlN,SpATywNh6bZuzm8s1ceuBUnMUAeoAHHw,7,11,4,0,1,1,6,0,23,3.2857142857142856,3,0.0,0,4,0,1,11,1,0,6,0,5,18,1
4937,182376,QlyEMMfomXdFJCE0WvpazQe9ZaXY0FQw,SpATywNh6bZuzm8s1ceuBUnMUAeoAHHw,1,0,0,0,0,0,2,0,2,0.2857142857142857,1,0.0,0,0,0,0,0,0,0,2,0,0,2,1
4938,182379,JdJ1SwT93OWgPbpS5GdJzD3RLASaE4SR,RXDvfPUBYFlVdlueBFbLW0mhhAyGEqpt,22,14,10,44,7,0,1,0,76,10.857142857142858,1,0.0,3,10,40,7,11,0,4,1,0,60,16,1
4939,182384,ORzIK1DF1vIanXrZDWEgyHCiC4GvvfBc,SpATywNh6bZuzm8s1ceuBUnMUAeoAHHw,4,3,1,0,1,0,3,0,8,1.1428571428571428,1,0.0,0,1,0,1,3,0,0,3,0,2,6,1
4940,182391,UoSDdKW8bXtB0Kuj20V0r0Rw6UViB6yh,SpATywNh6bZuzm8s1ceuBUnMUAeoAHHw,5,1,0,0,0,2,7,1,11,1.5714285714285714,1,0.0,0,0,0,0,1,2,0,7,1,0,11,1
4941,182394,0f1EqzZzcXc3MSIWeoaoeCrrqcxrvxwo,bWdj2GDclj5ofokWjzoa5jAwMkxCykd6,2,0,0,0,0,0,2,0,2,0.2857142857142857,1,0.0,0,0,0,0,0,0,0,2,0,0,2,1
4942,182395,pvxjw4szSuluDWQ3DWPes9Mzs1MCvxjI,G8EPVSXsOYB5YQWZGiz1aVq5Pgr2GrQu,6,3,2,0,2,0,1,0,8,1.1428571428571428,1,0.0,0,2,0,2,3,0,0,1,0,4,4,1
4943,182399,vheHPiBs6HjJGbv3Snt0SQIKMYHc5UaU,SpATywNh6bZuzm8s1ceuBUnMUAeoAHHw,3,2,1,0,0,0,1,0,4,0.5714285714285714,1,0.0,0,1,0,0,2,0,0,1,0,1,3,1
4944,182402,UdmIlH1y5ROywT4Ry6jaou64JO5vWiAz,RXDvfPUBYFlVdlueBFbLW0mhhAyGEqpt,1,0,0,0,0,0,1,0,1,0.14285714285714285,1,0.0,0,0,0,0,0,0,0,1,0,0,1,1
4945,182403,ED2sXONkBYI0OZyQYOJ9ygAn9aUKK1Wk,SpATywNh6bZuzm8s1ceuBUnMUAeoAHHw,11,11,6,0,3,4,4,1,29,4.142857142857143,1,0.0,3,6,0,3,8,4,0,4,1,12,17,1
4946,182404,zfXJRVQB9jP4gtyolibVkLvC6I4sMq4Z,SpATywNh6bZuzm8s1ceuBUnMUAeoAHHw,13,9,7,0,3,1,6,1,27,3.857142857142857,1,0.0,0,7,0,3,9,1,0,6,1,10,17,1
4947,182416,Efp2zT9GZ53ahT7m5PosJWOFPjhn8JqA,SpATywNh6bZuzm8s1ceuBUnMUAeoAHHw,1,0,0,0,0,0,1,0,1,0.14285714285714285,1,0.0,0,0,0,0,0,0,0,1,0,0,1,1
4948,182417,4PtDSHhkS4yeMTirE5mvkBBwP3dmM9Qp,SpATywNh6bZuzm8s1ceuBUnMUAeoAHHw,9,8,1,8,0,0,1,0,18,2.5714285714285716,1,0.0,3,1,8,0,5,0,0,1,0,12,6,1
4949,182419,x22fjNSFy0R926MDZKZwS7I3gfP8Gm84,SpATywNh6bZuzm8s1ceuBUnMUAeoAHHw,7,3,2,0,2,0,4,0,11,1.5714285714285714,1,0.0,0,2,0,2,3,0,0,4,0,4,7,1
4950,182420,pYlHnfVkpsPzITBRcvdTXUYMyNXMgg3O,SpATywNh6bZuzm8s1ceuBUnMUAeoAHHw,1,0,0,0,0,0,1,0,1,0.14285714285714285,1,0.0,0,0,0,0,0,0,0,1,0,0,1,1
4951,182427,cZXuWsaeYW0DT1jWDe6bxRqc9qfzrr3C,SpATywNh6bZuzm8s1ceuBUnMUAeoAHHw,5,3,1,0,1,4,3,0,12,1.7142857142857142,1,0.0,0,1,0,1,3,4,0,3,0,2,10,1
4952,182430,3Gc9QM94u4cd0Dw8TEKRCkl8s35hHWXM,SpATywNh6bZuzm8s1ceuBUnMUAeoAHHw,9,4,3,0,3,0,2,0,12,1.7142857142857142,1,0.0,0,3,0,3,4,0,0,2,0,6,6,1
4953,182436,UvIGBO3KU0rWCndAPFCCP6wfS7NUy3B1,SpATywNh6bZuzm8s1ceuBUnMUAeoAHHw,2,0,0,0,0,0,3,0,3,0.42857142857142855,1,0.0,0,0,0,0,0,0,0,3,0,0,3,1
4954,182439,Ilz4MVKb2TGAxWTIiq19EE5elYfPlhdl,SpATywNh6bZuzm8s1ceuBUnMUAeoAHHw,9,6,4,0,3,0,5,0,18,2.5714285714285716,1,0.0,0,4,0,3,6,0,0,5,0,7,11,1
4955,182441,vaWLVKWyrsUzDV0qs20ZUq8M3VNW01Uk,RXDvfPUBYFlVdlueBFbLW0mhhAyGEqpt,1,0,0,0,0,0,1,0,1,0.14285714285714285,1,0.0,0,0,0,0,0,0,0,1,0,0,1,1
4956,182444,SPRinDndbzCEO5Ph1nH3gJGoP1uaeA7R,G8EPVSXsOYB5YQWZGiz1aVq5Pgr2GrQu,1,0,0,0,0,0,1,0,1,0.14285714285714285,1,0.0,0,0,0,0,0,0,0,1,0,0,1,1
4957,182445,Ww3MvCXkT8tDnrpdz1E1wBxJBjpXj1Rq,SpATywNh6bZuzm8s1ceuBUnMUAeoAHHw,5,2,1,0,1,0,2,0,6,0.8571428571428571,1,0.0,0,1,0,1,2,0,0,2,0,2,4,1
4958,182448,hFzrRa1GPtD5a7H30wae91F5SOZlRQO1,SpATywNh6bZuzm8s1ceuBUnMUAeoAHHw,9,8,1,0,0,2,6,1,18,2.5714285714285716,1,0.0,0,1,0,0,8,2,0,6,1,1,17,1
4959,182450,8NJMmSdWvECNT7Pwfk6FLAypMClX0z5v,SpATywNh6bZuzm8s1ceuBUnMUAeoAHHw,4,2,1,0,0,0,2,0,5,0.7142857142857143,1,0.0,0,1,0,0,2,0,0,2,0,1,4,1
4960,182453,8ZePp5sXciCV5oXPjTIQbWFxt1SxfcLl,SpATywNh6bZuzm8s1ceuBUnMUAeoAHHw,10,3,2,0,2,2,5,1,15,2.142857142857143,1,0.0,0,2,0,2,3,2,0,5,1,4,11,1
4961,182466,FYh1ETHUxyunx6o3SR9eAC4QbrxXPzoc,RXDvfPUBYFlVdlueBFbLW0mhhAyGEqpt,8,7,3,0,2,0,3,0,15,2.142857142857143,1,0.0,0,3,0,2,7,0,0,3,0,5,10,1
4962,182470,YITGGXKhxzNHdElox232lzcaZdJ61YFn,bWdj2GDclj5ofokWjzoa5jAwMkxCykd6,5,2,1,0,1,3,3,0,10,1.4285714285714286,1,0.0,0,1,0,1,2,3,0,3,0,2,8,1
4963,182472,BeFe1KokGOrbanlGLijG18LEqInxi9W4,RXDvfPUBYFlVdlueBFbLW0mhhAyGEqpt,1,0,0,0,0,0,1,0,1,0.14285714285714285,1,0.0,0,0,0,0,0,0,0,1,0,0,1,1
4964,182476,ryyeh5DB53zHNKeo2vkO5VPfDAHRLLxK,SpATywNh6bZuzm8s1ceuBUnMUAeoAHHw,5,4,0,0,0,0,2,0,6,0.8571428571428571,1,0.0,0,0,0,0,4,0,0,2,0,0,6,1
4965,182478,ywCBITW2Nk5KrEWUjIfEEyRW364OA7v3,SpATywNh6bZuzm8s1ceuBUnMUAeoAHHw,7,4,2,0,0,0,4,0,10,1.4285714285714286,1,0.0,0,2,0,0,4,0,0,4,0,2,8,1
4966,182483,Wm4boeiuAufaIeI7PkgbnseZNqzvwXoA,RXDvfPUBYFlVdlueBFbLW0mhhAyGEqpt,1,0,0,0,0,0,1,0,1,0.14285714285714285,1,0.0,0,0,0,0,0,0,0,1,0,0,1,1
4967,182484,nJFL4ZgVlk8vsvSCMEvmMvfyFCPNkQbb,bWdj2GDclj5ofokWjzoa5jAwMkxCykd6,2,0,0,0,0,0,2,0,2,0.2857142857142857,1,0.0,0,0,0,0,0,0,0,2,0,0,2,1
4968,182490,5kux74rVeqoEvbABYMpdIOO6ta3zLim7,bWdj2GDclj5ofokWjzoa5jAwMkxCykd6,3,2,1,0,0,0,1,0,4,0.5714285714285714,1,0.0,0,1,0,0,2,0,0,1,0,1,3,1
4969,182491,HxeyM7hnjqqrHkT4PVJnwDZtWwoxUMiy,RXDvfPUBYFlVdlueBFbLW0mhhAyGEqpt,1,0,0,0,0,0,1,0,1,0.14285714285714285,1,0.0,0,0,0,0,0,0,0,1,0,0,1,1
4970,182496,FWAi9SzUY3hC5pRVyJkleZ3oNtaFNi6V,SpATywNh6bZuzm8s1ceuBUnMUAeoAHHw,2,0,0,0,0,0,2,0,2,0.2857142857142857,1,0.0,0,0,0,0,0,0,0,2,0,0,2,1
4971,182497,zsHSwvXoubMUxhT2AYVzfcvRGMppEBUX,G8EPVSXsOYB5YQWZGiz1aVq5Pgr2GrQu,1,0,0,0,0,0,1,0,1,0.14285714285714285,1,0.0,0,0,0,0,0,0,0,1,0,0,1,1
4972,182499,9bY2ODFG0JcDRpzNxe1p1poGx2Xx1OUa,SpATywNh6bZuzm8s1ceuBUnMUAeoAHHw,6,6,0,0,0,0,4,0,10,1.4285714285714286,1,0.0,0,0,0,0,6,0,0,4,0,0,10,1
4973,182508,e3jS2U1BhNpArENK983B1rVL1JoqwREV,SpATywNh6bZuzm8s1ceuBUnMUAeoAHHw,8,6,3,0,3,0,1,0,13,1.8571428571428572,1,0.0,0,3,0,3,6,0,0,1,0,6,7,1
4974,182515,oElQ0NJpFnzZRtGV3YErd6rr4i8DxzbB,SpATywNh6bZuzm8s1ceuBUnMUAeoAHHw,6,4,2,0,1,0,2,0,9,1.2857142857142858,1,0.0,0,2,0,1,4,0,0,2,0,3,6,1
4975,182524,IKXwL3bDtlAxjRP4WWhZczJlcbIhG3ib,G8EPVSXsOYB5YQWZGiz1aVq5Pgr2GrQu,9,7,5,0,4,1,6,1,24,3.4285714285714284,1,0.0,0,5,0,4,7,1,0,6,1,9,15,1
4976,182527,QoLZveDbZCrcOypIzCYKhgphRVMR37f0,SpATywNh6bZuzm8s1ceuBUnMUAeoAHHw,7,11,5,0,3,0,5,0,24,3.4285714285714284,1,0.0,2,5,0,3,9,0,0,5,0,10,14,1
4977,182540,68zow3PIETzGkbgKSgGqp4cft1zzT0Wg,SpATywNh6bZuzm8s1ceuBUnMUAeoAHHw,15,29,13,18,5,23,11,0,99,14.142857142857142,2,0.0,6,13,15,5,23,23,3,11,0,39,60,1
4978,182548,1wTTPpSWNZRGQY72YsG9M4kDyp3wXVIX,SpATywNh6bZuzm8s1ceuBUnMUAeoAHHw,9,4,0,3,0,0,5,2,14,2.0,1,0.0,1,0,3,0,3,0,0,5,2,4,10,1
4979,182552,ykEW9evpDPHZbB36kn5ppyB9XHnMY2SE,bWdj2GDclj5ofokWjzoa5jAwMkxCykd6,4,2,1,0,0,0,2,0,5,0.7142857142857143,1,0.0,0,1,0,0,2,0,0,2,0,1,4,1
4980,182556,0dYUj8IzWWp9WKVei3srYo9Z7019GkyS,SpATywNh6bZuzm8s1ceuBUnMUAeoAHHw,6,2,1,0,1,0,3,0,7,1.0,1,0.0,0,1,0,1,2,0,0,3,0,2,5,1
4981,182565,BtOoPJiqJpi7FXEZFIq8NLvECwNXeaZ8,SpATywNh6bZuzm8s1ceuBUnMUAeoAHHw,6,1,1,0,1,0,3,0,6,0.8571428571428571,1,0.0,0,1,0,1,1,0,0,3,0,2,4,1
4982,182572,L3vH8w9MBmyNbE6zYIQcQAgtUd2AVGJ2,bWdj2GDclj5ofokWjzoa5jAwMkxCykd6,2,0,0,0,0,0,2,0,2,0.2857142857142857,1,0.0,0,0,0,0,0,0,0,2,0,0,2,1
4983,182574,9HtqmGFwW9nlaXQoPiq8Q0exBzv6okJA,SpATywNh6bZuzm8s1ceuBUnMUAeoAHHw,6,2,1,0,1,0,10,0,14,2.0,1,0.0,0,1,0,1,2,0,0,10,0,2,12,1
4984,182583,67xpG0g0SaNRrqSFMK3Slz5FQV4uaOHQ,SpATywNh6bZuzm8s1ceuBUnMUAeoAHHw,7,2,1,0,1,0,4,2,10,1.4285714285714286,1,0.0,0,1,0,1,2,0,0,4,2,2,8,1
4985,182590,AgVRfkL9ddoBcgWiMEqgB28oDseRQMfR,G8EPVSXsOYB5YQWZGiz1aVq5Pgr2GrQu,7,10,0,0,0,0,2,0,12,1.7142857142857142,1,0.0,1,0,0,0,9,0,0,2,0,1,11,1
4986,182592,o8FE9F7Hj949CAE87fPDQyCYZ9zgH4qv,SpATywNh6bZuzm8s1ceuBUnMUAeoAHHw,1,0,0,0,0,0,1,0,1,0.14285714285714285,1,0.0,0,0,0,0,0,0,0,1,0,0,1,1
4987,182593,MV8XdB3h6ePuBNN3BGaZCvIfimFFX0Mk,SpATywNh6bZuzm8s1ceuBUnMUAeoAHHw,1,0,0,0,0,0,1,0,1,0.14285714285714285,1,0.0,0,0,0,0,0,0,0,1,0,0,1,1
4988,182595,iQCW6W4nBE7M3nPE1JFW3uJTussgN79A,SpATywNh6bZuzm8s1ceuBUnMUAeoAHHw,7,2,1,0,1,0,5,1,10,1.4285714285714286,1,0.0,0,1,0,1,2,0,0,5,1,2,8,1
4989,182596,i1weaEaafaiWi31Ms4bwoF6JM4IRf714,G8EPVSXsOYB5YQWZGiz1aVq5Pgr2GrQu,14,27,11,20,7,0,2,0,67,9.571428571428571,1,0.0,14,11,11,7,13,0,9,2,0,43,24,1
4990,182599,C82stxYBdobab5s8FnzuMHxgMBwKu2tD,SpATywNh6bZuzm8s1ceuBUnMUAeoAHHw,3,2,0,0,0,0,2,0,4,0.5714285714285714,1,0.0,0,0,0,0,2,0,0,2,0,0,4,1
4991,182602,pC6FwYDHxh9swUa6nvJYcLLtE0AYC1Cg,bWdj2GDclj5ofokWjzoa5jAwMkxCykd6,1,0,0,0,0,0,1,0,1,0.14285714285714285,1,0.0,0,0,0,0,0,0,0,1,0,0,1,1
4992,182604,YYm9SLmjJQnTtFQLnNCxEK5OKVRWWeS9,SpATywNh6bZuzm8s1ceuBUnMUAeoAHHw,7,7,3,0,3,1,2,0,16,2.2857142857142856,1,0.0,0,3,0,3,7,1,0,2,0,6,10,1
4993,182610,VR4kpCHjSnr2YglEgcuTrivL0Gg47pGL,SpATywNh6bZuzm8s1ceuBUnMUAeoAHHw,13,15,7,18,5,0,2,0,47,6.714285714285714,1,0.0,6,7,15,5,9,0,3,2,0,33,14,1
4994,182611,WtbenHJvVPK6SiW3psJUnjqNlshJ00ku,SpATywNh6bZuzm8s1ceuBUnMUAeoAHHw,9,5,0,0,0,1,5,1,12,1.7142857142857142,1,0.0,0,0,0,0,5,1,0,5,1,0,12,1
4995,182614,UuSIoFbtQOfzMmWUxokidkbXgJFaHXwx,bWdj2GDclj5ofokWjzoa5jAwMkxCykd6,1,0,0,0,0,0,1,0,1,0.14285714285714285,1,0.0,0,0,0,0,0,0,0,1,0,0,1,1
4996,182623,Vqh7IxciNu3w4ryq9DwYRMQWb1h8f16V,G8EPVSXsOYB5YQWZGiz1aVq5Pgr2GrQu,11,13,7,0,4,19,5,0,48,6.857142857142857,1,0.0,0,7,0,4,13,19,0,5,0,11,37,1
4997,182626,1P2LChndrUiRCjj6mVB5w5hmLH8bp8jB,SpATywNh6bZuzm8s1ceuBUnMUAeoAHHw,7,6,1,0,1,0,3,0,11,1.5714285714285714,1,0.0,0,1,0,1,6,0,0,3,0,2,9,1
4998,182629,x5W7px1blVgXPSeduQeF8luvK0oCFfzJ,RXDvfPUBYFlVdlueBFbLW0mhhAyGEqpt,1,0,0,0,0,0,1,0,1,0.14285714285714285,1,0.0,0,0,0,0,0,0,0,1,0,0,1,1
4999,182633,XO0d4deCWOy3mmgL5fsAr1MAAwghPAkB,RXDvfPUBYFlVdlueBFbLW0mhhAyGEqpt,38,50,3,86,5,1,11,0,156,22.285714285714285,1,0.0,16,3,80,5,34,1,6,11,0,104,52,1
5000,182639,COhPD73W4lvIiazL2vbp3j5FVs5HQ601,SpATywNh6bZuzm8s1ceuBUnMUAeoAHHw,5,2,1,0,1,0,2,0,6,0.8571428571428571,1,0.0,0,1,0,1,2,0,0,2,0,2,4,1
5001,182640,2Wz9ixAR47Et860ivxArFAVvspY1IqDz,bWdj2GDclj5ofokWjzoa5jAwMkxCykd6,6,3,0,24,0,1,2,0,30,4.285714285714286,1,0.0,1,0,23,0,2,1,1,2,0,24,6,1
5002,182643,1IgVs7QdLHhnPG0jFRERCqu2Y9FlWiVF,G8EPVSXsOYB5YQWZGiz1aVq5Pgr2GrQu,3,0,0,0,0,3,2,0,5,0.7142857142857143,1,0.0,0,0,0,0,0,3,0,2,0,0,5,1
5003,182647,8P2IV2kWoU5ZCAhZNesFZXBCmVIcwHGV,SpATywNh6bZuzm8s1ceuBUnMUAeoAHHw,15,33,2,18,0,5,15,2,75,10.714285714285714,2,0.0,7,2,15,0,26,5,3,15,2,24,51,1
5004,182664,VHKy90msZ6s6PWErEswELl083Xh3kNC6,SpATywNh6bZuzm8s1ceuBUnMUAeoAHHw,10,7,1,14,1,9,5,0,37,5.285714285714286,2,0.0,2,1,13,1,5,9,1,5,0,17,20,1
5005,182669,PhL2ZyLw1V28vd4DfOVSi8FZIcPFQkVx,bWdj2GDclj5ofokWjzoa5jAwMkxCykd6,4,2,1,0,1,1,1,0,6,0.8571428571428571,1,0.0,0,1,0,1,2,1,0,1,0,2,4,1
5006,182671,GANbW2mfChK4bd2m73sodc3ItJtDn1ba,SpATywNh6bZuzm8s1ceuBUnMUAeoAHHw,4,0,0,0,0,0,3,1,4,0.5714285714285714,1,0.0,0,0,0,0,0,0,0,3,1,0,4,1
5007,182672,L8GepxGnZH9aQkkBlOp07iXjAUHLfNwr,SpATywNh6bZuzm8s1ceuBUnMUAeoAHHw,3,5,0,0,0,0,1,0,6,0.8571428571428571,1,0.0,2,0,0,0,3,0,0,1,0,2,4,1
5008,182675,XYKEbaRABcMuBHmMB2I3YkBepzCp0swB,bWdj2GDclj5ofokWjzoa5jAwMkxCykd6,5,14,2,0,1,0,4,0,21,3.0,2,0.0,2,2,0,1,12,0,0,4,0,5,16,1
5009,182696,GcJFzpyOdnnoWwg3V1INu4JCOvQXcJgJ,SpATywNh6bZuzm8s1ceuBUnMUAeoAHHw,1,0,0,0,0,0,1,0,1,0.14285714285714285,1,0.0,0,0,0,0,0,0,0,1,0,0,1,1
5010,182699,RAGQmaCMG2kfcGeGG7CgUDmUq1d4kIyn,G8EPVSXsOYB5YQWZGiz1aVq5Pgr2GrQu,2,0,0,0,0,0,4,0,4,0.5714285714285714,1,0.0,0,0,0,0,0,0,0,4,0,0,4,1
5011,182702,3QS27JowcKsai44171i1lf7TLJ6jrzZW,SpATywNh6bZuzm8s1ceuBUnMUAeoAHHw,6,5,2,0,1,0,2,0,10,1.4285714285714286,1,0.0,2,2,0,1,3,0,0,2,0,5,5,1
5012,182705,vgiQpvSAFn3WqqXXyEm42CrUfpctzUEX,SpATywNh6bZuzm8s1ceuBUnMUAeoAHHw,5,2,1,0,1,0,2,0,6,0.8571428571428571,1,0.0,0,1,0,1,2,0,0,2,0,2,4,1
5013,182714,SDvatKCgfdtv12UzJLxR0GYxgD4pUkgT,bWdj2GDclj5ofokWjzoa5jAwMkxCykd6,3,3,1,0,0,0,2,0,6,0.8571428571428571,1,0.0,0,1,0,0,3,0,0,2,0,1,5,1
5014,182718,e9IMJZnDOQwZUgVPoYAYW4meXQnaglvw,SpATywNh6bZuzm8s1ceuBUnMUAeoAHHw,10,2,2,0,2,0,8,3,17,2.4285714285714284,1,0.0,0,2,0,2,2,0,0,8,3,4,13,1
5015,182724,TV8zrBdNM1adKaAPI8D2c3PyvuLKkNEi,SpATywNh6bZuzm8s1ceuBUnMUAeoAHHw,8,2,1,0,1,3,7,1,15,2.142857142857143,1,0.0,0,1,0,1,2,3,0,7,1,2,13,1
5016,182742,YMU8P29wy18QfGxug1svcdE5aeLt8eef,SpATywNh6bZuzm8s1ceuBUnMUAeoAHHw,13,14,5,0,2,5,10,1,37,5.285714285714286,1,0.0,2,5,0,2,12,5,0,10,1,9,28,1
5017,182744,AXhSW785x6j50916e34SRK9faB9FqLBm,SpATywNh6bZuzm8s1ceuBUnMUAeoAHHw,2,0,0,0,0,0,2,0,2,0.2857142857142857,1,0.0,0,0,0,0,0,0,0,2,0,0,2,1
5018,182746,ADL0cXowUMs4wyiAOHKMOrtTHu5tmUqi,SpATywNh6bZuzm8s1ceuBUnMUAeoAHHw,5,5,3,0,2,0,2,0,12,1.7142857142857142,1,0.0,0,3,0,2,5,0,0,2,0,5,7,1
5019,182751,s4TEJX3ZSvr4kBLGdjg6CpTOCIceK5wi,SpATywNh6bZuzm8s1ceuBUnMUAeoAHHw,1,0,0,0,0,0,1,0,1,0.14285714285714285,1,0.0,0,0,0,0,0,0,0,1,0,0,1,1
5020,182755,CwJSAfmXBIxjg0tYJaLcAWBrHja9U2kJ,SpATywNh6bZuzm8s1ceuBUnMUAeoAHHw,5,3,0,0,0,0,5,0,8,1.1428571428571428,1,0.0,0,0,0,0,3,0,0,5,0,0,8,1
5021,182766,ywNFtohqWrdbrhEW62rPnGjVYfzTZ181,SpATywNh6bZuzm8s1ceuBUnMUAeoAHHw,1,0,0,0,0,0,1,0,1,0.14285714285714285,1,0.0,0,0,0,0,0,0,0,1,0,0,1,1
5022,182768,wVdlJl1TkeMQ7fPs3s7SDiFZ9EQoXXFL,RXDvfPUBYFlVdlueBFbLW0mhhAyGEqpt,1,0,0,0,0,0,1,0,1,0.14285714285714285,1,0.0,0,0,0,0,0,0,0,1,0,0,1,1
5023,182781,myIIBocNFelldmuN47bMrRiORGKDSj7S,RXDvfPUBYFlVdlueBFbLW0mhhAyGEqpt,1,0,0,0,0,0,1,0,1,0.14285714285714285,1,0.0,0,0,0,0,0,0,0,1,0,0,1,1
5024,182783,H5XDLEjPVO5GyYRwYkINM9ORsYQG2YvW,SpATywNh6bZuzm8s1ceuBUnMUAeoAHHw,13,12,4,14,3,0,1,0,34,4.857142857142857,1,0.0,5,4,13,3,7,0,1,1,0,25,9,1
5025,182796,G1LkA451FC6E6IOfdWKqpy8y2lc8YSzz,SpATywNh6bZuzm8s1ceuBUnMUAeoAHHw,6,5,2,0,0,0,4,0,11,1.5714285714285714,1,0.0,0,2,0,0,5,0,0,4,0,2,9,1
5026,182815,JfAsemHlarA2F9Qw0stOCWfmH1qVmt8W,SpATywNh6bZuzm8s1ceuBUnMUAeoAHHw,1,0,0,0,0,0,1,0,1,0.14285714285714285,1,0.0,0,0,0,0,0,0,0,1,0,0,1,1
5027,182831,ZNcLOAJ2r3H5DqhbGk1CiPtwI7ixaCeK,RXDvfPUBYFlVdlueBFbLW0mhhAyGEqpt,5,5,3,0,1,0,2,0,11,1.5714285714285714,1,0.0,0,3,0,1,5,0,0,2,0,4,7,1
5028,182833,7cuOR7XN3OKWyCY4rmOlBcFyB6vgzoQs,bWdj2GDclj5ofokWjzoa5jAwMkxCykd6,9,13,3,34,3,0,4,0,57,8.142857142857142,1,0.0,5,3,33,3,8,0,1,4,0,44,13,1
5029,182849,2CWwtE86TUtrUhYms4GqpHHdjjzejIiw,RXDvfPUBYFlVdlueBFbLW0mhhAyGEqpt,10,9,0,0,0,0,1,0,10,1.4285714285714286,1,0.0,0,0,0,0,9,0,0,1,0,0,10,1
5030,182851,dJrIkntdHmFqt2nNdHl0WRj6RFfeHhWR,G8EPVSXsOYB5YQWZGiz1aVq5Pgr2GrQu,3,0,0,0,0,1,2,0,3,0.42857142857142855,1,0.0,0,0,0,0,0,1,0,2,0,0,3,1
5031,182860,foTg5qEPNfrsoDSNAhj65g7lMuh2VdSR,SpATywNh6bZuzm8s1ceuBUnMUAeoAHHw,1,0,0,0,0,0,1,0,1,0.14285714285714285,1,0.0,0,0,0,0,0,0,0,1,0,0,1,1
5032,182872,Klt9qoufCaIWdba44x7MkMWwmjaj9rrO,G8EPVSXsOYB5YQWZGiz1aVq5Pgr2GrQu,8,5,3,0,2,0,4,0,14,2.0,1,0.0,0,3,0,2,5,0,0,4,0,5,9,1
5033,182876,73K789g4e0jr9RbqLOh1RUOvDP0ZYtaO,SpATywNh6bZuzm8s1ceuBUnMUAeoAHHw,1,0,0,0,0,0,1,0,1,0.14285714285714285,1,0.0,0,0,0,0,0,0,0,1,0,0,1,1
5034,182884,q1zfV7JQnPHYBA4GkSf8RBmBmzIBSPXp,SpATywNh6bZuzm8s1ceuBUnMUAeoAHHw,1,0,0,0,0,0,2,0,2,0.2857142857142857,1,0.0,0,0,0,0,0,0,0,2,0,0,2,1
5035,182901,ROcCBAUDWCCmSmJWa8UkAc38NUTaJmvd,SpATywNh6bZuzm8s1ceuBUnMUAeoAHHw,7,7,6,0,4,0,1,0,18,2.5714285714285716,1,0.0,0,6,0,4,7,0,0,1,0,10,8,1
5036,182902,Gj3pHpaNgZrapEPZYhvbfuaS2aMS6tgO,SpATywNh6bZuzm8s1ceuBUnMUAeoAHHw,1,0,0,0,0,0,1,0,1,0.14285714285714285,1,0.0,0,0,0,0,0,0,0,1,0,0,1,1
5037,182909,kZLA3umCB77AeK17F9sH7z1Ojbpf7TLv,RXDvfPUBYFlVdlueBFbLW0mhhAyGEqpt,11,9,6,0,3,0,2,0,20,2.857142857142857,1,0.0,3,6,0,3,6,0,0,2,0,12,8,1
5038,182910,woTsCvW1lUQJlNZPTxvW6TWDeSBjlE3x,SpATywNh6bZuzm8s1ceuBUnMUAeoAHHw,15,45,2,21,2,4,7,1,82,11.714285714285714,1,0.0,32,2,16,2,13,4,5,7,1,52,30,1
5039,182923,7kYJ9SFEtYe6Heh67x8Vp6BF2X3NW60w,SpATywNh6bZuzm8s1ceuBUnMUAeoAHHw,5,2,1,0,0,0,5,0,8,1.1428571428571428,1,0.0,0,1,0,0,2,0,0,5,0,1,7,1
5040,182928,hOv5RKQK1RGRxpJJGcW0k2cA3RwQ8Rk5,SpATywNh6bZuzm8s1ceuBUnMUAeoAHHw,8,9,5,0,3,0,3,0,20,2.857142857142857,2,0.0,2,5,0,3,7,0,0,3,0,10,10,1
5041,182929,czJlHgmBYIN2fkWm8DMCxTMvIB7CPSjD,SpATywNh6bZuzm8s1ceuBUnMUAeoAHHw,1,0,0,0,0,0,1,0,1,0.14285714285714285,1,0.0,0,0,0,0,0,0,0,1,0,0,1,1
5042,182953,tmP3hiAxOmIcth7vkvpHKk2OIqOO5u37,bWdj2GDclj5ofokWjzoa5jAwMkxCykd6,4,5,1,0,0,0,1,0,7,1.0,1,0.0,0,1,0,0,5,0,0,1,0,1,6,1
5043,182959,4uRRd3ZIFdyKPTDLtcF8p2hJfez66l8b,bWdj2GDclj5ofokWjzoa5jAwMkxCykd6,4,2,1,0,1,0,1,0,5,0.7142857142857143,1,0.0,0,1,0,1,2,0,0,1,0,2,3,1
5044,182961,XNpvXjwLvaeOlYFUhwJmIuJfOHxWLTUx,SpATywNh6bZuzm8s1ceuBUnMUAeoAHHw,8,11,5,3,0,0,2,0,21,3.0,1,0.0,5,5,3,0,6,0,0,2,0,13,8,1
5045,182971,LslskpvRu2kdJKdLBrkhLUwON3Gy18Vo,bWdj2GDclj5ofokWjzoa5jAwMkxCykd6,10,3,2,12,2,0,3,0,22,3.142857142857143,1,0.0,1,2,12,2,2,0,0,3,0,17,5,0
5046,182975,TVBdP57RgHmXdzDOQxhhxrruZniECnNa,SpATywNh6bZuzm8s1ceuBUnMUAeoAHHw,10,11,7,0,3,10,10,2,43,6.142857142857143,2,0.0,0,7,0,3,11,10,0,10,2,10,33,1
5047,182978,WRGP3RiE3PgQD7N1Gw3XyQmMvgPUNX5x,SpATywNh6bZuzm8s1ceuBUnMUAeoAHHw,10,15,9,0,5,1,13,2,45,6.428571428571429,1,0.0,0,9,0,5,15,1,0,13,2,14,31,1
5048,182990,LHjZbHCdMckrMwOq7c5kO6EdbIUV0ZXr,SpATywNh6bZuzm8s1ceuBUnMUAeoAHHw,1,0,0,0,0,0,1,0,1,0.14285714285714285,1,0.0,0,0,0,0,0,0,0,1,0,0,1,1
5049,182992,p0pdpDYYJlDvrp00zDzLRGjYUqDxuGfa,SpATywNh6bZuzm8s1ceuBUnMUAeoAHHw,8,3,1,0,1,1,5,1,12,1.7142857142857142,1,0.0,0,1,0,1,3,1,0,5,1,2,10,1
5050,182994,64m0Q8jwm0bupg7LuUgGhNi3maBhbH3Y,SpATywNh6bZuzm8s1ceuBUnMUAeoAHHw,5,1,1,0,1,0,2,0,5,0.7142857142857143,1,0.0,0,1,0,1,1,0,0,2,0,2,3,1
5051,182998,aliLWjsmDZq4LP4uTi2kUntAc8WQqjiN,SpATywNh6bZuzm8s1ceuBUnMUAeoAHHw,6,3,2,0,2,0,1,0,8,1.1428571428571428,1,0.0,0,2,0,2,3,0,0,1,0,4,4,1
5052,183000,mjiGg0j06CInyeszEq1InPQHaMEdBBQC,SpATywNh6bZuzm8s1ceuBUnMUAeoAHHw,1,0,0,0,0,0,1,0,1,0.14285714285714285,1,0.0,0,0,0,0,0,0,0,1,0,0,1,1
5053,183015,Klt9qoufCaIWdba44x7MkMWwmjaj9rrO,RXDvfPUBYFlVdlueBFbLW0mhhAyGEqpt,5,2,1,0,1,0,2,0,6,0.8571428571428571,1,0.0,0,1,0,1,2,0,0,2,0,2,4,1
5054,183020,ktn21iQNCuR3oHHXVI0NrarzymknVPKy,bWdj2GDclj5ofokWjzoa5jAwMkxCykd6,14,17,6,60,3,0,4,0,90,12.857142857142858,1,0.0,4,6,59,3,13,0,1,4,0,72,18,1
5055,183023,iVDV62MoJzFeSGfSaOdA9lfvHL2Xprv8,bWdj2GDclj5ofokWjzoa5jAwMkxCykd6,1,0,0,0,0,0,1,0,1,0.14285714285714285,1,0.0,0,0,0,0,0,0,0,1,0,0,1,1
5056,183035,A23dnlnLlkfS4Hk14geJvIKVXuW282iT,SpATywNh6bZuzm8s1ceuBUnMUAeoAHHw,7,2,1,0,1,0,4,0,8,1.1428571428571428,1,0.0,0,1,0,1,2,0,0,4,0,2,6,1
5057,183046,wgSBRoX5zgs9VU58GuULiQecnpPq9Lqh,RXDvfPUBYFlVdlueBFbLW0mhhAyGEqpt,6,3,2,0,2,0,1,0,8,1.1428571428571428,1,0.0,0,2,0,2,3,0,0,1,0,4,4,1
5058,183051,rlQIqtgsDfEVihltHvVH3EnaOkFIJWY2,bWdj2GDclj5ofokWjzoa5jAwMkxCykd6,2,0,0,0,0,0,2,0,2,0.2857142857142857,1,0.0,0,0,0,0,0,0,0,2,0,0,2,1
5059,183053,lmeMhWa8hXVoeC6vmJbPTxkNCUltvvzl,bWdj2GDclj5ofokWjzoa5jAwMkxCykd6,1,0,0,0,0,0,1,0,1,0.14285714285714285,1,0.0,0,0,0,0,0,0,0,1,0,0,1,0
5060,183074,hDvxnDgro87cypkqHin6LwVYFrNPTTLE,RXDvfPUBYFlVdlueBFbLW0mhhAyGEqpt,11,5,3,0,2,0,8,1,19,2.7142857142857144,1,0.0,0,3,0,2,5,0,0,8,1,5,14,0
5061,183099,VerLbwiPxmF2ThOpDXTyChlnDHBPqkR9,SpATywNh6bZuzm8s1ceuBUnMUAeoAHHw,1,0,0,0,0,0,1,0,1,0.14285714285714285,1,0.0,0,0,0,0,0,0,0,1,0,0,1,1
5062,183102,Kl5tK7ooc00n8wf3ct9g9Ke76aOxJvfm,RXDvfPUBYFlVdlueBFbLW0mhhAyGEqpt,2,0,0,0,0,0,3,0,3,0.42857142857142855,1,0.0,0,0,0,0,0,0,0,3,0,0,3,1
5063,183108,jVeR6Ygg8woHLAlxijrDAiyFqfotJXuz,SpATywNh6bZuzm8s1ceuBUnMUAeoAHHw,1,0,0,0,0,0,1,0,1,0.14285714285714285,1,0.0,0,0,0,0,0,0,0,1,0,0,1,1
5064,183109,AildxiB1DfzGkzpFkUFcF6xLBoz939kN,SpATywNh6bZuzm8s1ceuBUnMUAeoAHHw,4,2,1,0,1,0,1,0,5,0.7142857142857143,1,0.0,0,1,0,1,2,0,0,1,0,2,3,1
5065,183115,lKZ6PIEzVkW9yjCyAe8hsmBYDIXs5abt,RXDvfPUBYFlVdlueBFbLW0mhhAyGEqpt,4,3,0,0,0,0,4,0,7,1.0,1,0.0,0,0,0,0,3,0,0,4,0,0,7,1
5066,183119,BoPqpHAIR2FQ1yjN5I6jPiYn67RLyUD3,bWdj2GDclj5ofokWjzoa5jAwMkxCykd6,1,0,0,0,0,0,2,0,2,0.2857142857142857,1,0.0,0,0,0,0,0,0,0,2,0,0,2,1
5067,183123,CkLUnVGhbMVv40VnwKxHWwmtgjnmo4A6,G8EPVSXsOYB5YQWZGiz1aVq5Pgr2GrQu,77,101,41,204,25,34,16,5,426,60.857142857142854,2,0.0,55,41,158,25,46,34,46,16,5,279,147,0
5068,183129,eOxm8XEI11Xs6eiBi1Nu5QzIagZXwEm9,RXDvfPUBYFlVdlueBFbLW0mhhAyGEqpt,12,13,8,0,1,8,2,0,32,4.571428571428571,1,0.0,4,8,0,1,9,8,0,2,0,13,19,0
5069,183130,w2Erm8d51TR8x1zaznDbwXn8kjSZE4Bu,G8EPVSXsOYB5YQWZGiz1aVq5Pgr2GrQu,8,8,5,0,3,0,8,0,24,3.4285714285714284,1,0.0,0,5,0,3,8,0,0,8,0,8,16,1
5070,183131,xWIW5AMIa14HXXQklcDbkiec2fixez0X,SpATywNh6bZuzm8s1ceuBUnMUAeoAHHw,2,0,0,0,0,0,2,0,2,0.2857142857142857,1,0.0,0,0,0,0,0,0,0,2,0,0,2,1
5071,183144,NFQYK3FjmQHQ82RJihsHHyxDsiLlEhiy,G8EPVSXsOYB5YQWZGiz1aVq5Pgr2GrQu,6,3,2,0,2,0,1,0,8,1.1428571428571428,1,0.0,0,2,0,2,3,0,0,1,0,4,4,1
5072,183150,RDDLwVBt5GubTYBjjqKExEAvJzlxgV07,G8EPVSXsOYB5YQWZGiz1aVq5Pgr2GrQu,4,2,1,0,1,0,1,0,5,0.7142857142857143,1,0.0,0,1,0,1,2,0,0,1,0,2,3,1
5073,183151,mXfwwTIVjHMqoVKAh2iEQbinKUCJHwTp,RXDvfPUBYFlVdlueBFbLW0mhhAyGEqpt,1,0,0,0,0,0,1,0,1,0.14285714285714285,1,0.0,0,0,0,0,0,0,0,1,0,0,1,1
5074,183153,meaga1KCWxPmzsqVBplIkGxQedzxaUD2,bWdj2GDclj5ofokWjzoa5jAwMkxCykd6,7,3,2,0,2,0,2,0,9,1.2857142857142858,1,0.0,0,2,0,2,3,0,0,2,0,4,5,1
5075,183156,BWYYcHsqCzhUpDFvLBDv5oyoAjPbY2ao,G8EPVSXsOYB5YQWZGiz1aVq5Pgr2GrQu,6,1,1,0,1,0,3,0,6,0.8571428571428571,1,0.0,0,1,0,1,1,0,0,3,0,2,4,1
5076,183166,1vUHALYrvSKjWqmr07cdKDwJ3ETsWONf,G8EPVSXsOYB5YQWZGiz1aVq5Pgr2GrQu,8,12,6,0,0,0,4,0,22,3.142857142857143,1,0.0,0,6,0,0,12,0,0,4,0,6,16,1
5077,183167,98I0uRRrxrvjOLcZ6vxnPf4VwE1fUSbw,SpATywNh6bZuzm8s1ceuBUnMUAeoAHHw,10,7,5,0,3,1,4,0,20,2.857142857142857,1,0.0,0,5,0,3,7,1,0,4,0,8,12,1
5078,183169,Ha83qom95SRdPZQ3GDUlHj6Txt7HaICx,RXDvfPUBYFlVdlueBFbLW0mhhAyGEqpt,5,1,0,0,0,0,3,1,5,0.7142857142857143,1,0.0,0,0,0,0,1,0,0,3,1,0,5,1
5079,183171,uWoWmi6BUckUwLrnQ5aAr8mNZ3FhCJCq,bWdj2GDclj5ofokWjzoa5jAwMkxCykd6,6,6,1,6,2,0,3,0,18,2.5714285714285716,1,0.0,4,1,6,2,2,0,0,3,0,13,5,1
5080,183175,uWoWmi6BUckUwLrnQ5aAr8mNZ3FhCJCq,SpATywNh6bZuzm8s1ceuBUnMUAeoAHHw,13,19,6,17,3,0,1,0,46,6.571428571428571,1,0.0,11,6,15,3,8,0,2,1,0,35,11,1
5081,183176,vmxFgUyErGGqygNyLIYogRrMCWwWAOsK,SpATywNh6bZuzm8s1ceuBUnMUAeoAHHw,3,0,0,0,0,0,2,1,3,0.42857142857142855,1,0.0,0,0,0,0,0,0,0,2,1,0,3,1
5082,183179,cBEtpnUSjx0dg8glJzii42d18FEs4ecN,bWdj2GDclj5ofokWjzoa5jAwMkxCykd6,4,2,1,0,1,0,1,0,5,0.7142857142857143,1,0.0,0,1,0,1,2,0,0,1,0,2,3,1
5083,183185,6UfIu5SKHPYfwZxBxJpGSqhLHKhbdsl0,RXDvfPUBYFlVdlueBFbLW0mhhAyGEqpt,6,4,3,0,0,0,3,0,10,1.4285714285714286,1,0.0,0,3,0,0,4,0,0,3,0,3,7,1
5084,183195,ZUG5m2QmH8RqkCO5a89mIgt4zubZUyS0,SpATywNh6bZuzm8s1ceuBUnMUAeoAHHw,6,0,0,0,0,6,6,1,13,1.8571428571428572,1,0.0,0,0,0,0,0,6,0,6,1,0,13,1
5085,183205,rtxwCWIEQDwTZ37mLeJaxSUkUCTNLEOP,SpATywNh6bZuzm8s1ceuBUnMUAeoAHHw,9,6,3,0,1,0,5,2,17,2.4285714285714284,1,0.0,0,3,0,1,6,0,0,5,2,4,13,1
5086,183228,EnOE2zcU3adIQka8zXE5uaDcwrIceQaF,SpATywNh6bZuzm8s1ceuBUnMUAeoAHHw,15,8,5,16,4,11,5,1,50,7.142857142857143,1,0.0,2,5,14,4,6,11,2,5,1,25,25,1
5087,183230,RYd1k9DojojPZwrkV3NjsTI5OdZnPV9W,bWdj2GDclj5ofokWjzoa5jAwMkxCykd6,6,12,0,0,1,0,4,0,17,2.4285714285714284,1,0.0,0,0,0,1,12,0,0,4,0,1,16,1
5088,183232,7RSTSE7CX0EZRW2RDRnKS7CJkHtK7gJx,SpATywNh6bZuzm8s1ceuBUnMUAeoAHHw,5,3,2,0,1,0,2,0,8,1.1428571428571428,1,0.0,0,2,0,1,3,0,0,2,0,3,5,1
5089,183236,DIfj5Ba2axfDE4LFDWqKjVBCgesW8XXW,bWdj2GDclj5ofokWjzoa5jAwMkxCykd6,1,0,0,0,0,0,2,0,2,0.2857142857142857,1,0.0,0,0,0,0,0,0,0,2,0,0,2,1
5090,183238,L44FpqBwTo2JSXh1jKpzwO4TUp5s63E0,SpATywNh6bZuzm8s1ceuBUnMUAeoAHHw,5,2,1,0,1,0,2,0,6,0.8571428571428571,1,0.0,0,1,0,1,2,0,0,2,0,2,4,1
5091,183250,zvOHbaUWjxRZ9zCYxYPMcUH4Ef5dE8Ae,SpATywNh6bZuzm8s1ceuBUnMUAeoAHHw,6,3,1,0,1,0,2,0,7,1.0,1,0.0,0,1,0,1,3,0,0,2,0,2,5,1
5092,183254,1EtDFoshTxvFPxLRYfA4KzHCN6a1sUab,RXDvfPUBYFlVdlueBFbLW0mhhAyGEqpt,8,8,5,0,2,2,2,0,19,2.7142857142857144,1,0.0,0,5,0,2,8,2,0,2,0,7,12,1
5093,183258,cwjdhzGq04zCTXyAv16dQv37UeRHYh5B,G8EPVSXsOYB5YQWZGiz1aVq5Pgr2GrQu,6,3,2,0,2,0,1,0,8,1.1428571428571428,1,0.0,0,2,0,2,3,0,0,1,0,4,4,1
5094,183260,5nq8zs9A2tdQgPir7vYvctaqXkR3aFiH,SpATywNh6bZuzm8s1ceuBUnMUAeoAHHw,12,17,2,15,1,0,5,0,40,5.714285714285714,1,0.0,6,2,13,1,11,0,2,5,0,22,18,1
5095,183265,QT9CjDkbeQDwB2YMvS9MmI6T8kS9zKHi,RXDvfPUBYFlVdlueBFbLW0mhhAyGEqpt,5,1,1,0,1,0,2,0,5,0.7142857142857143,1,0.0,0,1,0,1,1,0,0,2,0,2,3,1
5096,183267,9nmSiMdYrhU2xelQs2wN4VWDOzZHLs5V,G8EPVSXsOYB5YQWZGiz1aVq5Pgr2GrQu,1,0,0,0,0,0,1,0,1,0.14285714285714285,1,0.0,0,0,0,0,0,0,0,1,0,0,1,1
5097,183291,KA8RyaMJzO49U5Bg2GbjpW1mpD8UFvq1,bWdj2GDclj5ofokWjzoa5jAwMkxCykd6,1,0,0,0,0,0,1,0,1,0.14285714285714285,1,0.0,0,0,0,0,0,0,0,1,0,0,1,1
5098,183294,x0GEvwkvyx0g8nTyKguqj2gMY7vcYmyU,SpATywNh6bZuzm8s1ceuBUnMUAeoAHHw,6,3,1,0,1,0,2,0,7,1.0,1,0.0,0,1,0,1,3,0,0,2,0,2,5,1
5099,183297,11kDA8TSGRrd2fZeDsp1CDJVYBIctE55,RXDvfPUBYFlVdlueBFbLW0mhhAyGEqpt,6,6,4,0,1,0,1,0,12,1.7142857142857142,1,0.0,0,4,0,1,6,0,0,1,0,5,7,1
5100,183300,K6sgJjXLg94pFHcJsnQvREqPhcrsQGLq,SpATywNh6bZuzm8s1ceuBUnMUAeoAHHw,2,0,0,0,0,0,3,0,3,0.42857142857142855,1,0.0,0,0,0,0,0,0,0,3,0,0,3,1
5101,183306,uufXnXOfmStAymRAiMYAROVtj5hPlDvd,bWdj2GDclj5ofokWjzoa5jAwMkxCykd6,5,2,1,0,1,0,3,0,7,1.0,1,0.0,0,1,0,1,2,0,0,3,0,2,5,1
5102,183315,G77tKik9NyptRJFC9Rot5qsRZiF0D6mk,SpATywNh6bZuzm8s1ceuBUnMUAeoAHHw,6,6,3,0,2,0,2,0,13,1.8571428571428572,1,0.0,2,3,0,2,4,0,0,2,0,7,6,1
5103,183316,Dm8rUUBDQqhrTm6PWZMMnJPt5PSDMko0,G8EPVSXsOYB5YQWZGiz1aVq5Pgr2GrQu,3,2,0,0,0,1,2,0,5,0.7142857142857143,1,0.0,0,0,0,0,2,1,0,2,0,0,5,1
5104,183317,jTtPdqNIV0C6SwNZGMhf4DTx667U70VG,SpATywNh6bZuzm8s1ceuBUnMUAeoAHHw,12,21,0,18,0,13,5,2,59,8.428571428571429,1,0.0,4,0,15,0,17,13,3,5,2,19,40,1
5105,183319,olHirIGJLYzj8TwhRxe1Dm9DLgoQbNvO,SpATywNh6bZuzm8s1ceuBUnMUAeoAHHw,9,7,6,0,5,0,5,0,23,3.2857142857142856,1,0.0,0,6,0,5,7,0,0,5,0,11,12,1
5106,183340,0Vj24SN7QK68fxZGEj9b6pGHh8nTXfGG,bWdj2GDclj5ofokWjzoa5jAwMkxCykd6,1,0,0,0,0,0,1,0,1,0.14285714285714285,1,0.0,0,0,0,0,0,0,0,1,0,0,1,1
5107,183345,7QIKpGgitmD7tk807kQNY8RClDv3488Y,SpATywNh6bZuzm8s1ceuBUnMUAeoAHHw,5,2,1,0,1,1,2,1,8,1.1428571428571428,1,0.0,0,1,0,1,2,1,0,2,1,2,6,1
5108,183350,89IraAtUfhoGAQgzdMP1844g2s2iN4Ox,RXDvfPUBYFlVdlueBFbLW0mhhAyGEqpt,16,18,6,15,6,4,6,10,65,9.285714285714286,1,0.0,5,6,15,6,13,4,0,6,10,32,33,1
5109,183353,geebTbOsD2liuGCoIF7cu53Xft014LYQ,bWdj2GDclj5ofokWjzoa5jAwMkxCykd6,5,2,1,0,1,0,2,1,7,1.0,1,0.0,0,1,0,1,2,0,0,2,1,2,5,1
5110,183399,5e8eBFhY8m9197wxmtpeMKTT5Js0t5oX,SpATywNh6bZuzm8s1ceuBUnMUAeoAHHw,1,0,0,0,0,0,1,0,1,0.14285714285714285,1,0.0,0,0,0,0,0,0,0,1,0,0,1,1
5111,183400,dWLPd7W4XxJuKssPJAJlISLlvxj9YqGO,G8EPVSXsOYB5YQWZGiz1aVq5Pgr2GrQu,14,14,6,10,3,0,6,1,40,5.714285714285714,1,0.0,3,6,7,3,11,0,3,6,1,19,21,1
5112,183411,GO3MGrx4XteeFiOXpQf53F1doJGXYUJh,G8EPVSXsOYB5YQWZGiz1aVq5Pgr2GrQu,11,11,8,0,4,1,8,3,35,5.0,1,0.0,0,8,0,4,11,1,0,8,3,12,23,1
5113,183413,qvBe3rKX4kTO2XRpAwHefqsXVjGwcgVZ,SpATywNh6bZuzm8s1ceuBUnMUAeoAHHw,6,7,0,0,0,2,2,0,11,1.5714285714285714,1,0.0,3,0,0,0,4,2,0,2,0,3,8,1
5114,183416,orkcYdEVQqlH9SJjCRUiZ5P3bFy172XW,bWdj2GDclj5ofokWjzoa5jAwMkxCykd6,2,0,0,0,0,0,5,0,5,0.7142857142857143,2,0.0,0,0,0,0,0,0,0,5,0,0,5,1
5115,183434,OocLfrCOBb0PIIRDKMfTM554g3aeKj99,bWdj2GDclj5ofokWjzoa5jAwMkxCykd6,5,2,1,0,1,0,2,0,6,0.8571428571428571,1,0.0,0,1,0,1,2,0,0,2,0,2,4,1
5116,183441,AGnMVhenXKmXw34icDYbSubheSiHLlFC,bWdj2GDclj5ofokWjzoa5jAwMkxCykd6,1,0,0,0,0,0,1,0,1,0.14285714285714285,1,0.0,0,0,0,0,0,0,0,1,0,0,1,1
5117,183444,7OyOaefKbOX5xGdSnzdHd0CL6VXfEf8T,G8EPVSXsOYB5YQWZGiz1aVq5Pgr2GrQu,2,0,0,0,0,0,2,0,2,0.2857142857142857,1,0.0,0,0,0,0,0,0,0,2,0,0,2,1
5118,183447,IGdK3d2q4pwzeowbu1fnlncF2G0mIESt,SpATywNh6bZuzm8s1ceuBUnMUAeoAHHw,6,12,0,0,0,0,2,0,14,2.0,1,0.0,1,0,0,0,11,0,0,2,0,1,13,1
5119,183449,NhOj8NHtxbWRVl1n7CiUbpZQHLOfubek,RXDvfPUBYFlVdlueBFbLW0mhhAyGEqpt,13,16,2,0,1,21,12,1,53,7.571428571428571,1,0.0,0,2,0,1,16,21,0,12,1,3,50,1
5120,183460,zsosD9YlCDywhEUV3Vphbp3IXW8MeBYM,bWdj2GDclj5ofokWjzoa5jAwMkxCykd6,1,0,0,0,0,0,1,0,1,0.14285714285714285,1,0.0,0,0,0,0,0,0,0,1,0,0,1,1
5121,183476,069ftOw6ldZ1V3ipXwZemwIwoCreCmPS,G8EPVSXsOYB5YQWZGiz1aVq5Pgr2GrQu,16,15,5,36,3,0,1,0,60,8.571428571428571,1,0.0,9,5,27,3,6,0,9,1,0,44,16,1
5122,183481,zpoCbNcTK6iqE6Hm4JrK6lHIZV2VXvYX,SpATywNh6bZuzm8s1ceuBUnMUAeoAHHw,1,0,0,0,0,0,3,0,3,0.42857142857142855,1,0.0,0,0,0,0,0,0,0,3,0,0,3,1
5123,183488,kUJcgErkiF8AsEDKHMMLmp1H5MenUsXw,G8EPVSXsOYB5YQWZGiz1aVq5Pgr2GrQu,2,0,0,0,0,0,3,0,3,0.42857142857142855,1,0.0,0,0,0,0,0,0,0,3,0,0,3,1
5124,183500,fsFbJ8UrfADOZi56VOg1TSjQKQnG4WLk,RXDvfPUBYFlVdlueBFbLW0mhhAyGEqpt,8,5,0,0,0,0,3,0,8,1.1428571428571428,1,0.0,0,0,0,0,5,0,0,3,0,0,8,1
5125,183502,VtCUQBk0TlN0AJOAq0bEC4tTAH6HVrBA,SpATywNh6bZuzm8s1ceuBUnMUAeoAHHw,3,2,0,0,0,0,1,0,3,0.42857142857142855,1,0.0,0,0,0,0,2,0,0,1,0,0,3,1
5126,183514,f2GMLkjrqGdN19ysxF64zEiQj9fxR4cG,G8EPVSXsOYB5YQWZGiz1aVq5Pgr2GrQu,5,2,1,0,1,0,2,0,6,0.8571428571428571,1,0.0,0,1,0,1,2,0,0,2,0,2,4,1
5127,183527,66KnlNHw8D8zXFB0ktOwarKa6xDfCRsA,SpATywNh6bZuzm8s1ceuBUnMUAeoAHHw,2,0,0,0,0,0,2,0,2,0.2857142857142857,1,0.0,0,0,0,0,0,0,0,2,0,0,2,1
5128,183534,joi2hmNEoOCl0stUXbrsaehVDAdpUejn,SpATywNh6bZuzm8s1ceuBUnMUAeoAHHw,1,0,0,0,0,0,1,0,1,0.14285714285714285,1,0.0,0,0,0,0,0,0,0,1,0,0,1,1
5129,183537,GNsGzjFSidI9fBCvT9fI5F8kfuYTc1I2,RXDvfPUBYFlVdlueBFbLW0mhhAyGEqpt,13,16,9,0,3,0,7,1,36,5.142857142857143,2,0.0,2,9,0,3,14,0,0,7,1,14,22,0
5130,183541,gqy9Iq3u49oICISghrOoeZuPt4tAVyjr,SpATywNh6bZuzm8s1ceuBUnMUAeoAHHw,5,2,1,0,1,0,2,0,6,0.8571428571428571,1,0.0,0,1,0,1,2,0,0,2,0,2,4,1
5131,183543,RrZIh1Er4YeabEoYA6SJyDj40LWgHTn5,SpATywNh6bZuzm8s1ceuBUnMUAeoAHHw,6,2,0,0,0,0,5,0,7,1.0,1,0.0,0,0,0,0,2,0,0,5,0,0,7,1
5132,183549,oAjXymbDbd4Rt4XO0pdep7ez7kmoJtvA,bWdj2GDclj5ofokWjzoa5jAwMkxCykd6,2,0,0,0,0,0,2,0,2,0.2857142857142857,1,0.0,0,0,0,0,0,0,0,2,0,0,2,1
5133,183550,JaYbgvhgx43SysY9J8DaCR3IcdUzCcUf,bWdj2GDclj5ofokWjzoa5jAwMkxCykd6,4,4,1,0,0,0,2,0,7,1.0,2,0.0,0,1,0,0,4,0,0,2,0,1,6,1
5134,183552,tCPCenWlAqHKYLuxwQ692ECgp8ponIEe,SpATywNh6bZuzm8s1ceuBUnMUAeoAHHw,2,0,0,0,0,0,2,0,2,0.2857142857142857,1,0.0,0,0,0,0,0,0,0,2,0,0,2,1
5135,183560,539icBw2nmvBmBkzeMPm9mMNpWONyi1a,bWdj2GDclj5ofokWjzoa5jAwMkxCykd6,2,0,0,0,0,0,2,0,2,0.2857142857142857,1,0.0,0,0,0,0,0,0,0,2,0,0,2,1
5136,183569,iJJNhRwyvCNK6HRXY0B7B0PcxR090Rv4,SpATywNh6bZuzm8s1ceuBUnMUAeoAHHw,1,0,0,0,0,0,1,0,1,0.14285714285714285,1,0.0,0,0,0,0,0,0,0,1,0,0,1,1
5137,183570,mORy2uEWeq5FPaYREt08zxVhXzxOvG5x,SpATywNh6bZuzm8s1ceuBUnMUAeoAHHw,4,2,1,0,1,18,1,0,23,3.2857142857142856,1,0.0,0,1,0,1,2,18,0,1,0,2,21,1
5138,183579,hKd0tEZKHss60gUM0z43MBrDD3KnSpLX,SpATywNh6bZuzm8s1ceuBUnMUAeoAHHw,6,3,1,0,1,0,3,0,8,1.1428571428571428,1,0.0,0,1,0,1,3,0,0,3,0,2,6,1
5139,183585,bGVVh5mMYkn1gHW6CnpRuYzXwIcX6sC6,SpATywNh6bZuzm8s1ceuBUnMUAeoAHHw,6,1,1,0,1,1,3,1,8,1.1428571428571428,1,0.0,0,1,0,1,1,1,0,3,1,2,6,1
5140,183590,iwLRjFCEFjJtmNgQnRk4kXqxuLSCzbLr,SpATywNh6bZuzm8s1ceuBUnMUAeoAHHw,7,4,2,0,2,0,4,1,13,1.8571428571428572,1,0.0,1,2,0,2,3,0,0,4,1,5,8,1
5141,183603,yMScB1KMRz60XZtblJXZ7cOwpx8nYT9h,G8EPVSXsOYB5YQWZGiz1aVq5Pgr2GrQu,9,9,1,18,2,0,2,0,32,4.571428571428571,1,0.0,7,1,12,2,2,0,6,2,0,22,10,1
5142,183613,7jDyNmBRkEY6fNon9RWGerv8blE7YVJd,bWdj2GDclj5ofokWjzoa5jAwMkxCykd6,4,2,0,0,0,0,2,0,4,0.5714285714285714,1,0.0,0,0,0,0,2,0,0,2,0,0,4,1
5143,183614,x967IREOKVWVVneKjnOdD8ZruuMl1VE7,SpATywNh6bZuzm8s1ceuBUnMUAeoAHHw,9,21,9,0,7,0,3,0,40,5.714285714285714,1,0.0,1,9,0,7,20,0,0,3,0,17,23,1
5144,183624,Tfb5kzD9uzk4IFFKiGmgMSkZRj1tZ0K9,bWdj2GDclj5ofokWjzoa5jAwMkxCykd6,8,22,5,26,8,0,4,0,65,9.285714285714286,2,0.0,16,5,26,8,6,0,0,4,0,55,10,0
5145,183631,FbdmHwhDtQoDvNNbH5NO4UO0Yhp01nUq,SpATywNh6bZuzm8s1ceuBUnMUAeoAHHw,5,2,1,0,1,0,2,0,6,0.8571428571428571,1,0.0,0,1,0,1,2,0,0,2,0,2,4,1
5146,183634,R4jzs50fuf1JavV9xGEb7vRBguxW8cYa,SpATywNh6bZuzm8s1ceuBUnMUAeoAHHw,8,13,6,0,2,1,4,0,26,3.7142857142857144,1,0.0,0,6,0,2,13,1,0,4,0,8,18,1
5147,183641,CAXYMnI26CJKVZLm27KWhrQ5wZxlWBLx,SpATywNh6bZuzm8s1ceuBUnMUAeoAHHw,5,6,1,0,1,0,1,0,9,1.2857142857142858,1,0.0,0,1,0,1,6,0,0,1,0,2,7,1
5148,183645,rzux1UjWNNs1GqyksFiTFp3NDiKcqZIA,SpATywNh6bZuzm8s1ceuBUnMUAeoAHHw,5,2,1,0,1,0,2,0,6,0.8571428571428571,1,0.0,0,1,0,1,2,0,0,2,0,2,4,1
5149,183649,tHouYbJheFPQJDK2n6XJK9jRREGEheXi,G8EPVSXsOYB5YQWZGiz1aVq5Pgr2GrQu,36,43,12,44,10,2,6,1,118,16.857142857142858,1,0.0,25,12,29,10,18,2,15,6,1,76,42,1
5150,183651,QP3bOKPbx70fYEywL9MXgcXTnFgBdqPj,SpATywNh6bZuzm8s1ceuBUnMUAeoAHHw,6,3,1,0,1,0,3,0,8,1.1428571428571428,1,0.0,0,1,0,1,3,0,0,3,0,2,6,1
5151,183655,Mbj5txvZRTAvPuGny65LvJcTeJZzO2Xr,SpATywNh6bZuzm8s1ceuBUnMUAeoAHHw,5,4,3,0,1,0,1,0,9,1.2857142857142858,1,0.0,0,3,0,1,4,0,0,1,0,4,5,1
5152,183664,o19vb57bgfx9sNjmUMNmIakP5nctIJ3O,bWdj2GDclj5ofokWjzoa5jAwMkxCykd6,5,4,0,0,0,0,2,0,6,0.8571428571428571,1,0.0,0,0,0,0,4,0,0,2,0,0,6,1
5153,183675,cpH6ushFbRO23LBN96kMSHMHQ5CDuqWx,SpATywNh6bZuzm8s1ceuBUnMUAeoAHHw,10,8,4,0,3,0,2,0,17,2.4285714285714284,1,0.0,3,4,0,3,5,0,0,2,0,10,7,1
5154,183689,tVDSRebDM9kj4eZBXWEp0omzaKHFumrl,SpATywNh6bZuzm8s1ceuBUnMUAeoAHHw,4,2,1,0,1,0,1,0,5,0.7142857142857143,1,0.0,0,1,0,1,2,0,0,1,0,2,3,1
5155,183698,o19vb57bgfx9sNjmUMNmIakP5nctIJ3O,G8EPVSXsOYB5YQWZGiz1aVq5Pgr2GrQu,1,0,0,0,0,0,1,0,1,0.14285714285714285,1,0.0,0,0,0,0,0,0,0,1,0,0,1,1
5156,183699,qjQ6GiU7sehnY7qaKKajZBfA0GV2t1bA,SpATywNh6bZuzm8s1ceuBUnMUAeoAHHw,5,2,0,0,1,0,2,0,5,0.7142857142857143,1,0.0,0,0,0,1,2,0,0,2,0,1,4,1
5157,183716,2hMeaUc14fgUG8b3kgXxN1xDYogexPXy,bWdj2GDclj5ofokWjzoa5jAwMkxCykd6,5,9,0,0,1,0,1,0,11,1.5714285714285714,1,0.0,3,0,0,1,6,0,0,1,0,4,7,1
5158,183718,Lf0mThPYOrtlCzgRGBCVTPy1hiGUII8h,bWdj2GDclj5ofokWjzoa5jAwMkxCykd6,7,2,1,0,1,0,4,0,8,1.1428571428571428,1,0.0,0,1,0,1,2,0,0,4,0,2,6,1
5159,183726,hB6lALXH4sMaj6Hr4qOJgZbelF7wY5ML,SpATywNh6bZuzm8s1ceuBUnMUAeoAHHw,5,2,1,0,1,0,2,0,6,0.8571428571428571,1,0.0,0,1,0,1,2,0,0,2,0,2,4,1
5160,183734,bUWUvqWKJBmYgRNIoWQO6VIVyvpJs3GG,bWdj2GDclj5ofokWjzoa5jAwMkxCykd6,14,16,6,16,2,0,3,0,43,6.142857142857143,1,0.0,3,6,14,2,13,0,2,3,0,25,18,1
5161,183736,CJjWj5QSoyqJ23EMwHZtEX525JWA2E7K,SpATywNh6bZuzm8s1ceuBUnMUAeoAHHw,5,2,1,0,1,0,2,0,6,0.8571428571428571,1,0.0,0,1,0,1,2,0,0,2,0,2,4,1
5162,183737,EEKM5fD1OwESnar1FjU8hxj0L9tVWx44,RXDvfPUBYFlVdlueBFbLW0mhhAyGEqpt,10,9,1,0,1,5,2,0,18,2.5714285714285716,1,0.0,0,1,0,1,9,5,0,2,0,2,16,1
5163,183740,e1dzN81UKTvb4PNCErZLbC2uYa0wPNos,SpATywNh6bZuzm8s1ceuBUnMUAeoAHHw,6,5,2,0,2,0,1,0,10,1.4285714285714286,1,0.0,0,2,0,2,5,0,0,1,0,4,6,1
5164,183743,Tkxf1Z89UY3ofefoIUKYhYMqhRZ3ElpY,SpATywNh6bZuzm8s1ceuBUnMUAeoAHHw,1,0,0,0,0,0,1,0,1,0.14285714285714285,1,0.0,0,0,0,0,0,0,0,1,0,0,1,1
5165,183755,5UWxjYJaVNtau37O89p9sB7M5HwhMo3z,bWdj2GDclj5ofokWjzoa5jAwMkxCykd6,1,0,0,0,0,0,1,0,1,0.14285714285714285,1,0.0,0,0,0,0,0,0,0,1,0,0,1,1
5166,183759,NplT7OhnAZOp9hCAdGLFNwSMTc3LAhF2,G8EPVSXsOYB5YQWZGiz1aVq5Pgr2GrQu,23,32,6,38,4,0,2,0,82,11.714285714285714,1,0.0,23,6,23,4,9,0,15,2,0,56,26,1
5167,183766,bY2gh2mIojoS37RuKr0mq0gh4QBiW0z8,G8EPVSXsOYB5YQWZGiz1aVq5Pgr2GrQu,11,18,5,16,2,3,2,0,46,6.571428571428571,1,0.0,10,5,14,2,8,3,2,2,0,31,15,1
5168,183781,HL5HEUPq5k60nwiHmjiz48idVIW7iDWP,SpATywNh6bZuzm8s1ceuBUnMUAeoAHHw,5,2,1,0,1,0,2,0,6,0.8571428571428571,1,0.0,0,1,0,1,2,0,0,2,0,2,4,1
5169,183784,QzFNcWcdt9jKMCztuclgA8fbidhRkaqv,SpATywNh6bZuzm8s1ceuBUnMUAeoAHHw,7,6,0,0,0,0,13,1,20,2.857142857142857,1,0.0,0,0,0,0,6,0,0,13,1,0,20,1
5170,183796,MhvviuZNTmfoceElB9BVHo0GzJkIAz9b,G8EPVSXsOYB5YQWZGiz1aVq5Pgr2GrQu,7,6,2,0,2,0,1,0,11,1.5714285714285714,1,0.0,0,2,0,2,6,0,0,1,0,4,7,1
5171,183800,4T6e9tf501hupPEmmZRZG7Lv5vYmRX6i,SpATywNh6bZuzm8s1ceuBUnMUAeoAHHw,6,4,3,0,3,0,1,0,11,1.5714285714285714,1,0.0,0,3,0,3,4,0,0,1,0,6,5,1
5172,183802,4Y8z1fVuk8HPWGVOteuQwAFNrdo0CBpu,SpATywNh6bZuzm8s1ceuBUnMUAeoAHHw,1,0,0,0,0,0,2,0,2,0.2857142857142857,1,0.0,0,0,0,0,0,0,0,2,0,0,2,1
5173,183805,6Ysh3EXeoiNCd1uXxsjEQronkryNKRU5,RXDvfPUBYFlVdlueBFbLW0mhhAyGEqpt,1,0,0,0,0,0,1,0,1,0.14285714285714285,1,0.0,0,0,0,0,0,0,0,1,0,0,1,1
5174,183808,cLRv4oHsLxWfkE6gs4eN6fO5y0RK8Odw,G8EPVSXsOYB5YQWZGiz1aVq5Pgr2GrQu,6,4,2,0,1,0,4,0,11,1.5714285714285714,1,0.0,0,2,0,1,4,0,0,4,0,3,8,1
5175,183822,OuPUar7X5BJymhikUDnyE5tFiUVuL09j,bWdj2GDclj5ofokWjzoa5jAwMkxCykd6,4,2,1,0,1,0,1,0,5,0.7142857142857143,1,0.0,0,1,0,1,2,0,0,1,0,2,3,1
5176,183839,yzbVurZnZZ3LzSESEDTD8mBP09kqyBBh,G8EPVSXsOYB5YQWZGiz1aVq5Pgr2GrQu,5,2,1,0,0,0,4,0,7,1.0,1,0.0,0,1,0,0,2,0,0,4,0,1,6,1
5177,183842,e3vAZGPddv8GG7o51Df54H5d3GJcihRZ,G8EPVSXsOYB5YQWZGiz1aVq5Pgr2GrQu,5,2,1,0,1,0,2,0,6,0.8571428571428571,1,0.0,0,1,0,1,2,0,0,2,0,2,4,1
5178,183843,KqeR1ihSDa1Ej9nVqHYeUS5y6oETFEfM,bWdj2GDclj5ofokWjzoa5jAwMkxCykd6,4,2,0,0,1,0,1,0,4,0.5714285714285714,1,0.0,0,0,0,1,2,0,0,1,0,1,3,1
5179,183850,N9VYkIRf4aydaM9gnOlftZxNGDW8I3Zp,SpATywNh6bZuzm8s1ceuBUnMUAeoAHHw,5,6,3,0,1,1,3,0,14,2.0,3,0.0,0,3,0,1,6,1,0,3,0,4,10,1
5180,183851,ls613vLH6fBQyqRMeuiCg3ot5Tyb4DDz,RXDvfPUBYFlVdlueBFbLW0mhhAyGEqpt,1,0,0,0,0,0,1,0,1,0.14285714285714285,1,0.0,0,0,0,0,0,0,0,1,0,0,1,1
5181,183852,NyPL3YppErvC9cRYCzI4gxKdO7060UB2,SpATywNh6bZuzm8s1ceuBUnMUAeoAHHw,4,2,1,0,0,0,2,0,5,0.7142857142857143,1,0.0,0,1,0,0,2,0,0,2,0,1,4,1
5182,183854,3aJcxnpBDknIFELx5q7A1ed9nLB6csNj,bWdj2GDclj5ofokWjzoa5jAwMkxCykd6,3,3,0,0,0,0,1,0,4,0.5714285714285714,1,0.0,0,0,0,0,3,0,0,1,0,0,4,1
5183,183856,PN6HDAlC1c0mDwWmACSk2v8uGfyNjwaH,SpATywNh6bZuzm8s1ceuBUnMUAeoAHHw,5,1,1,0,1,0,2,0,5,0.7142857142857143,1,0.0,0,1,0,1,1,0,0,2,0,2,3,1
5184,183857,xaz3R9QEFJxcfadxPNec99QMlGTDEIiY,SpATywNh6bZuzm8s1ceuBUnMUAeoAHHw,16,20,6,24,5,7,5,1,68,9.714285714285714,1,0.0,12,6,21,5,8,7,3,5,1,44,24,1
5185,183870,56VZldyBA7sJdFNsW4uyCbKalKBMfJny,SpATywNh6bZuzm8s1ceuBUnMUAeoAHHw,5,3,0,0,0,0,4,0,7,1.0,1,0.0,0,0,0,0,3,0,0,4,0,0,7,1
5186,183872,KLhUlREKq0O2xglSDOcFfaFp54qACtHM,SpATywNh6bZuzm8s1ceuBUnMUAeoAHHw,1,0,0,0,0,0,1,0,1,0.14285714285714285,1,0.0,0,0,0,0,0,0,0,1,0,0,1,1
5187,183875,fgQYCS5dRFsryAHcjDowcgqd9vNhjm9J,SpATywNh6bZuzm8s1ceuBUnMUAeoAHHw,6,7,0,0,0,0,2,0,9,1.2857142857142858,1,0.0,0,0,0,0,7,0,0,2,0,0,9,1
5188,183886,jhJPaGwU7dqU4ZwAVfiDn0qBdh771kri,G8EPVSXsOYB5YQWZGiz1aVq5Pgr2GrQu,15,66,32,50,17,0,2,0,167,23.857142857142858,1,0.0,0,32,47,17,66,0,3,2,0,96,71,1
5189,183895,HdOvDLzexKNSAsc0DtnaPUszT8VuZf1r,SpATywNh6bZuzm8s1ceuBUnMUAeoAHHw,7,3,2,0,2,0,3,0,10,1.4285714285714286,1,0.0,0,2,0,2,3,0,0,3,0,4,6,1
5190,183899,BDTbCzD1BP0Zvh6WPG7fuO5jLB3vSWaq,SpATywNh6bZuzm8s1ceuBUnMUAeoAHHw,4,2,1,0,1,0,1,0,5,0.7142857142857143,1,0.0,0,1,0,1,2,0,0,1,0,2,3,1
5191,183909,hpKSHIi4bRo1DEIvbfvzcRke2iP1vwgF,RXDvfPUBYFlVdlueBFbLW0mhhAyGEqpt,5,6,4,0,1,0,2,0,13,1.8571428571428572,1,0.0,0,4,0,1,6,0,0,2,0,5,8,1
5192,183910,52QsTv4Uo7nj5fP154PK0QEBA8xMFRXc,G8EPVSXsOYB5YQWZGiz1aVq5Pgr2GrQu,4,2,1,0,1,0,1,0,5,0.7142857142857143,1,0.0,0,1,0,1,2,0,0,1,0,2,3,1
5193,183919,5BY2554FQkXzWEII8U25cUr1TyLfBPj6,RXDvfPUBYFlVdlueBFbLW0mhhAyGEqpt,5,2,1,0,0,0,3,0,6,0.8571428571428571,1,0.0,0,1,0,0,2,0,0,3,0,1,5,1
5194,183923,2HllbOBswZcfya5rDzlXYMHVB93oWjxb,bWdj2GDclj5ofokWjzoa5jAwMkxCykd6,1,0,0,0,0,0,1,0,1,0.14285714285714285,1,0.0,0,0,0,0,0,0,0,1,0,0,1,1
5195,183926,DiwcwcqzaE6lFsZWpJEHbAW7aioGreHg,SpATywNh6bZuzm8s1ceuBUnMUAeoAHHw,8,3,2,0,2,0,4,0,11,1.5714285714285714,1,0.0,0,2,0,2,3,0,0,4,0,4,7,1
5196,183935,oFr2hzwQRg7T6VDIxFir4OUQxI2WAOox,SpATywNh6bZuzm8s1ceuBUnMUAeoAHHw,6,5,1,0,0,0,2,0,8,1.1428571428571428,1,0.0,0,1,0,0,5,0,0,2,0,1,7,1
5197,183947,3SCBHiEI4HvwPrOQDNTIAqp1rZOAx5IK,RXDvfPUBYFlVdlueBFbLW0mhhAyGEqpt,4,2,1,0,1,0,1,0,5,0.7142857142857143,1,0.0,0,1,0,1,2,0,0,1,0,2,3,1
5198,183950,9ihleSS6gtfYUO7B3tfCDZConGdOxWz6,SpATywNh6bZuzm8s1ceuBUnMUAeoAHHw,7,3,0,0,0,0,4,0,7,1.0,1,0.0,0,0,0,0,3,0,0,4,0,0,7,1
5199,183952,ojd6JmvYlEsNwy0j8rsyD9P7isML33mP,SpATywNh6bZuzm8s1ceuBUnMUAeoAHHw,7,3,2,0,2,0,3,0,10,1.4285714285714286,1,0.0,0,2,0,2,3,0,0,3,0,4,6,1
5200,183958,5cpP5I4qy02g5JK1VuduuXdg8Frcarq0,SpATywNh6bZuzm8s1ceuBUnMUAeoAHHw,5,2,1,0,1,0,3,0,7,1.0,1,0.0,0,1,0,1,2,0,0,3,0,2,5,1
5201,183969,xZnb7uXmxIWQ7sisovgxwTXG7X7Be4Tl,bWdj2GDclj5ofokWjzoa5jAwMkxCykd6,11,15,7,8,2,10,8,1,51,7.285714285714286,1,0.0,2,7,6,2,13,10,2,8,1,17,34,1
5202,183973,qQ4S9PtUViLcUYCg7MK0igZg7IO7I0HK,SpATywNh6bZuzm8s1ceuBUnMUAeoAHHw,4,3,0,0,0,0,2,0,5,0.7142857142857143,1,0.0,0,0,0,0,3,0,0,2,0,0,5,1
5203,183988,qgG4OU0HRuoi21bBKmy9fO5g8h7KcP6E,RXDvfPUBYFlVdlueBFbLW0mhhAyGEqpt,20,16,7,18,7,0,8,0,56,8.0,1,0.0,8,7,16,7,8,0,2,8,0,38,18,1
5204,183997,FZXhILo2dZIp84xBqa5ZKNF9O2Wx35MO,SpATywNh6bZuzm8s1ceuBUnMUAeoAHHw,2,0,0,0,0,0,2,0,2,0.2857142857142857,1,0.0,0,0,0,0,0,0,0,2,0,0,2,1
5205,184003,ZqhWTPWWREP1gJARqRhQXMYloraIQQwo,SpATywNh6bZuzm8s1ceuBUnMUAeoAHHw,5,5,3,0,0,0,2,0,10,1.4285714285714286,2,0.0,0,3,0,0,5,0,0,2,0,3,7,1
5206,184008,UJHNe0sYjldvLe2oh1mb1WNNcWhYLg5J,SpATywNh6bZuzm8s1ceuBUnMUAeoAHHw,1,0,0,0,0,0,1,0,1,0.14285714285714285,1,0.0,0,0,0,0,0,0,0,1,0,0,1,1
5207,184017,m4zdr76CpU472F6wsJffFbslI27LpI4g,bWdj2GDclj5ofokWjzoa5jAwMkxCykd6,4,2,1,0,1,0,5,0,9,1.2857142857142858,2,0.0,0,1,0,1,2,0,0,5,0,2,7,1
5208,184024,h774wdF6vIIcl50Js74gckwUtlv9SBGH,G8EPVSXsOYB5YQWZGiz1aVq5Pgr2GrQu,8,14,5,0,4,0,3,0,26,3.7142857142857144,1,0.0,6,5,0,4,8,0,0,3,0,15,11,1
5209,184025,rXd7sBSm51uTyzv9MhrGYApbktwAzsFy,SpATywNh6bZuzm8s1ceuBUnMUAeoAHHw,3,3,1,0,0,0,1,0,5,0.7142857142857143,1,0.0,0,1,0,0,3,0,0,1,0,1,4,1
5210,184027,iu7Na8oZcPlYaVeI8FJk9aKFI4xc19c4,G8EPVSXsOYB5YQWZGiz1aVq5Pgr2GrQu,4,0,0,0,0,1,3,0,4,0.5714285714285714,1,0.0,0,0,0,0,0,1,0,3,0,0,4,1
5211,184029,CrwOvQpdA842UJZ7DoCSM957jMvz9EeO,SpATywNh6bZuzm8s1ceuBUnMUAeoAHHw,6,3,2,0,2,0,1,0,8,1.1428571428571428,1,0.0,0,2,0,2,3,0,0,1,0,4,4,1
5212,184046,5kCR1wjWWz9eEHdizA4crFyxKTH4mIdl,SpATywNh6bZuzm8s1ceuBUnMUAeoAHHw,7,7,2,0,1,0,4,0,14,2.0,1,0.0,2,2,0,1,5,0,0,4,0,5,9,1
5213,184054,dcJH2SRBlozVvsUdEPFKC47IdUh8xpq7,SpATywNh6bZuzm8s1ceuBUnMUAeoAHHw,16,20,9,12,5,4,13,1,64,9.142857142857142,1,0.0,8,9,9,5,12,4,3,13,1,31,33,1
5214,184080,Q0ABMzqV4ZKePGWKS9YO1g6VONZhZLgg,RXDvfPUBYFlVdlueBFbLW0mhhAyGEqpt,13,12,6,25,0,0,1,0,44,6.285714285714286,1,0.0,4,6,21,0,8,0,4,1,0,31,13,0
5215,184093,NslicJCNMxB9cZhzoMFtRxmqPnqyw5Ii,RXDvfPUBYFlVdlueBFbLW0mhhAyGEqpt,5,2,1,0,1,0,2,0,6,0.8571428571428571,1,0.0,0,1,0,1,2,0,0,2,0,2,4,1
5216,184099,jb1WJE68F4yEoD652bth3JuHIrLPIvo8,SpATywNh6bZuzm8s1ceuBUnMUAeoAHHw,8,7,2,0,1,0,5,0,15,2.142857142857143,1,0.0,0,2,0,1,7,0,0,5,0,3,12,1
5217,184108,Jr0wwW2Pnso55z8kcFx2vv1KjdLnz1KD,bWdj2GDclj5ofokWjzoa5jAwMkxCykd6,2,0,0,0,0,0,2,0,2,0.2857142857142857,1,0.0,0,0,0,0,0,0,0,2,0,0,2,1
5218,184121,fqQqpuKLzyQIMrl6XKL3tfcygq4Er6K5,bWdj2GDclj5ofokWjzoa5jAwMkxCykd6,1,0,0,0,0,0,1,0,1,0.14285714285714285,1,0.0,0,0,0,0,0,0,0,1,0,0,1,1
5219,184128,vQs4K4jFbbnMTWF8mXp4DI5eKN8aBPM9,SpATywNh6bZuzm8s1ceuBUnMUAeoAHHw,9,6,3,0,2,0,4,1,16,2.2857142857142856,2,0.0,0,3,0,2,6,0,0,4,1,5,11,1
5220,184130,hHVyNQkfLcybgeO1W2xMmju5SBV0vBkh,SpATywNh6bZuzm8s1ceuBUnMUAeoAHHw,7,6,3,0,2,0,3,0,14,2.0,1,0.0,0,3,0,2,6,0,0,3,0,5,9,1
5221,184135,01vp16vMBdfdzNflK84lEgGXfBDKyb7S,bWdj2GDclj5ofokWjzoa5jAwMkxCykd6,8,6,4,0,2,0,5,0,17,2.4285714285714284,2,0.0,0,4,0,2,6,0,0,5,0,6,11,1
5222,184139,87SYGQjFYUtEWda0pG12bcNker0JGBy3,bWdj2GDclj5ofokWjzoa5jAwMkxCykd6,10,10,0,12,0,2,5,1,30,4.285714285714286,1,0.0,3,0,12,0,7,2,0,5,1,15,15,1
5223,184140,erOlfnGmmzlHYZTaWMuJdUpNjOjYMpjJ,G8EPVSXsOYB5YQWZGiz1aVq5Pgr2GrQu,16,15,15,0,0,0,3,0,33,4.714285714285714,1,0.0,0,15,0,0,15,0,0,3,0,15,18,1
5224,184141,rhwYpyX6KgM0VDKsxgisgjFhLGxmCQNh,SpATywNh6bZuzm8s1ceuBUnMUAeoAHHw,10,5,3,0,3,0,3,0,14,2.0,1,0.0,0,3,0,3,5,0,0,3,0,6,8,1
5225,184159,grKJZKhbDMTJWn0gJUYvmKRwIdpcuPd3,SpATywNh6bZuzm8s1ceuBUnMUAeoAHHw,1,0,0,0,0,0,1,0,1,0.14285714285714285,1,0.0,0,0,0,0,0,0,0,1,0,0,1,1
5226,184162,wrzzafNhG6GCvwxPDE3fRWCo6aRW8DwL,SpATywNh6bZuzm8s1ceuBUnMUAeoAHHw,7,3,2,0,2,0,3,0,10,1.4285714285714286,1,0.0,0,2,0,2,3,0,0,3,0,4,6,1
5227,184177,OOKe107tRCXEu4JY5tmAfF1YLRgWymlM,SpATywNh6bZuzm8s1ceuBUnMUAeoAHHw,7,2,1,0,1,0,4,1,9,1.2857142857142858,1,0.0,0,1,0,1,2,0,0,4,1,2,7,1
5228,184186,VVnP6JrqXx0kcUSjOpF3nGJjlaJ7pttn,RXDvfPUBYFlVdlueBFbLW0mhhAyGEqpt,6,3,2,0,2,4,2,0,13,1.8571428571428572,1,0.0,0,2,0,2,3,4,0,2,0,4,9,1
5229,184196,fz9iMau4c5Sc5pf7Ev3deQnz7r6jSD21,bWdj2GDclj5ofokWjzoa5jAwMkxCykd6,7,4,2,0,1,3,4,0,14,2.0,1,0.0,0,2,0,1,4,3,0,4,0,3,11,1
5230,184198,T5b4rlcXzzOiQabsmSU227C710oPv1q6,SpATywNh6bZuzm8s1ceuBUnMUAeoAHHw,1,0,0,0,0,0,1,0,1,0.14285714285714285,1,0.0,0,0,0,0,0,0,0,1,0,0,1,1
5231,184200,fgbY9PHcmr11G1IYkEJJMMaayPBzrdUL,bWdj2GDclj5ofokWjzoa5jAwMkxCykd6,1,0,0,0,0,0,1,0,1,0.14285714285714285,1,0.0,0,0,0,0,0,0,0,1,0,0,1,1
5232,184206,6YsryIPZKCMdT9rBoswcMetX0bA1SxAS,G8EPVSXsOYB5YQWZGiz1aVq5Pgr2GrQu,1,0,0,0,0,0,1,0,1,0.14285714285714285,1,0.0,0,0,0,0,0,0,0,1,0,0,1,1
5233,185695,GeBQuszwSQRCopSsB1wYZb4YBk7b0Cp6,SpATywNh6bZuzm8s1ceuBUnMUAeoAHHw,5,4,3,0,0,0,2,0,9,1.2857142857142858,1,0.0,0,3,0,0,4,0,0,2,0,3,6,1
5234,185708,XKXeDYTx8c3NYYfheBcuxoUZV0qXomPt,RXDvfPUBYFlVdlueBFbLW0mhhAyGEqpt,7,2,1,0,1,0,4,0,8,1.1428571428571428,1,0.0,0,1,0,1,2,0,0,4,0,2,6,1
5235,185744,Az4YfhTihzekQWxQtUyhZcCNXF1QoO5A,A3fsA9Zfv1X2fVEQhTw51lKENdNrEqT3,2,0,0,0,0,0,2,0,2,0.2857142857142857,1,0.0,0,0,0,0,0,0,0,2,0,0,2,1
5236,185750,sJThH3sI3ghUBWEkkF5jl318HrGCcG4Q,SpATywNh6bZuzm8s1ceuBUnMUAeoAHHw,8,14,0,10,0,0,6,0,30,4.285714285714286,1,0.0,11,0,9,0,3,0,1,6,0,20,10,1
5237,185765,EcTOYzny90oltpyqEhmLnMxAbahxVt33,A3fsA9Zfv1X2fVEQhTw51lKENdNrEqT3,16,8,7,0,6,6,4,1,32,4.571428571428571,2,0.0,0,7,0,6,8,6,0,4,1,13,19,1
5238,185777,VDLlgOqW7FFpT6uHqFXXlnnZR1JOz0x8,G8EPVSXsOYB5YQWZGiz1aVq5Pgr2GrQu,2,0,0,0,0,0,2,0,2,0.2857142857142857,1,0.0,0,0,0,0,0,0,0,2,0,0,2,1
5239,185787,pX5xieCfpPW4jfU74i0ayJdMShXi7ShL,A3fsA9Zfv1X2fVEQhTw51lKENdNrEqT3,2,0,0,0,0,0,2,0,2,0.2857142857142857,1,0.0,0,0,0,0,0,0,0,2,0,0,2,1
5240,185791,OLSxCkluLildKVrVnzRIsj47tt9tVHj9,SpATywNh6bZuzm8s1ceuBUnMUAeoAHHw,1,0,0,0,0,0,1,0,1,0.14285714285714285,1,0.0,0,0,0,0,0,0,0,1,0,0,1,1
5241,185804,YxKCslAege9DFmBzH0U7gCkLRow3CW1P,SpATywNh6bZuzm8s1ceuBUnMUAeoAHHw,9,9,7,0,6,0,1,0,23,3.2857142857142856,1,0.0,1,7,0,6,8,0,0,1,0,14,9,1
5242,185828,IlZMDuyHlB01hS9oHYhp77XsI0vMQkwN,bWdj2GDclj5ofokWjzoa5jAwMkxCykd6,7,9,2,0,1,0,5,0,17,2.4285714285714284,2,0.0,0,2,0,1,9,0,0,5,0,3,14,1
5243,185840,9UxAqNYuBtvS2ppV37y5D8wZyoNAl3Em,bWdj2GDclj5ofokWjzoa5jAwMkxCykd6,9,22,7,0,6,0,7,12,54,7.714285714285714,1,0.0,7,7,0,6,15,0,0,7,12,20,34,1
5244,185842,gQqEJZs7B37MmzRexP5otRszUHd2KLYy,SpATywNh6bZuzm8s1ceuBUnMUAeoAHHw,14,11,7,3,4,0,2,0,27,3.857142857142857,1,0.0,2,7,3,4,9,0,0,2,0,16,11,1
5245,185845,nSUHoNpp8PQSdMavNp5bhwMOhBRAUKca,bWdj2GDclj5ofokWjzoa5jAwMkxCykd6,1,0,0,0,0,0,1,0,1,0.14285714285714285,1,0.0,0,0,0,0,0,0,0,1,0,0,1,1
5246,185855,mIK1AsuZnsKqFebwZwvDET5yr9oF0NY2,bWdj2GDclj5ofokWjzoa5jAwMkxCykd6,1,0,0,0,0,0,1,0,1,0.14285714285714285,1,0.0,0,0,0,0,0,0,0,1,0,0,1,1
5247,185864,eQeAZJfAlQDBFNhBayGkUGtYxXtMJqJ1,SpATywNh6bZuzm8s1ceuBUnMUAeoAHHw,11,6,5,0,3,0,6,0,20,2.857142857142857,1,0.0,0,5,0,3,6,0,0,6,0,8,12,1
5248,185868,KZ6GY3fLdtMBq5t6dJwyKZUQ4aE5PB3r,SpATywNh6bZuzm8s1ceuBUnMUAeoAHHw,11,16,1,18,0,0,5,0,40,5.714285714285714,1,0.0,10,1,17,0,6,0,1,5,0,28,12,1
5249,185871,TOGjSTNLmP1U3WLV68xOjR9qYmcLTX2F,bWdj2GDclj5ofokWjzoa5jAwMkxCykd6,4,2,1,0,1,0,1,0,5,0.7142857142857143,1,0.0,0,1,0,1,2,0,0,1,0,2,3,1
5250,185874,U6w2qwGH0WBMPRrilbl2Pu4q8r7wV2i5,RXDvfPUBYFlVdlueBFbLW0mhhAyGEqpt,4,2,1,0,1,0,2,0,6,0.8571428571428571,1,0.0,0,1,0,1,2,0,0,2,0,2,4,0
5251,185878,BCr2GOpOyeEKOuzlRV7PJCL1CEnRyr6Q,A3fsA9Zfv1X2fVEQhTw51lKENdNrEqT3,1,0,0,0,0,0,1,0,1,0.14285714285714285,1,0.0,0,0,0,0,0,0,0,1,0,0,1,1
5252,185900,mP0oq4UFI55XwGbomuLjnKyaYZ9Irhl8,SpATywNh6bZuzm8s1ceuBUnMUAeoAHHw,1,0,0,0,0,0,1,0,1,0.14285714285714285,1,0.0,0,0,0,0,0,0,0,1,0,0,1,1
5253,185906,3RLcNHh9pobwm6kdbgPM3yL4oOSbkTV7,bWdj2GDclj5ofokWjzoa5jAwMkxCykd6,11,8,3,12,2,1,10,3,39,5.571428571428571,1,0.0,1,3,11,2,7,1,1,10,3,17,22,1
5254,185913,JNo2rLqKe6aBGDwGzu8tXd13uOC5tEnq,A3fsA9Zfv1X2fVEQhTw51lKENdNrEqT3,11,8,7,0,0,0,7,0,22,3.142857142857143,1,0.0,0,7,0,0,8,0,0,7,0,7,15,0
5255,185916,AZzjcou5vNOE04RAMAJi2EeLUqqymRTr,SpATywNh6bZuzm8s1ceuBUnMUAeoAHHw,5,2,1,0,1,0,2,0,6,0.8571428571428571,1,0.0,0,1,0,1,2,0,0,2,0,2,4,1
5256,185958,brnRegHqgNF4oAtC7Z92Gvb6wNpNm0iX,SpATywNh6bZuzm8s1ceuBUnMUAeoAHHw,5,2,1,0,1,1,2,0,7,1.0,1,0.0,0,1,0,1,2,1,0,2,0,2,5,1
5257,185973,xpLT6AJby37iITmsTgKzOCviwStat3HT,RXDvfPUBYFlVdlueBFbLW0mhhAyGEqpt,15,27,18,23,12,0,5,0,85,12.142857142857142,2,0.0,2,18,19,12,25,0,4,5,0,51,34,1
5258,186015,IZAsMmFtzA3Z4w092UEvwBTSkmDLpELL,bWdj2GDclj5ofokWjzoa5jAwMkxCykd6,1,0,0,0,0,0,1,0,1,0.14285714285714285,1,0.0,0,0,0,0,0,0,0,1,0,0,1,1
5259,186026,CQWretzMoQOL7mDTUjZusG4cd4L6wPQK,G8EPVSXsOYB5YQWZGiz1aVq5Pgr2GrQu,8,7,5,0,4,0,3,0,19,2.7142857142857144,2,0.0,0,5,0,4,7,0,0,3,0,9,10,1
5260,186031,OrXQ89uxDLDCGqiuZJDaLKhVuW8wRjFm,SpATywNh6bZuzm8s1ceuBUnMUAeoAHHw,1,0,0,0,0,0,1,0,1,0.14285714285714285,1,0.0,0,0,0,0,0,0,0,1,0,0,1,1
5261,186032,q8cwoymgEO62c2PjNUcCMU666aFjaHHf,RXDvfPUBYFlVdlueBFbLW0mhhAyGEqpt,9,4,3,0,3,0,2,0,12,1.7142857142857142,1,0.0,0,3,0,3,4,0,0,2,0,6,6,0
5262,186036,3CK0J1tusVtSvx6F6S9RQr6rj3f2luQC,A3fsA9Zfv1X2fVEQhTw51lKENdNrEqT3,4,1,0,0,0,0,5,0,6,0.8571428571428571,2,0.0,0,0,0,0,1,0,0,5,0,0,6,1
5263,186037,l2J6DNpa2tfvVIbHf48MlgRXXDizR7ZU,RXDvfPUBYFlVdlueBFbLW0mhhAyGEqpt,21,21,2,26,1,0,1,0,51,7.285714285714286,1,0.0,4,2,24,1,17,0,2,1,0,31,20,1
5264,186043,pwdsR2guw7jGBDVAdaksGODr7uJoy6bJ,SpATywNh6bZuzm8s1ceuBUnMUAeoAHHw,1,0,0,0,0,0,1,0,1,0.14285714285714285,1,0.0,0,0,0,0,0,0,0,1,0,0,1,1
5265,186051,pwdsR2guw7jGBDVAdaksGODr7uJoy6bJ,bWdj2GDclj5ofokWjzoa5jAwMkxCykd6,1,0,0,0,0,0,1,0,1,0.14285714285714285,1,0.0,0,0,0,0,0,0,0,1,0,0,1,1
5266,186083,vbZxM4TDv9mGZl0HuTBLAdzQ0iLXNnWT,SpATywNh6bZuzm8s1ceuBUnMUAeoAHHw,7,4,2,0,2,0,2,0,10,1.4285714285714286,2,0.0,0,2,0,2,4,0,0,2,0,4,6,1
5267,186122,tzFDwEYPmJ3KvE5ftnVNKM2NcL054uAX,G8EPVSXsOYB5YQWZGiz1aVq5Pgr2GrQu,6,3,1,0,0,1,4,1,10,1.4285714285714286,1,0.0,0,1,0,0,3,1,0,4,1,1,9,1
5268,186142,JozaCp1AeR7tr4bIEFDuRD5emwNjHpcL,SpATywNh6bZuzm8s1ceuBUnMUAeoAHHw,7,4,0,0,0,10,3,0,17,2.4285714285714284,1,0.0,0,0,0,0,4,10,0,3,0,0,17,1
5269,186154,UY0l6TfHASkV3r4lAYBX1Kuh54Mk5Xfi,RXDvfPUBYFlVdlueBFbLW0mhhAyGEqpt,23,33,2,28,5,0,4,0,72,10.285714285714286,2,0.0,10,2,25,5,23,0,3,4,0,42,30,1
5270,186155,Xl8Tem8G8sPah3KAWnbWgv7GNqLZqPFw,RXDvfPUBYFlVdlueBFbLW0mhhAyGEqpt,1,0,0,0,0,0,1,0,1,0.14285714285714285,1,0.0,0,0,0,0,0,0,0,1,0,0,1,1
5271,186156,ujpnoFj9Sccm69HUxcPfoVG6MkkjyaiE,G8EPVSXsOYB5YQWZGiz1aVq5Pgr2GrQu,7,0,0,0,0,14,8,1,23,3.2857142857142856,1,0.0,0,0,0,0,0,14,0,8,1,0,23,0
5272,186158,gHhm2qXabgimtxCoVqwGNu3GtN0RfHoU,G8EPVSXsOYB5YQWZGiz1aVq5Pgr2GrQu,6,2,1,0,1,0,4,0,8,1.1428571428571428,1,0.0,0,1,0,1,2,0,0,4,0,2,6,1
5273,186170,3ULN82Jhvo9A1lCK71PqFv86yozEWjuj,SpATywNh6bZuzm8s1ceuBUnMUAeoAHHw,10,8,5,0,3,0,2,0,18,2.5714285714285716,1,0.0,0,5,0,3,8,0,0,2,0,8,10,1
5274,186194,kQWd08MJREYjLYHoBUU4DknlUSMQ7cCV,SpATywNh6bZuzm8s1ceuBUnMUAeoAHHw,6,4,2,0,2,3,2,0,13,1.8571428571428572,1,0.0,0,2,0,2,4,3,0,2,0,4,9,1
5275,186196,POFpLFsQBaugY3YnnocJIKLsXXkLzRDf,SpATywNh6bZuzm8s1ceuBUnMUAeoAHHw,1,0,0,0,0,0,1,0,1,0.14285714285714285,1,0.0,0,0,0,0,0,0,0,1,0,0,1,1
5276,186198,v6v1hayEEXofBruMyo9TZ2ggXeu5UD3T,A3fsA9Zfv1X2fVEQhTw51lKENdNrEqT3,5,3,1,0,1,0,3,0,8,1.1428571428571428,1,0.0,0,1,0,1,3,0,0,3,0,2,6,1
5277,186211,Zc1PnahT9ISh4c9DBr5jGFkTq2VN1Ayy,G8EPVSXsOYB5YQWZGiz1aVq5Pgr2GrQu,11,14,8,10,3,2,1,0,38,5.428571428571429,1,0.0,5,8,7,3,9,2,3,1,0,23,15,1
5278,186222,vlarE7zCdES78rsfbZ9s0PTdwVr1rAk4,bWdj2GDclj5ofokWjzoa5jAwMkxCykd6,3,3,0,0,0,0,1,0,4,0.5714285714285714,1,0.0,0,0,0,0,3,0,0,1,0,0,4,1
5279,186224,MSWIy7wC5VROeIgPqQIhPQ6v5vOa7TXY,G8EPVSXsOYB5YQWZGiz1aVq5Pgr2GrQu,6,0,0,0,0,1,13,3,17,2.4285714285714284,1,0.0,0,0,0,0,0,1,0,13,3,0,17,1
5280,186246,UY0l6TfHASkV3r4lAYBX1Kuh54Mk5Xfi,A3fsA9Zfv1X2fVEQhTw51lKENdNrEqT3,35,32,1,62,1,0,14,5,115,16.428571428571427,2,0.0,7,1,56,1,25,0,6,14,5,65,50,1
5281,186252,6HmdNYWkOfKPcsSkwkqnh7uY2Gqe1cX7,SpATywNh6bZuzm8s1ceuBUnMUAeoAHHw,5,4,3,0,3,0,2,0,12,1.7142857142857142,2,0.0,0,3,0,3,4,0,0,2,0,6,6,1
5282,186255,vbQsfStPUAntkNJPXL2TWQHB0509Qjr7,A3fsA9Zfv1X2fVEQhTw51lKENdNrEqT3,3,0,0,0,0,0,4,0,4,0.5714285714285714,1,0.0,0,0,0,0,0,0,0,4,0,0,4,1
5283,186266,dehhpoRrM4rg7t676Y7qCiumWRV2WOzS,SpATywNh6bZuzm8s1ceuBUnMUAeoAHHw,1,0,0,0,0,0,1,0,1,0.14285714285714285,1,0.0,0,0,0,0,0,0,0,1,0,0,1,1
5284,186271,XAjd05OrffFBimg6dLsDVkG5Gjsx6XlT,A3fsA9Zfv1X2fVEQhTw51lKENdNrEqT3,1,0,0,0,0,0,1,0,1,0.14285714285714285,1,0.0,0,0,0,0,0,0,0,1,0,0,1,1
5285,186289,rkWpVW2n5cp9IeLZVRLQUrt1dID41LRY,SpATywNh6bZuzm8s1ceuBUnMUAeoAHHw,7,10,6,0,3,0,1,0,20,2.857142857142857,1,0.0,3,6,0,3,7,0,0,1,0,12,8,1
5286,186292,tWw75YIFgGadaRnkyPeGlfSVpk3ysa4L,A3fsA9Zfv1X2fVEQhTw51lKENdNrEqT3,5,3,1,0,1,0,1,0,6,0.8571428571428571,1,0.0,0,1,0,1,3,0,0,1,0,2,4,1
5287,186318,OSHDYiz33FI0tkAswcTI5uxK5gdfibj6,A3fsA9Zfv1X2fVEQhTw51lKENdNrEqT3,3,0,0,0,0,0,3,0,3,0.42857142857142855,1,0.0,0,0,0,0,0,0,0,3,0,0,3,1
5288,186319,8UDPY0GORYpQM3S1dtt5YkG0CDkJUfAi,SpATywNh6bZuzm8s1ceuBUnMUAeoAHHw,8,7,5,0,2,0,2,0,16,2.2857142857142856,1,0.0,0,5,0,2,7,0,0,2,0,7,9,1
5289,186332,SdUI7MFv1cY1lGHTqsLRYstBYRI0xIIR,SpATywNh6bZuzm8s1ceuBUnMUAeoAHHw,13,10,0,18,0,0,5,2,35,5.0,1,0.0,2,0,15,0,8,0,3,5,2,17,18,1
5290,186359,GMzSpgZQ6jzVsfHn8W8i83JsYNxnP00b,RXDvfPUBYFlVdlueBFbLW0mhhAyGEqpt,4,2,1,0,1,0,1,0,5,0.7142857142857143,1,0.0,0,1,0,1,2,0,0,1,0,2,3,1
5291,186375,uQzrox8H38SjXEhLoth5A55QRUWPEK46,G8EPVSXsOYB5YQWZGiz1aVq5Pgr2GrQu,7,4,1,0,1,0,3,0,9,1.2857142857142858,1,0.0,0,1,0,1,4,0,0,3,0,2,7,1
5292,186378,4lhCwJo7yYXKFlssNpVO8DZHuYKFBvLp,A3fsA9Zfv1X2fVEQhTw51lKENdNrEqT3,7,3,2,0,2,6,3,0,16,2.2857142857142856,1,0.0,0,2,0,2,3,6,0,3,0,4,12,1
5293,186398,59oEIRULxWLaLldaaHbqaw4nucIn93k4,G8EPVSXsOYB5YQWZGiz1aVq5Pgr2GrQu,5,2,1,0,1,0,2,0,6,0.8571428571428571,1,0.0,0,1,0,1,2,0,0,2,0,2,4,1
5294,186433,KZqJQBCdtksPSQ3TutEdK8fy0LKI4eut,RXDvfPUBYFlVdlueBFbLW0mhhAyGEqpt,1,0,0,0,0,0,1,0,1,0.14285714285714285,1,0.0,0,0,0,0,0,0,0,1,0,0,1,1
5295,186446,bIezVonf0N1LpjwByS1ltzDSkDe7OlG8,SpATywNh6bZuzm8s1ceuBUnMUAeoAHHw,12,19,10,0,3,1,9,2,44,6.285714285714286,1,0.0,0,10,0,3,19,1,0,9,2,13,31,1
5296,186457,LjhFDdYhdfVWWRFvrc4aNHUi5SD6clAR,bWdj2GDclj5ofokWjzoa5jAwMkxCykd6,4,2,1,0,1,0,1,0,5,0.7142857142857143,1,0.0,0,1,0,1,2,0,0,1,0,2,3,1
5297,186461,qIinMseAcQ8q8AFqNGAlgGp8FqmURvdC,bWdj2GDclj5ofokWjzoa5jAwMkxCykd6,6,3,0,0,0,0,4,0,7,1.0,1,0.0,0,0,0,0,3,0,0,4,0,0,7,1
5298,186471,T7YlTqIDVTZFYEYihxD1Zij5IkDsmVZP,SpATywNh6bZuzm8s1ceuBUnMUAeoAHHw,5,6,3,0,1,0,1,0,11,1.5714285714285714,1,0.0,2,3,0,1,4,0,0,1,0,6,5,1
5299,186475,qsPGhZXTxPpaTY2qxQgCzRxNrBA26TIJ,A3fsA9Zfv1X2fVEQhTw51lKENdNrEqT3,3,1,0,0,0,0,4,0,5,0.7142857142857143,1,0.0,0,0,0,0,1,0,0,4,0,0,5,1
5300,186479,FtIGPSLlLHlXJuNP4CbCwrQzSedZBL0g,SpATywNh6bZuzm8s1ceuBUnMUAeoAHHw,9,9,5,0,3,0,2,0,19,2.7142857142857144,1,0.0,3,5,0,3,6,0,0,2,0,11,8,1
5301,186490,V7rVXKT1jqsQDinfnUz1gk0ep5LdnCQz,SpATywNh6bZuzm8s1ceuBUnMUAeoAHHw,8,2,1,0,1,1,5,1,11,1.5714285714285714,1,0.0,0,1,0,1,2,1,0,5,1,2,9,1
5302,186493,htua1xywlnpsMMY7EJSOsurL86GI912X,bWdj2GDclj5ofokWjzoa5jAwMkxCykd6,3,3,1,0,0,0,1,0,5,0.7142857142857143,1,0.0,0,1,0,0,3,0,0,1,0,1,4,1
5303,186521,4BrXOKatej2Wdv61aLL3SraA7e0yYTLh,SpATywNh6bZuzm8s1ceuBUnMUAeoAHHw,2,0,0,0,0,0,2,0,2,0.2857142857142857,1,0.0,0,0,0,0,0,0,0,2,0,0,2,1
5304,186524,5pfeeYLWSB4wCSWnPZbrmiSBS3yXgMsk,SpATywNh6bZuzm8s1ceuBUnMUAeoAHHw,5,4,0,0,0,0,3,0,7,1.0,1,0.0,0,0,0,0,4,0,0,3,0,0,7,1
5305,186543,bJDihmOTOP8tzchQo3EmXDlLmnZksGMI,SpATywNh6bZuzm8s1ceuBUnMUAeoAHHw,1,0,0,0,0,0,1,0,1,0.14285714285714285,1,0.0,0,0,0,0,0,0,0,1,0,0,1,1
5306,186551,ITnBh4AcTaOdkBvoDVqj5ARkv2J54QTG,SpATywNh6bZuzm8s1ceuBUnMUAeoAHHw,7,2,1,0,1,0,6,1,11,1.5714285714285714,1,0.0,0,1,0,1,2,0,0,6,1,2,9,1
5307,186556,VIptmPegATK5qvvl8OyUabYRGHZdqxvU,SpATywNh6bZuzm8s1ceuBUnMUAeoAHHw,9,4,2,0,2,0,4,1,13,1.8571428571428572,1,0.0,1,2,0,2,3,0,0,4,1,5,8,1
5308,186563,itb7buqF5mtGNemnlGyYA2pmGWssLWjE,SpATywNh6bZuzm8s1ceuBUnMUAeoAHHw,10,6,4,0,3,0,3,0,16,2.2857142857142856,2,0.0,0,4,0,3,6,0,0,3,0,7,9,1
5309,186570,QZIRHdwFgibI2SBehTrmLAZxED1F4JL7,A3fsA9Zfv1X2fVEQhTw51lKENdNrEqT3,14,15,7,0,7,0,1,0,30,4.285714285714286,1,0.0,0,7,0,7,15,0,0,1,0,14,16,1
5310,186572,MYsCU1zkMrWxPhV1b7wSL5LZIo1zGyhU,SpATywNh6bZuzm8s1ceuBUnMUAeoAHHw,1,0,0,0,0,0,1,0,1,0.14285714285714285,1,0.0,0,0,0,0,0,0,0,1,0,0,1,1
5311,186585,4GCFGR3S6zyUaFCN0ANuEVdNqsmLUl3s,SpATywNh6bZuzm8s1ceuBUnMUAeoAHHw,14,43,2,16,0,17,25,3,106,15.142857142857142,2,0.0,14,2,14,0,29,17,2,25,3,30,76,1
5312,186591,ZUogtQULz2GfCq4cni0kVmwpD4O6JuwY,SpATywNh6bZuzm8s1ceuBUnMUAeoAHHw,8,6,1,6,0,0,2,0,15,2.142857142857143,1,0.0,1,1,5,0,5,0,1,2,0,7,8,1
5313,186592,UDgUCnq3QLzgpXlB51yXFWzxVoQqQtdJ,G8EPVSXsOYB5YQWZGiz1aVq5Pgr2GrQu,29,18,15,0,10,0,9,3,55,7.857142857142857,1,0.0,0,15,0,10,18,0,0,9,3,25,30,0
5314,186593,dFhW5phJnKOqlVjNkJknZ8QVATFpUOzD,bWdj2GDclj5ofokWjzoa5jAwMkxCykd6,2,0,0,0,0,0,3,0,3,0.42857142857142855,1,0.0,0,0,0,0,0,0,0,3,0,0,3,1
5315,186596,KZqJQBCdtksPSQ3TutEdK8fy0LKI4eut,bWdj2GDclj5ofokWjzoa5jAwMkxCykd6,1,0,0,0,0,0,1,0,1,0.14285714285714285,1,0.0,0,0,0,0,0,0,0,1,0,0,1,1
5316,186597,KZqJQBCdtksPSQ3TutEdK8fy0LKI4eut,A3fsA9Zfv1X2fVEQhTw51lKENdNrEqT3,1,0,0,0,0,0,1,0,1,0.14285714285714285,1,0.0,0,0,0,0,0,0,0,1,0,0,1,1
5317,186600,RCImAeGNpwksr5OoLexzhMJb9tVjxo1e,SpATywNh6bZuzm8s1ceuBUnMUAeoAHHw,1,0,0,0,0,0,1,0,1,0.14285714285714285,1,0.0,0,0,0,0,0,0,0,1,0,0,1,1
5318,186602,vavfgCcT5IuD68jWJDk0XbOVSfTIDT0M,G8EPVSXsOYB5YQWZGiz1aVq5Pgr2GrQu,7,11,0,0,0,0,6,1,18,2.5714285714285716,1,0.0,0,0,0,0,11,0,0,6,1,0,18,1
5319,186610,BOiGxHn3raRj9eGIKlFjQQHhXEBtSDbh,SpATywNh6bZuzm8s1ceuBUnMUAeoAHHw,2,0,0,0,0,0,2,0,2,0.2857142857142857,1,0.0,0,0,0,0,0,0,0,2,0,0,2,1
5320,186623,OyDMa8JOXSYbsE31qL3fL6emrgq0mwJU,SpATywNh6bZuzm8s1ceuBUnMUAeoAHHw,1,0,0,0,0,0,1,0,1,0.14285714285714285,1,0.0,0,0,0,0,0,0,0,1,0,0,1,1
5321,186635,MZdlzL4gO74etRlgkUDa9eGtQZo9ovTN,SpATywNh6bZuzm8s1ceuBUnMUAeoAHHw,1,0,0,0,0,0,1,0,1,0.14285714285714285,1,0.0,0,0,0,0,0,0,0,1,0,0,1,1
5322,186644,Rv6gVo5TL2yRLbTriDaWEPebl1P4Qs2d,A3fsA9Zfv1X2fVEQhTw51lKENdNrEqT3,1,0,0,0,0,0,1,0,1,0.14285714285714285,1,0.0,0,0,0,0,0,0,0,1,0,0,1,1
5323,186646,EXWNkRXjkZOc8AsQnQXXGYq4K74jND3i,SpATywNh6bZuzm8s1ceuBUnMUAeoAHHw,5,2,1,0,1,0,2,0,6,0.8571428571428571,1,0.0,0,1,0,1,2,0,0,2,0,2,4,1
5324,186650,Rv6gVo5TL2yRLbTriDaWEPebl1P4Qs2d,bWdj2GDclj5ofokWjzoa5jAwMkxCykd6,16,23,9,124,9,0,2,0,167,23.857142857142858,1,0.0,12,9,119,9,11,0,5,2,0,149,18,1
5325,186657,cEMxPdpNr0sg7WlHPqAdbLiWdfHH1ZVi,RXDvfPUBYFlVdlueBFbLW0mhhAyGEqpt,8,5,4,0,2,0,1,0,12,1.7142857142857142,1,0.0,0,4,0,2,5,0,0,1,0,6,6,1
5326,186663,w67bG97cTw7otOM2uWqK71mG1zCn2Z71,RXDvfPUBYFlVdlueBFbLW0mhhAyGEqpt,6,2,1,0,1,0,3,0,7,1.0,1,0.0,1,1,0,1,1,0,0,3,0,3,4,1
5327,186685,NkVQGteS9t3nbfagAzHcxD3mnVkb9mPC,A3fsA9Zfv1X2fVEQhTw51lKENdNrEqT3,35,28,21,64,12,0,7,0,132,18.857142857142858,2,0.0,3,21,56,12,25,0,8,7,0,92,40,1
5328,186707,mnhLxfC9FQKYouYyd3LS1enEfHJfDKsX,G8EPVSXsOYB5YQWZGiz1aVq5Pgr2GrQu,12,12,0,0,0,1,5,0,18,2.5714285714285716,1,0.0,0,0,0,0,12,1,0,5,0,0,18,0
5329,186721,XO4yOVP7eCwBTi6pYIgtRmMh0ft7YdHb,bWdj2GDclj5ofokWjzoa5jAwMkxCykd6,6,4,0,0,0,2,8,0,14,2.0,1,0.0,0,0,0,0,4,2,0,8,0,0,14,1
5330,186759,hHVyNQkfLcybgeO1W2xMmju5SBV0vBkh,A3fsA9Zfv1X2fVEQhTw51lKENdNrEqT3,3,2,0,0,0,0,1,0,3,0.42857142857142855,1,0.0,0,0,0,0,2,0,0,1,0,0,3,1
5331,186789,zaUwSB02aOgiyf49lPt6UjZNYDYC7fjT,A3fsA9Zfv1X2fVEQhTw51lKENdNrEqT3,4,2,0,0,0,0,3,0,5,0.7142857142857143,1,0.0,0,0,0,0,2,0,0,3,0,0,5,1
5332,186792,eREFizdpriB0dfyYOU7lPptHy7Cm4d3g,SpATywNh6bZuzm8s1ceuBUnMUAeoAHHw,4,2,0,0,0,0,2,0,4,0.5714285714285714,1,0.0,0,0,0,0,2,0,0,2,0,0,4,1
5333,186797,Eh8pkmowXyhtJAd3Rq2bSawvaaJrouRd,RXDvfPUBYFlVdlueBFbLW0mhhAyGEqpt,6,5,2,0,1,0,4,0,12,1.7142857142857142,2,0.0,0,2,0,1,5,0,0,4,0,3,9,1
5334,186819,vAnLr8TMB4xrFCa1bt8zTG1qXKp0tpM2,SpATywNh6bZuzm8s1ceuBUnMUAeoAHHw,8,2,2,0,1,0,8,0,13,1.8571428571428572,1,0.0,0,2,0,1,2,0,0,8,0,3,10,1
5335,186845,rztgByxlqb0NHiCkVNMSLs4z23c2EnGy,SpATywNh6bZuzm8s1ceuBUnMUAeoAHHw,6,3,2,0,2,0,1,0,8,1.1428571428571428,1,0.0,0,2,0,2,3,0,0,1,0,4,4,1
5336,186852,h8UWLevhpVfEbcVzC3XxVtErwnEzlHV5,RXDvfPUBYFlVdlueBFbLW0mhhAyGEqpt,1,0,0,0,0,0,1,0,1,0.14285714285714285,1,0.0,0,0,0,0,0,0,0,1,0,0,1,0
5337,186879,f5d2qvzqNcWdC1ycnE8TG7hK2snW07TA,SpATywNh6bZuzm8s1ceuBUnMUAeoAHHw,6,8,5,0,4,0,7,0,24,3.4285714285714284,2,0.0,0,5,0,4,8,0,0,7,0,9,15,1
5338,186886,1Che5WZp8JOnI2bMKJvtmSYY66gIbE1b,SpATywNh6bZuzm8s1ceuBUnMUAeoAHHw,8,6,0,0,0,0,3,0,9,1.2857142857142858,1,0.0,0,0,0,0,6,0,0,3,0,0,9,1
5339,188522,VZRd1DrilkNeD7Ya8MVZCNtIczH3eEMz,G8EPVSXsOYB5YQWZGiz1aVq5Pgr2GrQu,5,2,1,0,1,0,7,0,11,1.5714285714285714,1,0.0,0,1,0,1,2,0,0,7,0,2,9,1
5340,188602,faupOzOQrYnrhUP3CZcXERH5hL8Q3xd2,bWdj2GDclj5ofokWjzoa5jAwMkxCykd6,8,6,2,32,1,3,2,0,46,6.571428571428571,1,0.0,1,2,31,1,5,3,1,2,0,35,11,1
5341,188952,tuXkXzLKLtIRrgeepCbs4ws8aCl66h43,7GRhBDsirIGkRZBtSMEzNTyDr2JQm4xx,34,119,36,50,30,53,17,1,306,43.714285714285715,1,0.0,69,36,39,30,50,53,11,17,1,174,132,1
5342,188957,UcAhBIdVZpMELDlnTcMm9mzDJ1F9Jhg3,7GRhBDsirIGkRZBtSMEzNTyDr2JQm4xx,1,0,0,0,0,0,1,0,1,0.14285714285714285,1,0.0,0,0,0,0,0,0,0,1,0,0,1,1
5343,188980,b9SN0Via9Qc1lw25HlIBgqllvaoVGqZR,7GRhBDsirIGkRZBtSMEzNTyDr2JQm4xx,1,0,0,0,0,0,1,0,1,0.14285714285714285,1,0.0,0,0,0,0,0,0,0,1,0,0,1,1
5344,188988,ljmWZCzWPqv1RXsn1q2wpsQtrnA1zct2,7GRhBDsirIGkRZBtSMEzNTyDr2JQm4xx,6,3,2,0,2,0,1,0,8,1.1428571428571428,1,0.0,0,2,0,2,3,0,0,1,0,4,4,1
5345,188998,kGchkvQPmF7DV3eBhLNc2GVWP2dYDeVK,7GRhBDsirIGkRZBtSMEzNTyDr2JQm4xx,4,2,1,0,1,0,1,0,5,0.7142857142857143,1,0.0,0,1,0,1,2,0,0,1,0,2,3,1
5346,189006,fOtwdZktYnpxoylqFRzXhWQ4IRQZkjMB,7GRhBDsirIGkRZBtSMEzNTyDr2JQm4xx,5,7,2,0,1,0,1,0,11,1.5714285714285714,1,0.0,0,2,0,1,7,0,0,1,0,3,8,1
5347,189008,6sr5fFi7rfC2NnnMJfyjbVZzoXpjJRhH,7GRhBDsirIGkRZBtSMEzNTyDr2JQm4xx,4,1,1,0,0,3,3,0,8,1.1428571428571428,1,0.0,0,1,0,0,1,3,0,3,0,1,7,1
5348,189027,Tb3iSIl4j6IIWQqGXGjvVBDqMgnRJLyl,7GRhBDsirIGkRZBtSMEzNTyDr2JQm4xx,5,7,1,0,2,0,1,0,11,1.5714285714285714,1,0.0,3,1,0,2,4,0,0,1,0,6,5,1
5349,189098,YX2r5oewraL6wIQ6yI9Js4hkHPlQTVjj,7GRhBDsirIGkRZBtSMEzNTyDr2JQm4xx,9,2,1,0,1,1,7,1,13,1.8571428571428572,1,0.0,0,1,0,1,2,1,0,7,1,2,11,1
5350,189104,NumNFW5RaIHDi6n0KLy5Cf1kLDxHgZZ0,G8EPVSXsOYB5YQWZGiz1aVq5Pgr2GrQu,6,4,1,0,0,0,2,0,7,1.0,1,0.0,0,1,0,0,4,0,0,2,0,1,6,1
5351,189107,krtZQqbvUpNsJjcNARYP8JsIRTz2QIeg,7GRhBDsirIGkRZBtSMEzNTyDr2JQm4xx,8,5,2,0,0,3,7,1,18,2.5714285714285716,1,0.0,0,2,0,0,5,3,0,7,1,2,16,1
5352,189109,ejIJpZTu0P4rcWcZmBKl6OiURGceVpiA,7GRhBDsirIGkRZBtSMEzNTyDr2JQm4xx,1,0,0,0,0,0,1,0,1,0.14285714285714285,1,0.0,0,0,0,0,0,0,0,1,0,0,1,1
5353,189110,sYKWdML3lybCcfZ8QzVXzUviXjVArLUH,7GRhBDsirIGkRZBtSMEzNTyDr2JQm4xx,2,0,0,0,0,0,2,0,2,0.2857142857142857,1,0.0,0,0,0,0,0,0,0,2,0,0,2,1
5354,189128,2wo3X72grgQzEbc3L58KSbNxJ33Bf4SU,7GRhBDsirIGkRZBtSMEzNTyDr2JQm4xx,4,2,1,0,1,0,1,0,5,0.7142857142857143,1,0.0,0,1,0,1,2,0,0,1,0,2,3,1
5355,189136,zNtPMkFrc8ewnZZhVeVhVYVOPd8vhwG9,7GRhBDsirIGkRZBtSMEzNTyDr2JQm4xx,13,15,3,34,1,10,6,0,69,9.857142857142858,1,0.0,8,3,26,1,7,10,8,6,0,38,31,1
5356,189162,o1LtNqe9OsdaahKJ5pz4qvaOsnGwGQzD,7GRhBDsirIGkRZBtSMEzNTyDr2JQm4xx,1,0,0,0,0,0,1,0,1,0.14285714285714285,1,0.0,0,0,0,0,0,0,0,1,0,0,1,1
5357,189203,ae9f7NnRGKtEuH4u37koNvJrDj4cou5c,7GRhBDsirIGkRZBtSMEzNTyDr2JQm4xx,13,24,0,0,3,0,9,0,36,5.142857142857143,1,0.0,10,0,0,3,14,0,0,9,0,13,23,1
5358,189221,8BLT2rbjNDvBkr2B6AQHpQ2yNooLf1CU,SpATywNh6bZuzm8s1ceuBUnMUAeoAHHw,12,22,13,18,0,2,3,0,58,8.285714285714286,1,0.0,5,13,15,0,17,2,3,3,0,33,25,1
5359,189324,RHO2J6AKDheXb2vKjeepgmCGgMG6BTYE,7GRhBDsirIGkRZBtSMEzNTyDr2JQm4xx,5,4,1,0,2,0,2,0,9,1.2857142857142858,1,0.0,2,1,0,2,2,0,0,2,0,5,4,1
5360,189353,iNXUknYcsccIKS8GgjuItiXxtSErv2BI,7GRhBDsirIGkRZBtSMEzNTyDr2JQm4xx,1,0,0,0,0,0,1,0,1,0.14285714285714285,1,0.0,0,0,0,0,0,0,0,1,0,0,1,1
5361,189395,aJzfntQTIfp35A305talVl9pd4o3Uf8u,7GRhBDsirIGkRZBtSMEzNTyDr2JQm4xx,1,0,0,0,0,0,1,0,1,0.14285714285714285,1,0.0,0,0,0,0,0,0,0,1,0,0,1,1
5362,189423,XE68NKSR0NgsUmxAP8OC135kqBLzzb9D,7GRhBDsirIGkRZBtSMEzNTyDr2JQm4xx,5,3,2,0,2,0,2,0,9,1.2857142857142858,1,0.0,0,2,0,2,3,0,0,2,0,4,5,1
5363,189429,UqksMVZ1lLvn2u7s6dT9SU5OFeNJnaAy,7GRhBDsirIGkRZBtSMEzNTyDr2JQm4xx,5,3,1,0,1,0,4,0,9,1.2857142857142858,1,0.0,0,1,0,1,3,0,0,4,0,2,7,1
5364,189463,8YAsQsQu6K1gQ9X3j9OO3pg6TTWyhygc,7GRhBDsirIGkRZBtSMEzNTyDr2JQm4xx,5,3,1,0,1,0,2,0,7,1.0,1,0.0,0,1,0,1,3,0,0,2,0,2,5,1
5365,189495,5O6gO2IHLbVMXXDwdapXEnrWY7rrDpQl,7GRhBDsirIGkRZBtSMEzNTyDr2JQm4xx,1,0,0,0,0,0,1,0,1,0.14285714285714285,1,0.0,0,0,0,0,0,0,0,1,0,0,1,1
5366,189513,W44EUSPSAj1fZWLor5hD25joUoQF1Axq,A3fsA9Zfv1X2fVEQhTw51lKENdNrEqT3,9,4,1,0,1,2,8,1,17,2.4285714285714284,1,0.0,0,1,0,1,4,2,0,8,1,2,15,1
5367,189554,7ZT5u11YEDTZhD4NZDPzOcLz6uLhq9Bd,7GRhBDsirIGkRZBtSMEzNTyDr2JQm4xx,1,0,0,0,0,0,1,0,1,0.14285714285714285,1,0.0,0,0,0,0,0,0,0,1,0,0,1,1
5368,189566,UIWPjpONY8VKQTSxeNrHquVi8SXHJ9tU,7GRhBDsirIGkRZBtSMEzNTyDr2JQm4xx,16,20,8,0,6,0,1,0,35,5.0,1,0.0,0,8,0,6,20,0,0,1,0,14,21,1
5369,189570,BRlaUe6oMRYCNox0BajKnWHes3A3ujyM,A3fsA9Zfv1X2fVEQhTw51lKENdNrEqT3,6,4,0,0,0,0,3,0,7,1.0,1,0.0,0,0,0,0,4,0,0,3,0,0,7,1
5370,189597,0vAWgNGUpLVRA2RW70tZzBBxiCN36t8Y,7GRhBDsirIGkRZBtSMEzNTyDr2JQm4xx,8,4,3,0,3,0,1,0,11,1.5714285714285714,1,0.0,0,3,0,3,4,0,0,1,0,6,5,1
5371,189636,JBk9P3H9SpNENMmKz8O8B3au3Kj5XKWF,7GRhBDsirIGkRZBtSMEzNTyDr2JQm4xx,1,0,0,0,0,0,1,0,1,0.14285714285714285,1,0.0,0,0,0,0,0,0,0,1,0,0,1,1
5372,189647,0a9LRwLYq2zam4NcdU9Yh5C7IQvHBC1m,A3fsA9Zfv1X2fVEQhTw51lKENdNrEqT3,1,0,0,0,0,0,1,0,1,0.14285714285714285,1,0.0,0,0,0,0,0,0,0,1,0,0,1,1
5373,189662,AykjJday1wTguij5gx88Emm7vsRmhjsn,7GRhBDsirIGkRZBtSMEzNTyDr2JQm4xx,1,0,0,0,0,0,1,0,1,0.14285714285714285,1,0.0,0,0,0,0,0,0,0,1,0,0,1,1
5374,189702,OyEvoRilpzFxIY7Xkwhpuz3t7yWiHYAD,7GRhBDsirIGkRZBtSMEzNTyDr2JQm4xx,1,0,0,0,0,0,1,0,1,0.14285714285714285,1,0.0,0,0,0,0,0,0,0,1,0,0,1,1
5375,189742,XtbEYUqZcMVM0EiUYCXC2IEORNMWz2mD,7GRhBDsirIGkRZBtSMEzNTyDr2JQm4xx,1,0,0,0,0,0,1,0,1,0.14285714285714285,1,0.0,0,0,0,0,0,0,0,1,0,0,1,1
5376,189788,DFDnEvNaTkvfy3RohV4MJVwGUkEZrUrx,7GRhBDsirIGkRZBtSMEzNTyDr2JQm4xx,2,0,0,0,0,0,2,0,2,0.2857142857142857,1,0.0,0,0,0,0,0,0,0,2,0,0,2,1
5377,189818,Y65j88wkyz5DKML6XOG6DUVrzLQhWfST,7GRhBDsirIGkRZBtSMEzNTyDr2JQm4xx,1,0,0,0,0,0,1,0,1,0.14285714285714285,1,0.0,0,0,0,0,0,0,0,1,0,0,1,1
5378,189830,cfto4CbYTItqNRa3py5uJG0bkzsfzUco,7GRhBDsirIGkRZBtSMEzNTyDr2JQm4xx,1,0,0,0,0,0,1,0,1,0.14285714285714285,1,0.0,0,0,0,0,0,0,0,1,0,0,1,1
5379,189869,mG2HKIW4KvK5MNtCekVvEvxXHT51PCPq,7GRhBDsirIGkRZBtSMEzNTyDr2JQm4xx,6,3,1,0,1,0,2,0,7,1.0,1,0.0,0,1,0,1,3,0,0,2,0,2,5,1
5380,190011,flCkd2hO7iQUUhaB3sp4v9WlXmzkKaLL,7GRhBDsirIGkRZBtSMEzNTyDr2JQm4xx,4,2,1,0,0,6,2,0,11,1.5714285714285714,1,0.0,0,1,0,0,2,6,0,2,0,1,10,1
5381,190081,iNidvGpmnGwj0TQ5PtdizeiguG8bztuW,7GRhBDsirIGkRZBtSMEzNTyDr2JQm4xx,10,10,6,0,5,0,3,0,24,3.4285714285714284,1,0.0,0,6,0,5,10,0,0,3,0,11,13,1
5382,190088,3SVVs5mG0aNsXrE6M2lNU1XqYm152qHm,7GRhBDsirIGkRZBtSMEzNTyDr2JQm4xx,3,2,1,0,0,0,1,0,4,0.5714285714285714,1,0.0,0,1,0,0,2,0,0,1,0,1,3,1
5383,190110,BohRHH2vBIgnEZGZjM3WnHwJbVFmITRG,7GRhBDsirIGkRZBtSMEzNTyDr2JQm4xx,1,0,0,0,0,0,1,0,1,0.14285714285714285,1,0.0,0,0,0,0,0,0,0,1,0,0,1,1
5384,190169,FaHW93yZCBwugzWZBbJAJZvMZt2lRMiJ,7GRhBDsirIGkRZBtSMEzNTyDr2JQm4xx,6,3,0,0,0,0,4,1,8,1.1428571428571428,1,0.0,1,0,0,0,2,0,0,4,1,1,7,1
5385,190190,p7LK5YIYyaPhnePVXdi7X5HGSzcJjL2r,7GRhBDsirIGkRZBtSMEzNTyDr2JQm4xx,1,0,0,0,0,0,1,0,1,0.14285714285714285,1,0.0,0,0,0,0,0,0,0,1,0,0,1,0
5386,190234,snhKj7MALyM2LCqV5sSwFpjNBeCB9QMT,7GRhBDsirIGkRZBtSMEzNTyDr2JQm4xx,4,1,0,0,1,0,2,0,4,0.5714285714285714,1,0.0,0,0,0,1,1,0,0,2,0,1,3,1
5387,190254,AA7aVbrpQJ2zUau6VJLFiC8rutvLHi1m,A3fsA9Zfv1X2fVEQhTw51lKENdNrEqT3,12,20,9,0,0,0,1,0,30,4.285714285714286,1,0.0,0,9,0,0,20,0,0,1,0,9,21,1
5388,190717,bKF5MosBqVKnYq47osSfpVQVg6H93E3y,SpATywNh6bZuzm8s1ceuBUnMUAeoAHHw,11,6,4,0,3,7,10,3,33,4.714285714285714,1,0.0,0,4,0,3,6,7,0,10,3,7,26,0
5389,190734,clv7wTDLUGVcdBnHuGK5igxvVYbUFhfO,A3fsA9Zfv1X2fVEQhTw51lKENdNrEqT3,1,0,0,0,0,0,1,0,1,0.14285714285714285,1,0.0,0,0,0,0,0,0,0,1,0,0,1,1
5390,190737,SqKmRlxZATrsBxFcgKwGzFSyWis0fRul,SpATywNh6bZuzm8s1ceuBUnMUAeoAHHw,12,8,5,0,3,2,6,1,25,3.5714285714285716,1,0.0,2,5,0,3,6,2,0,6,1,10,15,1
5391,190739,FFNnY7di7du4c5wFNDNV6nMH5bqqpuVS,G8EPVSXsOYB5YQWZGiz1aVq5Pgr2GrQu,16,5,5,28,3,1,4,0,46,6.571428571428571,1,0.0,0,5,24,3,5,1,4,4,0,32,14,1
5392,190747,cTeA1f2AYHCTzaLCFeSZpEjefvjGhNJD,G8EPVSXsOYB5YQWZGiz1aVq5Pgr2GrQu,8,8,3,0,2,0,2,0,15,2.142857142857143,1,0.0,3,3,0,2,5,0,0,2,0,8,7,1
5393,190756,wIcAqiIkhVke6PQk1FQ10LQjFUOa268K,bWdj2GDclj5ofokWjzoa5jAwMkxCykd6,1,0,0,0,0,0,1,0,1,0.14285714285714285,1,0.0,0,0,0,0,0,0,0,1,0,0,1,1
5394,190767,ErHRXoQE3PAKpLvIUT0gh504hJR8YxvQ,SpATywNh6bZuzm8s1ceuBUnMUAeoAHHw,1,0,0,0,0,0,1,0,1,0.14285714285714285,1,0.0,0,0,0,0,0,0,0,1,0,0,1,1
5395,190769,FZEwaAUaiR6zemazrUHMMvDLCgHez3sb,A3fsA9Zfv1X2fVEQhTw51lKENdNrEqT3,1,0,0,0,0,0,2,0,2,0.2857142857142857,1,0.0,0,0,0,0,0,0,0,2,0,0,2,1
5396,190774,xClBQDVnnmCO9u08LGuvxGj9xJyOTeqG,SpATywNh6bZuzm8s1ceuBUnMUAeoAHHw,6,3,1,0,1,0,2,0,7,1.0,1,0.0,0,1,0,1,3,0,0,2,0,2,5,1
5397,190775,uf9uxJ0q9fqnk8v2mIZk18f6DfpdKvW8,bWdj2GDclj5ofokWjzoa5jAwMkxCykd6,9,13,5,44,5,0,5,1,73,10.428571428571429,1,0.0,4,5,42,5,9,0,2,5,1,56,17,1
5398,190781,WgwvOVLxVR0cLBIPFfdMgIZsyrXu2dEM,RXDvfPUBYFlVdlueBFbLW0mhhAyGEqpt,10,6,1,0,1,1,11,7,27,3.857142857142857,1,0.0,0,1,0,1,6,1,0,11,7,2,25,1
5399,190794,jImHfNEIObE674KdIbKVj7cCJ4ufqzHJ,A3fsA9Zfv1X2fVEQhTw51lKENdNrEqT3,1,0,0,0,0,0,1,0,1,0.14285714285714285,1,0.0,0,0,0,0,0,0,0,1,0,0,1,1
5400,190795,cHDpTfio4QPhERzYfGBXzFYjVYPP50Cv,SpATywNh6bZuzm8s1ceuBUnMUAeoAHHw,7,5,3,0,2,0,4,0,14,2.0,1,0.0,0,3,0,2,5,0,0,4,0,5,9,1
5401,190797,pHifOW1icP08PuJhI8vGjqOw0aKfYcAe,bWdj2GDclj5ofokWjzoa5jAwMkxCykd6,15,11,6,60,4,6,8,1,96,13.714285714285714,1,0.0,2,6,53,4,9,6,7,8,1,65,31,1
5402,190807,UuSIoFbtQOfzMmWUxokidkbXgJFaHXwx,A3fsA9Zfv1X2fVEQhTw51lKENdNrEqT3,1,0,0,0,0,0,1,0,1,0.14285714285714285,1,0.0,0,0,0,0,0,0,0,1,0,0,1,0
5403,190808,wU9dwS3WWOQY9ZgttcIaOxUTFKpzQrwI,bWdj2GDclj5ofokWjzoa5jAwMkxCykd6,1,0,0,0,0,0,1,0,1,0.14285714285714285,1,0.0,0,0,0,0,0,0,0,1,0,0,1,0
5404,190809,hHLItJoAM7XEkMep3WUdcTboIWoYySm9,SpATywNh6bZuzm8s1ceuBUnMUAeoAHHw,7,5,0,0,0,4,6,1,16,2.2857142857142856,1,0.0,0,0,0,0,5,4,0,6,1,0,16,1
5405,190815,xnAaa3WYxuN7DFkNBugIG5RWGpSS1yS8,bWdj2GDclj5ofokWjzoa5jAwMkxCykd6,1,0,0,0,0,0,1,0,1,0.14285714285714285,1,0.0,0,0,0,0,0,0,0,1,0,0,1,1
5406,190818,uDXojcZmAjRrYpbHg6OiLrdKtE8isYPI,G8EPVSXsOYB5YQWZGiz1aVq5Pgr2GrQu,1,0,0,0,0,0,1,0,1,0.14285714285714285,1,0.0,0,0,0,0,0,0,0,1,0,0,1,1
5407,190822,8pF3cyLxq0AckySwkuwDRCVUkL6fkRLY,SpATywNh6bZuzm8s1ceuBUnMUAeoAHHw,6,2,0,0,0,0,9,0,11,1.5714285714285714,1,0.0,0,0,0,0,2,0,0,9,0,0,11,1
5408,190826,5ae8aSisBHmEo0mgVwdFagGGHfcfDsIo,G8EPVSXsOYB5YQWZGiz1aVq5Pgr2GrQu,1,0,0,0,0,0,1,0,1,0.14285714285714285,1,0.0,0,0,0,0,0,0,0,1,0,0,1,1
5409,190834,PUW0i4IuafllkJEtV0GCqmTDeLHkDmH3,SpATywNh6bZuzm8s1ceuBUnMUAeoAHHw,1,0,0,0,0,0,1,0,1,0.14285714285714285,1,0.0,0,0,0,0,0,0,0,1,0,0,1,1
5410,190852,5FKNtYsTkByroijTHxSZ2wThgqvXV2F5,SpATywNh6bZuzm8s1ceuBUnMUAeoAHHw,4,2,1,0,1,0,1,0,5,0.7142857142857143,1,0.0,0,1,0,1,2,0,0,1,0,2,3,1
5411,190861,HkcPmWCSdk3INCYsquWGQGZKijdTCD0w,A3fsA9Zfv1X2fVEQhTw51lKENdNrEqT3,1,0,0,0,0,0,1,0,1,0.14285714285714285,1,0.0,0,0,0,0,0,0,0,1,0,0,1,1
5412,190883,NtWIu4J0HPOWOANC7ZYns4tsHx1TBJoi,bWdj2GDclj5ofokWjzoa5jAwMkxCykd6,1,0,0,0,0,0,1,0,1,0.14285714285714285,1,0.0,0,0,0,0,0,0,0,1,0,0,1,1
5413,190889,9Yh9BGNzlB70iEC7VABYNXfepXjXz9Ik,RXDvfPUBYFlVdlueBFbLW0mhhAyGEqpt,1,0,0,0,0,0,1,0,1,0.14285714285714285,1,0.0,0,0,0,0,0,0,0,1,0,0,1,1
5414,190895,RJe7xu782OWYH4oamOQryIYQy1schp1L,SpATywNh6bZuzm8s1ceuBUnMUAeoAHHw,14,29,12,16,0,7,6,1,71,10.142857142857142,1,0.0,6,12,14,0,23,7,2,6,1,32,39,1
5415,190903,x71DJUx1l6jseHCehLwk4aITn2PbPyqZ,SpATywNh6bZuzm8s1ceuBUnMUAeoAHHw,5,2,1,0,1,0,2,0,6,0.8571428571428571,1,0.0,0,1,0,1,2,0,0,2,0,2,4,1
5416,190904,vyEmNT9CTTZs1s1eotM7mTmxUqBkMZB7,A3fsA9Zfv1X2fVEQhTw51lKENdNrEqT3,1,0,0,0,0,0,1,0,1,0.14285714285714285,1,0.0,0,0,0,0,0,0,0,1,0,0,1,1
5417,190917,KK8c9Dmj5I63bhg4LxlQHTWu5jCGLVNt,G8EPVSXsOYB5YQWZGiz1aVq5Pgr2GrQu,1,0,0,0,0,0,1,0,1,0.14285714285714285,1,0.0,0,0,0,0,0,0,0,1,0,0,1,1
5418,190947,ok4VFpKhZuAEe6hS0zrBXKoNseBmFZze,SpATywNh6bZuzm8s1ceuBUnMUAeoAHHw,14,22,2,25,0,2,9,1,61,8.714285714285714,2,0.0,4,2,22,0,18,2,3,9,1,28,33,1
5419,190954,WsLtEmeFmoC69MkLWoUcJ9ig36NGyKM9,SpATywNh6bZuzm8s1ceuBUnMUAeoAHHw,6,3,1,0,1,0,2,0,7,1.0,1,0.0,0,1,0,1,3,0,0,2,0,2,5,1
5420,190958,2xUoAPKuvFamkqgtuAisQsHAYFznYGmc,RXDvfPUBYFlVdlueBFbLW0mhhAyGEqpt,21,22,5,31,10,0,4,0,72,10.285714285714286,2,0.0,15,5,28,10,7,0,3,4,0,58,14,0
5421,190967,FENPBJBmeLAdvUkUsPg7akiTSdA52zTP,SpATywNh6bZuzm8s1ceuBUnMUAeoAHHw,7,6,2,0,1,0,3,0,12,1.7142857142857142,1,0.0,1,2,0,1,5,0,0,3,0,4,8,1
5422,190972,iACYFngARHwRlBD1uz8Bwi5b1szxFkra,SpATywNh6bZuzm8s1ceuBUnMUAeoAHHw,8,29,1,0,1,0,5,0,36,5.142857142857143,1,0.0,2,1,0,1,27,0,0,5,0,4,32,1
5423,190977,oaoj9be4jW2Hot8wYgYrzLRvB0RU4KYy,bWdj2GDclj5ofokWjzoa5jAwMkxCykd6,3,2,1,0,0,0,1,0,4,0.5714285714285714,1,0.0,0,1,0,0,2,0,0,1,0,1,3,1
5424,190991,M7fcRt21bsAgtvsrrzEizQkpE9mFW4i5,G8EPVSXsOYB5YQWZGiz1aVq5Pgr2GrQu,1,0,0,0,0,0,2,0,2,0.2857142857142857,1,0.0,0,0,0,0,0,0,0,2,0,0,2,1
5425,191001,nT8w17cJcdO2lsrz7cGSY123lCPnSOcs,SpATywNh6bZuzm8s1ceuBUnMUAeoAHHw,11,11,0,19,0,2,5,2,39,5.571428571428571,1,0.0,4,0,17,0,7,2,2,5,2,21,18,1
5426,191008,HQaEPrkmOsZZRI0w0Zd2GpWW5QsOPUNb,RXDvfPUBYFlVdlueBFbLW0mhhAyGEqpt,7,7,1,0,1,0,5,0,14,2.0,1,0.0,0,1,0,1,7,0,0,5,0,2,12,1
5427,191076,kLjseYEqrk7qJRpdsFaZefvj0uwqDQlm,SpATywNh6bZuzm8s1ceuBUnMUAeoAHHw,1,0,0,0,0,0,1,0,1,0.14285714285714285,1,0.0,0,0,0,0,0,0,0,1,0,0,1,1
5428,191092,arrrU4WiLIpECIetBxOM4AIL8R5yPrJI,SpATywNh6bZuzm8s1ceuBUnMUAeoAHHw,3,0,0,0,0,0,3,0,3,0.42857142857142855,1,0.0,0,0,0,0,0,0,0,3,0,0,3,1
5429,191108,geEAXwfPbJ0MhEZG0COad1UptHNAilTd,A3fsA9Zfv1X2fVEQhTw51lKENdNrEqT3,1,0,0,0,0,0,1,0,1,0.14285714285714285,1,0.0,0,0,0,0,0,0,0,1,0,0,1,1
5430,191177,cd5GtUhUnzyOzoyRaUudZZpk7s0Fqqr1,SpATywNh6bZuzm8s1ceuBUnMUAeoAHHw,2,0,0,0,0,0,2,0,2,0.2857142857142857,1,0.0,0,0,0,0,0,0,0,2,0,0,2,1
5431,191193,5isrCsGh9CKWlpcsbDYSNSmskNZ5RJjk,A3fsA9Zfv1X2fVEQhTw51lKENdNrEqT3,1,0,0,0,0,0,1,0,1,0.14285714285714285,1,0.0,0,0,0,0,0,0,0,1,0,0,1,1
5432,191204,p8HUn53OHQxlBbPvpqicSSSkhMnoLuUk,SpATywNh6bZuzm8s1ceuBUnMUAeoAHHw,1,0,0,0,0,0,1,0,1,0.14285714285714285,1,0.0,0,0,0,0,0,0,0,1,0,0,1,1
5433,191228,kMzMJEHy7fAHiNUZU0um3I2BsPC7gMll,RXDvfPUBYFlVdlueBFbLW0mhhAyGEqpt,1,0,0,0,0,0,1,0,1,0.14285714285714285,1,0.0,0,0,0,0,0,0,0,1,0,0,1,1
5434,191255,2WxDTXrRtDNHrqbb0X9iRKeiD9MDTDVK,SpATywNh6bZuzm8s1ceuBUnMUAeoAHHw,9,25,9,0,0,1,7,0,42,6.0,1,0.0,12,9,0,0,13,1,0,7,0,21,21,1
5435,191284,WgQR6nrfyl7yDpgHC595JSoog2R9VhVs,A3fsA9Zfv1X2fVEQhTw51lKENdNrEqT3,1,0,0,0,0,0,1,0,1,0.14285714285714285,1,0.0,0,0,0,0,0,0,0,1,0,0,1,1
5436,191309,V2MW5TTOl8erA9KB40i6ShoB0MXn3LUC,SpATywNh6bZuzm8s1ceuBUnMUAeoAHHw,5,2,1,0,1,0,4,0,8,1.1428571428571428,1,0.0,0,1,0,1,2,0,0,4,0,2,6,1
5437,191314,GRgjzx7VHY5z0cMezCfvrpSTKqpE3kNZ,SpATywNh6bZuzm8s1ceuBUnMUAeoAHHw,6,5,2,0,2,0,1,0,10,1.4285714285714286,1,0.0,0,2,0,2,5,0,0,1,0,4,6,1
5438,191320,SFvWBN0LUhWN6O8eK5tB1YryzhojhfkD,SpATywNh6bZuzm8s1ceuBUnMUAeoAHHw,1,0,0,0,0,0,1,0,1,0.14285714285714285,1,0.0,0,0,0,0,0,0,0,1,0,0,1,1
5439,191334,iwS4gRr8dUdengK5x37B93sG4oePIfDx,SpATywNh6bZuzm8s1ceuBUnMUAeoAHHw,1,0,0,0,0,0,1,0,1,0.14285714285714285,1,0.0,0,0,0,0,0,0,0,1,0,0,1,1
5440,191346,p6TgFJdLQMaMzbR16kycIPcRPnBj3paK,bWdj2GDclj5ofokWjzoa5jAwMkxCykd6,4,5,1,0,0,0,3,0,9,1.2857142857142858,1,0.0,0,1,0,0,5,0,0,3,0,1,8,1
5441,191365,v0iISMadlSfH1jVtRvOUuiYm96jA1BgF,SpATywNh6bZuzm8s1ceuBUnMUAeoAHHw,3,2,0,0,0,0,1,0,3,0.42857142857142855,1,0.0,0,0,0,0,2,0,0,1,0,0,3,1
5442,191390,T6EWQ7jVP89JlHzj41KN1gEtGYevpSQM,RXDvfPUBYFlVdlueBFbLW0mhhAyGEqpt,1,0,0,0,0,0,1,0,1,0.14285714285714285,1,0.0,0,0,0,0,0,0,0,1,0,0,1,1
5443,191396,kFbAoBQLoBy3cufqfKmpAxdN84jZuyGv,SpATywNh6bZuzm8s1ceuBUnMUAeoAHHw,1,0,0,0,0,0,1,0,1,0.14285714285714285,1,0.0,0,0,0,0,0,0,0,1,0,0,1,1
5444,191399,RknKWTR2QlcaofxNlEIJO86tIh9EMpGt,SpATywNh6bZuzm8s1ceuBUnMUAeoAHHw,6,8,3,0,2,0,2,0,15,2.142857142857143,1,0.0,0,3,0,2,8,0,0,2,0,5,10,1
5445,191400,oB66Su2y0fKCmlftIiys81THD7pT5Kwq,SpATywNh6bZuzm8s1ceuBUnMUAeoAHHw,3,2,0,0,0,0,2,0,4,0.5714285714285714,1,0.0,0,0,0,0,2,0,0,2,0,0,4,1
5446,191418,cBqC4wQ0uum34JxjmDvje145C1HEdpV7,A3fsA9Zfv1X2fVEQhTw51lKENdNrEqT3,1,0,0,0,0,0,1,0,1,0.14285714285714285,1,0.0,0,0,0,0,0,0,0,1,0,0,1,1
5447,191426,if3F5GyFS3tLy1wJ6MlpPAYmdoRWmS4a,G8EPVSXsOYB5YQWZGiz1aVq5Pgr2GrQu,15,9,8,24,6,0,2,0,49,7.0,1,0.0,0,8,19,6,9,0,5,2,0,33,16,1
5448,191428,0g874SF3SMbHGyq5A3NVcdw5ZagrIMLX,A3fsA9Zfv1X2fVEQhTw51lKENdNrEqT3,1,0,0,0,0,0,1,0,1,0.14285714285714285,1,0.0,0,0,0,0,0,0,0,1,0,0,1,1
5449,191439,7k95jHpTPudDL0r9ern1lqZsX7khTblO,SpATywNh6bZuzm8s1ceuBUnMUAeoAHHw,10,3,2,0,2,4,8,2,21,3.0,1,0.0,0,2,0,2,3,4,0,8,2,4,17,1
5450,191470,WmysxkCsgnQj3BaPOZ0U0HkLBTddwtEo,RXDvfPUBYFlVdlueBFbLW0mhhAyGEqpt,18,8,4,15,3,8,10,4,52,7.428571428571429,1,0.0,3,4,15,3,5,8,0,10,4,25,27,1
5451,191474,URsMDmBXxCzQPD8yy0pnaAiUOwpb4Aof,G8EPVSXsOYB5YQWZGiz1aVq5Pgr2GrQu,1,0,0,0,0,0,1,0,1,0.14285714285714285,1,0.0,0,0,0,0,0,0,0,1,0,0,1,1
5452,191485,XFJ68m78eqRR6RTXtGyyLhWYKyJpG8am,SpATywNh6bZuzm8s1ceuBUnMUAeoAHHw,13,20,7,28,3,3,6,0,67,9.571428571428571,1,0.0,7,7,24,3,13,3,4,6,0,41,26,1
5453,191503,wuaIkUodYTr49NZ7BbMPsEdpO0t0C8Nt,bWdj2GDclj5ofokWjzoa5jAwMkxCykd6,1,0,0,0,0,0,1,0,1,0.14285714285714285,1,0.0,0,0,0,0,0,0,0,1,0,0,1,0
5454,191513,8Hc0b25bgfH6lNfQjbdydA9Vr0ij1wAo,RXDvfPUBYFlVdlueBFbLW0mhhAyGEqpt,6,3,2,0,1,0,2,0,8,1.1428571428571428,1,0.0,0,2,0,1,3,0,0,2,0,3,5,1
5455,191520,aQZ3ue6sZAjGbF4xHc1nd423AeIpShr7,SpATywNh6bZuzm8s1ceuBUnMUAeoAHHw,6,1,1,0,0,7,7,2,18,2.5714285714285716,1,0.0,0,1,0,0,1,7,0,7,2,1,17,1
5456,191555,xJg5Rk4cV40ktI4XCqJwerPySa8KdDum,SpATywNh6bZuzm8s1ceuBUnMUAeoAHHw,4,2,0,0,0,0,5,0,7,1.0,1,0.0,0,0,0,0,2,0,0,5,0,0,7,1
5457,191557,H7bZ54NuzkB5Nw5q0ZI1nld9qDoHNngL,RXDvfPUBYFlVdlueBFbLW0mhhAyGEqpt,7,3,2,0,2,0,2,0,9,1.2857142857142858,1,0.0,0,2,0,2,3,0,0,2,0,4,5,0
5458,191558,bxybXAkYqJdxWDLSPlh74sjGoIJub8gI,A3fsA9Zfv1X2fVEQhTw51lKENdNrEqT3,1,0,0,0,0,0,1,0,1,0.14285714285714285,1,0.0,0,0,0,0,0,0,0,1,0,0,1,1
5459,191566,dPo2apv0Dzwh69Z1mYMogRvND7Zqb5Dp,SpATywNh6bZuzm8s1ceuBUnMUAeoAHHw,1,0,0,0,0,0,1,0,1,0.14285714285714285,1,0.0,0,0,0,0,0,0,0,1,0,0,1,1
5460,191595,6VqcRtEStIFn65gZeMiEFRDlkNKCPpuX,SpATywNh6bZuzm8s1ceuBUnMUAeoAHHw,1,0,0,0,0,0,1,0,1,0.14285714285714285,1,0.0,0,0,0,0,0,0,0,1,0,0,1,1
5461,191600,6hpnm3HPpj7kwmlYcJCdnCjcQP3bgA8P,SpATywNh6bZuzm8s1ceuBUnMUAeoAHHw,1,0,0,0,0,0,1,0,1,0.14285714285714285,1,0.0,0,0,0,0,0,0,0,1,0,0,1,1
5462,191609,VRZ45dbdEaezkrEYnjvv0A7uj4TRC509,RXDvfPUBYFlVdlueBFbLW0mhhAyGEqpt,1,0,0,0,0,0,2,0,2,0.2857142857142857,1,0.0,0,0,0,0,0,0,0,2,0,0,2,1
5463,191619,WlHV3frRLxQmTIY14HccRXj4N1zg8F2y,A3fsA9Zfv1X2fVEQhTw51lKENdNrEqT3,1,0,0,0,0,0,1,0,1,0.14285714285714285,1,0.0,0,0,0,0,0,0,0,1,0,0,1,1
5464,191625,WlHV3frRLxQmTIY14HccRXj4N1zg8F2y,SpATywNh6bZuzm8s1ceuBUnMUAeoAHHw,1,0,0,0,0,0,1,0,1,0.14285714285714285,1,0.0,0,0,0,0,0,0,0,1,0,0,1,1
5465,191629,XdXU1POVy8aDaqRsnREruSsMPvgxWetA,A3fsA9Zfv1X2fVEQhTw51lKENdNrEqT3,1,0,0,0,0,0,1,0,1,0.14285714285714285,1,0.0,0,0,0,0,0,0,0,1,0,0,1,0
5466,191655,p04QzukP32kpPk8EGoBhDUGJJQqJUoNz,G8EPVSXsOYB5YQWZGiz1aVq5Pgr2GrQu,1,0,0,0,0,0,2,0,2,0.2857142857142857,1,0.0,0,0,0,0,0,0,0,2,0,0,2,1
5467,191678,vWQfaR79jDjjXdq7DWLb4Yep3Hqk0KZU,SpATywNh6bZuzm8s1ceuBUnMUAeoAHHw,1,0,0,0,0,0,1,0,1,0.14285714285714285,1,0.0,0,0,0,0,0,0,0,1,0,0,1,1
5468,191692,KNNMSW3oLxGqEqv2czanNkhQgdUkOWgY,RXDvfPUBYFlVdlueBFbLW0mhhAyGEqpt,7,6,4,0,1,0,2,0,13,1.8571428571428572,1,0.0,0,4,0,1,6,0,0,2,0,5,8,0
5469,191725,OnbafhawH0rPSL0N5ij1JID10mYyXSki,RXDvfPUBYFlVdlueBFbLW0mhhAyGEqpt,15,23,1,14,1,1,4,0,44,6.285714285714286,1,0.0,3,1,12,1,20,1,2,4,0,17,27,1
5470,191729,N7U6b4ydC4LyBj5GQ1EeCbwlZ2DqZbJ6,bWdj2GDclj5ofokWjzoa5jAwMkxCykd6,5,4,1,0,1,0,4,0,10,1.4285714285714286,1,0.0,0,1,0,1,4,0,0,4,0,2,8,1
5471,191733,dZqFLbQhzRGv0XrnoR6Btyn7eZPLWNcs,G8EPVSXsOYB5YQWZGiz1aVq5Pgr2GrQu,5,3,1,0,1,0,1,0,6,0.8571428571428571,1,0.0,0,1,0,1,3,0,0,1,0,2,4,1
5472,191735,qwG1GCNkwhgE1heJRoYjfA2CYeRyFFBD,SpATywNh6bZuzm8s1ceuBUnMUAeoAHHw,5,2,1,0,1,0,2,0,6,0.8571428571428571,1,0.0,0,1,0,1,2,0,0,2,0,2,4,1
5473,191740,0A6FjHxqeczBpR079Zm0ynsuWpteOCkO,A3fsA9Zfv1X2fVEQhTw51lKENdNrEqT3,1,0,0,0,0,0,1,0,1,0.14285714285714285,1,0.0,0,0,0,0,0,0,0,1,0,0,1,1
5474,191744,ifBHT3U3Q2vZ9dQs2fpRYsiXqMAEWHBB,SpATywNh6bZuzm8s1ceuBUnMUAeoAHHw,1,0,0,0,0,0,1,0,1,0.14285714285714285,1,0.0,0,0,0,0,0,0,0,1,0,0,1,1
5475,191751,inFcOljKYTbAioEZelr7FOpytUh6Wwwm,A3fsA9Zfv1X2fVEQhTw51lKENdNrEqT3,1,0,0,0,0,0,2,0,2,0.2857142857142857,1,0.0,0,0,0,0,0,0,0,2,0,0,2,1
5476,191755,BgRqBvDqiEwBpSmGhgFl2BztVgNMTQzO,SpATywNh6bZuzm8s1ceuBUnMUAeoAHHw,5,5,1,2,0,0,1,0,9,1.2857142857142858,1,0.0,1,1,2,0,4,0,0,1,0,4,5,1
5477,191758,RpI9z3V0AgaYDbaVWpv7K8qBLot9xbZ1,SpATywNh6bZuzm8s1ceuBUnMUAeoAHHw,2,0,0,0,0,2,1,0,3,0.42857142857142855,1,0.0,0,0,0,0,0,2,0,1,0,0,3,1
5478,191784,yPgZKtTbqfPKTL2LU9Q3PsQCk4gWnK9n,bWdj2GDclj5ofokWjzoa5jAwMkxCykd6,2,0,0,0,0,0,2,0,2,0.2857142857142857,1,0.0,0,0,0,0,0,0,0,2,0,0,2,1
5479,191792,kmiB7WIX79F3dncKlftv8WHURaepCY2a,G8EPVSXsOYB5YQWZGiz1aVq5Pgr2GrQu,5,3,1,0,1,0,1,0,6,0.8571428571428571,1,0.0,0,1,0,1,3,0,0,1,0,2,4,1
5480,191795,I4TQ7Q1utfRs4sHagyenl8ox4pkFBHHE,bWdj2GDclj5ofokWjzoa5jAwMkxCykd6,2,0,0,0,0,0,2,0,2,0.2857142857142857,1,0.0,0,0,0,0,0,0,0,2,0,0,2,1
5481,191796,HsUrz2Tvq8sRzoPDsx1zZZFVKu21a9Fj,bWdj2GDclj5ofokWjzoa5jAwMkxCykd6,1,0,0,0,0,0,1,0,1,0.14285714285714285,1,0.0,0,0,0,0,0,0,0,1,0,0,1,1
5482,191809,RkMMgfrDoCy0k6xciXBqfQqum2o9XEow,A3fsA9Zfv1X2fVEQhTw51lKENdNrEqT3,1,0,0,0,0,0,1,0,1,0.14285714285714285,1,0.0,0,0,0,0,0,0,0,1,0,0,1,1
5483,191820,GPXoKOYBnmTprrhcUmupBdNFpJRyodal,G8EPVSXsOYB5YQWZGiz1aVq5Pgr2GrQu,8,7,2,0,2,0,4,0,15,2.142857142857143,1,0.0,4,2,0,2,3,0,0,4,0,8,7,1
5484,191826,apfvYM10NU1k5W582bvs0kUbUD2jx0Pf,SpATywNh6bZuzm8s1ceuBUnMUAeoAHHw,1,0,0,0,0,0,2,0,2,0.2857142857142857,1,0.0,0,0,0,0,0,0,0,2,0,0,2,1
5485,191827,hMmMWG2mCSPmBVJCfg0hTnXWgrWTXDtT,bWdj2GDclj5ofokWjzoa5jAwMkxCykd6,1,0,0,0,0,0,1,0,1,0.14285714285714285,1,0.0,0,0,0,0,0,0,0,1,0,0,1,1
5486,191837,Fq5B003Bt4YEeqhrth8SMHf096RbzYAO,SpATywNh6bZuzm8s1ceuBUnMUAeoAHHw,16,16,4,16,3,0,6,1,46,6.571428571428571,1,0.0,11,4,14,3,5,0,2,6,1,32,14,1
5487,191840,bR8wdPBdFHSsMQ5cBBQOeSecEHoEdU3R,SpATywNh6bZuzm8s1ceuBUnMUAeoAHHw,1,0,0,0,0,0,1,0,1,0.14285714285714285,1,0.0,0,0,0,0,0,0,0,1,0,0,1,1
5488,191850,eRPwUTqaIsUryY9jPBGa7k7RWRZnrrvU,A3fsA9Zfv1X2fVEQhTw51lKENdNrEqT3,1,0,0,0,0,0,1,0,1,0.14285714285714285,1,0.0,0,0,0,0,0,0,0,1,0,0,1,1
5489,191861,AdLAJ2czvUY9AyeUk5B4rn58TrqeeWxO,RXDvfPUBYFlVdlueBFbLW0mhhAyGEqpt,1,0,0,0,0,0,1,0,1,0.14285714285714285,1,0.0,0,0,0,0,0,0,0,1,0,0,1,1
5490,191865,XVfEU97madT1zlAJ4ceeVrr8RhA7IGa2,SpATywNh6bZuzm8s1ceuBUnMUAeoAHHw,5,3,1,0,1,0,1,0,6,0.8571428571428571,1,0.0,0,1,0,1,3,0,0,1,0,2,4,1
5491,191889,kvp7nv1Fk7hbG5ZfWGkJtc8xaumUx9u9,bWdj2GDclj5ofokWjzoa5jAwMkxCykd6,5,6,1,0,2,0,2,0,11,1.5714285714285714,1,0.0,2,1,0,2,4,0,0,2,0,5,6,1
5492,191891,lej2dE7o05DOz003uw82zCNwZA2EHApG,SpATywNh6bZuzm8s1ceuBUnMUAeoAHHw,6,0,0,0,0,1,12,1,14,2.0,1,0.0,0,0,0,0,0,1,0,12,1,0,14,1
5493,191926,3h1FKqVdnDmZ3yTfOEvfGnfVX1CtMfQe,SpATywNh6bZuzm8s1ceuBUnMUAeoAHHw,4,2,1,0,1,0,1,0,5,0.7142857142857143,1,0.0,0,1,0,1,2,0,0,1,0,2,3,1
5494,191941,P7vHBcOeIbOXFo3TPWP2lDcTM83EhGeU,bWdj2GDclj5ofokWjzoa5jAwMkxCykd6,1,0,0,0,0,0,4,0,4,0.5714285714285714,1,0.0,0,0,0,0,0,0,0,4,0,0,4,1
5495,191955,BoMnQ757r2rWyLplEG42Z5wOai4BClQl,SpATywNh6bZuzm8s1ceuBUnMUAeoAHHw,5,2,1,0,1,0,2,0,6,0.8571428571428571,1,0.0,0,1,0,1,2,0,0,2,0,2,4,1
5496,191956,Rb4RoMnOmkTH16vQxR6FJxXkteFqMsSl,SpATywNh6bZuzm8s1ceuBUnMUAeoAHHw,5,2,1,0,1,0,3,0,7,1.0,1,0.0,0,1,0,1,2,0,0,3,0,2,5,1
5497,191985,IN6qMq7COdhsPUWIeIwbfkPbP9c7KKGp,A3fsA9Zfv1X2fVEQhTw51lKENdNrEqT3,1,0,0,0,0,0,1,0,1,0.14285714285714285,1,0.0,0,0,0,0,0,0,0,1,0,0,1,1
5498,191989,WFLWEfQrQsuFMQB4h1DfinKxHOxaJgRw,SpATywNh6bZuzm8s1ceuBUnMUAeoAHHw,1,0,0,0,0,0,1,0,1,0.14285714285714285,1,0.0,0,0,0,0,0,0,0,1,0,0,1,1
5499,192026,Efh1AOucFRD20ZMCFA52VPOCblceahzE,SpATywNh6bZuzm8s1ceuBUnMUAeoAHHw,13,25,12,23,7,0,4,0,71,10.142857142857142,1,0.0,10,12,19,7,15,0,4,4,0,48,23,1
5500,192041,XMT1fxCKn20PfgVrzu92ZEp8ge6Hh1C8,SpATywNh6bZuzm8s1ceuBUnMUAeoAHHw,1,0,0,0,0,0,2,0,2,0.2857142857142857,1,0.0,0,0,0,0,0,0,0,2,0,0,2,1
5501,192045,dMRYTOUYlQ9p1SCjA1w6Lggb6GRAcl7F,SpATywNh6bZuzm8s1ceuBUnMUAeoAHHw,1,0,0,0,0,0,2,0,2,0.2857142857142857,1,0.0,0,0,0,0,0,0,0,2,0,0,2,1
5502,192054,AFTEQHbalt54u0CSOEb5Gff5gtuUeG8b,SpATywNh6bZuzm8s1ceuBUnMUAeoAHHw,6,2,1,0,1,0,3,0,7,1.0,1,0.0,0,1,0,1,2,0,0,3,0,2,5,1
5503,192061,uTVTksRdwbB07oR2uLGlNMnBpRxCQAXg,SpATywNh6bZuzm8s1ceuBUnMUAeoAHHw,3,5,1,0,0,0,1,0,7,1.0,1,0.0,0,1,0,0,5,0,0,1,0,1,6,1
5504,192077,vsDIa2pTzMsANsuFnkRlfs0CNdNFRShO,A3fsA9Zfv1X2fVEQhTw51lKENdNrEqT3,1,0,0,0,0,0,1,0,1,0.14285714285714285,1,0.0,0,0,0,0,0,0,0,1,0,0,1,1
5505,192094,1JKF7DnCOdaXTBELvpKByyY2uKECcREV,A3fsA9Zfv1X2fVEQhTw51lKENdNrEqT3,1,0,0,0,0,0,1,0,1,0.14285714285714285,1,0.0,0,0,0,0,0,0,0,1,0,0,1,1
5506,192104,Dk2p6h1MYjykCuVHQMak8GN098n0FvGH,SpATywNh6bZuzm8s1ceuBUnMUAeoAHHw,10,13,3,10,0,2,3,0,31,4.428571428571429,1,0.0,2,3,8,0,11,2,2,3,0,13,18,1
5507,192115,ROeS4r0zXNXDfvEicSssoPyhkNCzHO0O,SpATywNh6bZuzm8s1ceuBUnMUAeoAHHw,6,3,2,0,2,0,5,0,12,1.7142857142857142,1,0.0,0,2,0,2,3,0,0,5,0,4,8,1
5508,192133,ItSWWp12ZmgzUSMzIbnzpzxw5V6GCE6O,SpATywNh6bZuzm8s1ceuBUnMUAeoAHHw,8,2,1,0,1,2,4,2,12,1.7142857142857142,1,0.0,0,1,0,1,2,2,0,4,2,2,10,1
5509,192137,VYiSBPiiJFjQtdS8d7Gp4hibwyjeIeC0,G8EPVSXsOYB5YQWZGiz1aVq5Pgr2GrQu,9,2,0,0,0,1,14,2,19,2.7142857142857144,1,0.0,0,0,0,0,2,1,0,14,2,0,19,1
5510,192146,luNGlNTmJ26UVXohAPNf4yZNgIUDcpxK,G8EPVSXsOYB5YQWZGiz1aVq5Pgr2GrQu,1,0,0,0,0,0,1,0,1,0.14285714285714285,1,0.0,0,0,0,0,0,0,0,1,0,0,1,1
5511,192154,D0xF5k3pRFZOFsh7BuEa1nD61TTGPmxo,SpATywNh6bZuzm8s1ceuBUnMUAeoAHHw,6,4,2,0,1,2,4,0,13,1.8571428571428572,2,0.0,0,2,0,1,4,2,0,4,0,3,10,1
5512,192163,12jrpDfrACe14hfSyU7dlcaDb6lV0AX7,SpATywNh6bZuzm8s1ceuBUnMUAeoAHHw,6,3,1,0,1,0,2,0,7,1.0,1,0.0,0,1,0,1,3,0,0,2,0,2,5,1
5513,192173,ezgBG4pn9egd5PGuIQdeghPmBuYsQq9O,bWdj2GDclj5ofokWjzoa5jAwMkxCykd6,2,0,0,0,0,0,3,0,3,0.42857142857142855,1,0.0,0,0,0,0,0,0,0,3,0,0,3,1
5514,192174,gdWcAsoLOdR54U3HxoDgKlKnKUBV7xCX,G8EPVSXsOYB5YQWZGiz1aVq5Pgr2GrQu,5,7,2,0,2,0,2,0,13,1.8571428571428572,1,0.0,2,2,0,2,5,0,0,2,0,6,7,1
5515,192180,3bqYNHEttQnrSXCOjNHPi8cuvQEsNCSU,SpATywNh6bZuzm8s1ceuBUnMUAeoAHHw,16,17,9,17,7,4,6,1,61,8.714285714285714,2,0.0,4,9,14,7,13,4,3,6,1,34,27,1
5516,192182,Zn2WcWGw1Iq8LSMueWFynbJxp3D9ATzp,bWdj2GDclj5ofokWjzoa5jAwMkxCykd6,6,3,2,0,2,0,1,0,8,1.1428571428571428,1,0.0,0,2,0,2,3,0,0,1,0,4,4,1
5517,192202,4WRiJt7yDLRdAnLXyL07imUb9PD066er,G8EPVSXsOYB5YQWZGiz1aVq5Pgr2GrQu,10,3,2,0,2,0,8,2,17,2.4285714285714284,2,0.0,0,2,0,2,3,0,0,8,2,4,13,1
5518,192212,FCG6YWuKaaz2zD1Uj2uT7JnTQhXHO8IA,SpATywNh6bZuzm8s1ceuBUnMUAeoAHHw,7,12,1,0,1,0,3,0,17,2.4285714285714284,1,0.0,0,1,0,1,12,0,0,3,0,2,15,1
5519,192235,fB1Ln4rTpVlSNSwZArMTX9xX5MOVzyer,SpATywNh6bZuzm8s1ceuBUnMUAeoAHHw,7,3,2,0,2,0,3,0,10,1.4285714285714286,1,0.0,0,2,0,2,3,0,0,3,0,4,6,1
5520,192244,43uMTKmmKD0ZGUfjI6gHffJ1F3eBB7HV,SpATywNh6bZuzm8s1ceuBUnMUAeoAHHw,12,10,5,11,3,0,2,0,31,4.428571428571429,1,0.0,3,5,10,3,7,0,1,2,0,21,10,1
5521,192255,NqQoXS07qNtJAkIAmOpEhw2wLcRnmrrU,SpATywNh6bZuzm8s1ceuBUnMUAeoAHHw,4,3,1,0,0,0,1,0,5,0.7142857142857143,1,0.0,0,1,0,0,3,0,0,1,0,1,4,1
5522,192264,WnUfGeFilK9N1GtlbmsLVr7aEjsrhuHu,SpATywNh6bZuzm8s1ceuBUnMUAeoAHHw,5,3,1,0,1,0,2,0,7,1.0,1,0.0,0,1,0,1,3,0,0,2,0,2,5,1
5523,192277,MExPU9M982R5ikM7jDJpvEjyfJ2HFRXK,G8EPVSXsOYB5YQWZGiz1aVq5Pgr2GrQu,1,0,0,0,0,0,2,0,2,0.2857142857142857,1,0.0,0,0,0,0,0,0,0,2,0,0,2,1
5524,192288,8ZHyO9qRnMfYwp3tP7QulKpzu10sbQSr,A3fsA9Zfv1X2fVEQhTw51lKENdNrEqT3,1,0,0,0,0,0,1,0,1,0.14285714285714285,1,0.0,0,0,0,0,0,0,0,1,0,0,1,1
5525,192289,a7ccLvSmzFTDxQ153X5LPl9qw8dtjwJS,bWdj2GDclj5ofokWjzoa5jAwMkxCykd6,1,0,0,0,0,0,1,0,1,0.14285714285714285,1,0.0,0,0,0,0,0,0,0,1,0,0,1,1
5526,192291,u5ObOMoHUcvVsOQTGkiv0BRKKcn8v2w8,SpATywNh6bZuzm8s1ceuBUnMUAeoAHHw,5,5,4,0,2,0,1,0,12,1.7142857142857142,1,0.0,0,4,0,2,5,0,0,1,0,6,6,1
5527,192315,eGRaiLXqwboqQlaTTQYr1FB1cM61jV4I,A3fsA9Zfv1X2fVEQhTw51lKENdNrEqT3,1,0,0,0,0,0,1,0,1,0.14285714285714285,1,0.0,0,0,0,0,0,0,0,1,0,0,1,1
5528,192324,cHLNWYCLO1WUu673oiGBHY06ztWWlBMP,bWdj2GDclj5ofokWjzoa5jAwMkxCykd6,1,0,0,0,0,0,1,0,1,0.14285714285714285,1,0.0,0,0,0,0,0,0,0,1,0,0,1,1
5529,192327,ZW8MI4gpXd8J54W8a3uuPTjmv3mJCgoT,G8EPVSXsOYB5YQWZGiz1aVq5Pgr2GrQu,2,0,0,0,0,0,2,0,2,0.2857142857142857,1,0.0,0,0,0,0,0,0,0,2,0,0,2,1
5530,192367,cBgZxnbCWuxd2FofXugFoDh4OfmFe8dT,bWdj2GDclj5ofokWjzoa5jAwMkxCykd6,5,2,1,0,1,0,2,0,6,0.8571428571428571,1,0.0,0,1,0,1,2,0,0,2,0,2,4,1
5531,192372,shnL5ct8qob4HtqjYuzsqQN09ccan9RZ,bWdj2GDclj5ofokWjzoa5jAwMkxCykd6,4,5,1,0,2,0,4,0,12,1.7142857142857142,1,0.0,2,1,0,2,3,0,0,4,0,5,7,1
5532,192374,ooAUGXFOFAguQ9s1QlStBjM610gDeFBk,A3fsA9Zfv1X2fVEQhTw51lKENdNrEqT3,1,0,0,0,0,0,1,0,1,0.14285714285714285,1,0.0,0,0,0,0,0,0,0,1,0,0,1,1
5533,192378,0Tg2flbTUdD7fODqYIfpiJiK0IDdFiOP,G8EPVSXsOYB5YQWZGiz1aVq5Pgr2GrQu,7,6,1,0,0,0,9,2,18,2.5714285714285716,1,0.0,0,1,0,0,6,0,0,9,2,1,17,1
5534,192390,xWEkYGAfNptAwZnPYzVBCVMgcZk3qKaB,SpATywNh6bZuzm8s1ceuBUnMUAeoAHHw,9,15,0,0,0,0,4,0,19,2.7142857142857144,2,0.0,1,0,0,0,14,0,0,4,0,1,18,0
5535,192412,31BGhLl5fMPdcRk1AZsl6rdwMvdi9CfF,SpATywNh6bZuzm8s1ceuBUnMUAeoAHHw,7,6,5,0,5,0,2,0,18,2.5714285714285716,1,0.0,0,5,0,5,6,0,0,2,0,10,8,1
5536,192416,2aLPbnt4moA8gfuPTpLKAlOHQIQiYuAh,SpATywNh6bZuzm8s1ceuBUnMUAeoAHHw,9,4,3,0,3,0,2,0,12,1.7142857142857142,1,0.0,0,3,0,3,4,0,0,2,0,6,6,1
5537,192423,6ZFGnTjh94PbXkR7sbTLWokikXbcLQlV,SpATywNh6bZuzm8s1ceuBUnMUAeoAHHw,1,0,0,0,0,0,1,0,1,0.14285714285714285,1,0.0,0,0,0,0,0,0,0,1,0,0,1,1
5538,192429,9LhQI6E10btWpLjiUrRwj3MG72TIQ74Y,SpATywNh6bZuzm8s1ceuBUnMUAeoAHHw,7,2,0,0,0,1,5,2,10,1.4285714285714286,1,0.0,0,0,0,0,2,1,0,5,2,0,10,1
5539,192436,xHQ7Ypd5S1OzYjBAcoZTGl29nW3kI889,SpATywNh6bZuzm8s1ceuBUnMUAeoAHHw,9,15,9,0,4,4,7,1,40,5.714285714285714,1,0.0,2,9,0,4,13,4,0,7,1,15,25,1
5540,192454,2o2Mu0kizqtKfAG0EeAIvXT3SodGLvCM,A3fsA9Zfv1X2fVEQhTw51lKENdNrEqT3,1,0,0,0,0,0,2,0,2,0.2857142857142857,1,0.0,0,0,0,0,0,0,0,2,0,0,2,1
5541,192457,2o2Mu0kizqtKfAG0EeAIvXT3SodGLvCM,bWdj2GDclj5ofokWjzoa5jAwMkxCykd6,1,0,0,0,0,0,1,0,1,0.14285714285714285,1,0.0,0,0,0,0,0,0,0,1,0,0,1,1
5542,192458,3h1zqwMTeQWdhoWHPgvllPWyD6P0qFtr,A3fsA9Zfv1X2fVEQhTw51lKENdNrEqT3,2,0,0,0,0,0,2,0,2,0.2857142857142857,2,0.0,0,0,0,0,0,0,0,2,0,0,2,1
5543,193755,nKyehpqCzFKe7AQ0H2jeEWUcUDLPIpGO,SpATywNh6bZuzm8s1ceuBUnMUAeoAHHw,4,2,1,0,1,0,1,0,5,0.7142857142857143,1,0.0,0,1,0,1,2,0,0,1,0,2,3,1
5544,194249,pYpEHiiN5hrwCDFMKyLxLiOaj9mHQ7GD,SpATywNh6bZuzm8s1ceuBUnMUAeoAHHw,8,10,3,0,2,0,3,0,18,2.5714285714285716,1,0.0,0,3,0,2,10,0,0,3,0,5,13,1
5545,194505,j5jVj2bcu5kXIDJr17WzWDRjLxNGLUuO,SpATywNh6bZuzm8s1ceuBUnMUAeoAHHw,11,9,1,3,0,0,2,0,15,2.142857142857143,1,0.0,2,1,3,0,7,0,0,2,0,6,9,1
5546,194513,0SWFrShD2Nk1V8wWNIvbhD4Wg61qxonB,SpATywNh6bZuzm8s1ceuBUnMUAeoAHHw,4,2,0,0,1,0,2,0,5,0.7142857142857143,1,0.0,1,0,0,1,1,0,0,2,0,2,3,1
5547,194532,K5Sy6doI03r5uctdEcvObhW1bpzNGROt,SpATywNh6bZuzm8s1ceuBUnMUAeoAHHw,1,0,0,0,0,0,1,0,1,0.14285714285714285,1,0.0,0,0,0,0,0,0,0,1,0,0,1,1
5548,194537,H3KvIatiAwzsCPQBVABALz431TkTR6tW,A3fsA9Zfv1X2fVEQhTw51lKENdNrEqT3,5,4,0,0,0,0,3,0,7,1.0,1,0.0,0,0,0,0,4,0,0,3,0,0,7,1
5549,194547,CBNFR2yvlMJ76Qf0H5A5aLcRXIsTpjTt,A3fsA9Zfv1X2fVEQhTw51lKENdNrEqT3,8,2,1,0,1,0,6,0,10,1.4285714285714286,1,0.0,0,1,0,1,2,0,0,6,0,2,8,1
5550,194559,AZZvRPcRkLSa6vwofzfwsEULTUhiKy0E,bWdj2GDclj5ofokWjzoa5jAwMkxCykd6,1,0,0,0,0,0,1,0,1,0.14285714285714285,1,0.0,0,0,0,0,0,0,0,1,0,0,1,1
5551,194561,n5wUv34AuAx6Xa4DLYxEIV5L4Btui37s,SpATywNh6bZuzm8s1ceuBUnMUAeoAHHw,3,2,0,0,0,0,2,0,4,0.5714285714285714,1,0.0,0,0,0,0,2,0,0,2,0,0,4,1
5552,194575,0a9LRwLYq2zam4NcdU9Yh5C7IQvHBC1m,bWdj2GDclj5ofokWjzoa5jAwMkxCykd6,1,0,0,0,0,0,2,0,2,0.2857142857142857,1,0.0,0,0,0,0,0,0,0,2,0,0,2,0
5553,194594,GzXqA08hGJ8jcoopZQLhcubV2m4jl8LU,SpATywNh6bZuzm8s1ceuBUnMUAeoAHHw,8,7,3,0,0,1,8,1,20,2.857142857142857,1,0.0,0,3,0,0,7,1,0,8,1,3,17,1
5554,194598,fQCBMBoRMdmYhgrCFbeJRBZ7kML0GboZ,SpATywNh6bZuzm8s1ceuBUnMUAeoAHHw,10,6,5,0,4,0,2,0,17,2.4285714285714284,1,0.0,0,5,0,4,6,0,0,2,0,9,8,1
5555,194605,L7tS5WxhPVvFnR9bkUR4sVMKwjpwOVxP,bWdj2GDclj5ofokWjzoa5jAwMkxCykd6,6,11,1,0,1,0,5,0,18,2.5714285714285716,1,0.0,0,1,0,1,11,0,0,5,0,2,16,1
5556,194612,QbCiNdlMyqDCsAbTGmu0rgI2d2IPTQYV,SpATywNh6bZuzm8s1ceuBUnMUAeoAHHw,1,0,0,0,0,0,1,0,1,0.14285714285714285,1,0.0,0,0,0,0,0,0,0,1,0,0,1,1
5557,194616,0RzZnN2VlQfnUgC4UWcMDxWp2iZsqlCl,SpATywNh6bZuzm8s1ceuBUnMUAeoAHHw,9,6,3,0,1,2,7,1,20,2.857142857142857,1,0.0,0,3,0,1,6,2,0,7,1,4,16,1
5558,194620,aZ7bXLhm88jb64CpmaMPaGfxwPdIjnoI,SpATywNh6bZuzm8s1ceuBUnMUAeoAHHw,2,0,0,0,0,0,2,0,2,0.2857142857142857,1,0.0,0,0,0,0,0,0,0,2,0,0,2,1
5559,194660,6S42i3UQWxx5Vy8tElcT4nwPzZzrdR85,SpATywNh6bZuzm8s1ceuBUnMUAeoAHHw,2,0,0,0,0,0,2,0,2,0.2857142857142857,1,0.0,0,0,0,0,0,0,0,2,0,0,2,1
5560,194671,HPJrmwivOMEDkgdyN7JDkONun7b8CtmQ,SpATywNh6bZuzm8s1ceuBUnMUAeoAHHw,5,3,1,0,1,0,1,0,6,0.8571428571428571,1,0.0,0,1,0,1,3,0,0,1,0,2,4,1
5561,194673,4sHw1UrsiyaJNXlPeVCwFs89kPI7rFXb,SpATywNh6bZuzm8s1ceuBUnMUAeoAHHw,10,8,2,0,2,0,5,1,18,2.5714285714285716,1,0.0,5,2,0,2,3,0,0,5,1,9,9,1
5562,194682,fOtwdZktYnpxoylqFRzXhWQ4IRQZkjMB,A3fsA9Zfv1X2fVEQhTw51lKENdNrEqT3,7,3,2,0,2,0,2,0,9,1.2857142857142858,1,0.0,0,2,0,2,3,0,0,2,0,4,5,1
5563,194683,BoPqpHAIR2FQ1yjN5I6jPiYn67RLyUD3,A3fsA9Zfv1X2fVEQhTw51lKENdNrEqT3,3,2,0,0,0,0,1,0,3,0.42857142857142855,1,0.0,0,0,0,0,2,0,0,1,0,0,3,1
5564,194687,zeGNUT3jrsWIuoEonUpuQekYC6uAy3VD,SpATywNh6bZuzm8s1ceuBUnMUAeoAHHw,10,17,5,0,3,0,2,0,27,3.857142857142857,1,0.0,11,5,0,3,6,0,0,2,0,19,8,1
5565,194689,jWHZ4vPCIn46Q1yqOYKTzhu7yXXPh48K,SpATywNh6bZuzm8s1ceuBUnMUAeoAHHw,4,2,1,0,1,0,1,0,5,0.7142857142857143,1,0.0,0,1,0,1,2,0,0,1,0,2,3,1
5566,194700,UV3gRhbCQYEkFRwtzHQKR8Uz1PLcy3Cv,A3fsA9Zfv1X2fVEQhTw51lKENdNrEqT3,9,3,2,0,2,0,6,1,14,2.0,1,0.0,0,2,0,2,3,0,0,6,1,4,10,1
5567,194704,aBLoyZmvDn4bo6KaMYT6oQr1olyWZk2d,SpATywNh6bZuzm8s1ceuBUnMUAeoAHHw,6,3,1,0,1,0,2,0,7,1.0,1,0.0,0,1,0,1,3,0,0,2,0,2,5,1
5568,194707,JlZc44brK6lbQxfSfaJSAohGFJLWA41f,SpATywNh6bZuzm8s1ceuBUnMUAeoAHHw,1,0,0,0,0,0,1,0,1,0.14285714285714285,1,0.0,0,0,0,0,0,0,0,1,0,0,1,1
5569,194708,9T6sJuPiEkwFHn4VyREnKyR6Ni1hFol4,bWdj2GDclj5ofokWjzoa5jAwMkxCykd6,5,2,1,0,1,0,3,0,7,1.0,1,0.0,0,1,0,1,2,0,0,3,0,2,5,1
5570,194715,Ynti1kEVPZ88eymZgi4Ldsdb7WhG2uKG,SpATywNh6bZuzm8s1ceuBUnMUAeoAHHw,6,7,3,0,3,0,1,0,14,2.0,1,0.0,0,3,0,3,7,0,0,1,0,6,8,0
5571,194718,We3kejZMHXKEdbxhEAiN4oVd8fYmz3y9,A3fsA9Zfv1X2fVEQhTw51lKENdNrEqT3,2,0,0,0,0,0,3,0,3,0.42857142857142855,1,0.0,0,0,0,0,0,0,0,3,0,0,3,1
5572,194750,I2ghGumCKIaVsnJOGZA0xyJzTnEm5KtW,A3fsA9Zfv1X2fVEQhTw51lKENdNrEqT3,32,27,14,50,2,2,14,1,110,15.714285714285714,2,0.0,8,14,47,2,19,2,3,14,1,71,39,1
5573,194769,6bu6C39hyqa2rqkbngsN91OKjCxnxMLI,SpATywNh6bZuzm8s1ceuBUnMUAeoAHHw,10,12,4,16,0,0,2,0,34,4.857142857142857,1,0.0,7,4,14,0,5,0,2,2,0,25,9,1
5574,194812,U1JFUNAXc1AkReOZ8wdY4hTFUY2t5lXd,SpATywNh6bZuzm8s1ceuBUnMUAeoAHHw,4,3,1,0,1,0,1,0,6,0.8571428571428571,1,0.0,0,1,0,1,3,0,0,1,0,2,4,1
5575,194819,8mJzNtbbhYVCgZPRtpQ3nYyV12q5x7iP,SpATywNh6bZuzm8s1ceuBUnMUAeoAHHw,6,3,1,0,1,0,2,0,7,1.0,1,0.0,0,1,0,1,3,0,0,2,0,2,5,1
5576,194838,0Rc9QmalpGXvwxh2iIaT1Kf7aHCEMOJW,bWdj2GDclj5ofokWjzoa5jAwMkxCykd6,2,0,0,0,0,0,2,0,2,0.2857142857142857,1,0.0,0,0,0,0,0,0,0,2,0,0,2,1
5577,194840,9uetg4jrkfyr9l65M4782Ix4xyAceyAw,SpATywNh6bZuzm8s1ceuBUnMUAeoAHHw,4,2,1,0,0,0,2,0,5,0.7142857142857143,1,0.0,0,1,0,0,2,0,0,2,0,1,4,1
5578,194856,TfgVRC9skFsGu3qq14caEQmfjmrp7rot,SpATywNh6bZuzm8s1ceuBUnMUAeoAHHw,1,0,0,0,0,0,1,0,1,0.14285714285714285,1,0.0,0,0,0,0,0,0,0,1,0,0,1,1
5579,194894,KpYtE2oiCacGgvHDiOR9EPHvEG8K5VAH,A3fsA9Zfv1X2fVEQhTw51lKENdNrEqT3,14,4,3,42,1,0,1,0,51,7.285714285714286,1,0.0,0,3,37,1,4,0,5,1,0,41,10,1
5580,194898,EoYsxsuekHFOGMEOJolKStlPHqzqAJps,SpATywNh6bZuzm8s1ceuBUnMUAeoAHHw,1,0,0,0,0,0,1,0,1,0.14285714285714285,1,0.0,0,0,0,0,0,0,0,1,0,0,1,1
5581,194899,CJ8rz0JWIuI4wzHfaCoKLPdQC5hP7L8o,SpATywNh6bZuzm8s1ceuBUnMUAeoAHHw,2,0,0,0,0,0,2,0,2,0.2857142857142857,1,0.0,0,0,0,0,0,0,0,2,0,0,2,1
5582,194911,coZTr10eytnE55me2AxqRWq6qrVXEB7M,A3fsA9Zfv1X2fVEQhTw51lKENdNrEqT3,6,6,3,0,1,0,3,0,13,1.8571428571428572,1,0.0,0,3,0,1,6,0,0,3,0,4,9,1
5583,194920,nAKoJ3KJH4tNdKl2KzEFM3pKVZsfxNEo,SpATywNh6bZuzm8s1ceuBUnMUAeoAHHw,9,7,1,0,1,0,3,0,12,1.7142857142857142,1,0.0,0,1,0,1,7,0,0,3,0,2,10,1
5584,194938,iUqEEHE7KFlYvrJ9lttneq6sdDOxoE0o,A3fsA9Zfv1X2fVEQhTw51lKENdNrEqT3,1,0,0,0,0,0,1,0,1,0.14285714285714285,1,0.0,0,0,0,0,0,0,0,1,0,0,1,1
5585,194944,5yeJY3nTHKOfgXEh2NQejnxfnR8LFeFo,SpATywNh6bZuzm8s1ceuBUnMUAeoAHHw,6,5,2,0,2,0,1,0,10,1.4285714285714286,1,0.0,0,2,0,2,5,0,0,1,0,4,6,1
5586,194990,ULvgH0dn9cMQ7RqvqnSWbMcAlKJJQ0Fk,A3fsA9Zfv1X2fVEQhTw51lKENdNrEqT3,4,3,1,0,1,0,2,0,7,1.0,1,0.0,0,1,0,1,3,0,0,2,0,2,5,0
5587,195000,h2BiSzi5m6dXS3KusokZajeewmz5ASZK,SpATywNh6bZuzm8s1ceuBUnMUAeoAHHw,1,0,0,0,0,0,1,0,1,0.14285714285714285,1,0.0,0,0,0,0,0,0,0,1,0,0,1,1
5588,195011,NgAo8zTwzEL5kdUZa1oY4oYdY9RywdJx,bWdj2GDclj5ofokWjzoa5jAwMkxCykd6,1,0,0,0,0,0,1,0,1,0.14285714285714285,1,0.0,0,0,0,0,0,0,0,1,0,0,1,1
5589,195028,A7Dy7wBvIZYcTIZR94lL6Ks9jKNwU0Wy,bWdj2GDclj5ofokWjzoa5jAwMkxCykd6,6,2,1,0,1,0,3,0,7,1.0,1,0.0,0,1,0,1,2,0,0,3,0,2,5,1
5590,195048,KGzfXe849hKjIs0BHn7D33gnH3hOFhhi,A3fsA9Zfv1X2fVEQhTw51lKENdNrEqT3,1,0,0,0,0,0,1,0,1,0.14285714285714285,1,0.0,0,0,0,0,0,0,0,1,0,0,1,1
5591,195050,1qqlfnvXgcooPyZOwWYRIPDMSQDSWipF,A3fsA9Zfv1X2fVEQhTw51lKENdNrEqT3,8,4,3,0,2,0,2,0,11,1.5714285714285714,1,0.0,0,3,0,2,4,0,0,2,0,5,6,1
5592,195054,EboqTOLce3Kcnbr13rePsINEM3noHrcD,SpATywNh6bZuzm8s1ceuBUnMUAeoAHHw,1,0,0,0,0,0,3,0,3,0.42857142857142855,1,0.0,0,0,0,0,0,0,0,3,0,0,3,1
5593,195067,0hhH7SwEpwXhVryAlzllJZZoxMiaryTB,A3fsA9Zfv1X2fVEQhTw51lKENdNrEqT3,2,0,0,0,0,0,3,0,3,0.42857142857142855,1,0.0,0,0,0,0,0,0,0,3,0,0,3,1
5594,195070,LcDHI9VirEpxfDmLtYSK63dNG6QfI1o9,bWdj2GDclj5ofokWjzoa5jAwMkxCykd6,1,0,0,0,0,0,2,0,2,0.2857142857142857,1,0.0,0,0,0,0,0,0,0,2,0,0,2,1
5595,195096,VblkSmB0qnt2Sn7mKykILqjl5hQ7D7Rd,SpATywNh6bZuzm8s1ceuBUnMUAeoAHHw,8,3,0,0,0,4,5,1,13,1.8571428571428572,1,0.0,0,0,0,0,3,4,0,5,1,0,13,1
5596,195123,9bRCoX5aFYQHE9DZm9jyLHKfMlQ7Zegu,A3fsA9Zfv1X2fVEQhTw51lKENdNrEqT3,15,10,8,0,6,0,19,1,44,6.285714285714286,1,0.0,0,8,0,6,10,0,0,19,1,14,30,1
5597,195133,0vh8eAAsIFnTSYCbme0HYH2GZabOpyjO,SpATywNh6bZuzm8s1ceuBUnMUAeoAHHw,6,4,3,0,0,0,2,0,9,1.2857142857142858,1,0.0,0,3,0,0,4,0,0,2,0,3,6,1
5598,195138,zcYW5hQJaAne538I54YBHKKIHPYdcKzR,SpATywNh6bZuzm8s1ceuBUnMUAeoAHHw,3,0,0,0,0,0,3,0,3,0.42857142857142855,1,0.0,0,0,0,0,0,0,0,3,0,0,3,1
5599,195139,WKjm9NNrYTUj7AQwUBj4LGUEStoUuQbI,A3fsA9Zfv1X2fVEQhTw51lKENdNrEqT3,5,2,1,0,1,0,3,0,7,1.0,1,0.0,0,1,0,1,2,0,0,3,0,2,5,1
5600,195143,ZD6KzBJPXfWBkZLRMcl4p14dD6WWX4Ih,SpATywNh6bZuzm8s1ceuBUnMUAeoAHHw,10,14,0,2,0,0,4,0,20,2.857142857142857,1,0.0,2,0,2,0,12,0,0,4,0,4,16,1
5601,195148,AH5vrBLwc7s7uQQh3dO8uaZFfBQDcQxi,SpATywNh6bZuzm8s1ceuBUnMUAeoAHHw,1,0,0,0,0,0,1,0,1,0.14285714285714285,1,0.0,0,0,0,0,0,0,0,1,0,0,1,1
5602,195168,lk6sSo2mEoREiTaQjIlY6dKahZkFRKmP,A3fsA9Zfv1X2fVEQhTw51lKENdNrEqT3,1,0,0,0,0,0,1,0,1,0.14285714285714285,1,0.0,0,0,0,0,0,0,0,1,0,0,1,1
5603,195172,TzUoSJ3pyMjwCKLIHuVSKLad9h9hLr5U,A3fsA9Zfv1X2fVEQhTw51lKENdNrEqT3,4,4,0,0,0,0,1,0,5,0.7142857142857143,1,0.0,0,0,0,0,4,0,0,1,0,0,5,1
5604,195192,hT3gwKIRPmJxcgYf5liQovlZBdIJz1xq,SpATywNh6bZuzm8s1ceuBUnMUAeoAHHw,1,0,0,0,0,0,1,0,1,0.14285714285714285,1,0.0,0,0,0,0,0,0,0,1,0,0,1,1
5605,195202,FVkmb2ERZAYNUD3Q1ZAc0irCEUsLVQQz,SpATywNh6bZuzm8s1ceuBUnMUAeoAHHw,5,2,1,0,1,0,2,0,6,0.8571428571428571,1,0.0,0,1,0,1,2,0,0,2,0,2,4,1
5606,195218,abz0JUG7GWWef4jRyaayLqZkxtxXeHAT,SpATywNh6bZuzm8s1ceuBUnMUAeoAHHw,5,3,2,0,2,0,2,0,9,1.2857142857142858,1,0.0,0,2,0,2,3,0,0,2,0,4,5,1
5607,195226,xQ2ZtBKsHIRujsTwaOBWpiIEohBtlo5W,SpATywNh6bZuzm8s1ceuBUnMUAeoAHHw,7,10,5,0,1,0,2,0,18,2.5714285714285716,1,0.0,3,5,0,1,7,0,0,2,0,9,9,1
5608,195234,r0nvOJG3TaeLm69nhbeK6crtYznkTFB2,SpATywNh6bZuzm8s1ceuBUnMUAeoAHHw,7,5,2,0,2,0,4,0,13,1.8571428571428572,1,0.0,2,2,0,2,3,0,0,4,0,6,7,1
5609,195236,fIET0xNMcDIlnjd0AnC9TZEnn5s3AA6i,A3fsA9Zfv1X2fVEQhTw51lKENdNrEqT3,1,0,0,0,0,0,1,0,1,0.14285714285714285,1,0.0,0,0,0,0,0,0,0,1,0,0,1,1
5610,195239,bONRCO0uATZ9orvOXASjWia0swY9AaMZ,bWdj2GDclj5ofokWjzoa5jAwMkxCykd6,6,2,1,0,1,0,3,0,7,1.0,1,0.0,0,1,0,1,2,0,0,3,0,2,5,1
5611,195271,H9TBxem7IeyaJ30CPoPNOnkpc9xO2MQu,SpATywNh6bZuzm8s1ceuBUnMUAeoAHHw,1,0,0,0,0,0,1,0,1,0.14285714285714285,1,0.0,0,0,0,0,0,0,0,1,0,0,1,1
5612,195281,JHMFz2Gy459G1ldyhA75ALSO8YlPxA4n,bWdj2GDclj5ofokWjzoa5jAwMkxCykd6,9,7,3,0,3,0,2,0,15,2.142857142857143,1,0.0,0,3,0,3,7,0,0,2,0,6,9,1
5613,195305,jvZodiJQZU7RrA7XB4M3G0LE2sozlnz7,SpATywNh6bZuzm8s1ceuBUnMUAeoAHHw,10,22,2,0,2,1,10,0,37,5.285714285714286,1,0.0,9,2,0,2,13,1,0,10,0,13,24,1
5614,195310,a4n3ibeXbsub5EdlaCwB08x9krqRlEDa,A3fsA9Zfv1X2fVEQhTw51lKENdNrEqT3,1,0,0,0,0,0,1,0,1,0.14285714285714285,1,0.0,0,0,0,0,0,0,0,1,0,0,1,1
5615,195330,0htbMyPoZSLGh1Ogweb6zD7W8pfwScFx,SpATywNh6bZuzm8s1ceuBUnMUAeoAHHw,6,0,0,0,0,0,6,1,7,1.0,1,0.0,0,0,0,0,0,0,0,6,1,0,7,1
5616,195344,cA8asOLHRHcK3Kr0VMyGtrDdcfovAiM5,SpATywNh6bZuzm8s1ceuBUnMUAeoAHHw,10,4,4,0,4,0,3,0,15,2.142857142857143,1,0.0,0,4,0,4,4,0,0,3,0,8,7,1
5617,195347,P608wg2hLiaVE1CUhuKbnmhkIP7IEvsI,A3fsA9Zfv1X2fVEQhTw51lKENdNrEqT3,1,0,0,0,0,0,1,0,1,0.14285714285714285,1,0.0,0,0,0,0,0,0,0,1,0,0,1,1
5618,195366,EnaSTRqxkWjMR8pSWQe4ipdWniwPtGKE,SpATywNh6bZuzm8s1ceuBUnMUAeoAHHw,9,8,2,0,2,0,4,0,16,2.2857142857142856,1,0.0,0,2,0,2,8,0,0,4,0,4,12,1
5619,195370,OxLv0CDANbcaaaoNVUlIdXfqEbT45GpW,SpATywNh6bZuzm8s1ceuBUnMUAeoAHHw,1,0,0,0,0,0,3,0,3,0.42857142857142855,1,0.0,0,0,0,0,0,0,0,3,0,0,3,1
5620,195381,KMHV70a7rpZuAmNpI2Il8aVBDDazbOMO,A3fsA9Zfv1X2fVEQhTw51lKENdNrEqT3,5,2,1,0,1,1,2,0,7,1.0,1,0.0,0,1,0,1,2,1,0,2,0,2,5,1
5621,195405,GR3TNNEdaPxz3Wim5wCYlS1FUuZ9ygFu,SpATywNh6bZuzm8s1ceuBUnMUAeoAHHw,6,2,1,0,1,1,4,0,9,1.2857142857142858,1,0.0,0,1,0,1,2,1,0,4,0,2,7,1
5622,195431,uo6XWLpCc9aLEsRInaYzNhRYRrPEd76a,A3fsA9Zfv1X2fVEQhTw51lKENdNrEqT3,13,6,5,0,5,0,3,0,19,2.7142857142857144,1,0.0,0,5,0,5,6,0,0,3,0,10,9,1
5623,195433,nJkkRmbTjzmjz5X8FxdffFf8Y1I78bGw,SpATywNh6bZuzm8s1ceuBUnMUAeoAHHw,6,4,2,0,2,0,2,0,10,1.4285714285714286,1,0.0,0,2,0,2,4,0,0,2,0,4,6,0
5624,195439,rwvZ7FfuNpbh9VhQHt7eVb6FQWLjKGy4,SpATywNh6bZuzm8s1ceuBUnMUAeoAHHw,1,0,0,0,0,0,1,0,1,0.14285714285714285,1,0.0,0,0,0,0,0,0,0,1,0,0,1,1
5625,195459,IyN6z4xrJLEbmfDFZipqdcIPNBoMNgik,SpATywNh6bZuzm8s1ceuBUnMUAeoAHHw,5,2,1,0,1,0,2,0,6,0.8571428571428571,1,0.0,0,1,0,1,2,0,0,2,0,2,4,1
5626,195462,x5Bs4lB8d8XfmyyIE5x0cYPvnoiorBpL,SpATywNh6bZuzm8s1ceuBUnMUAeoAHHw,5,3,2,0,1,0,1,0,7,1.0,1,0.0,0,2,0,1,3,0,0,1,0,3,4,1
5627,195485,WnSnDWbUpPwgyOqh9KapbEmhFpxGdgxn,SpATywNh6bZuzm8s1ceuBUnMUAeoAHHw,1,0,0,0,0,0,1,0,1,0.14285714285714285,1,0.0,0,0,0,0,0,0,0,1,0,0,1,1
5628,195504,dfSV6MVOjiUgDK7JKupNIc842GwgOkeF,A3fsA9Zfv1X2fVEQhTw51lKENdNrEqT3,1,0,0,0,0,0,1,0,1,0.14285714285714285,1,0.0,0,0,0,0,0,0,0,1,0,0,1,1
5629,195532,7ckF3LPSV13LgZ2Fg6VdSWg1opJZgrXH,SpATywNh6bZuzm8s1ceuBUnMUAeoAHHw,2,0,0,0,0,0,2,0,2,0.2857142857142857,1,0.0,0,0,0,0,0,0,0,2,0,0,2,1
5630,195556,GmAgRxUlxl118Xo8rOFwbcuTp9uDnYde,SpATywNh6bZuzm8s1ceuBUnMUAeoAHHw,17,14,8,16,5,1,9,1,54,7.714285714285714,1,0.0,5,8,13,5,9,1,3,9,1,31,23,1
5631,195561,iZqC3Cf6t3CzqiiohlVddd9vHxMr4jyG,bWdj2GDclj5ofokWjzoa5jAwMkxCykd6,8,2,1,0,1,0,6,1,11,1.5714285714285714,1,0.0,0,1,0,1,2,0,0,6,1,2,9,1
5632,195564,augCFReFBQs2gO1ZsbARNIDALhMdNkTr,SpATywNh6bZuzm8s1ceuBUnMUAeoAHHw,1,0,0,0,0,0,2,0,2,0.2857142857142857,1,0.0,0,0,0,0,0,0,0,2,0,0,2,1
5633,195566,V7zoEtLfhU5rtj42pQGAui9L72mSu8fB,SpATywNh6bZuzm8s1ceuBUnMUAeoAHHw,5,3,1,0,1,0,1,0,6,0.8571428571428571,1,0.0,0,1,0,1,3,0,0,1,0,2,4,1
5634,196306,X6Lezij464ccKeng4uwKJTPF9kfTAT6Z,SpATywNh6bZuzm8s1ceuBUnMUAeoAHHw,1,0,0,0,0,0,1,0,1,0.14285714285714285,1,0.0,0,0,0,0,0,0,0,1,0,0,1,1
5635,196307,X6Lezij464ccKeng4uwKJTPF9kfTAT6Z,RXDvfPUBYFlVdlueBFbLW0mhhAyGEqpt,7,8,4,0,2,0,3,0,17,2.4285714285714284,1,0.0,0,4,0,2,8,0,0,3,0,6,11,1
5636,196705,bZa2cKnNlVdaH2zh1KBEDwy94lOurAbl,A3fsA9Zfv1X2fVEQhTw51lKENdNrEqT3,5,2,1,0,1,0,3,0,7,1.0,1,0.0,0,1,0,1,2,0,0,3,0,2,5,1
5637,197539,KgsFs481TCjQwvLPKxf7Q7ylhhpHCPhV,A3fsA9Zfv1X2fVEQhTw51lKENdNrEqT3,1,0,0,0,0,0,1,0,1,0.14285714285714285,1,0.0,0,0,0,0,0,0,0,1,0,0,1,1
5638,197555,mI8VCRBSYdxznLkfNYlx0gUNvZ04sNfj,SpATywNh6bZuzm8s1ceuBUnMUAeoAHHw,1,0,0,0,0,0,1,0,1,0.14285714285714285,1,0.0,0,0,0,0,0,0,0,1,0,0,1,1
5639,197567,zGQkx7I5R9FuZgfmXPXAegIJkfQnaSVg,SpATywNh6bZuzm8s1ceuBUnMUAeoAHHw,9,4,2,0,2,0,4,3,15,2.142857142857143,1,0.0,1,2,0,2,3,0,0,4,3,5,10,1
5640,197568,fBs8B9TyWeZ3NFnjocJnCJ1lDFqvyofp,SpATywNh6bZuzm8s1ceuBUnMUAeoAHHw,1,0,0,0,0,0,1,0,1,0.14285714285714285,1,0.0,0,0,0,0,0,0,0,1,0,0,1,1
5641,197590,sszCBt8cghX6qgFnXDzG8r5isZBGG9No,bWdj2GDclj5ofokWjzoa5jAwMkxCykd6,1,0,0,0,0,0,1,0,1,0.14285714285714285,1,0.0,0,0,0,0,0,0,0,1,0,0,1,1
5642,197605,xWQhq9RZKw08hANIa0LgFXN2DnwycQf4,A3fsA9Zfv1X2fVEQhTw51lKENdNrEqT3,1,0,0,0,0,0,1,0,1,0.14285714285714285,1,0.0,0,0,0,0,0,0,0,1,0,0,1,1
5643,197607,oarWFl12GJz5VOCw3d9cT9LuNMnlfaty,SpATywNh6bZuzm8s1ceuBUnMUAeoAHHw,9,11,1,8,0,5,7,0,32,4.571428571428571,1,0.0,0,1,6,0,11,5,2,7,0,7,25,1
5644,197610,PsqZXIXDMOG5Y38IYf7VtFHU6aWciJTC,A3fsA9Zfv1X2fVEQhTw51lKENdNrEqT3,4,2,0,0,0,0,3,0,5,0.7142857142857143,1,0.0,0,0,0,0,2,0,0,3,0,0,5,1
5645,197613,McYATdhZDDMDpni6a4GbjI06ustMpvdV,RXDvfPUBYFlVdlueBFbLW0mhhAyGEqpt,5,2,1,0,1,0,2,0,6,0.8571428571428571,1,0.0,0,1,0,1,2,0,0,2,0,2,4,1
5646,197630,GlVmjWGZ8XsOuLGdZvtzRw0xzELGNzxx,A3fsA9Zfv1X2fVEQhTw51lKENdNrEqT3,1,0,0,0,0,0,1,0,1,0.14285714285714285,1,0.0,0,0,0,0,0,0,0,1,0,0,1,1
5647,197637,y0PkAopIdLmRFrkWC9eBHvWT77KfVWMh,bWdj2GDclj5ofokWjzoa5jAwMkxCykd6,5,5,2,0,2,0,2,0,11,1.5714285714285714,1,0.0,0,2,0,2,5,0,0,2,0,4,7,1
5648,197647,yJyieqiQ74x4K1fGefSNl8T336TNyMah,G8EPVSXsOYB5YQWZGiz1aVq5Pgr2GrQu,7,5,3,0,1,0,3,0,12,1.7142857142857142,1,0.0,0,3,0,1,5,0,0,3,0,4,8,1
5649,197666,NXEwBXbU6vvce77sujWgRB6LivhFJvRb,bWdj2GDclj5ofokWjzoa5jAwMkxCykd6,4,2,1,0,1,0,2,0,6,0.8571428571428571,1,0.0,0,1,0,1,2,0,0,2,0,2,4,0
5650,197686,IlMRFFFNuG5w9EpYG3Dyt8Sj1nCtwb6Z,SpATywNh6bZuzm8s1ceuBUnMUAeoAHHw,6,8,4,0,0,0,1,0,13,1.8571428571428572,1,0.0,0,4,0,0,8,0,0,1,0,4,9,1
5651,197694,CLJmxLRlSw5V2HPI140IDE0f4EOszt4Y,SpATywNh6bZuzm8s1ceuBUnMUAeoAHHw,1,0,0,0,0,0,1,0,1,0.14285714285714285,1,0.0,0,0,0,0,0,0,0,1,0,0,1,1
5652,197701,irsB3oA9q2Yuz0rnZheRoFNJtkEWBPEv,SpATywNh6bZuzm8s1ceuBUnMUAeoAHHw,1,0,0,0,0,0,1,0,1,0.14285714285714285,1,0.0,0,0,0,0,0,0,0,1,0,0,1,1
5653,197705,Q2m4p3E1xU5tjACIAMpsbnVuTeuD9Zj8,RXDvfPUBYFlVdlueBFbLW0mhhAyGEqpt,1,0,0,0,0,0,1,0,1,0.14285714285714285,1,0.0,0,0,0,0,0,0,0,1,0,0,1,1
5654,197748,lvB2HAmzN6WpjnZWZKcaAAjy9p9VjGaG,SpATywNh6bZuzm8s1ceuBUnMUAeoAHHw,4,4,1,0,0,0,1,0,6,0.8571428571428571,1,0.0,1,1,0,0,3,0,0,1,0,2,4,1
5655,197754,DIr3Wrj5z4hYJwtDO9ijYT7A5ei5kcOt,SpATywNh6bZuzm8s1ceuBUnMUAeoAHHw,5,4,0,0,0,1,2,0,7,1.0,1,0.0,0,0,0,0,4,1,0,2,0,0,7,1
5656,197760,syyc0SZ7JGCYLXzo3H6grsNKbnA69vWI,SpATywNh6bZuzm8s1ceuBUnMUAeoAHHw,15,14,4,12,3,1,6,1,41,5.857142857142857,1,0.0,9,4,12,3,5,1,0,6,1,28,13,1
5657,197775,ate9cHga4fvGZQe84ZmaH3duYZ3g1R1F,G8EPVSXsOYB5YQWZGiz1aVq5Pgr2GrQu,9,5,4,0,3,2,4,0,18,2.5714285714285716,1,0.0,0,4,0,3,5,2,0,4,0,7,11,1
5658,197793,BxOnqjgkTpP6bgtURLXQygVvMj5N3Ti3,SpATywNh6bZuzm8s1ceuBUnMUAeoAHHw,7,4,0,0,0,0,5,1,10,1.4285714285714286,1,0.0,0,0,0,0,4,0,0,5,1,0,10,1
5659,197798,ZECsrQDWNf4nPUfo4HpZsLiXc2swEQ6q,SpATywNh6bZuzm8s1ceuBUnMUAeoAHHw,5,4,3,0,1,0,1,0,9,1.2857142857142858,1,0.0,0,3,0,1,4,0,0,1,0,4,5,1
5660,197810,doaL1TzO9FZY2ziOksLPhVRKrqvsMpej,SpATywNh6bZuzm8s1ceuBUnMUAeoAHHw,6,2,1,0,1,0,3,0,7,1.0,1,0.0,0,1,0,1,2,0,0,3,0,2,5,1
5661,197820,6WpUAvOn0104PVGU1qRupfdkikcVBl8O,SpATywNh6bZuzm8s1ceuBUnMUAeoAHHw,7,11,3,6,0,0,2,0,22,3.142857142857143,1,0.0,2,3,5,0,9,0,1,2,0,10,12,1
5662,197829,4ZyQJ5jYIytY6BbDJp7B3MYaAhi1NvbZ,SpATywNh6bZuzm8s1ceuBUnMUAeoAHHw,1,0,0,0,0,0,1,0,1,0.14285714285714285,1,0.0,0,0,0,0,0,0,0,1,0,0,1,1
5663,197846,qePcgnp7eGbGREyZzIMf7xZBiRdT6s9H,SpATywNh6bZuzm8s1ceuBUnMUAeoAHHw,5,2,1,0,1,0,2,0,6,0.8571428571428571,1,0.0,0,1,0,1,2,0,0,2,0,2,4,1
5664,197851,HwQlDqQYrfHrBUx2SSkCNQ3Dej1xgfkf,A3fsA9Zfv1X2fVEQhTw51lKENdNrEqT3,4,3,0,0,0,0,5,0,8,1.1428571428571428,1,0.0,0,0,0,0,3,0,0,5,0,0,8,1
5665,197889,bjP4zb5x0G9Cc1USSNLgNUtaJAQzeUAu,A3fsA9Zfv1X2fVEQhTw51lKENdNrEqT3,4,4,0,0,0,0,2,0,6,0.8571428571428571,1,0.0,0,0,0,0,4,0,0,2,0,0,6,1
5666,197898,QTE6XpirXhdZj0nCidu516iE2M5a9YWy,SpATywNh6bZuzm8s1ceuBUnMUAeoAHHw,4,3,2,0,2,0,1,0,8,1.1428571428571428,1,0.0,0,2,0,2,3,0,0,1,0,4,4,1
5667,197940,pXqF8hGJZiVQMekFKWzwpXptQULIbit3,A3fsA9Zfv1X2fVEQhTw51lKENdNrEqT3,1,0,0,0,0,0,1,0,1,0.14285714285714285,1,0.0,0,0,0,0,0,0,0,1,0,0,1,1
5668,197946,hICMvevjXddBWDZc80Udm3Jkv903MANA,A3fsA9Zfv1X2fVEQhTw51lKENdNrEqT3,7,4,2,0,2,0,1,0,9,1.2857142857142858,1,0.0,0,2,0,2,4,0,0,1,0,4,5,1
5669,197948,hw7IvcaYFJuJeZABsZjmbMK4OkcJdM6i,bWdj2GDclj5ofokWjzoa5jAwMkxCykd6,6,5,4,0,4,0,2,0,15,2.142857142857143,1,0.0,0,4,0,4,5,0,0,2,0,8,7,1
5670,197962,xp0PGlV4qhp60qYyxRe8xCxRmmPbM3Jj,A3fsA9Zfv1X2fVEQhTw51lKENdNrEqT3,2,0,0,0,0,0,4,0,4,0.5714285714285714,1,0.0,0,0,0,0,0,0,0,4,0,0,4,1
5671,197980,lQYiHkk4y0zDXyHNzb0tlv73qls5L2Vm,SpATywNh6bZuzm8s1ceuBUnMUAeoAHHw,5,4,0,0,0,0,4,0,8,1.1428571428571428,1,0.0,0,0,0,0,4,0,0,4,0,0,8,1
5672,198003,mJztKjO5nESo6T2c5pukm2m7KLliSS8S,A3fsA9Zfv1X2fVEQhTw51lKENdNrEqT3,10,5,3,0,3,4,3,0,18,2.5714285714285716,1,0.0,0,3,0,3,5,4,0,3,0,6,12,1
5673,198006,zkqKiyV6OvwyKPkyCN37KC4hTRCpZYCH,A3fsA9Zfv1X2fVEQhTw51lKENdNrEqT3,10,7,5,0,4,0,3,0,19,2.7142857142857144,1,0.0,0,5,0,4,7,0,0,3,0,9,10,1
5674,198018,XwJMK5oKK2pkH5F1a5Sx8BXHH3EqGmzs,A3fsA9Zfv1X2fVEQhTw51lKENdNrEqT3,25,3,1,56,1,0,4,0,65,9.285714285714286,1,0.0,1,1,55,1,2,0,1,4,0,58,7,1
5675,198022,Mv7lfepPwMiuMAg4tPzXsqZKJDYbRo5M,RXDvfPUBYFlVdlueBFbLW0mhhAyGEqpt,6,3,1,0,0,0,5,0,9,1.2857142857142858,1,0.0,0,1,0,0,3,0,0,5,0,1,8,1
5676,198026,NrHk4qmJXuD0TsjkQSnghKpk9ZjGAOyU,A3fsA9Zfv1X2fVEQhTw51lKENdNrEqT3,8,9,6,0,6,0,1,0,22,3.142857142857143,1,0.0,0,6,0,6,9,0,0,1,0,12,10,1
5677,198028,HePRyod5aTSIcFeoVudB8huyR12d5o5i,A3fsA9Zfv1X2fVEQhTw51lKENdNrEqT3,7,3,2,0,2,0,4,0,11,1.5714285714285714,1,0.0,0,2,0,2,3,0,0,4,0,4,7,0
5678,198029,4SbF4DhXcYorYYyJ4XmwwPJZFVh1ZUhY,A3fsA9Zfv1X2fVEQhTw51lKENdNrEqT3,6,3,2,0,1,0,5,0,11,1.5714285714285714,1,0.0,0,2,0,1,3,0,0,5,0,3,8,1
5679,198046,aDI9D7tn5adCCbKFB0sAA8QdbVuXFqVk,RXDvfPUBYFlVdlueBFbLW0mhhAyGEqpt,17,16,11,31,7,0,1,0,66,9.428571428571429,1,0.0,4,11,29,7,12,0,2,1,0,51,15,1
5680,198047,26YSBPGFrjIOM80TFQ5XwHijdAXAx6uk,bWdj2GDclj5ofokWjzoa5jAwMkxCykd6,12,5,3,0,3,0,5,2,18,2.5714285714285716,1,0.0,0,3,0,3,5,0,0,5,2,6,12,1
5681,198073,tBWD1VTj6Jcj3AQ0AXY8eZtUzkjmoiNH,A3fsA9Zfv1X2fVEQhTw51lKENdNrEqT3,34,31,1,62,1,0,10,1,106,15.142857142857142,1,0.0,3,1,54,1,28,0,8,10,1,59,47,1
5682,198086,xq1s7UZZ1wrCX5Lo1UzeFrdUUjRT403R,SpATywNh6bZuzm8s1ceuBUnMUAeoAHHw,11,12,1,12,0,0,3,1,29,4.142857142857143,1,0.0,6,1,12,0,6,0,0,3,1,19,10,1
5683,198098,AjlQRJzysjPIR7iVlK5KoW1nu66aTyed,SpATywNh6bZuzm8s1ceuBUnMUAeoAHHw,1,0,0,0,0,0,1,0,1,0.14285714285714285,1,0.0,0,0,0,0,0,0,0,1,0,0,1,0
5684,198105,gMfSnnrpIllvTRFx8lm7ezHNF6v0Kz0J,A3fsA9Zfv1X2fVEQhTw51lKENdNrEqT3,8,4,2,0,1,4,9,2,22,3.142857142857143,1,0.0,0,2,0,1,4,4,0,9,2,3,19,1
5685,198115,qB4NKZzfw5ku2R1El6nAmpvYSqoEp884,SpATywNh6bZuzm8s1ceuBUnMUAeoAHHw,4,3,1,0,0,0,2,0,6,0.8571428571428571,1,0.0,0,1,0,0,3,0,0,2,0,1,5,0
5686,198145,4GJSwwikGuUWXSajcKoSlvfsoiC8eEZq,bWdj2GDclj5ofokWjzoa5jAwMkxCykd6,13,17,7,0,3,3,7,1,38,5.428571428571429,1,0.0,1,7,0,3,16,3,0,7,1,11,27,1
5687,198154,S0gkXMGtXyRSx8zYg1gsCVaZEuGxgZkA,bWdj2GDclj5ofokWjzoa5jAwMkxCykd6,4,2,1,0,1,0,3,0,7,1.0,1,0.0,0,1,0,1,2,0,0,3,0,2,5,1
5688,198161,T6EWQ7jVP89JlHzj41KN1gEtGYevpSQM,A3fsA9Zfv1X2fVEQhTw51lKENdNrEqT3,12,8,6,0,4,0,2,0,20,2.857142857142857,1,0.0,0,6,0,4,8,0,0,2,0,10,10,1
5689,198163,plvcgi97Dmyn6KmfywjhqH2jaOdxU3cF,SpATywNh6bZuzm8s1ceuBUnMUAeoAHHw,8,5,3,0,0,1,5,1,15,2.142857142857143,1,0.0,0,3,0,0,5,1,0,5,1,3,12,1
5690,198180,gykRbA7iJUFygOkXv9mNdsHLTYvvd4jI,A3fsA9Zfv1X2fVEQhTw51lKENdNrEqT3,9,7,0,0,0,5,3,0,15,2.142857142857143,1,0.0,0,0,0,0,7,5,0,3,0,0,15,1
5691,198184,XeY97U0dths6K286UoEX2Zr2QUaKKAXx,SpATywNh6bZuzm8s1ceuBUnMUAeoAHHw,1,0,0,0,0,0,1,0,1,0.14285714285714285,1,0.0,0,0,0,0,0,0,0,1,0,0,1,1
5692,198186,73Lo5aiYTeasg8R5eGVwIsechNk0OHx6,G8EPVSXsOYB5YQWZGiz1aVq5Pgr2GrQu,9,4,3,0,3,0,2,0,12,1.7142857142857142,1,0.0,0,3,0,3,4,0,0,2,0,6,6,1
5693,198189,OtQITYEhL1ZwLf1P3GqZbaC4QV1QHl7a,A3fsA9Zfv1X2fVEQhTw51lKENdNrEqT3,9,15,7,0,0,0,2,0,24,3.4285714285714284,1,0.0,0,7,0,0,15,0,0,2,0,7,17,1
5694,198208,G2J62R4OLusX5hri0oMn1VajtiIn6i9q,bWdj2GDclj5ofokWjzoa5jAwMkxCykd6,6,1,1,0,1,0,3,0,6,0.8571428571428571,1,0.0,0,1,0,1,1,0,0,3,0,2,4,1
5695,198215,nrvDpyOlV5T6ZU5wiBAqPXpBwJOtawqO,A3fsA9Zfv1X2fVEQhTw51lKENdNrEqT3,20,17,9,0,7,8,8,0,49,7.0,1,0.0,1,9,0,7,16,8,0,8,0,17,32,1
5696,198221,9Mbi6CksSOlTvzJd1jV7pzorOP4mmF9E,A3fsA9Zfv1X2fVEQhTw51lKENdNrEqT3,5,2,1,0,1,0,2,0,6,0.8571428571428571,1,0.0,0,1,0,1,2,0,0,2,0,2,4,1
5697,198226,So8gZ8cXseEZ7lXf4idNMqcN46bXtlIA,A3fsA9Zfv1X2fVEQhTw51lKENdNrEqT3,8,8,5,0,1,0,6,0,20,2.857142857142857,1,0.0,1,5,0,1,7,0,0,6,0,7,13,1
5698,198241,qq2f8Akny1ajULPtgXYv9fMRWduKMr9q,bWdj2GDclj5ofokWjzoa5jAwMkxCykd6,1,0,0,0,0,0,1,0,1,0.14285714285714285,1,0.0,0,0,0,0,0,0,0,1,0,0,1,1
5699,198265,tblYMREbAeB7j9qmk5L4ctIeWrhD9ybH,bWdj2GDclj5ofokWjzoa5jAwMkxCykd6,3,2,1,0,0,0,2,0,5,0.7142857142857143,1,0.0,0,1,0,0,2,0,0,2,0,1,4,1
5700,198305,XMS4dHK4VF2mldxN8JQikVR6RXER8Fkw,bWdj2GDclj5ofokWjzoa5jAwMkxCykd6,5,3,1,0,1,0,2,0,7,1.0,1,0.0,0,1,0,1,3,0,0,2,0,2,5,1
5701,198318,6I2t4qPvSGFHgotoOOeNtMQj1MijCM5Q,A3fsA9Zfv1X2fVEQhTw51lKENdNrEqT3,10,7,5,0,5,0,2,0,19,2.7142857142857144,1,0.0,1,5,0,5,6,0,0,2,0,11,8,1
5702,198321,VLCI0RtMsYSrwlXRiyKxAF4TijVOF7sG,G8EPVSXsOYB5YQWZGiz1aVq5Pgr2GrQu,6,10,0,2,0,0,1,0,13,1.8571428571428572,1,0.0,1,0,2,0,9,0,0,1,0,3,10,1
5703,198326,Dq2cCGdJlkpRnI9Tq5kE4JyzjGIGvpDz,bWdj2GDclj5ofokWjzoa5jAwMkxCykd6,3,2,0,0,0,0,1,0,3,0.42857142857142855,1,0.0,0,0,0,0,2,0,0,1,0,0,3,1
5704,198371,LWF5YNBuaLmRzZBpMALW00OMClXmBQ67,SpATywNh6bZuzm8s1ceuBUnMUAeoAHHw,2,0,0,0,0,0,2,0,2,0.2857142857142857,1,0.0,0,0,0,0,0,0,0,2,0,0,2,1
5705,198409,ipd4iDlo57xlncm3PxcBpEpu3rjoDaW0,SpATywNh6bZuzm8s1ceuBUnMUAeoAHHw,7,4,2,0,0,3,5,2,16,2.2857142857142856,1,0.0,0,2,0,0,4,3,0,5,2,2,14,1
5706,198412,MW1CCUAVszgiBJBxxvrBhzMkhEDfscQF,SpATywNh6bZuzm8s1ceuBUnMUAeoAHHw,6,0,0,0,0,0,11,8,19,2.7142857142857144,1,0.0,0,0,0,0,0,0,0,11,8,0,19,1
5707,198425,Im7Gqlg4DTaApzafTWanJWaOLzYDgQ9W,A3fsA9Zfv1X2fVEQhTw51lKENdNrEqT3,3,2,0,0,0,0,1,0,3,0.42857142857142855,1,0.0,0,0,0,0,2,0,0,1,0,0,3,1
5708,198427,LUXdrYaxg0yAPMJIVFuGpyCbBaRkWcyF,G8EPVSXsOYB5YQWZGiz1aVq5Pgr2GrQu,1,0,0,0,0,0,1,0,1,0.14285714285714285,1,0.0,0,0,0,0,0,0,0,1,0,0,1,1
5709,198437,itsIv2TK9169ecmSXMRGqFj2himLJ6iM,A3fsA9Zfv1X2fVEQhTw51lKENdNrEqT3,6,2,1,0,1,0,3,0,7,1.0,1,0.0,0,1,0,1,2,0,0,3,0,2,5,1
5710,198439,ap1pnANC6OX2VWawEUL9RM8TJxJj0bNk,SpATywNh6bZuzm8s1ceuBUnMUAeoAHHw,5,2,1,0,1,0,2,0,6,0.8571428571428571,1,0.0,0,1,0,1,2,0,0,2,0,2,4,1
5711,198451,hB4kfP3FOz99INk6teFtXjDJ0tVrgCfz,A3fsA9Zfv1X2fVEQhTw51lKENdNrEqT3,7,4,1,0,1,0,3,1,10,1.4285714285714286,1,0.0,0,1,0,1,4,0,0,3,1,2,8,1
5712,198471,rVGqmbwIRU16AVLpkBRDBFOfZ4AeaSVo,G8EPVSXsOYB5YQWZGiz1aVq5Pgr2GrQu,8,2,0,0,0,4,6,1,13,1.8571428571428572,1,0.0,0,0,0,0,2,4,0,6,1,0,13,1
5713,198513,h4OSpklHSinT7B8HRJJ34ZVL6q4IdQwV,A3fsA9Zfv1X2fVEQhTw51lKENdNrEqT3,10,7,1,0,1,0,6,1,16,2.2857142857142856,1,0.0,0,1,0,1,7,0,0,6,1,2,14,1
5714,198521,I3IP7zznUTOp2SzpkCoD3Y916MRFIMEQ,G8EPVSXsOYB5YQWZGiz1aVq5Pgr2GrQu,17,18,1,24,3,0,2,0,48,6.857142857142857,1,0.0,12,1,14,3,6,0,10,2,0,30,18,1
5715,198524,3nkAYJy31glMu7RttArFOqU7gmkfxNPM,RXDvfPUBYFlVdlueBFbLW0mhhAyGEqpt,1,0,0,0,0,0,1,0,1,0.14285714285714285,1,0.0,0,0,0,0,0,0,0,1,0,0,1,1
5716,198527,7UnGK0lAfGMjUxMyS4n60DI4CBHlFUHS,SpATywNh6bZuzm8s1ceuBUnMUAeoAHHw,4,2,0,0,0,1,2,0,5,0.7142857142857143,1,0.0,0,0,0,0,2,1,0,2,0,0,5,1
5717,198540,PQpooRd3Dcd7MsTxOspuuB35YLvA2JZK,SpATywNh6bZuzm8s1ceuBUnMUAeoAHHw,5,5,4,0,2,0,2,0,13,1.8571428571428572,1,0.0,0,4,0,2,5,0,0,2,0,6,7,1
5718,198541,cIviUx1oarGZRWOqPuxscIM6aOUp7v5L,G8EPVSXsOYB5YQWZGiz1aVq5Pgr2GrQu,11,3,3,0,3,0,5,0,14,2.0,1,0.0,0,3,0,3,3,0,0,5,0,6,8,1
5719,198543,7UnGK0lAfGMjUxMyS4n60DI4CBHlFUHS,bWdj2GDclj5ofokWjzoa5jAwMkxCykd6,1,0,0,0,0,0,1,0,1,0.14285714285714285,1,0.0,0,0,0,0,0,0,0,1,0,0,1,1
5720,198563,IR9p9WuPGPaaA4f6RkgkUYRRmOTg8aPE,bWdj2GDclj5ofokWjzoa5jAwMkxCykd6,3,2,1,0,0,0,1,0,4,0.5714285714285714,1,0.0,0,1,0,0,2,0,0,1,0,1,3,1
5721,198573,0Rc9QmalpGXvwxh2iIaT1Kf7aHCEMOJW,A3fsA9Zfv1X2fVEQhTw51lKENdNrEqT3,1,0,0,0,0,0,1,0,1,0.14285714285714285,1,0.0,0,0,0,0,0,0,0,1,0,0,1,1
5722,198585,pHj2ScU15UNB28eYcbm9r11wq0WKivrS,bWdj2GDclj5ofokWjzoa5jAwMkxCykd6,4,5,2,0,2,0,1,0,10,1.4285714285714286,1,0.0,2,2,0,2,3,0,0,1,0,6,4,1
5723,198590,Zr4KLz2ZL4aSF5gVvs5p4LZP1ixAwF6u,SpATywNh6bZuzm8s1ceuBUnMUAeoAHHw,8,3,1,0,1,1,5,1,12,1.7142857142857142,1,0.0,0,1,0,1,3,1,0,5,1,2,10,1
5724,198592,CiLev4iw4aDKDkfbO8GSdlCCB3fQXQsY,A3fsA9Zfv1X2fVEQhTw51lKENdNrEqT3,10,4,3,0,2,0,4,0,13,1.8571428571428572,1,0.0,0,3,0,2,4,0,0,4,0,5,8,1
5725,198611,lMscwAq4rucD5Y2Dxs1NCZ0Ax6V2NgJ7,SpATywNh6bZuzm8s1ceuBUnMUAeoAHHw,5,3,2,0,1,0,1,0,7,1.0,1,0.0,0,2,0,1,3,0,0,1,0,3,4,1
5726,198616,odybwv6zTY9TMhO6yi1EIRr2WfIsx8N5,SpATywNh6bZuzm8s1ceuBUnMUAeoAHHw,1,0,0,0,0,0,1,0,1,0.14285714285714285,1,0.0,0,0,0,0,0,0,0,1,0,0,1,1
5727,198622,WV3YkTyrIBT24sYf1NcBchbLSWfuPseq,A3fsA9Zfv1X2fVEQhTw51lKENdNrEqT3,4,3,2,0,2,0,1,0,8,1.1428571428571428,1,0.0,0,2,0,2,3,0,0,1,0,4,4,1
5728,198623,Dzu6GQmc5vuwFq9gJBuCSSuvGPsIdsSj,SpATywNh6bZuzm8s1ceuBUnMUAeoAHHw,6,0,0,0,0,0,7,2,9,1.2857142857142858,1,0.0,0,0,0,0,0,0,0,7,2,0,9,1
5729,198631,Jvu0Hx9YHJ8mxetJAU2xMbziN16z8eDf,SpATywNh6bZuzm8s1ceuBUnMUAeoAHHw,12,7,5,0,4,1,5,1,23,3.2857142857142856,1,0.0,0,5,0,4,7,1,0,5,1,9,14,1
5730,198633,v8AEmfj5ScfNiqWSiB9twce4e05jQ9FQ,bWdj2GDclj5ofokWjzoa5jAwMkxCykd6,1,0,0,0,0,0,1,0,1,0.14285714285714285,1,0.0,0,0,0,0,0,0,0,1,0,0,1,1
5731,198639,9Nsgp7LQN84rKL9niMUlqjv8b2ci26i2,A3fsA9Zfv1X2fVEQhTw51lKENdNrEqT3,1,0,0,0,0,0,1,0,1,0.14285714285714285,1,0.0,0,0,0,0,0,0,0,1,0,0,1,1
5732,198641,boqZBuL5xdPgOX9TFr0s595aQRVHTZHS,SpATywNh6bZuzm8s1ceuBUnMUAeoAHHw,1,0,0,0,0,0,1,0,1,0.14285714285714285,1,0.0,0,0,0,0,0,0,0,1,0,0,1,1
5733,198648,pGAAxK6WZxbSHdtKKBvQSoYltPRqe43C,SpATywNh6bZuzm8s1ceuBUnMUAeoAHHw,6,3,1,0,1,0,2,0,7,1.0,1,0.0,0,1,0,1,3,0,0,2,0,2,5,1
5734,198672,GSkYUOcl4XzYMWSWhE6gXRGQ9kqPeXsi,bWdj2GDclj5ofokWjzoa5jAwMkxCykd6,9,5,3,28,3,0,2,0,41,5.857142857142857,1,0.0,1,3,27,3,4,0,1,2,0,34,7,1
5735,198675,34cVbMGyVO1SqQjOK9RNk00q4uKA3nIE,A3fsA9Zfv1X2fVEQhTw51lKENdNrEqT3,5,3,1,0,1,2,4,0,11,1.5714285714285714,1,0.0,1,1,0,1,2,2,0,4,0,3,8,1
5736,198714,MZXb9jchKEtLA37ZVUIxBtaUGdZhYeJT,G8EPVSXsOYB5YQWZGiz1aVq5Pgr2GrQu,4,2,1,0,1,0,1,0,5,0.7142857142857143,1,0.0,0,1,0,1,2,0,0,1,0,2,3,1
5737,198717,I2yihQ33CDsuDBZLIV6bzhSjVdIOvgGC,bWdj2GDclj5ofokWjzoa5jAwMkxCykd6,7,3,0,0,2,0,4,0,9,1.2857142857142858,1,0.0,2,0,0,2,1,0,0,4,0,4,5,1
5738,198720,GdwsSQDD3RD1ds1JuZBmFzmfEkBslekC,SpATywNh6bZuzm8s1ceuBUnMUAeoAHHw,4,3,0,0,0,0,2,0,5,0.7142857142857143,1,0.0,0,0,0,0,3,0,0,2,0,0,5,1
5739,198721,foGVhKIFjMIFQYicH2TLfLzHHE7pM4bi,A3fsA9Zfv1X2fVEQhTw51lKENdNrEqT3,7,2,1,0,0,1,6,1,11,1.5714285714285714,1,0.0,0,1,0,0,2,1,0,6,1,1,10,1
5740,198753,xX0iYdUwlCBlooAwOCU3ud9UtqInVGRm,A3fsA9Zfv1X2fVEQhTw51lKENdNrEqT3,12,8,6,0,3,7,6,1,31,4.428571428571429,1,0.0,0,6,0,3,8,7,0,6,1,9,22,1
5741,198758,7FTb8qcMeGic1m25RrAdw1gNnGsbUnQN,SpATywNh6bZuzm8s1ceuBUnMUAeoAHHw,13,17,7,0,3,0,8,1,36,5.142857142857143,1,0.0,4,7,0,3,13,0,0,8,1,14,22,1
5742,198767,rdXBX56hdm6MgOkqvDTZw84EG2v9Ij01,A3fsA9Zfv1X2fVEQhTw51lKENdNrEqT3,5,2,1,0,1,0,4,0,8,1.1428571428571428,1,0.0,0,1,0,1,2,0,0,4,0,2,6,1
5743,198777,bWklEyYoSpuuB2ZTCwBPrnaJDLkOGTMp,SpATywNh6bZuzm8s1ceuBUnMUAeoAHHw,1,0,0,0,0,0,1,0,1,0.14285714285714285,1,0.0,0,0,0,0,0,0,0,1,0,0,1,1
5744,198781,hkPW1meCvutegNytZP5zAHZkZdu7wM1N,G8EPVSXsOYB5YQWZGiz1aVq5Pgr2GrQu,6,7,5,0,4,0,4,0,20,2.857142857142857,1,0.0,0,5,0,4,7,0,0,4,0,9,11,1
5745,198795,v4qKKz4EWeiMbiMd1pppvrFEFDQHnpRJ,G8EPVSXsOYB5YQWZGiz1aVq5Pgr2GrQu,8,7,3,0,3,0,1,0,14,2.0,1,0.0,3,3,0,3,4,0,0,1,0,9,5,1
5746,198797,u601bf5LgTloUnzWrvF8VsEbNdAIplE1,A3fsA9Zfv1X2fVEQhTw51lKENdNrEqT3,1,0,0,0,0,0,2,0,2,0.2857142857142857,1,0.0,0,0,0,0,0,0,0,2,0,0,2,1
5747,198800,wnDMDigjN4PlQ0HWg6PwACxEoBUS4Gx4,A3fsA9Zfv1X2fVEQhTw51lKENdNrEqT3,4,2,0,0,0,0,2,0,4,0.5714285714285714,1,0.0,0,0,0,0,2,0,0,2,0,0,4,1
5748,198803,9N7TqBwx16hmfqT5WweyvUVrAeU2Gds6,SpATywNh6bZuzm8s1ceuBUnMUAeoAHHw,10,15,6,0,4,1,1,0,27,3.857142857142857,1,0.0,3,6,0,4,12,1,0,1,0,13,14,1
5749,198804,oOPW8b1yKsHdoM2CKb7DyH4zCUGTI2L7,G8EPVSXsOYB5YQWZGiz1aVq5Pgr2GrQu,7,3,2,0,2,0,4,0,11,1.5714285714285714,1,0.0,0,2,0,2,3,0,0,4,0,4,7,1
5750,198813,bu3K5v9qe8b55yPk6H1Kzu2kZgUnBQeS,bWdj2GDclj5ofokWjzoa5jAwMkxCykd6,1,0,0,0,0,0,1,0,1,0.14285714285714285,1,0.0,0,0,0,0,0,0,0,1,0,0,1,1
5751,198818,4JyZWYWxxqGCPr9dTz7bgpLcCXWs003A,G8EPVSXsOYB5YQWZGiz1aVq5Pgr2GrQu,7,1,1,0,1,0,5,0,8,1.1428571428571428,1,0.0,0,1,0,1,1,0,0,5,0,2,6,1
5752,198824,AG3Ywlgg0zeoJMMzx5kl7d9PzkM3xyjk,A3fsA9Zfv1X2fVEQhTw51lKENdNrEqT3,18,9,7,0,6,0,6,1,29,4.142857142857143,1,0.0,0,7,0,6,9,0,0,6,1,13,16,1
5753,198827,2ULjUBKcAnyQSi1NZFeDGBWEU4kETCtv,G8EPVSXsOYB5YQWZGiz1aVq5Pgr2GrQu,18,24,11,40,5,3,4,0,87,12.428571428571429,1,0.0,7,11,33,5,17,3,7,4,0,56,31,1
5754,198843,nhKo3n0QtoNri1dTW77ZJUsuajlfq52l,SpATywNh6bZuzm8s1ceuBUnMUAeoAHHw,6,4,3,0,3,0,1,0,11,1.5714285714285714,1,0.0,0,3,0,3,4,0,0,1,0,6,5,1
5755,198861,HhUNMDqxiy7U4QVsVWLmXLfoPctCDoGr,SpATywNh6bZuzm8s1ceuBUnMUAeoAHHw,3,0,0,0,0,1,2,0,3,0.42857142857142855,1,0.0,0,0,0,0,0,1,0,2,0,0,3,1
5756,198876,3FwKlBDtKGlNAYyQNzHL1qfkuXpNOPVW,bWdj2GDclj5ofokWjzoa5jAwMkxCykd6,1,0,0,0,0,0,1,0,1,0.14285714285714285,1,0.0,0,0,0,0,0,0,0,1,0,0,1,1
5757,198881,R2bf9dlDhtEUgfKzXR1GPBa12LhUfZ8W,A3fsA9Zfv1X2fVEQhTw51lKENdNrEqT3,6,4,3,0,2,0,1,0,10,1.4285714285714286,1,0.0,0,3,0,2,4,0,0,1,0,5,5,1
5758,198883,TwsuaxQpuQH4X71hofoKVQ1FXkHOyr0Z,bWdj2GDclj5ofokWjzoa5jAwMkxCykd6,8,2,1,0,1,0,5,1,10,1.4285714285714286,1,0.0,1,1,0,1,1,0,0,5,1,3,7,1
5759,198887,IGs2FsXHkQDnXVyqCPa0nawJqdQ0PAsD,SpATywNh6bZuzm8s1ceuBUnMUAeoAHHw,1,0,0,0,0,0,1,0,1,0.14285714285714285,1,0.0,0,0,0,0,0,0,0,1,0,0,1,1
5760,198897,Isy1saDmyEIfHHr1kPm1JUuUBknEItqI,SpATywNh6bZuzm8s1ceuBUnMUAeoAHHw,1,0,0,0,0,0,1,0,1,0.14285714285714285,1,0.0,0,0,0,0,0,0,0,1,0,0,1,1
5761,198900,r4qXpyLtUsV0WLMpP48wcQ1UcY1so2Nu,G8EPVSXsOYB5YQWZGiz1aVq5Pgr2GrQu,10,5,4,0,3,0,2,0,14,2.0,1,0.0,0,4,0,3,5,0,0,2,0,7,7,1
5762,198908,pSRqXJrhW3cpcIMqshrNJY13lAR5UPwX,bWdj2GDclj5ofokWjzoa5jAwMkxCykd6,1,0,0,0,0,0,1,0,1,0.14285714285714285,1,0.0,0,0,0,0,0,0,0,1,0,0,1,1
5763,198912,nKVAY2GHYnzf4BfG261ddlVdtqvsIA9B,bWdj2GDclj5ofokWjzoa5jAwMkxCykd6,4,2,1,0,1,0,2,0,6,0.8571428571428571,1,0.0,0,1,0,1,2,0,0,2,0,2,4,1
5764,198919,1j8gbclC0lfQw1ATQbildJE9fULo0ecU,A3fsA9Zfv1X2fVEQhTw51lKENdNrEqT3,5,2,1,0,1,0,2,0,6,0.8571428571428571,1,0.0,0,1,0,1,2,0,0,2,0,2,4,1
5765,198934,YQQ0U1ySGhxQGw2MpzkqAJru8VuefP0L,A3fsA9Zfv1X2fVEQhTw51lKENdNrEqT3,6,2,1,0,1,7,7,1,19,2.7142857142857144,1,0.0,0,1,0,1,2,7,0,7,1,2,17,1
5766,198949,sNbuAEBvvCL9s1FspvGXLJVjQkFzxwpw,bWdj2GDclj5ofokWjzoa5jAwMkxCykd6,4,2,0,0,0,0,2,0,4,0.5714285714285714,1,0.0,0,0,0,0,2,0,0,2,0,0,4,1
5767,198961,mJt5KMSSr7JvGBEQNnS7zxJqeuNThNSs,SpATywNh6bZuzm8s1ceuBUnMUAeoAHHw,7,5,4,0,4,0,2,0,15,2.142857142857143,1,0.0,0,4,0,4,5,0,0,2,0,8,7,1
5768,198967,2oTvbzieHn2y5oozeOgSnruqE6N0BtR5,SpATywNh6bZuzm8s1ceuBUnMUAeoAHHw,7,3,2,0,2,3,2,0,12,1.7142857142857142,1,0.0,0,2,0,2,3,3,0,2,0,4,8,1
5769,198990,2SHX7pefWKxAdle5f43dow0MyPOF6YGF,SpATywNh6bZuzm8s1ceuBUnMUAeoAHHw,6,3,0,0,0,1,4,0,8,1.1428571428571428,1,0.0,0,0,0,0,3,1,0,4,0,0,8,1
5770,198997,37OFfdd4jVDH9Wkzlzun8gwzZeYEoVZi,SpATywNh6bZuzm8s1ceuBUnMUAeoAHHw,7,3,2,0,2,0,2,0,9,1.2857142857142858,1,0.0,0,2,0,2,3,0,0,2,0,4,5,1
5771,198998,2oTvbzieHn2y5oozeOgSnruqE6N0BtR5,G8EPVSXsOYB5YQWZGiz1aVq5Pgr2GrQu,11,6,4,0,4,8,2,0,24,3.4285714285714284,1,0.0,1,4,0,4,5,8,0,2,0,9,15,1
5772,199003,z8AZNvy0mvqias2V5LoDHYpS46oKfDaS,RXDvfPUBYFlVdlueBFbLW0mhhAyGEqpt,2,0,0,0,0,0,2,0,2,0.2857142857142857,1,0.0,0,0,0,0,0,0,0,2,0,0,2,1
5773,199007,TqIBAk7ZVNx5vdURE7Yh8YGgkMcauYpn,A3fsA9Zfv1X2fVEQhTw51lKENdNrEqT3,5,4,3,0,0,0,2,0,9,1.2857142857142858,1,0.0,0,3,0,0,4,0,0,2,0,3,6,1
5774,199048,seGsWY5pHJdYc0dygxkfgWkiK3wzJxVH,A3fsA9Zfv1X2fVEQhTw51lKENdNrEqT3,5,3,1,0,1,0,2,0,7,1.0,1,0.0,1,1,0,1,2,0,0,2,0,3,4,1
5775,199063,ODCx2UO2z0ldelF48alKkiQzrvYMM8sJ,G8EPVSXsOYB5YQWZGiz1aVq5Pgr2GrQu,9,6,3,2,1,0,9,0,21,3.0,1,0.0,3,3,2,1,3,0,0,9,0,9,12,1
5776,199068,TTLR6K3ZlbSrGOfX2kjd2U4ChldGiopU,RXDvfPUBYFlVdlueBFbLW0mhhAyGEqpt,5,3,1,0,0,0,3,0,7,1.0,1,0.0,0,1,0,0,3,0,0,3,0,1,6,1
5777,199070,mne1Bu1F2f0U7iravmS4eQYQtLTkVvPe,A3fsA9Zfv1X2fVEQhTw51lKENdNrEqT3,9,4,3,0,3,0,3,0,13,1.8571428571428572,1,0.0,0,3,0,3,4,0,0,3,0,6,7,1
5778,199075,zmFq2MrnMqSFLtSy4w1SV24s7OiYosym,A3fsA9Zfv1X2fVEQhTw51lKENdNrEqT3,4,2,1,0,1,0,1,0,5,0.7142857142857143,1,0.0,0,1,0,1,2,0,0,1,0,2,3,1
