,enrollment_id,username,course_id,no_of_objects123,bno_access123,bno_pageclose123,bno_problem123,bno_video123,bno_discussion123,bno_navigate123,bno_wiki123,bno_total123,bno_avg123,no_of_active_days123,time_consumption123,browser_access123,browser_pageclose123,browser_problem123,browser_video123,server_access123,server_discussion123,server_problem123,server_navigate123,server_wiki123,bno_browser123,bno_server123,label
0,3,1qXC7Fjbwp66GPQc6pHLfEuO8WKozxG4,7GRhBDsirIGkRZBtSMEzNTyDr2JQm4xx,69,51,20,83,9,21,11,0,195,27.857142857142858,7,-11438230.0,22,20,82,9,29,21,1,11,0,133,62,0
1,5,p1Mp7WkVfzUijX0peVQKSHbgd5pXyl4c,7GRhBDsirIGkRZBtSMEzNTyDr2JQm4xx,68,147,63,112,47,20,22,0,411,58.714285714285715,7,0.0,72,63,90,47,75,20,22,22,0,272,139,0
2,7,I1KwJ6EdCZnEPLfC8Q7yWpIkLOHn7h02,7GRhBDsirIGkRZBtSMEzNTyDr2JQm4xx,69,180,50,76,65,33,16,0,420,60.0,7,0.0,114,50,65,65,66,33,11,16,0,294,126,1
3,22,dPBUV0FPFjTZZK079rPAeq0WXhW4DUkF,7GRhBDsirIGkRZBtSMEzNTyDr2JQm4xx,49,66,38,64,36,0,1,0,205,29.285714285714285,2,0.0,26,38,56,36,40,0,8,1,0,156,49,1
4,45,5Tz6BGN7p1lkmdoopAY1Z5ufYTrUsi9E,7GRhBDsirIGkRZBtSMEzNTyDr2JQm4xx,79,211,70,108,54,35,23,0,501,71.57142857142857,10,0.0,104,70,92,54,107,35,16,23,0,320,181,0
5,49,2oTvbzieHn2y5oozeOgSnruqE6N0BtR5,7GRhBDsirIGkRZBtSMEzNTyDr2JQm4xx,84,259,127,58,42,1098,125,0,1709,244.14285714285714,21,0.0,58,127,29,42,201,1098,29,125,0,256,1453,0
6,50,LnNj9zDI8D38ixGOYTIjTH2iF5m36v9S,7GRhBDsirIGkRZBtSMEzNTyDr2JQm4xx,24,49,22,48,0,0,7,0,126,18.0,6,0.0,19,22,43,0,30,0,5,7,0,84,42,1
7,58,l9KseRU4xYtwOzoILYmGcicF0iiXQqxl,7GRhBDsirIGkRZBtSMEzNTyDr2JQm4xx,95,228,82,139,32,40,47,2,570,81.42857142857143,15,0.0,66,82,126,32,162,40,13,47,2,306,264,0
8,96,KXi2lu4GlKmrO1lJTLg3t4l701rvNXNZ,7GRhBDsirIGkRZBtSMEzNTyDr2JQm4xx,31,65,28,34,22,1,6,0,156,22.285714285714285,6,0.0,29,28,29,22,36,1,5,6,0,108,48,1
9,134,Q5TmTVdy8nnH2vTL73s67ZseaCMO3k91,7GRhBDsirIGkRZBtSMEzNTyDr2JQm4xx,28,20,9,24,8,0,10,0,71,10.142857142857142,2,0.0,9,9,24,8,11,0,0,10,0,50,21,1
10,141,CB4JYroUtmiKv572P6g4vrvJCi6Pzr9h,7GRhBDsirIGkRZBtSMEzNTyDr2JQm4xx,59,105,42,101,31,22,34,0,335,47.857142857142854,5,0.0,61,42,87,31,44,22,14,34,0,221,114,1
11,192,hCxbmPBmjgsEuMY36HnZH4x3BwWFnCUn,7GRhBDsirIGkRZBtSMEzNTyDr2JQm4xx,65,104,37,28,38,0,44,0,251,35.857142857142854,12,0.0,64,37,25,38,40,0,3,44,0,164,87,0
12,199,OEQBiRbbo3yEBzKSHcNX9ESBTSUy08ze,7GRhBDsirIGkRZBtSMEzNTyDr2JQm4xx,103,234,83,175,54,217,43,5,811,115.85714285714286,8,0.0,132,83,146,54,102,217,29,43,5,415,396,0
13,219,088SASUPOVYUGhoEly8vlrkGvRBJoNwp,7GRhBDsirIGkRZBtSMEzNTyDr2JQm4xx,64,530,171,159,17,250,105,13,1245,177.85714285714286,12,0.0,260,171,138,17,270,250,21,105,13,586,659,0
14,248,BTWrAWjg41jpM1wlPsS1mmQbZAFIvx2o,7GRhBDsirIGkRZBtSMEzNTyDr2JQm4xx,2,0,0,0,0,0,4,0,4,0.5714285714285714,1,0.0,0,0,0,0,0,0,0,4,0,0,4,1
15,255,O6WL6sxvoPCZnvTLyTPxdXbnpOz3wcJ4,7GRhBDsirIGkRZBtSMEzNTyDr2JQm4xx,40,93,29,74,15,2,12,0,225,32.142857142857146,4,0.0,29,29,61,15,64,2,13,12,0,134,91,0
16,284,L9qMLlGWAeAI6zWAZIyJtn0wISNa3dxg,7GRhBDsirIGkRZBtSMEzNTyDr2JQm4xx,97,116,37,6,55,275,62,0,551,78.71428571428571,16,0.0,45,37,5,55,71,275,1,62,0,142,409,0
17,320,2zijdtZPcsrYvyvmgApN5PnCXULBsIBX,7GRhBDsirIGkRZBtSMEzNTyDr2JQm4xx,1,0,0,0,0,0,1,0,1,0.14285714285714285,1,0.0,0,0,0,0,0,0,0,1,0,0,1,1
18,373,XUkSDdNHWcdano4aRGWpLSTI2IF8D1IH,7GRhBDsirIGkRZBtSMEzNTyDr2JQm4xx,48,139,55,68,3,50,32,3,350,50.0,6,0.0,37,55,59,3,102,50,9,32,3,154,196,0
19,433,PEDnL2c66c2DN92O9BTVM9D6p19gGbT6,7GRhBDsirIGkRZBtSMEzNTyDr2JQm4xx,61,128,56,57,43,62,31,1,378,54.0,15,0.0,68,56,50,43,60,62,7,31,1,217,161,0
20,493,xNkIHhqS8GZXIqyoWwwS3ZeYfSmUsNJo,7GRhBDsirIGkRZBtSMEzNTyDr2JQm4xx,39,80,23,54,23,0,4,0,184,26.285714285714285,7,0.0,27,23,44,23,53,0,10,4,0,117,67,0
21,555,tiLrccMjeOBHHBLooSoPfc0IKYtAsyXK,7GRhBDsirIGkRZBtSMEzNTyDr2JQm4xx,2,0,0,0,0,0,3,0,3,0.42857142857142855,2,0.0,0,0,0,0,0,0,0,3,0,0,3,1
22,630,BbZEGv8zMCuD8c0LXrenf9W1lGSlVd04,7GRhBDsirIGkRZBtSMEzNTyDr2JQm4xx,10,49,6,0,0,1,10,0,66,9.428571428571429,2,0.0,0,6,0,0,49,1,0,10,0,6,60,1
23,777,bLIF0ETNcg7fjkutu8YBWJptM3zxtu2Z,7GRhBDsirIGkRZBtSMEzNTyDr2JQm4xx,67,151,60,107,64,23,44,0,449,64.14285714285714,11,0.0,84,60,97,64,67,23,10,44,0,305,144,0
24,780,anqtRE1JbVfWjk9aVYgpNXBcTCoFe9WO,7GRhBDsirIGkRZBtSMEzNTyDr2JQm4xx,77,176,70,82,49,16,40,4,437,62.42857142857143,11,0.0,72,70,71,49,104,16,11,40,4,262,175,1
25,796,6gLqDWyaI2NtlxSWPzL6286Swi1mEUeL,7GRhBDsirIGkRZBtSMEzNTyDr2JQm4xx,2,0,0,0,0,0,2,0,2,0.2857142857142857,1,0.0,0,0,0,0,0,0,0,2,0,0,2,1
26,833,TOPojNiMH24da1PoGtHTHtr3v40hc02S,7GRhBDsirIGkRZBtSMEzNTyDr2JQm4xx,10,7,0,19,0,0,6,0,32,4.571428571428571,1,0.0,3,0,16,0,4,0,3,6,0,19,13,1
27,845,bY5BU72AucM53Ivc1aSf6rn9i7DKfcQZ,7GRhBDsirIGkRZBtSMEzNTyDr2JQm4xx,1,0,0,0,0,0,1,0,1,0.14285714285714285,1,0.0,0,0,0,0,0,0,0,1,0,0,1,1
28,884,c3CVim2QZeSVk1wACFUHDmf9ZjEIwtuP,7GRhBDsirIGkRZBtSMEzNTyDr2JQm4xx,58,113,36,144,27,0,11,0,331,47.285714285714285,3,0.0,73,36,120,27,40,0,24,11,0,256,75,0
29,936,Z4uUjFPFbGNbmcg4E2opeBQCoO0nQyZe,7GRhBDsirIGkRZBtSMEzNTyDr2JQm4xx,58,352,100,95,46,18,39,0,650,92.85714285714286,12,0.0,140,100,74,46,212,18,21,39,0,360,290,1
30,937,uQjl8NGtIQkRfoe9edBiMgtYYmdkzVXR,7GRhBDsirIGkRZBtSMEzNTyDr2JQm4xx,64,203,62,146,24,24,21,0,480,68.57142857142857,13,0.0,87,62,123,24,116,24,23,21,0,296,184,0
31,956,SIuVkNKTY2J1cPfs6wUSNXAjh8XyxgwI,7GRhBDsirIGkRZBtSMEzNTyDr2JQm4xx,1,0,0,0,0,0,1,0,1,0.14285714285714285,1,0.0,0,0,0,0,0,0,0,1,0,0,1,1
32,966,uVv1ioGVvP0A5CGQgSQhVTbH75lJRG4O,7GRhBDsirIGkRZBtSMEzNTyDr2JQm4xx,8,11,1,0,2,2,8,1,25,3.5714285714285716,4,0.0,2,1,0,2,9,2,0,8,1,5,20,1
33,991,HvUs11HJgqndKBOynrg9yliToxZs6PoS,7GRhBDsirIGkRZBtSMEzNTyDr2JQm4xx,20,26,12,0,10,0,3,0,51,7.285714285714286,1,0.0,6,12,0,10,20,0,0,3,0,28,23,0
34,999,sGrMSEzmd0nQ8tazrPYbRhLOuMlMN34w,7GRhBDsirIGkRZBtSMEzNTyDr2JQm4xx,5,4,2,0,0,0,5,0,11,1.5714285714285714,1,0.0,1,2,0,0,3,0,0,5,0,3,8,1
35,1030,uDdfaOyae5qLVYC8BQlj5xLhiV3is9wS,7GRhBDsirIGkRZBtSMEzNTyDr2JQm4xx,73,272,135,7,76,292,46,1,829,118.42857142857143,15,0.0,109,135,5,76,163,292,2,46,1,325,504,0
36,1052,db3m19q36pgCYtTdKoL3kV4Ubidysmpw,7GRhBDsirIGkRZBtSMEzNTyDr2JQm4xx,1,0,0,0,0,0,1,0,1,0.14285714285714285,1,0.0,0,0,0,0,0,0,0,1,0,0,1,1
37,1090,9ct6Fth9rRpjZJrFIHs9xOnW9W5hBHw6,7GRhBDsirIGkRZBtSMEzNTyDr2JQm4xx,54,120,40,141,22,4,14,0,341,48.714285714285715,6,0.0,69,40,123,22,51,4,18,14,0,254,87,1
38,1134,Q3zkClKdiEJIkoKspwBuSNOwYXuxalAX,7GRhBDsirIGkRZBtSMEzNTyDr2JQm4xx,49,76,27,24,21,6,23,0,177,25.285714285714285,8,0.0,32,27,24,21,44,6,0,23,0,104,73,1
39,1147,gCxbOVEJ7FeSqOiwKbB6HzPEL3I9x6ca,7GRhBDsirIGkRZBtSMEzNTyDr2JQm4xx,71,117,51,127,22,48,19,1,385,55.0,6,0.0,53,51,103,22,64,48,24,19,1,229,156,0
40,1206,ymJGsoe3Y9XwSfD9UhxMG8gRl87RdPUe,7GRhBDsirIGkRZBtSMEzNTyDr2JQm4xx,41,97,45,44,21,2,12,0,221,31.571428571428573,8,0.0,31,45,38,21,66,2,6,12,0,135,86,1
41,1223,o7MfiO1X5Ui1AYG08PXFhTcXSShcuNhK,7GRhBDsirIGkRZBtSMEzNTyDr2JQm4xx,59,80,47,98,34,13,17,3,292,41.714285714285715,7,0.0,23,47,89,34,57,13,9,17,3,193,99,0
42,1227,RuOAeaUVW53IP9AqfP0jxaXbNkmd7lKN,7GRhBDsirIGkRZBtSMEzNTyDr2JQm4xx,25,30,1,38,3,0,12,0,84,12.0,4,0.0,19,1,33,3,11,0,5,12,0,56,28,0
43,1252,mZIaM3Lmux7GERtSm258BKPOSUYFlwyy,7GRhBDsirIGkRZBtSMEzNTyDr2JQm4xx,78,247,54,131,40,77,33,0,582,83.14285714285714,14,0.0,88,54,109,40,159,77,22,33,0,291,291,0
44,1255,jB9rh6QoUWlta1KDWb4mdWzYIut8deHu,7GRhBDsirIGkRZBtSMEzNTyDr2JQm4xx,6,3,1,0,1,0,2,0,7,1.0,1,0.0,0,1,0,1,3,0,0,2,0,2,5,1
45,1260,beV03mdN2n7VoZwDqBMCKGETqOChXWUx,7GRhBDsirIGkRZBtSMEzNTyDr2JQm4xx,70,348,108,112,47,81,40,4,740,105.71428571428571,7,0.0,120,108,104,47,228,81,8,40,4,379,361,0
46,1269,RSJQ68OFisJaYDiRNDqeLSdLFyonAIP1,7GRhBDsirIGkRZBtSMEzNTyDr2JQm4xx,4,3,1,0,0,0,2,0,6,0.8571428571428571,1,0.0,0,1,0,0,3,0,0,2,0,1,5,1
47,1289,zlsPhArkUaQ0CCdgZTO1797WJjiciHBk,7GRhBDsirIGkRZBtSMEzNTyDr2JQm4xx,69,182,65,132,44,88,26,1,538,76.85714285714286,9,0.0,68,65,112,44,114,88,20,26,1,289,249,0
48,1315,kNG9cn23NW62SZcqQSqyW9wMtO0GajdN,7GRhBDsirIGkRZBtSMEzNTyDr2JQm4xx,63,118,32,183,32,8,11,1,385,55.0,5,0.0,76,32,156,32,42,8,27,11,1,296,89,0
49,1345,eyksoE4AUoKYBpwx782vtNzuK4dwKRY9,7GRhBDsirIGkRZBtSMEzNTyDr2JQm4xx,10,15,4,0,2,1,6,1,29,4.142857142857143,1,0.0,9,4,0,2,6,1,0,6,1,15,14,1
50,1381,8W0dKFntzVy5gs8nAvO6lyUGOY4SLHwO,7GRhBDsirIGkRZBtSMEzNTyDr2JQm4xx,4,2,0,0,0,0,2,0,4,0.5714285714285714,1,0.0,0,0,0,0,2,0,0,2,0,0,4,1
51,1429,YbP52dGau1RB8H6599HdGbUKOVHWxxw1,7GRhBDsirIGkRZBtSMEzNTyDr2JQm4xx,72,243,103,136,34,13,14,0,543,77.57142857142857,6,0.0,106,103,103,34,137,13,33,14,0,346,197,0
52,1450,q88579uTDrz7tsNTbZoL3mbWXAP4ClqK,7GRhBDsirIGkRZBtSMEzNTyDr2JQm4xx,75,191,72,50,47,35,53,13,461,65.85714285714286,10,0.0,98,72,44,47,93,35,6,53,13,261,200,0
53,1472,Qc7qhDYnMQ0se5itn8lyxOFjZ1zzyfhE,7GRhBDsirIGkRZBtSMEzNTyDr2JQm4xx,67,189,42,186,41,49,46,3,556,79.42857142857143,7,0.0,82,42,161,41,107,49,25,46,3,326,230,0
54,1491,lCyf3TRKW0i3K1mBgKz23OONMdCWqNsI,7GRhBDsirIGkRZBtSMEzNTyDr2JQm4xx,72,309,14,223,31,53,83,11,724,103.42857142857143,10,0.0,185,14,192,31,124,53,31,83,11,422,302,0
55,1502,1rAHmNrxrqnzHEQFMlydmQ968LsZW0oG,7GRhBDsirIGkRZBtSMEzNTyDr2JQm4xx,33,71,26,33,14,5,4,0,153,21.857142857142858,3,0.0,40,26,31,14,31,5,2,4,0,111,42,0
56,1529,DT600yQDJaU6nnkoEQdVx5gZnWz5FfNY,7GRhBDsirIGkRZBtSMEzNTyDr2JQm4xx,56,238,9,196,14,18,35,1,511,73.0,5,0.0,92,9,171,14,146,18,25,35,1,286,225,0
57,1541,Ydg0lHV8igjCQUoXTu9LI2axWzXgXWvH,7GRhBDsirIGkRZBtSMEzNTyDr2JQm4xx,5,2,1,0,0,0,3,0,6,0.8571428571428571,1,0.0,0,1,0,0,2,0,0,3,0,1,5,1
58,1576,d9rEzZ3v1PmiMyudpVDJ4ystf1RU9dCH,7GRhBDsirIGkRZBtSMEzNTyDr2JQm4xx,18,33,8,8,3,1,22,2,77,11.0,6,0.0,8,8,7,3,25,1,1,22,2,26,51,1
59,1593,rLQXRKLwDTvBugA3fH8VUxASy31pAAsE,7GRhBDsirIGkRZBtSMEzNTyDr2JQm4xx,77,283,94,164,42,93,21,5,702,100.28571428571429,13,0.0,160,94,136,42,123,93,28,21,5,432,270,1
60,1594,argwyep7vMTLtgODtMQ0gxLXJNoq9csR,7GRhBDsirIGkRZBtSMEzNTyDr2JQm4xx,42,126,23,65,16,0,18,0,248,35.42857142857143,10,0.0,49,23,56,16,77,0,9,18,0,144,104,1
61,1616,Bi4hHmeTLwTbUCScu9tC6ZZN7frLUhVP,7GRhBDsirIGkRZBtSMEzNTyDr2JQm4xx,60,136,45,84,26,0,13,0,304,43.42857142857143,4,0.0,68,45,82,26,68,0,2,13,0,221,83,0
62,1630,BN8wlDCfm46NLUt2P4jjdpJvase6IJc9,7GRhBDsirIGkRZBtSMEzNTyDr2JQm4xx,46,150,41,56,18,20,22,0,307,43.857142857142854,8,0.0,70,41,53,18,80,20,3,22,0,182,125,1
63,1651,iR2FNNwwVPECfrAWwxLxHcw8art5BqJj,7GRhBDsirIGkRZBtSMEzNTyDr2JQm4xx,55,171,57,93,62,7,10,0,400,57.142857142857146,4,0.0,82,57,72,62,89,7,21,10,0,273,127,0
64,1685,rAPaguNT0tnoFK76JileqLEbVcmAD9at,7GRhBDsirIGkRZBtSMEzNTyDr2JQm4xx,1,0,0,0,0,0,1,0,1,0.14285714285714285,1,0.0,0,0,0,0,0,0,0,1,0,0,1,1
65,1697,LdIFMEp4Gma3xMuOQ2mpp1BJ3jFvB9c2,7GRhBDsirIGkRZBtSMEzNTyDr2JQm4xx,78,152,43,122,41,3,6,0,367,52.42857142857143,9,0.0,59,43,99,41,93,3,23,6,0,242,125,0
66,1708,PVIjAE0m0OeJAYOHc5gIjzktRijtXdS4,7GRhBDsirIGkRZBtSMEzNTyDr2JQm4xx,48,90,32,91,22,4,11,1,251,35.857142857142854,4,0.0,48,32,77,22,42,4,14,11,1,179,72,1
67,1724,yXGb0Kuxvr3gyMDMjDKW3Llv1qZCYjSd,7GRhBDsirIGkRZBtSMEzNTyDr2JQm4xx,1,0,0,0,0,0,1,0,1,0.14285714285714285,1,0.0,0,0,0,0,0,0,0,1,0,0,1,1
68,1728,B6EpScn9lSCPa3RR6ElGV7QvO5jse6Q3,7GRhBDsirIGkRZBtSMEzNTyDr2JQm4xx,1,0,0,0,0,0,1,0,1,0.14285714285714285,1,0.0,0,0,0,0,0,0,0,1,0,0,1,1
69,1755,qLrXKwo0jPQz47eKqKRnMiywjqEMxYd1,7GRhBDsirIGkRZBtSMEzNTyDr2JQm4xx,92,173,52,135,46,16,19,0,441,63.0,6,0.0,66,52,119,46,107,16,16,19,0,283,158,0
70,1756,wc32nzp9MMjroUa1gifXyCPIfYwLXy9J,7GRhBDsirIGkRZBtSMEzNTyDr2JQm4xx,36,61,27,39,20,10,28,2,187,26.714285714285715,10,0.0,22,27,34,20,39,10,5,28,2,103,84,1
71,1788,ZsmdkNcVTPviDi6RDTzc0nnIspFki9Ld,7GRhBDsirIGkRZBtSMEzNTyDr2JQm4xx,29,49,24,34,6,6,9,0,128,18.285714285714285,4,0.0,21,24,31,6,28,6,3,9,0,82,46,0
72,1801,wy2vY5aiYwg0C5zglGAXrG2vaWLSbGC9,fbPkOYLVPtPgIt0MxizjfFJov3JbHyAi,7,3,2,0,2,0,2,0,9,1.2857142857142858,1,0.0,0,2,0,2,3,0,0,2,0,4,5,1
73,1803,MlHPKmdi90dDdvX24jYoFlYEp8xS4RGn,fbPkOYLVPtPgIt0MxizjfFJov3JbHyAi,4,0,0,0,0,0,4,0,4,0.5714285714285714,1,0.0,0,0,0,0,0,0,0,4,0,0,4,1
74,1804,qRMvc4T53dkwmyfrgm76E5HygPUZo2vr,fbPkOYLVPtPgIt0MxizjfFJov3JbHyAi,52,157,68,36,30,158,55,5,509,72.71428571428571,17,0.0,44,68,30,30,113,158,6,55,5,172,337,0
75,1807,tvXgoUvFgvHT9SyDah6Ue0bK2mvIbZdy,fbPkOYLVPtPgIt0MxizjfFJov3JbHyAi,58,190,121,68,48,108,32,0,567,81.0,9,0.0,49,121,53,48,141,108,15,32,0,271,296,0
76,1811,466PN9Ek5iJamUCk5pZUwazAoeVcTj9e,fbPkOYLVPtPgIt0MxizjfFJov3JbHyAi,7,11,6,0,4,0,4,0,25,3.5714285714285716,2,0.0,2,6,0,4,9,0,0,4,0,12,13,1
77,1815,EZXku3HiM8iDGMBMsO2RMLHj3AEpHhBq,fbPkOYLVPtPgIt0MxizjfFJov3JbHyAi,25,69,3,11,15,22,10,2,132,18.857142857142858,4,0.0,30,3,10,15,39,22,1,10,2,58,74,0
78,1817,bXMaalfz1ZqHKnJWw6VXCAoemSeuw45Q,fbPkOYLVPtPgIt0MxizjfFJov3JbHyAi,2,0,0,0,0,0,2,0,2,0.2857142857142857,1,0.0,0,0,0,0,0,0,0,2,0,0,2,0
79,1818,pIBqJuNsqTHvkyItKwWF6wLVRjCC6EZu,fbPkOYLVPtPgIt0MxizjfFJov3JbHyAi,10,34,17,0,9,5,23,0,88,12.571428571428571,2,0.0,7,17,0,9,27,5,0,23,0,33,55,1
80,1819,dg1Id0ZrueajjkgW22Z2GRzCY20snksW,fbPkOYLVPtPgIt0MxizjfFJov3JbHyAi,2,0,0,0,0,0,3,0,3,0.42857142857142855,2,0.0,0,0,0,0,0,0,0,3,0,0,3,1
81,1821,dovSPYooNHmzLLH97Ddy4FG7Uxhw5XJl,fbPkOYLVPtPgIt0MxizjfFJov3JbHyAi,5,4,2,0,1,0,1,0,8,1.1428571428571428,1,0.0,0,2,0,1,4,0,0,1,0,3,5,1
82,1822,v1Dw0XqubI6wLrO1l5puralkQ2Aofi2j,fbPkOYLVPtPgIt0MxizjfFJov3JbHyAi,61,163,66,63,48,212,58,13,623,89.0,16,0.0,67,66,47,48,96,212,16,58,13,228,395,0
83,1823,SnTftKVvcKGSnHeK28R5spRYYXrrxUfB,fbPkOYLVPtPgIt0MxizjfFJov3JbHyAi,7,5,3,0,2,0,4,0,14,2.0,1,0.0,0,3,0,2,5,0,0,4,0,5,9,1
84,1826,5BwluL2iwK0HgKhM8FgXFAWZQHsXkB8V,fbPkOYLVPtPgIt0MxizjfFJov3JbHyAi,42,79,16,27,17,51,30,3,223,31.857142857142858,8,0.0,23,16,26,17,56,51,1,30,3,82,141,0
85,1827,tfcv93vJo2GySad9H44VOkIGpLaZ6vJT,fbPkOYLVPtPgIt0MxizjfFJov3JbHyAi,49,155,70,49,36,113,37,1,461,65.85714285714286,7,0.0,56,70,40,36,99,113,9,37,1,202,259,0
86,1830,dtAiYXul2PNEQLlJvo6qGgg8Rx9ORbY3,fbPkOYLVPtPgIt0MxizjfFJov3JbHyAi,8,6,4,0,2,1,9,1,23,3.2857142857142856,2,0.0,0,4,0,2,6,1,0,9,1,6,17,1
87,1832,IIfD9UPHJEG512IBEQGZwkZbr6HRQ12X,fbPkOYLVPtPgIt0MxizjfFJov3JbHyAi,17,7,5,7,5,6,17,0,47,6.714285714285714,3,0.0,1,5,4,5,6,6,3,17,0,15,32,1
88,1835,EF6CIWnoQbVOAhqoxFyrjqUraX7wKiE2,fbPkOYLVPtPgIt0MxizjfFJov3JbHyAi,7,3,1,0,1,0,5,0,10,1.4285714285714286,1,0.0,0,1,0,1,3,0,0,5,0,2,8,1
89,1844,FSrU0Uh74oBwrZKS577R74m2Rk2Lst8A,fbPkOYLVPtPgIt0MxizjfFJov3JbHyAi,12,11,9,0,7,0,9,0,36,5.142857142857143,1,0.0,0,9,0,7,11,0,0,9,0,16,20,1
90,1845,oaoj9be4jW2Hot8wYgYrzLRvB0RU4KYy,fbPkOYLVPtPgIt0MxizjfFJov3JbHyAi,5,18,7,0,1,0,8,0,34,4.857142857142857,7,0.0,0,7,0,1,18,0,0,8,0,8,26,0
91,1852,srnnzUkIJr2Uisav8LfnV4SnpbNw9CLp,fbPkOYLVPtPgIt0MxizjfFJov3JbHyAi,8,10,5,0,3,1,4,0,23,3.2857142857142856,1,0.0,3,5,0,3,7,1,0,4,0,11,12,1
92,1856,ScOtpH9Zf7UmvFfXBxi9XtXFmhGO9CpS,fbPkOYLVPtPgIt0MxizjfFJov3JbHyAi,62,143,58,50,52,124,56,4,487,69.57142857142857,15,0.0,55,58,47,52,88,124,3,56,4,212,275,0
93,1859,renLevNnf6MkkqeGAoBcuGxp4Cuebb9X,fbPkOYLVPtPgIt0MxizjfFJov3JbHyAi,21,69,38,13,16,66,71,12,285,40.714285714285715,7,0.0,6,38,10,16,63,66,3,71,12,70,215,0
94,1861,wHW6M4zJx3WQvnkWxa8NK7bA13uSffjE,fbPkOYLVPtPgIt0MxizjfFJov3JbHyAi,63,280,155,61,73,161,65,12,807,115.28571428571429,16,0.0,76,155,49,73,204,161,12,65,12,353,454,0
95,1862,w85QVmINOIyrXRzegh8uuBeGTw3K4uG8,fbPkOYLVPtPgIt0MxizjfFJov3JbHyAi,27,61,27,8,18,33,14,2,163,23.285714285714285,5,0.0,24,27,8,18,37,33,0,14,2,77,86,0
96,1863,2HxHgYZUxjcTVAkRZXALZPpAKp12AIkW,fbPkOYLVPtPgIt0MxizjfFJov3JbHyAi,29,66,23,13,22,35,28,4,191,27.285714285714285,6,0.0,16,23,9,22,50,35,4,28,4,70,121,1
97,1875,NmOI6yuIgn0ShW8ps51AeOISH4CX20PY,fbPkOYLVPtPgIt0MxizjfFJov3JbHyAi,2,0,0,0,0,0,3,0,3,0.42857142857142855,1,0.0,0,0,0,0,0,0,0,3,0,0,3,1
98,1878,0UPVw8ecIiIpfGXqAIUJXTbKxiiOJqXC,fbPkOYLVPtPgIt0MxizjfFJov3JbHyAi,12,17,8,4,6,4,3,0,42,6.0,2,0.0,2,8,3,6,15,4,1,3,0,19,23,1
99,1880,DSWjfYVjIvEWi0MzNQ04NT3mnhbcHkJI,fbPkOYLVPtPgIt0MxizjfFJov3JbHyAi,18,9,8,0,7,0,2,0,26,3.7142857142857144,1,0.0,0,8,0,7,9,0,0,2,0,15,11,0
100,1888,lbgTV2YMskSv2TX4EXpaazpMVWfsftEV,fbPkOYLVPtPgIt0MxizjfFJov3JbHyAi,9,14,9,0,4,0,8,0,35,5.0,1,0.0,0,9,0,4,14,0,0,8,0,13,22,0
101,1891,s6iksgptFmyh2vfiarKdJkiKnp6RLi3f,fbPkOYLVPtPgIt0MxizjfFJov3JbHyAi,24,56,20,0,8,143,21,1,249,35.57142857142857,8,0.0,3,20,0,8,53,143,0,21,1,31,218,0
102,1894,Vc4rFh1HQZiO6qLgOrealEeiZYYPbmOY,fbPkOYLVPtPgIt0MxizjfFJov3JbHyAi,60,109,49,78,23,50,17,0,326,46.57142857142857,10,0.0,18,49,64,23,91,50,14,17,0,154,172,0
103,1899,CXDFvBGg10x2RDdl5BC09Fv76dN9FJm7,fbPkOYLVPtPgIt0MxizjfFJov3JbHyAi,60,118,32,70,26,23,18,0,287,41.0,5,0.0,43,32,68,26,75,23,2,18,0,169,118,0
104,1903,TkQQvYTOoXkFjbJKIO2v3OeQa3imG4fA,fbPkOYLVPtPgIt0MxizjfFJov3JbHyAi,62,136,48,28,47,99,41,2,401,57.285714285714285,10,0.0,72,48,25,47,64,99,3,41,2,192,209,0
105,1910,CtgLRd04Cnda49EWlN19NulXjkuBNDXd,fbPkOYLVPtPgIt0MxizjfFJov3JbHyAi,44,62,20,32,18,34,5,0,171,24.428571428571427,4,0.0,21,20,28,18,41,34,4,5,0,87,84,0
106,1913,OXDIjQPBiuWpB7PdzfniEtiITaq40Kxq,fbPkOYLVPtPgIt0MxizjfFJov3JbHyAi,1,0,0,0,0,0,2,0,2,0.2857142857142857,1,0.0,0,0,0,0,0,0,0,2,0,0,2,1
107,1922,ddq0oVEKEWGKWnbGS4cfbzVZj0yFimxw,fbPkOYLVPtPgIt0MxizjfFJov3JbHyAi,39,51,38,19,22,0,10,0,140,20.0,6,0.0,7,38,16,22,44,0,3,10,0,83,57,0
108,1923,UgNr6maIjrTPAjpLAvEGxJ6P02hrpr0j,fbPkOYLVPtPgIt0MxizjfFJov3JbHyAi,48,137,54,47,34,17,32,1,322,46.0,14,0.0,30,54,44,34,107,17,3,32,1,162,160,0
109,1926,5ZyvCd3AP7a8azCiLN5JfLAP53iZpAyD,fbPkOYLVPtPgIt0MxizjfFJov3JbHyAi,1,0,0,0,0,0,1,0,1,0.14285714285714285,1,0.0,0,0,0,0,0,0,0,1,0,0,1,1
110,1929,v9mjKPlqj9n2M1xFKzFtpQVo3yi6HxGV,fbPkOYLVPtPgIt0MxizjfFJov3JbHyAi,5,3,2,0,1,0,2,0,8,1.1428571428571428,1,0.0,0,2,0,1,3,0,0,2,0,3,5,1
111,1931,gUUf0vmNg6gEFqYol91VXQX0Cn6Mly3v,fbPkOYLVPtPgIt0MxizjfFJov3JbHyAi,61,180,122,31,75,60,9,4,481,68.71428571428571,12,0.0,39,122,28,75,141,60,3,9,4,264,217,0
112,1932,0QuoKrP2mZHT58SMwYhNVh8QIa2Bx3jw,fbPkOYLVPtPgIt0MxizjfFJov3JbHyAi,17,17,11,0,9,3,8,3,51,7.285714285714286,1,0.0,2,11,0,9,15,3,0,8,3,22,29,0
113,1933,mNLR1O6gqXF6Zqi4uIf130gITni9gN1A,fbPkOYLVPtPgIt0MxizjfFJov3JbHyAi,61,129,74,23,39,29,30,3,327,46.714285714285715,14,0.0,20,74,23,39,109,29,0,30,3,156,171,0
114,1936,YLLq9nLffaF9TP2dJ2OpMZwhKv5cSnoB,fbPkOYLVPtPgIt0MxizjfFJov3JbHyAi,13,16,7,2,6,2,1,0,34,4.857142857142857,1,0.0,5,7,2,6,11,2,0,1,0,20,14,1
115,1939,GpNHaNdhxCDdSQ7DpRSuzDihSlnkIh3f,fbPkOYLVPtPgIt0MxizjfFJov3JbHyAi,9,2,1,0,1,0,5,1,10,1.4285714285714286,1,0.0,0,1,0,1,2,0,0,5,1,2,8,1
116,1940,a7VEIs7rhyootOFOxpi9zJBtM0N2POJ5,fbPkOYLVPtPgIt0MxizjfFJov3JbHyAi,7,6,3,0,2,0,2,0,13,1.8571428571428572,2,0.0,1,3,0,2,5,0,0,2,0,6,7,1
117,1943,S1MqxZA8wNnn30FSBfJ8uK4pTicj2Ko9,fbPkOYLVPtPgIt0MxizjfFJov3JbHyAi,47,102,63,27,31,21,36,7,287,41.0,10,0.0,15,63,24,31,87,21,3,36,7,133,154,0
118,1945,KM3IAf1A23ZYRH7BjTN3a6rzUKD52rd8,fbPkOYLVPtPgIt0MxizjfFJov3JbHyAi,9,12,7,0,3,0,16,0,38,5.428571428571429,3,0.0,0,7,0,3,12,0,0,16,0,10,28,1
119,1951,dq3iqibSI5OSwCbWRZv7tfgbiuLwOgjh,fbPkOYLVPtPgIt0MxizjfFJov3JbHyAi,19,37,21,0,14,6,8,3,89,12.714285714285714,3,0.0,2,21,0,14,35,6,0,8,3,37,52,0
120,3982,Dw289XdbVPARtBCp3XyIbEXKo6sChudi,fbPkOYLVPtPgIt0MxizjfFJov3JbHyAi,12,15,5,5,5,8,7,1,46,6.571428571428571,1,0.0,5,5,4,5,10,8,1,7,1,19,27,1
121,3986,lri3Bm6mGdJ1wEpJO4c8fcTdLtxpvXa6,fbPkOYLVPtPgIt0MxizjfFJov3JbHyAi,32,109,35,27,17,55,36,1,280,40.0,6,0.0,32,35,25,17,77,55,2,36,1,109,171,0
122,3987,RvRsXzYULX8CJPXHa5mzL8AcNhscf6wx,fbPkOYLVPtPgIt0MxizjfFJov3JbHyAi,5,7,3,0,2,8,5,0,25,3.5714285714285716,2,0.0,0,3,0,2,7,8,0,5,0,5,20,1
123,3988,n6g50uYKXPDZP0tI3HvDI3sQlgkEYQ9t,fbPkOYLVPtPgIt0MxizjfFJov3JbHyAi,2,0,0,0,0,0,5,0,5,0.7142857142857143,1,0.0,0,0,0,0,0,0,0,5,0,0,5,1
124,3989,WQvAdilRxsksKqQWzKEILUwddYnT927z,fbPkOYLVPtPgIt0MxizjfFJov3JbHyAi,8,19,7,0,5,4,11,0,46,6.571428571428571,3,0.0,0,7,0,5,19,4,0,11,0,12,34,1
125,3990,IjNUKB7dvHimeVQdJPcMV9GHh8X3ACi4,fbPkOYLVPtPgIt0MxizjfFJov3JbHyAi,9,3,2,0,2,0,7,1,15,2.142857142857143,1,0.0,0,2,0,2,3,0,0,7,1,4,11,1
126,3991,affppoxqvCZhtMd3A1khAMJ6PTtvZhf9,fbPkOYLVPtPgIt0MxizjfFJov3JbHyAi,34,82,33,17,30,91,20,10,283,40.42857142857143,6,0.0,36,33,14,30,46,91,3,20,10,113,170,1
127,3992,uzWBIpHNnLP0Ck2jFJb3dlQmKW50Edgg,fbPkOYLVPtPgIt0MxizjfFJov3JbHyAi,9,7,4,0,3,0,12,0,26,3.7142857142857144,1,0.0,0,4,0,3,7,0,0,12,0,7,19,1
128,3993,LBiRwhykvYlkPokFukwKE3pfXRl4e4Nw,fbPkOYLVPtPgIt0MxizjfFJov3JbHyAi,10,50,30,0,12,1,17,1,111,15.857142857142858,6,0.0,3,30,0,12,47,1,0,17,1,45,66,1
129,3994,CAJTHZgER1cUEaMoS6UrUkuHNZZbsU9M,fbPkOYLVPtPgIt0MxizjfFJov3JbHyAi,43,63,27,45,23,23,10,2,193,27.571428571428573,4,0.0,27,27,35,23,36,23,10,10,2,112,81,1
130,3995,TYu8VgV6TkJO1pWVABdfXnpa6VWQUK0O,fbPkOYLVPtPgIt0MxizjfFJov3JbHyAi,11,15,6,3,9,1,7,1,42,6.0,3,0.0,8,6,3,9,7,1,0,7,1,26,16,1
131,3999,4IkxYjTflPhoHxhEdrFyf3T4ZXNMTaKd,fbPkOYLVPtPgIt0MxizjfFJov3JbHyAi,28,103,43,16,16,17,22,0,217,31.0,8,0.0,22,43,14,16,81,17,2,22,0,95,122,0
132,4000,A8rz0vMThAU17OyS7TiHPCSZ088mScoQ,fbPkOYLVPtPgIt0MxizjfFJov3JbHyAi,12,18,10,0,6,0,6,0,40,5.714285714285714,2,0.0,3,10,0,6,15,0,0,6,0,19,21,1
133,4001,NKzNFHK6LaJqjMec69ZX5HfBigF4yyJV,fbPkOYLVPtPgIt0MxizjfFJov3JbHyAi,21,45,4,14,2,48,14,1,128,18.285714285714285,4,0.0,9,4,12,2,36,48,2,14,1,27,101,1
134,4002,MoOt0pLc6LPrRtSRaIbD7yJ5rRpkSxQh,fbPkOYLVPtPgIt0MxizjfFJov3JbHyAi,9,9,3,0,5,10,7,2,36,5.142857142857143,1,0.0,5,3,0,5,4,10,0,7,2,13,23,1
135,4003,DgaifwdXOeOWB23pZZjNIgSww1uVv3vI,fbPkOYLVPtPgIt0MxizjfFJov3JbHyAi,6,5,2,0,1,0,9,0,17,2.4285714285714284,1,0.0,0,2,0,1,5,0,0,9,0,3,14,1
136,4005,HAPPxnLUjIhcauBZnnWBFk3JE6gETTxa,fbPkOYLVPtPgIt0MxizjfFJov3JbHyAi,8,5,3,0,2,0,4,0,14,2.0,2,0.0,0,3,0,2,5,0,0,4,0,5,9,0
137,4006,McVFksjsd7gqjfpNdRYswxB6Ly7zMDUI,fbPkOYLVPtPgIt0MxizjfFJov3JbHyAi,11,26,11,22,7,24,23,1,114,16.285714285714285,2,0.0,9,11,13,7,17,24,9,23,1,40,74,1
138,4010,tCXUYAVw455MAJWBfBlKD9PaArTnum6K,fbPkOYLVPtPgIt0MxizjfFJov3JbHyAi,5,2,1,0,1,0,3,0,7,1.0,1,0.0,0,1,0,1,2,0,0,3,0,2,5,1
139,4013,mDG9Rxl75Wy9jJLHldZXeLQnqCWbJnNh,fbPkOYLVPtPgIt0MxizjfFJov3JbHyAi,9,10,6,0,4,0,7,0,27,3.857142857142857,1,0.0,0,6,0,4,10,0,0,7,0,10,17,1
140,4014,cDTJe7mzABgZuuhVrbXbLDlWeF860dTW,fbPkOYLVPtPgIt0MxizjfFJov3JbHyAi,5,4,2,0,1,2,2,0,11,1.5714285714285714,1,0.0,0,2,0,1,4,2,0,2,0,3,8,1
141,4015,Sqb9rCT9CzMY8ZiGPrmmTQHW8dIqJZBT,fbPkOYLVPtPgIt0MxizjfFJov3JbHyAi,1,0,0,0,0,0,1,0,1,0.14285714285714285,1,0.0,0,0,0,0,0,0,0,1,0,0,1,1
142,4016,0OQWZBG0W4kepi8nreWMZMMypwSc3KLe,fbPkOYLVPtPgIt0MxizjfFJov3JbHyAi,30,102,62,16,24,67,27,2,300,42.857142857142854,10,0.0,24,62,14,24,78,67,2,27,2,124,176,0
143,4017,R0BF3k8rl0hN1Xjq59ZjmegVjqcKX9oA,fbPkOYLVPtPgIt0MxizjfFJov3JbHyAi,12,25,8,9,3,6,4,0,55,7.857142857142857,4,0.0,6,8,7,3,19,6,2,4,0,24,31,1
144,4018,PueCTOZid1NIenGrGQNvEExDupERGR94,fbPkOYLVPtPgIt0MxizjfFJov3JbHyAi,6,15,2,0,0,21,5,0,43,6.142857142857143,3,0.0,1,2,0,0,14,21,0,5,0,3,40,1
145,4019,dFrBZuKOTxv7Ek84BAuACScgZVHLiPRz,fbPkOYLVPtPgIt0MxizjfFJov3JbHyAi,27,89,50,15,30,40,17,1,242,34.57142857142857,6,0.0,18,50,12,30,71,40,3,17,1,110,132,0
146,4021,2txyeJeVHewFPGKztIs7LVNsRtu62SIj,fbPkOYLVPtPgIt0MxizjfFJov3JbHyAi,15,29,19,16,13,0,10,0,87,12.428571428571429,6,0.0,4,19,14,13,25,0,2,10,0,50,37,0
147,4022,CNy8nHnus6ReY45d9zqNv8rRJDfMythS,fbPkOYLVPtPgIt0MxizjfFJov3JbHyAi,10,11,5,0,5,0,5,0,26,3.7142857142857144,2,0.0,2,5,0,5,9,0,0,5,0,12,14,1
148,4024,UInMBEH8f1h2vxXVslRsWyLOTv8ggYq3,fbPkOYLVPtPgIt0MxizjfFJov3JbHyAi,49,200,97,20,54,255,37,4,667,95.28571428571429,12,0.0,47,97,15,54,153,255,5,37,4,213,454,0
149,4025,0XUEmNa1QlvbJ6h0wBm0Vh8YELQW58i8,fbPkOYLVPtPgIt0MxizjfFJov3JbHyAi,2,0,0,0,0,0,3,0,3,0.42857142857142855,1,0.0,0,0,0,0,0,0,0,3,0,0,3,1
150,4026,OMzzJICpXQ12vN2QhxiLmWbQhc59H2Je,fbPkOYLVPtPgIt0MxizjfFJov3JbHyAi,19,30,13,0,10,118,13,0,184,26.285714285714285,3,0.0,8,13,0,10,22,118,0,13,0,31,153,1
151,4028,BJaK31XM4DCMgldXltRIhwlSVt79ImvN,fbPkOYLVPtPgIt0MxizjfFJov3JbHyAi,1,0,0,0,0,0,2,0,2,0.2857142857142857,2,0.0,0,0,0,0,0,0,0,2,0,0,2,1
152,4029,Wkp6iolUyaZoJ05flcS8uKmcM1K0sTAZ,fbPkOYLVPtPgIt0MxizjfFJov3JbHyAi,6,7,4,0,2,1,3,0,17,2.4285714285714284,1,0.0,0,4,0,2,7,1,0,3,0,6,11,1
153,4030,qdFvSvAu7YEiiOuRfROhUegKEcAw8WjI,fbPkOYLVPtPgIt0MxizjfFJov3JbHyAi,9,7,3,0,3,0,5,0,18,2.5714285714285716,2,0.0,0,3,0,3,7,0,0,5,0,6,12,1
154,4031,l5LfU8gApOG72AnBkdAbfOLQLwFH7Zo2,fbPkOYLVPtPgIt0MxizjfFJov3JbHyAi,18,39,6,9,3,13,12,0,82,11.714285714285714,8,0.0,5,6,7,3,34,13,2,12,0,21,61,0
155,4035,YJ5mxpUsuGnox6GEy3E35b75l1Yuk6TC,fbPkOYLVPtPgIt0MxizjfFJov3JbHyAi,1,0,0,0,0,0,1,0,1,0.14285714285714285,1,0.0,0,0,0,0,0,0,0,1,0,0,1,1
156,4036,Y75HPUfsmJFX2l4CIc47CvtaKqz7eTTH,fbPkOYLVPtPgIt0MxizjfFJov3JbHyAi,5,2,1,0,1,0,2,0,6,0.8571428571428571,1,0.0,0,1,0,1,2,0,0,2,0,2,4,1
157,4039,nPGsjt6sk2qCL2FY7YNDGlVui96j8qhd,fbPkOYLVPtPgIt0MxizjfFJov3JbHyAi,24,22,10,14,11,0,7,0,64,9.142857142857142,2,0.0,10,10,13,11,12,0,1,7,0,44,20,0
158,4040,tmmvczbZLiPw6t5Ru9DTWRYnvMI3hKxN,fbPkOYLVPtPgIt0MxizjfFJov3JbHyAi,7,28,11,0,7,5,9,1,61,8.714285714285714,2,0.0,0,11,0,7,28,5,0,9,1,18,43,1
159,4042,03I1lWZt67ECKkJOIVeqAmBCKjZopH4v,fbPkOYLVPtPgIt0MxizjfFJov3JbHyAi,15,26,15,7,9,11,13,0,81,11.571428571428571,8,0.0,4,15,5,9,22,11,2,13,0,33,48,1
160,4044,dQeQGMqD2AfjLt9WMqT1wjR4i8srmTVY,fbPkOYLVPtPgIt0MxizjfFJov3JbHyAi,7,6,4,0,3,0,2,0,15,2.142857142857143,2,0.0,0,4,0,3,6,0,0,2,0,7,8,1
161,4046,FUyt82uYcKeXe5a1uDqi5Za4PXy0kx7h,fbPkOYLVPtPgIt0MxizjfFJov3JbHyAi,9,8,2,3,4,0,6,0,23,3.2857142857142856,1,0.0,5,2,2,4,3,0,1,6,0,13,10,1
162,4048,pWZNevyPOl4ouTcnYPIT4PYWT7cW7Aq7,fbPkOYLVPtPgIt0MxizjfFJov3JbHyAi,12,29,13,1,11,7,9,1,71,10.142857142857142,4,0.0,10,13,1,11,19,7,0,9,1,35,36,1
163,4052,e1CSwKLgflGiW7QjzYRNEoHjbDEH3F2k,fbPkOYLVPtPgIt0MxizjfFJov3JbHyAi,6,9,0,0,0,0,4,1,14,2.0,3,0.0,0,0,0,0,9,0,0,4,1,0,14,1
164,4054,hOv5RKQK1RGRxpJJGcW0k2cA3RwQ8Rk5,fbPkOYLVPtPgIt0MxizjfFJov3JbHyAi,13,30,12,5,8,22,12,0,89,12.714285714285714,4,0.0,9,12,4,8,21,22,1,12,0,33,56,1
165,4056,jcyuD7rFE4XO7CpWU6qjqHSzjWdDLgUn,fbPkOYLVPtPgIt0MxizjfFJov3JbHyAi,12,19,9,4,6,7,13,0,58,8.285714285714286,2,0.0,7,9,3,6,12,7,1,13,0,25,33,1
166,4060,vag0mKRhWPXqyPdrs8UzxFb02sZFFg3Z,fbPkOYLVPtPgIt0MxizjfFJov3JbHyAi,6,1,1,0,1,1,3,1,8,1.1428571428571428,1,0.0,0,1,0,1,1,1,0,3,1,2,6,1
167,4061,A7tHWOZtAjCVDU6Pkr6MtHjmqydOP5Uv,fbPkOYLVPtPgIt0MxizjfFJov3JbHyAi,8,5,3,0,2,0,2,0,12,1.7142857142857142,1,0.0,1,3,0,2,4,0,0,2,0,6,6,1
168,4062,GfQva8AQrZlwGbvyDGDInKzkvq0dln6l,fbPkOYLVPtPgIt0MxizjfFJov3JbHyAi,12,21,11,0,9,0,6,0,47,6.714285714285714,3,0.0,4,11,0,9,17,0,0,6,0,24,23,1
169,4064,IhporhjBpD87E7pLhYtc9YRC8PipZyt6,fbPkOYLVPtPgIt0MxizjfFJov3JbHyAi,21,58,35,3,19,15,34,4,168,24.0,8,0.0,6,35,3,19,52,15,0,34,4,63,105,1
170,4065,6khySUugasTypUZbIissXWV1lXFT1d5n,fbPkOYLVPtPgIt0MxizjfFJov3JbHyAi,8,5,3,0,2,8,8,1,27,3.857142857142857,1,0.0,0,3,0,2,5,8,0,8,1,5,22,1
171,4066,0m3zP8nDyi6TxYSAa3KOP4WzeZItFG3V,fbPkOYLVPtPgIt0MxizjfFJov3JbHyAi,5,2,1,0,1,0,11,0,15,2.142857142857143,1,0.0,0,1,0,1,2,0,0,11,0,2,13,1
172,4070,bUizg9a7xaQ9xo39EDPwubco3asipi0e,fbPkOYLVPtPgIt0MxizjfFJov3JbHyAi,43,37,31,0,21,7,14,2,112,16.0,6,0.0,0,31,0,21,37,7,0,14,2,52,60,1
173,4071,HH3HV5HDJ35z2ldQAEIDXBOSBTxLd6O9,fbPkOYLVPtPgIt0MxizjfFJov3JbHyAi,24,40,27,12,11,24,17,0,131,18.714285714285715,7,0.0,4,27,10,11,36,24,2,17,0,52,79,1
174,4072,kHp5QZURLzbWn4koqFYZnQmO0kliz5hb,fbPkOYLVPtPgIt0MxizjfFJov3JbHyAi,46,75,43,25,20,33,18,1,215,30.714285714285715,9,0.0,16,43,22,20,59,33,3,18,1,101,114,0
175,4077,reYWWuBxz5Nnxq3jAGjfGe1NyMEEto5R,fbPkOYLVPtPgIt0MxizjfFJov3JbHyAi,27,62,20,12,22,47,37,31,231,33.0,6,0.0,31,20,11,22,31,47,1,37,31,84,147,1
176,4081,GXuacM1G2BzxiXouSVLnDv1V97NGwCCe,fbPkOYLVPtPgIt0MxizjfFJov3JbHyAi,10,17,8,0,3,0,9,1,38,5.428571428571429,2,0.0,0,8,0,3,17,0,0,9,1,11,27,1
177,4083,5tD3trtPQ6jzqFRimP1PMPhgvFtRmfA4,fbPkOYLVPtPgIt0MxizjfFJov3JbHyAi,14,64,7,5,6,6,13,1,102,14.571428571428571,6,0.0,10,7,4,6,54,6,1,13,1,27,75,1
178,4084,a4RYqILKcnu8c617gYSbD0KQIm9DqZnc,fbPkOYLVPtPgIt0MxizjfFJov3JbHyAi,4,6,0,0,0,0,2,0,8,1.1428571428571428,2,0.0,0,0,0,0,6,0,0,2,0,0,8,1
179,4088,czTQ5ELSy91Dy79vk5MgxZdL9nunJtpb,fbPkOYLVPtPgIt0MxizjfFJov3JbHyAi,4,3,0,0,0,0,7,0,10,1.4285714285714286,1,0.0,0,0,0,0,3,0,0,7,0,0,10,1
180,4090,1nooHXMbJhGPsGTrHpT4esI4WCkiFA2H,fbPkOYLVPtPgIt0MxizjfFJov3JbHyAi,8,8,5,0,3,0,6,0,22,3.142857142857143,1,0.0,0,5,0,3,8,0,0,6,0,8,14,1
181,4091,BbZEGv8zMCuD8c0LXrenf9W1lGSlVd04,fbPkOYLVPtPgIt0MxizjfFJov3JbHyAi,18,22,9,8,10,0,3,0,52,7.428571428571429,2,0.0,4,9,5,10,18,0,3,3,0,28,24,1
182,4093,zLfLf7Y2Kf0HyKtBcK0c943FFMXMBiGO,fbPkOYLVPtPgIt0MxizjfFJov3JbHyAi,12,23,7,0,6,7,4,0,47,6.714285714285714,2,0.0,3,7,0,6,20,7,0,4,0,16,31,1
183,4095,ijFjDmHOLiyu54Ko0v4roRDWdDCIX5i1,fbPkOYLVPtPgIt0MxizjfFJov3JbHyAi,61,134,76,40,49,27,24,1,351,50.142857142857146,15,0.0,25,76,36,49,109,27,4,24,1,186,165,0
184,4097,CVQI4y90zNEQKnbziqeit6sPoxhPlPMP,fbPkOYLVPtPgIt0MxizjfFJov3JbHyAi,7,2,1,0,1,0,3,0,7,1.0,1,0.0,0,1,0,1,2,0,0,3,0,2,5,1
185,4101,pWkLIEFKVWp1dpRpiw46ybvs7QZ4nDA4,fbPkOYLVPtPgIt0MxizjfFJov3JbHyAi,7,5,2,0,0,0,7,0,14,2.0,2,0.0,0,2,0,0,5,0,0,7,0,2,12,1
186,4103,Y1ppxEgbx61jNTLCoOABIFXnW04QUYST,fbPkOYLVPtPgIt0MxizjfFJov3JbHyAi,7,3,2,0,2,0,4,0,11,1.5714285714285714,1,0.0,0,2,0,2,3,0,0,4,0,4,7,1
187,4105,VJ15PTmNAjfB6ipRCoKMs7aSjJuraSNv,fbPkOYLVPtPgIt0MxizjfFJov3JbHyAi,37,69,27,28,13,46,14,1,198,28.285714285714285,8,0.0,16,27,25,13,53,46,3,14,1,81,117,1
188,4106,TMVzoCHYEzB4dA3dJFO0jufgXr0xWoMt,fbPkOYLVPtPgIt0MxizjfFJov3JbHyAi,6,7,1,0,1,0,2,0,11,1.5714285714285714,1,0.0,3,1,0,1,4,0,0,2,0,5,6,1
189,4108,ILcXhWva6fUJAzRZSl16N8h2AK8Jjf9I,fbPkOYLVPtPgIt0MxizjfFJov3JbHyAi,7,8,2,0,2,0,3,0,15,2.142857142857143,1,0.0,0,2,0,2,8,0,0,3,0,4,11,1
190,4111,blTEANBNlwleHMZh60k5xSk9rNOJZKek,fbPkOYLVPtPgIt0MxizjfFJov3JbHyAi,2,0,0,0,0,0,6,0,6,0.8571428571428571,2,0.0,0,0,0,0,0,0,0,6,0,0,6,1
191,4112,FM7f8SmryrQv0xQWmeGBOm7E9JzAE7cF,fbPkOYLVPtPgIt0MxizjfFJov3JbHyAi,12,17,6,0,5,20,10,1,59,8.428571428571429,2,0.0,4,6,0,5,13,20,0,10,1,15,44,1
192,4113,uYnLLjFhtmRLfdb6UnGOhZKWKwE2Sz7S,fbPkOYLVPtPgIt0MxizjfFJov3JbHyAi,1,0,0,0,0,0,3,0,3,0.42857142857142855,1,0.0,0,0,0,0,0,0,0,3,0,0,3,1
193,4114,XqcIbo9pkzTiouZzC4CsMH0T57ZrJT7c,fbPkOYLVPtPgIt0MxizjfFJov3JbHyAi,12,21,8,11,5,8,7,1,61,8.714285714285714,3,0.0,3,8,8,5,18,8,3,7,1,24,37,1
194,4116,SbxWcDAQO1PnIdll82O1Qa8HqEHuIfT7,fbPkOYLVPtPgIt0MxizjfFJov3JbHyAi,5,5,1,0,1,0,1,0,8,1.1428571428571428,1,0.0,0,1,0,1,5,0,0,1,0,2,6,1
195,4117,DIqOhojonPjb3L0MafoRC4vbkm2ZgCPT,fbPkOYLVPtPgIt0MxizjfFJov3JbHyAi,15,13,4,13,5,7,6,2,50,7.142857142857143,2,0.0,6,4,9,5,7,7,4,6,2,24,26,1
196,4121,jcdJUvdxIg03VTKugjVUNiWSl6LwbiFS,fbPkOYLVPtPgIt0MxizjfFJov3JbHyAi,6,3,2,0,2,10,1,0,18,2.5714285714285716,1,0.0,0,2,0,2,3,10,0,1,0,4,14,1
197,4122,Uo5Is5U7melZAv7xg2Req57LK7O8TGT8,fbPkOYLVPtPgIt0MxizjfFJov3JbHyAi,30,41,25,0,16,1,14,3,100,14.285714285714286,3,0.0,2,25,0,16,39,1,0,14,3,43,57,1
198,4124,gml56PidNECJRV7FxBwKkFjPhRALq3yM,fbPkOYLVPtPgIt0MxizjfFJov3JbHyAi,9,8,5,0,4,0,10,0,27,3.857142857142857,2,0.0,0,5,0,4,8,0,0,10,0,9,18,1
199,4125,bGXe45VQE79P82jCvYbfBiOeISe1I8HL,fbPkOYLVPtPgIt0MxizjfFJov3JbHyAi,1,0,0,0,0,0,1,0,1,0.14285714285714285,1,0.0,0,0,0,0,0,0,0,1,0,0,1,1
200,4126,u4TNxfYOFL4kSz0gq3emLn9aOKma8Z0X,fbPkOYLVPtPgIt0MxizjfFJov3JbHyAi,12,8,6,3,2,0,0,0,19,2.7142857142857144,4,0.0,0,6,3,2,8,0,0,0,0,11,8,1
201,4127,iMXZvpdXIEwupZ3KLZs1wDk19TeUIZDi,fbPkOYLVPtPgIt0MxizjfFJov3JbHyAi,34,94,44,35,29,67,36,4,309,44.142857142857146,7,0.0,28,44,28,29,66,67,7,36,4,129,180,1
202,4129,Xl7O5Es6VpkB2PrTgzArkv7OwJ7XzlEg,fbPkOYLVPtPgIt0MxizjfFJov3JbHyAi,17,33,10,5,9,5,13,2,77,11.0,4,0.0,5,10,4,9,28,5,1,13,2,28,49,1
203,4130,8h1kpVFWyv776a7gZ8tw0jpXvK9G6pQ2,fbPkOYLVPtPgIt0MxizjfFJov3JbHyAi,10,9,4,0,3,0,7,0,23,3.2857142857142856,1,0.0,0,4,0,3,9,0,0,7,0,7,16,1
204,4133,sT9hGAnww95aeGvqwQpJlS3ORhWDT49F,fbPkOYLVPtPgIt0MxizjfFJov3JbHyAi,60,92,47,29,29,17,19,0,233,33.285714285714285,7,0.0,32,47,27,29,60,17,2,19,0,135,98,0
205,4134,bRG3KNKPz8MtEb5G1Duc4i5IiNMa8ZLU,fbPkOYLVPtPgIt0MxizjfFJov3JbHyAi,10,17,5,2,1,10,10,2,47,6.714285714285714,2,0.0,1,5,2,1,16,10,0,10,2,9,38,1
206,4135,Y9GqNI8HKN8AZelF8dSXK2b9zuzFq9b9,fbPkOYLVPtPgIt0MxizjfFJov3JbHyAi,4,2,1,0,1,0,1,0,5,0.7142857142857143,1,0.0,0,1,0,1,2,0,0,1,0,2,3,1
207,4136,WfTazznjeVMuts1c6fhfvqWuaprKs7C3,fbPkOYLVPtPgIt0MxizjfFJov3JbHyAi,32,46,30,0,20,97,34,4,231,33.0,8,0.0,0,30,0,20,46,97,0,34,4,50,181,1
208,4137,Z9qi5pq1C1bndfjP0mrTCfL8YAf6Qiv7,fbPkOYLVPtPgIt0MxizjfFJov3JbHyAi,16,31,18,7,16,11,15,1,99,14.142857142857142,4,0.0,8,18,6,16,23,11,1,15,1,48,51,0
209,4138,9tBhYjIXbTBZ0n8EA8LPV9H9GyKFjXEe,fbPkOYLVPtPgIt0MxizjfFJov3JbHyAi,9,4,3,0,3,0,2,0,12,1.7142857142857142,1,0.0,0,3,0,3,4,0,0,2,0,6,6,1
210,4140,JqdbZyx8jQDjvl0RCDBDldcliaXwceyv,fbPkOYLVPtPgIt0MxizjfFJov3JbHyAi,8,5,3,0,2,0,4,0,14,2.0,2,0.0,0,3,0,2,5,0,0,4,0,5,9,1
211,4141,3n39NQ5LzQS0QCcr9JZOE6aTUD48ZbAa,fbPkOYLVPtPgIt0MxizjfFJov3JbHyAi,7,3,2,0,2,0,6,0,13,1.8571428571428572,1,0.0,0,2,0,2,3,0,0,6,0,4,9,1
212,4143,9sFMHkQmozo76x80tFTC9ms1LtFpAvDD,fbPkOYLVPtPgIt0MxizjfFJov3JbHyAi,43,67,20,50,31,22,18,0,208,29.714285714285715,5,0.0,44,20,40,31,23,22,10,18,0,135,73,0
213,4145,AIdvsyhxoVQRPe3inEZOul3GszLWUII0,fbPkOYLVPtPgIt0MxizjfFJov3JbHyAi,7,3,2,0,2,0,5,0,12,1.7142857142857142,1,0.0,0,2,0,2,3,0,0,5,0,4,8,1
214,4146,UzWWq61d6vy3b9FQ0Zm3Qt9Ks0lmq3Qw,fbPkOYLVPtPgIt0MxizjfFJov3JbHyAi,9,4,3,0,3,0,5,0,15,2.142857142857143,1,0.0,0,3,0,3,4,0,0,5,0,6,9,1
215,4147,pUAX44GhkdnMgwkbpKeIXW1XZgu0a3SV,fbPkOYLVPtPgIt0MxizjfFJov3JbHyAi,5,2,1,0,1,0,4,0,8,1.1428571428571428,1,0.0,0,1,0,1,2,0,0,4,0,2,6,1
216,4148,V2KAeU5M9aZ71MSOJMPq9O99rHGzmKaR,fbPkOYLVPtPgIt0MxizjfFJov3JbHyAi,9,33,5,0,5,0,7,0,50,7.142857142857143,4,0.0,3,5,0,5,30,0,0,7,0,13,37,1
217,4149,dTHHrNH4JPIQjJnYjUmUZmHrgYHdCxcs,fbPkOYLVPtPgIt0MxizjfFJov3JbHyAi,6,5,2,0,3,0,1,0,11,1.5714285714285714,1,0.0,2,2,0,3,3,0,0,1,0,7,4,1
218,4150,mkfe4TuGJEOOkk4BSi5C0OnTlC842bEi,fbPkOYLVPtPgIt0MxizjfFJov3JbHyAi,26,51,15,13,22,0,8,1,110,15.714285714285714,3,0.0,33,15,11,22,18,0,2,8,1,81,29,1
219,4152,SBELepDdWchL6dd3B4yF17bQJZRyBGmW,fbPkOYLVPtPgIt0MxizjfFJov3JbHyAi,4,2,0,0,0,2,2,0,6,0.8571428571428571,1,0.0,0,0,0,0,2,2,0,2,0,0,6,1
220,4155,82WiuHoB3dVqYkf2UKsu9ogC0IsQQnqa,fbPkOYLVPtPgIt0MxizjfFJov3JbHyAi,13,57,22,1,10,6,10,0,106,15.142857142857142,5,0.0,10,22,1,10,47,6,0,10,0,43,63,1
221,4157,ZfaQRDpYRWxr1tKliyWhtiIkOEpZJsx1,fbPkOYLVPtPgIt0MxizjfFJov3JbHyAi,11,21,14,0,1,9,5,0,50,7.142857142857143,3,0.0,2,14,0,1,19,9,0,5,0,17,33,1
222,4160,nLSyDmuwtZ9VcSdeL7kW6FG97w0wmm94,fbPkOYLVPtPgIt0MxizjfFJov3JbHyAi,6,2,1,0,1,2,4,1,11,1.5714285714285714,1,0.0,0,1,0,1,2,2,0,4,1,2,9,1
223,4161,gT3kB48dwTiT117VlKJVDNNpHcWl18uZ,fbPkOYLVPtPgIt0MxizjfFJov3JbHyAi,5,0,0,0,0,1,5,1,7,1.0,1,0.0,0,0,0,0,0,1,0,5,1,0,7,1
224,4162,w9kAk351HcnpUdtlF40UgfJ8nmtrjk1M,fbPkOYLVPtPgIt0MxizjfFJov3JbHyAi,3,3,0,0,0,0,2,0,5,0.7142857142857143,1,0.0,0,0,0,0,3,0,0,2,0,0,5,1
225,4163,PBd2c59pI8ZCJwc4iQjHYNeQj4K3oGvT,fbPkOYLVPtPgIt0MxizjfFJov3JbHyAi,12,10,6,0,4,6,13,1,40,5.714285714285714,2,0.0,0,6,0,4,10,6,0,13,1,10,30,1
226,4164,6PFF6a3rTtp143lPxgdGFZZ0CCZBKH49,fbPkOYLVPtPgIt0MxizjfFJov3JbHyAi,27,46,17,12,18,4,13,6,116,16.571428571428573,2,0.0,20,17,10,18,26,4,2,13,6,65,51,1
227,4168,heWUPIsxtHSwXQGmJMsYqzGkbNQihssP,fbPkOYLVPtPgIt0MxizjfFJov3JbHyAi,4,2,1,0,1,0,1,0,5,0.7142857142857143,1,0.0,0,1,0,1,2,0,0,1,0,2,3,1
228,4169,z9oFzf9xIbCN4mhupPeK6qv2AnZTqp8G,fbPkOYLVPtPgIt0MxizjfFJov3JbHyAi,6,1,1,0,1,0,3,0,6,0.8571428571428571,1,0.0,0,1,0,1,1,0,0,3,0,2,4,1
229,4170,cJuR6mykFWWefoh4qiG9O6BBEr08qxSv,fbPkOYLVPtPgIt0MxizjfFJov3JbHyAi,8,13,4,0,4,18,6,3,48,6.857142857142857,2,0.0,4,4,0,4,9,18,0,6,3,12,36,1
230,4171,uHgH8m4GJET0eE5mE8JCyLZD7HEKwM4t,SpATywNh6bZuzm8s1ceuBUnMUAeoAHHw,27,59,29,26,4,39,41,3,201,28.714285714285715,12,0.0,14,29,23,4,45,39,3,41,3,70,131,0
231,4182,HgeZmyLysCZF827lPwLNCfqcskKVvNDd,SpATywNh6bZuzm8s1ceuBUnMUAeoAHHw,24,47,4,28,2,16,27,2,126,18.0,6,0.0,12,4,25,2,35,16,3,27,2,43,83,0
232,4218,EReWp6ilgaQY61GGX2jAkIc5IQisheJq,SpATywNh6bZuzm8s1ceuBUnMUAeoAHHw,29,35,16,34,9,0,9,0,103,14.714285714285714,6,0.0,8,16,28,9,27,0,6,9,0,61,42,1
233,4219,Jm4nQ05ndX10jbofbWx6S0r9VXrqia6S,bWdj2GDclj5ofokWjzoa5jAwMkxCykd6,11,30,15,46,2,14,12,0,119,17.0,4,0.0,3,15,44,2,27,14,2,12,0,64,55,0
234,4237,SVFfJJhaWd2RlHPtvg5SWBRGj8N0paMQ,SpATywNh6bZuzm8s1ceuBUnMUAeoAHHw,23,60,8,34,1,2,31,0,136,19.428571428571427,10,0.0,20,8,30,1,40,2,4,31,0,59,77,0
235,4238,hevZgCUVQAVwtaivzco7bLaVpTOAAfiG,SpATywNh6bZuzm8s1ceuBUnMUAeoAHHw,27,41,24,18,11,1,7,0,102,14.571428571428571,5,0.0,11,24,15,11,30,1,3,7,0,61,41,0
236,4243,83p9ejSELsW1j5wNlAyUXF2YWFL8Z8tc,A3fsA9Zfv1X2fVEQhTw51lKENdNrEqT3,66,32,16,118,13,1,13,0,193,27.571428571428573,4,0.0,2,16,112,13,30,1,6,13,0,143,50,0
237,4247,0NGZq9HZW5KOrSfzSGGipuN20pCRDMWu,G8EPVSXsOYB5YQWZGiz1aVq5Pgr2GrQu,40,138,50,17,17,67,45,3,337,48.142857142857146,6,0.0,33,50,13,17,105,67,4,45,3,113,224,0
238,4250,DHUv7XpIZcPp2QYGNmTXjhgg7Zq4BpJ7,SpATywNh6bZuzm8s1ceuBUnMUAeoAHHw,21,20,13,2,9,0,5,0,49,7.0,3,0.0,4,13,2,9,16,0,0,5,0,28,21,1
239,4254,J5PQMceXoOVyN05md7NqKfAhSfcgJgVJ,SpATywNh6bZuzm8s1ceuBUnMUAeoAHHw,24,53,2,37,0,150,24,2,268,38.285714285714285,10,0.0,18,2,32,0,35,150,5,24,2,52,216,0
240,4268,nYFWhKbFKiXgZ193lmJEmg3xQ65UNrPv,SpATywNh6bZuzm8s1ceuBUnMUAeoAHHw,28,49,21,29,8,3,11,1,122,17.428571428571427,5,0.0,22,21,27,8,27,3,2,11,1,78,44,1
241,4270,xmsckIAcvM2S7rjWsHHPvyDsjVFjwdMr,SpATywNh6bZuzm8s1ceuBUnMUAeoAHHw,20,34,1,22,0,13,5,0,75,10.714285714285714,3,0.0,11,1,20,0,23,13,2,5,0,32,43,1
242,4278,iVNWfvqx80bYGUpxbD5kOVH2Fugs6QtQ,SpATywNh6bZuzm8s1ceuBUnMUAeoAHHw,26,37,23,14,14,3,8,0,99,14.142857142857142,4,0.0,7,23,14,14,30,3,0,8,0,58,41,0
243,4286,i9UIJe9BPLqUSVYMtAIMhpSeBf6cbruQ,SpATywNh6bZuzm8s1ceuBUnMUAeoAHHw,17,26,12,11,5,0,5,0,59,8.428571428571429,6,0.0,9,12,11,5,17,0,0,5,0,37,22,0
244,4290,EVhDvNThWnvwe7HGJiMKoMo6EeAXDH9R,bWdj2GDclj5ofokWjzoa5jAwMkxCykd6,14,15,10,0,5,2,20,3,55,7.857142857142857,3,0.0,0,10,0,5,15,2,0,20,3,15,40,1
245,4291,UTQBVZwwRuN7bMqGkwJeqpNJF2PPrsFV,A3fsA9Zfv1X2fVEQhTw51lKENdNrEqT3,18,12,9,0,8,0,2,0,31,4.428571428571429,1,0.0,0,9,0,8,12,0,0,2,0,17,14,0
246,4292,5IOZn10arhSe83Sz47oGoyNxbAFXZkA2,SpATywNh6bZuzm8s1ceuBUnMUAeoAHHw,16,43,12,0,3,16,15,0,89,12.714285714285714,5,0.0,2,12,0,3,41,16,0,15,0,17,72,1
247,4301,QOK5LHvwN0A5g3JhxMPHBffh5Rh2wZF8,SpATywNh6bZuzm8s1ceuBUnMUAeoAHHw,13,20,5,0,2,3,11,1,42,6.0,3,0.0,1,5,0,2,19,3,0,11,1,8,34,1
248,4313,l80sDXQh6tFmRSRsJvWJgP55drvQUfT2,SpATywNh6bZuzm8s1ceuBUnMUAeoAHHw,29,67,24,28,11,0,33,1,164,23.428571428571427,7,0.0,20,24,26,11,47,0,2,33,1,81,83,1
249,4327,glS180WZt8C6hB13WP6NUijid7zN96cg,SpATywNh6bZuzm8s1ceuBUnMUAeoAHHw,26,41,16,22,4,4,10,1,98,14.0,5,0.0,18,16,20,4,23,4,2,10,1,58,40,0
250,4342,gqe5NXbZbf5uXY0rPviLeIFOMpQyekdp,G8EPVSXsOYB5YQWZGiz1aVq5Pgr2GrQu,57,68,5,100,7,16,17,0,213,30.428571428571427,8,0.0,1,5,88,7,67,16,12,17,0,101,112,1
251,4344,xq251j4u37TVpTeMx1v6QtnvJbeUYzjd,SpATywNh6bZuzm8s1ceuBUnMUAeoAHHw,19,44,7,12,0,0,18,0,81,11.571428571428571,3,0.0,4,7,11,0,40,0,1,18,0,22,59,1
252,4352,3OBHdoV61de7ICMrnWAXr689Eb2AyuN0,SpATywNh6bZuzm8s1ceuBUnMUAeoAHHw,32,35,18,34,11,12,16,1,127,18.142857142857142,5,0.0,9,18,29,11,26,12,5,16,1,67,60,0
253,4361,jygZDxdNc5vnyQVPVME6xQbLWCY2Zptq,SpATywNh6bZuzm8s1ceuBUnMUAeoAHHw,7,14,6,0,6,0,5,0,31,4.428571428571429,2,0.0,0,6,0,6,14,0,0,5,0,12,19,1
254,4364,dVnTQl9ANUhHsXIPIWBdmTgLVkOgcfeV,bWdj2GDclj5ofokWjzoa5jAwMkxCykd6,5,2,1,0,1,0,2,0,6,0.8571428571428571,1,0.0,0,1,0,1,2,0,0,2,0,2,4,1
255,4365,ebO6e76NCFlMeek1yPjM9gz3mJBPl1yH,RXDvfPUBYFlVdlueBFbLW0mhhAyGEqpt,73,96,51,137,23,43,29,2,381,54.42857142857143,5,0.0,18,51,131,23,78,43,6,29,2,223,158,1
256,4395,C6xrhZPOmVH2gCVNP26gSSPka2CcwgB5,SpATywNh6bZuzm8s1ceuBUnMUAeoAHHw,27,22,14,14,8,1,16,0,75,10.714285714285714,5,0.0,7,14,14,8,15,1,0,16,0,43,32,1
257,4396,5c5BMuD35oybcLij9FEBpLM3FZXJ5QAD,G8EPVSXsOYB5YQWZGiz1aVq5Pgr2GrQu,52,140,9,49,2,24,40,7,271,38.714285714285715,8,0.0,10,9,41,2,130,24,8,40,7,62,209,0
258,4406,U0MChqulsymiJYCtbj873TXGFuXiZDFk,SpATywNh6bZuzm8s1ceuBUnMUAeoAHHw,31,55,30,24,12,14,22,1,158,22.571428571428573,11,0.0,16,30,22,12,39,14,2,22,1,80,78,0
259,4430,sWkTuB7KUS6C7uaxH84rlQvKN8aRF9JC,bWdj2GDclj5ofokWjzoa5jAwMkxCykd6,6,6,3,0,1,8,10,0,28,4.0,3,0.0,0,3,0,1,6,8,0,10,0,4,24,1
260,4432,kdQVQcPehC1WZyKhleQe5vDaCQv1dpj8,SpATywNh6bZuzm8s1ceuBUnMUAeoAHHw,29,34,19,37,9,7,18,4,128,18.285714285714285,7,0.0,6,19,35,9,28,7,2,18,4,69,59,0
261,4435,bN6JhUz4s97Xsh7eq2ZH1ilTMaKJDuUF,bWdj2GDclj5ofokWjzoa5jAwMkxCykd6,42,156,47,113,15,38,37,1,407,58.142857142857146,13,0.0,17,47,99,15,139,38,14,37,1,178,229,0
262,4440,ZhTCqX8GMUcn0a0betuEauHNuCk1aRhm,bWdj2GDclj5ofokWjzoa5jAwMkxCykd6,52,129,48,142,19,125,26,0,489,69.85714285714286,6,0.0,26,48,128,19,103,125,14,26,0,221,268,0
263,4453,4sZlPbPnBCwNHbrOUXcVAiPkTKHriJTV,SpATywNh6bZuzm8s1ceuBUnMUAeoAHHw,26,67,5,36,1,52,59,4,224,32.0,10,0.0,14,5,32,1,53,52,4,59,4,52,172,0
264,4454,lMy0A59BRo4770ALzvOjsBS5HJkCRV78,bWdj2GDclj5ofokWjzoa5jAwMkxCykd6,47,82,11,120,3,20,49,1,286,40.857142857142854,7,0.0,11,11,109,3,71,20,11,49,1,134,152,1
265,4481,XjrP1VAGwJCwkRm4KgImIkZYNjnvGQN9,RXDvfPUBYFlVdlueBFbLW0mhhAyGEqpt,74,272,114,172,63,130,143,39,933,133.28571428571428,21,0.0,53,114,155,63,219,130,17,143,39,385,548,0
266,4498,dxoTIhhPXBvqzWGLltH0slJdxsuyggjI,G8EPVSXsOYB5YQWZGiz1aVq5Pgr2GrQu,49,100,75,0,38,70,66,4,353,50.42857142857143,13,0.0,1,75,0,38,99,70,0,66,4,114,239,0
267,4499,2ZP4iw9joeRPfEuWLWQQFnKchFtuqx5l,SpATywNh6bZuzm8s1ceuBUnMUAeoAHHw,14,22,12,14,7,3,4,0,62,8.857142857142858,3,0.0,6,12,13,7,16,3,1,4,0,38,24,0
268,4506,j1jdy8OF5VQw4rqSYOkbK2pQplvvvz37,G8EPVSXsOYB5YQWZGiz1aVq5Pgr2GrQu,88,245,32,160,10,225,133,9,814,116.28571428571429,19,0.0,33,32,130,10,212,225,30,133,9,205,609,0
269,4507,HuDaXYBstQFpbEGg5tkyPhxLKzB3hVSB,SpATywNh6bZuzm8s1ceuBUnMUAeoAHHw,32,195,89,47,12,115,111,6,575,82.14285714285714,21,0.0,45,89,35,12,150,115,12,111,6,181,394,0
270,4524,j1jdy8OF5VQw4rqSYOkbK2pQplvvvz37,bWdj2GDclj5ofokWjzoa5jAwMkxCykd6,47,136,29,170,8,68,66,3,480,68.57142857142857,13,0.0,17,29,150,8,119,68,20,66,3,204,276,1
271,4547,fczke4UuC99kQHbLPBF9eDbT99FMycXd,SpATywNh6bZuzm8s1ceuBUnMUAeoAHHw,4,0,0,0,0,0,10,0,10,1.4285714285714286,3,0.0,0,0,0,0,0,0,0,10,0,0,10,0
272,4548,kla9cpzzaIqMfwRx5dULfeceoZisiJXJ,SpATywNh6bZuzm8s1ceuBUnMUAeoAHHw,31,127,42,36,14,51,80,11,361,51.57142857142857,12,0.0,55,42,32,14,72,51,4,80,11,143,218,0
273,4560,LUmOTPPHIX2y7l2dFV3yMvYCAxk1M4FC,SpATywNh6bZuzm8s1ceuBUnMUAeoAHHw,18,38,27,0,0,1,14,3,83,11.857142857142858,2,0.0,5,27,0,0,33,1,0,14,3,32,51,1
274,4571,PUW0i4IuafllkJEtV0GCqmTDeLHkDmH3,bWdj2GDclj5ofokWjzoa5jAwMkxCykd6,40,98,9,114,8,424,80,7,740,105.71428571428571,13,0.0,15,9,95,8,83,424,19,80,7,127,613,0
275,4585,HqsJVGNbokPBStWiDvKZXbvoLlDHixpp,SpATywNh6bZuzm8s1ceuBUnMUAeoAHHw,22,70,9,36,1,0,11,0,127,18.142857142857142,5,0.0,36,9,31,1,34,0,5,11,0,77,50,0
276,4598,izDb8XjXh0aaLsv56xtUKjGq4nGYtog4,G8EPVSXsOYB5YQWZGiz1aVq5Pgr2GrQu,78,181,114,48,48,49,52,12,504,72.0,6,0.0,41,114,24,48,140,49,24,52,12,227,277,0
277,4610,sZNhT3IqtfFMwMod3w0cGQK1HKvrIFwI,SpATywNh6bZuzm8s1ceuBUnMUAeoAHHw,29,20,13,31,8,8,5,0,85,12.142857142857142,3,0.0,4,13,30,8,16,8,1,5,0,55,30,1
278,4613,aVE6FAaI67jjqObdfL3BkKQUvDsOp43M,SpATywNh6bZuzm8s1ceuBUnMUAeoAHHw,32,101,63,26,20,66,51,1,328,46.857142857142854,5,0.0,14,63,24,20,87,66,2,51,1,121,207,0
279,4614,D77mYRAEHVmHmrch91cWflZwkGfWXMn3,SpATywNh6bZuzm8s1ceuBUnMUAeoAHHw,16,34,6,0,5,0,8,0,53,7.571428571428571,5,0.0,0,6,0,5,34,0,0,8,0,11,42,1
280,4619,y7HHpDc09mCS3h1lthBIJASJI1RnROT7,SpATywNh6bZuzm8s1ceuBUnMUAeoAHHw,1,0,0,0,0,0,1,0,1,0.14285714285714285,1,0.0,0,0,0,0,0,0,0,1,0,0,1,1
281,4625,qRy2DimM9SNsqYvrYrrnIw2oQKcYB3wP,SpATywNh6bZuzm8s1ceuBUnMUAeoAHHw,22,40,2,29,1,0,10,0,82,11.714285714285714,6,0.0,8,2,24,1,32,0,5,10,0,35,47,0
282,4630,DLDhUvvvfnnYFJuV65Zt2yaS0jPJgvzq,G8EPVSXsOYB5YQWZGiz1aVq5Pgr2GrQu,114,142,1,284,3,31,28,2,491,70.14285714285714,7,0.0,52,1,218,3,90,31,66,28,2,274,217,0
283,4637,jWkqymVvvfv6xuX5RWgcj99r1zpcnb3g,SpATywNh6bZuzm8s1ceuBUnMUAeoAHHw,23,65,2,19,1,0,14,0,101,14.428571428571429,7,0.0,12,2,16,1,53,0,3,14,0,31,70,0
284,4641,8oxFWBumsNA4SJ0CIJujNkjFW8ZzMgtQ,SpATywNh6bZuzm8s1ceuBUnMUAeoAHHw,28,93,5,45,5,61,52,8,269,38.42857142857143,11,0.0,28,5,36,5,65,61,9,52,8,74,195,0
285,4647,MKlpymF14KtyI236a0RjVjNdDlFXwHJE,SpATywNh6bZuzm8s1ceuBUnMUAeoAHHw,26,71,14,20,3,42,18,3,171,24.428571428571427,9,0.0,15,14,19,3,56,42,1,18,3,51,120,0
286,4652,D1N0ONIJFdYniASKJjZ0ujwEVr50txl7,A3fsA9Zfv1X2fVEQhTw51lKENdNrEqT3,8,7,5,0,5,0,3,0,20,2.857142857142857,2,0.0,0,5,0,5,7,0,0,3,0,10,10,1
287,4664,kMN5uYNaj23K9PVTrdyiL9iDB1lCye57,SpATywNh6bZuzm8s1ceuBUnMUAeoAHHw,31,102,36,35,12,51,28,1,265,37.857142857142854,12,0.0,27,36,30,12,75,51,5,28,1,105,160,0
288,4667,hjlIy32j2vlgUCGRsMhZTr5gQN9bE8Ko,A3fsA9Zfv1X2fVEQhTw51lKENdNrEqT3,3,3,1,0,0,0,1,0,5,0.7142857142857143,1,0.0,0,1,0,0,3,0,0,1,0,1,4,1
289,4672,LBkf4MhTcgqLqBnp8u6ZnAtRKKkDVT0Y,RXDvfPUBYFlVdlueBFbLW0mhhAyGEqpt,24,33,24,15,6,6,3,0,87,12.428571428571429,1,0.0,8,24,15,6,25,6,0,3,0,53,34,0
290,4685,vdpA0dH9z73XaAQ0RErmDlnn6qBKeXm2,SpATywNh6bZuzm8s1ceuBUnMUAeoAHHw,2,0,0,0,0,0,2,0,2,0.2857142857142857,1,0.0,0,0,0,0,0,0,0,2,0,0,2,1
291,4690,uOFQjpYGMV24K1kl5khOKpWKqO5hcEHE,SpATywNh6bZuzm8s1ceuBUnMUAeoAHHw,25,53,5,39,4,13,13,3,130,18.571428571428573,5,0.0,21,5,33,4,32,13,6,13,3,63,67,0
292,4697,Dth3GgZsbd3MjUskvlTR45iDGsOfcse1,bWdj2GDclj5ofokWjzoa5jAwMkxCykd6,9,6,0,0,1,0,7,1,15,2.142857142857143,1,0.0,2,0,0,1,4,0,0,7,1,3,12,1
293,4713,2d73pTPKGJeE59DtbgirchSdsN0c5ZX8,G8EPVSXsOYB5YQWZGiz1aVq5Pgr2GrQu,83,156,57,255,18,9,38,2,535,76.42857142857143,10,0.0,73,57,213,18,83,9,42,38,2,361,174,1
294,4717,pYVXRlnQ0YvWKNjc7FEDAmE4Ai0Z428V,SpATywNh6bZuzm8s1ceuBUnMUAeoAHHw,15,10,5,13,5,3,11,0,47,6.714285714285714,3,0.0,3,5,11,5,7,3,2,11,0,24,23,1
295,4724,CjC2ROZAsG20pDynA7ZPw7kC7J3IUQLv,SpATywNh6bZuzm8s1ceuBUnMUAeoAHHw,23,45,20,29,6,19,21,1,141,20.142857142857142,4,0.0,6,20,27,6,39,19,2,21,1,59,82,0
296,4728,pteLC5OQ4se3k1DPDEwaYOBtzSkv9plY,A3fsA9Zfv1X2fVEQhTw51lKENdNrEqT3,8,6,2,0,2,0,5,0,15,2.142857142857143,2,0.0,0,2,0,2,6,0,0,5,0,4,11,1
297,4731,LgFsEu5TARkqPf6cgrTX0NqpOzewq5Lk,SpATywNh6bZuzm8s1ceuBUnMUAeoAHHw,27,27,14,23,8,3,12,2,89,12.714285714285714,6,0.0,6,14,20,8,21,3,3,12,2,48,41,0
298,4742,24nfIqL449Y829FZxcDvbCwFktTYfhAB,SpATywNh6bZuzm8s1ceuBUnMUAeoAHHw,1,0,0,0,0,0,1,0,1,0.14285714285714285,1,0.0,0,0,0,0,0,0,0,1,0,0,1,1
299,4743,24nfIqL449Y829FZxcDvbCwFktTYfhAB,bWdj2GDclj5ofokWjzoa5jAwMkxCykd6,5,2,1,0,1,0,2,0,6,0.8571428571428571,1,0.0,0,1,0,1,2,0,0,2,0,2,4,1
300,4747,2YrfQZgyUPdiZGXhplgKBSkvHochAfw6,SpATywNh6bZuzm8s1ceuBUnMUAeoAHHw,26,102,41,47,10,3,28,0,231,33.0,10,0.0,13,41,38,10,89,3,9,28,0,102,129,0
301,4756,5QI6OaFhCHlCtRcFfvDdZQ38fgw6K7ZS,SpATywNh6bZuzm8s1ceuBUnMUAeoAHHw,1,0,0,0,0,0,1,0,1,0.14285714285714285,1,0.0,0,0,0,0,0,0,0,1,0,0,1,1
302,4767,OLNUzQUHvlNsi2WFlH5eEyaieqKXrEz7,SpATywNh6bZuzm8s1ceuBUnMUAeoAHHw,14,19,9,0,4,6,7,0,45,6.428571428571429,4,0.0,2,9,0,4,17,6,0,7,0,15,30,1
303,4772,6BV3xjXq9ekiRfYm3O3pN6jZMMACVAnm,G8EPVSXsOYB5YQWZGiz1aVq5Pgr2GrQu,1,0,0,0,0,0,1,0,1,0.14285714285714285,1,0.0,0,0,0,0,0,0,0,1,0,0,1,1
304,4773,29ctmAiYEOKj7HqUZOWS8Kj1hgVEvKs8,bWdj2GDclj5ofokWjzoa5jAwMkxCykd6,11,26,1,14,1,0,6,0,48,6.857142857142857,2,0.0,5,1,14,1,21,0,0,6,0,21,27,1
305,4774,urHq1UPtLFVLJW8r9uUffDflKlN7AYRL,SpATywNh6bZuzm8s1ceuBUnMUAeoAHHw,33,46,22,31,7,5,17,0,128,18.285714285714285,6,0.0,12,22,26,7,34,5,5,17,0,67,61,0
306,4801,uvl7kPB3Po3jrDtnQvCsunCWcJhdeQPU,A3fsA9Zfv1X2fVEQhTw51lKENdNrEqT3,50,54,30,103,18,3,21,2,231,33.0,5,0.0,4,30,88,18,50,3,15,21,2,140,91,1
307,4802,aI2WbSCktVyijPTHCbgAdpzpfdnFGcq9,RXDvfPUBYFlVdlueBFbLW0mhhAyGEqpt,34,61,31,0,13,1,41,6,153,21.857142857142858,10,0.0,4,31,0,13,57,1,0,41,6,48,105,0
308,4806,iGjPcJm3i62KsWTQKhrsxcQv7n97iair,G8EPVSXsOYB5YQWZGiz1aVq5Pgr2GrQu,124,195,27,350,11,86,24,1,694,99.14285714285714,9,0.0,73,27,240,11,122,86,110,24,1,351,343,0
309,4813,8956nHnvCL40778s76lABgHdN1UGjdzq,bWdj2GDclj5ofokWjzoa5jAwMkxCykd6,5,3,1,0,1,0,2,0,7,1.0,1,0.0,0,1,0,1,3,0,0,2,0,2,5,1
310,4825,q3SjGV3d1qwn1q3ehoXsAmC01281iVQV,SpATywNh6bZuzm8s1ceuBUnMUAeoAHHw,27,41,19,32,11,8,20,1,132,18.857142857142858,3,0.0,15,19,28,11,26,8,4,20,1,73,59,0
311,4827,yNygMjDRQbsmQrkdzv6Ni3gEhrA9rC9T,SpATywNh6bZuzm8s1ceuBUnMUAeoAHHw,13,34,16,12,7,2,7,0,78,11.142857142857142,4,0.0,10,16,9,7,24,2,3,7,0,42,36,0
312,4846,7gQzvY1ridUPLjuboweNhi3eMZVeaUA3,SpATywNh6bZuzm8s1ceuBUnMUAeoAHHw,1,0,0,0,0,0,1,0,1,0.14285714285714285,1,0.0,0,0,0,0,0,0,0,1,0,0,1,1
313,4852,bvRAS0uJ0Teq8mZcNb9rxcXigDj59DTa,RXDvfPUBYFlVdlueBFbLW0mhhAyGEqpt,16,32,21,0,2,0,9,0,64,9.142857142857142,6,0.0,1,21,0,2,31,0,0,9,0,24,40,0
314,4859,WFpcwuADsWD4IXIxExn0sUfX41HgFWZg,SpATywNh6bZuzm8s1ceuBUnMUAeoAHHw,6,5,2,0,2,0,1,0,10,1.4285714285714286,1,0.0,0,2,0,2,5,0,0,1,0,4,6,1
315,4903,jJEQAKDG1yT0OS9qRBZrNXlEJDxE8Etq,A3fsA9Zfv1X2fVEQhTw51lKENdNrEqT3,37,66,19,42,2,197,65,4,395,56.42857142857143,17,0.0,7,19,35,2,59,197,7,65,4,63,332,0
316,4907,24hyIKTWvGbDpRNiVA2hNdG9ApRuVKWS,SpATywNh6bZuzm8s1ceuBUnMUAeoAHHw,30,49,26,19,12,14,25,1,146,20.857142857142858,9,0.0,10,26,17,12,39,14,2,25,1,65,81,0
317,4910,FlH4hJdTFopI7d7C8aCFmJunlCxyAcSh,SpATywNh6bZuzm8s1ceuBUnMUAeoAHHw,20,25,12,17,6,4,12,2,78,11.142857142857142,5,0.0,7,12,15,6,18,4,2,12,2,40,38,1
318,4916,zgScsnx97lbYEQNQ5ihDmYHFxSK6ucUx,SpATywNh6bZuzm8s1ceuBUnMUAeoAHHw,1,0,0,0,0,0,1,0,1,0.14285714285714285,1,0.0,0,0,0,0,0,0,0,1,0,0,1,1
319,4919,QDpN8D19Mr8RZumTONWpZNlCWcHCCTbH,bWdj2GDclj5ofokWjzoa5jAwMkxCykd6,16,31,3,44,3,14,9,0,104,14.857142857142858,5,0.0,6,3,42,3,25,14,2,9,0,54,50,1
320,4924,bef1HHNzLfXpAEPkvkmDyHD9r4t8l5gN,RXDvfPUBYFlVdlueBFbLW0mhhAyGEqpt,2,0,0,0,0,0,2,0,2,0.2857142857142857,1,0.0,0,0,0,0,0,0,0,2,0,0,2,1
321,4927,WYPfgLKE9VINcT4gmCjKg6KY4hGmzmxN,SpATywNh6bZuzm8s1ceuBUnMUAeoAHHw,30,39,19,20,7,3,9,0,97,13.857142857142858,3,0.0,14,19,17,7,25,3,3,9,0,57,40,0
322,4931,eiL4sJzBUqNqEAwJXavGTHQchRgg0E9e,G8EPVSXsOYB5YQWZGiz1aVq5Pgr2GrQu,63,110,8,121,2,32,44,5,322,46.0,14,0.0,24,8,97,2,86,32,24,44,5,131,191,0
323,4934,RkupeBiDJM8eQAHegSIZXnYfypYMPCFs,SpATywNh6bZuzm8s1ceuBUnMUAeoAHHw,15,69,38,5,10,0,21,0,143,20.428571428571427,10,0.0,9,38,5,10,60,0,0,21,0,62,81,0
324,4937,aZcgamrUxwqX7Nt2qxeI2ZGGKhcvbWIt,SpATywNh6bZuzm8s1ceuBUnMUAeoAHHw,20,42,3,24,1,2,32,1,105,15.0,6,0.0,12,3,21,1,30,2,3,32,1,37,68,0
325,4948,D8SfZbudbfX5pEFjOEna12FQCnvrJwde,SpATywNh6bZuzm8s1ceuBUnMUAeoAHHw,7,13,6,0,0,1,10,1,31,4.428571428571429,3,0.0,0,6,0,0,13,1,0,10,1,6,25,1
326,4954,w9jybkX7jENxFw2ZN48ruQIJfCGfUCTe,bWdj2GDclj5ofokWjzoa5jAwMkxCykd6,16,28,1,52,4,1,4,0,90,12.857142857142858,3,0.0,11,1,47,4,17,1,5,4,0,63,27,1
327,4956,w9jybkX7jENxFw2ZN48ruQIJfCGfUCTe,A3fsA9Zfv1X2fVEQhTw51lKENdNrEqT3,58,63,1,226,1,0,5,0,296,42.285714285714285,4,0.0,8,1,183,1,55,0,43,5,0,193,103,1
328,4967,W4dUmcINvn4EmYk22ZRR3EuEX8WaEqL8,A3fsA9Zfv1X2fVEQhTw51lKENdNrEqT3,9,6,4,0,2,0,3,0,15,2.142857142857143,1,0.0,0,4,0,2,6,0,0,3,0,6,9,1
329,4979,dSloiolTuQA1YnIVrIEZb5m23cL24cRw,bWdj2GDclj5ofokWjzoa5jAwMkxCykd6,10,12,4,0,4,0,5,0,25,3.5714285714285716,4,0.0,0,4,0,4,12,0,0,5,0,8,17,1
330,4982,3ZzNkdWgGb47Go07PRKPf0XZ6jjhVCB4,A3fsA9Zfv1X2fVEQhTw51lKENdNrEqT3,44,36,25,62,11,26,20,0,180,25.714285714285715,6,0.0,1,25,51,11,35,26,11,20,0,88,92,0
331,4984,3h1zqwMTeQWdhoWHPgvllPWyD6P0qFtr,SpATywNh6bZuzm8s1ceuBUnMUAeoAHHw,29,57,23,24,12,5,12,2,135,19.285714285714285,7,0.0,20,23,24,12,37,5,0,12,2,79,56,0
332,4989,WxVM9kOqNmenlQy1YKMo3yVYKYKkewCz,A3fsA9Zfv1X2fVEQhTw51lKENdNrEqT3,98,51,34,272,16,27,26,0,426,60.857142857142854,7,0.0,9,34,214,16,42,27,58,26,0,273,153,0
333,5009,lgip049r6Eu24ga2SPdixKHu4ShoVkOP,SpATywNh6bZuzm8s1ceuBUnMUAeoAHHw,27,21,13,23,8,0,8,0,73,10.428571428571429,3,0.0,4,13,21,8,17,0,2,8,0,46,27,0
334,5014,CIp7kQvL8WZLrf0lp78hw3OiOipB94Fc,SpATywNh6bZuzm8s1ceuBUnMUAeoAHHw,1,0,0,0,0,0,1,0,1,0.14285714285714285,1,0.0,0,0,0,0,0,0,0,1,0,0,1,1
335,5028,v1AqHfMoNhUox9GyIOrxftKibIp07zrt,RXDvfPUBYFlVdlueBFbLW0mhhAyGEqpt,18,15,13,0,9,15,4,0,56,8.0,3,0.0,0,13,0,9,15,15,0,4,0,22,34,1
336,5042,QP1Im9jEj4yDlujZ0cdksBwzi1qoq6uz,A3fsA9Zfv1X2fVEQhTw51lKENdNrEqT3,21,17,14,0,12,0,8,1,52,7.428571428571429,3,0.0,0,14,0,12,17,0,0,8,1,26,26,1
337,5058,UJNew1tDOTKAwtlVI7Xin0dzgnQGk4oE,SpATywNh6bZuzm8s1ceuBUnMUAeoAHHw,28,87,33,39,6,16,22,0,203,29.0,9,0.0,37,33,35,6,50,16,4,22,0,111,92,0
338,5081,EEKRPW8tn9Mg3QBn5MHwc7463f6P9lSa,SpATywNh6bZuzm8s1ceuBUnMUAeoAHHw,13,22,0,7,0,0,5,0,34,4.857142857142857,3,0.0,5,0,6,0,17,0,1,5,0,11,23,1
339,5084,kMzMJEHy7fAHiNUZU0um3I2BsPC7gMll,bWdj2GDclj5ofokWjzoa5jAwMkxCykd6,52,112,82,165,60,39,52,2,512,73.14285714285714,15,0.0,14,82,140,60,98,39,25,52,2,296,216,0
340,5092,EiO5bky9R1Iqlpv4ItUpPBUgGb1eJItE,A3fsA9Zfv1X2fVEQhTw51lKENdNrEqT3,32,116,11,20,6,216,79,0,448,64.0,11,0.0,3,11,17,6,113,216,3,79,0,37,411,1
341,5106,77HeNUdRA0IEkObqGpfDRUjK9MGFXlcs,SpATywNh6bZuzm8s1ceuBUnMUAeoAHHw,7,7,1,0,1,0,4,0,13,1.8571428571428572,1,0.0,0,1,0,1,7,0,0,4,0,2,11,0
342,5112,eXHbDnPXGOepjGY8R1QdCMeSWp9NDZZc,SpATywNh6bZuzm8s1ceuBUnMUAeoAHHw,29,89,39,19,10,4,10,0,171,24.428571428571427,6,0.0,23,39,17,10,66,4,2,10,0,89,82,0
343,5114,3SWDgl41jXPWPBCB5sVpNEwmW9L3MerS,SpATywNh6bZuzm8s1ceuBUnMUAeoAHHw,27,31,19,20,11,0,6,0,87,12.428571428571429,8,0.0,5,19,18,11,26,0,2,6,0,53,34,0
344,5136,35QP8hkG1fMgJT5B2mWO7L1K5UDzKccP,SpATywNh6bZuzm8s1ceuBUnMUAeoAHHw,12,25,1,0,1,0,16,1,44,6.285714285714286,4,0.0,4,1,0,1,21,0,0,16,1,6,38,1
345,5148,uN992cfJ2NJqNQmns1XgyEcZyWUiJR0U,SpATywNh6bZuzm8s1ceuBUnMUAeoAHHw,29,94,19,20,5,21,34,2,195,27.857142857142858,10,0.0,27,19,20,5,67,21,0,34,2,71,124,0
346,5163,nOBQYWrG3xrA9IeoO0kkFbpfztBbno3g,A3fsA9Zfv1X2fVEQhTw51lKENdNrEqT3,10,5,3,0,3,0,3,0,14,2.0,1,0.0,0,3,0,3,5,0,0,3,0,6,8,1
347,5168,UWuyaaoLwLnyFDmtW8yT3lff7bHBBBqe,SpATywNh6bZuzm8s1ceuBUnMUAeoAHHw,26,99,10,36,9,6,24,6,190,27.142857142857142,14,0.0,12,10,33,9,87,6,3,24,6,64,126,0
348,5205,VhlYBZ7MZgP2ChzlwqizJv2MimYYdGta,SpATywNh6bZuzm8s1ceuBUnMUAeoAHHw,26,36,22,15,15,0,10,4,102,14.571428571428571,4,0.0,2,22,15,15,34,0,0,10,4,54,48,1
349,5209,884KSEusRiMlLTSulMFf41A22MivDNwN,G8EPVSXsOYB5YQWZGiz1aVq5Pgr2GrQu,7,3,2,0,2,0,5,0,12,1.7142857142857142,1,0.0,0,2,0,2,3,0,0,5,0,4,8,1
350,5212,4HfbFsCyYszJO7w4OHW3KiOw346tCEQ3,SpATywNh6bZuzm8s1ceuBUnMUAeoAHHw,27,26,13,19,7,0,2,0,67,9.571428571428571,2,0.0,11,13,18,7,15,0,1,2,0,49,18,1
351,5238,S4uinMe8PGabKcmtVdXuBZWFnRj2oMAw,bWdj2GDclj5ofokWjzoa5jAwMkxCykd6,1,0,0,0,0,0,1,0,1,0.14285714285714285,1,0.0,0,0,0,0,0,0,0,1,0,0,1,1
352,5245,17IsanlXziT2tczTSDkapcsRHmSWuCWH,SpATywNh6bZuzm8s1ceuBUnMUAeoAHHw,16,67,7,0,8,0,10,0,92,13.142857142857142,5,0.0,10,7,0,8,57,0,0,10,0,25,67,0
353,5249,TCQ7j55cp3iQY2crxSrod75YneerL94o,SpATywNh6bZuzm8s1ceuBUnMUAeoAHHw,29,35,16,29,7,4,15,0,106,15.142857142857142,6,0.0,12,16,27,7,23,4,2,15,0,62,44,1
354,5255,0NbLYZNvmNdh82upKkBVVwJoa5b6RKVj,SpATywNh6bZuzm8s1ceuBUnMUAeoAHHw,27,49,18,36,5,18,29,6,161,23.0,5,0.0,4,18,30,5,45,18,6,29,6,57,104,0
355,5272,ClI23A4eXCdUFVQKR5uvI4exGZKJHgkV,SpATywNh6bZuzm8s1ceuBUnMUAeoAHHw,6,6,0,0,0,0,2,0,8,1.1428571428571428,4,0.0,0,0,0,0,6,0,0,2,0,0,8,1
356,5280,nsvq9MYt4IahoN4kXXFtAP2mFM9VmORm,SpATywNh6bZuzm8s1ceuBUnMUAeoAHHw,20,25,12,18,6,20,8,0,89,12.714285714285714,2,0.0,7,12,16,6,18,20,2,8,0,41,48,1
357,5284,QqE2Xjwy9gUzOvFdkDqAwAaNZLBZkxvd,RXDvfPUBYFlVdlueBFbLW0mhhAyGEqpt,55,312,20,91,12,220,124,1,780,111.42857142857143,20,0.0,20,20,84,12,292,220,7,124,1,136,644,0
358,5290,4xEpIgR9alQqM4xeSug69KmBmO9gpD69,A3fsA9Zfv1X2fVEQhTw51lKENdNrEqT3,82,159,83,114,46,75,75,5,557,79.57142857142857,13,0.0,9,83,104,46,150,75,10,75,5,242,315,0
359,5294,KZD0EIKZJQdXNs947RuceyEoKIUwV8dz,SpATywNh6bZuzm8s1ceuBUnMUAeoAHHw,1,0,0,0,0,0,1,0,1,0.14285714285714285,1,0.0,0,0,0,0,0,0,0,1,0,0,1,1
360,5311,SFbTZDEo0JTOG7VHfxeJz2kz3qSzlHq4,SpATywNh6bZuzm8s1ceuBUnMUAeoAHHw,19,39,2,40,0,0,9,0,90,12.857142857142858,6,0.0,18,2,35,0,21,0,5,9,0,55,35,0
361,5316,0tT4cQq52T8bu4irQ9KewNXtlD33hVZo,SpATywNh6bZuzm8s1ceuBUnMUAeoAHHw,29,39,23,32,9,4,18,1,126,18.0,6,0.0,4,23,30,9,35,4,2,18,1,66,60,0
362,5337,a6f3gPi6axX0cfBnUGVliBDQrPx92l1r,bWdj2GDclj5ofokWjzoa5jAwMkxCykd6,52,221,99,205,68,42,35,2,672,96.0,14,0.0,72,99,173,68,149,42,32,35,2,412,260,1
363,5368,dXV6CXhMuL2MovsaBcVnWuwVAfDnBy3D,A3fsA9Zfv1X2fVEQhTw51lKENdNrEqT3,12,18,0,0,0,54,9,0,81,11.571428571428571,4,0.0,0,0,0,0,18,54,0,9,0,0,81,1
364,5369,AcgDUm5SSEb0zgM8tYKiOFvTewc0KRAc,SpATywNh6bZuzm8s1ceuBUnMUAeoAHHw,29,31,19,19,9,3,9,0,90,12.857142857142858,5,0.0,9,19,19,9,22,3,0,9,0,56,34,0
365,5374,Z9h5SEHVh1MWbNBNnOXUduD5djAjdPpF,SpATywNh6bZuzm8s1ceuBUnMUAeoAHHw,2,0,0,0,0,0,3,0,3,0.42857142857142855,1,0.0,0,0,0,0,0,0,0,3,0,0,3,1
366,5416,nds56JS5tgInTRshD1ZJkwXi4oW5Ln7a,RXDvfPUBYFlVdlueBFbLW0mhhAyGEqpt,66,113,65,143,24,72,43,1,461,65.85714285714286,14,0.0,13,65,126,24,100,72,17,43,1,228,233,0
367,5431,VnkZQ14wQqfipOllRb5zJLKqrvJ7kfcr,A3fsA9Zfv1X2fVEQhTw51lKENdNrEqT3,1,0,0,0,0,0,2,0,2,0.2857142857142857,2,0.0,0,0,0,0,0,0,0,2,0,0,2,1
368,5435,90Sn7UxaiRTmCSrIbSNevcUMokJI9XYS,A3fsA9Zfv1X2fVEQhTw51lKENdNrEqT3,11,14,1,0,1,0,3,0,19,2.7142857142857144,2,0.0,0,1,0,1,14,0,0,3,0,2,17,1
369,5439,vUerya30clLdh9EQX34ayPT3Cr8C7lb8,A3fsA9Zfv1X2fVEQhTw51lKENdNrEqT3,6,7,0,0,0,0,3,0,10,1.4285714285714286,1,0.0,0,0,0,0,7,0,0,3,0,0,10,1
370,5470,acVvGaaH1iVFQOYF94V9THpGPkF7EIj3,SpATywNh6bZuzm8s1ceuBUnMUAeoAHHw,20,44,22,22,11,10,22,3,134,19.142857142857142,4,0.0,14,22,19,11,30,10,3,22,3,66,68,0
371,5471,ZWj0iRzT4HOMV032BfEyYj9IEk1Rdo03,SpATywNh6bZuzm8s1ceuBUnMUAeoAHHw,25,104,1,41,0,73,24,3,246,35.142857142857146,4,0.0,48,1,34,0,56,73,7,24,3,83,163,0
372,5482,lfAQ0nsHdkBDoIcTW4jXyPy4wOsVYtMB,RXDvfPUBYFlVdlueBFbLW0mhhAyGEqpt,72,89,50,171,23,18,28,4,383,54.714285714285715,6,0.0,31,50,160,23,58,18,11,28,4,264,119,1
373,5484,DjQWiwlbqq88H7QziTtErXo3yBTqRc6U,A3fsA9Zfv1X2fVEQhTw51lKENdNrEqT3,9,10,4,0,0,1,7,1,23,3.2857142857142856,6,0.0,0,4,0,0,10,1,0,7,1,4,19,1
374,5495,xsW19PmjvHmfOgtSCjdxnkpzOWqbKfLn,SpATywNh6bZuzm8s1ceuBUnMUAeoAHHw,32,94,40,27,12,31,41,3,248,35.42857142857143,11,0.0,38,40,25,12,56,31,2,41,3,115,133,0
375,5509,BSZDIT15eAtNgfldCBCd9uZr5nmLTo1Y,RXDvfPUBYFlVdlueBFbLW0mhhAyGEqpt,1,0,0,0,0,0,1,0,1,0.14285714285714285,1,0.0,0,0,0,0,0,0,0,1,0,0,1,1
376,5519,BsWy5ImeTPQvYgOCRPYHOm3gBOyZfxYj,SpATywNh6bZuzm8s1ceuBUnMUAeoAHHw,19,24,12,14,8,0,5,0,63,9.0,4,0.0,7,12,14,8,17,0,0,5,0,41,22,0
377,5523,njb10SfHXKB30cApzPJzWBcqA8VQx0HA,SpATywNh6bZuzm8s1ceuBUnMUAeoAHHw,3,0,0,0,0,0,4,0,4,0.5714285714285714,2,0.0,0,0,0,0,0,0,0,4,0,0,4,1
378,5546,sc5S8mzwcw7LbcetViv5Dahuhyet4uF1,SpATywNh6bZuzm8s1ceuBUnMUAeoAHHw,19,36,10,36,0,25,14,3,124,17.714285714285715,4,0.0,17,10,30,0,19,25,6,14,3,57,67,0
379,5558,WRVD7vy9jlNHm0bah44rHP1heNWkqPcT,G8EPVSXsOYB5YQWZGiz1aVq5Pgr2GrQu,1,0,0,0,0,0,1,0,1,0.14285714285714285,1,0.0,0,0,0,0,0,0,0,1,0,0,1,1
380,5562,XERB0lrfKs66PgzJO1IOD0FHZqNqZnJ6,G8EPVSXsOYB5YQWZGiz1aVq5Pgr2GrQu,5,2,1,0,1,0,2,0,6,0.8571428571428571,1,0.0,0,1,0,1,2,0,0,2,0,2,4,1
381,5584,Qt99KRFUK6FY5ovJvB9yRLziSf5bEirX,SpATywNh6bZuzm8s1ceuBUnMUAeoAHHw,22,34,14,8,6,1,9,1,73,10.428571428571429,3,0.0,6,14,8,6,28,1,0,9,1,34,39,1
382,5585,9SqAB4FNYGY3EljMvCEjcqYhPFLwBD3j,SpATywNh6bZuzm8s1ceuBUnMUAeoAHHw,7,3,0,0,0,16,7,1,27,3.857142857142857,1,0.0,0,0,0,0,3,16,0,7,1,0,27,1
383,5606,Ecxkox9cBNw9DlXWEeDlSJP4O73ORQaY,SpATywNh6bZuzm8s1ceuBUnMUAeoAHHw,7,21,5,0,2,0,3,0,31,4.428571428571429,4,0.0,0,5,0,2,21,0,0,3,0,7,24,0
384,5621,3rCZba8eKP7jaFsDjNb32WoGn9BjnrjN,A3fsA9Zfv1X2fVEQhTw51lKENdNrEqT3,38,44,21,86,13,35,11,0,210,30.0,4,0.0,7,21,68,13,37,35,18,11,0,109,101,1
385,5623,0V0UTSnfmpjJ4ctKxsLk1IHNpN42J6mH,G8EPVSXsOYB5YQWZGiz1aVq5Pgr2GrQu,4,2,0,0,0,0,3,0,5,0.7142857142857143,1,0.0,0,0,0,0,2,0,0,3,0,0,5,1
386,5635,7bFemKDlww8gPchsZMuFNOn3TtHTqbHw,bWdj2GDclj5ofokWjzoa5jAwMkxCykd6,6,7,2,0,1,0,11,0,21,3.0,3,0.0,0,2,0,1,7,0,0,11,0,3,18,1
387,5641,dzQyKxZ43BiLWGC6nfqSfnHfJKyWUbky,SpATywNh6bZuzm8s1ceuBUnMUAeoAHHw,11,8,6,0,5,0,4,0,23,3.2857142857142856,1,0.0,0,6,0,5,8,0,0,4,0,11,12,1
388,5642,IAvuP4GGmvnNj3Zisz3jDfo3mSmXiJSb,A3fsA9Zfv1X2fVEQhTw51lKENdNrEqT3,34,108,4,56,2,0,11,0,181,25.857142857142858,7,0.0,0,4,44,2,108,0,12,11,0,50,131,1
389,5644,J388HMX5pYHjqXdA7jEUkFec6orRQtIq,A3fsA9Zfv1X2fVEQhTw51lKENdNrEqT3,35,58,31,0,8,0,16,0,113,16.142857142857142,4,0.0,0,31,0,8,58,0,0,16,0,39,74,0
390,5655,PztWYF4ZTLP8rvUvCUcN3hQiYuYJPY9t,bWdj2GDclj5ofokWjzoa5jAwMkxCykd6,7,14,4,0,1,0,7,0,26,3.7142857142857144,3,0.0,0,4,0,1,14,0,0,7,0,5,21,1
391,5660,CZZkgDgsqVR6ftNFrTmx0jPpBHh2f3Zo,SpATywNh6bZuzm8s1ceuBUnMUAeoAHHw,26,144,8,33,3,97,57,2,344,49.142857142857146,15,0.0,31,8,32,3,113,97,1,57,2,74,270,0
392,5663,1QA0SqfAW0hFBv6FjoAHgHRHfBlvLSPL,A3fsA9Zfv1X2fVEQhTw51lKENdNrEqT3,4,2,0,0,0,0,3,0,5,0.7142857142857143,2,0.0,0,0,0,0,2,0,0,3,0,0,5,1
393,5671,HbDaABEakQmE8DQEoFoIphu2SH13rFRy,A3fsA9Zfv1X2fVEQhTw51lKENdNrEqT3,41,21,16,78,12,0,4,0,131,18.714285714285715,4,0.0,1,16,67,12,20,0,11,4,0,96,35,1
394,5672,HbDaABEakQmE8DQEoFoIphu2SH13rFRy,bWdj2GDclj5ofokWjzoa5jAwMkxCykd6,5,6,3,0,1,0,4,0,14,2.0,3,0.0,0,3,0,1,6,0,0,4,0,4,10,1
395,5675,HbDaABEakQmE8DQEoFoIphu2SH13rFRy,RXDvfPUBYFlVdlueBFbLW0mhhAyGEqpt,7,10,7,0,2,0,4,0,23,3.2857142857142856,3,0.0,0,7,0,2,10,0,0,4,0,9,14,1
396,5702,C6xrhZPOmVH2gCVNP26gSSPka2CcwgB5,bWdj2GDclj5ofokWjzoa5jAwMkxCykd6,25,24,15,82,11,13,11,0,156,22.285714285714285,3,0.0,9,15,78,11,15,13,4,11,0,113,43,1
397,5705,TwYAYdYU7yn5FjnP72W4DEwE8N7Dqkqq,bWdj2GDclj5ofokWjzoa5jAwMkxCykd6,8,10,2,0,2,1,8,0,23,3.2857142857142856,3,0.0,0,2,0,2,10,1,0,8,0,4,19,1
398,5724,9b2fchNyVZPjqpmxjleqzL9edi9EOH23,SpATywNh6bZuzm8s1ceuBUnMUAeoAHHw,6,1,1,0,1,0,4,0,7,1.0,2,0.0,0,1,0,1,1,0,0,4,0,2,5,1
399,5740,PizUKf6mRUas66X3VMYXf9aygnN1CUCf,SpATywNh6bZuzm8s1ceuBUnMUAeoAHHw,27,51,23,24,15,18,8,5,144,20.571428571428573,2,0.0,25,23,20,15,26,18,4,8,5,83,61,1
400,5743,57qzgJAwfROYPxzSOrsA3G5DLHP95ajU,RXDvfPUBYFlVdlueBFbLW0mhhAyGEqpt,36,48,36,0,19,0,15,0,118,16.857142857142858,7,0.0,2,36,0,19,46,0,0,15,0,57,61,0
401,5746,seRgjh60dHSex83x3yaP07EkHkNZ3zq1,SpATywNh6bZuzm8s1ceuBUnMUAeoAHHw,31,66,32,36,12,11,14,1,172,24.571428571428573,8,0.0,25,32,32,12,41,11,4,14,1,101,71,0
402,5768,ytK9EwjDrcEsoXMvgjh9BEVuEXIjTD3M,bWdj2GDclj5ofokWjzoa5jAwMkxCykd6,7,4,2,0,2,0,4,0,12,1.7142857142857142,1,0.0,0,2,0,2,4,0,0,4,0,4,8,1
403,5777,FVINYuQhNwQ1IBS2HaRVFMtFczGjKWmz,SpATywNh6bZuzm8s1ceuBUnMUAeoAHHw,1,0,0,0,0,0,1,0,1,0.14285714285714285,1,0.0,0,0,0,0,0,0,0,1,0,0,1,1
404,5781,D2S5bjWjmtwLivqx7n7FZWso5Kd6We5x,bWdj2GDclj5ofokWjzoa5jAwMkxCykd6,29,51,10,83,3,1,11,0,159,22.714285714285715,5,0.0,14,10,74,3,37,1,9,11,0,101,58,0
405,5785,Llzpy0Dk1LPSE6nBLZ8vNVNgQXCzGpc1,SpATywNh6bZuzm8s1ceuBUnMUAeoAHHw,31,52,31,26,17,0,22,2,150,21.428571428571427,9,0.0,6,31,22,17,46,0,4,22,2,76,74,1
406,5788,zysr84QD6b78mLaezXoryEdhH6kH14EQ,SpATywNh6bZuzm8s1ceuBUnMUAeoAHHw,29,41,24,32,11,0,10,0,118,16.857142857142858,8,0.0,9,24,30,11,32,0,2,10,0,74,44,0
407,5792,GIb3glgYrsEfHWtEWPWpwONqwE7RMf6f,bWdj2GDclj5ofokWjzoa5jAwMkxCykd6,52,238,121,153,18,145,87,4,766,109.42857142857143,17,0.0,17,121,139,18,221,145,14,87,4,295,471,0
408,5802,8tzllCaQFf5FO2XcYgqoYiMGBjUwujYx,A3fsA9Zfv1X2fVEQhTw51lKENdNrEqT3,5,3,0,0,0,0,4,0,7,1.0,1,0.0,0,0,0,0,3,0,0,4,0,0,7,1
409,5803,sD3rDh1CtXsAdfDDyFRBf917K7ELQzHQ,SpATywNh6bZuzm8s1ceuBUnMUAeoAHHw,22,68,28,32,9,0,22,0,159,22.714285714285715,7,0.0,16,28,31,9,52,0,1,22,0,84,75,0
410,5805,VUYRWxIK25dyFla7xdkPw6qN6gZPPejU,SpATywNh6bZuzm8s1ceuBUnMUAeoAHHw,20,37,25,6,10,0,14,0,92,13.142857142857142,4,0.0,2,25,6,10,35,0,0,14,0,43,49,0
411,5807,8tzllCaQFf5FO2XcYgqoYiMGBjUwujYx,bWdj2GDclj5ofokWjzoa5jAwMkxCykd6,5,15,0,0,1,0,6,0,22,3.142857142857143,2,0.0,3,0,0,1,12,0,0,6,0,4,18,1
412,5822,yXIAbgjR7S4042oicRyG8kfTX0pG8yI5,SpATywNh6bZuzm8s1ceuBUnMUAeoAHHw,22,35,1,14,1,4,5,0,60,8.571428571428571,2,0.0,8,1,13,1,27,4,1,5,0,23,37,0
413,5826,zTf8XOQnwWWl1KDwh9NJmoY9QiDPt6oU,SpATywNh6bZuzm8s1ceuBUnMUAeoAHHw,29,66,40,32,14,0,22,1,175,25.0,12,0.0,15,40,31,14,51,0,1,22,1,100,75,0
414,5827,IXG6Mrr8VTjEEQIqeVi1KlyYwZ2T4ziy,A3fsA9Zfv1X2fVEQhTw51lKENdNrEqT3,4,2,1,0,1,0,1,0,5,0.7142857142857143,1,0.0,0,1,0,1,2,0,0,1,0,2,3,0
415,5841,eKmIYKU6Yx5AUBketpCKhFRjn0XSrN5J,SpATywNh6bZuzm8s1ceuBUnMUAeoAHHw,30,54,31,22,16,3,16,1,143,20.428571428571427,3,0.0,8,31,22,16,46,3,0,16,1,77,66,0
416,5865,Ojf2FGMPjkgcQ8cOS7KSlXqYowZOsPoh,A3fsA9Zfv1X2fVEQhTw51lKENdNrEqT3,14,24,12,0,2,2,12,0,52,7.428571428571429,8,0.0,0,12,0,2,24,2,0,12,0,14,38,0
417,5876,5hXpDY3fUOWXeNSNssxdgQEXyy5gGZpD,SpATywNh6bZuzm8s1ceuBUnMUAeoAHHw,6,5,1,0,1,0,2,0,9,1.2857142857142858,1,0.0,1,1,0,1,4,0,0,2,0,3,6,1
418,5890,8c2gk77rfHeG4kEZpifVHT547X2ayTNE,RXDvfPUBYFlVdlueBFbLW0mhhAyGEqpt,70,134,82,143,31,46,43,4,483,69.0,7,0.0,28,82,139,31,106,46,4,43,4,280,203,0
419,5892,1YxknoiTrSwQgclDlSAh4oMYHRyARhLv,SpATywNh6bZuzm8s1ceuBUnMUAeoAHHw,24,44,16,12,6,0,12,0,90,12.857142857142858,7,0.0,20,16,12,6,24,0,0,12,0,54,36,0
420,5894,biGiKcwkAdzTvOFIAeW8Vs1H1jbCmhSY,SpATywNh6bZuzm8s1ceuBUnMUAeoAHHw,4,2,0,0,0,0,2,0,4,0.5714285714285714,1,0.0,0,0,0,0,2,0,0,2,0,0,4,1
421,5902,7o8xhk1rh0BQyK6zL1slDKappRA3D8Mk,SpATywNh6bZuzm8s1ceuBUnMUAeoAHHw,24,30,6,27,4,4,15,2,88,12.571428571428571,3,0.0,11,6,26,4,19,4,1,15,2,47,41,0
422,5927,vYyC3PI9WOfKd54xBrxSVvrhn62CQxzz,SpATywNh6bZuzm8s1ceuBUnMUAeoAHHw,26,31,20,13,9,0,5,0,78,11.142857142857142,5,0.0,4,20,13,9,27,0,0,5,0,46,32,1
423,5934,hdKqkkWKrDzbKE9btGChBqiCfsTwp68E,A3fsA9Zfv1X2fVEQhTw51lKENdNrEqT3,37,41,27,28,12,62,45,3,218,31.142857142857142,12,0.0,2,27,23,12,39,62,5,45,3,64,154,0
424,5971,XVAvU5kUUejQSld1XjHX8mt1uGOkgzW4,RXDvfPUBYFlVdlueBFbLW0mhhAyGEqpt,9,6,5,0,3,0,2,0,16,2.2857142857142856,2,0.0,0,5,0,3,6,0,0,2,0,8,8,1
425,6001,Wb4KcRKSzKNnIp1HnFKSZY95LILGuTll,SpATywNh6bZuzm8s1ceuBUnMUAeoAHHw,23,33,0,31,1,1,7,0,73,10.428571428571429,2,0.0,13,0,28,1,20,1,3,7,0,42,31,0
426,6004,dlFVVLBV3ZD4RhjUk38UJOj8FktRTHQw,SpATywNh6bZuzm8s1ceuBUnMUAeoAHHw,1,0,0,0,0,0,2,0,2,0.2857142857142857,2,0.0,0,0,0,0,0,0,0,2,0,0,2,1
427,6018,cJcuhtji0eqLhfXtnFSDlw6v5huTlvOS,SpATywNh6bZuzm8s1ceuBUnMUAeoAHHw,25,37,1,28,1,5,10,1,83,11.857142857142858,6,0.0,13,1,22,1,24,5,6,10,1,37,46,0
428,6022,zzh7OhB1yuFx7KNMW6cKx1t3e2ezVcvZ,SpATywNh6bZuzm8s1ceuBUnMUAeoAHHw,6,4,1,0,1,0,2,0,8,1.1428571428571428,1,0.0,0,1,0,1,4,0,0,2,0,2,6,1
429,6031,H2B0ZVh2RYo5LjimmBQ15UDjcAOL7h2y,A3fsA9Zfv1X2fVEQhTw51lKENdNrEqT3,9,3,3,0,3,0,10,1,20,2.857142857142857,2,0.0,0,3,0,3,3,0,0,10,1,6,14,1
430,6032,sc5S8mzwcw7LbcetViv5Dahuhyet4uF1,bWdj2GDclj5ofokWjzoa5jAwMkxCykd6,17,17,9,16,1,24,12,1,80,11.428571428571429,3,0.0,0,9,16,1,17,24,0,12,1,26,54,1
431,6048,hf7YI3B1kTTuvmd2vS9DIoiPGXbrQyBH,SpATywNh6bZuzm8s1ceuBUnMUAeoAHHw,26,51,5,18,4,59,25,0,162,23.142857142857142,8,0.0,17,5,15,4,34,59,3,25,0,41,121,0
432,6058,KrIVcXIiCdwRGUI4WguKXHPsvZChbtIb,A3fsA9Zfv1X2fVEQhTw51lKENdNrEqT3,71,75,49,154,22,97,31,0,428,61.142857142857146,9,0.0,4,49,118,22,71,97,36,31,0,193,235,0
433,6059,RDBly29xbybxfRPXjsOP81xd2Sgww6yI,bWdj2GDclj5ofokWjzoa5jAwMkxCykd6,8,11,5,34,3,0,15,0,68,9.714285714285714,5,0.0,1,5,33,3,10,0,1,15,0,42,26,1
434,6069,imazrFpyX68kLUAydat119Z5XKshja9y,SpATywNh6bZuzm8s1ceuBUnMUAeoAHHw,24,36,22,26,6,0,12,0,102,14.571428571428571,9,0.0,4,22,25,6,32,0,1,12,0,57,45,0
435,6084,egIcBO9xXh5XDAWBOR2C58eTHcHVaPTq,SpATywNh6bZuzm8s1ceuBUnMUAeoAHHw,10,7,5,0,3,31,5,0,51,7.285714285714286,4,0.0,0,5,0,3,7,31,0,5,0,8,43,1
436,6086,ZL7VsgZBlKFfi6BGNSyN1gGJros1L9ra,SpATywNh6bZuzm8s1ceuBUnMUAeoAHHw,30,58,20,23,6,46,26,1,180,25.714285714285715,4,0.0,18,20,19,6,40,46,4,26,1,63,117,1
437,6087,uUWoPLkJSFKbD6KppcebOwMXezopCcLj,SpATywNh6bZuzm8s1ceuBUnMUAeoAHHw,24,188,24,40,8,25,42,1,328,46.857142857142854,7,0.0,57,24,33,8,131,25,7,42,1,122,206,0
438,6090,Qsrx4kwwBFByqyYPAbCeTAurBzPDhOG4,SpATywNh6bZuzm8s1ceuBUnMUAeoAHHw,5,6,3,0,1,0,3,0,13,1.8571428571428572,3,0.0,0,3,0,1,6,0,0,3,0,4,9,1
439,6125,CovNnemmooeYpLX2YfcP75dIKg65MoIW,SpATywNh6bZuzm8s1ceuBUnMUAeoAHHw,4,2,1,0,1,0,1,0,5,0.7142857142857143,1,0.0,0,1,0,1,2,0,0,1,0,2,3,1
440,6136,sF8Qur7NIXPGJG744QNBCJLJgM51K1cT,SpATywNh6bZuzm8s1ceuBUnMUAeoAHHw,10,20,9,0,4,2,7,0,42,6.0,3,0.0,3,9,0,4,17,2,0,7,0,16,26,1
441,6184,Ui5s6msHQkQWoojIHrlye6CrlPfuJtqr,SpATywNh6bZuzm8s1ceuBUnMUAeoAHHw,7,4,1,0,1,0,2,0,8,1.1428571428571428,1,0.0,0,1,0,1,4,0,0,2,0,2,6,1
442,6197,6A2JLpLWnCwUlo9pD1HHlgEwNLvzcllv,SpATywNh6bZuzm8s1ceuBUnMUAeoAHHw,22,24,14,12,8,0,6,0,64,9.142857142857142,5,0.0,4,14,9,8,20,0,3,6,0,35,29,1
443,6200,P1GB7lMEFMwTm3zg0Vd2JWGeu5aUPfGc,bWdj2GDclj5ofokWjzoa5jAwMkxCykd6,1,0,0,0,0,0,1,0,1,0.14285714285714285,1,0.0,0,0,0,0,0,0,0,1,0,0,1,1
444,6203,qwOn6svjZUr6PbEPbdgCynJcocJs2Tff,SpATywNh6bZuzm8s1ceuBUnMUAeoAHHw,32,46,25,18,12,19,19,1,140,20.0,5,0.0,9,25,18,12,37,19,0,19,1,64,76,0
445,6215,FgYPvBwLri7YiFI9og6clP9FuKJ08jX7,SpATywNh6bZuzm8s1ceuBUnMUAeoAHHw,27,45,22,22,9,1,6,0,105,15.0,5,0.0,13,22,21,9,32,1,1,6,0,65,40,1
446,6217,xVu6NAX59MOmpApYDfs9WPe7YPPVhsFD,A3fsA9Zfv1X2fVEQhTw51lKENdNrEqT3,44,35,8,62,7,5,11,1,129,18.428571428571427,3,0.0,1,8,53,7,34,5,9,11,1,69,60,1
447,6222,2CJPniJdzPQB2xVD7usFld4N6998DubA,SpATywNh6bZuzm8s1ceuBUnMUAeoAHHw,30,62,29,34,12,33,36,2,208,29.714285714285715,10,0.0,21,29,27,12,41,33,7,36,2,89,119,0
448,6235,ywdL3xkp7d2PSjbvnflAvIe7Wp6Q4SRe,A3fsA9Zfv1X2fVEQhTw51lKENdNrEqT3,90,61,16,242,9,0,23,0,351,50.142857142857146,9,0.0,3,16,218,9,58,0,24,23,0,246,105,0
449,6238,rc6U1IMtYVyu2KS4UAAUQ2nFc3tipLM4,SpATywNh6bZuzm8s1ceuBUnMUAeoAHHw,3,0,0,0,0,0,3,0,3,0.42857142857142855,1,0.0,0,0,0,0,0,0,0,3,0,0,3,1
450,6241,JOowoFboUWVsMh86KvKaqn28cyqJccLu,SpATywNh6bZuzm8s1ceuBUnMUAeoAHHw,22,61,5,37,1,32,22,1,159,22.714285714285715,10,0.0,27,5,32,1,34,32,5,22,1,65,94,1
451,6251,xHZbSROhwP4RRQerUVWvcNTfOGc2DHWf,A3fsA9Zfv1X2fVEQhTw51lKENdNrEqT3,95,133,57,357,18,156,68,2,791,113.0,16,0.0,12,57,274,18,121,156,83,68,2,361,430,0
452,6275,CMyYXmkdotyZIBj4pIMXARl4LU8dOntR,RXDvfPUBYFlVdlueBFbLW0mhhAyGEqpt,15,13,6,0,3,4,7,3,36,5.142857142857143,1,0.0,2,6,0,3,11,4,0,7,3,11,25,1
453,6276,e05jFgKTpMKrOATktordZrOlXAadcmLm,bWdj2GDclj5ofokWjzoa5jAwMkxCykd6,5,4,1,0,1,0,2,0,8,1.1428571428571428,2,0.0,0,1,0,1,4,0,0,2,0,2,6,1
454,6297,IBlNXwDR3MmRt5PBvnP44ynAugPBAbiq,A3fsA9Zfv1X2fVEQhTw51lKENdNrEqT3,8,12,5,0,0,0,5,0,22,3.142857142857143,4,0.0,0,5,0,0,12,0,0,5,0,5,17,1
455,6301,4NUGABfnQkRS9FoH90Vgnhdha4tRSmOB,A3fsA9Zfv1X2fVEQhTw51lKENdNrEqT3,80,91,58,122,26,0,30,0,327,46.714285714285715,16,0.0,8,58,101,26,83,0,21,30,0,193,134,0
456,6310,K0OSl2yDmHYQ9TtZdxy9shErNwx3ga0n,SpATywNh6bZuzm8s1ceuBUnMUAeoAHHw,13,13,5,20,1,0,2,0,41,5.857142857142857,2,0.0,6,5,19,1,7,0,1,2,0,31,10,1
457,6322,2IvFgMw0NfaiiFt35dmyYrQHt1TRMHZA,SpATywNh6bZuzm8s1ceuBUnMUAeoAHHw,31,77,29,28,11,93,79,7,324,46.285714285714285,6,0.0,26,29,26,11,51,93,2,79,7,92,232,0
458,6333,VRqncpDBm1hyq75gsrR3U5uyrx0nFI6D,G8EPVSXsOYB5YQWZGiz1aVq5Pgr2GrQu,9,13,6,0,3,0,4,0,26,3.7142857142857144,2,0.0,0,6,0,3,13,0,0,4,0,9,17,0
459,6344,e09uq36QgLuBVK5DERoejsHeMH2uPMRM,RXDvfPUBYFlVdlueBFbLW0mhhAyGEqpt,7,5,1,0,1,0,2,0,9,1.2857142857142858,1,0.0,0,1,0,1,5,0,0,2,0,2,7,1
460,6360,S6vBzHKpSh31SFGGZmwgKaOH2RvW3RpH,A3fsA9Zfv1X2fVEQhTw51lKENdNrEqT3,10,10,8,0,7,0,4,0,29,4.142857142857143,4,0.0,0,8,0,7,10,0,0,4,0,15,14,0
461,6361,8nT76hrzyl8ZAUdI7W6kfrIzHxI3puKM,A3fsA9Zfv1X2fVEQhTw51lKENdNrEqT3,62,62,0,132,0,0,19,0,213,30.428571428571427,7,0.0,2,0,130,0,60,0,2,19,0,132,81,0
462,6386,sgU8bYbkNg27HLTOfRzwWIg1HmjCd9Xd,SpATywNh6bZuzm8s1ceuBUnMUAeoAHHw,25,41,1,41,1,2,22,3,111,15.857142857142858,6,0.0,14,1,35,1,27,2,6,22,3,51,60,0
463,6391,VWT0erf4AD2BzAGMlVwaBcrhUFyVXGW3,SpATywNh6bZuzm8s1ceuBUnMUAeoAHHw,24,54,2,28,0,48,25,4,161,23.0,7,0.0,21,2,26,0,33,48,2,25,4,49,112,0
464,6396,mXsmDArxUTe9rMFHp3cGPJEx5ACYKD90,SpATywNh6bZuzm8s1ceuBUnMUAeoAHHw,28,70,31,35,9,125,14,0,284,40.57142857142857,9,0.0,26,31,30,9,44,125,5,14,0,96,188,0
465,6407,y7mamutAMELy79Bgdj0zOeVjiQ071oNX,SpATywNh6bZuzm8s1ceuBUnMUAeoAHHw,26,56,17,23,9,0,7,0,112,16.0,6,0.0,23,17,20,9,33,0,3,7,0,69,43,0
466,6419,ogzPi8CzE9rbCDvKtEdVGoEcOcn50cII,G8EPVSXsOYB5YQWZGiz1aVq5Pgr2GrQu,1,0,0,0,0,0,1,0,1,0.14285714285714285,1,0.0,0,0,0,0,0,0,0,1,0,0,1,1
467,6423,46NDON0KgB1jK61LBfpVyB2xpUlT8XUc,SpATywNh6bZuzm8s1ceuBUnMUAeoAHHw,4,2,0,0,0,0,4,0,6,0.8571428571428571,1,0.0,0,0,0,0,2,0,0,4,0,0,6,1
468,6427,vuqnfFRpmwKE9RdxK6XJMNF9m6H6VyTM,RXDvfPUBYFlVdlueBFbLW0mhhAyGEqpt,74,117,76,177,33,49,28,12,492,70.28571428571429,8,0.0,25,76,159,33,92,49,18,28,12,293,199,0
469,6453,thQSVbeIiNRLplpbUVbYa004tKe0jz1z,SpATywNh6bZuzm8s1ceuBUnMUAeoAHHw,17,33,4,14,0,0,8,0,59,8.428571428571429,4,0.0,2,4,12,0,31,0,2,8,0,18,41,1
470,6473,QYNtwRXZGk0TiZU9fvvZmyYTg9wzmVe8,bWdj2GDclj5ofokWjzoa5jAwMkxCykd6,48,132,11,157,5,290,117,4,716,102.28571428571429,17,0.0,24,11,134,5,108,290,23,117,4,174,542,0
471,6475,4NUGABfnQkRS9FoH90Vgnhdha4tRSmOB,SpATywNh6bZuzm8s1ceuBUnMUAeoAHHw,28,67,30,12,8,7,48,1,173,24.714285714285715,15,0.0,20,30,9,8,47,7,3,48,1,67,106,0
472,6476,5l7JbkjmfBonHdF7CbCa3GMejToAwTQZ,SpATywNh6bZuzm8s1ceuBUnMUAeoAHHw,20,39,6,24,0,8,25,2,104,14.857142857142858,5,0.0,15,6,21,0,24,8,3,25,2,42,62,1
473,6480,fFnDSL1hWADv25SE5UTFI35tGRTcYBEF,SpATywNh6bZuzm8s1ceuBUnMUAeoAHHw,24,55,3,30,2,1,10,0,101,14.428571428571429,3,0.0,14,3,26,2,41,1,4,10,0,45,56,0
474,6490,CozZoSX7AwprtwyJFCAeFUYiCq7OSEAP,G8EPVSXsOYB5YQWZGiz1aVq5Pgr2GrQu,16,47,17,0,11,0,3,0,78,11.142857142857142,5,0.0,0,17,0,11,47,0,0,3,0,28,50,0
475,6494,w1o1S1rsKOagmFCmrSXvpPsO3fHW3lAq,A3fsA9Zfv1X2fVEQhTw51lKENdNrEqT3,57,46,30,108,14,16,25,4,243,34.714285714285715,5,0.0,4,30,86,14,42,16,22,25,4,134,109,1
476,6497,QYNtwRXZGk0TiZU9fvvZmyYTg9wzmVe8,A3fsA9Zfv1X2fVEQhTw51lKENdNrEqT3,70,143,5,190,3,428,130,3,902,128.85714285714286,17,0.0,10,5,152,3,133,428,38,130,3,170,732,0
477,6502,MFUbiMqXEmfaBzK7hirtX5aBXDvqfQ39,RXDvfPUBYFlVdlueBFbLW0mhhAyGEqpt,31,36,24,34,12,4,10,1,121,17.285714285714285,5,0.0,6,24,31,12,30,4,3,10,1,73,48,0
478,6507,srJeJbIuD6nlvLtYdUFiQcvh7X1ghk8m,bWdj2GDclj5ofokWjzoa5jAwMkxCykd6,1,0,0,0,0,0,1,0,1,0.14285714285714285,1,0.0,0,0,0,0,0,0,0,1,0,0,1,1
479,6527,iYw8kPkvjn3xb3wtZEyAytTepRhqUlKj,SpATywNh6bZuzm8s1ceuBUnMUAeoAHHw,28,61,28,28,10,6,22,2,157,22.428571428571427,7,0.0,6,28,26,10,55,6,2,22,2,70,87,0
480,6542,wSw0H7eAN6dfAeYMaWU4nG5bgtRJyFlj,SpATywNh6bZuzm8s1ceuBUnMUAeoAHHw,28,102,18,24,6,52,22,2,226,32.285714285714285,11,0.0,9,18,20,6,93,52,4,22,2,53,173,0
481,6547,6U06x0rZdU2wXE04MeChX934BjpYCGYO,A3fsA9Zfv1X2fVEQhTw51lKENdNrEqT3,71,52,30,108,11,30,15,2,248,35.42857142857143,5,0.0,7,30,97,11,45,30,11,15,2,145,103,0
482,6551,uiGGvm5bzelA6YjURZYgSYljUTVOBIB1,A3fsA9Zfv1X2fVEQhTw51lKENdNrEqT3,4,2,1,0,0,0,4,0,7,1.0,3,0.0,0,1,0,0,2,0,0,4,0,1,6,1
483,6556,xeRiyg2Y5ZgvqPGiWyjXk0hLMBeGkeoJ,RXDvfPUBYFlVdlueBFbLW0mhhAyGEqpt,22,25,12,48,9,2,12,1,109,15.571428571428571,5,0.0,7,12,39,9,18,2,9,12,1,67,42,0
484,6562,KnR9Rn7adHv02cUeYZsmQrRux2GhqbgV,SpATywNh6bZuzm8s1ceuBUnMUAeoAHHw,20,20,15,0,8,0,7,0,50,7.142857142857143,5,0.0,0,15,0,8,20,0,0,7,0,23,27,1
485,6563,5zX31TZPkBQ4nxGKP7lPYFABTGNW6PHa,A3fsA9Zfv1X2fVEQhTw51lKENdNrEqT3,51,51,23,122,9,57,25,1,288,41.142857142857146,8,0.0,4,23,95,9,47,57,27,25,1,131,157,1
486,6576,X1EwqmDy4MdORdVb79oGgVGVtNlVZgX3,A3fsA9Zfv1X2fVEQhTw51lKENdNrEqT3,8,1,1,0,0,1,14,2,19,2.7142857142857144,2,0.0,0,1,0,0,1,1,0,14,2,1,18,1
487,6579,FxyjnTbjAUnINdJgNqjfUflUXLEYBAKC,SpATywNh6bZuzm8s1ceuBUnMUAeoAHHw,25,76,8,12,2,6,12,0,116,16.571428571428573,7,0.0,35,8,12,2,41,6,0,12,0,57,59,0
488,6605,xR1z4zZU6RpVYkLfGcAdkLgM2fC8s4Qf,SpATywNh6bZuzm8s1ceuBUnMUAeoAHHw,1,0,0,0,0,0,1,0,1,0.14285714285714285,1,0.0,0,0,0,0,0,0,0,1,0,0,1,1
489,6606,vqNQHlaqBAqN0Ghl4wYJYkeoe3u1AJkM,SpATywNh6bZuzm8s1ceuBUnMUAeoAHHw,6,6,3,0,1,0,10,0,20,2.857142857142857,2,0.0,0,3,0,1,6,0,0,10,0,4,16,1
490,6619,TgtZeZ58ebuFniTgQX061K6ibFhvtBpU,SpATywNh6bZuzm8s1ceuBUnMUAeoAHHw,31,70,33,34,12,3,18,3,173,24.714285714285715,10,0.0,8,33,31,12,62,3,3,18,3,84,89,0
491,6633,hu8eak1Xmf8voE8pnxPzkSD2dZP9Sipf,SpATywNh6bZuzm8s1ceuBUnMUAeoAHHw,19,20,1,19,1,16,24,0,81,11.571428571428571,4,0.0,7,1,17,1,13,16,2,24,0,26,55,0
492,6634,CozZoSX7AwprtwyJFCAeFUYiCq7OSEAP,SpATywNh6bZuzm8s1ceuBUnMUAeoAHHw,18,50,21,0,15,0,4,0,90,12.857142857142858,5,0.0,0,21,0,15,50,0,0,4,0,36,54,0
493,6635,xKsPjk1jm2BE3h1iJlr6XUhvP4lcDdRk,RXDvfPUBYFlVdlueBFbLW0mhhAyGEqpt,71,100,61,177,34,14,20,2,408,58.285714285714285,9,0.0,23,61,163,34,77,14,14,20,2,281,127,0
494,6645,jzhfcjSJMALhuWl4kOoGHRTc9xbTfPXO,SpATywNh6bZuzm8s1ceuBUnMUAeoAHHw,10,21,2,0,0,0,4,0,27,3.857142857142857,4,0.0,0,2,0,0,21,0,0,4,0,2,25,0
495,6646,JV1BgG1khCT6s4RU5oY7ZOSmwW31Qjbp,SpATywNh6bZuzm8s1ceuBUnMUAeoAHHw,29,51,26,30,9,22,24,3,165,23.571428571428573,9,0.0,5,26,24,9,46,22,6,24,3,64,101,0
496,6651,imazrFpyX68kLUAydat119Z5XKshja9y,G8EPVSXsOYB5YQWZGiz1aVq5Pgr2GrQu,23,38,31,50,15,0,6,0,140,20.0,5,0.0,0,31,45,15,38,0,5,6,0,91,49,1
497,6654,WIULTFMTHtU9DH0SABu7cidImBPYBDLB,SpATywNh6bZuzm8s1ceuBUnMUAeoAHHw,30,41,6,28,5,1,20,2,103,14.714285714285714,3,0.0,5,6,26,5,36,1,2,20,2,42,61,1
498,6664,7nQB7cjVdr2HijR82OoX1oMRPa42JjfY,bWdj2GDclj5ofokWjzoa5jAwMkxCykd6,46,67,41,106,18,59,30,0,321,45.857142857142854,6,0.0,12,41,94,18,55,59,12,30,0,165,156,0
499,6665,tanZAGaF7HXSgqth6P4eBUao9FBYSWWr,G8EPVSXsOYB5YQWZGiz1aVq5Pgr2GrQu,6,6,1,0,1,0,5,0,13,1.8571428571428572,1,0.0,3,1,0,1,3,0,0,5,0,5,8,1
500,6666,MFUbiMqXEmfaBzK7hirtX5aBXDvqfQ39,A3fsA9Zfv1X2fVEQhTw51lKENdNrEqT3,11,7,6,0,5,0,2,0,20,2.857142857142857,3,0.0,0,6,0,5,7,0,0,2,0,11,9,1
501,6668,FFC6l9rAl1GAsErQ9wySBY8QQVxtUctK,SpATywNh6bZuzm8s1ceuBUnMUAeoAHHw,3,0,0,0,0,0,3,0,3,0.42857142857142855,1,0.0,0,0,0,0,0,0,0,3,0,0,3,1
502,6680,dSGnj6srDjb9PWIgErMSQXx2qQzyzYUX,SpATywNh6bZuzm8s1ceuBUnMUAeoAHHw,15,15,10,0,7,0,2,0,34,4.857142857142857,2,0.0,1,10,0,7,14,0,0,2,0,18,16,0
503,6682,hl9NS7ZQVsxPwew9lFoMcbw555xXfA7K,SpATywNh6bZuzm8s1ceuBUnMUAeoAHHw,19,23,11,14,5,0,7,0,60,8.571428571428571,4,0.0,7,11,11,5,16,0,3,7,0,34,26,1
504,6710,7FUJzRatex45Tiw3cL91Uz5fZD5gpQMy,RXDvfPUBYFlVdlueBFbLW0mhhAyGEqpt,2,0,0,0,0,0,2,0,2,0.2857142857142857,1,0.0,0,0,0,0,0,0,0,2,0,0,2,1
505,6712,7FUJzRatex45Tiw3cL91Uz5fZD5gpQMy,A3fsA9Zfv1X2fVEQhTw51lKENdNrEqT3,2,0,0,0,0,0,3,0,3,0.42857142857142855,1,0.0,0,0,0,0,0,0,0,3,0,0,3,1
506,6721,5EbadEY64E8d6mWCOGPXe4HNciATivZW,SpATywNh6bZuzm8s1ceuBUnMUAeoAHHw,30,86,32,20,11,10,23,1,183,26.142857142857142,5,0.0,39,32,20,11,47,10,0,23,1,102,81,0
507,6722,r5hJNp3FkX6JOBVI5bSeTBPneDl7PaKl,A3fsA9Zfv1X2fVEQhTw51lKENdNrEqT3,12,15,1,0,1,4,33,3,57,8.142857142857142,5,0.0,0,1,0,1,15,4,0,33,3,2,55,1
508,6723,e12uQn96OlYfknMdqSXCXdImglIj4IRR,A3fsA9Zfv1X2fVEQhTw51lKENdNrEqT3,43,156,89,0,21,379,150,11,806,115.14285714285714,18,0.0,20,89,0,21,136,379,0,150,11,130,676,0
509,6724,2VLDXf2vRwSQsnPUMIG8jcgCB93IxRHm,SpATywNh6bZuzm8s1ceuBUnMUAeoAHHw,2,0,0,0,0,0,4,0,4,0.5714285714285714,1,0.0,0,0,0,0,0,0,0,4,0,0,4,1
510,6725,2LSIOP9EwUlEUMR84kNdXwxCTBof59AV,SpATywNh6bZuzm8s1ceuBUnMUAeoAHHw,27,28,15,20,8,1,17,1,90,12.857142857142858,7,0.0,2,15,16,8,26,1,4,17,1,41,49,0
511,6734,XxYK4zbyqtm9UELp1oR6gZVKRAER78zL,A3fsA9Zfv1X2fVEQhTw51lKENdNrEqT3,36,49,30,50,16,39,37,2,223,31.857142857142858,7,0.0,4,30,39,16,45,39,11,37,2,89,134,1
512,6739,D5mwgoAPtfwdsFrdNADBqEJQSy8E0CUi,SpATywNh6bZuzm8s1ceuBUnMUAeoAHHw,30,65,41,16,11,12,32,2,179,25.571428571428573,9,0.0,10,41,16,11,55,12,0,32,2,78,101,0
513,6740,YkHlvsvfON124uz3tNHCqQavCTgfzIIn,SpATywNh6bZuzm8s1ceuBUnMUAeoAHHw,20,22,8,13,4,6,15,3,71,10.142857142857142,2,0.0,5,8,11,4,17,6,2,15,3,28,43,1
514,6741,uOAgQLQslSL4cABC9ZqhaeK1XrisqlGh,SpATywNh6bZuzm8s1ceuBUnMUAeoAHHw,29,33,14,20,9,0,12,0,88,12.571428571428571,5,0.0,13,14,17,9,20,0,3,12,0,53,35,0
515,6761,DTS3O3ZujmzMefQXzAvfnTTqItcbsW8A,SpATywNh6bZuzm8s1ceuBUnMUAeoAHHw,25,58,5,28,0,59,17,3,170,24.285714285714285,6,0.0,13,5,24,0,45,59,4,17,3,42,128,0
516,6762,MFUbiMqXEmfaBzK7hirtX5aBXDvqfQ39,bWdj2GDclj5ofokWjzoa5jAwMkxCykd6,6,4,3,0,3,0,1,0,11,1.5714285714285714,1,0.0,0,3,0,3,4,0,0,1,0,6,5,1
517,6776,r5hJNp3FkX6JOBVI5bSeTBPneDl7PaKl,bWdj2GDclj5ofokWjzoa5jAwMkxCykd6,1,0,0,0,0,0,1,0,1,0.14285714285714285,1,0.0,0,0,0,0,0,0,0,1,0,0,1,1
518,6778,lVgq3gYt1tDiZq5EPAUcQ3qHGrMei1Rm,SpATywNh6bZuzm8s1ceuBUnMUAeoAHHw,32,48,31,36,12,27,40,14,208,29.714285714285715,5,0.0,10,31,30,12,38,27,6,40,14,83,125,0
519,6781,eWIsTbhL2p3ztTyrIxD7wf9RK1qPkZuf,SpATywNh6bZuzm8s1ceuBUnMUAeoAHHw,19,28,19,6,0,21,12,2,88,12.571428571428571,6,0.0,0,19,6,0,28,21,0,12,2,25,63,0
520,6783,hjSv3nB1dzB315OJ0MdIWlJoWmd5FDgm,bWdj2GDclj5ofokWjzoa5jAwMkxCykd6,9,21,6,60,5,10,11,0,113,16.142857142857142,2,0.0,11,6,58,5,10,10,2,11,0,80,33,1
521,6785,ptoBkN66Bt2QtZB1aEXx1ZVYWGKSe4nx,SpATywNh6bZuzm8s1ceuBUnMUAeoAHHw,31,58,22,26,8,21,27,0,162,23.142857142857142,4,0.0,14,22,24,8,44,21,2,27,0,68,94,0
522,6790,QZbPGbTnAqz8GS6cm25XcpeiETovvLN6,A3fsA9Zfv1X2fVEQhTw51lKENdNrEqT3,1,0,0,0,0,0,1,0,1,0.14285714285714285,1,0.0,0,0,0,0,0,0,0,1,0,0,1,1
523,6794,Yh46fozwerObqlP4OOrKTS69VvjT8dK1,A3fsA9Zfv1X2fVEQhTw51lKENdNrEqT3,40,14,10,90,8,0,8,0,130,18.571428571428573,5,0.0,2,10,86,8,12,0,4,8,0,106,24,1
524,6823,DeZ9eduD0lM3aHUAAOCnUrOhgp8jUmje,SpATywNh6bZuzm8s1ceuBUnMUAeoAHHw,11,25,2,4,0,0,14,0,45,6.428571428571429,6,0.0,8,2,3,0,17,0,1,14,0,13,32,0
525,6825,QwrR0O4UOobB3AXjFyYOVMeWzFnayzmx,SpATywNh6bZuzm8s1ceuBUnMUAeoAHHw,29,49,19,33,9,72,69,10,261,37.285714285714285,8,0.0,25,19,28,9,24,72,5,69,10,81,180,1
526,6842,sbyXmrcpTszqVBWlyhJ5lsnmstVyQQWU,SpATywNh6bZuzm8s1ceuBUnMUAeoAHHw,1,0,0,0,0,0,2,0,2,0.2857142857142857,1,0.0,0,0,0,0,0,0,0,2,0,0,2,1
527,6862,JtMmp5BCDQnYE7CMI3NvnX4aRCZsQW9K,A3fsA9Zfv1X2fVEQhTw51lKENdNrEqT3,35,180,92,0,28,279,196,4,779,111.28571428571429,16,0.0,15,92,0,28,165,279,0,196,4,135,644,0
528,6866,ysSrXViwdbNw9df0HT1ETP8r4aB84YLw,SpATywNh6bZuzm8s1ceuBUnMUAeoAHHw,6,4,1,0,1,0,1,0,7,1.0,1,0.0,0,1,0,1,4,0,0,1,0,2,5,1
529,6878,7fC3V6ivG07wUIMOmiYFzSlyjWvbYnYf,SpATywNh6bZuzm8s1ceuBUnMUAeoAHHw,17,19,0,28,0,11,12,0,70,10.0,7,0.0,5,0,26,0,14,11,2,12,0,31,39,0
530,6895,z69L6knExrBf5gtr9B70Dgt3D9Xtp8CH,A3fsA9Zfv1X2fVEQhTw51lKENdNrEqT3,46,38,25,146,16,4,14,0,243,34.714285714285715,2,0.0,7,25,126,16,31,4,20,14,0,174,69,1
531,6896,WVOs4Pi3ll5FpomkXlRuIpcugHN3f0rV,SpATywNh6bZuzm8s1ceuBUnMUAeoAHHw,30,69,24,20,13,31,23,1,181,25.857142857142858,8,0.0,31,24,20,13,38,31,0,23,1,88,93,0
532,6907,CjvViMn5KClGeXFftICAvm8SWkvn3LHW,A3fsA9Zfv1X2fVEQhTw51lKENdNrEqT3,64,25,18,118,12,33,13,3,222,31.714285714285715,3,0.0,3,18,108,12,22,33,10,13,3,141,81,1
533,6915,V29AZJRcvBxCayax5I99yuRivRNPAZjj,SpATywNh6bZuzm8s1ceuBUnMUAeoAHHw,9,5,3,0,2,1,6,1,18,2.5714285714285716,2,0.0,0,3,0,2,5,1,0,6,1,5,13,0
534,6920,V29AZJRcvBxCayax5I99yuRivRNPAZjj,A3fsA9Zfv1X2fVEQhTw51lKENdNrEqT3,10,10,6,0,2,13,15,1,47,6.714285714285714,3,0.0,0,6,0,2,10,13,0,15,1,8,39,0
535,6923,FXwY1YS9Ue01cJBRQTifvzVPDx1ARw9E,SpATywNh6bZuzm8s1ceuBUnMUAeoAHHw,6,6,0,0,0,0,3,0,9,1.2857142857142858,2,0.0,0,0,0,0,6,0,0,3,0,0,9,1
536,6934,nsZMAREUaN1W79W768VHLU7EdYuf3Qrp,G8EPVSXsOYB5YQWZGiz1aVq5Pgr2GrQu,72,136,15,147,24,42,43,2,409,58.42857142857143,13,0.0,32,15,106,24,104,42,41,43,2,177,232,0
537,6935,JR1R4x5j4WkP10KgaKlpdN5JIGsgsmdk,SpATywNh6bZuzm8s1ceuBUnMUAeoAHHw,16,16,8,10,5,0,5,0,44,6.285714285714286,3,0.0,4,8,9,5,12,0,1,5,0,26,18,1
538,6944,cG2zraudtV44kPzel5abcAzgwVOUaAs4,A3fsA9Zfv1X2fVEQhTw51lKENdNrEqT3,7,8,0,6,0,0,4,0,18,2.5714285714285716,2,0.0,1,0,5,0,7,0,1,4,0,6,12,1
539,6972,ySy2zYThCkVZr5MjEXuKxq60wfOynxkJ,RXDvfPUBYFlVdlueBFbLW0mhhAyGEqpt,58,118,1,142,6,26,25,0,318,45.42857142857143,5,0.0,21,1,136,6,97,26,6,25,0,164,154,0
540,6975,ztNAIyTwcTmZ7oVMH6qBDo3dC1RimDND,SpATywNh6bZuzm8s1ceuBUnMUAeoAHHw,11,8,5,0,4,1,3,0,21,3.0,1,0.0,2,5,0,4,6,1,0,3,0,11,10,0
541,6977,EO1ssFp8oIj0TSE3bDdD8GeuhxRs5RVg,SpATywNh6bZuzm8s1ceuBUnMUAeoAHHw,28,111,14,42,9,32,66,3,277,39.57142857142857,10,0.0,27,14,37,9,84,32,5,66,3,87,190,0
542,6982,R0LbBsHoep5Au5A4mW7do32jHSfgQD8E,SpATywNh6bZuzm8s1ceuBUnMUAeoAHHw,29,107,36,34,8,82,40,3,310,44.285714285714285,8,0.0,53,36,27,8,54,82,7,40,3,124,186,1
543,6986,7fC3V6ivG07wUIMOmiYFzSlyjWvbYnYf,bWdj2GDclj5ofokWjzoa5jAwMkxCykd6,43,54,1,240,0,4,20,0,319,45.57142857142857,9,0.0,9,1,205,0,45,4,35,20,0,215,104,0
544,6992,YvR8b2YAoaLYLpo6WJ6bDiEtPLllysRd,RXDvfPUBYFlVdlueBFbLW0mhhAyGEqpt,21,23,16,26,5,0,8,0,78,11.142857142857142,1,0.0,3,16,23,5,20,0,3,8,0,47,31,0
545,6996,Ah63NhKhS4EP98tjvGlVfvoLlBn6V6BJ,A3fsA9Zfv1X2fVEQhTw51lKENdNrEqT3,13,7,4,0,2,1,15,1,30,4.285714285714286,3,0.0,0,4,0,2,7,1,0,15,1,6,24,1
546,7009,oBSB2zh7bYN4yELh7x5ItqnxR463BvKC,bWdj2GDclj5ofokWjzoa5jAwMkxCykd6,49,325,103,164,79,3,47,0,721,103.0,16,0.0,83,103,145,79,242,3,19,47,0,410,311,0
547,7013,FTzllWD6ZzVNVacMJQ1FqQQ50E09onOa,bWdj2GDclj5ofokWjzoa5jAwMkxCykd6,9,9,4,0,2,4,8,1,28,4.0,1,0.0,0,4,0,2,9,4,0,8,1,6,22,1
548,7025,EFMEoi5W4mceo8rjft5LKrYvvT3E2eat,bWdj2GDclj5ofokWjzoa5jAwMkxCykd6,11,18,6,10,3,70,6,5,118,16.857142857142858,4,0.0,3,6,9,3,15,70,1,6,5,21,97,1
549,7030,AntKijOf83pltCnII9LLX8PQYe0F20yO,G8EPVSXsOYB5YQWZGiz1aVq5Pgr2GrQu,13,11,6,0,3,0,9,0,29,4.142857142857143,3,0.0,0,6,0,3,11,0,0,9,0,9,20,0
550,7033,hplRuUXyLFhHcMqMJcb12YjqquTYp3Qw,A3fsA9Zfv1X2fVEQhTw51lKENdNrEqT3,43,38,18,80,11,0,5,0,152,21.714285714285715,4,0.0,5,18,64,11,33,0,16,5,0,98,54,0
551,7037,1pusTPLSLF5m0UuZqZkNpGlAq8VrQ1KA,SpATywNh6bZuzm8s1ceuBUnMUAeoAHHw,31,29,17,21,8,6,10,0,91,13.0,4,0.0,7,17,20,8,22,6,1,10,0,52,39,0
552,7045,Qo4EYwRduG0qocv3scjgK3zQnLtIvid1,SpATywNh6bZuzm8s1ceuBUnMUAeoAHHw,19,120,27,0,10,4,49,7,217,31.0,11,0.0,0,27,0,10,120,4,0,49,7,37,180,0
553,7060,dGqImSq9UHavQbhAMWmMoDizcuOefX1Y,SpATywNh6bZuzm8s1ceuBUnMUAeoAHHw,26,55,2,34,2,27,17,3,140,20.0,5,0.0,22,2,28,2,33,27,6,17,3,54,86,0
554,7080,KqUCRL8ws5CG5PQvlspSHJpgFexIO4Jl,SpATywNh6bZuzm8s1ceuBUnMUAeoAHHw,23,83,3,38,2,0,4,0,130,18.571428571428573,4,0.0,32,3,32,2,51,0,6,4,0,69,61,0
555,7083,k85NFhuORfuDcrrXLAFWOhl0dHDWmC1t,bWdj2GDclj5ofokWjzoa5jAwMkxCykd6,12,15,9,2,3,0,7,0,36,5.142857142857143,4,0.0,2,9,2,3,13,0,0,7,0,16,20,1
556,7091,zBYq3S89hCrsMeRBWwKxH3wWGwuZLtQd,SpATywNh6bZuzm8s1ceuBUnMUAeoAHHw,13,11,1,22,0,0,1,0,35,5.0,1,0.0,5,1,22,0,6,0,0,1,0,28,7,1
557,7093,cz3HVUxVHDVORvVKi9yREbYasmzZlaFd,G8EPVSXsOYB5YQWZGiz1aVq5Pgr2GrQu,25,37,6,10,5,0,15,0,73,10.428571428571429,4,0.0,2,6,10,5,35,0,0,15,0,23,50,0
558,7117,RHl3DsvAX7TisJ7qBptmgrrtDAQvH7mr,A3fsA9Zfv1X2fVEQhTw51lKENdNrEqT3,24,53,28,6,10,5,22,0,124,17.714285714285715,8,0.0,5,28,5,10,48,5,1,22,0,48,76,0
559,7124,DRhlp1eJHQqsxjCL0bRD6kkHN20HbJ4w,SpATywNh6bZuzm8s1ceuBUnMUAeoAHHw,27,59,29,20,15,0,13,0,136,19.428571428571427,10,0.0,15,29,19,15,44,0,1,13,0,78,58,0
560,7128,RvFRgUGsoT6kl0oxj3AEZMdMRkNHUTgp,SpATywNh6bZuzm8s1ceuBUnMUAeoAHHw,15,23,6,38,0,1,11,0,79,11.285714285714286,3,0.0,15,6,31,0,8,1,7,11,0,52,27,1
561,7129,mgwquciozkhcF0WnEEHOJYDb1rZHthNN,A3fsA9Zfv1X2fVEQhTw51lKENdNrEqT3,5,4,0,0,0,0,3,0,7,1.0,1,0.0,0,0,0,0,4,0,0,3,0,0,7,1
562,7137,rT1OrFQC18rdvYkTGYqwRgC7eDvihHsc,bWdj2GDclj5ofokWjzoa5jAwMkxCykd6,20,90,48,0,7,461,117,7,730,104.28571428571429,21,0.0,4,48,0,7,86,461,0,117,7,59,671,0
563,7142,YE22fRNdaFtk3nhWfjSOMHWERX5O7Ymi,A3fsA9Zfv1X2fVEQhTw51lKENdNrEqT3,86,90,9,144,5,0,19,0,267,38.142857142857146,7,0.0,5,9,134,5,85,0,10,19,0,153,114,0
564,7158,Ky3k8JBiR8OkS6sd2foNFIGjx3wXRsFp,G8EPVSXsOYB5YQWZGiz1aVq5Pgr2GrQu,32,55,2,8,2,20,19,3,109,15.571428571428571,2,0.0,13,2,4,2,42,20,4,19,3,21,88,0
565,7171,QzVwezWUOBpl33EMiprsTWQNwkGzpYUZ,A3fsA9Zfv1X2fVEQhTw51lKENdNrEqT3,7,4,2,0,2,0,4,0,12,1.7142857142857142,2,0.0,1,2,0,2,3,0,0,4,0,5,7,0
566,7179,3HOnjRDe3XaKpyhDvtGYWIvTQ5R0B6U5,RXDvfPUBYFlVdlueBFbLW0mhhAyGEqpt,15,12,8,0,4,1,12,0,37,5.285714285714286,3,0.0,1,8,0,4,11,1,0,12,0,13,24,1
567,7181,29zlPnPFaHRpKhWmQq4cQrKoDn0GEyMA,SpATywNh6bZuzm8s1ceuBUnMUAeoAHHw,18,73,32,15,8,8,40,1,177,25.285714285714285,10,0.0,13,32,13,8,60,8,2,40,1,66,111,1
568,7197,yiOlNWWu3p4vJ73FHFCmMYCNgzMDTrne,A3fsA9Zfv1X2fVEQhTw51lKENdNrEqT3,70,24,18,136,13,0,15,1,207,29.571428571428573,4,0.0,2,18,119,13,22,0,17,15,1,152,55,1
569,7219,t0cRwLqt3PES7T3WXJUMfvNkz6DOAsQy,G8EPVSXsOYB5YQWZGiz1aVq5Pgr2GrQu,33,67,21,74,13,31,11,1,218,31.142857142857142,5,0.0,28,21,50,13,39,31,24,11,1,112,106,0
570,7222,7abxlkdMiNWAIk78NzVnHWo2fZI6eMvl,SpATywNh6bZuzm8s1ceuBUnMUAeoAHHw,23,15,11,0,7,35,13,1,82,11.714285714285714,3,0.0,2,11,0,7,13,35,0,13,1,20,62,1
571,7229,iZlqOil8HuQgM9wIdCp3EDJlfdWSJRmO,SpATywNh6bZuzm8s1ceuBUnMUAeoAHHw,24,39,1,33,1,30,9,5,118,16.857142857142858,5,0.0,8,1,29,1,31,30,4,9,5,39,79,0
572,7232,Kv9yM6Ye606xOusGmqGDWX6SW9fdHP2Q,A3fsA9Zfv1X2fVEQhTw51lKENdNrEqT3,1,0,0,0,0,0,1,0,1,0.14285714285714285,1,0.0,0,0,0,0,0,0,0,1,0,0,1,1
573,7240,HJ4qDtw6u2JHJE7qmEDgWJOzWUYAv4mG,A3fsA9Zfv1X2fVEQhTw51lKENdNrEqT3,87,64,49,202,27,23,25,0,390,55.714285714285715,10,0.0,2,49,178,27,62,23,24,25,0,256,134,0
574,7256,D1NRZnTG0gvNQpfa2XPRkdGhYZVx3Bz8,RXDvfPUBYFlVdlueBFbLW0mhhAyGEqpt,70,90,64,155,34,10,17,8,378,54.0,9,0.0,16,64,136,34,74,10,19,17,8,250,128,0
575,7262,WIuYkRjZD9FutPqnDeyA4qgpxVJpTEdL,SpATywNh6bZuzm8s1ceuBUnMUAeoAHHw,1,0,0,0,0,0,1,0,1,0.14285714285714285,1,0.0,0,0,0,0,0,0,0,1,0,0,1,0
576,7274,YZ1MgmwJiUridNKhbKx061bAjGk955T1,G8EPVSXsOYB5YQWZGiz1aVq5Pgr2GrQu,52,129,6,108,3,16,16,4,282,40.285714285714285,9,0.0,5,6,91,3,124,16,17,16,4,105,177,0
577,7291,o7nB1nybhMcFgLy31X3R6RDOK94b1Iaa,SpATywNh6bZuzm8s1ceuBUnMUAeoAHHw,15,25,2,8,2,0,4,0,41,5.857142857142857,2,0.0,3,2,7,2,22,0,1,4,0,14,27,0
578,7296,ObMYjZj16p1bGCa8nmaBIv8cDUPUXE5o,SpATywNh6bZuzm8s1ceuBUnMUAeoAHHw,25,54,1,28,1,14,23,3,124,17.714285714285715,7,0.0,15,1,23,1,39,14,5,23,3,40,84,0
579,7297,bAkMyE6uCR0gc04pERZmDJrGVqJ4Z2Yi,G8EPVSXsOYB5YQWZGiz1aVq5Pgr2GrQu,74,99,42,98,31,12,14,0,296,42.285714285714285,10,0.0,37,42,65,31,62,12,33,14,0,175,121,0
580,7298,VSEOcWZYpZiKC2PUmidzj4VqbBnc3GAo,bWdj2GDclj5ofokWjzoa5jAwMkxCykd6,49,74,38,129,18,93,126,5,483,69.0,16,0.0,21,38,115,18,53,93,14,126,5,192,291,0
581,7301,Yby0It9Tj4ASosIcvg72qeavqJKBNZLT,bWdj2GDclj5ofokWjzoa5jAwMkxCykd6,1,0,0,0,0,0,1,0,1,0.14285714285714285,1,0.0,0,0,0,0,0,0,0,1,0,0,1,1
582,7303,Yby0It9Tj4ASosIcvg72qeavqJKBNZLT,A3fsA9Zfv1X2fVEQhTw51lKENdNrEqT3,2,0,0,0,0,0,2,0,2,0.2857142857142857,1,0.0,0,0,0,0,0,0,0,2,0,0,2,1
583,7318,7glymc4Wt1TTt6LrLi78VQNF5GV1r6UY,bWdj2GDclj5ofokWjzoa5jAwMkxCykd6,8,4,2,8,1,0,2,0,17,2.4285714285714284,1,0.0,1,2,8,1,3,0,0,2,0,12,5,1
584,7325,3jh7S7idreXg4tLgwxk2JirIFS2kxatr,SpATywNh6bZuzm8s1ceuBUnMUAeoAHHw,24,54,27,22,15,7,22,1,148,21.142857142857142,7,0.0,7,27,18,15,47,7,4,22,1,67,81,0
585,7328,83p9ejSELsW1j5wNlAyUXF2YWFL8Z8tc,bWdj2GDclj5ofokWjzoa5jAwMkxCykd6,46,63,23,190,15,9,17,1,318,45.42857142857143,8,0.0,16,23,174,15,47,9,16,17,1,228,90,0
586,7344,B9KqNNxXBxHFUsJnQKQysblL3f8zF7sg,A3fsA9Zfv1X2fVEQhTw51lKENdNrEqT3,46,100,6,69,0,7,25,0,207,29.571428571428573,13,0.0,7,6,55,0,93,7,14,25,0,68,139,0
587,7350,ve9ySeJmFQKT879uz3hqg8kvVYA6FA8D,SpATywNh6bZuzm8s1ceuBUnMUAeoAHHw,1,0,0,0,0,0,2,0,2,0.2857142857142857,1,0.0,0,0,0,0,0,0,0,2,0,0,2,1
588,7356,uXSmZuPz2xNXPk2qFBcPykAtedr98vP4,RXDvfPUBYFlVdlueBFbLW0mhhAyGEqpt,46,44,25,80,17,3,5,0,174,24.857142857142858,4,0.0,10,25,75,17,34,3,5,5,0,127,47,0
589,7372,32uJBAomTJQIXKZnCX4K7PYoVfESGbct,A3fsA9Zfv1X2fVEQhTw51lKENdNrEqT3,72,50,7,182,4,0,7,0,250,35.714285714285715,11,0.0,3,7,159,4,47,0,23,7,0,173,77,1
590,7385,ErlOpSNxC1ZbmJguJSp3ZjxFq4nCmwgx,G8EPVSXsOYB5YQWZGiz1aVq5Pgr2GrQu,19,42,10,2,4,0,23,2,83,11.857142857142858,5,0.0,7,10,1,4,35,0,1,23,2,22,61,0
591,7391,7L5unYIhab1TebFiFv55Vd3f3JppE4WH,A3fsA9Zfv1X2fVEQhTw51lKENdNrEqT3,10,12,9,0,6,0,4,0,31,4.428571428571429,2,0.0,0,9,0,6,12,0,0,4,0,15,16,0
592,7422,WKdxdVcCk0v6q8w6qEVoDAEpoNH9nq1b,A3fsA9Zfv1X2fVEQhTw51lKENdNrEqT3,43,39,19,66,10,4,14,0,152,21.714285714285715,4,0.0,3,19,53,10,36,4,13,14,0,85,67,1
593,7428,dTkPxaFmNowU6Qk7fnasqvgAevZOuRY9,RXDvfPUBYFlVdlueBFbLW0mhhAyGEqpt,43,17,10,78,7,9,4,0,125,17.857142857142858,2,0.0,7,10,77,7,10,9,1,4,0,101,24,1
594,7439,yK7fQWYLG0RsBbgokh3BoTMU9oScdsOd,bWdj2GDclj5ofokWjzoa5jAwMkxCykd6,4,3,2,0,2,0,1,0,8,1.1428571428571428,1,0.0,0,2,0,2,3,0,0,1,0,4,4,1
595,7440,5TRqp5WlxU778HZGbnj0S6xLTaRfUJxG,SpATywNh6bZuzm8s1ceuBUnMUAeoAHHw,25,68,4,27,4,21,27,2,153,21.857142857142858,10,0.0,17,4,23,4,51,21,4,27,2,48,105,0
596,7463,zdqliI4eCBGH6nGv4KKIRZFL1YFXBytK,SpATywNh6bZuzm8s1ceuBUnMUAeoAHHw,31,83,37,36,11,158,60,2,387,55.285714285714285,10,0.0,26,37,31,11,57,158,5,60,2,105,282,0
597,7464,lFMYqumkG36iLJm9YwVpbzadzxUvswUa,bWdj2GDclj5ofokWjzoa5jAwMkxCykd6,1,0,0,0,0,0,3,0,3,0.42857142857142855,2,0.0,0,0,0,0,0,0,0,3,0,0,3,1
598,7466,lFMYqumkG36iLJm9YwVpbzadzxUvswUa,SpATywNh6bZuzm8s1ceuBUnMUAeoAHHw,14,25,15,11,0,5,10,0,66,9.428571428571429,5,0.0,6,15,9,0,19,5,2,10,0,30,36,0
599,7475,vRHTfFGO3STxLwMRkIw1geBTPnARvg2o,SpATywNh6bZuzm8s1ceuBUnMUAeoAHHw,15,21,13,6,6,8,14,0,68,9.714285714285714,4,0.0,1,13,5,6,20,8,1,14,0,25,43,0
600,7488,uUSTKM8g1hIskJbYHh1UiIQ6epHTSTNR,A3fsA9Zfv1X2fVEQhTw51lKENdNrEqT3,33,34,17,80,3,0,12,0,146,20.857142857142858,7,0.0,5,17,66,3,29,0,14,12,0,91,55,1
601,7491,uUSTKM8g1hIskJbYHh1UiIQ6epHTSTNR,RXDvfPUBYFlVdlueBFbLW0mhhAyGEqpt,65,81,47,112,30,3,19,1,293,41.857142857142854,7,0.0,18,47,105,30,63,3,7,19,1,200,93,0
602,7496,6qVy3H4VOdeTnu4v49EIcz51mS5B3gWH,SpATywNh6bZuzm8s1ceuBUnMUAeoAHHw,24,66,37,19,0,143,58,8,331,47.285714285714285,10,0.0,12,37,16,0,54,143,3,58,8,65,266,0
603,7503,0PrF4PViZdaRQhbt6FYXwLbcetJ8RnwC,A3fsA9Zfv1X2fVEQhTw51lKENdNrEqT3,79,55,2,272,1,0,21,0,351,50.142857142857146,7,0.0,7,2,232,1,48,0,40,21,0,242,109,0
604,7504,NH2DAS5rCP8HjIcwHAZxDBAjUjjdHeyM,SpATywNh6bZuzm8s1ceuBUnMUAeoAHHw,29,24,19,18,9,29,22,0,121,17.285714285714285,4,0.0,5,19,17,9,19,29,1,22,0,50,71,0
605,7521,a3StgABPgimfVHzW1FR4usG9kIA0tZV5,bWdj2GDclj5ofokWjzoa5jAwMkxCykd6,16,86,3,26,7,0,16,0,138,19.714285714285715,9,0.0,19,3,24,7,67,0,2,16,0,53,85,1
606,7525,xNkIHhqS8GZXIqyoWwwS3ZeYfSmUsNJo,A3fsA9Zfv1X2fVEQhTw51lKENdNrEqT3,49,45,19,80,12,8,12,1,177,25.285714285714285,5,0.0,1,19,62,12,44,8,18,12,1,94,83,0
607,7535,8a9f5zlAzg00IZpxpFpd0Yys1Z1UDN82,RXDvfPUBYFlVdlueBFbLW0mhhAyGEqpt,42,90,58,31,27,2,18,0,226,32.285714285714285,7,0.0,2,58,27,27,88,2,4,18,0,114,112,1
608,7539,p6HxMfZynarvwZflE5DcOWxdvhYhrFbF,G8EPVSXsOYB5YQWZGiz1aVq5Pgr2GrQu,6,2,1,0,1,0,3,0,7,1.0,1,0.0,0,1,0,1,2,0,0,3,0,2,5,1
609,7540,oRVMh8MBvWswMrCZYZVSC4ANhRghr3SC,RXDvfPUBYFlVdlueBFbLW0mhhAyGEqpt,25,41,20,13,7,5,14,2,102,14.571428571428571,6,0.0,3,20,13,7,38,5,0,14,2,43,59,1
610,7550,EGswqlieknT0DkOMjaOEPr1kJjoddSSw,G8EPVSXsOYB5YQWZGiz1aVq5Pgr2GrQu,32,74,8,42,8,85,31,8,256,36.57142857142857,10,0.0,8,8,33,8,66,85,9,31,8,57,199,0
611,7552,ljmWZCzWPqv1RXsn1q2wpsQtrnA1zct2,SpATywNh6bZuzm8s1ceuBUnMUAeoAHHw,25,45,17,24,6,7,11,0,110,15.714285714285714,5,0.0,10,17,20,6,35,7,4,11,0,53,57,0
612,7562,606SeIKBIFg9vt3BinDbRysHBP3GLEGI,bWdj2GDclj5ofokWjzoa5jAwMkxCykd6,11,10,2,0,3,7,11,2,35,5.0,1,0.0,2,2,0,3,8,7,0,11,2,7,28,1
613,7571,hPtqAQmVA3C7MVQi98nPJLfZYLyZ86Qe,SpATywNh6bZuzm8s1ceuBUnMUAeoAHHw,4,2,1,0,1,0,1,0,5,0.7142857142857143,2,0.0,0,1,0,1,2,0,0,1,0,2,3,1
614,7579,7KQcIrOp3KoypOTvziMED7rHtDH1CXtE,SpATywNh6bZuzm8s1ceuBUnMUAeoAHHw,14,11,0,18,0,11,9,0,49,7.0,2,0.0,3,0,15,0,8,11,3,9,0,18,31,1
615,7581,QoKkWqCz9JSPf2G2l4XrJl2BfFSq9X9B,RXDvfPUBYFlVdlueBFbLW0mhhAyGEqpt,47,73,3,135,4,45,25,9,294,42.0,6,0.0,19,3,124,4,54,45,11,25,9,150,144,0
616,7589,ljmWZCzWPqv1RXsn1q2wpsQtrnA1zct2,A3fsA9Zfv1X2fVEQhTw51lKENdNrEqT3,42,16,13,68,9,1,4,0,111,15.857142857142858,2,0.0,1,13,56,9,15,1,12,4,0,79,32,1
617,7628,hRBUrY0Ipi1X9aVKI1Gcp4xJWynJPCa6,SpATywNh6bZuzm8s1ceuBUnMUAeoAHHw,28,34,19,26,8,0,4,0,91,13.0,6,0.0,8,19,25,8,26,0,1,4,0,60,31,0
618,7632,YpYAswD6xdR70kiD53LA7ygDBkdDLMQF,SpATywNh6bZuzm8s1ceuBUnMUAeoAHHw,11,13,6,2,3,4,2,0,30,4.285714285714286,2,0.0,1,6,2,3,12,4,0,2,0,12,18,1
619,7633,11ljuSLdnPtPyfemLE7b9qn6qXcmssv1,SpATywNh6bZuzm8s1ceuBUnMUAeoAHHw,18,46,17,42,2,9,17,0,133,19.0,7,0.0,19,17,33,2,27,9,9,17,0,71,62,1
620,7634,I4noBaz6GyRD2PZe6j4LCRYlVDmmxoLh,SpATywNh6bZuzm8s1ceuBUnMUAeoAHHw,12,17,2,1,0,1,8,1,30,4.285714285714286,1,0.0,2,2,1,0,15,1,0,8,1,5,25,1
621,7642,WZSiXPjEuCIRtzYUNEK3DyAuPVNMLJ4a,SpATywNh6bZuzm8s1ceuBUnMUAeoAHHw,15,15,7,29,4,8,4,0,67,9.571428571428571,1,0.0,6,7,24,4,9,8,5,4,0,41,26,1
622,7647,ylrXVJAuag501sD5FTvKV7DusuU60h41,SpATywNh6bZuzm8s1ceuBUnMUAeoAHHw,5,2,0,0,1,0,3,0,6,0.8571428571428571,1,0.0,0,0,0,1,2,0,0,3,0,1,5,1
623,7652,PQ7ibn4CoD7R92qj9CnBXvU4YpUOqVHi,SpATywNh6bZuzm8s1ceuBUnMUAeoAHHw,27,54,32,16,14,4,30,4,154,22.0,6,0.0,19,32,16,14,35,4,0,30,4,81,73,0
624,7653,v9Jp2iBPSFTVxP8FrUe1odwfz8Hd1wS3,RXDvfPUBYFlVdlueBFbLW0mhhAyGEqpt,72,60,40,92,21,11,21,2,247,35.285714285714285,6,0.0,13,40,87,21,47,11,5,21,2,161,86,0
625,7675,LiEDHNjd9tDT7NPtKiOjuDJtkaP8cSxY,bWdj2GDclj5ofokWjzoa5jAwMkxCykd6,46,109,63,88,19,76,33,5,393,56.142857142857146,8,0.0,14,63,73,19,95,76,15,33,5,169,224,0
626,7679,GjmRL85Fx59ASzosh0kQzycWTmRCzek4,SpATywNh6bZuzm8s1ceuBUnMUAeoAHHw,14,31,1,17,1,1,5,0,56,8.0,3,0.0,19,1,16,1,12,1,1,5,0,37,19,1
627,7702,ulNRkVxxtx7SLWYKYYIDWhAGHHFqHWWG,SpATywNh6bZuzm8s1ceuBUnMUAeoAHHw,28,41,19,24,7,3,23,1,118,16.857142857142858,8,0.0,11,19,23,7,30,3,1,23,1,60,58,0
628,7707,Om7TmUpRVXmKCq1XRkQCdyE9M7r8n9tE,SpATywNh6bZuzm8s1ceuBUnMUAeoAHHw,15,32,5,28,0,4,8,1,78,11.142857142857142,2,0.0,12,5,26,0,20,4,2,8,1,43,35,0
629,7711,U4GXlaQk4qQjr2K7P59OKvXX0vv1Pxee,SpATywNh6bZuzm8s1ceuBUnMUAeoAHHw,16,47,7,21,1,0,22,2,100,14.285714285714286,9,0.0,11,7,18,1,36,0,3,22,2,37,63,0
630,7713,0W4XScVx81tfxJ0Qr09mHB39FqA62JyS,SpATywNh6bZuzm8s1ceuBUnMUAeoAHHw,19,24,4,31,2,2,4,0,67,9.571428571428571,4,0.0,8,4,29,2,16,2,2,4,0,43,24,1
631,7716,yG9o9nU1hVydCMiwULHDO2ptGPwb3jNJ,SpATywNh6bZuzm8s1ceuBUnMUAeoAHHw,22,31,15,12,5,2,6,0,71,10.142857142857142,6,0.0,10,15,12,5,21,2,0,6,0,42,29,1
632,7721,MAlRgKpZXlP3WrMKjRw2YskqEALVtCKw,SpATywNh6bZuzm8s1ceuBUnMUAeoAHHw,21,41,1,17,0,5,15,0,79,11.285714285714286,8,0.0,9,1,17,0,32,5,0,15,0,27,52,0
633,7727,h5vEAVTb94xGNGjpn4Ohi5mNcXfM0rMl,RXDvfPUBYFlVdlueBFbLW0mhhAyGEqpt,21,46,4,14,5,1,13,5,88,12.571428571428571,3,0.0,11,4,14,5,35,1,0,13,5,34,54,1
634,7742,zu1WAijSG0F2wy5x45xxD1w2SrPWGtuK,RXDvfPUBYFlVdlueBFbLW0mhhAyGEqpt,59,76,23,72,16,33,62,9,291,41.57142857142857,5,0.0,17,23,65,16,59,33,7,62,9,121,170,0
635,7748,cXt4yzdeLQWJ2a8N3WCCOFlxmV6sHALc,bWdj2GDclj5ofokWjzoa5jAwMkxCykd6,28,34,14,182,11,0,7,0,248,35.42857142857143,3,0.0,16,14,173,11,18,0,9,7,0,214,34,1
636,7752,nIJT2WzxvFmAAdv0mMRGLvQiPT819gU3,SpATywNh6bZuzm8s1ceuBUnMUAeoAHHw,29,125,24,36,10,132,76,1,404,57.714285714285715,11,0.0,24,24,28,10,101,132,8,76,1,86,318,0
637,7753,kzQ1HmHoPnIhyiOH3J5g0gxiDZh4kW6J,RXDvfPUBYFlVdlueBFbLW0mhhAyGEqpt,69,54,33,129,23,2,31,0,272,38.857142857142854,5,0.0,16,33,116,23,38,2,13,31,0,188,84,1
638,7762,2Sqmg51RWZnvGf1B4BEysn1wJm7yLaQl,G8EPVSXsOYB5YQWZGiz1aVq5Pgr2GrQu,61,112,21,120,5,11,22,0,291,41.57142857142857,6,0.0,30,21,104,5,82,11,16,22,0,160,131,0
639,7769,QV7Z9LfpjzP9d797QCfKxmoOjdo08shd,SpATywNh6bZuzm8s1ceuBUnMUAeoAHHw,30,39,21,15,11,24,11,1,122,17.428571428571427,6,0.0,9,21,15,11,30,24,0,11,1,56,66,0
640,7770,4dVGo2nGpdhjYgYbTYmjlligu2kflHn7,RXDvfPUBYFlVdlueBFbLW0mhhAyGEqpt,50,105,35,77,13,4,20,3,257,36.714285714285715,2,0.0,24,35,73,13,81,4,4,20,3,145,112,1
641,7782,EJ52dc9s4CYydLeBR3nGlXxXka6Fltqj,A3fsA9Zfv1X2fVEQhTw51lKENdNrEqT3,7,5,2,0,2,0,7,0,16,2.2857142857142856,2,0.0,0,2,0,2,5,0,0,7,0,4,12,0
642,7784,Y96AzEZtgYGN39EPdmAzdYPvLhv1Tzsf,SpATywNh6bZuzm8s1ceuBUnMUAeoAHHw,31,31,19,33,10,16,19,1,129,18.428571428571427,4,0.0,8,19,28,10,23,16,5,19,1,65,64,0
643,7787,b87ksD29UBdF2YCxTtUOCsx5OJsZrMS6,SpATywNh6bZuzm8s1ceuBUnMUAeoAHHw,10,19,2,0,0,4,7,0,32,4.571428571428571,3,0.0,2,2,0,0,17,4,0,7,0,4,28,1
644,7808,xG6pQFBC9YTxYi6joCJjOh2c6LkI7Trq,SpATywNh6bZuzm8s1ceuBUnMUAeoAHHw,5,2,1,0,1,0,2,0,6,0.8571428571428571,1,0.0,0,1,0,1,2,0,0,2,0,2,4,1
645,7816,rbxp4ygAJiuJravRmpeSgvTRbWslY8KE,G8EPVSXsOYB5YQWZGiz1aVq5Pgr2GrQu,43,47,18,102,12,2,12,2,195,27.857142857142858,3,0.0,25,18,75,12,22,2,27,12,2,130,65,1
646,7817,KLERBlLR5to2IuMEV6VaweaoU18ID2Ks,SpATywNh6bZuzm8s1ceuBUnMUAeoAHHw,30,51,27,30,15,0,20,0,143,20.428571428571427,4,0.0,13,27,28,15,38,0,2,20,0,83,60,1
647,7818,LMGbvXS3ZBgtTcKCRLMcqBHrfADBxwXe,SpATywNh6bZuzm8s1ceuBUnMUAeoAHHw,30,57,31,16,14,2,28,0,148,21.142857142857142,11,0.0,8,31,14,14,49,2,2,28,0,67,81,0
648,7819,hHscGHEjmeiL8NswOTKn3P6KxplprGQ7,SpATywNh6bZuzm8s1ceuBUnMUAeoAHHw,4,3,2,0,0,0,1,0,6,0.8571428571428571,1,0.0,0,2,0,0,3,0,0,1,0,2,4,1
649,7832,RNgrmqPicYezsE4BsF8Au4WfPdSMWP6C,G8EPVSXsOYB5YQWZGiz1aVq5Pgr2GrQu,12,13,7,0,1,2,13,1,37,5.285714285714286,2,0.0,2,7,0,1,11,2,0,13,1,10,27,1
650,7835,3iSbhZU0XFdJUgUA6Ry01TQ9T4nPzP7c,SpATywNh6bZuzm8s1ceuBUnMUAeoAHHw,11,24,6,0,2,0,10,0,42,6.0,3,0.0,0,6,0,2,24,0,0,10,0,8,34,1
651,7838,S10grfxrn0tXcuL6DSaVTf7wyvXspCvq,SpATywNh6bZuzm8s1ceuBUnMUAeoAHHw,7,15,1,0,0,22,9,0,47,6.714285714285714,2,0.0,2,1,0,0,13,22,0,9,0,3,44,0
652,7839,WYNpj52NyIePFOfUouGRXkQmACPQnP2J,SpATywNh6bZuzm8s1ceuBUnMUAeoAHHw,30,308,150,38,15,1500,246,10,2267,323.85714285714283,16,0.0,38,150,32,15,270,1500,6,246,10,235,2032,0
653,7853,70BrIR23BcsI705EZj4LSyr7fHWI0Xjf,A3fsA9Zfv1X2fVEQhTw51lKENdNrEqT3,25,40,24,0,17,12,10,0,103,14.714285714285714,5,0.0,0,24,0,17,40,12,0,10,0,41,62,0
654,7855,FOHqSST3UlMcK0PZ2G62CXA809f8BW7i,bWdj2GDclj5ofokWjzoa5jAwMkxCykd6,5,2,1,0,1,0,2,0,6,0.8571428571428571,1,0.0,0,1,0,1,2,0,0,2,0,2,4,1
655,7857,Z6YQS36VdHJFF4DkVSTcUgmOIdlOITNE,SpATywNh6bZuzm8s1ceuBUnMUAeoAHHw,28,50,20,36,9,1,7,0,123,17.571428571428573,5,0.0,22,20,30,9,28,1,6,7,0,81,42,0
656,7858,Ak0ru019Ynz1X1qhUbDFCskGZavLrHBc,SpATywNh6bZuzm8s1ceuBUnMUAeoAHHw,30,76,38,33,16,24,15,2,204,29.142857142857142,4,0.0,29,38,31,16,47,24,2,15,2,114,90,0
657,7860,rWA9BhwEXXwDdj5p5FXRqP1JA3HaX1US,SpATywNh6bZuzm8s1ceuBUnMUAeoAHHw,29,59,32,31,18,2,7,0,149,21.285714285714285,4,0.0,17,32,28,18,42,2,3,7,0,95,54,1
658,7863,bDqqR2hng29QNjexgLbMGRH4AJBfyli8,SpATywNh6bZuzm8s1ceuBUnMUAeoAHHw,21,38,25,12,8,5,14,1,103,14.714285714285714,6,0.0,2,25,10,8,36,5,2,14,1,45,58,1
659,7868,ptvDGcVFI5vzF4lBwRLTADNrenNp2tF2,SpATywNh6bZuzm8s1ceuBUnMUAeoAHHw,26,51,16,24,3,7,32,1,134,19.142857142857142,7,0.0,10,16,21,3,41,7,3,32,1,50,84,0
660,7870,sj7wQJWVAxmId67LlkoaFzAmqWKmeC7I,SpATywNh6bZuzm8s1ceuBUnMUAeoAHHw,27,167,9,20,5,122,82,1,406,58.0,11,0.0,38,9,18,5,129,122,2,82,1,70,336,0
661,7882,0zObXmoXHP7rszDYuu8m5842mUKzCfEP,G8EPVSXsOYB5YQWZGiz1aVq5Pgr2GrQu,12,16,1,38,0,0,3,0,58,8.285714285714286,1,0.0,2,1,33,0,14,0,5,3,0,36,22,1
662,7883,JiNN6rHoPfwH1fuAk6q9tmTGqAFVjob4,SpATywNh6bZuzm8s1ceuBUnMUAeoAHHw,16,14,8,12,5,2,6,1,48,6.857142857142857,2,0.0,4,8,10,5,10,2,2,6,1,27,21,0
663,7909,fbuy5iqzFkLuifp42uT7tvssNinDwhQ9,G8EPVSXsOYB5YQWZGiz1aVq5Pgr2GrQu,19,12,5,0,5,0,5,0,27,3.857142857142857,1,0.0,2,5,0,5,10,0,0,5,0,12,15,1
664,7923,pJUI0Hs11rZxgXk3r1clZCyuDCtGsbvH,SpATywNh6bZuzm8s1ceuBUnMUAeoAHHw,31,43,19,31,8,0,11,1,113,16.142857142857142,5,0.0,18,19,29,8,25,0,2,11,1,74,39,1
665,7933,dEPUxcdyZTnKUVP0o2JXv6VWX3ETnwmr,SpATywNh6bZuzm8s1ceuBUnMUAeoAHHw,26,77,39,32,3,18,48,7,224,32.0,5,0.0,34,39,26,3,43,18,6,48,7,102,122,1
666,7937,ywdL3xkp7d2PSjbvnflAvIe7Wp6Q4SRe,SpATywNh6bZuzm8s1ceuBUnMUAeoAHHw,30,84,32,35,10,0,28,1,190,27.142857142857142,12,0.0,22,32,30,10,62,0,5,28,1,94,96,0
667,7942,JNo2rLqKe6aBGDwGzu8tXd13uOC5tEnq,bWdj2GDclj5ofokWjzoa5jAwMkxCykd6,15,25,13,52,0,18,41,2,151,21.571428571428573,5,0.0,8,13,51,0,17,18,1,41,2,72,79,0
668,7949,FnY3or5QaQRvUAAgyu53eYBfcMnduugT,SpATywNh6bZuzm8s1ceuBUnMUAeoAHHw,26,56,10,22,3,11,21,1,124,17.714285714285715,9,0.0,12,10,20,3,44,11,2,21,1,45,79,0
669,7952,CI12SZIYH2QOfgaDvq8F4VKXwDinb334,SpATywNh6bZuzm8s1ceuBUnMUAeoAHHw,32,51,30,25,13,1,9,1,130,18.571428571428573,6,0.0,13,30,22,13,38,1,3,9,1,78,52,0
670,7954,WzyWOzB7f8AVbQvaWeU3O4gxEwZ13sIC,RXDvfPUBYFlVdlueBFbLW0mhhAyGEqpt,50,70,37,113,26,3,13,2,264,37.714285714285715,8,0.0,18,37,107,26,52,3,6,13,2,188,76,0
671,7956,ljmWZCzWPqv1RXsn1q2wpsQtrnA1zct2,G8EPVSXsOYB5YQWZGiz1aVq5Pgr2GrQu,127,123,30,397,15,26,15,0,606,86.57142857142857,5,0.0,55,30,287,15,68,26,110,15,0,387,219,1
672,7962,mtW8rWxW2XwZIB5TM8b8gUVmE4UACp0R,SpATywNh6bZuzm8s1ceuBUnMUAeoAHHw,22,31,18,14,5,0,9,0,77,11.0,9,0.0,6,18,14,5,25,0,0,9,0,43,34,0
673,7964,z8zMi50azvRwAPUNW2f5Gt0F6WOr8PI9,A3fsA9Zfv1X2fVEQhTw51lKENdNrEqT3,13,10,8,0,5,0,3,0,26,3.7142857142857144,3,0.0,0,8,0,5,10,0,0,3,0,13,13,1
674,7967,Wyji6pvgj7unEJ4mD7FWwu0Sma8fUdv4,SpATywNh6bZuzm8s1ceuBUnMUAeoAHHw,28,69,47,15,23,20,28,3,205,29.285714285714285,6,0.0,9,47,15,23,60,20,0,28,3,94,111,0
675,7970,2mdoNlBiXpgUVSmoihAheHl3NISmi738,SpATywNh6bZuzm8s1ceuBUnMUAeoAHHw,3,0,0,0,0,14,2,0,16,2.2857142857142856,1,0.0,0,0,0,0,0,14,0,2,0,0,16,1
676,7973,SUqHrTqjE8jHVpASqCaMjjR6iZ17k2Gq,SpATywNh6bZuzm8s1ceuBUnMUAeoAHHw,29,55,27,36,8,1,29,1,157,22.428571428571427,11,0.0,12,27,31,8,43,1,5,29,1,78,79,0
677,7975,EwJz8sdPLnTPbvCqxQKV7YueKEdP0wYf,SpATywNh6bZuzm8s1ceuBUnMUAeoAHHw,24,34,21,15,11,4,11,0,96,13.714285714285714,6,0.0,6,21,13,11,28,4,2,11,0,51,45,0
678,7999,j55CnsxXtuPHDTIgqOvx7oExU3RRtQ4I,SpATywNh6bZuzm8s1ceuBUnMUAeoAHHw,31,37,18,31,7,11,24,1,129,18.428571428571427,5,0.0,12,18,29,7,25,11,2,24,1,66,63,1
679,8000,YiNeIrEOhZYEzsuuN5nQKcsVr5To2nDU,SpATywNh6bZuzm8s1ceuBUnMUAeoAHHw,28,31,17,30,9,2,19,0,108,15.428571428571429,7,0.0,13,17,27,9,18,2,3,19,0,66,42,0
680,8001,DI3YZyhWTKxhZZnQuVUpGne2QEEoyvnw,SpATywNh6bZuzm8s1ceuBUnMUAeoAHHw,32,54,24,32,13,1,16,18,158,22.571428571428573,4,0.0,24,24,30,13,30,1,2,16,18,91,67,0
681,8016,0wTvjguYOmHTRx6CgVlID5lRmd6At3zN,RXDvfPUBYFlVdlueBFbLW0mhhAyGEqpt,7,3,2,0,2,1,2,0,10,1.4285714285714286,1,0.0,0,2,0,2,3,1,0,2,0,4,6,0
682,8026,KtSnhyXFi6bevwD38L0oZAkqxHVX0Rkl,RXDvfPUBYFlVdlueBFbLW0mhhAyGEqpt,31,55,10,43,17,13,6,19,163,23.285714285714285,3,0.0,18,10,41,17,37,13,2,6,19,86,77,1
683,8029,cuDL2ISAKT9SiekAD9CQynXiu9fQTVyV,G8EPVSXsOYB5YQWZGiz1aVq5Pgr2GrQu,68,71,13,218,7,8,41,5,363,51.857142857142854,13,0.0,0,13,175,7,71,8,43,41,5,195,168,0
684,8031,Ra8GzsxOGVkAaMFXN2T6V1Y5fgtJJH5X,SpATywNh6bZuzm8s1ceuBUnMUAeoAHHw,19,54,1,31,1,4,13,0,104,14.857142857142858,6,0.0,10,1,28,1,44,4,3,13,0,40,64,0
685,8051,HZ6Si9PJ3YYyrZuVsVHlXbrETWWPILa2,SpATywNh6bZuzm8s1ceuBUnMUAeoAHHw,30,30,13,39,7,4,17,1,111,15.857142857142858,3,0.0,12,13,33,7,18,4,6,17,1,65,46,1
686,8059,W8K4VS8rPvnPTNUJrqgtS2FKH93KmR91,bWdj2GDclj5ofokWjzoa5jAwMkxCykd6,42,75,36,251,17,5,18,1,403,57.57142857142857,7,0.0,6,36,228,17,69,5,23,18,1,287,116,1
687,8061,eDdFtfGTTqvukOdpQCeNfhpEnZacRMyL,SpATywNh6bZuzm8s1ceuBUnMUAeoAHHw,28,28,17,20,8,0,17,0,90,12.857142857142858,5,0.0,5,17,19,8,23,0,1,17,0,49,41,0
688,8065,F4JRzQAurYVB0YRhdceJcfWH3R0QimyF,A3fsA9Zfv1X2fVEQhTw51lKENdNrEqT3,6,9,0,0,0,1,4,0,14,2.0,1,0.0,0,0,0,0,9,1,0,4,0,0,14,1
689,8070,Hk1cgW0d6IHp4JJgdPvorinTv3vI8Eld,bWdj2GDclj5ofokWjzoa5jAwMkxCykd6,2,0,0,0,0,0,2,0,2,0.2857142857142857,1,0.0,0,0,0,0,0,0,0,2,0,0,2,1
690,8078,nD2aR2lBTYEZ05tUWGjogkwgt2d7zeNx,bWdj2GDclj5ofokWjzoa5jAwMkxCykd6,34,62,3,137,3,25,20,1,251,35.857142857142854,4,0.0,8,3,125,3,54,25,12,20,1,139,112,1
691,8087,3nOS3JEH08BgwunQqioyEFfja4qIND4p,A3fsA9Zfv1X2fVEQhTw51lKENdNrEqT3,37,26,3,58,2,0,7,0,96,13.714285714285714,2,0.0,5,3,51,2,21,0,7,7,0,61,35,1
692,8106,MyaVABM4nYDk4vd54igotJktuGSzZ2QZ,SpATywNh6bZuzm8s1ceuBUnMUAeoAHHw,4,2,0,0,0,0,2,0,4,0.5714285714285714,1,0.0,0,0,0,0,2,0,0,2,0,0,4,1
693,8120,9vfzrI57qoGmouqr760GeuDugjxYZgDg,A3fsA9Zfv1X2fVEQhTw51lKENdNrEqT3,2,0,0,0,0,0,2,0,2,0.2857142857142857,1,0.0,0,0,0,0,0,0,0,2,0,0,2,1
694,8124,aFQfsfvTRloUF4eJLXlE0V3FUzRLFNv8,RXDvfPUBYFlVdlueBFbLW0mhhAyGEqpt,11,10,6,0,3,0,5,0,24,3.4285714285714284,2,0.0,2,6,0,3,8,0,0,5,0,11,13,1
695,8131,0chnDCxU68X7ybwDimwVoWcTfCUDrb8j,SpATywNh6bZuzm8s1ceuBUnMUAeoAHHw,21,23,12,18,7,74,16,5,155,22.142857142857142,2,0.0,7,12,15,7,16,74,3,16,5,41,114,1
696,8150,0QzhB266MffxtP4NW9xGCK2aFIanQJEL,SpATywNh6bZuzm8s1ceuBUnMUAeoAHHw,17,50,22,16,6,190,37,6,327,46.714285714285715,6,0.0,18,22,13,6,32,190,3,37,6,59,268,1
697,8155,S6HVmLPlerZStE1FmYWcP13FOlr0Ldio,SpATywNh6bZuzm8s1ceuBUnMUAeoAHHw,23,40,1,20,0,4,22,2,89,12.714285714285714,6,0.0,15,1,18,0,25,4,2,22,2,34,55,1
698,8159,rLDZGBeZrRdOkLUUwzLb6ezyjai8N3vb,G8EPVSXsOYB5YQWZGiz1aVq5Pgr2GrQu,9,3,2,0,1,2,8,0,16,2.2857142857142856,1,0.0,0,2,0,1,3,2,0,8,0,3,13,1
699,8164,OvIrFDXnTf7lPGXHN37tKh2m9dXSHGJK,RXDvfPUBYFlVdlueBFbLW0mhhAyGEqpt,71,137,79,131,23,169,61,17,617,88.14285714285714,10,0.0,20,79,128,23,117,169,3,61,17,250,367,0
700,8167,4OFy9ZLb1svxpVgXkgI60wOGeiU4V4oA,SpATywNh6bZuzm8s1ceuBUnMUAeoAHHw,32,67,32,38,10,3,24,1,175,25.0,4,0.0,10,32,31,10,57,3,7,24,1,83,92,1
701,8171,Agc8I1aREEPfi2PqA7NK0aenTcuvE1HC,SpATywNh6bZuzm8s1ceuBUnMUAeoAHHw,29,41,26,27,13,21,14,4,146,20.857142857142858,6,0.0,8,26,23,13,33,21,4,14,4,70,76,0
702,8174,ZFeBOOLKgUUTF7XgzMMbqDAJmFSviC7K,SpATywNh6bZuzm8s1ceuBUnMUAeoAHHw,31,60,29,26,15,1,22,1,154,22.0,6,0.0,17,29,24,15,43,1,2,22,1,85,69,0
703,8182,LVZNwk74X0NnQqnGU1Um0MYH9C8V0Gpb,A3fsA9Zfv1X2fVEQhTw51lKENdNrEqT3,29,28,22,4,17,1,10,1,83,11.857142857142858,1,0.0,0,22,3,17,28,1,1,10,1,42,41,1
704,8183,FFyynYy7wGQKjNauntgybGuFHItz8juf,G8EPVSXsOYB5YQWZGiz1aVq5Pgr2GrQu,109,101,49,303,32,0,12,0,497,71.0,7,0.0,8,49,257,32,93,0,46,12,0,346,151,0
705,8189,vJz36xQo6TWpiQM1Na1nFu4lVJoSD2XQ,A3fsA9Zfv1X2fVEQhTw51lKENdNrEqT3,11,5,1,0,1,1,8,1,17,2.4285714285714284,2,0.0,0,1,0,1,5,1,0,8,1,2,15,1
706,8190,yFLanYq8p4sf6NFSB1Td9ag6632plY4t,bWdj2GDclj5ofokWjzoa5jAwMkxCykd6,20,35,21,12,11,0,14,0,93,13.285714285714286,5,0.0,7,21,11,11,28,0,1,14,0,50,43,1
707,8193,95EnvGi27MT4ra7RQ8eLxKyAZNUVPzZY,G8EPVSXsOYB5YQWZGiz1aVq5Pgr2GrQu,4,0,0,0,0,0,5,0,5,0.7142857142857143,1,0.0,0,0,0,0,0,0,0,5,0,0,5,1
708,8194,I2GJVZ7RHpZycmvh6r4mj8R0Y34OZpBl,SpATywNh6bZuzm8s1ceuBUnMUAeoAHHw,25,52,3,32,2,11,22,1,123,17.571428571428573,6,0.0,11,3,26,2,41,11,6,22,1,42,81,1
709,8200,myPDU4mr5TIDvQCh3WcoSxbhe6fCunPv,SpATywNh6bZuzm8s1ceuBUnMUAeoAHHw,27,49,18,30,8,1,14,1,121,17.285714285714285,4,0.0,8,18,27,8,41,1,3,14,1,61,60,0
710,8216,PR09vSIT2XyOVxXQjGmEX911FaSVIYTE,SpATywNh6bZuzm8s1ceuBUnMUAeoAHHw,17,22,9,14,4,3,11,1,64,9.142857142857142,5,0.0,6,9,13,4,16,3,1,11,1,32,32,1
711,8223,nx1z63DgmeEAxW8gQgEbpcNs34kbRne4,bWdj2GDclj5ofokWjzoa5jAwMkxCykd6,2,0,0,0,0,0,10,0,10,1.4285714285714286,5,0.0,0,0,0,0,0,0,0,10,0,0,10,1
712,8224,5u57vWlYBlYDQJhbIpJzLY4ZLMAv0Mtf,SpATywNh6bZuzm8s1ceuBUnMUAeoAHHw,29,40,12,29,10,34,15,5,145,20.714285714285715,4,0.0,17,12,27,10,23,34,2,15,5,66,79,1
713,8234,1IMOvf9v1bRH0tUTRkiIkzGe833lnAgf,SpATywNh6bZuzm8s1ceuBUnMUAeoAHHw,27,33,14,20,7,2,4,0,80,11.428571428571429,2,0.0,14,14,16,7,19,2,4,4,0,51,29,1
714,8235,gNTGzjcOmHTKgzmUa0veV0Pk7aaKxz1N,SpATywNh6bZuzm8s1ceuBUnMUAeoAHHw,15,27,3,28,0,12,3,0,73,10.428571428571429,1,0.0,14,3,23,0,13,12,5,3,0,40,33,0
715,8241,EV3yvBrX41XoJgzc87hp5TvHhhtAvyFn,SpATywNh6bZuzm8s1ceuBUnMUAeoAHHw,27,41,21,28,8,0,10,0,108,15.428571428571429,4,0.0,8,21,26,8,33,0,2,10,0,63,45,1
716,8242,3mL78JhEm154Hwp0XQW8ZVuzbvUw5uCk,SpATywNh6bZuzm8s1ceuBUnMUAeoAHHw,24,58,30,3,14,2,13,1,121,17.285714285714285,7,0.0,9,30,3,14,49,2,0,13,1,56,65,0
717,8252,HKDSRzc7MQzCfJsk49D6xFQK4oFHHvy7,SpATywNh6bZuzm8s1ceuBUnMUAeoAHHw,21,59,0,38,0,7,36,1,141,20.142857142857142,7,0.0,28,0,32,0,31,7,6,36,1,60,81,0
718,8258,JTNAXWhf5PjT17BvIH89SNZsmQ5O87y8,SpATywNh6bZuzm8s1ceuBUnMUAeoAHHw,22,33,16,21,9,0,3,0,82,11.714285714285714,2,0.0,15,16,21,9,18,0,0,3,0,61,21,1
719,8259,DVIil2NM7ZWOtqe6rhlMzwEUAb2wuaeh,bWdj2GDclj5ofokWjzoa5jAwMkxCykd6,33,78,44,76,19,15,16,0,248,35.42857142857143,9,0.0,13,44,76,19,65,15,0,16,0,152,96,0
720,8260,DVIil2NM7ZWOtqe6rhlMzwEUAb2wuaeh,A3fsA9Zfv1X2fVEQhTw51lKENdNrEqT3,68,146,85,69,31,20,22,0,373,53.285714285714285,9,0.0,5,85,69,31,141,20,0,22,0,190,183,0
721,8271,Bf5XnSmEHpp62KAmmEq9Qh5nAQvits8I,SpATywNh6bZuzm8s1ceuBUnMUAeoAHHw,28,45,27,19,19,7,13,1,131,18.714285714285715,6,0.0,17,27,18,19,28,7,1,13,1,81,50,1
722,8274,wcD7BoyQ6hUK2AqYmriY7H2V7sWuy6kP,G8EPVSXsOYB5YQWZGiz1aVq5Pgr2GrQu,6,2,0,0,0,1,6,1,10,1.4285714285714286,1,0.0,0,0,0,0,2,1,0,6,1,0,10,1
723,8275,GHabqgRgi0KXSBTYXxIc3mcQESEOp0QM,SpATywNh6bZuzm8s1ceuBUnMUAeoAHHw,12,14,7,2,1,76,23,1,124,17.714285714285715,7,0.0,3,7,2,1,11,76,0,23,1,13,111,0
724,8276,V7y3ErWDx79HQwDxdGqBqCI3nEwG2a9C,SpATywNh6bZuzm8s1ceuBUnMUAeoAHHw,22,38,6,10,4,37,24,1,120,17.142857142857142,5,0.0,2,6,9,4,36,37,1,24,1,21,99,0
725,8280,41Lg2hcbw0N9iuSjhrPTYqB7aTnux5zG,SpATywNh6bZuzm8s1ceuBUnMUAeoAHHw,28,48,21,24,7,0,18,0,118,16.857142857142858,9,0.0,4,21,23,7,44,0,1,18,0,55,63,0
726,8299,SYTowVKdp8XatPrqrpe4A3JAMuYI5Sox,A3fsA9Zfv1X2fVEQhTw51lKENdNrEqT3,3,3,0,0,0,0,2,0,5,0.7142857142857143,1,0.0,0,0,0,0,3,0,0,2,0,0,5,1
727,8306,cpsVaqCE0ju1HgyRTcGi2lL27KFxQlQV,G8EPVSXsOYB5YQWZGiz1aVq5Pgr2GrQu,13,38,2,0,2,33,16,0,91,13.0,3,0.0,0,2,0,2,38,33,0,16,0,4,87,1
728,8307,U091mKrbkiTDzf4rGIqu8muSeBSZhUjL,A3fsA9Zfv1X2fVEQhTw51lKENdNrEqT3,37,18,10,76,6,0,4,0,114,16.285714285714285,2,0.0,5,10,61,6,13,0,15,4,0,82,32,1
729,8319,VzKWDpKk4q6OejBxKl56odCKiGjlmGba,SpATywNh6bZuzm8s1ceuBUnMUAeoAHHw,7,3,2,0,2,0,2,0,9,1.2857142857142858,1,0.0,0,2,0,2,3,0,0,2,0,4,5,1
730,8327,Rxx8uEqY3FOt7Egy2EEEwihJJCyVsQKy,G8EPVSXsOYB5YQWZGiz1aVq5Pgr2GrQu,88,119,51,137,38,15,30,4,394,56.285714285714285,8,0.0,52,51,98,38,67,15,39,30,4,239,155,0
731,8330,RPoQoiLJoTfoUXTEomWL6iW4S8GRhX7J,SpATywNh6bZuzm8s1ceuBUnMUAeoAHHw,13,23,8,17,3,0,5,0,56,8.0,4,0.0,4,8,14,3,19,0,3,5,0,29,27,0
732,8335,2tvGCUYYinrGZmVDaUEHPItUSSMqiKmY,SpATywNh6bZuzm8s1ceuBUnMUAeoAHHw,29,44,28,29,15,0,10,0,126,18.0,6,0.0,8,28,27,15,36,0,2,10,0,78,48,0
733,8336,UgRvVqO3twMvJzAlD49rqrTbxTS8yLpX,A3fsA9Zfv1X2fVEQhTw51lKENdNrEqT3,74,44,34,116,25,0,11,0,230,32.857142857142854,7,0.0,2,34,105,25,42,0,11,11,0,166,64,1
734,8337,SP1OGXx7XA1zodabwHSZpThCzaY2Fjl2,SpATywNh6bZuzm8s1ceuBUnMUAeoAHHw,20,33,6,22,2,21,11,0,95,13.571428571428571,8,0.0,6,6,21,2,27,21,1,11,0,35,60,0
735,8347,jMKMopo0fDIDt1YMaxiGrP1SNRt3VtFz,SpATywNh6bZuzm8s1ceuBUnMUAeoAHHw,19,31,14,14,7,3,5,0,74,10.571428571428571,2,0.0,14,14,13,7,17,3,1,5,0,48,26,0
736,8359,xI8Nr9tpm5UYMfkPTEK7ZnHqHm9s1zwr,SpATywNh6bZuzm8s1ceuBUnMUAeoAHHw,15,28,0,19,0,2,7,1,57,8.142857142857142,4,0.0,6,0,16,0,22,2,3,7,1,22,35,1
737,8372,Ja8xgxpUQSylPcWwfGyX1RUCUJ6MhJqT,SpATywNh6bZuzm8s1ceuBUnMUAeoAHHw,26,41,17,10,8,29,12,0,117,16.714285714285715,4,0.0,9,17,9,8,32,29,1,12,0,43,74,0
738,8374,eA2IVnHLbAPJoKRWHDe6zYszLSF4Gt3f,SpATywNh6bZuzm8s1ceuBUnMUAeoAHHw,5,2,1,0,1,1,2,0,7,1.0,1,0.0,0,1,0,1,2,1,0,2,0,2,5,1
739,8386,UkUsH963uedhLI1tDU35ug9sCdholLWP,SpATywNh6bZuzm8s1ceuBUnMUAeoAHHw,1,0,0,0,0,0,1,0,1,0.14285714285714285,1,0.0,0,0,0,0,0,0,0,1,0,0,1,1
740,8389,NngMZQTGAdrhmbSK51CUolNQSpFXDhiO,SpATywNh6bZuzm8s1ceuBUnMUAeoAHHw,31,70,34,21,12,6,33,1,177,25.285714285714285,7,0.0,15,34,18,12,55,6,3,33,1,79,98,0
741,8391,tF8i4h1a2Nm3JCN3xA7kONOWBOERcJ4Q,SpATywNh6bZuzm8s1ceuBUnMUAeoAHHw,29,44,23,47,8,2,13,0,137,19.571428571428573,6,0.0,16,23,38,8,28,2,9,13,0,85,52,0
742,8393,4sCPuVlkq4rBRlBYNyTR5EDg94co1oy4,bWdj2GDclj5ofokWjzoa5jAwMkxCykd6,7,5,2,0,1,0,6,0,14,2.0,3,0.0,0,2,0,1,5,0,0,6,0,3,11,0
743,8400,LutlROyPHhGEkAfetUikskFihdvWMQNQ,SpATywNh6bZuzm8s1ceuBUnMUAeoAHHw,7,2,1,0,1,0,12,0,16,2.2857142857142856,4,0.0,0,1,0,1,2,0,0,12,0,2,14,1
744,8405,kWUbu8oK1dFJKpHhiF15MwcSzNzv8GaS,bWdj2GDclj5ofokWjzoa5jAwMkxCykd6,29,58,30,118,14,25,15,0,260,37.142857142857146,6,0.0,12,30,111,14,46,25,7,15,0,167,93,0
745,8416,mrUvSMVJRVrLlCOcTH6rs5HGHSxrWvwY,A3fsA9Zfv1X2fVEQhTw51lKENdNrEqT3,44,32,19,60,12,1,10,1,135,19.285714285714285,4,0.0,7,19,50,12,25,1,10,10,1,88,47,1
746,8431,7CBtPeICctNtzQffl1jHApp4Y7WIYc5w,SpATywNh6bZuzm8s1ceuBUnMUAeoAHHw,7,6,5,0,2,0,2,0,15,2.142857142857143,1,0.0,0,5,0,2,6,0,0,2,0,7,8,1
747,8435,j1jdy8OF5VQw4rqSYOkbK2pQplvvvz37,A3fsA9Zfv1X2fVEQhTw51lKENdNrEqT3,76,116,17,142,13,13,56,0,357,51.0,13,0.0,5,17,119,13,111,13,23,56,0,154,203,0
748,8437,12tfSRcVHU1LY6VYbYjnNdGrVUGUAhWB,SpATywNh6bZuzm8s1ceuBUnMUAeoAHHw,31,46,25,16,11,3,14,1,116,16.571428571428573,6,0.0,13,25,14,11,33,3,2,14,1,63,53,0
749,8446,oDnQYjxji4p3XVFJMOGI9NvIvASqoqC1,A3fsA9Zfv1X2fVEQhTw51lKENdNrEqT3,45,24,19,78,14,0,20,0,155,22.142857142857142,6,0.0,1,19,63,14,23,0,15,20,0,97,58,1
750,8447,gok0oMg5xY1pC9HgrOtGpZy6NUwXLxlf,SpATywNh6bZuzm8s1ceuBUnMUAeoAHHw,9,30,0,6,0,1,13,0,50,7.142857142857143,4,0.0,2,0,5,0,28,1,1,13,0,7,43,1
751,8456,Ve3uiMw5Q81FgfkGuxFl4mQAXBScEtc6,G8EPVSXsOYB5YQWZGiz1aVq5Pgr2GrQu,29,11,8,69,6,0,7,0,101,14.428571428571429,2,0.0,0,8,54,6,11,0,15,7,0,68,33,1
752,8461,tH916xRbn4bSZXJ6Z57PlnTAPQfz04PX,SpATywNh6bZuzm8s1ceuBUnMUAeoAHHw,22,22,13,2,6,0,10,0,53,7.571428571428571,5,0.0,1,13,2,6,21,0,0,10,0,22,31,0
753,8473,wfFQgTOVxHIMKx1Ficu9NrZPRH0gMksQ,bWdj2GDclj5ofokWjzoa5jAwMkxCykd6,3,3,0,0,0,0,1,0,4,0.5714285714285714,1,0.0,0,0,0,0,3,0,0,1,0,0,4,1
754,8476,iUNH7SHIFk6NFV7H1Nzzf4QPKBlc8jre,SpATywNh6bZuzm8s1ceuBUnMUAeoAHHw,9,5,4,0,4,0,2,0,15,2.142857142857143,1,0.0,0,4,0,4,5,0,0,2,0,8,7,1
755,8486,BeZnyZhcScrHr8WAPYtxUxDjMPiK7yK1,SpATywNh6bZuzm8s1ceuBUnMUAeoAHHw,19,39,21,0,10,0,12,0,82,11.714285714285714,7,0.0,4,21,0,10,35,0,0,12,0,35,47,0
756,8492,ttr9a170CwLt0wxJRJXz9h6pCGNxEiGM,SpATywNh6bZuzm8s1ceuBUnMUAeoAHHw,8,11,0,0,0,0,6,0,17,2.4285714285714284,4,0.0,0,0,0,0,11,0,0,6,0,0,17,1
757,8494,gir9E9ZUbwj6bCUNLD2kQmOx1nsVwG4J,SpATywNh6bZuzm8s1ceuBUnMUAeoAHHw,26,52,22,14,11,13,16,1,129,18.428571428571427,6,0.0,15,22,14,11,37,13,0,16,1,62,67,1
758,8503,PtXR7nBc6ugMebaEp6mKjp0TYO5kZtvE,SpATywNh6bZuzm8s1ceuBUnMUAeoAHHw,32,81,43,36,17,21,22,1,221,31.571428571428573,11,0.0,23,43,30,17,58,21,6,22,1,113,108,0
759,8511,FjbDR3UaxcNBkb6IH3GDQCUcWtWdh8Qq,A3fsA9Zfv1X2fVEQhTw51lKENdNrEqT3,17,8,5,46,2,0,3,0,64,9.142857142857142,2,0.0,1,5,37,2,7,0,9,3,0,45,19,1
760,8519,doRePDFWyZgA5bRcL7NARsAGKc9EfIRX,SpATywNh6bZuzm8s1ceuBUnMUAeoAHHw,1,0,0,0,0,0,1,0,1,0.14285714285714285,1,0.0,0,0,0,0,0,0,0,1,0,0,1,1
761,8534,sYJH30p3sjRgvjLciMuuEKpuHxukMGmh,bWdj2GDclj5ofokWjzoa5jAwMkxCykd6,13,17,6,12,4,2,14,2,57,8.142857142857142,3,0.0,5,6,10,4,12,2,2,14,2,25,32,1
762,8539,ApFdQQBcLqTLoA4wIvtlnnwFs4FrlVS1,A3fsA9Zfv1X2fVEQhTw51lKENdNrEqT3,99,60,47,252,26,1,41,1,428,61.142857142857146,10,0.0,6,47,238,26,54,1,14,41,1,317,111,0
763,8542,DALf49Q7nGCtSxipmkha0WYpWi5x67si,SpATywNh6bZuzm8s1ceuBUnMUAeoAHHw,26,51,5,33,5,9,32,4,139,19.857142857142858,3,0.0,14,5,29,5,37,9,4,32,4,53,86,1
764,8552,pSX00XUyCx7VlmgWGN0d39OwC9BZ8bRV,A3fsA9Zfv1X2fVEQhTw51lKENdNrEqT3,44,19,14,46,9,3,8,0,99,14.142857142857142,2,0.0,1,14,43,9,18,3,3,8,0,67,32,1
765,8554,R2LGboNcUADM1LGFGgPuEpT43AraZJb1,SpATywNh6bZuzm8s1ceuBUnMUAeoAHHw,2,0,0,0,0,0,2,0,2,0.2857142857142857,1,0.0,0,0,0,0,0,0,0,2,0,0,2,1
766,8562,2YohZ5UKGzy1qUgVAShosLdhgm3pfvsR,RXDvfPUBYFlVdlueBFbLW0mhhAyGEqpt,26,36,4,21,3,0,8,11,83,11.857142857142858,5,0.0,5,4,20,3,31,0,1,8,11,32,51,1
767,8576,HHsJECDPslzJS0fyoCEbSGrnL1evzSJb,SpATywNh6bZuzm8s1ceuBUnMUAeoAHHw,10,13,5,0,3,3,8,2,34,4.857142857142857,4,0.0,3,5,0,3,10,3,0,8,2,11,23,0
768,8578,ctoSfpAfvm3av2aqkT0D3Yq8icDxZKCx,SpATywNh6bZuzm8s1ceuBUnMUAeoAHHw,7,7,2,0,2,0,6,0,17,2.4285714285714284,4,0.0,1,2,0,2,6,0,0,6,0,5,12,1
769,8579,5SaN6rc1Jws1AbkuHmPyLN82qDTc23Xp,SpATywNh6bZuzm8s1ceuBUnMUAeoAHHw,8,6,0,10,0,1,7,0,24,3.4285714285714284,2,0.0,0,0,7,0,6,1,3,7,0,7,17,1
770,8580,NbSKhx4CxJyTkjcYgC3wEU9PLylFddj5,SpATywNh6bZuzm8s1ceuBUnMUAeoAHHw,26,101,2,29,3,47,40,6,228,32.57142857142857,8,0.0,47,2,25,3,54,47,4,40,6,77,151,0
771,8589,QiGOPB8shOtQ5nbvOvvOxzT1SShMMuAf,SpATywNh6bZuzm8s1ceuBUnMUAeoAHHw,29,37,13,45,7,6,8,0,116,16.571428571428573,3,0.0,13,13,37,7,24,6,8,8,0,70,46,0
772,8590,tQHFI5lya7DKbCzO4oTkHd2600sh8kNe,G8EPVSXsOYB5YQWZGiz1aVq5Pgr2GrQu,21,22,7,38,5,0,5,0,77,11.0,3,0.0,9,7,30,5,13,0,8,5,0,51,26,1
773,8603,NDWoO09mCIeS4HdBeNYH7dNkyhIv3eXv,SpATywNh6bZuzm8s1ceuBUnMUAeoAHHw,25,30,2,23,1,14,11,2,83,11.857142857142858,4,0.0,8,2,21,1,22,14,2,11,2,32,51,1
774,8610,YPO9VbNOFh7KZMXyxOJMSk1iTNwVpJOe,SpATywNh6bZuzm8s1ceuBUnMUAeoAHHw,11,12,0,12,0,0,6,0,30,4.285714285714286,1,0.0,6,0,11,0,6,0,1,6,0,17,13,0
775,8617,ls4yyZ7MYyWiEmQ5nJV5QAmKdBgFaV8n,G8EPVSXsOYB5YQWZGiz1aVq5Pgr2GrQu,51,99,35,114,16,0,17,0,281,40.142857142857146,5,0.0,61,35,81,16,38,0,33,17,0,193,88,1
776,8622,Y7IgoRAqVJfNlsulCSI4HObujHPSzoLA,A3fsA9Zfv1X2fVEQhTw51lKENdNrEqT3,13,8,6,0,5,0,2,0,21,3.0,2,0.0,0,6,0,5,8,0,0,2,0,11,10,1
777,8626,yq8YyMugEpZrcWzhPtzidXoqQsPJ81ZJ,G8EPVSXsOYB5YQWZGiz1aVq5Pgr2GrQu,4,2,0,0,0,1,3,0,6,0.8571428571428571,2,0.0,0,0,0,0,2,1,0,3,0,0,6,1
778,8635,jH123vWnpYTVLfmuSyled9Oau0AYvcx6,G8EPVSXsOYB5YQWZGiz1aVq5Pgr2GrQu,41,20,2,118,1,0,7,0,148,21.142857142857142,3,0.0,0,2,103,1,20,0,15,7,0,106,42,1
779,8637,YeutUTPU1KeBL2Vd5ZhxL2fFNQ8D7NVG,SpATywNh6bZuzm8s1ceuBUnMUAeoAHHw,17,43,13,12,3,11,18,3,103,14.714285714285714,2,0.0,21,13,12,3,22,11,0,18,3,49,54,1
780,8638,kXndrjnvT5RUWACXG428KqXdIpBxsEit,A3fsA9Zfv1X2fVEQhTw51lKENdNrEqT3,12,26,0,0,0,2,12,1,41,5.857142857142857,4,0.0,1,0,0,0,25,2,0,12,1,1,40,1
781,8639,xqboiFlp42vyY93nDStsbVWBCL5sgIRH,SpATywNh6bZuzm8s1ceuBUnMUAeoAHHw,5,2,1,0,1,0,4,0,8,1.1428571428571428,1,0.0,0,1,0,1,2,0,0,4,0,2,6,1
782,8644,4PVAcJZJLiNhJa8rMcHaqBMuPaZIl5Nm,SpATywNh6bZuzm8s1ceuBUnMUAeoAHHw,27,30,17,27,11,0,13,0,98,14.0,4,0.0,7,17,23,11,23,0,4,13,0,58,40,1
783,8647,pZDK7WA5fQeGMPFsats2GLmFnZbZQ7ed,SpATywNh6bZuzm8s1ceuBUnMUAeoAHHw,24,49,22,26,6,15,14,1,133,19.0,5,0.0,16,22,23,6,33,15,3,14,1,67,66,1
784,8654,nquBmikiqPFYvs17N894M5iUc88scoVO,SpATywNh6bZuzm8s1ceuBUnMUAeoAHHw,21,74,4,38,1,47,30,2,196,28.0,5,0.0,8,4,31,1,66,47,7,30,2,44,152,0
785,8661,CxzZVyClE1BEgH3USSirqOtKD3HSH7vg,SpATywNh6bZuzm8s1ceuBUnMUAeoAHHw,17,17,8,12,4,0,6,2,49,7.0,2,0.0,2,8,11,4,15,0,1,6,2,25,24,1
786,8679,kyUPY0MEVeZNvkmrQxOn0CHNXLZiD03b,A3fsA9Zfv1X2fVEQhTw51lKENdNrEqT3,10,24,2,0,1,10,8,0,45,6.428571428571429,5,0.0,3,2,0,1,21,10,0,8,0,6,39,1
787,8691,ESjXyWS3x5wlkZHp5KISOO9gy5mDNyIG,SpATywNh6bZuzm8s1ceuBUnMUAeoAHHw,9,21,10,0,5,0,10,0,46,6.571428571428571,5,0.0,2,10,0,5,19,0,0,10,0,17,29,1
788,8700,je9A6l6tP7wnbFhNJD7vbbHTYhqshuqB,G8EPVSXsOYB5YQWZGiz1aVq5Pgr2GrQu,59,172,56,120,19,6,19,1,393,56.142857142857146,10,0.0,62,56,88,19,110,6,32,19,1,225,168,0
789,8701,kxC3AAELak9RRmJoG2dzH7rfP0Xyo0FH,SpATywNh6bZuzm8s1ceuBUnMUAeoAHHw,15,24,16,4,7,0,7,0,58,8.285714285714286,4,0.0,0,16,4,7,24,0,0,7,0,27,31,1
790,8706,4G8PB07c1AYOLDoNxj95BoxFXM7YCCci,SpATywNh6bZuzm8s1ceuBUnMUAeoAHHw,3,2,0,0,0,0,1,0,3,0.42857142857142855,1,0.0,0,0,0,0,2,0,0,1,0,0,3,1
791,8708,nzGzo6fW6QPE9hjoabI90qrzv3llY1Fg,G8EPVSXsOYB5YQWZGiz1aVq5Pgr2GrQu,12,17,6,0,3,0,5,0,31,4.428571428571429,2,0.0,2,6,0,3,15,0,0,5,0,11,20,1
792,8711,MQxVHrLqN67CEKfOyyeFlttLUKuqvrcv,RXDvfPUBYFlVdlueBFbLW0mhhAyGEqpt,1,0,0,0,0,0,1,0,1,0.14285714285714285,1,0.0,0,0,0,0,0,0,0,1,0,0,1,0
793,8730,JoruyAOmEeM1qjcSEWRUjLvQUHpNPZGp,RXDvfPUBYFlVdlueBFbLW0mhhAyGEqpt,52,116,3,107,8,88,37,9,368,52.57142857142857,7,0.0,24,3,91,8,92,88,16,37,9,126,242,1
794,8735,WNT8mFhPmDPRuQT8JLsnindelSr1MnST,SpATywNh6bZuzm8s1ceuBUnMUAeoAHHw,31,44,23,34,8,40,28,3,180,25.714285714285715,6,0.0,14,23,29,8,30,40,5,28,3,74,106,1
795,8747,WuOqx5J7nUG7M0CzOeQJHpDiW7DgSS7B,SpATywNh6bZuzm8s1ceuBUnMUAeoAHHw,16,31,1,24,1,2,3,0,62,8.857142857142858,1,0.0,15,1,20,1,16,2,4,3,0,37,25,1
796,8758,NCbFqYNTEfc5vPQvAyBwDtnbS3ENYJY7,bWdj2GDclj5ofokWjzoa5jAwMkxCykd6,12,22,1,37,3,3,14,2,82,11.714285714285714,2,0.0,7,1,35,3,15,3,2,14,2,46,36,1
797,8759,9SPQ1jfplQbke9byQIAxTVMFCooGS54y,A3fsA9Zfv1X2fVEQhTw51lKENdNrEqT3,16,10,5,0,4,4,8,1,32,4.571428571428571,1,0.0,2,5,0,4,8,4,0,8,1,11,21,1
798,8761,7ye3FQXc4XBmC7UwnNQWxsWGDnaNcvG6,SpATywNh6bZuzm8s1ceuBUnMUAeoAHHw,23,38,0,34,0,3,11,1,87,12.428571428571429,4,0.0,5,0,29,0,33,3,5,11,1,34,53,1
799,8780,l7cIWSn2QdqLoOKMFO8yNQGKfk999nJh,A3fsA9Zfv1X2fVEQhTw51lKENdNrEqT3,5,7,3,0,0,0,2,0,12,1.7142857142857142,2,0.0,2,3,0,0,5,0,0,2,0,5,7,1
800,8791,E2VKNfvaS8HbcvRZooqcq8161JUOvad2,RXDvfPUBYFlVdlueBFbLW0mhhAyGEqpt,14,23,12,0,4,0,5,0,44,6.285714285714286,3,0.0,1,12,0,4,22,0,0,5,0,17,27,1
801,8793,Ga4lr67F0RIjyUetWH1EgQ3xzSHDnViF,bWdj2GDclj5ofokWjzoa5jAwMkxCykd6,19,28,16,64,7,3,10,1,129,18.428571428571427,4,0.0,7,16,62,7,21,3,2,10,1,92,37,0
802,8794,br8lmEhz6IHlXV0QfsU4Spi9BczfMT8x,SpATywNh6bZuzm8s1ceuBUnMUAeoAHHw,21,32,14,32,0,0,6,0,84,12.0,3,0.0,15,14,29,0,17,0,3,6,0,58,26,0
803,8803,RFvs5NuNtACNU2U9ElWUm5Jw7rHjvZwP,SpATywNh6bZuzm8s1ceuBUnMUAeoAHHw,6,5,4,0,2,0,1,0,12,1.7142857142857142,1,0.0,0,4,0,2,5,0,0,1,0,6,6,1
804,8809,ivdkzhYPhrTUKnU1xY68Yfp2rdDhgD3h,SpATywNh6bZuzm8s1ceuBUnMUAeoAHHw,18,52,21,16,10,31,38,3,171,24.428571428571427,4,0.0,17,21,15,10,35,31,1,38,3,63,108,0
805,8814,8IuzZOXaXVUql9pLZtNuJIyLoDJ8ZL4V,SpATywNh6bZuzm8s1ceuBUnMUAeoAHHw,15,27,10,6,3,1,8,0,55,7.857142857142857,5,0.0,4,10,6,3,23,1,0,8,0,23,32,0
806,8815,Ga4lr67F0RIjyUetWH1EgQ3xzSHDnViF,A3fsA9Zfv1X2fVEQhTw51lKENdNrEqT3,1,0,0,0,0,0,1,0,1,0.14285714285714285,1,0.0,0,0,0,0,0,0,0,1,0,0,1,1
807,8852,1sf1a7OMEvwky5hvLFD12TaOsmoNw2Qb,SpATywNh6bZuzm8s1ceuBUnMUAeoAHHw,25,53,22,24,9,0,7,0,115,16.428571428571427,5,0.0,10,22,24,9,43,0,0,7,0,65,50,0
808,8860,IwB6SmnBZExRlnmOtkIDRkNteqe5iWyf,SpATywNh6bZuzm8s1ceuBUnMUAeoAHHw,1,0,0,0,0,0,1,0,1,0.14285714285714285,1,0.0,0,0,0,0,0,0,0,1,0,0,1,1
809,8865,Up0SfqXbbz6NGY2S4ku6GM2FOwYrzCdN,SpATywNh6bZuzm8s1ceuBUnMUAeoAHHw,1,0,0,0,0,0,1,0,1,0.14285714285714285,1,0.0,0,0,0,0,0,0,0,1,0,0,1,1
810,8870,ZNWyxGsQnaw3e5XPyIUr5rwKsBrD0VQe,G8EPVSXsOYB5YQWZGiz1aVq5Pgr2GrQu,8,21,1,0,2,0,4,0,28,4.0,1,0.0,8,1,0,2,13,0,0,4,0,11,17,0
811,8900,fY0uxi2rFKNgoTYTvIZdgXrk3XKUTjS3,SpATywNh6bZuzm8s1ceuBUnMUAeoAHHw,18,47,11,13,5,0,2,0,78,11.142857142857142,2,0.0,4,11,13,5,43,0,0,2,0,33,45,0
812,8904,0QFADiD6IvsCiGKcRzsLQbDvaZGh6BVG,SpATywNh6bZuzm8s1ceuBUnMUAeoAHHw,9,9,2,0,2,0,3,0,16,2.2857142857142856,2,0.0,0,2,0,2,9,0,0,3,0,4,12,0
813,8917,5vUuq5ZeDCNce4LmvH0naoUjpb3qbNOp,SpATywNh6bZuzm8s1ceuBUnMUAeoAHHw,19,20,11,14,3,8,15,1,72,10.285714285714286,7,0.0,3,11,11,3,17,8,3,15,1,28,44,1
814,8925,PenDUeO0eoR8hyLVdfPN6H7q2FnTGMus,A3fsA9Zfv1X2fVEQhTw51lKENdNrEqT3,14,22,11,0,2,32,25,1,93,13.285714285714286,6,0.0,0,11,0,2,22,32,0,25,1,13,80,0
815,8929,1oBn81XXDSWJtnCZIRPmhZcBWe7qP0iB,RXDvfPUBYFlVdlueBFbLW0mhhAyGEqpt,61,103,65,145,28,2,27,0,370,52.857142857142854,8,0.0,19,65,133,28,84,2,12,27,0,245,125,1
816,8934,H3CmwGihecRb7lZltIA7orKjensSqIgF,RXDvfPUBYFlVdlueBFbLW0mhhAyGEqpt,16,21,3,0,4,12,2,0,42,6.0,3,0.0,2,3,0,4,19,12,0,2,0,9,33,1
817,8935,pYasYOOyUapjKdoqnDhFpArs52eNDPLb,SpATywNh6bZuzm8s1ceuBUnMUAeoAHHw,25,31,19,34,8,1,13,0,106,15.142857142857142,8,0.0,5,19,29,8,26,1,5,13,0,61,45,0
818,8945,Iupcx1vHh7MTin0aJweHjQkwiErp9HHL,SpATywNh6bZuzm8s1ceuBUnMUAeoAHHw,5,2,1,0,1,0,2,0,6,0.8571428571428571,1,0.0,0,1,0,1,2,0,0,2,0,2,4,1
819,8956,JtMmp5BCDQnYE7CMI3NvnX4aRCZsQW9K,bWdj2GDclj5ofokWjzoa5jAwMkxCykd6,16,32,14,0,8,11,58,2,125,17.857142857142858,14,0.0,4,14,0,8,28,11,0,58,2,26,99,0
820,8966,qFpdcx3mtZSSE0KVCMsIlMdOIeoOzyoo,SpATywNh6bZuzm8s1ceuBUnMUAeoAHHw,27,84,23,38,4,2,36,2,189,27.0,15,0.0,21,23,31,4,63,2,7,36,2,79,110,0
821,8971,p04QzukP32kpPk8EGoBhDUGJJQqJUoNz,SpATywNh6bZuzm8s1ceuBUnMUAeoAHHw,28,69,10,18,6,42,34,6,185,26.428571428571427,9,0.0,14,10,18,6,55,42,0,34,6,48,137,0
822,8990,d50bzrDUj3g2Xiqt1t5CNiAegqkJwLeY,SpATywNh6bZuzm8s1ceuBUnMUAeoAHHw,15,19,2,0,2,1,7,1,32,4.571428571428571,1,0.0,5,2,0,2,14,1,0,7,1,9,23,1
823,8991,N16QHS59cTDWe3hpSKjuHvn5eRO4wcEE,SpATywNh6bZuzm8s1ceuBUnMUAeoAHHw,7,6,3,0,2,0,3,0,14,2.0,1,0.0,0,3,0,2,6,0,0,3,0,5,9,1
824,9002,L534Da3JB50xKXQoTXrCa1H5GVkKxZyU,SpATywNh6bZuzm8s1ceuBUnMUAeoAHHw,8,5,2,0,2,0,4,0,13,1.8571428571428572,1,0.0,0,2,0,2,5,0,0,4,0,4,9,1
825,9011,sNZ43ghPU2QwNk3cu7wYztVZWvmkGmKL,SpATywNh6bZuzm8s1ceuBUnMUAeoAHHw,25,40,20,28,5,5,5,0,103,14.714285714285714,5,0.0,9,20,27,5,31,5,1,5,0,61,42,0
826,9015,3BQ5hO2xolpwYa13L4VN9VBwShRsjOB9,A3fsA9Zfv1X2fVEQhTw51lKENdNrEqT3,17,9,7,0,6,0,4,0,26,3.7142857142857144,1,0.0,0,7,0,6,9,0,0,4,0,13,13,1
827,9017,a5tgLYkHndhh8Yb10TacQs9Vi34mi45u,RXDvfPUBYFlVdlueBFbLW0mhhAyGEqpt,47,40,22,79,12,5,16,9,183,26.142857142857142,3,0.0,15,22,72,12,25,5,7,16,9,121,62,0
828,9018,pVooF8yxRpciMTpPCaLN6jM2lWrWpauA,SpATywNh6bZuzm8s1ceuBUnMUAeoAHHw,7,4,2,0,0,2,7,1,16,2.2857142857142856,1,0.0,1,2,0,0,3,2,0,7,1,3,13,1
829,9023,K7xeVolEtXE0AogXgMn5GEzQ96UioEwW,SpATywNh6bZuzm8s1ceuBUnMUAeoAHHw,16,16,8,0,8,0,1,0,33,4.714285714285714,1,0.0,4,8,0,8,12,0,0,1,0,20,13,1
830,9031,L534Da3JB50xKXQoTXrCa1H5GVkKxZyU,bWdj2GDclj5ofokWjzoa5jAwMkxCykd6,5,2,1,0,1,0,2,0,6,0.8571428571428571,1,0.0,0,1,0,1,2,0,0,2,0,2,4,1
831,9040,AoGNGJBevj5UJJAo0rhBglhkcP4W6WBy,bWdj2GDclj5ofokWjzoa5jAwMkxCykd6,1,0,0,0,0,0,1,0,1,0.14285714285714285,1,0.0,0,0,0,0,0,0,0,1,0,0,1,1
832,9041,L534Da3JB50xKXQoTXrCa1H5GVkKxZyU,RXDvfPUBYFlVdlueBFbLW0mhhAyGEqpt,5,2,1,0,1,0,2,0,6,0.8571428571428571,1,0.0,0,1,0,1,2,0,0,2,0,2,4,1
833,9047,bssQsmzoNxPtkllVsM0XyYElvtsPU1iO,A3fsA9Zfv1X2fVEQhTw51lKENdNrEqT3,6,10,1,0,1,0,1,0,13,1.8571428571428572,1,0.0,0,1,0,1,10,0,0,1,0,2,11,1
834,9048,8IYoAw78mc8ysNlcBgXt630ETnnEuaUM,SpATywNh6bZuzm8s1ceuBUnMUAeoAHHw,14,24,2,23,1,0,12,0,62,8.857142857142858,4,0.0,9,2,22,1,15,0,1,12,0,34,28,0
835,9056,WJoD89Bo9NFFK86vx66y3rksOk6ixc2b,SpATywNh6bZuzm8s1ceuBUnMUAeoAHHw,21,30,19,0,11,0,9,0,69,9.857142857142858,2,0.0,2,19,0,11,28,0,0,9,0,32,37,1
836,9064,J782awhmjhWAohIOvWifbZTNvhSxGcmf,RXDvfPUBYFlVdlueBFbLW0mhhAyGEqpt,32,45,29,0,19,0,7,0,100,14.285714285714286,4,0.0,2,29,0,19,43,0,0,7,0,50,50,1
837,9065,6Dq4LTGgUzJAJPwYkedRMadSEQwnkyG3,SpATywNh6bZuzm8s1ceuBUnMUAeoAHHw,7,27,15,0,1,0,11,0,54,7.714285714285714,2,0.0,0,15,0,1,27,0,0,11,0,16,38,1
838,9072,xBNDEDD7fMER9fNR4W15k6QiKRrdBf4x,G8EPVSXsOYB5YQWZGiz1aVq5Pgr2GrQu,51,79,8,116,3,1,15,1,223,31.857142857142858,4,0.0,37,8,81,3,42,1,35,15,1,129,94,1
839,9079,Cb1aR5BeXGrDewkPGGzseNCh6yBNhS9Z,G8EPVSXsOYB5YQWZGiz1aVq5Pgr2GrQu,18,22,8,20,5,0,6,0,61,8.714285714285714,3,0.0,7,8,13,5,15,0,7,6,0,33,28,1
840,9085,q78BjeBORwDIcVH7lRGRd3WfImLmduN4,G8EPVSXsOYB5YQWZGiz1aVq5Pgr2GrQu,18,9,8,0,8,0,3,0,28,4.0,1,0.0,0,8,0,8,9,0,0,3,0,16,12,1
841,9100,0K6JPqiivQzicxY4EV4nqMLCL3a08A97,bWdj2GDclj5ofokWjzoa5jAwMkxCykd6,13,19,6,10,8,0,18,0,61,8.714285714285714,4,0.0,6,6,10,8,13,0,0,18,0,30,31,0
842,9112,XDPvGyFLLEYwbNEQik2MM4yiADs5rrYJ,bWdj2GDclj5ofokWjzoa5jAwMkxCykd6,9,7,4,0,3,0,2,0,16,2.2857142857142856,1,0.0,1,4,0,3,6,0,0,2,0,8,8,0
843,9118,ZPIRNChg4KaoHQC5y65LKyeBd78COsQH,A3fsA9Zfv1X2fVEQhTw51lKENdNrEqT3,8,4,3,0,3,0,1,0,11,1.5714285714285714,1,0.0,0,3,0,3,4,0,0,1,0,6,5,1
844,9124,0mJoMFAp6vm88Kg6ltLw74tsdf8pNH48,SpATywNh6bZuzm8s1ceuBUnMUAeoAHHw,10,9,3,0,3,0,3,0,18,2.5714285714285716,2,0.0,0,3,0,3,9,0,0,3,0,6,12,0
845,9125,8NRsKZ3hMeinWXhN3qtntd7OTP25jyWY,bWdj2GDclj5ofokWjzoa5jAwMkxCykd6,13,13,6,14,5,0,3,0,41,5.857142857142857,2,0.0,3,6,14,5,10,0,0,3,0,28,13,1
846,9128,bZSiNUbAIuydDBd77IMAJ15Hy6k2A1kT,bWdj2GDclj5ofokWjzoa5jAwMkxCykd6,11,17,10,30,3,6,7,1,74,10.571428571428571,2,0.0,1,10,28,3,16,6,2,7,1,42,32,1
847,9129,x8EozFE9amTkjsgRipu221C7Pejcw9dl,RXDvfPUBYFlVdlueBFbLW0mhhAyGEqpt,37,83,23,18,13,42,48,3,230,32.857142857142854,8,0.0,0,23,17,13,83,42,1,48,3,53,177,1
848,9132,AkJ8njZZaMlqYX3miC2oUBlMGg9ZSm2E,SpATywNh6bZuzm8s1ceuBUnMUAeoAHHw,23,34,0,31,0,9,15,1,90,12.857142857142858,3,0.0,12,0,29,0,22,9,2,15,1,41,49,1
849,9137,rD3x5Ovuza1MLiqkvaHksaL42hepSLSa,A3fsA9Zfv1X2fVEQhTw51lKENdNrEqT3,24,39,19,0,11,5,10,0,84,12.0,4,0.0,3,19,0,11,36,5,0,10,0,33,51,1
850,9145,RFW46IpEEo40HQZmVwQOMd3VcTSwzvKz,SpATywNh6bZuzm8s1ceuBUnMUAeoAHHw,23,67,16,16,3,0,16,0,118,16.857142857142858,7,0.0,20,16,15,3,47,0,1,16,0,54,64,0
851,9147,FTc6jHk7ojdVaEQtsGdTEiSOrQxUe2mX,SpATywNh6bZuzm8s1ceuBUnMUAeoAHHw,7,6,1,0,1,0,1,0,9,1.2857142857142858,1,0.0,0,1,0,1,6,0,0,1,0,2,7,0
852,9148,9DysAmMC3i4TW1eruWnww7wyDSDGRjXp,bWdj2GDclj5ofokWjzoa5jAwMkxCykd6,9,17,11,0,6,0,7,0,41,5.857142857142857,2,0.0,0,11,0,6,17,0,0,7,0,17,24,1
853,9158,DbhhTMdVqWIBI3VwdAesh5LxfMFeyK5c,SpATywNh6bZuzm8s1ceuBUnMUAeoAHHw,7,3,2,0,2,0,2,0,9,1.2857142857142858,1,0.0,0,2,0,2,3,0,0,2,0,4,5,1
854,9163,Hv1gke8Z6oPKIjxv7227ovS4ZRFTrLpp,bWdj2GDclj5ofokWjzoa5jAwMkxCykd6,4,2,1,0,1,0,1,0,5,0.7142857142857143,1,0.0,0,1,0,1,2,0,0,1,0,2,3,1
855,9165,fnvAURpBgndjkYxbDVVMCKsNQuRUMiGS,SpATywNh6bZuzm8s1ceuBUnMUAeoAHHw,20,44,22,0,9,6,18,2,101,14.428571428571429,8,0.0,0,22,0,9,44,6,0,18,2,31,70,0
856,9171,9cDsgjqaFerwqRiPgBxIO3HH5FKzzgdj,RXDvfPUBYFlVdlueBFbLW0mhhAyGEqpt,28,22,19,0,16,2,2,0,61,8.714285714285714,1,0.0,2,19,0,16,20,2,0,2,0,37,24,1
857,9182,aqcsR8SNbfax2wKqSkYdDU8hi71eVqW9,A3fsA9Zfv1X2fVEQhTw51lKENdNrEqT3,7,10,2,0,1,0,4,0,17,2.4285714285714284,1,0.0,1,2,0,1,9,0,0,4,0,4,13,0
858,9202,TnBvipzpsoJKVSP9HO76PUA5bg5zcHA5,SpATywNh6bZuzm8s1ceuBUnMUAeoAHHw,1,0,0,0,0,0,1,0,1,0.14285714285714285,1,0.0,0,0,0,0,0,0,0,1,0,0,1,1
859,9214,cw1zp7V2E9LtJgGgHmRoYt6oelCovAzM,bWdj2GDclj5ofokWjzoa5jAwMkxCykd6,24,40,22,118,6,36,21,2,245,35.0,5,0.0,8,22,112,6,32,36,6,21,2,148,97,1
860,9217,ZWsQt8qxIk0ozpqBcSOvnGxYevyvwXWW,SpATywNh6bZuzm8s1ceuBUnMUAeoAHHw,4,4,0,0,0,0,1,0,5,0.7142857142857143,1,0.0,0,0,0,0,4,0,0,1,0,0,5,1
861,9218,llxTRiluZGftr8xJaXSwJljp3xP1zOiw,SpATywNh6bZuzm8s1ceuBUnMUAeoAHHw,6,3,2,0,2,0,1,0,8,1.1428571428571428,1,0.0,0,2,0,2,3,0,0,1,0,4,4,1
862,9221,DHqQemLc6gAFLZmIcghnnHYSJ9DiwwJJ,A3fsA9Zfv1X2fVEQhTw51lKENdNrEqT3,19,10,3,30,2,1,8,1,55,7.857142857142857,3,0.0,0,3,27,2,10,1,3,8,1,32,23,1
863,9223,DHqQemLc6gAFLZmIcghnnHYSJ9DiwwJJ,G8EPVSXsOYB5YQWZGiz1aVq5Pgr2GrQu,4,2,0,0,0,0,2,0,4,0.5714285714285714,1,0.0,0,0,0,0,2,0,0,2,0,0,4,1
864,9225,bBiJ7ASlGThY8sK9BrJtoHZicOYFZngs,SpATywNh6bZuzm8s1ceuBUnMUAeoAHHw,9,17,0,4,0,0,4,0,25,3.5714285714285716,4,0.0,0,0,3,0,17,0,1,4,0,3,22,1
865,9249,0px3bu53b0JtWfgR2HZboUVCWvKPFWbh,SpATywNh6bZuzm8s1ceuBUnMUAeoAHHw,16,32,0,27,0,2,9,1,71,10.142857142857142,4,0.0,16,0,21,0,16,2,6,9,1,37,34,1
866,9252,9YWFnwknNOzyIUIKR7l51R7vKAyWFRtw,SpATywNh6bZuzm8s1ceuBUnMUAeoAHHw,11,9,6,0,6,1,2,0,24,3.4285714285714284,1,0.0,1,6,0,6,8,1,0,2,0,13,11,1
867,9256,tfcOvcMIVTpughZ66Us0P1WhX9cxijTo,SpATywNh6bZuzm8s1ceuBUnMUAeoAHHw,31,53,31,16,15,8,20,1,144,20.571428571428573,6,0.0,15,31,15,15,38,8,1,20,1,76,68,1
868,9261,QC8X6HHWWr8l8BhOv6dcxn8F38OGn4O4,bWdj2GDclj5ofokWjzoa5jAwMkxCykd6,19,28,12,48,11,8,15,0,122,17.428571428571427,3,0.0,11,12,43,11,17,8,5,15,0,77,45,1
869,9263,cgHFcM0rIMOzMpGf6lXZssDwXCb8l7YM,SpATywNh6bZuzm8s1ceuBUnMUAeoAHHw,27,39,22,12,11,187,34,3,308,44.0,12,0.0,4,22,10,11,35,187,2,34,3,47,261,0
870,9266,9Gijx5H37DPofktlpBMoMZTbguUDFGMv,SpATywNh6bZuzm8s1ceuBUnMUAeoAHHw,31,49,26,14,8,16,18,1,132,18.857142857142858,10,0.0,9,26,13,8,40,16,1,18,1,56,76,0
871,9280,S33pdehUgQXmm7BALY2AI5GkXomITIjp,SpATywNh6bZuzm8s1ceuBUnMUAeoAHHw,10,10,6,0,2,5,13,8,44,6.285714285714286,1,0.0,0,6,0,2,10,5,0,13,8,8,36,1
872,9284,nmePotX0raTb5EFn0d2G6sYKXgcl2u96,SpATywNh6bZuzm8s1ceuBUnMUAeoAHHw,30,33,15,24,7,26,16,1,122,17.428571428571427,4,0.0,12,15,21,7,21,26,3,16,1,55,67,1
873,9300,V2BC6P9m08ZwtWifNk1sABHW864l2OQe,SpATywNh6bZuzm8s1ceuBUnMUAeoAHHw,30,29,13,23,8,0,5,1,79,11.285714285714286,3,0.0,11,13,22,8,18,0,1,5,1,54,25,0
874,9319,7KQcIrOp3KoypOTvziMED7rHtDH1CXtE,bWdj2GDclj5ofokWjzoa5jAwMkxCykd6,14,20,2,34,5,0,4,0,65,9.285714285714286,2,0.0,11,2,29,5,9,0,5,4,0,47,18,1
875,9326,cw1zp7V2E9LtJgGgHmRoYt6oelCovAzM,A3fsA9Zfv1X2fVEQhTw51lKENdNrEqT3,42,59,35,66,12,13,40,2,227,32.42857142857143,6,0.0,9,35,52,12,50,13,14,40,2,108,119,0
876,9331,U5AVDljh153RMBqEeJz3uJoBcMeMiYU5,RXDvfPUBYFlVdlueBFbLW0mhhAyGEqpt,17,24,15,6,8,0,6,0,59,8.428571428571429,5,0.0,2,15,6,8,22,0,0,6,0,31,28,0
877,9337,6W9L2N1NV5yWuM4zWKiNN7jncCdBZXs0,SpATywNh6bZuzm8s1ceuBUnMUAeoAHHw,14,18,1,19,1,0,3,0,42,6.0,2,0.0,3,1,16,1,15,0,3,3,0,21,21,1
878,9348,yh14zaFitCUTgvBPqRXiaZ6cUijtktL4,SpATywNh6bZuzm8s1ceuBUnMUAeoAHHw,10,8,4,0,4,0,3,0,19,2.7142857142857144,2,0.0,0,4,0,4,8,0,0,3,0,8,11,1
879,9359,aR6DmUHNNFHdBeCRliKxXxLUoIhOd6AH,SpATywNh6bZuzm8s1ceuBUnMUAeoAHHw,29,64,22,22,7,45,23,1,184,26.285714285714285,10,0.0,11,22,20,7,53,45,2,23,1,60,124,1
880,9361,8Eqf4bSicFmRziRU1kFgF89C5yGB8WDX,A3fsA9Zfv1X2fVEQhTw51lKENdNrEqT3,66,97,15,120,6,7,76,7,328,46.857142857142854,13,0.0,8,15,112,6,89,7,8,76,7,141,187,0
881,9368,gGSMkNgPdXpBQgdZzyjzifomyCxFSNyt,RXDvfPUBYFlVdlueBFbLW0mhhAyGEqpt,50,99,43,89,23,9,22,1,286,40.857142857142854,7,0.0,13,43,80,23,86,9,9,22,1,159,127,1
882,9373,y94TMklf7UHNxvOoBChAR2OERrGRdiJq,G8EPVSXsOYB5YQWZGiz1aVq5Pgr2GrQu,21,20,6,18,4,0,8,0,56,8.0,2,0.0,9,6,12,4,11,0,6,8,0,31,25,0
883,9385,8fvsCrC8dcOje6DxrGntnTxmufYXJCrq,RXDvfPUBYFlVdlueBFbLW0mhhAyGEqpt,6,4,3,0,1,0,4,0,12,1.7142857142857142,2,0.0,0,3,0,1,4,0,0,4,0,4,8,1
884,9388,67TNJl3Pfj4UvDY0EpzZyKupN8wfhq1l,SpATywNh6bZuzm8s1ceuBUnMUAeoAHHw,18,26,15,14,5,1,22,7,90,12.857142857142858,3,0.0,5,15,13,5,21,1,1,22,7,38,52,1
885,9407,iY3PnTi5AY3h01aMZ0ccsJOuRXfKtImU,SpATywNh6bZuzm8s1ceuBUnMUAeoAHHw,30,57,25,24,10,4,9,0,129,18.428571428571427,4,0.0,22,25,24,10,35,4,0,9,0,81,48,0
886,9412,ZoicU1K1NYxoyDJQjMEMlarFqaZkNBQL,SpATywNh6bZuzm8s1ceuBUnMUAeoAHHw,24,40,4,29,2,0,23,0,98,14.0,7,0.0,5,4,28,2,35,0,1,23,0,39,59,0
887,9413,7LCuPqBIUzStV6rbjpGGsRhhNGaAe94J,G8EPVSXsOYB5YQWZGiz1aVq5Pgr2GrQu,5,2,1,0,1,0,2,0,6,0.8571428571428571,1,0.0,0,1,0,1,2,0,0,2,0,2,4,1
888,9421,mVo6pZlclrtmbfR2GbQ4wq8gZuK7O36S,SpATywNh6bZuzm8s1ceuBUnMUAeoAHHw,29,48,26,27,11,8,5,1,126,18.0,6,0.0,13,26,21,11,35,8,6,5,1,71,55,0
889,9443,mt466qDcj0vZCLdMYFtb42Vnaf84dHao,SpATywNh6bZuzm8s1ceuBUnMUAeoAHHw,32,82,49,24,14,3,50,2,224,32.0,12,0.0,12,49,18,14,70,3,6,50,2,93,131,1
890,9451,3tkFTpynSNaQLF6kINch4bQXEK1IrheG,SpATywNh6bZuzm8s1ceuBUnMUAeoAHHw,29,54,28,25,9,2,16,0,134,19.142857142857142,9,0.0,13,28,20,9,41,2,5,16,0,70,64,0
891,9461,L22HEShRU3FqNfdzTYdzEWxS4vfndGJu,SpATywNh6bZuzm8s1ceuBUnMUAeoAHHw,18,31,1,31,0,19,23,2,107,15.285714285714286,9,0.0,13,1,28,0,18,19,3,23,2,42,65,0
892,9496,lzjn3SIRVbYq5ZVBPCRXRd4xV1z1jylE,SpATywNh6bZuzm8s1ceuBUnMUAeoAHHw,30,69,40,47,16,32,26,0,230,32.857142857142854,8,0.0,15,40,38,16,54,32,9,26,0,109,121,0
893,9498,tNcQJSYfIwP0RRLCMvpsyr5j06z8N8iO,G8EPVSXsOYB5YQWZGiz1aVq5Pgr2GrQu,87,173,23,191,14,68,38,12,519,74.14285714285714,9,0.0,63,23,144,14,110,68,47,38,12,244,275,0
894,9513,onGGlsMh4Ah4OxYC5tqGXHHp3fKlLcL2,RXDvfPUBYFlVdlueBFbLW0mhhAyGEqpt,22,21,15,0,9,0,5,0,50,7.142857142857143,4,0.0,0,15,0,9,21,0,0,5,0,24,26,1
895,9515,FK87Mh9LEgwj1VU4pstPcNLLVrRCTWuM,SpATywNh6bZuzm8s1ceuBUnMUAeoAHHw,31,69,38,30,18,28,15,3,201,28.714285714285715,4,0.0,22,38,30,18,47,28,0,15,3,108,93,0
896,9524,qLAmicSwiz2res8NbViiztvss1lFMGpj,SpATywNh6bZuzm8s1ceuBUnMUAeoAHHw,14,30,6,15,2,1,13,1,68,9.714285714285714,6,0.0,8,6,13,2,22,1,2,13,1,29,39,1
897,9527,zdZzILDgH724BR2ZZqHskjwJPcqfxq36,SpATywNh6bZuzm8s1ceuBUnMUAeoAHHw,1,0,0,0,0,0,1,0,1,0.14285714285714285,1,0.0,0,0,0,0,0,0,0,1,0,0,1,1
898,9531,KwyWbYzWCyNQryHYqWYU5PuARebCENlh,SpATywNh6bZuzm8s1ceuBUnMUAeoAHHw,23,27,15,3,9,0,11,0,65,9.285714285714286,5,0.0,5,15,3,9,22,0,0,11,0,32,33,0
899,9554,qLhvnFj4NLk8zjpoDXsgy2yaKup2la0b,SpATywNh6bZuzm8s1ceuBUnMUAeoAHHw,8,9,3,0,2,0,1,0,15,2.142857142857143,1,0.0,0,3,0,2,9,0,0,1,0,5,10,1
900,9561,CS0wlcwiXBGjNBCCxbQaVvPkChe2nnOH,SpATywNh6bZuzm8s1ceuBUnMUAeoAHHw,4,2,1,0,1,0,1,0,5,0.7142857142857143,1,0.0,0,1,0,1,2,0,0,1,0,2,3,1
901,9562,ELMHLkq0bytqwO03zO0z2h1fRq8v5uwM,RXDvfPUBYFlVdlueBFbLW0mhhAyGEqpt,6,7,0,0,0,0,2,0,9,1.2857142857142858,1,0.0,0,0,0,0,7,0,0,2,0,0,9,0
902,9570,kRNs7iQ9Dcre5KLj8rtojE3fVWuqCtop,SpATywNh6bZuzm8s1ceuBUnMUAeoAHHw,24,31,3,26,0,2,14,2,78,11.142857142857142,2,0.0,11,3,25,0,20,2,1,14,2,39,39,0
903,9576,8L1ZpuGtJGJkgFF34DS0HYPQNaVRqmzv,G8EPVSXsOYB5YQWZGiz1aVq5Pgr2GrQu,7,1,1,0,1,1,5,1,10,1.4285714285714286,1,0.0,0,1,0,1,1,1,0,5,1,2,8,1
904,9583,InTDVHpDSVoZu5vOSvueBLdJOgZb9Qu8,bWdj2GDclj5ofokWjzoa5jAwMkxCykd6,12,18,9,14,4,4,6,0,55,7.857142857142857,2,0.0,4,9,12,4,14,4,2,6,0,29,26,0
905,9589,oJ9j9ejTgKixczg3tSE8Sg8DPI7YQpJq,A3fsA9Zfv1X2fVEQhTw51lKENdNrEqT3,16,21,15,0,7,1,8,1,53,7.571428571428571,3,0.0,1,15,0,7,20,1,0,8,1,23,30,0
906,9596,8fvsCrC8dcOje6DxrGntnTxmufYXJCrq,G8EPVSXsOYB5YQWZGiz1aVq5Pgr2GrQu,2,0,0,0,0,0,3,0,3,0.42857142857142855,2,0.0,0,0,0,0,0,0,0,3,0,0,3,1
907,9597,op6fYsDSJ7UTrHBvFtSBIo32ykj3vZlc,SpATywNh6bZuzm8s1ceuBUnMUAeoAHHw,23,50,8,29,2,35,28,1,153,21.857142857142858,9,0.0,17,8,25,2,33,35,4,28,1,52,101,0
908,9601,op6fYsDSJ7UTrHBvFtSBIo32ykj3vZlc,A3fsA9Zfv1X2fVEQhTw51lKENdNrEqT3,4,2,2,0,0,0,4,0,8,1.1428571428571428,2,0.0,0,2,0,0,2,0,0,4,0,2,6,1
909,9602,op6fYsDSJ7UTrHBvFtSBIo32ykj3vZlc,bWdj2GDclj5ofokWjzoa5jAwMkxCykd6,4,2,1,0,0,0,11,0,14,2.0,6,0.0,1,1,0,0,1,0,0,11,0,2,12,1
910,9626,foCA7ZrrJkil1q7yKxvukoHCZEz5fz8N,bWdj2GDclj5ofokWjzoa5jAwMkxCykd6,27,68,2,98,3,0,15,0,186,26.571428571428573,5,0.0,18,2,93,3,50,0,5,15,0,116,70,0
911,9629,RMdVVE71rvbt2Qm5k09H4IClAre95rfd,SpATywNh6bZuzm8s1ceuBUnMUAeoAHHw,7,2,1,0,1,1,5,1,11,1.5714285714285714,1,0.0,0,1,0,1,2,1,0,5,1,2,9,1
912,9631,ZkR2H9b56Jhek553JSEuRtj1fnuwaa03,SpATywNh6bZuzm8s1ceuBUnMUAeoAHHw,1,0,0,0,0,0,1,0,1,0.14285714285714285,1,0.0,0,0,0,0,0,0,0,1,0,0,1,1
913,9646,op6fYsDSJ7UTrHBvFtSBIo32ykj3vZlc,G8EPVSXsOYB5YQWZGiz1aVq5Pgr2GrQu,1,0,0,0,0,0,1,0,1,0.14285714285714285,1,0.0,0,0,0,0,0,0,0,1,0,0,1,1
914,9647,bPCZpicN2hhnN8uELNOuVf328EONwoA2,SpATywNh6bZuzm8s1ceuBUnMUAeoAHHw,15,46,17,4,3,2,21,2,95,13.571428571428571,5,0.0,23,17,4,3,23,2,0,21,2,47,48,1
915,9649,EH4LxHwYpFQLq5kesgWPY21JUpYpymba,SpATywNh6bZuzm8s1ceuBUnMUAeoAHHw,1,0,0,0,0,0,1,0,1,0.14285714285714285,1,0.0,0,0,0,0,0,0,0,1,0,0,1,1
916,9654,EH4LxHwYpFQLq5kesgWPY21JUpYpymba,A3fsA9Zfv1X2fVEQhTw51lKENdNrEqT3,1,0,0,0,0,0,1,0,1,0.14285714285714285,1,0.0,0,0,0,0,0,0,0,1,0,0,1,1
917,9662,tRu7kc3B7i0xOP4FswhcDsdZx5KznD0T,SpATywNh6bZuzm8s1ceuBUnMUAeoAHHw,16,50,12,9,7,0,7,0,85,12.142857142857142,5,0.0,7,12,9,7,43,0,0,7,0,35,50,0
918,9673,Bi4hHmeTLwTbUCScu9tC6ZZN7frLUhVP,bWdj2GDclj5ofokWjzoa5jAwMkxCykd6,51,55,33,94,18,8,23,1,232,33.142857142857146,4,0.0,12,33,91,18,43,8,3,23,1,154,78,0
919,9684,LdhLlSD36AR268yKf0v6JE8vG5XYPHSF,RXDvfPUBYFlVdlueBFbLW0mhhAyGEqpt,65,128,27,125,26,11,19,2,338,48.285714285714285,6,0.0,46,27,115,26,82,11,10,19,2,214,124,0
920,9707,5GS5OD1cmKWecEPymf3UVauvWYXb9WHE,SpATywNh6bZuzm8s1ceuBUnMUAeoAHHw,8,12,3,0,1,0,5,0,21,3.0,2,0.0,3,3,0,1,9,0,0,5,0,7,14,0
921,9713,KFNYz6Dhe7c7sjFmDdHR2V6Cj3vv7anD,SpATywNh6bZuzm8s1ceuBUnMUAeoAHHw,27,20,10,28,5,0,14,1,78,11.142857142857142,2,0.0,8,10,24,5,12,0,4,14,1,47,31,1
922,9718,0dBn4alo7QBTd62VD5XO0yNMbQ5QN2OQ,A3fsA9Zfv1X2fVEQhTw51lKENdNrEqT3,38,56,16,64,6,0,5,0,147,21.0,3,0.0,2,16,61,6,54,0,3,5,0,85,62,0
923,9719,STRzNG5Wp366HphlQVfWFRMC5QrerXCb,SpATywNh6bZuzm8s1ceuBUnMUAeoAHHw,24,57,19,10,11,0,5,0,102,14.571428571428571,4,0.0,3,19,10,11,54,0,0,5,0,43,59,0
924,9735,gL9bGH4cIhlV7ZeZxNKPKl7YRjV9LvBk,bWdj2GDclj5ofokWjzoa5jAwMkxCykd6,8,7,2,94,1,0,5,0,109,15.571428571428571,2,0.0,1,2,92,1,6,0,2,5,0,96,13,1
925,9745,ITkxDxE80MnM3R1P6Tny4qeXU1QIqBHa,bWdj2GDclj5ofokWjzoa5jAwMkxCykd6,25,38,22,38,11,78,22,2,211,30.142857142857142,6,0.0,8,22,34,11,30,78,4,22,2,75,136,1
926,9754,UhHoLs8knx0jlEPi8SMFvlBmI0lPgR6y,SpATywNh6bZuzm8s1ceuBUnMUAeoAHHw,20,51,1,12,2,15,23,2,106,15.142857142857142,9,0.0,14,1,11,2,37,15,1,23,2,28,78,1
927,9770,Z719Tc3zuVfTrBRe6VKkZp0coC11gNCc,SpATywNh6bZuzm8s1ceuBUnMUAeoAHHw,9,22,13,0,10,0,1,0,46,6.571428571428571,6,0.0,0,13,0,10,22,0,0,1,0,23,23,1
928,9785,gm1mCfFqKN0eTkg2YXDowzQf6xnuANVZ,SpATywNh6bZuzm8s1ceuBUnMUAeoAHHw,15,36,1,12,1,2,9,0,61,8.714285714285714,2,0.0,17,1,12,1,19,2,0,9,0,31,30,1
929,9786,LcO86mxxL8cZOPJBDybTSOoI4LZ5qE2M,SpATywNh6bZuzm8s1ceuBUnMUAeoAHHw,18,35,24,0,16,0,5,0,80,11.428571428571429,5,0.0,0,24,0,16,35,0,0,5,0,40,40,0
930,9787,EYniy2nQGNpFME0mRi8PdZNA2QjnXIxY,RXDvfPUBYFlVdlueBFbLW0mhhAyGEqpt,61,119,1,159,7,10,22,3,321,45.857142857142854,5,0.0,31,1,149,7,88,10,10,22,3,188,133,0
931,9792,M7EQ6UxOsXQjbu4WIJCWam7cgbYToC2D,bWdj2GDclj5ofokWjzoa5jAwMkxCykd6,1,0,0,0,0,0,1,0,1,0.14285714285714285,1,0.0,0,0,0,0,0,0,0,1,0,0,1,1
932,9799,oIeIfwhQt9r1G6uZ62W7p7DLvDQ1KzcN,SpATywNh6bZuzm8s1ceuBUnMUAeoAHHw,4,0,0,0,0,0,4,1,5,0.7142857142857143,1,0.0,0,0,0,0,0,0,0,4,1,0,5,0
933,9806,q0a8XSQyj8ok2HbWv28MubA9x20SFg4i,SpATywNh6bZuzm8s1ceuBUnMUAeoAHHw,20,26,4,12,5,0,21,0,68,9.714285714285714,5,0.0,2,4,10,5,24,0,2,21,0,21,47,0
934,9820,aHRdc7lsBBp8F9aMkgntONfsLpIf0i6y,SpATywNh6bZuzm8s1ceuBUnMUAeoAHHw,28,33,16,37,8,0,9,0,103,14.714285714285714,3,0.0,12,16,35,8,21,0,2,9,0,71,32,0
935,9833,31jhVyZsYwM3i4SgxR1MFYrhxZjgzlJ8,SpATywNh6bZuzm8s1ceuBUnMUAeoAHHw,27,30,17,38,10,2,7,0,104,14.857142857142858,4,0.0,7,17,31,10,23,2,7,7,0,65,39,0
936,9834,SVcpJb6gXZcQDuOEWDQYFqv2P86R1Xaj,A3fsA9Zfv1X2fVEQhTw51lKENdNrEqT3,16,7,6,0,4,4,11,1,33,4.714285714285714,2,0.0,0,6,0,4,7,4,0,11,1,10,23,1
937,9835,a9OOTcAZgZGDa68djsRaJXsHoRuNVOvz,SpATywNh6bZuzm8s1ceuBUnMUAeoAHHw,30,130,72,33,15,83,43,3,379,54.142857142857146,11,0.0,16,72,27,15,114,83,6,43,3,130,249,1
938,9836,nknXXbQsC6Q6nMDyRKc0MDJZg6KtAXBE,SpATywNh6bZuzm8s1ceuBUnMUAeoAHHw,28,73,32,18,9,9,12,0,153,21.857142857142858,9,0.0,27,32,16,9,46,9,2,12,0,84,69,0
939,9842,MVF65xcT9c1o85EvDPizEzpYwxjeii1v,SpATywNh6bZuzm8s1ceuBUnMUAeoAHHw,26,64,8,35,1,7,23,1,139,19.857142857142858,6,0.0,9,8,30,1,55,7,5,23,1,48,91,1
940,9857,qDhyxHmDfIFLWQlPUBxWy3YNuv335dWU,SpATywNh6bZuzm8s1ceuBUnMUAeoAHHw,15,44,18,8,8,15,11,0,104,14.857142857142858,7,0.0,8,18,8,8,36,15,0,11,0,42,62,0
941,9866,0KmXUOal7sGDR9cJbaeaj8aaBpdVW5sk,bWdj2GDclj5ofokWjzoa5jAwMkxCykd6,6,6,2,0,1,0,6,0,15,2.142857142857143,2,0.0,0,2,0,1,6,0,0,6,0,3,12,1
942,9867,Cv6IwnmHzYzI7Znom4eT6Rs7brgvVn5U,SpATywNh6bZuzm8s1ceuBUnMUAeoAHHw,7,10,2,0,1,0,3,0,16,2.2857142857142856,2,0.0,0,2,0,1,10,0,0,3,0,3,13,1
943,9874,mZIaM3Lmux7GERtSm258BKPOSUYFlwyy,SpATywNh6bZuzm8s1ceuBUnMUAeoAHHw,31,64,21,32,7,12,21,1,158,22.571428571428573,8,0.0,19,21,30,7,45,12,2,21,1,77,81,0
944,9878,iw5QtMAk2wyMi9Kh4hTv1WAFOj2rnxVj,SpATywNh6bZuzm8s1ceuBUnMUAeoAHHw,19,22,4,17,2,0,7,2,54,7.714285714285714,4,0.0,3,4,16,2,19,0,1,7,2,25,29,0
945,9894,MarhO8rhsTXcbFpvat4mcEiSQvbAftxM,SpATywNh6bZuzm8s1ceuBUnMUAeoAHHw,2,0,0,0,0,0,2,0,2,0.2857142857142857,2,0.0,0,0,0,0,0,0,0,2,0,0,2,1
946,9896,47Lhswr4ZfAxhCMxQ5kAgIIaZKdQ7ZYE,SpATywNh6bZuzm8s1ceuBUnMUAeoAHHw,23,60,21,34,6,99,24,1,245,35.0,6,0.0,15,21,28,6,45,99,6,24,1,70,175,0
947,9903,wHRp5VFhSRE1ez0DDg63jhbDbNE6ujgu,bWdj2GDclj5ofokWjzoa5jAwMkxCykd6,1,0,0,0,0,0,2,0,2,0.2857142857142857,2,0.0,0,0,0,0,0,0,0,2,0,0,2,1
948,9910,FUkw8gvbqykqbH4tdSuG6VwP03f4pQvB,SpATywNh6bZuzm8s1ceuBUnMUAeoAHHw,31,48,26,15,12,1,16,0,118,16.857142857142858,9,0.0,13,26,15,12,35,1,0,16,0,66,52,0
949,9911,Jd5OP6GIsguRdsq9k3eSYNENmzhPbdGe,bWdj2GDclj5ofokWjzoa5jAwMkxCykd6,9,18,8,0,2,0,10,0,38,5.428571428571429,6,0.0,2,8,0,2,16,0,0,10,0,12,26,1
950,9916,CJe4pjtrcC0FOMy3krEkccqFJZO0Cqq4,RXDvfPUBYFlVdlueBFbLW0mhhAyGEqpt,34,54,15,68,3,69,40,21,270,38.57142857142857,5,0.0,14,15,59,3,40,69,9,40,21,91,179,1
951,9919,YwojqO58bCgaotjJoOTtpKH2oiEFOZyB,SpATywNh6bZuzm8s1ceuBUnMUAeoAHHw,19,18,10,21,7,0,6,0,62,8.857142857142858,2,0.0,6,10,18,7,12,0,3,6,0,41,21,1
952,9921,Mv7oSGs75OaCjYLhHCNmqqrqaAjjO5gs,RXDvfPUBYFlVdlueBFbLW0mhhAyGEqpt,57,148,17,149,14,13,38,10,389,55.57142857142857,10,0.0,35,17,134,14,113,13,15,38,10,200,189,1
953,9926,TgheOgj9khTgshxaHKtqDHWb3smGHeUA,SpATywNh6bZuzm8s1ceuBUnMUAeoAHHw,22,21,2,18,0,1,9,1,52,7.428571428571429,2,0.0,6,2,16,0,15,1,2,9,1,24,28,1
954,9937,lZ58Ty5L7QhiK80QjmlI7dd3eLrrNLr0,A3fsA9Zfv1X2fVEQhTw51lKENdNrEqT3,7,3,2,0,2,0,3,0,10,1.4285714285714286,1,0.0,0,2,0,2,3,0,0,3,0,4,6,1
955,9944,IUn6MADAjAYkGlJisA1WiDvCeNlJd5Xd,G8EPVSXsOYB5YQWZGiz1aVq5Pgr2GrQu,85,96,34,137,20,0,8,0,295,42.142857142857146,13,0.0,47,34,91,20,49,0,46,8,0,192,103,1
956,9945,5NIu7B9o5GAsLAdx3xyl9xnxkK6Z7Hn1,SpATywNh6bZuzm8s1ceuBUnMUAeoAHHw,1,0,0,0,0,0,1,0,1,0.14285714285714285,1,0.0,0,0,0,0,0,0,0,1,0,0,1,1
957,9965,XL8OObjZsaGHAKex6gNHyGuTbyi42iwz,SpATywNh6bZuzm8s1ceuBUnMUAeoAHHw,24,66,0,23,1,39,17,6,152,21.714285714285715,4,0.0,26,0,21,1,40,39,2,17,6,48,104,1
958,9973,pqAmXCZ0vs0c5YNrZSPIZNZIkmuJCMBN,RXDvfPUBYFlVdlueBFbLW0mhhAyGEqpt,71,58,39,181,19,43,18,5,363,51.857142857142854,7,0.0,12,39,167,19,46,43,14,18,5,237,126,0
959,9986,hM3OejyZim6cDpiFQsjtqNuKMzh1dYaY,SpATywNh6bZuzm8s1ceuBUnMUAeoAHHw,12,11,0,24,0,0,4,0,39,5.571428571428571,2,0.0,2,0,20,0,9,0,4,4,0,22,17,1
960,9989,GVRJN4wkoooaXJUVmwnX983A87KsrZPK,A3fsA9Zfv1X2fVEQhTw51lKENdNrEqT3,51,31,17,110,6,10,14,0,188,26.857142857142858,8,0.0,7,17,96,6,24,10,14,14,0,126,62,0
961,9993,oThgY0TV97t9DlLv4WWVQ93RXTQBQvf5,SpATywNh6bZuzm8s1ceuBUnMUAeoAHHw,1,0,0,0,0,0,2,0,2,0.2857142857142857,1,0.0,0,0,0,0,0,0,0,2,0,0,2,1
962,10001,vsk33lNJbFXN2L68Y5R9TSkfONwNMOQ8,SpATywNh6bZuzm8s1ceuBUnMUAeoAHHw,27,53,18,30,6,92,22,6,227,32.42857142857143,6,0.0,21,18,26,6,32,92,4,22,6,71,156,0
963,10002,HjIrUt1Ax8b3fBkdKQupL2gDMbKYgLrZ,bWdj2GDclj5ofokWjzoa5jAwMkxCykd6,5,5,3,0,2,0,2,0,12,1.7142857142857142,2,0.0,0,3,0,2,5,0,0,2,0,5,7,1
964,10011,gGIYUaDzHtuVAdLHD7FaG5z9ih7s8ZFV,SpATywNh6bZuzm8s1ceuBUnMUAeoAHHw,6,1,1,0,1,0,3,1,7,1.0,1,0.0,0,1,0,1,1,0,0,3,1,2,5,1
965,10012,vqSgORDp5PsEpveQVJoPh4dnJvR6AQkK,RXDvfPUBYFlVdlueBFbLW0mhhAyGEqpt,68,105,64,106,26,52,30,1,384,54.857142857142854,11,0.0,20,64,99,26,85,52,7,30,1,209,175,0
966,10013,NYNmhRIaW3AmhvVQt7ReXvH6yAc7z73U,RXDvfPUBYFlVdlueBFbLW0mhhAyGEqpt,7,24,12,0,0,131,35,5,207,29.571428571428573,7,0.0,0,12,0,0,24,131,0,35,5,12,195,1
967,10021,oX8Y4icCGan10HVW1mtOWEP3pxrvK1WZ,RXDvfPUBYFlVdlueBFbLW0mhhAyGEqpt,39,53,33,47,8,156,15,5,317,45.285714285714285,5,0.0,8,33,46,8,45,156,1,15,5,95,222,0
968,10029,sdNkCaSqYSgtx1tSTEHqB38WFlBnpR89,SpATywNh6bZuzm8s1ceuBUnMUAeoAHHw,16,17,11,5,6,0,5,0,44,6.285714285714286,1,0.0,4,11,4,6,13,0,1,5,0,25,19,1
969,10036,M0OuzdgM82B7CvwoM2EBQihSEuKyfCoB,G8EPVSXsOYB5YQWZGiz1aVq5Pgr2GrQu,16,7,1,26,1,3,16,0,54,7.714285714285714,2,0.0,0,1,22,1,7,3,4,16,0,24,30,1
970,10042,RCWIrGGQZDVLNIofIMbc1GdSrqA961jg,RXDvfPUBYFlVdlueBFbLW0mhhAyGEqpt,23,48,28,4,4,246,68,4,402,57.42857142857143,7,0.0,3,28,3,4,45,246,1,68,4,38,364,1
971,10044,Wigd4PnyDnjfDcFOxsTBcEnXo7kl9GSg,bWdj2GDclj5ofokWjzoa5jAwMkxCykd6,21,91,26,74,8,22,28,0,249,35.57142857142857,5,0.0,15,26,69,8,76,22,5,28,0,118,131,1
972,10048,X8GmwqDtWUFSMSOGWtivlDRmblWXusTi,SpATywNh6bZuzm8s1ceuBUnMUAeoAHHw,13,13,9,7,3,12,8,0,52,7.428571428571429,4,0.0,2,9,7,3,11,12,0,8,0,21,31,0
973,10065,GV5J9MUmZdHez5d6vsAQtSAbOI4jKQlj,bWdj2GDclj5ofokWjzoa5jAwMkxCykd6,40,71,41,162,19,50,25,2,370,52.857142857142854,4,0.0,11,41,138,19,60,50,24,25,2,209,161,0
974,10067,IkfMHDVbFGQIQxWjHsEqTwjNnrBCaA7O,SpATywNh6bZuzm8s1ceuBUnMUAeoAHHw,31,101,44,27,15,43,30,1,261,37.285714285714285,11,0.0,20,44,26,15,81,43,1,30,1,105,156,0
975,10068,GV5J9MUmZdHez5d6vsAQtSAbOI4jKQlj,A3fsA9Zfv1X2fVEQhTw51lKENdNrEqT3,12,8,5,0,2,0,7,0,22,3.142857142857143,3,0.0,0,5,0,2,8,0,0,7,0,7,15,1
976,10069,EdSyqy374rFTTRmoH6AfOLgRNsPjxdOm,A3fsA9Zfv1X2fVEQhTw51lKENdNrEqT3,19,14,10,0,6,0,6,0,36,5.142857142857143,2,0.0,0,10,0,6,14,0,0,6,0,16,20,1
977,10070,FkxhG6zHFqigfK7M5JQhv4MT6lPE3kxN,RXDvfPUBYFlVdlueBFbLW0mhhAyGEqpt,68,125,79,171,43,6,22,18,464,66.28571428571429,10,0.0,24,79,155,43,101,6,16,22,18,301,163,0
978,10071,ivII4h55QUeXOce5qbbvWPv1IAJ1FXtO,SpATywNh6bZuzm8s1ceuBUnMUAeoAHHw,17,22,1,18,0,0,8,0,49,7.0,1,0.0,7,1,17,0,15,0,1,8,0,25,24,1
979,10073,3VQVtsFphnOA3h1KWYRcAEMgfViLsPnF,A3fsA9Zfv1X2fVEQhTw51lKENdNrEqT3,15,40,1,0,4,0,6,0,51,7.285714285714286,4,0.0,5,1,0,4,35,0,0,6,0,10,41,1
980,10075,EdSyqy374rFTTRmoH6AfOLgRNsPjxdOm,bWdj2GDclj5ofokWjzoa5jAwMkxCykd6,8,11,7,0,4,0,4,0,26,3.7142857142857144,3,0.0,1,7,0,4,10,0,0,4,0,12,14,1
981,10081,2LiXT3Fppj80YAOl6K8p0HtAK0LHy6KG,SpATywNh6bZuzm8s1ceuBUnMUAeoAHHw,28,35,24,22,13,6,13,0,113,16.142857142857142,5,0.0,7,24,22,13,28,6,0,13,0,66,47,0
982,10095,JQVJEgOcL8lOPq9QqGxWJ7NUVC20wQ1o,SpATywNh6bZuzm8s1ceuBUnMUAeoAHHw,31,50,25,44,12,5,12,1,149,21.285714285714285,4,0.0,17,25,37,12,33,5,7,12,1,91,58,0
983,10112,D1iAkJgGLDV90w339eOp4Bqd5z6wvBY6,bWdj2GDclj5ofokWjzoa5jAwMkxCykd6,1,0,0,0,0,0,1,0,1,0.14285714285714285,1,0.0,0,0,0,0,0,0,0,1,0,0,1,1
984,10114,D1iAkJgGLDV90w339eOp4Bqd5z6wvBY6,A3fsA9Zfv1X2fVEQhTw51lKENdNrEqT3,1,0,0,0,0,0,1,0,1,0.14285714285714285,1,0.0,0,0,0,0,0,0,0,1,0,0,1,1
985,10119,8IVnhzyRJrPiaCjSSJli9bG8p44dgy3T,SpATywNh6bZuzm8s1ceuBUnMUAeoAHHw,14,18,7,0,5,0,6,0,36,5.142857142857143,2,0.0,1,7,0,5,17,0,0,6,0,13,23,1
986,10120,9Dm5yt1s5sm1v7MbrzCfMpw138AkercO,RXDvfPUBYFlVdlueBFbLW0mhhAyGEqpt,44,38,24,105,18,41,14,5,245,35.0,3,0.0,13,24,98,18,25,41,7,14,5,153,92,0
987,10122,NiXPZUmEILmWUPwXexYxtHvaIL7QdjCQ,RXDvfPUBYFlVdlueBFbLW0mhhAyGEqpt,68,88,53,92,20,84,28,13,378,54.0,10,0.0,18,53,87,20,70,84,5,28,13,178,200,0
988,10129,7rP408Gy6dVEeyQ5Me3hr5GFRnqOotmL,A3fsA9Zfv1X2fVEQhTw51lKENdNrEqT3,12,10,6,0,5,0,9,1,31,4.428571428571429,1,0.0,2,6,0,5,8,0,0,9,1,13,18,1
989,10130,u3iTsADy3VjWLwiWIPabdGKGPi8ZLAbJ,SpATywNh6bZuzm8s1ceuBUnMUAeoAHHw,12,15,3,0,2,0,7,0,27,3.857142857142857,4,0.0,0,3,0,2,15,0,0,7,0,5,22,0
990,10137,CUHsvexAAfaCEMKsM3644JTxXL5DgSss,bWdj2GDclj5ofokWjzoa5jAwMkxCykd6,4,2,1,0,1,0,1,0,5,0.7142857142857143,1,0.0,0,1,0,1,2,0,0,1,0,2,3,1
991,10147,ng7eSUGwAsEpodxFM2MoBV45uXU9cRkh,SpATywNh6bZuzm8s1ceuBUnMUAeoAHHw,23,30,11,15,6,0,5,0,67,9.571428571428571,2,0.0,10,11,14,6,20,0,1,5,0,41,26,1
992,10161,n4cJEUTWqAxTpul10x8ZDTmIRIbytL0a,SpATywNh6bZuzm8s1ceuBUnMUAeoAHHw,31,58,20,38,8,4,13,1,142,20.285714285714285,6,0.0,24,20,35,8,34,4,3,13,1,87,55,1
993,10164,w7s7CbDlE2P2RGY2w8kEYH9keSavEsec,A3fsA9Zfv1X2fVEQhTw51lKENdNrEqT3,8,6,3,0,2,0,4,0,15,2.142857142857143,3,0.0,0,3,0,2,6,0,0,4,0,5,10,1
994,10165,PzZ2nmySEoPT9qSsl3Z3wqf8hhgEC7RR,bWdj2GDclj5ofokWjzoa5jAwMkxCykd6,10,12,2,0,3,0,7,2,26,3.7142857142857144,3,0.0,4,2,0,3,8,0,0,7,2,9,17,1
995,10171,IceoOG9Um0Dwn1hM2FcjjE3CJhGCpTrp,SpATywNh6bZuzm8s1ceuBUnMUAeoAHHw,1,0,0,0,0,0,1,0,1,0.14285714285714285,1,0.0,0,0,0,0,0,0,0,1,0,0,1,1
996,10190,h81tMgwEiasc4dN2MBVSIam9UKAPfs93,A3fsA9Zfv1X2fVEQhTw51lKENdNrEqT3,34,56,6,74,1,0,7,0,144,20.571428571428573,5,0.0,9,6,59,1,47,0,15,7,0,75,69,0
997,10193,T6JL6sNT8M40gVvb059fgHfBQIftQwIF,SpATywNh6bZuzm8s1ceuBUnMUAeoAHHw,24,89,38,26,0,3,35,0,191,27.285714285714285,11,0.0,34,38,23,0,55,3,3,35,0,95,96,1
998,10200,Sb9hMB1NLdfMmS0ToFmgrY6MZEZ6TYgo,SpATywNh6bZuzm8s1ceuBUnMUAeoAHHw,30,55,22,26,10,3,10,1,127,18.142857142857142,5,0.0,20,22,22,10,35,3,4,10,1,74,53,0
999,10202,BiB7jdHiaAHugRlYDLxmiYyQzifAAliU,SpATywNh6bZuzm8s1ceuBUnMUAeoAHHw,12,34,16,0,3,1,15,1,70,10.0,3,0.0,2,16,0,3,32,1,0,15,1,21,49,1
1000,10204,nJbKKV1iJX5hAlKTzoiNMNIkB5aNJcfW,G8EPVSXsOYB5YQWZGiz1aVq5Pgr2GrQu,44,56,36,40,16,2,20,3,173,24.714285714285715,6,0.0,0,36,37,16,56,2,3,20,3,89,84,0
1001,10207,Qf6P6bxCyzplkdXIQa3YsHmpzfUnMGYL,SpATywNh6bZuzm8s1ceuBUnMUAeoAHHw,24,60,27,11,14,3,23,4,142,20.285714285714285,6,0.0,13,27,11,14,47,3,0,23,4,65,77,0
1002,10210,qVH2miiWM8Lf3bY2iypzRXLuMojA4gKB,SpATywNh6bZuzm8s1ceuBUnMUAeoAHHw,26,23,15,15,9,3,8,1,74,10.571428571428571,3,0.0,5,15,12,9,18,3,3,8,1,41,33,1
1003,10212,IKkLcanOfBFv8w6vw2fYzBwzbCJQZq5m,SpATywNh6bZuzm8s1ceuBUnMUAeoAHHw,23,27,12,12,7,9,7,1,75,10.714285714285714,2,0.0,4,12,12,7,23,9,0,7,1,35,40,0
1004,10214,X71Zy6g4fufrJXrIbNfXtlVdtViubQUc,G8EPVSXsOYB5YQWZGiz1aVq5Pgr2GrQu,5,6,1,0,3,0,2,0,12,1.7142857142857142,1,0.0,3,1,0,3,3,0,0,2,0,7,5,1
1005,10218,JN0hu6OtICcRlrPNS3Zt5hNT8ffEQP2J,bWdj2GDclj5ofokWjzoa5jAwMkxCykd6,12,29,12,0,5,1,12,1,60,8.571428571428571,2,0.0,2,12,0,5,27,1,0,12,1,19,41,1
1006,10227,SnivjdMp3HL6G23yPscSnzZlAD2Rbyt6,A3fsA9Zfv1X2fVEQhTw51lKENdNrEqT3,57,28,18,124,10,0,6,0,186,26.571428571428573,4,0.0,4,18,110,10,24,0,14,6,0,142,44,0
1007,10230,X9IfBkBBoI1jhyhTI5cK6hEB3eMT1rI2,SpATywNh6bZuzm8s1ceuBUnMUAeoAHHw,22,49,28,23,0,84,12,0,196,28.0,4,0.0,15,28,21,0,34,84,2,12,0,64,132,0
1008,10232,zXzBBpTV9epJ0NK0fVVhqGAiB4MQXdB4,SpATywNh6bZuzm8s1ceuBUnMUAeoAHHw,31,38,21,18,9,18,20,1,125,17.857142857142858,6,0.0,9,21,18,9,29,18,0,20,1,57,68,0
1009,10236,zMsdFc2bNoJ6urVmU6g31AhzZMFpCEEM,SpATywNh6bZuzm8s1ceuBUnMUAeoAHHw,16,14,1,19,1,0,6,1,42,6.0,3,0.0,2,1,16,1,12,0,3,6,1,20,22,1
1010,10244,5gwirWhcaVB1Z2yy4RRslODx7MsCrRca,SpATywNh6bZuzm8s1ceuBUnMUAeoAHHw,30,54,28,38,13,16,16,2,167,23.857142857142858,5,0.0,15,28,34,13,39,16,4,16,2,90,77,0
1011,10250,GhXXCYV4l3r313zlwGPyJpPeGLc4qMAC,bWdj2GDclj5ofokWjzoa5jAwMkxCykd6,8,3,2,0,2,0,3,0,10,1.4285714285714286,1,0.0,0,2,0,2,3,0,0,3,0,4,6,1
1012,10263,Gy6MuuTSUxAvObvL74Ev0uen9bQJO61p,SpATywNh6bZuzm8s1ceuBUnMUAeoAHHw,7,5,3,0,3,1,8,3,23,3.2857142857142856,2,0.0,0,3,0,3,5,1,0,8,3,6,17,1
1013,10271,1kFTVSLESXiimtERcEyClh5CUMgpZbSa,SpATywNh6bZuzm8s1ceuBUnMUAeoAHHw,26,48,19,27,9,12,16,4,135,19.285714285714285,3,0.0,16,19,27,9,32,12,0,16,4,71,64,0
1014,10276,6pYrzEgLAB7Gx24u5Kn0l64uyJLXY41J,SpATywNh6bZuzm8s1ceuBUnMUAeoAHHw,3,0,0,0,0,0,11,0,11,1.5714285714285714,4,0.0,0,0,0,0,0,0,0,11,0,0,11,0
1015,10280,dtlGqEkxytgl4rvxvygVAnxqgcqdYicp,SpATywNh6bZuzm8s1ceuBUnMUAeoAHHw,28,54,13,20,8,6,13,0,114,16.285714285714285,7,0.0,7,13,19,8,47,6,1,13,0,47,67,0
1016,10289,83H2FVc0DUlyPpMlZsbpGsFQRMFc6fan,SpATywNh6bZuzm8s1ceuBUnMUAeoAHHw,15,14,12,6,6,0,4,0,42,6.0,2,0.0,0,12,5,6,14,0,1,4,0,23,19,0
1017,10307,ZBhV1m5APkbtG3EQZyk5pMZqkJsFLe6t,SpATywNh6bZuzm8s1ceuBUnMUAeoAHHw,9,25,16,0,11,1,11,0,64,9.142857142857142,3,0.0,1,16,0,11,24,1,0,11,0,28,36,1
1018,10310,nTUP3gEuwVy2Io3TzQXGmuh9VvJxgHk3,bWdj2GDclj5ofokWjzoa5jAwMkxCykd6,18,35,19,90,5,27,4,0,180,25.714285714285715,3,0.0,3,19,86,5,32,27,4,4,0,113,67,1
1019,10328,GSkYUOcl4XzYMWSWhE6gXRGQ9kqPeXsi,SpATywNh6bZuzm8s1ceuBUnMUAeoAHHw,30,41,21,32,9,1,15,0,119,17.0,6,0.0,12,21,29,9,29,1,3,15,0,71,48,0
1020,10340,afCicX2FGCc7YS72xtNmCsPkAgJ0p3xk,SpATywNh6bZuzm8s1ceuBUnMUAeoAHHw,5,2,0,0,0,0,7,0,9,1.2857142857142858,1,0.0,0,0,0,0,2,0,0,7,0,0,9,1
1021,10342,snAYYuMQqGAkhlZMfAgAWobAumSD4u2s,SpATywNh6bZuzm8s1ceuBUnMUAeoAHHw,8,5,3,0,2,0,3,0,13,1.8571428571428572,1,0.0,0,3,0,2,5,0,0,3,0,5,8,1
1022,10358,Nzrw7pk0OZ13UV7zfdLy7gEMwvTA7qqG,SpATywNh6bZuzm8s1ceuBUnMUAeoAHHw,32,111,48,32,13,142,59,8,413,59.0,15,0.0,36,48,31,13,75,142,1,59,8,128,285,0
1023,10365,xg8dkQPzve0MzcpgxvEsbKyY4VwKrxAC,SpATywNh6bZuzm8s1ceuBUnMUAeoAHHw,13,34,1,0,0,0,5,0,40,5.714285714285714,3,0.0,5,1,0,0,29,0,0,5,0,6,34,1
1024,10380,ziZWaDkSdnYYFQL9rVa6Bhv9eL7a9wWX,SpATywNh6bZuzm8s1ceuBUnMUAeoAHHw,26,70,8,37,5,29,39,1,189,27.0,7,0.0,17,8,31,5,53,29,6,39,1,61,128,0
1025,10382,wONMmUHIYwPBmEB9lgpOY3KCldKiuZFl,SpATywNh6bZuzm8s1ceuBUnMUAeoAHHw,13,23,13,0,11,4,13,1,65,9.285714285714286,5,0.0,6,13,0,11,17,4,0,13,1,30,35,0
1026,10383,1wBdrtLehQQJkXlNE5BI48cxv9PbJtLD,bWdj2GDclj5ofokWjzoa5jAwMkxCykd6,1,0,0,0,0,0,1,0,1,0.14285714285714285,1,0.0,0,0,0,0,0,0,0,1,0,0,1,1
1027,10388,SaHrUfZXnTghdXjrd2g1gBsj8aUTXhNX,SpATywNh6bZuzm8s1ceuBUnMUAeoAHHw,30,47,10,22,6,12,20,1,118,16.857142857142858,7,0.0,19,10,21,6,28,12,1,20,1,56,62,0
1028,10395,HYP3Q558qDipVvMi5tV4os7veHPJBNBQ,bWdj2GDclj5ofokWjzoa5jAwMkxCykd6,8,13,6,0,2,0,6,0,27,3.857142857142857,3,0.0,0,6,0,2,13,0,0,6,0,8,19,0
1029,10403,VgIpHnZLrMLRtvQcwLJvvhrvLtLKds8Y,SpATywNh6bZuzm8s1ceuBUnMUAeoAHHw,24,55,4,8,4,0,14,0,85,12.142857142857142,3,0.0,1,4,7,4,54,0,1,14,0,16,69,1
1030,10407,xLsstPG4sh6BOKWjwGwQnQICDDoIsKTd,SpATywNh6bZuzm8s1ceuBUnMUAeoAHHw,21,66,32,3,14,20,19,8,162,23.142857142857142,11,0.0,14,32,3,14,52,20,0,19,8,63,99,0
1031,10416,9jZsAxMdQXvLjxKIorcfAyZ7kTyyk2m3,bWdj2GDclj5ofokWjzoa5jAwMkxCykd6,21,43,16,22,11,3,14,2,111,15.857142857142858,6,0.0,9,16,21,11,34,3,1,14,2,57,54,1
1032,10422,Eu9HoDt3WhECHgcXaERosbI6lMj7Hipb,RXDvfPUBYFlVdlueBFbLW0mhhAyGEqpt,65,95,54,135,35,44,17,6,386,55.142857142857146,9,0.0,26,54,124,35,69,44,11,17,6,239,147,0
1033,10423,0bGsOnbsTfgtcrUHSL9Ba6RYBtQEiaAR,SpATywNh6bZuzm8s1ceuBUnMUAeoAHHw,5,2,1,0,1,0,3,0,7,1.0,2,0.0,0,1,0,1,2,0,0,3,0,2,5,1
1034,10427,Daw06K1PSOXldo19kBgHP5sewulb7Vu5,SpATywNh6bZuzm8s1ceuBUnMUAeoAHHw,25,44,1,18,0,8,12,1,84,12.0,7,0.0,9,1,18,0,35,8,0,12,1,28,56,1
1035,10441,KRLjLXKoKEagD4g49Zuzvz0geq7JPqfn,bWdj2GDclj5ofokWjzoa5jAwMkxCykd6,16,62,29,40,17,1,19,2,170,24.285714285714285,7,0.0,12,29,36,17,50,1,4,19,2,94,76,0
1036,10462,PERCKVrZOUZ9ZmdU3J0Mwd1TZrMvK8yc,RXDvfPUBYFlVdlueBFbLW0mhhAyGEqpt,38,76,40,0,40,5,9,1,171,24.428571428571427,3,0.0,25,40,0,40,51,5,0,9,1,105,66,0
1037,10481,4baDuWDcygh3I7gf3DfgmuPMN0Tyoi19,SpATywNh6bZuzm8s1ceuBUnMUAeoAHHw,27,44,8,29,2,3,26,3,115,16.428571428571427,7,0.0,12,8,23,2,32,3,6,26,3,45,70,0
1038,10489,VC1Fuf9dV49znO9PkMawj1ZQqMcKHAjm,SpATywNh6bZuzm8s1ceuBUnMUAeoAHHw,26,58,9,32,5,31,24,1,160,22.857142857142858,13,0.0,21,9,28,5,37,31,4,24,1,63,97,0
1039,10502,vx1j5ZdbVcqMnaq8fewmENptts2XnB9X,SpATywNh6bZuzm8s1ceuBUnMUAeoAHHw,28,44,9,20,5,11,12,1,102,14.571428571428571,3,0.0,16,9,17,5,28,11,3,12,1,47,55,0
1040,10509,gtq5s5jDEXDrRLbMZLZJIjHVD4oTJM3K,SpATywNh6bZuzm8s1ceuBUnMUAeoAHHw,25,37,1,30,1,9,15,2,95,13.571428571428571,2,0.0,11,1,26,1,26,9,4,15,2,39,56,1
1041,10510,Dz5Gcjm5wFySM7nVbkILZVfr9rOqjoD4,bWdj2GDclj5ofokWjzoa5jAwMkxCykd6,1,0,0,0,0,0,1,0,1,0.14285714285714285,1,0.0,0,0,0,0,0,0,0,1,0,0,1,1
1042,10518,rzGwtyhvOohTorRAFSpekt9j8KJVn1Nq,SpATywNh6bZuzm8s1ceuBUnMUAeoAHHw,29,58,30,34,15,3,20,0,160,22.857142857142858,6,0.0,15,30,31,15,43,3,3,20,0,91,69,0
1043,10522,6rHs7FPoWFgbGCrOeJU6CnRQs9oaZ934,SpATywNh6bZuzm8s1ceuBUnMUAeoAHHw,1,0,0,0,0,0,1,0,1,0.14285714285714285,1,0.0,0,0,0,0,0,0,0,1,0,0,1,0
1044,10523,jUBhH6RhAb1JtOUdjtvZ9A8khJilFTTv,RXDvfPUBYFlVdlueBFbLW0mhhAyGEqpt,9,14,4,0,1,4,8,0,31,4.428571428571429,1,0.0,9,4,0,1,5,4,0,8,0,14,17,1
1045,10527,VYMfm0tgVS6x4Eosz9NPpRPYpCrgFsMy,A3fsA9Zfv1X2fVEQhTw51lKENdNrEqT3,92,92,42,375,29,2,27,0,567,81.0,9,0.0,11,42,336,29,81,2,39,27,0,418,149,0
1046,10528,WubsiWqf9HrcjL91VrCtUc1j3k8esFc2,G8EPVSXsOYB5YQWZGiz1aVq5Pgr2GrQu,13,10,4,4,3,7,5,0,33,4.714285714285714,2,0.0,0,4,3,3,10,7,1,5,0,10,23,1
1047,10535,TyLciGh9B6yO4eY9EZiNs3MwXyb1sWVv,SpATywNh6bZuzm8s1ceuBUnMUAeoAHHw,21,28,2,34,2,2,10,0,78,11.142857142857142,4,0.0,12,2,30,2,16,2,4,10,0,46,32,1
1048,10540,Cwlc0kvvLoKXxEuXNQkjFRo818TDMpZS,SpATywNh6bZuzm8s1ceuBUnMUAeoAHHw,30,75,25,23,9,16,14,4,166,23.714285714285715,8,0.0,34,25,23,9,41,16,0,14,4,91,75,0
1049,10542,r2u5KF0HWbXOmPd8SinNo3Ik67swOdP7,SpATywNh6bZuzm8s1ceuBUnMUAeoAHHw,16,23,14,6,9,1,9,0,62,8.857142857142858,3,0.0,7,14,6,9,16,1,0,9,0,36,26,0
1050,10555,QqE2Xjwy9gUzOvFdkDqAwAaNZLBZkxvd,bWdj2GDclj5ofokWjzoa5jAwMkxCykd6,11,19,2,0,1,3,29,0,54,7.714285714285714,8,0.0,0,2,0,1,19,3,0,29,0,3,51,0
1051,10558,Cvs414mYH2FKto3axCpDhfQljawQ5dk9,SpATywNh6bZuzm8s1ceuBUnMUAeoAHHw,17,31,17,15,4,0,9,0,76,10.857142857142858,4,0.0,4,17,15,4,27,0,0,9,0,40,36,0
1052,10567,WubsiWqf9HrcjL91VrCtUc1j3k8esFc2,SpATywNh6bZuzm8s1ceuBUnMUAeoAHHw,1,0,0,0,0,0,2,0,2,0.2857142857142857,2,0.0,0,0,0,0,0,0,0,2,0,0,2,1
1053,10580,m1V3ygdnufe369wleiOQ11JelGyARbAF,SpATywNh6bZuzm8s1ceuBUnMUAeoAHHw,30,46,27,34,14,3,22,0,146,20.857142857142858,3,0.0,11,27,28,14,35,3,6,22,0,80,66,1
1054,10591,wbbNGhodAmSlYSg7ZSWYtWMdb0rjLgRw,G8EPVSXsOYB5YQWZGiz1aVq5Pgr2GrQu,92,60,33,208,13,54,31,1,400,57.142857142857146,7,0.0,3,33,193,13,57,54,15,31,1,242,158,0
1055,10602,v86tUMPiBVyN5RvZX1ZNepQ3NEMTABtY,A3fsA9Zfv1X2fVEQhTw51lKENdNrEqT3,20,21,20,0,20,0,1,0,62,8.857142857142858,1,0.0,0,20,0,20,21,0,0,1,0,40,22,1
1056,10604,UKrQdzHwNJRJK7ZoTzKsoWlrkEbsQk7X,G8EPVSXsOYB5YQWZGiz1aVq5Pgr2GrQu,56,73,38,82,14,15,26,1,249,35.57142857142857,8,0.0,2,38,76,14,71,15,6,26,1,130,119,1
1057,10606,BOBLP6pTmRtpQ8LtVgJyutFMDL3q6xno,SpATywNh6bZuzm8s1ceuBUnMUAeoAHHw,28,35,21,14,7,0,7,0,84,12.0,6,0.0,7,21,14,7,28,0,0,7,0,49,35,0
1058,10608,a3StgABPgimfVHzW1FR4usG9kIA0tZV5,SpATywNh6bZuzm8s1ceuBUnMUAeoAHHw,22,86,0,26,0,4,20,0,136,19.428571428571427,7,0.0,7,0,21,0,79,4,5,20,0,28,108,0
1059,10609,VYMfm0tgVS6x4Eosz9NPpRPYpCrgFsMy,bWdj2GDclj5ofokWjzoa5jAwMkxCykd6,40,75,29,198,16,17,17,0,352,50.285714285714285,7,0.0,22,29,177,16,53,17,21,17,0,244,108,1
1060,10619,CGB0PTeWY2VA2Nk2INJOsdD7IvpzgObV,G8EPVSXsOYB5YQWZGiz1aVq5Pgr2GrQu,33,59,32,35,18,24,20,0,188,26.857142857142858,5,0.0,15,32,30,18,44,24,5,20,0,95,93,1
1061,10620,uhhVn2X7KTVJ0ZZ7uUwG1hMZv4TidRQj,SpATywNh6bZuzm8s1ceuBUnMUAeoAHHw,5,2,1,0,1,0,2,0,6,0.8571428571428571,1,0.0,0,1,0,1,2,0,0,2,0,2,4,1
1062,10623,dzaUNwKZy91BtYj96fOhuSgIlp9lXQDU,SpATywNh6bZuzm8s1ceuBUnMUAeoAHHw,9,15,7,0,1,2,8,0,33,4.714285714285714,5,0.0,2,7,0,1,13,2,0,8,0,10,23,0
1063,10634,OUOJlObKrXM0JmEUq0o8KzZHzr8jy9dn,bWdj2GDclj5ofokWjzoa5jAwMkxCykd6,9,8,3,0,3,9,16,1,40,5.714285714285714,6,0.0,3,3,0,3,5,9,0,16,1,9,31,0
1064,10637,uzPUKUi7vVAcTKZXvlLeqjC4erxz8WBI,bWdj2GDclj5ofokWjzoa5jAwMkxCykd6,27,31,24,34,21,6,6,0,122,17.428571428571427,9,0.0,0,24,31,21,31,6,3,6,0,76,46,0
1065,10642,OnuqqUI42ulcOdv07J5FWiuL2V3DVzCo,RXDvfPUBYFlVdlueBFbLW0mhhAyGEqpt,10,15,8,0,2,0,5,0,30,4.285714285714286,4,0.0,0,8,0,2,15,0,0,5,0,10,20,1
1066,10647,JqgIGUKaljto8rJQxV18FonxG0JqVkY4,SpATywNh6bZuzm8s1ceuBUnMUAeoAHHw,13,19,2,0,1,0,5,0,27,3.857142857142857,2,0.0,0,2,0,1,19,0,0,5,0,3,24,1
1067,10655,39GYbZ8lJRbKZppnA1dQGPRJvzLTR46Q,SpATywNh6bZuzm8s1ceuBUnMUAeoAHHw,12,30,14,0,5,10,11,1,71,10.142857142857142,6,0.0,0,14,0,5,30,10,0,11,1,19,52,0
1068,10658,teqJGecOr4a6oVYU1O9bgvPkX5ZSKA8N,A3fsA9Zfv1X2fVEQhTw51lKENdNrEqT3,3,2,0,0,0,0,1,0,3,0.42857142857142855,1,0.0,0,0,0,0,2,0,0,1,0,0,3,1
1069,10666,9G8Z3eYe0C9cQmNRrnywgJDzRVO9yiAU,SpATywNh6bZuzm8s1ceuBUnMUAeoAHHw,10,7,4,0,3,0,2,0,16,2.2857142857142856,1,0.0,0,4,0,3,7,0,0,2,0,7,9,1
1070,10667,gvBW2L5p7TFF6lkwpHMNMz6nt7oEVYk1,SpATywNh6bZuzm8s1ceuBUnMUAeoAHHw,28,37,15,23,7,0,13,0,95,13.571428571428571,3,0.0,16,15,23,7,21,0,0,13,0,61,34,0
1071,10670,vUBx8sjBPXrETcrwHSfZ0pSQFIH0HPOl,SpATywNh6bZuzm8s1ceuBUnMUAeoAHHw,8,6,3,0,2,0,7,0,18,2.5714285714285716,2,0.0,0,3,0,2,6,0,0,7,0,5,13,1
1072,10671,xg8dkQPzve0MzcpgxvEsbKyY4VwKrxAC,A3fsA9Zfv1X2fVEQhTw51lKENdNrEqT3,15,22,1,0,0,0,5,0,28,4.0,2,0.0,1,1,0,0,21,0,0,5,0,2,26,1
1073,10676,Bv9FSXvHlE6wLC4E4yrAKqe3BQhrrtfx,SpATywNh6bZuzm8s1ceuBUnMUAeoAHHw,22,50,2,26,2,1,10,0,91,13.0,6,0.0,16,2,20,2,34,1,6,10,0,40,51,0
1074,10677,e3VhXxfZ0vOxuCz75HZxH5mLRjbeafOC,A3fsA9Zfv1X2fVEQhTw51lKENdNrEqT3,46,19,15,66,11,4,14,3,132,18.857142857142858,3,0.0,1,15,57,11,18,4,9,14,3,84,48,1
1075,10692,rTYF0meww41Jaf1ZhSKn71dF6UobIHyn,SpATywNh6bZuzm8s1ceuBUnMUAeoAHHw,26,68,5,20,2,10,26,1,132,18.857142857142858,7,0.0,8,5,20,2,60,10,0,26,1,35,97,0
1076,10693,ZAehH9zLr3mvrD0qfr21tfeJdYtTkUHf,SpATywNh6bZuzm8s1ceuBUnMUAeoAHHw,22,28,3,18,2,12,17,2,82,11.714285714285714,5,0.0,5,3,16,2,23,12,2,17,2,26,56,1
1077,10700,jX1wtG8uym7vm2Ny85W79HCXnEeqhUm4,bWdj2GDclj5ofokWjzoa5jAwMkxCykd6,40,127,62,156,9,70,54,2,480,68.57142857142857,10,0.0,19,62,136,9,108,70,20,54,2,226,254,0
1078,10701,01A7cnd3gvCIwCcMkE5K8qeHnbk9l92w,SpATywNh6bZuzm8s1ceuBUnMUAeoAHHw,10,8,1,0,1,0,5,0,15,2.142857142857143,2,0.0,0,1,0,1,8,0,0,5,0,2,13,1
1079,10712,IaSb2U7ef1Fkefm60uQQgWhKloK1Rfe8,SpATywNh6bZuzm8s1ceuBUnMUAeoAHHw,28,26,16,26,8,0,10,0,86,12.285714285714286,5,0.0,5,16,23,8,21,0,3,10,0,52,34,0
1080,10725,TgheOgj9khTgshxaHKtqDHWb3smGHeUA,G8EPVSXsOYB5YQWZGiz1aVq5Pgr2GrQu,2,0,0,0,0,0,2,0,2,0.2857142857142857,1,0.0,0,0,0,0,0,0,0,2,0,0,2,1
1081,10730,mJZNVvZltlGUOWmItS7lca1ZZKMYLgfv,A3fsA9Zfv1X2fVEQhTw51lKENdNrEqT3,69,28,1,224,1,0,10,0,264,37.714285714285715,4,0.0,5,1,222,1,23,0,2,10,0,229,35,1
1082,10743,98UEGByxiN7tned6NDQeKfQDq4HCSGvQ,SpATywNh6bZuzm8s1ceuBUnMUAeoAHHw,30,56,21,27,8,19,14,1,146,20.857142857142858,5,0.0,17,21,23,8,39,19,4,14,1,69,77,0
1083,10746,FQskTqGJU9GeC9XfemJd5Qp19XhmSu0D,SpATywNh6bZuzm8s1ceuBUnMUAeoAHHw,9,14,4,0,2,1,7,0,28,4.0,3,0.0,2,4,0,2,12,1,0,7,0,8,20,1
1084,10747,348VAoiXzNIM3yBiHWYaT9jpmJfwDK3a,SpATywNh6bZuzm8s1ceuBUnMUAeoAHHw,24,14,9,31,7,0,1,0,62,8.857142857142858,1,0.0,4,9,27,7,10,0,4,1,0,47,15,1
1085,10758,JjZeMsAmsZa7SQS0vTrtExRB1lmjwAQ2,SpATywNh6bZuzm8s1ceuBUnMUAeoAHHw,17,48,5,7,5,0,18,0,83,11.857142857142858,6,0.0,5,5,7,5,43,0,0,18,0,22,61,0
1086,10760,Y2f2dC6l8KkgqmCmVNjopMQFUan6brSz,G8EPVSXsOYB5YQWZGiz1aVq5Pgr2GrQu,5,5,3,0,2,0,2,0,12,1.7142857142857142,2,0.0,0,3,0,2,5,0,0,2,0,5,7,1
1087,10761,Grmueh4kYgLYo2kInw23ZHrSQJbjli7D,SpATywNh6bZuzm8s1ceuBUnMUAeoAHHw,29,32,16,43,10,4,14,3,122,17.428571428571427,5,0.0,11,16,36,10,21,4,7,14,3,73,49,0
1088,10763,tby14fMJpDIjTBkK50rauZ0P5DHnQphs,SpATywNh6bZuzm8s1ceuBUnMUAeoAHHw,30,74,27,26,10,2,16,5,160,22.857142857142858,7,0.0,12,27,23,10,62,2,3,16,5,72,88,1
1089,10774,QmKLhFuFtodx97KXUUkaok1RXKwJOs6p,SpATywNh6bZuzm8s1ceuBUnMUAeoAHHw,31,58,29,44,14,6,21,0,172,24.571428571428573,7,0.0,21,29,36,14,37,6,8,21,0,100,72,0
1090,10780,4rsvMJ6Q6FXQkVitKsbveKESjOLTvSkd,bWdj2GDclj5ofokWjzoa5jAwMkxCykd6,5,2,1,0,1,0,3,0,7,1.0,2,0.0,0,1,0,1,2,0,0,3,0,2,5,1
1091,10784,4fg1E2X2Iqab02UjKHSaN93jLrNDtbK1,SpATywNh6bZuzm8s1ceuBUnMUAeoAHHw,6,2,1,0,1,0,3,0,7,1.0,2,0.0,0,1,0,1,2,0,0,3,0,2,5,1
1092,10798,8gqnQBccwF9lDaMHj8oF8zZMqUrUX7OJ,SpATywNh6bZuzm8s1ceuBUnMUAeoAHHw,6,2,0,0,0,0,4,0,6,0.8571428571428571,1,0.0,0,0,0,0,2,0,0,4,0,0,6,1
1093,10799,4wGoSTuzJXBCojeNmaxk9GbR1KaCV7ql,G8EPVSXsOYB5YQWZGiz1aVq5Pgr2GrQu,62,107,10,128,9,2,16,3,275,39.285714285714285,5,0.0,42,10,98,9,65,2,30,16,3,159,116,0
1094,10802,7jkKKf5Pb7FrtJ3WnuF11G7ePioUPJm3,SpATywNh6bZuzm8s1ceuBUnMUAeoAHHw,29,56,32,30,16,6,9,0,149,21.285714285714285,5,0.0,17,32,29,16,39,6,1,9,0,94,55,0
1095,10805,mJAgtJKHxy28GsPIeuAEUCIOXmHzCywF,SpATywNh6bZuzm8s1ceuBUnMUAeoAHHw,32,145,73,16,16,149,85,2,486,69.42857142857143,11,0.0,23,73,15,16,122,149,1,85,2,127,359,0
1096,10815,2MQR5LCqimp6aDvlkve2ALXoA292MToK,A3fsA9Zfv1X2fVEQhTw51lKENdNrEqT3,3,3,0,0,0,0,3,0,6,0.8571428571428571,1,0.0,0,0,0,0,3,0,0,3,0,0,6,1
1097,10820,2DRl1D33z6i9gsgW5IB0KBdkJJ1Zsu7a,SpATywNh6bZuzm8s1ceuBUnMUAeoAHHw,8,6,2,12,0,1,3,0,24,3.4285714285714284,1,0.0,4,2,12,0,2,1,0,3,0,18,6,1
1098,10821,NXEwBXbU6vvce77sujWgRB6LivhFJvRb,SpATywNh6bZuzm8s1ceuBUnMUAeoAHHw,8,11,7,0,4,0,6,0,28,4.0,3,0.0,0,7,0,4,11,0,0,6,0,11,17,0
1099,10824,lMRWvZAvduvP2Pz46WY1VVjM0sCfB7T7,A3fsA9Zfv1X2fVEQhTw51lKENdNrEqT3,14,8,7,0,7,0,1,0,23,3.2857142857142856,1,0.0,0,7,0,7,8,0,0,1,0,14,9,1
1100,10825,7WuJYJfQSGYpjK1VOCbNTWx56QRfHZwF,SpATywNh6bZuzm8s1ceuBUnMUAeoAHHw,12,18,8,0,2,2,11,2,43,6.142857142857143,1,0.0,5,8,0,2,13,2,0,11,2,15,28,1
1101,10832,W73xMu8SLqBdMS90qjmpE3wGeT86YnLl,SpATywNh6bZuzm8s1ceuBUnMUAeoAHHw,1,0,0,0,0,0,1,0,1,0.14285714285714285,1,0.0,0,0,0,0,0,0,0,1,0,0,1,1
1102,10850,O4Go02y0WzYwbHIZc8uk50WjYKUP2Q4Y,G8EPVSXsOYB5YQWZGiz1aVq5Pgr2GrQu,8,12,2,0,3,2,7,0,26,3.7142857142857144,2,0.0,5,2,0,3,7,2,0,7,0,10,16,1
1103,10863,SE8wOQdHqwRS7ESACXcTxQAuYFlgu1Py,SpATywNh6bZuzm8s1ceuBUnMUAeoAHHw,22,64,39,26,0,14,18,2,163,23.285714285714285,5,0.0,18,39,19,0,46,14,7,18,2,76,87,1
1104,10867,n6zGNJI1hLWYjlMIVXYesa3jTXjLwizj,SpATywNh6bZuzm8s1ceuBUnMUAeoAHHw,28,67,41,25,8,0,23,1,165,23.571428571428573,10,0.0,13,41,22,8,54,0,3,23,1,84,81,0
1105,10868,d9cbpiPwBULo3iFfJzjTidseoxKi3AEA,SpATywNh6bZuzm8s1ceuBUnMUAeoAHHw,28,75,14,40,5,55,34,7,230,32.857142857142854,8,0.0,13,14,34,5,62,55,6,34,7,66,164,0
1106,10873,YLA48gUHn1Dc2R5xXAOe8bpBqZ5RWVW4,A3fsA9Zfv1X2fVEQhTw51lKENdNrEqT3,7,5,3,0,1,0,4,0,13,1.8571428571428572,2,0.0,0,3,0,1,5,0,0,4,0,4,9,1
1107,10881,31ZWCwEsmLt26QDeYIg9aUSXrbkhFpxl,SpATywNh6bZuzm8s1ceuBUnMUAeoAHHw,24,20,14,26,6,8,9,0,83,11.857142857142858,4,0.0,4,14,22,6,16,8,4,9,0,46,37,0
1108,10883,FRmbznbV6x9Ojz1brfaBTFmC2TFyzd4t,SpATywNh6bZuzm8s1ceuBUnMUAeoAHHw,6,2,1,0,1,0,3,0,7,1.0,1,0.0,0,1,0,1,2,0,0,3,0,2,5,1
1109,10889,QYLtTejmIZrOzfj0rdDVGzAjECmBavYx,A3fsA9Zfv1X2fVEQhTw51lKENdNrEqT3,22,12,9,0,7,4,11,1,44,6.285714285714286,4,0.0,0,9,0,7,12,4,0,11,1,16,28,1
1110,10902,wGtQdpTL13GOtTQAxkeOO6rmRR5kG8Nt,G8EPVSXsOYB5YQWZGiz1aVq5Pgr2GrQu,17,19,1,15,1,3,12,1,52,7.428571428571429,2,0.0,6,1,9,1,13,3,6,12,1,17,35,1
1111,10903,896KUUFdpc0Ig8weMXOkWbw7cjXtmIVV,SpATywNh6bZuzm8s1ceuBUnMUAeoAHHw,24,24,9,20,5,0,18,1,77,11.0,6,0.0,4,9,19,5,20,0,1,18,1,37,40,0
1112,10907,90tR2Jy52lv1kJ6TwJ9Jqo5P6u0CqT0E,SpATywNh6bZuzm8s1ceuBUnMUAeoAHHw,16,25,15,15,10,0,5,0,70,10.0,3,0.0,5,15,13,10,20,0,2,5,0,43,27,0
1113,10959,DgZ8el6keJUnUjxjYHQCrfhij2kpBixa,SpATywNh6bZuzm8s1ceuBUnMUAeoAHHw,6,5,1,0,1,0,6,0,13,1.8571428571428572,3,0.0,0,1,0,1,5,0,0,6,0,2,11,1
1114,10960,0LuT01kLiLvn9XWvvtK0UMLQOoqN4d0O,SpATywNh6bZuzm8s1ceuBUnMUAeoAHHw,7,3,2,0,2,0,2,0,9,1.2857142857142858,1,0.0,0,2,0,2,3,0,0,2,0,4,5,1
1115,10961,1N6nOsYXnkatuA8YMolfRAv0tQpjn2uG,SpATywNh6bZuzm8s1ceuBUnMUAeoAHHw,30,41,22,29,10,5,10,0,117,16.714285714285715,7,0.0,10,22,25,10,31,5,4,10,0,67,50,0
1116,10965,Vc1baHxuYCOF9wXqOziB65UR0NyB8LSm,bWdj2GDclj5ofokWjzoa5jAwMkxCykd6,13,12,0,78,0,8,4,0,102,14.571428571428571,2,0.0,3,0,75,0,9,8,3,4,0,78,24,1
1117,10966,DmvuE1XVhhp2s0ZR7GTfZK1NmSM6wJmI,SpATywNh6bZuzm8s1ceuBUnMUAeoAHHw,18,19,8,14,4,2,7,1,55,7.857142857142857,1,0.0,9,8,12,4,10,2,2,7,1,33,22,1
1118,10970,IdRsdksEKIk9aXKOiGRUkjb7QPozokDa,SpATywNh6bZuzm8s1ceuBUnMUAeoAHHw,19,49,8,17,1,0,10,1,86,12.285714285714286,6,0.0,7,8,14,1,42,0,3,10,1,30,56,0
1119,10977,2VCaGNRfRGGtWxoLqznZdBtjcnH6XG28,SpATywNh6bZuzm8s1ceuBUnMUAeoAHHw,6,5,1,0,1,0,3,0,10,1.4285714285714286,2,0.0,0,1,0,1,5,0,0,3,0,2,8,1
1120,10981,gFIubR5L7uAqsUwFMmCtpUtAJn2LXJti,SpATywNh6bZuzm8s1ceuBUnMUAeoAHHw,12,33,13,0,8,0,16,2,72,10.285714285714286,4,0.0,0,13,0,8,33,0,0,16,2,21,51,1
1121,10986,MN4wOgynUY4QcRaraCB5Ym52vNjUttfc,SpATywNh6bZuzm8s1ceuBUnMUAeoAHHw,28,35,20,37,13,9,5,0,119,17.0,2,0.0,11,20,31,13,24,9,6,5,0,75,44,0
1122,10992,EaV63ns250Za7MNTuadlc0JeYoVcm5bM,SpATywNh6bZuzm8s1ceuBUnMUAeoAHHw,26,44,8,25,4,4,14,0,99,14.142857142857142,6,0.0,16,8,22,4,28,4,3,14,0,50,49,0
1123,11000,zyIWmJjaz36PnMZpAzR2HEZCUbJWe8iQ,bWdj2GDclj5ofokWjzoa5jAwMkxCykd6,51,52,23,109,14,1,17,1,217,31.0,7,0.0,20,23,105,14,32,1,4,17,1,162,55,1
1124,11005,o6ABKk2KTrZIkABXncviG8GWvJhMxPWI,A3fsA9Zfv1X2fVEQhTw51lKENdNrEqT3,23,10,5,60,0,0,5,0,80,11.428571428571429,2,0.0,4,5,55,0,6,0,5,5,0,64,16,1
1125,11007,o6ABKk2KTrZIkABXncviG8GWvJhMxPWI,bWdj2GDclj5ofokWjzoa5jAwMkxCykd6,4,2,1,0,0,0,5,0,8,1.1428571428571428,2,0.0,0,1,0,0,2,0,0,5,0,1,7,1
1126,11009,V9WdcffWyPz5HIrf6AUJoXYLZsZmovZs,bWdj2GDclj5ofokWjzoa5jAwMkxCykd6,8,5,2,0,2,0,6,0,15,2.142857142857143,1,0.0,0,2,0,2,5,0,0,6,0,4,11,1
1127,11018,bjG4XBkL5oSJA9TxyrmgPKXKYOTfiWVp,bWdj2GDclj5ofokWjzoa5jAwMkxCykd6,31,50,26,91,16,11,14,1,209,29.857142857142858,4,0.0,11,26,80,16,39,11,11,14,1,133,76,0
1128,11035,oOFCpO143ty3GSSLZVLh2o69NMEyxWhF,A3fsA9Zfv1X2fVEQhTw51lKENdNrEqT3,3,0,0,0,0,0,2,1,3,0.42857142857142855,1,0.0,0,0,0,0,0,0,0,2,1,0,3,1
1129,11039,uukZZIB0DkTcJFX9Kfm5gzAJiaQWt3jq,SpATywNh6bZuzm8s1ceuBUnMUAeoAHHw,25,34,18,12,8,12,21,2,107,15.285714285714286,6,0.0,8,18,10,8,26,12,2,21,2,44,63,1
1130,11063,RlHRJAiYu3Nfz7DEuzJcJRZJq4vbOfQu,SpATywNh6bZuzm8s1ceuBUnMUAeoAHHw,8,5,3,0,2,0,8,0,18,2.5714285714285716,3,0.0,0,3,0,2,5,0,0,8,0,5,13,0
1131,11072,48y8P1mBttkP3u0gtvk3ydvAiO35KU2g,SpATywNh6bZuzm8s1ceuBUnMUAeoAHHw,15,23,13,15,7,0,3,0,61,8.714285714285714,4,0.0,7,13,15,7,16,0,0,3,0,42,19,0
1132,11095,ALXyvdc776DMhlVyaaoPo6cQhevpwTYD,SpATywNh6bZuzm8s1ceuBUnMUAeoAHHw,27,68,10,27,2,2,30,1,140,20.0,11,0.0,31,10,24,2,37,2,3,30,1,67,73,0
1133,11096,vogj6DdqvLTkNOGuPksobO32JsQUkuqr,SpATywNh6bZuzm8s1ceuBUnMUAeoAHHw,23,76,7,41,0,31,21,1,177,25.285714285714285,10,0.0,29,7,34,0,47,31,7,21,1,70,107,0
1134,11098,R5MIWOdfQPF58rt5zIICrbN58FLsYSLK,SpATywNh6bZuzm8s1ceuBUnMUAeoAHHw,21,34,24,9,15,8,13,0,103,14.714285714285714,6,0.0,0,24,7,15,34,8,2,13,0,46,57,0
1135,11099,EfuhWoaB1h47xaBVO37JU7S7sIj3K77V,SpATywNh6bZuzm8s1ceuBUnMUAeoAHHw,23,44,2,37,1,0,13,0,97,13.857142857142858,5,0.0,8,2,32,1,36,0,5,13,0,43,54,0
1136,11100,qRCFXu9SKQXvPlpvjvNkgxm9VD5k2SNq,G8EPVSXsOYB5YQWZGiz1aVq5Pgr2GrQu,6,14,5,0,2,0,7,0,28,4.0,4,0.0,0,5,0,2,14,0,0,7,0,7,21,1
1137,11102,WCS011LuLB85y1yYsddT54kQDph1Fl5i,SpATywNh6bZuzm8s1ceuBUnMUAeoAHHw,11,5,4,0,4,0,2,0,15,2.142857142857143,1,0.0,0,4,0,4,5,0,0,2,0,8,7,1
1138,11108,kfRiZgRVbY5ABTVoI4HG09f2IgSZ5p9y,SpATywNh6bZuzm8s1ceuBUnMUAeoAHHw,1,0,0,0,0,0,1,0,1,0.14285714285714285,1,0.0,0,0,0,0,0,0,0,1,0,0,1,1
1139,11110,fNM6a78gna3DBlYrxiSuwL1HfiXFBx1X,SpATywNh6bZuzm8s1ceuBUnMUAeoAHHw,27,27,14,21,8,1,11,2,84,12.0,3,0.0,9,14,17,8,18,1,4,11,2,48,36,1
1140,11117,yBKClM5or0v37bBK9shMFXqtoOJsEOKi,SpATywNh6bZuzm8s1ceuBUnMUAeoAHHw,31,65,24,27,10,9,13,2,150,21.428571428571427,6,0.0,20,24,24,10,45,9,3,13,2,78,72,0
1141,11118,8G3TIfWeYnotKEBloHzMAvSj0jab6YCE,SpATywNh6bZuzm8s1ceuBUnMUAeoAHHw,29,87,10,37,7,1,19,0,161,23.0,7,0.0,17,10,35,7,70,1,2,19,0,69,92,0
1142,11132,2YJ5Tv1YViB4JNiKZeHEEz6eSF3MN6um,bWdj2GDclj5ofokWjzoa5jAwMkxCykd6,1,0,0,0,0,0,1,0,1,0.14285714285714285,1,0.0,0,0,0,0,0,0,0,1,0,0,1,1
1143,11133,CdI8eHwhOFOmT1gRfkQHwobJyLn2OtRJ,SpATywNh6bZuzm8s1ceuBUnMUAeoAHHw,8,8,2,0,0,0,8,0,18,2.5714285714285716,3,0.0,0,2,0,0,8,0,0,8,0,2,16,1
1144,11140,kQ63n93d5CTXewyEhcoySFeLgYStuYpO,SpATywNh6bZuzm8s1ceuBUnMUAeoAHHw,27,39,21,37,7,7,13,0,124,17.714285714285715,9,0.0,9,21,31,7,30,7,6,13,0,68,56,0
1145,11145,UnV0HDk59T6cuzi8hS829ZOjCdT0CRoB,SpATywNh6bZuzm8s1ceuBUnMUAeoAHHw,30,61,25,25,12,20,14,11,168,24.0,5,0.0,20,25,23,12,41,20,2,14,11,80,88,0
1146,11152,SuK945tkxadINDtal1yRSiV9QKse6fnl,G8EPVSXsOYB5YQWZGiz1aVq5Pgr2GrQu,65,136,46,102,38,25,12,0,359,51.285714285714285,7,0.0,69,46,60,38,67,25,42,12,0,213,146,0
1147,11153,h8eBexpHr95TQpIPdJzX4ggtrj3rthKs,SpATywNh6bZuzm8s1ceuBUnMUAeoAHHw,26,42,23,24,11,10,8,0,118,16.857142857142858,6,0.0,13,23,22,11,29,10,2,8,0,69,49,0
1148,11156,HIC4ktOJbqbNeF2uNjLeMCsJ9XcoLJFS,SpATywNh6bZuzm8s1ceuBUnMUAeoAHHw,7,9,5,0,5,0,3,0,22,3.142857142857143,2,0.0,0,5,0,5,9,0,0,3,0,10,12,1
1149,11196,0K6JPqiivQzicxY4EV4nqMLCL3a08A97,A3fsA9Zfv1X2fVEQhTw51lKENdNrEqT3,8,2,2,0,2,0,7,0,13,1.8571428571428572,3,0.0,0,2,0,2,2,0,0,7,0,4,9,1
1150,11199,G5krO16D3cyvAnQXVywA0e0QfvmDKyJE,SpATywNh6bZuzm8s1ceuBUnMUAeoAHHw,11,35,13,0,6,2,16,1,73,10.428571428571429,4,0.0,2,13,0,6,33,2,0,16,1,21,52,1
1151,11218,ESIDCh7JUpjIHOXvPcQBcrSs3Att83qK,SpATywNh6bZuzm8s1ceuBUnMUAeoAHHw,23,115,3,36,0,7,51,0,212,30.285714285714285,12,0.0,10,3,33,0,105,7,3,51,0,46,166,0
1152,11231,FpAFHYP26eZqx6Z5sDhKdTJPTBgbDKt4,SpATywNh6bZuzm8s1ceuBUnMUAeoAHHw,31,96,37,45,9,127,54,5,373,53.285714285714285,11,0.0,38,37,36,9,58,127,9,54,5,120,253,0
1153,11232,wmD7RtZPHqOfpVEXsJ4kv2jVIQOymIt7,G8EPVSXsOYB5YQWZGiz1aVq5Pgr2GrQu,17,16,5,2,3,5,8,1,40,5.714285714285714,2,0.0,5,5,1,3,11,5,1,8,1,14,26,1
1154,11266,VhukMS7IeX7XDUBwwZYzbVsz6P6yEHKX,RXDvfPUBYFlVdlueBFbLW0mhhAyGEqpt,1,0,0,0,0,0,1,0,1,0.14285714285714285,1,0.0,0,0,0,0,0,0,0,1,0,0,1,1
1155,11267,Zp4vK4oqe1AwFnnOJdy7Uz1AWwNAcdOt,SpATywNh6bZuzm8s1ceuBUnMUAeoAHHw,25,27,16,11,11,0,6,0,71,10.142857142857142,3,0.0,4,16,10,11,23,0,1,6,0,41,30,1
1156,11277,fOGAjxxxpsDuk08vAdjWtxgrvUhA2ic8,SpATywNh6bZuzm8s1ceuBUnMUAeoAHHw,21,37,0,34,0,25,5,0,101,14.428571428571429,3,0.0,14,0,27,0,23,25,7,5,0,41,60,1
1157,11298,gnjZOoI8BeitDTrO8bhWhoFLWjid4LeA,A3fsA9Zfv1X2fVEQhTw51lKENdNrEqT3,8,11,9,0,0,0,1,0,21,3.0,1,0.0,0,9,0,0,11,0,0,1,0,9,12,1
1158,11307,1dxQmK9WwlHWuIG7ZTn4PsJ2vflQBDH3,SpATywNh6bZuzm8s1ceuBUnMUAeoAHHw,14,20,2,6,0,1,2,0,31,4.428571428571429,2,0.0,6,2,6,0,14,1,0,2,0,14,17,0
1159,11316,dw8UeboqdsSC29cEE9urly5h5PKlFfq8,SpATywNh6bZuzm8s1ceuBUnMUAeoAHHw,2,0,0,0,0,0,3,0,3,0.42857142857142855,2,0.0,0,0,0,0,0,0,0,3,0,0,3,1
1160,11325,urVw10ZOKTw1O1zHFnsutUzT6EcZdTal,SpATywNh6bZuzm8s1ceuBUnMUAeoAHHw,27,31,12,24,5,0,13,2,87,12.428571428571429,8,0.0,6,12,22,5,25,0,2,13,2,45,42,0
1161,11336,dEamTHPv2n4UBaBMMzaMVTBu34nRHB8p,SpATywNh6bZuzm8s1ceuBUnMUAeoAHHw,5,0,0,0,0,4,5,1,10,1.4285714285714286,1,0.0,0,0,0,0,0,4,0,5,1,0,10,1
1162,11341,mJAgtJKHxy28GsPIeuAEUCIOXmHzCywF,bWdj2GDclj5ofokWjzoa5jAwMkxCykd6,21,80,45,38,22,9,37,0,231,33.0,8,0.0,11,45,36,22,69,9,2,37,0,114,117,0
1163,11350,OfMabADNCpK7MfQ7IaqBsUw8RvPeHL0S,G8EPVSXsOYB5YQWZGiz1aVq5Pgr2GrQu,1,0,0,0,0,0,1,0,1,0.14285714285714285,1,0.0,0,0,0,0,0,0,0,1,0,0,1,1
1164,11351,1YxknoiTrSwQgclDlSAh4oMYHRyARhLv,A3fsA9Zfv1X2fVEQhTw51lKENdNrEqT3,20,13,7,8,4,0,8,0,40,5.714285714285714,5,0.0,1,7,8,4,12,0,0,8,0,20,20,1
1165,11353,8OeiQbuEbEG2DSTpkZJyuKzc1PTNg0ge,SpATywNh6bZuzm8s1ceuBUnMUAeoAHHw,5,3,1,0,1,0,1,0,6,0.8571428571428571,1,0.0,0,1,0,1,3,0,0,1,0,2,4,1
1166,11366,GsMuFjXWxUh2UrLHKPEnIwFvWlVxAcB7,SpATywNh6bZuzm8s1ceuBUnMUAeoAHHw,7,5,3,0,2,0,2,0,12,1.7142857142857142,2,0.0,0,3,0,2,5,0,0,2,0,5,7,0
1167,11367,zEiNHlokNuJTLVoV4Hy4kJd9kzaIjztD,SpATywNh6bZuzm8s1ceuBUnMUAeoAHHw,30,38,18,20,9,1,8,0,94,13.428571428571429,6,0.0,6,18,16,9,32,1,4,8,0,49,45,0
1168,11369,7KNecsubFdywoFPLyTu2kgv5VbQekjao,SpATywNh6bZuzm8s1ceuBUnMUAeoAHHw,22,37,2,29,0,3,7,0,78,11.142857142857142,3,0.0,17,2,26,0,20,3,3,7,0,45,33,1
1169,11382,GDyZ2LKwtCChKfTbObuzefDdka9nIeiE,G8EPVSXsOYB5YQWZGiz1aVq5Pgr2GrQu,1,0,0,0,0,0,1,0,1,0.14285714285714285,1,0.0,0,0,0,0,0,0,0,1,0,0,1,1
1170,11384,U8CJ4eMAocRPzH9a3a2MJhXfikEQ51WM,bWdj2GDclj5ofokWjzoa5jAwMkxCykd6,5,2,1,0,1,0,2,0,6,0.8571428571428571,1,0.0,0,1,0,1,2,0,0,2,0,2,4,1
1171,11385,KKGY1xUUxKUn4nPRs2VmwvVd6JuyBBfA,SpATywNh6bZuzm8s1ceuBUnMUAeoAHHw,3,0,0,0,0,0,2,3,5,0.7142857142857143,1,0.0,0,0,0,0,0,0,0,2,3,0,5,1
1172,11387,8xe55v4hJPUrl0YZIl8G73vP4j2l4PsW,SpATywNh6bZuzm8s1ceuBUnMUAeoAHHw,26,26,6,24,3,0,6,0,65,9.285714285714286,3,0.0,8,6,19,3,18,0,5,6,0,36,29,0
1173,11393,D1fgtFfIsG1EcZQzDGeiCx6sI7k5ShWV,G8EPVSXsOYB5YQWZGiz1aVq5Pgr2GrQu,17,21,2,10,4,9,13,2,61,8.714285714285714,3,0.0,9,2,7,4,12,9,3,13,2,22,39,1
1174,11396,rYSxun4NgQnH8EYwHicH82Z91cblITe8,RXDvfPUBYFlVdlueBFbLW0mhhAyGEqpt,1,0,0,0,0,0,1,0,1,0.14285714285714285,1,0.0,0,0,0,0,0,0,0,1,0,0,1,1
1175,11406,rYSxun4NgQnH8EYwHicH82Z91cblITe8,G8EPVSXsOYB5YQWZGiz1aVq5Pgr2GrQu,1,0,0,0,0,0,1,0,1,0.14285714285714285,1,0.0,0,0,0,0,0,0,0,1,0,0,1,1
1176,11407,HYCkyEJhW9QtzilmanJKsxRLSBi9UGoV,RXDvfPUBYFlVdlueBFbLW0mhhAyGEqpt,1,0,0,0,0,0,1,0,1,0.14285714285714285,1,0.0,0,0,0,0,0,0,0,1,0,0,1,1
1177,11418,Km3IX0L3OZADSpnXU3tgLmBjn4mYhfRJ,SpATywNh6bZuzm8s1ceuBUnMUAeoAHHw,23,43,0,35,0,22,21,1,122,17.428571428571427,3,0.0,11,0,34,0,32,22,1,21,1,45,77,0
1178,11423,WeFVkkJO52wtRMBMdihRXPPKstU7E9sn,A3fsA9Zfv1X2fVEQhTw51lKENdNrEqT3,2,0,0,0,0,0,2,0,2,0.2857142857142857,1,0.0,0,0,0,0,0,0,0,2,0,0,2,1
1179,11430,7KNecsubFdywoFPLyTu2kgv5VbQekjao,RXDvfPUBYFlVdlueBFbLW0mhhAyGEqpt,12,13,1,0,1,0,3,0,18,2.5714285714285716,3,0.0,0,1,0,1,13,0,0,3,0,2,16,1
1180,11442,Sz8jNgPmKJ1IbqEEVQqTtQlVUDGarqh2,A3fsA9Zfv1X2fVEQhTw51lKENdNrEqT3,26,30,21,0,15,0,22,0,88,12.571428571428571,6,0.0,0,21,0,15,30,0,0,22,0,36,52,0
1181,11448,tLAxgBhXx0zpE8fWNnwggaJx5LeHI2h1,RXDvfPUBYFlVdlueBFbLW0mhhAyGEqpt,69,81,37,173,14,2,15,2,324,46.285714285714285,4,0.0,13,37,163,14,68,2,10,15,2,227,97,1
1182,11450,HnptwVrdWLkMWuHezQcYS6A0pyVov5BG,SpATywNh6bZuzm8s1ceuBUnMUAeoAHHw,32,59,32,55,11,9,21,6,193,27.571428571428573,7,0.0,16,32,43,11,43,9,12,21,6,102,91,0
1183,11454,G5viWFw6vjc0kZ7aRbev4NG1fp3ajLxi,A3fsA9Zfv1X2fVEQhTw51lKENdNrEqT3,17,13,10,0,9,0,2,0,34,4.857142857142857,3,0.0,0,10,0,9,13,0,0,2,0,19,15,1
1184,11455,5ObfmFiTeuGjRWtYuJy4iGiMBZ3jgU0e,SpATywNh6bZuzm8s1ceuBUnMUAeoAHHw,15,28,15,16,10,0,3,0,72,10.285714285714286,4,0.0,8,15,14,10,20,0,2,3,0,47,25,1
1185,11456,CWDKRVVm01sfgssULmzIPwx9dbULLbqB,A3fsA9Zfv1X2fVEQhTw51lKENdNrEqT3,91,72,52,266,33,19,14,0,456,65.14285714285714,6,0.0,3,52,227,33,69,19,39,14,0,315,141,0
1186,11461,cW0TF0QgesgeR4yvyFNeSG2Tsy7pGtpm,A3fsA9Zfv1X2fVEQhTw51lKENdNrEqT3,49,78,17,84,11,9,24,1,224,32.0,6,0.0,4,17,65,11,74,9,19,24,1,97,127,1
1187,11472,mN4qYBgpy4Qxh2rSlBkY5ZDyLEZtAHu9,RXDvfPUBYFlVdlueBFbLW0mhhAyGEqpt,57,43,26,82,15,30,11,10,217,31.0,5,0.0,11,26,80,15,32,30,2,11,10,132,85,1
1188,11483,fG7nauhHd6Hp0Y6uPPSQifF45RcZ5wiO,SpATywNh6bZuzm8s1ceuBUnMUAeoAHHw,16,23,3,17,0,1,4,0,48,6.857142857142857,3,0.0,5,3,14,0,18,1,3,4,0,22,26,1
1189,11490,mDEirND7nLzt2vy8e34SZhdfEbglxCWs,SpATywNh6bZuzm8s1ceuBUnMUAeoAHHw,29,81,21,28,9,20,20,1,180,25.714285714285715,4,0.0,21,21,22,9,60,20,6,20,1,73,107,0
1190,11494,nBVpguvJeCUz3AWDoX9CCNT2qyeZb33T,G8EPVSXsOYB5YQWZGiz1aVq5Pgr2GrQu,41,67,45,84,1,8,11,0,216,30.857142857142858,6,0.0,10,45,67,1,57,8,17,11,0,123,93,0
1191,11497,tfkukKUMRkePYIfP864uQoXVHWicLcZ3,A3fsA9Zfv1X2fVEQhTw51lKENdNrEqT3,13,23,12,0,5,0,9,0,49,7.0,2,0.0,1,12,0,5,22,0,0,9,0,18,31,1
1192,11511,zNxhmmLWnSaIABuhKypYetmsDg2VcOK8,SpATywNh6bZuzm8s1ceuBUnMUAeoAHHw,14,12,6,11,5,1,3,0,38,5.428571428571429,3,0.0,4,6,11,5,8,1,0,3,0,26,12,1
1193,11516,aSlIMkfly6xTMJCGTWDQcnFZjajcWM6y,RXDvfPUBYFlVdlueBFbLW0mhhAyGEqpt,21,38,5,0,5,4,8,0,60,8.571428571428571,7,0.0,4,5,0,5,34,4,0,8,0,14,46,0
1194,11541,vIBcYbs1BLdmaaP30fcE2FS7kB7v7QRn,A3fsA9Zfv1X2fVEQhTw51lKENdNrEqT3,7,18,9,0,1,0,12,0,40,5.714285714285714,6,0.0,0,9,0,1,18,0,0,12,0,10,30,1
1195,11546,9PS6Icub6VXkyVUcoskrzajETE7Qoarh,SpATywNh6bZuzm8s1ceuBUnMUAeoAHHw,29,68,30,36,12,6,10,0,162,23.142857142857142,5,0.0,29,30,30,12,39,6,6,10,0,101,61,0
1196,11556,pplAmbuLk2c8g7K4eYBlhKFfYSpZgbNo,SpATywNh6bZuzm8s1ceuBUnMUAeoAHHw,20,39,4,10,1,0,19,1,74,10.571428571428571,6,0.0,6,4,8,1,33,0,2,19,1,19,55,0
1197,11557,mtYhUCuiqvMc7E9n6ZRYWej43jynHbMu,SpATywNh6bZuzm8s1ceuBUnMUAeoAHHw,14,18,12,10,8,0,4,0,52,7.428571428571429,2,0.0,1,12,9,8,17,0,1,4,0,30,22,1
1198,11564,ZPbUovw1YoDeaWUVrbGEj5A5WdIXTYjf,SpATywNh6bZuzm8s1ceuBUnMUAeoAHHw,9,25,9,0,4,0,2,0,40,5.714285714285714,2,0.0,11,9,0,4,14,0,0,2,0,24,16,1
1199,11568,l1IK9ZY8MbRv8UoeCkxEH7P4W2dtATGX,SpATywNh6bZuzm8s1ceuBUnMUAeoAHHw,27,40,7,22,4,1,13,1,88,12.571428571428571,8,0.0,6,7,22,4,34,1,0,13,1,39,49,0
1200,11574,ypwDBeQLkxtWilMLhemtoXkZG88PSCik,SpATywNh6bZuzm8s1ceuBUnMUAeoAHHw,18,113,51,0,0,1,18,1,184,26.285714285714285,13,0.0,14,51,0,0,99,1,0,18,1,65,119,0
1201,11576,GKKNtfrAHKD2xUEQBz7HLN3kKO9SrWyD,SpATywNh6bZuzm8s1ceuBUnMUAeoAHHw,18,80,44,12,11,42,46,3,238,34.0,6,0.0,10,44,9,11,70,42,3,46,3,74,164,0
1202,11579,MgYx3sTen8piVhQ0ZPLZ6p6e7rh59bPE,SpATywNh6bZuzm8s1ceuBUnMUAeoAHHw,11,18,0,8,0,0,7,0,33,4.714285714285714,2,0.0,5,0,7,0,13,0,1,7,0,12,21,1
1203,11581,PXjkYsNMSYVKdz07qjMtS6mMBWIuSmKF,bWdj2GDclj5ofokWjzoa5jAwMkxCykd6,7,22,3,0,0,1,14,3,43,6.142857142857143,5,0.0,2,3,0,0,20,1,0,14,3,5,38,1
1204,11586,GIK69AVoFAXQo5stVHHEqOqo5xlrkSOx,SpATywNh6bZuzm8s1ceuBUnMUAeoAHHw,22,52,3,12,1,58,71,9,206,29.428571428571427,16,0.0,8,3,10,1,44,58,2,71,9,22,184,0
1205,11591,nlq4r6xc3rTUqTwcYhL6wudXdN6RIE52,A3fsA9Zfv1X2fVEQhTw51lKENdNrEqT3,43,42,31,0,18,0,13,0,104,14.857142857142858,5,0.0,0,31,0,18,42,0,0,13,0,49,55,0
1206,11593,wmwDf7eIRrKPL0l8cNmMygnEPd5vzoqs,SpATywNh6bZuzm8s1ceuBUnMUAeoAHHw,28,67,10,14,5,1,11,1,109,15.571428571428571,6,0.0,23,10,14,5,44,1,0,11,1,52,57,0
1207,11596,2AeMxbMeXomHZjSsEj2bsr8PzPP1Dh6q,bWdj2GDclj5ofokWjzoa5jAwMkxCykd6,16,46,21,32,5,12,21,2,139,19.857142857142858,2,0.0,12,21,30,5,34,12,2,21,2,68,71,1
1208,11599,GD5KzWMBHDnHVJHzVFtf3u7bIC7XYtJH,SpATywNh6bZuzm8s1ceuBUnMUAeoAHHw,25,76,2,36,1,3,46,1,165,23.571428571428573,12,0.0,8,2,28,1,68,3,8,46,1,39,126,0
1209,11600,IroEtJPlvjKfczRi5laeb2DQegyNKOWM,SpATywNh6bZuzm8s1ceuBUnMUAeoAHHw,17,23,13,10,6,7,5,0,64,9.142857142857142,2,0.0,6,13,8,6,17,7,2,5,0,33,31,0
1210,11603,wrdkNhe8GmpsjdZUr22H6zTi43mdouZW,SpATywNh6bZuzm8s1ceuBUnMUAeoAHHw,23,36,2,26,2,0,8,0,74,10.571428571428571,2,0.0,5,2,23,2,31,0,3,8,0,32,42,1
1211,11606,nNXCDU7pCvXdQPycxWESwEGIIRWvHKWv,A3fsA9Zfv1X2fVEQhTw51lKENdNrEqT3,1,0,0,0,0,0,1,0,1,0.14285714285714285,1,0.0,0,0,0,0,0,0,0,1,0,0,1,1
1212,11607,nNXCDU7pCvXdQPycxWESwEGIIRWvHKWv,bWdj2GDclj5ofokWjzoa5jAwMkxCykd6,6,13,3,0,2,14,3,1,36,5.142857142857143,1,0.0,0,3,0,2,13,14,0,3,1,5,31,1
1213,11609,lk3lGbNCFxoPG1OVILbfGp3s2wN91K2M,SpATywNh6bZuzm8s1ceuBUnMUAeoAHHw,5,9,1,0,0,0,1,0,11,1.5714285714285714,2,0.0,0,1,0,0,9,0,0,1,0,1,10,1
1214,11624,Kw83ufYGIFIihz0PdiaJro4hz0pKGozQ,SpATywNh6bZuzm8s1ceuBUnMUAeoAHHw,16,17,1,10,1,0,4,0,33,4.714285714285714,4,0.0,2,1,8,1,15,0,2,4,0,12,21,1
1215,11628,BHczT02DEALJmy7zbrGU6QbzLcOGM0Lz,SpATywNh6bZuzm8s1ceuBUnMUAeoAHHw,24,46,2,10,4,5,13,1,81,11.571428571428571,5,0.0,9,2,10,4,37,5,0,13,1,25,56,0
1216,11630,MR4k3wv95Ttq1fQaT9W4WgxrPezl0N4j,SpATywNh6bZuzm8s1ceuBUnMUAeoAHHw,5,3,1,0,1,0,4,0,9,1.2857142857142858,1,0.0,0,1,0,1,3,0,0,4,0,2,7,1
1217,11637,glYOnGBygagQ3d4VwvOcHKnCEWLKXuzk,SpATywNh6bZuzm8s1ceuBUnMUAeoAHHw,24,103,7,28,1,10,27,1,177,25.285714285714285,7,0.0,38,7,26,1,65,10,2,27,1,72,105,0
1218,11641,WHRYwHaNw8C182lJomkvSukjZ7e91Upo,SpATywNh6bZuzm8s1ceuBUnMUAeoAHHw,30,38,24,25,9,26,11,2,135,19.285714285714285,2,0.0,10,24,19,9,28,26,6,11,2,62,73,1
1219,11650,ilWzYGLWBh9DSc1MV8g2C4Go5wDNgUHX,SpATywNh6bZuzm8s1ceuBUnMUAeoAHHw,22,29,15,24,3,6,7,0,84,12.0,6,0.0,9,15,20,3,20,6,4,7,0,47,37,0
1220,11651,tnLfm9tutF6YoqDXNIONCmii1aynBy80,G8EPVSXsOYB5YQWZGiz1aVq5Pgr2GrQu,60,127,53,126,18,57,49,1,431,61.57142857142857,11,0.0,24,53,104,18,103,57,22,49,1,199,232,0
1221,11653,WHRYwHaNw8C182lJomkvSukjZ7e91Upo,G8EPVSXsOYB5YQWZGiz1aVq5Pgr2GrQu,64,72,24,130,14,26,13,2,281,40.142857142857146,4,0.0,40,24,88,14,32,26,42,13,2,166,115,1
1222,11668,3D1G3v8o9ZJD4YifQcvj5oZ6l4EKMMc3,SpATywNh6bZuzm8s1ceuBUnMUAeoAHHw,31,51,12,24,7,13,18,0,125,17.857142857142858,7,0.0,18,12,24,7,33,13,0,18,0,61,64,0
1223,11670,LJnHkVr961LFlbm7Gjo7zRYOv6MZ6dE5,bWdj2GDclj5ofokWjzoa5jAwMkxCykd6,6,4,2,0,1,0,4,0,11,1.5714285714285714,1,0.0,0,2,0,1,4,0,0,4,0,3,8,1
1224,11682,VLIaJAnZiJEAdolQsQ0bq4zJoZaIUmTN,SpATywNh6bZuzm8s1ceuBUnMUAeoAHHw,9,11,2,0,2,0,11,0,26,3.7142857142857144,3,0.0,0,2,0,2,11,0,0,11,0,4,22,1
1225,11688,QyLVPf4M60EkZ1E7DsOzioCPS0UDQt1T,SpATywNh6bZuzm8s1ceuBUnMUAeoAHHw,12,17,1,12,1,2,8,0,41,5.857142857142857,3,0.0,0,1,10,1,17,2,2,8,0,12,29,1
1226,11692,relWJA0qYE5Pue4C6aAwg584OGIxhwwx,A3fsA9Zfv1X2fVEQhTw51lKENdNrEqT3,1,0,0,0,0,0,2,0,2,0.2857142857142857,2,0.0,0,0,0,0,0,0,0,2,0,0,2,1
1227,11698,kVkYStq5954wY9YqVoootgnbo59g0CLi,SpATywNh6bZuzm8s1ceuBUnMUAeoAHHw,4,2,0,0,0,0,2,0,4,0.5714285714285714,1,0.0,0,0,0,0,2,0,0,2,0,0,4,1
1228,11699,fJdUKH8czX92V7yfMeG7e087z1xbQDMc,SpATywNh6bZuzm8s1ceuBUnMUAeoAHHw,30,28,17,14,8,3,9,0,79,11.285714285714286,4,0.0,7,17,14,8,21,3,0,9,0,46,33,0
1229,11704,DVIil2NM7ZWOtqe6rhlMzwEUAb2wuaeh,SpATywNh6bZuzm8s1ceuBUnMUAeoAHHw,21,52,26,6,7,11,13,1,116,16.571428571428573,6,0.0,10,26,6,7,42,11,0,13,1,49,67,1
1230,11719,cr12tMBqYKzLJbEmIsyFvFLKAg0DiCbM,SpATywNh6bZuzm8s1ceuBUnMUAeoAHHw,29,60,23,16,12,0,10,0,121,17.285714285714285,8,0.0,10,23,15,12,50,0,1,10,0,60,61,0
1231,11732,6L205IIarnrBFjrCXSXMQhtSJJ5O5hiQ,SpATywNh6bZuzm8s1ceuBUnMUAeoAHHw,29,122,61,26,27,3,26,18,283,40.42857142857143,4,0.0,33,61,21,27,89,3,5,26,18,142,141,0
1232,11737,vn3szbx80pQPfVJU7Et6YnUzTgKJ2evQ,A3fsA9Zfv1X2fVEQhTw51lKENdNrEqT3,8,3,2,0,2,0,5,0,12,1.7142857142857142,2,0.0,0,2,0,2,3,0,0,5,0,4,8,1
1233,11743,relWJA0qYE5Pue4C6aAwg584OGIxhwwx,SpATywNh6bZuzm8s1ceuBUnMUAeoAHHw,1,0,0,0,0,0,1,0,1,0.14285714285714285,1,0.0,0,0,0,0,0,0,0,1,0,0,1,1
1234,11765,CF9EOBndFkwfNq6XdrlnJGwplvjOhGZh,SpATywNh6bZuzm8s1ceuBUnMUAeoAHHw,22,62,4,31,0,23,13,0,133,19.0,2,0.0,25,4,29,0,37,23,2,13,0,58,75,0
1235,11773,gxkoHTlKe7FVuciB5TU7TNQLS1IuXLYY,SpATywNh6bZuzm8s1ceuBUnMUAeoAHHw,25,52,4,32,2,19,12,1,122,17.428571428571427,7,0.0,18,4,28,2,34,19,4,12,1,52,70,1
1236,11782,twnWF0mfZYHjmoqBvUs9g7jWpDxNR6WV,SpATywNh6bZuzm8s1ceuBUnMUAeoAHHw,27,59,20,22,4,17,16,1,139,19.857142857142858,4,0.0,34,20,20,4,25,17,2,16,1,78,61,1
1237,11795,iQzwToywLVi52lg7X1CKAqUmrJweCbY4,A3fsA9Zfv1X2fVEQhTw51lKENdNrEqT3,2,0,0,0,0,0,4,0,4,0.5714285714285714,1,0.0,0,0,0,0,0,0,0,4,0,0,4,1
1238,11796,5Pn4uvjsBWdhF0lVc4LtU6HIHnySgqaU,SpATywNh6bZuzm8s1ceuBUnMUAeoAHHw,1,0,0,0,0,0,1,0,1,0.14285714285714285,1,0.0,0,0,0,0,0,0,0,1,0,0,1,1
1239,11797,ejIJpZTu0P4rcWcZmBKl6OiURGceVpiA,SpATywNh6bZuzm8s1ceuBUnMUAeoAHHw,29,41,19,13,7,1,11,0,92,13.142857142857142,7,0.0,8,19,13,7,33,1,0,11,0,47,45,0
1240,11803,jpgFrFPODuxdIxVKUbbelvbFMPtUp7jo,SpATywNh6bZuzm8s1ceuBUnMUAeoAHHw,31,38,17,19,9,29,17,1,130,18.571428571428573,6,0.0,15,17,17,9,23,29,2,17,1,58,72,0
1241,11822,neCsLgPwvO3NM22QUF7ePoDh9jooDB1R,G8EPVSXsOYB5YQWZGiz1aVq5Pgr2GrQu,19,30,4,8,3,5,15,1,66,9.428571428571429,5,0.0,5,4,7,3,25,5,1,15,1,19,47,0
1242,11830,OJNek1dgn6lYb4ldZM3hUDbtlOcoRdmG,SpATywNh6bZuzm8s1ceuBUnMUAeoAHHw,14,11,7,11,5,0,3,0,37,5.285714285714286,2,0.0,2,7,10,5,9,0,1,3,0,24,13,0
1243,11866,0Ycdp4l6pgMwD7gJz4jynSnW5FA5aOcj,RXDvfPUBYFlVdlueBFbLW0mhhAyGEqpt,26,44,26,25,15,1,13,3,127,18.142857142857142,2,0.0,10,26,23,15,34,1,2,13,3,74,53,0
1244,11868,grkG64gC1ukbqi3lu9n1P24tGPzF2BzQ,SpATywNh6bZuzm8s1ceuBUnMUAeoAHHw,26,59,37,12,18,20,19,0,165,23.571428571428573,6,0.0,10,37,10,18,49,20,2,19,0,75,90,0
1245,11873,CLsYy7g1hYWHJyj1aROfKK9oTeo5yxJx,SpATywNh6bZuzm8s1ceuBUnMUAeoAHHw,30,42,19,29,8,8,15,1,122,17.428571428571427,6,0.0,13,19,26,8,29,8,3,15,1,66,56,0
1246,11875,s1zoJG6TsTv8LP9PRWCYbeiv4OLIivpy,SpATywNh6bZuzm8s1ceuBUnMUAeoAHHw,21,21,14,0,10,0,7,0,52,7.428571428571429,6,0.0,0,14,0,10,21,0,0,7,0,24,28,0
1247,11882,x5ZyS8ChPKTwgxrKWhGeApVsRxKYNf86,SpATywNh6bZuzm8s1ceuBUnMUAeoAHHw,18,27,0,12,1,2,10,0,52,7.428571428571429,2,0.0,14,0,9,1,13,2,3,10,0,24,28,1
1248,11885,5Yc9dIv7921c7z5p5LW8t3x8iddn1yRC,SpATywNh6bZuzm8s1ceuBUnMUAeoAHHw,30,81,23,35,10,5,20,1,175,25.0,3,0.0,19,23,33,10,62,5,2,20,1,85,90,1
1249,11891,BeyfLbwb8pdDQU6WTI5ee3FkxRPRP7B2,A3fsA9Zfv1X2fVEQhTw51lKENdNrEqT3,8,7,4,0,2,0,5,0,18,2.5714285714285716,3,0.0,0,4,0,2,7,0,0,5,0,6,12,1
1250,11898,pSPFAE8vJ6UClRkBsZEyTga6sVysOokX,SpATywNh6bZuzm8s1ceuBUnMUAeoAHHw,1,0,0,0,0,0,1,0,1,0.14285714285714285,1,0.0,0,0,0,0,0,0,0,1,0,0,1,1
1251,11909,Hh6CQ9eQF89j5a5Oi2NUf2uAs2DZd4QT,A3fsA9Zfv1X2fVEQhTw51lKENdNrEqT3,56,104,68,102,22,131,44,3,474,67.71428571428571,14,0.0,2,68,79,22,102,131,23,44,3,171,303,1
1252,11912,5FSqkpRO54sosmyXXDdXixBIUlxd8QNQ,SpATywNh6bZuzm8s1ceuBUnMUAeoAHHw,24,36,22,31,6,1,17,1,114,16.285714285714285,6,0.0,5,22,25,6,31,1,6,17,1,58,56,0
1253,11928,syrttArug8Mpzs9L0IHsvBtATawYF9J2,A3fsA9Zfv1X2fVEQhTw51lKENdNrEqT3,48,24,12,116,1,1,16,0,170,24.285714285714285,6,0.0,4,12,101,1,20,1,15,16,0,118,52,0
1254,11933,OmF4aFe06TkjIpsTgGpQ4vBzMWi2jjQV,bWdj2GDclj5ofokWjzoa5jAwMkxCykd6,52,49,25,146,13,0,30,1,264,37.714285714285715,7,0.0,11,25,120,13,38,0,26,30,1,169,95,0
1255,11955,oyFfPK6y9oPPwQR5mbsXW98FJaEnU88b,SpATywNh6bZuzm8s1ceuBUnMUAeoAHHw,14,24,9,16,6,2,4,0,61,8.714285714285714,3,0.0,10,9,15,6,14,2,1,4,0,40,21,1
1256,11958,HG2MGN3erjLUr4zPCv4UJukzIqIJPVZ2,SpATywNh6bZuzm8s1ceuBUnMUAeoAHHw,31,48,24,37,9,56,16,1,191,27.285714285714285,5,0.0,15,24,31,9,33,56,6,16,1,79,112,1
1257,11969,RhMByUF03fgdIuaHANL6m20mbMakGgJs,SpATywNh6bZuzm8s1ceuBUnMUAeoAHHw,22,56,29,0,13,0,9,0,107,15.285714285714286,5,0.0,5,29,0,13,51,0,0,9,0,47,60,0
1258,11975,MAjx1xtQvL5ZiofHx4xuO3WtfmkLHjqM,SpATywNh6bZuzm8s1ceuBUnMUAeoAHHw,21,26,16,0,11,1,5,0,59,8.428571428571429,4,0.0,3,16,0,11,23,1,0,5,0,30,29,1
1259,11981,FZjjoikxEifQwEx2vf6LYlhg4yyTwbym,A3fsA9Zfv1X2fVEQhTw51lKENdNrEqT3,34,62,30,24,14,34,32,0,196,28.0,9,0.0,5,30,19,14,57,34,5,32,0,68,128,1
1260,11982,BA5BMBRmhCtFQyjTLAMMLlVS5ABrW2hi,SpATywNh6bZuzm8s1ceuBUnMUAeoAHHw,22,28,12,24,5,4,8,1,82,11.714285714285714,4,0.0,7,12,20,5,21,4,4,8,1,44,38,0
1261,11998,NHPpKvbnrSpxM8e1DORBWJbRCpmrxZw8,SpATywNh6bZuzm8s1ceuBUnMUAeoAHHw,30,44,23,26,11,6,13,0,123,17.571428571428573,5,0.0,14,23,20,11,30,6,6,13,0,68,55,0
1262,12000,tncBhgwJEnaybUdK2e3UQ2PdOl85hyHm,SpATywNh6bZuzm8s1ceuBUnMUAeoAHHw,30,58,21,41,9,20,11,2,162,23.142857142857142,3,0.0,29,21,35,9,29,20,6,11,2,94,68,0
1263,12016,matrDCCbXVpxlcX50EwFfEaLRW1d7v0q,SpATywNh6bZuzm8s1ceuBUnMUAeoAHHw,9,13,3,0,1,1,5,0,23,3.2857142857142856,2,0.0,0,3,0,1,13,1,0,5,0,4,19,1
1264,12019,UaSh8dwx8gnofYbXlmpqj9uYDbpJ89pX,bWdj2GDclj5ofokWjzoa5jAwMkxCykd6,31,123,21,94,13,86,47,1,385,55.0,12,0.0,25,21,84,13,98,86,10,47,1,143,242,0
1265,12022,wHhHCETlsngCbxRgyphDRhWNDaw9hkb5,bWdj2GDclj5ofokWjzoa5jAwMkxCykd6,7,18,1,30,2,0,1,0,52,7.428571428571429,1,0.0,13,1,29,2,5,0,1,1,0,45,7,1
1266,12028,TnWxqbrMUttPbRmFwVduGXC6tM50wXNs,G8EPVSXsOYB5YQWZGiz1aVq5Pgr2GrQu,17,8,6,16,3,0,7,1,41,5.857142857142857,2,0.0,0,6,13,3,8,0,3,7,1,22,19,1
1267,12029,yj09XjzxRqPWNB0AOEufH55lHRijrBGr,A3fsA9Zfv1X2fVEQhTw51lKENdNrEqT3,11,7,3,0,3,0,6,0,19,2.7142857142857144,1,0.0,0,3,0,3,7,0,0,6,0,6,13,1
1268,12051,ECki0IXplihhOXFtHwNEOZv3lgdNQeLX,bWdj2GDclj5ofokWjzoa5jAwMkxCykd6,8,7,4,0,2,1,7,1,22,3.142857142857143,2,0.0,0,4,0,2,7,1,0,7,1,6,16,1
1269,12052,g3902agYIRHzac78MKVZlvljLMXXNpQ7,SpATywNh6bZuzm8s1ceuBUnMUAeoAHHw,31,55,32,34,11,1,24,0,157,22.428571428571427,9,0.0,9,32,30,11,46,1,4,24,0,82,75,0
1270,12058,iPBAJ9CVDCVYdsrujNIhJfrUSnaDCIHG,bWdj2GDclj5ofokWjzoa5jAwMkxCykd6,6,6,2,0,2,0,4,0,14,2.0,2,0.0,1,2,0,2,5,0,0,4,0,5,9,1
1271,12071,aeavxOLfuZgcJqnNwarxFiMVjjeJZrPA,SpATywNh6bZuzm8s1ceuBUnMUAeoAHHw,5,3,1,0,1,0,2,0,7,1.0,1,0.0,0,1,0,1,3,0,0,2,0,2,5,1
1272,12079,ZpZGRrq9otivAzXqSjL90NMLUImGmxsg,SpATywNh6bZuzm8s1ceuBUnMUAeoAHHw,6,7,1,0,0,0,2,0,10,1.4285714285714286,2,0.0,0,1,0,0,7,0,0,2,0,1,9,1
1273,12082,QWRabGXxCqME5Lkb4IAANkZxIcelEiGP,bWdj2GDclj5ofokWjzoa5jAwMkxCykd6,1,0,0,0,0,0,2,0,2,0.2857142857142857,1,0.0,0,0,0,0,0,0,0,2,0,0,2,1
1274,12083,U0kf3qSBRgyWv3qqGgGYInyPjg6gK9O9,RXDvfPUBYFlVdlueBFbLW0mhhAyGEqpt,1,0,0,0,0,0,1,0,1,0.14285714285714285,1,0.0,0,0,0,0,0,0,0,1,0,0,1,1
1275,12088,7yMNJWNsXgPHWgF0rje4LKKgdLbyOw5Y,A3fsA9Zfv1X2fVEQhTw51lKENdNrEqT3,4,3,2,0,0,0,1,0,6,0.8571428571428571,1,0.0,0,2,0,0,3,0,0,1,0,2,4,1
1276,12097,LclkEDGY7WCR76zraNkzkcQywMJivp2l,SpATywNh6bZuzm8s1ceuBUnMUAeoAHHw,31,93,29,42,19,6,20,2,211,30.142857142857142,5,0.0,25,29,36,19,68,6,6,20,2,109,102,1
1277,12100,tCXa4pMsMXRuliZWNM9so3Odte6UmpYj,A3fsA9Zfv1X2fVEQhTw51lKENdNrEqT3,1,0,0,0,0,0,1,0,1,0.14285714285714285,1,0.0,0,0,0,0,0,0,0,1,0,0,1,1
1278,12111,1GWkEwQ90VRdtDsFxjla0MbrnOSbAEId,RXDvfPUBYFlVdlueBFbLW0mhhAyGEqpt,4,2,0,0,0,0,2,0,4,0.5714285714285714,1,0.0,0,0,0,0,2,0,0,2,0,0,4,1
1279,12119,x0VzAeYdlywtGLqE1HF68qQMYZTLfsw9,A3fsA9Zfv1X2fVEQhTw51lKENdNrEqT3,66,62,43,124,14,7,18,0,268,38.285714285714285,9,0.0,4,43,114,14,58,7,10,18,0,175,93,1
1280,12126,32uJBAomTJQIXKZnCX4K7PYoVfESGbct,RXDvfPUBYFlVdlueBFbLW0mhhAyGEqpt,63,94,51,120,35,0,9,0,309,44.142857142857146,6,0.0,29,51,111,35,65,0,9,9,0,226,83,1
1281,12127,HElrq1eSGzBafUMUdvN7RCubKET34OTX,SpATywNh6bZuzm8s1ceuBUnMUAeoAHHw,1,0,0,0,0,0,1,0,1,0.14285714285714285,1,0.0,0,0,0,0,0,0,0,1,0,0,1,1
1282,12137,jkbAnCxwl3OIEg7uH62X9N4RjNwDvZxg,SpATywNh6bZuzm8s1ceuBUnMUAeoAHHw,21,36,15,0,10,0,8,0,69,9.857142857142858,7,0.0,5,15,0,10,31,0,0,8,0,30,39,1
1283,12139,i8WIZSEgsoHBi5QZhvayPbZQldL0txWw,A3fsA9Zfv1X2fVEQhTw51lKENdNrEqT3,7,3,2,0,2,0,3,0,10,1.4285714285714286,1,0.0,0,2,0,2,3,0,0,3,0,4,6,1
1284,12144,4JPTMOEW3QvxnvFVxcqBPUVqTDTMZIow,SpATywNh6bZuzm8s1ceuBUnMUAeoAHHw,1,0,0,0,0,0,2,0,2,0.2857142857142857,1,0.0,0,0,0,0,0,0,0,2,0,0,2,1
1285,12166,x6CSpC8D3vQdEDfFDD93c2HvZ1J8Rtto,RXDvfPUBYFlVdlueBFbLW0mhhAyGEqpt,66,87,57,124,21,31,10,0,330,47.142857142857146,3,0.0,20,57,112,21,67,31,12,10,0,210,120,1
1286,12171,eAArxLyCThtu9N3Mv8rQculKbGSa66j9,SpATywNh6bZuzm8s1ceuBUnMUAeoAHHw,10,12,8,0,2,9,12,0,43,6.142857142857143,6,0.0,0,8,0,2,12,9,0,12,0,10,33,1
1287,12182,rdSWxFhXxAq7LLsaFRDkga5HDqBXvg9z,bWdj2GDclj5ofokWjzoa5jAwMkxCykd6,2,0,0,0,0,0,2,0,2,0.2857142857142857,1,0.0,0,0,0,0,0,0,0,2,0,0,2,1
1288,12193,ajHCgh5jQq7dgoaNHY1H5hSSSFewTHW9,A3fsA9Zfv1X2fVEQhTw51lKENdNrEqT3,2,0,0,0,0,0,2,0,2,0.2857142857142857,1,0.0,0,0,0,0,0,0,0,2,0,0,2,1
1289,12197,RPansaKc9yPYyKahcqLAJO6a0GoBHglr,SpATywNh6bZuzm8s1ceuBUnMUAeoAHHw,31,66,36,17,21,5,23,1,169,24.142857142857142,9,0.0,14,36,16,21,52,5,1,23,1,87,82,0
1290,12202,rdSWxFhXxAq7LLsaFRDkga5HDqBXvg9z,A3fsA9Zfv1X2fVEQhTw51lKENdNrEqT3,7,5,1,0,1,0,2,0,9,1.2857142857142858,1,0.0,0,1,0,1,5,0,0,2,0,2,7,1
1291,12212,KXPHZfgM3L9NmmWzrburRZrpNwRct3s8,SpATywNh6bZuzm8s1ceuBUnMUAeoAHHw,32,54,24,43,8,12,19,2,162,23.142857142857142,5,0.0,22,24,37,8,32,12,6,19,2,91,71,1
1292,12220,9b4Qm8eSvDuZev1N90TcJBdVRXi0Jx1k,SpATywNh6bZuzm8s1ceuBUnMUAeoAHHw,25,26,2,39,1,5,9,1,83,11.857142857142858,3,0.0,10,2,33,1,16,5,6,9,1,46,37,1
1293,12255,lCVPDaggOlwGJsnAJvi5aMCj1weM2Pue,SpATywNh6bZuzm8s1ceuBUnMUAeoAHHw,6,3,2,0,2,0,1,0,8,1.1428571428571428,1,0.0,0,2,0,2,3,0,0,1,0,4,4,1
1294,12257,Htb70W0lnqw4QeBjeePevzE0xRg4O6vF,A3fsA9Zfv1X2fVEQhTw51lKENdNrEqT3,12,11,10,0,0,1,4,0,26,3.7142857142857144,1,0.0,0,10,0,0,11,1,0,4,0,10,16,1
1295,12258,Htb70W0lnqw4QeBjeePevzE0xRg4O6vF,bWdj2GDclj5ofokWjzoa5jAwMkxCykd6,1,0,0,0,0,0,2,0,2,0.2857142857142857,1,0.0,0,0,0,0,0,0,0,2,0,0,2,1
1296,12270,mccn7oMsSoLGVTk06xkhM1ICp7gdLXuk,SpATywNh6bZuzm8s1ceuBUnMUAeoAHHw,20,35,17,19,6,2,13,1,93,13.285714285714286,4,0.0,12,17,16,6,23,2,3,13,1,51,42,1
1297,12276,lCVPDaggOlwGJsnAJvi5aMCj1weM2Pue,A3fsA9Zfv1X2fVEQhTw51lKENdNrEqT3,4,2,1,0,1,0,1,0,5,0.7142857142857143,1,0.0,0,1,0,1,2,0,0,1,0,2,3,1
1298,12281,lCVPDaggOlwGJsnAJvi5aMCj1weM2Pue,bWdj2GDclj5ofokWjzoa5jAwMkxCykd6,6,6,1,0,1,0,2,0,10,1.4285714285714286,1,0.0,0,1,0,1,6,0,0,2,0,2,8,1
1299,12289,j3c6K94i9dgmcXc2NErAuVxnWFJZj8tT,bWdj2GDclj5ofokWjzoa5jAwMkxCykd6,7,4,3,0,2,0,2,0,11,1.5714285714285714,2,0.0,0,3,0,2,4,0,0,2,0,5,6,1
1300,12299,fa6SZdwIb8QmMO5YcB5PQzrN75peDxq7,G8EPVSXsOYB5YQWZGiz1aVq5Pgr2GrQu,5,3,2,0,1,0,1,0,7,1.0,1,0.0,0,2,0,1,3,0,0,1,0,3,4,1
1301,12301,OeLBIzS0gNQ56euxy5b66gAZMzQCGE7n,bWdj2GDclj5ofokWjzoa5jAwMkxCykd6,1,0,0,0,0,0,1,0,1,0.14285714285714285,1,0.0,0,0,0,0,0,0,0,1,0,0,1,1
1302,12308,CQOn4KWCA0duDCOSP1DQzvXZ3yAfq1zW,SpATywNh6bZuzm8s1ceuBUnMUAeoAHHw,32,62,36,40,12,35,27,1,213,30.428571428571427,8,0.0,14,36,34,12,48,35,6,27,1,96,117,0
1303,12317,niLMw8MCObO7SSR2V1jNg9WQt5oSjDFJ,A3fsA9Zfv1X2fVEQhTw51lKENdNrEqT3,14,12,7,0,5,0,4,0,28,4.0,3,0.0,0,7,0,5,12,0,0,4,0,12,16,1
1304,12320,niLMw8MCObO7SSR2V1jNg9WQt5oSjDFJ,SpATywNh6bZuzm8s1ceuBUnMUAeoAHHw,9,14,7,0,3,0,7,0,31,4.428571428571429,4,0.0,2,7,0,3,12,0,0,7,0,12,19,1
1305,12321,g3902agYIRHzac78MKVZlvljLMXXNpQ7,A3fsA9Zfv1X2fVEQhTw51lKENdNrEqT3,25,20,14,0,8,2,23,2,69,9.857142857142858,6,0.0,0,14,0,8,20,2,0,23,2,22,47,1
1306,12323,dceX0m9075YvlWaEabJwd03DyXl3MtL8,SpATywNh6bZuzm8s1ceuBUnMUAeoAHHw,23,52,16,22,3,1,12,3,109,15.571428571428571,6,0.0,24,16,19,3,28,1,3,12,3,62,47,0
1307,12328,lCVPDaggOlwGJsnAJvi5aMCj1weM2Pue,RXDvfPUBYFlVdlueBFbLW0mhhAyGEqpt,7,5,4,0,1,0,1,0,11,1.5714285714285714,1,0.0,0,4,0,1,5,0,0,1,0,5,6,1
1308,12332,ncwdVeNEm9rMUWWKD40nNQFCSGSrd8Qu,SpATywNh6bZuzm8s1ceuBUnMUAeoAHHw,1,0,0,0,0,0,1,0,1,0.14285714285714285,1,0.0,0,0,0,0,0,0,0,1,0,0,1,1
1309,12333,8V1FCzMo3zMKQW1ts44FS8gSim8xyz9W,G8EPVSXsOYB5YQWZGiz1aVq5Pgr2GrQu,4,2,1,0,1,0,1,0,5,0.7142857142857143,1,0.0,0,1,0,1,2,0,0,1,0,2,3,1
1310,12348,ZhTCqX8GMUcn0a0betuEauHNuCk1aRhm,A3fsA9Zfv1X2fVEQhTw51lKENdNrEqT3,81,67,33,162,9,84,24,0,379,54.142857142857146,9,0.0,9,33,145,9,58,84,17,24,0,196,183,0
1311,12351,f5nUM7X4snZl1Dwk9DyOLQ7PstRe3yG1,SpATywNh6bZuzm8s1ceuBUnMUAeoAHHw,17,12,8,21,5,0,11,0,57,8.142857142857142,3,0.0,2,8,17,5,10,0,4,11,0,32,25,1
1312,12371,Dx1ZzKpwFtwNhE9gdaLaohssqGyqrqjD,SpATywNh6bZuzm8s1ceuBUnMUAeoAHHw,31,70,31,26,10,70,23,2,232,33.142857142857146,8,0.0,23,31,20,10,47,70,6,23,2,84,148,0
1313,12384,bKVslXuzEQ1pv4c6iV5mVjs6X6avUbmL,RXDvfPUBYFlVdlueBFbLW0mhhAyGEqpt,62,433,206,61,43,813,366,97,2019,288.42857142857144,18,0.0,17,206,53,43,416,813,8,366,97,319,1700,0
1314,12386,Ak5p1JsyLmT4pGKGNb849PzZbmvFekml,SpATywNh6bZuzm8s1ceuBUnMUAeoAHHw,11,15,4,12,2,0,2,0,35,5.0,1,0.0,10,4,11,2,5,0,1,2,0,27,8,1
1315,12389,DNxlKJNm5ao3DSObllNvFwn0RJUn50Hh,SpATywNh6bZuzm8s1ceuBUnMUAeoAHHw,1,0,0,0,0,0,1,0,1,0.14285714285714285,1,0.0,0,0,0,0,0,0,0,1,0,0,1,1
1316,12402,3z0hX7DEeFfsgBAb2GCqLtG7EloWzN4g,bWdj2GDclj5ofokWjzoa5jAwMkxCykd6,5,4,1,0,0,0,3,0,8,1.1428571428571428,2,0.0,0,1,0,0,4,0,0,3,0,1,7,1
1317,12409,Io5gLr8QOxaBw8nFReloAXOpt3IlZ5WE,SpATywNh6bZuzm8s1ceuBUnMUAeoAHHw,6,6,1,0,0,0,7,0,14,2.0,4,0.0,0,1,0,0,6,0,0,7,0,1,13,0
1318,12415,9xXPu4XrxUEQD4kiDWTsMvTkTFxGkYzI,A3fsA9Zfv1X2fVEQhTw51lKENdNrEqT3,44,35,17,64,11,0,3,0,130,18.571428571428573,4,0.0,3,17,55,11,32,0,9,3,0,86,44,1
1319,12430,w62eko3BoCGIpZmfYYoFjoaBC9TFzjaB,SpATywNh6bZuzm8s1ceuBUnMUAeoAHHw,32,34,18,30,9,33,19,1,144,20.571428571428573,4,0.0,9,18,25,9,25,33,5,19,1,61,83,1
1320,12431,dOkXreE5Co54rqG7YecVg356rhQtEiRH,SpATywNh6bZuzm8s1ceuBUnMUAeoAHHw,14,15,1,21,0,1,8,0,46,6.571428571428571,3,0.0,7,1,17,0,8,1,4,8,0,25,21,1
1321,12440,48vx3qHAZvBzdWBXsxihTari5aBTmUGi,SpATywNh6bZuzm8s1ceuBUnMUAeoAHHw,16,12,6,0,4,2,12,2,38,5.428571428571429,1,0.0,0,6,0,4,12,2,0,12,2,10,28,1
1322,12448,AQaaG4AcAnObnM2M4NcHCUkX6lEg0Mlu,SpATywNh6bZuzm8s1ceuBUnMUAeoAHHw,30,33,16,33,8,6,16,1,113,16.142857142857142,3,0.0,12,16,29,8,21,6,4,16,1,65,48,1
1323,12473,Jn3Y3EwJczNHkfzTGUpSSJOFpEETB0cw,A3fsA9Zfv1X2fVEQhTw51lKENdNrEqT3,2,0,0,0,0,0,4,0,4,0.5714285714285714,2,0.0,0,0,0,0,0,0,0,4,0,0,4,1
1324,12484,yEuZmA9AbYZaWqEfxA4FratjPoewKT3C,bWdj2GDclj5ofokWjzoa5jAwMkxCykd6,10,14,7,0,6,4,11,2,44,6.285714285714286,2,0.0,4,7,0,6,10,4,0,11,2,17,27,1
1325,12488,UkVp32qxLqsEWmDdG99xhNvtg1mVGbkd,SpATywNh6bZuzm8s1ceuBUnMUAeoAHHw,17,36,14,20,3,7,10,0,90,12.857142857142858,2,0.0,12,14,16,3,24,7,4,10,0,45,45,1
1326,12513,Jn3Y3EwJczNHkfzTGUpSSJOFpEETB0cw,SpATywNh6bZuzm8s1ceuBUnMUAeoAHHw,13,16,5,0,5,0,5,0,31,4.428571428571429,2,0.0,0,5,0,5,16,0,0,5,0,10,21,1
1327,12517,VfrUmEAx0ZYYX6kUXFzpxLwtafRhi7qR,SpATywNh6bZuzm8s1ceuBUnMUAeoAHHw,5,2,1,0,1,0,2,0,6,0.8571428571428571,1,0.0,0,1,0,1,2,0,0,2,0,2,4,1
1328,12518,4IkxYjTflPhoHxhEdrFyf3T4ZXNMTaKd,SpATywNh6bZuzm8s1ceuBUnMUAeoAHHw,27,46,20,26,7,0,4,0,103,14.714285714285714,3,0.0,10,20,25,7,36,0,1,4,0,62,41,0
1329,12521,jCbueeMsegjPu59bj6eGJyYcDxtIb05e,bWdj2GDclj5ofokWjzoa5jAwMkxCykd6,7,4,1,4,1,0,3,0,13,1.8571428571428572,1,0.0,2,1,3,1,2,0,1,3,0,7,6,1
1330,12536,XKtSJUu70kLs3jRiKFAR2MlWI70CZUcv,G8EPVSXsOYB5YQWZGiz1aVq5Pgr2GrQu,30,60,3,2,5,3,18,2,93,13.285714285714286,3,0.0,8,3,1,5,52,3,1,18,2,17,76,0
1331,12540,nlq4r6xc3rTUqTwcYhL6wudXdN6RIE52,bWdj2GDclj5ofokWjzoa5jAwMkxCykd6,12,8,7,0,7,6,5,0,33,4.714285714285714,3,0.0,0,7,0,7,8,6,0,5,0,14,19,1
1332,12546,LRHDYNgQAsG2UssS8TgaqkiYDbFlVrrj,A3fsA9Zfv1X2fVEQhTw51lKENdNrEqT3,24,41,30,0,14,5,17,2,109,15.571428571428571,5,0.0,1,30,0,14,40,5,0,17,2,45,64,1
1333,12547,IImOhpbuTNHI88DulkMnjvsH7H0HMncx,SpATywNh6bZuzm8s1ceuBUnMUAeoAHHw,4,2,1,0,1,0,1,0,5,0.7142857142857143,1,0.0,0,1,0,1,2,0,0,1,0,2,3,1
1334,12556,InTDVHpDSVoZu5vOSvueBLdJOgZb9Qu8,A3fsA9Zfv1X2fVEQhTw51lKENdNrEqT3,8,5,3,0,1,7,4,0,20,2.857142857142857,1,0.0,0,3,0,1,5,7,0,4,0,4,16,1
1335,12557,Vx74c4EnHqTcmxhMcO6kRvadcvYQC7Hl,SpATywNh6bZuzm8s1ceuBUnMUAeoAHHw,24,56,27,11,8,1,22,0,125,17.857142857142858,10,0.0,6,27,10,8,50,1,1,22,0,51,74,0
1336,12564,D59LfxtLBEXUXJuXCGYTJcy2S1d5nPYE,SpATywNh6bZuzm8s1ceuBUnMUAeoAHHw,19,26,5,13,3,0,8,0,55,7.857142857142857,6,0.0,4,5,12,3,22,0,1,8,0,24,31,0
1337,12566,ph8ToQs4xH6gdMMZGt7KWlSytujO4hy7,bWdj2GDclj5ofokWjzoa5jAwMkxCykd6,28,49,25,46,7,10,21,0,158,22.571428571428573,5,0.0,7,25,44,7,42,10,2,21,0,83,75,0
1338,12590,g8m22R7W0Wo8v9RXY0TMbj5qf5RFgvht,A3fsA9Zfv1X2fVEQhTw51lKENdNrEqT3,49,53,38,54,23,0,14,0,182,26.0,5,0.0,7,38,53,23,46,0,1,14,0,121,61,1
1339,12592,VwUXTBGJaTv5xN1He6TwE1OKxII3IUB4,A3fsA9Zfv1X2fVEQhTw51lKENdNrEqT3,17,13,9,0,5,2,16,2,47,6.714285714285714,2,0.0,1,9,0,5,12,2,0,16,2,15,32,1
1340,12598,0MgLdwlRWQ7TpUbl7lDTcNpvvpvRxwZk,SpATywNh6bZuzm8s1ceuBUnMUAeoAHHw,15,16,9,2,5,0,5,0,37,5.285714285714286,4,0.0,1,9,2,5,15,0,0,5,0,17,20,1
1341,12602,8g5cBj0Gjzli28QiIdgpvFAz2836fyoV,A3fsA9Zfv1X2fVEQhTw51lKENdNrEqT3,14,20,13,0,7,1,13,1,55,7.857142857142857,3,0.0,0,13,0,7,20,1,0,13,1,20,35,1
1342,12628,JaYbgvhgx43SysY9J8DaCR3IcdUzCcUf,SpATywNh6bZuzm8s1ceuBUnMUAeoAHHw,16,25,0,6,0,0,7,0,38,5.428571428571429,6,0.0,2,0,6,0,23,0,0,7,0,8,30,0
1343,12643,8DlfU1bgriTJuUO8vI8x268Lnn7yRdfp,bWdj2GDclj5ofokWjzoa5jAwMkxCykd6,5,2,1,0,1,3,4,0,11,1.5714285714285714,2,0.0,0,1,0,1,2,3,0,4,0,2,9,1
1344,12665,2DNSh2UatQFpodq67CmKbjqpA6AJb7Oi,SpATywNh6bZuzm8s1ceuBUnMUAeoAHHw,28,30,14,18,8,0,14,0,84,12.0,4,0.0,11,14,17,8,19,0,1,14,0,50,34,0
1345,12671,UcbTdkZF8IIJuBiyaeVa5dJ5AMKloTWJ,A3fsA9Zfv1X2fVEQhTw51lKENdNrEqT3,1,0,0,0,0,0,1,0,1,0.14285714285714285,1,0.0,0,0,0,0,0,0,0,1,0,0,1,1
1346,12676,NGkJealfvLzyvMkO29aSPohtdMh2i3ow,SpATywNh6bZuzm8s1ceuBUnMUAeoAHHw,18,21,13,6,7,1,2,0,50,7.142857142857143,2,0.0,6,13,6,7,15,1,0,2,0,32,18,1
1347,12678,v8Csqzh937f2Vg9ZqHM3p8LLheZjBof3,SpATywNh6bZuzm8s1ceuBUnMUAeoAHHw,13,15,2,0,1,0,3,0,21,3.0,2,0.0,3,2,0,1,12,0,0,3,0,6,15,0
1348,12691,nUlI6cjptTLAgli6MFzyKD61AHPa0Ow2,SpATywNh6bZuzm8s1ceuBUnMUAeoAHHw,7,4,3,0,2,0,1,0,10,1.4285714285714286,1,0.0,0,3,0,2,4,0,0,1,0,5,5,1
1349,12694,EelXsFqmLbbOgu7NMVlCz136fL2FTkZO,G8EPVSXsOYB5YQWZGiz1aVq5Pgr2GrQu,17,49,18,0,10,0,6,0,83,11.857142857142858,6,0.0,2,18,0,10,47,0,0,6,0,30,53,1
1350,12702,piMSzq394zCurmILy54TdIfNK5vFDgeH,SpATywNh6bZuzm8s1ceuBUnMUAeoAHHw,10,17,10,0,2,1,11,1,42,6.0,2,0.0,0,10,0,2,17,1,0,11,1,12,30,1
1351,12717,pXqbqKhLN9u2vMm4aIB5JwL5PRPhZDCp,A3fsA9Zfv1X2fVEQhTw51lKENdNrEqT3,4,2,0,0,0,0,3,0,5,0.7142857142857143,2,0.0,0,0,0,0,2,0,0,3,0,0,5,0
1352,12725,yXkO3eR7yt6I5YPt7SbP4lJC7f4DWsPi,SpATywNh6bZuzm8s1ceuBUnMUAeoAHHw,22,72,6,55,3,12,13,0,161,23.0,6,0.0,16,6,44,3,56,12,11,13,0,69,92,0
1353,12741,yFLanYq8p4sf6NFSB1Td9ag6632plY4t,A3fsA9Zfv1X2fVEQhTw51lKENdNrEqT3,27,32,25,0,18,1,13,1,90,12.857142857142858,6,0.0,0,25,0,18,32,1,0,13,1,43,47,0
1354,12743,qWbrTjg87QoJMjqclpcgpkGIkTTfGYPg,SpATywNh6bZuzm8s1ceuBUnMUAeoAHHw,1,0,0,0,0,0,1,0,1,0.14285714285714285,1,0.0,0,0,0,0,0,0,0,1,0,0,1,1
1355,12762,u82lBhpDxJIwlZISEntCxj1zgVFdW0vT,A3fsA9Zfv1X2fVEQhTw51lKENdNrEqT3,1,0,0,0,0,0,3,0,3,0.42857142857142855,2,0.0,0,0,0,0,0,0,0,3,0,0,3,1
1356,12781,xI2qMeJnp6aq2CKhFmXJQYegY0eBgJqh,SpATywNh6bZuzm8s1ceuBUnMUAeoAHHw,16,72,27,4,10,0,9,0,122,17.428571428571427,8,0.0,27,27,4,10,45,0,0,9,0,68,54,0
1357,12786,rZSLmwiYX8trzeLsBLeg8r0IN1GBbqOC,RXDvfPUBYFlVdlueBFbLW0mhhAyGEqpt,1,0,0,0,0,0,1,0,1,0.14285714285714285,1,0.0,0,0,0,0,0,0,0,1,0,0,1,1
1358,12788,rZSLmwiYX8trzeLsBLeg8r0IN1GBbqOC,A3fsA9Zfv1X2fVEQhTw51lKENdNrEqT3,50,20,11,104,3,0,14,0,152,21.714285714285715,3,0.0,3,11,92,3,17,0,12,14,0,109,43,0
1359,12797,0r0opwFyJ4N25MV6ZjVs69MBQP4LTfaz,RXDvfPUBYFlVdlueBFbLW0mhhAyGEqpt,72,77,47,152,21,10,11,4,322,46.0,5,0.0,23,47,146,21,54,10,6,11,4,237,85,0
1360,12798,SZOXOmDilP1KR3OJXHpIlLf61tEoqX1S,SpATywNh6bZuzm8s1ceuBUnMUAeoAHHw,20,39,0,26,0,12,13,2,92,13.142857142857142,3,0.0,18,0,23,0,21,12,3,13,2,41,51,1
1361,12801,N5iDERl36Pe29yDG8gDe9a99dYgqwB7y,bWdj2GDclj5ofokWjzoa5jAwMkxCykd6,33,36,8,141,2,0,15,0,202,28.857142857142858,5,0.0,9,8,119,2,27,0,22,15,0,138,64,1
1362,12802,n2H1RsIyXGWShdCbCzwLRVNV0gBoMcRI,bWdj2GDclj5ofokWjzoa5jAwMkxCykd6,12,14,7,4,5,0,12,1,43,6.142857142857143,3,0.0,5,7,4,5,9,0,0,12,1,21,22,1
1363,12803,P0uW8e7uWJsgVO5MWg1krlEvXljM181Y,A3fsA9Zfv1X2fVEQhTw51lKENdNrEqT3,2,0,0,0,0,0,2,0,2,0.2857142857142857,1,0.0,0,0,0,0,0,0,0,2,0,0,2,1
1364,12817,n2H1RsIyXGWShdCbCzwLRVNV0gBoMcRI,A3fsA9Zfv1X2fVEQhTw51lKENdNrEqT3,2,0,0,0,0,0,3,0,3,0.42857142857142855,2,0.0,0,0,0,0,0,0,0,3,0,0,3,1
1365,12830,L0KQTTHes3X5LPSdqQrdBMVgea19D6tJ,SpATywNh6bZuzm8s1ceuBUnMUAeoAHHw,27,57,29,14,13,0,10,0,123,17.571428571428573,7,0.0,7,29,14,13,50,0,0,10,0,63,60,1
1366,12838,D1VQybdJv05b8bnQWlTwVLnxuzPr9TGg,SpATywNh6bZuzm8s1ceuBUnMUAeoAHHw,32,55,18,38,7,1,25,2,146,20.857142857142858,7,0.0,17,18,33,7,38,1,5,25,2,75,71,0
1367,12850,cVHCYdG6eoXKQe55dLZbvLgwBGbWam7p,SpATywNh6bZuzm8s1ceuBUnMUAeoAHHw,10,12,0,0,0,1,15,1,29,4.142857142857143,2,0.0,2,0,0,0,10,1,0,15,1,2,27,1
1368,12861,clcszcRJ03jiyZ5GYQyVZZ7N7YqBvRWN,G8EPVSXsOYB5YQWZGiz1aVq5Pgr2GrQu,8,12,9,0,5,1,3,0,30,4.285714285714286,1,0.0,0,9,0,5,12,1,0,3,0,14,16,1
1369,12876,birimXAhV5T8auACU6PoAgdoddyc5gxF,SpATywNh6bZuzm8s1ceuBUnMUAeoAHHw,20,16,8,16,4,6,5,1,56,8.0,1,0.0,6,8,15,4,10,6,1,5,1,33,23,1
1370,12878,nxXaLxK1WzKt8vz8gfQ7mw2jj0DmsYuz,SpATywNh6bZuzm8s1ceuBUnMUAeoAHHw,24,29,0,27,1,1,31,2,91,13.0,10,0.0,8,0,23,1,21,1,4,31,2,32,59,0
1371,12886,jitS86VYMmQkiBJMhbTP5ghyPiIbWGe4,SpATywNh6bZuzm8s1ceuBUnMUAeoAHHw,7,13,1,0,0,4,3,1,22,3.142857142857143,1,0.0,2,1,0,0,11,4,0,3,1,3,19,1
1372,12898,P0uW8e7uWJsgVO5MWg1krlEvXljM181Y,RXDvfPUBYFlVdlueBFbLW0mhhAyGEqpt,2,0,0,0,0,0,2,0,2,0.2857142857142857,1,0.0,0,0,0,0,0,0,0,2,0,0,2,1
1373,12911,qAfzRWdcV29MrGV4Q3OpnDw6sMEqxrsX,SpATywNh6bZuzm8s1ceuBUnMUAeoAHHw,6,4,0,0,0,0,3,0,7,1.0,1,0.0,0,0,0,0,4,0,0,3,0,0,7,1
1374,12919,UaSh8dwx8gnofYbXlmpqj9uYDbpJ89pX,SpATywNh6bZuzm8s1ceuBUnMUAeoAHHw,12,33,3,0,0,204,30,5,275,39.285714285714285,6,0.0,7,3,0,0,26,204,0,30,5,10,265,0
1375,12920,C7qRsA5jr1OEmJhfxUyc4ekgHn4q4XXi,SpATywNh6bZuzm8s1ceuBUnMUAeoAHHw,10,62,15,0,0,3,11,0,91,13.0,5,0.0,1,15,0,0,61,3,0,11,0,16,75,1
1376,12922,uqIn0vdfJ1SDJCOeCVEAQPRFBBKQA2eB,A3fsA9Zfv1X2fVEQhTw51lKENdNrEqT3,99,69,32,190,24,0,23,0,338,48.285714285714285,7,0.0,3,32,173,24,66,0,17,23,0,232,106,1
1377,12939,BZIh5Ji4WRsl5XFn0vcayrSAt3EwPPq7,SpATywNh6bZuzm8s1ceuBUnMUAeoAHHw,25,50,1,33,1,1,23,2,111,15.857142857142858,9,0.0,14,1,28,1,36,1,5,23,2,44,67,0
1378,12941,agXxlcmOoEfRNuHGmntEOJrJqSCOihJk,SpATywNh6bZuzm8s1ceuBUnMUAeoAHHw,22,36,0,18,0,1,10,1,66,9.428571428571429,7,0.0,8,0,18,0,28,1,0,10,1,26,40,1
1379,12960,QxcB9RiJu5tiHZOch1DPGex1fIsAotsI,SpATywNh6bZuzm8s1ceuBUnMUAeoAHHw,27,79,5,28,3,40,48,8,211,30.142857142857142,12,0.0,23,5,23,3,56,40,5,48,8,54,157,0
1380,12970,GR6VeteR9GEbfhgsQCuQ7IOGLVIdLf6Q,SpATywNh6bZuzm8s1ceuBUnMUAeoAHHw,10,20,1,2,0,0,4,0,27,3.857142857142857,3,0.0,1,1,2,0,19,0,0,4,0,4,23,0
1381,12973,7fFZLbLMI7Ucj1mdrBxpY9hCEcczhOLF,RXDvfPUBYFlVdlueBFbLW0mhhAyGEqpt,52,59,8,100,2,5,24,2,200,28.571428571428573,9,0.0,15,8,98,2,44,5,2,24,2,123,77,0
1382,12987,d1JMD7qxfNKpLgzBvlpfaUYeKyTI6qbc,RXDvfPUBYFlVdlueBFbLW0mhhAyGEqpt,15,9,6,0,5,1,9,0,30,4.285714285714286,2,0.0,0,6,0,5,9,1,0,9,0,11,19,0
1383,12998,MM2B2653YFHORo361rzambfOSuqgdvxU,SpATywNh6bZuzm8s1ceuBUnMUAeoAHHw,27,35,16,20,6,4,12,0,93,13.285714285714286,8,0.0,12,16,17,6,23,4,3,12,0,51,42,1
1384,13002,qBuOYvjWXxAt6x3Clq0Mm94iVtXMfRzl,A3fsA9Zfv1X2fVEQhTw51lKENdNrEqT3,42,23,18,60,15,3,9,2,130,18.571428571428573,2,0.0,2,18,49,15,21,3,11,9,2,84,46,1
1385,13021,rXHS1nVaWODpE4oMoF8GV1PH34kuNjhN,A3fsA9Zfv1X2fVEQhTw51lKENdNrEqT3,50,34,23,68,13,6,14,0,158,22.571428571428573,3,0.0,3,23,63,13,31,6,5,14,0,102,56,1
1386,13024,gdBVlnD2M7V6ljn8vJvT9NnajpxXqL1v,SpATywNh6bZuzm8s1ceuBUnMUAeoAHHw,28,41,15,18,9,1,11,0,95,13.571428571428571,5,0.0,14,15,15,9,27,1,3,11,0,53,42,1
1387,13026,nE3rPlTTHJqOdfeqGlvnz4cddsiodod7,SpATywNh6bZuzm8s1ceuBUnMUAeoAHHw,4,2,0,0,0,0,2,0,4,0.5714285714285714,1,0.0,0,0,0,0,2,0,0,2,0,0,4,0
1388,13038,Ys5FH0nq7NeLEdwGoDUOp7Sz8iAMAB3d,SpATywNh6bZuzm8s1ceuBUnMUAeoAHHw,18,80,24,5,6,0,11,0,126,18.0,4,0.0,5,24,4,6,75,0,1,11,0,39,87,1
1389,13049,8nRie7othcdG0O4zmQQo2Wo4gx8ixPWA,SpATywNh6bZuzm8s1ceuBUnMUAeoAHHw,8,3,0,0,0,1,6,1,11,1.5714285714285714,1,0.0,0,0,0,0,3,1,0,6,1,0,11,1
1390,13064,FH8uaUgDtH5I6cjMpNACS7MT4OVRdm6l,SpATywNh6bZuzm8s1ceuBUnMUAeoAHHw,25,29,3,26,1,3,14,1,77,11.0,5,0.0,8,3,23,1,21,3,3,14,1,35,42,0
1391,13068,Oewk1cgUhxDAPgxI9Y8opSnbFrQ56lFp,G8EPVSXsOYB5YQWZGiz1aVq5Pgr2GrQu,29,38,15,26,9,3,31,0,122,17.428571428571427,5,0.0,7,15,22,9,31,3,4,31,0,53,69,0
1392,13079,UnqeeEn98S2A9CknpatcyHPMxgZC4vhi,bWdj2GDclj5ofokWjzoa5jAwMkxCykd6,12,17,10,56,0,2,9,0,94,13.428571428571429,2,0.0,4,10,53,0,13,2,3,9,0,67,27,1
1393,13084,iKiK6wMQ7FsUhBHmZmA4WSvuLlgoIAIT,SpATywNh6bZuzm8s1ceuBUnMUAeoAHHw,29,44,19,12,7,1,5,0,88,12.571428571428571,4,0.0,20,19,12,7,24,1,0,5,0,58,30,1
1394,13087,JuiV77lwSiyunloCdIxpEqZLnyAIWuGF,SpATywNh6bZuzm8s1ceuBUnMUAeoAHHw,28,93,18,37,8,58,33,0,247,35.285714285714285,7,0.0,31,18,31,8,62,58,6,33,0,88,159,1
1395,13093,X0UQZEMetzdnutZa926McNof6mCEs6hL,bWdj2GDclj5ofokWjzoa5jAwMkxCykd6,19,13,2,220,4,12,8,1,260,37.142857142857146,3,0.0,3,2,214,4,10,12,6,8,1,223,37,0
1396,13096,WkW7xhOBov4cdi1HI8MIcYy2tcL8JIqM,G8EPVSXsOYB5YQWZGiz1aVq5Pgr2GrQu,29,33,13,74,6,1,16,0,143,20.428571428571427,5,0.0,18,13,58,6,15,1,16,16,0,95,48,0
1397,13097,jSElHDudYQXAurrUrZvr8PEvqza2483p,SpATywNh6bZuzm8s1ceuBUnMUAeoAHHw,22,48,5,15,5,25,41,5,144,20.571428571428573,7,0.0,6,5,13,5,42,25,2,41,5,29,115,0
1398,13118,VSdgqyGl0eURAhfgbcwFZu4zgDm6da40,A3fsA9Zfv1X2fVEQhTw51lKENdNrEqT3,7,8,0,0,0,0,7,0,15,2.142857142857143,1,0.0,0,0,0,0,8,0,0,7,0,0,15,1
1399,13123,DER7joh3KQKE4dEofQirnM23uWHXKmaD,SpATywNh6bZuzm8s1ceuBUnMUAeoAHHw,2,0,0,0,0,0,2,0,2,0.2857142857142857,1,0.0,0,0,0,0,0,0,0,2,0,0,2,1
1400,13126,zEeuqWNlBTdOCPxX0tLPUzZrt62Jaced,SpATywNh6bZuzm8s1ceuBUnMUAeoAHHw,19,32,2,19,2,0,10,0,65,9.285714285714286,1,0.0,14,2,17,2,18,0,2,10,0,35,30,1
1401,13150,5LHFGZp52JmCecbZlM5IR7cocsBDm2vK,A3fsA9Zfv1X2fVEQhTw51lKENdNrEqT3,1,0,0,0,0,0,2,0,2,0.2857142857142857,1,0.0,0,0,0,0,0,0,0,2,0,0,2,1
1402,13160,i9EYjpibuPRn90FUwaEumbd5PTkZZAqq,SpATywNh6bZuzm8s1ceuBUnMUAeoAHHw,1,0,0,0,0,0,1,0,1,0.14285714285714285,1,0.0,0,0,0,0,0,0,0,1,0,0,1,1
1403,13162,PLNAK5eO2jDldFb2P1VVgW3GLNYSW1XE,A3fsA9Zfv1X2fVEQhTw51lKENdNrEqT3,58,25,1,128,0,20,12,1,187,26.714285714285715,4,0.0,3,1,112,0,22,20,16,12,1,116,71,1
1404,13167,c1zDCPDnvv0eep80ND9h9tNicqqWeY8x,SpATywNh6bZuzm8s1ceuBUnMUAeoAHHw,4,2,1,0,1,0,1,0,5,0.7142857142857143,1,0.0,0,1,0,1,2,0,0,1,0,2,3,1
1405,13169,VD51DafWdYqPb9OUf4DGqW0cSE2mdG9x,RXDvfPUBYFlVdlueBFbLW0mhhAyGEqpt,49,49,30,75,15,14,13,0,196,28.0,5,0.0,12,30,70,15,37,14,5,13,0,127,69,0
1406,13171,Xz4KwNrqILWO256erDoEJKlZ22fLi17K,bWdj2GDclj5ofokWjzoa5jAwMkxCykd6,8,12,0,74,2,0,9,0,97,13.857142857142858,4,0.0,6,0,73,2,6,0,1,9,0,81,16,1
1407,13182,Gur5FuhE9EyV9K1F0qLPk7AenhoY8PBS,A3fsA9Zfv1X2fVEQhTw51lKENdNrEqT3,30,41,14,0,10,0,17,0,82,11.714285714285714,4,0.0,0,14,0,10,41,0,0,17,0,24,58,0
1408,13202,Oyq7ji1m15xuxwPKjm7Gg05YiNCQEcyW,A3fsA9Zfv1X2fVEQhTw51lKENdNrEqT3,4,2,1,0,1,0,1,0,5,0.7142857142857143,1,0.0,0,1,0,1,2,0,0,1,0,2,3,1
1409,13205,t0soD7aQ6w7DGyhmXz7wyAfUbtBWT4NA,SpATywNh6bZuzm8s1ceuBUnMUAeoAHHw,6,7,2,0,1,0,3,1,14,2.0,1,0.0,4,2,0,1,3,0,0,3,1,7,7,1
1410,13213,fvcf8Mss4D9M5Dkk5Dn5T9NiTapwZ9dB,A3fsA9Zfv1X2fVEQhTw51lKENdNrEqT3,34,11,6,80,5,0,8,0,110,15.714285714285714,2,0.0,4,6,65,5,7,0,15,8,0,80,30,1
1411,13215,YKsQbxqCbn9zYlM8hXkeyvve9j97h5Fs,SpATywNh6bZuzm8s1ceuBUnMUAeoAHHw,5,2,1,0,1,0,2,0,6,0.8571428571428571,1,0.0,0,1,0,1,2,0,0,2,0,2,4,1
1412,13231,CGCo1ulRSzYrFke9WXpheptgBfQxf2gK,SpATywNh6bZuzm8s1ceuBUnMUAeoAHHw,30,66,32,25,13,16,27,2,181,25.857142857142858,9,0.0,16,32,23,13,50,16,2,27,2,84,97,0
1413,13243,D3y4ChHgB3o0JcWw3QbeyrPnD6ZSD4me,SpATywNh6bZuzm8s1ceuBUnMUAeoAHHw,4,0,0,0,0,8,4,1,13,1.8571428571428572,1,0.0,0,0,0,0,0,8,0,4,1,0,13,1
1414,13268,eAArxLyCThtu9N3Mv8rQculKbGSa66j9,G8EPVSXsOYB5YQWZGiz1aVq5Pgr2GrQu,111,101,37,297,23,26,23,0,507,72.42857142857143,5,0.0,60,37,214,23,41,26,83,23,0,334,173,0
1415,13270,ffLXxfgMU4yir9uI5fIkKo2iZzEw2Lpz,SpATywNh6bZuzm8s1ceuBUnMUAeoAHHw,21,23,15,0,8,4,12,0,62,8.857142857142858,6,0.0,0,15,0,8,23,4,0,12,0,23,39,1
1416,13278,XwU61hOxlE8cqDut2rPIgRseTsxZ07jG,SpATywNh6bZuzm8s1ceuBUnMUAeoAHHw,24,81,12,40,1,8,9,0,151,21.571428571428573,3,0.0,58,12,36,1,23,8,4,9,0,107,44,0
1417,13284,HmCqvdVQxacevQymd3KKpvfG444InuCU,RXDvfPUBYFlVdlueBFbLW0mhhAyGEqpt,57,68,40,144,0,0,7,0,259,37.0,3,0.0,23,40,140,0,45,0,4,7,0,203,56,0
1418,13294,kI6cheDOBy9s4ZYk6wZ8CKNoQdId12d9,SpATywNh6bZuzm8s1ceuBUnMUAeoAHHw,11,13,6,0,2,2,16,6,45,6.428571428571429,2,0.0,0,6,0,2,13,2,0,16,6,8,37,1
1419,13297,0b8UUNX7vDapSg0uCVOk0glpsbuPbDat,SpATywNh6bZuzm8s1ceuBUnMUAeoAHHw,31,82,31,36,14,73,22,2,260,37.142857142857146,11,0.0,36,31,30,14,46,73,6,22,2,111,149,0
1420,13305,QIQR6VwK3cpUKM5lDzadEKeQATM23w8z,RXDvfPUBYFlVdlueBFbLW0mhhAyGEqpt,1,0,0,0,0,0,1,0,1,0.14285714285714285,1,0.0,0,0,0,0,0,0,0,1,0,0,1,1
1421,13309,1dxQmK9WwlHWuIG7ZTn4PsJ2vflQBDH3,A3fsA9Zfv1X2fVEQhTw51lKENdNrEqT3,13,12,3,16,1,0,7,0,39,5.571428571428571,4,0.0,0,3,12,1,12,0,4,7,0,16,23,0
1422,13312,9aWGLeAVHncegHPXAP1qMMyzvcIDPZKu,A3fsA9Zfv1X2fVEQhTw51lKENdNrEqT3,42,26,21,164,0,7,17,2,237,33.857142857142854,3,0.0,1,21,132,0,25,7,32,17,2,154,83,1
1423,13318,Xzt2w1aRoJeIAP02oHWxu8IVeFzxqDvF,SpATywNh6bZuzm8s1ceuBUnMUAeoAHHw,30,93,29,49,22,9,18,3,223,31.857142857142858,4,0.0,16,29,40,22,77,9,9,18,3,107,116,0
1424,13324,NuZwpz0U4SxzLHddLsrKCkHdkj5yyqPt,A3fsA9Zfv1X2fVEQhTw51lKENdNrEqT3,40,57,3,60,0,0,8,1,129,18.428571428571427,3,0.0,3,3,54,0,54,0,6,8,1,60,69,1
1425,13327,M3xTB6LenTJvMpybZKparVtRZKzrRM1R,SpATywNh6bZuzm8s1ceuBUnMUAeoAHHw,28,83,35,20,9,108,41,3,299,42.714285714285715,4,0.0,21,35,19,9,62,108,1,41,3,84,215,0
1426,13335,BuvcW1QbEkmICBwJsmVk62irFMyFXFIl,SpATywNh6bZuzm8s1ceuBUnMUAeoAHHw,6,4,2,0,1,0,2,0,9,1.2857142857142858,1,0.0,0,2,0,1,4,0,0,2,0,3,6,0
1427,13350,ooqIS0ldRRRaqJrrOHVscbkigkM4wbN5,SpATywNh6bZuzm8s1ceuBUnMUAeoAHHw,15,17,14,0,10,0,5,0,46,6.571428571428571,3,0.0,0,14,0,10,17,0,0,5,0,24,22,0
1428,13353,Aw7PeIkLW9CDHbPpPSjrFUdtBaUuHUXm,A3fsA9Zfv1X2fVEQhTw51lKENdNrEqT3,95,56,42,192,22,4,70,0,386,55.142857142857146,14,0.0,5,42,157,22,51,4,35,70,0,226,160,0
1429,13357,sFfdfS73lXtMTUaBLpEd17ZzknvXcxlF,G8EPVSXsOYB5YQWZGiz1aVq5Pgr2GrQu,5,3,1,0,1,0,2,0,7,1.0,1,0.0,0,1,0,1,3,0,0,2,0,2,5,1
1430,13389,suNtRVoL26o1uoSjCtTBYoEROkIKHNRV,SpATywNh6bZuzm8s1ceuBUnMUAeoAHHw,21,46,6,10,3,10,7,0,82,11.714285714285714,3,0.0,16,6,10,3,30,10,0,7,0,35,47,0
1431,13392,Zp81uMflvqqrfEwxhUzFhFbNFp63e2qq,SpATywNh6bZuzm8s1ceuBUnMUAeoAHHw,25,101,5,33,1,6,19,1,166,23.714285714285715,9,0.0,26,5,30,1,75,6,3,19,1,62,104,0
1432,13395,eq0kQUYo3qpAoZ9JUGvTejR7TbE9dl0n,A3fsA9Zfv1X2fVEQhTw51lKENdNrEqT3,1,0,0,0,0,0,2,0,2,0.2857142857142857,1,0.0,0,0,0,0,0,0,0,2,0,0,2,1
1433,13417,P6cCvRjvbpDjgLjSjFoCoaUi3J3jrMaV,bWdj2GDclj5ofokWjzoa5jAwMkxCykd6,19,55,3,94,5,6,27,2,192,27.428571428571427,4,0.0,14,3,90,5,41,6,4,27,2,112,80,1
1434,13419,zFUDj5TvEjIvvTLimj5EmmmOcToptA99,bWdj2GDclj5ofokWjzoa5jAwMkxCykd6,5,2,1,0,1,0,2,0,6,0.8571428571428571,1,0.0,0,1,0,1,2,0,0,2,0,2,4,1
1435,13426,PfZH4Yubwsve9DvShzAvHjayDN16nhpN,RXDvfPUBYFlVdlueBFbLW0mhhAyGEqpt,2,0,0,0,0,0,2,0,2,0.2857142857142857,1,0.0,0,0,0,0,0,0,0,2,0,0,2,1
1436,13434,xzjKh0on5UQxslbqX3WgWTiQPFL3pvFu,A3fsA9Zfv1X2fVEQhTw51lKENdNrEqT3,9,7,5,0,3,0,3,0,18,2.5714285714285716,2,0.0,0,5,0,3,7,0,0,3,0,8,10,1
1437,13436,0wXXwNeE6W7NBvQ3k3OMvVCCQezsKKgg,SpATywNh6bZuzm8s1ceuBUnMUAeoAHHw,24,43,19,22,14,0,3,0,101,14.428571428571429,2,0.0,6,19,19,14,37,0,3,3,0,58,43,1
1438,13442,Q459I6WtHQ4LYscZN5C0n5NrNaEwzARk,A3fsA9Zfv1X2fVEQhTw51lKENdNrEqT3,5,2,1,0,1,0,6,0,10,1.4285714285714286,2,0.0,0,1,0,1,2,0,0,6,0,2,8,0
1439,13466,G9zssYsMiy0OM7PcLiakkEdvgznZi21h,bWdj2GDclj5ofokWjzoa5jAwMkxCykd6,10,7,4,22,2,0,2,0,37,5.285714285714286,2,0.0,1,4,18,2,6,0,4,2,0,25,12,1
1440,13468,LSqC7qdkRAhbSsajNxT5pt4NlUyn2gsl,SpATywNh6bZuzm8s1ceuBUnMUAeoAHHw,6,5,4,0,4,0,1,0,14,2.0,1,0.0,0,4,0,4,5,0,0,1,0,8,6,1
1441,13488,3szdu9Q6Oikq1zf8fBs2hQUGk7dqskOy,SpATywNh6bZuzm8s1ceuBUnMUAeoAHHw,13,11,2,14,2,0,4,0,33,4.714285714285714,1,0.0,3,2,13,2,8,0,1,4,0,20,13,1
1442,13502,Zdseq1rQmkAi5wZl57d3RwjzOxlL3B5I,A3fsA9Zfv1X2fVEQhTw51lKENdNrEqT3,47,56,38,62,14,18,42,6,236,33.714285714285715,9,0.0,4,38,51,14,52,18,11,42,6,107,129,0
1443,13503,2YfvPW4RjjB1wuYNlMfzfMUdSCE4Rwzu,SpATywNh6bZuzm8s1ceuBUnMUAeoAHHw,17,28,1,17,1,24,16,3,90,12.857142857142858,6,0.0,3,1,14,1,25,24,3,16,3,19,71,0
1444,13513,OsjipUObm67JsyJjOy7xHoa32L8CSYg5,RXDvfPUBYFlVdlueBFbLW0mhhAyGEqpt,20,26,4,11,2,9,5,0,57,8.142857142857142,3,0.0,0,4,11,2,26,9,0,5,0,17,40,0
1445,13514,XDXCn0FDh32qCzKi52Qo5wbWma8m1QWg,SpATywNh6bZuzm8s1ceuBUnMUAeoAHHw,2,0,0,0,0,0,2,0,2,0.2857142857142857,1,0.0,0,0,0,0,0,0,0,2,0,0,2,1
1446,13529,Ge8ZKyoh7v3U8XFFvvntz8tE5dDD1txz,SpATywNh6bZuzm8s1ceuBUnMUAeoAHHw,17,38,15,15,5,11,26,4,114,16.285714285714285,4,0.0,14,15,12,5,24,11,3,26,4,46,68,1
1447,13538,LjMEB9aIUIvEfq4JTf4C9ef9fHbbyj0M,SpATywNh6bZuzm8s1ceuBUnMUAeoAHHw,31,63,22,42,13,17,15,1,173,24.714285714285715,7,0.0,32,22,36,13,31,17,6,15,1,103,70,0
1448,13539,UCcQjKn5wSzQ8Z7Gu1uECZPrSwuRD4I9,SpATywNh6bZuzm8s1ceuBUnMUAeoAHHw,4,3,1,0,1,0,3,0,8,1.1428571428571428,1,0.0,0,1,0,1,3,0,0,3,0,2,6,1
1449,13541,dQ6ARJIxCHLlztvK37NHQ0C1ttipx0zg,SpATywNh6bZuzm8s1ceuBUnMUAeoAHHw,21,30,16,13,8,4,6,0,77,11.0,5,0.0,8,16,12,8,22,4,1,6,0,44,33,0
1450,13561,i6CSuJ6asUrdPRp5edOkSDBKGwbyCy2y,bWdj2GDclj5ofokWjzoa5jAwMkxCykd6,3,0,0,0,0,1,4,0,5,0.7142857142857143,1,0.0,0,0,0,0,0,1,0,4,0,0,5,1
1451,13562,Du4OhdznDw29gaWDeHXBUWRKyEVAbHaQ,SpATywNh6bZuzm8s1ceuBUnMUAeoAHHw,31,67,32,31,9,1,35,1,176,25.142857142857142,10,0.0,21,32,22,9,46,1,9,35,1,84,92,0
1452,13568,r0yAsNzYkqEPYi6zNhQfzuueDjmcyFRr,G8EPVSXsOYB5YQWZGiz1aVq5Pgr2GrQu,103,92,60,172,22,0,21,1,368,52.57142857142857,3,0.0,28,60,140,22,64,0,32,21,1,250,118,1
1453,13571,QFQlbn421RXpUzVVaKhkxpBlvQfTJy18,SpATywNh6bZuzm8s1ceuBUnMUAeoAHHw,29,48,23,40,9,0,11,0,131,18.714285714285715,5,0.0,19,23,34,9,29,0,6,11,0,85,46,0
1454,13574,BOWTvQlkFu3OONGPj2orMpzJbZOzBXuG,SpATywNh6bZuzm8s1ceuBUnMUAeoAHHw,25,47,3,26,0,50,31,4,161,23.0,7,0.0,11,3,23,0,36,50,3,31,4,37,124,0
1455,13577,r9n2Z7iYkL5tKegLJwMIOxTHQqxopYp0,SpATywNh6bZuzm8s1ceuBUnMUAeoAHHw,25,42,23,30,10,0,10,0,115,16.428571428571427,10,0.0,9,23,25,10,33,0,5,10,0,67,48,1
1456,13591,thD3JQHh1xpY9SdL9w6TAUhWjJrPsSHi,SpATywNh6bZuzm8s1ceuBUnMUAeoAHHw,23,53,22,21,10,7,15,1,129,18.428571428571427,4,0.0,20,22,18,10,33,7,3,15,1,70,59,0
1457,13596,SuKlsA6xoxq9JGrANP30LMW7qjrc07fy,bWdj2GDclj5ofokWjzoa5jAwMkxCykd6,23,33,21,82,5,0,14,0,155,22.142857142857142,3,0.0,7,21,75,5,26,0,7,14,0,108,47,1
1458,13603,2YfvPW4RjjB1wuYNlMfzfMUdSCE4Rwzu,RXDvfPUBYFlVdlueBFbLW0mhhAyGEqpt,5,7,0,0,0,6,3,0,16,2.2857142857142856,1,0.0,0,0,0,0,7,6,0,3,0,0,16,0
1459,13611,taXwAmoyCNDGaXo8nVRGsDZwnk4if3bF,SpATywNh6bZuzm8s1ceuBUnMUAeoAHHw,24,78,20,14,6,2,16,1,137,19.571428571428573,6,0.0,23,20,13,6,55,2,1,16,1,62,75,0
1460,13615,SFczaSY6Hc3uft6fwzUwvxTQx8AOyArS,G8EPVSXsOYB5YQWZGiz1aVq5Pgr2GrQu,21,57,2,36,8,9,14,2,128,18.285714285714285,2,0.0,30,2,27,8,27,9,9,14,2,67,61,1
1461,13617,q1nSg7gMR4fmcENPvRW7b84TFAk5YaYv,SpATywNh6bZuzm8s1ceuBUnMUAeoAHHw,25,72,1,27,1,17,23,2,143,20.428571428571427,5,0.0,20,1,23,1,52,17,4,23,2,45,98,1
1462,13619,q1nSg7gMR4fmcENPvRW7b84TFAk5YaYv,bWdj2GDclj5ofokWjzoa5jAwMkxCykd6,1,0,0,0,0,0,1,0,1,0.14285714285714285,1,0.0,0,0,0,0,0,0,0,1,0,0,1,1
1463,13625,Df1QcOycdzVWQv3hsgRFSNdSZglUPcB7,SpATywNh6bZuzm8s1ceuBUnMUAeoAHHw,1,0,0,0,0,0,2,0,2,0.2857142857142857,1,0.0,0,0,0,0,0,0,0,2,0,0,2,1
1464,13627,Df1QcOycdzVWQv3hsgRFSNdSZglUPcB7,G8EPVSXsOYB5YQWZGiz1aVq5Pgr2GrQu,1,0,0,0,0,0,1,0,1,0.14285714285714285,1,0.0,0,0,0,0,0,0,0,1,0,0,1,1
1465,13635,ePpfrPKFmuYE4CHcpunEZ73b0FxyOz0q,A3fsA9Zfv1X2fVEQhTw51lKENdNrEqT3,100,48,30,198,19,6,34,1,336,48.0,7,0.0,4,30,167,19,44,6,31,34,1,220,116,1
1466,13639,6ZFGnTjh94PbXkR7sbTLWokikXbcLQlV,A3fsA9Zfv1X2fVEQhTw51lKENdNrEqT3,13,14,6,8,0,0,13,0,41,5.857142857142857,3,0.0,1,6,8,0,13,0,0,13,0,15,26,0
1467,13643,kF8fYPSPVuf77u2d6KdtH12htaNTxyrR,SpATywNh6bZuzm8s1ceuBUnMUAeoAHHw,5,7,1,0,1,0,2,0,11,1.5714285714285714,2,0.0,0,1,0,1,7,0,0,2,0,2,9,1
1468,13645,FOoOtP9CvNldG35bvwpepCilGCCL9n8O,SpATywNh6bZuzm8s1ceuBUnMUAeoAHHw,24,43,26,15,15,0,16,0,115,16.428571428571427,4,0.0,3,26,13,15,40,0,2,16,0,57,58,1
1469,13646,2gMbFqhNbghdA4J5huVDcJIix3xmMqms,SpATywNh6bZuzm8s1ceuBUnMUAeoAHHw,29,54,14,33,7,20,18,1,147,21.0,6,0.0,17,14,28,7,37,20,5,18,1,66,81,1
1470,13655,5LtufKrJgtzGXPllU5SjGTHr8eJRp7wi,SpATywNh6bZuzm8s1ceuBUnMUAeoAHHw,9,4,3,0,3,0,2,0,12,1.7142857142857142,1,0.0,0,3,0,3,4,0,0,2,0,6,6,1
1471,13658,BRb6GOIqcgYg1e6c431h8FubF4jTJim3,SpATywNh6bZuzm8s1ceuBUnMUAeoAHHw,28,57,6,22,3,3,23,4,118,16.857142857142858,6,0.0,11,6,18,3,46,3,4,23,4,38,80,1
1472,13663,oNStIislotbuK2XCCskaFe8CInb3EbrY,bWdj2GDclj5ofokWjzoa5jAwMkxCykd6,3,3,0,0,0,0,1,0,4,0.5714285714285714,1,0.0,1,0,0,0,2,0,0,1,0,1,3,1
1473,13666,Y0LHIPeN84CX2pJB37p6sblq4PhQo9k4,SpATywNh6bZuzm8s1ceuBUnMUAeoAHHw,22,27,4,30,3,1,7,0,72,10.285714285714286,4,0.0,7,4,29,3,20,1,1,7,0,43,29,1
1474,13668,ZFgJH3XPKn6EjDuXV9VLOpKftzENCqEZ,G8EPVSXsOYB5YQWZGiz1aVq5Pgr2GrQu,42,69,42,74,10,38,23,1,257,36.714285714285715,9,0.0,10,42,63,10,59,38,11,23,1,125,132,0
1475,13677,ZFgJH3XPKn6EjDuXV9VLOpKftzENCqEZ,RXDvfPUBYFlVdlueBFbLW0mhhAyGEqpt,33,63,43,27,10,25,19,0,187,26.714285714285715,6,0.0,7,43,27,10,56,25,0,19,0,87,100,0
1476,13688,1TRHxgoibI9N1jVfz15wdiz3VF8KLiZV,G8EPVSXsOYB5YQWZGiz1aVq5Pgr2GrQu,8,5,4,0,4,0,2,0,15,2.142857142857143,1,0.0,0,4,0,4,5,0,0,2,0,8,7,1
1477,13690,XkKS323fFxBVezQ5JyIgzxHDxEKEwwEf,bWdj2GDclj5ofokWjzoa5jAwMkxCykd6,10,12,4,14,3,0,2,0,35,5.0,1,0.0,4,4,14,3,8,0,0,2,0,25,10,1
1478,13692,dB9soxJVmgwXZSiR7r7fYfCigeYZx4rK,SpATywNh6bZuzm8s1ceuBUnMUAeoAHHw,8,6,4,0,3,1,4,0,18,2.5714285714285716,3,0.0,0,4,0,3,6,1,0,4,0,7,11,1
1479,13695,eosk3dY7502Pbg6Dsnx0qWKWUpRTliXK,SpATywNh6bZuzm8s1ceuBUnMUAeoAHHw,19,38,7,12,5,0,8,0,70,10.0,6,0.0,5,7,9,5,33,0,3,8,0,26,44,1
1480,13722,MFpshextOJLHhySF4C6u9eWxWZPDeRiA,SpATywNh6bZuzm8s1ceuBUnMUAeoAHHw,5,3,1,0,1,0,5,0,10,1.4285714285714286,3,0.0,1,1,0,1,2,0,0,5,0,3,7,1
1481,13725,r0yAsNzYkqEPYi6zNhQfzuueDjmcyFRr,A3fsA9Zfv1X2fVEQhTw51lKENdNrEqT3,2,0,0,0,0,0,3,0,3,0.42857142857142855,1,0.0,0,0,0,0,0,0,0,3,0,0,3,1
1482,13746,QNA44zjiZdozxT5YpeINlRZRlMKPMkhp,A3fsA9Zfv1X2fVEQhTw51lKENdNrEqT3,21,20,17,0,17,0,1,0,55,7.857142857142857,2,0.0,0,17,0,17,20,0,0,1,0,34,21,1
1483,13752,GUhU3sa7QMussHGi4kspdulqSqF9Ft42,SpATywNh6bZuzm8s1ceuBUnMUAeoAHHw,25,69,4,33,3,35,25,1,170,24.285714285714285,11,0.0,22,4,27,3,47,35,6,25,1,56,114,0
1484,13756,zx92A3etlZOmjWi19IMDYlwaWCkvF08z,SpATywNh6bZuzm8s1ceuBUnMUAeoAHHw,6,18,2,0,2,0,3,0,25,3.5714285714285716,3,0.0,2,2,0,2,16,0,0,3,0,6,19,1
1485,13765,rtYqtRTnqUXb6diSp0MKjdA0eLt2BJ3X,A3fsA9Zfv1X2fVEQhTw51lKENdNrEqT3,1,0,0,0,0,0,4,0,4,0.5714285714285714,3,0.0,0,0,0,0,0,0,0,4,0,0,4,1
1486,13770,73akjB4xSPosxH1enrEsMGxNVgbw9q8A,SpATywNh6bZuzm8s1ceuBUnMUAeoAHHw,20,48,20,6,13,2,5,0,94,13.428571428571429,4,0.0,0,20,5,13,48,2,1,5,0,38,56,1
1487,13771,I1KwJ6EdCZnEPLfC8Q7yWpIkLOHn7h02,A3fsA9Zfv1X2fVEQhTw51lKENdNrEqT3,65,71,44,128,22,0,25,1,291,41.57142857142857,9,0.0,4,44,103,22,67,0,25,25,1,173,118,1
1488,13776,PUFh3BsQaDVIJMDvwsFTqkrgAzvjO9ME,A3fsA9Zfv1X2fVEQhTw51lKENdNrEqT3,22,34,23,0,9,7,17,1,91,13.0,4,0.0,1,23,0,9,33,7,0,17,1,33,58,0
1489,13783,LnPF2pHnhCMvVEpluujjfPcHsgc8Fmmk,bWdj2GDclj5ofokWjzoa5jAwMkxCykd6,1,0,0,0,0,0,1,0,1,0.14285714285714285,1,0.0,0,0,0,0,0,0,0,1,0,0,1,1
1490,13793,1Uc6kG05PFkTNzxuWvIFBwjY8EtNBPxQ,A3fsA9Zfv1X2fVEQhTw51lKENdNrEqT3,2,0,0,0,0,0,5,0,5,0.7142857142857143,2,0.0,0,0,0,0,0,0,0,5,0,0,5,1
1491,14546,82UlWF6Fm1gkNum7nNbVw0yOV1BUdNoS,7GRhBDsirIGkRZBtSMEzNTyDr2JQm4xx,50,133,51,74,30,55,13,0,356,50.857142857142854,9,0.0,68,51,60,30,65,55,14,13,0,209,147,1
1492,14552,gmqCuQTX0aljJXYwlMbQKWVNQXzJBU7z,7GRhBDsirIGkRZBtSMEzNTyDr2JQm4xx,13,13,9,0,4,20,23,2,71,10.142857142857142,5,0.0,0,9,0,4,13,20,0,23,2,13,58,0
1493,14609,Q9kdHcV1kbonm0KnIW9OSERwU5lfVZ8s,7GRhBDsirIGkRZBtSMEzNTyDr2JQm4xx,91,269,52,95,50,27,17,2,512,73.14285714285714,8,0.0,129,52,77,50,140,27,18,17,2,308,204,1
1494,14627,wXa3VpbKMQY5nmCqd1pDfzVK4mBWfzPA,7GRhBDsirIGkRZBtSMEzNTyDr2JQm4xx,5,3,1,0,0,6,5,1,16,2.2857142857142856,1,0.0,0,1,0,0,3,6,0,5,1,1,15,1
1495,14654,StcQZMEDAMldF4GFQUzkrPFNVNZnPaeq,7GRhBDsirIGkRZBtSMEzNTyDr2JQm4xx,70,308,98,129,62,64,29,7,697,99.57142857142857,7,0.0,194,98,99,62,114,64,30,29,7,453,244,0
1496,14715,WuM67GwQW9M3d1mnuGHuvAdo907S9qb5,7GRhBDsirIGkRZBtSMEzNTyDr2JQm4xx,1,0,0,0,0,0,1,0,1,0.14285714285714285,1,0.0,0,0,0,0,0,0,0,1,0,0,1,1
1497,14729,vfwAUxRdOnC4hT5Ba9e9XvBRXfww6oyg,7GRhBDsirIGkRZBtSMEzNTyDr2JQm4xx,12,7,5,0,2,0,8,1,23,3.2857142857142856,2,0.0,0,5,0,2,7,0,0,8,1,7,16,1
1498,14738,QqvzSns2WWHJJpRBF1DJin1UI4cHoJM0,7GRhBDsirIGkRZBtSMEzNTyDr2JQm4xx,53,95,24,78,27,3,14,1,242,34.57142857142857,3,0.0,51,24,69,27,44,3,9,14,1,171,71,1
1499,14744,fznl9GLBUcCuiLFhCkHOSxn8Xeb6YOkl,7GRhBDsirIGkRZBtSMEzNTyDr2JQm4xx,48,95,42,76,47,67,15,0,342,48.857142857142854,5,0.0,53,42,62,47,42,67,14,15,0,204,138,1
1500,14778,SxA4qsG4oQiVsK58JS1BnBCuBa1rQRmi,7GRhBDsirIGkRZBtSMEzNTyDr2JQm4xx,36,44,18,62,12,4,4,0,144,20.571428571428573,3,0.0,20,18,52,12,24,4,10,4,0,102,42,1
1501,14816,NJcCHbOJUQpAuhbw958dR9qCvbh6GNk7,7GRhBDsirIGkRZBtSMEzNTyDr2JQm4xx,43,90,29,53,30,0,14,0,216,30.857142857142858,5,0.0,43,29,49,30,47,0,4,14,0,151,65,1
1502,14827,qxbESUsL0xgJYJDfjiKdrZA2VpHvSkr3,7GRhBDsirIGkRZBtSMEzNTyDr2JQm4xx,35,51,18,47,19,1,4,0,140,20.0,3,0.0,29,18,41,19,22,1,6,4,0,107,33,1
1503,14847,1CUoIZB9t7SxaldyOLjOrt0HiuV3YmmT,7GRhBDsirIGkRZBtSMEzNTyDr2JQm4xx,32,88,36,0,8,3,25,2,162,23.142857142857142,4,0.0,19,36,0,8,69,3,0,25,2,63,99,0
1504,14900,iG30XkTMNSFjufmkcMfMeTLCQkIO89rL,7GRhBDsirIGkRZBtSMEzNTyDr2JQm4xx,2,0,0,0,0,0,3,0,3,0.42857142857142855,1,0.0,0,0,0,0,0,0,0,3,0,0,3,1
1505,14920,tLb8Xi221e5NaJvytwcAD3V04AqBaAZQ,7GRhBDsirIGkRZBtSMEzNTyDr2JQm4xx,25,31,11,18,12,0,6,0,78,11.142857142857142,1,0.0,16,11,17,12,15,0,1,6,0,56,22,1
1506,15048,YUqXNrT8XQT6xSTrWrerz6EWyspe1b7c,7GRhBDsirIGkRZBtSMEzNTyDr2JQm4xx,88,210,65,197,39,11,10,0,532,76.0,6,0.0,123,65,172,39,87,11,25,10,0,399,133,0
1507,15051,KXPsJNzb3MNK5rxQc94IXJdmXF0ziWwA,7GRhBDsirIGkRZBtSMEzNTyDr2JQm4xx,1,0,0,0,0,0,1,0,1,0.14285714285714285,1,0.0,0,0,0,0,0,0,0,1,0,0,1,1
1508,15066,6vCR5MIMPnf9UWKZznVOJS5OTo4Gr7Hd,7GRhBDsirIGkRZBtSMEzNTyDr2JQm4xx,56,149,31,75,24,25,10,0,314,44.857142857142854,3,0.0,70,31,68,24,79,25,7,10,0,193,121,1
1509,15082,0ogceMBqbMfusFqG89X9sBzEnUGema9q,7GRhBDsirIGkRZBtSMEzNTyDr2JQm4xx,10,7,6,0,6,0,3,0,22,3.142857142857143,3,0.0,0,6,0,6,7,0,0,3,0,12,10,1
1510,15083,AsBtR21xGFKZ6c2LKvPTdlawgiUBcaPL,7GRhBDsirIGkRZBtSMEzNTyDr2JQm4xx,74,179,84,138,66,25,28,1,521,74.42857142857143,8,0.0,75,84,110,66,104,25,28,28,1,335,186,0
1511,15187,q36eiA77bwwsXGg05ifhgnTFDpR9Ar4V,7GRhBDsirIGkRZBtSMEzNTyDr2JQm4xx,101,237,69,209,57,7,20,0,599,85.57142857142857,4,0.0,132,69,178,57,105,7,31,20,0,436,163,0
1512,15202,ePpfrPKFmuYE4CHcpunEZ73b0FxyOz0q,7GRhBDsirIGkRZBtSMEzNTyDr2JQm4xx,57,72,26,160,19,1,8,0,286,40.857142857142854,4,0.0,36,26,138,19,36,1,22,8,0,219,67,1
1513,15240,9PiJFDewOyLmHT48JZWbbQ236haTndT7,7GRhBDsirIGkRZBtSMEzNTyDr2JQm4xx,62,210,56,79,38,13,41,3,440,62.857142857142854,12,0.0,105,56,75,38,105,13,4,41,3,274,166,1
1514,15242,CYwEz0VhssUEnyi7GLISc2cCNlhTg5eu,7GRhBDsirIGkRZBtSMEzNTyDr2JQm4xx,64,112,3,132,16,2,14,0,279,39.857142857142854,7,0.0,69,3,116,16,43,2,16,14,0,204,75,1
1515,15273,zx92A3etlZOmjWi19IMDYlwaWCkvF08z,7GRhBDsirIGkRZBtSMEzNTyDr2JQm4xx,27,81,0,43,8,17,1,0,150,21.428571428571427,1,0.0,37,0,41,8,44,17,2,1,0,86,64,1
1516,15296,S0OJjF6aof0iTnIX6lUAxekoH3m4w7V0,7GRhBDsirIGkRZBtSMEzNTyDr2JQm4xx,100,286,104,228,53,140,36,0,847,121.0,12,0.0,152,104,191,53,134,140,37,36,0,500,347,0
1517,15339,C6xrhZPOmVH2gCVNP26gSSPka2CcwgB5,7GRhBDsirIGkRZBtSMEzNTyDr2JQm4xx,42,52,20,42,21,3,12,1,151,21.571428571428573,4,0.0,31,20,39,21,21,3,3,12,1,111,40,1
1518,15361,CrwYq2YvOe70PhTOuriN4QumcrUjBJDI,7GRhBDsirIGkRZBtSMEzNTyDr2JQm4xx,64,208,49,104,22,20,20,0,423,60.42857142857143,5,0.0,137,49,94,22,71,20,10,20,0,302,121,0
1519,15365,sDcc9eMBMovhbCv3mcSbRYupViyMpSXg,7GRhBDsirIGkRZBtSMEzNTyDr2JQm4xx,1,0,0,0,0,0,2,0,2,0.2857142857142857,1,0.0,0,0,0,0,0,0,0,2,0,0,2,1
1520,15367,nnTxxp3z9fcrPPkS4kzYDi6mu4P5bdue,7GRhBDsirIGkRZBtSMEzNTyDr2JQm4xx,80,132,48,160,34,17,30,0,421,60.142857142857146,11,0.0,69,48,137,34,63,17,23,30,0,288,133,0
1521,15401,9iGaqBGS5kkoXjLd87hUL2eIJMVUVKfU,7GRhBDsirIGkRZBtSMEzNTyDr2JQm4xx,4,4,1,0,0,0,4,0,9,1.2857142857142858,2,0.0,0,1,0,0,4,0,0,4,0,1,8,0
1522,15436,OURivxGQBNOdhRVXNUy5pKGguC3x3JGV,7GRhBDsirIGkRZBtSMEzNTyDr2JQm4xx,22,49,13,20,15,1,11,0,109,15.571428571428571,2,0.0,17,13,17,15,32,1,3,11,0,62,47,0
1523,15491,iKE2AmvagEBVkqWumD0qyaUU8HShKvRo,7GRhBDsirIGkRZBtSMEzNTyDr2JQm4xx,1,0,0,0,0,0,1,0,1,0.14285714285714285,1,0.0,0,0,0,0,0,0,0,1,0,0,1,0
1524,15563,VVltscgfR96aweHb5nQdD1Q7dsOwuOJz,7GRhBDsirIGkRZBtSMEzNTyDr2JQm4xx,33,42,2,41,7,2,4,0,98,14.0,3,0.0,19,2,38,7,23,2,3,4,0,66,32,0
1525,15641,xY5IUgrYconprXri0F5cssyTAsVeuYqD,7GRhBDsirIGkRZBtSMEzNTyDr2JQm4xx,7,18,6,0,0,0,3,0,27,3.857142857142857,2,0.0,8,6,0,0,10,0,0,3,0,14,13,1
1526,15694,ls88dNG7SGcb3wsgc3lZQCJwuuAQTKkF,7GRhBDsirIGkRZBtSMEzNTyDr2JQm4xx,8,14,1,0,2,0,5,0,22,3.142857142857143,3,0.0,2,1,0,2,12,0,0,5,0,5,17,1
1527,15700,p8pFuUg19xWGOlJygMvSlQjonA3l7FUn,7GRhBDsirIGkRZBtSMEzNTyDr2JQm4xx,7,6,3,0,2,0,5,0,16,2.2857142857142856,3,0.0,1,3,0,2,5,0,0,5,0,6,10,1
1528,15713,UQMPqDnQtELOyig8xWMMs5ktcYwtyCzh,7GRhBDsirIGkRZBtSMEzNTyDr2JQm4xx,30,48,24,0,23,3,16,0,114,16.285714285714285,7,0.0,0,24,0,23,48,3,0,16,0,47,67,0
1529,15716,W2ohBuN5JfRDGloM0s99vkGQJHKKrtyK,7GRhBDsirIGkRZBtSMEzNTyDr2JQm4xx,25,46,21,8,13,1,7,0,96,13.714285714285714,9,0.0,15,21,6,13,31,1,2,7,0,55,41,1
1530,15771,HbdIEiZ1jslj2pBp8czn7lhBbxLYjtpj,7GRhBDsirIGkRZBtSMEzNTyDr2JQm4xx,55,51,12,76,10,0,5,0,154,22.0,3,0.0,29,12,76,10,22,0,0,5,0,127,27,0
1531,15810,WJLMraoon9e2y7OtDk9UrQjU4oqkoa0t,7GRhBDsirIGkRZBtSMEzNTyDr2JQm4xx,40,80,49,43,42,17,16,5,252,36.0,6,0.0,16,49,37,42,64,17,6,16,5,144,108,0
1532,15814,g7u6ac7DR9jMW4aOouB4W8Gur81b4cDe,7GRhBDsirIGkRZBtSMEzNTyDr2JQm4xx,79,100,37,110,38,0,28,2,315,45.0,8,0.0,58,37,85,38,42,0,25,28,2,218,97,0
1533,15876,rrw2WJkAL0R5jcfwKMTsm56jlh9a5ial,7GRhBDsirIGkRZBtSMEzNTyDr2JQm4xx,34,73,1,55,5,9,19,0,162,23.142857142857142,5,0.0,22,1,48,5,51,9,7,19,0,76,86,1
1534,15878,468cxTIslgaJVBCubZgOneiS2rtqRqqz,7GRhBDsirIGkRZBtSMEzNTyDr2JQm4xx,7,7,1,0,1,0,1,0,10,1.4285714285714286,1,0.0,0,1,0,1,7,0,0,1,0,2,8,1
1535,15881,W8K4VS8rPvnPTNUJrqgtS2FKH93KmR91,7GRhBDsirIGkRZBtSMEzNTyDr2JQm4xx,58,157,49,73,28,3,15,0,325,46.42857142857143,7,0.0,52,49,69,28,105,3,4,15,0,198,127,1
1536,15900,MvkVXPKImqjQobZ7zCJXq4GfQ4IthLq9,7GRhBDsirIGkRZBtSMEzNTyDr2JQm4xx,87,130,35,97,28,22,21,0,333,47.57142857142857,13,0.0,47,35,95,28,83,22,2,21,0,205,128,0
1537,15906,3c8IXjLzAuM9vKLwVwPhkOijPLPnFRJ2,7GRhBDsirIGkRZBtSMEzNTyDr2JQm4xx,1,0,0,0,0,0,1,0,1,0.14285714285714285,1,0.0,0,0,0,0,0,0,0,1,0,0,1,1
1538,15912,hJo1MgKiPZFXuH2ko6hqPTd9dbjMQKDO,7GRhBDsirIGkRZBtSMEzNTyDr2JQm4xx,35,54,19,56,13,0,18,3,163,23.285714285714285,6,0.0,21,19,45,13,33,0,11,18,3,98,65,1
1539,15919,oho8eUx0qt2QgQUM9H4Puo64w9V5nVUl,7GRhBDsirIGkRZBtSMEzNTyDr2JQm4xx,82,118,45,80,43,1,30,2,319,45.57142857142857,9,0.0,59,45,78,43,59,1,2,30,2,225,94,1
1540,15922,OHdLWfOkVYVSxh9avWbeG6oGLyuN9vvx,7GRhBDsirIGkRZBtSMEzNTyDr2JQm4xx,48,88,31,69,24,24,17,0,253,36.142857142857146,5,0.0,39,31,62,24,49,24,7,17,0,156,97,1
1541,15924,pXzK9E1YOZkyyLlXWv7EKpRMBTF7x1zF,7GRhBDsirIGkRZBtSMEzNTyDr2JQm4xx,1,0,0,0,0,0,1,0,1,0.14285714285714285,1,0.0,0,0,0,0,0,0,0,1,0,0,1,1
1542,15944,i4Ja5POFcbWsTXzyspWne0P4gq0Sndm7,7GRhBDsirIGkRZBtSMEzNTyDr2JQm4xx,29,55,21,27,9,0,13,0,125,17.857142857142858,3,0.0,30,21,22,9,25,0,5,13,0,82,43,1
1543,15947,JvcRsdOfDUJrxbmOeabeYf6ul7MDwm6b,7GRhBDsirIGkRZBtSMEzNTyDr2JQm4xx,22,25,7,19,6,0,3,0,60,8.571428571428571,3,0.0,14,7,17,6,11,0,2,3,0,44,16,1
1544,15956,wg7c1wZNHnWuQEzOFg3X7UO4UvdvZ0Nl,7GRhBDsirIGkRZBtSMEzNTyDr2JQm4xx,41,41,14,195,5,0,6,0,261,37.285714285714285,4,0.0,14,14,175,5,27,0,20,6,0,208,53,1
1545,15959,KD5stEhIDxW0wB7Mr1YVPQQ5AGRkzqAA,7GRhBDsirIGkRZBtSMEzNTyDr2JQm4xx,103,209,80,158,47,33,39,1,567,81.0,10,0.0,109,80,135,47,100,33,23,39,1,371,196,1
1546,15966,dWGIj0UEkV1WxMBYGHRsdtDhUsNSq5LC,7GRhBDsirIGkRZBtSMEzNTyDr2JQm4xx,48,125,47,26,34,9,19,1,261,37.285714285714285,9,0.0,59,47,25,34,66,9,1,19,1,165,96,0
1547,15982,yUo0f8mA9XEAtzr6kcSUh5ydpzcuIcml,7GRhBDsirIGkRZBtSMEzNTyDr2JQm4xx,56,121,32,74,29,18,25,0,299,42.714285714285715,5,0.0,60,32,66,29,61,18,8,25,0,187,112,1
1548,15987,6zXGZtvwHnFZCYFcS3Xzk5yrVH7CXdoJ,7GRhBDsirIGkRZBtSMEzNTyDr2JQm4xx,1,0,0,0,0,0,1,0,1,0.14285714285714285,1,0.0,0,0,0,0,0,0,0,1,0,0,1,1
1549,16020,ywdL3xkp7d2PSjbvnflAvIe7Wp6Q4SRe,7GRhBDsirIGkRZBtSMEzNTyDr2JQm4xx,46,147,20,108,21,0,20,0,316,45.142857142857146,7,0.0,64,20,102,21,83,0,6,20,0,207,109,1
1550,16029,aWq626ehQk5Iuuwzds6iAgtzgkimu1j2,7GRhBDsirIGkRZBtSMEzNTyDr2JQm4xx,60,91,32,130,36,2,15,0,306,43.714285714285715,6,0.0,50,32,113,36,41,2,17,15,0,231,75,1
1551,16038,NoaJNfAZAESYC7salsh3Qwaa5hC3sdBk,7GRhBDsirIGkRZBtSMEzNTyDr2JQm4xx,34,79,22,58,8,19,6,0,192,27.428571428571427,3,0.0,48,22,48,8,31,19,10,6,0,126,66,0
1552,16081,Z9zd5ft7NWbOfEUxKVShKB2Y1F3jXBm8,7GRhBDsirIGkRZBtSMEzNTyDr2JQm4xx,13,10,6,2,3,1,10,0,32,4.571428571428571,2,0.0,1,6,2,3,9,1,0,10,0,12,20,1
1553,16087,SIdEQEXoagJ5WwAcAkPtkVF6pipatiIa,7GRhBDsirIGkRZBtSMEzNTyDr2JQm4xx,79,205,56,92,41,4,15,0,413,59.0,5,0.0,67,56,78,41,138,4,14,15,0,242,171,0
1554,16091,DWloCId6fkO6Ms5BXhdCfDhm96dIK6F3,7GRhBDsirIGkRZBtSMEzNTyDr2JQm4xx,1,0,0,0,0,0,1,0,1,0.14285714285714285,1,0.0,0,0,0,0,0,0,0,1,0,0,1,1
1555,16131,cwM32Iyo8DmzSk0EybXLo5ksFWhXG4Da,7GRhBDsirIGkRZBtSMEzNTyDr2JQm4xx,54,86,23,27,23,0,5,0,164,23.428571428571427,6,0.0,48,23,18,23,38,0,9,5,0,112,52,0
1556,16134,JmlFAaRVuCFkmr6g7GLFJYPWWHADo3Vp,7GRhBDsirIGkRZBtSMEzNTyDr2JQm4xx,1,0,0,0,0,0,1,0,1,0.14285714285714285,1,0.0,0,0,0,0,0,0,0,1,0,0,1,1
1557,16168,DLDhUvvvfnnYFJuV65Zt2yaS0jPJgvzq,7GRhBDsirIGkRZBtSMEzNTyDr2JQm4xx,37,92,0,82,1,0,13,0,188,26.857142857142858,6,0.0,29,0,68,1,63,0,14,13,0,98,90,1
1558,16238,4NRUo07WkcrdRLUhlPTipY45aaERRn99,7GRhBDsirIGkRZBtSMEzNTyDr2JQm4xx,30,66,18,50,15,1,4,0,154,22.0,2,0.0,24,18,44,15,42,1,6,4,0,101,53,0
1559,16285,W8p8vrZuo5elf0zj1Aez8mTMlTcetQ7p,7GRhBDsirIGkRZBtSMEzNTyDr2JQm4xx,6,4,2,0,1,0,2,0,9,1.2857142857142858,1,0.0,0,2,0,1,4,0,0,2,0,3,6,1
1560,16289,moK1GdnqoYxhSRCf5a95lgXdVNdzYrjs,7GRhBDsirIGkRZBtSMEzNTyDr2JQm4xx,49,151,13,72,15,2,46,0,299,42.714285714285715,8,0.0,43,13,64,15,108,2,8,46,0,135,164,1
1561,16303,2WHNpOBPMmOzdjUXQIDdX6w5Bhh6AyHU,7GRhBDsirIGkRZBtSMEzNTyDr2JQm4xx,32,78,7,41,7,0,17,0,150,21.428571428571427,4,0.0,37,7,35,7,41,0,6,17,0,86,64,0
1562,16378,RjbxXw1YYmiUcedHIl1VrXvYXiS6wbOC,7GRhBDsirIGkRZBtSMEzNTyDr2JQm4xx,33,42,2,75,8,1,21,2,151,21.571428571428573,5,0.0,20,2,64,8,22,1,11,21,2,94,57,0
1563,16415,096xYyhB9kL7G6lT7J9rVrXyGNwUToLF,7GRhBDsirIGkRZBtSMEzNTyDr2JQm4xx,28,67,36,0,4,0,9,0,116,16.571428571428573,5,0.0,17,36,0,4,50,0,0,9,0,57,59,0
1564,16460,KDzfaWgTSBqeMJLFLmFuh4CMLsva9aWu,7GRhBDsirIGkRZBtSMEzNTyDr2JQm4xx,45,118,0,108,3,5,18,0,252,36.0,9,0.0,27,0,91,3,91,5,17,18,0,121,131,0
1565,16484,v1iavhjAgOftyRIIBT7pVhYkpNdcTDpm,7GRhBDsirIGkRZBtSMEzNTyDr2JQm4xx,12,11,5,0,2,1,6,1,26,3.7142857142857144,2,0.0,4,5,0,2,7,1,0,6,1,11,15,1
1566,16518,VFg2AN5zsuWpHyPwDEXIcAxQpNCPCOo7,7GRhBDsirIGkRZBtSMEzNTyDr2JQm4xx,66,178,62,99,48,54,43,2,486,69.42857142857143,5,0.0,70,62,86,48,108,54,13,43,2,266,220,1
1567,16541,tDBUBIMhJEJx4Pe5n9oY4eK5G81QRmVq,7GRhBDsirIGkRZBtSMEzNTyDr2JQm4xx,90,247,37,273,45,16,15,0,633,90.42857142857143,8,0.0,121,37,242,45,126,16,31,15,0,445,188,0
1568,16559,WbPhqfwmFYggW432ooC1iHmgUJBCP9Le,7GRhBDsirIGkRZBtSMEzNTyDr2JQm4xx,97,193,86,122,76,33,47,5,562,80.28571428571429,10,0.0,90,86,108,76,103,33,14,47,5,360,202,0
1569,16582,BxR5XM6DXnDlyXChlQFtgsFNvTkRDfGo,7GRhBDsirIGkRZBtSMEzNTyDr2JQm4xx,5,4,1,0,0,0,2,0,7,1.0,1,0.0,1,1,0,0,3,0,0,2,0,2,5,1
1570,16632,uPNpQwnvEtjDufLcIcScg8qVljQjes1y,7GRhBDsirIGkRZBtSMEzNTyDr2JQm4xx,48,80,26,78,18,0,10,0,212,30.285714285714285,8,0.0,35,26,74,18,45,0,4,10,0,153,59,1
1571,16696,EshSTNSaPVDLcPEwlm2e07DrZJhzPNHK,7GRhBDsirIGkRZBtSMEzNTyDr2JQm4xx,103,287,100,169,57,58,48,0,719,102.71428571428571,9,0.0,161,100,136,57,126,58,33,48,0,454,265,0
1572,16712,5nwrdJlhASYfMmSpU3deRRqUrd3ZpMIS,7GRhBDsirIGkRZBtSMEzNTyDr2JQm4xx,6,4,2,0,1,0,4,0,11,1.5714285714285714,2,0.0,0,2,0,1,4,0,0,4,0,3,8,1
1573,16787,ntbB11ay7TxjZmHHl7KvM6m0h5FtxAHR,7GRhBDsirIGkRZBtSMEzNTyDr2JQm4xx,9,8,4,0,5,1,6,1,25,3.5714285714285716,1,0.0,3,4,0,5,5,1,0,6,1,12,13,1
1574,16828,FhnsJdRTpIANrPfAv3Fv2vn7QGHPfOsl,7GRhBDsirIGkRZBtSMEzNTyDr2JQm4xx,13,24,11,0,2,91,36,0,164,23.428571428571427,8,0.0,4,11,0,2,20,91,0,36,0,17,147,0
1575,16923,oSfAVLTcGEmcT7y7OMQrYnvkkm78yh0P,7GRhBDsirIGkRZBtSMEzNTyDr2JQm4xx,101,163,61,282,47,68,14,0,635,90.71428571428571,5,0.0,86,61,242,47,77,68,40,14,0,436,199,1
1576,16957,5fUv2a4WMEi2Bc60cQo0Uzo1I7SufPfI,7GRhBDsirIGkRZBtSMEzNTyDr2JQm4xx,38,69,2,96,10,43,8,0,228,32.57142857142857,5,0.0,29,2,80,10,40,43,16,8,0,121,107,1
1577,16978,9gZpfuq1OK1diJdWcNoIpwo7QJUSplIt,7GRhBDsirIGkRZBtSMEzNTyDr2JQm4xx,56,151,65,69,29,6,33,2,355,50.714285714285715,7,0.0,72,65,63,29,79,6,6,33,2,229,126,1
1578,16979,hdKqkkWKrDzbKE9btGChBqiCfsTwp68E,7GRhBDsirIGkRZBtSMEzNTyDr2JQm4xx,13,7,5,0,0,26,18,2,58,8.285714285714286,3,0.0,0,5,0,0,7,26,0,18,2,5,53,1
1579,16989,76mZXn9JCyY7Mb7TWPGPGPMVCvSrLgze,7GRhBDsirIGkRZBtSMEzNTyDr2JQm4xx,39,74,18,68,27,1,8,1,197,28.142857142857142,2,0.0,44,18,63,27,30,1,5,8,1,152,45,1
1580,16999,Jb792VQeMGhUz59LQDa5JysSU082aNRs,7GRhBDsirIGkRZBtSMEzNTyDr2JQm4xx,25,58,23,30,11,1,4,0,127,18.142857142857142,7,0.0,29,23,26,11,29,1,4,4,0,89,38,0
1581,17028,HF98YPKzT8oi2j9flZW9kstZcvL3ZimG,7GRhBDsirIGkRZBtSMEzNTyDr2JQm4xx,37,94,27,74,13,0,6,0,214,30.571428571428573,4,0.0,28,27,63,13,66,0,11,6,0,131,83,0
1582,17049,4i80ssNqIa74pSBDzjYYryTbL6MBe9I9,7GRhBDsirIGkRZBtSMEzNTyDr2JQm4xx,95,205,75,197,71,63,69,0,680,97.14285714285714,11,0.0,119,75,163,71,86,63,34,69,0,428,252,1
1583,17055,CxUPOQRaQMGLmbOcfniIQOhh24PXLDR6,7GRhBDsirIGkRZBtSMEzNTyDr2JQm4xx,37,134,42,34,23,13,14,2,262,37.42857142857143,12,0.0,51,42,27,23,83,13,7,14,2,143,119,0
1584,17104,oxYTAYYaR98reRev5BqLPii4AFJGZbGZ,7GRhBDsirIGkRZBtSMEzNTyDr2JQm4xx,43,75,24,91,21,6,20,1,238,34.0,5,0.0,30,24,82,21,45,6,9,20,1,157,81,1
1585,17166,aJMNcTer76nTaYZZR58xtdmLr8BYq1Op,7GRhBDsirIGkRZBtSMEzNTyDr2JQm4xx,1,0,0,0,0,0,1,0,1,0.14285714285714285,1,0.0,0,0,0,0,0,0,0,1,0,0,1,1
1586,17267,5nhjk1VnZY8a3OWnkRujRs0BorgiAKUm,7GRhBDsirIGkRZBtSMEzNTyDr2JQm4xx,47,96,2,204,5,29,29,2,367,52.42857142857143,8,0.0,44,2,187,5,52,29,17,29,2,238,129,1
1587,17303,yhSGXw7EnYX7J3WWxRb9piBAfJaOtRLJ,7GRhBDsirIGkRZBtSMEzNTyDr2JQm4xx,50,86,29,151,7,0,6,0,279,39.857142857142854,5,0.0,38,29,133,7,48,0,18,6,0,207,72,1
1588,17332,Dy53HBwqZRiUys0tuL4RoOSu6jKEN99b,7GRhBDsirIGkRZBtSMEzNTyDr2JQm4xx,64,176,6,109,27,14,17,4,353,50.42857142857143,4,0.0,109,6,99,27,67,14,10,17,4,241,112,0
1589,17340,TilPXsBtUeInJte9nDlpbC1Ot52Vr9xD,7GRhBDsirIGkRZBtSMEzNTyDr2JQm4xx,6,8,1,0,1,0,3,0,13,1.8571428571428572,1,0.0,0,1,0,1,8,0,0,3,0,2,11,1
1590,17350,3WLDG20nmrHcXqgUBcbAgxTDjIgQgeWc,7GRhBDsirIGkRZBtSMEzNTyDr2JQm4xx,1,0,0,0,0,0,1,0,1,0.14285714285714285,1,0.0,0,0,0,0,0,0,0,1,0,0,1,1
1591,17382,B9q7BVaj4oZ0WT5JELnStUq4yahYsvGS,7GRhBDsirIGkRZBtSMEzNTyDr2JQm4xx,52,182,32,68,41,13,12,0,348,49.714285714285715,9,0.0,82,32,63,41,100,13,5,12,0,218,130,1
1592,17388,QRh7ApSBJNbSH61R3OkAQmXanxVzZM0F,7GRhBDsirIGkRZBtSMEzNTyDr2JQm4xx,35,80,32,44,23,14,7,0,200,28.571428571428573,4,0.0,41,32,33,23,39,14,11,7,0,129,71,0
1593,17389,Qj89AM8R8CzDfUmyoFjU0iKz1g513ZXt,7GRhBDsirIGkRZBtSMEzNTyDr2JQm4xx,100,332,134,234,52,597,109,9,1467,209.57142857142858,14,0.0,89,134,196,52,243,597,38,109,9,471,996,1
1594,17419,RALsNmDC4TIWwMjDij2qj4Bbd4iRP5eW,7GRhBDsirIGkRZBtSMEzNTyDr2JQm4xx,5,2,1,0,1,0,2,0,6,0.8571428571428571,1,0.0,0,1,0,1,2,0,0,2,0,2,4,1
1595,17459,1Ueye4RWWjvz8urTBfWMjk9mmqk3rMDD,7GRhBDsirIGkRZBtSMEzNTyDr2JQm4xx,39,70,26,32,23,13,10,0,174,24.857142857142858,4,0.0,39,26,32,23,31,13,0,10,0,120,54,1
1596,17510,riM9GkB0ajSqpIPlVq4tRzOjk7wJ6NHE,7GRhBDsirIGkRZBtSMEzNTyDr2JQm4xx,43,73,28,55,30,4,20,1,211,30.142857142857142,6,0.0,37,28,51,30,36,4,4,20,1,146,65,0
1597,17535,0j1auVPH81fVETuSCGy4JUgrdNva23MX,7GRhBDsirIGkRZBtSMEzNTyDr2JQm4xx,10,10,3,0,2,1,5,0,21,3.0,1,0.0,0,3,0,2,10,1,0,5,0,5,16,1
1598,17536,5EqHj7Yiq3ymf3kXC9ShF9mwG40Y7dpr,7GRhBDsirIGkRZBtSMEzNTyDr2JQm4xx,6,7,1,0,1,0,2,0,11,1.5714285714285714,1,0.0,0,1,0,1,7,0,0,2,0,2,9,1
1599,17540,FAO2ZdiHLpuwiCcIDpRl8MBgRMyFcfQ2,7GRhBDsirIGkRZBtSMEzNTyDr2JQm4xx,7,6,2,0,1,1,3,0,13,1.8571428571428572,2,0.0,0,2,0,1,6,1,0,3,0,3,10,1
1600,17586,TwDUv8vbemLEqdAHMCXeJ0dOJyZMBx6V,7GRhBDsirIGkRZBtSMEzNTyDr2JQm4xx,57,139,37,103,16,9,10,0,314,44.857142857142854,5,0.0,54,37,92,16,85,9,11,10,0,199,115,0
1601,17592,87HjW3xlExsdfk3WF0s7d71nmAzoFuKE,7GRhBDsirIGkRZBtSMEzNTyDr2JQm4xx,2,0,0,0,0,0,2,0,2,0.2857142857142857,1,0.0,0,0,0,0,0,0,0,2,0,0,2,1
1602,17595,3vhCoT2dzeVdCpmcedhNzxK4VNLZ2l0r,7GRhBDsirIGkRZBtSMEzNTyDr2JQm4xx,9,5,1,0,1,0,7,1,15,2.142857142857143,2,0.0,0,1,0,1,5,0,0,7,1,2,13,1
1603,17597,dxt9lWTWbhPZn9mT70zVSi49oFElvqw6,7GRhBDsirIGkRZBtSMEzNTyDr2JQm4xx,28,54,5,68,7,1,7,0,142,20.285714285714285,4,0.0,25,5,60,7,29,1,8,7,0,97,45,1
1604,17612,XarBLnhwPhERC9Lork4s2tIiSLNqD9KT,7GRhBDsirIGkRZBtSMEzNTyDr2JQm4xx,1,0,0,0,0,0,1,0,1,0.14285714285714285,1,0.0,0,0,0,0,0,0,0,1,0,0,1,1
1605,17620,5HX4czL6Sp8ee3UX2kWAHqmFW5CMMTjE,7GRhBDsirIGkRZBtSMEzNTyDr2JQm4xx,45,155,47,70,30,2,14,0,318,45.42857142857143,5,0.0,52,47,63,30,103,2,7,14,0,192,126,0
1606,17626,uol5rXltLKrhjm5SMrTU5qkZcMAMKTe6,7GRhBDsirIGkRZBtSMEzNTyDr2JQm4xx,49,102,46,96,35,23,20,1,323,46.142857142857146,6,0.0,44,46,81,35,58,23,15,20,1,206,117,1
1607,17647,f0IqI5DBlXdS6eUmVFeyauyA8dq5ftiC,7GRhBDsirIGkRZBtSMEzNTyDr2JQm4xx,23,38,19,2,10,8,6,0,83,11.857142857142858,1,0.0,5,19,2,10,33,8,0,6,0,36,47,1
1608,17652,dW2So4dhz8sFwZQzndBoTpsFa69MFo0q,7GRhBDsirIGkRZBtSMEzNTyDr2JQm4xx,1,0,0,0,0,0,1,0,1,0.14285714285714285,1,0.0,0,0,0,0,0,0,0,1,0,0,1,1
1609,17660,UaSh8dwx8gnofYbXlmpqj9uYDbpJ89pX,7GRhBDsirIGkRZBtSMEzNTyDr2JQm4xx,35,139,7,52,10,42,22,0,272,38.857142857142854,7,0.0,82,7,44,10,57,42,8,22,0,143,129,0
1610,17677,7VmmzXV3A639hzlpZwrx655FqwOsl8uh,7GRhBDsirIGkRZBtSMEzNTyDr2JQm4xx,10,15,0,0,0,0,12,0,27,3.857142857142857,5,0.0,0,0,0,0,15,0,0,12,0,0,27,1
1611,17692,xndkXq03AGanha0Zu6RBymqlwrjUbtA1,7GRhBDsirIGkRZBtSMEzNTyDr2JQm4xx,10,5,2,6,3,0,5,0,21,3.0,2,0.0,2,2,6,3,3,0,0,5,0,13,8,1
1612,17706,WJVoKPfDDccrIbPzaP1iqdrTUwOdTQpf,7GRhBDsirIGkRZBtSMEzNTyDr2JQm4xx,43,101,22,4,23,6,12,2,170,24.285714285714285,2,0.0,45,22,4,23,56,6,0,12,2,94,76,1
1613,17707,8hNQWXBoItm3CRzdk0wSJDwYSfUbhUCO,7GRhBDsirIGkRZBtSMEzNTyDr2JQm4xx,45,79,20,54,15,1,4,0,173,24.714285714285715,3,0.0,37,20,45,15,42,1,9,4,0,117,56,1
1614,19577,udnRYxurswpE4GUZcnc80kafg0hn3fpz,fbPkOYLVPtPgIt0MxizjfFJov3JbHyAi,1,0,0,0,0,0,1,0,1,0.14285714285714285,1,0.0,0,0,0,0,0,0,0,1,0,0,1,1
1615,19578,8o4E9PO3r20M8IPbGHnn7ry81or8oVUd,fbPkOYLVPtPgIt0MxizjfFJov3JbHyAi,5,4,1,0,1,0,2,0,8,1.1428571428571428,1,0.0,0,1,0,1,4,0,0,2,0,2,6,1
1616,19579,mK2PenVNfwXeBJzi7mP3HzWchd5fxecA,fbPkOYLVPtPgIt0MxizjfFJov3JbHyAi,7,5,2,0,1,4,8,0,20,2.857142857142857,3,0.0,0,2,0,1,5,4,0,8,0,3,17,1
1617,19580,3W09pasLSoDWuQqGyvECJ7WiykG165j2,fbPkOYLVPtPgIt0MxizjfFJov3JbHyAi,17,64,18,5,4,31,14,0,136,19.428571428571427,7,0.0,9,18,4,4,55,31,1,14,0,35,101,1
1618,19581,VHVVDsLJTPPR7rfPiJMrbsUMa6RdDEDz,fbPkOYLVPtPgIt0MxizjfFJov3JbHyAi,1,0,0,0,0,0,2,0,2,0.2857142857142857,1,0.0,0,0,0,0,0,0,0,2,0,0,2,1
1619,19582,0YyuZCZ9YG2n31hPJCi1E2GmCt5JQVnE,fbPkOYLVPtPgIt0MxizjfFJov3JbHyAi,7,3,2,0,2,2,3,0,12,1.7142857142857142,1,0.0,0,2,0,2,3,2,0,3,0,4,8,0
1620,19584,svaRJHaQGfUR34JQvStVpv5jX9kWWhlQ,fbPkOYLVPtPgIt0MxizjfFJov3JbHyAi,7,5,2,0,2,0,3,0,12,1.7142857142857142,1,0.0,0,2,0,2,5,0,0,3,0,4,8,1
1621,19586,z5Htt0utseDft2JjH8T5zYokNhpAiHNE,fbPkOYLVPtPgIt0MxizjfFJov3JbHyAi,11,31,0,0,5,23,8,0,67,9.571428571428571,3,0.0,14,0,0,5,17,23,0,8,0,19,48,0
1622,19587,I45Q3yivyiRN2kHVhbV8bUCfrXvtpUvU,fbPkOYLVPtPgIt0MxizjfFJov3JbHyAi,9,7,5,0,4,0,7,0,23,3.2857142857142856,1,0.0,0,5,0,4,7,0,0,7,0,9,14,1
1623,19588,EFioWHTkYv074j9vSFY7qmw2MvFzZ0mo,fbPkOYLVPtPgIt0MxizjfFJov3JbHyAi,62,122,51,52,39,91,37,1,393,56.142857142857146,13,0.0,49,51,43,39,73,91,9,37,1,182,211,0
1624,19589,SgWqRh3XmeJpz6RfUb8yXu2ZkH0AleuJ,fbPkOYLVPtPgIt0MxizjfFJov3JbHyAi,9,9,1,0,0,10,7,1,28,4.0,2,0.0,1,1,0,0,8,10,0,7,1,2,26,1
1625,19591,I91CCtQfetYUPwkEXIvTFBP6tbrp1spN,fbPkOYLVPtPgIt0MxizjfFJov3JbHyAi,27,82,46,20,17,0,19,0,184,26.285714285714285,13,0.0,11,46,16,17,71,0,4,19,0,90,94,0
1626,19592,dl33BYrB63jF9H7InuQDxo3dQrVdjLGV,fbPkOYLVPtPgIt0MxizjfFJov3JbHyAi,7,3,2,0,2,0,4,0,11,1.5714285714285714,1,0.0,0,2,0,2,3,0,0,4,0,4,7,1
1627,19593,sYGG7Hl1IcaeWwJigpwVXXbQKD0HFEPn,fbPkOYLVPtPgIt0MxizjfFJov3JbHyAi,10,10,7,0,5,0,4,0,26,3.7142857142857144,2,0.0,1,7,0,5,9,0,0,4,0,13,13,1
1628,19595,b3ktGBnxedY4iAdFYIyjERgRCauTInkK,fbPkOYLVPtPgIt0MxizjfFJov3JbHyAi,12,30,13,2,8,48,17,2,120,17.142857142857142,3,0.0,10,13,2,8,20,48,0,17,2,33,87,1
1629,19597,wFWVvTUKN4Nj5vWrbX5PVi6EvLKq8sqa,fbPkOYLVPtPgIt0MxizjfFJov3JbHyAi,24,54,18,29,27,0,5,0,133,19.0,2,0.0,32,18,22,27,22,0,7,5,0,99,34,1
1630,19598,rUHwInfwrT2VCsoj7SngGENcoxIrK2aA,fbPkOYLVPtPgIt0MxizjfFJov3JbHyAi,34,117,32,48,30,97,33,7,364,52.0,8,0.0,67,32,38,30,50,97,10,33,7,167,197,1
1631,19599,QZNGHI9TocOuANx6bTOdMFrqzeb0fTw3,fbPkOYLVPtPgIt0MxizjfFJov3JbHyAi,1,0,0,0,0,0,1,0,1,0.14285714285714285,1,0.0,0,0,0,0,0,0,0,1,0,0,1,1
1632,19600,YCZ0HSNcZja1vuapbZTjyZlLagijA85V,fbPkOYLVPtPgIt0MxizjfFJov3JbHyAi,7,3,2,0,2,0,3,0,10,1.4285714285714286,1,0.0,0,2,0,2,3,0,0,3,0,4,6,1
1633,19601,gpUff0gJHSKcQDbNnT6UR6klN9yWn4B3,fbPkOYLVPtPgIt0MxizjfFJov3JbHyAi,17,27,12,12,10,1,7,0,69,9.857142857142858,2,0.0,8,12,9,10,19,1,3,7,0,39,30,1
1634,19602,cxXfR155NqvzoUrJxE0tct65N6OEUGW3,fbPkOYLVPtPgIt0MxizjfFJov3JbHyAi,2,0,0,0,0,0,3,0,3,0.42857142857142855,1,0.0,0,0,0,0,0,0,0,3,0,0,3,1
1635,19603,0VxsYnODhio1aXODkLqOGQB4NYdClGaT,fbPkOYLVPtPgIt0MxizjfFJov3JbHyAi,2,1,0,0,0,0,1,0,2,0.2857142857142857,1,0.0,0,0,0,0,1,0,0,1,0,0,2,1
1636,19604,1EQy9mKBCgbz8jG2K6f93LU9GKq65V9v,fbPkOYLVPtPgIt0MxizjfFJov3JbHyAi,7,3,1,0,2,0,3,0,9,1.2857142857142858,1,0.0,0,1,0,2,3,0,0,3,0,3,6,1
1637,19606,CLH6KVxeKfUu9lbHyFm5yc6Qf4HvLCyR,fbPkOYLVPtPgIt0MxizjfFJov3JbHyAi,2,0,0,0,0,0,8,0,8,1.1428571428571428,2,0.0,0,0,0,0,0,0,0,8,0,0,8,1
1638,19607,BCPOhUa2LrfH93ebCE15VbF0VEWEyi7T,fbPkOYLVPtPgIt0MxizjfFJov3JbHyAi,9,5,3,0,2,10,4,1,25,3.5714285714285716,2,0.0,0,3,0,2,5,10,0,4,1,5,20,1
1639,19609,hSrmLZQ0ouEuE46yYppuvpfSWmkaTAsV,fbPkOYLVPtPgIt0MxizjfFJov3JbHyAi,8,5,2,0,2,0,5,0,14,2.0,2,0.0,0,2,0,2,5,0,0,5,0,4,10,1
1640,19610,kLgTb4zs1DK0fasndFOTstbWViutnXRG,fbPkOYLVPtPgIt0MxizjfFJov3JbHyAi,17,37,18,11,12,3,17,2,100,14.285714285714286,3,0.0,11,18,9,12,26,3,2,17,2,50,50,1
1641,19611,jmpbNsd2zzToMH9HZWx8NTyZ25PfYydC,fbPkOYLVPtPgIt0MxizjfFJov3JbHyAi,10,8,5,0,4,7,5,0,29,4.142857142857143,2,0.0,0,5,0,4,8,7,0,5,0,9,20,1
1642,19612,XVNXZTDLYViPgXZBTcX5RWMvf5SNK18Y,fbPkOYLVPtPgIt0MxizjfFJov3JbHyAi,18,14,10,0,9,0,4,0,37,5.285714285714286,3,0.0,0,10,0,9,14,0,0,4,0,19,18,1
1643,19615,y9ukbIQfB4L7zn5UoeGfcZjZUqTsQsJk,fbPkOYLVPtPgIt0MxizjfFJov3JbHyAi,6,3,2,0,2,3,1,0,11,1.5714285714285714,1,0.0,0,2,0,2,3,3,0,1,0,4,7,1
1644,19616,kyJzGSg3elXhPrIWM8rkZuAZv6RhnLQu,fbPkOYLVPtPgIt0MxizjfFJov3JbHyAi,29,73,49,4,21,91,11,2,251,35.857142857142854,7,0.0,1,49,3,21,72,91,1,11,2,74,177,1
1645,19617,FcPFK6OTsUF1j3uNGabdzGTvbY8kcO3D,fbPkOYLVPtPgIt0MxizjfFJov3JbHyAi,7,20,0,0,2,0,4,0,26,3.7142857142857144,2,0.0,4,0,0,2,16,0,0,4,0,6,20,1
1646,19620,wbbNGhodAmSlYSg7ZSWYtWMdb0rjLgRw,fbPkOYLVPtPgIt0MxizjfFJov3JbHyAi,13,13,7,2,5,8,6,0,41,5.857142857142857,2,0.0,1,7,2,5,12,8,0,6,0,15,26,1
1647,19621,P7cWTzqHbKs2w7IhW7Eb0IWuvmS7VHHm,fbPkOYLVPtPgIt0MxizjfFJov3JbHyAi,57,155,78,33,62,77,20,2,427,61.0,7,0.0,67,78,30,62,88,77,3,20,2,237,190,0
1648,19622,qGzhVjTxktnI3gvlHnV7uXSPz6cASHXn,fbPkOYLVPtPgIt0MxizjfFJov3JbHyAi,11,10,5,0,4,13,8,1,41,5.857142857142857,4,0.0,0,5,0,4,10,13,0,8,1,9,32,1
1649,19623,GDKy1KAMQHkxWaQDYOeRxnEA0ZpODsn0,fbPkOYLVPtPgIt0MxizjfFJov3JbHyAi,7,3,2,0,2,10,6,0,23,3.2857142857142856,2,0.0,0,2,0,2,3,10,0,6,0,4,19,1
1650,19624,2we3WxltFBT1dd0FjP3YZ8iHf2xpHEei,fbPkOYLVPtPgIt0MxizjfFJov3JbHyAi,8,16,5,0,4,7,5,0,37,5.285714285714286,5,0.0,4,5,0,4,12,7,0,5,0,13,24,1
1651,19626,HnvxqugChFN5yjBU90JTvP996KYT36S0,fbPkOYLVPtPgIt0MxizjfFJov3JbHyAi,26,86,38,11,14,45,24,2,220,31.428571428571427,6,0.0,30,38,10,14,56,45,1,24,2,92,128,1
1652,19627,aNviqaUsa8tjM9b6nMwh7ketdx2tdX99,fbPkOYLVPtPgIt0MxizjfFJov3JbHyAi,1,0,0,0,0,0,1,0,1,0.14285714285714285,1,0.0,0,0,0,0,0,0,0,1,0,0,1,1
1653,19629,G0JgmTQ55TeK9aeblJVq6TYQNTXqJFIQ,fbPkOYLVPtPgIt0MxizjfFJov3JbHyAi,14,21,9,8,7,0,6,0,51,7.285714285714286,4,0.0,2,9,7,7,19,0,1,6,0,25,26,1
1654,19630,peOW1xVaKPULFrN5Gy7l1puUz8vUwyZz,fbPkOYLVPtPgIt0MxizjfFJov3JbHyAi,6,9,5,0,1,12,5,0,32,4.571428571428571,2,0.0,0,5,0,1,9,12,0,5,0,6,26,1
1655,19631,8skbDsuebvai4ARav7dTtpvek1eLVeds,fbPkOYLVPtPgIt0MxizjfFJov3JbHyAi,12,69,47,0,43,15,24,3,201,28.714285714285715,7,0.0,11,47,0,43,58,15,0,24,3,101,100,1
1656,19633,npX3FgekV8W61Z0uW836onGI4m2nQdnG,fbPkOYLVPtPgIt0MxizjfFJov3JbHyAi,4,2,1,0,1,3,1,0,8,1.1428571428571428,1,0.0,0,1,0,1,2,3,0,1,0,2,6,1
1657,19634,jX7tq2pnsDlar9WIdJmOwYa2kqXNP8p5,fbPkOYLVPtPgIt0MxizjfFJov3JbHyAi,26,36,15,23,16,22,18,6,136,19.428571428571427,2,0.0,17,15,19,16,19,22,4,18,6,67,69,1
1658,19636,cFawqBd5fJtkKlCTemtngl3kfpxBO2Oy,fbPkOYLVPtPgIt0MxizjfFJov3JbHyAi,13,23,10,10,9,12,7,1,72,10.285714285714286,4,0.0,8,10,7,9,15,12,3,7,1,34,38,1
1659,19638,VG5BsqnAudb2wrnNFKVoV7tORlRXExaE,fbPkOYLVPtPgIt0MxizjfFJov3JbHyAi,9,26,15,0,6,20,13,3,83,11.857142857142858,4,0.0,2,15,0,6,24,20,0,13,3,23,60,1
1660,19639,nHMKztqwQYqP5QiyWQSLf3rlpTKGeMZ7,fbPkOYLVPtPgIt0MxizjfFJov3JbHyAi,9,6,4,0,3,12,3,2,30,4.285714285714286,1,0.0,0,4,0,3,6,12,0,3,2,7,23,1
1661,19640,qvYnUocR0frsPd3kYwxIbvUGNPr9n1qt,fbPkOYLVPtPgIt0MxizjfFJov3JbHyAi,7,8,5,0,3,0,2,0,18,2.5714285714285716,2,0.0,0,5,0,3,8,0,0,2,0,8,10,1
1662,19641,GoCzFgZtKHP9v4b0WP4lIjCorcS7Jt3F,fbPkOYLVPtPgIt0MxizjfFJov3JbHyAi,23,55,28,15,17,6,7,0,128,18.285714285714285,5,0.0,18,28,12,17,37,6,3,7,0,75,53,1
1663,19642,kQ63n93d5CTXewyEhcoySFeLgYStuYpO,fbPkOYLVPtPgIt0MxizjfFJov3JbHyAi,7,6,4,0,3,0,2,0,15,2.142857142857143,2,0.0,0,4,0,3,6,0,0,2,0,7,8,1
1664,19643,7Wr2VTJWzRxZOKgdu9ZKFIXmTnCI9fnu,fbPkOYLVPtPgIt0MxizjfFJov3JbHyAi,23,72,21,20,16,0,7,0,136,19.428571428571427,2,0.0,35,21,16,16,37,0,4,7,0,88,48,1
1665,19644,No5ifG9v9VDpFVCY05CK70WSRGncERpv,fbPkOYLVPtPgIt0MxizjfFJov3JbHyAi,12,14,5,0,4,1,8,0,32,4.571428571428571,4,0.0,0,5,0,4,14,1,0,8,0,9,23,1
1666,19646,ggEr2STKTwtSSUdtGCmiPr3DBu3TJ34B,fbPkOYLVPtPgIt0MxizjfFJov3JbHyAi,60,118,46,24,48,54,12,0,302,43.142857142857146,6,0.0,58,46,24,48,60,54,0,12,0,176,126,1
1667,19648,wQAzZrNBkZu6TvNOv2yKxdbJtBBRTSuF,fbPkOYLVPtPgIt0MxizjfFJov3JbHyAi,6,6,1,0,1,11,5,0,24,3.4285714285714284,1,0.0,0,1,0,1,6,11,0,5,0,2,22,1
1668,19649,mbP9O9bSfibkETk00N09Osk4AH9tyOW9,fbPkOYLVPtPgIt0MxizjfFJov3JbHyAi,1,0,0,0,0,0,1,0,1,0.14285714285714285,1,0.0,0,0,0,0,0,0,0,1,0,0,1,1
1669,19650,9Q3q5ak3WAEiXRLChbacNd3Hje0Wa6sd,fbPkOYLVPtPgIt0MxizjfFJov3JbHyAi,29,106,37,30,29,72,25,1,300,42.857142857142854,6,0.0,38,37,21,29,68,72,9,25,1,125,175,1
1670,19654,5J6AhQDgqCTdGi4V2FLrPa1uynjLJqbR,fbPkOYLVPtPgIt0MxizjfFJov3JbHyAi,11,33,1,6,1,16,6,1,64,9.142857142857142,1,0.0,7,1,4,1,26,16,2,6,1,13,51,1
1671,19655,9e5dcfJQbPUU8sTcmzE9DWoDPOA9Nhu3,fbPkOYLVPtPgIt0MxizjfFJov3JbHyAi,6,8,3,0,2,0,2,0,15,2.142857142857143,2,0.0,0,3,0,2,8,0,0,2,0,5,10,1
1672,19656,gsUbcjiJXGVEzC0HsE7H7oNZQUP3vN7h,fbPkOYLVPtPgIt0MxizjfFJov3JbHyAi,28,67,38,14,23,67,26,3,238,34.0,7,0.0,13,38,11,23,54,67,3,26,3,85,153,1
1673,19657,RaBOiV7pbDCxFmg73km3gwoEkG637iTS,fbPkOYLVPtPgIt0MxizjfFJov3JbHyAi,7,3,2,0,2,0,3,0,10,1.4285714285714286,1,0.0,0,2,0,2,3,0,0,3,0,4,6,1
1674,19658,zTv4QKAduCCJ5yquHsz6UKPKumHF7znP,fbPkOYLVPtPgIt0MxizjfFJov3JbHyAi,10,14,9,0,4,0,4,0,31,4.428571428571429,2,0.0,1,9,0,4,13,0,0,4,0,14,17,1
1675,19659,p8vHkfo5SI0V6B4KROfqrnRCgCCEpojM,fbPkOYLVPtPgIt0MxizjfFJov3JbHyAi,26,55,15,34,16,18,9,0,147,21.0,3,0.0,31,15,25,16,24,18,9,9,0,87,60,1
1676,19660,Fdf5W8Lu9p3zXrwWlt1EPTxeAnJSyNEE,fbPkOYLVPtPgIt0MxizjfFJov3JbHyAi,8,3,2,0,2,2,4,0,13,1.8571428571428572,1,0.0,0,2,0,2,3,2,0,4,0,4,9,1
1677,19661,yJPR0OidzPKNg5Rj1FfQqqXJqCl4r5z8,fbPkOYLVPtPgIt0MxizjfFJov3JbHyAi,1,0,0,0,0,0,1,0,1,0.14285714285714285,1,0.0,0,0,0,0,0,0,0,1,0,0,1,1
1678,19665,NlHO5hXiy7TmVTHiRgExH6y7p9gJG1YF,fbPkOYLVPtPgIt0MxizjfFJov3JbHyAi,5,4,1,0,1,0,1,0,7,1.0,1,0.0,0,1,0,1,4,0,0,1,0,2,5,1
1679,19667,U04y5vFf0AfyJVGIOJHlryTyRQEOm5pT,fbPkOYLVPtPgIt0MxizjfFJov3JbHyAi,21,36,21,10,10,13,10,1,101,14.428571428571429,5,0.0,3,21,8,10,33,13,2,10,1,42,59,1
1680,19668,Xh98I3V3ah7C40wUQRlxQZnzp2hUFzZ9,fbPkOYLVPtPgIt0MxizjfFJov3JbHyAi,7,6,4,0,3,0,2,0,15,2.142857142857143,3,0.0,0,4,0,3,6,0,0,2,0,7,8,1
1681,19671,m38kM2O7Y9dS9qRyh326gVCH42EwGlbN,fbPkOYLVPtPgIt0MxizjfFJov3JbHyAi,7,5,2,0,3,12,4,0,26,3.7142857142857144,2,0.0,2,2,0,3,3,12,0,4,0,7,19,1
1682,19674,ohSArIWJFOjWcw1iipOBHaELVY4dEsuk,fbPkOYLVPtPgIt0MxizjfFJov3JbHyAi,17,19,9,0,5,13,9,4,59,8.428571428571429,2,0.0,0,9,0,5,19,13,0,9,4,14,45,1
1683,19675,2H6KbsPWrpdsyjI0g4q0nnMN85W6it1n,fbPkOYLVPtPgIt0MxizjfFJov3JbHyAi,1,0,0,0,0,0,1,0,1,0.14285714285714285,1,0.0,0,0,0,0,0,0,0,1,0,0,1,1
1684,19678,5zeXp1xbv4d96w4nRSFAsiN01xqmo82u,fbPkOYLVPtPgIt0MxizjfFJov3JbHyAi,2,0,0,0,0,0,7,0,7,1.0,1,0.0,0,0,0,0,0,0,0,7,0,0,7,1
1685,19679,onkD63zW36qWueM4FnIhDEFep4J6xaTB,fbPkOYLVPtPgIt0MxizjfFJov3JbHyAi,2,0,0,0,0,0,7,0,7,1.0,1,0.0,0,0,0,0,0,0,0,7,0,0,7,1
1686,19685,vh8VMxJwpHETuDx8mTcywtcFmJ5lOlZy,fbPkOYLVPtPgIt0MxizjfFJov3JbHyAi,4,3,2,0,2,0,1,0,8,1.1428571428571428,1,0.0,0,2,0,2,3,0,0,1,0,4,4,0
1687,19687,jh0D2keICXHjZlE8o0iWfTU4GtogK2iV,fbPkOYLVPtPgIt0MxizjfFJov3JbHyAi,11,13,6,0,6,10,3,0,38,5.428571428571429,2,0.0,2,6,0,6,11,10,0,3,0,14,24,1
1688,19689,PwY3L0IvWcNAAWE8QgIO3juuVesQg6xr,fbPkOYLVPtPgIt0MxizjfFJov3JbHyAi,6,5,3,0,1,7,5,0,21,3.0,3,0.0,0,3,0,1,5,7,0,5,0,4,17,1
1689,19690,YNemkS5dqknHOwehYprPYVkMaqYUO4yA,fbPkOYLVPtPgIt0MxizjfFJov3JbHyAi,5,3,1,0,1,1,1,0,7,1.0,1,0.0,0,1,0,1,3,1,0,1,0,2,5,1
1690,19692,KkdnagFJtwwq5n9Iuy7rnQaTqa2llFa9,fbPkOYLVPtPgIt0MxizjfFJov3JbHyAi,25,45,19,9,16,22,17,0,128,18.285714285714285,5,0.0,19,19,9,16,26,22,0,17,0,63,65,1
1691,19693,OWBUV30zEQH7Jt1VRLKmraf0vAFBacfv,fbPkOYLVPtPgIt0MxizjfFJov3JbHyAi,9,11,5,0,4,11,12,0,43,6.142857142857143,2,0.0,3,5,0,4,8,11,0,12,0,12,31,1
1692,19694,4GJSwwikGuUWXSajcKoSlvfsoiC8eEZq,fbPkOYLVPtPgIt0MxizjfFJov3JbHyAi,6,7,2,0,1,0,2,0,12,1.7142857142857142,1,0.0,0,2,0,1,7,0,0,2,0,3,9,1
1693,19695,3SP9iNDvUt8m67ZMqC5DpQRe6ekkTpsP,fbPkOYLVPtPgIt0MxizjfFJov3JbHyAi,12,11,7,0,4,5,10,1,38,5.428571428571429,4,0.0,0,7,0,4,11,5,0,10,1,11,27,0
1694,19696,wE17RsVOxdHL75rwI5QafkkqcL3REji3,fbPkOYLVPtPgIt0MxizjfFJov3JbHyAi,4,2,1,0,1,0,1,0,5,0.7142857142857143,1,0.0,0,1,0,1,2,0,0,1,0,2,3,1
1695,19698,vTwbvGW3E1IdqF0HV32uMMc0gGolPCvf,fbPkOYLVPtPgIt0MxizjfFJov3JbHyAi,8,21,12,5,10,5,3,0,56,8.0,2,0.0,4,12,4,10,17,5,1,3,0,30,26,1
1696,19699,ZQS70X3Ksth8gmZtwesyaYzrxIBfpjcf,fbPkOYLVPtPgIt0MxizjfFJov3JbHyAi,10,24,9,2,4,17,6,0,62,8.857142857142858,2,0.0,10,9,2,4,14,17,0,6,0,25,37,1
1697,19701,Zw1bdKbgaMzUzlqlieQSaucEQ8wggZlx,fbPkOYLVPtPgIt0MxizjfFJov3JbHyAi,4,2,1,0,1,0,2,0,6,0.8571428571428571,1,0.0,0,1,0,1,2,0,0,2,0,2,4,0
1698,19702,p4yxCxiqzIMRoAwoOyGnN7P9RZxypnFm,fbPkOYLVPtPgIt0MxizjfFJov3JbHyAi,20,28,17,6,14,6,6,1,78,11.142857142857142,4,0.0,9,17,6,14,19,6,0,6,1,46,32,1
1699,19705,nbIGolByJC5FPssjDvcKL2vGL3vYMGAq,fbPkOYLVPtPgIt0MxizjfFJov3JbHyAi,63,174,81,58,56,64,51,5,489,69.85714285714286,9,0.0,48,81,49,56,126,64,9,51,5,234,255,0
1700,19708,6U0gCtH3epdLuuj59LGYbTzqvsPQ3DiY,fbPkOYLVPtPgIt0MxizjfFJov3JbHyAi,6,5,3,0,2,0,3,0,13,1.8571428571428572,1,0.0,0,3,0,2,5,0,0,3,0,5,8,1
1701,19709,uMtCQ7Qbv3rm9GwFXfsL1kyH8D7nIalM,fbPkOYLVPtPgIt0MxizjfFJov3JbHyAi,8,33,2,0,1,8,7,0,51,7.285714285714286,5,0.0,2,2,0,1,31,8,0,7,0,5,46,0
1702,19713,IxqtjkNiph0SiGkmwfaH729SQtK50jPu,fbPkOYLVPtPgIt0MxizjfFJov3JbHyAi,7,3,0,0,0,14,7,1,25,3.5714285714285716,1,0.0,0,0,0,0,3,14,0,7,1,0,25,1
1703,19714,uuyAyzBNPZJSqNkYTwX3ItAQ7Xcq5lqK,fbPkOYLVPtPgIt0MxizjfFJov3JbHyAi,25,32,18,14,11,16,7,0,98,14.0,5,0.0,9,18,12,11,23,16,2,7,0,50,48,1
1704,19715,bGUkoSiHaU85ol0k2itTO3o20n3CqprE,fbPkOYLVPtPgIt0MxizjfFJov3JbHyAi,6,3,2,0,2,0,1,0,8,1.1428571428571428,1,0.0,0,2,0,2,3,0,0,1,0,4,4,1
1705,19719,gl2YVlebVAvCcxsYaIoTwLj5l1IGqntH,fbPkOYLVPtPgIt0MxizjfFJov3JbHyAi,10,12,7,0,3,3,6,1,32,4.571428571428571,3,0.0,1,7,0,3,11,3,0,6,1,11,21,1
1706,19720,VgTzrg40YN89iMQMYp8DL2dsBQiMtIfa,fbPkOYLVPtPgIt0MxizjfFJov3JbHyAi,1,0,0,0,0,0,1,0,1,0.14285714285714285,1,0.0,0,0,0,0,0,0,0,1,0,0,1,1
1707,19721,cAjVoc8wOYDE8lScDAhEgvHdzkmg6Oh2,fbPkOYLVPtPgIt0MxizjfFJov3JbHyAi,10,11,8,0,3,0,11,0,33,4.714285714285714,3,0.0,0,8,0,3,11,0,0,11,0,11,22,1
1708,19722,YchS7FPUUCrsbeC0RlrXHuAg4O0pgdnY,fbPkOYLVPtPgIt0MxizjfFJov3JbHyAi,7,14,9,0,5,0,4,0,32,4.571428571428571,4,0.0,0,9,0,5,14,0,0,4,0,14,18,1
1709,19723,jWMVSdUkBIApMFEIB4X88BTUfxnffWAx,fbPkOYLVPtPgIt0MxizjfFJov3JbHyAi,31,45,35,3,27,0,11,0,121,17.285714285714285,5,0.0,1,35,2,27,44,0,1,11,0,65,56,1
1710,19726,LhzU5apxkgFguqzaBs2la7gJhoIHnun9,fbPkOYLVPtPgIt0MxizjfFJov3JbHyAi,5,2,1,0,1,0,7,0,11,1.5714285714285714,3,0.0,0,1,0,1,2,0,0,7,0,2,9,1
1711,19730,nIvIddlMAmTQagaACOulbZ6PInxlyOy2,fbPkOYLVPtPgIt0MxizjfFJov3JbHyAi,43,53,24,38,20,0,5,1,141,20.142857142857142,3,0.0,23,24,37,20,30,0,1,5,1,104,37,0
1712,19731,RLvJ5u6m28hhUO44ztK3P01H4ZTIxGoD,fbPkOYLVPtPgIt0MxizjfFJov3JbHyAi,6,8,3,0,3,0,2,0,16,2.2857142857142856,2,0.0,2,3,0,3,6,0,0,2,0,8,8,1
1713,19732,z0Q6ONK9gZ6rOpbD6TitX6FkYPuixcug,fbPkOYLVPtPgIt0MxizjfFJov3JbHyAi,41,119,39,31,17,30,23,4,263,37.57142857142857,8,0.0,26,39,26,17,93,30,5,23,4,108,155,1
1714,19733,D83ozkIhUBEzx10ZBkDPuuGHLXGFtU0D,fbPkOYLVPtPgIt0MxizjfFJov3JbHyAi,1,0,0,0,0,0,1,0,1,0.14285714285714285,1,0.0,0,0,0,0,0,0,0,1,0,0,1,1
1715,19735,KcSCnS83JgHtWEXfmBorkn1UBZpKO1nN,fbPkOYLVPtPgIt0MxizjfFJov3JbHyAi,2,0,0,0,0,0,2,0,2,0.2857142857142857,1,0.0,0,0,0,0,0,0,0,2,0,0,2,1
1716,19738,Bt0YrpvyveynQfxqkzppqbivsu9tYRaK,fbPkOYLVPtPgIt0MxizjfFJov3JbHyAi,12,7,6,0,5,0,1,0,19,2.7142857142857144,1,0.0,0,6,0,5,7,0,0,1,0,11,8,0
1717,19742,c2xUxg7vuhPItQZr96ojei2FNm4xg1X0,fbPkOYLVPtPgIt0MxizjfFJov3JbHyAi,44,77,34,18,31,38,17,2,217,31.0,7,0.0,33,34,18,31,44,38,0,17,2,116,101,1
1718,19743,EUZk7LUBeSnU7Li4WmLt7uKxhlLiKOYq,fbPkOYLVPtPgIt0MxizjfFJov3JbHyAi,11,29,14,0,6,0,15,1,65,9.285714285714286,2,0.0,0,14,0,6,29,0,0,15,1,20,45,1
1719,19744,k2JSp3bkSnFCXfzGP6sNaxUIyLpM06TA,fbPkOYLVPtPgIt0MxizjfFJov3JbHyAi,1,0,0,0,0,0,1,0,1,0.14285714285714285,1,0.0,0,0,0,0,0,0,0,1,0,0,1,1
1720,19745,Y5j2JtsMt3y0lrKil9FIBv8kmvrOLA4X,fbPkOYLVPtPgIt0MxizjfFJov3JbHyAi,7,5,3,0,2,0,4,0,14,2.0,1,0.0,0,3,0,2,5,0,0,4,0,5,9,1
1721,19746,teqJGecOr4a6oVYU1O9bgvPkX5ZSKA8N,fbPkOYLVPtPgIt0MxizjfFJov3JbHyAi,5,2,1,0,1,0,4,0,8,1.1428571428571428,1,0.0,0,1,0,1,2,0,0,4,0,2,6,1
1722,19748,P9CRp0z2n5HfPA3EY25pk86UB1hpP0VE,fbPkOYLVPtPgIt0MxizjfFJov3JbHyAi,6,7,4,0,0,1,7,0,19,2.7142857142857144,3,0.0,0,4,0,0,7,1,0,7,0,4,15,1
1723,19752,97yjJniO9qlZAjgn3gm4HXnkbwnHzt9O,fbPkOYLVPtPgIt0MxizjfFJov3JbHyAi,1,0,0,0,0,0,1,0,1,0.14285714285714285,1,0.0,0,0,0,0,0,0,0,1,0,0,1,1
1724,19753,4xhrCYKdzHUQrqW9iIr0KOeWujKeYIus,fbPkOYLVPtPgIt0MxizjfFJov3JbHyAi,6,7,1,0,1,0,7,0,16,2.2857142857142856,2,0.0,0,1,0,1,7,0,0,7,0,2,14,1
1725,19754,6K3h9aDeHI9AUqOKTvZxzGkKh6WMc7A3,fbPkOYLVPtPgIt0MxizjfFJov3JbHyAi,7,3,2,0,2,0,2,0,9,1.2857142857142858,1,0.0,0,2,0,2,3,0,0,2,0,4,5,1
1726,19757,hbUthRcRktel8CTk5FJE2GFw0tsGaPJX,fbPkOYLVPtPgIt0MxizjfFJov3JbHyAi,9,4,3,0,3,0,4,0,14,2.0,3,0.0,0,3,0,3,4,0,0,4,0,6,8,1
1727,19758,ipOqQyQpg3SQQaHklGxEISyDZxdmtba9,fbPkOYLVPtPgIt0MxizjfFJov3JbHyAi,3,0,0,0,0,0,5,0,5,0.7142857142857143,1,0.0,0,0,0,0,0,0,0,5,0,0,5,1
1728,19759,K2Gev6RW8VKqmC4C4H0XJFrGZeT1JyyW,fbPkOYLVPtPgIt0MxizjfFJov3JbHyAi,9,3,2,0,2,0,4,1,12,1.7142857142857142,1,0.0,0,2,0,2,3,0,0,4,1,4,8,1
1729,19762,haOtWLq8R5iBRxrylu7qsQb4IXuRIQaN,fbPkOYLVPtPgIt0MxizjfFJov3JbHyAi,20,40,19,24,0,3,11,3,100,14.285714285714286,3,0.0,14,19,22,0,26,3,2,11,3,55,45,1
1730,19763,E3VAWhRWNv6BjTckpQB4VpqgHIOmEPoD,fbPkOYLVPtPgIt0MxizjfFJov3JbHyAi,7,3,2,0,2,0,2,0,9,1.2857142857142858,1,0.0,0,2,0,2,3,0,0,2,0,4,5,1
1731,19766,02KikDpeL3BkT1uIl0J4sjaa91Wls8ih,fbPkOYLVPtPgIt0MxizjfFJov3JbHyAi,14,8,5,5,5,0,5,0,28,4.0,1,0.0,3,5,4,5,5,0,1,5,0,17,11,1
1732,19767,GKKNtfrAHKD2xUEQBz7HLN3kKO9SrWyD,fbPkOYLVPtPgIt0MxizjfFJov3JbHyAi,29,79,42,15,9,22,42,6,215,30.714285714285715,9,0.0,17,42,11,9,62,22,4,42,6,79,136,1
1733,19768,Why02UcIH8ZdjwIJwPOElrNVNSec4in6,fbPkOYLVPtPgIt0MxizjfFJov3JbHyAi,9,8,4,0,4,0,4,0,20,2.857142857142857,1,0.0,2,4,0,4,6,0,0,4,0,10,10,1
1734,19769,bgBhXSh8X6pD8mAGuk3zRCZBNqTSqnHJ,fbPkOYLVPtPgIt0MxizjfFJov3JbHyAi,13,30,17,8,13,8,5,0,81,11.571428571428571,4,0.0,8,17,6,13,22,8,2,5,0,44,37,1
1735,19771,9lFnGVb4ngjyCBpAPFF4Py9FZpYTRwoJ,fbPkOYLVPtPgIt0MxizjfFJov3JbHyAi,5,2,1,0,1,0,2,0,6,0.8571428571428571,1,0.0,0,1,0,1,2,0,0,2,0,2,4,1
1736,19776,CfeENerIdAGepleePWSt0SV88ctt0Tmw,fbPkOYLVPtPgIt0MxizjfFJov3JbHyAi,29,26,16,0,13,0,7,0,62,8.857142857142858,5,0.0,1,16,0,13,25,0,0,7,0,30,32,1
1737,19777,yUDnZwj7Yxaj86CQGKHCPnaBfq9O3vcc,fbPkOYLVPtPgIt0MxizjfFJov3JbHyAi,5,2,1,0,1,0,3,0,7,1.0,2,0.0,0,1,0,1,2,0,0,3,0,2,5,1
1738,19779,0nqj6iIWmYxLKHezCs5xwlB8hzJ9Rg2d,fbPkOYLVPtPgIt0MxizjfFJov3JbHyAi,5,5,2,0,1,0,1,0,9,1.2857142857142858,1,0.0,0,2,0,1,5,0,0,1,0,3,6,1
1739,19780,nG5SIna2Yr2MumgRI14CLkOHNh2U0rkm,fbPkOYLVPtPgIt0MxizjfFJov3JbHyAi,7,4,2,0,1,0,3,0,10,1.4285714285714286,1,0.0,0,2,0,1,4,0,0,3,0,3,7,1
1740,19781,Jv08t8fpcawyaZCw9f0bMJgjS8SuUKfb,fbPkOYLVPtPgIt0MxizjfFJov3JbHyAi,6,5,3,0,1,0,4,0,13,1.8571428571428572,2,0.0,0,3,0,1,5,0,0,4,0,4,9,1
1741,19782,UstweopmwuJ2fqnPYowNY0vr3lDWnNEA,fbPkOYLVPtPgIt0MxizjfFJov3JbHyAi,16,24,15,0,10,2,22,1,74,10.571428571428571,3,0.0,2,15,0,10,22,2,0,22,1,27,47,1
1742,19783,LzhmzME7EkyHXpFVu0EENS6JHqvsJLtH,fbPkOYLVPtPgIt0MxizjfFJov3JbHyAi,28,57,28,16,22,9,9,0,141,20.142857142857142,3,0.0,21,28,14,22,36,9,2,9,0,85,56,1
1743,19785,UhCNSbJxDa9CkR9faEu7q44yTurX7YJH,fbPkOYLVPtPgIt0MxizjfFJov3JbHyAi,5,2,1,0,1,0,3,0,7,1.0,1,0.0,0,1,0,1,2,0,0,3,0,2,5,1
1744,19788,gfuRBmlPKlXNn3u69OCkIXEsqvf1vpRo,fbPkOYLVPtPgIt0MxizjfFJov3JbHyAi,14,13,10,0,8,0,3,0,34,4.857142857142857,4,0.0,0,10,0,8,13,0,0,3,0,18,16,1
1745,19789,Ao05SPEEQv1WpXaKhWVTBjeRlniH33AQ,fbPkOYLVPtPgIt0MxizjfFJov3JbHyAi,9,10,2,2,3,0,3,1,21,3.0,1,0.0,2,2,2,3,8,0,0,3,1,9,12,1
1746,19790,9v5FBlkT08VgqPArpwPYDVOHzgkK8DmA,fbPkOYLVPtPgIt0MxizjfFJov3JbHyAi,12,25,11,4,6,6,10,0,62,8.857142857142858,5,0.0,3,11,4,6,22,6,0,10,0,24,38,1
1747,19791,GAIOcbnQvA9qhvhMc6r6zhVuhoFpfQD2,fbPkOYLVPtPgIt0MxizjfFJov3JbHyAi,4,2,0,0,0,0,2,0,4,0.5714285714285714,1,0.0,0,0,0,0,2,0,0,2,0,0,4,1
1748,19793,NiwhcToNaizZtNhA7c6Q1ZKoUp33LASc,fbPkOYLVPtPgIt0MxizjfFJov3JbHyAi,16,28,13,7,9,1,10,0,68,9.714285714285714,4,0.0,7,13,7,9,21,1,0,10,0,36,32,1
1749,19794,i2J6g1YHP6evnvsQatEoUV6Lz662N8Pt,fbPkOYLVPtPgIt0MxizjfFJov3JbHyAi,24,61,14,15,8,6,12,0,116,16.571428571428573,5,0.0,10,14,11,8,51,6,4,12,0,43,73,1
1750,19795,AtTEb2VyFEMuCpu9E7TOV4gAVRLFEpvg,fbPkOYLVPtPgIt0MxizjfFJov3JbHyAi,3,0,0,0,0,4,4,0,8,1.1428571428571428,1,0.0,0,0,0,0,0,4,0,4,0,0,8,1
1751,19798,ghh1dIrprkTKfllDMPy4cIkYxENWN3hG,fbPkOYLVPtPgIt0MxizjfFJov3JbHyAi,9,10,5,7,6,0,1,0,29,4.142857142857143,1,0.0,4,5,5,6,6,0,2,1,0,20,9,1
1752,19799,HmPFRf4HaEfqanP8jptbixb101SDWsz7,fbPkOYLVPtPgIt0MxizjfFJov3JbHyAi,1,0,0,0,0,0,1,0,1,0.14285714285714285,1,0.0,0,0,0,0,0,0,0,1,0,0,1,1
1753,19800,qmuiZWmGa2h5jyuvdl0AMpjDHyWxmqus,fbPkOYLVPtPgIt0MxizjfFJov3JbHyAi,6,3,2,0,2,13,1,0,21,3.0,1,0.0,0,2,0,2,3,13,0,1,0,4,17,1
1754,19803,DAe94MkHTdcPmdhTmwEa78RpI8unH7VU,fbPkOYLVPtPgIt0MxizjfFJov3JbHyAi,1,0,0,0,0,0,2,0,2,0.2857142857142857,2,0.0,0,0,0,0,0,0,0,2,0,0,2,1
1755,19804,WRgbGIz2wotOKHxhxfqrZ7xS0r15aDGp,fbPkOYLVPtPgIt0MxizjfFJov3JbHyAi,10,4,4,0,4,0,6,0,18,2.5714285714285716,3,0.0,0,4,0,4,4,0,0,6,0,8,10,1
1756,19806,mV6vIHBrgth3lTaajvzuqQeEfK5qY5yY,fbPkOYLVPtPgIt0MxizjfFJov3JbHyAi,12,15,9,0,7,0,13,0,44,6.285714285714286,2,0.0,2,9,0,7,13,0,0,13,0,18,26,1
1757,19807,FkDqcRzVuKxo8KhYGAYk6Shrbs7IlfbL,fbPkOYLVPtPgIt0MxizjfFJov3JbHyAi,6,3,1,0,1,0,2,0,7,1.0,1,0.0,0,1,0,1,3,0,0,2,0,2,5,1
1758,19809,pApGdDVXhze4S6UmutYTLmYS4Jr9ACYb,fbPkOYLVPtPgIt0MxizjfFJov3JbHyAi,20,37,0,0,1,1,13,0,52,7.428571428571429,3,0.0,0,0,0,1,37,1,0,13,0,1,51,1
1759,19810,Gwx6NHIDtKbDhZ9qq0DoHrv95iBiEB1U,fbPkOYLVPtPgIt0MxizjfFJov3JbHyAi,2,0,0,0,0,0,2,0,2,0.2857142857142857,2,0.0,0,0,0,0,0,0,0,2,0,0,2,0
1760,19814,lxHUxupmVUuN6U299GOAnBvW4C4Ubp0H,fbPkOYLVPtPgIt0MxizjfFJov3JbHyAi,18,23,10,0,7,0,7,0,47,6.714285714285714,4,0.0,0,10,0,7,23,0,0,7,0,17,30,1
1761,19815,1NMKAl678ZBpdBkhXfYTAgEyYygMZz0x,fbPkOYLVPtPgIt0MxizjfFJov3JbHyAi,5,2,1,0,1,4,2,0,10,1.4285714285714286,1,0.0,0,1,0,1,2,4,0,2,0,2,8,1
1762,19818,vjUSE4bgwDQC5HnxxZ5hkgXMs7C5kFpu,fbPkOYLVPtPgIt0MxizjfFJov3JbHyAi,8,8,6,0,1,0,9,2,26,3.7142857142857144,2,0.0,0,6,0,1,8,0,0,9,2,7,19,1
1763,19819,Psc0x9bwTA2QigjfdORw9GCdjVkSZA2A,fbPkOYLVPtPgIt0MxizjfFJov3JbHyAi,7,7,0,0,2,14,5,1,29,4.142857142857143,1,0.0,4,0,0,2,3,14,0,5,1,6,23,1
1764,19820,uUas23B5BASlNq70mr2W0D90rbZsDp9I,fbPkOYLVPtPgIt0MxizjfFJov3JbHyAi,1,0,0,0,0,0,3,0,3,0.42857142857142855,1,0.0,0,0,0,0,0,0,0,3,0,0,3,1
1765,19821,zXwLjZ50Cji8fztc0B2bslPL9Qi2XHaI,fbPkOYLVPtPgIt0MxizjfFJov3JbHyAi,12,5,3,4,3,1,6,1,23,3.2857142857142856,1,0.0,1,3,3,3,4,1,1,6,1,10,13,1
1766,19822,5MN7pHb9NYTV49RYHFa2nAB0siwac3Fy,fbPkOYLVPtPgIt0MxizjfFJov3JbHyAi,4,0,0,0,0,1,4,0,5,0.7142857142857143,1,0.0,0,0,0,0,0,1,0,4,0,0,5,1
1767,19823,bUWcfbWQ4EJOw9u39LuSlWdeodW7fOna,fbPkOYLVPtPgIt0MxizjfFJov3JbHyAi,9,7,4,0,5,0,2,0,18,2.5714285714285716,1,0.0,2,4,0,5,5,0,0,2,0,11,7,1
1768,19824,eNb7XRS8Q3wFtMfryy1D5nNWvhGj2o8v,fbPkOYLVPtPgIt0MxizjfFJov3JbHyAi,1,0,0,0,0,0,1,0,1,0.14285714285714285,1,0.0,0,0,0,0,0,0,0,1,0,0,1,1
1769,19825,MXrTIwWI5paes908dD3STKMpnrGJOoNO,fbPkOYLVPtPgIt0MxizjfFJov3JbHyAi,12,18,6,4,6,0,4,3,41,5.857142857142857,2,0.0,8,6,3,6,10,0,1,4,3,23,18,1
1770,19827,IKvqinkDWiPNKr8H3jp05XvxFjOVjhOj,fbPkOYLVPtPgIt0MxizjfFJov3JbHyAi,8,5,1,0,1,0,7,1,15,2.142857142857143,2,0.0,0,1,0,1,5,0,0,7,1,2,13,1
1771,19828,35U2BNXuS9D65uTVA2fa3pi1wj26AmH8,fbPkOYLVPtPgIt0MxizjfFJov3JbHyAi,41,80,59,19,31,2,8,0,199,28.428571428571427,2,0.0,18,59,19,31,62,2,0,8,0,127,72,1
1772,19829,XQUx3MwVudtjeHmsju8PhHxsdXW0kluK,fbPkOYLVPtPgIt0MxizjfFJov3JbHyAi,46,130,69,50,39,2,17,0,307,43.857142857142854,4,0.0,49,69,48,39,81,2,2,17,0,205,102,1
1773,19833,HgGs6QavYmEoVlzJBRQZ1VM1JzFodPBe,fbPkOYLVPtPgIt0MxizjfFJov3JbHyAi,7,8,3,4,3,0,2,0,20,2.857142857142857,1,0.0,4,3,3,3,4,0,1,2,0,13,7,1
1774,19834,uVhSYke06PCowTkKK0TnzYsz7ytxSXo0,fbPkOYLVPtPgIt0MxizjfFJov3JbHyAi,7,3,2,0,0,2,6,2,15,2.142857142857143,1,0.0,0,2,0,0,3,2,0,6,2,2,13,1
1775,19836,Je1fglzWzz7Ubv1tp06pLOT4u9z98Ytt,fbPkOYLVPtPgIt0MxizjfFJov3JbHyAi,7,3,2,0,2,0,2,0,9,1.2857142857142858,1,0.0,0,2,0,2,3,0,0,2,0,4,5,1
1776,19838,t0CXTWQ7WrgANKqIJnC4VUgKY5pjWYTr,fbPkOYLVPtPgIt0MxizjfFJov3JbHyAi,10,8,5,2,4,0,3,0,22,3.142857142857143,1,0.0,1,5,2,4,7,0,0,3,0,12,10,1
1777,19840,cp0mDdUb6VxZ2pGbwlIxMgdC20NVEaQ4,fbPkOYLVPtPgIt0MxizjfFJov3JbHyAi,1,0,0,0,0,0,1,0,1,0.14285714285714285,1,0.0,0,0,0,0,0,0,0,1,0,0,1,1
1778,19841,a9t5CEcjAfQWyvzEkAK92JIcTHveQuDM,fbPkOYLVPtPgIt0MxizjfFJov3JbHyAi,7,8,2,0,1,0,2,0,13,1.8571428571428572,1,0.0,0,2,0,1,8,0,0,2,0,3,10,1
1779,19842,bKIU4h5S6pxVBBvQYicGGZljVmGThQTZ,fbPkOYLVPtPgIt0MxizjfFJov3JbHyAi,17,63,20,18,23,8,25,6,163,23.285714285714285,7,0.0,23,20,12,23,40,8,6,25,6,78,85,1
1780,19843,T3QyKd9fTQnVL3QXwMXmpa9VWP9rOfpT,fbPkOYLVPtPgIt0MxizjfFJov3JbHyAi,5,2,1,0,1,0,2,0,6,0.8571428571428571,1,0.0,0,1,0,1,2,0,0,2,0,2,4,1
1781,19844,TlJVvBC6ZZacGRqb7kuKo7HQvBARJCM4,fbPkOYLVPtPgIt0MxizjfFJov3JbHyAi,6,2,1,0,1,0,6,0,10,1.4285714285714286,1,0.0,0,1,0,1,2,0,0,6,0,2,8,1
1782,19847,KRnn8XVP0dgmIdWOTGU35QhJLJDHduYk,fbPkOYLVPtPgIt0MxizjfFJov3JbHyAi,1,0,0,0,0,0,1,0,1,0.14285714285714285,1,0.0,0,0,0,0,0,0,0,1,0,0,1,1
1783,19849,mvpXmdYDyNuTBu09E8ipnS5MHRHy94Z3,fbPkOYLVPtPgIt0MxizjfFJov3JbHyAi,1,0,0,0,0,0,1,0,1,0.14285714285714285,1,0.0,0,0,0,0,0,0,0,1,0,0,1,1
1784,19850,UpdEFuakVIRY83Er2LIy9VWQWoA2gpIx,fbPkOYLVPtPgIt0MxizjfFJov3JbHyAi,6,2,1,0,1,0,3,1,8,1.1428571428571428,1,0.0,0,1,0,1,2,0,0,3,1,2,6,1
1785,19851,9JKtUaJcAEBh7CYVmXIhRY2O1dODpq4M,fbPkOYLVPtPgIt0MxizjfFJov3JbHyAi,8,5,2,0,2,1,6,1,17,2.4285714285714284,1,0.0,0,2,0,2,5,1,0,6,1,4,13,1
1786,19852,4qaBwsaC0pfXg0219Ny01dop8gTlFMu6,fbPkOYLVPtPgIt0MxizjfFJov3JbHyAi,8,6,4,0,3,0,4,0,17,2.4285714285714284,2,0.0,0,4,0,3,6,0,0,4,0,7,10,1
1787,19853,yDFNgKY5UYQPIwh86Jl7JH0GU7drQgSP,fbPkOYLVPtPgIt0MxizjfFJov3JbHyAi,1,0,0,0,0,0,1,0,1,0.14285714285714285,1,0.0,0,0,0,0,0,0,0,1,0,0,1,1
1788,19854,yEEPICUjqVU7brBN4wrh8xK8bTVFbXDy,fbPkOYLVPtPgIt0MxizjfFJov3JbHyAi,7,6,2,0,2,0,2,0,12,1.7142857142857142,1,0.0,0,2,0,2,6,0,0,2,0,4,8,1
1789,19855,hr3tXA8jmCXsxdUFfi43JuiRTUpoDlMt,fbPkOYLVPtPgIt0MxizjfFJov3JbHyAi,4,2,0,0,0,1,2,0,5,0.7142857142857143,2,0.0,0,0,0,0,2,1,0,2,0,0,5,0
1790,19857,oB66Su2y0fKCmlftIiys81THD7pT5Kwq,fbPkOYLVPtPgIt0MxizjfFJov3JbHyAi,6,4,2,0,1,0,3,0,10,1.4285714285714286,2,0.0,0,2,0,1,4,0,0,3,0,3,7,1
1791,19859,xqYFyIT46SV7QvhQMGzYnnx9x1RIvm9K,fbPkOYLVPtPgIt0MxizjfFJov3JbHyAi,4,0,0,0,0,1,3,1,5,0.7142857142857143,1,0.0,0,0,0,0,0,1,0,3,1,0,5,1
1792,19860,GFpBLlPKlIeg4yYkbxEh26IfN8cMuAmf,fbPkOYLVPtPgIt0MxizjfFJov3JbHyAi,8,5,2,0,3,0,6,0,16,2.2857142857142856,1,0.0,2,2,0,3,3,0,0,6,0,7,9,1
1793,19861,kMADhIGduPqSkYFwoAlaAOq4Z3kg8su8,fbPkOYLVPtPgIt0MxizjfFJov3JbHyAi,13,35,24,0,15,1,13,0,88,12.571428571428571,5,0.0,0,24,0,15,35,1,0,13,0,39,49,0
1794,19866,BOBLP6pTmRtpQ8LtVgJyutFMDL3q6xno,fbPkOYLVPtPgIt0MxizjfFJov3JbHyAi,38,54,30,21,20,13,9,1,148,21.142857142857142,10,0.0,16,30,18,20,38,13,3,9,1,84,64,0
1795,19867,SxX5znCjYpr86kkQyrVn3BfwaCzWOPGc,fbPkOYLVPtPgIt0MxizjfFJov3JbHyAi,1,0,0,0,0,0,1,0,1,0.14285714285714285,1,0.0,0,0,0,0,0,0,0,1,0,0,1,1
1796,19868,IW1rPvW2Bte4OLapfIZWsk9LSVWmKs26,fbPkOYLVPtPgIt0MxizjfFJov3JbHyAi,9,12,8,0,5,2,6,0,33,4.714285714285714,1,0.0,0,8,0,5,12,2,0,6,0,13,20,1
1797,19869,jUJD4zc1LqwiHBuYXxVgX9j6xi6RKWgV,fbPkOYLVPtPgIt0MxizjfFJov3JbHyAi,23,14,9,0,8,7,8,1,47,6.714285714285714,2,0.0,2,9,0,8,12,7,0,8,1,19,28,1
1798,19870,ynbQlisqFiyBzv22bYVgrb1CTn5JfjMW,fbPkOYLVPtPgIt0MxizjfFJov3JbHyAi,7,3,2,0,2,0,2,0,9,1.2857142857142858,1,0.0,0,2,0,2,3,0,0,2,0,4,5,1
1799,19871,vuIldWG0zIZiagbsArdWgNONid3wMi26,fbPkOYLVPtPgIt0MxizjfFJov3JbHyAi,16,18,0,0,0,0,14,2,34,4.857142857142857,2,0.0,0,0,0,0,18,0,0,14,2,0,34,0
1800,19872,foOeNx7QB7iDsgeA0D657sokODh0QEAw,fbPkOYLVPtPgIt0MxizjfFJov3JbHyAi,9,13,3,3,4,0,4,0,27,3.857142857142857,3,0.0,2,3,2,4,11,0,1,4,0,11,16,1
1801,19873,gVvL6RmTRBe8pjHtydeg9sOn3yGJFctB,fbPkOYLVPtPgIt0MxizjfFJov3JbHyAi,6,1,0,0,0,2,4,1,8,1.1428571428571428,1,0.0,0,0,0,0,1,2,0,4,1,0,8,1
1802,19874,FJnM8KTgJkJ4RTmU7j0GlObcSBlrkSGR,fbPkOYLVPtPgIt0MxizjfFJov3JbHyAi,7,3,2,0,2,0,2,0,9,1.2857142857142858,1,0.0,0,2,0,2,3,0,0,2,0,4,5,1
1803,19875,YCFIP2rd7N9mtFDuRY6Eqqkecqrs4vTb,fbPkOYLVPtPgIt0MxizjfFJov3JbHyAi,7,6,3,0,1,9,4,1,24,3.4285714285714284,1,0.0,0,3,0,1,6,9,0,4,1,4,20,1
1804,19876,ig6krYSkue3MO5KtEMkAXakLUYviTHgU,fbPkOYLVPtPgIt0MxizjfFJov3JbHyAi,5,7,0,0,0,0,5,0,12,1.7142857142857142,1,0.0,0,0,0,0,7,0,0,5,0,0,12,1
1805,19877,9OvnGSufsqgkF0zk0lt4wMrdl04PgMkr,fbPkOYLVPtPgIt0MxizjfFJov3JbHyAi,1,0,0,0,0,0,1,0,1,0.14285714285714285,1,0.0,0,0,0,0,0,0,0,1,0,0,1,1
1806,19879,1foSXZwCCr5lR9Aws6pCnQ1ZUbu5TIHp,fbPkOYLVPtPgIt0MxizjfFJov3JbHyAi,5,8,4,0,2,0,2,0,16,2.2857142857142856,2,0.0,0,4,0,2,8,0,0,2,0,6,10,0
1807,19884,NqKjMSY6eOZQ1uSyzlPrquJVqzjvSO7O,fbPkOYLVPtPgIt0MxizjfFJov3JbHyAi,36,77,48,10,39,19,14,1,208,29.714285714285715,7,0.0,13,48,8,39,64,19,2,14,1,108,100,1
1808,19885,A6nWdlGih5qGNSA7X8sCBpQ5KoSeu0HC,fbPkOYLVPtPgIt0MxizjfFJov3JbHyAi,2,0,0,0,0,0,3,0,3,0.42857142857142855,2,0.0,0,0,0,0,0,0,0,3,0,0,3,1
1809,19886,ovFlS72dfchdekZxDK8eGHjXjC0Q6ofX,fbPkOYLVPtPgIt0MxizjfFJov3JbHyAi,8,16,8,0,3,0,3,0,30,4.285714285714286,2,0.0,0,8,0,3,16,0,0,3,0,11,19,1
1810,19887,VleZx6AMrGRAMIGS9OzdztH8msuxEpLN,fbPkOYLVPtPgIt0MxizjfFJov3JbHyAi,1,0,0,0,0,0,1,0,1,0.14285714285714285,1,0.0,0,0,0,0,0,0,0,1,0,0,1,1
1811,19888,dgZyMqZ7S2zEOAUOkBV4Iw21KUChsDnG,fbPkOYLVPtPgIt0MxizjfFJov3JbHyAi,1,0,0,0,0,0,1,0,1,0.14285714285714285,1,0.0,0,0,0,0,0,0,0,1,0,0,1,1
1812,19889,esagsd88OzgcWVyUBv4e4lrejs4sAfDh,fbPkOYLVPtPgIt0MxizjfFJov3JbHyAi,4,3,0,0,0,0,3,0,6,0.8571428571428571,1,0.0,0,0,0,0,3,0,0,3,0,0,6,0
1813,19893,NAeglY8cYFpzQKpSfjAgfrtdD2qzmpB5,fbPkOYLVPtPgIt0MxizjfFJov3JbHyAi,33,70,21,0,11,58,27,0,187,26.714285714285715,10,0.0,3,21,0,11,67,58,0,27,0,35,152,0
1814,19894,csHCA49GIFIMIMhddtJXr13v0W45c2zX,fbPkOYLVPtPgIt0MxizjfFJov3JbHyAi,5,2,1,0,1,0,2,0,6,0.8571428571428571,1,0.0,0,1,0,1,2,0,0,2,0,2,4,1
1815,19895,DNuzfFZaKzq1rWcHLzrBtPkDL7hdOTyB,fbPkOYLVPtPgIt0MxizjfFJov3JbHyAi,9,16,8,4,8,0,7,0,43,6.142857142857143,2,0.0,6,8,3,8,10,0,1,7,0,25,18,1
1816,19896,XPjAO3f97ZJcCpAApqMVf8ngBFZ3HzQd,fbPkOYLVPtPgIt0MxizjfFJov3JbHyAi,3,2,0,0,0,0,1,0,3,0.42857142857142855,1,0.0,0,0,0,0,2,0,0,1,0,0,3,1
1817,19897,xdXdQD6d3ouQxPFQHtUqoRivYIjaf4BI,fbPkOYLVPtPgIt0MxizjfFJov3JbHyAi,10,9,3,0,2,15,12,3,44,6.285714285714286,2,0.0,0,3,0,2,9,15,0,12,3,5,39,1
1818,19898,Ng1jToRjDK8omnYgabDdTz8XK2pnHjqz,fbPkOYLVPtPgIt0MxizjfFJov3JbHyAi,7,6,2,0,1,0,3,0,12,1.7142857142857142,1,0.0,0,2,0,1,6,0,0,3,0,3,9,1
1819,19903,yUSW5IznwhnzD0ElBVHBvUlhh23ZO3ve,fbPkOYLVPtPgIt0MxizjfFJov3JbHyAi,5,2,1,0,1,0,2,0,6,0.8571428571428571,1,0.0,0,1,0,1,2,0,0,2,0,2,4,1
1820,19905,3GUwU7gGfH9QSI4jt2ezx9kun1vMueYz,fbPkOYLVPtPgIt0MxizjfFJov3JbHyAi,7,3,1,0,1,1,4,1,11,1.5714285714285714,1,0.0,0,1,0,1,3,1,0,4,1,2,9,1
1821,19906,0CXKn1HfInqkCvrX7MeQPFZQO5dZ0oCE,fbPkOYLVPtPgIt0MxizjfFJov3JbHyAi,9,6,5,0,5,0,2,0,18,2.5714285714285716,1,0.0,0,5,0,5,6,0,0,2,0,10,8,1
1822,19907,vDr9SspvKA7PR8FwpNzXdQMEFONy3TNW,fbPkOYLVPtPgIt0MxizjfFJov3JbHyAi,1,0,0,0,0,0,1,0,1,0.14285714285714285,1,0.0,0,0,0,0,0,0,0,1,0,0,1,1
1823,19908,sxJROJWWpXBhtZ5cBce4vLa62HcIMLBD,fbPkOYLVPtPgIt0MxizjfFJov3JbHyAi,5,3,2,0,2,0,2,0,9,1.2857142857142858,1,0.0,0,2,0,2,3,0,0,2,0,4,5,1
1824,19912,pvxjw4szSuluDWQ3DWPes9Mzs1MCvxjI,fbPkOYLVPtPgIt0MxizjfFJov3JbHyAi,9,7,4,0,2,1,4,1,19,2.7142857142857144,1,0.0,0,4,0,2,7,1,0,4,1,6,13,1
1825,19916,AhEZQvNIIn2lXBelWns2lgtmj9ZMEiO6,fbPkOYLVPtPgIt0MxizjfFJov3JbHyAi,1,0,0,0,0,0,1,0,1,0.14285714285714285,1,0.0,0,0,0,0,0,0,0,1,0,0,1,1
1826,19917,HwGdYA9FLmZeF9QWVKJTGzkq5gZ7zUGa,fbPkOYLVPtPgIt0MxizjfFJov3JbHyAi,6,3,2,0,2,0,1,0,8,1.1428571428571428,1,0.0,0,2,0,2,3,0,0,1,0,4,4,1
1827,19918,xZymr065e4jMs1k7FdN1s1dPRCmzgAiD,fbPkOYLVPtPgIt0MxizjfFJov3JbHyAi,1,0,0,0,0,0,1,0,1,0.14285714285714285,1,0.0,0,0,0,0,0,0,0,1,0,0,1,1
1828,19920,VfXq2XzbXkkKi937rrheKnFTqIJJNxri,fbPkOYLVPtPgIt0MxizjfFJov3JbHyAi,1,0,0,0,0,0,2,0,2,0.2857142857142857,1,0.0,0,0,0,0,0,0,0,2,0,0,2,1
1829,19926,1InE8cdjhx7tJRBfUjLOpNXVGiOXTrtd,fbPkOYLVPtPgIt0MxizjfFJov3JbHyAi,11,33,15,0,3,41,18,1,111,15.857142857142858,4,0.0,0,15,0,3,33,41,0,18,1,18,93,1
1830,19928,97ov4fTuLcUGM3NRcbowYBsVQSUEYP2S,fbPkOYLVPtPgIt0MxizjfFJov3JbHyAi,1,0,0,0,0,0,1,0,1,0.14285714285714285,1,0.0,0,0,0,0,0,0,0,1,0,0,1,1
1831,19932,G2qWD1bGIYovTM2Y7RxiPiKf92aFGc9X,fbPkOYLVPtPgIt0MxizjfFJov3JbHyAi,27,36,19,16,14,36,12,0,133,19.0,1,0.0,13,19,14,14,23,36,2,12,0,60,73,1
1832,19933,wnXrCFQnu5K77E0TUKHPXLbEZiXu32Gt,fbPkOYLVPtPgIt0MxizjfFJov3JbHyAi,37,43,28,33,22,0,6,0,132,18.857142857142858,2,0.0,11,28,30,22,32,0,3,6,0,91,41,1
1833,19934,GyWTABuPpZEqO585EnNTIpM2B2faPYN3,fbPkOYLVPtPgIt0MxizjfFJov3JbHyAi,12,9,6,0,4,0,4,0,23,3.2857142857142856,4,0.0,0,6,0,4,9,0,0,4,0,10,13,1
1834,19935,wEajQeQse5CzhcFd5XXOtEsUUddZZAU5,fbPkOYLVPtPgIt0MxizjfFJov3JbHyAi,15,32,12,13,13,1,10,1,82,11.714285714285714,3,0.0,16,12,10,13,16,1,3,10,1,51,31,0
1835,19936,viuKt4GgrX0rYL5EpHoxJbsiC9TblSuk,fbPkOYLVPtPgIt0MxizjfFJov3JbHyAi,29,95,56,1,30,60,40,0,282,40.285714285714285,11,0.0,12,56,1,30,83,60,0,40,0,99,183,0
1836,19937,TW2XIE8RVUXEKU7cj0LXiqnV9PpOeW5X,fbPkOYLVPtPgIt0MxizjfFJov3JbHyAi,9,5,4,0,3,0,3,0,15,2.142857142857143,1,0.0,0,4,0,3,5,0,0,3,0,7,8,1
1837,19938,33YJhO56Hz6X3YkBaXAE8jLXj3hGQz0E,fbPkOYLVPtPgIt0MxizjfFJov3JbHyAi,12,12,7,4,4,0,5,0,32,4.571428571428571,3,0.0,2,7,3,4,10,0,1,5,0,16,16,1
1838,19939,7uDVcwukNss0paMtTOJXNPZUXWP9vYuG,fbPkOYLVPtPgIt0MxizjfFJov3JbHyAi,4,2,1,0,1,0,1,0,5,0.7142857142857143,1,0.0,0,1,0,1,2,0,0,1,0,2,3,1
1839,19940,eeYj7ooXMmKNnXyjLGvyz7RVwRLoScYs,fbPkOYLVPtPgIt0MxizjfFJov3JbHyAi,7,3,2,0,2,0,2,0,9,1.2857142857142858,1,0.0,0,2,0,2,3,0,0,2,0,4,5,1
1840,19941,a7hY9wWK5IElJ1dZWTInS8ONEoRm1ika,fbPkOYLVPtPgIt0MxizjfFJov3JbHyAi,4,2,0,0,0,0,3,0,5,0.7142857142857143,2,0.0,0,0,0,0,2,0,0,3,0,0,5,1
1841,19942,je9A6l6tP7wnbFhNJD7vbbHTYhqshuqB,fbPkOYLVPtPgIt0MxizjfFJov3JbHyAi,28,76,29,16,17,14,23,2,177,25.285714285714285,7,0.0,16,29,11,17,60,14,5,23,2,73,104,1
1842,19943,yS4oyG8z71VcMw1yy9w2LWRiDWgGhtKA,fbPkOYLVPtPgIt0MxizjfFJov3JbHyAi,1,0,0,0,0,0,1,0,1,0.14285714285714285,1,0.0,0,0,0,0,0,0,0,1,0,0,1,1
1843,19947,ZkhJUa8EJMEosRkUx3uFogoZkW9dBDLF,fbPkOYLVPtPgIt0MxizjfFJov3JbHyAi,5,2,1,0,1,0,2,0,6,0.8571428571428571,1,0.0,0,1,0,1,2,0,0,2,0,2,4,1
1844,19948,yvyZaz4xAz9F6HZ98hADpdZbO8B3aQLI,fbPkOYLVPtPgIt0MxizjfFJov3JbHyAi,4,2,0,0,0,0,3,0,5,0.7142857142857143,1,0.0,0,0,0,0,2,0,0,3,0,0,5,1
1845,19949,lulY8D00ct0beDGYE4CRU9KsINnQRaV8,fbPkOYLVPtPgIt0MxizjfFJov3JbHyAi,13,37,18,0,8,1,14,2,80,11.428571428571429,4,0.0,3,18,0,8,34,1,0,14,2,29,51,0
1846,19951,rPw77eL90jbIeSFJYyvVIXe9A8wT4cw5,fbPkOYLVPtPgIt0MxizjfFJov3JbHyAi,5,2,1,0,1,3,3,0,10,1.4285714285714286,1,0.0,0,1,0,1,2,3,0,3,0,2,8,1
1847,19953,7rTP5bps09htLBiewU1OlHyTn48UEKTD,fbPkOYLVPtPgIt0MxizjfFJov3JbHyAi,4,2,1,0,1,0,1,0,5,0.7142857142857143,1,0.0,0,1,0,1,2,0,0,1,0,2,3,1
1848,19955,Y7REnesylqzkGeCcXJqxiJ4B25LlDJnj,fbPkOYLVPtPgIt0MxizjfFJov3JbHyAi,8,4,3,0,2,0,4,0,13,1.8571428571428572,2,0.0,0,3,0,2,4,0,0,4,0,5,8,1
1849,19956,MelNG8TL1wwoBfj4YB6xJw5vokLsJ0c9,fbPkOYLVPtPgIt0MxizjfFJov3JbHyAi,1,0,0,0,0,0,1,0,1,0.14285714285714285,1,0.0,0,0,0,0,0,0,0,1,0,0,1,1
1850,21459,NH0hsgo5xcqAdosarQoW4RQUZxH32Gzl,7GRhBDsirIGkRZBtSMEzNTyDr2JQm4xx,51,170,74,73,49,9,19,0,394,56.285714285714285,8,0.0,57,74,67,49,113,9,6,19,0,247,147,0
1851,21468,Hj6wuu6IJzCenxWAs1sLyWNMm32YIpDq,7GRhBDsirIGkRZBtSMEzNTyDr2JQm4xx,52,196,87,122,38,43,30,0,516,73.71428571428571,11,0.0,50,87,108,38,146,43,14,30,0,283,233,0
1852,21473,fd2e5NJVnyVwHFHuiTOOM639ZY1uThtn,7GRhBDsirIGkRZBtSMEzNTyDr2JQm4xx,68,240,74,132,36,112,34,2,630,90.0,12,0.0,127,74,108,36,113,112,24,34,2,345,285,1
1853,21485,l3mz2aAslwaCLhkdMrM7sQ5OXLzl6A2r,7GRhBDsirIGkRZBtSMEzNTyDr2JQm4xx,57,111,6,139,24,16,15,1,312,44.57142857142857,4,0.0,61,6,125,24,50,16,14,15,1,216,96,0
1854,21487,ppwn795jM3X8HLmfBGWlJ1RCSK9HLpNe,7GRhBDsirIGkRZBtSMEzNTyDr2JQm4xx,5,3,2,0,1,0,1,0,7,1.0,1,0.0,0,2,0,1,3,0,0,1,0,3,4,0
1855,21496,z6p7uYa25VIrmVARFxz5koBofuqHB2cM,7GRhBDsirIGkRZBtSMEzNTyDr2JQm4xx,73,102,35,94,29,3,11,0,274,39.142857142857146,4,0.0,60,35,82,29,42,3,12,11,0,206,68,0
1856,21497,NToJOpRtq67cszdyzl1RlLKqGwS5lZl5,7GRhBDsirIGkRZBtSMEzNTyDr2JQm4xx,45,55,19,82,17,0,6,0,179,25.571428571428573,4,0.0,31,19,69,17,24,0,13,6,0,136,43,1
1857,21514,ZhTCqX8GMUcn0a0betuEauHNuCk1aRhm,7GRhBDsirIGkRZBtSMEzNTyDr2JQm4xx,80,105,46,98,20,110,29,0,408,58.285714285714285,7,0.0,34,46,91,20,71,110,7,29,0,191,217,0
1858,21518,j5n34dhJSAsFAv6KAw4rsAZTfhL07lCD,7GRhBDsirIGkRZBtSMEzNTyDr2JQm4xx,2,0,0,0,0,0,2,0,2,0.2857142857142857,1,0.0,0,0,0,0,0,0,0,2,0,0,2,1
1859,21524,6Ysh3EXeoiNCd1uXxsjEQronkryNKRU5,7GRhBDsirIGkRZBtSMEzNTyDr2JQm4xx,52,165,65,74,32,7,25,0,368,52.57142857142857,7,0.0,73,65,63,32,92,7,11,25,0,233,135,1
1860,21529,Lf0mThPYOrtlCzgRGBCVTPy1hiGUII8h,7GRhBDsirIGkRZBtSMEzNTyDr2JQm4xx,45,356,116,81,24,71,65,17,730,104.28571428571429,11,0.0,188,116,56,24,168,71,25,65,17,384,346,0
1861,21531,GvY4Z1NOjK4oYpeBStbrl7zpe2zlFqoT,7GRhBDsirIGkRZBtSMEzNTyDr2JQm4xx,66,141,53,175,34,5,10,0,418,59.714285714285715,7,0.0,69,53,148,34,72,5,27,10,0,304,114,0
1862,21537,ofcigTTYbE1oojdrdB7FR2yHe6nxdUzR,7GRhBDsirIGkRZBtSMEzNTyDr2JQm4xx,66,101,31,42,57,2,8,0,241,34.42857142857143,5,0.0,68,31,36,57,33,2,6,8,0,192,49,0
1863,21545,be7952wawx5BhhJ4vIqX6Vxi48lNKbM1,7GRhBDsirIGkRZBtSMEzNTyDr2JQm4xx,5,11,8,0,7,2,5,0,33,4.714285714285714,7,0.0,0,8,0,7,11,2,0,5,0,15,18,1
1864,21558,dQBjOw3ZDQ2EPHOdT4W6pRAoF6sniGIc,7GRhBDsirIGkRZBtSMEzNTyDr2JQm4xx,43,65,32,65,18,6,25,1,212,30.285714285714285,5,0.0,27,32,58,18,38,6,7,25,1,135,77,1
1865,21561,OaI9ma7KxaY6DFxSwgYhrXCPXva2T3pp,7GRhBDsirIGkRZBtSMEzNTyDr2JQm4xx,68,153,58,132,33,10,26,0,412,58.857142857142854,7,0.0,62,58,110,33,91,10,22,26,0,263,149,0
1866,21564,w1NKmDhRc1aeBgZmDEyDguSkZ23SdrlX,7GRhBDsirIGkRZBtSMEzNTyDr2JQm4xx,14,9,4,4,3,0,7,0,27,3.857142857142857,1,0.0,2,4,3,3,7,0,1,7,0,12,15,1
1867,21570,y9BxmAhm0ieCF6b0HaF7gMrGu5BDtZs5,7GRhBDsirIGkRZBtSMEzNTyDr2JQm4xx,107,371,144,267,119,13,66,0,980,140.0,8,0.0,190,144,217,119,181,13,50,66,0,670,310,0
1868,21618,TzODuX5kuf2iqGNG9vk0uMzeGNqx5LsA,7GRhBDsirIGkRZBtSMEzNTyDr2JQm4xx,39,142,9,47,8,0,23,2,231,33.0,3,0.0,55,9,31,8,87,0,16,23,2,103,128,0
1869,21638,mwc0YjZS72xD4dO6Zk7KmFewdh7PWkAS,7GRhBDsirIGkRZBtSMEzNTyDr2JQm4xx,63,169,52,77,55,9,14,0,376,53.714285714285715,10,0.0,101,52,74,55,68,9,3,14,0,282,94,0
1870,21640,yf6f57VN5vQ3uXtZoopqYTtboGpfts8e,7GRhBDsirIGkRZBtSMEzNTyDr2JQm4xx,27,18,7,28,5,0,3,0,61,8.714285714285714,1,0.0,8,7,25,5,10,0,3,3,0,45,16,0
1871,21659,D5mwgoAPtfwdsFrdNADBqEJQSy8E0CUi,7GRhBDsirIGkRZBtSMEzNTyDr2JQm4xx,104,195,96,133,56,22,80,2,584,83.42857142857143,12,0.0,59,96,121,56,136,22,12,80,2,332,252,0
1872,21672,c9jABEJQla4i8vH29nKPFM4cx5bWdrLS,7GRhBDsirIGkRZBtSMEzNTyDr2JQm4xx,87,259,116,83,94,7,27,2,588,84.0,7,0.0,118,116,79,94,141,7,4,27,2,407,181,0
1873,21690,mezQjcBtwPIB1SXkjHJo9kxjc5UIXdOH,7GRhBDsirIGkRZBtSMEzNTyDr2JQm4xx,104,206,79,181,69,14,23,0,572,81.71428571428571,7,0.0,103,79,145,69,103,14,36,23,0,396,176,1
1874,21692,rf43ZHojMqXQ775bmX3nnHgQ62d9XvGK,7GRhBDsirIGkRZBtSMEzNTyDr2JQm4xx,9,7,2,11,2,0,12,0,34,4.857142857142857,5,0.0,2,2,9,2,5,0,2,12,0,15,19,1
1875,21708,aU6SEeOgxLKetBRDwfHMDunWavvfr54M,7GRhBDsirIGkRZBtSMEzNTyDr2JQm4xx,40,119,18,51,26,18,19,0,251,35.857142857142854,8,0.0,49,18,46,26,70,18,5,19,0,139,112,0
1876,21816,5M2ejSoYrgCHrezYAGX7ObuTLuLA6uzQ,7GRhBDsirIGkRZBtSMEzNTyDr2JQm4xx,4,2,1,0,1,0,1,0,5,0.7142857142857143,1,0.0,0,1,0,1,2,0,0,1,0,2,3,1
1877,21820,GGGVxWw7kUcQH8IveSqLixfu0u0FTfvz,7GRhBDsirIGkRZBtSMEzNTyDr2JQm4xx,6,2,0,0,0,1,6,0,9,1.2857142857142858,1,0.0,0,0,0,0,2,1,0,6,0,0,9,1
1878,21870,3OGm4X1PEnAaZoBoZXt04kXOR4TFtoHS,7GRhBDsirIGkRZBtSMEzNTyDr2JQm4xx,37,70,28,58,37,1,17,0,211,30.142857142857142,6,0.0,39,28,50,37,31,1,8,17,0,154,57,1
1879,21900,LRwPaW9GtyhH2VMWEMsABaY8IaWh4rBR,7GRhBDsirIGkRZBtSMEzNTyDr2JQm4xx,100,105,28,171,43,21,9,1,378,54.0,2,0.0,72,28,132,43,33,21,39,9,1,275,103,1
1880,21922,UyrB62TC80PvjIx5mHAqyBQJHo9hnImU,7GRhBDsirIGkRZBtSMEzNTyDr2JQm4xx,7,3,2,0,2,0,4,0,11,1.5714285714285714,2,0.0,0,2,0,2,3,0,0,4,0,4,7,1
1881,21976,MYCZGZUUB6h2kR5SWwXC3erQhe8wj439,7GRhBDsirIGkRZBtSMEzNTyDr2JQm4xx,58,97,33,73,22,27,26,0,278,39.714285714285715,8,0.0,51,33,72,22,46,27,1,26,0,178,100,0
1882,21999,r6bvKJ2a2G72TbQZE3LacWwmKi7rGXEx,7GRhBDsirIGkRZBtSMEzNTyDr2JQm4xx,38,113,35,39,18,19,19,3,246,35.142857142857146,4,0.0,41,35,35,18,72,19,4,19,3,129,117,1
1883,22022,wXFfHtwd9smrvhh9NQW7SmEEo1001LDW,7GRhBDsirIGkRZBtSMEzNTyDr2JQm4xx,35,39,16,36,12,11,8,1,123,17.571428571428573,3,0.0,18,16,31,12,21,11,5,8,1,77,46,1
1884,22062,MuwljKZkWjKmChDtxaHsKSqu30ykavpg,7GRhBDsirIGkRZBtSMEzNTyDr2JQm4xx,48,134,41,44,19,3,11,2,254,36.285714285714285,6,0.0,55,41,41,19,79,3,3,11,2,156,98,0
1885,22212,ezzV2inIlk654APZ7lOJdt6ubCpUxMCa,7GRhBDsirIGkRZBtSMEzNTyDr2JQm4xx,72,196,27,134,28,164,36,5,590,84.28571428571429,12,0.0,82,27,111,28,114,164,23,36,5,248,342,0
1886,22268,tixL6jRbFRYTnAeCUMfXKIdV2z5MfmCZ,7GRhBDsirIGkRZBtSMEzNTyDr2JQm4xx,38,37,33,14,22,0,11,0,117,16.714285714285715,3,0.0,1,33,11,22,36,0,3,11,0,67,50,1
1887,22640,SXQudUQxotVyHX3jIj58IdonMUWj4z4L,RXDvfPUBYFlVdlueBFbLW0mhhAyGEqpt,61,149,81,114,17,1,31,0,393,56.142857142857146,6,0.0,36,81,112,17,113,1,2,31,0,246,147,0
1888,22647,ytmo5vQStkDdkr7G8Cx66kM5tANiVYa8,G8EPVSXsOYB5YQWZGiz1aVq5Pgr2GrQu,48,64,53,66,26,0,11,1,221,31.571428571428573,5,0.0,5,53,48,26,59,0,18,11,1,132,89,1
1889,22651,bPMM8JJVMbo3dHwzrkYwNanOXVlVjIZM,SpATywNh6bZuzm8s1ceuBUnMUAeoAHHw,25,66,44,18,35,4,6,0,173,24.714285714285715,11,0.0,17,44,15,35,49,4,3,6,0,111,62,0
1890,22655,DVzw8nYpE4lnf8MkHHhtHMESTcnd5SSm,A3fsA9Zfv1X2fVEQhTw51lKENdNrEqT3,7,3,2,0,2,0,4,0,11,1.5714285714285714,2,0.0,0,2,0,2,3,0,0,4,0,4,7,1
1891,22656,6r68uLeYBa0U5j97XGrLINpoFwwpiU0a,SpATywNh6bZuzm8s1ceuBUnMUAeoAHHw,24,99,9,5,4,1,20,4,142,20.285714285714285,9,0.0,18,9,5,4,81,1,0,20,4,36,106,0
1892,22658,3SER276qaao5TSZqnt0y9TkdmkGTUUcO,A3fsA9Zfv1X2fVEQhTw51lKENdNrEqT3,42,17,14,62,12,0,3,0,108,15.428571428571429,2,0.0,1,14,54,12,16,0,8,3,0,81,27,1
1893,22661,zgbCsvFYb3b53axsu4K7VNjBEGD1Bru2,G8EPVSXsOYB5YQWZGiz1aVq5Pgr2GrQu,33,103,5,27,5,49,21,3,213,30.428571428571427,4,0.0,13,5,23,5,90,49,4,21,3,46,167,1
1894,22663,v8EL49Rw5uIBfTnluJIiynUhJSONuHZw,A3fsA9Zfv1X2fVEQhTw51lKENdNrEqT3,24,7,2,38,0,0,1,0,48,6.857142857142857,2,0.0,2,2,38,0,5,0,0,1,0,42,6,1
1895,22666,8NZmD5KXyLIfbrDZRanIJvBfumgIsUhW,SpATywNh6bZuzm8s1ceuBUnMUAeoAHHw,16,40,15,16,1,0,7,0,79,11.285714285714286,5,0.0,15,15,15,1,25,0,1,7,0,46,33,0
1896,22672,xtQFPkqe4Pp8hbaCpifaLA8aJ90k2oDs,SpATywNh6bZuzm8s1ceuBUnMUAeoAHHw,20,68,2,12,2,0,4,0,88,12.571428571428571,5,0.0,22,2,9,2,46,0,3,4,0,35,53,0
1897,22675,FZWt1vapJFvo3kXFvlr3Pcq5dqSsXIdl,A3fsA9Zfv1X2fVEQhTw51lKENdNrEqT3,18,22,15,0,8,0,12,0,57,8.142857142857142,3,0.0,0,15,0,8,22,0,0,12,0,23,34,1
1898,22688,6aazLDsf7EAZ2t5BIjBNI9Ug5zAk9J2O,SpATywNh6bZuzm8s1ceuBUnMUAeoAHHw,29,31,16,20,6,5,9,0,87,12.428571428571429,4,0.0,4,16,18,6,27,5,2,9,0,44,43,0
1899,22699,f7tZxTkA0B7yOxMWeydGO2hW0y86mAhD,A3fsA9Zfv1X2fVEQhTw51lKENdNrEqT3,57,83,3,90,0,6,14,1,197,28.142857142857142,7,0.0,7,3,89,0,76,6,1,14,1,99,98,0
1900,22705,JoQg2qlyTB6aPyv163qnZSLUAy3J9zXZ,bWdj2GDclj5ofokWjzoa5jAwMkxCykd6,9,12,5,6,4,0,2,0,29,4.142857142857143,2,0.0,5,5,6,4,7,0,0,2,0,20,9,1
1901,22706,JoQg2qlyTB6aPyv163qnZSLUAy3J9zXZ,A3fsA9Zfv1X2fVEQhTw51lKENdNrEqT3,6,6,3,0,0,0,3,0,12,1.7142857142857142,3,0.0,0,3,0,0,6,0,0,3,0,3,9,1
1902,22711,TPPsOieQBcwqH8dqABTR3mddQ5gDzlZO,SpATywNh6bZuzm8s1ceuBUnMUAeoAHHw,28,36,15,41,8,0,12,0,112,16.0,4,0.0,18,15,35,8,18,0,6,12,0,76,36,0
1903,22720,4iz2t15J5bzEPElZVcStT3H8hpTNKJIQ,SpATywNh6bZuzm8s1ceuBUnMUAeoAHHw,15,23,9,18,0,2,4,0,56,8.0,3,0.0,7,9,15,0,16,2,3,4,0,31,25,0
1904,22733,IQ4ladQoM2x2909mlbY9xWKwXIcK6uEd,A3fsA9Zfv1X2fVEQhTw51lKENdNrEqT3,45,21,18,60,14,1,22,1,137,19.571428571428573,4,0.0,2,18,55,14,19,1,5,22,1,89,48,0
1905,22737,Os09VRrdiO6C7gqaf1B7u0gzmL7FIPJg,SpATywNh6bZuzm8s1ceuBUnMUAeoAHHw,19,75,17,31,0,17,11,1,152,21.714285714285715,3,0.0,54,17,27,0,21,17,4,11,1,98,54,1
1906,22760,xQ0oPcnoBqnptb23qNnWO05KL2jCqFC5,SpATywNh6bZuzm8s1ceuBUnMUAeoAHHw,7,26,9,0,0,1,9,0,45,6.428571428571429,6,0.0,8,9,0,0,18,1,0,9,0,17,28,1
1907,22779,Di3I8NyVIkGc06HLMDBeTqdX1iL5ZolI,A3fsA9Zfv1X2fVEQhTw51lKENdNrEqT3,6,0,0,0,0,4,12,0,16,2.2857142857142856,1,0.0,0,0,0,0,0,4,0,12,0,0,16,1
1908,22786,6TmTcNQyMYVAXbtK6HsQ96Mn7OGENU3z,bWdj2GDclj5ofokWjzoa5jAwMkxCykd6,4,2,1,0,0,0,2,0,5,0.7142857142857143,1,0.0,0,1,0,0,2,0,0,2,0,1,4,1
1909,22796,NEe9TsP56Xype0U6CLfwX8CaejtfAtDd,SpATywNh6bZuzm8s1ceuBUnMUAeoAHHw,22,80,8,43,1,2,28,1,163,23.285714285714285,5,0.0,27,8,36,1,53,2,7,28,1,72,91,0
1910,22805,6TmTcNQyMYVAXbtK6HsQ96Mn7OGENU3z,A3fsA9Zfv1X2fVEQhTw51lKENdNrEqT3,7,6,1,0,1,0,1,0,9,1.2857142857142858,1,0.0,0,1,0,1,6,0,0,1,0,2,7,1
1911,22822,jt6cAnJpqYCiS3Lj5wNBvifs8WZJznlF,A3fsA9Zfv1X2fVEQhTw51lKENdNrEqT3,9,4,3,0,3,0,3,0,13,1.8571428571428572,1,0.0,0,3,0,3,4,0,0,3,0,6,7,1
1912,22825,pgtfwPx3gBWk0s41FLIY8xNKvQvpnNYF,SpATywNh6bZuzm8s1ceuBUnMUAeoAHHw,25,42,2,25,3,9,13,1,95,13.571428571428571,2,0.0,12,2,19,3,30,9,6,13,1,36,59,0
1913,22828,pgtfwPx3gBWk0s41FLIY8xNKvQvpnNYF,A3fsA9Zfv1X2fVEQhTw51lKENdNrEqT3,10,5,1,0,1,2,10,2,21,3.0,3,0.0,0,1,0,1,5,2,0,10,2,2,19,1
1914,22844,TQIRy5vD7Rgv73APMCqQZ7AssMVX3u4N,A3fsA9Zfv1X2fVEQhTw51lKENdNrEqT3,22,12,10,0,8,0,5,0,35,5.0,3,0.0,0,10,0,8,12,0,0,5,0,18,17,1
1915,22847,uKSoXEJNhPBaLwogtj5AI2INbh67Hhkx,G8EPVSXsOYB5YQWZGiz1aVq5Pgr2GrQu,7,12,0,0,1,0,3,0,16,2.2857142857142856,2,0.0,2,0,0,1,10,0,0,3,0,3,13,1
1916,22849,Wd5Y51TL4njlLeYHUjz5D9nrsHvDXUZ8,A3fsA9Zfv1X2fVEQhTw51lKENdNrEqT3,83,43,27,174,10,3,22,1,280,40.0,7,0.0,3,27,158,10,40,3,16,22,1,198,82,0
1917,22855,4J9zAQq4ZlZzXgNIT2zhfBx7kGs24C6D,SpATywNh6bZuzm8s1ceuBUnMUAeoAHHw,30,35,18,26,8,21,22,0,130,18.571428571428573,8,0.0,10,18,25,8,25,21,1,22,0,61,69,0
1918,22858,xOeteuxexg2mP8NxgmLBWH8qhXnVfLfh,A3fsA9Zfv1X2fVEQhTw51lKENdNrEqT3,1,0,0,0,0,0,1,0,1,0.14285714285714285,1,0.0,0,0,0,0,0,0,0,1,0,0,1,1
1919,22867,ec87BaRQsrP5IAuQEXYeAFWoVPURyRtj,SpATywNh6bZuzm8s1ceuBUnMUAeoAHHw,30,48,10,28,6,4,14,1,111,15.857142857142858,3,0.0,17,10,25,6,31,4,3,14,1,58,53,0
1920,22882,53VGMeycKD8ekdZB7srikqwK1dcTbnwu,bWdj2GDclj5ofokWjzoa5jAwMkxCykd6,20,41,14,44,13,0,11,0,123,17.571428571428573,6,0.0,19,14,38,13,22,0,6,11,0,84,39,1
1921,22889,VXeEmbu1PPBvvH7wFjnGFaE2yqIFKByx,G8EPVSXsOYB5YQWZGiz1aVq5Pgr2GrQu,23,38,2,0,3,2,14,0,59,8.428571428571429,4,0.0,4,2,0,3,34,2,0,14,0,9,50,1
1922,22891,tnLfm9tutF6YoqDXNIONCmii1aynBy80,SpATywNh6bZuzm8s1ceuBUnMUAeoAHHw,28,70,33,30,7,5,25,0,170,24.285714285714285,8,0.0,7,33,23,7,63,5,7,25,0,70,100,0
1923,22893,fslIhUAreTqu48Va3DJjHuBASqZWV4lb,SpATywNh6bZuzm8s1ceuBUnMUAeoAHHw,9,10,0,3,0,0,2,0,15,2.142857142857143,1,0.0,0,0,3,0,10,0,0,2,0,3,12,0
1924,22896,kwtDMW6kCF4Dj4cVANDmT2RtqpyiMQZT,A3fsA9Zfv1X2fVEQhTw51lKENdNrEqT3,99,170,77,225,42,0,48,0,562,80.28571428571429,12,0.0,3,77,189,42,167,0,36,48,0,311,251,0
1925,22909,za2dBkPPLD9IPRBjooK7GJit2ulI5UgN,SpATywNh6bZuzm8s1ceuBUnMUAeoAHHw,19,19,7,43,1,13,10,1,94,13.428571428571429,4,0.0,9,7,36,1,10,13,7,10,1,53,41,0
1926,22916,dLoTMfurIDgppPqjn68MhR8oLIGjxbCC,A3fsA9Zfv1X2fVEQhTw51lKENdNrEqT3,12,32,16,0,5,0,12,1,66,9.428571428571429,5,0.0,0,16,0,5,32,0,0,12,1,21,45,1
1927,22917,faHDojVqWXLiB8t0I6HX2vfFaDqeEAWd,G8EPVSXsOYB5YQWZGiz1aVq5Pgr2GrQu,26,45,3,64,1,0,4,0,117,16.714285714285715,3,0.0,18,3,46,1,27,0,18,4,0,68,49,1
1928,22923,CbShtPgX8EbSEeSUeGV654dzDIai2s5c,G8EPVSXsOYB5YQWZGiz1aVq5Pgr2GrQu,4,8,0,0,1,0,1,0,10,1.4285714285714286,1,0.0,5,0,0,1,3,0,0,1,0,6,4,1
1929,22930,HrbizO8RcI1YFSo093sl97C3MRm3iZSm,SpATywNh6bZuzm8s1ceuBUnMUAeoAHHw,10,7,1,0,1,3,4,0,16,2.2857142857142856,2,0.0,0,1,0,1,7,3,0,4,0,2,14,1
1930,22939,za2dBkPPLD9IPRBjooK7GJit2ulI5UgN,A3fsA9Zfv1X2fVEQhTw51lKENdNrEqT3,12,8,4,0,3,0,5,0,20,2.857142857142857,2,0.0,0,4,0,3,8,0,0,5,0,7,13,1
1931,22960,G7eyYYWDjRzjfvQepcwnefZtLIHlQINA,SpATywNh6bZuzm8s1ceuBUnMUAeoAHHw,28,45,18,35,5,11,18,1,133,19.0,7,0.0,18,18,31,5,27,11,4,18,1,72,61,1
1932,22962,M6VmJD8JYDR5w6GV5uzAgWpIXM5eanml,G8EPVSXsOYB5YQWZGiz1aVq5Pgr2GrQu,149,279,133,255,61,39,35,1,803,114.71428571428571,8,0.0,85,133,193,61,194,39,62,35,1,472,331,0
1933,22969,dT92IjRcuruPiAlpqVUTtu3wNL9IIegT,A3fsA9Zfv1X2fVEQhTw51lKENdNrEqT3,27,44,17,0,10,0,11,0,82,11.714285714285714,3,0.0,2,17,0,10,42,0,0,11,0,29,53,1
1934,22970,dT92IjRcuruPiAlpqVUTtu3wNL9IIegT,bWdj2GDclj5ofokWjzoa5jAwMkxCykd6,49,90,33,130,17,104,27,1,402,57.42857142857143,8,0.0,8,33,112,17,82,104,18,27,1,170,232,1
1935,22988,mYyzW7j4oHjgvbS0hfWvmpiecRMbZDgq,SpATywNh6bZuzm8s1ceuBUnMUAeoAHHw,15,28,15,27,5,4,9,0,88,12.571428571428571,4,0.0,7,15,21,5,21,4,6,9,0,48,40,1
1936,22993,WaZjCMCq9zHT0tGjpLu6Y2rc6ox0JLNd,A3fsA9Zfv1X2fVEQhTw51lKENdNrEqT3,42,22,15,86,12,0,12,0,147,21.0,2,0.0,3,15,67,12,19,0,19,12,0,97,50,1
1937,22996,W9f8UmYzSEsFhECsZDg6FwyOA22yb0R3,SpATywNh6bZuzm8s1ceuBUnMUAeoAHHw,31,84,32,43,11,264,54,6,494,70.57142857142857,11,0.0,36,32,37,11,48,264,6,54,6,116,378,0
1938,23002,QgNI0yI2W8R4yAAyuaSrYw2RL1D6EBzF,A3fsA9Zfv1X2fVEQhTw51lKENdNrEqT3,5,2,1,0,1,0,2,0,6,0.8571428571428571,1,0.0,0,1,0,1,2,0,0,2,0,2,4,1
1939,23006,UInMBEH8f1h2vxXVslRsWyLOTv8ggYq3,A3fsA9Zfv1X2fVEQhTw51lKENdNrEqT3,81,109,53,172,17,107,37,1,496,70.85714285714286,9,0.0,11,53,137,17,98,107,35,37,1,218,278,1
1940,23014,UInMBEH8f1h2vxXVslRsWyLOTv8ggYq3,bWdj2GDclj5ofokWjzoa5jAwMkxCykd6,29,48,24,134,6,73,24,3,312,44.57142857142857,8,0.0,4,24,127,6,44,73,7,24,3,161,151,0
1941,23049,I2ghGumCKIaVsnJOGZA0xyJzTnEm5KtW,SpATywNh6bZuzm8s1ceuBUnMUAeoAHHw,28,31,18,26,7,27,6,0,115,16.428571428571427,5,0.0,7,18,22,7,24,27,4,6,0,54,61,1
1942,23054,aOK5wIKpKN9ikUy2a1FUGeQDEt1AAFa3,G8EPVSXsOYB5YQWZGiz1aVq5Pgr2GrQu,35,53,36,0,14,11,36,1,151,21.571428571428573,8,0.0,0,36,0,14,53,11,0,36,1,50,101,1
1943,23058,Dp9gZlmwGRMU0Crlqtgk7QHM4JW7fsY6,SpATywNh6bZuzm8s1ceuBUnMUAeoAHHw,22,42,7,28,5,0,10,0,92,13.142857142857142,4,0.0,10,7,22,5,32,0,6,10,0,44,48,0
1944,23061,PzUJiLnP9HZJxQE6JmMTkx1KTzCMtAvI,bWdj2GDclj5ofokWjzoa5jAwMkxCykd6,8,7,4,0,1,0,6,0,18,2.5714285714285716,1,0.0,0,4,0,1,7,0,0,6,0,5,13,1
1945,23063,mekJnkZy13R9odlyEHUcID5pf1ROn3NK,bWdj2GDclj5ofokWjzoa5jAwMkxCykd6,1,0,0,0,0,0,1,0,1,0.14285714285714285,1,0.0,0,0,0,0,0,0,0,1,0,0,1,1
1946,23066,wKKdkZJ3MevUShYy00jn3yNZpY2kcdrV,bWdj2GDclj5ofokWjzoa5jAwMkxCykd6,7,4,2,0,0,1,8,1,16,2.2857142857142856,2,0.0,0,2,0,0,4,1,0,8,1,2,14,1
1947,23068,mekJnkZy13R9odlyEHUcID5pf1ROn3NK,A3fsA9Zfv1X2fVEQhTw51lKENdNrEqT3,2,0,0,0,0,0,2,0,2,0.2857142857142857,1,0.0,0,0,0,0,0,0,0,2,0,0,2,1
1948,23073,gZWf27ETcHz4bBmwZPjiPumw55JZ4IOR,SpATywNh6bZuzm8s1ceuBUnMUAeoAHHw,28,43,0,38,3,67,10,1,162,23.142857142857142,3,0.0,22,0,34,3,21,67,4,10,1,59,103,0
1949,23084,mjoKY29bSBUSIg1iJCO4z3ZZIabGnClW,SpATywNh6bZuzm8s1ceuBUnMUAeoAHHw,28,59,24,39,8,42,22,0,194,27.714285714285715,7,0.0,14,24,30,8,45,42,9,22,0,76,118,0
1950,23091,aOhrgEBrLoAbudoZk6lY36jneHxQbWdO,G8EPVSXsOYB5YQWZGiz1aVq5Pgr2GrQu,36,36,25,38,12,6,28,6,151,21.571428571428573,4,0.0,0,25,31,12,36,6,7,28,6,68,83,0
1951,23118,2wKdgTom3CXBb3VapzvEijoKrYgkRC9s,SpATywNh6bZuzm8s1ceuBUnMUAeoAHHw,26,31,26,8,14,13,18,3,113,16.142857142857142,2,0.0,0,26,8,14,31,13,0,18,3,48,65,0
1952,23130,hGDnsprgLmlBuNCzDAhbMdsa7xgZW8Z4,A3fsA9Zfv1X2fVEQhTw51lKENdNrEqT3,50,16,8,136,2,21,14,0,197,28.142857142857142,2,0.0,2,8,113,2,14,21,23,14,0,125,72,1
1953,23135,Emt7DBFLBFlleaJw0CDWZkbz2fh9bCe8,SpATywNh6bZuzm8s1ceuBUnMUAeoAHHw,15,11,8,0,5,0,6,0,30,4.285714285714286,1,0.0,0,8,0,5,11,0,0,6,0,13,17,1
1954,23137,adDGX99l1n1iBt8AmYVD4kO1enVdrmvn,SpATywNh6bZuzm8s1ceuBUnMUAeoAHHw,20,20,12,24,4,0,5,0,65,9.285714285714286,3,0.0,5,12,24,4,15,0,0,5,0,45,20,1
1955,23140,0Tg2flbTUdD7fODqYIfpiJiK0IDdFiOP,RXDvfPUBYFlVdlueBFbLW0mhhAyGEqpt,66,77,38,76,19,57,15,7,289,41.285714285714285,9,0.0,21,38,75,19,56,57,1,15,7,153,136,0
1956,23145,VO6tFMF3YqIQYaW8tkV9BLtheEJyKKQK,SpATywNh6bZuzm8s1ceuBUnMUAeoAHHw,30,39,20,24,9,1,13,0,106,15.142857142857142,5,0.0,11,20,22,9,28,1,2,13,0,62,44,0
1957,23174,dpHLF21uvMbokNNTJHdbSyHoiwNjC5Qc,RXDvfPUBYFlVdlueBFbLW0mhhAyGEqpt,18,15,11,0,5,8,5,4,48,6.857142857142857,2,0.0,0,11,0,5,15,8,0,5,4,16,32,1
1958,23181,PwNax3W8g4wFzRQCUhWcP9EnmZeticjo,SpATywNh6bZuzm8s1ceuBUnMUAeoAHHw,27,29,14,12,8,1,3,0,67,9.571428571428571,4,0.0,12,14,12,8,17,1,0,3,0,46,21,1
1959,23182,CBLeEN4LtKF8I3pqDKXGm8PyJoErUnYX,A3fsA9Zfv1X2fVEQhTw51lKENdNrEqT3,10,9,1,0,1,1,3,0,15,2.142857142857143,1,0.0,0,1,0,1,9,1,0,3,0,2,13,1
1960,23186,jOKGDo32k5y1tQ1HBtDhmlq3GlvnMuW4,A3fsA9Zfv1X2fVEQhTw51lKENdNrEqT3,30,53,41,0,30,2,34,0,160,22.857142857142858,5,0.0,1,41,0,30,52,2,0,34,0,72,88,1
1961,23188,HycevJIm7cBjf1oJ5QCBMMXEBTG8jyRF,RXDvfPUBYFlVdlueBFbLW0mhhAyGEqpt,72,129,78,108,16,74,69,2,476,68.0,10,0.0,27,78,101,16,102,74,7,69,2,222,254,0
1962,23189,ClKPcHfoSfkiUFto4BTBZmMJfgBwADCv,bWdj2GDclj5ofokWjzoa5jAwMkxCykd6,4,2,1,0,1,0,1,0,5,0.7142857142857143,1,0.0,0,1,0,1,2,0,0,1,0,2,3,1
1963,23203,YBZJfjYuKfwb2VLWbDlKIMN1YSYXBGau,A3fsA9Zfv1X2fVEQhTw51lKENdNrEqT3,14,18,12,0,4,6,7,0,47,6.714285714285714,4,0.0,0,12,0,4,18,6,0,7,0,16,31,1
1964,23216,BdGjvuZcr0pZwpTvi8kd6szBp0GhSFRx,bWdj2GDclj5ofokWjzoa5jAwMkxCykd6,10,10,6,0,5,0,5,0,26,3.7142857142857144,1,0.0,2,6,0,5,8,0,0,5,0,13,13,1
1965,23229,AjE14bAFpRvd1b44PmMUpBPn2loehR8N,SpATywNh6bZuzm8s1ceuBUnMUAeoAHHw,19,31,7,15,7,9,18,0,87,12.428571428571429,3,0.0,5,7,14,7,26,9,1,18,0,33,54,1
1966,23230,qJSVGIIBKQpzllCeTCwG3pgdEZIo3QRz,A3fsA9Zfv1X2fVEQhTw51lKENdNrEqT3,12,9,2,4,1,0,16,0,32,4.571428571428571,3,0.0,0,2,3,1,9,0,1,16,0,6,26,1
1967,23241,wmmgynPgGzw7ypLLU9vcdxog9SI7Juul,RXDvfPUBYFlVdlueBFbLW0mhhAyGEqpt,19,13,8,20,3,0,3,0,47,6.714285714285714,2,0.0,2,8,17,3,11,0,3,3,0,30,17,1
1968,23254,3rBX9dOAFMfNlnyfBe9F26nbNxp33Uvk,G8EPVSXsOYB5YQWZGiz1aVq5Pgr2GrQu,20,21,7,0,6,1,13,1,49,7.0,3,0.0,0,7,0,6,21,1,0,13,1,13,36,1
1969,23255,FfhVetKUzu5KpGrHLPHaynXPJghmm3It,SpATywNh6bZuzm8s1ceuBUnMUAeoAHHw,20,21,1,17,2,0,3,0,44,6.285714285714286,2,0.0,6,1,16,2,15,0,1,3,0,25,19,0
1970,23259,xqwUV9iQK4erbWJ9fEZ3Fau5k4aAZ9DO,SpATywNh6bZuzm8s1ceuBUnMUAeoAHHw,22,59,27,46,7,16,18,2,175,25.0,6,0.0,22,27,36,7,37,16,10,18,2,92,83,0
1971,23263,tnLfm9tutF6YoqDXNIONCmii1aynBy80,A3fsA9Zfv1X2fVEQhTw51lKENdNrEqT3,9,8,4,0,0,3,12,1,28,4.0,3,0.0,0,4,0,0,8,3,0,12,1,4,24,1
1972,23264,XTgYONXtkRAl3sCFaGFF8e1mU9AMcEwg,SpATywNh6bZuzm8s1ceuBUnMUAeoAHHw,20,18,13,0,9,0,7,0,47,6.714285714285714,4,0.0,0,13,0,9,18,0,0,7,0,22,25,1
1973,23265,knRZtWEcWI5MFAs7PYIJdk2jdyAY8A24,SpATywNh6bZuzm8s1ceuBUnMUAeoAHHw,30,36,16,16,7,2,15,1,93,13.285714285714286,3,0.0,13,16,16,7,23,2,0,15,1,52,41,0
1974,23268,XJpmNtat26NZxNAZqQE63m1qpYdHanqw,RXDvfPUBYFlVdlueBFbLW0mhhAyGEqpt,67,94,59,96,28,7,3,0,287,41.0,3,0.0,16,59,89,28,78,7,7,3,0,192,95,0
1975,23281,peL7W7HsPQXwJW8IfNPUpznrjT13FLeH,SpATywNh6bZuzm8s1ceuBUnMUAeoAHHw,12,25,0,13,0,0,12,0,50,7.142857142857143,2,0.0,8,0,12,0,17,0,1,12,0,20,30,1
1976,23288,pLQfsJL46iqa9L7UfI8ODNozilMqoPl0,A3fsA9Zfv1X2fVEQhTw51lKENdNrEqT3,7,4,3,0,2,0,2,0,11,1.5714285714285714,1,0.0,0,3,0,2,4,0,0,2,0,5,6,1
1977,23297,3cB0rEpxJxC0jjqfQ9EPT6ntxFajOXrx,A3fsA9Zfv1X2fVEQhTw51lKENdNrEqT3,81,83,56,226,21,35,15,1,437,62.42857142857143,6,0.0,7,56,195,21,76,35,31,15,1,279,158,0
1978,23304,WEwbMamm1WQzZcIYKs7fv3KkFwrZAu4n,SpATywNh6bZuzm8s1ceuBUnMUAeoAHHw,28,43,19,27,9,6,10,0,114,16.285714285714285,6,0.0,18,19,27,9,25,6,0,10,0,73,41,0
1979,23307,S1PbXrIuvwc8AvxDGKhjkWzwRdM8cFN0,SpATywNh6bZuzm8s1ceuBUnMUAeoAHHw,21,33,18,12,0,0,9,0,72,10.285714285714286,7,0.0,5,18,12,0,28,0,0,9,0,35,37,0
1980,23308,P0KoQHPz5chEfkMzzCMKKbnUkwSC15gh,G8EPVSXsOYB5YQWZGiz1aVq5Pgr2GrQu,1,0,0,0,0,0,1,0,1,0.14285714285714285,1,0.0,0,0,0,0,0,0,0,1,0,0,1,1
1981,23311,fE7crtUj4hDSQo6ITE7OJYFi4AN2F95M,A3fsA9Zfv1X2fVEQhTw51lKENdNrEqT3,43,32,16,92,10,2,9,0,161,23.0,2,0.0,1,16,75,10,31,2,17,9,0,102,59,1
1982,23313,TXBaUi0GpvXZWCDXsKlkFWTtfaT87UMz,bWdj2GDclj5ofokWjzoa5jAwMkxCykd6,11,33,5,32,1,1,9,2,83,11.857142857142858,5,0.0,3,5,30,1,30,1,2,9,2,39,44,1
1983,23341,1cMpA6zMPA0affI3yASPkTig9lUEcx1e,G8EPVSXsOYB5YQWZGiz1aVq5Pgr2GrQu,9,14,7,0,1,63,11,0,96,13.714285714285714,4,0.0,0,7,0,1,14,63,0,11,0,8,88,1
1984,23358,dob27oJoC3Vd5K1oOuihpbNGBh5pIGaM,SpATywNh6bZuzm8s1ceuBUnMUAeoAHHw,14,30,16,1,7,1,6,0,61,8.714285714285714,3,0.0,6,16,1,7,24,1,0,6,0,30,31,1
1985,23388,HZWZtPkCTeK90eQ90MHe5cWcAqiVgkGk,bWdj2GDclj5ofokWjzoa5jAwMkxCykd6,39,112,62,182,31,45,38,1,471,67.28571428571429,7,0.0,26,62,162,31,86,45,20,38,1,281,190,0
1986,23390,lfrqXPATBesMooHpdCa9ZnxlXhb59rmp,SpATywNh6bZuzm8s1ceuBUnMUAeoAHHw,30,153,93,37,29,13,39,0,364,52.0,8,0.0,17,93,34,29,136,13,3,39,0,173,191,1
1987,23399,QUw5YB8tw6ArwfIF1vjOH2aXsMxDBB6n,SpATywNh6bZuzm8s1ceuBUnMUAeoAHHw,31,30,18,22,9,20,16,2,117,16.714285714285715,6,0.0,5,18,18,9,25,20,4,16,2,50,67,0
1988,23405,3AFvyqpOB7zyiycGY1NpbFOUZUj9K9Bb,SpATywNh6bZuzm8s1ceuBUnMUAeoAHHw,25,26,16,12,7,1,10,0,72,10.285714285714286,5,0.0,4,16,12,7,22,1,0,10,0,39,33,1
1989,23416,1ulA4jhwI0WhLE9MVLjWBxEEeOzdq7WL,SpATywNh6bZuzm8s1ceuBUnMUAeoAHHw,31,67,37,34,13,34,23,3,211,30.142857142857142,7,0.0,16,37,29,13,51,34,5,23,3,95,116,0
1990,23440,lHNqd6KTSO9CrJzRDAqosVITLVN3mMHR,bWdj2GDclj5ofokWjzoa5jAwMkxCykd6,43,61,35,208,12,0,22,0,338,48.285714285714285,6,0.0,12,35,194,12,49,0,14,22,0,253,85,1
1991,23450,RKjVof9Yhxeyyya4gtkZu1fqgIbPHIOB,A3fsA9Zfv1X2fVEQhTw51lKENdNrEqT3,17,16,10,0,5,14,20,5,70,10.0,5,0.0,1,10,0,5,15,14,0,20,5,16,54,0
1992,23452,iEsDxJ2LNGTFl1t0aAKhf24FeoeDy4PX,G8EPVSXsOYB5YQWZGiz1aVq5Pgr2GrQu,5,4,0,0,1,0,1,0,6,0.8571428571428571,1,0.0,0,0,0,1,4,0,0,1,0,1,5,1
1993,23457,wLAgbiz3XWV6Nef8pQe1TlLxUN8CIoJ8,G8EPVSXsOYB5YQWZGiz1aVq5Pgr2GrQu,1,0,0,0,0,0,1,0,1,0.14285714285714285,1,0.0,0,0,0,0,0,0,0,1,0,0,1,1
1994,23477,wctOEAfOfHjaIn2ukTVBg3NDDfP2Pt1c,SpATywNh6bZuzm8s1ceuBUnMUAeoAHHw,28,87,52,28,13,18,35,5,238,34.0,9,0.0,10,52,24,13,77,18,4,35,5,99,139,0
1995,23490,Id4UmIRRQiLXHoJYSjh5OCO1CRaFgQ2K,SpATywNh6bZuzm8s1ceuBUnMUAeoAHHw,31,55,22,26,10,8,15,1,137,19.571428571428573,5,0.0,16,22,21,10,39,8,5,15,1,69,68,1
1996,23510,GIb3glgYrsEfHWtEWPWpwONqwE7RMf6f,A3fsA9Zfv1X2fVEQhTw51lKENdNrEqT3,90,158,89,148,43,7,54,1,500,71.42857142857143,15,0.0,7,89,135,43,151,7,13,54,1,274,226,0
1997,23515,Oqfkhjg6t51PZcyyCwvjWtQ6bDHYceB1,SpATywNh6bZuzm8s1ceuBUnMUAeoAHHw,29,74,42,24,13,25,16,0,194,27.714285714285715,10,0.0,16,42,19,13,58,25,5,16,0,90,104,0
1998,23516,PzbAAQBdNIO5q0hDkxJETX7v12Y9h0xH,SpATywNh6bZuzm8s1ceuBUnMUAeoAHHw,7,6,1,0,1,0,3,0,11,1.5714285714285714,1,0.0,0,1,0,1,6,0,0,3,0,2,9,0
1999,23519,DsdEYwXt7PO92K8VROCVVtUqrprzaIo4,A3fsA9Zfv1X2fVEQhTw51lKENdNrEqT3,46,26,17,88,10,1,24,1,167,23.857142857142858,2,0.0,2,17,71,10,24,1,17,24,1,100,67,1
2000,23542,d4mvkfcwFcYKWYB1PuCW432MT8LvqlFh,SpATywNh6bZuzm8s1ceuBUnMUAeoAHHw,29,65,33,38,13,0,17,0,166,23.714285714285715,6,0.0,25,33,36,13,40,0,2,17,0,107,59,1
2001,23552,H0WeKsbXeLHWXz7EV7ygxgCQNCt5DOUD,SpATywNh6bZuzm8s1ceuBUnMUAeoAHHw,27,62,23,47,6,7,18,1,164,23.428571428571427,12,0.0,6,23,39,6,56,7,8,18,1,74,90,0
2002,23554,bVCYDQX7pJxff6OyJX4M9s17AtFlpk5i,SpATywNh6bZuzm8s1ceuBUnMUAeoAHHw,10,18,12,0,7,0,6,0,43,6.142857142857143,2,0.0,0,12,0,7,18,0,0,6,0,19,24,1
2003,23573,MwhE2MowwPvamSVFrLUWaatDsrzcIgQY,SpATywNh6bZuzm8s1ceuBUnMUAeoAHHw,21,23,14,6,6,5,11,1,66,9.428571428571429,3,0.0,2,14,6,6,21,5,0,11,1,28,38,0
2004,23585,NRdQjU0MJFdxtbDqiTrBcJcd064egve1,SpATywNh6bZuzm8s1ceuBUnMUAeoAHHw,17,45,28,15,0,11,24,1,124,17.714285714285715,3,0.0,8,28,13,0,37,11,2,24,1,49,75,1
2005,23588,DHUv7XpIZcPp2QYGNmTXjhgg7Zq4BpJ7,RXDvfPUBYFlVdlueBFbLW0mhhAyGEqpt,1,0,0,0,0,0,1,0,1,0.14285714285714285,1,0.0,0,0,0,0,0,0,0,1,0,0,1,1
2006,23595,0EotlIgKGd3opCDMhDC2aBqeeKmFST46,A3fsA9Zfv1X2fVEQhTw51lKENdNrEqT3,2,0,0,0,0,0,4,0,4,0.5714285714285714,1,0.0,0,0,0,0,0,0,0,4,0,0,4,1
2007,23596,DdGVDKNQwSkPIQKeE1XouOkZR5kVZ7SK,SpATywNh6bZuzm8s1ceuBUnMUAeoAHHw,23,42,8,34,3,0,8,0,95,13.571428571428571,3,0.0,15,8,28,3,27,0,6,8,0,54,41,1
2008,23597,lLz9WbehghUNLRABDjzrIp7BjBkWjoW9,SpATywNh6bZuzm8s1ceuBUnMUAeoAHHw,6,5,2,0,1,0,2,0,10,1.4285714285714286,1,0.0,0,2,0,1,5,0,0,2,0,3,7,1
2009,23603,0wJhtCWK60WPCeRF62m8T80DtNpWhRrg,SpATywNh6bZuzm8s1ceuBUnMUAeoAHHw,26,36,17,32,5,0,10,1,101,14.428571428571429,3,0.0,14,17,28,5,22,0,4,10,1,64,37,0
2010,23633,o6ILANWxUGmdLZhlBol9mZCEolnG5bhy,SpATywNh6bZuzm8s1ceuBUnMUAeoAHHw,28,36,21,3,8,34,19,1,122,17.428571428571427,9,0.0,2,21,3,8,34,34,0,19,1,34,88,1
2011,23639,tMPZYG0DCvDSDEuO4KsQAdk0iwwmXKYt,A3fsA9Zfv1X2fVEQhTw51lKENdNrEqT3,32,78,42,28,23,2,22,0,195,27.857142857142858,6,0.0,2,42,23,23,76,2,5,22,0,90,105,0
2012,23640,9uqkwYb5ddQJIw4su6OaF1hwvWEdLp1S,A3fsA9Zfv1X2fVEQhTw51lKENdNrEqT3,29,31,20,0,13,0,7,0,71,10.142857142857142,5,0.0,0,20,0,13,31,0,0,7,0,33,38,0
2013,23647,3rCZba8eKP7jaFsDjNb32WoGn9BjnrjN,bWdj2GDclj5ofokWjzoa5jAwMkxCykd6,1,0,0,0,0,0,1,0,1,0.14285714285714285,1,0.0,0,0,0,0,0,0,0,1,0,0,1,1
2014,23671,9sTtmQQAXG5XvwtZJPuuRKLnfgaYWfWO,SpATywNh6bZuzm8s1ceuBUnMUAeoAHHw,26,26,11,26,6,0,5,0,74,10.571428571428571,3,0.0,13,11,24,6,13,0,2,5,0,54,20,1
2015,23674,l9KseRU4xYtwOzoILYmGcicF0iiXQqxl,SpATywNh6bZuzm8s1ceuBUnMUAeoAHHw,31,53,20,33,7,25,17,1,156,22.285714285714285,8,0.0,14,20,27,7,39,25,6,17,1,68,88,0
2016,23675,pJj2PU7RZQK2Nwrb96O5DurQcsPoqkDx,bWdj2GDclj5ofokWjzoa5jAwMkxCykd6,1,0,0,0,0,0,3,0,3,0.42857142857142855,2,0.0,0,0,0,0,0,0,0,3,0,0,3,1
2017,23692,zJ99WhK6aN6yEmbpXd5cJuqKo0p9kPsD,RXDvfPUBYFlVdlueBFbLW0mhhAyGEqpt,59,41,22,78,16,2,14,1,174,24.857142857142858,3,0.0,16,22,74,16,25,2,4,14,1,128,46,1
2018,23710,3iJrlZJEv2h7DgWBpz6wZtSXPXEy6IAY,A3fsA9Zfv1X2fVEQhTw51lKENdNrEqT3,14,19,9,0,6,0,10,0,44,6.285714285714286,8,0.0,0,9,0,6,19,0,0,10,0,15,29,0
2019,23711,POOwrt9teJiwgIKzPgqwiwhGp5kUKv01,SpATywNh6bZuzm8s1ceuBUnMUAeoAHHw,29,37,22,27,10,8,12,1,117,16.714285714285715,2,0.0,9,22,23,10,28,8,4,12,1,64,53,0
2020,23716,epEhe5zjAdMHelSWe8cywAVR1iLucvwI,SpATywNh6bZuzm8s1ceuBUnMUAeoAHHw,4,2,0,0,0,0,2,0,4,0.5714285714285714,1,0.0,0,0,0,0,2,0,0,2,0,0,4,1
2021,23723,aX5o3K4conQ4SoTRN7MBCmGaArjn5YFA,SpATywNh6bZuzm8s1ceuBUnMUAeoAHHw,5,2,1,0,1,0,3,0,7,1.0,1,0.0,0,1,0,1,2,0,0,3,0,2,5,1
2022,23725,wNbKFPX6oYsfVEr8buyWthBblPuPZGxv,SpATywNh6bZuzm8s1ceuBUnMUAeoAHHw,1,0,0,0,0,0,1,0,1,0.14285714285714285,1,0.0,0,0,0,0,0,0,0,1,0,0,1,1
2023,23740,oJ9j9ejTgKixczg3tSE8Sg8DPI7YQpJq,SpATywNh6bZuzm8s1ceuBUnMUAeoAHHw,29,47,25,18,6,14,13,0,123,17.571428571428573,7,0.0,14,25,15,6,33,14,3,13,0,60,63,0
2024,23745,Ot8esbQhlnTNYRjqPJ5gBbiW6Aw8bpdE,G8EPVSXsOYB5YQWZGiz1aVq5Pgr2GrQu,1,0,0,0,0,0,1,0,1,0.14285714285714285,1,0.0,0,0,0,0,0,0,0,1,0,0,1,1
2025,23752,oW1SPRE23Cu85GeGZYRmhPcFuXq6dZoG,SpATywNh6bZuzm8s1ceuBUnMUAeoAHHw,27,46,23,15,10,3,13,0,110,15.714285714285714,3,0.0,16,23,14,10,30,3,1,13,0,63,47,0
2026,23754,atxTINx1wNa0Kz1uw7bW34Z47POxkGeq,SpATywNh6bZuzm8s1ceuBUnMUAeoAHHw,29,83,14,34,11,4,61,1,208,29.714285714285715,10,0.0,9,14,29,11,74,4,5,61,1,63,145,0
2027,23760,6uy0rYsVs6ntSHgwhJ1mwDkW5uKAQxi4,SpATywNh6bZuzm8s1ceuBUnMUAeoAHHw,22,68,39,16,18,10,9,0,160,22.857142857142858,8,0.0,12,39,14,18,56,10,2,9,0,83,77,1
2028,23771,zG5wQdjarSEp1xTKP5FU2TvutBYexg1v,bWdj2GDclj5ofokWjzoa5jAwMkxCykd6,6,12,0,0,0,0,4,0,16,2.2857142857142856,1,0.0,1,0,0,0,11,0,0,4,0,1,15,1
2029,23773,35E85h2ExBPeTd1VmxNX0GKo8krIMsCP,SpATywNh6bZuzm8s1ceuBUnMUAeoAHHw,30,64,24,32,13,1,12,0,146,20.857142857142858,4,0.0,32,24,28,13,32,1,4,12,0,97,49,1
2030,23789,i1f7BljhTNgVMfGOHZ66OYaR3kNetCAs,SpATywNh6bZuzm8s1ceuBUnMUAeoAHHw,13,23,0,34,0,19,7,0,83,11.857142857142858,5,0.0,12,0,31,0,11,19,3,7,0,43,40,0
2031,23795,bHKiB8yjzvUwkeHE5fxnHNywx47ldJ6B,SpATywNh6bZuzm8s1ceuBUnMUAeoAHHw,24,51,4,31,2,2,13,0,103,14.714285714285714,7,0.0,15,4,27,2,36,2,4,13,0,48,55,1
2032,23798,GOPMGFz5xoFESgugOmv6JtNIOPfS0GCX,SpATywNh6bZuzm8s1ceuBUnMUAeoAHHw,18,43,1,17,1,13,14,1,90,12.857142857142858,6,0.0,10,1,16,1,33,13,1,14,1,28,62,0
2033,23806,uxWndEUVVRQyohhChNH7OrcMXH2VCOhT,SpATywNh6bZuzm8s1ceuBUnMUAeoAHHw,10,11,2,0,1,0,2,0,16,2.2857142857142856,2,0.0,0,2,0,1,11,0,0,2,0,3,13,1
2034,23812,6GriNnzq8xnsLEV5ztRmUAFnPPewwL0q,A3fsA9Zfv1X2fVEQhTw51lKENdNrEqT3,29,16,8,64,0,0,6,0,94,13.428571428571429,3,0.0,3,8,56,0,13,0,8,6,0,67,27,1
2035,23836,83Gotur1nDdhzZnnscpduWQ3wLNBDtA6,SpATywNh6bZuzm8s1ceuBUnMUAeoAHHw,12,15,1,22,0,0,3,0,41,5.857142857142857,1,0.0,8,1,18,0,7,0,4,3,0,27,14,1
2036,23840,FBu5R2eGEtl9EDw0VwXtH1t5i2ELpdqI,SpATywNh6bZuzm8s1ceuBUnMUAeoAHHw,9,18,7,0,3,0,7,0,35,5.0,3,0.0,0,7,0,3,18,0,0,7,0,10,25,1
2037,23841,7Vj4ziukCVrVZvt93RQ91d2zl9J3pERE,SpATywNh6bZuzm8s1ceuBUnMUAeoAHHw,17,22,13,6,5,0,6,0,52,7.428571428571429,2,0.0,5,13,5,5,17,0,1,6,0,28,24,1
2038,23852,dFrBZuKOTxv7Ek84BAuACScgZVHLiPRz,SpATywNh6bZuzm8s1ceuBUnMUAeoAHHw,5,5,0,0,0,0,3,0,8,1.1428571428571428,2,0.0,0,0,0,0,5,0,0,3,0,0,8,1
2039,23855,4okppsrdnKYxqs2gLNMiS6gb60QmM8WN,RXDvfPUBYFlVdlueBFbLW0mhhAyGEqpt,63,92,69,168,14,9,17,17,386,55.142857142857146,4,0.0,13,69,155,14,79,9,13,17,17,251,135,1
2040,23857,840TvauCMn8hUpsV90vm3IXVVzLXLwLs,A3fsA9Zfv1X2fVEQhTw51lKENdNrEqT3,35,43,1,80,0,0,3,0,127,18.142857142857142,2,0.0,6,1,70,0,37,0,10,3,0,77,50,1
2041,23862,YxEAEqB4R6GTRBWDvga1GWE0URAxGc6U,A3fsA9Zfv1X2fVEQhTw51lKENdNrEqT3,9,16,11,0,0,0,4,0,31,4.428571428571429,4,0.0,0,11,0,0,16,0,0,4,0,11,20,1
2042,23863,3Ta0rfBtrbiqFMIpcV3b3USyW2ELEZd2,bWdj2GDclj5ofokWjzoa5jAwMkxCykd6,14,24,3,6,6,9,16,2,66,9.428571428571429,3,0.0,5,3,5,6,19,9,1,16,2,19,47,1
2043,23872,7iw4UiR57uyLjfIdpxq0wONlaNvYfNiV,SpATywNh6bZuzm8s1ceuBUnMUAeoAHHw,1,0,0,0,0,0,1,0,1,0.14285714285714285,1,0.0,0,0,0,0,0,0,0,1,0,0,1,1
2044,23874,986WgoFI0AZSDPIvWwBI8MUZveW4E4Xu,RXDvfPUBYFlVdlueBFbLW0mhhAyGEqpt,23,63,32,0,15,0,9,0,119,17.0,5,0.0,0,32,0,15,63,0,0,9,0,47,72,0
2045,23891,FBu5R2eGEtl9EDw0VwXtH1t5i2ELpdqI,A3fsA9Zfv1X2fVEQhTw51lKENdNrEqT3,68,73,32,202,14,1,15,0,337,48.142857142857146,7,0.0,5,32,168,14,68,1,34,15,0,219,118,1
2046,23893,dkQw8oK3XR4qlNNv9mJoCG5KMSpfLA0u,SpATywNh6bZuzm8s1ceuBUnMUAeoAHHw,29,20,12,31,7,9,8,1,88,12.571428571428571,3,0.0,6,12,28,7,14,9,3,8,1,53,35,1
2047,23895,g7nx8KecXhqsIkJIviLtJahoCAcu06DW,SpATywNh6bZuzm8s1ceuBUnMUAeoAHHw,2,0,0,0,0,0,2,0,2,0.2857142857142857,1,0.0,0,0,0,0,0,0,0,2,0,0,2,1
2048,23901,4dLqJDBbl4XgAFoagStv97aI3aHRciy5,SpATywNh6bZuzm8s1ceuBUnMUAeoAHHw,13,19,12,0,7,3,10,1,52,7.428571428571429,3,0.0,0,12,0,7,19,3,0,10,1,19,33,1
2049,23909,B7s9DHPpvHggi4c4m5C7RuYNMMAUXQfR,SpATywNh6bZuzm8s1ceuBUnMUAeoAHHw,8,10,6,0,5,0,4,0,25,3.5714285714285716,1,0.0,0,6,0,5,10,0,0,4,0,11,14,1
2050,23920,v5teTtQ61doFtyEryEU1FEZNTQeJUrxX,SpATywNh6bZuzm8s1ceuBUnMUAeoAHHw,25,74,6,26,0,13,41,2,162,23.142857142857142,9,0.0,30,6,25,0,44,13,1,41,2,61,101,0
2051,23926,haBS6HInfRwWNu7SJCbVrmAnlh8blC7U,SpATywNh6bZuzm8s1ceuBUnMUAeoAHHw,1,0,0,0,0,0,1,0,1,0.14285714285714285,1,0.0,0,0,0,0,0,0,0,1,0,0,1,1
2052,23942,yk8HuNxXIum8r8XDIOHqnAVeWfg9tYo1,A3fsA9Zfv1X2fVEQhTw51lKENdNrEqT3,14,16,12,0,6,2,20,2,58,8.285714285714286,4,0.0,0,12,0,6,16,2,0,20,2,18,40,1
2053,23944,ZKAk08L8Iriz8Uv5UOeqSbrNnzg1rlMz,RXDvfPUBYFlVdlueBFbLW0mhhAyGEqpt,39,37,25,27,15,17,15,1,137,19.571428571428573,5,0.0,5,25,27,15,32,17,0,15,1,72,65,0
2054,23955,5mJ1itg2cQYRNscuJuLNd4sNUrdim8JB,bWdj2GDclj5ofokWjzoa5jAwMkxCykd6,51,159,67,102,10,50,53,7,448,64.0,8,0.0,15,67,99,10,144,50,3,53,7,191,257,0
2055,23975,xCPsccPRbQTL93kwam6OPz5i1lU77hqE,SpATywNh6bZuzm8s1ceuBUnMUAeoAHHw,19,29,2,6,0,3,15,0,55,7.857142857142857,4,0.0,4,2,6,0,25,3,0,15,0,12,43,0
2056,23976,PSJftXZeDfoFySmsRqkLgFson1mEyJqX,SpATywNh6bZuzm8s1ceuBUnMUAeoAHHw,31,94,38,42,12,81,62,4,333,47.57142857142857,10,0.0,42,38,35,12,52,81,7,62,4,127,206,0
2057,23982,3W09pasLSoDWuQqGyvECJ7WiykG165j2,RXDvfPUBYFlVdlueBFbLW0mhhAyGEqpt,13,14,9,0,3,7,6,0,39,5.571428571428571,5,0.0,1,9,0,3,13,7,0,6,0,13,26,1
2058,23985,T23nrSnpQ3vWpr6CtL4ZskVcSM0KOOu0,A3fsA9Zfv1X2fVEQhTw51lKENdNrEqT3,46,20,16,40,14,0,5,0,95,13.571428571428571,2,0.0,2,16,39,14,18,0,1,5,0,71,24,1
2059,24006,FrLEzodgON5rcdCDFBdqJa5CoY6xgWo9,G8EPVSXsOYB5YQWZGiz1aVq5Pgr2GrQu,2,0,0,0,0,1,1,0,2,0.2857142857142857,1,0.0,0,0,0,0,0,1,0,1,0,0,2,1
2060,24015,op8q14GHWgkmIf6XOfnEOFm5IfQDADrc,SpATywNh6bZuzm8s1ceuBUnMUAeoAHHw,4,2,1,0,1,0,1,0,5,0.7142857142857143,1,0.0,0,1,0,1,2,0,0,1,0,2,3,1
2061,24019,tML4IQ8jFiP4YuH9NbvzKQFqAdof0qcO,G8EPVSXsOYB5YQWZGiz1aVq5Pgr2GrQu,76,103,2,194,1,38,31,2,371,53.0,9,0.0,12,2,159,1,91,38,35,31,2,174,197,0
2062,24035,j5UlwBty5MOwHf8rgRJk1hdlEvwivM1k,SpATywNh6bZuzm8s1ceuBUnMUAeoAHHw,27,85,38,29,9,38,59,1,259,37.0,11,0.0,17,38,29,9,68,38,0,59,1,93,166,0
2063,24036,tx5OjuBvtxXu3JLfhVRvs5pDkriVKuCZ,SpATywNh6bZuzm8s1ceuBUnMUAeoAHHw,2,0,0,0,0,0,2,0,2,0.2857142857142857,1,0.0,0,0,0,0,0,0,0,2,0,0,2,1
2064,24046,5C3sCk6rXQc2OvYtSBZh5PoYxtIPWyJ2,SpATywNh6bZuzm8s1ceuBUnMUAeoAHHw,13,18,13,0,5,2,7,0,45,6.428571428571429,3,0.0,5,13,0,5,13,2,0,7,0,23,22,1
2065,24050,vJOEMmX7SHj3LcECHogPAykr3CpSjcOR,SpATywNh6bZuzm8s1ceuBUnMUAeoAHHw,9,7,5,0,4,0,2,0,18,2.5714285714285716,1,0.0,0,5,0,4,7,0,0,2,0,9,9,0
2066,24053,eosk3dY7502Pbg6Dsnx0qWKWUpRTliXK,A3fsA9Zfv1X2fVEQhTw51lKENdNrEqT3,54,42,5,140,0,0,20,0,207,29.571428571428573,9,0.0,4,5,130,0,38,0,10,20,0,139,68,1
2067,24065,DTTxrR88jPl5bCCaxQVsf8wzpnk1CzMM,bWdj2GDclj5ofokWjzoa5jAwMkxCykd6,3,0,0,0,0,0,3,0,3,0.42857142857142855,1,0.0,0,0,0,0,0,0,0,3,0,0,3,1
2068,24066,kXKIMNlMdItv4EM1IWayIAvXYTB44MoC,RXDvfPUBYFlVdlueBFbLW0mhhAyGEqpt,15,43,16,0,7,0,10,0,76,10.857142857142858,2,0.0,0,16,0,7,43,0,0,10,0,23,53,1
2069,24068,lUdpqcwQn1Cq8H3mwfWcSvZsVHMY64gd,SpATywNh6bZuzm8s1ceuBUnMUAeoAHHw,24,49,4,32,2,0,23,6,116,16.571428571428573,3,0.0,18,4,27,2,31,0,5,23,6,51,65,1
2070,24070,DTTxrR88jPl5bCCaxQVsf8wzpnk1CzMM,A3fsA9Zfv1X2fVEQhTw51lKENdNrEqT3,7,2,0,0,0,0,7,0,9,1.2857142857142858,1,0.0,0,0,0,0,2,0,0,7,0,0,9,1
2071,24077,1xg9Qkt1ODqUyNotraxCzvVYE0R3XRTq,SpATywNh6bZuzm8s1ceuBUnMUAeoAHHw,17,79,46,2,0,4,33,1,165,23.571428571428573,7,0.0,11,46,2,0,68,4,0,33,1,59,106,0
2072,24088,M8ZBCZwMuabH0ACZboTe8kVgLwQBa43E,SpATywNh6bZuzm8s1ceuBUnMUAeoAHHw,7,9,2,0,2,0,2,0,15,2.142857142857143,1,0.0,0,2,0,2,9,0,0,2,0,4,11,1
2073,24095,gIOMjsdC7cxqbaSIU1FRFPikduEMi8Cf,A3fsA9Zfv1X2fVEQhTw51lKENdNrEqT3,1,0,0,0,0,0,1,0,1,0.14285714285714285,1,0.0,0,0,0,0,0,0,0,1,0,0,1,1
2074,24097,quAtav6r2isPETtEaXY0Zey5BbVDiT8E,bWdj2GDclj5ofokWjzoa5jAwMkxCykd6,12,12,4,160,4,1,8,3,192,27.428571428571427,2,0.0,6,4,149,4,6,1,11,8,3,163,29,1
2075,24104,vhdI0CMIgkIrtFphutHmT5NtC4th9ah8,G8EPVSXsOYB5YQWZGiz1aVq5Pgr2GrQu,19,29,15,20,6,8,9,2,89,12.714285714285714,1,0.0,11,15,13,6,18,8,7,9,2,45,44,1
2076,24105,CARvKOUSVZPjSOb5Yfv5PAWmTBO0zJGw,SpATywNh6bZuzm8s1ceuBUnMUAeoAHHw,11,10,5,0,2,0,25,2,44,6.285714285714286,1,0.0,0,5,0,2,10,0,0,25,2,7,37,1
2077,24107,GCaUOiguxLs9b5sngb0RwjOWSkIZZOW6,RXDvfPUBYFlVdlueBFbLW0mhhAyGEqpt,1,0,0,0,0,0,2,0,2,0.2857142857142857,1,0.0,0,0,0,0,0,0,0,2,0,0,2,1
2078,24113,dMrgH440WCDAs3UnYGenYjtBiGOLNMI7,G8EPVSXsOYB5YQWZGiz1aVq5Pgr2GrQu,10,10,1,14,0,0,5,1,31,4.428571428571429,1,0.0,0,1,12,0,10,0,2,5,1,13,18,1
2079,24117,qQwIO2VZC7PFj9cTI7x2EoRtRcwJFk5y,A3fsA9Zfv1X2fVEQhTw51lKENdNrEqT3,17,11,2,24,1,5,7,0,50,7.142857142857143,2,0.0,0,2,19,1,11,5,5,7,0,22,28,1
2080,24130,PweHbRIHs8SwjKQfEtpqIQuZBXBDcuDm,SpATywNh6bZuzm8s1ceuBUnMUAeoAHHw,31,43,22,34,10,0,11,2,122,17.428571428571427,4,0.0,15,22,31,10,28,0,3,11,2,78,44,1
2081,24139,oz1karFupMeBQM5wp1X9Aheb4RKufic7,SpATywNh6bZuzm8s1ceuBUnMUAeoAHHw,28,37,23,39,9,16,11,0,135,19.285714285714285,8,0.0,4,23,34,9,33,16,5,11,0,70,65,0
2082,24140,68BjCXfBFqeZ01fFx1csrFmvef5xs0w2,SpATywNh6bZuzm8s1ceuBUnMUAeoAHHw,15,30,20,0,10,12,8,0,80,11.428571428571429,6,0.0,3,20,0,10,27,12,0,8,0,33,47,1
2083,24142,6zt7VkEpMezYkke6xelTowmnsTySao1Z,SpATywNh6bZuzm8s1ceuBUnMUAeoAHHw,27,18,12,18,8,9,6,0,71,10.142857142857142,5,0.0,5,12,16,8,13,9,2,6,0,41,30,1
2084,24146,W41zjpcR5alpzNzSmbyy9bBZYrT6UXxL,RXDvfPUBYFlVdlueBFbLW0mhhAyGEqpt,31,37,28,18,16,0,24,0,123,17.571428571428573,5,0.0,4,28,13,16,33,0,5,24,0,61,62,1
2085,24149,yEc0qGRUsnGavj0JPbk8pVtWktClrURk,SpATywNh6bZuzm8s1ceuBUnMUAeoAHHw,24,38,17,22,4,8,16,0,105,15.0,8,0.0,13,17,17,4,25,8,5,16,0,51,54,0
2086,24150,7mxOgTUP9lSjAUBOPZ9fhNEhVSHMvF2J,bWdj2GDclj5ofokWjzoa5jAwMkxCykd6,37,90,16,129,8,43,20,2,308,44.0,7,0.0,22,16,113,8,68,43,16,20,2,159,149,0
2087,24154,WTCEOd5LeoB3M6qdd6wv5K0UJQNEdjBy,bWdj2GDclj5ofokWjzoa5jAwMkxCykd6,7,2,1,0,1,7,6,1,18,2.5714285714285716,2,0.0,0,1,0,1,2,7,0,6,1,2,16,1
2088,24161,ZRTZW05J88lidJZzll8LtXVXzVI1deNg,SpATywNh6bZuzm8s1ceuBUnMUAeoAHHw,8,8,0,0,0,1,10,0,19,2.7142857142857144,2,0.0,0,0,0,0,8,1,0,10,0,0,19,1
2089,24172,s4TNdVBVykBR8x72RZEnjBx6ebkwwW3k,A3fsA9Zfv1X2fVEQhTw51lKENdNrEqT3,16,10,9,0,9,0,1,0,29,4.142857142857143,1,0.0,0,9,0,9,10,0,0,1,0,18,11,1
2090,24179,gEzMd6gbgpZIm67NWd6vqHpEEo3Eo4i8,RXDvfPUBYFlVdlueBFbLW0mhhAyGEqpt,1,0,0,0,0,0,1,0,1,0.14285714285714285,1,0.0,0,0,0,0,0,0,0,1,0,0,1,1
2091,24187,GlAlbUSi7bTkQeCE1bsVWDk5GBPq0ZBP,bWdj2GDclj5ofokWjzoa5jAwMkxCykd6,15,20,11,22,5,26,11,0,95,13.571428571428571,5,0.0,3,11,21,5,17,26,1,11,0,40,55,1
2092,24188,6my3HLUJsR66IUqoTOpOu4zu43YWvDxI,A3fsA9Zfv1X2fVEQhTw51lKENdNrEqT3,10,16,4,0,1,0,9,0,30,4.285714285714286,2,0.0,2,4,0,1,14,0,0,9,0,7,23,1
2093,24191,VVltscgfR96aweHb5nQdD1Q7dsOwuOJz,A3fsA9Zfv1X2fVEQhTw51lKENdNrEqT3,34,26,0,48,0,0,7,0,81,11.571428571428571,3,0.0,1,0,45,0,25,0,3,7,0,46,35,1
2094,24205,KjugBA6V5bkEA5fAIbJoGnSUlDhZoaIH,SpATywNh6bZuzm8s1ceuBUnMUAeoAHHw,17,39,18,0,7,7,12,0,83,11.857142857142858,4,0.0,2,18,0,7,37,7,0,12,0,27,56,0
2095,24210,LpAsllakvdmHNKkTbI74k56UY22DACic,SpATywNh6bZuzm8s1ceuBUnMUAeoAHHw,4,2,1,0,1,0,2,0,6,0.8571428571428571,1,0.0,0,1,0,1,2,0,0,2,0,2,4,1
2096,24228,Kawdpya8bnbVtCe5VJbkVPFzmayWdtI6,SpATywNh6bZuzm8s1ceuBUnMUAeoAHHw,1,0,0,0,0,0,1,0,1,0.14285714285714285,1,0.0,0,0,0,0,0,0,0,1,0,0,1,1
2097,24250,UPb6839zer74dQL1gRcC95mBDcZeCZUO,bWdj2GDclj5ofokWjzoa5jAwMkxCykd6,4,2,1,0,1,0,1,0,5,0.7142857142857143,1,0.0,0,1,0,1,2,0,0,1,0,2,3,1
2098,24255,SvdoxHaqv4If8vTEQE4Ye6pIzdBuUEi9,G8EPVSXsOYB5YQWZGiz1aVq5Pgr2GrQu,25,44,29,28,14,13,7,0,135,19.285714285714285,3,0.0,11,29,24,14,33,13,4,7,0,78,57,1
2099,24257,L8lHLh6Mth1S7I3sErP5oDZD885a1BOh,A3fsA9Zfv1X2fVEQhTw51lKENdNrEqT3,45,14,6,117,1,0,6,0,144,20.571428571428573,2,0.0,5,6,111,1,9,0,6,6,0,123,21,1
2100,24258,Ne25k1DU4nK81LWo7930HvBFWlFV2ZKt,SpATywNh6bZuzm8s1ceuBUnMUAeoAHHw,27,52,19,29,9,0,15,0,124,17.714285714285715,9,0.0,11,19,28,9,41,0,1,15,0,67,57,0
2101,24260,RxUvz1VnE0RHae7wTLOzUprYmci0pJ08,bWdj2GDclj5ofokWjzoa5jAwMkxCykd6,6,2,1,0,1,0,4,1,9,1.2857142857142858,1,0.0,0,1,0,1,2,0,0,4,1,2,7,1
2102,24283,yZoviGGxgr5NFf9klHeC5PfXfdVd14QP,A3fsA9Zfv1X2fVEQhTw51lKENdNrEqT3,47,30,20,58,10,2,18,2,140,20.0,4,0.0,1,20,54,10,29,2,4,18,2,85,55,1
2103,24285,Kd69M9W1nim0woqVm1QxfVaSebsYtFIh,RXDvfPUBYFlVdlueBFbLW0mhhAyGEqpt,16,36,15,12,5,1,11,1,81,11.571428571428571,6,0.0,1,15,12,5,35,1,0,11,1,33,48,1
2104,24289,oMQSjsmH1aRsG8joAcNWi5ozsWLu10HK,bWdj2GDclj5ofokWjzoa5jAwMkxCykd6,5,2,1,0,1,0,2,0,6,0.8571428571428571,1,0.0,0,1,0,1,2,0,0,2,0,2,4,1
2105,24290,Ms0MC4W5moiGJLWP7iE3FImeH9CHN4KT,A3fsA9Zfv1X2fVEQhTw51lKENdNrEqT3,7,16,7,0,1,0,13,0,37,5.285714285714286,7,0.0,0,7,0,1,16,0,0,13,0,8,29,0
2106,24294,j1LAePLDyUZgKcurnBhMK9q8whbJ98ja,SpATywNh6bZuzm8s1ceuBUnMUAeoAHHw,4,2,0,0,0,0,2,0,4,0.5714285714285714,1,0.0,0,0,0,0,2,0,0,2,0,0,4,1
2107,24302,ew0XpK44UZ9NkpDlIMehLaSdbqgabj65,SpATywNh6bZuzm8s1ceuBUnMUAeoAHHw,4,2,1,0,1,0,2,0,6,0.8571428571428571,1,0.0,0,1,0,1,2,0,0,2,0,2,4,1
2108,24313,Evco2d15cNydZMimph5VWFT3j0HfgNP5,SpATywNh6bZuzm8s1ceuBUnMUAeoAHHw,22,26,17,6,10,0,6,0,65,9.285714285714286,5,0.0,5,17,6,10,21,0,0,6,0,38,27,0
2109,24324,W41zjpcR5alpzNzSmbyy9bBZYrT6UXxL,A3fsA9Zfv1X2fVEQhTw51lKENdNrEqT3,13,11,7,0,6,0,4,0,28,4.0,2,0.0,0,7,0,6,11,0,0,4,0,13,15,1
2110,24351,iugl3Rn3u1ci3BiC2tfekDHOQsD5QVGj,A3fsA9Zfv1X2fVEQhTw51lKENdNrEqT3,11,20,11,0,1,1,13,0,46,6.571428571428571,6,0.0,4,11,0,1,16,1,0,13,0,16,30,1
2111,24356,jb05o2Us6b6SE2vZsRGcabjWWbS3vGCF,SpATywNh6bZuzm8s1ceuBUnMUAeoAHHw,1,0,0,0,0,0,2,0,2,0.2857142857142857,1,0.0,0,0,0,0,0,0,0,2,0,0,2,1
2112,24359,WdQwb0B6ZnAdvXskBHP8stZHsjNTkrqQ,SpATywNh6bZuzm8s1ceuBUnMUAeoAHHw,10,11,5,9,1,0,8,0,34,4.857142857142857,1,0.0,1,5,7,1,10,0,2,8,0,14,20,1
2113,24369,dWVj5G83xAxBDmPzLgLHfDC3pxyIk4K1,SpATywNh6bZuzm8s1ceuBUnMUAeoAHHw,1,0,0,0,0,0,3,0,3,0.42857142857142855,1,0.0,0,0,0,0,0,0,0,3,0,0,3,1
2114,24371,1RLhIao7wKT4YvgWBYzjLBBf7hozJmqb,SpATywNh6bZuzm8s1ceuBUnMUAeoAHHw,8,5,1,0,1,1,6,1,15,2.142857142857143,2,0.0,0,1,0,1,5,1,0,6,1,2,13,1
2115,24375,vx3ISVZde9Js9SAljxLNpat5gkbJKEY2,RXDvfPUBYFlVdlueBFbLW0mhhAyGEqpt,49,57,18,67,11,15,25,2,195,27.857142857142858,5,0.0,21,18,62,11,36,15,5,25,2,112,83,0
2116,24384,j1jdy8OF5VQw4rqSYOkbK2pQplvvvz37,SpATywNh6bZuzm8s1ceuBUnMUAeoAHHw,1,0,0,0,0,0,2,0,2,0.2857142857142857,2,0.0,0,0,0,0,0,0,0,2,0,0,2,1
2117,24391,5tGNQxzw9lFd1DSnmxNCdWwVZfTyj1IB,bWdj2GDclj5ofokWjzoa5jAwMkxCykd6,24,35,22,108,8,0,13,0,186,26.571428571428573,8,0.0,4,22,106,8,31,0,2,13,0,140,46,1
2118,24396,WdQwb0B6ZnAdvXskBHP8stZHsjNTkrqQ,A3fsA9Zfv1X2fVEQhTw51lKENdNrEqT3,10,4,1,0,1,0,7,2,15,2.142857142857143,1,0.0,0,1,0,1,4,0,0,7,2,2,13,1
2119,24397,2ZTBzb1Y4dwuOwNiUUSWB6SyHlRXxNso,SpATywNh6bZuzm8s1ceuBUnMUAeoAHHw,31,63,18,25,9,2,9,1,127,18.142857142857142,5,0.0,33,18,25,9,30,2,0,9,1,85,42,1
2120,24418,a3VUGRBh4vIHU6nTy2I0Dl5D5S8VvzQM,SpATywNh6bZuzm8s1ceuBUnMUAeoAHHw,7,3,2,0,2,0,2,0,9,1.2857142857142858,1,0.0,0,2,0,2,3,0,0,2,0,4,5,1
2121,24431,ADFd6U5gb8MuQY2di0urTV7aR0h11Ir1,RXDvfPUBYFlVdlueBFbLW0mhhAyGEqpt,2,0,0,0,0,0,2,0,2,0.2857142857142857,1,0.0,0,0,0,0,0,0,0,2,0,0,2,1
2122,24432,ADFd6U5gb8MuQY2di0urTV7aR0h11Ir1,A3fsA9Zfv1X2fVEQhTw51lKENdNrEqT3,2,0,0,0,0,0,2,0,2,0.2857142857142857,1,0.0,0,0,0,0,0,0,0,2,0,0,2,1
2123,24445,mFNGHC6aCmhHmhRXFCDO0uvnGnNYaro0,bWdj2GDclj5ofokWjzoa5jAwMkxCykd6,14,18,12,14,6,8,8,0,66,9.428571428571429,3,0.0,2,12,12,6,16,8,2,8,0,32,34,1
2124,24447,bSOq11L6zS91mDTcR42LcWMRdkU0Htpv,SpATywNh6bZuzm8s1ceuBUnMUAeoAHHw,7,8,3,0,1,1,7,0,20,2.857142857142857,2,0.0,0,3,0,1,8,1,0,7,0,4,16,1
2125,24456,AOtTiaeDNx4G2J0NpAHDjb596RxqAAI3,SpATywNh6bZuzm8s1ceuBUnMUAeoAHHw,19,28,10,14,6,2,13,2,75,10.714285714285714,2,0.0,15,10,11,6,13,2,3,13,2,42,33,1
2126,24475,1yAfuEW0CNQiRXnPO0v79LFUyx4hhTWm,bWdj2GDclj5ofokWjzoa5jAwMkxCykd6,16,7,5,38,1,0,9,0,60,8.571428571428571,2,0.0,0,5,33,1,7,0,5,9,0,39,21,0
2127,24503,VVgqDLLa7j66k9tQU3M7wVOF4BEse4lo,SpATywNh6bZuzm8s1ceuBUnMUAeoAHHw,16,55,17,13,7,1,10,0,103,14.714285714285714,5,0.0,9,17,13,7,46,1,0,10,0,46,57,0
2128,24505,iXoEMwcJ5o4IM7VKZ5pyam9GxPy4olUQ,G8EPVSXsOYB5YQWZGiz1aVq5Pgr2GrQu,4,3,1,0,0,0,3,0,7,1.0,1,0.0,0,1,0,0,3,0,0,3,0,1,6,1
2129,24517,iXoEMwcJ5o4IM7VKZ5pyam9GxPy4olUQ,bWdj2GDclj5ofokWjzoa5jAwMkxCykd6,1,0,0,0,0,0,2,0,2,0.2857142857142857,1,0.0,0,0,0,0,0,0,0,2,0,0,2,1
2130,24536,tE3Bwjiismxnblg3Eq9l6K3IoXQaklnD,bWdj2GDclj5ofokWjzoa5jAwMkxCykd6,1,0,0,0,0,0,1,0,1,0.14285714285714285,1,0.0,0,0,0,0,0,0,0,1,0,0,1,1
2131,24539,tE3Bwjiismxnblg3Eq9l6K3IoXQaklnD,SpATywNh6bZuzm8s1ceuBUnMUAeoAHHw,11,12,1,0,1,0,3,0,17,2.4285714285714284,1,0.0,3,1,0,1,9,0,0,3,0,5,12,1
2132,24542,GW33fgaq0ndGNQkirzfpXhCeUuV3tuD2,SpATywNh6bZuzm8s1ceuBUnMUAeoAHHw,30,46,23,28,14,3,12,1,127,18.142857142857142,4,0.0,12,23,27,14,34,3,1,12,1,76,51,0
2133,24550,qr1Y8xuPrcpdzScNHYsirGXqasfUdOVa,SpATywNh6bZuzm8s1ceuBUnMUAeoAHHw,8,15,7,0,4,0,7,0,33,4.714285714285714,4,0.0,0,7,0,4,15,0,0,7,0,11,22,1
2134,24551,foJyfq5hSUj3jzVw8TG0nT1wv3hLMMNc,G8EPVSXsOYB5YQWZGiz1aVq5Pgr2GrQu,52,89,55,80,33,0,16,0,273,39.0,6,0.0,2,55,71,33,87,0,9,16,0,161,112,0
2135,24552,foJyfq5hSUj3jzVw8TG0nT1wv3hLMMNc,SpATywNh6bZuzm8s1ceuBUnMUAeoAHHw,26,41,14,24,4,5,13,0,101,14.428571428571429,5,0.0,5,14,24,4,36,5,0,13,0,47,54,0
2136,24569,VeFENcSXAiXgJQaSjlXiodtIBxgSrzaH,A3fsA9Zfv1X2fVEQhTw51lKENdNrEqT3,8,8,3,0,1,0,6,0,18,2.5714285714285716,3,0.0,0,3,0,1,8,0,0,6,0,4,14,1
2137,24572,QDaW6SyhKIOYnUckUXKfy6A7QKIp9Kb8,A3fsA9Zfv1X2fVEQhTw51lKENdNrEqT3,6,0,0,0,0,1,5,0,6,0.8571428571428571,1,0.0,0,0,0,0,0,1,0,5,0,0,6,1
2138,24587,f7pgA2Hp0s8DkqzKuvE0Kw8QRuoBh3Zv,RXDvfPUBYFlVdlueBFbLW0mhhAyGEqpt,48,82,48,92,20,19,10,0,271,38.714285714285715,5,0.0,21,48,80,20,61,19,12,10,0,169,102,0
2139,24601,rhJzZeMBkfw1Q75cLyvgh9HzDvUXe9cc,SpATywNh6bZuzm8s1ceuBUnMUAeoAHHw,4,3,0,0,0,0,4,0,7,1.0,2,0.0,0,0,0,0,3,0,0,4,0,0,7,1
2140,24602,tBWD1VTj6Jcj3AQ0AXY8eZtUzkjmoiNH,SpATywNh6bZuzm8s1ceuBUnMUAeoAHHw,20,36,10,6,5,22,16,1,96,13.714285714285714,4,0.0,7,10,6,5,29,22,0,16,1,28,68,0
2141,24608,S5LJKm1sQOy9mdQmh7HP7gCjw7krEMbq,A3fsA9Zfv1X2fVEQhTw51lKENdNrEqT3,13,6,3,0,3,0,8,0,20,2.857142857142857,3,0.0,0,3,0,3,6,0,0,8,0,6,14,1
2142,24619,0JvlwMe8wRQNeLJu71UvJCaEJca2naUP,7GRhBDsirIGkRZBtSMEzNTyDr2JQm4xx,38,48,17,34,14,9,15,2,139,19.857142857142858,4,0.0,17,17,28,14,31,9,6,15,2,76,63,1
2143,24632,zn2X74vvqUQRINz90WjZLsSsFglpYr7o,bWdj2GDclj5ofokWjzoa5jAwMkxCykd6,2,0,0,0,0,0,2,0,2,0.2857142857142857,1,0.0,0,0,0,0,0,0,0,2,0,0,2,1
2144,24640,a34YLXSKFcXb1SBjIduE3dfW4OSAFwK1,A3fsA9Zfv1X2fVEQhTw51lKENdNrEqT3,100,155,110,216,62,92,16,1,652,93.14285714285714,4,0.0,9,110,186,62,146,92,30,16,1,367,285,0
2145,24661,ZgPDgY8Y43cADkyBad03WZKNqaM99vmp,7GRhBDsirIGkRZBtSMEzNTyDr2JQm4xx,49,156,3,63,17,7,57,4,307,43.857142857142854,6,0.0,70,3,51,17,86,7,12,57,4,141,166,0
2146,24680,1VsjBK2ROnIVYUeDYM5LmXmBSaC6415r,7GRhBDsirIGkRZBtSMEzNTyDr2JQm4xx,4,2,1,0,0,0,2,0,5,0.7142857142857143,1,0.0,0,1,0,0,2,0,0,2,0,1,4,1
2147,24744,S6vBzHKpSh31SFGGZmwgKaOH2RvW3RpH,bWdj2GDclj5ofokWjzoa5jAwMkxCykd6,12,26,16,0,7,0,24,0,73,10.428571428571429,4,0.0,0,16,0,7,26,0,0,24,0,23,50,1
2148,24770,JSUd2wnxbPhnPOoSIVdrMCxy8KhaLF4M,7GRhBDsirIGkRZBtSMEzNTyDr2JQm4xx,20,34,17,17,10,0,9,0,87,12.428571428571429,5,0.0,5,17,14,10,29,0,3,9,0,46,41,1
2149,24771,zOqvR5SeTZmNwN7GW7m4oZ7a32WZgEDz,RXDvfPUBYFlVdlueBFbLW0mhhAyGEqpt,10,9,2,0,2,0,4,0,17,2.4285714285714284,1,0.0,0,2,0,2,9,0,0,4,0,4,13,1
2150,24783,3b2PIBrJ06iLfdDIB9BTmuEwfL5TZfMa,RXDvfPUBYFlVdlueBFbLW0mhhAyGEqpt,65,57,33,112,17,8,9,1,237,33.857142857142854,3,0.0,15,33,103,17,42,8,9,9,1,168,69,0
2151,24796,8tSKdZ8K9lE8Sg5tXOt7ENrj00lNonld,SpATywNh6bZuzm8s1ceuBUnMUAeoAHHw,23,28,1,34,0,15,13,2,93,13.285714285714286,4,0.0,7,1,29,0,21,15,5,13,2,37,56,0
2152,24805,KRi80h1uK84snC5HvtQKWlsjwt9i3oa5,SpATywNh6bZuzm8s1ceuBUnMUAeoAHHw,12,15,9,7,4,0,4,0,39,5.571428571428571,3,0.0,3,9,6,4,12,0,1,4,0,22,17,0
2153,24823,FCXkOVtASvwM4OqelAOjh7n6TzPCCzLb,7GRhBDsirIGkRZBtSMEzNTyDr2JQm4xx,7,5,3,0,3,0,2,0,13,1.8571428571428572,1,0.0,1,3,0,3,4,0,0,2,0,7,6,1
2154,24824,JEEkuD8nRyQdFWZOzS8kZ8mhHw8bPQH3,7GRhBDsirIGkRZBtSMEzNTyDr2JQm4xx,2,0,0,0,0,0,2,0,2,0.2857142857142857,1,0.0,0,0,0,0,0,0,0,2,0,0,2,1
2155,24834,NsnGWsRio9JsRS5X1oYgeBjF7tc8iDdA,7GRhBDsirIGkRZBtSMEzNTyDr2JQm4xx,40,95,39,85,27,28,18,1,293,41.857142857142854,5,0.0,44,39,74,27,51,28,11,18,1,184,109,1
2156,24836,wuaIkUodYTr49NZ7BbMPsEdpO0t0C8Nt,7GRhBDsirIGkRZBtSMEzNTyDr2JQm4xx,2,0,0,0,0,0,2,0,2,0.2857142857142857,1,0.0,0,0,0,0,0,0,0,2,0,0,2,1
2157,24885,7AeiHdeG7nh46bg2JDAmPWtQ1zuvRpUT,A3fsA9Zfv1X2fVEQhTw51lKENdNrEqT3,8,2,0,0,0,1,8,1,12,1.7142857142857142,1,0.0,0,0,0,0,2,1,0,8,1,0,12,0
2158,24886,rO1KHHxaPbWq8U3I08PqNPYplaZaPb83,RXDvfPUBYFlVdlueBFbLW0mhhAyGEqpt,1,0,0,0,0,0,1,0,1,0.14285714285714285,1,0.0,0,0,0,0,0,0,0,1,0,0,1,1
2159,24901,paRtaUir7BROwVpnw69gcE7HkkiPuHFt,7GRhBDsirIGkRZBtSMEzNTyDr2JQm4xx,34,81,6,70,7,8,43,5,220,31.428571428571427,4,0.0,49,6,61,7,32,8,9,43,5,123,97,1
2160,24909,pyd2EL5x8zMZ7LCIvrt0VYq229eSSKrd,SpATywNh6bZuzm8s1ceuBUnMUAeoAHHw,30,40,27,32,16,7,6,1,129,18.428571428571427,2,0.0,11,27,28,16,29,7,4,6,1,82,47,0
2161,24929,hCRoH0np1tajD5PHKKgVw7dH4NZJLfD2,A3fsA9Zfv1X2fVEQhTw51lKENdNrEqT3,53,37,25,80,15,27,30,7,221,31.571428571428573,8,0.0,1,25,69,15,36,27,11,30,7,110,111,0
2162,24942,DCwFNk2m7QLqdKcTT3u5CdSnRyl5YCHB,SpATywNh6bZuzm8s1ceuBUnMUAeoAHHw,1,0,0,0,0,0,1,0,1,0.14285714285714285,1,0.0,0,0,0,0,0,0,0,1,0,0,1,1
2163,24984,p8pFuUg19xWGOlJygMvSlQjonA3l7FUn,A3fsA9Zfv1X2fVEQhTw51lKENdNrEqT3,28,33,29,0,22,0,4,0,88,12.571428571428571,4,0.0,0,29,0,22,33,0,0,4,0,51,37,0
2164,24996,tLK32ryOHeiJecBcFzaTeN36vYEmQ8Nk,SpATywNh6bZuzm8s1ceuBUnMUAeoAHHw,30,27,13,42,7,8,10,4,111,15.857142857142858,3,0.0,11,13,37,7,16,8,5,10,4,68,43,1
2165,25033,BuZcYQWwWDSVZcqno1RGBiY1PDnVqtUZ,G8EPVSXsOYB5YQWZGiz1aVq5Pgr2GrQu,19,33,19,20,1,1,5,0,79,11.285714285714286,3,0.0,4,19,19,1,29,1,1,5,0,43,36,1
2166,25049,zkOr0wwuxAzYftPuxG6iQaCtbl1egkTS,A3fsA9Zfv1X2fVEQhTw51lKENdNrEqT3,57,69,45,102,17,22,47,5,307,43.857142857142854,6,0.0,10,45,93,17,59,22,9,47,5,165,142,0
2167,25067,aQ6WrdDe9pTNwVW3vmaMOs1pxy5r3Dxa,A3fsA9Zfv1X2fVEQhTw51lKENdNrEqT3,60,46,28,106,14,34,19,0,247,35.285714285714285,5,0.0,2,28,89,14,44,34,17,19,0,133,114,0
2168,25073,WQKoaWRi4j5EUCfZEZsK4LU6GIHATRae,SpATywNh6bZuzm8s1ceuBUnMUAeoAHHw,30,26,16,29,10,9,12,0,102,14.571428571428571,6,0.0,7,16,23,10,19,9,6,12,0,56,46,1
2169,25075,WQKoaWRi4j5EUCfZEZsK4LU6GIHATRae,7GRhBDsirIGkRZBtSMEzNTyDr2JQm4xx,32,48,17,50,14,10,5,0,144,20.571428571428573,2,0.0,29,17,39,14,19,10,11,5,0,99,45,1
2170,25096,i7qRP2nhuaIR2tcQnQvT86ViNtPopbnz,7GRhBDsirIGkRZBtSMEzNTyDr2JQm4xx,11,13,7,0,4,0,7,0,31,4.428571428571429,3,0.0,1,7,0,4,12,0,0,7,0,12,19,1
2171,25111,XQUx3MwVudtjeHmsju8PhHxsdXW0kluK,SpATywNh6bZuzm8s1ceuBUnMUAeoAHHw,15,24,12,12,4,1,5,0,58,8.285714285714286,3,0.0,9,12,12,4,15,1,0,5,0,37,21,0
2172,25118,mBkByOktWGTfbLjZh4oUEAyrYqB4PqkG,7GRhBDsirIGkRZBtSMEzNTyDr2JQm4xx,6,17,3,0,1,0,3,0,24,3.4285714285714284,6,0.0,0,3,0,1,17,0,0,3,0,4,20,1
2173,25134,tyleDimh7zmzFWTVgvg7bgaQaZGfwPk2,A3fsA9Zfv1X2fVEQhTw51lKENdNrEqT3,8,7,1,0,0,0,4,0,12,1.7142857142857142,1,0.0,0,1,0,0,7,0,0,4,0,1,11,0
2174,25182,hGCwfWh9ySQVbALdmRR0HUMpPic5OOrw,bWdj2GDclj5ofokWjzoa5jAwMkxCykd6,7,2,1,0,1,0,5,0,9,1.2857142857142858,1,0.0,1,1,0,1,1,0,0,5,0,3,6,0
2175,25194,evrdwGhLAFWdgr0Clw2EFTM91w358eNP,SpATywNh6bZuzm8s1ceuBUnMUAeoAHHw,25,19,14,6,8,10,8,2,67,9.571428571428571,1,0.0,3,14,6,8,16,10,0,8,2,31,36,0
2176,25198,w6Jq91nutnXM9db4LCqDd346NIYOr0ts,7GRhBDsirIGkRZBtSMEzNTyDr2JQm4xx,8,6,3,0,0,0,9,0,18,2.5714285714285716,1,0.0,1,3,0,0,5,0,0,9,0,4,14,1
2177,25212,95whmOrr6ttgAKmA8d5EYFggt87ONgHi,SpATywNh6bZuzm8s1ceuBUnMUAeoAHHw,17,27,5,22,3,3,8,0,68,9.714285714285714,3,0.0,14,5,19,3,13,3,3,8,0,41,27,1
2178,25219,skOScgcMIkYsPXikHjLqvicjdb3rv6St,A3fsA9Zfv1X2fVEQhTw51lKENdNrEqT3,9,12,5,14,1,0,7,0,39,5.571428571428571,4,0.0,2,5,12,1,10,0,2,7,0,20,19,1
2179,25235,BgFWtuiCvZoByaUpZ5qN1JDEWuWXlm2n,G8EPVSXsOYB5YQWZGiz1aVq5Pgr2GrQu,31,72,28,90,9,2,21,2,224,32.0,3,0.0,32,28,55,9,40,2,35,21,2,124,100,1
2180,25249,ycTj3YOXaJ7pHDIwrzbh7koMVXAXAOVY,bWdj2GDclj5ofokWjzoa5jAwMkxCykd6,37,38,22,186,12,2,11,1,272,38.857142857142854,2,0.0,11,22,177,12,27,2,9,11,1,222,50,0
2181,25265,9va79rFsgW625mCi6PBHbhUMC5acSS5i,bWdj2GDclj5ofokWjzoa5jAwMkxCykd6,40,34,18,165,14,0,16,2,249,35.57142857142857,4,0.0,14,18,153,14,20,0,12,16,2,199,50,0
2182,25269,E1ioRxhhohHY3rrHygts052gZKXoxwdE,7GRhBDsirIGkRZBtSMEzNTyDr2JQm4xx,7,3,2,0,2,0,2,0,9,1.2857142857142858,1,0.0,0,2,0,2,3,0,0,2,0,4,5,1
2183,25284,6DpgdlGoKRdZ3TeMwKLdUESj04TqApO6,7GRhBDsirIGkRZBtSMEzNTyDr2JQm4xx,39,58,20,84,16,0,6,0,184,26.285714285714285,3,0.0,33,20,74,16,25,0,10,6,0,143,41,1
2184,25287,ETzcC9n39CwhBb4MTbqq1Ng4NqGIoiPj,SpATywNh6bZuzm8s1ceuBUnMUAeoAHHw,14,26,1,8,2,0,4,0,41,5.857142857142857,1,0.0,9,1,8,2,17,0,0,4,0,20,21,1
2185,25295,ETzcC9n39CwhBb4MTbqq1Ng4NqGIoiPj,bWdj2GDclj5ofokWjzoa5jAwMkxCykd6,20,21,1,32,1,1,8,0,64,9.142857142857142,2,0.0,1,1,28,1,20,1,4,8,0,31,33,1
2186,25299,NwQCoUHJKyAdqdG7U0utXO1oyZsmr8V3,A3fsA9Zfv1X2fVEQhTw51lKENdNrEqT3,89,41,8,252,6,21,18,1,347,49.57142857142857,3,0.0,5,8,218,6,36,21,34,18,1,237,110,0
2187,25330,JQkQWFK6hvLU3dRb6IiKAH09cV6i6Ru3,SpATywNh6bZuzm8s1ceuBUnMUAeoAHHw,17,23,1,21,1,1,5,1,53,7.571428571428571,1,0.0,11,1,18,1,12,1,3,5,1,31,22,0
2188,25371,tMJpDv6ZjEPz2ELzUVp4mZTT6G7u49T6,bWdj2GDclj5ofokWjzoa5jAwMkxCykd6,8,8,3,0,1,0,12,0,24,3.4285714285714284,5,0.0,1,3,0,1,7,0,0,12,0,5,19,0
2189,25376,Evco2d15cNydZMimph5VWFT3j0HfgNP5,7GRhBDsirIGkRZBtSMEzNTyDr2JQm4xx,8,13,4,2,6,1,2,0,28,4.0,2,0.0,6,4,2,6,7,1,0,2,0,18,10,1
2190,25391,1aQoKDna73jstuOrupWa9Kq8V3FdvbRU,A3fsA9Zfv1X2fVEQhTw51lKENdNrEqT3,8,6,3,0,2,0,4,0,15,2.142857142857143,3,0.0,0,3,0,2,6,0,0,4,0,5,10,1
2191,25393,qfUwpJQAdesy8M2BZDMAUMfg4I7ObmXB,7GRhBDsirIGkRZBtSMEzNTyDr2JQm4xx,8,0,0,0,0,0,7,1,8,1.1428571428571428,1,0.0,0,0,0,0,0,0,0,7,1,0,8,1
2192,25406,Ua8t7GvEqkquREwn5gCoNVwYmIqhqGMw,G8EPVSXsOYB5YQWZGiz1aVq5Pgr2GrQu,47,62,33,66,19,32,21,3,236,33.714285714285715,3,0.0,19,33,50,19,43,32,16,21,3,121,115,0
2193,25409,tvH2SB0L50iCqaXyQDY3u7qaByLbL0rV,RXDvfPUBYFlVdlueBFbLW0mhhAyGEqpt,7,5,1,0,1,1,2,0,10,1.4285714285714286,2,0.0,0,1,0,1,5,1,0,2,0,2,8,1
2194,25410,eLRb35TMSz5mhOV1jFWfgFHXl5MBmODw,SpATywNh6bZuzm8s1ceuBUnMUAeoAHHw,4,10,0,0,0,0,3,0,13,1.8571428571428572,2,0.0,0,0,0,0,10,0,0,3,0,0,13,1
2195,25411,zTKXcgMSZF7JvFUNYP705peyaFADazmR,bWdj2GDclj5ofokWjzoa5jAwMkxCykd6,9,11,7,0,3,1,11,0,33,4.714285714285714,3,0.0,0,7,0,3,11,1,0,11,0,10,23,0
2196,25414,JGLccTidDHJDu8gDiATpQDW1eozc4icT,G8EPVSXsOYB5YQWZGiz1aVq5Pgr2GrQu,40,27,19,116,13,0,2,0,177,25.285714285714285,2,0.0,4,19,101,13,23,0,15,2,0,137,40,1
2197,25442,QLGFenndIPaX8I2vSI7keErJ6m5JCAL7,7GRhBDsirIGkRZBtSMEzNTyDr2JQm4xx,9,5,2,2,3,1,5,0,18,2.5714285714285716,1,0.0,3,2,2,3,2,1,0,5,0,10,8,1
2198,25443,rpvfqHO7dPQYBUZWKnS2wc1t5Qy6pGj6,bWdj2GDclj5ofokWjzoa5jAwMkxCykd6,15,41,0,32,3,0,13,0,89,12.714285714285714,5,0.0,9,0,29,3,32,0,3,13,0,41,48,1
2199,25446,cUmqYT3vXiSNkNfCulTfjg26cA62ehB2,SpATywNh6bZuzm8s1ceuBUnMUAeoAHHw,6,2,0,0,0,1,7,1,11,1.5714285714285714,1,0.0,0,0,0,0,2,1,0,7,1,0,11,1
2200,25461,TvoBOfhroHgtNwfOxtnATpVOdfdysLPf,SpATywNh6bZuzm8s1ceuBUnMUAeoAHHw,13,9,1,8,1,1,5,1,26,3.7142857142857144,1,0.0,4,1,7,1,5,1,1,5,1,13,13,1
2201,25463,tCXa4pMsMXRuliZWNM9so3Odte6UmpYj,RXDvfPUBYFlVdlueBFbLW0mhhAyGEqpt,10,9,4,0,2,0,4,0,19,2.7142857142857144,1,0.0,2,4,0,2,7,0,0,4,0,8,11,1
2202,25482,M3Xa5IFPEZiaLK2rAjKqcPYFncjR6IsA,7GRhBDsirIGkRZBtSMEzNTyDr2JQm4xx,10,9,6,0,2,0,8,0,25,3.5714285714285716,3,0.0,0,6,0,2,9,0,0,8,0,8,17,1
2203,25503,XQUx3MwVudtjeHmsju8PhHxsdXW0kluK,G8EPVSXsOYB5YQWZGiz1aVq5Pgr2GrQu,6,6,3,0,2,0,4,0,15,2.142857142857143,1,0.0,0,3,0,2,6,0,0,4,0,5,10,1
2204,25511,RtpaISGKG8FC1poFd4XAu8898XLnl6EI,SpATywNh6bZuzm8s1ceuBUnMUAeoAHHw,23,55,23,16,9,10,20,1,134,19.142857142857142,8,0.0,11,23,14,9,44,10,2,20,1,57,77,0
2205,25527,qEjaWdK86bYd7lCS9YD68MsK6migCUpH,SpATywNh6bZuzm8s1ceuBUnMUAeoAHHw,26,22,10,17,7,0,11,0,67,9.571428571428571,3,0.0,4,10,16,7,18,0,1,11,0,37,30,0
2206,25546,rfOApTbQ4xF2665bHZIBhoJqQcTU6i9L,A3fsA9Zfv1X2fVEQhTw51lKENdNrEqT3,17,19,13,0,6,0,11,1,50,7.142857142857143,2,0.0,0,13,0,6,19,0,0,11,1,19,31,1
2207,25551,KArM7gUn52riH9ery2Pt8jVzh161mtd5,7GRhBDsirIGkRZBtSMEzNTyDr2JQm4xx,1,0,0,0,0,0,1,0,1,0.14285714285714285,1,0.0,0,0,0,0,0,0,0,1,0,0,1,1
2208,25552,OL3EuzPtZh7LsYXjzzPmtbrDH2VopR0Y,bWdj2GDclj5ofokWjzoa5jAwMkxCykd6,6,8,4,0,1,0,7,0,20,2.857142857142857,1,0.0,0,4,0,1,8,0,0,7,0,5,15,0
2209,25588,fEjyEDOkalYa6eH46cG6UcR1E7twiXyF,SpATywNh6bZuzm8s1ceuBUnMUAeoAHHw,32,32,19,36,7,51,16,1,162,23.142857142857142,2,0.0,6,19,30,7,26,51,6,16,1,62,100,0
2210,25589,3Oka5GvBd9TakXRvr9D5vxoJEhxwuxJA,SpATywNh6bZuzm8s1ceuBUnMUAeoAHHw,23,37,18,26,4,0,17,0,102,14.571428571428571,6,0.0,11,18,26,4,26,0,0,17,0,59,43,0
2211,25599,tSfB7w0NRlNAlyBUvZCESn8JJeD8KUGH,7GRhBDsirIGkRZBtSMEzNTyDr2JQm4xx,6,2,1,0,0,0,3,0,6,0.8571428571428571,1,0.0,0,1,0,0,2,0,0,3,0,1,5,1
2212,25607,s5bmHBniKJzstjkFlsJcJn6YQEnj7XjP,SpATywNh6bZuzm8s1ceuBUnMUAeoAHHw,4,2,1,0,1,0,2,0,6,0.8571428571428571,1,0.0,0,1,0,1,2,0,0,2,0,2,4,0
2213,25655,TOdJr6wpv1Do14qMOudEcAu5ZtPnzG5P,SpATywNh6bZuzm8s1ceuBUnMUAeoAHHw,29,20,11,22,7,7,8,1,76,10.857142857142858,3,0.0,6,11,22,7,14,7,0,8,1,46,30,0
2214,25675,wgifE6A0kxnDEjw7myKTY39TRuCgYxaB,A3fsA9Zfv1X2fVEQhTw51lKENdNrEqT3,21,28,7,0,5,0,6,0,46,6.571428571428571,3,0.0,0,7,0,5,28,0,0,6,0,12,34,1
2215,25678,8hHM4gMR8PLgcGE0KxgxZ4wD71iRPNWp,RXDvfPUBYFlVdlueBFbLW0mhhAyGEqpt,70,102,39,84,27,0,10,1,263,37.57142857142857,2,0.0,31,39,82,27,71,0,2,10,1,179,84,1
2216,25696,Ufo4AkS2vTW82q9Kpcrkrp0gG0Us5zu9,7GRhBDsirIGkRZBtSMEzNTyDr2JQm4xx,11,17,2,0,2,0,4,0,25,3.5714285714285716,2,0.0,0,2,0,2,17,0,0,4,0,4,21,1
2217,25706,udBjfCluZTte9l6GhqqG4v3kEGoKKcxC,SpATywNh6bZuzm8s1ceuBUnMUAeoAHHw,26,55,22,23,10,28,21,3,162,23.142857142857142,6,0.0,24,22,20,10,31,28,3,21,3,76,86,0
2218,25720,v0qndwa3TlbOqgdTUBH2afnl049VDWzU,SpATywNh6bZuzm8s1ceuBUnMUAeoAHHw,29,50,26,24,8,0,15,0,123,17.571428571428573,9,0.0,10,26,24,8,40,0,0,15,0,68,55,0
2219,25733,AHQHegrW1VuEGnFOHlvBpkb4mWL3NKW9,SpATywNh6bZuzm8s1ceuBUnMUAeoAHHw,29,122,50,33,16,3,41,4,269,38.42857142857143,4,0.0,23,50,27,16,99,3,6,41,4,116,153,0
2220,25761,Y3GsHv1t2an649bMll1LdxvN2SIICjxG,SpATywNh6bZuzm8s1ceuBUnMUAeoAHHw,6,3,2,0,2,0,2,0,9,1.2857142857142858,2,0.0,0,2,0,2,3,0,0,2,0,4,5,0
2221,25773,xYLJB56SVkFUOdT5vN3Qq6OYNlnP0Fjc,7GRhBDsirIGkRZBtSMEzNTyDr2JQm4xx,40,144,54,36,23,0,14,0,271,38.714285714285715,7,0.0,10,54,33,23,134,0,3,14,0,120,151,1
2222,25804,E7Frt6tr6owhsgLSRkD2PqDaTSKmNLId,7GRhBDsirIGkRZBtSMEzNTyDr2JQm4xx,7,12,3,0,1,0,7,0,23,3.2857142857142856,4,0.0,3,3,0,1,9,0,0,7,0,7,16,1
2223,25814,XfsOspDiOb9wQgSI2MsAsoTalG7mdDaH,A3fsA9Zfv1X2fVEQhTw51lKENdNrEqT3,26,56,2,0,2,0,18,2,80,11.428571428571429,5,0.0,1,2,0,2,55,0,0,18,2,5,75,1
2224,25816,lMefkcgNh5NMvOXiUOkNuemhw07vFq2i,SpATywNh6bZuzm8s1ceuBUnMUAeoAHHw,22,17,13,0,8,6,11,0,55,7.857142857142857,3,0.0,1,13,0,8,16,6,0,11,0,22,33,0
2225,25826,mLf710wFmDQbZB0X7jv0DPpqMqjMZwPk,SpATywNh6bZuzm8s1ceuBUnMUAeoAHHw,30,51,29,34,15,25,22,6,182,26.0,2,0.0,12,29,32,15,39,25,2,22,6,88,94,1
2226,25882,N3h2N9w5PnUvhnv2E14KTv0J7vawpbdm,7GRhBDsirIGkRZBtSMEzNTyDr2JQm4xx,1,0,0,0,0,0,1,0,1,0.14285714285714285,1,0.0,0,0,0,0,0,0,0,1,0,0,1,1
2227,25900,NRMzH6tZyLT2qk2QIkwNRbUliCMPz2WK,A3fsA9Zfv1X2fVEQhTw51lKENdNrEqT3,18,13,11,0,9,0,3,0,36,5.142857142857143,2,0.0,0,11,0,9,13,0,0,3,0,20,16,0
2228,25915,iyIAPlnIEma306NSolsaccbjttZIVUuH,SpATywNh6bZuzm8s1ceuBUnMUAeoAHHw,29,33,13,31,7,0,7,0,91,13.0,3,0.0,17,13,28,7,16,0,3,7,0,65,26,0
2229,25927,OrVbBbY1FlOrLC1xq9uXlMrFdoBE11eg,SpATywNh6bZuzm8s1ceuBUnMUAeoAHHw,30,42,18,16,8,43,14,5,146,20.857142857142858,3,0.0,13,18,15,8,29,43,1,14,5,54,92,0
2230,25936,Q0eCH09NIGOawcyrOKgsrxZbMJuOLuiw,A3fsA9Zfv1X2fVEQhTw51lKENdNrEqT3,57,80,38,68,30,0,5,0,221,31.571428571428573,2,0.0,1,38,57,30,79,0,11,5,0,126,95,0
2231,25939,Krxyy23fZ28ymHlUM9cR68oteYOpMEoc,bWdj2GDclj5ofokWjzoa5jAwMkxCykd6,7,10,4,0,0,0,6,0,20,2.857142857142857,3,0.0,2,4,0,0,8,0,0,6,0,6,14,0
2232,25944,Q0eCH09NIGOawcyrOKgsrxZbMJuOLuiw,7GRhBDsirIGkRZBtSMEzNTyDr2JQm4xx,1,0,0,0,0,0,3,0,3,0.42857142857142855,1,0.0,0,0,0,0,0,0,0,3,0,0,3,1
2233,25945,Xl7O5Es6VpkB2PrTgzArkv7OwJ7XzlEg,SpATywNh6bZuzm8s1ceuBUnMUAeoAHHw,18,46,17,12,7,24,15,1,122,17.428571428571427,4,0.0,21,17,12,7,25,24,0,15,1,57,65,0
2234,25956,iHFiZ9SvBVcIu7YGo4eFTUpkfFG44jX7,SpATywNh6bZuzm8s1ceuBUnMUAeoAHHw,23,67,24,17,9,4,32,2,155,22.142857142857142,9,0.0,11,24,14,9,56,4,3,32,2,58,97,0
2235,25959,E31WqWw5nCEWlSKgmhsOSj5j4T79ypCl,7GRhBDsirIGkRZBtSMEzNTyDr2JQm4xx,33,87,39,65,18,0,7,0,216,30.857142857142858,3,0.0,39,39,52,18,48,0,13,7,0,148,68,1
2236,26008,HPaJ9EDG8HjC5rpTdpwlfh4gznoH5Kdn,7GRhBDsirIGkRZBtSMEzNTyDr2JQm4xx,5,3,1,0,1,0,6,0,11,1.5714285714285714,1,0.0,0,1,0,1,3,0,0,6,0,2,9,1
2237,26009,RADrfrSrqd2D1lhkJRYdtWMv0TybV2Zk,A3fsA9Zfv1X2fVEQhTw51lKENdNrEqT3,12,12,3,0,3,0,4,0,22,3.142857142857143,3,0.0,0,3,0,3,12,0,0,4,0,6,16,1
2238,26020,Jag1EXQWfAuTRiCgcVLyhRRkdOL9RtSD,A3fsA9Zfv1X2fVEQhTw51lKENdNrEqT3,45,21,13,58,10,9,10,1,122,17.428571428571427,3,0.0,1,13,51,10,20,9,7,10,1,75,47,1
2239,26024,niLMw8MCObO7SSR2V1jNg9WQt5oSjDFJ,7GRhBDsirIGkRZBtSMEzNTyDr2JQm4xx,14,21,8,6,4,0,7,0,46,6.571428571428571,4,0.0,7,8,6,4,14,0,0,7,0,25,21,1
2240,26045,XDpGoHZOK8VrEEa7PvW4PqKqVXXJAMd4,7GRhBDsirIGkRZBtSMEzNTyDr2JQm4xx,19,22,11,0,10,0,6,0,49,7.0,1,0.0,8,11,0,10,14,0,0,6,0,29,20,1
2241,26064,bmnzCBeFMMY9XczD2LcVJyXeCKQk1fV4,bWdj2GDclj5ofokWjzoa5jAwMkxCykd6,4,0,0,0,0,4,5,0,9,1.2857142857142858,2,0.0,0,0,0,0,0,4,0,5,0,0,9,0
2242,26078,ByDjTuY0oLVzrle7JgW0XGlu5bLAo5Uj,SpATywNh6bZuzm8s1ceuBUnMUAeoAHHw,23,47,1,30,0,7,14,0,99,14.142857142857142,8,0.0,14,1,27,0,33,7,3,14,0,42,57,0
2243,26118,BoHg0aGtLUBHCRED1C89CbXgNAVI0w1o,7GRhBDsirIGkRZBtSMEzNTyDr2JQm4xx,7,5,1,0,0,0,4,0,10,1.4285714285714286,1,0.0,0,1,0,0,5,0,0,4,0,1,9,1
2244,26153,WDOhUt18DNMCYDEG35QkOfLroSJB0yOR,7GRhBDsirIGkRZBtSMEzNTyDr2JQm4xx,31,43,11,78,7,2,10,0,151,21.571428571428573,4,0.0,30,11,66,7,13,2,12,10,0,114,37,0
2245,26214,SB3PBvXY4EEkcNDmtIOX6bpu8RFJOU8W,G8EPVSXsOYB5YQWZGiz1aVq5Pgr2GrQu,40,59,20,65,0,12,9,2,167,23.857142857142858,5,0.0,33,20,43,0,26,12,22,9,2,96,71,1
2246,26240,2EOw8IdpJR7gJqo77SwHRhwFw89UUu0T,7GRhBDsirIGkRZBtSMEzNTyDr2JQm4xx,1,0,0,0,0,0,1,0,1,0.14285714285714285,1,0.0,0,0,0,0,0,0,0,1,0,0,1,1
2247,26245,SrYdmWsdLgR34Xuoeb5msz3OavGm9rEt,SpATywNh6bZuzm8s1ceuBUnMUAeoAHHw,13,19,10,0,4,0,10,0,43,6.142857142857143,4,0.0,1,10,0,4,18,0,0,10,0,15,28,0
2248,26268,tynbQ4TjTy74SqA5UqLPd55W0CYMmxkv,bWdj2GDclj5ofokWjzoa5jAwMkxCykd6,43,66,35,178,15,42,25,3,364,52.0,6,0.0,17,35,149,15,49,42,29,25,3,216,148,0
2249,26275,PSNpE96w64UzqJ7izDn4zKyoyc3uU8P4,SpATywNh6bZuzm8s1ceuBUnMUAeoAHHw,17,19,11,20,4,7,10,2,73,10.428571428571429,3,0.0,4,11,16,4,15,7,4,10,2,35,38,0
2250,26300,skOScgcMIkYsPXikHjLqvicjdb3rv6St,G8EPVSXsOYB5YQWZGiz1aVq5Pgr2GrQu,15,22,7,33,3,1,11,0,77,11.0,2,0.0,3,7,27,3,19,1,6,11,0,40,37,1
2251,26317,Ke04PwAVtaYumEPrCNIyUmIZgpnMElWJ,SpATywNh6bZuzm8s1ceuBUnMUAeoAHHw,20,41,24,9,9,0,8,0,91,13.0,5,0.0,0,24,8,9,41,0,1,8,0,41,50,1
2252,26327,WXFtCer94iMbYlxH69t15Pw03EngjneX,7GRhBDsirIGkRZBtSMEzNTyDr2JQm4xx,5,3,1,0,0,0,4,0,8,1.1428571428571428,2,0.0,0,1,0,0,3,0,0,4,0,1,7,1
2253,26340,nLSyDmuwtZ9VcSdeL7kW6FG97w0wmm94,SpATywNh6bZuzm8s1ceuBUnMUAeoAHHw,25,42,19,24,9,0,9,0,103,14.714285714285714,5,0.0,13,19,23,9,29,0,1,9,0,64,39,0
2254,26353,EHRxEuwJ6W1Usro8hvBy0CGhrazjH6cO,SpATywNh6bZuzm8s1ceuBUnMUAeoAHHw,11,6,4,0,4,0,2,0,16,2.2857142857142856,1,0.0,0,4,0,4,6,0,0,2,0,8,8,0
2255,26357,BNkiF9A7J88AJfBxuk7BTxSVookFJYSj,SpATywNh6bZuzm8s1ceuBUnMUAeoAHHw,22,39,1,33,0,44,22,3,142,20.285714285714285,4,0.0,7,1,29,0,32,44,4,22,3,37,105,0
2256,26390,4BpRE14XuCFERPNFltqE4ojcMHw6pKyT,SpATywNh6bZuzm8s1ceuBUnMUAeoAHHw,17,21,12,10,6,0,3,0,52,7.428571428571429,1,0.0,7,12,9,6,14,0,1,3,0,34,18,0
2257,26398,x4ez09GGWUnioTSf6qckx5goNY5giLKq,7GRhBDsirIGkRZBtSMEzNTyDr2JQm4xx,61,136,54,207,26,15,28,1,467,66.71428571428571,7,0.0,64,54,184,26,72,15,23,28,1,328,139,0
2258,26399,Ke04PwAVtaYumEPrCNIyUmIZgpnMElWJ,A3fsA9Zfv1X2fVEQhTw51lKENdNrEqT3,14,10,6,14,3,0,4,0,37,5.285714285714286,3,0.0,1,6,14,3,9,0,0,4,0,24,13,1
2259,26424,jDvQIlE5Sz6V9SpiJ3fC38kGJJ76UIjp,7GRhBDsirIGkRZBtSMEzNTyDr2JQm4xx,8,3,1,0,1,1,8,0,14,2.0,1,0.0,0,1,0,1,3,1,0,8,0,2,12,1
2260,26430,LqtuGUVCKWBEA86X4uy5b4ZjnXPoVVJt,SpATywNh6bZuzm8s1ceuBUnMUAeoAHHw,22,30,2,31,1,4,5,0,73,10.428571428571429,3,0.0,12,2,27,1,18,4,4,5,0,42,31,0
2261,26436,J7iejq5NtsfdHjPTK3MrPhGPRoJN9WrB,A3fsA9Zfv1X2fVEQhTw51lKENdNrEqT3,56,34,24,84,15,2,16,1,176,25.142857142857142,3,0.0,3,24,81,15,31,2,3,16,1,123,53,0
2262,26453,qIRkU6GTErqHGiePGqqQmQyg81Pc8mmk,SpATywNh6bZuzm8s1ceuBUnMUAeoAHHw,27,22,17,10,10,14,8,1,82,11.714285714285714,2,0.0,0,17,9,10,22,14,1,8,1,36,46,1
2263,26460,oNf6qoW6E6dhoPJKSUjvElFlUKN9drLY,SpATywNh6bZuzm8s1ceuBUnMUAeoAHHw,27,48,23,12,14,1,9,0,107,15.285714285714286,3,0.0,20,23,12,14,28,1,0,9,0,69,38,0
2264,26464,xioMf6frC9P8sc1cIrYLanKwZwDuxRiz,G8EPVSXsOYB5YQWZGiz1aVq5Pgr2GrQu,124,103,32,369,26,4,26,2,562,80.28571428571429,6,0.0,70,32,279,26,33,4,90,26,2,407,155,0
2265,26489,PD0QXI0Ip2PVwJ6kJaKkkINkj7BvGZMC,SpATywNh6bZuzm8s1ceuBUnMUAeoAHHw,18,34,0,27,0,0,8,0,69,9.857142857142858,2,0.0,10,0,23,0,24,0,4,8,0,33,36,0
2266,26497,lHqsd1041AF6CV0C0CnR0FxJTQGWXgTK,SpATywNh6bZuzm8s1ceuBUnMUAeoAHHw,16,19,1,17,2,27,5,0,71,10.142857142857142,3,0.0,6,1,15,2,13,27,2,5,0,24,47,1
2267,26500,0jMOLkd6bX5LTqVnq5W50RF0alCjmWfd,SpATywNh6bZuzm8s1ceuBUnMUAeoAHHw,12,15,1,12,0,0,3,0,31,4.428571428571429,2,0.0,6,1,11,0,9,0,1,3,0,18,13,0
2268,26514,IJmtizRHLdF3WotHNxwRcdFjzienWtJz,bWdj2GDclj5ofokWjzoa5jAwMkxCykd6,10,18,11,8,3,0,8,0,48,6.857142857142857,3,0.0,2,11,8,3,16,0,0,8,0,24,24,1
2269,26528,CiVcRubRqdt8MrzyUg75lzZmUZcaVQVo,SpATywNh6bZuzm8s1ceuBUnMUAeoAHHw,17,22,13,14,4,0,5,0,58,8.285714285714286,3,0.0,5,13,12,4,17,0,2,5,0,34,24,0
2270,26561,kg6Avyi36lrn1xiUPv7mqR2okQaeNtUx,7GRhBDsirIGkRZBtSMEzNTyDr2JQm4xx,5,5,4,0,3,0,1,0,13,1.8571428571428572,1,0.0,0,4,0,3,5,0,0,1,0,7,6,1
2271,26572,h5vEAVTb94xGNGjpn4Ohi5mNcXfM0rMl,SpATywNh6bZuzm8s1ceuBUnMUAeoAHHw,9,16,4,0,3,0,8,0,31,4.428571428571429,2,0.0,0,4,0,3,16,0,0,8,0,7,24,0
2272,26574,kSTg1JLYdhltSJsPuKhUcTkKXIqnVUW2,SpATywNh6bZuzm8s1ceuBUnMUAeoAHHw,25,72,3,23,1,15,24,2,140,20.0,4,0.0,6,3,21,1,66,15,2,24,2,31,109,1
2273,26590,5pjAdY5K4FfgQPLSzQKwXaKF78ph9a0y,bWdj2GDclj5ofokWjzoa5jAwMkxCykd6,15,19,8,32,4,0,10,1,74,10.571428571428571,3,0.0,4,8,29,4,15,0,3,10,1,45,29,0
2274,26610,xzPjA6KrslcE6S6chFTjdwgsvoAelzjQ,G8EPVSXsOYB5YQWZGiz1aVq5Pgr2GrQu,100,95,28,182,17,3,20,1,346,49.42857142857143,7,0.0,56,28,120,17,39,3,62,20,1,221,125,0
2275,26624,bwFkbWIAdNVUMLQhE1w1MjvyFVabaAgW,SpATywNh6bZuzm8s1ceuBUnMUAeoAHHw,23,29,14,20,7,1,13,1,85,12.142857142857142,6,0.0,7,14,16,7,22,1,4,13,1,44,41,0
2276,26634,rrQbAPV4QBpP2BW10bzZtz96beXLch00,SpATywNh6bZuzm8s1ceuBUnMUAeoAHHw,25,32,22,14,16,17,10,0,111,15.857142857142858,4,0.0,6,22,13,16,26,17,1,10,0,57,54,1
2277,26640,RbUxQb46RHLKt8MRdcRI6KFNQeGEWd4E,7GRhBDsirIGkRZBtSMEzNTyDr2JQm4xx,52,139,57,54,24,23,28,3,328,46.857142857142854,10,0.0,67,57,47,24,72,23,7,28,3,195,133,1
2278,26655,hkI32MAgHvJ4T3I3Up79daEJ8l4sKHaC,7GRhBDsirIGkRZBtSMEzNTyDr2JQm4xx,7,4,2,2,2,0,1,0,11,1.5714285714285714,1,0.0,1,2,2,2,3,0,0,1,0,7,4,1
2279,26657,KPcfuz5VL4gtxrf9oXg3NuCUgo5lfp0J,7GRhBDsirIGkRZBtSMEzNTyDr2JQm4xx,16,26,3,19,0,1,9,1,59,8.428571428571429,3,0.0,8,3,18,0,18,1,1,9,1,29,30,1
2280,26672,XN0YlXkOOCzzQkjkPHbmHYzBt2kMHbPM,G8EPVSXsOYB5YQWZGiz1aVq5Pgr2GrQu,23,47,3,10,3,0,10,0,73,10.428571428571429,3,0.0,6,3,6,3,41,0,4,10,0,18,55,0
2281,26693,HAPPxnLUjIhcauBZnnWBFk3JE6gETTxa,A3fsA9Zfv1X2fVEQhTw51lKENdNrEqT3,20,17,12,0,11,0,2,0,42,6.0,1,0.0,4,12,0,11,13,0,0,2,0,27,15,1
2282,26720,DsLjooCLnfZ8B5pzT2arifZ6SOAto1Wc,SpATywNh6bZuzm8s1ceuBUnMUAeoAHHw,8,4,2,0,2,0,3,1,12,1.7142857142857142,1,0.0,0,2,0,2,4,0,0,3,1,4,8,1
2283,26750,7J9JIWVCQG1g6yXh3uTVbrSu3pa18Ezn,A3fsA9Zfv1X2fVEQhTw51lKENdNrEqT3,14,8,6,0,4,3,7,0,28,4.0,1,0.0,0,6,0,4,8,3,0,7,0,10,18,1
2284,26754,GLksmLIo4jY0swb77XkCz4Oz6WJw9kTq,bWdj2GDclj5ofokWjzoa5jAwMkxCykd6,8,6,2,42,3,0,1,0,54,7.714285714285714,1,0.0,3,2,40,3,3,0,2,1,0,48,6,1
2285,26763,6gAyvwJKSeHOrljTS7vTc1U71cPBh7nb,RXDvfPUBYFlVdlueBFbLW0mhhAyGEqpt,61,87,12,116,7,0,9,0,231,33.0,5,0.0,18,12,107,7,69,0,9,9,0,144,87,0
2286,26770,H7bZ54NuzkB5Nw5q0ZI1nld9qDoHNngL,7GRhBDsirIGkRZBtSMEzNTyDr2JQm4xx,4,2,1,0,0,0,3,0,6,0.8571428571428571,2,0.0,0,1,0,0,2,0,0,3,0,1,5,1
2287,26774,HQOz3dJ2hZ8qbl5l8pp7OKuPIeM9Xh55,G8EPVSXsOYB5YQWZGiz1aVq5Pgr2GrQu,32,50,25,56,10,4,7,3,155,22.142857142857142,1,0.0,19,25,43,10,31,4,13,7,3,97,58,0
2288,26801,q2xQCstASp96wpspi8iqsuaqJ7gzfsux,SpATywNh6bZuzm8s1ceuBUnMUAeoAHHw,19,27,14,24,0,0,7,0,72,10.285714285714286,5,0.0,6,14,19,0,21,0,5,7,0,39,33,0
2289,26811,S4x7F2zwGMymIPjPy7YGoWTUwlKzmNvg,SpATywNh6bZuzm8s1ceuBUnMUAeoAHHw,1,0,0,0,0,0,1,0,1,0.14285714285714285,1,0.0,0,0,0,0,0,0,0,1,0,0,1,0
2290,26812,8b4CSrjMjmc5Jmqnv833uCnAad4TIcFZ,A3fsA9Zfv1X2fVEQhTw51lKENdNrEqT3,39,16,14,92,13,3,6,0,144,20.571428571428573,2,0.0,1,14,78,13,15,3,14,6,0,106,38,0
2291,26816,HCwyZ32TalGxA6ZNHNOB04su4fWSeWBj,A3fsA9Zfv1X2fVEQhTw51lKENdNrEqT3,19,17,10,0,6,2,10,1,46,6.571428571428571,4,0.0,0,10,0,6,17,2,0,10,1,16,30,0
2292,26823,oidXTGaCUuuF1QPNvhmiPoqhWsTY245r,7GRhBDsirIGkRZBtSMEzNTyDr2JQm4xx,19,21,12,0,7,0,4,0,44,6.285714285714286,4,0.0,3,12,0,7,18,0,0,4,0,22,22,1
2293,26863,erDgXJOtYMWq3DbmDGyxl8sIhvZ9oKFE,SpATywNh6bZuzm8s1ceuBUnMUAeoAHHw,27,51,15,37,8,7,13,1,132,18.857142857142858,5,0.0,8,15,31,8,43,7,6,13,1,62,70,0
2294,26877,nE23LYiQpabdXkj6YvKSja9sZnHRizmo,bWdj2GDclj5ofokWjzoa5jAwMkxCykd6,7,21,3,0,0,10,8,0,42,6.0,9,0.0,0,3,0,0,21,10,0,8,0,3,39,0
2295,26902,wlMzjZIA65JiQ9JE1VQhTzG17NZZPeo3,SpATywNh6bZuzm8s1ceuBUnMUAeoAHHw,30,152,31,54,8,58,63,2,368,52.57142857142857,16,0.0,40,31,44,8,112,58,10,63,2,123,245,0
2296,26903,1YVr5Tebgu8QXWBg3164QQg1YdmUcYYo,7GRhBDsirIGkRZBtSMEzNTyDr2JQm4xx,6,12,3,0,1,2,7,0,25,3.5714285714285716,2,0.0,0,3,0,1,12,2,0,7,0,4,21,1
2297,26907,sTDzO3bjgLIIYNoWgHN2HiaPZw68DTyo,7GRhBDsirIGkRZBtSMEzNTyDr2JQm4xx,8,12,5,0,3,1,7,1,29,4.142857142857143,5,0.0,0,5,0,3,12,1,0,7,1,8,21,0
2298,26928,0eeJP6MiDq1cOnP8cGxNMZEXCvgY0tHY,SpATywNh6bZuzm8s1ceuBUnMUAeoAHHw,16,32,14,18,3,1,3,0,71,10.142857142857142,3,0.0,13,14,15,3,19,1,3,3,0,45,26,0
2299,26931,luNGlNTmJ26UVXohAPNf4yZNgIUDcpxK,SpATywNh6bZuzm8s1ceuBUnMUAeoAHHw,21,26,16,2,7,0,11,0,62,8.857142857142858,9,0.0,1,16,2,7,25,0,0,11,0,26,36,0
2300,26940,EQUZwbG72sVIvQVavXNV7pB9UhkYp9aI,SpATywNh6bZuzm8s1ceuBUnMUAeoAHHw,32,42,19,30,8,72,11,2,184,26.285714285714285,2,0.0,15,19,26,8,27,72,4,11,2,68,116,0
2301,26955,V44Q36yyz0HxZhlrCwrLJjYwv8UzqoCn,A3fsA9Zfv1X2fVEQhTw51lKENdNrEqT3,12,20,9,0,2,0,5,0,36,5.142857142857143,4,0.0,0,9,0,2,20,0,0,5,0,11,25,1
2302,26967,GXmApUIE1IechykqO3xyhcbVn1kfVOsr,SpATywNh6bZuzm8s1ceuBUnMUAeoAHHw,1,0,0,0,0,0,1,0,1,0.14285714285714285,1,0.0,0,0,0,0,0,0,0,1,0,0,1,0
2303,27019,CIg0k418cM4NKEJ0IrZ66fdZQiBikcx7,G8EPVSXsOYB5YQWZGiz1aVq5Pgr2GrQu,7,7,0,0,0,3,5,0,15,2.142857142857143,1,0.0,0,0,0,0,7,3,0,5,0,0,15,0
2304,27085,Y1uVq657IWCue4abNsh62IVHKtmwsQHQ,SpATywNh6bZuzm8s1ceuBUnMUAeoAHHw,23,30,18,12,9,3,13,2,87,12.428571428571429,3,0.0,6,18,12,9,24,3,0,13,2,45,42,0
2305,27087,1sf1a7OMEvwky5hvLFD12TaOsmoNw2Qb,G8EPVSXsOYB5YQWZGiz1aVq5Pgr2GrQu,47,72,36,176,14,0,13,0,311,44.42857142857143,6,0.0,9,36,148,14,63,0,28,13,0,207,104,0
2306,27114,aI6LGLI5TSvCsqcL1v38BDwXz2AdVe9U,7GRhBDsirIGkRZBtSMEzNTyDr2JQm4xx,1,0,0,0,0,0,1,0,1,0.14285714285714285,1,0.0,0,0,0,0,0,0,0,1,0,0,1,1
2307,27140,9zKzyrDc2ZLmZJn8iNzeeCTIcbRbidfo,A3fsA9Zfv1X2fVEQhTw51lKENdNrEqT3,31,15,8,48,1,14,16,1,103,14.714285714285714,2,0.0,1,8,44,1,14,14,4,16,1,54,49,0
2308,27145,5pjAdY5K4FfgQPLSzQKwXaKF78ph9a0y,A3fsA9Zfv1X2fVEQhTw51lKENdNrEqT3,30,25,18,6,11,1,14,0,75,10.714285714285714,5,0.0,2,18,6,11,23,1,0,14,0,37,38,0
2309,27154,zi3yOAhUK1J3AbYoEq9VqjXWOhiWlKvY,SpATywNh6bZuzm8s1ceuBUnMUAeoAHHw,27,88,4,33,3,66,16,1,211,30.142857142857142,7,0.0,32,4,28,3,56,66,5,16,1,67,144,0
2310,27171,EUmZ5qzjwgko2PIWEnctkvYh7APnUrX9,G8EPVSXsOYB5YQWZGiz1aVq5Pgr2GrQu,5,2,1,0,1,0,3,0,7,1.0,2,0.0,0,1,0,1,2,0,0,3,0,2,5,1
2311,27206,5pjAdY5K4FfgQPLSzQKwXaKF78ph9a0y,7GRhBDsirIGkRZBtSMEzNTyDr2JQm4xx,7,20,6,0,1,0,6,0,33,4.714285714285714,4,0.0,8,6,0,1,12,0,0,6,0,15,18,0
2312,27209,147kfUKOVzUnQEgEhu4oFkvvuFRbAg9Y,bWdj2GDclj5ofokWjzoa5jAwMkxCykd6,11,15,9,0,6,8,6,1,45,6.428571428571429,4,0.0,0,9,0,6,15,8,0,6,1,15,30,1
2313,27213,S0nQm2eOAlSxKM1RfeGoUgB4GQEZsJ1U,SpATywNh6bZuzm8s1ceuBUnMUAeoAHHw,29,57,21,30,12,21,33,11,185,26.428571428571427,3,0.0,16,21,28,12,41,21,2,33,11,77,108,0
2314,27220,SqRpmgv1gGFKN06wuAdrCbdyqbZyrZkj,bWdj2GDclj5ofokWjzoa5jAwMkxCykd6,5,4,1,0,0,0,3,0,8,1.1428571428571428,1,0.0,0,1,0,0,4,0,0,3,0,1,7,1
2315,27229,vvW1UkV9WqtfmPMhz7QIGvDdFqIvY2j3,7GRhBDsirIGkRZBtSMEzNTyDr2JQm4xx,1,0,0,0,0,0,1,0,1,0.14285714285714285,1,0.0,0,0,0,0,0,0,0,1,0,0,1,1
2316,27230,uciz4weP1kSziQB1Oe1Psu4CdK1uNqzl,SpATywNh6bZuzm8s1ceuBUnMUAeoAHHw,16,32,15,19,4,21,10,2,103,14.714285714285714,2,0.0,11,15,16,4,21,21,3,10,2,46,57,0
2317,27245,L6Tc39ltUCigrI45L69IfmvrMsjwxFPz,RXDvfPUBYFlVdlueBFbLW0mhhAyGEqpt,21,16,8,51,9,41,8,0,133,19.0,2,0.0,6,8,46,9,10,41,5,8,0,69,64,0
2318,27257,ilQqtG05VEreri5rVwRPOodDRvBSi2Yp,7GRhBDsirIGkRZBtSMEzNTyDr2JQm4xx,6,9,0,2,0,0,2,0,13,1.8571428571428572,1,0.0,1,0,2,0,8,0,0,2,0,3,10,1
2319,27261,xk5bwSTEAMNKyEU3iNkOO0oTip8zPc6K,7GRhBDsirIGkRZBtSMEzNTyDr2JQm4xx,3,0,0,0,0,3,3,0,6,0.8571428571428571,1,0.0,0,0,0,0,0,3,0,3,0,0,6,1
2320,27263,X5ugOWLhdmTxo3CYqfXWDVoDsvjcSnkc,SpATywNh6bZuzm8s1ceuBUnMUAeoAHHw,23,46,20,28,5,7,22,2,130,18.571428571428573,8,0.0,13,20,24,5,33,7,4,22,2,62,68,0
2321,27277,DTD40RjYwLBuwaHKa3c3iphTurXVm83S,7GRhBDsirIGkRZBtSMEzNTyDr2JQm4xx,2,0,0,0,0,0,3,0,3,0.42857142857142855,1,0.0,0,0,0,0,0,0,0,3,0,0,3,1
2322,27284,0vYe49xmwT3tPlTtY6ubPLznONbIxbXe,7GRhBDsirIGkRZBtSMEzNTyDr2JQm4xx,5,6,2,0,0,0,5,0,13,1.8571428571428572,1,0.0,0,2,0,0,6,0,0,5,0,2,11,1
2323,27306,tTMyaWTlizKdT72ief23Wjd2wqSzEHSk,bWdj2GDclj5ofokWjzoa5jAwMkxCykd6,11,14,7,0,5,0,6,0,32,4.571428571428571,2,0.0,0,7,0,5,14,0,0,6,0,12,20,0
2324,27313,rUrD3vOZKxi004QKs8MuR2Ws6PqRB5Bd,SpATywNh6bZuzm8s1ceuBUnMUAeoAHHw,12,14,6,18,3,0,1,0,42,6.0,1,0.0,7,6,16,3,7,0,2,1,0,32,10,1
2325,27318,qOCeRyabO4TOWDJBtcnFq6ksxPSapJ0M,7GRhBDsirIGkRZBtSMEzNTyDr2JQm4xx,6,6,1,0,1,0,2,0,10,1.4285714285714286,1,0.0,0,1,0,1,6,0,0,2,0,2,8,1
2326,27327,JiMk3YzOg8oAYgApOK7xg1JGgnoRvDfl,SpATywNh6bZuzm8s1ceuBUnMUAeoAHHw,21,23,8,15,5,3,7,3,64,9.142857142857142,1,0.0,14,8,12,5,9,3,3,7,3,39,25,0
2327,27386,jQaCxlcrIW3B0ti76HtzjtRZOLJHPbzy,RXDvfPUBYFlVdlueBFbLW0mhhAyGEqpt,26,65,37,0,3,178,36,17,336,48.0,9,0.0,0,37,0,3,65,178,0,36,17,40,296,0
2328,27387,FFlICu8a1PeaY8oKBFESJAT3q6I5h6Xu,SpATywNh6bZuzm8s1ceuBUnMUAeoAHHw,20,39,19,10,5,4,9,0,86,12.285714285714286,6,0.0,8,19,9,5,31,4,1,9,0,41,45,0
2329,27397,bdtPawZirEzy4zJwBHLye0XuKdBDsRNa,7GRhBDsirIGkRZBtSMEzNTyDr2JQm4xx,1,0,0,0,0,0,1,0,1,0.14285714285714285,1,0.0,0,0,0,0,0,0,0,1,0,0,1,1
2330,27401,BvCRPlMfMau2kDEBEjyV1l6RJMQy5B5l,7GRhBDsirIGkRZBtSMEzNTyDr2JQm4xx,17,33,12,42,0,0,6,0,93,13.285714285714286,2,0.0,10,12,34,0,23,0,8,6,0,56,37,1
2331,27402,GDOD5H0bl28RO8whBIu6B8qS2nGsRznY,A3fsA9Zfv1X2fVEQhTw51lKENdNrEqT3,4,2,1,0,1,0,2,0,6,0.8571428571428571,2,0.0,0,1,0,1,2,0,0,2,0,2,4,1
2332,27412,JKpUdoayexmnBaGuLjDe4nN4yf5KTJWi,SpATywNh6bZuzm8s1ceuBUnMUAeoAHHw,8,7,4,0,3,0,3,0,17,2.4285714285714284,1,0.0,0,4,0,3,7,0,0,3,0,7,10,0
2333,27418,46ijefZyx5KF4YGCmdayIapXrAG6omzt,SpATywNh6bZuzm8s1ceuBUnMUAeoAHHw,13,10,4,16,0,0,3,0,33,4.714285714285714,4,0.0,4,4,15,0,6,0,1,3,0,23,10,0
2334,27441,xaMkz5ExnwaMxZxilE1ZpVj0K68325xB,7GRhBDsirIGkRZBtSMEzNTyDr2JQm4xx,31,63,22,42,12,0,6,0,145,20.714285714285715,2,0.0,18,22,36,12,45,0,6,6,0,88,57,1
2335,27445,M5fmtGmpo2DUfH2kBcBzBwkDFjGnGDqf,7GRhBDsirIGkRZBtSMEzNTyDr2JQm4xx,13,24,1,2,0,17,6,0,50,7.142857142857143,2,0.0,3,1,1,0,21,17,1,6,0,5,45,1
2336,27448,h5vEAVTb94xGNGjpn4Ohi5mNcXfM0rMl,7GRhBDsirIGkRZBtSMEzNTyDr2JQm4xx,20,51,6,3,7,0,10,0,77,11.0,4,0.0,15,6,3,7,36,0,0,10,0,31,46,1
2337,27464,XLmXRx6QIJBEWZLK5otMq8wfQNXonT4D,SpATywNh6bZuzm8s1ceuBUnMUAeoAHHw,12,17,6,4,4,0,1,0,32,4.571428571428571,4,0.0,2,6,4,4,15,0,0,1,0,16,16,0
2338,27466,rQQvHNajcjjfIyLOReFtjaD8d9v2FigP,7GRhBDsirIGkRZBtSMEzNTyDr2JQm4xx,3,0,0,0,0,0,5,0,5,0.7142857142857143,1,0.0,0,0,0,0,0,0,0,5,0,0,5,1
2339,27473,xYJiCXQflcZ5NTqhkCBqQygWsRlPt9ao,7GRhBDsirIGkRZBtSMEzNTyDr2JQm4xx,4,4,2,0,0,42,2,0,50,7.142857142857143,2,0.0,1,2,0,0,3,42,0,2,0,3,47,1
2340,27475,mEMC3mPRFcLDpf0MVM7Pji9FNHa590x9,SpATywNh6bZuzm8s1ceuBUnMUAeoAHHw,20,44,20,25,0,9,10,0,108,15.428571428571429,3,0.0,18,20,19,0,26,9,6,10,0,57,51,1
2341,27477,pz4WzmrapGULqEk99lfOZVzJbwiC2Cl1,SpATywNh6bZuzm8s1ceuBUnMUAeoAHHw,13,15,0,12,0,8,6,0,41,5.857142857142857,3,0.0,4,0,12,0,11,8,0,6,0,16,25,0
2342,27478,dgp1qm7PjXoVV4MjyzuvWetQrJ3T9kos,7GRhBDsirIGkRZBtSMEzNTyDr2JQm4xx,53,167,78,56,57,72,35,6,471,67.28571428571429,6,0.0,73,78,53,57,94,72,3,35,6,261,210,1
2343,27491,9Nmjm4BvnbKTQ3ZZwECYdKy9zBNGmQNW,7GRhBDsirIGkRZBtSMEzNTyDr2JQm4xx,1,0,0,0,0,0,1,0,1,0.14285714285714285,1,0.0,0,0,0,0,0,0,0,1,0,0,1,1
2344,27517,9CBq37ANJ7gzpAJJLjvNc0D6JKL0q7QE,SpATywNh6bZuzm8s1ceuBUnMUAeoAHHw,28,31,16,32,10,7,3,0,99,14.142857142857142,1,0.0,13,16,31,10,18,7,1,3,0,70,29,1
2345,27523,8ga3z0NKN1WQ3YzAZr5NtUzbD9BjtY0C,G8EPVSXsOYB5YQWZGiz1aVq5Pgr2GrQu,28,32,15,38,5,0,17,0,107,15.285714285714286,5,0.0,10,15,27,5,22,0,11,17,0,57,50,0
2346,27541,4LLdV2zTWS697dAsOgAPJZPFwfNnrjt6,A3fsA9Zfv1X2fVEQhTw51lKENdNrEqT3,31,19,13,60,4,0,5,0,101,14.428571428571429,4,0.0,1,13,51,4,18,0,9,5,0,69,32,1
2347,27548,azOWgfyXQBkztOqJ4AAsFqAk137ZwNDW,SpATywNh6bZuzm8s1ceuBUnMUAeoAHHw,20,33,23,18,0,6,15,1,96,13.714285714285714,3,0.0,2,23,14,0,31,6,4,15,1,39,57,0
2348,30652,c0SE05tRjiEOaThvWcYxSYbAxboLNaZo,7GRhBDsirIGkRZBtSMEzNTyDr2JQm4xx,26,48,2,40,9,7,31,2,139,19.857142857142858,4,0.0,26,2,35,9,22,7,5,31,2,72,67,0
2349,30661,Da2YYkrh9YuRinihWxRQSQhXAdFeKqSb,7GRhBDsirIGkRZBtSMEzNTyDr2JQm4xx,10,7,3,8,4,0,2,0,24,3.4285714285714284,1,0.0,3,3,6,4,4,0,2,2,0,16,8,0
2350,30662,4Y6ySID5iQf80xGHEGKPq13tPSHHOAOF,7GRhBDsirIGkRZBtSMEzNTyDr2JQm4xx,68,164,49,110,24,4,13,0,364,52.0,7,0.0,41,49,86,24,123,4,24,13,0,200,164,0
2351,30690,AcpmcKbkGL0wHG2z3MmcGuG9z6KsBEJe,7GRhBDsirIGkRZBtSMEzNTyDr2JQm4xx,44,85,41,56,20,8,16,0,226,32.285714285714285,10,0.0,31,41,46,20,54,8,10,16,0,138,88,0
2352,30695,uqA5Smdw6BACOcL0f2tmxwTTxZXBpZpE,7GRhBDsirIGkRZBtSMEzNTyDr2JQm4xx,20,27,8,12,9,6,1,0,63,9.0,1,0.0,15,8,7,9,12,6,5,1,0,39,24,1
2353,30717,Upqz62cwWKexlUMk4uvP9aosOnbcADgX,7GRhBDsirIGkRZBtSMEzNTyDr2JQm4xx,72,116,32,132,17,2,25,0,324,46.285714285714285,7,0.0,54,32,120,17,62,2,12,25,0,223,101,0
2354,30722,N0Sos51WanCzoSGKDmMPzQtMlLxY3bFb,7GRhBDsirIGkRZBtSMEzNTyDr2JQm4xx,98,263,110,153,63,65,76,3,733,104.71428571428571,10,0.0,111,110,134,63,152,65,19,76,3,418,315,0
2355,30724,Cdp3gxqrAuRwjOLmDu9YrutxbWvuOM9e,7GRhBDsirIGkRZBtSMEzNTyDr2JQm4xx,1,0,0,0,0,0,1,0,1,0.14285714285714285,1,0.0,0,0,0,0,0,0,0,1,0,0,1,0
2356,30730,NoqigwhYAB9TtnANg1WMYh4zsRGoOl0D,7GRhBDsirIGkRZBtSMEzNTyDr2JQm4xx,69,89,51,61,34,0,21,0,256,36.57142857142857,4,0.0,30,51,46,34,59,0,15,21,0,161,95,0
2357,30733,9GVWhCbqivE4bnCr9NW81pWzAvrdhoCR,7GRhBDsirIGkRZBtSMEzNTyDr2JQm4xx,2,0,0,0,0,0,2,0,2,0.2857142857142857,1,0.0,0,0,0,0,0,0,0,2,0,0,2,1
2358,30742,m7YQyhtMcEUVm4YEl0ls7E37ljO7KzRy,7GRhBDsirIGkRZBtSMEzNTyDr2JQm4xx,57,208,77,98,21,41,21,0,466,66.57142857142857,10,0.0,95,77,89,21,113,41,9,21,0,282,184,0
2359,30747,tLopTDeUShprCRgfwS3p7Zbir4u3Yxe8,7GRhBDsirIGkRZBtSMEzNTyDr2JQm4xx,17,20,12,6,9,0,2,0,49,7.0,2,0.0,5,12,5,9,15,0,1,2,0,31,18,1
2360,30750,yk7hISr9k5KlTllac6P28wE1wuN0cd27,7GRhBDsirIGkRZBtSMEzNTyDr2JQm4xx,72,190,16,202,45,30,22,1,506,72.28571428571429,6,0.0,129,16,175,45,61,30,27,22,1,365,141,0
2361,30756,5He5r20lSAk84shJAoxdWcVq0zVfBWNL,7GRhBDsirIGkRZBtSMEzNTyDr2JQm4xx,54,110,41,135,8,67,14,0,375,53.57142857142857,3,0.0,35,41,114,8,75,67,21,14,0,198,177,0
2362,30776,YtymNq1ebo5JQ6VlWg3H52cMIU1je3tP,SpATywNh6bZuzm8s1ceuBUnMUAeoAHHw,17,22,12,16,7,3,4,0,64,9.142857142857142,3,0.0,6,12,14,7,16,3,2,4,0,39,25,0
2363,30784,SmONSyS4YgG4Afnv6ZxU81t7p4CQPV5P,SpATywNh6bZuzm8s1ceuBUnMUAeoAHHw,24,41,3,23,1,2,6,3,79,11.285714285714286,1,0.0,13,3,20,1,28,2,3,6,3,37,42,1
2364,30797,S0OJjF6aof0iTnIX6lUAxekoH3m4w7V0,bWdj2GDclj5ofokWjzoa5jAwMkxCykd6,53,70,36,92,11,57,23,1,290,41.42857142857143,7,0.0,12,36,85,11,58,57,7,23,1,144,146,0
2365,30824,VpttOLX6WfGZBZLZt8acfk7430VwqHRi,RXDvfPUBYFlVdlueBFbLW0mhhAyGEqpt,65,115,37,210,19,38,21,1,441,63.0,4,0.0,26,37,195,19,89,38,15,21,1,277,164,1
2366,30830,Uj0YzcfvBcWRuM5ooqhtOKSU0RtOgHEO,SpATywNh6bZuzm8s1ceuBUnMUAeoAHHw,24,16,13,10,7,0,4,0,50,7.142857142857143,3,0.0,1,13,9,7,15,0,1,4,0,30,20,0
2367,30842,aacyvESmAfP5D5oPQjdLdL2QR8GRVLet,SpATywNh6bZuzm8s1ceuBUnMUAeoAHHw,29,71,37,22,21,49,14,1,215,30.714285714285715,3,0.0,15,37,19,21,56,49,3,14,1,92,123,0
2368,30844,BzAEXi273boWm5fg8ZX5MfzoC5AJdE3M,SpATywNh6bZuzm8s1ceuBUnMUAeoAHHw,28,28,19,23,10,2,11,0,93,13.285714285714286,3,0.0,4,19,21,10,24,2,2,11,0,54,39,1
2369,30851,dEqFTu442IbDfPtop0GcM4lzz1lxVMo1,7GRhBDsirIGkRZBtSMEzNTyDr2JQm4xx,45,143,51,93,19,2,7,0,315,45.0,12,0.0,40,51,80,19,103,2,13,7,0,190,125,0
2370,30861,Ip3irZsxFvOeGg8WSppVhJArbPhoH3qm,SpATywNh6bZuzm8s1ceuBUnMUAeoAHHw,30,66,25,38,9,10,22,3,173,24.714285714285715,4,0.0,25,25,33,9,41,10,5,22,3,92,81,0
2371,30870,GpbDOMkrqaLXOPkd8jI4TxThJAZPGWSK,SpATywNh6bZuzm8s1ceuBUnMUAeoAHHw,17,31,13,19,6,17,10,1,97,13.857142857142858,4,0.0,8,13,16,6,23,17,3,10,1,43,54,0
2372,30871,3IgwuZBiVdgdYRQ9ySaEvpMizbjCJFS0,7GRhBDsirIGkRZBtSMEzNTyDr2JQm4xx,62,132,40,110,30,64,19,0,395,56.42857142857143,6,0.0,66,40,86,30,66,64,24,19,0,222,173,1
2373,30887,1NNWgXZojZkqAeoQhcUz4Xc8qgLXmALC,SpATywNh6bZuzm8s1ceuBUnMUAeoAHHw,30,166,89,22,59,16,7,0,359,51.285714285714285,14,0.0,42,89,22,59,124,16,0,7,0,212,147,0
2374,30889,9MbsP03nqyzNF8ytIM40Tx9W50TUxwHO,SpATywNh6bZuzm8s1ceuBUnMUAeoAHHw,18,75,3,9,1,0,21,0,109,15.571428571428571,8,0.0,2,3,9,1,73,0,0,21,0,15,94,0
2375,30905,5GkxvaD11peDsZoT8jF1pQZKBzcvYxOV,G8EPVSXsOYB5YQWZGiz1aVq5Pgr2GrQu,28,40,15,50,1,9,23,2,140,20.0,7,0.0,18,15,37,1,22,9,13,23,2,71,69,0
2376,30907,LKEJY5MvP0gj7M4NL5iRnXDBazXBKsOA,SpATywNh6bZuzm8s1ceuBUnMUAeoAHHw,30,164,69,22,13,122,74,9,473,67.57142857142857,11,0.0,38,69,19,13,126,122,3,74,9,139,334,0
2377,30948,CfeENerIdAGepleePWSt0SV88ctt0Tmw,G8EPVSXsOYB5YQWZGiz1aVq5Pgr2GrQu,142,185,68,296,38,0,10,1,598,85.42857142857143,13,0.0,55,68,228,38,130,0,68,10,1,389,209,0
2378,30959,hjUSUM6roI2mLGkMAqBjE0uxFRBSMYHJ,SpATywNh6bZuzm8s1ceuBUnMUAeoAHHw,28,68,45,24,28,9,13,0,187,26.714285714285715,5,0.0,12,45,18,28,56,9,6,13,0,103,84,0
2379,30987,xVvNMYPAdkOMbR8cyTeqVHpVoO8wZQ2b,7GRhBDsirIGkRZBtSMEzNTyDr2JQm4xx,6,9,2,0,1,4,6,0,22,3.142857142857143,2,0.0,1,2,0,1,8,4,0,6,0,4,18,1
2380,31001,oTQ81PqeruuETb6SukxAp0sOazRUpE32,7GRhBDsirIGkRZBtSMEzNTyDr2JQm4xx,30,47,15,48,13,11,6,0,140,20.0,4,0.0,28,15,41,13,19,11,7,6,0,97,43,1
2381,31010,u8YPaORaz1zRBmx3Zp1zm30bQFzwDInM,SpATywNh6bZuzm8s1ceuBUnMUAeoAHHw,30,82,28,50,12,83,27,3,285,40.714285714285715,6,0.0,27,28,43,12,55,83,7,27,3,110,175,0
2382,31012,t069DROGMOy4O12B9Ty0yznUmNUBGFUp,7GRhBDsirIGkRZBtSMEzNTyDr2JQm4xx,4,2,1,0,1,0,1,0,5,0.7142857142857143,1,0.0,0,1,0,1,2,0,0,1,0,2,3,1
2383,31062,CfeENerIdAGepleePWSt0SV88ctt0Tmw,A3fsA9Zfv1X2fVEQhTw51lKENdNrEqT3,8,14,6,0,1,0,5,0,26,3.7142857142857144,5,0.0,0,6,0,1,14,0,0,5,0,7,19,1
2384,31080,6U2xPMo27MRkbrPflG5WrvgHD37CuMpR,7GRhBDsirIGkRZBtSMEzNTyDr2JQm4xx,7,7,3,0,2,0,3,0,15,2.142857142857143,2,0.0,0,3,0,2,7,0,0,3,0,5,10,1
2385,31089,MxVVcAtMSnLQjlvLOx5XySlZblFVugTc,SpATywNh6bZuzm8s1ceuBUnMUAeoAHHw,21,94,1,23,0,0,30,0,148,21.142857142857142,6,0.0,13,1,21,0,81,0,2,30,0,35,113,0
2386,31100,yNeIUKhEuJHTBsPD5kABjlBuASduqZHz,SpATywNh6bZuzm8s1ceuBUnMUAeoAHHw,6,3,2,0,1,0,2,0,8,1.1428571428571428,1,0.0,0,2,0,1,3,0,0,2,0,3,5,1
2387,31137,JP79INNRcQzkUx6dZie4v1QvuMQ7OVUy,RXDvfPUBYFlVdlueBFbLW0mhhAyGEqpt,65,226,4,145,8,34,19,1,437,62.42857142857143,6,0.0,26,4,132,8,200,34,13,19,1,170,267,0
2388,31162,tq5rSafpJQn5saVcMLWCPKYcu2G69rbK,7GRhBDsirIGkRZBtSMEzNTyDr2JQm4xx,9,5,3,0,2,0,7,0,17,2.4285714285714284,1,0.0,0,3,0,2,5,0,0,7,0,5,12,1
2389,31176,In25hAYYA32yjVT3Fete5XUoGWlQgd5t,G8EPVSXsOYB5YQWZGiz1aVq5Pgr2GrQu,46,21,1,90,1,0,4,0,117,16.714285714285715,2,0.0,4,1,85,1,17,0,5,4,0,91,26,0
2390,31187,s6iksgptFmyh2vfiarKdJkiKnp6RLi3f,G8EPVSXsOYB5YQWZGiz1aVq5Pgr2GrQu,10,6,3,0,1,6,6,0,22,3.142857142857143,1,0.0,0,3,0,1,6,6,0,6,0,4,18,0
2391,31214,s6iksgptFmyh2vfiarKdJkiKnp6RLi3f,bWdj2GDclj5ofokWjzoa5jAwMkxCykd6,6,5,1,0,1,6,3,0,16,2.2857142857142856,1,0.0,0,1,0,1,5,6,0,3,0,2,14,0
2392,31215,5Gf23uaI2ID1BMi2tbrzYBqwuoTD7nj1,G8EPVSXsOYB5YQWZGiz1aVq5Pgr2GrQu,81,96,49,98,26,3,22,1,295,42.142857142857146,6,0.0,32,49,92,26,64,3,6,22,1,199,96,0
2393,31216,VvIsuXfKScxQtpB88WTGf8JMf9TTXDon,SpATywNh6bZuzm8s1ceuBUnMUAeoAHHw,4,2,1,0,1,0,1,0,5,0.7142857142857143,1,0.0,0,1,0,1,2,0,0,1,0,2,3,0
2394,31225,FHIf7MUGEVUr0CqbuDIIiBw1QO6ZVxVj,SpATywNh6bZuzm8s1ceuBUnMUAeoAHHw,16,40,0,2,1,24,21,2,90,12.857142857142858,3,0.0,9,0,2,1,31,24,0,21,2,12,78,0
2395,31271,WL2pmxbGb1jmTh21fuUuAtLcak4ndNX3,SpATywNh6bZuzm8s1ceuBUnMUAeoAHHw,13,21,6,18,2,2,3,0,52,7.428571428571429,1,0.0,8,6,15,2,13,2,3,3,0,31,21,1
2396,31282,U04y5vFf0AfyJVGIOJHlryTyRQEOm5pT,SpATywNh6bZuzm8s1ceuBUnMUAeoAHHw,21,26,8,21,3,0,4,0,62,8.857142857142858,3,0.0,5,8,19,3,21,0,2,4,0,35,27,0
2397,31294,wAJGUOfaMNSu8fVs50XbquwP1qlCP18o,7GRhBDsirIGkRZBtSMEzNTyDr2JQm4xx,102,445,134,222,84,177,41,2,1105,157.85714285714286,13,0.0,244,134,161,84,201,177,61,41,2,623,482,0
2398,31314,lk5cMwU2ei6fPMwij7uDCwcTMg6KbTEh,RXDvfPUBYFlVdlueBFbLW0mhhAyGEqpt,26,40,20,0,12,0,7,1,80,11.428571428571429,2,0.0,0,20,0,12,40,0,0,7,1,32,48,0
2399,31315,flpVPPsUWfhNx2m3NGTbdkxp57HITcVF,SpATywNh6bZuzm8s1ceuBUnMUAeoAHHw,32,98,42,38,16,7,33,2,236,33.714285714285715,10,0.0,38,42,30,16,60,7,8,33,2,126,110,0
2400,31322,HgQbl59wfMZ62eOeVscJctviZYi0GAnj,SpATywNh6bZuzm8s1ceuBUnMUAeoAHHw,29,36,19,37,7,13,7,1,120,17.142857142857142,3,0.0,13,19,32,7,23,13,5,7,1,71,49,0
2401,31327,MjVksKClEDbwKLDQ3ID6os0AiFzU5BN2,7GRhBDsirIGkRZBtSMEzNTyDr2JQm4xx,1,0,0,0,0,0,1,0,1,0.14285714285714285,1,0.0,0,0,0,0,0,0,0,1,0,0,1,1
2402,31329,ZuXB7SoEgVCDuS66pcJ2jF54Mdbn2Nuz,SpATywNh6bZuzm8s1ceuBUnMUAeoAHHw,4,5,1,0,0,0,1,0,7,1.0,3,0.0,0,1,0,0,5,0,0,1,0,1,6,0
2403,31335,XqfKw12BYBxvQyUszKCvSmcUn4H9qRJJ,7GRhBDsirIGkRZBtSMEzNTyDr2JQm4xx,19,50,13,40,8,5,13,0,129,18.428571428571427,4,0.0,30,13,33,8,20,5,7,13,0,84,45,1
2404,31349,RAFVAKoL6cQatcQ8rTN5mIwPhy02koDR,A3fsA9Zfv1X2fVEQhTw51lKENdNrEqT3,40,65,33,88,11,12,15,0,224,32.0,7,0.0,4,33,77,11,61,12,11,15,0,125,99,0
2405,31368,q15es4hix4DJR5zOH0N1aGsdTpjonWNC,SpATywNh6bZuzm8s1ceuBUnMUAeoAHHw,28,66,12,32,4,104,41,3,262,37.42857142857143,12,0.0,13,12,28,4,53,104,4,41,3,57,205,0
2406,31414,StcFIgK5T4YiiLiOpPHFjzohTVz9Jaf7,A3fsA9Zfv1X2fVEQhTw51lKENdNrEqT3,43,54,25,74,16,0,4,0,173,24.714285714285715,9,0.0,2,25,56,16,52,0,18,4,0,99,74,0
2407,31419,o7pzdRTO1dnxuhf9kxurH0oMz67aa1kw,SpATywNh6bZuzm8s1ceuBUnMUAeoAHHw,10,8,2,12,0,0,3,0,25,3.5714285714285716,3,0.0,3,2,12,0,5,0,0,3,0,17,8,1
2408,31446,Sg3DXxUJJ7e58r0b7OHd09yiv7acnFU0,SpATywNh6bZuzm8s1ceuBUnMUAeoAHHw,13,23,10,21,7,4,5,0,70,10.0,3,0.0,12,10,18,7,11,4,3,5,0,47,23,0
2409,31452,ouZJjXOMfv0cgbezRQ2yVqJJVKJPFP9g,SpATywNh6bZuzm8s1ceuBUnMUAeoAHHw,9,17,1,0,1,0,3,0,22,3.142857142857143,2,0.0,0,1,0,1,17,0,0,3,0,2,20,1
2410,31455,AX9Hte0A6zp61WUmhFkv1rU3P0cKffFQ,SpATywNh6bZuzm8s1ceuBUnMUAeoAHHw,22,34,7,32,1,0,12,0,86,12.285714285714286,6,0.0,7,7,29,1,27,0,3,12,0,44,42,0
2411,31479,8jqDD2phXiMGQf0XQi1kVRzLj3TILO0y,bWdj2GDclj5ofokWjzoa5jAwMkxCykd6,1,0,0,0,0,0,1,0,1,0.14285714285714285,1,0.0,0,0,0,0,0,0,0,1,0,0,1,1
2412,31486,CTfjOlWW4k8IhTEXOJYJ7bo74K8z07kZ,bWdj2GDclj5ofokWjzoa5jAwMkxCykd6,16,22,8,10,7,1,7,1,56,8.0,1,0.0,4,8,8,7,18,1,2,7,1,27,29,0
2413,31493,iGNqI0WQkdTRPPMB99MG4DRoKjQuEfCJ,SpATywNh6bZuzm8s1ceuBUnMUAeoAHHw,16,25,6,6,3,0,9,0,49,7.0,9,0.0,0,6,5,3,25,0,1,9,0,14,35,0
2414,31509,oyStFfS7Y0XvpvDI8JwDIhnFdZZl3Ixl,SpATywNh6bZuzm8s1ceuBUnMUAeoAHHw,11,11,0,12,0,1,6,0,30,4.285714285714286,2,0.0,6,0,12,0,5,1,0,6,0,18,12,0
2415,31513,XBCkMYdRHaBwbyaKg5wVLPpzX1Jqu9p0,7GRhBDsirIGkRZBtSMEzNTyDr2JQm4xx,8,8,2,0,4,0,2,0,16,2.2857142857142856,1,0.0,4,2,0,4,4,0,0,2,0,10,6,1
2416,31521,SQBW44VzMb5zXQWTfzFzAP2RU7qxP2su,bWdj2GDclj5ofokWjzoa5jAwMkxCykd6,35,74,45,160,22,0,8,0,309,44.142857142857146,8,0.0,13,45,143,22,61,0,17,8,0,223,86,1
2417,31532,oNX40hvUpCseO8BHKhGJvG2jyQpYKQyk,RXDvfPUBYFlVdlueBFbLW0mhhAyGEqpt,65,128,45,124,19,18,34,3,371,53.0,8,0.0,15,45,121,19,113,18,3,34,3,200,171,0
2418,31540,fenn4oQ5cZO7k0rG5qWqM8q00nrCNGWN,G8EPVSXsOYB5YQWZGiz1aVq5Pgr2GrQu,9,10,2,0,2,2,6,0,22,3.142857142857143,1,0.0,0,2,0,2,10,2,0,6,0,4,18,0
2419,31557,H3GbKrAtFVtLEXWNNdFaZDFbuKQIUVPU,SpATywNh6bZuzm8s1ceuBUnMUAeoAHHw,26,55,35,21,13,10,30,0,164,23.428571428571427,12,0.0,6,35,21,13,49,10,0,30,0,75,89,0
2420,31568,c49ANcMlFceMxZBmI2dFNiETx72UlFpt,SpATywNh6bZuzm8s1ceuBUnMUAeoAHHw,27,74,20,39,5,32,38,0,208,29.714285714285715,10,0.0,14,20,34,5,60,32,5,38,0,73,135,0
2421,31575,VYkkz2UClMIV09P0Xfa0EEIHkYXDA8gf,SpATywNh6bZuzm8s1ceuBUnMUAeoAHHw,15,33,2,25,2,34,6,1,103,14.714285714285714,2,0.0,13,2,21,2,20,34,4,6,1,38,65,1
2422,31616,fvZ0NGV51VzyC0WSd0PRSRn84KNPjRPi,SpATywNh6bZuzm8s1ceuBUnMUAeoAHHw,18,19,0,8,0,5,6,0,38,5.428571428571429,1,0.0,0,0,8,0,19,5,0,6,0,8,30,0
2423,31630,uqaaAh63woEl1GEmEsDUSC0vwOZYZP0g,G8EPVSXsOYB5YQWZGiz1aVq5Pgr2GrQu,9,7,3,8,3,0,1,0,22,3.142857142857143,1,0.0,3,3,7,3,4,0,1,1,0,16,6,1
2424,31631,OcchkIht8b8QIrrapp5dUsDP9GE3Vfdw,SpATywNh6bZuzm8s1ceuBUnMUAeoAHHw,2,0,0,0,0,0,2,0,2,0.2857142857142857,1,0.0,0,0,0,0,0,0,0,2,0,0,2,0
2425,31636,8V9pnrkvwK33pI3AiYSlsgxV7TeKgfNZ,G8EPVSXsOYB5YQWZGiz1aVq5Pgr2GrQu,77,166,50,122,23,115,26,5,507,72.42857142857143,8,0.0,69,50,74,23,97,115,48,26,5,216,291,0
2426,31637,5vZRuON34JUuUxkGF08Mu94iTiQzZas4,RXDvfPUBYFlVdlueBFbLW0mhhAyGEqpt,50,64,35,116,14,2,21,12,264,37.714285714285715,4,0.0,14,35,103,14,50,2,13,21,12,166,98,0
2427,31672,kGJ0kJD3LGzwfPeuS19lVyqb4r7gscqA,SpATywNh6bZuzm8s1ceuBUnMUAeoAHHw,6,5,4,0,4,0,1,0,14,2.0,1,0.0,0,4,0,4,5,0,0,1,0,8,6,0
2428,31683,YTga640T6i241jGBhxN7pUtNHHrQTFGS,7GRhBDsirIGkRZBtSMEzNTyDr2JQm4xx,10,12,3,14,1,1,1,0,32,4.571428571428571,1,0.0,8,3,12,1,4,1,2,1,0,24,8,1
2429,31695,yWhbSfRhq0GQaIid8lmuGTuOjD7iQVVR,SpATywNh6bZuzm8s1ceuBUnMUAeoAHHw,25,82,23,27,7,38,24,0,201,28.714285714285715,7,0.0,38,23,21,7,44,38,6,24,0,89,112,1
2430,31718,TJ0V0Q8Q7PU7JaM3K55nOnFdpx29qUfy,SpATywNh6bZuzm8s1ceuBUnMUAeoAHHw,5,9,4,0,0,0,5,0,18,2.5714285714285716,2,0.0,0,4,0,0,9,0,0,5,0,4,14,0
2431,31730,a4RYqILKcnu8c617gYSbD0KQIm9DqZnc,SpATywNh6bZuzm8s1ceuBUnMUAeoAHHw,29,32,14,23,8,1,11,0,89,12.714285714285714,6,0.0,7,14,22,8,25,1,1,11,0,51,38,0
2432,31742,Ol0EltSC0dLtmI4Ws0ziQYNZlpSWDTB5,SpATywNh6bZuzm8s1ceuBUnMUAeoAHHw,20,73,4,0,3,1,19,1,101,14.428571428571429,2,0.0,18,4,0,3,55,1,0,19,1,25,76,0
2433,31780,DQDVulqp0h5DfSUqCcuRlUTAbYsaxOXV,7GRhBDsirIGkRZBtSMEzNTyDr2JQm4xx,3,0,0,0,0,4,4,0,8,1.1428571428571428,1,0.0,0,0,0,0,0,4,0,4,0,0,8,1
2434,31785,WMHp5hy6JREfQvjE2o6B3Iu0aAWFRyny,SpATywNh6bZuzm8s1ceuBUnMUAeoAHHw,15,18,9,12,6,0,7,0,52,7.428571428571429,4,0.0,5,9,10,6,13,0,2,7,0,30,22,0
2435,31792,ZNcLOAJ2r3H5DqhbGk1CiPtwI7ixaCeK,A3fsA9Zfv1X2fVEQhTw51lKENdNrEqT3,35,36,28,34,19,0,8,0,125,17.857142857142858,5,0.0,0,28,33,19,36,0,1,8,0,80,45,0
2436,31827,JOddnojV0OZrysgzYsnxzhRLS1r6GCxl,SpATywNh6bZuzm8s1ceuBUnMUAeoAHHw,10,16,7,0,4,1,3,0,31,4.428571428571429,2,0.0,4,7,0,4,12,1,0,3,0,15,16,1
2437,31829,861mcqUZ4WyFkrWdyYySCd1kJULdzhG3,SpATywNh6bZuzm8s1ceuBUnMUAeoAHHw,10,8,0,12,0,0,1,0,21,3.0,1,0.0,2,0,12,0,6,0,0,1,0,14,7,1
2438,31854,wLAgbiz3XWV6Nef8pQe1TlLxUN8CIoJ8,7GRhBDsirIGkRZBtSMEzNTyDr2JQm4xx,64,76,24,105,24,7,13,1,250,35.714285714285715,2,0.0,47,24,96,24,29,7,9,13,1,191,59,1
2439,31869,R2cga9JVVM2tXEVs2saYswslfxAU4nMk,SpATywNh6bZuzm8s1ceuBUnMUAeoAHHw,21,13,8,14,4,0,7,0,46,6.571428571428571,3,0.0,4,8,14,4,9,0,0,7,0,30,16,0
2440,31877,ioaeb7d1U29jI9wsI7DHJ7aiuWWVX3KB,RXDvfPUBYFlVdlueBFbLW0mhhAyGEqpt,21,33,11,0,7,6,17,2,76,10.857142857142858,2,0.0,1,11,0,7,32,6,0,17,2,19,57,0
2441,31898,PWcBu9Kt7uTK1WC32ssYHrspf5hPuUjQ,7GRhBDsirIGkRZBtSMEzNTyDr2JQm4xx,8,5,3,0,2,0,4,0,14,2.0,2,0.0,0,3,0,2,5,0,0,4,0,5,9,1
2442,31927,6tkBZTnNxRRRXGSFUHBd7kkZUgcJhsIy,7GRhBDsirIGkRZBtSMEzNTyDr2JQm4xx,2,0,0,0,0,0,2,0,2,0.2857142857142857,1,0.0,0,0,0,0,0,0,0,2,0,0,2,1
2443,31979,XYKAwX2Sl88KhgfkTOpg6K4pRdGN7Orp,7GRhBDsirIGkRZBtSMEzNTyDr2JQm4xx,2,0,0,0,0,0,3,0,3,0.42857142857142855,1,0.0,0,0,0,0,0,0,0,3,0,0,3,1
2444,31983,EwpbggvNdZkeSTjdG48aEltlJYavm02s,A3fsA9Zfv1X2fVEQhTw51lKENdNrEqT3,14,14,1,0,0,0,4,0,19,2.7142857142857144,2,0.0,0,1,0,0,14,0,0,4,0,1,18,0
2445,31996,TZQnDQD4c1wLJcg98vkGC4z0YxJAykwb,SpATywNh6bZuzm8s1ceuBUnMUAeoAHHw,32,90,44,35,23,14,22,4,232,33.142857142857146,8,0.0,29,44,29,23,61,14,6,22,4,125,107,0
2446,32072,oV1ETioZLdwgIeANYoTTe9mpmAow2qIk,A3fsA9Zfv1X2fVEQhTw51lKENdNrEqT3,8,3,2,0,2,0,6,0,13,1.8571428571428572,1,0.0,0,2,0,2,3,0,0,6,0,4,9,0
2447,32112,Jf77UYIvUtofHBGpvQMQ0qUfMZBh9rRJ,SpATywNh6bZuzm8s1ceuBUnMUAeoAHHw,27,28,16,33,7,0,6,0,90,12.857142857142858,5,0.0,8,16,31,7,20,0,2,6,0,62,28,0
2448,32123,xrDGwnLLNa6QlQOfL38MTY3529BaxYjK,RXDvfPUBYFlVdlueBFbLW0mhhAyGEqpt,14,9,7,17,3,0,2,0,38,5.428571428571429,1,0.0,1,7,16,3,8,0,1,2,0,27,11,0
2449,32124,SWaMMFaEgBIwWimOSjcPRySyg7Gfrl6L,SpATywNh6bZuzm8s1ceuBUnMUAeoAHHw,29,29,13,27,7,0,4,1,81,11.571428571428571,1,0.0,6,13,24,7,23,0,3,4,1,50,31,0
2450,32130,4bLrsVDvLnrTqHqeIpcqQPyvl02eai7n,bWdj2GDclj5ofokWjzoa5jAwMkxCykd6,1,0,0,0,0,0,1,0,1,0.14285714285714285,1,0.0,0,0,0,0,0,0,0,1,0,0,1,1
2451,32135,610PtRFkaYif9s7nz1Kdra5qTHjPTrYT,SpATywNh6bZuzm8s1ceuBUnMUAeoAHHw,27,26,16,28,10,0,7,0,87,12.428571428571429,4,0.0,7,16,26,10,19,0,2,7,0,59,28,0
2452,32141,jagu0OJDhWTGFhfCMk0ghqluLpW3kzdC,bWdj2GDclj5ofokWjzoa5jAwMkxCykd6,6,2,1,0,1,0,6,0,10,1.4285714285714286,2,0.0,0,1,0,1,2,0,0,6,0,2,8,1
2453,32154,JB5wgKgEAIwYsiifcpDf7iv2yPgMBOVA,SpATywNh6bZuzm8s1ceuBUnMUAeoAHHw,24,62,3,29,1,1,16,1,113,16.142857142857142,6,0.0,14,3,28,1,48,1,1,16,1,46,67,0
2454,32159,DyQHVTNiwX6W4PiKOVh8BCoKQr8u7ImW,bWdj2GDclj5ofokWjzoa5jAwMkxCykd6,11,18,1,0,1,0,6,0,26,3.7142857142857144,1,0.0,3,1,0,1,15,0,0,6,0,5,21,1
2455,32162,kAQFM0dEgOQIxOG9jTMe5puRtNxZZWMN,A3fsA9Zfv1X2fVEQhTw51lKENdNrEqT3,80,55,3,254,2,0,8,0,322,46.0,7,0.0,4,3,226,2,51,0,28,8,0,235,87,0
2456,32165,xVQ88VrIuIA75ygDlevnROobNkwcFnsc,SpATywNh6bZuzm8s1ceuBUnMUAeoAHHw,19,29,5,14,4,16,10,0,78,11.142857142857142,4,0.0,0,5,12,4,29,16,2,10,0,21,57,0
2457,32177,kvf1WFygeLGKOFkoertca6J9TDxV9fcY,7GRhBDsirIGkRZBtSMEzNTyDr2JQm4xx,6,6,2,0,3,0,1,0,12,1.7142857142857142,2,0.0,3,2,0,3,3,0,0,1,0,8,4,1
2458,32181,yz5W8rI4J1brvBsiH8Bk8UlG6rKQV6QY,SpATywNh6bZuzm8s1ceuBUnMUAeoAHHw,16,28,15,16,3,0,10,0,72,10.285714285714286,3,0.0,7,15,14,3,21,0,2,10,0,39,33,0
2459,32220,dpAJ54wEPUDHZcYRCRrxvDfIakq9pmaQ,SpATywNh6bZuzm8s1ceuBUnMUAeoAHHw,22,29,2,26,0,4,11,1,73,10.428571428571429,5,0.0,10,2,25,0,19,4,1,11,1,37,36,1
2460,32237,qh4tHm7Ijtk0rXK87a1UXx5JdnCnPyij,7GRhBDsirIGkRZBtSMEzNTyDr2JQm4xx,5,3,2,0,0,0,2,0,7,1.0,1,0.0,0,2,0,0,3,0,0,2,0,2,5,1
2461,32248,s54A0hFU7GzRUM0cq0hWJTDlnMIM1TAX,SpATywNh6bZuzm8s1ceuBUnMUAeoAHHw,20,30,15,18,11,0,4,0,78,11.142857142857142,2,0.0,5,15,17,11,25,0,1,4,0,48,30,1
2462,32253,ttxTsF9ExfVKBVMcQbsoZt6AA8x2bWVB,SpATywNh6bZuzm8s1ceuBUnMUAeoAHHw,12,31,4,22,0,7,8,1,73,10.428571428571429,2,0.0,22,4,19,0,9,7,3,8,1,45,28,1
2463,32266,JfQVgXDVu1NGs9lcRBOD4w6V7BSaZCc2,SpATywNh6bZuzm8s1ceuBUnMUAeoAHHw,31,38,18,24,11,4,8,1,104,14.857142857142858,1,0.0,15,18,24,11,23,4,0,8,1,68,36,1
2464,32277,TEmVdQ7zwLYXmbCXgKpcJL6SMosCkEk6,7GRhBDsirIGkRZBtSMEzNTyDr2JQm4xx,13,12,5,4,4,8,9,4,46,6.571428571428571,1,0.0,4,5,3,4,8,8,1,9,4,16,30,1
2465,32281,SSlieJULaqRb1C7jSzOwyPvbJnH3adQv,7GRhBDsirIGkRZBtSMEzNTyDr2JQm4xx,50,76,6,151,16,6,8,0,263,37.57142857142857,7,0.0,36,6,131,16,40,6,20,8,0,189,74,1
2466,32289,5getYNIZ2hnUwVH9nwJiD9At1XFs260U,RXDvfPUBYFlVdlueBFbLW0mhhAyGEqpt,58,83,7,187,7,6,8,0,298,42.57142857142857,5,0.0,29,7,168,7,54,6,19,8,0,211,87,0
2467,32338,AgNNzeJI1RzulgZ7Mt174twC5BMmXMhy,SpATywNh6bZuzm8s1ceuBUnMUAeoAHHw,16,49,21,0,0,0,6,0,76,10.857142857142858,1,0.0,10,21,0,0,39,0,0,6,0,31,45,0
2468,32350,4Z7KasuRx9CbJCcpGQot8eWIzFoK9Y6e,G8EPVSXsOYB5YQWZGiz1aVq5Pgr2GrQu,14,14,5,14,3,1,6,2,45,6.428571428571429,2,0.0,6,5,12,3,8,1,2,6,2,26,19,0
2469,32378,dnBboDTKZBSq62soTT8p1zFH5HInmJMi,SpATywNh6bZuzm8s1ceuBUnMUAeoAHHw,8,6,4,0,2,1,6,0,19,2.7142857142857144,2,0.0,0,4,0,2,6,1,0,6,0,6,13,0
2470,32387,40BfkvCbbDiXljpQ7TxzzDakjMbYaL3S,SpATywNh6bZuzm8s1ceuBUnMUAeoAHHw,15,22,10,27,1,0,5,0,65,9.285714285714286,4,0.0,9,10,24,1,13,0,3,5,0,44,21,0
2471,32404,w7790lyNDi5biQPgaVfIpYKtROrGndED,SpATywNh6bZuzm8s1ceuBUnMUAeoAHHw,30,104,35,30,14,6,25,0,214,30.571428571428573,5,0.0,16,35,27,14,88,6,3,25,0,92,122,1
2472,32423,FW47VC0lzmys2S4k8Ky52JrXCSFDeyeP,A3fsA9Zfv1X2fVEQhTw51lKENdNrEqT3,9,7,5,0,3,0,2,0,17,2.4285714285714284,1,0.0,0,5,0,3,7,0,0,2,0,8,9,1
2473,32435,QqE2Xjwy9gUzOvFdkDqAwAaNZLBZkxvd,7GRhBDsirIGkRZBtSMEzNTyDr2JQm4xx,33,84,4,76,5,47,27,0,243,34.714285714285715,9,0.0,45,4,64,5,39,47,12,27,0,118,125,1
2474,32437,gGSMkNgPdXpBQgdZzyjzifomyCxFSNyt,A3fsA9Zfv1X2fVEQhTw51lKENdNrEqT3,48,48,29,52,15,31,46,1,222,31.714285714285715,11,0.0,1,29,47,15,47,31,5,46,1,92,130,0
2475,32439,sbafJyL5hxYHWbu0cbLBSCFDQh5Oe8Ww,RXDvfPUBYFlVdlueBFbLW0mhhAyGEqpt,20,32,2,1,2,12,6,0,55,7.857142857142857,2,0.0,1,2,1,2,31,12,0,6,0,6,49,0
2476,32466,JJro1amtaUogvd4Vkbdsh0DmnqfguR8P,SpATywNh6bZuzm8s1ceuBUnMUAeoAHHw,5,3,2,0,0,0,5,0,10,1.4285714285714286,1,0.0,0,2,0,0,3,0,0,5,0,2,8,1
2477,32471,1BEoeS35Ni9RflXqhdHAKpKpQ07oVqkG,SpATywNh6bZuzm8s1ceuBUnMUAeoAHHw,27,83,6,31,1,7,40,4,172,24.571428571428573,6,0.0,18,6,28,1,65,7,3,40,4,53,119,0
2478,32477,LPul7vNnoWP2lahy0vntgg039NwfmlYY,SpATywNh6bZuzm8s1ceuBUnMUAeoAHHw,25,48,4,26,1,11,23,1,114,16.285714285714285,7,0.0,8,4,19,1,40,11,7,23,1,32,82,0
2479,32483,MauXcYq2z30gm4QmDqcfc1IfWjnRlPwg,SpATywNh6bZuzm8s1ceuBUnMUAeoAHHw,14,29,2,0,1,0,8,2,42,6.0,5,0.0,0,2,0,1,29,0,0,8,2,3,39,0
2480,32520,AFUJTbEqqgSsqCkUsNrjbPAjZvFwpzeW,G8EPVSXsOYB5YQWZGiz1aVq5Pgr2GrQu,92,135,33,238,22,0,9,0,437,62.42857142857143,4,0.0,67,33,157,22,68,0,81,9,0,279,158,0
2481,32530,KbfT30uvubax3lKEct6iblV8VhlPaIEn,G8EPVSXsOYB5YQWZGiz1aVq5Pgr2GrQu,22,22,11,22,7,0,2,0,64,9.142857142857142,1,0.0,0,11,20,7,22,0,2,2,0,38,26,0
2482,32536,13AvYdfA6LYkS80MstJgmNNdfNqd80ja,bWdj2GDclj5ofokWjzoa5jAwMkxCykd6,6,2,1,0,1,1,7,0,12,1.7142857142857142,3,0.0,0,1,0,1,2,1,0,7,0,2,10,0
2483,32547,wkfBzItw0JCH6ZUz2WUZn7ngJ5M4Oksy,SpATywNh6bZuzm8s1ceuBUnMUAeoAHHw,27,62,5,18,4,71,22,0,182,26.0,7,0.0,6,5,17,4,56,71,1,22,0,32,150,0
2484,32555,g14jBWDuqUHRwpf4jHpBljeNVwCyjgqd,G8EPVSXsOYB5YQWZGiz1aVq5Pgr2GrQu,24,40,20,0,20,0,5,0,85,12.142857142857142,3,0.0,9,20,0,20,31,0,0,5,0,49,36,1
2485,32579,rQ8twu2Y4JlbZAVSeNSb6mmUSGGvpIAq,SpATywNh6bZuzm8s1ceuBUnMUAeoAHHw,22,40,3,32,0,5,15,0,95,13.571428571428571,5,0.0,6,3,28,0,34,5,4,15,0,37,58,0
2486,32587,dwKCRrq2cYlFl5YxmnjTpirr5PBMVnOq,RXDvfPUBYFlVdlueBFbLW0mhhAyGEqpt,23,38,18,0,11,0,4,0,71,10.142857142857142,2,0.0,5,18,0,11,33,0,0,4,0,34,37,0
2487,32600,jaDaYkvR41YbLhesvf9mW32i93zNzaSK,RXDvfPUBYFlVdlueBFbLW0mhhAyGEqpt,51,64,37,73,11,3,27,1,216,30.857142857142858,7,0.0,9,37,67,11,55,3,6,27,1,124,92,0
2488,32617,ncKGr6xR4Vhs3wPeU0aqO1sSEow8LN64,SpATywNh6bZuzm8s1ceuBUnMUAeoAHHw,29,50,13,26,5,122,45,6,267,38.142857142857146,9,0.0,13,13,23,5,37,122,3,45,6,54,213,0
2489,32633,KSfQPUyfWWfWDmmi6m3KXcKzxz89wkwt,SpATywNh6bZuzm8s1ceuBUnMUAeoAHHw,24,45,10,12,5,6,9,0,87,12.428571428571429,4,0.0,13,10,12,5,32,6,0,9,0,40,47,0
2490,32634,vjkHj7F0L8pzTZztOfHA8KLslVpjNBKq,G8EPVSXsOYB5YQWZGiz1aVq5Pgr2GrQu,33,33,4,76,2,1,15,3,134,19.142857142857142,2,0.0,14,4,57,2,19,1,19,15,3,77,57,0
2491,32652,nqDX1tmEeTnbqCn9T8Crn5CYQgmIy9Eq,SpATywNh6bZuzm8s1ceuBUnMUAeoAHHw,31,69,37,25,12,20,27,5,195,27.857142857142858,5,0.0,21,37,23,12,48,20,2,27,5,93,102,0
2492,32654,zQwNebC3qLt6HHOuoG7oSsRj8l42sEdO,7GRhBDsirIGkRZBtSMEzNTyDr2JQm4xx,10,16,4,0,2,0,4,1,27,3.857142857142857,2,0.0,0,4,0,2,16,0,0,4,1,6,21,1
2493,32661,qKc8EuUOlEzXysFMoXghKaieW3HIaePV,SpATywNh6bZuzm8s1ceuBUnMUAeoAHHw,27,56,16,36,8,1,13,0,130,18.571428571428573,5,0.0,13,16,30,8,43,1,6,13,0,67,63,0
2494,32663,RQ7L9CpArhwtUrlKYRf29Ou4YmyW3xpx,A3fsA9Zfv1X2fVEQhTw51lKENdNrEqT3,15,18,11,0,8,0,6,0,43,6.142857142857143,2,0.0,0,11,0,8,18,0,0,6,0,19,24,0
2495,32675,S65yhLgjTGwwuDt6C6cjI82AJbGfYIiK,SpATywNh6bZuzm8s1ceuBUnMUAeoAHHw,22,22,11,12,6,0,15,1,67,9.571428571428571,3,0.0,8,11,11,6,14,0,1,15,1,36,31,1
2496,32680,4m1Dg29Y9pbvJRrOBjNRbyWgB17yJl3U,G8EPVSXsOYB5YQWZGiz1aVq5Pgr2GrQu,2,0,0,0,0,0,2,0,2,0.2857142857142857,1,0.0,0,0,0,0,0,0,0,2,0,0,2,0
2497,32681,t6I1fQ9ItZRIjAyoxww7ONpoKNI8Ya9L,SpATywNh6bZuzm8s1ceuBUnMUAeoAHHw,11,9,0,22,0,0,7,0,38,5.428571428571429,1,0.0,6,0,20,0,3,0,2,7,0,26,12,0
2498,32686,DE2u0bz0HnoULwJGtrWEHwtLyRyGfjcB,SpATywNh6bZuzm8s1ceuBUnMUAeoAHHw,24,24,13,11,9,2,2,0,61,8.714285714285714,1,0.0,9,13,10,9,15,2,1,2,0,41,20,0
2499,32688,vsH3qB64VOSnSTFhrkJQnHqm8c83psRR,SpATywNh6bZuzm8s1ceuBUnMUAeoAHHw,27,44,23,40,9,59,5,0,180,25.714285714285715,4,0.0,6,23,33,9,38,59,7,5,0,71,109,0
2500,32691,zIxh0JW4JCwiox9jMtpfpkw3WRcYtUgv,SpATywNh6bZuzm8s1ceuBUnMUAeoAHHw,13,18,0,8,0,8,8,1,43,6.142857142857143,1,0.0,8,0,8,0,10,8,0,8,1,16,27,0
2501,32693,NrExtDPytZeckpp4FyIosvaEjFjzywmC,A3fsA9Zfv1X2fVEQhTw51lKENdNrEqT3,47,12,0,120,0,0,10,0,142,20.285714285714285,3,0.0,3,0,113,0,9,0,7,10,0,116,26,1
2502,32701,abaCPMr6xWMrCiOErEioyXWBSEERS1tE,7GRhBDsirIGkRZBtSMEzNTyDr2JQm4xx,17,14,8,0,6,1,14,2,45,6.428571428571429,2,0.0,3,8,0,6,11,1,0,14,2,17,28,1
2503,32710,HJ2gv3yF0WCJxGH8T6tjLTFYdM4sCizz,RXDvfPUBYFlVdlueBFbLW0mhhAyGEqpt,47,60,26,103,18,26,20,2,255,36.42857142857143,4,0.0,22,26,87,18,38,26,16,20,2,153,102,0
2504,32715,KvjMYuIyC1QuxskkhpxIY7MoDNSU5FMk,7GRhBDsirIGkRZBtSMEzNTyDr2JQm4xx,16,23,14,0,11,0,2,0,50,7.142857142857143,1,0.0,6,14,0,11,17,0,0,2,0,31,19,1
2505,32721,aLRP3ahB5SIcOn5vpM1VPEh9ib2QIioX,A3fsA9Zfv1X2fVEQhTw51lKENdNrEqT3,13,11,8,0,6,0,4,0,29,4.142857142857143,3,0.0,0,8,0,6,11,0,0,4,0,14,15,1
2506,32722,Jd5OP6GIsguRdsq9k3eSYNENmzhPbdGe,A3fsA9Zfv1X2fVEQhTw51lKENdNrEqT3,7,7,5,0,1,0,2,0,15,2.142857142857143,2,0.0,0,5,0,1,7,0,0,2,0,6,9,0
2507,32732,L74tKRZpBi1qsh0NM3EwE5D87acCLK8s,A3fsA9Zfv1X2fVEQhTw51lKENdNrEqT3,88,104,52,251,21,3,44,0,475,67.85714285714286,16,0.0,10,52,245,21,94,3,6,44,0,328,147,0
2508,32746,mXsmDArxUTe9rMFHp3cGPJEx5ACYKD90,7GRhBDsirIGkRZBtSMEzNTyDr2JQm4xx,29,45,19,37,9,6,7,0,123,17.571428571428573,5,0.0,18,19,31,9,27,6,6,7,0,77,46,1
2509,32753,Gn3GzN2xweKhiR4C9qIb4ocllZ2lANYz,SpATywNh6bZuzm8s1ceuBUnMUAeoAHHw,7,9,6,0,4,0,3,0,22,3.142857142857143,2,0.0,0,6,0,4,9,0,0,3,0,10,12,1
2510,32769,vEKYOhRdGZ59kfXY6wTO63YZY4EqPYqX,SpATywNh6bZuzm8s1ceuBUnMUAeoAHHw,22,34,21,10,8,0,6,0,79,11.285714285714286,5,0.0,5,21,9,8,29,0,1,6,0,43,36,0
2511,32826,wCKxyDpTEsiI3UuDi33CaUGYhXjKnrBv,SpATywNh6bZuzm8s1ceuBUnMUAeoAHHw,14,11,6,6,4,0,2,0,29,4.142857142857143,1,0.0,2,6,5,4,9,0,1,2,0,17,12,0
2512,32837,wZVSpaATIDuE7qW0svZJi84Cpi6PMqWg,SpATywNh6bZuzm8s1ceuBUnMUAeoAHHw,16,38,5,12,2,0,15,0,72,10.285714285714286,4,0.0,6,5,10,2,32,0,2,15,0,23,49,1
2513,32872,XEcLEoVa2SWvlFcbbhIECksb9a6XvMec,RXDvfPUBYFlVdlueBFbLW0mhhAyGEqpt,19,25,14,35,3,9,10,6,102,14.571428571428571,2,0.0,8,14,30,3,17,9,5,10,6,55,47,0
2514,32884,z2Zz9wVXxnQo0wOtqHQc06HPM9iWXDoN,SpATywNh6bZuzm8s1ceuBUnMUAeoAHHw,18,27,10,20,5,24,10,1,97,13.857142857142858,2,0.0,8,10,17,5,19,24,3,10,1,40,57,0
2515,32887,9WVTv7dWHzTCHwCGLSPAioAO2udyHWmu,SpATywNh6bZuzm8s1ceuBUnMUAeoAHHw,18,37,14,18,10,32,26,0,137,19.571428571428573,7,0.0,17,14,16,10,20,32,2,26,0,57,80,0
2516,32906,ZE27RADj3bE2oGbL4tXAfIaeVlYNn4oN,SpATywNh6bZuzm8s1ceuBUnMUAeoAHHw,5,8,4,0,2,2,2,0,18,2.5714285714285716,2,0.0,0,4,0,2,8,2,0,2,0,6,12,0
2517,32917,dwKCRrq2cYlFl5YxmnjTpirr5PBMVnOq,SpATywNh6bZuzm8s1ceuBUnMUAeoAHHw,10,29,14,0,6,5,4,0,58,8.285714285714286,2,0.0,9,14,0,6,20,5,0,4,0,29,29,0
2518,32923,NqKjMSY6eOZQ1uSyzlPrquJVqzjvSO7O,SpATywNh6bZuzm8s1ceuBUnMUAeoAHHw,27,50,21,24,5,26,17,4,147,21.0,7,0.0,10,21,24,5,40,26,0,17,4,60,87,0
2519,32929,OWN7QY4MoQINwciZKacEUOaJkqenbOMp,SpATywNh6bZuzm8s1ceuBUnMUAeoAHHw,5,0,0,0,0,0,4,1,5,0.7142857142857143,1,0.0,0,0,0,0,0,0,0,4,1,0,5,0
2520,32962,gi1cGXmBNmpbe6lA2hzKFh8EEd7gQMCM,7GRhBDsirIGkRZBtSMEzNTyDr2JQm4xx,1,0,0,0,0,0,1,0,1,0.14285714285714285,1,0.0,0,0,0,0,0,0,0,1,0,0,1,1
2521,32969,z4c8EBwIn89viFGIwasAjQhkMGV3BTQj,SpATywNh6bZuzm8s1ceuBUnMUAeoAHHw,16,28,16,14,13,0,2,0,73,10.428571428571429,3,0.0,7,16,10,13,21,0,4,2,0,46,27,0
2522,32970,f9VMkfOoUWXzqEbeO2IX0YOVcNKnSKLo,7GRhBDsirIGkRZBtSMEzNTyDr2JQm4xx,1,0,0,0,0,0,1,0,1,0.14285714285714285,1,0.0,0,0,0,0,0,0,0,1,0,0,1,1
2523,32976,E7QFiJdCviuClYDIfnaKnxTdSk0i534L,7GRhBDsirIGkRZBtSMEzNTyDr2JQm4xx,1,0,0,0,0,0,1,0,1,0.14285714285714285,1,0.0,0,0,0,0,0,0,0,1,0,0,1,1
2524,32983,BtS3BvehCjq4QaGPbzrC7JIugP6OKoPy,7GRhBDsirIGkRZBtSMEzNTyDr2JQm4xx,47,104,46,73,32,31,33,2,321,45.857142857142854,7,0.0,41,46,61,32,63,31,12,33,2,180,141,1
2525,33024,P7HoHyQzVXLghYr6m3MYTEIsDQbHfDfp,SpATywNh6bZuzm8s1ceuBUnMUAeoAHHw,25,21,12,26,7,0,2,0,68,9.714285714285714,3,0.0,6,12,25,7,15,0,1,2,0,50,18,0
2526,33071,S4x7F2zwGMymIPjPy7YGoWTUwlKzmNvg,7GRhBDsirIGkRZBtSMEzNTyDr2JQm4xx,19,22,8,18,3,7,35,3,96,13.714285714285714,5,0.0,2,8,15,3,20,7,3,35,3,28,68,1
2527,33080,5ADMlR48WDr3F57JEz4JNbgGytxoga6J,SpATywNh6bZuzm8s1ceuBUnMUAeoAHHw,24,43,2,28,1,1,47,1,123,17.571428571428573,9,0.0,18,2,28,1,25,1,0,47,1,49,74,0
2528,33108,ixS1p3tBQwqQrlFRj6LavXiIpA0ocHQj,SpATywNh6bZuzm8s1ceuBUnMUAeoAHHw,25,60,4,34,1,0,9,1,109,15.571428571428571,3,0.0,34,4,32,1,26,0,2,9,1,71,38,1
2529,33127,FAyJy1gyoIxzJtXvVglyOve11ozvFF4C,SpATywNh6bZuzm8s1ceuBUnMUAeoAHHw,28,32,15,21,9,0,4,0,81,11.571428571428571,2,0.0,5,15,19,9,27,0,2,4,0,48,33,0
2530,33150,vU01Fxors0KlSd7gao1Z0nHesILTHNPI,SpATywNh6bZuzm8s1ceuBUnMUAeoAHHw,23,34,9,8,5,16,32,0,104,14.857142857142858,13,0.0,1,9,8,5,33,16,0,32,0,23,81,0
2531,33164,AJYnlahOLAGVXTJrzU8y7gkOQqLtYt6X,SpATywNh6bZuzm8s1ceuBUnMUAeoAHHw,17,22,9,19,4,3,4,0,61,8.714285714285714,2,0.0,3,9,16,4,19,3,3,4,0,32,29,0
2532,33169,FPQSXji4bDip0jB4obm0vWFPXClGuSyC,7GRhBDsirIGkRZBtSMEzNTyDr2JQm4xx,52,79,33,88,21,24,18,1,264,37.714285714285715,8,0.0,39,33,71,21,40,24,17,18,1,164,100,0
2533,33179,79cpMMK2EsbvkowaPozXyQoZKeC4iKuw,A3fsA9Zfv1X2fVEQhTw51lKENdNrEqT3,12,14,9,0,4,0,7,0,34,4.857142857142857,4,0.0,1,9,0,4,13,0,0,7,0,14,20,0
2534,33203,6oSvXBiE6hMQm6ur1TzQBxRkuWf4UJ1w,SpATywNh6bZuzm8s1ceuBUnMUAeoAHHw,30,102,40,28,9,17,40,2,238,34.0,6,0.0,30,40,22,9,72,17,6,40,2,101,137,0
2535,33224,M5i9wheFDK1paYxXA7PsW9kp3DBbWp4e,bWdj2GDclj5ofokWjzoa5jAwMkxCykd6,16,41,12,136,8,2,8,2,209,29.857142857142858,5,0.0,20,12,130,8,21,2,6,8,2,170,39,0
2536,33251,9oofyIqQs4svoCsTL3Pyep7hA30rIFOe,SpATywNh6bZuzm8s1ceuBUnMUAeoAHHw,15,22,10,17,3,3,7,0,62,8.857142857142858,3,0.0,8,10,15,3,14,3,2,7,0,36,26,0
2537,33266,ANj8LPP4QCqsLHbhaQj263PWrIQ9dqGZ,SpATywNh6bZuzm8s1ceuBUnMUAeoAHHw,24,54,0,39,0,0,10,1,104,14.857142857142858,4,0.0,20,0,32,0,34,0,7,10,1,52,52,0
2538,33270,BFrfDseDfXCBvtTfCsJAy36Ogk6b0Rfx,SpATywNh6bZuzm8s1ceuBUnMUAeoAHHw,18,45,24,0,7,0,14,0,90,12.857142857142858,9,0.0,0,24,0,7,45,0,0,14,0,31,59,0
2539,33272,QQyKT0cNRgXjfYZrcyku7Q3OKE07rSzG,A3fsA9Zfv1X2fVEQhTw51lKENdNrEqT3,1,0,0,0,0,0,1,0,1,0.14285714285714285,1,0.0,0,0,0,0,0,0,0,1,0,0,1,1
2540,33284,jRnFs6XBk6vGxxB24JG9v0Qh3pYfUtLh,RXDvfPUBYFlVdlueBFbLW0mhhAyGEqpt,44,109,37,73,13,10,25,15,282,40.285714285714285,10,0.0,12,37,66,13,97,10,7,25,15,128,154,0
2541,33290,0wm7bVyJC7jfhIoeylaV85sHOH5JOhtj,SpATywNh6bZuzm8s1ceuBUnMUAeoAHHw,27,53,15,23,8,13,15,1,128,18.285714285714285,6,0.0,12,15,19,8,41,13,4,15,1,54,74,0
2542,33298,wjqMTSqGRhad7XTyyuysYYbP0x4J6ulv,bWdj2GDclj5ofokWjzoa5jAwMkxCykd6,9,14,3,0,3,2,10,0,32,4.571428571428571,4,0.0,0,3,0,3,14,2,0,10,0,6,26,1
2543,33322,vIBcYbs1BLdmaaP30fcE2FS7kB7v7QRn,SpATywNh6bZuzm8s1ceuBUnMUAeoAHHw,4,2,1,0,0,0,3,0,6,0.8571428571428571,2,0.0,0,1,0,0,2,0,0,3,0,1,5,1
2544,33331,mJNmN9AbVBmhzBfxSlHeSff1yTyr8w50,SpATywNh6bZuzm8s1ceuBUnMUAeoAHHw,22,77,28,0,15,6,27,0,153,21.857142857142858,9,0.0,0,28,0,15,77,6,0,27,0,43,110,0
2545,33348,we9tWnySpl1G7k7FqyXPj8wmC2gUYK0W,SpATywNh6bZuzm8s1ceuBUnMUAeoAHHw,23,27,1,25,1,8,8,3,73,10.428571428571429,3,0.0,9,1,23,1,18,8,2,8,3,34,39,0
2546,33354,0LjNTZG6byvXe7xKDfNEXUTZjqaDOglx,G8EPVSXsOYB5YQWZGiz1aVq5Pgr2GrQu,17,19,9,6,4,0,10,1,49,7.0,3,0.0,3,9,5,4,16,0,1,10,1,21,28,1
2547,33368,hJo1MgKiPZFXuH2ko6hqPTd9dbjMQKDO,bWdj2GDclj5ofokWjzoa5jAwMkxCykd6,37,42,22,202,8,0,11,0,285,40.714285714285715,7,0.0,10,22,188,8,32,0,14,11,0,228,57,0
2548,33370,3EwUg208bV0DvnhKptmbGHdmCctMgvT5,SpATywNh6bZuzm8s1ceuBUnMUAeoAHHw,6,7,2,0,0,1,3,0,13,1.8571428571428572,1,0.0,0,2,0,0,7,1,0,3,0,2,11,1
2549,33431,viuKt4GgrX0rYL5EpHoxJbsiC9TblSuk,A3fsA9Zfv1X2fVEQhTw51lKENdNrEqT3,36,78,39,14,5,78,60,1,275,39.285714285714285,9,0.0,1,39,8,5,77,78,6,60,1,53,222,0
2550,33443,viuKt4GgrX0rYL5EpHoxJbsiC9TblSuk,bWdj2GDclj5ofokWjzoa5jAwMkxCykd6,27,44,28,6,12,69,37,1,197,28.142857142857142,9,0.0,0,28,3,12,44,69,3,37,1,43,154,0
2551,33455,7usMWWPRRbqHqTGVe4yfuQMnaM8GH1DT,SpATywNh6bZuzm8s1ceuBUnMUAeoAHHw,8,6,4,0,3,1,6,0,20,2.857142857142857,2,0.0,0,4,0,3,6,1,0,6,0,7,13,0
2552,33469,viuKt4GgrX0rYL5EpHoxJbsiC9TblSuk,G8EPVSXsOYB5YQWZGiz1aVq5Pgr2GrQu,29,74,42,0,5,55,29,0,205,29.285714285714285,8,0.0,8,42,0,5,66,55,0,29,0,55,150,0
2553,33481,viuKt4GgrX0rYL5EpHoxJbsiC9TblSuk,RXDvfPUBYFlVdlueBFbLW0mhhAyGEqpt,32,103,36,0,7,106,47,8,307,43.857142857142854,8,0.0,11,36,0,7,92,106,0,47,8,54,253,0
2554,33500,VwUXTBGJaTv5xN1He6TwE1OKxII3IUB4,7GRhBDsirIGkRZBtSMEzNTyDr2JQm4xx,3,6,1,0,1,1,1,0,10,1.4285714285714286,1,0.0,2,1,0,1,4,1,0,1,0,4,6,1
2555,33506,R6mWJ0ZeHkZWWi0xlkZZqK7iozuGXemG,7GRhBDsirIGkRZBtSMEzNTyDr2JQm4xx,8,10,6,0,5,3,9,2,35,5.0,3,0.0,4,6,0,5,6,3,0,9,2,15,20,1
2556,33517,R6mWJ0ZeHkZWWi0xlkZZqK7iozuGXemG,SpATywNh6bZuzm8s1ceuBUnMUAeoAHHw,18,26,12,20,5,6,12,1,82,11.714285714285714,3,0.0,9,12,17,5,17,6,3,12,1,43,39,1
2557,33519,7yKH9idxIZZIHmSby2TlRwglHE2J4AOu,7GRhBDsirIGkRZBtSMEzNTyDr2JQm4xx,28,74,23,22,9,14,12,2,156,22.285714285714285,4,0.0,19,23,20,9,55,14,2,12,2,71,85,1
2558,33521,kOcsNetIsK9HFRaYNeKiWrndfQDPUf2b,7GRhBDsirIGkRZBtSMEzNTyDr2JQm4xx,44,92,37,52,36,5,8,0,230,32.857142857142854,6,0.0,47,37,46,36,45,5,6,8,0,166,64,1
2559,33529,sYEBB7Cezd6bYcnMjhqBrC5c63jbJN18,SpATywNh6bZuzm8s1ceuBUnMUAeoAHHw,19,21,13,0,9,0,5,0,48,6.857142857142857,3,0.0,5,13,0,9,16,0,0,5,0,27,21,0
2560,33576,KshwCmsAWd7PYW2Qdxpd0Dd8iC7QTJ5v,SpATywNh6bZuzm8s1ceuBUnMUAeoAHHw,11,10,4,0,3,0,3,0,20,2.857142857142857,3,0.0,0,4,0,3,10,0,0,3,0,7,13,0
2561,33589,orkcYdEVQqlH9SJjCRUiZ5P3bFy172XW,7GRhBDsirIGkRZBtSMEzNTyDr2JQm4xx,4,7,0,0,0,0,3,0,10,1.4285714285714286,2,0.0,0,0,0,0,7,0,0,3,0,0,10,1
2562,33638,kGNoIC9AxgB9nCs6frsN1R7EeU5BsStD,SpATywNh6bZuzm8s1ceuBUnMUAeoAHHw,16,28,7,25,1,1,3,0,65,9.285714285714286,2,0.0,17,7,21,1,11,1,4,3,0,46,19,1
2563,33644,eE4DAv5aHElS2DPaTad4VXPjk6A3xvPl,G8EPVSXsOYB5YQWZGiz1aVq5Pgr2GrQu,92,92,58,175,29,0,12,1,367,52.42857142857143,6,0.0,15,58,154,29,77,0,21,12,1,256,111,0
2564,33674,Ry5r3PlRYtX7RdQht9vGdro0Bt4zHDPw,SpATywNh6bZuzm8s1ceuBUnMUAeoAHHw,32,56,20,42,8,28,20,3,177,25.285714285714285,4,0.0,18,20,35,8,38,28,7,20,3,81,96,0
2565,33676,csMt1h4jwoK6sZ6rEkcutiAH8F6ocCR4,A3fsA9Zfv1X2fVEQhTw51lKENdNrEqT3,32,16,0,46,0,0,4,0,66,9.428571428571429,2,0.0,1,0,46,0,15,0,0,4,0,47,19,1
2566,34640,n6oy92A0COsM84uyQbTNZ7pqWc0u5Wg0,7GRhBDsirIGkRZBtSMEzNTyDr2JQm4xx,1,0,0,0,0,0,1,0,1,0.14285714285714285,1,0.0,0,0,0,0,0,0,0,1,0,0,1,1
2567,34665,X0fr45rfdEeZ9hURKvWR9AGDFDSFFsR7,7GRhBDsirIGkRZBtSMEzNTyDr2JQm4xx,12,22,6,2,2,0,5,0,37,5.285714285714286,2,0.0,1,6,1,2,21,0,1,5,0,10,27,1
2568,34710,521YJDVy6G9ul5QyLTUZAuztPLpe7gqW,7GRhBDsirIGkRZBtSMEzNTyDr2JQm4xx,3,0,0,0,0,0,3,0,3,0.42857142857142855,1,0.0,0,0,0,0,0,0,0,3,0,0,3,1
2569,34719,42bX0uPWOXgBHMwF4wqdnl1Ve6wIHNQe,7GRhBDsirIGkRZBtSMEzNTyDr2JQm4xx,9,5,3,0,3,0,2,0,13,1.8571428571428572,1,0.0,1,3,0,3,4,0,0,2,0,7,6,1
2570,34725,n8Qj7926d7yvtreYunFCLT4mrboYdeRa,7GRhBDsirIGkRZBtSMEzNTyDr2JQm4xx,14,14,5,4,5,3,9,1,41,5.857142857142857,1,0.0,3,5,3,5,11,3,1,9,1,16,25,1
2571,34738,4en36s6M5dWiGXaOz7Ao485PkasQppcC,7GRhBDsirIGkRZBtSMEzNTyDr2JQm4xx,34,44,15,18,14,10,7,4,112,16.0,4,0.0,23,15,9,14,21,10,9,7,4,61,51,1
2572,34752,Ul8fOM41ROTx6GwtVQf8fol92V0sOxIU,7GRhBDsirIGkRZBtSMEzNTyDr2JQm4xx,1,0,0,0,0,0,2,0,2,0.2857142857142857,2,0.0,0,0,0,0,0,0,0,2,0,0,2,1
2573,34771,1znu7Xzg4p1qA4YkunjQTwOhXoKFFWr0,7GRhBDsirIGkRZBtSMEzNTyDr2JQm4xx,29,35,3,16,4,1,6,0,65,9.285714285714286,4,0.0,13,3,9,4,22,1,7,6,0,29,36,0
2574,34808,t6gbXbSU5L3FPpVibBhtf9ABrcXvjFov,7GRhBDsirIGkRZBtSMEzNTyDr2JQm4xx,5,9,6,0,5,0,3,0,23,3.2857142857142856,2,0.0,0,6,0,5,9,0,0,3,0,11,12,0
2575,34836,XZ6wb1QGJGwEfyG45cl1hveOKOr0OgzY,7GRhBDsirIGkRZBtSMEzNTyDr2JQm4xx,5,2,1,0,1,0,2,0,6,0.8571428571428571,1,0.0,0,1,0,1,2,0,0,2,0,2,4,1
2576,34841,DBI154fAsTYpTW5PDGxgInzkEniSAAwK,7GRhBDsirIGkRZBtSMEzNTyDr2JQm4xx,1,0,0,0,0,0,1,0,1,0.14285714285714285,1,0.0,0,0,0,0,0,0,0,1,0,0,1,1
2577,34851,BkozGGotFoRWvs7kivTQvwwV5JZ8hddc,7GRhBDsirIGkRZBtSMEzNTyDr2JQm4xx,1,0,0,0,0,0,1,0,1,0.14285714285714285,1,0.0,0,0,0,0,0,0,0,1,0,0,1,0
2578,34867,ZmcKxihZ1R64O2ndnnAR75Wj8TfQ1PuJ,7GRhBDsirIGkRZBtSMEzNTyDr2JQm4xx,8,4,0,4,0,0,5,0,13,1.8571428571428572,1,0.0,1,0,3,0,3,0,1,5,0,4,9,1
2579,34870,OE6rKd9Nqgw6uyQXd4G7Xvv5u5KYnYfc,7GRhBDsirIGkRZBtSMEzNTyDr2JQm4xx,1,0,0,0,0,0,1,0,1,0.14285714285714285,1,0.0,0,0,0,0,0,0,0,1,0,0,1,0
2580,34887,tjK76iagpFGbk5YoF97wIV91VIkWMXeI,7GRhBDsirIGkRZBtSMEzNTyDr2JQm4xx,1,0,0,0,0,0,1,0,1,0.14285714285714285,1,0.0,0,0,0,0,0,0,0,1,0,0,1,1
2581,34895,TPjv2mgvzs8mtuY7ccAmTpwjgR5agCrX,7GRhBDsirIGkRZBtSMEzNTyDr2JQm4xx,4,6,2,0,0,1,2,0,11,1.5714285714285714,1,0.0,2,2,0,0,4,1,0,2,0,4,7,1
2582,34905,lB6Kl0if51YgTDbpdNoXtX6HKiMZvllY,7GRhBDsirIGkRZBtSMEzNTyDr2JQm4xx,1,0,0,0,0,0,1,0,1,0.14285714285714285,1,0.0,0,0,0,0,0,0,0,1,0,0,1,1
2583,34952,Fc6or2UHUceP4nvPJGhwD2OTewY2syOC,7GRhBDsirIGkRZBtSMEzNTyDr2JQm4xx,5,4,1,0,2,0,2,0,9,1.2857142857142858,1,0.0,2,1,0,2,2,0,0,2,0,5,4,1
2584,35056,Az35wHR97uuRkRSgT8BjE6DkhH91OHMF,7GRhBDsirIGkRZBtSMEzNTyDr2JQm4xx,10,11,5,2,3,0,6,1,28,4.0,3,0.0,1,5,2,3,10,0,0,6,1,11,17,1
2585,35087,CfeENerIdAGepleePWSt0SV88ctt0Tmw,7GRhBDsirIGkRZBtSMEzNTyDr2JQm4xx,1,0,0,0,0,0,1,0,1,0.14285714285714285,1,0.0,0,0,0,0,0,0,0,1,0,0,1,1
2586,35128,rOp8aBXrvMFn99ymSn6pN6nQjBR9XCcF,7GRhBDsirIGkRZBtSMEzNTyDr2JQm4xx,5,4,0,0,0,0,3,0,7,1.0,1,0.0,0,0,0,0,4,0,0,3,0,0,7,1
2587,35150,AvQhWM9grultmx48matDmWO7LLNb13dd,7GRhBDsirIGkRZBtSMEzNTyDr2JQm4xx,39,43,12,48,16,4,4,0,127,18.142857142857142,3,0.0,25,12,39,16,18,4,9,4,0,92,35,0
2588,35152,VsfU7jeSb2K8k0CBzCZzXJjDlMye1sB1,7GRhBDsirIGkRZBtSMEzNTyDr2JQm4xx,53,125,61,71,36,4,15,0,312,44.57142857142857,8,0.0,51,61,63,36,74,4,8,15,0,211,101,1
2589,35154,6TeNHmnZsy2QqeLuJegGqbjbPJMrX0FT,7GRhBDsirIGkRZBtSMEzNTyDr2JQm4xx,2,0,0,0,0,0,2,0,2,0.2857142857142857,1,0.0,0,0,0,0,0,0,0,2,0,0,2,1
2590,35156,WDMP5c2Ubx8vVSFegA0mXeU23cYb0qCY,7GRhBDsirIGkRZBtSMEzNTyDr2JQm4xx,32,56,3,46,5,8,7,0,125,17.857142857142858,6,0.0,27,3,40,5,29,8,6,7,0,75,50,1
2591,35159,dJJJLtI6F18pblO9KPkBPg9ZKTgQPaQc,7GRhBDsirIGkRZBtSMEzNTyDr2JQm4xx,53,122,4,107,14,7,10,0,264,37.714285714285715,9,0.0,60,4,99,14,62,7,8,10,0,177,87,0
2592,35160,kThSxP6kRJAiUPqrS6DypsJwuP8aoEPr,7GRhBDsirIGkRZBtSMEzNTyDr2JQm4xx,2,0,0,0,0,0,2,0,2,0.2857142857142857,1,0.0,0,0,0,0,0,0,0,2,0,0,2,0
2593,35165,Gvn1GQVBkQxq6rZTkkY4CKnlRmLWyiJO,7GRhBDsirIGkRZBtSMEzNTyDr2JQm4xx,1,0,0,0,0,0,1,0,1,0.14285714285714285,1,0.0,0,0,0,0,0,0,0,1,0,0,1,1
2594,35167,eU4MPF9R01ru4sQN9giW756pdpNlnW4H,7GRhBDsirIGkRZBtSMEzNTyDr2JQm4xx,31,25,11,30,6,0,7,0,79,11.285714285714286,5,0.0,9,11,29,6,16,0,1,7,0,55,24,0
2595,35175,SWRtXIccwFeW0V06tTCrQAmJKwDAOcQm,7GRhBDsirIGkRZBtSMEzNTyDr2JQm4xx,1,0,0,0,0,0,1,0,1,0.14285714285714285,1,0.0,0,0,0,0,0,0,0,1,0,0,1,1
2596,35558,hJwtwnOzJaTrAeP4eXJAEwz2xbKsgc4M,7GRhBDsirIGkRZBtSMEzNTyDr2JQm4xx,3,0,0,0,0,0,6,0,6,0.8571428571428571,2,0.0,0,0,0,0,0,0,0,6,0,0,6,1
2597,35583,O36QxtTrV6jSigC0QBjRMiqSpx0KHX6w,7GRhBDsirIGkRZBtSMEzNTyDr2JQm4xx,100,190,73,178,58,27,25,0,551,78.71428571428571,7,0.0,98,73,151,58,92,27,27,25,0,380,171,0
2598,35592,WgQR6nrfyl7yDpgHC595JSoog2R9VhVs,7GRhBDsirIGkRZBtSMEzNTyDr2JQm4xx,103,227,88,173,63,29,24,1,605,86.42857142857143,12,0.0,101,88,135,63,126,29,38,24,1,387,218,0
2599,35594,d6aHeIWZcsirh8eDlHrmG2KrUzDWnJuj,7GRhBDsirIGkRZBtSMEzNTyDr2JQm4xx,11,14,4,0,1,0,6,0,25,3.5714285714285716,1,0.0,6,4,0,1,8,0,0,6,0,11,14,1
2600,35646,CCMzevo14iTCqMsIpKsbx331FhP08gFZ,7GRhBDsirIGkRZBtSMEzNTyDr2JQm4xx,2,0,0,0,0,0,2,0,2,0.2857142857142857,1,0.0,0,0,0,0,0,0,0,2,0,0,2,1
2601,35726,xHZbSROhwP4RRQerUVWvcNTfOGc2DHWf,7GRhBDsirIGkRZBtSMEzNTyDr2JQm4xx,59,168,67,103,31,60,49,1,479,68.42857142857143,13,0.0,45,67,84,31,123,60,19,49,1,227,252,1
2602,35753,aXYyJMDvVYwwKBbiO4CB25XlnDBfWYNg,7GRhBDsirIGkRZBtSMEzNTyDr2JQm4xx,18,27,9,18,1,11,6,0,72,10.285714285714286,3,0.0,14,9,15,1,13,11,3,6,0,39,33,0
2603,35817,Kneva8tRfI6BhvgFMe4i80mebf2hEQk0,7GRhBDsirIGkRZBtSMEzNTyDr2JQm4xx,9,5,4,0,2,0,5,0,16,2.2857142857142856,2,0.0,0,4,0,2,5,0,0,5,0,6,10,1
2604,35868,PeCugnCDRTxTqifK7mkc0ffuLTN5EPRT,7GRhBDsirIGkRZBtSMEzNTyDr2JQm4xx,7,10,4,0,1,0,4,0,19,2.7142857142857144,2,0.0,4,4,0,1,6,0,0,4,0,9,10,0
2605,37571,9jZsAxMdQXvLjxKIorcfAyZ7kTyyk2m3,A3fsA9Zfv1X2fVEQhTw51lKENdNrEqT3,19,25,13,14,2,3,11,0,68,9.714285714285714,4,0.0,0,13,14,2,25,3,0,11,0,29,39,1
2606,37590,ZHGbzWgnUfJJPdovMfpePS97QxPtktWe,SpATywNh6bZuzm8s1ceuBUnMUAeoAHHw,7,2,1,0,1,0,5,0,9,1.2857142857142858,1,0.0,0,1,0,1,2,0,0,5,0,2,7,1
2607,37593,ZmKF4tFBenzCeCXZcmDdE2tsuT4rzLPd,G8EPVSXsOYB5YQWZGiz1aVq5Pgr2GrQu,5,2,1,0,1,0,2,0,6,0.8571428571428571,1,0.0,0,1,0,1,2,0,0,2,0,2,4,1
2608,37599,yVtzjNm7Xgz14yjopuLvCh7VRZR9RBra,bWdj2GDclj5ofokWjzoa5jAwMkxCykd6,7,13,5,2,6,0,7,0,33,4.714285714285714,2,0.0,5,5,2,6,8,0,0,7,0,18,15,1
2609,37600,NHGmMinB9WoQusKCx50F4M4nJF124Ms4,A3fsA9Zfv1X2fVEQhTw51lKENdNrEqT3,58,58,41,56,24,17,41,5,242,34.57142857142857,8,0.0,3,41,50,24,55,17,6,41,5,118,124,1
2610,37607,NvmmlHTgNmxqyrQU3a9c6oM8kVrIYu3Q,SpATywNh6bZuzm8s1ceuBUnMUAeoAHHw,19,26,12,0,9,0,7,0,54,7.714285714285714,4,0.0,0,12,0,9,26,0,0,7,0,21,33,1
2611,37613,deaOh1cCfPHHygo0HX3j8JDIzRZNPF7P,SpATywNh6bZuzm8s1ceuBUnMUAeoAHHw,10,6,3,13,2,0,1,0,25,3.5714285714285716,2,0.0,2,3,12,2,4,0,1,1,0,19,6,0
2612,37618,ABlVlNkPi30ZMlFLrcsAhP5jZW6rJhdZ,A3fsA9Zfv1X2fVEQhTw51lKENdNrEqT3,22,16,13,0,11,0,4,0,44,6.285714285714286,3,0.0,0,13,0,11,16,0,0,4,0,24,20,1
2613,37621,7ynsHGhJ1N4494Hez57ckblgtBNGbed9,A3fsA9Zfv1X2fVEQhTw51lKENdNrEqT3,3,0,0,0,0,0,3,0,3,0.42857142857142855,2,0.0,0,0,0,0,0,0,0,3,0,0,3,1
2614,37622,3hFWpwvaMZB4do5VrkI46WX7phUXE8q9,SpATywNh6bZuzm8s1ceuBUnMUAeoAHHw,1,0,0,0,0,0,2,0,2,0.2857142857142857,1,0.0,0,0,0,0,0,0,0,2,0,0,2,1
2615,37627,61Btwz5kWZaS3OIGnNTMXi3lqbtcLCB7,SpATywNh6bZuzm8s1ceuBUnMUAeoAHHw,26,114,19,17,5,0,53,0,208,29.714285714285715,11,0.0,12,19,17,5,102,0,0,53,0,53,155,1
2616,37628,9S5uoFAiVHVF4D2DNR23wCkbQZ8LhtES,RXDvfPUBYFlVdlueBFbLW0mhhAyGEqpt,31,43,13,36,10,0,8,0,110,15.714285714285714,5,0.0,12,13,34,10,31,0,2,8,0,69,41,0
2617,37655,W68HJCLMGaPDXLquuNsADTmn70KIcSIQ,G8EPVSXsOYB5YQWZGiz1aVq5Pgr2GrQu,2,0,0,0,0,0,4,0,4,0.5714285714285714,1,0.0,0,0,0,0,0,0,0,4,0,0,4,1
2618,37656,BGZaaH5HDVuGvqaegp5MyJblPEuJpcXP,bWdj2GDclj5ofokWjzoa5jAwMkxCykd6,2,0,0,0,0,0,2,0,2,0.2857142857142857,1,0.0,0,0,0,0,0,0,0,2,0,0,2,1
2619,37657,h93nu205LxG6yA79vswKf1FixgIn79rm,G8EPVSXsOYB5YQWZGiz1aVq5Pgr2GrQu,10,11,5,0,0,1,7,1,25,3.5714285714285716,1,0.0,4,5,0,0,7,1,0,7,1,9,16,1
2620,37658,k3sYdhuU0JisiJgPpOdae3U2CoUcaazJ,SpATywNh6bZuzm8s1ceuBUnMUAeoAHHw,16,24,7,12,3,23,7,1,77,11.0,2,0.0,10,7,12,3,14,23,0,7,1,32,45,1
2621,37661,BGZaaH5HDVuGvqaegp5MyJblPEuJpcXP,A3fsA9Zfv1X2fVEQhTw51lKENdNrEqT3,2,0,0,0,0,0,2,0,2,0.2857142857142857,1,0.0,0,0,0,0,0,0,0,2,0,0,2,0
2622,37675,4P8kDd8yuaZj29FYuMADbc9LGiIxpIwD,bWdj2GDclj5ofokWjzoa5jAwMkxCykd6,23,25,6,95,5,5,22,1,159,22.714285714285715,3,0.0,9,6,87,5,16,5,8,22,1,107,52,1
2623,37686,UkQJwGAwu2oSVR7bdUsiWWEqFzH2qHlf,SpATywNh6bZuzm8s1ceuBUnMUAeoAHHw,26,46,8,34,3,23,12,0,126,18.0,5,0.0,9,8,29,3,37,23,5,12,0,49,77,0
2624,37694,umy7brIUz48bN1VUJsZEuHA9by5FINCa,A3fsA9Zfv1X2fVEQhTw51lKENdNrEqT3,23,27,21,0,13,3,16,0,80,11.428571428571429,2,0.0,0,21,0,13,27,3,0,16,0,34,46,1
2625,37695,KaDaT2PXnsmD67HkbCpFnRySFfo61Clp,A3fsA9Zfv1X2fVEQhTw51lKENdNrEqT3,19,20,15,0,13,0,3,0,51,7.285714285714286,2,0.0,0,15,0,13,20,0,0,3,0,28,23,1
2626,37700,bLIF0ETNcg7fjkutu8YBWJptM3zxtu2Z,A3fsA9Zfv1X2fVEQhTw51lKENdNrEqT3,9,11,11,0,11,1,12,0,46,6.571428571428571,3,0.0,0,11,0,11,11,1,0,12,0,22,24,1
2627,37712,K8l2u7bOqtMijaHas6Baa4xmjexwxyjr,G8EPVSXsOYB5YQWZGiz1aVq5Pgr2GrQu,7,3,2,0,2,0,6,0,13,1.8571428571428572,1,0.0,0,2,0,2,3,0,0,6,0,4,9,0
2628,37715,vfZ107RlnUxktrRHn8r9duLiSNHxQt59,SpATywNh6bZuzm8s1ceuBUnMUAeoAHHw,13,8,6,2,3,8,3,0,30,4.285714285714286,1,0.0,0,6,2,3,8,8,0,3,0,11,19,1
2629,37730,z3YnX73v2uoVHmuLGzQD2gKKBoJqIQxK,bWdj2GDclj5ofokWjzoa5jAwMkxCykd6,36,96,51,184,34,2,29,2,398,56.857142857142854,9,0.0,26,51,166,34,70,2,18,29,2,277,121,0
2630,37740,B1u0c5LDTPlzBAhbGuUr9zut2NBFb4ik,G8EPVSXsOYB5YQWZGiz1aVq5Pgr2GrQu,8,4,3,0,2,0,2,0,11,1.5714285714285714,1,0.0,0,3,0,2,4,0,0,2,0,5,6,1
2631,37743,5IM8g7YMOYo5qH7Yu3x31T3JkVOH9iqe,A3fsA9Zfv1X2fVEQhTw51lKENdNrEqT3,17,26,8,0,7,0,2,0,43,6.142857142857143,1,0.0,0,8,0,7,26,0,0,2,0,15,28,1
2632,37744,YGd4irzc5KMR1PH2KdOtbCkghLMZ2dPk,bWdj2GDclj5ofokWjzoa5jAwMkxCykd6,4,2,2,0,0,0,2,0,6,0.8571428571428571,1,0.0,0,2,0,0,2,0,0,2,0,2,4,1
2633,37750,GpHiOkm3UY3R1sigoD8RZsfbPyCjOvL2,bWdj2GDclj5ofokWjzoa5jAwMkxCykd6,12,39,22,0,17,0,18,1,97,13.857142857142858,10,0.0,0,22,0,17,39,0,0,18,1,39,58,1
2634,37754,qzjZHUzfivuSEB3h2CxO69AUVaBX51Ki,A3fsA9Zfv1X2fVEQhTw51lKENdNrEqT3,2,0,0,0,0,0,5,0,5,0.7142857142857143,2,0.0,0,0,0,0,0,0,0,5,0,0,5,1
2635,37767,b9kodEhA94IDSBT3ykY4QWiqr6rjyws0,G8EPVSXsOYB5YQWZGiz1aVq5Pgr2GrQu,1,0,0,0,0,0,1,0,1,0.14285714285714285,1,0.0,0,0,0,0,0,0,0,1,0,0,1,1
2636,37768,CeSP4PMtab0Lz3R25BXEghWPiV1yY5Ef,SpATywNh6bZuzm8s1ceuBUnMUAeoAHHw,15,22,3,17,0,9,17,2,70,10.0,3,0.0,9,3,15,0,13,9,2,17,2,27,43,1
2637,37778,MT2eJtF59AVNdUs7mwFqputROb2HgEm3,A3fsA9Zfv1X2fVEQhTw51lKENdNrEqT3,99,43,29,244,19,0,15,1,351,50.142857142857146,6,0.0,7,29,203,19,36,0,41,15,1,258,93,0
2638,37792,fXZ6GxDg4jr2jydxDfAmDq6HhmCcTKhM,bWdj2GDclj5ofokWjzoa5jAwMkxCykd6,6,1,1,0,1,0,3,1,7,1.0,1,0.0,0,1,0,1,1,0,0,3,1,2,5,1
2639,37794,uQjl8NGtIQkRfoe9edBiMgtYYmdkzVXR,A3fsA9Zfv1X2fVEQhTw51lKENdNrEqT3,70,127,72,134,29,8,44,1,415,59.285714285714285,12,0.0,11,72,107,29,116,8,27,44,1,219,196,0
2640,37795,AtIH4YI3eYIPCQxtOLtZgwyhSnXOdn2e,A3fsA9Zfv1X2fVEQhTw51lKENdNrEqT3,1,0,0,0,0,0,1,0,1,0.14285714285714285,1,0.0,0,0,0,0,0,0,0,1,0,0,1,1
2641,37796,Zl7A4QMlAs6IcbXcPt0cXmqZJLFzPwcf,SpATywNh6bZuzm8s1ceuBUnMUAeoAHHw,15,14,7,10,5,0,10,0,46,6.571428571428571,2,0.0,4,7,9,5,10,0,1,10,0,25,21,1
2642,37799,t7ddfllmrYfl93sdsVEbTfmmaWswoGkm,bWdj2GDclj5ofokWjzoa5jAwMkxCykd6,11,21,11,0,7,0,11,1,51,7.285714285714286,3,0.0,2,11,0,7,19,0,0,11,1,20,31,1
2643,37806,0FuB48Egjj7khWsNq1DtKTVsB7OEgidM,bWdj2GDclj5ofokWjzoa5jAwMkxCykd6,21,32,22,0,15,0,13,0,82,11.714285714285714,3,0.0,2,22,0,15,30,0,0,13,0,39,43,1
2644,37809,eEE69ZWSNrdmveqNEUHZYk60iG9wpaEc,SpATywNh6bZuzm8s1ceuBUnMUAeoAHHw,26,50,23,25,5,32,13,0,148,21.142857142857142,5,0.0,13,23,22,5,37,32,3,13,0,63,85,1
2645,37810,NcPdgwZnF0RkLUxC56tG83zG3V3KP94S,SpATywNh6bZuzm8s1ceuBUnMUAeoAHHw,25,25,15,27,7,14,12,1,101,14.428571428571429,5,0.0,8,15,23,7,17,14,4,12,1,53,48,1
2646,37820,VjekNiOqthnLG6rS8JBJtCSICch28JV9,SpATywNh6bZuzm8s1ceuBUnMUAeoAHHw,11,12,9,0,5,0,8,0,34,4.857142857142857,3,0.0,0,9,0,5,12,0,0,8,0,14,20,0
2647,37823,2Y3h62Lps0fU6B3C4MXM4YNVNDf25XBr,SpATywNh6bZuzm8s1ceuBUnMUAeoAHHw,27,48,29,49,20,1,6,0,153,21.857142857142858,6,0.0,12,29,38,20,36,1,11,6,0,99,54,0
2648,37825,C2tzR0PThnHl9xmZylE5Te8es3KNWViY,SpATywNh6bZuzm8s1ceuBUnMUAeoAHHw,1,0,0,0,0,0,1,0,1,0.14285714285714285,1,0.0,0,0,0,0,0,0,0,1,0,0,1,1
2649,37827,C2tzR0PThnHl9xmZylE5Te8es3KNWViY,bWdj2GDclj5ofokWjzoa5jAwMkxCykd6,8,15,0,0,1,1,6,0,23,3.2857142857142856,5,0.0,0,0,0,1,15,1,0,6,0,1,22,1
2650,37830,0FuB48Egjj7khWsNq1DtKTVsB7OEgidM,A3fsA9Zfv1X2fVEQhTw51lKENdNrEqT3,44,34,27,0,20,0,14,1,96,13.714285714285714,3,0.0,0,27,0,20,34,0,0,14,1,47,49,0
2651,37841,H4f84AflSuLjxZbar9MNvTHEIA8lIMO0,G8EPVSXsOYB5YQWZGiz1aVq5Pgr2GrQu,8,2,2,0,2,0,3,0,9,1.2857142857142858,1,0.0,0,2,0,2,2,0,0,3,0,4,5,1
2652,37842,QeQqhAEpCOGJwaPPp0lj3OsPiBcGFat2,SpATywNh6bZuzm8s1ceuBUnMUAeoAHHw,14,52,3,4,3,1,15,0,78,11.142857142857142,5,0.0,14,3,4,3,38,1,0,15,0,24,54,0
2653,37851,6ovqVSF3YZ6bnWJaJ7v2dHPROWXVVlFQ,SpATywNh6bZuzm8s1ceuBUnMUAeoAHHw,15,14,6,10,3,0,4,2,39,5.571428571428571,2,0.0,6,6,10,3,8,0,0,4,2,25,14,1
2654,37857,fhNT15VFhs3gsHOTo44snQYPYn9BDZ0e,A3fsA9Zfv1X2fVEQhTw51lKENdNrEqT3,5,6,3,0,0,3,4,0,16,2.2857142857142856,2,0.0,1,3,0,0,5,3,0,4,0,4,12,1
2655,37862,i454zkNvATiV1XJbjzVrf2ArWE1JYXx7,G8EPVSXsOYB5YQWZGiz1aVq5Pgr2GrQu,6,1,1,0,1,0,5,0,8,1.1428571428571428,1,0.0,0,1,0,1,1,0,0,5,0,2,6,1
2656,37879,xx9GC4KvGKaMlifXkbb8bDYUKB0PSURf,G8EPVSXsOYB5YQWZGiz1aVq5Pgr2GrQu,14,9,6,0,5,0,4,0,24,3.4285714285714284,1,0.0,0,6,0,5,9,0,0,4,0,11,13,1
2657,37900,qZhmmNUvkNXdf3u04DTUQOFEBxxO10p4,SpATywNh6bZuzm8s1ceuBUnMUAeoAHHw,29,74,31,22,7,4,28,0,166,23.714285714285715,11,0.0,13,31,20,7,61,4,2,28,0,71,95,0
2658,37901,blQFA8HzhNQeb8MMYJXyJW6sPMdvZQKn,bWdj2GDclj5ofokWjzoa5jAwMkxCykd6,7,4,2,0,1,0,8,0,15,2.142857142857143,2,0.0,0,2,0,1,4,0,0,8,0,3,12,1
2659,37902,fHWbyI7D8dlYSwaHNTLNlsq8suMt5t3C,SpATywNh6bZuzm8s1ceuBUnMUAeoAHHw,25,83,37,33,10,77,50,4,294,42.0,6,0.0,14,37,30,10,69,77,3,50,4,91,203,1
2660,37917,zov347eGa3QeB2nEEXWZhFIKLoCmgiMD,SpATywNh6bZuzm8s1ceuBUnMUAeoAHHw,10,34,4,0,2,2,8,0,50,7.142857142857143,4,0.0,0,4,0,2,34,2,0,8,0,6,44,0
2661,37922,j3dtYivg2u73ZbuSWbPPpSBQQec6vBYH,A3fsA9Zfv1X2fVEQhTw51lKENdNrEqT3,13,27,14,0,4,0,15,0,60,8.571428571428571,9,0.0,0,14,0,4,27,0,0,15,0,18,42,0
2662,37923,EHdY3AEgr2nI6jaAM9bjHY2nqgEPned4,SpATywNh6bZuzm8s1ceuBUnMUAeoAHHw,11,12,4,5,2,0,4,0,27,3.857142857142857,2,0.0,2,4,4,2,10,0,1,4,0,12,15,1
2663,37925,v1W3YvgJ0IFCSGXyKmwZ2bb9TVfgDIwv,G8EPVSXsOYB5YQWZGiz1aVq5Pgr2GrQu,6,6,2,0,2,0,1,0,11,1.5714285714285714,1,0.0,3,2,0,2,3,0,0,1,0,7,4,0
2664,37935,OkJ0lKmMXuQ2MGftQ8Isfw1JciMpapRC,SpATywNh6bZuzm8s1ceuBUnMUAeoAHHw,21,47,27,7,15,2,16,1,115,16.428571428571427,6,0.0,3,27,7,15,44,2,0,16,1,52,63,0
2665,37940,QmHQ7ayFECnRsgCVpHpJI6yMYR4kf5re,bWdj2GDclj5ofokWjzoa5jAwMkxCykd6,37,51,29,193,6,23,11,0,313,44.714285714285715,6,0.0,10,29,165,6,41,23,28,11,0,210,103,0
2666,37960,bz2uqvuFRCLaJmY4vFLIXrs9g0cTBHJC,A3fsA9Zfv1X2fVEQhTw51lKENdNrEqT3,42,21,15,52,9,0,13,3,113,16.142857142857142,5,0.0,1,15,46,9,20,0,6,13,3,71,42,1
2667,37973,k0lvFNaTVHTtB1XHBZ8229ej4v1r4rPk,bWdj2GDclj5ofokWjzoa5jAwMkxCykd6,10,9,1,0,1,6,15,1,33,4.714285714285714,3,0.0,0,1,0,1,9,6,0,15,1,2,31,0
2668,37982,OJtJM3YEXIy4oJKwRv1QkycNqhb8JLoi,SpATywNh6bZuzm8s1ceuBUnMUAeoAHHw,6,2,1,0,1,0,3,2,9,1.2857142857142858,1,0.0,0,1,0,1,2,0,0,3,2,2,7,1
2669,37983,YG3IIEQOezPClODg4SNvtFayndWcEJ7a,A3fsA9Zfv1X2fVEQhTw51lKENdNrEqT3,8,11,5,0,1,0,5,0,22,3.142857142857143,2,0.0,0,5,0,1,11,0,0,5,0,6,16,1
2670,37988,fUqxJqppQTNVXv13r4wKORaBU4L22bhx,SpATywNh6bZuzm8s1ceuBUnMUAeoAHHw,5,3,2,0,2,0,2,0,9,1.2857142857142858,1,0.0,0,2,0,2,3,0,0,2,0,4,5,1
2671,37989,jkwnVusgQrKbxfhd5nIkbaklULLOZT9D,A3fsA9Zfv1X2fVEQhTw51lKENdNrEqT3,1,0,0,0,0,0,2,0,2,0.2857142857142857,1,0.0,0,0,0,0,0,0,0,2,0,0,2,1
2672,38003,gxc60X8EJb2yIw8hE5NeguZan8o3YXLZ,SpATywNh6bZuzm8s1ceuBUnMUAeoAHHw,16,14,6,10,3,1,6,1,41,5.857142857142857,2,0.0,2,6,9,3,12,1,1,6,1,20,21,1
2673,38004,QEbMAkKsvpPGPL1XkTiHjXblquVwKrlD,A3fsA9Zfv1X2fVEQhTw51lKENdNrEqT3,17,21,4,0,1,0,19,1,46,6.571428571428571,5,0.0,1,4,0,1,20,0,0,19,1,6,40,1
2674,38006,KRzA1Kk4qiSF9draiukb1XAlRpMcb8Gh,SpATywNh6bZuzm8s1ceuBUnMUAeoAHHw,5,2,1,0,1,0,2,0,6,0.8571428571428571,1,0.0,0,1,0,1,2,0,0,2,0,2,4,1
2675,38016,i9wjeQMhaeiCRSFBW7M0FOy9yJ5VeZZF,SpATywNh6bZuzm8s1ceuBUnMUAeoAHHw,8,15,2,0,0,0,13,0,30,4.285714285714286,2,0.0,0,2,0,0,15,0,0,13,0,2,28,1
2676,38026,u82lBhpDxJIwlZISEntCxj1zgVFdW0vT,G8EPVSXsOYB5YQWZGiz1aVq5Pgr2GrQu,1,0,0,0,0,0,1,0,1,0.14285714285714285,1,0.0,0,0,0,0,0,0,0,1,0,0,1,1
2677,38033,KlQIh6CJiUFTrdMyk4Y8sFKMj5TT9ON4,A3fsA9Zfv1X2fVEQhTw51lKENdNrEqT3,26,20,15,0,10,1,8,1,55,7.857142857142857,2,0.0,2,15,0,10,18,1,0,8,1,27,28,1
2678,38047,KkXSOHPa8OPkVJQjN92ejg7MqYYerSuw,A3fsA9Zfv1X2fVEQhTw51lKENdNrEqT3,5,3,2,0,2,0,5,0,12,1.7142857142857142,2,0.0,0,2,0,2,3,0,0,5,0,4,8,1
2679,38068,PmZJAFj6wJkOD163WkhaJjRHdYOMjBZW,SpATywNh6bZuzm8s1ceuBUnMUAeoAHHw,24,25,11,18,5,64,7,1,131,18.714285714285715,6,0.0,9,11,15,5,16,64,3,7,1,40,91,1
2680,38070,sKmcegdtnOHdb8n0mSxwdw5R2hJqVxhV,SpATywNh6bZuzm8s1ceuBUnMUAeoAHHw,6,3,2,0,2,0,1,0,8,1.1428571428571428,1,0.0,0,2,0,2,3,0,0,1,0,4,4,1
2681,38087,QyvVrWztIgSCCViLyqSM2D5NbMV2fEBm,SpATywNh6bZuzm8s1ceuBUnMUAeoAHHw,1,0,0,0,0,0,1,0,1,0.14285714285714285,1,0.0,0,0,0,0,0,0,0,1,0,0,1,0
2682,38092,32tAPwhpK9bCQqIAiBE9WTs1sTNu9Vyf,A3fsA9Zfv1X2fVEQhTw51lKENdNrEqT3,1,0,0,0,0,0,1,0,1,0.14285714285714285,1,0.0,0,0,0,0,0,0,0,1,0,0,1,1
2683,38097,MkuttLQlAg2ibzg21YKyuq14uYFl6Q9Q,A3fsA9Zfv1X2fVEQhTw51lKENdNrEqT3,10,30,7,0,0,1,13,1,52,7.428571428571429,3,0.0,10,7,0,0,20,1,0,13,1,17,35,1
2684,38100,NsLNEhFZrusC9duqTXuavXuymnAo5QEg,SpATywNh6bZuzm8s1ceuBUnMUAeoAHHw,15,35,3,19,1,4,16,0,78,11.142857142857142,4,0.0,12,3,16,1,23,4,3,16,0,32,46,1
2685,38105,vrESC5Tu2ZaCb3FZy3EK8oGteg0Z9Ni5,SpATywNh6bZuzm8s1ceuBUnMUAeoAHHw,9,10,2,2,1,1,2,0,18,2.5714285714285716,2,0.0,0,2,2,1,10,1,0,2,0,5,13,1
2686,38106,ayqwdyDC23QUsfyE7IPhnu9xrtfBNG6f,A3fsA9Zfv1X2fVEQhTw51lKENdNrEqT3,8,3,2,0,2,0,7,0,14,2.0,1,0.0,0,2,0,2,3,0,0,7,0,4,10,1
2687,38107,LHHlrNsXCuatY288NK6FIa7kJtq4Rtqs,bWdj2GDclj5ofokWjzoa5jAwMkxCykd6,8,5,4,0,3,0,8,0,20,2.857142857142857,1,0.0,0,4,0,3,5,0,0,8,0,7,13,1
2688,38111,QRq9SneqdOEdNrPCbzGfNOJsUrpMzzSX,bWdj2GDclj5ofokWjzoa5jAwMkxCykd6,6,2,1,0,1,1,5,1,11,1.5714285714285714,2,0.0,0,1,0,1,2,1,0,5,1,2,9,1
2689,38123,c0naQwXHS50DG3yNNBzMC8iE3KoRWTjm,SpATywNh6bZuzm8s1ceuBUnMUAeoAHHw,7,1,1,0,1,0,4,1,8,1.1428571428571428,1,0.0,0,1,0,1,1,0,0,4,1,2,6,1
2690,38140,xGWjos5nKrn7rxQEQkV1V6pBI2rS4Q4S,SpATywNh6bZuzm8s1ceuBUnMUAeoAHHw,15,28,17,18,8,10,3,0,84,12.0,2,0.0,7,17,15,8,21,10,3,3,0,47,37,1
2691,38144,0Hl4WpPV6z0OC8rO0L3mZy6harAUBUs7,G8EPVSXsOYB5YQWZGiz1aVq5Pgr2GrQu,74,101,21,178,13,5,25,1,344,49.142857142857146,9,0.0,35,21,143,13,66,5,35,25,1,212,132,1
2692,38147,OHOHfGJUvl8C8rOynV86vKj0FrD2jzFO,SpATywNh6bZuzm8s1ceuBUnMUAeoAHHw,24,32,4,35,2,3,22,0,98,14.0,6,0.0,7,4,29,2,25,3,6,22,0,42,56,1
2693,38154,qazSXcMxbAaqtIZJoNDUrPRsgwDYZFDz,SpATywNh6bZuzm8s1ceuBUnMUAeoAHHw,1,0,0,0,0,0,1,0,1,0.14285714285714285,1,0.0,0,0,0,0,0,0,0,1,0,0,1,1
2694,38155,cqdnmjbJq0lDv2xgeKuzXqVr5xQytWr0,A3fsA9Zfv1X2fVEQhTw51lKENdNrEqT3,6,4,2,0,1,0,2,0,9,1.2857142857142858,1,0.0,0,2,0,1,4,0,0,2,0,3,6,1
2695,38157,tHNSnLtZK1vGs5MVrEoD7S1mcW3GtFm4,SpATywNh6bZuzm8s1ceuBUnMUAeoAHHw,16,20,10,14,4,2,2,0,52,7.428571428571429,2,0.0,3,10,13,4,17,2,1,2,0,30,22,0
2696,38170,vs0vqlNXzuHsqVxOsB15kGfpvGf2pUt3,SpATywNh6bZuzm8s1ceuBUnMUAeoAHHw,19,58,31,24,6,0,12,0,131,18.714285714285715,9,0.0,15,31,24,6,43,0,0,12,0,76,55,0
2697,38176,c59GF0I0pecGycS0yL4PRG9aMLNUIigo,bWdj2GDclj5ofokWjzoa5jAwMkxCykd6,5,2,1,0,1,0,3,0,7,1.0,2,0.0,0,1,0,1,2,0,0,3,0,2,5,1
2698,38187,SX4dmJ5a5AfJLGZkCiiWab293xeIyxbW,SpATywNh6bZuzm8s1ceuBUnMUAeoAHHw,29,99,16,29,10,9,43,4,210,30.0,12,0.0,10,16,25,10,89,9,4,43,4,61,149,0
2699,38192,PfM2UIipqAa1BYASMdmivESfQH5kpXct,RXDvfPUBYFlVdlueBFbLW0mhhAyGEqpt,8,5,4,0,2,0,1,0,12,1.7142857142857142,1,0.0,0,4,0,2,5,0,0,1,0,6,6,0
2700,38201,hUScWllYUJ1urcx9IQ6nI2SqodbYOaw3,SpATywNh6bZuzm8s1ceuBUnMUAeoAHHw,14,23,8,21,5,0,2,0,59,8.428571428571429,2,0.0,8,8,17,5,15,0,4,2,0,38,21,0
2701,38203,fZom2mtwZsSiSJuSBhugfgY0ABzNEmyV,G8EPVSXsOYB5YQWZGiz1aVq5Pgr2GrQu,13,25,13,0,9,2,4,0,53,7.571428571428571,3,0.0,9,13,0,9,16,2,0,4,0,31,22,1
2702,38206,kKH4olslIcMX5RimtmBANWk2T6CuD4cI,G8EPVSXsOYB5YQWZGiz1aVq5Pgr2GrQu,16,11,4,55,2,0,12,0,84,12.0,2,0.0,1,4,46,2,10,0,9,12,0,53,31,1
2703,38219,EwpbggvNdZkeSTjdG48aEltlJYavm02s,bWdj2GDclj5ofokWjzoa5jAwMkxCykd6,7,14,1,0,0,0,3,0,18,2.5714285714285716,2,0.0,1,1,0,0,13,0,0,3,0,2,16,0
2704,38243,dwm6PFLf21BfXk9L9RgwIu033moNrMaZ,A3fsA9Zfv1X2fVEQhTw51lKENdNrEqT3,2,0,0,0,0,0,2,0,2,0.2857142857142857,1,0.0,0,0,0,0,0,0,0,2,0,0,2,1
2705,38245,9d3FbHjuwecHssUlcCF17pB1YrxPmjAd,SpATywNh6bZuzm8s1ceuBUnMUAeoAHHw,5,2,1,0,1,0,2,0,6,0.8571428571428571,1,0.0,0,1,0,1,2,0,0,2,0,2,4,1
2706,38252,S2i0VW7GN0ACeCnuAPN00XONM8w8kvsN,G8EPVSXsOYB5YQWZGiz1aVq5Pgr2GrQu,72,92,47,165,0,11,20,8,343,49.0,5,0.0,35,47,119,0,57,11,46,20,8,201,142,0
2707,38255,EwpbggvNdZkeSTjdG48aEltlJYavm02s,RXDvfPUBYFlVdlueBFbLW0mhhAyGEqpt,1,0,0,0,0,0,1,0,1,0.14285714285714285,1,0.0,0,0,0,0,0,0,0,1,0,0,1,1
2708,38261,h2cFTJnPj8CTdq0hhUdrEDtmsY30xXQA,G8EPVSXsOYB5YQWZGiz1aVq5Pgr2GrQu,10,20,5,2,1,0,5,0,33,4.714285714285714,3,0.0,6,5,1,1,14,0,1,5,0,13,20,1
2709,38264,DPr3Hy8387gfJi0Jc3ohxKBzY0mvhH1G,SpATywNh6bZuzm8s1ceuBUnMUAeoAHHw,15,19,8,16,1,34,10,2,90,12.857142857142858,5,0.0,6,8,16,1,13,34,0,10,2,31,59,0
2710,38267,xnr1pqResnWIFBWHoMthHT4GwMr3vBWt,SpATywNh6bZuzm8s1ceuBUnMUAeoAHHw,15,23,7,11,3,0,5,0,49,7.0,1,0.0,13,7,11,3,10,0,0,5,0,34,15,1
2711,38269,gzTBwYPoQwnODJJ2vedsUKp2EoGao5Fz,bWdj2GDclj5ofokWjzoa5jAwMkxCykd6,10,16,1,0,1,1,10,0,29,4.142857142857143,6,0.0,1,1,0,1,15,1,0,10,0,3,26,1
2712,38312,PzUJiLnP9HZJxQE6JmMTkx1KTzCMtAvI,A3fsA9Zfv1X2fVEQhTw51lKENdNrEqT3,1,0,0,0,0,0,1,0,1,0.14285714285714285,1,0.0,0,0,0,0,0,0,0,1,0,0,1,1
2713,38319,mGGeZkXtXipHfCgx75xnWUmx7JTil5yZ,SpATywNh6bZuzm8s1ceuBUnMUAeoAHHw,1,0,0,0,0,0,1,0,1,0.14285714285714285,1,0.0,0,0,0,0,0,0,0,1,0,0,1,1
2714,38330,ooLh9t6oSyJHSmVF4HH7sDMAh5QMFRua,bWdj2GDclj5ofokWjzoa5jAwMkxCykd6,7,10,1,0,0,2,15,2,30,4.285714285714286,3,0.0,1,1,0,0,9,2,0,15,2,2,28,1
2715,38342,C8IOBAC7DRHGJ1rz7pC1Kh8zvUK3Uruf,bWdj2GDclj5ofokWjzoa5jAwMkxCykd6,5,2,1,0,1,0,2,0,6,0.8571428571428571,1,0.0,0,1,0,1,2,0,0,2,0,2,4,1
2716,38345,skcEk7TV3jhSAknl5Kr7UawZFeqJNMzy,SpATywNh6bZuzm8s1ceuBUnMUAeoAHHw,9,10,6,0,5,0,3,0,24,3.4285714285714284,2,0.0,0,6,0,5,10,0,0,3,0,11,13,1
2717,38348,DTsOT0NTIRutfokoKq4yB8bQe3U1fEsD,SpATywNh6bZuzm8s1ceuBUnMUAeoAHHw,31,50,17,20,7,21,7,1,123,17.571428571428573,3,0.0,22,17,20,7,28,21,0,7,1,66,57,0
2718,38362,ngiOS4CfHKeFfCKjGfQvFpxE4ckVZ4zO,A3fsA9Zfv1X2fVEQhTw51lKENdNrEqT3,9,4,3,0,3,0,2,0,12,1.7142857142857142,1,0.0,0,3,0,3,4,0,0,2,0,6,6,1
2719,38369,P4MCLwt6pxkkQ1f3WWeAp7xsGAazOtsm,SpATywNh6bZuzm8s1ceuBUnMUAeoAHHw,4,2,1,0,1,0,3,0,7,1.0,2,0.0,0,1,0,1,2,0,0,3,0,2,5,1
2720,38371,a3kUr1OVNVUUdkmJCjmwPQMV5PtCkdEz,SpATywNh6bZuzm8s1ceuBUnMUAeoAHHw,2,0,0,0,0,0,2,0,2,0.2857142857142857,1,0.0,0,0,0,0,0,0,0,2,0,0,2,1
2721,38377,qkZ3BaC1M1zrdLJXoQVUnE0RxlFverb8,A3fsA9Zfv1X2fVEQhTw51lKENdNrEqT3,27,45,14,28,5,1,14,1,108,15.428571428571429,3,0.0,2,14,22,5,43,1,6,14,1,43,65,1
2722,38391,MAkHN0TS4uaTPgKLso4eQ3LTCDiU28De,bWdj2GDclj5ofokWjzoa5jAwMkxCykd6,12,30,16,0,10,1,15,0,72,10.285714285714286,2,0.0,2,16,0,10,28,1,0,15,0,28,44,1
2723,38393,NgT4xv3zS3UyiRdDnPLyxI49HQKeMn2D,G8EPVSXsOYB5YQWZGiz1aVq5Pgr2GrQu,62,117,6,118,8,14,33,2,298,42.57142857142857,6,0.0,56,6,87,8,61,14,31,33,2,157,141,1
2724,38407,JJYEr1YA7SClhqsLz61VElUYdghcCxlW,RXDvfPUBYFlVdlueBFbLW0mhhAyGEqpt,1,0,0,0,0,0,1,0,1,0.14285714285714285,1,0.0,0,0,0,0,0,0,0,1,0,0,1,1
2725,38420,YAaB5kbzMpno3yyQhEjSC43PC6r4FUut,bWdj2GDclj5ofokWjzoa5jAwMkxCykd6,3,2,1,0,0,1,4,0,8,1.1428571428571428,1,0.0,0,1,0,0,2,1,0,4,0,1,7,1
2726,38425,bIGq7A9r0Y0NLU65d3TOWeEFWRfABEv0,SpATywNh6bZuzm8s1ceuBUnMUAeoAHHw,17,18,9,14,3,0,13,1,58,8.285714285714286,1,0.0,7,9,12,3,11,0,2,13,1,31,27,1
2727,38431,gjPSUf8VbxmvyczDJCPomXU7IV6RTx1x,SpATywNh6bZuzm8s1ceuBUnMUAeoAHHw,17,28,7,10,3,23,25,4,100,14.285714285714286,2,0.0,10,7,9,3,18,23,1,25,4,29,71,1
2728,38447,dNx7yBBYuWpRM4BeMNLD1yOnUwcueGfB,bWdj2GDclj5ofokWjzoa5jAwMkxCykd6,11,25,5,40,4,5,13,1,93,13.285714285714286,2,0.0,5,5,39,4,20,5,1,13,1,53,40,0
2729,38453,oBHdxxTFsPNGTsDRAnTRpoi8FODO2mxr,SpATywNh6bZuzm8s1ceuBUnMUAeoAHHw,7,3,2,0,2,0,2,0,9,1.2857142857142858,1,0.0,0,2,0,2,3,0,0,2,0,4,5,1
2730,38454,dNx7yBBYuWpRM4BeMNLD1yOnUwcueGfB,SpATywNh6bZuzm8s1ceuBUnMUAeoAHHw,15,31,6,17,4,0,10,0,68,9.714285714285714,2,0.0,4,6,15,4,27,0,2,10,0,29,39,0
2731,38480,Y0R5Jnk5aIi2yBcZ9pxBzdem2y9Lpgok,SpATywNh6bZuzm8s1ceuBUnMUAeoAHHw,10,7,1,0,1,1,6,0,16,2.2857142857142856,1,0.0,0,1,0,1,7,1,0,6,0,2,14,1
2732,38494,nkWrffpo6kobU01lUWepcu6aQb60BdxH,SpATywNh6bZuzm8s1ceuBUnMUAeoAHHw,15,24,14,7,7,0,7,0,59,8.428571428571429,3,0.0,5,14,7,7,19,0,0,7,0,33,26,1
2733,38496,fd1NhQTFxl8TsBhiRc4F6bEwrFxQh7qC,SpATywNh6bZuzm8s1ceuBUnMUAeoAHHw,10,5,4,0,2,0,3,0,14,2.0,1,0.0,0,4,0,2,5,0,0,3,0,6,8,1
2734,38503,KGORZAfEVmjDZyD0eVVyErKdl89uylGc,G8EPVSXsOYB5YQWZGiz1aVq5Pgr2GrQu,5,4,0,0,0,0,1,0,5,0.7142857142857143,1,0.0,0,0,0,0,4,0,0,1,0,0,5,1
2735,38505,Dy0I4gbpbRtwh6YDRhpgGBLDEGUYJgO6,SpATywNh6bZuzm8s1ceuBUnMUAeoAHHw,9,13,5,0,0,2,5,1,26,3.7142857142857144,1,0.0,3,5,0,0,10,2,0,5,1,8,18,1
2736,38514,88mqKZu0uTbuMx2E6ZRqhvo4tmoL4qfn,SpATywNh6bZuzm8s1ceuBUnMUAeoAHHw,26,31,3,32,2,12,23,1,104,14.857142857142858,4,0.0,9,3,26,2,22,12,6,23,1,40,64,1
2737,38520,WRiHtWJX61VUGyAGQFSHJ3czdrgqxeQW,RXDvfPUBYFlVdlueBFbLW0mhhAyGEqpt,3,0,0,0,0,5,6,0,11,1.5714285714285714,5,0.0,0,0,0,0,0,5,0,6,0,0,11,1
2738,38525,859jT8mbwD5IkofIqzzz6ylJUi1ZwOt3,SpATywNh6bZuzm8s1ceuBUnMUAeoAHHw,18,31,14,10,9,21,12,1,98,14.0,3,0.0,9,14,9,9,22,21,1,12,1,41,57,1
2739,38532,8SZ4vKq1qHRfFJV3A51uH46l0c4FRvvR,SpATywNh6bZuzm8s1ceuBUnMUAeoAHHw,21,38,22,13,10,2,17,2,104,14.857142857142858,7,0.0,9,22,12,10,29,2,1,17,2,53,51,0
2740,38538,oBHdxxTFsPNGTsDRAnTRpoi8FODO2mxr,RXDvfPUBYFlVdlueBFbLW0mhhAyGEqpt,1,0,0,0,0,0,1,0,1,0.14285714285714285,1,0.0,0,0,0,0,0,0,0,1,0,0,1,1
2741,38541,uarVJhEs6XLW7Dw1D7iBgEK6zPe65WwX,bWdj2GDclj5ofokWjzoa5jAwMkxCykd6,1,0,0,0,0,0,1,0,1,0.14285714285714285,1,0.0,0,0,0,0,0,0,0,1,0,0,1,1
2742,38545,rarzYMzRoT8HAQOSSilddy5adopj22jf,A3fsA9Zfv1X2fVEQhTw51lKENdNrEqT3,8,7,0,0,0,0,1,0,8,1.1428571428571428,1,0.0,0,0,0,0,7,0,0,1,0,0,8,1
2743,38550,Xq1kPqflDNgXwQ2pEniNYUjMpkVzPp1m,A3fsA9Zfv1X2fVEQhTw51lKENdNrEqT3,36,31,16,50,13,2,4,0,116,16.571428571428573,4,0.0,3,16,48,13,28,2,2,4,0,80,36,1
2744,38551,UKG5GO5JWRjFVRMggOgvDIxPiEZzBxAO,bWdj2GDclj5ofokWjzoa5jAwMkxCykd6,5,7,2,0,1,0,2,0,12,1.7142857142857142,2,0.0,0,2,0,1,7,0,0,2,0,3,9,1
2745,38554,tajSblOKlQlXdpIXIOLLEJCHn56vIOfT,bWdj2GDclj5ofokWjzoa5jAwMkxCykd6,21,74,27,80,13,66,32,0,292,41.714285714285715,8,0.0,14,27,70,13,60,66,10,32,0,124,168,1
2746,38556,rajcXZ0kL5d9yXQIc9HHtBEyfRs8vn2R,G8EPVSXsOYB5YQWZGiz1aVq5Pgr2GrQu,6,4,1,0,1,0,3,0,9,1.2857142857142858,2,0.0,0,1,0,1,4,0,0,3,0,2,7,1
2747,38587,NeX0NKDgti39PYJeedkcSvEJfGuCFAhK,SpATywNh6bZuzm8s1ceuBUnMUAeoAHHw,11,5,3,0,3,0,5,0,16,2.2857142857142856,1,0.0,1,3,0,3,4,0,0,5,0,7,9,1
2748,38596,spd8M0wss3Tbv0YQ5WcIllIwTexcZnnW,SpATywNh6bZuzm8s1ceuBUnMUAeoAHHw,24,67,7,38,3,0,12,0,127,18.142857142857142,8,0.0,7,7,33,3,60,0,5,12,0,50,77,0
2749,38602,KbRlzY47exomwt4drbIiBF6s4vNevAUk,A3fsA9Zfv1X2fVEQhTw51lKENdNrEqT3,40,21,16,60,12,0,4,0,113,16.142857142857142,1,0.0,2,16,59,12,19,0,1,4,0,89,24,1
2750,38605,VPjMKah4KBMlWaK4uQInEcrWLVtwuYU3,SpATywNh6bZuzm8s1ceuBUnMUAeoAHHw,8,6,4,0,1,0,8,1,20,2.857142857142857,2,0.0,0,4,0,1,6,0,0,8,1,5,15,1
2751,38610,qatSZvztGH03ZmpAnP6syWYERxxmPTgm,SpATywNh6bZuzm8s1ceuBUnMUAeoAHHw,8,5,4,0,3,0,5,0,17,2.4285714285714284,1,0.0,0,4,0,3,5,0,0,5,0,7,10,1
2752,38618,6zUyeP7S7jGCTdu7QvSdhvgcWdRlZ9vk,A3fsA9Zfv1X2fVEQhTw51lKENdNrEqT3,11,14,5,0,3,0,13,0,35,5.0,2,0.0,0,5,0,3,14,0,0,13,0,8,27,1
2753,38621,C800geUBh3GYBhoh4cW6ReKUGj5LAMGi,SpATywNh6bZuzm8s1ceuBUnMUAeoAHHw,18,21,3,17,3,53,35,0,132,18.857142857142858,6,0.0,3,3,16,3,18,53,1,35,0,25,107,0
2754,38623,aKS3VkxSVtZSsON0tlb1uUJK6seiU1iY,SpATywNh6bZuzm8s1ceuBUnMUAeoAHHw,16,26,14,21,6,0,9,5,81,11.571428571428571,3,0.0,6,14,17,6,20,0,4,9,5,43,38,1
2755,38625,Na52PtAqm4VlTMUv1OPLGNjij0a5votC,A3fsA9Zfv1X2fVEQhTw51lKENdNrEqT3,18,25,12,0,6,15,12,0,70,10.0,3,0.0,0,12,0,6,25,15,0,12,0,18,52,1
2756,38636,xbw9nCFRWInH7KOVpMVJ0cKpswH8IEpv,SpATywNh6bZuzm8s1ceuBUnMUAeoAHHw,13,20,4,18,0,2,9,0,53,7.571428571428571,3,0.0,2,4,16,0,18,2,2,9,0,22,31,0
2757,38637,aYZOvavq8vAsMixc171e3LCkk7Ck4eQv,SpATywNh6bZuzm8s1ceuBUnMUAeoAHHw,2,0,0,0,0,0,2,0,2,0.2857142857142857,1,0.0,0,0,0,0,0,0,0,2,0,0,2,1
2758,38649,I6Zefk3suQV0ULhgPf2DN9gGAf2yKSKv,SpATywNh6bZuzm8s1ceuBUnMUAeoAHHw,10,17,6,0,0,2,6,0,31,4.428571428571429,2,0.0,0,6,0,0,17,2,0,6,0,6,25,1
2759,38668,NjnyUEkQdbuj3M7NhvY8iDqgWMA59DIH,SpATywNh6bZuzm8s1ceuBUnMUAeoAHHw,14,11,7,3,5,2,7,1,36,5.142857142857143,2,0.0,2,7,3,5,9,2,0,7,1,17,19,1
2760,38670,dg0Zm4MjeckxnEiOKa4Gh8nunN8SFI0L,SpATywNh6bZuzm8s1ceuBUnMUAeoAHHw,4,2,1,0,0,0,2,0,5,0.7142857142857143,1,0.0,0,1,0,0,2,0,0,2,0,1,4,1
2761,38676,aWfbena9lEo41V5W87oDDgjvcz4pLKtN,SpATywNh6bZuzm8s1ceuBUnMUAeoAHHw,30,39,16,25,9,1,18,2,110,15.714285714285714,4,0.0,14,16,22,9,25,1,3,18,2,61,49,0
2762,38679,5LOlerEFHf0UNcpvuhvEHGBh6ERlMDur,G8EPVSXsOYB5YQWZGiz1aVq5Pgr2GrQu,9,7,3,0,1,5,9,0,25,3.5714285714285716,4,0.0,0,3,0,1,7,5,0,9,0,4,21,0
2763,38685,FncubT1DgrtJxWo1YRhPHqwgNARiG5Jv,SpATywNh6bZuzm8s1ceuBUnMUAeoAHHw,22,44,3,18,2,0,12,0,79,11.285714285714286,5,0.0,9,3,17,2,35,0,1,12,0,31,48,0
2764,38687,RfCEa3pRuKLOxQiUZgZZMFg3JntXDg1m,SpATywNh6bZuzm8s1ceuBUnMUAeoAHHw,13,28,15,0,9,0,11,0,63,9.0,4,0.0,0,15,0,9,28,0,0,11,0,24,39,0
2765,38688,spd8M0wss3Tbv0YQ5WcIllIwTexcZnnW,A3fsA9Zfv1X2fVEQhTw51lKENdNrEqT3,6,11,0,0,0,0,2,0,13,1.8571428571428572,3,0.0,0,0,0,0,11,0,0,2,0,0,13,1
2766,38692,ktbF3sxXQk0MrToCOKFGvH2bCmfBVgYK,G8EPVSXsOYB5YQWZGiz1aVq5Pgr2GrQu,39,72,23,6,19,1,9,0,130,18.571428571428573,4,0.0,19,23,4,19,53,1,2,9,0,65,65,0
2767,38703,bDOMCQV7nFdKo0pDqOPr3ECLpgkdBCSt,bWdj2GDclj5ofokWjzoa5jAwMkxCykd6,10,9,2,0,1,1,6,1,20,2.857142857142857,2,0.0,0,2,0,1,9,1,0,6,1,3,17,1
2768,38704,LbhBqPcHsayzBPTM5h5jHXG3yJonlt5t,A3fsA9Zfv1X2fVEQhTw51lKENdNrEqT3,44,36,30,72,22,8,14,0,182,26.0,1,0.0,1,30,63,22,35,8,9,14,0,116,66,1
2769,38708,QWAnJ98MRtHXbl78XXr3UpScat4E7MnZ,SpATywNh6bZuzm8s1ceuBUnMUAeoAHHw,24,34,10,23,4,0,5,0,76,10.857142857142858,3,0.0,10,10,23,4,24,0,0,5,0,47,29,0
2770,38719,UIE935UirfemaybvWwRc5Sijo8VfPEYO,SpATywNh6bZuzm8s1ceuBUnMUAeoAHHw,7,6,4,0,2,0,5,0,17,2.4285714285714284,2,0.0,0,4,0,2,6,0,0,5,0,6,11,1
2771,38757,sEqqQzJgfFwEJ59pjhsH9YLQDd58mQLD,SpATywNh6bZuzm8s1ceuBUnMUAeoAHHw,7,13,1,0,0,0,5,0,19,2.7142857142857144,3,0.0,2,1,0,0,11,0,0,5,0,3,16,1
2772,38759,JBGQp737lLGmxKZ5ElVyvCkZ4zEqlLXt,SpATywNh6bZuzm8s1ceuBUnMUAeoAHHw,5,3,0,0,0,0,2,0,5,0.7142857142857143,1,0.0,0,0,0,0,3,0,0,2,0,0,5,1
2773,38769,OygU41dc8lyatpKc4JEBkP0ni21xzfvB,SpATywNh6bZuzm8s1ceuBUnMUAeoAHHw,15,11,6,9,3,0,11,0,40,5.714285714285714,6,0.0,2,6,9,3,9,0,0,11,0,20,20,0
2774,38785,QpfK7z5GdRL9KsohkHQ7AWpk99tKhwdp,SpATywNh6bZuzm8s1ceuBUnMUAeoAHHw,12,25,14,9,0,0,6,0,54,7.714285714285714,4,0.0,6,14,7,0,19,0,2,6,0,27,27,1
2775,38808,xy8Pu3m8OtRxFLhTfix6XvZn0H18zyZc,G8EPVSXsOYB5YQWZGiz1aVq5Pgr2GrQu,11,19,1,0,1,0,7,0,28,4.0,4,0.0,0,1,0,1,19,0,0,7,0,2,26,0
2776,38811,T6EWQ7jVP89JlHzj41KN1gEtGYevpSQM,SpATywNh6bZuzm8s1ceuBUnMUAeoAHHw,14,26,12,5,1,0,10,0,54,7.714285714285714,7,0.0,5,12,5,1,21,0,0,10,0,23,31,0
2777,38815,RfVW0lNKrf9tzkgd827lLFW37SMuSXSa,SpATywNh6bZuzm8s1ceuBUnMUAeoAHHw,14,22,1,12,1,0,2,0,38,5.428571428571429,2,0.0,2,1,12,1,20,0,0,2,0,16,22,1
2778,38825,t8zwYEwnyPi1IDBby2HgJ3IlSwhRkmGy,SpATywNh6bZuzm8s1ceuBUnMUAeoAHHw,15,30,1,21,0,25,12,1,90,12.857142857142858,4,0.0,10,1,18,0,20,25,3,12,1,29,61,0
2779,38826,RLA6GL5vSBJRKc1kwf2CaEaK6FOv9roZ,RXDvfPUBYFlVdlueBFbLW0mhhAyGEqpt,27,52,6,0,6,1,7,2,74,10.571428571428571,4,0.0,3,6,0,6,49,1,0,7,2,15,59,0
2780,38827,i5nCgFIHY6Zcmf0CbMZLC0bzGv6djmqm,G8EPVSXsOYB5YQWZGiz1aVq5Pgr2GrQu,7,6,1,0,1,1,7,0,16,2.2857142857142856,1,0.0,0,1,0,1,6,1,0,7,0,2,14,1
2781,38833,v4HIYrR0I8FWtTlaAHD463q83gEr8oUl,RXDvfPUBYFlVdlueBFbLW0mhhAyGEqpt,22,18,11,12,4,1,5,0,51,7.285714285714286,2,0.0,2,11,12,4,16,1,0,5,0,29,22,1
2782,38849,FnrvxXFGCqAMeXxoMCc55xlzH80Et8mi,SpATywNh6bZuzm8s1ceuBUnMUAeoAHHw,7,1,1,0,1,1,5,0,9,1.2857142857142858,1,0.0,0,1,0,1,1,1,0,5,0,2,7,1
2783,38860,aSq9IJ4ZfLUbnD7QSBT8oeA7EtoTrGal,bWdj2GDclj5ofokWjzoa5jAwMkxCykd6,17,31,8,0,8,23,8,1,79,11.285714285714286,4,0.0,0,8,0,8,31,23,0,8,1,16,63,1
2784,38906,U6b5ShGjMWYggq6FsoytPW1feWorMDiT,SpATywNh6bZuzm8s1ceuBUnMUAeoAHHw,1,0,0,0,0,0,1,0,1,0.14285714285714285,1,0.0,0,0,0,0,0,0,0,1,0,0,1,1
2785,38912,35Qckp7squ2ifhCEFcVeQZHmfUAJiaXc,SpATywNh6bZuzm8s1ceuBUnMUAeoAHHw,18,38,16,18,3,12,18,3,108,15.428571428571429,3,0.0,14,16,14,3,24,12,4,18,3,47,61,1
2786,38922,nV21XWIQ3aHCYYV7hPNmU8NbA6rAppIq,G8EPVSXsOYB5YQWZGiz1aVq5Pgr2GrQu,7,6,0,0,0,0,4,0,10,1.4285714285714286,1,0.0,0,0,0,0,6,0,0,4,0,0,10,1
2787,38923,MuiBmNrQSuFDjsexIRPrYiU9583FwFbE,SpATywNh6bZuzm8s1ceuBUnMUAeoAHHw,17,39,18,15,7,15,13,2,109,15.571428571428571,1,0.0,9,18,12,7,30,15,3,13,2,46,63,1
2788,38928,LKo3yUnM07K4Le8KPm2nARMox6nb3a03,SpATywNh6bZuzm8s1ceuBUnMUAeoAHHw,10,12,5,0,2,1,7,1,28,4.0,2,0.0,5,5,0,2,7,1,0,7,1,12,16,1
2789,38940,IXJChwgShKb71VXFYaM4KTehE3VXk7Kg,bWdj2GDclj5ofokWjzoa5jAwMkxCykd6,8,3,2,0,2,0,3,0,10,1.4285714285714286,1,0.0,1,2,0,2,2,0,0,3,0,5,5,1
2790,38942,VrBnKyI7RjgXozKQXJ2DSbj5Gvev22L0,SpATywNh6bZuzm8s1ceuBUnMUAeoAHHw,25,25,14,28,8,0,5,0,80,11.428571428571429,3,0.0,6,14,28,8,19,0,0,5,0,56,24,0
2791,38944,N1N2VoCQ3DCM7YknWLib5UEHyI2wyiAp,A3fsA9Zfv1X2fVEQhTw51lKENdNrEqT3,6,3,2,0,1,0,6,0,12,1.7142857142857142,1,0.0,0,2,0,1,3,0,0,6,0,3,9,1
2792,38954,hWagcbwGHP337RS0iBSta7Eh6v3OAnlN,SpATywNh6bZuzm8s1ceuBUnMUAeoAHHw,17,28,12,15,3,5,12,0,75,10.714285714285714,5,0.0,11,12,14,3,17,5,1,12,0,40,35,1
2793,38955,BE4JaFadHavW9r5xCXpj3M456eZAgaG6,SpATywNh6bZuzm8s1ceuBUnMUAeoAHHw,16,27,9,15,4,1,9,0,65,9.285714285714286,2,0.0,13,9,12,4,14,1,3,9,0,38,27,1
2794,38960,csUQD8kl5B2qOhCgBpUdVV3uOWaYGbyH,A3fsA9Zfv1X2fVEQhTw51lKENdNrEqT3,17,29,1,0,1,1,9,0,41,5.857142857142857,3,0.0,1,1,0,1,28,1,0,9,0,3,38,1
2795,38969,qP7HUxoCtXsXPUg6TOciLBwLDEqZxGLw,SpATywNh6bZuzm8s1ceuBUnMUAeoAHHw,5,3,1,0,1,0,2,0,7,1.0,1,0.0,0,1,0,1,3,0,0,2,0,2,5,1
2796,38976,n7mMvLvnaxc6y3IIFJpmSNUncj3jx1Ev,RXDvfPUBYFlVdlueBFbLW0mhhAyGEqpt,7,2,2,0,2,1,4,2,13,1.8571428571428572,1,0.0,0,2,0,2,2,1,0,4,2,4,9,1
2797,38984,Np3UGgyqJRbdjHAs6eqMYNuWuEJ67rAv,bWdj2GDclj5ofokWjzoa5jAwMkxCykd6,29,38,19,86,7,0,9,0,159,22.714285714285715,5,0.0,5,19,79,7,33,0,7,9,0,110,49,1
2798,38995,7nUtazUwwSnnXJpIKdQBJGpXV6Po42DQ,A3fsA9Zfv1X2fVEQhTw51lKENdNrEqT3,15,17,1,0,0,0,22,1,41,5.857142857142857,3,0.0,0,1,0,0,17,0,0,22,1,1,40,1
2799,39016,79QvR9MowSFdJ7PRFtAx8omEmqdf2G66,A3fsA9Zfv1X2fVEQhTw51lKENdNrEqT3,8,5,1,0,1,0,6,0,13,1.8571428571428572,1,0.0,0,1,0,1,5,0,0,6,0,2,11,1
2800,39017,sUk3OLEiiNZtlo4krMYRLjkp5xwgbsPl,bWdj2GDclj5ofokWjzoa5jAwMkxCykd6,1,0,0,0,0,0,1,0,1,0.14285714285714285,1,0.0,0,0,0,0,0,0,0,1,0,0,1,1
2801,39020,sUk3OLEiiNZtlo4krMYRLjkp5xwgbsPl,A3fsA9Zfv1X2fVEQhTw51lKENdNrEqT3,1,0,0,0,0,0,2,0,2,0.2857142857142857,1,0.0,0,0,0,0,0,0,0,2,0,0,2,1
2802,39024,KbrQAfHN76lnV5ENpEesywqeBtzfyubO,SpATywNh6bZuzm8s1ceuBUnMUAeoAHHw,18,25,11,19,3,2,19,7,86,12.285714285714286,2,0.0,9,11,16,3,16,2,3,19,7,39,47,0
2803,39028,dNx7yBBYuWpRM4BeMNLD1yOnUwcueGfB,A3fsA9Zfv1X2fVEQhTw51lKENdNrEqT3,8,25,0,0,0,2,7,0,34,4.857142857142857,2,0.0,1,0,0,0,24,2,0,7,0,1,33,0
2804,39033,NfJMxVbS19N5X90YBDzzOQ6861Bhuidv,SpATywNh6bZuzm8s1ceuBUnMUAeoAHHw,11,6,4,0,3,0,4,1,18,2.5714285714285716,1,0.0,0,4,0,3,6,0,0,4,1,7,11,1
2805,39050,St7zx5CuqYmo3cCQEAdzvR5kNp3mDM9y,SpATywNh6bZuzm8s1ceuBUnMUAeoAHHw,32,42,23,26,9,19,24,1,144,20.571428571428573,6,0.0,11,23,22,9,31,19,4,24,1,65,79,0
2806,39051,PlXHYUUQO0ZfkxRdI3LzMqwSKR0cnJTo,bWdj2GDclj5ofokWjzoa5jAwMkxCykd6,1,0,0,0,0,0,1,0,1,0.14285714285714285,1,0.0,0,0,0,0,0,0,0,1,0,0,1,1
2807,39054,blGSSjmsnVQQQrRQxZJTHNQQUXxgUvBL,SpATywNh6bZuzm8s1ceuBUnMUAeoAHHw,9,22,9,0,4,0,5,0,40,5.714285714285714,3,0.0,3,9,0,4,19,0,0,5,0,16,24,0
2808,39057,l21tCwOolR7RD0CZyqRiNHHeEZC1D67K,SpATywNh6bZuzm8s1ceuBUnMUAeoAHHw,9,30,10,19,0,35,7,0,101,14.428571428571429,3,0.0,16,10,17,0,14,35,2,7,0,43,58,0
2809,39058,uGuE3FWo0NVfQumLjneHZr95vibdZhQe,SpATywNh6bZuzm8s1ceuBUnMUAeoAHHw,8,12,5,3,0,0,2,0,22,3.142857142857143,1,0.0,6,5,3,0,6,0,0,2,0,14,8,1
2810,39060,T4lMOZ9NGQ0RS4ue5IeZuDcW1ySIGZ9u,A3fsA9Zfv1X2fVEQhTw51lKENdNrEqT3,46,29,22,62,18,0,4,0,135,19.285714285714285,3,0.0,0,22,55,18,29,0,7,4,0,95,40,1
2811,39063,Zx1NMbt45yqUj8qZK11kDvFPzYX2jIZZ,SpATywNh6bZuzm8s1ceuBUnMUAeoAHHw,14,15,8,17,6,0,2,0,48,6.857142857142857,1,0.0,4,8,15,6,11,0,2,2,0,33,15,1
2812,39066,3SER276qaao5TSZqnt0y9TkdmkGTUUcO,SpATywNh6bZuzm8s1ceuBUnMUAeoAHHw,8,5,4,0,4,0,1,0,14,2.0,1,0.0,0,4,0,4,5,0,0,1,0,8,6,1
2813,39070,O3F8lLfHLYapLPkEvSdAfSwSBCUUJfWK,SpATywNh6bZuzm8s1ceuBUnMUAeoAHHw,4,0,0,0,0,1,4,1,6,0.8571428571428571,2,0.0,0,0,0,0,0,1,0,4,1,0,6,1
2814,39076,76j1Dib3EpIIxYpQXxI6VKhD3TOXoxhS,SpATywNh6bZuzm8s1ceuBUnMUAeoAHHw,16,31,3,12,1,4,15,0,66,9.428571428571429,2,0.0,9,3,12,1,22,4,0,15,0,25,41,1
2815,39090,fTfrYxb6cRWvjdEVjIZ7skF0s5uk6kd9,SpATywNh6bZuzm8s1ceuBUnMUAeoAHHw,33,44,22,47,8,1,21,1,144,20.571428571428573,9,0.0,7,22,43,8,37,1,4,21,1,80,64,0
2816,39094,tcrMObz5SSDCQNYpPsv4XWOxcLo3IPpN,SpATywNh6bZuzm8s1ceuBUnMUAeoAHHw,7,5,1,0,0,0,3,0,9,1.2857142857142858,2,0.0,0,1,0,0,5,0,0,3,0,1,8,1
2817,39102,7nUtazUwwSnnXJpIKdQBJGpXV6Po42DQ,SpATywNh6bZuzm8s1ceuBUnMUAeoAHHw,26,52,1,28,3,3,21,1,109,15.571428571428571,5,0.0,16,1,22,3,36,3,6,21,1,42,67,1
2818,39103,avH35RZc6PS7vBKogre4B3MKABAedNBF,bWdj2GDclj5ofokWjzoa5jAwMkxCykd6,7,22,12,0,2,0,13,0,49,7.0,5,0.0,1,12,0,2,21,0,0,13,0,15,34,1
2819,39107,Dzo4bt517HDNgh4yuxQj3WQVtnrvmG1A,SpATywNh6bZuzm8s1ceuBUnMUAeoAHHw,5,3,0,0,0,0,2,0,5,0.7142857142857143,1,0.0,0,0,0,0,3,0,0,2,0,0,5,1
2820,39109,zu1WAijSG0F2wy5x45xxD1w2SrPWGtuK,SpATywNh6bZuzm8s1ceuBUnMUAeoAHHw,6,1,1,0,1,0,3,0,6,0.8571428571428571,1,0.0,0,1,0,1,1,0,0,3,0,2,4,1
2821,39113,VvziK1FrzCcoikfRc0daxkE7fq3iFq0v,SpATywNh6bZuzm8s1ceuBUnMUAeoAHHw,31,47,22,30,9,2,18,0,128,18.285714285714285,4,0.0,16,22,26,9,31,2,4,18,0,73,55,0
2822,39125,BTjtyE8NjHRpreY21d7F2wNmadCPRKCQ,SpATywNh6bZuzm8s1ceuBUnMUAeoAHHw,7,8,5,0,2,0,4,0,19,2.7142857142857144,3,0.0,0,5,0,2,8,0,0,4,0,7,12,1
2823,39131,uJIh67cllxQLgAhipzdDZMEunDbuBxvF,RXDvfPUBYFlVdlueBFbLW0mhhAyGEqpt,60,64,46,124,27,17,42,20,340,48.57142857142857,6,0.0,14,46,116,27,50,17,8,42,20,203,137,0
2824,39136,srXgccav6ELo546oVIR7hwKdVqMPE3uB,SpATywNh6bZuzm8s1ceuBUnMUAeoAHHw,7,6,1,0,1,0,4,0,12,1.7142857142857142,2,0.0,0,1,0,1,6,0,0,4,0,2,10,1
2825,39139,sUk3OLEiiNZtlo4krMYRLjkp5xwgbsPl,G8EPVSXsOYB5YQWZGiz1aVq5Pgr2GrQu,1,0,0,0,0,0,1,0,1,0.14285714285714285,1,0.0,0,0,0,0,0,0,0,1,0,0,1,1
2826,39152,9LQKs2OgeSVzfrSEIBiyZg4jCEuAC01N,G8EPVSXsOYB5YQWZGiz1aVq5Pgr2GrQu,11,4,1,12,0,0,2,0,19,2.7142857142857144,1,0.0,1,1,11,0,3,0,1,2,0,13,6,1
2827,39158,V0auOwxD2tv59agygO0uPvKcU5ercMUa,SpATywNh6bZuzm8s1ceuBUnMUAeoAHHw,15,28,15,6,5,0,9,0,63,9.0,4,0.0,4,15,6,5,24,0,0,9,0,30,33,1
2828,39179,OGoPVjudSuGohkzHyvu7N6zC3RGML0mw,G8EPVSXsOYB5YQWZGiz1aVq5Pgr2GrQu,19,34,30,0,27,0,3,0,94,13.428571428571429,2,0.0,0,30,0,27,34,0,0,3,0,57,37,1
2829,39182,VIwJtaSOWWljnDL02ObzIxH4JeVU0QQ1,bWdj2GDclj5ofokWjzoa5jAwMkxCykd6,4,3,1,0,0,0,7,0,11,1.5714285714285714,3,0.0,0,1,0,0,3,0,0,7,0,1,10,1
2830,39201,45r4ENaVPqa3xBFTqWFkoJttz7HBM6Lb,SpATywNh6bZuzm8s1ceuBUnMUAeoAHHw,12,18,0,6,0,3,14,5,46,6.571428571428571,3,0.0,2,0,5,0,16,3,1,14,5,7,39,1
2831,39207,RmlyieNXfVrGM9LWnpgNxfz0WPjjsgcE,A3fsA9Zfv1X2fVEQhTw51lKENdNrEqT3,2,0,0,0,0,0,2,0,2,0.2857142857142857,1,0.0,0,0,0,0,0,0,0,2,0,0,2,1
2832,39216,qsBNE43NxZycap30DuQDyNDzs5hGI95w,SpATywNh6bZuzm8s1ceuBUnMUAeoAHHw,15,14,11,2,7,0,4,0,38,5.428571428571429,3,0.0,0,11,2,7,14,0,0,4,0,20,18,1
2833,39229,rue9XaVrhPMV8jlzLPRPLBsY7dTh1epz,SpATywNh6bZuzm8s1ceuBUnMUAeoAHHw,14,52,3,24,0,8,29,6,122,17.428571428571427,5,0.0,19,3,17,0,33,8,7,29,6,39,83,1
2834,39237,PNuCKnyPWCRVxphTjJ1pIquyKu0dURK7,SpATywNh6bZuzm8s1ceuBUnMUAeoAHHw,5,3,1,0,1,0,2,0,7,1.0,1,0.0,0,1,0,1,3,0,0,2,0,2,5,1
2835,39239,xmz4ffo3Xzh257Ul94Vh1nR04juD6y1C,SpATywNh6bZuzm8s1ceuBUnMUAeoAHHw,1,0,0,0,0,0,1,0,1,0.14285714285714285,1,0.0,0,0,0,0,0,0,0,1,0,0,1,1
2836,39241,krVsPdgfe85VvAQ2rdfbpjD89zMbnkR0,SpATywNh6bZuzm8s1ceuBUnMUAeoAHHw,11,11,4,6,3,1,2,0,27,3.857142857142857,1,0.0,6,4,5,3,5,1,1,2,0,18,9,1
2837,39243,gpyXT5iZHN1onXoVstOXZoiFizXraIkU,SpATywNh6bZuzm8s1ceuBUnMUAeoAHHw,11,16,8,0,3,2,6,1,36,5.142857142857143,2,0.0,5,8,0,3,11,2,0,6,1,16,20,1
2838,39246,fv07Mlz09PBHitYybJt9eVrK276xe9YI,SpATywNh6bZuzm8s1ceuBUnMUAeoAHHw,23,14,9,26,6,0,20,0,75,10.714285714285714,7,0.0,4,9,22,6,10,0,4,20,0,41,34,0
2839,39247,Qr5qzmAxo2eU7JvBgyKuPQuH3YgkGzii,SpATywNh6bZuzm8s1ceuBUnMUAeoAHHw,6,3,1,0,1,0,2,0,7,1.0,1,0.0,0,1,0,1,3,0,0,2,0,2,5,1
2840,39248,Lc5TZPB93C58CDuO8VjF5g6g9boxDaHr,RXDvfPUBYFlVdlueBFbLW0mhhAyGEqpt,1,0,0,0,0,0,1,0,1,0.14285714285714285,1,0.0,0,0,0,0,0,0,0,1,0,0,1,1
2841,39254,PATQ2JDuYcR1iRnRPNzs82w3vSQnScOh,RXDvfPUBYFlVdlueBFbLW0mhhAyGEqpt,1,0,0,0,0,0,1,0,1,0.14285714285714285,1,0.0,0,0,0,0,0,0,0,1,0,0,1,1
2842,39264,7ddOasUgoSwmcHs4lJMhvhalD4IA2urH,SpATywNh6bZuzm8s1ceuBUnMUAeoAHHw,10,18,0,0,0,3,9,2,32,4.571428571428571,2,0.0,5,0,0,0,13,3,0,9,2,5,27,0
2843,39274,2nLjdaVfmxwWCLw5sEI1KKYk7UXViPES,SpATywNh6bZuzm8s1ceuBUnMUAeoAHHw,13,16,0,6,1,0,2,0,25,3.5714285714285716,2,0.0,5,0,6,1,11,0,0,2,0,12,13,0
2844,39277,G6iele4ho79nU5jQ1J8umZLq8jEFa9yN,A3fsA9Zfv1X2fVEQhTw51lKENdNrEqT3,12,5,3,0,3,10,5,1,27,3.857142857142857,2,0.0,0,3,0,3,5,10,0,5,1,6,21,1
2845,39293,59KrgCJlOEHQHzBNjsHoSd6BkQVArDrc,SpATywNh6bZuzm8s1ceuBUnMUAeoAHHw,8,8,4,0,2,0,2,0,16,2.2857142857142856,2,0.0,0,4,0,2,8,0,0,2,0,6,10,1
2846,39294,t43o0GKgntYeNvU3jSnPK3vOmS44e5N2,G8EPVSXsOYB5YQWZGiz1aVq5Pgr2GrQu,9,5,1,0,1,2,3,0,12,1.7142857142857142,1,0.0,0,1,0,1,5,2,0,3,0,2,10,1
2847,39296,R2cga9JVVM2tXEVs2saYswslfxAU4nMk,bWdj2GDclj5ofokWjzoa5jAwMkxCykd6,8,7,5,4,0,0,10,0,26,3.7142857142857144,4,0.0,2,5,4,0,5,0,0,10,0,11,15,1
2848,39301,ezp80xTAgodAGV4fsnNivfTneJn97tLE,RXDvfPUBYFlVdlueBFbLW0mhhAyGEqpt,70,67,38,134,17,6,17,0,279,39.857142857142854,6,0.0,11,38,125,17,56,6,9,17,0,191,88,0
2849,39312,5taolCXbi4GnZeqgvcKlHbiPurs2tpgr,SpATywNh6bZuzm8s1ceuBUnMUAeoAHHw,29,29,17,16,7,0,10,2,81,11.571428571428571,4,0.0,7,17,16,7,22,0,0,10,2,47,34,0
2850,39327,CnuwKGLCLbXYnPgy82VEWYA1NOiOhvr0,A3fsA9Zfv1X2fVEQhTw51lKENdNrEqT3,8,9,0,0,0,0,5,0,14,2.0,2,0.0,1,0,0,0,8,0,0,5,0,1,13,1
2851,39330,YY7yHizDn0UpGHVq4qoTfbulP3ev5TkC,SpATywNh6bZuzm8s1ceuBUnMUAeoAHHw,22,26,18,2,11,4,9,0,70,10.0,4,0.0,0,18,2,11,26,4,0,9,0,31,39,0
2852,39339,0QbAHgL1bHqgkC1CgcznJ6rPBigpeoia,SpATywNh6bZuzm8s1ceuBUnMUAeoAHHw,13,9,7,4,3,0,3,0,26,3.7142857142857144,2,0.0,0,7,4,3,9,0,0,3,0,14,12,1
2853,39349,8eqcmJf66b25Hdf1a71yMHA6gdhfVvDC,G8EPVSXsOYB5YQWZGiz1aVq5Pgr2GrQu,83,169,75,148,41,67,57,4,561,80.14285714285714,6,0.0,14,75,134,41,155,67,14,57,4,264,297,0
2854,39360,aiSJXiTI4iLjZWytdZmE5zydDNEQzaHj,A3fsA9Zfv1X2fVEQhTw51lKENdNrEqT3,2,0,0,0,0,0,2,0,2,0.2857142857142857,1,0.0,0,0,0,0,0,0,0,2,0,0,2,1
2855,39367,SgAa84aajahM2sd2hvCdYRfO014ocPV5,SpATywNh6bZuzm8s1ceuBUnMUAeoAHHw,29,56,21,22,11,27,15,1,153,21.857142857142858,5,0.0,16,21,21,11,40,27,1,15,1,69,84,0
2856,39368,OTHiy7CJ3gPgZvtv97Ds8YkrZ0bgVlAw,G8EPVSXsOYB5YQWZGiz1aVq5Pgr2GrQu,4,4,0,0,2,0,1,0,7,1.0,1,0.0,2,0,0,2,2,0,0,1,0,4,3,0
2857,39371,194jqOV6jnj4prH3N2CqRtpc9qi9vfln,A3fsA9Zfv1X2fVEQhTw51lKENdNrEqT3,4,1,0,0,0,0,3,0,4,0.5714285714285714,1,0.0,0,0,0,0,1,0,0,3,0,0,4,1
2858,39372,aA47iNtja2lxoPqFPeHjI7xjYuTmvZjx,SpATywNh6bZuzm8s1ceuBUnMUAeoAHHw,15,20,8,18,3,1,5,0,55,7.857142857142857,4,0.0,8,8,15,3,12,1,3,5,0,34,21,1
2859,39377,M0xQooArrVMTCCgk3YkWTaBSUVldkFxi,SpATywNh6bZuzm8s1ceuBUnMUAeoAHHw,27,32,19,26,6,16,16,0,115,16.428571428571427,5,0.0,4,19,26,6,28,16,0,16,0,55,60,0
2860,39395,i2suUv0IuyNKOwhtAFmOMY1okBxszKdN,A3fsA9Zfv1X2fVEQhTw51lKENdNrEqT3,1,0,0,0,0,0,1,0,1,0.14285714285714285,1,0.0,0,0,0,0,0,0,0,1,0,0,1,1
2861,39397,dlNspelxxHXjwBoo8dpRx9m2ctqEqalr,G8EPVSXsOYB5YQWZGiz1aVq5Pgr2GrQu,7,5,2,0,2,0,3,0,12,1.7142857142857142,1,0.0,0,2,0,2,5,0,0,3,0,4,8,1
2862,39407,W7Pzvj7hPa3qVKdWluutDHqjcp3iIpAb,SpATywNh6bZuzm8s1ceuBUnMUAeoAHHw,28,69,33,36,19,1,11,1,170,24.285714285714285,9,0.0,29,33,32,19,40,1,4,11,1,113,57,0
2863,39418,nBG9NwFfkLReYPd7l4XLlLWLMjwV7w8K,A3fsA9Zfv1X2fVEQhTw51lKENdNrEqT3,5,4,1,0,1,0,2,0,8,1.1428571428571428,1,0.0,0,1,0,1,4,0,0,2,0,2,6,1
2864,39422,f6uLbTCHrR4TIVQHhrh2EEZiIDyLA7ZC,SpATywNh6bZuzm8s1ceuBUnMUAeoAHHw,1,0,0,0,0,0,1,0,1,0.14285714285714285,1,0.0,0,0,0,0,0,0,0,1,0,0,1,1
2865,39430,IAvuP4GGmvnNj3Zisz3jDfo3mSmXiJSb,bWdj2GDclj5ofokWjzoa5jAwMkxCykd6,5,9,0,0,0,0,10,0,19,2.7142857142857144,6,0.0,0,0,0,0,9,0,0,10,0,0,19,0
2866,39432,roGokqGBKtukTNGPdY1C2VEr66iWn5eT,G8EPVSXsOYB5YQWZGiz1aVq5Pgr2GrQu,7,7,4,0,2,0,5,0,18,2.5714285714285716,3,0.0,0,4,0,2,7,0,0,5,0,6,12,1
2867,39441,VsLOJ7Xi4SI8kpOP7KF7SoJJkHTp6ASm,SpATywNh6bZuzm8s1ceuBUnMUAeoAHHw,32,36,20,29,12,8,13,1,119,17.0,5,0.0,11,20,27,12,25,8,2,13,1,70,49,0
2868,39443,WxaYTMCI7yD8mE0osZVkZT9Orbo545LC,G8EPVSXsOYB5YQWZGiz1aVq5Pgr2GrQu,25,20,17,36,12,0,5,1,91,13.0,2,0.0,2,17,30,12,18,0,6,5,1,61,30,1
2869,39464,e2VhgSHwCVj2IYcx6wF0yjNoIULwWBq8,A3fsA9Zfv1X2fVEQhTw51lKENdNrEqT3,17,15,11,0,7,0,3,0,36,5.142857142857143,2,0.0,1,11,0,7,14,0,0,3,0,19,17,1
2870,39485,O9c4mZKt6PM5RxUHcRjnRJOfvI41UF2p,SpATywNh6bZuzm8s1ceuBUnMUAeoAHHw,31,57,25,26,10,5,24,2,149,21.285714285714285,6,0.0,22,25,21,10,35,5,5,24,2,78,71,0
2871,39486,7UOiW6Ks9JGRUR75AHoSTuRNGYY2xnnm,A3fsA9Zfv1X2fVEQhTw51lKENdNrEqT3,10,10,5,0,2,0,3,0,20,2.857142857142857,1,0.0,0,5,0,2,10,0,0,3,0,7,13,0
2872,39488,fxwFHQhfnCCHU83SJwJLBtmbCrCDlv3i,G8EPVSXsOYB5YQWZGiz1aVq5Pgr2GrQu,17,24,17,0,10,1,4,0,56,8.0,4,0.0,0,17,0,10,24,1,0,4,0,27,29,1
2873,39494,L8U7mZiX5tfpfUV7mFpP0znonqPA6G6R,SpATywNh6bZuzm8s1ceuBUnMUAeoAHHw,12,16,2,14,0,0,5,0,37,5.285714285714286,2,0.0,11,2,13,0,5,0,1,5,0,26,11,1
2874,39496,D55KBHzjFX6XlkQnUeIgoK6OnycKiatp,SpATywNh6bZuzm8s1ceuBUnMUAeoAHHw,7,6,3,0,2,0,2,0,13,1.8571428571428572,2,0.0,0,3,0,2,6,0,0,2,0,5,8,1
2875,39499,nBZt0s4EJwoCi0gxserLJGtn0aLrx1yc,A3fsA9Zfv1X2fVEQhTw51lKENdNrEqT3,26,40,9,18,7,0,16,0,90,12.857142857142858,7,0.0,0,9,15,7,40,0,3,16,0,31,59,1
2876,39504,1BLAPxf3lDzwOBM6NeFyerOFp0vZobfY,SpATywNh6bZuzm8s1ceuBUnMUAeoAHHw,9,14,8,0,4,1,5,0,32,4.571428571428571,2,0.0,0,8,0,4,14,1,0,5,0,12,20,0
2877,39512,ivxBGUbA7UT7tzED0gKK31cJU8Lv97zd,SpATywNh6bZuzm8s1ceuBUnMUAeoAHHw,7,7,1,0,1,0,2,0,11,1.5714285714285714,1,0.0,0,1,0,1,7,0,0,2,0,2,9,1
2878,39526,3Aezv8lgcVyIW4Uwgi3KMiL4RZSkwke5,A3fsA9Zfv1X2fVEQhTw51lKENdNrEqT3,12,16,11,0,5,0,7,0,39,5.571428571428571,3,0.0,1,11,0,5,15,0,0,7,0,17,22,1
2879,39527,BZSYb0PJXmPcTlknqBAAi8E9uLmy4IRE,SpATywNh6bZuzm8s1ceuBUnMUAeoAHHw,21,53,26,12,5,1,13,2,112,16.0,5,0.0,4,26,11,5,49,1,1,13,2,46,66,1
2880,39530,ZuUY5FCqqOqbgit08Gvv6v9cPTZXO9su,SpATywNh6bZuzm8s1ceuBUnMUAeoAHHw,9,9,4,0,2,0,6,1,22,3.142857142857143,1,0.0,1,4,0,2,8,0,0,6,1,7,15,1
2881,39534,cULoH8ZJIqrdeB8ADfKnnQ8THzmbMgQV,A3fsA9Zfv1X2fVEQhTw51lKENdNrEqT3,2,0,0,0,0,0,2,0,2,0.2857142857142857,1,0.0,0,0,0,0,0,0,0,2,0,0,2,1
2882,39537,xg8lJQFNYZJBLJxL1TK1I5KNSxuhMUEI,bWdj2GDclj5ofokWjzoa5jAwMkxCykd6,5,7,2,0,0,0,4,0,13,1.8571428571428572,3,0.0,0,2,0,0,7,0,0,4,0,2,11,1
2883,39540,xnObPmivHmj7phvTSVLNuvvFk898J2aO,SpATywNh6bZuzm8s1ceuBUnMUAeoAHHw,16,26,4,9,2,2,10,0,53,7.571428571428571,4,0.0,4,4,9,2,22,2,0,10,0,19,34,1
2884,39541,fnvAURpBgndjkYxbDVVMCKsNQuRUMiGS,RXDvfPUBYFlVdlueBFbLW0mhhAyGEqpt,1,0,0,0,0,0,1,0,1,0.14285714285714285,1,0.0,0,0,0,0,0,0,0,1,0,0,1,1
2885,39546,94sscb1tthVT0LkFotULcfURBxnTdgyP,A3fsA9Zfv1X2fVEQhTw51lKENdNrEqT3,5,2,1,0,1,0,2,0,6,0.8571428571428571,1,0.0,0,1,0,1,2,0,0,2,0,2,4,1
2886,39560,tfLWXkHQA3FBV54C2lvq1caDx4Pi6QwO,SpATywNh6bZuzm8s1ceuBUnMUAeoAHHw,28,56,24,26,10,0,13,0,129,18.428571428571427,8,0.0,13,24,26,10,43,0,0,13,0,73,56,0
2887,39565,lY81J0j7TM6V2dDMqV7lafTfl1uBUPgf,A3fsA9Zfv1X2fVEQhTw51lKENdNrEqT3,36,16,9,92,6,0,14,1,138,19.714285714285715,2,0.0,4,9,81,6,12,0,11,14,1,100,38,1
2888,39567,YC5UG6m05nI4uxDXYqrNEKgzKHSk4oSu,SpATywNh6bZuzm8s1ceuBUnMUAeoAHHw,30,63,32,29,15,6,18,2,165,23.571428571428573,7,0.0,17,32,25,15,46,6,4,18,2,89,76,0
2889,39568,veYIONVCJwpad8Khvzq7a5rgGQHvYo6S,G8EPVSXsOYB5YQWZGiz1aVq5Pgr2GrQu,30,34,23,20,16,1,5,0,99,14.142857142857142,3,0.0,5,23,15,16,29,1,5,5,0,59,40,0
2890,39587,X14gKVD1ZKu0qL0NchpqxwhoYSEpz9QI,SpATywNh6bZuzm8s1ceuBUnMUAeoAHHw,14,28,4,10,1,19,19,0,81,11.571428571428571,9,0.0,5,4,9,1,23,19,1,19,0,19,62,0
2891,39595,YFvrapJWr0AHUdxkctZzup6RNdDbndzC,SpATywNh6bZuzm8s1ceuBUnMUAeoAHHw,7,9,2,0,2,0,3,1,17,2.4285714285714284,2,0.0,0,2,0,2,9,0,0,3,1,4,13,0
2892,39608,Z75g2Nz4DcysTkbj3XO50UPDPTuBSclE,A3fsA9Zfv1X2fVEQhTw51lKENdNrEqT3,36,18,2,88,1,5,7,2,123,17.571428571428573,2,0.0,1,2,70,1,17,5,18,7,2,74,49,1
2893,39613,Kp4YCt5gbTMeLX4vxDVqvPhrGDdHDcEC,SpATywNh6bZuzm8s1ceuBUnMUAeoAHHw,8,6,4,0,3,0,1,0,14,2.0,1,0.0,0,4,0,3,6,0,0,1,0,7,7,1
2894,39620,RERMHDA2gNT2NdhpczhxOdgAsVrkLgnS,SpATywNh6bZuzm8s1ceuBUnMUAeoAHHw,5,2,1,0,1,0,2,0,6,0.8571428571428571,1,0.0,0,1,0,1,2,0,0,2,0,2,4,0
2895,39622,GqdYzH9IQjNV4Qw4poxGmkYlIXbhf40S,SpATywNh6bZuzm8s1ceuBUnMUAeoAHHw,11,6,4,8,3,0,1,0,22,3.142857142857143,1,0.0,1,4,7,3,5,0,1,1,0,15,7,1
2896,39623,nlj7VjLiwr4POHSdgtLvTaDUWFoae60t,SpATywNh6bZuzm8s1ceuBUnMUAeoAHHw,15,18,10,2,6,0,9,1,46,6.571428571428571,3,0.0,1,10,2,6,17,0,0,9,1,19,27,1
2897,39627,W5u0uO7QxoiOFkTJ8a7Iluj7qY01eSEK,SpATywNh6bZuzm8s1ceuBUnMUAeoAHHw,8,3,1,0,1,0,4,1,10,1.4285714285714286,1,0.0,0,1,0,1,3,0,0,4,1,2,8,1
2898,39629,vh69W01dADhjl8K2ZA2b9sRlprr5NXs0,SpATywNh6bZuzm8s1ceuBUnMUAeoAHHw,11,11,5,4,2,0,1,0,23,3.2857142857142856,1,0.0,3,5,4,2,8,0,0,1,0,14,9,1
2899,39630,3Aezv8lgcVyIW4Uwgi3KMiL4RZSkwke5,bWdj2GDclj5ofokWjzoa5jAwMkxCykd6,24,56,29,40,11,58,32,5,231,33.0,10,0.0,9,29,34,11,47,58,6,32,5,83,148,0
2900,39632,YHL8SFwBUtFpO36pvl6xAPsnC0mLXaOp,G8EPVSXsOYB5YQWZGiz1aVq5Pgr2GrQu,9,16,3,0,3,0,5,0,27,3.857142857142857,4,0.0,0,3,0,3,16,0,0,5,0,6,21,1
2901,39649,BfV7UiYzJLw6WeEm3hlQsMK4WHcSosq4,A3fsA9Zfv1X2fVEQhTw51lKENdNrEqT3,50,27,24,94,21,0,5,0,171,24.428571428571427,3,0.0,1,24,75,21,26,0,19,5,0,121,50,1
2902,39652,6FzXe5nPWUHRxntREHsQRnp7x1pxuhUz,bWdj2GDclj5ofokWjzoa5jAwMkxCykd6,15,37,15,44,7,8,7,1,119,17.0,3,0.0,11,15,43,7,26,8,1,7,1,76,43,1
2903,39662,3uY3PXIjE4xYhALzqv9EDJ3LJju3f4Jc,A3fsA9Zfv1X2fVEQhTw51lKENdNrEqT3,1,0,0,0,0,0,1,0,1,0.14285714285714285,1,0.0,0,0,0,0,0,0,0,1,0,0,1,1
2904,39673,fCmdFT6vVaKttJ0wsJVd3YILMXjqgUpl,A3fsA9Zfv1X2fVEQhTw51lKENdNrEqT3,1,0,0,0,0,0,1,0,1,0.14285714285714285,1,0.0,0,0,0,0,0,0,0,1,0,0,1,1
2905,39676,jsiVqpEsXq0sluinZw5ff1hSi6FTnuod,SpATywNh6bZuzm8s1ceuBUnMUAeoAHHw,5,2,1,0,1,0,4,0,8,1.1428571428571428,2,0.0,0,1,0,1,2,0,0,4,0,2,6,1
2906,39697,CJISoHtkGNnkB0CRrvBDw2uUj4sPNv5j,SpATywNh6bZuzm8s1ceuBUnMUAeoAHHw,12,28,0,13,0,1,4,0,46,6.571428571428571,2,0.0,11,0,10,0,17,1,3,4,0,21,25,1
2907,39709,Nfn60tuwOzVop5pbBaYFyFMaifJoAIP6,bWdj2GDclj5ofokWjzoa5jAwMkxCykd6,16,27,12,56,7,0,4,0,106,15.142857142857142,2,0.0,12,12,48,7,15,0,8,4,0,79,27,1
2908,39723,wg81hfugF770xMHAXCLP7YJmOhdUJnHl,SpATywNh6bZuzm8s1ceuBUnMUAeoAHHw,30,64,21,22,11,11,13,1,143,20.428571428571427,7,0.0,14,21,17,11,50,11,5,13,1,63,80,0
2909,39733,rMXcpM1YL9uvJc9vPGaTEpRlMvl4lfsn,bWdj2GDclj5ofokWjzoa5jAwMkxCykd6,4,3,1,0,0,0,1,0,5,0.7142857142857143,1,0.0,0,1,0,0,3,0,0,1,0,1,4,1
2910,39741,aw5sNjg3Ll84wJrvKaca9hOr6No0sjrv,SpATywNh6bZuzm8s1ceuBUnMUAeoAHHw,13,16,2,13,1,0,4,0,36,5.142857142857143,2,0.0,9,2,11,1,7,0,2,4,0,23,13,1
2911,39756,0aMTCmDPG4aC91o1krmKQxgTxAagyKJp,bWdj2GDclj5ofokWjzoa5jAwMkxCykd6,17,31,17,86,12,0,18,1,165,23.571428571428573,4,0.0,11,17,77,12,20,0,9,18,1,117,48,1
2912,39760,s8yyjhcg4BVOip4HSP4txOTTHFJ4aWPU,SpATywNh6bZuzm8s1ceuBUnMUAeoAHHw,3,2,1,0,0,0,2,0,5,0.7142857142857143,2,0.0,0,1,0,0,2,0,0,2,0,1,4,1
2913,39765,Ea76prVlgHXbifiTXOy9yoJBa7oRFv41,RXDvfPUBYFlVdlueBFbLW0mhhAyGEqpt,1,0,0,0,0,0,1,0,1,0.14285714285714285,1,0.0,0,0,0,0,0,0,0,1,0,0,1,1
2914,39773,6QYAwv5e3xo1Sn1iZiEuGx1qJzd44Lj7,RXDvfPUBYFlVdlueBFbLW0mhhAyGEqpt,19,29,7,0,5,0,10,0,51,7.285714285714286,2,0.0,3,7,0,5,26,0,0,10,0,15,36,1
2915,39774,1aQoKDna73jstuOrupWa9Kq8V3FdvbRU,RXDvfPUBYFlVdlueBFbLW0mhhAyGEqpt,7,4,2,0,2,0,1,0,9,1.2857142857142858,1,0.0,0,2,0,2,4,0,0,1,0,4,5,1
2916,39776,OdMr7dE5UlAme9Tp979vREBvY5CV50po,bWdj2GDclj5ofokWjzoa5jAwMkxCykd6,49,39,19,114,12,0,10,0,194,27.714285714285715,7,0.0,14,19,107,12,25,0,7,10,0,152,42,0
2917,39808,Y1HbgiosdaMEUFcfxOopNbywAYIWyuQr,SpATywNh6bZuzm8s1ceuBUnMUAeoAHHw,10,16,1,0,1,8,5,0,31,4.428571428571429,3,0.0,0,1,0,1,16,8,0,5,0,2,29,1
2918,39817,vkw8WV6aYKsdxKvxTMS0euMnMdoDV8qN,bWdj2GDclj5ofokWjzoa5jAwMkxCykd6,5,7,3,0,2,3,2,0,17,2.4285714285714284,2,0.0,2,3,0,2,5,3,0,2,0,7,10,1
2919,39823,rEKGYBPmMNG2ptSViOUukUYctuPLpJ3c,A3fsA9Zfv1X2fVEQhTw51lKENdNrEqT3,8,10,1,0,0,1,11,3,26,3.7142857142857144,2,0.0,2,1,0,0,8,1,0,11,3,3,23,1
2920,39824,ZKL2WgbeR5PdyCIYfqDQ4XNCHZlCFLIz,bWdj2GDclj5ofokWjzoa5jAwMkxCykd6,5,5,3,0,2,0,5,0,15,2.142857142857143,2,0.0,0,3,0,2,5,0,0,5,0,5,10,1
2921,39827,A6hS9pkzvwTNmFdD6HzIqa5y6YmtMrCe,A3fsA9Zfv1X2fVEQhTw51lKENdNrEqT3,7,7,1,0,1,0,1,0,10,1.4285714285714286,1,0.0,0,1,0,1,7,0,0,1,0,2,8,1
2922,39828,ke8J6J68PMmqZ8rK8FCDUgXlLZQpLLZW,A3fsA9Zfv1X2fVEQhTw51lKENdNrEqT3,46,42,20,102,9,0,14,2,189,27.0,4,0.0,1,20,84,9,41,0,18,14,2,114,75,1
2923,39837,HboM24Wk39YTBPWC8WzrZxRqA9rZpUU4,SpATywNh6bZuzm8s1ceuBUnMUAeoAHHw,7,8,2,0,1,1,7,1,20,2.857142857142857,2,0.0,0,2,0,1,8,1,0,7,1,3,17,1
2924,39838,dNIlKItJkU7JaK0shSCPHRrbzZCvxDbc,A3fsA9Zfv1X2fVEQhTw51lKENdNrEqT3,6,0,0,0,0,4,8,0,12,1.7142857142857142,1,0.0,0,0,0,0,0,4,0,8,0,0,12,1
2925,39858,efn1iuG0ajlfaHaXrPxReUu8GzdIHbZe,SpATywNh6bZuzm8s1ceuBUnMUAeoAHHw,12,18,10,0,5,1,12,1,47,6.714285714285714,2,0.0,1,10,0,5,17,1,0,12,1,16,31,0
2926,39861,wVfyl6WgFur5urtfx8TypP7osjiRs72N,A3fsA9Zfv1X2fVEQhTw51lKENdNrEqT3,2,0,0,0,0,0,3,0,3,0.42857142857142855,1,0.0,0,0,0,0,0,0,0,3,0,0,3,1
2927,39885,g6UH67YbvJtewLNXQNVZTYui0XC1Hxpo,G8EPVSXsOYB5YQWZGiz1aVq5Pgr2GrQu,33,66,31,66,9,0,15,1,188,26.857142857142858,5,0.0,27,31,50,9,39,0,16,15,1,117,71,0
2928,39886,Dd40k4eqowbb0BAmqLv8aP0MP2R1XA5P,SpATywNh6bZuzm8s1ceuBUnMUAeoAHHw,18,15,6,6,3,21,11,3,65,9.285714285714286,1,0.0,7,6,6,3,8,21,0,11,3,22,43,1
2929,39891,Dk2p6h1MYjykCuVHQMak8GN098n0FvGH,A3fsA9Zfv1X2fVEQhTw51lKENdNrEqT3,7,5,0,0,0,0,3,0,8,1.1428571428571428,2,0.0,0,0,0,0,5,0,0,3,0,0,8,1
2930,39906,xOGjXyyeq87fCMSZ9z7Yuds9sMvR7Ohh,RXDvfPUBYFlVdlueBFbLW0mhhAyGEqpt,12,13,10,0,6,0,2,0,31,4.428571428571429,2,0.0,0,10,0,6,13,0,0,2,0,16,15,0
2931,39919,C6gazwyl7EiFD8XZj9L3YaSfbatiTDEE,bWdj2GDclj5ofokWjzoa5jAwMkxCykd6,9,28,15,58,10,0,8,0,119,17.0,6,0.0,5,15,55,10,23,0,3,8,0,85,34,0
2932,39924,1Lhe3e5bki1E1AUNwq5SspoMJiU5aMmH,RXDvfPUBYFlVdlueBFbLW0mhhAyGEqpt,44,45,30,59,24,0,7,2,167,23.857142857142858,2,0.0,10,30,53,24,35,0,6,7,2,117,50,0
2933,39925,muBWBBbWzkNF6Dzg57EIx35WmD2zp0yP,SpATywNh6bZuzm8s1ceuBUnMUAeoAHHw,19,34,5,16,4,1,13,0,73,10.428571428571429,6,0.0,7,5,14,4,27,1,2,13,0,30,43,0
2934,39928,ygXUYNlms6qOypCR1kXz9dAuLrVhdPds,SpATywNh6bZuzm8s1ceuBUnMUAeoAHHw,19,32,15,18,3,22,21,1,112,16.0,7,0.0,9,15,15,3,23,22,3,21,1,42,70,1
2935,39929,r3yTAtA27zn29k1K73ADGURrMlpR5nC7,RXDvfPUBYFlVdlueBFbLW0mhhAyGEqpt,12,19,15,0,12,0,5,0,51,7.285714285714286,1,0.0,0,15,0,12,19,0,0,5,0,27,24,0
2936,39932,ddMTOiTV5HSxEMNnjSDeiKLzuF1YmYcT,A3fsA9Zfv1X2fVEQhTw51lKENdNrEqT3,3,2,1,0,0,0,1,0,4,0.5714285714285714,1,0.0,0,1,0,0,2,0,0,1,0,1,3,1
2937,39938,RVwnUs0luG0pmL3ADXHeT8MpQNWgZj3Z,RXDvfPUBYFlVdlueBFbLW0mhhAyGEqpt,34,38,26,100,0,0,1,0,165,23.571428571428573,6,0.0,10,26,92,0,28,0,8,1,0,128,37,1
2938,39941,Z90b24vMiOddvA3R8cPrefim6f9EiVmz,SpATywNh6bZuzm8s1ceuBUnMUAeoAHHw,20,25,7,27,2,8,7,3,79,11.285714285714286,3,0.0,16,7,21,2,9,8,6,7,3,46,33,0
2939,39943,P6hNwLATXTVCZjt7DoobnBSI1FyeLq01,A3fsA9Zfv1X2fVEQhTw51lKENdNrEqT3,8,15,2,0,2,0,6,0,25,3.5714285714285716,1,0.0,0,2,0,2,15,0,0,6,0,4,21,1
2940,39951,UXCeDIhL283LDr12VbAjFZUd7R6owJ9F,G8EPVSXsOYB5YQWZGiz1aVq5Pgr2GrQu,5,4,0,0,0,0,4,0,8,1.1428571428571428,1,0.0,1,0,0,0,3,0,0,4,0,1,7,0
2941,39956,CHAwTqWzS9gyj5Ro2Bvsw8FCNCA8dW6W,RXDvfPUBYFlVdlueBFbLW0mhhAyGEqpt,21,27,1,6,2,3,27,1,67,9.571428571428571,6,0.0,4,1,6,2,23,3,0,27,1,13,54,1
2942,39960,IyXR1neCOqlWiBnFK6SoolM6gOHf0cwa,A3fsA9Zfv1X2fVEQhTw51lKENdNrEqT3,12,4,3,0,3,1,7,0,18,2.5714285714285716,1,0.0,0,3,0,3,4,1,0,7,0,6,12,1
2943,39967,VFl026LXCSxME7l2ZLRhGKmh3R96duCq,SpATywNh6bZuzm8s1ceuBUnMUAeoAHHw,31,96,50,29,19,16,48,2,260,37.142857142857146,14,0.0,11,50,25,19,85,16,4,48,2,105,155,0
2944,39983,m4cy52txIJ3BHr73S3AvnUeiz4g3fpv8,A3fsA9Zfv1X2fVEQhTw51lKENdNrEqT3,8,4,3,0,3,0,1,0,11,1.5714285714285714,1,0.0,0,3,0,3,4,0,0,1,0,6,5,1
2945,39989,dhMm94sLRibUWA6YOpXlMLxyaR3sl4a9,A3fsA9Zfv1X2fVEQhTw51lKENdNrEqT3,18,39,2,0,2,5,14,0,62,8.857142857142858,6,0.0,0,2,0,2,39,5,0,14,0,4,58,0
2946,40010,XsIiMjBHDyB8SLEzKHAHcKIpWlAHXu34,RXDvfPUBYFlVdlueBFbLW0mhhAyGEqpt,29,77,22,45,13,4,9,0,170,24.285714285714285,2,0.0,9,22,43,13,68,4,2,9,0,87,83,0
2947,40013,p1fshV6UZeW7KZmzuxOc9ex10GYNTePc,RXDvfPUBYFlVdlueBFbLW0mhhAyGEqpt,48,41,23,85,12,42,8,2,213,30.428571428571427,3,0.0,15,23,77,12,26,42,8,8,2,127,86,1
2948,40019,wDbI53389OJRBH6MsGEj6dttayfVtGlQ,SpATywNh6bZuzm8s1ceuBUnMUAeoAHHw,1,0,0,0,0,0,1,0,1,0.14285714285714285,1,0.0,0,0,0,0,0,0,0,1,0,0,1,1
2949,40022,SP7CCOQc4gFs6CnOJ8vpnG2qG74ffSCZ,SpATywNh6bZuzm8s1ceuBUnMUAeoAHHw,12,15,0,14,0,0,9,0,38,5.428571428571429,3,0.0,5,0,13,0,10,0,1,9,0,18,20,0
2950,40027,vpdMGAwpHu1uhd9ckN957NDWXXLtiXYo,bWdj2GDclj5ofokWjzoa5jAwMkxCykd6,8,8,4,0,1,26,7,2,48,6.857142857142857,3,0.0,3,4,0,1,5,26,0,7,2,8,40,1
2951,40028,KaeCX7DoW5htn0YhXrWslGGGeoVPFyiJ,G8EPVSXsOYB5YQWZGiz1aVq5Pgr2GrQu,12,11,7,0,5,0,5,0,28,4.0,2,0.0,0,7,0,5,11,0,0,5,0,12,16,1
2952,40037,4wGoSTuzJXBCojeNmaxk9GbR1KaCV7ql,bWdj2GDclj5ofokWjzoa5jAwMkxCykd6,8,4,1,0,1,0,7,1,14,2.0,2,0.0,0,1,0,1,4,0,0,7,1,2,12,1
2953,40039,28PHU9suTM8EqUKsQwsvQ03DzFXi0yDl,A3fsA9Zfv1X2fVEQhTw51lKENdNrEqT3,48,29,20,54,10,1,17,1,132,18.857142857142858,6,0.0,3,20,46,10,26,1,8,17,1,79,53,0
2954,40054,dlphjzS7Cck7yL7KPK4kXgmYSbBOCuFC,bWdj2GDclj5ofokWjzoa5jAwMkxCykd6,23,68,26,120,12,52,31,4,313,44.714285714285715,7,0.0,17,26,116,12,51,52,4,31,4,171,142,0
2955,40060,qDqnrpVee3l5HrPD2lnOTUKZmsC9F3UK,A3fsA9Zfv1X2fVEQhTw51lKENdNrEqT3,5,2,1,0,1,0,2,0,6,0.8571428571428571,1,0.0,0,1,0,1,2,0,0,2,0,2,4,1
2956,40063,l5LfU8gApOG72AnBkdAbfOLQLwFH7Zo2,bWdj2GDclj5ofokWjzoa5jAwMkxCykd6,19,43,4,128,5,3,7,0,190,27.142857142857142,4,0.0,14,4,123,5,29,3,5,7,0,146,44,1
2957,40074,gT1aUgmAT0anYSW9us4nwhFYETF9WL3j,A3fsA9Zfv1X2fVEQhTw51lKENdNrEqT3,5,2,1,0,1,0,2,0,6,0.8571428571428571,1,0.0,0,1,0,1,2,0,0,2,0,2,4,1
2958,40079,2A7IXlmbeljDbPAl1ZsZqwpJw9LPGGGX,SpATywNh6bZuzm8s1ceuBUnMUAeoAHHw,31,29,18,28,9,15,7,1,107,15.285714285714286,2,0.0,8,18,23,9,21,15,5,7,1,58,49,1
2959,40080,tw29YEXMOD494kfaqMSHK6i8NRmqKdtq,G8EPVSXsOYB5YQWZGiz1aVq5Pgr2GrQu,9,4,3,0,3,0,2,0,12,1.7142857142857142,1,0.0,0,3,0,3,4,0,0,2,0,6,6,1
2960,40081,zyMs55MEXcYV6llnecBHL4KGyjGwZwbR,SpATywNh6bZuzm8s1ceuBUnMUAeoAHHw,8,6,1,14,0,0,4,0,25,3.5714285714285716,2,0.0,3,1,13,0,3,0,1,4,0,17,8,0
2961,40084,J8UiKHYyR4z2Md44vzlhH8x9Cnerjpzr,G8EPVSXsOYB5YQWZGiz1aVq5Pgr2GrQu,2,0,0,0,0,0,2,0,2,0.2857142857142857,1,0.0,0,0,0,0,0,0,0,2,0,0,2,1
2962,40087,yoDT9q7GsYYKpWeoYGubo3V2RcRn4gQU,A3fsA9Zfv1X2fVEQhTw51lKENdNrEqT3,24,4,2,56,1,0,3,0,66,9.428571428571429,1,0.0,1,2,47,1,3,0,9,3,0,51,15,1
2963,40101,D2f4XnvAFD8ZIkDvhpGbd6yCstJua9ut,SpATywNh6bZuzm8s1ceuBUnMUAeoAHHw,8,8,3,0,2,0,2,0,15,2.142857142857143,1,0.0,0,3,0,2,8,0,0,2,0,5,10,1
2964,40104,FUMcFXXfXADMgcSzTyKSabMQ45EVJp0n,A3fsA9Zfv1X2fVEQhTw51lKENdNrEqT3,42,24,19,72,12,1,16,0,144,20.571428571428573,5,0.0,1,19,60,12,23,1,12,16,0,92,52,1
2965,40137,7Blw5DXu09ENSrwHZywqqUdODuz4CZi6,SpATywNh6bZuzm8s1ceuBUnMUAeoAHHw,31,39,18,24,11,0,18,1,111,15.857142857142858,4,0.0,13,18,21,11,26,0,3,18,1,63,48,0
2966,40139,5veZ6xRUiuZvoK7jObyhZU0X1eoLbhpg,SpATywNh6bZuzm8s1ceuBUnMUAeoAHHw,6,3,2,0,2,0,1,0,8,1.1428571428571428,1,0.0,0,2,0,2,3,0,0,1,0,4,4,1
2967,40140,LEeLDvxwrRnZu2qnrsr2uQ3TKN0DCY1A,SpATywNh6bZuzm8s1ceuBUnMUAeoAHHw,4,2,1,0,1,1,1,0,6,0.8571428571428571,1,0.0,0,1,0,1,2,1,0,1,0,2,4,0
2968,40149,iUzEPtD1F6CCo8jGkTMMkDMICh5ACqJB,SpATywNh6bZuzm8s1ceuBUnMUAeoAHHw,7,4,2,0,1,0,6,0,13,1.8571428571428572,2,0.0,0,2,0,1,4,0,0,6,0,3,10,1
2969,40154,grc1pAXqdUQaBlZrZyROqjuEtg08nen2,bWdj2GDclj5ofokWjzoa5jAwMkxCykd6,6,2,0,0,0,0,10,0,12,1.7142857142857142,1,0.0,0,0,0,0,2,0,0,10,0,0,12,0
2970,40156,BM23agkLBTvZTkItMt2GtI7Rt9Nmmgof,SpATywNh6bZuzm8s1ceuBUnMUAeoAHHw,20,52,25,0,10,83,11,0,181,25.857142857142858,6,0.0,6,25,0,10,46,83,0,11,0,41,140,0
2971,40164,Ml8yd2wTtJsMaa32cmbKtb7cTpIqIKz4,SpATywNh6bZuzm8s1ceuBUnMUAeoAHHw,20,54,34,26,16,0,11,0,141,20.142857142857142,3,0.0,13,34,20,16,41,0,6,11,0,83,58,1
2972,40175,m2y02R5W4wE10TMNO80PJL5IOUbHqLJ2,SpATywNh6bZuzm8s1ceuBUnMUAeoAHHw,30,43,26,19,8,0,14,0,110,15.714285714285714,6,0.0,6,26,19,8,37,0,0,14,0,59,51,0
2973,40182,gMD3QXq0NP11IqNCLAQviPDQUlnfIgHG,A3fsA9Zfv1X2fVEQhTw51lKENdNrEqT3,14,25,1,0,0,13,7,3,49,7.0,2,0.0,0,1,0,0,25,13,0,7,3,1,48,1
2974,40184,p2NSaI2ihMq1kpyPoZO7VVEhFNMs1UZl,bWdj2GDclj5ofokWjzoa5jAwMkxCykd6,15,27,6,104,5,9,5,2,158,22.571428571428573,3,0.0,11,6,97,5,16,9,7,5,2,119,39,1
2975,40188,su19QKj6MYt8IN4q4jbVFtyo4Ew7wkeA,RXDvfPUBYFlVdlueBFbLW0mhhAyGEqpt,12,11,9,0,3,1,4,0,28,4.0,1,0.0,0,9,0,3,11,1,0,4,0,12,16,1
2976,40190,PPWmWzLrUp96FN46Q0IBJuH09vUmH4P8,RXDvfPUBYFlVdlueBFbLW0mhhAyGEqpt,5,2,2,0,0,1,2,0,7,1.0,1,0.0,0,2,0,0,2,1,0,2,0,2,5,1
2977,40198,w1whp42bLIFDRZ3YUW58J4w8I7T8mTT8,SpATywNh6bZuzm8s1ceuBUnMUAeoAHHw,18,72,9,10,3,14,36,1,145,20.714285714285715,7,0.0,25,9,10,3,47,14,0,36,1,47,98,1
2978,40204,tYXSIW41vEc1ilow8iQ6smCJvAodHkNV,bWdj2GDclj5ofokWjzoa5jAwMkxCykd6,3,0,0,0,0,4,6,0,10,1.4285714285714286,3,0.0,0,0,0,0,0,4,0,6,0,0,10,1
2979,40221,eLZwBv2irk6SjmpfpnKpxtWIlq5cEmna,SpATywNh6bZuzm8s1ceuBUnMUAeoAHHw,1,0,0,0,0,0,1,0,1,0.14285714285714285,1,0.0,0,0,0,0,0,0,0,1,0,0,1,1
2980,40222,eLodedTH8LaOO46CeXCjKZbHSbVrNTIU,SpATywNh6bZuzm8s1ceuBUnMUAeoAHHw,14,9,4,12,3,0,2,0,30,4.285714285714286,1,0.0,3,4,10,3,6,0,2,2,0,20,10,1
2981,40241,9y5g4IgoufVMmdRflE8Vnup7J4tZ9eiA,SpATywNh6bZuzm8s1ceuBUnMUAeoAHHw,9,13,5,0,2,0,3,0,23,3.2857142857142856,2,0.0,0,5,0,2,13,0,0,3,0,7,16,1
2982,40247,CnndUXNaSJ8w2bb9DGxHOhqjHw4SEo1K,SpATywNh6bZuzm8s1ceuBUnMUAeoAHHw,18,55,18,24,7,39,16,1,160,22.857142857142858,6,0.0,20,18,21,7,35,39,3,16,1,66,94,0
2983,40257,IRfJ2J3e4oTjcMA6yNpRgLvZtLwyduUa,SpATywNh6bZuzm8s1ceuBUnMUAeoAHHw,28,91,36,33,22,12,26,0,220,31.428571428571427,6,0.0,10,36,30,22,81,12,3,26,0,98,122,0
2984,40277,w1whp42bLIFDRZ3YUW58J4w8I7T8mTT8,G8EPVSXsOYB5YQWZGiz1aVq5Pgr2GrQu,1,0,0,0,0,0,3,0,3,0.42857142857142855,2,0.0,0,0,0,0,0,0,0,3,0,0,3,1
2985,40278,mMBONcOMl6gC3uzknh0XJLJbk13L2x3D,SpATywNh6bZuzm8s1ceuBUnMUAeoAHHw,1,0,0,0,0,0,1,0,1,0.14285714285714285,1,0.0,0,0,0,0,0,0,0,1,0,0,1,1
2986,40282,CSh5hGbaSFu2yCb31iVMOVwKocrH471Q,A3fsA9Zfv1X2fVEQhTw51lKENdNrEqT3,44,34,22,80,15,0,10,0,161,23.0,5,0.0,1,22,61,15,33,0,19,10,0,99,62,1
2987,40283,QrVCBnMblCvtcbL9oEOfx7eoMJ5VAhGg,A3fsA9Zfv1X2fVEQhTw51lKENdNrEqT3,5,3,0,0,0,1,4,0,8,1.1428571428571428,1,0.0,0,0,0,0,3,1,0,4,0,0,8,1
2988,40311,1Pk7jZ6bfmKYXcNnRyEd7kPSZWAEJN0N,RXDvfPUBYFlVdlueBFbLW0mhhAyGEqpt,4,0,0,0,0,1,3,4,8,1.1428571428571428,3,0.0,0,0,0,0,0,1,0,3,4,0,8,1
2989,40316,TDPVJF1yuusgDrAkAZKxkuuOK4BkswXA,RXDvfPUBYFlVdlueBFbLW0mhhAyGEqpt,1,0,0,0,0,0,1,0,1,0.14285714285714285,1,0.0,0,0,0,0,0,0,0,1,0,0,1,1
2990,40319,wg81hfugF770xMHAXCLP7YJmOhdUJnHl,A3fsA9Zfv1X2fVEQhTw51lKENdNrEqT3,11,16,6,0,3,12,9,0,46,6.571428571428571,4,0.0,0,6,0,3,16,12,0,9,0,9,37,0
2991,40327,5vUuq5ZeDCNce4LmvH0naoUjpb3qbNOp,A3fsA9Zfv1X2fVEQhTw51lKENdNrEqT3,52,71,37,76,8,3,21,1,217,31.0,5,0.0,3,37,57,8,68,3,19,21,1,105,112,1
2992,40332,JCQSo9f9Aey0YG4wslCCbhR6oOLB0oC6,SpATywNh6bZuzm8s1ceuBUnMUAeoAHHw,30,41,20,16,7,5,17,1,107,15.285714285714286,6,0.0,8,20,15,7,33,5,1,17,1,50,57,0
2993,40352,lkFGShqBa18inWINppsv8Kl48gyf85dR,A3fsA9Zfv1X2fVEQhTw51lKENdNrEqT3,27,18,13,0,11,4,8,1,55,7.857142857142857,1,0.0,1,13,0,11,17,4,0,8,1,25,30,0
2994,40354,GFHYWWeeAuj1pePvOmCpIpIQDTy4Q3Iv,RXDvfPUBYFlVdlueBFbLW0mhhAyGEqpt,5,4,3,0,0,0,3,0,10,1.4285714285714286,1,0.0,0,3,0,0,4,0,0,3,0,3,7,0
2995,40358,EEH4DLdmIdcQf1RzjjDafMrB5kVed71w,A3fsA9Zfv1X2fVEQhTw51lKENdNrEqT3,12,12,6,0,5,1,12,0,36,5.142857142857143,3,0.0,0,6,0,5,12,1,0,12,0,11,25,1
2996,40364,yzVmKfAEq3932HHrOfA6gQJmdnGWlxk3,bWdj2GDclj5ofokWjzoa5jAwMkxCykd6,1,0,0,0,0,0,1,0,1,0.14285714285714285,1,0.0,0,0,0,0,0,0,0,1,0,0,1,1
2997,40367,wg81hfugF770xMHAXCLP7YJmOhdUJnHl,bWdj2GDclj5ofokWjzoa5jAwMkxCykd6,7,10,3,4,1,0,3,0,21,3.0,2,0.0,1,3,3,1,9,0,1,3,0,8,13,0
2998,40368,12mZjkjOmjGXj1h45WoNLHZyHxNUfx7S,SpATywNh6bZuzm8s1ceuBUnMUAeoAHHw,8,10,1,0,0,0,4,0,15,2.142857142857143,2,0.0,0,1,0,0,10,0,0,4,0,1,14,1
2999,40379,ypimmfavTEjP3dtudBXAUUwNT9VgZavl,SpATywNh6bZuzm8s1ceuBUnMUAeoAHHw,6,3,2,0,1,0,3,0,9,1.2857142857142858,1,0.0,0,2,0,1,3,0,0,3,0,3,6,1
3000,40393,b3FNzt9bW0DYxGtrDwfKBHrmIKO1If8w,SpATywNh6bZuzm8s1ceuBUnMUAeoAHHw,8,10,3,0,3,0,2,0,18,2.5714285714285716,2,0.0,0,3,0,3,10,0,0,2,0,6,12,1
3001,40400,OEVp80aW59NsIt7NX2Io1skiDEX4Ksu0,RXDvfPUBYFlVdlueBFbLW0mhhAyGEqpt,9,5,5,0,1,2,6,2,21,3.0,2,0.0,0,5,0,1,5,2,0,6,2,6,15,1
3002,40402,O7GZYzgRa5tZbYrbtpqYuheFfdPZTjLl,bWdj2GDclj5ofokWjzoa5jAwMkxCykd6,13,25,12,30,7,52,13,2,141,20.142857142857142,4,0.0,5,12,28,7,20,52,2,13,2,52,89,1
3003,40407,oKgEB6oFYTWjl9uatjwv0rz1CsEob0nE,G8EPVSXsOYB5YQWZGiz1aVq5Pgr2GrQu,1,0,0,0,0,0,1,0,1,0.14285714285714285,1,0.0,0,0,0,0,0,0,0,1,0,0,1,1
3004,40413,0Cx8S0i9vAPm7jZ8jXLUkrYp9xGpIHIS,SpATywNh6bZuzm8s1ceuBUnMUAeoAHHw,4,2,1,0,0,4,3,2,12,1.7142857142857142,2,0.0,0,1,0,0,2,4,0,3,2,1,11,1
3005,40423,8jqDD2phXiMGQf0XQi1kVRzLj3TILO0y,RXDvfPUBYFlVdlueBFbLW0mhhAyGEqpt,21,25,15,44,6,0,7,0,97,13.857142857142858,3,0.0,7,15,36,6,18,0,8,7,0,64,33,1
3006,40426,gp5vtbG0la8PEmRrqmDatBiyjEv7PWrx,SpATywNh6bZuzm8s1ceuBUnMUAeoAHHw,9,12,5,20,0,0,3,0,40,5.714285714285714,3,0.0,3,5,16,0,9,0,4,3,0,24,16,1
3007,40427,7x51V9V9eIHFPqiYUnOLpACvWY55pqZF,G8EPVSXsOYB5YQWZGiz1aVq5Pgr2GrQu,6,4,2,0,2,0,2,0,10,1.4285714285714286,1,0.0,0,2,0,2,4,0,0,2,0,4,6,1
3008,40437,sV8Z2WoHSkq80AVgpDh4TBiipVVqEZ0U,A3fsA9Zfv1X2fVEQhTw51lKENdNrEqT3,6,2,1,0,1,0,4,0,8,1.1428571428571428,1,0.0,0,1,0,1,2,0,0,4,0,2,6,1
3009,40438,sV8Z2WoHSkq80AVgpDh4TBiipVVqEZ0U,bWdj2GDclj5ofokWjzoa5jAwMkxCykd6,4,2,1,0,1,0,1,0,5,0.7142857142857143,1,0.0,0,1,0,1,2,0,0,1,0,2,3,1
3010,40447,y6i20DJpIul6LihHwgZcWxbdAap5GcBP,bWdj2GDclj5ofokWjzoa5jAwMkxCykd6,6,4,0,0,0,1,5,0,10,1.4285714285714286,3,0.0,0,0,0,0,4,1,0,5,0,0,10,1
3011,40456,vGcLxIxx9hPQmjm92Kj3O9RHGwvxcHnD,RXDvfPUBYFlVdlueBFbLW0mhhAyGEqpt,18,13,8,6,4,7,8,1,47,6.714285714285714,2,0.0,1,8,6,4,12,7,0,8,1,19,28,1
3012,40467,bNBhDpviOcrLuVFG9Qda6S7fiYJ6jIvc,SpATywNh6bZuzm8s1ceuBUnMUAeoAHHw,19,35,15,14,6,0,5,0,75,10.714285714285714,5,0.0,9,15,13,6,26,0,1,5,0,43,32,1
3013,40469,zynLWMDwDGZGrMFdec4rl1UB2FSg8e8K,A3fsA9Zfv1X2fVEQhTw51lKENdNrEqT3,16,8,6,0,4,2,10,1,31,4.428571428571429,2,0.0,0,6,0,4,8,2,0,10,1,10,21,1
3014,40470,nc7wDS7f7s8kprAeqMfrtjmYyoRdpJ65,bWdj2GDclj5ofokWjzoa5jAwMkxCykd6,7,4,2,0,1,3,7,1,18,2.5714285714285716,2,0.0,0,2,0,1,4,3,0,7,1,3,15,1
3015,40476,EChSttZSil8pQFLm0qImYXOhSqXem2dj,SpATywNh6bZuzm8s1ceuBUnMUAeoAHHw,8,7,0,0,0,0,4,2,13,1.8571428571428572,1,0.0,1,0,0,0,6,0,0,4,2,1,12,1
3016,40478,i0LHbVo0MUWeo1slrPpQRlCoWzknlhLR,A3fsA9Zfv1X2fVEQhTw51lKENdNrEqT3,5,2,1,0,1,0,2,0,6,0.8571428571428571,1,0.0,0,1,0,1,2,0,0,2,0,2,4,1
3017,40483,qbRtu1q5PIx1qmhJ9lRn0S3Y5dNcEYWw,G8EPVSXsOYB5YQWZGiz1aVq5Pgr2GrQu,16,10,3,18,2,0,7,0,40,5.714285714285714,2,0.0,0,3,14,2,10,0,4,7,0,19,21,1
3018,40486,JyWRLOWjORt63r48lT9LFGZBSOdXCttf,SpATywNh6bZuzm8s1ceuBUnMUAeoAHHw,6,3,2,0,2,0,1,0,8,1.1428571428571428,1,0.0,0,2,0,2,3,0,0,1,0,4,4,1
3019,40507,ZuoiR8ZSgQ4EIp0UPK1kvYAuneCl6lTF,SpATywNh6bZuzm8s1ceuBUnMUAeoAHHw,8,9,6,0,3,0,1,0,19,2.7142857142857144,1,0.0,1,6,0,3,8,0,0,1,0,10,9,1
3020,40512,l01aGQuAgd5VHAVuk21pZMIeJcDQOX6i,RXDvfPUBYFlVdlueBFbLW0mhhAyGEqpt,31,30,15,73,8,0,7,0,133,19.0,4,0.0,7,15,69,8,23,0,4,7,0,99,34,0
3021,40514,weKRMLBzfxs8ekS11Y9oGFXbhmcomWRF,A3fsA9Zfv1X2fVEQhTw51lKENdNrEqT3,73,53,33,112,18,0,25,0,241,34.42857142857143,6,0.0,6,33,107,18,47,0,5,25,0,164,77,0
3022,40515,zynLWMDwDGZGrMFdec4rl1UB2FSg8e8K,bWdj2GDclj5ofokWjzoa5jAwMkxCykd6,5,2,1,0,1,0,4,0,8,1.1428571428571428,1,0.0,0,1,0,1,2,0,0,4,0,2,6,1
3023,40525,Su94NLhpMEwzyTwfu3GGXYbQEbtpeLin,G8EPVSXsOYB5YQWZGiz1aVq5Pgr2GrQu,23,23,3,28,3,0,3,0,60,8.571428571428571,3,0.0,1,3,24,3,22,0,4,3,0,31,29,1
3024,40531,KUjjznPFpWdBg0GS5p0fa4zyp2j0nULG,SpATywNh6bZuzm8s1ceuBUnMUAeoAHHw,2,0,0,0,0,0,2,0,2,0.2857142857142857,1,0.0,0,0,0,0,0,0,0,2,0,0,2,1
3025,40541,55BMoXCnWKUmNoRDU7bcdmqWNuK9JpZ6,RXDvfPUBYFlVdlueBFbLW0mhhAyGEqpt,5,6,1,0,0,0,3,0,10,1.4285714285714286,1,0.0,2,1,0,0,4,0,0,3,0,3,7,1
3026,40554,vG6SgKMKhZDlcYDUDKC1NlbpiW2uFCxn,A3fsA9Zfv1X2fVEQhTw51lKENdNrEqT3,11,11,0,0,0,4,10,0,25,3.5714285714285716,3,0.0,0,0,0,0,11,4,0,10,0,0,25,1
3027,40565,jPMKgTfqS9zWr9zlMBzf8ARp4D8cnFWF,SpATywNh6bZuzm8s1ceuBUnMUAeoAHHw,7,7,3,0,2,0,2,0,14,2.0,1,0.0,0,3,0,2,7,0,0,2,0,5,9,1
3028,40576,V2LBVc8iZdDnuXsiI9Sw06zIg4OqT9B6,SpATywNh6bZuzm8s1ceuBUnMUAeoAHHw,18,46,20,7,9,7,21,1,111,15.857142857142858,5,0.0,14,20,7,9,32,7,0,21,1,50,61,1
3029,40583,EVKTxmdXvqH9f0V4XuFLHjVRnnUWi9xh,A3fsA9Zfv1X2fVEQhTw51lKENdNrEqT3,49,66,41,46,17,1,38,1,210,30.0,11,0.0,11,41,39,17,55,1,7,38,1,108,102,1
3030,40591,izEpfh69zQRV21ZbipmxXr7f4EKcykoG,bWdj2GDclj5ofokWjzoa5jAwMkxCykd6,11,10,2,0,2,1,11,1,27,3.857142857142857,4,0.0,0,2,0,2,10,1,0,11,1,4,23,1
3031,40600,0ipS9A7VTQjzw25R8uCDpA963DAu7orq,SpATywNh6bZuzm8s1ceuBUnMUAeoAHHw,2,0,0,0,0,0,2,0,2,0.2857142857142857,1,0.0,0,0,0,0,0,0,0,2,0,0,2,1
3032,40608,nD2aR2lBTYEZ05tUWGjogkwgt2d7zeNx,A3fsA9Zfv1X2fVEQhTw51lKENdNrEqT3,43,46,2,92,2,0,4,0,146,20.857142857142858,3,0.0,0,2,81,2,46,0,11,4,0,85,61,1
3033,40611,hQ1i3lCFgZxFqzoAUMmIxeDISYlA8zCv,A3fsA9Zfv1X2fVEQhTw51lKENdNrEqT3,11,5,4,0,4,0,6,0,19,2.7142857142857144,1,0.0,0,4,0,4,5,0,0,6,0,8,11,1
3034,40622,FUMcFXXfXADMgcSzTyKSabMQ45EVJp0n,bWdj2GDclj5ofokWjzoa5jAwMkxCykd6,53,62,35,218,15,23,30,2,385,55.0,7,0.0,13,35,187,15,49,23,31,30,2,250,135,0
3035,40624,Tf1mjUo3ghY0Z5spwun4QIkEOaJmI2Lk,RXDvfPUBYFlVdlueBFbLW0mhhAyGEqpt,7,1,1,0,1,4,10,2,19,2.7142857142857144,1,0.0,0,1,0,1,1,4,0,10,2,2,17,1
3036,40635,BOna3ORacJGhjt4FcGMkKNwkDYsEjcvt,RXDvfPUBYFlVdlueBFbLW0mhhAyGEqpt,28,45,24,0,12,1,17,2,101,14.428571428571429,6,0.0,0,24,0,12,45,1,0,17,2,36,65,1
3037,40638,KLMwnbeiUPyAq67r6m0k1uM0yIHdmaWg,SpATywNh6bZuzm8s1ceuBUnMUAeoAHHw,6,2,0,0,0,0,5,0,7,1.0,1,0.0,0,0,0,0,2,0,0,5,0,0,7,1
3038,40646,uL0Po5J8HnBQPqSUKMNRTAvfe5A6cmqw,bWdj2GDclj5ofokWjzoa5jAwMkxCykd6,5,2,1,0,1,0,2,0,6,0.8571428571428571,1,0.0,0,1,0,1,2,0,0,2,0,2,4,1
3039,40670,AMHmOq5PY3K2Bq5bkWrg2Cz6hshdhVde,SpATywNh6bZuzm8s1ceuBUnMUAeoAHHw,11,15,1,7,1,4,8,0,36,5.142857142857143,3,0.0,2,1,6,1,13,4,1,8,0,10,26,1
3040,40685,UIuYkrvUrLhMOE6NfUprrMfA4RCzuhOi,SpATywNh6bZuzm8s1ceuBUnMUAeoAHHw,8,3,2,0,2,0,5,1,13,1.8571428571428572,1,0.0,0,2,0,2,3,0,0,5,1,4,9,1
3041,40693,UGYGSfRkJhOkgkdlCI6YSCshpNvwBF31,SpATywNh6bZuzm8s1ceuBUnMUAeoAHHw,11,13,8,3,4,0,3,0,31,4.428571428571429,2,0.0,1,8,3,4,12,0,0,3,0,16,15,1
3042,40694,EY3QtJOWsoMIz6ZJR9ZEsrPPDsaYmN0t,SpATywNh6bZuzm8s1ceuBUnMUAeoAHHw,16,31,0,20,0,19,21,2,93,13.285714285714286,3,0.0,7,0,15,0,24,19,5,21,2,22,71,1
3043,40696,mWUHV4msWZXLdeYpWFdjuucQsrIdSFxH,SpATywNh6bZuzm8s1ceuBUnMUAeoAHHw,1,0,0,0,0,0,1,0,1,0.14285714285714285,1,0.0,0,0,0,0,0,0,0,1,0,0,1,1
3044,40697,B9Ey1tIo6ANxVa0IvzoinvUWj4cenbLl,SpATywNh6bZuzm8s1ceuBUnMUAeoAHHw,11,19,2,11,1,0,1,0,34,4.857142857142857,4,0.0,3,2,9,1,16,0,2,1,0,15,19,1
3045,40717,P11RKOPCDL5miqBQ5O3oznfREAcXF9hp,A3fsA9Zfv1X2fVEQhTw51lKENdNrEqT3,49,48,24,50,22,4,23,2,173,24.714285714285715,4,0.0,1,24,44,22,47,4,6,23,2,91,82,0
3046,40720,n0jV4ldO1halkYjljprJ6GkJFBgQehlW,bWdj2GDclj5ofokWjzoa5jAwMkxCykd6,5,5,0,0,0,0,3,0,8,1.1428571428571428,1,0.0,0,0,0,0,5,0,0,3,0,0,8,1
3047,40731,1UUWIp3PiN0CT0O96IXxrt6TRVFJmFUz,bWdj2GDclj5ofokWjzoa5jAwMkxCykd6,2,0,0,0,0,0,2,0,2,0.2857142857142857,1,0.0,0,0,0,0,0,0,0,2,0,0,2,1
3048,40755,1Pk7jZ6bfmKYXcNnRyEd7kPSZWAEJN0N,SpATywNh6bZuzm8s1ceuBUnMUAeoAHHw,2,0,0,0,0,0,2,0,2,0.2857142857142857,2,0.0,0,0,0,0,0,0,0,2,0,0,2,1
3049,40759,1Pk7jZ6bfmKYXcNnRyEd7kPSZWAEJN0N,bWdj2GDclj5ofokWjzoa5jAwMkxCykd6,10,12,0,2,1,3,13,2,33,4.714285714285714,4,0.0,1,0,2,1,11,3,0,13,2,4,29,1
3050,40760,n0jV4ldO1halkYjljprJ6GkJFBgQehlW,A3fsA9Zfv1X2fVEQhTw51lKENdNrEqT3,8,8,1,0,1,0,3,0,13,1.8571428571428572,2,0.0,0,1,0,1,8,0,0,3,0,2,11,1
3051,40762,FcIMQNoo2B9wNij30W0t3SsuF1pzZCFp,SpATywNh6bZuzm8s1ceuBUnMUAeoAHHw,14,42,0,21,0,19,33,8,123,17.571428571428573,6,0.0,19,0,18,0,23,19,3,33,8,37,86,0
3052,40771,bsalGAvHbAyi2zQkMdMuno7PqVBrE5qV,SpATywNh6bZuzm8s1ceuBUnMUAeoAHHw,11,14,7,2,4,1,1,0,29,4.142857142857143,1,0.0,6,7,2,4,8,1,0,1,0,19,10,1
3053,40784,H2Rgqo3kRDsNdbNVEDl0788s9SSdLM8P,A3fsA9Zfv1X2fVEQhTw51lKENdNrEqT3,10,8,1,0,0,0,4,0,13,1.8571428571428572,1,0.0,0,1,0,0,8,0,0,4,0,1,12,1
3054,40788,TXXodrsD3gpNuvLWnhSXeHO4v2Kp7PZ2,SpATywNh6bZuzm8s1ceuBUnMUAeoAHHw,18,22,10,13,4,0,7,0,56,8.0,4,0.0,3,10,11,4,19,0,2,7,0,28,28,1
3055,40790,c6KChK06Rh7fb4zwLQYLlfB5pAi9XDtG,A3fsA9Zfv1X2fVEQhTw51lKENdNrEqT3,15,14,2,2,2,0,6,0,26,3.7142857142857144,2,0.0,0,2,2,2,14,0,0,6,0,6,20,1
3056,40818,0wm7bVyJC7jfhIoeylaV85sHOH5JOhtj,RXDvfPUBYFlVdlueBFbLW0mhhAyGEqpt,1,0,0,0,0,0,4,0,4,0.5714285714285714,4,0.0,0,0,0,0,0,0,0,4,0,0,4,1
3057,40830,WVkWa16sSufUj4kk1L49kzGtRQMQkIJr,SpATywNh6bZuzm8s1ceuBUnMUAeoAHHw,14,30,2,17,1,0,6,0,56,8.0,3,0.0,6,2,14,1,24,0,3,6,0,23,33,1
3058,40833,LRHDYNgQAsG2UssS8TgaqkiYDbFlVrrj,bWdj2GDclj5ofokWjzoa5jAwMkxCykd6,5,2,1,0,1,0,2,0,6,0.8571428571428571,1,0.0,0,1,0,1,2,0,0,2,0,2,4,1
3059,40845,PiMa9t7XXgGIfYACepD9P8yHYFoha6X9,SpATywNh6bZuzm8s1ceuBUnMUAeoAHHw,7,3,2,0,2,0,2,0,9,1.2857142857142858,1,0.0,0,2,0,2,3,0,0,2,0,4,5,1
3060,40851,hkTx4XunczsnVq4H9eVYRZURkkofvB6I,bWdj2GDclj5ofokWjzoa5jAwMkxCykd6,15,19,7,20,3,29,6,0,84,12.0,2,0.0,4,7,16,3,15,29,4,6,0,30,54,1
3061,40858,dJJJLtI6F18pblO9KPkBPg9ZKTgQPaQc,SpATywNh6bZuzm8s1ceuBUnMUAeoAHHw,16,43,4,8,1,3,9,0,68,9.714285714285714,7,0.0,15,4,8,1,28,3,0,9,0,28,40,0
3062,40861,40L77km5z19sJEVeJ6u4qpa9SAG2ZSIF,SpATywNh6bZuzm8s1ceuBUnMUAeoAHHw,19,30,18,26,0,0,11,0,85,12.142857142857142,4,0.0,7,18,23,0,23,0,3,11,0,48,37,0
3063,40862,dNG5hDkS45m4C7FwHXebOEhyKKD4NWCM,SpATywNh6bZuzm8s1ceuBUnMUAeoAHHw,9,4,2,0,2,0,4,1,13,1.8571428571428572,1,0.0,1,2,0,2,3,0,0,4,1,5,8,1
3064,40870,8gfCGxZ6lFjZr89RwPF8oXZs1Qn6Pq6X,bWdj2GDclj5ofokWjzoa5jAwMkxCykd6,3,0,0,0,0,0,10,0,10,1.4285714285714286,3,0.0,0,0,0,0,0,0,0,10,0,0,10,1
3065,40873,EjYujgGigN4Oo3US4ixRA3bL0nJn2PDZ,SpATywNh6bZuzm8s1ceuBUnMUAeoAHHw,25,27,5,38,3,4,11,0,88,12.571428571428571,5,0.0,4,5,33,3,23,4,5,11,0,45,43,1
3066,40875,2ekh2uQneNAGmhQ3c3UciXnUFmuOUWou,SpATywNh6bZuzm8s1ceuBUnMUAeoAHHw,28,38,21,30,12,2,10,1,114,16.285714285714285,4,0.0,10,21,27,12,28,2,3,10,1,70,44,1
3067,40877,EjYujgGigN4Oo3US4ixRA3bL0nJn2PDZ,G8EPVSXsOYB5YQWZGiz1aVq5Pgr2GrQu,5,6,1,0,1,0,3,0,11,1.5714285714285714,2,0.0,1,1,0,1,5,0,0,3,0,3,8,1
3068,40891,CuHXUjtagLOKelRrRvelBtnV2Gm8l97I,RXDvfPUBYFlVdlueBFbLW0mhhAyGEqpt,5,2,1,0,1,0,4,0,8,1.1428571428571428,1,0.0,0,1,0,1,2,0,0,4,0,2,6,1
3069,40905,aldLXGpzmiip2CUSDhqN8A5UpGMVUHxY,bWdj2GDclj5ofokWjzoa5jAwMkxCykd6,35,66,39,38,16,18,17,0,194,27.714285714285715,9,0.0,10,39,38,16,56,18,0,17,0,103,91,0
3070,40908,OXDIjQPBiuWpB7PdzfniEtiITaq40Kxq,RXDvfPUBYFlVdlueBFbLW0mhhAyGEqpt,2,0,0,0,0,0,2,0,2,0.2857142857142857,1,0.0,0,0,0,0,0,0,0,2,0,0,2,1
3071,40910,M2AmcvqhvMtUlyRV6vMvvoM2IhrMmAwT,A3fsA9Zfv1X2fVEQhTw51lKENdNrEqT3,100,49,33,124,21,40,27,5,299,42.714285714285715,6,0.0,6,33,124,21,43,40,0,27,5,184,115,1
3072,40911,CdB6oTxVZuxQJ7m61lQzyuJSIxL6zQLH,A3fsA9Zfv1X2fVEQhTw51lKENdNrEqT3,16,17,8,0,7,0,4,0,36,5.142857142857143,1,0.0,0,8,0,7,17,0,0,4,0,15,21,1
3073,40918,6tIWZMByN6VbFXOKgaTSsptqRovNe938,bWdj2GDclj5ofokWjzoa5jAwMkxCykd6,1,0,0,0,0,0,1,0,1,0.14285714285714285,1,0.0,0,0,0,0,0,0,0,1,0,0,1,1
3074,40920,6tIWZMByN6VbFXOKgaTSsptqRovNe938,A3fsA9Zfv1X2fVEQhTw51lKENdNrEqT3,8,4,2,0,0,1,7,1,15,2.142857142857143,2,0.0,0,2,0,0,4,1,0,7,1,2,13,1
3075,40928,qoIGs6RP8XMC5yN9VowJtSVp77FsPrRk,A3fsA9Zfv1X2fVEQhTw51lKENdNrEqT3,25,40,27,0,16,0,8,0,91,13.0,3,0.0,1,27,0,16,39,0,0,8,0,44,47,1
3076,40936,DJeWlgB4cP1RQ3JZLa1wZwd4zgAbYOxv,RXDvfPUBYFlVdlueBFbLW0mhhAyGEqpt,1,0,0,0,0,0,1,0,1,0.14285714285714285,1,0.0,0,0,0,0,0,0,0,1,0,0,1,1
3077,40946,G14xjTwMWbfsqTNiU3Ie1utHyPegqSvR,G8EPVSXsOYB5YQWZGiz1aVq5Pgr2GrQu,4,2,1,0,1,0,2,0,6,0.8571428571428571,2,0.0,0,1,0,1,2,0,0,2,0,2,4,1
3078,40947,G14xjTwMWbfsqTNiU3Ie1utHyPegqSvR,SpATywNh6bZuzm8s1ceuBUnMUAeoAHHw,14,20,4,19,0,0,4,0,47,6.714285714285714,3,0.0,5,4,18,0,15,0,1,4,0,27,20,1
3079,40959,kKw20KeSl1t7Pslb9OutpFfK6qbHmAq8,bWdj2GDclj5ofokWjzoa5jAwMkxCykd6,8,10,2,0,0,0,10,1,23,3.2857142857142856,2,0.0,4,2,0,0,6,0,0,10,1,6,17,1
3080,40965,dSPH9g8Ag2uZLcQxLXukxNXBLRvLY5xp,A3fsA9Zfv1X2fVEQhTw51lKENdNrEqT3,10,8,0,0,1,0,1,0,10,1.4285714285714286,2,0.0,0,0,0,1,8,0,0,1,0,1,9,1
3081,40994,WmqMKoevd5yMpzwxk3BDNFkg4y1FZjx5,G8EPVSXsOYB5YQWZGiz1aVq5Pgr2GrQu,45,64,8,18,8,2,18,1,119,17.0,13,0.0,1,8,15,8,63,2,3,18,1,32,87,1
3082,40998,syzcMhy375dEj89fdUtXti8MXg1a8bSN,7GRhBDsirIGkRZBtSMEzNTyDr2JQm4xx,26,58,23,54,5,1,30,0,171,24.428571428571427,3,0.0,18,23,52,5,40,1,2,30,0,98,73,1
3083,41012,9GQBKn8LG5mdPSwy8AFUPaG4NSLWjEYt,7GRhBDsirIGkRZBtSMEzNTyDr2JQm4xx,9,15,5,0,0,0,12,2,34,4.857142857142857,2,0.0,3,5,0,0,12,0,0,12,2,8,26,1
3084,41018,Htb70W0lnqw4QeBjeePevzE0xRg4O6vF,7GRhBDsirIGkRZBtSMEzNTyDr2JQm4xx,6,4,2,0,1,0,2,0,9,1.2857142857142858,2,0.0,1,2,0,1,3,0,0,2,0,4,5,1
3085,41023,8Ht2Zmfn81Gwb093X2QMQmBGW6qi8rRd,7GRhBDsirIGkRZBtSMEzNTyDr2JQm4xx,41,67,27,70,26,2,9,0,201,28.714285714285715,6,0.0,31,27,60,26,36,2,10,9,0,144,57,1
3086,41066,wb00XyLFbUrmycITZ6LeGF1mEqSeoH2s,7GRhBDsirIGkRZBtSMEzNTyDr2JQm4xx,7,6,1,12,0,0,2,0,21,3.0,1,0.0,3,1,10,0,3,0,2,2,0,14,7,1
3087,41082,DVIil2NM7ZWOtqe6rhlMzwEUAb2wuaeh,7GRhBDsirIGkRZBtSMEzNTyDr2JQm4xx,36,98,33,34,17,15,10,0,207,29.571428571428573,5,0.0,53,33,33,17,45,15,1,10,0,136,71,0
3088,41111,LZT7nbUFDfOvhG31ggWghVXoB5daajKc,7GRhBDsirIGkRZBtSMEzNTyDr2JQm4xx,6,9,3,0,0,2,2,0,16,2.2857142857142856,1,0.0,3,3,0,0,6,2,0,2,0,6,10,1
3089,41157,k3YRNSEUtBfnCzCI2ffYAi1qqoCc9d8W,7GRhBDsirIGkRZBtSMEzNTyDr2JQm4xx,5,5,1,0,0,0,2,0,8,1.1428571428571428,1,0.0,0,1,0,0,5,0,0,2,0,1,7,1
3090,41289,I1VndljUSmkFLMl8yI2zESYAyPlBzjwo,7GRhBDsirIGkRZBtSMEzNTyDr2JQm4xx,10,13,7,0,2,0,1,0,23,3.2857142857142856,1,0.0,4,7,0,2,9,0,0,1,0,13,10,1
3091,41300,qJQBhMSxZNb9FZGkj9PyIWzMqhMNvrJp,7GRhBDsirIGkRZBtSMEzNTyDr2JQm4xx,37,60,6,32,9,0,18,1,126,18.0,6,0.0,21,6,30,9,39,0,2,18,1,66,60,0
3092,41366,Ns35aao5T8wUPwIDoTDfhRc8L852Neqp,7GRhBDsirIGkRZBtSMEzNTyDr2JQm4xx,20,30,10,0,10,2,7,1,60,8.571428571428571,1,0.0,18,10,0,10,12,2,0,7,1,38,22,0
3093,41377,PoxO0NKuyAvBdyfzZW09NxNtHwzofyd3,7GRhBDsirIGkRZBtSMEzNTyDr2JQm4xx,5,2,1,0,1,0,2,0,6,0.8571428571428571,1,0.0,0,1,0,1,2,0,0,2,0,2,4,1
3094,41405,wxXsB2E97PklyJnNr2rcYvINOWKCzd23,7GRhBDsirIGkRZBtSMEzNTyDr2JQm4xx,1,0,0,0,0,0,1,0,1,0.14285714285714285,1,0.0,0,0,0,0,0,0,0,1,0,0,1,0
3095,41483,KqlAQr8NRKwI0MhjiYskyr4iy4QPJQrZ,7GRhBDsirIGkRZBtSMEzNTyDr2JQm4xx,4,2,1,0,0,0,2,0,5,0.7142857142857143,1,0.0,0,1,0,0,2,0,0,2,0,1,4,1
3096,41485,xg6gozDtJtmbriZIHFk0YIJKhyzF16Dg,7GRhBDsirIGkRZBtSMEzNTyDr2JQm4xx,18,42,18,2,12,0,7,0,81,11.571428571428571,3,0.0,16,18,1,12,26,0,1,7,0,47,34,1
3097,41495,w1eCZn6FuUz5n8CxQTkysG8zjugCkTfX,7GRhBDsirIGkRZBtSMEzNTyDr2JQm4xx,1,0,0,0,0,0,1,0,1,0.14285714285714285,1,0.0,0,0,0,0,0,0,0,1,0,0,1,1
3098,41514,TDsFMiW3NmfZzVauB4oMkOZiSJ5XLe6I,7GRhBDsirIGkRZBtSMEzNTyDr2JQm4xx,25,40,9,58,3,2,21,1,134,19.142857142857142,5,0.0,17,9,52,3,23,2,6,21,1,81,53,1
3099,41521,m7HNFlUhYzKWxgjrmFGLTIf1VbbNLm66,7GRhBDsirIGkRZBtSMEzNTyDr2JQm4xx,1,0,0,0,0,0,1,0,1,0.14285714285714285,1,0.0,0,0,0,0,0,0,0,1,0,0,1,1
3100,41533,8zcddBOPFYuIEkUZpmoApSiBFpQCKBLf,7GRhBDsirIGkRZBtSMEzNTyDr2JQm4xx,5,5,1,0,0,0,3,0,9,1.2857142857142858,2,0.0,2,1,0,0,3,0,0,3,0,3,6,1
3101,41551,SmViYwWTWrMXjcjjHVYvpvTHTeWvqg4X,7GRhBDsirIGkRZBtSMEzNTyDr2JQm4xx,7,3,1,0,1,0,3,0,8,1.1428571428571428,1,0.0,0,1,0,1,3,0,0,3,0,2,6,1
3102,41577,8niPfp9xqHHlhtnR3IY1QWUasjj0zQpl,7GRhBDsirIGkRZBtSMEzNTyDr2JQm4xx,5,2,1,0,1,0,2,0,6,0.8571428571428571,1,0.0,0,1,0,1,2,0,0,2,0,2,4,1
3103,41582,CfUHqy5TfjBtRxjNztsGxyFua9jISd0Q,7GRhBDsirIGkRZBtSMEzNTyDr2JQm4xx,43,70,31,53,22,1,10,0,187,26.714285714285715,5,0.0,34,31,46,22,36,1,7,10,0,133,54,1
3104,41618,ZqebYSMW1RUIRSXJmMzKs77Liu7pj2zF,7GRhBDsirIGkRZBtSMEzNTyDr2JQm4xx,33,34,32,0,24,4,8,1,103,14.714285714285714,3,0.0,0,32,0,24,34,4,0,8,1,56,47,1
3105,41697,CQ8MKRcyoRQu9uvYz8G86ILjGgWWbOQv,7GRhBDsirIGkRZBtSMEzNTyDr2JQm4xx,5,5,2,0,0,0,3,0,10,1.4285714285714286,1,0.0,0,2,0,0,5,0,0,3,0,2,8,1
3106,41753,5QHXCSGlBOGq7ih6SlrH28hNQCROqU2d,7GRhBDsirIGkRZBtSMEzNTyDr2JQm4xx,2,0,0,0,0,0,3,0,3,0.42857142857142855,2,0.0,0,0,0,0,0,0,0,3,0,0,3,1
3107,41762,FJJqBn1iTJmAbav7Ov5Y4ycyF65fvY1E,7GRhBDsirIGkRZBtSMEzNTyDr2JQm4xx,3,0,0,0,0,2,3,0,5,0.7142857142857143,3,0.0,0,0,0,0,0,2,0,3,0,0,5,0
3108,41792,UNnwy1ZgbFYM2Kztvg7tp4bM94xWe0nF,7GRhBDsirIGkRZBtSMEzNTyDr2JQm4xx,1,0,0,0,0,0,1,0,1,0.14285714285714285,1,0.0,0,0,0,0,0,0,0,1,0,0,1,1
3109,41795,F71ZfnryHCMhVExpC2gJVpDSfOwRuiHf,7GRhBDsirIGkRZBtSMEzNTyDr2JQm4xx,6,1,1,0,1,0,5,0,8,1.1428571428571428,1,0.0,0,1,0,1,1,0,0,5,0,2,6,1
3110,41801,3SP9iNDvUt8m67ZMqC5DpQRe6ekkTpsP,7GRhBDsirIGkRZBtSMEzNTyDr2JQm4xx,1,0,0,0,0,0,1,0,1,0.14285714285714285,1,0.0,0,0,0,0,0,0,0,1,0,0,1,1
3111,41807,txRaMeFRdTsCsziGBMMxzL5gSPIB7mbk,7GRhBDsirIGkRZBtSMEzNTyDr2JQm4xx,64,182,66,76,16,30,34,2,406,58.0,5,0.0,84,66,72,16,98,30,4,34,2,238,168,1
3112,41815,NYjtfRvfVgjdP93necZvZvYS7zFHrEkH,7GRhBDsirIGkRZBtSMEzNTyDr2JQm4xx,6,2,1,0,1,0,4,0,8,1.1428571428571428,1,0.0,0,1,0,1,2,0,0,4,0,2,6,1
3113,43665,NrHk4qmJXuD0TsjkQSnghKpk9ZjGAOyU,7GRhBDsirIGkRZBtSMEzNTyDr2JQm4xx,31,21,18,0,12,0,5,0,56,8.0,2,0.0,0,18,0,12,21,0,0,5,0,30,26,1
3114,43668,s78QKjJp2qJWP86SKhU5XdBMn22opRSP,7GRhBDsirIGkRZBtSMEzNTyDr2JQm4xx,11,10,6,0,5,0,2,0,23,3.2857142857142856,2,0.0,1,6,0,5,9,0,0,2,0,12,11,0
3115,43673,Y53vJNK6NsQxTqlgv0AKozWzT5IkWSVb,7GRhBDsirIGkRZBtSMEzNTyDr2JQm4xx,10,16,9,9,0,0,4,0,38,5.428571428571429,3,0.0,2,9,6,0,14,0,3,4,0,17,21,0
3116,43695,z0WA70zlCYNC0D6ukf1TU1erCNwbETr4,7GRhBDsirIGkRZBtSMEzNTyDr2JQm4xx,8,8,0,4,1,0,2,0,15,2.142857142857143,1,0.0,3,0,2,1,5,0,2,2,0,6,9,1
3117,43711,astaomdRwCWRae7GfR14orvLqERJnyWg,7GRhBDsirIGkRZBtSMEzNTyDr2JQm4xx,26,27,9,36,1,17,15,0,105,15.0,2,0.0,16,9,31,1,11,17,5,15,0,57,48,0
3118,43724,bbBEHMN2ei4wG0H7nW7BSSaBcqs1CEnx,7GRhBDsirIGkRZBtSMEzNTyDr2JQm4xx,2,0,0,0,0,0,2,0,2,0.2857142857142857,1,0.0,0,0,0,0,0,0,0,2,0,0,2,1
3119,43725,6QRfbLtBjFn7GPZrNgqut0wbkSDHHl9M,7GRhBDsirIGkRZBtSMEzNTyDr2JQm4xx,15,11,1,80,0,0,2,0,94,13.428571428571429,1,0.0,6,1,72,0,5,0,8,2,0,79,15,1
3120,43993,p0RuxkRTmLRS6ii3YN8z6W4Bqa7AYRuD,fbPkOYLVPtPgIt0MxizjfFJov3JbHyAi,7,3,2,0,2,1,4,0,12,1.7142857142857142,1,0.0,0,2,0,2,3,1,0,4,0,4,8,1
3121,43994,hWE8YlXrkle820sTOY1UXpm2QbX0rLTx,fbPkOYLVPtPgIt0MxizjfFJov3JbHyAi,21,25,14,1,12,12,9,1,74,10.571428571428571,2,0.0,6,14,1,12,19,12,0,9,1,33,41,1
3122,43995,diyFwrzJDqdxnswzs6l8ZdAq590WR6Is,fbPkOYLVPtPgIt0MxizjfFJov3JbHyAi,5,4,0,0,0,1,14,3,22,3.142857142857143,1,0.0,0,0,0,0,4,1,0,14,3,0,22,1
3123,43996,aNKQixLt1xurBtrkCE5j4vCWMytj94zC,fbPkOYLVPtPgIt0MxizjfFJov3JbHyAi,7,14,6,0,3,7,11,0,41,5.857142857142857,3,0.0,0,6,0,3,14,7,0,11,0,9,32,1
3124,43997,mtCGwN4OvCoCnbzMbutLT6Nf2wxkcaDu,fbPkOYLVPtPgIt0MxizjfFJov3JbHyAi,3,1,0,0,0,0,2,0,3,0.42857142857142855,1,0.0,0,0,0,0,1,0,0,2,0,0,3,1
3125,43999,sCVKWDTf6SABzbHNn99T0WibbkC7xg03,fbPkOYLVPtPgIt0MxizjfFJov3JbHyAi,1,0,0,0,0,0,1,0,1,0.14285714285714285,1,0.0,0,0,0,0,0,0,0,1,0,0,1,1
3126,44000,7iDvRXsYqjRdgImengAvKZVd91CAi3lD,fbPkOYLVPtPgIt0MxizjfFJov3JbHyAi,10,13,8,0,4,4,6,2,37,5.285714285714286,2,0.0,2,8,0,4,11,4,0,6,2,14,23,1
3127,44001,mJn5S64R5TbyphUPASOXDVT6KwPqgFqV,fbPkOYLVPtPgIt0MxizjfFJov3JbHyAi,26,25,14,13,11,22,10,1,96,13.714285714285714,2,0.0,8,14,12,11,17,22,1,10,1,45,51,1
3128,44002,u11lG1A4K1gIhpOqkswgAj4EhDI0xOZ0,fbPkOYLVPtPgIt0MxizjfFJov3JbHyAi,7,3,2,0,2,0,6,0,13,1.8571428571428572,1,0.0,0,2,0,2,3,0,0,6,0,4,9,1
3129,44003,DDTIWqk6JJRrEvr9d9O7DmY1OYVdzDEA,fbPkOYLVPtPgIt0MxizjfFJov3JbHyAi,10,7,4,0,3,2,8,1,25,3.5714285714285716,1,0.0,1,4,0,3,6,2,0,8,1,8,17,1
3130,44004,d8EMxzMifzqQKHyC0riOTQo2zuIYKTb1,fbPkOYLVPtPgIt0MxizjfFJov3JbHyAi,11,9,6,0,4,5,7,0,31,4.428571428571429,1,0.0,0,6,0,4,9,5,0,7,0,10,21,1
3131,44005,J8NkUmSvsrLHkKNXPhFg7o0pG3K7Aywh,fbPkOYLVPtPgIt0MxizjfFJov3JbHyAi,20,26,13,18,9,51,6,0,123,17.571428571428573,3,0.0,7,13,16,9,19,51,2,6,0,45,78,0
3132,44006,hjUSUM6roI2mLGkMAqBjE0uxFRBSMYHJ,fbPkOYLVPtPgIt0MxizjfFJov3JbHyAi,7,3,2,0,2,4,4,0,15,2.142857142857143,2,0.0,0,2,0,2,3,4,0,4,0,4,11,1
3133,44011,DBl87nF6WTgoCD6kgTHVE2oB45pDEn6y,fbPkOYLVPtPgIt0MxizjfFJov3JbHyAi,7,7,5,0,3,0,2,0,17,2.4285714285714284,2,0.0,0,5,0,3,7,0,0,2,0,8,9,1
3134,44013,p2au3FOExtiqsg1tYoyGj3KNDXCc91mB,fbPkOYLVPtPgIt0MxizjfFJov3JbHyAi,10,6,4,0,3,1,7,1,22,3.142857142857143,1,0.0,0,4,0,3,6,1,0,7,1,7,15,1
3135,44014,x7XiHrvKEMpxKuTFiRO880d5p07e6S97,fbPkOYLVPtPgIt0MxizjfFJov3JbHyAi,8,2,2,0,2,1,3,1,11,1.5714285714285714,1,0.0,0,2,0,2,2,1,0,3,1,4,7,1
3136,44016,FssYjkUANdoULgFGTzw1AQpi3Hr9RmSx,fbPkOYLVPtPgIt0MxizjfFJov3JbHyAi,7,4,2,0,2,2,4,0,14,2.0,1,0.0,0,2,0,2,4,2,0,4,0,4,10,1
3137,44018,qKfZusm0R8jxltESvgi15dswdw73Gjlp,fbPkOYLVPtPgIt0MxizjfFJov3JbHyAi,11,14,3,0,3,0,3,0,23,3.2857142857142856,2,0.0,0,3,0,3,14,0,0,3,0,6,17,1
3138,44020,Z2WYkCILkqUB8wo1t1Cu8aCpPedEwo19,fbPkOYLVPtPgIt0MxizjfFJov3JbHyAi,5,3,1,0,1,0,1,0,6,0.8571428571428571,1,0.0,0,1,0,1,3,0,0,1,0,2,4,1
3139,44022,PDXGFyBPYCflMZuvp1Ir4M4S3e0nyboZ,fbPkOYLVPtPgIt0MxizjfFJov3JbHyAi,43,152,74,27,20,75,36,0,384,54.857142857142854,13,0.0,27,74,24,20,125,75,3,36,0,145,239,1
3140,44023,YB6Mdw3HVis2k9yXIV8Bn5gVXQ6GVqTU,fbPkOYLVPtPgIt0MxizjfFJov3JbHyAi,5,5,0,0,0,4,4,0,13,1.8571428571428572,2,0.0,0,0,0,0,5,4,0,4,0,0,13,1
3141,44025,26PDrRJYSMH6uI6XnAwbn1s6xjvZitk1,fbPkOYLVPtPgIt0MxizjfFJov3JbHyAi,5,2,1,0,1,0,3,0,7,1.0,1,0.0,0,1,0,1,2,0,0,3,0,2,5,1
3142,44026,A1Bqk2hgKzNE6O0Jd3HBtI2AJixgnU9D,fbPkOYLVPtPgIt0MxizjfFJov3JbHyAi,8,3,2,0,2,2,5,0,14,2.0,1,0.0,0,2,0,2,3,2,0,5,0,4,10,1
3143,44029,cDtNKVgke675efaANxs81gywhUCG6Xvn,fbPkOYLVPtPgIt0MxizjfFJov3JbHyAi,2,0,0,0,0,0,2,0,2,0.2857142857142857,1,0.0,0,0,0,0,0,0,0,2,0,0,2,1
3144,44030,AqCPWoJ3Xqrj0YuS9VE2yr3qK1da6ZEL,fbPkOYLVPtPgIt0MxizjfFJov3JbHyAi,6,2,1,0,1,8,4,0,16,2.2857142857142856,2,0.0,0,1,0,1,2,8,0,4,0,2,14,1
3145,44031,wg3Aluyuv2BxZCQwpp08tOXwIGHtBXla,fbPkOYLVPtPgIt0MxizjfFJov3JbHyAi,9,6,3,0,4,0,13,1,27,3.857142857142857,3,0.0,3,3,0,4,3,0,0,13,1,10,17,1
3146,44033,jCGl2la0U6McatWubPbo3ygrfz4SQroM,fbPkOYLVPtPgIt0MxizjfFJov3JbHyAi,2,0,0,0,0,0,2,0,2,0.2857142857142857,1,0.0,0,0,0,0,0,0,0,2,0,0,2,1
3147,44035,AOTrlTWQ3Oa2ClznlEkXg5ypb6eqlCbx,fbPkOYLVPtPgIt0MxizjfFJov3JbHyAi,11,6,4,0,3,1,11,3,28,4.0,2,0.0,0,4,0,3,6,1,0,11,3,7,21,1
3148,44037,R2NtjVNHKdme1jYGEGYDv7qM6g83uuPF,fbPkOYLVPtPgIt0MxizjfFJov3JbHyAi,10,9,6,0,3,1,6,0,25,3.5714285714285716,1,0.0,0,6,0,3,9,1,0,6,0,9,16,1
3149,44038,3JmWuBfNEBLNWjaLSdiSh8Z86NQq0lk7,fbPkOYLVPtPgIt0MxizjfFJov3JbHyAi,15,23,1,5,1,9,7,1,47,6.714285714285714,1,0.0,3,1,4,1,20,9,1,7,1,9,38,1
3150,44039,4yBRvdZ1Q3XWGsAQkRh6UnzQ7WibjAOe,fbPkOYLVPtPgIt0MxizjfFJov3JbHyAi,7,8,6,0,4,0,7,0,25,3.5714285714285716,1,0.0,0,6,0,4,8,0,0,7,0,10,15,1
3151,44042,4QPOXaQgHIrhjYrZ52sVeohXb5o3Oznm,fbPkOYLVPtPgIt0MxizjfFJov3JbHyAi,2,0,0,0,0,0,2,0,2,0.2857142857142857,1,0.0,0,0,0,0,0,0,0,2,0,0,2,1
3152,44043,s8VWFWImIYSA2JA5l16L3WRLI25ddNXq,fbPkOYLVPtPgIt0MxizjfFJov3JbHyAi,11,21,5,1,8,7,10,0,52,7.428571428571429,2,0.0,13,5,1,8,8,7,0,10,0,27,25,1
3153,44045,HfDg6ZshQIIsqHP26E57zcevXCtObxuT,fbPkOYLVPtPgIt0MxizjfFJov3JbHyAi,1,0,0,0,0,0,2,0,2,0.2857142857142857,1,0.0,0,0,0,0,0,0,0,2,0,0,2,1
3154,44047,SJEqwoHZ7xXB9jGS9EmfQals4M4vlWb2,fbPkOYLVPtPgIt0MxizjfFJov3JbHyAi,5,3,1,0,1,0,5,0,10,1.4285714285714286,1,0.0,0,1,0,1,3,0,0,5,0,2,8,1
3155,44048,YmdgsFslyipuqAvTNMUf5cKIo7lT9UI2,fbPkOYLVPtPgIt0MxizjfFJov3JbHyAi,9,12,4,0,2,0,3,0,21,3.0,1,0.0,2,4,0,2,10,0,0,3,0,8,13,1
3156,44050,VeCExJm9PxMsppGBNIELDYWjqzgCI8lp,fbPkOYLVPtPgIt0MxizjfFJov3JbHyAi,6,3,2,0,2,0,1,0,8,1.1428571428571428,1,0.0,0,2,0,2,3,0,0,1,0,4,4,1
3157,44051,AmoWrYr0vE5hXRkVUs4W3twtpkRI6UWn,fbPkOYLVPtPgIt0MxizjfFJov3JbHyAi,10,19,9,0,6,14,9,1,58,8.285714285714286,3,0.0,4,9,0,6,15,14,0,9,1,19,39,1
3158,44053,eoxsaFPg8O2Z1ERwXNqkhtxGChEAvpFr,fbPkOYLVPtPgIt0MxizjfFJov3JbHyAi,6,8,2,2,2,0,1,0,15,2.142857142857143,1,0.0,5,2,2,2,3,0,0,1,0,11,4,1
3159,44055,aosFpeLMqBiLLcyUKYcbUuWGCjQbFGiD,fbPkOYLVPtPgIt0MxizjfFJov3JbHyAi,11,5,4,0,4,1,3,0,17,2.4285714285714284,1,0.0,0,4,0,4,5,1,0,3,0,8,9,1
3160,44056,pdAqVvKgeCIaihAcxhTXOYjPQxxjaa8K,fbPkOYLVPtPgIt0MxizjfFJov3JbHyAi,5,3,2,0,0,0,2,0,7,1.0,1,0.0,0,2,0,0,3,0,0,2,0,2,5,1
3161,44059,VCAUk6CdtYtSQUkeIHqrUkYmOmbAoytN,fbPkOYLVPtPgIt0MxizjfFJov3JbHyAi,12,16,13,0,10,9,7,0,55,7.857142857142857,4,0.0,0,13,0,10,16,9,0,7,0,23,32,1
3162,44061,YnLmtd3JRb0zimQpfWrFNcrwemvknDW5,fbPkOYLVPtPgIt0MxizjfFJov3JbHyAi,2,0,0,0,0,0,4,0,4,0.5714285714285714,1,0.0,0,0,0,0,0,0,0,4,0,0,4,1
3163,44064,sclpC2Q9gGuchXaYOn9jBhR0HTWTR3aT,fbPkOYLVPtPgIt0MxizjfFJov3JbHyAi,2,0,0,0,0,0,2,0,2,0.2857142857142857,1,0.0,0,0,0,0,0,0,0,2,0,0,2,1
3164,44065,MdDhGnwj5ASXKbZjKBE4rTINrZJxZKmf,fbPkOYLVPtPgIt0MxizjfFJov3JbHyAi,5,3,1,0,1,0,1,0,6,0.8571428571428571,1,0.0,0,1,0,1,3,0,0,1,0,2,4,1
3165,44066,YRnTGuoAQA7UM3uV59YNXUYN4n1CR9jv,fbPkOYLVPtPgIt0MxizjfFJov3JbHyAi,5,2,1,0,1,2,3,0,9,1.2857142857142858,1,0.0,0,1,0,1,2,2,0,3,0,2,7,1
3166,44067,j8RhTJjYDyhhJwKuX9dEaH9i8I1ldsXI,fbPkOYLVPtPgIt0MxizjfFJov3JbHyAi,6,1,1,0,1,0,5,0,8,1.1428571428571428,1,0.0,0,1,0,1,1,0,0,5,0,2,6,1
3167,44068,L5YuT98afVAOrSauv1O87vabcuU5P3FK,fbPkOYLVPtPgIt0MxizjfFJov3JbHyAi,9,6,4,0,4,15,4,0,33,4.714285714285714,2,0.0,1,4,0,4,5,15,0,4,0,9,24,1
3168,44073,IvyZt31HCtjMQMuaWC4jdk1sB0Xv7ntN,fbPkOYLVPtPgIt0MxizjfFJov3JbHyAi,2,0,0,0,0,0,2,0,2,0.2857142857142857,1,0.0,0,0,0,0,0,0,0,2,0,0,2,1
3169,44074,2ZTBzb1Y4dwuOwNiUUSWB6SyHlRXxNso,fbPkOYLVPtPgIt0MxizjfFJov3JbHyAi,7,8,6,0,5,3,2,0,24,3.4285714285714284,2,0.0,0,6,0,5,8,3,0,2,0,11,13,1
3170,44075,igbWLwpgdT3vH8N8WUDj5bw0PNuf5yJu,fbPkOYLVPtPgIt0MxizjfFJov3JbHyAi,5,0,0,0,0,1,10,1,12,1.7142857142857142,1,0.0,0,0,0,0,0,1,0,10,1,0,12,1
3171,44077,O8WpIn8YZlC9fwaPz6HgwkG3VYK9Pnk2,fbPkOYLVPtPgIt0MxizjfFJov3JbHyAi,42,48,32,37,21,13,12,1,164,23.428571428571427,2,0.0,10,32,31,21,38,13,6,12,1,94,70,1
3172,44078,QR9tTgqPj604qYCY9eaTIBAzrFpNWrLy,fbPkOYLVPtPgIt0MxizjfFJov3JbHyAi,11,22,7,8,11,0,7,0,55,7.857142857142857,1,0.0,10,7,6,11,12,0,2,7,0,34,21,1
3173,44080,bheLkhWEWGgBqIkahX9VmPOuI7dx9l0C,fbPkOYLVPtPgIt0MxizjfFJov3JbHyAi,9,5,3,0,2,1,8,0,19,2.7142857142857144,2,0.0,0,3,0,2,5,1,0,8,0,5,14,1
3174,44082,YzWgrkJXzobheYWSTdIFQuZL9QRQEEwo,fbPkOYLVPtPgIt0MxizjfFJov3JbHyAi,15,23,9,0,8,9,20,2,71,10.142857142857142,5,0.0,0,9,0,8,23,9,0,20,2,17,54,1
3175,44085,k3g7vGyejcBHPAYTerpXAPXP3aDlXECc,fbPkOYLVPtPgIt0MxizjfFJov3JbHyAi,12,13,5,4,5,0,4,0,31,4.428571428571429,2,0.0,3,5,3,5,10,0,1,4,0,16,15,1
3176,44086,RdUl2sUA9mfz6RQdwlY0IjEO1TB3V6He,fbPkOYLVPtPgIt0MxizjfFJov3JbHyAi,5,3,1,0,1,6,5,0,16,2.2857142857142856,1,0.0,0,1,0,1,3,6,0,5,0,2,14,1
3177,44087,lFoBW5pwyNxgkXXOh07oCGiEJfc9EI9m,fbPkOYLVPtPgIt0MxizjfFJov3JbHyAi,12,4,4,0,4,0,14,0,26,3.7142857142857144,1,0.0,0,4,0,4,4,0,0,14,0,8,18,1
3178,44088,lROQAiXdM7cGoWUW60LyDcyoBjMP9r3o,fbPkOYLVPtPgIt0MxizjfFJov3JbHyAi,3,2,0,0,0,0,1,0,3,0.42857142857142855,1,0.0,0,0,0,0,2,0,0,1,0,0,3,1
3179,44089,No6TsyszmhFBqFzsKXtnzkYT0Jt4BFGw,fbPkOYLVPtPgIt0MxizjfFJov3JbHyAi,25,62,31,18,22,56,20,9,218,31.142857142857142,5,0.0,18,31,14,22,44,56,4,20,9,85,133,0
3180,44090,8nAPL0mPQAW1c0oKz3Cmzoe0fblYTaaz,fbPkOYLVPtPgIt0MxizjfFJov3JbHyAi,8,6,4,0,3,0,4,0,17,2.4285714285714284,2,0.0,0,4,0,3,6,0,0,4,0,7,10,1
3181,44091,UzZPsoX0fPCsbykjSOoJQOmAIToD9VOQ,fbPkOYLVPtPgIt0MxizjfFJov3JbHyAi,4,2,1,0,1,0,1,0,5,0.7142857142857143,1,0.0,0,1,0,1,2,0,0,1,0,2,3,1
3182,44092,sLiNYOqDfBlMo7O3bGWUzk1xVOtexeDN,fbPkOYLVPtPgIt0MxizjfFJov3JbHyAi,6,3,2,0,2,0,1,0,8,1.1428571428571428,1,0.0,0,2,0,2,3,0,0,1,0,4,4,1
3183,44094,Y5EybULOrY5dAmMMQWE7bK5wg4bsR2Lr,fbPkOYLVPtPgIt0MxizjfFJov3JbHyAi,19,28,15,2,7,0,8,0,60,8.571428571428571,3,0.0,2,15,2,7,26,0,0,8,0,26,34,1
3184,44096,MvkVXPKImqjQobZ7zCJXq4GfQ4IthLq9,fbPkOYLVPtPgIt0MxizjfFJov3JbHyAi,7,2,1,0,1,0,6,1,11,1.5714285714285714,1,0.0,0,1,0,1,2,0,0,6,1,2,9,1
3185,44098,XMrYl2ASKmtprKkSXb8ccJGHLdsrFHJk,fbPkOYLVPtPgIt0MxizjfFJov3JbHyAi,5,0,0,0,0,4,10,1,15,2.142857142857143,1,0.0,0,0,0,0,0,4,0,10,1,0,15,1
3186,44099,ZD3ToNRRIcmCEA8K3LVmNsFQ0Leu0MkF,fbPkOYLVPtPgIt0MxizjfFJov3JbHyAi,7,3,2,0,2,0,4,0,11,1.5714285714285714,1,0.0,0,2,0,2,3,0,0,4,0,4,7,1
3187,44100,ANJ7A7TrnpRJsv1mG7Zq08b8gsBzPJqI,fbPkOYLVPtPgIt0MxizjfFJov3JbHyAi,9,18,11,2,6,22,9,0,68,9.714285714285714,2,0.0,2,11,2,6,16,22,0,9,0,21,47,1
3188,44101,VwVgSiouEmdKXwssd2MCisWFwFtWB9Im,fbPkOYLVPtPgIt0MxizjfFJov3JbHyAi,1,0,0,0,0,0,1,0,1,0.14285714285714285,1,0.0,0,0,0,0,0,0,0,1,0,0,1,1
3189,44103,A7lXg14ZXc0SEgbl8pEzN5LJNLnibxLn,fbPkOYLVPtPgIt0MxizjfFJov3JbHyAi,4,0,0,0,0,1,9,0,10,1.4285714285714286,1,0.0,0,0,0,0,0,1,0,9,0,0,10,1
3190,44104,v6ULfJ1wWpantgoVZXel0J0DDCWEkouX,fbPkOYLVPtPgIt0MxizjfFJov3JbHyAi,7,2,1,0,1,0,5,0,9,1.2857142857142858,1,0.0,0,1,0,1,2,0,0,5,0,2,7,1
3191,44105,LmCwIRpUqSmmlWIBPK14fUA8Auzaletz,fbPkOYLVPtPgIt0MxizjfFJov3JbHyAi,8,10,5,0,4,5,7,0,31,4.428571428571429,2,0.0,2,5,0,4,8,5,0,7,0,11,20,1
3192,44106,futHw5ylJYoore6oNuefdx05Xc1Es6E8,fbPkOYLVPtPgIt0MxizjfFJov3JbHyAi,17,58,21,4,13,1,12,0,109,15.571428571428571,8,0.0,9,21,4,13,49,1,0,12,0,47,62,1
3193,44107,671RbTfA5jsL1XLdOXGDRlUV35MrYEo2,fbPkOYLVPtPgIt0MxizjfFJov3JbHyAi,2,0,0,0,0,0,5,0,5,0.7142857142857143,1,0.0,0,0,0,0,0,0,0,5,0,0,5,1
3194,44108,05K9eYg3CyRfEGjA2jN84Kisnns0xWMm,fbPkOYLVPtPgIt0MxizjfFJov3JbHyAi,9,6,3,0,4,0,4,0,17,2.4285714285714284,1,0.0,2,3,0,4,4,0,0,4,0,9,8,1
3195,44109,2yhMB5G7BP9mjaTBhgm2Ob8NSOmIWTch,fbPkOYLVPtPgIt0MxizjfFJov3JbHyAi,5,2,1,0,1,6,4,0,14,2.0,1,0.0,0,1,0,1,2,6,0,4,0,2,12,1
3196,44110,e4cZqrYucFu6WeO5quZuqBqXvsVJ1X82,fbPkOYLVPtPgIt0MxizjfFJov3JbHyAi,4,2,1,0,1,2,2,0,8,1.1428571428571428,2,0.0,0,1,0,1,2,2,0,2,0,2,6,1
3197,44113,2X7VWDc6h4sEfr5aWwtNfHXgmbohmuZY,fbPkOYLVPtPgIt0MxizjfFJov3JbHyAi,8,3,2,0,2,0,5,0,12,1.7142857142857142,1,0.0,0,2,0,2,3,0,0,5,0,4,8,1
3198,44114,Hnsg2RdEy94EzQKO2WfhQn1bhDkIZpuP,fbPkOYLVPtPgIt0MxizjfFJov3JbHyAi,16,63,34,0,10,26,20,3,156,22.285714285714285,7,0.0,8,34,0,10,55,26,0,20,3,52,104,1
3199,44116,6A60zadtj8FKi84VaMeYcSvKWRtVJvs6,fbPkOYLVPtPgIt0MxizjfFJov3JbHyAi,6,9,0,0,0,12,6,0,27,3.857142857142857,1,0.0,2,0,0,0,7,12,0,6,0,2,25,1
3200,44117,0MmMvk8S1ad0tMPIPxO3E9ZWoQTH5ohX,fbPkOYLVPtPgIt0MxizjfFJov3JbHyAi,7,5,2,0,2,0,7,0,16,2.2857142857142856,1,0.0,2,2,0,2,3,0,0,7,0,6,10,1
3201,44120,FTBGY79AZl1FhUSv46TguNvaQwPqRnW0,fbPkOYLVPtPgIt0MxizjfFJov3JbHyAi,6,8,4,0,1,7,3,0,23,3.2857142857142856,2,0.0,0,4,0,1,8,7,0,3,0,5,18,1
3202,44121,6adUsSvPO0BlKLyJ63pGCXpdZbbHOrC1,fbPkOYLVPtPgIt0MxizjfFJov3JbHyAi,7,3,2,0,2,0,3,0,10,1.4285714285714286,1,0.0,0,2,0,2,3,0,0,3,0,4,6,1
3203,44124,YDpcKYv6zEDbgKCrCZaLRWDXdGnmbBrJ,fbPkOYLVPtPgIt0MxizjfFJov3JbHyAi,7,3,2,0,2,1,2,0,10,1.4285714285714286,1,0.0,0,2,0,2,3,1,0,2,0,4,6,1
3204,44125,S0Ddt9YO0WoRWUIwBGA5TdHpdcYScp4i,fbPkOYLVPtPgIt0MxizjfFJov3JbHyAi,2,0,0,0,0,0,4,0,4,0.5714285714285714,1,0.0,0,0,0,0,0,0,0,4,0,0,4,1
3205,44126,tp8q2FaFgEZoEyMd2w4a4ElJA60aVpjU,fbPkOYLVPtPgIt0MxizjfFJov3JbHyAi,8,4,2,0,2,1,5,0,14,2.0,1,0.0,1,2,0,2,3,1,0,5,0,5,9,1
3206,44127,uE45A9X1ub2amdi5pgtNBuPUXW1OngP4,fbPkOYLVPtPgIt0MxizjfFJov3JbHyAi,8,7,4,0,2,25,8,1,47,6.714285714285714,3,0.0,0,4,0,2,7,25,0,8,1,6,41,1
3207,44128,V1LvU1c7E3PIUZFRN6WpF3BM13fnjgNE,fbPkOYLVPtPgIt0MxizjfFJov3JbHyAi,1,0,0,0,0,0,1,0,1,0.14285714285714285,1,0.0,0,0,0,0,0,0,0,1,0,0,1,1
3208,44129,p1XbGfxeaI6DleJXE743W1CITQmkaVh6,fbPkOYLVPtPgIt0MxizjfFJov3JbHyAi,20,29,15,0,11,41,8,1,105,15.0,2,0.0,6,15,0,11,23,41,0,8,1,32,73,1
3209,44130,aldLXGpzmiip2CUSDhqN8A5UpGMVUHxY,fbPkOYLVPtPgIt0MxizjfFJov3JbHyAi,7,6,3,0,2,0,2,0,13,1.8571428571428572,2,0.0,1,3,0,2,5,0,0,2,0,6,7,1
3210,44132,zFnB514y0Q6xzKQdlkyv2Oz7aEiEsfcU,fbPkOYLVPtPgIt0MxizjfFJov3JbHyAi,11,3,3,0,3,0,10,1,20,2.857142857142857,1,0.0,0,3,0,3,3,0,0,10,1,6,14,1
3211,44136,BF0qnZaKn6rKWwFuVZZ6evM5Lwl2Cgas,fbPkOYLVPtPgIt0MxizjfFJov3JbHyAi,9,5,3,0,3,31,8,1,51,7.285714285714286,1,0.0,1,3,0,3,4,31,0,8,1,7,44,1
3212,44137,2UpfysYIIWrRQes9MePdZN0xiR2zRHJz,fbPkOYLVPtPgIt0MxizjfFJov3JbHyAi,8,6,3,0,2,0,2,0,13,1.8571428571428572,1,0.0,0,3,0,2,6,0,0,2,0,5,8,1
3213,44138,3xpaESbMVIacFbBBinGWFh7uTUaRebCC,fbPkOYLVPtPgIt0MxizjfFJov3JbHyAi,7,5,3,0,1,0,3,0,12,1.7142857142857142,2,0.0,0,3,0,1,5,0,0,3,0,4,8,1
3214,44140,MmriHcroMe075aYWrI4hc7SygXVasdbB,fbPkOYLVPtPgIt0MxizjfFJov3JbHyAi,7,7,5,0,4,2,2,0,20,2.857142857142857,1,0.0,0,5,0,4,7,2,0,2,0,9,11,1
3215,44142,VT4lg4rYLuaybdJw72lJCTs81gBgRRBg,fbPkOYLVPtPgIt0MxizjfFJov3JbHyAi,26,121,61,23,38,68,33,3,347,49.57142857142857,9,0.0,36,61,18,38,85,68,5,33,3,153,194,1
3216,44143,J9FSUo4laXGBW66T35Zr5CFe56ZdTJTQ,fbPkOYLVPtPgIt0MxizjfFJov3JbHyAi,9,6,3,0,4,3,4,0,20,2.857142857142857,1,0.0,2,3,0,4,4,3,0,4,0,9,11,1
3217,44145,niLMw8MCObO7SSR2V1jNg9WQt5oSjDFJ,fbPkOYLVPtPgIt0MxizjfFJov3JbHyAi,6,7,3,0,2,2,2,0,16,2.2857142857142856,1,0.0,2,3,0,2,5,2,0,2,0,7,9,1
3218,44146,NiOuJ51IxTtojHMts8OdX2AfCH09G7vK,fbPkOYLVPtPgIt0MxizjfFJov3JbHyAi,8,5,2,0,2,11,5,1,26,3.7142857142857144,1,0.0,0,2,0,2,5,11,0,5,1,4,22,1
3219,44147,zeUi2UnQZPPF6bRQXw2s8LZ41ZOdqRAa,fbPkOYLVPtPgIt0MxizjfFJov3JbHyAi,5,2,1,0,1,5,5,0,14,2.0,2,0.0,0,1,0,1,2,5,0,5,0,2,12,1
3220,44149,W7N7he2GGE1A2J3fJvsUdwOZI9P4besV,fbPkOYLVPtPgIt0MxizjfFJov3JbHyAi,16,52,14,3,11,0,7,0,87,12.428571428571429,3,0.0,18,14,3,11,34,0,0,7,0,46,41,1
3221,44150,1OCnfEluJ5C06UYF5oIawyvraf5cATWk,fbPkOYLVPtPgIt0MxizjfFJov3JbHyAi,12,9,3,4,5,0,3,0,24,3.4285714285714284,1,0.0,4,3,3,5,5,0,1,3,0,15,9,1
3222,44153,mZ7ilucqUFwey1NwU92PRXQQ0HeHtWmh,fbPkOYLVPtPgIt0MxizjfFJov3JbHyAi,7,4,3,0,3,0,3,0,13,1.8571428571428572,1,0.0,0,3,0,3,4,0,0,3,0,6,7,1
3223,44154,wJViEDKJG9cycqokQxxOomq0g3hb2X0n,fbPkOYLVPtPgIt0MxizjfFJov3JbHyAi,1,0,0,0,0,0,1,0,1,0.14285714285714285,1,0.0,0,0,0,0,0,0,0,1,0,0,1,1
3224,44156,2fI4wWrvurl3ODzFoF1kViu5y8Lc1NgZ,fbPkOYLVPtPgIt0MxizjfFJov3JbHyAi,5,3,1,0,1,10,2,0,17,2.4285714285714284,1,0.0,0,1,0,1,3,10,0,2,0,2,15,1
3225,44157,ScslB7DNmqv4WEnDOYxGnluFKACqdrbs,fbPkOYLVPtPgIt0MxizjfFJov3JbHyAi,13,18,7,1,8,0,9,2,45,6.428571428571429,2,0.0,7,7,1,8,11,0,0,9,2,23,22,1
3226,44158,KBAguIZfF7JFxQgNwhhTOV2JtOxu7CHH,fbPkOYLVPtPgIt0MxizjfFJov3JbHyAi,8,9,4,0,3,0,4,0,20,2.857142857142857,2,0.0,2,4,0,3,7,0,0,4,0,9,11,1
3227,44160,gHeXtpmuyccgWbGT5QiAuKlFydUbHDzc,fbPkOYLVPtPgIt0MxizjfFJov3JbHyAi,5,4,2,0,1,0,2,0,9,1.2857142857142858,2,0.0,0,2,0,1,4,0,0,2,0,3,6,1
3228,44162,Lyagkt8Tl6Y9546SuIOdZylzB0VpBr47,fbPkOYLVPtPgIt0MxizjfFJov3JbHyAi,2,0,0,0,0,0,8,0,8,1.1428571428571428,1,0.0,0,0,0,0,0,0,0,8,0,0,8,1
3229,44164,WLc3nzeMA1m785zH4gOIVyKG8qieUOwG,fbPkOYLVPtPgIt0MxizjfFJov3JbHyAi,4,2,1,0,1,0,2,0,6,0.8571428571428571,1,0.0,0,1,0,1,2,0,0,2,0,2,4,1
3230,44166,zLQK4qXkDKq3GVHuvnA5ZgyIevHVQUHp,fbPkOYLVPtPgIt0MxizjfFJov3JbHyAi,14,17,8,0,5,0,4,1,35,5.0,1,0.0,0,8,0,5,17,0,0,4,1,13,22,1
3231,44167,aXGAxVHU5aDLZJJ1gHpvXefHkIbw92yB,fbPkOYLVPtPgIt0MxizjfFJov3JbHyAi,18,11,8,0,7,18,8,1,53,7.571428571428571,1,0.0,1,8,0,7,10,18,0,8,1,16,37,1
3232,44171,JhiJnBpiVfW8JCO4BrjAwx4ywoZHB71f,fbPkOYLVPtPgIt0MxizjfFJov3JbHyAi,7,8,3,0,2,0,3,0,16,2.2857142857142856,1,0.0,0,3,0,2,8,0,0,3,0,5,11,1
3233,44172,SvI7NjkOF6DOPWLRc1U4XOWjW6ht1V3M,fbPkOYLVPtPgIt0MxizjfFJov3JbHyAi,2,0,0,0,0,0,5,0,5,0.7142857142857143,1,0.0,0,0,0,0,0,0,0,5,0,0,5,1
3234,44174,kr9MhAzeae0UKmOp6QSbcSIPAfRDBwyS,fbPkOYLVPtPgIt0MxizjfFJov3JbHyAi,17,30,12,3,10,32,10,0,97,13.857142857142858,3,0.0,12,12,3,10,18,32,0,10,0,37,60,1
3235,44175,58HxGhVJCkPf0xNzljCqWpiXdfJMiEDw,fbPkOYLVPtPgIt0MxizjfFJov3JbHyAi,8,2,2,0,2,0,6,0,12,1.7142857142857142,1,0.0,0,2,0,2,2,0,0,6,0,4,8,1
3236,44178,ZUj8ciewoY1krerme1rA06bZgMQzwUwF,fbPkOYLVPtPgIt0MxizjfFJov3JbHyAi,10,20,9,0,5,10,8,1,53,7.571428571428571,3,0.0,2,9,0,5,18,10,0,8,1,16,37,0
3237,44179,KybJTS3fr0HyrDCaccrgyo0RzMzG0qom,fbPkOYLVPtPgIt0MxizjfFJov3JbHyAi,2,0,0,0,0,0,4,0,4,0.5714285714285714,1,0.0,0,0,0,0,0,0,0,4,0,0,4,1
3238,44181,ZPamISIdPsbqsq6aVqRDFzUi3IlRadjg,fbPkOYLVPtPgIt0MxizjfFJov3JbHyAi,12,12,6,0,4,16,8,1,47,6.714285714285714,2,0.0,0,6,0,4,12,16,0,8,1,10,37,1
3239,44182,sn2EpOZocGCK2n6oyJ74BVfoIYZKGwBK,fbPkOYLVPtPgIt0MxizjfFJov3JbHyAi,9,15,0,10,3,11,10,0,49,7.0,1,0.0,10,0,7,3,5,11,3,10,0,20,29,1
3240,44184,UsLFN9dzLo3sTXf5tfNoi18KyZHWYRsB,fbPkOYLVPtPgIt0MxizjfFJov3JbHyAi,22,35,16,16,19,5,3,0,94,13.428571428571429,2,0.0,17,16,13,19,18,5,3,3,0,65,29,1
3241,44185,tcFBEkXakkuMK1VljJZtgKVBO9EsakN0,fbPkOYLVPtPgIt0MxizjfFJov3JbHyAi,1,0,0,0,0,0,1,0,1,0.14285714285714285,1,0.0,0,0,0,0,0,0,0,1,0,0,1,1
3242,44186,mJ5BZ6EJA3wLg8jbGMObtpjRK8yspzI5,fbPkOYLVPtPgIt0MxizjfFJov3JbHyAi,46,53,28,38,16,46,13,1,195,27.857142857142858,3,0.0,17,28,32,16,36,46,6,13,1,93,102,1
3243,44187,i7yYKzmNeDNpl7ZXyamysycDjJWbLntm,fbPkOYLVPtPgIt0MxizjfFJov3JbHyAi,11,19,4,7,9,4,5,0,48,6.857142857142857,1,0.0,14,4,6,9,5,4,1,5,0,33,15,1
3244,44188,yFk2LSMib4DE4CR8Gt7OigYN8UE5SERE,fbPkOYLVPtPgIt0MxizjfFJov3JbHyAi,6,5,3,0,1,0,4,0,13,1.8571428571428572,3,0.0,0,3,0,1,5,0,0,4,0,4,9,1
3245,44193,5olZBiEN7fREGvXjZsAPA34LD7TNv2Om,fbPkOYLVPtPgIt0MxizjfFJov3JbHyAi,9,12,3,0,3,11,7,0,36,5.142857142857143,1,0.0,0,3,0,3,12,11,0,7,0,6,30,1
3246,44194,nkWrffpo6kobU01lUWepcu6aQb60BdxH,fbPkOYLVPtPgIt0MxizjfFJov3JbHyAi,46,75,35,18,22,34,17,1,202,28.857142857142858,9,0.0,22,35,17,22,53,34,1,17,1,96,106,0
3247,44195,rQ7jrT4jqfVvIwV7TCyxKklrYfaXz5qx,fbPkOYLVPtPgIt0MxizjfFJov3JbHyAi,6,7,4,0,2,7,4,0,24,3.4285714285714284,1,0.0,0,4,0,2,7,7,0,4,0,6,18,1
3248,44196,cXbVpSHehoFAcD5jvifZg4hoGlmfKlx5,fbPkOYLVPtPgIt0MxizjfFJov3JbHyAi,3,3,1,0,0,0,1,0,5,0.7142857142857143,1,0.0,0,1,0,0,3,0,0,1,0,1,4,0
3249,44201,bGSf4Dv41LrPDFgbxGTmHZXMfhKccKJy,fbPkOYLVPtPgIt0MxizjfFJov3JbHyAi,8,4,3,0,3,0,2,0,12,1.7142857142857142,2,0.0,0,3,0,3,4,0,0,2,0,6,6,1
3250,44202,UvmsOyeKqNqdnoWuF67HYRoCd5vZCTT3,fbPkOYLVPtPgIt0MxizjfFJov3JbHyAi,4,2,0,0,0,0,10,0,12,1.7142857142857142,2,0.0,0,0,0,0,2,0,0,10,0,0,12,1
3251,44203,4cRZxyVNjv13lU3nu2aK2rwyndExVCGa,fbPkOYLVPtPgIt0MxizjfFJov3JbHyAi,24,38,23,23,11,10,8,0,113,16.142857142857142,6,0.0,6,23,17,11,32,10,6,8,0,57,56,1
3252,44208,9nBDwXR4PojGZeJgF10uxjH1va7sf1sb,fbPkOYLVPtPgIt0MxizjfFJov3JbHyAi,5,3,1,0,1,0,7,0,12,1.7142857142857142,1,0.0,0,1,0,1,3,0,0,7,0,2,10,1
3253,44209,XZNYPNX0OVSTYmnVJQK9QQliGDqh1neQ,fbPkOYLVPtPgIt0MxizjfFJov3JbHyAi,5,8,3,0,0,0,7,0,18,2.5714285714285716,1,0.0,3,3,0,0,5,0,0,7,0,6,12,1
3254,44212,lMefkcgNh5NMvOXiUOkNuemhw07vFq2i,fbPkOYLVPtPgIt0MxizjfFJov3JbHyAi,6,4,2,0,1,6,5,0,18,2.5714285714285716,1,0.0,0,2,0,1,4,6,0,5,0,3,15,1
3255,44213,lR39Ca78D0WrhfXRqUEM5XEFow5I5VmV,fbPkOYLVPtPgIt0MxizjfFJov3JbHyAi,10,11,4,0,4,0,3,0,22,3.142857142857143,1,0.0,5,4,0,4,6,0,0,3,0,13,9,1
3256,44215,zLhYaUkalf3cJa8yuQ4GA08EdlJo6KYR,fbPkOYLVPtPgIt0MxizjfFJov3JbHyAi,2,0,0,0,0,0,2,0,2,0.2857142857142857,1,0.0,0,0,0,0,0,0,0,2,0,0,2,1
3257,44216,398KUlAbQAJq86al7WBicOZ2ToPIvKyy,fbPkOYLVPtPgIt0MxizjfFJov3JbHyAi,5,2,1,0,1,0,3,0,7,1.0,1,0.0,0,1,0,1,2,0,0,3,0,2,5,1
3258,44217,DwhbrQEsdQ584Yt1VsJhxkmyn6wsMQlr,fbPkOYLVPtPgIt0MxizjfFJov3JbHyAi,9,5,3,4,3,0,1,0,16,2.2857142857142856,1,0.0,1,3,3,3,4,0,1,1,0,10,6,1
3259,44219,Ur8i7WXZlexxp5KjJw4MNXxBOiEFRmEq,fbPkOYLVPtPgIt0MxizjfFJov3JbHyAi,12,4,4,0,4,0,3,0,15,2.142857142857143,2,0.0,0,4,0,4,4,0,0,3,0,8,7,1
3260,44225,9asMsoidPaReetlZL7sWsBgxvGgFunIW,fbPkOYLVPtPgIt0MxizjfFJov3JbHyAi,7,7,2,0,3,0,5,0,17,2.4285714285714284,1,0.0,2,2,0,3,5,0,0,5,0,7,10,1
3261,44227,W3EB1elPrDjFWV4QIzuswTukmjxtHb6Z,fbPkOYLVPtPgIt0MxizjfFJov3JbHyAi,5,2,0,0,1,0,2,0,5,0.7142857142857143,1,0.0,0,0,0,1,2,0,0,2,0,1,4,1
3262,44228,R1FqqBKIoe5gb1Zm4cRd6C2dKym4oN3J,fbPkOYLVPtPgIt0MxizjfFJov3JbHyAi,9,22,12,0,6,0,10,0,50,7.142857142857143,3,0.0,1,12,0,6,21,0,0,10,0,19,31,0
3263,44229,xDQR9jsrXbDdyr5ix2doPKar2TBbunBq,fbPkOYLVPtPgIt0MxizjfFJov3JbHyAi,8,8,4,0,3,19,4,1,39,5.571428571428571,1,0.0,0,4,0,3,8,19,0,4,1,7,32,1
3264,44230,Ijb9fKceIgYIt7UF8znubY4lpG9MvHfC,fbPkOYLVPtPgIt0MxizjfFJov3JbHyAi,4,2,1,0,1,0,1,0,5,0.7142857142857143,1,0.0,0,1,0,1,2,0,0,1,0,2,3,1
3265,44232,VvFmHqJuverkRg9SOJfO7EAhSTYwhk8R,fbPkOYLVPtPgIt0MxizjfFJov3JbHyAi,1,0,0,0,0,0,2,0,2,0.2857142857142857,1,0.0,0,0,0,0,0,0,0,2,0,0,2,1
3266,44233,wm9IrPuDWolACPuibTN3CpCrRGsa74ef,fbPkOYLVPtPgIt0MxizjfFJov3JbHyAi,19,8,7,0,7,0,19,1,42,6.0,1,0.0,0,7,0,7,8,0,0,19,1,14,28,1
3267,44236,jagu0OJDhWTGFhfCMk0ghqluLpW3kzdC,fbPkOYLVPtPgIt0MxizjfFJov3JbHyAi,36,54,30,26,21,50,31,5,217,31.0,6,0.0,14,30,20,21,40,50,6,31,5,85,132,0
3268,44237,5wfiCJMdbkN7MkoUGvo3cfz8jV3jCktA,fbPkOYLVPtPgIt0MxizjfFJov3JbHyAi,6,4,2,0,1,11,4,0,22,3.142857142857143,2,0.0,0,2,0,1,4,11,0,4,0,3,19,1
3269,44239,0rBpfipIkPUXXv4992tUqetb5IpoweSC,fbPkOYLVPtPgIt0MxizjfFJov3JbHyAi,7,3,2,0,2,0,2,0,9,1.2857142857142858,1,0.0,0,2,0,2,3,0,0,2,0,4,5,1
3270,44240,OrcJP9YaqKO2WfXtlTi3GWMyG2WCYDrA,fbPkOYLVPtPgIt0MxizjfFJov3JbHyAi,7,3,2,0,2,0,4,0,11,1.5714285714285714,1,0.0,0,2,0,2,3,0,0,4,0,4,7,1
3271,44242,QYVRHTpooyTkzSbIywJ7ri5o4t73Xwty,fbPkOYLVPtPgIt0MxizjfFJov3JbHyAi,7,11,5,0,2,6,6,3,33,4.714285714285714,2,0.0,0,5,0,2,11,6,0,6,3,7,26,1
3272,44243,RR8icbJjkYOdUrylwRxkzCL89mNBS1kQ,fbPkOYLVPtPgIt0MxizjfFJov3JbHyAi,7,5,2,0,2,0,6,0,15,2.142857142857143,1,0.0,2,2,0,2,3,0,0,6,0,6,9,1
3273,44244,g2zZYnTJ1Pk3cSjsVP5SH4UjJdsbDJv7,fbPkOYLVPtPgIt0MxizjfFJov3JbHyAi,34,42,23,28,17,13,10,1,134,19.142857142857142,4,0.0,13,23,22,17,29,13,6,10,1,75,59,0
3274,44248,K1umGIzxZInQChRQpf7KLIJB3rfPL8P3,fbPkOYLVPtPgIt0MxizjfFJov3JbHyAi,7,6,4,0,2,2,1,0,15,2.142857142857143,1,0.0,0,4,0,2,6,2,0,1,0,6,9,1
3275,44251,vFF7Q9hHOJ6qa16cDuF7JSSiOD7EEEuA,fbPkOYLVPtPgIt0MxizjfFJov3JbHyAi,2,0,0,0,0,0,2,0,2,0.2857142857142857,1,0.0,0,0,0,0,0,0,0,2,0,0,2,1
3276,44252,ly2UupZqGwkAeluSmrnRPVaNBG5zI6oB,fbPkOYLVPtPgIt0MxizjfFJov3JbHyAi,10,3,3,0,3,0,3,0,12,1.7142857142857142,1,0.0,0,3,0,3,3,0,0,3,0,6,6,1
3277,44253,ZV7o5798W7XrprHpNhvS0Cr1EgwiSgHZ,fbPkOYLVPtPgIt0MxizjfFJov3JbHyAi,10,11,5,0,4,17,8,0,45,6.428571428571429,2,0.0,3,5,0,4,8,17,0,8,0,12,33,1
3278,44256,bJOkL9U6IOy2ICy3FtWSfPLY5BHrDaNn,fbPkOYLVPtPgIt0MxizjfFJov3JbHyAi,19,19,11,2,8,1,8,0,49,7.0,3,0.0,1,11,2,8,18,1,0,8,0,22,27,1
3279,44257,QyPU5c4UNqLLtktJRpwU2AioPifGtMTU,fbPkOYLVPtPgIt0MxizjfFJov3JbHyAi,5,3,1,0,1,0,5,0,10,1.4285714285714286,1,0.0,0,1,0,1,3,0,0,5,0,2,8,1
3280,44258,mV7oUFoQV8UaUytbbGy8dq3Lp45sMej3,fbPkOYLVPtPgIt0MxizjfFJov3JbHyAi,5,2,1,0,1,0,3,0,7,1.0,1,0.0,0,1,0,1,2,0,0,3,0,2,5,1
3281,44260,fTY7PbFNeV0B3b5XiSuBQtOgneGDS4iZ,fbPkOYLVPtPgIt0MxizjfFJov3JbHyAi,12,7,5,0,4,0,4,0,20,2.857142857142857,2,0.0,0,5,0,4,7,0,0,4,0,9,11,1
3282,44263,w7sOZdeQBox0eO8DVqyUKzi8avIzaYn4,fbPkOYLVPtPgIt0MxizjfFJov3JbHyAi,11,9,4,0,3,2,8,1,27,3.857142857142857,1,0.0,3,4,0,3,6,2,0,8,1,10,17,1
3283,44264,cA8JP9WlrRgRowgBnuouyPdSEGVSdPoU,fbPkOYLVPtPgIt0MxizjfFJov3JbHyAi,7,3,2,0,2,0,2,0,9,1.2857142857142858,1,0.0,0,2,0,2,3,0,0,2,0,4,5,1
3284,44265,beJ7nfPQcUdFyj8P1C0Vl4K57I6wCKrL,fbPkOYLVPtPgIt0MxizjfFJov3JbHyAi,7,8,5,0,3,0,3,1,20,2.857142857142857,1,0.0,0,5,0,3,8,0,0,3,1,8,12,1
3285,44267,r9kprGnmV8vKXI1tErs4EvgHZZ8IRF8I,fbPkOYLVPtPgIt0MxizjfFJov3JbHyAi,4,2,0,0,0,4,4,0,10,1.4285714285714286,1,0.0,0,0,0,0,2,4,0,4,0,0,10,1
3286,44270,GMzSpgZQ6jzVsfHn8W8i83JsYNxnP00b,fbPkOYLVPtPgIt0MxizjfFJov3JbHyAi,14,15,8,6,7,0,4,0,40,5.714285714285714,2,0.0,5,8,5,7,10,0,1,4,0,25,15,1
3287,44272,J3rwPgcYHKst1mTrkHfz6lTuHZtWbhHS,fbPkOYLVPtPgIt0MxizjfFJov3JbHyAi,6,5,3,0,3,0,1,0,12,1.7142857142857142,1,0.0,0,3,0,3,5,0,0,1,0,6,6,1
3288,44274,2qxdbGcKrOShnqwnQiXgdDAFvYPhSM6o,fbPkOYLVPtPgIt0MxizjfFJov3JbHyAi,9,7,5,0,4,0,4,0,20,2.857142857142857,2,0.0,0,5,0,4,7,0,0,4,0,9,11,1
3289,44275,KTCLrjyRw15OM6ZLS9kBfeLSSnS0pLeh,fbPkOYLVPtPgIt0MxizjfFJov3JbHyAi,10,11,8,0,4,3,15,2,43,6.142857142857143,2,0.0,0,8,0,4,11,3,0,15,2,12,31,1
3290,44277,chYWQx9p6mrqtOqnuZLINe1RPkFDRJYi,fbPkOYLVPtPgIt0MxizjfFJov3JbHyAi,10,11,5,0,4,1,15,1,37,5.285714285714286,1,0.0,2,5,0,4,9,1,0,15,1,11,26,1
3291,44279,tx4grxmlQgEoy6eADYfJTj1STA6T1B91,fbPkOYLVPtPgIt0MxizjfFJov3JbHyAi,4,2,1,0,1,0,1,0,5,0.7142857142857143,1,0.0,0,1,0,1,2,0,0,1,0,2,3,1
3292,44280,gIksIEwmEEV0Pn8wMtaqnzuIMor23skp,fbPkOYLVPtPgIt0MxizjfFJov3JbHyAi,12,17,4,2,2,14,19,1,59,8.428571428571429,3,0.0,3,4,2,2,14,14,0,19,1,11,48,1
3293,44282,bxc4zM194IAB8OgoL6kSDGRq4OX5TDtY,fbPkOYLVPtPgIt0MxizjfFJov3JbHyAi,10,12,7,0,3,10,6,1,39,5.571428571428571,2,0.0,2,7,0,3,10,10,0,6,1,12,27,1
3294,44283,57qzgJAwfROYPxzSOrsA3G5DLHP95ajU,fbPkOYLVPtPgIt0MxizjfFJov3JbHyAi,6,5,3,0,2,0,4,0,14,2.0,2,0.0,0,3,0,2,5,0,0,4,0,5,9,1
3295,44284,lAPXQuLP1yRNYGiTpu7dIeoZTMEKBA0b,fbPkOYLVPtPgIt0MxizjfFJov3JbHyAi,10,16,4,6,4,0,3,0,33,4.714285714285714,1,0.0,4,4,6,4,12,0,0,3,0,18,15,1
3296,44285,KMmrb4nTAt1m2OAaFtq8lztLT3NFO2Pb,fbPkOYLVPtPgIt0MxizjfFJov3JbHyAi,1,0,0,0,0,0,1,0,1,0.14285714285714285,1,0.0,0,0,0,0,0,0,0,1,0,0,1,1
3297,44286,Sw0laYN5mow6XiHfrWCJl4qnRcU0Nesb,fbPkOYLVPtPgIt0MxizjfFJov3JbHyAi,10,10,8,0,6,0,2,0,26,3.7142857142857144,2,0.0,0,8,0,6,10,0,0,2,0,14,12,1
3298,44287,DULOyOFZsLRkoNHg3me4lby4O9mlfTfP,fbPkOYLVPtPgIt0MxizjfFJov3JbHyAi,8,14,8,0,0,0,6,0,28,4.0,2,0.0,0,8,0,0,14,0,0,6,0,8,20,1
3299,44288,mSToVMacc08MhsUyEFn562K69bpANB3P,fbPkOYLVPtPgIt0MxizjfFJov3JbHyAi,6,3,1,0,1,0,2,0,7,1.0,2,0.0,0,1,0,1,3,0,0,2,0,2,5,1
3300,44289,Z8E1fWEz0b5y6BD6dlIVX2UJWlqxRpHR,fbPkOYLVPtPgIt0MxizjfFJov3JbHyAi,11,12,6,5,5,4,2,0,34,4.857142857142857,2,0.0,4,6,4,5,8,4,1,2,0,19,15,1
3301,44290,RdArNf6qPycx7nnXJK9MCRyymBwv75n3,fbPkOYLVPtPgIt0MxizjfFJov3JbHyAi,5,2,1,0,0,0,5,0,8,1.1428571428571428,1,0.0,0,1,0,0,2,0,0,5,0,1,7,1
3302,44291,wGwI5daC8SwOUE0hcVwwOwixSwocHFPs,fbPkOYLVPtPgIt0MxizjfFJov3JbHyAi,6,3,2,0,2,0,1,0,8,1.1428571428571428,1,0.0,0,2,0,2,3,0,0,1,0,4,4,1
3303,44295,ydIfB5lDuQMdwnqw1Trec6MMfLMb9KME,fbPkOYLVPtPgIt0MxizjfFJov3JbHyAi,5,9,0,0,1,2,2,0,14,2.0,1,0.0,3,0,0,1,6,2,0,2,0,4,10,1
3304,44296,SlxIPeu1dmMaJlW3478OT2sG7yUhXJL1,fbPkOYLVPtPgIt0MxizjfFJov3JbHyAi,2,0,0,0,0,0,5,0,5,0.7142857142857143,1,0.0,0,0,0,0,0,0,0,5,0,0,5,1
3305,44297,4LlDUfJVZRN4VGhz1cOPbu42ptFr0ItJ,fbPkOYLVPtPgIt0MxizjfFJov3JbHyAi,10,22,16,0,10,4,5,0,57,8.142857142857142,2,0.0,2,16,0,10,20,4,0,5,0,28,29,1
3306,44299,5uyWPVLiSthHYhSAJufLobkztuAqGghO,fbPkOYLVPtPgIt0MxizjfFJov3JbHyAi,12,39,13,8,14,10,6,0,90,12.857142857142858,4,0.0,15,13,5,14,24,10,3,6,0,47,43,1
3307,44302,OzkaXzIRl9kqXzCHMBKEBEDNw27l64vJ,fbPkOYLVPtPgIt0MxizjfFJov3JbHyAi,5,2,1,0,1,0,6,0,10,1.4285714285714286,1,0.0,0,1,0,1,2,0,0,6,0,2,8,1
3308,44303,6SFV3JbKdSV7hRZqshJPkaxQAde0a5lX,fbPkOYLVPtPgIt0MxizjfFJov3JbHyAi,6,2,1,0,1,2,5,1,12,1.7142857142857142,1,0.0,0,1,0,1,2,2,0,5,1,2,10,1
3309,44304,NqxqEj1F6iv4kBP9fZF1q6JwtPVhl0hk,fbPkOYLVPtPgIt0MxizjfFJov3JbHyAi,4,1,0,0,0,0,3,0,4,0.5714285714285714,1,0.0,0,0,0,0,1,0,0,3,0,0,4,1
3310,44306,GCwNBqpZSN8gReMgO4ZxJ7plXwWznnJn,fbPkOYLVPtPgIt0MxizjfFJov3JbHyAi,1,0,0,0,0,0,1,0,1,0.14285714285714285,1,0.0,0,0,0,0,0,0,0,1,0,0,1,1
3311,44308,hIXeM0yyb6wIxVNnB5ijRV2LpcYBbrLW,fbPkOYLVPtPgIt0MxizjfFJov3JbHyAi,5,8,1,0,1,0,2,0,12,1.7142857142857142,1,0.0,0,1,0,1,8,0,0,2,0,2,10,1
3312,45309,cvmNQvB8C9tzfr5JL4ScqNRXsUkWS0qq,RXDvfPUBYFlVdlueBFbLW0mhhAyGEqpt,68,196,127,65,18,173,65,5,649,92.71428571428571,7,0.0,16,127,50,18,180,173,15,65,5,211,438,0
3313,45312,JrU3mQXDsHM3JCMrGML8Gsd1f6KKBRz5,RXDvfPUBYFlVdlueBFbLW0mhhAyGEqpt,1,0,0,0,0,0,1,0,1,0.14285714285714285,1,0.0,0,0,0,0,0,0,0,1,0,0,1,1
3314,45316,KUdvYZYC6ZViW3z5eiAU2e6Me0VXEfY4,RXDvfPUBYFlVdlueBFbLW0mhhAyGEqpt,9,6,0,0,0,0,7,0,13,1.8571428571428572,2,0.0,0,0,0,0,6,0,0,7,0,0,13,1
3315,45327,oE1QbspE1VaPia0G9CbmnflG7dN6cZJM,G8EPVSXsOYB5YQWZGiz1aVq5Pgr2GrQu,8,7,4,0,0,0,4,1,16,2.2857142857142856,2,0.0,1,4,0,0,6,0,0,4,1,5,11,1
3316,45339,CladEfFLLomb4XABUtmNVPFfnjm4LhE2,RXDvfPUBYFlVdlueBFbLW0mhhAyGEqpt,44,86,2,135,10,6,13,0,252,36.0,2,0.0,37,2,122,10,49,6,13,13,0,171,81,0
3317,45340,Q57EC9WScoWjECRp7MT77bmBt9oZMVVG,RXDvfPUBYFlVdlueBFbLW0mhhAyGEqpt,53,115,64,64,12,620,199,37,1111,158.71428571428572,16,0.0,18,64,51,12,97,620,13,199,37,145,966,0
3318,45366,4v506xwnN2gFG9XeSNIeiBlmXImooi1O,RXDvfPUBYFlVdlueBFbLW0mhhAyGEqpt,66,96,44,139,35,0,5,0,319,45.57142857142857,2,0.0,43,44,134,35,53,0,5,5,0,256,63,0
3319,45384,zkzUmPQTrqnNy4aMEOpIupZNYtjTcR9O,G8EPVSXsOYB5YQWZGiz1aVq5Pgr2GrQu,1,0,0,0,0,0,1,0,1,0.14285714285714285,1,0.0,0,0,0,0,0,0,0,1,0,0,1,1
3320,45391,sUA9xXq2cjEIung0hBSUfP1uBxFNZSs5,G8EPVSXsOYB5YQWZGiz1aVq5Pgr2GrQu,17,11,5,24,3,3,8,1,55,7.857142857142857,3,0.0,1,5,20,3,10,3,4,8,1,29,26,1
3321,45402,1lu7qFlpJ7c77SdGrohS207VNZCEPQ2W,G8EPVSXsOYB5YQWZGiz1aVq5Pgr2GrQu,14,7,6,0,4,0,19,2,38,5.428571428571429,2,0.0,0,6,0,4,7,0,0,19,2,10,28,1
3322,45436,yX4GtBReTtJl8CLrRCBEP3vcJDxXoOOn,RXDvfPUBYFlVdlueBFbLW0mhhAyGEqpt,1,0,0,0,0,0,1,0,1,0.14285714285714285,1,0.0,0,0,0,0,0,0,0,1,0,0,1,1
3323,45466,E2SSacGkmDwMmCOVOXL29GviqMFLwc68,G8EPVSXsOYB5YQWZGiz1aVq5Pgr2GrQu,1,0,0,0,0,0,1,0,1,0.14285714285714285,1,0.0,0,0,0,0,0,0,0,1,0,0,1,1
3324,45483,5U9E0pnoyq8gJfR6llsPDT5KP7DSR7H8,G8EPVSXsOYB5YQWZGiz1aVq5Pgr2GrQu,1,0,0,0,0,0,1,0,1,0.14285714285714285,1,0.0,0,0,0,0,0,0,0,1,0,0,1,1
3325,45532,ZrIXM5h8t7QDXRvT8qPfGTwh0kjMYeoV,RXDvfPUBYFlVdlueBFbLW0mhhAyGEqpt,9,13,8,0,1,15,4,0,41,5.857142857142857,3,0.0,2,8,0,1,11,15,0,4,0,11,30,1
3326,45546,VMgv7OqkaBwITbfAg6B6mOmAS6m3C11w,G8EPVSXsOYB5YQWZGiz1aVq5Pgr2GrQu,18,21,1,60,0,0,2,0,84,12.0,2,0.0,10,1,44,0,11,0,16,2,0,55,29,1
3327,45611,f2dlkEjQnfiTH1JmGq8MzaHN9HyOSQno,RXDvfPUBYFlVdlueBFbLW0mhhAyGEqpt,1,0,0,0,0,0,1,0,1,0.14285714285714285,1,0.0,0,0,0,0,0,0,0,1,0,0,1,1
3328,45722,zUCFNdkDJjSNIqUVigI0Q3t79JnpwRq3,RXDvfPUBYFlVdlueBFbLW0mhhAyGEqpt,1,0,0,0,0,0,1,0,1,0.14285714285714285,1,0.0,0,0,0,0,0,0,0,1,0,0,1,1
3329,45849,CpJFUzNBBad8gxGQfFWcVCTdakqtlRdi,RXDvfPUBYFlVdlueBFbLW0mhhAyGEqpt,1,0,0,0,0,0,2,0,2,0.2857142857142857,1,0.0,0,0,0,0,0,0,0,2,0,0,2,1
3330,45854,0DHsJAElXb9hqHUPTXAQocHtOXvWXP78,RXDvfPUBYFlVdlueBFbLW0mhhAyGEqpt,1,0,0,0,0,0,1,0,1,0.14285714285714285,1,0.0,0,0,0,0,0,0,0,1,0,0,1,1
3331,45931,BTsn79qot898Mo4TTFaO7NRlDTnmwcCn,G8EPVSXsOYB5YQWZGiz1aVq5Pgr2GrQu,1,0,0,0,0,0,1,0,1,0.14285714285714285,1,0.0,0,0,0,0,0,0,0,1,0,0,1,1
3332,45958,QVJT76zcnp3BslGL7JUS10ZkHM5HFGSg,RXDvfPUBYFlVdlueBFbLW0mhhAyGEqpt,1,0,0,0,0,0,1,0,1,0.14285714285714285,1,0.0,0,0,0,0,0,0,0,1,0,0,1,1
3333,45969,chQJNd08oe4UgyVlUUX52CvD3Wla8eb7,G8EPVSXsOYB5YQWZGiz1aVq5Pgr2GrQu,1,0,0,0,0,0,1,0,1,0.14285714285714285,1,0.0,0,0,0,0,0,0,0,1,0,0,1,1
3334,45977,sGg2QuTzc9ZdW4JVwqEMxUhxNa3l9bLB,G8EPVSXsOYB5YQWZGiz1aVq5Pgr2GrQu,1,0,0,0,0,0,1,0,1,0.14285714285714285,1,0.0,0,0,0,0,0,0,0,1,0,0,1,1
3335,46013,PNXl2SBlhwK5mHxVh3FrbKdX9rl1VIVp,G8EPVSXsOYB5YQWZGiz1aVq5Pgr2GrQu,1,0,0,0,0,0,1,0,1,0.14285714285714285,1,0.0,0,0,0,0,0,0,0,1,0,0,1,1
3336,46015,fGEAQY13PDoFhSvPw6ar51lhcxcXekJz,RXDvfPUBYFlVdlueBFbLW0mhhAyGEqpt,1,0,0,0,0,0,2,0,2,0.2857142857142857,1,0.0,0,0,0,0,0,0,0,2,0,0,2,1
3337,46059,ffnHtZ1QN4qjciwC3Yy8mONo5ZYvivQf,G8EPVSXsOYB5YQWZGiz1aVq5Pgr2GrQu,1,0,0,0,0,0,1,0,1,0.14285714285714285,1,0.0,0,0,0,0,0,0,0,1,0,0,1,1
3338,46114,3YdfU7bhuCtVSPeVcn33KfVYPID77mmY,RXDvfPUBYFlVdlueBFbLW0mhhAyGEqpt,1,0,0,0,0,0,1,0,1,0.14285714285714285,1,0.0,0,0,0,0,0,0,0,1,0,0,1,1
3339,46173,jj6BKJzz2LfNkxpbRScKRBOb519d4fcM,G8EPVSXsOYB5YQWZGiz1aVq5Pgr2GrQu,1,0,0,0,0,0,1,0,1,0.14285714285714285,1,0.0,0,0,0,0,0,0,0,1,0,0,1,1
3340,46237,N7kM3jWM4eH8xNeIeU71MKRwK6kQucbk,G8EPVSXsOYB5YQWZGiz1aVq5Pgr2GrQu,4,2,0,0,0,0,2,0,4,0.5714285714285714,1,0.0,0,0,0,0,2,0,0,2,0,0,4,1
3341,46280,2kMQkfKYMlhaU4UM5pB8xmNc8uChRuw1,RXDvfPUBYFlVdlueBFbLW0mhhAyGEqpt,1,0,0,0,0,0,1,0,1,0.14285714285714285,1,0.0,0,0,0,0,0,0,0,1,0,0,1,1
3342,46284,5lTTIs9nhtO0O7RTM99nDh8BPtI6ScTe,G8EPVSXsOYB5YQWZGiz1aVq5Pgr2GrQu,1,0,0,0,0,0,1,0,1,0.14285714285714285,1,0.0,0,0,0,0,0,0,0,1,0,0,1,1
3343,46304,khyDqhFAo6DpK4tMIyensDnI5TCI4bvw,G8EPVSXsOYB5YQWZGiz1aVq5Pgr2GrQu,1,0,0,0,0,0,1,0,1,0.14285714285714285,1,0.0,0,0,0,0,0,0,0,1,0,0,1,1
3344,46338,ZqLzWImxdtQBdKkWQiADsQDooYoZ3q37,RXDvfPUBYFlVdlueBFbLW0mhhAyGEqpt,1,0,0,0,0,0,1,0,1,0.14285714285714285,1,0.0,0,0,0,0,0,0,0,1,0,0,1,1
3345,46355,kjTdi307uJdPG2dA0MRZXL0j1FvRWtkq,G8EPVSXsOYB5YQWZGiz1aVq5Pgr2GrQu,1,0,0,0,0,0,1,0,1,0.14285714285714285,1,0.0,0,0,0,0,0,0,0,1,0,0,1,1
3346,46366,KuNFtG4l08F89uoxUeo0jGAYIKWrBRbs,RXDvfPUBYFlVdlueBFbLW0mhhAyGEqpt,15,19,6,0,3,0,10,0,38,5.428571428571429,2,0.0,0,6,0,3,19,0,0,10,0,9,29,1
3347,46383,cxxLaXhgAon6KrRcUx12hLoqbuiALekd,RXDvfPUBYFlVdlueBFbLW0mhhAyGEqpt,1,0,0,0,0,0,1,0,1,0.14285714285714285,1,0.0,0,0,0,0,0,0,0,1,0,0,1,1
3348,46389,gGFmJyNMerYTj0kT96HuKIvL9JdTq2vY,RXDvfPUBYFlVdlueBFbLW0mhhAyGEqpt,34,50,26,87,17,8,15,0,203,29.0,5,0.0,18,26,73,17,32,8,14,15,0,134,69,0
3349,46393,2AW6aH0SqKYjpe5J2qxXqfKxHscq7JWf,G8EPVSXsOYB5YQWZGiz1aVq5Pgr2GrQu,1,0,0,0,0,0,1,0,1,0.14285714285714285,1,0.0,0,0,0,0,0,0,0,1,0,0,1,1
3350,46413,3eLagVEammG0JrQUYdbSaNysDt0g3zAb,RXDvfPUBYFlVdlueBFbLW0mhhAyGEqpt,1,0,0,0,0,0,1,0,1,0.14285714285714285,1,0.0,0,0,0,0,0,0,0,1,0,0,1,1
3351,46414,pxpbjivAFvcOKL2janpM89oHptiaHIsF,G8EPVSXsOYB5YQWZGiz1aVq5Pgr2GrQu,1,0,0,0,0,0,1,0,1,0.14285714285714285,1,0.0,0,0,0,0,0,0,0,1,0,0,1,1
3352,46440,jspM6ZD48llYyfw95wwrh04hh61lp4NC,RXDvfPUBYFlVdlueBFbLW0mhhAyGEqpt,7,6,3,0,1,0,2,0,12,1.7142857142857142,2,0.0,0,3,0,1,6,0,0,2,0,4,8,1
3353,46446,C7E8IpvmWl51PErSqNPx8JIZDHe2uLQP,RXDvfPUBYFlVdlueBFbLW0mhhAyGEqpt,24,47,22,0,17,0,13,0,99,14.142857142857142,3,0.0,6,22,0,17,41,0,0,13,0,45,54,1
3354,46481,HBy8mPchGFgKjPi1BR1hdK1ryzkGe4Eu,fbPkOYLVPtPgIt0MxizjfFJov3JbHyAi,2,0,0,0,0,0,2,0,2,0.2857142857142857,1,0.0,0,0,0,0,0,0,0,2,0,0,2,1
3355,46482,QvWjJCxM4Z5YXutHnyToIP2emrXnT27F,fbPkOYLVPtPgIt0MxizjfFJov3JbHyAi,8,2,1,0,1,1,5,1,11,1.5714285714285714,1,0.0,0,1,0,1,2,1,0,5,1,2,9,1
3356,46483,TZ1qqjK0a5Zztn1Eld8NcfyMD8SKYxjC,fbPkOYLVPtPgIt0MxizjfFJov3JbHyAi,8,2,1,0,1,1,18,3,26,3.7142857142857144,1,0.0,0,1,0,1,2,1,0,18,3,2,24,1
3357,46484,acna1oLISW5GtLdHgEb3HFIk5PnI1WRA,fbPkOYLVPtPgIt0MxizjfFJov3JbHyAi,1,0,0,0,0,0,1,0,1,0.14285714285714285,1,0.0,0,0,0,0,0,0,0,1,0,0,1,1
3358,46485,n0aD0wlRo2epwn74jquTDUFpiwWF99mc,fbPkOYLVPtPgIt0MxizjfFJov3JbHyAi,11,16,5,2,6,4,4,0,37,5.285714285714286,2,0.0,7,5,2,6,9,4,0,4,0,20,17,0
3359,46487,0cQOAQZYor1XBUr8oohVdZF8cKrNp08W,fbPkOYLVPtPgIt0MxizjfFJov3JbHyAi,25,36,15,22,9,1,11,0,94,13.428571428571429,4,0.0,10,15,17,9,26,1,5,11,0,51,43,1
3360,46489,vjcoSDgY9JiBCtsViMhHCl6KGCk2TvE5,fbPkOYLVPtPgIt0MxizjfFJov3JbHyAi,7,3,2,0,2,0,2,0,9,1.2857142857142858,1,0.0,0,2,0,2,3,0,0,2,0,4,5,1
3361,46492,A5Ha5kMAE8LgDZc3iTs32MwLDsMXRqMa,fbPkOYLVPtPgIt0MxizjfFJov3JbHyAi,16,16,9,20,0,0,3,0,48,6.857142857142857,1,0.0,6,9,20,0,10,0,0,3,0,35,13,1
3362,46494,JedhrXCQn7XYerN8pX6fyNhWwODWvnUf,fbPkOYLVPtPgIt0MxizjfFJov3JbHyAi,10,16,3,8,7,0,4,0,38,5.428571428571429,1,0.0,12,3,5,7,4,0,3,4,0,27,11,0
3363,46496,TvKzeZn2ihjFdDt7bera0RviFXCeKKB6,fbPkOYLVPtPgIt0MxizjfFJov3JbHyAi,5,2,1,0,1,0,4,0,8,1.1428571428571428,1,0.0,0,1,0,1,2,0,0,4,0,2,6,1
3364,46498,jSp9qlCQEKpc4PsUPHVOngS2TFfQ6jwl,fbPkOYLVPtPgIt0MxizjfFJov3JbHyAi,3,1,0,0,0,0,2,0,3,0.42857142857142855,1,0.0,0,0,0,0,1,0,0,2,0,0,3,1
3365,46500,Kkk2oty8lHBEgyFYDiZgsO24fUpD8pZQ,fbPkOYLVPtPgIt0MxizjfFJov3JbHyAi,9,5,3,4,3,0,1,0,16,2.2857142857142856,1,0.0,1,3,3,3,4,0,1,1,0,10,6,1
3366,46501,rIwy3FDbkCxSl3lJMcDBmeUqV54svIRx,fbPkOYLVPtPgIt0MxizjfFJov3JbHyAi,8,9,5,0,4,0,5,0,23,3.2857142857142856,1,0.0,0,5,0,4,9,0,0,5,0,9,14,1
3367,46503,DPR39VXlEgPnSvHJlcrFWVjZyCJYvn9R,fbPkOYLVPtPgIt0MxizjfFJov3JbHyAi,11,5,4,0,4,0,6,0,19,2.7142857142857144,2,0.0,0,4,0,4,5,0,0,6,0,8,11,1
3368,46504,CpsMjwcxvfkSN0hyQGRgXRt6dQZxAjwb,fbPkOYLVPtPgIt0MxizjfFJov3JbHyAi,11,7,4,0,5,0,5,1,22,3.142857142857143,1,0.0,2,4,0,5,5,0,0,5,1,11,11,1
3369,46505,kBNWoa4A4jmNOoJaSAupB8wyNzpsoJAN,fbPkOYLVPtPgIt0MxizjfFJov3JbHyAi,61,98,38,38,30,1,19,3,227,32.42857142857143,6,0.0,37,38,34,30,61,1,4,19,3,139,88,0
3370,46511,xeCFX5y6IRjmYKFA9y4Rgt3SG4YPELud,fbPkOYLVPtPgIt0MxizjfFJov3JbHyAi,62,259,85,24,37,51,29,0,485,69.28571428571429,5,0.0,24,85,23,37,235,51,1,29,0,169,316,0
3371,46512,a8mEu8FF4lDfLSb2ZwttyDGOOQsEW3CZ,fbPkOYLVPtPgIt0MxizjfFJov3JbHyAi,9,7,3,0,3,0,6,0,19,2.7142857142857144,1,0.0,2,3,0,3,5,0,0,6,0,8,11,1
3372,46513,EiO5bky9R1Iqlpv4ItUpPBUgGb1eJItE,fbPkOYLVPtPgIt0MxizjfFJov3JbHyAi,5,2,1,0,1,0,2,0,6,0.8571428571428571,2,0.0,0,1,0,1,2,0,0,2,0,2,4,1
3373,46514,wQDLnIhQRiBlJ7OOKtAQT7egktqnXxWd,fbPkOYLVPtPgIt0MxizjfFJov3JbHyAi,13,9,6,0,5,18,11,1,50,7.142857142857143,1,0.0,0,6,0,5,9,18,0,11,1,11,39,1
3374,46515,ZalaHb2nOUsnNI2p4xQ00VNI9pJY08yk,fbPkOYLVPtPgIt0MxizjfFJov3JbHyAi,2,0,0,0,0,0,2,0,2,0.2857142857142857,1,0.0,0,0,0,0,0,0,0,2,0,0,2,1
3375,46516,WvBcJWjHUn0OSdcSOrveOYpPP7iy97HT,fbPkOYLVPtPgIt0MxizjfFJov3JbHyAi,3,0,0,0,0,0,7,0,7,1.0,1,0.0,0,0,0,0,0,0,0,7,0,0,7,1
3376,46517,MN4wOgynUY4QcRaraCB5Ym52vNjUttfc,fbPkOYLVPtPgIt0MxizjfFJov3JbHyAi,9,3,2,0,2,1,5,1,14,2.0,2,0.0,0,2,0,2,3,1,0,5,1,4,10,1
3377,46518,zNp29QwJYW19LnSbsZ5BdQrNdzMHpz2F,fbPkOYLVPtPgIt0MxizjfFJov3JbHyAi,27,53,30,12,20,22,8,0,145,20.714285714285715,3,0.0,14,30,11,20,39,22,1,8,0,75,70,1
3378,46519,q0GqO7mYZSUjsbmDGsoT5N4ppqd8vOBB,fbPkOYLVPtPgIt0MxizjfFJov3JbHyAi,7,4,2,0,2,0,4,0,12,1.7142857142857142,1,0.0,0,2,0,2,4,0,0,4,0,4,8,1
3379,46520,SK3evWrWxCZl0iqN8sbmSNUdgxEYSLSK,fbPkOYLVPtPgIt0MxizjfFJov3JbHyAi,2,0,0,0,0,0,2,0,2,0.2857142857142857,1,0.0,0,0,0,0,0,0,0,2,0,0,2,1
3380,46522,EfURFHip4N6v2zuhSrNJ2KVVAM4Td3mY,fbPkOYLVPtPgIt0MxizjfFJov3JbHyAi,11,11,4,0,4,0,1,0,20,2.857142857142857,1,0.0,0,4,0,4,11,0,0,1,0,8,12,1
3381,46523,UD5FqfNicjboiN32GGPYtIcMIUIxLZOX,fbPkOYLVPtPgIt0MxizjfFJov3JbHyAi,6,4,3,0,3,0,1,0,11,1.5714285714285714,1,0.0,0,3,0,3,4,0,0,1,0,6,5,1
3382,46524,2QBIivovfBXOULGvBnn18Q4kSGQH3yTO,fbPkOYLVPtPgIt0MxizjfFJov3JbHyAi,7,2,1,0,1,0,4,0,8,1.1428571428571428,1,0.0,0,1,0,1,2,0,0,4,0,2,6,1
3383,46526,LTrIeWW4Gi4Y09oaKB1naUI4GII0UZAi,fbPkOYLVPtPgIt0MxizjfFJov3JbHyAi,4,3,0,0,0,0,5,0,8,1.1428571428571428,1,0.0,0,0,0,0,3,0,0,5,0,0,8,1
3384,46527,8JTz84ZDdJm6tvsd7hgyCl1RB6wU6r2e,fbPkOYLVPtPgIt0MxizjfFJov3JbHyAi,23,48,20,13,18,29,23,2,153,21.857142857142858,5,0.0,19,20,10,18,29,29,3,23,2,67,86,1
3385,46529,HQVRezU89umSvdjmOYF3nS0qPRPvMBxw,fbPkOYLVPtPgIt0MxizjfFJov3JbHyAi,8,5,2,0,3,0,3,0,13,1.8571428571428572,1,0.0,3,2,0,3,2,0,0,3,0,8,5,1
3386,46530,TBXYAxwexaNd47Tj9eT3p3QhXiwNSKj3,fbPkOYLVPtPgIt0MxizjfFJov3JbHyAi,1,0,0,0,0,0,1,0,1,0.14285714285714285,1,0.0,0,0,0,0,0,0,0,1,0,0,1,1
3387,46531,KbMG2R5hi7lV4ttClunSqF2UarKF8FNZ,fbPkOYLVPtPgIt0MxizjfFJov3JbHyAi,40,107,28,14,24,85,46,3,307,43.857142857142854,9,0.0,18,28,14,24,89,85,0,46,3,84,223,1
3388,46533,pRxI77wBFvTUHzDy8YsNcKJFbpdAZGNh,fbPkOYLVPtPgIt0MxizjfFJov3JbHyAi,15,9,5,0,4,3,7,1,29,4.142857142857143,2,0.0,0,5,0,4,9,3,0,7,1,9,20,1
3389,46534,KvCAdo1odeI84idtqyQZyVEKdaH6IDdM,fbPkOYLVPtPgIt0MxizjfFJov3JbHyAi,45,168,85,31,25,166,49,3,527,75.28571428571429,9,0.0,18,85,30,25,150,166,1,49,3,158,369,1
3390,46536,8HQsMOkKLewVMfte6VD2DYuU0urKWHXv,fbPkOYLVPtPgIt0MxizjfFJov3JbHyAi,14,40,15,4,12,9,22,1,103,14.714285714285714,6,0.0,13,15,4,12,27,9,0,22,1,44,59,0
3391,46540,25lc3om6HRn7SihjBlQbrBSLSUySLWnG,fbPkOYLVPtPgIt0MxizjfFJov3JbHyAi,7,3,2,0,2,0,2,0,9,1.2857142857142858,1,0.0,0,2,0,2,3,0,0,2,0,4,5,1
3392,46541,StTC3qGjYN4V41LymnTzXQRS0bQSlPrF,fbPkOYLVPtPgIt0MxizjfFJov3JbHyAi,7,4,2,0,2,0,2,0,10,1.4285714285714286,1,0.0,1,2,0,2,3,0,0,2,0,5,5,1
3393,46543,xBRGHAvkTfDDok4cH7N9aC7OMTMv6n3O,fbPkOYLVPtPgIt0MxizjfFJov3JbHyAi,7,5,4,0,3,0,4,0,16,2.2857142857142856,1,0.0,0,4,0,3,5,0,0,4,0,7,9,1
3394,46544,DAHT3MY5s8ge8Fy97bhkuUzIKyk1q8L2,fbPkOYLVPtPgIt0MxizjfFJov3JbHyAi,9,6,2,2,3,1,5,0,19,2.7142857142857144,1,0.0,3,2,2,3,3,1,0,5,0,10,9,1
3395,46547,GHqW2sFZULw6xLeFQhSQm5IW9wmBIZnH,fbPkOYLVPtPgIt0MxizjfFJov3JbHyAi,5,3,0,0,0,0,4,0,7,1.0,1,0.0,0,0,0,0,3,0,0,4,0,0,7,1
3396,46549,4ApVgPYGz6bz2SJLoGELpZ6RPnXwOa88,fbPkOYLVPtPgIt0MxizjfFJov3JbHyAi,61,188,83,56,49,41,38,0,455,65.0,16,0.0,67,83,46,49,121,41,10,38,0,245,210,0
3397,46550,F9UZi4Eyme7smBBGI6b8l0B0Zh1VRQUD,fbPkOYLVPtPgIt0MxizjfFJov3JbHyAi,10,6,3,0,2,1,13,1,26,3.7142857142857144,2,0.0,1,3,0,2,5,1,0,13,1,6,20,1
3398,46552,K3nS4VcLIzBgqPQsAsjEIOPChH8gvdgH,fbPkOYLVPtPgIt0MxizjfFJov3JbHyAi,8,2,1,0,1,2,8,1,15,2.142857142857143,1,0.0,0,1,0,1,2,2,0,8,1,2,13,1
3399,46555,QPiUGBr4vUjXTmo4VUV66g7hHPK0zcgj,fbPkOYLVPtPgIt0MxizjfFJov3JbHyAi,7,3,1,0,2,0,2,0,8,1.1428571428571428,1,0.0,0,1,0,2,3,0,0,2,0,3,5,1
3400,46556,VnuUyTHNwHr2LPEpDCNFEvbJ7YyA2Dtr,fbPkOYLVPtPgIt0MxizjfFJov3JbHyAi,7,2,1,0,1,0,6,1,11,1.5714285714285714,1,0.0,0,1,0,1,2,0,0,6,1,2,9,1
3401,46557,uoS96wNFUwtq7HfaPY02QxMEsIwJzjv6,fbPkOYLVPtPgIt0MxizjfFJov3JbHyAi,12,34,2,0,2,7,5,0,50,7.142857142857143,4,0.0,2,2,0,2,32,7,0,5,0,6,44,1
3402,46558,wgVuc0GdXqkgwRE7sGVxY1lchlcFK9wg,fbPkOYLVPtPgIt0MxizjfFJov3JbHyAi,3,0,0,0,0,0,5,0,5,0.7142857142857143,1,0.0,0,0,0,0,0,0,0,5,0,0,5,1
3403,46559,jl7dXdzz09XmO4Xe8w2lkGI7U7DzbG09,fbPkOYLVPtPgIt0MxizjfFJov3JbHyAi,8,6,4,0,3,0,3,0,16,2.2857142857142856,1,0.0,0,4,0,3,6,0,0,3,0,7,9,1
3404,46560,9giAVCaBxbNk2UdLbnYeVpzaUfG3nD03,fbPkOYLVPtPgIt0MxizjfFJov3JbHyAi,23,42,16,19,12,4,21,1,115,16.428571428571427,2,0.0,16,16,14,12,26,4,5,21,1,58,57,1
3405,46561,7ZyJguBzL4oDvx3QuauBv2Vv3pHBPVh3,fbPkOYLVPtPgIt0MxizjfFJov3JbHyAi,9,8,5,0,5,0,2,0,20,2.857142857142857,1,0.0,0,5,0,5,8,0,0,2,0,10,10,1
3406,46562,rCajReBu2KQJPlVlrrQZIZvrYAp8h9Yy,fbPkOYLVPtPgIt0MxizjfFJov3JbHyAi,2,0,0,0,0,0,3,0,3,0.42857142857142855,2,0.0,0,0,0,0,0,0,0,3,0,0,3,1
3407,46564,W7FXzdnq9Ktue5ZNM3TQmIP7HktmL3kC,fbPkOYLVPtPgIt0MxizjfFJov3JbHyAi,1,0,0,0,0,0,1,0,1,0.14285714285714285,1,0.0,0,0,0,0,0,0,0,1,0,0,1,1
3408,46565,wFCoKk3O7Yg710logPyDwMV7EivrZQCR,fbPkOYLVPtPgIt0MxizjfFJov3JbHyAi,1,0,0,0,0,0,1,0,1,0.14285714285714285,1,0.0,0,0,0,0,0,0,0,1,0,0,1,1
3409,46566,jFdhdjmfzOKKtloREabrCYP6a5dr6kJ3,fbPkOYLVPtPgIt0MxizjfFJov3JbHyAi,10,5,2,0,3,1,13,1,25,3.5714285714285716,1,0.0,2,2,0,3,3,1,0,13,1,7,18,1
3410,46567,UPecCjx5RBL6BceSov5rJLAaDoiPXUhg,fbPkOYLVPtPgIt0MxizjfFJov3JbHyAi,9,7,4,0,2,0,14,1,28,4.0,4,0.0,0,4,0,2,7,0,0,14,1,6,22,1
3411,46568,a9pvo8cVBjTHxQYvCPfHB4tPGRdFjAui,fbPkOYLVPtPgIt0MxizjfFJov3JbHyAi,13,8,5,0,4,2,13,1,33,4.714285714285714,1,0.0,0,5,0,4,8,2,0,13,1,9,24,1
3412,46569,EvnDUDuRuksYPdrCaUQQweT0GY5Najoh,fbPkOYLVPtPgIt0MxizjfFJov3JbHyAi,5,2,1,0,1,0,2,0,6,0.8571428571428571,1,0.0,0,1,0,1,2,0,0,2,0,2,4,1
3413,46570,1w8EW76qmBSgQ2s8Jb4yoPsNX01KUcoD,fbPkOYLVPtPgIt0MxizjfFJov3JbHyAi,10,3,2,0,2,1,7,1,16,2.2857142857142856,1,0.0,0,2,0,2,3,1,0,7,1,4,12,1
3414,46571,ZKAk08L8Iriz8Uv5UOeqSbrNnzg1rlMz,fbPkOYLVPtPgIt0MxizjfFJov3JbHyAi,9,9,6,0,4,0,12,0,31,4.428571428571429,2,0.0,1,6,0,4,8,0,0,12,0,11,20,1
3415,46573,IvhEQ40qNYap5nunxQhwiW2fnAok3TLS,fbPkOYLVPtPgIt0MxizjfFJov3JbHyAi,9,5,3,0,2,31,6,1,48,6.857142857142857,2,0.0,0,3,0,2,5,31,0,6,1,5,43,0
3416,46574,mZc1V3rQTRH4oqK1zqSjimuZcPwomnsE,fbPkOYLVPtPgIt0MxizjfFJov3JbHyAi,5,7,4,0,0,14,2,0,27,3.857142857142857,1,0.0,2,4,0,0,5,14,0,2,0,6,21,1
3417,46576,a8wX3Bl3kW6KFXwHZ6A5CPXKLBX1p4MZ,fbPkOYLVPtPgIt0MxizjfFJov3JbHyAi,2,0,0,0,0,0,3,0,3,0.42857142857142855,1,0.0,0,0,0,0,0,0,0,3,0,0,3,1
3418,46577,Edq6Echk8wEs8ShX5RBw5c8Yx8ANHVje,fbPkOYLVPtPgIt0MxizjfFJov3JbHyAi,1,0,0,0,0,0,1,0,1,0.14285714285714285,1,0.0,0,0,0,0,0,0,0,1,0,0,1,1
3419,46578,xpD8zL0kPAHItDUStTwEIkWWrm8dDFmA,fbPkOYLVPtPgIt0MxizjfFJov3JbHyAi,10,6,3,0,2,3,5,1,20,2.857142857142857,1,0.0,0,3,0,2,6,3,0,5,1,5,15,1
3420,46579,LWBASHvZlE9V0DOIMqscGs93ncFzXARw,fbPkOYLVPtPgIt0MxizjfFJov3JbHyAi,8,9,4,0,3,0,3,0,19,2.7142857142857144,1,0.0,2,4,0,3,7,0,0,3,0,9,10,1
3421,46580,sn1OZIzg3ZOiyRClBvvQLUKwx6tymOkC,fbPkOYLVPtPgIt0MxizjfFJov3JbHyAi,29,34,16,12,17,0,7,2,88,12.571428571428571,2,0.0,16,16,11,17,18,0,1,7,2,60,28,1
3422,46581,sw536JzryZ42F137fkltWvrIc3QLRo3o,fbPkOYLVPtPgIt0MxizjfFJov3JbHyAi,8,3,2,0,0,1,6,1,13,1.8571428571428572,1,0.0,0,2,0,0,3,1,0,6,1,2,11,1
3423,46582,Ikjjxpfg5ascMIjhTuGW8BkxPihDwWmv,fbPkOYLVPtPgIt0MxizjfFJov3JbHyAi,32,41,20,15,17,2,5,0,100,14.285714285714286,2,0.0,13,20,12,17,28,2,3,5,0,62,38,1
3424,46585,1fz7RS94t8nuoMroWFq8B06N4IWtq90I,fbPkOYLVPtPgIt0MxizjfFJov3JbHyAi,2,0,0,0,0,0,2,0,2,0.2857142857142857,1,0.0,0,0,0,0,0,0,0,2,0,0,2,1
3425,46587,lDJqver3AFFUyXISNdqvZpmq6OeWVl0r,fbPkOYLVPtPgIt0MxizjfFJov3JbHyAi,10,9,4,2,3,0,2,0,20,2.857142857142857,2,0.0,2,4,2,3,7,0,0,2,0,11,9,1
3426,46588,yfppFvC7mTSlPuhod9GGDRPkzP1HmCAu,fbPkOYLVPtPgIt0MxizjfFJov3JbHyAi,48,65,28,29,22,0,14,0,158,22.571428571428573,7,0.0,20,28,24,22,45,0,5,14,0,94,64,1
3427,46589,Q8UiR0g4rvfffexhCwFYjhzrBs6RScJA,fbPkOYLVPtPgIt0MxizjfFJov3JbHyAi,8,4,3,0,2,8,6,0,23,3.2857142857142856,1,0.0,0,3,0,2,4,8,0,6,0,5,18,1
3428,46590,DeMkq0IaxnRQrXCQHQpz60sFvrsX1jLn,fbPkOYLVPtPgIt0MxizjfFJov3JbHyAi,15,10,6,0,6,13,11,1,47,6.714285714285714,1,0.0,2,6,0,6,8,13,0,11,1,14,33,1
3429,46593,xanxsjSeaVNFCeWQJAicKck5SsVFdK55,fbPkOYLVPtPgIt0MxizjfFJov3JbHyAi,13,6,5,0,5,0,3,0,19,2.7142857142857144,1,0.0,0,5,0,5,6,0,0,3,0,10,9,1
3430,47680,5j9EQkqR4CZfRV8sku9HLld3NnlBiUj6,7GRhBDsirIGkRZBtSMEzNTyDr2JQm4xx,33,50,3,38,9,0,6,0,106,15.142857142857142,2,0.0,32,3,30,9,18,0,8,6,0,74,32,1
3431,47709,gSg4PIaWl0hBhOgVlpN9o8YrQn4pTOeq,7GRhBDsirIGkRZBtSMEzNTyDr2JQm4xx,2,0,0,0,0,0,3,0,3,0.42857142857142855,1,0.0,0,0,0,0,0,0,0,3,0,0,3,1
3432,47725,yO35UgaD8utoCb4qpLRXsAlxVi0i8Hs2,7GRhBDsirIGkRZBtSMEzNTyDr2JQm4xx,24,35,6,12,9,2,9,1,74,10.571428571428571,1,0.0,16,6,7,9,19,2,5,9,1,38,36,1
3433,47739,GpxTNWiiHORZrtpaNpqPl31grEf03aBZ,7GRhBDsirIGkRZBtSMEzNTyDr2JQm4xx,2,0,0,0,0,0,2,0,2,0.2857142857142857,1,0.0,0,0,0,0,0,0,0,2,0,0,2,1
3434,47743,iiuR3N6D1WRXLO09fb3Myc2MlNCCDfce,fbPkOYLVPtPgIt0MxizjfFJov3JbHyAi,4,3,0,0,0,0,2,0,5,0.7142857142857143,1,0.0,0,0,0,0,3,0,0,2,0,0,5,1
3435,47744,vCEQKCbjX310wPLqLwTGRr7i4Nhg0wTp,fbPkOYLVPtPgIt0MxizjfFJov3JbHyAi,10,8,4,0,3,2,5,0,22,3.142857142857143,1,0.0,0,4,0,3,8,2,0,5,0,7,15,1
3436,47745,gHBHYv37TuKpRs5kVViSUWhCV5Lhiblh,fbPkOYLVPtPgIt0MxizjfFJov3JbHyAi,7,3,2,0,2,0,2,0,9,1.2857142857142858,1,0.0,0,2,0,2,3,0,0,2,0,4,5,1
3437,47746,8ZsblV6culyKvM3swAGhgvHIR3alJq9n,fbPkOYLVPtPgIt0MxizjfFJov3JbHyAi,6,4,2,0,1,4,2,0,13,1.8571428571428572,2,0.0,0,2,0,1,4,4,0,2,0,3,10,1
3438,47747,FmNtF0dqiST5GypmKkWanKtXqnTegJEy,fbPkOYLVPtPgIt0MxizjfFJov3JbHyAi,1,0,0,0,0,0,1,0,1,0.14285714285714285,1,0.0,0,0,0,0,0,0,0,1,0,0,1,1
3439,47749,kkpDZ77gSlUQ6KcLobLV9NQm1XnSLEFr,fbPkOYLVPtPgIt0MxizjfFJov3JbHyAi,1,0,0,0,0,0,1,0,1,0.14285714285714285,1,0.0,0,0,0,0,0,0,0,1,0,0,1,1
3440,47751,cNndd5chSMU3sSAeRXd6PJHkgPmrCB8z,fbPkOYLVPtPgIt0MxizjfFJov3JbHyAi,7,2,1,0,1,1,4,2,11,1.5714285714285714,1,0.0,0,1,0,1,2,1,0,4,2,2,9,1
3441,47754,Pp9LbsXIl32Hj8Wq17Qd9kc6BTy8YAGl,fbPkOYLVPtPgIt0MxizjfFJov3JbHyAi,8,2,1,0,1,0,6,1,11,1.5714285714285714,1,0.0,0,1,0,1,2,0,0,6,1,2,9,1
3442,47755,lz6lDEfdau9dm3sqop0RmJjc1H5uyps1,fbPkOYLVPtPgIt0MxizjfFJov3JbHyAi,8,2,2,0,2,0,3,0,9,1.2857142857142858,1,0.0,0,2,0,2,2,0,0,3,0,4,5,1
3443,47756,L0FSy0eDJB0vLjpSsrNVX0T1aJD3NXFR,fbPkOYLVPtPgIt0MxizjfFJov3JbHyAi,15,29,11,12,10,4,19,0,85,12.142857142857142,2,0.0,12,11,9,10,17,4,3,19,0,42,43,1
3444,47757,AVyLSaof0VtZQR2ODvUxATLv8wovFv6r,fbPkOYLVPtPgIt0MxizjfFJov3JbHyAi,5,1,1,0,1,0,5,0,8,1.1428571428571428,1,0.0,0,1,0,1,1,0,0,5,0,2,6,1
3445,47759,ihajxoAz8rtCLZp3NhTz4Dj4wyy7Ve6j,fbPkOYLVPtPgIt0MxizjfFJov3JbHyAi,16,26,13,13,12,5,11,3,83,11.857142857142858,2,0.0,9,13,9,12,17,5,4,11,3,43,40,1
3446,47761,wzqDZnt5ey5srxRDV6DOODvuoPbW2hmC,fbPkOYLVPtPgIt0MxizjfFJov3JbHyAi,3,0,0,0,0,0,3,0,3,0.42857142857142855,1,0.0,0,0,0,0,0,0,0,3,0,0,3,1
3447,47762,zcIKJMENggqIW9hSdKBxNE0nRwFUSouz,fbPkOYLVPtPgIt0MxizjfFJov3JbHyAi,7,5,2,0,2,0,2,0,11,1.5714285714285714,1,0.0,2,2,0,2,3,0,0,2,0,6,5,1
3448,47763,JVoHWX6804dBiuuywxHjLhyoqtZIkCFx,fbPkOYLVPtPgIt0MxizjfFJov3JbHyAi,1,0,0,0,0,0,1,0,1,0.14285714285714285,1,0.0,0,0,0,0,0,0,0,1,0,0,1,1
3449,47765,ri6NVluQbSKckezFilIjxRHtq5swKp7U,fbPkOYLVPtPgIt0MxizjfFJov3JbHyAi,7,4,3,0,2,2,1,0,12,1.7142857142857142,1,0.0,0,3,0,2,4,2,0,1,0,5,7,1
3450,47766,ag9HLImVQiPyL9rK7r26gIINFvgysNlx,fbPkOYLVPtPgIt0MxizjfFJov3JbHyAi,10,7,5,0,4,0,5,0,21,3.0,1,0.0,0,5,0,4,7,0,0,5,0,9,12,0
3451,47767,Y54KD3ZA4LZs5ByE3QveGSSA4lLE8N3J,fbPkOYLVPtPgIt0MxizjfFJov3JbHyAi,6,3,2,0,2,0,1,0,8,1.1428571428571428,1,0.0,0,2,0,2,3,0,0,1,0,4,4,1
3452,47768,Yjq3LhAjOWvN82KjjED7khdom1HyBA50,fbPkOYLVPtPgIt0MxizjfFJov3JbHyAi,4,2,1,0,0,0,2,0,5,0.7142857142857143,1,0.0,0,1,0,0,2,0,0,2,0,1,4,1
3453,47769,37QXIA2mA5HwR196s7DdMurvu7yccsaS,fbPkOYLVPtPgIt0MxizjfFJov3JbHyAi,5,2,1,0,1,0,4,0,8,1.1428571428571428,1,0.0,0,1,0,1,2,0,0,4,0,2,6,1
3454,47771,WEqUhplW7x1SpLabVjNcI5M4HsCYjumg,fbPkOYLVPtPgIt0MxizjfFJov3JbHyAi,7,3,2,0,2,0,2,0,9,1.2857142857142858,1,0.0,0,2,0,2,3,0,0,2,0,4,5,1
3455,47773,rPoI3YNCiMsaBvpMVe9YNNLovGBjXQL1,fbPkOYLVPtPgIt0MxizjfFJov3JbHyAi,5,2,1,0,1,0,2,0,6,0.8571428571428571,1,0.0,0,1,0,1,2,0,0,2,0,2,4,1
3456,47774,38RAlLJIctL7kclCvMfQ1cdfefa6tncU,fbPkOYLVPtPgIt0MxizjfFJov3JbHyAi,7,4,2,0,2,0,4,0,12,1.7142857142857142,1,0.0,0,2,0,2,4,0,0,4,0,4,8,1
3457,47775,NbFjLBlaokvKCRfsLwofmB9VjZfUQeXG,fbPkOYLVPtPgIt0MxizjfFJov3JbHyAi,6,6,4,0,4,0,2,0,16,2.2857142857142856,1,0.0,0,4,0,4,6,0,0,2,0,8,8,1
3458,47778,tF7Aut7t0G2GWI4HCraCbVOE9W7RdLCy,fbPkOYLVPtPgIt0MxizjfFJov3JbHyAi,2,0,0,0,0,0,6,0,6,0.8571428571428571,1,0.0,0,0,0,0,0,0,0,6,0,0,6,1
3459,47781,JelJmDAgdvYMwysu2S8khlhEiSoRMDm3,fbPkOYLVPtPgIt0MxizjfFJov3JbHyAi,43,61,28,30,21,20,13,0,173,24.714285714285715,4,0.0,29,28,29,21,32,20,1,13,0,107,66,0
3460,47782,TGulLRA4GuGoMcQ4GcDFWeudMqmFclIY,fbPkOYLVPtPgIt0MxizjfFJov3JbHyAi,4,2,1,0,1,0,1,0,5,0.7142857142857143,1,0.0,0,1,0,1,2,0,0,1,0,2,3,1
3461,47784,o9yvVrDdqWbWhDTxptqPNzcJYAQzSgqs,fbPkOYLVPtPgIt0MxizjfFJov3JbHyAi,7,5,2,0,3,1,5,0,16,2.2857142857142856,1,0.0,2,2,0,3,3,1,0,5,0,7,9,1
3462,47785,hIwxGIao0auqtzgWn2kttNbjIiHkmA5D,fbPkOYLVPtPgIt0MxizjfFJov3JbHyAi,5,2,1,0,1,0,2,0,6,0.8571428571428571,1,0.0,0,1,0,1,2,0,0,2,0,2,4,1
3463,47786,9BOxWH9bnbnBFLyov7eyKil4OAMIu6r8,fbPkOYLVPtPgIt0MxizjfFJov3JbHyAi,1,0,0,0,0,0,4,0,4,0.5714285714285714,1,0.0,0,0,0,0,0,0,0,4,0,0,4,1
3464,47788,ZQSZgZ79Y2BI2kLu43mIPc6ox1OLMn3i,fbPkOYLVPtPgIt0MxizjfFJov3JbHyAi,9,4,3,0,2,0,7,0,16,2.2857142857142856,2,0.0,0,3,0,2,4,0,0,7,0,5,11,1
3465,47791,Hw8jmGp4VI4tAz6cfKhHDOeLB2t7MJ9z,fbPkOYLVPtPgIt0MxizjfFJov3JbHyAi,8,12,7,0,4,21,3,0,47,6.714285714285714,3,0.0,0,7,0,4,12,21,0,3,0,11,36,1
3466,47792,D6PbpNnbT91V2mO50Yo6lGeWMgk4tx0G,fbPkOYLVPtPgIt0MxizjfFJov3JbHyAi,8,9,6,0,2,5,2,0,24,3.4285714285714284,1,0.0,0,6,0,2,9,5,0,2,0,8,16,1
3467,47795,Ve7ldJJUZUHFSKTyCbiFRbXYpCfgkMe0,fbPkOYLVPtPgIt0MxizjfFJov3JbHyAi,5,3,2,0,1,0,2,0,8,1.1428571428571428,1,0.0,0,2,0,1,3,0,0,2,0,3,5,1
3468,47796,To4tY3l3Iwdy23bNNN8VbGmgVWF3Gp06,fbPkOYLVPtPgIt0MxizjfFJov3JbHyAi,11,7,3,7,4,0,3,0,24,3.4285714285714284,1,0.0,3,3,5,4,4,0,2,3,0,15,9,1
3469,47797,tHjeVI3fd22SmNtfBSk3NBb4XLGkojbV,fbPkOYLVPtPgIt0MxizjfFJov3JbHyAi,1,0,0,0,0,0,1,0,1,0.14285714285714285,1,0.0,0,0,0,0,0,0,0,1,0,0,1,1
3470,47798,ZobeGMKyIBgjnUNms43CrtMrVHf6iI1r,fbPkOYLVPtPgIt0MxizjfFJov3JbHyAi,8,7,4,0,2,0,5,0,18,2.5714285714285716,2,0.0,0,4,0,2,7,0,0,5,0,6,12,1
3471,47799,Iwfu4an5Skhugcqyo5SceYhoFf90uJBX,fbPkOYLVPtPgIt0MxizjfFJov3JbHyAi,9,5,2,0,2,3,5,1,18,2.5714285714285716,1,0.0,0,2,0,2,5,3,0,5,1,4,14,1
3472,47800,4TT2g7nLcTVtuILlZdgBu9rrz9KLLOMk,fbPkOYLVPtPgIt0MxizjfFJov3JbHyAi,6,8,2,0,3,0,6,0,19,2.7142857142857144,1,0.0,5,2,0,3,3,0,0,6,0,10,9,1
3473,47801,PmMFkd1Rzxa3QPI5maWIgc4heZgC88AX,fbPkOYLVPtPgIt0MxizjfFJov3JbHyAi,7,3,2,0,2,0,2,0,9,1.2857142857142858,1,0.0,0,2,0,2,3,0,0,2,0,4,5,1
3474,47803,93FWPuXY2azQQwZQWS80tdORRpOo60jj,fbPkOYLVPtPgIt0MxizjfFJov3JbHyAi,16,25,15,0,11,10,6,0,67,9.571428571428571,4,0.0,3,15,0,11,22,10,0,6,0,29,38,1
3475,47804,ZcgzdyII0xKmmApyb1MgVZBfYdWiemwd,fbPkOYLVPtPgIt0MxizjfFJov3JbHyAi,7,3,2,0,2,0,3,0,10,1.4285714285714286,2,0.0,0,2,0,2,3,0,0,3,0,4,6,1
3476,47807,JQWlZ9S0smBFDMGfgqcpt4ewgfL5yur6,fbPkOYLVPtPgIt0MxizjfFJov3JbHyAi,10,9,5,0,2,1,6,0,23,3.2857142857142856,2,0.0,1,5,0,2,8,1,0,6,0,8,15,1
3477,47808,FYmdcExkLD3hobz533EUh65L31LUqQ1Y,fbPkOYLVPtPgIt0MxizjfFJov3JbHyAi,2,0,0,0,0,0,3,0,3,0.42857142857142855,1,0.0,0,0,0,0,0,0,0,3,0,0,3,1
3478,47811,eIW9M0Trkt0EiuTzN2HuEtF6QnUOm4E9,fbPkOYLVPtPgIt0MxizjfFJov3JbHyAi,16,24,14,7,10,0,5,0,60,8.571428571428571,2,0.0,7,14,7,10,17,0,0,5,0,38,22,1
3479,47813,pzBdNMI6l60tGyYDZDsD8a3IbqJH27O8,fbPkOYLVPtPgIt0MxizjfFJov3JbHyAi,34,59,11,11,6,6,22,1,116,16.571428571428573,11,0.0,7,11,10,6,52,6,1,22,1,34,82,0
3480,47814,1gTDkM1DmoNiWAXMcO7Ry3TBKifByJrA,fbPkOYLVPtPgIt0MxizjfFJov3JbHyAi,5,3,2,0,0,0,2,0,7,1.0,1,0.0,0,2,0,0,3,0,0,2,0,2,5,1
3481,47815,R32OpsvoWT0fJOVOqVFkJPGA6xEYJoku,fbPkOYLVPtPgIt0MxizjfFJov3JbHyAi,5,0,0,0,0,2,5,1,8,1.1428571428571428,1,0.0,0,0,0,0,0,2,0,5,1,0,8,1
3482,47819,JSeJszCXASTiAymchwd8Mbxb0d9xvaME,fbPkOYLVPtPgIt0MxizjfFJov3JbHyAi,4,2,1,0,1,0,1,0,5,0.7142857142857143,1,0.0,0,1,0,1,2,0,0,1,0,2,3,1
3483,47821,GYAhe7QkBFzfyQOufZzJyKbMW1Ol7QR2,fbPkOYLVPtPgIt0MxizjfFJov3JbHyAi,1,0,0,0,0,0,1,0,1,0.14285714285714285,1,0.0,0,0,0,0,0,0,0,1,0,0,1,1
3484,47823,9uK9gXYJyTZNtNSUCINqfEFUfFE2z8C1,fbPkOYLVPtPgIt0MxizjfFJov3JbHyAi,2,0,0,0,0,0,2,0,2,0.2857142857142857,1,0.0,0,0,0,0,0,0,0,2,0,0,2,1
3485,47825,FosOn7Nym18de58uciRhhONZG69DSOHR,fbPkOYLVPtPgIt0MxizjfFJov3JbHyAi,1,0,0,0,0,0,1,0,1,0.14285714285714285,1,0.0,0,0,0,0,0,0,0,1,0,0,1,1
3486,47827,QXhJhqRI2RKlJx1bX2NHrvRhjNHoTmov,fbPkOYLVPtPgIt0MxizjfFJov3JbHyAi,7,5,3,0,2,0,2,0,12,1.7142857142857142,1,0.0,0,3,0,2,5,0,0,2,0,5,7,1
3487,47829,XHEZtfDZPcYKEJdadg7oTWoKvKH8Zuar,fbPkOYLVPtPgIt0MxizjfFJov3JbHyAi,2,0,0,0,0,0,2,0,2,0.2857142857142857,1,0.0,0,0,0,0,0,0,0,2,0,0,2,1
3488,47830,2yx2qSv17vABrVR2NSjoUhZ8khDHzM1p,fbPkOYLVPtPgIt0MxizjfFJov3JbHyAi,6,7,1,0,1,0,3,0,12,1.7142857142857142,2,0.0,0,1,0,1,7,0,0,3,0,2,10,1
3489,47831,YpdehTzQsSqz1ddMB0XGW2Y6lcmHTYFK,fbPkOYLVPtPgIt0MxizjfFJov3JbHyAi,6,4,2,0,0,0,4,0,10,1.4285714285714286,1,0.0,0,2,0,0,4,0,0,4,0,2,8,1
3490,47832,uzyKB6l5IMjDSYdYxLudAhgrFzD2VyDw,fbPkOYLVPtPgIt0MxizjfFJov3JbHyAi,8,6,4,0,3,1,4,0,18,2.5714285714285716,1,0.0,0,4,0,3,6,1,0,4,0,7,11,1
3491,47833,16veA4geT2xKUlqWBL48Fcqf8WTsVJtc,fbPkOYLVPtPgIt0MxizjfFJov3JbHyAi,1,0,0,0,0,0,1,0,1,0.14285714285714285,1,0.0,0,0,0,0,0,0,0,1,0,0,1,1
3492,47834,ONghHwhwAX2IyqpHHX698rW0VH9BRcsu,fbPkOYLVPtPgIt0MxizjfFJov3JbHyAi,7,4,2,0,3,0,3,0,12,1.7142857142857142,1,0.0,2,2,0,3,2,0,0,3,0,7,5,1
3493,47835,bPKFcVQkxVd0TAh9nUEtyZP7EFWzhnRn,fbPkOYLVPtPgIt0MxizjfFJov3JbHyAi,9,8,6,0,5,0,5,0,24,3.4285714285714284,1,0.0,0,6,0,5,8,0,0,5,0,11,13,1
3494,47836,SvayS3hRjiQUsZJZ3Z80XuRW7pnvNCGH,fbPkOYLVPtPgIt0MxizjfFJov3JbHyAi,28,72,32,10,19,9,15,1,158,22.571428571428573,3,0.0,22,32,9,19,50,9,1,15,1,82,76,1
3495,47837,pwbQ0rznhIurRxyuVQAFAxt3Zer8oDir,fbPkOYLVPtPgIt0MxizjfFJov3JbHyAi,4,3,2,0,2,0,3,0,10,1.4285714285714286,1,0.0,0,2,0,2,3,0,0,3,0,4,6,1
3496,47840,BNU2wGZhV5dmPLymeUzZGTZPF40H3QyF,fbPkOYLVPtPgIt0MxizjfFJov3JbHyAi,7,3,2,0,2,0,2,0,9,1.2857142857142858,1,0.0,0,2,0,2,3,0,0,2,0,4,5,1
3497,47841,HIbKGQJ8yDbPhmqDqsEHxHEydttgfsQA,fbPkOYLVPtPgIt0MxizjfFJov3JbHyAi,7,3,2,0,2,0,2,0,9,1.2857142857142858,1,0.0,0,2,0,2,3,0,0,2,0,4,5,1
3498,47842,oQIbxVPhPOzQp4tRk0swq8bc74m862Je,fbPkOYLVPtPgIt0MxizjfFJov3JbHyAi,6,13,1,0,1,0,3,0,18,2.5714285714285716,1,0.0,3,1,0,1,10,0,0,3,0,5,13,1
3499,47843,IZ5pWpBLzW50MjCCGxCjTz4w6DVz2MU3,fbPkOYLVPtPgIt0MxizjfFJov3JbHyAi,6,8,5,0,2,0,2,0,17,2.4285714285714284,2,0.0,0,5,0,2,8,0,0,2,0,7,10,1
3500,47844,P4gIdHzF607L8e8VPH3Qb09lxgNZRJFa,fbPkOYLVPtPgIt0MxizjfFJov3JbHyAi,12,29,17,0,16,3,10,0,75,10.714285714285714,5,0.0,7,17,0,16,22,3,0,10,0,40,35,1
3501,47845,QQOQ1mBFT0hbDG4vhxUnw8WQ7hq3XsN0,fbPkOYLVPtPgIt0MxizjfFJov3JbHyAi,8,5,3,0,2,0,3,0,13,1.8571428571428572,2,0.0,0,3,0,2,5,0,0,3,0,5,8,1
3502,47847,Bat1lO5dwlkuBIiIqyEjLCmla1w2SsRg,fbPkOYLVPtPgIt0MxizjfFJov3JbHyAi,1,0,0,0,0,0,1,0,1,0.14285714285714285,1,0.0,0,0,0,0,0,0,0,1,0,0,1,1
3503,47849,hjbzzLF0uZqUL22zLBiQhzq51chcw6mb,fbPkOYLVPtPgIt0MxizjfFJov3JbHyAi,18,19,11,5,8,6,5,0,54,7.714285714285714,1,0.0,6,11,4,8,13,6,1,5,0,29,25,1
3504,47851,kLsZKBC25zLVIospdIdcGhrxzfP125JG,fbPkOYLVPtPgIt0MxizjfFJov3JbHyAi,11,6,5,0,5,0,6,0,22,3.142857142857143,1,0.0,0,5,0,5,6,0,0,6,0,10,12,1
3505,47852,RfgbqJEazOp1Rb866WYVJPYz91jABFLG,fbPkOYLVPtPgIt0MxizjfFJov3JbHyAi,15,7,6,0,6,1,4,1,25,3.5714285714285716,1,0.0,0,6,0,6,7,1,0,4,1,12,13,1
3506,47854,gRdV8TKfYOuiXGGwKnVS8SiUiAxajq1L,fbPkOYLVPtPgIt0MxizjfFJov3JbHyAi,13,30,13,4,11,2,11,0,71,10.142857142857142,4,0.0,9,13,4,11,21,2,0,11,0,37,34,1
3507,47855,II1eOimMlUCajOv1GRuK8VabiA0lRWyy,fbPkOYLVPtPgIt0MxizjfFJov3JbHyAi,5,2,1,0,1,0,5,0,9,1.2857142857142858,1,0.0,0,1,0,1,2,0,0,5,0,2,7,1
3508,47856,82BkQjqJpTLnL5kDgBNneTIQ8dLAyaMt,fbPkOYLVPtPgIt0MxizjfFJov3JbHyAi,6,7,3,0,0,0,5,0,15,2.142857142857143,2,0.0,0,3,0,0,7,0,0,5,0,3,12,1
3509,47857,r7L6HOKA435eaor9jfOstdB35ZN19tsN,fbPkOYLVPtPgIt0MxizjfFJov3JbHyAi,5,4,3,0,3,0,2,0,12,1.7142857142857142,1,0.0,0,3,0,3,4,0,0,2,0,6,6,1
3510,47858,4uvFeDWIZ6bzoupIa1lCMrJxU4bo03vY,fbPkOYLVPtPgIt0MxizjfFJov3JbHyAi,21,25,10,13,12,1,5,1,67,9.571428571428571,2,0.0,13,10,10,12,12,1,3,5,1,45,22,1
3511,47859,HlsUiRcEZx95oGsZBkao06lPbfTneh9d,fbPkOYLVPtPgIt0MxizjfFJov3JbHyAi,1,0,0,0,0,0,1,0,1,0.14285714285714285,1,0.0,0,0,0,0,0,0,0,1,0,0,1,1
3512,47860,3Fj747AfeK8Iy9OuiJhJRPDmQRCh2lEF,fbPkOYLVPtPgIt0MxizjfFJov3JbHyAi,7,11,6,0,6,1,2,0,26,3.7142857142857144,2,0.0,2,6,0,6,9,1,0,2,0,14,12,1
3513,47899,7x6GR5vcpLicOQJjWWlyJk5P5JNLZFuv,RXDvfPUBYFlVdlueBFbLW0mhhAyGEqpt,3,0,0,0,0,0,2,3,5,0.7142857142857143,1,0.0,0,0,0,0,0,0,0,2,3,0,5,1
3514,47903,H938uEDZMr5x6mZr5R8OyAsB16zTacVQ,SpATywNh6bZuzm8s1ceuBUnMUAeoAHHw,14,14,1,12,0,0,2,0,29,4.142857142857143,1,0.0,2,1,11,0,12,0,1,2,0,14,15,1
3515,47931,ExNrdfeKsdYl3xmpiJlCBa13JPKyssuX,A3fsA9Zfv1X2fVEQhTw51lKENdNrEqT3,24,63,4,0,3,29,28,1,128,18.285714285714285,8,0.0,0,4,0,3,63,29,0,28,1,7,121,0
3516,47944,6u4AKdJzjLLZR1AtlnLDuMzDbZ4kM1Iv,bWdj2GDclj5ofokWjzoa5jAwMkxCykd6,11,14,8,0,7,4,5,0,38,5.428571428571429,2,0.0,2,8,0,7,12,4,0,5,0,17,21,1
3517,47949,9A7NeA8CSGMqqHgIDjiMNeFZF78KMRT6,bWdj2GDclj5ofokWjzoa5jAwMkxCykd6,8,5,1,0,0,1,7,2,16,2.2857142857142856,1,0.0,0,1,0,0,5,1,0,7,2,1,15,0
3518,47955,WCBxImuXCQhe4JCGgmUbhM2fHJqNW9fo,bWdj2GDclj5ofokWjzoa5jAwMkxCykd6,15,17,8,0,43,0,3,0,71,10.142857142857142,2,0.0,1,8,0,43,16,0,0,3,0,52,19,1
3519,47959,grSdEhkb3V38lf9YQcXO8O3GBe0inhXx,SpATywNh6bZuzm8s1ceuBUnMUAeoAHHw,22,57,0,17,0,2,12,0,88,12.571428571428571,4,0.0,14,0,17,0,43,2,0,12,0,31,57,0
3520,47976,HhK8Fr5pAwm4jm0sdGfJEGDMiAvZjcpI,bWdj2GDclj5ofokWjzoa5jAwMkxCykd6,9,13,8,0,3,0,7,0,31,4.428571428571429,3,0.0,0,8,0,3,13,0,0,7,0,11,20,1
3521,47983,nC6UOgoIicf8pr79f2rdG7NgUQiopW9Q,A3fsA9Zfv1X2fVEQhTw51lKENdNrEqT3,4,2,1,0,1,0,1,0,5,0.7142857142857143,1,0.0,0,1,0,1,2,0,0,1,0,2,3,0
3522,47984,nC6UOgoIicf8pr79f2rdG7NgUQiopW9Q,bWdj2GDclj5ofokWjzoa5jAwMkxCykd6,6,11,7,0,3,2,2,0,25,3.5714285714285716,2,0.0,0,7,0,3,11,2,0,2,0,10,15,0
3523,47991,w37wSK655FONLskeVHZ1T8H2i8llhkAq,SpATywNh6bZuzm8s1ceuBUnMUAeoAHHw,16,36,4,15,2,0,7,0,64,9.142857142857142,3,0.0,8,4,13,2,28,0,2,7,0,27,37,1
3524,47995,UjOHFBm02iem7rlbuAJcfFkUj4JVBikN,RXDvfPUBYFlVdlueBFbLW0mhhAyGEqpt,39,50,3,71,4,8,17,2,155,22.142857142857142,3,0.0,14,3,68,4,36,8,3,17,2,89,66,0
3525,48006,PihBsIILx8UWSnCui7TqzlKGzY1fk9nJ,RXDvfPUBYFlVdlueBFbLW0mhhAyGEqpt,18,13,8,0,4,0,6,2,33,4.714285714285714,1,0.0,1,8,0,4,12,0,0,6,2,13,20,1
3526,48035,DX4dLCDX6l0Z68Mym7vcnKV6tMlkufOW,RXDvfPUBYFlVdlueBFbLW0mhhAyGEqpt,23,25,14,18,7,1,5,0,70,10.0,1,0.0,7,14,17,7,18,1,1,5,0,45,25,1
3527,48037,tK5QWvLAN98DDvHjcCO96Vrig3bCPcrd,RXDvfPUBYFlVdlueBFbLW0mhhAyGEqpt,65,164,8,232,25,19,23,3,474,67.71428571428571,4,0.0,60,8,198,25,104,19,34,23,3,291,183,0
3528,48061,LUgTh6GVAZUuu6P6ClIsXLbxeQUErBSM,SpATywNh6bZuzm8s1ceuBUnMUAeoAHHw,6,6,1,0,1,0,2,0,10,1.4285714285714286,1,0.0,0,1,0,1,6,0,0,2,0,2,8,1
3529,48066,waLyzusenGGt78OBjbfLuixQktneXMVQ,SpATywNh6bZuzm8s1ceuBUnMUAeoAHHw,23,49,1,34,1,21,14,2,122,17.428571428571427,2,0.0,22,1,27,1,27,21,7,14,2,51,71,0
3530,48069,S0OJjF6aof0iTnIX6lUAxekoH3m4w7V0,A3fsA9Zfv1X2fVEQhTw51lKENdNrEqT3,92,66,39,210,13,34,29,2,393,56.142857142857146,9,0.0,6,39,173,13,60,34,37,29,2,231,162,0
3531,48082,s13Zj70iGaPJV2HiUyzOXf2g6dcMZpb3,RXDvfPUBYFlVdlueBFbLW0mhhAyGEqpt,49,62,25,46,17,37,9,0,196,28.0,3,0.0,13,25,46,17,49,37,0,9,0,101,95,0
3532,48088,jQM28yyQ4L2nHSWUJsgj6ijycvLum07J,bWdj2GDclj5ofokWjzoa5jAwMkxCykd6,11,8,6,0,2,0,7,1,24,3.4285714285714284,2,0.0,0,6,0,2,8,0,0,7,1,8,16,1
3533,48089,Yr9in8tqNPW6lzKPGBlYAXmDVewnbDn1,SpATywNh6bZuzm8s1ceuBUnMUAeoAHHw,21,14,9,6,7,12,4,0,52,7.428571428571429,1,0.0,4,9,5,7,10,12,1,4,0,25,27,0
3534,48092,TUbsPVDtB54KSPR2qHUpWUmDnVtGYqAT,SpATywNh6bZuzm8s1ceuBUnMUAeoAHHw,16,16,2,0,1,2,8,1,30,4.285714285714286,2,0.0,0,2,0,1,16,2,0,8,1,3,27,0
3535,48100,MEAK3CtWNpeCicplOKHcDUkHm4e2Gnat,A3fsA9Zfv1X2fVEQhTw51lKENdNrEqT3,31,19,16,68,9,0,5,0,117,16.714285714285715,2,0.0,0,16,55,9,19,0,13,5,0,80,37,0
3536,48118,9pydrkItOvXReb7xWe6yqdMpXhFzfa5K,SpATywNh6bZuzm8s1ceuBUnMUAeoAHHw,31,77,27,36,8,49,25,0,222,31.714285714285715,9,0.0,21,27,30,8,56,49,6,25,0,86,136,0
3537,48135,gtGDHRUZ7LgMlMOjWieE5uKSYCgIoTZ0,G8EPVSXsOYB5YQWZGiz1aVq5Pgr2GrQu,48,66,7,138,5,17,11,1,245,35.0,7,0.0,14,7,110,5,52,17,28,11,1,136,109,0
3538,48138,f3FFKNKPDIkY4ZzespQ1tkojfbmyOtUb,SpATywNh6bZuzm8s1ceuBUnMUAeoAHHw,30,117,40,31,19,137,68,7,419,59.857142857142854,12,0.0,18,40,28,19,99,137,3,68,7,105,314,0
3539,48139,6hXBi8QXIGsuTrfCDVW9WjrIWoxnhuCE,SpATywNh6bZuzm8s1ceuBUnMUAeoAHHw,1,0,0,0,0,0,1,0,1,0.14285714285714285,1,0.0,0,0,0,0,0,0,0,1,0,0,1,1
3540,48148,2zQQnqY1LiZ9lcEXTzcE3zimEdKe8CdV,SpATywNh6bZuzm8s1ceuBUnMUAeoAHHw,31,51,29,23,11,13,19,3,149,21.285714285714285,8,0.0,14,29,23,11,37,13,0,19,3,77,72,0
3541,48179,HCOgsqUBNFumf2cCspNzKWg9hTVzHRVA,SpATywNh6bZuzm8s1ceuBUnMUAeoAHHw,29,23,14,20,10,3,11,3,84,12.0,3,0.0,9,14,16,10,14,3,4,11,3,49,35,1
3542,48197,5KWnGsOw1ONkUhC7cQevc5FAKOxsvvUS,SpATywNh6bZuzm8s1ceuBUnMUAeoAHHw,15,21,4,14,2,0,8,0,49,7.0,3,0.0,7,4,13,2,14,0,1,8,0,26,23,1
3543,48215,PEmuWJA7a0s7F0V9aIB9k0qqsQOvzH5e,A3fsA9Zfv1X2fVEQhTw51lKENdNrEqT3,9,2,2,0,2,0,5,0,11,1.5714285714285714,1,0.0,0,2,0,2,2,0,0,5,0,4,7,1
3544,48218,VBP5PzVQEKJYFH0y5ffEek5WfP9EW7uc,A3fsA9Zfv1X2fVEQhTw51lKENdNrEqT3,16,26,16,0,4,2,22,2,72,10.285714285714286,9,0.0,0,16,0,4,26,2,0,22,2,20,52,1
3545,48221,eznmpA5TU6txEde6CJT70lkRbK5fBPvC,A3fsA9Zfv1X2fVEQhTw51lKENdNrEqT3,26,6,1,84,0,7,14,0,112,16.0,3,0.0,3,1,69,0,3,7,15,14,0,73,39,0
3546,48223,GfRp1O86gI5zJJh8SIJ1bczUJPWlAqoK,SpATywNh6bZuzm8s1ceuBUnMUAeoAHHw,20,32,1,34,0,2,26,2,97,13.857142857142858,5,0.0,8,1,29,0,24,2,5,26,2,38,59,0
3547,48239,5dHhwSyX3MJPaRvMe9fCcvMfYGdzfWsb,SpATywNh6bZuzm8s1ceuBUnMUAeoAHHw,2,0,0,0,0,0,2,0,2,0.2857142857142857,1,0.0,0,0,0,0,0,0,0,2,0,0,2,1
3548,48255,gLAW4GOuyz8JKg5RO5Sf2rzir65isCiq,G8EPVSXsOYB5YQWZGiz1aVq5Pgr2GrQu,27,49,26,0,20,6,16,2,119,17.0,4,0.0,0,26,0,20,49,6,0,16,2,46,73,0
3549,48268,EhHrinjt1AkEWC09AFZwBuP61S5NJgjn,A3fsA9Zfv1X2fVEQhTw51lKENdNrEqT3,46,44,28,54,17,2,15,0,160,22.857142857142858,4,0.0,1,28,44,17,43,2,10,15,0,90,70,1
3550,48277,KJnvgR26H5LLeKdyvjJHjjqg4mjHEhgN,A3fsA9Zfv1X2fVEQhTw51lKENdNrEqT3,50,15,11,152,4,0,8,0,190,27.142857142857142,3,0.0,2,11,137,4,13,0,15,8,0,154,36,1
3551,48285,CQ3xdz8pT9zQNTAl7b68jJZVAWVF2aTL,SpATywNh6bZuzm8s1ceuBUnMUAeoAHHw,15,12,0,13,1,6,7,1,40,5.714285714285714,3,0.0,3,0,11,1,9,6,2,7,1,15,25,1
3552,48303,ibgC3AgPCiKxZzQtLwOtyIa6DJRV6K2p,SpATywNh6bZuzm8s1ceuBUnMUAeoAHHw,23,87,36,44,4,142,50,7,370,52.857142857142854,11,0.0,29,36,35,4,58,142,9,50,7,104,266,0
3553,48304,H5UEKpeYUS8ZwAU1o3ZTuTx8QVBIM5mj,SpATywNh6bZuzm8s1ceuBUnMUAeoAHHw,22,21,0,12,0,6,10,1,50,7.142857142857143,4,0.0,4,0,12,0,17,6,0,10,1,16,34,1
3554,48308,UqMl8IgLVIouo6TVWfUzDQbBX8JDKQrY,SpATywNh6bZuzm8s1ceuBUnMUAeoAHHw,18,17,11,0,8,1,4,0,41,5.857142857142857,2,0.0,2,11,0,8,15,1,0,4,0,21,20,1
3555,48343,KJnvgR26H5LLeKdyvjJHjjqg4mjHEhgN,bWdj2GDclj5ofokWjzoa5jAwMkxCykd6,50,71,32,230,28,56,36,1,454,64.85714285714286,6,0.0,32,32,209,28,39,56,21,36,1,301,153,0
3556,48353,kiVzCvDoEqSB7iO0TU3ERoanC9pEAYCs,A3fsA9Zfv1X2fVEQhTw51lKENdNrEqT3,2,0,0,0,0,0,4,0,4,0.5714285714285714,1,0.0,0,0,0,0,0,0,0,4,0,0,4,1
3557,48354,YUkia24kFQkJdU9Tc0bEfJWS5kFL3fnZ,SpATywNh6bZuzm8s1ceuBUnMUAeoAHHw,28,64,21,26,10,33,45,1,200,28.571428571428573,13,0.0,25,21,20,10,39,33,6,45,1,76,124,0
3558,48364,TMaAbfbbsUXbGWJIhu1feBQgRZO29am6,G8EPVSXsOYB5YQWZGiz1aVq5Pgr2GrQu,120,131,65,297,37,105,49,3,687,98.14285714285714,10,0.0,28,65,245,37,103,105,52,49,3,375,312,0
3559,48366,eQnxTOv5tF733HrH1v8IIfXTQQ20WB86,SpATywNh6bZuzm8s1ceuBUnMUAeoAHHw,23,21,13,12,6,6,33,1,92,13.142857142857142,9,0.0,4,13,12,6,17,6,0,33,1,35,57,0
3560,48410,fKzNFTbPePkMpMq31aLHMmVifATbrx2C,A3fsA9Zfv1X2fVEQhTw51lKENdNrEqT3,9,7,3,0,1,1,5,1,18,2.5714285714285716,3,0.0,0,3,0,1,7,1,0,5,1,4,14,1
3561,48450,oWaJx5przpU6lf15eldDAW9VD7f9UZbS,SpATywNh6bZuzm8s1ceuBUnMUAeoAHHw,31,26,16,12,8,34,15,3,114,16.285714285714285,3,0.0,5,16,12,8,21,34,0,15,3,41,73,0
3562,48466,zOGgv8cnkqEW7Y2l6fqZ3IzLqplNhsIx,SpATywNh6bZuzm8s1ceuBUnMUAeoAHHw,12,19,1,0,1,4,10,2,37,5.285714285714286,3,0.0,2,1,0,1,17,4,0,10,2,4,33,1
3563,48480,T2e7T1KVGbCZHkx82TLCiB6K2groJqnl,SpATywNh6bZuzm8s1ceuBUnMUAeoAHHw,23,49,1,35,0,26,15,1,127,18.142857142857142,2,0.0,19,1,31,0,30,26,4,15,1,51,76,1
3564,48498,VEdQQ1yOFNqPNBrecyFKsnw5QECT7x69,SpATywNh6bZuzm8s1ceuBUnMUAeoAHHw,6,6,1,0,1,0,3,0,11,1.5714285714285714,2,0.0,0,1,0,1,6,0,0,3,0,2,9,1
3565,48509,a41llItPMmO7jtwR6NH41lmydyfI26Gz,SpATywNh6bZuzm8s1ceuBUnMUAeoAHHw,23,62,2,36,2,17,14,3,136,19.428571428571427,3,0.0,30,2,30,2,32,17,6,14,3,64,72,0
3566,48515,NCU9xqLhC281ErH7IwNmupIJSyhaNMZW,SpATywNh6bZuzm8s1ceuBUnMUAeoAHHw,22,26,8,25,5,0,14,0,78,11.142857142857142,4,0.0,9,8,23,5,17,0,2,14,0,45,33,0
3567,48520,EBgUhfQ9Yh2Xchyg5A4RNjz8pUXCnWl0,SpATywNh6bZuzm8s1ceuBUnMUAeoAHHw,23,45,0,25,0,0,4,0,74,10.571428571428571,1,0.0,13,0,21,0,32,0,4,4,0,34,40,1
3568,48524,aYYkr3EBoQc6U0mONjplTV8V30x3QwMR,SpATywNh6bZuzm8s1ceuBUnMUAeoAHHw,20,92,27,47,5,23,55,4,253,36.142857142857146,6,0.0,20,27,40,5,72,23,7,55,4,92,161,0
3569,48557,CMxWacrlvHBos1yTh6CX0stfBtIQjdRZ,SpATywNh6bZuzm8s1ceuBUnMUAeoAHHw,11,15,4,13,2,4,1,0,39,5.571428571428571,1,0.0,8,4,12,2,7,4,1,1,0,26,13,0
3570,48572,RvDbqb1jf5bMQYeeBsAiuychmXlXMqZ3,SpATywNh6bZuzm8s1ceuBUnMUAeoAHHw,12,26,9,18,2,26,12,1,94,13.428571428571429,3,0.0,10,9,15,2,16,26,3,12,1,36,58,0
3571,48579,OmRwEqIcEcFH28h4LCCN9RZtwAWWiBmW,SpATywNh6bZuzm8s1ceuBUnMUAeoAHHw,11,53,1,8,0,0,6,0,68,9.714285714285714,3,0.0,0,1,7,0,53,0,1,6,0,8,60,1
3572,48580,PTsQJZyhlmM5FQqbiEkU0C6Xoz9Oth0N,RXDvfPUBYFlVdlueBFbLW0mhhAyGEqpt,4,2,0,0,0,0,2,0,4,0.5714285714285714,1,0.0,0,0,0,0,2,0,0,2,0,0,4,0
3573,48581,ZmRlQUxjzuIBTqGZ1TI9p3XDJluy6dCH,SpATywNh6bZuzm8s1ceuBUnMUAeoAHHw,26,37,27,11,15,20,8,0,118,16.857142857142858,3,0.0,0,27,10,15,37,20,1,8,0,52,66,0
3574,48590,Bm1ROY20Td8ahvL40ylWLEiakWpICc5q,SpATywNh6bZuzm8s1ceuBUnMUAeoAHHw,31,35,20,44,9,78,12,6,204,29.142857142857142,4,0.0,7,20,37,9,28,78,7,12,6,73,131,0
3575,48627,SRvotFFDI4c4Tqustgf1LZhg7uROitU6,SpATywNh6bZuzm8s1ceuBUnMUAeoAHHw,10,7,1,0,0,0,12,3,23,3.2857142857142856,1,0.0,0,1,0,0,7,0,0,12,3,1,22,1
3576,48629,1ERwpt9wMj2n5z0yrcDeOTKwiq17bpYL,SpATywNh6bZuzm8s1ceuBUnMUAeoAHHw,18,22,15,12,8,0,9,1,67,9.571428571428571,3,0.0,3,15,11,8,19,0,1,9,1,37,30,0
3577,48637,rhEIW0I6psA9HvuF18HCB0BDkVKeLeRv,SpATywNh6bZuzm8s1ceuBUnMUAeoAHHw,6,2,1,0,1,0,3,0,7,1.0,1,0.0,0,1,0,1,2,0,0,3,0,2,5,1
3578,48647,A5P9jrlzLqQKpA3sVBvwbPCf9CAYmtxw,SpATywNh6bZuzm8s1ceuBUnMUAeoAHHw,30,47,15,33,9,46,12,2,164,23.428571428571427,6,0.0,22,15,27,9,25,46,6,12,2,73,91,0
3579,48677,miskafWCgRGEerOwmFhGeXinZmiVq8Xq,SpATywNh6bZuzm8s1ceuBUnMUAeoAHHw,30,41,20,28,10,13,15,1,128,18.285714285714285,3,0.0,10,20,23,10,31,13,5,15,1,63,65,0
3580,48710,2wpbmqMFHp4amvfRnEjwZEJ5A6Okr1xC,G8EPVSXsOYB5YQWZGiz1aVq5Pgr2GrQu,6,3,1,0,1,0,2,0,7,1.0,1,0.0,0,1,0,1,3,0,0,2,0,2,5,1
3581,48718,5AugieBFEAlTT6fEoe5Ptq1jAvWA2bXj,SpATywNh6bZuzm8s1ceuBUnMUAeoAHHw,17,19,1,19,1,0,3,0,43,6.142857142857143,1,0.0,7,1,16,1,12,0,3,3,0,25,18,1
3582,48727,2XL6bjSwWRsdF2Id5N4HOR8GedxbL8Tj,SpATywNh6bZuzm8s1ceuBUnMUAeoAHHw,16,20,0,8,0,0,5,0,33,4.714285714285714,3,0.0,2,0,7,0,18,0,1,5,0,9,24,0
3583,48733,mitKAcO5Yq84LGwUL473CFioIDbwQfRi,SpATywNh6bZuzm8s1ceuBUnMUAeoAHHw,21,37,21,26,0,6,23,0,113,16.142857142857142,7,0.0,7,21,26,0,30,6,0,23,0,54,59,0
3584,48743,geHYnGH5sQ7aHnnwLKBvDRjabqJU8jWh,RXDvfPUBYFlVdlueBFbLW0mhhAyGEqpt,45,64,4,96,6,7,16,4,197,28.142857142857142,4,0.0,18,4,82,6,46,7,14,16,4,110,87,1
3585,48764,oWaJx5przpU6lf15eldDAW9VD7f9UZbS,RXDvfPUBYFlVdlueBFbLW0mhhAyGEqpt,72,84,51,91,25,63,18,5,337,48.142857142857146,4,0.0,18,51,90,25,66,63,1,18,5,184,153,0
3586,48766,xBzkSH4dgUCYZ5BDcyxU9YukAdw2snHB,RXDvfPUBYFlVdlueBFbLW0mhhAyGEqpt,5,2,1,0,1,0,2,0,6,0.8571428571428571,1,0.0,0,1,0,1,2,0,0,2,0,2,4,1
3587,48788,IN0xY05lGNY1Rxj5WWCYq1C0mF0lQ2fJ,SpATywNh6bZuzm8s1ceuBUnMUAeoAHHw,32,59,14,24,7,32,18,2,156,22.285714285714285,3,0.0,17,14,19,7,42,32,5,18,2,57,99,0
3588,48803,GkoB2VZz49YRew10AQsiKgGNbvbaRd2W,SpATywNh6bZuzm8s1ceuBUnMUAeoAHHw,21,51,20,0,7,2,24,3,107,15.285714285714286,5,0.0,0,20,0,7,51,2,0,24,3,27,80,0
3589,48816,Vn131dD12fh0kapodbBhio0q4dV4IYmG,SpATywNh6bZuzm8s1ceuBUnMUAeoAHHw,21,22,12,14,5,22,9,1,85,12.142857142857142,2,0.0,6,12,14,5,16,22,0,9,1,37,48,0
3590,48847,zrYm7VvWMlvZCf7Dgu9kA0S4dPcpd9DE,G8EPVSXsOYB5YQWZGiz1aVq5Pgr2GrQu,1,0,0,0,0,0,1,0,1,0.14285714285714285,1,0.0,0,0,0,0,0,0,0,1,0,0,1,1
3591,48861,0WvPxKqLdXDP6VJDS60sOhS8Syb4RdJF,G8EPVSXsOYB5YQWZGiz1aVq5Pgr2GrQu,27,100,1,0,1,0,8,1,111,15.857142857142858,2,0.0,2,1,0,1,98,0,0,8,1,4,107,1
3592,48876,Ufo4AkS2vTW82q9Kpcrkrp0gG0Us5zu9,SpATywNh6bZuzm8s1ceuBUnMUAeoAHHw,22,33,6,11,3,0,15,1,69,9.857142857142858,3,0.0,5,6,10,3,28,0,1,15,1,24,45,0
3593,48881,n7yQ1FvfAXqDnBpszfIUjZkrvw3J2aJC,A3fsA9Zfv1X2fVEQhTw51lKENdNrEqT3,4,0,0,0,0,3,4,0,7,1.0,2,0.0,0,0,0,0,0,3,0,4,0,0,7,1
3594,48903,TdcZVkuHoNELu59WVF9f7EUYKiYIHP14,A3fsA9Zfv1X2fVEQhTw51lKENdNrEqT3,13,16,8,0,3,0,11,0,38,5.428571428571429,4,0.0,0,8,0,3,16,0,0,11,0,11,27,0
3595,48953,cPrlzYoTDFDvccHbBKlJUrITep6ieC7X,SpATywNh6bZuzm8s1ceuBUnMUAeoAHHw,25,32,16,33,6,0,11,0,98,14.0,5,0.0,7,16,30,6,25,0,3,11,0,59,39,0
3596,48954,7Lv6OVvu1nsvUexcKSRks3wnATE3pr1d,G8EPVSXsOYB5YQWZGiz1aVq5Pgr2GrQu,3,0,0,0,0,0,3,0,3,0.42857142857142855,1,0.0,0,0,0,0,0,0,0,3,0,0,3,1
3597,48972,4IxIKalU9kAsrSpHM9QUN57NRdKohmHA,SpATywNh6bZuzm8s1ceuBUnMUAeoAHHw,17,26,1,17,0,0,12,1,57,8.142857142857142,3,0.0,15,1,17,0,11,0,0,12,1,33,24,0
3598,48991,aOfddFrct0TUA0MYqpcFv1UssmM1IX2e,SpATywNh6bZuzm8s1ceuBUnMUAeoAHHw,29,51,18,37,12,25,10,0,153,21.857142857142858,3,0.0,31,18,32,12,20,25,5,10,0,93,60,1
3599,49001,xLRXz6THj9rNHROqVgV4eCcKXyO03jXb,RXDvfPUBYFlVdlueBFbLW0mhhAyGEqpt,36,88,35,46,18,0,7,0,194,27.714285714285715,4,0.0,2,35,42,18,86,0,4,7,0,97,97,1
3600,49011,1fjO19pGLwHG3depgSJxIFrDpr07UqZK,SpATywNh6bZuzm8s1ceuBUnMUAeoAHHw,29,84,24,28,6,10,32,1,185,26.428571428571427,9,0.0,20,24,26,6,64,10,2,32,1,76,109,0
3601,49017,1fjO19pGLwHG3depgSJxIFrDpr07UqZK,bWdj2GDclj5ofokWjzoa5jAwMkxCykd6,27,41,20,58,6,35,21,0,181,25.857142857142858,6,0.0,0,20,51,6,41,35,7,21,0,77,104,1
3602,49024,SLljRLEQVmbKytDsyUG54XDlcZasHRnD,SpATywNh6bZuzm8s1ceuBUnMUAeoAHHw,12,21,6,4,2,1,18,0,52,7.428571428571429,3,0.0,0,6,3,2,21,1,1,18,0,11,41,0
3603,49047,PcQbQt2Pubz9h6iRkhILIzmVZ7ajU4yi,SpATywNh6bZuzm8s1ceuBUnMUAeoAHHw,10,19,0,19,0,0,4,0,42,6.0,1,0.0,4,0,17,0,15,0,2,4,0,21,21,1
3604,49076,WSyXGkhm7NDepRlMA3agJj8k8GLnavsP,SpATywNh6bZuzm8s1ceuBUnMUAeoAHHw,29,72,41,15,16,31,48,6,229,32.714285714285715,8,0.0,8,41,13,16,64,31,2,48,6,78,151,0
3605,49088,se5zs87qj8m5HDpiAuY9fHW8e8hfOFuJ,A3fsA9Zfv1X2fVEQhTw51lKENdNrEqT3,1,0,0,0,0,0,1,0,1,0.14285714285714285,1,0.0,0,0,0,0,0,0,0,1,0,0,1,1
3606,49093,KcyotPC829BMj56l23keqhJ3VB5WV4xY,A3fsA9Zfv1X2fVEQhTw51lKENdNrEqT3,7,8,2,0,1,1,4,0,16,2.2857142857142856,2,0.0,1,2,0,1,7,1,0,4,0,4,12,1
3607,49096,etO9cGvtnbcyDOUow8PWemZvzpbkeWT2,SpATywNh6bZuzm8s1ceuBUnMUAeoAHHw,24,60,21,24,5,1,22,0,133,19.0,10,0.0,10,21,22,5,50,1,2,22,0,58,75,0
3608,49114,1uHLOYSfEFwzZFuLCsgyZIWEkaqBo7Qo,A3fsA9Zfv1X2fVEQhTw51lKENdNrEqT3,1,0,0,0,0,0,1,0,1,0.14285714285714285,1,0.0,0,0,0,0,0,0,0,1,0,0,1,1
3609,49129,5VPsupm8AUE2ZBwqUxHjS8zxcSp1Mcls,SpATywNh6bZuzm8s1ceuBUnMUAeoAHHw,32,43,20,43,8,34,29,2,179,25.571428571428573,5,0.0,14,20,35,8,29,34,8,29,2,77,102,0
3610,49132,gSsRzqNvll8eqcaaEGmB933OlJpuGX1g,G8EPVSXsOYB5YQWZGiz1aVq5Pgr2GrQu,129,118,45,300,33,35,38,2,571,81.57142857142857,9,0.0,57,45,239,33,61,35,61,38,2,374,197,0
3611,49139,cszgTMCcWdEja3BpEwPP5MtLXTMUMJXE,G8EPVSXsOYB5YQWZGiz1aVq5Pgr2GrQu,28,42,18,54,6,3,6,1,130,18.571428571428573,1,0.0,17,18,39,6,25,3,15,6,1,80,50,1
3612,49143,Jt2ZVEP2fRpS6kT1yCei4p4So6yqdxLs,SpATywNh6bZuzm8s1ceuBUnMUAeoAHHw,32,45,21,32,10,5,18,4,135,19.285714285714285,5,0.0,14,21,30,10,31,5,2,18,4,75,60,0
3613,49155,xbEgNPkq7oopGIGH4RYgTrlgPLk46GrG,SpATywNh6bZuzm8s1ceuBUnMUAeoAHHw,16,18,1,30,0,1,10,1,61,8.714285714285714,1,0.0,12,1,29,0,6,1,1,10,1,42,19,0
3614,49174,WjU8VISsquSeFe2LBisgFs90fx26laYI,SpATywNh6bZuzm8s1ceuBUnMUAeoAHHw,8,8,0,0,0,2,12,1,23,3.2857142857142856,1,0.0,0,0,0,0,8,2,0,12,1,0,23,0
3615,49188,tg4dRbWUPF4nI55illP72uaDj0KVwE07,SpATywNh6bZuzm8s1ceuBUnMUAeoAHHw,2,0,0,0,0,0,2,0,2,0.2857142857142857,1,0.0,0,0,0,0,0,0,0,2,0,0,2,1
3616,49196,FFLpMSWkcYP9u5pfR9jmdACaFpKaDwug,SpATywNh6bZuzm8s1ceuBUnMUAeoAHHw,18,13,10,0,8,0,4,0,35,5.0,2,0.0,0,10,0,8,13,0,0,4,0,18,17,0
3617,49197,sHAdbtjkiytWLt2Io4BZ2tzs5Et0ae7f,A3fsA9Zfv1X2fVEQhTw51lKENdNrEqT3,4,2,0,0,0,0,5,0,7,1.0,1,0.0,0,0,0,0,2,0,0,5,0,0,7,1
3618,49204,KWhhYcngkyB7QbL1Y9080mTGvLlZLj2v,SpATywNh6bZuzm8s1ceuBUnMUAeoAHHw,32,70,27,34,9,4,21,1,166,23.714285714285715,5,0.0,29,27,27,9,41,4,7,21,1,92,74,1
3619,49212,l70wRZ2DS0s6LjbT7C4gRoGrF27x9p2H,SpATywNh6bZuzm8s1ceuBUnMUAeoAHHw,16,31,0,18,0,10,12,0,71,10.142857142857142,8,0.0,7,0,17,0,24,10,1,12,0,24,47,0
3620,49227,Qv53J5pwTj9vVvZOfTayJrmLGAxLRscw,A3fsA9Zfv1X2fVEQhTw51lKENdNrEqT3,7,2,1,0,1,1,5,0,10,1.4285714285714286,1,0.0,0,1,0,1,2,1,0,5,0,2,8,1
3621,49237,Et66VbQRwkFnF42twZ8Z4ErFWQLehmwC,G8EPVSXsOYB5YQWZGiz1aVq5Pgr2GrQu,8,12,4,0,4,0,9,0,29,4.142857142857143,3,0.0,1,4,0,4,11,0,0,9,0,9,20,1
3622,49313,YQzUeDQQAfJF96X2O80R1owwrQ0VWsFN,SpATywNh6bZuzm8s1ceuBUnMUAeoAHHw,14,8,7,0,7,0,2,0,24,3.4285714285714284,2,0.0,0,7,0,7,8,0,0,2,0,14,10,0
3623,49351,eFBES6IMQYn0JaXFDvfen5eqvCA8gBJT,A3fsA9Zfv1X2fVEQhTw51lKENdNrEqT3,1,0,0,0,0,0,1,0,1,0.14285714285714285,1,0.0,0,0,0,0,0,0,0,1,0,0,1,1
3624,49353,W6MGFBQ1Tov9lOeRQ8QlzHUMCDNEGRDq,SpATywNh6bZuzm8s1ceuBUnMUAeoAHHw,21,20,5,33,4,0,3,0,65,9.285714285714286,2,0.0,8,5,30,4,12,0,3,3,0,47,18,1
3625,49357,oJ9j9ejTgKixczg3tSE8Sg8DPI7YQpJq,G8EPVSXsOYB5YQWZGiz1aVq5Pgr2GrQu,39,46,16,53,7,6,7,0,135,19.285714285714285,3,0.0,25,16,35,7,21,6,18,7,0,83,52,0
3626,49376,endumB3uNuPZEFkf3CSbVDfBrwPiEVSP,A3fsA9Zfv1X2fVEQhTw51lKENdNrEqT3,9,5,5,0,4,0,4,0,18,2.5714285714285716,1,0.0,0,5,0,4,5,0,0,4,0,9,9,1
3627,49397,uZVvmJaNXb0GsvOW7SvWgzrpxZ3muXeW,SpATywNh6bZuzm8s1ceuBUnMUAeoAHHw,25,30,9,33,5,15,16,2,110,15.714285714285714,7,0.0,14,9,32,5,16,15,1,16,2,60,50,0
3628,49410,tzUG2qRl7N6mPYRCQUU2RS3J3hIQZLrD,bWdj2GDclj5ofokWjzoa5jAwMkxCykd6,18,31,18,28,11,8,7,0,103,14.714285714285714,2,0.0,7,18,24,11,24,8,4,7,0,60,43,1
3629,49428,HxubVk6qxALTKY86iFsfskUh9kA3f2Wx,SpATywNh6bZuzm8s1ceuBUnMUAeoAHHw,31,70,28,51,14,29,16,3,211,30.142857142857142,4,0.0,22,28,40,14,48,29,11,16,3,104,107,0
3630,49457,KdLS3BVh0aFKrdvLPEqJwR9P75VBUiUC,SpATywNh6bZuzm8s1ceuBUnMUAeoAHHw,8,8,5,0,5,0,3,0,21,3.0,1,0.0,1,5,0,5,7,0,0,3,0,11,10,1
3631,49481,2uoMQOxqyRzmIYFGnyAflqy5t44QW2xE,G8EPVSXsOYB5YQWZGiz1aVq5Pgr2GrQu,36,80,36,52,24,0,14,0,206,29.428571428571427,6,0.0,29,36,37,24,51,0,15,14,0,126,80,0
3632,49491,4WZA45bzzwtSAshCx00ZUSQpyrxBtdvp,SpATywNh6bZuzm8s1ceuBUnMUAeoAHHw,7,7,6,0,6,0,2,0,21,3.0,2,0.0,0,6,0,6,7,0,0,2,0,12,9,1
3633,49492,8zWgVyFjldbfjgOVhyVSCY9hVHofzB37,SpATywNh6bZuzm8s1ceuBUnMUAeoAHHw,26,52,12,16,7,1,12,1,101,14.428571428571429,9,0.0,9,12,16,7,43,1,0,12,1,44,57,0
3634,49502,zbDDJL57Eoinf5rQFwxv5qPElJd1fdtI,SpATywNh6bZuzm8s1ceuBUnMUAeoAHHw,3,2,0,0,0,0,1,0,3,0.42857142857142855,1,0.0,0,0,0,0,2,0,0,1,0,0,3,1
3635,49506,ZOJ5QbCRlZ7Fm01C02cxFKL8leZWKfBc,SpATywNh6bZuzm8s1ceuBUnMUAeoAHHw,25,62,1,35,0,6,14,2,120,17.142857142857142,3,0.0,17,1,28,0,45,6,7,14,2,46,74,0
3636,49507,IFqWOl32JJm0W3Ap2jxVCpJeXeLJlYDp,bWdj2GDclj5ofokWjzoa5jAwMkxCykd6,6,7,4,0,2,0,3,0,16,2.2857142857142856,2,0.0,1,4,0,2,6,0,0,3,0,7,9,1
3637,49547,PIAH3m3yXecwsaiYYmcRmhzQt3oUmGgZ,A3fsA9Zfv1X2fVEQhTw51lKENdNrEqT3,2,0,0,0,0,0,2,0,2,0.2857142857142857,1,0.0,0,0,0,0,0,0,0,2,0,0,2,1
3638,49574,jdOdZxrxaATCu1ggjNzD0BD26QmUeIwp,A3fsA9Zfv1X2fVEQhTw51lKENdNrEqT3,1,0,0,0,0,0,1,0,1,0.14285714285714285,1,0.0,0,0,0,0,0,0,0,1,0,0,1,1
3639,49593,tLAxgBhXx0zpE8fWNnwggaJx5LeHI2h1,A3fsA9Zfv1X2fVEQhTw51lKENdNrEqT3,85,88,47,214,38,0,9,0,396,56.57142857142857,6,0.0,2,47,182,38,86,0,32,9,0,269,127,1
3640,49594,cvoMRtPY6qflB97uu9pYZ8EABJnJiTnH,A3fsA9Zfv1X2fVEQhTw51lKENdNrEqT3,7,7,1,0,1,0,3,0,12,1.7142857142857142,2,0.0,1,1,0,1,6,0,0,3,0,3,9,1
3641,49602,7vO4g7GKU63bpLmNrZ8Z66FvgSw6Sbgl,A3fsA9Zfv1X2fVEQhTw51lKENdNrEqT3,4,2,1,0,1,0,1,0,5,0.7142857142857143,1,0.0,0,1,0,1,2,0,0,1,0,2,3,1
3642,49675,vEvuCci9jxTTRH9CGXFnMQL31rdrARkm,RXDvfPUBYFlVdlueBFbLW0mhhAyGEqpt,47,93,47,110,25,11,29,2,317,45.285714285714285,9,0.0,18,47,99,25,75,11,11,29,2,189,128,1
3643,49676,1rh5VRO8SYrfP8Lu1XXtrSs551JhH1SG,SpATywNh6bZuzm8s1ceuBUnMUAeoAHHw,32,40,21,31,10,19,21,1,143,20.428571428571427,4,0.0,12,21,28,10,28,19,3,21,1,71,72,0
3644,49684,RSF86CJJRRqjqcjlLpUNS7gfvntoDbsR,SpATywNh6bZuzm8s1ceuBUnMUAeoAHHw,22,48,19,12,10,1,3,0,93,13.285714285714286,1,0.0,9,19,9,10,39,1,3,3,0,47,46,0
3645,49689,M4KtR07p6NuW0Nzc9JWKn4kOJ33eMAHm,G8EPVSXsOYB5YQWZGiz1aVq5Pgr2GrQu,22,28,6,30,4,1,5,1,75,10.714285714285714,1,0.0,20,6,16,4,8,1,14,5,1,46,29,1
3646,49713,3mhHS6HFiNSDTjK0MItggE081qDKfyqL,SpATywNh6bZuzm8s1ceuBUnMUAeoAHHw,15,23,9,14,3,14,11,0,74,10.571428571428571,5,0.0,9,9,11,3,14,14,3,11,0,32,42,0
3647,49733,YIbC1cuJA4PbBVwCZRQOVlAtofCW8hIn,A3fsA9Zfv1X2fVEQhTw51lKENdNrEqT3,68,27,19,116,13,0,6,0,181,25.857142857142858,4,0.0,3,19,102,13,24,0,14,6,0,137,44,1
3648,49746,pFE82fh5DH8NUVtvV1y83suNQP2lNeAe,RXDvfPUBYFlVdlueBFbLW0mhhAyGEqpt,18,17,1,24,1,0,1,0,44,6.285714285714286,1,0.0,6,1,23,1,11,0,1,1,0,31,13,0
3649,49779,W6MGFBQ1Tov9lOeRQ8QlzHUMCDNEGRDq,A3fsA9Zfv1X2fVEQhTw51lKENdNrEqT3,93,78,41,140,23,3,20,2,307,43.857142857142854,6,0.0,5,41,136,23,73,3,4,20,2,205,102,0
3650,49819,TN2mpCmjDkqLDPlwKTIBj6ZZbjnMqCiy,A3fsA9Zfv1X2fVEQhTw51lKENdNrEqT3,25,18,13,0,11,0,10,0,52,7.428571428571429,2,0.0,0,13,0,11,18,0,0,10,0,24,28,1
3651,49837,lBlhCim6cr1auRYAm96gRvGD6qkdcp2T,A3fsA9Zfv1X2fVEQhTw51lKENdNrEqT3,2,0,0,0,0,0,4,0,4,0.5714285714285714,1,0.0,0,0,0,0,0,0,0,4,0,0,4,1
3652,49867,ajdXJNtmFj3djCMALYMagt4EstfNGU3t,SpATywNh6bZuzm8s1ceuBUnMUAeoAHHw,21,17,12,9,7,11,14,0,70,10.0,3,0.0,2,12,9,7,15,11,0,14,0,30,40,0
3653,49875,0Akk5gAtNLhWs93rvoK6BfZzftMu43VT,SpATywNh6bZuzm8s1ceuBUnMUAeoAHHw,30,37,15,32,7,3,12,2,108,15.428571428571429,3,0.0,8,15,30,7,29,3,2,12,2,60,48,0
3654,49878,fvzGqz3wcA15cPFjEfZNgqzkQDubcDYj,SpATywNh6bZuzm8s1ceuBUnMUAeoAHHw,25,102,59,32,0,32,57,10,292,41.714285714285715,8,0.0,16,59,27,0,86,32,5,57,10,102,190,0
3655,49885,v8BycPX41vEGxhnmXhJJeiFe4eT4u7RK,SpATywNh6bZuzm8s1ceuBUnMUAeoAHHw,20,17,11,28,0,3,7,0,66,9.428571428571429,3,0.0,4,11,24,0,13,3,4,7,0,39,27,0
3656,49939,WMFV7sfGiymyypraYicGVqscWxGZ0nHz,SpATywNh6bZuzm8s1ceuBUnMUAeoAHHw,5,3,0,0,0,0,4,0,7,1.0,1,0.0,0,0,0,0,3,0,0,4,0,0,7,1
3657,49941,C4q4gNQYEpjKh7pq1qjN8i3L7uSpUX9d,RXDvfPUBYFlVdlueBFbLW0mhhAyGEqpt,22,24,16,32,13,1,7,1,94,13.428571428571429,3,0.0,2,16,28,13,22,1,4,7,1,59,35,1
3658,49947,xXjBI1Nf4mgkfSUkf8YjQF9E0XahXwSr,SpATywNh6bZuzm8s1ceuBUnMUAeoAHHw,30,37,16,14,8,14,13,1,103,14.714285714285714,4,0.0,16,16,14,8,21,14,0,13,1,54,49,0
3659,49957,BJvWyg8XIdrq4SNeVAfLk9dJg6cRJiup,A3fsA9Zfv1X2fVEQhTw51lKENdNrEqT3,2,0,0,0,0,0,5,0,5,0.7142857142857143,1,0.0,0,0,0,0,0,0,0,5,0,0,5,1
3660,49960,5DZRIacIZU0OycjWEAvqBXR0CzjjwwCH,SpATywNh6bZuzm8s1ceuBUnMUAeoAHHw,20,22,0,27,0,0,7,0,56,8.0,2,0.0,10,0,25,0,12,0,2,7,0,35,21,0
3661,49980,fFjj8aLqWVfTrDoDqL54VYBbLQmMY3Y1,G8EPVSXsOYB5YQWZGiz1aVq5Pgr2GrQu,25,58,1,40,4,0,18,2,123,17.571428571428573,5,0.0,40,1,32,4,18,0,8,18,2,77,46,1
3662,49981,Q0d1WItnRJvnzlnn5VcAU6GMGN4rfbYJ,A3fsA9Zfv1X2fVEQhTw51lKENdNrEqT3,22,45,28,0,14,0,16,0,103,14.714285714285714,5,0.0,0,28,0,14,45,0,0,16,0,42,61,1
3663,49986,cT0XTodWylQtczhaeg1zuAXwbhCqeXWR,SpATywNh6bZuzm8s1ceuBUnMUAeoAHHw,16,25,3,5,3,0,8,0,44,6.285714285714286,4,0.0,0,3,4,3,25,0,1,8,0,10,34,0
3664,50006,IjWCyY0OMptnbDif5zdKxFY839cuvS21,SpATywNh6bZuzm8s1ceuBUnMUAeoAHHw,13,18,5,7,2,0,4,0,36,5.142857142857143,3,0.0,0,5,7,2,18,0,0,4,0,14,22,0
3665,50015,me65WsEaHvTZs0TNYVukzNrKK1hdRpMM,A3fsA9Zfv1X2fVEQhTw51lKENdNrEqT3,7,5,3,0,1,0,3,0,12,1.7142857142857142,1,0.0,0,3,0,1,5,0,0,3,0,4,8,1
3666,50023,Eu9HoDt3WhECHgcXaERosbI6lMj7Hipb,A3fsA9Zfv1X2fVEQhTw51lKENdNrEqT3,63,77,65,90,52,17,13,1,315,45.0,6,0.0,2,65,73,52,75,17,17,13,1,192,123,1
3667,50027,tWEnJYIhXMJ03Foo959mubaAJUHZPTw0,SpATywNh6bZuzm8s1ceuBUnMUAeoAHHw,24,102,1,48,0,69,36,4,260,37.142857142857146,9,0.0,16,1,41,0,86,69,7,36,4,58,202,0
3668,50028,9e5dcfJQbPUU8sTcmzE9DWoDPOA9Nhu3,A3fsA9Zfv1X2fVEQhTw51lKENdNrEqT3,7,15,1,0,1,0,4,0,21,3.0,2,0.0,0,1,0,1,15,0,0,4,0,2,19,0
3669,50032,aKjAC5UWlmbeTD1k9n3NGSA3VSvaAKtm,SpATywNh6bZuzm8s1ceuBUnMUAeoAHHw,30,58,33,28,11,7,16,1,154,22.0,4,0.0,17,33,24,11,41,7,4,16,1,85,69,0
3670,50037,5ARkGJ4p1hrN1paVNwlZ2LmySeAZIjWv,SpATywNh6bZuzm8s1ceuBUnMUAeoAHHw,7,7,4,0,2,0,3,0,16,2.2857142857142856,1,0.0,0,4,0,2,7,0,0,3,0,6,10,1
3671,50084,1HlQxNM9nR1hj1jXFLyimiGxZiQUWT8w,RXDvfPUBYFlVdlueBFbLW0mhhAyGEqpt,40,55,24,67,23,12,12,3,196,28.0,4,0.0,19,24,64,23,36,12,3,12,3,130,66,1
3672,50113,YGwgPZSZDAKlEa7pV7OgIimz6xfMMXoJ,A3fsA9Zfv1X2fVEQhTw51lKENdNrEqT3,1,0,0,0,0,0,1,0,1,0.14285714285714285,1,0.0,0,0,0,0,0,0,0,1,0,0,1,1
3673,50157,QxxdakYrISiiDLexNlB0fwU8yeNcfQh4,SpATywNh6bZuzm8s1ceuBUnMUAeoAHHw,16,15,8,17,3,1,2,0,46,6.571428571428571,1,0.0,4,8,15,3,11,1,2,2,0,30,16,1
3674,50161,vQxwNbtZgUat9SDZRmE7MEKdvAizpBwk,SpATywNh6bZuzm8s1ceuBUnMUAeoAHHw,20,43,4,17,1,2,5,0,72,10.285714285714286,3,0.0,6,4,17,1,37,2,0,5,0,28,44,0
3675,50170,jJ6KwmQPdHVF9SNnawJ7zfgWoExKlRbO,SpATywNh6bZuzm8s1ceuBUnMUAeoAHHw,14,23,10,12,3,0,4,0,52,7.428571428571429,2,0.0,5,10,10,3,18,0,2,4,0,28,24,1
3676,50173,lVM3D8yPmd62Fdb29hI2YI0VPwlNvI4t,bWdj2GDclj5ofokWjzoa5jAwMkxCykd6,12,22,8,8,9,0,8,0,55,7.857142857142857,3,0.0,10,8,7,9,12,0,1,8,0,34,21,1
3677,50203,8ZgsKNDzCbgk8zoZndfYiYFsfvE0SQgi,SpATywNh6bZuzm8s1ceuBUnMUAeoAHHw,25,45,6,30,3,1,20,1,106,15.142857142857142,7,0.0,19,6,26,3,26,1,4,20,1,54,52,0
3678,50223,l5LfU8gApOG72AnBkdAbfOLQLwFH7Zo2,SpATywNh6bZuzm8s1ceuBUnMUAeoAHHw,26,55,6,26,3,19,12,0,121,17.285714285714285,8,0.0,13,6,20,3,42,19,6,12,0,42,79,0
3679,50279,CyelsVXrffOJcI4D4Ax6e4uKbn9S9AKP,A3fsA9Zfv1X2fVEQhTw51lKENdNrEqT3,2,0,0,0,0,0,2,0,2,0.2857142857142857,1,0.0,0,0,0,0,0,0,0,2,0,0,2,1
3680,50294,mexTVUuTBaMSHWugjgX7gCSwX1B8AubF,SpATywNh6bZuzm8s1ceuBUnMUAeoAHHw,6,12,1,0,1,0,3,0,17,2.4285714285714284,2,0.0,0,1,0,1,12,0,0,3,0,2,15,0
3681,50320,1OwZz25mXZNgO62URLrpwxju1xtv0yd9,SpATywNh6bZuzm8s1ceuBUnMUAeoAHHw,11,25,4,24,0,6,13,1,73,10.428571428571429,3,0.0,11,4,20,0,14,6,4,13,1,35,38,0
3682,50322,jxVbF1puB335S13Sh1SeiyqryzWrY9TH,SpATywNh6bZuzm8s1ceuBUnMUAeoAHHw,8,9,2,0,3,0,8,0,22,3.142857142857143,2,0.0,0,2,0,3,9,0,0,8,0,5,17,1
3683,50352,BS7u1moD4G6tIsp3i8TsGiKk2duVqSQ0,G8EPVSXsOYB5YQWZGiz1aVq5Pgr2GrQu,6,5,3,0,2,0,4,0,14,2.0,2,0.0,0,3,0,2,5,0,0,4,0,5,9,1
3684,50361,Gur5FuhE9EyV9K1F0qLPk7AenhoY8PBS,SpATywNh6bZuzm8s1ceuBUnMUAeoAHHw,17,18,0,24,0,34,21,3,100,14.285714285714286,3,0.0,5,0,18,0,13,34,6,21,3,23,77,1
3685,50380,Xdag5jOmE7uWC3FmBvgPc5F7lO3QNcPW,bWdj2GDclj5ofokWjzoa5jAwMkxCykd6,39,101,44,165,14,63,40,5,432,61.714285714285715,8,0.0,13,44,149,14,88,63,16,40,5,220,212,0
3686,50383,wcXKTRp3782w7z3pcKy7I4KlcLaVU81W,SpATywNh6bZuzm8s1ceuBUnMUAeoAHHw,11,12,1,0,1,0,3,0,17,2.4285714285714284,2,0.0,0,1,0,1,12,0,0,3,0,2,15,0
3687,50401,dk07gP54X69nuCMty25BNGOYSGmkxtJW,SpATywNh6bZuzm8s1ceuBUnMUAeoAHHw,25,38,1,23,0,4,22,2,90,12.857142857142858,3,0.0,16,1,21,0,22,4,2,22,2,38,52,0
3688,50417,zYT144o5gG83ITHydzc0I4BahBKUTuVY,A3fsA9Zfv1X2fVEQhTw51lKENdNrEqT3,6,6,0,0,0,0,5,0,11,1.5714285714285714,2,0.0,0,0,0,0,6,0,0,5,0,0,11,1
3689,50422,SnivjdMp3HL6G23yPscSnzZlAD2Rbyt6,bWdj2GDclj5ofokWjzoa5jAwMkxCykd6,47,83,40,114,29,22,8,0,296,42.285714285714285,7,0.0,29,40,98,29,54,22,16,8,0,196,100,1
3690,50455,9jNN69RJsAFkkuYDPHWQVpfsVwA6mFxd,SpATywNh6bZuzm8s1ceuBUnMUAeoAHHw,23,44,28,32,0,0,12,0,116,16.571428571428573,6,0.0,4,28,29,0,40,0,3,12,0,61,55,0
3691,50460,DRhlp1eJHQqsxjCL0bRD6kkHN20HbJ4w,RXDvfPUBYFlVdlueBFbLW0mhhAyGEqpt,15,15,10,12,6,3,3,0,49,7.0,4,0.0,1,10,12,6,14,3,0,3,0,29,20,1
3692,50479,wfvJgFT5spPJFxchmb7eMbxy7ga4Z42J,A3fsA9Zfv1X2fVEQhTw51lKENdNrEqT3,31,30,1,80,0,18,27,3,159,22.714285714285715,3,0.0,2,1,66,0,28,18,14,27,3,69,90,0
3693,50485,bZVDIvmAMciYIQrrbhRx0jvH9Tiicfyn,SpATywNh6bZuzm8s1ceuBUnMUAeoAHHw,15,26,0,14,0,5,7,0,52,7.428571428571429,3,0.0,5,0,13,0,21,5,1,7,0,18,34,0
3694,50495,3kOFsgHC3tWJNSzqIlZ1BKfxh1AIkRy9,SpATywNh6bZuzm8s1ceuBUnMUAeoAHHw,7,3,2,0,2,0,2,0,9,1.2857142857142858,1,0.0,0,2,0,2,3,0,0,2,0,4,5,0
3695,50498,Crsle3QdAPcjxEbhDM61m0114QeooRDa,A3fsA9Zfv1X2fVEQhTw51lKENdNrEqT3,2,0,0,0,0,0,2,0,2,0.2857142857142857,1,0.0,0,0,0,0,0,0,0,2,0,0,2,1
3696,50515,E7wBgQCkgD4tkfXLdP9URnDZqb2ubvF0,A3fsA9Zfv1X2fVEQhTw51lKENdNrEqT3,1,0,0,0,0,0,1,0,1,0.14285714285714285,1,0.0,0,0,0,0,0,0,0,1,0,0,1,0
3697,50526,SKzEklIJtB0H7qSb29ZCLXx6x8polS8t,G8EPVSXsOYB5YQWZGiz1aVq5Pgr2GrQu,10,5,3,0,0,2,7,2,19,2.7142857142857144,1,0.0,0,3,0,0,5,2,0,7,2,3,16,1
3698,50568,Ikx8dqw7N29O68oP7rbQGE7AGY4iLNon,SpATywNh6bZuzm8s1ceuBUnMUAeoAHHw,5,6,2,0,2,0,2,0,12,1.7142857142857142,1,0.0,0,2,0,2,6,0,0,2,0,4,8,0
3699,50572,XIlz5QvnlEzidDqYGld3VSh8CaOyBXAa,RXDvfPUBYFlVdlueBFbLW0mhhAyGEqpt,13,13,8,0,6,0,10,0,37,5.285714285714286,3,0.0,1,8,0,6,12,0,0,10,0,15,22,1
3700,50609,THlX4ibtjGYQg6ZUfc8ItvnKMtOly4Xi,SpATywNh6bZuzm8s1ceuBUnMUAeoAHHw,21,28,14,0,9,1,9,0,61,8.714285714285714,3,0.0,0,14,0,9,28,1,0,9,0,23,38,0
3701,50619,U0ut2RIK4RMVOoanuVtPF17vT9gKZVmq,A3fsA9Zfv1X2fVEQhTw51lKENdNrEqT3,8,5,3,0,1,0,3,0,12,1.7142857142857142,1,0.0,0,3,0,1,5,0,0,3,0,4,8,1
3702,50632,DeyP5lAVv1H3yXRPzbyis5xLngeggxpO,RXDvfPUBYFlVdlueBFbLW0mhhAyGEqpt,12,16,8,0,3,1,10,1,39,5.571428571428571,2,0.0,0,8,0,3,16,1,0,10,1,11,28,1
3703,50670,IDqUeKOsakXfpJsNR0qoC3jJJuHYmkPd,SpATywNh6bZuzm8s1ceuBUnMUAeoAHHw,11,66,18,0,0,10,11,1,106,15.142857142857142,3,0.0,20,18,0,0,46,10,0,11,1,38,68,0
3704,50692,BfoybeaeQZxTt069jPLA4qjwQgNZD97I,G8EPVSXsOYB5YQWZGiz1aVq5Pgr2GrQu,17,22,0,10,0,18,13,2,65,9.285714285714286,1,0.0,6,0,5,0,16,18,5,13,2,11,54,1
3705,50700,ZjAnj7LejyrDjdytaW8xiEftNjkACZgi,A3fsA9Zfv1X2fVEQhTw51lKENdNrEqT3,1,0,0,0,0,0,1,0,1,0.14285714285714285,1,0.0,0,0,0,0,0,0,0,1,0,0,1,1
3706,50703,AEOK3hwhmsMNDRL3o1uoaIUrWvSc7heg,SpATywNh6bZuzm8s1ceuBUnMUAeoAHHw,5,5,1,0,0,0,2,0,8,1.1428571428571428,1,0.0,2,1,0,0,3,0,0,2,0,3,5,1
3707,50736,6EsKULTJVMq3E9IpeZllE0vOQuFiZwCm,SpATywNh6bZuzm8s1ceuBUnMUAeoAHHw,16,19,5,28,3,11,6,2,74,10.571428571428571,1,0.0,13,5,24,3,6,11,4,6,2,45,29,1
3708,50738,9va47BxxunDTlRdlZXe6vZY5WX0faoXZ,G8EPVSXsOYB5YQWZGiz1aVq5Pgr2GrQu,30,12,0,110,0,0,8,1,131,18.714285714285715,1,0.0,3,0,93,0,9,0,17,8,1,96,35,1
3709,50761,EttKeSyg9r0EcjglXuiRsuMNde5ZPNQV,A3fsA9Zfv1X2fVEQhTw51lKENdNrEqT3,5,3,2,0,0,0,2,0,7,1.0,1,0.0,0,2,0,0,3,0,0,2,0,2,5,1
3710,50776,kQmP7eUv8W6zmkJRQJGIL9eNv0mJSlzv,SpATywNh6bZuzm8s1ceuBUnMUAeoAHHw,7,7,2,0,2,0,1,0,12,1.7142857142857142,1,0.0,0,2,0,2,7,0,0,1,0,4,8,1
3711,50777,se9ZVl8DNkiCW8i2nP0p3krrUcQqYC47,bWdj2GDclj5ofokWjzoa5jAwMkxCykd6,19,34,18,114,9,5,14,2,196,28.0,5,0.0,8,18,111,9,26,5,3,14,2,146,50,0
3712,50789,3URMlJ8WFfbFx3SvBMPqUCA5oJqCky66,RXDvfPUBYFlVdlueBFbLW0mhhAyGEqpt,1,0,0,0,0,0,1,0,1,0.14285714285714285,1,0.0,0,0,0,0,0,0,0,1,0,0,1,1
3713,50792,oidXTGaCUuuF1QPNvhmiPoqhWsTY245r,bWdj2GDclj5ofokWjzoa5jAwMkxCykd6,6,4,3,0,3,0,2,0,12,1.7142857142857142,1,0.0,0,3,0,3,4,0,0,2,0,6,6,0
3714,50795,c0bjMduOwhlaRS3h8xRhAhid9jTsLzPD,A3fsA9Zfv1X2fVEQhTw51lKENdNrEqT3,13,15,7,0,5,0,4,0,31,4.428571428571429,2,0.0,0,7,0,5,15,0,0,4,0,12,19,1
3715,50797,BWuaSpfjjWoQ6suviyDvOJ1XUJLgJBtc,SpATywNh6bZuzm8s1ceuBUnMUAeoAHHw,32,32,16,36,10,56,17,3,170,24.285714285714285,5,0.0,12,16,30,10,20,56,6,17,3,68,102,0
3716,50805,1HrXazG6mMhlQyrWzEYwtGHFWa0bXXko,SpATywNh6bZuzm8s1ceuBUnMUAeoAHHw,25,31,0,22,0,73,10,1,137,19.571428571428573,4,0.0,7,0,18,0,24,73,4,10,1,25,112,0
3717,50808,xm9wUIf1J8EjTNxXT4ffEWzhuySk21YK,RXDvfPUBYFlVdlueBFbLW0mhhAyGEqpt,47,87,39,108,50,2,10,1,297,42.42857142857143,6,0.0,14,39,101,50,73,2,7,10,1,204,93,0
3718,50814,tOVeFZbpewRX07F0N4KV6g00WNGootzd,SpATywNh6bZuzm8s1ceuBUnMUAeoAHHw,2,0,0,0,0,0,2,0,2,0.2857142857142857,1,0.0,0,0,0,0,0,0,0,2,0,0,2,1
3719,50835,KH1qoBE3q99uPmQbxyBhuyXhrxNuFdJJ,A3fsA9Zfv1X2fVEQhTw51lKENdNrEqT3,1,0,0,0,0,0,2,0,2,0.2857142857142857,2,0.0,0,0,0,0,0,0,0,2,0,0,2,1
3720,50841,POGRFFRZzlPiBHiCHXnlCDCb459JTEzc,G8EPVSXsOYB5YQWZGiz1aVq5Pgr2GrQu,99,149,4,345,4,5,41,0,548,78.28571428571429,9,0.0,21,4,292,4,128,5,53,41,0,321,227,0
3721,52414,LwOwoJdIBH6qSphf2Y21IIrVgEcOPNno,7GRhBDsirIGkRZBtSMEzNTyDr2JQm4xx,8,4,1,0,0,3,11,0,19,2.7142857142857144,1,0.0,0,1,0,0,4,3,0,11,0,1,18,1
3722,52418,AWLXkSqW4e7SbhduVpZ7fOXghxuuP6q1,7GRhBDsirIGkRZBtSMEzNTyDr2JQm4xx,38,48,17,54,17,1,10,0,147,21.0,3,0.0,27,17,47,17,21,1,7,10,0,108,39,1
3723,52525,7tM0glf5iOjFrrOx11jEjeXPWGg1qnPf,7GRhBDsirIGkRZBtSMEzNTyDr2JQm4xx,27,57,20,125,9,7,13,0,231,33.0,4,0.0,24,20,124,9,33,7,1,13,0,177,54,1
3724,52527,3EXQpH44dmXe1KuNCn9IRB8zLxVzdC0Z,7GRhBDsirIGkRZBtSMEzNTyDr2JQm4xx,4,2,0,0,0,0,2,0,4,0.5714285714285714,2,0.0,0,0,0,0,2,0,0,2,0,0,4,1
3725,52564,KFkM2LdM6U7FLDyErp7vnT4e1T4YjeOt,7GRhBDsirIGkRZBtSMEzNTyDr2JQm4xx,1,0,0,0,0,0,1,0,1,0.14285714285714285,1,0.0,0,0,0,0,0,0,0,1,0,0,1,1
3726,52609,pf5bjcn02zW6F9NEdRWcVWa4U5P6G0ff,7GRhBDsirIGkRZBtSMEzNTyDr2JQm4xx,16,11,1,24,0,0,3,0,39,5.571428571428571,2,0.0,0,1,21,0,11,0,3,3,0,22,17,1
3727,52629,N1ze97FAwTuBZx89GGh4oyy7kZndQ2aO,7GRhBDsirIGkRZBtSMEzNTyDr2JQm4xx,1,0,0,0,0,0,1,0,1,0.14285714285714285,1,0.0,0,0,0,0,0,0,0,1,0,0,1,1
3728,52648,PCT9UecTLFgHQMLESQLM3zo2VKyldhOq,7GRhBDsirIGkRZBtSMEzNTyDr2JQm4xx,57,141,4,182,17,29,14,2,389,55.57142857142857,5,0.0,80,4,162,17,61,29,20,14,2,263,126,0
3729,52708,qZCURwy8JtTyuwzOv8VNGZdlPKRFUQ4x,7GRhBDsirIGkRZBtSMEzNTyDr2JQm4xx,6,4,1,0,1,2,8,0,16,2.2857142857142856,2,0.0,0,1,0,1,4,2,0,8,0,2,14,1
3730,52730,8XaoEwTyWeXdGPkk69feFC4MnARlyEPY,7GRhBDsirIGkRZBtSMEzNTyDr2JQm4xx,60,93,5,72,10,8,18,1,207,29.571428571428573,3,0.0,60,5,70,10,33,8,2,18,1,145,62,0
3731,52753,SwHZgUxPjIeMthkMeeVpPfNadNOmRqaT,7GRhBDsirIGkRZBtSMEzNTyDr2JQm4xx,9,3,2,0,3,0,2,0,10,1.4285714285714286,1,0.0,0,2,0,3,3,0,0,2,0,5,5,1
3732,52762,yoBRTcR2cnNdwxBl8X3b5dAnEe5pLM8o,7GRhBDsirIGkRZBtSMEzNTyDr2JQm4xx,27,59,15,24,16,0,3,0,117,16.714285714285715,1,0.0,22,15,21,16,37,0,3,3,0,74,43,1
3733,52767,oegjA7ZBrBlZ5Cd9WyrHTpKnm4129pWq,7GRhBDsirIGkRZBtSMEzNTyDr2JQm4xx,3,3,1,0,0,0,1,0,5,0.7142857142857143,1,0.0,0,1,0,0,3,0,0,1,0,1,4,0
3734,52794,ZI5bmLXRjGY30yDOOtLk3SjipijnEDdH,7GRhBDsirIGkRZBtSMEzNTyDr2JQm4xx,40,114,35,60,19,2,11,0,241,34.42857142857143,4,0.0,44,35,50,19,70,2,10,11,0,148,93,1
3735,52796,5PAJAhGm6mrmRya9bVA0TVEjvyxWSpHH,7GRhBDsirIGkRZBtSMEzNTyDr2JQm4xx,1,0,0,0,0,0,1,0,1,0.14285714285714285,1,0.0,0,0,0,0,0,0,0,1,0,0,1,1
3736,52797,JIMEFE3LdWAEpCV2LFwTCYSPjTS7eSnb,7GRhBDsirIGkRZBtSMEzNTyDr2JQm4xx,1,0,0,0,0,0,2,0,2,0.2857142857142857,1,0.0,0,0,0,0,0,0,0,2,0,0,2,1
3737,52822,kXa3f0Vj2v6uxMPIg14PPBVn8OhOZ096,7GRhBDsirIGkRZBtSMEzNTyDr2JQm4xx,2,0,0,0,0,0,2,0,2,0.2857142857142857,1,0.0,0,0,0,0,0,0,0,2,0,0,2,1
3738,52863,3AQcLF4401vlSQmnRaDEtc72D2nXEfx6,7GRhBDsirIGkRZBtSMEzNTyDr2JQm4xx,3,0,0,0,0,0,4,0,4,0.5714285714285714,2,0.0,0,0,0,0,0,0,0,4,0,0,4,1
3739,52951,ZFZTZbiKHOXenp1TWxEkC4SRLbwYuUkm,7GRhBDsirIGkRZBtSMEzNTyDr2JQm4xx,2,0,0,0,0,0,2,0,2,0.2857142857142857,1,0.0,0,0,0,0,0,0,0,2,0,0,2,1
3740,52952,MfF2UM103u4NW6P3ppuUwg5ByBUcnBZA,7GRhBDsirIGkRZBtSMEzNTyDr2JQm4xx,1,0,0,0,0,0,1,0,1,0.14285714285714285,1,0.0,0,0,0,0,0,0,0,1,0,0,1,1
3741,52976,IiVkIz2ymD5LAyFMLUAoz4dlLCufsOLN,7GRhBDsirIGkRZBtSMEzNTyDr2JQm4xx,1,0,0,0,0,0,1,0,1,0.14285714285714285,1,0.0,0,0,0,0,0,0,0,1,0,0,1,0
3742,52994,KogrHROquIJLSXIZqzhYU9Hcb9zVebwT,7GRhBDsirIGkRZBtSMEzNTyDr2JQm4xx,18,25,4,24,7,0,1,0,61,8.714285714285714,1,0.0,10,4,22,7,15,0,2,1,0,43,18,1
3743,53007,0d9QTHxHI38QwsI8Nrfe3h4nIFkKB9wm,7GRhBDsirIGkRZBtSMEzNTyDr2JQm4xx,67,110,40,114,28,10,6,0,308,44.0,4,0.0,44,40,100,28,66,10,14,6,0,212,96,0
3744,53015,zKm7XBlAnX1kvqmnbBunuJ0zgW910NPD,7GRhBDsirIGkRZBtSMEzNTyDr2JQm4xx,2,0,0,0,0,0,2,0,2,0.2857142857142857,1,0.0,0,0,0,0,0,0,0,2,0,0,2,1
3745,53030,KR1JBNTPMvAMQwZ6jsgCry7qScNUELlI,7GRhBDsirIGkRZBtSMEzNTyDr2JQm4xx,1,0,0,0,0,0,1,0,1,0.14285714285714285,1,0.0,0,0,0,0,0,0,0,1,0,0,1,1
3746,53034,TCECwaNYQUDA9PVYFYURPe0mJR7V4JvI,SpATywNh6bZuzm8s1ceuBUnMUAeoAHHw,5,2,1,0,1,0,3,0,7,1.0,2,0.0,0,1,0,1,2,0,0,3,0,2,5,0
3747,53041,FW02PfU8vx3pzmS7oOXpJualmcvfngs4,SpATywNh6bZuzm8s1ceuBUnMUAeoAHHw,24,98,3,27,3,0,18,0,149,21.285714285714285,5,0.0,33,3,23,3,65,0,4,18,0,62,87,0
3748,53043,4LLdV2zTWS697dAsOgAPJZPFwfNnrjt6,SpATywNh6bZuzm8s1ceuBUnMUAeoAHHw,20,20,14,4,9,2,7,0,56,8.0,4,0.0,2,14,4,9,18,2,0,7,0,29,27,0
3749,53050,dy8SjTNGjfrg38FBIbengGqlbDgTOAri,bWdj2GDclj5ofokWjzoa5jAwMkxCykd6,7,3,2,0,2,0,2,0,9,1.2857142857142858,1,0.0,0,2,0,2,3,0,0,2,0,4,5,1
3750,53055,1EHzEIUJa67W0jqPggV7KDaLGgi5Qkxp,SpATywNh6bZuzm8s1ceuBUnMUAeoAHHw,22,25,12,11,8,1,4,0,61,8.714285714285714,3,0.0,8,12,11,8,17,1,0,4,0,39,22,1
3751,53074,vwFaMtviPYvvdeDxiexQOh059O9Yefj1,SpATywNh6bZuzm8s1ceuBUnMUAeoAHHw,18,80,11,0,12,1,14,2,120,17.142857142857142,6,0.0,6,11,0,12,74,1,0,14,2,29,91,1
3752,53087,Bos3zEEnAcYzPXQktMkJJ0ak5mhGWCAf,A3fsA9Zfv1X2fVEQhTw51lKENdNrEqT3,67,42,20,104,13,0,6,0,185,26.428571428571427,3,0.0,4,20,103,13,38,0,1,6,0,140,45,1
3753,53099,l5zm2dyq1Lp4ch4ILKl8mqNj892nMhsW,A3fsA9Zfv1X2fVEQhTw51lKENdNrEqT3,45,36,25,72,10,6,23,2,174,24.857142857142858,4,0.0,1,25,55,10,35,6,17,23,2,91,83,1
3754,53104,f3SUvLtMnVyEZPEDJVhRMSC5cEFasHSH,G8EPVSXsOYB5YQWZGiz1aVq5Pgr2GrQu,14,19,12,2,5,1,8,1,48,6.857142857142857,4,0.0,5,12,1,5,14,1,1,8,1,23,25,1
3755,53109,fFw6uRnMpWU4RqpwQO2WZ8GCAi6hyn9t,SpATywNh6bZuzm8s1ceuBUnMUAeoAHHw,31,39,19,31,12,5,19,1,126,18.0,5,0.0,7,19,27,12,32,5,4,19,1,65,61,0
3756,53110,ovvuiEhj0QBv4xi11GVjXr8JhlCgaPmd,bWdj2GDclj5ofokWjzoa5jAwMkxCykd6,35,47,18,288,7,17,29,0,406,58.0,3,0.0,16,18,264,7,31,17,24,29,0,305,101,0
3757,53122,OOC2fhf6AkZDpDsl3NCh3irgmTTqQt8y,G8EPVSXsOYB5YQWZGiz1aVq5Pgr2GrQu,3,0,0,0,0,1,2,0,3,0.42857142857142855,1,0.0,0,0,0,0,0,1,0,2,0,0,3,1
3758,53138,SSeq3zqfD5kMUB9gUKp0rdzGfihYMJi7,A3fsA9Zfv1X2fVEQhTw51lKENdNrEqT3,1,0,0,0,0,0,1,0,1,0.14285714285714285,1,0.0,0,0,0,0,0,0,0,1,0,0,1,1
3759,53142,AjsS25Vcjgm2GGcNjE7GPEmmTU7snmJA,SpATywNh6bZuzm8s1ceuBUnMUAeoAHHw,24,43,16,30,9,7,9,1,115,16.428571428571427,4,0.0,19,16,28,9,24,7,2,9,1,72,43,0
3760,53149,fkwxmynqKl1E9zGnE59tFxhsiBODuFhR,SpATywNh6bZuzm8s1ceuBUnMUAeoAHHw,6,3,1,0,1,0,2,0,7,1.0,1,0.0,0,1,0,1,3,0,0,2,0,2,5,1
3761,53157,H8hoxOy1VDjrCqtl8Y1RjEzCSImzfPb1,SpATywNh6bZuzm8s1ceuBUnMUAeoAHHw,31,34,15,34,9,15,9,5,121,17.285714285714285,4,0.0,15,15,29,9,19,15,5,9,5,68,53,1
3762,53160,PPZEwof9f8rZx0lcTpURHpbkLB2YY5hH,A3fsA9Zfv1X2fVEQhTw51lKENdNrEqT3,8,7,4,0,2,0,8,0,21,3.0,3,0.0,0,4,0,2,7,0,0,8,0,6,15,1
3763,53162,4nHfdAZtp0niyFyrjm2L6LhTVPrJBlZM,A3fsA9Zfv1X2fVEQhTw51lKENdNrEqT3,100,67,34,204,18,9,43,2,377,53.857142857142854,11,0.0,10,34,182,18,57,9,22,43,2,244,133,1
3764,53178,kgME9COu6f9ljQ8FhJeUQLVyeGDbkeLG,SpATywNh6bZuzm8s1ceuBUnMUAeoAHHw,15,15,1,24,0,0,4,0,44,6.285714285714286,2,0.0,6,1,21,0,9,0,3,4,0,28,16,1
3765,53190,cWykzNKAq5sFQBA059QN4Jx74YGPkfwB,SpATywNh6bZuzm8s1ceuBUnMUAeoAHHw,12,19,0,8,0,0,7,0,34,4.857142857142857,3,0.0,0,0,8,0,19,0,0,7,0,8,26,0
3766,53199,RfxrjGWEyzBCwnQEmvcmVh3DEMcbhg4m,bWdj2GDclj5ofokWjzoa5jAwMkxCykd6,10,13,10,0,9,0,4,0,36,5.142857142857143,3,0.0,0,10,0,9,13,0,0,4,0,19,17,1
3767,53220,5TX7mZmksEi56P8MasqobWPGE5NBw2IQ,A3fsA9Zfv1X2fVEQhTw51lKENdNrEqT3,10,8,7,0,6,0,2,0,23,3.2857142857142856,1,0.0,0,7,0,6,8,0,0,2,0,13,10,1
3768,53233,nOWqKetxGFQ9o73UNfcoh0XyCt3ITawR,SpATywNh6bZuzm8s1ceuBUnMUAeoAHHw,27,52,18,28,8,0,8,0,114,16.285714285714285,6,0.0,14,18,25,8,38,0,3,8,0,65,49,0
3769,53242,XHTKaBKRPxCmq5MPcwRRZlQAa68hU6KT,RXDvfPUBYFlVdlueBFbLW0mhhAyGEqpt,15,7,3,31,2,1,3,0,47,6.714285714285714,1,0.0,3,3,28,2,4,1,3,3,0,36,11,1
3770,53244,cW2Xkl8EMUT4ygDkm6LqHv4BqvkNTIWA,SpATywNh6bZuzm8s1ceuBUnMUAeoAHHw,9,3,2,0,2,1,5,0,13,1.8571428571428572,1,0.0,0,2,0,2,3,1,0,5,0,4,9,1
3771,53245,2Bc3e8bWl6DTvfTPBZCyShFFG8OApkva,G8EPVSXsOYB5YQWZGiz1aVq5Pgr2GrQu,24,53,20,20,12,23,7,0,135,19.285714285714285,5,0.0,15,20,15,12,38,23,5,7,0,62,73,1
3772,53253,nsNOT1cU6IuLaV7JjnTNsqpFb1YDxqEb,SpATywNh6bZuzm8s1ceuBUnMUAeoAHHw,27,85,36,30,2,83,35,15,286,40.857142857142854,12,0.0,23,36,26,2,62,83,4,35,15,87,199,0
3773,53264,cWykzNKAq5sFQBA059QN4Jx74YGPkfwB,bWdj2GDclj5ofokWjzoa5jAwMkxCykd6,7,10,1,0,1,0,4,0,16,2.2857142857142856,3,0.0,0,1,0,1,10,0,0,4,0,2,14,0
3774,53267,alOTnyZzhm1w471FhEQsPMZXRjsY4Vw8,SpATywNh6bZuzm8s1ceuBUnMUAeoAHHw,14,14,6,13,3,0,3,0,39,5.571428571428571,1,0.0,7,6,10,3,7,0,3,3,0,26,13,1
3775,53274,OfEWzuzCYpLy1DIkUzWxNoBbzCb9peT6,SpATywNh6bZuzm8s1ceuBUnMUAeoAHHw,6,4,1,0,0,0,6,0,11,1.5714285714285714,1,0.0,0,1,0,0,4,0,0,6,0,1,10,0
3776,53297,wEZByhPumKHDR8Jv649KZn2fKnoB4Z7a,RXDvfPUBYFlVdlueBFbLW0mhhAyGEqpt,61,98,6,177,4,6,7,1,299,42.714285714285715,5,0.0,23,6,169,4,75,6,8,7,1,202,97,0
3777,53298,TL33IPw9u5rF9KFoVrfFEZ81kglnbuR1,bWdj2GDclj5ofokWjzoa5jAwMkxCykd6,1,0,0,0,0,0,1,0,1,0.14285714285714285,1,0.0,0,0,0,0,0,0,0,1,0,0,1,1
3778,53302,yo1PAd1hBwimD9OOoxvyi6mwQC5bfK9g,A3fsA9Zfv1X2fVEQhTw51lKENdNrEqT3,5,2,1,0,1,0,3,0,7,1.0,3,0.0,0,1,0,1,2,0,0,3,0,2,5,1
3779,53311,aPkMT9tuTlJ66PtOLGr8kUMmFmOPUdkZ,SpATywNh6bZuzm8s1ceuBUnMUAeoAHHw,7,7,4,0,3,0,2,0,16,2.2857142857142856,2,0.0,0,4,0,3,7,0,0,2,0,7,9,1
3780,53317,yEniPsoZW8Rgn4eOpAbvQhjj6pD8iwKc,A3fsA9Zfv1X2fVEQhTw51lKENdNrEqT3,1,0,0,0,0,0,1,0,1,0.14285714285714285,1,0.0,0,0,0,0,0,0,0,1,0,0,1,1
3781,53331,hibDkoksqk55U27uWSImoVEarIMKhRU6,SpATywNh6bZuzm8s1ceuBUnMUAeoAHHw,1,0,0,0,0,0,1,0,1,0.14285714285714285,1,0.0,0,0,0,0,0,0,0,1,0,0,1,1
3782,53344,zDAtaSKsAJQmmJ6xHQBbAGN68vDebyev,bWdj2GDclj5ofokWjzoa5jAwMkxCykd6,4,4,0,0,0,0,1,0,5,0.7142857142857143,1,0.0,1,0,0,0,3,0,0,1,0,1,4,0
3783,53345,FtZzEliHSUjgpcn9CYNSke7IZriM02xT,SpATywNh6bZuzm8s1ceuBUnMUAeoAHHw,27,29,21,37,6,3,5,0,101,14.428571428571429,3,0.0,4,21,31,6,25,3,6,5,0,62,39,1
3784,53355,NiXPZUmEILmWUPwXexYxtHvaIL7QdjCQ,A3fsA9Zfv1X2fVEQhTw51lKENdNrEqT3,10,13,7,0,0,0,16,0,36,5.142857142857143,2,0.0,1,7,0,0,12,0,0,16,0,8,28,1
3785,53363,kMMGkT5aXtXvkc2Ht1vStIyRGPA6Fe7z,G8EPVSXsOYB5YQWZGiz1aVq5Pgr2GrQu,17,14,10,0,7,0,8,1,40,5.714285714285714,2,0.0,2,10,0,7,12,0,0,8,1,19,21,1
3786,53367,qJEf5DGSDkSxZ1JIhipEbBFRbrhnAj1a,SpATywNh6bZuzm8s1ceuBUnMUAeoAHHw,27,69,28,32,15,0,10,0,154,22.0,3,0.0,30,28,31,15,39,0,1,10,0,104,50,0
3787,53375,Wz9l8snB7xy02KowUlwVZlKvIqcEcSjS,SpATywNh6bZuzm8s1ceuBUnMUAeoAHHw,20,25,1,16,0,0,2,0,44,6.285714285714286,1,0.0,10,1,16,0,15,0,0,2,0,27,17,1
3788,53378,5IoXxgwnl1RIJLxkp1FnmYezwVSXlFjr,SpATywNh6bZuzm8s1ceuBUnMUAeoAHHw,27,44,25,14,12,4,16,2,117,16.714285714285715,6,0.0,5,25,11,12,39,4,3,16,2,53,64,0
3789,53388,b8RIifGIgaKQKUnIb1k2djgWvbjJC3hc,A3fsA9Zfv1X2fVEQhTw51lKENdNrEqT3,1,0,0,0,0,0,1,0,1,0.14285714285714285,1,0.0,0,0,0,0,0,0,0,1,0,0,1,1
3790,53468,rLYXv7hKF9TmAtWbjwlsT53xTtV0g4r6,A3fsA9Zfv1X2fVEQhTw51lKENdNrEqT3,13,6,3,0,2,0,10,2,23,3.2857142857142856,1,0.0,0,3,0,2,6,0,0,10,2,5,18,0
3791,53487,N3Kcp8HxIitle1dnmjMusLDj62CzfGvL,SpATywNh6bZuzm8s1ceuBUnMUAeoAHHw,19,54,7,6,8,23,17,0,115,16.428571428571427,9,0.0,5,7,6,8,49,23,0,17,0,26,89,0
3792,53488,OnFhgQq4yBEqO4X7tLyRDBVhde68jGdf,RXDvfPUBYFlVdlueBFbLW0mhhAyGEqpt,52,49,31,97,12,42,28,4,263,37.57142857142857,4,0.0,13,31,87,12,36,42,10,28,4,143,120,0
3793,53489,griMTqEKR37PeprCrLd3ng7H5lhHXROa,G8EPVSXsOYB5YQWZGiz1aVq5Pgr2GrQu,6,0,0,0,0,1,6,1,8,1.1428571428571428,1,0.0,0,0,0,0,0,1,0,6,1,0,8,1
3794,53491,DJenb7iikHj085JzrOjjcdsjyfa241f7,RXDvfPUBYFlVdlueBFbLW0mhhAyGEqpt,2,0,0,0,0,0,2,0,2,0.2857142857142857,1,0.0,0,0,0,0,0,0,0,2,0,0,2,1
3795,53502,MrmZgmDV3fLNPBur1xb2HpNXhTz9Exkt,SpATywNh6bZuzm8s1ceuBUnMUAeoAHHw,18,25,2,32,2,0,19,0,80,11.428571428571429,7,0.0,11,2,28,2,14,0,4,19,0,43,37,0
3796,53508,PJ44wkPMp1IThxNmQ1GXtcqK19ORMpJF,A3fsA9Zfv1X2fVEQhTw51lKENdNrEqT3,2,0,0,0,0,0,2,0,2,0.2857142857142857,1,0.0,0,0,0,0,0,0,0,2,0,0,2,1
3797,53520,MhrFHIexWYn2dilUXh03cpnfpoe9tMBe,SpATywNh6bZuzm8s1ceuBUnMUAeoAHHw,30,44,14,32,6,8,16,1,121,17.285714285714285,8,0.0,25,14,29,6,19,8,3,16,1,74,47,1
3798,53539,i2lUV72IHqqXWYqLFMWv3y4XGmlq2lXa,SpATywNh6bZuzm8s1ceuBUnMUAeoAHHw,29,38,18,18,8,3,9,0,94,13.428571428571429,4,0.0,5,18,18,8,33,3,0,9,0,49,45,0
3799,53549,luffaRyMH17lmf9lXIITCUvmvLstdhJF,RXDvfPUBYFlVdlueBFbLW0mhhAyGEqpt,8,9,1,0,1,0,2,0,13,1.8571428571428572,1,0.0,0,1,0,1,9,0,0,2,0,2,11,1
3800,53555,gb9jOdGxS4Zwvh3LQboE7LmvRCw5TLz9,SpATywNh6bZuzm8s1ceuBUnMUAeoAHHw,18,32,2,15,1,0,16,1,67,9.571428571428571,2,0.0,8,2,14,1,24,0,1,16,1,25,42,1
3801,53562,KhZJrlhAYzlNSzHg9PDkxBUGTDjg8IXY,SpATywNh6bZuzm8s1ceuBUnMUAeoAHHw,14,13,2,7,1,0,3,0,26,3.7142857142857144,2,0.0,2,2,7,1,11,0,0,3,0,12,14,1
3802,53578,aEf8iYWPFredkFvIYIscqnDLIOz4fHRM,RXDvfPUBYFlVdlueBFbLW0mhhAyGEqpt,4,6,0,0,0,0,1,0,7,1.0,1,0.0,0,0,0,0,6,0,0,1,0,0,7,1
3803,53584,6ulfbgGgKweBR5jQh3XucxQAX08OMB72,SpATywNh6bZuzm8s1ceuBUnMUAeoAHHw,11,8,1,0,1,0,2,0,12,1.7142857142857142,1,0.0,0,1,0,1,8,0,0,2,0,2,10,0
3804,53597,dL8suqa4DXYE6Q2rD72jJySCosptOAyu,SpATywNh6bZuzm8s1ceuBUnMUAeoAHHw,15,37,11,3,8,0,14,0,73,10.428571428571429,4,0.0,6,11,3,8,31,0,0,14,0,28,45,0
3805,53603,4Eyygyv4Uek4GSzjnDMCkiuVf4JBrAxc,SpATywNh6bZuzm8s1ceuBUnMUAeoAHHw,17,32,1,30,0,23,12,0,98,14.0,4,0.0,17,1,27,0,15,23,3,12,0,45,53,1
3806,53622,N07QLGV4GMHH6HuHURctAIeJ4ePasSlF,SpATywNh6bZuzm8s1ceuBUnMUAeoAHHw,2,0,0,0,0,0,2,0,2,0.2857142857142857,1,0.0,0,0,0,0,0,0,0,2,0,0,2,1
3807,53625,WJVoKPfDDccrIbPzaP1iqdrTUwOdTQpf,A3fsA9Zfv1X2fVEQhTw51lKENdNrEqT3,5,4,2,0,1,0,1,0,8,1.1428571428571428,1,0.0,0,2,0,1,4,0,0,1,0,3,5,1
3808,53651,TXNnbjY690dLjW2nCR7nDyfRxXhXZM7x,A3fsA9Zfv1X2fVEQhTw51lKENdNrEqT3,7,11,0,0,0,0,3,0,14,2.0,2,0.0,0,0,0,0,11,0,0,3,0,0,14,1
3809,53678,uqIn0vdfJ1SDJCOeCVEAQPRFBBKQA2eB,bWdj2GDclj5ofokWjzoa5jAwMkxCykd6,50,39,16,157,10,9,15,1,247,35.285714285714285,5,0.0,7,16,152,10,32,9,5,15,1,185,62,1
3810,53706,xQeTj9CLDdVhlEixqachfO1hdSy3qexC,SpATywNh6bZuzm8s1ceuBUnMUAeoAHHw,17,32,5,32,0,4,11,4,88,12.571428571428571,6,0.0,14,5,31,0,18,4,1,11,4,50,38,1
3811,53713,RluI9XQtU4oZmhgM6DxuPP3K5fCr0lBq,SpATywNh6bZuzm8s1ceuBUnMUAeoAHHw,17,15,11,5,7,0,3,0,41,5.857142857142857,3,0.0,0,11,5,7,15,0,0,3,0,23,18,1
3812,53714,Ar22lkOE5FvesxoMKtYhm8Cbv4MUQUYF,RXDvfPUBYFlVdlueBFbLW0mhhAyGEqpt,53,97,4,138,8,28,61,26,362,51.714285714285715,6,0.0,33,4,127,8,64,28,11,61,26,172,190,1
3813,53720,eeYgUeHIQERDYwF1mxwVIZYsVaVSgwlV,A3fsA9Zfv1X2fVEQhTw51lKENdNrEqT3,51,64,35,104,11,21,22,0,257,36.714285714285715,6,0.0,3,35,89,11,61,21,15,22,0,138,119,1
3814,53727,krkfIMLel7iDn2mta14hX7PO3xGpidTe,bWdj2GDclj5ofokWjzoa5jAwMkxCykd6,4,6,0,0,0,0,3,0,9,1.2857142857142858,2,0.0,0,0,0,0,6,0,0,3,0,0,9,1
3815,53733,1OspHY7rOajB01D4WOGZGtONpUzR26jm,bWdj2GDclj5ofokWjzoa5jAwMkxCykd6,1,0,0,0,0,0,1,0,1,0.14285714285714285,1,0.0,0,0,0,0,0,0,0,1,0,0,1,1
3816,53750,DHyGbluRYDb9YK4sD54nYIDtRwaCVU4f,SpATywNh6bZuzm8s1ceuBUnMUAeoAHHw,21,44,14,6,3,10,11,1,89,12.714285714285714,7,0.0,5,14,6,3,39,10,0,11,1,28,61,1
3817,53758,Hu906OsUOpYkLeeay2GUzLMtBtAH0201,SpATywNh6bZuzm8s1ceuBUnMUAeoAHHw,15,30,4,0,2,0,14,0,50,7.142857142857143,7,0.0,0,4,0,2,30,0,0,14,0,6,44,1
3818,53765,tsMYMsnBDSMWs12MBfqVxxI4flEFKsqY,SpATywNh6bZuzm8s1ceuBUnMUAeoAHHw,6,2,1,0,1,0,3,0,7,1.0,1,0.0,0,1,0,1,2,0,0,3,0,2,5,1
3819,53767,7pxuwoHJlBJIgCUu1Em6p1jZ4AOgWd02,SpATywNh6bZuzm8s1ceuBUnMUAeoAHHw,1,0,0,0,0,0,1,0,1,0.14285714285714285,1,0.0,0,0,0,0,0,0,0,1,0,0,1,1
3820,53775,10a3aPUuiEikOQBzdtiLA8dXlMBNaCqq,SpATywNh6bZuzm8s1ceuBUnMUAeoAHHw,1,0,0,0,0,0,1,0,1,0.14285714285714285,1,0.0,0,0,0,0,0,0,0,1,0,0,1,1
3821,53790,F6SQlqazEZ0w5BjMwjWgS37WY6aKoLpg,SpATywNh6bZuzm8s1ceuBUnMUAeoAHHw,25,42,1,21,1,31,16,1,113,16.142857142857142,1,0.0,10,1,20,1,32,31,1,16,1,32,81,1
3822,53800,j69quqIKpcCSzqXo9ZsaY7H1y4DglvlA,SpATywNh6bZuzm8s1ceuBUnMUAeoAHHw,8,6,4,0,3,1,3,0,17,2.4285714285714284,2,0.0,0,4,0,3,6,1,0,3,0,7,10,1
3823,53801,JVippbCdijsZvDTgzyPclP2OizOfI7bg,SpATywNh6bZuzm8s1ceuBUnMUAeoAHHw,26,32,15,26,7,5,5,0,90,12.857142857142858,2,0.0,5,15,21,7,27,5,5,5,0,48,42,1
3824,53811,VMIa4tT0g1D8FcJ7AhOiLBIndESbZgIA,A3fsA9Zfv1X2fVEQhTw51lKENdNrEqT3,1,0,0,0,0,0,1,0,1,0.14285714285714285,1,0.0,0,0,0,0,0,0,0,1,0,0,1,1
3825,53813,JfKuoH41ocsNDmphdAQOIFuKNZWqJJwf,SpATywNh6bZuzm8s1ceuBUnMUAeoAHHw,29,48,31,25,1,172,27,2,306,43.714285714285715,5,0.0,4,31,22,1,44,172,3,27,2,58,248,1
3826,53815,zSmc8rKmn3W7ClGZoLsZk5lSBVQHeitz,SpATywNh6bZuzm8s1ceuBUnMUAeoAHHw,17,23,1,10,1,0,26,0,61,8.714285714285714,6,0.0,2,1,8,1,21,0,2,26,0,12,49,0
3827,53828,anpgTlAzqtcn1vI43094PZ2LMGoPXQz9,SpATywNh6bZuzm8s1ceuBUnMUAeoAHHw,8,9,4,0,1,12,7,0,33,4.714285714285714,2,0.0,3,4,0,1,6,12,0,7,0,8,25,1
3828,53838,QApdmb1PXR97hGOt28aAXkYQiicNqOKw,SpATywNh6bZuzm8s1ceuBUnMUAeoAHHw,21,30,1,28,1,0,10,1,71,10.142857142857142,2,0.0,7,1,26,1,23,0,2,10,1,35,36,0
3829,53842,tN95ymRxU88OqvEeFVj1h9MemYWUdm2H,A3fsA9Zfv1X2fVEQhTw51lKENdNrEqT3,21,12,9,0,8,0,3,0,32,4.571428571428571,2,0.0,0,9,0,8,12,0,0,3,0,17,15,1
3830,53849,gSVGAbR6ZoNLN4J93dYtc3hGFE6M7IrZ,SpATywNh6bZuzm8s1ceuBUnMUAeoAHHw,5,2,0,0,0,0,3,0,5,0.7142857142857143,1,0.0,0,0,0,0,2,0,0,3,0,0,5,1
3831,53858,6Upqh8KDtBiZuS1AWTucTCCkEJCPfX5m,SpATywNh6bZuzm8s1ceuBUnMUAeoAHHw,23,77,2,42,1,141,14,0,277,39.57142857142857,8,0.0,33,2,34,1,44,141,8,14,0,70,207,0
3832,53861,Su9COtUoYOdyYjAUoqvAULKdQODTHr7E,bWdj2GDclj5ofokWjzoa5jAwMkxCykd6,49,104,36,299,6,19,40,4,508,72.57142857142857,9,0.0,20,36,281,6,84,19,18,40,4,343,165,0
3833,53875,wgifE6A0kxnDEjw7myKTY39TRuCgYxaB,bWdj2GDclj5ofokWjzoa5jAwMkxCykd6,9,10,4,0,3,0,7,0,24,3.4285714285714284,4,0.0,0,4,0,3,10,0,0,7,0,7,17,1
3834,53877,cLYelk5eLuqZus5jIOPS82VsEcbwjlHd,SpATywNh6bZuzm8s1ceuBUnMUAeoAHHw,17,26,13,6,8,0,4,0,57,8.142857142857142,1,0.0,8,13,6,8,18,0,0,4,0,35,22,1
3835,53881,nEyHrNWAhCJiBBDbSB6IHu4lz50w5Dy6,A3fsA9Zfv1X2fVEQhTw51lKENdNrEqT3,17,14,10,0,7,0,6,0,37,5.285714285714286,4,0.0,0,10,0,7,14,0,0,6,0,17,20,1
3836,53895,Y0j1i2gPpBKnJTyvOTxYtV3JtU8UpMcv,SpATywNh6bZuzm8s1ceuBUnMUAeoAHHw,20,37,12,27,3,0,15,4,98,14.0,3,0.0,16,12,25,3,21,0,2,15,4,56,42,1
3837,53904,SjgqKMmF4tqpvhmgO66D1TdoOxgqcy2V,RXDvfPUBYFlVdlueBFbLW0mhhAyGEqpt,35,53,18,49,11,2,6,0,139,19.857142857142858,3,0.0,16,18,49,11,37,2,0,6,0,94,45,0
3838,53906,nCx7ByTflBYRKyE0yen5MKylk9XOx9rV,A3fsA9Zfv1X2fVEQhTw51lKENdNrEqT3,10,18,9,0,4,0,4,0,35,5.0,3,0.0,1,9,0,4,17,0,0,4,0,14,21,1
3839,53913,a2z9RsxlqGCqsHimTXs86MGbzWTI57AJ,SpATywNh6bZuzm8s1ceuBUnMUAeoAHHw,11,9,6,5,4,1,2,0,27,3.857142857142857,1,0.0,2,6,4,4,7,1,1,2,0,16,11,1
3840,53917,4S03noH7cjIbR4dHJ5qcypZRCrtfcYb6,bWdj2GDclj5ofokWjzoa5jAwMkxCykd6,16,28,3,10,2,11,8,2,64,9.142857142857142,5,0.0,3,3,10,2,25,11,0,8,2,18,46,1
3841,53923,hiq4p9Wpf1ENeqXLCQsPukhDTDL2bNA2,RXDvfPUBYFlVdlueBFbLW0mhhAyGEqpt,27,36,15,33,3,18,21,5,131,18.714285714285715,4,0.0,14,15,31,3,22,18,2,21,5,63,68,0
3842,53939,JUQwyjRts4o299yp6PZYUiNur6LnV5UN,SpATywNh6bZuzm8s1ceuBUnMUAeoAHHw,7,5,1,0,1,0,2,0,9,1.2857142857142858,1,0.0,0,1,0,1,5,0,0,2,0,2,7,1
3843,53947,cL4725Y58Cl01IjeOv5CCdtpjNF0EqJp,SpATywNh6bZuzm8s1ceuBUnMUAeoAHHw,13,23,13,0,4,7,9,1,57,8.142857142857142,5,0.0,3,13,0,4,20,7,0,9,1,20,37,1
3844,53958,wcSIko8HPcmbs4cOPlImi3EyazICOLlR,bWdj2GDclj5ofokWjzoa5jAwMkxCykd6,2,0,0,0,0,0,9,0,9,1.2857142857142858,4,0.0,0,0,0,0,0,0,0,9,0,0,9,1
3845,53962,HH3HV5HDJ35z2ldQAEIDXBOSBTxLd6O9,bWdj2GDclj5ofokWjzoa5jAwMkxCykd6,20,19,9,118,7,1,12,1,167,23.857142857142858,4,0.0,7,9,113,7,12,1,5,12,1,136,31,1
3846,53968,561j5AofjwKlXet6wIEWLTESu761wNuJ,SpATywNh6bZuzm8s1ceuBUnMUAeoAHHw,10,12,6,0,3,9,6,1,37,5.285714285714286,1,0.0,0,6,0,3,12,9,0,6,1,9,28,1
3847,53980,f50myi7Wnjd1BWfZdyqaXMcdfMAdeGX9,G8EPVSXsOYB5YQWZGiz1aVq5Pgr2GrQu,105,136,0,233,2,40,36,1,448,64.0,16,0.0,56,0,188,2,80,40,45,36,1,246,202,0
3848,53983,R48KCTeb8uSJLAUTCApWBwkMVREjjMDW,A3fsA9Zfv1X2fVEQhTw51lKENdNrEqT3,24,5,3,87,0,2,8,1,106,15.142857142857142,1,0.0,1,3,71,0,4,2,16,8,1,75,31,1
3849,53992,srF76iHf3IXwkM0p0daLjk1LYx1sO9QO,A3fsA9Zfv1X2fVEQhTw51lKENdNrEqT3,43,69,4,68,5,1,16,1,164,23.428571428571427,2,0.0,7,4,59,5,62,1,9,16,1,75,89,1
3850,54001,Gglvz7f1jVuISouyvTJRaLDdezGOZ6EL,SpATywNh6bZuzm8s1ceuBUnMUAeoAHHw,29,59,13,34,7,11,22,1,147,21.0,6,0.0,12,13,29,7,47,11,5,22,1,61,86,0
3851,54002,FHrj4N2SCEsxza13qmFjgJkCjs8BkrF3,bWdj2GDclj5ofokWjzoa5jAwMkxCykd6,18,36,22,68,8,22,22,2,180,25.714285714285715,4,0.0,5,22,61,8,31,22,7,22,2,96,84,1
3852,54009,U2oiAxypJX3TTENRYPio3LHOtQ2XmXGS,SpATywNh6bZuzm8s1ceuBUnMUAeoAHHw,25,50,19,17,6,4,17,1,114,16.285714285714285,4,0.0,12,19,14,6,38,4,3,17,1,51,63,0
3853,54015,Uo49WNvktWkKOAhlqrqOXLXaeoQpAgrc,SpATywNh6bZuzm8s1ceuBUnMUAeoAHHw,15,17,2,15,2,0,3,0,39,5.571428571428571,3,0.0,8,2,14,2,9,0,1,3,0,26,13,1
3854,54018,dyoINQ9hlelfXhGgA7SokU45MaV6r2b8,SpATywNh6bZuzm8s1ceuBUnMUAeoAHHw,29,25,16,26,8,2,4,0,81,11.571428571428571,3,0.0,5,16,21,8,20,2,5,4,0,50,31,0
3855,54023,n7yQ1FvfAXqDnBpszfIUjZkrvw3J2aJC,bWdj2GDclj5ofokWjzoa5jAwMkxCykd6,2,0,0,0,0,0,2,0,2,0.2857142857142857,1,0.0,0,0,0,0,0,0,0,2,0,0,2,1
3856,54026,gw1ywpstRy3gY1kWojp1woauzVM2ZYVr,SpATywNh6bZuzm8s1ceuBUnMUAeoAHHw,24,45,30,12,12,0,14,0,113,16.142857142857142,5,0.0,2,30,9,12,43,0,3,14,0,53,60,0
3857,54027,0S1IMyqlmBJaUdNY6QqTX948M0Vx0tcJ,SpATywNh6bZuzm8s1ceuBUnMUAeoAHHw,13,18,6,0,3,0,3,0,30,4.285714285714286,2,0.0,0,6,0,3,18,0,0,3,0,9,21,1
3858,54029,So8gZ8cXseEZ7lXf4idNMqcN46bXtlIA,SpATywNh6bZuzm8s1ceuBUnMUAeoAHHw,24,40,20,17,14,4,11,0,106,15.142857142857142,7,0.0,11,20,14,14,29,4,3,11,0,59,47,0
3859,54048,pXLwXf6zUsqL9SOfZNShdqFixygLJrWR,SpATywNh6bZuzm8s1ceuBUnMUAeoAHHw,7,4,2,0,2,0,2,0,10,1.4285714285714286,1,0.0,1,2,0,2,3,0,0,2,0,5,5,1
3860,54056,HLuhLxGFPt6I9n1CokhbKviDPHHdGO60,G8EPVSXsOYB5YQWZGiz1aVq5Pgr2GrQu,4,2,0,0,0,0,2,0,4,0.5714285714285714,1,0.0,0,0,0,0,2,0,0,2,0,0,4,1
3861,54062,1zcBOliKKVXK419jHsqjZGpz654bIAn5,RXDvfPUBYFlVdlueBFbLW0mhhAyGEqpt,24,42,23,42,13,13,6,1,140,20.0,3,0.0,10,23,40,13,32,13,2,6,1,86,54,1
3862,54071,vYeGcWGAJP4B8Lvbjdr2jkY9NnpHN8xb,SpATywNh6bZuzm8s1ceuBUnMUAeoAHHw,29,44,23,27,11,5,19,0,129,18.428571428571427,5,0.0,12,23,24,11,32,5,3,19,0,70,59,1
3863,54076,33fwsM5EFqk5KwLRS1Hdk3QGBr5jYWOs,SpATywNh6bZuzm8s1ceuBUnMUAeoAHHw,30,41,22,19,9,20,25,2,138,19.714285714285715,7,0.0,11,22,18,9,30,20,1,25,2,60,78,0
3864,54078,mzJ0trk582dssKvdbvvSr3OyxZiFuQ3P,bWdj2GDclj5ofokWjzoa5jAwMkxCykd6,11,13,2,0,1,1,6,1,24,3.4285714285714284,3,0.0,0,2,0,1,13,1,0,6,1,3,21,1
3865,54079,pJOjDRWW7Xh5i12ZiWoQnz8dZuNP8rXl,SpATywNh6bZuzm8s1ceuBUnMUAeoAHHw,11,18,8,0,5,2,1,0,34,4.857142857142857,1,0.0,2,8,0,5,16,2,0,1,0,15,19,1
3866,54082,4LX6gYDKcYMBLDa9yuezfCQG1GKo9eu8,SpATywNh6bZuzm8s1ceuBUnMUAeoAHHw,5,8,0,0,0,0,7,0,15,2.142857142857143,1,0.0,0,0,0,0,8,0,0,7,0,0,15,1
3867,54083,QYVRHTpooyTkzSbIywJ7ri5o4t73Xwty,RXDvfPUBYFlVdlueBFbLW0mhhAyGEqpt,1,0,0,0,0,0,1,0,1,0.14285714285714285,1,0.0,0,0,0,0,0,0,0,1,0,0,1,1
3868,54085,BQCssLSYZBRoNs0A82WS0r6vRVhdQKvg,SpATywNh6bZuzm8s1ceuBUnMUAeoAHHw,9,6,4,0,2,0,3,0,15,2.142857142857143,1,0.0,0,4,0,2,6,0,0,3,0,6,9,1
3869,54088,7Xq01ZEcLJ8EiJEfAlByyafLSPE4vuef,SpATywNh6bZuzm8s1ceuBUnMUAeoAHHw,5,3,2,0,0,0,2,0,7,1.0,1,0.0,0,2,0,0,3,0,0,2,0,2,5,1
3870,54094,Fdt86Xu5OLPdaOgl6M1XDpiJ3zar7SU6,SpATywNh6bZuzm8s1ceuBUnMUAeoAHHw,27,45,11,65,3,2,17,4,147,21.0,5,0.0,19,11,57,3,26,2,8,17,4,90,57,0
3871,54103,uEA5Un9wAGiDxjEkoYiTUGhoxCFEEvwr,SpATywNh6bZuzm8s1ceuBUnMUAeoAHHw,1,0,0,0,0,0,1,0,1,0.14285714285714285,1,0.0,0,0,0,0,0,0,0,1,0,0,1,1
3872,54113,Dpj1ute7yeokptEET2ZfYuubDiXNwLXm,A3fsA9Zfv1X2fVEQhTw51lKENdNrEqT3,9,13,7,0,4,0,2,0,26,3.7142857142857144,2,0.0,0,7,0,4,13,0,0,2,0,11,15,1
3873,54121,nVNeaHavpiSEFe567sT2ScRxObLjhEGL,G8EPVSXsOYB5YQWZGiz1aVq5Pgr2GrQu,39,31,22,140,9,6,6,0,214,30.571428571428573,4,0.0,0,22,120,9,31,6,20,6,0,151,63,1
3874,54123,b5xbU8SGcZEvpqzyP6Qk6welzZOUxOvx,A3fsA9Zfv1X2fVEQhTw51lKENdNrEqT3,9,6,2,0,2,0,5,0,15,2.142857142857143,2,0.0,0,2,0,2,6,0,0,5,0,4,11,1
3875,54129,qKOvjGeHnXAGhScloNy1qhNnfc1xHZ3T,SpATywNh6bZuzm8s1ceuBUnMUAeoAHHw,25,138,3,36,3,122,55,5,362,51.714285714285715,11,0.0,38,3,28,3,100,122,8,55,5,72,290,0
3876,54132,PfTpx7WgTJY6IpNokJ2POml34GMs7LTI,bWdj2GDclj5ofokWjzoa5jAwMkxCykd6,47,32,17,96,9,8,12,0,174,24.857142857142858,5,0.0,8,17,93,9,24,8,3,12,0,127,47,0
3877,54133,jU9n6p1KRt3F2eM3pIcFgt7azc85bbxP,SpATywNh6bZuzm8s1ceuBUnMUAeoAHHw,18,46,28,0,18,6,25,1,124,17.714285714285715,4,0.0,3,28,0,18,43,6,0,25,1,49,75,1
3878,54134,BtB75B9l8XyH0uPaKeOkkRrm2NqBrtQe,A3fsA9Zfv1X2fVEQhTw51lKENdNrEqT3,31,24,18,0,15,0,9,0,66,9.428571428571429,7,0.0,0,18,0,15,24,0,0,9,0,33,33,1
3879,54137,kdSq236IYQMsCu2OjWxBROoAPTYOBg4Z,A3fsA9Zfv1X2fVEQhTw51lKENdNrEqT3,1,0,0,0,0,0,1,0,1,0.14285714285714285,1,0.0,0,0,0,0,0,0,0,1,0,0,1,1
3880,54138,cZ43eywkms9yBmvkdibtxlcZqrcdFmmE,SpATywNh6bZuzm8s1ceuBUnMUAeoAHHw,10,8,4,0,0,2,6,1,21,3.0,2,0.0,2,4,0,0,6,2,0,6,1,6,15,1
3881,54140,2Bc3e8bWl6DTvfTPBZCyShFFG8OApkva,A3fsA9Zfv1X2fVEQhTw51lKENdNrEqT3,9,11,5,0,3,0,2,0,21,3.0,2,0.0,0,5,0,3,11,0,0,2,0,8,13,1
3882,54144,oEOiBLMr97GK8O9ympHG9NMLQODJ0Xam,bWdj2GDclj5ofokWjzoa5jAwMkxCykd6,1,0,0,0,0,0,1,0,1,0.14285714285714285,1,0.0,0,0,0,0,0,0,0,1,0,0,1,1
3883,54145,uL6960SAwN5kJgcsaw9m5ztApNeZFO95,A3fsA9Zfv1X2fVEQhTw51lKENdNrEqT3,40,32,23,56,12,0,10,0,133,19.0,3,0.0,2,23,50,12,30,0,6,10,0,87,46,1
3884,54149,oEOiBLMr97GK8O9ympHG9NMLQODJ0Xam,SpATywNh6bZuzm8s1ceuBUnMUAeoAHHw,1,0,0,0,0,0,1,0,1,0.14285714285714285,1,0.0,0,0,0,0,0,0,0,1,0,0,1,1
3885,54153,1rAHmNrxrqnzHEQFMlydmQ968LsZW0oG,A3fsA9Zfv1X2fVEQhTw51lKENdNrEqT3,18,12,9,0,5,0,9,0,35,5.0,3,0.0,0,9,0,5,12,0,0,9,0,14,21,1
3886,54176,i2jPckJdA9hhx8KLohXM0CrojRerYpdv,SpATywNh6bZuzm8s1ceuBUnMUAeoAHHw,32,134,57,49,21,68,45,12,386,55.142857142857146,9,0.0,54,57,39,21,80,68,10,45,12,171,215,0
3887,54185,0fPKzumQAfSwGfxF7d6bvXWcsMGpFXOP,SpATywNh6bZuzm8s1ceuBUnMUAeoAHHw,30,46,19,28,9,6,8,2,118,16.857142857142858,5,0.0,7,19,26,9,39,6,2,8,2,61,57,0
3888,54199,yhj9ME5eIWuvrbwWqT7KNKtjeY6yuvxW,A3fsA9Zfv1X2fVEQhTw51lKENdNrEqT3,4,0,0,0,0,1,4,2,7,1.0,1,0.0,0,0,0,0,0,1,0,4,2,0,7,1
3889,54226,l3sfUHhSnAdS6GAthlSM3lKuUCRdk9CZ,A3fsA9Zfv1X2fVEQhTw51lKENdNrEqT3,21,14,8,62,2,0,5,0,91,13.0,3,0.0,2,8,48,2,12,0,14,5,0,60,31,1
3890,54231,o6TNCL8FasDR1iE3PXeICx9M4vKCc0T1,bWdj2GDclj5ofokWjzoa5jAwMkxCykd6,6,1,1,0,1,0,5,0,8,1.1428571428571428,2,0.0,0,1,0,1,1,0,0,5,0,2,6,1
3891,54233,o6TNCL8FasDR1iE3PXeICx9M4vKCc0T1,A3fsA9Zfv1X2fVEQhTw51lKENdNrEqT3,1,0,0,0,0,0,1,0,1,0.14285714285714285,1,0.0,0,0,0,0,0,0,0,1,0,0,1,1
3892,54238,V9HQPxlLSz0QiOl8p8UTUo6CstrlztcH,SpATywNh6bZuzm8s1ceuBUnMUAeoAHHw,4,2,0,0,0,0,2,0,4,0.5714285714285714,1,0.0,0,0,0,0,2,0,0,2,0,0,4,1
3893,54285,Io3VzTK6sP3a0ZVRKkRhFNz8A2ULjris,bWdj2GDclj5ofokWjzoa5jAwMkxCykd6,2,0,0,0,0,0,3,0,3,0.42857142857142855,1,0.0,0,0,0,0,0,0,0,3,0,0,3,1
3894,54287,kuiW3Le0WeMGiwxmKgXwp1GfHw3vKMeq,SpATywNh6bZuzm8s1ceuBUnMUAeoAHHw,11,7,4,4,3,0,3,0,21,3.0,3,0.0,1,4,4,3,6,0,0,3,0,12,9,1
3895,54306,pQnR1td8vlxsKseVpfzZVvCBdR2iP4U6,A3fsA9Zfv1X2fVEQhTw51lKENdNrEqT3,16,18,6,0,4,0,11,0,39,5.571428571428571,4,0.0,0,6,0,4,18,0,0,11,0,10,29,0
3896,54312,np300nKbgkFp0EFcdJyIdPu3KUkiYdwY,G8EPVSXsOYB5YQWZGiz1aVq5Pgr2GrQu,6,4,1,0,1,0,2,0,8,1.1428571428571428,1,0.0,0,1,0,1,4,0,0,2,0,2,6,1
3897,54316,64OeQzK990rz5QNrMOQujVxWZWc38bZL,SpATywNh6bZuzm8s1ceuBUnMUAeoAHHw,17,11,7,11,4,0,3,0,36,5.142857142857143,2,0.0,2,7,11,4,9,0,0,3,0,24,12,1
3898,54321,qgHNkIIeFGRC3Bav4KufUnqlMzkDetSU,bWdj2GDclj5ofokWjzoa5jAwMkxCykd6,20,31,13,54,10,8,12,1,129,18.428571428571427,4,0.0,8,13,51,10,23,8,3,12,1,82,47,0
3899,54341,bJm6vpekKjS0vCZZW0loTWMZ3NWdcX0T,SpATywNh6bZuzm8s1ceuBUnMUAeoAHHw,1,0,0,0,0,0,1,0,1,0.14285714285714285,1,0.0,0,0,0,0,0,0,0,1,0,0,1,1
3900,54344,M7Vbw5q1oL32IfEMSI9AM5uHCUMDFHmm,bWdj2GDclj5ofokWjzoa5jAwMkxCykd6,1,0,0,0,0,0,1,0,1,0.14285714285714285,1,0.0,0,0,0,0,0,0,0,1,0,0,1,1
3901,54345,7P3XgLwfwlFBQozc5Gty8UBmzZ1wk3nf,bWdj2GDclj5ofokWjzoa5jAwMkxCykd6,3,5,1,0,1,0,1,0,8,1.1428571428571428,1,0.0,3,1,0,1,2,0,0,1,0,5,3,1
3902,54352,pQnR1td8vlxsKseVpfzZVvCBdR2iP4U6,RXDvfPUBYFlVdlueBFbLW0mhhAyGEqpt,5,2,1,0,1,0,2,0,6,0.8571428571428571,1,0.0,0,1,0,1,2,0,0,2,0,2,4,1
3903,54378,wykDdjB45pC3zZUNNLpkNXDJGEatsGFp,SpATywNh6bZuzm8s1ceuBUnMUAeoAHHw,1,0,0,0,0,0,1,0,1,0.14285714285714285,1,0.0,0,0,0,0,0,0,0,1,0,0,1,1
3904,54389,Dpj1ute7yeokptEET2ZfYuubDiXNwLXm,SpATywNh6bZuzm8s1ceuBUnMUAeoAHHw,9,14,9,0,6,0,4,0,33,4.714285714285714,4,0.0,0,9,0,6,14,0,0,4,0,15,18,1
3905,54391,6GW7T2KXNaFy6SJDNV3BLn1vYIvac4zq,bWdj2GDclj5ofokWjzoa5jAwMkxCykd6,1,0,0,0,0,0,1,0,1,0.14285714285714285,1,0.0,0,0,0,0,0,0,0,1,0,0,1,1
3906,54398,lg3JWapmXZgNYOt38qBO2QsZMUBFS5SJ,G8EPVSXsOYB5YQWZGiz1aVq5Pgr2GrQu,84,127,54,180,32,19,24,2,438,62.57142857142857,6,0.0,61,54,136,32,66,19,44,24,2,283,155,0
3907,54399,6GW7T2KXNaFy6SJDNV3BLn1vYIvac4zq,A3fsA9Zfv1X2fVEQhTw51lKENdNrEqT3,21,16,12,0,11,0,1,0,40,5.714285714285714,1,0.0,1,12,0,11,15,0,0,1,0,24,16,1
3908,54411,UZrNs5yPvW1ZVC8d6wdut2Js7XUvysRH,SpATywNh6bZuzm8s1ceuBUnMUAeoAHHw,29,36,24,27,7,29,12,3,138,19.714285714285715,8,0.0,4,24,26,7,32,29,1,12,3,61,77,1
3909,54419,H4rucA3Bl92feiIFqEyA7i9inMfODBCx,SpATywNh6bZuzm8s1ceuBUnMUAeoAHHw,4,2,0,0,0,0,3,0,5,0.7142857142857143,1,0.0,0,0,0,0,2,0,0,3,0,0,5,0
3910,54447,6A2JLpLWnCwUlo9pD1HHlgEwNLvzcllv,A3fsA9Zfv1X2fVEQhTw51lKENdNrEqT3,25,38,27,12,14,0,7,0,98,14.0,4,0.0,2,27,10,14,36,0,2,7,0,53,45,1
3911,54458,w8ymvO72UlYPBd2tG0A8iTEwt4UoIvlZ,A3fsA9Zfv1X2fVEQhTw51lKENdNrEqT3,40,26,18,50,12,0,4,0,110,15.714285714285714,2,0.0,3,18,50,12,23,0,0,4,0,83,27,1
3912,54467,Ha2E1KX6VBrxAJ0Y64ONsTCt1RbrAdiK,SpATywNh6bZuzm8s1ceuBUnMUAeoAHHw,22,22,12,13,5,0,10,0,62,8.857142857142858,6,0.0,6,12,11,5,16,0,2,10,0,34,28,0
3913,54485,bbBKqbJ74sqbqRiQHsLpyapFJxr2Z728,SpATywNh6bZuzm8s1ceuBUnMUAeoAHHw,17,55,16,14,3,5,13,2,108,15.428571428571429,3,0.0,26,16,12,3,29,5,2,13,2,57,51,1
3914,54509,HPaDTzk2xymxbpoa0VdcxdHl3uFfOfZk,bWdj2GDclj5ofokWjzoa5jAwMkxCykd6,11,21,12,0,1,5,51,3,93,13.285714285714286,7,0.0,2,12,0,1,19,5,0,51,3,15,78,1
3915,54512,x6BtQH70uuLHaxqzHA21U9wmfT0SxzD9,SpATywNh6bZuzm8s1ceuBUnMUAeoAHHw,26,38,7,22,4,38,48,3,160,22.857142857142858,13,0.0,11,7,18,4,27,38,4,48,3,40,120,0
3916,54514,Xq1kPqflDNgXwQ2pEniNYUjMpkVzPp1m,bWdj2GDclj5ofokWjzoa5jAwMkxCykd6,5,8,3,0,0,0,2,0,13,1.8571428571428572,2,0.0,0,3,0,0,8,0,0,2,0,3,10,1
3917,54516,bYSbXmkovrv6ucz58VC2SSCMvEjrNo7x,SpATywNh6bZuzm8s1ceuBUnMUAeoAHHw,1,0,0,0,0,0,1,0,1,0.14285714285714285,1,0.0,0,0,0,0,0,0,0,1,0,0,1,1
3918,54518,CE7hlTWnMpoldcHVRqlfbEgzp5iUVo4d,SpATywNh6bZuzm8s1ceuBUnMUAeoAHHw,15,17,8,0,4,1,7,1,38,5.428571428571429,2,0.0,7,8,0,4,10,1,0,7,1,19,19,0
3919,54524,CxUPOQRaQMGLmbOcfniIQOhh24PXLDR6,bWdj2GDclj5ofokWjzoa5jAwMkxCykd6,17,40,14,30,4,13,9,0,110,15.714285714285714,8,0.0,8,14,26,4,32,13,4,9,0,52,58,0
3920,54528,MXVve1Eg6sXSXHh1Skrb0tjPJ9Wtb0M7,SpATywNh6bZuzm8s1ceuBUnMUAeoAHHw,5,2,1,0,1,0,4,0,8,1.1428571428571428,2,0.0,0,1,0,1,2,0,0,4,0,2,6,1
3921,54544,CF0PQ9PBY5Y16Xk8e9CdQNNLQnwOLSsu,bWdj2GDclj5ofokWjzoa5jAwMkxCykd6,7,9,1,0,2,0,4,0,16,2.2857142857142856,1,0.0,3,1,0,2,6,0,0,4,0,6,10,1
3922,54554,7kbuqNU54d8d11QmdSpTGAMhLhmSDka1,SpATywNh6bZuzm8s1ceuBUnMUAeoAHHw,9,6,2,2,0,0,5,0,15,2.142857142857143,1,0.0,1,2,2,0,5,0,0,5,0,5,10,1
3923,54555,7kbuqNU54d8d11QmdSpTGAMhLhmSDka1,G8EPVSXsOYB5YQWZGiz1aVq5Pgr2GrQu,13,13,4,0,2,0,5,0,24,3.4285714285714284,1,0.0,6,4,0,2,7,0,0,5,0,12,12,1
3924,54558,jtxvuHBV8ZOgNnNCL1A1WerzR2TVfFNy,RXDvfPUBYFlVdlueBFbLW0mhhAyGEqpt,43,42,28,63,10,0,6,0,149,21.285714285714285,3,0.0,7,28,60,10,35,0,3,6,0,105,44,1
3925,54568,fUMqQuy71n3a3vBlGt3GhPdNsIerKaNG,SpATywNh6bZuzm8s1ceuBUnMUAeoAHHw,21,34,21,10,1,0,9,0,75,10.714285714285714,5,0.0,4,21,8,1,30,0,2,9,0,34,41,1
3926,54581,MF9uYxE1fYdj67HROuwgGArAcww4zZp4,bWdj2GDclj5ofokWjzoa5jAwMkxCykd6,1,0,0,0,0,0,1,0,1,0.14285714285714285,1,0.0,0,0,0,0,0,0,0,1,0,0,1,1
3927,54588,iL3U1k6BvBmHPE9rSR4M1VNouviCTM2t,fbPkOYLVPtPgIt0MxizjfFJov3JbHyAi,1,0,0,0,0,0,1,0,1,0.14285714285714285,1,0.0,0,0,0,0,0,0,0,1,0,0,1,1
3928,54593,S5r0CKOxIwwZ6o4r0E3DEfNq3HUydzP8,fbPkOYLVPtPgIt0MxizjfFJov3JbHyAi,5,2,1,0,1,0,2,0,6,0.8571428571428571,1,0.0,0,1,0,1,2,0,0,2,0,2,4,0
3929,54595,jMSxxfftYD0taGWVEUZkcvxpGucC0j8q,fbPkOYLVPtPgIt0MxizjfFJov3JbHyAi,4,5,3,0,0,0,1,0,9,1.2857142857142858,1,0.0,0,3,0,0,5,0,0,1,0,3,6,1
3930,54604,X3X3klM03RXeGUjty93sg2SlkZrg3xpQ,fbPkOYLVPtPgIt0MxizjfFJov3JbHyAi,9,9,5,0,3,0,2,0,19,2.7142857142857144,2,0.0,1,5,0,3,8,0,0,2,0,9,10,1
3931,54606,JKXm7kCLnrEkQn6smb2KejU80afBEA8I,fbPkOYLVPtPgIt0MxizjfFJov3JbHyAi,7,2,1,0,1,2,5,0,11,1.5714285714285714,1,0.0,0,1,0,1,2,2,0,5,0,2,9,1
3932,54616,cgTRAnMuMn887xEhHTcg5rpmYHHPoyIP,fbPkOYLVPtPgIt0MxizjfFJov3JbHyAi,60,122,57,44,36,45,21,1,326,46.57142857142857,6,0.0,51,57,40,36,71,45,4,21,1,184,142,0
3933,54620,z4EDsyht0TzSAKAyhX4LHmg2BH9dRlQd,fbPkOYLVPtPgIt0MxizjfFJov3JbHyAi,11,5,4,0,3,5,5,1,23,3.2857142857142856,1,0.0,0,4,0,3,5,5,0,5,1,7,16,1
3934,54621,NBbu054C30RuH0I4yDic7caWEQZO4bn5,fbPkOYLVPtPgIt0MxizjfFJov3JbHyAi,12,29,8,4,6,11,12,1,71,10.142857142857142,2,0.0,8,8,3,6,21,11,1,12,1,25,46,1
3935,54625,OJlmjkvuQW4IsXhvjyjAhhq68S3friGW,fbPkOYLVPtPgIt0MxizjfFJov3JbHyAi,20,33,10,12,13,1,8,1,78,11.142857142857142,2,0.0,20,10,10,13,13,1,2,8,1,53,25,1
3936,54629,AkvoyA0ovU8KwnK8lPG0oOHqQo6t4vfK,fbPkOYLVPtPgIt0MxizjfFJov3JbHyAi,24,28,21,0,14,6,17,2,88,12.571428571428571,2,0.0,3,21,0,14,25,6,0,17,2,38,50,1
3937,54646,gLf8tcvfqgbiET6dKZOWAuUewpIVftFZ,fbPkOYLVPtPgIt0MxizjfFJov3JbHyAi,9,14,6,4,4,0,2,0,30,4.285714285714286,1,0.0,6,6,4,4,8,0,0,2,0,20,10,0
3938,54660,LG6VIza4JcQFFbXQ1PDBU7m3JeA6BbpC,fbPkOYLVPtPgIt0MxizjfFJov3JbHyAi,24,30,15,17,19,25,15,3,124,17.714285714285715,1,0.0,14,15,14,19,16,25,3,15,3,62,62,1
3939,54668,KEpGXvdRkmZf3PNthZY5jtIyu6Bw3Rlp,SpATywNh6bZuzm8s1ceuBUnMUAeoAHHw,31,43,21,22,7,8,28,1,130,18.571428571428573,4,0.0,13,21,20,7,30,8,2,28,1,61,69,1
3940,54721,5FY4ZrNjp3ms2uO9UJ9szCrbCrZUttRZ,7GRhBDsirIGkRZBtSMEzNTyDr2JQm4xx,5,3,1,0,1,0,1,0,6,0.8571428571428571,1,0.0,0,1,0,1,3,0,0,1,0,2,4,1
3941,54723,z5Ulo2w0cg5OjY2Cx9aYoywDQvm6hLIF,RXDvfPUBYFlVdlueBFbLW0mhhAyGEqpt,15,25,18,0,7,0,10,0,60,8.571428571428571,8,0.0,0,18,0,7,25,0,0,10,0,25,35,0
3942,54724,XfiCSk5eLAbq9rzQtnLkX2OQTd6M8xFG,bWdj2GDclj5ofokWjzoa5jAwMkxCykd6,48,55,20,60,11,0,22,0,168,24.0,5,0.0,11,20,60,11,44,0,0,22,0,102,66,0
3943,54731,EBk8CcgfO89MwmYfmQzxphOJxpVE6Uvu,bWdj2GDclj5ofokWjzoa5jAwMkxCykd6,6,3,1,0,1,3,6,0,14,2.0,1,0.0,0,1,0,1,3,3,0,6,0,2,12,1
3944,54736,16QzaT3BGZQ3ycViO0KNFfkskSZdjqFw,SpATywNh6bZuzm8s1ceuBUnMUAeoAHHw,31,46,17,31,11,11,13,1,130,18.571428571428573,4,0.0,10,17,25,11,36,11,6,13,1,63,67,0
3945,54761,MfwWTipzPsRtzbyiOZCobMuGSNow3sHg,SpATywNh6bZuzm8s1ceuBUnMUAeoAHHw,11,11,7,5,6,0,2,0,31,4.428571428571429,1,0.0,0,7,4,6,11,0,1,2,0,17,14,0
3946,54800,OseLd0Vj4CawbZPfZRznLZH5tivxQP68,SpATywNh6bZuzm8s1ceuBUnMUAeoAHHw,7,2,2,0,2,0,2,0,8,1.1428571428571428,1,0.0,0,2,0,2,2,0,0,2,0,4,4,1
3947,54810,T6JGf7KDvuej9SKYUMtG3FHgkPZQV429,A3fsA9Zfv1X2fVEQhTw51lKENdNrEqT3,8,4,2,0,2,0,3,0,11,1.5714285714285714,1,0.0,0,2,0,2,4,0,0,3,0,4,7,0
3948,54819,PkEcTe3rugNe3WrTlhHnV7MduvQXThEB,RXDvfPUBYFlVdlueBFbLW0mhhAyGEqpt,6,5,4,0,0,0,1,0,10,1.4285714285714286,1,0.0,0,4,0,0,5,0,0,1,0,4,6,1
3949,54823,NNTbkWufZqd6OEZ4OfeDtmQCNI4vEzJo,A3fsA9Zfv1X2fVEQhTw51lKENdNrEqT3,2,0,0,0,0,0,4,0,4,0.5714285714285714,2,0.0,0,0,0,0,0,0,0,4,0,0,4,1
3950,54837,2AWz8OiYqJqT0VYmevCkAuxaVCSl88oB,7GRhBDsirIGkRZBtSMEzNTyDr2JQm4xx,1,0,0,0,0,0,1,0,1,0.14285714285714285,1,0.0,0,0,0,0,0,0,0,1,0,0,1,1
3951,54871,H2pnCC5fUi5Ho09aPqAE97vnlsM8FGBU,bWdj2GDclj5ofokWjzoa5jAwMkxCykd6,9,8,5,12,2,0,3,0,30,4.285714285714286,2,0.0,0,5,9,2,8,0,3,3,0,16,14,1
3952,54876,tVqiyi20xeAPqMyQ1qSspr9PuF7fr80u,SpATywNh6bZuzm8s1ceuBUnMUAeoAHHw,9,6,4,0,3,1,4,0,18,2.5714285714285716,1,0.0,0,4,0,3,6,1,0,4,0,7,11,1
3953,54879,bT6yH99PTuyz3a6ueCehCDHIMjMdNYHB,SpATywNh6bZuzm8s1ceuBUnMUAeoAHHw,16,16,8,18,4,7,2,0,55,7.857142857142857,2,0.0,6,8,15,4,10,7,3,2,0,33,22,1
3954,54910,L8A0UDBue4RuYlwBFsU412yruT49eHlP,7GRhBDsirIGkRZBtSMEzNTyDr2JQm4xx,6,4,1,0,0,0,8,0,13,1.8571428571428572,1,0.0,0,1,0,0,4,0,0,8,0,1,12,1
3955,54937,o076ufFxYjFcAtg8dPv0W5vwk5oKbSiz,SpATywNh6bZuzm8s1ceuBUnMUAeoAHHw,13,17,11,0,5,0,7,1,41,5.857142857142857,4,0.0,0,11,0,5,17,0,0,7,1,16,25,1
3956,54942,ijpfz5cJPrusRBczJIwOiwlUzdR9aysy,SpATywNh6bZuzm8s1ceuBUnMUAeoAHHw,23,36,16,16,6,0,12,0,86,12.285714285714286,5,0.0,14,16,15,6,22,0,1,12,0,51,35,0
3957,54944,ak9H3u3GmnBMjkxaXtGHxcLDDF2zUXnS,7GRhBDsirIGkRZBtSMEzNTyDr2JQm4xx,2,0,0,0,0,0,3,0,3,0.42857142857142855,1,0.0,0,0,0,0,0,0,0,3,0,0,3,1
3958,54973,KIPXc8MOqmnlmMqnIzIeaBqliIw9pS44,A3fsA9Zfv1X2fVEQhTw51lKENdNrEqT3,13,13,9,0,5,0,4,0,31,4.428571428571429,2,0.0,0,9,0,5,13,0,0,4,0,14,17,1
3959,54989,DUw85TcNpxyZaZKIM1HlHxvgtSm7uwxY,A3fsA9Zfv1X2fVEQhTw51lKENdNrEqT3,7,3,1,0,1,0,8,1,14,2.0,2,0.0,0,1,0,1,3,0,0,8,1,2,12,1
3960,54999,4RUK0a6HkZbpdBgheC58rw27wDnlPa70,7GRhBDsirIGkRZBtSMEzNTyDr2JQm4xx,10,8,3,0,4,2,5,1,23,3.2857142857142856,1,0.0,4,3,0,4,4,2,0,5,1,11,12,1
3961,55026,7GuXtdTnAtax3FkfgWewqF5JrGz1oCyt,7GRhBDsirIGkRZBtSMEzNTyDr2JQm4xx,1,0,0,0,0,0,1,0,1,0.14285714285714285,1,0.0,0,0,0,0,0,0,0,1,0,0,1,1
3962,55039,0Au7FrQGJI1dB5PAH0C5RtkL9GE7xsrQ,SpATywNh6bZuzm8s1ceuBUnMUAeoAHHw,13,25,9,0,5,1,9,0,49,7.0,6,0.0,1,9,0,5,24,1,0,9,0,15,34,1
3963,55082,UbxAJQUpM4nPUifCeu8NjmX0juFyLMFH,SpATywNh6bZuzm8s1ceuBUnMUAeoAHHw,13,16,1,12,1,0,5,0,35,5.0,4,0.0,2,1,12,1,14,0,0,5,0,16,19,1
3964,55105,5ysSxswt94Gjj7n5OSEcRzDBWhgbKFUg,7GRhBDsirIGkRZBtSMEzNTyDr2JQm4xx,8,11,4,6,4,0,2,0,27,3.857142857142857,2,0.0,5,4,5,4,6,0,1,2,0,18,9,1
3965,55114,7U7MZiTthIrdSyitYp5jXYVRqrLWtNBu,7GRhBDsirIGkRZBtSMEzNTyDr2JQm4xx,11,10,0,0,0,0,4,0,14,2.0,1,0.0,0,0,0,0,10,0,0,4,0,0,14,1
3966,55135,GaaUSAn7OjFLzHXXBEBVyi3shjmvN0lH,A3fsA9Zfv1X2fVEQhTw51lKENdNrEqT3,4,4,3,0,2,0,2,0,11,1.5714285714285714,1,0.0,0,3,0,2,4,0,0,2,0,5,6,1
3967,55164,ELrr1JfnDsWjEvT48HXDtL9YqiQpfZmF,A3fsA9Zfv1X2fVEQhTw51lKENdNrEqT3,4,2,1,0,1,0,2,0,6,0.8571428571428571,1,0.0,0,1,0,1,2,0,0,2,0,2,4,1
3968,55182,VF14jDCwIzSb92Zq60K5zB8BaUbLT4fN,A3fsA9Zfv1X2fVEQhTw51lKENdNrEqT3,32,30,1,81,0,2,6,0,120,17.142857142857142,1,0.0,2,1,69,0,28,2,12,6,0,72,48,1
3969,55190,T71AtVPaJkGSIyo6SH0vxJiIfo9P5xoJ,bWdj2GDclj5ofokWjzoa5jAwMkxCykd6,1,0,0,0,0,0,2,0,2,0.2857142857142857,1,0.0,0,0,0,0,0,0,0,2,0,0,2,0
3970,55215,RHl3DsvAX7TisJ7qBptmgrrtDAQvH7mr,7GRhBDsirIGkRZBtSMEzNTyDr2JQm4xx,5,4,2,0,1,0,2,0,9,1.2857142857142858,2,0.0,0,2,0,1,4,0,0,2,0,3,6,1
3971,55220,nPRsjektHdbQkeAf1fIK4JbhrESPbPsA,RXDvfPUBYFlVdlueBFbLW0mhhAyGEqpt,8,6,1,0,0,2,5,1,15,2.142857142857143,1,0.0,0,1,0,0,6,2,0,5,1,1,14,1
3972,55252,SFUf9a1eQYyFSfDqOIKMZYV7yqLnThV1,SpATywNh6bZuzm8s1ceuBUnMUAeoAHHw,12,9,1,14,1,1,1,0,27,3.857142857142857,1,0.0,2,1,13,1,7,1,1,1,0,17,10,0
3973,55295,XmfaTDISWF5comI3j0oigEszknbdPhWn,7GRhBDsirIGkRZBtSMEzNTyDr2JQm4xx,1,0,0,0,0,0,2,0,2,0.2857142857142857,1,0.0,0,0,0,0,0,0,0,2,0,0,2,1
3974,55343,YPEupTuOqSGieSSneZcv3AcUcSBCtbGY,7GRhBDsirIGkRZBtSMEzNTyDr2JQm4xx,8,10,1,6,1,1,3,0,22,3.142857142857143,2,0.0,3,1,5,1,7,1,1,3,0,10,12,1
3975,55346,7bnGjPq4sg9VhmEEoEqqXHNgeEpEuUDV,SpATywNh6bZuzm8s1ceuBUnMUAeoAHHw,26,27,11,20,6,21,8,2,95,13.571428571428571,5,0.0,5,11,20,6,22,21,0,8,2,42,53,0
3976,55350,FbrKChJI6NE19RCUX3nZg6RKzVDriIZa,7GRhBDsirIGkRZBtSMEzNTyDr2JQm4xx,1,0,0,0,0,0,1,0,1,0.14285714285714285,1,0.0,0,0,0,0,0,0,0,1,0,0,1,1
3977,55358,eeotL07J3Y8VeL6DbnIqkm9FhuiNkg7O,SpATywNh6bZuzm8s1ceuBUnMUAeoAHHw,19,19,10,0,6,2,7,1,45,6.428571428571429,3,0.0,7,10,0,6,12,2,0,7,1,23,22,0
3978,55376,avsFLymnsxrXULvKpllQNNUZoqF0bJ35,SpATywNh6bZuzm8s1ceuBUnMUAeoAHHw,23,26,9,19,5,0,5,1,65,9.285714285714286,3,0.0,4,9,19,5,22,0,0,5,1,37,28,0
3979,55409,LuPgMCIdX2ugHzDAngaEsA394qOat0id,7GRhBDsirIGkRZBtSMEzNTyDr2JQm4xx,4,6,1,0,1,0,1,0,9,1.2857142857142858,1,0.0,3,1,0,1,3,0,0,1,0,5,4,1
3980,55425,iDV5to1cYevkdTWvpbQHbqC1rLSJxp3m,SpATywNh6bZuzm8s1ceuBUnMUAeoAHHw,29,48,16,28,11,11,9,0,123,17.571428571428573,2,0.0,22,16,26,11,26,11,2,9,0,75,48,0
3981,55427,n5fmXY7W3OsRId8yMehdsktfc1GCY6un,7GRhBDsirIGkRZBtSMEzNTyDr2JQm4xx,16,20,10,34,3,12,4,0,83,11.857142857142858,1,0.0,6,10,28,3,14,12,6,4,0,47,36,0
3982,55468,kYJNxYDAilMvu34mGr6cbIsnQA0irwNN,bWdj2GDclj5ofokWjzoa5jAwMkxCykd6,7,5,2,0,2,0,2,0,11,1.5714285714285714,1,0.0,0,2,0,2,5,0,0,2,0,4,7,0
3983,55475,mDHr8WvVVX9KSvXMqxtLvZ6vP4uuNF6E,SpATywNh6bZuzm8s1ceuBUnMUAeoAHHw,13,25,1,23,0,7,5,1,62,8.857142857142858,1,0.0,17,1,19,0,8,7,4,5,1,37,25,1
3984,55483,C4q4gNQYEpjKh7pq1qjN8i3L7uSpUX9d,A3fsA9Zfv1X2fVEQhTw51lKENdNrEqT3,94,81,62,274,45,1,21,2,486,69.42857142857143,7,0.0,2,62,233,45,79,1,41,21,2,342,144,0
3985,55489,vCm3LfZ9M6wOLWnqELTZFsk5hnCTaEbi,SpATywNh6bZuzm8s1ceuBUnMUAeoAHHw,24,46,5,24,2,11,16,3,107,15.285714285714286,4,0.0,17,5,20,2,29,11,4,16,3,44,63,0
3986,55505,3DMtg3Ou9e33dDThiO2ndZwS8d6akzB7,RXDvfPUBYFlVdlueBFbLW0mhhAyGEqpt,18,15,1,0,2,2,6,0,26,3.7142857142857144,2,0.0,0,1,0,2,15,2,0,6,0,3,23,0
3987,55511,g1maG24WsPdpEOMuZUsxQc7SlEYHJjT4,SpATywNh6bZuzm8s1ceuBUnMUAeoAHHw,12,21,10,0,4,0,4,0,39,5.571428571428571,1,0.0,6,10,0,4,15,0,0,4,0,20,19,1
3988,55516,lgS8T7X8MPl4rnyyVo63W82KpUI1LtmK,SpATywNh6bZuzm8s1ceuBUnMUAeoAHHw,4,2,1,0,0,0,2,0,5,0.7142857142857143,1,0.0,0,1,0,0,2,0,0,2,0,1,4,1
3989,55524,Sle0t5zy0VbRjUdpojBY9wV6zuG12LCM,A3fsA9Zfv1X2fVEQhTw51lKENdNrEqT3,34,10,7,48,5,3,3,0,76,10.857142857142858,2,0.0,1,7,45,5,9,3,3,3,0,58,18,1
3990,55531,icc28ggRdRmZu2r1UuNBMEMav6yv5QTB,7GRhBDsirIGkRZBtSMEzNTyDr2JQm4xx,1,0,0,0,0,0,1,0,1,0.14285714285714285,1,0.0,0,0,0,0,0,0,0,1,0,0,1,1
3991,55532,vrKNA3eEZxLntZreFchejbQ8UgnPaTUE,RXDvfPUBYFlVdlueBFbLW0mhhAyGEqpt,16,12,7,6,4,0,3,0,32,4.571428571428571,1,0.0,4,7,6,4,8,0,0,3,0,21,11,1
3992,55536,lVM3D8yPmd62Fdb29hI2YI0VPwlNvI4t,7GRhBDsirIGkRZBtSMEzNTyDr2JQm4xx,5,2,1,0,1,0,3,0,7,1.0,2,0.0,0,1,0,1,2,0,0,3,0,2,5,1
3993,55537,QN2mu01aS3iQpw1z3TFQyQa0hQWsCjGH,SpATywNh6bZuzm8s1ceuBUnMUAeoAHHw,24,53,32,20,0,6,26,4,141,20.142857142857142,3,0.0,10,32,19,0,43,6,1,26,4,61,80,0
3994,55556,Pg0gXikYsatKV6C2YLhl2LUFEvJuK423,SpATywNh6bZuzm8s1ceuBUnMUAeoAHHw,1,0,0,0,0,0,1,0,1,0.14285714285714285,1,0.0,0,0,0,0,0,0,0,1,0,0,1,1
3995,55557,FELnhQR0c7GZZX82ioYJEZsqujOrfyf7,SpATywNh6bZuzm8s1ceuBUnMUAeoAHHw,7,4,2,0,1,5,5,0,17,2.4285714285714284,2,0.0,0,2,0,1,4,5,0,5,0,3,14,1
3996,55560,NGCjg1L5IFyOkl1pLM5r5gRwzJYb60Ux,7GRhBDsirIGkRZBtSMEzNTyDr2JQm4xx,1,0,0,0,0,0,2,0,2,0.2857142857142857,1,0.0,0,0,0,0,0,0,0,2,0,0,2,1
3997,55573,9MJtonlQxxOCrYvWkEprq1yVcFsrnJFZ,SpATywNh6bZuzm8s1ceuBUnMUAeoAHHw,19,27,13,0,9,0,5,0,54,7.714285714285714,3,0.0,0,13,0,9,27,0,0,5,0,22,32,1
3998,55591,9t2KBUQ5GiAw5lDqGOd0BuKNW0LVvTVG,A3fsA9Zfv1X2fVEQhTw51lKENdNrEqT3,76,69,39,158,19,0,12,0,297,42.42857142857143,4,0.0,15,39,135,19,54,0,23,12,0,208,89,0
3999,55593,9t2KBUQ5GiAw5lDqGOd0BuKNW0LVvTVG,bWdj2GDclj5ofokWjzoa5jAwMkxCykd6,41,78,43,100,11,15,22,1,270,38.57142857142857,6,0.0,15,43,91,11,63,15,9,22,1,160,110,0
4000,55624,QOwpzKqFZ32bfGgNkKoMFA0kfbklA5vW,7GRhBDsirIGkRZBtSMEzNTyDr2JQm4xx,6,6,4,0,1,0,3,0,14,2.0,2,0.0,0,4,0,1,6,0,0,3,0,5,9,1
4001,55637,ykaUPJW4Nc9r2mv4b25QxgdHgIcQ63RQ,7GRhBDsirIGkRZBtSMEzNTyDr2JQm4xx,2,0,0,0,0,0,2,0,2,0.2857142857142857,1,0.0,0,0,0,0,0,0,0,2,0,0,2,1
4002,55661,KKjjlHFWeLSseHD90tBUbNiE7bxXsPHK,A3fsA9Zfv1X2fVEQhTw51lKENdNrEqT3,1,0,0,0,0,0,1,0,1,0.14285714285714285,1,0.0,0,0,0,0,0,0,0,1,0,0,1,1
4003,55667,8ZhpSkXuKXWxDMEbryu3zVTkh7o5swmt,SpATywNh6bZuzm8s1ceuBUnMUAeoAHHw,10,14,1,6,0,5,11,0,37,5.285714285714286,2,0.0,7,1,6,0,7,5,0,11,0,14,23,1
4004,55692,y2EdvoA45jiUkTJcqU8mJ6KiT8yLZUjw,SpATywNh6bZuzm8s1ceuBUnMUAeoAHHw,5,3,1,0,0,3,3,0,10,1.4285714285714286,1,0.0,0,1,0,0,3,3,0,3,0,1,9,1
4005,55696,jaCcwHYnVHfV5mSQjy3wPbHHjpbiHJ5a,SpATywNh6bZuzm8s1ceuBUnMUAeoAHHw,28,66,15,29,9,0,33,0,152,21.714285714285715,6,0.0,10,15,27,9,56,0,2,33,0,61,91,0
4006,55699,HFO33lcsFKBDjSdg8KE5lGTCABOqytNM,RXDvfPUBYFlVdlueBFbLW0mhhAyGEqpt,44,53,16,108,20,2,5,1,205,29.285714285714285,2,0.0,34,16,92,20,19,2,16,5,1,162,43,0
4007,55734,JwzCuKRnJiCboJiRTMovpzJhdCfcNETm,bWdj2GDclj5ofokWjzoa5jAwMkxCykd6,4,2,0,0,0,0,2,0,4,0.5714285714285714,1,0.0,0,0,0,0,2,0,0,2,0,0,4,1
4008,55738,rCrf0hc0QRrKoK9w9R5Z8IvJlhGyjTyy,bWdj2GDclj5ofokWjzoa5jAwMkxCykd6,20,29,8,70,4,16,10,1,138,19.714285714285715,4,0.0,4,8,64,4,25,16,6,10,1,80,58,1
4009,55761,gEZOnwjA41tJvFOifXsWWDx9ePmBM5Kk,7GRhBDsirIGkRZBtSMEzNTyDr2JQm4xx,2,0,0,0,0,0,2,0,2,0.2857142857142857,1,0.0,0,0,0,0,0,0,0,2,0,0,2,1
4010,55773,mKWCTH01KzkLjFgXaCUEfs0dLu17r2jM,SpATywNh6bZuzm8s1ceuBUnMUAeoAHHw,3,2,1,0,0,0,1,0,4,0.5714285714285714,1,0.0,0,1,0,0,2,0,0,1,0,1,3,0
4011,55775,ZvdQafaVNGdhweIxI9FbVGKoGVxZDXFe,7GRhBDsirIGkRZBtSMEzNTyDr2JQm4xx,2,0,0,0,0,0,4,0,4,0.5714285714285714,3,0.0,0,0,0,0,0,0,0,4,0,0,4,1
4012,55777,aQ6WrdDe9pTNwVW3vmaMOs1pxy5r3Dxa,bWdj2GDclj5ofokWjzoa5jAwMkxCykd6,27,38,21,106,7,10,12,0,194,27.714285714285715,7,0.0,6,21,100,7,32,10,6,12,0,134,60,0
4013,55780,i5WDkhlf7rrVPmbQxsFTG1gowMYshvKj,bWdj2GDclj5ofokWjzoa5jAwMkxCykd6,9,15,6,8,5,2,3,0,39,5.571428571428571,2,0.0,7,6,8,5,8,2,0,3,0,26,13,1
4014,55820,LdhLlSD36AR268yKf0v6JE8vG5XYPHSF,SpATywNh6bZuzm8s1ceuBUnMUAeoAHHw,6,3,2,0,1,0,2,0,8,1.1428571428571428,1,0.0,0,2,0,1,3,0,0,2,0,3,5,1
4015,55843,S2i0VW7GN0ACeCnuAPN00XONM8w8kvsN,SpATywNh6bZuzm8s1ceuBUnMUAeoAHHw,9,14,5,17,0,0,1,0,37,5.285714285714286,1,0.0,6,5,14,0,8,0,3,1,0,25,12,0
4016,55846,q7ZtC6SevF8q9PKkXEaBMzUJ37xWhTDz,SpATywNh6bZuzm8s1ceuBUnMUAeoAHHw,18,29,10,19,3,16,12,0,89,12.714285714285714,6,0.0,6,10,16,3,23,16,3,12,0,35,54,1
4017,55865,ZEHkvN1JnR5aRFAd5UGefALeV7OHXWFP,7GRhBDsirIGkRZBtSMEzNTyDr2JQm4xx,37,106,32,42,13,24,22,3,242,34.57142857142857,4,0.0,49,32,40,13,57,24,2,22,3,134,108,1
4018,55877,GPe5tDvCMFa0yvoGbU7FbSxYbtu5eayz,SpATywNh6bZuzm8s1ceuBUnMUAeoAHHw,30,47,23,28,8,2,17,1,126,18.0,8,0.0,8,23,24,8,39,2,4,17,1,63,63,0
4019,55936,Uh4whLcptRuZuhdtjFruuYJY4YmOeYlV,SpATywNh6bZuzm8s1ceuBUnMUAeoAHHw,20,34,1,34,1,0,3,0,73,10.428571428571429,2,0.0,10,1,30,1,24,0,4,3,0,42,31,0
4020,55948,fOZTYKShrDEPywLsvnOq8r6y0esJP04d,G8EPVSXsOYB5YQWZGiz1aVq5Pgr2GrQu,47,125,53,76,32,35,21,2,344,49.142857142857146,5,0.0,56,53,58,32,69,35,18,21,2,199,145,0
4021,55969,Qs9VQJkriDZBH3FlG0bgTumvMa49MEaO,SpATywNh6bZuzm8s1ceuBUnMUAeoAHHw,2,0,0,0,0,2,1,0,3,0.42857142857142855,1,0.0,0,0,0,0,0,2,0,1,0,0,3,1
4022,56001,7EU7vMf2b4Xv6MdI3zbAqQNQTiRVSvYt,bWdj2GDclj5ofokWjzoa5jAwMkxCykd6,9,15,4,0,2,0,4,0,25,3.5714285714285716,3,0.0,0,4,0,2,15,0,0,4,0,6,19,0
4023,56002,aX8XTxJBQE99ErDnzZHdMXoXH5wjXDSz,SpATywNh6bZuzm8s1ceuBUnMUAeoAHHw,6,5,3,0,1,0,3,0,12,1.7142857142857142,1,0.0,0,3,0,1,5,0,0,3,0,4,8,1
4024,56010,hJo1MgKiPZFXuH2ko6hqPTd9dbjMQKDO,A3fsA9Zfv1X2fVEQhTw51lKENdNrEqT3,14,15,8,18,1,0,6,0,48,6.857142857142857,5,0.0,0,8,15,1,15,0,3,6,0,24,24,0
4025,56032,Y7LsqgQDUbWtXalaq4LkDEQKBlxOaCL3,A3fsA9Zfv1X2fVEQhTw51lKENdNrEqT3,7,8,3,0,2,0,1,0,14,2.0,1,0.0,1,3,0,2,7,0,0,1,0,6,8,1
4026,56040,420Gm2AWh0nImDTapBba1KojOp3noScY,SpATywNh6bZuzm8s1ceuBUnMUAeoAHHw,25,36,2,30,1,0,21,0,90,12.857142857142858,6,0.0,4,2,26,1,32,0,4,21,0,33,57,0
4027,56103,h7RW3AuXPtbIdr6MfEtTA3AoeBZHMuDe,SpATywNh6bZuzm8s1ceuBUnMUAeoAHHw,16,36,20,20,6,0,16,0,98,14.0,5,0.0,6,20,16,6,30,0,4,16,0,48,50,1
4028,56136,Ooe9SpvA9vL8fZI7YLdrPaZtM6Unwf0C,SpATywNh6bZuzm8s1ceuBUnMUAeoAHHw,22,30,1,20,1,1,3,0,56,8.0,2,0.0,6,1,18,1,24,1,2,3,0,26,30,1
4029,56184,ndLSZuWw3bhlmRMZV7snp1VzVKaJfO1o,7GRhBDsirIGkRZBtSMEzNTyDr2JQm4xx,1,0,0,0,0,0,1,0,1,0.14285714285714285,1,0.0,0,0,0,0,0,0,0,1,0,0,1,1
4030,56202,xbYSqp0T7Uu69VoCNyfTCvQcS3HV3UeU,SpATywNh6bZuzm8s1ceuBUnMUAeoAHHw,15,57,24,20,1,56,39,7,204,29.142857142857142,8,0.0,12,24,16,1,45,56,4,39,7,53,151,1
4031,56215,J3FKLxbUlPTor4lyG8lMpHc8oUQEjfcp,SpATywNh6bZuzm8s1ceuBUnMUAeoAHHw,2,0,0,0,0,0,2,0,2,0.2857142857142857,1,0.0,0,0,0,0,0,0,0,2,0,0,2,0
4032,56223,7qDBI7pI0SQ1bfBBjf175GzJeqNA6CgO,7GRhBDsirIGkRZBtSMEzNTyDr2JQm4xx,6,4,2,0,1,0,3,0,10,1.4285714285714286,2,0.0,0,2,0,1,4,0,0,3,0,3,7,1
4033,56226,ok15ssTMon44FKUffK29mVEN6xTGU7F9,SpATywNh6bZuzm8s1ceuBUnMUAeoAHHw,10,6,4,6,3,0,1,0,20,2.857142857142857,1,0.0,1,4,5,3,5,0,1,1,0,13,7,1
4034,56244,XKteUTBXNdDfK3DTLCpAPdVFmdrv3Rx5,7GRhBDsirIGkRZBtSMEzNTyDr2JQm4xx,13,27,1,0,0,0,5,2,35,5.0,1,0.0,4,1,0,0,23,0,0,5,2,5,30,1
4035,56307,1GmUBgbH4qyfafNMJ2VdhisOaMrOQzrs,A3fsA9Zfv1X2fVEQhTw51lKENdNrEqT3,2,0,0,0,0,0,2,0,2,0.2857142857142857,1,0.0,0,0,0,0,0,0,0,2,0,0,2,1
4036,56311,O0ctfeDXN3RQlb9YZzp4oH5DaLYaRlEd,A3fsA9Zfv1X2fVEQhTw51lKENdNrEqT3,29,21,17,65,13,0,6,0,122,17.428571428571427,3,0.0,0,17,61,13,21,0,4,6,0,91,31,1
4037,56321,YQloiHp4EDEAnQ7UnBm1Re3dyFVVFj8Z,SpATywNh6bZuzm8s1ceuBUnMUAeoAHHw,18,85,3,50,0,23,13,0,174,24.857142857142858,5,0.0,39,3,41,0,46,23,9,13,0,83,91,0
4038,56333,CwAitLaYuWheNSIoTgEZfJ56lAJf0HG8,7GRhBDsirIGkRZBtSMEzNTyDr2JQm4xx,36,48,18,55,19,0,17,0,157,22.428571428571427,4,0.0,28,18,49,19,20,0,6,17,0,114,43,1
4039,56354,EKjzbhHjXWCVYpc4LH9ESzstcF131j56,7GRhBDsirIGkRZBtSMEzNTyDr2JQm4xx,1,0,0,0,0,0,1,0,1,0.14285714285714285,1,0.0,0,0,0,0,0,0,0,1,0,0,1,1
4040,56366,CQ9z29HXcNaQxMUuAJ5s2uvH0fLzGYjv,SpATywNh6bZuzm8s1ceuBUnMUAeoAHHw,11,16,7,18,0,1,5,1,48,6.857142857142857,1,0.0,4,7,15,0,12,1,3,5,1,26,22,1
4041,56398,aGbKep26uuguTzwAUYDcwjqS1RQNroF5,SpATywNh6bZuzm8s1ceuBUnMUAeoAHHw,28,36,13,36,7,0,11,1,104,14.857142857142858,5,0.0,12,13,33,7,24,0,3,11,1,65,39,1
4042,56418,1yk3ITtkCTeBgpvC46EyEEfYcyKWD7Qc,SpATywNh6bZuzm8s1ceuBUnMUAeoAHHw,30,21,13,27,7,3,7,1,79,11.285714285714286,3,0.0,6,13,24,7,15,3,3,7,1,50,29,0
4043,56423,ouOARkjMonPxhUKVUmTMgEZ4vGcTZcAk,7GRhBDsirIGkRZBtSMEzNTyDr2JQm4xx,45,43,0,164,2,0,3,0,212,30.285714285714285,2,0.0,23,0,161,2,20,0,3,3,0,186,26,1
4044,56444,bUYPIrKUhpdtG1KH0Y9GXp4xZk1AgdLJ,SpATywNh6bZuzm8s1ceuBUnMUAeoAHHw,4,1,1,0,0,2,3,0,7,1.0,2,0.0,0,1,0,0,1,2,0,3,0,1,6,0
4045,56445,UalIk08w9p6VGqWfZ6drUaQL5GhjEzcw,SpATywNh6bZuzm8s1ceuBUnMUAeoAHHw,20,20,11,15,5,7,7,1,66,9.428571428571429,2,0.0,3,11,13,5,17,7,2,7,1,32,34,1
4046,56446,TVQrQzdOFJxL0otAPBsN1HXNpNNlOLWm,7GRhBDsirIGkRZBtSMEzNTyDr2JQm4xx,24,41,0,84,3,0,3,0,131,18.714285714285715,2,0.0,27,0,74,3,14,0,10,3,0,104,27,1
4047,56477,g5ozjvUCdaFJGkcIZvHKw5OmNcDvdyli,G8EPVSXsOYB5YQWZGiz1aVq5Pgr2GrQu,14,19,7,12,2,0,3,0,43,6.142857142857143,2,0.0,6,7,7,2,13,0,5,3,0,22,21,1
4048,56490,kqS8BwWN9R1093oeblGkvtCsQJ68Gh0G,SpATywNh6bZuzm8s1ceuBUnMUAeoAHHw,30,119,57,45,27,20,23,0,291,41.57142857142857,11,0.0,18,57,36,27,101,20,9,23,0,138,153,0
4049,56494,mSe1A4ptQkbf64uqFepueFInmdXgPhYy,SpATywNh6bZuzm8s1ceuBUnMUAeoAHHw,7,4,2,0,1,0,6,0,13,1.8571428571428572,1,0.0,0,2,0,1,4,0,0,6,0,3,10,1
4050,56495,LMrnY95OXOcKLbPJNFk6CNnUTJJC01Mr,7GRhBDsirIGkRZBtSMEzNTyDr2JQm4xx,1,0,0,0,0,0,1,0,1,0.14285714285714285,1,0.0,0,0,0,0,0,0,0,1,0,0,1,1
4051,56501,AxlfZzXkXnhJLfyjxNARPh8wNlmuerJT,SpATywNh6bZuzm8s1ceuBUnMUAeoAHHw,6,6,2,0,1,0,4,0,13,1.8571428571428572,1,0.0,0,2,0,1,6,0,0,4,0,3,10,0
4052,56514,57DmCkxeT4CodU6tDrBCDXqGpXQ0D1sF,A3fsA9Zfv1X2fVEQhTw51lKENdNrEqT3,56,70,8,190,1,13,8,0,290,41.42857142857143,5,0.0,7,8,153,1,63,13,37,8,0,169,121,0
4053,56520,Q0J8U0u6fxm0Djpm7255SwygxGBxa60v,A3fsA9Zfv1X2fVEQhTw51lKENdNrEqT3,7,4,2,0,1,1,4,0,12,1.7142857142857142,1,0.0,0,2,0,1,4,1,0,4,0,3,9,0
4054,56527,3t7GtELm6lLnb8FYC1DTga6GS5ymEox1,bWdj2GDclj5ofokWjzoa5jAwMkxCykd6,9,7,0,0,0,1,8,1,17,2.4285714285714284,1,0.0,1,0,0,0,6,1,0,8,1,1,16,1
4055,56536,v3Nj91qeWhwVYxgQExYL9jO1Rd2uR5bo,SpATywNh6bZuzm8s1ceuBUnMUAeoAHHw,5,2,1,0,1,0,2,0,6,0.8571428571428571,1,0.0,0,1,0,1,2,0,0,2,0,2,4,1
4056,56559,Mr892OMsEEXQ3UZ94sswWXvqkTfFWjMB,SpATywNh6bZuzm8s1ceuBUnMUAeoAHHw,7,6,3,0,1,0,5,0,15,2.142857142857143,1,0.0,0,3,0,1,6,0,0,5,0,4,11,0
4057,56576,zlC9nEdRrqLSPX386Mctiz9fIdlU29GI,A3fsA9Zfv1X2fVEQhTw51lKENdNrEqT3,24,17,16,0,15,0,2,0,50,7.142857142857143,1,0.0,0,16,0,15,17,0,0,2,0,31,19,0
4058,56615,ktKfaRtFOnFJdZMcfSCqSP14OG6TxlMY,SpATywNh6bZuzm8s1ceuBUnMUAeoAHHw,25,40,4,30,3,0,13,0,90,12.857142857142858,4,0.0,6,4,30,3,34,0,0,13,0,43,47,0
4059,56621,ma8nscMCD0ftKjbxujos5nzHFFtaZMo4,A3fsA9Zfv1X2fVEQhTw51lKENdNrEqT3,9,9,3,0,1,0,9,0,22,3.142857142857143,3,0.0,1,3,0,1,8,0,0,9,0,5,17,0
4060,56633,NGQ6HXbhxwBlJxikVxca5noX2u8xI9AV,A3fsA9Zfv1X2fVEQhTw51lKENdNrEqT3,40,31,14,76,10,0,6,0,137,19.571428571428573,2,0.0,2,14,61,10,29,0,15,6,0,87,50,0
4061,56683,MbewcgzgToNhp9B6eaNSolme5R0M2nkY,A3fsA9Zfv1X2fVEQhTw51lKENdNrEqT3,27,24,3,52,1,0,4,0,84,12.0,4,0.0,0,3,42,1,24,0,10,4,0,46,38,1
4062,56695,zEnfy6jGZRz4vOOACnUS9WJEmxBWMfYK,SpATywNh6bZuzm8s1ceuBUnMUAeoAHHw,20,38,0,32,0,7,21,6,104,14.857142857142858,3,0.0,17,0,29,0,21,7,3,21,6,46,58,0
4063,56696,ReIy3etnMmZBVQ3CosU4FbzEF29F9nHU,SpATywNh6bZuzm8s1ceuBUnMUAeoAHHw,21,26,0,20,0,0,6,0,52,7.428571428571429,5,0.0,9,0,19,0,17,0,1,6,0,28,24,0
4064,56701,6JgXcKWsc0MTV1avPvLw4YopCc17Rmgt,A3fsA9Zfv1X2fVEQhTw51lKENdNrEqT3,1,0,0,0,0,0,1,0,1,0.14285714285714285,1,0.0,0,0,0,0,0,0,0,1,0,0,1,1
4065,56707,bFvRESu40USsImLcj4Wu3bOXKdpnzC9Q,SpATywNh6bZuzm8s1ceuBUnMUAeoAHHw,3,2,0,0,0,0,2,0,4,0.5714285714285714,1,0.0,0,0,0,0,2,0,0,2,0,0,4,0
4066,56715,6iyCCTAEdDUFtgP0yXcCVROgqrKuAsJY,SpATywNh6bZuzm8s1ceuBUnMUAeoAHHw,28,31,21,40,9,2,8,0,111,15.857142857142858,4,0.0,6,21,34,9,25,2,6,8,0,70,41,0
4067,56718,TqNtDLLO1ShCV3mG6MbvpUVS2QVfiYPr,SpATywNh6bZuzm8s1ceuBUnMUAeoAHHw,1,0,0,0,0,0,1,0,1,0.14285714285714285,1,0.0,0,0,0,0,0,0,0,1,0,0,1,1
4068,56722,xYLJB56SVkFUOdT5vN3Qq6OYNlnP0Fjc,A3fsA9Zfv1X2fVEQhTw51lKENdNrEqT3,11,7,3,0,3,1,4,0,18,2.5714285714285716,2,0.0,0,3,0,3,7,1,0,4,0,6,12,1
4069,56725,Bxz1zTHFCCx9o1kJA9B0Pzm3PnmqKxr5,SpATywNh6bZuzm8s1ceuBUnMUAeoAHHw,19,35,30,0,17,0,2,0,84,12.0,7,0.0,2,30,0,17,33,0,0,2,0,49,35,1
4070,56736,csg0yBjjrshmLGGyq6UVgiiqMZP9T0vI,A3fsA9Zfv1X2fVEQhTw51lKENdNrEqT3,10,8,5,0,3,0,9,0,25,3.5714285714285716,3,0.0,0,5,0,3,8,0,0,9,0,8,17,1
4071,56763,bZSiNUbAIuydDBd77IMAJ15Hy6k2A1kT,SpATywNh6bZuzm8s1ceuBUnMUAeoAHHw,10,6,5,0,4,0,2,0,17,2.4285714285714284,1,0.0,0,5,0,4,6,0,0,2,0,9,8,0
4072,56771,I8C35PB4HAz5bxjARemPN0YBdl9xTOvv,SpATywNh6bZuzm8s1ceuBUnMUAeoAHHw,24,48,1,33,1,0,5,0,88,12.571428571428571,2,0.0,12,1,29,1,36,0,4,5,0,43,45,1
4073,56785,70BrIR23BcsI705EZj4LSyr7fHWI0Xjf,SpATywNh6bZuzm8s1ceuBUnMUAeoAHHw,5,2,1,0,1,0,2,0,6,0.8571428571428571,1,0.0,0,1,0,1,2,0,0,2,0,2,4,1
4074,56791,1G2HPMj7bCJEDZxxbF8ae2kPQCHvH8vB,bWdj2GDclj5ofokWjzoa5jAwMkxCykd6,10,18,9,0,4,1,14,8,54,7.714285714285714,3,0.0,0,9,0,4,18,1,0,14,8,13,41,1
4075,56806,1ZeLZDjvvDkWWsoonk2q4KdJg9fzmSLS,SpATywNh6bZuzm8s1ceuBUnMUAeoAHHw,10,19,1,4,1,0,5,0,30,4.285714285714286,3,0.0,1,1,3,1,18,0,1,5,0,6,24,1
4076,56817,qzripbhm6sAPdZP3rld8n0avyAjcFNv4,G8EPVSXsOYB5YQWZGiz1aVq5Pgr2GrQu,7,9,3,0,3,0,3,0,18,2.5714285714285716,3,0.0,0,3,0,3,9,0,0,3,0,6,12,0
4077,56834,i86rWeuy3cBtKeVeDiyieBp3ovKTOVnd,SpATywNh6bZuzm8s1ceuBUnMUAeoAHHw,21,38,18,1,8,1,10,1,77,11.0,3,0.0,6,18,1,8,32,1,0,10,1,33,44,1
4078,56836,PihBsIILx8UWSnCui7TqzlKGzY1fk9nJ,SpATywNh6bZuzm8s1ceuBUnMUAeoAHHw,1,0,0,0,0,0,1,0,1,0.14285714285714285,1,0.0,0,0,0,0,0,0,0,1,0,0,1,1
4079,56846,JQHOsaQcbZuyd8KUhRwPnej9sALKGQEC,SpATywNh6bZuzm8s1ceuBUnMUAeoAHHw,15,25,3,30,0,10,7,3,78,11.142857142857142,3,0.0,7,3,23,0,18,10,7,7,3,33,45,0
4080,56864,y64BqR5f4fJBfwxF4aLt14ViHkvnjGLs,A3fsA9Zfv1X2fVEQhTw51lKENdNrEqT3,43,37,18,50,7,8,19,0,139,19.857142857142858,6,0.0,3,18,48,7,34,8,2,19,0,76,63,1
4081,56875,T8TKNQciNYxyZa02JNR1WAwQ2Y5qXjum,G8EPVSXsOYB5YQWZGiz1aVq5Pgr2GrQu,38,52,29,64,5,11,27,2,190,27.142857142857142,6,0.0,6,29,59,5,46,11,5,27,2,99,91,0
4082,56922,O1q1xXNHTWodSWO9JfUWT4rggWDNTlDY,SpATywNh6bZuzm8s1ceuBUnMUAeoAHHw,7,8,4,0,0,0,2,0,14,2.0,1,0.0,3,4,0,0,5,0,0,2,0,7,7,0
4083,56928,GXmApUIE1IechykqO3xyhcbVn1kfVOsr,A3fsA9Zfv1X2fVEQhTw51lKENdNrEqT3,1,0,0,0,0,0,1,0,1,0.14285714285714285,1,0.0,0,0,0,0,0,0,0,1,0,0,1,1
4084,56931,T6EWQ7jVP89JlHzj41KN1gEtGYevpSQM,bWdj2GDclj5ofokWjzoa5jAwMkxCykd6,20,30,19,10,8,9,18,2,96,13.714285714285714,6,0.0,4,19,9,8,26,9,1,18,2,40,56,1
4085,56934,8rmN9H3w27FWPHiV35iZMwZvoCzyP6Mm,RXDvfPUBYFlVdlueBFbLW0mhhAyGEqpt,9,10,7,0,5,0,4,0,26,3.7142857142857144,1,0.0,0,7,0,5,10,0,0,4,0,12,14,1
4086,56936,6YrlVe0EsBFAYrnxnMsqTpBboV8J5mFJ,SpATywNh6bZuzm8s1ceuBUnMUAeoAHHw,5,3,2,0,0,0,2,0,7,1.0,1,0.0,0,2,0,0,3,0,0,2,0,2,5,1
4087,56950,kSTVldlILQTC4uvQjFTvUZT6Q6PR2etw,SpATywNh6bZuzm8s1ceuBUnMUAeoAHHw,11,17,2,26,0,3,5,0,53,7.571428571428571,2,0.0,5,2,21,0,12,3,5,5,0,28,25,0
4088,56956,6iOLSqRTRABETCaDgzA6NufDV3dLbSSl,bWdj2GDclj5ofokWjzoa5jAwMkxCykd6,46,40,28,122,16,9,27,0,242,34.57142857142857,6,0.0,9,28,105,16,31,9,17,27,0,158,84,1
4089,56962,0XE1X3Ctb7lK10K23BNZFxwGgwh0UjZf,SpATywNh6bZuzm8s1ceuBUnMUAeoAHHw,9,14,9,0,0,0,4,0,27,3.857142857142857,1,0.0,2,9,0,0,12,0,0,4,0,11,16,1
4090,56963,GKzw24uGItaRbrNpOwWtTqnRbaZohHHZ,SpATywNh6bZuzm8s1ceuBUnMUAeoAHHw,31,75,36,42,15,43,31,3,245,35.0,5,0.0,26,36,36,15,49,43,6,31,3,113,132,0
4091,56973,yeTZ5KMDDEc73UUfQpRLrz0nY0YDQXhl,SpATywNh6bZuzm8s1ceuBUnMUAeoAHHw,28,56,21,25,9,3,6,0,120,17.142857142857142,2,0.0,5,21,25,9,51,3,0,6,0,60,60,1
4092,56974,ca0FiReQbSJ11H1fqXLWoWnOvLbBbR3V,SpATywNh6bZuzm8s1ceuBUnMUAeoAHHw,18,56,22,23,6,7,13,1,128,18.285714285714285,6,0.0,18,22,16,6,38,7,7,13,1,62,66,0
4093,57000,iCeqWib80JT1adwU3NbFJnaBIJ2wIhjE,RXDvfPUBYFlVdlueBFbLW0mhhAyGEqpt,10,8,1,0,1,0,4,0,14,2.0,2,0.0,1,1,0,1,7,0,0,4,0,3,11,1
4094,57017,RVthfCRYYRCiFRx3Qkq6vL0caXa3Y6XL,SpATywNh6bZuzm8s1ceuBUnMUAeoAHHw,13,17,3,30,0,2,19,1,72,10.285714285714286,2,0.0,14,3,27,0,3,2,3,19,1,44,28,0
4095,57039,pJVtkRFEs9CaJKE9rNOcmTvOB8uBPejR,A3fsA9Zfv1X2fVEQhTw51lKENdNrEqT3,7,5,2,0,1,0,3,0,11,1.5714285714285714,2,0.0,0,2,0,1,5,0,0,3,0,3,8,0
4096,57041,LiEq7cB8PYL97VcZAVnxJwY7r8Xsvmdl,SpATywNh6bZuzm8s1ceuBUnMUAeoAHHw,4,2,0,0,0,0,3,0,5,0.7142857142857143,1,0.0,0,0,0,0,2,0,0,3,0,0,5,1
4097,57042,7QBdZ8YakikUsDbHJXtRSZV9tfWCg7qW,SpATywNh6bZuzm8s1ceuBUnMUAeoAHHw,20,25,10,33,3,0,4,0,75,10.714285714285714,2,0.0,10,10,29,3,15,0,4,4,0,52,23,0
4098,57048,I7IIrHAh1LzzCf8lcvI92o8deFulzAh8,G8EPVSXsOYB5YQWZGiz1aVq5Pgr2GrQu,1,0,0,0,0,0,3,0,3,0.42857142857142855,3,0.0,0,0,0,0,0,0,0,3,0,0,3,1
4099,57049,I7IIrHAh1LzzCf8lcvI92o8deFulzAh8,RXDvfPUBYFlVdlueBFbLW0mhhAyGEqpt,1,0,0,0,0,0,5,0,5,0.7142857142857143,3,0.0,0,0,0,0,0,0,0,5,0,0,5,1
4100,57051,I7IIrHAh1LzzCf8lcvI92o8deFulzAh8,A3fsA9Zfv1X2fVEQhTw51lKENdNrEqT3,1,0,0,0,0,0,2,0,2,0.2857142857142857,2,0.0,0,0,0,0,0,0,0,2,0,0,2,1
4101,57057,uMWcv4ZmW7X4PBv6egGkJZliUjuRluME,A3fsA9Zfv1X2fVEQhTw51lKENdNrEqT3,5,3,0,0,0,0,2,0,5,0.7142857142857143,1,0.0,0,0,0,0,3,0,0,2,0,0,5,1
4102,57071,ZAm3LJlcyCl8h6ue5pLqqLpG5qq07BLo,A3fsA9Zfv1X2fVEQhTw51lKENdNrEqT3,1,0,0,0,0,0,1,0,1,0.14285714285714285,1,0.0,0,0,0,0,0,0,0,1,0,0,1,0
4103,57088,Wwec43la23BkGWuxstkp5xbmi9HpOvs1,G8EPVSXsOYB5YQWZGiz1aVq5Pgr2GrQu,12,15,1,0,1,0,4,0,21,3.0,1,0.0,0,1,0,1,15,0,0,4,0,2,19,0
4104,57094,NY9lbGArbud0VjFCO45IgKzDykuc5Wkn,G8EPVSXsOYB5YQWZGiz1aVq5Pgr2GrQu,3,2,0,0,0,0,2,0,4,0.5714285714285714,1,0.0,0,0,0,0,2,0,0,2,0,0,4,1
4105,57105,91awV6zWN0QiCEvZkSCaXQj0382CBE5H,A3fsA9Zfv1X2fVEQhTw51lKENdNrEqT3,1,0,0,0,0,0,1,0,1,0.14285714285714285,1,0.0,0,0,0,0,0,0,0,1,0,0,1,1
4106,57116,FeZn6c6vb5R5SPZtACtqOXKJC1inbsZN,SpATywNh6bZuzm8s1ceuBUnMUAeoAHHw,28,43,3,38,4,5,8,0,101,14.428571428571429,4,0.0,9,3,31,4,34,5,7,8,0,47,54,0
4107,57131,3CLlQYPJzaDqTsMDCyIWfYEpsKmi9sXD,G8EPVSXsOYB5YQWZGiz1aVq5Pgr2GrQu,18,35,9,10,7,3,25,1,90,12.857142857142858,4,0.0,18,9,6,7,17,3,4,25,1,40,50,0
4108,57162,aHtknnRqNt7Y7dvI5B5U8KGn3pFw6RdZ,G8EPVSXsOYB5YQWZGiz1aVq5Pgr2GrQu,23,30,22,0,0,7,7,1,67,9.571428571428571,1,0.0,6,22,0,0,24,7,0,7,1,28,39,1
4109,57182,n2sxBm1YdWdbqY5218d4GO8H7c30aZzU,SpATywNh6bZuzm8s1ceuBUnMUAeoAHHw,1,0,0,0,0,0,1,0,1,0.14285714285714285,1,0.0,0,0,0,0,0,0,0,1,0,0,1,1
4110,57183,5jlZO84otZB9xpGdUF5HgmcrtViZn9QR,SpATywNh6bZuzm8s1ceuBUnMUAeoAHHw,1,0,0,0,0,0,1,0,1,0.14285714285714285,1,0.0,0,0,0,0,0,0,0,1,0,0,1,1
4111,57190,ZzEeIm98vbP9lRunZYePLW46UyhiVxbR,A3fsA9Zfv1X2fVEQhTw51lKENdNrEqT3,8,9,2,0,1,0,4,1,17,2.4285714285714284,2,0.0,3,2,0,1,6,0,0,4,1,6,11,1
4112,57193,v6sJocXlJFeoDG1nXrmoTeUih19304GZ,SpATywNh6bZuzm8s1ceuBUnMUAeoAHHw,16,25,3,9,3,0,7,0,47,6.714285714285714,5,0.0,2,3,8,3,23,0,1,7,0,16,31,1
4113,57213,iSYj2oDe5RyCcvKGOIlJlpq8H0342az5,SpATywNh6bZuzm8s1ceuBUnMUAeoAHHw,15,13,11,5,9,1,12,1,52,7.428571428571429,2,0.0,1,11,4,9,12,1,1,12,1,25,27,1
4114,57215,XP5riJnXYg5EQATrHDgwlSDdWk49ZnJK,SpATywNh6bZuzm8s1ceuBUnMUAeoAHHw,17,30,1,14,1,2,6,1,55,7.857142857142857,2,0.0,10,1,12,1,20,2,2,6,1,24,31,1
4115,57223,CYN3tl2d8PV3r7FRKTn3DmaQTLhkh777,A3fsA9Zfv1X2fVEQhTw51lKENdNrEqT3,19,21,0,0,0,4,15,1,41,5.857142857142857,2,0.0,0,0,0,0,21,4,0,15,1,0,41,1
4116,57225,Ct3eFzamQizfpV2I2rZSBKqavcN2kzGI,bWdj2GDclj5ofokWjzoa5jAwMkxCykd6,18,36,22,14,13,0,5,0,90,12.857142857142858,4,0.0,7,22,14,13,29,0,0,5,0,56,34,1
4117,57247,mAtPYhgVQEdXuexaQz1O6am3axcwvcQv,SpATywNh6bZuzm8s1ceuBUnMUAeoAHHw,8,6,1,0,1,1,4,0,13,1.8571428571428572,1,0.0,0,1,0,1,6,1,0,4,0,2,11,0
4118,57274,a91ewPLjlp1X8KqwrnZISs7xgERRXuh7,SpATywNh6bZuzm8s1ceuBUnMUAeoAHHw,23,63,24,14,5,6,25,0,137,19.571428571428573,8,0.0,0,24,11,5,63,6,3,25,0,40,97,0
4119,57275,2Al3Sg2oc4NVlws5jTNzQZvd3PHAcnAl,SpATywNh6bZuzm8s1ceuBUnMUAeoAHHw,18,18,8,0,7,2,3,0,38,5.428571428571429,2,0.0,1,8,0,7,17,2,0,3,0,16,22,1
4120,57289,JfftjOGdDbpgbrupi0Gwr899R0jzXikJ,SpATywNh6bZuzm8s1ceuBUnMUAeoAHHw,25,43,21,5,8,0,20,0,97,13.857142857142858,10,0.0,7,21,5,8,36,0,0,20,0,41,56,0
4121,57303,CaX18aJHbUP3ScD0zmD3Y89LmBQVHmQw,SpATywNh6bZuzm8s1ceuBUnMUAeoAHHw,9,11,1,0,1,0,5,0,18,2.5714285714285716,1,0.0,0,1,0,1,11,0,0,5,0,2,16,1
4122,57310,amNosdi6Uiilljdy8esSBA3F29NKPLUW,A3fsA9Zfv1X2fVEQhTw51lKENdNrEqT3,16,23,15,0,3,2,23,0,66,9.428571428571429,7,0.0,0,15,0,3,23,2,0,23,0,18,48,1
4123,57326,v5WfKNQF0CY0mETK5LltBghiZQFigDWQ,A3fsA9Zfv1X2fVEQhTw51lKENdNrEqT3,5,0,0,0,0,0,8,0,8,1.1428571428571428,1,0.0,0,0,0,0,0,0,0,8,0,0,8,1
4124,57331,lG1rIQFzGK2zgeecJjKcKMBkKt4Dzz9j,RXDvfPUBYFlVdlueBFbLW0mhhAyGEqpt,7,3,2,0,2,0,2,0,9,1.2857142857142858,1,0.0,0,2,0,2,3,0,0,2,0,4,5,1
4125,57336,7FBwqoodmzhvrGGLuwBjRrxsykocUv8u,A3fsA9Zfv1X2fVEQhTw51lKENdNrEqT3,24,88,67,0,35,22,15,1,228,32.57142857142857,3,0.0,9,67,0,35,79,22,0,15,1,111,117,1
4126,57348,YPxQmDfYnmHgiT7CBa1xK3KUyMZAnQfd,SpATywNh6bZuzm8s1ceuBUnMUAeoAHHw,16,9,5,6,3,1,6,1,31,4.428571428571429,2,0.0,2,5,6,3,7,1,0,6,1,16,15,1
4127,57351,m8heXBwBoAingce16ZKybSsmTBnHzE4y,SpATywNh6bZuzm8s1ceuBUnMUAeoAHHw,1,0,0,0,0,0,1,0,1,0.14285714285714285,1,0.0,0,0,0,0,0,0,0,1,0,0,1,1
4128,57356,3SNPt0tgFaFs22ZCc56rWyLmizBS9I72,RXDvfPUBYFlVdlueBFbLW0mhhAyGEqpt,1,0,0,0,0,0,1,0,1,0.14285714285714285,1,0.0,0,0,0,0,0,0,0,1,0,0,1,1
4129,57359,Arkq8NiPd69nYa08JuNw4PEusLHNf9hH,SpATywNh6bZuzm8s1ceuBUnMUAeoAHHw,4,6,1,0,0,0,2,0,9,1.2857142857142858,1,0.0,0,1,0,0,6,0,0,2,0,1,8,1
4130,57362,VrrBciftY2IctWxZzgYOD4l9QhmKgryv,SpATywNh6bZuzm8s1ceuBUnMUAeoAHHw,27,29,20,18,10,1,7,0,85,12.142857142857142,5,0.0,5,20,16,10,24,1,2,7,0,51,34,0
4131,57385,XJf8gYhDJm1hrkVJvLQ4HKEnvPd3mIMq,SpATywNh6bZuzm8s1ceuBUnMUAeoAHHw,21,24,0,18,0,1,6,0,49,7.0,4,0.0,4,0,18,0,20,1,0,6,0,22,27,0
4132,57396,YTd6RUCxKSrzEOkqGgY5uphLrJJcaHu6,RXDvfPUBYFlVdlueBFbLW0mhhAyGEqpt,1,0,0,0,0,0,1,0,1,0.14285714285714285,1,0.0,0,0,0,0,0,0,0,1,0,0,1,1
4133,57398,jHVltfBYXhDsXX9G7YWEMLSGV2wRodE1,SpATywNh6bZuzm8s1ceuBUnMUAeoAHHw,2,0,0,0,0,0,3,0,3,0.42857142857142855,1,0.0,0,0,0,0,0,0,0,3,0,0,3,1
4134,57414,sQhlNn7KiXOhhd3W8wdYsXetKwfQaOrI,SpATywNh6bZuzm8s1ceuBUnMUAeoAHHw,14,35,2,5,2,0,2,0,46,6.571428571428571,2,0.0,23,2,5,2,12,0,0,2,0,32,14,0
4135,57416,VrQWFYHS8Y40ZzXEJSIKFiNDL1oCM4M9,G8EPVSXsOYB5YQWZGiz1aVq5Pgr2GrQu,7,3,2,0,2,0,2,0,9,1.2857142857142858,1,0.0,0,2,0,2,3,0,0,2,0,4,5,1
4136,57421,xVSPiuldrfuaqB5x0wSqqh0RzPMsoNZK,SpATywNh6bZuzm8s1ceuBUnMUAeoAHHw,21,24,20,0,14,1,5,1,65,9.285714285714286,4,0.0,0,20,0,14,24,1,0,5,1,34,31,0
4137,57430,trbTOxlGHBKj11KndbOpMZg4seGBeXai,SpATywNh6bZuzm8s1ceuBUnMUAeoAHHw,1,0,0,0,0,0,1,0,1,0.14285714285714285,1,0.0,0,0,0,0,0,0,0,1,0,0,1,1
4138,57441,VR8oLKZP6LgyxXON0sRbhHMwM11kusu8,bWdj2GDclj5ofokWjzoa5jAwMkxCykd6,2,0,0,0,0,0,4,0,4,0.5714285714285714,1,0.0,0,0,0,0,0,0,0,4,0,0,4,1
4139,57444,VR8oLKZP6LgyxXON0sRbhHMwM11kusu8,A3fsA9Zfv1X2fVEQhTw51lKENdNrEqT3,1,0,0,0,0,0,1,0,1,0.14285714285714285,1,0.0,0,0,0,0,0,0,0,1,0,0,1,1
4140,57462,QLGFenndIPaX8I2vSI7keErJ6m5JCAL7,A3fsA9Zfv1X2fVEQhTw51lKENdNrEqT3,19,6,6,0,6,0,12,2,32,4.571428571428571,1,0.0,0,6,0,6,6,0,0,12,2,12,20,1
4141,57477,5OgjW4RBhSCbfYx5XYwPp5mVp3N7l8JT,SpATywNh6bZuzm8s1ceuBUnMUAeoAHHw,18,33,21,7,1,11,45,3,121,17.285714285714285,8,0.0,2,21,7,1,31,11,0,45,3,31,90,1
4142,57497,h8ApK52PAIR0nuhXQv52hCsI8LxUHnXl,SpATywNh6bZuzm8s1ceuBUnMUAeoAHHw,15,23,1,15,0,0,5,1,45,6.428571428571429,2,0.0,6,1,12,0,17,0,3,5,1,19,26,1
4143,57510,CUu3LU8HdtJIouVTGHl3Ax78lqpPSeMD,A3fsA9Zfv1X2fVEQhTw51lKENdNrEqT3,12,12,7,0,3,0,4,0,26,3.7142857142857144,3,0.0,0,7,0,3,12,0,0,4,0,10,16,1
4144,57513,UzQguR9rIMiPdU8z0yQro6T1cVdElqDP,RXDvfPUBYFlVdlueBFbLW0mhhAyGEqpt,1,0,0,0,0,0,1,0,1,0.14285714285714285,1,0.0,0,0,0,0,0,0,0,1,0,0,1,1
4145,57540,q9BQrPVmTGVLXUZRKxvQUgkPlzz6bi8e,SpATywNh6bZuzm8s1ceuBUnMUAeoAHHw,7,8,4,0,4,0,3,0,19,2.7142857142857144,2,0.0,0,4,0,4,8,0,0,3,0,8,11,1
4146,57564,eAArxLyCThtu9N3Mv8rQculKbGSa66j9,bWdj2GDclj5ofokWjzoa5jAwMkxCykd6,7,7,2,22,1,0,6,0,38,5.428571428571429,3,0.0,3,2,20,1,4,0,2,6,0,26,12,1
4147,57568,73lhhrOcE2srJj5BkIzSweWSnQRZBT2o,SpATywNh6bZuzm8s1ceuBUnMUAeoAHHw,21,54,33,20,0,1,13,0,121,17.285714285714285,11,0.0,6,33,18,0,48,1,2,13,0,57,64,1
4148,57575,2OPkOMgZitV39CjjFQfjbadYph2VzorR,SpATywNh6bZuzm8s1ceuBUnMUAeoAHHw,6,3,1,0,1,0,2,0,7,1.0,1,0.0,0,1,0,1,3,0,0,2,0,2,5,1
4149,57594,OOsRSTJd6U7cE43XHk99M9ofvrefufrh,A3fsA9Zfv1X2fVEQhTw51lKENdNrEqT3,18,21,10,0,7,0,4,0,42,6.0,3,0.0,0,10,0,7,21,0,0,4,0,17,25,0
4150,57617,NVzsLV2hJQHxCBnLyaDpT9HrhRSWUOfa,RXDvfPUBYFlVdlueBFbLW0mhhAyGEqpt,48,91,29,66,11,9,22,4,232,33.142857142857146,4,0.0,18,29,63,11,73,9,3,22,4,121,111,1
4151,57619,WN542VQFBPN1yXud5IZMh3hZ3MXP7IGT,SpATywNh6bZuzm8s1ceuBUnMUAeoAHHw,6,0,0,0,0,1,7,1,9,1.2857142857142858,1,0.0,0,0,0,0,0,1,0,7,1,0,9,1
4152,57636,D5gDQ8hFb4klemeBiodWmMPe9KIvqw9O,A3fsA9Zfv1X2fVEQhTw51lKENdNrEqT3,21,32,2,12,1,0,8,0,55,7.857142857142857,5,0.0,1,2,9,1,31,0,3,8,0,13,42,1
4153,57647,4nbfL8rG09dpITd3UJqnI29RM9ZdkZtq,SpATywNh6bZuzm8s1ceuBUnMUAeoAHHw,2,0,0,0,0,0,2,0,2,0.2857142857142857,2,0.0,0,0,0,0,0,0,0,2,0,0,2,0
4154,57651,4nbfL8rG09dpITd3UJqnI29RM9ZdkZtq,RXDvfPUBYFlVdlueBFbLW0mhhAyGEqpt,1,0,0,0,0,0,1,0,1,0.14285714285714285,1,0.0,0,0,0,0,0,0,0,1,0,0,1,1
4155,57656,Y3ZpN8DOQK8YTfD0eUtklxiZfpWuBIeU,SpATywNh6bZuzm8s1ceuBUnMUAeoAHHw,29,36,21,25,13,4,8,0,107,15.285714285714286,3,0.0,9,21,25,13,27,4,0,8,0,68,39,0
4156,57658,gVmGREkYa5QlWPxC36Kl2VgCKKIwVXGZ,SpATywNh6bZuzm8s1ceuBUnMUAeoAHHw,1,0,0,0,0,0,1,0,1,0.14285714285714285,1,0.0,0,0,0,0,0,0,0,1,0,0,1,1
4157,57662,Py3KfqJj0ayFe0tkBJK6rKEFzXLKIBTS,RXDvfPUBYFlVdlueBFbLW0mhhAyGEqpt,18,19,1,0,1,0,1,0,22,3.142857142857143,1,0.0,1,1,0,1,18,0,0,1,0,3,19,0
4158,57663,bMJNLK5q5EUyioc5VWWKIebvvb4KHRiu,SpATywNh6bZuzm8s1ceuBUnMUAeoAHHw,14,20,2,18,1,0,8,1,50,7.142857142857143,2,0.0,10,2,15,1,10,0,3,8,1,28,22,1
4159,57671,j2LUphS0wjc6SNX1uC1d62i1omfcNa3o,SpATywNh6bZuzm8s1ceuBUnMUAeoAHHw,1,0,0,0,0,0,1,0,1,0.14285714285714285,1,0.0,0,0,0,0,0,0,0,1,0,0,1,1
4160,57674,o51Y4SLAGY9EUpnbYlzlny2aYMXKv66D,RXDvfPUBYFlVdlueBFbLW0mhhAyGEqpt,32,25,19,0,15,2,4,0,65,9.285714285714286,2,0.0,0,19,0,15,25,2,0,4,0,34,31,0
4161,57682,srWiqmJDli77OpcMHfZ4qTkRYOHonVJT,SpATywNh6bZuzm8s1ceuBUnMUAeoAHHw,18,18,0,10,0,1,8,0,37,5.285714285714286,3,0.0,0,0,10,0,18,1,0,8,0,10,27,0
4162,57711,cIl5ErCL6J4OGJVSovWEaY2KTpWCk21L,SpATywNh6bZuzm8s1ceuBUnMUAeoAHHw,20,19,7,38,2,16,7,2,91,13.0,1,0.0,11,7,33,2,8,16,5,7,2,53,38,1
4163,57712,p8eEbMqW5LefqN7qPq07exxdOPrIZY20,SpATywNh6bZuzm8s1ceuBUnMUAeoAHHw,21,45,18,14,12,1,16,2,108,15.428571428571429,6,0.0,5,18,14,12,40,1,0,16,2,49,59,1
4164,57719,3t9ZicXafEarB5kevklUjZj2RJMyb5VH,A3fsA9Zfv1X2fVEQhTw51lKENdNrEqT3,8,13,4,0,2,7,6,0,32,4.571428571428571,1,0.0,0,4,0,2,13,7,0,6,0,6,26,1
4165,57721,s61FWJSeWbhAUVg6RnrheusxdyXUW2UQ,bWdj2GDclj5ofokWjzoa5jAwMkxCykd6,1,0,0,0,0,0,1,0,1,0.14285714285714285,1,0.0,0,0,0,0,0,0,0,1,0,0,1,1
4166,57723,s61FWJSeWbhAUVg6RnrheusxdyXUW2UQ,A3fsA9Zfv1X2fVEQhTw51lKENdNrEqT3,1,0,0,0,0,0,1,0,1,0.14285714285714285,1,0.0,0,0,0,0,0,0,0,1,0,0,1,1
4167,57731,VfWuQS8OTjJmyvWxq07hV2rzKtyu1LCX,SpATywNh6bZuzm8s1ceuBUnMUAeoAHHw,11,14,9,6,0,0,5,0,34,4.857142857142857,2,0.0,2,9,6,0,12,0,0,5,0,17,17,0
4168,57735,uhbUne0Zqx7l0LKNWrxxR44WistJmxKI,SpATywNh6bZuzm8s1ceuBUnMUAeoAHHw,25,46,5,32,3,0,11,0,97,13.857142857142858,5,0.0,8,5,29,3,38,0,3,11,0,45,52,1
4169,57739,6hTHLv2ACZhw5sTOpdEFsUQMXrnQn22A,RXDvfPUBYFlVdlueBFbLW0mhhAyGEqpt,3,2,1,0,0,0,2,0,5,0.7142857142857143,2,0.0,0,1,0,0,2,0,0,2,0,1,4,1
4170,57745,2cQ9kfcrQBQHmPAj78FQajELUCejB41f,bWdj2GDclj5ofokWjzoa5jAwMkxCykd6,6,2,1,0,1,0,3,0,7,1.0,1,0.0,0,1,0,1,2,0,0,3,0,2,5,1
4171,57750,c7B7iseemfO0QdFbtlw4FK4yHsx5NyMH,SpATywNh6bZuzm8s1ceuBUnMUAeoAHHw,11,6,4,6,3,0,2,0,21,3.0,1,0.0,1,4,5,3,5,0,1,2,0,13,8,1
4172,57770,TiyssQ1xBxRpSE8M84hoblpjLNawoMPM,A3fsA9Zfv1X2fVEQhTw51lKENdNrEqT3,12,7,5,0,4,0,8,0,24,3.4285714285714284,3,0.0,0,5,0,4,7,0,0,8,0,9,15,1
4173,57777,RDWXbk79jB26meX1BrQSCYz1EfxumOsd,bWdj2GDclj5ofokWjzoa5jAwMkxCykd6,1,0,0,0,0,0,1,0,1,0.14285714285714285,1,0.0,0,0,0,0,0,0,0,1,0,0,1,1
4174,57793,QiC1wt4ygzMS12Sok49ryeSwI2RAnFQT,bWdj2GDclj5ofokWjzoa5jAwMkxCykd6,4,3,0,0,0,0,4,0,7,1.0,1,0.0,0,0,0,0,3,0,0,4,0,0,7,1
4175,57797,bZSiNUbAIuydDBd77IMAJ15Hy6k2A1kT,A3fsA9Zfv1X2fVEQhTw51lKENdNrEqT3,34,19,15,52,12,0,4,0,102,14.571428571428571,2,0.0,2,15,43,12,17,0,9,4,0,72,30,0
4176,57814,qdfZW2ffZy8gfDfLseVXmzjU3pjHztuR,SpATywNh6bZuzm8s1ceuBUnMUAeoAHHw,11,6,4,11,2,1,7,1,32,4.571428571428571,2,0.0,1,4,10,2,5,1,1,7,1,17,15,1
4177,57823,nTCOXKuQTHlcdJy5DLRFkg6Zh0x7ymZf,SpATywNh6bZuzm8s1ceuBUnMUAeoAHHw,22,49,5,30,2,3,13,0,102,14.571428571428571,2,0.0,13,5,27,2,36,3,3,13,0,47,55,0
4178,57840,97ov4fTuLcUGM3NRcbowYBsVQSUEYP2S,SpATywNh6bZuzm8s1ceuBUnMUAeoAHHw,7,6,3,0,3,0,1,0,13,1.8571428571428572,1,0.0,0,3,0,3,6,0,0,1,0,6,7,0
4179,57842,pJxqH2g5fYbOQNkZyqRIriBj2xa6OAqj,A3fsA9Zfv1X2fVEQhTw51lKENdNrEqT3,12,7,5,0,4,0,3,0,19,2.7142857142857144,2,0.0,0,5,0,4,7,0,0,3,0,9,10,0
4180,57865,6R0qSS2YfDD3HGMPKZeKRUJLbFOIEhNG,SpATywNh6bZuzm8s1ceuBUnMUAeoAHHw,11,21,2,0,1,0,4,0,28,4.0,2,0.0,0,2,0,1,21,0,0,4,0,3,25,0
4181,57882,X5rINxWa3wsNz25becwIKIJ1YSNrjMdg,bWdj2GDclj5ofokWjzoa5jAwMkxCykd6,2,0,0,0,0,0,2,0,2,0.2857142857142857,1,0.0,0,0,0,0,0,0,0,2,0,0,2,0
4182,57891,zwagDP4QQaMM8mzfViYvCtx8beK29IaC,A3fsA9Zfv1X2fVEQhTw51lKENdNrEqT3,5,2,1,0,1,0,3,0,7,1.0,1,0.0,0,1,0,1,2,0,0,3,0,2,5,1
4183,57921,LJN1NW4KDrkfGUEkF9SJPSL4rdPIFcim,RXDvfPUBYFlVdlueBFbLW0mhhAyGEqpt,11,10,5,0,2,0,6,0,23,3.2857142857142856,3,0.0,0,5,0,2,10,0,0,6,0,7,16,1
4184,57923,g6dPr9Qj9PAMVLVyPAgx25XT3ANwjQos,A3fsA9Zfv1X2fVEQhTw51lKENdNrEqT3,34,15,11,48,8,0,5,0,87,12.428571428571429,3,0.0,1,11,46,8,14,0,2,5,0,66,21,1
4185,57973,pZOzdWSKDu3gPwQbI7bGCPRq9RkLjBvS,SpATywNh6bZuzm8s1ceuBUnMUAeoAHHw,1,0,0,0,0,0,1,0,1,0.14285714285714285,1,0.0,0,0,0,0,0,0,0,1,0,0,1,1
4186,57974,kdNglpfKE0K2VvGEZqSD6DoYNnlqyGGv,SpATywNh6bZuzm8s1ceuBUnMUAeoAHHw,11,12,1,5,1,0,2,0,21,3.0,2,0.0,1,1,5,1,11,0,0,2,0,8,13,1
4187,57983,Di7uZGkXU7ZYc44baVoHLFkrq0yYlHlb,SpATywNh6bZuzm8s1ceuBUnMUAeoAHHw,28,37,15,27,7,2,9,0,97,13.857142857142858,2,0.0,9,15,26,7,28,2,1,9,0,57,40,0
4188,57985,Fg273P4R5QIMcXX0ux53RnorAp03dcGp,SpATywNh6bZuzm8s1ceuBUnMUAeoAHHw,5,7,1,0,1,0,2,0,11,1.5714285714285714,1,0.0,0,1,0,1,7,0,0,2,0,2,9,1
4189,58010,iHNKByBLJR2ePn7ZhbbN3FnmeYGE5yyC,SpATywNh6bZuzm8s1ceuBUnMUAeoAHHw,8,10,4,0,2,0,3,2,21,3.0,1,0.0,2,4,0,2,8,0,0,3,2,8,13,1
4190,58047,RTEXU8778fHYGtEiPFJloCtKj0eYc7zl,SpATywNh6bZuzm8s1ceuBUnMUAeoAHHw,6,3,0,0,0,4,4,0,11,1.5714285714285714,1,0.0,0,0,0,0,3,4,0,4,0,0,11,1
4191,58064,rtg3Ki4vk14kI9MkEBE0pkOCAO2AnCnU,A3fsA9Zfv1X2fVEQhTw51lKENdNrEqT3,72,53,36,160,17,0,17,1,284,40.57142857142857,6,0.0,3,36,132,17,50,0,28,17,1,188,96,0
4192,58067,pAWmot8vJjNkDuzTDPJSBxqvPejAjgVS,RXDvfPUBYFlVdlueBFbLW0mhhAyGEqpt,7,6,5,0,5,0,6,0,22,3.142857142857143,2,0.0,0,5,0,5,6,0,0,6,0,10,12,1
4193,58072,QWCcSRplc8XLohtOnjfleuw3Kl55Wt2l,G8EPVSXsOYB5YQWZGiz1aVq5Pgr2GrQu,20,28,15,4,9,0,2,0,58,8.285714285714286,2,0.0,5,15,3,9,23,0,1,2,0,32,26,1
4194,58081,VdrjT29t1tCYeqV5Pjs9K79bb5dKTQSe,SpATywNh6bZuzm8s1ceuBUnMUAeoAHHw,12,6,3,0,2,1,8,1,21,3.0,2,0.0,0,3,0,2,6,1,0,8,1,5,16,1
4195,58088,ohNbQfFfbGDEMVmhwhRAFtQhn1peVJYy,SpATywNh6bZuzm8s1ceuBUnMUAeoAHHw,17,15,10,16,6,3,4,0,54,7.714285714285714,2,0.0,3,10,14,6,12,3,2,4,0,33,21,1
4196,58090,02SLgXn6QytDv0WqMwkosTxHkpEuP7VB,bWdj2GDclj5ofokWjzoa5jAwMkxCykd6,5,2,1,0,1,0,2,0,6,0.8571428571428571,1,0.0,0,1,0,1,2,0,0,2,0,2,4,0
4197,58102,RPQvIQfjeayIRS4PyDyrIytbJ9ZHNktA,SpATywNh6bZuzm8s1ceuBUnMUAeoAHHw,31,54,27,12,7,7,18,1,126,18.0,8,0.0,16,27,12,7,38,7,0,18,1,62,64,1
4198,58103,7bgBjtUo1mIawwXbLRcW3oiIroDcQOz6,SpATywNh6bZuzm8s1ceuBUnMUAeoAHHw,5,2,1,0,1,0,2,0,6,0.8571428571428571,1,0.0,0,1,0,1,2,0,0,2,0,2,4,1
4199,58112,Bf025FfgNrlcqN8gYGnmBAhjBy0v5Xmo,A3fsA9Zfv1X2fVEQhTw51lKENdNrEqT3,8,7,4,0,2,0,6,0,19,2.7142857142857144,2,0.0,0,4,0,2,7,0,0,6,0,6,13,1
4200,58123,YUqfabBN24DH37opLol4A70oThsuifuQ,SpATywNh6bZuzm8s1ceuBUnMUAeoAHHw,1,0,0,0,0,0,1,0,1,0.14285714285714285,1,0.0,0,0,0,0,0,0,0,1,0,0,1,1
4201,58128,th3jtP88bHr6FB2R2HdadrOKTixMDxTi,SpATywNh6bZuzm8s1ceuBUnMUAeoAHHw,11,11,3,0,3,0,16,1,34,4.857142857142857,3,0.0,0,3,0,3,11,0,0,16,1,6,28,1
4202,58133,dytCdr5a5mu9Lr4Kt80AVLD7WwBUELzE,A3fsA9Zfv1X2fVEQhTw51lKENdNrEqT3,13,23,12,0,5,0,5,0,45,6.428571428571429,2,0.0,0,12,0,5,23,0,0,5,0,17,28,1
4203,58150,7a8ZShKuD962zsBaN4mct9BkYS1KNLrF,SpATywNh6bZuzm8s1ceuBUnMUAeoAHHw,15,16,10,5,6,1,5,0,43,6.142857142857143,1,0.0,2,10,4,6,14,1,1,5,0,22,21,0
4204,58153,5IgfYzsKnLRjBd3YVdiUAOaMV18WR5D2,SpATywNh6bZuzm8s1ceuBUnMUAeoAHHw,2,0,0,0,0,0,3,0,3,0.42857142857142855,2,0.0,0,0,0,0,0,0,0,3,0,0,3,1
4205,58161,0WJYCLUpH1qPXc41N4k9wHMseoSu2vAz,SpATywNh6bZuzm8s1ceuBUnMUAeoAHHw,30,42,19,29,8,5,6,0,109,15.571428571428571,3,0.0,17,19,26,8,25,5,3,6,0,70,39,0
4206,58181,XuNt1i5t4SR1AjDP4UHvsoux0R9qVf5C,A3fsA9Zfv1X2fVEQhTw51lKENdNrEqT3,23,15,7,52,2,0,3,0,79,11.285714285714286,1,0.0,0,7,49,2,15,0,3,3,0,58,21,1
4207,58216,nZTn5dZMRyIKKNGuMbIWH6lpWaWoYX62,bWdj2GDclj5ofokWjzoa5jAwMkxCykd6,5,3,1,0,1,0,2,0,7,1.0,1,0.0,0,1,0,1,3,0,0,2,0,2,5,1
4208,58242,JaIi02fnjAZfoUxjYtpyJ7uZYWKdC5yF,RXDvfPUBYFlVdlueBFbLW0mhhAyGEqpt,20,54,3,17,4,10,17,0,105,15.0,3,0.0,6,3,17,4,48,10,0,17,0,30,75,1
4209,58254,hkGRaSb7xMufUFhBVJXaeYKKkPgEjvNE,SpATywNh6bZuzm8s1ceuBUnMUAeoAHHw,12,9,1,0,1,0,3,1,15,2.142857142857143,1,0.0,0,1,0,1,9,0,0,3,1,2,13,1
4210,58255,zzLagpOecSivjjn7PNG5qmEhwa4PmnNX,SpATywNh6bZuzm8s1ceuBUnMUAeoAHHw,21,48,22,30,7,0,17,0,124,17.714285714285715,5,0.0,17,22,27,7,31,0,3,17,0,73,51,1
4211,58270,49oypRKmbhsESvRt5ynYhyueQezYQsCQ,bWdj2GDclj5ofokWjzoa5jAwMkxCykd6,4,2,0,0,0,0,3,0,5,0.7142857142857143,2,0.0,0,0,0,0,2,0,0,3,0,0,5,1
4212,58271,S8Q8neHdkaiSIrDXkWMhuMhsENfqfEdt,G8EPVSXsOYB5YQWZGiz1aVq5Pgr2GrQu,8,10,3,0,5,0,5,0,23,3.2857142857142856,1,0.0,6,3,0,5,4,0,0,5,0,14,9,1
4213,58272,xOB7vl3l1Tpb0i0cSWni40BfJ5FBclms,A3fsA9Zfv1X2fVEQhTw51lKENdNrEqT3,41,39,10,74,8,3,20,0,154,22.0,4,0.0,3,10,66,8,36,3,8,20,0,87,67,1
4214,58273,YkzGM7FCSZusATw7cM0Pqx3TXux1w8Gj,SpATywNh6bZuzm8s1ceuBUnMUAeoAHHw,5,2,1,0,1,0,2,0,6,0.8571428571428571,1,0.0,0,1,0,1,2,0,0,2,0,2,4,1
4215,58286,y6i20DJpIul6LihHwgZcWxbdAap5GcBP,A3fsA9Zfv1X2fVEQhTw51lKENdNrEqT3,16,18,8,0,3,14,15,1,59,8.428571428571429,5,0.0,2,8,0,3,16,14,0,15,1,13,46,1
4216,58291,PCPmtsqEtkHe7GooXQswbqyH8cnukgFn,G8EPVSXsOYB5YQWZGiz1aVq5Pgr2GrQu,51,55,9,82,4,29,9,1,189,27.0,2,0.0,25,9,61,4,30,29,21,9,1,99,90,0
4217,58293,3ZzhbGHk0AMavVBVS0pUAaZvWnLoQODp,A3fsA9Zfv1X2fVEQhTw51lKENdNrEqT3,5,3,1,0,1,0,1,0,6,0.8571428571428571,1,0.0,0,1,0,1,3,0,0,1,0,2,4,0
4218,58300,uQw9hBSE2Dk9ZRkbmlhR0YJ8RRLoEt0U,SpATywNh6bZuzm8s1ceuBUnMUAeoAHHw,14,12,2,10,1,0,3,0,28,4.0,2,0.0,2,2,10,1,10,0,0,3,0,15,13,1
4219,58316,GfppdBt6zqP8G2m8ukjaahHhJ4ewTb0w,SpATywNh6bZuzm8s1ceuBUnMUAeoAHHw,22,56,3,28,1,1,6,0,95,13.571428571428571,6,0.0,11,3,26,1,45,1,2,6,0,41,54,0
4220,58328,bwboRgaiFEflIqviFAKUixpzo8aJUZGL,G8EPVSXsOYB5YQWZGiz1aVq5Pgr2GrQu,49,198,1,116,4,0,14,1,334,47.714285714285715,4,0.0,66,1,64,4,132,0,52,14,1,135,199,0
4221,58357,OdMr7dE5UlAme9Tp979vREBvY5CV50po,A3fsA9Zfv1X2fVEQhTw51lKENdNrEqT3,87,38,23,168,12,0,8,0,249,35.57142857142857,4,0.0,7,23,153,12,31,0,15,8,0,195,54,0
4222,58359,czKChsqaxfwVoznY2WnWYH2vLIXb6X34,bWdj2GDclj5ofokWjzoa5jAwMkxCykd6,18,24,14,2,12,1,5,0,58,8.285714285714286,3,0.0,3,14,2,12,21,1,0,5,0,31,27,1
4223,58371,O77ylT4ugXOb86DaYG0RYlYAbEVpuj16,bWdj2GDclj5ofokWjzoa5jAwMkxCykd6,6,3,1,0,2,0,3,0,9,1.2857142857142858,1,0.0,2,1,0,2,1,0,0,3,0,5,4,1
4224,58383,ewcDv7X6I323ciCMJsU4n4MdvO632A9I,bWdj2GDclj5ofokWjzoa5jAwMkxCykd6,8,11,1,136,1,0,3,0,152,21.714285714285715,1,0.0,7,1,135,1,4,0,1,3,0,144,8,1
4225,58387,AsOtGuZjIIEs9Ge9E033Sbp9VeIeUiUH,A3fsA9Zfv1X2fVEQhTw51lKENdNrEqT3,9,7,5,0,4,0,2,0,18,2.5714285714285716,2,0.0,0,5,0,4,7,0,0,2,0,9,9,1
4226,58396,vMwiflFInrKAqz6Uhuhl7ZJhinTtaSMK,SpATywNh6bZuzm8s1ceuBUnMUAeoAHHw,1,0,0,0,0,0,1,0,1,0.14285714285714285,1,0.0,0,0,0,0,0,0,0,1,0,0,1,1
4227,58403,Xn2ydtleLSG85TyAEd0OMkY2BfH9jhfO,SpATywNh6bZuzm8s1ceuBUnMUAeoAHHw,27,42,3,36,4,52,14,1,152,21.714285714285715,3,0.0,12,3,30,4,30,52,6,14,1,49,103,0
4228,58404,RBJm407yEn5NJTf66xkOViV4vHRGXhZs,A3fsA9Zfv1X2fVEQhTw51lKENdNrEqT3,37,40,20,0,17,0,7,0,84,12.0,1,0.0,0,20,0,17,40,0,0,7,0,37,47,0
4229,58453,fgzbUfrTxXYCuiFYTG1cTemcEJUl36an,A3fsA9Zfv1X2fVEQhTw51lKENdNrEqT3,10,11,4,0,3,0,6,0,24,3.4285714285714284,5,0.0,0,4,0,3,11,0,0,6,0,7,17,1
4230,58459,UO0yW1yQ6dpOPTHCocxgWJWaWMRmXAmV,SpATywNh6bZuzm8s1ceuBUnMUAeoAHHw,15,18,5,4,4,0,6,0,37,5.285714285714286,3,0.0,1,5,3,4,17,0,1,6,0,13,24,0
4231,58485,UO0yW1yQ6dpOPTHCocxgWJWaWMRmXAmV,A3fsA9Zfv1X2fVEQhTw51lKENdNrEqT3,1,0,0,0,0,0,1,0,1,0.14285714285714285,1,0.0,0,0,0,0,0,0,0,1,0,0,1,1
4232,58503,uznRyNJNtd1ZgZ95fF39jNQxAuIkBivb,A3fsA9Zfv1X2fVEQhTw51lKENdNrEqT3,29,36,27,12,22,0,12,0,109,15.571428571428571,3,0.0,2,27,12,22,34,0,0,12,0,63,46,0
4233,58524,T761UltC8HrAVgHTpcJuQFf7vNJ3Ud9J,A3fsA9Zfv1X2fVEQhTw51lKENdNrEqT3,40,48,32,0,23,0,5,0,108,15.428571428571429,3,0.0,0,32,0,23,48,0,0,5,0,55,53,0
4234,58526,OgKWYLWF7k4jNyuIPtj4HfbaQ79kKNws,A3fsA9Zfv1X2fVEQhTw51lKENdNrEqT3,21,16,13,0,10,0,14,0,53,7.571428571428571,4,0.0,0,13,0,10,16,0,0,14,0,23,30,1
4235,58544,bpxaFadaQixJuWRVtAAq5miKiBM3zC6u,A3fsA9Zfv1X2fVEQhTw51lKENdNrEqT3,43,76,4,88,3,21,25,0,217,31.0,9,0.0,2,4,83,3,74,21,5,25,0,92,125,0
4236,58546,u1YszrViylpVYfK1eoJx8s7LOLPdQuxR,G8EPVSXsOYB5YQWZGiz1aVq5Pgr2GrQu,8,6,1,0,1,1,5,1,15,2.142857142857143,1,0.0,3,1,0,1,3,1,0,5,1,5,10,1
4237,58560,3wojMge418Q4FflCb29r3hem59j6egRX,SpATywNh6bZuzm8s1ceuBUnMUAeoAHHw,21,54,1,20,0,5,23,0,103,14.714285714285714,5,0.0,20,1,16,0,34,5,4,23,0,37,66,1
4238,58581,2rfL8B4HbJAOL6vHmGEftXwUPWvgkqAq,G8EPVSXsOYB5YQWZGiz1aVq5Pgr2GrQu,2,0,0,0,0,0,2,0,2,0.2857142857142857,1,0.0,0,0,0,0,0,0,0,2,0,0,2,1
4239,58582,o0M6SOlciWGWtqkYLASaq6tS76D18V6N,SpATywNh6bZuzm8s1ceuBUnMUAeoAHHw,30,69,25,40,10,47,22,1,214,30.571428571428573,6,0.0,28,25,33,10,41,47,7,22,1,96,118,0
4240,58598,7Yap2PcZ1Tcmw27mR2CH7ZbGwXBMRlQy,bWdj2GDclj5ofokWjzoa5jAwMkxCykd6,7,3,1,0,1,0,8,1,14,2.0,1,0.0,0,1,0,1,3,0,0,8,1,2,12,1
4241,58600,O3gLgOLI0OlNHxEv48gq43YbMqSfrrr5,SpATywNh6bZuzm8s1ceuBUnMUAeoAHHw,1,0,0,0,0,0,1,0,1,0.14285714285714285,1,0.0,0,0,0,0,0,0,0,1,0,0,1,1
4242,58601,pIkx6nDAjTla5NYVEsjhMXOIu5zXDzmO,G8EPVSXsOYB5YQWZGiz1aVq5Pgr2GrQu,31,23,16,0,15,0,11,2,67,9.571428571428571,3,0.0,3,16,0,15,20,0,0,11,2,34,33,0
4243,58614,Elb131j0dQdh1y8beabFLrOKaH2n8x2C,SpATywNh6bZuzm8s1ceuBUnMUAeoAHHw,1,0,0,0,0,0,1,0,1,0.14285714285714285,1,0.0,0,0,0,0,0,0,0,1,0,0,1,1
4244,58637,2CPNIar2bLO0Nk3gqpw6tYIpylWKP9T0,RXDvfPUBYFlVdlueBFbLW0mhhAyGEqpt,20,26,9,28,13,0,10,0,86,12.285714285714286,3,0.0,17,9,26,13,9,0,2,10,0,65,21,0
4245,58640,z0d4GdTRWwPphB67CIM0rjy94Artnm4E,bWdj2GDclj5ofokWjzoa5jAwMkxCykd6,13,16,9,4,7,15,9,1,61,8.714285714285714,2,0.0,2,9,4,7,14,15,0,9,1,22,39,1
4246,58641,0du1ow9RqiNaGy3uHg59U3uAi9Pl6foI,SpATywNh6bZuzm8s1ceuBUnMUAeoAHHw,6,3,1,0,1,0,2,0,7,1.0,1,0.0,0,1,0,1,3,0,0,2,0,2,5,1
4247,58642,ALYZFAVviUOGzyN4znk46d3PmVgvtUAM,A3fsA9Zfv1X2fVEQhTw51lKENdNrEqT3,35,24,2,74,1,0,4,0,105,15.0,2,0.0,1,2,62,1,23,0,12,4,0,66,39,1
4248,58644,zWZdErlwOQ1yvd6vlyAltL2Balhdc8gj,G8EPVSXsOYB5YQWZGiz1aVq5Pgr2GrQu,112,138,84,296,33,57,29,1,638,91.14285714285714,9,0.0,24,84,253,33,114,57,43,29,1,394,244,0
4249,58658,CG3QLsuznsakuKho7ljIoKCjBowMzxNf,SpATywNh6bZuzm8s1ceuBUnMUAeoAHHw,6,3,2,0,2,0,1,0,8,1.1428571428571428,1,0.0,0,2,0,2,3,0,0,1,0,4,4,0
4250,58675,jm31Z85lUKPglpGy76SHR0pRWJW0VhuU,SpATywNh6bZuzm8s1ceuBUnMUAeoAHHw,23,48,6,22,1,1,13,0,91,13.0,5,0.0,10,6,22,1,38,1,0,13,0,39,52,1
4251,58686,y9A8XMlmfPaglBBuQFjiuxUOvb1WQu2v,bWdj2GDclj5ofokWjzoa5jAwMkxCykd6,1,0,0,0,0,0,1,0,1,0.14285714285714285,1,0.0,0,0,0,0,0,0,0,1,0,0,1,0
4252,58692,2rfL8B4HbJAOL6vHmGEftXwUPWvgkqAq,A3fsA9Zfv1X2fVEQhTw51lKENdNrEqT3,5,2,1,0,1,0,3,0,7,1.0,1,0.0,0,1,0,1,2,0,0,3,0,2,5,1
4253,58693,2AEx3J0dyYAsdnSPWbdrCmQApLqSYiKY,SpATywNh6bZuzm8s1ceuBUnMUAeoAHHw,32,52,28,22,8,12,15,2,139,19.857142857142858,3,0.0,17,28,17,8,35,12,5,15,2,70,69,0
4254,58738,eFoLZ7Ff0p8wCkYKEUOC13yf0OTaGh2R,A3fsA9Zfv1X2fVEQhTw51lKENdNrEqT3,2,0,0,0,0,0,6,0,6,0.8571428571428571,1,0.0,0,0,0,0,0,0,0,6,0,0,6,1
4255,58755,Hw4Baku6JlYmMCYHpyYlIRmyrGYxbxqZ,bWdj2GDclj5ofokWjzoa5jAwMkxCykd6,4,2,1,0,1,0,1,0,5,0.7142857142857143,1,0.0,0,1,0,1,2,0,0,1,0,2,3,1
4256,58763,HZ8Q7bQ1EwRW8jOabrhMI019qnvyVzyL,G8EPVSXsOYB5YQWZGiz1aVq5Pgr2GrQu,63,108,26,86,23,20,10,3,276,39.42857142857143,4,0.0,51,26,52,23,57,20,34,10,3,152,124,0
4257,58765,rc05wotvNjs6yb6NUxWRBXqWQTWfWnjs,SpATywNh6bZuzm8s1ceuBUnMUAeoAHHw,9,10,1,0,0,0,4,0,15,2.142857142857143,1,0.0,0,1,0,0,10,0,0,4,0,1,14,1
4258,58777,4Ofl2Ny0Hi8mgxaGCrkktZk3mHl8PQkx,SpATywNh6bZuzm8s1ceuBUnMUAeoAHHw,1,0,0,0,0,0,1,0,1,0.14285714285714285,1,0.0,0,0,0,0,0,0,0,1,0,0,1,1
4259,58791,rc05wotvNjs6yb6NUxWRBXqWQTWfWnjs,bWdj2GDclj5ofokWjzoa5jAwMkxCykd6,1,0,0,0,0,0,1,0,1,0.14285714285714285,1,0.0,0,0,0,0,0,0,0,1,0,0,1,1
4260,58794,1zErz13s8fNQRVaEvkOtvw6bLhr23yB4,SpATywNh6bZuzm8s1ceuBUnMUAeoAHHw,13,15,6,31,0,0,2,0,54,7.714285714285714,2,0.0,7,6,26,0,8,0,5,2,0,39,15,0
4261,58800,irZDaKqT4KdxcZGgiOHoDpvTtZyUugWP,G8EPVSXsOYB5YQWZGiz1aVq5Pgr2GrQu,75,70,25,187,12,8,21,0,323,46.142857142857146,7,0.0,1,25,170,12,69,8,17,21,0,208,115,0
4262,58804,OUbh6hvaOJDp9RK7kgTBzzPmjzmkYhZF,SpATywNh6bZuzm8s1ceuBUnMUAeoAHHw,25,37,0,24,1,16,15,2,95,13.571428571428571,5,0.0,5,0,21,1,32,16,3,15,2,27,68,0
4263,58806,Sz4iN9vM7plSJObu2Kgng7aJijtNNsts,SpATywNh6bZuzm8s1ceuBUnMUAeoAHHw,9,11,1,0,0,1,1,0,14,2.0,1,0.0,1,1,0,0,10,1,0,1,0,2,12,1
4264,58812,x2TXADDQJTDLVMnKDb6BhJyWEoYQjlQy,SpATywNh6bZuzm8s1ceuBUnMUAeoAHHw,23,45,0,26,1,8,10,0,90,12.857142857142858,6,0.0,19,0,20,1,26,8,6,10,0,40,50,1
4265,58818,67rSRaCVWXo14Jy7qMP7vHh2SS3POF3M,G8EPVSXsOYB5YQWZGiz1aVq5Pgr2GrQu,55,50,31,20,21,2,20,4,148,21.142857142857142,3,0.0,10,31,10,21,40,2,10,20,4,72,76,0
4266,58833,z9n4TGh9UXCrVLnylY34Ni1zPy7fphxP,G8EPVSXsOYB5YQWZGiz1aVq5Pgr2GrQu,8,15,10,0,0,1,2,0,28,4.0,2,0.0,2,10,0,0,13,1,0,2,0,12,16,1
4267,58849,9UxAqNYuBtvS2ppV37y5D8wZyoNAl3Em,SpATywNh6bZuzm8s1ceuBUnMUAeoAHHw,16,53,8,15,2,23,16,4,121,17.285714285714285,4,0.0,13,8,12,2,40,23,3,16,4,35,86,1
4268,58855,6K3h9aDeHI9AUqOKTvZxzGkKh6WMc7A3,SpATywNh6bZuzm8s1ceuBUnMUAeoAHHw,16,10,8,0,6,0,4,0,28,4.0,2,0.0,0,8,0,6,10,0,0,4,0,14,14,0
4269,58877,Hoitr98hXhrf7xDGgACEFamKhiarA3wg,SpATywNh6bZuzm8s1ceuBUnMUAeoAHHw,30,66,39,28,15,44,18,1,211,30.142857142857142,8,0.0,14,39,26,15,52,44,2,18,1,94,117,0
4270,58887,7wyfXvc1g99QNmXzEb4w8C1vE0Vi2bHm,RXDvfPUBYFlVdlueBFbLW0mhhAyGEqpt,22,34,16,0,9,1,7,0,67,9.571428571428571,4,0.0,0,16,0,9,34,1,0,7,0,25,42,0
4271,58893,Oh4qObC7j4dz8QtvEnVVjGNXqScAv0Td,A3fsA9Zfv1X2fVEQhTw51lKENdNrEqT3,1,0,0,0,0,0,1,0,1,0.14285714285714285,1,0.0,0,0,0,0,0,0,0,1,0,0,1,0
4272,58928,oxKInSadxtDVW8xImZsLo8dMy3cZAYYB,G8EPVSXsOYB5YQWZGiz1aVq5Pgr2GrQu,6,2,2,0,2,0,6,0,12,1.7142857142857142,1,0.0,0,2,0,2,2,0,0,6,0,4,8,0
4273,58931,KF0Hp0kY1zRx3PfsDN1lrNbV34F9NU2o,SpATywNh6bZuzm8s1ceuBUnMUAeoAHHw,1,0,0,0,0,0,1,0,1,0.14285714285714285,1,0.0,0,0,0,0,0,0,0,1,0,0,1,1
4274,58937,BWQpUowEHGBDEzSf23lNUZVBPlEw3Sq1,SpATywNh6bZuzm8s1ceuBUnMUAeoAHHw,23,42,4,24,0,1,13,0,84,12.0,7,0.0,12,4,18,0,30,1,6,13,0,34,50,0
4275,58988,yQ30DktO8KD929ApuNMOdNKTtmTpkfc3,SpATywNh6bZuzm8s1ceuBUnMUAeoAHHw,3,0,0,0,0,8,4,0,12,1.7142857142857142,2,0.0,0,0,0,0,0,8,0,4,0,0,12,1
4276,58995,s52sWVKWNW4BhZF8lEKgLOTywZdUL59a,A3fsA9Zfv1X2fVEQhTw51lKENdNrEqT3,46,42,24,76,14,1,23,4,184,26.285714285714285,4,0.0,3,24,65,14,39,1,11,23,4,106,78,1
4277,59000,yQ30DktO8KD929ApuNMOdNKTtmTpkfc3,bWdj2GDclj5ofokWjzoa5jAwMkxCykd6,3,0,0,0,0,4,2,0,6,0.8571428571428571,1,0.0,0,0,0,0,0,4,0,2,0,0,6,1
4278,59003,yQ30DktO8KD929ApuNMOdNKTtmTpkfc3,RXDvfPUBYFlVdlueBFbLW0mhhAyGEqpt,3,0,0,0,0,4,2,0,6,0.8571428571428571,1,0.0,0,0,0,0,0,4,0,2,0,0,6,1
4279,59023,1zErz13s8fNQRVaEvkOtvw6bLhr23yB4,G8EPVSXsOYB5YQWZGiz1aVq5Pgr2GrQu,56,95,41,108,16,10,24,3,297,42.42857142857143,5,0.0,34,41,75,16,61,10,33,24,3,166,131,0
4280,59030,yxVlIOgiPy2uO2769tIJMAsvrTHms87z,SpATywNh6bZuzm8s1ceuBUnMUAeoAHHw,1,0,0,0,0,0,1,0,1,0.14285714285714285,1,0.0,0,0,0,0,0,0,0,1,0,0,1,1
4281,59043,SicKtTdinGjYgkh3dK0y8UiEfELy0LiN,A3fsA9Zfv1X2fVEQhTw51lKENdNrEqT3,4,3,2,0,0,0,1,0,6,0.8571428571428571,1,0.0,0,2,0,0,3,0,0,1,0,2,4,1
4282,59059,WyukafQHQxismOtYiPzoFkAc38hAOB09,SpATywNh6bZuzm8s1ceuBUnMUAeoAHHw,31,80,35,29,14,17,14,0,189,27.0,7,0.0,36,35,26,14,44,17,3,14,0,111,78,0
4283,59061,XviXJdbSmJpUjtXY3NDPcBVoPrslVGvz,A3fsA9Zfv1X2fVEQhTw51lKENdNrEqT3,2,0,0,0,0,0,2,0,2,0.2857142857142857,1,0.0,0,0,0,0,0,0,0,2,0,0,2,1
4284,59074,pspPjjKHZe0z6Fq8OVRjBFFpabOEyxUN,G8EPVSXsOYB5YQWZGiz1aVq5Pgr2GrQu,1,0,0,0,0,0,1,0,1,0.14285714285714285,1,0.0,0,0,0,0,0,0,0,1,0,0,1,0
4285,59086,QscGDFmAAH7jp4ntcbRqVptjZvFSEe7R,bWdj2GDclj5ofokWjzoa5jAwMkxCykd6,1,0,0,0,0,0,1,0,1,0.14285714285714285,1,0.0,0,0,0,0,0,0,0,1,0,0,1,1
4286,59096,ycTj3YOXaJ7pHDIwrzbh7koMVXAXAOVY,A3fsA9Zfv1X2fVEQhTw51lKENdNrEqT3,9,4,3,0,3,0,2,0,12,1.7142857142857142,1,0.0,0,3,0,3,4,0,0,2,0,6,6,1
4287,59112,SSR2C7GBXM7XyR67GN0wwOxiCuLYjW4G,SpATywNh6bZuzm8s1ceuBUnMUAeoAHHw,27,85,5,42,6,8,31,3,180,25.714285714285715,6,0.0,26,5,36,6,59,8,6,31,3,73,107,0
4288,59123,GDXKLbggMsEQESvte5Fm99YDi8EaSknC,SpATywNh6bZuzm8s1ceuBUnMUAeoAHHw,2,0,0,0,0,0,2,0,2,0.2857142857142857,1,0.0,0,0,0,0,0,0,0,2,0,0,2,1
4289,59133,kqS8BwWN9R1093oeblGkvtCsQJ68Gh0G,A3fsA9Zfv1X2fVEQhTw51lKENdNrEqT3,11,11,6,0,2,3,7,0,29,4.142857142857143,3,0.0,1,6,0,2,10,3,0,7,0,9,20,1
4290,59152,1QXHZAtBZ2KaQglYqYbNwbUn7ThwuB1g,A3fsA9Zfv1X2fVEQhTw51lKENdNrEqT3,1,0,0,0,0,0,1,0,1,0.14285714285714285,1,0.0,0,0,0,0,0,0,0,1,0,0,1,1
4291,59154,xkk52A95ro7prnFrC4vTRChCiKRyqt9P,bWdj2GDclj5ofokWjzoa5jAwMkxCykd6,13,11,6,4,7,1,6,1,36,5.142857142857143,2,0.0,4,6,4,7,7,1,0,6,1,21,15,1
4292,59155,1QXHZAtBZ2KaQglYqYbNwbUn7ThwuB1g,RXDvfPUBYFlVdlueBFbLW0mhhAyGEqpt,11,10,2,12,2,4,8,1,39,5.571428571428571,1,0.0,6,2,10,2,4,4,2,8,1,20,19,1
4293,59158,83bogZlv4TVHMx4MUYOU3yEQWNYHnGAe,A3fsA9Zfv1X2fVEQhTw51lKENdNrEqT3,6,4,2,0,0,0,3,1,10,1.4285714285714286,1,0.0,0,2,0,0,4,0,0,3,1,2,8,1
4294,59163,Jx3Mosyeukaoh3SiTDGSPF6OEZs0bdWa,bWdj2GDclj5ofokWjzoa5jAwMkxCykd6,15,9,7,0,6,4,7,1,34,4.857142857142857,1,0.0,0,7,0,6,9,4,0,7,1,13,21,1
4295,59172,jImHfNEIObE674KdIbKVj7cCJ4ufqzHJ,SpATywNh6bZuzm8s1ceuBUnMUAeoAHHw,9,25,12,0,3,59,10,0,109,15.571428571428571,5,0.0,2,12,0,3,23,59,0,10,0,17,92,0
4296,59176,EEY05e2oBdca2rsoXfuwyrFxbCmUnL6Y,SpATywNh6bZuzm8s1ceuBUnMUAeoAHHw,1,0,0,0,0,0,2,0,2,0.2857142857142857,2,0.0,0,0,0,0,0,0,0,2,0,0,2,1
4297,59184,GBRSAR4GUGDv32LhHoze2mah1gIJQuBL,bWdj2GDclj5ofokWjzoa5jAwMkxCykd6,1,0,0,0,0,0,1,0,1,0.14285714285714285,1,0.0,0,0,0,0,0,0,0,1,0,0,1,1
4298,60061,bYV2ECkbVEzILNLnjio0M2wLrbMzskol,7GRhBDsirIGkRZBtSMEzNTyDr2JQm4xx,2,0,0,0,0,0,2,0,2,0.2857142857142857,1,0.0,0,0,0,0,0,0,0,2,0,0,2,1
4299,60066,OkJ0lKmMXuQ2MGftQ8Isfw1JciMpapRC,7GRhBDsirIGkRZBtSMEzNTyDr2JQm4xx,1,0,0,0,0,0,1,0,1,0.14285714285714285,1,0.0,0,0,0,0,0,0,0,1,0,0,1,1
4300,60074,Vve0UwhmiGWZN8bT2t4sC82sMWi2ZyY8,7GRhBDsirIGkRZBtSMEzNTyDr2JQm4xx,14,8,3,14,4,1,15,1,46,6.571428571428571,3,0.0,4,3,13,4,4,1,1,15,1,24,22,1
4301,60186,YIoKCUIP4Rx4Vrk0MaySMDs3xqxsTZ0O,7GRhBDsirIGkRZBtSMEzNTyDr2JQm4xx,27,22,10,33,6,0,7,0,78,11.142857142857142,2,0.0,9,10,30,6,13,0,3,7,0,55,23,1
4302,60189,trY5Yo0vbJ00GveQ31z4FIOxjL0ITdnW,7GRhBDsirIGkRZBtSMEzNTyDr2JQm4xx,5,2,1,0,1,0,2,0,6,0.8571428571428571,1,0.0,0,1,0,1,2,0,0,2,0,2,4,0
4303,60193,ya3v1iYETjj0QFCSbW4Y8PQXQRFY49xl,7GRhBDsirIGkRZBtSMEzNTyDr2JQm4xx,40,91,27,70,28,16,10,0,242,34.57142857142857,4,0.0,42,27,57,28,49,16,13,10,0,154,88,1
4304,60210,wGqhUJlJ3fGYOW2r7IbwNL0CdAR0avoU,7GRhBDsirIGkRZBtSMEzNTyDr2JQm4xx,72,258,91,198,59,133,15,0,754,107.71428571428571,9,0.0,145,91,151,59,113,133,47,15,0,446,308,1
4305,60214,Y3uwxWCm13Ol5xozrT2GPjOPhBlC2kOq,7GRhBDsirIGkRZBtSMEzNTyDr2JQm4xx,75,130,21,154,22,0,10,0,337,48.142857142857146,6,0.0,39,21,140,22,91,0,14,10,0,222,115,1
4306,60224,Glan4HLmS50xRoKOWAXnEjHiOG5ALXJa,7GRhBDsirIGkRZBtSMEzNTyDr2JQm4xx,2,0,0,0,0,0,2,0,2,0.2857142857142857,1,0.0,0,0,0,0,0,0,0,2,0,0,2,1
4307,60229,4IJ56QlJSL8avuRQEkrBcEyhUIO3LIP3,7GRhBDsirIGkRZBtSMEzNTyDr2JQm4xx,51,139,47,72,38,5,15,0,316,45.142857142857146,4,0.0,82,47,55,38,57,5,17,15,0,222,94,1
4308,60241,n2vbSLePtnxy4AVvThroeNvlXpcTMINy,7GRhBDsirIGkRZBtSMEzNTyDr2JQm4xx,30,38,14,2,9,0,4,0,67,9.571428571428571,2,0.0,8,14,1,9,30,0,1,4,0,32,35,0
4309,60245,yO1Jj5u6PMEcpPI9xjxordPxwxelX8AU,7GRhBDsirIGkRZBtSMEzNTyDr2JQm4xx,1,0,0,0,0,0,1,0,1,0.14285714285714285,1,0.0,0,0,0,0,0,0,0,1,0,0,1,1
4310,60264,iSrdvAXagFyTWuVpDzl1vXqwXkCyI8Nx,7GRhBDsirIGkRZBtSMEzNTyDr2JQm4xx,2,0,0,0,0,0,8,0,8,1.1428571428571428,3,0.0,0,0,0,0,0,0,0,8,0,0,8,1
4311,60279,vxpUumLCzU7FedUSJgEG4isBVr1VqobO,7GRhBDsirIGkRZBtSMEzNTyDr2JQm4xx,5,2,0,0,0,0,3,0,5,0.7142857142857143,1,0.0,0,0,0,0,2,0,0,3,0,0,5,1
4312,60283,uRNJHauAxW10nQZrIpEU1nj0mhvBnDcR,7GRhBDsirIGkRZBtSMEzNTyDr2JQm4xx,8,6,3,0,2,1,5,0,17,2.4285714285714284,2,0.0,0,3,0,2,6,1,0,5,0,5,12,1
4313,60285,3A3xnhkl0PPjpuPQj8ksbgab2OoOm2Bf,7GRhBDsirIGkRZBtSMEzNTyDr2JQm4xx,2,0,0,0,0,0,2,0,2,0.2857142857142857,1,0.0,0,0,0,0,0,0,0,2,0,0,2,1
4314,60295,zKEKzDZvBY5bjlEOjPTJFe0fxEtpR0hq,7GRhBDsirIGkRZBtSMEzNTyDr2JQm4xx,1,0,0,0,0,0,1,0,1,0.14285714285714285,1,0.0,0,0,0,0,0,0,0,1,0,0,1,1
4315,60359,FMaoSj6PouPVBL36elw7C1ayn8NuceeR,7GRhBDsirIGkRZBtSMEzNTyDr2JQm4xx,1,0,0,0,0,0,1,0,1,0.14285714285714285,1,0.0,0,0,0,0,0,0,0,1,0,0,1,1
4316,60427,r3TtJNrYEPB9JfkbBp23luDTSVLZGHt2,7GRhBDsirIGkRZBtSMEzNTyDr2JQm4xx,75,305,17,141,39,55,48,1,606,86.57142857142857,16,0.0,129,17,119,39,176,55,22,48,1,304,302,0
4317,60442,76btfIjeEvKDRqZ07unLyzOBWCQVXirv,7GRhBDsirIGkRZBtSMEzNTyDr2JQm4xx,31,24,9,46,9,0,4,0,92,13.142857142857142,3,0.0,12,9,40,9,12,0,6,4,0,70,22,0
4318,60518,r639bFH7kDBWMyuyounNz9zTrG9jbNqa,7GRhBDsirIGkRZBtSMEzNTyDr2JQm4xx,69,187,50,120,37,52,36,2,484,69.14285714285714,3,0.0,70,50,107,37,117,52,13,36,2,264,220,0
4319,60531,Vdzl3X3O6ZP4Npa6oBdNxCc6U3L9nvWo,7GRhBDsirIGkRZBtSMEzNTyDr2JQm4xx,75,202,58,113,42,12,19,0,446,63.714285714285715,6,0.0,105,58,97,42,97,12,16,19,0,302,144,0
4320,60537,HixqtECIw1MfDhOlFHcd4iKMiA1aAB20,7GRhBDsirIGkRZBtSMEzNTyDr2JQm4xx,1,0,0,0,0,0,1,0,1,0.14285714285714285,1,0.0,0,0,0,0,0,0,0,1,0,0,1,1
4321,60551,yYnzwoX1EEo9O5PANf4AeqhApgmnqHcZ,7GRhBDsirIGkRZBtSMEzNTyDr2JQm4xx,48,77,36,48,25,5,12,0,203,29.0,2,0.0,34,36,42,25,43,5,6,12,0,137,66,1
4322,60575,u5mzcmE18EKn09QMnw59wiWLJPMqcNLU,7GRhBDsirIGkRZBtSMEzNTyDr2JQm4xx,11,5,4,0,4,0,2,0,15,2.142857142857143,1,0.0,0,4,0,4,5,0,0,2,0,8,7,1
4323,60578,n8xDhUwKlkQ0nvvpXIE3P2WLYZ4QLCAp,7GRhBDsirIGkRZBtSMEzNTyDr2JQm4xx,1,0,0,0,0,0,1,0,1,0.14285714285714285,1,0.0,0,0,0,0,0,0,0,1,0,0,1,1
4324,60612,hXKu4e2xQzaCku75DATROcU5QTIKASt0,7GRhBDsirIGkRZBtSMEzNTyDr2JQm4xx,9,4,3,0,3,0,4,0,14,2.0,1,0.0,0,3,0,3,4,0,0,4,0,6,8,1
4325,60698,yWBM5NSXn0oxTlghKgVFEOhem7bIKtAR,7GRhBDsirIGkRZBtSMEzNTyDr2JQm4xx,1,0,0,0,0,0,1,0,1,0.14285714285714285,1,0.0,0,0,0,0,0,0,0,1,0,0,1,1
4326,60726,YmnL5Vd2hwZrlPvojHN5WzyBYQvWTeW1,7GRhBDsirIGkRZBtSMEzNTyDr2JQm4xx,2,0,0,0,0,0,2,0,2,0.2857142857142857,1,0.0,0,0,0,0,0,0,0,2,0,0,2,1
4327,60736,c9pXHqWvBB8LbdUhG5A5ihiNKOhfyXDu,7GRhBDsirIGkRZBtSMEzNTyDr2JQm4xx,6,7,0,0,0,0,3,0,10,1.4285714285714286,3,0.0,0,0,0,0,7,0,0,3,0,0,10,1
4328,60936,3bqMPd7dmQ6bVwYt9AjfxpDPMW8ppczj,7GRhBDsirIGkRZBtSMEzNTyDr2JQm4xx,4,2,1,0,1,1,1,0,6,0.8571428571428571,1,0.0,0,1,0,1,2,1,0,1,0,2,4,1
4329,60940,QVVTY0MAE22SN6rxHu950HeUm4kG0Wko,7GRhBDsirIGkRZBtSMEzNTyDr2JQm4xx,6,6,3,0,1,0,1,0,11,1.5714285714285714,1,0.0,0,3,0,1,6,0,0,1,0,4,7,1
4330,60941,GhWSz5WEMmds3hiXd5zoNrNGoNsN9LXL,7GRhBDsirIGkRZBtSMEzNTyDr2JQm4xx,14,14,6,0,4,1,12,1,38,5.428571428571429,2,0.0,5,6,0,4,9,1,0,12,1,15,23,1
4331,60960,hcKYo6bLhlANvHE0FxLuR4YY8jocfBwJ,7GRhBDsirIGkRZBtSMEzNTyDr2JQm4xx,1,0,0,0,0,0,1,0,1,0.14285714285714285,1,0.0,0,0,0,0,0,0,0,1,0,0,1,1
4332,60976,loY20pnf7suv2LWREXjC0h3XNawzaj7l,7GRhBDsirIGkRZBtSMEzNTyDr2JQm4xx,9,4,3,0,3,0,2,0,12,1.7142857142857142,1,0.0,0,3,0,3,4,0,0,2,0,6,6,1
4333,61001,KwMhn6xKDQ4sc6tWHQxhmw9vLZQikEKV,7GRhBDsirIGkRZBtSMEzNTyDr2JQm4xx,2,0,0,0,0,0,2,0,2,0.2857142857142857,1,0.0,0,0,0,0,0,0,0,2,0,0,2,1
4334,61039,RzKvPu4qwYnkKioYxIJem5I7hV4q5Zey,7GRhBDsirIGkRZBtSMEzNTyDr2JQm4xx,2,0,0,0,0,0,4,0,4,0.5714285714285714,2,0.0,0,0,0,0,0,0,0,4,0,0,4,0
4335,61087,GDHvw72iSHIz6VwsSteleP4praXBxk8h,7GRhBDsirIGkRZBtSMEzNTyDr2JQm4xx,38,76,1,36,6,33,13,5,170,24.285714285714285,4,0.0,40,1,26,6,36,33,10,13,5,73,97,1
4336,61130,v6Wfy2XnikKgnCNfehO3TIQzyPp7MzcN,7GRhBDsirIGkRZBtSMEzNTyDr2JQm4xx,2,0,0,0,0,0,2,0,2,0.2857142857142857,1,0.0,0,0,0,0,0,0,0,2,0,0,2,1
4337,61150,Z0pyF529vY6gfAXTUXYd2MCguE49KLJ7,7GRhBDsirIGkRZBtSMEzNTyDr2JQm4xx,2,0,0,0,0,0,4,0,4,0.5714285714285714,2,0.0,0,0,0,0,0,0,0,4,0,0,4,1
4338,61163,5HJHxaIfd0nCZcEUKuXJqPamaYk6aBtq,7GRhBDsirIGkRZBtSMEzNTyDr2JQm4xx,5,4,1,0,2,0,2,0,9,1.2857142857142858,1,0.0,2,1,0,2,2,0,0,2,0,5,4,1
4339,61200,Y3GsHv1t2an649bMll1LdxvN2SIICjxG,7GRhBDsirIGkRZBtSMEzNTyDr2JQm4xx,5,2,1,0,1,0,3,0,7,1.0,1,0.0,0,1,0,1,2,0,0,3,0,2,5,1
4340,61208,5REjJFENp7n9hcI3zWF81mKx1k4GQz67,7GRhBDsirIGkRZBtSMEzNTyDr2JQm4xx,12,11,1,12,0,5,7,0,36,5.142857142857143,2,0.0,10,1,6,0,1,5,6,7,0,17,19,1
4341,61235,qDUQ1iBvNWtXbHcBUbRaieW5ktYMRWE0,7GRhBDsirIGkRZBtSMEzNTyDr2JQm4xx,1,0,0,0,0,0,1,0,1,0.14285714285714285,1,0.0,0,0,0,0,0,0,0,1,0,0,1,1
4342,61604,X8nI71wgjvVnziT2GohIRTnyUeumIuGT,SpATywNh6bZuzm8s1ceuBUnMUAeoAHHw,17,21,12,18,6,38,14,2,111,15.857142857142858,4,0.0,2,12,15,6,19,38,3,14,2,35,76,0
4343,61609,0RRA0LeDh4nSJ7FMl9qY1fE7T0M4oANR,SpATywNh6bZuzm8s1ceuBUnMUAeoAHHw,26,28,9,30,4,2,16,1,90,12.857142857142858,3,0.0,8,9,28,4,20,2,2,16,1,49,41,0
4344,61634,PyaXrfJadEJJdtWYxd1SSz75aPVyhQhH,SpATywNh6bZuzm8s1ceuBUnMUAeoAHHw,24,38,0,34,0,17,17,4,110,15.714285714285714,3,0.0,17,0,30,0,21,17,4,17,4,47,63,0
4345,61638,lLutp8H3vKf6Z8olMEwVlKswK040AY6M,7GRhBDsirIGkRZBtSMEzNTyDr2JQm4xx,39,111,43,85,28,3,15,1,286,40.857142857142854,5,0.0,54,43,75,28,57,3,10,15,1,200,86,1
4346,61654,LYqZV37zE6nJxDsCo1hT04A5qKWsawBT,SpATywNh6bZuzm8s1ceuBUnMUAeoAHHw,17,30,16,17,6,13,35,1,118,16.857142857142858,4,0.0,5,16,14,6,25,13,3,35,1,41,77,0
4347,61675,gejGa8SAgjHkzsw2hD6p8TKYmXAjocFe,A3fsA9Zfv1X2fVEQhTw51lKENdNrEqT3,14,10,6,0,6,0,3,0,25,3.5714285714285716,1,0.0,0,6,0,6,10,0,0,3,0,12,13,1
4348,61703,1Ccev0ap5uQQlfggUCTp94lkg9qZetYO,SpATywNh6bZuzm8s1ceuBUnMUAeoAHHw,7,2,0,0,0,1,4,1,8,1.1428571428571428,1,0.0,0,0,0,0,2,1,0,4,1,0,8,1
4349,61713,MYsCU1zkMrWxPhV1b7wSL5LZIo1zGyhU,bWdj2GDclj5ofokWjzoa5jAwMkxCykd6,21,34,21,0,13,0,7,0,75,10.714285714285714,5,0.0,5,21,0,13,29,0,0,7,0,39,36,0
4350,61732,NcracMTfiaTPMbO6SSDnt9CDc4SnvBs9,SpATywNh6bZuzm8s1ceuBUnMUAeoAHHw,31,25,15,18,7,44,9,0,118,16.857142857142858,2,0.0,5,15,17,7,20,44,1,9,0,44,74,0
4351,61740,I9yi1jZjIznCPzP5fpMJEhPDMiUaetUu,SpATywNh6bZuzm8s1ceuBUnMUAeoAHHw,31,71,38,35,10,85,18,6,263,37.57142857142857,4,0.0,16,38,29,10,55,85,6,18,6,93,170,0
4352,61744,l30g3WB045lPyRkHzrw7l9v0SYLqOMWO,SpATywNh6bZuzm8s1ceuBUnMUAeoAHHw,20,59,22,28,6,8,15,2,140,20.0,5,0.0,12,22,23,6,47,8,5,15,2,63,77,0
4353,61745,ZQ6y2Bmw7qT9LD8jxMjYzUpaHRmpaQsM,A3fsA9Zfv1X2fVEQhTw51lKENdNrEqT3,4,2,0,0,0,0,3,0,5,0.7142857142857143,1,0.0,0,0,0,0,2,0,0,3,0,0,5,0
4354,61759,fx9PEMItfmJUgx5YPFOnYPw9ZcUduuYm,SpATywNh6bZuzm8s1ceuBUnMUAeoAHHw,15,38,4,12,1,1,16,1,73,10.428571428571429,2,0.0,6,4,11,1,32,1,1,16,1,22,51,1
4355,61801,2we3WxltFBT1dd0FjP3YZ8iHf2xpHEei,SpATywNh6bZuzm8s1ceuBUnMUAeoAHHw,28,34,16,14,9,0,7,0,80,11.428571428571429,5,0.0,4,16,13,9,30,0,1,7,0,42,38,1
4356,61837,2yFrrfFKwmpyH7xPcC8i0UYFZJHtjntf,SpATywNh6bZuzm8s1ceuBUnMUAeoAHHw,29,52,26,45,11,45,22,2,203,29.0,7,0.0,10,26,36,11,42,45,9,22,2,83,120,0
4357,61890,bY3M6NxBAZjGeFa96h2br6AbSx8krpDK,SpATywNh6bZuzm8s1ceuBUnMUAeoAHHw,14,16,9,19,7,7,4,0,62,8.857142857142858,2,0.0,3,9,15,7,13,7,4,4,0,34,28,0
4358,61910,TNArortVQm3F09odJ2W3xdM27lVc5PiX,SpATywNh6bZuzm8s1ceuBUnMUAeoAHHw,2,0,0,0,0,0,3,0,3,0.42857142857142855,1,0.0,0,0,0,0,0,0,0,3,0,0,3,0
4359,61916,XDPvGyFLLEYwbNEQik2MM4yiADs5rrYJ,A3fsA9Zfv1X2fVEQhTw51lKENdNrEqT3,5,5,2,0,1,0,3,0,11,1.5714285714285714,2,0.0,1,2,0,1,4,0,0,3,0,4,7,0
4360,61934,8dPQDWD7NMlHSztQh4Fh3dqPVx6xptft,SpATywNh6bZuzm8s1ceuBUnMUAeoAHHw,31,58,25,26,11,2,20,1,143,20.428571428571427,8,0.0,7,25,20,11,51,2,6,20,1,63,80,0
4361,61941,aJMNcTer76nTaYZZR58xtdmLr8BYq1Op,bWdj2GDclj5ofokWjzoa5jAwMkxCykd6,4,2,1,0,1,0,1,0,5,0.7142857142857143,1,0.0,0,1,0,1,2,0,0,1,0,2,3,0
4362,61948,MHUd30s3WtRLChM8IirlGkLsv26fGFJh,bWdj2GDclj5ofokWjzoa5jAwMkxCykd6,14,26,15,36,6,20,12,2,117,16.714285714285715,3,0.0,3,15,34,6,23,20,2,12,2,58,59,1
4363,61951,01vp16vMBdfdzNflK84lEgGXfBDKyb7S,SpATywNh6bZuzm8s1ceuBUnMUAeoAHHw,8,6,3,0,3,0,5,0,17,2.4285714285714284,1,0.0,2,3,0,3,4,0,0,5,0,8,9,1
4364,61959,0qbWIMzrwjcZydLWs8mxTmhu7QXiYFSP,7GRhBDsirIGkRZBtSMEzNTyDr2JQm4xx,11,8,5,0,6,0,3,0,22,3.142857142857143,1,0.0,2,5,0,6,6,0,0,3,0,13,9,1
4365,61968,oNcOLZOgRKuqVCWgf9VQFQ2ph82THXaV,7GRhBDsirIGkRZBtSMEzNTyDr2JQm4xx,17,58,22,0,13,0,7,0,100,14.285714285714286,3,0.0,4,22,0,13,54,0,0,7,0,39,61,1
4366,61970,rw1CeO1TCa8fgCdp1zXNf3dRKMz7g6nk,SpATywNh6bZuzm8s1ceuBUnMUAeoAHHw,5,5,3,0,1,0,2,0,11,1.5714285714285714,1,0.0,0,3,0,1,5,0,0,2,0,4,7,1
4367,61977,XupxNoKQxp2aAQkFy5RiZK4Yl6Wd1tRi,SpATywNh6bZuzm8s1ceuBUnMUAeoAHHw,22,48,5,18,4,25,25,3,128,18.285714285714285,9,0.0,5,5,15,4,43,25,3,25,3,29,99,0
4368,61994,pvjfd8HSIoVZ71m9TCBbQlraohrUi2x6,SpATywNh6bZuzm8s1ceuBUnMUAeoAHHw,14,14,1,17,0,0,2,0,34,4.857142857142857,1,0.0,1,1,14,0,13,0,3,2,0,16,18,0
4369,62001,9RakuKxD8WS6oi5xvzWI4nJK3Tjlrymz,7GRhBDsirIGkRZBtSMEzNTyDr2JQm4xx,5,2,1,0,1,0,2,0,6,0.8571428571428571,1,0.0,0,1,0,1,2,0,0,2,0,2,4,1
4370,62005,63waYBGRyitKxyJxVKV8NWeJFWacnPQr,7GRhBDsirIGkRZBtSMEzNTyDr2JQm4xx,8,5,4,0,4,0,1,0,14,2.0,1,0.0,0,4,0,4,5,0,0,1,0,8,6,1
4371,62011,vPv7PsanhRceiGshTPXtgrOmcrOEYM8O,SpATywNh6bZuzm8s1ceuBUnMUAeoAHHw,17,11,8,1,5,0,2,0,27,3.857142857142857,2,0.0,0,8,1,5,11,0,0,2,0,14,13,1
4372,62032,xMkkyPamBlQnoa7jeVZTYr4avomD93Rr,7GRhBDsirIGkRZBtSMEzNTyDr2JQm4xx,2,0,0,0,0,0,3,0,3,0.42857142857142855,1,0.0,0,0,0,0,0,0,0,3,0,0,3,1
4373,62051,xFkd6TNWJ8qmIM4trYH57onQcjo5lnU0,SpATywNh6bZuzm8s1ceuBUnMUAeoAHHw,18,44,13,18,5,0,12,0,92,13.142857142857142,6,0.0,7,13,17,5,37,0,1,12,0,42,50,0
4374,62072,VWEcCKiwp28lQZuBYYNslDL0523gk0Z6,SpATywNh6bZuzm8s1ceuBUnMUAeoAHHw,22,27,12,23,7,1,9,2,81,11.571428571428571,3,0.0,9,12,18,7,18,1,5,9,2,46,35,0
4375,62091,6AOZlfpjI3ayLpXvguaWVv2FqhQMzw4M,SpATywNh6bZuzm8s1ceuBUnMUAeoAHHw,16,23,9,20,0,0,8,0,60,8.571428571428571,6,0.0,6,9,19,0,17,0,1,8,0,34,26,0
4376,62133,CsUkH6E2FiorKRYwpRBQQof16ywBIfF7,SpATywNh6bZuzm8s1ceuBUnMUAeoAHHw,28,53,18,40,7,1,12,1,132,18.857142857142858,3,0.0,21,18,36,7,32,1,4,12,1,82,50,0
4377,62146,y8Q2VwfVlqk1j3XET9GUUSulEAonzlDI,7GRhBDsirIGkRZBtSMEzNTyDr2JQm4xx,4,0,0,0,0,0,5,1,6,0.8571428571428571,1,0.0,0,0,0,0,0,0,0,5,1,0,6,1
4378,62156,W2whDchxLBc7jpJ4UAVUryN7DSrj5pnr,SpATywNh6bZuzm8s1ceuBUnMUAeoAHHw,6,2,0,0,0,10,22,2,36,5.142857142857143,1,0.0,0,0,0,0,2,10,0,22,2,0,36,0
4379,62160,Mm7Iv2bcZu7V7eMb3kbuiZ6iWSUOq5iS,7GRhBDsirIGkRZBtSMEzNTyDr2JQm4xx,7,6,2,0,1,0,3,0,12,1.7142857142857142,2,0.0,0,2,0,1,6,0,0,3,0,3,9,1
4380,62161,We0slB08viHgFv6ByLfwdtuQZUg6JG7L,SpATywNh6bZuzm8s1ceuBUnMUAeoAHHw,2,0,0,0,0,0,2,0,2,0.2857142857142857,1,0.0,0,0,0,0,0,0,0,2,0,0,2,1
4381,62186,W0MWfR8rCQKyPPfo34tiE6MzA7EX1V3m,7GRhBDsirIGkRZBtSMEzNTyDr2JQm4xx,1,0,0,0,0,0,1,0,1,0.14285714285714285,1,0.0,0,0,0,0,0,0,0,1,0,0,1,1
4382,62208,mPSPvu82Gr17tV9GJ95bDC7exvsVnwDE,7GRhBDsirIGkRZBtSMEzNTyDr2JQm4xx,26,39,13,57,11,3,1,0,124,17.714285714285715,1,0.0,22,13,50,11,17,3,7,1,0,96,28,1
4383,62235,2cdJoONM7ugDmkPkQHwnxWZwEOIANTXn,SpATywNh6bZuzm8s1ceuBUnMUAeoAHHw,26,78,40,9,9,87,29,2,254,36.285714285714285,8,0.0,0,40,9,9,78,87,0,29,2,58,196,0
4384,62251,76Kz8DEQMUa3r549crPtcn99eC1czeI6,7GRhBDsirIGkRZBtSMEzNTyDr2JQm4xx,1,0,0,0,0,0,1,0,1,0.14285714285714285,1,0.0,0,0,0,0,0,0,0,1,0,0,1,1
4385,62290,FAyKTlOaLRLHiyLG5PXQhYddpdx56j0F,SpATywNh6bZuzm8s1ceuBUnMUAeoAHHw,19,43,20,19,9,6,12,1,110,15.714285714285714,3,0.0,13,20,16,9,30,6,3,12,1,58,52,0
4386,62305,jFuORSL1URM2oqg9zp9eOfHmKoYyUgBh,SpATywNh6bZuzm8s1ceuBUnMUAeoAHHw,26,42,8,28,4,1,10,1,94,13.428571428571429,3,0.0,16,8,25,4,26,1,3,10,1,53,41,1
4387,62321,4aUZNrEysB01BTDaMjEoJUWN7ca7RotB,SpATywNh6bZuzm8s1ceuBUnMUAeoAHHw,7,3,2,0,2,0,3,0,10,1.4285714285714286,1,0.0,0,2,0,2,3,0,0,3,0,4,6,1
4388,62331,FMwKUA8u0BzLarxpeAgKTtl6QSWIGKl8,SpATywNh6bZuzm8s1ceuBUnMUAeoAHHw,1,0,0,0,0,0,1,0,1,0.14285714285714285,1,0.0,0,0,0,0,0,0,0,1,0,0,1,0
4389,62371,sdgY41MIb6WYbIgC75Nfq2olF7e670eU,7GRhBDsirIGkRZBtSMEzNTyDr2JQm4xx,6,3,1,0,1,0,2,0,7,1.0,1,0.0,0,1,0,1,3,0,0,2,0,2,5,1
4390,62376,CqhdzHIILIe1pnO5H5MX1yWHcBaohaEB,7GRhBDsirIGkRZBtSMEzNTyDr2JQm4xx,8,2,2,0,2,0,3,0,9,1.2857142857142858,1,0.0,0,2,0,2,2,0,0,3,0,4,5,1
4391,62383,hIFgL0n5x61JjabCFOIHZgZxMVGzmHNh,SpATywNh6bZuzm8s1ceuBUnMUAeoAHHw,14,16,11,6,8,0,5,0,46,6.571428571428571,3,0.0,2,11,6,8,14,0,0,5,0,27,19,0
4392,62392,FLIojen7fff3GhtDNtEDgYWfLgv0g8w4,A3fsA9Zfv1X2fVEQhTw51lKENdNrEqT3,11,5,1,0,0,1,8,1,16,2.2857142857142856,2,0.0,0,1,0,0,5,1,0,8,1,1,15,1
4393,62427,7FBwqoodmzhvrGGLuwBjRrxsykocUv8u,7GRhBDsirIGkRZBtSMEzNTyDr2JQm4xx,17,13,10,0,7,0,2,0,32,4.571428571428571,1,0.0,2,10,0,7,11,0,0,2,0,19,13,1
4394,62466,ggEr2STKTwtSSUdtGCmiPr3DBu3TJ34B,SpATywNh6bZuzm8s1ceuBUnMUAeoAHHw,14,13,5,12,0,0,2,0,32,4.571428571428571,2,0.0,4,5,12,0,9,0,0,2,0,21,11,1
4395,62481,ggEr2STKTwtSSUdtGCmiPr3DBu3TJ34B,7GRhBDsirIGkRZBtSMEzNTyDr2JQm4xx,1,0,0,0,0,0,1,0,1,0.14285714285714285,1,0.0,0,0,0,0,0,0,0,1,0,0,1,1
4396,62516,l7f4vHvlZkxCYoU9qM63V45bmndBSeZQ,A3fsA9Zfv1X2fVEQhTw51lKENdNrEqT3,14,8,3,34,0,0,4,0,49,7.0,2,0.0,0,3,32,0,8,0,2,4,0,35,14,1
4397,62533,UOssUZDJcaoIiaAH8nTbzjrXIWUHSQSA,7GRhBDsirIGkRZBtSMEzNTyDr2JQm4xx,3,2,1,0,0,0,1,0,4,0.5714285714285714,1,0.0,0,1,0,0,2,0,0,1,0,1,3,1
4398,62549,u82lBhpDxJIwlZISEntCxj1zgVFdW0vT,bWdj2GDclj5ofokWjzoa5jAwMkxCykd6,1,0,0,0,0,0,1,0,1,0.14285714285714285,1,0.0,0,0,0,0,0,0,0,1,0,0,1,1
4399,62554,bYD2u7vuN3G54awyDYPdRiZI3O4zw6kx,SpATywNh6bZuzm8s1ceuBUnMUAeoAHHw,15,14,7,12,3,4,4,0,44,6.285714285714286,2,0.0,4,7,12,3,10,4,0,4,0,26,18,0
4400,62571,E96VmAw6m1AOHRckdqiq2ASKbnHBlpAb,SpATywNh6bZuzm8s1ceuBUnMUAeoAHHw,14,21,10,6,4,4,6,0,51,7.285714285714286,5,0.0,5,10,6,4,16,4,0,6,0,25,26,0
4401,62578,Q11HqpDxrpVz5YMzRCx4zOr85dBot8E5,A3fsA9Zfv1X2fVEQhTw51lKENdNrEqT3,8,2,0,0,0,2,8,0,12,1.7142857142857142,1,0.0,0,0,0,0,2,2,0,8,0,0,12,0
4402,62622,uU71zmfnwmq5Imjxap728hWGDmNRuuCF,SpATywNh6bZuzm8s1ceuBUnMUAeoAHHw,14,12,10,19,8,1,5,1,56,8.0,1,0.0,2,10,16,8,10,1,3,5,1,36,20,1
4403,62633,zlsPhArkUaQ0CCdgZTO1797WJjiciHBk,SpATywNh6bZuzm8s1ceuBUnMUAeoAHHw,6,2,1,0,1,0,4,1,9,1.2857142857142858,1,0.0,0,1,0,1,2,0,0,4,1,2,7,0
4404,62637,7PJjcgOQXwj0M6oz8Sxyd66Tvypm0TFY,SpATywNh6bZuzm8s1ceuBUnMUAeoAHHw,15,29,20,3,11,6,8,3,80,11.428571428571429,4,0.0,3,20,3,11,26,6,0,8,3,37,43,0
4405,62669,PMp3RxnsqELMI5BiCmteZ8iF2l5wlW7H,7GRhBDsirIGkRZBtSMEzNTyDr2JQm4xx,1,0,0,0,0,0,1,0,1,0.14285714285714285,1,0.0,0,0,0,0,0,0,0,1,0,0,1,1
4406,62685,xhufFs72rOwOGZDYtQtHTXdheNyqrUTX,SpATywNh6bZuzm8s1ceuBUnMUAeoAHHw,29,36,21,30,8,2,27,1,125,17.857142857142858,7,0.0,7,21,27,8,29,2,3,27,1,63,62,0
4407,62686,DpXkrIHIAIPNESKyvFah0WhpVT5PHFeL,bWdj2GDclj5ofokWjzoa5jAwMkxCykd6,10,28,16,16,0,3,7,0,70,10.0,2,0.0,3,16,16,0,25,3,0,7,0,35,35,1
4408,62739,CaM5OJ40UpPm5AoorpoNghXDZnct2Zfn,SpATywNh6bZuzm8s1ceuBUnMUAeoAHHw,27,40,10,32,5,26,12,2,127,18.142857142857142,3,0.0,15,10,28,5,25,26,4,12,2,58,69,1
4409,62752,GKJr5PPNFb6sbmwmK3Q19sOuk5TaY1oJ,SpATywNh6bZuzm8s1ceuBUnMUAeoAHHw,10,11,2,7,0,0,3,0,23,3.2857142857142856,3,0.0,1,2,6,0,10,0,1,3,0,9,14,1
4410,62764,XsK920toyXvpWwNS6lvZzDVJcrgCTFKd,SpATywNh6bZuzm8s1ceuBUnMUAeoAHHw,28,37,17,28,10,4,6,0,102,14.571428571428571,4,0.0,13,17,26,10,24,4,2,6,0,66,36,0
4411,62795,hf0GNWS6vfpKVHFBCaEpR8vnVjTeyl46,7GRhBDsirIGkRZBtSMEzNTyDr2JQm4xx,1,0,0,0,0,0,1,0,1,0.14285714285714285,1,0.0,0,0,0,0,0,0,0,1,0,0,1,1
4412,62805,LJYBef7iIBiSZz8D7KTtMTsdkyd91gnR,A3fsA9Zfv1X2fVEQhTw51lKENdNrEqT3,7,6,3,0,2,0,4,0,15,2.142857142857143,2,0.0,0,3,0,2,6,0,0,4,0,5,10,1
4413,62809,EEgHvStGR7XKoMKoPOCBxkxFHcb7UdMh,SpATywNh6bZuzm8s1ceuBUnMUAeoAHHw,6,17,9,0,1,0,9,0,36,5.142857142857143,6,0.0,0,9,0,1,17,0,0,9,0,10,26,0
4414,62813,reVwvLtud5XxET1iG7iTTQOqQC7njl8h,SpATywNh6bZuzm8s1ceuBUnMUAeoAHHw,7,4,2,5,1,0,2,0,14,2.0,1,0.0,1,2,5,1,3,0,0,2,0,9,5,0
4415,62819,zn2X74vvqUQRINz90WjZLsSsFglpYr7o,SpATywNh6bZuzm8s1ceuBUnMUAeoAHHw,2,0,0,0,0,0,2,0,2,0.2857142857142857,1,0.0,0,0,0,0,0,0,0,2,0,0,2,1
4416,62837,k4ieA0VLPLUG1GV8FhtBGpWAykZRhHXI,7GRhBDsirIGkRZBtSMEzNTyDr2JQm4xx,58,152,55,147,35,3,13,1,406,58.0,9,0.0,87,55,132,35,65,3,15,13,1,309,97,1
4417,62856,SMph1YQCIZlmphiUl0TLsRAe6lO4LFpT,7GRhBDsirIGkRZBtSMEzNTyDr2JQm4xx,1,0,0,0,0,0,1,0,1,0.14285714285714285,1,0.0,0,0,0,0,0,0,0,1,0,0,1,1
4418,62864,3LVlNsK7BHroChDOSCZ8wTJul8hRnncw,7GRhBDsirIGkRZBtSMEzNTyDr2JQm4xx,8,18,5,6,2,0,3,0,34,4.857142857142857,1,0.0,11,5,4,2,7,0,2,3,0,22,12,1
4419,62891,lo9vHqgfDG1UEcho8eZgahljlKaQ2l9G,7GRhBDsirIGkRZBtSMEzNTyDr2JQm4xx,1,0,0,0,0,0,1,0,1,0.14285714285714285,1,0.0,0,0,0,0,0,0,0,1,0,0,1,1
4420,62903,6WyBLtTebYxWs237cTFazhrWvguV9PiM,7GRhBDsirIGkRZBtSMEzNTyDr2JQm4xx,40,76,0,151,9,0,4,0,240,34.285714285714285,3,0.0,34,0,135,9,42,0,16,4,0,178,62,1
4421,62911,KwjYZWNYzBofNYG8mRoeOhYNpisNnTvM,SpATywNh6bZuzm8s1ceuBUnMUAeoAHHw,6,3,2,0,2,0,1,0,8,1.1428571428571428,1,0.0,0,2,0,2,3,0,0,1,0,4,4,1
4422,62913,VnWhM3BeDRhDK8eiBuMGZHGyfJnGv0sM,SpATywNh6bZuzm8s1ceuBUnMUAeoAHHw,24,42,2,37,0,1,14,2,98,14.0,3,0.0,6,2,36,0,36,1,1,14,2,44,54,1
4423,62945,psUY0jMEvxZuoP9UKA82E9maLgW6I63x,SpATywNh6bZuzm8s1ceuBUnMUAeoAHHw,15,21,2,14,2,1,10,0,50,7.142857142857143,1,0.0,5,2,13,2,16,1,1,10,0,22,28,0
4424,62948,XjHYgZsrS0l8TkcDRDNv64IhD09kdX0g,7GRhBDsirIGkRZBtSMEzNTyDr2JQm4xx,4,2,1,0,1,0,1,0,5,0.7142857142857143,1,0.0,0,1,0,1,2,0,0,1,0,2,3,1
4425,62957,iugl3Rn3u1ci3BiC2tfekDHOQsD5QVGj,bWdj2GDclj5ofokWjzoa5jAwMkxCykd6,35,127,65,164,18,47,45,5,471,67.28571428571429,7,0.0,21,65,145,18,106,47,19,45,5,249,222,0
4426,62975,fV0W6675p3fpyY1tGNGM2NdIFpKgGWLW,SpATywNh6bZuzm8s1ceuBUnMUAeoAHHw,24,35,13,16,3,28,11,0,106,15.142857142857142,5,0.0,14,13,14,3,21,28,2,11,0,44,62,0
4427,62999,JFnonbrySwtMlSqTfY5pp3MQd3sPiIYz,bWdj2GDclj5ofokWjzoa5jAwMkxCykd6,6,6,3,0,1,0,7,0,17,2.4285714285714284,1,0.0,0,3,0,1,6,0,0,7,0,4,13,0
4428,63022,aGKf0W7DbO5pZNcjJ5sGrg9jyzAmLXkB,SpATywNh6bZuzm8s1ceuBUnMUAeoAHHw,7,12,7,0,5,0,4,0,28,4.0,1,0.0,0,7,0,5,12,0,0,4,0,12,16,0
4429,63048,OO2Ag6HEFKkZRtZuzzt1ya8SiL4BLCOC,bWdj2GDclj5ofokWjzoa5jAwMkxCykd6,11,24,9,0,6,1,13,1,54,7.714285714285714,2,0.0,6,9,0,6,18,1,0,13,1,21,33,0
4430,63053,2gXHY5qLgY96Nt3kImmboPawcy43EQXt,7GRhBDsirIGkRZBtSMEzNTyDr2JQm4xx,11,22,11,6,7,0,4,0,50,7.142857142857143,4,0.0,1,11,5,7,21,0,1,4,0,24,26,0
4431,63099,WYoMb9pjSPIkNMKnbh6vDtB0LRCn2aRR,bWdj2GDclj5ofokWjzoa5jAwMkxCykd6,9,4,3,0,3,0,3,0,13,1.8571428571428572,2,0.0,0,3,0,3,4,0,0,3,0,6,7,1
4432,63108,rtYqtRTnqUXb6diSp0MKjdA0eLt2BJ3X,7GRhBDsirIGkRZBtSMEzNTyDr2JQm4xx,25,23,12,18,6,0,5,0,64,9.142857142857142,2,0.0,8,12,17,6,15,0,1,5,0,43,21,1
4433,63116,BvCRPlMfMau2kDEBEjyV1l6RJMQy5B5l,SpATywNh6bZuzm8s1ceuBUnMUAeoAHHw,14,25,6,11,0,3,12,1,58,8.285714285714286,1,0.0,8,6,10,0,17,3,1,12,1,24,34,0
4434,63119,HVSG66Eu1vmbossvKhmdJDOdo5jOHC1z,7GRhBDsirIGkRZBtSMEzNTyDr2JQm4xx,1,0,0,0,0,0,1,0,1,0.14285714285714285,1,0.0,0,0,0,0,0,0,0,1,0,0,1,1
4435,63126,8nlNDsWSaxHCvsMKtqhBs81sknEiTCeb,bWdj2GDclj5ofokWjzoa5jAwMkxCykd6,44,63,33,116,20,5,17,0,254,36.285714285714285,11,0.0,16,33,89,20,47,5,27,17,0,158,96,0
4436,63128,5uO2cAopKsWa3VCKCGDarnhTzdurYycs,SpATywNh6bZuzm8s1ceuBUnMUAeoAHHw,24,22,13,25,8,0,4,0,72,10.285714285714286,3,0.0,5,13,22,8,17,0,3,4,0,48,24,0
4437,63131,6soSIDwrJrHtOwhrrHwhMkHLJvUycuiD,SpATywNh6bZuzm8s1ceuBUnMUAeoAHHw,11,9,2,7,1,0,6,0,25,3.5714285714285716,3,0.0,0,2,6,1,9,0,1,6,0,9,16,1
4438,63143,oE1QbspE1VaPia0G9CbmnflG7dN6cZJM,bWdj2GDclj5ofokWjzoa5jAwMkxCykd6,1,0,0,0,0,0,1,0,1,0.14285714285714285,1,0.0,0,0,0,0,0,0,0,1,0,0,1,1
4439,63144,Uf8FY0gZoVytp6K7SsDRXVZeOCL2hDEX,A3fsA9Zfv1X2fVEQhTw51lKENdNrEqT3,17,8,7,0,7,2,2,0,26,3.7142857142857144,1,0.0,0,7,0,7,8,2,0,2,0,14,12,1
4440,63158,U24ZSbLp0qd6U36m7tKLx7zFvStnoEpw,A3fsA9Zfv1X2fVEQhTw51lKENdNrEqT3,9,4,3,0,3,0,2,0,12,1.7142857142857142,1,0.0,0,3,0,3,4,0,0,2,0,6,6,1
4441,63165,lECqbqrkQ3HlfeNWRN0jqJEeRHxVUCOh,A3fsA9Zfv1X2fVEQhTw51lKENdNrEqT3,43,17,14,84,12,0,1,0,128,18.285714285714285,2,0.0,2,14,68,12,15,0,16,1,0,96,32,1
4442,63198,JUAvN6CchqwicZ9lfSkTbwue3bPu0qhC,7GRhBDsirIGkRZBtSMEzNTyDr2JQm4xx,28,76,37,6,36,1,8,2,166,23.714285714285715,2,0.0,25,37,6,36,51,1,0,8,2,104,62,0
4443,63233,MvNnLQma2eBM9bCcMIR159XYSNp8VREs,A3fsA9Zfv1X2fVEQhTw51lKENdNrEqT3,73,32,24,167,17,31,12,0,283,40.42857142857143,5,0.0,4,24,130,17,28,31,37,12,0,175,108,0
4444,63255,7u0QfTKQg4itZK9m8foLXkIGwUxxHMsT,7GRhBDsirIGkRZBtSMEzNTyDr2JQm4xx,40,49,18,32,18,1,7,0,125,17.857142857142858,4,0.0,27,18,32,18,22,1,0,7,0,95,30,0
4445,63257,A1X8BnmDZU7GoDnOEZBjlNXiBeexxBQy,7GRhBDsirIGkRZBtSMEzNTyDr2JQm4xx,1,0,0,0,0,0,1,0,1,0.14285714285714285,1,0.0,0,0,0,0,0,0,0,1,0,0,1,1
4446,63296,qMFAmPw34z5IViYTtA1Kkpcn2uEg1WBM,7GRhBDsirIGkRZBtSMEzNTyDr2JQm4xx,1,0,0,0,0,0,2,0,2,0.2857142857142857,2,0.0,0,0,0,0,0,0,0,2,0,0,2,1
4447,63344,pxvZPop6eUfNSRIk3XGIXLwhqmGee9n7,A3fsA9Zfv1X2fVEQhTw51lKENdNrEqT3,6,2,1,0,1,0,8,3,15,2.142857142857143,1,0.0,0,1,0,1,2,0,0,8,3,2,13,1
4448,63346,fOHPhMpeg8x93fPCuBnyT2XMX6wTKqV5,7GRhBDsirIGkRZBtSMEzNTyDr2JQm4xx,4,4,1,0,0,0,3,0,8,1.1428571428571428,1,0.0,0,1,0,0,4,0,0,3,0,1,7,1
4449,63384,oT95jnCrOomgCStV09kTjQxruOcKiBza,7GRhBDsirIGkRZBtSMEzNTyDr2JQm4xx,1,0,0,0,0,0,2,0,2,0.2857142857142857,2,0.0,0,0,0,0,0,0,0,2,0,0,2,1
4450,63415,BkWsoOcHNs2015z3Qrz6HVGKHPIIV4xg,7GRhBDsirIGkRZBtSMEzNTyDr2JQm4xx,1,0,0,0,0,0,1,0,1,0.14285714285714285,1,0.0,0,0,0,0,0,0,0,1,0,0,1,1
4451,63441,zga7Ud0Vk6NOYChIx78X5xKIKbxIADsx,7GRhBDsirIGkRZBtSMEzNTyDr2JQm4xx,2,0,0,0,0,0,2,0,2,0.2857142857142857,1,0.0,0,0,0,0,0,0,0,2,0,0,2,1
4452,63493,NRZzsjM7f5dJSFvndgYyTX54NocUI1PS,7GRhBDsirIGkRZBtSMEzNTyDr2JQm4xx,31,58,19,36,11,15,6,0,145,20.714285714285715,3,0.0,35,19,28,11,23,15,8,6,0,93,52,1
4453,63498,5P9Jg9PB0Bpdf0i8vhVF4X9FZYYuI2qy,7GRhBDsirIGkRZBtSMEzNTyDr2JQm4xx,8,4,4,0,3,0,5,0,16,2.2857142857142856,1,0.0,0,4,0,3,4,0,0,5,0,7,9,1
4454,63504,Bf025FfgNrlcqN8gYGnmBAhjBy0v5Xmo,7GRhBDsirIGkRZBtSMEzNTyDr2JQm4xx,7,8,4,0,2,0,1,0,15,2.142857142857143,1,0.0,0,4,0,2,8,0,0,1,0,6,9,1
4455,63534,XNb7KU6KeHuNJzclGX2ePynnmu8yxV3v,7GRhBDsirIGkRZBtSMEzNTyDr2JQm4xx,1,0,0,0,0,0,1,0,1,0.14285714285714285,1,0.0,0,0,0,0,0,0,0,1,0,0,1,1
4456,63541,kq2xSgp8UyUnYWtPUU1dLGJ6LLqx20W2,A3fsA9Zfv1X2fVEQhTw51lKENdNrEqT3,11,10,6,0,3,0,6,0,25,3.5714285714285716,1,0.0,1,6,0,3,9,0,0,6,0,10,15,0
4457,63571,EwaALzeaojV7pPZOsHFx7jzB7xjVDGvQ,A3fsA9Zfv1X2fVEQhTw51lKENdNrEqT3,53,30,1,138,1,0,10,0,180,25.714285714285715,3,0.0,2,1,116,1,28,0,22,10,0,120,60,1
4458,63577,WofGn4IWpKZgx8XqCdK2PR8vwgQ2CXSv,7GRhBDsirIGkRZBtSMEzNTyDr2JQm4xx,4,2,1,0,1,0,1,0,5,0.7142857142857143,1,0.0,0,1,0,1,2,0,0,1,0,2,3,0
4459,63583,CLsYy7g1hYWHJyj1aROfKK9oTeo5yxJx,7GRhBDsirIGkRZBtSMEzNTyDr2JQm4xx,47,57,21,48,20,34,10,0,190,27.142857142857142,3,0.0,24,21,40,20,33,34,8,10,0,105,85,1
4460,63593,KNf8lqR4KQcQVf1nb3UW38BlYtlHOqrY,A3fsA9Zfv1X2fVEQhTw51lKENdNrEqT3,8,6,3,0,2,0,2,1,14,2.0,2,0.0,1,3,0,2,5,0,0,2,1,6,8,0
4461,63644,abujBNmSyI9HYgtoO1EXyLGaW1rUTrMR,7GRhBDsirIGkRZBtSMEzNTyDr2JQm4xx,10,5,1,0,1,1,11,1,20,2.857142857142857,1,0.0,0,1,0,1,5,1,0,11,1,2,18,1
4462,63662,JFaXJp13wvkCeQQDDH7gpaTiCpXvjbvf,7GRhBDsirIGkRZBtSMEzNTyDr2JQm4xx,10,17,4,0,2,0,3,0,26,3.7142857142857144,1,0.0,3,4,0,2,14,0,0,3,0,9,17,1
4463,63710,Ga4lr67F0RIjyUetWH1EgQ3xzSHDnViF,7GRhBDsirIGkRZBtSMEzNTyDr2JQm4xx,13,10,5,13,4,0,3,0,35,5.0,2,0.0,2,5,12,4,8,0,1,3,0,23,12,1
4464,63713,DedOVhQ90meYxq6Misau3AEJ23SFBM8N,A3fsA9Zfv1X2fVEQhTw51lKENdNrEqT3,4,2,1,0,1,0,1,0,5,0.7142857142857143,1,0.0,0,1,0,1,2,0,0,1,0,2,3,1
4465,63719,RPsysYLHG9V8ibC4agPmUkz49odzJ61i,A3fsA9Zfv1X2fVEQhTw51lKENdNrEqT3,58,36,1,142,0,5,18,1,203,29.0,5,0.0,2,1,128,0,34,5,14,18,1,131,72,0
4466,63730,ZxSt3TZtQO3EpuEM7vETaMfS20LEVHky,7GRhBDsirIGkRZBtSMEzNTyDr2JQm4xx,1,0,0,0,0,0,1,0,1,0.14285714285714285,1,0.0,0,0,0,0,0,0,0,1,0,0,1,1
4467,63750,0wm7bVyJC7jfhIoeylaV85sHOH5JOhtj,7GRhBDsirIGkRZBtSMEzNTyDr2JQm4xx,1,0,0,0,0,0,2,0,2,0.2857142857142857,2,0.0,0,0,0,0,0,0,0,2,0,0,2,1
4468,63800,pwyQw70rdHu06KaDwuJu2ks1YZiiVKHU,7GRhBDsirIGkRZBtSMEzNTyDr2JQm4xx,5,2,1,0,1,0,2,0,6,0.8571428571428571,1,0.0,0,1,0,1,2,0,0,2,0,2,4,1
4469,63868,5Dk7QJtqh7ATnN1jDaFE4dN4E1GugvAr,A3fsA9Zfv1X2fVEQhTw51lKENdNrEqT3,12,8,6,0,4,0,2,0,20,2.857142857142857,1,0.0,0,6,0,4,8,0,0,2,0,10,10,1
4470,63914,Yt9n1K8qzV8RLiOcWgNVrYW5xiZerljd,7GRhBDsirIGkRZBtSMEzNTyDr2JQm4xx,41,58,3,62,10,2,12,2,149,21.285714285714285,2,0.0,35,3,55,10,23,2,7,12,2,103,46,1
4471,63933,K9G4dlm9tLRMMK1kov6MCkkTMks8NOCf,7GRhBDsirIGkRZBtSMEzNTyDr2JQm4xx,1,0,0,0,0,0,1,0,1,0.14285714285714285,1,0.0,0,0,0,0,0,0,0,1,0,0,1,1
4472,63934,QXR5sUbv4S12yRWxM4AzFUAlm7Vhd4VU,7GRhBDsirIGkRZBtSMEzNTyDr2JQm4xx,2,0,0,0,0,0,2,0,2,0.2857142857142857,1,0.0,0,0,0,0,0,0,0,2,0,0,2,1
4473,63977,OVG8I98WuYVhtwF4PGQiRQJNGKoIW18s,7GRhBDsirIGkRZBtSMEzNTyDr2JQm4xx,9,5,3,0,3,0,2,0,13,1.8571428571428572,1,0.0,0,3,0,3,5,0,0,2,0,6,7,0
4474,63996,kaNpWuIxNLxZkDfmjMzrYRVzuOgwIf0o,7GRhBDsirIGkRZBtSMEzNTyDr2JQm4xx,1,0,0,0,0,0,1,0,1,0.14285714285714285,1,0.0,0,0,0,0,0,0,0,1,0,0,1,1
4475,64025,VmlXkvuP00sXBlaPmnRadtsHqWz5E4fz,7GRhBDsirIGkRZBtSMEzNTyDr2JQm4xx,107,530,113,202,52,65,44,0,1006,143.71428571428572,13,0.0,274,113,158,52,256,65,44,44,0,597,409,0
4476,64036,4dC723f2ZXGHBwWoh8xH8B5ftd5Zr0Rn,A3fsA9Zfv1X2fVEQhTw51lKENdNrEqT3,9,7,1,0,1,0,6,0,15,2.142857142857143,4,0.0,0,1,0,1,7,0,0,6,0,2,13,1
4477,64113,EVGpdajso7QxNR24Ui7ldtFyj6uWtpYs,7GRhBDsirIGkRZBtSMEzNTyDr2JQm4xx,31,53,12,65,11,0,4,0,145,20.714285714285715,2,0.0,26,12,58,11,27,0,7,4,0,107,38,1
4478,64116,sQpA2SuskRigo277vTUjZ4C84cF8DuDE,7GRhBDsirIGkRZBtSMEzNTyDr2JQm4xx,18,43,10,22,6,7,11,1,100,14.285714285714286,3,0.0,16,10,18,6,27,7,4,11,1,50,50,0
4479,64124,pseKOpRPBJlgz4ycJmBeuSlXa5DHSZxH,7GRhBDsirIGkRZBtSMEzNTyDr2JQm4xx,4,2,1,0,1,5,1,0,10,1.4285714285714286,1,0.0,0,1,0,1,2,5,0,1,0,2,8,1
4480,64139,oKHRSMo3yDALM11wXRuypZuoIWmshJLG,7GRhBDsirIGkRZBtSMEzNTyDr2JQm4xx,2,0,0,0,0,0,2,0,2,0.2857142857142857,1,0.0,0,0,0,0,0,0,0,2,0,0,2,1
4481,64142,as5VymGJtrKzsVSyPlhaHLjXcgFKhbSH,A3fsA9Zfv1X2fVEQhTw51lKENdNrEqT3,18,11,8,0,6,6,9,1,41,5.857142857142857,2,0.0,0,8,0,6,11,6,0,9,1,14,27,1
4482,64169,Z5Gd8RjsJSljoHUoBd3hvIVNy4VKuGq0,7GRhBDsirIGkRZBtSMEzNTyDr2JQm4xx,12,29,7,10,0,2,5,0,53,7.571428571428571,3,0.0,7,7,9,0,22,2,1,5,0,23,30,1
4483,64170,XPA1Jv5NXHfUcU7CMUA4EKvCqSxl1bO3,7GRhBDsirIGkRZBtSMEzNTyDr2JQm4xx,4,2,1,0,1,0,1,0,5,0.7142857142857143,1,0.0,0,1,0,1,2,0,0,1,0,2,3,1
4484,64177,SSM7wEvdZo8FZW0zxJcXGwdA1S6Vbn5Q,A3fsA9Zfv1X2fVEQhTw51lKENdNrEqT3,21,15,12,0,9,0,3,0,39,5.571428571428571,2,0.0,0,12,0,9,15,0,0,3,0,21,18,1
4485,65688,EP1XQRGS4HZOG1hdGzNZdD1HFhJcHpos,7GRhBDsirIGkRZBtSMEzNTyDr2JQm4xx,1,0,0,0,0,0,1,0,1,0.14285714285714285,1,0.0,0,0,0,0,0,0,0,1,0,0,1,1
4486,65717,Qp3BNNi2PRh8N3k7qOPk9z3KeApis9gf,7GRhBDsirIGkRZBtSMEzNTyDr2JQm4xx,8,2,1,0,1,2,5,0,11,1.5714285714285714,1,0.0,0,1,0,1,2,2,0,5,0,2,9,1
4487,65731,rsQSljy58PFsI3No6cbIG6iDQtqQAtCs,7GRhBDsirIGkRZBtSMEzNTyDr2JQm4xx,1,0,0,0,0,0,1,0,1,0.14285714285714285,1,0.0,0,0,0,0,0,0,0,1,0,0,1,1
4488,65788,aszS4GIQTgIfNXx5jr5Ct6AzWRVtVT5s,7GRhBDsirIGkRZBtSMEzNTyDr2JQm4xx,41,58,19,67,16,0,2,0,162,23.142857142857142,6,0.0,33,19,59,16,25,0,8,2,0,127,35,1
4489,65790,ee5z0tJLP6Khk8QhqHWb5RZbzlS7e0OS,7GRhBDsirIGkRZBtSMEzNTyDr2JQm4xx,1,0,0,0,0,0,1,0,1,0.14285714285714285,1,0.0,0,0,0,0,0,0,0,1,0,0,1,1
4490,65802,60AdiK8bE6l0acvscYCimI00NJzONtxh,7GRhBDsirIGkRZBtSMEzNTyDr2JQm4xx,13,10,0,4,0,0,3,1,18,2.5714285714285716,1,0.0,2,0,2,0,8,0,2,3,1,4,14,1
4491,65812,h0zdkMb61woGfNMOXfs3Ua8AU5wIq6lQ,7GRhBDsirIGkRZBtSMEzNTyDr2JQm4xx,1,0,0,0,0,0,1,0,1,0.14285714285714285,1,0.0,0,0,0,0,0,0,0,1,0,0,1,1
4492,65830,MolmRPAkFPlZY7OScpgwiUUkM3K4fMlt,7GRhBDsirIGkRZBtSMEzNTyDr2JQm4xx,28,57,26,18,20,3,12,0,136,19.428571428571427,4,0.0,20,26,13,20,37,3,5,12,0,79,57,0
4493,65865,GR3SserD0hZUoJkJpGFDq48sIZDvaFeW,7GRhBDsirIGkRZBtSMEzNTyDr2JQm4xx,8,7,0,2,1,0,4,0,14,2.0,2,0.0,3,0,1,1,4,0,1,4,0,5,9,1
4494,65923,RoVG0kiFP0OBGlNfg8NpT0lrHhQWFVjU,7GRhBDsirIGkRZBtSMEzNTyDr2JQm4xx,51,63,27,70,34,1,5,0,200,28.571428571428573,2,0.0,35,27,54,34,28,1,16,5,0,150,50,1
4495,65973,aIukhaeMXO0Xpo45YRTaW0ARdMHoLnbr,7GRhBDsirIGkRZBtSMEzNTyDr2JQm4xx,7,2,1,0,1,4,4,1,13,1.8571428571428572,1,0.0,0,1,0,1,2,4,0,4,1,2,11,1
4496,66546,DTbJ7KB3uMFcpk8W3n4kvUeKqSYyolkW,SpATywNh6bZuzm8s1ceuBUnMUAeoAHHw,17,39,6,18,2,1,15,0,81,11.571428571428571,4,0.0,19,6,15,2,20,1,3,15,0,42,39,1
4497,66551,fkrSqTHnPEweVdPiAW6RgeMJZWZWaXQt,G8EPVSXsOYB5YQWZGiz1aVq5Pgr2GrQu,87,70,21,201,15,22,26,2,357,51.0,5,0.0,46,21,149,15,24,22,52,26,2,231,126,0
4498,66555,fdzq5tofwv4sAm3YqrsC6AMOnGl1oPA0,RXDvfPUBYFlVdlueBFbLW0mhhAyGEqpt,3,0,0,0,0,5,2,0,7,1.0,2,0.0,0,0,0,0,0,5,0,2,0,0,7,1
4499,66558,z6Xzy59qUrOr9kg6qBkR4Bly4uQ6Qoy2,SpATywNh6bZuzm8s1ceuBUnMUAeoAHHw,22,46,18,23,7,11,26,4,135,19.285714285714285,6,0.0,12,18,19,7,34,11,4,26,4,56,79,1
4500,66563,rMO5SCPyMgH89I8wk1aP5Tz4xRCn17BB,SpATywNh6bZuzm8s1ceuBUnMUAeoAHHw,6,5,2,0,2,0,1,0,10,1.4285714285714286,1,0.0,0,2,0,2,5,0,0,1,0,4,6,1
4501,66564,pzsUx69X9Xid85hyecE8y9Ou9VDtnPhb,SpATywNh6bZuzm8s1ceuBUnMUAeoAHHw,1,0,0,0,0,0,1,0,1,0.14285714285714285,1,0.0,0,0,0,0,0,0,0,1,0,0,1,1
4502,66569,2daUzJgefGOj5dfl9u5sPO7QTYuS1O1e,SpATywNh6bZuzm8s1ceuBUnMUAeoAHHw,4,2,1,0,0,0,2,0,5,0.7142857142857143,1,0.0,0,1,0,0,2,0,0,2,0,1,4,1
4503,66570,MpNfjrXai4aLf7BfVSQwZSS0DPolU3oZ,RXDvfPUBYFlVdlueBFbLW0mhhAyGEqpt,51,66,39,69,23,0,14,2,213,30.428571428571427,6,0.0,14,39,66,23,52,0,3,14,2,142,71,0
4504,66571,2jofclRKNdmEGIMZjR1X3xlqQjjV6yF4,SpATywNh6bZuzm8s1ceuBUnMUAeoAHHw,17,32,13,29,5,6,18,1,104,14.857142857142858,3,0.0,9,13,22,5,23,6,7,18,1,49,55,0
4505,66577,s9OHCOR537Yr2UKR6DSCnB7grKBa5GVW,SpATywNh6bZuzm8s1ceuBUnMUAeoAHHw,5,2,1,0,1,0,2,0,6,0.8571428571428571,1,0.0,0,1,0,1,2,0,0,2,0,2,4,1
4506,66579,bDdEUq0MJvGkx68ulN38uXa8x4Oc6Mqn,SpATywNh6bZuzm8s1ceuBUnMUAeoAHHw,17,18,6,20,4,0,9,1,58,8.285714285714286,1,0.0,5,6,16,4,13,0,4,9,1,31,27,1
4507,66581,thNNhxxCA11oJLPqP35etO0M0nOY00HM,G8EPVSXsOYB5YQWZGiz1aVq5Pgr2GrQu,32,59,28,60,18,0,4,0,169,24.142857142857142,2,0.0,27,28,50,18,32,0,10,4,0,123,46,1
4508,66586,F2b4wQkSXPvl6LtgZJlfZ4TcFXgwDGKe,SpATywNh6bZuzm8s1ceuBUnMUAeoAHHw,7,4,3,0,3,0,2,0,12,1.7142857142857142,1,0.0,0,3,0,3,4,0,0,2,0,6,6,1
4509,66592,7mVgrKQULKrxGxLEFeqEhI8vLoHAKVjH,SpATywNh6bZuzm8s1ceuBUnMUAeoAHHw,5,2,1,0,1,0,2,0,6,0.8571428571428571,1,0.0,0,1,0,1,2,0,0,2,0,2,4,1
4510,66594,Jkvg2vrMG0bsI6gC4CJJwz6mYReBwqyD,bWdj2GDclj5ofokWjzoa5jAwMkxCykd6,18,34,17,8,7,0,25,2,93,13.285714285714286,5,0.0,2,17,8,7,32,0,0,25,2,34,59,1
4511,66599,FrnZkjOLuaGZ96dbbyAebpl6VdyOmBDE,RXDvfPUBYFlVdlueBFbLW0mhhAyGEqpt,6,2,1,0,1,0,4,0,8,1.1428571428571428,2,0.0,0,1,0,1,2,0,0,4,0,2,6,1
4512,66603,2zQQnqY1LiZ9lcEXTzcE3zimEdKe8CdV,G8EPVSXsOYB5YQWZGiz1aVq5Pgr2GrQu,28,25,12,62,8,0,5,0,112,16.0,3,0.0,12,12,51,8,13,0,11,5,0,83,29,1
4513,66606,yceNLUK4FCR6SZUYW0W0TAVYCfKl5jP6,SpATywNh6bZuzm8s1ceuBUnMUAeoAHHw,13,23,0,15,0,10,13,1,62,8.857142857142858,2,0.0,2,0,14,0,21,10,1,13,1,16,46,1
4514,66607,nvX3zuXPoMSUhlRzwAoQtF8bA4zlkXZY,G8EPVSXsOYB5YQWZGiz1aVq5Pgr2GrQu,21,40,31,20,2,20,32,3,148,21.142857142857142,3,0.0,0,31,18,2,40,20,2,32,3,51,97,1
4515,66614,RxKdUoY8VjcWLXSrUuB2O5rajs7dKtPo,SpATywNh6bZuzm8s1ceuBUnMUAeoAHHw,9,10,4,0,3,1,4,0,22,3.142857142857143,1,0.0,3,4,0,3,7,1,0,4,0,10,12,1
4516,66620,YSRj2LyghpGgbkTJyCc5CeAD7nnieGEa,SpATywNh6bZuzm8s1ceuBUnMUAeoAHHw,7,9,1,0,1,0,2,0,13,1.8571428571428572,1,0.0,0,1,0,1,9,0,0,2,0,2,11,1
4517,66622,3BM8P16Xlf6mH29LptGI3X2aHEFZEk4O,SpATywNh6bZuzm8s1ceuBUnMUAeoAHHw,11,10,6,0,3,8,12,2,41,5.857142857142857,2,0.0,0,6,0,3,10,8,0,12,2,9,32,1
4518,66625,WSyXGkhm7NDepRlMA3agJj8k8GLnavsP,bWdj2GDclj5ofokWjzoa5jAwMkxCykd6,5,2,1,0,1,0,2,0,6,0.8571428571428571,1,0.0,0,1,0,1,2,0,0,2,0,2,4,1
4519,66633,tuzr7UEFeueCuu7trKtH12YoCRZa4u3J,SpATywNh6bZuzm8s1ceuBUnMUAeoAHHw,32,73,31,19,14,101,26,2,266,38.0,7,0.0,16,31,17,14,57,101,2,26,2,78,188,1
4520,66642,7i6uHx2i3AcAV22o4Aq16TZJzUL7SbJ8,SpATywNh6bZuzm8s1ceuBUnMUAeoAHHw,20,32,9,19,4,9,14,4,91,13.0,4,0.0,9,9,16,4,23,9,3,14,4,38,53,0
4521,66643,YpwPSpfFUdYNa3VjazLGMwZAAiqtZEgp,SpATywNh6bZuzm8s1ceuBUnMUAeoAHHw,1,0,0,0,0,0,1,0,1,0.14285714285714285,1,0.0,0,0,0,0,0,0,0,1,0,0,1,1
4522,66648,Z5eVqB1AyrDAwIaFYca0z5tjEfS46LEV,SpATywNh6bZuzm8s1ceuBUnMUAeoAHHw,6,2,1,0,0,0,4,0,7,1.0,1,0.0,0,1,0,0,2,0,0,4,0,1,6,1
4523,66649,Gmz5iMjiwcyTx4KusyWM0rOecmUutZaf,RXDvfPUBYFlVdlueBFbLW0mhhAyGEqpt,66,84,52,101,33,10,12,5,297,42.42857142857143,4,0.0,20,52,98,33,64,10,3,12,5,203,94,0
4524,66661,uPc8X6Bm31kSZXvsGiF4cJMs1CphJwNI,RXDvfPUBYFlVdlueBFbLW0mhhAyGEqpt,7,4,3,0,1,0,2,0,10,1.4285714285714286,1,0.0,0,3,0,1,4,0,0,2,0,4,6,1
4525,66666,4QSKoi2COLIjISXuWMSgkhYU8OcqVVuy,SpATywNh6bZuzm8s1ceuBUnMUAeoAHHw,10,12,4,0,3,0,2,0,21,3.0,1,0.0,4,4,0,3,8,0,0,2,0,11,10,1
4526,66667,emzkGgKaVLaDWCW4bOLMsgyMV9eX3Ume,G8EPVSXsOYB5YQWZGiz1aVq5Pgr2GrQu,29,33,13,62,3,6,11,1,129,18.428571428571427,2,0.0,13,13,44,3,20,6,18,11,1,73,56,0
4527,66668,VKxATUtWUHvLpvjNhrujhWYm5cDOeljR,SpATywNh6bZuzm8s1ceuBUnMUAeoAHHw,3,3,0,0,0,0,1,0,4,0.5714285714285714,2,0.0,0,0,0,0,3,0,0,1,0,0,4,1
4528,66673,jdTzrZz0SYzgENOxdTEUzOnYtapHefGQ,SpATywNh6bZuzm8s1ceuBUnMUAeoAHHw,3,2,0,0,0,0,1,0,3,0.42857142857142855,1,0.0,0,0,0,0,2,0,0,1,0,0,3,1
4529,66686,N1N2VoCQ3DCM7YknWLib5UEHyI2wyiAp,SpATywNh6bZuzm8s1ceuBUnMUAeoAHHw,12,10,3,25,2,0,6,0,46,6.571428571428571,2,0.0,4,3,20,2,6,0,5,6,0,29,17,1
4530,66687,Lb2uKLbwD8GvR2CPQEYJA4oaJUHHccBI,G8EPVSXsOYB5YQWZGiz1aVq5Pgr2GrQu,9,9,0,0,0,0,4,0,13,1.8571428571428572,1,0.0,0,0,0,0,9,0,0,4,0,0,13,1
4531,66692,X2YAK6wLAh05M8slR10ibCM34PqZNEYp,G8EPVSXsOYB5YQWZGiz1aVq5Pgr2GrQu,21,24,2,24,1,1,4,0,56,8.0,2,0.0,1,2,19,1,23,1,5,4,0,23,33,1
4532,66693,Q0GCy8RLg4XnQiHX0oDTDootKu46YmWa,SpATywNh6bZuzm8s1ceuBUnMUAeoAHHw,4,2,0,0,0,0,2,0,4,0.5714285714285714,1,0.0,0,0,0,0,2,0,0,2,0,0,4,1
4533,66694,ZnCJUx9hjBAhb4k6sSnSHXC3G4doeeAn,SpATywNh6bZuzm8s1ceuBUnMUAeoAHHw,12,17,8,0,4,10,6,1,46,6.571428571428571,1,0.0,6,8,0,4,11,10,0,6,1,18,28,1
4534,66699,vYjevNGSZuPL0Me7nQ7eB69nuvnbZiuq,SpATywNh6bZuzm8s1ceuBUnMUAeoAHHw,13,17,0,16,0,0,6,1,40,5.714285714285714,3,0.0,8,0,14,0,9,0,2,6,1,22,18,1
4535,66700,xLfQrz0Mm3ryvcwRcTyZdkwlshtwNJHB,RXDvfPUBYFlVdlueBFbLW0mhhAyGEqpt,5,2,1,0,1,0,2,0,6,0.8571428571428571,1,0.0,0,1,0,1,2,0,0,2,0,2,4,1
4536,66708,bPMM8JJVMbo3dHwzrkYwNanOXVlVjIZM,bWdj2GDclj5ofokWjzoa5jAwMkxCykd6,6,2,1,0,1,0,3,0,7,1.0,1,0.0,0,1,0,1,2,0,0,3,0,2,5,1
4537,66710,fUNdgzfWSE4HzsYQQ7FDu5pyDUIMQ40m,bWdj2GDclj5ofokWjzoa5jAwMkxCykd6,1,0,0,0,0,0,1,0,1,0.14285714285714285,1,0.0,0,0,0,0,0,0,0,1,0,0,1,1
4538,66712,Ksg32KcGSJwlEbdLbDafCAI8P52qq3MX,SpATywNh6bZuzm8s1ceuBUnMUAeoAHHw,5,2,1,0,0,0,3,0,6,0.8571428571428571,1,0.0,0,1,0,0,2,0,0,3,0,1,5,1
4539,66716,m8pWjgRGGqizCnvKfqrgJiRn5L3s4aMf,SpATywNh6bZuzm8s1ceuBUnMUAeoAHHw,10,6,4,0,3,0,4,1,18,2.5714285714285716,1,0.0,1,4,0,3,5,0,0,4,1,8,10,1
4540,66717,PI4R0HcIedaRtD4i4AnoySGCINPF9uFD,SpATywNh6bZuzm8s1ceuBUnMUAeoAHHw,15,16,7,15,3,0,6,0,47,6.714285714285714,2,0.0,4,7,12,3,12,0,3,6,0,26,21,1
4541,66722,dwydM4WZn1EE9lbFO8uBMhGMVscnDmyy,G8EPVSXsOYB5YQWZGiz1aVq5Pgr2GrQu,18,26,15,2,10,18,11,1,83,11.857142857142858,2,0.0,5,15,1,10,21,18,1,11,1,31,52,0
4542,66723,o4fNZaSYX3UHutrkuKOAdzPPx4q40e5R,SpATywNh6bZuzm8s1ceuBUnMUAeoAHHw,17,31,13,6,7,14,8,1,80,11.428571428571429,3,0.0,2,13,6,7,29,14,0,8,1,28,52,1
4543,66724,cWGbfR2Lw2D62YH4zDUtSEtnjy8NlUpm,SpATywNh6bZuzm8s1ceuBUnMUAeoAHHw,28,44,13,27,9,1,16,1,111,15.857142857142858,5,0.0,14,13,22,9,30,1,5,16,1,58,53,1
4544,66727,1F8QRhMnvAcX05zajUIEw9khHJe9qgvr,SpATywNh6bZuzm8s1ceuBUnMUAeoAHHw,2,2,0,0,0,0,2,0,4,0.5714285714285714,1,0.0,0,0,0,0,2,0,0,2,0,0,4,1
4545,66729,YG3IIEQOezPClODg4SNvtFayndWcEJ7a,bWdj2GDclj5ofokWjzoa5jAwMkxCykd6,10,18,7,0,7,1,4,0,37,5.285714285714286,2,0.0,7,7,0,7,11,1,0,4,0,21,16,1
4546,66731,Sz4iN9vM7plSJObu2Kgng7aJijtNNsts,bWdj2GDclj5ofokWjzoa5jAwMkxCykd6,10,11,0,14,3,8,3,0,39,5.571428571428571,1,0.0,5,0,13,3,6,8,1,3,0,21,18,1
4547,66734,NMCQVQ1Cg6MS9ushYbZMMzLoDclKVOyZ,SpATywNh6bZuzm8s1ceuBUnMUAeoAHHw,9,13,5,0,1,2,10,0,31,4.428571428571429,1,0.0,0,5,0,1,13,2,0,10,0,6,25,1
4548,66735,BF8BUQGTWJSC3An0NoOdiFsCvGqN90lp,SpATywNh6bZuzm8s1ceuBUnMUAeoAHHw,10,16,6,0,4,0,3,0,29,4.142857142857143,3,0.0,0,6,0,4,16,0,0,3,0,10,19,1
4549,66739,ggntZRuHqDckUtFC9TYtfF8K09iXYWES,G8EPVSXsOYB5YQWZGiz1aVq5Pgr2GrQu,12,11,2,26,2,2,3,0,46,6.571428571428571,2,0.0,6,2,20,2,5,2,6,3,0,30,16,1
4550,66743,ilB3zN3UyBwxCz4uXPqvzE0bs5QUbmk2,SpATywNh6bZuzm8s1ceuBUnMUAeoAHHw,6,12,0,0,0,0,4,0,16,2.2857142857142856,3,0.0,0,0,0,0,12,0,0,4,0,0,16,1
4551,66746,S5gDAq7XL2B348BbNrSZrsxK2ihjbqjX,bWdj2GDclj5ofokWjzoa5jAwMkxCykd6,4,2,0,0,0,2,10,0,14,2.0,2,0.0,0,0,0,0,2,2,0,10,0,0,14,1
4552,66748,IGtuwcXa7Vvuptxp2yP0y7DMlNgXBbkF,SpATywNh6bZuzm8s1ceuBUnMUAeoAHHw,17,19,11,6,0,12,6,0,54,7.714285714285714,3,0.0,5,11,6,0,14,12,0,6,0,22,32,1
4553,66752,qdU5OfBLhmAdLS2yu5kAr5MPjmjgxaEx,SpATywNh6bZuzm8s1ceuBUnMUAeoAHHw,9,9,4,0,4,0,2,0,19,2.7142857142857144,1,0.0,0,4,0,4,9,0,0,2,0,8,11,1
4554,66759,IFoWLGmc3yYo3jvZy7brYExecFieUsPa,SpATywNh6bZuzm8s1ceuBUnMUAeoAHHw,17,18,7,21,4,3,6,1,60,8.571428571428571,2,0.0,9,7,18,4,9,3,3,6,1,38,22,1
4555,66761,jZW7RSw8d3NHdCMzGR4TAiNXCrcYo90E,SpATywNh6bZuzm8s1ceuBUnMUAeoAHHw,22,24,8,41,4,12,13,1,103,14.714285714285714,2,0.0,14,8,37,4,10,12,4,13,1,63,40,0
4556,66763,3LiDRA4eEhNTPRwhkLOl4Xef83bJtvN6,SpATywNh6bZuzm8s1ceuBUnMUAeoAHHw,16,12,5,14,3,0,7,0,41,5.857142857142857,1,0.0,2,5,13,3,10,0,1,7,0,23,18,1
4557,66767,hphlDgjkqVbyJnFgMbu9WAMmL2wONlSy,SpATywNh6bZuzm8s1ceuBUnMUAeoAHHw,13,20,0,28,2,4,6,1,61,8.714285714285714,1,0.0,14,0,21,2,6,4,7,6,1,37,24,0
4558,66769,j8UeSZFNUzzfzk2DFBytx4Rkr6FApV94,SpATywNh6bZuzm8s1ceuBUnMUAeoAHHw,4,4,3,0,0,0,1,0,8,1.1428571428571428,1,0.0,0,3,0,0,4,0,0,1,0,3,5,1
4559,66771,DSoedfH3iEqkDSoEfnR9hPK9fGA03nvE,SpATywNh6bZuzm8s1ceuBUnMUAeoAHHw,8,6,4,0,3,3,3,0,19,2.7142857142857144,2,0.0,0,4,0,3,6,3,0,3,0,7,12,1
4560,66772,3IQ5vbIjcGZGFJfWLKmxNcLXTnJQLHyr,SpATywNh6bZuzm8s1ceuBUnMUAeoAHHw,17,25,13,16,4,35,17,2,112,16.0,4,0.0,2,13,13,4,23,35,3,17,2,32,80,1
4561,66773,5KXpHHWqAiriAz89DseoECa9CF8nNmNg,G8EPVSXsOYB5YQWZGiz1aVq5Pgr2GrQu,2,0,0,0,0,0,2,0,2,0.2857142857142857,1,0.0,0,0,0,0,0,0,0,2,0,0,2,1
4562,66774,3imocgNxcBfwQHadpMof51TjC5xJp8PT,SpATywNh6bZuzm8s1ceuBUnMUAeoAHHw,9,9,6,0,4,0,8,0,27,3.857142857142857,2,0.0,1,6,0,4,8,0,0,8,0,11,16,1
4563,66777,FQiENNRH2NfeZWMamUs40Z7QmdDjNODH,SpATywNh6bZuzm8s1ceuBUnMUAeoAHHw,5,2,1,0,1,0,2,0,6,0.8571428571428571,1,0.0,0,1,0,1,2,0,0,2,0,2,4,1
4564,66786,qGRPIv5dAFSTdBTLUyG7n07ghfZFrtTR,SpATywNh6bZuzm8s1ceuBUnMUAeoAHHw,17,51,4,16,3,4,22,4,104,14.857142857142858,3,0.0,18,4,14,3,33,4,2,22,4,39,65,1
4565,66787,hphlDgjkqVbyJnFgMbu9WAMmL2wONlSy,G8EPVSXsOYB5YQWZGiz1aVq5Pgr2GrQu,9,10,1,0,0,1,8,0,20,2.857142857142857,1,0.0,3,1,0,0,7,1,0,8,0,4,16,1
4566,66791,YKDsG4vA9NLXfljPnrmnZIZC1s2Q0ugD,SpATywNh6bZuzm8s1ceuBUnMUAeoAHHw,5,2,1,0,1,0,4,0,8,1.1428571428571428,1,0.0,0,1,0,1,2,0,0,4,0,2,6,1
4567,66795,ee4pYUOGDieGavHZlg2HTSjfqraD5k7B,SpATywNh6bZuzm8s1ceuBUnMUAeoAHHw,13,10,0,18,0,0,6,1,35,5.0,1,0.0,5,0,15,0,5,0,3,6,1,20,15,1
4568,66814,x0EQgyUAdVGVXHM8VfLLFzp2FQY3yEsn,SpATywNh6bZuzm8s1ceuBUnMUAeoAHHw,8,6,3,0,3,0,3,0,15,2.142857142857143,1,0.0,2,3,0,3,4,0,0,3,0,8,7,0
4569,66817,to6uzLarCrneiGy62nJuyfDuz8bCYwik,G8EPVSXsOYB5YQWZGiz1aVq5Pgr2GrQu,83,100,35,163,20,9,25,2,354,50.57142857142857,6,0.0,51,35,116,20,49,9,47,25,2,222,132,1
4570,66819,j21aImOKDywGp9C5VIymBW05Q7mvVltH,SpATywNh6bZuzm8s1ceuBUnMUAeoAHHw,4,5,0,0,0,0,1,0,6,0.8571428571428571,1,0.0,0,0,0,0,5,0,0,1,0,0,6,1
4571,66821,JcMvDAHro8DuV6i3JIeUIujj4IscZiT7,G8EPVSXsOYB5YQWZGiz1aVq5Pgr2GrQu,13,10,3,22,0,1,4,0,40,5.714285714285714,1,0.0,7,3,16,0,3,1,6,4,0,26,14,0
4572,66831,grwjhoAI1dEZsOpkE7fbBAVHWaIfQbiU,SpATywNh6bZuzm8s1ceuBUnMUAeoAHHw,7,10,6,0,5,0,2,0,23,3.2857142857142856,2,0.0,0,6,0,5,10,0,0,2,0,11,12,1
4573,66836,GjmAjZkQ0i4VbB9kzslDSKYjTMxi0DJm,SpATywNh6bZuzm8s1ceuBUnMUAeoAHHw,10,14,8,0,6,1,2,0,31,4.428571428571429,1,0.0,3,8,0,6,11,1,0,2,0,17,14,1
4574,66840,jW6xo8o8ggQigxJzuOWpksdLscP0nmMK,RXDvfPUBYFlVdlueBFbLW0mhhAyGEqpt,9,11,9,0,7,0,2,0,29,4.142857142857143,1,0.0,1,9,0,7,10,0,0,2,0,17,12,1
4575,66842,KP9bG9uWRMGfX1tzS44KTvN8Cg66ynpe,SpATywNh6bZuzm8s1ceuBUnMUAeoAHHw,13,12,3,13,2,0,4,0,34,4.857142857142857,3,0.0,3,3,10,2,9,0,3,4,0,18,16,1
4576,66845,spo2AoBcB8z4JnQ75NfCsXxxs58G8kjU,SpATywNh6bZuzm8s1ceuBUnMUAeoAHHw,4,2,1,0,1,0,1,0,5,0.7142857142857143,1,0.0,0,1,0,1,2,0,0,1,0,2,3,0
4577,66849,Q089sE9VtgxkkGKk7SyD8fz5PShaeQQT,SpATywNh6bZuzm8s1ceuBUnMUAeoAHHw,6,2,0,0,0,14,5,3,24,3.4285714285714284,1,0.0,0,0,0,0,2,14,0,5,3,0,24,1
4578,66850,WREte9djoqLkGoMvPHsglYJ5ApOOE4Xa,SpATywNh6bZuzm8s1ceuBUnMUAeoAHHw,5,2,0,0,0,1,4,0,7,1.0,1,0.0,0,0,0,0,2,1,0,4,0,0,7,0
4579,66856,9Bmxb2kRkvmXtKdf1iC2KsdGSl1k4oD2,G8EPVSXsOYB5YQWZGiz1aVq5Pgr2GrQu,3,0,0,0,0,0,7,0,7,1.0,5,0.0,0,0,0,0,0,0,0,7,0,0,7,1
4580,66863,xdClWt95AonMUbXmVncDz7pyQAF4u9BG,RXDvfPUBYFlVdlueBFbLW0mhhAyGEqpt,1,0,0,0,0,0,1,0,1,0.14285714285714285,1,0.0,0,0,0,0,0,0,0,1,0,0,1,1
4581,66867,t2MGYeUu0hRLKtqGYRo6b7Rz4YOZ5CAl,SpATywNh6bZuzm8s1ceuBUnMUAeoAHHw,8,3,1,0,1,1,8,0,14,2.0,2,0.0,0,1,0,1,3,1,0,8,0,2,12,1
4582,66876,lBWHzt16Kw5civcvlfzsyLbIMpskhKLb,SpATywNh6bZuzm8s1ceuBUnMUAeoAHHw,4,2,1,0,0,0,2,0,5,0.7142857142857143,1,0.0,0,1,0,0,2,0,0,2,0,1,4,1
4583,66882,RUyO8vGMdp7jhM6g17yji5ANjGox4I7a,G8EPVSXsOYB5YQWZGiz1aVq5Pgr2GrQu,15,45,18,6,13,1,3,7,93,13.285714285714286,2,0.0,16,18,4,13,29,1,2,3,7,51,42,1
4584,66901,jsqKkuSbErall5JnaWQXJQsGef5XwKOD,SpATywNh6bZuzm8s1ceuBUnMUAeoAHHw,9,13,6,0,1,4,9,1,34,4.857142857142857,2,0.0,0,6,0,1,13,4,0,9,1,7,27,1
4585,66902,SaCuUEx4yVWy7KEZ7c1LumXyYr79w4Rm,bWdj2GDclj5ofokWjzoa5jAwMkxCykd6,7,4,2,0,0,3,5,1,15,2.142857142857143,1,0.0,0,2,0,0,4,3,0,5,1,2,13,1
4586,66906,dEKCxHL9joqZNeQKkyzq4Y5b5GlTbyt0,SpATywNh6bZuzm8s1ceuBUnMUAeoAHHw,1,0,0,0,0,0,1,0,1,0.14285714285714285,1,0.0,0,0,0,0,0,0,0,1,0,0,1,1
4587,66912,i0LHbVo0MUWeo1slrPpQRlCoWzknlhLR,SpATywNh6bZuzm8s1ceuBUnMUAeoAHHw,6,6,1,0,0,0,3,0,10,1.4285714285714286,1,0.0,1,1,0,0,5,0,0,3,0,2,8,1
4588,66913,Pp6wRQkPti9Bk2fBcpI0VrxeT3AtZv4c,SpATywNh6bZuzm8s1ceuBUnMUAeoAHHw,13,42,7,16,3,4,10,0,82,11.714285714285714,3,0.0,7,7,14,3,35,4,2,10,0,31,51,1
4589,66919,4W9VDoom5TgPKJhY4YS0TxVzPBBhVmKe,SpATywNh6bZuzm8s1ceuBUnMUAeoAHHw,5,5,3,2,0,0,1,0,11,1.5714285714285714,1,0.0,1,3,2,0,4,0,0,1,0,6,5,1
4590,66921,HEyWCm29dAxf2gF6HX7SoCKEpp5xOaMH,SpATywNh6bZuzm8s1ceuBUnMUAeoAHHw,8,16,2,0,0,23,11,1,53,7.571428571428571,2,0.0,0,2,0,0,16,23,0,11,1,2,51,1
4591,66936,STtQLJYeEtdkd5hogRcAby24tBZrG3TQ,SpATywNh6bZuzm8s1ceuBUnMUAeoAHHw,1,0,0,0,0,0,1,0,1,0.14285714285714285,1,0.0,0,0,0,0,0,0,0,1,0,0,1,1
4592,66953,hgypFYGQkHCtSzjmFaIf3CToNAXniUea,bWdj2GDclj5ofokWjzoa5jAwMkxCykd6,4,4,0,0,2,0,3,0,9,1.2857142857142858,1,0.0,2,0,0,2,2,0,0,3,0,4,5,1
4593,66954,8Eqf4bSicFmRziRU1kFgF89C5yGB8WDX,bWdj2GDclj5ofokWjzoa5jAwMkxCykd6,7,26,7,0,6,16,20,0,75,10.714285714285714,3,0.0,0,7,0,6,26,16,0,20,0,13,62,1
4594,66957,19VrgqzLVY9ZBYQoB1uroAA02q94O1Zu,SpATywNh6bZuzm8s1ceuBUnMUAeoAHHw,11,8,0,21,0,1,4,1,35,5.0,1,0.0,2,0,17,0,6,1,4,4,1,19,16,1
4595,66958,VNn0ZSteI0TUWATSfv7oNQMdpP8UUblh,SpATywNh6bZuzm8s1ceuBUnMUAeoAHHw,31,61,23,18,10,9,20,1,142,20.285714285714285,3,0.0,17,23,18,10,44,9,0,20,1,68,74,1
4596,66963,HYIak5MajHEE4KscVQZXOCe1sQzZq7OB,G8EPVSXsOYB5YQWZGiz1aVq5Pgr2GrQu,7,7,1,0,0,0,3,0,11,1.5714285714285714,2,0.0,1,1,0,0,6,0,0,3,0,2,9,1
4597,66973,AtBEE9J055aDlITLvmg36iywfRw9ii2d,SpATywNh6bZuzm8s1ceuBUnMUAeoAHHw,22,18,10,15,6,0,13,0,62,8.857142857142858,3,0.0,2,10,12,6,16,0,3,13,0,30,32,1
4598,66977,vEpbzgzC6vVRH2ddUE3uoPla0NVwp3kL,SpATywNh6bZuzm8s1ceuBUnMUAeoAHHw,7,4,0,0,0,0,5,0,9,1.2857142857142858,1,0.0,0,0,0,0,4,0,0,5,0,0,9,1
4599,66996,vgJBdvzTqJ5MKR9sNPkrlU2Mvr3KdXZ3,SpATywNh6bZuzm8s1ceuBUnMUAeoAHHw,16,17,8,19,5,0,4,0,53,7.571428571428571,2,0.0,6,8,16,5,11,0,3,4,0,35,18,0
4600,66999,FfIijJSc7v6Gx20szDQGd4UKB6lngdbn,SpATywNh6bZuzm8s1ceuBUnMUAeoAHHw,4,2,1,0,1,0,1,0,5,0.7142857142857143,1,0.0,0,1,0,1,2,0,0,1,0,2,3,1
4601,67000,5TmlEBiIGuIt6aB6TwvG68U4RXEnGCj0,SpATywNh6bZuzm8s1ceuBUnMUAeoAHHw,4,2,1,0,1,0,1,0,5,0.7142857142857143,1,0.0,0,1,0,1,2,0,0,1,0,2,3,0
4602,67002,x0d0kPxQt2lqC4Ti0c8RfiJ0ufqJ2aAF,SpATywNh6bZuzm8s1ceuBUnMUAeoAHHw,4,2,1,0,0,1,2,0,6,0.8571428571428571,1,0.0,0,1,0,0,2,1,0,2,0,1,5,1
4603,67004,P2uvU61vWnBKPWmDU3fEsDqh9JFKsQoE,bWdj2GDclj5ofokWjzoa5jAwMkxCykd6,11,15,11,66,5,0,3,0,100,14.285714285714286,2,0.0,1,11,65,5,14,0,1,3,0,82,18,1
4604,67006,3KIB4La3IsOSQkcNKGmRWQWUPPUMWKbW,RXDvfPUBYFlVdlueBFbLW0mhhAyGEqpt,9,3,2,0,2,1,5,1,14,2.0,1,0.0,0,2,0,2,3,1,0,5,1,4,10,0
4605,67012,Id4UmIRRQiLXHoJYSjh5OCO1CRaFgQ2K,RXDvfPUBYFlVdlueBFbLW0mhhAyGEqpt,10,12,8,0,5,0,2,0,27,3.857142857142857,2,0.0,0,8,0,5,12,0,0,2,0,13,14,1
4606,67014,1yJ7vGttwVZkfwO9DkOg0seBq4i9314Q,bWdj2GDclj5ofokWjzoa5jAwMkxCykd6,1,0,0,0,0,0,1,0,1,0.14285714285714285,1,0.0,0,0,0,0,0,0,0,1,0,0,1,1
4607,67015,knXx0VSX34ZZdw5j0pCDnRFFDbxG6IJ6,SpATywNh6bZuzm8s1ceuBUnMUAeoAHHw,13,15,8,3,5,0,6,0,37,5.285714285714286,2,0.0,4,8,3,5,11,0,0,6,0,20,17,0
4608,67022,qgATVDXI6hyNw5k2TylFI0Voj1oJ8GzP,RXDvfPUBYFlVdlueBFbLW0mhhAyGEqpt,4,2,1,0,1,0,1,0,5,0.7142857142857143,1,0.0,0,1,0,1,2,0,0,1,0,2,3,1
4609,67023,qgATVDXI6hyNw5k2TylFI0Voj1oJ8GzP,SpATywNh6bZuzm8s1ceuBUnMUAeoAHHw,2,0,0,0,0,0,2,0,2,0.2857142857142857,1,0.0,0,0,0,0,0,0,0,2,0,0,2,1
4610,67033,tPYh43YRHAzuf09xESxSKtWvST0aCsjn,SpATywNh6bZuzm8s1ceuBUnMUAeoAHHw,15,19,8,16,1,0,7,0,51,7.285714285714286,5,0.0,7,8,14,1,12,0,2,7,0,30,21,0
4611,67034,yZ9FndAKqVsKwZtO1B2JJJblefdbhZ02,SpATywNh6bZuzm8s1ceuBUnMUAeoAHHw,14,15,1,30,0,0,14,0,60,8.571428571428571,6,0.0,8,1,27,0,7,0,3,14,0,36,24,0
4612,67037,6RtjQ87TFCeYnCEQooYczzLrx8zugyat,SpATywNh6bZuzm8s1ceuBUnMUAeoAHHw,1,0,0,0,0,0,1,0,1,0.14285714285714285,1,0.0,0,0,0,0,0,0,0,1,0,0,1,1
4613,67040,Rf7b7AtnB3yMHMysfPwxe6fh0kofBsCX,G8EPVSXsOYB5YQWZGiz1aVq5Pgr2GrQu,6,7,3,0,2,0,6,0,18,2.5714285714285716,2,0.0,3,3,0,2,4,0,0,6,0,8,10,1
4614,67041,G2vTTAEhPpy1uiGVOSc3WfzCmuUhZyw6,SpATywNh6bZuzm8s1ceuBUnMUAeoAHHw,12,19,1,19,1,0,12,0,52,7.428571428571429,1,0.0,8,1,15,1,11,0,4,12,0,25,27,1
4615,67049,caAQbOI1NkkZKVF3oGPK3OdsY0lbDlYb,SpATywNh6bZuzm8s1ceuBUnMUAeoAHHw,10,14,6,0,3,0,8,3,34,4.857142857142857,2,0.0,0,6,0,3,14,0,0,8,3,9,25,1
4616,67051,fJHji2otGUDYDMFxwiigoqhPCAcWp4zZ,SpATywNh6bZuzm8s1ceuBUnMUAeoAHHw,5,2,1,0,1,0,2,0,6,0.8571428571428571,1,0.0,0,1,0,1,2,0,0,2,0,2,4,1
4617,67058,b5Gj1OyeYKLhLlGsleyNSSJpbJ2lneFj,RXDvfPUBYFlVdlueBFbLW0mhhAyGEqpt,19,9,6,24,4,0,3,0,46,6.571428571428571,1,0.0,2,6,24,4,7,0,0,3,0,36,10,1
4618,67059,3w7hN41KgzlGkT6XiQZqVbo1geJzchKr,G8EPVSXsOYB5YQWZGiz1aVq5Pgr2GrQu,5,1,1,0,1,0,4,0,7,1.0,2,0.0,0,1,0,1,1,0,0,4,0,2,5,1
4619,67061,OisrcH2Uqqf03TtDLM3YLpNZbhlSzcT1,SpATywNh6bZuzm8s1ceuBUnMUAeoAHHw,8,7,4,0,2,0,11,1,25,3.5714285714285716,1,0.0,0,4,0,2,7,0,0,11,1,6,19,1
4620,67076,llPRK5GJ1Fu42jqOdNFWOcUEenGG1vdv,SpATywNh6bZuzm8s1ceuBUnMUAeoAHHw,13,26,6,17,3,0,4,0,56,8.0,1,0.0,15,6,16,3,11,0,1,4,0,40,16,1
4621,67077,wDMKq3Xvq95ERd20zjEMEb0BtCbHx7BM,SpATywNh6bZuzm8s1ceuBUnMUAeoAHHw,24,48,18,36,4,6,25,2,139,19.857142857142858,12,0.0,10,18,34,4,38,6,2,25,2,66,73,0
4622,67080,CgsguvEs0KUN3Abw9Qjh5ZZT0chwXUSw,SpATywNh6bZuzm8s1ceuBUnMUAeoAHHw,31,72,26,34,8,247,18,1,406,58.0,6,0.0,22,26,33,8,50,247,1,18,1,89,317,0
4623,67087,CN11ovtPF8fJmUO54gCiYLygyrR54itQ,SpATywNh6bZuzm8s1ceuBUnMUAeoAHHw,8,11,6,0,2,0,2,0,21,3.0,2,0.0,0,6,0,2,11,0,0,2,0,8,13,0
4624,67096,N7x6rez9AavUVus2y33zQwbgvW9e4FwN,SpATywNh6bZuzm8s1ceuBUnMUAeoAHHw,14,18,6,17,3,0,2,0,46,6.571428571428571,1,0.0,10,6,16,3,8,0,1,2,0,35,11,1
4625,67099,rwVFzRApiQw3vAU5Rpa6do3mD0uc5CXG,SpATywNh6bZuzm8s1ceuBUnMUAeoAHHw,22,53,1,33,1,5,14,1,108,15.428571428571429,5,0.0,17,1,29,1,36,5,4,14,1,48,60,1
4626,67104,8IdT3BpziJuUIg1uIZIVpj0NWmeXuSS8,G8EPVSXsOYB5YQWZGiz1aVq5Pgr2GrQu,37,62,5,96,5,6,15,1,190,27.142857142857142,4,0.0,38,5,80,5,24,6,16,15,1,128,62,1
4627,67111,KOlp6BtLHFtxPjNN0KYQVjD6WvIwSYtA,SpATywNh6bZuzm8s1ceuBUnMUAeoAHHw,22,56,1,25,0,9,14,0,105,15.0,4,0.0,16,1,24,0,40,9,1,14,0,41,64,0
4628,67114,G7XB7BvktED5k0pfiNMFlIFMFGCreTGp,G8EPVSXsOYB5YQWZGiz1aVq5Pgr2GrQu,6,12,1,0,3,0,3,0,19,2.7142857142857144,1,0.0,10,1,0,3,2,0,0,3,0,14,5,1
4629,67116,KhEJGS2oZuX97oPJJp9Z5yTu0JSgEwNN,SpATywNh6bZuzm8s1ceuBUnMUAeoAHHw,11,26,2,11,0,1,5,0,45,6.428571428571429,1,0.0,10,2,10,0,16,1,1,5,0,22,23,1
4630,67122,TuRtla6uL7YMLA6vfJsBKtiNWjCxP0OZ,RXDvfPUBYFlVdlueBFbLW0mhhAyGEqpt,10,26,13,0,3,0,3,0,45,6.428571428571429,2,0.0,9,13,0,3,17,0,0,3,0,25,20,1
4631,67128,dL3mb41Bm8AhTujPtToBfgUCEqTQ4yms,G8EPVSXsOYB5YQWZGiz1aVq5Pgr2GrQu,11,25,3,0,1,0,4,0,33,4.714285714285714,3,0.0,3,3,0,1,22,0,0,4,0,7,26,1
4632,67133,iU8sg5PBq7mTADvs0COG4jXH4nM6hq2B,SpATywNh6bZuzm8s1ceuBUnMUAeoAHHw,31,54,21,13,12,16,26,1,143,20.428571428571427,7,0.0,20,21,13,12,34,16,0,26,1,66,77,1
4633,67137,iZa1NC6aT0Npl7jBiTIydtSYeYsdEobQ,bWdj2GDclj5ofokWjzoa5jAwMkxCykd6,3,0,0,0,0,0,2,1,3,0.42857142857142855,1,0.0,0,0,0,0,0,0,0,2,1,0,3,1
4634,67152,gaiJtHdepYI8ZLS7HsizBoGVbYaMsssC,bWdj2GDclj5ofokWjzoa5jAwMkxCykd6,2,0,0,0,0,0,2,0,2,0.2857142857142857,1,0.0,0,0,0,0,0,0,0,2,0,0,2,1
4635,67156,3vhG5LSOA1YcHy71CJJOxAgCZ2y6XT8e,SpATywNh6bZuzm8s1ceuBUnMUAeoAHHw,15,31,11,23,4,0,9,0,78,11.142857142857142,2,0.0,15,11,20,4,16,0,3,9,0,50,28,1
4636,67158,07nBIjV5wvxeipK7Zz3uxWH8hv0V5VvH,SpATywNh6bZuzm8s1ceuBUnMUAeoAHHw,31,49,23,20,11,5,10,1,119,17.0,5,0.0,19,23,19,11,30,5,1,10,1,72,47,0
4637,67159,CQ3lDAshmWjO1E4GBV1wnteO6NqYgq2s,G8EPVSXsOYB5YQWZGiz1aVq5Pgr2GrQu,30,63,1,68,5,8,7,1,153,21.857142857142858,2,0.0,23,1,53,5,40,8,15,7,1,82,71,1
4638,67164,ztcM8oJ9cYwAQxtlfaWWEY7el55tNp3L,SpATywNh6bZuzm8s1ceuBUnMUAeoAHHw,13,60,15,0,13,12,17,2,119,17.0,3,0.0,2,15,0,13,58,12,0,17,2,30,89,1
4639,67171,ILwuNMaKW9cfodB9O42BE2MDGjshUqyt,SpATywNh6bZuzm8s1ceuBUnMUAeoAHHw,10,12,0,0,0,0,7,0,19,2.7142857142857144,2,0.0,0,0,0,0,12,0,0,7,0,0,19,1
4640,67175,U9sp7fhhso4I4hUMdZYxdb4jjkzhb9EZ,SpATywNh6bZuzm8s1ceuBUnMUAeoAHHw,16,16,8,20,6,6,20,8,84,12.0,2,0.0,3,8,17,6,13,6,3,20,8,34,50,1
4641,67178,29637v4JeTV4lmXkjMER9DNWcGaMyJ4v,G8EPVSXsOYB5YQWZGiz1aVq5Pgr2GrQu,3,2,1,0,0,0,1,0,4,0.5714285714285714,1,0.0,0,1,0,0,2,0,0,1,0,1,3,1
4642,67184,tYMYXyJdOChlQSPrkrVNlrHj5tCYzHnQ,bWdj2GDclj5ofokWjzoa5jAwMkxCykd6,11,15,3,50,4,0,1,0,73,10.428571428571429,2,0.0,8,3,47,4,7,0,3,1,0,62,11,1
4643,67185,yCubUbsDW6wXrTu9ngQq5pTghAOVDrjs,SpATywNh6bZuzm8s1ceuBUnMUAeoAHHw,1,0,0,0,0,0,1,0,1,0.14285714285714285,1,0.0,0,0,0,0,0,0,0,1,0,0,1,1
4644,67195,MPLO46zeqSAmGFkKKuWvnx6pcJItRavU,SpATywNh6bZuzm8s1ceuBUnMUAeoAHHw,32,80,30,39,8,10,27,9,203,29.0,4,0.0,38,30,33,8,42,10,6,27,9,109,94,0
4645,67198,MozrQftkFsk2HJMPpZe4xQGho83nBBbJ,SpATywNh6bZuzm8s1ceuBUnMUAeoAHHw,9,8,3,0,1,1,6,1,20,2.857142857142857,1,0.0,1,3,0,1,7,1,0,6,1,5,15,1
4646,67207,jn6VKgJPC4fyRRCl6zZirG5zLpU8fnC6,SpATywNh6bZuzm8s1ceuBUnMUAeoAHHw,2,0,0,0,0,0,2,0,2,0.2857142857142857,1,0.0,0,0,0,0,0,0,0,2,0,0,2,1
4647,67209,lXVULXqG43l726A9V3NFlFs9kvovJQx4,SpATywNh6bZuzm8s1ceuBUnMUAeoAHHw,10,7,5,0,4,0,4,0,20,2.857142857142857,2,0.0,0,5,0,4,7,0,0,4,0,9,11,1
4648,67213,IHjTTbtSKJcagLP8HZiMzotl9tnHf7ev,SpATywNh6bZuzm8s1ceuBUnMUAeoAHHw,19,22,10,12,5,7,17,2,75,10.714285714285714,4,0.0,2,10,9,5,20,7,3,17,2,26,49,0
4649,67220,5UJZmEar1AX3gQXOzkh3MnQcYdErI17M,SpATywNh6bZuzm8s1ceuBUnMUAeoAHHw,21,25,9,12,5,3,10,1,65,9.285714285714286,3,0.0,12,9,10,5,13,3,2,10,1,36,29,1
4650,67224,AszzZcQ3DzjVCWiO17ucpHFrMmRC8MRV,SpATywNh6bZuzm8s1ceuBUnMUAeoAHHw,17,66,5,31,3,74,35,4,218,31.142857142857142,3,0.0,15,5,25,3,51,74,6,35,4,48,170,0
4651,67231,DBWpurAvW8awkr3pqCDDF8bsim2D57Vj,G8EPVSXsOYB5YQWZGiz1aVq5Pgr2GrQu,14,7,5,0,6,0,8,1,27,3.857142857142857,1,0.0,2,5,0,6,5,0,0,8,1,13,14,1
4652,67246,kA48LgfRPY6vHgTrWK5pJnx3RsuxrRTH,SpATywNh6bZuzm8s1ceuBUnMUAeoAHHw,10,6,3,1,2,0,3,0,15,2.142857142857143,1,0.0,1,3,1,2,5,0,0,3,0,7,8,1
4653,67247,q2AJDoW2EuJlq2uo87Sn9QLp36IwXzSv,SpATywNh6bZuzm8s1ceuBUnMUAeoAHHw,8,3,1,0,2,0,5,0,11,1.5714285714285714,2,0.0,0,1,0,2,3,0,0,5,0,3,8,1
4654,67248,8R7wkJYHxnNXLQq4dxMbBtsEclGat3j9,bWdj2GDclj5ofokWjzoa5jAwMkxCykd6,1,0,0,0,0,0,1,0,1,0.14285714285714285,1,0.0,0,0,0,0,0,0,0,1,0,0,1,1
4655,67260,ZULZi8TAkwGNSYKMYJ57kBAZvrMte2xF,SpATywNh6bZuzm8s1ceuBUnMUAeoAHHw,15,28,13,16,7,0,5,0,69,9.857142857142858,1,0.0,4,13,14,7,24,0,2,5,0,38,31,1
4656,67262,4hqkXkyq5mjsuNE9t6Q3zzOu4OQAJfqm,SpATywNh6bZuzm8s1ceuBUnMUAeoAHHw,14,22,11,10,5,0,6,0,54,7.714285714285714,5,0.0,5,11,10,5,17,0,0,6,0,31,23,1
4657,67264,uxiQAPJTLsI808GQpb2cYmEtdBDdQ3cx,SpATywNh6bZuzm8s1ceuBUnMUAeoAHHw,14,15,6,9,3,0,5,0,38,5.428571428571429,2,0.0,8,6,9,3,7,0,0,5,0,26,12,1
4658,67265,hfSXPDFaR2dzrQsij0JMBqqFRCNkzN0i,SpATywNh6bZuzm8s1ceuBUnMUAeoAHHw,6,3,1,0,1,0,2,0,7,1.0,1,0.0,0,1,0,1,3,0,0,2,0,2,5,1
4659,67266,X0qiYFDfIWOz74gDCjJtjtlJKUHThKgm,SpATywNh6bZuzm8s1ceuBUnMUAeoAHHw,24,45,23,18,9,19,13,1,128,18.285714285714285,6,0.0,15,23,15,9,30,19,3,13,1,62,66,0
4660,67267,d4AhROqi4DjVmWKfbbbhi19n7hcGPkSg,RXDvfPUBYFlVdlueBFbLW0mhhAyGEqpt,55,60,1,178,3,12,14,4,272,38.857142857142854,8,0.0,14,1,150,3,46,12,28,14,4,168,104,0
4661,67272,28W5CJrYp73LQgjHivjzAixkCQuqTCh6,bWdj2GDclj5ofokWjzoa5jAwMkxCykd6,4,2,1,0,1,0,2,0,6,0.8571428571428571,2,0.0,0,1,0,1,2,0,0,2,0,2,4,1
4662,67275,d7AooNZI1FOSZnZfgBmuAUMu5eysX9mb,SpATywNh6bZuzm8s1ceuBUnMUAeoAHHw,12,13,8,14,6,0,2,0,43,6.142857142857143,1,0.0,4,8,11,6,9,0,3,2,0,29,14,1
4663,67278,frK0oim7qtvURbYrZJ5gIFPqgQt63IEt,G8EPVSXsOYB5YQWZGiz1aVq5Pgr2GrQu,9,3,2,0,0,7,9,1,22,3.142857142857143,2,0.0,0,2,0,0,3,7,0,9,1,2,20,0
4664,67287,r9n2Z7iYkL5tKegLJwMIOxTHQqxopYp0,G8EPVSXsOYB5YQWZGiz1aVq5Pgr2GrQu,7,5,3,0,2,0,2,0,12,1.7142857142857142,2,0.0,0,3,0,2,5,0,0,2,0,5,7,0
4665,67288,PXVYYQlV1TwZ9b9f7GhoFUXTgABGZcBY,SpATywNh6bZuzm8s1ceuBUnMUAeoAHHw,17,27,11,19,5,3,16,2,83,11.857142857142858,2,0.0,12,11,16,5,15,3,3,16,2,44,39,0
4666,67297,mZ0efv4ffU6kCJ0Ro6mv6OGSULVT9odf,SpATywNh6bZuzm8s1ceuBUnMUAeoAHHw,1,0,0,0,0,0,1,0,1,0.14285714285714285,1,0.0,0,0,0,0,0,0,0,1,0,0,1,1
4667,67300,3QGIXvN5AKtl5SyCz6EZh0jA8JPL5Nkx,bWdj2GDclj5ofokWjzoa5jAwMkxCykd6,6,9,1,0,0,0,3,0,13,1.8571428571428572,2,0.0,0,1,0,0,9,0,0,3,0,1,12,1
4668,67302,CrdUJ25e700hCpU6YbocYb3uKRMcCPjz,SpATywNh6bZuzm8s1ceuBUnMUAeoAHHw,9,15,0,4,0,0,2,0,21,3.0,3,0.0,0,0,3,0,15,0,1,2,0,3,18,1
4669,67303,xrGYbDqan6dLH2p778nfhYmmVfnrrpam,SpATywNh6bZuzm8s1ceuBUnMUAeoAHHw,2,0,0,0,0,0,2,0,2,0.2857142857142857,1,0.0,0,0,0,0,0,0,0,2,0,0,2,1
4670,67308,T73fWQC3H2PhmOiodFuHvvahENx7TmZo,SpATywNh6bZuzm8s1ceuBUnMUAeoAHHw,7,6,4,0,3,0,1,0,14,2.0,1,0.0,1,4,0,3,5,0,0,1,0,8,6,1
4671,67314,CVINZY0qqZyjVQC8d4yq3w0fqkMGJBVL,G8EPVSXsOYB5YQWZGiz1aVq5Pgr2GrQu,21,16,2,14,2,0,7,1,42,6.0,1,0.0,0,2,12,2,16,0,2,7,1,16,26,1
4672,67328,HurK028hfari9vlQzhAchljjKEaGMu7l,SpATywNh6bZuzm8s1ceuBUnMUAeoAHHw,5,9,4,0,2,0,5,0,20,2.857142857142857,4,0.0,0,4,0,2,9,0,0,5,0,6,14,1
4673,67332,0xyoG1WvCKM42y6l9xPNGRXw8gklJB9a,G8EPVSXsOYB5YQWZGiz1aVq5Pgr2GrQu,14,34,7,8,5,9,5,0,68,9.714285714285714,2,0.0,2,7,6,5,32,9,2,5,0,20,48,1
4674,67345,WACfmqzUT9wOhkm3QdtpYOSdY2CeIJWa,RXDvfPUBYFlVdlueBFbLW0mhhAyGEqpt,44,42,25,57,14,3,13,3,157,22.428571428571427,2,0.0,10,25,52,14,32,3,5,13,3,101,56,1
4675,67346,DDhKDNB6fEAHv06PdV80Zz5GVaFianlg,SpATywNh6bZuzm8s1ceuBUnMUAeoAHHw,11,13,5,0,1,4,9,1,33,4.714285714285714,1,0.0,3,5,0,1,10,4,0,9,1,9,24,1
4676,67348,GQMirxB5y3FtUmix76KGcpTxWntGgKiV,RXDvfPUBYFlVdlueBFbLW0mhhAyGEqpt,50,35,22,50,15,8,6,0,136,19.428571428571427,2,0.0,9,22,48,15,26,8,2,6,0,94,42,1
4677,67353,VWEcCKiwp28lQZuBYYNslDL0523gk0Z6,G8EPVSXsOYB5YQWZGiz1aVq5Pgr2GrQu,16,19,7,8,7,0,4,1,46,6.571428571428571,1,0.0,10,7,5,7,9,0,3,4,1,29,17,1
4678,67354,ZdDSfnnRjfjHFmnDyPudXjLUHiOgLvKy,SpATywNh6bZuzm8s1ceuBUnMUAeoAHHw,4,2,0,0,0,0,2,0,4,0.5714285714285714,1,0.0,0,0,0,0,2,0,0,2,0,0,4,1
4679,67359,SODa9wZLHSXHCkQdc5G9XFSaZePE5xpY,bWdj2GDclj5ofokWjzoa5jAwMkxCykd6,1,0,0,0,0,0,1,0,1,0.14285714285714285,1,0.0,0,0,0,0,0,0,0,1,0,0,1,1
4680,67360,V5bKpsSihRb2F9h32bBQPUZX9j9nvFi3,SpATywNh6bZuzm8s1ceuBUnMUAeoAHHw,5,5,0,0,0,0,2,0,7,1.0,1,0.0,0,0,0,0,5,0,0,2,0,0,7,1
4681,67362,a5BZ9otCoBYjX9WVbUSqK2dp356IUlVP,bWdj2GDclj5ofokWjzoa5jAwMkxCykd6,2,0,0,0,0,0,2,0,2,0.2857142857142857,1,0.0,0,0,0,0,0,0,0,2,0,0,2,1
4682,67371,Ofc6ixmmoavYN92PkloL7C1g0H36jbU2,SpATywNh6bZuzm8s1ceuBUnMUAeoAHHw,10,11,5,0,3,0,8,1,28,4.0,3,0.0,0,5,0,3,11,0,0,8,1,8,20,1
4683,67377,w2OXuLJJs4MYqj6mF4JPNXoMIMuUu4d7,SpATywNh6bZuzm8s1ceuBUnMUAeoAHHw,6,5,2,0,1,2,3,0,13,1.8571428571428572,1,0.0,0,2,0,1,5,2,0,3,0,3,10,1
4684,67381,lPTnc5ZrBauZXbwYcDNNjt3Gvgvmp9Cq,SpATywNh6bZuzm8s1ceuBUnMUAeoAHHw,5,5,3,0,1,0,3,0,12,1.7142857142857142,2,0.0,0,3,0,1,5,0,0,3,0,4,8,1
4685,67382,ib1Tw9jwnFk22Zeb4pY0FX5aHNkeyMBZ,SpATywNh6bZuzm8s1ceuBUnMUAeoAHHw,3,3,1,0,0,0,1,0,5,0.7142857142857143,1,0.0,0,1,0,0,3,0,0,1,0,1,4,1
4686,67388,ALYZFAVviUOGzyN4znk46d3PmVgvtUAM,bWdj2GDclj5ofokWjzoa5jAwMkxCykd6,4,2,0,0,0,0,2,2,6,0.8571428571428571,1,0.0,0,0,0,0,2,0,0,2,2,0,6,1
4687,67389,k5fKzDcQyLOb8CsK2DtBEPxysEHaDdpC,RXDvfPUBYFlVdlueBFbLW0mhhAyGEqpt,6,12,3,0,1,3,4,1,24,3.4285714285714284,2,0.0,0,3,0,1,12,3,0,4,1,4,20,1
4688,67394,5fHLQXAfhzEdTjeeb4rbhkUBfbZKOD1P,SpATywNh6bZuzm8s1ceuBUnMUAeoAHHw,6,9,1,0,0,2,4,0,16,2.2857142857142856,1,0.0,0,1,0,0,9,2,0,4,0,1,15,1
4689,67405,5MnZ5TXikbZdya4aF9I9IoQXVWF4ujt6,SpATywNh6bZuzm8s1ceuBUnMUAeoAHHw,2,0,0,0,0,0,3,0,3,0.42857142857142855,1,0.0,0,0,0,0,0,0,0,3,0,0,3,1
4690,67406,KglHKNjP3QUQRobKP7GTczISSfhOt7DT,SpATywNh6bZuzm8s1ceuBUnMUAeoAHHw,1,0,0,0,0,0,1,0,1,0.14285714285714285,1,0.0,0,0,0,0,0,0,0,1,0,0,1,1
4691,67418,lCMgevd3r8NsQWpObW4O6eaYbm6xHejf,bWdj2GDclj5ofokWjzoa5jAwMkxCykd6,8,6,4,0,3,0,3,0,16,2.2857142857142856,2,0.0,0,4,0,3,6,0,0,3,0,7,9,1
4692,67421,DjTSUM8no03TdLiv7ibkGW8BkXCgFLYB,bWdj2GDclj5ofokWjzoa5jAwMkxCykd6,11,22,11,16,9,0,6,0,64,9.142857142857142,2,0.0,4,11,14,9,18,0,2,6,0,38,26,1
4693,67424,kuV8TXv5cFVPIWK37fDR8nnl0vrHyjjA,RXDvfPUBYFlVdlueBFbLW0mhhAyGEqpt,61,108,50,115,10,6,14,2,305,43.57142857142857,5,0.0,16,50,107,10,92,6,8,14,2,183,122,0
4694,67427,vS0PO2z5tTpDl1S200qdqNDkFjNmdjxd,G8EPVSXsOYB5YQWZGiz1aVq5Pgr2GrQu,29,21,11,30,9,0,4,0,75,10.714285714285714,2,0.0,1,11,26,9,20,0,4,4,0,47,28,1
4695,67429,JY3pL2MJnhOGuIufYZaXnkXrdE9eR9kZ,SpATywNh6bZuzm8s1ceuBUnMUAeoAHHw,7,3,2,0,2,0,2,0,9,1.2857142857142858,1,0.0,0,2,0,2,3,0,0,2,0,4,5,1
4696,67431,ic21uM8q7hG6lYEnCwOGpdZRk8GzB2Q4,bWdj2GDclj5ofokWjzoa5jAwMkxCykd6,4,3,1,0,1,0,1,0,6,0.8571428571428571,1,0.0,0,1,0,1,3,0,0,1,0,2,4,1
4697,67435,gK0C2Qn10uFCDrXyxIuukzeUErx51I1a,SpATywNh6bZuzm8s1ceuBUnMUAeoAHHw,23,49,1,35,2,2,11,0,100,14.285714285714286,5,0.0,22,1,33,2,27,2,2,11,0,58,42,0
4698,67437,H1gNXDemnE2i9lW82GrGfdWk3AATsmHy,SpATywNh6bZuzm8s1ceuBUnMUAeoAHHw,27,36,14,12,10,6,7,2,87,12.428571428571429,2,0.0,13,14,12,10,23,6,0,7,2,49,38,0
4699,67444,Cow0Edw3V8JD4s2oOxNrhyd18ZVv78TG,SpATywNh6bZuzm8s1ceuBUnMUAeoAHHw,16,22,9,7,5,0,2,0,45,6.428571428571429,2,0.0,5,9,6,5,17,0,1,2,0,25,20,1
4700,67445,Q9jQ2QVFcDk6rCEN1ap0bZmI7VqzGuqs,SpATywNh6bZuzm8s1ceuBUnMUAeoAHHw,25,47,5,33,3,10,10,1,109,15.571428571428571,3,0.0,12,5,27,3,35,10,6,10,1,47,62,0
4701,67454,7KhKGJPxu4uQKYHNs7O3NjmuTH6NjrVY,bWdj2GDclj5ofokWjzoa5jAwMkxCykd6,9,50,28,4,7,19,36,2,146,20.857142857142858,5,0.0,2,28,3,7,48,19,1,36,2,40,106,0
4702,67458,gjY6BujcNO3C8usrnDcYxkNzXuI0fCEe,SpATywNh6bZuzm8s1ceuBUnMUAeoAHHw,8,6,4,0,3,0,4,0,17,2.4285714285714284,1,0.0,0,4,0,3,6,0,0,4,0,7,10,1
4703,67464,uBWT9p90Ea0JVvR5wbRV9EQLPt0ehYR1,SpATywNh6bZuzm8s1ceuBUnMUAeoAHHw,24,43,1,27,1,10,21,0,103,14.714285714285714,5,0.0,12,1,24,1,31,10,3,21,0,38,65,1
4704,67466,6yy5YFhebeCVEWPcZqK4jg9qO8ru1OT4,SpATywNh6bZuzm8s1ceuBUnMUAeoAHHw,15,17,3,23,2,2,7,0,54,7.714285714285714,4,0.0,3,3,19,2,14,2,4,7,0,27,27,1
4705,67467,ZLbvkY9GfOSzox7JCIcmWczltkUqxVjR,SpATywNh6bZuzm8s1ceuBUnMUAeoAHHw,7,6,4,0,2,0,4,0,16,2.2857142857142856,1,0.0,0,4,0,2,6,0,0,4,0,6,10,1
4706,67468,lHCmVtLnmElXqFcol1pTzGnaqp21GEs7,RXDvfPUBYFlVdlueBFbLW0mhhAyGEqpt,3,0,0,0,0,0,2,2,4,0.5714285714285714,1,0.0,0,0,0,0,0,0,0,2,2,0,4,1
4707,67469,7tCVHfGANSkwc2DzOsbidXgZOw6Q8q5f,G8EPVSXsOYB5YQWZGiz1aVq5Pgr2GrQu,9,4,3,0,3,0,2,0,12,1.7142857142857142,1,0.0,0,3,0,3,4,0,0,2,0,6,6,1
4708,67474,XQsLTRxBgT09jhwR2kw4g3k34p5O8kHV,bWdj2GDclj5ofokWjzoa5jAwMkxCykd6,10,16,9,0,7,0,5,0,37,5.285714285714286,3,0.0,3,9,0,7,13,0,0,5,0,19,18,1
4709,67483,vEVxgcd4BTOgXUZ4VmhnVVivaAZ5TwNb,bWdj2GDclj5ofokWjzoa5jAwMkxCykd6,8,19,9,0,1,0,14,0,43,6.142857142857143,2,0.0,2,9,0,1,17,0,0,14,0,12,31,1
4710,67486,Ey4V2u8lgXOqStmlXh5LfVpeA2fR57Ho,SpATywNh6bZuzm8s1ceuBUnMUAeoAHHw,1,0,0,0,0,0,1,0,1,0.14285714285714285,1,0.0,0,0,0,0,0,0,0,1,0,0,1,1
4711,67492,pUaHa5R2nATh2lieQIvoIQ34ofl1qMpg,RXDvfPUBYFlVdlueBFbLW0mhhAyGEqpt,41,40,2,102,4,1,10,1,160,22.857142857142858,2,0.0,15,2,91,4,25,1,11,10,1,112,48,1
4712,67510,9by6FuLW9p6hAe2x8b5HjrOAjJeqk2av,SpATywNh6bZuzm8s1ceuBUnMUAeoAHHw,30,31,19,14,10,5,8,1,88,12.571428571428571,3,0.0,8,19,14,10,23,5,0,8,1,51,37,0
4713,67511,XiaZKMFLZltgVmLipzSXdXFKLHeDtV4U,SpATywNh6bZuzm8s1ceuBUnMUAeoAHHw,6,7,3,0,1,0,4,0,15,2.142857142857143,2,0.0,0,3,0,1,7,0,0,4,0,4,11,1
4714,67513,XKOZTIyRECata3wyZZEEtiKIhGnxgB74,SpATywNh6bZuzm8s1ceuBUnMUAeoAHHw,5,2,1,0,1,0,3,0,7,1.0,1,0.0,0,1,0,1,2,0,0,3,0,2,5,1
4715,67514,cCePdsnJSYHqdiZSbXBQK6xp3gMbJSPB,SpATywNh6bZuzm8s1ceuBUnMUAeoAHHw,8,2,1,0,1,0,4,1,9,1.2857142857142858,1,0.0,0,1,0,1,2,0,0,4,1,2,7,1
4716,67518,hd2F6jShBoDgDRbyWyB2cglMktEJbDcH,SpATywNh6bZuzm8s1ceuBUnMUAeoAHHw,5,2,1,0,1,0,3,0,7,1.0,1,0.0,0,1,0,1,2,0,0,3,0,2,5,1
4717,67532,GnIRbc6SlMVQELxTtsBRscVXZT2NaPnc,bWdj2GDclj5ofokWjzoa5jAwMkxCykd6,6,10,1,0,0,0,7,0,18,2.5714285714285716,2,0.0,0,1,0,0,10,0,0,7,0,1,17,1
4718,67535,HMMCRStJmM0GACTX8KnkMjogoI7SHUjo,SpATywNh6bZuzm8s1ceuBUnMUAeoAHHw,7,3,1,0,1,0,4,1,10,1.4285714285714286,1,0.0,0,1,0,1,3,0,0,4,1,2,8,1
4719,67539,ZhvYiagkjSANqD9iooXU2LPvYt7TDBNe,G8EPVSXsOYB5YQWZGiz1aVq5Pgr2GrQu,4,3,1,0,1,0,1,0,6,0.8571428571428571,1,0.0,1,1,0,1,2,0,0,1,0,3,3,1
4720,67542,87BKS3OvioYx6sBWp6JvkL3oGnn9HR6v,SpATywNh6bZuzm8s1ceuBUnMUAeoAHHw,6,2,0,0,1,0,6,0,9,1.2857142857142858,1,0.0,0,0,0,1,2,0,0,6,0,1,8,1
4721,67550,ScQd2YUPQVjLNV28id8viiUK1faGo8Du,SpATywNh6bZuzm8s1ceuBUnMUAeoAHHw,16,33,13,5,6,15,16,0,88,12.571428571428571,2,0.0,10,13,5,6,23,15,0,16,0,34,54,1
4722,67560,KpidFAO2tkY7K2KKYbeq2b9OWhsW5M4B,SpATywNh6bZuzm8s1ceuBUnMUAeoAHHw,1,0,0,0,0,0,1,0,1,0.14285714285714285,1,0.0,0,0,0,0,0,0,0,1,0,0,1,1
4723,67564,TyrR2674qqrmqDfJA1ba19pBHw30wbZn,bWdj2GDclj5ofokWjzoa5jAwMkxCykd6,9,11,3,2,2,0,7,1,26,3.7142857142857144,2,0.0,4,3,2,2,7,0,0,7,1,11,15,1
4724,67566,tYJFbmbzeY9dNgPSZvFhNskxnqvhh3AK,SpATywNh6bZuzm8s1ceuBUnMUAeoAHHw,27,38,17,18,10,9,14,2,108,15.428571428571429,5,0.0,6,17,15,10,32,9,3,14,2,48,60,0
4725,67572,HMOOD0QNsPiJ6FSYOiE4GQjvcEPtEXiW,SpATywNh6bZuzm8s1ceuBUnMUAeoAHHw,15,17,5,12,3,0,5,0,42,6.0,2,0.0,7,5,9,3,10,0,3,5,0,24,18,0
4726,67579,JsUpucQyiTLV5gDB7KrgqzRdiUsoUyeZ,bWdj2GDclj5ofokWjzoa5jAwMkxCykd6,1,0,0,0,0,0,2,0,2,0.2857142857142857,2,0.0,0,0,0,0,0,0,0,2,0,0,2,1
4727,67588,KgPlJUOxzo6K50clHm6VhLAZdTWxAeXA,SpATywNh6bZuzm8s1ceuBUnMUAeoAHHw,12,23,13,4,7,2,18,0,67,9.571428571428571,4,0.0,0,13,4,7,23,2,0,18,0,24,43,1
4728,67589,PiJ3gX6gddDaZL8DcE6EIcui1JUSTcfU,SpATywNh6bZuzm8s1ceuBUnMUAeoAHHw,21,20,13,6,8,16,6,1,70,10.0,2,0.0,3,13,6,8,17,16,0,6,1,30,40,1
4729,67590,iNC1K3GLRLEbKnkKM9DRjQmgl0TV31hj,SpATywNh6bZuzm8s1ceuBUnMUAeoAHHw,8,6,3,0,2,0,3,0,14,2.0,1,0.0,0,3,0,2,6,0,0,3,0,5,9,1
4730,67594,MwsjD881hF2KUCEG3rXUPSq3GKMfMo2d,SpATywNh6bZuzm8s1ceuBUnMUAeoAHHw,6,9,3,0,2,0,2,0,16,2.2857142857142856,2,0.0,0,3,0,2,9,0,0,2,0,5,11,0
4731,67595,FMyTD79DpzQKrXEJ9281Xlgi6vC7oMRz,SpATywNh6bZuzm8s1ceuBUnMUAeoAHHw,17,17,7,17,5,8,10,2,66,9.428571428571429,1,0.0,8,7,16,5,9,8,1,10,2,36,30,1
4732,67596,HMOOD0QNsPiJ6FSYOiE4GQjvcEPtEXiW,bWdj2GDclj5ofokWjzoa5jAwMkxCykd6,5,7,3,0,2,0,2,0,14,2.0,2,0.0,0,3,0,2,7,0,0,2,0,5,9,1
4733,67604,L7L1tCD13b9bwYB3itcIQLsWY4ZOzl4s,bWdj2GDclj5ofokWjzoa5jAwMkxCykd6,6,5,1,0,1,0,2,0,9,1.2857142857142858,1,0.0,0,1,0,1,5,0,0,2,0,2,7,1
4734,67606,zZJSO6J2IdlSRtL9i78S9ARTcFOb9HLo,SpATywNh6bZuzm8s1ceuBUnMUAeoAHHw,14,17,9,17,7,0,3,0,53,7.571428571428571,2,0.0,6,9,16,7,11,0,1,3,0,38,15,1
4735,67616,GkpBYL5A7XxQyiiOJwD69PHsUVDvMfPz,SpATywNh6bZuzm8s1ceuBUnMUAeoAHHw,15,14,10,0,5,0,8,1,38,5.428571428571429,4,0.0,0,10,0,5,14,0,0,8,1,15,23,0
4736,67621,n288BYpWLuFVQQ2eIcifxwEJn9u582IB,G8EPVSXsOYB5YQWZGiz1aVq5Pgr2GrQu,25,45,18,0,10,0,13,1,87,12.428571428571429,2,0.0,21,18,0,10,24,0,0,13,1,49,38,1
4737,67622,Sl7LGszo87N2dywG99gPMorFDWvvcTbU,SpATywNh6bZuzm8s1ceuBUnMUAeoAHHw,17,30,15,12,4,2,8,1,72,10.285714285714286,2,0.0,11,15,11,4,19,2,1,8,1,41,31,1
4738,67627,8AVylVqrvC0I5BhB8uK5ffluG4JxIZF6,SpATywNh6bZuzm8s1ceuBUnMUAeoAHHw,1,0,0,0,0,0,1,0,1,0.14285714285714285,1,0.0,0,0,0,0,0,0,0,1,0,0,1,1
4739,67633,IDjwQPQrnszw6soIGbbAmOia0h5OBccp,SpATywNh6bZuzm8s1ceuBUnMUAeoAHHw,2,0,0,0,0,0,2,0,2,0.2857142857142857,1,0.0,0,0,0,0,0,0,0,2,0,0,2,1
4740,67648,is1YRTEVdAbYSlOww6gWdslOyhkcfPV2,SpATywNh6bZuzm8s1ceuBUnMUAeoAHHw,15,30,14,17,7,2,6,0,76,10.857142857142858,3,0.0,11,14,14,7,19,2,3,6,0,46,30,0
4741,67652,HFAIeLw8Y6ycDg9QeC8e64dlQREKJUgu,SpATywNh6bZuzm8s1ceuBUnMUAeoAHHw,11,15,11,2,6,3,2,0,39,5.571428571428571,1,0.0,2,11,2,6,13,3,0,2,0,21,18,1
4742,67655,tkE1JI2oJkZLA1XOzEZ3Jn8IFDQS4QJ9,G8EPVSXsOYB5YQWZGiz1aVq5Pgr2GrQu,53,128,37,142,16,25,16,2,366,52.285714285714285,4,0.0,79,37,98,16,49,25,44,16,2,230,136,0
4743,67663,nBG9NwFfkLReYPd7l4XLlLWLMjwV7w8K,SpATywNh6bZuzm8s1ceuBUnMUAeoAHHw,5,11,6,0,3,0,5,0,25,3.5714285714285716,1,0.0,0,6,0,3,11,0,0,5,0,9,16,1
4744,67664,4GEmQt0JA7IFOeI2xvDzq0AMU7AHzUAO,G8EPVSXsOYB5YQWZGiz1aVq5Pgr2GrQu,1,0,0,0,0,0,1,0,1,0.14285714285714285,1,0.0,0,0,0,0,0,0,0,1,0,0,1,1
4745,67665,4GEmQt0JA7IFOeI2xvDzq0AMU7AHzUAO,RXDvfPUBYFlVdlueBFbLW0mhhAyGEqpt,8,8,1,0,1,0,2,0,12,1.7142857142857142,1,0.0,0,1,0,1,8,0,0,2,0,2,10,1
4746,67671,0ghe43x8DU4ZKEP2rwt8HDtWNCmUsBMb,SpATywNh6bZuzm8s1ceuBUnMUAeoAHHw,3,2,1,0,0,0,1,0,4,0.5714285714285714,1,0.0,0,1,0,0,2,0,0,1,0,1,3,1
4747,67676,HYd5rlFFgGK0QJw1jPObfen7RGCCaTWr,SpATywNh6bZuzm8s1ceuBUnMUAeoAHHw,12,19,2,14,0,0,11,0,46,6.571428571428571,2,0.0,6,2,13,0,13,0,1,11,0,21,25,1
4748,67678,5QFY4jhno4lDKDZjex2aoyci3DX1zToG,SpATywNh6bZuzm8s1ceuBUnMUAeoAHHw,6,3,1,0,1,0,2,0,7,1.0,1,0.0,0,1,0,1,3,0,0,2,0,2,5,1
4749,67679,MSP7eDamCCVYhdl4Hb4ah8yrT6phuW5z,SpATywNh6bZuzm8s1ceuBUnMUAeoAHHw,1,0,0,0,0,0,1,0,1,0.14285714285714285,1,0.0,0,0,0,0,0,0,0,1,0,0,1,1
4750,67682,UgNxeSUTyiiwvKUEwlvxMdHu83PhXRUn,G8EPVSXsOYB5YQWZGiz1aVq5Pgr2GrQu,5,6,1,0,0,0,2,0,9,1.2857142857142858,1,0.0,0,1,0,0,6,0,0,2,0,1,8,1
4751,67684,dQggCBdg5KVSltApPCgVZB7TTUQzzzoI,bWdj2GDclj5ofokWjzoa5jAwMkxCykd6,1,0,0,0,0,0,3,0,3,0.42857142857142855,2,0.0,0,0,0,0,0,0,0,3,0,0,3,1
4752,67685,fZeg9HEKP8oNI2LkglD6L1BrnS7HGXVv,SpATywNh6bZuzm8s1ceuBUnMUAeoAHHw,1,0,0,0,0,0,1,0,1,0.14285714285714285,1,0.0,0,0,0,0,0,0,0,1,0,0,1,1
4753,67686,eWYR1r7NLXWhx2IMzSgNL5MgIoGDCoNF,G8EPVSXsOYB5YQWZGiz1aVq5Pgr2GrQu,8,3,2,0,2,0,7,0,14,2.0,2,0.0,1,2,0,2,2,0,0,7,0,5,9,1
4754,67688,Bi4hHmeTLwTbUCScu9tC6ZZN7frLUhVP,RXDvfPUBYFlVdlueBFbLW0mhhAyGEqpt,8,7,3,0,1,0,4,0,15,2.142857142857143,2,0.0,0,3,0,1,7,0,0,4,0,4,11,1
4755,67690,nPRsjektHdbQkeAf1fIK4JbhrESPbPsA,G8EPVSXsOYB5YQWZGiz1aVq5Pgr2GrQu,11,15,1,8,1,0,2,0,27,3.857142857142857,2,0.0,6,1,5,1,9,0,3,2,0,13,14,0
4756,67692,EVc4qUhPkP7UL5sL9o4Nn0zqfNCNBtZE,SpATywNh6bZuzm8s1ceuBUnMUAeoAHHw,5,5,1,0,0,0,1,0,7,1.0,1,0.0,0,1,0,0,5,0,0,1,0,1,6,1
4757,67701,4TWfM9na19lYGzUwRed2aAXURJ78KWCP,RXDvfPUBYFlVdlueBFbLW0mhhAyGEqpt,12,13,10,0,4,0,8,11,46,6.571428571428571,1,0.0,0,10,0,4,13,0,0,8,11,14,32,1
4758,67710,zDAtaSKsAJQmmJ6xHQBbAGN68vDebyev,SpATywNh6bZuzm8s1ceuBUnMUAeoAHHw,17,18,6,42,2,0,5,0,73,10.428571428571429,3,0.0,5,6,42,2,13,0,0,5,0,55,18,0
4759,67716,wuUYknrhhK9A1rfWPXYwIaIGT1vO8QhA,SpATywNh6bZuzm8s1ceuBUnMUAeoAHHw,9,12,1,12,0,1,2,0,28,4.0,2,0.0,7,1,12,0,5,1,0,2,0,20,8,1
4760,67717,qO8ml6g9ZeMxls7C74RxeVjl6mVWAz7I,RXDvfPUBYFlVdlueBFbLW0mhhAyGEqpt,13,9,0,21,1,0,5,0,36,5.142857142857143,2,0.0,5,0,21,1,4,0,0,5,0,27,9,1
4761,67722,vVABuHEl55FNtayFertBjV9CA1b1uUqW,SpATywNh6bZuzm8s1ceuBUnMUAeoAHHw,14,44,10,23,3,9,4,0,93,13.285714285714286,3,0.0,29,10,18,3,15,9,5,4,0,60,33,1
4762,67726,R2bf9dlDhtEUgfKzXR1GPBa12LhUfZ8W,bWdj2GDclj5ofokWjzoa5jAwMkxCykd6,8,7,2,28,2,1,3,0,43,6.142857142857143,1,0.0,3,2,28,2,4,1,0,3,0,35,8,1
4763,67736,SBdAO3sKpqSlgeWybSBaDHqROjoMpn5T,SpATywNh6bZuzm8s1ceuBUnMUAeoAHHw,8,6,4,0,3,0,2,0,15,2.142857142857143,1,0.0,1,4,0,3,5,0,0,2,0,8,7,1
4764,67737,NcqjzYwttpnmK16DHJYLwVOs33NDqK5j,bWdj2GDclj5ofokWjzoa5jAwMkxCykd6,5,5,3,0,3,0,3,0,14,2.0,2,0.0,0,3,0,3,5,0,0,3,0,6,8,1
4765,67738,7MNV6BxCJmXmzQulnH88qjtXkhlV5cJV,SpATywNh6bZuzm8s1ceuBUnMUAeoAHHw,1,0,0,0,0,0,2,0,2,0.2857142857142857,1,0.0,0,0,0,0,0,0,0,2,0,0,2,1
4766,67747,tV7GilNH4qERxqQG9yXRbyo0vWdEfCmA,bWdj2GDclj5ofokWjzoa5jAwMkxCykd6,2,0,0,0,0,0,2,0,2,0.2857142857142857,1,0.0,0,0,0,0,0,0,0,2,0,0,2,1
4767,67759,51ihx2Bl0VB10raEriHBNStktgNYyJiR,bWdj2GDclj5ofokWjzoa5jAwMkxCykd6,5,0,0,0,0,1,4,1,6,0.8571428571428571,1,0.0,0,0,0,0,0,1,0,4,1,0,6,1
4768,67761,vLffmcT3S49L5a1tJO8Q4Q4dkiJJ7J44,RXDvfPUBYFlVdlueBFbLW0mhhAyGEqpt,6,7,2,0,1,0,2,0,12,1.7142857142857142,1,0.0,3,2,0,1,4,0,0,2,0,6,6,1
4769,67779,bYYoAejjFfWzrfKZwav40GCs4SuO1jAC,SpATywNh6bZuzm8s1ceuBUnMUAeoAHHw,7,2,1,0,1,2,10,1,17,2.4285714285714284,1,0.0,0,1,0,1,2,2,0,10,1,2,15,1
4770,67781,bavq9pAJWJ3ks5oNWHTGf2k9koDwXsAH,RXDvfPUBYFlVdlueBFbLW0mhhAyGEqpt,14,17,12,0,4,2,6,0,41,5.857142857142857,4,0.0,0,12,0,4,17,2,0,6,0,16,25,1
4771,67793,Q97rHk1i5w2LHTlLAzCat2tEB4ZGa9hz,SpATywNh6bZuzm8s1ceuBUnMUAeoAHHw,11,8,5,0,3,1,6,0,23,3.2857142857142856,1,0.0,0,5,0,3,8,1,0,6,0,8,15,1
4772,67796,X2XXZYuDF6JxTO2GjiNfzkEyj4FQesn5,SpATywNh6bZuzm8s1ceuBUnMUAeoAHHw,29,49,14,40,8,28,23,4,166,23.714285714285715,6,0.0,27,14,35,8,22,28,5,23,4,84,82,0
4773,67797,BDbaeDrifYAc4onT7CTIZiQyVNIb3LDx,SpATywNh6bZuzm8s1ceuBUnMUAeoAHHw,1,0,0,0,0,0,1,0,1,0.14285714285714285,1,0.0,0,0,0,0,0,0,0,1,0,0,1,1
4774,67798,Zz1hYW3bIv4cloYkUjUfNR6Tk0kO8ZBM,SpATywNh6bZuzm8s1ceuBUnMUAeoAHHw,13,19,0,12,0,3,19,1,54,7.714285714285714,2,0.0,7,0,12,0,12,3,0,19,1,19,35,1
4775,67803,MVA6iVb95DkbKsEBY1TwCJRFhaq9Spfs,SpATywNh6bZuzm8s1ceuBUnMUAeoAHHw,8,4,3,0,3,0,4,0,14,2.0,1,0.0,0,3,0,3,4,0,0,4,0,6,8,1
4776,67804,A0FFdH0xpvPEedjm7o52yYaFKsMLgpjw,SpATywNh6bZuzm8s1ceuBUnMUAeoAHHw,12,15,1,10,1,8,6,0,41,5.857142857142857,2,0.0,5,1,10,1,10,8,0,6,0,17,24,1
4777,67809,FlsqjVVrWyPYAwe3clQKMsya1OMo4po8,SpATywNh6bZuzm8s1ceuBUnMUAeoAHHw,4,5,1,0,0,0,1,0,7,1.0,1,0.0,2,1,0,0,3,0,0,1,0,3,4,1
4778,67817,CBLeEN4LtKF8I3pqDKXGm8PyJoErUnYX,bWdj2GDclj5ofokWjzoa5jAwMkxCykd6,7,16,6,0,3,6,6,0,37,5.285714285714286,2,0.0,0,6,0,3,16,6,0,6,0,9,28,0
4779,67818,Ve30VVfu3WOSJCl56SL7TQHGBM98BQ3E,bWdj2GDclj5ofokWjzoa5jAwMkxCykd6,2,0,0,0,0,0,2,0,2,0.2857142857142857,1,0.0,0,0,0,0,0,0,0,2,0,0,2,1
4780,67820,opdILbT2IBFIYJvyIT5NXM7ymKeuMTcM,SpATywNh6bZuzm8s1ceuBUnMUAeoAHHw,31,93,59,34,24,47,36,3,296,42.285714285714285,9,0.0,17,59,29,24,76,47,5,36,3,129,167,0
4781,67822,AQTVoGGpVGka0Kb0gVc0xEeMCYW0e1Aj,SpATywNh6bZuzm8s1ceuBUnMUAeoAHHw,12,10,6,0,4,1,3,0,24,3.4285714285714284,1,0.0,2,6,0,4,8,1,0,3,0,12,12,1
4782,67832,Kp7bCEP3w8tCAj2Zcsfolokp8CiYHRrL,SpATywNh6bZuzm8s1ceuBUnMUAeoAHHw,11,10,0,21,0,0,3,0,34,4.857142857142857,1,0.0,4,0,17,0,6,0,4,3,0,21,13,1
4783,67837,FSLduWx3U7kR3IEOy9TPL7q6u3uDMATy,SpATywNh6bZuzm8s1ceuBUnMUAeoAHHw,17,29,15,20,8,7,10,3,92,13.142857142857142,3,0.0,8,15,18,8,21,7,2,10,3,49,43,1
4784,67845,ndNZsN4dzAawDolPqzrjn2BmwgSJmFEf,bWdj2GDclj5ofokWjzoa5jAwMkxCykd6,16,40,4,130,4,23,20,4,225,32.142857142857146,4,0.0,11,4,125,4,29,23,5,20,4,144,81,1
4785,67853,oseHKim5ugRciFh8lXIQ174blllPPfFO,SpATywNh6bZuzm8s1ceuBUnMUAeoAHHw,27,56,25,31,6,19,20,4,161,23.0,5,0.0,7,25,27,6,49,19,4,20,4,65,96,0
4786,67855,RGHao356rd6STLU5i2lDxhCwgle1rNFw,SpATywNh6bZuzm8s1ceuBUnMUAeoAHHw,13,11,7,0,4,1,7,1,31,4.428571428571429,3,0.0,0,7,0,4,11,1,0,7,1,11,20,1
4787,67867,YJjGstHCH0jRUJlDUc92oNrPq0d0Zijd,SpATywNh6bZuzm8s1ceuBUnMUAeoAHHw,28,42,23,26,11,0,8,0,110,15.714285714285714,5,0.0,10,23,22,11,32,0,4,8,0,66,44,1
4788,67869,Tn3HlTIsOQNqv7r0Cv64haAgTvsZ6b4U,SpATywNh6bZuzm8s1ceuBUnMUAeoAHHw,1,0,0,0,0,0,6,0,6,0.8571428571428571,1,0.0,0,0,0,0,0,0,0,6,0,0,6,1
4789,67875,LacgvIbC5Mx6NWAbh5ZFbP873whAiOPf,SpATywNh6bZuzm8s1ceuBUnMUAeoAHHw,7,5,2,0,2,0,2,0,11,1.5714285714285714,2,0.0,0,2,0,2,5,0,0,2,0,4,7,1
4790,67876,yTPe4A1Cw5qKDjYpFW5H73VItf0UPFbm,SpATywNh6bZuzm8s1ceuBUnMUAeoAHHw,15,28,15,0,4,7,12,1,67,9.571428571428571,5,0.0,3,15,0,4,25,7,0,12,1,22,45,1
4791,67897,yKgKNljfs8EwbfiKqNgGPLaIDdrvaFSp,SpATywNh6bZuzm8s1ceuBUnMUAeoAHHw,18,33,13,17,5,0,10,0,78,11.142857142857142,4,0.0,2,13,15,5,31,0,2,10,0,35,43,0
4792,67898,hs0BkyfSJv3crs4cIvcxkt53zip5FMPg,bWdj2GDclj5ofokWjzoa5jAwMkxCykd6,5,2,1,0,1,0,2,0,6,0.8571428571428571,1,0.0,0,1,0,1,2,0,0,2,0,2,4,1
4793,67899,p3H39E0dwbDTbdLaprpRXUCSVCX0arUc,SpATywNh6bZuzm8s1ceuBUnMUAeoAHHw,8,5,1,0,1,0,3,3,13,1.8571428571428572,1,0.0,0,1,0,1,5,0,0,3,3,2,11,1
4794,67901,8qABUnBBHxxZkfUhEQNUn5NNMSRrqvPC,RXDvfPUBYFlVdlueBFbLW0mhhAyGEqpt,55,46,27,101,0,15,11,1,201,28.714285714285715,3,0.0,11,27,97,0,35,15,4,11,1,135,66,1
4795,67910,uegc4WtztZ9oPCp3WmAu2ymDghX5YdD7,SpATywNh6bZuzm8s1ceuBUnMUAeoAHHw,8,7,4,0,1,0,10,0,22,3.142857142857143,3,0.0,0,4,0,1,7,0,0,10,0,5,17,0
4796,67917,g7pbT2353K6nDyXKA1Zfrr1XqVe2dRBP,SpATywNh6bZuzm8s1ceuBUnMUAeoAHHw,17,57,28,18,16,27,16,2,164,23.428571428571427,3,0.0,10,28,15,16,47,27,3,16,2,69,95,1
4797,67920,gqL1AoJbIkLDCmEi1SGH37fAu1Zdec1f,SpATywNh6bZuzm8s1ceuBUnMUAeoAHHw,8,13,8,0,2,0,9,0,32,4.571428571428571,3,0.0,0,8,0,2,13,0,0,9,0,10,22,0
4798,67926,ndNZsN4dzAawDolPqzrjn2BmwgSJmFEf,SpATywNh6bZuzm8s1ceuBUnMUAeoAHHw,5,2,0,0,0,0,3,0,5,0.7142857142857143,1,0.0,0,0,0,0,2,0,0,3,0,0,5,1
4799,67942,PXSCTSolyT6nzbTsv2Nsca26yVAoeW5q,SpATywNh6bZuzm8s1ceuBUnMUAeoAHHw,29,44,22,26,10,3,17,2,124,17.714285714285715,4,0.0,14,22,23,10,30,3,3,17,2,69,55,0
4800,67943,jR4AfVlqsecU2OD2EAAPnmIP3mzjfI1q,bWdj2GDclj5ofokWjzoa5jAwMkxCykd6,5,5,3,0,2,0,5,0,15,2.142857142857143,3,0.0,0,3,0,2,5,0,0,5,0,5,10,1
4801,67947,Ybrpv4FlyuZUoocuO2Icsv1UQ9DeHSQ3,RXDvfPUBYFlVdlueBFbLW0mhhAyGEqpt,17,27,4,6,1,0,6,0,44,6.285714285714286,4,0.0,0,4,5,1,27,0,1,6,0,10,34,1
4802,67952,S7PakAxNjFEw6AvrJnn5uzkFmL6Zaill,SpATywNh6bZuzm8s1ceuBUnMUAeoAHHw,5,2,1,0,1,0,3,0,7,1.0,1,0.0,0,1,0,1,2,0,0,3,0,2,5,1
4803,67955,8Kp5E2we1VVLiWHeVTgDcI33lkyZihaL,SpATywNh6bZuzm8s1ceuBUnMUAeoAHHw,3,2,0,0,0,0,1,0,3,0.42857142857142855,1,0.0,0,0,0,0,2,0,0,1,0,0,3,1
4804,67957,NFziKHIzOwiPmHVTsgIR3hdUWupUP7S5,SpATywNh6bZuzm8s1ceuBUnMUAeoAHHw,6,14,1,0,1,0,2,0,18,2.5714285714285716,3,0.0,0,1,0,1,14,0,0,2,0,2,16,1
4805,67960,up9RsivyokQDdIY9XjceWgPIaWSXiHeb,SpATywNh6bZuzm8s1ceuBUnMUAeoAHHw,17,45,2,12,1,8,10,1,79,11.285714285714286,2,0.0,2,2,10,1,43,8,2,10,1,15,64,1
4806,67961,TauShxFiSmmTBchoFAIoZD1cYw24SbpR,SpATywNh6bZuzm8s1ceuBUnMUAeoAHHw,23,96,3,44,0,14,61,2,220,31.428571428571427,5,0.0,21,3,36,0,75,14,8,61,2,60,160,1
4807,67971,tfoakS3EMOjWuYWNRSgWZTjBxe3Mf9Te,RXDvfPUBYFlVdlueBFbLW0mhhAyGEqpt,1,0,0,0,0,0,1,0,1,0.14285714285714285,1,0.0,0,0,0,0,0,0,0,1,0,0,1,1
4808,67972,6iHCxsm5tJiarmhUscvMMFN1oXgIYfGK,SpATywNh6bZuzm8s1ceuBUnMUAeoAHHw,12,18,1,14,1,14,11,0,59,8.428571428571429,2,0.0,4,1,11,1,14,14,3,11,0,17,42,1
4809,67977,tfoakS3EMOjWuYWNRSgWZTjBxe3Mf9Te,G8EPVSXsOYB5YQWZGiz1aVq5Pgr2GrQu,1,0,0,0,0,0,1,0,1,0.14285714285714285,1,0.0,0,0,0,0,0,0,0,1,0,0,1,1
4810,67978,nI7KHCeuUwYkf0rhfMBOC7e8vy7auq4l,SpATywNh6bZuzm8s1ceuBUnMUAeoAHHw,7,3,2,0,2,0,2,0,9,1.2857142857142858,1,0.0,0,2,0,2,3,0,0,2,0,4,5,1
4811,67982,ILI6Vf7i1QDo4pXG14Vgww7LNrHFRhLg,SpATywNh6bZuzm8s1ceuBUnMUAeoAHHw,7,5,0,4,0,0,6,0,15,2.142857142857143,2,0.0,1,0,3,0,4,0,1,6,0,4,11,1
4812,67988,Qy32fNQVMClwOlmUTHDbimblSTgM9GDa,SpATywNh6bZuzm8s1ceuBUnMUAeoAHHw,4,1,0,0,0,0,4,0,5,0.7142857142857143,1,0.0,0,0,0,0,1,0,0,4,0,0,5,1
4813,67993,HwikiMaD2SSDNPWrHLzCjZX0RDgnndHf,bWdj2GDclj5ofokWjzoa5jAwMkxCykd6,5,4,1,0,1,0,1,0,7,1.0,1,0.0,0,1,0,1,4,0,0,1,0,2,5,0
4814,68002,K0IGGULkNaDBoXYWwyrmeTaxQ3RLMvBE,SpATywNh6bZuzm8s1ceuBUnMUAeoAHHw,8,7,3,0,3,0,1,0,14,2.0,1,0.0,0,3,0,3,7,0,0,1,0,6,8,1
4815,68013,CDy3wblikhG2TGdNI3LhbAglknKqeMeq,RXDvfPUBYFlVdlueBFbLW0mhhAyGEqpt,1,0,0,0,0,0,1,0,1,0.14285714285714285,1,0.0,0,0,0,0,0,0,0,1,0,0,1,0
4816,68017,Ea76prVlgHXbifiTXOy9yoJBa7oRFv41,SpATywNh6bZuzm8s1ceuBUnMUAeoAHHw,18,40,2,17,1,8,9,1,78,11.142857142857142,5,0.0,12,2,14,1,28,8,3,9,1,29,49,1
4817,68019,c4Lb4MH2H2BBD2Eny5diwcURGPUNIr88,G8EPVSXsOYB5YQWZGiz1aVq5Pgr2GrQu,17,26,7,14,7,0,2,0,56,8.0,3,0.0,18,7,7,7,8,0,7,2,0,39,17,1
4818,68021,YxdX3NPpzVJ59dpoBODWSD8Noi3lkajj,G8EPVSXsOYB5YQWZGiz1aVq5Pgr2GrQu,140,258,125,390,58,23,37,8,899,128.42857142857142,12,0.0,95,125,291,58,163,23,99,37,8,569,330,0
4819,68042,zHQwuuMF2E73UUayJX1hbmgxSuUBnwou,G8EPVSXsOYB5YQWZGiz1aVq5Pgr2GrQu,30,54,16,58,14,1,13,0,156,22.285714285714285,2,0.0,32,16,41,14,22,1,17,13,0,103,53,0
4820,68049,EBHdi8xR8rUEs7i0QRogmtFZNO8JeTy8,SpATywNh6bZuzm8s1ceuBUnMUAeoAHHw,16,16,7,5,3,2,7,1,41,5.857142857142857,3,0.0,3,7,5,3,13,2,0,7,1,18,23,1
4821,68051,CORJXNhWUR52sdjQNNf8qLspXXnCgswJ,SpATywNh6bZuzm8s1ceuBUnMUAeoAHHw,32,60,15,41,8,17,19,5,165,23.571428571428573,3,0.0,31,15,34,8,29,17,7,19,5,88,77,0
4822,68055,EBLsXyMzbHjWnC0OjjqcacEXrmUIJvTs,SpATywNh6bZuzm8s1ceuBUnMUAeoAHHw,5,2,1,0,1,0,2,0,6,0.8571428571428571,1,0.0,0,1,0,1,2,0,0,2,0,2,4,1
4823,68058,8qyr4gmatx7C6lBFbhpf1S75SesVpGhm,SpATywNh6bZuzm8s1ceuBUnMUAeoAHHw,16,30,10,17,5,11,12,1,86,12.285714285714286,4,0.0,13,10,15,5,17,11,2,12,1,43,43,0
4824,68061,Y0xpzPU1KVTtj1ZRV6oETnVQafrG6Rxw,G8EPVSXsOYB5YQWZGiz1aVq5Pgr2GrQu,15,17,10,18,4,0,5,0,54,7.714285714285714,2,0.0,3,10,15,4,14,0,3,5,0,32,22,1
4825,68074,C1sQeK9WfNApOsknFeDtbZSozuem8vKZ,SpATywNh6bZuzm8s1ceuBUnMUAeoAHHw,8,10,2,0,1,0,6,1,20,2.857142857142857,1,0.0,0,2,0,1,10,0,0,6,1,3,17,1
4826,68078,w9Zejjae59IiHj98CiIbluCo9JOahx2s,bWdj2GDclj5ofokWjzoa5jAwMkxCykd6,20,20,10,42,7,3,8,2,92,13.142857142857142,1,0.0,7,10,39,7,13,3,3,8,2,63,29,1
4827,68081,C1sQeK9WfNApOsknFeDtbZSozuem8vKZ,bWdj2GDclj5ofokWjzoa5jAwMkxCykd6,1,0,0,0,0,0,1,0,1,0.14285714285714285,1,0.0,0,0,0,0,0,0,0,1,0,0,1,1
4828,68082,C1sQeK9WfNApOsknFeDtbZSozuem8vKZ,G8EPVSXsOYB5YQWZGiz1aVq5Pgr2GrQu,1,0,0,0,0,0,1,0,1,0.14285714285714285,1,0.0,0,0,0,0,0,0,0,1,0,0,1,1
4829,68087,GlnhykNK42Hk2YDmiiI5XtZaM9QknLVN,SpATywNh6bZuzm8s1ceuBUnMUAeoAHHw,14,56,21,11,0,27,26,4,145,20.714285714285715,2,0.0,22,21,10,0,34,27,1,26,4,53,92,1
4830,68088,GIsRCDxWVYGm4So2chhYPzgj7oVxCsSB,RXDvfPUBYFlVdlueBFbLW0mhhAyGEqpt,12,14,2,0,3,0,4,0,23,3.2857142857142856,3,0.0,0,2,0,3,14,0,0,4,0,5,18,1
4831,68092,gmQzxzrGOrQhncsrBOMeYdsKsXhK53lF,bWdj2GDclj5ofokWjzoa5jAwMkxCykd6,11,10,4,34,3,0,9,0,60,8.571428571428571,1,0.0,1,4,34,3,9,0,0,9,0,42,18,1
4832,68093,GjzhHwDiXF2E87hVW0UoZGkmnIxus0Jb,G8EPVSXsOYB5YQWZGiz1aVq5Pgr2GrQu,2,0,0,0,0,0,2,0,2,0.2857142857142857,1,0.0,0,0,0,0,0,0,0,2,0,0,2,1
4833,68097,YtgrpGciY5emPU7tatGUnxp8LeEpuZ2R,G8EPVSXsOYB5YQWZGiz1aVq5Pgr2GrQu,1,0,0,0,0,0,1,0,1,0.14285714285714285,1,0.0,0,0,0,0,0,0,0,1,0,0,1,1
4834,68099,bf977a2Ekvsg0xEzQOrZjXRWnBKTxo2i,G8EPVSXsOYB5YQWZGiz1aVq5Pgr2GrQu,20,22,16,14,10,1,2,0,65,9.285714285714286,1,0.0,0,16,13,10,22,1,1,2,0,39,26,1
4835,68102,7rvGs1kznZu35xmEOruWRR3N50tl6czz,bWdj2GDclj5ofokWjzoa5jAwMkxCykd6,8,9,1,10,1,0,2,0,23,3.2857142857142856,1,0.0,1,1,9,1,8,0,1,2,0,12,11,1
4836,68104,6ybGGzfjXeEOFmc8PHowGPQhK4ir7keP,SpATywNh6bZuzm8s1ceuBUnMUAeoAHHw,9,5,1,0,1,4,7,1,19,2.7142857142857144,1,0.0,0,1,0,1,5,4,0,7,1,2,17,1
4837,68107,fJGnkdlpDXyGxGQQghKR3BhEMVARR2Lg,SpATywNh6bZuzm8s1ceuBUnMUAeoAHHw,1,0,0,0,0,0,1,0,1,0.14285714285714285,1,0.0,0,0,0,0,0,0,0,1,0,0,1,1
4838,68108,A0dHL3oOosmNf0Of1dLTB9JxNisZL1pv,SpATywNh6bZuzm8s1ceuBUnMUAeoAHHw,8,10,4,0,3,0,8,0,25,3.5714285714285716,2,0.0,1,4,0,3,9,0,0,8,0,8,17,1
4839,68110,aIu8QzWjQFPb4qaDfl0P1tztYuItpL4R,RXDvfPUBYFlVdlueBFbLW0mhhAyGEqpt,39,54,4,100,1,3,18,2,182,26.0,4,0.0,10,4,94,1,44,3,6,18,2,109,73,1
4840,68114,5PtI5arrhi7X94UIlnofTGsT9hPK6ewX,SpATywNh6bZuzm8s1ceuBUnMUAeoAHHw,5,4,3,0,0,0,1,0,8,1.1428571428571428,1,0.0,0,3,0,0,4,0,0,1,0,3,5,1
4841,68118,Z5b3QXG5aJtKMyvjqd5INn7f1wDhqIm4,SpATywNh6bZuzm8s1ceuBUnMUAeoAHHw,10,8,4,0,3,1,5,0,21,3.0,2,0.0,1,4,0,3,7,1,0,5,0,8,13,0
4842,68125,6akze6dlAjqRJRBQfIi4wuyuoFxmW6lS,SpATywNh6bZuzm8s1ceuBUnMUAeoAHHw,9,21,9,0,7,0,12,0,49,7.0,1,0.0,0,9,0,7,21,0,0,12,0,16,33,1
4843,68126,gLWYERddjD0e20XUR43WwbF7uNaF2Pgm,bWdj2GDclj5ofokWjzoa5jAwMkxCykd6,6,17,2,0,4,0,1,0,24,3.4285714285714284,1,0.0,0,2,0,4,17,0,0,1,0,6,18,1
4844,68130,gmQzxzrGOrQhncsrBOMeYdsKsXhK53lF,SpATywNh6bZuzm8s1ceuBUnMUAeoAHHw,1,0,0,0,0,0,1,0,1,0.14285714285714285,1,0.0,0,0,0,0,0,0,0,1,0,0,1,1
4845,68133,2NZH8U3WrlujDhhhOcDdw5QM9Su6Hvdq,SpATywNh6bZuzm8s1ceuBUnMUAeoAHHw,12,21,4,14,3,8,2,0,52,7.428571428571429,1,0.0,16,4,13,3,5,8,1,2,0,36,16,1
4846,68138,TnMuPtEYCG1UP1JnaDUM0auIBTc6VjvH,SpATywNh6bZuzm8s1ceuBUnMUAeoAHHw,4,2,0,0,0,0,5,0,7,1.0,1,0.0,0,0,0,0,2,0,0,5,0,0,7,0
4847,68142,78gf8prmiaXO1waYCeS1MI82L5gA5cph,SpATywNh6bZuzm8s1ceuBUnMUAeoAHHw,8,12,3,0,1,5,4,1,26,3.7142857142857144,1,0.0,0,3,0,1,12,5,0,4,1,4,22,1
4848,68155,GlnhykNK42Hk2YDmiiI5XtZaM9QknLVN,G8EPVSXsOYB5YQWZGiz1aVq5Pgr2GrQu,18,35,29,78,11,3,10,0,166,23.714285714285715,2,0.0,2,29,76,11,33,3,2,10,0,118,48,1
4849,68157,WHlJuYfhW4fQXvIRdAMxkZtYXebgfAZs,SpATywNh6bZuzm8s1ceuBUnMUAeoAHHw,7,4,3,0,3,0,2,0,12,1.7142857142857142,1,0.0,0,3,0,3,4,0,0,2,0,6,6,1
4850,68158,ZDEv7xdHlbONQGNdkwzMgbMsJFIzjdrJ,RXDvfPUBYFlVdlueBFbLW0mhhAyGEqpt,17,41,1,16,3,13,11,5,90,12.857142857142858,2,0.0,16,1,13,3,25,13,3,11,5,33,57,1
4851,68159,8PUTYY5GxR5hJrTB9VGuf6OwgmQYLlz6,SpATywNh6bZuzm8s1ceuBUnMUAeoAHHw,17,30,10,18,3,2,14,0,77,11.0,5,0.0,15,10,16,3,15,2,2,14,0,44,33,1
4852,68163,E7q8xgbm4JOITPhixAXraRklJYYNgqh3,SpATywNh6bZuzm8s1ceuBUnMUAeoAHHw,1,0,0,0,0,0,1,0,1,0.14285714285714285,1,0.0,0,0,0,0,0,0,0,1,0,0,1,1
4853,68165,c011xwxkscfGfFvLGjK44gLGvqvYHhED,SpATywNh6bZuzm8s1ceuBUnMUAeoAHHw,13,17,8,3,3,0,10,0,41,5.857142857142857,2,0.0,2,8,3,3,15,0,0,10,0,16,25,1
4854,68175,WAqLnSQyhRD0PYZmBqQYHPqSLjTTUH6O,SpATywNh6bZuzm8s1ceuBUnMUAeoAHHw,15,34,13,18,8,0,7,3,83,11.857142857142858,3,0.0,3,13,16,8,31,0,2,7,3,40,43,1
4855,68181,wCP7MM6FfvdZx8uOqp7AG8m1oFJcqLHB,SpATywNh6bZuzm8s1ceuBUnMUAeoAHHw,22,54,28,12,11,26,32,3,166,23.714285714285715,7,0.0,16,28,9,11,38,26,3,32,3,64,102,1
4856,68182,U8vo2wOZC3Q8EW1kIl6iwoIzgmQUZ4u1,SpATywNh6bZuzm8s1ceuBUnMUAeoAHHw,3,0,0,0,0,2,2,0,4,0.5714285714285714,1,0.0,0,0,0,0,0,2,0,2,0,0,4,1
4857,68191,hkTx4XunczsnVq4H9eVYRZURkkofvB6I,SpATywNh6bZuzm8s1ceuBUnMUAeoAHHw,8,6,3,2,2,0,1,0,14,2.0,1,0.0,0,3,2,2,6,0,0,1,0,7,7,1
4858,68194,3F9rh0xtO3MPjBfGcFPCm9PRbwYuY4I3,SpATywNh6bZuzm8s1ceuBUnMUAeoAHHw,23,44,3,34,1,8,16,1,107,15.285714285714286,8,0.0,9,3,29,1,35,8,5,16,1,42,65,1
4859,68195,PUFh3BsQaDVIJMDvwsFTqkrgAzvjO9ME,bWdj2GDclj5ofokWjzoa5jAwMkxCykd6,3,2,1,0,0,0,1,0,4,0.5714285714285714,1,0.0,0,1,0,0,2,0,0,1,0,1,3,1
4860,68203,6U8VFnPyZYhBRDbe5XdPXo17gTSrU7h6,bWdj2GDclj5ofokWjzoa5jAwMkxCykd6,10,11,7,0,2,10,8,1,39,5.571428571428571,3,0.0,0,7,0,2,11,10,0,8,1,9,30,1
4861,68205,XRUycqJgK6Teg1VieyLPSxgajklcF856,SpATywNh6bZuzm8s1ceuBUnMUAeoAHHw,8,7,1,0,0,5,4,1,18,2.5714285714285716,1,0.0,2,1,0,0,5,5,0,4,1,3,15,0
4862,68206,XZ83JcONkALUi8eW1z8sh8GNkNHnCecC,SpATywNh6bZuzm8s1ceuBUnMUAeoAHHw,17,26,11,25,3,11,11,3,90,12.857142857142858,2,0.0,12,11,19,3,14,11,6,11,3,45,45,1
4863,68208,j4u6F4qZpPKGLDItX0Q2HAWM10zHBR79,SpATywNh6bZuzm8s1ceuBUnMUAeoAHHw,13,19,8,11,3,0,2,0,43,6.142857142857143,1,0.0,7,8,11,3,12,0,0,2,0,29,14,1
4864,68210,6A7JcBAaCtlmyXJds1FDIeGlm0ezPnc3,SpATywNh6bZuzm8s1ceuBUnMUAeoAHHw,12,13,1,17,1,0,4,0,36,5.142857142857143,1,0.0,8,1,16,1,5,0,1,4,0,26,10,1
4865,68212,1fxFMFifV1rQ9EWjOwHxBWikLCyhcjXV,SpATywNh6bZuzm8s1ceuBUnMUAeoAHHw,7,15,1,8,0,0,1,0,25,3.5714285714285716,1,0.0,0,1,6,0,15,0,2,1,0,7,18,1
4866,68222,WnGoJ0X05nmmcr9OBuNGFmD5r4EVF1g6,bWdj2GDclj5ofokWjzoa5jAwMkxCykd6,12,24,13,0,5,34,20,4,100,14.285714285714286,4,0.0,0,13,0,5,24,34,0,20,4,18,82,1
4867,68230,82GMCFQFd0THTrsyKfVm7WvJIFvIx6zJ,bWdj2GDclj5ofokWjzoa5jAwMkxCykd6,1,0,0,0,0,0,1,0,1,0.14285714285714285,1,0.0,0,0,0,0,0,0,0,1,0,0,1,1
4868,68234,CR4gghlbM9RsvrMmN4aq9I8yiSZncbD8,SpATywNh6bZuzm8s1ceuBUnMUAeoAHHw,23,28,15,18,5,0,10,0,76,10.857142857142858,4,0.0,9,15,18,5,19,0,0,10,0,47,29,0
4869,68239,ZGeJlcog0o13nhqeKC2vRvkt6LFvOzyP,SpATywNh6bZuzm8s1ceuBUnMUAeoAHHw,1,0,0,0,0,0,1,0,1,0.14285714285714285,1,0.0,0,0,0,0,0,0,0,1,0,0,1,1
4870,68240,IZwgoYiQOwzeEoIsJbmj0ULJBVLQ8tDo,SpATywNh6bZuzm8s1ceuBUnMUAeoAHHw,6,3,2,0,2,0,1,0,8,1.1428571428571428,1,0.0,0,2,0,2,3,0,0,1,0,4,4,0
4871,68241,i2PPXz5Z5PB2ZfiVAI64TcWxYgJR1QQ1,RXDvfPUBYFlVdlueBFbLW0mhhAyGEqpt,31,26,19,12,10,7,10,1,85,12.142857142857142,4,0.0,0,19,11,10,26,7,1,10,1,40,45,1
4872,68242,zQ0WfWm1cz6xtKNF9R3KOD2OW4OSAkc1,SpATywNh6bZuzm8s1ceuBUnMUAeoAHHw,11,7,6,6,0,0,5,0,24,3.4285714285714284,2,0.0,0,6,5,0,7,0,1,5,0,11,13,1
4873,68248,difzQoAVFjIhhoeyJCnFHhQfdluM0dbZ,G8EPVSXsOYB5YQWZGiz1aVq5Pgr2GrQu,1,0,0,0,0,0,1,0,1,0.14285714285714285,1,0.0,0,0,0,0,0,0,0,1,0,0,1,1
4874,68250,bNThALRhT3LNXximO1paliuB0aPzkqk7,SpATywNh6bZuzm8s1ceuBUnMUAeoAHHw,17,15,7,25,4,47,15,3,116,16.571428571428573,2,0.0,6,7,21,4,9,47,4,15,3,38,78,1
4875,68251,Hy6j11K745hIL1HizKPEi5wjs7F2sOsG,SpATywNh6bZuzm8s1ceuBUnMUAeoAHHw,5,3,1,0,1,0,4,0,9,1.2857142857142858,1,0.0,0,1,0,1,3,0,0,4,0,2,7,1
4876,68252,5N9UtpTd0Iyfm1Amzky3t1R9JrMPidgw,SpATywNh6bZuzm8s1ceuBUnMUAeoAHHw,25,58,23,24,20,0,21,1,147,21.0,4,0.0,14,23,17,20,44,0,7,21,1,74,73,0
4877,68258,oL1G89Phk4nduULmJ17br7A4xddcHdc4,RXDvfPUBYFlVdlueBFbLW0mhhAyGEqpt,13,14,7,0,3,6,11,1,42,6.0,4,0.0,1,7,0,3,13,6,0,11,1,11,31,0
4878,68262,jwmMikqyMlJ3SzOUjqLjM22mCL5p25A7,SpATywNh6bZuzm8s1ceuBUnMUAeoAHHw,5,3,1,0,1,0,4,0,9,1.2857142857142858,1,0.0,1,1,0,1,2,0,0,4,0,3,6,1
4879,68263,pbaQcU38LWlEY15kC2Yb0jdLNtMAYhsA,SpATywNh6bZuzm8s1ceuBUnMUAeoAHHw,28,78,39,30,15,0,11,0,173,24.714285714285715,9,0.0,22,39,26,15,56,0,4,11,0,102,71,0
4880,68268,jwN9sgXwQLE8sD1F25K97DLtEDZ0gnxi,SpATywNh6bZuzm8s1ceuBUnMUAeoAHHw,1,0,0,0,0,0,1,0,1,0.14285714285714285,1,0.0,0,0,0,0,0,0,0,1,0,0,1,1
4881,68273,1qOWHE2SxHYAOzNCTuiHl1kSZUHL0gyU,SpATywNh6bZuzm8s1ceuBUnMUAeoAHHw,32,132,52,37,19,16,62,6,324,46.285714285714285,6,0.0,38,52,31,19,94,16,6,62,6,140,184,0
4882,68275,RWU4omSsfIhWMdUidy2dDc2hADqC6J7F,RXDvfPUBYFlVdlueBFbLW0mhhAyGEqpt,1,0,0,0,0,0,1,0,1,0.14285714285714285,1,0.0,0,0,0,0,0,0,0,1,0,0,1,1
4883,68279,S5r0CKOxIwwZ6o4r0E3DEfNq3HUydzP8,SpATywNh6bZuzm8s1ceuBUnMUAeoAHHw,10,11,9,0,7,0,2,0,29,4.142857142857143,1,0.0,0,9,0,7,11,0,0,2,0,16,13,1
4884,68280,0iBsrOe2KnLxk8TGZ7ugYIrItWDyZcX5,bWdj2GDclj5ofokWjzoa5jAwMkxCykd6,1,0,0,0,0,0,1,0,1,0.14285714285714285,1,0.0,0,0,0,0,0,0,0,1,0,0,1,1
4885,68296,b1g4AWG6A2zG5plnQY4paLSHRFnrgObC,G8EPVSXsOYB5YQWZGiz1aVq5Pgr2GrQu,9,21,7,0,2,1,25,0,56,8.0,5,0.0,0,7,0,2,21,1,0,25,0,9,47,1
4886,68299,MzTmeAugUJkvlIkD1VbUcP5NYDEco9Sz,bWdj2GDclj5ofokWjzoa5jAwMkxCykd6,12,9,3,54,3,0,1,0,70,10.0,1,0.0,5,3,51,3,4,0,3,1,0,62,8,1
4887,68305,1Z4DcQGB0iHwU6wAGYAE4UwCDJhJoWI1,SpATywNh6bZuzm8s1ceuBUnMUAeoAHHw,5,2,1,0,1,0,4,0,8,1.1428571428571428,1,0.0,0,1,0,1,2,0,0,4,0,2,6,0
4888,68312,FmmzXResih4xmTvS1USR90U6hsc9smA9,RXDvfPUBYFlVdlueBFbLW0mhhAyGEqpt,6,10,3,0,3,0,1,0,17,2.4285714285714284,2,0.0,0,3,0,3,10,0,0,1,0,6,11,1
4889,68316,FocgTK7ZKP5rXdprEvR0U5yJcvk72CbF,SpATywNh6bZuzm8s1ceuBUnMUAeoAHHw,11,14,6,10,0,9,7,0,46,6.571428571428571,2,0.0,7,6,8,0,7,9,2,7,0,21,25,1
4890,68318,g3PG76pcZjQr6VJ2OlBuhnEf9tLvgXf4,SpATywNh6bZuzm8s1ceuBUnMUAeoAHHw,4,2,1,0,1,0,1,0,5,0.7142857142857143,1,0.0,0,1,0,1,2,0,0,1,0,2,3,1
4891,68321,AOjgDe9pflTNYpkfyCGVCxzTomGLrXC9,G8EPVSXsOYB5YQWZGiz1aVq5Pgr2GrQu,9,7,3,0,2,3,15,1,31,4.428571428571429,1,0.0,2,3,0,2,5,3,0,15,1,7,24,1
4892,68324,VwIVGF64yzO60dfdnqn1D6KZSjw1xNvm,bWdj2GDclj5ofokWjzoa5jAwMkxCykd6,6,19,2,0,1,0,5,0,27,3.857142857142857,3,0.0,0,2,0,1,19,0,0,5,0,3,24,1
4893,68332,hJo1MgKiPZFXuH2ko6hqPTd9dbjMQKDO,SpATywNh6bZuzm8s1ceuBUnMUAeoAHHw,14,36,18,10,7,0,7,0,78,11.142857142857142,7,0.0,9,18,10,7,27,0,0,7,0,44,34,0
4894,68333,8DBF0kTYvtu7h0hsdxFO3EFrNNkmUkiM,SpATywNh6bZuzm8s1ceuBUnMUAeoAHHw,16,17,5,14,3,11,7,0,57,8.142857142857142,2,0.0,10,5,14,3,7,11,0,7,0,32,25,1
4895,68345,SnyeeNQTfkqzknIlQQLm06X1xA6g9a0l,SpATywNh6bZuzm8s1ceuBUnMUAeoAHHw,16,29,9,19,8,12,9,1,87,12.428571428571429,2,0.0,9,9,16,8,20,12,3,9,1,42,45,1
4896,68349,iADE6TgYebHG0th9GrbiEmbQ3Qc3Go8z,RXDvfPUBYFlVdlueBFbLW0mhhAyGEqpt,6,1,1,0,1,0,4,1,8,1.1428571428571428,2,0.0,0,1,0,1,1,0,0,4,1,2,6,1
4897,68351,QkN5nvBbZszJiSQ2f66kudMZ2eWWY8sa,RXDvfPUBYFlVdlueBFbLW0mhhAyGEqpt,6,4,3,0,1,0,1,0,9,1.2857142857142858,1,0.0,0,3,0,1,4,0,0,1,0,4,5,1
4898,68352,clbUGnOQsN7CuaV7idGJ2LVbYN3t8qC3,SpATywNh6bZuzm8s1ceuBUnMUAeoAHHw,26,47,14,18,6,17,11,1,114,16.285714285714285,7,0.0,7,14,17,6,40,17,1,11,1,44,70,0
4899,68357,uxWS9amhXxmjOvqXmZExJSg0LcMFBAvq,G8EPVSXsOYB5YQWZGiz1aVq5Pgr2GrQu,7,3,2,0,1,0,6,0,12,1.7142857142857142,2,0.0,0,2,0,1,3,0,0,6,0,3,9,1
4900,68360,4pJW5s4UUKXpxe6ChNDK23aeXIukgMH8,SpATywNh6bZuzm8s1ceuBUnMUAeoAHHw,16,17,6,17,4,17,10,1,72,10.285714285714286,1,0.0,3,6,14,4,14,17,3,10,1,27,45,1
4901,68362,tlaj4fnwxWl22MIDqzqpAu1L2vA1lQmh,bWdj2GDclj5ofokWjzoa5jAwMkxCykd6,12,23,14,16,7,10,8,1,79,11.285714285714286,4,0.0,3,14,15,7,20,10,1,8,1,39,40,1
4902,68363,0F1DhnfuH8hFtOjZ8dWmoNBQat6tI7Te,SpATywNh6bZuzm8s1ceuBUnMUAeoAHHw,5,2,1,0,1,0,2,1,7,1.0,1,0.0,0,1,0,1,2,0,0,2,1,2,5,1
4903,68364,2FyRSMemMx0WQNXDNdLObUL8ox2VWXod,SpATywNh6bZuzm8s1ceuBUnMUAeoAHHw,29,67,34,35,19,9,15,0,179,25.571428571428573,8,0.0,10,34,31,19,57,9,4,15,0,94,85,1
4904,68365,SG7hB83Yya2DA2E0NTjAVNa4uzxtdA6s,SpATywNh6bZuzm8s1ceuBUnMUAeoAHHw,9,9,2,0,0,2,6,1,20,2.857142857142857,1,0.0,0,2,0,0,9,2,0,6,1,2,18,1
4905,68371,xBU5Obte2st2JNuH81iN4TihJEa7jvrL,SpATywNh6bZuzm8s1ceuBUnMUAeoAHHw,1,0,0,0,0,0,2,0,2,0.2857142857142857,1,0.0,0,0,0,0,0,0,0,2,0,0,2,1
4906,68379,b4M5OphEGf9HhlcR04bazUL6wKV8uIkU,G8EPVSXsOYB5YQWZGiz1aVq5Pgr2GrQu,49,96,3,102,5,69,19,10,304,43.42857142857143,7,0.0,21,3,81,5,75,69,21,19,10,110,194,1
4907,68388,R2V0izPrSC9aiv4wxr7ZUbqHHqyQkLxw,bWdj2GDclj5ofokWjzoa5jAwMkxCykd6,4,2,1,0,1,0,1,0,5,0.7142857142857143,1,0.0,0,1,0,1,2,0,0,1,0,2,3,1
4908,68395,lTZusowYpBCkpVlkG3X20kNgU6aMOOBS,SpATywNh6bZuzm8s1ceuBUnMUAeoAHHw,17,18,7,18,3,3,15,1,65,9.285714285714286,3,0.0,8,7,15,3,10,3,3,15,1,33,32,1
4909,68397,td9JVyRGLfbXKWE7ys0aQ9IRUtJd97NP,bWdj2GDclj5ofokWjzoa5jAwMkxCykd6,5,2,1,0,1,0,3,0,7,1.0,1,0.0,0,1,0,1,2,0,0,3,0,2,5,1
4910,68398,LNdimqsJkOxQDP9dT4IGwewg9YvH7zfV,SpATywNh6bZuzm8s1ceuBUnMUAeoAHHw,15,32,17,6,5,8,5,0,73,10.428571428571429,4,0.0,9,17,6,5,23,8,0,5,0,37,36,1
4911,68399,TTmbjhCeX7YmnFUettVVam4HwYq17paa,SpATywNh6bZuzm8s1ceuBUnMUAeoAHHw,4,5,0,0,0,0,4,0,9,1.2857142857142858,2,0.0,0,0,0,0,5,0,0,4,0,0,9,0
4912,68406,fWzpIAl5AhTFdJeUPdzJHspdUzMjFUYM,bWdj2GDclj5ofokWjzoa5jAwMkxCykd6,5,3,2,0,1,0,5,0,11,1.5714285714285714,2,0.0,0,2,0,1,3,0,0,5,0,3,8,1
4913,68411,4vxCaGfGDr7qH4ipzhuoVimWrYG1kGYQ,bWdj2GDclj5ofokWjzoa5jAwMkxCykd6,17,47,22,58,6,52,43,4,232,33.142857142857146,4,0.0,3,22,49,6,44,52,9,43,4,80,152,1
4914,68412,0KxBv7TNEUj27dsp2zMGG4WpBswpgOyf,SpATywNh6bZuzm8s1ceuBUnMUAeoAHHw,13,24,15,10,2,0,9,0,60,8.571428571428571,6,0.0,0,15,10,2,24,0,0,9,0,27,33,0
4915,68423,bET2Moo4lPgmSBI2ZHgAloQD25b1Jinn,G8EPVSXsOYB5YQWZGiz1aVq5Pgr2GrQu,17,18,8,30,4,0,3,0,63,9.0,3,0.0,0,8,28,4,18,0,2,3,0,40,23,1
4916,68424,7XeEjaT7Rw76VaeBef1jnkEycygog40I,SpATywNh6bZuzm8s1ceuBUnMUAeoAHHw,9,16,8,0,7,0,2,0,33,4.714285714285714,1,0.0,2,8,0,7,14,0,0,2,0,17,16,1
4917,68426,4a1LmrNqPaRbQL0Q68aycdhtteXqXTMU,SpATywNh6bZuzm8s1ceuBUnMUAeoAHHw,5,2,1,0,1,0,2,0,6,0.8571428571428571,1,0.0,0,1,0,1,2,0,0,2,0,2,4,1
4918,68435,dYES117kkj3IhCPWFa9k6hhXgoc7YknJ,G8EPVSXsOYB5YQWZGiz1aVq5Pgr2GrQu,8,4,1,0,0,6,6,1,18,2.5714285714285716,1,0.0,0,1,0,0,4,6,0,6,1,1,17,1
4919,68438,nnZGKhMV6zkzSC8Qzeh7UPQIZVHpp5uX,bWdj2GDclj5ofokWjzoa5jAwMkxCykd6,1,0,0,0,0,0,1,0,1,0.14285714285714285,1,0.0,0,0,0,0,0,0,0,1,0,0,1,1
4920,68439,6H5tZYvQXUXA5x38gvAZ0WgqLjIkqn3b,SpATywNh6bZuzm8s1ceuBUnMUAeoAHHw,8,5,2,0,2,0,3,0,12,1.7142857142857142,2,0.0,0,2,0,2,5,0,0,3,0,4,8,1
4921,68442,v8CV9SymhVbpaH5nH9XVMeR4jjsMeKhG,G8EPVSXsOYB5YQWZGiz1aVq5Pgr2GrQu,15,5,4,20,3,0,2,0,34,4.857142857142857,1,0.0,0,4,17,3,5,0,3,2,0,24,10,1
4922,68455,HzaFh1I0rWfjYqs3kd2mhXywhDrDBNWZ,bWdj2GDclj5ofokWjzoa5jAwMkxCykd6,8,17,5,0,2,3,9,1,37,5.285714285714286,3,0.0,2,5,0,2,15,3,0,9,1,9,28,1
4923,68463,CJyFZrp4dFxNPWh98LYOwXSivShmskBg,SpATywNh6bZuzm8s1ceuBUnMUAeoAHHw,7,3,2,0,2,0,2,0,9,1.2857142857142858,1,0.0,0,2,0,2,3,0,0,2,0,4,5,1
4924,68467,4VUauTz2C9X4SCHk8ugs49B1paCitpmU,G8EPVSXsOYB5YQWZGiz1aVq5Pgr2GrQu,22,14,13,42,5,1,12,1,88,12.571428571428571,1,0.0,0,13,37,5,14,1,5,12,1,55,33,1
4925,68475,FCvIa0IivvqNa6modx0mbEXg1jcpQzBN,SpATywNh6bZuzm8s1ceuBUnMUAeoAHHw,1,0,0,0,0,0,1,0,1,0.14285714285714285,1,0.0,0,0,0,0,0,0,0,1,0,0,1,1
4926,68483,b3xaxczfVryBkeC1YPbXWEZUleYIZAnq,bWdj2GDclj5ofokWjzoa5jAwMkxCykd6,7,5,4,0,2,0,5,0,16,2.2857142857142856,2,0.0,1,4,0,2,4,0,0,5,0,7,9,1
4927,68485,v6euctfbzWthWyLBlYjaRzf7ryZssgjA,bWdj2GDclj5ofokWjzoa5jAwMkxCykd6,1,0,0,0,0,0,1,0,1,0.14285714285714285,1,0.0,0,0,0,0,0,0,0,1,0,0,1,1
4928,68494,yvCmfQ3z3fMLbjXX0h1AIIPVh4np9hhq,SpATywNh6bZuzm8s1ceuBUnMUAeoAHHw,27,48,25,40,10,6,20,1,150,21.428571428571427,7,0.0,13,25,35,10,35,6,5,20,1,83,67,0
4929,68496,SI82MK5h5zRoUuXAAtKY5ltobDSBBXh9,bWdj2GDclj5ofokWjzoa5jAwMkxCykd6,21,32,16,132,9,0,10,1,200,28.571428571428573,2,0.0,10,16,128,9,22,0,4,10,1,163,37,1
4930,68500,IhUEedXCjE6LoKReKNbXGS4Fqk4t4GUl,SpATywNh6bZuzm8s1ceuBUnMUAeoAHHw,7,5,1,0,1,0,3,0,10,1.4285714285714286,1,0.0,0,1,0,1,5,0,0,3,0,2,8,1
4931,68509,hkI32MAgHvJ4T3I3Up79daEJ8l4sKHaC,bWdj2GDclj5ofokWjzoa5jAwMkxCykd6,20,26,12,156,11,29,9,1,244,34.857142857142854,3,0.0,9,12,146,11,17,29,10,9,1,178,66,1
4932,68511,Q9VYSqOD2rxffT9mHJg8GtdPL5OsLSDn,G8EPVSXsOYB5YQWZGiz1aVq5Pgr2GrQu,5,2,1,0,1,0,3,0,7,1.0,1,0.0,0,1,0,1,2,0,0,3,0,2,5,1
4933,68513,PRgLfGkxJHP58QbJdXg5l5vWjuJI88nv,SpATywNh6bZuzm8s1ceuBUnMUAeoAHHw,25,26,15,12,9,15,8,0,85,12.142857142857142,4,0.0,7,15,9,9,19,15,3,8,0,40,45,1
4934,68516,6oCDtYWE1YbVTX7pVBS5Cflb4KyRNNI9,SpATywNh6bZuzm8s1ceuBUnMUAeoAHHw,1,0,0,0,0,0,1,0,1,0.14285714285714285,1,0.0,0,0,0,0,0,0,0,1,0,0,1,1
4935,68521,iSIDy53M1GeZpXt46JkUT1CVMnifiRBT,bWdj2GDclj5ofokWjzoa5jAwMkxCykd6,6,4,1,0,1,1,3,1,11,1.5714285714285714,2,0.0,0,1,0,1,4,1,0,3,1,2,9,1
4936,68543,kS5Tu2RHO9HzXMOZp3CUIdzW6Y8prRRh,SpATywNh6bZuzm8s1ceuBUnMUAeoAHHw,14,26,0,20,0,12,10,1,69,9.857142857142858,4,0.0,9,0,16,0,17,12,4,10,1,25,44,1
4937,68544,neZ18tPUzdX2s40f6yVBysxDUKCDyzmG,SpATywNh6bZuzm8s1ceuBUnMUAeoAHHw,14,22,2,13,2,0,4,0,43,6.142857142857143,2,0.0,10,2,12,2,12,0,1,4,0,26,17,0
4938,68551,NfUq1iJeG4DoVU66A3eQnbdSJYCM4IOC,SpATywNh6bZuzm8s1ceuBUnMUAeoAHHw,6,3,2,0,1,0,2,0,8,1.1428571428571428,1,0.0,0,2,0,1,3,0,0,2,0,3,5,1
4939,68555,vle68wJbpBxaKK8jTIIpU222057lhydD,bWdj2GDclj5ofokWjzoa5jAwMkxCykd6,4,3,1,0,1,0,2,0,7,1.0,1,0.0,0,1,0,1,3,0,0,2,0,2,5,1
4940,68561,Y3Qq9FqOVwUj6PrB3KNsrLngzeSzadt5,bWdj2GDclj5ofokWjzoa5jAwMkxCykd6,9,12,5,2,2,0,6,0,27,3.857142857142857,2,0.0,1,5,2,2,11,0,0,6,0,10,17,1
4941,68563,8fwUYmiU3p577nM1EutDr5QOZIKfzBRc,RXDvfPUBYFlVdlueBFbLW0mhhAyGEqpt,70,106,53,149,19,64,30,16,437,62.42857142857143,9,0.0,18,53,142,19,88,64,7,30,16,232,205,0
4942,68567,IFerpKRFijjTvFKVmnLPfRMMDF4cIZJF,SpATywNh6bZuzm8s1ceuBUnMUAeoAHHw,7,4,0,0,0,0,5,0,9,1.2857142857142858,1,0.0,0,0,0,0,4,0,0,5,0,0,9,1
4943,68585,Glxmm6OkKDEBHVvI7QqNEC5RvmqUE0HS,bWdj2GDclj5ofokWjzoa5jAwMkxCykd6,4,3,2,0,1,0,2,0,8,1.1428571428571428,1,0.0,0,2,0,1,3,0,0,2,0,3,5,1
4944,68590,E8oGkXDZccLFAlXi9bJFdyG7ZjuPGPVx,bWdj2GDclj5ofokWjzoa5jAwMkxCykd6,6,5,3,0,2,0,6,0,16,2.2857142857142856,1,0.0,0,3,0,2,5,0,0,6,0,5,11,1
4945,68593,ko8ha9Nr4wk6DeuPN4U2tszPncta4AJu,RXDvfPUBYFlVdlueBFbLW0mhhAyGEqpt,6,5,2,0,2,0,1,0,10,1.4285714285714286,1,0.0,0,2,0,2,5,0,0,1,0,4,6,1
4946,68594,rPL0mqKklpGJ7nKQwJfgLcDkUtLeeh8C,SpATywNh6bZuzm8s1ceuBUnMUAeoAHHw,1,0,0,0,0,0,1,0,1,0.14285714285714285,1,0.0,0,0,0,0,0,0,0,1,0,0,1,1
4947,68600,w4KVb9q7mwoVRgCyZI0dPAL72VxyapbO,SpATywNh6bZuzm8s1ceuBUnMUAeoAHHw,17,25,10,10,4,13,23,1,86,12.285714285714286,2,0.0,12,10,9,4,13,13,1,23,1,35,51,0
4948,68608,xKFuemwLTt1HbT05n0729C3MfJQfGzio,bWdj2GDclj5ofokWjzoa5jAwMkxCykd6,8,8,2,0,2,0,4,0,16,2.2857142857142856,2,0.0,0,2,0,2,8,0,0,4,0,4,12,1
4949,68614,oA0E9aMtllY5HCZuDmQFAhbdEUxnmzHK,SpATywNh6bZuzm8s1ceuBUnMUAeoAHHw,14,13,5,18,3,5,6,0,50,7.142857142857143,2,0.0,5,5,15,3,8,5,3,6,0,28,22,1
4950,68615,mPyp7jTeTZOoi8uKfW9n4yxp1m3yxLU6,SpATywNh6bZuzm8s1ceuBUnMUAeoAHHw,16,12,6,11,3,3,7,1,43,6.142857142857143,2,0.0,3,6,10,3,9,3,1,7,1,22,21,1
4951,68623,F5DvCuAufOHMNW6g3uuO7OUr15Bgdj9y,SpATywNh6bZuzm8s1ceuBUnMUAeoAHHw,23,51,15,29,5,20,14,0,134,19.142857142857142,4,0.0,11,15,25,5,40,20,4,14,0,56,78,0
4952,68633,EoHwSWSzaw8CNhaYKiwnwX4BUG0jVkiR,G8EPVSXsOYB5YQWZGiz1aVq5Pgr2GrQu,28,35,10,95,5,0,7,0,152,21.714285714285715,2,0.0,20,10,79,5,15,0,16,7,0,114,38,1
4953,68643,800D5qwHCt3Ko9pzEVC49paGCt6dYzm8,bWdj2GDclj5ofokWjzoa5jAwMkxCykd6,14,61,32,26,10,79,18,0,226,32.285714285714285,6,0.0,11,32,23,10,50,79,3,18,0,76,150,1
4954,68645,uSpti6Yw7qPzPT4S4dLtJ0lPSlE5C6Xf,RXDvfPUBYFlVdlueBFbLW0mhhAyGEqpt,1,0,0,0,0,0,1,0,1,0.14285714285714285,1,0.0,0,0,0,0,0,0,0,1,0,0,1,1
4955,68648,xHynkOdioqQyjpJfj8K7fiM1HqYlBJD7,SpATywNh6bZuzm8s1ceuBUnMUAeoAHHw,9,9,5,0,4,0,8,0,26,3.7142857142857144,2,0.0,0,5,0,4,9,0,0,8,0,9,17,1
4956,68652,HVM7cvH7tmJviHLVmU4moAWMBQcFDIXR,SpATywNh6bZuzm8s1ceuBUnMUAeoAHHw,1,0,0,0,0,0,1,0,1,0.14285714285714285,1,0.0,0,0,0,0,0,0,0,1,0,0,1,1
4957,68663,uWg9viAyRsUVYkVv3Yy7uJ56PNmRweOf,SpATywNh6bZuzm8s1ceuBUnMUAeoAHHw,7,3,1,0,1,1,3,0,9,1.2857142857142858,1,0.0,0,1,0,1,3,1,0,3,0,2,7,1
4958,68668,LJN1NW4KDrkfGUEkF9SJPSL4rdPIFcim,bWdj2GDclj5ofokWjzoa5jAwMkxCykd6,9,14,0,8,3,15,8,1,49,7.0,2,0.0,8,0,8,3,6,15,0,8,1,19,30,1
4959,68669,UpJrRBQ59x3Gn5L7s007cXh7Wi1pgqj5,G8EPVSXsOYB5YQWZGiz1aVq5Pgr2GrQu,1,0,0,0,0,0,1,0,1,0.14285714285714285,1,0.0,0,0,0,0,0,0,0,1,0,0,1,1
4960,68672,XlAtLUmCwQMJblZxz5Uj8YKvORzQq8sL,bWdj2GDclj5ofokWjzoa5jAwMkxCykd6,2,0,0,0,0,0,2,0,2,0.2857142857142857,1,0.0,0,0,0,0,0,0,0,2,0,0,2,1
4961,68673,LDvIjeK3BrrUiPE6HdHKfvDgiWdtz8gl,bWdj2GDclj5ofokWjzoa5jAwMkxCykd6,5,5,2,0,1,0,3,0,11,1.5714285714285714,2,0.0,0,2,0,1,5,0,0,3,0,3,8,1
4962,68675,ZBFATksKEZIW0yZpEc4DInpubrEeq3eS,SpATywNh6bZuzm8s1ceuBUnMUAeoAHHw,16,22,11,4,5,0,1,0,43,6.142857142857143,4,0.0,2,11,4,5,20,0,0,1,0,22,21,1
4963,68684,wL3zK87VyJEaxj3JDk5zLpiovNVlVgY0,SpATywNh6bZuzm8s1ceuBUnMUAeoAHHw,9,4,3,0,3,0,3,0,13,1.8571428571428572,1,0.0,0,3,0,3,4,0,0,3,0,6,7,1
4964,68685,0sGUIxoauZHFSZVR3Y4LtOM6Pq2DRxjU,SpATywNh6bZuzm8s1ceuBUnMUAeoAHHw,6,2,1,0,1,0,3,0,7,1.0,1,0.0,0,1,0,1,2,0,0,3,0,2,5,1
4965,68686,YRBA7GRiLrrlZjduaK8N9tfqRO36138H,SpATywNh6bZuzm8s1ceuBUnMUAeoAHHw,22,49,17,37,6,0,10,0,119,17.0,6,0.0,10,17,32,6,39,0,5,10,0,65,54,0
4966,68690,vsAcPV04LnM01WalbcA4jNxiuu2qNyeQ,SpATywNh6bZuzm8s1ceuBUnMUAeoAHHw,25,75,17,31,8,32,19,3,185,26.428571428571427,10,0.0,25,17,30,8,50,32,1,19,3,80,105,0
4967,68694,SPA2zjP6CEFeNMb3HCTy4jT9WpFTBDct,SpATywNh6bZuzm8s1ceuBUnMUAeoAHHw,28,37,13,29,7,1,9,1,97,13.857142857142858,3,0.0,5,13,27,7,32,1,2,9,1,52,45,1
4968,68698,L0kYOQ1jlQCXWFfUIC5KdixPfS0gzVfJ,SpATywNh6bZuzm8s1ceuBUnMUAeoAHHw,1,0,0,0,0,0,1,0,1,0.14285714285714285,1,0.0,0,0,0,0,0,0,0,1,0,0,1,1
4969,68702,vX3VPIJhPCYSA7dPeCf6CgdqKnk7djlz,SpATywNh6bZuzm8s1ceuBUnMUAeoAHHw,1,0,0,0,0,0,1,0,1,0.14285714285714285,1,0.0,0,0,0,0,0,0,0,1,0,0,1,1
4970,68706,i1TcNs7eTFFk7oCk5M8KreZU8FvcW9bN,SpATywNh6bZuzm8s1ceuBUnMUAeoAHHw,5,1,1,0,1,3,2,0,8,1.1428571428571428,1,0.0,0,1,0,1,1,3,0,2,0,2,6,1
4971,68714,AUQbcN6sP8jOc3r7pDcomR6R8baoxLvG,SpATywNh6bZuzm8s1ceuBUnMUAeoAHHw,9,9,4,0,3,0,5,0,21,3.0,1,0.0,1,4,0,3,8,0,0,5,0,8,13,1
4972,68715,naqtjO9tZgTvMaAs9wVFgT7OrPAljiOn,bWdj2GDclj5ofokWjzoa5jAwMkxCykd6,6,6,2,0,1,0,5,0,14,2.0,3,0.0,1,2,0,1,5,0,0,5,0,4,10,1
4973,68725,v9XA8V9r9cuRk407xmjctqU28ZOWPjKH,SpATywNh6bZuzm8s1ceuBUnMUAeoAHHw,11,14,2,14,1,9,4,0,44,6.285714285714286,2,0.0,4,2,13,1,10,9,1,4,0,20,24,1
4974,68726,9DFLyn8rbv9Edwun9eQjrB5tgbqXjOr5,RXDvfPUBYFlVdlueBFbLW0mhhAyGEqpt,13,24,11,0,8,3,10,1,57,8.142857142857142,3,0.0,2,11,0,8,22,3,0,10,1,21,36,1
4975,68728,OPI0XMiYXF2KbjFje02yg2IsfXd4KQW0,G8EPVSXsOYB5YQWZGiz1aVq5Pgr2GrQu,1,0,0,0,0,0,1,0,1,0.14285714285714285,1,0.0,0,0,0,0,0,0,0,1,0,0,1,1
4976,68729,fgHXEx1kTgwNtn0duzRnGZnTM9G4nrHz,SpATywNh6bZuzm8s1ceuBUnMUAeoAHHw,7,6,4,0,3,0,2,0,15,2.142857142857143,2,0.0,0,4,0,3,6,0,0,2,0,7,8,1
4977,68734,U7RYhML9VmouEXOzi3jihOcHs1Odr6nQ,SpATywNh6bZuzm8s1ceuBUnMUAeoAHHw,4,2,1,0,1,2,2,0,8,1.1428571428571428,1,0.0,0,1,0,1,2,2,0,2,0,2,6,1
4978,68735,3JdonxNhNI9NQjhEwg0qbYv0wUomYvrC,SpATywNh6bZuzm8s1ceuBUnMUAeoAHHw,5,6,4,0,0,0,5,0,15,2.142857142857143,2,0.0,0,4,0,0,6,0,0,5,0,4,11,1
4979,68738,8mpNTb2f22eIFQe95nOOySrTvXoHGtkW,SpATywNh6bZuzm8s1ceuBUnMUAeoAHHw,5,1,1,0,0,0,4,0,6,0.8571428571428571,1,0.0,0,1,0,0,1,0,0,4,0,1,5,1
4980,68742,kv6R7WjolUetaoWMs79hGLWsktu3yDdz,bWdj2GDclj5ofokWjzoa5jAwMkxCykd6,16,39,5,0,5,0,9,0,58,8.285714285714286,2,0.0,12,5,0,5,27,0,0,9,0,22,36,1
4981,68744,Gt9BtVmn4m8oLlyiIlUegGAp2m9g8UFD,SpATywNh6bZuzm8s1ceuBUnMUAeoAHHw,12,14,7,0,3,0,8,1,33,4.714285714285714,3,0.0,0,7,0,3,14,0,0,8,1,10,23,1
4982,68753,i3mc4Kbynj5lAgvXLfa16WvI77RFTi9E,SpATywNh6bZuzm8s1ceuBUnMUAeoAHHw,13,21,4,17,1,11,9,3,66,9.428571428571429,2,0.0,15,4,16,1,6,11,1,9,3,36,30,1
4983,68756,GbO46rd9u4nTIYKWQ4uqsc2u6MxCvlf3,bWdj2GDclj5ofokWjzoa5jAwMkxCykd6,8,17,10,0,0,0,10,0,37,5.285714285714286,4,0.0,2,10,0,0,15,0,0,10,0,12,25,1
4984,68766,o9OiuR1V9DDjBMFIfw7sS4DiqEBIQuP8,SpATywNh6bZuzm8s1ceuBUnMUAeoAHHw,1,0,0,0,0,0,1,0,1,0.14285714285714285,1,0.0,0,0,0,0,0,0,0,1,0,0,1,1
4985,68769,RtEFZWMpyIRlgcponU0BmtpKa8uVqiIS,bWdj2GDclj5ofokWjzoa5jAwMkxCykd6,8,8,2,0,1,19,9,1,40,5.714285714285714,3,0.0,2,2,0,1,6,19,0,9,1,5,35,1
4986,68770,yo49sG8PZONryMrR1vxvvUfG4Kw6dJSG,bWdj2GDclj5ofokWjzoa5jAwMkxCykd6,1,0,0,0,0,0,1,0,1,0.14285714285714285,1,0.0,0,0,0,0,0,0,0,1,0,0,1,1
4987,68773,G1AwzYA13F3hOahvKjBBoTuWWSrXyEmf,SpATywNh6bZuzm8s1ceuBUnMUAeoAHHw,8,20,1,0,1,1,18,0,41,5.857142857142857,4,0.0,1,1,0,1,19,1,0,18,0,3,38,1
4988,68774,b7XeenIAmbbWWMDukegOQ8zSwFKoA3Yg,SpATywNh6bZuzm8s1ceuBUnMUAeoAHHw,6,10,1,0,1,0,5,0,17,2.4285714285714284,2,0.0,0,1,0,1,10,0,0,5,0,2,15,1
4989,68779,r5IH8s4isWFYMIVZOSBCnIzOrNuqNLMt,RXDvfPUBYFlVdlueBFbLW0mhhAyGEqpt,2,0,0,0,0,0,3,0,3,0.42857142857142855,1,0.0,0,0,0,0,0,0,0,3,0,0,3,1
4990,68781,THXcc2NGn7OhkfHl1lLehmfkJwTtl0vs,SpATywNh6bZuzm8s1ceuBUnMUAeoAHHw,18,18,8,15,3,37,13,2,96,13.714285714285714,4,0.0,6,8,15,3,12,37,0,13,2,32,64,1
4991,68782,0txLoRwFKi6b3jBavBHeGS8Bc3NOwsVb,SpATywNh6bZuzm8s1ceuBUnMUAeoAHHw,6,2,1,0,1,1,4,0,9,1.2857142857142858,2,0.0,0,1,0,1,2,1,0,4,0,2,7,1
4992,68784,QhYcOEapN0nrffEwA6S7jQzZwToRePP8,SpATywNh6bZuzm8s1ceuBUnMUAeoAHHw,5,7,5,0,0,0,2,0,14,2.0,2,0.0,0,5,0,0,7,0,0,2,0,5,9,1
4993,68786,zikfbKKf6UwbalVzNX9BImZBlJFR20fk,bWdj2GDclj5ofokWjzoa5jAwMkxCykd6,5,0,0,0,0,2,7,0,9,1.2857142857142858,2,0.0,0,0,0,0,0,2,0,7,0,0,9,1
4994,68792,SmrYmgxL1AB7vaaR6Foc1c7Uyze9dDt7,RXDvfPUBYFlVdlueBFbLW0mhhAyGEqpt,1,0,0,0,0,0,1,0,1,0.14285714285714285,1,0.0,0,0,0,0,0,0,0,1,0,0,1,1
4995,68797,7BZDKYSiNttbGsEOSXAkMuiEhZ6QNT9G,bWdj2GDclj5ofokWjzoa5jAwMkxCykd6,16,27,15,46,2,38,5,1,134,19.142857142857142,2,0.0,10,15,42,2,17,38,4,5,1,69,65,1
4996,68805,xjDtTrSSXACX8VZBwSxlHbYQJ7eeUCIt,SpATywNh6bZuzm8s1ceuBUnMUAeoAHHw,5,2,1,0,1,0,2,0,6,0.8571428571428571,2,0.0,0,1,0,1,2,0,0,2,0,2,4,1
4997,68807,3vpFIgzmYroxEHJb2wiXr0H3xcuBXZTn,SpATywNh6bZuzm8s1ceuBUnMUAeoAHHw,1,0,0,0,0,0,1,0,1,0.14285714285714285,1,0.0,0,0,0,0,0,0,0,1,0,0,1,1
4998,68830,RqkVdaWIELGLgdM7036pqEWeMvYmKVEW,A3fsA9Zfv1X2fVEQhTw51lKENdNrEqT3,1,0,0,0,0,0,1,0,1,0.14285714285714285,1,0.0,0,0,0,0,0,0,0,1,0,0,1,1
4999,68831,SmLgezr6vw2mXwO7w10XynKKHaO5xE5n,SpATywNh6bZuzm8s1ceuBUnMUAeoAHHw,16,17,7,8,4,3,6,1,46,6.571428571428571,2,0.0,3,7,8,4,14,3,0,6,1,22,24,1
5000,68843,B2BG30LLtuU2kSL0uylbi1RWlBzZcLDB,SpATywNh6bZuzm8s1ceuBUnMUAeoAHHw,7,4,2,0,2,0,2,0,10,1.4285714285714286,1,0.0,0,2,0,2,4,0,0,2,0,4,6,1
5001,68844,EleMlloryvuXR0G9AOtui0gfdXfrUQfc,SpATywNh6bZuzm8s1ceuBUnMUAeoAHHw,11,22,1,0,0,2,22,2,49,7.0,4,0.0,2,1,0,0,20,2,0,22,2,3,46,1
5002,68868,FvJCcTNYroCUcSPHSotcunzGZyPy4Qi0,SpATywNh6bZuzm8s1ceuBUnMUAeoAHHw,1,0,0,0,0,0,1,0,1,0.14285714285714285,1,0.0,0,0,0,0,0,0,0,1,0,0,1,1
5003,68880,abcXzTNrOBL75IbG8Oh34uJmizkY4tz5,SpATywNh6bZuzm8s1ceuBUnMUAeoAHHw,5,2,0,0,0,0,5,3,10,1.4285714285714286,1,0.0,0,0,0,0,2,0,0,5,3,0,10,1
5004,68881,8cN2OVniTirjZQCsN0ZQrtldoXZmf2q1,SpATywNh6bZuzm8s1ceuBUnMUAeoAHHw,1,0,0,0,0,0,1,0,1,0.14285714285714285,1,0.0,0,0,0,0,0,0,0,1,0,0,1,1
5005,68888,de81RIzfVtIgQfKrUlwLBazhrka9zYFQ,RXDvfPUBYFlVdlueBFbLW0mhhAyGEqpt,44,29,19,80,13,6,6,0,153,21.857142857142858,2,0.0,9,19,78,13,20,6,2,6,0,119,34,1
5006,68902,ZNvFH7xCRnWt4senPXcU6KKoaNuuuPfc,SpATywNh6bZuzm8s1ceuBUnMUAeoAHHw,15,13,9,8,4,8,6,1,49,7.0,1,0.0,1,9,7,4,12,8,1,6,1,21,28,1
5007,68909,dgs5q517os0QP00EQ3rFo0TcrFNCs1kW,RXDvfPUBYFlVdlueBFbLW0mhhAyGEqpt,18,15,7,22,3,0,1,0,48,6.857142857142857,1,0.0,3,7,18,3,12,0,4,1,0,31,17,1
5008,68914,KwglP5SNsu1REAmS7zGy1xBBD4v1B0TU,A3fsA9Zfv1X2fVEQhTw51lKENdNrEqT3,2,0,0,0,0,0,3,0,3,0.42857142857142855,1,0.0,0,0,0,0,0,0,0,3,0,0,3,1
5009,68924,ekbuMTLYQMuR0OvEI2LJUhDBg5Hzduc2,SpATywNh6bZuzm8s1ceuBUnMUAeoAHHw,13,14,8,6,3,4,6,0,41,5.857142857142857,2,0.0,0,8,5,3,14,4,1,6,0,16,25,1
5010,68932,yDiB1gdGW97IDQmCuLOgxDpZ8bOAbVfO,SpATywNh6bZuzm8s1ceuBUnMUAeoAHHw,10,3,3,0,3,0,3,0,12,1.7142857142857142,1,0.0,0,3,0,3,3,0,0,3,0,6,6,1
5011,68936,FsS49SZqT6XuQy2tX0gejqco4jQwOMN4,SpATywNh6bZuzm8s1ceuBUnMUAeoAHHw,26,27,15,21,7,0,1,0,71,10.142857142857142,1,0.0,11,15,17,7,16,0,4,1,0,50,21,0
5012,68939,qUJHOEJOIUq6GHsEj06xYmT7rQa6YMuP,SpATywNh6bZuzm8s1ceuBUnMUAeoAHHw,8,6,4,0,3,0,3,0,16,2.2857142857142856,2,0.0,0,4,0,3,6,0,0,3,0,7,9,1
5013,68944,iLiEQfwv1SBVYie6f2UeSo0gjqwSPq60,SpATywNh6bZuzm8s1ceuBUnMUAeoAHHw,12,16,2,14,0,1,3,1,37,5.285714285714286,2,0.0,7,2,13,0,9,1,1,3,1,22,15,1
5014,68957,03OlEjthtH7bdIcwtrFwO8IymW2gZt4t,SpATywNh6bZuzm8s1ceuBUnMUAeoAHHw,24,66,2,43,1,47,27,8,194,27.714285714285715,5,0.0,21,2,35,1,45,47,8,27,8,59,135,0
5015,68961,Ivwf4DZ9PeaEe6riRbe3YhY3mU61V7Rv,SpATywNh6bZuzm8s1ceuBUnMUAeoAHHw,8,6,3,0,2,0,2,0,13,1.8571428571428572,1,0.0,1,3,0,2,5,0,0,2,0,6,7,1
5016,68965,wyjPcrAJWPhHnDHJIjk8dYEEg9jaoLeO,A3fsA9Zfv1X2fVEQhTw51lKENdNrEqT3,5,2,1,0,1,0,3,0,7,1.0,2,0.0,0,1,0,1,2,0,0,3,0,2,5,1
5017,68982,jvjNqoblvibp0tKoaV1BTGpJ4j9v7r5a,SpATywNh6bZuzm8s1ceuBUnMUAeoAHHw,7,13,3,0,2,0,6,0,24,3.4285714285714284,2,0.0,3,3,0,2,10,0,0,6,0,8,16,0
5018,68983,drUu3tyovHqnF7EAaPHayHDYbWMe2Od6,SpATywNh6bZuzm8s1ceuBUnMUAeoAHHw,1,0,0,0,0,0,2,0,2,0.2857142857142857,2,0.0,0,0,0,0,0,0,0,2,0,0,2,1
5019,68985,xHLXHkY22B9ev5t6W5YAgehgj6yjfueC,bWdj2GDclj5ofokWjzoa5jAwMkxCykd6,2,0,0,0,0,0,3,0,3,0.42857142857142855,1,0.0,0,0,0,0,0,0,0,3,0,0,3,1
5020,68990,Plvb7aRlGh6MOUAvNEeJPeQdOD4FTpby,SpATywNh6bZuzm8s1ceuBUnMUAeoAHHw,6,2,1,0,1,0,4,0,8,1.1428571428571428,1,0.0,0,1,0,1,2,0,0,4,0,2,6,1
5021,69002,f6sYAy41OQsdqlcuUmQWoHmf9GvB4eiI,SpATywNh6bZuzm8s1ceuBUnMUAeoAHHw,8,8,3,0,1,0,7,0,19,2.7142857142857144,2,0.0,0,3,0,1,8,0,0,7,0,4,15,1
5022,69017,fo11APiMDJF2DjuYtDFoBE2X6zRUvD0O,A3fsA9Zfv1X2fVEQhTw51lKENdNrEqT3,7,4,3,0,0,1,4,0,12,1.7142857142857142,1,0.0,0,3,0,0,4,1,0,4,0,3,9,1
5023,69030,fvADHkZjzAohNYEqPdzq6kjINkcTeJGs,SpATywNh6bZuzm8s1ceuBUnMUAeoAHHw,1,0,0,0,0,0,1,0,1,0.14285714285714285,1,0.0,0,0,0,0,0,0,0,1,0,0,1,1
5024,69035,Z71mo3axv3ChUzLxRVr9u5krFj7IoCv8,SpATywNh6bZuzm8s1ceuBUnMUAeoAHHw,1,0,0,0,0,0,1,0,1,0.14285714285714285,1,0.0,0,0,0,0,0,0,0,1,0,0,1,1
5025,69038,DanoP5XpHODQZmwuFGZgNKBiu5nY9yH1,A3fsA9Zfv1X2fVEQhTw51lKENdNrEqT3,39,25,14,68,11,0,4,0,122,17.428571428571427,2,0.0,5,14,59,11,20,0,9,4,0,89,33,1
5026,69046,iOxekl9VdW2ENNqFsiAkjUDt6XuQIiCO,G8EPVSXsOYB5YQWZGiz1aVq5Pgr2GrQu,9,17,2,0,1,1,12,1,34,4.857142857142857,2,0.0,2,2,0,1,15,1,0,12,1,5,29,1
5027,69051,NCEmznACf7J3BIMI6JIs4ZzQnHlfSjOZ,SpATywNh6bZuzm8s1ceuBUnMUAeoAHHw,2,0,0,0,0,0,2,0,2,0.2857142857142857,1,0.0,0,0,0,0,0,0,0,2,0,0,2,1
5028,69066,0a6HihupPBi4xpjolN637qOYG6WSN1Gx,SpATywNh6bZuzm8s1ceuBUnMUAeoAHHw,31,132,77,23,30,40,28,0,330,47.142857142857146,9,0.0,31,77,20,30,101,40,3,28,0,158,172,0
5029,69070,g5yKalRrHBvoyNkzpNTa67etQfVwykko,SpATywNh6bZuzm8s1ceuBUnMUAeoAHHw,30,44,18,39,10,7,8,1,127,18.142857142857142,5,0.0,15,18,32,10,29,7,7,8,1,75,52,0
5030,69076,cy1UxkAxcqJswFy9Syqm01bsE17PQcla,SpATywNh6bZuzm8s1ceuBUnMUAeoAHHw,32,70,38,45,15,21,33,2,224,32.0,10,0.0,12,38,33,15,58,21,12,33,2,98,126,0
5031,69081,BByvTH8isxSvKoMrLrxzWQ5eR0EYxeSe,SpATywNh6bZuzm8s1ceuBUnMUAeoAHHw,8,9,4,0,3,1,7,0,24,3.4285714285714284,3,0.0,0,4,0,3,9,1,0,7,0,7,17,1
5032,69087,sydTASQZF88RFtSW5G7BxBO6Hd5gV1Jf,A3fsA9Zfv1X2fVEQhTw51lKENdNrEqT3,43,51,23,90,16,2,8,1,191,27.285714285714285,2,0.0,5,23,72,16,46,2,18,8,1,116,75,1
5033,69088,tZsLQPiwQA1iRhDP7AIV5FXBJBCNasRN,SpATywNh6bZuzm8s1ceuBUnMUAeoAHHw,5,3,1,0,1,0,2,0,7,1.0,1,0.0,0,1,0,1,3,0,0,2,0,2,5,1
5034,69090,jtRxF2WWWP8ViskFgfl6yKIsTs5XUZVy,SpATywNh6bZuzm8s1ceuBUnMUAeoAHHw,5,2,1,0,1,0,2,0,6,0.8571428571428571,1,0.0,0,1,0,1,2,0,0,2,0,2,4,1
5035,69096,JsUpucQyiTLV5gDB7KrgqzRdiUsoUyeZ,SpATywNh6bZuzm8s1ceuBUnMUAeoAHHw,1,0,0,0,0,0,1,0,1,0.14285714285714285,1,0.0,0,0,0,0,0,0,0,1,0,0,1,1
5036,69098,EXVoxE3v0YCKVCUy0azISc65MiXBDpAw,SpATywNh6bZuzm8s1ceuBUnMUAeoAHHw,13,12,6,0,3,0,7,0,28,4.0,2,0.0,2,6,0,3,10,0,0,7,0,11,17,1
5037,69099,JQSlrp0DjB9to2Jj4hPDSm3T2LtQheyt,SpATywNh6bZuzm8s1ceuBUnMUAeoAHHw,1,0,0,0,0,0,1,0,1,0.14285714285714285,1,0.0,0,0,0,0,0,0,0,1,0,0,1,1
5038,69111,1pa7pgDaPKVXrmbNpHMbk5nmhTlNRGem,bWdj2GDclj5ofokWjzoa5jAwMkxCykd6,1,0,0,0,0,0,1,0,1,0.14285714285714285,1,0.0,0,0,0,0,0,0,0,1,0,0,1,1
5039,69118,27R6lnSTl4HmEumP2huFCqg7wjTw1o6f,SpATywNh6bZuzm8s1ceuBUnMUAeoAHHw,12,18,7,0,2,3,16,3,49,7.0,3,0.0,0,7,0,2,18,3,0,16,3,9,40,1
5040,69122,JsUpucQyiTLV5gDB7KrgqzRdiUsoUyeZ,A3fsA9Zfv1X2fVEQhTw51lKENdNrEqT3,1,0,0,0,0,0,1,0,1,0.14285714285714285,1,0.0,0,0,0,0,0,0,0,1,0,0,1,1
5041,69127,y7mamutAMELy79Bgdj0zOeVjiQ071oNX,bWdj2GDclj5ofokWjzoa5jAwMkxCykd6,6,4,2,0,1,0,5,0,12,1.7142857142857142,2,0.0,0,2,0,1,4,0,0,5,0,3,9,1
5042,69130,pGYLDmhkSj1iBp1YljlDSId0XSrjZNZR,SpATywNh6bZuzm8s1ceuBUnMUAeoAHHw,27,29,18,19,9,0,9,0,84,12.0,8,0.0,4,18,18,9,25,0,1,9,0,49,35,1
5043,69136,dcJzvjKrpatpLnXddQ3Vx9PLCNP0aaAz,SpATywNh6bZuzm8s1ceuBUnMUAeoAHHw,5,2,1,0,1,0,2,0,6,0.8571428571428571,1,0.0,0,1,0,1,2,0,0,2,0,2,4,1
5044,69138,C5Rja3fyOmRxfpM2pXQmwA2G5rEfb320,SpATywNh6bZuzm8s1ceuBUnMUAeoAHHw,23,48,2,23,1,2,24,2,102,14.571428571428571,4,0.0,8,2,19,1,40,2,4,24,2,30,72,1
5045,69140,EJxY61pifGLoX5582yQzVg4H77fLkSml,A3fsA9Zfv1X2fVEQhTw51lKENdNrEqT3,5,2,1,0,1,0,5,0,9,1.2857142857142858,1,0.0,0,1,0,1,2,0,0,5,0,2,7,1
5046,69142,YLA48gUHn1Dc2R5xXAOe8bpBqZ5RWVW4,bWdj2GDclj5ofokWjzoa5jAwMkxCykd6,1,0,0,0,0,0,1,0,1,0.14285714285714285,1,0.0,0,0,0,0,0,0,0,1,0,0,1,1
5047,69160,Vnhhp2QbBiDiUTTHmXkksXuO8NCNMbjj,A3fsA9Zfv1X2fVEQhTw51lKENdNrEqT3,3,0,0,0,0,0,3,0,3,0.42857142857142855,1,0.0,0,0,0,0,0,0,0,3,0,0,3,1
5048,69163,Oc5qPJBdwZoUrwnszLfpz6LxBxG1LBA2,SpATywNh6bZuzm8s1ceuBUnMUAeoAHHw,1,0,0,0,0,0,1,0,1,0.14285714285714285,1,0.0,0,0,0,0,0,0,0,1,0,0,1,1
5049,69170,RfZCGgQvqSwCxzUkNgQBjxizWHoR00JV,SpATywNh6bZuzm8s1ceuBUnMUAeoAHHw,1,0,0,0,0,0,1,0,1,0.14285714285714285,1,0.0,0,0,0,0,0,0,0,1,0,0,1,1
5050,69172,g2ieOC0GwkKqaZWeJNXowTArkXtXRKC6,SpATywNh6bZuzm8s1ceuBUnMUAeoAHHw,1,0,0,0,0,0,2,0,2,0.2857142857142857,2,0.0,0,0,0,0,0,0,0,2,0,0,2,0
5051,69179,WX5bge9EFbPypYuObEiSD1Gyvh8Z866G,A3fsA9Zfv1X2fVEQhTw51lKENdNrEqT3,10,12,5,0,3,0,6,0,26,3.7142857142857144,3,0.0,0,5,0,3,12,0,0,6,0,8,18,1
5052,69184,2qz1ezmlR3R3fKwgJceAEHpik5SGv87j,SpATywNh6bZuzm8s1ceuBUnMUAeoAHHw,1,0,0,0,0,0,1,0,1,0.14285714285714285,1,0.0,0,0,0,0,0,0,0,1,0,0,1,1
5053,69193,R8klv9uflG5co96NLU45hbr8n54FLcZh,SpATywNh6bZuzm8s1ceuBUnMUAeoAHHw,1,0,0,0,0,0,1,0,1,0.14285714285714285,1,0.0,0,0,0,0,0,0,0,1,0,0,1,1
5054,69194,pngME6c5Y6LdP7X9v20FCeYjZ97OMCQR,SpATywNh6bZuzm8s1ceuBUnMUAeoAHHw,11,7,1,11,0,1,4,1,25,3.5714285714285716,1,0.0,2,1,10,0,5,1,1,4,1,13,12,1
5055,69199,CpruMjpYp2wLmRpTC4dJZ8iwMDhltzag,RXDvfPUBYFlVdlueBFbLW0mhhAyGEqpt,1,0,0,0,0,0,1,0,1,0.14285714285714285,1,0.0,0,0,0,0,0,0,0,1,0,0,1,1
5056,69213,WX5bge9EFbPypYuObEiSD1Gyvh8Z866G,bWdj2GDclj5ofokWjzoa5jAwMkxCykd6,9,4,2,12,2,0,2,0,22,3.142857142857143,1,0.0,1,2,11,2,3,0,1,2,0,16,6,0
5057,69218,YZJnbvfbnhVRirLqDRHGzQv4606Wu6TO,bWdj2GDclj5ofokWjzoa5jAwMkxCykd6,9,13,8,0,5,2,6,1,35,5.0,3,0.0,2,8,0,5,11,2,0,6,1,15,20,1
5058,69224,65ggrHSAXoVCOK75IinKW9i4EJF8EDcN,SpATywNh6bZuzm8s1ceuBUnMUAeoAHHw,6,3,1,0,1,0,2,0,7,1.0,1,0.0,0,1,0,1,3,0,0,2,0,2,5,1
5059,69233,W8K4VS8rPvnPTNUJrqgtS2FKH93KmR91,A3fsA9Zfv1X2fVEQhTw51lKENdNrEqT3,70,86,43,194,17,3,18,0,361,51.57142857142857,7,0.0,2,43,166,17,84,3,28,18,0,228,133,1
5060,69258,8O10QoLvReRhqOHRxozXCjfp01CP9Y6X,RXDvfPUBYFlVdlueBFbLW0mhhAyGEqpt,5,2,1,0,1,0,2,0,6,0.8571428571428571,1,0.0,0,1,0,1,2,0,0,2,0,2,4,1
5061,69261,Y0yiSfPX9V0A8oNPfdzCuT5yHRuHvSj6,SpATywNh6bZuzm8s1ceuBUnMUAeoAHHw,12,8,6,0,3,0,4,1,22,3.142857142857143,2,0.0,0,6,0,3,8,0,0,4,1,9,13,1
5062,69262,X9IKf8GgqS6dvoKX3VBo51mIr8yb4uFC,A3fsA9Zfv1X2fVEQhTw51lKENdNrEqT3,63,88,37,54,23,5,20,5,232,33.142857142857146,3,0.0,9,37,51,23,79,5,3,20,5,120,112,1
5063,69266,ZutC6FPMJvnUSI7oc7F8Om4NpwtKuyEH,SpATywNh6bZuzm8s1ceuBUnMUAeoAHHw,8,5,2,0,2,0,3,0,12,1.7142857142857142,1,0.0,0,2,0,2,5,0,0,3,0,4,8,1
5064,69270,2XqSSCGvWuNVBTm3MCFePDMOSuloLKPQ,SpATywNh6bZuzm8s1ceuBUnMUAeoAHHw,8,4,1,0,1,3,4,0,13,1.8571428571428572,4,0.0,0,1,0,1,4,3,0,4,0,2,11,1
5065,69273,61kObDGseAVKKKJnoykLCdN2clfrzPTZ,SpATywNh6bZuzm8s1ceuBUnMUAeoAHHw,20,26,10,16,8,0,5,0,65,9.285714285714286,2,0.0,6,10,13,8,20,0,3,5,0,37,28,1
5066,69279,HKRHFribtFXCazZMADj8ySc6wcBJmS1L,A3fsA9Zfv1X2fVEQhTw51lKENdNrEqT3,10,4,3,0,2,1,6,0,16,2.2857142857142856,1,0.0,0,3,0,2,4,1,0,6,0,5,11,1
5067,69295,NGQ6HXbhxwBlJxikVxca5noX2u8xI9AV,bWdj2GDclj5ofokWjzoa5jAwMkxCykd6,17,17,7,50,10,0,1,0,85,12.142857142857142,1,0.0,9,7,43,10,8,0,7,1,0,69,16,0
5068,69304,JR238GZjZ1ruNiJtwVaWypz6LFnrEv5m,A3fsA9Zfv1X2fVEQhTw51lKENdNrEqT3,10,10,5,0,0,1,19,1,36,5.142857142857143,3,0.0,0,5,0,0,10,1,0,19,1,5,31,1
5069,69305,1RaxWRR42BzbDLa8H5HkFu4x9YPe7T0C,A3fsA9Zfv1X2fVEQhTw51lKENdNrEqT3,9,4,2,0,2,0,6,0,14,2.0,1,0.0,1,2,0,2,3,0,0,6,0,5,9,1
5070,69313,JZ8D07WpMQUIA2O2a3f2Q2gV7h70rqbC,SpATywNh6bZuzm8s1ceuBUnMUAeoAHHw,15,22,11,8,6,32,7,0,86,12.285714285714286,4,0.0,7,11,7,6,15,32,1,7,0,31,55,1
5071,69343,hSBgpCIALinoasvGugUi15XiQqzIP0W5,SpATywNh6bZuzm8s1ceuBUnMUAeoAHHw,11,34,10,0,6,1,16,0,67,9.571428571428571,2,0.0,0,10,0,6,34,1,0,16,0,16,51,1
5072,69344,mAEhdvjtLD2ESiLI6ko7GgTTKTJ1f5Tn,SpATywNh6bZuzm8s1ceuBUnMUAeoAHHw,12,46,13,15,1,5,6,1,87,12.428571428571429,2,0.0,29,13,13,1,17,5,2,6,1,56,31,1
5073,69346,4G8hhK38eDoUtZ2viIFKnYiWqmC4nF56,SpATywNh6bZuzm8s1ceuBUnMUAeoAHHw,19,38,3,10,0,0,6,0,57,8.142857142857142,3,0.0,16,3,10,0,22,0,0,6,0,29,28,1
5074,69347,mhllqKKDFjXI3RWMG7mLE4M16FOLrFxr,SpATywNh6bZuzm8s1ceuBUnMUAeoAHHw,4,3,1,0,1,1,1,0,7,1.0,1,0.0,0,1,0,1,3,1,0,1,0,2,5,1
5075,69364,4cOOYrtQdvpiZuIPnsoBt4lhRdbqEcsp,SpATywNh6bZuzm8s1ceuBUnMUAeoAHHw,13,13,0,12,0,0,3,0,28,4.0,2,0.0,5,0,12,0,8,0,0,3,0,17,11,1
5076,69369,uMEUDlZ1tL8WoZ2EmL0CStSYwA0zOal8,bWdj2GDclj5ofokWjzoa5jAwMkxCykd6,10,6,3,8,2,0,5,0,24,3.4285714285714284,2,0.0,1,3,8,2,5,0,0,5,0,14,10,1
5077,69370,YsoUugdKj0wstrontIOHZ151jgNGqxCe,G8EPVSXsOYB5YQWZGiz1aVq5Pgr2GrQu,8,6,3,0,2,0,3,0,14,2.0,2,0.0,0,3,0,2,6,0,0,3,0,5,9,1
5078,69386,yeibveOoJwlHHcJycB6lhQvIP04mhNkZ,SpATywNh6bZuzm8s1ceuBUnMUAeoAHHw,7,11,0,0,0,0,1,0,12,1.7142857142857142,1,0.0,1,0,0,0,10,0,0,1,0,1,11,1
5079,69392,TmRAKP6Cldz70hzdom0pqdRRs9qbBLvD,SpATywNh6bZuzm8s1ceuBUnMUAeoAHHw,4,1,0,0,0,0,3,0,4,0.5714285714285714,1,0.0,0,0,0,0,1,0,0,3,0,0,4,1
5080,69404,EB2RCe088gjmT7cbJrt6urBwZOusH5vg,SpATywNh6bZuzm8s1ceuBUnMUAeoAHHw,24,46,23,27,11,0,9,0,116,16.571428571428573,3,0.0,15,23,24,11,31,0,3,9,0,73,43,1
5081,69407,cpYO1CIRym9qUpCwm4jnjZ21HfSKew1t,SpATywNh6bZuzm8s1ceuBUnMUAeoAHHw,20,26,1,15,1,4,14,1,62,8.857142857142858,2,0.0,9,1,15,1,17,4,0,14,1,26,36,1
5082,69418,Wb7djzeQ8T0CrP6nbbq8WdqHClynqFRu,SpATywNh6bZuzm8s1ceuBUnMUAeoAHHw,1,0,0,0,0,0,1,0,1,0.14285714285714285,1,0.0,0,0,0,0,0,0,0,1,0,0,1,1
5083,69422,1taO8BWZHffh7l7BaqgWcQJY3gQ1z1ac,A3fsA9Zfv1X2fVEQhTw51lKENdNrEqT3,5,0,0,0,0,0,5,1,6,0.8571428571428571,1,0.0,0,0,0,0,0,0,0,5,1,0,6,1
5084,69426,2iC0lVJQRHLawEI3r58K4Wl79T69zQyN,G8EPVSXsOYB5YQWZGiz1aVq5Pgr2GrQu,6,4,0,0,0,2,6,0,12,1.7142857142857142,1,0.0,0,0,0,0,4,2,0,6,0,0,12,1
5085,69435,vPqhvdjrX3GgCAjq6K96tYCv7DiMTBkh,SpATywNh6bZuzm8s1ceuBUnMUAeoAHHw,23,44,1,20,1,0,11,0,77,11.0,4,0.0,10,1,19,1,34,0,1,11,0,31,46,0
5086,69437,tHPSGx00vsFzhzr0zwBlWWarqJT4wPHF,bWdj2GDclj5ofokWjzoa5jAwMkxCykd6,18,17,11,36,7,0,3,0,74,10.571428571428571,3,0.0,3,11,35,7,14,0,1,3,0,56,18,1
5087,69438,QDpN8D19Mr8RZumTONWpZNlCWcHCCTbH,SpATywNh6bZuzm8s1ceuBUnMUAeoAHHw,5,5,1,0,0,0,2,0,8,1.1428571428571428,2,0.0,0,1,0,0,5,0,0,2,0,1,7,1
5088,69439,WELjmgdsP962Pc1teJ96xvofKraKe6qa,A3fsA9Zfv1X2fVEQhTw51lKENdNrEqT3,29,29,20,30,12,36,28,4,159,22.714285714285715,7,0.0,0,20,28,12,29,36,2,28,4,60,99,1
5089,69443,JnRbwXg3XGYAmOXQP1OiJxv44LsKYQS5,SpATywNh6bZuzm8s1ceuBUnMUAeoAHHw,21,26,1,26,1,5,11,1,71,10.142857142857142,4,0.0,7,1,23,1,19,5,3,11,1,32,39,0
5090,69444,sfdgnQL9ZJy8iQoJsTh6pz33V1sjsZlD,A3fsA9Zfv1X2fVEQhTw51lKENdNrEqT3,32,26,20,0,13,0,10,0,69,9.857142857142858,3,0.0,0,20,0,13,26,0,0,10,0,33,36,0
5091,69452,30KFUYZeibWx0Iky00wqYaxS7YWNwWx4,SpATywNh6bZuzm8s1ceuBUnMUAeoAHHw,5,5,2,0,1,0,1,0,9,1.2857142857142858,1,0.0,0,2,0,1,5,0,0,1,0,3,6,1
5092,69466,DcPL5Zur8S33yRX2fv1HxqidGklhFV5P,SpATywNh6bZuzm8s1ceuBUnMUAeoAHHw,22,34,17,18,7,2,10,1,89,12.714285714285714,3,0.0,9,17,15,7,25,2,3,10,1,48,41,1
5093,69471,x9up4wvnaS79M9udGA7fqhv1sigb86bK,SpATywNh6bZuzm8s1ceuBUnMUAeoAHHw,8,7,4,0,2,3,4,0,20,2.857142857142857,2,0.0,0,4,0,2,7,3,0,4,0,6,14,1
5094,69477,FlAkKX6ow9SvOzk0dTWPWgnX5766zY29,G8EPVSXsOYB5YQWZGiz1aVq5Pgr2GrQu,26,36,17,32,11,0,4,0,100,14.285714285714286,3,0.0,5,17,27,11,31,0,5,4,0,60,40,0
5095,69478,8tkFlxYnls5Mxd2ekCeWIpaKuJe1mR6W,G8EPVSXsOYB5YQWZGiz1aVq5Pgr2GrQu,19,25,8,12,8,4,6,1,64,9.142857142857142,1,0.0,15,8,7,8,10,4,5,6,1,38,26,1
5096,69499,oG7qUH6PFRXdknLnOhOWneHPtBW8Ta2o,A3fsA9Zfv1X2fVEQhTw51lKENdNrEqT3,3,0,0,0,0,0,3,0,3,0.42857142857142855,1,0.0,0,0,0,0,0,0,0,3,0,0,3,0
5097,69500,pNxcbeMWYcUZBxJCtPF9qmCQyBYd1bU7,SpATywNh6bZuzm8s1ceuBUnMUAeoAHHw,29,40,20,32,9,2,14,0,117,16.714285714285715,4,0.0,14,20,30,9,26,2,2,14,0,73,44,1
5098,69536,F6yoJDYdOCdZg3HrTm4YkvnDfcsvPtnN,SpATywNh6bZuzm8s1ceuBUnMUAeoAHHw,7,6,3,0,2,0,1,0,12,1.7142857142857142,1,0.0,0,3,0,2,6,0,0,1,0,5,7,1
5099,69538,RCYov8DEPqszWUDtrunbywhn5eFESjlB,SpATywNh6bZuzm8s1ceuBUnMUAeoAHHw,16,22,8,9,5,7,5,1,57,8.142857142857142,1,0.0,9,8,9,5,13,7,0,5,1,31,26,1
5100,69540,a160ewxyRJdtN45GnX3uGxkLMyeZKvV7,bWdj2GDclj5ofokWjzoa5jAwMkxCykd6,13,20,10,84,5,7,13,2,141,20.142857142857142,2,0.0,4,10,82,5,16,7,2,13,2,101,40,1
5101,69543,ZAi0jAKRdwQEtga2Yygb9adNtNc26TKH,SpATywNh6bZuzm8s1ceuBUnMUAeoAHHw,7,6,3,0,1,0,2,0,12,1.7142857142857142,1,0.0,2,3,0,1,4,0,0,2,0,6,6,1
5102,69548,cjgnRFcpPxhUwluGuMHbhKtpIo8g67oX,SpATywNh6bZuzm8s1ceuBUnMUAeoAHHw,5,2,1,0,1,0,5,0,9,1.2857142857142858,1,0.0,0,1,0,1,2,0,0,5,0,2,7,1
5103,69551,WfPfJn9lrx0nGBfxPbzYzJSQElx0Vya0,A3fsA9Zfv1X2fVEQhTw51lKENdNrEqT3,7,7,6,0,1,0,1,0,15,2.142857142857143,3,0.0,0,6,0,1,7,0,0,1,0,7,8,1
5104,69561,Z4SPpJfwg3kmbYmCX1430X6xnjXFgqan,SpATywNh6bZuzm8s1ceuBUnMUAeoAHHw,1,0,0,0,0,0,1,0,1,0.14285714285714285,1,0.0,0,0,0,0,0,0,0,1,0,0,1,1
5105,69567,q3DUInVVvDGT22ACyMKixODyUkgLOKmI,SpATywNh6bZuzm8s1ceuBUnMUAeoAHHw,18,25,16,13,8,0,5,0,67,9.571428571428571,3,0.0,4,16,13,8,21,0,0,5,0,41,26,1
5106,69577,zdQpZzeZtdBJrKxe0kkh4zz1KUaEeB2I,G8EPVSXsOYB5YQWZGiz1aVq5Pgr2GrQu,21,17,12,22,7,4,3,0,65,9.285714285714286,2,0.0,1,12,18,7,16,4,4,3,0,38,27,1
5107,69583,82WiuHoB3dVqYkf2UKsu9ogC0IsQQnqa,A3fsA9Zfv1X2fVEQhTw51lKENdNrEqT3,5,3,0,0,0,0,3,0,6,0.8571428571428571,1,0.0,0,0,0,0,3,0,0,3,0,0,6,1
5108,69590,aYhMdR5xaez3fr0lBrD6kCxYiCOyculR,SpATywNh6bZuzm8s1ceuBUnMUAeoAHHw,3,0,0,0,0,1,2,0,3,0.42857142857142855,1,0.0,0,0,0,0,0,1,0,2,0,0,3,0
5109,69594,0pQnhOp7TmXmyZJvGFVAPDeo6QapvPWM,SpATywNh6bZuzm8s1ceuBUnMUAeoAHHw,1,0,0,0,0,0,1,0,1,0.14285714285714285,1,0.0,0,0,0,0,0,0,0,1,0,0,1,1
5110,69602,ebvWYER6Bde0EUcNXXIX0vyTB9ur6Kqi,bWdj2GDclj5ofokWjzoa5jAwMkxCykd6,4,4,0,0,0,0,2,0,6,0.8571428571428571,2,0.0,0,0,0,0,4,0,0,2,0,0,6,1
5111,69604,ebvWYER6Bde0EUcNXXIX0vyTB9ur6Kqi,RXDvfPUBYFlVdlueBFbLW0mhhAyGEqpt,11,10,0,0,0,3,10,1,24,3.4285714285714284,2,0.0,1,0,0,0,9,3,0,10,1,1,23,1
5112,69608,luffaRyMH17lmf9lXIITCUvmvLstdhJF,SpATywNh6bZuzm8s1ceuBUnMUAeoAHHw,7,6,1,0,1,0,3,0,11,1.5714285714285714,2,0.0,2,1,0,1,4,0,0,3,0,4,7,1
5113,69609,m6d8SS4M8CUq3BoC3xOyTU0oHsPjDd2w,SpATywNh6bZuzm8s1ceuBUnMUAeoAHHw,4,2,0,0,0,0,2,0,4,0.5714285714285714,1,0.0,0,0,0,0,2,0,0,2,0,0,4,1
5114,69611,nJobBmBuwmDPhO4EIrWUJq110WMVvZw4,SpATywNh6bZuzm8s1ceuBUnMUAeoAHHw,8,4,3,0,2,0,2,0,11,1.5714285714285714,1,0.0,0,3,0,2,4,0,0,2,0,5,6,1
5115,69616,faupOzOQrYnrhUP3CZcXERH5hL8Q3xd2,SpATywNh6bZuzm8s1ceuBUnMUAeoAHHw,18,27,14,10,6,23,7,0,87,12.428571428571429,5,0.0,7,14,10,6,20,23,0,7,0,37,50,1
5116,69638,nkfthsiEhj5rlE8h2UVfSYWZi1i1pvPD,SpATywNh6bZuzm8s1ceuBUnMUAeoAHHw,25,46,15,22,8,2,7,0,100,14.285714285714286,2,0.0,11,15,19,8,35,2,3,7,0,53,47,1
5117,69643,W17GnVDduKqnwPQhc7qvZa9k2VQEwhjA,G8EPVSXsOYB5YQWZGiz1aVq5Pgr2GrQu,5,2,1,0,1,0,2,0,6,0.8571428571428571,1,0.0,0,1,0,1,2,0,0,2,0,2,4,1
5118,69647,tD4YaA9C1jzNLnr7tPBZ897xHEsnzm9F,SpATywNh6bZuzm8s1ceuBUnMUAeoAHHw,1,0,0,0,0,0,1,0,1,0.14285714285714285,1,0.0,0,0,0,0,0,0,0,1,0,0,1,1
5119,69650,tD4YaA9C1jzNLnr7tPBZ897xHEsnzm9F,A3fsA9Zfv1X2fVEQhTw51lKENdNrEqT3,1,0,0,0,0,0,1,0,1,0.14285714285714285,1,0.0,0,0,0,0,0,0,0,1,0,0,1,1
5120,69654,lD3KgUtWok6mjiblbvy163en24cSYNXc,RXDvfPUBYFlVdlueBFbLW0mhhAyGEqpt,1,0,0,0,0,0,1,0,1,0.14285714285714285,1,0.0,0,0,0,0,0,0,0,1,0,0,1,1
5121,69680,tes6smsqnnhtic7mel4he0HOVKxdsIk0,SpATywNh6bZuzm8s1ceuBUnMUAeoAHHw,5,6,3,0,1,0,5,0,15,2.142857142857143,3,0.0,0,3,0,1,6,0,0,5,0,4,11,1
5122,69682,DpqUZKEZpIFvZzvEXk8oaJMRAbEfypNN,A3fsA9Zfv1X2fVEQhTw51lKENdNrEqT3,25,20,15,0,14,0,7,0,56,8.0,2,0.0,2,15,0,14,18,0,0,7,0,31,25,1
5123,69684,jKWIhuXmlYFBIapfd4E50TBTHed3oveP,SpATywNh6bZuzm8s1ceuBUnMUAeoAHHw,16,25,10,12,4,1,4,0,56,8.0,3,0.0,6,10,11,4,19,1,1,4,0,31,25,1
5124,69690,RsnXePogfsPEsPaBIDmu1zOlkZ0nGsJG,SpATywNh6bZuzm8s1ceuBUnMUAeoAHHw,10,14,6,0,5,0,15,0,40,5.714285714285714,3,0.0,2,6,0,5,12,0,0,15,0,13,27,1
5125,69693,Z3XF9lddm62bhylNbOc8gNaNENZtsGVQ,SpATywNh6bZuzm8s1ceuBUnMUAeoAHHw,6,6,2,0,0,0,4,0,12,1.7142857142857142,2,0.0,0,2,0,0,6,0,0,4,0,2,10,1
5126,69697,KCsv9o14hbrQKvzaJVVOUtS9ZXoioMZi,SpATywNh6bZuzm8s1ceuBUnMUAeoAHHw,23,26,16,11,12,0,3,0,68,9.714285714285714,2,0.0,7,16,10,12,19,0,1,3,0,45,23,1
5127,69702,V5MB02xz5am2kHfey21j0yueDNM7JiHU,A3fsA9Zfv1X2fVEQhTw51lKENdNrEqT3,6,3,2,0,2,0,4,0,11,1.5714285714285714,1,0.0,0,2,0,2,3,0,0,4,0,4,7,1
5128,69708,xcD6YWhnGA2xukGmX4eaYrm6VS9ffz1H,RXDvfPUBYFlVdlueBFbLW0mhhAyGEqpt,49,67,28,84,19,3,16,0,217,31.0,3,0.0,28,28,76,19,39,3,8,16,0,151,66,0
5129,69709,HkR8egrosmo3p8vvw0Masj2JRYmaSMRW,bWdj2GDclj5ofokWjzoa5jAwMkxCykd6,3,0,0,0,0,1,6,0,7,1.0,2,0.0,0,0,0,0,0,1,0,6,0,0,7,0
5130,69713,8gwjs0B0kUE7stjGZjvEBczr2cXGTwYJ,SpATywNh6bZuzm8s1ceuBUnMUAeoAHHw,11,7,4,6,1,0,2,0,20,2.857142857142857,2,0.0,2,4,6,1,5,0,0,2,0,13,7,0
5131,69719,o7QNLHma5sLHPf1vf8edH1AxEjwzXjmH,RXDvfPUBYFlVdlueBFbLW0mhhAyGEqpt,4,2,1,0,1,0,1,0,5,0.7142857142857143,1,0.0,0,1,0,1,2,0,0,1,0,2,3,1
5132,69726,MJibuyVypmuBs7BncEuo5i3GOsk8IZAX,SpATywNh6bZuzm8s1ceuBUnMUAeoAHHw,9,5,3,0,1,1,5,0,15,2.142857142857143,1,0.0,0,3,0,1,5,1,0,5,0,4,11,1
5133,69728,RGp0TGYq2GqXU0ffAofLYX0dCiUdIWSh,SpATywNh6bZuzm8s1ceuBUnMUAeoAHHw,9,8,5,0,2,0,6,0,21,3.0,3,0.0,0,5,0,2,8,0,0,6,0,7,14,0
5134,69749,1mwVsEWRdpRYvoqkUN67uGNzTUomXEbQ,G8EPVSXsOYB5YQWZGiz1aVq5Pgr2GrQu,31,58,5,34,4,3,10,0,114,16.285714285714285,3,0.0,2,5,29,4,56,3,5,10,0,40,74,1
5135,69750,LITEXQWwZ0HwbfUIw2ZTJ1Nz80g3xPKl,RXDvfPUBYFlVdlueBFbLW0mhhAyGEqpt,5,4,2,0,1,0,2,0,9,1.2857142857142858,2,0.0,0,2,0,1,4,0,0,2,0,3,6,1
5136,69752,WXX8Za7OuZw2MA7QaLNUhKigQ32JFLJo,SpATywNh6bZuzm8s1ceuBUnMUAeoAHHw,11,10,4,1,3,0,2,0,20,2.857142857142857,1,0.0,5,4,1,3,5,0,0,2,0,13,7,1
5137,69774,NiepHsDkcSMT8UZbqGGY6QXqNiJKeyrC,SpATywNh6bZuzm8s1ceuBUnMUAeoAHHw,6,4,1,0,1,0,3,0,9,1.2857142857142858,1,0.0,0,1,0,1,4,0,0,3,0,2,7,1
5138,69776,P1MYDLvlR6YqACMf13Tb8sFZFVWSr1nZ,bWdj2GDclj5ofokWjzoa5jAwMkxCykd6,7,11,0,0,0,0,11,0,22,3.142857142857143,1,0.0,0,0,0,0,11,0,0,11,0,0,22,1
5139,69777,vljlAhHGhHZt2ciFpy2bQxMoEL2SUwdk,G8EPVSXsOYB5YQWZGiz1aVq5Pgr2GrQu,10,5,1,0,0,2,8,1,17,2.4285714285714284,1,0.0,0,1,0,0,5,2,0,8,1,1,16,1
5140,69783,Nr4xgaqWlp3GY7Luca1HZwWSVTgxpORh,A3fsA9Zfv1X2fVEQhTw51lKENdNrEqT3,24,23,8,47,0,0,2,0,80,11.428571428571429,4,0.0,1,8,46,0,22,0,1,2,0,55,25,0
5141,69792,pmTpzYlO4DcSR3Hjn7J1Go0PaUoezH5E,SpATywNh6bZuzm8s1ceuBUnMUAeoAHHw,6,1,1,0,1,0,3,0,6,0.8571428571428571,1,0.0,0,1,0,1,1,0,0,3,0,2,4,1
5142,69800,kzyt7hO7yEeJxQfXO5XM7Bawq3xoVkTz,SpATywNh6bZuzm8s1ceuBUnMUAeoAHHw,9,6,3,7,1,0,5,0,22,3.142857142857143,2,0.0,2,3,6,1,4,0,1,5,0,12,10,0
5143,69802,2NIeHPnJrY66zbADeGJTptXbk5YYYnSv,G8EPVSXsOYB5YQWZGiz1aVq5Pgr2GrQu,6,3,1,9,0,0,1,0,14,2.0,1,0.0,0,1,7,0,3,0,2,1,0,8,6,1
5144,69807,iysh9174eOcFH0suenSCLNsv1cqN2Oie,A3fsA9Zfv1X2fVEQhTw51lKENdNrEqT3,15,13,5,0,4,0,8,0,30,4.285714285714286,2,0.0,0,5,0,4,13,0,0,8,0,9,21,1
5145,69808,rDR9DQbHi1eXHd28a6bdjn6YaDG8j833,SpATywNh6bZuzm8s1ceuBUnMUAeoAHHw,4,2,1,0,1,0,1,0,5,0.7142857142857143,1,0.0,0,1,0,1,2,0,0,1,0,2,3,1
5146,69809,j7794Az14TTh7tEEmhTpADHq4ipGllnd,SpATywNh6bZuzm8s1ceuBUnMUAeoAHHw,32,68,29,62,9,35,22,1,226,32.285714285714285,8,0.0,28,29,52,9,40,35,10,22,1,118,108,0
5147,69811,RN9YqqNsHa7lmCtbb4sE8JmcbttJklXE,SpATywNh6bZuzm8s1ceuBUnMUAeoAHHw,13,18,3,0,3,31,13,2,70,10.0,3,0.0,0,3,0,3,18,31,0,13,2,6,64,1
5148,69831,LFBaIhK5031yuWJYVNd4qT9zLr1L16XD,A3fsA9Zfv1X2fVEQhTw51lKENdNrEqT3,9,5,3,0,3,0,4,0,15,2.142857142857143,2,0.0,1,3,0,3,4,0,0,4,0,7,8,1
5149,69841,AlFdkAawiX4QZgKaI0ukIeHoMMs579rt,A3fsA9Zfv1X2fVEQhTw51lKENdNrEqT3,1,0,0,0,0,0,1,0,1,0.14285714285714285,1,0.0,0,0,0,0,0,0,0,1,0,0,1,1
5150,69843,yIgziBEY1QeE2VunyvjKVApcpAZz6INk,bWdj2GDclj5ofokWjzoa5jAwMkxCykd6,13,26,13,20,6,7,8,0,80,11.428571428571429,2,0.0,6,13,18,6,20,7,2,8,0,43,37,1
5151,69847,LyDM0yrwn8zKtQsuxEGqFMxdhffaZNVY,SpATywNh6bZuzm8s1ceuBUnMUAeoAHHw,7,7,1,0,1,0,3,0,12,1.7142857142857142,2,0.0,0,1,0,1,7,0,0,3,0,2,10,1
5152,69849,jSFXNgNICT3cTdtFY1qrRx06ncJbHNIL,SpATywNh6bZuzm8s1ceuBUnMUAeoAHHw,31,53,26,32,10,10,22,3,156,22.285714285714285,6,0.0,14,26,27,10,39,10,5,22,3,77,79,0
5153,69852,jGWjfQmpnKrCWFzIMxwjgnePo6w3vCLc,SpATywNh6bZuzm8s1ceuBUnMUAeoAHHw,19,50,24,2,12,4,17,3,112,16.0,6,0.0,16,24,2,12,34,4,0,17,3,54,58,1
5154,69854,vtTIluoXpRIe9zpqEiPikMWtGXSMpuiF,SpATywNh6bZuzm8s1ceuBUnMUAeoAHHw,18,37,12,18,4,1,9,0,81,11.571428571428571,5,0.0,8,12,15,4,29,1,3,9,0,39,42,1
5155,69856,SBz1G9CPNh7b1YKxwzjWQ2S8H7JkEfYW,SpATywNh6bZuzm8s1ceuBUnMUAeoAHHw,21,48,1,27,0,17,6,0,99,14.142857142857142,3,0.0,14,1,24,0,34,17,3,6,0,39,60,0
5156,69861,TgjP3M05p3RMkUJ6UX2DRRlsHiZcIeqm,SpATywNh6bZuzm8s1ceuBUnMUAeoAHHw,17,28,2,15,0,2,7,1,55,7.857142857142857,2,0.0,10,2,12,0,18,2,3,7,1,24,31,1
5157,69877,2eCbk1UbEiqe2btnyk0kQWHxge0iLKhu,SpATywNh6bZuzm8s1ceuBUnMUAeoAHHw,10,4,4,0,4,0,3,0,15,2.142857142857143,1,0.0,0,4,0,4,4,0,0,3,0,8,7,1
5158,69879,T7hyLHRci3AaSKtnxgzZP9PZimkugFag,SpATywNh6bZuzm8s1ceuBUnMUAeoAHHw,25,21,13,16,6,0,12,0,68,9.714285714285714,3,0.0,5,13,16,6,16,0,0,12,0,40,28,1
5159,69886,C89edYjc0egHm9DK0UhG6TICXc3cgfYt,SpATywNh6bZuzm8s1ceuBUnMUAeoAHHw,14,19,11,0,6,2,8,1,47,6.714285714285714,4,0.0,0,11,0,6,19,2,0,8,1,17,30,1
5160,69887,uxXbNZQzMKFVtvkoRDDVyoOZczad3AGk,SpATywNh6bZuzm8s1ceuBUnMUAeoAHHw,5,2,1,0,1,0,3,0,7,1.0,1,0.0,0,1,0,1,2,0,0,3,0,2,5,1
5161,69894,uxXbNZQzMKFVtvkoRDDVyoOZczad3AGk,bWdj2GDclj5ofokWjzoa5jAwMkxCykd6,1,0,0,0,0,0,1,0,1,0.14285714285714285,1,0.0,0,0,0,0,0,0,0,1,0,0,1,1
5162,69896,uxXbNZQzMKFVtvkoRDDVyoOZczad3AGk,A3fsA9Zfv1X2fVEQhTw51lKENdNrEqT3,1,0,0,0,0,0,1,0,1,0.14285714285714285,1,0.0,0,0,0,0,0,0,0,1,0,0,1,1
5163,69913,NMnvuPuFFRZJF8iN4i8wvMDrTjhZSOh9,SpATywNh6bZuzm8s1ceuBUnMUAeoAHHw,20,43,11,9,4,1,9,1,78,11.142857142857142,1,0.0,10,11,9,4,33,1,0,9,1,34,44,1
5164,69924,hF9wzZzzUNXUdemSIRccNUzFWcmYBmRA,SpATywNh6bZuzm8s1ceuBUnMUAeoAHHw,4,2,1,0,1,0,1,0,5,0.7142857142857143,1,0.0,0,1,0,1,2,0,0,1,0,2,3,1
5165,69926,iC67OjDFbVlCchthNt40xrjNGlZz61fX,SpATywNh6bZuzm8s1ceuBUnMUAeoAHHw,2,0,0,0,0,0,4,0,4,0.5714285714285714,2,0.0,0,0,0,0,0,0,0,4,0,0,4,0
5166,69928,VzpntkFDzyOIiXtUxc8LkeciWhAJhdSD,SpATywNh6bZuzm8s1ceuBUnMUAeoAHHw,9,4,3,2,2,0,3,0,14,2.0,2,0.0,0,3,2,2,4,0,0,3,0,7,7,1
5167,69933,GRXlFzfh4xOjZLiMJPGMcltQGlQAKqSw,A3fsA9Zfv1X2fVEQhTw51lKENdNrEqT3,3,2,0,0,0,0,2,0,4,0.5714285714285714,2,0.0,0,0,0,0,2,0,0,2,0,0,4,0
5168,69941,DpqUZKEZpIFvZzvEXk8oaJMRAbEfypNN,SpATywNh6bZuzm8s1ceuBUnMUAeoAHHw,15,11,7,0,7,0,6,0,31,4.428571428571429,1,0.0,2,7,0,7,9,0,0,6,0,16,15,0
5169,69948,lqeVvfv7UmHu5JiyWoTOATw0yL0HJQEo,G8EPVSXsOYB5YQWZGiz1aVq5Pgr2GrQu,1,0,0,0,0,0,1,0,1,0.14285714285714285,1,0.0,0,0,0,0,0,0,0,1,0,0,1,1
5170,69949,jcyADRcnQkvVHllsyVvCCi5Wcx40AoFW,SpATywNh6bZuzm8s1ceuBUnMUAeoAHHw,2,0,0,0,0,0,2,0,2,0.2857142857142857,1,0.0,0,0,0,0,0,0,0,2,0,0,2,1
5171,69961,jcyADRcnQkvVHllsyVvCCi5Wcx40AoFW,A3fsA9Zfv1X2fVEQhTw51lKENdNrEqT3,1,0,0,0,0,0,1,0,1,0.14285714285714285,1,0.0,0,0,0,0,0,0,0,1,0,0,1,1
5172,69973,CabsQjb2Sd2I3ynTdtsErAG67rLex08f,A3fsA9Zfv1X2fVEQhTw51lKENdNrEqT3,2,0,0,0,0,0,2,0,2,0.2857142857142857,1,0.0,0,0,0,0,0,0,0,2,0,0,2,1
5173,69975,xL2GGqHxlfngRtz8ATMPQBFRBvX6HArr,SpATywNh6bZuzm8s1ceuBUnMUAeoAHHw,23,31,17,16,3,21,26,5,119,17.0,4,0.0,8,17,16,3,23,21,0,26,5,44,75,0
5174,69997,viQoPUNtB7SIUiKvJ4gjpMz5oecDT31f,G8EPVSXsOYB5YQWZGiz1aVq5Pgr2GrQu,4,2,1,0,1,0,1,0,5,0.7142857142857143,1,0.0,0,1,0,1,2,0,0,1,0,2,3,1
5175,70006,wBxOvXavxcvDHQtsCbkdt1VRzmB8Qh9E,bWdj2GDclj5ofokWjzoa5jAwMkxCykd6,10,18,9,19,2,3,12,0,63,9.0,4,0.0,2,9,19,2,16,3,0,12,0,32,31,1
5176,70013,Kmxwvn5YFvJ5yFX0GZXEdEhcQGDP2CuP,SpATywNh6bZuzm8s1ceuBUnMUAeoAHHw,4,2,1,0,1,0,1,0,5,0.7142857142857143,1,0.0,0,1,0,1,2,0,0,1,0,2,3,1
5177,70034,J1us9rPcxSTckBHItgnAQKi26DjcRbl6,A3fsA9Zfv1X2fVEQhTw51lKENdNrEqT3,7,3,2,0,2,0,9,0,16,2.2857142857142856,1,0.0,0,2,0,2,3,0,0,9,0,4,12,1
5178,70037,jQGozXgCDEtih8n0QNDjwOxHGubLTjEt,SpATywNh6bZuzm8s1ceuBUnMUAeoAHHw,6,6,4,0,2,0,2,0,14,2.0,1,0.0,0,4,0,2,6,0,0,2,0,6,8,0
5179,70046,J1us9rPcxSTckBHItgnAQKi26DjcRbl6,bWdj2GDclj5ofokWjzoa5jAwMkxCykd6,5,2,1,0,1,0,2,0,6,0.8571428571428571,1,0.0,0,1,0,1,2,0,0,2,0,2,4,1
5180,70048,DbyuNNEIfQSCSjURAYhbFblaR63gfHlU,A3fsA9Zfv1X2fVEQhTw51lKENdNrEqT3,2,0,0,0,0,0,2,0,2,0.2857142857142857,1,0.0,0,0,0,0,0,0,0,2,0,0,2,1
5181,70049,DbyuNNEIfQSCSjURAYhbFblaR63gfHlU,bWdj2GDclj5ofokWjzoa5jAwMkxCykd6,7,5,1,24,2,0,4,0,36,5.142857142857143,2,0.0,3,1,23,2,2,0,1,4,0,29,7,1
5182,70050,hcNcs1eHZusVH4vyoLl8j9zdN7CZ6Lcy,SpATywNh6bZuzm8s1ceuBUnMUAeoAHHw,24,20,16,12,12,0,5,0,65,9.285714285714286,2,0.0,2,16,10,12,18,0,2,5,0,40,25,1
5183,70063,EJgYYp7MOTUbdsSUr6xoQChx0uLQ5Tys,SpATywNh6bZuzm8s1ceuBUnMUAeoAHHw,7,3,2,0,2,0,2,0,9,1.2857142857142858,1,0.0,0,2,0,2,3,0,0,2,0,4,5,1
5184,70070,nzxk9UvHRiwkN6SIsgPzgRjDaGaCgQRa,bWdj2GDclj5ofokWjzoa5jAwMkxCykd6,1,0,0,0,0,0,1,0,1,0.14285714285714285,1,0.0,0,0,0,0,0,0,0,1,0,0,1,1
5185,70101,vYeGcWGAJP4B8Lvbjdr2jkY9NnpHN8xb,bWdj2GDclj5ofokWjzoa5jAwMkxCykd6,1,0,0,0,0,0,1,0,1,0.14285714285714285,1,0.0,0,0,0,0,0,0,0,1,0,0,1,1
5186,70108,JaY583iEzhUh1H375yAqlbYi0f6zdDLM,SpATywNh6bZuzm8s1ceuBUnMUAeoAHHw,4,3,0,0,0,0,2,0,5,0.7142857142857143,1,0.0,1,0,0,0,2,0,0,2,0,1,4,1
5187,70109,w1PJeTTskG2DF1TtLUpuz9MkqxNdq5EB,SpATywNh6bZuzm8s1ceuBUnMUAeoAHHw,6,8,2,0,2,0,3,0,15,2.142857142857143,2,0.0,0,2,0,2,8,0,0,3,0,4,11,1
5188,70119,NXyco71N78GkVfHnZsK8R307XzQzXNS1,SpATywNh6bZuzm8s1ceuBUnMUAeoAHHw,18,27,12,8,4,0,2,0,53,7.571428571428571,4,0.0,7,12,7,4,20,0,1,2,0,30,23,0
5189,70122,68BjCXfBFqeZ01fFx1csrFmvef5xs0w2,G8EPVSXsOYB5YQWZGiz1aVq5Pgr2GrQu,33,47,28,8,14,31,10,0,138,19.714285714285715,6,0.0,8,28,5,14,39,31,3,10,0,55,83,1
5190,70132,rSEfJyHxNlxmmbC9ORIbqcFKKq08QDrh,A3fsA9Zfv1X2fVEQhTw51lKENdNrEqT3,7,5,2,0,2,14,3,0,26,3.7142857142857144,2,0.0,0,2,0,2,5,14,0,3,0,4,22,1
5191,70137,DyZ33FUAQ083lF7iqwpOMtJVUGHaWBxJ,SpATywNh6bZuzm8s1ceuBUnMUAeoAHHw,1,0,0,0,0,0,1,0,1,0.14285714285714285,1,0.0,0,0,0,0,0,0,0,1,0,0,1,1
5192,70139,j4hecXKY3USBQpRwMuzKA9d9SPzBKhRY,bWdj2GDclj5ofokWjzoa5jAwMkxCykd6,22,21,12,0,8,9,11,0,61,8.714285714285714,3,0.0,0,12,0,8,21,9,0,11,0,20,41,1
5193,70147,YlInwW32qLdS6CieoVgP5nZzRZh7iEhb,A3fsA9Zfv1X2fVEQhTw51lKENdNrEqT3,11,16,8,0,5,0,4,0,33,4.714285714285714,2,0.0,0,8,0,5,16,0,0,4,0,13,20,1
5194,70151,Zn9SLiwLflmw7DD6LFx0hGPxPjMJmhLJ,SpATywNh6bZuzm8s1ceuBUnMUAeoAHHw,1,0,0,0,0,0,1,0,1,0.14285714285714285,1,0.0,0,0,0,0,0,0,0,1,0,0,1,1
5195,70163,wykDdjB45pC3zZUNNLpkNXDJGEatsGFp,RXDvfPUBYFlVdlueBFbLW0mhhAyGEqpt,1,0,0,0,0,0,1,0,1,0.14285714285714285,1,0.0,0,0,0,0,0,0,0,1,0,0,1,1
5196,70363,u2uyYrsZ1NxMBxwWaoB6Ro03rTqsVsmy,fbPkOYLVPtPgIt0MxizjfFJov3JbHyAi,9,6,4,0,1,1,18,2,32,4.571428571428571,1,0.0,0,4,0,1,6,1,0,18,2,5,27,1
5197,70365,p48vWUMspFuVCwMv8mYFsyaHTRvcpcL8,fbPkOYLVPtPgIt0MxizjfFJov3JbHyAi,7,10,5,0,2,0,7,0,24,3.4285714285714284,1,0.0,0,5,0,2,10,0,0,7,0,7,17,1
5198,70368,4AzWdcwb3SG5chIViRUSkI6mbhUE2J75,fbPkOYLVPtPgIt0MxizjfFJov3JbHyAi,42,96,53,0,35,2,19,1,206,29.428571428571427,9,0.0,2,53,0,35,94,2,0,19,1,90,116,1
5199,70371,kC7JLQowN0BSKnzXXKRn5vuXi1nnM0dA,fbPkOYLVPtPgIt0MxizjfFJov3JbHyAi,14,16,13,0,10,0,3,0,42,6.0,3,0.0,0,13,0,10,16,0,0,3,0,23,19,1
5200,70372,FQa7FML2dxClmAhYk6OVYx2GHs5nEEVz,fbPkOYLVPtPgIt0MxizjfFJov3JbHyAi,11,15,5,0,3,0,4,0,27,3.857142857142857,1,0.0,0,5,0,3,15,0,0,4,0,8,19,1
5201,70373,cX0P9gUHB3WzWCloaI5EOvK7S6ZZ4sV6,fbPkOYLVPtPgIt0MxizjfFJov3JbHyAi,1,0,0,0,0,0,1,0,1,0.14285714285714285,1,0.0,0,0,0,0,0,0,0,1,0,0,1,1
5202,70375,0U0tIMU8GJAaJuwFbrHTH59SwJZ2uGnq,fbPkOYLVPtPgIt0MxizjfFJov3JbHyAi,5,2,1,0,1,0,2,0,6,0.8571428571428571,1,0.0,0,1,0,1,2,0,0,2,0,2,4,1
5203,70376,61PsrnqGMh19xjWowe2Lz8ELqYCTUUqE,fbPkOYLVPtPgIt0MxizjfFJov3JbHyAi,55,180,94,68,13,42,55,6,458,65.42857142857143,16,0.0,46,94,58,13,134,42,10,55,6,211,247,0
5204,70377,F1rdosKmYTZ6HBhTBGWJEe9EBJKQd8S8,fbPkOYLVPtPgIt0MxizjfFJov3JbHyAi,8,9,6,0,4,4,4,0,27,3.857142857142857,1,0.0,1,6,0,4,8,4,0,4,0,11,16,1
5205,70378,msjMVm4wh7wQYNgRDY7af8l1AlP1idBu,fbPkOYLVPtPgIt0MxizjfFJov3JbHyAi,13,6,3,9,3,0,4,0,25,3.5714285714285716,1,0.0,2,3,7,3,4,0,2,4,0,15,10,1
5206,70379,XjdksOkSKZrf2p0cWebK5cufRcdWg90c,fbPkOYLVPtPgIt0MxizjfFJov3JbHyAi,7,7,2,0,3,0,2,0,14,2.0,1,0.0,4,2,0,3,3,0,0,2,0,9,5,1
5207,70381,i67qzouvUD7nINgK6d1xrH4pvufZqbFd,fbPkOYLVPtPgIt0MxizjfFJov3JbHyAi,4,2,1,0,1,0,1,0,5,0.7142857142857143,1,0.0,0,1,0,1,2,0,0,1,0,2,3,1
5208,70384,QJS32fOTs325a0GlAhy998Sct293VriJ,fbPkOYLVPtPgIt0MxizjfFJov3JbHyAi,8,2,1,0,1,0,8,1,13,1.8571428571428572,1,0.0,0,1,0,1,2,0,0,8,1,2,11,1
5209,70385,BQwPjuIfQmrx5lpYZY3tsAMsirLTrL44,fbPkOYLVPtPgIt0MxizjfFJov3JbHyAi,9,4,3,0,3,0,2,0,12,1.7142857142857142,1,0.0,0,3,0,3,4,0,0,2,0,6,6,1
5210,70388,3VWYOIqoNbquvkyiG0UxiMd0Ny2ffzYn,fbPkOYLVPtPgIt0MxizjfFJov3JbHyAi,1,0,0,0,0,0,1,0,1,0.14285714285714285,1,0.0,0,0,0,0,0,0,0,1,0,0,1,1
5211,70389,AHPbZNsGkOJLnomSDr66Lsr56SzydeZ9,fbPkOYLVPtPgIt0MxizjfFJov3JbHyAi,4,0,0,0,0,0,4,0,4,0.5714285714285714,1,0.0,0,0,0,0,0,0,0,4,0,0,4,1
5212,70390,CZolsxTOSFE94rXDRXRTcZmeVsLJ3JH7,fbPkOYLVPtPgIt0MxizjfFJov3JbHyAi,20,13,10,0,8,0,4,0,35,5.0,3,0.0,0,10,0,8,13,0,0,4,0,18,17,1
5213,70391,33mJ0RGBAyjE4CKOfiTALYWXunuMDP86,fbPkOYLVPtPgIt0MxizjfFJov3JbHyAi,9,5,3,0,2,0,6,0,16,2.2857142857142856,1,0.0,0,3,0,2,5,0,0,6,0,5,11,1
5214,70392,RObsRvS6ivBKFOxQvJXBp0LqecTCcxns,fbPkOYLVPtPgIt0MxizjfFJov3JbHyAi,5,3,1,0,1,3,5,0,13,1.8571428571428572,2,0.0,0,1,0,1,3,3,0,5,0,2,11,1
5215,70393,NRRB20JWU11ewowP1RJ7HD6jBKqLT3DC,fbPkOYLVPtPgIt0MxizjfFJov3JbHyAi,1,0,0,0,0,0,1,0,1,0.14285714285714285,1,0.0,0,0,0,0,0,0,0,1,0,0,1,1
5216,70394,jVBLsQocjzyX8TfhIQuGcF0tRTsZU0fl,fbPkOYLVPtPgIt0MxizjfFJov3JbHyAi,8,8,4,0,3,0,4,0,19,2.7142857142857144,2,0.0,1,4,0,3,7,0,0,4,0,8,11,1
5217,70395,e0E9n0HmHiD7GloTGo5pwSGRifRse0is,fbPkOYLVPtPgIt0MxizjfFJov3JbHyAi,1,0,0,0,0,0,1,0,1,0.14285714285714285,1,0.0,0,0,0,0,0,0,0,1,0,0,1,1
5218,70396,WxiMfvuIhzGtTOKN3rfExm4cBAegUNmS,fbPkOYLVPtPgIt0MxizjfFJov3JbHyAi,4,0,0,0,0,1,7,0,8,1.1428571428571428,1,0.0,0,0,0,0,0,1,0,7,0,0,8,1
5219,70397,1CMLhtavMvC0VlqRyCT3yzXnyLuHWoin,fbPkOYLVPtPgIt0MxizjfFJov3JbHyAi,7,8,4,0,2,0,4,0,18,2.5714285714285716,1,0.0,0,4,0,2,8,0,0,4,0,6,12,1
5220,70398,ZDwBma59xbolXq5GHAmKUUQnUT2REqrt,fbPkOYLVPtPgIt0MxizjfFJov3JbHyAi,1,0,0,0,0,0,1,0,1,0.14285714285714285,1,0.0,0,0,0,0,0,0,0,1,0,0,1,1
5221,70399,MjMfsXNTnm5lSVaPE42HKPGjEP4JdYyv,fbPkOYLVPtPgIt0MxizjfFJov3JbHyAi,11,5,2,8,2,0,6,1,24,3.4285714285714284,1,0.0,1,2,6,2,4,0,2,6,1,11,13,1
5222,70400,SdUI7MFv1cY1lGHTqsLRYstBYRI0xIIR,fbPkOYLVPtPgIt0MxizjfFJov3JbHyAi,17,21,14,10,7,2,5,0,59,8.428571428571429,2,0.0,5,14,8,7,16,2,2,5,0,34,25,1
5223,70401,Fnv71uLEZTKv4jXhwN4OiZMjnP26bZSP,fbPkOYLVPtPgIt0MxizjfFJov3JbHyAi,3,0,0,0,0,0,5,0,5,0.7142857142857143,1,0.0,0,0,0,0,0,0,0,5,0,0,5,1
5224,70404,8ZhpSkXuKXWxDMEbryu3zVTkh7o5swmt,fbPkOYLVPtPgIt0MxizjfFJov3JbHyAi,1,0,0,0,0,0,1,0,1,0.14285714285714285,1,0.0,0,0,0,0,0,0,0,1,0,0,1,1
5225,70406,6Ozqfp4jaBSg7FmT8HpyXWJDqKSyAP5W,fbPkOYLVPtPgIt0MxizjfFJov3JbHyAi,2,0,0,0,0,0,2,0,2,0.2857142857142857,1,0.0,0,0,0,0,0,0,0,2,0,0,2,1
5226,70407,2G7A4QoutYqsQhCEpYdHlicpDLnRQDr3,fbPkOYLVPtPgIt0MxizjfFJov3JbHyAi,2,0,0,0,0,0,2,0,2,0.2857142857142857,1,0.0,0,0,0,0,0,0,0,2,0,0,2,1
5227,70409,rmhIiBxDtXLZVL14b2QxLmm4nyg5Vaki,fbPkOYLVPtPgIt0MxizjfFJov3JbHyAi,1,0,0,0,0,0,1,0,1,0.14285714285714285,1,0.0,0,0,0,0,0,0,0,1,0,0,1,1
5228,70410,XRUsgF0CDtpOGrnGNBjxKyyDO6IoyuZv,fbPkOYLVPtPgIt0MxizjfFJov3JbHyAi,1,0,0,0,0,0,1,0,1,0.14285714285714285,1,0.0,0,0,0,0,0,0,0,1,0,0,1,1
5229,70412,HJDBhocphGBunDu6wRNi5xUX9mlf7tO8,fbPkOYLVPtPgIt0MxizjfFJov3JbHyAi,26,44,16,23,14,0,7,0,104,14.857142857142858,2,0.0,14,16,20,14,30,0,3,7,0,64,40,1
5230,70414,DxcYMrQ21AStjf17HASizKXEPVvKuUI9,fbPkOYLVPtPgIt0MxizjfFJov3JbHyAi,10,6,1,0,0,2,7,1,17,2.4285714285714284,1,0.0,0,1,0,0,6,2,0,7,1,1,16,1
5231,70419,SDT3ZftpiolwjTigpC58j5o0ZRUhDG2F,fbPkOYLVPtPgIt0MxizjfFJov3JbHyAi,12,12,5,5,6,12,3,0,43,6.142857142857143,1,0.0,5,5,4,6,7,12,1,3,0,20,23,1
5232,70423,LBz8eebDA0q3o7gWfqXlzvsHwwqTUJzd,fbPkOYLVPtPgIt0MxizjfFJov3JbHyAi,14,15,7,4,3,0,8,1,38,5.428571428571429,2,0.0,5,7,3,3,10,0,1,8,1,18,20,1
5233,70424,umLfDUbxjnrT5PppK2cJ5eTNtkgpa74K,fbPkOYLVPtPgIt0MxizjfFJov3JbHyAi,1,0,0,0,0,0,1,0,1,0.14285714285714285,1,0.0,0,0,0,0,0,0,0,1,0,0,1,1
5234,70427,xlOz0HV4EOx3YcSKdziNkU6Tif0rYjnx,fbPkOYLVPtPgIt0MxizjfFJov3JbHyAi,6,8,5,0,3,0,5,0,21,3.0,3,0.0,0,5,0,3,8,0,0,5,0,8,13,1
5235,70428,XuNpmX60qMeqTMm6loZLPt3hrjsNO9oc,fbPkOYLVPtPgIt0MxizjfFJov3JbHyAi,5,2,1,0,1,0,2,0,6,0.8571428571428571,1,0.0,0,1,0,1,2,0,0,2,0,2,4,1
5236,70429,ndJjad3g9fi4m3MaVbqG9HoSdy5NpmWc,fbPkOYLVPtPgIt0MxizjfFJov3JbHyAi,5,2,1,0,1,0,2,0,6,0.8571428571428571,1,0.0,0,1,0,1,2,0,0,2,0,2,4,1
5237,70431,2g8zxwHmn0vyZ27TucfkG6P7s8LClDHy,fbPkOYLVPtPgIt0MxizjfFJov3JbHyAi,2,0,0,0,0,0,2,0,2,0.2857142857142857,1,0.0,0,0,0,0,0,0,0,2,0,0,2,1
5238,70433,guAAb9ckvAjdsS0lv2pnwyDARfevxUzH,fbPkOYLVPtPgIt0MxizjfFJov3JbHyAi,6,3,2,0,2,0,1,0,8,1.1428571428571428,1,0.0,0,2,0,2,3,0,0,1,0,4,4,1
5239,70434,lSCJ8ylZ5PCl7TN61VRBQOeN1dbHBCKj,fbPkOYLVPtPgIt0MxizjfFJov3JbHyAi,7,5,3,0,3,0,2,0,13,1.8571428571428572,2,0.0,0,3,0,3,5,0,0,2,0,6,7,1
5240,70435,bexdM93ug7d9XS96XYNBLrki1Em3eYQu,fbPkOYLVPtPgIt0MxizjfFJov3JbHyAi,1,0,0,0,0,0,1,0,1,0.14285714285714285,1,0.0,0,0,0,0,0,0,0,1,0,0,1,1
5241,70436,5tNddvEPZ6adptKjdq6L9gHvDOUDmliH,fbPkOYLVPtPgIt0MxizjfFJov3JbHyAi,7,10,2,0,2,0,2,0,16,2.2857142857142856,1,0.0,5,2,0,2,5,0,0,2,0,9,7,1
5242,70437,zlHnyn2o1Q4DVHdUqyCbAWLuHmOKttM3,fbPkOYLVPtPgIt0MxizjfFJov3JbHyAi,1,0,0,0,0,0,1,0,1,0.14285714285714285,1,0.0,0,0,0,0,0,0,0,1,0,0,1,1
5243,70438,TcuUuOMUA0rnssmvuX7CLScapgs7yDzA,fbPkOYLVPtPgIt0MxizjfFJov3JbHyAi,9,6,2,0,1,0,4,1,14,2.0,1,0.0,0,2,0,1,6,0,0,4,1,3,11,1
5244,70439,qgV0HNJ9ICkZ7TcoJUGdc2JSSqNGtGZ7,fbPkOYLVPtPgIt0MxizjfFJov3JbHyAi,8,10,6,5,4,0,3,0,28,4.0,1,0.0,3,6,4,4,7,0,1,3,0,17,11,1
5245,70441,a4heGNfxWtaNpzRnv4l5t37neKjFR36r,fbPkOYLVPtPgIt0MxizjfFJov3JbHyAi,6,2,0,0,0,0,5,1,8,1.1428571428571428,1,0.0,0,0,0,0,2,0,0,5,1,0,8,1
5246,70445,jJnHLWNDobnCPy5FiRkgK6gW3VoeZNER,fbPkOYLVPtPgIt0MxizjfFJov3JbHyAi,12,6,5,0,4,10,3,0,28,4.0,1,0.0,0,5,0,4,6,10,0,3,0,9,19,1
5247,70446,ZbaPpC6DlaDgy5Ic6oj7YX9qkm2j3Pmr,fbPkOYLVPtPgIt0MxizjfFJov3JbHyAi,2,0,0,0,0,0,2,0,2,0.2857142857142857,1,0.0,0,0,0,0,0,0,0,2,0,0,2,1
5248,70449,OuD2K7J68ITZFWHHO1jbGZ6J29NSRzcb,fbPkOYLVPtPgIt0MxizjfFJov3JbHyAi,1,0,0,0,0,0,2,0,2,0.2857142857142857,1,0.0,0,0,0,0,0,0,0,2,0,0,2,1
5249,70452,BtObcKvoRLWw2wTYrIxs3nRcUhT64kDl,fbPkOYLVPtPgIt0MxizjfFJov3JbHyAi,5,3,2,0,1,0,1,0,7,1.0,1,0.0,0,2,0,1,3,0,0,1,0,3,4,1
5250,70455,UdUawMbovWyI95L2WHmtm8dSD2c6Mirq,fbPkOYLVPtPgIt0MxizjfFJov3JbHyAi,1,0,0,0,0,0,3,0,3,0.42857142857142855,2,0.0,0,0,0,0,0,0,0,3,0,0,3,1
5251,70456,glPr7QpSO3UuaddnFvb5PsvEyV64Bjzf,fbPkOYLVPtPgIt0MxizjfFJov3JbHyAi,6,9,2,4,4,0,1,0,20,2.857142857142857,1,0.0,6,2,3,4,3,0,1,1,0,15,5,1
5252,70457,yGll7cBEK4l513wg08W8WjrXiINZSUwd,fbPkOYLVPtPgIt0MxizjfFJov3JbHyAi,1,0,0,0,0,0,1,0,1,0.14285714285714285,1,0.0,0,0,0,0,0,0,0,1,0,0,1,1
5253,70458,TLnrwcxEgz2mrbehNNXwzL2eSvPdN3Si,fbPkOYLVPtPgIt0MxizjfFJov3JbHyAi,18,22,10,2,5,0,2,0,41,5.857142857142857,1,0.0,1,10,2,5,21,0,0,2,0,18,23,1
5254,70459,jR6b1WwZvYbWar4qY41wd06uzAZM2Wm4,fbPkOYLVPtPgIt0MxizjfFJov3JbHyAi,1,0,0,0,0,0,1,0,1,0.14285714285714285,1,0.0,0,0,0,0,0,0,0,1,0,0,1,1
5255,70461,6s9Xh8eciyhZj6AHFu4vTyr6KvYwFOCT,fbPkOYLVPtPgIt0MxizjfFJov3JbHyAi,2,0,0,0,0,0,2,0,2,0.2857142857142857,1,0.0,0,0,0,0,0,0,0,2,0,0,2,1
5256,70462,q7Q44V2N9alRALsjF38u0JgTcKmJyVSV,fbPkOYLVPtPgIt0MxizjfFJov3JbHyAi,8,4,2,0,1,0,6,0,13,1.8571428571428572,1,0.0,0,2,0,1,4,0,0,6,0,3,10,1
5257,70463,q5Mh1DiRxqFPerzFhySJn3OvdiZ2Qdjc,fbPkOYLVPtPgIt0MxizjfFJov3JbHyAi,9,6,4,0,3,1,5,2,21,3.0,2,0.0,0,4,0,3,6,1,0,5,2,7,14,1
5258,70469,wsHrywXqK9pQHQooNVLXSXuDfHuX10wJ,fbPkOYLVPtPgIt0MxizjfFJov3JbHyAi,11,8,5,0,4,1,6,1,25,3.5714285714285716,1,0.0,0,5,0,4,8,1,0,6,1,9,16,1
5259,70470,RbeBYSWxB5YUB8XfumpP3ReeBILP8GQy,fbPkOYLVPtPgIt0MxizjfFJov3JbHyAi,6,4,2,0,1,0,3,0,10,1.4285714285714286,1,0.0,0,2,0,1,4,0,0,3,0,3,7,1
5260,70471,qbl5rpxJliTRqjMlXPxrXNDAwFWGT88v,fbPkOYLVPtPgIt0MxizjfFJov3JbHyAi,4,2,1,0,1,0,1,0,5,0.7142857142857143,1,0.0,0,1,0,1,2,0,0,1,0,2,3,1
5261,70472,Jxzkhh0U3PjsXsXvIQ1RukUNEABuBZir,fbPkOYLVPtPgIt0MxizjfFJov3JbHyAi,6,1,1,0,1,0,3,0,6,0.8571428571428571,1,0.0,0,1,0,1,1,0,0,3,0,2,4,1
5262,70473,TfXAnflKNnQz6DuwkJiGkjk0fNqIcdbb,fbPkOYLVPtPgIt0MxizjfFJov3JbHyAi,9,3,2,0,2,0,4,0,11,1.5714285714285714,1,0.0,0,2,0,2,3,0,0,4,0,4,7,1
5263,70474,NvOjhiruQj7OPLj435mRJgxxBFzX5464,fbPkOYLVPtPgIt0MxizjfFJov3JbHyAi,1,0,0,0,0,0,1,0,1,0.14285714285714285,1,0.0,0,0,0,0,0,0,0,1,0,0,1,1
5264,70476,EiRrHQO9y6KZsQm1S959e8bTml9ewKqm,fbPkOYLVPtPgIt0MxizjfFJov3JbHyAi,6,2,1,0,1,0,5,0,9,1.2857142857142858,1,0.0,0,1,0,1,2,0,0,5,0,2,7,1
5265,70477,jEK7s8PazjYlgavgxBhEJ34esgHb5r59,fbPkOYLVPtPgIt0MxizjfFJov3JbHyAi,8,8,5,0,4,3,7,0,27,3.857142857142857,1,0.0,0,5,0,4,8,3,0,7,0,9,18,1
5266,70478,KUQVcSgCXyv6H6oERclsfGhdo9VFKXlH,fbPkOYLVPtPgIt0MxizjfFJov3JbHyAi,9,4,3,0,3,0,3,0,13,1.8571428571428572,1,0.0,0,3,0,3,4,0,0,3,0,6,7,1
5267,70481,bcuHKGDPi1i2lleukutg2XopIRt9zCPL,fbPkOYLVPtPgIt0MxizjfFJov3JbHyAi,1,0,0,0,0,0,2,0,2,0.2857142857142857,1,0.0,0,0,0,0,0,0,0,2,0,0,2,1
5268,70482,jHiBXPRyvnOA5W3dD5pIjKcoACQXqFJ5,fbPkOYLVPtPgIt0MxizjfFJov3JbHyAi,5,2,1,0,1,0,2,0,6,0.8571428571428571,1,0.0,0,1,0,1,2,0,0,2,0,2,4,1
5269,70484,NZGDKrLK9sMpIPoDEekWqKbifVFi38Go,fbPkOYLVPtPgIt0MxizjfFJov3JbHyAi,5,2,1,0,1,2,10,0,16,2.2857142857142856,1,0.0,0,1,0,1,2,2,0,10,0,2,14,1
5270,70485,scWFbDUGBDAED5tZERDIuB5WNVjTVxwA,fbPkOYLVPtPgIt0MxizjfFJov3JbHyAi,13,6,4,0,4,0,5,0,19,2.7142857142857144,1,0.0,0,4,0,4,6,0,0,5,0,8,11,1
5271,70486,HpRhpantip3wKMH4DG1UO07aIjpFrvNc,fbPkOYLVPtPgIt0MxizjfFJov3JbHyAi,1,0,0,0,0,0,1,0,1,0.14285714285714285,1,0.0,0,0,0,0,0,0,0,1,0,0,1,1
5272,70487,bNsQaARwlcoPz5iHn0mmqTE4ae2nNQLk,fbPkOYLVPtPgIt0MxizjfFJov3JbHyAi,5,2,1,0,1,0,2,0,6,0.8571428571428571,1,0.0,0,1,0,1,2,0,0,2,0,2,4,0
5273,70488,OJtIvWrXfQPJJSf2ovLSm6YwghN7AEL1,fbPkOYLVPtPgIt0MxizjfFJov3JbHyAi,7,3,2,0,2,0,2,0,9,1.2857142857142858,1,0.0,0,2,0,2,3,0,0,2,0,4,5,1
5274,70490,txE1eLKUbbtrl9557b0RVmjAcidcH23D,fbPkOYLVPtPgIt0MxizjfFJov3JbHyAi,4,2,1,0,0,0,2,0,5,0.7142857142857143,1,0.0,0,1,0,0,2,0,0,2,0,1,4,1
5275,70492,MlowXT3hhqxu8JbBXveSGYwt4gmwlpxF,fbPkOYLVPtPgIt0MxizjfFJov3JbHyAi,9,12,6,0,3,6,5,1,33,4.714285714285714,1,0.0,2,6,0,3,10,6,0,5,1,11,22,1
5276,70495,STkYkZEAJSwprBqpDKOiSfNJUIRyo0Bq,fbPkOYLVPtPgIt0MxizjfFJov3JbHyAi,5,2,1,0,1,0,3,0,7,1.0,1,0.0,0,1,0,1,2,0,0,3,0,2,5,0
5277,70496,AzLeSPI7N5fTBGeJQXVJiiiwHcrcLWj9,fbPkOYLVPtPgIt0MxizjfFJov3JbHyAi,7,2,1,0,1,0,10,0,14,2.0,1,0.0,0,1,0,1,2,0,0,10,0,2,12,1
5278,70501,QRNZCYPVLmCISEPDuklXJvVOWAcJbKvm,fbPkOYLVPtPgIt0MxizjfFJov3JbHyAi,1,0,0,0,0,0,1,0,1,0.14285714285714285,1,0.0,0,0,0,0,0,0,0,1,0,0,1,1
5279,70502,fd3M5GFuTNibIF234PDGuNuJ7TaPIle6,fbPkOYLVPtPgIt0MxizjfFJov3JbHyAi,11,8,3,0,2,0,12,0,25,3.5714285714285716,4,0.0,0,3,0,2,8,0,0,12,0,5,20,1
5280,70503,yoIXcPh3WeERNBgp3KavFpHxxtSbEbDw,fbPkOYLVPtPgIt0MxizjfFJov3JbHyAi,1,0,0,0,0,0,1,0,1,0.14285714285714285,1,0.0,0,0,0,0,0,0,0,1,0,0,1,1
5281,70504,hx5sJ7jwWSrYbv8AAwrwIYlkyA5lh0xw,fbPkOYLVPtPgIt0MxizjfFJov3JbHyAi,1,0,0,0,0,0,1,0,1,0.14285714285714285,1,0.0,0,0,0,0,0,0,0,1,0,0,1,1
5282,70506,mfNh4uOHHxwzdcujnNlWt7NLyD4AZdsC,fbPkOYLVPtPgIt0MxizjfFJov3JbHyAi,6,6,1,0,1,0,2,0,10,1.4285714285714286,1,0.0,0,1,0,1,6,0,0,2,0,2,8,1
5283,70617,UNVbIrcEO0nclbN5f0xdIeSb61jrpRSX,fbPkOYLVPtPgIt0MxizjfFJov3JbHyAi,12,31,8,4,10,0,10,0,63,9.0,3,0.0,18,8,3,10,13,0,1,10,0,39,24,1
5284,70618,pE2pfmXY2JZ1ppA5N0APNqSGmVpRUVPY,fbPkOYLVPtPgIt0MxizjfFJov3JbHyAi,4,2,1,0,0,0,2,0,5,0.7142857142857143,1,0.0,0,1,0,0,2,0,0,2,0,1,4,1
5285,70620,szRdvMC9nJxtimPyvxBftIjBA99HXMVn,fbPkOYLVPtPgIt0MxizjfFJov3JbHyAi,5,2,1,0,1,0,2,0,6,0.8571428571428571,1,0.0,0,1,0,1,2,0,0,2,0,2,4,1
5286,70622,vL40lDIpwhva8z6IagRWvDtekT2W0mhZ,fbPkOYLVPtPgIt0MxizjfFJov3JbHyAi,10,12,9,0,7,7,6,0,41,5.857142857142857,3,0.0,0,9,0,7,12,7,0,6,0,16,25,1
5287,70623,MIB3h4eZc4hBNhmh6kNQRNuuqfplV8jE,fbPkOYLVPtPgIt0MxizjfFJov3JbHyAi,2,0,0,0,0,0,3,0,3,0.42857142857142855,1,0.0,0,0,0,0,0,0,0,3,0,0,3,1
5288,70624,ig7R2lu2J2odRrDTiKZUVfTrsahUIcRt,fbPkOYLVPtPgIt0MxizjfFJov3JbHyAi,5,2,1,0,1,0,3,0,7,1.0,2,0.0,0,1,0,1,2,0,0,3,0,2,5,0
5289,70625,07qmQr7YUC93IIwpmr9s2O0n03vLXYHf,fbPkOYLVPtPgIt0MxizjfFJov3JbHyAi,5,4,1,0,1,0,2,0,8,1.1428571428571428,1,0.0,1,1,0,1,3,0,0,2,0,3,5,1
5290,70626,QhtGT2PDmxENzsHDxP88jgz9lWXkKr4b,fbPkOYLVPtPgIt0MxizjfFJov3JbHyAi,9,20,9,6,9,4,1,0,49,7.0,1,0.0,3,9,5,9,17,4,1,1,0,26,23,1
5291,70627,VJsbRtMXxy8aqyccEZDzV7pPAGBosBu1,fbPkOYLVPtPgIt0MxizjfFJov3JbHyAi,58,103,71,28,38,6,19,2,267,38.142857142857146,8,0.0,17,71,25,38,86,6,3,19,2,151,116,0
5292,70629,jsdFWuQZ9wDLCnnTt28t2BLCDeZlTxUM,fbPkOYLVPtPgIt0MxizjfFJov3JbHyAi,6,5,1,0,1,0,2,0,9,1.2857142857142858,1,0.0,0,1,0,1,5,0,0,2,0,2,7,1
5293,70632,sMynuMhoZTpmWI7JIgM7Zcgv9Nw77yWq,fbPkOYLVPtPgIt0MxizjfFJov3JbHyAi,5,2,1,0,1,0,2,0,6,0.8571428571428571,1,0.0,0,1,0,1,2,0,0,2,0,2,4,1
5294,70635,DIYlLDsIX3rRB00v33V6F050gdzNiYGy,fbPkOYLVPtPgIt0MxizjfFJov3JbHyAi,10,13,9,5,5,0,3,0,35,5.0,2,0.0,1,9,4,5,12,0,1,3,0,19,16,1
5295,70636,cWnlO9T3wiOdZzNrm52Q8On5YEPOag8t,fbPkOYLVPtPgIt0MxizjfFJov3JbHyAi,14,21,2,0,2,0,11,0,36,5.142857142857143,3,0.0,1,2,0,2,20,0,0,11,0,5,31,1
5296,70637,1fleh7lPd7aghMITlPRITTq0TKiljgoj,fbPkOYLVPtPgIt0MxizjfFJov3JbHyAi,7,3,2,0,2,0,3,0,10,1.4285714285714286,2,0.0,0,2,0,2,3,0,0,3,0,4,6,1
5297,70638,xM8lVcqU5uqtxPXKRkobTl3b50GvL7Y6,fbPkOYLVPtPgIt0MxizjfFJov3JbHyAi,5,2,1,0,1,0,2,0,6,0.8571428571428571,1,0.0,0,1,0,1,2,0,0,2,0,2,4,1
5298,70641,2uadn8x6eG3s1sEJofJgCr35bh3OHGLh,fbPkOYLVPtPgIt0MxizjfFJov3JbHyAi,31,47,26,11,17,42,16,1,160,22.857142857142858,5,0.0,16,26,11,17,31,42,0,16,1,70,90,1
5299,70642,FaGf4ZENvncNMeGerxuOLnibVyMwnEb7,fbPkOYLVPtPgIt0MxizjfFJov3JbHyAi,4,2,1,0,1,0,1,0,5,0.7142857142857143,1,0.0,0,1,0,1,2,0,0,1,0,2,3,1
5300,70644,6kW13L6OI2CXAgkzbQCGiGCWDPgPVNqL,fbPkOYLVPtPgIt0MxizjfFJov3JbHyAi,8,3,2,0,2,0,5,1,13,1.8571428571428572,1,0.0,0,2,0,2,3,0,0,5,1,4,9,1
5301,70646,tuBfe6WhJei1RdPAXwFNRJbSnuTMeD4l,fbPkOYLVPtPgIt0MxizjfFJov3JbHyAi,1,0,0,0,0,0,1,0,1,0.14285714285714285,1,0.0,0,0,0,0,0,0,0,1,0,0,1,1
5302,70647,5Hvfr1gz4w1l7NMxdNIG23Iybswr6a4X,fbPkOYLVPtPgIt0MxizjfFJov3JbHyAi,5,2,1,0,1,0,2,0,6,0.8571428571428571,1,0.0,0,1,0,1,2,0,0,2,0,2,4,1
5303,70648,fdJXQSSucuzaRljy096jXgInnW2TakHQ,fbPkOYLVPtPgIt0MxizjfFJov3JbHyAi,1,0,0,0,0,0,1,0,1,0.14285714285714285,1,0.0,0,0,0,0,0,0,0,1,0,0,1,1
5304,70649,TqM5lkEeW6odNqcCIpnB8ZfnKymScjxh,fbPkOYLVPtPgIt0MxizjfFJov3JbHyAi,9,10,7,0,6,0,8,0,31,4.428571428571429,1,0.0,0,7,0,6,10,0,0,8,0,13,18,1
5305,70651,zPbUIdTRPjnN9GVjy7Vs8SVwjdhRAaUM,fbPkOYLVPtPgIt0MxizjfFJov3JbHyAi,11,30,18,0,6,54,12,1,121,17.285714285714285,6,0.0,0,18,0,6,30,54,0,12,1,24,97,1
5306,70652,RUk1UgFf8pHkjYocajMr35nYXvyKvRsO,fbPkOYLVPtPgIt0MxizjfFJov3JbHyAi,21,31,14,0,8,15,11,2,81,11.571428571428571,2,0.0,0,14,0,8,31,15,0,11,2,22,59,1
5307,70653,PNYL1Lh4wAAOtLwVLWtMerOLdRvGmWgc,fbPkOYLVPtPgIt0MxizjfFJov3JbHyAi,7,1,1,0,1,1,4,1,9,1.2857142857142858,1,0.0,0,1,0,1,1,1,0,4,1,2,7,1
5308,70655,NrraMyTwgTzYDPkTyoYsd0r0OJPy1sab,fbPkOYLVPtPgIt0MxizjfFJov3JbHyAi,7,3,2,0,2,0,6,0,13,1.8571428571428572,1,0.0,0,2,0,2,3,0,0,6,0,4,9,1
5309,70656,Nc9p0NDSJdMFoXyGCYKlMLXQtm4qOOTX,fbPkOYLVPtPgIt0MxizjfFJov3JbHyAi,7,3,2,0,2,6,6,0,19,2.7142857142857144,1,0.0,0,2,0,2,3,6,0,6,0,4,15,1
5310,70657,kF87tAiaM8moNftPhO4ia9AXwDDxrUtb,fbPkOYLVPtPgIt0MxizjfFJov3JbHyAi,11,9,5,0,2,14,13,4,47,6.714285714285714,1,0.0,0,5,0,2,9,14,0,13,4,7,40,1
5311,70658,7h3tDULs3BTNaDybaRAqNsIlSNoXgEZh,fbPkOYLVPtPgIt0MxizjfFJov3JbHyAi,11,14,6,0,4,0,7,0,31,4.428571428571429,2,0.0,1,6,0,4,13,0,0,7,0,11,20,1
5312,70659,3w3oVzXQmE457clbfwy8fl67WyFwWeZX,fbPkOYLVPtPgIt0MxizjfFJov3JbHyAi,4,3,1,0,1,0,1,0,6,0.8571428571428571,1,0.0,0,1,0,1,3,0,0,1,0,2,4,1
5313,70661,eLqag6twmL6nT6SLVrpY07QGG3bytKwe,fbPkOYLVPtPgIt0MxizjfFJov3JbHyAi,4,3,2,0,2,0,2,0,9,1.2857142857142858,1,0.0,0,2,0,2,3,0,0,2,0,4,5,1
5314,70664,8djQJACWabqqdfUYlZxiiBK5fRdO0gWZ,fbPkOYLVPtPgIt0MxizjfFJov3JbHyAi,26,35,19,13,8,10,9,0,94,13.428571428571429,5,0.0,6,19,11,8,29,10,2,9,0,44,50,1
5315,70666,ThmrVFQiXEXdtbVq9OcHgxf5egZE7CCF,fbPkOYLVPtPgIt0MxizjfFJov3JbHyAi,1,0,0,0,0,0,1,0,1,0.14285714285714285,1,0.0,0,0,0,0,0,0,0,1,0,0,1,1
5316,70669,NrAjCwSdkokFEs2cMTtwLegWozRaakkE,fbPkOYLVPtPgIt0MxizjfFJov3JbHyAi,7,3,2,0,2,0,2,0,9,1.2857142857142858,1,0.0,0,2,0,2,3,0,0,2,0,4,5,1
5317,70670,mgRmoo6F9KYYizHMOajedFcuJHtEV6by,fbPkOYLVPtPgIt0MxizjfFJov3JbHyAi,32,32,13,21,8,0,3,0,77,11.0,2,0.0,10,13,21,8,22,0,0,3,0,52,25,1
5318,70672,XRCyFAenNfq06SRijoW2bL3eLeq7TTnH,fbPkOYLVPtPgIt0MxizjfFJov3JbHyAi,1,0,0,0,0,0,1,0,1,0.14285714285714285,1,0.0,0,0,0,0,0,0,0,1,0,0,1,1
5319,70674,tsQNS0TFi4T2OwDWxOZsXYloXeaBeZAv,fbPkOYLVPtPgIt0MxizjfFJov3JbHyAi,16,22,11,10,8,0,3,0,54,7.714285714285714,3,0.0,5,11,10,8,17,0,0,3,0,34,20,1
5320,70675,qgTFbAMyZczl8sJiC9JGSI0pTfFVEsq0,fbPkOYLVPtPgIt0MxizjfFJov3JbHyAi,2,0,0,0,0,0,3,0,3,0.42857142857142855,1,0.0,0,0,0,0,0,0,0,3,0,0,3,1
5321,70676,Pv9LrfjnRw1WO1VwPNHCu7aKxUz6zC8i,fbPkOYLVPtPgIt0MxizjfFJov3JbHyAi,11,17,13,0,7,5,5,0,47,6.714285714285714,3,0.0,0,13,0,7,17,5,0,5,0,20,27,1
5322,70677,zmlL73g2U1Ek37ZDQ2H6P7dwK1MBsxuX,fbPkOYLVPtPgIt0MxizjfFJov3JbHyAi,11,22,12,2,8,11,7,0,62,8.857142857142858,3,0.0,5,12,2,8,17,11,0,7,0,27,35,1
5323,70678,o8iN3RNsKXCFYghfUgBvPvRXa514UVMy,fbPkOYLVPtPgIt0MxizjfFJov3JbHyAi,1,0,0,0,0,0,1,0,1,0.14285714285714285,1,0.0,0,0,0,0,0,0,0,1,0,0,1,1
5324,70682,KAxSek3GgKlkDfM652adYCX6zjbSz36L,fbPkOYLVPtPgIt0MxizjfFJov3JbHyAi,7,5,4,0,2,0,2,0,13,1.8571428571428572,1,0.0,0,4,0,2,5,0,0,2,0,6,7,1
5325,70685,HUREvJ7y9WAOKVUwE1W5wjAznpJ2uyCs,fbPkOYLVPtPgIt0MxizjfFJov3JbHyAi,9,4,3,0,3,0,3,0,13,1.8571428571428572,1,0.0,0,3,0,3,4,0,0,3,0,6,7,1
5326,70687,EjU0dAqbUvEwc53uCAdZVva4XIVSaRPC,fbPkOYLVPtPgIt0MxizjfFJov3JbHyAi,5,2,1,0,1,0,4,0,8,1.1428571428571428,1,0.0,0,1,0,1,2,0,0,4,0,2,6,1
5327,70688,RtFjOHQ78yo3bQ6aRAVmoLevb4Ve3GxB,fbPkOYLVPtPgIt0MxizjfFJov3JbHyAi,7,5,3,0,1,0,5,0,14,2.0,2,0.0,0,3,0,1,5,0,0,5,0,4,10,1
5328,70690,R8o5XScw0cHktAR1kvrGC4Hk6nsNJ50O,fbPkOYLVPtPgIt0MxizjfFJov3JbHyAi,7,4,2,0,2,0,2,0,10,1.4285714285714286,1,0.0,0,2,0,2,4,0,0,2,0,4,6,1
5329,70691,sW1u9EOUYrJApfkaDSoDkISZzFP3ogv6,fbPkOYLVPtPgIt0MxizjfFJov3JbHyAi,6,4,2,0,2,0,1,0,9,1.2857142857142858,1,0.0,0,2,0,2,4,0,0,1,0,4,5,1
5330,70693,10zM0lTEidXp4ysKuDBYxHMLWTshL529,fbPkOYLVPtPgIt0MxizjfFJov3JbHyAi,1,0,0,0,0,0,1,0,1,0.14285714285714285,1,0.0,0,0,0,0,0,0,0,1,0,0,1,1
5331,70695,aR3fk0CNwd9ygarvr0BOVu5p8WeU32I1,fbPkOYLVPtPgIt0MxizjfFJov3JbHyAi,5,2,1,0,1,0,4,0,8,1.1428571428571428,2,0.0,0,1,0,1,2,0,0,4,0,2,6,0
5332,70697,ZQ7aIrw0oaneyIJXr1o9BaGyCupjLIKv,fbPkOYLVPtPgIt0MxizjfFJov3JbHyAi,8,9,3,0,3,0,2,0,17,2.4285714285714284,1,0.0,4,3,0,3,5,0,0,2,0,10,7,1
5333,70699,w5ZVCLR3vfwLftGVhyQYRVOjp6YWhw1i,fbPkOYLVPtPgIt0MxizjfFJov3JbHyAi,14,19,6,2,6,0,11,2,46,6.571428571428571,1,0.0,7,6,2,6,12,0,0,11,2,21,25,1
5334,70700,TaMOkXsZdqqtZoisxF7gCh53bqhSIWJo,fbPkOYLVPtPgIt0MxizjfFJov3JbHyAi,8,3,1,0,1,2,6,1,14,2.0,1,0.0,0,1,0,1,3,2,0,6,1,2,12,1
5335,70701,u71FEuwuCmO3r4p2rE2moG5KipMWcySZ,fbPkOYLVPtPgIt0MxizjfFJov3JbHyAi,6,3,0,0,0,0,6,2,11,1.5714285714285714,1,0.0,0,0,0,0,3,0,0,6,2,0,11,1
5336,70702,0x2sITGXbmptNoJgvpnNEvFzUs19fgRa,fbPkOYLVPtPgIt0MxizjfFJov3JbHyAi,5,3,1,0,1,0,2,0,7,1.0,1,0.0,0,1,0,1,3,0,0,2,0,2,5,1
5337,70703,Evomveryl9GU6Kyv21VjN2TZpSsXcU7r,fbPkOYLVPtPgIt0MxizjfFJov3JbHyAi,2,0,0,0,0,0,3,0,3,0.42857142857142855,1,0.0,0,0,0,0,0,0,0,3,0,0,3,1
5338,70704,vyZYP10ZbNOAlqCfJpVxupzTWedLnj63,fbPkOYLVPtPgIt0MxizjfFJov3JbHyAi,1,0,0,0,0,0,1,0,1,0.14285714285714285,1,0.0,0,0,0,0,0,0,0,1,0,0,1,1
5339,70705,tdygDfFACDU3UgcaUQcaQlbTc0CT910g,fbPkOYLVPtPgIt0MxizjfFJov3JbHyAi,5,2,0,0,0,0,4,0,6,0.8571428571428571,1,0.0,0,0,0,0,2,0,0,4,0,0,6,1
5340,70706,2j7JDJ8MsffyV0kSC0vh7baFkUIS4GAx,fbPkOYLVPtPgIt0MxizjfFJov3JbHyAi,36,74,28,35,30,0,9,0,176,25.142857142857142,5,0.0,42,28,28,30,32,0,7,9,0,128,48,1
5341,70708,7h2Z9QDw2si8maJ5It93IgGcw9Rvo97L,fbPkOYLVPtPgIt0MxizjfFJov3JbHyAi,7,2,1,0,1,0,3,0,7,1.0,1,0.0,0,1,0,1,2,0,0,3,0,2,5,1
5342,70709,bxNjpvJUyYuoYRYlnOXzFxygMwQkPpdy,fbPkOYLVPtPgIt0MxizjfFJov3JbHyAi,1,0,0,0,0,0,1,0,1,0.14285714285714285,1,0.0,0,0,0,0,0,0,0,1,0,0,1,1
5343,70710,ZbRcmeUPJ5YWlzvZySRNdBYY12qzZPLH,fbPkOYLVPtPgIt0MxizjfFJov3JbHyAi,2,0,0,0,0,0,5,0,5,0.7142857142857143,1,0.0,0,0,0,0,0,0,0,5,0,0,5,1
5344,70711,898EWlvcqwFCOnhtz4G2TeXb2eJQJsSY,fbPkOYLVPtPgIt0MxizjfFJov3JbHyAi,6,4,0,0,0,0,5,1,10,1.4285714285714286,1,0.0,0,0,0,0,4,0,0,5,1,0,10,1
5345,70712,OXXS9H9b2CvKWuZ1kgFXpystd5LpKcni,fbPkOYLVPtPgIt0MxizjfFJov3JbHyAi,1,0,0,0,0,0,2,0,2,0.2857142857142857,1,0.0,0,0,0,0,0,0,0,2,0,0,2,1
5346,70713,4aIAxdudlKdNnJYDYlmurnayXljF85dB,fbPkOYLVPtPgIt0MxizjfFJov3JbHyAi,5,2,1,0,1,0,2,0,6,0.8571428571428571,1,0.0,0,1,0,1,2,0,0,2,0,2,4,1
5347,70715,fMmuNXjPEhNXfnU1x4BfSanHlv9m7fK3,fbPkOYLVPtPgIt0MxizjfFJov3JbHyAi,7,6,2,0,3,0,2,0,13,1.8571428571428572,1,0.0,3,2,0,3,3,0,0,2,0,8,5,1
5348,70717,ptm9xuFWpeV3IYsTqQHb5OT1hlhuZP2R,fbPkOYLVPtPgIt0MxizjfFJov3JbHyAi,5,2,1,0,1,0,2,0,6,0.8571428571428571,1,0.0,0,1,0,1,2,0,0,2,0,2,4,1
5349,70721,vKb5mkAesgp0CxIabJFr8I3VERLyILwt,fbPkOYLVPtPgIt0MxizjfFJov3JbHyAi,2,0,0,0,0,0,2,0,2,0.2857142857142857,1,0.0,0,0,0,0,0,0,0,2,0,0,2,1
5350,70722,x3bkOAcKf3YrvrKxnJbZKaEoApnaabtK,fbPkOYLVPtPgIt0MxizjfFJov3JbHyAi,2,0,0,0,0,0,5,0,5,0.7142857142857143,1,0.0,0,0,0,0,0,0,0,5,0,0,5,1
5351,70723,IkoiWVr2ygCLdZNh2Bkmtx3mmgIErIzY,fbPkOYLVPtPgIt0MxizjfFJov3JbHyAi,1,0,0,0,0,0,1,0,1,0.14285714285714285,1,0.0,0,0,0,0,0,0,0,1,0,0,1,1
5352,70727,jtRMyLnPrQKBYosd7A0axGxYdzZLfoyG,fbPkOYLVPtPgIt0MxizjfFJov3JbHyAi,5,2,1,0,1,0,2,0,6,0.8571428571428571,1,0.0,0,1,0,1,2,0,0,2,0,2,4,1
5353,70728,txNRRPx9OJW1ssLv0i1BuynOrKT6T5bw,fbPkOYLVPtPgIt0MxizjfFJov3JbHyAi,7,3,2,0,2,0,2,0,9,1.2857142857142858,1,0.0,0,2,0,2,3,0,0,2,0,4,5,1
5354,70729,D7NGYdR3TLx6U0EvEqMYenyKGPerYPxa,fbPkOYLVPtPgIt0MxizjfFJov3JbHyAi,4,2,1,0,1,0,1,0,5,0.7142857142857143,1,0.0,0,1,0,1,2,0,0,1,0,2,3,1
5355,70730,OdsEBh425XZxll0hTUv04OAotDf6aGtE,fbPkOYLVPtPgIt0MxizjfFJov3JbHyAi,1,0,0,0,0,0,1,0,1,0.14285714285714285,1,0.0,0,0,0,0,0,0,0,1,0,0,1,1
5356,70732,1Z5BGBo2C4Yx5dovaTv5L9hwpHiDBAED,fbPkOYLVPtPgIt0MxizjfFJov3JbHyAi,6,0,0,0,0,0,5,3,8,1.1428571428571428,1,0.0,0,0,0,0,0,0,0,5,3,0,8,1
5357,70734,5W0RrimHGXv2rlPQ5YUetmDKQyAz3Zx5,fbPkOYLVPtPgIt0MxizjfFJov3JbHyAi,5,2,1,0,1,0,4,0,8,1.1428571428571428,1,0.0,0,1,0,1,2,0,0,4,0,2,6,1
5358,70736,pVY9a8xiiW5Hoddx6sJePwV7ScRr5XzD,fbPkOYLVPtPgIt0MxizjfFJov3JbHyAi,5,2,1,0,1,0,2,0,6,0.8571428571428571,1,0.0,0,1,0,1,2,0,0,2,0,2,4,1
5359,70737,Dht5yukEe9IZ0iWFi8cUIe1SOPRbmo8J,fbPkOYLVPtPgIt0MxizjfFJov3JbHyAi,1,0,0,0,0,0,1,0,1,0.14285714285714285,1,0.0,0,0,0,0,0,0,0,1,0,0,1,1
5360,70742,cMdcyYeaotcfCR4kGKYkD6AiwNH9y3n3,fbPkOYLVPtPgIt0MxizjfFJov3JbHyAi,1,0,0,0,0,0,1,0,1,0.14285714285714285,1,0.0,0,0,0,0,0,0,0,1,0,0,1,1
5361,70743,vIbI2SixV9mKPlPtOmgytvBhorWx01zg,fbPkOYLVPtPgIt0MxizjfFJov3JbHyAi,9,20,5,4,7,0,4,0,40,5.714285714285714,2,0.0,5,5,4,7,15,0,0,4,0,21,19,1
5362,70744,JRuzCriX6hvuTQ943ttXKlmrFVyfxMHr,fbPkOYLVPtPgIt0MxizjfFJov3JbHyAi,9,17,10,0,8,0,5,0,40,5.714285714285714,2,0.0,0,10,0,8,17,0,0,5,0,18,22,1
5363,70747,lzZwGZ8LEp741qdGyudVx7KySokTlOIW,fbPkOYLVPtPgIt0MxizjfFJov3JbHyAi,2,0,0,0,0,0,2,0,2,0.2857142857142857,1,0.0,0,0,0,0,0,0,0,2,0,0,2,1
5364,70749,R7ezqxAQ4nt5CDDIMvGiu8qnbxIzzY4p,fbPkOYLVPtPgIt0MxizjfFJov3JbHyAi,12,18,5,5,7,7,5,0,47,6.714285714285714,1,0.0,11,5,4,7,7,7,1,5,0,27,20,1
5365,70750,IUee3dxL3SpdHZIyH7i51dwHDxPaEBUA,fbPkOYLVPtPgIt0MxizjfFJov3JbHyAi,5,4,3,0,0,2,2,0,11,1.5714285714285714,1,0.0,0,3,0,0,4,2,0,2,0,3,8,1
5366,70752,SQJaiB30pTjKgZfQdgaYh0tKJZ2Vbeya,fbPkOYLVPtPgIt0MxizjfFJov3JbHyAi,5,2,1,0,1,5,4,0,13,1.8571428571428572,1,0.0,0,1,0,1,2,5,0,4,0,2,11,1
5367,70753,pPpyZpCndPvCUqSYWY13yKivGYGNWTDN,fbPkOYLVPtPgIt0MxizjfFJov3JbHyAi,10,5,2,0,2,0,6,1,16,2.2857142857142856,2,0.0,0,2,0,2,5,0,0,6,1,4,12,1
5368,70757,lvOGlvq1OFLMKhaj3JewwbbVHWgR6eFx,fbPkOYLVPtPgIt0MxizjfFJov3JbHyAi,5,2,1,0,1,0,2,0,6,0.8571428571428571,1,0.0,0,1,0,1,2,0,0,2,0,2,4,1
5369,70760,OqvR8B9aeDPyw7GoFTuy14iBmyo2yUUo,fbPkOYLVPtPgIt0MxizjfFJov3JbHyAi,1,0,0,0,0,0,1,0,1,0.14285714285714285,1,0.0,0,0,0,0,0,0,0,1,0,0,1,1
5370,70761,jlGY9VVNLsG0TC6XiI2Gb1hDNr4xsLUL,fbPkOYLVPtPgIt0MxizjfFJov3JbHyAi,1,0,0,0,0,0,1,0,1,0.14285714285714285,1,0.0,0,0,0,0,0,0,0,1,0,0,1,1
5371,70762,WwezrN5LILw3d1vvAAZRdwCqhKY8Em85,fbPkOYLVPtPgIt0MxizjfFJov3JbHyAi,1,0,0,0,0,0,1,0,1,0.14285714285714285,1,0.0,0,0,0,0,0,0,0,1,0,0,1,1
5372,70764,tLk8QFN3K7Bcj6ufd8b4XKqxIHVe1uKA,fbPkOYLVPtPgIt0MxizjfFJov3JbHyAi,5,2,1,0,1,0,2,0,6,0.8571428571428571,1,0.0,0,1,0,1,2,0,0,2,0,2,4,1
5373,70765,tGM2jlTFxHBYs0VdqQh38eEUGkMospiQ,fbPkOYLVPtPgIt0MxizjfFJov3JbHyAi,5,6,0,0,0,2,2,0,10,1.4285714285714286,1,0.0,1,0,0,0,5,2,0,2,0,1,9,1
5374,70769,ZkpfVZ9dukn1hNLus0iW46eniC4TxZ6X,fbPkOYLVPtPgIt0MxizjfFJov3JbHyAi,1,0,0,0,0,0,1,0,1,0.14285714285714285,1,0.0,0,0,0,0,0,0,0,1,0,0,1,1
5375,70770,HTGoS5GBox39vCiJgxlIGI9vDOWsXL3B,fbPkOYLVPtPgIt0MxizjfFJov3JbHyAi,1,0,0,0,0,0,1,0,1,0.14285714285714285,1,0.0,0,0,0,0,0,0,0,1,0,0,1,1
5376,70771,4kLcf1sktZawnqU0fFOj7xHNGXJNEsqd,fbPkOYLVPtPgIt0MxizjfFJov3JbHyAi,5,2,1,0,1,0,2,0,6,0.8571428571428571,1,0.0,0,1,0,1,2,0,0,2,0,2,4,1
5377,70772,pSL3xyt1UkD2OS3D0WJIKUXPhJ7M3COF,fbPkOYLVPtPgIt0MxizjfFJov3JbHyAi,5,3,1,0,1,4,4,0,13,1.8571428571428572,2,0.0,0,1,0,1,3,4,0,4,0,2,11,1
5378,70773,0HbAPj0XnG7vlXZFqJF9LLMjlYRkGlju,fbPkOYLVPtPgIt0MxizjfFJov3JbHyAi,5,2,1,0,1,0,2,0,6,0.8571428571428571,1,0.0,0,1,0,1,2,0,0,2,0,2,4,1
5379,70774,u8utNBdxE23PvPDWJ6xVLDwIgTiwdrjZ,fbPkOYLVPtPgIt0MxizjfFJov3JbHyAi,7,3,2,0,2,0,5,0,12,1.7142857142857142,1,0.0,0,2,0,2,3,0,0,5,0,4,8,1
5380,70775,gefkY5cBNvxKJUtGlDogpcQymljtkCst,fbPkOYLVPtPgIt0MxizjfFJov3JbHyAi,7,7,2,0,1,0,5,0,15,2.142857142857143,1,0.0,0,2,0,1,7,0,0,5,0,3,12,1
5381,70776,QjEHoumOE3gC1HJbKGy6t8704j46vuue,fbPkOYLVPtPgIt0MxizjfFJov3JbHyAi,5,2,1,0,1,0,2,0,6,0.8571428571428571,1,0.0,0,1,0,1,2,0,0,2,0,2,4,1
5382,70779,i26V50afV6u2Oz8a9ixc5ngW3fXqCcxA,fbPkOYLVPtPgIt0MxizjfFJov3JbHyAi,1,0,0,0,0,0,1,0,1,0.14285714285714285,1,0.0,0,0,0,0,0,0,0,1,0,0,1,1
5383,70780,sEr814ypFl2X1b9bje9rxXB65bZC1Pq5,fbPkOYLVPtPgIt0MxizjfFJov3JbHyAi,6,1,1,0,1,0,6,0,9,1.2857142857142858,1,0.0,0,1,0,1,1,0,0,6,0,2,7,1
5384,70781,ctdO04zd7K8QUa5HFdH2dxaEs6nEQGcX,fbPkOYLVPtPgIt0MxizjfFJov3JbHyAi,9,9,6,0,3,1,3,0,22,3.142857142857143,2,0.0,0,6,0,3,9,1,0,3,0,9,13,0
5385,70783,mjSdUbH7OSJo2BOaPOnuv8MaiHH7FYld,fbPkOYLVPtPgIt0MxizjfFJov3JbHyAi,7,7,1,0,1,0,6,0,15,2.142857142857143,1,0.0,0,1,0,1,7,0,0,6,0,2,13,1
5386,70784,aF5137RwRQKiOvbUfzDxmAlUCEx92fD4,fbPkOYLVPtPgIt0MxizjfFJov3JbHyAi,1,0,0,0,0,0,1,0,1,0.14285714285714285,1,0.0,0,0,0,0,0,0,0,1,0,0,1,1
5387,70787,Oul8bw2tz24DOZALLi9OxblcSUmg6nEp,fbPkOYLVPtPgIt0MxizjfFJov3JbHyAi,1,0,0,0,0,0,1,0,1,0.14285714285714285,1,0.0,0,0,0,0,0,0,0,1,0,0,1,1
5388,70789,mCnzi5BmvpEBZDUN0ETW99FPkWmNtKNX,fbPkOYLVPtPgIt0MxizjfFJov3JbHyAi,1,0,0,0,0,0,1,0,1,0.14285714285714285,1,0.0,0,0,0,0,0,0,0,1,0,0,1,1
5389,70793,7SossPIJgp94YSmcs9GpN1Sm5zV7LKJL,fbPkOYLVPtPgIt0MxizjfFJov3JbHyAi,7,2,1,0,1,0,3,0,7,1.0,1,0.0,0,1,0,1,2,0,0,3,0,2,5,1
5390,70794,JMM8zz1Uply0QN5h5fJ96sYTBK2yeOxI,fbPkOYLVPtPgIt0MxizjfFJov3JbHyAi,9,6,1,0,1,0,6,0,14,2.0,1,0.0,0,1,0,1,6,0,0,6,0,2,12,1
5391,70796,t9IYCo7lv1UoShjijTGehWjAkf2pn5n5,fbPkOYLVPtPgIt0MxizjfFJov3JbHyAi,5,7,0,0,0,0,4,0,11,1.5714285714285714,1,0.0,0,0,0,0,7,0,0,4,0,0,11,1
5392,70797,uu7UzVxYYlz1pgYD2MFJ9iOaqFHTpesA,fbPkOYLVPtPgIt0MxizjfFJov3JbHyAi,7,4,2,0,1,2,4,1,14,2.0,2,0.0,0,2,0,1,4,2,0,4,1,3,11,1
5393,70799,fanbcR91UHcbTVNiIv1nQj1qUYZ30rX0,fbPkOYLVPtPgIt0MxizjfFJov3JbHyAi,1,0,0,0,0,0,1,0,1,0.14285714285714285,1,0.0,0,0,0,0,0,0,0,1,0,0,1,1
5394,70803,ssyd9rdEHVqPnd0fx1MHuvIhEU773VLT,fbPkOYLVPtPgIt0MxizjfFJov3JbHyAi,2,0,0,0,0,0,3,0,3,0.42857142857142855,1,0.0,0,0,0,0,0,0,0,3,0,0,3,1
5395,70804,1NKuiSaTPUbZFDACCyv5YoUfO7qDer9w,fbPkOYLVPtPgIt0MxizjfFJov3JbHyAi,6,6,2,0,1,0,2,0,11,1.5714285714285714,1,0.0,2,2,0,1,4,0,0,2,0,5,6,1
5396,70808,lpmkkM8oiYpde5WjxbhcBFXAV9lrOr4z,fbPkOYLVPtPgIt0MxizjfFJov3JbHyAi,2,0,0,0,0,0,3,0,3,0.42857142857142855,1,0.0,0,0,0,0,0,0,0,3,0,0,3,1
5397,70809,Fr6BZTrWQKFo57dNUS0jHL2UnsMPDOqr,fbPkOYLVPtPgIt0MxizjfFJov3JbHyAi,6,1,1,0,1,0,3,0,6,0.8571428571428571,1,0.0,0,1,0,1,1,0,0,3,0,2,4,1
5398,70812,CkTzCZEBDUKVj2CxuBE6PIjgAxiqFn5E,fbPkOYLVPtPgIt0MxizjfFJov3JbHyAi,2,0,0,0,0,0,2,0,2,0.2857142857142857,1,0.0,0,0,0,0,0,0,0,2,0,0,2,1
5399,70813,yk15CHpjIZz9cgwSjdiK1bpIkmjG49Ja,fbPkOYLVPtPgIt0MxizjfFJov3JbHyAi,3,0,0,0,0,0,3,0,3,0.42857142857142855,1,0.0,0,0,0,0,0,0,0,3,0,0,3,1
5400,70814,7DDb0W5dNil3mOKBSIGlg2cdwn7LYTP2,fbPkOYLVPtPgIt0MxizjfFJov3JbHyAi,9,9,5,0,4,0,5,0,23,3.2857142857142856,1,0.0,0,5,0,4,9,0,0,5,0,9,14,1
5401,70817,D8q3p28oNnCDKOIbiGQbgveHVNlF4K29,fbPkOYLVPtPgIt0MxizjfFJov3JbHyAi,4,3,0,0,0,0,1,0,4,0.5714285714285714,1,0.0,0,0,0,0,3,0,0,1,0,0,4,1
5402,70820,ELhlMyuHt1scQfOhkxfCzXRENMteryFF,fbPkOYLVPtPgIt0MxizjfFJov3JbHyAi,6,1,1,0,1,0,3,0,6,0.8571428571428571,2,0.0,0,1,0,1,1,0,0,3,0,2,4,1
5403,70821,1DYVtevZL3aXGY7HGRbaRGOoCf6sTS9c,fbPkOYLVPtPgIt0MxizjfFJov3JbHyAi,6,3,1,0,1,0,2,0,7,1.0,1,0.0,0,1,0,1,3,0,0,2,0,2,5,1
5404,70822,k8AJw7WDdTwEOJNmtUY3WESJ7YjggqcB,fbPkOYLVPtPgIt0MxizjfFJov3JbHyAi,8,3,2,0,2,0,5,0,12,1.7142857142857142,1,0.0,0,2,0,2,3,0,0,5,0,4,8,1
5405,70823,EORvS3nZwxrQaK5VcaXN4Zq4BMWJUMRs,fbPkOYLVPtPgIt0MxizjfFJov3JbHyAi,5,2,1,0,1,0,2,0,6,0.8571428571428571,1,0.0,0,1,0,1,2,0,0,2,0,2,4,1
5406,70824,V68nYWLc75b2tl11Mh8jvaF8SbKiBV2d,fbPkOYLVPtPgIt0MxizjfFJov3JbHyAi,8,2,2,0,2,0,5,0,11,1.5714285714285714,1,0.0,0,2,0,2,2,0,0,5,0,4,7,1
5407,70825,oPTYZ3PJdSd8ml5amG32UA8HE12eiUok,fbPkOYLVPtPgIt0MxizjfFJov3JbHyAi,1,0,0,0,0,0,1,0,1,0.14285714285714285,1,0.0,0,0,0,0,0,0,0,1,0,0,1,1
5408,70826,j3jyWJflvqAFzJJxwhnXOjHUHBgIVWxk,fbPkOYLVPtPgIt0MxizjfFJov3JbHyAi,5,0,0,0,0,0,8,1,9,1.2857142857142858,1,0.0,0,0,0,0,0,0,0,8,1,0,9,1
5409,70828,fK4SC23SdBJjy6ZJHLxy5rG3k6OEQhRL,fbPkOYLVPtPgIt0MxizjfFJov3JbHyAi,2,0,0,0,0,0,2,0,2,0.2857142857142857,1,0.0,0,0,0,0,0,0,0,2,0,0,2,1
5410,70829,xUwzuL2GpG7tsntxE4jr1sQzSM0uvwiU,fbPkOYLVPtPgIt0MxizjfFJov3JbHyAi,1,0,0,0,0,0,2,0,2,0.2857142857142857,1,0.0,0,0,0,0,0,0,0,2,0,0,2,1
5411,70830,riMtgGmUwEsIgmPcMgfRpJw7h8RVspUI,fbPkOYLVPtPgIt0MxizjfFJov3JbHyAi,8,5,3,0,2,0,5,0,15,2.142857142857143,1,0.0,0,3,0,2,5,0,0,5,0,5,10,1
5412,70831,o5TpAjMe8TM6a528HMcKqr5zZTFMsmaP,fbPkOYLVPtPgIt0MxizjfFJov3JbHyAi,5,2,1,0,1,0,3,0,7,1.0,1,0.0,0,1,0,1,2,0,0,3,0,2,5,1
5413,70832,YZxXVaDyfqjJPwTonj6xC3yeCKyyMcwI,fbPkOYLVPtPgIt0MxizjfFJov3JbHyAi,13,7,5,0,4,1,14,1,32,4.571428571428571,1,0.0,0,5,0,4,7,1,0,14,1,9,23,1
5414,70833,4kqdE82TaUj9Ob6PVxpRbM2PysfdMkCH,fbPkOYLVPtPgIt0MxizjfFJov3JbHyAi,2,0,0,0,0,0,2,0,2,0.2857142857142857,1,0.0,0,0,0,0,0,0,0,2,0,0,2,1
5415,70836,2WmhxllOxqyxpNvuB1Z1rT8LyIpEZOpF,fbPkOYLVPtPgIt0MxizjfFJov3JbHyAi,5,2,1,0,1,0,4,0,8,1.1428571428571428,1,0.0,0,1,0,1,2,0,0,4,0,2,6,1
5416,70837,afJgM79zX2Cd4ccBAriQnfjQcEwLizk6,fbPkOYLVPtPgIt0MxizjfFJov3JbHyAi,6,2,1,0,1,0,4,0,8,1.1428571428571428,1,0.0,0,1,0,1,2,0,0,4,0,2,6,1
5417,70839,Kc2ZLOGfjK9xNvMUO1HfN3eAcuOUNA78,fbPkOYLVPtPgIt0MxizjfFJov3JbHyAi,8,6,4,6,4,0,2,0,22,3.142857142857143,1,0.0,1,4,5,4,5,0,1,2,0,14,8,1
5418,70840,5fjtZf3Xc8lWt8s6egMqZtlShhUGjtFd,fbPkOYLVPtPgIt0MxizjfFJov3JbHyAi,1,0,0,0,0,0,2,0,2,0.2857142857142857,1,0.0,0,0,0,0,0,0,0,2,0,0,2,1
5419,70842,fZXWFljczIs2zKTKNU8XHxkkGuihaYBi,fbPkOYLVPtPgIt0MxizjfFJov3JbHyAi,9,2,2,0,2,0,9,0,15,2.142857142857143,1,0.0,0,2,0,2,2,0,0,9,0,4,11,1
5420,70845,32PywyFA7AkNsj9LytGcBkA7FP2gdk44,fbPkOYLVPtPgIt0MxizjfFJov3JbHyAi,11,6,4,0,4,0,2,0,16,2.2857142857142856,1,0.0,1,4,0,4,5,0,0,2,0,9,7,1
5421,70846,9MUoTs0to78yIRrWTuXVx5TqwwKqlOPH,fbPkOYLVPtPgIt0MxizjfFJov3JbHyAi,5,3,0,0,0,0,6,0,9,1.2857142857142858,1,0.0,0,0,0,0,3,0,0,6,0,0,9,1
5422,70847,RAvsZ60Di0pQF1FWzazLKNgo4gQa7NT4,fbPkOYLVPtPgIt0MxizjfFJov3JbHyAi,5,2,1,0,1,0,2,0,6,0.8571428571428571,1,0.0,0,1,0,1,2,0,0,2,0,2,4,1
5423,70850,ynbc4a4L1nKWaQxbZwKtj7FjbYhjhhuF,fbPkOYLVPtPgIt0MxizjfFJov3JbHyAi,9,9,4,0,4,6,8,1,32,4.571428571428571,1,0.0,2,4,0,4,7,6,0,8,1,10,22,1
5424,70854,tg8ij1J8ppYeqUKBQEMOpFULhUiviSC2,fbPkOYLVPtPgIt0MxizjfFJov3JbHyAi,9,6,3,0,2,0,3,0,14,2.0,1,0.0,0,3,0,2,6,0,0,3,0,5,9,1
5425,70855,qpLrdk2TB7GVW6GaJkCWKNJYyd2ZkyLM,fbPkOYLVPtPgIt0MxizjfFJov3JbHyAi,1,0,0,0,0,0,1,0,1,0.14285714285714285,1,0.0,0,0,0,0,0,0,0,1,0,0,1,1
5426,70858,4oK5zfJFZ9TDAoTvsTlgrbulTcK542q2,fbPkOYLVPtPgIt0MxizjfFJov3JbHyAi,1,0,0,0,0,0,1,0,1,0.14285714285714285,1,0.0,0,0,0,0,0,0,0,1,0,0,1,1
5427,70859,VkEXjyLrlFj2CVFPhpeVw6CAqjFXGva0,fbPkOYLVPtPgIt0MxizjfFJov3JbHyAi,2,0,0,0,0,0,2,0,2,0.2857142857142857,1,0.0,0,0,0,0,0,0,0,2,0,0,2,1
5428,70861,6IJVUSEMpeG6F6UAW6d6aBbrEWsQ8azq,fbPkOYLVPtPgIt0MxizjfFJov3JbHyAi,8,4,2,0,2,0,2,0,10,1.4285714285714286,1,0.0,0,2,0,2,4,0,0,2,0,4,6,1
5429,70862,I1a9vqQH46q1bfrkbp3ETeJrS6dPcAC4,fbPkOYLVPtPgIt0MxizjfFJov3JbHyAi,4,2,1,0,1,0,1,0,5,0.7142857142857143,1,0.0,0,1,0,1,2,0,0,1,0,2,3,1
5430,70864,YJYft8Pp3kKpsnAX9YvA8ajUcBQBHE3D,fbPkOYLVPtPgIt0MxizjfFJov3JbHyAi,2,0,0,0,0,0,4,0,4,0.5714285714285714,1,0.0,0,0,0,0,0,0,0,4,0,0,4,1
5431,70866,I6VmaLF2DMFBmVoL127xEyjprXeqzx0a,fbPkOYLVPtPgIt0MxizjfFJov3JbHyAi,1,0,0,0,0,0,1,0,1,0.14285714285714285,1,0.0,0,0,0,0,0,0,0,1,0,0,1,1
5432,70867,Y1l5HeKL2xGQ4Lkb5zNCgu2DeFrAlTw8,fbPkOYLVPtPgIt0MxizjfFJov3JbHyAi,1,0,0,0,0,0,1,0,1,0.14285714285714285,1,0.0,0,0,0,0,0,0,0,1,0,0,1,1
5433,70869,LowxZv7QGeTRZfT1csfuXH5r1UZa4mVS,fbPkOYLVPtPgIt0MxizjfFJov3JbHyAi,2,0,0,0,0,0,2,0,2,0.2857142857142857,1,0.0,0,0,0,0,0,0,0,2,0,0,2,1
5434,70870,NaTkGN0OVzlcYhXnPctl6N7eYxY7z7gT,fbPkOYLVPtPgIt0MxizjfFJov3JbHyAi,10,10,7,0,5,0,7,0,29,4.142857142857143,2,0.0,2,7,0,5,8,0,0,7,0,14,15,1
5435,70872,tqL96lBifCNy09m1ns0UwqJwea5MwY8p,fbPkOYLVPtPgIt0MxizjfFJov3JbHyAi,5,2,1,0,1,0,2,0,6,0.8571428571428571,1,0.0,0,1,0,1,2,0,0,2,0,2,4,1
5436,70875,nFDMbovZeON7sHMHTJjtcsqufxGoPyJM,fbPkOYLVPtPgIt0MxizjfFJov3JbHyAi,7,3,2,0,2,13,3,0,23,3.2857142857142856,1,0.0,0,2,0,2,3,13,0,3,0,4,19,1
5437,70876,MJ4Uban6VG5v2fJm4mTva4c0ih2DGhnb,fbPkOYLVPtPgIt0MxizjfFJov3JbHyAi,1,0,0,0,0,0,1,0,1,0.14285714285714285,1,0.0,0,0,0,0,0,0,0,1,0,0,1,1
5438,70877,54WhnApSVDtiavajsWLmVxiyF7WDQOJu,fbPkOYLVPtPgIt0MxizjfFJov3JbHyAi,6,2,1,0,1,0,3,1,8,1.1428571428571428,1,0.0,0,1,0,1,2,0,0,3,1,2,6,1
5439,70884,d5N36ltJLuexchMmFNrBfpp3LZsF74JT,fbPkOYLVPtPgIt0MxizjfFJov3JbHyAi,6,4,2,0,3,0,4,1,14,2.0,1,0.0,1,2,0,3,3,0,0,4,1,6,8,0
5440,70885,Qn4oQ1lJoD4ucx7ZxtRp3oFmTZaTCpvg,fbPkOYLVPtPgIt0MxizjfFJov3JbHyAi,6,11,1,0,1,0,2,0,15,2.142857142857143,1,0.0,0,1,0,1,11,0,0,2,0,2,13,1
5441,70888,Xa0yw5PV4YIPq4eEJJzljtBOuhOF0jib,fbPkOYLVPtPgIt0MxizjfFJov3JbHyAi,1,0,0,0,0,0,1,0,1,0.14285714285714285,1,0.0,0,0,0,0,0,0,0,1,0,0,1,1
5442,70889,k1wwEuRLRVBVQA9v2crFDSBLM3kZLoUU,fbPkOYLVPtPgIt0MxizjfFJov3JbHyAi,1,0,0,0,0,0,1,0,1,0.14285714285714285,1,0.0,0,0,0,0,0,0,0,1,0,0,1,1
5443,70891,Q1IUtiIo2SS94zzJgNzczdxtoIMSWoLW,fbPkOYLVPtPgIt0MxizjfFJov3JbHyAi,1,0,0,0,0,0,1,0,1,0.14285714285714285,1,0.0,0,0,0,0,0,0,0,1,0,0,1,1
5444,70894,oKN2xGH7PD9pLBHMPHUcfj3zTJV8tvd5,fbPkOYLVPtPgIt0MxizjfFJov3JbHyAi,5,2,1,0,1,0,2,0,6,0.8571428571428571,1,0.0,0,1,0,1,2,0,0,2,0,2,4,1
5445,70896,U6LzAVwYbxAVbRMMxjnV16LKATxmA2bk,fbPkOYLVPtPgIt0MxizjfFJov3JbHyAi,7,2,1,0,1,0,4,1,9,1.2857142857142858,1,0.0,0,1,0,1,2,0,0,4,1,2,7,1
5446,70897,83JPfkin3GX4GLKqML2uaHSZ5KvsuJhM,fbPkOYLVPtPgIt0MxizjfFJov3JbHyAi,7,7,4,0,3,0,4,0,18,2.5714285714285716,2,0.0,0,4,0,3,7,0,0,4,0,7,11,1
5447,70898,u8Y97sSr2xWs294k9cdsB9u79pU8RMWs,fbPkOYLVPtPgIt0MxizjfFJov3JbHyAi,7,3,2,0,2,0,2,0,9,1.2857142857142858,1,0.0,0,2,0,2,3,0,0,2,0,4,5,0
5448,70899,tfQATW81rZGgOpzlf2lkFqeziBeMELEX,fbPkOYLVPtPgIt0MxizjfFJov3JbHyAi,2,0,0,0,0,0,3,0,3,0.42857142857142855,1,0.0,0,0,0,0,0,0,0,3,0,0,3,1
5449,70905,OrhyJL1JbaOfmgNByKgbYgqzq4Sm4HlT,G8EPVSXsOYB5YQWZGiz1aVq5Pgr2GrQu,39,37,14,76,8,0,6,0,141,20.142857142857142,2,0.0,17,14,53,8,20,0,23,6,0,92,49,1
5450,70908,B6p5x6qI5IapFaeXO9jhM5m7rqDF4l8p,SpATywNh6bZuzm8s1ceuBUnMUAeoAHHw,7,3,2,6,1,0,3,0,15,2.142857142857143,2,0.0,1,2,5,1,2,0,1,3,0,9,6,0
5451,70917,Iv5H8eRk1KgfQB11AxWDsPacAIgml2Fq,SpATywNh6bZuzm8s1ceuBUnMUAeoAHHw,15,20,10,10,4,0,4,0,48,6.857142857142857,2,0.0,5,10,9,4,15,0,1,4,0,28,20,1
5452,70941,hplRuUXyLFhHcMqMJcb12YjqquTYp3Qw,bWdj2GDclj5ofokWjzoa5jAwMkxCykd6,11,13,7,0,4,1,9,1,35,5.0,4,0.0,0,7,0,4,13,1,0,9,1,11,24,1
5453,70964,AtOHbVb7kxzZIoD2M5RWKjBCYCoDUPL6,SpATywNh6bZuzm8s1ceuBUnMUAeoAHHw,20,37,12,28,2,0,7,0,86,12.285714285714286,5,0.0,21,12,23,2,16,0,5,7,0,58,28,0
5454,70969,Ooaq1toVrKJC9KROMnT52Id1rqx2sDam,A3fsA9Zfv1X2fVEQhTw51lKENdNrEqT3,47,42,25,90,11,60,25,1,254,36.285714285714285,10,0.0,1,25,70,11,41,60,20,25,1,107,147,0
5455,70994,EMrObXWheuWLSYoJOoJqZbkDhx4X9COM,SpATywNh6bZuzm8s1ceuBUnMUAeoAHHw,20,29,1,16,0,5,7,1,59,8.428571428571429,2,0.0,3,1,15,0,26,5,1,7,1,19,40,1
5456,70998,VuxUQKMDYsA4LWFsDh3lY6mcAw5xbtkR,SpATywNh6bZuzm8s1ceuBUnMUAeoAHHw,7,15,3,0,1,2,4,0,25,3.5714285714285716,2,0.0,5,3,0,1,10,2,0,4,0,9,16,0
5457,71000,SuOS5e9JRupQcpgzaLejcvmk4nnyhsIA,A3fsA9Zfv1X2fVEQhTw51lKENdNrEqT3,6,4,3,0,3,0,1,0,11,1.5714285714285714,1,0.0,0,3,0,3,4,0,0,1,0,6,5,1
5458,71001,Qty87BeKrf3ZgzVA2PT9rBe28vADAPbJ,A3fsA9Zfv1X2fVEQhTw51lKENdNrEqT3,10,9,6,0,4,0,3,0,22,3.142857142857143,3,0.0,0,6,0,4,9,0,0,3,0,10,12,0
5459,71025,Sk4DUKJRImF6lijTnkABuH01jDj9zcnP,RXDvfPUBYFlVdlueBFbLW0mhhAyGEqpt,1,0,0,0,0,0,1,0,1,0.14285714285714285,1,0.0,0,0,0,0,0,0,0,1,0,0,1,1
5460,71027,oDMwcP97XCFhatRKDALyEk29j0A66Zee,A3fsA9Zfv1X2fVEQhTw51lKENdNrEqT3,11,4,3,0,3,1,18,1,30,4.285714285714286,4,0.0,1,3,0,3,3,1,0,18,1,7,23,1
5461,71036,SbxWcDAQO1PnIdll82O1Qa8HqEHuIfT7,SpATywNh6bZuzm8s1ceuBUnMUAeoAHHw,4,2,0,0,0,0,3,0,5,0.7142857142857143,1,0.0,0,0,0,0,2,0,0,3,0,0,5,1
5462,71042,Rz8bL6jCH0Pf0jvKzb91yxe7VkOLAlQk,SpATywNh6bZuzm8s1ceuBUnMUAeoAHHw,7,8,0,0,0,0,10,2,20,2.857142857142857,1,0.0,0,0,0,0,8,0,0,10,2,0,20,1
5463,71078,dfEK3xvueeR9teWVma5VAaO4dthOOslM,bWdj2GDclj5ofokWjzoa5jAwMkxCykd6,50,54,18,113,17,0,34,2,238,34.0,5,0.0,17,18,101,17,37,0,12,34,2,153,85,1
5464,71085,niCfrernMgxaiAe4XJm2E9uKlmDuNpx3,SpATywNh6bZuzm8s1ceuBUnMUAeoAHHw,1,0,0,0,0,0,1,0,1,0.14285714285714285,1,0.0,0,0,0,0,0,0,0,1,0,0,1,1
5465,71094,8IMVGvB09WRKHeXEjWGkZOVu6CXmlVXA,RXDvfPUBYFlVdlueBFbLW0mhhAyGEqpt,6,4,1,0,1,0,1,0,7,1.0,1,0.0,0,1,0,1,4,0,0,1,0,2,5,1
5466,71101,kv6R7WjolUetaoWMs79hGLWsktu3yDdz,SpATywNh6bZuzm8s1ceuBUnMUAeoAHHw,5,4,1,0,0,0,2,0,7,1.0,2,0.0,0,1,0,0,4,0,0,2,0,1,6,1
5467,71121,WonWbBpwgN3XpAwPD3B5sUYZEtzBanfo,A3fsA9Zfv1X2fVEQhTw51lKENdNrEqT3,2,0,0,0,0,0,3,0,3,0.42857142857142855,1,0.0,0,0,0,0,0,0,0,3,0,0,3,1
5468,71122,WonWbBpwgN3XpAwPD3B5sUYZEtzBanfo,bWdj2GDclj5ofokWjzoa5jAwMkxCykd6,1,0,0,0,0,0,1,0,1,0.14285714285714285,1,0.0,0,0,0,0,0,0,0,1,0,0,1,1
5469,71124,5niJhzBqY5BWt03iPKjNSLwlp6bq9sIM,SpATywNh6bZuzm8s1ceuBUnMUAeoAHHw,7,3,1,0,2,0,2,0,8,1.1428571428571428,1,0.0,0,1,0,2,3,0,0,2,0,3,5,1
5470,71144,Ze9kgklMuT1yRhjZzYqZ128xNCVJ9Ing,G8EPVSXsOYB5YQWZGiz1aVq5Pgr2GrQu,6,4,1,0,1,0,2,0,8,1.1428571428571428,1,0.0,0,1,0,1,4,0,0,2,0,2,6,1
5471,71148,nzvOBXg9mmjIbNHZZO9eP5MzuZiA7QBu,SpATywNh6bZuzm8s1ceuBUnMUAeoAHHw,8,8,6,0,3,0,3,0,20,2.857142857142857,2,0.0,0,6,0,3,8,0,0,3,0,9,11,1
5472,71161,FixP7IuJ80KsWtzMzcQsJZKOjLxDKZgC,bWdj2GDclj5ofokWjzoa5jAwMkxCykd6,1,0,0,0,0,0,1,0,1,0.14285714285714285,1,0.0,0,0,0,0,0,0,0,1,0,0,1,1
5473,71164,GqY8cM6bEQ2o2zTrfF7msueNZ1f4HNE4,A3fsA9Zfv1X2fVEQhTw51lKENdNrEqT3,13,11,2,0,2,0,4,0,19,2.7142857142857144,2,0.0,0,2,0,2,11,0,0,4,0,4,15,1
5474,71174,axaScF3P7Dmq9RVjqcR7oOXvuGJjIWKx,SpATywNh6bZuzm8s1ceuBUnMUAeoAHHw,20,41,19,24,10,9,18,2,123,17.571428571428573,5,0.0,5,19,19,10,36,9,5,18,2,53,70,0
5475,71177,moqDrkL7HaqSVPAIPOv1C3iTYb2EoCoF,A3fsA9Zfv1X2fVEQhTw51lKENdNrEqT3,36,25,1,82,0,12,6,0,126,18.0,1,0.0,3,1,67,0,22,12,15,6,0,71,55,1
5476,71183,v6Wfy2XnikKgnCNfehO3TIQzyPp7MzcN,RXDvfPUBYFlVdlueBFbLW0mhhAyGEqpt,2,0,0,0,0,0,2,0,2,0.2857142857142857,1,0.0,0,0,0,0,0,0,0,2,0,0,2,1
5477,71191,a5Mkdg3fnTGCu7x8lN0CyRFil7seaApN,SpATywNh6bZuzm8s1ceuBUnMUAeoAHHw,10,22,10,0,1,3,24,0,60,8.571428571428571,2,0.0,0,10,0,1,22,3,0,24,0,11,49,1
5478,71194,AeStUweNOwwDKml97drefO9KmmqkdvwG,bWdj2GDclj5ofokWjzoa5jAwMkxCykd6,2,0,0,0,0,0,2,0,2,0.2857142857142857,1,0.0,0,0,0,0,0,0,0,2,0,0,2,1
5479,71195,4k7x6DcNdq1PRhbqFmfcKoI6JpPSJsyb,G8EPVSXsOYB5YQWZGiz1aVq5Pgr2GrQu,17,43,1,0,1,0,6,0,51,7.285714285714286,2,0.0,0,1,0,1,43,0,0,6,0,2,49,1
5480,71212,VaOhD86uWnK2TjloSi50DgiXbw9C3K0T,A3fsA9Zfv1X2fVEQhTw51lKENdNrEqT3,12,38,10,0,7,0,8,0,63,9.0,3,0.0,0,10,0,7,38,0,0,8,0,17,46,1
5481,71222,mRThjjGON0zU0Y2plEdpqVN16fEiXwSr,bWdj2GDclj5ofokWjzoa5jAwMkxCykd6,11,13,8,0,5,0,8,0,34,4.857142857142857,2,0.0,0,8,0,5,13,0,0,8,0,13,21,1
5482,71253,TPJCnKhFzWhbo2FKOiMksWmjMVFIKGgD,SpATywNh6bZuzm8s1ceuBUnMUAeoAHHw,5,3,1,0,1,0,2,0,7,1.0,1,0.0,1,1,0,1,2,0,0,2,0,3,4,1
5483,71272,CeGIsWlT0KBVS1hQGCUY2KCY4J9xzr3t,SpATywNh6bZuzm8s1ceuBUnMUAeoAHHw,24,24,1,34,1,54,16,0,130,18.571428571428573,5,0.0,4,1,29,1,20,54,5,16,0,35,95,1
5484,71289,VObPdzDYiBKi8TLPXY1g1HS4rT0eO4IR,RXDvfPUBYFlVdlueBFbLW0mhhAyGEqpt,20,22,10,30,8,0,7,0,77,11.0,1,0.0,7,10,27,8,15,0,3,7,0,52,25,1
5485,71291,TdqsraGiWnME5OctPE2I7wQ3BMLqTuwl,SpATywNh6bZuzm8s1ceuBUnMUAeoAHHw,5,9,1,0,1,0,3,0,14,2.0,2,0.0,2,1,0,1,7,0,0,3,0,4,10,1
5486,71305,lBX5Yzu1Dk0lwimtM6RHOAgAth8sqjDN,G8EPVSXsOYB5YQWZGiz1aVq5Pgr2GrQu,22,24,6,26,2,0,1,0,59,8.428571428571429,1,0.0,12,6,14,2,12,0,12,1,0,34,25,1
5487,71355,HwPaWKFgttQqp1SWzLrqkMuI2ELbGJaG,G8EPVSXsOYB5YQWZGiz1aVq5Pgr2GrQu,1,0,0,0,0,0,1,0,1,0.14285714285714285,1,0.0,0,0,0,0,0,0,0,1,0,0,1,1
5488,71362,f6IvpzZQ4NKKZIUTkgWEi3BVq577qLnM,SpATywNh6bZuzm8s1ceuBUnMUAeoAHHw,22,26,6,27,3,18,15,0,95,13.571428571428571,4,0.0,11,6,25,3,15,18,2,15,0,45,50,0
5489,71375,fol611Bi6YnD4zjFVUOPJixEwpbUH6yt,SpATywNh6bZuzm8s1ceuBUnMUAeoAHHw,2,0,0,0,0,0,3,0,3,0.42857142857142855,2,0.0,0,0,0,0,0,0,0,3,0,0,3,0
5490,71380,4Q0hw7idVzdmILVQjJdMPqXbEU97hajF,A3fsA9Zfv1X2fVEQhTw51lKENdNrEqT3,1,0,0,0,0,0,2,0,2,0.2857142857142857,1,0.0,0,0,0,0,0,0,0,2,0,0,2,1
5491,71393,bzlTCtIUcO5BfACSIQwT3PRYSdK0QGTr,SpATywNh6bZuzm8s1ceuBUnMUAeoAHHw,21,25,15,10,8,0,7,0,65,9.285714285714286,3,0.0,6,15,8,8,19,0,2,7,0,37,28,1
5492,71441,VG72z05p4N4OFvxvgLIqa7VdIfM3Q8YO,A3fsA9Zfv1X2fVEQhTw51lKENdNrEqT3,1,0,0,0,0,0,1,0,1,0.14285714285714285,1,0.0,0,0,0,0,0,0,0,1,0,0,1,1
5493,71454,gxNweITMLFQ6uKW8j94tIvo0aCJTBt29,SpATywNh6bZuzm8s1ceuBUnMUAeoAHHw,2,0,0,0,0,0,2,0,2,0.2857142857142857,1,0.0,0,0,0,0,0,0,0,2,0,0,2,1
5494,71478,au4q0hHoeIchXXu4o0X9kRH2tLR2LkOi,SpATywNh6bZuzm8s1ceuBUnMUAeoAHHw,7,2,1,0,1,1,7,1,13,1.8571428571428572,2,0.0,0,1,0,1,2,1,0,7,1,2,11,1
5495,71492,AgmWWSmPg3HCFtB0FkZujRvKdZYey1as,SpATywNh6bZuzm8s1ceuBUnMUAeoAHHw,6,7,5,0,2,0,3,0,17,2.4285714285714284,2,0.0,0,5,0,2,7,0,0,3,0,7,10,1
5496,71503,2YohZ5UKGzy1qUgVAShosLdhgm3pfvsR,A3fsA9Zfv1X2fVEQhTw51lKENdNrEqT3,5,2,1,0,1,0,2,0,6,0.8571428571428571,1,0.0,0,1,0,1,2,0,0,2,0,2,4,1
5497,71505,vP0leqUpaGisQu73FfHJ6k2A2vAG6aiB,bWdj2GDclj5ofokWjzoa5jAwMkxCykd6,5,2,1,0,1,0,2,0,6,0.8571428571428571,1,0.0,0,1,0,1,2,0,0,2,0,2,4,1
5498,71521,SmONSyS4YgG4Afnv6ZxU81t7p4CQPV5P,G8EPVSXsOYB5YQWZGiz1aVq5Pgr2GrQu,1,0,0,0,0,0,1,0,1,0.14285714285714285,1,0.0,0,0,0,0,0,0,0,1,0,0,1,1
5499,71523,SmONSyS4YgG4Afnv6ZxU81t7p4CQPV5P,RXDvfPUBYFlVdlueBFbLW0mhhAyGEqpt,2,0,0,0,0,0,2,0,2,0.2857142857142857,1,0.0,0,0,0,0,0,0,0,2,0,0,2,0
5500,71526,PrwfjW9YGtDxqVBHDm7KtO2cr4GlU48n,SpATywNh6bZuzm8s1ceuBUnMUAeoAHHw,24,25,12,27,5,6,7,1,83,11.857142857142858,1,0.0,7,12,26,5,18,6,1,7,1,50,33,0
5501,71534,6kmRTTlm2tGjO1GkeO8yvcp6lmCvKO0m,A3fsA9Zfv1X2fVEQhTw51lKENdNrEqT3,9,6,3,0,2,1,9,0,21,3.0,4,0.0,0,3,0,2,6,1,0,9,0,5,16,1
5502,71546,f1e5g73OiAut7IKbJN1QM0zdAV9QZu4j,G8EPVSXsOYB5YQWZGiz1aVq5Pgr2GrQu,19,23,8,0,6,2,8,0,47,6.714285714285714,1,0.0,4,8,0,6,19,2,0,8,0,18,29,0
5503,71552,wEaTyOJwwvOCk7eUttQISK5WPXL7ANNV,G8EPVSXsOYB5YQWZGiz1aVq5Pgr2GrQu,1,0,0,0,0,0,1,0,1,0.14285714285714285,1,0.0,0,0,0,0,0,0,0,1,0,0,1,1
5504,71612,L56U1ayQBSvA3ytGNrFwHPNpiuCpgXCq,A3fsA9Zfv1X2fVEQhTw51lKENdNrEqT3,36,15,9,50,8,0,4,0,86,12.285714285714286,1,0.0,4,9,46,8,11,0,4,4,0,67,19,1
5505,71616,Lt7VPheILDSvy2io7NudVCZ6gMhwTn9j,SpATywNh6bZuzm8s1ceuBUnMUAeoAHHw,1,0,0,0,0,0,1,0,1,0.14285714285714285,1,0.0,0,0,0,0,0,0,0,1,0,0,1,1
5506,71625,ddRUcnq8CFHBGHWZEDIhMAjA3ypo6C57,RXDvfPUBYFlVdlueBFbLW0mhhAyGEqpt,7,4,1,0,1,0,2,0,8,1.1428571428571428,1,0.0,0,1,0,1,4,0,0,2,0,2,6,1
5507,71642,YZqjHyJb9T1aeLqKSF3CKbXzYGNTpFDA,SpATywNh6bZuzm8s1ceuBUnMUAeoAHHw,5,3,0,0,0,0,2,0,5,0.7142857142857143,2,0.0,0,0,0,0,3,0,0,2,0,0,5,1
5508,71654,qTtdX55CV2fJxnEb7mhnsvXbisJZJyaM,bWdj2GDclj5ofokWjzoa5jAwMkxCykd6,2,0,0,0,0,0,2,0,2,0.2857142857142857,1,0.0,0,0,0,0,0,0,0,2,0,0,2,1
5509,71671,ElsXlbvFFCxkAZK5wxKh1k6NT3PqrFej,bWdj2GDclj5ofokWjzoa5jAwMkxCykd6,1,0,0,0,0,0,1,0,1,0.14285714285714285,1,0.0,0,0,0,0,0,0,0,1,0,0,1,1
5510,71679,udXq1W3W39FL5ELVdayz2yBuWe1SMQSB,SpATywNh6bZuzm8s1ceuBUnMUAeoAHHw,3,0,0,0,0,0,3,0,3,0.42857142857142855,1,0.0,0,0,0,0,0,0,0,3,0,0,3,1
5511,71687,G0R41qglSXZRKpF9p8Vfr2YtoPUNtseQ,A3fsA9Zfv1X2fVEQhTw51lKENdNrEqT3,1,0,0,0,0,0,1,0,1,0.14285714285714285,1,0.0,0,0,0,0,0,0,0,1,0,0,1,1
5512,71700,qGPfY7GDQqrO1DPuPdsJnIrEGeJp1MpX,SpATywNh6bZuzm8s1ceuBUnMUAeoAHHw,20,56,6,18,4,14,14,0,112,16.0,4,0.0,8,6,15,4,48,14,3,14,0,33,79,1
5513,71702,JUwnpYDokyUXTC7SfWpuPqShDK4ZEqmX,A3fsA9Zfv1X2fVEQhTw51lKENdNrEqT3,11,5,4,0,4,1,7,1,22,3.142857142857143,3,0.0,0,4,0,4,5,1,0,7,1,8,14,1
5514,71712,TztthVt5KMop1hWx6wFArC8xg8H9VhnG,SpATywNh6bZuzm8s1ceuBUnMUAeoAHHw,22,21,14,4,7,5,12,0,63,9.0,7,0.0,1,14,3,7,20,5,1,12,0,25,38,1
5515,71718,pcpAhLjoTN8lH8rrB4WzhaKSF9JUuI0T,G8EPVSXsOYB5YQWZGiz1aVq5Pgr2GrQu,7,5,4,0,3,0,3,0,15,2.142857142857143,1,0.0,0,4,0,3,5,0,0,3,0,7,8,1
5516,71737,5VlUeVUXRN1CcPaOOWsH3KOAj8dOWksi,G8EPVSXsOYB5YQWZGiz1aVq5Pgr2GrQu,27,25,13,24,8,0,4,0,74,10.571428571428571,2,0.0,6,13,18,8,19,0,6,4,0,45,29,1
5517,71765,RNIlCFbK1TpIi5Jv91aZZHNNmFBjGDjQ,SpATywNh6bZuzm8s1ceuBUnMUAeoAHHw,1,0,0,0,0,0,1,0,1,0.14285714285714285,1,0.0,0,0,0,0,0,0,0,1,0,0,1,1
5518,71782,bvymgtoEENeCZc8oxchZvznMloDqHCnU,bWdj2GDclj5ofokWjzoa5jAwMkxCykd6,5,5,3,0,0,0,4,0,12,1.7142857142857142,2,0.0,0,3,0,0,5,0,0,4,0,3,9,1
5519,71802,YkfUrC2IjNSUcSjXepY6IHt6QpgdD85G,SpATywNh6bZuzm8s1ceuBUnMUAeoAHHw,31,50,27,18,15,10,11,0,131,18.714285714285715,4,0.0,16,27,18,15,34,10,0,11,0,76,55,1
5520,71822,Z1BvcrHFnz5lnLSAy2ZEcjcmCxIRFxqE,bWdj2GDclj5ofokWjzoa5jAwMkxCykd6,1,0,0,0,0,0,1,0,1,0.14285714285714285,1,0.0,0,0,0,0,0,0,0,1,0,0,1,1
5521,71823,Z1BvcrHFnz5lnLSAy2ZEcjcmCxIRFxqE,A3fsA9Zfv1X2fVEQhTw51lKENdNrEqT3,1,0,0,0,0,0,1,0,1,0.14285714285714285,1,0.0,0,0,0,0,0,0,0,1,0,0,1,1
5522,71842,ErXNe7efkRl64E8pJRc91VCcYddra1a4,SpATywNh6bZuzm8s1ceuBUnMUAeoAHHw,22,48,13,32,2,20,20,2,137,19.571428571428573,7,0.0,15,13,26,2,33,20,6,20,2,56,81,0
5523,71844,yjE4tqKQR2WC3DLToz6n1TUHIiH6cjX1,SpATywNh6bZuzm8s1ceuBUnMUAeoAHHw,13,21,12,0,7,0,9,0,49,7.0,6,0.0,0,12,0,7,21,0,0,9,0,19,30,0
5524,71845,Bl9yotIOWBgbQXjSe795sBrgMyA0TCNf,RXDvfPUBYFlVdlueBFbLW0mhhAyGEqpt,53,37,1,110,1,0,4,0,153,21.857142857142858,2,0.0,12,1,102,1,25,0,8,4,0,116,37,1
5525,71854,It5GZoF42fMzBpqBoHOwTBOzCr0aB6Mf,SpATywNh6bZuzm8s1ceuBUnMUAeoAHHw,4,2,1,0,0,0,2,0,5,0.7142857142857143,1,0.0,0,1,0,0,2,0,0,2,0,1,4,0
5526,71855,PzUJiLnP9HZJxQE6JmMTkx1KTzCMtAvI,SpATywNh6bZuzm8s1ceuBUnMUAeoAHHw,6,5,3,0,2,0,3,0,13,1.8571428571428572,1,0.0,0,3,0,2,5,0,0,3,0,5,8,1
5527,71873,nBOtam7XKIa3PxdTZIAJPzc36wtmbKH4,A3fsA9Zfv1X2fVEQhTw51lKENdNrEqT3,59,27,18,144,9,2,15,0,215,30.714285714285715,3,0.0,5,18,141,9,22,2,3,15,0,173,42,1
5528,71885,STpGdIPaHCaW4TikUdsIz5l3OEI1w4EH,SpATywNh6bZuzm8s1ceuBUnMUAeoAHHw,5,2,1,0,1,0,2,0,6,0.8571428571428571,1,0.0,0,1,0,1,2,0,0,2,0,2,4,1
5529,71888,sr89KLsFZj5opXIwIPCyClXHTk70EGW9,SpATywNh6bZuzm8s1ceuBUnMUAeoAHHw,7,6,5,0,3,0,2,0,16,2.2857142857142856,1,0.0,0,5,0,3,6,0,0,2,0,8,8,1
5530,71930,fvtcu8mnRKcOOxIrvdMmUWRWOCvOPCJY,A3fsA9Zfv1X2fVEQhTw51lKENdNrEqT3,4,2,1,0,0,0,2,0,5,0.7142857142857143,1,0.0,0,1,0,0,2,0,0,2,0,1,4,1
5531,71935,Cg7iNBAj8Tw36V9R4YA417eEEGy00kAz,SpATywNh6bZuzm8s1ceuBUnMUAeoAHHw,18,24,10,26,1,1,10,0,72,10.285714285714286,5,0.0,7,10,23,1,17,1,3,10,0,41,31,0
5532,71946,ap47j49GydESvLtt85D5zvr7ZznC8gTV,bWdj2GDclj5ofokWjzoa5jAwMkxCykd6,10,11,2,0,2,1,8,2,26,3.7142857142857144,1,0.0,0,2,0,2,11,1,0,8,2,4,22,1
5533,71949,ap47j49GydESvLtt85D5zvr7ZznC8gTV,RXDvfPUBYFlVdlueBFbLW0mhhAyGEqpt,13,11,6,0,2,14,15,1,49,7.0,1,0.0,0,6,0,2,11,14,0,15,1,8,41,0
5534,71966,Zs0g0mKdq0TdImqBhrX0faEWu7slOeJl,G8EPVSXsOYB5YQWZGiz1aVq5Pgr2GrQu,7,3,2,0,2,0,2,0,9,1.2857142857142858,1,0.0,0,2,0,2,3,0,0,2,0,4,5,1
5535,71970,51xlIGXGRsE7YMneHTw1mXYuaEFgELF3,A3fsA9Zfv1X2fVEQhTw51lKENdNrEqT3,29,20,18,0,14,0,2,0,54,7.714285714285714,2,0.0,0,18,0,14,20,0,0,2,0,32,22,0
5536,71985,1LkX4t7QGG0LPbqqJvnwJmrweFNAYkvm,bWdj2GDclj5ofokWjzoa5jAwMkxCykd6,15,17,4,0,5,0,5,0,31,4.428571428571429,3,0.0,3,4,0,5,14,0,0,5,0,12,19,1
5537,71991,imshqH7JQ2KBPUk9GL3zPD8OWwRSwtuq,SpATywNh6bZuzm8s1ceuBUnMUAeoAHHw,7,5,3,0,2,35,7,1,53,7.571428571428571,2,0.0,0,3,0,2,5,35,0,7,1,5,48,1
5538,71997,1twNQDvdxBOgcj0lq6GVrkkiWBY4fWuM,A3fsA9Zfv1X2fVEQhTw51lKENdNrEqT3,2,0,0,0,0,0,5,0,5,0.7142857142857143,2,0.0,0,0,0,0,0,0,0,5,0,0,5,1
5539,72013,ukCIrv5h45nbdIEPPmMlvipT87B8fFE7,A3fsA9Zfv1X2fVEQhTw51lKENdNrEqT3,1,0,0,0,0,0,1,0,1,0.14285714285714285,1,0.0,0,0,0,0,0,0,0,1,0,0,1,1
5540,72028,rGUcxYNOJhuu9K9SMgsP5W3xbSiphSwH,SpATywNh6bZuzm8s1ceuBUnMUAeoAHHw,19,28,12,14,5,12,9,1,81,11.571428571428571,4,0.0,9,12,14,5,19,12,0,9,1,40,41,1
5541,72034,4D3Mr9GTnnSeHqe4k4RduVTIffzivKXV,SpATywNh6bZuzm8s1ceuBUnMUAeoAHHw,25,22,11,26,4,2,10,2,77,11.0,3,0.0,8,11,25,4,14,2,1,10,2,48,29,1
5542,72036,X5enyutaN4BslWhmXx6XhoGlJxHpkXgF,SpATywNh6bZuzm8s1ceuBUnMUAeoAHHw,5,3,1,0,0,0,3,0,7,1.0,1,0.0,0,1,0,0,3,0,0,3,0,1,6,1
5543,72066,FCXISzNoe8FGZLEA3b4ES0P455MShvJn,SpATywNh6bZuzm8s1ceuBUnMUAeoAHHw,4,2,1,0,1,0,3,0,7,1.0,2,0.0,0,1,0,1,2,0,0,3,0,2,5,1
5544,72074,RuDy1GBbehKUBaX6QEes5OGfFL3kKVSX,SpATywNh6bZuzm8s1ceuBUnMUAeoAHHw,1,0,0,0,0,0,1,0,1,0.14285714285714285,1,0.0,0,0,0,0,0,0,0,1,0,0,1,1
5545,72106,zIrlaPdUoa4jAQzQMvRWsAtbCae2mGEc,G8EPVSXsOYB5YQWZGiz1aVq5Pgr2GrQu,1,0,0,0,0,0,1,0,1,0.14285714285714285,1,0.0,0,0,0,0,0,0,0,1,0,0,1,1
5546,72117,Sel2OIwsCKHe9RO5oHI96p00tLi1mx10,RXDvfPUBYFlVdlueBFbLW0mhhAyGEqpt,1,0,0,0,0,0,1,0,1,0.14285714285714285,1,0.0,0,0,0,0,0,0,0,1,0,0,1,1
5547,72123,a8HvMkBRr1QnoDxivZVIhrkeiZFWplka,bWdj2GDclj5ofokWjzoa5jAwMkxCykd6,32,46,27,93,13,10,15,0,204,29.142857142857142,5,0.0,8,27,74,13,38,10,19,15,0,122,82,1
5548,72166,yS4hKsLzPsdj6M1qMcvQzXXEbCXgtzUx,A3fsA9Zfv1X2fVEQhTw51lKENdNrEqT3,11,7,1,0,1,11,7,1,28,4.0,1,0.0,0,1,0,1,7,11,0,7,1,2,26,1
5549,72180,h3JQOcsvjUnoJCiMtN2qNwJvDlNp6yEa,SpATywNh6bZuzm8s1ceuBUnMUAeoAHHw,6,3,2,0,2,0,1,0,8,1.1428571428571428,1,0.0,0,2,0,2,3,0,0,1,0,4,4,1
5550,72187,pg03VLobZ1zAAslEUdBaTgGu7kih28vz,SpATywNh6bZuzm8s1ceuBUnMUAeoAHHw,6,3,1,0,1,0,2,0,7,1.0,1,0.0,0,1,0,1,3,0,0,2,0,2,5,0
5551,72195,2XrVfo49pLwaH12euHkVNsz60Xa54j5d,SpATywNh6bZuzm8s1ceuBUnMUAeoAHHw,1,0,0,0,0,0,1,0,1,0.14285714285714285,1,0.0,0,0,0,0,0,0,0,1,0,0,1,1
5552,72198,dRTXM152V1lTMTi8e61qXn3u4WelzJ82,A3fsA9Zfv1X2fVEQhTw51lKENdNrEqT3,20,20,1,0,2,0,6,0,29,4.142857142857143,2,0.0,0,1,0,2,20,0,0,6,0,3,26,1
5553,72200,ZRC032b6bAMTdyW8JO1vU2llk0mQNPce,SpATywNh6bZuzm8s1ceuBUnMUAeoAHHw,21,39,13,38,3,23,15,5,136,19.428571428571427,3,0.0,17,13,31,3,22,23,7,15,5,64,72,1
5554,72206,2t2mFcXnjCSGOBpya1wSPFZtPiud9I2F,SpATywNh6bZuzm8s1ceuBUnMUAeoAHHw,25,51,1,27,0,0,26,3,108,15.428571428571429,8,0.0,18,1,24,0,33,0,3,26,3,43,65,0
5555,72215,6ngga8jBuXKmnKYc00TBjXbVEmc0f4XL,SpATywNh6bZuzm8s1ceuBUnMUAeoAHHw,11,10,6,0,4,0,3,0,23,3.2857142857142856,3,0.0,0,6,0,4,10,0,0,3,0,10,13,1
5556,72250,SozblGZP0jqptTVCGb8oKsTCWZZGfIvg,SpATywNh6bZuzm8s1ceuBUnMUAeoAHHw,16,20,3,18,3,0,3,0,47,6.714285714285714,2,0.0,11,3,16,3,9,0,2,3,0,33,14,0
5557,72268,hluzPB1y7zkKLSSzVkJvXfWNLyDAuRho,RXDvfPUBYFlVdlueBFbLW0mhhAyGEqpt,16,18,11,0,6,0,6,4,45,6.428571428571429,3,0.0,0,11,0,6,18,0,0,6,4,17,28,1
5558,72270,VCY6PHshXOjPWWfmo1l8Uf1lH1o7rZ3R,bWdj2GDclj5ofokWjzoa5jAwMkxCykd6,1,0,0,0,0,0,1,0,1,0.14285714285714285,1,0.0,0,0,0,0,0,0,0,1,0,0,1,1
5559,72321,cfFiO9ikb1PkctbOzz1e9XkphXHtxdbN,A3fsA9Zfv1X2fVEQhTw51lKENdNrEqT3,10,4,2,0,2,0,7,0,15,2.142857142857143,1,0.0,0,2,0,2,4,0,0,7,0,4,11,1
5560,72327,vpU9FFM3siBSv5Tq74CkiYBZ5nbD9oub,SpATywNh6bZuzm8s1ceuBUnMUAeoAHHw,23,30,1,28,0,2,11,1,73,10.428571428571429,3,0.0,11,1,26,0,19,2,2,11,1,38,35,1
5561,72328,iq2dRooMckypJXruhYgCykZbS7Y4UNpS,SpATywNh6bZuzm8s1ceuBUnMUAeoAHHw,2,0,0,0,0,0,2,0,2,0.2857142857142857,1,0.0,0,0,0,0,0,0,0,2,0,0,2,1
5562,72342,AImx2eHFGaeqTe0d3fwuX86fffC0rd9k,RXDvfPUBYFlVdlueBFbLW0mhhAyGEqpt,6,4,3,0,1,0,1,0,9,1.2857142857142858,1,0.0,0,3,0,1,4,0,0,1,0,4,5,1
5563,72354,4ZKN4qjeNhliROr2sm8vB8zmpPTrlPXO,A3fsA9Zfv1X2fVEQhTw51lKENdNrEqT3,7,11,1,0,1,0,2,0,15,2.142857142857143,1,0.0,1,1,0,1,10,0,0,2,0,3,12,1
5564,72370,WI9rk8aS11tBAJzjcX0JSIgomYYRQVjW,SpATywNh6bZuzm8s1ceuBUnMUAeoAHHw,24,41,2,26,2,5,24,0,100,14.285714285714286,6,0.0,4,2,25,2,37,5,1,24,0,33,67,0
5565,72371,iahhmqoMx53j5nO5miK92n3wdWI8ut4z,RXDvfPUBYFlVdlueBFbLW0mhhAyGEqpt,5,2,1,0,1,0,6,0,10,1.4285714285714286,4,0.0,0,1,0,1,2,0,0,6,0,2,8,1
5566,72375,jpXIq3stqWScWG27acYJbNKpdTmc6kli,bWdj2GDclj5ofokWjzoa5jAwMkxCykd6,39,87,53,190,14,13,43,0,400,57.142857142857146,11,0.0,7,53,183,14,80,13,7,43,0,257,143,0
5567,72406,m2qlFWWWmt2hJc2nGhR4gu4Qag46wOrg,bWdj2GDclj5ofokWjzoa5jAwMkxCykd6,15,9,6,0,4,0,9,1,29,4.142857142857143,3,0.0,0,6,0,4,9,0,0,9,1,10,19,1
5568,72412,NIlxh2g7VTAquieuVc9RGErPkOzbSh2Z,SpATywNh6bZuzm8s1ceuBUnMUAeoAHHw,17,34,14,19,3,0,14,0,84,12.0,3,0.0,4,14,17,3,30,0,2,14,0,38,46,1
5569,72416,iPefB9aOL6bAjIaS6Gks903vpOsT6Kof,SpATywNh6bZuzm8s1ceuBUnMUAeoAHHw,8,6,1,0,1,0,7,0,15,2.142857142857143,2,0.0,0,1,0,1,6,0,0,7,0,2,13,1
5570,72418,idKVU6p7Q7GgRNB8N8uPXj3SONpH1Rke,SpATywNh6bZuzm8s1ceuBUnMUAeoAHHw,9,10,1,0,1,0,3,0,15,2.142857142857143,1,0.0,0,1,0,1,10,0,0,3,0,2,13,1
5571,72426,B9BCqbSn4dXX7PoOMPBly9mxS1ETXKHH,SpATywNh6bZuzm8s1ceuBUnMUAeoAHHw,7,17,8,0,2,0,3,0,30,4.285714285714286,3,0.0,5,8,0,2,12,0,0,3,0,15,15,1
5572,72429,GwQix8XlCp4q9CmSxf5jg9NO42lfroib,SpATywNh6bZuzm8s1ceuBUnMUAeoAHHw,2,0,0,0,0,0,3,0,3,0.42857142857142855,3,0.0,0,0,0,0,0,0,0,3,0,0,3,1
5573,72438,7o7xgD7LMzcqbchAXccb0936AlSMEPrX,G8EPVSXsOYB5YQWZGiz1aVq5Pgr2GrQu,3,2,0,0,0,0,1,0,3,0.42857142857142855,1,0.0,0,0,0,0,2,0,0,1,0,0,3,1
5574,72442,LWfPQEZcfqcdY03cxPtuNt5LIUXK1J1h,bWdj2GDclj5ofokWjzoa5jAwMkxCykd6,20,31,2,80,5,25,26,1,170,24.285714285714285,4,0.0,10,2,75,5,21,25,5,26,1,92,78,1
5575,72443,r4duLXpBfZecmSM9LE5BQOC4ssd1sXJk,SpATywNh6bZuzm8s1ceuBUnMUAeoAHHw,1,0,0,0,0,0,1,0,1,0.14285714285714285,1,0.0,0,0,0,0,0,0,0,1,0,0,1,1
5576,72445,r4duLXpBfZecmSM9LE5BQOC4ssd1sXJk,bWdj2GDclj5ofokWjzoa5jAwMkxCykd6,3,0,0,0,0,0,4,0,4,0.5714285714285714,1,0.0,0,0,0,0,0,0,0,4,0,0,4,1
5577,72448,Ln23tN1YAlBNEBT8tndbR9JhZVhVTsS7,SpATywNh6bZuzm8s1ceuBUnMUAeoAHHw,30,57,29,36,15,3,22,1,163,23.285714285714285,5,0.0,18,29,33,15,39,3,3,22,1,95,68,1
5578,72451,9FaPBbsYKn0C9myyRYf9vYNhns2eJDpD,bWdj2GDclj5ofokWjzoa5jAwMkxCykd6,24,67,26,0,12,0,27,1,133,19.0,8,0.0,2,26,0,12,65,0,0,27,1,40,93,0
5579,72452,MU4dVyJTD7iIRSTZIdJZ9VoLOxogfKQN,A3fsA9Zfv1X2fVEQhTw51lKENdNrEqT3,44,22,16,86,11,5,9,0,149,21.285714285714285,4,0.0,1,16,74,11,21,5,12,9,0,102,47,0
5580,72465,ypoGZw2r9uT31DVWRK8Ak5IwBPQDf2ZW,A3fsA9Zfv1X2fVEQhTw51lKENdNrEqT3,6,5,2,0,0,0,4,0,11,1.5714285714285714,2,0.0,0,2,0,0,5,0,0,4,0,2,9,1
5581,72468,clbUGnOQsN7CuaV7idGJ2LVbYN3t8qC3,bWdj2GDclj5ofokWjzoa5jAwMkxCykd6,31,68,4,83,2,8,14,1,180,25.714285714285715,6,0.0,24,4,81,2,44,8,2,14,1,111,69,0
5582,72485,H1nbdkC904EOh8jWeVVcV5piaqMVBsli,RXDvfPUBYFlVdlueBFbLW0mhhAyGEqpt,45,47,5,84,3,0,12,2,153,21.857142857142858,5,0.0,9,5,83,3,38,0,1,12,2,100,53,0
5583,72488,KQPXidcwG060yQGJPDlINxK2yFVflTSt,bWdj2GDclj5ofokWjzoa5jAwMkxCykd6,1,0,0,0,0,0,1,0,1,0.14285714285714285,1,0.0,0,0,0,0,0,0,0,1,0,0,1,1
5584,72489,RJYmcEEhHfwNHiJXK5LzE5hkiIIoNU9v,RXDvfPUBYFlVdlueBFbLW0mhhAyGEqpt,1,0,0,0,0,0,1,0,1,0.14285714285714285,1,0.0,0,0,0,0,0,0,0,1,0,0,1,1
5585,72499,sD8qOTBQiDeb2NJjPdXUeUPzMkOLP9sv,G8EPVSXsOYB5YQWZGiz1aVq5Pgr2GrQu,18,17,5,17,4,1,14,2,60,8.571428571428571,1,0.0,7,5,14,4,10,1,3,14,2,30,30,1
5586,72510,0Zbkv3HIeYhldfQXVnfym9fVEiuNqjhW,G8EPVSXsOYB5YQWZGiz1aVq5Pgr2GrQu,10,21,2,0,2,1,12,1,39,5.571428571428571,1,0.0,0,2,0,2,21,1,0,12,1,4,35,1
5587,72521,8UBuXoKnbGMq6Q0kIIWDMawKN4aOMWdt,SpATywNh6bZuzm8s1ceuBUnMUAeoAHHw,6,7,5,0,4,0,1,0,17,2.4285714285714284,1,0.0,0,5,0,4,7,0,0,1,0,9,8,1
5588,72523,bBon9Fz54W0VEKu51qXuvXYwLHShFyI1,SpATywNh6bZuzm8s1ceuBUnMUAeoAHHw,5,7,2,0,0,0,4,0,13,1.8571428571428572,1,0.0,4,2,0,0,3,0,0,4,0,6,7,1
5589,72527,3RFxfyZdyTuIPVV58WHND3p7FoSeVnvd,SpATywNh6bZuzm8s1ceuBUnMUAeoAHHw,1,0,0,0,0,0,1,0,1,0.14285714285714285,1,0.0,0,0,0,0,0,0,0,1,0,0,1,1
5590,72532,QPoypIc1fBONo2zEXZGrqFPP68plPMOG,A3fsA9Zfv1X2fVEQhTw51lKENdNrEqT3,63,51,2,216,1,1,22,3,296,42.285714285714285,4,0.0,6,2,164,1,45,1,52,22,3,173,123,0
5591,72540,3RFxfyZdyTuIPVV58WHND3p7FoSeVnvd,G8EPVSXsOYB5YQWZGiz1aVq5Pgr2GrQu,6,8,4,0,3,0,4,0,19,2.7142857142857144,1,0.0,0,4,0,3,8,0,0,4,0,7,12,1
5592,72547,ACrAvl4ssWNFndB2wDhI3oY0Vqi5B1FR,RXDvfPUBYFlVdlueBFbLW0mhhAyGEqpt,47,28,18,88,9,2,3,0,148,21.142857142857142,2,0.0,7,18,86,9,21,2,2,3,0,120,28,1
5593,72554,92DwnWdf0DjZODrvrNNLdxmEfzQWnu5Z,A3fsA9Zfv1X2fVEQhTw51lKENdNrEqT3,17,11,10,0,8,4,11,1,45,6.428571428571429,2,0.0,0,10,0,8,11,4,0,11,1,18,27,1
5594,72588,5fUv2a4WMEi2Bc60cQo0Uzo1I7SufPfI,SpATywNh6bZuzm8s1ceuBUnMUAeoAHHw,24,50,0,24,0,13,9,0,96,13.714285714285714,3,0.0,8,0,23,0,42,13,1,9,0,31,65,0
5595,72593,rPY59o3LLmGBPTPMGcA5vX57KVfmywv5,bWdj2GDclj5ofokWjzoa5jAwMkxCykd6,1,0,0,0,0,0,1,0,1,0.14285714285714285,1,0.0,0,0,0,0,0,0,0,1,0,0,1,1
5596,72609,qIgfmlfsBIhgTbQqqVFddAaDPPK19iKa,SpATywNh6bZuzm8s1ceuBUnMUAeoAHHw,6,6,3,0,0,0,3,0,12,1.7142857142857142,1,0.0,2,3,0,0,4,0,0,3,0,5,7,1
5597,72622,3RFxfyZdyTuIPVV58WHND3p7FoSeVnvd,A3fsA9Zfv1X2fVEQhTw51lKENdNrEqT3,1,0,0,0,0,0,1,0,1,0.14285714285714285,1,0.0,0,0,0,0,0,0,0,1,0,0,1,1
5598,72626,KQPXidcwG060yQGJPDlINxK2yFVflTSt,A3fsA9Zfv1X2fVEQhTw51lKENdNrEqT3,2,0,0,0,0,0,3,0,3,0.42857142857142855,1,0.0,0,0,0,0,0,0,0,3,0,0,3,1
5599,72636,xOB7vl3l1Tpb0i0cSWni40BfJ5FBclms,bWdj2GDclj5ofokWjzoa5jAwMkxCykd6,1,0,0,0,0,0,1,0,1,0.14285714285714285,1,0.0,0,0,0,0,0,0,0,1,0,0,1,1
5600,72659,Ikx8dqw7N29O68oP7rbQGE7AGY4iLNon,A3fsA9Zfv1X2fVEQhTw51lKENdNrEqT3,6,3,1,0,1,0,3,0,8,1.1428571428571428,1,0.0,0,1,0,1,3,0,0,3,0,2,6,1
5601,72685,2IlOpdUgsPu5FVltj0flScFk4CeI7uHm,RXDvfPUBYFlVdlueBFbLW0mhhAyGEqpt,31,29,17,26,7,7,5,0,91,13.0,4,0.0,4,17,26,7,25,7,0,5,0,54,37,0
5602,72692,H2pnCC5fUi5Ho09aPqAE97vnlsM8FGBU,A3fsA9Zfv1X2fVEQhTw51lKENdNrEqT3,66,22,12,246,2,0,9,0,291,41.57142857142857,3,0.0,4,12,237,2,18,0,9,9,0,255,36,0
5603,72701,h2ynGKkFoAy58qRjHGCAYsp0Afa0leqG,SpATywNh6bZuzm8s1ceuBUnMUAeoAHHw,6,7,0,0,0,0,6,0,13,1.8571428571428572,3,0.0,0,0,0,0,7,0,0,6,0,0,13,1
5604,72716,0VjAWG5aLQgXyXeTqTPnha195szz41mH,RXDvfPUBYFlVdlueBFbLW0mhhAyGEqpt,71,69,30,151,26,57,13,2,348,49.714285714285715,3,0.0,33,30,144,26,36,57,7,13,2,233,115,1
5605,72721,1UwRwlLE0RwxPaY5NbrfjlESNYQllZZa,A3fsA9Zfv1X2fVEQhTw51lKENdNrEqT3,18,20,8,0,6,0,8,0,42,6.0,3,0.0,0,8,0,6,20,0,0,8,0,14,28,0
5606,72726,0bJvCDj0GgBeU0HMz26Zp0pAIP7Ku0m6,G8EPVSXsOYB5YQWZGiz1aVq5Pgr2GrQu,14,13,7,0,8,0,3,0,31,4.428571428571429,1,0.0,5,7,0,8,8,0,0,3,0,20,11,0
5607,72729,gfqBONxF3vgkgkzNGOBh2NvmbBtnV553,A3fsA9Zfv1X2fVEQhTw51lKENdNrEqT3,22,17,15,0,12,0,7,0,51,7.285714285714286,1,0.0,0,15,0,12,17,0,0,7,0,27,24,1
5608,72741,CVH6urFvexNmD0aVZsmcYsZiC7ATsEWQ,SpATywNh6bZuzm8s1ceuBUnMUAeoAHHw,23,35,12,23,5,16,4,0,95,13.571428571428571,2,0.0,14,12,19,5,21,16,4,4,0,50,45,1
5609,72750,Jd5OP6GIsguRdsq9k3eSYNENmzhPbdGe,RXDvfPUBYFlVdlueBFbLW0mhhAyGEqpt,1,0,0,0,0,0,1,0,1,0.14285714285714285,1,0.0,0,0,0,0,0,0,0,1,0,0,1,1
5610,72760,V7hPLACO2aZJMGkqrqGs8iTi1dh1D640,A3fsA9Zfv1X2fVEQhTw51lKENdNrEqT3,8,3,2,0,2,1,6,0,14,2.0,1,0.0,0,2,0,2,3,1,0,6,0,4,10,1
5611,72764,Sr1toTUNefJAFbhTUg77mqKaZFTtdaV4,A3fsA9Zfv1X2fVEQhTw51lKENdNrEqT3,5,0,0,0,0,3,5,2,10,1.4285714285714286,1,0.0,0,0,0,0,0,3,0,5,2,0,10,1
5612,72794,GcYYdMUd1jTzTWqukpvr0rVRxsxU8er2,G8EPVSXsOYB5YQWZGiz1aVq5Pgr2GrQu,1,0,0,0,0,0,1,0,1,0.14285714285714285,1,0.0,0,0,0,0,0,0,0,1,0,0,1,1
5613,72811,QmwPzVmCybpAgMwyMz1fwIqSJEweIwjc,SpATywNh6bZuzm8s1ceuBUnMUAeoAHHw,12,8,5,0,3,4,5,3,28,4.0,1,0.0,1,5,0,3,7,4,0,5,3,9,19,1
5614,72814,kPOhZ6qf9bbLzunMF2utkZU62wMNJPxJ,SpATywNh6bZuzm8s1ceuBUnMUAeoAHHw,13,15,4,12,2,0,2,0,35,5.0,1,0.0,9,4,11,2,6,0,1,2,0,26,9,1
5615,72824,UZj9qZ6lkWkIz7HEEFyBh5LFRNaz4SI2,bWdj2GDclj5ofokWjzoa5jAwMkxCykd6,5,2,1,0,1,0,2,0,6,0.8571428571428571,1,0.0,0,1,0,1,2,0,0,2,0,2,4,1
5616,72844,pQdSl7i5ZuZeH9uPILgdHrvwskp4vc4V,A3fsA9Zfv1X2fVEQhTw51lKENdNrEqT3,5,2,1,0,1,0,4,0,8,1.1428571428571428,2,0.0,0,1,0,1,2,0,0,4,0,2,6,1
5617,72847,OUbh6hvaOJDp9RK7kgTBzzPmjzmkYhZF,bWdj2GDclj5ofokWjzoa5jAwMkxCykd6,11,13,1,70,0,0,8,0,92,13.142857142857142,3,0.0,1,1,68,0,12,0,2,8,0,70,22,1
5618,72850,QqE2Xjwy9gUzOvFdkDqAwAaNZLBZkxvd,G8EPVSXsOYB5YQWZGiz1aVq5Pgr2GrQu,22,34,4,0,1,18,33,1,91,13.0,12,0.0,3,4,0,1,31,18,0,33,1,8,83,1
5619,72861,uynRJ81lKSVTwiBUWysuMw4GfvXEQcj1,A3fsA9Zfv1X2fVEQhTw51lKENdNrEqT3,1,0,0,0,0,0,1,0,1,0.14285714285714285,1,0.0,0,0,0,0,0,0,0,1,0,0,1,1
5620,72878,3z37iBp19kh1LYVfVTprpt7Nc7WFUSh9,bWdj2GDclj5ofokWjzoa5jAwMkxCykd6,13,15,9,0,7,0,6,0,37,5.285714285714286,2,0.0,2,9,0,7,13,0,0,6,0,18,19,1
5621,72885,czhzfQM5hzKsjmfr33GA4a86kqhVxJHf,A3fsA9Zfv1X2fVEQhTw51lKENdNrEqT3,44,19,13,70,11,0,6,0,119,17.0,2,0.0,1,13,60,11,18,0,10,6,0,85,34,1
5622,72922,ria1rZm5v1iNiSZkl2at79lKlYWZvHeF,SpATywNh6bZuzm8s1ceuBUnMUAeoAHHw,24,51,0,21,0,45,15,2,134,19.142857142857142,4,0.0,10,0,21,0,41,45,0,15,2,31,103,0
5623,72950,5lXEnKEAbuix9ITMHrIbzKht9sQOw1oR,A3fsA9Zfv1X2fVEQhTw51lKENdNrEqT3,1,0,0,0,0,0,1,0,1,0.14285714285714285,1,0.0,0,0,0,0,0,0,0,1,0,0,1,1
5624,72951,Ou3iHiBDr7O5XF3iHhMwgAvySH9eHz42,RXDvfPUBYFlVdlueBFbLW0mhhAyGEqpt,9,8,2,0,1,0,10,0,21,3.0,3,0.0,0,2,0,1,8,0,0,10,0,3,18,1
5625,72964,rN6lunIjAbCWqlUClfGlFjDjxcPvXSQ8,G8EPVSXsOYB5YQWZGiz1aVq5Pgr2GrQu,1,0,0,0,0,0,1,0,1,0.14285714285714285,1,0.0,0,0,0,0,0,0,0,1,0,0,1,1
5626,72967,NYagfMVvA1FDdZ7PZwzv8OVDbZ0jsy8R,SpATywNh6bZuzm8s1ceuBUnMUAeoAHHw,4,2,0,0,0,1,4,0,7,1.0,3,0.0,0,0,0,0,2,1,0,4,0,0,7,1
5627,73009,l569pvTkqA1hwU8mlPA8zjV2SyK4a7w2,SpATywNh6bZuzm8s1ceuBUnMUAeoAHHw,20,45,0,34,0,1,5,0,85,12.142857142857142,4,0.0,12,0,29,0,33,1,5,5,0,41,44,0
5628,73024,LzA5wgwJJZVLbqKdv9NjOOvbbtbdWAC9,SpATywNh6bZuzm8s1ceuBUnMUAeoAHHw,5,2,1,0,1,0,2,0,6,0.8571428571428571,1,0.0,0,1,0,1,2,0,0,2,0,2,4,1
5629,73036,zcVtFTrToAbXyBSFxcFkJCnMsb7Jt1Wc,SpATywNh6bZuzm8s1ceuBUnMUAeoAHHw,7,8,4,0,0,0,3,0,15,2.142857142857143,2,0.0,0,4,0,0,8,0,0,3,0,4,11,1
5630,73080,y1PyjNePB0NOk56DVMODQe87hVVXR5yE,bWdj2GDclj5ofokWjzoa5jAwMkxCykd6,1,0,0,0,0,0,1,0,1,0.14285714285714285,1,0.0,0,0,0,0,0,0,0,1,0,0,1,1
5631,73091,bVDYKiZvgd2IcK5UYf7mO2QJtYbh5uZ8,SpATywNh6bZuzm8s1ceuBUnMUAeoAHHw,5,2,1,0,1,0,2,0,6,0.8571428571428571,1,0.0,0,1,0,1,2,0,0,2,0,2,4,1
5632,73105,O2ctwJV4MPvP5qTfQJUUGlNEKgJxJSl6,G8EPVSXsOYB5YQWZGiz1aVq5Pgr2GrQu,1,0,0,0,0,0,1,0,1,0.14285714285714285,1,0.0,0,0,0,0,0,0,0,1,0,0,1,1
5633,73141,YWIcWPk2owvGQjJvioCvuMwwhqp9Hu6o,SpATywNh6bZuzm8s1ceuBUnMUAeoAHHw,2,0,0,0,0,0,2,0,2,0.2857142857142857,1,0.0,0,0,0,0,0,0,0,2,0,0,2,1
5634,73173,afdo7sttc7aaNvz9ca7YCfhlkfRUdKCm,SpATywNh6bZuzm8s1ceuBUnMUAeoAHHw,1,0,0,0,0,0,3,0,3,0.42857142857142855,1,0.0,0,0,0,0,0,0,0,3,0,0,3,1
5635,73180,uoufNidjh1zD724gB2zYdd5MROgtTWHO,A3fsA9Zfv1X2fVEQhTw51lKENdNrEqT3,29,34,27,0,24,0,3,0,88,12.571428571428571,2,0.0,1,27,0,24,33,0,0,3,0,52,36,1
5636,73500,m7jLYh84m9f53uDPmmpRCKYuGkwpenOB,fbPkOYLVPtPgIt0MxizjfFJov3JbHyAi,7,5,2,0,2,0,2,0,11,1.5714285714285714,1,0.0,2,2,0,2,3,0,0,2,0,6,5,1
5637,73514,eAreSTsX7Dih2J54vyrFl8ByPnikZNX4,fbPkOYLVPtPgIt0MxizjfFJov3JbHyAi,47,72,31,35,21,47,20,2,228,32.57142857142857,5,0.0,26,31,30,21,46,47,5,20,2,108,120,0
5638,73521,tZsZwfZKEwgih9HC8eRqwpFt6sEwssno,fbPkOYLVPtPgIt0MxizjfFJov3JbHyAi,8,5,3,0,2,0,3,0,13,1.8571428571428572,1,0.0,0,3,0,2,5,0,0,3,0,5,8,0
5639,73551,tpXvTahACNQY51r2DDxBjRZh56EvpTZe,fbPkOYLVPtPgIt0MxizjfFJov3JbHyAi,10,6,3,0,3,3,9,1,25,3.5714285714285716,1,0.0,2,3,0,3,4,3,0,9,1,8,17,1
5640,73885,zlC9nEdRrqLSPX386Mctiz9fIdlU29GI,7GRhBDsirIGkRZBtSMEzNTyDr2JQm4xx,71,109,44,44,52,0,4,0,253,36.142857142857146,4,0.0,60,44,41,52,49,0,3,4,0,197,56,1
5641,73899,4hEMELZWHLOm7hvjgIF8HpEdrI7mKYR9,7GRhBDsirIGkRZBtSMEzNTyDr2JQm4xx,1,0,0,0,0,0,4,0,4,0.5714285714285714,1,0.0,0,0,0,0,0,0,0,4,0,0,4,1
5642,73907,u40Wnz941IKPEKg6evh8MfJNEbnPlztD,7GRhBDsirIGkRZBtSMEzNTyDr2JQm4xx,1,0,0,0,0,0,1,0,1,0.14285714285714285,1,0.0,0,0,0,0,0,0,0,1,0,0,1,1
5643,73909,SQIuOWvxkt3YnLUzk8J5rhFP8qdbWUct,7GRhBDsirIGkRZBtSMEzNTyDr2JQm4xx,9,9,1,0,1,0,6,2,19,2.7142857142857144,1,0.0,4,1,0,1,5,0,0,6,2,6,13,1
5644,73914,nBvjxfottsOCrOycyCAN2ZrAK5pyyTJB,7GRhBDsirIGkRZBtSMEzNTyDr2JQm4xx,1,0,0,0,0,0,1,0,1,0.14285714285714285,1,0.0,0,0,0,0,0,0,0,1,0,0,1,1
5645,73925,QJJ8wBq7nom8t0h6F4ecboFqFhwa246L,7GRhBDsirIGkRZBtSMEzNTyDr2JQm4xx,1,0,0,0,0,0,2,0,2,0.2857142857142857,1,0.0,0,0,0,0,0,0,0,2,0,0,2,1
5646,73926,MrlzmdVJr5WOflJfAlRUbmdI8vfVUpTE,7GRhBDsirIGkRZBtSMEzNTyDr2JQm4xx,7,4,1,2,1,0,2,0,10,1.4285714285714286,1,0.0,1,1,2,1,3,0,0,2,0,5,5,1
5647,73937,28W5CJrYp73LQgjHivjzAixkCQuqTCh6,A3fsA9Zfv1X2fVEQhTw51lKENdNrEqT3,28,44,19,0,15,1,6,0,85,12.142857142857142,3,0.0,0,19,0,15,44,1,0,6,0,34,51,0
5648,73941,vaBnFuKrFzaRvpuQOGO2KMutesPcXn34,SpATywNh6bZuzm8s1ceuBUnMUAeoAHHw,27,35,14,31,5,2,7,1,95,13.571428571428571,4,0.0,15,14,27,5,20,2,4,7,1,61,34,0
5649,73951,7nQB7cjVdr2HijR82OoX1oMRPa42JjfY,7GRhBDsirIGkRZBtSMEzNTyDr2JQm4xx,11,4,2,4,2,0,5,0,17,2.4285714285714284,1,0.0,1,2,3,2,3,0,1,5,0,8,9,1
5650,73970,j32U9Y949ZW1nXMwG0aPWZXCmluBzel9,7GRhBDsirIGkRZBtSMEzNTyDr2JQm4xx,3,4,1,0,0,0,2,0,7,1.0,2,0.0,0,1,0,0,4,0,0,2,0,1,6,1
5651,73972,fK0ybxlrUhmgrAr6gFQPIfSHLrJ4RdyL,7GRhBDsirIGkRZBtSMEzNTyDr2JQm4xx,27,49,16,32,12,0,10,0,119,17.0,1,0.0,27,16,29,12,22,0,3,10,0,84,35,1
5652,73975,YmZgT8JqU8nh2NPc6NVlnnDgPwwbycrT,SpATywNh6bZuzm8s1ceuBUnMUAeoAHHw,17,19,9,19,6,0,2,0,55,7.857142857142857,3,0.0,6,9,17,6,13,0,2,2,0,38,17,0
5653,73976,7mxOgTUP9lSjAUBOPZ9fhNEhVSHMvF2J,A3fsA9Zfv1X2fVEQhTw51lKENdNrEqT3,9,9,5,0,0,0,8,0,22,3.142857142857143,3,0.0,0,5,0,0,9,0,0,8,0,5,17,0
5654,74004,obFplu8p0J5bdsesTSoaj6Bc4UGbTB6M,7GRhBDsirIGkRZBtSMEzNTyDr2JQm4xx,1,0,0,0,0,0,2,0,2,0.2857142857142857,1,0.0,0,0,0,0,0,0,0,2,0,0,2,1
5655,74009,obFplu8p0J5bdsesTSoaj6Bc4UGbTB6M,bWdj2GDclj5ofokWjzoa5jAwMkxCykd6,1,0,0,0,0,0,1,0,1,0.14285714285714285,1,0.0,0,0,0,0,0,0,0,1,0,0,1,1
5656,74012,1rnRBDe6QdlyFMXjNKkPkQwNjoqRhDMp,SpATywNh6bZuzm8s1ceuBUnMUAeoAHHw,16,22,10,26,0,4,7,0,69,9.857142857142858,2,0.0,7,10,25,0,15,4,1,7,0,42,27,0
5657,74017,2kb07SQlxjCbOTE1DAO38U9f5IsTds9o,7GRhBDsirIGkRZBtSMEzNTyDr2JQm4xx,10,6,4,0,4,0,2,0,16,2.2857142857142856,1,0.0,0,4,0,4,6,0,0,2,0,8,8,1
5658,74024,EPmLjBxeWpwhjwoRgtmLV8RkhFOu2zzj,7GRhBDsirIGkRZBtSMEzNTyDr2JQm4xx,2,0,0,0,0,0,2,0,2,0.2857142857142857,1,0.0,0,0,0,0,0,0,0,2,0,0,2,1
5659,74026,zQ1YX4nsnROAkBYQ0FJFP0QSnhVmUslT,7GRhBDsirIGkRZBtSMEzNTyDr2JQm4xx,1,0,0,0,0,0,1,0,1,0.14285714285714285,1,0.0,0,0,0,0,0,0,0,1,0,0,1,1
5660,74040,CopXShP3zDILDEKJnKili2vT6Sl9AJnD,SpATywNh6bZuzm8s1ceuBUnMUAeoAHHw,2,0,0,0,0,0,2,0,2,0.2857142857142857,1,0.0,0,0,0,0,0,0,0,2,0,0,2,1
5661,74042,vQAS0obh0bWlfi2VaK7gKWVKUzPkWalY,7GRhBDsirIGkRZBtSMEzNTyDr2JQm4xx,7,2,1,0,1,0,4,0,8,1.1428571428571428,1,0.0,0,1,0,1,2,0,0,4,0,2,6,1
5662,74046,vQAS0obh0bWlfi2VaK7gKWVKUzPkWalY,bWdj2GDclj5ofokWjzoa5jAwMkxCykd6,6,2,1,0,1,0,3,0,7,1.0,1,0.0,0,1,0,1,2,0,0,3,0,2,5,1
5663,74052,2TaYh8ycp9sh1x4LkBWnthNJDMCHE85T,7GRhBDsirIGkRZBtSMEzNTyDr2JQm4xx,29,59,20,46,16,1,8,0,150,21.428571428571427,2,0.0,31,20,37,16,28,1,9,8,0,104,46,1
5664,74059,TRGa3GfGhognO7jXiVPcSrWpnBuIeInO,7GRhBDsirIGkRZBtSMEzNTyDr2JQm4xx,7,7,5,0,0,0,3,0,15,2.142857142857143,1,0.0,0,5,0,0,7,0,0,3,0,5,10,1
5665,74075,DfnO2Gp0WpLIOOGCReKHPkH7dv25s88Q,7GRhBDsirIGkRZBtSMEzNTyDr2JQm4xx,1,0,0,0,0,0,1,0,1,0.14285714285714285,1,0.0,0,0,0,0,0,0,0,1,0,0,1,1
5666,74078,yqOOYx1jXUdpDzqGMMXJAQVE6fglCaFI,7GRhBDsirIGkRZBtSMEzNTyDr2JQm4xx,2,0,0,0,0,0,3,0,3,0.42857142857142855,1,0.0,0,0,0,0,0,0,0,3,0,0,3,1
5667,74086,a4naBAZCHNqdVKKeEiKQVvfTN6r4f6eG,bWdj2GDclj5ofokWjzoa5jAwMkxCykd6,9,12,6,42,4,4,6,1,75,10.714285714285714,1,0.0,3,6,41,4,9,4,1,6,1,54,21,1
5668,74095,f66qV2E6gvO4HMZXdbtN6yW4m9klwB2A,7GRhBDsirIGkRZBtSMEzNTyDr2JQm4xx,2,0,0,0,0,0,2,0,2,0.2857142857142857,1,0.0,0,0,0,0,0,0,0,2,0,0,2,1
5669,74114,OakZIwMalw5UgG2N0rTydClOEPiV8rki,SpATywNh6bZuzm8s1ceuBUnMUAeoAHHw,23,27,15,4,8,0,5,0,59,8.428571428571429,2,0.0,0,15,4,8,27,0,0,5,0,27,32,0
5670,74115,NFrovzSNFaGOKX4ckxlOk5TIATwQWZDv,SpATywNh6bZuzm8s1ceuBUnMUAeoAHHw,31,67,36,50,11,23,24,3,214,30.571428571428573,3,0.0,18,36,37,11,49,23,13,24,3,102,112,0
5671,74117,ehQYO42YZfN9JqdFqKxgBFmu1fmVCsCo,7GRhBDsirIGkRZBtSMEzNTyDr2JQm4xx,8,1,1,0,1,3,9,0,15,2.142857142857143,1,0.0,0,1,0,1,1,3,0,9,0,2,13,1
5672,74121,Ym1ZTRs6QB0e3lMSh4qwLaB0p6ohf0Ak,RXDvfPUBYFlVdlueBFbLW0mhhAyGEqpt,68,80,38,99,32,7,8,0,264,37.714285714285715,4,0.0,32,38,87,32,48,7,12,8,0,189,75,0
5673,74122,MkhWkWrDBg7jFp3XklVC8uZQ46nAon3u,7GRhBDsirIGkRZBtSMEzNTyDr2JQm4xx,16,40,15,8,3,0,7,0,73,10.428571428571429,4,0.0,5,15,6,3,35,0,2,7,0,29,44,1
5674,74123,AisGNT34d6x1DicMgidteYUWukPQUQ7X,7GRhBDsirIGkRZBtSMEzNTyDr2JQm4xx,1,0,0,0,0,0,2,0,2,0.2857142857142857,2,0.0,0,0,0,0,0,0,0,2,0,0,2,1
5675,74136,ogJhjZ6JRse1i9Rm200W41y6knKdib4X,7GRhBDsirIGkRZBtSMEzNTyDr2JQm4xx,7,3,2,0,2,0,2,0,9,1.2857142857142858,1,0.0,0,2,0,2,3,0,0,2,0,4,5,1
5676,74160,fkpoiY9BcwTpPdjkd5ID0mAyCrJQOIvN,7GRhBDsirIGkRZBtSMEzNTyDr2JQm4xx,7,3,2,0,2,0,2,0,9,1.2857142857142858,1,0.0,0,2,0,2,3,0,0,2,0,4,5,1
5677,74224,s8rbNwiDb6Ued6nUvpbwuDl2s256fOiD,SpATywNh6bZuzm8s1ceuBUnMUAeoAHHw,10,7,0,12,0,0,3,0,22,3.142857142857143,1,0.0,2,0,9,0,5,0,3,3,0,11,11,1
5678,74245,2ZDZeGxlSkOYdQNOELblzmlZJh9Z3y1x,SpATywNh6bZuzm8s1ceuBUnMUAeoAHHw,13,17,14,6,8,0,3,0,48,6.857142857142857,2,0.0,0,14,5,8,17,0,1,3,0,27,21,0
5679,74262,USFNJQ0DS4O3ARJSYADvtg2Aw3GLb3J9,SpATywNh6bZuzm8s1ceuBUnMUAeoAHHw,10,11,4,7,2,0,3,0,27,3.857142857142857,3,0.0,0,4,6,2,11,0,1,3,0,12,15,1
5680,74268,NFrovzSNFaGOKX4ckxlOk5TIATwQWZDv,RXDvfPUBYFlVdlueBFbLW0mhhAyGEqpt,57,45,31,96,18,2,9,1,202,28.857142857142858,3,0.0,9,31,86,18,36,2,10,9,1,144,58,1
5681,74275,Qr56xJpKpx3PDtASRPf6XQoHmcGp3CKT,7GRhBDsirIGkRZBtSMEzNTyDr2JQm4xx,1,0,0,0,0,0,3,0,3,0.42857142857142855,2,0.0,0,0,0,0,0,0,0,3,0,0,3,1
5682,74292,a4RYqILKcnu8c617gYSbD0KQIm9DqZnc,7GRhBDsirIGkRZBtSMEzNTyDr2JQm4xx,7,4,2,2,2,0,1,0,11,1.5714285714285714,1,0.0,1,2,2,2,3,0,0,1,0,7,4,1
5683,74293,1484VvY7Fi4yz6Sx6JQlO6okKw4a6Bw6,7GRhBDsirIGkRZBtSMEzNTyDr2JQm4xx,3,3,0,0,0,0,1,0,4,0.5714285714285714,1,0.0,0,0,0,0,3,0,0,1,0,0,4,1
5684,74302,Na52PtAqm4VlTMUv1OPLGNjij0a5votC,7GRhBDsirIGkRZBtSMEzNTyDr2JQm4xx,6,7,3,4,1,0,1,0,16,2.2857142857142856,1,0.0,1,3,3,1,6,0,1,1,0,8,8,1
5685,74323,fCmdFT6vVaKttJ0wsJVd3YILMXjqgUpl,7GRhBDsirIGkRZBtSMEzNTyDr2JQm4xx,8,8,4,0,3,0,4,0,19,2.7142857142857144,1,0.0,2,4,0,3,6,0,0,4,0,9,10,1
5686,74329,vCnaR7A3EMdV2eOQ4pBMh0byIjK5VwLE,SpATywNh6bZuzm8s1ceuBUnMUAeoAHHw,4,6,0,0,0,0,2,0,8,1.1428571428571428,3,0.0,0,0,0,0,6,0,0,2,0,0,8,1
5687,74333,Dc9OIUGhQBh3pdZe3Ppn36a1Oo81Nm8J,RXDvfPUBYFlVdlueBFbLW0mhhAyGEqpt,5,3,0,0,0,0,2,0,5,0.7142857142857143,1,0.0,0,0,0,0,3,0,0,2,0,0,5,1
5688,74342,GCXdwkqD60eGG5W317sN3ZNf27MOQY4U,7GRhBDsirIGkRZBtSMEzNTyDr2JQm4xx,1,0,0,0,0,0,1,0,1,0.14285714285714285,1,0.0,0,0,0,0,0,0,0,1,0,0,1,1
5689,74361,TvtViclCsd2PmV5PrW2DKEwPmoLOSaRh,7GRhBDsirIGkRZBtSMEzNTyDr2JQm4xx,16,23,1,11,2,0,3,0,40,5.714285714285714,2,0.0,6,1,10,2,17,0,1,3,0,19,21,1
5690,74375,pOkvcIFcOLnKHqzWe7X68PwdTZWgfXNn,7GRhBDsirIGkRZBtSMEzNTyDr2JQm4xx,26,46,15,20,8,1,3,0,93,13.285714285714286,1,0.0,15,15,20,8,31,1,0,3,0,58,35,1
5691,74376,uhOpSMle6LWQUtiKJ61AGF4uUuGwyCQB,7GRhBDsirIGkRZBtSMEzNTyDr2JQm4xx,7,6,1,0,1,0,3,0,11,1.5714285714285714,2,0.0,0,1,0,1,6,0,0,3,0,2,9,1
5692,74385,PiugBYfME8MQpTzoS0G5QvEJsAm89oP5,7GRhBDsirIGkRZBtSMEzNTyDr2JQm4xx,9,5,1,4,2,3,9,1,25,3.5714285714285716,1,0.0,3,1,3,2,2,3,1,9,1,9,16,1
5693,74397,FzKYBP9DQh3u0w9lQRHJGeubpb75FItD,A3fsA9Zfv1X2fVEQhTw51lKENdNrEqT3,9,7,1,0,0,0,7,1,16,2.2857142857142856,1,0.0,0,1,0,0,7,0,0,7,1,1,15,0
5694,74412,vX9PpvehRTgTkIr6tSKODV93gbmBGfye,7GRhBDsirIGkRZBtSMEzNTyDr2JQm4xx,1,0,0,0,0,0,3,0,3,0.42857142857142855,2,0.0,0,0,0,0,0,0,0,3,0,0,3,1
5695,74417,pZeZwcDZvDaUYfNrM0JBq16CcPqoVjAy,7GRhBDsirIGkRZBtSMEzNTyDr2JQm4xx,2,0,0,0,0,0,2,0,2,0.2857142857142857,1,0.0,0,0,0,0,0,0,0,2,0,0,2,1
5696,74432,iB2CzgEKP1k7rQZEzYQoAPIRp7dEItA4,7GRhBDsirIGkRZBtSMEzNTyDr2JQm4xx,14,16,8,12,8,0,2,0,46,6.571428571428571,1,0.0,6,8,11,8,10,0,1,2,0,33,13,1
5697,74441,grxgFxuiaSTlMIk1kWcHwbLAYZVnIvkA,7GRhBDsirIGkRZBtSMEzNTyDr2JQm4xx,10,9,3,0,3,0,3,0,18,2.5714285714285716,1,0.0,0,3,0,3,9,0,0,3,0,6,12,1
5698,74453,XKfrMCVtqlIZ8enVJyGd7DD1q7PXaYx0,bWdj2GDclj5ofokWjzoa5jAwMkxCykd6,8,3,0,0,0,0,5,1,9,1.2857142857142858,1,0.0,0,0,0,0,3,0,0,5,1,0,9,1
5699,74455,PRNejdeVNKfxLUk8kGMRZmgBIyh1R45g,7GRhBDsirIGkRZBtSMEzNTyDr2JQm4xx,5,2,1,0,1,0,2,0,6,0.8571428571428571,1,0.0,0,1,0,1,2,0,0,2,0,2,4,1
5700,74456,2ZaLqb29uQ5ksFfqfhamJxjvg9jGJ9Ay,7GRhBDsirIGkRZBtSMEzNTyDr2JQm4xx,5,3,0,0,0,0,3,0,6,0.8571428571428571,1,0.0,0,0,0,0,3,0,0,3,0,0,6,1
5701,74461,z2UutrDxctGBl3XhV09hNxXdsZmqDZvY,A3fsA9Zfv1X2fVEQhTw51lKENdNrEqT3,29,35,27,2,18,40,22,1,145,20.714285714285715,4,0.0,3,27,2,18,32,40,0,22,1,50,95,1
5702,74462,dT92IjRcuruPiAlpqVUTtu3wNL9IIegT,7GRhBDsirIGkRZBtSMEzNTyDr2JQm4xx,4,0,0,0,0,0,3,1,4,0.5714285714285714,1,0.0,0,0,0,0,0,0,0,3,1,0,4,1
5703,74483,SP7hg1EWo2mZkHuxZFtI4Vbcyr5vcP4h,SpATywNh6bZuzm8s1ceuBUnMUAeoAHHw,10,12,4,14,1,0,6,0,37,5.285714285714286,4,0.0,4,4,13,1,8,0,1,6,0,22,15,0
5704,74500,spNi8Q5WiDgxakh0uckmQbexani6DCOh,7GRhBDsirIGkRZBtSMEzNTyDr2JQm4xx,20,23,7,12,6,0,2,0,50,7.142857142857143,2,0.0,8,7,12,6,15,0,0,2,0,33,17,1
5705,74506,M3qc1xm79CLjiw98zxp89bImiVSCJcDh,7GRhBDsirIGkRZBtSMEzNTyDr2JQm4xx,1,0,0,0,0,0,1,0,1,0.14285714285714285,1,0.0,0,0,0,0,0,0,0,1,0,0,1,1
5706,74516,KaBv8PoJ8OVsLIkZYrjM1X6uYKyRrniG,7GRhBDsirIGkRZBtSMEzNTyDr2JQm4xx,8,8,2,0,3,0,3,0,16,2.2857142857142856,1,0.0,5,2,0,3,3,0,0,3,0,10,6,1
5707,74522,ZYGzPhdrKsCQft8z3gUrz2GR31kmqGY8,SpATywNh6bZuzm8s1ceuBUnMUAeoAHHw,30,70,33,33,9,37,10,1,193,27.571428571428573,4,0.0,25,33,28,9,45,37,5,10,1,95,98,0
5708,74526,qwopEmmu52GEF4KxBC26RpTkcwtY07S9,SpATywNh6bZuzm8s1ceuBUnMUAeoAHHw,16,28,11,17,5,1,10,0,72,10.285714285714286,2,0.0,13,11,15,5,15,1,2,10,0,44,28,0
5709,74537,p64MOtUXpLiy07h6B0dKNFYMkAVaqQ98,7GRhBDsirIGkRZBtSMEzNTyDr2JQm4xx,2,0,0,0,0,0,4,0,4,0.5714285714285714,1,0.0,0,0,0,0,0,0,0,4,0,0,4,1
5710,74541,HbmZzALzRW0CJmaD07o1oMpvJwGgfjK4,bWdj2GDclj5ofokWjzoa5jAwMkxCykd6,3,2,0,0,0,0,1,0,3,0.42857142857142855,1,0.0,0,0,0,0,2,0,0,1,0,0,3,1
5711,74548,HF98YPKzT8oi2j9flZW9kstZcvL3ZimG,A3fsA9Zfv1X2fVEQhTw51lKENdNrEqT3,36,38,16,74,6,0,3,0,137,19.571428571428573,3,0.0,1,16,63,6,37,0,11,3,0,86,51,1
5712,74560,Q0d1WItnRJvnzlnn5VcAU6GMGN4rfbYJ,7GRhBDsirIGkRZBtSMEzNTyDr2JQm4xx,1,0,0,0,0,0,1,0,1,0.14285714285714285,1,0.0,0,0,0,0,0,0,0,1,0,0,1,1
5713,74603,A5la8pvW0tLLXP6HSr61aMxUll9fPTHI,7GRhBDsirIGkRZBtSMEzNTyDr2JQm4xx,11,5,2,4,3,0,10,0,24,3.4285714285714284,1,0.0,3,2,3,3,2,0,1,10,0,11,13,1
5714,74612,T8yZ978Owo7xSmEVFbiCM8j5K4ntSTo2,7GRhBDsirIGkRZBtSMEzNTyDr2JQm4xx,1,0,0,0,0,0,1,0,1,0.14285714285714285,1,0.0,0,0,0,0,0,0,0,1,0,0,1,1
5715,74644,NoceYrOX1tWqokyDfvqtevfQbA2rhFqB,SpATywNh6bZuzm8s1ceuBUnMUAeoAHHw,5,5,3,0,2,0,2,0,12,1.7142857142857142,1,0.0,0,3,0,2,5,0,0,2,0,5,7,0
5716,74650,usRZSdDsUQfZaciTJTskV4NLSeP1lHRl,7GRhBDsirIGkRZBtSMEzNTyDr2JQm4xx,14,22,4,14,6,13,8,1,68,9.714285714285714,1,0.0,10,4,11,6,12,13,3,8,1,31,37,1
5717,74697,RYEl9qV5WolRR4P8IF9M1gxceAzD6Axt,SpATywNh6bZuzm8s1ceuBUnMUAeoAHHw,17,24,10,25,3,35,7,0,104,14.857142857142858,2,0.0,12,10,21,3,12,35,4,7,0,46,58,1
5718,74712,ZudgpcrDV2RrJQUR1YBw9q8iUT5VbCHi,RXDvfPUBYFlVdlueBFbLW0mhhAyGEqpt,19,16,8,32,8,0,3,0,67,9.571428571428571,2,0.0,6,8,28,8,10,0,4,3,0,50,17,0
5719,74723,bLurC9srutCM4k4gLSsbzYrz2ihcIC86,7GRhBDsirIGkRZBtSMEzNTyDr2JQm4xx,6,3,1,0,1,0,4,0,9,1.2857142857142858,1,0.0,0,1,0,1,3,0,0,4,0,2,7,1
5720,74725,dg1KWi5LRRms7lQMyP0ii5Pv3KonWqiG,7GRhBDsirIGkRZBtSMEzNTyDr2JQm4xx,30,40,22,40,13,1,20,1,137,19.571428571428573,4,0.0,9,22,35,13,31,1,5,20,1,79,58,1
5721,74737,xMjaHywxqKHoEbgcAEYnpZkLLGRuzCTC,SpATywNh6bZuzm8s1ceuBUnMUAeoAHHw,25,67,15,24,9,7,14,0,136,19.428571428571427,5,0.0,12,15,18,9,55,7,6,14,0,54,82,0
5722,74739,WnGoJ0X05nmmcr9OBuNGFmD5r4EVF1g6,A3fsA9Zfv1X2fVEQhTw51lKENdNrEqT3,15,12,8,0,5,18,9,1,53,7.571428571428571,2,0.0,0,8,0,5,12,18,0,9,1,13,40,0
5723,74778,bYD2u7vuN3G54awyDYPdRiZI3O4zw6kx,G8EPVSXsOYB5YQWZGiz1aVq5Pgr2GrQu,5,3,2,0,1,0,2,0,8,1.1428571428571428,1,0.0,0,2,0,1,3,0,0,2,0,3,5,1
5724,74815,LFkf4WR1XfFwr3RF5erdei3F4d3PlupD,7GRhBDsirIGkRZBtSMEzNTyDr2JQm4xx,2,0,0,0,0,0,2,0,2,0.2857142857142857,1,0.0,0,0,0,0,0,0,0,2,0,0,2,1
5725,74840,FvY4K2RN2da3T8MEGlPk2LmHUIxOyg0h,SpATywNh6bZuzm8s1ceuBUnMUAeoAHHw,17,23,11,14,8,18,5,0,79,11.285714285714286,3,0.0,7,11,13,8,16,18,1,5,0,39,40,0
5726,74852,0wpgF8T87E4lIPjqoh0AkxyomANfbalw,7GRhBDsirIGkRZBtSMEzNTyDr2JQm4xx,1,0,0,0,0,0,1,0,1,0.14285714285714285,1,0.0,0,0,0,0,0,0,0,1,0,0,1,1
5727,74855,pTjlgRGlVEY0q8gZSgoQhD2BjMBUQLrl,SpATywNh6bZuzm8s1ceuBUnMUAeoAHHw,11,4,3,0,2,1,10,2,22,3.142857142857143,1,0.0,0,3,0,2,4,1,0,10,2,5,17,1
5728,74858,mB36rXDIKgGQROGEKlrDrvsLRYA6xyWr,bWdj2GDclj5ofokWjzoa5jAwMkxCykd6,1,0,0,0,0,0,1,0,1,0.14285714285714285,1,0.0,0,0,0,0,0,0,0,1,0,0,1,1
5729,74862,iNVrCH89sJttoddUpv5O2bH5LrAKlFHk,SpATywNh6bZuzm8s1ceuBUnMUAeoAHHw,7,4,3,0,3,0,2,0,12,1.7142857142857142,1,0.0,0,3,0,3,4,0,0,2,0,6,6,1
5730,74865,WlLtmSTcQZkOIIH38SOYOKYSBYpp2ymS,7GRhBDsirIGkRZBtSMEzNTyDr2JQm4xx,1,0,0,0,0,0,1,0,1,0.14285714285714285,1,0.0,0,0,0,0,0,0,0,1,0,0,1,1
5731,74867,IePFEx0pR5xLGQlWWjU59zR6qxTHOeo0,7GRhBDsirIGkRZBtSMEzNTyDr2JQm4xx,1,0,0,0,0,0,2,0,2,0.2857142857142857,2,0.0,0,0,0,0,0,0,0,2,0,0,2,1
5732,74868,Ob4gv0EanZge2ZoC1mjpKSlZhrSnoOS3,SpATywNh6bZuzm8s1ceuBUnMUAeoAHHw,4,2,1,0,1,0,1,0,5,0.7142857142857143,2,0.0,0,1,0,1,2,0,0,1,0,2,3,0
5733,74874,CjjbRPpHR9Bj7mz7vlCMGl56lBOfuzeG,7GRhBDsirIGkRZBtSMEzNTyDr2JQm4xx,1,0,0,0,0,0,1,0,1,0.14285714285714285,1,0.0,0,0,0,0,0,0,0,1,0,0,1,1
5734,74887,YnXdaRteqU5oS01NC3H96Vynlp7riJjN,7GRhBDsirIGkRZBtSMEzNTyDr2JQm4xx,5,2,1,0,1,0,2,0,6,0.8571428571428571,1,0.0,0,1,0,1,2,0,0,2,0,2,4,1
5735,74888,hB4yTUnQMne1LtjUUKgpcnhj6jq7S5Co,7GRhBDsirIGkRZBtSMEzNTyDr2JQm4xx,68,94,39,84,37,2,13,0,269,38.42857142857143,6,0.0,40,39,76,37,54,2,8,13,0,192,77,0
5736,74890,ZqjoiK6u3Oz9EZH4lOkXjinyTZauCj8B,7GRhBDsirIGkRZBtSMEzNTyDr2JQm4xx,4,3,1,0,0,0,2,0,6,0.8571428571428571,1,0.0,0,1,0,0,3,0,0,2,0,1,5,1
5737,74903,Y0dbTriNAgSzbrnkzFHfTSZPt5kDzGfo,7GRhBDsirIGkRZBtSMEzNTyDr2JQm4xx,55,128,4,181,22,11,14,0,360,51.42857142857143,5,0.0,71,4,163,22,57,11,18,14,0,260,100,1
5738,74911,KXR3u54SykbWYMuF2sF6lcMFs68otiQO,SpATywNh6bZuzm8s1ceuBUnMUAeoAHHw,31,61,28,33,10,9,13,0,154,22.0,6,0.0,19,28,29,10,42,9,4,13,0,86,68,0
5739,74913,uFxbwM61ZWFC5xnxVOlmiGXCTyHmK3HX,bWdj2GDclj5ofokWjzoa5jAwMkxCykd6,8,5,3,0,2,9,6,1,26,3.7142857142857144,1,0.0,0,3,0,2,5,9,0,6,1,5,21,1
5740,74917,iFkbfunFypPiiZAClHyDLR02ievAgqRo,7GRhBDsirIGkRZBtSMEzNTyDr2JQm4xx,8,5,3,2,3,0,2,0,15,2.142857142857143,1,0.0,1,3,2,3,4,0,0,2,0,9,6,1
5741,74921,S6vBzHKpSh31SFGGZmwgKaOH2RvW3RpH,7GRhBDsirIGkRZBtSMEzNTyDr2JQm4xx,10,10,6,3,6,2,10,0,37,5.285714285714286,1,0.0,3,6,3,6,7,2,0,10,0,18,19,1
5742,74932,zaNavQl8vjpykftGiklyCQVgYYsAGELI,7GRhBDsirIGkRZBtSMEzNTyDr2JQm4xx,9,4,3,0,3,0,2,0,12,1.7142857142857142,1,0.0,0,3,0,3,4,0,0,2,0,6,6,1
5743,74934,knxAJpSFDgjN8jBmnCV7BB7s4fbgoTt1,SpATywNh6bZuzm8s1ceuBUnMUAeoAHHw,17,15,8,15,1,13,9,1,62,8.857142857142858,2,0.0,2,8,13,1,13,13,2,9,1,24,38,0
5744,74963,jt6cAnJpqYCiS3Lj5wNBvifs8WZJznlF,7GRhBDsirIGkRZBtSMEzNTyDr2JQm4xx,5,2,1,0,1,0,2,0,6,0.8571428571428571,1,0.0,0,1,0,1,2,0,0,2,0,2,4,1
5745,74990,RbewLSSgBXbMSLEvzESHw0b6pdUZ0dT1,7GRhBDsirIGkRZBtSMEzNTyDr2JQm4xx,4,2,1,0,1,0,1,0,5,0.7142857142857143,1,0.0,0,1,0,1,2,0,0,1,0,2,3,1
5746,75002,0FC20UDeWvUi5UrOg2NVCepKkW4oulyY,SpATywNh6bZuzm8s1ceuBUnMUAeoAHHw,22,23,10,32,3,11,8,1,88,12.571428571428571,3,0.0,10,10,29,3,13,11,3,8,1,52,36,1
5747,75008,s2svupUO1VMo8YfeGdH5qCtTY141gV4e,7GRhBDsirIGkRZBtSMEzNTyDr2JQm4xx,16,41,1,4,5,1,13,0,65,9.285714285714286,2,0.0,18,1,3,5,23,1,1,13,0,27,38,1
5748,75076,Oa5Z9qxxvzPY6Y4pD2DPDPqyzdKPou5A,7GRhBDsirIGkRZBtSMEzNTyDr2JQm4xx,5,7,2,0,1,0,1,0,11,1.5714285714285714,1,0.0,3,2,0,1,4,0,0,1,0,6,5,1
5749,75083,WFdKiZBTbeCiiw3YIeAU1XWn0P3M4cOn,7GRhBDsirIGkRZBtSMEzNTyDr2JQm4xx,1,0,0,0,0,0,1,0,1,0.14285714285714285,1,0.0,0,0,0,0,0,0,0,1,0,0,1,1
5750,75093,Wcbtj2ddFRjLWK9tTZ7uzCDmpegrAZ78,A3fsA9Zfv1X2fVEQhTw51lKENdNrEqT3,61,33,22,104,13,2,15,1,190,27.142857142857142,4,0.0,3,22,92,13,30,2,12,15,1,130,60,0
5751,75102,7PsSHlEYnB89Jan9VqppndjNHL90G8j5,7GRhBDsirIGkRZBtSMEzNTyDr2JQm4xx,1,0,0,0,0,0,3,0,3,0.42857142857142855,3,0.0,0,0,0,0,0,0,0,3,0,0,3,1
5752,75108,35ygmhgWZR3Rp3zgk5PM9pjJe8hJeFw2,G8EPVSXsOYB5YQWZGiz1aVq5Pgr2GrQu,22,22,14,20,9,6,7,1,79,11.285714285714286,2,0.0,4,14,19,9,18,6,1,7,1,46,33,0
5753,75120,H2nT05aeA6Q1zZKHa66kquyct5PT5SXn,SpATywNh6bZuzm8s1ceuBUnMUAeoAHHw,21,40,2,18,0,21,6,0,87,12.428571428571429,4,0.0,16,2,18,0,24,21,0,6,0,36,51,0
5754,75208,EsXr4Om7Vwi1sKSVuaosexmk6LU6FCZi,SpATywNh6bZuzm8s1ceuBUnMUAeoAHHw,12,13,8,0,6,2,8,0,37,5.285714285714286,1,0.0,0,8,0,6,13,2,0,8,0,14,23,0
5755,75218,loLM1q927UBCE6cjZ1Vielkh2VBpufUl,7GRhBDsirIGkRZBtSMEzNTyDr2JQm4xx,2,0,0,0,0,0,2,0,2,0.2857142857142857,1,0.0,0,0,0,0,0,0,0,2,0,0,2,1
5756,75237,RFr9TyIVEW42bBHoptkHxr0bo57RDi2m,7GRhBDsirIGkRZBtSMEzNTyDr2JQm4xx,60,109,32,116,27,42,23,2,351,50.142857142857146,2,0.0,76,32,99,27,33,42,17,23,2,234,117,1
5757,75239,azgXgRxypRV3MCHuv22g9fm7GCtWHZdX,SpATywNh6bZuzm8s1ceuBUnMUAeoAHHw,11,21,15,8,0,1,2,0,47,6.714285714285714,1,0.0,6,15,7,0,15,1,1,2,0,28,19,1
5758,75244,pkcnSnJ3oMXJ1Rn021rYtsOpPmKbDGk6,7GRhBDsirIGkRZBtSMEzNTyDr2JQm4xx,17,34,13,3,7,0,7,0,64,9.142857142857142,1,0.0,12,13,3,7,22,0,0,7,0,35,29,1
5759,75288,ZuPH4O6ElHiBwlm11NvwWK4IBueWaJol,7GRhBDsirIGkRZBtSMEzNTyDr2JQm4xx,1,0,0,0,0,0,1,0,1,0.14285714285714285,1,0.0,0,0,0,0,0,0,0,1,0,0,1,1
5760,75307,80mucTACVCDvIo1wfgGJkZ9oDdziiwCh,SpATywNh6bZuzm8s1ceuBUnMUAeoAHHw,31,46,16,30,9,9,12,1,123,17.571428571428573,2,0.0,21,16,29,9,25,9,1,12,1,75,48,0
5761,75314,2IlOpdUgsPu5FVltj0flScFk4CeI7uHm,A3fsA9Zfv1X2fVEQhTw51lKENdNrEqT3,70,34,23,80,14,18,14,1,184,26.285714285714285,3,0.0,4,23,80,14,30,18,0,14,1,121,63,1
5762,75323,1aZU0pZlvemw2X4WLr3aSR93nNOLRr5M,7GRhBDsirIGkRZBtSMEzNTyDr2JQm4xx,13,12,4,16,5,1,2,0,40,5.714285714285714,1,0.0,6,4,13,5,6,1,3,2,0,28,12,1
5763,75329,gmhCT21egJ120TaG89Xay0aaFTdFxysB,7GRhBDsirIGkRZBtSMEzNTyDr2JQm4xx,2,0,0,0,0,0,2,0,2,0.2857142857142857,1,0.0,0,0,0,0,0,0,0,2,0,0,2,1
5764,75347,iJftBP3zncmjUCwGWSZ77IUrDb3Dt8rz,7GRhBDsirIGkRZBtSMEzNTyDr2JQm4xx,9,10,5,4,3,0,3,0,25,3.5714285714285716,1,0.0,2,5,3,3,8,0,1,3,0,13,12,1
5765,75379,MYsCU1zkMrWxPhV1b7wSL5LZIo1zGyhU,A3fsA9Zfv1X2fVEQhTw51lKENdNrEqT3,41,38,31,2,21,0,7,0,99,14.142857142857142,5,0.0,0,31,2,21,38,0,0,7,0,54,45,0
5766,75401,i93wq7dpRKS8LWX4FM6N5PqvNqUj0cQr,G8EPVSXsOYB5YQWZGiz1aVq5Pgr2GrQu,15,13,4,34,3,0,5,0,59,8.428571428571429,1,0.0,8,4,28,3,5,0,6,5,0,43,16,1
5767,75425,Th6GGIKucyCokdQsUn3aOeloTzqx0Qbo,G8EPVSXsOYB5YQWZGiz1aVq5Pgr2GrQu,48,47,2,140,1,22,9,0,221,31.571428571428573,2,0.0,12,2,114,1,35,22,26,9,0,129,92,1
5768,75476,RJ8UDBA8MoIbU3vEiMeGJTOTXtH9PTgu,7GRhBDsirIGkRZBtSMEzNTyDr2JQm4xx,21,44,17,32,20,2,3,0,118,16.857142857142858,1,0.0,25,17,31,20,19,2,1,3,0,93,25,1
5769,75480,RsZjSLVxYbmsMcCyiGpXZKIPYOa4dUlN,7GRhBDsirIGkRZBtSMEzNTyDr2JQm4xx,1,0,0,0,0,0,2,0,2,0.2857142857142857,1,0.0,0,0,0,0,0,0,0,2,0,0,2,1
5770,75493,Y7Pi7uKjChwCBFftO7ZsD2oE8A4VzjzU,7GRhBDsirIGkRZBtSMEzNTyDr2JQm4xx,5,2,1,0,1,0,2,0,6,0.8571428571428571,1,0.0,0,1,0,1,2,0,0,2,0,2,4,1
5771,75511,MYsCU1zkMrWxPhV1b7wSL5LZIo1zGyhU,RXDvfPUBYFlVdlueBFbLW0mhhAyGEqpt,37,31,26,0,16,0,5,0,78,11.142857142857142,4,0.0,0,26,0,16,31,0,0,5,0,42,36,0
5772,75520,9Ymehs8Guv0M3ykIpbJLNOnh3ut9xb1R,SpATywNh6bZuzm8s1ceuBUnMUAeoAHHw,2,0,0,0,0,0,2,0,2,0.2857142857142857,1,0.0,0,0,0,0,0,0,0,2,0,0,2,1
5773,75537,MYsCU1zkMrWxPhV1b7wSL5LZIo1zGyhU,7GRhBDsirIGkRZBtSMEzNTyDr2JQm4xx,11,6,5,0,3,0,2,0,16,2.2857142857142856,1,0.0,0,5,0,3,6,0,0,2,0,8,8,1
5774,75593,9aM24JWMSszlno8F5rXsYdVrvPAYQQTl,7GRhBDsirIGkRZBtSMEzNTyDr2JQm4xx,2,0,0,0,0,0,2,0,2,0.2857142857142857,1,0.0,0,0,0,0,0,0,0,2,0,0,2,1
5775,75601,Xt4h1KWJBlSDSafJvdbE69LJiRLDiihq,7GRhBDsirIGkRZBtSMEzNTyDr2JQm4xx,6,3,1,0,1,0,2,0,7,1.0,1,0.0,0,1,0,1,3,0,0,2,0,2,5,0
5776,75642,jZTK26BTfBLHQKFhPE9kcyNEiSpfCkRJ,SpATywNh6bZuzm8s1ceuBUnMUAeoAHHw,6,5,1,0,1,0,1,0,8,1.1428571428571428,1,0.0,0,1,0,1,5,0,0,1,0,2,6,0
5777,75685,7glymc4Wt1TTt6LrLi78VQNF5GV1r6UY,7GRhBDsirIGkRZBtSMEzNTyDr2JQm4xx,6,1,0,0,0,1,6,1,9,1.2857142857142858,1,0.0,0,0,0,0,1,1,0,6,1,0,9,1
5778,75687,LFB2kImAJUILQTj3BlBgq5zjMlrHesod,7GRhBDsirIGkRZBtSMEzNTyDr2JQm4xx,1,0,0,0,0,0,2,0,2,0.2857142857142857,1,0.0,0,0,0,0,0,0,0,2,0,0,2,1
5779,75690,BSh5O31gIGvDrYgmsU5wxbvxaTpBXZ4G,A3fsA9Zfv1X2fVEQhTw51lKENdNrEqT3,1,0,0,0,0,0,1,0,1,0.14285714285714285,1,0.0,0,0,0,0,0,0,0,1,0,0,1,1
5780,75711,ONaGFOFSpTcGmGss3L3s1gXRn5LKjFn3,SpATywNh6bZuzm8s1ceuBUnMUAeoAHHw,5,1,1,0,1,0,2,0,5,0.7142857142857143,1,0.0,0,1,0,1,1,0,0,2,0,2,3,1
5781,75721,hkOcH5tOuxyPKzObCfNaFgGI6cTMtgMP,SpATywNh6bZuzm8s1ceuBUnMUAeoAHHw,11,10,7,0,2,0,8,0,27,3.857142857142857,1,0.0,0,7,0,2,10,0,0,8,0,9,18,0
5782,75736,bwGV7RxO9uTA6WTvdbogMOQvBlvVU3Dn,A3fsA9Zfv1X2fVEQhTw51lKENdNrEqT3,5,2,1,0,1,0,2,0,6,0.8571428571428571,1,0.0,0,1,0,1,2,0,0,2,0,2,4,1
5783,75751,AQki29spcihutk4byKfhdfiwIESO5QjE,7GRhBDsirIGkRZBtSMEzNTyDr2JQm4xx,4,3,1,0,0,0,3,0,7,1.0,1,0.0,0,1,0,0,3,0,0,3,0,1,6,1
5784,75752,0CuRIhBavvQKL5rTT1QWf2kztAfRXZug,A3fsA9Zfv1X2fVEQhTw51lKENdNrEqT3,56,56,29,100,12,15,15,2,229,32.714285714285715,6,0.0,3,29,78,12,53,15,22,15,2,122,107,0
5785,75760,87yFIXn8YjKLNtiBpBtMqW5Rij3yU58s,SpATywNh6bZuzm8s1ceuBUnMUAeoAHHw,1,0,0,0,0,0,1,0,1,0.14285714285714285,1,0.0,0,0,0,0,0,0,0,1,0,0,1,0
5786,75772,nknXXbQsC6Q6nMDyRKc0MDJZg6KtAXBE,G8EPVSXsOYB5YQWZGiz1aVq5Pgr2GrQu,6,6,2,0,1,0,3,1,13,1.8571428571428572,2,0.0,0,2,0,1,6,0,0,3,1,3,10,0
5787,75790,rT1OrFQC18rdvYkTGYqwRgC7eDvihHsc,A3fsA9Zfv1X2fVEQhTw51lKENdNrEqT3,25,14,11,0,9,2,11,1,48,6.857142857142857,4,0.0,1,11,0,9,13,2,0,11,1,21,27,1
5788,75879,Slk5JcZSYHmDLQZXaNVmcMDmjJ16kBhI,SpATywNh6bZuzm8s1ceuBUnMUAeoAHHw,21,43,0,18,0,8,19,1,89,12.714285714285714,8,0.0,11,0,16,0,32,8,2,19,1,27,62,0
5789,75888,PQscC5e4adjOlDXssQTF1miDsYNrTX1i,7GRhBDsirIGkRZBtSMEzNTyDr2JQm4xx,5,2,1,0,1,1,3,0,8,1.1428571428571428,1,0.0,0,1,0,1,2,1,0,3,0,2,6,1
5790,75965,v3CIUjxPH9xWB79tSDrtVHc9ShR8m6Ki,7GRhBDsirIGkRZBtSMEzNTyDr2JQm4xx,9,15,0,2,1,36,3,0,57,8.142857142857142,1,0.0,2,0,2,1,13,36,0,3,0,5,52,1
5791,75985,XJ0fPDPj1weE8n0B17PQ5bWqC1TTj821,7GRhBDsirIGkRZBtSMEzNTyDr2JQm4xx,4,2,0,0,0,0,2,0,4,0.5714285714285714,1,0.0,0,0,0,0,2,0,0,2,0,0,4,1
5792,76027,BlBPU32FQaOv4FFjXSkiNL1PvarqZtmh,7GRhBDsirIGkRZBtSMEzNTyDr2JQm4xx,1,0,0,0,0,0,1,0,1,0.14285714285714285,1,0.0,0,0,0,0,0,0,0,1,0,0,1,1
5793,76044,Qfr71fBWHfCr6Grcd1acKeeOb47jgXr2,RXDvfPUBYFlVdlueBFbLW0mhhAyGEqpt,17,14,10,0,7,3,6,0,40,5.714285714285714,1,0.0,0,10,0,7,14,3,0,6,0,17,23,1
5794,76073,sxlaG4Fls4yl9crPN8VEZQ5WoWsunptZ,7GRhBDsirIGkRZBtSMEzNTyDr2JQm4xx,3,0,0,0,0,3,2,0,5,0.7142857142857143,1,0.0,0,0,0,0,0,3,0,2,0,0,5,1
5795,76091,UcMBbV5apyBn6US03aF0lorBUPxtfuSB,bWdj2GDclj5ofokWjzoa5jAwMkxCykd6,12,9,4,14,3,13,5,1,49,7.0,1,0.0,2,4,13,3,7,13,1,5,1,22,27,0
5796,76108,zKXJGJg9DMEB2RAxuThjb4UbLJ2XM2gW,RXDvfPUBYFlVdlueBFbLW0mhhAyGEqpt,14,16,11,9,4,0,3,0,43,6.142857142857143,1,0.0,3,11,9,4,13,0,0,3,0,27,16,1
5797,76121,UcMBbV5apyBn6US03aF0lorBUPxtfuSB,SpATywNh6bZuzm8s1ceuBUnMUAeoAHHw,18,14,7,12,4,47,8,1,93,13.285714285714286,2,0.0,5,7,11,4,9,47,1,8,1,27,66,0
5798,76169,6RuWsSvS3Ngnjl37PzNAaaGn8Jd9a1lW,A3fsA9Zfv1X2fVEQhTw51lKENdNrEqT3,10,19,4,0,4,0,9,0,36,5.142857142857143,5,0.0,0,4,0,4,19,0,0,9,0,8,28,0
5799,76192,eeUPLnGQx37dkxrDcGRSCAvma26w8Yjq,RXDvfPUBYFlVdlueBFbLW0mhhAyGEqpt,9,12,6,0,2,2,6,0,28,4.0,1,0.0,0,6,0,2,12,2,0,6,0,8,20,0
5800,76232,o9SCOAY5nuSxaVorNF1mq3E0AGKQbCox,G8EPVSXsOYB5YQWZGiz1aVq5Pgr2GrQu,1,0,0,0,0,0,1,0,1,0.14285714285714285,1,0.0,0,0,0,0,0,0,0,1,0,0,1,1
5801,76235,jByBG50ghoSer5UP92qpkAfDGFpraaH7,SpATywNh6bZuzm8s1ceuBUnMUAeoAHHw,24,53,13,25,3,8,34,1,137,19.571428571428573,5,0.0,12,13,24,3,41,8,1,34,1,52,85,0
5802,76295,Slk5JcZSYHmDLQZXaNVmcMDmjJ16kBhI,bWdj2GDclj5ofokWjzoa5jAwMkxCykd6,48,95,13,132,5,6,28,2,281,40.142857142857146,10,0.0,21,13,117,5,74,6,15,28,2,156,125,0
5803,76325,R5PVQLHQfRcyGqt0KVpTkwcmfBgB3rs1,7GRhBDsirIGkRZBtSMEzNTyDr2JQm4xx,8,16,7,2,1,2,6,0,34,4.857142857142857,3,0.0,1,7,2,1,15,2,0,6,0,11,23,0
5804,76368,Kcl98h3mNpyExmJuf2coZt58rSEztGxk,7GRhBDsirIGkRZBtSMEzNTyDr2JQm4xx,65,131,55,108,51,65,16,0,426,60.857142857142854,7,0.0,64,55,98,51,67,65,10,16,0,268,158,0
5805,76949,QzYbn86ruFNwqcTxxFURk0zGhEatBUQQ,7GRhBDsirIGkRZBtSMEzNTyDr2JQm4xx,3,2,0,0,0,0,1,0,3,0.42857142857142855,1,0.0,0,0,0,0,2,0,0,1,0,0,3,0
5806,76950,e1Ni97fhQkMnOfSs68693wQS8Fze4UXJ,7GRhBDsirIGkRZBtSMEzNTyDr2JQm4xx,32,22,20,0,14,1,1,0,58,8.285714285714286,1,0.0,0,20,0,14,22,1,0,1,0,34,24,1
5807,76967,2NKObRqEjsRrxsIaHNv4gzcAP6eW660j,7GRhBDsirIGkRZBtSMEzNTyDr2JQm4xx,1,0,0,0,0,0,1,0,1,0.14285714285714285,1,0.0,0,0,0,0,0,0,0,1,0,0,1,1
5808,77031,uLw7Ns7eU6sxKEU6M5svYmkgyCUXe32f,7GRhBDsirIGkRZBtSMEzNTyDr2JQm4xx,18,29,3,5,4,0,4,0,45,6.428571428571429,1,0.0,1,3,3,4,28,0,2,4,0,11,34,0
5809,77034,s6iksgptFmyh2vfiarKdJkiKnp6RLi3f,7GRhBDsirIGkRZBtSMEzNTyDr2JQm4xx,22,33,19,0,7,10,33,3,105,15.0,4,0.0,4,19,0,7,29,10,0,33,3,30,75,0
5810,77042,h2A0iMKtZOnc2TftPlP9GQGNtfgyyhcj,7GRhBDsirIGkRZBtSMEzNTyDr2JQm4xx,1,0,0,0,0,0,1,0,1,0.14285714285714285,1,0.0,0,0,0,0,0,0,0,1,0,0,1,1
5811,77064,h18jWYSAObqvOO5XjUcCaWiyguLiAvCC,7GRhBDsirIGkRZBtSMEzNTyDr2JQm4xx,2,0,0,0,0,0,2,0,2,0.2857142857142857,1,0.0,0,0,0,0,0,0,0,2,0,0,2,1
5812,77122,Q4w60uH4MK8mN5fYaKMbhF5stFXWr0Vi,7GRhBDsirIGkRZBtSMEzNTyDr2JQm4xx,2,0,0,0,0,0,4,0,4,0.5714285714285714,1,0.0,0,0,0,0,0,0,0,4,0,0,4,1
5813,77123,s6dupzTq7IPrRZizdsz3m7uW9SFh4kDC,7GRhBDsirIGkRZBtSMEzNTyDr2JQm4xx,20,26,12,8,12,0,2,0,60,8.571428571428571,1,0.0,10,12,4,12,16,0,4,2,0,38,22,1
5814,77128,KsfSaMDW3YtqB9HKnB6Qn6E8m6zJPOJA,7GRhBDsirIGkRZBtSMEzNTyDr2JQm4xx,7,6,3,0,1,0,3,0,13,1.8571428571428572,1,0.0,1,3,0,1,5,0,0,3,0,5,8,1
5815,77148,80y9S8r32w7HjdSrNUEAoEBMUZWJtxmp,7GRhBDsirIGkRZBtSMEzNTyDr2JQm4xx,1,0,0,0,0,0,1,0,1,0.14285714285714285,1,0.0,0,0,0,0,0,0,0,1,0,0,1,1
5816,77151,CDzHyYO40Bybwfq6RBlk0Sz8LcMuVYAa,7GRhBDsirIGkRZBtSMEzNTyDr2JQm4xx,1,0,0,0,0,0,2,0,2,0.2857142857142857,1,0.0,0,0,0,0,0,0,0,2,0,0,2,1
5817,77169,Cp72CI2Sf9jM7OL4FtK9fjTjNz5WkQpA,fbPkOYLVPtPgIt0MxizjfFJov3JbHyAi,21,20,16,0,7,0,6,1,50,7.142857142857143,2,0.0,0,16,0,7,20,0,0,6,1,23,27,1
5818,77171,HBsmUsRxNy9YIFuJFQ7jYNsbYwo3J2fi,fbPkOYLVPtPgIt0MxizjfFJov3JbHyAi,2,0,0,0,0,0,4,0,4,0.5714285714285714,1,0.0,0,0,0,0,0,0,0,4,0,0,4,1
5819,77174,SAaosoVr2vtr4dixGOnJyFfsZpQgNJkr,fbPkOYLVPtPgIt0MxizjfFJov3JbHyAi,7,3,2,0,2,0,2,0,9,1.2857142857142858,1,0.0,0,2,0,2,3,0,0,2,0,4,5,1
5820,77175,uHjc02bb5yahJPEhzfl5FY8Jbd1eMOQQ,fbPkOYLVPtPgIt0MxizjfFJov3JbHyAi,6,2,1,0,1,0,4,0,8,1.1428571428571428,1,0.0,0,1,0,1,2,0,0,4,0,2,6,1
5821,77178,sgnybIqhppcE8t2VPYKo1tSMEtj9RDxf,fbPkOYLVPtPgIt0MxizjfFJov3JbHyAi,11,13,2,4,5,0,2,0,26,3.7142857142857144,1,0.0,7,2,4,5,6,0,0,2,0,18,8,1
5822,77179,eoSLO9oJFq2ypi74bXNS4eHCMDLAFDL3,fbPkOYLVPtPgIt0MxizjfFJov3JbHyAi,25,94,27,21,27,0,30,1,200,28.571428571428573,9,0.0,41,27,15,27,53,0,6,30,1,110,90,0
5823,77180,4G8giDRiV5HhGR2bRPmscEq6mPK32SgK,fbPkOYLVPtPgIt0MxizjfFJov3JbHyAi,1,0,0,0,0,0,1,0,1,0.14285714285714285,1,0.0,0,0,0,0,0,0,0,1,0,0,1,1
5824,77183,bDjOfMP0w62FEHIuWcxaWhNnsKOONfSS,fbPkOYLVPtPgIt0MxizjfFJov3JbHyAi,8,3,2,0,2,0,3,1,11,1.5714285714285714,1,0.0,0,2,0,2,3,0,0,3,1,4,7,1
5825,77186,ezX0IzuZ3J41r6pzTzeXqv8c59Uxb12M,fbPkOYLVPtPgIt0MxizjfFJov3JbHyAi,25,56,25,44,9,6,15,2,157,22.428571428571427,2,0.0,20,25,37,9,36,6,7,15,2,91,66,1
5826,77192,meLyG0wJkMmV21DuYQM3wSrWMuffsNoT,fbPkOYLVPtPgIt0MxizjfFJov3JbHyAi,6,7,1,0,2,0,2,0,12,1.7142857142857142,1,0.0,4,1,0,2,3,0,0,2,0,7,5,1
5827,77193,alkuv5SdY4gggdYWMPXddOsJJh5KuvhQ,fbPkOYLVPtPgIt0MxizjfFJov3JbHyAi,8,5,2,0,2,1,4,1,15,2.142857142857143,1,0.0,0,2,0,2,5,1,0,4,1,4,11,1
5828,77195,gir9E9ZUbwj6bCUNLD2kQmOx1nsVwG4J,fbPkOYLVPtPgIt0MxizjfFJov3JbHyAi,1,0,0,0,0,0,1,0,1,0.14285714285714285,1,0.0,0,0,0,0,0,0,0,1,0,0,1,1
5829,77196,MzVpgt6eIu33aOAUbbblQyleNNMrWM7t,fbPkOYLVPtPgIt0MxizjfFJov3JbHyAi,5,2,1,0,1,0,2,0,6,0.8571428571428571,1,0.0,0,1,0,1,2,0,0,2,0,2,4,1
5830,77199,KG6oNmBFEPQJXhvAD0RPIYEBC1kCcYzu,fbPkOYLVPtPgIt0MxizjfFJov3JbHyAi,12,12,8,2,4,0,6,0,32,4.571428571428571,1,0.0,1,8,2,4,11,0,0,6,0,15,17,1
5831,77201,syI09vfTHJXWHQvllYPBF5DBbMlFFVEK,fbPkOYLVPtPgIt0MxizjfFJov3JbHyAi,8,8,3,0,1,0,9,0,21,3.0,3,0.0,0,3,0,1,8,0,0,9,0,4,17,1
5832,77202,U7npE6DxNpBR5QQ69mhzcy60y59pDPJp,fbPkOYLVPtPgIt0MxizjfFJov3JbHyAi,7,4,3,0,3,0,2,0,12,1.7142857142857142,1,0.0,0,3,0,3,4,0,0,2,0,6,6,1
5833,77203,riM9GkB0ajSqpIPlVq4tRzOjk7wJ6NHE,fbPkOYLVPtPgIt0MxizjfFJov3JbHyAi,4,2,0,0,0,0,2,0,4,0.5714285714285714,1,0.0,0,0,0,0,2,0,0,2,0,0,4,1
5834,77204,cNbaOf1E9E66ogkJPuo6YM141nAFPTNg,fbPkOYLVPtPgIt0MxizjfFJov3JbHyAi,14,22,15,0,11,3,5,0,56,8.0,2,0.0,2,15,0,11,20,3,0,5,0,28,28,1
5835,77205,tAelht5FQdpcbtZQoKgvZA90XQy6zeRb,fbPkOYLVPtPgIt0MxizjfFJov3JbHyAi,7,5,4,0,3,0,1,0,13,1.8571428571428572,1,0.0,0,4,0,3,5,0,0,1,0,7,6,1
5836,77207,AXWWqNDiRDejTjo5V7yUaMbjtzXKhlP0,fbPkOYLVPtPgIt0MxizjfFJov3JbHyAi,10,6,3,0,2,5,5,1,22,3.142857142857143,1,0.0,1,3,0,2,5,5,0,5,1,6,16,1
5837,77304,nknXXbQsC6Q6nMDyRKc0MDJZg6KtAXBE,fbPkOYLVPtPgIt0MxizjfFJov3JbHyAi,8,9,5,0,2,3,7,0,26,3.7142857142857144,2,0.0,0,5,0,2,9,3,0,7,0,7,19,1
5838,77848,4s6cwLPbdRkDxHfFtEkiNoQ9RLKrwhVv,A3fsA9Zfv1X2fVEQhTw51lKENdNrEqT3,16,10,8,0,5,4,10,1,38,5.428571428571429,4,0.0,0,8,0,5,10,4,0,10,1,13,25,1
5839,77859,FbNQPrTC7bI79XxVFKHE9WIoUItnOpDj,SpATywNh6bZuzm8s1ceuBUnMUAeoAHHw,27,30,19,28,12,17,3,0,109,15.571428571428571,2,0.0,8,19,26,12,22,17,2,3,0,65,44,1
5840,77863,YV0OYizek02yKJ88HEeJHkNjkL20XUDk,SpATywNh6bZuzm8s1ceuBUnMUAeoAHHw,27,82,15,23,3,8,13,1,145,20.714285714285715,3,0.0,38,15,20,3,44,8,3,13,1,76,69,0
5841,77865,mqEWhrPz1lKF0rYKRYPaEdxo5F8aEixX,bWdj2GDclj5ofokWjzoa5jAwMkxCykd6,7,16,1,60,0,1,6,0,84,12.0,3,0.0,9,1,59,0,7,1,1,6,0,69,15,0
5842,77895,ywdL3xkp7d2PSjbvnflAvIe7Wp6Q4SRe,bWdj2GDclj5ofokWjzoa5jAwMkxCykd6,46,74,32,170,11,0,24,0,311,44.42857142857143,7,0.0,10,32,157,11,64,0,13,24,0,210,101,0
5843,77897,rxZkN71X2cLXhIjLr3jy095yRsk5XsRc,RXDvfPUBYFlVdlueBFbLW0mhhAyGEqpt,32,76,12,40,2,0,16,7,153,21.857142857142858,2,0.0,18,12,39,2,58,0,1,16,7,71,82,1
5844,77906,lzBQ7nLCxYOqaheVjLakGDqP6Wmnlnpq,A3fsA9Zfv1X2fVEQhTw51lKENdNrEqT3,2,0,0,0,0,0,2,0,2,0.2857142857142857,1,0.0,0,0,0,0,0,0,0,2,0,0,2,1
5845,77917,UpJrRBQ59x3Gn5L7s007cXh7Wi1pgqj5,A3fsA9Zfv1X2fVEQhTw51lKENdNrEqT3,1,0,0,0,0,0,1,0,1,0.14285714285714285,1,0.0,0,0,0,0,0,0,0,1,0,0,1,1
5846,77956,1hThKgDvGcWwSWVkG0XRyCPk0C8L5ypr,SpATywNh6bZuzm8s1ceuBUnMUAeoAHHw,7,2,0,0,0,0,6,1,9,1.2857142857142858,1,0.0,0,0,0,0,2,0,0,6,1,0,9,1
5847,77959,oL1G89Phk4nduULmJ17br7A4xddcHdc4,bWdj2GDclj5ofokWjzoa5jAwMkxCykd6,1,0,0,0,0,0,2,0,2,0.2857142857142857,2,0.0,0,0,0,0,0,0,0,2,0,0,2,1
5848,77984,lmR86sBtJRFaUISdgjy7MTzO5iilHcad,G8EPVSXsOYB5YQWZGiz1aVq5Pgr2GrQu,18,8,7,0,7,4,3,0,29,4.142857142857143,1,0.0,0,7,0,7,8,4,0,3,0,14,15,1
5849,77993,c8WJAdYLV71mOx4ZXSglpCNd0dBUR3Om,A3fsA9Zfv1X2fVEQhTw51lKENdNrEqT3,100,44,29,214,19,1,29,1,337,48.142857142857146,9,0.0,3,29,207,19,41,1,7,29,1,258,79,0
5850,78000,fFuKiCeoQQwOgD8VAud2ta198Mbq05KK,bWdj2GDclj5ofokWjzoa5jAwMkxCykd6,38,89,44,74,9,266,42,0,524,74.85714285714286,8,0.0,8,44,69,9,81,266,5,42,0,130,394,0
5851,78011,G1AkjrLrzxk8VSlUiuwTegO49rw4sqVB,SpATywNh6bZuzm8s1ceuBUnMUAeoAHHw,6,4,1,0,1,0,2,0,8,1.1428571428571428,1,0.0,0,1,0,1,4,0,0,2,0,2,6,1
5852,78033,PqRGPZDwCt8mcSQTJP9YLW5JCb0jrVN9,SpATywNh6bZuzm8s1ceuBUnMUAeoAHHw,5,2,1,0,1,0,2,0,6,0.8571428571428571,1,0.0,0,1,0,1,2,0,0,2,0,2,4,1
5853,78049,92DwnWdf0DjZODrvrNNLdxmEfzQWnu5Z,bWdj2GDclj5ofokWjzoa5jAwMkxCykd6,9,5,3,0,2,0,8,1,19,2.7142857142857144,1,0.0,0,3,0,2,5,0,0,8,1,5,14,1
5854,78061,CTzsOL49UPUArAP2sAfnnQhe79FdliFF,bWdj2GDclj5ofokWjzoa5jAwMkxCykd6,8,7,2,0,3,0,2,0,14,2.0,2,0.0,2,2,0,3,5,0,0,2,0,7,7,1
5855,78074,69m94gHdGGbBNOXpX0bnvC61pSot80tW,SpATywNh6bZuzm8s1ceuBUnMUAeoAHHw,31,49,18,41,8,41,25,3,185,26.428571428571427,5,0.0,23,18,34,8,26,41,7,25,3,83,102,1
5856,78082,kVKFY3wJD9F9OUo7qKYWy4VSNf8ef9A6,SpATywNh6bZuzm8s1ceuBUnMUAeoAHHw,11,11,0,0,0,9,8,1,29,4.142857142857143,2,0.0,0,0,0,0,11,9,0,8,1,0,29,1
5857,78089,hL8JceSXib9VR5R33sNp2RkuLry7d4Yu,SpATywNh6bZuzm8s1ceuBUnMUAeoAHHw,17,22,0,37,0,0,8,0,67,9.571428571428571,2,0.0,4,0,33,0,18,0,4,8,0,37,30,1
5858,78095,pd8vtyQRUNRd6UqLQhDDx4sQEKhI3nO6,SpATywNh6bZuzm8s1ceuBUnMUAeoAHHw,15,29,3,30,0,3,14,1,80,11.428571428571429,7,0.0,9,3,26,0,20,3,4,14,1,38,42,1
5859,78101,ew5XZC7WSosl0QdXH45kYD3syMSGbOj6,SpATywNh6bZuzm8s1ceuBUnMUAeoAHHw,22,25,14,12,7,12,11,1,82,11.714285714285714,4,0.0,4,14,9,7,21,12,3,11,1,34,48,1
5860,78102,3iVQIJ2a6dmEKXpiFwzH2EedoHvLyisM,bWdj2GDclj5ofokWjzoa5jAwMkxCykd6,7,4,1,0,1,1,6,0,13,1.8571428571428572,1,0.0,0,1,0,1,4,1,0,6,0,2,11,1
5861,78113,95wznOdbj11g3FRFEWLtWETJ4xtU9Lr5,G8EPVSXsOYB5YQWZGiz1aVq5Pgr2GrQu,6,2,1,0,0,5,6,1,15,2.142857142857143,2,0.0,0,1,0,0,2,5,0,6,1,1,14,1
5862,78118,5s2QZF0oRCYI8h2ElmgC6T7pH2gEDZ5h,G8EPVSXsOYB5YQWZGiz1aVq5Pgr2GrQu,1,0,0,0,0,0,1,0,1,0.14285714285714285,1,0.0,0,0,0,0,0,0,0,1,0,0,1,1
5863,78124,ipCWNN8EoPw4ehuG3rBsqrmm1abywAYg,SpATywNh6bZuzm8s1ceuBUnMUAeoAHHw,9,8,4,0,3,0,3,0,18,2.5714285714285716,2,0.0,1,4,0,3,7,0,0,3,0,8,10,1
5864,78127,2RG1wvJ2Akp0VzrUn9TPDWB6kxO9ia9I,SpATywNh6bZuzm8s1ceuBUnMUAeoAHHw,1,0,0,0,0,0,1,0,1,0.14285714285714285,1,0.0,0,0,0,0,0,0,0,1,0,0,1,1
5865,78129,JntXNtR3vyFADq0v1flreEKkRmGG9OQK,A3fsA9Zfv1X2fVEQhTw51lKENdNrEqT3,3,1,0,0,0,0,3,0,4,0.5714285714285714,1,0.0,0,0,0,0,1,0,0,3,0,0,4,1
5866,78136,s8Jf0qU6li81AKZyIKNz4C8LkYvCndM9,SpATywNh6bZuzm8s1ceuBUnMUAeoAHHw,8,2,1,0,1,0,4,1,9,1.2857142857142858,1,0.0,0,1,0,1,2,0,0,4,1,2,7,1
5867,78149,LXuJhI2cIog5nvobdVGbKieoIrAAgMV0,A3fsA9Zfv1X2fVEQhTw51lKENdNrEqT3,13,8,6,0,4,0,3,0,21,3.0,1,0.0,0,6,0,4,8,0,0,3,0,10,11,1
5868,78152,SozAkRr5kfRi3urQaoczmRXQoW70onBa,RXDvfPUBYFlVdlueBFbLW0mhhAyGEqpt,26,143,4,2,5,0,22,1,177,25.285714285714285,3,0.0,3,4,2,5,140,0,0,22,1,14,163,1
5869,78155,6D9tNiLYL0h3Qh7QJGbRexG5UNsHPfh9,bWdj2GDclj5ofokWjzoa5jAwMkxCykd6,6,2,1,0,1,1,3,1,9,1.2857142857142858,1,0.0,0,1,0,1,2,1,0,3,1,2,7,1
5870,78193,qxN9EXLVijHnXOSweK0J0YYviNolRhYg,SpATywNh6bZuzm8s1ceuBUnMUAeoAHHw,10,6,1,0,1,2,8,2,20,2.857142857142857,1,0.0,0,1,0,1,6,2,0,8,2,2,18,1
5871,78198,WnXohtCVTjGmg2VYZ7QMusUaSQiMqg1z,SpATywNh6bZuzm8s1ceuBUnMUAeoAHHw,15,21,9,6,3,0,8,0,47,6.714285714285714,4,0.0,8,9,6,3,13,0,0,8,0,26,21,1
5872,78207,KxuHPQOdlWxQw9hyxXdRrGHh12yzsPD2,SpATywNh6bZuzm8s1ceuBUnMUAeoAHHw,22,52,1,50,0,6,18,4,131,18.714285714285715,6,0.0,13,1,39,0,39,6,11,18,4,53,78,0
5873,78230,Q9vRNhatkLDJJU3tGkLQZvY6VPiyvyvp,SpATywNh6bZuzm8s1ceuBUnMUAeoAHHw,12,27,2,4,2,0,2,0,37,5.285714285714286,3,0.0,6,2,3,2,21,0,1,2,0,13,24,1
5874,78253,oDMwcP97XCFhatRKDALyEk29j0A66Zee,bWdj2GDclj5ofokWjzoa5jAwMkxCykd6,10,6,3,16,4,0,11,0,40,5.714285714285714,2,0.0,3,3,14,4,3,0,2,11,0,24,16,1
5875,78254,CWfEuozBd4liyBTvOMVgNSWJo0S8l1jG,A3fsA9Zfv1X2fVEQhTw51lKENdNrEqT3,2,0,0,0,0,0,2,0,2,0.2857142857142857,1,0.0,0,0,0,0,0,0,0,2,0,0,2,1
5876,78272,wnNKMl9xF7Ymo4g0NZCDRhkVYih1owQr,SpATywNh6bZuzm8s1ceuBUnMUAeoAHHw,19,34,24,21,13,0,8,0,100,14.285714285714286,3,0.0,5,24,17,13,29,0,4,8,0,59,41,1
5877,78273,XE05vZThEHf17O6FM08AySNf2qZFgNWa,SpATywNh6bZuzm8s1ceuBUnMUAeoAHHw,15,16,7,14,1,0,4,0,42,6.0,3,0.0,7,7,14,1,9,0,0,4,0,29,13,0
5878,78287,4If157RX0kFtn3QRqNwswYxl3iATvTeY,SpATywNh6bZuzm8s1ceuBUnMUAeoAHHw,13,27,9,17,0,4,8,0,65,9.285714285714286,1,0.0,15,9,14,0,12,4,3,8,0,38,27,1
5879,78302,CwyPNNTiGuAPbLEEKCBOpScgD8z9aW45,G8EPVSXsOYB5YQWZGiz1aVq5Pgr2GrQu,7,2,1,0,1,1,7,0,12,1.7142857142857142,1,0.0,0,1,0,1,2,1,0,7,0,2,10,1
5880,78317,kGMrZZF6IokC4ENFCmz5DqVfi7S4EU7Y,A3fsA9Zfv1X2fVEQhTw51lKENdNrEqT3,11,5,4,0,4,1,4,0,18,2.5714285714285716,1,0.0,0,4,0,4,5,1,0,4,0,8,10,1
5881,78320,d7dHJyfZvhoC9wAanfH162cM80LBpWIS,SpATywNh6bZuzm8s1ceuBUnMUAeoAHHw,6,7,4,0,1,0,5,0,17,2.4285714285714284,1,0.0,2,4,0,1,5,0,0,5,0,7,10,1
5882,78323,VhJqWY1s8NggIUb1uIcah3mgkAeL4PFu,SpATywNh6bZuzm8s1ceuBUnMUAeoAHHw,1,0,0,0,0,0,1,0,1,0.14285714285714285,1,0.0,0,0,0,0,0,0,0,1,0,0,1,1
5883,78327,VhJqWY1s8NggIUb1uIcah3mgkAeL4PFu,bWdj2GDclj5ofokWjzoa5jAwMkxCykd6,1,0,0,0,0,0,1,0,1,0.14285714285714285,1,0.0,0,0,0,0,0,0,0,1,0,0,1,1
5884,78376,QAguKdvn52pCJKW91rO3BCY8l8ZCAdvQ,bWdj2GDclj5ofokWjzoa5jAwMkxCykd6,4,2,1,0,1,0,1,0,5,0.7142857142857143,1,0.0,0,1,0,1,2,0,0,1,0,2,3,0
5885,78403,yndqePvRltfbBBHRj2cAuoKRvu7Id8hO,A3fsA9Zfv1X2fVEQhTw51lKENdNrEqT3,5,2,1,0,1,0,4,0,8,1.1428571428571428,1,0.0,0,1,0,1,2,0,0,4,0,2,6,1
5886,78404,r83Hvy5kcw0EMVIlIEQofYLVkxqypRN2,A3fsA9Zfv1X2fVEQhTw51lKENdNrEqT3,10,10,7,0,0,0,10,0,27,3.857142857142857,3,0.0,0,7,0,0,10,0,0,10,0,7,20,1
5887,78411,Bz3KWhAEO9yzXIB0jVNYIzbr7mGbueA4,A3fsA9Zfv1X2fVEQhTw51lKENdNrEqT3,8,4,3,0,2,0,2,0,11,1.5714285714285714,1,0.0,0,3,0,2,4,0,0,2,0,5,6,1
5888,78414,VzHARyOCXw9czoqgTkAm6CGUmYU7yDEA,A3fsA9Zfv1X2fVEQhTw51lKENdNrEqT3,5,0,0,0,0,0,12,1,13,1.8571428571428572,2,0.0,0,0,0,0,0,0,0,12,1,0,13,1
5889,78418,XE05vZThEHf17O6FM08AySNf2qZFgNWa,A3fsA9Zfv1X2fVEQhTw51lKENdNrEqT3,23,18,14,0,11,0,2,0,45,6.428571428571429,2,0.0,1,14,0,11,17,0,0,2,0,26,19,1
5890,78425,z0WA70zlCYNC0D6ukf1TU1erCNwbETr4,SpATywNh6bZuzm8s1ceuBUnMUAeoAHHw,10,10,3,7,1,1,4,1,27,3.857142857142857,1,0.0,6,3,6,1,4,1,1,4,1,16,11,0
5891,78439,urVw10ZOKTw1O1zHFnsutUzT6EcZdTal,A3fsA9Zfv1X2fVEQhTw51lKENdNrEqT3,5,5,0,0,0,0,1,0,6,0.8571428571428571,1,0.0,0,0,0,0,5,0,0,1,0,0,6,1
5892,78450,FKaIUzhQjfUDPqxWuQzJXyqHP4qLLgRX,SpATywNh6bZuzm8s1ceuBUnMUAeoAHHw,27,58,2,43,2,6,27,3,141,20.142857142857142,5,0.0,26,2,35,2,32,6,8,27,3,65,76,0
5893,78456,eBckG9AVr6bIBOpezfRr2S1KzQMM7OtD,SpATywNh6bZuzm8s1ceuBUnMUAeoAHHw,6,7,3,0,2,0,2,0,14,2.0,2,0.0,0,3,0,2,7,0,0,2,0,5,9,1
5894,78467,J2luenZYZZPbaRbefvLso2Jyw46qiM9q,G8EPVSXsOYB5YQWZGiz1aVq5Pgr2GrQu,46,49,17,82,10,0,8,0,166,23.714285714285715,4,0.0,26,17,55,10,23,0,27,8,0,108,58,1
5895,78480,NnzxbmsIt5XwCuqd88R8ZxWHliFkPx5u,A3fsA9Zfv1X2fVEQhTw51lKENdNrEqT3,4,2,0,0,0,0,2,0,4,0.5714285714285714,1,0.0,0,0,0,0,2,0,0,2,0,0,4,1
5896,78495,btLR1bWGFkTXEBZ7Aiu8bAmygJLuQ8xU,SpATywNh6bZuzm8s1ceuBUnMUAeoAHHw,1,0,0,0,0,0,1,0,1,0.14285714285714285,1,0.0,0,0,0,0,0,0,0,1,0,0,1,1
5897,78501,OX8GRDjTfhi0f98MbIiYM0XH4DZcRvix,SpATywNh6bZuzm8s1ceuBUnMUAeoAHHw,4,2,1,0,1,0,1,0,5,0.7142857142857143,1,0.0,0,1,0,1,2,0,0,1,0,2,3,1
5898,78507,BSh5O31gIGvDrYgmsU5wxbvxaTpBXZ4G,bWdj2GDclj5ofokWjzoa5jAwMkxCykd6,38,67,23,158,14,6,11,1,280,40.0,2,0.0,20,23,148,14,47,6,10,11,1,205,75,1
5899,78511,98Rmjqd0huhIhiHJIK65vNiEBdUVwDLb,A3fsA9Zfv1X2fVEQhTw51lKENdNrEqT3,17,18,13,0,7,0,5,0,43,6.142857142857143,4,0.0,0,13,0,7,18,0,0,5,0,20,23,1
5900,78545,Ckb71Ev9RlsIUvVDfkFS0AumQJilppvB,SpATywNh6bZuzm8s1ceuBUnMUAeoAHHw,5,3,1,0,1,0,2,0,7,1.0,2,0.0,0,1,0,1,3,0,0,2,0,2,5,1
5901,78551,n2o2ZtJFwUSYSGDBSers3t9xfBVg1pV7,SpATywNh6bZuzm8s1ceuBUnMUAeoAHHw,12,13,2,0,2,0,3,0,20,2.857142857142857,2,0.0,0,2,0,2,13,0,0,3,0,4,16,1
5902,78556,cWykzNKAq5sFQBA059QN4Jx74YGPkfwB,A3fsA9Zfv1X2fVEQhTw51lKENdNrEqT3,5,5,0,0,0,0,2,0,7,1.0,2,0.0,0,0,0,0,5,0,0,2,0,0,7,1
5903,78559,MkNNXRtvb2oEn4QkB8O2p0cdUi1EqesX,SpATywNh6bZuzm8s1ceuBUnMUAeoAHHw,9,6,3,0,2,1,7,1,20,2.857142857142857,1,0.0,0,3,0,2,6,1,0,7,1,5,15,1
5904,78562,QMBvXsBcxfHzg1mixrcjUrcMaoA4FrQo,SpATywNh6bZuzm8s1ceuBUnMUAeoAHHw,6,3,1,0,1,0,2,0,7,1.0,1,0.0,0,1,0,1,3,0,0,2,0,2,5,1
5905,78564,X8qfNjsHrwR5R67KkU9t7FXc6jQSGsyo,A3fsA9Zfv1X2fVEQhTw51lKENdNrEqT3,45,59,10,65,5,13,32,1,185,26.428571428571427,4,0.0,0,10,56,5,59,13,9,32,1,71,114,1
5906,78584,5bg7aQCg1xT3BNwuorGcguCUDl8W5Lwl,bWdj2GDclj5ofokWjzoa5jAwMkxCykd6,6,13,2,0,0,21,9,1,46,6.571428571428571,3,0.0,2,2,0,0,11,21,0,9,1,4,42,1
5907,78622,0gWJ7DFjheSDJbXHYhPpXkJuq9a45Fds,bWdj2GDclj5ofokWjzoa5jAwMkxCykd6,1,0,0,0,0,0,2,0,2,0.2857142857142857,2,0.0,0,0,0,0,0,0,0,2,0,0,2,1
5908,78627,mJ6Ucc9SqO7RDdkh3xF9KLI6sTyfYc24,SpATywNh6bZuzm8s1ceuBUnMUAeoAHHw,22,43,17,36,4,7,15,0,122,17.428571428571427,3,0.0,15,17,33,4,28,7,3,15,0,69,53,1
5909,78660,uhbUne0Zqx7l0LKNWrxxR44WistJmxKI,RXDvfPUBYFlVdlueBFbLW0mhhAyGEqpt,7,9,1,0,0,0,4,0,14,2.0,2,0.0,0,1,0,0,9,0,0,4,0,1,13,1
5910,78664,97xUfvFptTHex9YOgZiJKjEEIQ0YhjLh,bWdj2GDclj5ofokWjzoa5jAwMkxCykd6,7,5,3,0,3,4,1,0,16,2.2857142857142856,1,0.0,0,3,0,3,5,4,0,1,0,6,10,1
5911,78686,38U4yWxOl4oZXP5u7g0lCPmmavOa19Ln,A3fsA9Zfv1X2fVEQhTw51lKENdNrEqT3,11,17,3,0,3,0,8,0,31,4.428571428571429,3,0.0,0,3,0,3,17,0,0,8,0,6,25,1
5912,78691,tmJw00mRQLbE68iN3hs2GcRMynHK5cxp,A3fsA9Zfv1X2fVEQhTw51lKENdNrEqT3,44,26,19,96,11,2,7,2,163,23.285714285714285,2,0.0,3,19,83,11,23,2,13,7,2,116,47,1
5913,78700,avCGoxb1ZCWUYXGamrmyET2g851xKp7v,SpATywNh6bZuzm8s1ceuBUnMUAeoAHHw,4,6,0,0,0,0,4,0,10,1.4285714285714286,1,0.0,0,0,0,0,6,0,0,4,0,0,10,1
5914,78716,rjA1flUm5W5QdousXm9Zvd4FhEyMHlGN,SpATywNh6bZuzm8s1ceuBUnMUAeoAHHw,6,5,2,0,1,0,1,0,9,1.2857142857142858,1,0.0,0,2,0,1,5,0,0,1,0,3,6,1
5915,78733,hiYWxbK79jotdVc0LNw6xFpPROtaee83,SpATywNh6bZuzm8s1ceuBUnMUAeoAHHw,18,24,3,18,1,10,13,1,70,10.0,5,0.0,8,3,15,1,16,10,3,13,1,27,43,0
5916,78761,w7e18flx60x3aWIj6WG7yk02Ben80Ufh,SpATywNh6bZuzm8s1ceuBUnMUAeoAHHw,6,1,1,0,1,0,3,0,6,0.8571428571428571,1,0.0,0,1,0,1,1,0,0,3,0,2,4,1
5917,78765,UwNh19bGTGX7YEBtcKZFqxDpmh2gUs3A,A3fsA9Zfv1X2fVEQhTw51lKENdNrEqT3,17,17,10,0,8,0,2,0,37,5.285714285714286,2,0.0,0,10,0,8,17,0,0,2,0,18,19,1
5918,78773,Hua13xdEo1dQEcejfla3D6xiVkGTobMn,A3fsA9Zfv1X2fVEQhTw51lKENdNrEqT3,44,23,19,62,16,0,5,0,125,17.857142857142858,3,0.0,1,19,51,16,22,0,11,5,0,87,38,1
5919,78776,eAArxLyCThtu9N3Mv8rQculKbGSa66j9,A3fsA9Zfv1X2fVEQhTw51lKENdNrEqT3,9,9,6,0,1,0,6,0,22,3.142857142857143,4,0.0,0,6,0,1,9,0,0,6,0,7,15,1
5920,78793,hUKI9vR9OSrT9NXeUijAdTM2tdFNBSDI,SpATywNh6bZuzm8s1ceuBUnMUAeoAHHw,5,0,0,0,0,1,4,1,6,0.8571428571428571,1,0.0,0,0,0,0,0,1,0,4,1,0,6,1
5921,78822,WmqMKoevd5yMpzwxk3BDNFkg4y1FZjx5,A3fsA9Zfv1X2fVEQhTw51lKENdNrEqT3,18,38,3,0,2,0,8,0,51,7.285714285714286,4,0.0,1,3,0,2,37,0,0,8,0,6,45,1
5922,78828,DLDhUvvvfnnYFJuV65Zt2yaS0jPJgvzq,RXDvfPUBYFlVdlueBFbLW0mhhAyGEqpt,1,0,0,0,0,0,1,0,1,0.14285714285714285,1,0.0,0,0,0,0,0,0,0,1,0,0,1,1
5923,78834,Ffohn9JNnGJQD2IavzMTS00ubnVtcb2T,bWdj2GDclj5ofokWjzoa5jAwMkxCykd6,52,79,37,119,18,4,26,1,284,40.57142857142857,10,0.0,18,37,99,18,61,4,20,26,1,172,112,0
5924,78843,FSe393m4kqHOdsL9YDo8QralMIqcUHdZ,A3fsA9Zfv1X2fVEQhTw51lKENdNrEqT3,39,36,1,88,1,5,19,2,152,21.714285714285715,2,0.0,4,1,71,1,32,5,17,19,2,77,75,1
5925,78852,CfllunMvXOvFI7xojIDlg3YUnXMpOZhH,SpATywNh6bZuzm8s1ceuBUnMUAeoAHHw,1,0,0,0,0,0,1,0,1,0.14285714285714285,1,0.0,0,0,0,0,0,0,0,1,0,0,1,1
5926,78879,8a6lcOY5tqRSg2M4LEQLAhRHX2NBy9qe,G8EPVSXsOYB5YQWZGiz1aVq5Pgr2GrQu,46,59,26,64,17,12,12,3,193,27.571428571428573,4,0.0,25,26,47,17,34,12,17,12,3,115,78,0
5927,78880,b5FAs3DRd36MUCxhLKFjsHu3HN0mJvs6,SpATywNh6bZuzm8s1ceuBUnMUAeoAHHw,10,28,21,0,0,5,8,6,68,9.714285714285714,2,0.0,2,21,0,0,26,5,0,8,6,23,45,1
5928,78881,toLFcom7KFecBZf6qB124Knuopx8NQmy,SpATywNh6bZuzm8s1ceuBUnMUAeoAHHw,16,12,6,15,4,0,6,2,45,6.428571428571429,2,0.0,2,6,15,4,10,0,0,6,2,27,18,0
5929,78893,m4OoBDaIG24Lym5ngdexbjC54oYFKP8C,SpATywNh6bZuzm8s1ceuBUnMUAeoAHHw,10,9,2,0,2,0,7,0,20,2.857142857142857,2,0.0,0,2,0,2,9,0,0,7,0,4,16,0
5930,78897,E96VmAw6m1AOHRckdqiq2ASKbnHBlpAb,A3fsA9Zfv1X2fVEQhTw51lKENdNrEqT3,11,25,4,2,0,0,9,0,40,5.714285714285714,3,0.0,0,4,2,0,25,0,0,9,0,6,34,0
5931,78914,azVElWk7I3VwRJA3S907C5a9P0Jn3yCG,SpATywNh6bZuzm8s1ceuBUnMUAeoAHHw,16,28,21,20,9,0,2,0,80,11.428571428571429,4,0.0,4,21,16,9,24,0,4,2,0,50,30,1
5932,78923,8Sqo9fjyeTTkNJlQMuecsmvzSyQTiwcU,A3fsA9Zfv1X2fVEQhTw51lKENdNrEqT3,2,0,0,0,0,0,2,0,2,0.2857142857142857,1,0.0,0,0,0,0,0,0,0,2,0,0,2,1
5933,78937,oZKhsAromYlsN9MhR64yAv55dJDSDM8L,A3fsA9Zfv1X2fVEQhTw51lKENdNrEqT3,43,33,15,76,10,0,6,1,141,20.142857142857142,2,0.0,1,15,63,10,32,0,13,6,1,89,52,1
5934,78947,v9rP8OpiFSURJRERz1ekVHhngFGnpcnQ,A3fsA9Zfv1X2fVEQhTw51lKENdNrEqT3,1,0,0,0,0,0,1,0,1,0.14285714285714285,1,0.0,0,0,0,0,0,0,0,1,0,0,1,1
5935,78948,0OC0czg5KrchA85VzU71XhGpYSu49K6t,SpATywNh6bZuzm8s1ceuBUnMUAeoAHHw,14,20,2,0,1,0,9,0,32,4.571428571428571,2,0.0,4,2,0,1,16,0,0,9,0,7,25,0
5936,78967,GCaUOiguxLs9b5sngb0RwjOWSkIZZOW6,G8EPVSXsOYB5YQWZGiz1aVq5Pgr2GrQu,18,24,0,26,0,0,5,0,55,7.857142857142857,2,0.0,10,0,15,0,14,0,11,5,0,25,30,1
5937,78972,ef55znmweQJrijlI0fO1Ekc271nZnV0m,SpATywNh6bZuzm8s1ceuBUnMUAeoAHHw,28,35,19,13,10,1,14,0,92,13.142857142857142,6,0.0,11,19,13,10,24,1,0,14,0,53,39,0
5938,78980,B07cELO2KlXRGPLctjDn89XuHJVdJwZi,SpATywNh6bZuzm8s1ceuBUnMUAeoAHHw,4,0,0,0,0,1,3,0,4,0.5714285714285714,1,0.0,0,0,0,0,0,1,0,3,0,0,4,1
5939,78981,NohnA6aI0IdpBmazHAgdTY50K8lYcWSq,A3fsA9Zfv1X2fVEQhTw51lKENdNrEqT3,8,4,3,0,3,0,2,0,12,1.7142857142857142,2,0.0,0,3,0,3,4,0,0,2,0,6,6,1
5940,78984,v6Va3YleqjOFxWX0C18ItZbiVgGPA6xX,RXDvfPUBYFlVdlueBFbLW0mhhAyGEqpt,28,62,10,20,3,29,24,2,150,21.428571428571427,7,0.0,6,10,20,3,56,29,0,24,2,39,111,1
5941,78990,bYjPoNbc5ILh7K7s9YR8HLOMNJGN6Ums,bWdj2GDclj5ofokWjzoa5jAwMkxCykd6,4,3,1,0,1,0,1,0,6,0.8571428571428571,1,0.0,0,1,0,1,3,0,0,1,0,2,4,1
5942,79004,xsisvuj6gK52B2ADQNofz9kAaPqANNhO,SpATywNh6bZuzm8s1ceuBUnMUAeoAHHw,11,11,2,0,1,1,8,1,24,3.4285714285714284,2,0.0,0,2,0,1,11,1,0,8,1,3,21,1
5943,79006,mP6z9RZ14UwkQFXdxH2YSItn6R2tzg1x,SpATywNh6bZuzm8s1ceuBUnMUAeoAHHw,19,35,20,16,7,83,14,3,178,25.428571428571427,9,0.0,7,20,15,7,28,83,1,14,3,49,129,1
5944,79007,THie45OT0ypeHdwObqe2tZANN0miCnWz,SpATywNh6bZuzm8s1ceuBUnMUAeoAHHw,9,25,1,18,0,2,3,0,49,7.0,2,0.0,17,1,15,0,8,2,3,3,0,33,16,1
5945,79020,lYvVL2L87vZrMtNfBHPIK2tByK515zCD,SpATywNh6bZuzm8s1ceuBUnMUAeoAHHw,31,54,25,38,12,4,11,0,144,20.571428571428573,2,0.0,9,25,32,12,45,4,6,11,0,78,66,1
5946,79022,twCpzhGO216Hze2mrl4NXCjfHuwTo4Bh,SpATywNh6bZuzm8s1ceuBUnMUAeoAHHw,28,44,27,15,9,0,11,0,106,15.142857142857142,5,0.0,5,27,15,9,39,0,0,11,0,56,50,0
5947,79046,L7niq1ncOBb383w11rnZfYbZzDjcQtn7,SpATywNh6bZuzm8s1ceuBUnMUAeoAHHw,1,0,0,0,0,0,1,0,1,0.14285714285714285,1,0.0,0,0,0,0,0,0,0,1,0,0,1,1
5948,79047,XEg540lTawnkyAL3QhiV5067z0uxHwgk,A3fsA9Zfv1X2fVEQhTw51lKENdNrEqT3,5,2,1,0,1,0,2,0,6,0.8571428571428571,1,0.0,0,1,0,1,2,0,0,2,0,2,4,1
5949,79052,3Ue58lEEP6phWdiZFyqYsSebxfUI01kl,G8EPVSXsOYB5YQWZGiz1aVq5Pgr2GrQu,1,0,0,0,0,0,1,0,1,0.14285714285714285,1,0.0,0,0,0,0,0,0,0,1,0,0,1,1
5950,79055,zTHTtX2nKd2KBXQuLnlYdTrAwR5h128q,SpATywNh6bZuzm8s1ceuBUnMUAeoAHHw,14,25,2,14,1,0,3,0,45,6.428571428571429,2,0.0,13,2,13,1,12,0,1,3,0,29,16,1
5951,79060,iTtOMe88nbiuPASutV8uClvRUhsz01ky,SpATywNh6bZuzm8s1ceuBUnMUAeoAHHw,14,24,1,15,1,4,2,0,47,6.714285714285714,2,0.0,10,1,13,1,14,4,2,2,0,25,22,1
5952,79061,MoBz0U3Ui9CRWte6snkIzBaarIFflstn,SpATywNh6bZuzm8s1ceuBUnMUAeoAHHw,27,39,15,35,7,2,12,3,113,16.142857142857142,3,0.0,13,15,35,7,26,2,0,12,3,70,43,1
5953,79072,J5syH0FXR6WjYKnEvVUNdcCFIQBe5xVs,SpATywNh6bZuzm8s1ceuBUnMUAeoAHHw,10,7,4,0,3,0,4,0,18,2.5714285714285716,1,0.0,0,4,0,3,7,0,0,4,0,7,11,1
5954,79091,jSkiatUtSnpEyEODEjICZMBSnZji4UaY,SpATywNh6bZuzm8s1ceuBUnMUAeoAHHw,9,11,4,0,3,0,6,0,24,3.4285714285714284,1,0.0,0,4,0,3,11,0,0,6,0,7,17,1
5955,79092,7YLwmbXkWTQcIOGJa3UGeXl0rdNkt9r0,SpATywNh6bZuzm8s1ceuBUnMUAeoAHHw,15,25,11,20,4,0,10,0,70,10.0,2,0.0,8,11,17,4,17,0,3,10,0,40,30,1
5956,79110,TpoKGwVbR1z5uy5X3SWIdHRQv5iAfdP8,G8EPVSXsOYB5YQWZGiz1aVq5Pgr2GrQu,84,86,47,212,20,13,12,1,391,55.857142857142854,3,0.0,14,47,193,20,72,13,19,12,1,274,117,0
5957,79137,uGhg5UtMcNJmxDTYVPsOvlEYnzl32Hxh,SpATywNh6bZuzm8s1ceuBUnMUAeoAHHw,1,0,0,0,0,0,1,0,1,0.14285714285714285,1,0.0,0,0,0,0,0,0,0,1,0,0,1,1
5958,79141,uGhg5UtMcNJmxDTYVPsOvlEYnzl32Hxh,bWdj2GDclj5ofokWjzoa5jAwMkxCykd6,1,0,0,0,0,0,1,0,1,0.14285714285714285,1,0.0,0,0,0,0,0,0,0,1,0,0,1,1
5959,79163,LwwIfMdYfjJJxHB8Z4Fggv4xXuygh6dE,A3fsA9Zfv1X2fVEQhTw51lKENdNrEqT3,9,22,3,0,0,0,10,0,35,5.0,6,0.0,2,3,0,0,20,0,0,10,0,5,30,1
5960,79167,Zz3pwLjAzfZui2iOxDBByv28nniL3g2U,SpATywNh6bZuzm8s1ceuBUnMUAeoAHHw,17,26,11,13,5,0,3,0,58,8.285714285714286,2,0.0,10,11,13,5,16,0,0,3,0,39,19,1
5961,79169,LwwIfMdYfjJJxHB8Z4Fggv4xXuygh6dE,bWdj2GDclj5ofokWjzoa5jAwMkxCykd6,20,30,5,42,4,15,14,0,110,15.714285714285714,7,0.0,2,5,36,4,28,15,6,14,0,47,63,0
5962,79170,h774wdF6vIIcl50Js74gckwUtlv9SBGH,SpATywNh6bZuzm8s1ceuBUnMUAeoAHHw,17,58,31,6,5,2,15,1,118,16.857142857142858,7,0.0,12,31,6,5,46,2,0,15,1,54,64,0
5963,79172,layckrYedWZgFw7etRwkXZmJxZfLSCWL,RXDvfPUBYFlVdlueBFbLW0mhhAyGEqpt,7,6,3,0,1,0,6,0,16,2.2857142857142856,3,0.0,0,3,0,1,6,0,0,6,0,4,12,1
5964,79174,D34T8AaHzLaSWIuVXlXMljij4qGduaRA,bWdj2GDclj5ofokWjzoa5jAwMkxCykd6,4,3,0,0,0,0,4,0,7,1.0,1,0.0,0,0,0,0,3,0,0,4,0,0,7,1
5965,79178,7JsrwSACMJjWauKMGXgtvQhEeYIhl4Zy,G8EPVSXsOYB5YQWZGiz1aVq5Pgr2GrQu,19,15,10,0,8,0,2,0,35,5.0,1,0.0,2,10,0,8,13,0,0,2,0,20,15,1
5966,79180,PT6UXcwKy3wc3VzHkqI3gbGZ6DxtjZzB,SpATywNh6bZuzm8s1ceuBUnMUAeoAHHw,11,12,3,0,1,0,6,0,22,3.142857142857143,3,0.0,1,3,0,1,11,0,0,6,0,5,17,0
5967,79195,InUllTAkGXfLdwKOwLDshmASkFan6oBH,SpATywNh6bZuzm8s1ceuBUnMUAeoAHHw,1,0,0,0,0,0,1,0,1,0.14285714285714285,1,0.0,0,0,0,0,0,0,0,1,0,0,1,1
5968,79198,Edg0dAozE0JCiiLSAwIR5kwd1RYH2rd2,G8EPVSXsOYB5YQWZGiz1aVq5Pgr2GrQu,4,2,0,0,0,0,2,0,4,0.5714285714285714,1,0.0,0,0,0,0,2,0,0,2,0,0,4,1
5969,79238,KDatTi0m54YiEzXl0F0AXQe6UojttDHe,SpATywNh6bZuzm8s1ceuBUnMUAeoAHHw,2,0,0,0,0,0,2,0,2,0.2857142857142857,1,0.0,0,0,0,0,0,0,0,2,0,0,2,1
5970,79239,U7VST4h8u3L0dHQ2t3EXKPCnNxPfh7x1,SpATywNh6bZuzm8s1ceuBUnMUAeoAHHw,2,0,0,0,0,0,2,0,2,0.2857142857142857,1,0.0,0,0,0,0,0,0,0,2,0,0,2,1
5971,79244,Rq4yaO7GHrMIHqYMcL0bgP4mTQfRB57T,bWdj2GDclj5ofokWjzoa5jAwMkxCykd6,6,3,1,0,1,0,4,2,11,1.5714285714285714,1,0.0,0,1,0,1,3,0,0,4,2,2,9,1
5972,79263,ZnZiec7AmaGxSp844K5Oif1ySc9WoZ4f,SpATywNh6bZuzm8s1ceuBUnMUAeoAHHw,1,0,0,0,0,0,1,0,1,0.14285714285714285,1,0.0,0,0,0,0,0,0,0,1,0,0,1,1
5973,79273,DpXkrIHIAIPNESKyvFah0WhpVT5PHFeL,A3fsA9Zfv1X2fVEQhTw51lKENdNrEqT3,8,9,7,0,0,4,5,0,25,3.5714285714285716,3,0.0,0,7,0,0,9,4,0,5,0,7,18,1
5974,79281,1bKMONcV6Mq58szdlIajPdFyqaw4BvrA,A3fsA9Zfv1X2fVEQhTw51lKENdNrEqT3,5,2,1,0,1,0,2,0,6,0.8571428571428571,1,0.0,0,1,0,1,2,0,0,2,0,2,4,1
5975,79287,wd4pAwN3deBeynXwR5OfOX4prNtBduEk,bWdj2GDclj5ofokWjzoa5jAwMkxCykd6,9,16,6,0,3,0,3,0,28,4.0,2,0.0,5,6,0,3,11,0,0,3,0,14,14,1
5976,79290,vtrHNbtnxRGyZem1sSOdKIp109fZtSKY,SpATywNh6bZuzm8s1ceuBUnMUAeoAHHw,13,23,15,7,7,7,10,0,69,9.857142857142858,3,0.0,0,15,6,7,23,7,1,10,0,28,41,0
5977,79299,gpn05NwMGqKm6lLZGRrnOmPlhHxlC7Wb,A3fsA9Zfv1X2fVEQhTw51lKENdNrEqT3,52,23,12,111,2,0,13,0,161,23.0,3,0.0,3,12,104,2,20,0,7,13,0,121,40,1
5978,79307,3MN9gqffGxZJqVwbda6Nr5mGlWwnaW7z,G8EPVSXsOYB5YQWZGiz1aVq5Pgr2GrQu,73,83,49,134,38,0,5,0,309,44.142857142857146,3,0.0,28,49,110,38,55,0,24,5,0,225,84,0
5979,79315,b9hN1tjIpM67gB8PuwPQ3u561lqo1V2f,A3fsA9Zfv1X2fVEQhTw51lKENdNrEqT3,30,29,23,12,19,2,12,1,98,14.0,4,0.0,1,23,12,19,28,2,0,12,1,55,43,1
5980,79316,tOQd1UTCcWjv4TzfNnDKeVxaYKZcK6zC,SpATywNh6bZuzm8s1ceuBUnMUAeoAHHw,6,7,5,0,3,0,4,0,19,2.7142857142857144,2,0.0,0,5,0,3,7,0,0,4,0,8,11,1
5981,79320,xJW8ZtKDlfhPg81A47phNyXQMCFChGTr,A3fsA9Zfv1X2fVEQhTw51lKENdNrEqT3,1,0,0,0,0,0,1,0,1,0.14285714285714285,1,0.0,0,0,0,0,0,0,0,1,0,0,1,1
5982,79325,O8PspZcvgkNwi1MucHwbb6Csnu0UqahQ,SpATywNh6bZuzm8s1ceuBUnMUAeoAHHw,7,8,4,0,3,0,1,0,16,2.2857142857142856,2,0.0,2,4,0,3,6,0,0,1,0,9,7,1
5983,79338,pubFqThb9vS8zwU3cGWTlZ3rwYEdRpLE,SpATywNh6bZuzm8s1ceuBUnMUAeoAHHw,9,7,3,0,3,0,4,2,19,2.7142857142857144,1,0.0,0,3,0,3,7,0,0,4,2,6,13,1
5984,79352,giXuT5U1RtMqgo8IXt5j9x4mrlpr0AWq,SpATywNh6bZuzm8s1ceuBUnMUAeoAHHw,23,40,3,24,1,1,14,0,83,11.857142857142858,5,0.0,14,3,22,1,26,1,2,14,0,40,43,0
5985,79358,YUp9wnsqBKRrw8pzgc3Bo2ZNocfIQJ74,SpATywNh6bZuzm8s1ceuBUnMUAeoAHHw,5,3,1,0,1,0,3,0,8,1.1428571428571428,1,0.0,1,1,0,1,2,0,0,3,0,3,5,1
5986,79374,2Z36vzEoy2AuTF2qkFNHld62ohkbaoik,G8EPVSXsOYB5YQWZGiz1aVq5Pgr2GrQu,5,4,2,0,1,0,7,0,14,2.0,2,0.0,0,2,0,1,4,0,0,7,0,3,11,1
5987,79378,LgPlpopSU02baX8XsEJO6rWixplusEKm,SpATywNh6bZuzm8s1ceuBUnMUAeoAHHw,24,40,24,9,6,2,13,0,94,13.428571428571429,6,0.0,10,24,8,6,30,2,1,13,0,48,46,0
5988,79382,txR343znllIAYfUTT6ID4MaG49Hdxeix,A3fsA9Zfv1X2fVEQhTw51lKENdNrEqT3,12,8,7,0,4,1,12,0,32,4.571428571428571,2,0.0,1,7,0,4,7,1,0,12,0,12,20,1
5989,79392,yUyVc0xcETBdtpqOJUXovZ3QcO5gddPt,SpATywNh6bZuzm8s1ceuBUnMUAeoAHHw,10,9,4,0,2,0,3,0,18,2.5714285714285716,3,0.0,2,4,0,2,7,0,0,3,0,8,10,1
5990,79408,xrzB2fu1qTsTekSF1ue54a05GliBSiQw,G8EPVSXsOYB5YQWZGiz1aVq5Pgr2GrQu,1,0,0,0,0,0,1,0,1,0.14285714285714285,1,0.0,0,0,0,0,0,0,0,1,0,0,1,0
5991,79415,hDbCMto0j5iDn7Maxag0gQGk8WC8ErXx,A3fsA9Zfv1X2fVEQhTw51lKENdNrEqT3,1,0,0,0,0,0,1,0,1,0.14285714285714285,1,0.0,0,0,0,0,0,0,0,1,0,0,1,1
5992,79416,s1GlDLVUCJ2BKuqNJCwk2KXE92Q3fWuw,SpATywNh6bZuzm8s1ceuBUnMUAeoAHHw,2,0,0,0,0,0,2,0,2,0.2857142857142857,1,0.0,0,0,0,0,0,0,0,2,0,0,2,1
5993,79417,hDbCMto0j5iDn7Maxag0gQGk8WC8ErXx,bWdj2GDclj5ofokWjzoa5jAwMkxCykd6,1,0,0,0,0,0,1,0,1,0.14285714285714285,1,0.0,0,0,0,0,0,0,0,1,0,0,1,1
5994,79430,3MN9gqffGxZJqVwbda6Nr5mGlWwnaW7z,SpATywNh6bZuzm8s1ceuBUnMUAeoAHHw,20,30,20,0,10,0,9,0,69,9.857142857142858,3,0.0,2,20,0,10,28,0,0,9,0,32,37,0
5995,79443,FhE6YIauK1Fn9VMPL41bdd6jvfL2mFQX,SpATywNh6bZuzm8s1ceuBUnMUAeoAHHw,20,26,12,20,5,2,9,1,75,10.714285714285714,3,0.0,10,12,17,5,16,2,3,9,1,44,31,1
5996,79447,xhSNxzAdJZ3UvqN1HWRUi586YbiFg3gP,A3fsA9Zfv1X2fVEQhTw51lKENdNrEqT3,2,0,0,0,0,0,4,0,4,0.5714285714285714,1,0.0,0,0,0,0,0,0,0,4,0,0,4,1
5997,79458,onuTApdLgDnonVluLQhn0MEl8fr7acBD,SpATywNh6bZuzm8s1ceuBUnMUAeoAHHw,6,5,0,0,0,0,10,0,15,2.142857142857143,1,0.0,0,0,0,0,5,0,0,10,0,0,15,1
5998,79468,f1tp9GXe4J7KK6zPunhxBF4LGwylqtkw,A3fsA9Zfv1X2fVEQhTw51lKENdNrEqT3,1,0,0,0,0,0,1,0,1,0.14285714285714285,1,0.0,0,0,0,0,0,0,0,1,0,0,1,1
5999,79469,fu60FMGFqAwgUp8glfVKZNcdqYonSFb4,bWdj2GDclj5ofokWjzoa5jAwMkxCykd6,1,0,0,0,0,0,1,0,1,0.14285714285714285,1,0.0,0,0,0,0,0,0,0,1,0,0,1,1
6000,79478,JpLo3QIFwGWGVDbiGmNZwT1Vbl57aYGg,bWdj2GDclj5ofokWjzoa5jAwMkxCykd6,9,7,1,14,3,0,4,0,29,4.142857142857143,1,0.0,5,1,14,3,2,0,0,4,0,23,6,1
6001,79498,GPbq86k98Rz9tUbijEEopIymy9u0Fcyf,RXDvfPUBYFlVdlueBFbLW0mhhAyGEqpt,24,22,18,38,5,1,5,4,93,13.285714285714286,2,0.0,3,18,30,5,19,1,8,5,4,56,37,1
6002,79511,NMqhcmmxkLiM0RcDlPlkNnMgmo9q8VT7,A3fsA9Zfv1X2fVEQhTw51lKENdNrEqT3,3,4,0,0,0,0,1,0,5,0.7142857142857143,1,0.0,0,0,0,0,4,0,0,1,0,0,5,1
6003,79516,PSAOLNrXnjwLk6spKn3AQn9MyKNbkNFR,A3fsA9Zfv1X2fVEQhTw51lKENdNrEqT3,10,7,5,0,4,0,3,0,19,2.7142857142857144,1,0.0,0,5,0,4,7,0,0,3,0,9,10,1
6004,79530,iF24oNq097ygA95BwYxAfvpVnpWVn9EH,A3fsA9Zfv1X2fVEQhTw51lKENdNrEqT3,1,0,0,0,0,0,1,0,1,0.14285714285714285,1,0.0,0,0,0,0,0,0,0,1,0,0,1,1
6005,79565,9XlOX9Eokvp6Ei0R3cZVPHieVEjDZ3jD,SpATywNh6bZuzm8s1ceuBUnMUAeoAHHw,1,0,0,0,0,0,1,0,1,0.14285714285714285,1,0.0,0,0,0,0,0,0,0,1,0,0,1,1
6006,79568,rZUdPpi92l1qQIS8kuhajEO9kujkZRBg,SpATywNh6bZuzm8s1ceuBUnMUAeoAHHw,2,0,0,0,0,0,3,0,3,0.42857142857142855,2,0.0,0,0,0,0,0,0,0,3,0,0,3,1
6007,79580,D5cI8Qw5g3uZUHpPzRKVsXECgTB7bAYQ,SpATywNh6bZuzm8s1ceuBUnMUAeoAHHw,7,3,1,0,1,0,3,0,8,1.1428571428571428,1,0.0,0,1,0,1,3,0,0,3,0,2,6,1
6008,79582,yMKOk0dVftHnVR1CEiO9scq4ARXi4xK4,A3fsA9Zfv1X2fVEQhTw51lKENdNrEqT3,15,6,6,0,6,0,3,0,21,3.0,1,0.0,0,6,0,6,6,0,0,3,0,12,9,0
6009,79584,ZbdgVvxsxyG1aqBQ8n6eLVu27gWAZvhX,A3fsA9Zfv1X2fVEQhTw51lKENdNrEqT3,1,0,0,0,0,0,1,0,1,0.14285714285714285,1,0.0,0,0,0,0,0,0,0,1,0,0,1,1
6010,79596,dOESZLIKPuHnZVCxKOM963mYGkTHRDgL,SpATywNh6bZuzm8s1ceuBUnMUAeoAHHw,1,0,0,0,0,0,1,0,1,0.14285714285714285,1,0.0,0,0,0,0,0,0,0,1,0,0,1,1
6011,79606,ZOTpNZ0MPCzhXQVB7FrlPGVckR2bh01V,SpATywNh6bZuzm8s1ceuBUnMUAeoAHHw,16,49,6,17,2,6,18,1,99,14.142857142857142,4,0.0,19,6,16,2,30,6,1,18,1,43,56,0
6012,79608,cqucGUKHc5OyzV7unT5Cx0FmLMjKSwuY,SpATywNh6bZuzm8s1ceuBUnMUAeoAHHw,23,30,1,25,0,1,9,1,67,9.571428571428571,3,0.0,11,1,25,0,19,1,0,9,1,37,30,1
6013,79612,WEqJEPw3UV2Mp3IuXDKYrDsEow0Eq2np,SpATywNh6bZuzm8s1ceuBUnMUAeoAHHw,22,14,9,8,7,0,3,0,41,5.857142857142857,1,0.0,5,9,8,7,9,0,0,3,0,29,12,1
6014,79614,fIRimGrxWNqdzbEvkhoxiWFjGRhUXcWW,A3fsA9Zfv1X2fVEQhTw51lKENdNrEqT3,26,41,14,0,10,0,6,0,71,10.142857142857142,4,0.0,0,14,0,10,41,0,0,6,0,24,47,0
6015,79639,HHjw6PARN0UbkiffbOwvG4RULtVIyY0R,RXDvfPUBYFlVdlueBFbLW0mhhAyGEqpt,11,19,1,0,1,4,4,0,29,4.142857142857143,3,0.0,1,1,0,1,18,4,0,4,0,3,26,0
6016,79644,tx5OZwe4nbDaE4essnf26SrQBKKIE3v3,SpATywNh6bZuzm8s1ceuBUnMUAeoAHHw,12,19,3,0,3,1,11,0,37,5.285714285714286,1,0.0,0,3,0,3,19,1,0,11,0,6,31,1
6017,79658,MIuMzVdl8gwQZWh4ux7IRLhRo5aprHQC,A3fsA9Zfv1X2fVEQhTw51lKENdNrEqT3,24,13,10,0,10,0,2,0,35,5.0,1,0.0,0,10,0,10,13,0,0,2,0,20,15,1
6018,79672,kzKMRE4CEMjRtmtzEE50k044KTV0exYI,A3fsA9Zfv1X2fVEQhTw51lKENdNrEqT3,4,2,0,0,0,0,2,0,4,0.5714285714285714,1,0.0,0,0,0,0,2,0,0,2,0,0,4,1
6019,79685,gcVoHE2eZKEdZoZi7osuc3qSbsrdZukl,SpATywNh6bZuzm8s1ceuBUnMUAeoAHHw,5,2,1,0,1,0,2,0,6,0.8571428571428571,1,0.0,0,1,0,1,2,0,0,2,0,2,4,1
6020,79689,yMKOk0dVftHnVR1CEiO9scq4ARXi4xK4,RXDvfPUBYFlVdlueBFbLW0mhhAyGEqpt,31,15,15,0,14,0,9,0,53,7.571428571428571,2,0.0,0,15,0,14,15,0,0,9,0,29,24,1
6021,79708,rScZ8wYdCfayAwidHm4E5aYRTim0GnWj,A3fsA9Zfv1X2fVEQhTw51lKENdNrEqT3,7,3,2,0,2,0,4,0,11,1.5714285714285714,1,0.0,0,2,0,2,3,0,0,4,0,4,7,1
6022,79716,WIkPVA3ZQexYqPa7aSal3hPiR2XYOXKW,SpATywNh6bZuzm8s1ceuBUnMUAeoAHHw,5,4,2,0,0,0,2,0,8,1.1428571428571428,1,0.0,1,2,0,0,3,0,0,2,0,3,5,1
6023,79730,DfqPNSIrdvOzcxA1l2O2553pTk1dT4j1,SpATywNh6bZuzm8s1ceuBUnMUAeoAHHw,6,3,2,0,2,0,1,0,8,1.1428571428571428,1,0.0,0,2,0,2,3,0,0,1,0,4,4,1
6024,79750,iRchfzTUfvY9CtdBwkeS8vPP8TSfaMHm,A3fsA9Zfv1X2fVEQhTw51lKENdNrEqT3,9,12,6,0,5,0,6,0,29,4.142857142857143,1,0.0,1,6,0,5,11,0,0,6,0,12,17,1
6025,79754,wYJCkBOQ32exeR75AeEladGac7kG04uu,G8EPVSXsOYB5YQWZGiz1aVq5Pgr2GrQu,2,0,0,0,0,0,2,0,2,0.2857142857142857,1,0.0,0,0,0,0,0,0,0,2,0,0,2,1
6026,79762,cRzRjCJgmuuwG5N13DvLSiSY2kvou3I1,RXDvfPUBYFlVdlueBFbLW0mhhAyGEqpt,7,3,2,0,2,0,3,0,10,1.4285714285714286,1,0.0,0,2,0,2,3,0,0,3,0,4,6,1
6027,79767,ffg9VbmMkFKj2DfO61ClA5PDHr5Xa6gN,A3fsA9Zfv1X2fVEQhTw51lKENdNrEqT3,16,37,7,0,6,0,5,0,55,7.857142857142857,5,0.0,0,7,0,6,37,0,0,5,0,13,42,1
6028,79783,MMo67tZd2HnjPcYw7tUwheGT7fqD2cqI,SpATywNh6bZuzm8s1ceuBUnMUAeoAHHw,30,40,14,38,10,28,16,4,150,21.428571428571427,1,0.0,25,14,35,10,15,28,3,16,4,84,66,0
6029,79789,WIkPVA3ZQexYqPa7aSal3hPiR2XYOXKW,A3fsA9Zfv1X2fVEQhTw51lKENdNrEqT3,42,18,16,60,13,0,2,0,109,15.571428571428571,1,0.0,1,16,52,13,17,0,8,2,0,82,27,1
6030,79797,ziI4sKMlAzhuWPMy9t2U96G01O68Dxyj,A3fsA9Zfv1X2fVEQhTw51lKENdNrEqT3,27,6,1,54,1,0,10,0,72,10.285714285714286,2,0.0,1,1,47,1,5,0,7,10,0,50,22,0
6031,79798,tFCnCHPhdyVxBnAUk6TxLus2jXyEZIZz,SpATywNh6bZuzm8s1ceuBUnMUAeoAHHw,1,0,0,0,0,0,1,0,1,0.14285714285714285,1,0.0,0,0,0,0,0,0,0,1,0,0,1,1
6032,79806,Ku1kMcdvssJWj6FcSWxZr39sjgOG0VOZ,SpATywNh6bZuzm8s1ceuBUnMUAeoAHHw,17,20,11,18,6,3,9,0,67,9.571428571428571,2,0.0,6,11,15,6,14,3,3,9,0,38,29,1
6033,79813,qMFAmPw34z5IViYTtA1Kkpcn2uEg1WBM,RXDvfPUBYFlVdlueBFbLW0mhhAyGEqpt,21,29,13,16,10,0,3,0,71,10.142857142857142,3,0.0,4,13,14,10,25,0,2,3,0,41,30,1
6034,79820,h8BwrBZ61dHhi5fhxZzTUeeYh9J3sER4,SpATywNh6bZuzm8s1ceuBUnMUAeoAHHw,2,0,0,0,0,0,2,0,2,0.2857142857142857,1,0.0,0,0,0,0,0,0,0,2,0,0,2,1
6035,79825,TsxkgE9HYxx9Zb0VBXE5lsblSSqIkd78,SpATywNh6bZuzm8s1ceuBUnMUAeoAHHw,5,15,5,0,1,0,1,0,22,3.142857142857143,1,0.0,0,5,0,1,15,0,0,1,0,6,16,1
6036,79851,g8GfWRB0OxvXROL4NPNW5ZSi8XCvG0Vj,SpATywNh6bZuzm8s1ceuBUnMUAeoAHHw,1,0,0,0,0,0,1,0,1,0.14285714285714285,1,0.0,0,0,0,0,0,0,0,1,0,0,1,1
6037,79859,gEzMd6gbgpZIm67NWd6vqHpEEo3Eo4i8,SpATywNh6bZuzm8s1ceuBUnMUAeoAHHw,7,3,2,0,2,4,5,0,16,2.2857142857142856,2,0.0,0,2,0,2,3,4,0,5,0,4,12,1
6038,79861,E2JkawM7swORjZfJKIvXjkQElhQ86LjY,SpATywNh6bZuzm8s1ceuBUnMUAeoAHHw,5,2,0,0,1,0,2,0,5,0.7142857142857143,1,0.0,0,0,0,1,2,0,0,2,0,1,4,1
6039,79872,kFWoX8WayJBb1JiJ1zWV3jeUZLUqB1uv,SpATywNh6bZuzm8s1ceuBUnMUAeoAHHw,1,0,0,0,0,0,1,0,1,0.14285714285714285,1,0.0,0,0,0,0,0,0,0,1,0,0,1,1
6040,79874,P9ocaJAKrVY3fEwlpYkQdiICF2x4gV0B,SpATywNh6bZuzm8s1ceuBUnMUAeoAHHw,1,0,0,0,0,0,1,0,1,0.14285714285714285,1,0.0,0,0,0,0,0,0,0,1,0,0,1,1
6041,79887,yonwfYKGqRaxFqA59D8fadwOwcb5hmqL,SpATywNh6bZuzm8s1ceuBUnMUAeoAHHw,31,70,28,42,12,23,28,1,204,29.142857142857142,9,0.0,22,28,39,12,48,23,3,28,1,101,103,1
6042,79893,Wd5Y51TL4njlLeYHUjz5D9nrsHvDXUZ8,bWdj2GDclj5ofokWjzoa5jAwMkxCykd6,4,2,1,0,1,0,1,0,5,0.7142857142857143,1,0.0,0,1,0,1,2,0,0,1,0,2,3,1
6043,79908,Q2dKqJgalCRkN8Z90Lq1SNPa32DtEIlR,A3fsA9Zfv1X2fVEQhTw51lKENdNrEqT3,4,2,0,0,0,0,3,0,5,0.7142857142857143,2,0.0,0,0,0,0,2,0,0,3,0,0,5,1
6044,79912,6aZq0tRjnqwqsZYSpN4QHIWtCCCKxYqK,A3fsA9Zfv1X2fVEQhTw51lKENdNrEqT3,7,3,2,0,2,0,2,0,9,1.2857142857142858,1,0.0,0,2,0,2,3,0,0,2,0,4,5,1
6045,79950,mvNsYHmLGVvx6RdgKEq4DO6WGtgd6ICk,G8EPVSXsOYB5YQWZGiz1aVq5Pgr2GrQu,2,0,0,0,0,0,2,0,2,0.2857142857142857,1,0.0,0,0,0,0,0,0,0,2,0,0,2,1
6046,79951,mvNsYHmLGVvx6RdgKEq4DO6WGtgd6ICk,RXDvfPUBYFlVdlueBFbLW0mhhAyGEqpt,2,0,0,0,0,0,2,0,2,0.2857142857142857,1,0.0,0,0,0,0,0,0,0,2,0,0,2,1
6047,79954,U0h9ZcOzwmSa5zXabz3gRq51gj9CVPUf,SpATywNh6bZuzm8s1ceuBUnMUAeoAHHw,23,37,19,28,7,7,10,0,108,15.428571428571429,4,0.0,9,19,27,7,28,7,1,10,0,62,46,0
6048,79959,ViTvmoQakNqraCyfp2YEkEE863w1n9bk,A3fsA9Zfv1X2fVEQhTw51lKENdNrEqT3,13,22,15,0,12,0,7,0,56,8.0,2,0.0,1,15,0,12,21,0,0,7,0,28,28,1
6049,79973,lxjW2IwfKKnK2DrRSZaIR9GsDl9lxdt8,A3fsA9Zfv1X2fVEQhTw51lKENdNrEqT3,32,34,19,0,14,1,14,1,83,11.857142857142858,5,0.0,0,19,0,14,34,1,0,14,1,33,50,0
6050,79979,CNhJjrWccp5AYlucreTqDX8ieLTPwczE,bWdj2GDclj5ofokWjzoa5jAwMkxCykd6,1,0,0,0,0,0,1,0,1,0.14285714285714285,1,0.0,0,0,0,0,0,0,0,1,0,0,1,1
6051,79986,4LisTHudeBfv9ZX0nmcSnvoJT2p6nfzE,RXDvfPUBYFlVdlueBFbLW0mhhAyGEqpt,5,2,0,0,0,0,4,1,7,1.0,1,0.0,0,0,0,0,2,0,0,4,1,0,7,1
6052,79987,N3hAbbmjAcgnrOfHxCtYgYIWhCN4yU2c,SpATywNh6bZuzm8s1ceuBUnMUAeoAHHw,29,48,15,37,8,8,11,5,132,18.857142857142858,1,0.0,18,15,33,8,30,8,4,11,5,74,58,1
6053,79990,M0c3f3OA8Aim8kZWQMZkBlO1O030yIDl,A3fsA9Zfv1X2fVEQhTw51lKENdNrEqT3,7,4,1,0,1,0,7,0,13,1.8571428571428572,1,0.0,0,1,0,1,4,0,0,7,0,2,11,1
6054,79991,CmIaRR2qgpGVOUIbsTC8R6ZChGQweVzS,SpATywNh6bZuzm8s1ceuBUnMUAeoAHHw,1,0,0,0,0,0,1,0,1,0.14285714285714285,1,0.0,0,0,0,0,0,0,0,1,0,0,1,1
6055,79992,zYV55JtHGMyWJNzyklwx9RUxhxbuIU91,SpATywNh6bZuzm8s1ceuBUnMUAeoAHHw,16,15,11,16,0,0,6,0,48,6.857142857142857,2,0.0,2,11,13,0,13,0,3,6,0,26,22,1
6056,80003,8MTzNIeHZxoPzUB3QuA9UPwzkLipeLI2,SpATywNh6bZuzm8s1ceuBUnMUAeoAHHw,27,26,15,28,8,0,2,0,79,11.285714285714286,1,0.0,9,15,24,8,17,0,4,2,0,56,23,0
6057,80011,va3cVfF38XAjn4LEh6VxTTEdlP5IupZ2,A3fsA9Zfv1X2fVEQhTw51lKENdNrEqT3,37,25,0,52,0,0,6,0,83,11.857142857142858,1,0.0,3,0,47,0,22,0,5,6,0,50,33,1
6058,80028,HW81M2taDDpjfIALyR6RGLxMn7Z51s6I,SpATywNh6bZuzm8s1ceuBUnMUAeoAHHw,6,3,1,0,1,0,2,0,7,1.0,1,0.0,0,1,0,1,3,0,0,2,0,2,5,1
6059,80047,QjwQzuiA6TAJjCb0ag4sYfZRjiTOPACp,SpATywNh6bZuzm8s1ceuBUnMUAeoAHHw,27,58,34,26,16,1,19,0,154,22.0,6,0.0,6,34,22,16,52,1,4,19,0,78,76,0
6060,80052,dALdfMzfktV6uHq0TdqzSFS1vTHWuBBf,RXDvfPUBYFlVdlueBFbLW0mhhAyGEqpt,1,0,0,0,0,0,1,0,1,0.14285714285714285,1,0.0,0,0,0,0,0,0,0,1,0,0,1,1
6061,80060,PeuNsQ0DfVUJN0dfnSQ4wu6EhabO3RIr,SpATywNh6bZuzm8s1ceuBUnMUAeoAHHw,6,11,4,0,2,0,5,0,22,3.142857142857143,2,0.0,0,4,0,2,11,0,0,5,0,6,16,1
6062,80068,u88ty77IjrBmBqGSc7g01hskCAQHKUhV,SpATywNh6bZuzm8s1ceuBUnMUAeoAHHw,1,0,0,0,0,0,1,0,1,0.14285714285714285,1,0.0,0,0,0,0,0,0,0,1,0,0,1,1
6063,80069,srJeJbIuD6nlvLtYdUFiQcvh7X1ghk8m,A3fsA9Zfv1X2fVEQhTw51lKENdNrEqT3,1,0,0,0,0,0,1,0,1,0.14285714285714285,1,0.0,0,0,0,0,0,0,0,1,0,0,1,1
6064,80090,IAOTVxG7e06ArppQIZcVBCeppiZS52Zi,bWdj2GDclj5ofokWjzoa5jAwMkxCykd6,1,0,0,0,0,0,1,0,1,0.14285714285714285,1,0.0,0,0,0,0,0,0,0,1,0,0,1,1
6065,80096,IAOTVxG7e06ArppQIZcVBCeppiZS52Zi,A3fsA9Zfv1X2fVEQhTw51lKENdNrEqT3,1,0,0,0,0,0,1,0,1,0.14285714285714285,1,0.0,0,0,0,0,0,0,0,1,0,0,1,1
6066,80097,RPansaKc9yPYyKahcqLAJO6a0GoBHglr,bWdj2GDclj5ofokWjzoa5jAwMkxCykd6,10,16,6,32,6,7,6,0,73,10.428571428571429,4,0.0,7,6,30,6,9,7,2,6,0,49,24,1
6067,80124,CUvKB4XQpBmSBshZw5ZdyRvSPwxCLw87,SpATywNh6bZuzm8s1ceuBUnMUAeoAHHw,1,0,0,0,0,0,1,0,1,0.14285714285714285,1,0.0,0,0,0,0,0,0,0,1,0,0,1,1
6068,80132,hnPqEloZo6dqHCQR5BDkkOtRq9rLOuCJ,RXDvfPUBYFlVdlueBFbLW0mhhAyGEqpt,2,0,0,0,0,0,2,0,2,0.2857142857142857,1,0.0,0,0,0,0,0,0,0,2,0,0,2,1
6069,80136,XQFWhrsULMJrGiXoFieAPwx4Rm1ETQ8D,SpATywNh6bZuzm8s1ceuBUnMUAeoAHHw,28,50,27,27,10,2,12,0,128,18.285714285714285,6,0.0,13,27,26,10,37,2,1,12,0,76,52,0
6070,80140,yvsrEHHhwnRtY4nOPyuGoTME5YnK10XZ,SpATywNh6bZuzm8s1ceuBUnMUAeoAHHw,6,7,1,0,1,0,2,0,11,1.5714285714285714,1,0.0,0,1,0,1,7,0,0,2,0,2,9,1
6071,80145,LW6Tlr1sh6qRnRRoccMyoktiDikrPY7X,SpATywNh6bZuzm8s1ceuBUnMUAeoAHHw,5,2,1,0,1,0,2,0,6,0.8571428571428571,1,0.0,0,1,0,1,2,0,0,2,0,2,4,1
6072,80153,WltsLfDHgmeE6MCb49VMxs0TpIKzPZYO,SpATywNh6bZuzm8s1ceuBUnMUAeoAHHw,6,3,1,0,1,0,2,0,7,1.0,1,0.0,0,1,0,1,3,0,0,2,0,2,5,1
6073,80167,P4jUBX1wYi9y3sCR2kOEae0bW8qmRIv0,SpATywNh6bZuzm8s1ceuBUnMUAeoAHHw,8,13,6,0,3,0,6,0,28,4.0,1,0.0,0,6,0,3,13,0,0,6,0,9,19,1
6074,80196,y6xjaNTFuIUic3qLUBgR8svfOIFXDQ53,A3fsA9Zfv1X2fVEQhTw51lKENdNrEqT3,2,0,0,0,0,0,4,0,4,0.5714285714285714,1,0.0,0,0,0,0,0,0,0,4,0,0,4,1
6075,80202,fmLFfxTDbxBjR0ZGqW3ABKUJvjXC97BH,RXDvfPUBYFlVdlueBFbLW0mhhAyGEqpt,8,3,1,0,1,0,4,1,10,1.4285714285714286,1,0.0,0,1,0,1,3,0,0,4,1,2,8,1
6076,80207,53qrF6M0dMx7kKnOiKvVv5yJevXuY3XD,RXDvfPUBYFlVdlueBFbLW0mhhAyGEqpt,52,33,21,87,10,5,10,7,173,24.714285714285715,2,0.0,8,21,79,10,25,5,8,10,7,118,55,1
6077,80208,A6qBZik0VBfWjUh1l97ldNrUQvZV7VDA,bWdj2GDclj5ofokWjzoa5jAwMkxCykd6,7,5,2,0,2,0,2,0,11,1.5714285714285714,1,0.0,0,2,0,2,5,0,0,2,0,4,7,1
6078,80226,IVH8kKmCoTvdDqBRydeePjJ8DeEc5nxo,G8EPVSXsOYB5YQWZGiz1aVq5Pgr2GrQu,12,7,1,8,2,2,9,1,30,4.285714285714286,2,0.0,4,1,5,2,3,2,3,9,1,12,18,1
6079,80231,v20UMppd3ocHkd49REEhfohYTaesL83r,SpATywNh6bZuzm8s1ceuBUnMUAeoAHHw,6,9,4,0,2,0,5,0,20,2.857142857142857,5,0.0,3,4,0,2,6,0,0,5,0,9,11,1
6080,80243,JouvtE8n4ChPr4xaVaDvsPHmw4GRKG3o,SpATywNh6bZuzm8s1ceuBUnMUAeoAHHw,2,0,0,0,0,0,2,0,2,0.2857142857142857,1,0.0,0,0,0,0,0,0,0,2,0,0,2,1
6081,80256,qbxr7nsJKbupU2nnOZ4AXSvMY5DklIDV,SpATywNh6bZuzm8s1ceuBUnMUAeoAHHw,20,26,13,1,6,0,8,0,54,7.714285714285714,4,0.0,6,13,1,6,20,0,0,8,0,26,28,0
6082,80258,AlLFcyRB5UwpN8dJK67Vqu0OFPpIDrGm,A3fsA9Zfv1X2fVEQhTw51lKENdNrEqT3,68,56,46,168,31,18,9,0,328,46.857142857142854,4,0.0,4,46,137,31,52,18,31,9,0,218,110,0
6083,80259,BJsE566nx9Uhzip3qBQTh9T7yFdMy0IZ,SpATywNh6bZuzm8s1ceuBUnMUAeoAHHw,6,4,1,0,1,0,1,0,7,1.0,1,0.0,0,1,0,1,4,0,0,1,0,2,5,1
6084,80283,TY4t65XwSRMNK0q3MPTxoH0jDDniCwnz,bWdj2GDclj5ofokWjzoa5jAwMkxCykd6,1,0,0,0,0,0,1,0,1,0.14285714285714285,1,0.0,0,0,0,0,0,0,0,1,0,0,1,1
6085,80287,TY4t65XwSRMNK0q3MPTxoH0jDDniCwnz,RXDvfPUBYFlVdlueBFbLW0mhhAyGEqpt,2,0,0,0,0,0,2,0,2,0.2857142857142857,1,0.0,0,0,0,0,0,0,0,2,0,0,2,1
6086,80288,TY4t65XwSRMNK0q3MPTxoH0jDDniCwnz,A3fsA9Zfv1X2fVEQhTw51lKENdNrEqT3,1,0,0,0,0,0,1,0,1,0.14285714285714285,1,0.0,0,0,0,0,0,0,0,1,0,0,1,1
6087,80289,ZNeDcv9lqRN7ZQjZM2CkfhEwlbeNJpas,SpATywNh6bZuzm8s1ceuBUnMUAeoAHHw,29,24,15,22,7,3,14,2,87,12.428571428571429,5,0.0,4,15,21,7,20,3,1,14,2,47,40,0
6088,80298,TY4t65XwSRMNK0q3MPTxoH0jDDniCwnz,SpATywNh6bZuzm8s1ceuBUnMUAeoAHHw,1,0,0,0,0,0,1,0,1,0.14285714285714285,1,0.0,0,0,0,0,0,0,0,1,0,0,1,1
6089,80324,I90xPqkS9HpEgNxHw8dM4fDCcTPeHknd,A3fsA9Zfv1X2fVEQhTw51lKENdNrEqT3,1,0,0,0,0,0,1,0,1,0.14285714285714285,1,0.0,0,0,0,0,0,0,0,1,0,0,1,1
6090,80333,3BztBUlI63kL9yRcRfPOmeFpKMf9EWqH,SpATywNh6bZuzm8s1ceuBUnMUAeoAHHw,13,24,5,16,3,0,1,0,49,7.0,1,0.0,15,5,13,3,9,0,3,1,0,36,13,1
6091,80339,XT1waMohYamMih4d0cft0xqoQTrmFfop,SpATywNh6bZuzm8s1ceuBUnMUAeoAHHw,5,2,1,0,1,0,4,0,8,1.1428571428571428,1,0.0,0,1,0,1,2,0,0,4,0,2,6,1
6092,80344,EFMEoi5W4mceo8rjft5LKrYvvT3E2eat,A3fsA9Zfv1X2fVEQhTw51lKENdNrEqT3,6,4,1,0,1,0,3,0,9,1.2857142857142858,2,0.0,0,1,0,1,4,0,0,3,0,2,7,1
6093,80347,XEEROzXFwjY4oyjlmSc2mETyORRAjvE9,RXDvfPUBYFlVdlueBFbLW0mhhAyGEqpt,1,0,0,0,0,0,1,0,1,0.14285714285714285,1,0.0,0,0,0,0,0,0,0,1,0,0,1,1
6094,80348,9D8Fr85Y0xJSTSvXENunTRQkQQzpKKhe,bWdj2GDclj5ofokWjzoa5jAwMkxCykd6,19,24,14,72,4,4,14,1,133,19.0,5,0.0,5,14,68,4,19,4,4,14,1,91,42,1
6095,80349,d7Yl1K2nrAPh1Q4Gl4OFPqaLmDsQKnZb,SpATywNh6bZuzm8s1ceuBUnMUAeoAHHw,11,10,1,3,0,0,2,0,16,2.2857142857142856,1,0.0,4,1,3,0,6,0,0,2,0,8,8,1
6096,80360,eShFyPGgCT65uThL7XGiKvmljTNciFAA,G8EPVSXsOYB5YQWZGiz1aVq5Pgr2GrQu,34,54,8,50,8,6,17,1,144,20.571428571428573,4,0.0,15,8,36,8,39,6,14,17,1,67,77,1
6097,80373,YrgwsEFjLyT5SXSOyIIpFlTBfXK1acSP,bWdj2GDclj5ofokWjzoa5jAwMkxCykd6,19,17,7,32,7,1,5,2,71,10.142857142857142,2,0.0,8,7,25,7,9,1,7,5,2,47,24,0
6098,80396,3B3YADugrZ4bBgjxxClgqtVXSh5LmkAW,SpATywNh6bZuzm8s1ceuBUnMUAeoAHHw,1,0,0,0,0,0,1,0,1,0.14285714285714285,1,0.0,0,0,0,0,0,0,0,1,0,0,1,1
6099,80400,xH5f8nfW6oTIgHjXoQgEUKIx6qvDN8rk,A3fsA9Zfv1X2fVEQhTw51lKENdNrEqT3,5,4,0,0,0,0,6,0,10,1.4285714285714286,3,0.0,0,0,0,0,4,0,0,6,0,0,10,1
6100,80406,9d6HoNqzGbbCd66bGVck7uPSgkXTez3M,G8EPVSXsOYB5YQWZGiz1aVq5Pgr2GrQu,14,26,5,4,5,0,9,0,49,7.0,5,0.0,11,5,3,5,15,0,1,9,0,24,25,1
6101,80429,3WaaFhQhqNoXoyRVVZyUHNenDiDckaYh,bWdj2GDclj5ofokWjzoa5jAwMkxCykd6,1,0,0,0,0,0,1,0,1,0.14285714285714285,1,0.0,0,0,0,0,0,0,0,1,0,0,1,1
6102,80437,ef12hM7jr4TcIrwraImsdOigb7ZzGQBR,SpATywNh6bZuzm8s1ceuBUnMUAeoAHHw,13,15,1,12,1,2,3,0,34,4.857142857142857,2,0.0,3,1,12,1,12,2,0,3,0,17,17,1
6103,80439,hw4USDUss7xpmyvWKsTyQsT2eAX2LBFT,SpATywNh6bZuzm8s1ceuBUnMUAeoAHHw,1,0,0,0,0,0,1,0,1,0.14285714285714285,1,0.0,0,0,0,0,0,0,0,1,0,0,1,1
6104,80442,d50GHjVwwNPRl6KQMtLsCG0z8s5vd7XF,bWdj2GDclj5ofokWjzoa5jAwMkxCykd6,4,2,0,0,0,0,2,0,4,0.5714285714285714,1,0.0,0,0,0,0,2,0,0,2,0,0,4,1
6105,80452,oIncNl2qqfpjBksI2zhFahnNU9rnYXqO,SpATywNh6bZuzm8s1ceuBUnMUAeoAHHw,8,5,1,0,1,2,6,1,16,2.2857142857142856,2,0.0,0,1,0,1,5,2,0,6,1,2,14,1
6106,80454,SicKtTdinGjYgkh3dK0y8UiEfELy0LiN,bWdj2GDclj5ofokWjzoa5jAwMkxCykd6,5,6,2,0,0,0,7,0,15,2.142857142857143,3,0.0,0,2,0,0,6,0,0,7,0,2,13,1
6107,80455,zB3DnodqJETqBAtFNKyb5VwXIslDdCgP,RXDvfPUBYFlVdlueBFbLW0mhhAyGEqpt,24,15,14,0,11,0,2,0,42,6.0,1,0.0,0,14,0,11,15,0,0,2,0,25,17,1
6108,80462,6I4onWELkk7bHacbwPRHkBZyFy5av4gK,G8EPVSXsOYB5YQWZGiz1aVq5Pgr2GrQu,1,0,0,0,0,0,1,0,1,0.14285714285714285,1,0.0,0,0,0,0,0,0,0,1,0,0,1,1
6109,80464,KY2OGJhlQwlrWsxzAaVbFxD3T2YixWes,SpATywNh6bZuzm8s1ceuBUnMUAeoAHHw,19,35,0,39,0,0,6,0,80,11.428571428571429,1,0.0,17,0,32,0,18,0,7,6,0,49,31,1
6110,80475,53qrF6M0dMx7kKnOiKvVv5yJevXuY3XD,bWdj2GDclj5ofokWjzoa5jAwMkxCykd6,16,11,5,32,4,2,6,1,61,8.714285714285714,1,0.0,4,5,27,4,7,2,5,6,1,40,21,1
6111,80505,I7kUxTrFR4kUt4IUmZUgm3AQtDQNh7Pu,G8EPVSXsOYB5YQWZGiz1aVq5Pgr2GrQu,22,27,24,36,10,4,31,0,132,18.857142857142858,5,0.0,0,24,28,10,27,4,8,31,0,62,70,0
6112,80518,vrIS3rOFH8II8t7yTEWKp29B27kjVKhm,RXDvfPUBYFlVdlueBFbLW0mhhAyGEqpt,2,0,0,0,0,0,2,0,2,0.2857142857142857,1,0.0,0,0,0,0,0,0,0,2,0,0,2,1
6113,80537,LPlZQJB3VT531jm1uSCcLkocTrYuWDuM,SpATywNh6bZuzm8s1ceuBUnMUAeoAHHw,5,2,0,0,0,0,3,0,5,0.7142857142857143,1,0.0,0,0,0,0,2,0,0,3,0,0,5,1
6114,80550,CXCaJpUSDS18xEbIkOvQDpHLpsuhXdw4,A3fsA9Zfv1X2fVEQhTw51lKENdNrEqT3,6,3,1,0,1,0,2,0,7,1.0,1,0.0,0,1,0,1,3,0,0,2,0,2,5,1
6115,80561,0TYsGSagjtpdvts8BjnEYwbdzO0Cq9cu,bWdj2GDclj5ofokWjzoa5jAwMkxCykd6,7,18,8,0,4,0,8,0,38,5.428571428571429,3,0.0,3,8,0,4,15,0,0,8,0,15,23,1
6116,80563,ZjWuXv8EONEQWoGCaTlXceVXFgdHRHNG,A3fsA9Zfv1X2fVEQhTw51lKENdNrEqT3,24,12,1,58,0,0,2,0,73,10.428571428571429,1,0.0,1,1,47,0,11,0,11,2,0,49,24,1
6117,80564,qWUac1M6H0GGCt2oRkcCo2PK0QcGvZVS,A3fsA9Zfv1X2fVEQhTw51lKENdNrEqT3,9,9,1,8,0,0,2,0,20,2.857142857142857,2,0.0,1,1,8,0,8,0,0,2,0,10,10,1
6118,80568,ADKumVbkV9N5Z2ohQ2vgzJz2AGQtvwrg,G8EPVSXsOYB5YQWZGiz1aVq5Pgr2GrQu,2,0,0,0,0,0,2,0,2,0.2857142857142857,1,0.0,0,0,0,0,0,0,0,2,0,0,2,1
6119,80594,7U17eU07Q58xc6IhNX4TREySfrRlxt89,SpATywNh6bZuzm8s1ceuBUnMUAeoAHHw,5,2,1,0,1,0,2,0,6,0.8571428571428571,1,0.0,0,1,0,1,2,0,0,2,0,2,4,1
6120,80598,OLmaTq1VRWq8uhF6WwamKt59rXmIqMgh,bWdj2GDclj5ofokWjzoa5jAwMkxCykd6,1,0,0,0,0,0,1,0,1,0.14285714285714285,1,0.0,0,0,0,0,0,0,0,1,0,0,1,1
6121,80602,gpn05NwMGqKm6lLZGRrnOmPlhHxlC7Wb,bWdj2GDclj5ofokWjzoa5jAwMkxCykd6,1,0,0,0,0,0,1,0,1,0.14285714285714285,1,0.0,0,0,0,0,0,0,0,1,0,0,1,1
6122,80608,ci9OqCUCFmkuIFOKMHsPsoK829Gh2eXP,SpATywNh6bZuzm8s1ceuBUnMUAeoAHHw,6,3,2,0,1,0,2,0,8,1.1428571428571428,1,0.0,0,2,0,1,3,0,0,2,0,3,5,1
6123,80625,OtvBXiuty3fVhm4b8HhX0yrFKjgkxxYs,bWdj2GDclj5ofokWjzoa5jAwMkxCykd6,1,0,0,0,0,0,1,0,1,0.14285714285714285,1,0.0,0,0,0,0,0,0,0,1,0,0,1,1
6124,80632,4CBJi9FPwBtDwABbM6tdSqW9vKh1q7Z5,SpATywNh6bZuzm8s1ceuBUnMUAeoAHHw,23,42,15,37,3,32,24,3,156,22.285714285714285,6,0.0,20,15,31,3,22,32,6,24,3,69,87,1
6125,80634,LoPeI5vpiJIc8eFJHRcQzxkTVUzWtzqj,SpATywNh6bZuzm8s1ceuBUnMUAeoAHHw,4,3,2,0,0,0,1,0,6,0.8571428571428571,1,0.0,0,2,0,0,3,0,0,1,0,2,4,1
6126,80638,s4hqnx8xUoYKrJLqweBa2aNshVWoic6X,SpATywNh6bZuzm8s1ceuBUnMUAeoAHHw,1,0,0,0,0,0,1,0,1,0.14285714285714285,1,0.0,0,0,0,0,0,0,0,1,0,0,1,1
6127,80639,29gH0FAs4oAb41p5WLnz0d22eodFn1iN,bWdj2GDclj5ofokWjzoa5jAwMkxCykd6,7,4,3,0,3,0,2,0,12,1.7142857142857142,1,0.0,0,3,0,3,4,0,0,2,0,6,6,1
6128,80654,NKR2Krh4HHLg8axBFiC363Ms5CaLr3EI,SpATywNh6bZuzm8s1ceuBUnMUAeoAHHw,1,0,0,0,0,0,1,0,1,0.14285714285714285,1,0.0,0,0,0,0,0,0,0,1,0,0,1,1
6129,80660,TMS9M7AUlYgaEtdQAX29SchyEATrODFG,G8EPVSXsOYB5YQWZGiz1aVq5Pgr2GrQu,63,87,37,88,20,3,11,2,248,35.42857142857143,5,0.0,45,37,54,20,42,3,34,11,2,156,92,1
6130,80666,TaFs8IDIsMzdpxbnD04ku2RkLxSKkkwk,SpATywNh6bZuzm8s1ceuBUnMUAeoAHHw,7,7,1,4,0,0,1,0,13,1.8571428571428572,1,0.0,0,1,3,0,7,0,1,1,0,4,9,1
6131,80681,SyrTnLXKpH34dNmIyW3n9ptk8gbsqg3F,SpATywNh6bZuzm8s1ceuBUnMUAeoAHHw,1,0,0,0,0,0,1,0,1,0.14285714285714285,1,0.0,0,0,0,0,0,0,0,1,0,0,1,1
6132,80698,CqJyXqN2l3WOJQLqxchvfRFp3seiLXw6,A3fsA9Zfv1X2fVEQhTw51lKENdNrEqT3,15,15,7,0,6,0,4,0,32,4.571428571428571,2,0.0,0,7,0,6,15,0,0,4,0,13,19,1
6133,80707,29gH0FAs4oAb41p5WLnz0d22eodFn1iN,RXDvfPUBYFlVdlueBFbLW0mhhAyGEqpt,5,2,1,0,1,0,3,0,7,1.0,1,0.0,0,1,0,1,2,0,0,3,0,2,5,1
6134,80714,ATgF2ilKXTZ2e87FKuPjMOOGbSWS0Lln,bWdj2GDclj5ofokWjzoa5jAwMkxCykd6,1,0,0,0,0,0,1,0,1,0.14285714285714285,1,0.0,0,0,0,0,0,0,0,1,0,0,1,1
6135,80717,eVZffGeL4uoEevrNNMdcmW6f0YwT8plW,SpATywNh6bZuzm8s1ceuBUnMUAeoAHHw,16,25,13,13,6,2,11,2,72,10.285714285714286,4,0.0,6,13,13,6,19,2,0,11,2,38,34,1
6136,80728,EZ8RICWKm2CZHfClKFJxNtx1ItORs9so,SpATywNh6bZuzm8s1ceuBUnMUAeoAHHw,16,43,5,19,1,4,18,2,92,13.142857142857142,4,0.0,9,5,16,1,34,4,3,18,2,31,61,1
6137,80729,nuKEM7FMFD9npzL9DafH3T1pYgMoLJoQ,RXDvfPUBYFlVdlueBFbLW0mhhAyGEqpt,7,9,6,0,5,0,1,0,21,3.0,1,0.0,0,6,0,5,9,0,0,1,0,11,10,0
6138,80735,qOBlKap97zfj4fiqNpXMa6P8l1mqWQt7,SpATywNh6bZuzm8s1ceuBUnMUAeoAHHw,1,0,0,0,0,0,2,0,2,0.2857142857142857,1,0.0,0,0,0,0,0,0,0,2,0,0,2,1
6139,80758,T4bTYOzPYArqtWPF4tmIGoxoB2vrFxrw,SpATywNh6bZuzm8s1ceuBUnMUAeoAHHw,28,33,20,17,9,2,16,1,98,14.0,6,0.0,5,20,16,9,28,2,1,16,1,50,48,1
6140,80769,OmF4aFe06TkjIpsTgGpQ4vBzMWi2jjQV,RXDvfPUBYFlVdlueBFbLW0mhhAyGEqpt,1,0,0,0,0,0,1,0,1,0.14285714285714285,1,0.0,0,0,0,0,0,0,0,1,0,0,1,1
6141,80779,6qgQAmX6y5wh5nEPRINOiKrZNoTl5yfT,bWdj2GDclj5ofokWjzoa5jAwMkxCykd6,22,44,24,62,10,38,27,2,207,29.571428571428573,7,0.0,11,24,58,10,33,38,4,27,2,103,104,1
6142,80780,Nn60hlJlXHP7n7M6lOuhaSQUkd1WY1lX,A3fsA9Zfv1X2fVEQhTw51lKENdNrEqT3,2,0,0,0,0,0,3,0,3,0.42857142857142855,2,0.0,0,0,0,0,0,0,0,3,0,0,3,1
6143,80798,B0jVKFlvXfKwVR9pXnhJZcf2VbxqeEJP,SpATywNh6bZuzm8s1ceuBUnMUAeoAHHw,18,25,15,4,6,0,5,0,55,7.857142857142857,3,0.0,4,15,4,6,21,0,0,5,0,29,26,1
6144,80799,cJ9a9VybEQZXRFqEMI78WQ8ukmEaaVlE,SpATywNh6bZuzm8s1ceuBUnMUAeoAHHw,29,33,15,33,7,4,6,0,98,14.0,4,0.0,12,15,29,7,21,4,4,6,0,63,35,0
6145,80810,XGZlC1RvsVEr4DyOUAX5cTpjhf6EgwX5,G8EPVSXsOYB5YQWZGiz1aVq5Pgr2GrQu,1,0,0,0,0,0,1,0,1,0.14285714285714285,1,0.0,0,0,0,0,0,0,0,1,0,0,1,1
6146,80825,IH2c5uYafZAMnz8GRu5q3bfkjqRBG0d4,bWdj2GDclj5ofokWjzoa5jAwMkxCykd6,4,3,1,0,1,0,4,0,9,1.2857142857142858,2,0.0,0,1,0,1,3,0,0,4,0,2,7,1
6147,80832,GMSc5TEkkpgIO0gc1xREEszljcEWZiiA,SpATywNh6bZuzm8s1ceuBUnMUAeoAHHw,32,43,25,30,12,16,19,3,148,21.142857142857142,2,0.0,13,25,24,12,30,16,6,19,3,74,74,1
6148,80835,GMSc5TEkkpgIO0gc1xREEszljcEWZiiA,bWdj2GDclj5ofokWjzoa5jAwMkxCykd6,5,2,1,0,1,0,2,0,6,0.8571428571428571,1,0.0,0,1,0,1,2,0,0,2,0,2,4,1
6149,80849,2mD1u3b1vLrSJM0DZTrsvLcZVBVwwd27,A3fsA9Zfv1X2fVEQhTw51lKENdNrEqT3,3,0,0,0,0,0,7,0,7,1.0,2,0.0,0,0,0,0,0,0,0,7,0,0,7,1
6150,80851,okZrRzk81VekqLN26qutXWOBN8y8aCor,SpATywNh6bZuzm8s1ceuBUnMUAeoAHHw,7,3,1,0,1,0,3,0,8,1.1428571428571428,1,0.0,0,1,0,1,3,0,0,3,0,2,6,1
6151,80859,diZ65EjFunlRsT8e2068pcUuzCl79D1p,G8EPVSXsOYB5YQWZGiz1aVq5Pgr2GrQu,4,2,0,0,0,0,2,0,4,0.5714285714285714,1,0.0,0,0,0,0,2,0,0,2,0,0,4,1
6152,80867,pXgjy4DXaOKMQD4LAgLui9VHE5CpkZu9,fbPkOYLVPtPgIt0MxizjfFJov3JbHyAi,31,45,27,0,20,26,8,1,127,18.142857142857142,2,0.0,9,27,0,20,36,26,0,8,1,56,71,1
6153,80868,swFi5fb79eZLyE5zYDE8WBJhH3Y94beD,fbPkOYLVPtPgIt0MxizjfFJov3JbHyAi,2,0,0,0,0,0,2,0,2,0.2857142857142857,1,0.0,0,0,0,0,0,0,0,2,0,0,2,1
6154,80869,Ov1eEIsyiq4NpsQyBb4m5rDEEYvFdikk,fbPkOYLVPtPgIt0MxizjfFJov3JbHyAi,10,7,5,0,3,1,2,0,18,2.5714285714285716,1,0.0,0,5,0,3,7,1,0,2,0,8,10,1
6155,80870,YM9Z89N137bY5qphnaUaFSAicUvT78c0,fbPkOYLVPtPgIt0MxizjfFJov3JbHyAi,8,11,7,0,3,0,5,0,26,3.7142857142857144,1,0.0,0,7,0,3,11,0,0,5,0,10,16,1
6156,80871,Rs4pfmJlaHiSs2fYG1vucMoIlgnMNq35,fbPkOYLVPtPgIt0MxizjfFJov3JbHyAi,1,0,0,0,0,0,1,0,1,0.14285714285714285,1,0.0,0,0,0,0,0,0,0,1,0,0,1,1
6157,80873,J6Gdt3OhkKwtA1tiJMtQErFzdO5CDNjE,fbPkOYLVPtPgIt0MxizjfFJov3JbHyAi,4,3,0,0,0,0,1,0,4,0.5714285714285714,1,0.0,0,0,0,0,3,0,0,1,0,0,4,1
6158,80877,9aS1NSJb2Hj0xHbbuoyhLmktYrjypxsy,fbPkOYLVPtPgIt0MxizjfFJov3JbHyAi,31,69,24,45,18,26,20,0,202,28.857142857142858,5,0.0,34,24,44,18,35,26,1,20,0,120,82,1
6159,80878,mz4jh38pq3jPwJJzfaN8eT823I3JqGp6,fbPkOYLVPtPgIt0MxizjfFJov3JbHyAi,6,4,0,0,0,2,5,1,12,1.7142857142857142,1,0.0,0,0,0,0,4,2,0,5,1,0,12,1
6160,80881,whV1nFYZoFkMMEitqUr4NmhBR8HyCOwO,fbPkOYLVPtPgIt0MxizjfFJov3JbHyAi,10,18,12,0,6,24,9,0,69,9.857142857142858,5,0.0,0,12,0,6,18,24,0,9,0,18,51,1
6161,80882,a98Mt6r9LLCkAEPo2R3JVMN20OhIPoaG,fbPkOYLVPtPgIt0MxizjfFJov3JbHyAi,9,10,5,0,4,0,6,1,26,3.7142857142857144,4,0.0,0,5,0,4,10,0,0,6,1,9,17,1
6162,80884,jUXtuG5Q1xcdJqmPNWwEYGXvh7x6ZP49,fbPkOYLVPtPgIt0MxizjfFJov3JbHyAi,1,0,0,0,0,0,2,0,2,0.2857142857142857,2,0.0,0,0,0,0,0,0,0,2,0,0,2,1
6163,80886,0DzldTHKdoH90kklIAjpWyAEe6XDDjyM,fbPkOYLVPtPgIt0MxizjfFJov3JbHyAi,8,13,8,0,5,13,7,0,46,6.571428571428571,4,0.0,1,8,0,5,12,13,0,7,0,14,32,1
6164,80887,oFIudRLykO0Fs6hEVqUgdjhHssApq1CY,fbPkOYLVPtPgIt0MxizjfFJov3JbHyAi,10,6,3,8,4,0,2,0,23,3.2857142857142856,1,0.0,2,3,6,4,4,0,2,2,0,15,8,1
6165,80888,koWvCadm1og0LpcFvcQlTqhBDNIm2AFz,fbPkOYLVPtPgIt0MxizjfFJov3JbHyAi,8,6,4,0,3,0,3,0,16,2.2857142857142856,2,0.0,0,4,0,3,6,0,0,3,0,7,9,1
6166,80889,K8SEVoLEOyaxiId31CfQ3tViDlX904mj,fbPkOYLVPtPgIt0MxizjfFJov3JbHyAi,8,7,4,0,3,0,3,0,17,2.4285714285714284,2,0.0,0,4,0,3,7,0,0,3,0,7,10,1
6167,80893,u5RnzaYe9alTOldsdopsRhwom5jR9n5h,fbPkOYLVPtPgIt0MxizjfFJov3JbHyAi,12,16,6,4,7,0,3,0,36,5.142857142857143,1,0.0,8,6,4,7,8,0,0,3,0,25,11,1
6168,80895,b17BXpd9CJ1FbG7Eiys3N3TmOMsQOqc5,fbPkOYLVPtPgIt0MxizjfFJov3JbHyAi,6,2,1,0,1,0,3,0,7,1.0,1,0.0,0,1,0,1,2,0,0,3,0,2,5,1
6169,80897,IVsQLNPDPXZtEeF9QnUix2gm2WS214ki,fbPkOYLVPtPgIt0MxizjfFJov3JbHyAi,1,0,0,0,0,0,1,0,1,0.14285714285714285,1,0.0,0,0,0,0,0,0,0,1,0,0,1,1
6170,80898,87MEmQxd2seObxQu44Z8XlD7ySMr8nwp,fbPkOYLVPtPgIt0MxizjfFJov3JbHyAi,9,3,2,0,2,0,9,1,17,2.4285714285714284,1,0.0,0,2,0,2,3,0,0,9,1,4,13,1
6171,80899,LB9Y3hHJxXFKUivI2IDZO69UMgf1mHWd,fbPkOYLVPtPgIt0MxizjfFJov3JbHyAi,12,31,11,0,1,9,4,0,56,8.0,2,0.0,1,11,0,1,30,9,0,4,0,13,43,1
6172,80900,zbVrmGy9kpOt2q8xeIclHo9H8afE2cMh,fbPkOYLVPtPgIt0MxizjfFJov3JbHyAi,4,6,2,0,0,0,1,0,9,1.2857142857142858,1,0.0,0,2,0,0,6,0,0,1,0,2,7,1
6173,82292,vCT5TWno1npWLslO7yYTAIaOZBV06mao,fbPkOYLVPtPgIt0MxizjfFJov3JbHyAi,3,2,0,0,0,0,1,0,3,0.42857142857142855,1,0.0,0,0,0,0,2,0,0,1,0,0,3,1
6174,82294,mPSu9wD4am4oNde1aNJ4Hx4pSuKdoZ9s,fbPkOYLVPtPgIt0MxizjfFJov3JbHyAi,1,0,0,0,0,0,1,0,1,0.14285714285714285,1,0.0,0,0,0,0,0,0,0,1,0,0,1,1
6175,82295,2vTiDJaUXObkB4MCSVV6b36fCzIFNmlO,fbPkOYLVPtPgIt0MxizjfFJov3JbHyAi,7,1,1,0,1,14,17,1,35,5.0,2,0.0,0,1,0,1,1,14,0,17,1,2,33,1
6176,82297,mucqYKQHr68fZN1W1bDFGJobVl8lTzGk,fbPkOYLVPtPgIt0MxizjfFJov3JbHyAi,5,2,1,0,1,0,4,0,8,1.1428571428571428,1,0.0,0,1,0,1,2,0,0,4,0,2,6,1
6177,82299,qGj2UPAGCVKaEMFWyN0RHLn8amW4mHcs,fbPkOYLVPtPgIt0MxizjfFJov3JbHyAi,2,0,0,0,0,0,2,0,2,0.2857142857142857,1,0.0,0,0,0,0,0,0,0,2,0,0,2,1
6178,82301,qDO5LP5T3lr3EoF63npeMJOU1F5CHwlT,fbPkOYLVPtPgIt0MxizjfFJov3JbHyAi,1,0,0,0,0,0,1,0,1,0.14285714285714285,1,0.0,0,0,0,0,0,0,0,1,0,0,1,1
6179,82302,LJ7sgKzaMtvAPFXeVXXiaB5SrStNVwGH,fbPkOYLVPtPgIt0MxizjfFJov3JbHyAi,2,0,0,0,0,0,2,0,2,0.2857142857142857,1,0.0,0,0,0,0,0,0,0,2,0,0,2,1
6180,82303,7cOxNQ9QY0kpQ3XCTHRP00ygFCzb9CpO,fbPkOYLVPtPgIt0MxizjfFJov3JbHyAi,7,4,2,0,1,2,4,1,14,2.0,2,0.0,0,2,0,1,4,2,0,4,1,3,11,1
6181,82304,zrkzLXbSKLZ5TMR3XqCd3VcTJUh1RbFU,fbPkOYLVPtPgIt0MxizjfFJov3JbHyAi,7,3,2,0,2,0,2,0,9,1.2857142857142858,1,0.0,0,2,0,2,3,0,0,2,0,4,5,1
6182,82305,5D84XSx425N7nheLe6kqFUzsI4xGTRr7,fbPkOYLVPtPgIt0MxizjfFJov3JbHyAi,15,23,7,8,10,4,7,1,60,8.571428571428571,1,0.0,13,7,6,10,10,4,2,7,1,36,24,1
6183,82307,i6tlOFL86lQi7en8qXwdqAGtc3xj3T2v,fbPkOYLVPtPgIt0MxizjfFJov3JbHyAi,1,0,0,0,0,0,1,0,1,0.14285714285714285,1,0.0,0,0,0,0,0,0,0,1,0,0,1,1
6184,82308,dMfbUZDFyVyywHwJG3Dt4QrakRtLnsTX,fbPkOYLVPtPgIt0MxizjfFJov3JbHyAi,7,3,2,0,2,0,2,0,9,1.2857142857142858,1,0.0,0,2,0,2,3,0,0,2,0,4,5,1
6185,82309,R2bsNKaCyFNpEJtfIBR7wHhqazhTieVv,fbPkOYLVPtPgIt0MxizjfFJov3JbHyAi,5,3,2,0,1,0,1,0,7,1.0,1,0.0,0,2,0,1,3,0,0,1,0,3,4,1
6186,82310,2Hh0hyPi2bcd1tRNePJ2qIF1dysf5ndk,fbPkOYLVPtPgIt0MxizjfFJov3JbHyAi,6,2,1,0,1,0,6,0,10,1.4285714285714286,1,0.0,1,1,0,1,1,0,0,6,0,3,7,1
6187,82311,Ll3IzS1S6bZksUUlpyvq7rkVFnPwdP4J,fbPkOYLVPtPgIt0MxizjfFJov3JbHyAi,7,3,2,0,2,0,4,0,11,1.5714285714285714,1,0.0,0,2,0,2,3,0,0,4,0,4,7,1
6188,82312,Ocs5vn2Cz5hAUdTB4aWABUkRHND3d6Kt,fbPkOYLVPtPgIt0MxizjfFJov3JbHyAi,6,6,3,0,2,0,4,0,15,2.142857142857143,2,0.0,0,3,0,2,6,0,0,4,0,5,10,1
6189,82313,x2Dh8FpB4LfDSl1DvzXzmScd6yLeEPWy,fbPkOYLVPtPgIt0MxizjfFJov3JbHyAi,4,0,0,0,0,0,5,0,5,0.7142857142857143,1,0.0,0,0,0,0,0,0,0,5,0,0,5,1
6190,82314,XIDZAAoEp5yiaJ1NSNfTaFGT6RLKKbeY,fbPkOYLVPtPgIt0MxizjfFJov3JbHyAi,1,0,0,0,0,0,1,0,1,0.14285714285714285,1,0.0,0,0,0,0,0,0,0,1,0,0,1,1
6191,82315,t2E5rQgbhesaMxxpyksf3DgIq81BWWBg,fbPkOYLVPtPgIt0MxizjfFJov3JbHyAi,5,4,2,0,1,0,2,0,9,1.2857142857142858,1,0.0,0,2,0,1,4,0,0,2,0,3,6,1
6192,82337,0XFCa4HLY6qqhFLkbyOG8QvQlbZdVLQp,7GRhBDsirIGkRZBtSMEzNTyDr2JQm4xx,3,0,0,0,0,0,3,0,3,0.42857142857142855,1,0.0,0,0,0,0,0,0,0,3,0,0,3,1
6193,82347,HMYpimZGFgj5IczDutkfjUfnxl45PoHW,7GRhBDsirIGkRZBtSMEzNTyDr2JQm4xx,1,0,0,0,0,0,5,0,5,0.7142857142857143,3,0.0,0,0,0,0,0,0,0,5,0,0,5,1
6194,82354,4Kx1Tk1FEFaPAhJJ1qabZH7R2QRjZNC4,7GRhBDsirIGkRZBtSMEzNTyDr2JQm4xx,11,8,4,2,3,1,2,0,20,2.857142857142857,1,0.0,2,4,1,3,6,1,1,2,0,10,10,1
6195,82357,1v1hnAW2fjxDgMlfMAcBqTKOh6UMFrVl,7GRhBDsirIGkRZBtSMEzNTyDr2JQm4xx,31,40,17,4,17,1,16,0,95,13.571428571428571,4,0.0,16,17,3,17,24,1,1,16,0,53,42,1
6196,82369,1EoPeAPt0rQExpDMUB0Oh9LRcg1yhFWa,7GRhBDsirIGkRZBtSMEzNTyDr2JQm4xx,1,0,0,0,0,0,1,0,1,0.14285714285714285,1,0.0,0,0,0,0,0,0,0,1,0,0,1,1
6197,82391,r6vCAWlYIzTyZ2tN64AHwtfHr1599fdG,7GRhBDsirIGkRZBtSMEzNTyDr2JQm4xx,56,294,8,120,15,3,71,2,513,73.28571428571429,11,0.0,195,8,101,15,99,3,19,71,2,319,194,0
6198,82419,kkrf4aiGvXPFoVcEvoantT9MIbaoN3ev,7GRhBDsirIGkRZBtSMEzNTyDr2JQm4xx,2,0,0,0,0,0,2,0,2,0.2857142857142857,1,0.0,0,0,0,0,0,0,0,2,0,0,2,1
6199,82425,AYyigeqx54KlykjSn8XXM8xIAmNPwwgy,7GRhBDsirIGkRZBtSMEzNTyDr2JQm4xx,1,0,0,0,0,0,1,0,1,0.14285714285714285,1,0.0,0,0,0,0,0,0,0,1,0,0,1,1
6200,82439,nsVUUOs0l2kNCEJWP7CuzEzLUL7HHA2o,7GRhBDsirIGkRZBtSMEzNTyDr2JQm4xx,1,0,0,0,0,0,1,0,1,0.14285714285714285,1,0.0,0,0,0,0,0,0,0,1,0,0,1,1
6201,82443,506JH480T3Hay89W7G1dTs4qRT8mnHIv,7GRhBDsirIGkRZBtSMEzNTyDr2JQm4xx,4,3,1,0,0,0,2,0,6,0.8571428571428571,1,0.0,0,1,0,0,3,0,0,2,0,1,5,1
6202,82444,0OsY8LWQHJyrf2iZ6AGYuDrpmW3bfvqO,7GRhBDsirIGkRZBtSMEzNTyDr2JQm4xx,23,29,14,14,8,0,5,0,70,10.0,1,0.0,11,14,8,8,18,0,6,5,0,41,29,1
6203,82445,BA6kCSqOZYgPcpy87C2hTl09S7lpFd09,7GRhBDsirIGkRZBtSMEzNTyDr2JQm4xx,8,8,2,6,3,2,2,0,23,3.2857142857142856,1,0.0,2,2,5,3,6,2,1,2,0,12,11,0
6204,82479,iVw6PFrlJCMW2i4yQDVBv0p8rh0bg8oB,7GRhBDsirIGkRZBtSMEzNTyDr2JQm4xx,10,10,3,0,1,9,15,0,38,5.428571428571429,2,0.0,2,3,0,1,8,9,0,15,0,6,32,1
6205,82501,C90t4OTJKLckQlEHPGqMg6X9e1cv22jh,7GRhBDsirIGkRZBtSMEzNTyDr2JQm4xx,5,2,1,0,1,0,3,0,7,1.0,1,0.0,0,1,0,1,2,0,0,3,0,2,5,1
6206,82516,akfKNyiclQIBJSqS87A1d10ODSvejPEf,7GRhBDsirIGkRZBtSMEzNTyDr2JQm4xx,4,2,0,0,0,0,2,0,4,0.5714285714285714,1,0.0,0,0,0,0,2,0,0,2,0,0,4,1
6207,82545,mnt6WUJv4Nm9SlBAqM8Wy80LtV0oy5xh,7GRhBDsirIGkRZBtSMEzNTyDr2JQm4xx,1,0,0,0,0,0,1,0,1,0.14285714285714285,1,0.0,0,0,0,0,0,0,0,1,0,0,1,1
6208,82548,2DJrQZ1DQwZ17FIT9rErCdsuhNRIOxUc,7GRhBDsirIGkRZBtSMEzNTyDr2JQm4xx,1,0,0,0,0,0,1,0,1,0.14285714285714285,1,0.0,0,0,0,0,0,0,0,1,0,0,1,1
6209,82551,UJiJ4PvH4qodyDnURbFXyi5LWwaSKUwb,7GRhBDsirIGkRZBtSMEzNTyDr2JQm4xx,11,11,6,8,5,0,2,0,32,4.571428571428571,1,0.0,2,6,6,5,9,0,2,2,0,19,13,1
6210,82552,z6hFsPzsbEnFbaZ8fz961gcLxQ5khAMh,7GRhBDsirIGkRZBtSMEzNTyDr2JQm4xx,1,0,0,0,0,0,1,0,1,0.14285714285714285,1,0.0,0,0,0,0,0,0,0,1,0,0,1,1
6211,82581,aq4CF7Ase1niDETNNnN3SPNstQIkMzIb,7GRhBDsirIGkRZBtSMEzNTyDr2JQm4xx,1,0,0,0,0,0,1,0,1,0.14285714285714285,1,0.0,0,0,0,0,0,0,0,1,0,0,1,1
6212,82587,4BgAKbYEi6Ae1ZfaDy8dVhzCZKLQsM2C,7GRhBDsirIGkRZBtSMEzNTyDr2JQm4xx,2,0,0,0,0,0,2,0,2,0.2857142857142857,1,0.0,0,0,0,0,0,0,0,2,0,0,2,1
6213,82609,8t2I7RZ6tGpzDNhY5KSmkbKJTicFPhFD,SpATywNh6bZuzm8s1ceuBUnMUAeoAHHw,26,36,18,32,6,0,15,0,107,15.285714285714286,3,0.0,13,18,29,6,23,0,3,15,0,66,41,0
6214,82611,7xsMLAoX5cfA1ELNnW1Jyq3921JNch8p,bWdj2GDclj5ofokWjzoa5jAwMkxCykd6,7,5,2,0,1,0,9,0,17,2.4285714285714284,1,0.0,0,2,0,1,5,0,0,9,0,3,14,1
6215,82619,HBNOGDmQrCA8ZCNHwMOm4mGR9448iscJ,A3fsA9Zfv1X2fVEQhTw51lKENdNrEqT3,9,3,2,0,2,0,8,1,16,2.2857142857142856,2,0.0,0,2,0,2,3,0,0,8,1,4,12,0
6216,82626,1LsKSfuKnKljzcVBDuX88jdA4iNAFPmK,SpATywNh6bZuzm8s1ceuBUnMUAeoAHHw,8,35,17,0,13,0,9,0,74,10.571428571428571,1,0.0,2,17,0,13,33,0,0,9,0,32,42,0
6217,82633,xLA7fhjHBFsq0q4kxpkXfUkRljEs0TAd,SpATywNh6bZuzm8s1ceuBUnMUAeoAHHw,14,29,21,4,8,1,8,0,71,10.142857142857142,3,0.0,3,21,4,8,26,1,0,8,0,36,35,0
6218,82635,xLA7fhjHBFsq0q4kxpkXfUkRljEs0TAd,bWdj2GDclj5ofokWjzoa5jAwMkxCykd6,30,49,27,82,9,15,20,0,202,28.857142857142858,4,0.0,10,27,80,9,39,15,2,20,0,126,76,0
6219,82641,TqooiK8GaIskZ1TWtOHUh45RuTpvOkj9,SpATywNh6bZuzm8s1ceuBUnMUAeoAHHw,7,6,4,0,3,0,3,0,16,2.2857142857142856,1,0.0,0,4,0,3,6,0,0,3,0,7,9,0
6220,82642,7IO6p4687fQRowFKh8aP2BRrTBz96sXF,G8EPVSXsOYB5YQWZGiz1aVq5Pgr2GrQu,30,22,10,24,9,0,10,1,76,10.857142857142858,5,0.0,7,10,16,9,15,0,8,10,1,42,34,0
6221,82661,pSfJ0uMpX5mtiDADVfED9j2PrehMi4qf,SpATywNh6bZuzm8s1ceuBUnMUAeoAHHw,11,14,5,0,4,0,2,0,25,3.5714285714285716,1,0.0,8,5,0,4,6,0,0,2,0,17,8,1
6222,82682,pSfJ0uMpX5mtiDADVfED9j2PrehMi4qf,bWdj2GDclj5ofokWjzoa5jAwMkxCykd6,7,4,2,0,2,0,2,0,10,1.4285714285714286,1,0.0,1,2,0,2,3,0,0,2,0,5,5,1
6223,82686,r2H5XCYvW75clbYorkxbeTJTDpcuYsqR,A3fsA9Zfv1X2fVEQhTw51lKENdNrEqT3,1,0,0,0,0,0,1,0,1,0.14285714285714285,1,0.0,0,0,0,0,0,0,0,1,0,0,1,1
6224,82713,Qej7uJiPxPofj5VkSw5arNMXnDFwdHaU,bWdj2GDclj5ofokWjzoa5jAwMkxCykd6,1,0,0,0,0,0,1,0,1,0.14285714285714285,1,0.0,0,0,0,0,0,0,0,1,0,0,1,1
6225,82714,dmKq4wezB2pymsF6jHa3iwdFnCP4NIvi,SpATywNh6bZuzm8s1ceuBUnMUAeoAHHw,4,2,0,0,0,0,2,0,4,0.5714285714285714,1,0.0,0,0,0,0,2,0,0,2,0,0,4,1
6226,82722,i0k5iK0fS6RmfXLKfz70zhtGt8sKmdev,G8EPVSXsOYB5YQWZGiz1aVq5Pgr2GrQu,18,35,5,40,2,0,4,0,86,12.285714285714286,3,0.0,0,5,35,2,35,0,5,4,0,42,44,1
6227,82751,8kDMxN2jxnl0uIdlggQjT6QmHT7F6WvQ,A3fsA9Zfv1X2fVEQhTw51lKENdNrEqT3,10,12,1,0,0,0,8,0,21,3.0,4,0.0,0,1,0,0,12,0,0,8,0,1,20,0
6228,82772,ydoaEAxmO4gHSSp9D7mNNRYfsM5IVoFl,SpATywNh6bZuzm8s1ceuBUnMUAeoAHHw,6,0,0,0,0,1,5,1,7,1.0,1,0.0,0,0,0,0,0,1,0,5,1,0,7,1
6229,82820,PCDzowxElNLixXyfAFPkQqlbkMlIrEa9,SpATywNh6bZuzm8s1ceuBUnMUAeoAHHw,1,0,0,0,0,0,1,0,1,0.14285714285714285,1,0.0,0,0,0,0,0,0,0,1,0,0,1,1
6230,82832,bNG7kJA3jy4DW8PDzMNAT9OoyHwhutqS,bWdj2GDclj5ofokWjzoa5jAwMkxCykd6,28,61,0,128,4,0,19,1,213,30.428571428571427,3,0.0,14,0,119,4,47,0,9,19,1,137,76,1
6231,82834,rXk8o13Kpmo1kUY0hqp1VAqDdB7oaIVw,SpATywNh6bZuzm8s1ceuBUnMUAeoAHHw,1,0,0,0,0,0,1,0,1,0.14285714285714285,1,0.0,0,0,0,0,0,0,0,1,0,0,1,1
6232,82840,Jee7EGsn5XYP5oawysLFsO8VcnPFjYWM,SpATywNh6bZuzm8s1ceuBUnMUAeoAHHw,21,29,16,21,8,0,5,0,79,11.285714285714286,3,0.0,9,16,18,8,20,0,3,5,0,51,28,1
6233,82856,2Pkptevs7J69rsFmJqSHjNMBnKCLyXs7,SpATywNh6bZuzm8s1ceuBUnMUAeoAHHw,11,16,13,0,5,0,6,0,40,5.714285714285714,1,0.0,0,13,0,5,16,0,0,6,0,18,22,1
6234,82860,MWgepnFrbhIoMtzaoOzOjEjpjYI14nzb,bWdj2GDclj5ofokWjzoa5jAwMkxCykd6,5,3,0,0,0,0,4,0,7,1.0,1,0.0,0,0,0,0,3,0,0,4,0,0,7,1
6235,82865,UVY9zxbBVUyhzTA4AJhTZxTOHFZ2duQd,SpATywNh6bZuzm8s1ceuBUnMUAeoAHHw,20,26,3,16,0,2,5,0,52,7.428571428571429,1,0.0,5,3,14,0,21,2,2,5,0,22,30,1
6236,82875,LSxdutAKHjruUktaLYDzR4TTFH4npHSj,SpATywNh6bZuzm8s1ceuBUnMUAeoAHHw,15,33,17,14,10,0,12,0,86,12.285714285714286,4,0.0,10,17,13,10,23,0,1,12,0,50,36,1
6237,82911,g1LVeBlQiVCOcKiTDDTy4PafQkGd4pbr,A3fsA9Zfv1X2fVEQhTw51lKENdNrEqT3,56,18,12,144,8,0,7,1,190,27.142857142857142,3,0.0,3,12,125,8,15,0,19,7,1,148,42,0
6238,82912,dSKLyWRwDNYp6bnGVfES0oxRsg4F2fbZ,SpATywNh6bZuzm8s1ceuBUnMUAeoAHHw,14,23,0,16,1,0,4,0,44,6.285714285714286,2,0.0,6,0,13,1,17,0,3,4,0,20,24,1
6239,82914,cJcuhtji0eqLhfXtnFSDlw6v5huTlvOS,A3fsA9Zfv1X2fVEQhTw51lKENdNrEqT3,4,2,1,0,1,0,1,0,5,0.7142857142857143,1,0.0,0,1,0,1,2,0,0,1,0,2,3,1
6240,82928,xJa5HsLvA8jsaOm3YgI5AyYKc4qtiOFH,SpATywNh6bZuzm8s1ceuBUnMUAeoAHHw,5,4,1,0,1,0,2,0,8,1.1428571428571428,2,0.0,0,1,0,1,4,0,0,2,0,2,6,1
6241,82934,Vrjrap5JcUBcGnZI9GyoeJ8llD9p1BxJ,SpATywNh6bZuzm8s1ceuBUnMUAeoAHHw,9,5,4,0,4,0,4,0,17,2.4285714285714284,1,0.0,0,4,0,4,5,0,0,4,0,8,9,1
6242,82964,jMzDAkDrCqzTj207GrZXDfLQXbYc8WXP,A3fsA9Zfv1X2fVEQhTw51lKENdNrEqT3,4,0,0,0,0,0,4,0,4,0.5714285714285714,1,0.0,0,0,0,0,0,0,0,4,0,0,4,1
6243,82965,jMzDAkDrCqzTj207GrZXDfLQXbYc8WXP,bWdj2GDclj5ofokWjzoa5jAwMkxCykd6,9,11,5,0,2,0,7,0,25,3.5714285714285716,1,0.0,0,5,0,2,11,0,0,7,0,7,18,0
6244,82968,k3mZz4gOE5kxngWJdlg5ZkSuFCPjQxmM,A3fsA9Zfv1X2fVEQhTw51lKENdNrEqT3,24,18,13,0,12,0,5,0,48,6.857142857142857,2,0.0,0,13,0,12,18,0,0,5,0,25,23,1
6245,82994,pzQmB4p3u9FrEJSWAX6BNOWRPavo1Lrn,A3fsA9Zfv1X2fVEQhTw51lKENdNrEqT3,1,0,0,0,0,0,1,0,1,0.14285714285714285,1,0.0,0,0,0,0,0,0,0,1,0,0,1,1
6246,82997,HKDSRzc7MQzCfJsk49D6xFQK4oFHHvy7,RXDvfPUBYFlVdlueBFbLW0mhhAyGEqpt,25,50,2,0,2,0,9,0,63,9.0,2,0.0,13,2,0,2,37,0,0,9,0,17,46,1
6247,83039,2T4Z0Imx9CFpIzAb5WFSfhS9FT4FpZWV,SpATywNh6bZuzm8s1ceuBUnMUAeoAHHw,6,4,3,0,2,0,1,0,10,1.4285714285714286,1,0.0,0,3,0,2,4,0,0,1,0,5,5,1
6248,83046,c9uDpmjbhEZRV8vNkDH73VXR3MBTMWZN,SpATywNh6bZuzm8s1ceuBUnMUAeoAHHw,3,3,0,0,0,0,1,0,4,0.5714285714285714,1,0.0,0,0,0,0,3,0,0,1,0,0,4,1
6249,83062,srfjFpufe5zNlnc0Z3dNMD37ukToEJo1,bWdj2GDclj5ofokWjzoa5jAwMkxCykd6,5,2,1,0,1,0,2,0,6,0.8571428571428571,1,0.0,0,1,0,1,2,0,0,2,0,2,4,1
6250,83077,U58EahcrdrWDxUCYXDIka19POAAfjp1t,SpATywNh6bZuzm8s1ceuBUnMUAeoAHHw,1,0,0,0,0,0,1,0,1,0.14285714285714285,1,0.0,0,0,0,0,0,0,0,1,0,0,1,1
6251,83082,OIznJTzf0VYpJo8slc0B4fnJO5XA07gY,SpATywNh6bZuzm8s1ceuBUnMUAeoAHHw,3,0,0,0,0,0,3,0,3,0.42857142857142855,1,0.0,0,0,0,0,0,0,0,3,0,0,3,1
6252,83123,ZNcLOAJ2r3H5DqhbGk1CiPtwI7ixaCeK,bWdj2GDclj5ofokWjzoa5jAwMkxCykd6,30,25,16,36,11,3,5,0,96,13.714285714285714,3,0.0,2,16,35,11,23,3,1,5,0,64,32,0
6253,83126,Lcn36O95deZy87mO20P7rqE00Sa7JkLZ,SpATywNh6bZuzm8s1ceuBUnMUAeoAHHw,16,30,13,18,2,16,13,1,93,13.285714285714286,5,0.0,11,13,15,2,19,16,3,13,1,41,52,1
6254,83139,vwYpmLrcF8bt1idVso7bAZqs27Gfb44w,SpATywNh6bZuzm8s1ceuBUnMUAeoAHHw,1,0,0,0,0,0,2,0,2,0.2857142857142857,2,0.0,0,0,0,0,0,0,0,2,0,0,2,1
6255,83152,eDH23vVDxXZaCChKrwOZtbVMeyImNCFQ,SpATywNh6bZuzm8s1ceuBUnMUAeoAHHw,22,21,10,20,6,0,1,0,58,8.285714285714286,1,0.0,4,10,18,6,17,0,2,1,0,38,20,1
6256,83161,pAklb1PvY7ruK0UegPVyIZm4Osf6iC9m,bWdj2GDclj5ofokWjzoa5jAwMkxCykd6,5,1,1,0,1,0,3,0,6,0.8571428571428571,2,0.0,0,1,0,1,1,0,0,3,0,2,4,1
6257,83169,8xLHRJYQMKIoYFTLtqTA4nbHlXLKnGUi,SpATywNh6bZuzm8s1ceuBUnMUAeoAHHw,1,0,0,0,0,0,1,0,1,0.14285714285714285,1,0.0,0,0,0,0,0,0,0,1,0,0,1,0
6258,83173,TxlSnMAR26IaOfJh6C0k9qQhw2BgogEc,A3fsA9Zfv1X2fVEQhTw51lKENdNrEqT3,25,26,10,0,10,0,16,0,62,8.857142857142858,2,0.0,0,10,0,10,26,0,0,16,0,20,42,1
6259,83179,x0laSvoDXG0a7WULReVXZ8zh05t91jGU,bWdj2GDclj5ofokWjzoa5jAwMkxCykd6,9,25,6,0,0,0,2,0,33,4.714285714285714,1,0.0,0,6,0,0,25,0,0,2,0,6,27,1
6260,83203,cpPSwRiyzrnBZYcFR4yyg60XVFgQxQi4,A3fsA9Zfv1X2fVEQhTw51lKENdNrEqT3,2,0,0,0,0,0,2,0,2,0.2857142857142857,1,0.0,0,0,0,0,0,0,0,2,0,0,2,1
6261,83225,PQOxOuUmyRHKBoJFPoN8Q817ShM1EBnU,SpATywNh6bZuzm8s1ceuBUnMUAeoAHHw,18,25,8,3,6,0,5,0,47,6.714285714285714,2,0.0,14,8,3,6,11,0,0,5,0,31,16,1
6262,83229,x0laSvoDXG0a7WULReVXZ8zh05t91jGU,SpATywNh6bZuzm8s1ceuBUnMUAeoAHHw,10,29,7,0,0,0,2,0,38,5.428571428571429,1,0.0,0,7,0,0,29,0,0,2,0,7,31,1
6263,83231,d7WW3KTRknYcXaBZVYoIbNodkFYiI6Ik,A3fsA9Zfv1X2fVEQhTw51lKENdNrEqT3,18,18,8,0,6,2,8,1,43,6.142857142857143,2,0.0,0,8,0,6,18,2,0,8,1,14,29,1
6264,83237,EzJ8kmSst3q4WJG0Np16XBDvh9hFUAyd,SpATywNh6bZuzm8s1ceuBUnMUAeoAHHw,12,17,1,4,0,2,2,0,26,3.7142857142857144,3,0.0,0,1,4,0,17,2,0,2,0,5,21,0
6265,83259,kGjYv3fIEEVtPJnIV3ey8jABNxw0G9DP,A3fsA9Zfv1X2fVEQhTw51lKENdNrEqT3,8,6,3,0,1,0,5,0,15,2.142857142857143,1,0.0,0,3,0,1,6,0,0,5,0,4,11,1
6266,83271,8rZiJk9Qyng7Kz2M0sWaeZmr6L3VBmoQ,A3fsA9Zfv1X2fVEQhTw51lKENdNrEqT3,1,0,0,0,0,0,1,0,1,0.14285714285714285,1,0.0,0,0,0,0,0,0,0,1,0,0,1,1
6267,83274,nronI72HtraF0IcAJUYxB4sbj9I4wtB0,bWdj2GDclj5ofokWjzoa5jAwMkxCykd6,27,48,25,134,12,0,8,0,227,32.42857142857143,2,0.0,8,25,125,12,40,0,9,8,0,170,57,1
6268,83294,drMAzq4nC1GseQmyuPqctPxioPnjLJpD,bWdj2GDclj5ofokWjzoa5jAwMkxCykd6,7,4,1,2,2,0,3,1,13,1.8571428571428572,1,0.0,2,1,2,2,2,0,0,3,1,7,6,1
6269,83296,WlpCtlv6l7VubBVcQacaEfXgsH5IUowW,bWdj2GDclj5ofokWjzoa5jAwMkxCykd6,2,0,0,0,0,0,2,0,2,0.2857142857142857,1,0.0,0,0,0,0,0,0,0,2,0,0,2,1
6270,83305,4NR9J7NrWx9P8bFiOFbZEGtYIezzdGum,SpATywNh6bZuzm8s1ceuBUnMUAeoAHHw,6,5,2,0,1,0,5,0,13,1.8571428571428572,3,0.0,0,2,0,1,5,0,0,5,0,3,10,1
6271,83313,6cy8BWaUGaMCAOjojQczbStvsRKYISdK,SpATywNh6bZuzm8s1ceuBUnMUAeoAHHw,10,12,6,0,0,0,5,0,23,3.2857142857142856,1,0.0,0,6,0,0,12,0,0,5,0,6,17,0
6272,83314,n49l3ufDNhve5wMzUe1UGnoLeZWomGLA,SpATywNh6bZuzm8s1ceuBUnMUAeoAHHw,8,8,5,0,3,0,2,0,18,2.5714285714285716,2,0.0,0,5,0,3,8,0,0,2,0,8,10,1
6273,83320,7uDVcwukNss0paMtTOJXNPZUXWP9vYuG,SpATywNh6bZuzm8s1ceuBUnMUAeoAHHw,5,5,0,0,0,0,1,0,6,0.8571428571428571,1,0.0,0,0,0,0,5,0,0,1,0,0,6,1
6274,83351,9HqwJ8d4m6K7QOSGhF3dVzXYAYpOl0vj,SpATywNh6bZuzm8s1ceuBUnMUAeoAHHw,4,2,1,0,1,0,1,0,5,0.7142857142857143,1,0.0,0,1,0,1,2,0,0,1,0,2,3,1
6275,83362,UROHliIogkXuXAccUzTqFupOwNjOEbXL,SpATywNh6bZuzm8s1ceuBUnMUAeoAHHw,7,7,1,0,1,0,4,0,13,1.8571428571428572,1,0.0,0,1,0,1,7,0,0,4,0,2,11,1
6276,83387,6rAXQgJka1nTTwbebP8kTYZLBZ3H51fb,A3fsA9Zfv1X2fVEQhTw51lKENdNrEqT3,6,3,1,0,1,0,2,0,7,1.0,1,0.0,0,1,0,1,3,0,0,2,0,2,5,1
6277,83403,e7qNFJlKhMPlLeAG8swrUc3pRnnUCD82,SpATywNh6bZuzm8s1ceuBUnMUAeoAHHw,29,39,24,33,12,2,10,0,120,17.142857142857142,5,0.0,9,24,30,12,30,2,3,10,0,75,45,0
6278,83407,DmtYVZArE2EvS9aiKUqKSMgZGIBgO1QS,RXDvfPUBYFlVdlueBFbLW0mhhAyGEqpt,12,7,5,21,3,0,2,0,38,5.428571428571429,1,0.0,1,5,17,3,6,0,4,2,0,26,12,1
6279,83412,AImx2eHFGaeqTe0d3fwuX86fffC0rd9k,SpATywNh6bZuzm8s1ceuBUnMUAeoAHHw,6,5,2,2,1,0,1,0,11,1.5714285714285714,1,0.0,2,2,2,1,3,0,0,1,0,7,4,1
6280,83425,Lr6km982apCQSCgmC6f9GQFgHOEktsCy,G8EPVSXsOYB5YQWZGiz1aVq5Pgr2GrQu,12,7,2,14,1,1,5,0,30,4.285714285714286,2,0.0,0,2,12,1,7,1,2,5,0,15,15,1
6281,83436,Pp6wRQkPti9Bk2fBcpI0VrxeT3AtZv4c,A3fsA9Zfv1X2fVEQhTw51lKENdNrEqT3,1,0,0,0,0,0,1,0,1,0.14285714285714285,1,0.0,0,0,0,0,0,0,0,1,0,0,1,1
6282,83457,ZxhebDCFWL0m0f61BciDLXGRMOKOE45R,SpATywNh6bZuzm8s1ceuBUnMUAeoAHHw,2,0,0,0,0,0,3,0,3,0.42857142857142855,1,0.0,0,0,0,0,0,0,0,3,0,0,3,1
6283,83515,EHQfOyQJIuqt0P1nyDah8NPkqTS1EGa4,SpATywNh6bZuzm8s1ceuBUnMUAeoAHHw,13,10,7,0,5,1,7,1,31,4.428571428571429,1,0.0,0,7,0,5,10,1,0,7,1,12,19,1
6284,83519,OmeHT0PntcI0ieBORzxyW3ukuMNHL2Uw,bWdj2GDclj5ofokWjzoa5jAwMkxCykd6,1,0,0,0,0,0,1,0,1,0.14285714285714285,1,0.0,0,0,0,0,0,0,0,1,0,0,1,1
6285,83520,AIxODBgirdS9q7XBbO7B4LHcFYA0NbGc,bWdj2GDclj5ofokWjzoa5jAwMkxCykd6,7,13,2,30,6,0,2,0,53,7.571428571428571,1,0.0,10,2,29,6,3,0,1,2,0,47,6,0
6286,83524,4Uyhf3xkbmSb7blGg2niZUhegHNb0hzL,SpATywNh6bZuzm8s1ceuBUnMUAeoAHHw,10,8,4,0,3,0,2,0,17,2.4285714285714284,1,0.0,0,4,0,3,8,0,0,2,0,7,10,0
6287,83525,8Rf4S0ug2TWWxQ3mSUdOeqp73t5YEeYH,RXDvfPUBYFlVdlueBFbLW0mhhAyGEqpt,9,6,3,0,4,0,4,0,17,2.4285714285714284,1,0.0,2,3,0,4,4,0,0,4,0,9,8,1
6288,83574,bzc6yymc6ktkSbBvgdjBytLe8to97DFg,SpATywNh6bZuzm8s1ceuBUnMUAeoAHHw,5,2,1,0,1,0,2,0,6,0.8571428571428571,1,0.0,0,1,0,1,2,0,0,2,0,2,4,1
6289,83578,t8qBiDTvOvYmrxcVIErRuEOf38tywm6t,A3fsA9Zfv1X2fVEQhTw51lKENdNrEqT3,42,26,20,92,8,9,10,0,165,23.571428571428573,4,0.0,1,20,73,8,25,9,19,10,0,102,63,1
6290,83597,kzdGmpsGUR2isiUTRf34FiwBn190CZX2,SpATywNh6bZuzm8s1ceuBUnMUAeoAHHw,8,9,1,1,1,0,2,0,14,2.0,2,0.0,5,1,1,1,4,0,0,2,0,8,6,1
6291,83610,LsCKaHxDojvW6mqkt4YixGtP1AxIvEcR,SpATywNh6bZuzm8s1ceuBUnMUAeoAHHw,18,26,0,14,0,2,13,1,56,8.0,4,0.0,0,0,12,0,26,2,2,13,1,12,44,0
6292,83614,f0G6xN4ok96NnHxUb12ID1EOiKvmCYmR,SpATywNh6bZuzm8s1ceuBUnMUAeoAHHw,5,19,12,0,0,0,6,0,37,5.285714285714286,4,0.0,0,12,0,0,19,0,0,6,0,12,25,1
6293,83619,DBdf78JfZqUu6Xrj5qSlBFRqX4eZFYBh,SpATywNh6bZuzm8s1ceuBUnMUAeoAHHw,5,5,1,0,0,0,2,0,8,1.1428571428571428,1,0.0,2,1,0,0,3,0,0,2,0,3,5,1
6294,83624,uZO11U6xkUn8TqWyabhD9DUasFPbf13L,SpATywNh6bZuzm8s1ceuBUnMUAeoAHHw,2,0,0,0,0,0,2,0,2,0.2857142857142857,1,0.0,0,0,0,0,0,0,0,2,0,0,2,0
6295,83631,q4FzN29BOCqmKsQz24UjDiDoY7rAOM1p,SpATywNh6bZuzm8s1ceuBUnMUAeoAHHw,1,0,0,0,0,0,1,0,1,0.14285714285714285,1,0.0,0,0,0,0,0,0,0,1,0,0,1,1
6296,83647,5lUjtpVDM24Ky0bHM8HFsUs8uLGNBspP,SpATywNh6bZuzm8s1ceuBUnMUAeoAHHw,3,2,0,0,0,0,1,0,3,0.42857142857142855,1,0.0,0,0,0,0,2,0,0,1,0,0,3,1
6297,83654,gGPwEyB8WM9RKY8d6MZCxjfZZkbEQNgr,A3fsA9Zfv1X2fVEQhTw51lKENdNrEqT3,1,0,0,0,0,0,1,0,1,0.14285714285714285,1,0.0,0,0,0,0,0,0,0,1,0,0,1,1
6298,83664,KqTFA16VVILHiK0IYy8jaNTctvzYX8nu,bWdj2GDclj5ofokWjzoa5jAwMkxCykd6,11,12,1,0,1,0,1,0,15,2.142857142857143,1,0.0,0,1,0,1,12,0,0,1,0,2,13,1
6299,83704,z38xWziicrZeTyki4GmVJQHBKXdJd40R,bWdj2GDclj5ofokWjzoa5jAwMkxCykd6,2,0,0,0,0,0,8,0,8,1.1428571428571428,1,0.0,0,0,0,0,0,0,0,8,0,0,8,1
6300,83713,bAltXvR0FBKFy91atPslJEMIb77R3lRC,A3fsA9Zfv1X2fVEQhTw51lKENdNrEqT3,12,9,4,0,4,0,5,0,22,3.142857142857143,1,0.0,0,4,0,4,9,0,0,5,0,8,14,1
6301,83729,CioR8peuoSw6UJW12F3PHl1hUYQxgYtj,SpATywNh6bZuzm8s1ceuBUnMUAeoAHHw,17,24,7,28,1,5,7,0,72,10.285714285714286,2,0.0,13,7,27,1,11,5,1,7,0,48,24,1
6302,83775,uiC9EHMxnf2w4h6Qgd2IixJ8SdchRJcU,A3fsA9Zfv1X2fVEQhTw51lKENdNrEqT3,1,0,0,0,0,0,1,0,1,0.14285714285714285,1,0.0,0,0,0,0,0,0,0,1,0,0,1,1
6303,83795,P0VuZGgCaFPCBxKorH7bJdlMsmBgjIrL,bWdj2GDclj5ofokWjzoa5jAwMkxCykd6,6,2,1,0,1,2,5,5,16,2.2857142857142856,2,0.0,0,1,0,1,2,2,0,5,5,2,14,1
6304,83829,73yLreN6EzcjveHRceJMpzYK9XWfEA6F,A3fsA9Zfv1X2fVEQhTw51lKENdNrEqT3,1,0,0,0,0,0,1,0,1,0.14285714285714285,1,0.0,0,0,0,0,0,0,0,1,0,0,1,1
6305,83851,hkZJZMuEk3eRSgWhjH7jPcJrlgv2RTNl,A3fsA9Zfv1X2fVEQhTw51lKENdNrEqT3,21,16,13,18,8,0,4,0,59,8.428571428571429,2,0.0,0,13,15,8,16,0,3,4,0,36,23,1
6306,83854,4IJ56QlJSL8avuRQEkrBcEyhUIO3LIP3,bWdj2GDclj5ofokWjzoa5jAwMkxCykd6,23,23,13,54,5,11,13,0,119,17.0,2,0.0,7,13,44,5,16,11,10,13,0,69,50,0
6307,83858,mSQuPHmd8TP05MnBFR4zut82tnd837yj,G8EPVSXsOYB5YQWZGiz1aVq5Pgr2GrQu,10,20,2,0,3,0,5,0,30,4.285714285714286,2,0.0,6,2,0,3,14,0,0,5,0,11,19,0
6308,83861,yfR3kQ7JpR4tbAAtg2uJogcbjyExFgIX,A3fsA9Zfv1X2fVEQhTw51lKENdNrEqT3,66,29,0,234,0,0,12,0,275,39.285714285714285,4,0.0,6,0,232,0,23,0,2,12,0,238,37,1
6309,83875,3CXEafcVCxECgohc6attm6JVlndHTBVL,SpATywNh6bZuzm8s1ceuBUnMUAeoAHHw,8,15,9,0,5,0,4,0,33,4.714285714285714,2,0.0,0,9,0,5,15,0,0,4,0,14,19,1
6310,83891,vIXg8cSMNeH6m9S64QuOOXQlNK5JgpP1,SpATywNh6bZuzm8s1ceuBUnMUAeoAHHw,4,2,1,0,1,1,1,0,6,0.8571428571428571,1,0.0,0,1,0,1,2,1,0,1,0,2,4,1
6311,83898,mbeSuuMfzSoN2eC8D2XuG5snuf7K1Ab4,SpATywNh6bZuzm8s1ceuBUnMUAeoAHHw,5,2,1,0,1,0,3,0,7,1.0,1,0.0,0,1,0,1,2,0,0,3,0,2,5,1
6312,83900,YUf9YSE5dta2ffkPJrkUXDrdyRDcwPmp,SpATywNh6bZuzm8s1ceuBUnMUAeoAHHw,4,2,0,0,0,3,2,0,7,1.0,1,0.0,0,0,0,0,2,3,0,2,0,0,7,1
6313,83916,9gwK2SMO9RzFmbR3NVs20xNig2HGOi8l,A3fsA9Zfv1X2fVEQhTw51lKENdNrEqT3,6,3,1,0,1,0,3,0,8,1.1428571428571428,3,0.0,0,1,0,1,3,0,0,3,0,2,6,1
6314,83924,m5tZ7113qZA5gPphfQM81fCEbUkxpJsE,SpATywNh6bZuzm8s1ceuBUnMUAeoAHHw,3,3,0,0,0,0,1,0,4,0.5714285714285714,1,0.0,0,0,0,0,3,0,0,1,0,0,4,1
6315,83933,bA4tnPZD0UU4XAL3OkL7nUjtkAzbgj9d,bWdj2GDclj5ofokWjzoa5jAwMkxCykd6,43,78,29,81,14,20,11,0,233,33.285714285714285,3,0.0,11,29,74,14,67,20,7,11,0,128,105,0
6316,83937,riM9GkB0ajSqpIPlVq4tRzOjk7wJ6NHE,SpATywNh6bZuzm8s1ceuBUnMUAeoAHHw,4,2,1,0,0,0,3,0,6,0.8571428571428571,2,0.0,0,1,0,0,2,0,0,3,0,1,5,1
6317,83949,Z89wynkx1rcXHYvlCNExAupGqq9VVjQV,G8EPVSXsOYB5YQWZGiz1aVq5Pgr2GrQu,23,5,4,56,1,0,9,1,76,10.857142857142858,2,0.0,0,4,48,1,5,0,8,9,1,53,23,1
6318,83952,3FEVPp7qXQqf7zefGcAP21t6w7dOpf6B,SpATywNh6bZuzm8s1ceuBUnMUAeoAHHw,5,2,1,0,1,0,2,0,6,0.8571428571428571,1,0.0,0,1,0,1,2,0,0,2,0,2,4,1
6319,83957,JXoruAOSjfsBsWMnWERJPrR6Egi77l6M,SpATywNh6bZuzm8s1ceuBUnMUAeoAHHw,4,2,0,0,0,0,2,0,4,0.5714285714285714,1,0.0,0,0,0,0,2,0,0,2,0,0,4,1
6320,83972,h2AAA2rscYTKabHFKWYAQiMOilyMV9Ba,SpATywNh6bZuzm8s1ceuBUnMUAeoAHHw,2,0,0,0,0,0,2,0,2,0.2857142857142857,1,0.0,0,0,0,0,0,0,0,2,0,0,2,1
6321,83978,19iVDfShKixZpg8xTJAbBZz9CTfyTS2H,A3fsA9Zfv1X2fVEQhTw51lKENdNrEqT3,16,17,8,0,7,0,3,0,35,5.0,2,0.0,0,8,0,7,17,0,0,3,0,15,20,1
6322,83989,QbrhOgnPl8mnx3TbklxYm9mtjH3wH9bH,A3fsA9Zfv1X2fVEQhTw51lKENdNrEqT3,18,12,9,0,8,5,9,0,43,6.142857142857143,1,0.0,0,9,0,8,12,5,0,9,0,17,26,1
6323,84000,rdlMbs5MAmZwKWZ5MP6d4JJy7danp2Mg,bWdj2GDclj5ofokWjzoa5jAwMkxCykd6,1,0,0,0,0,0,1,0,1,0.14285714285714285,1,0.0,0,0,0,0,0,0,0,1,0,0,1,1
6324,84001,rdlMbs5MAmZwKWZ5MP6d4JJy7danp2Mg,A3fsA9Zfv1X2fVEQhTw51lKENdNrEqT3,44,24,17,94,15,0,10,1,161,23.0,2,0.0,2,17,77,15,22,0,17,10,1,111,50,1
6325,84035,dhO2y8sIijAlPYlXxsHK1aEk6O7FL2Q2,SpATywNh6bZuzm8s1ceuBUnMUAeoAHHw,1,0,0,0,0,0,1,0,1,0.14285714285714285,1,0.0,0,0,0,0,0,0,0,1,0,0,1,1
6326,84057,JA3GjaqmpFLtt1yojsnNXLqhMexKQ8aw,SpATywNh6bZuzm8s1ceuBUnMUAeoAHHw,7,4,1,0,1,0,2,0,8,1.1428571428571428,1,0.0,0,1,0,1,4,0,0,2,0,2,6,1
6327,84087,bl8YOhounxXowMizQE2ibaM5H4dVfT77,A3fsA9Zfv1X2fVEQhTw51lKENdNrEqT3,1,0,0,0,0,0,1,0,1,0.14285714285714285,1,0.0,0,0,0,0,0,0,0,1,0,0,1,1
6328,84111,uiC9EHMxnf2w4h6Qgd2IixJ8SdchRJcU,SpATywNh6bZuzm8s1ceuBUnMUAeoAHHw,1,0,0,0,0,0,1,0,1,0.14285714285714285,1,0.0,0,0,0,0,0,0,0,1,0,0,1,1
6329,84133,bVLtn3iBc4ibW8xWVzLLM3Hs9gCB0qb7,A3fsA9Zfv1X2fVEQhTw51lKENdNrEqT3,1,0,0,0,0,0,1,0,1,0.14285714285714285,1,0.0,0,0,0,0,0,0,0,1,0,0,1,1
6330,84158,8xjONclmnIBNB55spM8y9l5QMEcAlTZb,SpATywNh6bZuzm8s1ceuBUnMUAeoAHHw,7,5,1,0,1,1,3,0,11,1.5714285714285714,1,0.0,0,1,0,1,5,1,0,3,0,2,9,1
6331,84165,n1ESpvyobZkFsfrWJhKOuY4URaa1sUc5,SpATywNh6bZuzm8s1ceuBUnMUAeoAHHw,11,28,17,0,3,3,10,0,61,8.714285714285714,3,0.0,0,17,0,3,28,3,0,10,0,20,41,0
6332,84170,YTpSaD5WvcxnMj244x9U8tK7ZjCb9sw0,A3fsA9Zfv1X2fVEQhTw51lKENdNrEqT3,2,0,0,0,0,0,2,0,2,0.2857142857142857,1,0.0,0,0,0,0,0,0,0,2,0,0,2,1
6333,84178,btDL3pREx87iBHbN4DIhDQi5ERLMYVWp,bWdj2GDclj5ofokWjzoa5jAwMkxCykd6,1,0,0,0,0,0,1,0,1,0.14285714285714285,1,0.0,0,0,0,0,0,0,0,1,0,0,1,1
6334,84260,rYr2KHitWY2dJDjTm0iH4NPcJrqWE49C,fbPkOYLVPtPgIt0MxizjfFJov3JbHyAi,6,3,2,0,2,0,1,0,8,1.1428571428571428,1,0.0,0,2,0,2,3,0,0,1,0,4,4,1
6335,84262,FPAm2uFeanUhwrUMeNexrdAIqWOfXUXu,fbPkOYLVPtPgIt0MxizjfFJov3JbHyAi,9,3,2,0,1,0,9,2,17,2.4285714285714284,1,0.0,0,2,0,1,3,0,0,9,2,3,14,1
6336,84263,wYQFQjixTa6JPR4LS7RDubQDsjze2pIh,fbPkOYLVPtPgIt0MxizjfFJov3JbHyAi,4,0,0,0,0,1,6,0,7,1.0,1,0.0,0,0,0,0,0,1,0,6,0,0,7,1
6337,84265,RfVW0lNKrf9tzkgd827lLFW37SMuSXSa,fbPkOYLVPtPgIt0MxizjfFJov3JbHyAi,1,0,0,0,0,0,1,0,1,0.14285714285714285,1,0.0,0,0,0,0,0,0,0,1,0,0,1,1
6338,84266,Y9sABG91qMGS63qErzaDtI7NXtIr1yry,fbPkOYLVPtPgIt0MxizjfFJov3JbHyAi,1,0,0,0,0,0,2,0,2,0.2857142857142857,1,0.0,0,0,0,0,0,0,0,2,0,0,2,1
6339,84267,fSXZR9jouiiFWLCY3FdQ789t2sGYhvFo,fbPkOYLVPtPgIt0MxizjfFJov3JbHyAi,8,3,2,0,2,0,5,0,12,1.7142857142857142,1,0.0,0,2,0,2,3,0,0,5,0,4,8,1
6340,84269,m3CYAa4IcxX9Ylz9hZ2wRjnl2ftCrROV,fbPkOYLVPtPgIt0MxizjfFJov3JbHyAi,2,0,0,0,0,0,2,0,2,0.2857142857142857,1,0.0,0,0,0,0,0,0,0,2,0,0,2,1
6341,84271,hqClGLaQsSBO8I9GqLKpIixM0sA0K0b8,fbPkOYLVPtPgIt0MxizjfFJov3JbHyAi,7,5,2,0,1,0,6,0,14,2.0,1,0.0,0,2,0,1,5,0,0,6,0,3,11,0
6342,84272,evnakjU40Z6lomGsTCUgDGsdugdMX48K,fbPkOYLVPtPgIt0MxizjfFJov3JbHyAi,1,0,0,0,0,0,1,0,1,0.14285714285714285,1,0.0,0,0,0,0,0,0,0,1,0,0,1,1
6343,84275,pzjUl0u19ajI9ZVL0U8kEZyjNgq0vPjp,fbPkOYLVPtPgIt0MxizjfFJov3JbHyAi,6,1,1,0,1,0,3,0,6,0.8571428571428571,1,0.0,0,1,0,1,1,0,0,3,0,2,4,1
6344,84280,BCFi8OFpWeV6fuTRoD5vV8AJMWuQ1jB1,fbPkOYLVPtPgIt0MxizjfFJov3JbHyAi,1,0,0,0,0,0,1,0,1,0.14285714285714285,1,0.0,0,0,0,0,0,0,0,1,0,0,1,1
6345,84283,e0psMwhUBdLDxrOxBkoveKoEdFTTZrF1,fbPkOYLVPtPgIt0MxizjfFJov3JbHyAi,1,0,0,0,0,0,1,0,1,0.14285714285714285,1,0.0,0,0,0,0,0,0,0,1,0,0,1,1
6346,84286,jzGZfbr4RQdn7HQn4oyJMDfKBcS7VFEE,fbPkOYLVPtPgIt0MxizjfFJov3JbHyAi,5,5,0,0,0,0,5,0,10,1.4285714285714286,1,0.0,0,0,0,0,5,0,0,5,0,0,10,1
6347,84287,7Wr0weM79zMxBVlRbYesNzjHgoZsdOEJ,fbPkOYLVPtPgIt0MxizjfFJov3JbHyAi,5,2,1,0,1,0,2,0,6,0.8571428571428571,1,0.0,0,1,0,1,2,0,0,2,0,2,4,1
6348,84288,7o7xgD7LMzcqbchAXccb0936AlSMEPrX,fbPkOYLVPtPgIt0MxizjfFJov3JbHyAi,11,16,5,0,2,1,8,1,33,4.714285714285714,1,0.0,0,5,0,2,16,1,0,8,1,7,26,1
6349,84290,ZjhTJ45cHD4xtUxPoyNMJGOQiBl5fTQp,fbPkOYLVPtPgIt0MxizjfFJov3JbHyAi,5,1,1,0,1,0,3,0,6,0.8571428571428571,1,0.0,0,1,0,1,1,0,0,3,0,2,4,1
6350,84292,vvCucU5XJyhTM3r43nJfSwk9oTpOoOzq,fbPkOYLVPtPgIt0MxizjfFJov3JbHyAi,2,0,0,0,0,0,2,0,2,0.2857142857142857,1,0.0,0,0,0,0,0,0,0,2,0,0,2,1
6351,84428,X7EWmuNzsz8xJY0A1pRUOJGHwrCZ0B64,bWdj2GDclj5ofokWjzoa5jAwMkxCykd6,5,4,1,0,2,0,6,0,13,1.8571428571428572,1,0.0,2,1,0,2,2,0,0,6,0,5,8,1
6352,84435,OOJh2Yrr6RQf9QAHFBo7EBzeZ2OAmLfw,SpATywNh6bZuzm8s1ceuBUnMUAeoAHHw,13,52,18,6,1,3,16,2,98,14.0,6,0.0,0,18,5,1,52,3,1,16,2,24,74,1
6353,84436,Vu8rN942EwDIOj6iE8IDqvSFXpvGHO9R,bWdj2GDclj5ofokWjzoa5jAwMkxCykd6,1,0,0,0,0,0,1,0,1,0.14285714285714285,1,0.0,0,0,0,0,0,0,0,1,0,0,1,1
6354,84453,9g6dyxp7tVOU5kbyy5pf6QgprdOQv6vZ,RXDvfPUBYFlVdlueBFbLW0mhhAyGEqpt,12,15,7,16,5,0,3,1,47,6.714285714285714,1,0.0,7,7,14,5,8,0,2,3,1,33,14,1
6355,84456,RGf4k3THi4AV4qsAjc1UEOWiIeDYcchf,RXDvfPUBYFlVdlueBFbLW0mhhAyGEqpt,6,3,1,0,1,0,6,0,11,1.5714285714285714,2,0.0,0,1,0,1,3,0,0,6,0,2,9,1
6356,84462,bfYktB6xMRG2G8ooGt6o3rE63qV6JxlI,A3fsA9Zfv1X2fVEQhTw51lKENdNrEqT3,1,0,0,0,0,0,1,0,1,0.14285714285714285,1,0.0,0,0,0,0,0,0,0,1,0,0,1,1
6357,84492,unG4C0Ae6YJ39WbV1xtmGVvK7bPgQLG7,RXDvfPUBYFlVdlueBFbLW0mhhAyGEqpt,8,9,4,0,1,0,3,0,17,2.4285714285714284,1,0.0,1,4,0,1,8,0,0,3,0,6,11,1
6358,84519,RijiZcjqs3Sau2onXuynGNDorKgFFeFF,bWdj2GDclj5ofokWjzoa5jAwMkxCykd6,2,0,0,0,0,0,2,0,2,0.2857142857142857,1,0.0,0,0,0,0,0,0,0,2,0,0,2,1
6359,84525,Q8lgDaE6CB6Qe5bNGFRY9Gtyuy1mU1jD,bWdj2GDclj5ofokWjzoa5jAwMkxCykd6,5,6,1,0,0,0,2,0,9,1.2857142857142858,1,0.0,1,1,0,0,5,0,0,2,0,2,7,1
6360,84553,nUVa7zKjNimx07QWGFgK3J5PX7DLOyrU,RXDvfPUBYFlVdlueBFbLW0mhhAyGEqpt,1,0,0,0,0,0,1,0,1,0.14285714285714285,1,0.0,0,0,0,0,0,0,0,1,0,0,1,1
6361,84556,OatCEetKd31vq2MFNsgH6MMikZrZEqiC,bWdj2GDclj5ofokWjzoa5jAwMkxCykd6,6,5,0,0,1,0,4,0,10,1.4285714285714286,2,0.0,0,0,0,1,5,0,0,4,0,1,9,1
6362,84580,7dBPQqnhg3HraIZoj8IGy6tqqgLAonOI,SpATywNh6bZuzm8s1ceuBUnMUAeoAHHw,22,39,1,22,0,0,5,0,67,9.571428571428571,2,0.0,18,1,21,0,21,0,1,5,0,40,27,1
6363,84601,xH5f8nfW6oTIgHjXoQgEUKIx6qvDN8rk,SpATywNh6bZuzm8s1ceuBUnMUAeoAHHw,10,10,5,4,2,0,3,0,24,3.4285714285714284,1,0.0,3,5,3,2,7,0,1,3,0,13,11,1
6364,84623,bVCYDQX7pJxff6OyJX4M9s17AtFlpk5i,bWdj2GDclj5ofokWjzoa5jAwMkxCykd6,7,4,2,0,2,0,2,0,10,1.4285714285714286,1,0.0,0,2,0,2,4,0,0,2,0,4,6,1
6365,84646,RiDnEhaXHtwiFRournEb2192YjpdBStU,G8EPVSXsOYB5YQWZGiz1aVq5Pgr2GrQu,1,0,0,0,0,0,1,0,1,0.14285714285714285,1,0.0,0,0,0,0,0,0,0,1,0,0,1,1
6366,84653,M8sw9Q866fjD6jCvGFf8R8DxTYZlPOJu,A3fsA9Zfv1X2fVEQhTw51lKENdNrEqT3,6,3,2,0,1,0,2,0,8,1.1428571428571428,1,0.0,0,2,0,1,3,0,0,2,0,3,5,1
6367,84661,WEqUhplW7x1SpLabVjNcI5M4HsCYjumg,bWdj2GDclj5ofokWjzoa5jAwMkxCykd6,1,0,0,0,0,0,1,0,1,0.14285714285714285,1,0.0,0,0,0,0,0,0,0,1,0,0,1,1
6368,84662,WEqUhplW7x1SpLabVjNcI5M4HsCYjumg,A3fsA9Zfv1X2fVEQhTw51lKENdNrEqT3,1,0,0,0,0,0,1,0,1,0.14285714285714285,1,0.0,0,0,0,0,0,0,0,1,0,0,1,0
6369,84666,hBNiP82EasOgIR36wjHyg8vPIDQi3YO9,bWdj2GDclj5ofokWjzoa5jAwMkxCykd6,19,29,16,63,3,24,48,1,184,26.285714285714285,6,0.0,3,16,57,3,26,24,6,48,1,79,105,1
6370,84675,BEEx400Zym1Adj0LXV9O094DcgDYxMgU,SpATywNh6bZuzm8s1ceuBUnMUAeoAHHw,4,2,1,0,1,2,1,0,7,1.0,1,0.0,0,1,0,1,2,2,0,1,0,2,5,1
6371,84683,4VbB29c0q05cB50SX5b3ExZB3pSJc6RG,bWdj2GDclj5ofokWjzoa5jAwMkxCykd6,1,0,0,0,0,0,1,0,1,0.14285714285714285,1,0.0,0,0,0,0,0,0,0,1,0,0,1,1
6372,84699,BePz5wimB2cOHtaUExV25HDlvULcE611,bWdj2GDclj5ofokWjzoa5jAwMkxCykd6,1,0,0,0,0,0,1,0,1,0.14285714285714285,1,0.0,0,0,0,0,0,0,0,1,0,0,1,1
6373,84700,y6ntZnNLGo4HBLvhhvkQknL88GLC1lnO,A3fsA9Zfv1X2fVEQhTw51lKENdNrEqT3,14,18,11,0,7,1,6,1,44,6.285714285714286,2,0.0,0,11,0,7,18,1,0,6,1,18,26,1
6374,84701,T7Fjesc6ALJYDwDrKyS5CHisl2gr4aWJ,SpATywNh6bZuzm8s1ceuBUnMUAeoAHHw,18,25,8,16,4,2,7,1,63,9.0,1,0.0,11,8,15,4,14,2,1,7,1,38,25,1
6375,84702,BePz5wimB2cOHtaUExV25HDlvULcE611,A3fsA9Zfv1X2fVEQhTw51lKENdNrEqT3,7,4,2,0,2,0,2,0,10,1.4285714285714286,1,0.0,0,2,0,2,4,0,0,2,0,4,6,1
6376,84709,1Ld3jQU8M0eiaLBshs8gjcgQEfdlgHyZ,A3fsA9Zfv1X2fVEQhTw51lKENdNrEqT3,4,1,0,0,0,0,4,0,5,0.7142857142857143,2,0.0,0,0,0,0,1,0,0,4,0,0,5,1
6377,84728,GEuM5Jv5mgEiHQoZ7WZazbnkG2fcrd9Y,SpATywNh6bZuzm8s1ceuBUnMUAeoAHHw,27,43,27,21,16,2,9,0,118,16.857142857142858,4,0.0,10,27,19,16,33,2,2,9,0,72,46,0
6378,84745,BecDXRtXjm4nVBtBp7AS3BiGeJeKZmYu,SpATywNh6bZuzm8s1ceuBUnMUAeoAHHw,8,19,14,0,4,2,8,0,47,6.714285714285714,2,0.0,0,14,0,4,19,2,0,8,0,18,29,1
6379,84762,NC1pdSztpfJLgz1bqVoe5aonviJWe881,A3fsA9Zfv1X2fVEQhTw51lKENdNrEqT3,9,7,1,0,1,1,5,0,15,2.142857142857143,1,0.0,0,1,0,1,7,1,0,5,0,2,13,1
6380,84772,zZhdHu8U17iajwoRnuWugvDVR1mdDKy8,bWdj2GDclj5ofokWjzoa5jAwMkxCykd6,5,2,1,0,1,0,2,0,6,0.8571428571428571,1,0.0,0,1,0,1,2,0,0,2,0,2,4,1
6381,84777,pQdSl7i5ZuZeH9uPILgdHrvwskp4vc4V,SpATywNh6bZuzm8s1ceuBUnMUAeoAHHw,2,0,0,0,0,0,2,0,2,0.2857142857142857,1,0.0,0,0,0,0,0,0,0,2,0,0,2,1
6382,84779,Yg1xD2SamgKDKmDpRN2e3H3NAX0vGE2e,SpATywNh6bZuzm8s1ceuBUnMUAeoAHHw,23,36,2,31,1,7,16,0,93,13.285714285714286,3,0.0,18,2,28,1,18,7,3,16,0,49,44,1
6383,84789,rK4055OdlTymOWiwkxW7eIve09mowPhX,SpATywNh6bZuzm8s1ceuBUnMUAeoAHHw,7,7,3,0,1,0,2,0,13,1.8571428571428572,1,0.0,3,3,0,1,4,0,0,2,0,7,6,1
6384,84792,uGYj0yruFsWhwZGIUR02DogFquupaSDC,A3fsA9Zfv1X2fVEQhTw51lKENdNrEqT3,2,0,0,0,0,0,2,0,2,0.2857142857142857,1,0.0,0,0,0,0,0,0,0,2,0,0,2,1
6385,84795,uGYj0yruFsWhwZGIUR02DogFquupaSDC,SpATywNh6bZuzm8s1ceuBUnMUAeoAHHw,3,0,0,0,0,0,3,0,3,0.42857142857142855,1,0.0,0,0,0,0,0,0,0,3,0,0,3,1
6386,84798,TMW9SZvtLJ7yT5p9QtW5dUGKwlkcqKyn,SpATywNh6bZuzm8s1ceuBUnMUAeoAHHw,4,5,0,0,0,0,1,0,6,0.8571428571428571,1,0.0,0,0,0,0,5,0,0,1,0,0,6,1
6387,84805,eo86tl8OT9De2TqE4YR9qShJM6EFKpQ8,bWdj2GDclj5ofokWjzoa5jAwMkxCykd6,1,0,0,0,0,0,1,0,1,0.14285714285714285,1,0.0,0,0,0,0,0,0,0,1,0,0,1,1
6388,84812,hfXydPAjmOPsUaxL2NqJ9TVTB2YLFfnT,A3fsA9Zfv1X2fVEQhTw51lKENdNrEqT3,6,6,4,0,1,0,1,0,12,1.7142857142857142,1,0.0,1,4,0,1,5,0,0,1,0,6,6,1
6389,84817,Wefj86tFjwJZnMq6IAWMjbzJgYWyoGE5,SpATywNh6bZuzm8s1ceuBUnMUAeoAHHw,5,2,1,0,1,0,2,0,6,0.8571428571428571,1,0.0,0,1,0,1,2,0,0,2,0,2,4,1
6390,84826,Q9zNW7tUNygCfX90HmMYh3sp90BWwKOU,SpATywNh6bZuzm8s1ceuBUnMUAeoAHHw,5,5,2,0,1,0,3,0,11,1.5714285714285714,2,0.0,0,2,0,1,5,0,0,3,0,3,8,1
6391,84828,Q9zNW7tUNygCfX90HmMYh3sp90BWwKOU,A3fsA9Zfv1X2fVEQhTw51lKENdNrEqT3,7,5,2,0,2,0,4,0,13,1.8571428571428572,2,0.0,0,2,0,2,5,0,0,4,0,4,9,1
6392,84830,Q9zNW7tUNygCfX90HmMYh3sp90BWwKOU,bWdj2GDclj5ofokWjzoa5jAwMkxCykd6,6,2,1,0,1,1,7,1,13,1.8571428571428572,2,0.0,0,1,0,1,2,1,0,7,1,2,11,1
6393,84833,lYZxf8lh7ftdpqB6JLOchZTdcrWSTRKb,SpATywNh6bZuzm8s1ceuBUnMUAeoAHHw,1,0,0,0,0,0,1,0,1,0.14285714285714285,1,0.0,0,0,0,0,0,0,0,1,0,0,1,1
6394,84839,VIwJtaSOWWljnDL02ObzIxH4JeVU0QQ1,A3fsA9Zfv1X2fVEQhTw51lKENdNrEqT3,31,33,23,0,13,1,20,0,90,12.857142857142858,5,0.0,0,23,0,13,33,1,0,20,0,36,54,1
6395,84843,SgKrscfCtmytbxsrqs57oYYzOpyIlSfF,A3fsA9Zfv1X2fVEQhTw51lKENdNrEqT3,52,32,20,74,10,13,18,1,168,24.0,4,0.0,4,20,64,10,28,13,10,18,1,98,70,0
6396,84847,FeSQQc9CIFMTYLlHcSRbUJqf0NNwxJ2K,A3fsA9Zfv1X2fVEQhTw51lKENdNrEqT3,42,51,19,44,11,0,10,0,135,19.285714285714285,4,0.0,3,19,43,11,48,0,1,10,0,76,59,0
6397,84848,ykaUPJW4Nc9r2mv4b25QxgdHgIcQ63RQ,A3fsA9Zfv1X2fVEQhTw51lKENdNrEqT3,3,5,1,0,0,0,1,0,7,1.0,2,0.0,0,1,0,0,5,0,0,1,0,1,6,0
6398,84851,1GaXo8IuKFR6VdEVIYRJbTRl2qOzgbEk,SpATywNh6bZuzm8s1ceuBUnMUAeoAHHw,20,15,12,2,9,0,2,0,40,5.714285714285714,2,0.0,1,12,2,9,14,0,0,2,0,24,16,1
6399,84859,tW4kGyQmGPxJ7lQyOwGHaOFglTma7gIC,A3fsA9Zfv1X2fVEQhTw51lKENdNrEqT3,1,0,0,0,0,0,2,0,2,0.2857142857142857,2,0.0,0,0,0,0,0,0,0,2,0,0,2,1
6400,84861,HWTC2OrGiLVAGzdqeYnCu2ZFUrUbe6I6,A3fsA9Zfv1X2fVEQhTw51lKENdNrEqT3,24,13,11,0,9,0,10,0,43,6.142857142857143,2,0.0,0,11,0,9,13,0,0,10,0,20,23,1
6401,84872,eLmalTVeebqdOV7NU54KOewS5jRaHr8U,G8EPVSXsOYB5YQWZGiz1aVq5Pgr2GrQu,9,6,5,0,3,0,2,0,16,2.2857142857142856,1,0.0,0,5,0,3,6,0,0,2,0,8,8,1
6402,84878,94L6G6uqjoIozyLQIsc4GEWmNn1tQth5,SpATywNh6bZuzm8s1ceuBUnMUAeoAHHw,5,5,2,0,1,0,1,0,9,1.2857142857142858,1,0.0,2,2,0,1,3,0,0,1,0,5,4,1
6403,84900,kFEFWVRKxySg48KS2BQ5EGBj2Fy43YYR,SpATywNh6bZuzm8s1ceuBUnMUAeoAHHw,21,52,1,41,0,0,5,0,99,14.142857142857142,4,0.0,29,1,34,0,23,0,7,5,0,64,35,0
6404,84901,vDE54330fhfIeduEF4A9zDFR0caHiOdH,SpATywNh6bZuzm8s1ceuBUnMUAeoAHHw,5,4,2,0,2,0,1,0,9,1.2857142857142858,1,0.0,0,2,0,2,4,0,0,1,0,4,5,0
6405,84917,0vwRPKOOXqPVOG208KGIKC6ZMS7Sq8oQ,SpATywNh6bZuzm8s1ceuBUnMUAeoAHHw,1,0,0,0,0,0,1,0,1,0.14285714285714285,1,0.0,0,0,0,0,0,0,0,1,0,0,1,1
6406,84921,P8HECw7bHyNqGqPTlWbv24tTg1SG6bAf,bWdj2GDclj5ofokWjzoa5jAwMkxCykd6,5,2,1,0,1,0,2,0,6,0.8571428571428571,1,0.0,0,1,0,1,2,0,0,2,0,2,4,1
6407,84961,Z7OL2jReCGgQtTEQuUTXjMfA5lyDuHVX,bWdj2GDclj5ofokWjzoa5jAwMkxCykd6,1,0,0,0,0,0,1,0,1,0.14285714285714285,1,0.0,0,0,0,0,0,0,0,1,0,0,1,1
6408,84966,pCc4oMnSwjyLKgjKHMWP0AClAZXrGa7k,SpATywNh6bZuzm8s1ceuBUnMUAeoAHHw,4,3,2,0,2,0,1,0,8,1.1428571428571428,1,0.0,0,2,0,2,3,0,0,1,0,4,4,1
6409,84984,DzeVjg4mxykX9i07xMVI01d13jNEeveb,SpATywNh6bZuzm8s1ceuBUnMUAeoAHHw,7,2,1,0,1,1,5,0,10,1.4285714285714286,1,0.0,0,1,0,1,2,1,0,5,0,2,8,1
6410,84985,CrUGk3m8dLEwGtioGoHIpBu2eedFaqft,A3fsA9Zfv1X2fVEQhTw51lKENdNrEqT3,1,0,0,0,0,0,1,0,1,0.14285714285714285,1,0.0,0,0,0,0,0,0,0,1,0,0,1,1
6411,84991,NA0DQ3D2dj2Qrm5FSVbmrxMOfzF4fwPf,A3fsA9Zfv1X2fVEQhTw51lKENdNrEqT3,4,4,0,0,0,2,2,0,8,1.1428571428571428,1,0.0,0,0,0,0,4,2,0,2,0,0,8,1
6412,85012,DyupaV8BmUavHjvovvxyDg1D0z37S8dm,bWdj2GDclj5ofokWjzoa5jAwMkxCykd6,8,9,6,0,4,0,5,0,24,3.4285714285714284,3,0.0,0,6,0,4,9,0,0,5,0,10,14,1
6413,85019,aIIHBjdeRcv9jhajcTkxD39vpVMqF1ri,RXDvfPUBYFlVdlueBFbLW0mhhAyGEqpt,9,14,6,0,3,0,4,0,27,3.857142857142857,2,0.0,4,6,0,3,10,0,0,4,0,13,14,1
6414,85021,QAaGqoCRVYYJLVC9SEo8gPzESLmuOfNy,SpATywNh6bZuzm8s1ceuBUnMUAeoAHHw,6,3,1,0,2,0,1,0,7,1.0,1,0.0,0,1,0,2,3,0,0,1,0,3,4,1
6415,85025,BvCRPlMfMau2kDEBEjyV1l6RJMQy5B5l,A3fsA9Zfv1X2fVEQhTw51lKENdNrEqT3,5,3,2,0,0,0,4,0,9,1.2857142857142858,1,0.0,0,2,0,0,3,0,0,4,0,2,7,1
6416,85046,kNdT4Mob6J1VkdvqbhmS4aPzbDLqNeYP,bWdj2GDclj5ofokWjzoa5jAwMkxCykd6,5,5,1,0,1,0,1,0,8,1.1428571428571428,2,0.0,0,1,0,1,5,0,0,1,0,2,6,1
6417,85050,nyeqFiX3kXuwJTyYhNUJyRvPBqtJ6Two,bWdj2GDclj5ofokWjzoa5jAwMkxCykd6,5,2,1,0,1,0,4,0,8,1.1428571428571428,1,0.0,0,1,0,1,2,0,0,4,0,2,6,1
6418,85076,oW1xvgPq04VONgGO2ScFMsBR7tam1x2P,SpATywNh6bZuzm8s1ceuBUnMUAeoAHHw,6,6,1,0,1,0,2,0,10,1.4285714285714286,1,0.0,0,1,0,1,6,0,0,2,0,2,8,1
6419,85111,4sNqSI7Ntno9WsJhOo6RhAKwZwVuo3TV,bWdj2GDclj5ofokWjzoa5jAwMkxCykd6,1,0,0,0,0,0,1,0,1,0.14285714285714285,1,0.0,0,0,0,0,0,0,0,1,0,0,1,1
6420,85125,HpVSIYjYyErYvGk0jIIh7vGC0VGqoFpj,bWdj2GDclj5ofokWjzoa5jAwMkxCykd6,8,4,2,0,1,0,7,1,15,2.142857142857143,1,0.0,0,2,0,1,4,0,0,7,1,3,12,0
6421,85126,PWCmirnemxe8gmyr1O505eqeMATy6y8u,SpATywNh6bZuzm8s1ceuBUnMUAeoAHHw,7,3,2,0,2,0,2,0,9,1.2857142857142858,1,0.0,0,2,0,2,3,0,0,2,0,4,5,0
6422,85127,dZqFLbQhzRGv0XrnoR6Btyn7eZPLWNcs,SpATywNh6bZuzm8s1ceuBUnMUAeoAHHw,12,18,0,20,0,0,2,0,40,5.714285714285714,1,0.0,6,0,17,0,12,0,3,2,0,23,17,1
6423,85129,BvCRPlMfMau2kDEBEjyV1l6RJMQy5B5l,bWdj2GDclj5ofokWjzoa5jAwMkxCykd6,4,7,3,0,0,2,5,0,17,2.4285714285714284,1,0.0,2,3,0,0,5,2,0,5,0,5,12,1
6424,85135,n2FEbIJOdMpzLhQAaysQpPRu04nDuH4a,bWdj2GDclj5ofokWjzoa5jAwMkxCykd6,7,9,4,0,3,0,2,0,18,2.5714285714285716,1,0.0,0,4,0,3,9,0,0,2,0,7,11,1
6425,85144,CVCf4od7ffnWY5VcGG9qXOV7fsgr6eo9,G8EPVSXsOYB5YQWZGiz1aVq5Pgr2GrQu,8,2,0,0,0,0,14,0,16,2.2857142857142856,2,0.0,0,0,0,0,2,0,0,14,0,0,16,1
6426,85174,TNWu8lQOCqXwhlhWhjlBSPXoG0TmfsH5,SpATywNh6bZuzm8s1ceuBUnMUAeoAHHw,1,0,0,0,0,0,2,0,2,0.2857142857142857,1,0.0,0,0,0,0,0,0,0,2,0,0,2,1
6427,85178,TNWu8lQOCqXwhlhWhjlBSPXoG0TmfsH5,bWdj2GDclj5ofokWjzoa5jAwMkxCykd6,1,0,0,0,0,0,2,0,2,0.2857142857142857,1,0.0,0,0,0,0,0,0,0,2,0,0,2,1
6428,85180,TNWu8lQOCqXwhlhWhjlBSPXoG0TmfsH5,G8EPVSXsOYB5YQWZGiz1aVq5Pgr2GrQu,1,0,0,0,0,0,2,0,2,0.2857142857142857,1,0.0,0,0,0,0,0,0,0,2,0,0,2,1
6429,85182,TNWu8lQOCqXwhlhWhjlBSPXoG0TmfsH5,A3fsA9Zfv1X2fVEQhTw51lKENdNrEqT3,1,0,0,0,0,0,2,0,2,0.2857142857142857,1,0.0,0,0,0,0,0,0,0,2,0,0,2,1
6430,85191,YgaRsb5CJPElWQw5mvJ8Vl3IfLfYzm4F,SpATywNh6bZuzm8s1ceuBUnMUAeoAHHw,21,19,10,10,7,0,8,1,55,7.857142857142857,3,0.0,3,10,10,7,16,0,0,8,1,30,25,1
6431,85204,rSg9Ux5o4Clwkrl8yQB8aMYBxGhrELBb,bWdj2GDclj5ofokWjzoa5jAwMkxCykd6,5,3,1,0,1,0,2,0,7,1.0,1,0.0,0,1,0,1,3,0,0,2,0,2,5,1
6432,85215,hu8eak1Xmf8voE8pnxPzkSD2dZP9Sipf,RXDvfPUBYFlVdlueBFbLW0mhhAyGEqpt,3,3,0,0,0,0,9,0,12,1.7142857142857142,3,0.0,0,0,0,0,3,0,0,9,0,0,12,1
6433,85221,QtVFRX2q8o00yrhDoRxTCIn6JhufsUXY,A3fsA9Zfv1X2fVEQhTw51lKENdNrEqT3,1,0,0,0,0,0,1,0,1,0.14285714285714285,1,0.0,0,0,0,0,0,0,0,1,0,0,1,1
6434,85234,x8deFWL3OuMwdtM1Ar06UAP0kS8JTUGt,SpATywNh6bZuzm8s1ceuBUnMUAeoAHHw,14,32,0,21,0,0,2,0,55,7.857142857142857,1,0.0,19,0,18,0,13,0,3,2,0,37,18,1
6435,85236,rSg9Ux5o4Clwkrl8yQB8aMYBxGhrELBb,A3fsA9Zfv1X2fVEQhTw51lKENdNrEqT3,6,3,1,0,1,0,2,0,7,1.0,1,0.0,0,1,0,1,3,0,0,2,0,2,5,1
6436,85251,vSCx3udDUOJuH4qQxIeZOxrYva69olaR,G8EPVSXsOYB5YQWZGiz1aVq5Pgr2GrQu,10,7,2,0,2,1,5,0,17,2.4285714285714284,1,0.0,4,2,0,2,3,1,0,5,0,8,9,1
6437,85254,5AnTWuSZRA41O05i9OVXdtPUlL8FmaJL,SpATywNh6bZuzm8s1ceuBUnMUAeoAHHw,13,26,4,2,1,7,23,3,66,9.428571428571429,4,0.0,1,4,2,1,25,7,0,23,3,8,58,1
6438,85263,NTSPR2Wl1tIxtx1KX6XExiYGpKCsz0n8,G8EPVSXsOYB5YQWZGiz1aVq5Pgr2GrQu,1,0,0,0,0,0,1,0,1,0.14285714285714285,1,0.0,0,0,0,0,0,0,0,1,0,0,1,1
6439,85307,HDadS1kWhA9nJbFHsRG6aT6o1pPlcFrf,SpATywNh6bZuzm8s1ceuBUnMUAeoAHHw,1,0,0,0,0,0,2,0,2,0.2857142857142857,2,0.0,0,0,0,0,0,0,0,2,0,0,2,1
6440,85315,6wxNqFTG10UU1QlHAjCeeHAXofHA0Wd6,A3fsA9Zfv1X2fVEQhTw51lKENdNrEqT3,2,0,0,0,0,0,2,0,2,0.2857142857142857,1,0.0,0,0,0,0,0,0,0,2,0,0,2,1
6441,85320,6W33zL2q4028wAczl90YoEq5VRoJonHk,bWdj2GDclj5ofokWjzoa5jAwMkxCykd6,2,0,0,0,0,0,2,0,2,0.2857142857142857,1,0.0,0,0,0,0,0,0,0,2,0,0,2,0
6442,85324,4ZtOohTiezs8VzIzc66Ao14rrfIGFCZG,G8EPVSXsOYB5YQWZGiz1aVq5Pgr2GrQu,10,9,4,0,2,1,8,1,25,3.5714285714285716,2,0.0,0,4,0,2,9,1,0,8,1,6,19,1
6443,85329,dkZKTQ89aNq1jLWsQ8GHGCzeOaVmaX8E,SpATywNh6bZuzm8s1ceuBUnMUAeoAHHw,1,0,0,0,0,0,1,0,1,0.14285714285714285,1,0.0,0,0,0,0,0,0,0,1,0,0,1,1
6444,85336,176ILS8J1NMmZsoc0RxEg8JQJcz6ksLo,A3fsA9Zfv1X2fVEQhTw51lKENdNrEqT3,1,0,0,0,0,0,1,0,1,0.14285714285714285,1,0.0,0,0,0,0,0,0,0,1,0,0,1,1
6445,85340,7iqCukuZ9oGbANuGlupslMrsiHUFtGa5,bWdj2GDclj5ofokWjzoa5jAwMkxCykd6,3,3,1,0,0,0,1,0,5,0.7142857142857143,1,0.0,0,1,0,0,3,0,0,1,0,1,4,1
6446,85347,qr1Y8xuPrcpdzScNHYsirGXqasfUdOVa,A3fsA9Zfv1X2fVEQhTw51lKENdNrEqT3,14,15,11,0,6,0,14,0,46,6.571428571428571,4,0.0,0,11,0,6,15,0,0,14,0,17,29,1
6447,85360,sT9hGAnww95aeGvqwQpJlS3ORhWDT49F,SpATywNh6bZuzm8s1ceuBUnMUAeoAHHw,19,32,15,14,2,0,9,0,72,10.285714285714286,3,0.0,8,15,13,2,24,0,1,9,0,38,34,0
6448,85362,h7k1wsPKqQnsb0xgegTBlN0S8ZpolGHh,SpATywNh6bZuzm8s1ceuBUnMUAeoAHHw,6,5,1,0,1,0,2,0,9,1.2857142857142858,1,0.0,0,1,0,1,5,0,0,2,0,2,7,1
6449,85381,MaYaRLQWCfitDjLO89g6UksqHgmMxPRV,SpATywNh6bZuzm8s1ceuBUnMUAeoAHHw,24,35,4,38,1,5,14,2,99,14.142857142857142,4,0.0,12,4,32,1,23,5,6,14,2,49,50,0
6450,86898,JUAvN6CchqwicZ9lfSkTbwue3bPu0qhC,A3fsA9Zfv1X2fVEQhTw51lKENdNrEqT3,2,0,0,0,0,0,2,0,2,0.2857142857142857,1,0.0,0,0,0,0,0,0,0,2,0,0,2,1
6451,86912,GfqCozSB56b335uZLl5d2syEloMgMtnE,SpATywNh6bZuzm8s1ceuBUnMUAeoAHHw,8,22,10,0,5,5,25,3,70,10.0,1,0.0,1,10,0,5,21,5,0,25,3,16,54,0
6452,86916,m9APg30xFaPG98uje3arCJfO5W7zr48c,SpATywNh6bZuzm8s1ceuBUnMUAeoAHHw,1,0,0,0,0,0,1,0,1,0.14285714285714285,1,0.0,0,0,0,0,0,0,0,1,0,0,1,1
6453,86938,rJCRtFYOHadlaWolNt4hiGuOfo8UHBBK,SpATywNh6bZuzm8s1ceuBUnMUAeoAHHw,13,30,9,12,3,7,4,0,65,9.285714285714286,3,0.0,16,9,12,3,14,7,0,4,0,40,25,0
6454,86974,HB5xN5WvO63fyle8L9OU8KEV5tvW4m0R,SpATywNh6bZuzm8s1ceuBUnMUAeoAHHw,30,24,12,27,8,1,8,3,83,11.857142857142858,2,0.0,10,12,26,8,14,1,1,8,3,56,27,0
6455,86997,hXvrvs517Cljnw9n8TIqf0EZFGKj5tLN,A3fsA9Zfv1X2fVEQhTw51lKENdNrEqT3,1,0,0,0,0,0,1,0,1,0.14285714285714285,1,0.0,0,0,0,0,0,0,0,1,0,0,1,1
6456,87001,0dwnge5EOc1G7OI2GIE4cTm6v44kkXQF,A3fsA9Zfv1X2fVEQhTw51lKENdNrEqT3,1,0,0,0,0,0,1,0,1,0.14285714285714285,1,0.0,0,0,0,0,0,0,0,1,0,0,1,0
6457,87049,1BQpAvqrBw6EmiaIW2MwJ2rv4x4Q2s0V,SpATywNh6bZuzm8s1ceuBUnMUAeoAHHw,5,5,2,0,0,0,2,0,9,1.2857142857142858,1,0.0,1,2,0,0,4,0,0,2,0,3,6,0
6458,87087,ycZcyaRZkRmTmfTyJcaxWvg5l6N3L4CN,SpATywNh6bZuzm8s1ceuBUnMUAeoAHHw,12,13,7,0,4,3,5,1,33,4.714285714285714,2,0.0,3,7,0,4,10,3,0,5,1,14,19,1
6459,87094,TPPsOieQBcwqH8dqABTR3mddQ5gDzlZO,A3fsA9Zfv1X2fVEQhTw51lKENdNrEqT3,23,28,21,0,18,0,5,0,72,10.285714285714286,2,0.0,3,21,0,18,25,0,0,5,0,42,30,1
6460,87109,xSRvBNCdhLUrfFyYzicxsnRRkZUYQ9tk,SpATywNh6bZuzm8s1ceuBUnMUAeoAHHw,11,10,1,0,0,0,9,1,21,3.0,2,0.0,2,1,0,0,8,0,0,9,1,3,18,1
6461,87120,Kpr6ISdqohTmchfzbxziZ98TNPreGKVa,SpATywNh6bZuzm8s1ceuBUnMUAeoAHHw,6,5,1,0,1,0,2,0,9,1.2857142857142858,1,0.0,2,1,0,1,3,0,0,2,0,4,5,1
6462,87122,NFGYUC7dcOkWJh2BiZLJheVSucAvXvpt,A3fsA9Zfv1X2fVEQhTw51lKENdNrEqT3,9,18,0,0,0,0,4,0,22,3.142857142857143,2,0.0,0,0,0,0,18,0,0,4,0,0,22,1
6463,87147,PHBho9Sc0XQZt8wGEuns5tbDU5eoHa8g,A3fsA9Zfv1X2fVEQhTw51lKENdNrEqT3,64,66,27,138,16,0,21,0,268,38.285714285714285,5,0.0,8,27,125,16,58,0,13,21,0,176,92,0
6464,87162,RgxmGDfKcBuOKimrAda6q6r1m3kTwJWg,SpATywNh6bZuzm8s1ceuBUnMUAeoAHHw,2,0,0,0,0,0,2,0,2,0.2857142857142857,1,0.0,0,0,0,0,0,0,0,2,0,0,2,1
6465,87169,BYoagvhtaQZvEdBOdm0fSGLXeMikTNAf,SpATywNh6bZuzm8s1ceuBUnMUAeoAHHw,8,9,0,0,0,0,4,0,13,1.8571428571428572,2,0.0,0,0,0,0,9,0,0,4,0,0,13,1
6466,87190,rs3WOUQ4PSHbNxyhVeLlE6lgdYqGPTef,SpATywNh6bZuzm8s1ceuBUnMUAeoAHHw,16,26,5,15,3,0,4,0,53,7.571428571428571,1,0.0,20,5,14,3,6,0,1,4,0,42,11,1
6467,87199,hO4ixki4cn72f2HXil7H5yfXyIpxdfFl,SpATywNh6bZuzm8s1ceuBUnMUAeoAHHw,14,20,1,18,1,0,7,0,47,6.714285714285714,2,0.0,9,1,15,1,11,0,3,7,0,26,21,0
6468,87330,ChO2roT5np1gHX6O4LZD82zuXuaO1HXn,A3fsA9Zfv1X2fVEQhTw51lKENdNrEqT3,35,19,16,24,13,5,6,0,83,11.857142857142858,1,0.0,0,16,20,13,19,5,4,6,0,49,34,1
6469,87402,Xz40w2Sa6ycZOmupSA5XfcYT02Ov8S1m,A3fsA9Zfv1X2fVEQhTw51lKENdNrEqT3,11,8,4,0,3,0,2,0,17,2.4285714285714284,1,0.0,0,4,0,3,8,0,0,2,0,7,10,1
6470,87447,QflUMQYqgKuyQPnCteHvz3LqhJ9AwCga,RXDvfPUBYFlVdlueBFbLW0mhhAyGEqpt,37,63,47,0,39,6,8,0,163,23.285714285714285,2,0.0,8,47,0,39,55,6,0,8,0,94,69,1
6471,87485,HqS5s3hltvHSRLR6PzHeJNPRu48XNpMR,A3fsA9Zfv1X2fVEQhTw51lKENdNrEqT3,1,0,0,0,0,0,1,0,1,0.14285714285714285,1,0.0,0,0,0,0,0,0,0,1,0,0,1,1
6472,87514,UUyRymVa7K1uXcxu9NV7wrw7koSoKJkA,A3fsA9Zfv1X2fVEQhTw51lKENdNrEqT3,13,8,6,0,4,0,10,1,29,4.142857142857143,2,0.0,0,6,0,4,8,0,0,10,1,10,19,1
6473,87520,pqsPOTJhOrzp1CuSM0L3m4JXPVXPbkqe,SpATywNh6bZuzm8s1ceuBUnMUAeoAHHw,16,29,14,6,2,5,11,1,68,9.714285714285714,2,0.0,4,14,6,2,25,5,0,11,1,26,42,1
6474,87544,HF98YPKzT8oi2j9flZW9kstZcvL3ZimG,SpATywNh6bZuzm8s1ceuBUnMUAeoAHHw,29,49,13,18,9,0,9,0,98,14.0,4,0.0,8,13,15,9,41,0,3,9,0,45,53,0
6475,87552,VfEelXsd4Sgrcy5E8mk405V2S0XUGtSK,A3fsA9Zfv1X2fVEQhTw51lKENdNrEqT3,5,2,0,0,0,1,4,1,8,1.1428571428571428,1,0.0,0,0,0,0,2,1,0,4,1,0,8,1
6476,87563,mLnrkBxCMzHzCOgxlcePLHngsSsyrmY0,SpATywNh6bZuzm8s1ceuBUnMUAeoAHHw,23,50,0,28,0,2,16,1,97,13.857142857142858,4,0.0,16,0,25,0,34,2,3,16,1,41,56,0
6477,87601,fXFz6g5r2Tp8eWARWPVXqKuqaMAimuJv,A3fsA9Zfv1X2fVEQhTw51lKENdNrEqT3,6,4,2,0,2,0,1,0,9,1.2857142857142858,1,0.0,0,2,0,2,4,0,0,1,0,4,5,1
6478,87607,Y1N757YBcw2pa0f5R2cGYXkdHdVAg7lL,RXDvfPUBYFlVdlueBFbLW0mhhAyGEqpt,22,29,16,0,9,0,1,0,55,7.857142857142857,1,0.0,0,16,0,9,29,0,0,1,0,25,30,1
6479,87645,or5tGmwIQtkxzns3Abayo6pKJnoHWcAG,A3fsA9Zfv1X2fVEQhTw51lKENdNrEqT3,11,6,4,0,3,0,6,1,20,2.857142857142857,2,0.0,0,4,0,3,6,0,0,6,1,7,13,1
6480,87649,KCgqr6mS6kq5aoFQfmLbsIxQVUeF53Nr,SpATywNh6bZuzm8s1ceuBUnMUAeoAHHw,9,11,0,9,0,0,2,1,23,3.2857142857142856,1,0.0,1,0,7,0,10,0,2,2,1,8,15,0
6481,87732,L1FTG9TM6RI5TBCTexQgshQhXhu2oZpJ,RXDvfPUBYFlVdlueBFbLW0mhhAyGEqpt,45,34,20,59,13,2,10,0,138,19.714285714285715,5,0.0,9,20,57,13,25,2,2,10,0,99,39,1
6482,87733,bwOsVB833e5tHrwHSqmXCzs0EZClNPpv,bWdj2GDclj5ofokWjzoa5jAwMkxCykd6,6,3,1,0,1,3,5,1,14,2.0,2,0.0,1,1,0,1,2,3,0,5,1,3,11,1
6483,87742,TvtViclCsd2PmV5PrW2DKEwPmoLOSaRh,A3fsA9Zfv1X2fVEQhTw51lKENdNrEqT3,67,46,3,110,2,1,11,1,174,24.857142857142858,1,0.0,5,3,99,2,41,1,11,11,1,109,65,1
6484,87752,waDceRgc2N0BjPJorKWJj1WtKs87R7xP,A3fsA9Zfv1X2fVEQhTw51lKENdNrEqT3,11,11,7,0,5,0,3,0,26,3.7142857142857144,1,0.0,1,7,0,5,10,0,0,3,0,13,13,1
6485,87759,kbnbUyJ6SeYN8u39lgEBCBnZvcNekMlk,bWdj2GDclj5ofokWjzoa5jAwMkxCykd6,4,2,1,0,1,0,1,0,5,0.7142857142857143,1,0.0,0,1,0,1,2,0,0,1,0,2,3,1
6486,87764,VPCWV7vv7mSXLXdyKv2YQuYNd5q5tnVr,A3fsA9Zfv1X2fVEQhTw51lKENdNrEqT3,1,0,0,0,0,0,1,0,1,0.14285714285714285,1,0.0,0,0,0,0,0,0,0,1,0,0,1,1
6487,87826,yGll7cBEK4l513wg08W8WjrXiINZSUwd,SpATywNh6bZuzm8s1ceuBUnMUAeoAHHw,4,2,1,0,1,0,2,0,6,0.8571428571428571,1,0.0,0,1,0,1,2,0,0,2,0,2,4,1
6488,87864,nWedGV2Cyz7b86zoWjyUJZtraXV6YlYz,SpATywNh6bZuzm8s1ceuBUnMUAeoAHHw,12,12,0,7,0,1,5,0,25,3.5714285714285716,1,0.0,4,0,7,0,8,1,0,5,0,11,14,0
6489,87919,NtuSsCWxiM5cZ0UalS4e7aFbcsYH60Br,bWdj2GDclj5ofokWjzoa5jAwMkxCykd6,2,0,0,0,0,0,2,0,2,0.2857142857142857,1,0.0,0,0,0,0,0,0,0,2,0,0,2,0
6490,87920,1uj3lODORrX2PgjuF1fpWy9nhOirDGas,G8EPVSXsOYB5YQWZGiz1aVq5Pgr2GrQu,30,48,18,24,5,1,8,1,105,15.0,5,0.0,4,18,18,5,44,1,6,8,1,45,60,0
6491,87928,cszgTMCcWdEja3BpEwPP5MtLXTMUMJXE,A3fsA9Zfv1X2fVEQhTw51lKENdNrEqT3,1,0,0,0,0,0,1,0,1,0.14285714285714285,1,0.0,0,0,0,0,0,0,0,1,0,0,1,1
6492,87982,MQK4DgM2xSqvXiKh3zV47i5iY5mt4VPL,SpATywNh6bZuzm8s1ceuBUnMUAeoAHHw,4,2,1,0,1,0,1,0,5,0.7142857142857143,1,0.0,0,1,0,1,2,0,0,1,0,2,3,1
6493,87987,Ffohn9JNnGJQD2IavzMTS00ubnVtcb2T,SpATywNh6bZuzm8s1ceuBUnMUAeoAHHw,31,36,21,14,8,1,13,1,94,13.428571428571429,7,0.0,7,21,14,8,29,1,0,13,1,50,44,0
6494,87994,Y51MqWhaiGyWdNickwBkKEZ7LC7se5uV,A3fsA9Zfv1X2fVEQhTw51lKENdNrEqT3,1,0,0,0,0,0,1,0,1,0.14285714285714285,1,0.0,0,0,0,0,0,0,0,1,0,0,1,1
6495,88029,bSaZ1hYnI1zX06sBhHjW0JtYDEAqEuPp,SpATywNh6bZuzm8s1ceuBUnMUAeoAHHw,23,34,0,23,0,13,34,5,109,15.571428571428571,6,0.0,7,0,19,0,27,13,4,34,5,26,83,0
6496,88039,pAIEYSSXdgXA2O8eKo5gs0U3YOaGGkK5,SpATywNh6bZuzm8s1ceuBUnMUAeoAHHw,11,6,4,4,3,0,3,0,20,2.857142857142857,1,0.0,1,4,4,3,5,0,0,3,0,12,8,1
6497,88082,yiWok4eQ5hgdJ8eYi2O0qHhy67Y9EA3E,RXDvfPUBYFlVdlueBFbLW0mhhAyGEqpt,4,2,0,0,0,0,2,0,4,0.5714285714285714,1,0.0,0,0,0,0,2,0,0,2,0,0,4,1
6498,88086,ffLXxfgMU4yir9uI5fIkKo2iZzEw2Lpz,A3fsA9Zfv1X2fVEQhTw51lKENdNrEqT3,6,2,1,0,1,1,4,0,9,1.2857142857142858,2,0.0,0,1,0,1,2,1,0,4,0,2,7,1
6499,88089,x44blDMbARj16T0tLu8ojXSHZTWR98Zp,A3fsA9Zfv1X2fVEQhTw51lKENdNrEqT3,6,2,0,0,0,0,5,0,7,1.0,1,0.0,0,0,0,0,2,0,0,5,0,0,7,1
6500,88095,dCAqk9uHiS99GMTcJQtThG8XWnwwbp5Q,bWdj2GDclj5ofokWjzoa5jAwMkxCykd6,1,0,0,0,0,0,1,0,1,0.14285714285714285,1,0.0,0,0,0,0,0,0,0,1,0,0,1,1
6501,88114,giXuT5U1RtMqgo8IXt5j9x4mrlpr0AWq,A3fsA9Zfv1X2fVEQhTw51lKENdNrEqT3,33,29,3,56,0,0,6,0,94,13.428571428571429,3,0.0,5,3,52,0,24,0,4,6,0,60,34,1
6502,88115,57QNpq0y9acG53aqB6y56Mpy1s4uWqKM,A3fsA9Zfv1X2fVEQhTw51lKENdNrEqT3,18,10,8,0,7,0,6,0,31,4.428571428571429,2,0.0,0,8,0,7,10,0,0,6,0,15,16,1
6503,88117,os5aeAM18BF9yPST9BbZNwxdgfyb3iSj,A3fsA9Zfv1X2fVEQhTw51lKENdNrEqT3,4,2,1,0,1,0,6,0,10,1.4285714285714286,1,0.0,0,1,0,1,2,0,0,6,0,2,8,1
6504,88139,dclBqf1EWh3Ih224SoyQN0nAKWGjQR6I,SpATywNh6bZuzm8s1ceuBUnMUAeoAHHw,11,5,4,0,4,2,11,1,27,3.857142857142857,1,0.0,0,4,0,4,5,2,0,11,1,8,19,1
6505,88140,ci0TVQYsVR5jGo6uk57VSejmvHQzKbHq,SpATywNh6bZuzm8s1ceuBUnMUAeoAHHw,15,23,6,16,3,1,6,0,55,7.857142857142857,1,0.0,16,6,13,3,7,1,3,6,0,38,17,1
6506,88290,zagfJzNHtSvWCFgkMj9NSIbmff9j4Jzi,7GRhBDsirIGkRZBtSMEzNTyDr2JQm4xx,5,2,1,0,1,1,4,0,9,1.2857142857142858,1,0.0,0,1,0,1,2,1,0,4,0,2,7,1
6507,88395,qInCpaeuecWrGMAIOnQb1wZeYTgOfrqB,7GRhBDsirIGkRZBtSMEzNTyDr2JQm4xx,1,0,0,0,0,0,1,0,1,0.14285714285714285,1,0.0,0,0,0,0,0,0,0,1,0,0,1,1
6508,88419,Nnydl7u2ge7nezXYbZ5DWwoPbVU96qN7,7GRhBDsirIGkRZBtSMEzNTyDr2JQm4xx,25,25,12,25,7,2,4,0,75,10.714285714285714,1,0.0,8,12,19,7,17,2,6,4,0,46,29,1
6509,88520,klfSXDgeuLd0URCaUqSBWiGxyD6lj0zh,7GRhBDsirIGkRZBtSMEzNTyDr2JQm4xx,31,53,12,38,14,18,7,0,142,20.285714285714285,1,0.0,34,12,33,14,19,18,5,7,0,93,49,1
6510,88535,RMHhN3yqeqMVtL0le3LPxRjp5aMu0uOX,7GRhBDsirIGkRZBtSMEzNTyDr2JQm4xx,7,3,2,0,2,0,2,0,9,1.2857142857142858,1,0.0,0,2,0,2,3,0,0,2,0,4,5,1
6511,88543,dorUpp1ODfe9BqxoBX8EUNGD90FW70kn,7GRhBDsirIGkRZBtSMEzNTyDr2JQm4xx,37,61,20,58,15,0,2,0,156,22.285714285714285,1,0.0,30,20,52,15,31,0,6,2,0,117,39,0
6512,88559,dpAgQLtjPDPymVmdyZFVsWQut5sougN0,7GRhBDsirIGkRZBtSMEzNTyDr2JQm4xx,11,3,2,0,2,4,6,1,18,2.5714285714285716,1,0.0,0,2,0,2,3,4,0,6,1,4,14,1
6513,88609,NRGKxfD21idsk82Fv2MwrybcNTOKr52A,7GRhBDsirIGkRZBtSMEzNTyDr2JQm4xx,1,0,0,0,0,0,1,0,1,0.14285714285714285,1,0.0,0,0,0,0,0,0,0,1,0,0,1,1
6514,88671,uUGE7QSg22XWq63RpYifnvGl7ha2AJY9,7GRhBDsirIGkRZBtSMEzNTyDr2JQm4xx,1,0,0,0,0,0,1,0,1,0.14285714285714285,1,0.0,0,0,0,0,0,0,0,1,0,0,1,1
6515,88682,IPGiOAgTo8oAVcrOKeYCONet5W5qWWCW,7GRhBDsirIGkRZBtSMEzNTyDr2JQm4xx,2,0,0,0,0,0,2,0,2,0.2857142857142857,1,0.0,0,0,0,0,0,0,0,2,0,0,2,1
6516,88683,YPNKBmbK0WLMDD2GyDPdurqVlRMJYUzc,7GRhBDsirIGkRZBtSMEzNTyDr2JQm4xx,3,0,0,0,0,0,3,0,3,0.42857142857142855,1,0.0,0,0,0,0,0,0,0,3,0,0,3,1
6517,88691,OanZ4liHLS9Z9zOLSdbk7KQJbN4gOKSZ,7GRhBDsirIGkRZBtSMEzNTyDr2JQm4xx,1,0,0,0,0,0,1,0,1,0.14285714285714285,1,0.0,0,0,0,0,0,0,0,1,0,0,1,1
6518,88775,zNnqmF2sQm5pVrk4EjykARlvIbp0hTq0,fbPkOYLVPtPgIt0MxizjfFJov3JbHyAi,6,3,1,0,1,0,3,0,8,1.1428571428571428,2,0.0,0,1,0,1,3,0,0,3,0,2,6,1
6519,88777,Uf1qigQqXVxNALjpI0OUPGkslBlud9Ut,fbPkOYLVPtPgIt0MxizjfFJov3JbHyAi,6,3,2,0,2,0,1,0,8,1.1428571428571428,1,0.0,0,2,0,2,3,0,0,1,0,4,4,1
6520,88778,gfCaKEduRhBAyI1gNYKiZ3eGKbbM2Zzn,fbPkOYLVPtPgIt0MxizjfFJov3JbHyAi,2,0,0,0,0,0,2,0,2,0.2857142857142857,1,0.0,0,0,0,0,0,0,0,2,0,0,2,1
6521,88780,nxtpPsNzngYTsI1SZcZNPzXTwqY5qTmx,fbPkOYLVPtPgIt0MxizjfFJov3JbHyAi,5,2,1,0,1,0,2,0,6,0.8571428571428571,1,0.0,0,1,0,1,2,0,0,2,0,2,4,1
6522,88782,0Fj1MjrLeWw10VEjEhUtTscYzoHMiAaR,fbPkOYLVPtPgIt0MxizjfFJov3JbHyAi,2,0,0,0,0,0,6,0,6,0.8571428571428571,1,0.0,0,0,0,0,0,0,0,6,0,0,6,1
6523,88783,0osfGmMGm8jt9kb8kP5HcmQdyiR2KFbt,fbPkOYLVPtPgIt0MxizjfFJov3JbHyAi,9,5,3,0,2,6,4,1,21,3.0,1,0.0,0,3,0,2,5,6,0,4,1,5,16,1
6524,88784,la0M1c91h799fPQIw73JrRQfyaSu3lyA,fbPkOYLVPtPgIt0MxizjfFJov3JbHyAi,1,0,0,0,0,0,1,0,1,0.14285714285714285,1,0.0,0,0,0,0,0,0,0,1,0,0,1,1
6525,88785,76WTB850XyfRMUDEt6Hi4EqgOfT9IEtK,fbPkOYLVPtPgIt0MxizjfFJov3JbHyAi,9,12,1,0,1,1,5,1,21,3.0,1,0.0,1,1,0,1,11,1,0,5,1,3,18,1
6526,88787,9k2E0gibBkBETtLxegOSAXJ2stT7JIe8,fbPkOYLVPtPgIt0MxizjfFJov3JbHyAi,8,5,1,0,2,0,11,2,21,3.0,1,0.0,2,1,0,2,3,0,0,11,2,5,16,1
6527,88788,qT122hnKUhEIpv6ZsCDLoOTP7nHJSaNq,fbPkOYLVPtPgIt0MxizjfFJov3JbHyAi,7,4,2,0,2,0,7,0,15,2.142857142857143,1,0.0,1,2,0,2,3,0,0,7,0,5,10,1
6528,88789,fQyY3sWQeXkKYt8B4zLpW9naNVJ351r5,fbPkOYLVPtPgIt0MxizjfFJov3JbHyAi,11,7,3,0,4,0,8,2,24,3.4285714285714284,1,0.0,3,3,0,4,4,0,0,8,2,10,14,1
6529,88790,nZBEO25QEEdKJsNDjWc27BQlFlOJqVIP,fbPkOYLVPtPgIt0MxizjfFJov3JbHyAi,7,5,3,0,2,1,2,0,13,1.8571428571428572,1,0.0,0,3,0,2,5,1,0,2,0,5,8,1
6530,88791,iZvZwMImGAt7q4aUPPRIOXEQbHAYw3j9,fbPkOYLVPtPgIt0MxizjfFJov3JbHyAi,24,28,14,20,15,2,9,1,89,12.714285714285714,1,0.0,9,14,15,15,19,2,5,9,1,53,36,1
6531,88793,iUbyHXj7nnwsn3idID6iMxIxqlgprHQJ,fbPkOYLVPtPgIt0MxizjfFJov3JbHyAi,2,0,0,0,0,0,4,0,4,0.5714285714285714,1,0.0,0,0,0,0,0,0,0,4,0,0,4,1
6532,88797,SJbFjfL77hmrpjM2fDE61GEOGezGEGS2,fbPkOYLVPtPgIt0MxizjfFJov3JbHyAi,1,0,0,0,0,0,1,0,1,0.14285714285714285,1,0.0,0,0,0,0,0,0,0,1,0,0,1,1
6533,88799,sCKziRJTsOYc4lQfYxPq4wO4jIyYAbxE,fbPkOYLVPtPgIt0MxizjfFJov3JbHyAi,2,0,0,0,0,0,2,0,2,0.2857142857142857,1,0.0,0,0,0,0,0,0,0,2,0,0,2,1
6534,88800,NBVERkC2Sbv324jT0djpWcPmYUJcR4Oa,fbPkOYLVPtPgIt0MxizjfFJov3JbHyAi,3,2,0,0,0,0,1,0,3,0.42857142857142855,1,0.0,0,0,0,0,2,0,0,1,0,0,3,1
6535,88802,1qt3gH5lpss0VnR5LgXp1AGPTrEn5n0R,fbPkOYLVPtPgIt0MxizjfFJov3JbHyAi,2,0,0,0,0,0,2,0,2,0.2857142857142857,1,0.0,0,0,0,0,0,0,0,2,0,0,2,1
6536,88803,2zFsyHLRIVr61iaQkzpRvzQtauWJlCfW,fbPkOYLVPtPgIt0MxizjfFJov3JbHyAi,1,0,0,0,0,0,2,0,2,0.2857142857142857,1,0.0,0,0,0,0,0,0,0,2,0,0,2,1
6537,88804,u4s0SPiIkynucY7ReF58TL89R2q4zw1x,fbPkOYLVPtPgIt0MxizjfFJov3JbHyAi,4,2,1,0,1,0,1,0,5,0.7142857142857143,1,0.0,0,1,0,1,2,0,0,1,0,2,3,0
6538,88805,8YR0tcT3D8d0JlIytw4LxKfYYQekJyvj,fbPkOYLVPtPgIt0MxizjfFJov3JbHyAi,5,3,1,0,1,0,1,0,6,0.8571428571428571,1,0.0,0,1,0,1,3,0,0,1,0,2,4,1
6539,88806,emj3hNG2XZHsTTaF5Lr1CYx27lHx0rEZ,fbPkOYLVPtPgIt0MxizjfFJov3JbHyAi,8,9,4,0,4,0,1,0,18,2.5714285714285716,1,0.0,0,4,0,4,9,0,0,1,0,8,10,1
6540,88808,qvojdac7xUuog4FKjywIiWLo2CLniAnu,fbPkOYLVPtPgIt0MxizjfFJov3JbHyAi,9,5,3,0,3,0,2,0,13,1.8571428571428572,1,0.0,0,3,0,3,5,0,0,2,0,6,7,1
6541,88809,r7HcMNOT5LLOYH8hCtxY2qjQMqPnDz4Z,fbPkOYLVPtPgIt0MxizjfFJov3JbHyAi,11,13,7,2,5,4,4,0,35,5.0,1,0.0,1,7,2,5,12,4,0,4,0,15,20,1
6542,88810,Im5unyUxIwWC6gQuuhs0nm7hNG0B0uwk,fbPkOYLVPtPgIt0MxizjfFJov3JbHyAi,7,3,2,0,2,1,7,0,15,2.142857142857143,1,0.0,0,2,0,2,3,1,0,7,0,4,11,1
6543,88811,75sdjcSshG9zd9yqWMZjrix1dGre1kOU,fbPkOYLVPtPgIt0MxizjfFJov3JbHyAi,5,2,1,0,1,0,2,0,6,0.8571428571428571,1,0.0,0,1,0,1,2,0,0,2,0,2,4,1
6544,88813,KC3eAbHLPns12iVsS4LuLv4X7AErDIWY,fbPkOYLVPtPgIt0MxizjfFJov3JbHyAi,1,0,0,0,0,0,2,0,2,0.2857142857142857,1,0.0,0,0,0,0,0,0,0,2,0,0,2,1
6545,88814,qmemIVC5Iuvmt3EwAEmeheRArNgSE4sO,fbPkOYLVPtPgIt0MxizjfFJov3JbHyAi,1,0,0,0,0,0,1,0,1,0.14285714285714285,1,0.0,0,0,0,0,0,0,0,1,0,0,1,1
6546,88815,Ryj9SYlTY2129nyufOPixA9oPGYhqvjh,fbPkOYLVPtPgIt0MxizjfFJov3JbHyAi,4,3,1,0,1,0,3,0,8,1.1428571428571428,2,0.0,0,1,0,1,3,0,0,3,0,2,6,1
6547,88818,89WrqZK2Q73BIEUqNtaalkZbdJCLDFwZ,fbPkOYLVPtPgIt0MxizjfFJov3JbHyAi,8,4,2,0,1,3,6,1,17,2.4285714285714284,2,0.0,0,2,0,1,4,3,0,6,1,3,14,1
6548,88820,FwTErVkZ5KG64sGBwGPbKk9gM0cwQPh1,fbPkOYLVPtPgIt0MxizjfFJov3JbHyAi,10,7,5,0,4,8,6,1,31,4.428571428571429,1,0.0,0,5,0,4,7,8,0,6,1,9,22,1
6549,88821,p4bpHXDCH4ga8oV8ZqbH95nJI7VYCp8t,fbPkOYLVPtPgIt0MxizjfFJov3JbHyAi,1,0,0,0,0,0,1,0,1,0.14285714285714285,1,0.0,0,0,0,0,0,0,0,1,0,0,1,1
6550,88822,4hbcS1XH6kSybbsyz7K3CYFhB00MIUIr,fbPkOYLVPtPgIt0MxizjfFJov3JbHyAi,6,6,2,0,3,0,1,0,12,1.7142857142857142,1,0.0,3,2,0,3,3,0,0,1,0,8,4,1
6551,88823,AyhJARh0xhxObM9zhvUdDxlTCtu309eW,fbPkOYLVPtPgIt0MxizjfFJov3JbHyAi,8,7,4,0,3,27,5,0,46,6.571428571428571,3,0.0,0,4,0,3,7,27,0,5,0,7,39,1
6552,88824,mc7ReRohr0aHl54443zTpOlq1o12BqN6,fbPkOYLVPtPgIt0MxizjfFJov3JbHyAi,1,0,0,0,0,0,1,0,1,0.14285714285714285,1,0.0,0,0,0,0,0,0,0,1,0,0,1,1
6553,88825,SO7BGTzNf50pHLqWJC7Isbkuvs1iCvSw,fbPkOYLVPtPgIt0MxizjfFJov3JbHyAi,11,8,5,0,3,7,3,1,27,3.857142857142857,1,0.0,1,5,0,3,7,7,0,3,1,9,18,1
6554,88826,FHVGisAeAJdUWbqdfGOX1SqwMTNsn4Sl,fbPkOYLVPtPgIt0MxizjfFJov3JbHyAi,6,1,1,0,1,0,3,0,6,0.8571428571428571,1,0.0,0,1,0,1,1,0,0,3,0,2,4,1
6555,88828,D4QcA7podzZXBTfof4ESNtLtgPKFTty3,fbPkOYLVPtPgIt0MxizjfFJov3JbHyAi,7,2,1,0,1,8,6,1,19,2.7142857142857144,1,0.0,0,1,0,1,2,8,0,6,1,2,17,1
6556,88832,xLVZrHAd2rcd4gjL2AH8LHStjVOxoTXH,fbPkOYLVPtPgIt0MxizjfFJov3JbHyAi,7,7,4,0,3,0,2,0,16,2.2857142857142856,2,0.0,0,4,0,3,7,0,0,2,0,7,9,1
6557,88833,eOxm8XEI11Xs6eiBi1Nu5QzIagZXwEm9,fbPkOYLVPtPgIt0MxizjfFJov3JbHyAi,7,4,2,0,2,8,3,0,19,2.7142857142857144,2,0.0,1,2,0,2,3,8,0,3,0,5,14,1
6558,88834,UPCBTwptJrhgu4vesm7VG1r09OOWFZ8M,fbPkOYLVPtPgIt0MxizjfFJov3JbHyAi,2,0,0,0,0,0,3,0,3,0.42857142857142855,1,0.0,0,0,0,0,0,0,0,3,0,0,3,1
6559,88835,sR0gVqP9THtsGU0nXYxvlPsXuHuYggxR,fbPkOYLVPtPgIt0MxizjfFJov3JbHyAi,8,6,2,2,2,0,4,0,16,2.2857142857142856,1,0.0,2,2,2,2,4,0,0,4,0,8,8,1
6560,88837,QkdU1z3YFvdeUK9lKehYyofsDutrm196,fbPkOYLVPtPgIt0MxizjfFJov3JbHyAi,6,4,2,0,2,0,1,0,9,1.2857142857142858,1,0.0,0,2,0,2,4,0,0,1,0,4,5,1
6561,88838,gVqypDd1b5rP0VnVbrsZj4FDK81Xew1Y,fbPkOYLVPtPgIt0MxizjfFJov3JbHyAi,4,2,1,0,1,0,1,0,5,0.7142857142857143,1,0.0,0,1,0,1,2,0,0,1,0,2,3,1
6562,88839,iKVtXLZY6XC1Ozhvwt3XfCzLYHoRf4Le,fbPkOYLVPtPgIt0MxizjfFJov3JbHyAi,5,1,1,0,1,0,2,0,5,0.7142857142857143,1,0.0,0,1,0,1,1,0,0,2,0,2,3,1
6563,88840,Sbvsuo19O2SfThVQR8m11L1fIHdeUt20,fbPkOYLVPtPgIt0MxizjfFJov3JbHyAi,9,8,4,0,2,2,8,1,25,3.5714285714285716,2,0.0,0,4,0,2,8,2,0,8,1,6,19,1
6564,88841,sXHmxCYzWKnOBp4g0oDOkoNrOpYDpt1m,fbPkOYLVPtPgIt0MxizjfFJov3JbHyAi,1,0,0,0,0,0,1,0,1,0.14285714285714285,1,0.0,0,0,0,0,0,0,0,1,0,0,1,1
6565,88843,YkG4vF4KhqibrD50khtgskxo6iKIJC5w,fbPkOYLVPtPgIt0MxizjfFJov3JbHyAi,6,3,2,0,2,0,1,0,8,1.1428571428571428,1,0.0,0,2,0,2,3,0,0,1,0,4,4,1
6566,88846,AqzJls3OFl2nFap48g5Tia0Yo0Y7Cer3,fbPkOYLVPtPgIt0MxizjfFJov3JbHyAi,9,11,4,0,3,1,5,1,25,3.5714285714285716,1,0.0,0,4,0,3,11,1,0,5,1,7,18,1
6567,88847,6mNKW4qOUXPShTxM8cvfepjQFTLv3oOh,fbPkOYLVPtPgIt0MxizjfFJov3JbHyAi,20,20,16,0,16,18,15,1,86,12.285714285714286,1,0.0,2,16,0,16,18,18,0,15,1,34,52,1
6568,88850,d9MkkuCn04Toz7g1JpLdUJWD9xM5braA,fbPkOYLVPtPgIt0MxizjfFJov3JbHyAi,4,3,1,0,1,0,2,0,7,1.0,1,0.0,0,1,0,1,3,0,0,2,0,2,5,1
6569,88851,Gl03eSeNtb7juYcfyy4T6xQkEEhQalIx,fbPkOYLVPtPgIt0MxizjfFJov3JbHyAi,5,5,3,0,2,0,1,0,11,1.5714285714285714,1,0.0,0,3,0,2,5,0,0,1,0,5,6,0
6570,88852,SW8hZER4lRVJxocMEgvR4kXl1NsQnFzy,fbPkOYLVPtPgIt0MxizjfFJov3JbHyAi,6,3,2,0,2,0,1,0,8,1.1428571428571428,1,0.0,0,2,0,2,3,0,0,1,0,4,4,1
6571,88853,zvDqimtTzQDntzI9wqOWSebcIJKnGJ4a,fbPkOYLVPtPgIt0MxizjfFJov3JbHyAi,12,26,3,11,1,16,15,1,73,10.428571428571429,5,0.0,7,3,7,1,19,16,4,15,1,18,55,1
6572,88855,XQ3dYwdsUwJ24fnMOalUTaMPlpgBFmZW,fbPkOYLVPtPgIt0MxizjfFJov3JbHyAi,3,0,0,0,0,1,2,0,3,0.42857142857142855,1,0.0,0,0,0,0,0,1,0,2,0,0,3,1
6573,88856,hluzPB1y7zkKLSSzVkJvXfWNLyDAuRho,fbPkOYLVPtPgIt0MxizjfFJov3JbHyAi,9,11,8,0,6,0,3,0,28,4.0,2,0.0,0,8,0,6,11,0,0,3,0,14,14,1
6574,88858,sfQpIAyh1Bl1FfOPcdLy9YBFhdo6RQbA,fbPkOYLVPtPgIt0MxizjfFJov3JbHyAi,2,0,0,0,0,0,4,0,4,0.5714285714285714,1,0.0,0,0,0,0,0,0,0,4,0,0,4,1
6575,88859,JF7rR3pF5cT0hx4XGqF6ShAdIIlqNFHc,fbPkOYLVPtPgIt0MxizjfFJov3JbHyAi,7,3,2,0,2,0,2,0,9,1.2857142857142858,1,0.0,0,2,0,2,3,0,0,2,0,4,5,1
6576,88860,V8o57SeARenbMywXqROBGV5CkdHJLIRM,fbPkOYLVPtPgIt0MxizjfFJov3JbHyAi,3,0,0,0,0,8,4,0,12,1.7142857142857142,1,0.0,0,0,0,0,0,8,0,4,0,0,12,1
6577,89156,vbW1KaPU4HdAU3ExlW7t2Z2lZknONBDo,SpATywNh6bZuzm8s1ceuBUnMUAeoAHHw,1,0,0,0,0,0,1,0,1,0.14285714285714285,1,0.0,0,0,0,0,0,0,0,1,0,0,1,1
6578,89158,4izQXcJwvwmvhdH2eayMFjLqLTND3JLq,SpATywNh6bZuzm8s1ceuBUnMUAeoAHHw,1,0,0,0,0,0,1,0,1,0.14285714285714285,1,0.0,0,0,0,0,0,0,0,1,0,0,1,1
6579,89160,ujTZ8itG5tOi9RBi81LVjGylcfmfscnv,SpATywNh6bZuzm8s1ceuBUnMUAeoAHHw,1,0,0,0,0,0,4,0,4,0.5714285714285714,1,0.0,0,0,0,0,0,0,0,4,0,0,4,1
6580,89176,xe8A48TmWAWrsrOrkKLLF9EL4o5xag4y,SpATywNh6bZuzm8s1ceuBUnMUAeoAHHw,1,0,0,0,0,0,1,0,1,0.14285714285714285,1,0.0,0,0,0,0,0,0,0,1,0,0,1,1
6581,89177,JfoqUtmque7wAjeDp4JXdK1NxfjlSlfN,SpATywNh6bZuzm8s1ceuBUnMUAeoAHHw,1,0,0,0,0,0,1,0,1,0.14285714285714285,1,0.0,0,0,0,0,0,0,0,1,0,0,1,1
6582,89178,mmrzdjNmPvFK53WAh9BwB5yGYUT5HqSe,G8EPVSXsOYB5YQWZGiz1aVq5Pgr2GrQu,1,0,0,0,0,0,1,0,1,0.14285714285714285,1,0.0,0,0,0,0,0,0,0,1,0,0,1,1
6583,89179,byKEl7rjAYN1zOFtYklTCb9GFeYuN4nO,SpATywNh6bZuzm8s1ceuBUnMUAeoAHHw,1,0,0,0,0,0,1,0,1,0.14285714285714285,1,0.0,0,0,0,0,0,0,0,1,0,0,1,1
6584,89180,GWkPEXh9DjC0IZThysIgNjSmYaI9dcS2,G8EPVSXsOYB5YQWZGiz1aVq5Pgr2GrQu,9,2,1,0,1,1,7,1,13,1.8571428571428572,2,0.0,0,1,0,1,2,1,0,7,1,2,11,1
6585,89187,rfOApTbQ4xF2665bHZIBhoJqQcTU6i9L,bWdj2GDclj5ofokWjzoa5jAwMkxCykd6,7,3,2,0,2,0,4,0,11,1.5714285714285714,1,0.0,0,2,0,2,3,0,0,4,0,4,7,1
6586,89189,bJL1sGEdg6Wyh9EeL6PIHUn7Crptl1QG,SpATywNh6bZuzm8s1ceuBUnMUAeoAHHw,2,0,0,0,0,0,2,0,2,0.2857142857142857,1,0.0,0,0,0,0,0,0,0,2,0,0,2,1
6587,89195,htC7O6KmzjLEAd92jccVhN4tDLN92YII,SpATywNh6bZuzm8s1ceuBUnMUAeoAHHw,5,5,0,0,0,0,3,0,8,1.1428571428571428,2,0.0,0,0,0,0,5,0,0,3,0,0,8,1
6588,89205,iHJGDLnoobtpsuLsojTJ7EMK5S6IfRa5,bWdj2GDclj5ofokWjzoa5jAwMkxCykd6,10,7,1,12,2,1,4,0,27,3.857142857142857,1,0.0,1,1,12,2,6,1,0,4,0,16,11,1
6589,89207,Wfpsd6cFXMtD0KyRvLKtWb4mn0MDgPtD,SpATywNh6bZuzm8s1ceuBUnMUAeoAHHw,6,2,0,0,0,2,21,6,31,4.428571428571429,1,0.0,0,0,0,0,2,2,0,21,6,0,31,1
6590,89211,W4anGZ3gUxihb7qbTalaixckN7io0pRJ,RXDvfPUBYFlVdlueBFbLW0mhhAyGEqpt,1,0,0,0,0,0,1,0,1,0.14285714285714285,1,0.0,0,0,0,0,0,0,0,1,0,0,1,1
6591,89213,7ORBOKUOYBR6pt3N4fl6iHTd7mMd3dtL,G8EPVSXsOYB5YQWZGiz1aVq5Pgr2GrQu,5,9,2,0,2,0,2,0,15,2.142857142857143,2,0.0,6,2,0,2,3,0,0,2,0,10,5,1
6592,89216,moK1GdnqoYxhSRCf5a95lgXdVNdzYrjs,bWdj2GDclj5ofokWjzoa5jAwMkxCykd6,6,5,0,0,0,0,9,0,14,2.0,1,0.0,0,0,0,0,5,0,0,9,0,0,14,1
6593,89217,PA2zIjexrl5X42bUhfLaCsans4YmH5zQ,SpATywNh6bZuzm8s1ceuBUnMUAeoAHHw,12,15,5,0,3,2,11,2,38,5.428571428571429,2,0.0,0,5,0,3,15,2,0,11,2,8,30,1
6594,89219,Mqke4gGiYdtmQuFOtXx8ilrWhvfHEVOG,SpATywNh6bZuzm8s1ceuBUnMUAeoAHHw,6,2,1,0,1,1,5,0,10,1.4285714285714286,2,0.0,0,1,0,1,2,1,0,5,0,2,8,1
6595,89222,JmoVlWZppOh9wSlYvcOL4ciU00D3apDg,SpATywNh6bZuzm8s1ceuBUnMUAeoAHHw,3,2,0,0,0,0,4,0,6,0.8571428571428571,1,0.0,0,0,0,0,2,0,0,4,0,0,6,1
6596,89235,d4cb9OZbLbDBqzuhcJemwCaulhBw3XcA,bWdj2GDclj5ofokWjzoa5jAwMkxCykd6,18,19,7,44,7,4,7,0,88,12.571428571428571,1,0.0,10,7,37,7,9,4,7,7,0,61,27,1
6597,89242,hjUSUM6roI2mLGkMAqBjE0uxFRBSMYHJ,bWdj2GDclj5ofokWjzoa5jAwMkxCykd6,6,3,2,0,2,0,1,0,8,1.1428571428571428,1,0.0,0,2,0,2,3,0,0,1,0,4,4,1
6598,89249,YjL44X3XqXhDvKRGkgBLHiV9slzcQZGJ,SpATywNh6bZuzm8s1ceuBUnMUAeoAHHw,3,1,0,0,0,0,2,0,3,0.42857142857142855,1,0.0,0,0,0,0,1,0,0,2,0,0,3,1
6599,89252,gleoXCfE3tA6f5uM3pUTeqQbfFckrfVd,bWdj2GDclj5ofokWjzoa5jAwMkxCykd6,1,0,0,0,0,0,1,0,1,0.14285714285714285,1,0.0,0,0,0,0,0,0,0,1,0,0,1,1
6600,89262,qxQtZuyIzQWGcD008dVh3c4jYjIPrn2L,SpATywNh6bZuzm8s1ceuBUnMUAeoAHHw,3,1,0,0,0,0,2,0,3,0.42857142857142855,1,0.0,0,0,0,0,1,0,0,2,0,0,3,1
6601,89265,Hh6CQ9eQF89j5a5Oi2NUf2uAs2DZd4QT,SpATywNh6bZuzm8s1ceuBUnMUAeoAHHw,11,7,4,0,3,0,6,1,21,3.0,1,0.0,0,4,0,3,7,0,0,6,1,7,14,1
6602,89274,gAYHJa3M8crEnYGtoK5ulJH4EjKveQ23,SpATywNh6bZuzm8s1ceuBUnMUAeoAHHw,6,2,0,0,0,0,5,1,8,1.1428571428571428,1,0.0,0,0,0,0,2,0,0,5,1,0,8,1
6603,89275,PEDczBqLWdyMeFUgqqnQ5UtJeB7qq12O,SpATywNh6bZuzm8s1ceuBUnMUAeoAHHw,5,7,4,0,3,0,3,0,17,2.4285714285714284,1,0.0,0,4,0,3,7,0,0,3,0,7,10,1
6604,89286,pMaElq6QfFkzEK9UpuWlI5Z36ojw0yzC,bWdj2GDclj5ofokWjzoa5jAwMkxCykd6,1,0,0,0,0,0,1,0,1,0.14285714285714285,1,0.0,0,0,0,0,0,0,0,1,0,0,1,1
6605,89289,2Rw9LEKgxnu10TYMueqqEJs507ou3OOr,SpATywNh6bZuzm8s1ceuBUnMUAeoAHHw,5,2,0,0,0,2,5,1,10,1.4285714285714286,1,0.0,0,0,0,0,2,2,0,5,1,0,10,1
6606,89297,JYyHN8axXgpHcSLeMA1wyxGi6GgnqXzc,bWdj2GDclj5ofokWjzoa5jAwMkxCykd6,7,2,1,0,0,3,7,2,15,2.142857142857143,1,0.0,0,1,0,0,2,3,0,7,2,1,14,1
6607,89300,ZKwoFbqxmjGUhMeAwrPlEcEnBfnKdvyQ,SpATywNh6bZuzm8s1ceuBUnMUAeoAHHw,3,2,0,0,0,2,2,0,6,0.8571428571428571,1,0.0,0,0,0,0,2,2,0,2,0,0,6,1
6608,89301,Uk2Y8qj9Cf6T7k2O1cxM5Fue4zKTF1K8,SpATywNh6bZuzm8s1ceuBUnMUAeoAHHw,10,16,6,0,3,3,5,1,34,4.857142857142857,2,0.0,1,6,0,3,15,3,0,5,1,10,24,1
6609,89310,bwyEPRDnWmgwxNZP823jR0R0w9PchQI0,bWdj2GDclj5ofokWjzoa5jAwMkxCykd6,11,12,1,16,3,2,5,1,40,5.714285714285714,1,0.0,7,1,16,3,5,2,0,5,1,27,13,1
6610,89315,z8zMi50azvRwAPUNW2f5Gt0F6WOr8PI9,bWdj2GDclj5ofokWjzoa5jAwMkxCykd6,15,9,3,52,2,1,3,1,71,10.142857142857142,1,0.0,5,3,49,2,4,1,3,3,1,59,12,1
6611,89316,VF14jDCwIzSb92Zq60K5zB8BaUbLT4fN,bWdj2GDclj5ofokWjzoa5jAwMkxCykd6,16,31,3,40,4,9,8,1,96,13.714285714285714,3,0.0,7,3,39,4,24,9,1,8,1,53,43,1
6612,89320,EUrAZ23hcKSgGkr8BcxsusY5VGcq8UzJ,G8EPVSXsOYB5YQWZGiz1aVq5Pgr2GrQu,26,35,0,24,3,11,9,0,82,11.714285714285714,1,0.0,17,0,13,3,18,11,11,9,0,33,49,1
6613,89321,hwob5cfANjyVXpPbIwjR9A4IpD8atc3c,SpATywNh6bZuzm8s1ceuBUnMUAeoAHHw,10,8,7,0,5,0,2,0,22,3.142857142857143,1,0.0,0,7,0,5,8,0,0,2,0,12,10,1
6614,89323,JNtIRj6hnKiaMOhcBlcWRjLc0QwYKSxo,SpATywNh6bZuzm8s1ceuBUnMUAeoAHHw,12,9,2,14,1,0,4,0,30,4.285714285714286,1,0.0,2,2,11,1,7,0,3,4,0,16,14,1
6615,89325,8nDAopmFCIj7DcwdoC4rkmpeCk1s8Zgz,SpATywNh6bZuzm8s1ceuBUnMUAeoAHHw,9,8,4,0,3,1,5,1,22,3.142857142857143,2,0.0,1,4,0,3,7,1,0,5,1,8,14,1
6616,89330,HhEzipYCSzqDHvfYzAIj6GLpNqmUDFFt,SpATywNh6bZuzm8s1ceuBUnMUAeoAHHw,1,0,0,0,0,0,11,0,11,1.5714285714285714,1,0.0,0,0,0,0,0,0,0,11,0,0,11,1
6617,89345,g6IxzfRtoY3ZngcwPaZoK8tEiW61b5Gm,SpATywNh6bZuzm8s1ceuBUnMUAeoAHHw,7,2,1,0,1,0,4,2,10,1.4285714285714286,1,0.0,0,1,0,1,2,0,0,4,2,2,8,1
6618,89347,nRVtG0QK38ehOZE61TsAumXFUUbgiwAK,SpATywNh6bZuzm8s1ceuBUnMUAeoAHHw,5,3,0,0,0,0,3,0,6,0.8571428571428571,1,0.0,0,0,0,0,3,0,0,3,0,0,6,1
6619,89353,RMJqhWaieV03GDbDCUCDtD33fHLxVV5K,SpATywNh6bZuzm8s1ceuBUnMUAeoAHHw,14,12,6,10,3,1,3,1,36,5.142857142857143,1,0.0,5,6,9,3,7,1,1,3,1,23,13,1
6620,89354,PmjzDmD1PFYqpmVaelKXEbwbYfZH0pBp,SpATywNh6bZuzm8s1ceuBUnMUAeoAHHw,5,7,4,0,3,0,1,0,15,2.142857142857143,1,0.0,2,4,0,3,5,0,0,1,0,9,6,1
6621,89356,NpZps0g6tawFjKVlcYqueUROYKEoKNaJ,SpATywNh6bZuzm8s1ceuBUnMUAeoAHHw,4,3,1,0,1,0,1,0,6,0.8571428571428571,1,0.0,0,1,0,1,3,0,0,1,0,2,4,1
6622,89360,ZufvgvpRY93M4np3YlRkSzwkfWq82En4,SpATywNh6bZuzm8s1ceuBUnMUAeoAHHw,6,6,2,0,2,1,4,0,15,2.142857142857143,1,0.0,0,2,0,2,6,1,0,4,0,4,11,1
6623,89363,7oeUnzeChzbfg8iPaEKhVywsWn9pqTw6,SpATywNh6bZuzm8s1ceuBUnMUAeoAHHw,5,2,1,0,1,1,2,0,7,1.0,1,0.0,0,1,0,1,2,1,0,2,0,2,5,1
6624,89364,lXYwudRP8Zl9Z938FMhDttVYfWWJ9atj,RXDvfPUBYFlVdlueBFbLW0mhhAyGEqpt,12,13,6,0,3,3,7,0,32,4.571428571428571,2,0.0,3,6,0,3,10,3,0,7,0,12,20,1
6625,89365,LslskpvRu2kdJKdLBrkhLUwON3Gy18Vo,SpATywNh6bZuzm8s1ceuBUnMUAeoAHHw,7,4,3,0,3,0,4,0,14,2.0,2,0.0,0,3,0,3,4,0,0,4,0,6,8,1
6626,89368,Hut1tgueSKPspzugaIR7MA7bHeQEJ3sN,SpATywNh6bZuzm8s1ceuBUnMUAeoAHHw,11,7,5,0,3,2,5,1,23,3.2857142857142856,1,0.0,0,5,0,3,7,2,0,5,1,8,15,1
6627,89374,WJOBtEN6MBmL5RAy18uZScmCw5QHqH7o,bWdj2GDclj5ofokWjzoa5jAwMkxCykd6,7,9,5,32,1,0,2,0,49,7.0,1,0.0,1,5,31,1,8,0,1,2,0,38,11,1
6628,89376,x7a8xZCwJM4RqKXg6G5neepAYFOs6m5d,SpATywNh6bZuzm8s1ceuBUnMUAeoAHHw,7,3,1,0,1,1,4,1,11,1.5714285714285714,1,0.0,0,1,0,1,3,1,0,4,1,2,9,1
6629,89378,z8zMi50azvRwAPUNW2f5Gt0F6WOr8PI9,SpATywNh6bZuzm8s1ceuBUnMUAeoAHHw,7,6,2,0,1,0,2,0,11,1.5714285714285714,2,0.0,0,2,0,1,6,0,0,2,0,3,8,1
6630,89382,tEjzvvLPWnUBzeg9eUEbSbUDxKXRjQIx,SpATywNh6bZuzm8s1ceuBUnMUAeoAHHw,8,6,1,0,1,3,4,1,16,2.2857142857142856,1,0.0,0,1,0,1,6,3,0,4,1,2,14,1
6631,89384,IE6kqz4SgQ2K5IXq1ddIKWqjAvkWjxXn,SpATywNh6bZuzm8s1ceuBUnMUAeoAHHw,3,0,0,0,0,1,3,0,4,0.5714285714285714,1,0.0,0,0,0,0,0,1,0,3,0,0,4,1
6632,89389,YcgF3ndOhv1gz5wV43GDFwEO3v9Db2WY,SpATywNh6bZuzm8s1ceuBUnMUAeoAHHw,1,0,0,0,0,0,1,0,1,0.14285714285714285,1,0.0,0,0,0,0,0,0,0,1,0,0,1,1
6633,89392,zHLtAdps4GmYQ36wgo6nLPWMewImtEPP,SpATywNh6bZuzm8s1ceuBUnMUAeoAHHw,5,3,1,0,1,0,2,0,7,1.0,1,0.0,0,1,0,1,3,0,0,2,0,2,5,1
6634,89396,6xizGBxRpzCQSAXaR3hwOv1SoAXsZCKh,SpATywNh6bZuzm8s1ceuBUnMUAeoAHHw,7,1,1,0,1,0,7,1,11,1.5714285714285714,1,0.0,0,1,0,1,1,0,0,7,1,2,9,1
6635,89400,21PiP1YhF59KyQpWQkFYKWspSiSWfrA7,SpATywNh6bZuzm8s1ceuBUnMUAeoAHHw,4,2,0,0,0,0,2,0,4,0.5714285714285714,1,0.0,0,0,0,0,2,0,0,2,0,0,4,1
6636,89402,HG2LtxlWFsBhMuK56mWZ91TjbhMLoylz,SpATywNh6bZuzm8s1ceuBUnMUAeoAHHw,12,18,4,15,3,0,2,0,42,6.0,1,0.0,13,4,12,3,5,0,3,2,0,32,10,0
6637,89409,4OTqFMCZxx7r7u5a2qYtSI5NaNF7PvO8,SpATywNh6bZuzm8s1ceuBUnMUAeoAHHw,16,17,5,14,3,3,6,1,49,7.0,2,0.0,8,5,14,3,9,3,0,6,1,30,19,1
6638,89416,X8YK3vveOwnCTAS3rpB58DG3aostwJaj,SpATywNh6bZuzm8s1ceuBUnMUAeoAHHw,5,2,1,0,1,0,2,0,6,0.8571428571428571,1,0.0,0,1,0,1,2,0,0,2,0,2,4,1
6639,89419,s6NTLcoRryN4aDfvO1qsCQXhze6kEfOl,RXDvfPUBYFlVdlueBFbLW0mhhAyGEqpt,5,0,0,0,0,1,4,2,7,1.0,1,0.0,0,0,0,0,0,1,0,4,2,0,7,1
6640,89422,YjEaFn5LTfYqjxB6JXUvw4Xb9oLhK631,SpATywNh6bZuzm8s1ceuBUnMUAeoAHHw,1,0,0,0,0,0,1,0,1,0.14285714285714285,1,0.0,0,0,0,0,0,0,0,1,0,0,1,1
6641,89427,tMCbE9iM7KBcWjBabYSS51NRc5mnYleA,SpATywNh6bZuzm8s1ceuBUnMUAeoAHHw,4,3,1,0,1,0,1,0,6,0.8571428571428571,1,0.0,0,1,0,1,3,0,0,1,0,2,4,1
6642,89428,7rCsWwNSyvtkrQ3mC6RRhvkE6QVhgAZs,bWdj2GDclj5ofokWjzoa5jAwMkxCykd6,2,0,0,0,0,0,2,0,2,0.2857142857142857,1,0.0,0,0,0,0,0,0,0,2,0,0,2,1
6643,89429,2lYbk0XOrmGdaeqlfLI5dUfAHuZ6yPBA,SpATywNh6bZuzm8s1ceuBUnMUAeoAHHw,2,0,0,0,0,0,2,0,2,0.2857142857142857,1,0.0,0,0,0,0,0,0,0,2,0,0,2,1
6644,89431,nYSFDE8RCbcZhD46fRSvPHUvA1ahfupi,RXDvfPUBYFlVdlueBFbLW0mhhAyGEqpt,16,17,6,0,4,2,4,0,33,4.714285714285714,2,0.0,0,6,0,4,17,2,0,4,0,10,23,1
6645,89434,w60ThqGBllezQkIxCXQKmVVjrEAbCB3o,SpATywNh6bZuzm8s1ceuBUnMUAeoAHHw,13,12,8,0,4,1,11,1,37,5.285714285714286,1,0.0,1,8,0,4,11,1,0,11,1,13,24,1
6646,89435,mXql2iQ0u9MrfhDk3EyQfVgmOA6PfBP6,SpATywNh6bZuzm8s1ceuBUnMUAeoAHHw,9,5,4,0,3,0,3,1,16,2.2857142857142856,1,0.0,0,4,0,3,5,0,0,3,1,7,9,1
6647,89437,JaihKxZ9pTOfses6LZRLDOjCYawYvRFT,SpATywNh6bZuzm8s1ceuBUnMUAeoAHHw,15,14,2,6,1,1,6,1,31,4.428571428571429,1,0.0,6,2,6,1,8,1,0,6,1,15,16,1
6648,89438,KogrHROquIJLSXIZqzhYU9Hcb9zVebwT,bWdj2GDclj5ofokWjzoa5jAwMkxCykd6,12,15,8,38,2,7,8,1,79,11.285714285714286,1,0.0,1,8,37,2,14,7,1,8,1,48,31,1
6649,89439,GmpxJ8O1By2XxJiRtr729hGN3Vo5Le6z,SpATywNh6bZuzm8s1ceuBUnMUAeoAHHw,7,3,0,0,0,0,5,1,9,1.2857142857142858,1,0.0,1,0,0,0,2,0,0,5,1,1,8,1
6650,89445,QB10zfXuA41QjD5k4oKWFSxMld8hOlzr,SpATywNh6bZuzm8s1ceuBUnMUAeoAHHw,5,10,1,0,1,0,1,0,13,1.8571428571428572,1,0.0,0,1,0,1,10,0,0,1,0,2,11,1
6651,89447,reyLh94O0G9Sps1AWVf0MNOYDY3UabsF,bWdj2GDclj5ofokWjzoa5jAwMkxCykd6,1,0,0,0,0,0,1,0,1,0.14285714285714285,1,0.0,0,0,0,0,0,0,0,1,0,0,1,1
6652,89464,k7IDe0FSSJNcEAsxSZDCYYdSJ9TEDema,SpATywNh6bZuzm8s1ceuBUnMUAeoAHHw,5,2,1,0,1,0,2,0,6,0.8571428571428571,1,0.0,0,1,0,1,2,0,0,2,0,2,4,1
6653,89470,vEKYOhRdGZ59kfXY6wTO63YZY4EqPYqX,RXDvfPUBYFlVdlueBFbLW0mhhAyGEqpt,8,4,3,0,2,0,2,0,11,1.5714285714285714,1,0.0,0,3,0,2,4,0,0,2,0,5,6,1
6654,89472,hA0qeCFHNAYT25Zfkgax8xO422WWYXAI,SpATywNh6bZuzm8s1ceuBUnMUAeoAHHw,9,7,0,0,0,6,5,0,18,2.5714285714285716,1,0.0,1,0,0,0,6,6,0,5,0,1,17,1
6655,89481,KUppVPuFnFs0vLCUrPJOIfquMy1mUooq,SpATywNh6bZuzm8s1ceuBUnMUAeoAHHw,3,2,1,0,0,0,1,0,4,0.5714285714285714,1,0.0,0,1,0,0,2,0,0,1,0,1,3,1
6656,89484,tWsedvadboRaUvtnR4XHAbkrBvCaHSP7,SpATywNh6bZuzm8s1ceuBUnMUAeoAHHw,5,2,1,0,1,0,2,0,6,0.8571428571428571,1,0.0,0,1,0,1,2,0,0,2,0,2,4,1
6657,89486,ALqQPup1pnpnyRPY8Wn9arGTMiZcUqbO,SpATywNh6bZuzm8s1ceuBUnMUAeoAHHw,12,7,0,3,0,2,6,0,18,2.5714285714285716,1,0.0,2,0,3,0,5,2,0,6,0,5,13,1
6658,89487,C4jo9SMfYZ7U2XGeGdDn52kX4eeoqM99,bWdj2GDclj5ofokWjzoa5jAwMkxCykd6,13,17,0,36,0,1,7,0,61,8.714285714285714,3,0.0,4,0,30,0,13,1,6,7,0,34,27,1
6659,89493,KMupQNOY5AUo1OSHinupraqdnIAkZaUk,SpATywNh6bZuzm8s1ceuBUnMUAeoAHHw,11,8,5,0,3,2,3,0,21,3.0,1,0.0,2,5,0,3,6,2,0,3,0,10,11,0
6660,89496,9HuS6eeLBJKMWQs5fuvJufNrciBPiV4Z,SpATywNh6bZuzm8s1ceuBUnMUAeoAHHw,14,16,9,4,5,0,6,3,43,6.142857142857143,2,0.0,1,9,4,5,15,0,0,6,3,19,24,1
6661,89497,DoqTCfzI1BFXttxyeA3RWI5TOmYLp0hg,SpATywNh6bZuzm8s1ceuBUnMUAeoAHHw,6,5,0,0,0,1,6,1,13,1.8571428571428572,2,0.0,0,0,0,0,5,1,0,6,1,0,13,1
6662,89501,iIVb1PSNqRo7ycAAOFHU9Md1pZ0vCsoL,RXDvfPUBYFlVdlueBFbLW0mhhAyGEqpt,10,7,4,0,2,8,6,1,28,4.0,2,0.0,0,4,0,2,7,8,0,6,1,6,22,1
6663,89502,mR9Awu9GGhq6cpZDsN1vhsOMBBjHJTwu,SpATywNh6bZuzm8s1ceuBUnMUAeoAHHw,2,0,0,0,0,0,2,0,2,0.2857142857142857,1,0.0,0,0,0,0,0,0,0,2,0,0,2,1
6664,89504,g8m22R7W0Wo8v9RXY0TMbj5qf5RFgvht,SpATywNh6bZuzm8s1ceuBUnMUAeoAHHw,7,12,9,0,5,0,5,0,31,4.428571428571429,3,0.0,0,9,0,5,12,0,0,5,0,14,17,1
6665,89508,IK3hKesiTuTek37MSwSLzKRB4SC1WHUB,RXDvfPUBYFlVdlueBFbLW0mhhAyGEqpt,8,2,2,0,2,12,6,0,24,3.4285714285714284,1,0.0,0,2,0,2,2,12,0,6,0,4,20,1
6666,89510,HlbAiahvOwKnLbpNJlRLXObPS8VUYp1d,SpATywNh6bZuzm8s1ceuBUnMUAeoAHHw,4,4,2,0,2,0,2,0,10,1.4285714285714286,1,0.0,0,2,0,2,4,0,0,2,0,4,6,1
6667,89523,uufMRz1rjLB5PHuvCFtrRWUteDYIyLB4,SpATywNh6bZuzm8s1ceuBUnMUAeoAHHw,7,10,4,0,4,0,8,0,26,3.7142857142857144,5,0.0,1,4,0,4,9,0,0,8,0,9,17,1
6668,89528,UUMX1CmSolRdRWNSlMStbZ6MtOKuPj1e,bWdj2GDclj5ofokWjzoa5jAwMkxCykd6,6,4,1,0,1,0,4,0,10,1.4285714285714286,2,0.0,0,1,0,1,4,0,0,4,0,2,8,0
6669,89530,wIoFAWs9LgckZlTBThLS4htxmELqPsaS,SpATywNh6bZuzm8s1ceuBUnMUAeoAHHw,2,0,0,0,0,0,2,0,2,0.2857142857142857,1,0.0,0,0,0,0,0,0,0,2,0,0,2,1
6670,89537,KMupQNOY5AUo1OSHinupraqdnIAkZaUk,bWdj2GDclj5ofokWjzoa5jAwMkxCykd6,5,2,1,0,1,2,2,0,8,1.1428571428571428,1,0.0,0,1,0,1,2,2,0,2,0,2,6,1
6671,89545,gbYUHxxKDGWDbytDUcXlcbADJemufrHf,bWdj2GDclj5ofokWjzoa5jAwMkxCykd6,1,0,0,0,0,0,1,0,1,0.14285714285714285,1,0.0,0,0,0,0,0,0,0,1,0,0,1,1
6672,89547,yiyWtvIUUgzCTrQ1w4vh6W1sUUxvDdmd,G8EPVSXsOYB5YQWZGiz1aVq5Pgr2GrQu,19,33,11,6,7,0,8,1,66,9.428571428571429,3,0.0,9,11,3,7,24,0,3,8,1,30,36,1
6673,89554,ywVRX55s8qrIIZjyxsYaBHsGW40qS7zt,SpATywNh6bZuzm8s1ceuBUnMUAeoAHHw,8,5,2,5,1,0,2,0,15,2.142857142857143,1,0.0,1,2,4,1,4,0,1,2,0,8,7,1
6674,89558,s4xNNQ4RZ35amMfmvZawsu7u8CabnIey,bWdj2GDclj5ofokWjzoa5jAwMkxCykd6,13,14,8,0,7,1,8,1,39,5.571428571428571,1,0.0,2,8,0,7,12,1,0,8,1,17,22,1
6675,89559,0wpgF8T87E4lIPjqoh0AkxyomANfbalw,bWdj2GDclj5ofokWjzoa5jAwMkxCykd6,6,4,2,0,2,0,1,0,9,1.2857142857142858,1,0.0,1,2,0,2,3,0,0,1,0,5,4,1
6676,89564,CywE8FKIbY3F3QxzorcpvAYCApeOH4J5,SpATywNh6bZuzm8s1ceuBUnMUAeoAHHw,17,33,16,26,7,6,10,1,99,14.142857142857142,3,0.0,8,16,20,7,25,6,6,10,1,51,48,1
6677,89573,EJIkk1z1GAyTxouBU8smmsjhIBwzBhn1,bWdj2GDclj5ofokWjzoa5jAwMkxCykd6,5,2,0,0,0,1,6,0,9,1.2857142857142858,1,0.0,0,0,0,0,2,1,0,6,0,0,9,1
6678,89582,IVRKzAf1gWN5ButpaPiczzsxf6iD5MK8,SpATywNh6bZuzm8s1ceuBUnMUAeoAHHw,29,46,25,15,12,3,18,0,119,17.0,5,0.0,12,25,15,12,34,3,0,18,0,64,55,0
6679,89585,YyGQMZcaxlC6XILTwFAL9ZoWRvDQm7bN,SpATywNh6bZuzm8s1ceuBUnMUAeoAHHw,15,8,4,17,3,111,7,1,151,21.571428571428573,1,0.0,3,4,14,3,5,111,3,7,1,24,127,1
6680,89586,Ici19IlriqXgCDQhlI7Y7CIAQZwpQKlL,SpATywNh6bZuzm8s1ceuBUnMUAeoAHHw,6,2,1,0,1,0,3,0,7,1.0,1,0.0,0,1,0,1,2,0,0,3,0,2,5,1
6681,89594,8lejIyIXg2PoIErIyQIUo4voWGcEGVK1,SpATywNh6bZuzm8s1ceuBUnMUAeoAHHw,14,25,9,19,3,1,3,0,60,8.571428571428571,1,0.0,6,9,16,3,19,1,3,3,0,34,26,1
6682,89596,xfVSAJmUsFwMX0mM4lQFC1xlBJimN3Sw,SpATywNh6bZuzm8s1ceuBUnMUAeoAHHw,1,0,0,0,0,0,1,0,1,0.14285714285714285,1,0.0,0,0,0,0,0,0,0,1,0,0,1,1
6683,89600,JV9PrSM2vjuxfGaaWBES6jKK96YmYbtj,SpATywNh6bZuzm8s1ceuBUnMUAeoAHHw,13,11,4,16,3,1,2,0,37,5.285714285714286,1,0.0,6,4,16,3,5,1,0,2,0,29,8,1
6684,89605,f3LgSSewSBsudoWmIigH2aapqGCxH8CK,SpATywNh6bZuzm8s1ceuBUnMUAeoAHHw,8,6,2,8,0,0,4,0,20,2.857142857142857,3,0.0,1,2,7,0,5,0,1,4,0,10,10,0
6685,89606,QUiyBd2SaZz1OhTujJnVJUzpOWStKB8O,SpATywNh6bZuzm8s1ceuBUnMUAeoAHHw,11,14,7,0,2,2,10,0,35,5.0,2,0.0,3,7,0,2,11,2,0,10,0,12,23,1
6686,89611,oD0FQQV2wqYt3501tltDa6pobGqWwl0U,SpATywNh6bZuzm8s1ceuBUnMUAeoAHHw,2,0,0,0,0,0,2,0,2,0.2857142857142857,1,0.0,0,0,0,0,0,0,0,2,0,0,2,1
6687,89613,TrrLeSGbjOK3szupk5Bxq1KXuDNAsaBR,RXDvfPUBYFlVdlueBFbLW0mhhAyGEqpt,4,0,0,0,0,4,5,0,9,1.2857142857142858,1,0.0,0,0,0,0,0,4,0,5,0,0,9,1
6688,89614,v2d7e1ThXhvKY81XABSzKd6OtFeJV4cC,bWdj2GDclj5ofokWjzoa5jAwMkxCykd6,16,23,8,44,6,0,5,0,86,12.285714285714286,2,0.0,10,8,38,6,13,0,6,5,0,62,24,1
6689,89615,0Dihh52qSGvY4VErU5EvQUZatVGQEN7V,G8EPVSXsOYB5YQWZGiz1aVq5Pgr2GrQu,2,0,0,0,0,0,2,0,2,0.2857142857142857,1,0.0,0,0,0,0,0,0,0,2,0,0,2,1
6690,89629,yd5TT5oOy4dFZZMQ0jlppRbBYPk2zugf,RXDvfPUBYFlVdlueBFbLW0mhhAyGEqpt,34,40,26,34,12,29,15,4,160,22.857142857142858,3,0.0,6,26,31,12,34,29,3,15,4,75,85,1
6691,89632,fGUxtqzvs60cjlG1FT6OPrGFHTQ3arMq,SpATywNh6bZuzm8s1ceuBUnMUAeoAHHw,9,9,4,0,2,0,3,0,18,2.5714285714285716,2,0.0,0,4,0,2,9,0,0,3,0,6,12,1
6692,89633,NecHXZoXWlSlvFR2HUgkuO9YtJstZDyP,SpATywNh6bZuzm8s1ceuBUnMUAeoAHHw,2,0,0,0,0,0,3,0,3,0.42857142857142855,1,0.0,0,0,0,0,0,0,0,3,0,0,3,1
6693,89635,q0VUQjNPG110NUbSYiiAeb8QmfsAGRIl,bWdj2GDclj5ofokWjzoa5jAwMkxCykd6,2,0,0,0,0,0,2,0,2,0.2857142857142857,1,0.0,0,0,0,0,0,0,0,2,0,0,2,1
6694,89637,9FULiZu6qUnuIs2MyDSoVO8NHl3dw8Ao,SpATywNh6bZuzm8s1ceuBUnMUAeoAHHw,27,53,6,26,2,16,17,3,123,17.571428571428573,5,0.0,10,6,26,2,43,16,0,17,3,44,79,1
6695,89639,NecHXZoXWlSlvFR2HUgkuO9YtJstZDyP,G8EPVSXsOYB5YQWZGiz1aVq5Pgr2GrQu,1,0,0,0,0,0,1,0,1,0.14285714285714285,1,0.0,0,0,0,0,0,0,0,1,0,0,1,1
6696,89640,4rTxfdVJbNfbAtIV373iaao2aWX8Xwpx,bWdj2GDclj5ofokWjzoa5jAwMkxCykd6,11,16,4,0,3,1,10,1,35,5.0,1,0.0,2,4,0,3,14,1,0,10,1,9,26,1
6697,89642,tZzxdl7066iNcnLGeU4cT9rDUqFLgEBx,SpATywNh6bZuzm8s1ceuBUnMUAeoAHHw,5,2,1,0,1,0,2,0,6,0.8571428571428571,1,0.0,0,1,0,1,2,0,0,2,0,2,4,0
6698,89646,JEelEWgHt6PkTjt88tREqKMfbXr9CA9f,SpATywNh6bZuzm8s1ceuBUnMUAeoAHHw,5,3,1,0,1,0,2,0,7,1.0,1,0.0,0,1,0,1,3,0,0,2,0,2,5,1
6699,89648,et0FwkFflO62QJKGJwzwDqACodcSRV2v,SpATywNh6bZuzm8s1ceuBUnMUAeoAHHw,15,42,18,7,10,0,6,0,83,11.857142857142858,3,0.0,11,18,7,10,31,0,0,6,0,46,37,1
6700,89651,4qM7n65VbCTp8lq3dbzhDmImmEZcwgn8,bWdj2GDclj5ofokWjzoa5jAwMkxCykd6,7,8,3,0,2,0,3,0,16,2.2857142857142856,3,0.0,0,3,0,2,8,0,0,3,0,5,11,1
6701,89652,g8m22R7W0Wo8v9RXY0TMbj5qf5RFgvht,G8EPVSXsOYB5YQWZGiz1aVq5Pgr2GrQu,8,5,3,0,2,0,5,0,15,2.142857142857143,2,0.0,0,3,0,2,5,0,0,5,0,5,10,1
6702,89654,q0VUQjNPG110NUbSYiiAeb8QmfsAGRIl,SpATywNh6bZuzm8s1ceuBUnMUAeoAHHw,5,2,1,0,1,0,2,0,6,0.8571428571428571,1,0.0,0,1,0,1,2,0,0,2,0,2,4,1
6703,89657,d1q0By7DZyiPLgwuG8hyGXtu0NW1hfAc,SpATywNh6bZuzm8s1ceuBUnMUAeoAHHw,8,12,6,0,3,0,4,0,25,3.5714285714285716,2,0.0,0,6,0,3,12,0,0,4,0,9,16,1
6704,89660,gGywHgGU1Kdw7XJcqMzinsJnpz7uSgex,SpATywNh6bZuzm8s1ceuBUnMUAeoAHHw,3,2,0,0,0,0,2,0,4,0.5714285714285714,1,0.0,0,0,0,0,2,0,0,2,0,0,4,1
6705,89663,7plKTmv3RnLOGLbgKBn60EIAr1uLnnPW,SpATywNh6bZuzm8s1ceuBUnMUAeoAHHw,2,0,0,0,0,0,3,0,3,0.42857142857142855,1,0.0,0,0,0,0,0,0,0,3,0,0,3,1
6706,89665,7plKTmv3RnLOGLbgKBn60EIAr1uLnnPW,G8EPVSXsOYB5YQWZGiz1aVq5Pgr2GrQu,2,0,0,0,0,0,7,0,7,1.0,1,0.0,0,0,0,0,0,0,0,7,0,0,7,1
6707,89667,4ZJIc9fpxQVSj3UgQJHtkAvW8OVkOdgO,SpATywNh6bZuzm8s1ceuBUnMUAeoAHHw,1,0,0,0,0,0,1,0,1,0.14285714285714285,1,0.0,0,0,0,0,0,0,0,1,0,0,1,1
6708,89669,tmmvczbZLiPw6t5Ru9DTWRYnvMI3hKxN,G8EPVSXsOYB5YQWZGiz1aVq5Pgr2GrQu,8,8,5,0,3,0,4,0,20,2.857142857142857,2,0.0,0,5,0,3,8,0,0,4,0,8,12,1
6709,89672,Sqgk0iqdEQnGHvbbLSikGrUMP9U33RaR,SpATywNh6bZuzm8s1ceuBUnMUAeoAHHw,1,0,0,0,0,0,1,0,1,0.14285714285714285,1,0.0,0,0,0,0,0,0,0,1,0,0,1,1
6710,89682,VCrlTy1l4SI8aDl63osChvBColRWsjDv,bWdj2GDclj5ofokWjzoa5jAwMkxCykd6,4,2,1,0,1,6,2,0,12,1.7142857142857142,1,0.0,0,1,0,1,2,6,0,2,0,2,10,1
6711,89685,hAdLjCwSiW0mQdl44dFfRTVxdDqDmjKC,SpATywNh6bZuzm8s1ceuBUnMUAeoAHHw,7,4,3,0,1,0,2,0,10,1.4285714285714286,1,0.0,0,3,0,1,4,0,0,2,0,4,6,1
6712,89691,iADIVtxyoQg4RtIKmWkz3YbJ1msvN2b8,G8EPVSXsOYB5YQWZGiz1aVq5Pgr2GrQu,28,26,14,38,9,0,3,0,90,12.857142857142858,1,0.0,8,14,38,9,18,0,0,3,0,69,21,1
6713,89697,i4fgy4BVHlpEBMVrUkI9gWLihOonqgFN,SpATywNh6bZuzm8s1ceuBUnMUAeoAHHw,8,9,5,0,2,0,6,0,22,3.142857142857143,2,0.0,0,5,0,2,9,0,0,6,0,7,15,1
6714,89700,5c8lpFjwt7A1RG96ZJudxhytTaQ1Rdi3,SpATywNh6bZuzm8s1ceuBUnMUAeoAHHw,9,4,3,0,2,0,3,0,12,1.7142857142857142,1,0.0,0,3,0,2,4,0,0,3,0,5,7,1
6715,89704,EFvdBUP19hneCSDaGOnsFiBemnNxo1wC,SpATywNh6bZuzm8s1ceuBUnMUAeoAHHw,5,2,0,0,0,3,4,0,9,1.2857142857142858,1,0.0,0,0,0,0,2,3,0,4,0,0,9,1
6716,89716,34wvjhwjZXp59iVLK73uLxzWNB5SDXqZ,SpATywNh6bZuzm8s1ceuBUnMUAeoAHHw,1,0,0,0,0,0,1,0,1,0.14285714285714285,1,0.0,0,0,0,0,0,0,0,1,0,0,1,1
6717,89718,gJUEUQ7J006sORAArhI6J8FkT7xUEHkB,SpATywNh6bZuzm8s1ceuBUnMUAeoAHHw,27,42,13,34,4,7,8,1,109,15.571428571428571,3,0.0,10,13,30,4,32,7,4,8,1,57,52,1
6718,89721,Y1k7olzlKnbC2gLcfIeH2MYAVraORisd,SpATywNh6bZuzm8s1ceuBUnMUAeoAHHw,7,3,2,0,2,0,2,0,9,1.2857142857142858,1,0.0,0,2,0,2,3,0,0,2,0,4,5,1
6719,89727,8yrIKDtnkYcLfERwrXrvcRGxHxbt2Jd3,bWdj2GDclj5ofokWjzoa5jAwMkxCykd6,5,5,2,0,1,0,4,0,12,1.7142857142857142,1,0.0,0,2,0,1,5,0,0,4,0,3,9,1
6720,89728,XzytXRsbdOwF87AfAw5uPYzo1dbeIXdh,SpATywNh6bZuzm8s1ceuBUnMUAeoAHHw,11,10,8,0,2,1,6,1,28,4.0,1,0.0,0,8,0,2,10,1,0,6,1,10,18,1
6721,89730,lVnMpRF2pBRLkh9CfasNC1eZi18lrTad,G8EPVSXsOYB5YQWZGiz1aVq5Pgr2GrQu,7,4,3,0,3,0,2,0,12,1.7142857142857142,1,0.0,0,3,0,3,4,0,0,2,0,6,6,1
6722,89735,DBl87nF6WTgoCD6kgTHVE2oB45pDEn6y,RXDvfPUBYFlVdlueBFbLW0mhhAyGEqpt,10,8,4,0,2,0,2,0,16,2.2857142857142856,1,0.0,0,4,0,2,8,0,0,2,0,6,10,1
6723,89736,bRDMid9iRGcartTY4OAKAdQRbX2j8Y86,SpATywNh6bZuzm8s1ceuBUnMUAeoAHHw,5,2,1,0,1,0,2,0,6,0.8571428571428571,1,0.0,0,1,0,1,2,0,0,2,0,2,4,1
6724,89737,Fa7tOqP1WKllvNDMgvUWmTzPr8J8vhy8,bWdj2GDclj5ofokWjzoa5jAwMkxCykd6,4,2,1,0,0,0,3,0,6,0.8571428571428571,1,0.0,0,1,0,0,2,0,0,3,0,1,5,1
6725,89741,4TxI4qNPs1w5xlNJ8vKBNEb6bFI5MoVU,SpATywNh6bZuzm8s1ceuBUnMUAeoAHHw,3,2,0,0,0,0,1,0,3,0.42857142857142855,1,0.0,0,0,0,0,2,0,0,1,0,0,3,1
6726,89750,wpQN3hnHZvt8MtT7VRAs9ZQvlWkphaGS,SpATywNh6bZuzm8s1ceuBUnMUAeoAHHw,7,3,2,0,2,0,2,0,9,1.2857142857142858,1,0.0,0,2,0,2,3,0,0,2,0,4,5,1
6727,89752,bRDMid9iRGcartTY4OAKAdQRbX2j8Y86,G8EPVSXsOYB5YQWZGiz1aVq5Pgr2GrQu,2,0,0,0,0,0,2,0,2,0.2857142857142857,1,0.0,0,0,0,0,0,0,0,2,0,0,2,1
6728,89753,k3RqfBgQWTtiyEyw3fqGDGa48Oo6Lcuo,SpATywNh6bZuzm8s1ceuBUnMUAeoAHHw,2,0,0,0,0,0,3,0,3,0.42857142857142855,1,0.0,0,0,0,0,0,0,0,3,0,0,3,1
6729,89764,Ur5YqRaNsaD6KYfRfGA2p4Zmd8kpRITc,SpATywNh6bZuzm8s1ceuBUnMUAeoAHHw,26,41,20,16,7,8,13,0,105,15.0,6,0.0,12,20,16,7,29,8,0,13,0,55,50,0
6730,89766,36BAYEapI76Mtxquz6BRxAoc9Y27dWFZ,G8EPVSXsOYB5YQWZGiz1aVq5Pgr2GrQu,10,20,4,0,5,0,2,0,31,4.428571428571429,1,0.0,11,4,0,5,9,0,0,2,0,20,11,1
6731,89767,4geFTA2SGlVqwe93iNEDI1Zg55VMGaYi,SpATywNh6bZuzm8s1ceuBUnMUAeoAHHw,9,15,7,0,2,1,6,0,31,4.428571428571429,1,0.0,1,7,0,2,14,1,0,6,0,10,21,1
6732,89788,jH123vWnpYTVLfmuSyled9Oau0AYvcx6,SpATywNh6bZuzm8s1ceuBUnMUAeoAHHw,14,12,1,18,0,4,6,1,42,6.0,1,0.0,4,1,14,0,8,4,4,6,1,19,23,1
6733,89792,TvO9et6FKUYNWGTC0Lu8cSO0dysynadE,SpATywNh6bZuzm8s1ceuBUnMUAeoAHHw,13,21,1,18,0,2,10,0,52,7.428571428571429,1,0.0,6,1,15,0,15,2,3,10,0,22,30,1
6734,89796,TNaXEhaNWX9mct0CT7Pun5pZ6GW6ngCc,SpATywNh6bZuzm8s1ceuBUnMUAeoAHHw,1,0,0,0,0,0,1,0,1,0.14285714285714285,1,0.0,0,0,0,0,0,0,0,1,0,0,1,1
6735,89799,eaeORohb7wCQL9JM2uz3yah8DgLbswAx,SpATywNh6bZuzm8s1ceuBUnMUAeoAHHw,7,3,2,0,2,25,3,0,35,5.0,1,0.0,0,2,0,2,3,25,0,3,0,4,31,1
6736,89806,55eRUKhAgZ6jAG2QNlk8p8bxI8Mo1ci4,bWdj2GDclj5ofokWjzoa5jAwMkxCykd6,4,2,1,0,1,0,1,0,5,0.7142857142857143,1,0.0,0,1,0,1,2,0,0,1,0,2,3,1
6737,89810,ZGj94V0W2CVzOroBBKkby4OcuobYFXw5,SpATywNh6bZuzm8s1ceuBUnMUAeoAHHw,1,0,0,0,0,0,1,0,1,0.14285714285714285,1,0.0,0,0,0,0,0,0,0,1,0,0,1,1
6738,89814,HOOY7gv2DgQRhkoQeNGOHVNWen0BTC1i,SpATywNh6bZuzm8s1ceuBUnMUAeoAHHw,1,0,0,0,0,0,1,0,1,0.14285714285714285,1,0.0,0,0,0,0,0,0,0,1,0,0,1,1
6739,89816,KDx4Tzovot56yH25Hp8Dvz0vvUPU9kNc,RXDvfPUBYFlVdlueBFbLW0mhhAyGEqpt,13,8,0,0,0,3,7,1,19,2.7142857142857144,1,0.0,0,0,0,0,8,3,0,7,1,0,19,1
6740,89818,UD9YcWI16E6My1ERXiW1sP1n2okAaM6v,bWdj2GDclj5ofokWjzoa5jAwMkxCykd6,1,0,0,0,0,0,1,0,1,0.14285714285714285,1,0.0,0,0,0,0,0,0,0,1,0,0,1,1
6741,89822,9aAr0eFSVkxwTSV4wzEfwp33zeuW9SSs,bWdj2GDclj5ofokWjzoa5jAwMkxCykd6,17,20,5,44,4,0,5,0,78,11.142857142857142,2,0.0,4,5,42,4,16,0,2,5,0,55,23,1
6742,89824,JXDuo0HNKJSjtiXj27sPUY7beWRK43na,SpATywNh6bZuzm8s1ceuBUnMUAeoAHHw,9,3,1,0,2,1,11,2,20,2.857142857142857,1,0.0,0,1,0,2,3,1,0,11,2,3,17,1
6743,89829,sfmDw8Mu24TwJAISRGKb3tkGixPCex4a,SpATywNh6bZuzm8s1ceuBUnMUAeoAHHw,17,40,16,12,7,18,10,1,104,14.857142857142858,2,0.0,6,16,9,7,34,18,3,10,1,38,66,1
6744,89838,ZV56LNPqAGNtVEuE1uQTYk5rPuhQg5k4,bWdj2GDclj5ofokWjzoa5jAwMkxCykd6,2,0,0,0,0,0,3,0,3,0.42857142857142855,1,0.0,0,0,0,0,0,0,0,3,0,0,3,1
6745,89844,ijg95u2jQVjnyTNM7ClS8Oj92hwAA9nz,SpATywNh6bZuzm8s1ceuBUnMUAeoAHHw,8,2,1,0,1,0,5,1,10,1.4285714285714286,1,0.0,0,1,0,1,2,0,0,5,1,2,8,1
6746,89845,yirkVFAFnnxTIzPISxnqlF6vNcZ5Qb6v,SpATywNh6bZuzm8s1ceuBUnMUAeoAHHw,4,2,1,0,0,0,2,0,5,0.7142857142857143,1,0.0,0,1,0,0,2,0,0,2,0,1,4,1
6747,89865,3z5ETakafkt4JzUHVZc8EGa6ySJrNrZy,SpATywNh6bZuzm8s1ceuBUnMUAeoAHHw,5,2,1,0,1,0,2,0,6,0.8571428571428571,1,0.0,0,1,0,1,2,0,0,2,0,2,4,1
6748,89889,esqI93l6FZECayExObEEu4vBjC7wOeKE,SpATywNh6bZuzm8s1ceuBUnMUAeoAHHw,7,2,2,0,2,0,2,0,8,1.1428571428571428,1,0.0,0,2,0,2,2,0,0,2,0,4,4,1
6749,89890,IXH7oZyCKGgxdh9kwUS5VD9TLaoLggU5,SpATywNh6bZuzm8s1ceuBUnMUAeoAHHw,7,3,2,0,2,0,2,0,9,1.2857142857142858,1,0.0,0,2,0,2,3,0,0,2,0,4,5,1
6750,89893,HAAyQYNYY3ULmqhNC56bxv5FSwyMVoqP,SpATywNh6bZuzm8s1ceuBUnMUAeoAHHw,11,28,5,10,0,1,11,0,55,7.857142857142857,4,0.0,9,5,9,0,19,1,1,11,0,23,32,1
6751,89897,HAAyQYNYY3ULmqhNC56bxv5FSwyMVoqP,bWdj2GDclj5ofokWjzoa5jAwMkxCykd6,4,13,6,0,0,0,7,0,26,3.7142857142857144,4,0.0,0,6,0,0,13,0,0,7,0,6,20,1
6752,89899,uI2C8kZvxXShkoacauA0S9izMW2oRB2R,RXDvfPUBYFlVdlueBFbLW0mhhAyGEqpt,71,49,28,154,15,10,13,1,270,38.57142857142857,4,0.0,14,28,144,15,35,10,10,13,1,201,69,1
6753,89901,YiHBZRMHXXOxz07e5dCrboCIm1oQ0OKy,RXDvfPUBYFlVdlueBFbLW0mhhAyGEqpt,16,17,12,0,6,7,10,0,52,7.428571428571429,1,0.0,0,12,0,6,17,7,0,10,0,18,34,1
6754,89906,mMv5ULasJWNphOEtfj5B5HTtZYfxsB3G,SpATywNh6bZuzm8s1ceuBUnMUAeoAHHw,2,0,0,0,0,0,2,0,2,0.2857142857142857,1,0.0,0,0,0,0,0,0,0,2,0,0,2,1
6755,89910,qngZFTemZ9VNe5bU9mST85frjoIJ7IAD,RXDvfPUBYFlVdlueBFbLW0mhhAyGEqpt,5,2,1,0,1,0,2,0,6,0.8571428571428571,1,0.0,0,1,0,1,2,0,0,2,0,2,4,1
6756,89913,zlNlEcmlViJgBUG0ywxJEPhI6SYvToC0,SpATywNh6bZuzm8s1ceuBUnMUAeoAHHw,1,0,0,0,0,0,1,0,1,0.14285714285714285,1,0.0,0,0,0,0,0,0,0,1,0,0,1,1
6757,89917,Jr0Xqt1ZmxzSzD15wla9BChmcIeBBK4Z,G8EPVSXsOYB5YQWZGiz1aVq5Pgr2GrQu,9,4,0,0,0,3,7,1,15,2.142857142857143,1,0.0,0,0,0,0,4,3,0,7,1,0,15,1
6758,89923,ysO1bg2EIYdeVFkxhwuOr9gves820gWk,RXDvfPUBYFlVdlueBFbLW0mhhAyGEqpt,6,4,1,0,0,0,3,1,9,1.2857142857142858,1,0.0,0,1,0,0,4,0,0,3,1,1,8,1
6759,89935,Cvsz0UZNQwRp1mBIzDah4d0DHCa0q2WK,SpATywNh6bZuzm8s1ceuBUnMUAeoAHHw,1,0,0,0,0,0,1,0,1,0.14285714285714285,1,0.0,0,0,0,0,0,0,0,1,0,0,1,1
6760,89937,Lb6PKJrTzwsQYsITlNu0wfDvL4DmKZCj,RXDvfPUBYFlVdlueBFbLW0mhhAyGEqpt,4,2,1,0,1,0,1,0,5,0.7142857142857143,1,0.0,0,1,0,1,2,0,0,1,0,2,3,1
6761,89948,TtmytGkYhNaL4UmbxQBMSixlcCRjb9lD,SpATywNh6bZuzm8s1ceuBUnMUAeoAHHw,7,8,1,0,0,6,5,0,20,2.857142857142857,1,0.0,0,1,0,0,8,6,0,5,0,1,19,1
6762,89956,myYQGnE7AuDkDAMs5wvSchGGtMiBR3qG,RXDvfPUBYFlVdlueBFbLW0mhhAyGEqpt,6,4,0,0,0,2,5,0,11,1.5714285714285714,1,0.0,0,0,0,0,4,2,0,5,0,0,11,0
6763,89957,0q9MKOQI6izUm7JGi2QEuKfgyApDxosK,SpATywNh6bZuzm8s1ceuBUnMUAeoAHHw,2,0,0,0,0,0,2,0,2,0.2857142857142857,1,0.0,0,0,0,0,0,0,0,2,0,0,2,1
6764,89967,db8Cy33Nc9oRQhsghT9mZ7YJUbZnnH0B,SpATywNh6bZuzm8s1ceuBUnMUAeoAHHw,5,2,1,0,1,0,2,0,6,0.8571428571428571,1,0.0,0,1,0,1,2,0,0,2,0,2,4,1
6765,89968,KjHvjBsSgp7lqvkYLAjrQHS8ZrdrlLzv,SpATywNh6bZuzm8s1ceuBUnMUAeoAHHw,11,9,7,7,5,1,2,0,31,4.428571428571429,1,0.0,1,7,6,5,8,1,1,2,0,19,12,1
6766,89969,frAGxLKbgrgCbr9YXoqzdmgtbJjUbBNJ,G8EPVSXsOYB5YQWZGiz1aVq5Pgr2GrQu,5,8,1,0,2,1,2,0,14,2.0,1,0.0,6,1,0,2,2,1,0,2,0,9,5,1
6767,89971,DpB3NoJLarAGiHUaBV6zvSP8bR0qw4yk,RXDvfPUBYFlVdlueBFbLW0mhhAyGEqpt,23,17,15,0,11,0,3,0,46,6.571428571428571,3,0.0,0,15,0,11,17,0,0,3,0,26,20,1
6768,89984,HCLrpFC2S5L0Y8JmZewW8gsgYgpEkXeP,SpATywNh6bZuzm8s1ceuBUnMUAeoAHHw,14,12,5,24,3,0,6,0,50,7.142857142857143,2,0.0,4,5,19,3,8,0,5,6,0,31,19,1
6769,89987,8QIwRllpGKgpURtcmS5hWJ0AInSKESf0,RXDvfPUBYFlVdlueBFbLW0mhhAyGEqpt,6,2,1,0,1,0,3,0,7,1.0,1,0.0,0,1,0,1,2,0,0,3,0,2,5,1
6770,89994,zvOHbaUWjxRZ9zCYxYPMcUH4Ef5dE8Ae,G8EPVSXsOYB5YQWZGiz1aVq5Pgr2GrQu,9,6,2,0,2,0,9,0,19,2.7142857142857144,3,0.0,0,2,0,2,6,0,0,9,0,4,15,1
6771,90000,xFi8956jLKPkTqTiwrHbFAm2iOTFidYP,SpATywNh6bZuzm8s1ceuBUnMUAeoAHHw,1,0,0,0,0,0,2,0,2,0.2857142857142857,1,0.0,0,0,0,0,0,0,0,2,0,0,2,1
6772,90008,aM04j8B80UycNpLiy2mFNdgBiaLCgDBx,SpATywNh6bZuzm8s1ceuBUnMUAeoAHHw,5,2,1,0,1,0,4,0,8,1.1428571428571428,1,0.0,0,1,0,1,2,0,0,4,0,2,6,1
6773,90011,KbVIZwe7S3MOh9dlFVWDZwSpf3zNL2tv,SpATywNh6bZuzm8s1ceuBUnMUAeoAHHw,5,4,2,0,1,0,1,0,8,1.1428571428571428,1,0.0,0,2,0,1,4,0,0,1,0,3,5,1
6774,90014,ZDrt6zlGm4y4ur5AWVSG62RV3VJJ5cJS,SpATywNh6bZuzm8s1ceuBUnMUAeoAHHw,6,3,2,0,1,7,3,0,16,2.2857142857142856,1,0.0,0,2,0,1,3,7,0,3,0,3,13,1
6775,90021,bjoQsxzy5xWbIlWJOK88FLxI1KzCehRN,SpATywNh6bZuzm8s1ceuBUnMUAeoAHHw,3,2,0,0,0,0,1,0,3,0.42857142857142855,1,0.0,0,0,0,0,2,0,0,1,0,0,3,1
6776,90023,OMrBHOtDkdk4Zxba42NamuOWH8Ss9fWW,bWdj2GDclj5ofokWjzoa5jAwMkxCykd6,2,0,0,0,0,0,2,0,2,0.2857142857142857,1,0.0,0,0,0,0,0,0,0,2,0,0,2,1
6777,90030,rQT5JCDNn9UQwRKU1wpR7NGmcTvEHfxS,bWdj2GDclj5ofokWjzoa5jAwMkxCykd6,5,2,1,0,1,0,5,0,9,1.2857142857142858,1,0.0,0,1,0,1,2,0,0,5,0,2,7,1
6778,90034,YCpaFH59BZea33ilZmurVIrcGKs7kkSW,SpATywNh6bZuzm8s1ceuBUnMUAeoAHHw,1,0,0,0,0,0,1,0,1,0.14285714285714285,1,0.0,0,0,0,0,0,0,0,1,0,0,1,1
6779,90041,JaLvdj0QPGLA6QlwJ3N2oF66NiYZ7XSV,bWdj2GDclj5ofokWjzoa5jAwMkxCykd6,39,68,38,86,17,114,23,5,351,50.142857142857146,5,0.0,7,38,71,17,61,114,15,23,5,133,218,0
6780,90047,b31D3oEzHUylsy39VKOzq1naz39PNLwH,G8EPVSXsOYB5YQWZGiz1aVq5Pgr2GrQu,41,58,25,54,8,3,23,1,172,24.571428571428573,3,0.0,21,25,34,8,37,3,20,23,1,88,84,1
6781,90052,ggntZRuHqDckUtFC9TYtfF8K09iXYWES,SpATywNh6bZuzm8s1ceuBUnMUAeoAHHw,5,3,0,0,0,0,6,0,9,1.2857142857142858,2,0.0,0,0,0,0,3,0,0,6,0,0,9,1
6782,90055,kGkU7DU5zOC0IQHNRlo6r0rouCnUfi6R,RXDvfPUBYFlVdlueBFbLW0mhhAyGEqpt,24,30,14,17,9,3,15,1,89,12.714285714285714,3,0.0,5,14,16,9,25,3,1,15,1,44,45,1
6783,90063,Vn131dD12fh0kapodbBhio0q4dV4IYmG,bWdj2GDclj5ofokWjzoa5jAwMkxCykd6,4,2,1,0,1,0,1,0,5,0.7142857142857143,1,0.0,0,1,0,1,2,0,0,1,0,2,3,1
6784,90067,6e1wovvtDhnhxwqREzmRRei4eIEEGraW,bWdj2GDclj5ofokWjzoa5jAwMkxCykd6,8,6,4,0,3,0,7,1,21,3.0,1,0.0,0,4,0,3,6,0,0,7,1,7,14,1
6785,90076,QhIEGvYTYkDhEyimLONTXmJHONpcq43g,SpATywNh6bZuzm8s1ceuBUnMUAeoAHHw,1,0,0,0,0,0,1,0,1,0.14285714285714285,1,0.0,0,0,0,0,0,0,0,1,0,0,1,1
6786,90085,JYzVKgw0yfgKYwKodhquOfGRUiHh1739,SpATywNh6bZuzm8s1ceuBUnMUAeoAHHw,4,2,0,0,0,0,2,0,4,0.5714285714285714,1,0.0,0,0,0,0,2,0,0,2,0,0,4,1
6787,90087,6Xt9XL14E8rzUiRHbQmDyc0T0uWOhD5k,SpATywNh6bZuzm8s1ceuBUnMUAeoAHHw,5,4,1,0,1,0,2,0,8,1.1428571428571428,1,0.0,0,1,0,1,4,0,0,2,0,2,6,1
6788,90088,lzm9dP9Q32i0nrdz5KGk9vngMJk6H38J,SpATywNh6bZuzm8s1ceuBUnMUAeoAHHw,7,9,3,0,2,0,5,0,19,2.7142857142857144,2,0.0,1,3,0,2,8,0,0,5,0,6,13,1
6789,90090,srF76iHf3IXwkM0p0daLjk1LYx1sO9QO,bWdj2GDclj5ofokWjzoa5jAwMkxCykd6,1,0,0,0,0,0,1,0,1,0.14285714285714285,1,0.0,0,0,0,0,0,0,0,1,0,0,1,1
6790,90094,TYu8VgV6TkJO1pWVABdfXnpa6VWQUK0O,RXDvfPUBYFlVdlueBFbLW0mhhAyGEqpt,20,13,9,27,5,0,3,0,57,8.142857142857142,2,0.0,2,9,27,5,11,0,0,3,0,43,14,1
6791,90097,ilWzYGLWBh9DSc1MV8g2C4Go5wDNgUHX,bWdj2GDclj5ofokWjzoa5jAwMkxCykd6,9,6,3,6,1,8,3,0,27,3.857142857142857,2,0.0,1,3,6,1,5,8,0,3,0,11,16,1
6792,90103,faywX8b5OPf8lgTBqNfgsgut6a2kmqN4,SpATywNh6bZuzm8s1ceuBUnMUAeoAHHw,6,3,2,0,2,0,1,0,8,1.1428571428571428,1,0.0,0,2,0,2,3,0,0,1,0,4,4,1
6793,90117,MjWnBfKyq3bKCwHG0ZVIL5hXZR3ku4f4,SpATywNh6bZuzm8s1ceuBUnMUAeoAHHw,12,8,5,0,3,0,8,1,25,3.5714285714285716,1,0.0,0,5,0,3,8,0,0,8,1,8,17,1
6794,90120,jDBqOswp4ojFI0uystVaz1714DhGWBFe,SpATywNh6bZuzm8s1ceuBUnMUAeoAHHw,6,4,3,0,2,0,2,2,13,1.8571428571428572,1,0.0,0,3,0,2,4,0,0,2,2,5,8,1
6795,90131,bTJkfLPF7pQ1o12jyPBjkkHpxb8ACgm5,bWdj2GDclj5ofokWjzoa5jAwMkxCykd6,1,0,0,0,0,0,1,0,1,0.14285714285714285,1,0.0,0,0,0,0,0,0,0,1,0,0,1,1
6796,90135,bTJkfLPF7pQ1o12jyPBjkkHpxb8ACgm5,SpATywNh6bZuzm8s1ceuBUnMUAeoAHHw,4,2,1,0,1,0,1,0,5,0.7142857142857143,1,0.0,0,1,0,1,2,0,0,1,0,2,3,1
6797,90136,bMIS6W7sngWZiZpkuSg6XOmdfsq88CgB,bWdj2GDclj5ofokWjzoa5jAwMkxCykd6,9,13,6,126,7,0,2,0,154,22.0,1,0.0,6,6,125,7,7,0,1,2,0,144,10,1
6798,90138,Eg9TEdaEeaxICrLXGeMPzp6XOtJtw2iA,SpATywNh6bZuzm8s1ceuBUnMUAeoAHHw,6,1,1,0,1,0,5,0,8,1.1428571428571428,1,0.0,0,1,0,1,1,0,0,5,0,2,6,1
6799,90139,6ev6a6dpwen0GstMqDij5DO55YCNj8wV,SpATywNh6bZuzm8s1ceuBUnMUAeoAHHw,10,10,5,0,3,7,8,1,34,4.857142857142857,1,0.0,0,5,0,3,10,7,0,8,1,8,26,1
6800,90155,U7btMcQ825kheRskgLUndnBUWWFj60BC,G8EPVSXsOYB5YQWZGiz1aVq5Pgr2GrQu,2,0,0,0,0,0,3,0,3,0.42857142857142855,1,0.0,0,0,0,0,0,0,0,3,0,0,3,1
6801,90160,Q7rqeL75J4PJeAuNXiXhCR5dry9rPsv1,G8EPVSXsOYB5YQWZGiz1aVq5Pgr2GrQu,14,24,9,4,8,1,7,1,54,7.714285714285714,1,0.0,13,9,3,8,11,1,1,7,1,33,21,1
6802,90172,ktsGX0WguDDY6I5ilK51sxzTMtoxdwY2,G8EPVSXsOYB5YQWZGiz1aVq5Pgr2GrQu,5,2,1,0,1,0,4,0,8,1.1428571428571428,2,0.0,0,1,0,1,2,0,0,4,0,2,6,1
6803,90176,TM0zAsul1XLjJRFtspexc3sccxHTiW3v,SpATywNh6bZuzm8s1ceuBUnMUAeoAHHw,2,0,0,0,0,0,2,0,2,0.2857142857142857,1,0.0,0,0,0,0,0,0,0,2,0,0,2,0
6804,90177,ihuUuFaDeVBULP8Ogmzz18gVO9cBzlOD,RXDvfPUBYFlVdlueBFbLW0mhhAyGEqpt,3,0,0,0,0,2,2,0,4,0.5714285714285714,1,0.0,0,0,0,0,0,2,0,2,0,0,4,1
6805,90180,7ibtd0r1yxMhjpaNZCtEirkOcSqUBCGN,RXDvfPUBYFlVdlueBFbLW0mhhAyGEqpt,13,11,5,14,5,0,1,0,36,5.142857142857143,1,0.0,5,5,12,5,6,0,2,1,0,27,9,0
6806,90183,SYRx2sSX9LDLLUNNibf5r7JJQePy5BRh,G8EPVSXsOYB5YQWZGiz1aVq5Pgr2GrQu,27,47,2,48,0,1,12,1,111,15.857142857142858,2,0.0,19,2,35,0,28,1,13,12,1,56,55,1
6807,90184,7zAZJQJmdmR0Q9agHk9B0faabzdMeTDx,G8EPVSXsOYB5YQWZGiz1aVq5Pgr2GrQu,4,5,2,0,2,0,1,0,10,1.4285714285714286,1,0.0,2,2,0,2,3,0,0,1,0,6,4,1
6808,90189,64SFa5QYw3OYdZffw8ZxPKmPdz675qex,G8EPVSXsOYB5YQWZGiz1aVq5Pgr2GrQu,6,3,2,0,2,0,1,0,8,1.1428571428571428,1,0.0,0,2,0,2,3,0,0,1,0,4,4,1
6809,90192,uybm0Sdpts5PrhQW2nyBVnFfiT9zAmh4,G8EPVSXsOYB5YQWZGiz1aVq5Pgr2GrQu,8,9,1,8,1,0,3,0,22,3.142857142857143,1,0.0,2,1,6,1,7,0,2,3,0,10,12,0
6810,90199,loDNGhsCc1OXWM5CF3rme5wzdyMcOTJj,RXDvfPUBYFlVdlueBFbLW0mhhAyGEqpt,26,19,9,0,7,1,9,4,49,7.0,2,0.0,1,9,0,7,18,1,0,9,4,17,32,1
6811,90214,LfZmAYW4GITnFlauWgCvKzPoi1bCqPgK,bWdj2GDclj5ofokWjzoa5jAwMkxCykd6,12,13,4,4,5,0,6,0,32,4.571428571428571,2,0.0,4,4,4,5,9,0,0,6,0,17,15,1
6812,90215,GxfzvZIYYQ6Ai51iUnspJ06bhY10jacX,SpATywNh6bZuzm8s1ceuBUnMUAeoAHHw,17,20,9,18,5,0,8,1,61,8.714285714285714,2,0.0,3,9,15,5,17,0,3,8,1,32,29,1
6813,90219,feANl8pQvsJtkNIIOWO1qX8ND4VT9Cj4,G8EPVSXsOYB5YQWZGiz1aVq5Pgr2GrQu,4,2,1,0,1,0,1,0,5,0.7142857142857143,1,0.0,0,1,0,1,2,0,0,1,0,2,3,1
6814,90223,LRnQOt7NsdMcAvm0GOPse3zkFSQ0mVYI,SpATywNh6bZuzm8s1ceuBUnMUAeoAHHw,5,2,1,0,1,0,2,0,6,0.8571428571428571,1,0.0,0,1,0,1,2,0,0,2,0,2,4,1
6815,90224,S0OJjF6aof0iTnIX6lUAxekoH3m4w7V0,RXDvfPUBYFlVdlueBFbLW0mhhAyGEqpt,18,13,10,29,7,0,1,0,60,8.571428571428571,1,0.0,2,10,23,7,11,0,6,1,0,42,18,1
6816,90233,mXvtIKY9ZnAQyKjdLyySIxbvTtoP8Weq,G8EPVSXsOYB5YQWZGiz1aVq5Pgr2GrQu,5,2,1,0,1,0,3,0,7,1.0,1,0.0,0,1,0,1,2,0,0,3,0,2,5,1
6817,90235,pONYaLTf3U8GoaNpbS0j1PZ1GhOmkS7N,SpATywNh6bZuzm8s1ceuBUnMUAeoAHHw,14,17,6,14,4,1,3,0,45,6.428571428571429,1,0.0,10,6,14,4,7,1,0,3,0,34,11,1
6818,90244,DU0dRtEpZksA4ySXAez5UVn9g5rHoTAA,SpATywNh6bZuzm8s1ceuBUnMUAeoAHHw,8,22,11,0,3,0,3,0,39,5.571428571428571,2,0.0,8,11,0,3,14,0,0,3,0,22,17,1
6819,90248,b0xM3piMaIC7gCFYyxqHoITel9oKF6YW,bWdj2GDclj5ofokWjzoa5jAwMkxCykd6,9,5,1,26,1,2,4,1,40,5.714285714285714,1,0.0,2,1,25,1,3,2,1,4,1,29,11,1
6820,90249,RDTdhSHGbxVSFCWLWYH4XRafyz4IOkLm,SpATywNh6bZuzm8s1ceuBUnMUAeoAHHw,7,6,2,0,1,1,4,0,14,2.0,2,0.0,0,2,0,1,6,1,0,4,0,3,11,1
6821,90250,Cb5KBNxKLciN7IuFLNM0hPSrkcjzkoDX,SpATywNh6bZuzm8s1ceuBUnMUAeoAHHw,7,2,1,0,1,0,3,0,7,1.0,1,0.0,0,1,0,1,2,0,0,3,0,2,5,1
6822,90251,GMTEjCyWbqfKfP4EXN5ReJJtqfdXmmTA,RXDvfPUBYFlVdlueBFbLW0mhhAyGEqpt,2,0,0,0,0,0,2,0,2,0.2857142857142857,1,0.0,0,0,0,0,0,0,0,2,0,0,2,1
6823,90253,5a7fehAo0Ol3kwHzhNqAYRGEzPLIE5FD,bWdj2GDclj5ofokWjzoa5jAwMkxCykd6,6,9,5,0,1,0,7,0,22,3.142857142857143,3,0.0,0,5,0,1,9,0,0,7,0,6,16,1
6824,90256,JHLmQKNX4G6HmeBY0Psd6kgnv0WEcPsm,SpATywNh6bZuzm8s1ceuBUnMUAeoAHHw,7,4,1,0,1,0,6,0,12,1.7142857142857142,1,0.0,0,1,0,1,4,0,0,6,0,2,10,1
6825,90258,tQrXZ3EDIEf1hKQdGJOaurgPvqncjvEA,bWdj2GDclj5ofokWjzoa5jAwMkxCykd6,3,2,0,0,0,0,2,0,4,0.5714285714285714,1,0.0,0,0,0,0,2,0,0,2,0,0,4,1
6826,90260,zykAfhTnSrdYpElmeo66SyCzw5nw6JVn,bWdj2GDclj5ofokWjzoa5jAwMkxCykd6,7,12,7,0,3,0,6,0,28,4.0,1,0.0,0,7,0,3,12,0,0,6,0,10,18,1
6827,90263,QmJXKs57BF6o936ZGaQIMEt20JYrSdAW,G8EPVSXsOYB5YQWZGiz1aVq5Pgr2GrQu,4,27,1,4,2,0,1,0,35,5.0,1,0.0,23,1,3,2,4,0,1,1,0,29,6,1
6828,90266,n0HFF3TwqKuBMzzkdLCbvb8Mji5ZUnVX,SpATywNh6bZuzm8s1ceuBUnMUAeoAHHw,7,9,6,0,4,0,3,0,22,3.142857142857143,3,0.0,0,6,0,4,9,0,0,3,0,10,12,1
6829,90270,521YJDVy6G9ul5QyLTUZAuztPLpe7gqW,G8EPVSXsOYB5YQWZGiz1aVq5Pgr2GrQu,11,14,4,0,2,1,10,1,32,4.571428571428571,1,0.0,2,4,0,2,12,1,0,10,1,8,24,1
6830,90272,s41hWh3vMIIfQQVEuM6UwEzfhfcM1JZA,SpATywNh6bZuzm8s1ceuBUnMUAeoAHHw,5,2,1,0,1,0,2,0,6,0.8571428571428571,1,0.0,0,1,0,1,2,0,0,2,0,2,4,1
6831,90278,bweLZE6WiefKMb8vrgzlIS50q4xPrbd3,G8EPVSXsOYB5YQWZGiz1aVq5Pgr2GrQu,8,8,2,2,2,0,2,0,16,2.2857142857142856,2,0.0,3,2,2,2,5,0,0,2,0,9,7,1
6832,90279,Ewm3oAfqxDgJQMFbDpAkGPAjCut5zQSX,SpATywNh6bZuzm8s1ceuBUnMUAeoAHHw,1,0,0,0,0,0,1,0,1,0.14285714285714285,1,0.0,0,0,0,0,0,0,0,1,0,0,1,1
6833,90280,jwRuJMKgg5MQLF9v6u6v92ntnY2avB7X,SpATywNh6bZuzm8s1ceuBUnMUAeoAHHw,7,3,2,0,2,0,4,0,11,1.5714285714285714,1,0.0,0,2,0,2,3,0,0,4,0,4,7,1
6834,90285,v4laioBlEPXkN50wQCoVv0p0aRfPHa4S,G8EPVSXsOYB5YQWZGiz1aVq5Pgr2GrQu,1,0,0,0,0,0,1,0,1,0.14285714285714285,1,0.0,0,0,0,0,0,0,0,1,0,0,1,1
6835,90286,0nJUVE3hT3v1fqbd9NpHDszm9KS6NNTn,G8EPVSXsOYB5YQWZGiz1aVq5Pgr2GrQu,6,1,1,0,1,0,3,0,6,0.8571428571428571,1,0.0,0,1,0,1,1,0,0,3,0,2,4,1
6836,90289,n5gAmeJZl36AzaSKV2dfNY3RvYF0IYqr,SpATywNh6bZuzm8s1ceuBUnMUAeoAHHw,5,3,1,0,1,0,2,0,7,1.0,1,0.0,1,1,0,1,2,0,0,2,0,3,4,1
6837,90290,264OEiaYNcFYG5J7N6NDOp3G0CBJqdMF,SpATywNh6bZuzm8s1ceuBUnMUAeoAHHw,2,0,0,0,0,0,3,0,3,0.42857142857142855,1,0.0,0,0,0,0,0,0,0,3,0,0,3,1
6838,90294,juZ453F4cmwgObiaW1ClMKkoi0EGrafR,G8EPVSXsOYB5YQWZGiz1aVq5Pgr2GrQu,4,2,0,0,0,1,2,0,5,0.7142857142857143,1,0.0,0,0,0,0,2,1,0,2,0,0,5,1
6839,90305,Sy1NUS22p5IcvKggpod61sUWNUSyXtbs,G8EPVSXsOYB5YQWZGiz1aVq5Pgr2GrQu,19,29,11,0,8,0,7,0,55,7.857142857142857,4,0.0,8,11,0,8,21,0,0,7,0,27,28,0
6840,90306,cwnwk7sVo9oHpSkUPDdu8wUE4KBTJLBj,bWdj2GDclj5ofokWjzoa5jAwMkxCykd6,1,0,0,0,0,0,1,0,1,0.14285714285714285,1,0.0,0,0,0,0,0,0,0,1,0,0,1,1
6841,90321,NlgFEWO87VQbCzq3S6FQjH7bzvdUhuql,RXDvfPUBYFlVdlueBFbLW0mhhAyGEqpt,1,0,0,0,0,0,1,0,1,0.14285714285714285,1,0.0,0,0,0,0,0,0,0,1,0,0,1,1
6842,90326,J1iCM60eAwVKTPRoP9hdyFlEQf6db3YF,SpATywNh6bZuzm8s1ceuBUnMUAeoAHHw,13,10,6,6,4,4,3,0,33,4.714285714285714,1,0.0,2,6,6,4,8,4,0,3,0,18,15,1
6843,90337,AImQCDhN4bmgLgB3jm3FHzAq0G1rwIiv,SpATywNh6bZuzm8s1ceuBUnMUAeoAHHw,5,2,1,0,1,0,2,0,6,0.8571428571428571,1,0.0,0,1,0,1,2,0,0,2,0,2,4,1
6844,90343,jl79Z6TfXd4YLzsAQwSCeo1eMaF6Ha8d,bWdj2GDclj5ofokWjzoa5jAwMkxCykd6,13,14,1,0,2,11,19,4,51,7.285714285714286,2,0.0,2,1,0,2,12,11,0,19,4,5,46,1
6845,90348,VDscv2ylkQ5hVjxSl7FzkFmJDmBcIaMr,bWdj2GDclj5ofokWjzoa5jAwMkxCykd6,11,8,3,18,1,0,14,1,45,6.428571428571429,4,0.0,1,3,18,1,7,0,0,14,1,23,22,1
6846,90349,F6I7OSqjE137AeaYIX9MEazl6a7Noplf,SpATywNh6bZuzm8s1ceuBUnMUAeoAHHw,7,4,0,0,0,0,4,0,8,1.1428571428571428,1,0.0,0,0,0,0,4,0,0,4,0,0,8,1
6847,90351,vSAp2k0hR5TAgTxUO6r2EVSaLCqePHP4,SpATywNh6bZuzm8s1ceuBUnMUAeoAHHw,4,2,1,0,1,0,1,0,5,0.7142857142857143,1,0.0,0,1,0,1,2,0,0,1,0,2,3,1
6848,90354,x3sZblYMoUvQJbk7l9GY688n7RQqaQct,bWdj2GDclj5ofokWjzoa5jAwMkxCykd6,5,5,1,0,1,0,2,0,9,1.2857142857142858,1,0.0,0,1,0,1,5,0,0,2,0,2,7,1
6849,90355,D7Evkt9LkM9awqCB4mL7Tk75xiGKRcNK,RXDvfPUBYFlVdlueBFbLW0mhhAyGEqpt,1,0,0,0,0,0,1,0,1,0.14285714285714285,1,0.0,0,0,0,0,0,0,0,1,0,0,1,1
6850,90356,ublyxWXAJoR0ltzxB8gmTQ7Y4SFlWnZM,G8EPVSXsOYB5YQWZGiz1aVq5Pgr2GrQu,10,23,0,6,1,0,5,1,36,5.142857142857143,2,0.0,14,0,5,1,9,0,1,5,1,20,16,1
6851,90358,JnnoDII6jIRoAG8myf8F5d0DS0vEB9se,bWdj2GDclj5ofokWjzoa5jAwMkxCykd6,3,0,0,0,0,4,2,0,6,0.8571428571428571,1,0.0,0,0,0,0,0,4,0,2,0,0,6,1
6852,90359,6ryFJ2ZF3YGC7hqGJv2IswdyAnxH8nhB,G8EPVSXsOYB5YQWZGiz1aVq5Pgr2GrQu,5,2,1,0,1,0,7,0,11,1.5714285714285714,1,0.0,0,1,0,1,2,0,0,7,0,2,9,1
6853,90369,BBJ3vKTyvStRa10Tpfc6k0oOhgY721Pq,bWdj2GDclj5ofokWjzoa5jAwMkxCykd6,7,5,3,0,2,0,5,1,16,2.2857142857142856,1,0.0,0,3,0,2,5,0,0,5,1,5,11,1
6854,90372,4GMbKnTV7f2uA3paM09GNAdyVnypDTbs,RXDvfPUBYFlVdlueBFbLW0mhhAyGEqpt,8,2,2,0,2,0,8,0,14,2.0,1,0.0,0,2,0,2,2,0,0,8,0,4,10,1
6855,90374,FGJeYJZQGTs7gi3lnr6EovN6yJTo7ibM,G8EPVSXsOYB5YQWZGiz1aVq5Pgr2GrQu,20,8,6,22,3,1,7,1,48,6.857142857142857,1,0.0,0,6,17,3,8,1,5,7,1,26,22,1
6856,90376,BBJ3vKTyvStRa10Tpfc6k0oOhgY721Pq,RXDvfPUBYFlVdlueBFbLW0mhhAyGEqpt,1,0,0,0,0,0,1,0,1,0.14285714285714285,1,0.0,0,0,0,0,0,0,0,1,0,0,1,1
6857,90377,2sT7ojsC1w02fAwhcaRLBrXcss5IOsOK,bWdj2GDclj5ofokWjzoa5jAwMkxCykd6,5,2,1,0,1,0,2,0,6,0.8571428571428571,1,0.0,0,1,0,1,2,0,0,2,0,2,4,1
6858,90381,JnnoDII6jIRoAG8myf8F5d0DS0vEB9se,RXDvfPUBYFlVdlueBFbLW0mhhAyGEqpt,1,0,0,0,0,0,1,0,1,0.14285714285714285,1,0.0,0,0,0,0,0,0,0,1,0,0,1,1
6859,90382,JnnoDII6jIRoAG8myf8F5d0DS0vEB9se,G8EPVSXsOYB5YQWZGiz1aVq5Pgr2GrQu,1,0,0,0,0,0,1,0,1,0.14285714285714285,1,0.0,0,0,0,0,0,0,0,1,0,0,1,1
6860,90389,UdVAw5urwjLmc9uIJ3uWZ6MzY9bq82FD,bWdj2GDclj5ofokWjzoa5jAwMkxCykd6,5,11,1,18,0,5,1,0,36,5.142857142857143,1,0.0,6,1,16,0,5,5,2,1,0,23,13,1
6861,90391,wyK0UoS83lDT8utSJzcLSlSEzOTr7cFo,SpATywNh6bZuzm8s1ceuBUnMUAeoAHHw,4,0,0,0,0,0,4,0,4,0.5714285714285714,1,0.0,0,0,0,0,0,0,0,4,0,0,4,1
6862,90399,Gq0WW1vBA55n1msrepMKrg3TKn8N6yfT,bWdj2GDclj5ofokWjzoa5jAwMkxCykd6,16,21,1,48,2,0,6,0,78,11.142857142857142,2,0.0,10,1,47,2,11,0,1,6,0,60,18,1
6863,90404,5o9h0u1MdREnKa1ru9UVL61wcNO9zJkv,bWdj2GDclj5ofokWjzoa5jAwMkxCykd6,6,15,3,0,1,0,9,0,28,4.0,1,0.0,0,3,0,1,15,0,0,9,0,4,24,1
6864,90408,C6mvlVLzmlNXh4kv8CeERDr2P2W5lqpV,SpATywNh6bZuzm8s1ceuBUnMUAeoAHHw,7,2,0,0,0,2,7,1,12,1.7142857142857142,1,0.0,0,0,0,0,2,2,0,7,1,0,12,1
6865,90416,4tsGZRMByIyec9WCveltaBAT6TVvi6KF,RXDvfPUBYFlVdlueBFbLW0mhhAyGEqpt,9,6,2,26,3,0,1,0,38,5.428571428571429,1,0.0,2,2,20,3,4,0,6,1,0,27,11,1
6866,90418,fBvSAwv6uc40UeqRCaejhOfI13E4tjda,SpATywNh6bZuzm8s1ceuBUnMUAeoAHHw,6,12,3,0,1,0,4,0,20,2.857142857142857,2,0.0,3,3,0,1,9,0,0,4,0,7,13,1
6867,90422,rwjIOQWge6ogv55EFnUadvoZ473wCxPF,SpATywNh6bZuzm8s1ceuBUnMUAeoAHHw,2,0,0,0,0,0,3,0,3,0.42857142857142855,1,0.0,0,0,0,0,0,0,0,3,0,0,3,1
6868,90425,lcgsmC4BQDYDnzCO5vs1TCdTPnBbRaGt,SpATywNh6bZuzm8s1ceuBUnMUAeoAHHw,13,31,0,22,0,9,10,2,74,10.571428571428571,1,0.0,10,0,18,0,21,9,4,10,2,28,46,1
6869,90429,NnJUzVJQXS15uc1WVncpFgpFT3Jtm38y,bWdj2GDclj5ofokWjzoa5jAwMkxCykd6,4,2,1,0,1,0,1,0,5,0.7142857142857143,1,0.0,0,1,0,1,2,0,0,1,0,2,3,1
6870,90432,PCdtFg5aq768xRAGHCfQQy2MLmWOvvld,bWdj2GDclj5ofokWjzoa5jAwMkxCykd6,5,5,3,0,0,0,3,0,11,1.5714285714285714,2,0.0,0,3,0,0,5,0,0,3,0,3,8,1
6871,90435,ohlMhSWqKWmqC7u03UQO1YoFekI6xVAy,RXDvfPUBYFlVdlueBFbLW0mhhAyGEqpt,9,4,1,0,1,2,11,1,20,2.857142857142857,1,0.0,0,1,0,1,4,2,0,11,1,2,18,1
6872,90445,NvpLHMRFxJk2eR30iYl189WOkyZeEnSd,RXDvfPUBYFlVdlueBFbLW0mhhAyGEqpt,4,3,0,0,0,0,1,0,4,0.5714285714285714,1,0.0,0,0,0,0,3,0,0,1,0,0,4,1
6873,90446,FcIMQNoo2B9wNij30W0t3SsuF1pzZCFp,G8EPVSXsOYB5YQWZGiz1aVq5Pgr2GrQu,6,2,1,0,0,0,6,0,9,1.2857142857142858,1,0.0,0,1,0,0,2,0,0,6,0,1,8,1
6874,90448,8spZJm18FAAt0jkb5fLlQ7lVR80rIhqU,SpATywNh6bZuzm8s1ceuBUnMUAeoAHHw,9,8,2,0,1,4,13,3,31,4.428571428571429,2,0.0,0,2,0,1,8,4,0,13,3,3,28,1
6875,90449,MoVymwbcHW0CbhTCwXgAq4UFuaXFCEM8,SpATywNh6bZuzm8s1ceuBUnMUAeoAHHw,5,3,0,0,0,0,2,0,5,0.7142857142857143,1,0.0,0,0,0,0,3,0,0,2,0,0,5,1
6876,90450,K0GvqkFX0mEPCK9WbHThj3iwTwuWgCZz,G8EPVSXsOYB5YQWZGiz1aVq5Pgr2GrQu,83,118,49,230,6,19,18,2,442,63.142857142857146,1,0.0,55,49,171,6,63,19,59,18,2,281,161,1
6877,90451,gbhKUd7BJXTZpVcoQvBpKT3bqB9VoWlp,SpATywNh6bZuzm8s1ceuBUnMUAeoAHHw,4,2,1,0,1,0,1,0,5,0.7142857142857143,1,0.0,0,1,0,1,2,0,0,1,0,2,3,1
6878,90455,loPn0Qajy87SoektWTbVxEkxp7hmTtzk,SpATywNh6bZuzm8s1ceuBUnMUAeoAHHw,1,0,0,0,0,0,1,0,1,0.14285714285714285,1,0.0,0,0,0,0,0,0,0,1,0,0,1,1
6879,90456,ejWSFSNW1jOTCFDROUQkAUS6uY6mX6CR,bWdj2GDclj5ofokWjzoa5jAwMkxCykd6,4,2,1,0,1,0,1,0,5,0.7142857142857143,1,0.0,0,1,0,1,2,0,0,1,0,2,3,1
6880,90468,D0SRTJhzsGGnKbIKtAcGeOVG46CDAXxq,bWdj2GDclj5ofokWjzoa5jAwMkxCykd6,6,11,6,0,3,0,5,0,25,3.5714285714285716,2,0.0,0,6,0,3,11,0,0,5,0,9,16,1
6881,90469,3v3FB5XsF44WUQOyhVB1K7TjhxipIjnJ,bWdj2GDclj5ofokWjzoa5jAwMkxCykd6,1,0,0,0,0,0,1,0,1,0.14285714285714285,1,0.0,0,0,0,0,0,0,0,1,0,0,1,1
6882,90471,AcoYRXM9MxEJpHYoq7SsbSwZ8unsRtq3,SpATywNh6bZuzm8s1ceuBUnMUAeoAHHw,12,7,1,13,1,0,5,0,27,3.857142857142857,2,0.0,2,1,13,1,5,0,0,5,0,17,10,0
6883,90474,AMP1VomhrLvq0oxaLMgCzayTJQ1U3Z03,SpATywNh6bZuzm8s1ceuBUnMUAeoAHHw,8,8,2,0,0,0,10,1,21,3.0,1,0.0,0,2,0,0,8,0,0,10,1,2,19,1
6884,90479,09hA70zHHsdFY99KewQn0t7W1Th1KuA4,RXDvfPUBYFlVdlueBFbLW0mhhAyGEqpt,29,22,16,34,14,2,16,15,119,17.0,2,0.0,6,16,29,14,16,2,5,16,15,65,54,1
6885,90480,jJhM7dfbmyu6QnNvOuNIHUQvXzylS9kq,bWdj2GDclj5ofokWjzoa5jAwMkxCykd6,1,0,0,0,0,0,1,0,1,0.14285714285714285,1,0.0,0,0,0,0,0,0,0,1,0,0,1,1
6886,90482,LfSoKi26BKEYZHPv7eOdEODBvG4bpVnt,SpATywNh6bZuzm8s1ceuBUnMUAeoAHHw,11,8,5,0,3,0,7,0,23,3.2857142857142856,2,0.0,0,5,0,3,8,0,0,7,0,8,15,1
6887,90486,4eRAU6q1j8xj2oZfSvPOcocekaK18w9w,RXDvfPUBYFlVdlueBFbLW0mhhAyGEqpt,16,21,3,0,0,2,11,1,38,5.428571428571429,1,0.0,2,3,0,0,19,2,0,11,1,5,33,1
6888,90487,swTV8FwIOGPvq6kDLTbN7KErbstwahnB,RXDvfPUBYFlVdlueBFbLW0mhhAyGEqpt,5,3,2,0,1,0,2,0,8,1.1428571428571428,1,0.0,0,2,0,1,3,0,0,2,0,3,5,1
6889,90491,0Gw9qsZWrsuN96zAJXr0m2eOAANOJE07,SpATywNh6bZuzm8s1ceuBUnMUAeoAHHw,1,0,0,0,0,0,1,0,1,0.14285714285714285,1,0.0,0,0,0,0,0,0,0,1,0,0,1,1
6890,90493,3yfQbyJ9pf1yrEL1gur3tzr8XAtUzfm8,bWdj2GDclj5ofokWjzoa5jAwMkxCykd6,4,2,0,0,0,0,2,0,4,0.5714285714285714,1,0.0,0,0,0,0,2,0,0,2,0,0,4,1
6891,90494,r3ymEDBeAtjd52LKkH7rXxWW6cBfLEDa,bWdj2GDclj5ofokWjzoa5jAwMkxCykd6,10,9,4,0,4,0,6,0,23,3.2857142857142856,1,0.0,2,4,0,4,7,0,0,6,0,10,13,1
6892,90495,IV2jyEJwnx9XuvLUnJBPSDEiQEmkULrq,SpATywNh6bZuzm8s1ceuBUnMUAeoAHHw,13,25,3,17,1,0,8,0,54,7.714285714285714,1,0.0,11,3,15,1,14,0,2,8,0,30,24,1
6893,90504,3uY3PXIjE4xYhALzqv9EDJ3LJju3f4Jc,SpATywNh6bZuzm8s1ceuBUnMUAeoAHHw,7,4,2,0,2,0,2,0,10,1.4285714285714286,1,0.0,0,2,0,2,4,0,0,2,0,4,6,1
6894,90513,rW9Fl0YODiCSMxzLAOKlzYxXd8TfgDcd,RXDvfPUBYFlVdlueBFbLW0mhhAyGEqpt,4,5,2,0,0,0,1,0,8,1.1428571428571428,1,0.0,0,2,0,0,5,0,0,1,0,2,6,1
6895,90518,9D8Fr85Y0xJSTSvXENunTRQkQQzpKKhe,RXDvfPUBYFlVdlueBFbLW0mhhAyGEqpt,41,32,22,48,10,24,7,0,143,20.428571428571427,1,0.0,7,22,46,10,25,24,2,7,0,85,58,1
6896,90519,Xs5JYGOD3p8qnunCvDbRtmUT4YrLSZAt,SpATywNh6bZuzm8s1ceuBUnMUAeoAHHw,5,1,1,0,1,0,2,0,5,0.7142857142857143,1,0.0,0,1,0,1,1,0,0,2,0,2,3,1
6897,90520,JoruyAOmEeM1qjcSEWRUjLvQUHpNPZGp,bWdj2GDclj5ofokWjzoa5jAwMkxCykd6,1,0,0,0,0,0,1,0,1,0.14285714285714285,1,0.0,0,0,0,0,0,0,0,1,0,0,1,1
6898,90523,3CsUz8mRFoFNKmkeENo8HuDQSH05lxmZ,SpATywNh6bZuzm8s1ceuBUnMUAeoAHHw,11,23,0,16,0,3,9,0,51,7.285714285714286,1,0.0,9,0,13,0,14,3,3,9,0,22,29,1
6899,90524,LowLlbmaDUppvngMtOhXYfyftobUC8Pz,SpATywNh6bZuzm8s1ceuBUnMUAeoAHHw,10,6,3,0,2,1,7,1,20,2.857142857142857,1,0.0,1,3,0,2,5,1,0,7,1,6,14,1
6900,90526,w2OxtzQI9blY6H8U919hOBWDDo1sEi62,SpATywNh6bZuzm8s1ceuBUnMUAeoAHHw,14,22,0,28,0,55,20,2,127,18.142857142857142,1,0.0,12,0,22,0,10,55,6,20,2,34,93,1
6901,90527,HtbY3zzP3Q7syMRtSIgdj2lkZgZynozO,bWdj2GDclj5ofokWjzoa5jAwMkxCykd6,8,13,0,24,1,27,7,0,72,10.285714285714286,1,0.0,5,0,22,1,8,27,2,7,0,28,44,1
6902,90528,3DMxdIMHShIiQg7VSSohBgQL1oCtuKe4,SpATywNh6bZuzm8s1ceuBUnMUAeoAHHw,4,3,1,0,1,0,0,0,5,0.7142857142857143,1,0.0,0,1,0,1,3,0,0,0,0,2,3,1
6903,90531,iEQKBpzbjZD62mKeYEyJG967oZGFzYX2,SpATywNh6bZuzm8s1ceuBUnMUAeoAHHw,1,0,0,0,0,0,1,0,1,0.14285714285714285,1,0.0,0,0,0,0,0,0,0,1,0,0,1,0
6904,90532,MBimBV1KD5WZIVxadl6ACFa9rEZi9InE,SpATywNh6bZuzm8s1ceuBUnMUAeoAHHw,6,2,1,0,1,0,4,0,8,1.1428571428571428,1,0.0,0,1,0,1,2,0,0,4,0,2,6,1
6905,90540,M8ZBCZwMuabH0ACZboTe8kVgLwQBa43E,bWdj2GDclj5ofokWjzoa5jAwMkxCykd6,7,5,2,0,2,1,5,1,16,2.2857142857142856,1,0.0,0,2,0,2,5,1,0,5,1,4,12,1
6906,90546,68BjCXfBFqeZ01fFx1csrFmvef5xs0w2,bWdj2GDclj5ofokWjzoa5jAwMkxCykd6,9,8,5,0,4,7,3,0,27,3.857142857142857,2,0.0,1,5,0,4,7,7,0,3,0,10,17,1
6907,90549,Z3cBuyK57dLpleXUvGj6emfcnGidOatN,SpATywNh6bZuzm8s1ceuBUnMUAeoAHHw,11,9,7,0,5,0,3,0,24,3.4285714285714284,2,0.0,0,7,0,5,9,0,0,3,0,12,12,1
6908,90550,RNHJpl4xeeRwTYeul6H1SE3f8Bgn5J0c,SpATywNh6bZuzm8s1ceuBUnMUAeoAHHw,11,13,5,0,1,2,7,0,28,4.0,1,0.0,0,5,0,1,13,2,0,7,0,6,22,1
6909,90553,Urctwx56OvAe8Aa2Ler31rqDl5pjO2bG,G8EPVSXsOYB5YQWZGiz1aVq5Pgr2GrQu,23,13,3,24,2,9,17,1,69,9.857142857142858,3,0.0,3,3,18,2,10,9,6,17,1,26,43,1
6910,90560,QqAAFsY8kslizUQKd5uhHbFKpFbb6EW2,SpATywNh6bZuzm8s1ceuBUnMUAeoAHHw,28,45,18,32,6,15,10,1,127,18.142857142857142,3,0.0,12,18,29,6,33,15,3,10,1,65,62,0
6911,90564,gpn05NwMGqKm6lLZGRrnOmPlhHxlC7Wb,RXDvfPUBYFlVdlueBFbLW0mhhAyGEqpt,7,5,3,0,1,0,2,0,11,1.5714285714285714,1,0.0,0,3,0,1,5,0,0,2,0,4,7,1
6912,90569,vKmnCHrfJDutyArHoAT9SYM4ChEEDtjx,SpATywNh6bZuzm8s1ceuBUnMUAeoAHHw,3,5,0,0,0,0,1,0,6,0.8571428571428571,1,0.0,0,0,0,0,5,0,0,1,0,0,6,1
6913,90571,i6jKFDXXIDyjle2n9K5Y7L1CTASMdeNx,RXDvfPUBYFlVdlueBFbLW0mhhAyGEqpt,30,39,1,40,1,3,15,23,122,17.428571428571427,3,0.0,10,1,39,1,29,3,1,15,23,51,71,0
6914,90572,T8mcyrbyEy4XKuvvM213HanZBW8dGO2d,G8EPVSXsOYB5YQWZGiz1aVq5Pgr2GrQu,7,5,1,0,1,0,1,0,8,1.1428571428571428,1,0.0,0,1,0,1,5,0,0,1,0,2,6,1
6915,90581,zH9I9L0RNBBTkWMoTXe4TRjHS1m1XHhV,G8EPVSXsOYB5YQWZGiz1aVq5Pgr2GrQu,10,22,3,12,5,0,3,0,45,6.428571428571429,2,0.0,17,3,9,5,5,0,3,3,0,34,11,1
6916,90583,bXejoPivba2ie50IiUpExTQGL9Tgmtcn,bWdj2GDclj5ofokWjzoa5jAwMkxCykd6,5,2,1,0,1,0,2,0,6,0.8571428571428571,1,0.0,0,1,0,1,2,0,0,2,0,2,4,1
6917,90589,eRKD4Ti4W635KvBhrrkbgHKvnvdw2Idz,SpATywNh6bZuzm8s1ceuBUnMUAeoAHHw,5,2,1,0,1,0,2,0,6,0.8571428571428571,1,0.0,0,1,0,1,2,0,0,2,0,2,4,1
6918,90590,jAHcjIKPY9dlDu300CKSWdNxocPzZC4f,G8EPVSXsOYB5YQWZGiz1aVq5Pgr2GrQu,10,10,4,4,2,0,2,0,22,3.142857142857143,2,0.0,3,4,3,2,7,0,1,2,0,12,10,1
6919,90592,kYIFQ3xM3QnRCvimArGnWBFWWaGJijmw,RXDvfPUBYFlVdlueBFbLW0mhhAyGEqpt,5,2,1,0,1,0,2,0,6,0.8571428571428571,1,0.0,0,1,0,1,2,0,0,2,0,2,4,1
6920,90597,DFFDn6kzjxm3QeQyKXF89GDFKDcalqmY,bWdj2GDclj5ofokWjzoa5jAwMkxCykd6,4,2,1,0,1,1,1,0,6,0.8571428571428571,1,0.0,0,1,0,1,2,1,0,1,0,2,4,1
6921,90611,1e3hDoCmipyCoPSCkvgArsY66kXMIOjQ,SpATywNh6bZuzm8s1ceuBUnMUAeoAHHw,8,11,3,0,2,1,6,1,24,3.4285714285714284,1,0.0,0,3,0,2,11,1,0,6,1,5,19,1
6922,90612,JqFx1dnEaecJfkuX3GZ1Q8Br4IpDeS68,SpATywNh6bZuzm8s1ceuBUnMUAeoAHHw,5,5,4,0,0,0,1,0,10,1.4285714285714286,1,0.0,0,4,0,0,5,0,0,1,0,4,6,1
6923,90620,7QseuWlQx7k5rV1TFF4oSS2exFRRLKz7,SpATywNh6bZuzm8s1ceuBUnMUAeoAHHw,11,4,2,0,2,1,8,1,18,2.5714285714285716,1,0.0,0,2,0,2,4,1,0,8,1,4,14,1
6924,90627,vDq8yiqHZiGZE0VPuzr41C23TWmY1JqS,SpATywNh6bZuzm8s1ceuBUnMUAeoAHHw,5,4,3,0,1,0,1,0,9,1.2857142857142858,1,0.0,0,3,0,1,4,0,0,1,0,4,5,1
6925,90632,5Dk7QJtqh7ATnN1jDaFE4dN4E1GugvAr,bWdj2GDclj5ofokWjzoa5jAwMkxCykd6,16,31,17,140,6,19,5,0,218,31.142857142857142,2,0.0,6,17,137,6,25,19,3,5,0,166,52,1
6926,90640,3YR1C1jI56LrsXJAUkFoM0M9MuhHAioI,SpATywNh6bZuzm8s1ceuBUnMUAeoAHHw,8,4,1,0,1,0,4,0,10,1.4285714285714286,1,0.0,2,1,0,1,2,0,0,4,0,4,6,1
6927,90643,LvpKAlZO7ziKr9qX3nIahz2mFKsUbwWI,SpATywNh6bZuzm8s1ceuBUnMUAeoAHHw,6,2,1,0,1,0,6,0,10,1.4285714285714286,3,0.0,0,1,0,1,2,0,0,6,0,2,8,1
6928,90647,ATFpemxOxaCS0pUz9OSp5dq4w85WuWvd,SpATywNh6bZuzm8s1ceuBUnMUAeoAHHw,13,22,0,18,0,0,8,2,50,7.142857142857143,1,0.0,6,0,17,0,16,0,1,8,2,23,27,1
6929,90649,CfeENerIdAGepleePWSt0SV88ctt0Tmw,RXDvfPUBYFlVdlueBFbLW0mhhAyGEqpt,1,0,0,0,0,0,1,0,1,0.14285714285714285,1,0.0,0,0,0,0,0,0,0,1,0,0,1,1
6930,90650,cvuy8HaLnRoF5suMAoOqjooUG2AEFLC2,bWdj2GDclj5ofokWjzoa5jAwMkxCykd6,10,10,2,2,3,0,6,0,23,3.2857142857142856,2,0.0,1,2,2,3,9,0,0,6,0,8,15,1
6931,90655,w0NwX9gVv58q1LwNFajcpOhqIprh7BvB,G8EPVSXsOYB5YQWZGiz1aVq5Pgr2GrQu,10,17,2,6,3,0,5,0,33,4.714285714285714,2,0.0,8,2,5,3,9,0,1,5,0,18,15,1
6932,90671,PwGj8ON4yrWpMaoZE0ES8sG2eAqFQNfN,SpATywNh6bZuzm8s1ceuBUnMUAeoAHHw,21,24,14,16,7,11,9,1,82,11.714285714285714,4,0.0,4,14,14,7,20,11,2,9,1,39,43,1
6933,90673,yDc9ZpbUycr11xuvu88deR54WnL37yET,SpATywNh6bZuzm8s1ceuBUnMUAeoAHHw,22,44,8,31,4,2,10,1,100,14.285714285714286,4,0.0,20,8,27,4,24,2,4,10,1,59,41,0
6934,90674,bLDIg7orV5sh30oIBmQ342IswZTJ8Q5l,RXDvfPUBYFlVdlueBFbLW0mhhAyGEqpt,12,14,8,0,5,0,4,0,31,4.428571428571429,3,0.0,0,8,0,5,14,0,0,4,0,13,18,1
6935,90676,JrmmYCeYhJwPKrtI75WdL68kxmQcjGg8,SpATywNh6bZuzm8s1ceuBUnMUAeoAHHw,11,12,8,0,5,1,6,1,33,4.714285714285714,3,0.0,0,8,0,5,12,1,0,6,1,13,20,1
6936,90678,wQn1gyWkMsHmRn6FRBCpTkRxPyoDtHcK,G8EPVSXsOYB5YQWZGiz1aVq5Pgr2GrQu,5,13,0,0,1,0,4,0,18,2.5714285714285716,2,0.0,6,0,0,1,7,0,0,4,0,7,11,1
6937,90685,p1glD11J2O4xqRjpc7tPhfftojomVp8l,G8EPVSXsOYB5YQWZGiz1aVq5Pgr2GrQu,6,1,1,0,1,1,5,0,9,1.2857142857142858,2,0.0,0,1,0,1,1,1,0,5,0,2,7,1
6938,90696,H5UEKpeYUS8ZwAU1o3ZTuTx8QVBIM5mj,bWdj2GDclj5ofokWjzoa5jAwMkxCykd6,1,0,0,0,0,0,1,0,1,0.14285714285714285,1,0.0,0,0,0,0,0,0,0,1,0,0,1,1
6939,90700,63wWcpmf1i2NKSiQREiAJYYp7SpsRdNk,SpATywNh6bZuzm8s1ceuBUnMUAeoAHHw,6,4,3,0,2,0,2,0,11,1.5714285714285714,1,0.0,0,3,0,2,4,0,0,2,0,5,6,1
6940,90701,deIsi5BI37iNeLK3sFoXHW9756YDHzUX,SpATywNh6bZuzm8s1ceuBUnMUAeoAHHw,8,5,1,0,0,11,9,1,27,3.857142857142857,1,0.0,0,1,0,0,5,11,0,9,1,1,26,1
6941,90702,ORT6fH4QpWfdVApgOFbiZIUgnndzWNam,bWdj2GDclj5ofokWjzoa5jAwMkxCykd6,6,2,1,0,1,0,4,0,8,1.1428571428571428,1,0.0,0,1,0,1,2,0,0,4,0,2,6,1
6942,90707,oJ9j9ejTgKixczg3tSE8Sg8DPI7YQpJq,bWdj2GDclj5ofokWjzoa5jAwMkxCykd6,8,11,5,0,2,1,4,1,24,3.4285714285714284,1,0.0,3,5,0,2,8,1,0,4,1,10,14,1
6943,90708,rd6AxicG284gxewkDLzJ9mHqaB9eMpej,SpATywNh6bZuzm8s1ceuBUnMUAeoAHHw,5,2,1,0,1,0,2,0,6,0.8571428571428571,1,0.0,0,1,0,1,2,0,0,2,0,2,4,1
6944,90711,YwhJiJdY6sdupy0lRkNRU9p6H4rUPLhl,SpATywNh6bZuzm8s1ceuBUnMUAeoAHHw,2,0,0,0,0,0,3,0,3,0.42857142857142855,1,0.0,0,0,0,0,0,0,0,3,0,0,3,1
6945,90712,sKygNm7l33RvePXhMRKhT8eWlgq4D2Uu,G8EPVSXsOYB5YQWZGiz1aVq5Pgr2GrQu,7,2,1,0,1,0,8,1,13,1.8571428571428572,1,0.0,0,1,0,1,2,0,0,8,1,2,11,1
6946,90714,F56VIhO1QqwJ2EV8tGyI5l1mo3yf3Tk3,bWdj2GDclj5ofokWjzoa5jAwMkxCykd6,3,2,0,0,0,0,2,0,4,0.5714285714285714,1,0.0,0,0,0,0,2,0,0,2,0,0,4,1
6947,90716,D03u0gED7VbQRZXbOTEY3B3RSnOHMTwX,G8EPVSXsOYB5YQWZGiz1aVq5Pgr2GrQu,4,4,1,0,1,0,1,0,7,1.0,1,0.0,0,1,0,1,4,0,0,1,0,2,5,1
6948,90718,tOwol93HcvuFb5zloOErYW1pE3AivbGE,bWdj2GDclj5ofokWjzoa5jAwMkxCykd6,1,0,0,0,0,0,1,0,1,0.14285714285714285,1,0.0,0,0,0,0,0,0,0,1,0,0,1,1
6949,90720,tOwol93HcvuFb5zloOErYW1pE3AivbGE,RXDvfPUBYFlVdlueBFbLW0mhhAyGEqpt,6,2,1,0,1,0,3,0,7,1.0,1,0.0,0,1,0,1,2,0,0,3,0,2,5,1
6950,90722,1UXy9epSRpZ4kgvfm7ijkVKWuglHemTQ,SpATywNh6bZuzm8s1ceuBUnMUAeoAHHw,5,2,1,0,1,0,6,0,10,1.4285714285714286,1,0.0,0,1,0,1,2,0,0,6,0,2,8,0
6951,90729,4TzA065DYK6LuKsj03IdWmVVHtLP4pD7,SpATywNh6bZuzm8s1ceuBUnMUAeoAHHw,6,2,1,0,1,0,3,0,7,1.0,1,0.0,0,1,0,1,2,0,0,3,0,2,5,1
6952,90741,w5OdJoQZNGUVPiCQDXg0Vd0yo9ewUzmW,RXDvfPUBYFlVdlueBFbLW0mhhAyGEqpt,14,10,7,12,4,0,2,0,35,5.0,2,0.0,1,7,12,4,9,0,0,2,0,24,11,1
6953,90743,Y5C6JW9FcrJIhkFtmu7KcSC7Zibilzs4,RXDvfPUBYFlVdlueBFbLW0mhhAyGEqpt,14,15,10,0,4,2,11,2,44,6.285714285714286,2,0.0,0,10,0,4,15,2,0,11,2,14,30,1
6954,90746,ldckbcGV67YBoSN68pz7hDadzOTSpXE4,G8EPVSXsOYB5YQWZGiz1aVq5Pgr2GrQu,8,26,8,12,6,0,3,0,55,7.857142857142857,3,0.0,6,8,11,6,20,0,1,3,0,31,24,1
6955,90747,4f6gBunWwjsaAgYwinaGIAK95dQig1Sv,bWdj2GDclj5ofokWjzoa5jAwMkxCykd6,1,0,0,0,0,0,1,0,1,0.14285714285714285,1,0.0,0,0,0,0,0,0,0,1,0,0,1,1
6956,90749,Y5EybULOrY5dAmMMQWE7bK5wg4bsR2Lr,bWdj2GDclj5ofokWjzoa5jAwMkxCykd6,12,32,17,60,3,61,21,2,196,28.0,5,0.0,3,17,58,3,29,61,2,21,2,81,115,1
6957,90755,KQaABjEuQepl9FAcsVuUoYwnLleiOaUh,bWdj2GDclj5ofokWjzoa5jAwMkxCykd6,4,4,1,0,2,0,1,0,8,1.1428571428571428,1,0.0,2,1,0,2,2,0,0,1,0,5,3,1
6958,90757,wwEAB1ez2GqscQ96613pzqpcm4gmgk2z,bWdj2GDclj5ofokWjzoa5jAwMkxCykd6,9,13,3,0,5,0,2,0,23,3.2857142857142856,1,0.0,5,3,0,5,8,0,0,2,0,13,10,1
6959,90760,LknZf5R0kFesJr0Rm2KEqD235TVmngp0,SpATywNh6bZuzm8s1ceuBUnMUAeoAHHw,13,11,0,14,0,57,8,1,91,13.0,1,0.0,2,0,11,0,9,57,3,8,1,13,78,1
6960,90761,l4s4x0272kzhcEfgCvz1VNYYSzsAqk0d,G8EPVSXsOYB5YQWZGiz1aVq5Pgr2GrQu,11,8,4,0,3,3,6,0,24,3.4285714285714284,2,0.0,0,4,0,3,8,3,0,6,0,7,17,1
6961,90765,pGY1w8eP7I4lbateXReA0flFyTJRZgPr,G8EPVSXsOYB5YQWZGiz1aVq5Pgr2GrQu,6,1,1,0,1,0,3,0,6,0.8571428571428571,1,0.0,0,1,0,1,1,0,0,3,0,2,4,1
6962,90770,3CsUz8mRFoFNKmkeENo8HuDQSH05lxmZ,G8EPVSXsOYB5YQWZGiz1aVq5Pgr2GrQu,3,0,0,0,0,0,6,0,6,0.8571428571428571,2,0.0,0,0,0,0,0,0,0,6,0,0,6,1
6963,90773,D0SRTJhzsGGnKbIKtAcGeOVG46CDAXxq,SpATywNh6bZuzm8s1ceuBUnMUAeoAHHw,7,8,5,0,3,0,3,0,19,2.7142857142857144,2,0.0,0,5,0,3,8,0,0,3,0,8,11,1
6964,90782,LeyecjAY6mg5LvZFKVpB5z5Vy8PSThxU,SpATywNh6bZuzm8s1ceuBUnMUAeoAHHw,7,6,2,0,2,0,2,0,12,1.7142857142857142,1,0.0,0,2,0,2,6,0,0,2,0,4,8,1
6965,90788,AhMXiVok13ZjNF4gspHPwIDZecQgiWpM,RXDvfPUBYFlVdlueBFbLW0mhhAyGEqpt,1,0,0,0,0,0,1,0,1,0.14285714285714285,1,0.0,0,0,0,0,0,0,0,1,0,0,1,1
6966,90789,bEGwB6bxwamH303rlcp1dTooqcWaF93C,SpATywNh6bZuzm8s1ceuBUnMUAeoAHHw,20,31,3,20,3,19,15,1,92,13.142857142857142,6,0.0,15,3,17,3,16,19,3,15,1,38,54,0
6967,90790,CdOlESGB1DzB9C16eeGe1UhXPsjHWQGW,SpATywNh6bZuzm8s1ceuBUnMUAeoAHHw,13,9,5,13,3,10,3,0,43,6.142857142857143,1,0.0,3,5,12,3,6,10,1,3,0,23,20,1
6968,90794,J38SfNJhh0josFdljlBSrhXRogu9GoqX,G8EPVSXsOYB5YQWZGiz1aVq5Pgr2GrQu,23,56,25,30,7,0,8,0,126,18.0,1,0.0,17,25,23,7,39,0,7,8,0,72,54,1
6969,90799,4LhW0gpz7wD6EZALKqoopL1swej6F6kT,RXDvfPUBYFlVdlueBFbLW0mhhAyGEqpt,8,10,3,0,1,0,4,1,19,2.7142857142857144,2,0.0,0,3,0,1,10,0,0,4,1,4,15,1
6970,90800,HDDfG2CBGcAcxX3ycvOXstF4TGeBz4ZN,G8EPVSXsOYB5YQWZGiz1aVq5Pgr2GrQu,8,4,3,0,3,0,1,0,11,1.5714285714285714,1,0.0,0,3,0,3,4,0,0,1,0,6,5,1
6971,90801,D819UH6GjR554Q5KsACZVpoO8UDhricE,SpATywNh6bZuzm8s1ceuBUnMUAeoAHHw,7,3,2,0,2,0,2,0,9,1.2857142857142858,1,0.0,0,2,0,2,3,0,0,2,0,4,5,1
6972,90811,I2obse1Zq7Nau4sY1YPG5mgE6G3RFVMC,G8EPVSXsOYB5YQWZGiz1aVq5Pgr2GrQu,6,5,4,0,4,0,1,0,14,2.0,1,0.0,0,4,0,4,5,0,0,1,0,8,6,1
6973,90815,iXNm5ZN5LzdJniA2N9BJpNV8u0KUat63,SpATywNh6bZuzm8s1ceuBUnMUAeoAHHw,10,20,7,0,3,0,5,0,35,5.0,2,0.0,0,7,0,3,20,0,0,5,0,10,25,1
6974,90821,pNgGoRZfmUo4wkTYP23egMC3LUn4nA2d,SpATywNh6bZuzm8s1ceuBUnMUAeoAHHw,12,14,6,0,2,1,10,0,33,4.714285714285714,1,0.0,0,6,0,2,14,1,0,10,0,8,25,1
6975,90822,X6bWAuG7i4cSWjzWor8wb8Jqxiw7Y3fM,G8EPVSXsOYB5YQWZGiz1aVq5Pgr2GrQu,20,12,1,36,1,3,2,0,55,7.857142857142857,1,0.0,1,1,29,1,11,3,7,2,0,32,23,1
6976,90824,5vkNIYp2bYY1LtZU7tLxethQegJYgNo1,G8EPVSXsOYB5YQWZGiz1aVq5Pgr2GrQu,4,8,1,0,3,0,1,0,13,1.8571428571428572,1,0.0,6,1,0,3,2,0,0,1,0,10,3,1
6977,90825,06UqVup6ex1qeNp4vJ1m9FBAIaawxt3L,bWdj2GDclj5ofokWjzoa5jAwMkxCykd6,8,5,3,0,2,0,3,0,13,1.8571428571428572,1,0.0,0,3,0,2,5,0,0,3,0,5,8,1
6978,90828,l8KXVCEZbv28Mkels2ilOG7I8qSBHRqR,RXDvfPUBYFlVdlueBFbLW0mhhAyGEqpt,7,8,1,0,1,0,1,0,11,1.5714285714285714,1,0.0,2,1,0,1,6,0,0,1,0,4,7,1
6979,90832,Qsw20Q5PeTwiq1PxYe0LRVTTkwenKksO,SpATywNh6bZuzm8s1ceuBUnMUAeoAHHw,10,21,4,7,0,6,6,0,44,6.285714285714286,3,0.0,5,4,6,0,16,6,1,6,0,15,29,1
6980,90839,5ZwXPjJ7Hpe1sEszjUirFtHlC571EgXW,bWdj2GDclj5ofokWjzoa5jAwMkxCykd6,5,8,1,0,1,0,2,0,12,1.7142857142857142,1,0.0,1,1,0,1,7,0,0,2,0,3,9,1
6981,90848,KrsnHficdQyIsUU0OmJhlaIOPfA02mNz,bWdj2GDclj5ofokWjzoa5jAwMkxCykd6,1,0,0,0,0,0,2,0,2,0.2857142857142857,1,0.0,0,0,0,0,0,0,0,2,0,0,2,1
6982,90850,GWNKqanO7Bwv22F8soWqeHa4Wn2DiLGZ,RXDvfPUBYFlVdlueBFbLW0mhhAyGEqpt,36,32,10,61,8,0,1,0,112,16.0,1,0.0,6,10,59,8,26,0,2,1,0,83,29,1
6983,90855,KogrHROquIJLSXIZqzhYU9Hcb9zVebwT,SpATywNh6bZuzm8s1ceuBUnMUAeoAHHw,28,25,13,22,5,28,7,1,101,14.428571428571429,3,0.0,7,13,19,5,18,28,3,7,1,44,57,1
6984,90856,t4mBW06R5u34zTzy1YY0BqHR3HtrMlxW,bWdj2GDclj5ofokWjzoa5jAwMkxCykd6,17,18,9,20,3,11,15,2,78,11.142857142857142,3,0.0,3,9,19,3,15,11,1,15,2,34,44,1
6985,90861,sD4VJ3Pl6fUXDlwP0L4osteHu9UdT1hV,SpATywNh6bZuzm8s1ceuBUnMUAeoAHHw,6,3,1,0,1,0,4,0,9,1.2857142857142858,1,0.0,0,1,0,1,3,0,0,4,0,2,7,1
6986,90863,OuHC5cgkNZAxQ8FoVKCX7NbOcZdwtnqB,SpATywNh6bZuzm8s1ceuBUnMUAeoAHHw,8,11,7,0,4,0,5,0,27,3.857142857142857,1,0.0,0,7,0,4,11,0,0,5,0,11,16,1
6987,90872,nL9fwNKEZP1vFZxFJDQtGgReRFz5AlyD,SpATywNh6bZuzm8s1ceuBUnMUAeoAHHw,8,8,3,0,1,2,6,2,22,3.142857142857143,1,0.0,4,3,0,1,4,2,0,6,2,8,14,1
6988,90875,Qyq18jm4urtOwW9jbqpJJDMX3auyGXK1,SpATywNh6bZuzm8s1ceuBUnMUAeoAHHw,4,2,0,0,0,0,2,0,4,0.5714285714285714,1,0.0,0,0,0,0,2,0,0,2,0,0,4,1
6989,90877,C9Wh4VK0YDPz8OcZLvDPXEYgZvrO7fON,SpATywNh6bZuzm8s1ceuBUnMUAeoAHHw,4,2,1,0,1,0,1,0,5,0.7142857142857143,1,0.0,0,1,0,1,2,0,0,1,0,2,3,1
6990,90878,vIBcYbs1BLdmaaP30fcE2FS7kB7v7QRn,bWdj2GDclj5ofokWjzoa5jAwMkxCykd6,9,20,11,0,1,3,13,0,48,6.857142857142857,2,0.0,2,11,0,1,18,3,0,13,0,14,34,1
6991,90880,YAHRUvgTShfsjnOmO618HsecfyEFFriC,SpATywNh6bZuzm8s1ceuBUnMUAeoAHHw,5,15,3,0,2,0,2,0,22,3.142857142857143,1,0.0,0,3,0,2,15,0,0,2,0,5,17,1
6992,90885,kFMdrBn76woeFkLVMgIjnzYIkBkN2rjs,SpATywNh6bZuzm8s1ceuBUnMUAeoAHHw,5,5,3,0,2,0,1,0,11,1.5714285714285714,1,0.0,0,3,0,2,5,0,0,1,0,5,6,1
6993,90887,GVUw4u2UhYktwQlrJTo9fWmDS2qzWpQC,SpATywNh6bZuzm8s1ceuBUnMUAeoAHHw,26,38,2,30,2,98,19,1,190,27.142857142857142,4,0.0,13,2,26,2,25,98,4,19,1,43,147,0
6994,90905,R3vdKqOlKdhOGFVIJPoEGMoTbxTcB9bc,SpATywNh6bZuzm8s1ceuBUnMUAeoAHHw,16,10,7,5,6,1,17,1,47,6.714285714285714,3,0.0,0,7,4,6,10,1,1,17,1,17,30,1
6995,90910,8mVKxRgJ8A1rq04XffdKXYfatdM3yRYE,RXDvfPUBYFlVdlueBFbLW0mhhAyGEqpt,8,4,3,0,2,0,2,0,11,1.5714285714285714,1,0.0,0,3,0,2,4,0,0,2,0,5,6,1
6996,90915,HPaDTzk2xymxbpoa0VdcxdHl3uFfOfZk,G8EPVSXsOYB5YQWZGiz1aVq5Pgr2GrQu,1,0,0,0,0,0,1,0,1,0.14285714285714285,1,0.0,0,0,0,0,0,0,0,1,0,0,1,1
6997,90916,nMBGX3nqIipxPIzBJdOaTEwO6lPkrYAP,SpATywNh6bZuzm8s1ceuBUnMUAeoAHHw,9,12,8,0,2,2,8,0,32,4.571428571428571,1,0.0,0,8,0,2,12,2,0,8,0,10,22,1
6998,90918,P8T670PRvYsTF14RAy04Ypel9tVdSt4W,SpATywNh6bZuzm8s1ceuBUnMUAeoAHHw,14,16,3,14,2,1,7,1,44,6.285714285714286,1,0.0,11,3,13,2,5,1,1,7,1,29,15,1
6999,90926,mfSlhGs8TOW9c66xAJCzRN5uCUec3OQS,G8EPVSXsOYB5YQWZGiz1aVq5Pgr2GrQu,4,3,0,0,0,0,1,0,4,0.5714285714285714,1,0.0,0,0,0,0,3,0,0,1,0,0,4,1
7000,90938,qA7txaCsDINVj5jwLkjFxBdOEKcLbkUC,bWdj2GDclj5ofokWjzoa5jAwMkxCykd6,4,8,2,0,2,0,1,0,13,1.8571428571428572,1,0.0,4,2,0,2,4,0,0,1,0,8,5,1
7001,90939,hRiaJRtvIOFlbihdEsv906GxXONnrFfr,SpATywNh6bZuzm8s1ceuBUnMUAeoAHHw,6,11,2,0,1,0,7,0,21,3.0,1,0.0,1,2,0,1,10,0,0,7,0,4,17,1
7002,90951,bmpOpVuzweuue9KaoQwJh1soVS4PCMAj,RXDvfPUBYFlVdlueBFbLW0mhhAyGEqpt,16,7,4,15,5,1,4,0,36,5.142857142857143,1,0.0,2,4,14,5,5,1,1,4,0,25,11,1
7003,90953,hIjUruVScjiqfQ0ERHHhB6StdCOggvbB,RXDvfPUBYFlVdlueBFbLW0mhhAyGEqpt,18,14,5,29,3,0,5,1,57,8.142857142857142,1,0.0,2,5,29,3,12,0,0,5,1,39,18,1
7004,90959,bAPyDIJfdAxQ8AHvo3QeBgdKri2hlVLQ,G8EPVSXsOYB5YQWZGiz1aVq5Pgr2GrQu,1,0,0,0,0,0,1,0,1,0.14285714285714285,1,0.0,0,0,0,0,0,0,0,1,0,0,1,1
7005,90961,h3p30ndtRdIyBMRidOGn8LuOdbmfUl5i,bWdj2GDclj5ofokWjzoa5jAwMkxCykd6,4,2,1,0,0,0,2,0,5,0.7142857142857143,1,0.0,0,1,0,0,2,0,0,2,0,1,4,1
7006,90962,1x68B6ELAKzkC8Z87epaTU9JLE90xrom,SpATywNh6bZuzm8s1ceuBUnMUAeoAHHw,6,10,0,5,0,0,2,0,17,2.4285714285714284,1,0.0,7,0,5,0,3,0,0,2,0,12,5,1
7007,90964,UEGgGFOddxp081siu8g5s2awm2LAgg2C,G8EPVSXsOYB5YQWZGiz1aVq5Pgr2GrQu,5,3,0,0,0,0,2,0,5,0.7142857142857143,1,0.0,0,0,0,0,3,0,0,2,0,0,5,1
7008,90967,8nT76hrzyl8ZAUdI7W6kfrIzHxI3puKM,SpATywNh6bZuzm8s1ceuBUnMUAeoAHHw,1,0,0,0,0,0,1,0,1,0.14285714285714285,1,0.0,0,0,0,0,0,0,0,1,0,0,1,1
7009,90968,1YzhwwWLdVM4bzJMYH49O7nplNitMAxK,SpATywNh6bZuzm8s1ceuBUnMUAeoAHHw,1,0,0,0,0,0,1,0,1,0.14285714285714285,1,0.0,0,0,0,0,0,0,0,1,0,0,1,1
7010,90975,ABlVlNkPi30ZMlFLrcsAhP5jZW6rJhdZ,bWdj2GDclj5ofokWjzoa5jAwMkxCykd6,6,3,2,0,1,0,2,0,8,1.1428571428571428,2,0.0,0,2,0,1,3,0,0,2,0,3,5,1
7011,90976,JgACfbSPbgZxvcoTB7IZVAGzYc3ZbdQl,G8EPVSXsOYB5YQWZGiz1aVq5Pgr2GrQu,18,19,0,0,1,2,8,1,31,4.428571428571429,2,0.0,2,0,0,1,17,2,0,8,1,3,28,1
7012,90980,iKjkh1YrFzq5OB5DSHkFwl9ZdnaqKanG,SpATywNh6bZuzm8s1ceuBUnMUAeoAHHw,5,4,1,0,1,1,2,0,9,1.2857142857142858,1,0.0,1,1,0,1,3,1,0,2,0,3,6,1
7013,90982,P9uew3S2WCP2kqlooRwkV6WK6JXjnFW1,SpATywNh6bZuzm8s1ceuBUnMUAeoAHHw,7,4,1,0,0,1,4,1,11,1.5714285714285714,1,0.0,0,1,0,0,4,1,0,4,1,1,10,1
7014,90990,h3p30ndtRdIyBMRidOGn8LuOdbmfUl5i,SpATywNh6bZuzm8s1ceuBUnMUAeoAHHw,13,8,3,12,2,3,4,1,33,4.714285714285714,1,0.0,3,3,12,2,5,3,0,4,1,20,13,1
7015,90991,MSVIULFa47b8oOycWVWVcPhuMCdDd5NZ,SpATywNh6bZuzm8s1ceuBUnMUAeoAHHw,25,32,12,20,4,6,17,1,92,13.142857142857142,3,0.0,6,12,18,4,26,6,2,17,1,40,52,1
7016,90996,XjO6wB2Z4egz4mV0GhT9a1BmKnwX0iZQ,SpATywNh6bZuzm8s1ceuBUnMUAeoAHHw,7,7,1,0,1,0,2,0,11,1.5714285714285714,1,0.0,3,1,0,1,4,0,0,2,0,5,6,1
7017,91000,69mjZoNGtUdd47OHaI2iQubsVwSBE5CT,SpATywNh6bZuzm8s1ceuBUnMUAeoAHHw,5,3,0,0,0,0,5,0,8,1.1428571428571428,1,0.0,0,0,0,0,3,0,0,5,0,0,8,1
7018,91003,iJftBP3zncmjUCwGWSZ77IUrDb3Dt8rz,bWdj2GDclj5ofokWjzoa5jAwMkxCykd6,4,2,1,0,1,0,1,0,5,0.7142857142857143,1,0.0,0,1,0,1,2,0,0,1,0,2,3,1
7019,91005,h83s4W6wEAiVAQw1YsiHYJozxIiZHoSp,G8EPVSXsOYB5YQWZGiz1aVq5Pgr2GrQu,5,2,1,0,1,1,2,0,7,1.0,1,0.0,0,1,0,1,2,1,0,2,0,2,5,1
7020,91007,fnbOlL6zM0TdpgW3GvlsPHFVJnQSFTyA,SpATywNh6bZuzm8s1ceuBUnMUAeoAHHw,10,13,7,0,6,0,4,0,30,4.285714285714286,2,0.0,0,7,0,6,13,0,0,4,0,13,17,1
7021,91008,UB0nPfUwWgaRThrVeKik4SwdfP63TRHx,SpATywNh6bZuzm8s1ceuBUnMUAeoAHHw,14,29,2,18,1,4,6,0,60,8.571428571428571,2,0.0,5,2,15,1,24,4,3,6,0,23,37,1
7022,91011,UyjpsvsOggyMosfJEuRSeI96eHcBNf41,SpATywNh6bZuzm8s1ceuBUnMUAeoAHHw,6,4,2,3,1,0,1,0,11,1.5714285714285714,1,0.0,1,2,3,1,3,0,0,1,0,7,4,1
7023,91013,bqWpav7ocOhCfb3xc4QgAvBDK5g8BmiZ,bWdj2GDclj5ofokWjzoa5jAwMkxCykd6,11,10,8,0,2,0,4,0,24,3.4285714285714284,2,0.0,0,8,0,2,10,0,0,4,0,10,14,1
7024,91014,dLJ4i4UwjNqr5YPEuySq1h5THPMNjgjJ,SpATywNh6bZuzm8s1ceuBUnMUAeoAHHw,10,8,6,0,5,0,3,0,22,3.142857142857143,2,0.0,0,6,0,5,8,0,0,3,0,11,11,0
7025,91016,KyDM2Ub30UlLqAgwV3Kdja9FjS49F2cL,G8EPVSXsOYB5YQWZGiz1aVq5Pgr2GrQu,4,2,1,0,1,0,1,0,5,0.7142857142857143,1,0.0,0,1,0,1,2,0,0,1,0,2,3,1
7026,91017,zrZWN5ij2KPpDRaiyWWPqj2Z1YuwvTvt,SpATywNh6bZuzm8s1ceuBUnMUAeoAHHw,10,19,7,0,4,5,14,3,52,7.428571428571429,3,0.0,0,7,0,4,19,5,0,14,3,11,41,1
7027,91022,BvTUeUSX8ehdvYqgk6h69dy9HSlBWzXM,G8EPVSXsOYB5YQWZGiz1aVq5Pgr2GrQu,7,31,7,0,3,0,9,0,50,7.142857142857143,1,0.0,3,7,0,3,28,0,0,9,0,13,37,1
7028,91023,ZZzQCzIgfdjMh5GZMagmPbKqCFsmjzqD,SpATywNh6bZuzm8s1ceuBUnMUAeoAHHw,5,2,1,0,1,0,2,0,6,0.8571428571428571,1,0.0,0,1,0,1,2,0,0,2,0,2,4,1
7029,91025,nTeEg9IpivRmreYWiIjMvVlevTAaGMey,SpATywNh6bZuzm8s1ceuBUnMUAeoAHHw,7,5,3,0,2,0,2,0,12,1.7142857142857142,2,0.0,0,3,0,2,5,0,0,2,0,5,7,1
7030,91029,tvqXd520K684wy1KQ0GBsByYs78H3st9,RXDvfPUBYFlVdlueBFbLW0mhhAyGEqpt,1,0,0,0,0,0,1,0,1,0.14285714285714285,1,0.0,0,0,0,0,0,0,0,1,0,0,1,1
7031,91037,mJHwEQabAWgiuu06ZP8aR46SMutI8kEA,SpATywNh6bZuzm8s1ceuBUnMUAeoAHHw,5,2,1,0,1,0,3,0,7,1.0,1,0.0,0,1,0,1,2,0,0,3,0,2,5,1
7032,91045,dB4WDfiw60nGNNAG9g9zNz1Z102rMluZ,SpATywNh6bZuzm8s1ceuBUnMUAeoAHHw,19,12,7,12,4,2,7,1,45,6.428571428571429,2,0.0,2,7,11,4,10,2,1,7,1,24,21,1
7033,91050,Y5EybULOrY5dAmMMQWE7bK5wg4bsR2Lr,RXDvfPUBYFlVdlueBFbLW0mhhAyGEqpt,13,8,7,0,4,0,1,0,20,2.857142857142857,1,0.0,0,7,0,4,8,0,0,1,0,11,9,1
7034,91054,EjR7iUwsiJVzqJrC7t3D1JWVRCEYToml,bWdj2GDclj5ofokWjzoa5jAwMkxCykd6,8,7,1,0,2,24,5,1,40,5.714285714285714,1,0.0,2,1,0,2,5,24,0,5,1,5,35,1
7035,91058,JckOmRdQvE0R24dfuPeUe2DTKfe4tF0h,G8EPVSXsOYB5YQWZGiz1aVq5Pgr2GrQu,2,0,0,0,0,0,4,0,4,0.5714285714285714,1,0.0,0,0,0,0,0,0,0,4,0,0,4,0
7036,91059,YJQCaDByfjoOhBSQklKuzWe4YXgqBr84,SpATywNh6bZuzm8s1ceuBUnMUAeoAHHw,5,3,2,0,2,0,3,0,10,1.4285714285714286,2,0.0,0,2,0,2,3,0,0,3,0,4,6,1
7037,91061,4BM2X3vjiB0KMTdSgJPbb92aYDlCdKqm,SpATywNh6bZuzm8s1ceuBUnMUAeoAHHw,1,0,0,0,0,0,5,0,5,0.7142857142857143,1,0.0,0,0,0,0,0,0,0,5,0,0,5,1
7038,91063,gzBj4rBVIL1BI1dJCkBf6DnSNlOqQIwg,SpATywNh6bZuzm8s1ceuBUnMUAeoAHHw,7,8,0,0,0,4,4,0,16,2.2857142857142856,1,0.0,0,0,0,0,8,4,0,4,0,0,16,1
7039,91066,HvCZ1bV9L7D0erySzp1UH1mW8tuWfYPw,SpATywNh6bZuzm8s1ceuBUnMUAeoAHHw,7,11,5,0,3,3,2,0,24,3.4285714285714284,2,0.0,0,5,0,3,11,3,0,2,0,8,16,1
7040,91070,G1AtiTSNDONQwl0Hl81VRJCbBPxu3bhI,bWdj2GDclj5ofokWjzoa5jAwMkxCykd6,7,4,2,0,1,5,6,0,18,2.5714285714285716,1,0.0,0,2,0,1,4,5,0,6,0,3,15,0
7041,91078,KYLGj0LJWlbOKu0N6ntmca4SUIisJJd9,SpATywNh6bZuzm8s1ceuBUnMUAeoAHHw,1,0,0,0,0,0,4,0,4,0.5714285714285714,1,0.0,0,0,0,0,0,0,0,4,0,0,4,1
7042,91081,U04y5vFf0AfyJVGIOJHlryTyRQEOm5pT,RXDvfPUBYFlVdlueBFbLW0mhhAyGEqpt,6,2,1,0,1,0,4,0,8,1.1428571428571428,2,0.0,0,1,0,1,2,0,0,4,0,2,6,1
7043,91105,ZxvROepgS8uZpWYEjrhlsfyND4f2cw2o,SpATywNh6bZuzm8s1ceuBUnMUAeoAHHw,26,31,16,31,6,3,24,2,113,16.142857142857142,2,0.0,11,16,25,6,20,3,6,24,2,58,55,0
7044,91108,nJUQO0awidSkRki1FSo1rhLXdIxrzKfS,G8EPVSXsOYB5YQWZGiz1aVq5Pgr2GrQu,22,30,5,34,4,8,12,1,94,13.428571428571429,5,0.0,5,5,28,4,25,8,6,12,1,42,52,0
7045,91110,9jYO2Na9DSPgmUyIaCnH33KjtnbI2MPN,SpATywNh6bZuzm8s1ceuBUnMUAeoAHHw,8,4,3,0,3,0,1,0,11,1.5714285714285714,1,0.0,0,3,0,3,4,0,0,1,0,6,5,1
7046,91111,Bx6FqxWgsWymyOwxFcEQZn8BP7GPaoEm,G8EPVSXsOYB5YQWZGiz1aVq5Pgr2GrQu,8,5,3,0,1,0,12,0,21,3.0,1,0.0,0,3,0,1,5,0,0,12,0,4,17,1
7047,91115,fAwXW6DQAyNHjMN17jlyBSVcZRO4da21,SpATywNh6bZuzm8s1ceuBUnMUAeoAHHw,14,32,12,14,7,3,5,0,73,10.428571428571429,2,0.0,4,12,12,7,28,3,2,5,0,35,38,1
7048,91116,K1IqR71Sh84XFi6onZppsnD3thTHQIxV,SpATywNh6bZuzm8s1ceuBUnMUAeoAHHw,13,16,11,0,8,1,11,1,48,6.857142857142857,3,0.0,0,11,0,8,16,1,0,11,1,19,29,1
7049,91117,BbiSpjLUYXccDuntMMtC8mx0riONNKqb,bWdj2GDclj5ofokWjzoa5jAwMkxCykd6,5,2,1,0,1,0,2,0,6,0.8571428571428571,1,0.0,0,1,0,1,2,0,0,2,0,2,4,1
7050,91121,7LnOg1xHmRDTcvzCdFBumEhAPUujuxnu,SpATywNh6bZuzm8s1ceuBUnMUAeoAHHw,7,12,1,0,1,0,4,0,18,2.5714285714285716,1,0.0,0,1,0,1,12,0,0,4,0,2,16,1
7051,91124,EiO5bky9R1Iqlpv4ItUpPBUgGb1eJItE,RXDvfPUBYFlVdlueBFbLW0mhhAyGEqpt,1,0,0,0,0,0,1,0,1,0.14285714285714285,1,0.0,0,0,0,0,0,0,0,1,0,0,1,1
7052,91127,Dtyef0XPp5AB6qcxARHBVaIqOwKhnCJD,RXDvfPUBYFlVdlueBFbLW0mhhAyGEqpt,17,17,12,14,6,13,6,0,68,9.714285714285714,1,0.0,1,12,13,6,16,13,1,6,0,32,36,1
7053,91131,q5brbl1IUGTW0QCDlsOmPM8P083V7zR9,SpATywNh6bZuzm8s1ceuBUnMUAeoAHHw,1,0,0,0,0,0,1,0,1,0.14285714285714285,1,0.0,0,0,0,0,0,0,0,1,0,0,1,1
7054,91132,92Eer7xGYFDCorN4RAF4CYzwZt5RGCcT,SpATywNh6bZuzm8s1ceuBUnMUAeoAHHw,1,0,0,0,0,0,1,0,1,0.14285714285714285,1,0.0,0,0,0,0,0,0,0,1,0,0,1,1
7055,91143,hx5sJ7jwWSrYbv8AAwrwIYlkyA5lh0xw,SpATywNh6bZuzm8s1ceuBUnMUAeoAHHw,2,0,0,0,0,0,2,0,2,0.2857142857142857,1,0.0,0,0,0,0,0,0,0,2,0,0,2,1
7056,91145,im3SIH2rxe8iUb1VWEDrDsuvwOO0Qeuq,SpATywNh6bZuzm8s1ceuBUnMUAeoAHHw,1,0,0,0,0,0,1,0,1,0.14285714285714285,1,0.0,0,0,0,0,0,0,0,1,0,0,1,1
7057,91146,5kux74rVeqoEvbABYMpdIOO6ta3zLim7,SpATywNh6bZuzm8s1ceuBUnMUAeoAHHw,6,10,1,0,0,0,3,0,14,2.0,1,0.0,0,1,0,0,10,0,0,3,0,1,13,1
7058,91148,mirL98pOfRc0QA1dI8m4EOtFFog8KIsB,SpATywNh6bZuzm8s1ceuBUnMUAeoAHHw,6,11,2,0,0,0,3,0,16,2.2857142857142856,3,0.0,0,2,0,0,11,0,0,3,0,2,14,1
7059,91151,EpEDPL39pwbGw6HcHWJhf2GDqySvaN1h,SpATywNh6bZuzm8s1ceuBUnMUAeoAHHw,6,2,1,0,1,0,2,0,6,0.8571428571428571,1,0.0,0,1,0,1,2,0,0,2,0,2,4,1
7060,91158,B4jOMU8eQLApET1YBx1fXCzcdODxsgi8,bWdj2GDclj5ofokWjzoa5jAwMkxCykd6,7,9,1,0,2,0,2,0,14,2.0,1,0.0,2,1,0,2,7,0,0,2,0,5,9,1
7061,91159,O7hnrNbVuVSYYY4GiDlB8jr4kCwVIU3W,SpATywNh6bZuzm8s1ceuBUnMUAeoAHHw,1,0,0,0,0,0,7,0,7,1.0,1,0.0,0,0,0,0,0,0,0,7,0,0,7,1
7062,91160,urxyBMLwqPoccprp1W7NCQtPStGZDqxd,SpATywNh6bZuzm8s1ceuBUnMUAeoAHHw,5,2,1,0,1,0,4,0,8,1.1428571428571428,2,0.0,0,1,0,1,2,0,0,4,0,2,6,1
7063,91162,ORT6fH4QpWfdVApgOFbiZIUgnndzWNam,SpATywNh6bZuzm8s1ceuBUnMUAeoAHHw,21,30,20,14,12,3,6,0,85,12.142857142857142,3,0.0,6,20,11,12,24,3,3,6,0,49,36,0
7064,91167,XMtcnsDNasKCOMBWrsjCVH5NONQyEryR,bWdj2GDclj5ofokWjzoa5jAwMkxCykd6,21,42,23,122,7,0,12,0,206,29.428571428571427,3,0.0,12,23,118,7,30,0,4,12,0,160,46,0
7065,91171,XMIsZqrfw7qqk0EIVzNsPndKXVTScrCr,SpATywNh6bZuzm8s1ceuBUnMUAeoAHHw,16,22,10,17,4,5,7,1,66,9.428571428571429,1,0.0,6,10,15,4,16,5,2,7,1,35,31,1
7066,91172,EJfQNb5Mu8lcO1ocmk4PtmUhkW8FMGb9,RXDvfPUBYFlVdlueBFbLW0mhhAyGEqpt,7,10,4,0,2,0,3,0,19,2.7142857142857144,3,0.0,0,4,0,2,10,0,0,3,0,6,13,0
7067,91173,wdzOHZGShaydEKxmovJEzQ6EMiqynMte,SpATywNh6bZuzm8s1ceuBUnMUAeoAHHw,14,50,14,26,0,18,11,2,121,17.285714285714285,3,0.0,29,14,20,0,21,18,6,11,2,63,58,1
7068,91178,ogkoDosyBhbZAvybtPbmcuc4tjatNf2P,G8EPVSXsOYB5YQWZGiz1aVq5Pgr2GrQu,17,36,30,22,16,0,4,0,108,15.428571428571429,2,0.0,0,30,18,16,36,0,4,4,0,64,44,1
7069,91182,H1VDSbfLdFN8dYSqCsn4o54mYdltgayR,SpATywNh6bZuzm8s1ceuBUnMUAeoAHHw,1,0,0,0,0,0,1,0,1,0.14285714285714285,1,0.0,0,0,0,0,0,0,0,1,0,0,1,1
7070,91184,v5DL1tRN6AvAeQThFmEHNCo6sn5M6uIG,SpATywNh6bZuzm8s1ceuBUnMUAeoAHHw,12,14,6,19,4,0,1,0,44,6.285714285714286,1,0.0,5,6,17,4,9,0,2,1,0,32,12,1
7071,91190,HHjw6PARN0UbkiffbOwvG4RULtVIyY0R,bWdj2GDclj5ofokWjzoa5jAwMkxCykd6,1,0,0,0,0,0,1,0,1,0.14285714285714285,1,0.0,0,0,0,0,0,0,0,1,0,0,1,1
7072,91204,JwpnWAbXqqokshNbyxBH2QHaOUPb8wrj,G8EPVSXsOYB5YQWZGiz1aVq5Pgr2GrQu,11,24,1,0,1,1,11,2,40,5.714285714285714,2,0.0,1,1,0,1,23,1,0,11,2,3,37,0
7073,91207,37tZi453KKWhJoY7icXXq6XTM7CZX5cD,SpATywNh6bZuzm8s1ceuBUnMUAeoAHHw,14,16,0,21,0,3,10,2,52,7.428571428571429,1,0.0,4,0,17,0,12,3,4,10,2,21,31,1
7074,91208,tPYh43YRHAzuf09xESxSKtWvST0aCsjn,RXDvfPUBYFlVdlueBFbLW0mhhAyGEqpt,1,0,0,0,0,0,1,0,1,0.14285714285714285,1,0.0,0,0,0,0,0,0,0,1,0,0,1,1
7075,91214,Rd7eeroPlO4BVZv0bnl0CqHm3u7jCGNe,SpATywNh6bZuzm8s1ceuBUnMUAeoAHHw,12,17,8,0,6,6,4,0,41,5.857142857142857,1,0.0,0,8,0,6,17,6,0,4,0,14,27,1
7076,91215,AXWWqNDiRDejTjo5V7yUaMbjtzXKhlP0,bWdj2GDclj5ofokWjzoa5jAwMkxCykd6,6,5,2,0,1,3,3,0,14,2.0,1,0.0,2,2,0,1,3,3,0,3,0,5,9,1
7077,91217,Zw1bdKbgaMzUzlqlieQSaucEQ8wggZlx,G8EPVSXsOYB5YQWZGiz1aVq5Pgr2GrQu,9,14,5,0,3,0,3,0,25,3.5714285714285716,1,0.0,0,5,0,3,14,0,0,3,0,8,17,1
7078,91220,TXdA343riqqgy7iMdaooNvyNV5wjOdTg,SpATywNh6bZuzm8s1ceuBUnMUAeoAHHw,1,0,0,0,0,0,3,0,3,0.42857142857142855,1,0.0,0,0,0,0,0,0,0,3,0,0,3,1
7079,91221,2FMy3BDMeRecSDtTTnOKB2d19YsmeIUm,SpATywNh6bZuzm8s1ceuBUnMUAeoAHHw,17,15,9,6,5,12,11,2,60,8.571428571428571,1,0.0,4,9,6,5,11,12,0,11,2,24,36,1
7080,91228,14pD3OA8ZEvWCgDfU1fYkv0M9pXxNW5u,SpATywNh6bZuzm8s1ceuBUnMUAeoAHHw,14,34,0,19,0,11,14,5,83,11.857142857142858,2,0.0,15,0,17,0,19,11,2,14,5,32,51,0
7081,91243,eds8bJvJ9xWp5J9qVgS3pSKJpcp9ssMO,RXDvfPUBYFlVdlueBFbLW0mhhAyGEqpt,18,22,11,20,5,0,5,0,63,9.0,1,0.0,4,11,20,5,18,0,0,5,0,40,23,1
7082,91250,XdYuk6m8JAApvXFcBONfmeC52I0301IJ,SpATywNh6bZuzm8s1ceuBUnMUAeoAHHw,3,2,0,0,0,0,1,0,3,0.42857142857142855,1,0.0,0,0,0,0,2,0,0,1,0,0,3,1
7083,91251,69mjZoNGtUdd47OHaI2iQubsVwSBE5CT,RXDvfPUBYFlVdlueBFbLW0mhhAyGEqpt,7,3,2,0,1,1,6,1,14,2.0,2,0.0,0,2,0,1,3,1,0,6,1,3,11,1
7084,91253,XdYuk6m8JAApvXFcBONfmeC52I0301IJ,G8EPVSXsOYB5YQWZGiz1aVq5Pgr2GrQu,3,2,0,0,0,0,1,0,3,0.42857142857142855,1,0.0,0,0,0,0,2,0,0,1,0,0,3,1
7085,91254,3BYgVMhPAaxlk6STVmLlShJjZEZk9Ygh,G8EPVSXsOYB5YQWZGiz1aVq5Pgr2GrQu,7,5,4,8,2,0,1,0,20,2.857142857142857,1,0.0,0,4,6,2,5,0,2,1,0,12,8,1
7086,91257,WCmDosmdgfMjDVmsfhMjruGatZmceBZ1,G8EPVSXsOYB5YQWZGiz1aVq5Pgr2GrQu,10,10,1,0,2,2,8,2,25,3.5714285714285716,1,0.0,4,1,0,2,6,2,0,8,2,7,18,1
7087,91263,mpFcyQQmc8dk989EyC0qjuZYiRIdPGUA,G8EPVSXsOYB5YQWZGiz1aVq5Pgr2GrQu,15,14,11,18,5,0,2,0,50,7.142857142857143,2,0.0,0,11,14,5,14,0,4,2,0,30,20,1
7088,91264,Ydgz8POU25ETYijca209j0OeGw9lAoWU,RXDvfPUBYFlVdlueBFbLW0mhhAyGEqpt,6,3,2,0,1,1,4,1,12,1.7142857142857142,1,0.0,0,2,0,1,3,1,0,4,1,3,9,1
7089,91270,1g8yBUc3cHuCmwlbkVdrck4LA6Kk4jp8,SpATywNh6bZuzm8s1ceuBUnMUAeoAHHw,1,0,0,0,0,0,1,0,1,0.14285714285714285,1,0.0,0,0,0,0,0,0,0,1,0,0,1,1
7090,91271,xsGCEWhbZlUdlgrI9YmAsQkfbCuoHlqr,SpATywNh6bZuzm8s1ceuBUnMUAeoAHHw,3,2,0,0,0,0,1,0,3,0.42857142857142855,1,0.0,0,0,0,0,2,0,0,1,0,0,3,1
7091,91272,Xl4Lzddy8Aw3656QCmyajshZUF8lGm25,G8EPVSXsOYB5YQWZGiz1aVq5Pgr2GrQu,8,5,3,0,1,4,3,1,17,2.4285714285714284,1,0.0,0,3,0,1,5,4,0,3,1,4,13,1
7092,91274,Ub05s2SQ9ZHQTwcGaeWGVwMVL3ugFxRh,SpATywNh6bZuzm8s1ceuBUnMUAeoAHHw,18,19,8,11,3,2,9,1,53,7.571428571428571,2,0.0,8,8,11,3,11,2,0,9,1,30,23,1
7093,91278,g5Cdwy5RdXfNsnVJb5dTAjZFbf2MEVG0,bWdj2GDclj5ofokWjzoa5jAwMkxCykd6,5,13,7,0,5,0,3,0,28,4.0,2,0.0,0,7,0,5,13,0,0,3,0,12,16,1
7094,91284,3a9jnl6D615xvyDPr3X72Qm6tyAqQDq6,SpATywNh6bZuzm8s1ceuBUnMUAeoAHHw,5,0,0,0,0,2,6,1,9,1.2857142857142858,1,0.0,0,0,0,0,0,2,0,6,1,0,9,1
7095,91287,Xl4Lzddy8Aw3656QCmyajshZUF8lGm25,SpATywNh6bZuzm8s1ceuBUnMUAeoAHHw,14,19,6,22,3,8,4,0,62,8.857142857142858,1,0.0,10,6,19,3,9,8,3,4,0,38,24,1
7096,91299,3lDn61j7LQx2ct2mXSyFAxE4I2joOjdi,SpATywNh6bZuzm8s1ceuBUnMUAeoAHHw,16,16,5,19,3,4,7,1,55,7.857142857142857,1,0.0,10,5,16,3,6,4,3,7,1,34,21,1
7097,91300,UZj9qZ6lkWkIz7HEEFyBh5LFRNaz4SI2,SpATywNh6bZuzm8s1ceuBUnMUAeoAHHw,11,15,1,6,1,0,4,0,27,3.857142857142857,3,0.0,0,1,5,1,15,0,1,4,0,7,20,1
7098,91302,CuRQgxEa02jfJLJUhEm7AKFBwc2Dt3PE,SpATywNh6bZuzm8s1ceuBUnMUAeoAHHw,10,15,7,7,0,0,4,0,33,4.714285714285714,1,0.0,0,7,6,0,15,0,1,4,0,13,20,1
7099,91304,VYmODogcHFHSX4vALahPhItYfFc245Hp,RXDvfPUBYFlVdlueBFbLW0mhhAyGEqpt,21,28,17,31,5,1,9,0,91,13.0,2,0.0,5,17,26,5,23,1,5,9,0,53,38,1
7100,91307,MHM1aXC71Dw383yBooXdYF1qDKYHoccv,bWdj2GDclj5ofokWjzoa5jAwMkxCykd6,1,0,0,0,0,0,1,0,1,0.14285714285714285,1,0.0,0,0,0,0,0,0,0,1,0,0,1,1
7101,91310,MHM1aXC71Dw383yBooXdYF1qDKYHoccv,SpATywNh6bZuzm8s1ceuBUnMUAeoAHHw,4,2,1,0,1,0,2,0,6,0.8571428571428571,1,0.0,0,1,0,1,2,0,0,2,0,2,4,1
7102,91312,LmrXz112hM3lsrkiQcTLgB1CQdX7OPmf,RXDvfPUBYFlVdlueBFbLW0mhhAyGEqpt,23,22,16,30,10,1,5,1,85,12.142857142857142,1,0.0,4,16,27,10,18,1,3,5,1,57,28,1
7103,91325,q5vo1hp0Q9QDxbtjHEkZyC7Vz9AYHKaw,G8EPVSXsOYB5YQWZGiz1aVq5Pgr2GrQu,1,0,0,0,0,0,1,0,1,0.14285714285714285,1,0.0,0,0,0,0,0,0,0,1,0,0,1,1
7104,91328,OZaq72DmJH6bReA6lKvO4XbWYjmwsu42,bWdj2GDclj5ofokWjzoa5jAwMkxCykd6,18,22,8,98,4,0,7,0,139,19.857142857142858,4,0.0,6,8,92,4,16,0,6,7,0,110,29,1
7105,91333,xRrdKDq0SR8avtZTCYAseO6HdCVb8m0M,bWdj2GDclj5ofokWjzoa5jAwMkxCykd6,9,13,5,43,2,13,8,6,90,12.857142857142858,1,0.0,5,5,42,2,8,13,1,8,6,54,36,1
7106,91337,OtHqAfAnlt18GaEWyak2S1YVbRKxCTZV,bWdj2GDclj5ofokWjzoa5jAwMkxCykd6,1,0,0,0,0,0,1,0,1,0.14285714285714285,1,0.0,0,0,0,0,0,0,0,1,0,0,1,1
7107,91346,b4VAhvG3MG7lVRCMYGT7EV06rJVZjoZJ,SpATywNh6bZuzm8s1ceuBUnMUAeoAHHw,6,5,1,0,1,0,2,0,9,1.2857142857142858,2,0.0,0,1,0,1,5,0,0,2,0,2,7,1
7108,91357,CqJyXqN2l3WOJQLqxchvfRFp3seiLXw6,bWdj2GDclj5ofokWjzoa5jAwMkxCykd6,6,8,3,0,2,0,2,1,16,2.2857142857142856,1,0.0,3,3,0,2,5,0,0,2,1,8,8,1
7109,91358,za2dBkPPLD9IPRBjooK7GJit2ulI5UgN,RXDvfPUBYFlVdlueBFbLW0mhhAyGEqpt,1,0,0,0,0,0,1,0,1,0.14285714285714285,1,0.0,0,0,0,0,0,0,0,1,0,0,1,1
7110,91359,qlATuCCqDpQGO38aosxnvWXoyFwzEQc6,SpATywNh6bZuzm8s1ceuBUnMUAeoAHHw,1,0,0,0,0,0,1,0,1,0.14285714285714285,1,0.0,0,0,0,0,0,0,0,1,0,0,1,1
7111,91360,Y7IgoRAqVJfNlsulCSI4HObujHPSzoLA,bWdj2GDclj5ofokWjzoa5jAwMkxCykd6,16,31,16,18,9,1,9,0,84,12.0,3,0.0,9,16,15,9,22,1,3,9,0,49,35,1
7112,91363,LrkrvySxDPWP0dPv0sy62S8XY8vaxevX,SpATywNh6bZuzm8s1ceuBUnMUAeoAHHw,1,0,0,0,0,0,1,0,1,0.14285714285714285,1,0.0,0,0,0,0,0,0,0,1,0,0,1,1
7113,91364,PERCKVrZOUZ9ZmdU3J0Mwd1TZrMvK8yc,bWdj2GDclj5ofokWjzoa5jAwMkxCykd6,1,0,0,0,0,0,1,0,1,0.14285714285714285,1,0.0,0,0,0,0,0,0,0,1,0,0,1,1
7114,91370,A8jyl8S1kU5U2ikqJ1w16Eh9QcSPe3kU,bWdj2GDclj5ofokWjzoa5jAwMkxCykd6,10,6,2,36,1,14,9,0,68,9.714285714285714,3,0.0,1,2,35,1,5,14,1,9,0,39,29,1
7115,91372,KdRLGDNkLtrOcdNI9HZrV8CuGZ4u276z,SpATywNh6bZuzm8s1ceuBUnMUAeoAHHw,6,3,2,0,2,0,1,0,8,1.1428571428571428,1,0.0,0,2,0,2,3,0,0,1,0,4,4,1
7116,91378,2GLZl96ZIgoKdw26t6xniq9LngPm9HvA,RXDvfPUBYFlVdlueBFbLW0mhhAyGEqpt,1,0,0,0,0,0,1,0,1,0.14285714285714285,1,0.0,0,0,0,0,0,0,0,1,0,0,1,1
7117,91382,UmS6fyVqoZGfOpZXm4pjngyByXpv5BZq,SpATywNh6bZuzm8s1ceuBUnMUAeoAHHw,2,0,0,0,0,0,2,0,2,0.2857142857142857,1,0.0,0,0,0,0,0,0,0,2,0,0,2,1
7118,91400,mP7T5RBRG5ILBmmKKL1ktjST3p6gGZyD,G8EPVSXsOYB5YQWZGiz1aVq5Pgr2GrQu,27,33,16,54,10,8,17,3,141,20.142857142857142,2,0.0,7,16,46,10,26,8,8,17,3,79,62,0
7119,91402,95hqHTSw1gz1emf3tVFfyk36gKJr0SpD,SpATywNh6bZuzm8s1ceuBUnMUAeoAHHw,5,2,1,0,1,0,3,0,7,1.0,1,0.0,0,1,0,1,2,0,0,3,0,2,5,1
7120,91403,poUZo66KaOJLyZ89MU32hotzwVV9BV0u,SpATywNh6bZuzm8s1ceuBUnMUAeoAHHw,11,9,0,10,0,4,6,2,31,4.428571428571429,1,0.0,2,0,8,0,7,4,2,6,2,10,21,1
7121,91412,WS43utSG33bYCMf9KzrbX5AdwBBQGbjp,G8EPVSXsOYB5YQWZGiz1aVq5Pgr2GrQu,7,2,1,0,1,0,4,1,9,1.2857142857142858,1,0.0,0,1,0,1,2,0,0,4,1,2,7,1
7122,91418,guY4SSn1fy4TWThod7s2lBFrUtiOX15g,SpATywNh6bZuzm8s1ceuBUnMUAeoAHHw,1,0,0,0,0,0,1,0,1,0.14285714285714285,1,0.0,0,0,0,0,0,0,0,1,0,0,1,1
7123,91425,Kp4YCt5gbTMeLX4vxDVqvPhrGDdHDcEC,bWdj2GDclj5ofokWjzoa5jAwMkxCykd6,1,0,0,0,0,0,1,0,1,0.14285714285714285,1,0.0,0,0,0,0,0,0,0,1,0,0,1,1
7124,91440,FiJs6t54TQx94XiEoXWiArjFjkJV5FwV,SpATywNh6bZuzm8s1ceuBUnMUAeoAHHw,5,2,1,0,1,0,2,0,6,0.8571428571428571,1,0.0,0,1,0,1,2,0,0,2,0,2,4,1
7125,91443,KUB7X44VbEjxMDVZF3W29K5D0UgPC6KH,SpATywNh6bZuzm8s1ceuBUnMUAeoAHHw,1,0,0,0,0,0,1,0,1,0.14285714285714285,1,0.0,0,0,0,0,0,0,0,1,0,0,1,1
7126,91447,tf4ZGAY33jZAuxFy4GuZb8bCcW9cJu8C,SpATywNh6bZuzm8s1ceuBUnMUAeoAHHw,1,0,0,0,0,0,3,0,3,0.42857142857142855,1,0.0,0,0,0,0,0,0,0,3,0,0,3,1
7127,91448,IRULN38M25Cl78bawBWQTQjcpwpaaNDt,SpATywNh6bZuzm8s1ceuBUnMUAeoAHHw,20,37,0,34,0,2,11,4,88,12.571428571428571,3,0.0,15,0,28,0,22,2,6,11,4,43,45,1
7128,91455,iXxs6D3heezRYy4j7tliC14ux3klsjwX,SpATywNh6bZuzm8s1ceuBUnMUAeoAHHw,9,7,0,10,0,0,4,0,21,3.0,2,0.0,2,0,8,0,5,0,2,4,0,10,11,1
7129,91470,QGuKTIBC2KLaYpPdOnB4nXCWgxMM1Dog,SpATywNh6bZuzm8s1ceuBUnMUAeoAHHw,7,4,3,0,2,0,1,0,10,1.4285714285714286,1,0.0,0,3,0,2,4,0,0,1,0,5,5,0
7130,91476,TRCrdidmG6eXWyA1xpJbOiCViWff58Ia,RXDvfPUBYFlVdlueBFbLW0mhhAyGEqpt,35,26,16,42,11,1,6,0,102,14.571428571428571,2,0.0,5,16,39,11,21,1,3,6,0,71,31,1
7131,91479,7wwnUxCzQI2wyfpl5OyzTa3WTS3Ri45e,bWdj2GDclj5ofokWjzoa5jAwMkxCykd6,8,9,5,0,2,1,14,1,32,4.571428571428571,5,0.0,0,5,0,2,9,1,0,14,1,7,25,1
7132,91482,LOVxi1n45DRmVnmmx6W7w15Zc3W4DL9Q,SpATywNh6bZuzm8s1ceuBUnMUAeoAHHw,5,2,1,0,1,0,2,0,6,0.8571428571428571,1,0.0,0,1,0,1,2,0,0,2,0,2,4,1
7133,91485,iEQmrsDBbeOrnopk2RwtHZMbNkoYEU8q,SpATywNh6bZuzm8s1ceuBUnMUAeoAHHw,13,12,5,0,3,1,7,1,29,4.142857142857143,1,0.0,2,5,0,3,10,1,0,7,1,10,19,0
7134,91491,CwyOL3RMOVLomxrxyN9D4jPa9R0iWrS5,SpATywNh6bZuzm8s1ceuBUnMUAeoAHHw,30,39,23,17,12,1,14,1,107,15.285714285714286,4,0.0,6,23,16,12,33,1,1,14,1,57,50,1
7135,91494,Zdseq1rQmkAi5wZl57d3RwjzOxlL3B5I,bWdj2GDclj5ofokWjzoa5jAwMkxCykd6,1,0,0,0,0,0,1,0,1,0.14285714285714285,1,0.0,0,0,0,0,0,0,0,1,0,0,1,1
7136,91496,iX8db0h4bK73Weo8AP1BXtlfn6xSOf6w,bWdj2GDclj5ofokWjzoa5jAwMkxCykd6,6,7,4,0,2,0,7,0,20,2.857142857142857,2,0.0,1,4,0,2,6,0,0,7,0,7,13,1
7137,91500,cGHoibSqVUbVlKoJgTJL9GQ2AhPLVzAA,SpATywNh6bZuzm8s1ceuBUnMUAeoAHHw,5,2,1,0,1,0,2,0,6,0.8571428571428571,1,0.0,0,1,0,1,2,0,0,2,0,2,4,1
7138,91505,NjgQeSBBMWIwQySsR5ymtqiugkMaOyYh,SpATywNh6bZuzm8s1ceuBUnMUAeoAHHw,6,10,4,0,0,0,3,0,17,2.4285714285714284,1,0.0,1,4,0,0,9,0,0,3,0,5,12,1
7139,91508,CoIppafSfTN9XDj22SO0MlvO24IGW3qc,SpATywNh6bZuzm8s1ceuBUnMUAeoAHHw,5,3,1,0,1,0,2,0,7,1.0,1,0.0,0,1,0,1,3,0,0,2,0,2,5,1
7140,91509,sytW49I21SJ70ElOkXGU5SHeeHl1E3fL,bWdj2GDclj5ofokWjzoa5jAwMkxCykd6,9,9,4,4,1,0,11,2,31,4.428571428571429,3,0.0,1,4,3,1,8,0,1,11,2,9,22,1
7141,91515,HMYpimZGFgj5IczDutkfjUfnxl45PoHW,bWdj2GDclj5ofokWjzoa5jAwMkxCykd6,12,20,12,0,6,1,8,1,48,6.857142857142857,3,0.0,3,12,0,6,17,1,0,8,1,21,27,1
7142,91519,INi9R682jCcjSCeRDCpuPIJvFgA3WCPK,SpATywNh6bZuzm8s1ceuBUnMUAeoAHHw,4,4,0,0,0,0,3,0,7,1.0,1,0.0,0,0,0,0,4,0,0,3,0,0,7,1
7143,91523,zTDlJM8GToOfxmvivD5zWrgVHrXjTey0,SpATywNh6bZuzm8s1ceuBUnMUAeoAHHw,5,3,1,0,1,0,1,0,6,0.8571428571428571,1,0.0,0,1,0,1,3,0,0,1,0,2,4,1
7144,91527,8Juk29xSxX3yy5MeVUlmmq4TGH5jCyZl,bWdj2GDclj5ofokWjzoa5jAwMkxCykd6,1,0,0,0,0,0,1,0,1,0.14285714285714285,1,0.0,0,0,0,0,0,0,0,1,0,0,1,1
7145,91546,4ZKN4qjeNhliROr2sm8vB8zmpPTrlPXO,bWdj2GDclj5ofokWjzoa5jAwMkxCykd6,1,0,0,0,0,0,1,0,1,0.14285714285714285,1,0.0,0,0,0,0,0,0,0,1,0,0,1,1
7146,91551,HRDkxtbUq1mjWiCFLcR4tjQW2mCEHxu4,RXDvfPUBYFlVdlueBFbLW0mhhAyGEqpt,18,25,14,0,9,8,20,13,89,12.714285714285714,2,0.0,3,14,0,9,22,8,0,20,13,26,63,1
7147,91553,95ZATSYX39rVcaPDxHBCcw9smfWWWOJE,G8EPVSXsOYB5YQWZGiz1aVq5Pgr2GrQu,4,2,0,0,0,0,2,0,4,0.5714285714285714,1,0.0,0,0,0,0,2,0,0,2,0,0,4,1
7148,91561,JaxQCd7UV5o1rvWxAibMy6iOMU3fCV5H,G8EPVSXsOYB5YQWZGiz1aVq5Pgr2GrQu,2,0,0,0,0,0,2,0,2,0.2857142857142857,1,0.0,0,0,0,0,0,0,0,2,0,0,2,1
7149,91563,CV9JyLcIlYcf3I8rF9dkDEhChf1GM9os,G8EPVSXsOYB5YQWZGiz1aVq5Pgr2GrQu,5,5,1,0,1,0,2,0,9,1.2857142857142858,1,0.0,0,1,0,1,5,0,0,2,0,2,7,1
7150,91565,Yc7DWSMOX4qXPZYRvYXJRnfQO7mqesrH,SpATywNh6bZuzm8s1ceuBUnMUAeoAHHw,9,8,2,8,1,0,2,0,21,3.0,1,0.0,4,2,6,1,4,0,2,2,0,13,8,1
7151,91571,M3CWdGPorPClU70a2twe6L8itu10pmZS,SpATywNh6bZuzm8s1ceuBUnMUAeoAHHw,1,0,0,0,0,0,1,0,1,0.14285714285714285,1,0.0,0,0,0,0,0,0,0,1,0,0,1,1
7152,91572,tl6eW0ZllZHnwqWfi7Wfg5VpXnj5pUEg,SpATywNh6bZuzm8s1ceuBUnMUAeoAHHw,15,11,5,12,3,0,4,0,35,5.0,1,0.0,4,5,10,3,7,0,2,4,0,22,13,1
7153,91575,nzicLrGs2CkHsGEmCwyxF4pye3Bqo62U,G8EPVSXsOYB5YQWZGiz1aVq5Pgr2GrQu,10,6,4,0,3,0,2,0,15,2.142857142857143,1,0.0,1,4,0,3,5,0,0,2,0,8,7,1
7154,91578,Zh7CYVhvtUUFf70foMQSgpBF0IOlRY9B,SpATywNh6bZuzm8s1ceuBUnMUAeoAHHw,5,2,1,0,1,0,2,0,6,0.8571428571428571,1,0.0,0,1,0,1,2,0,0,2,0,2,4,1
7155,91584,JBjA243ZRIqgCsAm61lG2qOhZbNcozpv,G8EPVSXsOYB5YQWZGiz1aVq5Pgr2GrQu,12,16,3,0,2,1,7,1,30,4.285714285714286,3,0.0,1,3,0,2,15,1,0,7,1,6,24,1
7156,91586,vOpj8ur6jA13uE8NuDJFu1oyU88RJP1w,bWdj2GDclj5ofokWjzoa5jAwMkxCykd6,4,8,0,0,0,0,2,0,10,1.4285714285714286,2,0.0,0,0,0,0,8,0,0,2,0,0,10,1
7157,91589,JBjA243ZRIqgCsAm61lG2qOhZbNcozpv,SpATywNh6bZuzm8s1ceuBUnMUAeoAHHw,5,5,1,0,0,0,4,0,10,1.4285714285714286,1,0.0,0,1,0,0,5,0,0,4,0,1,9,1
7158,91591,Jp26ywpmjw8PCn9zJ6Emr3JwxCXz1vqU,SpATywNh6bZuzm8s1ceuBUnMUAeoAHHw,14,21,1,18,1,9,12,0,62,8.857142857142858,5,0.0,2,1,15,1,19,9,3,12,0,19,43,1
7159,91592,rzAa0SbIuqxRiUHWVTPJbitOwzhhOEdv,G8EPVSXsOYB5YQWZGiz1aVq5Pgr2GrQu,8,16,7,6,0,0,4,0,33,4.714285714285714,1,0.0,6,7,5,0,10,0,1,4,0,18,15,1
7160,91593,PizUKf6mRUas66X3VMYXf9aygnN1CUCf,bWdj2GDclj5ofokWjzoa5jAwMkxCykd6,8,12,5,0,6,0,3,0,26,3.7142857142857144,1,0.0,5,5,0,6,7,0,0,3,0,16,10,1
7161,91595,gDaSFJD4b80GGtFaPG7wjh3sxtnlKrIT,SpATywNh6bZuzm8s1ceuBUnMUAeoAHHw,26,41,15,25,8,4,10,2,105,15.0,6,0.0,14,15,23,8,27,4,2,10,2,60,45,0
7162,91597,GsuSgvyvG4oCfnW3UaGKEeHZUImW7ybU,RXDvfPUBYFlVdlueBFbLW0mhhAyGEqpt,6,3,1,0,1,0,2,0,7,1.0,1,0.0,0,1,0,1,3,0,0,2,0,2,5,1
7163,92825,DuFXvlMxtAdxfnPOoOZpxEKgHTS36vNK,A3fsA9Zfv1X2fVEQhTw51lKENdNrEqT3,32,15,13,56,9,0,6,0,99,14.142857142857142,2,0.0,0,13,46,9,15,0,10,6,0,68,31,1
7164,92827,ZEbdtmjZoFNJAd6x9CZyfsFMmBEwQpXv,SpATywNh6bZuzm8s1ceuBUnMUAeoAHHw,13,11,8,0,5,1,7,1,33,4.714285714285714,2,0.0,0,8,0,5,11,1,0,7,1,13,20,1
7165,92860,msWTEJiXPD0IrE0kyLI7rGT23zUS4bM8,A3fsA9Zfv1X2fVEQhTw51lKENdNrEqT3,1,0,0,0,0,0,1,0,1,0.14285714285714285,1,0.0,0,0,0,0,0,0,0,1,0,0,1,1
7166,92870,nCB7ViHcbXHrq91Tw7AsIMYmLiKIa5Jv,A3fsA9Zfv1X2fVEQhTw51lKENdNrEqT3,4,1,0,0,0,0,5,0,6,0.8571428571428571,1,0.0,0,0,0,0,1,0,0,5,0,0,6,1
7167,92890,HJ2gv3yF0WCJxGH8T6tjLTFYdM4sCizz,SpATywNh6bZuzm8s1ceuBUnMUAeoAHHw,16,16,10,12,6,6,7,0,57,8.142857142857142,2,0.0,4,10,9,6,12,6,3,7,0,29,28,1
7168,92931,09jqR7IfvazajqsgYnjd0mGOuTyUXJmR,A3fsA9Zfv1X2fVEQhTw51lKENdNrEqT3,2,0,0,0,0,0,2,0,2,0.2857142857142857,1,0.0,0,0,0,0,0,0,0,2,0,0,2,1
7169,92933,Mf0xp5vhxE4EpnovGXm23q0TRlnpal5a,SpATywNh6bZuzm8s1ceuBUnMUAeoAHHw,1,0,0,0,0,0,1,0,1,0.14285714285714285,1,0.0,0,0,0,0,0,0,0,1,0,0,1,1
7170,92944,9HqwJ8d4m6K7QOSGhF3dVzXYAYpOl0vj,A3fsA9Zfv1X2fVEQhTw51lKENdNrEqT3,2,0,0,0,0,0,2,0,2,0.2857142857142857,1,0.0,0,0,0,0,0,0,0,2,0,0,2,1
7171,92947,xVCW9o5KqxAPnPVb1aenUpUZ6QWvEQCo,A3fsA9Zfv1X2fVEQhTw51lKENdNrEqT3,6,7,6,0,0,0,1,0,14,2.0,1,0.0,0,6,0,0,7,0,0,1,0,6,8,1
7172,92954,erkNYBqLpKRElyeL8GeAgO43CMazg6Rt,bWdj2GDclj5ofokWjzoa5jAwMkxCykd6,2,0,0,0,0,0,6,0,6,0.8571428571428571,2,0.0,0,0,0,0,0,0,0,6,0,0,6,1
7173,92957,DsdpjqDmkf4bB9F4w67WvhR5rXeY4BvC,bWdj2GDclj5ofokWjzoa5jAwMkxCykd6,11,18,7,0,6,27,11,1,70,10.0,1,0.0,7,7,0,6,11,27,0,11,1,20,50,1
7174,92960,3aETBFRObq3YeSOCDzQSdXdbqZJSuHf3,A3fsA9Zfv1X2fVEQhTw51lKENdNrEqT3,5,4,0,0,0,0,1,0,5,0.7142857142857143,1,0.0,0,0,0,0,4,0,0,1,0,0,5,1
7175,92962,4JgrlxTTs75mHh4mrh8qrfNDEELryL3p,bWdj2GDclj5ofokWjzoa5jAwMkxCykd6,12,15,6,18,42,0,4,0,85,12.142857142857142,1,0.0,2,6,16,42,13,0,2,4,0,66,19,1
7176,92968,eD22YcO1SJ996J45uu5dqIqwhKfXceL1,SpATywNh6bZuzm8s1ceuBUnMUAeoAHHw,3,2,1,0,1,0,0,0,4,0.5714285714285714,1,0.0,0,1,0,1,2,0,0,0,0,2,2,1
7177,92972,NXRVwFyxLXtyRtxM7ojyAnaiZQnhtjWO,SpATywNh6bZuzm8s1ceuBUnMUAeoAHHw,3,3,1,0,0,0,1,0,5,0.7142857142857143,1,0.0,0,1,0,0,3,0,0,1,0,1,4,1
7178,92975,mblW3W0a9cnUCcAYuJVrRwCReLzIZfZq,A3fsA9Zfv1X2fVEQhTw51lKENdNrEqT3,27,11,1,60,0,6,12,1,91,13.0,2,0.0,4,1,54,0,7,6,6,12,1,59,32,0
7179,92986,QKIVpxTYRwxpGiT6VdCFipdI87gZtHRH,SpATywNh6bZuzm8s1ceuBUnMUAeoAHHw,6,1,1,0,1,0,5,0,8,1.1428571428571428,1,0.0,0,1,0,1,1,0,0,5,0,2,6,1
7180,92988,niqjW4BciMttbwWr8wY84QzUCSHN5RSJ,G8EPVSXsOYB5YQWZGiz1aVq5Pgr2GrQu,1,0,0,0,0,0,1,0,1,0.14285714285714285,1,0.0,0,0,0,0,0,0,0,1,0,0,1,1
7181,92997,83JPfkin3GX4GLKqML2uaHSZ5KvsuJhM,SpATywNh6bZuzm8s1ceuBUnMUAeoAHHw,14,18,8,8,5,0,2,0,41,5.857142857142857,2,0.0,7,8,7,5,11,0,1,2,0,27,14,1
7182,93010,TMOi85sLkuYVgzErcEPoJc0AevPqR04B,RXDvfPUBYFlVdlueBFbLW0mhhAyGEqpt,17,21,11,14,4,11,10,1,72,10.285714285714286,5,0.0,3,11,11,4,18,11,3,10,1,29,43,1
7183,93012,PLJp2RYA7RZnQtREb0F5oRb3E0g7Z0Hr,G8EPVSXsOYB5YQWZGiz1aVq5Pgr2GrQu,2,0,0,0,0,0,2,0,2,0.2857142857142857,1,0.0,0,0,0,0,0,0,0,2,0,0,2,1
7184,93015,m9qgZNgP3Zn0sGVjbTdK1WyVxg0SzTDj,bWdj2GDclj5ofokWjzoa5jAwMkxCykd6,4,0,0,0,0,1,4,2,7,1.0,1,0.0,0,0,0,0,0,1,0,4,2,0,7,1
7185,93020,1RtjVFUMnRaIGZgXyyq9YVsVqwZO71yi,A3fsA9Zfv1X2fVEQhTw51lKENdNrEqT3,27,11,3,58,1,0,5,0,78,11.142857142857142,1,0.0,5,3,54,1,6,0,4,5,0,63,15,1
7186,93026,faeF4I5p3gAJMB1p4LfYVeCLQZKervYV,RXDvfPUBYFlVdlueBFbLW0mhhAyGEqpt,23,44,4,24,5,0,6,0,83,11.857142857142858,3,0.0,11,4,24,5,33,0,0,6,0,44,39,1
7187,93034,BIzXD84TaTFgXPtPL9bMALD9s3bgn0u7,SpATywNh6bZuzm8s1ceuBUnMUAeoAHHw,7,2,1,0,1,0,3,0,7,1.0,1,0.0,0,1,0,1,2,0,0,3,0,2,5,1
7188,93040,FlkgbrtKorC1nj2J8Ggbje7DCDtg1huD,A3fsA9Zfv1X2fVEQhTw51lKENdNrEqT3,5,4,2,0,1,0,4,0,11,1.5714285714285714,2,0.0,0,2,0,1,4,0,0,4,0,3,8,1
7189,93043,E5602d0htkVZGQTnJE6WlrGSkrgiKfR6,SpATywNh6bZuzm8s1ceuBUnMUAeoAHHw,2,0,0,0,0,0,2,0,2,0.2857142857142857,1,0.0,0,0,0,0,0,0,0,2,0,0,2,1
7190,93059,y5aIEV04Hqe57KpGOGn83CrEmVkQlotT,SpATywNh6bZuzm8s1ceuBUnMUAeoAHHw,4,2,0,0,0,1,2,0,5,0.7142857142857143,1,0.0,0,0,0,0,2,1,0,2,0,0,5,1
7191,93069,wxDnmvTLHWGwCYYCjH3qEOtgLqGKeB8y,bWdj2GDclj5ofokWjzoa5jAwMkxCykd6,2,0,0,0,0,0,3,0,3,0.42857142857142855,1,0.0,0,0,0,0,0,0,0,3,0,0,3,1
7192,93071,va3cVfF38XAjn4LEh6VxTTEdlP5IupZ2,bWdj2GDclj5ofokWjzoa5jAwMkxCykd6,1,0,0,0,0,0,1,0,1,0.14285714285714285,1,0.0,0,0,0,0,0,0,0,1,0,0,1,1
7193,93073,15L69MXCYIH8txiwXfgte6Bdad1p8M7U,SpATywNh6bZuzm8s1ceuBUnMUAeoAHHw,11,20,7,0,4,0,2,0,33,4.714285714285714,1,0.0,0,7,0,4,20,0,0,2,0,11,22,1
7194,93077,cnJW6igbDk7mivnYsxVZcWD5COwXKpJj,A3fsA9Zfv1X2fVEQhTw51lKENdNrEqT3,23,13,5,68,0,0,9,0,95,13.571428571428571,1,0.0,7,5,60,0,6,0,8,9,0,72,23,1
7195,93082,dPAuRkHCuQhCcbVNP1uiDIdfcWFQHP2t,SpATywNh6bZuzm8s1ceuBUnMUAeoAHHw,2,0,0,0,0,0,2,0,2,0.2857142857142857,1,0.0,0,0,0,0,0,0,0,2,0,0,2,1
7196,93106,28Xs6RIGljkwGIhsVvWB0d4RartQZhIp,SpATywNh6bZuzm8s1ceuBUnMUAeoAHHw,14,13,8,3,4,0,5,0,33,4.714285714285714,2,0.0,2,8,3,4,11,0,0,5,0,17,16,0
7197,93108,dBPTjHGtowbPnTOm514Emm9Jz5rIzrSj,SpATywNh6bZuzm8s1ceuBUnMUAeoAHHw,15,17,2,0,1,3,8,1,32,4.571428571428571,3,0.0,0,2,0,1,17,3,0,8,1,3,29,1
7198,93113,QOWLFnVTxLvLint3QUq9XwfNiIwpTPjR,G8EPVSXsOYB5YQWZGiz1aVq5Pgr2GrQu,6,2,1,0,1,0,3,0,7,1.0,1,0.0,0,1,0,1,2,0,0,3,0,2,5,1
7199,93128,OTVmyM3oMOEh3RPUJ9JvZ1cqJuClk9Op,A3fsA9Zfv1X2fVEQhTw51lKENdNrEqT3,13,24,11,0,5,1,6,1,48,6.857142857142857,2,0.0,2,11,0,5,22,1,0,6,1,18,30,1
7200,93151,Co9dycRC3nnJN4rm3WsLzyk3Mwz3zosU,SpATywNh6bZuzm8s1ceuBUnMUAeoAHHw,10,26,0,15,0,9,6,0,56,8.0,3,0.0,5,0,14,0,21,9,1,6,0,19,37,1
7201,93166,wjcBLe1692KFPJUkCwcKQrXvoLbsDg0j,A3fsA9Zfv1X2fVEQhTw51lKENdNrEqT3,9,13,6,0,3,0,3,0,25,3.5714285714285716,3,0.0,0,6,0,3,13,0,0,3,0,9,16,1
7202,93206,JtMmp5BCDQnYE7CMI3NvnX4aRCZsQW9K,RXDvfPUBYFlVdlueBFbLW0mhhAyGEqpt,1,0,0,0,0,0,2,0,2,0.2857142857142857,2,0.0,0,0,0,0,0,0,0,2,0,0,2,1
7203,93207,E7aYibTjzxGSk6NL3yeJVWuk7dqVnncv,bWdj2GDclj5ofokWjzoa5jAwMkxCykd6,4,5,2,0,2,0,1,0,10,1.4285714285714286,1,0.0,0,2,0,2,5,0,0,1,0,4,6,1
7204,93210,O9DTMIbbKOPsa4B7k1STk0nNuSR3cdx2,SpATywNh6bZuzm8s1ceuBUnMUAeoAHHw,3,2,0,0,0,0,2,0,4,0.5714285714285714,2,0.0,0,0,0,0,2,0,0,2,0,0,4,1
7205,93215,iCEb35gaygczCVXBPDGlI3sXrSsDaVej,A3fsA9Zfv1X2fVEQhTw51lKENdNrEqT3,1,0,0,0,0,0,1,0,1,0.14285714285714285,1,0.0,0,0,0,0,0,0,0,1,0,0,1,1
7206,93221,BhaFO7Lx4Q4YbNxvEeo9nBTXjsmsEz6c,SpATywNh6bZuzm8s1ceuBUnMUAeoAHHw,10,9,6,0,4,0,4,0,23,3.2857142857142856,2,0.0,0,6,0,4,9,0,0,4,0,10,13,1
7207,93225,mWv2aD1lbqJSR5LQ8znxXgNEw4RCzno5,bWdj2GDclj5ofokWjzoa5jAwMkxCykd6,1,0,0,0,0,0,1,0,1,0.14285714285714285,1,0.0,0,0,0,0,0,0,0,1,0,0,1,1
7208,93235,epvD2Wcl45J2GdVoBHzahVMdghFLent2,A3fsA9Zfv1X2fVEQhTw51lKENdNrEqT3,8,6,5,0,5,0,2,0,18,2.5714285714285716,1,0.0,0,5,0,5,6,0,0,2,0,10,8,1
7209,93249,yqsIVJwLxHRAX79gd7ST37Kksa5nD2Lx,SpATywNh6bZuzm8s1ceuBUnMUAeoAHHw,4,8,0,0,0,0,2,0,10,1.4285714285714286,1,0.0,0,0,0,0,8,0,0,2,0,0,10,1
7210,93294,zGuA1mMLvM3gfcKciKtoyFo6318fINqG,SpATywNh6bZuzm8s1ceuBUnMUAeoAHHw,1,0,0,0,0,0,1,0,1,0.14285714285714285,1,0.0,0,0,0,0,0,0,0,1,0,0,1,1
7211,93313,MU7wboUY4X1pw35YtYq9QO37Sakj8O8C,SpATywNh6bZuzm8s1ceuBUnMUAeoAHHw,6,5,3,0,3,0,1,0,12,1.7142857142857142,1,0.0,0,3,0,3,5,0,0,1,0,6,6,1
7212,93326,x6oT9QqDd4S0kTW1QntTwdbJd7rGTsDd,G8EPVSXsOYB5YQWZGiz1aVq5Pgr2GrQu,40,38,26,44,14,8,9,1,140,20.0,1,0.0,7,26,40,14,31,8,4,9,1,87,53,1
7213,93335,6WDAV2K5JXtsN5Y7oVoYno0rdPlDVwAS,SpATywNh6bZuzm8s1ceuBUnMUAeoAHHw,12,33,10,1,8,0,22,0,74,10.571428571428571,3,0.0,1,10,1,8,32,0,0,22,0,20,54,1
7214,93336,J9IFZ6lJS0kAA8VxmLEtsSsATCVlFyib,A3fsA9Zfv1X2fVEQhTw51lKENdNrEqT3,9,5,0,0,0,0,8,1,14,2.0,1,0.0,0,0,0,0,5,0,0,8,1,0,14,1
7215,93338,J9IFZ6lJS0kAA8VxmLEtsSsATCVlFyib,G8EPVSXsOYB5YQWZGiz1aVq5Pgr2GrQu,3,0,0,0,0,0,6,0,6,0.8571428571428571,2,0.0,0,0,0,0,0,0,0,6,0,0,6,1
7216,93346,b3ww03gxsETlWqnhgdTKJu0odbTVWElw,SpATywNh6bZuzm8s1ceuBUnMUAeoAHHw,1,0,0,0,0,0,1,0,1,0.14285714285714285,1,0.0,0,0,0,0,0,0,0,1,0,0,1,1
7217,93347,xfIcqx8ftYruTYGt1LiJYX4e8qkp171D,A3fsA9Zfv1X2fVEQhTw51lKENdNrEqT3,6,5,0,0,0,0,2,0,7,1.0,1,0.0,0,0,0,0,5,0,0,2,0,0,7,1
7218,93351,cwBiyXmdgaiw26TEVXDuCjvVYFCLKOa1,SpATywNh6bZuzm8s1ceuBUnMUAeoAHHw,6,14,3,0,1,0,1,0,19,2.7142857142857144,1,0.0,10,3,0,1,4,0,0,1,0,14,5,1
7219,93356,QKPOTPLCFSSptakTWL9scYXAQmH9VPoV,A3fsA9Zfv1X2fVEQhTw51lKENdNrEqT3,4,2,1,0,1,0,1,0,5,0.7142857142857143,1,0.0,0,1,0,1,2,0,0,1,0,2,3,1
7220,93373,rdlkz4QUHd85FYWQkxx9tuSVm08spAcj,A3fsA9Zfv1X2fVEQhTw51lKENdNrEqT3,11,5,3,0,3,0,3,0,14,2.0,1,0.0,0,3,0,3,5,0,0,3,0,6,8,1
7221,93374,AN1pw84sOSfQ3KFcxuCbDy0hYOBni6dp,G8EPVSXsOYB5YQWZGiz1aVq5Pgr2GrQu,23,30,11,34,3,0,10,0,88,12.571428571428571,1,0.0,12,11,24,3,18,0,10,10,0,50,38,1
7222,93383,YyNcczfjJii4HexOcQkp0MHeatr8c5sB,bWdj2GDclj5ofokWjzoa5jAwMkxCykd6,4,3,0,0,0,0,2,0,5,0.7142857142857143,1,0.0,0,0,0,0,3,0,0,2,0,0,5,1
7223,93384,1M4xACtMIoM8zWBXmaYDVcE8Iy4RYZ8e,G8EPVSXsOYB5YQWZGiz1aVq5Pgr2GrQu,13,13,2,10,1,3,14,1,44,6.285714285714286,2,0.0,5,2,7,1,8,3,3,14,1,15,29,1
7224,93387,HWAJhvF3LR86qA3qhHJiqZmQp4teUKAm,G8EPVSXsOYB5YQWZGiz1aVq5Pgr2GrQu,31,53,0,94,5,2,2,0,156,22.285714285714285,1,0.0,40,0,66,5,13,2,28,2,0,111,45,1
7225,93399,8LtTXy2ZLwBwWwH4BENA0Wiv8pjMa9RP,SpATywNh6bZuzm8s1ceuBUnMUAeoAHHw,11,18,0,10,0,6,3,0,37,5.285714285714286,1,0.0,9,0,8,0,9,6,2,3,0,17,20,1
7226,93402,wRuDkiFKsIS1XayC3m2MgIyWR2x1W3i6,A3fsA9Zfv1X2fVEQhTw51lKENdNrEqT3,6,3,1,0,1,0,3,0,8,1.1428571428571428,1,0.0,0,1,0,1,3,0,0,3,0,2,6,1
7227,93404,eT5JmMMKMcNoJjMWrJaUqOJQSpR601jL,A3fsA9Zfv1X2fVEQhTw51lKENdNrEqT3,4,2,1,0,1,0,5,0,9,1.2857142857142858,2,0.0,0,1,0,1,2,0,0,5,0,2,7,1
7228,93414,LiD14ALXLddUqpdQnujGFxQiBSoJOZGF,bWdj2GDclj5ofokWjzoa5jAwMkxCykd6,25,59,8,132,4,3,31,0,237,33.857142857142854,9,0.0,11,8,122,4,48,3,10,31,0,145,92,0
7229,93415,CiJGHZYjg5XVOtN8y1aUHiZjaXvVvsf8,bWdj2GDclj5ofokWjzoa5jAwMkxCykd6,5,3,1,0,1,0,5,0,10,1.4285714285714286,3,0.0,0,1,0,1,3,0,0,5,0,2,8,1
7230,93416,NFwkvwlecWBzcgNCOvBMTCkkUA7P9cK8,bWdj2GDclj5ofokWjzoa5jAwMkxCykd6,6,7,3,0,1,0,4,0,15,2.142857142857143,2,0.0,0,3,0,1,7,0,0,4,0,4,11,1
7231,93417,C6OkpqYGxZDK55uJrTXLk64MO2W2kN6e,SpATywNh6bZuzm8s1ceuBUnMUAeoAHHw,1,0,0,0,0,0,1,0,1,0.14285714285714285,1,0.0,0,0,0,0,0,0,0,1,0,0,1,1
7232,93422,HcOpBFh3ZPBJu7PjBFffM3Zedw54RSXN,A3fsA9Zfv1X2fVEQhTw51lKENdNrEqT3,4,8,2,0,0,0,2,0,12,1.7142857142857142,3,0.0,0,2,0,0,8,0,0,2,0,2,10,1
7233,93426,Hc0D2UkydjyUi3vnnsfmiB8lOnMbIWKo,SpATywNh6bZuzm8s1ceuBUnMUAeoAHHw,4,2,1,0,1,0,1,0,5,0.7142857142857143,1,0.0,0,1,0,1,2,0,0,1,0,2,3,0
7234,93434,BCPOhUa2LrfH93ebCE15VbF0VEWEyi7T,SpATywNh6bZuzm8s1ceuBUnMUAeoAHHw,6,3,2,0,2,0,1,0,8,1.1428571428571428,1,0.0,0,2,0,2,3,0,0,1,0,4,4,0
7235,93437,lmx2t8WuCRr4yPlE96c0Hld3ah69yimY,SpATywNh6bZuzm8s1ceuBUnMUAeoAHHw,8,16,2,17,0,26,2,0,63,9.0,1,0.0,14,2,15,0,2,26,2,2,0,31,32,1
7236,93444,wfUVHBmDLe0V8vTm9YNAi5Eoe98kipNK,RXDvfPUBYFlVdlueBFbLW0mhhAyGEqpt,26,49,2,0,2,0,10,5,68,9.714285714285714,3,0.0,4,2,0,2,45,0,0,10,5,8,60,1
7237,93454,IdPM07Tobfo8uXfAGdfrnlSPQUjcS5lw,SpATywNh6bZuzm8s1ceuBUnMUAeoAHHw,27,26,13,32,9,3,10,2,95,13.571428571428571,3,0.0,10,13,27,9,16,3,5,10,2,59,36,1
7238,93461,iNqMxLUew1d2DW8l74urvD3s2ojQNcOj,G8EPVSXsOYB5YQWZGiz1aVq5Pgr2GrQu,9,6,1,0,1,0,3,0,11,1.5714285714285714,2,0.0,0,1,0,1,6,0,0,3,0,2,9,1
7239,93463,KnjIylBxQGK5ybTZHRQCIOf6LVaiEDiE,SpATywNh6bZuzm8s1ceuBUnMUAeoAHHw,17,21,9,14,6,56,8,0,114,16.285714285714285,3,0.0,10,9,11,6,11,56,3,8,0,36,78,1
7240,93476,XiRokcstRgTAoxw5fli1EiomcYln51fR,bWdj2GDclj5ofokWjzoa5jAwMkxCykd6,4,3,0,0,0,0,5,0,8,1.1428571428571428,1,0.0,1,0,0,0,2,0,0,5,0,1,7,1
7241,93478,ouHHL7JxNnPJ7sZc8oGHgugCfHuyBFzn,bWdj2GDclj5ofokWjzoa5jAwMkxCykd6,10,12,7,0,4,1,5,1,30,4.285714285714286,4,0.0,0,7,0,4,12,1,0,5,1,11,19,1
7242,93497,QcZtDJ3gyfgBjK6fnA4Umq8WcjzDqlhe,A3fsA9Zfv1X2fVEQhTw51lKENdNrEqT3,1,0,0,0,0,0,1,0,1,0.14285714285714285,1,0.0,0,0,0,0,0,0,0,1,0,0,1,1
7243,93504,vaOIevkYLsk4A7wWmrPXcGrOKX6OgVbB,G8EPVSXsOYB5YQWZGiz1aVq5Pgr2GrQu,12,4,3,0,3,1,5,1,17,2.4285714285714284,1,0.0,0,3,0,3,4,1,0,5,1,6,11,1
7244,93513,yuqYkP52C7pQOIQ48GEgTRDqcNtFSeb3,bWdj2GDclj5ofokWjzoa5jAwMkxCykd6,22,29,13,38,7,37,21,1,146,20.857142857142858,4,0.0,8,13,35,7,21,37,3,21,1,63,83,1
7245,93517,1yALM9xjClF6jgXaABxhrYNC8eb8bQ9n,bWdj2GDclj5ofokWjzoa5jAwMkxCykd6,18,31,16,34,8,14,6,0,109,15.571428571428571,2,0.0,6,16,30,8,25,14,4,6,0,60,49,1
7246,93518,I3RIPLupgcaFBN4TZgx1kwE7cqUmhNGE,SpATywNh6bZuzm8s1ceuBUnMUAeoAHHw,9,10,2,0,2,0,4,0,18,2.5714285714285716,2,0.0,0,2,0,2,10,0,0,4,0,4,14,1
7247,93519,lUW6V1mqrGSz0okgfju4Oi2AssrcTWTN,bWdj2GDclj5ofokWjzoa5jAwMkxCykd6,12,6,4,0,3,1,8,0,22,3.142857142857143,2,0.0,0,4,0,3,6,1,0,8,0,7,15,1
7248,93520,caAQbOI1NkkZKVF3oGPK3OdsY0lbDlYb,bWdj2GDclj5ofokWjzoa5jAwMkxCykd6,6,2,1,0,1,1,5,2,12,1.7142857142857142,1,0.0,0,1,0,1,2,1,0,5,2,2,10,1
7249,93523,7KhKGJPxu4uQKYHNs7O3NjmuTH6NjrVY,A3fsA9Zfv1X2fVEQhTw51lKENdNrEqT3,27,24,18,0,12,2,13,1,70,10.0,3,0.0,0,18,0,12,24,2,0,13,1,30,40,0
7250,93525,SI82rbAOql23YmOWiXWAc0dEkHYrXScg,SpATywNh6bZuzm8s1ceuBUnMUAeoAHHw,8,4,1,0,1,3,5,0,14,2.0,1,0.0,0,1,0,1,4,3,0,5,0,2,12,1
7251,93529,K5WcXRk24XKmzfaggLfniRGhO7RrNYwU,SpATywNh6bZuzm8s1ceuBUnMUAeoAHHw,13,15,8,12,6,0,1,0,42,6.0,1,0.0,6,8,12,6,9,0,0,1,0,32,10,0
7252,93531,RHEMdhoy3TVz84IqO3CiO0ZVmx7sjl4N,A3fsA9Zfv1X2fVEQhTw51lKENdNrEqT3,48,27,19,65,14,0,10,0,135,19.285714285714285,3,0.0,1,19,52,14,26,0,13,10,0,86,49,0
7253,93538,oUwdPVwTRYLcPpw0ARjn83xyQKxe2P4j,A3fsA9Zfv1X2fVEQhTw51lKENdNrEqT3,8,15,0,0,0,0,4,0,19,2.7142857142857144,1,0.0,0,0,0,0,15,0,0,4,0,0,19,1
7254,93558,wjcBLe1692KFPJUkCwcKQrXvoLbsDg0j,bWdj2GDclj5ofokWjzoa5jAwMkxCykd6,3,3,1,0,0,0,1,0,5,0.7142857142857143,1,0.0,0,1,0,0,3,0,0,1,0,1,4,1
7255,93559,kQHHmjfVeHdUMEjst4rHDTfMZ6Hq7zy6,G8EPVSXsOYB5YQWZGiz1aVq5Pgr2GrQu,21,36,13,56,5,0,11,1,122,17.428571428571427,3,0.0,15,13,49,5,21,0,7,11,1,82,40,1
7256,93567,GWCKXkmUMNA4NMWmbV0iY9p0NnvUAuFf,SpATywNh6bZuzm8s1ceuBUnMUAeoAHHw,2,0,0,0,0,0,2,0,2,0.2857142857142857,1,0.0,0,0,0,0,0,0,0,2,0,0,2,1
7257,93576,kWRi0bjTsOLXCT3B1x0edeUqfKik54ld,SpATywNh6bZuzm8s1ceuBUnMUAeoAHHw,7,3,2,0,2,0,2,0,9,1.2857142857142858,1,0.0,0,2,0,2,3,0,0,2,0,4,5,1
7258,93583,3RcsrMTbPrb8ZHYXLlgwoRK7zrqTGSuq,A3fsA9Zfv1X2fVEQhTw51lKENdNrEqT3,22,17,13,2,11,0,4,0,47,6.714285714285714,1,0.0,3,13,2,11,14,0,0,4,0,29,18,1
7259,93594,SI82rbAOql23YmOWiXWAc0dEkHYrXScg,G8EPVSXsOYB5YQWZGiz1aVq5Pgr2GrQu,6,1,1,0,1,0,3,0,6,0.8571428571428571,1,0.0,0,1,0,1,1,0,0,3,0,2,4,1
7260,93601,auyTDueRbJJVbSgkNfSzePWA0sXDjoDA,A3fsA9Zfv1X2fVEQhTw51lKENdNrEqT3,5,4,0,0,0,0,4,0,8,1.1428571428571428,1,0.0,0,0,0,0,4,0,0,4,0,0,8,1
7261,93608,XIhNBV2ngE6VH3B3rFCGmtxUmfBaQQAu,bWdj2GDclj5ofokWjzoa5jAwMkxCykd6,2,0,0,0,0,0,4,0,4,0.5714285714285714,1,0.0,0,0,0,0,0,0,0,4,0,0,4,1
7262,93612,iKQWUg85b7iQVNDnFW3yVIr4MRSX1OiM,SpATywNh6bZuzm8s1ceuBUnMUAeoAHHw,9,4,4,0,4,0,4,0,16,2.2857142857142856,2,0.0,0,4,0,4,4,0,0,4,0,8,8,1
7263,93613,5zmdkrLCsYposTlmADCtPSCtqJszOFSq,A3fsA9Zfv1X2fVEQhTw51lKENdNrEqT3,17,11,8,0,5,1,6,0,31,4.428571428571429,2,0.0,0,8,0,5,11,1,0,6,0,13,18,1
7264,93623,SetmDwaBCsbTdPHVqtt90lo6lvXmXkbh,RXDvfPUBYFlVdlueBFbLW0mhhAyGEqpt,2,0,0,0,0,0,2,0,2,0.2857142857142857,1,0.0,0,0,0,0,0,0,0,2,0,0,2,1
7265,93634,hjHWaXhruoFaGhRZCz2Vsvz3ABLehqZ4,bWdj2GDclj5ofokWjzoa5jAwMkxCykd6,5,2,1,0,1,0,3,0,7,1.0,1,0.0,0,1,0,1,2,0,0,3,0,2,5,1
7266,93641,3NITGQuylcrTi63aoWqnzXuF5Rtf7QVq,A3fsA9Zfv1X2fVEQhTw51lKENdNrEqT3,37,13,11,80,10,0,1,0,115,16.428571428571427,1,0.0,1,11,69,10,12,0,11,1,0,91,24,1
7267,93642,87SYGQjFYUtEWda0pG12bcNker0JGBy3,A3fsA9Zfv1X2fVEQhTw51lKENdNrEqT3,5,7,0,0,0,0,1,0,8,1.1428571428571428,1,0.0,0,0,0,0,7,0,0,1,0,0,8,1
7268,93647,GyNkIVOso2X6ndPFrPZ0dYdTkjhdba2Q,G8EPVSXsOYB5YQWZGiz1aVq5Pgr2GrQu,10,11,3,0,3,0,7,0,24,3.4285714285714284,2,0.0,2,3,0,3,9,0,0,7,0,8,16,1
7269,93654,FFnoMDhUnJZ86LrCRa50JPybQorDvh89,RXDvfPUBYFlVdlueBFbLW0mhhAyGEqpt,10,10,7,0,3,0,4,0,24,3.4285714285714284,3,0.0,1,7,0,3,9,0,0,4,0,11,13,1
7270,93664,wmwDf7eIRrKPL0l8cNmMygnEPd5vzoqs,A3fsA9Zfv1X2fVEQhTw51lKENdNrEqT3,10,7,0,0,0,2,9,2,20,2.857142857142857,2,0.0,1,0,0,0,6,2,0,9,2,1,19,1
7271,93665,OCOZunZP01no4Zh4NYF1FDXoOWZrc1Yv,SpATywNh6bZuzm8s1ceuBUnMUAeoAHHw,10,16,2,26,2,0,1,0,47,6.714285714285714,1,0.0,11,2,21,2,5,0,5,1,0,36,11,1
7272,93668,wmwDf7eIRrKPL0l8cNmMygnEPd5vzoqs,bWdj2GDclj5ofokWjzoa5jAwMkxCykd6,8,7,1,0,0,1,6,1,16,2.2857142857142856,2,0.0,0,1,0,0,7,1,0,6,1,1,15,1
7273,93698,F3pS3HhR6zAyElkIe1WFx5cvIXH3Mmjf,SpATywNh6bZuzm8s1ceuBUnMUAeoAHHw,1,0,0,0,0,0,1,0,1,0.14285714285714285,1,0.0,0,0,0,0,0,0,0,1,0,0,1,1
7274,93711,VvbZjK8y9aernnsSHvAW377h2uAEkOuF,RXDvfPUBYFlVdlueBFbLW0mhhAyGEqpt,2,0,0,0,0,0,2,0,2,0.2857142857142857,1,0.0,0,0,0,0,0,0,0,2,0,0,2,1
7275,93728,GZzbpBGluNcEXFZ9BEQgqFPzH6qJC8rT,SpATywNh6bZuzm8s1ceuBUnMUAeoAHHw,13,21,3,8,1,0,8,1,42,6.0,3,0.0,0,3,7,1,21,0,1,8,1,11,31,1
7276,93733,vSy2YWE0W8axNgPS8DBIlQoMQuLcT6wu,G8EPVSXsOYB5YQWZGiz1aVq5Pgr2GrQu,2,0,0,0,0,0,2,0,2,0.2857142857142857,1,0.0,0,0,0,0,0,0,0,2,0,0,2,1
7277,93734,J2Ryyq6g6TjnFue1VPNlM9zNmZVB3792,SpATywNh6bZuzm8s1ceuBUnMUAeoAHHw,6,3,1,0,1,0,2,0,7,1.0,1,0.0,0,1,0,1,3,0,0,2,0,2,5,1
7278,93744,ROmxIDt1Nv5jCVXIVh1nfk5f1b4KKNIR,bWdj2GDclj5ofokWjzoa5jAwMkxCykd6,8,6,3,0,2,0,6,0,17,2.4285714285714284,2,0.0,0,3,0,2,6,0,0,6,0,5,12,1
7279,93756,KO9zYaiac2CNagQLdx3aJ9c2fXXMgIJX,SpATywNh6bZuzm8s1ceuBUnMUAeoAHHw,14,20,9,11,5,0,5,0,50,7.142857142857143,4,0.0,4,9,11,5,16,0,0,5,0,29,21,1
7280,93774,2AXxkCmyE7acjKrdHA94DKX4eMigeF9j,A3fsA9Zfv1X2fVEQhTw51lKENdNrEqT3,14,8,6,0,6,0,3,0,23,3.2857142857142856,2,0.0,0,6,0,6,8,0,0,3,0,12,11,1
7281,93781,seYLwHio53k0mOFj19dZ5TEGXq5ADUux,SpATywNh6bZuzm8s1ceuBUnMUAeoAHHw,5,2,1,0,0,0,6,0,9,1.2857142857142858,1,0.0,0,1,0,0,2,0,0,6,0,1,8,1
7282,93787,QOHFX3G0atWVkV8bdUDLZP6MvVAU1bxE,A3fsA9Zfv1X2fVEQhTw51lKENdNrEqT3,7,5,0,0,0,0,7,0,12,1.7142857142857142,2,0.0,0,0,0,0,5,0,0,7,0,0,12,1
7283,93789,bFxkSwC4B7FuMDmZm2HkHgiHz8QC2hPC,A3fsA9Zfv1X2fVEQhTw51lKENdNrEqT3,9,11,5,0,3,0,2,0,21,3.0,1,0.0,0,5,0,3,11,0,0,2,0,8,13,1
7284,93799,SvayS3hRjiQUsZJZ3Z80XuRW7pnvNCGH,SpATywNh6bZuzm8s1ceuBUnMUAeoAHHw,25,52,8,18,3,20,27,4,132,18.857142857142858,4,0.0,8,8,17,3,44,20,1,27,4,36,96,1
7285,93814,uHLnVmnvVGRf9UQIVsgUkoIvLInqWS41,RXDvfPUBYFlVdlueBFbLW0mhhAyGEqpt,35,83,43,32,26,5,26,3,218,31.142857142857142,3,0.0,9,43,30,26,74,5,2,26,3,108,110,1
7286,93818,CYf5wdcurcSyhJdbx09KiN2Kzj9VLvNU,SpATywNh6bZuzm8s1ceuBUnMUAeoAHHw,1,0,0,0,0,0,1,0,1,0.14285714285714285,1,0.0,0,0,0,0,0,0,0,1,0,0,1,1
7287,93821,O2RP4lI2hqQTYW7uUxK7lTmJyXECBert,SpATywNh6bZuzm8s1ceuBUnMUAeoAHHw,4,2,1,0,1,0,1,0,5,0.7142857142857143,1,0.0,0,1,0,1,2,0,0,1,0,2,3,1
7288,93835,D98GkCb5yOnLtlLtWNWnUK2keXt1DRWI,A3fsA9Zfv1X2fVEQhTw51lKENdNrEqT3,2,0,0,0,0,0,2,0,2,0.2857142857142857,1,0.0,0,0,0,0,0,0,0,2,0,0,2,1
7289,93843,OMmdzdRtTLASG3chso9cdfg94JQDfZqt,SpATywNh6bZuzm8s1ceuBUnMUAeoAHHw,11,15,5,2,3,0,3,0,28,4.0,3,0.0,2,5,2,3,13,0,0,3,0,12,16,1
7290,93860,iDEg223wPLRjblw05XWiNlNB0XKXbAH3,SpATywNh6bZuzm8s1ceuBUnMUAeoAHHw,8,4,2,0,1,0,6,1,14,2.0,1,0.0,0,2,0,1,4,0,0,6,1,3,11,1
7291,93862,MdwJcKhWKSfBlz1JQsWSYPZY8VplWXai,SpATywNh6bZuzm8s1ceuBUnMUAeoAHHw,2,0,0,0,0,0,3,0,3,0.42857142857142855,2,0.0,0,0,0,0,0,0,0,3,0,0,3,1
7292,93863,Ac4OXBvc7WZ07azvF8LolPbeFPCXH5U0,SpATywNh6bZuzm8s1ceuBUnMUAeoAHHw,1,0,0,0,0,0,1,0,1,0.14285714285714285,1,0.0,0,0,0,0,0,0,0,1,0,0,1,1
7293,93879,qT6iwsUe27SkWCpThee9QunElnsrIqyP,SpATywNh6bZuzm8s1ceuBUnMUAeoAHHw,16,18,6,14,3,0,8,0,49,7.0,3,0.0,7,6,13,3,11,0,1,8,0,29,20,1
7294,93881,wKKdkZJ3MevUShYy00jn3yNZpY2kcdrV,A3fsA9Zfv1X2fVEQhTw51lKENdNrEqT3,4,1,0,0,0,0,3,0,4,0.5714285714285714,1,0.0,0,0,0,0,1,0,0,3,0,0,4,0
7295,93900,L1FTG9TM6RI5TBCTexQgshQhXhu2oZpJ,A3fsA9Zfv1X2fVEQhTw51lKENdNrEqT3,97,44,31,162,20,0,20,0,277,39.57142857142857,8,0.0,3,31,154,20,41,0,8,20,0,208,69,0
7296,93903,L1FTG9TM6RI5TBCTexQgshQhXhu2oZpJ,G8EPVSXsOYB5YQWZGiz1aVq5Pgr2GrQu,44,39,18,74,14,0,4,0,149,21.285714285714285,2,0.0,15,18,68,14,24,0,6,4,0,115,34,1
7297,93906,df9qJcc4auTr14t9gsIjmvQwAgkzyFuV,SpATywNh6bZuzm8s1ceuBUnMUAeoAHHw,6,2,1,0,1,0,3,0,7,1.0,1,0.0,0,1,0,1,2,0,0,3,0,2,5,1
7298,93917,MyQ8e9mBKn27AhY70WumCof36bw293Y4,SpATywNh6bZuzm8s1ceuBUnMUAeoAHHw,16,24,7,17,3,4,7,0,62,8.857142857142858,3,0.0,12,7,13,3,12,4,4,7,0,35,27,1
7299,93918,oW89eJD99A7pCOqqvTkgIt7CVSu0bGbe,SpATywNh6bZuzm8s1ceuBUnMUAeoAHHw,8,5,2,0,1,0,6,0,14,2.0,1,0.0,0,2,0,1,5,0,0,6,0,3,11,1
7300,93920,EJ6j1DQBzD1orM5Ltf8vXiAVi2YaVKj4,A3fsA9Zfv1X2fVEQhTw51lKENdNrEqT3,12,16,7,0,6,0,1,0,30,4.285714285714286,1,0.0,0,7,0,6,16,0,0,1,0,13,17,1
7301,93924,QrJQFROnKZICXeQTI0yD9R5uKCsOiaxB,bWdj2GDclj5ofokWjzoa5jAwMkxCykd6,5,3,1,0,1,0,2,0,7,1.0,1,0.0,0,1,0,1,3,0,0,2,0,2,5,1
7302,93928,grEUheAl7r2qUdLFFy9nEMsG9X5GQrvY,SpATywNh6bZuzm8s1ceuBUnMUAeoAHHw,17,16,7,7,5,1,6,1,43,6.142857142857143,1,0.0,7,7,7,5,9,1,0,6,1,26,17,1
7303,93937,2j0Susczy7BF2QnNLUm3dJdUMP10ntAU,SpATywNh6bZuzm8s1ceuBUnMUAeoAHHw,16,19,12,9,3,0,9,2,54,7.714285714285714,2,0.0,2,12,8,3,17,0,1,9,2,25,29,1
7304,93949,pQdqlOtxi2sBVu8vnQy738Mf4LOYprkG,SpATywNh6bZuzm8s1ceuBUnMUAeoAHHw,5,2,1,0,1,0,3,0,7,1.0,1,0.0,0,1,0,1,2,0,0,3,0,2,5,1
7305,93951,Ei65KRTqH4vAZu2hVbuPfr6ybTjVLWsx,SpATywNh6bZuzm8s1ceuBUnMUAeoAHHw,12,19,7,0,6,0,4,0,36,5.142857142857143,2,0.0,7,7,0,6,12,0,0,4,0,20,16,1
7306,93967,XyD01HhzMuHzP5ArHNJFexoSZMamD6Wh,SpATywNh6bZuzm8s1ceuBUnMUAeoAHHw,14,17,8,16,5,1,3,0,50,7.142857142857143,2,0.0,7,8,14,5,10,1,2,3,0,34,16,1
7307,93981,aoxjDsJ8sZvuPjSCqksrdXkImRMV7vgy,A3fsA9Zfv1X2fVEQhTw51lKENdNrEqT3,5,5,1,0,0,0,2,0,8,1.1428571428571428,1,0.0,0,1,0,0,5,0,0,2,0,1,7,1
7308,93999,M4LPRpz3NIxIAwFWtYdMyaFovwI23Hwi,SpATywNh6bZuzm8s1ceuBUnMUAeoAHHw,1,0,0,0,0,0,1,0,1,0.14285714285714285,1,0.0,0,0,0,0,0,0,0,1,0,0,1,1
7309,94009,E1EZDOz8phdW938KkZKGZCkkHanJOco1,bWdj2GDclj5ofokWjzoa5jAwMkxCykd6,5,2,1,0,1,0,2,0,6,0.8571428571428571,1,0.0,0,1,0,1,2,0,0,2,0,2,4,1
7310,94020,aj6uF4XWV3XUUfOpWCk3NuntI2wXym6n,bWdj2GDclj5ofokWjzoa5jAwMkxCykd6,3,0,0,0,0,0,9,0,9,1.2857142857142858,1,0.0,0,0,0,0,0,0,0,9,0,0,9,1
7311,94021,ZtP7ZrczBJoU0XUS4dUWlvI4t1uLf935,A3fsA9Zfv1X2fVEQhTw51lKENdNrEqT3,8,6,4,0,3,0,2,0,15,2.142857142857143,1,0.0,1,4,0,3,5,0,0,2,0,8,7,1
7312,94033,1j3EQYZpvzbHITrSXjRLOl0JrSGShjCW,SpATywNh6bZuzm8s1ceuBUnMUAeoAHHw,12,8,5,5,3,0,2,0,23,3.2857142857142856,1,0.0,2,5,4,3,6,0,1,2,0,14,9,1
7313,94041,gMeZHtHbmrRB8drlaFHRYNGQ6Z4lgho8,A3fsA9Zfv1X2fVEQhTw51lKENdNrEqT3,8,2,1,0,1,0,5,1,10,1.4285714285714286,1,0.0,0,1,0,1,2,0,0,5,1,2,8,1
7314,94050,5WAIxgqU8QRTpOrU8O3vmj4h4ZKof8jn,bWdj2GDclj5ofokWjzoa5jAwMkxCykd6,7,3,2,0,2,0,2,0,9,1.2857142857142858,1,0.0,0,2,0,2,3,0,0,2,0,4,5,1
7315,94059,WO12a2dRrxFwdlmt1PknzZCD2wf5mAFA,SpATywNh6bZuzm8s1ceuBUnMUAeoAHHw,4,3,0,0,0,0,2,0,5,0.7142857142857143,1,0.0,0,0,0,0,3,0,0,2,0,0,5,1
7316,94061,eEQqKnaUGHJzSnB7MrBGgZfDTYsV36xI,A3fsA9Zfv1X2fVEQhTw51lKENdNrEqT3,2,0,0,0,0,0,2,0,2,0.2857142857142857,1,0.0,0,0,0,0,0,0,0,2,0,0,2,1
7317,94083,sTlxlEkJ3MbMUAeSajnaHOGfpyW9hgq1,SpATywNh6bZuzm8s1ceuBUnMUAeoAHHw,29,38,17,26,7,1,6,0,95,13.571428571428571,3,0.0,10,17,25,7,28,1,1,6,0,59,36,0
7318,94086,uKZ87zwhOlE6XjyVFr8vmJl9wOD1B9qQ,A3fsA9Zfv1X2fVEQhTw51lKENdNrEqT3,11,9,4,0,2,8,14,0,37,5.285714285714286,4,0.0,0,4,0,2,9,8,0,14,0,6,31,1
7319,94097,uKZ87zwhOlE6XjyVFr8vmJl9wOD1B9qQ,bWdj2GDclj5ofokWjzoa5jAwMkxCykd6,1,0,0,0,0,0,1,0,1,0.14285714285714285,1,0.0,0,0,0,0,0,0,0,1,0,0,1,1
7320,94106,MRzfDn8Dt6xZQHTAuGEWQiuznoHxxpTX,SpATywNh6bZuzm8s1ceuBUnMUAeoAHHw,16,20,13,13,3,3,7,0,59,8.428571428571429,3,0.0,5,13,11,3,15,3,2,7,0,32,27,1
7321,94113,nVXGW3QRysmVp7bseFXpH5xogt6vyuOe,A3fsA9Zfv1X2fVEQhTw51lKENdNrEqT3,1,0,0,0,0,0,4,0,4,0.5714285714285714,3,0.0,0,0,0,0,0,0,0,4,0,0,4,1
7322,94124,XyD01HhzMuHzP5ArHNJFexoSZMamD6Wh,G8EPVSXsOYB5YQWZGiz1aVq5Pgr2GrQu,9,6,2,0,2,0,4,3,17,2.4285714285714284,2,0.0,2,2,0,2,4,0,0,4,3,6,11,1
7323,94128,sKWLe14EbvHw5vqAsPu64KkYjNDdUiTB,SpATywNh6bZuzm8s1ceuBUnMUAeoAHHw,8,9,0,8,0,0,6,0,23,3.2857142857142856,2,0.0,2,0,6,0,7,0,2,6,0,8,15,0
7324,94132,agX7ad5amneAPRCUHAMkIow0n3bNeaeT,SpATywNh6bZuzm8s1ceuBUnMUAeoAHHw,10,5,4,0,3,0,3,0,15,2.142857142857143,1,0.0,0,4,0,3,5,0,0,3,0,7,8,1
7325,94154,sEtktPcVAhFQ7PqkOK3agQy8gf3suIv1,SpATywNh6bZuzm8s1ceuBUnMUAeoAHHw,28,60,11,35,6,8,12,4,136,19.428571428571427,7,0.0,8,11,30,6,52,8,5,12,4,55,81,0
7326,94159,tT3q39TssUZPXoxVdRzgRUu1SUheNubE,A3fsA9Zfv1X2fVEQhTw51lKENdNrEqT3,9,5,3,0,3,1,2,0,14,2.0,1,0.0,0,3,0,3,5,1,0,2,0,6,8,1
7327,94168,ImT05r98NIKWlAcW1CpDyV3beLAyiPwI,A3fsA9Zfv1X2fVEQhTw51lKENdNrEqT3,39,20,10,72,7,0,4,0,113,16.142857142857142,2,0.0,1,10,62,7,19,0,10,4,0,80,33,1
7328,94173,ekbYWgnVFLMYoljaE2I4pYzmSROCPA7U,SpATywNh6bZuzm8s1ceuBUnMUAeoAHHw,17,21,7,11,3,15,11,1,69,9.857142857142858,3,0.0,11,7,10,3,10,15,1,11,1,31,38,1
7329,94185,uHQHB7VXsqIiN9QWww9HiRF0pTlZ4g4T,SpATywNh6bZuzm8s1ceuBUnMUAeoAHHw,12,14,1,23,0,0,2,0,40,5.714285714285714,1,0.0,4,1,20,0,10,0,3,2,0,25,15,1
7330,94191,aMoLa2myIR3XZbIIUknP0HHf77SQMaDf,A3fsA9Zfv1X2fVEQhTw51lKENdNrEqT3,1,0,0,0,0,0,1,0,1,0.14285714285714285,1,0.0,0,0,0,0,0,0,0,1,0,0,1,1
7331,94197,OOnLMU5i5dIEK7NKdoclKsBTE1KLFIfI,SpATywNh6bZuzm8s1ceuBUnMUAeoAHHw,6,7,2,0,1,0,2,0,12,1.7142857142857142,1,0.0,0,2,0,1,7,0,0,2,0,3,9,1
7332,94199,kbnRP5v2Cp1hRovzbBsM6Gb1jKCIVIhL,A3fsA9Zfv1X2fVEQhTw51lKENdNrEqT3,3,2,0,0,0,0,2,0,4,0.5714285714285714,1,0.0,0,0,0,0,2,0,0,2,0,0,4,1
7333,94203,6pBQz4v6AEbi1mr9tNTCug5y9Nmhc90r,A3fsA9Zfv1X2fVEQhTw51lKENdNrEqT3,9,8,5,0,3,0,3,0,19,2.7142857142857144,1,0.0,0,5,0,3,8,0,0,3,0,8,11,1
7334,94205,3KCb4A6amo38Fw6QE756HJn80s8Q1p3u,RXDvfPUBYFlVdlueBFbLW0mhhAyGEqpt,1,0,0,0,0,0,1,0,1,0.14285714285714285,1,0.0,0,0,0,0,0,0,0,1,0,0,1,1
7335,94208,NO1MJkdcGNcIxZKkf5qtzbhQeFobR0HR,SpATywNh6bZuzm8s1ceuBUnMUAeoAHHw,15,11,4,16,3,10,4,0,48,6.857142857142857,1,0.0,6,4,16,3,5,10,0,4,0,29,19,1
7336,94210,4cB4y17zVi4jfdrlreMIHGN1aQJHMMST,bWdj2GDclj5ofokWjzoa5jAwMkxCykd6,5,1,1,0,0,0,3,0,5,0.7142857142857143,1,0.0,0,1,0,0,1,0,0,3,0,1,4,1
7337,94213,6nUn5FL9ZAMjSGoB8M6FuLGMybzSihLy,SpATywNh6bZuzm8s1ceuBUnMUAeoAHHw,4,0,0,0,0,0,3,1,4,0.5714285714285714,1,0.0,0,0,0,0,0,0,0,3,1,0,4,1
7338,94229,dzvyuk189tsgDZIOFuacAzCgRiphRz5M,SpATywNh6bZuzm8s1ceuBUnMUAeoAHHw,7,6,3,0,1,0,4,0,14,2.0,2,0.0,1,3,0,1,5,0,0,4,0,5,9,0
7339,94245,rFglXXD43LPWYWjk5nJFVhPJBw4btSRI,SpATywNh6bZuzm8s1ceuBUnMUAeoAHHw,11,9,2,0,1,3,8,1,24,3.4285714285714284,2,0.0,0,2,0,1,9,3,0,8,1,3,21,1
7340,94269,CyJflfaXZKlRhnAKYz3Gu6YETYpaZMel,SpATywNh6bZuzm8s1ceuBUnMUAeoAHHw,2,0,0,0,0,0,2,0,2,0.2857142857142857,1,0.0,0,0,0,0,0,0,0,2,0,0,2,1
7341,94274,0NICeN7b6gzNzu2kflLtEXCwdFBGs0NN,bWdj2GDclj5ofokWjzoa5jAwMkxCykd6,7,5,0,0,0,0,4,0,9,1.2857142857142858,1,0.0,0,0,0,0,5,0,0,4,0,0,9,1
7342,94286,M8C9BDFICk4ida59GU0jjp556zazDEi1,A3fsA9Zfv1X2fVEQhTw51lKENdNrEqT3,17,16,11,0,6,0,10,0,43,6.142857142857143,5,0.0,0,11,0,6,16,0,0,10,0,17,26,1
7343,94287,Ft2AG2HMzLmh2EcmDrFVFbinKvFMlb1G,A3fsA9Zfv1X2fVEQhTw51lKENdNrEqT3,2,0,0,0,0,0,2,0,2,0.2857142857142857,1,0.0,0,0,0,0,0,0,0,2,0,0,2,1
7344,94291,r2j4kmS3sSw2bBC6XtGVEzDG8uZSaMde,bWdj2GDclj5ofokWjzoa5jAwMkxCykd6,2,0,0,0,0,0,2,0,2,0.2857142857142857,2,0.0,0,0,0,0,0,0,0,2,0,0,2,1
7345,94294,M8C9BDFICk4ida59GU0jjp556zazDEi1,bWdj2GDclj5ofokWjzoa5jAwMkxCykd6,9,19,11,0,5,5,11,0,51,7.285714285714286,5,0.0,0,11,0,5,19,5,0,11,0,16,35,1
7346,94297,PSQvTxj1y3we6BHzfg47qDUvmFQLocrD,RXDvfPUBYFlVdlueBFbLW0mhhAyGEqpt,4,3,1,0,0,0,2,0,6,0.8571428571428571,1,0.0,0,1,0,0,3,0,0,2,0,1,5,1
7347,94303,OFXXpJjmXQdJCa3neipnRUGCkhEYKOcL,RXDvfPUBYFlVdlueBFbLW0mhhAyGEqpt,1,0,0,0,0,0,1,0,1,0.14285714285714285,1,0.0,0,0,0,0,0,0,0,1,0,0,1,1
7348,94318,VykAceZUulaqkCpokuW5Za4FHqwbjR1t,bWdj2GDclj5ofokWjzoa5jAwMkxCykd6,2,0,0,0,0,0,3,0,3,0.42857142857142855,2,0.0,0,0,0,0,0,0,0,3,0,0,3,1
7349,94327,nm4sJLNdobmK6nfqGoX1goxharKsSyKv,RXDvfPUBYFlVdlueBFbLW0mhhAyGEqpt,6,3,2,0,2,0,1,0,8,1.1428571428571428,2,0.0,0,2,0,2,3,0,0,1,0,4,4,1
7350,94336,vtU6JORjVkLaXrwFmZEhiuwgIFIb8D5d,bWdj2GDclj5ofokWjzoa5jAwMkxCykd6,4,2,0,0,0,0,2,0,4,0.5714285714285714,1,0.0,0,0,0,0,2,0,0,2,0,0,4,1
7351,94338,yk8HuNxXIum8r8XDIOHqnAVeWfg9tYo1,bWdj2GDclj5ofokWjzoa5jAwMkxCykd6,24,37,17,88,8,2,4,0,156,22.285714285714285,2,0.0,17,17,88,8,20,2,0,4,0,130,26,1
7352,94345,57fIWdKz3C3DE8VWT2c85KC8LovB1GJc,SpATywNh6bZuzm8s1ceuBUnMUAeoAHHw,8,3,0,0,0,0,6,1,10,1.4285714285714286,1,0.0,0,0,0,0,3,0,0,6,1,0,10,1
7353,94349,tkz0XqYzbemGJfGKDWj9gxriQAFTaODF,SpATywNh6bZuzm8s1ceuBUnMUAeoAHHw,5,9,4,0,0,0,3,0,16,2.2857142857142856,1,0.0,0,4,0,0,9,0,0,3,0,4,12,1
7354,94360,Wx74KNuo9MEhjxtzU2HbTG4AbGSUPoBd,SpATywNh6bZuzm8s1ceuBUnMUAeoAHHw,13,11,6,0,4,1,4,0,26,3.7142857142857144,2,0.0,0,6,0,4,11,1,0,4,0,10,16,1
7355,94369,f83h4yuqimgMGxVhGXHOS7nPCMRes6Qy,A3fsA9Zfv1X2fVEQhTw51lKENdNrEqT3,20,10,9,0,8,0,2,0,29,4.142857142857143,1,0.0,0,9,0,8,10,0,0,2,0,17,12,1
7356,94370,LfQeKYjXm6fIUOYzQcp1BnDj9xoPObW8,SpATywNh6bZuzm8s1ceuBUnMUAeoAHHw,8,7,3,0,1,0,6,0,17,2.4285714285714284,1,0.0,0,3,0,1,7,0,0,6,0,4,13,1
7357,94371,na1nn5UiTLqwc4QuFzUQCajZnMiZo4DY,SpATywNh6bZuzm8s1ceuBUnMUAeoAHHw,9,7,5,6,1,0,3,0,22,3.142857142857143,1,0.0,0,5,5,1,7,0,1,3,0,11,11,1
7358,94380,FX47GMrA7B8YjGPkDGCkONJuduXkgeGC,A3fsA9Zfv1X2fVEQhTw51lKENdNrEqT3,1,0,0,0,0,0,1,0,1,0.14285714285714285,1,0.0,0,0,0,0,0,0,0,1,0,0,1,1
7359,94381,NpKmXMDiovurtYgXEkcoE0sVWAxI8pB3,SpATywNh6bZuzm8s1ceuBUnMUAeoAHHw,2,0,0,0,0,0,3,0,3,0.42857142857142855,1,0.0,0,0,0,0,0,0,0,3,0,0,3,1
7360,94390,2ZmAuHOKUwpsOZtu09BcUrjIotbqiy3i,RXDvfPUBYFlVdlueBFbLW0mhhAyGEqpt,7,2,1,0,0,1,6,1,11,1.5714285714285714,1,0.0,0,1,0,0,2,1,0,6,1,1,10,1
7361,94412,mXYBTPDkJluI9G6T4seVU7hhFpBmZYUl,G8EPVSXsOYB5YQWZGiz1aVq5Pgr2GrQu,5,2,1,0,1,0,2,0,6,0.8571428571428571,1,0.0,0,1,0,1,2,0,0,2,0,2,4,1
7362,94434,D7ijm86N7h5o3w1fsSkZ0iVyhHtcIbis,SpATywNh6bZuzm8s1ceuBUnMUAeoAHHw,20,37,9,40,2,11,6,1,106,15.142857142857142,2,0.0,26,9,34,2,11,11,6,6,1,71,35,0
7363,94436,dgp1qm7PjXoVV4MjyzuvWetQrJ3T9kos,A3fsA9Zfv1X2fVEQhTw51lKENdNrEqT3,13,10,7,0,3,2,20,2,44,6.285714285714286,3,0.0,0,7,0,3,10,2,0,20,2,10,34,1
7364,94440,Zp3KwB88qNkgRL7fOtXbXw8ohFvxUyg2,bWdj2GDclj5ofokWjzoa5jAwMkxCykd6,13,11,5,50,4,1,13,2,86,12.285714285714286,1,0.0,4,5,48,4,7,1,2,13,2,61,25,1
7365,94470,gTN0rkPeefB1hZOI5VW6CFWJwvhdBtBh,SpATywNh6bZuzm8s1ceuBUnMUAeoAHHw,5,2,1,0,1,0,4,0,8,1.1428571428571428,1,0.0,0,1,0,1,2,0,0,4,0,2,6,1
7366,94473,KkeLwwXyUiCfeVvKPcarXSSK8DrECkDe,A3fsA9Zfv1X2fVEQhTw51lKENdNrEqT3,5,7,3,0,0,0,3,0,13,1.8571428571428572,3,0.0,0,3,0,0,7,0,0,3,0,3,10,1
7367,94480,LkgxCzljZyoH3VIdoXwdLt0OprbSc3sT,SpATywNh6bZuzm8s1ceuBUnMUAeoAHHw,13,17,10,0,3,0,9,0,39,5.571428571428571,2,0.0,0,10,0,3,17,0,0,9,0,13,26,1
7368,94491,a9Qi5jUo324IBdWO7mih7fiFScdu3QAb,SpATywNh6bZuzm8s1ceuBUnMUAeoAHHw,5,4,3,0,0,0,1,0,8,1.1428571428571428,1,0.0,0,3,0,0,4,0,0,1,0,3,5,1
7369,94493,OseLd0Vj4CawbZPfZRznLZH5tivxQP68,G8EPVSXsOYB5YQWZGiz1aVq5Pgr2GrQu,15,10,4,14,2,0,2,0,32,4.571428571428571,1,0.0,6,4,8,2,4,0,6,2,0,20,12,1
7370,94892,nPRsjektHdbQkeAf1fIK4JbhrESPbPsA,fbPkOYLVPtPgIt0MxizjfFJov3JbHyAi,1,0,0,0,0,0,1,0,1,0.14285714285714285,1,0.0,0,0,0,0,0,0,0,1,0,0,1,1
7371,94908,Y0dtU5bUn0PrrnfgvOUCPfb1rktwn4CX,fbPkOYLVPtPgIt0MxizjfFJov3JbHyAi,11,13,6,0,4,2,12,1,38,5.428571428571429,2,0.0,0,6,0,4,13,2,0,12,1,10,28,1
7372,94913,YPe9PkGt8zBUqd5BCkLiDVIWrxR3Ane8,fbPkOYLVPtPgIt0MxizjfFJov3JbHyAi,1,0,0,0,0,0,1,0,1,0.14285714285714285,1,0.0,0,0,0,0,0,0,0,1,0,0,1,1
7373,94915,CD136AEP3K4fUPxB0PiyL0uWFPHfdCLY,fbPkOYLVPtPgIt0MxizjfFJov3JbHyAi,5,2,1,0,1,0,2,0,6,0.8571428571428571,1,0.0,0,1,0,1,2,0,0,2,0,2,4,1
7374,94916,tN25USY6Yw7TL4DfXwjrjqK862rGOedD,fbPkOYLVPtPgIt0MxizjfFJov3JbHyAi,7,3,2,0,2,0,5,0,12,1.7142857142857142,1,0.0,0,2,0,2,3,0,0,5,0,4,8,1
7375,94925,PF30Vqy17JIy50CbxBzrrEB7UvSbzYk3,fbPkOYLVPtPgIt0MxizjfFJov3JbHyAi,7,3,2,0,2,0,3,0,10,1.4285714285714286,2,0.0,0,2,0,2,3,0,0,3,0,4,6,1
7376,94926,5MiwmAeXmS1fmC9lSNRxf7aBKSjN4L17,fbPkOYLVPtPgIt0MxizjfFJov3JbHyAi,1,0,0,0,0,0,1,0,1,0.14285714285714285,1,0.0,0,0,0,0,0,0,0,1,0,0,1,1
7377,94927,BMt1sMJKW8lUV5XsrUOWqq2qoU33TZEw,fbPkOYLVPtPgIt0MxizjfFJov3JbHyAi,12,9,4,0,3,12,7,3,38,5.428571428571429,2,0.0,1,4,0,3,8,12,0,7,3,8,30,0
7378,94932,Oyh3flf2wYtqmXZJ703xfAIo394jSx4Q,fbPkOYLVPtPgIt0MxizjfFJov3JbHyAi,7,2,2,0,2,1,18,3,28,4.0,1,0.0,0,2,0,2,2,1,0,18,3,4,24,1
7379,94933,oASR1hbK6DD6OJfTJCDKLW9l2vPgw7kR,fbPkOYLVPtPgIt0MxizjfFJov3JbHyAi,6,3,2,0,2,0,1,0,8,1.1428571428571428,1,0.0,0,2,0,2,3,0,0,1,0,4,4,1
7380,94935,KbVIZwe7S3MOh9dlFVWDZwSpf3zNL2tv,fbPkOYLVPtPgIt0MxizjfFJov3JbHyAi,1,0,0,0,0,0,1,0,1,0.14285714285714285,1,0.0,0,0,0,0,0,0,0,1,0,0,1,1
7381,94936,uarVJhEs6XLW7Dw1D7iBgEK6zPe65WwX,fbPkOYLVPtPgIt0MxizjfFJov3JbHyAi,6,3,2,0,1,0,3,0,9,1.2857142857142858,1,0.0,0,2,0,1,3,0,0,3,0,3,6,1
7382,94937,P6rUUMuGXrvMpG8WR8uzYUJPpfieJxTd,fbPkOYLVPtPgIt0MxizjfFJov3JbHyAi,1,0,0,0,0,0,1,0,1,0.14285714285714285,1,0.0,0,0,0,0,0,0,0,1,0,0,1,1
7383,94939,gpRi42UI7sWUeBhI8VeTEp7H6XwIGlNG,fbPkOYLVPtPgIt0MxizjfFJov3JbHyAi,2,0,0,0,0,0,9,0,9,1.2857142857142858,1,0.0,0,0,0,0,0,0,0,9,0,0,9,1
7384,94940,2gXHY5qLgY96Nt3kImmboPawcy43EQXt,fbPkOYLVPtPgIt0MxizjfFJov3JbHyAi,7,3,2,0,2,0,2,0,9,1.2857142857142858,1,0.0,0,2,0,2,3,0,0,2,0,4,5,1
7385,94942,6u1ZWprTe7uoVhqimJI2aVqsjH23ao5o,fbPkOYLVPtPgIt0MxizjfFJov3JbHyAi,7,3,2,0,2,0,4,0,11,1.5714285714285714,1,0.0,0,2,0,2,3,0,0,4,0,4,7,1
7386,94944,Z13gCiJciUykTdLRTsjNu2GwwR7Nbxp1,fbPkOYLVPtPgIt0MxizjfFJov3JbHyAi,6,3,2,0,2,0,1,0,8,1.1428571428571428,1,0.0,0,2,0,2,3,0,0,1,0,4,4,1
7387,94945,VtEfFHwCwR0CG3OZFyRUkRQlzB85HLcu,fbPkOYLVPtPgIt0MxizjfFJov3JbHyAi,4,2,1,0,1,0,1,0,5,0.7142857142857143,1,0.0,0,1,0,1,2,0,0,1,0,2,3,1
7388,94947,MDIYLIYQBWx9HiPTzYboxCieX8UYramh,fbPkOYLVPtPgIt0MxizjfFJov3JbHyAi,2,0,0,0,0,0,3,0,3,0.42857142857142855,2,0.0,0,0,0,0,0,0,0,3,0,0,3,1
7389,94948,wtEiMTsSGyqVYmzAUWtaJeXU5b3t5li0,fbPkOYLVPtPgIt0MxizjfFJov3JbHyAi,9,7,5,0,3,8,2,0,25,3.5714285714285716,1,0.0,1,5,0,3,6,8,0,2,0,9,16,1
7390,94949,6VGKONVpl1KgJ6EuaAzeKa8BNrxzEeZU,fbPkOYLVPtPgIt0MxizjfFJov3JbHyAi,7,9,1,0,1,0,2,0,13,1.8571428571428572,2,0.0,0,1,0,1,9,0,0,2,0,2,11,1
7391,94951,Th6GGIKucyCokdQsUn3aOeloTzqx0Qbo,fbPkOYLVPtPgIt0MxizjfFJov3JbHyAi,1,0,0,0,0,0,1,0,1,0.14285714285714285,1,0.0,0,0,0,0,0,0,0,1,0,0,1,1
7392,95304,sXXu4twesSnXXidsHxSOeMg5Xzk8xAsm,A3fsA9Zfv1X2fVEQhTw51lKENdNrEqT3,2,0,0,0,0,0,2,0,2,0.2857142857142857,1,0.0,0,0,0,0,0,0,0,2,0,0,2,0
7393,95315,U0aWEpE7Ns3m6FjrcttSNCCy6f34uaV4,SpATywNh6bZuzm8s1ceuBUnMUAeoAHHw,1,0,0,0,0,0,1,0,1,0.14285714285714285,1,0.0,0,0,0,0,0,0,0,1,0,0,1,1
7394,95323,Ge5fW9CsKdA0D6503NL20NzJpcoMVtar,SpATywNh6bZuzm8s1ceuBUnMUAeoAHHw,6,2,1,0,1,0,3,0,7,1.0,1,0.0,0,1,0,1,2,0,0,3,0,2,5,1
7395,95333,YybGVTqjY7vuqDLgHStfT8JBgnvTLDFS,bWdj2GDclj5ofokWjzoa5jAwMkxCykd6,6,2,1,0,1,0,3,0,7,1.0,1,0.0,0,1,0,1,2,0,0,3,0,2,5,1
7396,95336,QzVwezWUOBpl33EMiprsTWQNwkGzpYUZ,RXDvfPUBYFlVdlueBFbLW0mhhAyGEqpt,1,0,0,0,0,0,1,0,1,0.14285714285714285,1,0.0,0,0,0,0,0,0,0,1,0,0,1,0
7397,95343,WjGAvDgXPzKEfssMPXtQ1xVWZPI1hH6R,SpATywNh6bZuzm8s1ceuBUnMUAeoAHHw,3,2,0,0,0,0,1,0,3,0.42857142857142855,1,0.0,0,0,0,0,2,0,0,1,0,0,3,0
7398,95365,Ieqd5itEcYJJN0R1exEtlEqnGZPAbCE6,A3fsA9Zfv1X2fVEQhTw51lKENdNrEqT3,4,3,1,0,1,0,2,0,7,1.0,1,0.0,0,1,0,1,3,0,0,2,0,2,5,1
7399,95379,jl79Z6TfXd4YLzsAQwSCeo1eMaF6Ha8d,A3fsA9Zfv1X2fVEQhTw51lKENdNrEqT3,10,7,0,0,0,4,9,1,21,3.0,1,0.0,0,0,0,0,7,4,0,9,1,0,21,1
7400,95421,Bha7QMGmONKAqxvqVmMzYDzgn03rupB9,A3fsA9Zfv1X2fVEQhTw51lKENdNrEqT3,2,0,0,0,0,0,2,0,2,0.2857142857142857,1,0.0,0,0,0,0,0,0,0,2,0,0,2,1
7401,95443,Bha7QMGmONKAqxvqVmMzYDzgn03rupB9,bWdj2GDclj5ofokWjzoa5jAwMkxCykd6,4,2,1,0,0,0,3,0,6,0.8571428571428571,1,0.0,0,1,0,0,2,0,0,3,0,1,5,1
7402,95457,5yUqlUp9Xefz1r5QbYyqOcfkyddpZEv3,SpATywNh6bZuzm8s1ceuBUnMUAeoAHHw,19,22,6,12,5,0,5,0,50,7.142857142857143,1,0.0,9,6,10,5,13,0,2,5,0,30,20,1
7403,95460,yell4xFioKaQh1Eh8e1BHgTr9kNc23uL,G8EPVSXsOYB5YQWZGiz1aVq5Pgr2GrQu,2,0,0,0,0,0,2,0,2,0.2857142857142857,1,0.0,0,0,0,0,0,0,0,2,0,0,2,1
7404,95491,pO2KznyI9EIaBuWTbRmHrZfzq1y78Swj,A3fsA9Zfv1X2fVEQhTw51lKENdNrEqT3,10,6,4,0,4,0,3,0,17,2.4285714285714284,1,0.0,1,4,0,4,5,0,0,3,0,9,8,1
7405,95501,XgCNwD2cEVKtD4WAVaPORGAj8LHTJr5e,A3fsA9Zfv1X2fVEQhTw51lKENdNrEqT3,1,0,0,0,0,0,2,0,2,0.2857142857142857,2,0.0,0,0,0,0,0,0,0,2,0,0,2,1
7406,95518,GjBrMYHaMHg9XRlK0GO1kzoiYlxNFcC2,A3fsA9Zfv1X2fVEQhTw51lKENdNrEqT3,60,29,19,126,9,0,13,0,196,28.0,3,0.0,2,19,118,9,27,0,8,13,0,148,48,1
7407,95519,3TwYkv5KYm0nsRHdmcaiJpajLH9JQ0UG,A3fsA9Zfv1X2fVEQhTw51lKENdNrEqT3,3,0,0,0,0,0,5,0,5,0.7142857142857143,1,0.0,0,0,0,0,0,0,0,5,0,0,5,1
7408,95547,t3XemfoUPPfcRENYQvP2H3PO2tJX9CiG,SpATywNh6bZuzm8s1ceuBUnMUAeoAHHw,4,2,1,0,1,0,1,0,5,0.7142857142857143,1,0.0,0,1,0,1,2,0,0,1,0,2,3,1
7409,95560,oSEQ14Ll1d8ZBrsI9L5wTDmDWqMOqneK,A3fsA9Zfv1X2fVEQhTw51lKENdNrEqT3,14,7,6,0,6,1,7,1,28,4.0,1,0.0,0,6,0,6,7,1,0,7,1,12,16,1
7410,95566,WdzyWsqPss1ohcmLXQZkxthaNy8YyGzL,A3fsA9Zfv1X2fVEQhTw51lKENdNrEqT3,3,0,0,0,0,0,5,0,5,0.7142857142857143,1,0.0,0,0,0,0,0,0,0,5,0,0,5,1
7411,95567,BlS8PCoC6oTDUZj2Hj1GOesx0cnG3IDt,A3fsA9Zfv1X2fVEQhTw51lKENdNrEqT3,8,6,4,0,2,0,5,0,17,2.4285714285714284,1,0.0,0,4,0,2,6,0,0,5,0,6,11,1
7412,95570,nYSFDE8RCbcZhD46fRSvPHUvA1ahfupi,SpATywNh6bZuzm8s1ceuBUnMUAeoAHHw,8,9,1,0,1,4,5,0,20,2.857142857142857,1,0.0,0,1,0,1,9,4,0,5,0,2,18,1
7413,95579,8DrwDXKGEBLVwNt7dUNV7BIWxiG8AH1C,A3fsA9Zfv1X2fVEQhTw51lKENdNrEqT3,8,7,2,0,2,0,7,0,18,2.5714285714285716,1,0.0,0,2,0,2,7,0,0,7,0,4,14,1
7414,95584,vnJ8iXwVjPF96rPn5RIZQWSaOopjKseH,SpATywNh6bZuzm8s1ceuBUnMUAeoAHHw,28,33,14,40,8,0,11,0,106,15.142857142857142,1,0.0,8,14,34,8,25,0,6,11,0,64,42,1
7415,95604,nYSFDE8RCbcZhD46fRSvPHUvA1ahfupi,G8EPVSXsOYB5YQWZGiz1aVq5Pgr2GrQu,7,4,1,0,1,1,2,0,9,1.2857142857142858,1,0.0,0,1,0,1,4,1,0,2,0,2,7,1
7416,95610,nYSFDE8RCbcZhD46fRSvPHUvA1ahfupi,A3fsA9Zfv1X2fVEQhTw51lKENdNrEqT3,9,7,1,0,1,3,2,0,14,2.0,1,0.0,0,1,0,1,7,3,0,2,0,2,12,1
7417,95621,nH3NRDQLecB3hMbOpaitsdqKrlyEIXGh,SpATywNh6bZuzm8s1ceuBUnMUAeoAHHw,25,29,17,34,7,0,4,0,91,13.0,3,0.0,8,17,29,7,21,0,5,4,0,61,30,0
7418,95640,Y7qsqdZIsv6Hy0vu4LtgtbOKv08z7vaS,A3fsA9Zfv1X2fVEQhTw51lKENdNrEqT3,2,0,0,0,0,0,2,0,2,0.2857142857142857,1,0.0,0,0,0,0,0,0,0,2,0,0,2,1
7419,95647,kHWuc10C4T4imgPGXw1iL9DdxxMDyloj,A3fsA9Zfv1X2fVEQhTw51lKENdNrEqT3,2,0,0,0,0,0,3,0,3,0.42857142857142855,1,0.0,0,0,0,0,0,0,0,3,0,0,3,1
7420,95655,aFVIDdMfPLCaqut6kVxorTellYImwEAn,RXDvfPUBYFlVdlueBFbLW0mhhAyGEqpt,1,0,0,0,0,0,1,0,1,0.14285714285714285,1,0.0,0,0,0,0,0,0,0,1,0,0,1,1
7421,95692,PoMIsULf4fdpKNpab6c33l88EClRsCjy,A3fsA9Zfv1X2fVEQhTw51lKENdNrEqT3,14,7,6,0,5,0,2,0,20,2.857142857142857,1,0.0,0,6,0,5,7,0,0,2,0,11,9,0
7422,95693,lLO2IvxcSlYUuWvFwkacGc9eGibtMx0u,A3fsA9Zfv1X2fVEQhTw51lKENdNrEqT3,1,0,0,0,0,0,1,0,1,0.14285714285714285,1,0.0,0,0,0,0,0,0,0,1,0,0,1,1
7423,95713,XUeZabU3qZWCaiD6wFnhBaCufbfFTb2H,A3fsA9Zfv1X2fVEQhTw51lKENdNrEqT3,16,7,6,0,6,0,3,0,22,3.142857142857143,1,0.0,0,6,0,6,7,0,0,3,0,12,10,1
7424,95742,Y9G0Vd7vUaj0pt9EeQDbDOvFl3eVdYaR,RXDvfPUBYFlVdlueBFbLW0mhhAyGEqpt,1,0,0,0,0,0,1,0,1,0.14285714285714285,1,0.0,0,0,0,0,0,0,0,1,0,0,1,1
7425,95754,fXpjk0OrbkXxQzpvttVDelNPD6lPfJXA,SpATywNh6bZuzm8s1ceuBUnMUAeoAHHw,20,14,8,19,6,0,6,0,53,7.571428571428571,1,0.0,6,8,16,6,8,0,3,6,0,36,17,1
7426,95775,WuM67GwQW9M3d1mnuGHuvAdo907S9qb5,SpATywNh6bZuzm8s1ceuBUnMUAeoAHHw,1,0,0,0,0,0,1,0,1,0.14285714285714285,1,0.0,0,0,0,0,0,0,0,1,0,0,1,0
7427,95777,Yc8rNkAsH37cAbAebyiE6I2RsfVaxpIZ,A3fsA9Zfv1X2fVEQhTw51lKENdNrEqT3,7,3,2,0,2,0,2,0,9,1.2857142857142858,1,0.0,0,2,0,2,3,0,0,2,0,4,5,1
7428,95783,Xcq5CVanT8J8ISNJVeThaVoqYhMkjumr,SpATywNh6bZuzm8s1ceuBUnMUAeoAHHw,5,2,1,0,1,0,2,0,6,0.8571428571428571,1,0.0,0,1,0,1,2,0,0,2,0,2,4,1
7429,95790,aSlIMkfly6xTMJCGTWDQcnFZjajcWM6y,A3fsA9Zfv1X2fVEQhTw51lKENdNrEqT3,7,4,1,0,1,0,2,0,8,1.1428571428571428,1,0.0,0,1,0,1,4,0,0,2,0,2,6,1
7430,95796,AfmdKPTL0IbcupndNMlY5c7PImPraChY,SpATywNh6bZuzm8s1ceuBUnMUAeoAHHw,25,20,11,16,5,0,6,1,59,8.428571428571429,2,0.0,6,11,15,5,14,0,1,6,1,37,22,1
7431,95800,XhN7QGypor4DcMvMWEJ3oRIi5DeJwYDV,SpATywNh6bZuzm8s1ceuBUnMUAeoAHHw,14,20,1,15,1,2,3,0,42,6.0,2,0.0,10,1,14,1,10,2,1,3,0,26,16,1
7432,95805,jN3AJMUVBTsXIfTNwaMmorNzhVw7coVS,A3fsA9Zfv1X2fVEQhTw51lKENdNrEqT3,2,0,0,0,0,0,2,0,2,0.2857142857142857,1,0.0,0,0,0,0,0,0,0,2,0,0,2,1
7433,95817,1uEo4BzsZxlgHBFClnUu9nbvDrRmzn4T,SpATywNh6bZuzm8s1ceuBUnMUAeoAHHw,7,4,3,5,1,0,1,0,14,2.0,1,0.0,0,3,5,1,4,0,0,1,0,9,5,1
7434,95824,qHYMkh2G06Tgj4MMABvKGj1g29BRMeXu,SpATywNh6bZuzm8s1ceuBUnMUAeoAHHw,6,4,3,0,3,0,1,0,11,1.5714285714285714,1,0.0,0,3,0,3,4,0,0,1,0,6,5,1
7435,95827,1u5RJ3ohzI9I8TYHEG8zy2n2QjuVVCRw,SpATywNh6bZuzm8s1ceuBUnMUAeoAHHw,1,0,0,0,0,0,1,0,1,0.14285714285714285,1,0.0,0,0,0,0,0,0,0,1,0,0,1,1
7436,95834,86utfBtmFqtE8TLsj2h1BusfBdMTH1O8,SpATywNh6bZuzm8s1ceuBUnMUAeoAHHw,10,11,3,1,2,0,2,0,19,2.7142857142857144,2,0.0,2,3,1,2,9,0,0,2,0,8,11,1
7437,95841,AEeLy9n4nUl6UlG8WfSP7Q5sqAzFdtaD,A3fsA9Zfv1X2fVEQhTw51lKENdNrEqT3,19,28,22,0,17,13,9,1,90,12.857142857142858,8,0.0,0,22,0,17,28,13,0,9,1,39,51,0
7438,95849,j3HNnX1GWjrCGNX5n4Ax13Vu5X6WNds7,SpATywNh6bZuzm8s1ceuBUnMUAeoAHHw,5,2,1,0,1,0,2,0,6,0.8571428571428571,1,0.0,0,1,0,1,2,0,0,2,0,2,4,1
7439,95866,wdK5DIKl9qd73hM1uOx3ufcKj0J9AcRr,A3fsA9Zfv1X2fVEQhTw51lKENdNrEqT3,9,8,6,0,5,0,2,0,21,3.0,2,0.0,0,6,0,5,8,0,0,2,0,11,10,1
7440,95877,ofStwmRRBPN4Od7HYTx4tgAh724FKaML,RXDvfPUBYFlVdlueBFbLW0mhhAyGEqpt,8,4,0,0,0,4,4,1,13,1.8571428571428572,1,0.0,0,0,0,0,4,4,0,4,1,0,13,1
7441,95886,xsD2uaFheAaDTDHzSeAKROA0IH2KQICZ,SpATywNh6bZuzm8s1ceuBUnMUAeoAHHw,12,11,1,6,1,0,2,0,21,3.0,1,0.0,2,1,6,1,9,0,0,2,0,10,11,1
7442,95903,8Bi5fR0qSZjzFptY6NNbPZ6GLpteABmy,SpATywNh6bZuzm8s1ceuBUnMUAeoAHHw,4,2,0,0,0,0,3,0,5,0.7142857142857143,2,0.0,0,0,0,0,2,0,0,3,0,0,5,1
7443,95914,rTLMEQB78zn1g6bt6KRypanGZ8QWPbQv,A3fsA9Zfv1X2fVEQhTw51lKENdNrEqT3,62,87,15,162,12,48,35,1,360,51.42857142857143,9,0.0,8,15,129,12,79,48,33,35,1,164,196,0
7444,95924,yF9l9yvoXyIeGTDuNPcQeoWm8bOFk82H,A3fsA9Zfv1X2fVEQhTw51lKENdNrEqT3,1,0,0,0,0,0,1,0,1,0.14285714285714285,1,0.0,0,0,0,0,0,0,0,1,0,0,1,1
7445,95938,H8hXX8mRAbdpVvW9JxPUH4Vz1O6DjIDQ,SpATywNh6bZuzm8s1ceuBUnMUAeoAHHw,12,15,4,11,3,0,1,0,34,4.857142857142857,1,0.0,10,4,10,3,5,0,1,1,0,27,7,1
7446,95943,Gnvd8M3zeIOpApc28ArYy1li1qM7ZTwg,SpATywNh6bZuzm8s1ceuBUnMUAeoAHHw,15,26,0,18,0,1,10,2,57,8.142857142857142,2,0.0,6,0,15,0,20,1,3,10,2,21,36,1
7447,95946,VSxmvcFHrZIVtNnTaFw0qdfh1Zdl1LMy,SpATywNh6bZuzm8s1ceuBUnMUAeoAHHw,27,43,20,12,9,0,4,0,88,12.571428571428571,3,0.0,19,20,12,9,24,0,0,4,0,60,28,0
7448,95965,L22oksNNnEaRYr1idj7T9wNLQN39zTXs,SpATywNh6bZuzm8s1ceuBUnMUAeoAHHw,8,2,1,0,1,1,5,1,11,1.5714285714285714,1,0.0,0,1,0,1,2,1,0,5,1,2,9,1
7449,95979,kYCiC9sjJhVea0nSa72pTn7A2eOhjLmI,SpATywNh6bZuzm8s1ceuBUnMUAeoAHHw,10,6,4,0,3,1,8,1,23,3.2857142857142856,2,0.0,0,4,0,3,6,1,0,8,1,7,16,1
7450,95984,D9YS628mhjQ1I60HvdkUWN4SFDF5a33E,SpATywNh6bZuzm8s1ceuBUnMUAeoAHHw,7,2,0,0,0,1,5,1,9,1.2857142857142858,1,0.0,0,0,0,0,2,1,0,5,1,0,9,1
7451,95991,S144mYN036ngEoT5NOZhFV5f1CGtYvQl,SpATywNh6bZuzm8s1ceuBUnMUAeoAHHw,7,2,0,0,0,1,7,1,11,1.5714285714285714,1,0.0,0,0,0,0,2,1,0,7,1,0,11,1
7452,96002,Hxd16O3nQG6ddXQCBbAu8BGBmmZmiixl,bWdj2GDclj5ofokWjzoa5jAwMkxCykd6,1,0,0,0,0,0,1,0,1,0.14285714285714285,1,0.0,0,0,0,0,0,0,0,1,0,0,1,1
7453,96009,GpLd8OePUlzkVkOH6kyAjUXsolCeEYNN,RXDvfPUBYFlVdlueBFbLW0mhhAyGEqpt,7,3,1,0,1,0,3,0,8,1.1428571428571428,1,0.0,0,1,0,1,3,0,0,3,0,2,6,1
7454,96015,5AnpX5rZgeZiqdXpEpBXchayqHICSQR2,SpATywNh6bZuzm8s1ceuBUnMUAeoAHHw,9,6,4,0,2,0,2,0,14,2.0,1,0.0,1,4,0,2,5,0,0,2,0,7,7,1
7455,96018,HPasLgueYgbdk1es5obBHn6eCO700ZnM,G8EPVSXsOYB5YQWZGiz1aVq5Pgr2GrQu,5,2,1,0,1,0,3,0,7,1.0,1,0.0,0,1,0,1,2,0,0,3,0,2,5,1
7456,96021,ix15aF6FOEF1waZCSZt01VrPOuPGJ3yM,SpATywNh6bZuzm8s1ceuBUnMUAeoAHHw,19,21,0,12,0,4,9,1,47,6.714285714285714,4,0.0,10,0,12,0,11,4,0,9,1,22,25,0
7457,96028,3tDepbYkazgiOrBsQmbtJa1H3rNZc54O,SpATywNh6bZuzm8s1ceuBUnMUAeoAHHw,9,5,1,0,1,0,7,2,16,2.2857142857142856,2,0.0,0,1,0,1,5,0,0,7,2,2,14,0
7458,96037,zwqhxdboQszkcKvPN5pyN1nGDFR4ub3y,bWdj2GDclj5ofokWjzoa5jAwMkxCykd6,7,8,1,6,4,0,3,0,22,3.142857142857143,2,0.0,6,1,6,4,2,0,0,3,0,17,5,1
7459,96038,NGxVJQppNBMfgJiFwD3Ox6xl5bHm79ig,A3fsA9Zfv1X2fVEQhTw51lKENdNrEqT3,7,5,4,0,1,0,2,0,12,1.7142857142857142,1,0.0,0,4,0,1,5,0,0,2,0,5,7,1
7460,96051,nl7CfVETct3efRgniW8qXKplgQDLZElB,bWdj2GDclj5ofokWjzoa5jAwMkxCykd6,2,0,0,0,0,0,3,0,3,0.42857142857142855,1,0.0,0,0,0,0,0,0,0,3,0,0,3,1
7461,96060,1FiRW6JL0h34vWqoZjG8ei2zujPF23NL,A3fsA9Zfv1X2fVEQhTw51lKENdNrEqT3,68,61,28,90,13,2,20,1,215,30.714285714285715,4,0.0,7,28,87,13,54,2,3,20,1,135,80,1
7462,96063,McYATdhZDDMDpni6a4GbjI06ustMpvdV,bWdj2GDclj5ofokWjzoa5jAwMkxCykd6,1,0,0,0,0,0,2,0,2,0.2857142857142857,2,0.0,0,0,0,0,0,0,0,2,0,0,2,1
7463,96074,MiDD69NvLCtsK6jzM5U32WgBFDv8XbVJ,A3fsA9Zfv1X2fVEQhTw51lKENdNrEqT3,11,7,2,0,2,0,11,1,23,3.2857142857142856,1,0.0,0,2,0,2,7,0,0,11,1,4,19,0
7464,96080,nBih09u5WtqrKAXZJuGGTQZ4MinMYlfW,SpATywNh6bZuzm8s1ceuBUnMUAeoAHHw,5,2,0,0,0,0,7,0,9,1.2857142857142858,1,0.0,0,0,0,0,2,0,0,7,0,0,9,1
7465,96094,ps5VcFUapZM31sy4VNJWOTFBzN98932v,SpATywNh6bZuzm8s1ceuBUnMUAeoAHHw,1,0,0,0,0,0,1,0,1,0.14285714285714285,1,0.0,0,0,0,0,0,0,0,1,0,0,1,1
7466,96102,VLNGwZ1eoTZ1MrW64VolhWSmnDD0C1Ov,A3fsA9Zfv1X2fVEQhTw51lKENdNrEqT3,8,3,2,0,1,4,8,1,19,2.7142857142857144,2,0.0,0,2,0,1,3,4,0,8,1,3,16,1
7467,96105,IhdK4MEktWiSl0ozGtXiJFeE1awPcboi,SpATywNh6bZuzm8s1ceuBUnMUAeoAHHw,29,37,19,37,8,3,8,0,112,16.0,2,0.0,6,19,32,8,31,3,5,8,0,65,47,1
7468,96109,gnTcbZ4BOuQk0BfuzZDpGiEEYJSGOrYu,SpATywNh6bZuzm8s1ceuBUnMUAeoAHHw,26,25,16,30,12,5,3,0,91,13.0,2,0.0,5,16,27,12,20,5,3,3,0,60,31,1
7469,96112,o3REKVT5jtm2Ed8QHiz1c3PlSbYTElLg,SpATywNh6bZuzm8s1ceuBUnMUAeoAHHw,3,0,0,0,0,0,3,0,3,0.42857142857142855,1,0.0,0,0,0,0,0,0,0,3,0,0,3,1
7470,96113,o3REKVT5jtm2Ed8QHiz1c3PlSbYTElLg,G8EPVSXsOYB5YQWZGiz1aVq5Pgr2GrQu,2,0,0,0,0,0,2,0,2,0.2857142857142857,1,0.0,0,0,0,0,0,0,0,2,0,0,2,1
7471,96114,XYKEbaRABcMuBHmMB2I3YkBepzCp0swB,A3fsA9Zfv1X2fVEQhTw51lKENdNrEqT3,32,22,2,82,0,14,6,0,126,18.0,4,0.0,3,2,66,0,19,14,16,6,0,71,55,1
7472,96121,gnTcbZ4BOuQk0BfuzZDpGiEEYJSGOrYu,A3fsA9Zfv1X2fVEQhTw51lKENdNrEqT3,7,3,2,0,2,0,4,0,11,1.5714285714285714,2,0.0,0,2,0,2,3,0,0,4,0,4,7,1
7473,96126,8n73BBd3mvRJq2a0KZ4WJWTYj65s8f61,bWdj2GDclj5ofokWjzoa5jAwMkxCykd6,1,0,0,0,0,0,1,0,1,0.14285714285714285,1,0.0,0,0,0,0,0,0,0,1,0,0,1,1
7474,96133,gMMqUNqa2ZYLkCBhPE0t3hx9nA1CQadH,SpATywNh6bZuzm8s1ceuBUnMUAeoAHHw,31,67,37,32,22,11,16,1,186,26.571428571428573,6,0.0,20,37,29,22,47,11,3,16,1,108,78,0
7475,96140,QTgmoEmFx7yveY8D3dDCUQU4BnndurNn,RXDvfPUBYFlVdlueBFbLW0mhhAyGEqpt,69,112,51,86,61,11,14,1,336,48.0,8,0.0,16,51,84,61,96,11,2,14,1,212,124,0
7476,96698,kfq7KT5bB5EYh8pOfijeZyMqCV9XlzvB,RXDvfPUBYFlVdlueBFbLW0mhhAyGEqpt,13,9,7,0,2,7,4,1,30,4.285714285714286,1,0.0,0,7,0,2,9,7,0,4,1,9,21,0
7477,96720,nyH7Jx4kN1AdDJdwkZQoUDqYoovHgbk5,SpATywNh6bZuzm8s1ceuBUnMUAeoAHHw,17,31,16,16,11,0,3,0,77,11.0,3,0.0,4,16,15,11,27,0,1,3,0,46,31,1
7478,96733,tMJpDv6ZjEPz2ELzUVp4mZTT6G7u49T6,SpATywNh6bZuzm8s1ceuBUnMUAeoAHHw,2,0,0,0,0,0,2,0,2,0.2857142857142857,1,0.0,0,0,0,0,0,0,0,2,0,0,2,1
7479,96734,fAZJvvaqILemW9qqdyo0ZQidn1S9S3J8,RXDvfPUBYFlVdlueBFbLW0mhhAyGEqpt,42,119,2,106,4,16,22,5,274,39.142857142857146,5,0.0,14,2,91,4,105,16,15,22,5,111,163,1
7480,96776,Q2sM7xUZ5pftXbE3pDquUzMiyNyEc1IS,SpATywNh6bZuzm8s1ceuBUnMUAeoAHHw,5,6,0,0,0,1,5,0,12,1.7142857142857142,1,0.0,0,0,0,0,6,1,0,5,0,0,12,1
7481,96805,l5LcQXaXypTaa8UtbYyDr1XartlmUM1X,A3fsA9Zfv1X2fVEQhTw51lKENdNrEqT3,3,0,0,0,0,0,5,0,5,0.7142857142857143,1,0.0,0,0,0,0,0,0,0,5,0,0,5,1
7482,96818,ULdF32fTmMpV957Ngz6P80D0kuxYFb2A,SpATywNh6bZuzm8s1ceuBUnMUAeoAHHw,30,25,13,18,6,0,25,3,90,12.857142857142858,6,0.0,11,13,17,6,14,0,1,25,3,47,43,0
7483,96873,cD5CJQRtTCG0McZYvErqx6oV3tTvutc8,RXDvfPUBYFlVdlueBFbLW0mhhAyGEqpt,46,50,22,73,9,19,7,3,183,26.142857142857142,1,0.0,11,22,70,9,39,19,3,7,3,112,71,1
7484,96901,umy7brIUz48bN1VUJsZEuHA9by5FINCa,7GRhBDsirIGkRZBtSMEzNTyDr2JQm4xx,4,2,1,0,1,0,1,0,5,0.7142857142857143,1,0.0,0,1,0,1,2,0,0,1,0,2,3,1
7485,96903,1pK61ylyaaC4hALoXRUV5dMzHILaBLST,7GRhBDsirIGkRZBtSMEzNTyDr2JQm4xx,10,6,4,0,3,3,5,0,21,3.0,1,0.0,0,4,0,3,6,3,0,5,0,7,14,1
7486,96909,cydJyLaLNn5DY7FvXVsvxCdKUpzLzSYa,7GRhBDsirIGkRZBtSMEzNTyDr2JQm4xx,1,0,0,0,0,0,1,0,1,0.14285714285714285,1,0.0,0,0,0,0,0,0,0,1,0,0,1,1
7487,96932,RdNoFjcCRsxTOOSC7N4ELIdxTaySGrVr,SpATywNh6bZuzm8s1ceuBUnMUAeoAHHw,27,34,14,26,7,3,4,0,88,12.571428571428571,2,0.0,16,14,26,7,18,3,0,4,0,63,25,0
7488,96942,ddBSvwjxr0YTDDcnYkevrytFfJuV96PQ,7GRhBDsirIGkRZBtSMEzNTyDr2JQm4xx,6,2,2,0,1,4,3,0,12,1.7142857142857142,1,0.0,0,2,0,1,2,4,0,3,0,3,9,0
7489,96973,sDkPRIBG4BxIPEbrLzSh2qpuZHtht3Is,7GRhBDsirIGkRZBtSMEzNTyDr2JQm4xx,5,5,0,0,0,4,2,1,12,1.7142857142857142,1,0.0,0,0,0,0,5,4,0,2,1,0,12,1
7490,96981,lWM0T55BVqig0BJS7dua8PmdCMELT35Y,SpATywNh6bZuzm8s1ceuBUnMUAeoAHHw,6,7,2,0,1,0,3,0,13,1.8571428571428572,1,0.0,0,2,0,1,7,0,0,3,0,3,10,0
7491,96985,JXYISIoy0xfDgxPuIXBBnerkjGt68Wii,7GRhBDsirIGkRZBtSMEzNTyDr2JQm4xx,2,0,0,0,0,0,2,0,2,0.2857142857142857,1,0.0,0,0,0,0,0,0,0,2,0,0,2,1
7492,96988,UpJhrUDqF2VjXGqQuraSx51MIPsKK7IC,7GRhBDsirIGkRZBtSMEzNTyDr2JQm4xx,1,0,0,0,0,0,1,0,1,0.14285714285714285,1,0.0,0,0,0,0,0,0,0,1,0,0,1,1
7493,96994,Pn5FZNl6VLJk6Snk5stzxPkp0wDMfahE,7GRhBDsirIGkRZBtSMEzNTyDr2JQm4xx,17,18,7,6,7,6,3,0,47,6.714285714285714,1,0.0,10,7,5,7,8,6,1,3,0,29,18,1
7494,97000,NTUe1XMr3a8PtjVuNaWc1ebEh7ejstpo,7GRhBDsirIGkRZBtSMEzNTyDr2JQm4xx,5,3,1,0,1,1,2,0,8,1.1428571428571428,1,0.0,0,1,0,1,3,1,0,2,0,2,6,1
7495,97002,uRoFRO1euFkfOgsqx7mXaWeoTuIR1DXQ,7GRhBDsirIGkRZBtSMEzNTyDr2JQm4xx,1,0,0,0,0,0,1,0,1,0.14285714285714285,1,0.0,0,0,0,0,0,0,0,1,0,0,1,1
7496,97009,nRHQUNRUIsIinoYx4tQlxNnAC0I3YYVk,7GRhBDsirIGkRZBtSMEzNTyDr2JQm4xx,4,2,1,0,1,0,1,0,5,0.7142857142857143,1,0.0,0,1,0,1,2,0,0,1,0,2,3,1
7497,97022,B5xWWXtq7QtEIXusjmb70Va0vI762ykg,7GRhBDsirIGkRZBtSMEzNTyDr2JQm4xx,1,0,0,0,0,0,1,0,1,0.14285714285714285,1,0.0,0,0,0,0,0,0,0,1,0,0,1,1
7498,97065,M2tv4JvKfiiNHzXtHrilXY5dpWpYAsaI,7GRhBDsirIGkRZBtSMEzNTyDr2JQm4xx,32,47,23,52,12,6,18,3,161,23.0,2,0.0,19,23,46,12,28,6,6,18,3,100,61,1
7499,97117,c8WJAdYLV71mOx4ZXSglpCNd0dBUR3Om,7GRhBDsirIGkRZBtSMEzNTyDr2JQm4xx,72,54,21,77,12,0,8,0,172,24.571428571428573,4,0.0,27,21,77,12,27,0,0,8,0,137,35,0
7500,97118,4qkLaALORr1a036cib5fpJjiu97UEMIR,A3fsA9Zfv1X2fVEQhTw51lKENdNrEqT3,1,0,0,0,0,0,1,0,1,0.14285714285714285,1,0.0,0,0,0,0,0,0,0,1,0,0,1,0
7501,97187,QRq9SneqdOEdNrPCbzGfNOJsUrpMzzSX,7GRhBDsirIGkRZBtSMEzNTyDr2JQm4xx,6,2,1,0,0,0,4,1,8,1.1428571428571428,1,0.0,0,1,0,0,2,0,0,4,1,1,7,1
7502,97214,9HiOT9GgvrP1q1oAqpQLpBir7zKJrsoX,A3fsA9Zfv1X2fVEQhTw51lKENdNrEqT3,26,30,16,0,9,0,6,0,61,8.714285714285714,2,0.0,0,16,0,9,30,0,0,6,0,25,36,0
7503,97263,7xpmz6LF4dl35fFKZgRU70OZyF8UO4PL,A3fsA9Zfv1X2fVEQhTw51lKENdNrEqT3,11,11,5,0,7,0,2,0,25,3.5714285714285716,1,0.0,1,5,0,7,10,0,0,2,0,13,12,0
7504,97267,lDlatmKJdo0qBYapZcbWQLsUydBhY3xU,7GRhBDsirIGkRZBtSMEzNTyDr2JQm4xx,2,0,0,0,0,0,2,0,2,0.2857142857142857,1,0.0,0,0,0,0,0,0,0,2,0,0,2,1
7505,97280,K3hHnTNefmiCtc4XrTaWBBqlsZLO9w2Y,7GRhBDsirIGkRZBtSMEzNTyDr2JQm4xx,7,2,1,0,1,0,6,0,10,1.4285714285714286,1,0.0,0,1,0,1,2,0,0,6,0,2,8,1
7506,97284,pMJooPSuvdyxYlrVEgbsDyM57xOtG2AB,7GRhBDsirIGkRZBtSMEzNTyDr2JQm4xx,10,20,8,0,3,5,12,1,49,7.0,1,0.0,0,8,0,3,20,5,0,12,1,11,38,1
7507,97298,tp9GLoYyljDV6mILQxrtrv1Iw4qcPl5Z,7GRhBDsirIGkRZBtSMEzNTyDr2JQm4xx,6,4,2,0,1,0,2,0,9,1.2857142857142858,1,0.0,1,2,0,1,3,0,0,2,0,4,5,1
7508,97310,OQh4D4FzaoRB0CBhRcAfr9BP6p8j9VSR,7GRhBDsirIGkRZBtSMEzNTyDr2JQm4xx,46,108,41,63,28,22,14,1,277,39.57142857142857,2,0.0,59,41,55,28,49,22,8,14,1,183,94,1
7509,97320,l70wRZ2DS0s6LjbT7C4gRoGrF27x9p2H,7GRhBDsirIGkRZBtSMEzNTyDr2JQm4xx,5,4,1,0,1,0,2,0,8,1.1428571428571428,2,0.0,0,1,0,1,4,0,0,2,0,2,6,1
7510,97324,f90qLjbKhR4QYxfjw2iRpmn1h5TurGYb,7GRhBDsirIGkRZBtSMEzNTyDr2JQm4xx,1,0,0,0,0,0,1,0,1,0.14285714285714285,1,0.0,0,0,0,0,0,0,0,1,0,0,1,1
7511,97328,drUu3tyovHqnF7EAaPHayHDYbWMe2Od6,7GRhBDsirIGkRZBtSMEzNTyDr2JQm4xx,1,0,0,0,0,0,1,0,1,0.14285714285714285,1,0.0,0,0,0,0,0,0,0,1,0,0,1,1
7512,97345,PUW0i4IuafllkJEtV0GCqmTDeLHkDmH3,7GRhBDsirIGkRZBtSMEzNTyDr2JQm4xx,41,49,15,73,2,2,6,0,147,21.0,3,0.0,23,15,68,2,26,2,5,6,0,108,39,0
7513,97357,VnkZQ14wQqfipOllRb5zJLKqrvJ7kfcr,7GRhBDsirIGkRZBtSMEzNTyDr2JQm4xx,25,70,24,24,11,2,8,0,139,19.857142857142858,2,0.0,37,24,22,11,33,2,2,8,0,94,45,1
7514,97373,PkSfLYbj8bmlsWpi3b15gaXmhBJLMldT,7GRhBDsirIGkRZBtSMEzNTyDr2JQm4xx,4,0,0,0,0,0,5,0,5,0.7142857142857143,1,0.0,0,0,0,0,0,0,0,5,0,0,5,1
7515,97388,X4FMUX7NyjmKPKTTYvtQYUeaVHGTuyBO,7GRhBDsirIGkRZBtSMEzNTyDr2JQm4xx,1,0,0,0,0,0,1,0,1,0.14285714285714285,1,0.0,0,0,0,0,0,0,0,1,0,0,1,1
7516,97428,92TVODkqWtTMaGGihgBsUR7wsg2cHNWw,A3fsA9Zfv1X2fVEQhTw51lKENdNrEqT3,1,0,0,0,0,0,1,0,1,0.14285714285714285,1,0.0,0,0,0,0,0,0,0,1,0,0,1,1
7517,97462,nCZrnJjbpsSoXVwiEhCJqTYAOI3F94p9,7GRhBDsirIGkRZBtSMEzNTyDr2JQm4xx,1,0,0,0,0,0,1,0,1,0.14285714285714285,1,0.0,0,0,0,0,0,0,0,1,0,0,1,1
7518,97464,rX6twqRSTJA5YELRg8HEcckmy1BY4CL4,7GRhBDsirIGkRZBtSMEzNTyDr2JQm4xx,2,0,0,0,0,0,4,0,4,0.5714285714285714,1,0.0,0,0,0,0,0,0,0,4,0,0,4,1
7519,97489,gSg4PIaWl0hBhOgVlpN9o8YrQn4pTOeq,A3fsA9Zfv1X2fVEQhTw51lKENdNrEqT3,36,27,23,42,16,4,8,0,120,17.142857142857142,1,0.0,2,23,36,16,25,4,6,8,0,77,43,1
7520,97503,kuZwBvEdgeUtKZ495C2FptBbxEtLtmVH,A3fsA9Zfv1X2fVEQhTw51lKENdNrEqT3,71,77,39,138,21,0,14,0,289,41.285714285714285,9,0.0,4,39,123,21,73,0,15,14,0,187,102,0
7521,97505,irC65kbKvoZeQoBjNpGJgeuitn3hVGmi,7GRhBDsirIGkRZBtSMEzNTyDr2JQm4xx,16,13,8,0,6,0,1,0,28,4.0,1,0.0,4,8,0,6,9,0,0,1,0,18,10,1
7522,97552,EO6xtvTLkHLCut4ifOiDl6xUZBrLObA6,7GRhBDsirIGkRZBtSMEzNTyDr2JQm4xx,1,0,0,0,0,0,1,0,1,0.14285714285714285,1,0.0,0,0,0,0,0,0,0,1,0,0,1,1
7523,97591,2B1Sa19tBbYgocD2xlB5fX7K09dmclmZ,7GRhBDsirIGkRZBtSMEzNTyDr2JQm4xx,5,5,1,0,1,0,1,0,8,1.1428571428571428,1,0.0,0,1,0,1,5,0,0,1,0,2,6,1
7524,97613,kz8Qaij4c30iDpbw4iAszcAM45hxcKwU,7GRhBDsirIGkRZBtSMEzNTyDr2JQm4xx,6,2,1,0,1,0,4,0,8,1.1428571428571428,2,0.0,0,1,0,1,2,0,0,4,0,2,6,1
7525,97636,xjgxPvzfyFRaUpAnYKBxqwH6viCz5kQQ,7GRhBDsirIGkRZBtSMEzNTyDr2JQm4xx,11,8,0,0,0,2,3,0,13,1.8571428571428572,1,0.0,0,0,0,0,8,2,0,3,0,0,13,1
7526,97740,pC1UDzWN2ohmqWVct0AFjGKW6gzUzWEQ,7GRhBDsirIGkRZBtSMEzNTyDr2JQm4xx,1,0,0,0,0,0,1,0,1,0.14285714285714285,1,0.0,0,0,0,0,0,0,0,1,0,0,1,1
7527,97741,WIkPVA3ZQexYqPa7aSal3hPiR2XYOXKW,7GRhBDsirIGkRZBtSMEzNTyDr2JQm4xx,7,5,3,4,1,4,2,0,19,2.7142857142857144,1,0.0,1,3,3,1,4,4,1,2,0,8,11,1
7528,97788,rUoEyfIkacNKFckMvyv3DLlxAp35p4TH,7GRhBDsirIGkRZBtSMEzNTyDr2JQm4xx,1,0,0,0,0,0,1,0,1,0.14285714285714285,1,0.0,0,0,0,0,0,0,0,1,0,0,1,1
7529,97823,ATQZndVeRd2FYpO1RdHKpCdTF73Knsgq,7GRhBDsirIGkRZBtSMEzNTyDr2JQm4xx,25,28,8,22,9,0,1,0,68,9.714285714285714,1,0.0,19,8,20,9,9,0,2,1,0,56,12,1
7530,97850,xRxxfDF9JUhs0UX7r4WnpuABa2UDKRlw,7GRhBDsirIGkRZBtSMEzNTyDr2JQm4xx,5,3,1,0,1,0,2,0,7,1.0,1,0.0,0,1,0,1,3,0,0,2,0,2,5,1
7531,97852,ZzaZO5citAcoeYBQ4xnco2bMgq0deP0c,7GRhBDsirIGkRZBtSMEzNTyDr2JQm4xx,5,2,1,0,1,0,2,0,6,0.8571428571428571,1,0.0,0,1,0,1,2,0,0,2,0,2,4,1
7532,97886,OCAzb1VfLGBRFoguhxZLxVaO4EgntnGi,7GRhBDsirIGkRZBtSMEzNTyDr2JQm4xx,11,5,4,0,3,2,9,1,24,3.4285714285714284,1,0.0,0,4,0,3,5,2,0,9,1,7,17,1
7533,97920,vWPEyRranfmzkX1ptXTrcH52A4pj7s7J,7GRhBDsirIGkRZBtSMEzNTyDr2JQm4xx,8,6,3,0,1,0,7,0,17,2.4285714285714284,1,0.0,0,3,0,1,6,0,0,7,0,4,13,1
7534,98950,ltaPWMahEaqTdpjQAeiBFxa5xewAQJDv,SpATywNh6bZuzm8s1ceuBUnMUAeoAHHw,1,0,0,0,0,0,1,0,1,0.14285714285714285,1,0.0,0,0,0,0,0,0,0,1,0,0,1,1
7535,98954,wBGtqMIqfQE0VLJPhcCJAUkBOhFNa6qW,G8EPVSXsOYB5YQWZGiz1aVq5Pgr2GrQu,7,4,0,0,0,0,10,1,15,2.142857142857143,3,0.0,0,0,0,0,4,0,0,10,1,0,15,1
7536,98963,y2GG0eXD492QyyIoYTZNCQnQCo2nl9OI,SpATywNh6bZuzm8s1ceuBUnMUAeoAHHw,4,6,0,0,0,1,2,0,9,1.2857142857142858,1,0.0,0,0,0,0,6,1,0,2,0,0,9,1
7537,98973,uxdJIidy36Grvd6xNfpUFUhDe4OC7W0I,SpATywNh6bZuzm8s1ceuBUnMUAeoAHHw,2,0,0,0,0,0,2,0,2,0.2857142857142857,1,0.0,0,0,0,0,0,0,0,2,0,0,2,1
7538,98979,fIRimGrxWNqdzbEvkhoxiWFjGRhUXcWW,bWdj2GDclj5ofokWjzoa5jAwMkxCykd6,9,12,9,0,7,0,3,0,31,4.428571428571429,3,0.0,0,9,0,7,12,0,0,3,0,16,15,1
7539,98990,m30r8XAusN1tKwuw4RNeOZUufFJ19O18,G8EPVSXsOYB5YQWZGiz1aVq5Pgr2GrQu,1,0,0,0,0,0,1,0,1,0.14285714285714285,1,0.0,0,0,0,0,0,0,0,1,0,0,1,1
7540,99018,ifcc4uHfz9c03WKs2R4honhWtRoNdK5d,SpATywNh6bZuzm8s1ceuBUnMUAeoAHHw,4,0,0,0,0,0,4,0,4,0.5714285714285714,1,0.0,0,0,0,0,0,0,0,4,0,0,4,1
7541,99029,qg6GOCuPcDwehPMMAEed7GZuAdyiaV9B,bWdj2GDclj5ofokWjzoa5jAwMkxCykd6,21,62,2,92,9,3,21,5,194,27.714285714285715,6,0.0,29,2,88,9,33,3,4,21,5,128,66,0
7542,99046,O7BkYKGPbSCKVITR1KG0UTtUy6cDdabs,SpATywNh6bZuzm8s1ceuBUnMUAeoAHHw,13,8,5,9,3,0,4,0,29,4.142857142857143,1,0.0,3,5,9,3,5,0,0,4,0,20,9,1
7543,99054,zzAZgy76SGFU6cR6cdB2SgVDsOtIFGEc,SpATywNh6bZuzm8s1ceuBUnMUAeoAHHw,14,28,15,16,3,10,2,0,74,10.571428571428571,1,0.0,7,15,14,3,21,10,2,2,0,39,35,1
7544,99058,84jM92o4oluSWHz68fjJdNU1O5aejzX8,G8EPVSXsOYB5YQWZGiz1aVq5Pgr2GrQu,39,58,9,46,6,2,18,1,140,20.0,7,0.0,6,9,43,6,52,2,3,18,1,64,76,0
7545,99066,T3sGbyIt0UjiteEMsVXGzcCDHseJZwlW,bWdj2GDclj5ofokWjzoa5jAwMkxCykd6,3,0,0,0,0,0,5,0,5,0.7142857142857143,1,0.0,0,0,0,0,0,0,0,5,0,0,5,1
7546,99069,88XDkNH6bI4ALBv7wIako8gqEashqdgA,bWdj2GDclj5ofokWjzoa5jAwMkxCykd6,4,2,0,0,0,0,2,0,4,0.5714285714285714,1,0.0,0,0,0,0,2,0,0,2,0,0,4,1
7547,99070,9e5dcfJQbPUU8sTcmzE9DWoDPOA9Nhu3,RXDvfPUBYFlVdlueBFbLW0mhhAyGEqpt,10,17,1,0,1,0,3,0,22,3.142857142857143,2,0.0,0,1,0,1,17,0,0,3,0,2,20,0
7548,99081,ZC2nAMORm6ACPbodv0ZDapZ3ammrIH2s,G8EPVSXsOYB5YQWZGiz1aVq5Pgr2GrQu,6,1,1,0,1,0,3,0,6,0.8571428571428571,1,0.0,0,1,0,1,1,0,0,3,0,2,4,1
7549,99082,4DxKDIVHzjxY43c2DifDetzvvaumQ2x6,RXDvfPUBYFlVdlueBFbLW0mhhAyGEqpt,8,7,1,0,1,0,1,0,10,1.4285714285714286,1,0.0,0,1,0,1,7,0,0,1,0,2,8,0
7550,99098,obIiPpvlsnw7kahKveiA1IdOjIdBUlWR,bWdj2GDclj5ofokWjzoa5jAwMkxCykd6,4,3,1,0,0,0,3,0,7,1.0,1,0.0,0,1,0,0,3,0,0,3,0,1,6,1
7551,99100,ZMTgNYkbfDsBe4X8ZM8wJYJMTUYSz0bl,SpATywNh6bZuzm8s1ceuBUnMUAeoAHHw,22,35,0,19,0,37,9,4,104,14.857142857142858,3,0.0,11,0,18,0,24,37,1,9,4,29,75,1
7552,99107,r3OdfccxoUjSXp0sWnFk9IAbamqaQLkg,SpATywNh6bZuzm8s1ceuBUnMUAeoAHHw,6,14,0,0,0,0,4,0,18,2.5714285714285716,3,0.0,0,0,0,0,14,0,0,4,0,0,18,1
7553,99118,8P2tXYi4EZDZkbdP0MJKzxjbxyxdg79S,bWdj2GDclj5ofokWjzoa5jAwMkxCykd6,4,2,0,0,0,0,4,0,6,0.8571428571428571,2,0.0,0,0,0,0,2,0,0,4,0,0,6,1
7554,99132,euFeRK4WVq3xP7j8z58Hdv4WK0cZyZNI,RXDvfPUBYFlVdlueBFbLW0mhhAyGEqpt,46,39,25,64,16,7,6,1,158,22.571428571428573,1,0.0,9,25,60,16,30,7,4,6,1,110,48,1
7555,99139,Q8CD0UEUMHAcRhd0KntpUKYo8YWk4fXe,SpATywNh6bZuzm8s1ceuBUnMUAeoAHHw,6,5,0,0,0,0,1,0,6,0.8571428571428571,1,0.0,0,0,0,0,5,0,0,1,0,0,6,1
7556,99174,u8ZjG1mGoKDfAR0qANs0LauHsnuYvByf,SpATywNh6bZuzm8s1ceuBUnMUAeoAHHw,2,0,0,0,0,0,2,0,2,0.2857142857142857,1,0.0,0,0,0,0,0,0,0,2,0,0,2,1
7557,99181,3gKLDpGjwKizSsdfJ1bxm4OzkmE9SSv0,G8EPVSXsOYB5YQWZGiz1aVq5Pgr2GrQu,10,5,3,0,3,0,5,2,18,2.5714285714285716,1,0.0,1,3,0,3,4,0,0,5,2,7,11,1
7558,99209,cKCzrCCCXe9nkBgWepq9AEXje7SITRTz,RXDvfPUBYFlVdlueBFbLW0mhhAyGEqpt,1,0,0,0,0,0,2,0,2,0.2857142857142857,2,0.0,0,0,0,0,0,0,0,2,0,0,2,1
7559,99238,Sd9iWVuleZqBvt54uADj49zmx7nnkEGd,SpATywNh6bZuzm8s1ceuBUnMUAeoAHHw,7,4,2,0,1,1,7,0,15,2.142857142857143,2,0.0,0,2,0,1,4,1,0,7,0,3,12,1
7560,99239,T0WYTVwYJgFl0x8drZ3acqWyc5rt9vgS,bWdj2GDclj5ofokWjzoa5jAwMkxCykd6,8,6,4,0,3,0,8,0,21,3.0,1,0.0,0,4,0,3,6,0,0,8,0,7,14,1
7561,99253,8i7cvJkHkgdZTPaFAtgMAW0lWMM44P2s,bWdj2GDclj5ofokWjzoa5jAwMkxCykd6,11,11,5,26,0,2,3,0,47,6.714285714285714,1,0.0,5,5,24,0,6,2,2,3,0,34,13,0
7562,99270,CV7h2ez66N3XbcrhHK1a0MSuvaKeLrbg,SpATywNh6bZuzm8s1ceuBUnMUAeoAHHw,4,2,1,0,1,0,1,0,5,0.7142857142857143,1,0.0,0,1,0,1,2,0,0,1,0,2,3,1
7563,99271,Pe5w2Jkb1gsjqOIYHp7FZfmU0KM6bSQ8,SpATywNh6bZuzm8s1ceuBUnMUAeoAHHw,14,19,2,34,0,39,7,0,101,14.428571428571429,3,0.0,11,2,29,0,8,39,5,7,0,42,59,1
7564,99274,F6DWPZmYOtVM9PypQunsAj9fDIO5oqCA,SpATywNh6bZuzm8s1ceuBUnMUAeoAHHw,7,3,1,0,2,0,2,0,8,1.1428571428571428,1,0.0,0,1,0,2,3,0,0,2,0,3,5,1
7565,99278,Zq7w9tMtshfWhXKxO6HgVWaJZugCDD4X,SpATywNh6bZuzm8s1ceuBUnMUAeoAHHw,7,2,0,0,0,0,6,1,9,1.2857142857142858,1,0.0,0,0,0,0,2,0,0,6,1,0,9,1
7566,99281,kLCnsSmz7iq09RICj2W5oj0rePK2t86T,A3fsA9Zfv1X2fVEQhTw51lKENdNrEqT3,7,4,2,0,1,0,5,0,12,1.7142857142857142,2,0.0,0,2,0,1,4,0,0,5,0,3,9,1
7567,99291,kkiueCBXYoPTmt9I3HbEovrMKKFeGu6b,SpATywNh6bZuzm8s1ceuBUnMUAeoAHHw,7,4,3,0,2,0,1,0,10,1.4285714285714286,1,0.0,0,3,0,2,4,0,0,1,0,5,5,1
7568,99301,U77qPrnpSziwcYTMiYVhQDvF7hOqssuP,A3fsA9Zfv1X2fVEQhTw51lKENdNrEqT3,1,0,0,0,0,0,1,0,1,0.14285714285714285,1,0.0,0,0,0,0,0,0,0,1,0,0,1,1
7569,99307,uA8rfZuH0eMveW06zMXRELfenuAEs8xA,RXDvfPUBYFlVdlueBFbLW0mhhAyGEqpt,12,10,8,0,6,0,1,0,25,3.5714285714285716,1,0.0,1,8,0,6,9,0,0,1,0,15,10,1
7570,99308,LtEcnNjG2bVTqyOQr5fGITsmCk6KdvTV,SpATywNh6bZuzm8s1ceuBUnMUAeoAHHw,7,3,2,0,2,0,2,0,9,1.2857142857142858,1,0.0,0,2,0,2,3,0,0,2,0,4,5,1
7571,99311,70RjGajH7pmMAPjzGV9cfLTOEtPaOO7x,bWdj2GDclj5ofokWjzoa5jAwMkxCykd6,4,0,0,0,0,0,5,1,6,0.8571428571428571,1,0.0,0,0,0,0,0,0,0,5,1,0,6,1
7572,99324,zZiKahy0aUh5eIyH06AprK07k6t9S0px,SpATywNh6bZuzm8s1ceuBUnMUAeoAHHw,4,2,0,0,0,0,2,0,4,0.5714285714285714,2,0.0,0,0,0,0,2,0,0,2,0,0,4,1
7573,99328,4lIBX7jVNURqeuVw7y54KWNhg5lYseZ6,bWdj2GDclj5ofokWjzoa5jAwMkxCykd6,10,8,3,0,2,5,7,0,25,3.5714285714285716,3,0.0,0,3,0,2,8,5,0,7,0,5,20,1
7574,99344,JbEjxQ5AsXJ2R3WBH2hwFnQgUiz9YCm1,RXDvfPUBYFlVdlueBFbLW0mhhAyGEqpt,33,79,43,41,21,19,34,5,242,34.57142857142857,5,0.0,16,43,33,21,63,19,8,34,5,113,129,0
7575,99347,d03TqUFy5aM2PIFe72rgYScPoI0zjriD,SpATywNh6bZuzm8s1ceuBUnMUAeoAHHw,1,0,0,0,0,0,1,0,1,0.14285714285714285,1,0.0,0,0,0,0,0,0,0,1,0,0,1,1
7576,99352,KQNAn65G00s1hNhpNIZbIlQjdMIvn0te,SpATywNh6bZuzm8s1ceuBUnMUAeoAHHw,3,2,0,0,0,1,2,0,5,0.7142857142857143,1,0.0,0,0,0,0,2,1,0,2,0,0,5,1
7577,99357,dA2znH7Ys1BZ6Ag1jC6siF2XLsfXuatY,G8EPVSXsOYB5YQWZGiz1aVq5Pgr2GrQu,10,12,4,0,4,0,5,0,25,3.5714285714285716,2,0.0,0,4,0,4,12,0,0,5,0,8,17,1
7578,99361,RUkwQN28KywAbYCPf8B2kmvVB4j6glMk,SpATywNh6bZuzm8s1ceuBUnMUAeoAHHw,4,3,0,0,0,0,2,0,5,0.7142857142857143,1,0.0,0,0,0,0,3,0,0,2,0,0,5,1
7579,99362,pUTxXh2GY765KSOGlKRsr8whr66yS2si,SpATywNh6bZuzm8s1ceuBUnMUAeoAHHw,6,3,1,0,1,0,2,0,7,1.0,1,0.0,0,1,0,1,3,0,0,2,0,2,5,1
7580,99367,7j1Qy60pQmlvQ7Dqk2iUN3aMOz565Svk,SpATywNh6bZuzm8s1ceuBUnMUAeoAHHw,10,7,4,0,3,0,5,0,19,2.7142857142857144,3,0.0,1,4,0,3,6,0,0,5,0,8,11,1
7581,99368,7M1gTpajHgYWFRBJBTE3YPlAjNYb9gfx,SpATywNh6bZuzm8s1ceuBUnMUAeoAHHw,1,0,0,0,0,0,1,0,1,0.14285714285714285,1,0.0,0,0,0,0,0,0,0,1,0,0,1,1
7582,99369,qW9QfVksexOjxQBoakOZ3N1wOwk2Uoq3,SpATywNh6bZuzm8s1ceuBUnMUAeoAHHw,4,2,0,0,0,0,4,0,6,0.8571428571428571,1,0.0,0,0,0,0,2,0,0,4,0,0,6,1
7583,99379,0DbC5JilnobJmMMZ806aDGvS966g1ymK,SpATywNh6bZuzm8s1ceuBUnMUAeoAHHw,5,3,1,0,1,1,2,0,8,1.1428571428571428,1,0.0,0,1,0,1,3,1,0,2,0,2,6,1
7584,99380,0DbC5JilnobJmMMZ806aDGvS966g1ymK,G8EPVSXsOYB5YQWZGiz1aVq5Pgr2GrQu,1,0,0,0,0,0,1,0,1,0.14285714285714285,1,0.0,0,0,0,0,0,0,0,1,0,0,1,1
7585,99395,kKVwpcRVIoBHXwQJxUscCmJVsObHmuic,SpATywNh6bZuzm8s1ceuBUnMUAeoAHHw,11,6,4,0,3,0,5,1,19,2.7142857142857144,1,0.0,0,4,0,3,6,0,0,5,1,7,12,1
7586,99410,RrZI3LBwWWMML70TBgENRap2pJnz1WcI,G8EPVSXsOYB5YQWZGiz1aVq5Pgr2GrQu,7,8,2,0,3,0,3,0,16,2.2857142857142856,1,0.0,4,2,0,3,4,0,0,3,0,9,7,1
7587,99419,CIojvdkZCguBWuN7246vWmUJ6qBNp7JQ,RXDvfPUBYFlVdlueBFbLW0mhhAyGEqpt,44,36,14,68,6,5,7,1,137,19.571428571428573,2,0.0,12,14,66,6,24,5,2,7,1,98,39,1
7588,99429,Og1p6VqqK505SKTAg7oggM1PpCX9htgK,bWdj2GDclj5ofokWjzoa5jAwMkxCykd6,2,0,0,0,0,0,2,0,2,0.2857142857142857,1,0.0,0,0,0,0,0,0,0,2,0,0,2,1
7589,99436,rPmua3xrnLtgdU4TZGq8z4hoSz54twnz,RXDvfPUBYFlVdlueBFbLW0mhhAyGEqpt,2,0,0,0,0,0,2,0,2,0.2857142857142857,1,0.0,0,0,0,0,0,0,0,2,0,0,2,1
7590,99458,XKiESHLmmxxFLSNhNTicMKXZo07ga8rR,SpATywNh6bZuzm8s1ceuBUnMUAeoAHHw,17,21,6,27,3,5,9,1,72,10.285714285714286,1,0.0,12,6,22,3,9,5,5,9,1,43,29,1
7591,99460,x0kuyWECJARUGYUkf8OBmp3NS07aeieW,SpATywNh6bZuzm8s1ceuBUnMUAeoAHHw,22,32,7,30,5,19,8,1,102,14.571428571428571,2,0.0,13,7,25,5,19,19,5,8,1,50,52,1
7592,99465,dDLv4oouOmVB45Y4hnRyV7IUqT7tMKiq,RXDvfPUBYFlVdlueBFbLW0mhhAyGEqpt,5,4,2,0,1,2,2,0,11,1.5714285714285714,1,0.0,0,2,0,1,4,2,0,2,0,3,8,1
7593,99476,H1SXscwZbeBIGdJtjznbLlFWKEefKgS4,bWdj2GDclj5ofokWjzoa5jAwMkxCykd6,1,0,0,0,0,0,1,0,1,0.14285714285714285,1,0.0,0,0,0,0,0,0,0,1,0,0,1,1
7594,99482,YLgIjYna0b19CObH0aixdNFVjkWguI8z,SpATywNh6bZuzm8s1ceuBUnMUAeoAHHw,6,3,1,0,1,0,2,0,7,1.0,1,0.0,0,1,0,1,3,0,0,2,0,2,5,1
7595,99499,nazeZS8BdRMOGGuVriyb5M21Pn5Qng36,RXDvfPUBYFlVdlueBFbLW0mhhAyGEqpt,2,0,0,0,0,0,5,0,5,0.7142857142857143,3,0.0,0,0,0,0,0,0,0,5,0,0,5,1
7596,99504,F6k3M4cXPmDcGMYwz4MYjROjPe1tP3Ym,SpATywNh6bZuzm8s1ceuBUnMUAeoAHHw,2,0,0,0,0,0,2,0,2,0.2857142857142857,1,0.0,0,0,0,0,0,0,0,2,0,0,2,1
7597,99519,qsSi1uSJyI5PyAmcKOuOd3i9fMbo7Kcq,SpATywNh6bZuzm8s1ceuBUnMUAeoAHHw,18,35,4,4,3,10,15,6,77,11.0,2,0.0,0,4,3,3,35,10,1,15,6,10,67,1
7598,99523,tItJmM8DSrsR2C4SUW6G90kGTH9CET7i,A3fsA9Zfv1X2fVEQhTw51lKENdNrEqT3,1,0,0,0,0,0,1,0,1,0.14285714285714285,1,0.0,0,0,0,0,0,0,0,1,0,0,1,1
7599,99528,9HLdaHmr6CL0Qkr0yUtrnxT1uvy3iohQ,G8EPVSXsOYB5YQWZGiz1aVq5Pgr2GrQu,4,4,2,0,0,2,3,0,11,1.5714285714285714,1,0.0,0,2,0,0,4,2,0,3,0,2,9,1
7600,99538,aApTNsNL5V8p77KfIZfCDf8PLQlY5mEZ,RXDvfPUBYFlVdlueBFbLW0mhhAyGEqpt,10,5,4,0,3,0,2,0,14,2.0,1,0.0,0,4,0,3,5,0,0,2,0,7,7,1
7601,99544,VMv3kIqXbjzzweiSaOh7btZJMGqiha14,SpATywNh6bZuzm8s1ceuBUnMUAeoAHHw,8,5,3,0,2,0,4,0,14,2.0,2,0.0,0,3,0,2,5,0,0,4,0,5,9,1
7602,99548,hbUthRcRktel8CTk5FJE2GFw0tsGaPJX,SpATywNh6bZuzm8s1ceuBUnMUAeoAHHw,8,10,1,0,0,0,7,1,19,2.7142857142857144,3,0.0,2,1,0,0,8,0,0,7,1,3,16,1
7603,99553,B48liWLvGTFhxmScNtRccVTYMrDSRz6T,SpATywNh6bZuzm8s1ceuBUnMUAeoAHHw,11,30,0,17,0,9,6,0,62,8.857142857142858,1,0.0,15,0,16,0,15,9,1,6,0,31,31,1
7604,99559,UvQp4bR98Xn1uwzsk2XfrzaGsOC8PbwE,SpATywNh6bZuzm8s1ceuBUnMUAeoAHHw,13,10,4,16,3,0,2,0,35,5.0,1,0.0,4,4,14,3,6,0,2,2,0,25,10,1
7605,99570,K9rvD8Iu0wq956P4CDD0WYKLX5TfMvJ0,G8EPVSXsOYB5YQWZGiz1aVq5Pgr2GrQu,1,0,0,0,0,0,1,0,1,0.14285714285714285,1,0.0,0,0,0,0,0,0,0,1,0,0,1,1
7606,99582,pJZjfxkmSUcLjysKXGMvcQJcdn3Lfmps,G8EPVSXsOYB5YQWZGiz1aVq5Pgr2GrQu,9,21,1,4,4,0,4,1,35,5.0,1,0.0,15,1,2,4,6,0,2,4,1,22,13,1
7607,99585,MsXQVdqX93JlyFfWTzQyZnJZn8bWw73p,G8EPVSXsOYB5YQWZGiz1aVq5Pgr2GrQu,1,0,0,0,0,0,1,0,1,0.14285714285714285,1,0.0,0,0,0,0,0,0,0,1,0,0,1,1
7608,99589,X2tBPTLsKr1PUmH63wCYNuKDkAG71YDY,SpATywNh6bZuzm8s1ceuBUnMUAeoAHHw,2,0,0,0,0,0,2,0,2,0.2857142857142857,1,0.0,0,0,0,0,0,0,0,2,0,0,2,1
7609,99591,X2tBPTLsKr1PUmH63wCYNuKDkAG71YDY,bWdj2GDclj5ofokWjzoa5jAwMkxCykd6,2,0,0,0,0,0,2,0,2,0.2857142857142857,1,0.0,0,0,0,0,0,0,0,2,0,0,2,1
7610,99624,eeYgUeHIQERDYwF1mxwVIZYsVaVSgwlV,RXDvfPUBYFlVdlueBFbLW0mhhAyGEqpt,1,0,0,0,0,0,1,0,1,0.14285714285714285,1,0.0,0,0,0,0,0,0,0,1,0,0,1,1
7611,99632,XcU2XTxeLZ8F89uBFmVFyW4cnWhjcEiA,SpATywNh6bZuzm8s1ceuBUnMUAeoAHHw,13,17,7,9,5,5,4,0,47,6.714285714285714,2,0.0,5,7,9,5,12,5,0,4,0,26,21,1
7612,99634,iKW0Nip3dgY8YRgutfX9HfgsuYc5FITi,SpATywNh6bZuzm8s1ceuBUnMUAeoAHHw,16,16,9,15,6,3,6,0,55,7.857142857142857,1,0.0,4,9,14,6,12,3,1,6,0,33,22,1
7613,99638,KfP7DqXlruQE3Tc1dgUq6GzZBbeDyO72,SpATywNh6bZuzm8s1ceuBUnMUAeoAHHw,6,7,2,0,1,1,2,0,13,1.8571428571428572,1,0.0,0,2,0,1,7,1,0,2,0,3,10,1
7614,99639,HdhmGphCRXsQFbeFhgLmEJAXmcjxk1qH,G8EPVSXsOYB5YQWZGiz1aVq5Pgr2GrQu,1,0,0,0,0,0,2,0,2,0.2857142857142857,2,0.0,0,0,0,0,0,0,0,2,0,0,2,1
7615,99653,2ENDZhPlfPQ7xqwHjrfLuuWg5Duw7ZBj,SpATywNh6bZuzm8s1ceuBUnMUAeoAHHw,27,49,23,16,8,1,16,1,114,16.285714285714285,6,0.0,6,23,16,8,43,1,0,16,1,53,61,0
7616,99654,uA8rfZuH0eMveW06zMXRELfenuAEs8xA,A3fsA9Zfv1X2fVEQhTw51lKENdNrEqT3,1,0,0,0,0,0,1,0,1,0.14285714285714285,1,0.0,0,0,0,0,0,0,0,1,0,0,1,1
7617,99667,yUFGaXV6e729cAx9t4iOfoMO0XzOm9Tn,SpATywNh6bZuzm8s1ceuBUnMUAeoAHHw,5,3,2,0,1,0,1,0,7,1.0,1,0.0,0,2,0,1,3,0,0,1,0,3,4,1
7618,99671,KbnH0sTIlztrZBuSXZduD8Hjf6pJFDbi,G8EPVSXsOYB5YQWZGiz1aVq5Pgr2GrQu,6,2,1,0,1,0,3,0,7,1.0,1,0.0,0,1,0,1,2,0,0,3,0,2,5,1
7619,99693,1poMA1x0qhCnYBPVsxm5CInRDHfF8Q0k,SpATywNh6bZuzm8s1ceuBUnMUAeoAHHw,10,12,8,0,4,2,15,3,44,6.285714285714286,1,0.0,0,8,0,4,12,2,0,15,3,12,32,1
7620,99715,xg8dkQPzve0MzcpgxvEsbKyY4VwKrxAC,G8EPVSXsOYB5YQWZGiz1aVq5Pgr2GrQu,1,0,0,0,0,0,1,0,1,0.14285714285714285,1,0.0,0,0,0,0,0,0,0,1,0,0,1,1
7621,99717,0b1xMc7vBqRRfJj4HArRLbAJZWV8VISr,RXDvfPUBYFlVdlueBFbLW0mhhAyGEqpt,1,0,0,0,0,0,1,0,1,0.14285714285714285,1,0.0,0,0,0,0,0,0,0,1,0,0,1,1
7622,99728,507IdnNFIDoiPRr88JDQa6OplkPcxI18,G8EPVSXsOYB5YQWZGiz1aVq5Pgr2GrQu,1,0,0,0,0,0,1,0,1,0.14285714285714285,1,0.0,0,0,0,0,0,0,0,1,0,0,1,1
7623,99747,SH3THvT9ATqMny80GD63EuK5GGnf8XMU,bWdj2GDclj5ofokWjzoa5jAwMkxCykd6,4,3,0,0,0,3,6,0,12,1.7142857142857142,3,0.0,0,0,0,0,3,3,0,6,0,0,12,1
7624,99752,v8s2hAX8tQgFD6i9MrUt2cuWPYPq3DuN,G8EPVSXsOYB5YQWZGiz1aVq5Pgr2GrQu,5,8,4,0,1,0,4,0,17,2.4285714285714284,3,0.0,0,4,0,1,8,0,0,4,0,5,12,0
7625,99758,q5R81Yw8uRP3FrwNvV49L9qc5ag0j7J9,A3fsA9Zfv1X2fVEQhTw51lKENdNrEqT3,1,0,0,0,0,0,1,0,1,0.14285714285714285,1,0.0,0,0,0,0,0,0,0,1,0,0,1,1
7626,99759,LgCMqz3FdP5FVzPuiAaae1dvV0Dou3Op,SpATywNh6bZuzm8s1ceuBUnMUAeoAHHw,7,3,2,0,2,0,2,0,9,1.2857142857142858,1,0.0,0,2,0,2,3,0,0,2,0,4,5,1
7627,99785,oNDKvCCMv3YHycTSYSxE4vCb7yy2VCwV,SpATywNh6bZuzm8s1ceuBUnMUAeoAHHw,10,3,2,0,2,7,5,1,20,2.857142857142857,1,0.0,0,2,0,2,3,7,0,5,1,4,16,1
7628,99798,t84V1IZRpqwPOLkIILsxQF8RqF1exsFD,SpATywNh6bZuzm8s1ceuBUnMUAeoAHHw,4,2,1,0,0,0,2,0,5,0.7142857142857143,1,0.0,0,1,0,0,2,0,0,2,0,1,4,1
7629,99810,E5f5bNHHVwXdE8xNDAy656AeEbGGB2sd,SpATywNh6bZuzm8s1ceuBUnMUAeoAHHw,11,43,3,27,2,0,3,0,78,11.142857142857142,2,0.0,30,3,23,2,13,0,4,3,0,58,20,1
7630,99812,ZDVmuYiPoGm0gu1bR2BaE1soF6dU5v1W,bWdj2GDclj5ofokWjzoa5jAwMkxCykd6,6,12,6,14,0,2,6,0,40,5.714285714285714,1,0.0,4,6,14,0,8,2,0,6,0,24,16,1
7631,99813,7aA6BrVZipLHOrozlrYBMEmfMq4MXahq,A3fsA9Zfv1X2fVEQhTw51lKENdNrEqT3,1,0,0,0,0,0,1,0,1,0.14285714285714285,1,0.0,0,0,0,0,0,0,0,1,0,0,1,1
7632,99817,TJwArXyryXs3RiLiYIGaN8bFGgjvPLws,SpATywNh6bZuzm8s1ceuBUnMUAeoAHHw,4,2,1,0,1,0,2,0,6,0.8571428571428571,1,0.0,0,1,0,1,2,0,0,2,0,2,4,1
7633,99819,GjfzOWel7UtLS6b5EULEaoKkW3os5vHa,SpATywNh6bZuzm8s1ceuBUnMUAeoAHHw,5,2,1,0,1,0,3,0,7,1.0,1,0.0,0,1,0,1,2,0,0,3,0,2,5,1
7634,99822,mb36VuCvp1Z6gW8mqkNElCgDYgcBIF3z,SpATywNh6bZuzm8s1ceuBUnMUAeoAHHw,7,11,8,0,6,0,3,0,28,4.0,1,0.0,0,8,0,6,11,0,0,3,0,14,14,1
7635,99831,Jzdxwa4kNVDonbh32Q542LfZRfsA4OPw,SpATywNh6bZuzm8s1ceuBUnMUAeoAHHw,8,3,2,0,2,1,4,0,12,1.7142857142857142,1,0.0,0,2,0,2,3,1,0,4,0,4,8,1
7636,99839,TdfXOtlNb7Av3MtzwkldFOrTHIZeitdz,SpATywNh6bZuzm8s1ceuBUnMUAeoAHHw,13,33,19,3,9,3,13,0,80,11.428571428571429,4,0.0,1,19,3,9,32,3,0,13,0,32,48,0
7637,99840,eVv8K2gdE5SVTmPw9MARDIRZSaYqMHSQ,SpATywNh6bZuzm8s1ceuBUnMUAeoAHHw,11,9,0,10,0,0,3,2,24,3.4285714285714284,1,0.0,2,0,9,0,7,0,1,3,2,11,13,1
7638,99843,oNDKvCCMv3YHycTSYSxE4vCb7yy2VCwV,RXDvfPUBYFlVdlueBFbLW0mhhAyGEqpt,9,5,4,0,4,0,4,0,17,2.4285714285714284,1,0.0,0,4,0,4,5,0,0,4,0,8,9,1
7639,99866,7aA6BrVZipLHOrozlrYBMEmfMq4MXahq,bWdj2GDclj5ofokWjzoa5jAwMkxCykd6,1,0,0,0,0,0,1,0,1,0.14285714285714285,1,0.0,0,0,0,0,0,0,0,1,0,0,1,1
7640,99879,6ACUaz471Pn1fnrZDeY9K0EfEHUBtjpk,SpATywNh6bZuzm8s1ceuBUnMUAeoAHHw,17,11,6,17,3,24,13,3,77,11.0,1,0.0,2,6,15,3,9,24,2,13,3,26,51,1
7641,99883,CFvk4wjTMYl1iJidR1XmhJBW4azBqofZ,SpATywNh6bZuzm8s1ceuBUnMUAeoAHHw,6,3,1,0,1,0,4,0,9,1.2857142857142858,1,0.0,0,1,0,1,3,0,0,4,0,2,7,1
7642,99891,cNOMlpfCFQuhn4NfuqDzr2Vocotv36oU,A3fsA9Zfv1X2fVEQhTw51lKENdNrEqT3,1,0,0,0,0,0,1,0,1,0.14285714285714285,1,0.0,0,0,0,0,0,0,0,1,0,0,1,1
7643,99892,DDOsm4qYmwEA6E1tTBXPjk0uhAES8TZ9,SpATywNh6bZuzm8s1ceuBUnMUAeoAHHw,9,7,3,3,2,0,2,0,17,2.4285714285714284,1,0.0,3,3,3,2,4,0,0,2,0,11,6,1
7644,99895,sRTon1VBBuP0uvdQE1lWLIce29YVBv8J,SpATywNh6bZuzm8s1ceuBUnMUAeoAHHw,13,19,0,11,0,4,8,0,42,6.0,2,0.0,6,0,10,0,13,4,1,8,0,16,26,1
7645,99900,90Ea96jYOrWvumropceyEFhiPsTvKfzf,bWdj2GDclj5ofokWjzoa5jAwMkxCykd6,8,4,0,0,0,1,4,1,10,1.4285714285714286,1,0.0,0,0,0,0,4,1,0,4,1,0,10,1
7646,99902,Fio0BW8a5yrv46EIdUqSrGYnBJXNuvAc,G8EPVSXsOYB5YQWZGiz1aVq5Pgr2GrQu,1,0,0,0,0,0,1,0,1,0.14285714285714285,1,0.0,0,0,0,0,0,0,0,1,0,0,1,1
7647,99905,GR0IZ8RAROGoO8dlKHQecnjtd4J4CV8E,SpATywNh6bZuzm8s1ceuBUnMUAeoAHHw,7,4,3,0,3,0,2,0,12,1.7142857142857142,1,0.0,0,3,0,3,4,0,0,2,0,6,6,1
7648,99908,Wlz3wRUCGZdxuPjJRKNKqt34F0pjoQUU,SpATywNh6bZuzm8s1ceuBUnMUAeoAHHw,5,3,0,0,0,0,2,0,5,0.7142857142857143,1,0.0,0,0,0,0,3,0,0,2,0,0,5,1
7649,99910,T0V1MC6bsX3mZxJfTJfqpva6BwB6iZOI,SpATywNh6bZuzm8s1ceuBUnMUAeoAHHw,5,3,2,0,2,0,2,0,9,1.2857142857142858,1,0.0,0,2,0,2,3,0,0,2,0,4,5,1
7650,99919,bzlTCtIUcO5BfACSIQwT3PRYSdK0QGTr,bWdj2GDclj5ofokWjzoa5jAwMkxCykd6,5,2,1,0,1,0,3,0,7,1.0,2,0.0,0,1,0,1,2,0,0,3,0,2,5,1
7651,99924,s22y3yJL9OZAJbywe5kehjyeI57l8QWk,SpATywNh6bZuzm8s1ceuBUnMUAeoAHHw,1,0,0,0,0,0,2,0,2,0.2857142857142857,1,0.0,0,0,0,0,0,0,0,2,0,0,2,1
7652,99933,grGzcyT8HhVfjhYhmvwa7hRZvpxVILf7,SpATywNh6bZuzm8s1ceuBUnMUAeoAHHw,12,19,5,15,4,0,1,0,44,6.285714285714286,1,0.0,13,5,14,4,6,0,1,1,0,36,8,1
7653,99936,Oi7Qhc5WNxKsxx530z6SWxDXUzxiC0Iw,G8EPVSXsOYB5YQWZGiz1aVq5Pgr2GrQu,10,15,1,0,2,0,9,0,27,3.857142857142857,2,0.0,8,1,0,2,7,0,0,9,0,11,16,0
7654,99937,cnsyUcQdXkjXAZu2LRhrO31c8mThrNUr,SpATywNh6bZuzm8s1ceuBUnMUAeoAHHw,13,11,5,20,2,0,4,0,42,6.0,2,0.0,2,5,16,2,9,0,4,4,0,25,17,1
7655,99947,IZ16dnDzM5qLtyHLu3aaKf2eiaAGYSGA,SpATywNh6bZuzm8s1ceuBUnMUAeoAHHw,1,0,0,0,0,0,1,0,1,0.14285714285714285,1,0.0,0,0,0,0,0,0,0,1,0,0,1,1
7656,99956,JncF0A6NLmySeUG55ffbMgtwYs8JPP1N,bWdj2GDclj5ofokWjzoa5jAwMkxCykd6,2,0,0,0,0,0,2,0,2,0.2857142857142857,1,0.0,0,0,0,0,0,0,0,2,0,0,2,1
7657,99986,4dUaGH7iXRv1eQLzCgjayv9tRaG807lp,SpATywNh6bZuzm8s1ceuBUnMUAeoAHHw,12,9,6,16,3,0,1,0,35,5.0,1,0.0,2,6,13,3,7,0,3,1,0,24,11,1
7658,99990,BY7rZbvKNAuIQddu3IMUH8CKbKBlCl4t,SpATywNh6bZuzm8s1ceuBUnMUAeoAHHw,16,47,25,17,8,6,15,1,119,17.0,4,0.0,6,25,14,8,41,6,3,15,1,53,66,0
7659,99994,25I3ZHC2CKPuZdwEsDJVb3ivMmenYIrh,SpATywNh6bZuzm8s1ceuBUnMUAeoAHHw,1,0,0,0,0,0,1,0,1,0.14285714285714285,1,0.0,0,0,0,0,0,0,0,1,0,0,1,1
7660,99997,DtHgKVPDhIQdcn9LoDGSbijzl93Gk2jn,SpATywNh6bZuzm8s1ceuBUnMUAeoAHHw,6,3,1,0,1,0,2,0,7,1.0,1,0.0,0,1,0,1,3,0,0,2,0,2,5,1
7661,99999,6sN2V3D1BSB8BILaihUzYoUSAATbUImJ,G8EPVSXsOYB5YQWZGiz1aVq5Pgr2GrQu,2,0,0,0,0,0,2,0,2,0.2857142857142857,1,0.0,0,0,0,0,0,0,0,2,0,0,2,1
7662,100015,kVQgvZQEECWcBpDBfOHSkyukPIRvJ5sY,RXDvfPUBYFlVdlueBFbLW0mhhAyGEqpt,1,0,0,0,0,0,1,0,1,0.14285714285714285,1,0.0,0,0,0,0,0,0,0,1,0,0,1,1
7663,100024,yIWuZECPMnNHsT4nnuxaCnrNgzyFmEU4,SpATywNh6bZuzm8s1ceuBUnMUAeoAHHw,12,9,1,13,0,0,6,0,29,4.142857142857143,2,0.0,2,1,11,0,7,0,2,6,0,14,15,1
7664,100027,lVpMvFJQUkBRc5QzVKlkj16QaA3takHv,G8EPVSXsOYB5YQWZGiz1aVq5Pgr2GrQu,20,10,6,42,3,5,4,0,70,10.0,1,0.0,3,6,34,3,7,5,8,4,0,46,24,0
7665,100028,AMKNyvONM5p8NpA87JkQdxEGdnEv8UBc,SpATywNh6bZuzm8s1ceuBUnMUAeoAHHw,14,16,3,20,1,11,12,4,67,9.571428571428571,3,0.0,2,3,17,1,14,11,3,12,4,23,44,1
7666,100034,UO4K287BxB8BWqN4Vsyelgc9IxlYK4Tg,SpATywNh6bZuzm8s1ceuBUnMUAeoAHHw,13,8,5,12,4,0,2,0,31,4.428571428571429,1,0.0,2,5,12,4,6,0,0,2,0,23,8,1
7667,100036,drecLIVL8lECR1fdFh4q87LPP9hTNU3f,SpATywNh6bZuzm8s1ceuBUnMUAeoAHHw,5,2,1,0,1,0,2,0,6,0.8571428571428571,1,0.0,0,1,0,1,2,0,0,2,0,2,4,1
7668,100061,wSHJOUrC5HDoRV04dRmaj6jhdM6NYaj6,RXDvfPUBYFlVdlueBFbLW0mhhAyGEqpt,17,26,16,0,9,1,12,0,64,9.142857142857142,1,0.0,0,16,0,9,26,1,0,12,0,25,39,1
7669,100063,ZmILkESSKwaUf7dlv2MYezsPM9kEgn0g,bWdj2GDclj5ofokWjzoa5jAwMkxCykd6,1,0,0,0,0,0,1,0,1,0.14285714285714285,1,0.0,0,0,0,0,0,0,0,1,0,0,1,1
7670,100072,GCBiFXC2EhwXYwz6gh8rDQT1ItPzfReO,SpATywNh6bZuzm8s1ceuBUnMUAeoAHHw,1,0,0,0,0,0,1,0,1,0.14285714285714285,1,0.0,0,0,0,0,0,0,0,1,0,0,1,1
7671,100101,7BLSB26pFgDMSTV4x8nY66FLFZIw20Ig,bWdj2GDclj5ofokWjzoa5jAwMkxCykd6,3,0,0,0,0,0,3,0,3,0.42857142857142855,1,0.0,0,0,0,0,0,0,0,3,0,0,3,1
7672,100118,e0PSviaCUv7g6edvYkj3Wxxy57eyFNfw,G8EPVSXsOYB5YQWZGiz1aVq5Pgr2GrQu,8,6,4,0,3,0,3,0,16,2.2857142857142856,1,0.0,0,4,0,3,6,0,0,3,0,7,9,1
7673,100121,zDkFthLb8QiYlJN46xEgukiHh2xvNh17,SpATywNh6bZuzm8s1ceuBUnMUAeoAHHw,12,8,4,4,6,24,5,0,51,7.285714285714286,1,0.0,0,4,4,6,8,24,0,5,0,14,37,1
7674,100126,92FUTIKpJKurgJxPcqboELrIlwQuRnws,SpATywNh6bZuzm8s1ceuBUnMUAeoAHHw,4,2,1,0,1,0,3,0,7,1.0,1,0.0,0,1,0,1,2,0,0,3,0,2,5,1
7675,100128,sQN6Ivaey7nQA0xFHZwWETnwBmEDP3C4,bWdj2GDclj5ofokWjzoa5jAwMkxCykd6,1,0,0,0,0,0,1,0,1,0.14285714285714285,1,0.0,0,0,0,0,0,0,0,1,0,0,1,1
7676,100129,UKq5lhvAp06ZhcbYGirhBoJurTHlyP25,SpATywNh6bZuzm8s1ceuBUnMUAeoAHHw,4,2,1,0,0,0,3,0,6,0.8571428571428571,1,0.0,0,1,0,0,2,0,0,3,0,1,5,0
7677,100132,zhtf7EZUjW6s3Guz5lXD8KDXJ4lw9cuB,SpATywNh6bZuzm8s1ceuBUnMUAeoAHHw,27,30,20,18,11,0,7,0,86,12.285714285714286,3,0.0,7,20,17,11,23,0,1,7,0,55,31,0
7678,100141,OMeQBd65CGlFdF9LPjtleDAWNG4SlWp3,SpATywNh6bZuzm8s1ceuBUnMUAeoAHHw,24,65,18,27,8,24,10,1,153,21.857142857142858,3,0.0,27,18,21,8,38,24,6,10,1,74,79,1
7679,100153,3ZBkeExde7b5snRqlcNlkhznPWJKIR4u,SpATywNh6bZuzm8s1ceuBUnMUAeoAHHw,3,2,0,0,0,0,1,0,3,0.42857142857142855,1,0.0,0,0,0,0,2,0,0,1,0,0,3,1
7680,100197,7VYsu22xA0behvNW5V0HO7suqw3RpS8G,A3fsA9Zfv1X2fVEQhTw51lKENdNrEqT3,1,0,0,0,0,0,1,0,1,0.14285714285714285,1,0.0,0,0,0,0,0,0,0,1,0,0,1,1
7681,100212,2bZFunHMPmr3ZtiaHMdXxkvbsb400BRF,bWdj2GDclj5ofokWjzoa5jAwMkxCykd6,7,2,1,0,1,0,5,1,10,1.4285714285714286,2,0.0,0,1,0,1,2,0,0,5,1,2,8,1
7682,100234,mV6vIHBrgth3lTaajvzuqQeEfK5qY5yY,SpATywNh6bZuzm8s1ceuBUnMUAeoAHHw,14,26,3,19,2,0,4,0,54,7.714285714285714,2,0.0,6,3,16,2,20,0,3,4,0,27,27,1
7683,100242,pOVkDtM2cW4XWonAB3isY5WCbnNkYAIp,G8EPVSXsOYB5YQWZGiz1aVq5Pgr2GrQu,12,38,2,30,5,1,6,1,83,11.857142857142858,1,0.0,21,2,21,5,17,1,9,6,1,49,34,0
7684,100248,YNyEESXbqSWkVhYDWRBMKhf7B8RI9hCb,SpATywNh6bZuzm8s1ceuBUnMUAeoAHHw,9,9,1,0,1,0,9,0,20,2.857142857142857,2,0.0,0,1,0,1,9,0,0,9,0,2,18,1
7685,100250,TciQEzJA4hKxeo0Ve5JLByGDZHpNx3uy,RXDvfPUBYFlVdlueBFbLW0mhhAyGEqpt,1,0,0,0,0,0,1,0,1,0.14285714285714285,1,0.0,0,0,0,0,0,0,0,1,0,0,1,1
7686,100254,qNh1HmZZ5IODkL9bGcGUg3xnGvE9VrLH,A3fsA9Zfv1X2fVEQhTw51lKENdNrEqT3,1,0,0,0,0,0,1,0,1,0.14285714285714285,1,0.0,0,0,0,0,0,0,0,1,0,0,1,1
7687,100255,CyLrnwOuvkEKQhwjogaYhZvzxTeqKBge,bWdj2GDclj5ofokWjzoa5jAwMkxCykd6,1,0,0,0,0,0,1,0,1,0.14285714285714285,1,0.0,0,0,0,0,0,0,0,1,0,0,1,1
7688,100259,c2Q5B1aYF1KkI9v6dRXIUSAa5DOcN20a,SpATywNh6bZuzm8s1ceuBUnMUAeoAHHw,1,0,0,0,0,0,1,0,1,0.14285714285714285,1,0.0,0,0,0,0,0,0,0,1,0,0,1,1
7689,100274,psBmoUfd8F19brtdh1bZTLzNbdOCOBdc,G8EPVSXsOYB5YQWZGiz1aVq5Pgr2GrQu,12,5,4,0,4,1,5,1,20,2.857142857142857,1,0.0,0,4,0,4,5,1,0,5,1,8,12,1
7690,100279,KyiebHDxme4fhoxffRK8u4aC4pCnnodx,RXDvfPUBYFlVdlueBFbLW0mhhAyGEqpt,7,9,1,0,1,0,3,0,14,2.0,2,0.0,0,1,0,1,9,0,0,3,0,2,12,1
7691,100283,RqdDZ59hZyptwdavZ7BebY7MyinitbUb,RXDvfPUBYFlVdlueBFbLW0mhhAyGEqpt,18,17,2,28,2,6,5,1,61,8.714285714285714,2,0.0,2,2,26,2,15,6,2,5,1,32,29,1
7692,100306,mSmEv1ySOfyHPKXATZwYWxeWIR1bOlzf,A3fsA9Zfv1X2fVEQhTw51lKENdNrEqT3,1,0,0,0,0,0,1,0,1,0.14285714285714285,1,0.0,0,0,0,0,0,0,0,1,0,0,1,1
7693,100316,zOam8QEm9OnWecRZGQt83gQL3mhsAeeZ,bWdj2GDclj5ofokWjzoa5jAwMkxCykd6,3,0,0,0,0,0,3,0,3,0.42857142857142855,1,0.0,0,0,0,0,0,0,0,3,0,0,3,1
7694,100317,jHFndzgHWJwhCt25LmxPZ3zqNFqlRdEb,A3fsA9Zfv1X2fVEQhTw51lKENdNrEqT3,7,3,2,0,2,0,2,0,9,1.2857142857142858,2,0.0,0,2,0,2,3,0,0,2,0,4,5,1
7695,100327,wrKMasi8LNygKef8piFZGi3m3QxjccZE,bWdj2GDclj5ofokWjzoa5jAwMkxCykd6,4,2,1,0,1,0,1,0,5,0.7142857142857143,1,0.0,0,1,0,1,2,0,0,1,0,2,3,1
7696,100328,KgI1c7voNVzVIvjs4ZhktR8A7fWkMDoW,SpATywNh6bZuzm8s1ceuBUnMUAeoAHHw,1,0,0,0,0,0,1,0,1,0.14285714285714285,1,0.0,0,0,0,0,0,0,0,1,0,0,1,1
7697,100330,XIlz5QvnlEzidDqYGld3VSh8CaOyBXAa,bWdj2GDclj5ofokWjzoa5jAwMkxCykd6,1,0,0,0,0,0,1,0,1,0.14285714285714285,1,0.0,0,0,0,0,0,0,0,1,0,0,1,1
7698,100338,ZtkS0KlWCGCzlEANBJ5GgCPzAAljBHVt,bWdj2GDclj5ofokWjzoa5jAwMkxCykd6,10,8,4,10,4,0,4,0,30,4.285714285714286,2,0.0,2,4,10,4,6,0,0,4,0,20,10,1
7699,100373,7rPiBqfbPQeCxCiqXyPinFDIqFEPCizE,SpATywNh6bZuzm8s1ceuBUnMUAeoAHHw,4,2,1,0,0,0,2,0,5,0.7142857142857143,1,0.0,0,1,0,0,2,0,0,2,0,1,4,1
7700,100377,MlHPKmdi90dDdvX24jYoFlYEp8xS4RGn,SpATywNh6bZuzm8s1ceuBUnMUAeoAHHw,8,23,8,0,3,3,6,0,43,6.142857142857143,3,0.0,1,8,0,3,22,3,0,6,0,12,31,0
7701,100383,CgW6eb6Uo35foWi9RCL2029DF7zH5e88,SpATywNh6bZuzm8s1ceuBUnMUAeoAHHw,7,2,1,0,1,1,7,1,13,1.8571428571428572,2,0.0,0,1,0,1,2,1,0,7,1,2,11,1
7702,100384,FMxvsapRPXXXNxGG3GDsHR7zl4E2ofKu,bWdj2GDclj5ofokWjzoa5jAwMkxCykd6,2,0,0,0,0,0,2,0,2,0.2857142857142857,1,0.0,0,0,0,0,0,0,0,2,0,0,2,1
7703,100388,2JB50R0jD3NibtfXa92f6mpF735lk1Oo,SpATywNh6bZuzm8s1ceuBUnMUAeoAHHw,13,10,6,16,3,0,1,0,36,5.142857142857143,1,0.0,2,6,14,3,8,0,2,1,0,25,11,1
7704,100391,kyGh4gel5GTGb41pTkpUlnRTMKLiWXKA,G8EPVSXsOYB5YQWZGiz1aVq5Pgr2GrQu,5,2,1,0,1,0,2,0,6,0.8571428571428571,1,0.0,0,1,0,1,2,0,0,2,0,2,4,1
7705,100395,lDJQud5AwL6Ba2zEaWPbxkrhuulYEvyw,bWdj2GDclj5ofokWjzoa5jAwMkxCykd6,1,0,0,0,0,0,3,0,3,0.42857142857142855,1,0.0,0,0,0,0,0,0,0,3,0,0,3,1
7706,100405,lsAfokF5POsODUr1G2X0v5zWkAd5sfbB,SpATywNh6bZuzm8s1ceuBUnMUAeoAHHw,2,0,0,0,0,0,3,0,3,0.42857142857142855,1,0.0,0,0,0,0,0,0,0,3,0,0,3,1
7707,100408,MlHPKmdi90dDdvX24jYoFlYEp8xS4RGn,RXDvfPUBYFlVdlueBFbLW0mhhAyGEqpt,14,22,1,0,1,3,2,0,29,4.142857142857143,2,0.0,4,1,0,1,18,3,0,2,0,6,23,0
7708,100412,OvbupWSPA81Tk7Ur62Bs2bcQ5LB2mCRC,bWdj2GDclj5ofokWjzoa5jAwMkxCykd6,1,0,0,0,0,0,1,0,1,0.14285714285714285,1,0.0,0,0,0,0,0,0,0,1,0,0,1,1
7709,100426,sWiS7fnOghX7y7YX6Vs9Fow1ZPp98c2P,bWdj2GDclj5ofokWjzoa5jAwMkxCykd6,10,26,0,0,3,3,15,1,48,6.857142857142857,1,0.0,9,0,0,3,17,3,0,15,1,12,36,1
7710,100439,FhVGWSUXUeZGSguiLBd186fsM4sRhpPL,G8EPVSXsOYB5YQWZGiz1aVq5Pgr2GrQu,9,11,1,22,1,0,1,0,36,5.142857142857143,1,0.0,3,1,17,1,8,0,5,1,0,22,14,1
7711,100450,lU8LXbJuGJewdk0jE0yxpPj20hcwCqO8,A3fsA9Zfv1X2fVEQhTw51lKENdNrEqT3,59,16,12,100,7,0,13,0,148,21.142857142857142,3,0.0,2,12,94,7,14,0,6,13,0,115,33,0
7712,100489,siw3z9CF4q7PdqdWdVvFDzTmHm8ZHf2L,SpATywNh6bZuzm8s1ceuBUnMUAeoAHHw,1,0,0,0,0,0,1,0,1,0.14285714285714285,1,0.0,0,0,0,0,0,0,0,1,0,0,1,1
7713,100499,ZIt5iRfEuLMxmr9xMDT0sX9zx5GgOmQf,A3fsA9Zfv1X2fVEQhTw51lKENdNrEqT3,1,0,0,0,0,0,2,0,2,0.2857142857142857,1,0.0,0,0,0,0,0,0,0,2,0,0,2,1
7714,100512,sv1H0k2AOskJuUJSlRoi2iUdzle6ZY5e,G8EPVSXsOYB5YQWZGiz1aVq5Pgr2GrQu,3,0,0,0,0,0,3,0,3,0.42857142857142855,1,0.0,0,0,0,0,0,0,0,3,0,0,3,1
7715,100523,FifZKzWgnHbxPg1j0vi1JZCTI4cVJ25l,G8EPVSXsOYB5YQWZGiz1aVq5Pgr2GrQu,9,8,0,6,0,0,2,0,16,2.2857142857142856,1,0.0,3,0,3,0,5,0,3,2,0,6,10,1
7716,100547,0Czxo1UyRYR5I2rUJ5duK2VwsqwaqR13,SpATywNh6bZuzm8s1ceuBUnMUAeoAHHw,10,6,0,0,0,4,6,1,17,2.4285714285714284,1,0.0,0,0,0,0,6,4,0,6,1,0,17,1
7717,100554,8msriFvaCCtQyOBjAsLjk1IXyxsB0lzq,RXDvfPUBYFlVdlueBFbLW0mhhAyGEqpt,5,3,2,0,0,0,2,0,7,1.0,2,0.0,0,2,0,0,3,0,0,2,0,2,5,1
7718,100560,x8DjxiuO7OZapd2gSqXnLZdmO4eYlUve,bWdj2GDclj5ofokWjzoa5jAwMkxCykd6,1,0,0,0,0,0,1,0,1,0.14285714285714285,1,0.0,0,0,0,0,0,0,0,1,0,0,1,1
7719,100568,9fKCM48WCwLwvCl1vZ5Sx66ep0GEs87k,RXDvfPUBYFlVdlueBFbLW0mhhAyGEqpt,10,8,3,6,1,0,1,0,19,2.7142857142857144,1,0.0,1,3,6,1,7,0,0,1,0,11,8,1
7720,100573,krUqGfXTBwqDLoVqEC6x5HRNcKeuU2b1,SpATywNh6bZuzm8s1ceuBUnMUAeoAHHw,1,0,0,0,0,0,1,0,1,0.14285714285714285,1,0.0,0,0,0,0,0,0,0,1,0,0,1,1
7721,100594,0m1xQAlS5S5aY7jod2X9WwncTIVqHxA2,SpATywNh6bZuzm8s1ceuBUnMUAeoAHHw,4,2,1,0,0,0,2,0,5,0.7142857142857143,1,0.0,0,1,0,0,2,0,0,2,0,1,4,0
7722,100599,2sNFZBlVAcN0C3ozIX9ouOQIe9XjJNO6,RXDvfPUBYFlVdlueBFbLW0mhhAyGEqpt,8,5,2,0,2,0,7,0,16,2.2857142857142856,3,0.0,0,2,0,2,5,0,0,7,0,4,12,1
7723,100604,FYehGDNRsrl5wDaAnO5HST0ivs3hH7sH,SpATywNh6bZuzm8s1ceuBUnMUAeoAHHw,12,12,1,12,1,12,3,0,41,5.857142857142857,1,0.0,3,1,12,1,9,12,0,3,0,17,24,1
7724,100606,EW14eVSThxGfz3peXBNT9jQSWqEa62yw,SpATywNh6bZuzm8s1ceuBUnMUAeoAHHw,5,2,1,0,1,0,4,0,8,1.1428571428571428,1,0.0,0,1,0,1,2,0,0,4,0,2,6,1
7725,100608,qrBxOx4xvfJbTRNtYXFo4mMHRch3LE9R,bWdj2GDclj5ofokWjzoa5jAwMkxCykd6,2,0,0,0,0,0,3,0,3,0.42857142857142855,1,0.0,0,0,0,0,0,0,0,3,0,0,3,1
7726,100610,vPuo8DmIldZLRb6b5UgHPfgjxOLUxczJ,SpATywNh6bZuzm8s1ceuBUnMUAeoAHHw,8,6,3,0,2,4,4,0,19,2.7142857142857144,2,0.0,0,3,0,2,6,4,0,4,0,5,14,1
7727,100614,qeHXe8DRkB9urr63HS1yAMwTxQkwIbff,RXDvfPUBYFlVdlueBFbLW0mhhAyGEqpt,48,102,3,85,10,10,30,13,253,36.142857142857146,7,0.0,34,3,78,10,68,10,7,30,13,125,128,1
7728,100628,5POGITm84aGrgNJ0nsPFC65wjX6UfDmC,SpATywNh6bZuzm8s1ceuBUnMUAeoAHHw,4,2,0,0,0,0,5,0,7,1.0,1,0.0,0,0,0,0,2,0,0,5,0,0,7,1
7729,100642,5kFbFpqTAfcE9zjpZiw5sGDR5BhJdfrE,SpATywNh6bZuzm8s1ceuBUnMUAeoAHHw,5,3,0,0,0,0,2,0,5,0.7142857142857143,1,0.0,0,0,0,0,3,0,0,2,0,0,5,1
7730,100644,W3mRXTG4xhvVAzedNOQzsJsrgQcHfu8g,A3fsA9Zfv1X2fVEQhTw51lKENdNrEqT3,1,0,0,0,0,0,1,0,1,0.14285714285714285,1,0.0,0,0,0,0,0,0,0,1,0,0,1,1
7731,100647,rOlo2GoZP9TqbgRI0oVgxX8oSUKh8U3d,RXDvfPUBYFlVdlueBFbLW0mhhAyGEqpt,7,5,0,0,0,0,4,0,9,1.2857142857142858,1,0.0,0,0,0,0,5,0,0,4,0,0,9,1
7732,100648,lWNGGFUB9gkHAgPFHpuxssg4Y5G8A4T2,bWdj2GDclj5ofokWjzoa5jAwMkxCykd6,4,2,1,0,0,0,2,0,5,0.7142857142857143,1,0.0,0,1,0,0,2,0,0,2,0,1,4,1
7733,100659,rDec3XLpppIQx4sScddB7i9e44PtAV8K,A3fsA9Zfv1X2fVEQhTw51lKENdNrEqT3,1,0,0,0,0,0,1,0,1,0.14285714285714285,1,0.0,0,0,0,0,0,0,0,1,0,0,1,1
7734,100661,3C8bDgUvFDILMw4UNlmk2n4yo5NHVGtC,SpATywNh6bZuzm8s1ceuBUnMUAeoAHHw,11,18,0,15,0,1,5,0,39,5.571428571428571,2,0.0,8,0,15,0,10,1,0,5,0,23,16,1
7735,100677,ga70xb8tiQejcbGQlS6US7AEzd2ynNMR,bWdj2GDclj5ofokWjzoa5jAwMkxCykd6,5,5,2,0,1,0,2,0,10,1.4285714285714286,1,0.0,0,2,0,1,5,0,0,2,0,3,7,0
7736,100690,TqIZW6TBerJNN7EZw5XWZ32AUByseuDz,bWdj2GDclj5ofokWjzoa5jAwMkxCykd6,1,0,0,0,0,0,1,0,1,0.14285714285714285,1,0.0,0,0,0,0,0,0,0,1,0,0,1,1
7737,100693,5hXITOhzRYMjx2VRfYxzWyiyJwxTbApF,RXDvfPUBYFlVdlueBFbLW0mhhAyGEqpt,3,0,0,0,0,0,3,0,3,0.42857142857142855,1,0.0,0,0,0,0,0,0,0,3,0,0,3,1
7738,100715,vt827MYpYgT0JKXBC62SZ24Gxa8OJ87k,bWdj2GDclj5ofokWjzoa5jAwMkxCykd6,4,5,1,0,0,0,1,0,7,1.0,1,0.0,0,1,0,0,5,0,0,1,0,1,6,1
7739,100716,dGI6yveNenjFfT8c0PjNzk1ugu0VsvkU,G8EPVSXsOYB5YQWZGiz1aVq5Pgr2GrQu,2,0,0,0,0,0,2,0,2,0.2857142857142857,1,0.0,0,0,0,0,0,0,0,2,0,0,2,1
7740,100739,MqqmdkYysHqA6UDBkyqkZJffv3577kEU,SpATywNh6bZuzm8s1ceuBUnMUAeoAHHw,7,2,1,0,1,1,5,1,11,1.5714285714285714,1,0.0,0,1,0,1,2,1,0,5,1,2,9,1
7741,100745,oBC6VJY82mEcAXDVlIE68Xc4JnrHjU4b,SpATywNh6bZuzm8s1ceuBUnMUAeoAHHw,6,8,2,0,1,0,4,0,15,2.142857142857143,1,0.0,0,2,0,1,8,0,0,4,0,3,12,1
7742,100774,6cRse7eR1s1pCddP2ji9L7RuB7UYuqjL,SpATywNh6bZuzm8s1ceuBUnMUAeoAHHw,5,3,2,0,0,0,2,0,7,1.0,1,0.0,0,2,0,0,3,0,0,2,0,2,5,1
7743,100778,Wigd4PnyDnjfDcFOxsTBcEnXo7kl9GSg,SpATywNh6bZuzm8s1ceuBUnMUAeoAHHw,16,26,9,22,3,5,15,1,81,11.571428571428571,2,0.0,6,9,18,3,20,5,4,15,1,36,45,1
7744,100779,Qi3PLuC7w2Yo9hFgq37MObjY8icnRdc6,bWdj2GDclj5ofokWjzoa5jAwMkxCykd6,52,110,48,131,30,75,30,1,425,60.714285714285715,9,0.0,17,48,109,30,93,75,22,30,1,204,221,1
7745,100781,C82stxYBdobab5s8FnzuMHxgMBwKu2tD,A3fsA9Zfv1X2fVEQhTw51lKENdNrEqT3,1,0,0,0,0,0,1,0,1,0.14285714285714285,1,0.0,0,0,0,0,0,0,0,1,0,0,1,1
7746,100796,oDUwm6L4MXQ6JEb98dYg8X4b6ULu2zCm,SpATywNh6bZuzm8s1ceuBUnMUAeoAHHw,7,14,4,0,0,0,2,0,20,2.857142857142857,1,0.0,3,4,0,0,11,0,0,2,0,7,13,1
7747,100807,zfQZFTiqHKQUgpAItjpYn7ZjkbIcP825,SpATywNh6bZuzm8s1ceuBUnMUAeoAHHw,5,3,1,0,0,0,2,0,6,0.8571428571428571,2,0.0,0,1,0,0,3,0,0,2,0,1,5,1
7748,100817,jSNLRK8jxSbbcqhbWW7DXZqoGlvGgXDY,G8EPVSXsOYB5YQWZGiz1aVq5Pgr2GrQu,10,15,4,0,0,2,7,1,29,4.142857142857143,5,0.0,0,4,0,0,15,2,0,7,1,4,25,1
7749,100823,3SCBHiEI4HvwPrOQDNTIAqp1rZOAx5IK,bWdj2GDclj5ofokWjzoa5jAwMkxCykd6,17,52,29,112,18,0,10,0,221,31.571428571428573,5,0.0,15,29,105,18,37,0,7,10,0,167,54,1
7750,100834,EhKlFSggqkpH0G4s3hbhvR0dQLyh6jQ2,bWdj2GDclj5ofokWjzoa5jAwMkxCykd6,9,5,1,10,1,0,14,0,31,4.428571428571429,1,0.0,2,1,9,1,3,0,1,14,0,13,18,1
7751,100846,78iUKf97Yd7gLvilaD752YymIdL84Vdn,SpATywNh6bZuzm8s1ceuBUnMUAeoAHHw,5,4,1,0,0,0,2,0,7,1.0,1,0.0,0,1,0,0,4,0,0,2,0,1,6,1
7752,100862,G6iele4ho79nU5jQ1J8umZLq8jEFa9yN,bWdj2GDclj5ofokWjzoa5jAwMkxCykd6,6,6,3,0,1,14,4,1,29,4.142857142857143,2,0.0,0,3,0,1,6,14,0,4,1,4,25,1
7753,100869,jfd2LG9hNbbf5Lp41xKYtXydDr9rSQaq,G8EPVSXsOYB5YQWZGiz1aVq5Pgr2GrQu,4,3,1,0,1,0,1,0,6,0.8571428571428571,1,0.0,0,1,0,1,3,0,0,1,0,2,4,1
7754,100879,xlgVVLxBZCGRSXArMda1ZJ2EETOVQEd7,SpATywNh6bZuzm8s1ceuBUnMUAeoAHHw,5,2,1,0,1,1,2,0,7,1.0,1,0.0,0,1,0,1,2,1,0,2,0,2,5,1
7755,100888,JfI1PlGVl9kA0mdAoeqyEmchpJwdwBfa,SpATywNh6bZuzm8s1ceuBUnMUAeoAHHw,14,21,8,6,5,6,5,1,52,7.428571428571429,2,0.0,0,8,5,5,21,6,1,5,1,18,34,1
7756,100921,9Dj7cZ9RPLWRgYWhoZq69xKKKshP0n7X,A3fsA9Zfv1X2fVEQhTw51lKENdNrEqT3,1,0,0,0,0,0,1,0,1,0.14285714285714285,1,0.0,0,0,0,0,0,0,0,1,0,0,1,1
7757,100928,erUNLgaqPpXW5SB6BA1vjCrKhwxECQ5B,bWdj2GDclj5ofokWjzoa5jAwMkxCykd6,5,7,0,0,0,0,3,0,10,1.4285714285714286,2,0.0,0,0,0,0,7,0,0,3,0,0,10,1
7758,100931,QAQOQC9orxaSCK47wTUjk6OT4uXNA4IV,SpATywNh6bZuzm8s1ceuBUnMUAeoAHHw,1,0,0,0,0,0,1,0,1,0.14285714285714285,1,0.0,0,0,0,0,0,0,0,1,0,0,1,1
7759,100944,ZqMeeZA1fdjNAJGfaX50qgTzDRJ8YFP5,SpATywNh6bZuzm8s1ceuBUnMUAeoAHHw,7,9,5,0,2,1,4,0,21,3.0,2,0.0,0,5,0,2,9,1,0,4,0,7,14,1
7760,100956,Qi3PLuC7w2Yo9hFgq37MObjY8icnRdc6,RXDvfPUBYFlVdlueBFbLW0mhhAyGEqpt,4,2,1,0,1,0,2,0,6,0.8571428571428571,1,0.0,0,1,0,1,2,0,0,2,0,2,4,1
7761,100957,U04y5vFf0AfyJVGIOJHlryTyRQEOm5pT,bWdj2GDclj5ofokWjzoa5jAwMkxCykd6,4,2,1,0,1,0,1,0,5,0.7142857142857143,1,0.0,0,1,0,1,2,0,0,1,0,2,3,1
7762,100958,JHP5MvKDX3euU7PqF5LcZxc3GqSOARsL,SpATywNh6bZuzm8s1ceuBUnMUAeoAHHw,2,0,0,0,0,0,2,0,2,0.2857142857142857,1,0.0,0,0,0,0,0,0,0,2,0,0,2,1
7763,100960,U04y5vFf0AfyJVGIOJHlryTyRQEOm5pT,G8EPVSXsOYB5YQWZGiz1aVq5Pgr2GrQu,2,0,0,0,0,0,2,0,2,0.2857142857142857,1,0.0,0,0,0,0,0,0,0,2,0,0,2,1
7764,100961,pdDWSL0qqW5lqoVLDvyIeqmUWuTqLvQ6,SpATywNh6bZuzm8s1ceuBUnMUAeoAHHw,1,0,0,0,0,0,1,0,1,0.14285714285714285,1,0.0,0,0,0,0,0,0,0,1,0,0,1,1
7765,100978,4X713FvFJyCLvswyefbqyJ5rn4U0EDrr,G8EPVSXsOYB5YQWZGiz1aVq5Pgr2GrQu,7,2,1,0,1,0,5,1,10,1.4285714285714286,1,0.0,0,1,0,1,2,0,0,5,1,2,8,1
7766,100990,CnuwKGLCLbXYnPgy82VEWYA1NOiOhvr0,SpATywNh6bZuzm8s1ceuBUnMUAeoAHHw,24,48,0,22,1,1,14,2,88,12.571428571428571,6,0.0,12,0,17,1,36,1,5,14,2,30,58,0
7767,100997,coZTr10eytnE55me2AxqRWq6qrVXEB7M,SpATywNh6bZuzm8s1ceuBUnMUAeoAHHw,31,56,29,22,16,22,22,3,170,24.285714285714285,5,0.0,8,29,20,16,48,22,2,22,3,73,97,1
7768,101010,fd2e5NJVnyVwHFHuiTOOM639ZY1uThtn,SpATywNh6bZuzm8s1ceuBUnMUAeoAHHw,1,0,0,0,0,0,1,0,1,0.14285714285714285,1,0.0,0,0,0,0,0,0,0,1,0,0,1,1
7769,101011,6RuWsSvS3Ngnjl37PzNAaaGn8Jd9a1lW,SpATywNh6bZuzm8s1ceuBUnMUAeoAHHw,1,0,0,0,0,0,1,0,1,0.14285714285714285,1,0.0,0,0,0,0,0,0,0,1,0,0,1,1
7770,101020,0ZCSFawDDnRtGIJPo0HlmFehfeS6kHt8,SpATywNh6bZuzm8s1ceuBUnMUAeoAHHw,6,7,3,0,2,0,2,0,14,2.0,1,0.0,0,3,0,2,7,0,0,2,0,5,9,1
7771,101024,WSII4CAtuXXVd816MewodzGLKdBCCfc2,SpATywNh6bZuzm8s1ceuBUnMUAeoAHHw,27,68,22,18,12,1,21,0,142,20.285714285714285,4,0.0,16,22,17,12,52,1,1,21,0,67,75,0
7772,101026,mbu5XDK8Rjc919DDY9nTqWKI0jGsFurC,A3fsA9Zfv1X2fVEQhTw51lKENdNrEqT3,1,0,0,0,0,0,1,0,1,0.14285714285714285,1,0.0,0,0,0,0,0,0,0,1,0,0,1,1
7773,101029,qnchlLjb2Sg0NdcHhbSBOQwh2G3s1NPH,G8EPVSXsOYB5YQWZGiz1aVq5Pgr2GrQu,9,6,1,0,1,0,3,0,11,1.5714285714285714,2,0.0,0,1,0,1,6,0,0,3,0,2,9,1
7774,101037,eWW5LWmp2L4jfpnZTKTrpHZw2NPytGoT,A3fsA9Zfv1X2fVEQhTw51lKENdNrEqT3,1,0,0,0,0,0,1,0,1,0.14285714285714285,1,0.0,0,0,0,0,0,0,0,1,0,0,1,1
7775,101039,3Cx4dFPpXfBhy67BB6opyx75Z6TxCQV0,SpATywNh6bZuzm8s1ceuBUnMUAeoAHHw,1,0,0,0,0,0,1,0,1,0.14285714285714285,1,0.0,0,0,0,0,0,0,0,1,0,0,1,1
7776,101040,0MInlyhRLhTct7ctvAmGIMuZ2WCCEQOJ,A3fsA9Zfv1X2fVEQhTw51lKENdNrEqT3,1,0,0,0,0,0,1,0,1,0.14285714285714285,1,0.0,0,0,0,0,0,0,0,1,0,0,1,1
7777,101049,4s35oxsHucC7ffS0wFNPwafPYeG49GAU,SpATywNh6bZuzm8s1ceuBUnMUAeoAHHw,4,0,0,0,0,0,4,1,5,0.7142857142857143,1,0.0,0,0,0,0,0,0,0,4,1,0,5,1
7778,101051,0WQxgoUN7TBDtRGEW7KgYzWz2pgrrK5v,A3fsA9Zfv1X2fVEQhTw51lKENdNrEqT3,1,0,0,0,0,0,1,0,1,0.14285714285714285,1,0.0,0,0,0,0,0,0,0,1,0,0,1,1
7779,101056,OHdLWfOkVYVSxh9avWbeG6oGLyuN9vvx,SpATywNh6bZuzm8s1ceuBUnMUAeoAHHw,6,3,2,0,1,0,3,0,9,1.2857142857142858,1,0.0,0,2,0,1,3,0,0,3,0,3,6,1
7780,101075,2edy9dIAe4yrL8yAxHgqsIKKU0nldbta,SpATywNh6bZuzm8s1ceuBUnMUAeoAHHw,18,32,10,15,4,17,19,1,98,14.0,4,0.0,16,10,12,4,16,17,3,19,1,42,56,0
7781,101076,9QftuNjRCr9ybWcdk9XGcjwoamuBGtxp,RXDvfPUBYFlVdlueBFbLW0mhhAyGEqpt,13,8,3,8,2,0,4,1,26,3.7142857142857144,1,0.0,4,3,8,2,4,0,0,4,1,17,9,1
7782,101088,skwGEmBgIkpxOdkOcle3E7qOBQA7vS2R,SpATywNh6bZuzm8s1ceuBUnMUAeoAHHw,5,3,1,0,1,0,2,0,7,1.0,1,0.0,0,1,0,1,3,0,0,2,0,2,5,1
7783,101089,6mMeVC2B7hFVd1nCtPVGU6PaoCXq1G2c,SpATywNh6bZuzm8s1ceuBUnMUAeoAHHw,3,2,0,0,0,0,1,0,3,0.42857142857142855,1,0.0,0,0,0,0,2,0,0,1,0,0,3,1
7784,101100,mRaBEX7ZDfkFg6XYznVptg421BJGPS3w,SpATywNh6bZuzm8s1ceuBUnMUAeoAHHw,6,3,1,0,1,0,2,1,8,1.1428571428571428,1,0.0,0,1,0,1,3,0,0,2,1,2,6,1
7785,101101,FTGBOUC5qFiXzNQNK1iKg2fvAMPM8ThA,SpATywNh6bZuzm8s1ceuBUnMUAeoAHHw,9,8,4,0,4,0,2,0,18,2.5714285714285716,1,0.0,0,4,0,4,8,0,0,2,0,8,10,1
7786,101111,jWJRJs7mP2iWLScGpcEFZK8ziDAIaDM6,SpATywNh6bZuzm8s1ceuBUnMUAeoAHHw,12,20,1,18,0,0,5,0,44,6.285714285714286,2,0.0,12,1,15,0,8,0,3,5,0,28,16,1
7787,101115,FixP7IuJ80KsWtzMzcQsJZKOjLxDKZgC,SpATywNh6bZuzm8s1ceuBUnMUAeoAHHw,1,0,0,0,0,0,1,0,1,0.14285714285714285,1,0.0,0,0,0,0,0,0,0,1,0,0,1,1
7788,101129,dZFFkuSkEdW4wzDVTZtpVIC64kvJ857o,G8EPVSXsOYB5YQWZGiz1aVq5Pgr2GrQu,5,2,1,0,1,0,2,0,6,0.8571428571428571,1,0.0,0,1,0,1,2,0,0,2,0,2,4,1
7789,101152,7B5rcRMuJ6A1xAdnnIVDusvPjMkwnC77,bWdj2GDclj5ofokWjzoa5jAwMkxCykd6,45,79,6,158,2,7,25,2,279,39.857142857142854,6,0.0,17,6,145,2,62,7,13,25,2,170,109,1
7790,101155,PSxHADin4S7TFVr4zP5HBd1nZjW3cx4M,G8EPVSXsOYB5YQWZGiz1aVq5Pgr2GrQu,11,10,5,6,0,19,2,0,42,6.0,1,0.0,3,5,3,0,7,19,3,2,0,11,31,1
7791,101166,DFKzgJXlXxnZVHESIM4fYC543XX9ZfDV,A3fsA9Zfv1X2fVEQhTw51lKENdNrEqT3,1,0,0,0,0,0,1,0,1,0.14285714285714285,1,0.0,0,0,0,0,0,0,0,1,0,0,1,1
7792,101168,Fa6BLRRKtDwlKrwyXtqO3LGNnTfVpmlS,SpATywNh6bZuzm8s1ceuBUnMUAeoAHHw,1,0,0,0,0,0,1,0,1,0.14285714285714285,1,0.0,0,0,0,0,0,0,0,1,0,0,1,1
7793,101172,hfMGuVwBeucr422AFfEYrtJHa9rVnsoA,SpATywNh6bZuzm8s1ceuBUnMUAeoAHHw,1,0,0,0,0,0,1,0,1,0.14285714285714285,1,0.0,0,0,0,0,0,0,0,1,0,0,1,1
7794,101178,uAXW7zeSaEEtMIdMcVsYpUquscAKUnr7,bWdj2GDclj5ofokWjzoa5jAwMkxCykd6,2,0,0,0,0,0,3,0,3,0.42857142857142855,2,0.0,0,0,0,0,0,0,0,3,0,0,3,1
7795,101183,4moZsX66K72QjGT5GqDqJCMPu4Ct97bi,G8EPVSXsOYB5YQWZGiz1aVq5Pgr2GrQu,6,5,1,0,2,1,2,0,11,1.5714285714285714,1,0.0,2,1,0,2,3,1,0,2,0,5,6,1
7796,101188,gtKTzkXHwS41ljYVmjlLLf4WyQSkK02q,RXDvfPUBYFlVdlueBFbLW0mhhAyGEqpt,2,0,0,0,0,0,2,0,2,0.2857142857142857,1,0.0,0,0,0,0,0,0,0,2,0,0,2,1
7797,101208,6bpPMNX4VLAo5FNzh6WrMNoyVaRnL68O,RXDvfPUBYFlVdlueBFbLW0mhhAyGEqpt,8,9,1,0,0,0,1,0,11,1.5714285714285714,1,0.0,0,1,0,0,9,0,0,1,0,1,10,1
7798,101210,h9fj5ctPIK6vllChG3R7Ob244BG9PpLx,SpATywNh6bZuzm8s1ceuBUnMUAeoAHHw,3,0,0,0,0,0,3,1,4,0.5714285714285714,1,0.0,0,0,0,0,0,0,0,3,1,0,4,1
7799,101217,eoY58NwX7OVcm2sOG1AAgydEA1V5TiLJ,SpATywNh6bZuzm8s1ceuBUnMUAeoAHHw,1,0,0,0,0,0,1,0,1,0.14285714285714285,1,0.0,0,0,0,0,0,0,0,1,0,0,1,1
7800,101222,7SY0SzNTkW1xUX8FK1P49jbfTWqfgLfG,SpATywNh6bZuzm8s1ceuBUnMUAeoAHHw,7,16,2,0,1,0,7,0,26,3.7142857142857144,2,0.0,0,2,0,1,16,0,0,7,0,3,23,1
7801,101225,MwRVXLIjs7ObnboXYRMgXHQa3UWpN5i5,bWdj2GDclj5ofokWjzoa5jAwMkxCykd6,5,2,1,0,1,0,3,0,7,1.0,1,0.0,0,1,0,1,2,0,0,3,0,2,5,1
7802,101227,1zysq5lTXLzGIAe1yQorA74YMvQPYkm5,SpATywNh6bZuzm8s1ceuBUnMUAeoAHHw,1,0,0,0,0,0,2,0,2,0.2857142857142857,1,0.0,0,0,0,0,0,0,0,2,0,0,2,1
7803,101234,7kbuqNU54d8d11QmdSpTGAMhLhmSDka1,RXDvfPUBYFlVdlueBFbLW0mhhAyGEqpt,44,25,15,72,8,0,4,0,124,17.714285714285715,2,0.0,7,15,68,8,18,0,4,4,0,98,26,1
7804,101236,cCvHnoX6St5OTmXQ2AOInGyMnqlmS6DL,SpATywNh6bZuzm8s1ceuBUnMUAeoAHHw,14,14,6,16,4,1,2,0,43,6.142857142857143,1,0.0,4,6,14,4,10,1,2,2,0,28,15,1
7805,101246,I5LLOe5opvt5J43scHH7lI6K5JrrHIsM,SpATywNh6bZuzm8s1ceuBUnMUAeoAHHw,7,2,1,0,1,0,4,0,8,1.1428571428571428,2,0.0,0,1,0,1,2,0,0,4,0,2,6,1
7806,101250,iI85tnA7qrRiHSPoxfEPOdB8KhBODfhh,bWdj2GDclj5ofokWjzoa5jAwMkxCykd6,3,0,0,0,0,0,3,0,3,0.42857142857142855,1,0.0,0,0,0,0,0,0,0,3,0,0,3,1
7807,101260,ti7nrCLZuFBhUOASmDPlWdVcwOuGnHAJ,SpATywNh6bZuzm8s1ceuBUnMUAeoAHHw,7,7,5,0,3,0,3,0,18,2.5714285714285716,2,0.0,0,5,0,3,7,0,0,3,0,8,10,1
7808,102868,eGy9PbpiLJ8MX3YMIjoO70TYhFvF8s3p,SpATywNh6bZuzm8s1ceuBUnMUAeoAHHw,6,2,1,0,1,2,3,1,10,1.4285714285714286,1,0.0,0,1,0,1,2,2,0,3,1,2,8,1
7809,102871,j91nMgV3K6rtEcjFaPoRw8ZzxTKSNRyI,A3fsA9Zfv1X2fVEQhTw51lKENdNrEqT3,12,6,5,0,5,0,1,0,17,2.4285714285714284,1,0.0,0,5,0,5,6,0,0,1,0,10,7,1
7810,102874,ovOrxCTVGxQyC9labPGJ3gKHEzv9s9aZ,A3fsA9Zfv1X2fVEQhTw51lKENdNrEqT3,1,0,0,0,0,0,1,0,1,0.14285714285714285,1,0.0,0,0,0,0,0,0,0,1,0,0,1,1
7811,102890,QBgKSCSCtuy3kameVOAw6Wwz0K2iKBbH,G8EPVSXsOYB5YQWZGiz1aVq5Pgr2GrQu,10,11,5,0,4,0,3,0,23,3.2857142857142856,1,0.0,0,5,0,4,11,0,0,3,0,9,14,1
7812,102893,c5JhVDkXO4Xl1o4x0X5wpbuFHZccHbBn,SpATywNh6bZuzm8s1ceuBUnMUAeoAHHw,1,0,0,0,0,0,1,0,1,0.14285714285714285,1,0.0,0,0,0,0,0,0,0,1,0,0,1,1
7813,102894,2cEDKyYGVPkvyTHRF0ybKZjw6PISqB33,SpATywNh6bZuzm8s1ceuBUnMUAeoAHHw,8,1,1,0,1,0,5,6,14,2.0,1,0.0,0,1,0,1,1,0,0,5,6,2,12,1
7814,102905,s6iksgptFmyh2vfiarKdJkiKnp6RLi3f,A3fsA9Zfv1X2fVEQhTw51lKENdNrEqT3,3,0,0,0,0,8,3,0,11,1.5714285714285714,1,0.0,0,0,0,0,0,8,0,3,0,0,11,0
7815,102911,YbWp9q0RRrBwQyXxgLzRZdIoNM6EmpNj,A3fsA9Zfv1X2fVEQhTw51lKENdNrEqT3,2,0,0,0,0,0,3,0,3,0.42857142857142855,1,0.0,0,0,0,0,0,0,0,3,0,0,3,1
7816,102912,34XPBSlARSAdEabwWriA5XSSURJsqF6Q,bWdj2GDclj5ofokWjzoa5jAwMkxCykd6,5,2,1,0,1,0,2,0,6,0.8571428571428571,1,0.0,0,1,0,1,2,0,0,2,0,2,4,1
7817,102927,wpXUynmsiSu4GN2ibkxsqCGp9o4mfy5I,bWdj2GDclj5ofokWjzoa5jAwMkxCykd6,16,18,5,10,6,0,6,0,45,6.428571428571429,1,0.0,8,5,9,6,10,0,1,6,0,28,17,1
7818,102943,Gkxx7PBptGwgdrd4W0pkw1awMXPiihSA,SpATywNh6bZuzm8s1ceuBUnMUAeoAHHw,6,5,1,0,1,0,2,0,9,1.2857142857142858,1,0.0,0,1,0,1,5,0,0,2,0,2,7,1
7819,102944,23V5Y4dLt5dAp7zCNE7sBan2cormM1XH,SpATywNh6bZuzm8s1ceuBUnMUAeoAHHw,10,4,2,0,2,1,4,1,14,2.0,1,0.0,0,2,0,2,4,1,0,4,1,4,10,1
7820,102949,qqzld2DbTg8EBxOLVVgl3AZMKcPoFnE4,RXDvfPUBYFlVdlueBFbLW0mhhAyGEqpt,5,2,1,0,1,0,2,0,6,0.8571428571428571,1,0.0,0,1,0,1,2,0,0,2,0,2,4,1
7821,102952,F7KfRJPBsgtS0jdyt11WgvAWy4zhSMkM,A3fsA9Zfv1X2fVEQhTw51lKENdNrEqT3,1,0,0,0,0,0,1,0,1,0.14285714285714285,1,0.0,0,0,0,0,0,0,0,1,0,0,1,1
7822,102963,1uu9vv80QLeZErtdx0I8CPsrCRhlMRmo,RXDvfPUBYFlVdlueBFbLW0mhhAyGEqpt,6,2,1,0,1,0,3,0,7,1.0,1,0.0,0,1,0,1,2,0,0,3,0,2,5,1
7823,102964,pNiUFQveXjumuZsJcsFdYJDy5O0Fbp3m,G8EPVSXsOYB5YQWZGiz1aVq5Pgr2GrQu,5,2,1,0,1,0,2,0,6,0.8571428571428571,1,0.0,0,1,0,1,2,0,0,2,0,2,4,0
7824,102974,l569pvTkqA1hwU8mlPA8zjV2SyK4a7w2,A3fsA9Zfv1X2fVEQhTw51lKENdNrEqT3,3,3,0,0,0,0,1,0,4,0.5714285714285714,1,0.0,0,0,0,0,3,0,0,1,0,0,4,0
7825,102975,DvNxKU9g5rp8dv94zJRF8Ah76URW61cr,SpATywNh6bZuzm8s1ceuBUnMUAeoAHHw,18,10,8,0,7,0,7,0,32,4.571428571428571,3,0.0,0,8,0,7,10,0,0,7,0,15,17,1
7826,102978,t3ySM4Gbs4aIhGFWYbt2nw6OG5oriaOF,A3fsA9Zfv1X2fVEQhTw51lKENdNrEqT3,8,7,2,0,1,0,2,0,12,1.7142857142857142,1,0.0,0,2,0,1,7,0,0,2,0,3,9,1
7827,102980,uD8Spqeq0tcI9O6lX7gMmMVhDE2HC0Al,SpATywNh6bZuzm8s1ceuBUnMUAeoAHHw,1,0,0,0,0,0,1,0,1,0.14285714285714285,1,0.0,0,0,0,0,0,0,0,1,0,0,1,1
7828,102993,BxKAgVcecbK566xlIeUHElTAEVt3GzGl,bWdj2GDclj5ofokWjzoa5jAwMkxCykd6,1,0,0,0,0,0,1,0,1,0.14285714285714285,1,0.0,0,0,0,0,0,0,0,1,0,0,1,1
7829,102999,9WjmBPp7tHUxJcX9cD1TMvtq8VTyCZtX,SpATywNh6bZuzm8s1ceuBUnMUAeoAHHw,8,6,5,0,5,0,1,0,17,2.4285714285714284,1,0.0,0,5,0,5,6,0,0,1,0,10,7,1
7830,103025,l6kshSYgIFjkBtVOYi7kIq0LGbdGcRje,A3fsA9Zfv1X2fVEQhTw51lKENdNrEqT3,2,0,0,0,0,0,3,0,3,0.42857142857142855,1,0.0,0,0,0,0,0,0,0,3,0,0,3,1
7831,103038,TGrjsRoxwzZ35wp3zciCPp8r5aOpBmZm,SpATywNh6bZuzm8s1ceuBUnMUAeoAHHw,2,0,0,0,0,0,3,0,3,0.42857142857142855,2,0.0,0,0,0,0,0,0,0,3,0,0,3,1
7832,103075,8hmY23T5sCq9C2hlUNLSrX2yqFt52Pgt,RXDvfPUBYFlVdlueBFbLW0mhhAyGEqpt,7,3,2,0,2,0,2,0,9,1.2857142857142858,1,0.0,0,2,0,2,3,0,0,2,0,4,5,1
7833,103089,Sd54wuYLJGE9pQgAE1cFvsQCM2O9iNXw,bWdj2GDclj5ofokWjzoa5jAwMkxCykd6,5,2,1,0,1,0,2,0,6,0.8571428571428571,1,0.0,0,1,0,1,2,0,0,2,0,2,4,1
7834,103104,JXOo8fki25FPq0plM7J4NKpdKtv8nAso,A3fsA9Zfv1X2fVEQhTw51lKENdNrEqT3,1,0,0,0,0,0,1,0,1,0.14285714285714285,1,0.0,0,0,0,0,0,0,0,1,0,0,1,1
7835,103120,UFSjkDLycCAe1fUAiyo92id2TiybbTZT,SpATywNh6bZuzm8s1ceuBUnMUAeoAHHw,1,0,0,0,0,0,1,0,1,0.14285714285714285,1,0.0,0,0,0,0,0,0,0,1,0,0,1,1
7836,103134,PeVPWFtqmyzNVNGrKsrCqRCUp0alyzHv,SpATywNh6bZuzm8s1ceuBUnMUAeoAHHw,1,0,0,0,0,0,1,0,1,0.14285714285714285,1,0.0,0,0,0,0,0,0,0,1,0,0,1,1
7837,103157,8IuzZOXaXVUql9pLZtNuJIyLoDJ8ZL4V,A3fsA9Zfv1X2fVEQhTw51lKENdNrEqT3,20,19,8,50,2,0,4,0,83,11.857142857142858,2,0.0,2,8,43,2,17,0,7,4,0,55,28,1
7838,103175,pta6TaYSQ4VWeJjoWzSVUA5Zasc1vOWe,SpATywNh6bZuzm8s1ceuBUnMUAeoAHHw,1,0,0,0,0,0,1,0,1,0.14285714285714285,1,0.0,0,0,0,0,0,0,0,1,0,0,1,1
7839,103198,lUbIMCaPWDbgwiRy3ym2mDRgVr1wLki4,SpATywNh6bZuzm8s1ceuBUnMUAeoAHHw,11,8,1,0,1,0,2,0,12,1.7142857142857142,1,0.0,0,1,0,1,8,0,0,2,0,2,10,1
7840,103224,TINvhk9VLXQ3D49XU1y8baDw0NlbVtwm,G8EPVSXsOYB5YQWZGiz1aVq5Pgr2GrQu,4,2,1,0,1,0,1,0,5,0.7142857142857143,1,0.0,0,1,0,1,2,0,0,1,0,2,3,1
7841,103258,FBzPXWPyPigVHlzVcgyn2CNx30l85SaP,RXDvfPUBYFlVdlueBFbLW0mhhAyGEqpt,9,13,1,0,0,0,4,0,18,2.5714285714285716,2,0.0,5,1,0,0,8,0,0,4,0,6,12,0
7842,103271,DPNeCmHDELHrss8mkRKEcvkApu8OfWuh,G8EPVSXsOYB5YQWZGiz1aVq5Pgr2GrQu,19,10,8,0,6,1,12,1,38,5.428571428571429,1,0.0,0,8,0,6,10,1,0,12,1,14,24,0
7843,103283,XDwcqxWI4I9CO2vb10lgpVeZsspXXaL1,SpATywNh6bZuzm8s1ceuBUnMUAeoAHHw,1,0,0,0,0,0,1,0,1,0.14285714285714285,1,0.0,0,0,0,0,0,0,0,1,0,0,1,1
7844,103303,0Yuzh7q9awy4giTrLKNAtc9FYnhCvFKA,SpATywNh6bZuzm8s1ceuBUnMUAeoAHHw,4,9,2,0,0,0,1,0,12,1.7142857142857142,1,0.0,6,2,0,0,3,0,0,1,0,8,4,1
7845,103314,DPNeCmHDELHrss8mkRKEcvkApu8OfWuh,SpATywNh6bZuzm8s1ceuBUnMUAeoAHHw,1,0,0,0,0,0,1,0,1,0.14285714285714285,1,0.0,0,0,0,0,0,0,0,1,0,0,1,1
7846,103326,1Gr28fGQi0AhhBsOfiHtkCfOBAY8S9VF,bWdj2GDclj5ofokWjzoa5jAwMkxCykd6,5,3,1,0,1,0,2,0,7,1.0,1,0.0,0,1,0,1,3,0,0,2,0,2,5,1
7847,103339,D2lFXeOodglgSTRNVccRvVrNvHlYgfLJ,bWdj2GDclj5ofokWjzoa5jAwMkxCykd6,1,0,0,0,0,0,1,0,1,0.14285714285714285,1,0.0,0,0,0,0,0,0,0,1,0,0,1,1
7848,103347,hNJz0qbOhrUgajUkzqSdDbybHkuRglfs,SpATywNh6bZuzm8s1ceuBUnMUAeoAHHw,30,43,27,25,10,1,15,3,124,17.714285714285715,8,0.0,6,27,23,10,37,1,2,15,3,66,58,0
7849,103363,Cd9PhUepdZFgXcqgJFSSyoIXTR4PezW8,SpATywNh6bZuzm8s1ceuBUnMUAeoAHHw,7,3,2,0,1,12,3,1,22,3.142857142857143,1,0.0,0,2,0,1,3,12,0,3,1,3,19,1
7850,103397,vuxD2zMfzfccChKnwKAggsxPZbOiZaTb,RXDvfPUBYFlVdlueBFbLW0mhhAyGEqpt,5,0,0,0,0,1,5,2,8,1.1428571428571428,1,0.0,0,0,0,0,0,1,0,5,2,0,8,1
7851,103413,YJBz2hu0xpzNzWrBf0qrKIvgi0aKng9X,SpATywNh6bZuzm8s1ceuBUnMUAeoAHHw,1,0,0,0,0,0,1,0,1,0.14285714285714285,1,0.0,0,0,0,0,0,0,0,1,0,0,1,1
7852,103417,0sAOKVns8BSkUL9PacRKzX0uoHgRzVTD,SpATywNh6bZuzm8s1ceuBUnMUAeoAHHw,9,5,0,0,0,1,8,1,15,2.142857142857143,1,0.0,0,0,0,0,5,1,0,8,1,0,15,1
7853,103438,A7splZdp3CZV6tKUIRVHnnLOftJO8UXC,A3fsA9Zfv1X2fVEQhTw51lKENdNrEqT3,7,10,0,0,0,1,4,0,15,2.142857142857143,1,0.0,0,0,0,0,10,1,0,4,0,0,15,1
7854,103443,U3lhctDRAiyFJZP8fBSRJ5CxsYPJfYQW,SpATywNh6bZuzm8s1ceuBUnMUAeoAHHw,1,0,0,0,0,0,1,0,1,0.14285714285714285,1,0.0,0,0,0,0,0,0,0,1,0,0,1,1
7855,103445,YR1IgV2TtttHJ35h5NJxgcWKWfmLYszA,SpATywNh6bZuzm8s1ceuBUnMUAeoAHHw,16,34,19,4,9,1,11,0,78,11.142857142857142,5,0.0,3,19,4,9,31,1,0,11,0,35,43,0
7856,103451,74Dywe4dn2al60hXONYhqNpcRQDf18AP,RXDvfPUBYFlVdlueBFbLW0mhhAyGEqpt,9,6,5,0,2,0,1,0,14,2.0,1,0.0,0,5,0,2,6,0,0,1,0,7,7,1
7857,103453,0ClPvfgZ3teF26LrMInT4RNIPntzqSzr,SpATywNh6bZuzm8s1ceuBUnMUAeoAHHw,4,2,1,0,1,0,1,0,5,0.7142857142857143,1,0.0,0,1,0,1,2,0,0,1,0,2,3,0
7858,103454,Fl2rv0GIrb1pZGPCAVV4X3WnsKhjbfP2,bWdj2GDclj5ofokWjzoa5jAwMkxCykd6,8,5,2,0,3,0,5,0,15,2.142857142857143,2,0.0,2,2,0,3,3,0,0,5,0,7,8,1
7859,103456,uAXW7zeSaEEtMIdMcVsYpUquscAKUnr7,A3fsA9Zfv1X2fVEQhTw51lKENdNrEqT3,6,2,1,0,1,0,6,0,10,1.4285714285714286,1,0.0,0,1,0,1,2,0,0,6,0,2,8,0
7860,103457,XvNNzv39b8VqKid0q4fV9ms2wVNAdWks,bWdj2GDclj5ofokWjzoa5jAwMkxCykd6,35,81,32,134,8,0,39,0,294,42.0,7,0.0,16,32,127,8,65,0,7,39,0,183,111,0
7861,103479,ZdJ1BYcCBDVkoF1RDWOaW7qs4fUuQvAO,SpATywNh6bZuzm8s1ceuBUnMUAeoAHHw,17,23,9,8,2,2,9,1,54,7.714285714285714,1,0.0,9,9,7,2,14,2,1,9,1,27,27,0
7862,103502,Cp2BbG4q7QXu1vAJ8MUQKIeyJJyHFg2f,G8EPVSXsOYB5YQWZGiz1aVq5Pgr2GrQu,1,0,0,0,0,0,1,0,1,0.14285714285714285,1,0.0,0,0,0,0,0,0,0,1,0,0,1,1
7863,103504,OM0KD57nHAa4Wr8wJ1ilvxhef5Muhj8p,A3fsA9Zfv1X2fVEQhTw51lKENdNrEqT3,21,19,0,0,0,0,2,0,21,3.0,1,0.0,0,0,0,0,19,0,0,2,0,0,21,1
7864,103509,DhyvKgcTrgxrQOa9DadKHClSdCqlYrTj,SpATywNh6bZuzm8s1ceuBUnMUAeoAHHw,1,0,0,0,0,0,1,0,1,0.14285714285714285,1,0.0,0,0,0,0,0,0,0,1,0,0,1,1
7865,103534,YEF0QYiQE86qWLJG6v6QSOKqWyf11mYZ,SpATywNh6bZuzm8s1ceuBUnMUAeoAHHw,9,5,2,0,1,1,7,1,17,2.4285714285714284,1,0.0,0,2,0,1,5,1,0,7,1,3,14,1
7866,103557,vPv7PsanhRceiGshTPXtgrOmcrOEYM8O,RXDvfPUBYFlVdlueBFbLW0mhhAyGEqpt,10,5,5,0,3,0,3,1,17,2.4285714285714284,1,0.0,0,5,0,3,5,0,0,3,1,8,9,1
7867,103566,OSDu5tMGaniTUgLVQTpKE1MEiHaSe3gW,A3fsA9Zfv1X2fVEQhTw51lKENdNrEqT3,3,2,1,0,0,0,1,0,4,0.5714285714285714,1,0.0,0,1,0,0,2,0,0,1,0,1,3,1
7868,103581,QYxvxdCf3BqEP6mnoIkBRIai2RDjDRx6,SpATywNh6bZuzm8s1ceuBUnMUAeoAHHw,4,6,1,0,0,0,2,0,9,1.2857142857142858,1,0.0,3,1,0,0,3,0,0,2,0,4,5,1
7869,103600,5ZyvCd3AP7a8azCiLN5JfLAP53iZpAyD,RXDvfPUBYFlVdlueBFbLW0mhhAyGEqpt,1,0,0,0,0,0,1,0,1,0.14285714285714285,1,0.0,0,0,0,0,0,0,0,1,0,0,1,1
7870,103643,02x1393HfdHWlTjjnIgsA4Mhbk6lI383,SpATywNh6bZuzm8s1ceuBUnMUAeoAHHw,6,2,1,0,1,0,3,0,7,1.0,1,0.0,0,1,0,1,2,0,0,3,0,2,5,0
7871,103651,xzqF2LiZ7Zp1COlqOBger1kuvNL9t5JK,A3fsA9Zfv1X2fVEQhTw51lKENdNrEqT3,26,19,3,30,1,0,6,0,59,8.428571428571429,2,0.0,0,3,27,1,19,0,3,6,0,31,28,1
7872,103661,Z5Gd8RjsJSljoHUoBd3hvIVNy4VKuGq0,SpATywNh6bZuzm8s1ceuBUnMUAeoAHHw,25,53,23,18,12,40,7,0,153,21.857142857142858,4,0.0,10,23,16,12,43,40,2,7,0,61,92,0
7873,103666,6TVAbHzle9P1EfKyH9hEoMksSxlp6T76,SpATywNh6bZuzm8s1ceuBUnMUAeoAHHw,22,18,14,10,11,0,5,0,58,8.285714285714286,2,0.0,1,14,9,11,17,0,1,5,0,35,23,1
7874,103668,p9NcQP74LARrulF6JzGeab5yk6ciJM9V,SpATywNh6bZuzm8s1ceuBUnMUAeoAHHw,12,27,1,10,1,1,3,0,43,6.142857142857143,2,0.0,6,1,10,1,21,1,0,3,0,18,25,0
7875,103682,gMeZHtHbmrRB8drlaFHRYNGQ6Z4lgho8,bWdj2GDclj5ofokWjzoa5jAwMkxCykd6,1,0,0,0,0,0,1,0,1,0.14285714285714285,1,0.0,0,0,0,0,0,0,0,1,0,0,1,1
7876,103690,4GnibPWQ8lJjDFqzggHzR1fwcHUGxpIS,A3fsA9Zfv1X2fVEQhTw51lKENdNrEqT3,40,16,11,86,9,0,3,0,125,17.857142857142858,1,0.0,4,11,72,9,12,0,14,3,0,96,29,1
7877,103692,lQ2haPSIRb6ySD072MeaIkhUrCYHIGKE,A3fsA9Zfv1X2fVEQhTw51lKENdNrEqT3,7,4,1,0,1,0,3,0,9,1.2857142857142858,1,0.0,0,1,0,1,4,0,0,3,0,2,7,1
7878,103730,yYnx2Djc2xdWmysqfYS5LaytJ644aZht,G8EPVSXsOYB5YQWZGiz1aVq5Pgr2GrQu,4,3,2,0,0,0,2,0,7,1.0,1,0.0,0,2,0,0,3,0,0,2,0,2,5,0
7879,103737,ANBM6p9EaEI4Seaj9IaAoVJfXZGQglbd,bWdj2GDclj5ofokWjzoa5jAwMkxCykd6,4,2,0,0,0,0,5,0,7,1.0,1,0.0,0,0,0,0,2,0,0,5,0,0,7,1
7880,103746,rJa06nlcyBimvgL7PoPXhuOUbmR9mddR,SpATywNh6bZuzm8s1ceuBUnMUAeoAHHw,17,16,9,12,5,0,3,0,45,6.428571428571429,2,0.0,5,9,12,5,11,0,0,3,0,31,14,1
7881,103753,4wd4ZPQBIu7cqe3jxupr4Gm26uh0zMx7,A3fsA9Zfv1X2fVEQhTw51lKENdNrEqT3,9,3,2,0,2,5,13,1,26,3.7142857142857144,1,0.0,0,2,0,2,3,5,0,13,1,4,22,1
7882,103794,x29OOChdmJGXK62DnUpwKbwJurqULmnD,SpATywNh6bZuzm8s1ceuBUnMUAeoAHHw,16,19,12,0,8,0,2,0,41,5.857142857142857,1,0.0,4,12,0,8,15,0,0,2,0,24,17,1
7883,103837,nSjkfSPbC0LXqtynr3m9X0CV4GIunTid,G8EPVSXsOYB5YQWZGiz1aVq5Pgr2GrQu,5,2,1,0,1,0,2,0,6,0.8571428571428571,1,0.0,0,1,0,1,2,0,0,2,0,2,4,1
7884,103847,i4SeHiwnbIIoq9LoP3weAeDXl7e5RBtg,A3fsA9Zfv1X2fVEQhTw51lKENdNrEqT3,2,0,0,0,0,0,3,0,3,0.42857142857142855,1,0.0,0,0,0,0,0,0,0,3,0,0,3,1
7885,103849,9poFqdhDn1jEwJp6tGIQlD3gMA14zAqO,SpATywNh6bZuzm8s1ceuBUnMUAeoAHHw,8,8,1,0,0,2,8,1,20,2.857142857142857,3,0.0,0,1,0,0,8,2,0,8,1,1,19,1
7886,103865,WuuGUCveHVXII42bEeLxc9ae8hzxCCU9,SpATywNh6bZuzm8s1ceuBUnMUAeoAHHw,4,4,0,0,0,1,3,0,8,1.1428571428571428,1,0.0,0,0,0,0,4,1,0,3,0,0,8,1
7887,103875,XmievsUMm7pYjS9V5usB7AjkzDHh9x5X,SpATywNh6bZuzm8s1ceuBUnMUAeoAHHw,5,2,1,0,1,0,2,0,6,0.8571428571428571,1,0.0,0,1,0,1,2,0,0,2,0,2,4,1
7888,103881,JNia6gKvSZOSZQHrR3Kro8PKF3m40Fop,A3fsA9Zfv1X2fVEQhTw51lKENdNrEqT3,1,0,0,0,0,0,1,0,1,0.14285714285714285,1,0.0,0,0,0,0,0,0,0,1,0,0,1,1
7889,103884,PGaKSLZzbsk1Y4PL9tj5XLuPkFqOZE5w,SpATywNh6bZuzm8s1ceuBUnMUAeoAHHw,2,0,0,0,0,0,2,0,2,0.2857142857142857,1,0.0,0,0,0,0,0,0,0,2,0,0,2,0
7890,103894,RS2Yi11w0LQ7fKvpNddEmwppsyvf2NcO,SpATywNh6bZuzm8s1ceuBUnMUAeoAHHw,14,8,6,0,5,0,5,1,25,3.5714285714285716,1,0.0,0,6,0,5,8,0,0,5,1,11,14,1
7891,103896,D5E2Qt7jBeIZBIFcDabwhaaXeayXbs8U,A3fsA9Zfv1X2fVEQhTw51lKENdNrEqT3,2,0,0,0,0,0,2,0,2,0.2857142857142857,1,0.0,0,0,0,0,0,0,0,2,0,0,2,1
7892,103912,923Md4hufFSw6fyqcrCqvjLKbertSNtk,A3fsA9Zfv1X2fVEQhTw51lKENdNrEqT3,2,0,0,0,0,0,2,0,2,0.2857142857142857,1,0.0,0,0,0,0,0,0,0,2,0,0,2,1
7893,103930,Txv4UTCXPzwxfIDD6g3LwRLt3kYLBXuk,SpATywNh6bZuzm8s1ceuBUnMUAeoAHHw,23,47,10,26,2,48,16,0,149,21.285714285714285,10,0.0,13,10,22,2,34,48,4,16,0,47,102,0
7894,103942,JsgxGxJYDhwgnBgYbCILUrGTg0zFV4WJ,A3fsA9Zfv1X2fVEQhTw51lKENdNrEqT3,5,2,1,0,1,0,2,0,6,0.8571428571428571,1,0.0,0,1,0,1,2,0,0,2,0,2,4,1
7895,103953,IAJw4YtfScJYA1rvh3QXP9oI1WE1l0cK,SpATywNh6bZuzm8s1ceuBUnMUAeoAHHw,1,0,0,0,0,0,1,0,1,0.14285714285714285,1,0.0,0,0,0,0,0,0,0,1,0,0,1,1
7896,103958,1twD6my472TWNbA8IiJP0V3NsZHRSKHs,SpATywNh6bZuzm8s1ceuBUnMUAeoAHHw,9,8,1,0,1,3,8,1,22,3.142857142857143,1,0.0,2,1,0,1,6,3,0,8,1,4,18,0
7897,103963,dCHgtAVwX12C1h73zUIzcSalawnmf1Ly,SpATywNh6bZuzm8s1ceuBUnMUAeoAHHw,1,0,0,0,0,0,1,0,1,0.14285714285714285,1,0.0,0,0,0,0,0,0,0,1,0,0,1,1
7898,103991,ov5fYk5qZ3Ni8oW2PufqBBemq0WW1ldD,SpATywNh6bZuzm8s1ceuBUnMUAeoAHHw,7,4,2,0,2,0,2,0,10,1.4285714285714286,1,0.0,1,2,0,2,3,0,0,2,0,5,5,1
7899,104001,ZD6t0gZaLreJsx23cvmpLJAxc5XEYPzo,G8EPVSXsOYB5YQWZGiz1aVq5Pgr2GrQu,9,6,1,0,1,0,3,0,11,1.5714285714285714,1,0.0,0,1,0,1,6,0,0,3,0,2,9,1
7900,104008,TfPlmQ2inId9ipwO1Tkp44zWAUy81HnS,A3fsA9Zfv1X2fVEQhTw51lKENdNrEqT3,2,0,0,0,0,0,2,0,2,0.2857142857142857,1,0.0,0,0,0,0,0,0,0,2,0,0,2,1
7901,104034,uGLBXaq2O6Oj4FwXgJgHiKB87ZAsGOij,RXDvfPUBYFlVdlueBFbLW0mhhAyGEqpt,7,3,2,0,2,0,2,0,9,1.2857142857142858,1,0.0,0,2,0,2,3,0,0,2,0,4,5,1
7902,104065,Mf49DzxpNroXZrZEzTyFS3opux1fUHZq,SpATywNh6bZuzm8s1ceuBUnMUAeoAHHw,4,2,1,0,1,0,1,0,5,0.7142857142857143,1,0.0,0,1,0,1,2,0,0,1,0,2,3,1
7903,104075,Jeb6HFnTv5BAeG7m0GpNhKDbGECtxEse,RXDvfPUBYFlVdlueBFbLW0mhhAyGEqpt,18,27,1,0,0,1,10,2,41,5.857142857142857,3,0.0,1,1,0,0,26,1,0,10,2,2,39,1
7904,104089,fGDhAQY2WhkQYcL5XaYeDMBiOUQEoTnX,bWdj2GDclj5ofokWjzoa5jAwMkxCykd6,19,11,6,86,5,0,5,0,113,16.142857142857142,2,0.0,3,6,77,5,8,0,9,5,0,91,22,1
7905,104091,Whrc7O8OYrwQtVL43oMCOWkRLnJ5RAnq,A3fsA9Zfv1X2fVEQhTw51lKENdNrEqT3,1,0,0,0,0,0,1,0,1,0.14285714285714285,1,0.0,0,0,0,0,0,0,0,1,0,0,1,1
7906,104095,YI86C9tMYiPNH60fwrrOqDqOHSDWv9QR,SpATywNh6bZuzm8s1ceuBUnMUAeoAHHw,5,2,1,0,1,0,2,0,6,0.8571428571428571,1,0.0,0,1,0,1,2,0,0,2,0,2,4,1
7907,104119,1aQoKDna73jstuOrupWa9Kq8V3FdvbRU,SpATywNh6bZuzm8s1ceuBUnMUAeoAHHw,6,3,2,0,2,0,2,0,9,1.2857142857142858,2,0.0,0,2,0,2,3,0,0,2,0,4,5,1
7908,104144,XFHjgUTOXGdMfDJPVsJ9fIgVszICPgyz,A3fsA9Zfv1X2fVEQhTw51lKENdNrEqT3,9,4,3,0,3,0,2,0,12,1.7142857142857142,1,0.0,0,3,0,3,4,0,0,2,0,6,6,1
7909,104157,3mm3mJxVS0eLh8IUtBxaLL8aknBAQjDa,bWdj2GDclj5ofokWjzoa5jAwMkxCykd6,1,0,0,0,0,0,1,0,1,0.14285714285714285,1,0.0,0,0,0,0,0,0,0,1,0,0,1,1
7910,104162,I8C35PB4HAz5bxjARemPN0YBdl9xTOvv,A3fsA9Zfv1X2fVEQhTw51lKENdNrEqT3,9,5,0,0,0,8,7,1,21,3.0,1,0.0,0,0,0,0,5,8,0,7,1,0,21,0
7911,104178,YTd6RUCxKSrzEOkqGgY5uphLrJJcaHu6,SpATywNh6bZuzm8s1ceuBUnMUAeoAHHw,4,3,0,0,0,0,1,0,4,0.5714285714285714,1,0.0,0,0,0,0,3,0,0,1,0,0,4,1
7912,104194,7EU7vMf2b4Xv6MdI3zbAqQNQTiRVSvYt,A3fsA9Zfv1X2fVEQhTw51lKENdNrEqT3,5,2,1,0,1,0,2,0,6,0.8571428571428571,1,0.0,0,1,0,1,2,0,0,2,0,2,4,1
7913,104211,t5GAapz2qu7QW3ZA52Mo1qG5gvWMLT4H,A3fsA9Zfv1X2fVEQhTw51lKENdNrEqT3,1,0,0,0,0,0,1,0,1,0.14285714285714285,1,0.0,0,0,0,0,0,0,0,1,0,0,1,1
7914,104219,r7mxDUU76gpRNfXXfJxT6UdxuWsIdonz,A3fsA9Zfv1X2fVEQhTw51lKENdNrEqT3,3,3,0,0,0,0,1,0,4,0.5714285714285714,1,0.0,1,0,0,0,2,0,0,1,0,1,3,1
7915,104241,ixafWGJcoRhCM5cJdtULfcNp2InCr2Sa,A3fsA9Zfv1X2fVEQhTw51lKENdNrEqT3,22,13,11,0,6,4,11,2,47,6.714285714285714,1,0.0,0,11,0,6,13,4,0,11,2,17,30,1
7916,104273,TldFKIBOCwaUWZkv8geqqO2kCXoWqpzq,SpATywNh6bZuzm8s1ceuBUnMUAeoAHHw,14,8,7,0,5,0,1,0,21,3.0,1,0.0,0,7,0,5,8,0,0,1,0,12,9,1
7917,104284,eTpWGRVGcm2Ik3M0L1jEIkegdNZVCw6R,SpATywNh6bZuzm8s1ceuBUnMUAeoAHHw,14,47,1,21,1,47,6,1,124,17.714285714285715,2,0.0,34,1,18,1,13,47,3,6,1,54,70,0
7918,104292,BhFlcQJWIjFJlF5Tqxm0xkVlpnp9sVr5,A3fsA9Zfv1X2fVEQhTw51lKENdNrEqT3,10,6,4,0,3,0,2,0,15,2.142857142857143,1,0.0,0,4,0,3,6,0,0,2,0,7,8,1
7919,104294,HTFrI1D4p0HbfBDMwhsdYfCOWsNzjXaR,SpATywNh6bZuzm8s1ceuBUnMUAeoAHHw,7,3,2,0,2,0,2,0,9,1.2857142857142858,1,0.0,0,2,0,2,3,0,0,2,0,4,5,1
7920,104296,qIvK9ObB3zgAcjyEoNQW2L93AtBba9D4,G8EPVSXsOYB5YQWZGiz1aVq5Pgr2GrQu,7,5,0,0,0,0,4,0,9,1.2857142857142858,1,0.0,0,0,0,0,5,0,0,4,0,0,9,0
7921,104301,Vy093XdUJPwNTmCPocZUTd1XYGzzyp34,G8EPVSXsOYB5YQWZGiz1aVq5Pgr2GrQu,2,0,0,0,0,0,2,0,2,0.2857142857142857,1,0.0,0,0,0,0,0,0,0,2,0,0,2,1
7922,104335,PcrKUgtxZcGXBYkLOmECh99m3fhAOabf,G8EPVSXsOYB5YQWZGiz1aVq5Pgr2GrQu,3,2,0,0,0,0,1,0,3,0.42857142857142855,1,0.0,0,0,0,0,2,0,0,1,0,0,3,1
7923,104337,dMZ9S55l3tq5M3A71U0KoWxXWAhXsFH4,SpATywNh6bZuzm8s1ceuBUnMUAeoAHHw,7,10,4,0,2,0,2,0,18,2.5714285714285716,1,0.0,0,4,0,2,10,0,0,2,0,6,12,1
7924,104341,2rPgSvtsbYrCOUBollArAnVMcQox4Rzz,SpATywNh6bZuzm8s1ceuBUnMUAeoAHHw,10,5,4,0,3,0,6,0,18,2.5714285714285716,1,0.0,0,4,0,3,5,0,0,6,0,7,11,1
7925,104352,Jc6Rj6cwfhWlrTpjaB2LnqARTW8Bbf0L,SpATywNh6bZuzm8s1ceuBUnMUAeoAHHw,5,3,1,0,1,0,2,0,7,1.0,1,0.0,0,1,0,1,3,0,0,2,0,2,5,1
7926,104356,Nvx1FqKYM0wMKIIRgD0fWbHs2ulluJLe,bWdj2GDclj5ofokWjzoa5jAwMkxCykd6,1,0,0,0,0,0,1,0,1,0.14285714285714285,1,0.0,0,0,0,0,0,0,0,1,0,0,1,1
7927,104358,Nvx1FqKYM0wMKIIRgD0fWbHs2ulluJLe,A3fsA9Zfv1X2fVEQhTw51lKENdNrEqT3,4,2,0,0,0,0,2,0,4,0.5714285714285714,1,0.0,0,0,0,0,2,0,0,2,0,0,4,1
7928,104361,xnObPmivHmj7phvTSVLNuvvFk898J2aO,RXDvfPUBYFlVdlueBFbLW0mhhAyGEqpt,1,0,0,0,0,0,1,0,1,0.14285714285714285,1,0.0,0,0,0,0,0,0,0,1,0,0,1,1
7929,104366,uLsUz9dpaUlUOxHeWF3yHSSVzvVLEW6w,SpATywNh6bZuzm8s1ceuBUnMUAeoAHHw,1,0,0,0,0,0,1,0,1,0.14285714285714285,1,0.0,0,0,0,0,0,0,0,1,0,0,1,1
7930,104391,jTauqnokjVi6ospRFXXduew42x2G5Up9,G8EPVSXsOYB5YQWZGiz1aVq5Pgr2GrQu,7,3,2,0,2,0,2,0,9,1.2857142857142858,1,0.0,0,2,0,2,3,0,0,2,0,4,5,1
7931,104410,ObbXaQT6J9VxlQqNb4O6euoNIJzHR7rT,SpATywNh6bZuzm8s1ceuBUnMUAeoAHHw,9,4,3,0,3,0,2,0,12,1.7142857142857142,1,0.0,0,3,0,3,4,0,0,2,0,6,6,1
7932,104411,pcsiSS3QOPo0n8yKp6skJyBWeonG4c8P,A3fsA9Zfv1X2fVEQhTw51lKENdNrEqT3,7,4,3,0,3,0,2,0,12,1.7142857142857142,1,0.0,0,3,0,3,4,0,0,2,0,6,6,1
7933,104432,nbu72Hfybp6pv1ykyATXAv2RfzFEFoR8,SpATywNh6bZuzm8s1ceuBUnMUAeoAHHw,12,12,0,20,0,4,5,0,41,5.857142857142857,1,0.0,5,0,17,0,7,4,3,5,0,22,19,1
7934,104441,xMs8rC8PWX4mnQhPoCok61SbExcNBkVe,SpATywNh6bZuzm8s1ceuBUnMUAeoAHHw,6,3,1,0,1,0,2,0,7,1.0,1,0.0,0,1,0,1,3,0,0,2,0,2,5,1
7935,104452,ziSW6xDH8gzyWXn2P08NFoRMJoG4EqEB,SpATywNh6bZuzm8s1ceuBUnMUAeoAHHw,12,25,12,0,7,0,2,0,46,6.571428571428571,1,0.0,4,12,0,7,21,0,0,2,0,23,23,1
7936,104453,8uGMX8Xu6j8RLuhsBjmFgfMaI4mZnvz1,SpATywNh6bZuzm8s1ceuBUnMUAeoAHHw,12,10,4,0,3,0,4,0,21,3.0,1,0.0,0,4,0,3,10,0,0,4,0,7,14,1
7937,104458,I3Y9SshT4Px6bPwzvv7ixI5CQirBePZQ,SpATywNh6bZuzm8s1ceuBUnMUAeoAHHw,6,12,6,0,0,0,4,0,22,3.142857142857143,3,0.0,0,6,0,0,12,0,0,4,0,6,16,1
7938,104463,DyQHVTNiwX6W4PiKOVh8BCoKQr8u7ImW,A3fsA9Zfv1X2fVEQhTw51lKENdNrEqT3,12,12,1,0,0,3,10,0,26,3.7142857142857144,1,0.0,1,1,0,0,11,3,0,10,0,2,24,1
7939,104464,4OFy9ZLb1svxpVgXkgI60wOGeiU4V4oA,G8EPVSXsOYB5YQWZGiz1aVq5Pgr2GrQu,1,0,0,0,0,0,1,0,1,0.14285714285714285,1,0.0,0,0,0,0,0,0,0,1,0,0,1,1
7940,104466,KXi2lu4GlKmrO1lJTLg3t4l701rvNXNZ,bWdj2GDclj5ofokWjzoa5jAwMkxCykd6,1,0,0,0,0,0,1,0,1,0.14285714285714285,1,0.0,0,0,0,0,0,0,0,1,0,0,1,1
7941,104468,qUJjM2rHGQKXLfW6M7Cfr4tvklEU6daf,SpATywNh6bZuzm8s1ceuBUnMUAeoAHHw,13,12,6,3,2,6,11,3,43,6.142857142857143,2,0.0,1,6,3,2,11,6,0,11,3,12,31,1
7942,104489,wT2PCRFj23I7HDSSujNYjrYVx91GnsP3,A3fsA9Zfv1X2fVEQhTw51lKENdNrEqT3,5,2,1,0,1,0,4,0,8,1.1428571428571428,3,0.0,0,1,0,1,2,0,0,4,0,2,6,0
7943,104492,tPRxZgUxDUTQm2PmIuX0fewSz7eitT8g,SpATywNh6bZuzm8s1ceuBUnMUAeoAHHw,1,0,0,0,0,0,1,0,1,0.14285714285714285,1,0.0,0,0,0,0,0,0,0,1,0,0,1,1
7944,104495,LYehQDSOM5PcdlXuo0xGoCftzdlyd2gI,A3fsA9Zfv1X2fVEQhTw51lKENdNrEqT3,4,0,0,0,0,0,4,0,4,0.5714285714285714,1,0.0,0,0,0,0,0,0,0,4,0,0,4,1
7945,104496,tWy6K2sNXVB2esbGJMyXdZRQGH2Klw9e,SpATywNh6bZuzm8s1ceuBUnMUAeoAHHw,1,0,0,0,0,0,1,0,1,0.14285714285714285,1,0.0,0,0,0,0,0,0,0,1,0,0,1,1
7946,104503,2jTGBIAeHp8pnl61IF8YWrKorMuy9KJe,SpATywNh6bZuzm8s1ceuBUnMUAeoAHHw,2,0,0,0,0,0,2,0,2,0.2857142857142857,1,0.0,0,0,0,0,0,0,0,2,0,0,2,1
7947,104509,oE1QbspE1VaPia0G9CbmnflG7dN6cZJM,SpATywNh6bZuzm8s1ceuBUnMUAeoAHHw,2,0,0,0,0,0,2,0,2,0.2857142857142857,1,0.0,0,0,0,0,0,0,0,2,0,0,2,1
7948,104515,KQvub9kHQ3XpwpO5JgmmZp67zs4af3TX,A3fsA9Zfv1X2fVEQhTw51lKENdNrEqT3,5,2,1,0,1,0,2,0,6,0.8571428571428571,1,0.0,0,1,0,1,2,0,0,2,0,2,4,1
7949,104521,i5EjwCywnHAh7QM2CMkeJsIdXa8rMV6i,bWdj2GDclj5ofokWjzoa5jAwMkxCykd6,2,0,0,0,0,0,2,0,2,0.2857142857142857,1,0.0,0,0,0,0,0,0,0,2,0,0,2,1
7950,104526,ydd1OhJLlZRjAmcrBX6w4fAjd763MlEr,SpATywNh6bZuzm8s1ceuBUnMUAeoAHHw,2,0,0,0,0,0,2,0,2,0.2857142857142857,1,0.0,0,0,0,0,0,0,0,2,0,0,2,1
7951,104531,VqPSgF7LIkhd0l6BSJd84AdcMj5MaqIS,SpATywNh6bZuzm8s1ceuBUnMUAeoAHHw,1,0,0,0,0,0,1,0,1,0.14285714285714285,1,0.0,0,0,0,0,0,0,0,1,0,0,1,1
7952,104540,WELjmgdsP962Pc1teJ96xvofKraKe6qa,bWdj2GDclj5ofokWjzoa5jAwMkxCykd6,8,5,3,0,1,13,11,0,33,4.714285714285714,5,0.0,0,3,0,1,5,13,0,11,0,4,29,0
7953,104546,h2uPViUap57On5JUqQ9igq5GDP75Rgzf,SpATywNh6bZuzm8s1ceuBUnMUAeoAHHw,21,28,13,9,8,1,5,0,64,9.142857142857142,2,0.0,3,13,9,8,25,1,0,5,0,33,31,1
7954,104548,V0AsQgHGQGwNZqmKaETWBrxe3WpC4m5k,SpATywNh6bZuzm8s1ceuBUnMUAeoAHHw,8,6,3,0,2,0,6,0,17,2.4285714285714284,1,0.0,0,3,0,2,6,0,0,6,0,5,12,1
7955,104555,PSygGEnajNdSwAgw8ZB2LUfijgMjfKqV,bWdj2GDclj5ofokWjzoa5jAwMkxCykd6,1,0,0,0,0,0,1,0,1,0.14285714285714285,1,0.0,0,0,0,0,0,0,0,1,0,0,1,1
7956,104582,xM1yUWSpt3htcKGdTrpZVO5ZeftoW9re,G8EPVSXsOYB5YQWZGiz1aVq5Pgr2GrQu,10,6,2,8,1,0,5,0,22,3.142857142857143,1,0.0,3,2,6,1,3,0,2,5,0,12,10,1
7957,104589,LOsVkswWxHe5YwcAM1YjHggicuRbJ5sf,SpATywNh6bZuzm8s1ceuBUnMUAeoAHHw,1,0,0,0,0,0,1,0,1,0.14285714285714285,1,0.0,0,0,0,0,0,0,0,1,0,0,1,1
7958,104590,hlub8IQ6xr3M5qQPn6YnEFWROpuhMcwL,A3fsA9Zfv1X2fVEQhTw51lKENdNrEqT3,9,2,1,0,1,2,10,1,17,2.4285714285714284,3,0.0,0,1,0,1,2,2,0,10,1,2,15,1
7959,104591,nZpaESUo0GJPIuUQLM7WpTAyDvRCYws3,SpATywNh6bZuzm8s1ceuBUnMUAeoAHHw,11,6,2,8,1,0,6,0,23,3.2857142857142856,1,0.0,2,2,6,1,4,0,2,6,0,11,12,1
7960,104593,Q37fGjJ8eugSdDYZTpXfPJGR1Hy2EJgr,A3fsA9Zfv1X2fVEQhTw51lKENdNrEqT3,8,2,1,0,1,1,6,1,12,1.7142857142857142,1,0.0,0,1,0,1,2,1,0,6,1,2,10,1
7961,104606,n0z9CmHQ1aT2Na1Alnc3POrgJ8DExUjg,G8EPVSXsOYB5YQWZGiz1aVq5Pgr2GrQu,8,12,3,0,3,1,4,0,23,3.2857142857142856,1,0.0,5,3,0,3,7,1,0,4,0,11,12,1
7962,104608,n0z9CmHQ1aT2Na1Alnc3POrgJ8DExUjg,A3fsA9Zfv1X2fVEQhTw51lKENdNrEqT3,1,0,0,0,0,0,1,0,1,0.14285714285714285,1,0.0,0,0,0,0,0,0,0,1,0,0,1,1
7963,104610,3C1lYSFixKkKNR8DGEXYYhDOAMAek2Zr,G8EPVSXsOYB5YQWZGiz1aVq5Pgr2GrQu,12,10,4,6,4,0,2,0,26,3.7142857142857144,1,0.0,5,4,3,4,5,0,3,2,0,16,10,1
7964,104613,Ek3NRIw6r3qK8qXdjTcUWOMSezARAlja,bWdj2GDclj5ofokWjzoa5jAwMkxCykd6,9,24,9,0,6,3,14,2,58,8.285714285714286,3,0.0,5,9,0,6,19,3,0,14,2,20,38,1
7965,104615,yfPEDU3OzZWMdKaypuOZrACuYp6GNcyd,A3fsA9Zfv1X2fVEQhTw51lKENdNrEqT3,1,0,0,0,0,0,2,0,2,0.2857142857142857,1,0.0,0,0,0,0,0,0,0,2,0,0,2,1
7966,104630,CtmqfatIKebJswM6ar9T0zVFJv52NCRl,G8EPVSXsOYB5YQWZGiz1aVq5Pgr2GrQu,7,11,0,0,0,0,5,0,16,2.2857142857142856,1,0.0,6,0,0,0,5,0,0,5,0,6,10,1
7967,104632,z2UutrDxctGBl3XhV09hNxXdsZmqDZvY,RXDvfPUBYFlVdlueBFbLW0mhhAyGEqpt,1,0,0,0,0,0,1,0,1,0.14285714285714285,1,0.0,0,0,0,0,0,0,0,1,0,0,1,1
7968,104633,CtmqfatIKebJswM6ar9T0zVFJv52NCRl,SpATywNh6bZuzm8s1ceuBUnMUAeoAHHw,7,5,0,0,0,0,3,0,8,1.1428571428571428,1,0.0,0,0,0,0,5,0,0,3,0,0,8,1
7969,104636,JgNllefl6lxMJFs121u0iwNrhgAg4Z2l,A3fsA9Zfv1X2fVEQhTw51lKENdNrEqT3,4,2,1,0,1,0,1,0,5,0.7142857142857143,1,0.0,0,1,0,1,2,0,0,1,0,2,3,1
7970,104642,OyCwM8soHH8QE4hfLYRsx6iyHPIOqWTw,SpATywNh6bZuzm8s1ceuBUnMUAeoAHHw,13,12,0,11,0,0,9,1,33,4.714285714285714,2,0.0,7,0,9,0,5,0,2,9,1,16,17,1
7971,104688,1vi3aoGF64IJNwusboKMOjObFPU3HDht,SpATywNh6bZuzm8s1ceuBUnMUAeoAHHw,14,15,6,15,4,0,2,0,42,6.0,1,0.0,8,6,12,4,7,0,3,2,0,30,12,0
7972,104693,vGcc0AnjpQHzU6MhASLVTSg5K7Oxs693,bWdj2GDclj5ofokWjzoa5jAwMkxCykd6,1,0,0,0,0,0,1,0,1,0.14285714285714285,1,0.0,0,0,0,0,0,0,0,1,0,0,1,0
7973,104697,HlYiU2TA92it9HWOPDlsBmlpdZ7J7QTJ,A3fsA9Zfv1X2fVEQhTw51lKENdNrEqT3,30,62,32,52,19,11,20,1,197,28.142857142857142,5,0.0,2,32,43,19,60,11,9,20,1,96,101,1
7974,104724,AO2DWs3lh9A1GvC8BAMupQKT1Hlk19lZ,A3fsA9Zfv1X2fVEQhTw51lKENdNrEqT3,5,7,0,0,0,0,6,0,13,1.8571428571428572,1,0.0,0,0,0,0,7,0,0,6,0,0,13,1
7975,104727,T8KPSkXPudd9vKVat9asv5ysr6zWaQCY,SpATywNh6bZuzm8s1ceuBUnMUAeoAHHw,15,25,2,19,0,1,9,2,58,8.285714285714286,1,0.0,9,2,16,0,16,1,3,9,2,27,31,1
7976,104735,XEAzAzWsIHOpS801lITcIzqWP1a4yYMV,SpATywNh6bZuzm8s1ceuBUnMUAeoAHHw,15,12,7,13,4,2,3,1,42,6.0,1,0.0,4,7,12,4,8,2,1,3,1,27,15,1
7977,104737,o6c539lwIkVrO8m1FxoLjW3D1hV2LZeV,SpATywNh6bZuzm8s1ceuBUnMUAeoAHHw,10,7,0,8,0,6,3,0,24,3.4285714285714284,2,0.0,2,0,7,0,5,6,1,3,0,9,15,1
7978,104746,Lzsz8G97Oqbb3ZBCI5dR9gHrqQ1EH7Ym,bWdj2GDclj5ofokWjzoa5jAwMkxCykd6,5,3,1,0,0,0,3,0,7,1.0,2,0.0,0,1,0,0,3,0,0,3,0,1,6,1
7979,104755,cwVdqEP9opAeKfgoOEHlcQUqgyjLtu9l,G8EPVSXsOYB5YQWZGiz1aVq5Pgr2GrQu,5,2,1,0,1,0,2,0,6,0.8571428571428571,1,0.0,0,1,0,1,2,0,0,2,0,2,4,1
7980,104757,couyquW2Z4n38XcaXOGqoUN34GlfxMVE,A3fsA9Zfv1X2fVEQhTw51lKENdNrEqT3,6,4,1,0,1,0,2,0,8,1.1428571428571428,1,0.0,0,1,0,1,4,0,0,2,0,2,6,0
7981,104762,Lo2vU6mH3fqBjPz8YtN99A9tnKdHVK6o,SpATywNh6bZuzm8s1ceuBUnMUAeoAHHw,8,11,7,0,4,0,8,0,30,4.285714285714286,2,0.0,0,7,0,4,11,0,0,8,0,11,19,1
7982,104767,futyrc5ZKHBBJxaxN8pRQj4FOD0yyEl8,RXDvfPUBYFlVdlueBFbLW0mhhAyGEqpt,7,9,5,0,1,0,2,0,17,2.4285714285714284,1,0.0,0,5,0,1,9,0,0,2,0,6,11,1
7983,104770,1O5EjoRsscLnc9nXfpqkKtbnynlBSzrx,SpATywNh6bZuzm8s1ceuBUnMUAeoAHHw,6,3,2,0,0,0,3,0,8,1.1428571428571428,1,0.0,0,2,0,0,3,0,0,3,0,2,6,1
7984,104774,tBbhVMYYQ6OTtHw8ihRfnNPpAK2u2FCV,SpATywNh6bZuzm8s1ceuBUnMUAeoAHHw,10,16,7,0,4,0,1,0,28,4.0,1,0.0,0,7,0,4,16,0,0,1,0,11,17,1
7985,104777,7AcpuVe6H4EQE4t982IHxKSRBEP280dQ,SpATywNh6bZuzm8s1ceuBUnMUAeoAHHw,11,13,1,16,0,6,5,1,42,6.0,1,0.0,6,1,15,0,7,6,1,5,1,22,20,1
7986,104784,A7BPMFQzaFIvFoWRCDmdq1av9dzZSKUQ,SpATywNh6bZuzm8s1ceuBUnMUAeoAHHw,1,0,0,0,0,0,1,0,1,0.14285714285714285,1,0.0,0,0,0,0,0,0,0,1,0,0,1,1
7987,104792,uMEUDlZ1tL8WoZ2EmL0CStSYwA0zOal8,SpATywNh6bZuzm8s1ceuBUnMUAeoAHHw,6,3,2,0,2,0,1,0,8,1.1428571428571428,1,0.0,0,2,0,2,3,0,0,1,0,4,4,1
7988,104793,qDtFi7e90cUeHzM7V0dyqooeuFxEYpNm,SpATywNh6bZuzm8s1ceuBUnMUAeoAHHw,7,3,2,0,2,0,2,0,9,1.2857142857142858,1,0.0,0,2,0,2,3,0,0,2,0,4,5,1
7989,104795,cjnjr7Duofdr7KxOEuxuSM38OHUgNo60,G8EPVSXsOYB5YQWZGiz1aVq5Pgr2GrQu,18,27,6,0,6,0,15,1,55,7.857142857142857,2,0.0,0,6,0,6,27,0,0,15,1,12,43,0
7990,104800,mz4uLo9BLm8C45jnilK7oxFwMZeC54GR,A3fsA9Zfv1X2fVEQhTw51lKENdNrEqT3,8,6,1,0,0,3,5,0,15,2.142857142857143,1,0.0,0,1,0,0,6,3,0,5,0,1,14,1
7991,104801,dDRiefJH6VL2xh5SH3Jn4nOIwtp9UE53,SpATywNh6bZuzm8s1ceuBUnMUAeoAHHw,4,0,0,0,0,0,5,0,5,0.7142857142857143,1,0.0,0,0,0,0,0,0,0,5,0,0,5,1
7992,104811,xhZvMzC7C3FI6QGx1nJhPvhS30jV3HlC,SpATywNh6bZuzm8s1ceuBUnMUAeoAHHw,1,0,0,0,0,0,1,0,1,0.14285714285714285,1,0.0,0,0,0,0,0,0,0,1,0,0,1,1
7993,104815,I3l3i5FdvqNSQ2HVtWbrElKwC57iq42m,SpATywNh6bZuzm8s1ceuBUnMUAeoAHHw,6,4,1,0,1,0,2,0,8,1.1428571428571428,1,0.0,1,1,0,1,3,0,0,2,0,3,5,1
7994,104817,kCDwRCPqHBdxL6Zm4oP4P8LFVB7ooBk2,A3fsA9Zfv1X2fVEQhTw51lKENdNrEqT3,1,0,0,0,0,0,1,0,1,0.14285714285714285,1,0.0,0,0,0,0,0,0,0,1,0,0,1,1
7995,104821,HZ09CsQBbpW2jBqTRwR09w2caEvBXEBF,SpATywNh6bZuzm8s1ceuBUnMUAeoAHHw,11,9,0,18,0,0,2,0,29,4.142857142857143,1,0.0,2,0,15,0,7,0,3,2,0,17,12,0
7996,104824,zoXigsWBjyJG6OSyWQP4Y5frh0Mc9ncS,A3fsA9Zfv1X2fVEQhTw51lKENdNrEqT3,5,3,1,0,1,0,3,0,8,1.1428571428571428,1,0.0,1,1,0,1,2,0,0,3,0,3,5,1
7997,104825,fPBHPutjsyATgfjDez6QiXqE3EQ549Sn,bWdj2GDclj5ofokWjzoa5jAwMkxCykd6,10,9,2,56,3,3,5,1,79,11.285714285714286,1,0.0,5,2,53,3,4,3,3,5,1,63,16,1
7998,104828,TvgIXPYmwQ8PEavqO4tLfxpm2FF8nOoT,RXDvfPUBYFlVdlueBFbLW0mhhAyGEqpt,5,2,1,0,1,0,3,0,7,1.0,1,0.0,0,1,0,1,2,0,0,3,0,2,5,1
7999,104835,Ri95AXIo8zsMGIr8iLd7Nlf3hXPlEtcm,SpATywNh6bZuzm8s1ceuBUnMUAeoAHHw,5,3,1,0,0,0,2,0,6,0.8571428571428571,1,0.0,0,1,0,0,3,0,0,2,0,1,5,1
8000,104851,zjreW3h1Ea5BeCNB7vdMhwpbveHkJfhN,SpATywNh6bZuzm8s1ceuBUnMUAeoAHHw,7,2,1,0,1,1,4,1,10,1.4285714285714286,1,0.0,0,1,0,1,2,1,0,4,1,2,8,1
8001,104852,YjmLtoh2FsHRMNwgNAtlpUzEWjN5nhAS,SpATywNh6bZuzm8s1ceuBUnMUAeoAHHw,7,3,2,0,2,0,2,0,9,1.2857142857142858,1,0.0,0,2,0,2,3,0,0,2,0,4,5,1
8002,104857,EfAzIK92h28Gz4WXYVhp9fzk6YRB1DXC,A3fsA9Zfv1X2fVEQhTw51lKENdNrEqT3,1,0,0,0,0,0,1,0,1,0.14285714285714285,1,0.0,0,0,0,0,0,0,0,1,0,0,1,0
8003,104865,w1QHQFv3RratMvfK2BnfmiIqIYey1EzI,bWdj2GDclj5ofokWjzoa5jAwMkxCykd6,12,10,1,72,4,0,1,0,88,12.571428571428571,1,0.0,6,1,70,4,4,0,2,1,0,81,7,1
8004,104867,vO07VFd2DYWPdrvNiSqsqXFTXPKE00c4,RXDvfPUBYFlVdlueBFbLW0mhhAyGEqpt,1,0,0,0,0,0,1,0,1,0.14285714285714285,1,0.0,0,0,0,0,0,0,0,1,0,0,1,1
8005,104879,KLWMzt2lbmi8onKYKX9eWLl5lpM0wx0M,A3fsA9Zfv1X2fVEQhTw51lKENdNrEqT3,1,0,0,0,0,0,1,0,1,0.14285714285714285,1,0.0,0,0,0,0,0,0,0,1,0,0,1,1
8006,104881,RGtc1IdNIb5F1GGBZyglC3Cmje3Zbvbo,SpATywNh6bZuzm8s1ceuBUnMUAeoAHHw,1,0,0,0,0,0,1,0,1,0.14285714285714285,1,0.0,0,0,0,0,0,0,0,1,0,0,1,1
8007,104892,knqmj88BDpPhBept6EC2R3YJ3D5KQUZz,SpATywNh6bZuzm8s1ceuBUnMUAeoAHHw,6,4,1,0,1,0,2,0,8,1.1428571428571428,1,0.0,0,1,0,1,4,0,0,2,0,2,6,1
8008,104895,pOlc1xunOD2pPlaz6EGQWZcGB6A8fwQn,SpATywNh6bZuzm8s1ceuBUnMUAeoAHHw,6,5,0,0,0,0,2,0,7,1.0,1,0.0,0,0,0,0,5,0,0,2,0,0,7,1
8009,104916,Pe6a7Y0LdkKZQUrgr38AH2nCOR1VUYXS,SpATywNh6bZuzm8s1ceuBUnMUAeoAHHw,20,26,13,16,9,0,3,0,67,9.571428571428571,2,0.0,7,13,15,9,19,0,1,3,0,44,23,0
8010,104920,CGn56kdY0PhcUPAztOY3cUKmF6tF5atc,RXDvfPUBYFlVdlueBFbLW0mhhAyGEqpt,5,2,1,0,1,0,2,0,6,0.8571428571428571,1,0.0,0,1,0,1,2,0,0,2,0,2,4,1
8011,104924,e1PghwtNUGs6vA3J705NBEUcrBHwivKH,G8EPVSXsOYB5YQWZGiz1aVq5Pgr2GrQu,19,19,1,32,0,1,13,1,67,9.571428571428571,2,0.0,2,1,28,0,17,1,4,13,1,31,36,0
8012,104925,EmcvJhyzyIpQugXCF4WUuZQjl0kHTxx5,SpATywNh6bZuzm8s1ceuBUnMUAeoAHHw,5,2,1,0,1,0,2,0,6,0.8571428571428571,1,0.0,0,1,0,1,2,0,0,2,0,2,4,1
8013,104926,ONFhYKrJFqmwx9zBxMrT7qWQQw1Hgoxe,SpATywNh6bZuzm8s1ceuBUnMUAeoAHHw,8,7,3,0,2,0,2,0,14,2.0,1,0.0,3,3,0,2,4,0,0,2,0,8,6,1
8014,104928,hp7Gqo5252E9slRfXH0KFbulYobVoVWo,SpATywNh6bZuzm8s1ceuBUnMUAeoAHHw,7,5,3,0,1,0,4,0,13,1.8571428571428572,1,0.0,1,3,0,1,4,0,0,4,0,5,8,1
8015,104936,9xV1wwHzLoXwKNrE0sl58GGQQc4oj1NS,bWdj2GDclj5ofokWjzoa5jAwMkxCykd6,4,2,1,0,0,0,6,0,9,1.2857142857142858,3,0.0,0,1,0,0,2,0,0,6,0,1,8,1
8016,104943,8yrIKDtnkYcLfERwrXrvcRGxHxbt2Jd3,RXDvfPUBYFlVdlueBFbLW0mhhAyGEqpt,5,4,0,0,0,1,3,0,8,1.1428571428571428,1,0.0,0,0,0,0,4,1,0,3,0,0,8,1
8017,104947,MRBkmzjOlIfmLj12ExsDOcm0igHkBWY5,SpATywNh6bZuzm8s1ceuBUnMUAeoAHHw,4,2,0,0,0,0,2,0,4,0.5714285714285714,1,0.0,0,0,0,0,2,0,0,2,0,0,4,1
8018,104948,GEo21EE9t59WNpPzwlumpgmynliuHSiq,SpATywNh6bZuzm8s1ceuBUnMUAeoAHHw,3,0,0,0,0,0,3,0,3,0.42857142857142855,1,0.0,0,0,0,0,0,0,0,3,0,0,3,1
8019,104968,7cuOR7XN3OKWyCY4rmOlBcFyB6vgzoQs,A3fsA9Zfv1X2fVEQhTw51lKENdNrEqT3,3,0,0,0,0,0,4,0,4,0.5714285714285714,1,0.0,0,0,0,0,0,0,0,4,0,0,4,1
8020,104978,4p8c3FKQ0TxdvnCwTtbL9bKeePWMVkGP,SpATywNh6bZuzm8s1ceuBUnMUAeoAHHw,1,0,0,0,0,0,3,0,3,0.42857142857142855,1,0.0,0,0,0,0,0,0,0,3,0,0,3,1
8021,104984,0BvOWU3Vj9nIRblTj7EEskLoO3PxCxAy,bWdj2GDclj5ofokWjzoa5jAwMkxCykd6,5,2,1,0,1,0,5,0,9,1.2857142857142858,1,0.0,0,1,0,1,2,0,0,5,0,2,7,1
8022,104997,ve3dSb9Szfp4MnOfHAgrGxXGtdEF42Tp,A3fsA9Zfv1X2fVEQhTw51lKENdNrEqT3,10,4,3,0,3,0,3,0,13,1.8571428571428572,1,0.0,0,3,0,3,4,0,0,3,0,6,7,1
8023,105008,yV65Fr78Zm5MeDBgymBFgzc66d5t5Zmy,SpATywNh6bZuzm8s1ceuBUnMUAeoAHHw,12,24,14,0,0,2,13,2,55,7.857142857142857,1,0.0,7,14,0,0,17,2,0,13,2,21,34,0
8024,105014,qUdYzd5flRA3GCXiGt7tidXnS0F0FsHM,SpATywNh6bZuzm8s1ceuBUnMUAeoAHHw,5,3,0,0,0,0,4,2,9,1.2857142857142858,1,0.0,0,0,0,0,3,0,0,4,2,0,9,1
8025,105023,JKdKVDiZ9BQn8tsX4CdH77AcEG85EmQH,SpATywNh6bZuzm8s1ceuBUnMUAeoAHHw,5,3,1,0,0,0,3,0,7,1.0,1,0.0,0,1,0,0,3,0,0,3,0,1,6,1
8026,105024,7NRmTpdp1LUibho8qoHBLQ3GcaVtwUud,SpATywNh6bZuzm8s1ceuBUnMUAeoAHHw,1,0,0,0,0,0,1,0,1,0.14285714285714285,1,0.0,0,0,0,0,0,0,0,1,0,0,1,1
8027,105029,AdZFV9sO1gJgqtrxJrKT3ZcjH3XA6zTA,RXDvfPUBYFlVdlueBFbLW0mhhAyGEqpt,1,0,0,0,0,0,1,0,1,0.14285714285714285,1,0.0,0,0,0,0,0,0,0,1,0,0,1,1
8028,105030,QtcaqP1Oq08hvIX3wqGcQDC13eo6FjVm,SpATywNh6bZuzm8s1ceuBUnMUAeoAHHw,11,11,7,0,5,1,5,1,30,4.285714285714286,1,0.0,0,7,0,5,11,1,0,5,1,12,18,1
8029,105036,ynZ1Df4G2ARwLF4O85BSlMjjeKhXCtXL,SpATywNh6bZuzm8s1ceuBUnMUAeoAHHw,4,4,0,0,0,0,3,0,7,1.0,1,0.0,0,0,0,0,4,0,0,3,0,0,7,1
8030,105049,5GS5OD1cmKWecEPymf3UVauvWYXb9WHE,A3fsA9Zfv1X2fVEQhTw51lKENdNrEqT3,1,0,0,0,0,0,1,0,1,0.14285714285714285,1,0.0,0,0,0,0,0,0,0,1,0,0,1,1
8031,105053,pNgLScEwGgq81vg0a0cEXKNs5eG2UXph,bWdj2GDclj5ofokWjzoa5jAwMkxCykd6,1,0,0,0,0,0,1,0,1,0.14285714285714285,1,0.0,0,0,0,0,0,0,0,1,0,0,1,1
8032,105055,J7rstoE2U9Xgk66AuMKUxWUISAvdCQAz,G8EPVSXsOYB5YQWZGiz1aVq5Pgr2GrQu,12,11,1,6,2,1,5,1,27,3.857142857142857,1,0.0,5,1,3,2,6,1,3,5,1,11,16,1
8033,105057,QhYcOEapN0nrffEwA6S7jQzZwToRePP8,A3fsA9Zfv1X2fVEQhTw51lKENdNrEqT3,1,0,0,0,0,0,1,0,1,0.14285714285714285,1,0.0,0,0,0,0,0,0,0,1,0,0,1,1
8034,105059,KbGfmKt9ZBLOdWhdHwa3KVnLDM8esaSY,bWdj2GDclj5ofokWjzoa5jAwMkxCykd6,6,6,4,0,0,0,3,0,13,1.8571428571428572,1,0.0,0,4,0,0,6,0,0,3,0,4,9,1
8035,105061,jbwkj7UcLcGeNeVIuodsT34xBiopSnSK,A3fsA9Zfv1X2fVEQhTw51lKENdNrEqT3,2,0,0,0,0,0,3,0,3,0.42857142857142855,1,0.0,0,0,0,0,0,0,0,3,0,0,3,0
8036,105065,qhE0nq1HVP5Z55HX3UNFMVHvllKc96Rl,SpATywNh6bZuzm8s1ceuBUnMUAeoAHHw,7,8,2,0,1,0,4,0,15,2.142857142857143,3,0.0,0,2,0,1,8,0,0,4,0,3,12,1
8037,105070,C6BeEBrAxqOuF3t7YwEepluTHqEHWFpN,G8EPVSXsOYB5YQWZGiz1aVq5Pgr2GrQu,5,4,1,0,1,0,1,0,7,1.0,1,0.0,0,1,0,1,4,0,0,1,0,2,5,1
8038,105071,NSXDiRfuzySceLFWn0ct3CJviCtJc0Gq,SpATywNh6bZuzm8s1ceuBUnMUAeoAHHw,1,0,0,0,0,0,1,0,1,0.14285714285714285,1,0.0,0,0,0,0,0,0,0,1,0,0,1,1
8039,105074,O4P6YgbHRYZHkVgbR7e9lebrpm34oAOF,G8EPVSXsOYB5YQWZGiz1aVq5Pgr2GrQu,2,0,0,0,0,0,2,0,2,0.2857142857142857,1,0.0,0,0,0,0,0,0,0,2,0,0,2,1
8040,105076,drf1IY3xrpWQ9619UjKLyUfcUQsAdZju,bWdj2GDclj5ofokWjzoa5jAwMkxCykd6,5,3,1,0,1,0,2,0,7,1.0,1,0.0,0,1,0,1,3,0,0,2,0,2,5,1
8041,105082,0V54aOwQrSAMewtMntBBMI7Ks56rZdIS,A3fsA9Zfv1X2fVEQhTw51lKENdNrEqT3,12,6,4,0,2,1,7,0,20,2.857142857142857,1,0.0,0,4,0,2,6,1,0,7,0,6,14,1
8042,105085,aBoQ4OrEI4L04m6kqgzVP3CKZVnd2VFV,A3fsA9Zfv1X2fVEQhTw51lKENdNrEqT3,9,9,1,0,1,0,6,1,18,2.5714285714285716,1,0.0,0,1,0,1,9,0,0,6,1,2,16,1
8043,105105,aBoQ4OrEI4L04m6kqgzVP3CKZVnd2VFV,bWdj2GDclj5ofokWjzoa5jAwMkxCykd6,5,4,0,0,1,0,3,0,8,1.1428571428571428,1,0.0,2,0,0,1,2,0,0,3,0,3,5,1
8044,105107,kJpZNsO69ywT5OXmlvOgbLwUz2WmPek1,SpATywNh6bZuzm8s1ceuBUnMUAeoAHHw,13,11,5,14,3,0,2,0,35,5.0,1,0.0,5,5,11,3,6,0,3,2,0,24,11,1
8045,105146,hzBzR1u0wuRoc2H2cG5d9FzvO4PwKrLQ,SpATywNh6bZuzm8s1ceuBUnMUAeoAHHw,7,27,8,0,4,6,8,0,53,7.571428571428571,3,0.0,6,8,0,4,21,6,0,8,0,18,35,1
8046,105153,qTzYx0lbBuxcg0Yki7msaMyOo4bFeb91,SpATywNh6bZuzm8s1ceuBUnMUAeoAHHw,29,32,19,27,7,0,15,0,100,14.285714285714286,5,0.0,6,19,26,7,26,0,1,15,0,58,42,0
8047,105158,CCtqoOTfmYZ29m0AHaWWxr5jrw4v0sd6,A3fsA9Zfv1X2fVEQhTw51lKENdNrEqT3,2,0,0,0,0,0,2,0,2,0.2857142857142857,1,0.0,0,0,0,0,0,0,0,2,0,0,2,1
8048,105161,e8r3psiscML69Zoh8ndZVq9bRmvgsAna,RXDvfPUBYFlVdlueBFbLW0mhhAyGEqpt,3,0,0,0,0,0,4,0,4,0.5714285714285714,1,0.0,0,0,0,0,0,0,0,4,0,0,4,1
8049,105162,k5TsyI58X8P4Z61qSJPkdF5Bt76uuEiR,A3fsA9Zfv1X2fVEQhTw51lKENdNrEqT3,6,5,0,0,0,0,5,0,10,1.4285714285714286,1,0.0,0,0,0,0,5,0,0,5,0,0,10,1
8050,105165,WmDH79DnUcU85ObQwdrX32y257qi5DRa,SpATywNh6bZuzm8s1ceuBUnMUAeoAHHw,5,6,4,0,0,0,2,0,12,1.7142857142857142,1,0.0,1,4,0,0,5,0,0,2,0,5,7,1
8051,105182,w5agfaMGeGtqcOtE7XkU1SDkqYl8T1h1,A3fsA9Zfv1X2fVEQhTw51lKENdNrEqT3,8,5,3,0,2,0,6,1,17,2.4285714285714284,1,0.0,0,3,0,2,5,0,0,6,1,5,12,1
8052,105191,BFrfDseDfXCBvtTfCsJAy36Ogk6b0Rfx,G8EPVSXsOYB5YQWZGiz1aVq5Pgr2GrQu,7,7,3,0,2,0,2,0,14,2.0,2,0.0,0,3,0,2,7,0,0,2,0,5,9,1
8053,105194,5KBUyFUobvfAu8D7u7bO9wAPV4vuXQZU,A3fsA9Zfv1X2fVEQhTw51lKENdNrEqT3,43,73,20,76,13,0,12,0,194,27.714285714285715,2,0.0,4,20,67,13,69,0,9,12,0,104,90,0
8054,105199,OX6Bv3g06ycMeO3pZBZoU81BWj7ixSi4,A3fsA9Zfv1X2fVEQhTw51lKENdNrEqT3,5,6,0,0,0,0,5,0,11,1.5714285714285714,1,0.0,0,0,0,0,6,0,0,5,0,0,11,1
8055,105209,H9GkE0FMgvPMf43bNx1b9TXX6TZkGY34,SpATywNh6bZuzm8s1ceuBUnMUAeoAHHw,8,10,4,0,0,0,8,0,22,3.142857142857143,2,0.0,0,4,0,0,10,0,0,8,0,4,18,1
8056,105210,4gTXYNChXbNDMcXayBSE04FxQ2nn4APt,SpATywNh6bZuzm8s1ceuBUnMUAeoAHHw,9,11,6,0,4,7,4,0,32,4.571428571428571,1,0.0,0,6,0,4,11,7,0,4,0,10,22,1
8057,105217,OTdrNhcnMXK6bAJrTqNFs6h1YG7CDhcG,SpATywNh6bZuzm8s1ceuBUnMUAeoAHHw,10,10,3,0,2,3,6,3,27,3.857142857142857,1,0.0,0,3,0,2,10,3,0,6,3,5,22,1
8058,105234,taq5KphdnNYof9EF9ofKeGcG174vbrqW,SpATywNh6bZuzm8s1ceuBUnMUAeoAHHw,7,3,2,0,2,0,3,0,10,1.4285714285714286,1,0.0,0,2,0,2,3,0,0,3,0,4,6,1
8059,105243,cOQL66KmsXcVQs1SDl21ZVtRVEM2A2Mr,SpATywNh6bZuzm8s1ceuBUnMUAeoAHHw,15,16,4,17,3,0,6,0,46,6.571428571428571,1,0.0,8,4,14,3,8,0,3,6,0,29,17,1
8060,105249,TS1ZCG3Pe57Kb9bO3M4HccqPzgampcZm,RXDvfPUBYFlVdlueBFbLW0mhhAyGEqpt,1,0,0,0,0,0,1,0,1,0.14285714285714285,1,0.0,0,0,0,0,0,0,0,1,0,0,1,1
8061,105252,0XkWdOrszvLHfOAiz41vzdHNx25DrTO5,SpATywNh6bZuzm8s1ceuBUnMUAeoAHHw,18,24,9,14,4,2,7,1,61,8.714285714285714,1,0.0,12,9,13,4,12,2,1,7,1,38,23,1
8062,105253,HVCfWzPuIjheqdsfcEfqumsi8ZGav6vR,SpATywNh6bZuzm8s1ceuBUnMUAeoAHHw,10,14,8,0,3,0,5,0,30,4.285714285714286,1,0.0,0,8,0,3,14,0,0,5,0,11,19,1
8063,105260,IK3mtf86eqab6u3Svud8svoyG25XbueY,SpATywNh6bZuzm8s1ceuBUnMUAeoAHHw,13,14,3,17,1,0,5,0,40,5.714285714285714,2,0.0,2,3,15,1,12,0,2,5,0,21,19,1
8064,105262,47V3QOKZAFRfMjY5qh3dGgU05qgUrwzk,SpATywNh6bZuzm8s1ceuBUnMUAeoAHHw,22,28,13,19,6,11,7,0,84,12.0,3,0.0,5,13,18,6,23,11,1,7,0,42,42,0
8065,105263,4HfbFsCyYszJO7w4OHW3KiOw346tCEQ3,RXDvfPUBYFlVdlueBFbLW0mhhAyGEqpt,9,11,8,0,2,0,3,0,24,3.4285714285714284,2,0.0,0,8,0,2,11,0,0,3,0,10,14,0
8066,105269,Kbp64JoaypwT9V2b1Sun21o5uQW5G9la,SpATywNh6bZuzm8s1ceuBUnMUAeoAHHw,6,3,2,0,2,0,1,0,8,1.1428571428571428,1,0.0,0,2,0,2,3,0,0,1,0,4,4,1
8067,105271,b1VyhJSDHv0QJ3rH7siQ8iNr5JEetUc9,RXDvfPUBYFlVdlueBFbLW0mhhAyGEqpt,17,42,13,0,8,1,10,1,75,10.714285714285714,2,0.0,13,13,0,8,29,1,0,10,1,34,41,1
8068,105273,eGtLsIjZlkWgWdMhhuLPGoqFtXLYqSzQ,G8EPVSXsOYB5YQWZGiz1aVq5Pgr2GrQu,11,14,8,0,5,0,5,0,32,4.571428571428571,1,0.0,0,8,0,5,14,0,0,5,0,13,19,0
8069,105274,6nb23dYhCIP1cVQ6kR327mxTR7zAmW6A,SpATywNh6bZuzm8s1ceuBUnMUAeoAHHw,15,13,9,3,5,0,3,0,33,4.714285714285714,2,0.0,2,9,3,5,11,0,0,3,0,19,14,1
8070,105289,BRC3IBMyw5vaRtTzcXuOEQUfoXyf29w0,G8EPVSXsOYB5YQWZGiz1aVq5Pgr2GrQu,8,2,1,0,2,0,3,0,8,1.1428571428571428,1,0.0,0,1,0,2,2,0,0,3,0,3,5,1
8071,105306,drUu3tyovHqnF7EAaPHayHDYbWMe2Od6,bWdj2GDclj5ofokWjzoa5jAwMkxCykd6,1,0,0,0,0,0,1,0,1,0.14285714285714285,1,0.0,0,0,0,0,0,0,0,1,0,0,1,1
8072,105322,CSp8QkNZa6B12LzJipxPFgC5w6lKLtbn,SpATywNh6bZuzm8s1ceuBUnMUAeoAHHw,1,0,0,0,0,0,1,0,1,0.14285714285714285,1,0.0,0,0,0,0,0,0,0,1,0,0,1,1
8073,105331,Sk4DUKJRImF6lijTnkABuH01jDj9zcnP,bWdj2GDclj5ofokWjzoa5jAwMkxCykd6,4,5,3,0,0,5,5,0,18,2.5714285714285716,2,0.0,0,3,0,0,5,5,0,5,0,3,15,1
8074,105347,CvSKLBTIxxGXbtAVP0WUmmB2Wsdsb6DU,SpATywNh6bZuzm8s1ceuBUnMUAeoAHHw,10,15,0,16,0,5,3,0,39,5.571428571428571,1,0.0,3,0,14,0,12,5,2,3,0,17,22,0
8075,105360,OWE34kkoT9KAMAmKtdn3UxQ37r5Vj3AT,SpATywNh6bZuzm8s1ceuBUnMUAeoAHHw,7,5,0,0,0,0,2,0,7,1.0,1,0.0,0,0,0,0,5,0,0,2,0,0,7,1
8076,105365,4ReTrx0DPSKofx7nLibnDMfTITGlbh8n,SpATywNh6bZuzm8s1ceuBUnMUAeoAHHw,7,6,3,0,2,0,3,0,14,2.0,2,0.0,0,3,0,2,6,0,0,3,0,5,9,1
8077,105366,dcPEtQ1aJsWPQvIFxgPvwR3ekqBX6ZB0,SpATywNh6bZuzm8s1ceuBUnMUAeoAHHw,1,0,0,0,0,0,1,0,1,0.14285714285714285,1,0.0,0,0,0,0,0,0,0,1,0,0,1,1
8078,105375,4Z0DzzRnG5ol9npBuWMZsHzI0G7yrdgb,SpATywNh6bZuzm8s1ceuBUnMUAeoAHHw,1,0,0,0,0,0,1,0,1,0.14285714285714285,1,0.0,0,0,0,0,0,0,0,1,0,0,1,1
8079,105377,ugyzx2kY0haeVd2DKPlWf2u8TPvIWwdG,SpATywNh6bZuzm8s1ceuBUnMUAeoAHHw,10,8,6,0,3,1,6,1,25,3.5714285714285716,1,0.0,0,6,0,3,8,1,0,6,1,9,16,1
8080,105382,OBVOXM1wUEgaM1Ic1TPHZnmgDHa3Iw3E,SpATywNh6bZuzm8s1ceuBUnMUAeoAHHw,5,2,1,0,1,0,2,0,6,0.8571428571428571,1,0.0,0,1,0,1,2,0,0,2,0,2,4,1
8081,105403,BAyiuAHT9YavjRYUTL3SqAF5fajY78B8,G8EPVSXsOYB5YQWZGiz1aVq5Pgr2GrQu,9,5,4,0,4,0,2,0,15,2.142857142857143,1,0.0,0,4,0,4,5,0,0,2,0,8,7,1
8082,105405,itFrYwUUr3TPc7mZS2RWfo2HaYAcNOxB,SpATywNh6bZuzm8s1ceuBUnMUAeoAHHw,15,13,6,13,4,1,9,0,46,6.571428571428571,1,0.0,4,6,12,4,9,1,1,9,0,26,20,1
8083,105409,vqSgORDp5PsEpveQVJoPh4dnJvR6AQkK,bWdj2GDclj5ofokWjzoa5jAwMkxCykd6,1,0,0,0,0,0,1,0,1,0.14285714285714285,1,0.0,0,0,0,0,0,0,0,1,0,0,1,1
8084,105412,6d0wTeGZDr0ncgCyWQX4AMn46gB2ZbPz,bWdj2GDclj5ofokWjzoa5jAwMkxCykd6,6,2,1,0,1,0,3,0,7,1.0,1,0.0,0,1,0,1,2,0,0,3,0,2,5,1
8085,105413,uTHtFLFEH5oi1Mhz7WcXFhd8fnlKyBlD,SpATywNh6bZuzm8s1ceuBUnMUAeoAHHw,11,10,6,0,4,0,2,0,22,3.142857142857143,1,0.0,1,6,0,4,9,0,0,2,0,11,11,1
8086,105431,7bBbNS8igBUmtAlhgWeyPaLpz7A08m0l,A3fsA9Zfv1X2fVEQhTw51lKENdNrEqT3,6,6,4,0,1,0,4,0,15,2.142857142857143,2,0.0,0,4,0,1,6,0,0,4,0,5,10,1
8087,105432,1cSsz0UCfa4Sky1FhbU6sbIRYsZ41OPL,A3fsA9Zfv1X2fVEQhTw51lKENdNrEqT3,20,28,1,38,0,2,24,4,97,13.857142857142858,1,0.0,0,1,32,0,28,2,6,24,4,33,64,1
8088,105439,jmHt2ZlvXO3qz2cHf72G06suxgziLa3C,A3fsA9Zfv1X2fVEQhTw51lKENdNrEqT3,2,0,0,0,0,0,2,0,2,0.2857142857142857,1,0.0,0,0,0,0,0,0,0,2,0,0,2,1
8089,105445,LdIFMEp4Gma3xMuOQ2mpp1BJ3jFvB9c2,bWdj2GDclj5ofokWjzoa5jAwMkxCykd6,39,69,27,134,9,4,22,0,265,37.857142857142854,9,0.0,15,27,112,9,54,4,22,22,0,163,102,0
8090,105451,1YSmilr2ajm5pFk4iAawwfB3mRapy4GR,bWdj2GDclj5ofokWjzoa5jAwMkxCykd6,4,2,1,0,1,0,1,0,5,0.7142857142857143,1,0.0,0,1,0,1,2,0,0,1,0,2,3,1
8091,105453,FNaEworzG9JIrUWWqoqtljEERNazKuKb,SpATywNh6bZuzm8s1ceuBUnMUAeoAHHw,6,3,1,0,1,0,2,0,7,1.0,1,0.0,0,1,0,1,3,0,0,2,0,2,5,1
8092,105454,EK81RbZoXEDM3g1RV68PHuRhq28X4Rfk,A3fsA9Zfv1X2fVEQhTw51lKENdNrEqT3,5,2,1,0,1,0,2,0,6,0.8571428571428571,1,0.0,0,1,0,1,2,0,0,2,0,2,4,1
8093,105456,P9cYtrIJUSQx41yE7x59h9MgXtuGnnbs,G8EPVSXsOYB5YQWZGiz1aVq5Pgr2GrQu,1,0,0,0,0,0,1,0,1,0.14285714285714285,1,0.0,0,0,0,0,0,0,0,1,0,0,1,1
8094,105464,rc8mOopKEVh5BHf3pFrEDGrzFcNfbS3h,SpATywNh6bZuzm8s1ceuBUnMUAeoAHHw,5,2,1,0,1,0,3,0,7,1.0,2,0.0,0,1,0,1,2,0,0,3,0,2,5,1
8095,105471,DIfj5Ba2axfDE4LFDWqKjVBCgesW8XXW,SpATywNh6bZuzm8s1ceuBUnMUAeoAHHw,12,36,8,0,2,3,8,0,57,8.142857142857142,1,0.0,0,8,0,2,36,3,0,8,0,10,47,1
8096,105479,DRqM6Ff42uz4k14OFxcFjetTXyC12WI7,SpATywNh6bZuzm8s1ceuBUnMUAeoAHHw,9,11,1,7,1,0,4,0,24,3.4285714285714284,2,0.0,0,1,6,1,11,0,1,4,0,8,16,1
8097,105480,RSwFpC1qMeXR2lSJtCkUxC2GY1HkPGdb,SpATywNh6bZuzm8s1ceuBUnMUAeoAHHw,9,10,6,0,3,0,3,0,22,3.142857142857143,2,0.0,1,6,0,3,9,0,0,3,0,10,12,1
8098,105491,QKXQzGYic4FsMmW8FpleZuFU3phntMAt,SpATywNh6bZuzm8s1ceuBUnMUAeoAHHw,8,4,3,0,3,0,1,0,11,1.5714285714285714,1,0.0,0,3,0,3,4,0,0,1,0,6,5,0
8099,105497,ouzFxiP7ljIzym1OgbkkNZsSGwRWOJRH,SpATywNh6bZuzm8s1ceuBUnMUAeoAHHw,5,2,1,0,1,0,2,0,6,0.8571428571428571,1,0.0,0,1,0,1,2,0,0,2,0,2,4,1
8100,105507,3xA82OlUzQ8FfAlTJcvVktSt0q894DXz,A3fsA9Zfv1X2fVEQhTw51lKENdNrEqT3,9,4,3,0,2,0,3,0,12,1.7142857142857142,1,0.0,0,3,0,2,4,0,0,3,0,5,7,1
8101,105513,huQkoBKNhxQg56EbGDFifh0dLnvHtGe7,SpATywNh6bZuzm8s1ceuBUnMUAeoAHHw,30,25,13,16,7,7,10,2,80,11.428571428571429,3,0.0,9,13,15,7,16,7,1,10,2,44,36,1
8102,105514,pb0NolqZsXAL2OR3XPD1zckdYQxFlvNU,SpATywNh6bZuzm8s1ceuBUnMUAeoAHHw,5,2,1,0,1,0,4,0,8,1.1428571428571428,1,0.0,0,1,0,1,2,0,0,4,0,2,6,1
8103,105517,bR55dFOoIQqPJPBvXoxJUIXx5dva0hOC,G8EPVSXsOYB5YQWZGiz1aVq5Pgr2GrQu,9,3,2,0,2,0,4,0,11,1.5714285714285714,1,0.0,0,2,0,2,3,0,0,4,0,4,7,1
8104,105526,dBYXiPq5rGdb4oW5xYaPd7zkgh6w8ny5,SpATywNh6bZuzm8s1ceuBUnMUAeoAHHw,3,3,0,0,0,0,1,0,4,0.5714285714285714,1,0.0,0,0,0,0,3,0,0,1,0,0,4,1
8105,105528,Gs4A8cx631DBKRtaVJfbdm1OgfYfhvQ8,A3fsA9Zfv1X2fVEQhTw51lKENdNrEqT3,2,0,0,0,0,0,2,0,2,0.2857142857142857,1,0.0,0,0,0,0,0,0,0,2,0,0,2,1
8106,105530,yjJ1iNhFO6aUkQdyDFXsvnts4X4TBbt1,G8EPVSXsOYB5YQWZGiz1aVq5Pgr2GrQu,14,8,7,0,6,0,6,1,28,4.0,1,0.0,0,7,0,6,8,0,0,6,1,13,15,1
8107,105532,YBSh2Ce8VFxfjfLxt9dOr0DLrvgLDo3G,SpATywNh6bZuzm8s1ceuBUnMUAeoAHHw,4,3,1,0,1,0,1,0,6,0.8571428571428571,1,0.0,0,1,0,1,3,0,0,1,0,2,4,1
8108,105538,JFR1iuUdFS1mD5BLqLO5DI7ZsHM5MIC6,SpATywNh6bZuzm8s1ceuBUnMUAeoAHHw,2,0,0,0,0,0,2,0,2,0.2857142857142857,1,0.0,0,0,0,0,0,0,0,2,0,0,2,1
8109,105543,JFR1iuUdFS1mD5BLqLO5DI7ZsHM5MIC6,bWdj2GDclj5ofokWjzoa5jAwMkxCykd6,2,0,0,0,0,0,2,0,2,0.2857142857142857,1,0.0,0,0,0,0,0,0,0,2,0,0,2,0
8110,105549,2OnJKTPobGmyM9bjszCwLbDBhhcw3Ptr,SpATywNh6bZuzm8s1ceuBUnMUAeoAHHw,6,4,2,0,1,0,4,0,11,1.5714285714285714,1,0.0,0,2,0,1,4,0,0,4,0,3,8,1
8111,105554,lD9Di3R0D8jVkARIDTv9uHKlPOJul1IJ,RXDvfPUBYFlVdlueBFbLW0mhhAyGEqpt,21,12,10,0,7,1,10,3,43,6.142857142857143,1,0.0,0,10,0,7,12,1,0,10,3,17,26,1
8112,105560,TBhSGbYkj43z5s2FElhR2mY8V29OFGOl,SpATywNh6bZuzm8s1ceuBUnMUAeoAHHw,9,12,4,14,1,8,1,0,40,5.714285714285714,1,0.0,7,4,12,1,5,8,2,1,0,24,16,1
8113,105564,a160ewxyRJdtN45GnX3uGxkLMyeZKvV7,A3fsA9Zfv1X2fVEQhTw51lKENdNrEqT3,5,3,2,0,1,0,1,0,7,1.0,1,0.0,0,2,0,1,3,0,0,1,0,3,4,1
8114,105572,i1rf4Uc8Jyx4GInthodWWBcAxWOUsNY3,SpATywNh6bZuzm8s1ceuBUnMUAeoAHHw,1,0,0,0,0,0,1,0,1,0.14285714285714285,1,0.0,0,0,0,0,0,0,0,1,0,0,1,1
8115,105578,UZSpGopByMz4vpZWWp6YjynYHDg7IDCz,SpATywNh6bZuzm8s1ceuBUnMUAeoAHHw,7,3,0,0,0,1,7,2,13,1.8571428571428572,1,0.0,0,0,0,0,3,1,0,7,2,0,13,1
8116,105596,9U8TB2VVR3SpNOaUoetOaSnkDznyBFBg,G8EPVSXsOYB5YQWZGiz1aVq5Pgr2GrQu,5,3,0,0,0,0,2,0,5,0.7142857142857143,1,0.0,0,0,0,0,3,0,0,2,0,0,5,1
8117,105603,U5SVBnEdwM8cChRjcz152ZJPSF8LRTgS,SpATywNh6bZuzm8s1ceuBUnMUAeoAHHw,17,23,12,15,6,10,4,0,70,10.0,1,0.0,10,12,12,6,13,10,3,4,0,40,30,1
8118,105605,vqN40E2i0C3fLg1fxObrFNN6aBFCAnYS,SpATywNh6bZuzm8s1ceuBUnMUAeoAHHw,4,2,1,0,1,0,1,0,5,0.7142857142857143,1,0.0,0,1,0,1,2,0,0,1,0,2,3,1
8119,105611,Z91ylcCa0QBPuZRAZnN7Bi8KMhEMk84I,G8EPVSXsOYB5YQWZGiz1aVq5Pgr2GrQu,1,0,0,0,0,0,1,0,1,0.14285714285714285,1,0.0,0,0,0,0,0,0,0,1,0,0,1,1
8120,105614,jkI0zARZWQkZpKjEUfCP0wADmuTyrZSB,G8EPVSXsOYB5YQWZGiz1aVq5Pgr2GrQu,5,2,1,0,1,0,2,0,6,0.8571428571428571,1,0.0,0,1,0,1,2,0,0,2,0,2,4,1
8121,105615,yt2gjsEupK8sBRyKpoF6RM4kG7zfvxKC,SpATywNh6bZuzm8s1ceuBUnMUAeoAHHw,30,62,20,33,6,9,16,2,148,21.142857142857142,5,0.0,27,20,32,6,35,9,1,16,2,85,63,0
8122,105618,UR2QSgawy0CjHWh1ilXf2hWdYdvRIm7a,A3fsA9Zfv1X2fVEQhTw51lKENdNrEqT3,1,0,0,0,0,0,1,0,1,0.14285714285714285,1,0.0,0,0,0,0,0,0,0,1,0,0,1,1
8123,105622,jkI0zARZWQkZpKjEUfCP0wADmuTyrZSB,A3fsA9Zfv1X2fVEQhTw51lKENdNrEqT3,12,11,2,0,2,0,4,0,19,2.7142857142857144,1,0.0,0,2,0,2,11,0,0,4,0,4,15,1
8124,105627,5uQhTmVLlxOLiyKyZlkmRhPs99pj5h4D,SpATywNh6bZuzm8s1ceuBUnMUAeoAHHw,7,3,2,0,2,0,2,0,9,1.2857142857142858,1,0.0,0,2,0,2,3,0,0,2,0,4,5,1
8125,105633,No3uaZVX8QfUWi2WuoYFYrVrLQNiuZit,SpATywNh6bZuzm8s1ceuBUnMUAeoAHHw,4,2,1,0,1,0,1,0,5,0.7142857142857143,1,0.0,0,1,0,1,2,0,0,1,0,2,3,1
8126,105634,6YparlTvGntzzoJlcpXRHjZMmqjae5pt,SpATywNh6bZuzm8s1ceuBUnMUAeoAHHw,14,7,5,2,3,7,7,1,32,4.571428571428571,1,0.0,0,5,2,3,7,7,0,7,1,10,22,1
8127,105640,gw3yc6n6VFyWcEZvOt8ZtzcLtuPxALTw,SpATywNh6bZuzm8s1ceuBUnMUAeoAHHw,14,25,11,19,0,21,16,1,93,13.285714285714286,4,0.0,8,11,16,0,17,21,3,16,1,35,58,1
8128,105645,jcprw7R15XocpeKMqxQA9O1OxKgjloTM,SpATywNh6bZuzm8s1ceuBUnMUAeoAHHw,1,0,0,0,0,0,1,0,1,0.14285714285714285,1,0.0,0,0,0,0,0,0,0,1,0,0,1,1
8129,105654,YpnxbgvlHOSkecYk2lPrRwAg5SZiWPmr,A3fsA9Zfv1X2fVEQhTw51lKENdNrEqT3,5,2,1,0,1,0,2,0,6,0.8571428571428571,1,0.0,0,1,0,1,2,0,0,2,0,2,4,1
8130,105668,7KQcIrOp3KoypOTvziMED7rHtDH1CXtE,A3fsA9Zfv1X2fVEQhTw51lKENdNrEqT3,1,0,0,0,0,0,1,0,1,0.14285714285714285,1,0.0,0,0,0,0,0,0,0,1,0,0,1,1
8131,105671,wpA3YODDDsWaFQtfPR7v2M6HEJbcAeIY,SpATywNh6bZuzm8s1ceuBUnMUAeoAHHw,6,8,3,0,1,0,4,0,16,2.2857142857142856,3,0.0,0,3,0,1,8,0,0,4,0,4,12,1
8132,105672,V02ryEmMmqjGIIiLHIkYu0vvVMLeyKKP,A3fsA9Zfv1X2fVEQhTw51lKENdNrEqT3,8,4,2,0,2,0,2,0,10,1.4285714285714286,1,0.0,0,2,0,2,4,0,0,2,0,4,6,1
8133,105677,tbzj7Go70gnZDKKkB7OUY9ROk4h4NATx,bWdj2GDclj5ofokWjzoa5jAwMkxCykd6,6,4,2,0,1,0,4,0,11,1.5714285714285714,1,0.0,0,2,0,1,4,0,0,4,0,3,8,1
8134,105690,dCV7p4dH2mfgkfJtane8atsSzuvj1JQf,bWdj2GDclj5ofokWjzoa5jAwMkxCykd6,1,0,0,0,0,0,1,0,1,0.14285714285714285,1,0.0,0,0,0,0,0,0,0,1,0,0,1,1
8135,105699,hBWZaknNj3MZUvkhj5xTqflV3rTd1l4t,bWdj2GDclj5ofokWjzoa5jAwMkxCykd6,2,0,0,0,0,0,2,0,2,0.2857142857142857,1,0.0,0,0,0,0,0,0,0,2,0,0,2,1
8136,105703,xePykhVJ0RKvBcesQ9TJJOkbxCOkEY1s,SpATywNh6bZuzm8s1ceuBUnMUAeoAHHw,4,0,0,0,0,3,3,0,6,0.8571428571428571,2,0.0,0,0,0,0,0,3,0,3,0,0,6,1
8137,105706,Higp7tL2evAdDfwxJ7Fv3MD5xI1FILhG,G8EPVSXsOYB5YQWZGiz1aVq5Pgr2GrQu,1,0,0,0,0,0,1,0,1,0.14285714285714285,1,0.0,0,0,0,0,0,0,0,1,0,0,1,1
8138,105707,YXw4AHOHrgMAyUR11Z0AMDwuHnZeqZI7,G8EPVSXsOYB5YQWZGiz1aVq5Pgr2GrQu,5,2,1,0,1,0,2,0,6,0.8571428571428571,1,0.0,0,1,0,1,2,0,0,2,0,2,4,1
8139,105713,RHNP6ku8FrLIdJ9UJ6RZ5wmeyQgTyWsO,A3fsA9Zfv1X2fVEQhTw51lKENdNrEqT3,1,0,0,0,0,0,2,0,2,0.2857142857142857,1,0.0,0,0,0,0,0,0,0,2,0,0,2,1
8140,105729,EhHrinjt1AkEWC09AFZwBuP61S5NJgjn,7GRhBDsirIGkRZBtSMEzNTyDr2JQm4xx,28,57,2,20,0,4,6,0,89,12.714285714285714,1,0.0,22,2,13,0,35,4,7,6,0,37,52,1
8141,105731,IG8NI5PgTAnRqVnVRaFxoKgrZHc8y65q,7GRhBDsirIGkRZBtSMEzNTyDr2JQm4xx,1,0,0,0,0,0,1,0,1,0.14285714285714285,1,0.0,0,0,0,0,0,0,0,1,0,0,1,1
8142,105736,r0ZdlKlEsmKZY094aSTCPxTKx82Pv4jZ,7GRhBDsirIGkRZBtSMEzNTyDr2JQm4xx,3,2,1,0,0,0,1,0,4,0.5714285714285714,1,0.0,0,1,0,0,2,0,0,1,0,1,3,1
8143,105746,szmVnhPypUPoSdN8Z8D02a6M8Gjrnwmf,7GRhBDsirIGkRZBtSMEzNTyDr2JQm4xx,7,5,3,0,2,0,2,0,12,1.7142857142857142,2,0.0,0,3,0,2,5,0,0,2,0,5,7,1
8144,105767,mjObtvp4vmduPSr2e6gxrQuYRjgGF8wF,7GRhBDsirIGkRZBtSMEzNTyDr2JQm4xx,22,42,12,36,6,7,7,1,111,15.857142857142858,3,0.0,26,12,32,6,16,7,4,7,1,76,35,0
8145,105784,QDpN8D19Mr8RZumTONWpZNlCWcHCCTbH,7GRhBDsirIGkRZBtSMEzNTyDr2JQm4xx,5,2,1,0,1,0,5,0,9,1.2857142857142858,1,0.0,0,1,0,1,2,0,0,5,0,2,7,1
8146,105836,67qAsD8gffFwGGRYP2VtVSy5y3Ookejk,7GRhBDsirIGkRZBtSMEzNTyDr2JQm4xx,7,3,2,0,2,0,2,0,9,1.2857142857142858,1,0.0,0,2,0,2,3,0,0,2,0,4,5,1
8147,105879,CkUOqtA27OCG1GaoeglcnLgN2xB1KvvL,7GRhBDsirIGkRZBtSMEzNTyDr2JQm4xx,2,0,0,0,0,0,2,0,2,0.2857142857142857,1,0.0,0,0,0,0,0,0,0,2,0,0,2,1
8148,105990,V1VqVvaNADQhdwUg7X6GrtUrah1AYvnF,7GRhBDsirIGkRZBtSMEzNTyDr2JQm4xx,6,4,0,0,0,0,6,0,10,1.4285714285714286,2,0.0,0,0,0,0,4,0,0,6,0,0,10,1
8149,106003,wwh7y5mxviojWrVEvWbfoKIYQ3Sgn2tu,7GRhBDsirIGkRZBtSMEzNTyDr2JQm4xx,6,4,1,0,1,0,3,0,9,1.2857142857142858,2,0.0,0,1,0,1,4,0,0,3,0,2,7,1
8150,106004,ZPzO2Jq9MyhQSTfjOYO9iqzdnziVzHhF,7GRhBDsirIGkRZBtSMEzNTyDr2JQm4xx,19,29,12,8,6,0,8,0,63,9.0,2,0.0,12,12,7,6,17,0,1,8,0,37,26,1
8151,106010,VLqeHUMgi9PQ3Cs8paSU7gHzDiYDPzML,7GRhBDsirIGkRZBtSMEzNTyDr2JQm4xx,5,2,1,0,1,0,2,0,6,0.8571428571428571,1,0.0,0,1,0,1,2,0,0,2,0,2,4,1
8152,106019,UBfqapbt41rZhlFda9dIX0sXKEHUoNRR,7GRhBDsirIGkRZBtSMEzNTyDr2JQm4xx,1,0,0,0,0,0,1,0,1,0.14285714285714285,1,0.0,0,0,0,0,0,0,0,1,0,0,1,1
8153,106408,3C0RNflDAI8FmTdsE1mhjUkpDZ4xUri7,SpATywNh6bZuzm8s1ceuBUnMUAeoAHHw,1,0,0,0,0,0,1,0,1,0.14285714285714285,1,0.0,0,0,0,0,0,0,0,1,0,0,1,1
8154,106434,i6H5zxz2U3b7Stgpyc7yvkBTJYyhoQYo,SpATywNh6bZuzm8s1ceuBUnMUAeoAHHw,11,12,1,10,1,0,2,0,26,3.7142857142857144,1,0.0,7,1,8,1,5,0,2,2,0,17,9,1
8155,106443,t3vj4r7JOWedUjNWDPc1a4izv1Cmnqwm,RXDvfPUBYFlVdlueBFbLW0mhhAyGEqpt,13,10,2,28,2,0,3,0,45,6.428571428571429,2,0.0,6,2,26,2,4,0,2,3,0,36,9,1
8156,106591,rxfzVJVj4XNymQN7SX1pdLUM549NCrW7,SpATywNh6bZuzm8s1ceuBUnMUAeoAHHw,6,9,5,0,1,0,6,0,21,3.0,4,0.0,0,5,0,1,9,0,0,6,0,6,15,0
8157,106650,GebdA7Vo87ReyKP2A7BXi3CttXQIgfXb,SpATywNh6bZuzm8s1ceuBUnMUAeoAHHw,5,3,1,0,0,0,4,0,8,1.1428571428571428,1,0.0,0,1,0,0,3,0,0,4,0,1,7,1
8158,106655,5r9OEsSFtsP3T0AQQIuWD6ouO08AmGp2,bWdj2GDclj5ofokWjzoa5jAwMkxCykd6,7,8,1,0,2,0,2,0,13,1.8571428571428572,1,0.0,2,1,0,2,6,0,0,2,0,5,8,1
8159,106698,AuIQbwKCl1rpgmIzQXLySneETBtGUcy9,SpATywNh6bZuzm8s1ceuBUnMUAeoAHHw,12,24,3,0,4,0,3,0,34,4.857142857142857,3,0.0,6,3,0,4,18,0,0,3,0,13,21,1
8160,106710,2sYGHfb0Gpw1ITIdkhTs2jjyBEZU4HAF,SpATywNh6bZuzm8s1ceuBUnMUAeoAHHw,4,2,0,0,0,0,4,0,6,0.8571428571428571,1,0.0,0,0,0,0,2,0,0,4,0,0,6,1
8161,106724,LBz8eebDA0q3o7gWfqXlzvsHwwqTUJzd,SpATywNh6bZuzm8s1ceuBUnMUAeoAHHw,7,14,0,0,0,0,3,1,18,2.5714285714285716,1,0.0,0,0,0,0,14,0,0,3,1,0,18,0
8162,106853,DSkyPIUtT8xxP5Yu1DrvohPZBHHgxJAD,SpATywNh6bZuzm8s1ceuBUnMUAeoAHHw,2,0,0,0,0,0,2,0,2,0.2857142857142857,1,0.0,0,0,0,0,0,0,0,2,0,0,2,1
8163,106858,wwFNSVNavy53ZZLg1TQ0hM4pFCmqfiLF,A3fsA9Zfv1X2fVEQhTw51lKENdNrEqT3,5,2,1,0,1,0,3,0,7,1.0,1,0.0,0,1,0,1,2,0,0,3,0,2,5,0
8164,106906,myNTp931AmSPRA2kl8memATVLQzx4fxs,SpATywNh6bZuzm8s1ceuBUnMUAeoAHHw,11,11,3,8,0,0,3,0,25,3.5714285714285716,1,0.0,5,3,8,0,6,0,0,3,0,16,9,1
8165,106940,NKTsGtocSBmn1p0LL8TfbQ17Oh6XvCt3,SpATywNh6bZuzm8s1ceuBUnMUAeoAHHw,14,48,3,27,0,71,23,4,176,25.142857142857142,7,0.0,19,3,21,0,29,71,6,23,4,43,133,0
8166,106955,wMYwbasBu7kj6nAVyuyEqjGmi3ogAq0E,SpATywNh6bZuzm8s1ceuBUnMUAeoAHHw,9,9,6,0,4,0,2,0,21,3.0,1,0.0,0,6,0,4,9,0,0,2,0,10,11,1
8167,106991,foZomfeiH5mdSFjeB6umSt6lwP9hfSDR,A3fsA9Zfv1X2fVEQhTw51lKENdNrEqT3,2,0,0,0,0,0,4,0,4,0.5714285714285714,1,0.0,0,0,0,0,0,0,0,4,0,0,4,1
8168,107974,dtVsNki5zywoboI6DGdzIRSljGsEQsRE,SpATywNh6bZuzm8s1ceuBUnMUAeoAHHw,7,6,1,0,1,0,3,0,11,1.5714285714285714,1,0.0,0,1,0,1,6,0,0,3,0,2,9,1
8169,107980,lOPfkJTjHU0xkFfC9CIvobXcPYmnNHom,SpATywNh6bZuzm8s1ceuBUnMUAeoAHHw,15,22,14,10,4,0,9,0,59,8.428571428571429,2,0.0,4,14,9,4,18,0,1,9,0,31,28,0
8170,107985,3zcQqBSlndQvb088xX2bWzjwjrK9gGXb,SpATywNh6bZuzm8s1ceuBUnMUAeoAHHw,13,23,0,21,0,2,4,0,50,7.142857142857143,1,0.0,6,0,20,0,17,2,1,4,0,26,24,1
8171,107989,ilWzYGLWBh9DSc1MV8g2C4Go5wDNgUHX,RXDvfPUBYFlVdlueBFbLW0mhhAyGEqpt,1,0,0,0,0,0,1,0,1,0.14285714285714285,1,0.0,0,0,0,0,0,0,0,1,0,0,1,1
8172,108004,6oCIsm9feSmMCAtwRcz7U3xMlVdQPmgW,SpATywNh6bZuzm8s1ceuBUnMUAeoAHHw,6,3,1,0,1,0,2,0,7,1.0,1,0.0,0,1,0,1,3,0,0,2,0,2,5,1
8173,108008,7JBtUpIhUnYCA4q3ae7hJoTZvMtE4cUd,SpATywNh6bZuzm8s1ceuBUnMUAeoAHHw,21,44,10,3,5,1,11,1,75,10.714285714285714,5,0.0,2,10,3,5,42,1,0,11,1,20,55,1
8174,108022,PouZmZXexxytkMLV0zJhqCjIk5MXfiuJ,SpATywNh6bZuzm8s1ceuBUnMUAeoAHHw,17,18,7,21,4,17,6,2,75,10.714285714285714,1,0.0,8,7,17,4,10,17,4,6,2,36,39,1
8175,108028,bDxjtNxv0fWJdWWEfRKEUv4YBma9IgaW,SpATywNh6bZuzm8s1ceuBUnMUAeoAHHw,15,18,8,18,4,5,12,1,66,9.428571428571429,2,0.0,4,8,16,4,14,5,2,12,1,32,34,1
8176,108043,e2g6ypvlbdTJJDNt2jr7tkCU179qUmrV,SpATywNh6bZuzm8s1ceuBUnMUAeoAHHw,1,0,0,0,0,0,1,0,1,0.14285714285714285,1,0.0,0,0,0,0,0,0,0,1,0,0,1,1
8177,108056,P6v79AbA8JNvvK6UNaNGagvsf7jk48sR,SpATywNh6bZuzm8s1ceuBUnMUAeoAHHw,5,2,1,0,1,0,2,0,6,0.8571428571428571,1,0.0,0,1,0,1,2,0,0,2,0,2,4,1
8178,108059,YHlbNc2DvzqJVtSUhFFwHv9LTYvtn9Mw,RXDvfPUBYFlVdlueBFbLW0mhhAyGEqpt,1,0,0,0,0,0,2,0,2,0.2857142857142857,1,0.0,0,0,0,0,0,0,0,2,0,0,2,1
8179,108063,FLuCisP22zuNYM50DiHloNWfjCL7Trqn,SpATywNh6bZuzm8s1ceuBUnMUAeoAHHw,7,7,2,0,1,0,3,0,13,1.8571428571428572,2,0.0,0,2,0,1,7,0,0,3,0,3,10,1
8180,108066,biPbQQgRZQFKOAVcr8zCs5vcz2Zp7TtR,SpATywNh6bZuzm8s1ceuBUnMUAeoAHHw,6,5,3,0,2,0,3,0,13,1.8571428571428572,1,0.0,0,3,0,2,5,0,0,3,0,5,8,1
8181,108067,7LgsB1Dbs9AWbCH4Qtqx9aZFnEle1djD,A3fsA9Zfv1X2fVEQhTw51lKENdNrEqT3,6,3,0,0,0,0,5,0,8,1.1428571428571428,1,0.0,0,0,0,0,3,0,0,5,0,0,8,1
8182,108068,521YJDVy6G9ul5QyLTUZAuztPLpe7gqW,A3fsA9Zfv1X2fVEQhTw51lKENdNrEqT3,8,4,2,0,0,4,10,0,20,2.857142857142857,1,0.0,1,2,0,0,3,4,0,10,0,3,17,1
8183,108075,EboqTOLce3Kcnbr13rePsINEM3noHrcD,A3fsA9Zfv1X2fVEQhTw51lKENdNrEqT3,39,18,12,62,8,29,6,0,135,19.285714285714285,3,0.0,3,12,55,8,15,29,7,6,0,78,57,1
8184,108077,aiXR63FJxLzLjxOw200I9QHjcVwt5TEN,RXDvfPUBYFlVdlueBFbLW0mhhAyGEqpt,1,0,0,0,0,0,1,0,1,0.14285714285714285,1,0.0,0,0,0,0,0,0,0,1,0,0,1,1
8185,108080,KMcnmZ5Os9sw6KyJ7BWURh6K8QGi1wsV,bWdj2GDclj5ofokWjzoa5jAwMkxCykd6,8,6,1,0,2,0,3,0,12,1.7142857142857142,1,0.0,2,1,0,2,4,0,0,3,0,5,7,1
8186,108086,3pgK06P2oLAcnmiNZRznn0B0EGmUgMOP,SpATywNh6bZuzm8s1ceuBUnMUAeoAHHw,6,9,3,0,1,0,4,0,17,2.4285714285714284,1,0.0,0,3,0,1,9,0,0,4,0,4,13,1
8187,108100,KYKzKpnBUYOr84PudAmq8tNzhwmTGrJ8,A3fsA9Zfv1X2fVEQhTw51lKENdNrEqT3,10,5,3,0,2,1,6,1,18,2.5714285714285716,1,0.0,0,3,0,2,5,1,0,6,1,5,13,1
8188,108102,7aA6BrVZipLHOrozlrYBMEmfMq4MXahq,SpATywNh6bZuzm8s1ceuBUnMUAeoAHHw,4,6,0,0,0,0,2,0,8,1.1428571428571428,1,0.0,0,0,0,0,6,0,0,2,0,0,8,1
8189,108103,2jvZGTQOv5HI5u69PvJ98o1zG3YXhtLw,SpATywNh6bZuzm8s1ceuBUnMUAeoAHHw,12,12,4,11,2,1,2,0,32,4.571428571428571,1,0.0,6,4,10,2,6,1,1,2,0,22,10,1
8190,108114,sgggYhWjUONtSvJl6cytWZyV2XJXwrfv,RXDvfPUBYFlVdlueBFbLW0mhhAyGEqpt,1,0,0,0,0,0,1,0,1,0.14285714285714285,1,0.0,0,0,0,0,0,0,0,1,0,0,1,1
8191,108117,dpzYaESA6MCFHXGYe2bLHvSr1kNOP50p,bWdj2GDclj5ofokWjzoa5jAwMkxCykd6,1,0,0,0,0,0,1,0,1,0.14285714285714285,1,0.0,0,0,0,0,0,0,0,1,0,0,1,1
8192,108124,dpzYaESA6MCFHXGYe2bLHvSr1kNOP50p,RXDvfPUBYFlVdlueBFbLW0mhhAyGEqpt,1,0,0,0,0,0,1,0,1,0.14285714285714285,1,0.0,0,0,0,0,0,0,0,1,0,0,1,1
8193,108126,5vV5bz7iJVuZlu434ocQi0K0Vkr9Mwnk,bWdj2GDclj5ofokWjzoa5jAwMkxCykd6,4,2,0,0,0,0,4,0,6,0.8571428571428571,1,0.0,0,0,0,0,2,0,0,4,0,0,6,1
8194,108129,5vV5bz7iJVuZlu434ocQi0K0Vkr9Mwnk,A3fsA9Zfv1X2fVEQhTw51lKENdNrEqT3,2,0,0,0,0,0,3,0,3,0.42857142857142855,1,0.0,0,0,0,0,0,0,0,3,0,0,3,1
8195,108132,2w4cE1JaIeIFAZaP4jTngJpTehNnFzsI,G8EPVSXsOYB5YQWZGiz1aVq5Pgr2GrQu,4,2,0,0,0,0,2,0,4,0.5714285714285714,1,0.0,0,0,0,0,2,0,0,2,0,0,4,0
8196,108137,wKzEabDf6tGdNdSmhgTmVPwzaHM3HdDm,bWdj2GDclj5ofokWjzoa5jAwMkxCykd6,1,0,0,0,0,0,1,0,1,0.14285714285714285,1,0.0,0,0,0,0,0,0,0,1,0,0,1,1
8197,108140,wKzEabDf6tGdNdSmhgTmVPwzaHM3HdDm,A3fsA9Zfv1X2fVEQhTw51lKENdNrEqT3,1,0,0,0,0,0,1,0,1,0.14285714285714285,1,0.0,0,0,0,0,0,0,0,1,0,0,1,1
8198,108154,hbTx2HlAPaSfk5EORjF7ocOSpDhWinaD,G8EPVSXsOYB5YQWZGiz1aVq5Pgr2GrQu,8,16,8,0,5,0,14,0,43,6.142857142857143,3,0.0,2,8,0,5,14,0,0,14,0,15,28,0
8199,108178,vz93ZdWSu0NWsoHKFr8vIf7NHeIpZbfP,bWdj2GDclj5ofokWjzoa5jAwMkxCykd6,7,3,2,0,2,0,2,0,9,1.2857142857142858,1,0.0,0,2,0,2,3,0,0,2,0,4,5,1
8200,108187,TSPlBwReynnjQ2q72CnYFjLp85rX76cJ,A3fsA9Zfv1X2fVEQhTw51lKENdNrEqT3,2,0,0,0,0,0,2,0,2,0.2857142857142857,1,0.0,0,0,0,0,0,0,0,2,0,0,2,1
8201,108190,bGjzMxOC88rUacNGu6kshAaxdH2zKDK7,A3fsA9Zfv1X2fVEQhTw51lKENdNrEqT3,6,9,0,0,0,0,1,0,10,1.4285714285714286,1,0.0,0,0,0,0,9,0,0,1,0,0,10,1
8202,108213,zrXVmAXKkFc8iiWu8fCjaRvDc9MMQT2x,SpATywNh6bZuzm8s1ceuBUnMUAeoAHHw,4,2,1,0,1,0,1,0,5,0.7142857142857143,1,0.0,0,1,0,1,2,0,0,1,0,2,3,1
8203,108217,6In9aidJiz35UAmMIZUhwjQpPpqW4IPc,A3fsA9Zfv1X2fVEQhTw51lKENdNrEqT3,4,3,1,0,0,0,4,0,8,1.1428571428571428,1,0.0,0,1,0,0,3,0,0,4,0,1,7,1
8204,108228,6In9aidJiz35UAmMIZUhwjQpPpqW4IPc,bWdj2GDclj5ofokWjzoa5jAwMkxCykd6,2,0,0,0,0,0,2,0,2,0.2857142857142857,1,0.0,0,0,0,0,0,0,0,2,0,0,2,1
8205,108235,uGnwUJpu1DKiWsVPpyszxZyMbYFsrVu7,SpATywNh6bZuzm8s1ceuBUnMUAeoAHHw,10,9,3,11,2,4,2,0,31,4.428571428571429,1,0.0,5,3,11,2,4,4,0,2,0,21,10,0
8206,108247,JVwYgpbMnhyXKC0xUgsIj4AIloKjDOV1,A3fsA9Zfv1X2fVEQhTw51lKENdNrEqT3,4,2,0,0,0,2,3,0,7,1.0,2,0.0,0,0,0,0,2,2,0,3,0,0,7,1
8207,108251,Exf9rFmbTdsimBjbWioKYnQ8NgdvC5jd,RXDvfPUBYFlVdlueBFbLW0mhhAyGEqpt,8,9,1,0,0,0,1,0,11,1.5714285714285714,1,0.0,0,1,0,0,9,0,0,1,0,1,10,1
8208,108256,D6COhDGqanxSpN5gApKicTTjeA66WqVe,SpATywNh6bZuzm8s1ceuBUnMUAeoAHHw,1,0,0,0,0,0,1,0,1,0.14285714285714285,1,0.0,0,0,0,0,0,0,0,1,0,0,1,1
8209,108262,BKTGezJoHjleu4tXARXtOL0EOZtL4wb9,bWdj2GDclj5ofokWjzoa5jAwMkxCykd6,9,11,5,0,3,0,2,0,21,3.0,3,0.0,0,5,0,3,11,0,0,2,0,8,13,1
8210,108283,hmtOqZVjWQ6rLJb3YkFWytQIy20ogszh,A3fsA9Zfv1X2fVEQhTw51lKENdNrEqT3,5,2,1,0,1,0,3,0,7,1.0,1,0.0,0,1,0,1,2,0,0,3,0,2,5,1
8211,108289,uidhjEbrao8Ccg3eBjaALRRkH9i692Ay,RXDvfPUBYFlVdlueBFbLW0mhhAyGEqpt,1,0,0,0,0,0,1,0,1,0.14285714285714285,1,0.0,0,0,0,0,0,0,0,1,0,0,1,1
8212,108291,KEDl5eQRZ3KXdMwf0omOM9Nnx9xLsQXi,SpATywNh6bZuzm8s1ceuBUnMUAeoAHHw,4,2,0,0,0,0,3,0,5,0.7142857142857143,1,0.0,0,0,0,0,2,0,0,3,0,0,5,1
8213,108292,uux8SuQRwPqDOuP8QlaB5wBQy6rHdvqS,SpATywNh6bZuzm8s1ceuBUnMUAeoAHHw,5,3,1,0,1,4,2,0,11,1.5714285714285714,1,0.0,0,1,0,1,3,4,0,2,0,2,9,1
8214,108301,cLfffYpPluVkrQWrGySOJC5E8Pia7HHf,A3fsA9Zfv1X2fVEQhTw51lKENdNrEqT3,2,0,0,0,0,0,2,0,2,0.2857142857142857,1,0.0,0,0,0,0,0,0,0,2,0,0,2,1
8215,108307,dbPMzxs1MK4eXxSu7capyuymr7qmuT7h,G8EPVSXsOYB5YQWZGiz1aVq5Pgr2GrQu,8,14,5,0,4,0,4,0,27,3.857142857142857,1,0.0,0,5,0,4,14,0,0,4,0,9,18,1
8216,108319,yVtzjNm7Xgz14yjopuLvCh7VRZR9RBra,A3fsA9Zfv1X2fVEQhTw51lKENdNrEqT3,5,0,0,0,0,6,8,0,14,2.0,1,0.0,0,0,0,0,0,6,0,8,0,0,14,1
8217,108328,xzsuu7TKRpeInAyJlxSvMP3hCrOSGC3q,G8EPVSXsOYB5YQWZGiz1aVq5Pgr2GrQu,7,6,2,0,2,0,4,0,14,2.0,1,0.0,3,2,0,2,3,0,0,4,0,7,7,1
8218,108342,LWnw8PqIiH64F1iHRbOem9hLLYoUuhVp,SpATywNh6bZuzm8s1ceuBUnMUAeoAHHw,1,0,0,0,0,0,1,0,1,0.14285714285714285,1,0.0,0,0,0,0,0,0,0,1,0,0,1,1
8219,108349,YbIRWz7aGoZEJGOL5qUEZpXGM6vHAAAA,SpATywNh6bZuzm8s1ceuBUnMUAeoAHHw,7,3,2,0,2,0,2,0,9,1.2857142857142858,1,0.0,0,2,0,2,3,0,0,2,0,4,5,1
8220,108363,LSAqQ9qRJ6IA5mDIPLRj3aw5O17rNapz,SpATywNh6bZuzm8s1ceuBUnMUAeoAHHw,4,3,0,0,0,0,1,0,4,0.5714285714285714,1,0.0,0,0,0,0,3,0,0,1,0,0,4,1
8221,108369,ZelBFCiIf4nT2uZgj3xzub7opPstKtrk,SpATywNh6bZuzm8s1ceuBUnMUAeoAHHw,1,0,0,0,0,0,1,0,1,0.14285714285714285,1,0.0,0,0,0,0,0,0,0,1,0,0,1,1
8222,108382,GibLcUgLW0dAKrvBvyjm1UI7aEhY2EYI,SpATywNh6bZuzm8s1ceuBUnMUAeoAHHw,7,7,5,0,3,0,5,0,20,2.857142857142857,1,0.0,0,5,0,3,7,0,0,5,0,8,12,1
8223,108383,dgp1qm7PjXoVV4MjyzuvWetQrJ3T9kos,SpATywNh6bZuzm8s1ceuBUnMUAeoAHHw,1,0,0,0,0,0,1,0,1,0.14285714285714285,1,0.0,0,0,0,0,0,0,0,1,0,0,1,1
8224,108384,HErgZ4jawN9YK19iQGOcyzXBTFaOouqG,bWdj2GDclj5ofokWjzoa5jAwMkxCykd6,7,4,3,0,3,0,2,0,12,1.7142857142857142,1,0.0,0,3,0,3,4,0,0,2,0,6,6,1
8225,108386,eBckG9AVr6bIBOpezfRr2S1KzQMM7OtD,G8EPVSXsOYB5YQWZGiz1aVq5Pgr2GrQu,21,31,20,0,12,8,9,1,81,11.571428571428571,3,0.0,0,20,0,12,31,8,0,9,1,32,49,0
8226,108388,M5VVteWQySX3L3J4dk5RJz0FGibCUyC6,SpATywNh6bZuzm8s1ceuBUnMUAeoAHHw,1,0,0,0,0,0,2,0,2,0.2857142857142857,1,0.0,0,0,0,0,0,0,0,2,0,0,2,1
8227,108444,slbuLFnaQZJ34dE8jfJqWtRl7JJLBe8u,SpATywNh6bZuzm8s1ceuBUnMUAeoAHHw,8,7,4,0,2,0,3,0,16,2.2857142857142856,1,0.0,0,4,0,2,7,0,0,3,0,6,10,1
8228,108472,AVjxFBCViTyDwpTqU42MWgJe18swM9dv,A3fsA9Zfv1X2fVEQhTw51lKENdNrEqT3,1,0,0,0,0,0,1,0,1,0.14285714285714285,1,0.0,0,0,0,0,0,0,0,1,0,0,1,1
8229,108477,0utD2vP6cBRtrip5Htxbgl8CGlMSWQLX,bWdj2GDclj5ofokWjzoa5jAwMkxCykd6,7,4,1,0,2,31,5,0,43,6.142857142857143,1,0.0,3,1,0,2,1,31,0,5,0,6,37,1
8230,108489,HBfe50okXo4yGURKfz5xhaX3ToIkoF7Q,A3fsA9Zfv1X2fVEQhTw51lKENdNrEqT3,46,48,23,61,12,20,11,1,176,25.142857142857142,2,0.0,1,23,51,12,47,20,10,11,1,87,89,1
8231,108497,FtVfxMAHOJCihrndIwrct9vQdb6Q44Wo,A3fsA9Zfv1X2fVEQhTw51lKENdNrEqT3,6,0,0,0,0,1,12,2,15,2.142857142857143,1,0.0,0,0,0,0,0,1,0,12,2,0,15,1
8232,108502,DfCpxv5XAI5uu8kT5xePLzsIgRboevuL,bWdj2GDclj5ofokWjzoa5jAwMkxCykd6,4,2,0,0,0,1,4,0,7,1.0,1,0.0,0,0,0,0,2,1,0,4,0,0,7,1
8233,108527,zbpyeHVfqJFGdhXASTaYNBrzQldiaNac,RXDvfPUBYFlVdlueBFbLW0mhhAyGEqpt,1,0,0,0,0,0,1,0,1,0.14285714285714285,1,0.0,0,0,0,0,0,0,0,1,0,0,1,1
8234,108530,vZzTgGwK0cR24BSm1xzdfANP52hj4iMk,SpATywNh6bZuzm8s1ceuBUnMUAeoAHHw,2,0,0,0,0,0,2,0,2,0.2857142857142857,1,0.0,0,0,0,0,0,0,0,2,0,0,2,1
8235,108537,CZVgFr3TEx4eVQgnanHCgaKUvWrCxqq0,bWdj2GDclj5ofokWjzoa5jAwMkxCykd6,1,0,0,0,0,0,1,0,1,0.14285714285714285,1,0.0,0,0,0,0,0,0,0,1,0,0,1,1
8236,108561,cJebZdZYNfcRFrDILULKtUjsVZucvQNZ,bWdj2GDclj5ofokWjzoa5jAwMkxCykd6,1,0,0,0,0,0,1,0,1,0.14285714285714285,1,0.0,0,0,0,0,0,0,0,1,0,0,1,1
8237,108566,ojqlaWuS8RKsQp5vm29IP0i1rlepDfW4,SpATywNh6bZuzm8s1ceuBUnMUAeoAHHw,9,7,3,0,1,0,5,0,16,2.2857142857142856,2,0.0,0,3,0,1,7,0,0,5,0,4,12,1
8238,108579,CppQWIoYRvNJi8vbZRpDyWKb0nwHtu8o,SpATywNh6bZuzm8s1ceuBUnMUAeoAHHw,8,9,3,0,1,0,3,0,16,2.2857142857142856,1,0.0,0,3,0,1,9,0,0,3,0,4,12,1
8239,108586,zGoXWftPbgMoerOVXBTD4diPBqy753pp,SpATywNh6bZuzm8s1ceuBUnMUAeoAHHw,14,16,8,11,0,2,10,1,48,6.857142857142857,2,0.0,4,8,10,0,12,2,1,10,1,22,26,1
8240,108588,anqtRE1JbVfWjk9aVYgpNXBcTCoFe9WO,RXDvfPUBYFlVdlueBFbLW0mhhAyGEqpt,1,0,0,0,0,0,2,0,2,0.2857142857142857,2,0.0,0,0,0,0,0,0,0,2,0,0,2,1
8241,108598,imxSDm2buzZ62mNMbQHQ2TU94JYpOhZs,A3fsA9Zfv1X2fVEQhTw51lKENdNrEqT3,2,0,0,0,0,0,2,0,2,0.2857142857142857,1,0.0,0,0,0,0,0,0,0,2,0,0,2,1
8242,108606,l1knNMDAAaNYCbUzngkK8zi8ibAxSEhp,SpATywNh6bZuzm8s1ceuBUnMUAeoAHHw,1,0,0,0,0,0,1,0,1,0.14285714285714285,1,0.0,0,0,0,0,0,0,0,1,0,0,1,1
8243,108614,QNTRCRLtlkIMOKaNSTyyYSuzmrMmUnRO,SpATywNh6bZuzm8s1ceuBUnMUAeoAHHw,11,12,1,17,0,0,2,0,32,4.571428571428571,1,0.0,2,1,14,0,10,0,3,2,0,17,15,1
8244,108616,9Em7ZIIQKauUvueNLPgAUpkXgxbNUW1r,A3fsA9Zfv1X2fVEQhTw51lKENdNrEqT3,16,17,7,0,6,0,6,0,36,5.142857142857143,1,0.0,0,7,0,6,17,0,0,6,0,13,23,1
8245,108620,5USBnLyMGXd4vW6kBwxN1Sg97co2qZq2,A3fsA9Zfv1X2fVEQhTw51lKENdNrEqT3,3,2,0,0,0,0,2,0,4,0.5714285714285714,1,0.0,0,0,0,0,2,0,0,2,0,0,4,1
8246,108622,QBPT1uwial7Y5XFWw81ordtuhoTMulQT,A3fsA9Zfv1X2fVEQhTw51lKENdNrEqT3,10,4,3,0,3,0,6,0,16,2.2857142857142856,1,0.0,0,3,0,3,4,0,0,6,0,6,10,1
8247,108623,vvgFtJK0OvK0nLiIcreYLk1PpU7Og3xn,A3fsA9Zfv1X2fVEQhTw51lKENdNrEqT3,6,1,1,0,1,0,5,0,8,1.1428571428571428,1,0.0,0,1,0,1,1,0,0,5,0,2,6,1
8248,108625,hi6YD0ZFgzDW7d6YNZOEVbYcZq8RBo6y,G8EPVSXsOYB5YQWZGiz1aVq5Pgr2GrQu,10,7,4,0,5,0,5,1,22,3.142857142857143,1,0.0,2,4,0,5,5,0,0,5,1,11,11,1
8249,108626,Pku6n7JNFwWSrlmN4ke1wEsgtvibhHUB,SpATywNh6bZuzm8s1ceuBUnMUAeoAHHw,7,4,1,0,1,0,3,0,9,1.2857142857142858,1,0.0,0,1,0,1,4,0,0,3,0,2,7,1
8250,108632,KCAa0nKBsiapAJL8hF3jy3WnrDUcaBRF,A3fsA9Zfv1X2fVEQhTw51lKENdNrEqT3,1,0,0,0,0,0,6,0,6,0.8571428571428571,1,0.0,0,0,0,0,0,0,0,6,0,0,6,1
8251,108646,WEWYd7NOLi6QToOgocTwXHUAGlncS3ka,A3fsA9Zfv1X2fVEQhTw51lKENdNrEqT3,6,7,1,0,1,0,3,0,12,1.7142857142857142,1,0.0,0,1,0,1,7,0,0,3,0,2,10,1
8252,108649,3R8N615p99BGAZXNRR4tu9I4dMAzyaYx,SpATywNh6bZuzm8s1ceuBUnMUAeoAHHw,10,6,6,0,6,0,3,0,21,3.0,1,0.0,0,6,0,6,6,0,0,3,0,12,9,1
8253,108651,LWFByRJk3azFmQgQM4UimOOGLsmXN342,A3fsA9Zfv1X2fVEQhTw51lKENdNrEqT3,1,0,0,0,0,0,3,0,3,0.42857142857142855,1,0.0,0,0,0,0,0,0,0,3,0,0,3,1
8254,108657,TxKyOi1lNIjE6GBf0G1VUEkgRaSNv5aU,bWdj2GDclj5ofokWjzoa5jAwMkxCykd6,5,2,1,0,1,0,2,0,6,0.8571428571428571,1,0.0,0,1,0,1,2,0,0,2,0,2,4,0
8255,108663,IVLYBILu5bsz4kc422I8sXYkTLjww3zh,SpATywNh6bZuzm8s1ceuBUnMUAeoAHHw,5,4,2,0,1,0,3,0,10,1.4285714285714286,1,0.0,0,2,0,1,4,0,0,3,0,3,7,1
8256,108666,wTFt4jd8Vf2XnbTwygw9m5uOggZGQW45,A3fsA9Zfv1X2fVEQhTw51lKENdNrEqT3,4,3,0,0,0,0,2,0,5,0.7142857142857143,1,0.0,0,0,0,0,3,0,0,2,0,0,5,1
8257,108671,uxgNKX0ZdDu87Z4mjH6KkxEGynnwur5T,A3fsA9Zfv1X2fVEQhTw51lKENdNrEqT3,3,4,0,0,0,0,2,0,6,0.8571428571428571,1,0.0,0,0,0,0,4,0,0,2,0,0,6,1
8258,108680,fihaFvHVK0WmjfjHHr8uDKIAQygBbKLV,A3fsA9Zfv1X2fVEQhTw51lKENdNrEqT3,1,0,0,0,0,0,1,0,1,0.14285714285714285,1,0.0,0,0,0,0,0,0,0,1,0,0,1,1
8259,108687,ABbPtVE9vR3q9TnGdVr0jhQS05eL9aJw,A3fsA9Zfv1X2fVEQhTw51lKENdNrEqT3,15,11,6,0,4,9,11,1,42,6.0,1,0.0,0,6,0,4,11,9,0,11,1,10,32,0
8260,108696,5Rbvag4nzKt7RfTqiThTliUWaR0ZVWak,bWdj2GDclj5ofokWjzoa5jAwMkxCykd6,14,23,13,22,8,4,11,1,82,11.714285714285714,1,0.0,7,13,21,8,16,4,1,11,1,49,33,1
8261,108697,6HIBebNSnNEoSeekVShzxF3x0IcbgohT,A3fsA9Zfv1X2fVEQhTw51lKENdNrEqT3,9,8,0,0,0,2,2,0,12,1.7142857142857142,1,0.0,1,0,0,0,7,2,0,2,0,1,11,1
8262,108708,5Rbvag4nzKt7RfTqiThTliUWaR0ZVWak,A3fsA9Zfv1X2fVEQhTw51lKENdNrEqT3,8,8,5,0,1,0,5,0,19,2.7142857142857144,1,0.0,2,5,0,1,6,0,0,5,0,8,11,1
8263,108719,WF6wuTvQFfQjN4sNbpLPNNaCItibHnsk,SpATywNh6bZuzm8s1ceuBUnMUAeoAHHw,5,2,1,0,1,0,2,0,6,0.8571428571428571,1,0.0,0,1,0,1,2,0,0,2,0,2,4,1
8264,108722,MSyG0cZLfbMN5GFb3dR5puqqT5uvCbhT,SpATywNh6bZuzm8s1ceuBUnMUAeoAHHw,6,1,1,0,1,0,3,0,6,0.8571428571428571,1,0.0,0,1,0,1,1,0,0,3,0,2,4,1
8265,108725,2qs5o4ShoJi8U8TmD1cNHDzshN8FK6oF,A3fsA9Zfv1X2fVEQhTw51lKENdNrEqT3,2,0,0,0,0,0,4,0,4,0.5714285714285714,1,0.0,0,0,0,0,0,0,0,4,0,0,4,1
8266,108728,I5y7gNrP5Yz8ZedoBMi3comUdlpFv5gJ,SpATywNh6bZuzm8s1ceuBUnMUAeoAHHw,3,2,0,0,0,0,1,0,3,0.42857142857142855,1,0.0,0,0,0,0,2,0,0,1,0,0,3,1
8267,108732,2Zhak41HpdUHgCzOLAuYT50kXg4d3Zji,G8EPVSXsOYB5YQWZGiz1aVq5Pgr2GrQu,5,2,1,0,1,0,2,0,6,0.8571428571428571,1,0.0,0,1,0,1,2,0,0,2,0,2,4,1
8268,108736,mFyBIO6GmLHqTEssxzuSwYKXW2BbEyYv,A3fsA9Zfv1X2fVEQhTw51lKENdNrEqT3,7,6,4,0,3,0,2,0,15,2.142857142857143,1,0.0,0,4,0,3,6,0,0,2,0,7,8,1
8269,108740,z8PlFZ3kRCGZCtReInG4syWyRUKvCeDo,RXDvfPUBYFlVdlueBFbLW0mhhAyGEqpt,59,97,4,157,16,1,9,1,285,40.714285714285715,3,0.0,45,4,148,16,52,1,9,9,1,213,72,0
8270,108741,8bMxud2pJnttNvsNwa7l9gc36Q1hRhIk,A3fsA9Zfv1X2fVEQhTw51lKENdNrEqT3,8,4,3,0,3,0,1,0,11,1.5714285714285714,1,0.0,0,3,0,3,4,0,0,1,0,6,5,1
8271,108748,ABbPtVE9vR3q9TnGdVr0jhQS05eL9aJw,bWdj2GDclj5ofokWjzoa5jAwMkxCykd6,6,2,1,0,1,0,3,0,7,1.0,1,0.0,0,1,0,1,2,0,0,3,0,2,5,1
8272,108756,h2bHu87wTYXhBBhcXbsLbNIYZ54rAZgt,A3fsA9Zfv1X2fVEQhTw51lKENdNrEqT3,45,38,27,84,19,7,14,1,190,27.142857142857142,1,0.0,4,27,74,19,34,7,10,14,1,124,66,1
8273,108765,wJC86gc3viBGM4vTuYg8647vhYAtlLLc,A3fsA9Zfv1X2fVEQhTw51lKENdNrEqT3,1,0,0,0,0,0,1,0,1,0.14285714285714285,1,0.0,0,0,0,0,0,0,0,1,0,0,1,1
8274,108766,sOb1oiy6NjSaiCXhGkHSqKHtlguCQRa0,A3fsA9Zfv1X2fVEQhTw51lKENdNrEqT3,1,0,0,0,0,0,1,0,1,0.14285714285714285,1,0.0,0,0,0,0,0,0,0,1,0,0,1,1
8275,108769,K1Izk0V4ksCL81zmOeuNNasAXwE95TLa,SpATywNh6bZuzm8s1ceuBUnMUAeoAHHw,1,0,0,0,0,0,2,0,2,0.2857142857142857,1,0.0,0,0,0,0,0,0,0,2,0,0,2,1
8276,108771,AvefCXcG5Ufaee9dlfNQnJvhOv3ejoZa,bWdj2GDclj5ofokWjzoa5jAwMkxCykd6,16,19,3,94,5,2,13,2,138,19.714285714285715,2,0.0,11,3,91,5,8,2,3,13,2,110,28,1
8277,108782,KdDp90RfX0ap0e8qJs31e2eGxlYje3er,A3fsA9Zfv1X2fVEQhTw51lKENdNrEqT3,41,31,14,96,10,0,8,0,159,22.714285714285715,2,0.0,3,14,83,10,28,0,13,8,0,110,49,1
8278,108786,ue5DigOvMG1l9Z3tvu2VwrvC8NR96FUy,SpATywNh6bZuzm8s1ceuBUnMUAeoAHHw,3,2,0,0,0,0,2,0,4,0.5714285714285714,1,0.0,0,0,0,0,2,0,0,2,0,0,4,1
8279,108787,x7jRdqJhx5ja6FBqxJnzxkapRPVQ2fNm,A3fsA9Zfv1X2fVEQhTw51lKENdNrEqT3,1,0,0,0,0,0,1,0,1,0.14285714285714285,1,0.0,0,0,0,0,0,0,0,1,0,0,1,1
8280,108789,AmjIDQe44ue5n1ufYmtWXDVGVMWDOkiz,A3fsA9Zfv1X2fVEQhTw51lKENdNrEqT3,3,3,0,0,0,0,1,0,4,0.5714285714285714,1,0.0,0,0,0,0,3,0,0,1,0,0,4,1
8281,108793,tn5nSlJLNdxx4Uni5Dn3S8nwDR8GJibq,A3fsA9Zfv1X2fVEQhTw51lKENdNrEqT3,14,7,5,0,3,1,7,1,24,3.4285714285714284,1,0.0,0,5,0,3,7,1,0,7,1,8,16,1
8282,108798,O12TpofOcB7jKUNGaL0IFXdieGzZ8DbW,SpATywNh6bZuzm8s1ceuBUnMUAeoAHHw,4,2,0,0,0,0,2,0,4,0.5714285714285714,1,0.0,0,0,0,0,2,0,0,2,0,0,4,1
8283,108799,J8izYPuHoJnyIb9qLV3GxLKVHOmNnyCQ,bWdj2GDclj5ofokWjzoa5jAwMkxCykd6,7,3,1,22,0,0,5,0,31,4.428571428571429,1,0.0,1,1,21,0,2,0,1,5,0,23,8,1
8284,108810,zcKuGtc5O9cMvHSHaVwufdFteCrEpUtA,A3fsA9Zfv1X2fVEQhTw51lKENdNrEqT3,69,43,25,164,16,37,11,0,296,42.285714285714285,4,0.0,3,25,138,16,40,37,26,11,0,182,114,1
8285,108835,NJrnUAVHenUfV0p23UPZO1ifAbb8gJ0p,SpATywNh6bZuzm8s1ceuBUnMUAeoAHHw,6,4,1,0,1,0,1,0,7,1.0,1,0.0,0,1,0,1,4,0,0,1,0,2,5,1
8286,108845,VBP5PzVQEKJYFH0y5ffEek5WfP9EW7uc,bWdj2GDclj5ofokWjzoa5jAwMkxCykd6,11,19,11,32,5,14,7,0,88,12.571428571428571,7,0.0,1,11,30,5,18,14,2,7,0,47,41,1
8287,108855,KQaABjEuQepl9FAcsVuUoYwnLleiOaUh,A3fsA9Zfv1X2fVEQhTw51lKENdNrEqT3,12,10,7,0,5,0,3,0,25,3.5714285714285716,1,0.0,0,7,0,5,10,0,0,3,0,12,13,1
8288,108856,AmiJtmcKc0Yc4REOzpITViIEZy1tcMgF,A3fsA9Zfv1X2fVEQhTw51lKENdNrEqT3,2,0,0,0,0,0,4,0,4,0.5714285714285714,1,0.0,0,0,0,0,0,0,0,4,0,0,4,1
8289,108857,XaYV3yff9o91oPBR4K32BeMm7Wg8wnLi,A3fsA9Zfv1X2fVEQhTw51lKENdNrEqT3,1,0,0,0,0,0,1,0,1,0.14285714285714285,1,0.0,0,0,0,0,0,0,0,1,0,0,1,1
8290,108869,4mtoRYC9jVVxEoNU8knjZ5oLeF7Lb02c,SpATywNh6bZuzm8s1ceuBUnMUAeoAHHw,5,8,0,0,0,0,2,0,10,1.4285714285714286,2,0.0,0,0,0,0,8,0,0,2,0,0,10,1
8291,108895,RGr3DE14hb7Ufb3qkxo2JnrYRs9POJfu,A3fsA9Zfv1X2fVEQhTw51lKENdNrEqT3,8,2,1,0,1,1,5,1,11,1.5714285714285714,1,0.0,0,1,0,1,2,1,0,5,1,2,9,1
8292,108904,5upQSO7J9z4uj80lVoIg3U6hUe3UwAJY,SpATywNh6bZuzm8s1ceuBUnMUAeoAHHw,2,0,0,0,0,0,2,0,2,0.2857142857142857,1,0.0,0,0,0,0,0,0,0,2,0,0,2,1
8293,108909,PIWGwmpuvT6lwwfSr4RWZP56tih9auMI,SpATywNh6bZuzm8s1ceuBUnMUAeoAHHw,8,5,1,0,1,0,3,0,10,1.4285714285714286,1,0.0,0,1,0,1,5,0,0,3,0,2,8,1
8294,108930,9vnJJcOjSmdwXe3BZQ5uEyhKgS7hqzyX,bWdj2GDclj5ofokWjzoa5jAwMkxCykd6,5,5,1,0,0,0,4,0,10,1.4285714285714286,1,0.0,0,1,0,0,5,0,0,4,0,1,9,1
8295,108946,xCHQAq5m2mtyQES4gfg6MjCHDUVD1J71,SpATywNh6bZuzm8s1ceuBUnMUAeoAHHw,9,14,1,0,0,0,3,0,18,2.5714285714285716,4,0.0,0,1,0,0,14,0,0,3,0,1,17,0
8296,108955,kLrl7hvNIzvhv6K321CFhgLYEgDfA62M,bWdj2GDclj5ofokWjzoa5jAwMkxCykd6,1,0,0,0,0,0,2,0,2,0.2857142857142857,1,0.0,0,0,0,0,0,0,0,2,0,0,2,1
8297,108960,g6loW2VoON94gkUidTjl3Rc73OlFLAiK,A3fsA9Zfv1X2fVEQhTw51lKENdNrEqT3,2,0,0,0,0,0,2,0,2,0.2857142857142857,1,0.0,0,0,0,0,0,0,0,2,0,0,2,0
8298,108961,xOpIfUll35xPHM6WEP4Czjw6kk2qoOGO,SpATywNh6bZuzm8s1ceuBUnMUAeoAHHw,5,7,4,0,3,0,4,0,18,2.5714285714285716,2,0.0,0,4,0,3,7,0,0,4,0,7,11,1
8299,108968,iRrv3nyo6BGr7ILpR2ahzmHKuzrYBh4I,SpATywNh6bZuzm8s1ceuBUnMUAeoAHHw,5,3,2,0,0,0,2,0,7,1.0,1,0.0,0,2,0,0,3,0,0,2,0,2,5,1
8300,108975,O5osNpvARQ134oncM7N5QGhst9sMjRtB,A3fsA9Zfv1X2fVEQhTw51lKENdNrEqT3,4,2,0,0,0,0,2,0,4,0.5714285714285714,1,0.0,0,0,0,0,2,0,0,2,0,0,4,1
8301,108989,i67qzouvUD7nINgK6d1xrH4pvufZqbFd,A3fsA9Zfv1X2fVEQhTw51lKENdNrEqT3,4,4,0,0,0,0,2,0,6,0.8571428571428571,1,0.0,0,0,0,0,4,0,0,2,0,0,6,0
8302,108990,OBplED2L50SmrdwVpOVn4VpcRjjudLK7,A3fsA9Zfv1X2fVEQhTw51lKENdNrEqT3,5,2,1,0,1,0,2,0,6,0.8571428571428571,1,0.0,0,1,0,1,2,0,0,2,0,2,4,1
8303,108993,SvKqfRpvSIeLIO42O4cF9tQtaigEgElY,A3fsA9Zfv1X2fVEQhTw51lKENdNrEqT3,7,6,2,0,2,0,3,0,13,1.8571428571428572,2,0.0,0,2,0,2,6,0,0,3,0,4,9,1
8304,108996,PhB6dZZRUCfcaCQkgFVOf4MMEPnUePaG,RXDvfPUBYFlVdlueBFbLW0mhhAyGEqpt,5,2,1,0,1,0,2,0,6,0.8571428571428571,1,0.0,0,1,0,1,2,0,0,2,0,2,4,1
8305,108999,3eJvDKkDryOUbJ3SYPy86iIynJcgnuci,SpATywNh6bZuzm8s1ceuBUnMUAeoAHHw,1,0,0,0,0,0,1,0,1,0.14285714285714285,1,0.0,0,0,0,0,0,0,0,1,0,0,1,1
8306,109002,qZCURwy8JtTyuwzOv8VNGZdlPKRFUQ4x,A3fsA9Zfv1X2fVEQhTw51lKENdNrEqT3,17,17,1,0,1,4,7,2,32,4.571428571428571,2,0.0,0,1,0,1,17,4,0,7,2,2,30,1
8307,109011,15KYq5P8DtSomIVrM0yWgXsvBsTL3cVz,A3fsA9Zfv1X2fVEQhTw51lKENdNrEqT3,9,5,4,0,4,0,3,0,16,2.2857142857142856,2,0.0,0,4,0,4,5,0,0,3,0,8,8,1
8308,109016,tJDZI9sjRcU2ZrvrdL12AwFT0OmQXIcr,A3fsA9Zfv1X2fVEQhTw51lKENdNrEqT3,5,2,1,0,1,0,5,0,9,1.2857142857142858,2,0.0,0,1,0,1,2,0,0,5,0,2,7,1
8309,109022,uJIh67cllxQLgAhipzdDZMEunDbuBxvF,bWdj2GDclj5ofokWjzoa5jAwMkxCykd6,1,0,0,0,0,0,1,0,1,0.14285714285714285,1,0.0,0,0,0,0,0,0,0,1,0,0,1,1
8310,109028,A1lWOqwgNzPh9AvybgvSnK3H60XpyG9J,SpATywNh6bZuzm8s1ceuBUnMUAeoAHHw,7,6,3,0,0,0,4,0,13,1.8571428571428572,1,0.0,2,3,0,0,4,0,0,4,0,5,8,1
8311,109035,qM8kx4xeCdgN7CQ3kDBj5MRznS4QMkrQ,G8EPVSXsOYB5YQWZGiz1aVq5Pgr2GrQu,1,0,0,0,0,0,1,0,1,0.14285714285714285,1,0.0,0,0,0,0,0,0,0,1,0,0,1,1
8312,109037,uCruZPKaQ2OyzLHOvqZfPPePv6wmtjTT,A3fsA9Zfv1X2fVEQhTw51lKENdNrEqT3,10,7,4,0,3,0,1,0,15,2.142857142857143,1,0.0,0,4,0,3,7,0,0,1,0,7,8,1
8313,109039,9RkNm8sDHM1l6EQFg0Uccrj0rG6zyU2p,A3fsA9Zfv1X2fVEQhTw51lKENdNrEqT3,18,13,0,32,0,0,2,0,47,6.714285714285714,1,0.0,2,0,29,0,11,0,3,2,0,31,16,1
8314,109047,JzBkQb66RlGvGZ9KheszqpvjIwSLUPa9,A3fsA9Zfv1X2fVEQhTw51lKENdNrEqT3,34,36,0,88,0,0,14,0,138,19.714285714285715,1,0.0,19,0,78,0,17,0,10,14,0,97,41,1
8315,109054,ay6BDjRoukNNZyMRT5YgyV5vrEPJDpPO,SpATywNh6bZuzm8s1ceuBUnMUAeoAHHw,8,9,6,0,4,1,5,0,25,3.5714285714285716,2,0.0,0,6,0,4,9,1,0,5,0,10,15,1
8316,109057,6UqKKdBhJ7OhJUUsVD1NV7GupMYMaBeb,RXDvfPUBYFlVdlueBFbLW0mhhAyGEqpt,15,12,8,0,6,0,3,0,29,4.142857142857143,1,0.0,0,8,0,6,12,0,0,3,0,14,15,1
8317,109059,i7lWxTot2xX5tUsFMkvVZL9ZWUCuO03L,A3fsA9Zfv1X2fVEQhTw51lKENdNrEqT3,11,9,4,0,1,1,7,2,24,3.4285714285714284,1,0.0,0,4,0,1,9,1,0,7,2,5,19,1
8318,109069,7JTB4CyOxMIYiscUQS5N24z40QJDU2NG,SpATywNh6bZuzm8s1ceuBUnMUAeoAHHw,13,13,8,7,5,0,5,0,38,5.428571428571429,2,0.0,0,8,6,5,13,0,1,5,0,19,19,1
8319,109074,3Q4BnqdcagQPfwKNQquFMuffhZmA481O,A3fsA9Zfv1X2fVEQhTw51lKENdNrEqT3,43,29,21,100,10,28,17,1,206,29.428571428571427,4,0.0,1,21,91,10,28,28,9,17,1,123,83,0
8320,109084,CJj1ly3IvknwPjPwTtDbF1Ndj6DLlK2p,A3fsA9Zfv1X2fVEQhTw51lKENdNrEqT3,1,0,0,0,0,0,1,0,1,0.14285714285714285,1,0.0,0,0,0,0,0,0,0,1,0,0,1,1
8321,109093,SSeq3zqfD5kMUB9gUKp0rdzGfihYMJi7,bWdj2GDclj5ofokWjzoa5jAwMkxCykd6,8,16,4,32,1,0,3,0,56,8.0,1,0.0,5,4,31,1,11,0,1,3,0,41,15,1
8322,109110,GqdYzH9IQjNV4Qw4poxGmkYlIXbhf40S,A3fsA9Zfv1X2fVEQhTw51lKENdNrEqT3,42,41,14,56,9,6,10,1,137,19.571428571428573,2,0.0,4,14,49,9,37,6,7,10,1,76,61,1
8323,109111,AQdHyQtscAI4B6OA1EdXFLllqKFEoazm,SpATywNh6bZuzm8s1ceuBUnMUAeoAHHw,5,2,1,0,1,0,2,0,6,0.8571428571428571,1,0.0,0,1,0,1,2,0,0,2,0,2,4,1
8324,109119,5bxm8iejKGaSX6YQr0TZiikGC5f5Uall,A3fsA9Zfv1X2fVEQhTw51lKENdNrEqT3,2,0,0,0,0,0,2,0,2,0.2857142857142857,1,0.0,0,0,0,0,0,0,0,2,0,0,2,1
8325,109122,Z9o0wypJqquui2I9MOTdTYh5ZR4U4MfH,A3fsA9Zfv1X2fVEQhTw51lKENdNrEqT3,7,3,0,0,0,0,5,0,8,1.1428571428571428,1,0.0,0,0,0,0,3,0,0,5,0,0,8,1
8326,109127,hIXeM0yyb6wIxVNnB5ijRV2LpcYBbrLW,bWdj2GDclj5ofokWjzoa5jAwMkxCykd6,1,0,0,0,0,0,1,0,1,0.14285714285714285,1,0.0,0,0,0,0,0,0,0,1,0,0,1,1
8327,109128,lvcfwg5xu40SCJNanQ0x3P780n9BnCrh,SpATywNh6bZuzm8s1ceuBUnMUAeoAHHw,5,2,1,0,1,0,2,0,6,0.8571428571428571,1,0.0,0,1,0,1,2,0,0,2,0,2,4,1
8328,109131,WixZusYrasZzR9owXlaQpXrbIZeJOheR,G8EPVSXsOYB5YQWZGiz1aVq5Pgr2GrQu,1,0,0,0,0,0,1,0,1,0.14285714285714285,1,0.0,0,0,0,0,0,0,0,1,0,0,1,1
8329,109132,ZVmjT1rppq7ilCPRRtmAl1wo0gOugsCt,A3fsA9Zfv1X2fVEQhTw51lKENdNrEqT3,49,37,31,66,25,2,8,4,173,24.714285714285715,4,0.0,2,31,58,25,35,2,8,8,4,116,57,1
8330,109136,oqLAJu8zdqUr5XPQYn4bKVmvqSIRanjc,A3fsA9Zfv1X2fVEQhTw51lKENdNrEqT3,1,0,0,0,0,0,1,0,1,0.14285714285714285,1,0.0,0,0,0,0,0,0,0,1,0,0,1,1
8331,109147,yM4AD5P6cznT9ej6JMMHXYh7GR0LcYuh,RXDvfPUBYFlVdlueBFbLW0mhhAyGEqpt,5,2,1,0,1,0,2,0,6,0.8571428571428571,1,0.0,0,1,0,1,2,0,0,2,0,2,4,0
8332,109169,7OAz0qWJXAI5T9rA3xczkfKNiBaKS5xD,A3fsA9Zfv1X2fVEQhTw51lKENdNrEqT3,5,2,1,0,1,0,3,0,7,1.0,1,0.0,0,1,0,1,2,0,0,3,0,2,5,1
8333,109181,YGxQDme0yci5ICjRYEy6Me4N0nnZ0g9H,SpATywNh6bZuzm8s1ceuBUnMUAeoAHHw,4,4,0,0,0,0,1,0,5,0.7142857142857143,1,0.0,0,0,0,0,4,0,0,1,0,0,5,1
8334,109182,QF5cQIRzKp7h2VSkoGej2U04awk99fmw,bWdj2GDclj5ofokWjzoa5jAwMkxCykd6,12,10,6,38,4,1,2,0,61,8.714285714285714,1,0.0,3,6,33,4,7,1,5,2,0,46,15,1
8335,109186,5kEshmgSAUGvBEOsnsKU8IViB0lkOwoD,A3fsA9Zfv1X2fVEQhTw51lKENdNrEqT3,23,4,0,94,0,0,2,0,100,14.285714285714286,1,0.0,1,0,78,0,3,0,16,2,0,79,21,1
8336,109189,eb3mqqeSvUWzy1wBijQrenro4Nhum9Na,SpATywNh6bZuzm8s1ceuBUnMUAeoAHHw,5,2,1,0,1,0,2,0,6,0.8571428571428571,1,0.0,0,1,0,1,2,0,0,2,0,2,4,1
8337,109191,Wigd4PnyDnjfDcFOxsTBcEnXo7kl9GSg,A3fsA9Zfv1X2fVEQhTw51lKENdNrEqT3,16,35,12,0,5,0,5,0,57,8.142857142857142,2,0.0,0,12,0,5,35,0,0,5,0,17,40,1
8338,109193,SclrH2608f72JlTtkBQ5xWQXCuDyyco3,A3fsA9Zfv1X2fVEQhTw51lKENdNrEqT3,62,26,18,176,10,3,17,0,250,35.714285714285715,7,0.0,2,18,155,10,24,3,21,17,0,185,65,0
8339,109195,1Gv11nS0XCuxdjw8VOmeY5aEETIaIhPq,A3fsA9Zfv1X2fVEQhTw51lKENdNrEqT3,9,7,4,0,3,0,2,0,16,2.2857142857142856,1,0.0,0,4,0,3,7,0,0,2,0,7,9,1
8340,109196,dUvs72HAR74VSIdDk98Za5hbojuIxWU6,A3fsA9Zfv1X2fVEQhTw51lKENdNrEqT3,7,5,1,6,0,0,1,0,13,1.8571428571428572,1,0.0,0,1,5,0,5,0,1,1,0,6,7,1
8341,109211,qGqiGKt8aL9OJtRSM5jpSwytmMiScrIj,SpATywNh6bZuzm8s1ceuBUnMUAeoAHHw,4,3,1,0,1,0,1,0,6,0.8571428571428571,1,0.0,0,1,0,1,3,0,0,1,0,2,4,1
8342,109231,eBgUh4wTe9cxKEwDUzWCU7PVyq9kVzKO,RXDvfPUBYFlVdlueBFbLW0mhhAyGEqpt,1,0,0,0,0,0,1,0,1,0.14285714285714285,1,0.0,0,0,0,0,0,0,0,1,0,0,1,1
8343,109241,XuNt1i5t4SR1AjDP4UHvsoux0R9qVf5C,SpATywNh6bZuzm8s1ceuBUnMUAeoAHHw,15,11,4,9,3,0,4,0,31,4.428571428571429,3,0.0,3,4,9,3,8,0,0,4,0,19,12,1
8344,109250,eS5XywA64oauZkENyWLpeVNsSbZFhj1k,A3fsA9Zfv1X2fVEQhTw51lKENdNrEqT3,4,2,1,0,1,0,1,0,5,0.7142857142857143,1,0.0,0,1,0,1,2,0,0,1,0,2,3,1
8345,109252,urSFKVbpyaFPrDJOmPVaNjyfC2aA3KOx,SpATywNh6bZuzm8s1ceuBUnMUAeoAHHw,9,10,3,0,2,0,10,0,25,3.5714285714285716,2,0.0,0,3,0,2,10,0,0,10,0,5,20,1
8346,109256,FHrj4N2SCEsxza13qmFjgJkCjs8BkrF3,A3fsA9Zfv1X2fVEQhTw51lKENdNrEqT3,1,0,0,0,0,0,1,0,1,0.14285714285714285,1,0.0,0,0,0,0,0,0,0,1,0,0,1,1
8347,109272,BLoa1RvSOgexbSH4hGzCihmBc8pXd0Db,SpATywNh6bZuzm8s1ceuBUnMUAeoAHHw,14,26,3,0,2,11,13,1,56,8.0,4,0.0,4,3,0,2,22,11,0,13,1,9,47,1
8348,109278,fsmpK8LD6WXenVxwQRsdTaVF7iZvaL2a,A3fsA9Zfv1X2fVEQhTw51lKENdNrEqT3,24,31,17,21,9,10,12,1,101,14.428571428571429,2,0.0,0,17,17,9,31,10,4,12,1,43,58,0
8349,109279,Y5EybULOrY5dAmMMQWE7bK5wg4bsR2Lr,A3fsA9Zfv1X2fVEQhTw51lKENdNrEqT3,26,32,21,0,9,46,13,2,123,17.571428571428573,1,0.0,0,21,0,9,32,46,0,13,2,30,93,1
8350,109281,MFZvBtjHJjKdCSK87D1kJEMGtcPTGn4S,A3fsA9Zfv1X2fVEQhTw51lKENdNrEqT3,13,14,1,0,0,9,18,2,44,6.285714285714286,5,0.0,1,1,0,0,13,9,0,18,2,2,42,1
8351,109284,wbX1noywm1bmZy8t47H8TCRwxZP7RsKK,A3fsA9Zfv1X2fVEQhTw51lKENdNrEqT3,1,0,0,0,0,0,1,0,1,0.14285714285714285,1,0.0,0,0,0,0,0,0,0,1,0,0,1,1
8352,109290,A7LjkAd6Hsm6pjjO6SeIGFgQk6AkrU13,A3fsA9Zfv1X2fVEQhTw51lKENdNrEqT3,2,0,0,0,0,0,2,0,2,0.2857142857142857,1,0.0,0,0,0,0,0,0,0,2,0,0,2,1
8353,109297,VHpS9hAicdnMqh79M7ktVNQGD7RUDs6Y,SpATywNh6bZuzm8s1ceuBUnMUAeoAHHw,1,0,0,0,0,0,1,0,1,0.14285714285714285,1,0.0,0,0,0,0,0,0,0,1,0,0,1,1
8354,109304,xIuSJsusLSQAfSXoNCyoYjZ56tZodncr,bWdj2GDclj5ofokWjzoa5jAwMkxCykd6,1,0,0,0,0,0,1,0,1,0.14285714285714285,1,0.0,0,0,0,0,0,0,0,1,0,0,1,1
8355,109312,XyoP35cBUiKk44G72mbtEXCBjk8FmHfo,RXDvfPUBYFlVdlueBFbLW0mhhAyGEqpt,25,17,11,40,5,0,6,0,79,11.285714285714286,2,0.0,4,11,37,5,13,0,3,6,0,57,22,1
8356,109317,3MhfBeZhIT9AL4Tb9CZUr8w3WzrKSn3o,A3fsA9Zfv1X2fVEQhTw51lKENdNrEqT3,3,1,0,0,0,0,4,0,5,0.7142857142857143,1,0.0,0,0,0,0,1,0,0,4,0,0,5,1
8357,109318,2kGHpLQ025yq85EhWUzksnj6YbPuOHOR,bWdj2GDclj5ofokWjzoa5jAwMkxCykd6,1,0,0,0,0,0,1,0,1,0.14285714285714285,1,0.0,0,0,0,0,0,0,0,1,0,0,1,1
8358,109319,Xv6VsjsdEll9lNbT4VRN24UmJx0y2b5E,SpATywNh6bZuzm8s1ceuBUnMUAeoAHHw,1,0,0,0,0,0,1,0,1,0.14285714285714285,1,0.0,0,0,0,0,0,0,0,1,0,0,1,1
8359,109328,1hnXgqUJOPkoCUYTmndUozE0mj3w5YNX,A3fsA9Zfv1X2fVEQhTw51lKENdNrEqT3,4,2,1,0,1,0,2,0,6,0.8571428571428571,1,0.0,0,1,0,1,2,0,0,2,0,2,4,1
8360,109344,zhiAnt6m0h6AhsgVFkvjzbntxyU6BMtY,A3fsA9Zfv1X2fVEQhTw51lKENdNrEqT3,7,3,2,0,2,0,3,1,11,1.5714285714285714,1,0.0,0,2,0,2,3,0,0,3,1,4,7,1
8361,109345,yjSLpu9rXQ5LHtGm8PnDgnJW6R5BYmgU,A3fsA9Zfv1X2fVEQhTw51lKENdNrEqT3,9,7,0,0,0,0,3,0,10,1.4285714285714286,1,0.0,1,0,0,0,6,0,0,3,0,1,9,1
8362,109346,m5W0Hr8czUb20VBRzQ0jvBI30TuPU4RJ,G8EPVSXsOYB5YQWZGiz1aVq5Pgr2GrQu,6,0,0,0,0,2,6,1,9,1.2857142857142858,1,0.0,0,0,0,0,0,2,0,6,1,0,9,1
8363,109359,G5JFEd58i47FiqQxatEMibk5NL9uoQb2,A3fsA9Zfv1X2fVEQhTw51lKENdNrEqT3,3,3,1,0,0,0,1,0,5,0.7142857142857143,1,0.0,0,1,0,0,3,0,0,1,0,1,4,1
8364,109374,Tpf1XLLzVEPyFa0H95Pm3DK4tc3XDhko,G8EPVSXsOYB5YQWZGiz1aVq5Pgr2GrQu,1,0,0,0,0,0,1,0,1,0.14285714285714285,1,0.0,0,0,0,0,0,0,0,1,0,0,1,1
8365,109376,Sqh5jl1ru6WQiSCN47rLyyyFSF0wkiCq,SpATywNh6bZuzm8s1ceuBUnMUAeoAHHw,6,9,0,0,0,0,2,0,11,1.5714285714285714,1,0.0,0,0,0,0,9,0,0,2,0,0,11,1
8366,109383,gbm2CIpey5BIwuF4GxSVVzkrIqxOpVxg,A3fsA9Zfv1X2fVEQhTw51lKENdNrEqT3,41,36,25,52,19,6,12,1,151,21.571428571428573,3,0.0,3,25,44,19,33,6,8,12,1,91,60,1
8367,109394,Gbu6u21HudOCm7T5rLfdumNquubs5EJ1,SpATywNh6bZuzm8s1ceuBUnMUAeoAHHw,1,0,0,0,0,0,1,0,1,0.14285714285714285,1,0.0,0,0,0,0,0,0,0,1,0,0,1,1
8368,109402,r9Iw8qv5Gd0slmKCVr3aUz7TALROG0cf,A3fsA9Zfv1X2fVEQhTw51lKENdNrEqT3,11,4,3,0,3,1,7,1,19,2.7142857142857144,1,0.0,0,3,0,3,4,1,0,7,1,6,13,1
8369,109403,RJ2AN96oZxuBCR52LgUmQpj4g9Y4mcD4,bWdj2GDclj5ofokWjzoa5jAwMkxCykd6,16,20,12,16,3,1,6,0,58,8.285714285714286,2,0.0,2,12,16,3,18,1,0,6,0,33,25,0
8370,109417,7T8zBGfQI7GmUNFouD9u4M8LhrQmKX66,RXDvfPUBYFlVdlueBFbLW0mhhAyGEqpt,1,0,0,0,0,0,1,0,1,0.14285714285714285,1,0.0,0,0,0,0,0,0,0,1,0,0,1,1
8371,109420,SPTliKTsT7X2iG2wvNL5AHdQ10rMJVZH,SpATywNh6bZuzm8s1ceuBUnMUAeoAHHw,6,4,1,0,1,0,5,0,11,1.5714285714285714,2,0.0,0,1,0,1,4,0,0,5,0,2,9,1
8372,109439,On26vSCnXPxlOaC4mCdb6AzdACXRPBhk,G8EPVSXsOYB5YQWZGiz1aVq5Pgr2GrQu,5,2,1,0,1,0,2,0,6,0.8571428571428571,1,0.0,0,1,0,1,2,0,0,2,0,2,4,1
8373,109443,7M6n6JJz8OT4WvASBJlRAyi4sCwcAzru,A3fsA9Zfv1X2fVEQhTw51lKENdNrEqT3,8,5,4,0,4,0,1,0,14,2.0,1,0.0,0,4,0,4,5,0,0,1,0,8,6,1
8374,109445,bwOsVB833e5tHrwHSqmXCzs0EZClNPpv,A3fsA9Zfv1X2fVEQhTw51lKENdNrEqT3,1,0,0,0,0,0,1,0,1,0.14285714285714285,1,0.0,0,0,0,0,0,0,0,1,0,0,1,1
8375,109451,JbJKnENXbd4D9YGrXPdV81P48WObl8vL,SpATywNh6bZuzm8s1ceuBUnMUAeoAHHw,6,7,0,0,0,0,7,0,14,2.0,1,0.0,0,0,0,0,7,0,0,7,0,0,14,1
8376,109454,xvNZbY8RiapNT0qosUHeJFlEtqfPfVcr,SpATywNh6bZuzm8s1ceuBUnMUAeoAHHw,14,11,6,12,4,0,4,0,37,5.285714285714286,2,0.0,3,6,11,4,8,0,1,4,0,24,13,1
8377,109455,MCvvcTb9wFwriBgKb49jcCFeKRdTXM9j,A3fsA9Zfv1X2fVEQhTw51lKENdNrEqT3,5,2,1,0,1,0,4,0,8,1.1428571428571428,2,0.0,0,1,0,1,2,0,0,4,0,2,6,1
8378,109475,RNh4yH9mZXB6eTgcXXcHwrIgY95Sp0W7,A3fsA9Zfv1X2fVEQhTw51lKENdNrEqT3,7,6,1,0,1,0,1,0,9,1.2857142857142858,1,0.0,0,1,0,1,6,0,0,1,0,2,7,1
8379,109477,7Cs0Abzd0FS9IIdr1A12WVGDozLYcxYb,SpATywNh6bZuzm8s1ceuBUnMUAeoAHHw,1,0,0,0,0,0,1,0,1,0.14285714285714285,1,0.0,0,0,0,0,0,0,0,1,0,0,1,1
8380,109482,ZwZ9L46oJNtj9fhgH7VsyHRiEXY9tnmd,G8EPVSXsOYB5YQWZGiz1aVq5Pgr2GrQu,5,3,1,0,1,0,3,0,8,1.1428571428571428,1,0.0,0,1,0,1,3,0,0,3,0,2,6,1
8381,109484,pdp70UYWh5otKyx4vGTfJaBVRuSZsd0M,SpATywNh6bZuzm8s1ceuBUnMUAeoAHHw,6,2,1,0,1,2,5,0,11,1.5714285714285714,1,0.0,0,1,0,1,2,2,0,5,0,2,9,1
8382,109493,kajklFKczHkuBeWWHTIA518Xzi7jmX3b,A3fsA9Zfv1X2fVEQhTw51lKENdNrEqT3,11,9,1,0,1,6,8,2,27,3.857142857142857,2,0.0,0,1,0,1,9,6,0,8,2,2,25,1
8383,109503,IoDMPccLVuoP1kfQwv1qzxHOaDwHWJ1B,RXDvfPUBYFlVdlueBFbLW0mhhAyGEqpt,17,15,11,0,6,0,13,0,45,6.428571428571429,2,0.0,0,11,0,6,15,0,0,13,0,17,28,1
8384,109510,xHqnmrHdKLDxnJRARDHa2hpY45Zdt2kb,A3fsA9Zfv1X2fVEQhTw51lKENdNrEqT3,3,2,0,0,0,0,1,0,3,0.42857142857142855,1,0.0,0,0,0,0,2,0,0,1,0,0,3,1
8385,109514,KpYtE2oiCacGgvHDiOR9EPHvEG8K5VAH,bWdj2GDclj5ofokWjzoa5jAwMkxCykd6,6,4,2,0,0,0,4,0,10,1.4285714285714286,2,0.0,0,2,0,0,4,0,0,4,0,2,8,1
8386,109517,EEukb1HtBZxlb0jW8bNwwOHInCYodyW7,bWdj2GDclj5ofokWjzoa5jAwMkxCykd6,1,0,0,0,0,0,1,0,1,0.14285714285714285,1,0.0,0,0,0,0,0,0,0,1,0,0,1,1
8387,109523,qYbhiF3nJ95ttwkxqyX4iKZXAQTXvtdJ,G8EPVSXsOYB5YQWZGiz1aVq5Pgr2GrQu,1,0,0,0,0,0,1,0,1,0.14285714285714285,1,0.0,0,0,0,0,0,0,0,1,0,0,1,1
8388,109527,e0jCfTT6aDMNOYEB4iNXcTbrqQiVpXOZ,bWdj2GDclj5ofokWjzoa5jAwMkxCykd6,1,0,0,0,0,0,1,0,1,0.14285714285714285,1,0.0,0,0,0,0,0,0,0,1,0,0,1,1
8389,109533,7Cs0Abzd0FS9IIdr1A12WVGDozLYcxYb,bWdj2GDclj5ofokWjzoa5jAwMkxCykd6,2,0,0,0,0,0,2,0,2,0.2857142857142857,1,0.0,0,0,0,0,0,0,0,2,0,0,2,1
8390,109537,F5SjzrcjsAWqSZbt6NDh8MAkDqWpXhkX,SpATywNh6bZuzm8s1ceuBUnMUAeoAHHw,25,38,16,24,9,1,5,0,93,13.285714285714286,2,0.0,19,16,22,9,19,1,2,5,0,66,27,1
8391,109547,R2rZMVSlSMqKi5RYuPtRmvScbhOABzyG,SpATywNh6bZuzm8s1ceuBUnMUAeoAHHw,8,5,0,0,1,0,3,0,9,1.2857142857142858,1,0.0,0,0,0,1,5,0,0,3,0,1,8,1
8392,109548,sXsJQIq7yfhUcvdfsv1TB75YziTHrdKC,SpATywNh6bZuzm8s1ceuBUnMUAeoAHHw,1,0,0,0,0,0,1,0,1,0.14285714285714285,1,0.0,0,0,0,0,0,0,0,1,0,0,1,1
8393,109549,rHrqDHLlL0apyY3RByvtRvQofhL6Brvn,A3fsA9Zfv1X2fVEQhTw51lKENdNrEqT3,8,8,0,0,0,4,5,0,17,2.4285714285714284,1,0.0,0,0,0,0,8,4,0,5,0,0,17,1
8394,109555,Cv1aavObJnuABKfipF6OGePzg0BnGPFs,G8EPVSXsOYB5YQWZGiz1aVq5Pgr2GrQu,44,7,6,194,0,0,14,0,221,31.571428571428573,4,0.0,1,6,165,0,6,0,29,14,0,172,49,1
8395,109569,XTOZBwO5vG1hcHef4AbuiTP7iSg27hS9,A3fsA9Zfv1X2fVEQhTw51lKENdNrEqT3,37,24,2,68,1,0,10,0,105,15.0,2,0.0,2,2,59,1,22,0,9,10,0,64,41,1
8396,109570,ZGw6EJB3cHSkZVviqnd0VnyCd0Hz7wva,SpATywNh6bZuzm8s1ceuBUnMUAeoAHHw,15,12,6,12,2,2,4,1,39,5.571428571428571,1,0.0,4,6,12,2,8,2,0,4,1,24,15,1
8397,109578,QYVRHTpooyTkzSbIywJ7ri5o4t73Xwty,G8EPVSXsOYB5YQWZGiz1aVq5Pgr2GrQu,1,0,0,0,0,0,1,0,1,0.14285714285714285,1,0.0,0,0,0,0,0,0,0,1,0,0,1,1
8398,109585,MF5edVvM6lCZDxnMdHelos9TUh3KERjn,bWdj2GDclj5ofokWjzoa5jAwMkxCykd6,4,2,1,0,1,0,1,0,5,0.7142857142857143,1,0.0,0,1,0,1,2,0,0,1,0,2,3,0
8399,109590,fsmpK8LD6WXenVxwQRsdTaVF7iZvaL2a,RXDvfPUBYFlVdlueBFbLW0mhhAyGEqpt,5,2,1,0,1,0,2,0,6,0.8571428571428571,1,0.0,0,1,0,1,2,0,0,2,0,2,4,0
8400,109591,Lo69R5WSRDc62Oqnj9VlNFkaC1RUwhyo,G8EPVSXsOYB5YQWZGiz1aVq5Pgr2GrQu,8,6,2,0,2,0,3,1,14,2.0,1,0.0,3,2,0,2,3,0,0,3,1,7,7,1
8401,109601,800D5qwHCt3Ko9pzEVC49paGCt6dYzm8,A3fsA9Zfv1X2fVEQhTw51lKENdNrEqT3,5,4,2,0,1,0,3,0,10,1.4285714285714286,1,0.0,0,2,0,1,4,0,0,3,0,3,7,1
8402,109607,6YbtihuLKjD5ARAIowoJ3OQ962AhWkN5,A3fsA9Zfv1X2fVEQhTw51lKENdNrEqT3,5,3,1,0,1,0,2,0,7,1.0,1,0.0,0,1,0,1,3,0,0,2,0,2,5,1
8403,109614,cu1UzrL4copIEW9h08HrvzOBVJhdKzoe,SpATywNh6bZuzm8s1ceuBUnMUAeoAHHw,7,2,1,0,1,0,7,2,13,1.8571428571428572,1,0.0,0,1,0,1,2,0,0,7,2,2,11,1
8404,109621,dpYSVisiS2cUJnMBorcbHAtUmvFhsmWA,bWdj2GDclj5ofokWjzoa5jAwMkxCykd6,7,1,1,0,1,0,7,0,10,1.4285714285714286,1,0.0,0,1,0,1,1,0,0,7,0,2,8,1
8405,109631,ol7Qu6IbbqCzG4dmk5UYJtqKBH41uMvQ,SpATywNh6bZuzm8s1ceuBUnMUAeoAHHw,10,7,5,5,4,0,2,0,23,3.2857142857142856,1,0.0,1,5,4,4,6,0,1,2,0,14,9,1
8406,109642,JsgxGxJYDhwgnBgYbCILUrGTg0zFV4WJ,SpATywNh6bZuzm8s1ceuBUnMUAeoAHHw,12,9,8,6,4,0,2,0,29,4.142857142857143,1,0.0,0,8,5,4,9,0,1,2,0,17,12,1
8407,109647,jHKRHkwov2ldu5B5B6LxfeJx9Okiy1xa,G8EPVSXsOYB5YQWZGiz1aVq5Pgr2GrQu,10,14,5,0,5,0,6,1,31,4.428571428571429,1,0.0,7,5,0,5,7,0,0,6,1,17,14,1
8408,109651,9JqGpnHdkbKBOmcT3LmREcuqxduizBra,SpATywNh6bZuzm8s1ceuBUnMUAeoAHHw,17,36,18,21,5,43,18,2,143,20.428571428571427,4,0.0,8,18,18,5,28,43,3,18,2,49,94,1
8409,109655,rfK1l9cGasJW2YfHTqaTiWeJHGoMfxaD,G8EPVSXsOYB5YQWZGiz1aVq5Pgr2GrQu,9,8,1,0,1,0,3,0,13,1.8571428571428572,1,0.0,2,1,0,1,6,0,0,3,0,4,9,1
8410,109664,SzAtQzNOap38B7fNAidQGz1HfRyu6YSS,A3fsA9Zfv1X2fVEQhTw51lKENdNrEqT3,41,24,15,68,10,0,17,0,134,19.142857142857142,2,0.0,6,15,56,10,18,0,12,17,0,87,47,1
8411,109678,PxrASHNEh6iqdpy6HawW3zGbUAupdzGr,G8EPVSXsOYB5YQWZGiz1aVq5Pgr2GrQu,6,1,1,0,1,0,5,0,8,1.1428571428571428,1,0.0,0,1,0,1,1,0,0,5,0,2,6,1
8412,109679,Dpj1ute7yeokptEET2ZfYuubDiXNwLXm,bWdj2GDclj5ofokWjzoa5jAwMkxCykd6,7,11,7,0,3,0,3,0,24,3.4285714285714284,2,0.0,0,7,0,3,11,0,0,3,0,10,14,1
8413,109680,yesikXRZpFYEGoXWRi2rEHboJsFyCCGG,A3fsA9Zfv1X2fVEQhTw51lKENdNrEqT3,4,2,1,0,1,0,1,0,5,0.7142857142857143,1,0.0,0,1,0,1,2,0,0,1,0,2,3,1
8414,109682,HYMxLb0qNi7DvNLdn0aBxzsZewAG7tgU,SpATywNh6bZuzm8s1ceuBUnMUAeoAHHw,6,3,1,0,1,0,2,0,7,1.0,2,0.0,0,1,0,1,3,0,0,2,0,2,5,1
8415,109695,3o4QanEzrLxU7IR8E0SkDLt6uwLmz5BV,SpATywNh6bZuzm8s1ceuBUnMUAeoAHHw,1,0,0,0,0,0,1,0,1,0.14285714285714285,1,0.0,0,0,0,0,0,0,0,1,0,0,1,1
8416,109702,eO5PxtKBgjWgF4Rm51wpAuHgGsQTJyoc,G8EPVSXsOYB5YQWZGiz1aVq5Pgr2GrQu,9,4,3,0,3,0,2,0,12,1.7142857142857142,1,0.0,0,3,0,3,4,0,0,2,0,6,6,1
8417,109705,HMYpimZGFgj5IczDutkfjUfnxl45PoHW,A3fsA9Zfv1X2fVEQhTw51lKENdNrEqT3,46,36,22,50,11,33,18,0,170,24.285714285714285,5,0.0,4,22,47,11,32,33,3,18,0,84,86,1
8418,109708,nPYAQvL2RWwzE56jCZxlu4AvBduWOQxo,SpATywNh6bZuzm8s1ceuBUnMUAeoAHHw,4,2,1,0,1,0,2,0,6,0.8571428571428571,1,0.0,0,1,0,1,2,0,0,2,0,2,4,1
8419,109716,9257hE3j2ibuyvUsd5ug9QNBvZR626xP,SpATywNh6bZuzm8s1ceuBUnMUAeoAHHw,19,38,15,18,9,0,6,0,86,12.285714285714286,4,0.0,11,15,15,9,27,0,3,6,0,50,36,1
8420,109718,LauvBEW2SjRiQSbmKACjhjUjr7ycSUes,SpATywNh6bZuzm8s1ceuBUnMUAeoAHHw,13,14,4,12,3,0,2,1,36,5.142857142857143,1,0.0,9,4,12,3,5,0,0,2,1,28,8,1
8421,109731,sXWQCMJ5uWT53YScVl07HilRx1j9KLZ2,SpATywNh6bZuzm8s1ceuBUnMUAeoAHHw,1,0,0,0,0,0,1,0,1,0.14285714285714285,1,0.0,0,0,0,0,0,0,0,1,0,0,1,1
8422,109746,GLXgEITEGSlq2OnY03wIuxcorHQRX3zY,A3fsA9Zfv1X2fVEQhTw51lKENdNrEqT3,10,7,5,0,3,1,5,0,21,3.0,1,0.0,0,5,0,3,7,1,0,5,0,8,13,0
8423,109757,NCq7uMk20xis3HUzEQcWP2K284TvGGUT,G8EPVSXsOYB5YQWZGiz1aVq5Pgr2GrQu,10,5,4,0,3,3,3,0,18,2.5714285714285716,1,0.0,0,4,0,3,5,3,0,3,0,7,11,0
8424,109782,OZaq72DmJH6bReA6lKvO4XbWYjmwsu42,A3fsA9Zfv1X2fVEQhTw51lKENdNrEqT3,1,0,0,0,0,0,1,0,1,0.14285714285714285,1,0.0,0,0,0,0,0,0,0,1,0,0,1,1
8425,109783,TGbtpXBmCBBlZeS2P72XRQZjesW8qA9X,SpATywNh6bZuzm8s1ceuBUnMUAeoAHHw,2,0,0,0,0,0,2,0,2,0.2857142857142857,1,0.0,0,0,0,0,0,0,0,2,0,0,2,1
8426,109784,qp7BLvS8nhXNAuvU9LsQhZWo9nk3BTFw,bWdj2GDclj5ofokWjzoa5jAwMkxCykd6,1,0,0,0,0,0,1,0,1,0.14285714285714285,1,0.0,0,0,0,0,0,0,0,1,0,0,1,1
8427,109785,qp7BLvS8nhXNAuvU9LsQhZWo9nk3BTFw,RXDvfPUBYFlVdlueBFbLW0mhhAyGEqpt,1,0,0,0,0,0,1,0,1,0.14285714285714285,1,0.0,0,0,0,0,0,0,0,1,0,0,1,1
8428,109786,jRi5kMZL8gw9VtNxiN9NAzyTyPmFUqYw,A3fsA9Zfv1X2fVEQhTw51lKENdNrEqT3,9,8,1,0,1,0,11,2,23,3.2857142857142856,1,0.0,0,1,0,1,8,0,0,11,2,2,21,1
8429,109800,PenDUeO0eoR8hyLVdfPN6H7q2FnTGMus,bWdj2GDclj5ofokWjzoa5jAwMkxCykd6,1,0,0,0,0,0,1,0,1,0.14285714285714285,1,0.0,0,0,0,0,0,0,0,1,0,0,1,1
8430,109811,4FKdcJP7BDwtMG7CY9eliEHXAfUQYGv7,RXDvfPUBYFlVdlueBFbLW0mhhAyGEqpt,9,12,6,0,3,0,1,0,22,3.142857142857143,1,0.0,0,6,0,3,12,0,0,1,0,9,13,1
8431,109816,NxKBgCf6L0n0EeCKRoJkVqGpdQ3sLVu2,SpATywNh6bZuzm8s1ceuBUnMUAeoAHHw,6,3,2,0,2,0,1,0,8,1.1428571428571428,1,0.0,0,2,0,2,3,0,0,1,0,4,4,1
8432,109821,OEuLxcw6vw5UY038iWtYfZUlieO9mgsq,RXDvfPUBYFlVdlueBFbLW0mhhAyGEqpt,9,24,15,0,5,0,5,0,49,7.0,2,0.0,0,15,0,5,24,0,0,5,0,20,29,1
8433,109835,QQrQFuArLkquFtXrvX0HKAU3caPT1bEW,SpATywNh6bZuzm8s1ceuBUnMUAeoAHHw,1,0,0,0,0,0,1,0,1,0.14285714285714285,1,0.0,0,0,0,0,0,0,0,1,0,0,1,1
8434,109840,fW2uAkcB4Zo13Su23SC3AqxKoKQQCv9V,bWdj2GDclj5ofokWjzoa5jAwMkxCykd6,14,11,4,28,5,0,2,0,50,7.142857142857143,2,0.0,4,4,27,5,7,0,1,2,0,40,10,1
8435,109841,008XUUt5rc6hUrg7SHj9oW0rG0FE0dkF,A3fsA9Zfv1X2fVEQhTw51lKENdNrEqT3,36,20,12,68,0,1,7,2,110,15.714285714285714,1,0.0,6,12,58,0,14,1,10,7,2,76,34,0
8436,109856,PVIjAE0m0OeJAYOHc5gIjzktRijtXdS4,SpATywNh6bZuzm8s1ceuBUnMUAeoAHHw,6,3,2,0,2,0,1,0,8,1.1428571428571428,2,0.0,0,2,0,2,3,0,0,1,0,4,4,0
8437,109858,45qf8dslh2FbT82HZJkVQ8o4xBP1tetJ,SpATywNh6bZuzm8s1ceuBUnMUAeoAHHw,5,4,1,0,1,0,2,0,8,1.1428571428571428,2,0.0,0,1,0,1,4,0,0,2,0,2,6,1
8438,109865,WRiHtWJX61VUGyAGQFSHJ3czdrgqxeQW,A3fsA9Zfv1X2fVEQhTw51lKENdNrEqT3,3,0,0,0,0,2,2,0,4,0.5714285714285714,1,0.0,0,0,0,0,0,2,0,2,0,0,4,1
8439,109876,J9b5OTfKjKw0x7GgqhJQnViZ6aYw88y1,bWdj2GDclj5ofokWjzoa5jAwMkxCykd6,4,2,0,0,0,0,3,0,5,0.7142857142857143,1,0.0,0,0,0,0,2,0,0,3,0,0,5,1
8440,109884,TiyssQ1xBxRpSE8M84hoblpjLNawoMPM,bWdj2GDclj5ofokWjzoa5jAwMkxCykd6,1,0,0,0,0,0,2,0,2,0.2857142857142857,2,0.0,0,0,0,0,0,0,0,2,0,0,2,1
8441,109888,onkD63zW36qWueM4FnIhDEFep4J6xaTB,SpATywNh6bZuzm8s1ceuBUnMUAeoAHHw,10,9,6,0,6,1,8,1,31,4.428571428571429,3,0.0,0,6,0,6,9,1,0,8,1,12,19,1
8442,109898,26GEnf61bFs7ZWD0apKuRzsFCe2K0kZz,SpATywNh6bZuzm8s1ceuBUnMUAeoAHHw,7,2,0,0,0,14,6,1,23,3.2857142857142856,1,0.0,0,0,0,0,2,14,0,6,1,0,23,1
8443,109903,m4zdr76CpU472F6wsJffFbslI27LpI4g,A3fsA9Zfv1X2fVEQhTw51lKENdNrEqT3,4,2,1,0,1,0,1,0,5,0.7142857142857143,1,0.0,0,1,0,1,2,0,0,1,0,2,3,1
8444,109911,AVOR5ugt0lZQkprV146IIDmyiCL0xSOy,SpATywNh6bZuzm8s1ceuBUnMUAeoAHHw,6,3,1,0,1,0,2,0,7,1.0,1,0.0,0,1,0,1,3,0,0,2,0,2,5,1
8445,109935,CViRSkXaB71kW0MpqfES8A240EKnhiKp,SpATywNh6bZuzm8s1ceuBUnMUAeoAHHw,9,13,10,0,6,0,5,0,34,4.857142857142857,3,0.0,0,10,0,6,13,0,0,5,0,16,18,1
8446,109938,jhSBNR9EEysD5KhTnnFndvZuefk9V3rI,SpATywNh6bZuzm8s1ceuBUnMUAeoAHHw,26,25,17,23,5,2,14,1,87,12.428571428571429,4,0.0,6,17,20,5,19,2,3,14,1,48,39,0
8447,109950,m46ZDnHY4MCOwsZObE6icbOdSDL76NDY,A3fsA9Zfv1X2fVEQhTw51lKENdNrEqT3,1,0,0,0,0,0,1,0,1,0.14285714285714285,1,0.0,0,0,0,0,0,0,0,1,0,0,1,1
8448,109952,7vgfRfYiZZ2eDFnPmEicllnUmROBENw7,SpATywNh6bZuzm8s1ceuBUnMUAeoAHHw,1,0,0,0,0,0,1,0,1,0.14285714285714285,1,0.0,0,0,0,0,0,0,0,1,0,0,1,1
8449,109957,69mjZoNGtUdd47OHaI2iQubsVwSBE5CT,bWdj2GDclj5ofokWjzoa5jAwMkxCykd6,4,3,1,0,1,0,2,0,7,1.0,1,0.0,0,1,0,1,3,0,0,2,0,2,5,1
8450,109960,dq3iqibSI5OSwCbWRZv7tfgbiuLwOgjh,A3fsA9Zfv1X2fVEQhTw51lKENdNrEqT3,10,7,5,0,4,0,1,0,17,2.4285714285714284,1,0.0,0,5,0,4,7,0,0,1,0,9,8,1
8451,109967,gcway7yukVhkU23YjxQt8J89R78muKel,A3fsA9Zfv1X2fVEQhTw51lKENdNrEqT3,1,0,0,0,0,0,2,0,2,0.2857142857142857,1,0.0,0,0,0,0,0,0,0,2,0,0,2,1
8452,109984,9vKJ7o9c510Kb9hLaAaKExOfBIo69t2w,bWdj2GDclj5ofokWjzoa5jAwMkxCykd6,4,3,1,0,1,0,1,0,6,0.8571428571428571,1,0.0,0,1,0,1,3,0,0,1,0,2,4,1
8453,109993,ma5SB0XT5eSIELPtdH2s2g8qesUddnBJ,SpATywNh6bZuzm8s1ceuBUnMUAeoAHHw,4,2,0,0,0,0,3,0,5,0.7142857142857143,1,0.0,0,0,0,0,2,0,0,3,0,0,5,1
8454,109994,V9A9B2T9pRTU3AqvpqzuKs4MfRcAEte2,bWdj2GDclj5ofokWjzoa5jAwMkxCykd6,7,3,2,0,2,0,3,0,10,1.4285714285714286,2,0.0,0,2,0,2,3,0,0,3,0,4,6,1
8455,109995,9vKJ7o9c510Kb9hLaAaKExOfBIo69t2w,SpATywNh6bZuzm8s1ceuBUnMUAeoAHHw,6,7,3,0,2,0,1,0,13,1.8571428571428572,1,0.0,0,3,0,2,7,0,0,1,0,5,8,1
8456,109996,OZ02Yntpt8Hg8thsFgejT4NSsPYtVPPm,A3fsA9Zfv1X2fVEQhTw51lKENdNrEqT3,4,3,2,0,2,0,1,0,8,1.1428571428571428,1,0.0,0,2,0,2,3,0,0,1,0,4,4,0
8457,109999,rYSxun4NgQnH8EYwHicH82Z91cblITe8,A3fsA9Zfv1X2fVEQhTw51lKENdNrEqT3,8,2,1,0,1,1,10,1,16,2.2857142857142856,1,0.0,0,1,0,1,2,1,0,10,1,2,14,1
8458,110000,A49hnVx3rwiVqM2hX3Oana4wZTCICiZX,SpATywNh6bZuzm8s1ceuBUnMUAeoAHHw,4,2,1,0,1,0,1,0,5,0.7142857142857143,1,0.0,0,1,0,1,2,0,0,1,0,2,3,0
8459,110005,CD2QgLWd9xNuEgr45XWnWQUVbnjf79M7,A3fsA9Zfv1X2fVEQhTw51lKENdNrEqT3,14,7,6,0,5,0,3,0,21,3.0,2,0.0,0,6,0,5,7,0,0,3,0,11,10,1
8460,110009,9803qM4isShkjkoVAPID7DQVAjFPwCDe,bWdj2GDclj5ofokWjzoa5jAwMkxCykd6,2,0,0,0,0,0,3,0,3,0.42857142857142855,1,0.0,0,0,0,0,0,0,0,3,0,0,3,1
8461,110013,OvIrFDXnTf7lPGXHN37tKh2m9dXSHGJK,A3fsA9Zfv1X2fVEQhTw51lKENdNrEqT3,1,0,0,0,0,0,2,0,2,0.2857142857142857,2,0.0,0,0,0,0,0,0,0,2,0,0,2,1
8462,110021,hkMQnmp0vvHTyvieOAhjYCGC9vi3Sftr,SpATywNh6bZuzm8s1ceuBUnMUAeoAHHw,10,5,3,0,2,5,5,0,20,2.857142857142857,1,0.0,0,3,0,2,5,5,0,5,0,5,15,1
8463,110025,VLJj9ywKL5TKEmvLWZO7iNyx7gDmV9Dg,SpATywNh6bZuzm8s1ceuBUnMUAeoAHHw,1,0,0,0,0,0,1,0,1,0.14285714285714285,1,0.0,0,0,0,0,0,0,0,1,0,0,1,1
8464,110030,2gXHY5qLgY96Nt3kImmboPawcy43EQXt,A3fsA9Zfv1X2fVEQhTw51lKENdNrEqT3,5,6,2,0,2,0,3,0,13,1.8571428571428572,1,0.0,0,2,0,2,6,0,0,3,0,4,9,1
8465,110033,sVIvm416vjfeqMOGnXZuyI7BvpOH8r6a,A3fsA9Zfv1X2fVEQhTw51lKENdNrEqT3,8,2,1,0,1,4,6,1,15,2.142857142857143,1,0.0,0,1,0,1,2,4,0,6,1,2,13,1
8466,110036,pKc7l3x3OfAQ9k2wvNUoHVHE65xXVFbV,G8EPVSXsOYB5YQWZGiz1aVq5Pgr2GrQu,9,5,3,0,2,1,4,0,15,2.142857142857143,1,0.0,0,3,0,2,5,1,0,4,0,5,10,1
8467,110047,mutkCKvqzTd4FkjKQRYUWL51H59AdIct,SpATywNh6bZuzm8s1ceuBUnMUAeoAHHw,10,10,7,0,6,0,4,0,27,3.857142857142857,1,0.0,0,7,0,6,10,0,0,4,0,13,14,0
8468,110051,UCDPR1k7RkPBDIde3KiukiosB55WbRVo,bWdj2GDclj5ofokWjzoa5jAwMkxCykd6,1,0,0,0,0,0,1,0,1,0.14285714285714285,1,0.0,0,0,0,0,0,0,0,1,0,0,1,1
8469,110053,gaD5Av49rKMTRISUDiGUl6H5FYk7vPMw,G8EPVSXsOYB5YQWZGiz1aVq5Pgr2GrQu,29,35,4,66,6,2,3,1,117,16.714285714285715,1,0.0,21,4,51,6,14,2,15,3,1,82,35,0
8470,110060,HAmydfc2dHhpF7W3j97KPwhZZY0mGz44,bWdj2GDclj5ofokWjzoa5jAwMkxCykd6,6,1,0,0,0,0,8,1,10,1.4285714285714286,2,0.0,0,0,0,0,1,0,0,8,1,0,10,1
8471,113825,xUhDcXiX03QQg1jNR3Lksh9CrGcRUkPg,7GRhBDsirIGkRZBtSMEzNTyDr2JQm4xx,38,83,3,20,11,7,19,0,143,20.428571428571427,8,0.0,29,3,12,11,54,7,8,19,0,55,88,0
8472,113845,EwpbggvNdZkeSTjdG48aEltlJYavm02s,7GRhBDsirIGkRZBtSMEzNTyDr2JQm4xx,4,2,1,0,1,0,1,0,5,0.7142857142857143,1,0.0,0,1,0,1,2,0,0,1,0,2,3,1
8473,113846,7hhGe4WcGEHypOzIVz3DLRx9GS52ozkE,7GRhBDsirIGkRZBtSMEzNTyDr2JQm4xx,40,59,25,58,16,0,7,0,165,23.571428571428573,5,0.0,26,25,51,16,33,0,7,7,0,118,47,1
8474,113935,nDRvdnRCphlivJCuFTuhDKgd5jyHoHuK,7GRhBDsirIGkRZBtSMEzNTyDr2JQm4xx,98,261,139,183,66,7,45,1,702,100.28571428571429,15,0.0,82,139,153,66,179,7,30,45,1,440,262,0
8475,113957,JoqAGqbao71wc04PyVzx7SVvlZZ0knbI,7GRhBDsirIGkRZBtSMEzNTyDr2JQm4xx,35,103,31,58,7,14,17,0,230,32.857142857142854,4,0.0,49,31,54,7,54,14,4,17,0,141,89,1
8476,114029,B7LHt2Cj2bBAHJSILTk3b5ZvfNYywzep,7GRhBDsirIGkRZBtSMEzNTyDr2JQm4xx,9,6,3,0,1,0,5,0,15,2.142857142857143,1,0.0,1,3,0,1,5,0,0,5,0,5,10,1
8477,114045,40f11BuizcEv7ZFFxcPqa0v1O1iUUbkI,7GRhBDsirIGkRZBtSMEzNTyDr2JQm4xx,7,9,5,0,2,0,3,0,19,2.7142857142857144,3,0.0,1,5,0,2,8,0,0,3,0,8,11,1
8478,114118,hNtOw8NhFSEVmWVm0uZ7niVIy1y64lqK,7GRhBDsirIGkRZBtSMEzNTyDr2JQm4xx,4,0,0,0,0,0,11,0,11,1.5714285714285714,3,0.0,0,0,0,0,0,0,0,11,0,0,11,1
8479,114136,tkUa5CpArdCreqMyzIcAuTFrrxiEVJbS,7GRhBDsirIGkRZBtSMEzNTyDr2JQm4xx,38,44,19,34,14,15,14,0,140,20.0,3,0.0,22,19,29,14,22,15,5,14,0,84,56,1
8480,114140,nUWkRuhBy34ASlaPMCQ75Oelnn64cfdy,7GRhBDsirIGkRZBtSMEzNTyDr2JQm4xx,52,151,53,36,45,10,21,1,317,45.285714285714285,4,0.0,87,53,33,45,64,10,3,21,1,218,99,0
8481,114147,okqN4nBVKRYYrkYonKicKGOmPqVGYjZh,7GRhBDsirIGkRZBtSMEzNTyDr2JQm4xx,4,3,1,0,0,0,4,0,8,1.1428571428571428,2,0.0,0,1,0,0,3,0,0,4,0,1,7,0
8482,114179,QZbPGbTnAqz8GS6cm25XcpeiETovvLN6,7GRhBDsirIGkRZBtSMEzNTyDr2JQm4xx,89,174,42,140,42,9,32,1,440,62.857142857142854,4,0.0,94,42,109,42,80,9,31,32,1,287,153,0
8483,114255,dtcl5eI6yhwMyoweqshgFuTzKqFJQm0u,7GRhBDsirIGkRZBtSMEzNTyDr2JQm4xx,2,0,0,0,0,0,3,0,3,0.42857142857142855,1,0.0,0,0,0,0,0,0,0,3,0,0,3,1
8484,114289,yt0pMjWs1WUyd9gdp8SqXOjWyU58K3uA,7GRhBDsirIGkRZBtSMEzNTyDr2JQm4xx,2,0,0,0,0,0,2,0,2,0.2857142857142857,2,0.0,0,0,0,0,0,0,0,2,0,0,2,1
8485,114349,HHtkMPGPD7M5HjKp2cITsAXThUPUGeqi,7GRhBDsirIGkRZBtSMEzNTyDr2JQm4xx,49,141,49,101,34,10,14,0,349,49.857142857142854,5,0.0,68,49,88,34,73,10,13,14,0,239,110,1
8486,114404,RrDvHNy910b7XxqIkvHWSamS4IG3fgCH,7GRhBDsirIGkRZBtSMEzNTyDr2JQm4xx,1,0,0,0,0,0,1,0,1,0.14285714285714285,1,0.0,0,0,0,0,0,0,0,1,0,0,1,1
8487,114429,NEVPUSDkU7HaE7xRESmGkn6KaWhWlNDH,7GRhBDsirIGkRZBtSMEzNTyDr2JQm4xx,11,19,4,51,0,0,1,0,75,10.714285714285714,1,0.0,14,4,44,0,5,0,7,1,0,62,13,1
8488,114458,hu8eak1Xmf8voE8pnxPzkSD2dZP9Sipf,7GRhBDsirIGkRZBtSMEzNTyDr2JQm4xx,56,45,0,75,0,4,22,0,146,20.857142857142858,5,0.0,28,0,75,0,17,4,0,22,0,103,43,0
8489,114460,gBUQvhjVwGtG2bUGFkuQNt86DA2hmTm5,7GRhBDsirIGkRZBtSMEzNTyDr2JQm4xx,51,188,99,64,60,3,37,3,454,64.85714285714286,5,0.0,79,99,54,60,109,3,10,37,3,292,162,1
8490,114491,MU4dVyJTD7iIRSTZIdJZ9VoLOxogfKQN,7GRhBDsirIGkRZBtSMEzNTyDr2JQm4xx,4,2,1,0,1,0,1,0,5,0.7142857142857143,1,0.0,0,1,0,1,2,0,0,1,0,2,3,1
8491,114492,oxOzo82Nq65tcwE6AZvxglw3lN8SeywJ,7GRhBDsirIGkRZBtSMEzNTyDr2JQm4xx,5,2,1,0,1,0,2,0,6,0.8571428571428571,1,0.0,0,1,0,1,2,0,0,2,0,2,4,1
8492,114508,DahdU3m64q9GHbzMvs6TdHVFTDo4asbt,7GRhBDsirIGkRZBtSMEzNTyDr2JQm4xx,13,5,3,0,2,10,15,6,41,5.857142857142857,2,0.0,0,3,0,2,5,10,0,15,6,5,36,0
8493,114536,BIrtFqgMfUNvzbgStoEGnPt5I5Uav700,7GRhBDsirIGkRZBtSMEzNTyDr2JQm4xx,1,0,0,0,0,0,1,0,1,0.14285714285714285,1,0.0,0,0,0,0,0,0,0,1,0,0,1,1
8494,114546,CKlPS4aJNSCYcpmTEnTkXSXKz4jn8q0W,7GRhBDsirIGkRZBtSMEzNTyDr2JQm4xx,2,0,0,0,0,0,2,0,2,0.2857142857142857,1,0.0,0,0,0,0,0,0,0,2,0,0,2,1
8495,114562,BQSRjVmgixA5nv8k53vKwJ20bVp0NOMd,7GRhBDsirIGkRZBtSMEzNTyDr2JQm4xx,95,126,45,117,45,124,28,2,487,69.57142857142857,7,0.0,67,45,100,45,59,124,17,28,2,257,230,0
8496,114597,rwCHpAN1sY0GvFYG7zQQk2qpgkOBz9O3,7GRhBDsirIGkRZBtSMEzNTyDr2JQm4xx,1,0,0,0,0,0,1,0,1,0.14285714285714285,1,0.0,0,0,0,0,0,0,0,1,0,0,1,1
8497,114609,niCmhuSfQsMKGJA13iBf3xqhHudkRRY5,fbPkOYLVPtPgIt0MxizjfFJov3JbHyAi,10,17,8,0,5,3,18,0,51,7.285714285714286,2,0.0,0,8,0,5,17,3,0,18,0,13,38,0
8498,114611,5x7PJKAlpwjJHVKa6EUCDUMMHmJ1P3I6,fbPkOYLVPtPgIt0MxizjfFJov3JbHyAi,7,3,2,0,2,0,2,0,9,1.2857142857142858,1,0.0,0,2,0,2,3,0,0,2,0,4,5,1
8499,114613,ov7BYx7M6nQf9HtywUVu0CvVUbJ2cMz9,fbPkOYLVPtPgIt0MxizjfFJov3JbHyAi,5,2,1,0,1,1,4,0,9,1.2857142857142858,1,0.0,0,1,0,1,2,1,0,4,0,2,7,1
8500,114622,whDoakw9KuyWQ8M0W7cddKOMydB0d6nf,fbPkOYLVPtPgIt0MxizjfFJov3JbHyAi,15,29,9,8,16,12,7,0,81,11.571428571428571,2,0.0,18,9,6,16,11,12,2,7,0,49,32,1
8501,114626,6tmxpsRtsjoDY9zXnzo3i4nW1oQa44E2,fbPkOYLVPtPgIt0MxizjfFJov3JbHyAi,1,0,0,0,0,0,1,0,1,0.14285714285714285,1,0.0,0,0,0,0,0,0,0,1,0,0,1,0
8502,114627,uKuE1pqPLKBLlaDHpMsHUJvLz6lxiokY,fbPkOYLVPtPgIt0MxizjfFJov3JbHyAi,11,25,13,0,10,0,5,0,53,7.571428571428571,2,0.0,0,13,0,10,25,0,0,5,0,23,30,1
8503,114634,5MFqn51ngpNJRILTITSLFdc469nefTuS,fbPkOYLVPtPgIt0MxizjfFJov3JbHyAi,9,5,2,0,2,3,4,1,17,2.4285714285714284,1,0.0,2,2,0,2,3,3,0,4,1,6,11,1
8504,114639,IXyECojptU5NkfL9RFdtwIRy87m56pw9,fbPkOYLVPtPgIt0MxizjfFJov3JbHyAi,46,170,79,66,38,69,91,27,540,77.14285714285714,15,0.0,49,79,42,38,121,69,24,91,27,208,332,1
8505,114643,WfE8YobKj49KJJchFTR0mkLGdZ0KFFcq,fbPkOYLVPtPgIt0MxizjfFJov3JbHyAi,7,3,2,0,2,6,3,0,16,2.2857142857142856,1,0.0,0,2,0,2,3,6,0,3,0,4,12,1
8506,114652,wuaIkUodYTr49NZ7BbMPsEdpO0t0C8Nt,fbPkOYLVPtPgIt0MxizjfFJov3JbHyAi,22,44,1,15,3,4,14,0,81,11.571428571428571,4,0.0,11,1,12,3,33,4,3,14,0,27,54,1
8507,117347,Lmy48LaZfIr9H2JGohLJKVaIoB8r8qji,fbPkOYLVPtPgIt0MxizjfFJov3JbHyAi,7,3,2,0,2,0,4,0,11,1.5714285714285714,1,0.0,0,2,0,2,3,0,0,4,0,4,7,1
8508,117348,5qhlEY7iczknBOw4qaTj0oiHyjQVe9rT,fbPkOYLVPtPgIt0MxizjfFJov3JbHyAi,4,2,1,0,1,0,1,0,5,0.7142857142857143,1,0.0,0,1,0,1,2,0,0,1,0,2,3,1
8509,117349,CcuDWPt1eyW7M86jUsYuAZO2EZvkv343,fbPkOYLVPtPgIt0MxizjfFJov3JbHyAi,2,0,0,0,0,0,2,0,2,0.2857142857142857,1,0.0,0,0,0,0,0,0,0,2,0,0,2,1
8510,117350,THBV67QwrR4fvYsMOGo7siHXFao0S7M8,fbPkOYLVPtPgIt0MxizjfFJov3JbHyAi,4,2,1,0,1,0,1,0,5,0.7142857142857143,1,0.0,0,1,0,1,2,0,0,1,0,2,3,1
8511,117351,S6eQGQp3K76RS5VMtIsaLuIm5UHtwYF7,fbPkOYLVPtPgIt0MxizjfFJov3JbHyAi,5,2,1,0,1,0,4,0,8,1.1428571428571428,1,0.0,0,1,0,1,2,0,0,4,0,2,6,1
8512,117352,W8LiHDfUOd6JJS4l21H06gvkeAd3UQzA,fbPkOYLVPtPgIt0MxizjfFJov3JbHyAi,8,6,2,0,3,0,6,0,17,2.4285714285714284,2,0.0,3,2,0,3,3,0,0,6,0,8,9,1
8513,117353,qsIC4v5Dx0AC8V7VvfXbXh1Orc1wEb3w,fbPkOYLVPtPgIt0MxizjfFJov3JbHyAi,2,0,0,0,0,0,4,0,4,0.5714285714285714,2,0.0,0,0,0,0,0,0,0,4,0,0,4,1
8514,117354,wJflvpFe05Aoyiv7JkqhQs7iDcvnIpoZ,fbPkOYLVPtPgIt0MxizjfFJov3JbHyAi,23,95,36,22,66,45,14,0,278,39.714285714285715,4,0.0,16,36,19,66,79,45,3,14,0,137,141,0
8515,117355,HymjYRZjO8zO0eFKC26krqimHj67lbM0,fbPkOYLVPtPgIt0MxizjfFJov3JbHyAi,9,3,2,0,2,12,13,1,33,4.714285714285714,1,0.0,0,2,0,2,3,12,0,13,1,4,29,1
8516,117356,BEpwi711y09XyC4DFTNZ8NMJ5PwUJeE1,fbPkOYLVPtPgIt0MxizjfFJov3JbHyAi,57,202,87,56,25,103,46,6,525,75.0,13,0.0,36,87,53,25,166,103,3,46,6,201,324,0
8517,117357,jdo8ZaITXdNg3iaXD5IuBNuDQn99Df8w,fbPkOYLVPtPgIt0MxizjfFJov3JbHyAi,6,6,3,0,1,0,2,0,12,1.7142857142857142,2,0.0,0,3,0,1,6,0,0,2,0,4,8,1
8518,117358,VIIC2sfSYNNzIhFTDhqx6glGRp1LLtBP,fbPkOYLVPtPgIt0MxizjfFJov3JbHyAi,1,0,0,0,0,0,1,0,1,0.14285714285714285,1,0.0,0,0,0,0,0,0,0,1,0,0,1,1
8519,117359,1fv3phUYFf4MQkWpDcJllU01xcW0vo3W,fbPkOYLVPtPgIt0MxizjfFJov3JbHyAi,4,2,1,0,1,0,1,0,5,0.7142857142857143,1,0.0,0,1,0,1,2,0,0,1,0,2,3,1
8520,117360,u8qSA6tNYpciCcX3NsOlG8kpTSmTzvQW,fbPkOYLVPtPgIt0MxizjfFJov3JbHyAi,1,0,0,0,0,0,1,0,1,0.14285714285714285,1,0.0,0,0,0,0,0,0,0,1,0,0,1,1
8521,117361,YmW9sTTkl6fJ0hETvvamJqK86iqzkJtX,fbPkOYLVPtPgIt0MxizjfFJov3JbHyAi,9,12,7,0,4,3,3,0,29,4.142857142857143,2,0.0,0,7,0,4,12,3,0,3,0,11,18,1
8522,117362,GhH23XxJCtHV5BHmHgLHMs1bT51czMlK,fbPkOYLVPtPgIt0MxizjfFJov3JbHyAi,2,0,0,0,0,0,8,0,8,1.1428571428571428,1,0.0,0,0,0,0,0,0,0,8,0,0,8,1
8523,117363,jpOV5NTWg54y4Oc7tw4bVLxYduaerIGO,fbPkOYLVPtPgIt0MxizjfFJov3JbHyAi,5,2,1,0,1,0,4,0,8,1.1428571428571428,1,0.0,0,1,0,1,2,0,0,4,0,2,6,1
8524,117364,gVDka1k86106F8RxhzEk3T4GWmptct3j,fbPkOYLVPtPgIt0MxizjfFJov3JbHyAi,5,2,1,0,1,0,5,0,9,1.2857142857142858,1,0.0,0,1,0,1,2,0,0,5,0,2,7,1
8525,117365,Jab5g3oUGQ9SaeNRnULqHnW16VXqaDjO,fbPkOYLVPtPgIt0MxizjfFJov3JbHyAi,5,3,1,0,1,0,4,0,9,1.2857142857142858,1,0.0,0,1,0,1,3,0,0,4,0,2,7,0
8526,117366,dzyBEAqhGTXZ2XFaP0jn5Y8xrnIodQ3R,fbPkOYLVPtPgIt0MxizjfFJov3JbHyAi,1,0,0,0,0,0,1,0,1,0.14285714285714285,1,0.0,0,0,0,0,0,0,0,1,0,0,1,1
8527,117369,84MmPDpZ0YkQ5nQqNX1rbALt0YU3wNuB,fbPkOYLVPtPgIt0MxizjfFJov3JbHyAi,6,1,0,0,0,0,8,1,10,1.4285714285714286,1,0.0,0,0,0,0,1,0,0,8,1,0,10,1
8528,117371,yr7gisoB3gNrf1PYumUdBsd83AKA13gw,fbPkOYLVPtPgIt0MxizjfFJov3JbHyAi,2,0,0,0,0,0,4,0,4,0.5714285714285714,1,0.0,0,0,0,0,0,0,0,4,0,0,4,1
8529,117372,frevGWOFyf2Wo6uQjpFNvZnyWeFbKP0E,fbPkOYLVPtPgIt0MxizjfFJov3JbHyAi,42,32,17,28,14,5,7,0,103,14.714285714285714,3,0.0,12,17,26,14,20,5,2,7,0,69,34,1
8530,117373,FAatoUEhCvhRpOYbmvA32pbUt7RdzYRu,fbPkOYLVPtPgIt0MxizjfFJov3JbHyAi,5,2,1,0,1,0,5,0,9,1.2857142857142858,1,0.0,0,1,0,1,2,0,0,5,0,2,7,1
8531,117374,ZMs9DXI7ESTFKW1YBMWs95iQQk6J7X2z,fbPkOYLVPtPgIt0MxizjfFJov3JbHyAi,5,3,1,0,1,2,4,0,11,1.5714285714285714,1,0.0,0,1,0,1,3,2,0,4,0,2,9,1
8532,117375,70RbSAVcGIyny9mWjCd20wt9FfgzeOIU,fbPkOYLVPtPgIt0MxizjfFJov3JbHyAi,12,25,12,0,4,12,16,1,70,10.0,4,0.0,0,12,0,4,25,12,0,16,1,16,54,1
8533,117376,7RSTSE7CX0EZRW2RDRnKS7CJkHtK7gJx,fbPkOYLVPtPgIt0MxizjfFJov3JbHyAi,4,3,1,0,1,3,1,0,9,1.2857142857142858,1,0.0,0,1,0,1,3,3,0,1,0,2,7,0
8534,117378,9jhH7wrMd3Eqw0VV440Dc9UHr2dQD82o,fbPkOYLVPtPgIt0MxizjfFJov3JbHyAi,6,1,1,0,1,0,5,0,8,1.1428571428571428,1,0.0,0,1,0,1,1,0,0,5,0,2,6,1
8535,117381,WeKk3LPA70V1znb6M7iSuaLFtRvTgv4L,fbPkOYLVPtPgIt0MxizjfFJov3JbHyAi,4,2,1,0,1,0,1,0,5,0.7142857142857143,1,0.0,0,1,0,1,2,0,0,1,0,2,3,1
8536,117383,cgR6Sk6i1HisakMjtLETZQtfL4e89Msk,fbPkOYLVPtPgIt0MxizjfFJov3JbHyAi,2,0,0,0,0,0,2,0,2,0.2857142857142857,1,0.0,0,0,0,0,0,0,0,2,0,0,2,1
8537,117384,QE7VYemIj4pMHXuEl2xp801KoSOaKbg6,fbPkOYLVPtPgIt0MxizjfFJov3JbHyAi,10,10,5,0,4,0,7,0,26,3.7142857142857144,2,0.0,2,5,0,4,8,0,0,7,0,11,15,1
8538,117387,Q6xW7zlgn9B8VyFUYRYPAiN0jH5lh0YZ,fbPkOYLVPtPgIt0MxizjfFJov3JbHyAi,5,3,1,0,1,0,5,0,10,1.4285714285714286,1,0.0,0,1,0,1,3,0,0,5,0,2,8,1
8539,117388,cdL4DEn7NceHWkENWhz16RxoYhvN1B4t,fbPkOYLVPtPgIt0MxizjfFJov3JbHyAi,9,9,4,0,3,3,7,1,27,3.857142857142857,1,0.0,3,4,0,3,6,3,0,7,1,10,17,1
8540,117390,CadKUf2Mul3ALexXlY5uWvTQFtSrVs8p,fbPkOYLVPtPgIt0MxizjfFJov3JbHyAi,5,2,1,0,1,0,2,0,6,0.8571428571428571,1,0.0,0,1,0,1,2,0,0,2,0,2,4,1
8541,117391,dGox9f4ZDlHQwjKRHa3wEmIJzGDWDxPX,fbPkOYLVPtPgIt0MxizjfFJov3JbHyAi,15,21,7,17,10,10,9,0,74,10.571428571428571,2,0.0,12,7,12,10,9,10,5,9,0,41,33,1
8542,117392,A3rmkE1bnOg1XwxjYHudD7UFmCyTX4Vy,fbPkOYLVPtPgIt0MxizjfFJov3JbHyAi,5,2,1,0,1,0,2,0,6,0.8571428571428571,1,0.0,0,1,0,1,2,0,0,2,0,2,4,1
8543,117393,1NRhqP9avvdGMFKMKghbEOxv5wnexLIt,fbPkOYLVPtPgIt0MxizjfFJov3JbHyAi,2,0,0,0,0,0,4,0,4,0.5714285714285714,1,0.0,0,0,0,0,0,0,0,4,0,0,4,1
8544,117394,x61GVEFoUQZEIHnVsxBCw0kitfDOhP0p,fbPkOYLVPtPgIt0MxizjfFJov3JbHyAi,40,75,45,10,31,96,28,1,286,40.857142857142854,5,0.0,13,45,9,31,62,96,1,28,1,98,188,1
8545,117395,Mh66DLCMXZ6dBObZWAREClnDkNcjPB4t,fbPkOYLVPtPgIt0MxizjfFJov3JbHyAi,5,2,1,0,1,0,4,0,8,1.1428571428571428,1,0.0,0,1,0,1,2,0,0,4,0,2,6,1
8546,117398,RToZJlmZ1SKeCpqwz31BArcaj4qy0SaF,fbPkOYLVPtPgIt0MxizjfFJov3JbHyAi,2,0,0,0,0,0,2,0,2,0.2857142857142857,1,0.0,0,0,0,0,0,0,0,2,0,0,2,1
8547,117400,DYhAozmaoJyITokVWonroVftsEgv5K6H,fbPkOYLVPtPgIt0MxizjfFJov3JbHyAi,7,3,2,0,2,0,4,0,11,1.5714285714285714,1,0.0,0,2,0,2,3,0,0,4,0,4,7,1
8548,117401,8loJZqV93UIB0LVEOgs0qIcfMBhyuVR4,fbPkOYLVPtPgIt0MxizjfFJov3JbHyAi,5,2,1,0,1,0,2,0,6,0.8571428571428571,1,0.0,0,1,0,1,2,0,0,2,0,2,4,1
8549,117402,BdMHqR5WAKDssANXDMso5QusZ7X7eexo,fbPkOYLVPtPgIt0MxizjfFJov3JbHyAi,25,89,34,11,20,37,10,1,202,28.857142857142858,3,0.0,31,34,10,20,58,37,1,10,1,95,107,1
8550,117403,AyVFKMWjzC4gPpDsd8ofzYs7TtpYPztD,fbPkOYLVPtPgIt0MxizjfFJov3JbHyAi,7,4,2,0,1,0,5,0,12,1.7142857142857142,1,0.0,0,2,0,1,4,0,0,5,0,3,9,1
8551,117404,C89edYjc0egHm9DK0UhG6TICXc3cgfYt,fbPkOYLVPtPgIt0MxizjfFJov3JbHyAi,4,2,1,0,0,0,2,0,5,0.7142857142857143,1,0.0,0,1,0,0,2,0,0,2,0,1,4,1
8552,117406,skfYGEKD2YfFTJGYxEqRg06NVhsZf6hd,fbPkOYLVPtPgIt0MxizjfFJov3JbHyAi,2,0,0,0,0,0,2,0,2,0.2857142857142857,1,0.0,0,0,0,0,0,0,0,2,0,0,2,1
8553,117411,K22VFryh5Od9V1LL0eOyTaqPsCNGJ8v3,fbPkOYLVPtPgIt0MxizjfFJov3JbHyAi,5,1,1,0,1,0,2,0,5,0.7142857142857143,1,0.0,0,1,0,1,1,0,0,2,0,2,3,1
8554,117412,27mdD0tYMMLTpcK2D7h6xnCOldDDzHch,fbPkOYLVPtPgIt0MxizjfFJov3JbHyAi,8,17,6,0,3,0,2,0,28,4.0,2,0.0,2,6,0,3,15,0,0,2,0,11,17,1
8555,117413,ZcypYnlQeadTdUIaT74Rv3xxhxFofUjh,fbPkOYLVPtPgIt0MxizjfFJov3JbHyAi,5,2,1,0,1,0,6,0,10,1.4285714285714286,1,0.0,0,1,0,1,2,0,0,6,0,2,8,1
8556,117414,u601bf5LgTloUnzWrvF8VsEbNdAIplE1,fbPkOYLVPtPgIt0MxizjfFJov3JbHyAi,7,3,2,0,2,0,4,0,11,1.5714285714285714,1,0.0,0,2,0,2,3,0,0,4,0,4,7,1
8557,117415,4Qo7Z1J3GHBpS2AY75HBdWU9Il8Ha5mP,fbPkOYLVPtPgIt0MxizjfFJov3JbHyAi,13,17,6,1,8,9,10,1,52,7.428571428571429,1,0.0,9,6,1,8,8,9,0,10,1,24,28,1
8558,117416,no2ug7TKVsupL4LU2a5jY2GhYHkskTdw,fbPkOYLVPtPgIt0MxizjfFJov3JbHyAi,44,79,42,30,19,9,19,0,198,28.285714285714285,8,0.0,22,42,24,19,57,9,6,19,0,107,91,1
8559,117417,MWcyYl4VKJ6gXYTCZ6GsdLjzmXlJRZpp,fbPkOYLVPtPgIt0MxizjfFJov3JbHyAi,10,9,2,0,3,21,12,4,51,7.285714285714286,2,0.0,2,2,0,3,7,21,0,12,4,7,44,1
8560,117418,xO9ez1QwXcTHUWvk9yY6tpiPg2NpvI40,fbPkOYLVPtPgIt0MxizjfFJov3JbHyAi,7,3,2,0,2,0,2,0,9,1.2857142857142858,1,0.0,0,2,0,2,3,0,0,2,0,4,5,1
8561,117419,EDx8dOeIuSiG4dzn3b6IyJq074mUoFqU,fbPkOYLVPtPgIt0MxizjfFJov3JbHyAi,2,0,0,0,0,0,4,0,4,0.5714285714285714,1,0.0,0,0,0,0,0,0,0,4,0,0,4,1
8562,117422,3ufcPQa9fE8hNqWpP8Ewk6MLJ169ewYG,fbPkOYLVPtPgIt0MxizjfFJov3JbHyAi,9,15,3,0,2,0,4,0,24,3.4285714285714284,2,0.0,0,3,0,2,15,0,0,4,0,5,19,1
8563,117423,NXEwBXbU6vvce77sujWgRB6LivhFJvRb,fbPkOYLVPtPgIt0MxizjfFJov3JbHyAi,8,11,7,0,2,0,5,0,25,3.5714285714285716,3,0.0,0,7,0,2,11,0,0,5,0,9,16,1
8564,117424,ksf7O5VoxfMEE12hvGca3f6KoMnOQ3Bh,fbPkOYLVPtPgIt0MxizjfFJov3JbHyAi,5,5,0,0,0,0,7,0,12,1.7142857142857142,1,0.0,0,0,0,0,5,0,0,7,0,0,12,1
8565,117427,bGLdkKassDYyZB9t4bgBBFjAHmjUsNSR,fbPkOYLVPtPgIt0MxizjfFJov3JbHyAi,7,3,1,0,1,1,7,1,14,2.0,1,0.0,0,1,0,1,3,1,0,7,1,2,12,1
8566,117428,es5zwE1DJ3gcng5ye9rbNjDc6YGVZjjA,fbPkOYLVPtPgIt0MxizjfFJov3JbHyAi,7,4,3,0,2,0,4,0,13,1.8571428571428572,1,0.0,0,3,0,2,4,0,0,4,0,5,8,1
8567,117431,da6MhMlDFSRLmIrClGzjJtU8eL0pm2dy,fbPkOYLVPtPgIt0MxizjfFJov3JbHyAi,5,2,1,0,1,0,2,0,6,0.8571428571428571,1,0.0,0,1,0,1,2,0,0,2,0,2,4,1
8568,117433,M75L90OOMTV1kEiI3n7vM0ty47YBFna9,fbPkOYLVPtPgIt0MxizjfFJov3JbHyAi,7,6,3,0,2,0,2,0,13,1.8571428571428572,2,0.0,0,3,0,2,6,0,0,2,0,5,8,1
8569,117435,Mal0OrUqylh9gVaeGBMc9fi4hOm7CY1j,fbPkOYLVPtPgIt0MxizjfFJov3JbHyAi,5,3,1,0,1,0,4,0,9,1.2857142857142858,1,0.0,0,1,0,1,3,0,0,4,0,2,7,1
8570,117436,CarlVCnkEuEWdxEFIyhyUfB0cb91lk3u,fbPkOYLVPtPgIt0MxizjfFJov3JbHyAi,5,2,1,0,1,1,4,0,9,1.2857142857142858,1,0.0,0,1,0,1,2,1,0,4,0,2,7,1
8571,117438,tD6MzN5QxvGBHQOVcmWLTvbMypNYMcey,fbPkOYLVPtPgIt0MxizjfFJov3JbHyAi,6,3,2,0,2,0,1,0,8,1.1428571428571428,1,0.0,0,2,0,2,3,0,0,1,0,4,4,1
8572,117439,vEs30RoWqgpB6hECbcLmFiwxEohGiKSd,fbPkOYLVPtPgIt0MxizjfFJov3JbHyAi,5,2,0,0,0,8,3,0,13,1.8571428571428572,1,0.0,0,0,0,0,2,8,0,3,0,0,13,1
8573,117440,IvHnLbw6NP6LhhQqreTJbhNQU5Zs6JCF,fbPkOYLVPtPgIt0MxizjfFJov3JbHyAi,4,2,1,0,1,0,2,0,6,0.8571428571428571,1,0.0,0,1,0,1,2,0,0,2,0,2,4,1
8574,117441,HptEZjRmdOpiqQNtiQtuC0XhWeQWrU1F,fbPkOYLVPtPgIt0MxizjfFJov3JbHyAi,2,0,0,0,0,0,2,0,2,0.2857142857142857,1,0.0,0,0,0,0,0,0,0,2,0,0,2,1
8575,117448,EVLibPakJPGsb5a9opPnLRzSILBMV36m,fbPkOYLVPtPgIt0MxizjfFJov3JbHyAi,7,2,1,0,1,1,7,1,13,1.8571428571428572,1,0.0,0,1,0,1,2,1,0,7,1,2,11,1
8576,117449,jfWbgHyvVBGKbleke3IOJ4RuvBB6sx7J,fbPkOYLVPtPgIt0MxizjfFJov3JbHyAi,9,5,3,0,3,0,3,0,14,2.0,2,0.0,0,3,0,3,5,0,0,3,0,6,8,1
8577,117450,NTi3RF6xGnkzsfYTj8D33u4sH3LbVAHE,fbPkOYLVPtPgIt0MxizjfFJov3JbHyAi,23,56,26,46,0,0,12,0,140,20.0,3,0.0,20,26,40,0,36,0,6,12,0,86,54,1
8578,117451,8TpvgxjbFSiTX0WEWOAldouvOlu5hbct,fbPkOYLVPtPgIt0MxizjfFJov3JbHyAi,5,2,0,0,0,22,4,0,28,4.0,1,0.0,0,0,0,0,2,22,0,4,0,0,28,1
8579,117453,GOoApgMbqW9QFX07cCt2mUBIZ8txh6qT,fbPkOYLVPtPgIt0MxizjfFJov3JbHyAi,9,17,9,0,9,15,1,0,51,7.285714285714286,1,0.0,6,9,0,9,11,15,0,1,0,24,27,1
8580,117455,HTst2SMNdS0XNA43FeobA5o05v7CUlNA,fbPkOYLVPtPgIt0MxizjfFJov3JbHyAi,25,42,17,22,18,2,6,1,108,15.428571428571429,1,0.0,22,17,21,18,20,2,1,6,1,78,30,0
8581,117456,PgMYw44fTh4Xx5U2R8ETG8pzBeXCE15Z,fbPkOYLVPtPgIt0MxizjfFJov3JbHyAi,1,0,0,0,0,0,1,0,1,0.14285714285714285,1,0.0,0,0,0,0,0,0,0,1,0,0,1,1
8582,117457,AFgD1DLeorByrsoA4AU51GpZfc6uZUVB,fbPkOYLVPtPgIt0MxizjfFJov3JbHyAi,6,7,3,0,2,0,1,0,13,1.8571428571428572,1,0.0,0,3,0,2,7,0,0,1,0,5,8,1
8583,117458,Uc3HK5Q0vMTy3ljdUcEzfnFcMiWvgtMK,fbPkOYLVPtPgIt0MxizjfFJov3JbHyAi,5,1,1,0,1,0,2,0,5,0.7142857142857143,1,0.0,0,1,0,1,1,0,0,2,0,2,3,1
8584,117459,8BPmxHv8u8jXk5HWBs0qXnY9uZ2rLMGq,fbPkOYLVPtPgIt0MxizjfFJov3JbHyAi,5,10,3,0,2,0,2,0,17,2.4285714285714284,4,0.0,0,3,0,2,10,0,0,2,0,5,12,0
8585,117461,OakZIwMalw5UgG2N0rTydClOEPiV8rki,fbPkOYLVPtPgIt0MxizjfFJov3JbHyAi,16,37,15,10,9,6,4,0,81,11.571428571428571,3,0.0,5,15,10,9,32,6,0,4,0,39,42,1
8586,117462,t9DYQDh2NoshF6BVBhwjK6lRvYfkvSI9,fbPkOYLVPtPgIt0MxizjfFJov3JbHyAi,5,2,1,0,1,0,4,0,8,1.1428571428571428,1,0.0,0,1,0,1,2,0,0,4,0,2,6,1
8587,117463,KMNMpAumo6Yq2T1usaL4CulVhqgN4Ggl,fbPkOYLVPtPgIt0MxizjfFJov3JbHyAi,10,4,3,0,3,0,5,0,15,2.142857142857143,1,0.0,0,3,0,3,4,0,0,5,0,6,9,1
8588,117464,SiySM3c36hCdKDVaWJXLlC2PBQXet4s6,fbPkOYLVPtPgIt0MxizjfFJov3JbHyAi,5,3,2,0,1,0,1,0,7,1.0,1,0.0,0,2,0,1,3,0,0,1,0,3,4,1
8589,117465,c0uK7fknnbIb1l1yn1QtakefMn1Gi8lI,fbPkOYLVPtPgIt0MxizjfFJov3JbHyAi,5,11,4,4,0,5,2,0,26,3.7142857142857144,2,0.0,6,4,4,0,5,5,0,2,0,14,12,1
8590,117466,f46TsvwYgA023En7b0jRPEBnKcXc3eeY,fbPkOYLVPtPgIt0MxizjfFJov3JbHyAi,1,0,0,0,0,0,1,0,1,0.14285714285714285,1,0.0,0,0,0,0,0,0,0,1,0,0,1,1
8591,117468,AyISABpEkA6iYSuwBUoEgieVOrxLsxsQ,fbPkOYLVPtPgIt0MxizjfFJov3JbHyAi,4,2,1,0,0,0,3,0,6,0.8571428571428571,1,0.0,0,1,0,0,2,0,0,3,0,1,5,1
8592,117469,L3IzrZCeDOJTtm8wqYhXyjKAgit0WIBa,fbPkOYLVPtPgIt0MxizjfFJov3JbHyAi,1,0,0,0,0,0,1,0,1,0.14285714285714285,1,0.0,0,0,0,0,0,0,0,1,0,0,1,1
8593,117471,yDbqTKS1iAgd89Ji6xK8IoXm0GxGr49P,fbPkOYLVPtPgIt0MxizjfFJov3JbHyAi,2,0,0,0,0,0,4,0,4,0.5714285714285714,1,0.0,0,0,0,0,0,0,0,4,0,0,4,1
8594,117473,5eQJepE2igmBlMYZK0syg6BGCi1adOu4,fbPkOYLVPtPgIt0MxizjfFJov3JbHyAi,5,2,1,0,1,0,2,0,6,0.8571428571428571,1,0.0,0,1,0,1,2,0,0,2,0,2,4,1
8595,117474,1HKWuDclbOiSiuIlQVduMPq7fJCJ9Rls,fbPkOYLVPtPgIt0MxizjfFJov3JbHyAi,8,27,10,0,2,0,6,0,45,6.428571428571429,3,0.0,3,10,0,2,24,0,0,6,0,15,30,1
8596,117475,SBljO82TZdHeWzc47l4IthlHIwfXwoH3,fbPkOYLVPtPgIt0MxizjfFJov3JbHyAi,7,5,3,0,3,0,6,0,17,2.4285714285714284,1,0.0,0,3,0,3,5,0,0,6,0,6,11,1
8597,117479,Hc79IVDWbH7OTe9ljIsaEhHZLqPrPrds,fbPkOYLVPtPgIt0MxizjfFJov3JbHyAi,7,4,3,0,3,0,2,0,12,1.7142857142857142,1,0.0,0,3,0,3,4,0,0,2,0,6,6,1
8598,117480,O85WftB5NCrDTb9pXVSgYQyFNgKq9cya,fbPkOYLVPtPgIt0MxizjfFJov3JbHyAi,8,6,4,0,3,0,5,0,18,2.5714285714285716,2,0.0,0,4,0,3,6,0,0,5,0,7,11,1
8599,117481,58Jq6K3XLZtch5ZG85QFaonKOWfQNCcP,fbPkOYLVPtPgIt0MxizjfFJov3JbHyAi,7,3,2,0,2,0,2,0,9,1.2857142857142858,1,0.0,0,2,0,2,3,0,0,2,0,4,5,1
8600,117482,ueh8Q0J414FE7Xmjqeh6AbzlK27RwSRw,fbPkOYLVPtPgIt0MxizjfFJov3JbHyAi,1,0,0,0,0,0,1,0,1,0.14285714285714285,1,0.0,0,0,0,0,0,0,0,1,0,0,1,1
8601,117486,XDj6kE9olAchZwfUS0dXzHZTiPPM5bec,fbPkOYLVPtPgIt0MxizjfFJov3JbHyAi,4,4,2,0,2,0,1,0,9,1.2857142857142858,1,0.0,0,2,0,2,4,0,0,1,0,4,5,1
8602,117487,UvYdE00Z5Ts8a6wK0WxKxxpGT2cAkrRh,fbPkOYLVPtPgIt0MxizjfFJov3JbHyAi,44,136,45,25,37,0,14,0,257,36.714285714285715,7,0.0,57,45,22,37,79,0,3,14,0,161,96,0
8603,117488,1CyCTZgUsAiY8PwSyUmbGce1pgpqezgo,fbPkOYLVPtPgIt0MxizjfFJov3JbHyAi,11,9,6,0,4,1,6,3,29,4.142857142857143,1,0.0,0,6,0,4,9,1,0,6,3,10,19,1
8604,117489,36E8EgprLSCZHQtlY5yjvPm97JUh2cfX,fbPkOYLVPtPgIt0MxizjfFJov3JbHyAi,1,0,0,0,0,0,1,0,1,0.14285714285714285,1,0.0,0,0,0,0,0,0,0,1,0,0,1,1
8605,117490,yCzdfwMA9QCcmr5ztirsmSQYamCmcIS7,fbPkOYLVPtPgIt0MxizjfFJov3JbHyAi,1,0,0,0,0,0,1,0,1,0.14285714285714285,1,0.0,0,0,0,0,0,0,0,1,0,0,1,1
8606,117491,WDD9a1qNUJX21r5OnYzYbe9snqA1PiYA,fbPkOYLVPtPgIt0MxizjfFJov3JbHyAi,9,4,3,0,3,0,2,0,12,1.7142857142857142,1,0.0,0,3,0,3,4,0,0,2,0,6,6,1
8607,117492,nsluEqDvvOEPdz5RzSmy7fU8guuqWKfm,fbPkOYLVPtPgIt0MxizjfFJov3JbHyAi,11,11,7,6,5,0,4,0,33,4.714285714285714,2,0.0,1,7,4,5,10,0,2,4,0,17,16,1
8608,117493,Cn5FQ7TJ9erBCpMOguGrs26OG5h6UtTt,fbPkOYLVPtPgIt0MxizjfFJov3JbHyAi,11,12,5,0,4,0,8,0,29,4.142857142857143,3,0.0,2,5,0,4,10,0,0,8,0,11,18,1
8609,117494,bXLdnFxUVQAW3oOCSdQxNLLTqr9NOtgu,fbPkOYLVPtPgIt0MxizjfFJov3JbHyAi,6,1,1,0,1,0,5,0,8,1.1428571428571428,3,0.0,0,1,0,1,1,0,0,5,0,2,6,1
8610,117495,ETdIqr5m0JR2Poccag4YWGY81ays6ejO,fbPkOYLVPtPgIt0MxizjfFJov3JbHyAi,4,2,0,0,0,0,6,0,8,1.1428571428571428,1,0.0,0,0,0,0,2,0,0,6,0,0,8,1
8611,117496,Hoitr98hXhrf7xDGgACEFamKhiarA3wg,fbPkOYLVPtPgIt0MxizjfFJov3JbHyAi,7,4,2,0,2,0,2,0,10,1.4285714285714286,1,0.0,1,2,0,2,3,0,0,2,0,5,5,0
8612,117501,Djtv0PgEw9uZSQc7WiXmZsJgnFOxrvrt,A3fsA9Zfv1X2fVEQhTw51lKENdNrEqT3,1,0,0,0,0,0,1,0,1,0.14285714285714285,1,0.0,0,0,0,0,0,0,0,1,0,0,1,1
8613,117509,ydSu1htsBf3RzcwY9UTcwNk58kfOh1CK,SpATywNh6bZuzm8s1ceuBUnMUAeoAHHw,15,23,1,12,1,0,8,0,45,6.428571428571429,6,0.0,0,1,11,1,23,0,1,8,0,13,32,0
8614,117515,Djtv0PgEw9uZSQc7WiXmZsJgnFOxrvrt,RXDvfPUBYFlVdlueBFbLW0mhhAyGEqpt,1,0,0,0,0,0,2,0,2,0.2857142857142857,2,0.0,0,0,0,0,0,0,0,2,0,0,2,1
8615,117517,s6b6Agzyi3Or4EEcsJYYkdvPZgCCL57f,A3fsA9Zfv1X2fVEQhTw51lKENdNrEqT3,20,14,9,0,7,0,7,0,37,5.285714285714286,2,0.0,0,9,0,7,14,0,0,7,0,16,21,1
8616,117534,qX3w4IgztgXyu9swieirFObama3kJyza,bWdj2GDclj5ofokWjzoa5jAwMkxCykd6,24,37,4,70,6,0,12,0,129,18.428571428571427,4,0.0,13,4,64,6,24,0,6,12,0,87,42,1
8617,117535,dB6JlfpSJir7ay6MgDMKvaO3E6lmbl8u,bWdj2GDclj5ofokWjzoa5jAwMkxCykd6,5,7,0,0,0,0,1,0,8,1.1428571428571428,1,0.0,0,0,0,0,7,0,0,1,0,0,8,1
8618,117536,f07Kut7kBpGHis5iRAbMzHKfd6CS5vLr,A3fsA9Zfv1X2fVEQhTw51lKENdNrEqT3,25,123,81,0,4,367,60,3,638,91.14285714285714,11,0.0,10,81,0,4,113,367,0,60,3,95,543,0
8619,117543,EX3gOxFqlG8z0KCJnBCBLiCIiQRkFF4q,bWdj2GDclj5ofokWjzoa5jAwMkxCykd6,4,1,0,0,0,0,4,0,5,0.7142857142857143,1,0.0,0,0,0,0,1,0,0,4,0,0,5,1
8620,117545,EX3gOxFqlG8z0KCJnBCBLiCIiQRkFF4q,G8EPVSXsOYB5YQWZGiz1aVq5Pgr2GrQu,15,8,4,8,3,0,6,0,29,4.142857142857143,1,0.0,3,4,5,3,5,0,3,6,0,15,14,1
8621,117546,EX3gOxFqlG8z0KCJnBCBLiCIiQRkFF4q,A3fsA9Zfv1X2fVEQhTw51lKENdNrEqT3,9,3,2,0,2,0,4,0,11,1.5714285714285714,1,0.0,0,2,0,2,3,0,0,4,0,4,7,1
8622,117552,wKSiPD3ccCI47tDYWhx56Wd2BJP8ki2L,SpATywNh6bZuzm8s1ceuBUnMUAeoAHHw,19,57,14,7,8,10,9,0,105,15.0,6,0.0,14,14,7,8,43,10,0,9,0,43,62,0
8623,117557,Z9nbZek76s4RBuA56w1WtME3e9ClZkaP,SpATywNh6bZuzm8s1ceuBUnMUAeoAHHw,26,18,12,18,7,1,2,0,58,8.285714285714286,1,0.0,5,12,15,7,13,1,3,2,0,39,19,0
8624,117561,ADL0cXowUMs4wyiAOHKMOrtTHu5tmUqi,A3fsA9Zfv1X2fVEQhTw51lKENdNrEqT3,39,34,18,100,1,0,26,0,179,25.571428571428573,9,0.0,2,18,93,1,32,0,7,26,0,114,65,0
8625,117563,W5xQOH5MemwXn7klqn6rjd1MM4WzuzQi,SpATywNh6bZuzm8s1ceuBUnMUAeoAHHw,30,24,13,26,7,0,12,0,82,11.714285714285714,5,0.0,7,13,23,7,17,0,3,12,0,50,32,0
8626,117573,0i4PCdH5yACfB3MbD4JgsC2DeGE0OI6C,SpATywNh6bZuzm8s1ceuBUnMUAeoAHHw,5,3,2,0,1,0,1,0,7,1.0,1,0.0,0,2,0,1,3,0,0,1,0,3,4,1
8627,117586,23MV7Tf2OIT2UG3xeA8mvmRw6rIFBd81,A3fsA9Zfv1X2fVEQhTw51lKENdNrEqT3,30,27,20,6,13,8,22,2,98,14.0,4,0.0,0,20,6,13,27,8,0,22,2,39,59,1
8628,117602,BcsAFxTYYWhC1bNDfK977UfoS17oCWvP,SpATywNh6bZuzm8s1ceuBUnMUAeoAHHw,25,53,4,27,0,4,12,2,102,14.571428571428571,4,0.0,20,4,23,0,33,4,4,12,2,47,55,0
8629,117611,BbvGM92sGSMMIrRMXDFdD1GEnySzXRYT,SpATywNh6bZuzm8s1ceuBUnMUAeoAHHw,21,56,5,32,1,0,13,0,107,15.285714285714286,11,0.0,13,5,30,1,43,0,2,13,0,49,58,0
8630,117616,GLClE8eg40BpWvmEfcSMwSvtSTOkzETn,SpATywNh6bZuzm8s1ceuBUnMUAeoAHHw,19,36,6,19,4,5,12,0,82,11.714285714285714,6,0.0,3,6,16,4,33,5,3,12,0,29,53,0
8631,117626,wj1Ce3w6RyUCBwI2hTV32GMvTMsHncyy,SpATywNh6bZuzm8s1ceuBUnMUAeoAHHw,14,11,5,17,3,0,2,0,38,5.428571428571429,1,0.0,5,5,15,3,6,0,2,2,0,28,10,1
8632,117653,xdxiKeJYKflgdr88D3HSJXuR1e81YpjG,A3fsA9Zfv1X2fVEQhTw51lKENdNrEqT3,25,21,16,0,11,0,7,0,55,7.857142857142857,4,0.0,0,16,0,11,21,0,0,7,0,27,28,1
8633,117662,1ujJ0EpnNLNXPSSRc7XEx7I0RReWnlus,SpATywNh6bZuzm8s1ceuBUnMUAeoAHHw,2,0,0,0,0,0,2,0,2,0.2857142857142857,1,0.0,0,0,0,0,0,0,0,2,0,0,2,1
8634,117664,wbMM6yL6hpsJkBDUrCRoi5Fuo2kgSUdK,SpATywNh6bZuzm8s1ceuBUnMUAeoAHHw,22,25,1,14,1,0,3,0,44,6.285714285714286,4,0.0,7,1,14,1,18,0,0,3,0,23,21,1
8635,117668,ZvlB6WVwV84B3g1S1DABzlXirXgL69kV,SpATywNh6bZuzm8s1ceuBUnMUAeoAHHw,14,16,5,19,4,0,13,0,57,8.142857142857142,6,0.0,11,5,16,4,5,0,3,13,0,36,21,1
8636,117669,3xN41ERTxK2f1CGWRDLSjBdLqp0aeXRu,SpATywNh6bZuzm8s1ceuBUnMUAeoAHHw,18,71,31,14,1,59,48,8,232,33.142857142857146,5,0.0,14,31,12,1,57,59,2,48,8,58,174,1
8637,117674,5MqtNGumkUVehW5cfaAfZ7nPmHPSTQ7V,bWdj2GDclj5ofokWjzoa5jAwMkxCykd6,1,0,0,0,0,0,1,0,1,0.14285714285714285,1,0.0,0,0,0,0,0,0,0,1,0,0,1,1
8638,117698,JjO25OOm89Iye7MTZHSNIwd1wvv7Llpy,bWdj2GDclj5ofokWjzoa5jAwMkxCykd6,8,2,1,0,1,2,8,1,15,2.142857142857143,2,0.0,0,1,0,1,2,2,0,8,1,2,13,1
8639,117703,70SrKRY1oWl5d62cNgc8OZe8Ra3cen1a,SpATywNh6bZuzm8s1ceuBUnMUAeoAHHw,26,88,3,37,1,38,23,1,191,27.285714285714285,10,0.0,41,3,32,1,47,38,5,23,1,77,114,0
8640,117724,IspEVPShBbjx8d4IihOvyrT9DEmhjxUS,SpATywNh6bZuzm8s1ceuBUnMUAeoAHHw,1,0,0,0,0,0,2,0,2,0.2857142857142857,1,0.0,0,0,0,0,0,0,0,2,0,0,2,1
8641,117730,ZRcEnEYSSBQbkjzMu7sidjbxasfrmw8l,A3fsA9Zfv1X2fVEQhTw51lKENdNrEqT3,38,48,23,78,2,0,11,0,162,23.142857142857142,3,0.0,1,23,62,2,47,0,16,11,0,88,74,0
8642,117732,cQJEH4N9NA86ElT2x4zkE6ToN6rVT4MQ,A3fsA9Zfv1X2fVEQhTw51lKENdNrEqT3,41,34,32,18,23,0,3,0,110,15.714285714285714,4,0.0,0,32,16,23,34,0,2,3,0,71,39,1
8643,117744,UqgvfgWyOQuTxiMgyBKfmUFRwGDD6lWb,SpATywNh6bZuzm8s1ceuBUnMUAeoAHHw,9,8,4,0,2,0,2,0,16,2.2857142857142856,1,0.0,3,4,0,2,5,0,0,2,0,9,7,0
8644,117749,yNygMjDRQbsmQrkdzv6Ni3gEhrA9rC9T,G8EPVSXsOYB5YQWZGiz1aVq5Pgr2GrQu,11,28,15,6,2,0,6,0,57,8.142857142857142,4,0.0,7,15,3,2,21,0,3,6,0,27,30,1
8645,117763,VeWfrT5492g1p7PzRa92mFX1sE44kxoq,bWdj2GDclj5ofokWjzoa5jAwMkxCykd6,5,2,1,0,1,0,2,0,6,0.8571428571428571,1,0.0,0,1,0,1,2,0,0,2,0,2,4,1
8646,117776,8EDi9ELIY5NaafGr5ul94OArAKYSlPLk,SpATywNh6bZuzm8s1ceuBUnMUAeoAHHw,27,47,23,27,11,3,12,0,123,17.571428571428573,4,0.0,18,23,27,11,29,3,0,12,0,79,44,0
8647,117782,usFuTvFQpKrRjDwn3CiAVcIq4WWtoKl0,RXDvfPUBYFlVdlueBFbLW0mhhAyGEqpt,59,120,78,122,53,147,89,86,695,99.28571428571429,14,0.0,20,78,114,53,100,147,8,89,86,265,430,0
8648,117794,koupoV2Bo5oQSD6MVvXaJhUITtX0e3bf,bWdj2GDclj5ofokWjzoa5jAwMkxCykd6,10,10,7,0,5,2,13,2,39,5.571428571428571,1,0.0,0,7,0,5,10,2,0,13,2,12,27,1
8649,117796,2HxuGhGQGzCNLHdg582isvj2k1uv2pCi,SpATywNh6bZuzm8s1ceuBUnMUAeoAHHw,26,92,4,29,2,35,27,4,193,27.571428571428573,2,0.0,51,4,27,2,41,35,2,27,4,84,109,0
8650,117802,n4PMPT9vVmStYaQ48auvwvWym2rE6F0p,bWdj2GDclj5ofokWjzoa5jAwMkxCykd6,1,0,0,0,0,0,1,0,1,0.14285714285714285,1,0.0,0,0,0,0,0,0,0,1,0,0,1,1
8651,117813,wKbSE55kexrWAbxmePgEr4VHk4YSiEaC,A3fsA9Zfv1X2fVEQhTw51lKENdNrEqT3,1,0,0,0,0,0,1,0,1,0.14285714285714285,1,0.0,0,0,0,0,0,0,0,1,0,0,1,1
8652,117830,2RJ8BBRkfXWUgOvINgxOSXP2ac2oP7fh,SpATywNh6bZuzm8s1ceuBUnMUAeoAHHw,8,7,3,0,1,0,6,0,17,2.4285714285714284,1,0.0,2,3,0,1,5,0,0,6,0,6,11,1
8653,117833,sDtEwaD6losyMUPLsmLS1gJz6VpRuXBt,G8EPVSXsOYB5YQWZGiz1aVq5Pgr2GrQu,6,3,1,0,1,0,2,0,7,1.0,1,0.0,0,1,0,1,3,0,0,2,0,2,5,1
8654,117834,R81t3oSweiKsqxrzFQTifbMpcqBh0IJe,SpATywNh6bZuzm8s1ceuBUnMUAeoAHHw,6,3,1,0,1,0,2,0,7,1.0,1,0.0,0,1,0,1,3,0,0,2,0,2,5,1
8655,117838,E6GtLgX3I7VGOpV74LvaV5V5J9ND1jUQ,SpATywNh6bZuzm8s1ceuBUnMUAeoAHHw,6,10,4,0,1,0,6,0,21,3.0,4,0.0,0,4,0,1,10,0,0,6,0,5,16,1
8656,117865,57P5UbCfzn8GLpyzVkqMDPp8kp3hFIaz,bWdj2GDclj5ofokWjzoa5jAwMkxCykd6,9,35,8,0,4,0,10,0,57,8.142857142857142,7,0.0,0,8,0,4,35,0,0,10,0,12,45,1
8657,117866,o7ztEzN1VLXMPiKeM3Eu4FDhVLhHjR47,A3fsA9Zfv1X2fVEQhTw51lKENdNrEqT3,19,14,11,0,7,35,10,0,77,11.0,2,0.0,0,11,0,7,14,35,0,10,0,18,59,1
8658,117906,NoA9xueUUthCTfidqnFplOKsMZsY3DHa,A3fsA9Zfv1X2fVEQhTw51lKENdNrEqT3,43,29,20,68,10,0,11,0,138,19.714285714285715,6,0.0,2,20,62,10,27,0,6,11,0,94,44,1
8659,117907,Z3bFvTwttDZ4bCfkqeyPSBE9NPAPKPqN,SpATywNh6bZuzm8s1ceuBUnMUAeoAHHw,17,58,7,36,0,1,15,0,117,16.714285714285715,7,0.0,19,7,32,0,39,1,4,15,0,58,59,0
8660,117910,QtoTN2OyyTcqe6Us4ENFLFoSg3hJkA40,SpATywNh6bZuzm8s1ceuBUnMUAeoAHHw,26,92,4,29,2,16,28,2,173,24.714285714285715,8,0.0,28,4,25,2,64,16,4,28,2,59,114,0
8661,117917,ch9tY2TtGdyg7x6KOapt9NQCSfX2sV8p,SpATywNh6bZuzm8s1ceuBUnMUAeoAHHw,2,0,0,0,0,0,2,0,2,0.2857142857142857,1,0.0,0,0,0,0,0,0,0,2,0,0,2,1
8662,117920,Tsqz3H4jIOz4dWir6zrZDbKSFYTGo0K7,G8EPVSXsOYB5YQWZGiz1aVq5Pgr2GrQu,29,51,9,24,5,0,29,2,120,17.142857142857142,3,0.0,1,9,20,5,50,0,4,29,2,35,85,0
8663,117927,M45J6fNUaggda3LzoFU6r4v9Do7R8HkV,bWdj2GDclj5ofokWjzoa5jAwMkxCykd6,39,107,78,32,16,13,18,2,266,38.0,5,0.0,13,78,16,16,94,13,16,18,2,123,143,0
8664,117931,2FyRSMemMx0WQNXDNdLObUL8ox2VWXod,G8EPVSXsOYB5YQWZGiz1aVq5Pgr2GrQu,2,0,0,0,0,0,2,0,2,0.2857142857142857,1,0.0,0,0,0,0,0,0,0,2,0,0,2,1
8665,117940,JYCXGTBUXKAgLYAuYSVkBAkWpoJ7TYUE,G8EPVSXsOYB5YQWZGiz1aVq5Pgr2GrQu,66,87,34,142,10,51,57,4,385,55.0,11,0.0,30,34,95,10,57,51,47,57,4,169,216,0
8666,117944,Lx03w1Z7uki61iSuRTBJrJMgf0kqOIrF,SpATywNh6bZuzm8s1ceuBUnMUAeoAHHw,31,31,13,25,8,7,15,2,101,14.428571428571429,3,0.0,12,13,21,8,19,7,4,15,2,54,47,0
8667,117946,yXqCA1yQnzskdA15yvjJGzN0ZJtznFpO,RXDvfPUBYFlVdlueBFbLW0mhhAyGEqpt,21,20,1,36,2,0,3,0,62,8.857142857142858,4,0.0,5,1,36,2,15,0,0,3,0,44,18,1
8668,117948,1AlOrbJ2y8dS4ycbJ2sP2OTCfMGEqZ01,SpATywNh6bZuzm8s1ceuBUnMUAeoAHHw,32,62,29,54,10,25,22,2,204,29.142857142857142,4,0.0,24,29,41,10,38,25,13,22,2,104,100,0
8669,117952,bAb84TA4vcs2wtZNieDCHeBDjeqCrQIp,SpATywNh6bZuzm8s1ceuBUnMUAeoAHHw,1,0,0,0,0,0,1,0,1,0.14285714285714285,1,0.0,0,0,0,0,0,0,0,1,0,0,1,1
8670,117954,jFYWygr5nLqLhHkXltZRkT0S1zQoLEVR,SpATywNh6bZuzm8s1ceuBUnMUAeoAHHw,25,25,12,22,6,0,4,0,69,9.857142857142858,3,0.0,7,12,19,6,18,0,3,4,0,44,25,0
8671,117985,LL81eYdCoRvNJLX5R1NjId0q1BUIEnQb,SpATywNh6bZuzm8s1ceuBUnMUAeoAHHw,2,0,0,0,0,0,2,0,2,0.2857142857142857,1,0.0,0,0,0,0,0,0,0,2,0,0,2,1
8672,117998,NbBykb0b9cShqzgiHDyBRNbubH18qJTN,SpATywNh6bZuzm8s1ceuBUnMUAeoAHHw,7,3,2,0,2,0,2,0,9,1.2857142857142858,1,0.0,0,2,0,2,3,0,0,2,0,4,5,1
8673,118025,DBl0Whn7bz7gT7myQMnidYa3zRNL4McA,SpATywNh6bZuzm8s1ceuBUnMUAeoAHHw,18,64,23,44,0,20,18,3,172,24.571428571428573,7,0.0,28,23,38,0,36,20,6,18,3,89,83,1
8674,118032,VE9HD5yzeCmqc2pNGfTQWsVbRdaqJBIV,A3fsA9Zfv1X2fVEQhTw51lKENdNrEqT3,4,2,1,0,1,0,1,0,5,0.7142857142857143,1,0.0,0,1,0,1,2,0,0,1,0,2,3,1
8675,118033,86F6XnjIRLQFbYrnQo4SUAq6YeqsWqJH,SpATywNh6bZuzm8s1ceuBUnMUAeoAHHw,20,22,12,15,5,26,19,17,116,16.571428571428573,3,0.0,5,12,12,5,17,26,3,19,17,34,82,1
8676,118043,ZfEmNtZnnnOMQU2ZxafVmay1LudDsU5A,bWdj2GDclj5ofokWjzoa5jAwMkxCykd6,10,12,1,0,1,1,9,1,25,3.5714285714285716,2,0.0,2,1,0,1,10,1,0,9,1,4,21,0
8677,118051,PHrtg3UspIdS1qc6Vp5GAq4YFnlF3cc7,G8EPVSXsOYB5YQWZGiz1aVq5Pgr2GrQu,9,23,5,4,1,0,6,0,39,5.571428571428571,2,0.0,6,5,2,1,17,0,2,6,0,14,25,1
8678,118070,nqDX1tmEeTnbqCn9T8Crn5CYQgmIy9Eq,RXDvfPUBYFlVdlueBFbLW0mhhAyGEqpt,45,59,34,91,14,22,11,0,231,33.0,3,0.0,15,34,83,14,44,22,8,11,0,146,85,0
8679,118081,E0Vc68zQyaBo1QGFDy3X2ztIvkjoKV3F,SpATywNh6bZuzm8s1ceuBUnMUAeoAHHw,4,3,0,0,0,0,1,0,4,0.5714285714285714,1,0.0,0,0,0,0,3,0,0,1,0,0,4,1
8680,118083,hJwtwnOzJaTrAeP4eXJAEwz2xbKsgc4M,SpATywNh6bZuzm8s1ceuBUnMUAeoAHHw,4,2,0,0,0,0,16,0,18,2.5714285714285716,12,0.0,0,0,0,0,2,0,0,16,0,0,18,0
8681,118101,bwCuicApqXH6S91HqGdXTXLfYA9d5SDK,SpATywNh6bZuzm8s1ceuBUnMUAeoAHHw,20,18,0,28,0,0,8,0,54,7.714285714285714,2,0.0,8,0,26,0,10,0,2,8,0,34,20,0
8682,118122,kQLFlWsDSg3FfLQ3EFfSSjFDdN5HLm8p,SpATywNh6bZuzm8s1ceuBUnMUAeoAHHw,6,6,1,0,0,0,1,0,8,1.1428571428571428,1,0.0,0,1,0,0,6,0,0,1,0,1,7,1
8683,118124,11qZqrXXcQbdqet0TC5DW03t5yp66Tzn,SpATywNh6bZuzm8s1ceuBUnMUAeoAHHw,29,18,12,18,7,0,7,0,62,8.857142857142858,4,0.0,4,12,18,7,14,0,0,7,0,41,21,0
8684,118135,JMvgr9jBzvLjspIkuYALsrL220eD0j0v,bWdj2GDclj5ofokWjzoa5jAwMkxCykd6,8,4,3,0,3,0,6,0,16,2.2857142857142856,1,0.0,0,3,0,3,4,0,0,6,0,6,10,1
8685,118136,9YxIQGUlsiIIuBjadM8J3jzezyJ6kq36,G8EPVSXsOYB5YQWZGiz1aVq5Pgr2GrQu,4,2,0,0,0,0,2,0,4,0.5714285714285714,1,0.0,0,0,0,0,2,0,0,2,0,0,4,1
8686,118145,CUEyHbsjLlbX6I7tsbnNjxFI1v5Lj4iD,SpATywNh6bZuzm8s1ceuBUnMUAeoAHHw,21,62,19,6,11,0,15,0,113,16.142857142857142,7,0.0,3,19,6,11,59,0,0,15,0,39,74,0
8687,118153,UwereIH21fVhvJGOSErkxB1cQ9i013xS,SpATywNh6bZuzm8s1ceuBUnMUAeoAHHw,9,7,4,0,2,1,7,3,24,3.4285714285714284,3,0.0,0,4,0,2,7,1,0,7,3,6,18,0
8688,118159,Wwe1S3XdwkCpnmMkWe7RNAVs8cVL63mN,RXDvfPUBYFlVdlueBFbLW0mhhAyGEqpt,11,14,1,0,1,0,5,0,21,3.0,1,0.0,0,1,0,1,14,0,0,5,0,2,19,1
8689,118165,cQJEH4N9NA86ElT2x4zkE6ToN6rVT4MQ,RXDvfPUBYFlVdlueBFbLW0mhhAyGEqpt,19,18,14,16,7,0,3,0,58,8.285714285714286,4,0.0,2,14,15,7,16,0,1,3,0,38,20,1
8690,118171,U3R4m4eLMm2lirgI7HLueBKsNpxhFpn9,A3fsA9Zfv1X2fVEQhTw51lKENdNrEqT3,15,15,10,4,3,0,6,0,38,5.428571428571429,5,0.0,0,10,4,3,15,0,0,6,0,17,21,0
8691,118178,qAVFbR5cx9X92KNDPDJmLoSTth8nEsRM,RXDvfPUBYFlVdlueBFbLW0mhhAyGEqpt,68,98,29,184,11,49,32,2,405,57.857142857142854,11,0.0,19,29,165,11,79,49,19,32,2,224,181,0
8692,118201,P6CjwZWiHeS0SJlPQAf4bN1TR1u7fnyP,bWdj2GDclj5ofokWjzoa5jAwMkxCykd6,1,0,0,0,0,0,1,0,1,0.14285714285714285,1,0.0,0,0,0,0,0,0,0,1,0,0,1,1
8693,118207,K1IFYdQkJo7QdfpjXetMWMiwm2r5nqZr,SpATywNh6bZuzm8s1ceuBUnMUAeoAHHw,5,3,1,0,0,0,3,0,7,1.0,1,0.0,0,1,0,0,3,0,0,3,0,1,6,1
8694,118209,5R4HgbQ9BkBXMi8Hq5UrA8kCLhbx6Nxh,SpATywNh6bZuzm8s1ceuBUnMUAeoAHHw,21,15,11,9,6,0,2,0,43,6.142857142857143,2,0.0,0,11,7,6,15,0,2,2,0,24,19,1
8695,118220,XzisIBOnMp6oTIH0sCLKHdwnfcGCSxLi,SpATywNh6bZuzm8s1ceuBUnMUAeoAHHw,5,2,1,0,1,0,4,0,8,1.1428571428571428,1,0.0,0,1,0,1,2,0,0,4,0,2,6,1
8696,118222,IONYwfWuSLUzRHMHVpaPTPvGauCNosjD,SpATywNh6bZuzm8s1ceuBUnMUAeoAHHw,14,63,45,0,29,1,16,0,154,22.0,6,0.0,3,45,0,29,60,1,0,16,0,77,77,1
8697,118237,rT3zpA0g6rjJ1jZXfn6mCIcHmMcmU756,SpATywNh6bZuzm8s1ceuBUnMUAeoAHHw,6,8,6,0,3,8,3,0,28,4.0,2,0.0,0,6,0,3,8,8,0,3,0,9,19,1
8698,118241,5R4HgbQ9BkBXMi8Hq5UrA8kCLhbx6Nxh,G8EPVSXsOYB5YQWZGiz1aVq5Pgr2GrQu,8,4,3,0,3,0,1,0,11,1.5714285714285714,1,0.0,0,3,0,3,4,0,0,1,0,6,5,1
8699,118247,j7aoEpW6aHY6ARo8v41e8m4DhCg6TYM9,SpATywNh6bZuzm8s1ceuBUnMUAeoAHHw,20,19,9,5,7,0,3,0,43,6.142857142857143,1,0.0,2,9,4,7,17,0,1,3,0,22,21,1
8700,118260,5rpYxIaCTDb4PhszkJWpACOx5VMpNGcQ,A3fsA9Zfv1X2fVEQhTw51lKENdNrEqT3,50,22,17,64,13,31,19,4,170,24.285714285714285,5,0.0,1,17,53,13,21,31,11,19,4,84,86,1
8701,118267,GyWTABuPpZEqO585EnNTIpM2B2faPYN3,SpATywNh6bZuzm8s1ceuBUnMUAeoAHHw,29,33,20,14,14,2,4,0,87,12.428571428571429,2,0.0,11,20,14,14,22,2,0,4,0,59,28,1
8702,118277,LULTOx14kVdHaym020tyvEUUMDRXiDOf,SpATywNh6bZuzm8s1ceuBUnMUAeoAHHw,8,10,6,0,1,0,10,0,27,3.857142857142857,3,0.0,0,6,0,1,10,0,0,10,0,7,20,1
8703,118284,iRkGn6DaWx0LZKTkLTjixCrksMnftQiz,SpATywNh6bZuzm8s1ceuBUnMUAeoAHHw,13,14,1,12,1,0,2,0,30,4.285714285714286,2,0.0,2,1,10,1,12,0,2,2,0,14,16,1
8704,118295,wlSHoMLYlXnNV9DeRulnbWIuryuBkIhv,RXDvfPUBYFlVdlueBFbLW0mhhAyGEqpt,1,0,0,0,0,0,1,0,1,0.14285714285714285,1,0.0,0,0,0,0,0,0,0,1,0,0,1,1
8705,118297,jSCfroddrqNUSCH6KjU0nXMDCSxYb3do,A3fsA9Zfv1X2fVEQhTw51lKENdNrEqT3,1,0,0,0,0,0,1,0,1,0.14285714285714285,1,0.0,0,0,0,0,0,0,0,1,0,0,1,1
8706,118321,vCel5g8zGhrngsDNZ5YOyxEmQk5qV7ac,bWdj2GDclj5ofokWjzoa5jAwMkxCykd6,9,14,0,0,1,5,8,1,29,4.142857142857143,4,0.0,5,0,0,1,9,5,0,8,1,6,23,1
8707,118324,QRV1oI1S8Ffuh8TqoOSVsQ6W4xedCLat,SpATywNh6bZuzm8s1ceuBUnMUAeoAHHw,4,12,1,0,0,0,4,0,17,2.4285714285714284,4,0.0,0,1,0,0,12,0,0,4,0,1,16,0
8708,118328,oyFfPK6y9oPPwQR5mbsXW98FJaEnU88b,RXDvfPUBYFlVdlueBFbLW0mhhAyGEqpt,24,19,14,25,8,0,2,0,68,9.714285714285714,2,0.0,2,14,22,8,17,0,3,2,0,46,22,1
8709,118336,50cUUtrBaOZeeifZra0Sj4seKRuBEyFS,SpATywNh6bZuzm8s1ceuBUnMUAeoAHHw,25,106,11,41,4,2,12,1,177,25.285714285714285,11,0.0,46,11,34,4,60,2,7,12,1,95,82,0
8710,118363,FOCCuGaJ7zYTl7CCCo7T3PqrLtxGVeiU,SpATywNh6bZuzm8s1ceuBUnMUAeoAHHw,26,33,1,24,1,8,15,2,84,12.0,4,0.0,11,1,21,1,22,8,3,15,2,34,50,0
8711,118375,iCakYP1w40pz3A1o7VgcbnomKTMQfUiT,SpATywNh6bZuzm8s1ceuBUnMUAeoAHHw,13,9,6,0,5,0,2,0,22,3.142857142857143,2,0.0,0,6,0,5,9,0,0,2,0,11,11,1
8712,118395,LVTU4qA4F3wWkxH81iGfu4ZuIt77nyhh,A3fsA9Zfv1X2fVEQhTw51lKENdNrEqT3,7,11,3,0,1,1,12,0,28,4.0,3,0.0,0,3,0,1,11,1,0,12,0,4,24,0
8713,118399,DMK7oEoztjNgXbVpWXavlWU4oVL3bMJ2,bWdj2GDclj5ofokWjzoa5jAwMkxCykd6,1,0,0,0,0,0,1,0,1,0.14285714285714285,1,0.0,0,0,0,0,0,0,0,1,0,0,1,1
8714,118423,9iGaqBGS5kkoXjLd87hUL2eIJMVUVKfU,bWdj2GDclj5ofokWjzoa5jAwMkxCykd6,6,8,4,0,2,0,4,0,18,2.5714285714285716,3,0.0,0,4,0,2,8,0,0,4,0,6,12,1
8715,118427,ycOAtB1gwFcaAwvsqsJPeGAqm0EVwIDN,G8EPVSXsOYB5YQWZGiz1aVq5Pgr2GrQu,22,25,9,16,6,0,18,0,74,10.571428571428571,3,0.0,11,9,14,6,14,0,2,18,0,40,34,1
8716,118432,LFsOk9gu14yLVtdY9pNmboBkRA6YhVq4,SpATywNh6bZuzm8s1ceuBUnMUAeoAHHw,1,0,0,0,0,0,2,0,2,0.2857142857142857,2,0.0,0,0,0,0,0,0,0,2,0,0,2,1
8717,118433,U4egSBuIz4Tp2aExbhUIhaem6H1lHi4I,A3fsA9Zfv1X2fVEQhTw51lKENdNrEqT3,1,0,0,0,0,0,1,0,1,0.14285714285714285,1,0.0,0,0,0,0,0,0,0,1,0,0,1,0
8718,118453,X285XxvFlCKmuDlV3vzMxZpCu1V9X67P,G8EPVSXsOYB5YQWZGiz1aVq5Pgr2GrQu,34,54,29,46,15,0,6,0,150,21.428571428571427,3,0.0,20,29,39,15,34,0,7,6,0,103,47,1
8719,118464,zGN54ktgVO57s42kNnMz1KyURivx1q9t,bWdj2GDclj5ofokWjzoa5jAwMkxCykd6,1,0,0,0,0,0,1,0,1,0.14285714285714285,1,0.0,0,0,0,0,0,0,0,1,0,0,1,1
8720,118469,HlHSVt6QwV3D8zM3oQa4RZqHTHgBTeDb,G8EPVSXsOYB5YQWZGiz1aVq5Pgr2GrQu,7,4,3,0,0,1,6,1,15,2.142857142857143,2,0.0,0,3,0,0,4,1,0,6,1,3,12,1
8721,118484,grhneBVDCBhvBD53OXACTDGfdH3pEWQ2,SpATywNh6bZuzm8s1ceuBUnMUAeoAHHw,23,50,5,28,0,1,14,1,99,14.142857142857142,10,0.0,11,5,22,0,39,1,6,14,1,38,61,0
8722,118497,D42av4RgpD46CqlOrc3UqYUQGU69fX7w,SpATywNh6bZuzm8s1ceuBUnMUAeoAHHw,14,22,11,7,7,0,1,0,48,6.857142857142857,3,0.0,0,11,6,7,22,0,1,1,0,24,24,1
8723,118503,AT8SDkvzrK4J3OL7I6ScWwycekA3DBUB,bWdj2GDclj5ofokWjzoa5jAwMkxCykd6,2,0,0,0,0,0,3,0,3,0.42857142857142855,1,0.0,0,0,0,0,0,0,0,3,0,0,3,1
8724,118517,AADHk2CnqIXqU54SVoJYYzHXkzsT7VVX,SpATywNh6bZuzm8s1ceuBUnMUAeoAHHw,29,130,55,56,4,55,42,17,359,51.285714285714285,9,0.0,47,55,45,4,83,55,11,42,17,151,208,0
8725,118525,ZPaxHFRYfWHILqdYYtzCUV3i0tOspO75,SpATywNh6bZuzm8s1ceuBUnMUAeoAHHw,9,3,2,0,1,3,10,2,21,3.0,1,0.0,0,2,0,1,3,3,0,10,2,3,18,1
8726,118542,bwCuicApqXH6S91HqGdXTXLfYA9d5SDK,RXDvfPUBYFlVdlueBFbLW0mhhAyGEqpt,1,0,0,0,0,0,1,0,1,0.14285714285714285,1,0.0,0,0,0,0,0,0,0,1,0,0,1,1
8727,118552,bQgvxTEfpKkG7faV4J3DTFNYdIGmaRJn,A3fsA9Zfv1X2fVEQhTw51lKENdNrEqT3,2,0,0,0,0,0,2,0,2,0.2857142857142857,1,0.0,0,0,0,0,0,0,0,2,0,0,2,1
8728,118557,p5WcSuRgNcVvsptKJrB8fiizrHjqBhQI,bWdj2GDclj5ofokWjzoa5jAwMkxCykd6,1,0,0,0,0,0,1,0,1,0.14285714285714285,1,0.0,0,0,0,0,0,0,0,1,0,0,1,1
8729,118561,Go1ERHGiNnYVc6rXpAjttQ9IaXemOnqN,A3fsA9Zfv1X2fVEQhTw51lKENdNrEqT3,4,3,2,0,0,0,1,0,6,0.8571428571428571,1,0.0,0,2,0,0,3,0,0,1,0,2,4,1
8730,118567,TQy9wSoPujib2kvNE4TTZJIA8yQmRsFr,bWdj2GDclj5ofokWjzoa5jAwMkxCykd6,3,5,0,0,0,0,1,0,6,0.8571428571428571,2,0.0,0,0,0,0,5,0,0,1,0,0,6,1
8731,118582,P27ziZ47DXA6Hi97vj6kZGIGFjWpnnsR,SpATywNh6bZuzm8s1ceuBUnMUAeoAHHw,8,4,2,0,2,0,2,0,10,1.4285714285714286,1,0.0,0,2,0,2,4,0,0,2,0,4,6,1
8732,118589,r0yZNwEG828V0TMkCl61Reya5Y5HO5aR,bWdj2GDclj5ofokWjzoa5jAwMkxCykd6,3,3,1,0,0,0,2,0,6,0.8571428571428571,1,0.0,0,1,0,0,3,0,0,2,0,1,5,0
8733,118592,RiCs84yGV6JCwVfBOhcXa8oCpUMbIJNf,SpATywNh6bZuzm8s1ceuBUnMUAeoAHHw,27,90,4,37,2,28,33,5,199,28.428571428571427,8,0.0,32,4,34,2,58,28,3,33,5,72,127,0
8734,118594,r0yZNwEG828V0TMkCl61Reya5Y5HO5aR,A3fsA9Zfv1X2fVEQhTw51lKENdNrEqT3,3,3,1,0,0,0,2,0,6,0.8571428571428571,1,0.0,0,1,0,0,3,0,0,2,0,1,5,1
8735,118599,tp9GLoYyljDV6mILQxrtrv1Iw4qcPl5Z,A3fsA9Zfv1X2fVEQhTw51lKENdNrEqT3,7,4,2,0,2,0,3,0,11,1.5714285714285714,1,0.0,1,2,0,2,3,0,0,3,0,5,6,1
8736,118611,OPuJXMBkJWOSkPuaVgsFtLgnzHpMTbpE,SpATywNh6bZuzm8s1ceuBUnMUAeoAHHw,7,2,1,0,1,0,4,0,8,1.1428571428571428,1,0.0,0,1,0,1,2,0,0,4,0,2,6,1
8737,118618,TQ8OFVc2xBKvPKyjEssWVNNgqzlZ0PAa,bWdj2GDclj5ofokWjzoa5jAwMkxCykd6,38,55,31,197,15,2,11,0,311,44.42857142857143,5,0.0,10,31,172,15,45,2,25,11,0,228,83,0
8738,118626,sjQQWItXAp5E8ocdOnRRzFCiZKv0PVqn,SpATywNh6bZuzm8s1ceuBUnMUAeoAHHw,17,18,5,11,0,0,6,0,40,5.714285714285714,3,0.0,2,5,10,0,16,0,1,6,0,17,23,0
8739,118627,PpZEAa1Mdati01h1lf363alLOjmVtvBB,bWdj2GDclj5ofokWjzoa5jAwMkxCykd6,5,0,0,0,0,1,4,1,6,0.8571428571428571,1,0.0,0,0,0,0,0,1,0,4,1,0,6,1
8740,118629,f4eElh7NTKGsWnUHRO9BuyTOQtrsnWlM,SpATywNh6bZuzm8s1ceuBUnMUAeoAHHw,17,16,9,19,4,3,7,0,58,8.285714285714286,2,0.0,6,9,17,4,10,3,2,7,0,36,22,1
8741,118633,NuFKQkAxfn2PT3wbGN0i3erkBYbjqkix,A3fsA9Zfv1X2fVEQhTw51lKENdNrEqT3,55,18,0,170,0,2,10,1,201,28.714285714285715,3,0.0,2,0,148,0,16,2,22,10,1,150,51,0
8742,118635,U6N64321JOuc5ylM9RcniwscGjdKavd0,bWdj2GDclj5ofokWjzoa5jAwMkxCykd6,1,0,0,0,0,0,1,0,1,0.14285714285714285,1,0.0,0,0,0,0,0,0,0,1,0,0,1,1
8743,118651,ANtHTaCISHkEW6ENLanE6G1HEnRFLZdw,SpATywNh6bZuzm8s1ceuBUnMUAeoAHHw,3,2,1,0,0,0,2,0,5,0.7142857142857143,2,0.0,0,1,0,0,2,0,0,2,0,1,4,1
8744,118653,YmAogTXGoaSGS2jBtwsCLUVebiwWGuMB,A3fsA9Zfv1X2fVEQhTw51lKENdNrEqT3,17,18,15,0,13,4,4,0,54,7.714285714285714,3,0.0,0,15,0,13,18,4,0,4,0,28,26,1
8745,118662,ANtHTaCISHkEW6ENLanE6G1HEnRFLZdw,RXDvfPUBYFlVdlueBFbLW0mhhAyGEqpt,4,4,2,0,0,0,3,0,9,1.2857142857142858,3,0.0,0,2,0,0,4,0,0,3,0,2,7,1
8746,118665,eNgDL8k9xOLyBlZ3UNlseJHly8SfPZZu,A3fsA9Zfv1X2fVEQhTw51lKENdNrEqT3,54,96,69,76,32,45,34,1,353,50.42857142857143,13,0.0,6,69,58,32,90,45,18,34,1,165,188,0
8747,118667,oamKaVYtYcTWlWXxR9gjWFZVaqJSv9QD,RXDvfPUBYFlVdlueBFbLW0mhhAyGEqpt,58,130,5,102,34,6,11,0,288,41.142857142857146,5,0.0,77,5,97,34,53,6,5,11,0,213,75,0
8748,118668,vbghp1PVpZxFaWqasEyQzIEfPKBk8vPh,A3fsA9Zfv1X2fVEQhTw51lKENdNrEqT3,12,7,4,0,4,0,3,0,18,2.5714285714285716,2,0.0,1,4,0,4,6,0,0,3,0,9,9,1
8749,118672,dtI4aHSJprK2Oz02958rC7RUVW99jWdh,SpATywNh6bZuzm8s1ceuBUnMUAeoAHHw,10,5,4,7,2,0,2,0,20,2.857142857142857,1,0.0,0,4,6,2,5,0,1,2,0,12,8,1
8750,118691,DvqqmzfQOqhniG6rRYaSYRCVzVLc6KPG,A3fsA9Zfv1X2fVEQhTw51lKENdNrEqT3,5,3,2,0,1,0,1,0,7,1.0,1,0.0,0,2,0,1,3,0,0,1,0,3,4,1
8751,118692,34Xbf7uBGJ4LnJBXPtvvptwjUQQdkYUg,A3fsA9Zfv1X2fVEQhTw51lKENdNrEqT3,70,108,46,112,13,10,61,3,353,50.42857142857143,8,0.0,7,46,101,13,101,10,11,61,3,167,186,0
8752,118695,DvqqmzfQOqhniG6rRYaSYRCVzVLc6KPG,bWdj2GDclj5ofokWjzoa5jAwMkxCykd6,4,3,1,0,1,0,2,0,7,1.0,2,0.0,1,1,0,1,2,0,0,2,0,3,4,1
8753,118697,xMj985YGbnpmmaLLf9WHP3PHD8Af4HUa,SpATywNh6bZuzm8s1ceuBUnMUAeoAHHw,7,2,1,0,1,0,6,1,11,1.5714285714285714,1,0.0,0,1,0,1,2,0,0,6,1,2,9,1
8754,118711,uIfDz0U6olmuGEmtRQWevpWq94B8FOe9,SpATywNh6bZuzm8s1ceuBUnMUAeoAHHw,5,2,1,0,1,0,2,0,6,0.8571428571428571,1,0.0,0,1,0,1,2,0,0,2,0,2,4,1
8755,118713,GzZqgl4giqqW7TCBTX5a2jDyy6Q646Os,SpATywNh6bZuzm8s1ceuBUnMUAeoAHHw,17,43,2,19,2,3,20,3,92,13.142857142857142,4,0.0,13,2,16,2,30,3,3,20,3,33,59,1
8756,118722,DHhoczdtvn37Fynebgh7tMkKtF0dh4jQ,A3fsA9Zfv1X2fVEQhTw51lKENdNrEqT3,1,0,0,0,0,0,1,0,1,0.14285714285714285,1,0.0,0,0,0,0,0,0,0,1,0,0,1,1
8757,118738,I3IAdtd399keUxdhVZ1J3PIkz3kC7zL8,RXDvfPUBYFlVdlueBFbLW0mhhAyGEqpt,22,23,2,34,7,0,4,0,70,10.0,3,0.0,14,2,31,7,9,0,3,4,0,54,16,1
8758,118752,v5ZzaFsvASHZHFHDQx30X4bWu2OAn0TJ,bWdj2GDclj5ofokWjzoa5jAwMkxCykd6,11,18,1,30,5,1,8,1,64,9.142857142857142,2,0.0,10,1,30,5,8,1,0,8,1,46,18,1
8759,118765,GGymFCz4p00DxUzTcaDeYIcqN4hoSzTk,SpATywNh6bZuzm8s1ceuBUnMUAeoAHHw,1,0,0,0,0,0,1,0,1,0.14285714285714285,1,0.0,0,0,0,0,0,0,0,1,0,0,1,1
8760,118771,lrp5AGJUh69hKuCI5IYUEU19E2beipwd,A3fsA9Zfv1X2fVEQhTw51lKENdNrEqT3,48,60,5,126,3,18,11,0,223,31.857142857142858,9,0.0,1,5,106,3,59,18,20,11,0,115,108,1
8761,118774,DqNAxwTcrk055KEf1va6hv0cFfrqGSiY,A3fsA9Zfv1X2fVEQhTw51lKENdNrEqT3,14,24,14,0,8,0,4,0,50,7.142857142857143,3,0.0,0,14,0,8,24,0,0,4,0,22,28,1
8762,118783,bKVslXuzEQ1pv4c6iV5mVjs6X6avUbmL,G8EPVSXsOYB5YQWZGiz1aVq5Pgr2GrQu,7,4,2,0,1,0,6,0,13,1.8571428571428572,5,0.0,0,2,0,1,4,0,0,6,0,3,10,0
8763,118800,AXOBQLaknxwaGBasKpj34YfhU436HR6z,G8EPVSXsOYB5YQWZGiz1aVq5Pgr2GrQu,24,31,12,10,10,0,20,1,84,12.0,4,0.0,8,12,5,10,23,0,5,20,1,35,49,0
8764,118816,v25EcAT5A0ySpzSARJj7hsNjPFXZUc3f,bWdj2GDclj5ofokWjzoa5jAwMkxCykd6,8,10,2,98,3,0,11,0,124,17.714285714285715,1,0.0,6,2,97,3,4,0,1,11,0,108,16,1
8765,118825,j9NZdBIxAXb3GeboncXceewydTlKXuYz,bWdj2GDclj5ofokWjzoa5jAwMkxCykd6,6,4,3,0,3,0,1,0,11,1.5714285714285714,1,0.0,0,3,0,3,4,0,0,1,0,6,5,1
8766,118828,QXEPfF2pAnokf1BSO0tTVCPJ0yWgZtcC,SpATywNh6bZuzm8s1ceuBUnMUAeoAHHw,6,5,1,0,0,0,2,1,9,1.2857142857142858,1,0.0,0,1,0,0,5,0,0,2,1,1,8,1
8767,118829,oYXc35V0j0DGRrciqWRUFfGtnQPnDhaQ,A3fsA9Zfv1X2fVEQhTw51lKENdNrEqT3,7,12,1,0,0,0,5,0,18,2.5714285714285716,1,0.0,0,1,0,0,12,0,0,5,0,1,17,1
8768,118858,uvmnuTMWO7CUJMGmbknJbfcrAcbdWpqR,SpATywNh6bZuzm8s1ceuBUnMUAeoAHHw,1,0,0,0,0,0,1,0,1,0.14285714285714285,1,0.0,0,0,0,0,0,0,0,1,0,0,1,1
8769,118862,uvmnuTMWO7CUJMGmbknJbfcrAcbdWpqR,bWdj2GDclj5ofokWjzoa5jAwMkxCykd6,1,0,0,0,0,0,1,0,1,0.14285714285714285,1,0.0,0,0,0,0,0,0,0,1,0,0,1,1
8770,118863,uvmnuTMWO7CUJMGmbknJbfcrAcbdWpqR,RXDvfPUBYFlVdlueBFbLW0mhhAyGEqpt,1,0,0,0,0,0,1,0,1,0.14285714285714285,1,0.0,0,0,0,0,0,0,0,1,0,0,1,1
8771,118876,eLhnZqVqldawLLuaLdbS0XPiIKiZAief,RXDvfPUBYFlVdlueBFbLW0mhhAyGEqpt,27,45,1,0,0,26,20,1,93,13.285714285714286,3,0.0,0,1,0,0,45,26,0,20,1,1,92,0
8772,118879,wuMhhjy7NxtqcBPxbigACLOqg9Xy71R7,SpATywNh6bZuzm8s1ceuBUnMUAeoAHHw,31,53,24,38,9,1,14,0,139,19.857142857142858,5,0.0,20,24,32,9,33,1,6,14,0,85,54,0
8773,118885,a3fDqs2SnQqVu7YeLa2fNuIYzGrHnHDE,SpATywNh6bZuzm8s1ceuBUnMUAeoAHHw,7,8,0,0,0,1,4,0,13,1.8571428571428572,1,0.0,0,0,0,0,8,1,0,4,0,0,13,1
8774,118889,a3fDqs2SnQqVu7YeLa2fNuIYzGrHnHDE,bWdj2GDclj5ofokWjzoa5jAwMkxCykd6,5,2,0,0,0,0,3,0,5,0.7142857142857143,1,0.0,0,0,0,0,2,0,0,3,0,0,5,1
8775,118913,xUhDcXiX03QQg1jNR3Lksh9CrGcRUkPg,A3fsA9Zfv1X2fVEQhTw51lKENdNrEqT3,52,121,66,116,24,154,31,0,512,73.14285714285714,12,0.0,14,66,87,24,107,154,29,31,0,191,321,0
8776,118918,TOHE2cn8sx2ym4g7cRhp3c9gQIpGV4UB,SpATywNh6bZuzm8s1ceuBUnMUAeoAHHw,10,10,5,0,2,1,8,1,27,3.857142857142857,2,0.0,2,5,0,2,8,1,0,8,1,9,18,1
8777,118919,TOHE2cn8sx2ym4g7cRhp3c9gQIpGV4UB,A3fsA9Zfv1X2fVEQhTw51lKENdNrEqT3,1,0,0,0,0,0,1,0,1,0.14285714285714285,1,0.0,0,0,0,0,0,0,0,1,0,0,1,1
8778,118923,FcPFK6OTsUF1j3uNGabdzGTvbY8kcO3D,A3fsA9Zfv1X2fVEQhTw51lKENdNrEqT3,15,14,12,0,8,0,2,0,36,5.142857142857143,2,0.0,0,12,0,8,14,0,0,2,0,20,16,1
8779,118926,efygWYkxxUMOGInRZT4qEeuzMRlIpQq6,SpATywNh6bZuzm8s1ceuBUnMUAeoAHHw,29,53,30,15,14,1,16,0,129,18.428571428571427,6,0.0,13,30,15,14,40,1,0,16,0,72,57,0
8780,118930,fiLsrcAU0ZFm61T8xhRUwb5p8PN605CT,SpATywNh6bZuzm8s1ceuBUnMUAeoAHHw,8,8,5,0,2,0,6,0,21,3.0,3,0.0,0,5,0,2,8,0,0,6,0,7,14,1
8781,118931,ZRfFWalEoINhUGe05gZETSGzjQUd6T5n,SpATywNh6bZuzm8s1ceuBUnMUAeoAHHw,27,34,16,23,9,9,5,0,96,13.714285714285714,5,0.0,14,16,18,9,20,9,5,5,0,57,39,1
8782,118943,6hOFMnbpcErHmlwc3MeiSQOkkbkZvsdF,SpATywNh6bZuzm8s1ceuBUnMUAeoAHHw,12,17,7,0,3,1,9,1,38,5.428571428571429,4,0.0,6,7,0,3,11,1,0,9,1,16,22,0
8783,118944,pqKCkJOspd9xXtA4k6IDJS4Js61XmolB,SpATywNh6bZuzm8s1ceuBUnMUAeoAHHw,4,2,1,0,1,0,1,0,5,0.7142857142857143,2,0.0,0,1,0,1,2,0,0,1,0,2,3,1
8784,118950,5eO5trczHn4tezH3o1mHOvzooHGmVWMl,A3fsA9Zfv1X2fVEQhTw51lKENdNrEqT3,11,11,7,0,4,0,4,0,26,3.7142857142857144,3,0.0,0,7,0,4,11,0,0,4,0,11,15,1
8785,118957,28PHU9suTM8EqUKsQwsvQ03DzFXi0yDl,RXDvfPUBYFlVdlueBFbLW0mhhAyGEqpt,1,0,0,0,0,0,3,0,3,0.42857142857142855,2,0.0,0,0,0,0,0,0,0,3,0,0,3,1
8786,118962,UHbjjkoY8eePNp6r324vyfQdD3BvD0KM,G8EPVSXsOYB5YQWZGiz1aVq5Pgr2GrQu,8,5,4,0,1,0,2,0,12,1.7142857142857142,1,0.0,0,4,0,1,5,0,0,2,0,5,7,1
8787,118964,YvVuka2rxSzzYYNnDLtzVMee0hjbsr3Q,SpATywNh6bZuzm8s1ceuBUnMUAeoAHHw,6,4,1,0,1,0,1,0,7,1.0,2,0.0,0,1,0,1,4,0,0,1,0,2,5,1
8788,118966,zQeYO5pZ1xh2UAEMjLOadhLt0hmfHHxb,bWdj2GDclj5ofokWjzoa5jAwMkxCykd6,9,15,7,8,3,1,7,0,41,5.857142857142857,3,0.0,1,7,7,3,14,1,1,7,0,18,23,1
8789,118977,rwmKpdbePJfKvi814EI3msCq1quO9ftl,SpATywNh6bZuzm8s1ceuBUnMUAeoAHHw,6,2,0,0,0,0,5,1,8,1.1428571428571428,1,0.0,0,0,0,0,2,0,0,5,1,0,8,1
8790,118987,u79qFvGauNOAmgDpP2DklDOwG6ISKFXs,SpATywNh6bZuzm8s1ceuBUnMUAeoAHHw,13,32,7,0,3,32,8,2,84,12.0,2,0.0,23,7,0,3,9,32,0,8,2,33,51,1
8791,118993,5R2yvtH9LNaB7I0DFs0y5Dgzft4SPkTz,SpATywNh6bZuzm8s1ceuBUnMUAeoAHHw,27,34,20,32,11,0,15,0,112,16.0,4,0.0,10,20,29,11,24,0,3,15,0,70,42,1
8792,118995,UoQ0PEeqIO4n6Ln8avpcjf2ZoIAx1YCQ,A3fsA9Zfv1X2fVEQhTw51lKENdNrEqT3,68,41,28,160,20,0,12,0,261,37.285714285714285,9,0.0,2,28,138,20,39,0,22,12,0,188,73,0
8793,119001,DXaGQeTbJkNEulVow7g1qYtfMHcxt0Bb,SpATywNh6bZuzm8s1ceuBUnMUAeoAHHw,26,50,3,20,2,18,8,1,102,14.571428571428571,6,0.0,12,3,17,2,38,18,3,8,1,34,68,0
8794,119008,i41wq4JFa1zWjnzk4s4F0u6D3S1UMuDT,bWdj2GDclj5ofokWjzoa5jAwMkxCykd6,1,0,0,0,0,0,1,0,1,0.14285714285714285,1,0.0,0,0,0,0,0,0,0,1,0,0,1,1
8795,119009,c8TFm45r0bfBe26eBlEeUAKDBoTJT9yV,SpATywNh6bZuzm8s1ceuBUnMUAeoAHHw,8,9,0,19,0,0,1,0,29,4.142857142857143,1,0.0,4,0,16,0,5,0,3,1,0,20,9,0
8796,119012,gVK9JFuVehH4w6Ht2Q17t4NUtbNWFPNf,SpATywNh6bZuzm8s1ceuBUnMUAeoAHHw,7,2,0,0,0,0,9,1,12,1.7142857142857142,1,0.0,0,0,0,0,2,0,0,9,1,0,12,1
8797,119026,Pqb8mgUOFwNjSYHZCNAFlv28S1hEJuyW,RXDvfPUBYFlVdlueBFbLW0mhhAyGEqpt,7,3,2,0,1,0,4,0,10,1.4285714285714286,1,0.0,1,2,0,1,2,0,0,4,0,4,6,1
8798,119027,5tL0goZ0bMjNeuGHJZ9VZymSM6PzqaXn,SpATywNh6bZuzm8s1ceuBUnMUAeoAHHw,28,51,25,20,14,12,8,0,130,18.571428571428573,5,0.0,20,25,17,14,31,12,3,8,0,76,54,0
8799,119042,lVwgv61cg8fkhW9rg5b1PIPnuUWxb0Vk,bWdj2GDclj5ofokWjzoa5jAwMkxCykd6,22,33,18,24,8,63,18,3,167,23.857142857142858,6,0.0,5,18,22,8,28,63,2,18,3,53,114,1
8800,119043,D5jAgVwgvpw2Kr66NxyapnkPl0dnzBLu,A3fsA9Zfv1X2fVEQhTw51lKENdNrEqT3,4,2,0,0,0,0,29,0,31,4.428571428571429,10,0.0,0,0,0,0,2,0,0,29,0,0,31,1
8801,119057,pKoUS2SEKCFMATrFfyk1PMmORYo186Kb,G8EPVSXsOYB5YQWZGiz1aVq5Pgr2GrQu,69,174,4,156,12,1,16,1,364,52.0,4,0.0,91,4,121,12,83,1,35,16,1,228,136,0
8802,119060,vnVRudtEjYlZLumIJaQJj0f2z3slueSl,SpATywNh6bZuzm8s1ceuBUnMUAeoAHHw,12,15,9,10,5,0,5,0,44,6.285714285714286,1,0.0,2,9,9,5,13,0,1,5,0,25,19,1
8803,119071,pcGXxspzr6LCJz7Udn3jdISDvA5WWes9,G8EPVSXsOYB5YQWZGiz1aVq5Pgr2GrQu,4,3,1,0,0,0,1,0,5,0.7142857142857143,1,0.0,0,1,0,0,3,0,0,1,0,1,4,1
8804,119080,iPvQyQrtKaIWy8V9F09NldCS64KhU7EA,G8EPVSXsOYB5YQWZGiz1aVq5Pgr2GrQu,1,0,0,0,0,0,1,0,1,0.14285714285714285,1,0.0,0,0,0,0,0,0,0,1,0,0,1,1
8805,119090,RwiQ9qTlDDbK4m60mKR4JxmbkQn57Rff,RXDvfPUBYFlVdlueBFbLW0mhhAyGEqpt,19,21,14,0,6,46,11,7,105,15.0,4,0.0,2,14,0,6,19,46,0,11,7,22,83,1
8806,119104,jq4JfpgApzrMRuCNvYDPIsQTWPeEZuhJ,G8EPVSXsOYB5YQWZGiz1aVq5Pgr2GrQu,30,35,5,81,3,30,19,3,176,25.142857142857142,3,0.0,11,5,71,3,24,30,10,19,3,90,86,1
8807,119109,PZtj1GnJa5qYIICIjESUcqp401L5vmnR,G8EPVSXsOYB5YQWZGiz1aVq5Pgr2GrQu,59,68,2,156,7,26,23,2,284,40.57142857142857,2,0.0,39,2,121,7,29,26,35,23,2,169,115,1
8808,119117,t1xspb1k3lEGBshWKCwAoW44MsPqXHk5,A3fsA9Zfv1X2fVEQhTw51lKENdNrEqT3,1,0,0,0,0,0,1,0,1,0.14285714285714285,1,0.0,0,0,0,0,0,0,0,1,0,0,1,1
8809,119130,7iwTSJc32zh43nzmRibHZmGv70Vk4Lgo,SpATywNh6bZuzm8s1ceuBUnMUAeoAHHw,5,2,1,0,1,0,4,0,8,1.1428571428571428,1,0.0,0,1,0,1,2,0,0,4,0,2,6,1
8810,119131,NOm4CR7y4Aje7RwR2ZLNwhU4SfabY7lA,SpATywNh6bZuzm8s1ceuBUnMUAeoAHHw,10,63,35,0,3,0,10,0,111,15.857142857142858,2,0.0,20,35,0,3,43,0,0,10,0,58,53,1
8811,119143,YMxXtA5A6XX1bdm998q3OXZqnuIpo8I0,SpATywNh6bZuzm8s1ceuBUnMUAeoAHHw,16,57,23,0,0,27,14,0,121,17.285714285714285,6,0.0,15,23,0,0,42,27,0,14,0,38,83,0
8812,119151,RlfxLmk0H7RVTMayoeG4aa7x6bQD0aZn,SpATywNh6bZuzm8s1ceuBUnMUAeoAHHw,4,2,1,0,1,0,1,0,5,0.7142857142857143,1,0.0,0,1,0,1,2,0,0,1,0,2,3,1
8813,119152,xJut5jnrMH6sobZn5JCJO1JseLVZmDHM,SpATywNh6bZuzm8s1ceuBUnMUAeoAHHw,11,15,6,0,4,0,3,0,28,4.0,1,0.0,0,6,0,4,15,0,0,3,0,10,18,1
8814,119159,rbbo6gYUB5I1wwOafpQCdj4m6UPXHmsz,SpATywNh6bZuzm8s1ceuBUnMUAeoAHHw,8,25,8,0,2,6,10,3,54,7.714285714285714,4,0.0,8,8,0,2,17,6,0,10,3,18,36,0
8815,119170,kd67Lm5QGeYWxcKJYnacCNFbyj5NIxDh,SpATywNh6bZuzm8s1ceuBUnMUAeoAHHw,14,21,3,39,1,0,3,0,67,9.571428571428571,2,0.0,14,3,31,1,7,0,8,3,0,49,18,0
8816,119185,mu7Zdr1ChN6xNMWE8Otd7Si7TQhm7pEQ,SpATywNh6bZuzm8s1ceuBUnMUAeoAHHw,10,32,9,0,6,0,18,1,66,9.428571428571429,5,0.0,2,9,0,6,30,0,0,18,1,17,49,0
8817,119190,oUj6dSGxHzsnU6uTXKwTomk9vwlHt6j0,G8EPVSXsOYB5YQWZGiz1aVq5Pgr2GrQu,15,15,11,0,7,0,6,0,39,5.571428571428571,3,0.0,0,11,0,7,15,0,0,6,0,18,21,1
8818,119192,NoA9xueUUthCTfidqnFplOKsMZsY3DHa,SpATywNh6bZuzm8s1ceuBUnMUAeoAHHw,26,43,18,26,8,0,10,0,105,15.0,5,0.0,10,18,25,8,33,0,1,10,0,61,44,1
8819,119203,PZqGQ10gijeZZaXj244FlA0iYVn9rzPC,SpATywNh6bZuzm8s1ceuBUnMUAeoAHHw,5,2,1,0,1,0,2,0,6,0.8571428571428571,1,0.0,0,1,0,1,2,0,0,2,0,2,4,1
8820,119204,okqN4nBVKRYYrkYonKicKGOmPqVGYjZh,G8EPVSXsOYB5YQWZGiz1aVq5Pgr2GrQu,8,11,4,0,1,0,10,0,26,3.7142857142857144,3,0.0,0,4,0,1,11,0,0,10,0,5,21,0
8821,119208,BnCTRJ1O4fVqlnxTGriZkJ9JZEc8p58K,A3fsA9Zfv1X2fVEQhTw51lKENdNrEqT3,1,0,0,0,0,0,2,0,2,0.2857142857142857,1,0.0,0,0,0,0,0,0,0,2,0,0,2,1
8822,119212,ttJwJCfGlOpWVOx9vRULE7UdoGyFI9Ut,SpATywNh6bZuzm8s1ceuBUnMUAeoAHHw,5,6,3,0,2,0,1,0,12,1.7142857142857142,1,0.0,2,3,0,2,4,0,0,1,0,7,5,1
8823,119217,UbE5C1Pto1KvqgPPDmGO0svv7BwAZk15,G8EPVSXsOYB5YQWZGiz1aVq5Pgr2GrQu,9,7,4,0,4,0,2,0,17,2.4285714285714284,1,0.0,0,4,0,4,7,0,0,2,0,8,9,1
8824,119224,ieJctBgJj74PFo2P7ymmdVzAX2v62LKu,G8EPVSXsOYB5YQWZGiz1aVq5Pgr2GrQu,12,11,5,0,4,0,6,0,26,3.7142857142857144,1,0.0,0,5,0,4,11,0,0,6,0,9,17,1
8825,119237,63TreuteShRAITxpj6URpYIQ3kURzPmt,bWdj2GDclj5ofokWjzoa5jAwMkxCykd6,8,9,1,0,1,10,7,1,29,4.142857142857143,1,0.0,2,1,0,1,7,10,0,7,1,4,25,1
8826,119239,okqN4nBVKRYYrkYonKicKGOmPqVGYjZh,bWdj2GDclj5ofokWjzoa5jAwMkxCykd6,8,30,14,0,0,13,21,0,78,11.142857142857142,5,0.0,1,14,0,0,29,13,0,21,0,15,63,0
8827,119243,q3pPbgY0JhPpTgQfSrEbBAWd7rbmYjI4,SpATywNh6bZuzm8s1ceuBUnMUAeoAHHw,23,77,2,34,2,6,30,0,151,21.571428571428573,6,0.0,17,2,32,2,60,6,2,30,0,53,98,0
8828,119245,7RIgMHzHpMzY7qBXHPj6WiDKK3U9H2Wz,SpATywNh6bZuzm8s1ceuBUnMUAeoAHHw,23,46,33,0,20,0,28,1,128,18.285714285714285,8,0.0,0,33,0,20,46,0,0,28,1,53,75,0
8829,119251,qujx8xRYXJGJrQ3ruvaaTF7TTwy8KaeC,G8EPVSXsOYB5YQWZGiz1aVq5Pgr2GrQu,9,5,3,0,1,0,4,0,13,1.8571428571428572,1,0.0,0,3,0,1,5,0,0,4,0,4,9,1
8830,119265,8oiFYmMp7IOF1mfFRmhZ7Lug8ImrhTTO,SpATywNh6bZuzm8s1ceuBUnMUAeoAHHw,18,31,13,21,5,9,8,0,87,12.428571428571429,4,0.0,11,13,18,5,20,9,3,8,0,47,40,1
8831,119266,iacqYcgHTn7FZ8NE4roe5kgAUjDF0efr,SpATywNh6bZuzm8s1ceuBUnMUAeoAHHw,31,57,31,35,16,6,32,1,178,25.428571428571427,7,0.0,16,31,29,16,41,6,6,32,1,92,86,0
8832,119267,4eT20gUbOYkq3qXZQOFYEeSPNFVVnLrB,A3fsA9Zfv1X2fVEQhTw51lKENdNrEqT3,2,0,0,0,0,0,2,0,2,0.2857142857142857,1,0.0,0,0,0,0,0,0,0,2,0,0,2,1
8833,119288,NDGU2YEumOCOuP8YkbdyT4JHlfK2eImX,SpATywNh6bZuzm8s1ceuBUnMUAeoAHHw,9,6,4,0,2,0,2,0,14,2.0,1,0.0,0,4,0,2,6,0,0,2,0,6,8,1
8834,119289,ch9jXib8D5Z69PRYwp1WHAUa7SmEdgIr,SpATywNh6bZuzm8s1ceuBUnMUAeoAHHw,18,19,7,11,3,1,10,2,53,7.571428571428571,1,0.0,10,7,11,3,9,1,0,10,2,31,22,1
8835,119290,AJAawUTIK5tTWvBfm3QRQhh9S7SsRdRA,SpATywNh6bZuzm8s1ceuBUnMUAeoAHHw,10,8,2,0,2,1,5,1,19,2.7142857142857144,2,0.0,0,2,0,2,8,1,0,5,1,4,15,1
8836,119293,845wZKTJiCD0zuzvTs70K7NaBfTnltXS,SpATywNh6bZuzm8s1ceuBUnMUAeoAHHw,7,2,1,0,1,10,4,1,19,2.7142857142857144,1,0.0,0,1,0,1,2,10,0,4,1,2,17,1
8837,119294,tdyEqQ928g4zwLz7u1XUELM0nW67gqKU,G8EPVSXsOYB5YQWZGiz1aVq5Pgr2GrQu,28,97,44,42,11,5,27,1,227,32.42857142857143,4,0.0,22,44,40,11,75,5,2,27,1,117,110,1
8838,119295,yuOMBhnDAvRSNCNkI5M8rpsRFdq6dg7T,RXDvfPUBYFlVdlueBFbLW0mhhAyGEqpt,4,2,1,0,1,0,1,0,5,0.7142857142857143,1,0.0,0,1,0,1,2,0,0,1,0,2,3,1
8839,119300,1P5MvFqtZDoED6FWgTnhCj192U5gDdPF,G8EPVSXsOYB5YQWZGiz1aVq5Pgr2GrQu,12,12,0,6,0,19,7,1,45,6.428571428571429,1,0.0,8,0,5,0,4,19,1,7,1,13,32,0
8840,119305,kLbYKjAePyQg6GOXHiVGeoyhhDvXEfjN,SpATywNh6bZuzm8s1ceuBUnMUAeoAHHw,25,68,3,32,1,37,23,7,171,24.428571428571427,6,0.0,31,3,28,1,37,37,4,23,7,63,108,0
8841,119309,kWr0BhoQMxiu9wSeKhtyX0T1P5JfsERH,SpATywNh6bZuzm8s1ceuBUnMUAeoAHHw,31,44,22,39,7,67,42,2,223,31.857142857142858,12,0.0,5,22,35,7,39,67,4,42,2,69,154,0
8842,119325,grNuFIQJF1sOOkw8RJjaExhlwTJt52uU,SpATywNh6bZuzm8s1ceuBUnMUAeoAHHw,31,99,45,24,8,158,55,5,394,56.285714285714285,10,0.0,21,45,23,8,78,158,1,55,5,97,297,0
8843,119330,Xx6t23p3XIha0hNmBziFcHG3GcEwTmQl,SpATywNh6bZuzm8s1ceuBUnMUAeoAHHw,29,32,19,25,9,30,40,2,157,22.428571428571427,2,0.0,7,19,22,9,25,30,3,40,2,57,100,0
8844,119332,FEK5BtdsP2RwxkLYp7U5A0VI3SgJyNlk,SpATywNh6bZuzm8s1ceuBUnMUAeoAHHw,5,7,1,0,1,0,1,0,10,1.4285714285714286,2,0.0,0,1,0,1,7,0,0,1,0,2,8,1
8845,119349,loZxBAFxFplmuCNvi9UHlWI1qnWbS4Xp,A3fsA9Zfv1X2fVEQhTw51lKENdNrEqT3,7,2,1,0,1,0,9,1,14,2.0,2,0.0,0,1,0,1,2,0,0,9,1,2,12,1
8846,119359,DhNEa94k5xGKWUPgWcx5F0CO6u6J4iIb,G8EPVSXsOYB5YQWZGiz1aVq5Pgr2GrQu,33,57,28,96,17,17,11,2,228,32.57142857142857,2,0.0,26,28,75,17,31,17,21,11,2,146,82,1
8847,119361,d0czHY9SleKhWFZVHkBc11jXgenCfeaE,SpATywNh6bZuzm8s1ceuBUnMUAeoAHHw,18,26,20,0,12,7,16,7,88,12.571428571428571,2,0.0,0,20,0,12,26,7,0,16,7,32,56,1
8848,119368,WfocL88obqufkiW8V6EsVJAto3ptM4se,RXDvfPUBYFlVdlueBFbLW0mhhAyGEqpt,13,9,0,0,0,2,11,2,24,3.4285714285714284,2,0.0,0,0,0,0,9,2,0,11,2,0,24,1
8849,119369,w0JXf5IU53zIrRHN4nASHPBtvGw0J3e8,SpATywNh6bZuzm8s1ceuBUnMUAeoAHHw,1,0,0,0,0,0,1,0,1,0.14285714285714285,1,0.0,0,0,0,0,0,0,0,1,0,0,1,1
8850,119372,RwvuGEh3euIR11rktJrGBhzDqcQMkhOC,SpATywNh6bZuzm8s1ceuBUnMUAeoAHHw,30,64,32,16,14,0,20,1,147,21.0,8,0.0,21,32,15,14,43,0,1,20,1,82,65,0
8851,119382,tiXCEdgwB1xd20Vy4mgIvE207fd2jlXf,SpATywNh6bZuzm8s1ceuBUnMUAeoAHHw,28,35,15,30,8,0,4,0,92,13.142857142857142,2,0.0,17,15,28,8,18,0,2,4,0,68,24,1
8852,119383,v2tR5cCXv44SOe8Z266q9U5FU2iAwtD3,SpATywNh6bZuzm8s1ceuBUnMUAeoAHHw,20,16,11,4,7,0,6,0,44,6.285714285714286,1,0.0,6,11,4,7,10,0,0,6,0,28,16,1
8853,119395,W4swLEiF6xa4CU1Ee5z4jQMNXyEDiyxR,A3fsA9Zfv1X2fVEQhTw51lKENdNrEqT3,8,2,0,0,0,7,7,1,17,2.4285714285714284,1,0.0,0,0,0,0,2,7,0,7,1,0,17,1
8854,119401,rSKz43hYiPnNMTLyx15fL1ocrthBLweg,SpATywNh6bZuzm8s1ceuBUnMUAeoAHHw,9,13,6,0,2,8,10,7,46,6.571428571428571,3,0.0,3,6,0,2,10,8,0,10,7,11,35,1
8855,119406,qL29jh1ARNpuNbjWhIJAl20fDBQmsVJq,A3fsA9Zfv1X2fVEQhTw51lKENdNrEqT3,1,0,0,0,0,0,1,0,1,0.14285714285714285,1,0.0,0,0,0,0,0,0,0,1,0,0,1,1
8856,119408,TDRTbyk0dkUIgXlX1DR0wEGLNYKbj2kE,SpATywNh6bZuzm8s1ceuBUnMUAeoAHHw,5,7,2,0,1,0,1,0,11,1.5714285714285714,1,0.0,2,2,0,1,5,0,0,1,0,5,6,0
8857,119413,HNjmezOX8bu6iW67SYkfKBzixQs4v7AY,SpATywNh6bZuzm8s1ceuBUnMUAeoAHHw,31,48,26,18,8,25,16,2,143,20.428571428571427,4,0.0,16,26,18,8,32,25,0,16,2,68,75,0
8858,119422,8bsgdKFaSfwROHIZCKXm97BMUW4OFzed,SpATywNh6bZuzm8s1ceuBUnMUAeoAHHw,28,30,15,22,7,6,10,0,90,12.857142857142858,5,0.0,9,15,18,7,21,6,4,10,0,49,41,0
8859,119437,WnuLHUQ0J3BeGgl165qL2l7BKuVDR3LS,RXDvfPUBYFlVdlueBFbLW0mhhAyGEqpt,51,66,5,129,5,2,11,2,220,31.428571428571427,4,0.0,12,5,121,5,54,2,8,11,2,143,77,0
8860,119446,XvNNzv39b8VqKid0q4fV9ms2wVNAdWks,A3fsA9Zfv1X2fVEQhTw51lKENdNrEqT3,1,0,0,0,0,0,1,0,1,0.14285714285714285,1,0.0,0,0,0,0,0,0,0,1,0,0,1,1
8861,119456,72z519PMt8GGBXLvF1FG0oMJuciCSWYJ,RXDvfPUBYFlVdlueBFbLW0mhhAyGEqpt,51,76,8,148,7,6,19,0,264,37.714285714285715,9,0.0,11,8,130,7,65,6,18,19,0,156,108,1
8862,119461,6ZwHbtvdiS8islxnPJXOOnLtMpvU3IpT,SpATywNh6bZuzm8s1ceuBUnMUAeoAHHw,18,27,15,0,12,0,10,2,66,9.428571428571429,6,0.0,3,15,0,12,24,0,0,10,2,30,36,0
8863,119482,S2q1gEPtloNcMfcAwTCrDjaeEJ3ox2aC,A3fsA9Zfv1X2fVEQhTw51lKENdNrEqT3,51,74,53,104,30,8,14,0,283,40.42857142857143,6,0.0,6,53,80,30,68,8,24,14,0,169,114,1
8864,119493,50aSuabL02e7lLNBHTRXsMQnBChV2lSX,G8EPVSXsOYB5YQWZGiz1aVq5Pgr2GrQu,4,2,0,0,0,0,2,0,4,0.5714285714285714,1,0.0,0,0,0,0,2,0,0,2,0,0,4,1
8865,119496,HJsFc87NFCDg5yRkkakXIT7nSH8XGxhF,A3fsA9Zfv1X2fVEQhTw51lKENdNrEqT3,9,4,3,0,3,0,2,0,12,1.7142857142857142,1,0.0,0,3,0,3,4,0,0,2,0,6,6,1
8866,119501,iWlNj0RlfLQkFgeY87o4tMiHnUMI1yTI,G8EPVSXsOYB5YQWZGiz1aVq5Pgr2GrQu,12,15,5,14,5,0,9,0,48,6.857142857142857,4,0.0,8,5,9,5,7,0,5,9,0,27,21,1
8867,119515,0mqsqXT4HPDOQPxpDnEoZEe1KeuUzpQx,SpATywNh6bZuzm8s1ceuBUnMUAeoAHHw,25,82,11,33,7,1,20,0,154,22.0,9,0.0,17,11,28,7,65,1,5,20,0,63,91,0
8868,119520,ZQcWT47pZxjNboL0V0inwxjvImMCbKfc,SpATywNh6bZuzm8s1ceuBUnMUAeoAHHw,28,114,33,28,13,0,23,0,211,30.142857142857142,8,0.0,6,33,23,13,108,0,5,23,0,75,136,0
8869,119528,BnWzYOrzXkQQKpdPflOsG06i68fZaDTp,SpATywNh6bZuzm8s1ceuBUnMUAeoAHHw,8,5,0,0,0,0,6,0,11,1.5714285714285714,1,0.0,0,0,0,0,5,0,0,6,0,0,11,1
8870,119537,OHgepWjzcLmDHpgOxR6c8DhDBUqi1HDm,G8EPVSXsOYB5YQWZGiz1aVq5Pgr2GrQu,2,0,0,0,0,0,2,0,2,0.2857142857142857,1,0.0,0,0,0,0,0,0,0,2,0,0,2,1
8871,119540,OHgepWjzcLmDHpgOxR6c8DhDBUqi1HDm,bWdj2GDclj5ofokWjzoa5jAwMkxCykd6,7,2,1,0,1,0,4,0,8,1.1428571428571428,1,0.0,0,1,0,1,2,0,0,4,0,2,6,1
8872,119544,NHjxa47feJ9sWQnmg6HoO6L78eHIRwnl,A3fsA9Zfv1X2fVEQhTw51lKENdNrEqT3,3,2,0,0,0,0,1,0,3,0.42857142857142855,1,0.0,0,0,0,0,2,0,0,1,0,0,3,1
8873,119547,NHjxa47feJ9sWQnmg6HoO6L78eHIRwnl,RXDvfPUBYFlVdlueBFbLW0mhhAyGEqpt,16,24,1,0,0,0,7,0,32,4.571428571428571,2,0.0,1,1,0,0,23,0,0,7,0,2,30,1
8874,119555,72z519PMt8GGBXLvF1FG0oMJuciCSWYJ,A3fsA9Zfv1X2fVEQhTw51lKENdNrEqT3,7,8,1,0,1,0,1,0,11,1.5714285714285714,1,0.0,0,1,0,1,8,0,0,1,0,2,9,0
8875,119556,ZQcWT47pZxjNboL0V0inwxjvImMCbKfc,A3fsA9Zfv1X2fVEQhTw51lKENdNrEqT3,54,93,29,68,14,0,24,1,229,32.714285714285715,6,0.0,2,29,58,14,91,0,10,24,1,103,126,1
8876,119563,HbDZBLuVJ2GX78KybFnufJtg8yn0zj71,SpATywNh6bZuzm8s1ceuBUnMUAeoAHHw,24,22,17,17,11,0,3,0,70,10.0,2,0.0,3,17,13,11,19,0,4,3,0,44,26,1
8877,119570,vuz6r1wL6cSmPMYDw5wsdIxwDVSbQPGA,SpATywNh6bZuzm8s1ceuBUnMUAeoAHHw,15,21,13,16,5,1,4,0,60,8.571428571428571,2,0.0,5,13,14,5,16,1,2,4,0,37,23,1
8878,119577,ZtIdVQN3EYruDP82MkDXBV4HsWJ99nHc,SpATywNh6bZuzm8s1ceuBUnMUAeoAHHw,17,12,1,12,0,7,18,1,51,7.285714285714286,4,0.0,0,1,10,0,12,7,2,18,1,11,40,1
8879,119580,TnET23MWjnuobi5dYEzVGlV9qd1ZWPbL,A3fsA9Zfv1X2fVEQhTw51lKENdNrEqT3,41,68,25,0,15,0,2,0,110,15.714285714285714,2,0.0,0,25,0,15,68,0,0,2,0,40,70,0
8880,119590,hWuNPhEBxnKOOJFguUTUYW5SrQ5ZI8jY,SpATywNh6bZuzm8s1ceuBUnMUAeoAHHw,5,2,1,0,1,0,2,0,6,0.8571428571428571,1,0.0,0,1,0,1,2,0,0,2,0,2,4,1
8881,119595,GPzUdrAeOhUs39B3OZTNuOkoEWda0QRy,G8EPVSXsOYB5YQWZGiz1aVq5Pgr2GrQu,9,6,0,0,0,3,10,0,19,2.7142857142857144,1,0.0,0,0,0,0,6,3,0,10,0,0,19,1
8882,119601,VW1NSXHsRBHsQFDrAdwMVKxbl0FK1kSa,SpATywNh6bZuzm8s1ceuBUnMUAeoAHHw,4,5,1,0,0,0,2,0,8,1.1428571428571428,1,0.0,0,1,0,0,5,0,0,2,0,1,7,0
8883,119603,RwVsCYe1en11KhE66sG3vEW9DQBctFlb,SpATywNh6bZuzm8s1ceuBUnMUAeoAHHw,28,48,23,30,11,0,9,0,121,17.285714285714285,5,0.0,18,23,29,11,30,0,1,9,0,81,40,1
8884,119629,nIvIddlMAmTQagaACOulbZ6PInxlyOy2,G8EPVSXsOYB5YQWZGiz1aVq5Pgr2GrQu,1,0,0,0,0,0,1,0,1,0.14285714285714285,1,0.0,0,0,0,0,0,0,0,1,0,0,1,1
8885,119630,nIvIddlMAmTQagaACOulbZ6PInxlyOy2,RXDvfPUBYFlVdlueBFbLW0mhhAyGEqpt,1,0,0,0,0,0,1,0,1,0.14285714285714285,1,0.0,0,0,0,0,0,0,0,1,0,0,1,1
8886,119633,owff2SMFy8taj2Sp3iBe2dPorkqov8kW,SpATywNh6bZuzm8s1ceuBUnMUAeoAHHw,29,56,34,22,21,16,22,5,176,25.142857142857142,10,0.0,9,34,18,21,47,16,4,22,5,82,94,0
8887,119636,ocTIjxG8zBs0mQRpUtpuAKc7MDpzU7Sd,RXDvfPUBYFlVdlueBFbLW0mhhAyGEqpt,5,2,1,0,1,0,3,0,7,1.0,1,0.0,0,1,0,1,2,0,0,3,0,2,5,1
8888,119662,sImBATl7O8yGkyet4MbeHdX4JDcSvSmd,SpATywNh6bZuzm8s1ceuBUnMUAeoAHHw,6,4,1,0,1,0,2,0,8,1.1428571428571428,1,0.0,0,1,0,1,4,0,0,2,0,2,6,1
8889,119668,Iydx83GAroCbGGGXrOpRJJuSwZtmEEM2,G8EPVSXsOYB5YQWZGiz1aVq5Pgr2GrQu,4,2,1,0,1,2,1,0,7,1.0,1,0.0,0,1,0,1,2,2,0,1,0,2,5,0
8890,119670,zVRAzbnjBCQDkq8v9znUSK3YAm6GKwXz,SpATywNh6bZuzm8s1ceuBUnMUAeoAHHw,13,18,1,6,0,1,6,1,33,4.714285714285714,1,0.0,2,1,5,0,16,1,1,6,1,8,25,0
8891,119681,528WImnBRwlpaJrHx5YESmcymECT8QVd,SpATywNh6bZuzm8s1ceuBUnMUAeoAHHw,7,6,4,0,3,0,2,0,15,2.142857142857143,1,0.0,0,4,0,3,6,0,0,2,0,7,8,1
8892,119685,OOIu03NBEHePUSUIFa86FGFP5M136EAn,SpATywNh6bZuzm8s1ceuBUnMUAeoAHHw,25,43,15,12,7,0,9,0,86,12.285714285714286,6,0.0,15,15,12,7,28,0,0,9,0,49,37,0
8893,119699,poqFOGQT2LdvIPHVhQsrQlPpawp1crlg,RXDvfPUBYFlVdlueBFbLW0mhhAyGEqpt,32,104,44,11,40,5,2,0,206,29.428571428571427,5,0.0,0,44,10,40,104,5,1,2,0,94,112,0
8894,119700,6PXcyDdGgas03jfN9GNBg7eDbTNLi58b,A3fsA9Zfv1X2fVEQhTw51lKENdNrEqT3,42,27,13,66,9,0,8,0,123,17.571428571428573,1,0.0,2,13,56,9,25,0,10,8,0,80,43,1
8895,119705,jyrCU8C7BRBPvFcEuIthOI2idRHtzC9e,RXDvfPUBYFlVdlueBFbLW0mhhAyGEqpt,3,0,0,0,0,0,3,0,3,0.42857142857142855,1,0.0,0,0,0,0,0,0,0,3,0,0,3,1
8896,119706,4aBimyYkJ2UKqGpkp7oZ1zAX2svcfueq,SpATywNh6bZuzm8s1ceuBUnMUAeoAHHw,16,16,6,19,4,0,2,0,47,6.714285714285714,2,0.0,10,6,17,4,6,0,2,2,0,37,10,1
8897,119713,6PXcyDdGgas03jfN9GNBg7eDbTNLi58b,bWdj2GDclj5ofokWjzoa5jAwMkxCykd6,2,0,0,0,0,0,2,0,2,0.2857142857142857,1,0.0,0,0,0,0,0,0,0,2,0,0,2,1
8898,119718,GB4yB9EIEjt1Ja66w5VOBhvDfHhUpkZn,G8EPVSXsOYB5YQWZGiz1aVq5Pgr2GrQu,14,13,9,0,8,0,4,0,34,4.857142857142857,3,0.0,0,9,0,8,13,0,0,4,0,17,17,1
8899,119720,k6RJ44LpfDefc4BqSfb5Ks3bqRLzpbPs,A3fsA9Zfv1X2fVEQhTw51lKENdNrEqT3,14,12,0,10,0,0,4,0,26,3.7142857142857144,2,0.0,0,0,9,0,12,0,1,4,0,9,17,1
8900,119726,crYeYmekM522NBCXMSSwnlz38sA9PXwb,SpATywNh6bZuzm8s1ceuBUnMUAeoAHHw,1,0,0,0,0,0,1,0,1,0.14285714285714285,1,0.0,0,0,0,0,0,0,0,1,0,0,1,1
8901,119730,6ap3DhKROc7tFODwClFOjVJl3s3EA3mu,G8EPVSXsOYB5YQWZGiz1aVq5Pgr2GrQu,18,32,21,10,22,0,24,0,109,15.571428571428571,5,0.0,7,21,7,22,25,0,3,24,0,57,52,1
8902,119735,7spTo5lIRwZxDBcGilRyFIwiDfkCxjQE,SpATywNh6bZuzm8s1ceuBUnMUAeoAHHw,20,38,1,24,0,22,13,0,98,14.0,4,0.0,16,1,20,0,22,22,4,13,0,37,61,1
8903,119738,mu5O3Y2ITikjmKkPmDursRzlvrhHDXTz,SpATywNh6bZuzm8s1ceuBUnMUAeoAHHw,2,0,0,0,0,0,2,0,2,0.2857142857142857,1,0.0,0,0,0,0,0,0,0,2,0,0,2,1
8904,119742,PHTS4r6mOEHpVZfm3SzAd9KLg785EPpx,SpATywNh6bZuzm8s1ceuBUnMUAeoAHHw,31,89,41,24,15,59,27,2,257,36.714285714285715,12,0.0,7,41,24,15,82,59,0,27,2,87,170,0
8905,119748,wIXH3gEY2v8CIGUg8D6sapoHRbIUXs86,SpATywNh6bZuzm8s1ceuBUnMUAeoAHHw,21,21,2,17,0,1,4,0,45,6.428571428571429,2,0.0,5,2,17,0,16,1,0,4,0,24,21,1
8906,119749,r81fu0o4ondjTT64GPXMD4igVXZTnWR1,G8EPVSXsOYB5YQWZGiz1aVq5Pgr2GrQu,15,18,1,22,0,0,4,0,45,6.428571428571429,2,0.0,3,1,17,0,15,0,5,4,0,21,24,1
8907,119758,VbCHzxhJd8ennilHHm3zMG389MZjcR4g,SpATywNh6bZuzm8s1ceuBUnMUAeoAHHw,28,30,14,30,8,10,7,0,99,14.142857142857142,7,0.0,10,14,28,8,20,10,2,7,0,60,39,0
8908,119759,eXv6ACzt62C4hMSoDSIQMvmz4LEnGBtm,SpATywNh6bZuzm8s1ceuBUnMUAeoAHHw,17,46,18,42,0,23,37,4,170,24.285714285714285,11,0.0,16,18,33,0,30,23,9,37,4,67,103,0
8909,119765,pTILTxXRSQA3FxWLi5P70kOpV3SZ6Qdg,SpATywNh6bZuzm8s1ceuBUnMUAeoAHHw,1,0,0,0,0,0,1,0,1,0.14285714285714285,1,0.0,0,0,0,0,0,0,0,1,0,0,1,1
8910,119767,OXe0TiHLRyjl3AO2ffihLeA3ZfDF07jU,SpATywNh6bZuzm8s1ceuBUnMUAeoAHHw,12,12,3,0,2,0,2,0,19,2.7142857142857144,2,0.0,0,3,0,2,12,0,0,2,0,5,14,1
8911,119775,Hvo87huFBpCunolEWjcvbDUcmX9h25rT,SpATywNh6bZuzm8s1ceuBUnMUAeoAHHw,30,37,23,9,13,1,10,1,94,13.428571428571429,2,0.0,6,23,9,13,31,1,0,10,1,51,43,1
8912,119777,6r9w9XrCXpAInFHxfDIxOD9m18cX5jcd,SpATywNh6bZuzm8s1ceuBUnMUAeoAHHw,9,9,1,0,1,0,3,0,14,2.0,1,0.0,0,1,0,1,9,0,0,3,0,2,12,1
8913,119783,XRCyFAenNfq06SRijoW2bL3eLeq7TTnH,SpATywNh6bZuzm8s1ceuBUnMUAeoAHHw,2,0,0,0,0,0,2,0,2,0.2857142857142857,1,0.0,0,0,0,0,0,0,0,2,0,0,2,1
8914,119789,s5PM22AMhoKbdj4BvXCXSb2DG7kHVY83,bWdj2GDclj5ofokWjzoa5jAwMkxCykd6,7,9,2,0,1,0,1,0,13,1.8571428571428572,1,0.0,0,2,0,1,9,0,0,1,0,3,10,1
8915,119791,WdCL06lQKY0BoTH9YYJuYqUtT5XtLkKl,A3fsA9Zfv1X2fVEQhTw51lKENdNrEqT3,1,0,0,0,0,0,1,0,1,0.14285714285714285,1,0.0,0,0,0,0,0,0,0,1,0,0,1,1
8916,119801,jORRvCSUTQr1FHykD1dmWMVMdAoKMUmG,RXDvfPUBYFlVdlueBFbLW0mhhAyGEqpt,8,3,2,0,2,0,4,1,12,1.7142857142857142,1,0.0,0,2,0,2,3,0,0,4,1,4,8,1
8917,119802,pgn1580cn8cQemEJzrm47II2SqctZZrK,G8EPVSXsOYB5YQWZGiz1aVq5Pgr2GrQu,36,27,18,0,17,0,3,0,65,9.285714285714286,3,0.0,2,18,0,17,25,0,0,3,0,37,28,0
8918,119807,ABAPRQWSFErhHUFQsJmCoj4Rpg4DtQ8w,bWdj2GDclj5ofokWjzoa5jAwMkxCykd6,2,0,0,0,0,0,6,0,6,0.8571428571428571,2,0.0,0,0,0,0,0,0,0,6,0,0,6,1
8919,119825,xwG9GgMrPHgbqqrlvclpGJMpSPdOCjxQ,A3fsA9Zfv1X2fVEQhTw51lKENdNrEqT3,6,6,0,0,0,0,2,0,8,1.1428571428571428,2,0.0,1,0,0,0,5,0,0,2,0,1,7,1
8920,119833,DhGcyoTp73fKDVPL51XtXQlMqfdtfXVc,SpATywNh6bZuzm8s1ceuBUnMUAeoAHHw,6,3,2,0,2,7,3,0,17,2.4285714285714284,2,0.0,0,2,0,2,3,7,0,3,0,4,13,1
8921,119836,GyWTABuPpZEqO585EnNTIpM2B2faPYN3,A3fsA9Zfv1X2fVEQhTw51lKENdNrEqT3,8,7,5,0,3,0,3,0,18,2.5714285714285716,1,0.0,0,5,0,3,7,0,0,3,0,8,10,1
8922,119867,bCILkQHxUJub9H7cxxmSR5zqZAu3BvHB,SpATywNh6bZuzm8s1ceuBUnMUAeoAHHw,24,19,15,0,8,0,5,0,47,6.714285714285714,2,0.0,0,15,0,8,19,0,0,5,0,23,24,1
8923,119878,T7izEMyckZ14Dpb0HXCCbCEgRCtemG2v,A3fsA9Zfv1X2fVEQhTw51lKENdNrEqT3,7,10,2,0,0,0,8,0,20,2.857142857142857,4,0.0,0,2,0,0,10,0,0,8,0,2,18,1
8924,119879,ClHMnOLy9vZKRtNjcA9yPWajeNvRCNdE,RXDvfPUBYFlVdlueBFbLW0mhhAyGEqpt,1,0,0,0,0,0,1,0,1,0.14285714285714285,1,0.0,0,0,0,0,0,0,0,1,0,0,1,1
8925,119888,pgB6pQ9DmcVMwAXk0gVwFSTwyA4alFe0,SpATywNh6bZuzm8s1ceuBUnMUAeoAHHw,7,4,3,0,0,1,5,0,13,1.8571428571428572,2,0.0,0,3,0,0,4,1,0,5,0,3,10,1
8926,119892,6PXcyDdGgas03jfN9GNBg7eDbTNLi58b,SpATywNh6bZuzm8s1ceuBUnMUAeoAHHw,5,3,1,0,1,1,3,0,9,1.2857142857142858,1,0.0,0,1,0,1,3,1,0,3,0,2,7,1
8927,119895,JAh5RXKrssqx6aZ2Y0OKL2tpBD86qsyv,SpATywNh6bZuzm8s1ceuBUnMUAeoAHHw,10,8,1,0,1,0,9,0,19,2.7142857142857144,1,0.0,0,1,0,1,8,0,0,9,0,2,17,1
8928,119896,c4MI9OfbyJ0RGX9j0ZiKqfaHb3fSOPCp,SpATywNh6bZuzm8s1ceuBUnMUAeoAHHw,9,26,1,11,0,0,8,0,46,6.571428571428571,3,0.0,10,1,11,0,16,0,0,8,0,22,24,1
8929,119898,7nQB7cjVdr2HijR82OoX1oMRPa42JjfY,A3fsA9Zfv1X2fVEQhTw51lKENdNrEqT3,13,7,5,0,2,2,8,1,25,3.5714285714285716,2,0.0,0,5,0,2,7,2,0,8,1,7,18,1
8930,119905,alePu0FhXWTyAf3z1TbtScq1Obpgwyvj,SpATywNh6bZuzm8s1ceuBUnMUAeoAHHw,10,5,2,0,2,1,9,1,20,2.857142857142857,1,0.0,0,2,0,2,5,1,0,9,1,4,16,0
8931,119907,Tlrkgpa05toeVrZOHafHN5HVS3Ley7hG,A3fsA9Zfv1X2fVEQhTw51lKENdNrEqT3,51,37,25,46,13,1,14,1,137,19.571428571428573,5,0.0,6,25,46,13,31,1,0,14,1,90,47,1
8932,119923,nrDkIZH2wqEVh6i4pBxcbRBJIMc9s20b,SpATywNh6bZuzm8s1ceuBUnMUAeoAHHw,20,80,3,34,2,0,23,0,142,20.285714285714285,9,0.0,24,3,29,2,56,0,5,23,0,58,84,0
8933,119933,nHnSkTZVeRCsQFFRAJ2tasC3JodYcJAU,SpATywNh6bZuzm8s1ceuBUnMUAeoAHHw,14,25,11,0,8,0,3,0,47,6.714285714285714,1,0.0,0,11,0,8,25,0,0,3,0,19,28,1
8934,119935,4uCHoIviHPzCtwadirbZDGuLNqx4H5qx,SpATywNh6bZuzm8s1ceuBUnMUAeoAHHw,28,48,23,44,6,0,10,0,131,18.714285714285715,4,0.0,17,23,37,6,31,0,7,10,0,83,48,0
8935,119937,l70wRZ2DS0s6LjbT7C4gRoGrF27x9p2H,bWdj2GDclj5ofokWjzoa5jAwMkxCykd6,1,0,0,0,0,0,1,0,1,0.14285714285714285,1,0.0,0,0,0,0,0,0,0,1,0,0,1,1
8936,119938,hdh7f9dbamC5OLbnjQIw5ciTwmy2oqSe,A3fsA9Zfv1X2fVEQhTw51lKENdNrEqT3,29,29,23,0,19,0,8,0,79,11.285714285714286,4,0.0,0,23,0,19,29,0,0,8,0,42,37,1
8937,119942,D9eQoamtTDpiMV0b0OdGca728kthGUV3,SpATywNh6bZuzm8s1ceuBUnMUAeoAHHw,7,6,0,4,0,0,3,0,13,1.8571428571428572,2,0.0,1,0,4,0,5,0,0,3,0,5,8,0
8938,119947,jnIQMhy9SQ2YnxY9vLXkaYJhqSTRkdV3,SpATywNh6bZuzm8s1ceuBUnMUAeoAHHw,24,40,17,7,9,0,8,0,81,11.571428571428571,3,0.0,18,17,7,9,22,0,0,8,0,51,30,1
8939,119949,3dRJytFtMTBsljPJJKUMWZqWEGtFd6rm,SpATywNh6bZuzm8s1ceuBUnMUAeoAHHw,14,16,4,17,3,0,2,0,42,6.0,1,0.0,10,4,14,3,6,0,3,2,0,31,11,1
8940,119953,ixEbiSQCdFYvedCjd9ZSVhkHMvgSKaLG,SpATywNh6bZuzm8s1ceuBUnMUAeoAHHw,8,6,4,0,3,0,3,0,16,2.2857142857142856,2,0.0,0,4,0,3,6,0,0,3,0,7,9,1
8941,119958,lm0zg2eARlzCRkKcI4nbhfozsZEvEhl3,SpATywNh6bZuzm8s1ceuBUnMUAeoAHHw,11,8,1,12,0,0,2,0,23,3.2857142857142856,1,0.0,2,1,11,0,6,0,1,2,0,14,9,1
8942,119960,4TtGjmtd4ISORDD5okRgx7kXAcGUW8IN,RXDvfPUBYFlVdlueBFbLW0mhhAyGEqpt,9,4,3,0,1,4,5,1,18,2.5714285714285716,2,0.0,0,3,0,1,4,4,0,5,1,4,14,1
8943,119969,RpC8ahxzmHtiHrtEolXbAvhs5yymX13F,SpATywNh6bZuzm8s1ceuBUnMUAeoAHHw,5,4,3,0,2,0,2,0,11,1.5714285714285714,1,0.0,0,3,0,2,4,0,0,2,0,5,6,1
8944,119970,4kQU73UJCeVbdLolFE0fE9baW58Y34lz,SpATywNh6bZuzm8s1ceuBUnMUAeoAHHw,11,8,5,0,3,0,8,1,25,3.5714285714285716,1,0.0,0,5,0,3,8,0,0,8,1,8,17,1
8945,119973,0NGZq9HZW5KOrSfzSGGipuN20pCRDMWu,RXDvfPUBYFlVdlueBFbLW0mhhAyGEqpt,13,9,6,0,4,3,4,0,26,3.7142857142857144,1,0.0,0,6,0,4,9,3,0,4,0,10,16,0
8946,119974,VLq5RjmauxaFZfPnx2f9r9Dehjw868o9,SpATywNh6bZuzm8s1ceuBUnMUAeoAHHw,22,35,21,11,12,6,14,2,101,14.428571428571429,6,0.0,2,21,11,12,33,6,0,14,2,46,55,0
8947,119981,hNJz0qbOhrUgajUkzqSdDbybHkuRglfs,A3fsA9Zfv1X2fVEQhTw51lKENdNrEqT3,39,21,15,56,9,1,8,1,111,15.857142857142858,2,0.0,3,15,48,9,18,1,8,8,1,75,36,0
8948,119983,8ZvgmVWPuU4xKWq9tw3YZdhhMDnHsFgT,SpATywNh6bZuzm8s1ceuBUnMUAeoAHHw,29,72,27,24,11,37,49,3,223,31.857142857142858,13,0.0,14,27,21,11,58,37,3,49,3,73,150,0
8949,119991,EjqS3A2Iv9J8JTjinbKy3gdtrrXaSQyJ,bWdj2GDclj5ofokWjzoa5jAwMkxCykd6,4,4,2,0,0,0,2,0,8,1.1428571428571428,2,0.0,0,2,0,0,4,0,0,2,0,2,6,1
8950,119993,GMzSpgZQ6jzVsfHn8W8i83JsYNxnP00b,A3fsA9Zfv1X2fVEQhTw51lKENdNrEqT3,5,3,2,0,1,0,1,0,7,1.0,1,0.0,0,2,0,1,3,0,0,1,0,3,4,1
8951,119994,O4934ANB2qMTFJBwUqvZeG7DbnQJCsce,SpATywNh6bZuzm8s1ceuBUnMUAeoAHHw,27,28,11,29,7,0,3,0,78,11.142857142857142,2,0.0,8,11,27,7,20,0,2,3,0,53,25,1
8952,120004,4mdszhiojUd6ka3AsjiiGyQ3X7W5E7uc,A3fsA9Zfv1X2fVEQhTw51lKENdNrEqT3,1,0,0,0,0,0,2,0,2,0.2857142857142857,2,0.0,0,0,0,0,0,0,0,2,0,0,2,1
8953,120015,4YCZfbR5vSUmQm9JKU53CaLT4o7zzhD5,A3fsA9Zfv1X2fVEQhTw51lKENdNrEqT3,1,0,0,0,0,0,1,0,1,0.14285714285714285,1,0.0,0,0,0,0,0,0,0,1,0,0,1,1
8954,120019,eC4QFVNRkDMJURDQ2ZX8Orvtuy3F8ILJ,SpATywNh6bZuzm8s1ceuBUnMUAeoAHHw,15,18,3,24,1,0,8,0,54,7.714285714285714,2,0.0,8,3,19,1,10,0,5,8,0,31,23,1
8955,120021,xr2T8ak6swOOfU9oanYvPbQ4STab9s9f,bWdj2GDclj5ofokWjzoa5jAwMkxCykd6,11,30,2,0,2,0,16,0,50,7.142857142857143,5,0.0,7,2,0,2,23,0,0,16,0,11,39,1
8956,120022,npXfYqxF0TCNN5vliwdRJdFcBk0rmfXv,bWdj2GDclj5ofokWjzoa5jAwMkxCykd6,13,20,6,16,7,6,15,2,72,10.285714285714286,5,0.0,5,6,14,7,15,6,2,15,2,32,40,0
8957,120026,ZH0VWJ7XJWogjYH6Qq2Nr4TMh6fe5JGW,SpATywNh6bZuzm8s1ceuBUnMUAeoAHHw,16,44,4,6,0,0,7,0,61,8.714285714285714,5,0.0,0,4,6,0,44,0,0,7,0,10,51,0
8958,120032,n58OZShh1DSriRlOeR7KzkMLpM8Ixh01,A3fsA9Zfv1X2fVEQhTw51lKENdNrEqT3,2,0,0,0,0,0,3,0,3,0.42857142857142855,1,0.0,0,0,0,0,0,0,0,3,0,0,3,1
8959,120052,2VfZF4h8v7eR70PfxTwoJImij1XH3cw0,SpATywNh6bZuzm8s1ceuBUnMUAeoAHHw,9,5,4,0,3,1,13,0,26,3.7142857142857144,1,0.0,0,4,0,3,5,1,0,13,0,7,19,1
8960,120053,WELjmgdsP962Pc1teJ96xvofKraKe6qa,RXDvfPUBYFlVdlueBFbLW0mhhAyGEqpt,6,5,3,0,1,9,2,0,20,2.857142857142857,1,0.0,0,3,0,1,5,9,0,2,0,4,16,1
8961,120056,fzsHY2LgfBXg8YsHOoWkwNUOqIdUaJDy,bWdj2GDclj5ofokWjzoa5jAwMkxCykd6,2,0,0,0,0,0,3,0,3,0.42857142857142855,1,0.0,0,0,0,0,0,0,0,3,0,0,3,1
8962,120069,md1Mf60Z4ySa4NKHKWMKq8Bxh8C0w3Ro,SpATywNh6bZuzm8s1ceuBUnMUAeoAHHw,10,12,6,0,2,4,7,0,31,4.428571428571429,2,0.0,2,6,0,2,10,4,0,7,0,10,21,1
8963,120070,JkGUdKB9J1ONvSF3GWx5guW4dzLf3fLB,RXDvfPUBYFlVdlueBFbLW0mhhAyGEqpt,6,4,3,0,1,0,2,0,10,1.4285714285714286,1,0.0,0,3,0,1,4,0,0,2,0,4,6,1
8964,120071,3n6ajKAkQu8rgtUnNpdWOfMF8VSNsMVs,G8EPVSXsOYB5YQWZGiz1aVq5Pgr2GrQu,6,5,3,0,0,0,3,0,11,1.5714285714285714,2,0.0,0,3,0,0,5,0,0,3,0,3,8,1
8965,120073,2VfZF4h8v7eR70PfxTwoJImij1XH3cw0,RXDvfPUBYFlVdlueBFbLW0mhhAyGEqpt,5,2,1,0,1,0,2,0,6,0.8571428571428571,1,0.0,0,1,0,1,2,0,0,2,0,2,4,1
8966,120075,OwDVM5C0ZIkYKCNBKi1eBMmRNb7I7ptI,bWdj2GDclj5ofokWjzoa5jAwMkxCykd6,2,0,0,0,0,0,5,0,5,0.7142857142857143,1,0.0,0,0,0,0,0,0,0,5,0,0,5,1
8967,120076,4YCZfbR5vSUmQm9JKU53CaLT4o7zzhD5,G8EPVSXsOYB5YQWZGiz1aVq5Pgr2GrQu,1,0,0,0,0,0,1,0,1,0.14285714285714285,1,0.0,0,0,0,0,0,0,0,1,0,0,1,1
8968,120078,saXRSf4MnhO78zgLoljZlslavqJjBtLm,bWdj2GDclj5ofokWjzoa5jAwMkxCykd6,20,80,7,60,7,48,31,0,233,33.285714285714285,6,0.0,20,7,54,7,60,48,6,31,0,88,145,1
8969,120085,SozLQk8695JG7fvj1Enp26s5ACJQjjq5,RXDvfPUBYFlVdlueBFbLW0mhhAyGEqpt,1,0,0,0,0,0,1,0,1,0.14285714285714285,1,0.0,0,0,0,0,0,0,0,1,0,0,1,1
8970,120088,ZOVfvlm206voHlGJ4V6McNGjtxTxB7JQ,A3fsA9Zfv1X2fVEQhTw51lKENdNrEqT3,16,12,10,0,8,0,4,0,34,4.857142857142857,4,0.0,0,10,0,8,12,0,0,4,0,18,16,1
8971,120097,5pfeeYLWSB4wCSWnPZbrmiSBS3yXgMsk,bWdj2GDclj5ofokWjzoa5jAwMkxCykd6,7,5,1,0,1,0,4,0,11,1.5714285714285714,2,0.0,0,1,0,1,5,0,0,4,0,2,9,1
8972,120100,JdKnU2sktk6AZyjwyIqgEXYK8OtgPCn2,bWdj2GDclj5ofokWjzoa5jAwMkxCykd6,16,27,10,0,15,0,8,0,60,8.571428571428571,2,0.0,4,10,0,15,23,0,0,8,0,29,31,0
8973,120111,aGyzysUQgcpficWqTygk8rcuo677dPZU,SpATywNh6bZuzm8s1ceuBUnMUAeoAHHw,29,101,17,51,8,30,25,3,235,33.57142857142857,8,0.0,34,17,43,8,67,30,8,25,3,102,133,0
8974,120118,cPZ5ch8V46zptI5nnRGh9SfMnAQrVDUi,bWdj2GDclj5ofokWjzoa5jAwMkxCykd6,14,37,20,0,12,7,12,0,88,12.571428571428571,5,0.0,4,20,0,12,33,7,0,12,0,36,52,0
8975,120124,Ga7iU5IP3f6oL4nXlygCBVszreMPGCt3,G8EPVSXsOYB5YQWZGiz1aVq5Pgr2GrQu,1,0,0,0,0,0,1,0,1,0.14285714285714285,1,0.0,0,0,0,0,0,0,0,1,0,0,1,1
8976,120126,c6XaDpje2iQSWpoXkTtf00BW6tACh6Q9,SpATywNh6bZuzm8s1ceuBUnMUAeoAHHw,31,67,31,31,14,25,28,3,199,28.428571428571427,4,0.0,10,31,28,14,57,25,3,28,3,83,116,0
8977,120129,nDUXGSBgQyo69KyzDsvsphUp6qKxv1Ib,SpATywNh6bZuzm8s1ceuBUnMUAeoAHHw,5,2,1,0,1,0,2,0,6,0.8571428571428571,1,0.0,0,1,0,1,2,0,0,2,0,2,4,1
8978,120134,nKMPTOF6v1sp7aVmO78zmSRg9f9QXrTf,A3fsA9Zfv1X2fVEQhTw51lKENdNrEqT3,70,54,39,147,22,1,10,0,273,39.0,6,0.0,4,39,131,22,50,1,16,10,0,196,77,1
8979,120142,Uxom3QvnZvmlcNVTXDTJG0YgMkZr2hhX,SpATywNh6bZuzm8s1ceuBUnMUAeoAHHw,7,3,2,0,2,0,2,0,9,1.2857142857142858,1,0.0,0,2,0,2,3,0,0,2,0,4,5,1
8980,120149,LY15AitabC9VNRy9N91XwsKL39G9Yhym,SpATywNh6bZuzm8s1ceuBUnMUAeoAHHw,24,31,18,14,8,14,10,4,99,14.142857142857142,4,0.0,6,18,11,8,25,14,3,10,4,43,56,1
8981,120153,la15uCtK5VeDQX41dystrGx2B895Oqjw,RXDvfPUBYFlVdlueBFbLW0mhhAyGEqpt,45,68,38,82,25,9,8,3,233,33.285714285714285,4,0.0,19,38,79,25,49,9,3,8,3,161,72,1
8982,120158,durZRNVeZgKGbNDftJUmwBeNsWC0AnPo,SpATywNh6bZuzm8s1ceuBUnMUAeoAHHw,1,0,0,0,0,0,1,0,1,0.14285714285714285,1,0.0,0,0,0,0,0,0,0,1,0,0,1,1
8983,120170,80Av2RXrFoxNOdv7EQUM2TDOM0gyNH0J,bWdj2GDclj5ofokWjzoa5jAwMkxCykd6,4,2,1,0,1,0,2,0,6,0.8571428571428571,1,0.0,0,1,0,1,2,0,0,2,0,2,4,1
8984,120171,ThGblU6q4nWmu3ORXgM7eQc8q9vcBP4r,A3fsA9Zfv1X2fVEQhTw51lKENdNrEqT3,37,39,5,56,1,0,28,0,129,18.428571428571427,5,0.0,4,5,49,1,35,0,7,28,0,59,70,1
8985,120177,83cBV2IXkwoW1nUaa1kxaJ98L3bxFsPn,A3fsA9Zfv1X2fVEQhTw51lKENdNrEqT3,54,66,50,72,5,7,17,0,217,31.0,12,0.0,2,50,72,5,64,7,0,17,0,129,88,0
8986,120181,yBsDX1Dsw9hy8f2NuaeMfD0tvX413Igw,bWdj2GDclj5ofokWjzoa5jAwMkxCykd6,5,2,1,0,1,0,3,0,7,1.0,2,0.0,0,1,0,1,2,0,0,3,0,2,5,0
8987,120194,Uylyq7LmmNSvSWdWZxt9uRF9NmGdfp0A,RXDvfPUBYFlVdlueBFbLW0mhhAyGEqpt,1,0,0,0,0,0,1,0,1,0.14285714285714285,1,0.0,0,0,0,0,0,0,0,1,0,0,1,1
8988,120196,qLscbApWydA7z1h7Ht7RN2UnF0mvGZpF,SpATywNh6bZuzm8s1ceuBUnMUAeoAHHw,17,33,1,20,1,0,7,0,62,8.857142857142858,2,0.0,7,1,16,1,26,0,4,7,0,25,37,1
8989,120204,cQbl9j85owwXzcR0zsrhIz1wkEuaLsqG,A3fsA9Zfv1X2fVEQhTw51lKENdNrEqT3,1,0,0,0,0,0,1,0,1,0.14285714285714285,1,0.0,0,0,0,0,0,0,0,1,0,0,1,1
8990,120211,WfK8spzPGQgUUjtYsrbByJpvEEqSCjRx,A3fsA9Zfv1X2fVEQhTw51lKENdNrEqT3,1,0,0,0,0,0,1,0,1,0.14285714285714285,1,0.0,0,0,0,0,0,0,0,1,0,0,1,1
8991,120219,Yp8yvTzeMvocSqLvL15ovVwipej5zHiT,SpATywNh6bZuzm8s1ceuBUnMUAeoAHHw,1,0,0,0,0,0,1,0,1,0.14285714285714285,1,0.0,0,0,0,0,0,0,0,1,0,0,1,1
8992,120228,zVgOUCulbNx05te9mrJWZeO6VJGrw5WO,G8EPVSXsOYB5YQWZGiz1aVq5Pgr2GrQu,14,19,10,8,1,0,9,0,47,6.714285714285714,2,0.0,3,10,5,1,16,0,3,9,0,19,28,1
8993,120230,LY15AitabC9VNRy9N91XwsKL39G9Yhym,G8EPVSXsOYB5YQWZGiz1aVq5Pgr2GrQu,22,43,11,0,11,0,10,0,75,10.714285714285714,6,0.0,8,11,0,11,35,0,0,10,0,30,45,1
8994,120234,1Rj37m2TWBRQIZjAlVjTge1bBoqghnB2,bWdj2GDclj5ofokWjzoa5jAwMkxCykd6,6,0,0,0,0,1,6,1,8,1.1428571428571428,1,0.0,0,0,0,0,0,1,0,6,1,0,8,1
8995,120240,YYie2sncdtzNtDvv2HrWAX3WcnBaHhtH,A3fsA9Zfv1X2fVEQhTw51lKENdNrEqT3,10,3,2,0,2,0,5,1,13,1.8571428571428572,1,0.0,0,2,0,2,3,0,0,5,1,4,9,1
8996,120251,qY3mO9VSgbSXrTZIckLWUEq4U741QpCT,SpATywNh6bZuzm8s1ceuBUnMUAeoAHHw,21,41,17,18,3,4,17,1,101,14.428571428571429,2,0.0,20,17,17,3,21,4,1,17,1,57,44,0
8997,120255,3nXqsLutTeQFNz1Ya8GTFnWUmV4VnYmX,SpATywNh6bZuzm8s1ceuBUnMUAeoAHHw,15,19,2,17,1,1,6,1,47,6.714285714285714,3,0.0,6,2,15,1,13,1,2,6,1,24,23,1
8998,120257,FsHh7NEicgBmDLs5h5Swts1JnEA5erYu,A3fsA9Zfv1X2fVEQhTw51lKENdNrEqT3,1,0,0,0,0,0,2,0,2,0.2857142857142857,1,0.0,0,0,0,0,0,0,0,2,0,0,2,1
8999,120262,x2vyDUpFuVAQOVEKoczKBtYvi1pP4Hfq,SpATywNh6bZuzm8s1ceuBUnMUAeoAHHw,1,0,0,0,0,0,1,0,1,0.14285714285714285,1,0.0,0,0,0,0,0,0,0,1,0,0,1,1
9000,120263,farPAnvPmsSrd5ovHg0tlsOgoAj5LoAg,SpATywNh6bZuzm8s1ceuBUnMUAeoAHHw,4,2,1,0,1,0,1,0,5,0.7142857142857143,1,0.0,0,1,0,1,2,0,0,1,0,2,3,1
9001,120270,oh70wjHZNiJm6YMEO2zTeIrDQMUiqmDd,A3fsA9Zfv1X2fVEQhTw51lKENdNrEqT3,11,15,1,0,1,0,2,0,19,2.7142857142857144,2,0.0,1,1,0,1,14,0,0,2,0,3,16,1
9002,120279,1cxiENcEp3mVuj0hieZU2n66DvVX0lKj,bWdj2GDclj5ofokWjzoa5jAwMkxCykd6,1,0,0,0,0,0,1,0,1,0.14285714285714285,1,0.0,0,0,0,0,0,0,0,1,0,0,1,1
9003,120284,1cxiENcEp3mVuj0hieZU2n66DvVX0lKj,A3fsA9Zfv1X2fVEQhTw51lKENdNrEqT3,8,2,0,0,0,2,10,1,15,2.142857142857143,1,0.0,0,0,0,0,2,2,0,10,1,0,15,1
9004,120285,G6cW0d2bzLHgB0vreFbhNx3GSiMBKbtv,A3fsA9Zfv1X2fVEQhTw51lKENdNrEqT3,40,23,10,48,9,0,3,0,93,13.285714285714286,2,0.0,2,10,46,9,21,0,2,3,0,67,26,1
9005,120287,JdKnU2sktk6AZyjwyIqgEXYK8OtgPCn2,A3fsA9Zfv1X2fVEQhTw51lKENdNrEqT3,11,11,5,0,3,0,3,1,23,3.2857142857142856,1,0.0,0,5,0,3,11,0,0,3,1,8,15,1
9006,120296,WnLVBva4oiF8muizYYbe8GP2LesbDaQA,SpATywNh6bZuzm8s1ceuBUnMUAeoAHHw,9,4,3,0,3,0,2,0,12,1.7142857142857142,1,0.0,0,3,0,3,4,0,0,2,0,6,6,1
9007,120318,Z01b5ZH1XnM8VywoaG2LGeoRdMPqFc6F,SpATywNh6bZuzm8s1ceuBUnMUAeoAHHw,9,9,4,0,3,0,7,1,24,3.4285714285714284,1,0.0,5,4,0,3,4,0,0,7,1,12,12,1
9008,120323,HZLnsnoiGm4WW2vjutmDoR0ipnBBZA4G,A3fsA9Zfv1X2fVEQhTw51lKENdNrEqT3,23,25,19,0,15,0,9,0,68,9.714285714285714,2,0.0,0,19,0,15,25,0,0,9,0,34,34,1
9009,120325,iG6MpbqzKA4jDaDFNYLj8a74oKQT8YWZ,A3fsA9Zfv1X2fVEQhTw51lKENdNrEqT3,2,0,0,0,0,0,4,0,4,0.5714285714285714,1,0.0,0,0,0,0,0,0,0,4,0,0,4,1
9010,120337,KDeaSgZ6wTHm30JcQgLQFVdVYbxH0KHc,SpATywNh6bZuzm8s1ceuBUnMUAeoAHHw,8,18,7,0,3,0,4,0,32,4.571428571428571,3,0.0,2,7,0,3,16,0,0,4,0,12,20,1
9011,120345,DsvMkutBFtLefRL1hsHU5bFQpdJBtlsH,SpATywNh6bZuzm8s1ceuBUnMUAeoAHHw,15,13,1,11,1,0,4,0,30,4.285714285714286,2,0.0,2,1,9,1,11,0,2,4,0,13,17,1
9012,120365,aXiJW8ayzWdjAFuCXJZEkZEM0lQLoZYD,bWdj2GDclj5ofokWjzoa5jAwMkxCykd6,9,16,4,0,2,5,12,1,40,5.714285714285714,2,0.0,4,4,0,2,12,5,0,12,1,10,30,1
9013,120369,Z0j9vlmYA8vddl2WEYwRJJAGu9WTMzZU,SpATywNh6bZuzm8s1ceuBUnMUAeoAHHw,6,3,2,0,2,0,1,0,8,1.1428571428571428,1,0.0,0,2,0,2,3,0,0,1,0,4,4,1
9014,120371,XQgYe2uvAKPXdUiz5f6AHKp9LdPbPxAU,A3fsA9Zfv1X2fVEQhTw51lKENdNrEqT3,5,4,2,0,1,0,2,0,9,1.2857142857142858,2,0.0,0,2,0,1,4,0,0,2,0,3,6,1
9015,120374,ePOpOKycvORTPdc6DfieYb44dd8ej3gR,SpATywNh6bZuzm8s1ceuBUnMUAeoAHHw,8,7,6,0,6,0,1,0,20,2.857142857142857,1,0.0,0,6,0,6,7,0,0,1,0,12,8,1
9016,120390,snoVfOu7m3uQyb0rtN2hVEbVR2VoIt0E,SpATywNh6bZuzm8s1ceuBUnMUAeoAHHw,1,0,0,0,0,0,1,0,1,0.14285714285714285,1,0.0,0,0,0,0,0,0,0,1,0,0,1,1
9017,120399,tQgPfoIxEUrRTpkUJ12lc7yYMouZEU13,SpATywNh6bZuzm8s1ceuBUnMUAeoAHHw,8,11,3,0,3,0,8,0,25,3.5714285714285716,2,0.0,0,3,0,3,11,0,0,8,0,6,19,1
9018,120400,STgJR8QT5S3NDhZTGanzgxzj1oLmNnCR,SpATywNh6bZuzm8s1ceuBUnMUAeoAHHw,19,10,8,0,7,3,6,0,34,4.857142857142857,1,0.0,0,8,0,7,10,3,0,6,0,15,19,1
9019,120402,Y2MWDCkue2rmZywdTMYpTi8OGrxwTILf,A3fsA9Zfv1X2fVEQhTw51lKENdNrEqT3,1,0,0,0,0,0,1,0,1,0.14285714285714285,1,0.0,0,0,0,0,0,0,0,1,0,0,1,1
9020,120404,NYt3HW4iIDKFfkoDHUmE2GfhEi6C8Rqu,A3fsA9Zfv1X2fVEQhTw51lKENdNrEqT3,8,9,3,0,2,0,6,0,20,2.857142857142857,2,0.0,1,3,0,2,8,0,0,6,0,6,14,1
9021,120406,7Tzl2OTGekrrZ1AXSNaODNbj4vnVdNB2,G8EPVSXsOYB5YQWZGiz1aVq5Pgr2GrQu,22,32,3,20,4,25,19,2,105,15.0,3,0.0,13,3,11,4,19,25,9,19,2,31,74,0
9022,120412,JPQfQe2O1MgBbogZcbI6qUWraQxSj98z,A3fsA9Zfv1X2fVEQhTw51lKENdNrEqT3,1,0,0,0,0,0,1,0,1,0.14285714285714285,1,0.0,0,0,0,0,0,0,0,1,0,0,1,1
9023,120415,lk6sSo2mEoREiTaQjIlY6dKahZkFRKmP,bWdj2GDclj5ofokWjzoa5jAwMkxCykd6,19,22,10,66,6,0,10,0,114,16.285714285714285,3,0.0,6,10,60,6,16,0,6,10,0,82,32,1
9024,120416,vQlqRATWFUYVohKNm8Qpw3XkVdJ2DmuJ,SpATywNh6bZuzm8s1ceuBUnMUAeoAHHw,14,18,0,17,0,0,1,0,36,5.142857142857143,1,0.0,7,0,14,0,11,0,3,1,0,21,15,1
9025,120417,DHUv7XpIZcPp2QYGNmTXjhgg7Zq4BpJ7,G8EPVSXsOYB5YQWZGiz1aVq5Pgr2GrQu,4,2,1,0,1,0,1,0,5,0.7142857142857143,1,0.0,0,1,0,1,2,0,0,1,0,2,3,1
9026,120419,ozv3HO6eArxO9HBSOsAR70hZyYDwrV65,A3fsA9Zfv1X2fVEQhTw51lKENdNrEqT3,6,2,1,0,1,0,5,0,9,1.2857142857142858,1,0.0,0,1,0,1,2,0,0,5,0,2,7,1
9027,120421,ouTwCUFDa5PRzaHQSaChM41Y1q02nIPV,SpATywNh6bZuzm8s1ceuBUnMUAeoAHHw,17,16,1,4,1,2,9,1,34,4.857142857142857,3,0.0,2,1,3,1,14,2,1,9,1,7,27,1
9028,120425,uEDnklEhnnZbnvzJYYw9brmjh3D3gkF9,SpATywNh6bZuzm8s1ceuBUnMUAeoAHHw,1,0,0,0,0,0,1,0,1,0.14285714285714285,1,0.0,0,0,0,0,0,0,0,1,0,0,1,1
9029,120435,OifsLGRBGBgFFNsSrNDnK5W8Vbn9qLGX,SpATywNh6bZuzm8s1ceuBUnMUAeoAHHw,11,28,1,0,0,0,0,0,29,4.142857142857143,6,0.0,0,1,0,0,28,0,0,0,0,1,28,1
9030,120437,do3bUhF7O0txAhPkHUppSnV3jZUZ9sqF,SpATywNh6bZuzm8s1ceuBUnMUAeoAHHw,5,2,1,0,1,0,2,0,6,0.8571428571428571,1,0.0,0,1,0,1,2,0,0,2,0,2,4,1
9031,120457,1La5rp9ZSz9cfpqCRJiC01Rwvuq5VVrf,SpATywNh6bZuzm8s1ceuBUnMUAeoAHHw,18,18,8,24,4,0,8,0,62,8.857142857142858,5,0.0,8,8,24,4,10,0,0,8,0,44,18,0
9032,120460,5MOHfgPntZIsRWkQebauzpUgUSaHvhFJ,bWdj2GDclj5ofokWjzoa5jAwMkxCykd6,6,9,5,0,1,0,6,0,21,3.0,4,0.0,0,5,0,1,9,0,0,6,0,6,15,1
9033,120465,oldypK1fqRkEbCk0bKZUJxOdwxxRRKXf,A3fsA9Zfv1X2fVEQhTw51lKENdNrEqT3,9,6,1,0,1,0,4,0,12,1.7142857142857142,1,0.0,0,1,0,1,6,0,0,4,0,2,10,1
9034,120471,I6qoCcohBrCkqxmkans73ezft5aIvcN6,SpATywNh6bZuzm8s1ceuBUnMUAeoAHHw,6,9,3,0,1,0,5,0,18,2.5714285714285716,3,0.0,2,3,0,1,7,0,0,5,0,6,12,1
9035,120480,GJdrQdNnhszyte4F0GpLkVjDN5SstsoH,SpATywNh6bZuzm8s1ceuBUnMUAeoAHHw,26,63,10,35,8,2,16,2,136,19.428571428571427,8,0.0,6,10,33,8,57,2,2,16,2,57,79,0
9036,120489,MgS6WK9esRya9QyP2ZOjbNdLSIL7NuM9,bWdj2GDclj5ofokWjzoa5jAwMkxCykd6,19,25,15,22,5,2,10,0,79,11.285714285714286,3,0.0,5,15,22,5,20,2,0,10,0,47,32,0
9037,120505,QZQvnzqgk3ZJQavig3cFuZehXC8CHrPm,bWdj2GDclj5ofokWjzoa5jAwMkxCykd6,16,43,11,64,17,0,9,0,144,20.571428571428573,3,0.0,28,11,60,17,15,0,4,9,0,116,28,1
9038,120524,MgS6WK9esRya9QyP2ZOjbNdLSIL7NuM9,RXDvfPUBYFlVdlueBFbLW0mhhAyGEqpt,7,7,4,0,1,0,2,0,14,2.0,2,0.0,0,4,0,1,7,0,0,2,0,5,9,1
9039,120531,Fkd43qYCuPn5hi79UziIpsXZru3xZf0R,SpATywNh6bZuzm8s1ceuBUnMUAeoAHHw,4,2,1,0,1,0,1,0,5,0.7142857142857143,1,0.0,0,1,0,1,2,0,0,1,0,2,3,1
9040,120533,vEaXPhyTYPOxUDFFnNSxdj1qZ39pJLBH,A3fsA9Zfv1X2fVEQhTw51lKENdNrEqT3,6,3,2,0,2,0,5,0,12,1.7142857142857142,1,0.0,0,2,0,2,3,0,0,5,0,4,8,1
9041,120538,kJkXo4nSNqbMETrXDpi6P9tfSt1mYjrM,SpATywNh6bZuzm8s1ceuBUnMUAeoAHHw,24,54,23,17,10,0,24,0,128,18.285714285714285,8,0.0,12,23,15,10,42,0,2,24,0,60,68,1
9042,120540,U0zx3N1uSd1t4oNG6aeia4oGy5qrTYII,SpATywNh6bZuzm8s1ceuBUnMUAeoAHHw,15,14,8,9,4,0,4,0,39,5.571428571428571,2,0.0,4,8,9,4,10,0,0,4,0,25,14,1
9043,120547,6T4qq3cdISFF5pyvVKMrcmEINY6BysCY,A3fsA9Zfv1X2fVEQhTw51lKENdNrEqT3,71,38,17,218,2,52,20,2,349,49.857142857142854,8,0.0,10,17,189,2,28,52,29,20,2,218,131,0
9044,120550,SiUZQJJjUWzItu4TetvbGbgpJYIYKjWr,SpATywNh6bZuzm8s1ceuBUnMUAeoAHHw,4,2,1,0,1,0,1,0,5,0.7142857142857143,1,0.0,0,1,0,1,2,0,0,1,0,2,3,1
9045,120554,33YJhO56Hz6X3YkBaXAE8jLXj3hGQz0E,RXDvfPUBYFlVdlueBFbLW0mhhAyGEqpt,4,2,1,0,1,0,1,0,5,0.7142857142857143,1,0.0,0,1,0,1,2,0,0,1,0,2,3,1
9046,120559,4YCZfbR5vSUmQm9JKU53CaLT4o7zzhD5,SpATywNh6bZuzm8s1ceuBUnMUAeoAHHw,1,0,0,0,0,0,2,0,2,0.2857142857142857,1,0.0,0,0,0,0,0,0,0,2,0,0,2,1
9047,120567,VL7NPBJuyzF1uV3nhlsl7JEimjvq8BIB,SpATywNh6bZuzm8s1ceuBUnMUAeoAHHw,30,84,52,12,26,6,22,0,202,28.857142857142858,8,0.0,9,52,12,26,75,6,0,22,0,99,103,0
9048,120570,EIpkB0c46fQRf924Hrf1SRiPLyg6N4rm,RXDvfPUBYFlVdlueBFbLW0mhhAyGEqpt,11,7,2,0,2,2,4,0,17,2.4285714285714284,2,0.0,0,2,0,2,7,2,0,4,0,4,13,1
9049,120571,ZcwgBhx2C5CsYaUWf4YQ2u1SWzTYaxss,A3fsA9Zfv1X2fVEQhTw51lKENdNrEqT3,16,15,7,0,5,1,15,1,44,6.285714285714286,3,0.0,6,7,0,5,9,1,0,15,1,18,26,0
9050,120576,WIgM6nvV9YFBo82xFhtQp6923xmcbs69,SpATywNh6bZuzm8s1ceuBUnMUAeoAHHw,22,35,20,15,0,0,11,0,81,11.571428571428571,6,0.0,10,20,15,0,25,0,0,11,0,45,36,0
9051,120580,tepLda5wSKMdrl1YSxQ7o9ErmWSmjLIs,SpATywNh6bZuzm8s1ceuBUnMUAeoAHHw,28,67,42,19,7,29,48,0,212,30.285714285714285,8,0.0,9,42,18,7,58,29,1,48,0,76,136,0
9052,120581,lggvGpvA9S46sPyt7OTjASGRNtpXIFQL,SpATywNh6bZuzm8s1ceuBUnMUAeoAHHw,1,0,0,0,0,0,1,0,1,0.14285714285714285,1,0.0,0,0,0,0,0,0,0,1,0,0,1,1
9053,120586,cOTtp4pVPpt9GEFdMZaLCIG1IBXouqo8,A3fsA9Zfv1X2fVEQhTw51lKENdNrEqT3,1,0,0,0,0,0,1,0,1,0.14285714285714285,1,0.0,0,0,0,0,0,0,0,1,0,0,1,1
9054,120592,eS2KrqTdusBuI6pcIMw5VPgc4bcyJ1eG,bWdj2GDclj5ofokWjzoa5jAwMkxCykd6,2,0,0,0,0,0,2,0,2,0.2857142857142857,1,0.0,0,0,0,0,0,0,0,2,0,0,2,1
9055,120599,yhSGXw7EnYX7J3WWxRb9piBAfJaOtRLJ,SpATywNh6bZuzm8s1ceuBUnMUAeoAHHw,1,0,0,0,0,0,1,0,1,0.14285714285714285,1,0.0,0,0,0,0,0,0,0,1,0,0,1,1
9056,120621,7rzvmKtANOU8M4posmrNW445K28DcImr,SpATywNh6bZuzm8s1ceuBUnMUAeoAHHw,2,0,0,0,0,0,2,0,2,0.2857142857142857,1,0.0,0,0,0,0,0,0,0,2,0,0,2,0
9057,120628,T84tM0SY1NeTwy8ZOUv1K7SYM12l3y0u,SpATywNh6bZuzm8s1ceuBUnMUAeoAHHw,17,24,9,0,5,14,11,2,65,9.285714285714286,5,0.0,9,9,0,5,15,14,0,11,2,23,42,1
9058,120633,IU1lGseLxckCGwI4nmuh7Ca5kBungyEP,SpATywNh6bZuzm8s1ceuBUnMUAeoAHHw,14,35,2,25,2,0,2,0,66,9.428571428571429,1,0.0,17,2,21,2,18,0,4,2,0,42,24,1
9059,120634,EDLvNoRIb3gHoThJ1NoAuBrT3yJGczm3,A3fsA9Zfv1X2fVEQhTw51lKENdNrEqT3,2,0,0,0,0,0,4,0,4,0.5714285714285714,1,0.0,0,0,0,0,0,0,0,4,0,0,4,1
9060,120647,RrUICdqzzS6uEuuuo42x7DWjiBSOVyuw,RXDvfPUBYFlVdlueBFbLW0mhhAyGEqpt,11,7,6,0,2,2,4,0,21,3.0,1,0.0,0,6,0,2,7,2,0,4,0,8,13,1
9061,120650,AqOYZE1KwO9ElxY4ESIL8wZt1KCX4QiQ,SpATywNh6bZuzm8s1ceuBUnMUAeoAHHw,28,47,20,26,10,16,13,1,133,19.0,7,0.0,9,20,23,10,38,16,3,13,1,62,71,0
9062,120654,8eYQfp27L4KqSIcQS2lfdmoY7VEE1qFC,RXDvfPUBYFlVdlueBFbLW0mhhAyGEqpt,6,7,1,0,0,0,6,0,14,2.0,2,0.0,0,1,0,0,7,0,0,6,0,1,13,1
9063,120680,Mv7oSGs75OaCjYLhHCNmqqrqaAjjO5gs,A3fsA9Zfv1X2fVEQhTw51lKENdNrEqT3,1,0,0,0,0,0,1,0,1,0.14285714285714285,1,0.0,0,0,0,0,0,0,0,1,0,0,1,1
9064,120683,1U4BCdHxNjp4LH6S6L2sowJaRSmQKYKF,A3fsA9Zfv1X2fVEQhTw51lKENdNrEqT3,5,8,1,0,1,0,5,0,15,2.142857142857143,2,0.0,0,1,0,1,8,0,0,5,0,2,13,1
9065,120685,dWpBguIfALUazWbTuRqWRbI4Z6RC5ZA1,SpATywNh6bZuzm8s1ceuBUnMUAeoAHHw,12,5,2,0,2,3,16,2,30,4.285714285714286,1,0.0,0,2,0,2,5,3,0,16,2,4,26,1
9066,120692,yPANNiQQMnN6yMtp5OhnGyYLdZrKDZ9V,RXDvfPUBYFlVdlueBFbLW0mhhAyGEqpt,9,4,3,0,2,0,3,0,12,1.7142857142857142,1,0.0,0,3,0,2,4,0,0,3,0,5,7,1
9067,120706,RrLCYgvxi3oib8ZNMGweT91KCXFbFqgQ,A3fsA9Zfv1X2fVEQhTw51lKENdNrEqT3,8,8,3,0,1,0,3,0,15,2.142857142857143,1,0.0,0,3,0,1,8,0,0,3,0,4,11,1
9068,120707,YBlpuOz29CjjHYq0RuGLiSzLtjKLdYy2,RXDvfPUBYFlVdlueBFbLW0mhhAyGEqpt,29,47,6,16,2,0,20,0,91,13.0,7,0.0,6,6,15,2,41,0,1,20,0,29,62,0
9069,120715,ucFGb4sKO6LhsbUaWhFjc3yaUOdGfmQa,RXDvfPUBYFlVdlueBFbLW0mhhAyGEqpt,7,2,2,0,2,0,2,0,8,1.1428571428571428,1,0.0,0,2,0,2,2,0,0,2,0,4,4,1
9070,120724,s4dtgJUQtJkEKTGiW6rNu8EDXRkyQStr,bWdj2GDclj5ofokWjzoa5jAwMkxCykd6,1,0,0,0,0,0,1,0,1,0.14285714285714285,1,0.0,0,0,0,0,0,0,0,1,0,0,1,1
9071,120736,niznzPsNcmf0qkvKVIABVzsBAFOWmMfr,SpATywNh6bZuzm8s1ceuBUnMUAeoAHHw,20,21,1,8,1,1,7,1,40,5.714285714285714,1,0.0,2,1,8,1,19,1,0,7,1,12,28,1
9072,120743,es5GTyNQHE6XqsHqRasxkSTkn6q7y8k2,SpATywNh6bZuzm8s1ceuBUnMUAeoAHHw,23,40,19,23,5,7,10,1,105,15.0,6,0.0,11,19,20,5,29,7,3,10,1,55,50,0
9073,120744,dvGlk7sqlRtsNklrx9jTekm5CnQWuhDQ,SpATywNh6bZuzm8s1ceuBUnMUAeoAHHw,21,23,13,17,6,0,8,0,67,9.571428571428571,4,0.0,6,13,17,6,17,0,0,8,0,42,25,1
9074,120755,PQyLGsdBWhEy27jacipkmntLAvcsGeQa,SpATywNh6bZuzm8s1ceuBUnMUAeoAHHw,29,28,15,30,8,4,8,0,93,13.285714285714286,3,0.0,11,15,25,8,17,4,5,8,0,59,34,0
9075,120768,lu6LWsHgfburMRdWsFabIR2bIQ3MFD6f,RXDvfPUBYFlVdlueBFbLW0mhhAyGEqpt,52,43,20,80,15,4,14,0,176,25.142857142857142,7,0.0,12,20,72,15,31,4,8,14,0,119,57,0
9076,120769,9ejhHF65VDeA89TY7yPYCEx8qdV4K69n,A3fsA9Zfv1X2fVEQhTw51lKENdNrEqT3,29,22,14,28,10,0,9,0,83,11.857142857142858,2,0.0,1,14,24,10,21,0,4,9,0,49,34,1
9077,120773,uiXIZg9P7E1egIRj5Sno619DS7IwlQY9,SpATywNh6bZuzm8s1ceuBUnMUAeoAHHw,1,0,0,0,0,0,1,0,1,0.14285714285714285,1,0.0,0,0,0,0,0,0,0,1,0,0,1,1
9078,120776,9ejhHF65VDeA89TY7yPYCEx8qdV4K69n,bWdj2GDclj5ofokWjzoa5jAwMkxCykd6,1,0,0,0,0,0,2,0,2,0.2857142857142857,1,0.0,0,0,0,0,0,0,0,2,0,0,2,1
9079,120785,Axaz2TU9iWJqggZ8S9ZVW7y3xhVfFBfg,SpATywNh6bZuzm8s1ceuBUnMUAeoAHHw,9,4,3,0,1,7,6,1,22,3.142857142857143,1,0.0,0,3,0,1,4,7,0,6,1,4,18,1
9080,120787,JBH4PfoUtr8SFyt6u3u3ciODwm9LbhKT,SpATywNh6bZuzm8s1ceuBUnMUAeoAHHw,8,2,1,0,1,0,5,1,10,1.4285714285714286,1,0.0,0,1,0,1,2,0,0,5,1,2,8,1
9081,120792,vSEsL1qLMsR8cNJOX6mMDcN6nVaHqWNR,bWdj2GDclj5ofokWjzoa5jAwMkxCykd6,1,0,0,0,0,0,1,0,1,0.14285714285714285,1,0.0,0,0,0,0,0,0,0,1,0,0,1,1
9082,120800,7bnGjPq4sg9VhmEEoEqqXHNgeEpEuUDV,bWdj2GDclj5ofokWjzoa5jAwMkxCykd6,11,12,6,0,2,23,8,4,55,7.857142857142857,2,0.0,0,6,0,2,12,23,0,8,4,8,47,0
9083,120807,KHl8vTLwoQOTsjJg2pVXTnG0Is0a8K1K,SpATywNh6bZuzm8s1ceuBUnMUAeoAHHw,6,4,1,0,1,0,3,1,10,1.4285714285714286,2,0.0,0,1,0,1,4,0,0,3,1,2,8,1
9084,120809,bWtnIrdbQPafPqPLZtocbxJYk8IfZ76X,SpATywNh6bZuzm8s1ceuBUnMUAeoAHHw,7,3,2,0,2,0,2,0,9,1.2857142857142858,1,0.0,0,2,0,2,3,0,0,2,0,4,5,1
9085,120825,tQAgy689j7VgAO7nbWHE1fj0JJjMUDvF,SpATywNh6bZuzm8s1ceuBUnMUAeoAHHw,4,2,0,0,0,0,2,0,4,0.5714285714285714,1,0.0,0,0,0,0,2,0,0,2,0,0,4,1
9086,120827,tCQ9JALurTpI0v0jgUfmOoOzw21YvN4S,RXDvfPUBYFlVdlueBFbLW0mhhAyGEqpt,10,4,3,0,1,2,6,1,17,2.4285714285714284,1,0.0,0,3,0,1,4,2,0,6,1,4,13,1
9087,120831,JLn36xalC1eIUd4jm6gux9oEgx3gpDxA,SpATywNh6bZuzm8s1ceuBUnMUAeoAHHw,15,24,0,17,0,0,5,0,46,6.571428571428571,2,0.0,6,0,15,0,18,0,2,5,0,21,25,1
9088,120833,72z519PMt8GGBXLvF1FG0oMJuciCSWYJ,SpATywNh6bZuzm8s1ceuBUnMUAeoAHHw,5,4,1,0,0,0,4,0,9,1.2857142857142858,3,0.0,0,1,0,0,4,0,0,4,0,1,8,1
9089,120844,JjOxJWvSLO4lglPA5ATD8doF5KAfdZlo,G8EPVSXsOYB5YQWZGiz1aVq5Pgr2GrQu,1,0,0,0,0,0,1,0,1,0.14285714285714285,1,0.0,0,0,0,0,0,0,0,1,0,0,1,1
9090,120846,UkERsue63b46ZbS092pGmdIWYcMFC2bg,SpATywNh6bZuzm8s1ceuBUnMUAeoAHHw,7,7,1,0,0,0,4,0,12,1.7142857142857142,2,0.0,0,1,0,0,7,0,0,4,0,1,11,1
9091,120851,dJq8sIYKCGcPSHpIrI20rFWCk7jAqAdY,A3fsA9Zfv1X2fVEQhTw51lKENdNrEqT3,8,4,3,0,3,0,1,0,11,1.5714285714285714,1,0.0,0,3,0,3,4,0,0,1,0,6,5,1
9092,120852,EPmLjBxeWpwhjwoRgtmLV8RkhFOu2zzj,G8EPVSXsOYB5YQWZGiz1aVq5Pgr2GrQu,1,0,0,0,0,0,1,0,1,0.14285714285714285,1,0.0,0,0,0,0,0,0,0,1,0,0,1,1
9093,120874,c7JueNv3hDicP8Z6SVI5VQqnBM3V6CD4,SpATywNh6bZuzm8s1ceuBUnMUAeoAHHw,8,7,3,0,2,2,15,3,32,4.571428571428571,1,0.0,0,3,0,2,7,2,0,15,3,5,27,1
9094,120878,edVuZXQuYE4LHUfAzzB1uGhpYsPr0vJx,SpATywNh6bZuzm8s1ceuBUnMUAeoAHHw,31,34,14,37,8,7,14,3,117,16.714285714285715,4,0.0,8,14,31,8,26,7,6,14,3,61,56,0
9095,120881,Ow20UOjVruC0CURQijQixRuf9scGhyUK,G8EPVSXsOYB5YQWZGiz1aVq5Pgr2GrQu,5,2,2,0,2,0,3,0,9,1.2857142857142858,2,0.0,0,2,0,2,2,0,0,3,0,4,5,1
9096,120893,xb9WJcv3uIYBfZD9WqegvIpYdxaUF3h5,bWdj2GDclj5ofokWjzoa5jAwMkxCykd6,8,8,4,0,3,0,3,0,18,2.5714285714285716,2,0.0,0,4,0,3,8,0,0,3,0,7,11,1
9097,120896,u5ObOMoHUcvVsOQTGkiv0BRKKcn8v2w8,A3fsA9Zfv1X2fVEQhTw51lKENdNrEqT3,19,29,18,0,12,0,8,0,67,9.571428571428571,2,0.0,2,18,0,12,27,0,0,8,0,32,35,0
9098,120904,kFp6IoufrvIevAVHehiSDqUBNzpbkI6L,bWdj2GDclj5ofokWjzoa5jAwMkxCykd6,23,49,26,34,11,25,29,2,176,25.142857142857142,8,0.0,6,26,32,11,43,25,2,29,2,75,101,0
9099,120919,DahdU3m64q9GHbzMvs6TdHVFTDo4asbt,SpATywNh6bZuzm8s1ceuBUnMUAeoAHHw,3,0,0,0,0,0,5,0,5,0.7142857142857143,3,0.0,0,0,0,0,0,0,0,5,0,0,5,1
9100,120924,ocmyq6MXRULfgpYdGM8QGfWnP2Queprt,SpATywNh6bZuzm8s1ceuBUnMUAeoAHHw,28,48,28,15,15,0,19,4,129,18.428571428571427,4,0.0,5,28,15,15,43,0,0,19,4,63,66,1
9101,120927,4bcOXBC1lhgwF9Pg3IMx9vJFVwNtFyik,SpATywNh6bZuzm8s1ceuBUnMUAeoAHHw,17,51,14,2,4,1,25,0,97,13.857142857142858,6,0.0,0,14,2,4,51,1,0,25,0,20,77,1
9102,120936,i0ksX07HnsV5rQlWqOr1uKEuc7yNU24c,A3fsA9Zfv1X2fVEQhTw51lKENdNrEqT3,53,41,27,68,12,29,29,3,209,29.857142857142858,7,0.0,3,27,56,12,38,29,12,29,3,98,111,0
9103,120940,KkBPwixR7onoXlZ2HnK8cYokgUE3P396,bWdj2GDclj5ofokWjzoa5jAwMkxCykd6,6,4,0,0,0,0,7,0,11,1.5714285714285714,3,0.0,0,0,0,0,4,0,0,7,0,0,11,1
9104,120948,TevGcL3mCy823FJCU3MpLHqDSnMlx8KC,SpATywNh6bZuzm8s1ceuBUnMUAeoAHHw,28,21,14,29,8,0,4,0,76,10.857142857142858,3,0.0,4,14,22,8,17,0,7,4,0,48,28,0
9105,120953,HGkuwdB1J817cl9wl529SZa2OTu14HFB,SpATywNh6bZuzm8s1ceuBUnMUAeoAHHw,31,31,15,35,7,8,21,1,118,16.857142857142858,4,0.0,10,15,30,7,21,8,5,21,1,62,56,0
9106,120964,JCDOEMgsanA2Wd8RJtg9ctpT52Gae7ak,SpATywNh6bZuzm8s1ceuBUnMUAeoAHHw,1,0,0,0,0,0,1,0,1,0.14285714285714285,1,0.0,0,0,0,0,0,0,0,1,0,0,1,1
9107,120967,nToY9YbKok17BpaPlTxZF9mLZdFu0iiS,G8EPVSXsOYB5YQWZGiz1aVq5Pgr2GrQu,17,19,12,0,9,0,6,0,46,6.571428571428571,3,0.0,3,12,0,9,16,0,0,6,0,24,22,1
9108,120969,hNYqJEuS1AXT481SIEkT37fZObOmjXuX,G8EPVSXsOYB5YQWZGiz1aVq5Pgr2GrQu,7,9,5,0,1,0,5,0,20,2.857142857142857,2,0.0,0,5,0,1,9,0,0,5,0,6,14,1
9109,120983,Tg9kFmEr6KGEyzeoopWvQ3WCSPhx01lk,SpATywNh6bZuzm8s1ceuBUnMUAeoAHHw,30,37,23,25,9,6,31,5,136,19.428571428571427,5,0.0,5,23,24,9,32,6,1,31,5,61,75,1
9110,120986,OcU9jyzQQ3iLPmO8KqVEvCwQSxQdBoZu,SpATywNh6bZuzm8s1ceuBUnMUAeoAHHw,11,15,7,0,5,1,10,1,39,5.571428571428571,2,0.0,4,7,0,5,11,1,0,10,1,16,23,1
9111,120998,y7Z8jSjEija2cXP8zDhgGRVfac5fnMAR,SpATywNh6bZuzm8s1ceuBUnMUAeoAHHw,9,16,0,2,0,0,3,0,21,3.0,4,0.0,1,0,2,0,15,0,0,3,0,3,18,1
9112,121001,k2w7Fl2HRg9SZoDIHFnK8RXCKuBBE2y7,A3fsA9Zfv1X2fVEQhTw51lKENdNrEqT3,92,53,31,142,19,27,15,0,287,41.0,6,0.0,3,31,126,19,50,27,16,15,0,179,108,1
9113,121014,5sovUdBY4AsVUtXY7BWDVXxvHAPsWkZb,A3fsA9Zfv1X2fVEQhTw51lKENdNrEqT3,9,5,4,0,3,0,1,0,13,1.8571428571428572,1,0.0,0,4,0,3,5,0,0,1,0,7,6,1
9114,121017,iW5zRjJuIjvxlxhDULlodfhsU8gFYbbs,SpATywNh6bZuzm8s1ceuBUnMUAeoAHHw,8,7,6,0,0,0,2,0,15,2.142857142857143,1,0.0,0,6,0,0,7,0,0,2,0,6,9,1
9115,121039,QaKdVtbgjSMpkDFYeFcsaL5O2NEtGRQz,SpATywNh6bZuzm8s1ceuBUnMUAeoAHHw,1,0,0,0,0,0,1,0,1,0.14285714285714285,1,0.0,0,0,0,0,0,0,0,1,0,0,1,1
9116,121053,npZiJYBXIvuULdTyVSfZOjhsnEdX6i82,SpATywNh6bZuzm8s1ceuBUnMUAeoAHHw,30,37,18,37,8,0,7,0,107,15.285714285714286,4,0.0,15,18,31,8,22,0,6,7,0,72,35,0
9117,121085,hWWjbjEJOX0Ph07p1EJp8Ya48hU8wP5v,SpATywNh6bZuzm8s1ceuBUnMUAeoAHHw,30,70,33,39,19,0,16,0,177,25.285714285714285,4,0.0,11,33,35,19,59,0,4,16,0,98,79,0
9118,121096,ZtA9pLb0sfgqk6iLVTJtOHVhh3oHeQLC,SpATywNh6bZuzm8s1ceuBUnMUAeoAHHw,5,2,0,0,0,0,3,0,5,0.7142857142857143,1,0.0,0,0,0,0,2,0,0,3,0,0,5,1
9119,121099,cHpOktJabOMVpsE04dze5ePRZnN7bWdJ,A3fsA9Zfv1X2fVEQhTw51lKENdNrEqT3,14,8,6,0,5,0,3,0,22,3.142857142857143,2,0.0,0,6,0,5,8,0,0,3,0,11,11,1
9120,121101,34fQh4AyuAWML6hByTmQJCsftdAFH2Hu,SpATywNh6bZuzm8s1ceuBUnMUAeoAHHw,20,39,16,18,4,0,11,1,89,12.714285714285714,4,0.0,16,16,15,4,23,0,3,11,1,51,38,1
9121,121118,vTTrcE2RlYlajsEul9ylLY6DUQNcdNgN,SpATywNh6bZuzm8s1ceuBUnMUAeoAHHw,7,6,4,0,2,0,2,0,14,2.0,2,0.0,0,4,0,2,6,0,0,2,0,6,8,1
9122,121122,GlVmjWGZ8XsOuLGdZvtzRw0xzELGNzxx,bWdj2GDclj5ofokWjzoa5jAwMkxCykd6,4,12,6,0,0,0,2,0,20,2.857142857142857,6,0.0,0,6,0,0,12,0,0,2,0,6,14,1
9123,121137,5uUrNOrq1vz8XtHDv1LWcBc27EEqbO5u,SpATywNh6bZuzm8s1ceuBUnMUAeoAHHw,19,43,4,22,1,0,7,0,77,11.0,4,0.0,3,4,20,1,40,0,2,7,0,28,49,1
9124,121140,QAb8PmUj3McyQuaW6daHNk0NhlxSWKuO,SpATywNh6bZuzm8s1ceuBUnMUAeoAHHw,1,0,0,0,0,0,2,0,2,0.2857142857142857,2,0.0,0,0,0,0,0,0,0,2,0,0,2,1
9125,121141,YhSlQp6TZH2sVWIgjyn2YxpekmOBzjQt,SpATywNh6bZuzm8s1ceuBUnMUAeoAHHw,27,30,16,25,8,0,11,0,90,12.857142857142858,4,0.0,11,16,23,8,19,0,2,11,0,58,32,0
9126,121142,xlx6h4vTU14b0zR9O9NKqKPZoDtNmECc,A3fsA9Zfv1X2fVEQhTw51lKENdNrEqT3,10,8,4,0,2,0,3,0,17,2.4285714285714284,1,0.0,2,4,0,2,6,0,0,3,0,8,9,1
9127,121143,rik0F1mWVOeGz53BJ3pfmg90EeuTpONo,bWdj2GDclj5ofokWjzoa5jAwMkxCykd6,5,5,1,0,1,0,2,0,9,1.2857142857142858,1,0.0,0,1,0,1,5,0,0,2,0,2,7,1
9128,121145,atoEVjauO8UqqxbDs90qm3bNJMwCLIt0,SpATywNh6bZuzm8s1ceuBUnMUAeoAHHw,30,26,12,27,8,6,6,0,85,12.142857142857142,2,0.0,10,12,22,8,16,6,5,6,0,52,33,0
9129,121156,ZPtKMZp2cxlBd5CcEcoCaraY1yoC22cg,SpATywNh6bZuzm8s1ceuBUnMUAeoAHHw,30,21,14,44,8,1,7,0,95,13.571428571428571,2,0.0,4,14,38,8,17,1,6,7,0,64,31,0
9130,121161,Yl3fWDphM6Ifhmu0NrJgclA0dIl02Kms,A3fsA9Zfv1X2fVEQhTw51lKENdNrEqT3,15,9,6,0,4,0,5,0,24,3.4285714285714284,2,0.0,1,6,0,4,8,0,0,5,0,11,13,1
9131,121165,Sp3nYt5ii7nPRoxqEiVcKwwIa973Pnnr,A3fsA9Zfv1X2fVEQhTw51lKENdNrEqT3,29,11,6,64,2,0,4,0,87,12.428571428571429,2,0.0,4,6,54,2,7,0,10,4,0,66,21,1
9132,121169,WJs2oS3DHmzLGumW31DTiDLH77aXdb4Z,G8EPVSXsOYB5YQWZGiz1aVq5Pgr2GrQu,1,0,0,0,0,0,1,0,1,0.14285714285714285,1,0.0,0,0,0,0,0,0,0,1,0,0,1,1
9133,121171,w81M8LsxqroaoVvhuOiOu12ogu2TTrVp,SpATywNh6bZuzm8s1ceuBUnMUAeoAHHw,8,8,2,0,3,0,4,0,17,2.4285714285714284,3,0.0,0,2,0,3,8,0,0,4,0,5,12,1
9134,121172,J7iejq5NtsfdHjPTK3MrPhGPRoJN9WrB,bWdj2GDclj5ofokWjzoa5jAwMkxCykd6,1,0,0,0,0,0,1,0,1,0.14285714285714285,1,0.0,0,0,0,0,0,0,0,1,0,0,1,1
9135,121195,rrD2k9raPTugWiiZJjKTcEpxfKzXPOoh,A3fsA9Zfv1X2fVEQhTw51lKENdNrEqT3,5,2,1,0,1,0,2,0,6,0.8571428571428571,1,0.0,0,1,0,1,2,0,0,2,0,2,4,1
9136,121200,xyoj4G3pVqlUCzQtS2iNDV55nyPLJkyp,A3fsA9Zfv1X2fVEQhTw51lKENdNrEqT3,8,5,4,0,4,0,1,0,14,2.0,1,0.0,0,4,0,4,5,0,0,1,0,8,6,1
9137,121201,osRqgZRzeeCEid1eYNHbUWEZePoVbqKO,SpATywNh6bZuzm8s1ceuBUnMUAeoAHHw,6,3,1,0,1,0,2,0,7,1.0,1,0.0,0,1,0,1,3,0,0,2,0,2,5,1
9138,121205,irUhnQtLaQWO9Ilnw5LLg2nfVwuwwh1f,SpATywNh6bZuzm8s1ceuBUnMUAeoAHHw,5,5,0,0,0,0,6,1,12,1.7142857142857142,3,0.0,0,0,0,0,5,0,0,6,1,0,12,1
9139,121225,6lL0tobxamv6kkGYMIOtqqnjmWQC4apa,A3fsA9Zfv1X2fVEQhTw51lKENdNrEqT3,71,30,23,138,16,3,9,1,220,31.428571428571427,3,0.0,2,23,123,16,28,3,15,9,1,164,56,1
9140,121226,RdjpcuNJHcq9iKd6LdCp1m7jbwau68ud,SpATywNh6bZuzm8s1ceuBUnMUAeoAHHw,2,0,0,0,0,1,2,0,3,0.42857142857142855,1,0.0,0,0,0,0,0,1,0,2,0,0,3,1
9141,121232,lojhMqQRO46DZsZEpJYUmk4ki07ZAOFG,SpATywNh6bZuzm8s1ceuBUnMUAeoAHHw,1,0,0,0,0,0,1,0,1,0.14285714285714285,1,0.0,0,0,0,0,0,0,0,1,0,0,1,1
9142,121261,YPxQmDfYnmHgiT7CBa1xK3KUyMZAnQfd,A3fsA9Zfv1X2fVEQhTw51lKENdNrEqT3,8,4,3,0,2,0,2,0,11,1.5714285714285714,1,0.0,0,3,0,2,4,0,0,2,0,5,6,1
9143,121269,OifsLGRBGBgFFNsSrNDnK5W8Vbn9qLGX,A3fsA9Zfv1X2fVEQhTw51lKENdNrEqT3,2,2,0,0,0,0,0,0,2,0.2857142857142857,1,0.0,0,0,0,0,2,0,0,0,0,0,2,1
9144,121279,iSSrSd8vVxBC2JC6ajviRFDfdtqLCuym,A3fsA9Zfv1X2fVEQhTw51lKENdNrEqT3,1,0,0,0,0,0,1,0,1,0.14285714285714285,1,0.0,0,0,0,0,0,0,0,1,0,0,1,1
9145,121286,go4j7bRhXINgA1WuC2lRA0Hee8dTMRV5,SpATywNh6bZuzm8s1ceuBUnMUAeoAHHw,8,6,4,0,2,0,6,0,18,2.5714285714285716,2,0.0,0,4,0,2,6,0,0,6,0,6,12,1
9146,121292,b4JhdDZuiMoCYMffFqg7ALO9K4ZBVn12,A3fsA9Zfv1X2fVEQhTw51lKENdNrEqT3,32,29,23,0,15,1,15,0,83,11.857142857142858,3,0.0,0,23,0,15,29,1,0,15,0,38,45,1
9147,121298,ONVx5VkCTs6D7RWJGi0oaLbXvf1yyHqy,bWdj2GDclj5ofokWjzoa5jAwMkxCykd6,1,0,0,0,0,0,1,0,1,0.14285714285714285,1,0.0,0,0,0,0,0,0,0,1,0,0,1,1
9148,121308,vFTyJ5TiVtOMNTDle7WFtHDAgvur1Shs,SpATywNh6bZuzm8s1ceuBUnMUAeoAHHw,7,4,3,0,3,0,2,0,12,1.7142857142857142,1,0.0,0,3,0,3,4,0,0,2,0,6,6,1
9149,121315,20miIbW6puYcFBNRUpHWBfGdgoL7IsKl,A3fsA9Zfv1X2fVEQhTw51lKENdNrEqT3,2,0,0,0,0,0,3,0,3,0.42857142857142855,1,0.0,0,0,0,0,0,0,0,3,0,0,3,1
9150,121316,AOiSjL4Nis9M3s1AhiMS89hfMIvo6CLU,SpATywNh6bZuzm8s1ceuBUnMUAeoAHHw,1,0,0,0,0,0,1,0,1,0.14285714285714285,1,0.0,0,0,0,0,0,0,0,1,0,0,1,1
9151,121325,togvLGeHHJalLzAy7gb7bMJngLXYGAjs,bWdj2GDclj5ofokWjzoa5jAwMkxCykd6,6,2,1,0,1,0,3,0,7,1.0,1,0.0,0,1,0,1,2,0,0,3,0,2,5,1
9152,121327,togvLGeHHJalLzAy7gb7bMJngLXYGAjs,A3fsA9Zfv1X2fVEQhTw51lKENdNrEqT3,2,0,0,0,0,0,2,0,2,0.2857142857142857,1,0.0,0,0,0,0,0,0,0,2,0,0,2,1
9153,121329,zJaHqs5kxeHEJuK4mQU1DIdrSDzLOTmW,bWdj2GDclj5ofokWjzoa5jAwMkxCykd6,1,0,0,0,0,0,1,0,1,0.14285714285714285,1,0.0,0,0,0,0,0,0,0,1,0,0,1,1
9154,121334,X9tesPfVRQu9R7pVopuvpFNecLnZt8Km,SpATywNh6bZuzm8s1ceuBUnMUAeoAHHw,26,36,13,13,5,3,21,2,93,13.285714285714286,5,0.0,8,13,11,5,28,3,2,21,2,37,56,1
9155,121335,rcQSbcF05AQYvzQJmDOGu4MfsQVuu05l,SpATywNh6bZuzm8s1ceuBUnMUAeoAHHw,29,27,16,33,7,2,7,1,93,13.285714285714286,3,0.0,8,16,29,7,19,2,4,7,1,60,33,0
9156,121350,OaR2omePx63fXdBiAV1sA954f6IcbIvq,A3fsA9Zfv1X2fVEQhTw51lKENdNrEqT3,22,24,17,18,10,0,15,0,84,12.0,5,0.0,2,17,18,10,22,0,0,15,0,47,37,0
9157,121354,EIHhmYlRU23gD32AsZHHvSXzjtFCo0yL,SpATywNh6bZuzm8s1ceuBUnMUAeoAHHw,12,18,2,14,0,2,4,0,40,5.714285714285714,3,0.0,3,2,12,0,15,2,2,4,0,17,23,1
9158,121375,JwzCuKRnJiCboJiRTMovpzJhdCfcNETm,A3fsA9Zfv1X2fVEQhTw51lKENdNrEqT3,12,14,1,0,2,0,1,0,18,2.5714285714285716,1,0.0,0,1,0,2,14,0,0,1,0,3,15,1
9159,121382,Kgm7zLW8p8Jc9BDI12KiHyoMRqlC0TXl,SpATywNh6bZuzm8s1ceuBUnMUAeoAHHw,1,0,0,0,0,0,1,0,1,0.14285714285714285,1,0.0,0,0,0,0,0,0,0,1,0,0,1,1
9160,121383,7af3IyECXIPSWoeM4guaEGHMHNE9EYdr,SpATywNh6bZuzm8s1ceuBUnMUAeoAHHw,1,0,0,0,0,0,1,0,1,0.14285714285714285,1,0.0,0,0,0,0,0,0,0,1,0,0,1,1
9161,121385,3pMXqJaEYEy2mxtFTggtjQ8mcRHGvdLr,SpATywNh6bZuzm8s1ceuBUnMUAeoAHHw,5,4,3,0,0,0,2,0,9,1.2857142857142858,2,0.0,0,3,0,0,4,0,0,2,0,3,6,1
9162,121390,3jWLQZ2XpNpB2H4UFvKRCVfzgbIsEanY,A3fsA9Zfv1X2fVEQhTw51lKENdNrEqT3,1,0,0,0,0,0,1,0,1,0.14285714285714285,1,0.0,0,0,0,0,0,0,0,1,0,0,1,1
9163,121395,Xn0msswMya4DdeH7Dc0xTOd0ODvYwWM7,SpATywNh6bZuzm8s1ceuBUnMUAeoAHHw,5,3,0,0,0,0,3,0,6,0.8571428571428571,2,0.0,0,0,0,0,3,0,0,3,0,0,6,1
9164,121400,BMjIPGqtYoLatxXDEHrhiIMt72Ckp0Wf,SpATywNh6bZuzm8s1ceuBUnMUAeoAHHw,14,41,3,18,0,5,12,2,81,11.571428571428571,3,0.0,6,3,16,0,35,5,2,12,2,25,56,1
9165,121403,Uf8FY0gZoVytp6K7SsDRXVZeOCL2hDEX,bWdj2GDclj5ofokWjzoa5jAwMkxCykd6,13,11,7,0,3,6,13,1,41,5.857142857142857,2,0.0,0,7,0,3,11,6,0,13,1,10,31,1
9166,121409,vi8rW5hK5fGcrIxB8UA7uUUfvDXFcBEr,SpATywNh6bZuzm8s1ceuBUnMUAeoAHHw,6,3,2,0,2,0,1,0,8,1.1428571428571428,1,0.0,0,2,0,2,3,0,0,1,0,4,4,1
9167,121411,VytsQ5XFduK8xsP7edRPe1GY948fNELc,SpATywNh6bZuzm8s1ceuBUnMUAeoAHHw,6,3,2,0,2,0,6,1,14,2.0,3,0.0,0,2,0,2,3,0,0,6,1,4,10,1
9168,121418,HSjT6fK4xHlufEG141acXPeMw5gqxgnK,RXDvfPUBYFlVdlueBFbLW0mhhAyGEqpt,1,0,0,0,0,0,1,0,1,0.14285714285714285,1,0.0,0,0,0,0,0,0,0,1,0,0,1,1
9169,121419,I6qGclNEImKeNJdvIwY5PrrMknw1zeQu,SpATywNh6bZuzm8s1ceuBUnMUAeoAHHw,29,52,27,31,8,4,17,0,139,19.857142857142858,5,0.0,10,27,27,8,42,4,4,17,0,72,67,0
9170,121430,wmNYHs69T6CHydhCxfzhydbjA79LMuTD,A3fsA9Zfv1X2fVEQhTw51lKENdNrEqT3,11,7,5,0,4,0,3,0,19,2.7142857142857144,2,0.0,0,5,0,4,7,0,0,3,0,9,10,1
9171,121432,SZ5q3TqDiWq8s23sHXWpsG5po2IH5JPk,A3fsA9Zfv1X2fVEQhTw51lKENdNrEqT3,42,18,12,64,10,0,5,0,109,15.571428571428571,1,0.0,4,12,58,10,14,0,6,5,0,84,25,1
9172,121448,TdEOLyaFODrUztdbfcJuA9ZwFd0i4XD2,SpATywNh6bZuzm8s1ceuBUnMUAeoAHHw,4,3,2,0,0,0,1,0,6,0.8571428571428571,1,0.0,0,2,0,0,3,0,0,1,0,2,4,1
9173,121457,ZBXcY1yn7nPU5Nfb3hlu4PDRbw4uvT17,bWdj2GDclj5ofokWjzoa5jAwMkxCykd6,5,2,1,0,1,0,2,0,6,0.8571428571428571,1,0.0,0,1,0,1,2,0,0,2,0,2,4,1
9174,121491,YydaZKjlAxGfDjMV5cfCRvsT4mycBKZj,SpATywNh6bZuzm8s1ceuBUnMUAeoAHHw,2,0,0,0,0,0,2,0,2,0.2857142857142857,1,0.0,0,0,0,0,0,0,0,2,0,0,2,1
9175,121499,4pJSh8LpNyCkIEyBWC74bNGXhEuDFen1,A3fsA9Zfv1X2fVEQhTw51lKENdNrEqT3,7,3,2,0,2,0,2,0,9,1.2857142857142858,1,0.0,0,2,0,2,3,0,0,2,0,4,5,1
9176,121506,8MuDfPMTQjGdTGCwKyaBRuguRPTmkIOy,SpATywNh6bZuzm8s1ceuBUnMUAeoAHHw,1,0,0,0,0,0,1,0,1,0.14285714285714285,1,0.0,0,0,0,0,0,0,0,1,0,0,1,1
9177,121507,gt5tqcVggdqz1dxVZeHDF843i5ITQdCe,SpATywNh6bZuzm8s1ceuBUnMUAeoAHHw,4,0,0,0,0,0,8,0,8,1.1428571428571428,1,0.0,0,0,0,0,0,0,0,8,0,0,8,1
9178,121533,H4AuaeZGDkkLMPXUAyZX0i8XXk2BDNyk,G8EPVSXsOYB5YQWZGiz1aVq5Pgr2GrQu,6,6,4,0,2,0,1,0,13,1.8571428571428572,1,0.0,0,4,0,2,6,0,0,1,0,6,7,1
9179,121556,D2GfCnbuT86TYful9fFSzT7T5yZ1f04f,A3fsA9Zfv1X2fVEQhTw51lKENdNrEqT3,34,22,15,30,13,0,6,0,86,12.285714285714286,2,0.0,5,15,26,13,17,0,4,6,0,59,27,1
9180,121558,YPFriT4OfareXOz7G4xpBUwlcCA03JlS,SpATywNh6bZuzm8s1ceuBUnMUAeoAHHw,21,22,17,0,13,0,8,0,60,8.571428571428571,2,0.0,0,17,0,13,22,0,0,8,0,30,30,1
9181,121569,4fggBiTulBMhqyvK9Klo3I0joX8sXLqR,RXDvfPUBYFlVdlueBFbLW0mhhAyGEqpt,7,6,3,0,1,0,3,1,14,2.0,2,0.0,0,3,0,1,6,0,0,3,1,4,10,1
9182,121571,LhjMbgeFB1ZSL6HIgJEVDb0SZxar7EsN,A3fsA9Zfv1X2fVEQhTw51lKENdNrEqT3,1,0,0,0,0,0,1,0,1,0.14285714285714285,1,0.0,0,0,0,0,0,0,0,1,0,0,1,1
9183,121573,kj5o7wMZl1s4q0cggcmipnm7O7L6g4Ps,G8EPVSXsOYB5YQWZGiz1aVq5Pgr2GrQu,1,0,0,0,0,0,1,0,1,0.14285714285714285,1,0.0,0,0,0,0,0,0,0,1,0,0,1,1
9184,121590,9iGaqBGS5kkoXjLd87hUL2eIJMVUVKfU,RXDvfPUBYFlVdlueBFbLW0mhhAyGEqpt,9,15,8,0,0,0,4,0,27,3.857142857142857,3,0.0,0,8,0,0,15,0,0,4,0,8,19,1
9185,121598,CtUi7t368xVR51EojyElWFRq57eG1Gx1,bWdj2GDclj5ofokWjzoa5jAwMkxCykd6,6,2,1,0,1,0,3,1,8,1.1428571428571428,1,0.0,0,1,0,1,2,0,0,3,1,2,6,1
9186,121606,qbhlqWnlMqLEJtHv0AQDrobM0lY6ZQwu,SpATywNh6bZuzm8s1ceuBUnMUAeoAHHw,1,0,0,0,0,0,1,0,1,0.14285714285714285,1,0.0,0,0,0,0,0,0,0,1,0,0,1,1
9187,121611,bDlowck7PoswtmYozGMoa41g1GVEejKh,RXDvfPUBYFlVdlueBFbLW0mhhAyGEqpt,73,92,60,94,38,47,15,1,347,49.57142857142857,6,0.0,22,60,91,38,70,47,3,15,1,211,136,0
9188,121619,JfftjOGdDbpgbrupi0Gwr899R0jzXikJ,A3fsA9Zfv1X2fVEQhTw51lKENdNrEqT3,17,22,13,0,6,1,14,1,57,8.142857142857142,4,0.0,0,13,0,6,22,1,0,14,1,19,38,1
9189,121641,ThGblU6q4nWmu3ORXgM7eQc8q9vcBP4r,G8EPVSXsOYB5YQWZGiz1aVq5Pgr2GrQu,2,0,0,0,0,0,5,0,5,0.7142857142857143,1,0.0,0,0,0,0,0,0,0,5,0,0,5,1
9190,121643,ZULomXsITwM6vNxcJN8imzU1pyfKn8Cw,bWdj2GDclj5ofokWjzoa5jAwMkxCykd6,4,2,1,0,1,0,1,0,5,0.7142857142857143,1,0.0,0,1,0,1,2,0,0,1,0,2,3,1
9191,121648,jXl4Q6TFlYw71Bn9dguW333wEk83ysVq,SpATywNh6bZuzm8s1ceuBUnMUAeoAHHw,15,74,0,18,0,17,26,2,137,19.571428571428573,3,0.0,27,0,13,0,47,17,5,26,2,40,97,1
9192,121655,h0mYz4sCKBTfszMtgSo44TDhg1SbrdKo,SpATywNh6bZuzm8s1ceuBUnMUAeoAHHw,1,0,0,0,0,0,1,0,1,0.14285714285714285,1,0.0,0,0,0,0,0,0,0,1,0,0,1,1
9193,121662,5HXdL6OatNrhiY174KvxQUp0tpTJ3ory,SpATywNh6bZuzm8s1ceuBUnMUAeoAHHw,16,31,0,8,0,0,14,0,53,7.571428571428571,6,0.0,7,0,7,0,24,0,1,14,0,14,39,0
9194,121671,aCa6UD5e0XT0F0IHI4OQnRXRULZbtISA,SpATywNh6bZuzm8s1ceuBUnMUAeoAHHw,6,2,1,0,1,0,3,0,7,1.0,1,0.0,0,1,0,1,2,0,0,3,0,2,5,1
9195,121698,4QwjE5TQhZzqrIrmgTxr1bYCO2SVUQg8,SpATywNh6bZuzm8s1ceuBUnMUAeoAHHw,5,2,1,0,1,0,2,0,6,0.8571428571428571,1,0.0,0,1,0,1,2,0,0,2,0,2,4,1
9196,121707,4Mn2tC0xP3jJpRjJYgW6V342Z3uScDbd,A3fsA9Zfv1X2fVEQhTw51lKENdNrEqT3,6,3,1,0,1,0,3,0,8,1.1428571428571428,1,0.0,0,1,0,1,3,0,0,3,0,2,6,1
9197,121708,UBz29jsG8rR9fxGJ07ON7jTRlCVHOAv0,A3fsA9Zfv1X2fVEQhTw51lKENdNrEqT3,11,6,4,0,4,0,1,0,15,2.142857142857143,1,0.0,0,4,0,4,6,0,0,1,0,8,7,0
9198,121722,u92r3WC1YEXgmCIXMjFGJYvXTQBxOYhd,SpATywNh6bZuzm8s1ceuBUnMUAeoAHHw,13,11,4,17,3,0,2,0,37,5.285714285714286,1,0.0,6,4,16,3,5,0,1,2,0,29,8,1
9199,121729,ZrDgEyfoUHLa5uf0N0ml9T9xO22FqwKE,SpATywNh6bZuzm8s1ceuBUnMUAeoAHHw,17,24,3,6,2,1,13,1,50,7.142857142857143,3,0.0,9,3,6,2,15,1,0,13,1,20,30,0
9200,121734,x6OLIz4hMM0ByyN6TmY57kyFyEddmJ4M,A3fsA9Zfv1X2fVEQhTw51lKENdNrEqT3,6,9,4,0,0,0,4,0,17,2.4285714285714284,2,0.0,0,4,0,0,9,0,0,4,0,4,13,1
9201,121761,x6OLIz4hMM0ByyN6TmY57kyFyEddmJ4M,bWdj2GDclj5ofokWjzoa5jAwMkxCykd6,21,30,11,64,11,1,8,1,126,18.0,2,0.0,11,11,58,11,19,1,6,8,1,91,35,1
9202,121765,v4KRIvW2fm59UFurmYoSZsK2mZZrmnsA,bWdj2GDclj5ofokWjzoa5jAwMkxCykd6,9,6,3,0,1,10,11,2,33,4.714285714285714,3,0.0,0,3,0,1,6,10,0,11,2,4,29,1
9203,121767,v4KRIvW2fm59UFurmYoSZsK2mZZrmnsA,A3fsA9Zfv1X2fVEQhTw51lKENdNrEqT3,6,3,2,0,2,0,1,0,8,1.1428571428571428,1,0.0,0,2,0,2,3,0,0,1,0,4,4,1
9204,121775,jqFdSJ7Rp5LdpTT9xaXcYyPDgZuP8K28,SpATywNh6bZuzm8s1ceuBUnMUAeoAHHw,8,6,1,0,1,0,3,0,11,1.5714285714285714,1,0.0,0,1,0,1,6,0,0,3,0,2,9,1
9205,121787,x4Txzgd0OUi5yqi55NtM21eJpZWiZeEW,A3fsA9Zfv1X2fVEQhTw51lKENdNrEqT3,40,36,14,44,10,0,9,0,113,16.142857142857142,3,0.0,2,14,43,10,34,0,1,9,0,69,44,1
9206,121807,FAflDmZ5UbfFzu5Y3WrugBr3CXMWVehE,bWdj2GDclj5ofokWjzoa5jAwMkxCykd6,1,0,0,0,0,0,1,0,1,0.14285714285714285,1,0.0,0,0,0,0,0,0,0,1,0,0,1,1
9207,121808,QhQuu2NMHYcgj0YP3onmnea8Jv814Mc8,SpATywNh6bZuzm8s1ceuBUnMUAeoAHHw,4,3,1,0,1,0,1,0,6,0.8571428571428571,1,0.0,0,1,0,1,3,0,0,1,0,2,4,1
9208,121817,qZUSZi93i2Ee9CUC34HmFgFywQL2ImeW,SpATywNh6bZuzm8s1ceuBUnMUAeoAHHw,22,50,6,0,5,0,19,1,81,11.571428571428571,2,0.0,3,6,0,5,47,0,0,19,1,14,67,1
9209,121819,PmBLjK8JCE0PzpkrJAjhhCm5nVqtWEV1,A3fsA9Zfv1X2fVEQhTw51lKENdNrEqT3,1,0,0,0,0,0,1,0,1,0.14285714285714285,1,0.0,0,0,0,0,0,0,0,1,0,0,1,1
9210,121821,qsqfA7OOnk8HnDIdBoWsK3JLpkRs9fc7,A3fsA9Zfv1X2fVEQhTw51lKENdNrEqT3,1,0,0,0,0,0,1,0,1,0.14285714285714285,1,0.0,0,0,0,0,0,0,0,1,0,0,1,1
9211,121831,SiH274DFlaeNzsDPV8qquK4qRpZHyEyM,SpATywNh6bZuzm8s1ceuBUnMUAeoAHHw,30,28,18,22,8,8,9,0,93,13.285714285714286,3,0.0,6,18,19,8,22,8,3,9,0,51,42,1
9212,121832,smSHdwJ1UOXCOwbwU1gE5ygVGM1XcWJI,SpATywNh6bZuzm8s1ceuBUnMUAeoAHHw,10,6,3,0,2,0,4,2,17,2.4285714285714284,1,0.0,0,3,0,2,6,0,0,4,2,5,12,1
9213,121833,QhQuu2NMHYcgj0YP3onmnea8Jv814Mc8,G8EPVSXsOYB5YQWZGiz1aVq5Pgr2GrQu,5,3,1,0,1,0,3,0,8,1.1428571428571428,1,0.0,0,1,0,1,3,0,0,3,0,2,6,1
9214,121840,A3FGIvcpmP9UeVzECTe66iC9lFbKmHRb,RXDvfPUBYFlVdlueBFbLW0mhhAyGEqpt,44,67,34,122,21,42,17,31,334,47.714285714285715,7,0.0,21,34,100,21,46,42,22,17,31,176,158,0
9215,121845,k6ujPs3A9T0AUvcnn4NYjtPRZDclle8p,SpATywNh6bZuzm8s1ceuBUnMUAeoAHHw,1,0,0,0,0,0,1,0,1,0.14285714285714285,1,0.0,0,0,0,0,0,0,0,1,0,0,1,1
9216,121846,986WgoFI0AZSDPIvWwBI8MUZveW4E4Xu,SpATywNh6bZuzm8s1ceuBUnMUAeoAHHw,1,0,0,0,0,0,1,0,1,0.14285714285714285,1,0.0,0,0,0,0,0,0,0,1,0,0,1,1
9217,121853,6kheVQ9HoYcmvRy4m74n5u7AB6nlCIYR,SpATywNh6bZuzm8s1ceuBUnMUAeoAHHw,7,3,2,0,2,0,2,0,9,1.2857142857142858,1,0.0,0,2,0,2,3,0,0,2,0,4,5,1
9218,121859,IcRuYze0CzOpE4oHF70ukHAkSTPB9bCH,SpATywNh6bZuzm8s1ceuBUnMUAeoAHHw,24,59,5,29,0,10,13,1,117,16.714285714285715,7,0.0,23,5,27,0,36,10,2,13,1,55,62,1
9219,121873,nHMoTKw6ss0dSnBzmsq0keGpHH2NjvR7,SpATywNh6bZuzm8s1ceuBUnMUAeoAHHw,28,35,16,32,8,1,21,3,116,16.571428571428573,8,0.0,9,16,28,8,26,1,4,21,3,61,55,1
9220,121889,PhJ8qm8JsHCEW9dAikvHznDiB4SDMYD6,A3fsA9Zfv1X2fVEQhTw51lKENdNrEqT3,6,3,2,0,2,0,1,0,8,1.1428571428571428,1,0.0,0,2,0,2,3,0,0,1,0,4,4,1
9221,121891,lyKWlQXSsOSx9dJ1ME8N6mLGOkZhDx56,SpATywNh6bZuzm8s1ceuBUnMUAeoAHHw,17,33,13,6,7,1,7,0,67,9.571428571428571,4,0.0,15,13,6,7,18,1,0,7,0,41,26,1
9222,121893,Q8D1GMU9DUO6Nj6ySx5rrvLwl2bu2DGZ,SpATywNh6bZuzm8s1ceuBUnMUAeoAHHw,31,67,33,26,13,49,20,1,209,29.857142857142858,6,0.0,18,33,25,13,49,49,1,20,1,89,120,0
9223,121896,IDVV2jtBUYHXvZRwUeupKpLFwBDZmMvi,bWdj2GDclj5ofokWjzoa5jAwMkxCykd6,8,2,2,0,2,0,5,0,11,1.5714285714285714,1,0.0,0,2,0,2,2,0,0,5,0,4,7,1
9224,121903,x2eztv69vavhwR6qv43AthcyQwI14YNr,SpATywNh6bZuzm8s1ceuBUnMUAeoAHHw,16,17,9,12,4,2,5,0,49,7.0,4,0.0,4,9,9,4,13,2,3,5,0,26,23,0
9225,121906,DPTAQ5lGsvjESrb4v1mwHpMaZuqLNytl,SpATywNh6bZuzm8s1ceuBUnMUAeoAHHw,26,36,6,22,1,4,14,1,84,12.0,4,0.0,9,6,17,1,27,4,5,14,1,33,51,0
9226,121937,Ks3akoPw8lV1qZsYDHC2B3y9yzMeHmnf,SpATywNh6bZuzm8s1ceuBUnMUAeoAHHw,1,0,0,0,0,0,2,0,2,0.2857142857142857,1,0.0,0,0,0,0,0,0,0,2,0,0,2,1
9227,121952,x98jQugu3yASfETi9tV0JU7AQJM0sBk6,A3fsA9Zfv1X2fVEQhTw51lKENdNrEqT3,1,0,0,0,0,0,1,0,1,0.14285714285714285,1,0.0,0,0,0,0,0,0,0,1,0,0,1,1
9228,121961,oW9L7CxP0sDxYCxol70CUfkBpdozjWLb,SpATywNh6bZuzm8s1ceuBUnMUAeoAHHw,1,0,0,0,0,0,1,0,1,0.14285714285714285,1,0.0,0,0,0,0,0,0,0,1,0,0,1,0
9229,121984,XGd8OaVZcFiceiXpuPYWv2tDLfwrfQG1,SpATywNh6bZuzm8s1ceuBUnMUAeoAHHw,4,4,2,0,2,0,1,0,9,1.2857142857142858,1,0.0,0,2,0,2,4,0,0,1,0,4,5,1
9230,122008,C7BxnTntfGXjkSosgH12xJ8S1pNqiUlY,SpATywNh6bZuzm8s1ceuBUnMUAeoAHHw,8,4,4,0,3,0,7,0,18,2.5714285714285716,3,0.0,0,4,0,3,4,0,0,7,0,7,11,1
9231,122009,DPTAQ5lGsvjESrb4v1mwHpMaZuqLNytl,G8EPVSXsOYB5YQWZGiz1aVq5Pgr2GrQu,1,0,0,0,0,0,1,0,1,0.14285714285714285,1,0.0,0,0,0,0,0,0,0,1,0,0,1,1
9232,122011,rwCHpAN1sY0GvFYG7zQQk2qpgkOBz9O3,SpATywNh6bZuzm8s1ceuBUnMUAeoAHHw,7,6,3,0,0,2,6,0,17,2.4285714285714284,2,0.0,0,3,0,0,6,2,0,6,0,3,14,1
9233,122031,CfiZ4fswch8CYfHMLc9SAlgLprJRdAVO,SpATywNh6bZuzm8s1ceuBUnMUAeoAHHw,15,16,8,0,16,0,5,0,45,6.428571428571429,2,0.0,0,8,0,16,16,0,0,5,0,24,21,1
9234,122035,PFXaSbylT2XRWmnFTzI7TT06KKEcrU02,G8EPVSXsOYB5YQWZGiz1aVq5Pgr2GrQu,5,2,1,0,1,0,4,0,8,1.1428571428571428,2,0.0,0,1,0,1,2,0,0,4,0,2,6,1
9235,122049,IDVV2jtBUYHXvZRwUeupKpLFwBDZmMvi,A3fsA9Zfv1X2fVEQhTw51lKENdNrEqT3,10,5,5,0,5,0,5,0,20,2.857142857142857,1,0.0,0,5,0,5,5,0,0,5,0,10,10,1
9236,122055,cgc8DGkd3Jwqn7jWLS8pFiVfUMBb7Shb,bWdj2GDclj5ofokWjzoa5jAwMkxCykd6,9,18,0,0,2,3,6,0,29,4.142857142857143,2,0.0,8,0,0,2,10,3,0,6,0,10,19,1
9237,122060,Cyazs2KNzeLH7rwO0YD9wLQWGHR2SXrB,SpATywNh6bZuzm8s1ceuBUnMUAeoAHHw,5,6,3,0,1,0,3,0,13,1.8571428571428572,3,0.0,0,3,0,1,6,0,0,3,0,4,9,1
9238,122062,Cyazs2KNzeLH7rwO0YD9wLQWGHR2SXrB,A3fsA9Zfv1X2fVEQhTw51lKENdNrEqT3,5,4,2,0,1,0,2,0,9,1.2857142857142858,2,0.0,0,2,0,1,4,0,0,2,0,3,6,1
9239,122063,Cyazs2KNzeLH7rwO0YD9wLQWGHR2SXrB,bWdj2GDclj5ofokWjzoa5jAwMkxCykd6,5,6,3,0,1,0,3,0,13,1.8571428571428572,3,0.0,0,3,0,1,6,0,0,3,0,4,9,1
9240,122072,UdIMXWwMbB1F8xXEtwt8g56Lh72G96hQ,SpATywNh6bZuzm8s1ceuBUnMUAeoAHHw,9,10,9,0,9,0,2,0,30,4.285714285714286,1,0.0,0,9,0,9,10,0,0,2,0,18,12,1
9241,122074,JbB7hpnQ5hVzqELznLtzJLRyOZ2rdnyH,SpATywNh6bZuzm8s1ceuBUnMUAeoAHHw,20,40,13,32,7,0,8,0,100,14.285714285714286,3,0.0,25,13,29,7,15,0,3,8,0,74,26,1
9242,122079,cderIDaWBR3ykedbqXoG7yh75mThXkpL,A3fsA9Zfv1X2fVEQhTw51lKENdNrEqT3,47,61,25,84,3,20,25,1,219,31.285714285714285,7,0.0,3,25,71,3,58,20,13,25,1,102,117,1
9243,122080,2dTQ27kTyKMSAN4dn7cbjnuDmdSbybLJ,SpATywNh6bZuzm8s1ceuBUnMUAeoAHHw,26,35,16,31,7,8,16,1,114,16.285714285714285,3,0.0,13,16,31,7,22,8,0,16,1,67,47,0
9244,124650,efygWYkxxUMOGInRZT4qEeuzMRlIpQq6,7GRhBDsirIGkRZBtSMEzNTyDr2JQm4xx,39,110,65,2,65,0,18,2,262,37.42857142857143,6,0.0,34,65,1,65,76,0,1,18,2,165,97,0
9245,124655,znF1cjtWo1KGLXEIK5C3NJfQlk7HZ3U1,7GRhBDsirIGkRZBtSMEzNTyDr2JQm4xx,32,71,19,68,6,35,9,1,209,29.857142857142858,4,0.0,44,19,57,6,27,35,11,9,1,126,83,1
9246,124664,sL5jw3pLWZoRI7avI17oM60mfF67Acgz,7GRhBDsirIGkRZBtSMEzNTyDr2JQm4xx,1,0,0,0,0,0,2,0,2,0.2857142857142857,2,0.0,0,0,0,0,0,0,0,2,0,0,2,1
9247,124672,SglSA2qg6fizXrvdkABD6ypMwWhttZ4P,7GRhBDsirIGkRZBtSMEzNTyDr2JQm4xx,1,0,0,0,0,0,1,0,1,0.14285714285714285,1,0.0,0,0,0,0,0,0,0,1,0,0,1,1
9248,124702,Xv0DoRVy2WPaq7NGSTl3PflvzGmHzjVJ,7GRhBDsirIGkRZBtSMEzNTyDr2JQm4xx,62,229,25,128,23,31,68,0,504,72.0,10,0.0,138,25,109,23,91,31,19,68,0,295,209,0
9249,124731,kAnFbfXpbNeJLwDkVeY9dBv06ssaFoQQ,7GRhBDsirIGkRZBtSMEzNTyDr2JQm4xx,7,5,4,0,4,0,10,0,23,3.2857142857142856,3,0.0,0,4,0,4,5,0,0,10,0,8,15,1
9250,124761,ioaeb7d1U29jI9wsI7DHJ7aiuWWVX3KB,7GRhBDsirIGkRZBtSMEzNTyDr2JQm4xx,1,0,0,0,0,0,1,0,1,0.14285714285714285,1,0.0,0,0,0,0,0,0,0,1,0,0,1,1
9251,124784,Eh1GmQ1l1uLUtTdjFKV3N8aG3h7KeTZw,7GRhBDsirIGkRZBtSMEzNTyDr2JQm4xx,16,14,9,0,6,11,8,0,48,6.857142857142857,4,0.0,0,9,0,6,14,11,0,8,0,15,33,1
9252,124806,Th577tzrUuQ2mCFol11GPYRTSP1uxDgy,7GRhBDsirIGkRZBtSMEzNTyDr2JQm4xx,1,0,0,0,0,0,10,0,10,1.4285714285714286,7,0.0,0,0,0,0,0,0,0,10,0,0,10,1
9253,124883,YglOmvsVjCCnNnyOM9hw1BozNvavt4Yw,7GRhBDsirIGkRZBtSMEzNTyDr2JQm4xx,10,10,5,4,5,0,4,0,28,4.0,2,0.0,3,5,3,5,7,0,1,4,0,16,12,1
9254,124914,Jjmm0y7q4AQOSfmS8g0ehDtEqybh04ZX,7GRhBDsirIGkRZBtSMEzNTyDr2JQm4xx,1,0,0,0,0,0,1,0,1,0.14285714285714285,1,0.0,0,0,0,0,0,0,0,1,0,0,1,1
9255,124920,gZWf27ETcHz4bBmwZPjiPumw55JZ4IOR,7GRhBDsirIGkRZBtSMEzNTyDr2JQm4xx,5,4,0,0,0,0,4,0,8,1.1428571428571428,2,0.0,0,0,0,0,4,0,0,4,0,0,8,1
9256,124935,VRS5uIqYlw2SwZ8kUgzPCb9ckuRb5DEy,7GRhBDsirIGkRZBtSMEzNTyDr2JQm4xx,51,163,1,149,18,2,25,1,359,51.285714285714285,5,0.0,81,1,131,18,82,2,18,25,1,231,128,1
9257,124949,sQym1SSnuvlV9rWhfoiNBuvnxQoSSsrc,7GRhBDsirIGkRZBtSMEzNTyDr2JQm4xx,8,17,5,0,1,1,3,0,27,3.857142857142857,2,0.0,6,5,0,1,11,1,0,3,0,12,15,0
9258,124950,Xn0FkHI67ejumzKXwubbQ6h7XBOcvKHb,7GRhBDsirIGkRZBtSMEzNTyDr2JQm4xx,1,0,0,0,0,0,2,0,2,0.2857142857142857,2,0.0,0,0,0,0,0,0,0,2,0,0,2,1
9259,124961,MQKEfJfHQjDI3xyJjnjmz4WwmQkpOvq2,7GRhBDsirIGkRZBtSMEzNTyDr2JQm4xx,5,5,3,0,2,4,3,0,17,2.4285714285714284,3,0.0,0,3,0,2,5,4,0,3,0,5,12,1
9260,125015,wuCb3DAs0UTa3nnL6gSfoBgjTkpbfyNt,7GRhBDsirIGkRZBtSMEzNTyDr2JQm4xx,2,0,0,0,0,0,7,0,7,1.0,3,0.0,0,0,0,0,0,0,0,7,0,0,7,0
9261,125055,GjKIGij44vr1LmHxaYp53Ww7DNMH4X51,7GRhBDsirIGkRZBtSMEzNTyDr2JQm4xx,1,0,0,0,0,0,1,0,1,0.14285714285714285,1,0.0,0,0,0,0,0,0,0,1,0,0,1,1
9262,125141,Bh56YjgPG1aYs0o5T2OK5m2v5NWxpiqv,7GRhBDsirIGkRZBtSMEzNTyDr2JQm4xx,1,0,0,0,0,0,1,0,1,0.14285714285714285,1,0.0,0,0,0,0,0,0,0,1,0,0,1,1
9263,125168,lJUTJBRxdmUZMtpc6Z00drkXv7sphS3I,7GRhBDsirIGkRZBtSMEzNTyDr2JQm4xx,1,0,0,0,0,0,1,0,1,0.14285714285714285,1,0.0,0,0,0,0,0,0,0,1,0,0,1,1
9264,125192,GCOHYGlzOItFnghKeaWS09bGB70fHDaY,7GRhBDsirIGkRZBtSMEzNTyDr2JQm4xx,3,1,0,0,0,0,2,0,3,0.42857142857142855,1,0.0,0,0,0,0,1,0,0,2,0,0,3,1
9265,125231,LKQx76DscP8cMaadDZLCOsushv3ygeRX,7GRhBDsirIGkRZBtSMEzNTyDr2JQm4xx,1,0,0,0,0,0,2,0,2,0.2857142857142857,2,0.0,0,0,0,0,0,0,0,2,0,0,2,1
9266,125245,eOxm8XEI11Xs6eiBi1Nu5QzIagZXwEm9,7GRhBDsirIGkRZBtSMEzNTyDr2JQm4xx,7,0,0,0,0,2,7,0,9,1.2857142857142858,2,0.0,0,0,0,0,0,2,0,7,0,0,9,1
9267,125259,BGrU91p3SJR2EobOQ7G1wG17DcXaN4qI,7GRhBDsirIGkRZBtSMEzNTyDr2JQm4xx,6,5,3,0,2,0,3,0,13,1.8571428571428572,2,0.0,0,3,0,2,5,0,0,3,0,5,8,1
9268,125303,b7PuwalmdIR7gI2f0kgWK9mhLJEyGy0c,7GRhBDsirIGkRZBtSMEzNTyDr2JQm4xx,5,2,1,0,1,0,4,0,8,1.1428571428571428,2,0.0,0,1,0,1,2,0,0,4,0,2,6,1
9269,125376,Im85u8aENweba95uFnFOR6zdQWFnfDOq,7GRhBDsirIGkRZBtSMEzNTyDr2JQm4xx,6,10,6,0,3,0,6,0,25,3.5714285714285716,2,0.0,0,6,0,3,10,0,0,6,0,9,16,1
9270,125417,EApv9HeMdrTOqAiEQ2b8Pe6dV7nBgttc,7GRhBDsirIGkRZBtSMEzNTyDr2JQm4xx,25,30,10,14,12,0,4,0,70,10.0,1,0.0,19,10,11,12,11,0,3,4,0,52,18,1
9271,125427,eRoc2wJbq7MhBPMEmeCelGVn6NCoE6rW,7GRhBDsirIGkRZBtSMEzNTyDr2JQm4xx,5,2,1,0,1,0,2,0,6,0.8571428571428571,1,0.0,0,1,0,1,2,0,0,2,0,2,4,1
9272,125428,7tmNprOSiahGzByaY8XiUnCFEIQfWwuf,7GRhBDsirIGkRZBtSMEzNTyDr2JQm4xx,42,187,37,56,21,10,14,0,325,46.42857142857143,7,0.0,97,37,50,21,90,10,6,14,0,205,120,0
9273,125495,idU4PBrRhkhRSQxacAs4twJhArJhSxu3,7GRhBDsirIGkRZBtSMEzNTyDr2JQm4xx,1,0,0,0,0,0,1,0,1,0.14285714285714285,1,0.0,0,0,0,0,0,0,0,1,0,0,1,1
9274,125497,PBb82RihjctDhPv3TdRmoDOf1nw7NrF1,7GRhBDsirIGkRZBtSMEzNTyDr2JQm4xx,7,7,4,0,2,0,4,0,17,2.4285714285714284,2,0.0,0,4,0,2,7,0,0,4,0,6,11,1
9275,125503,EihYm2z8SiHLHxWvKz7i6RRNVdYLw99f,7GRhBDsirIGkRZBtSMEzNTyDr2JQm4xx,2,0,0,0,0,0,4,0,4,0.5714285714285714,1,0.0,0,0,0,0,0,0,0,4,0,0,4,1
9276,125626,xAPFTLGOI6MhRuvYnyw4iYAuIk60vENo,7GRhBDsirIGkRZBtSMEzNTyDr2JQm4xx,5,9,5,0,0,0,6,0,20,2.857142857142857,1,0.0,0,5,0,0,9,0,0,6,0,5,15,1
9277,125633,FDR62LyL2NPX1eDLrbTp7iEOk4qB3llp,7GRhBDsirIGkRZBtSMEzNTyDr2JQm4xx,26,37,17,10,26,1,15,0,106,15.142857142857142,3,0.0,18,17,10,26,19,1,0,15,0,71,35,1
9278,125658,cUvcpWppohUVKz8Tban8cv5QfXMTXadW,7GRhBDsirIGkRZBtSMEzNTyDr2JQm4xx,1,0,0,0,0,0,2,0,2,0.2857142857142857,2,0.0,0,0,0,0,0,0,0,2,0,0,2,1
9279,125680,tRu7kc3B7i0xOP4FswhcDsdZx5KznD0T,7GRhBDsirIGkRZBtSMEzNTyDr2JQm4xx,2,0,0,0,0,0,3,0,3,0.42857142857142855,1,0.0,0,0,0,0,0,0,0,3,0,0,3,1
9280,125693,Z1sZhLd0yuKMu6iVzogIpx0JDek3jyqT,7GRhBDsirIGkRZBtSMEzNTyDr2JQm4xx,1,0,0,0,0,0,1,0,1,0.14285714285714285,1,0.0,0,0,0,0,0,0,0,1,0,0,1,1
9281,125756,ScNAsndZpkOb6xTMDq2TkU95eVmTkUfl,7GRhBDsirIGkRZBtSMEzNTyDr2JQm4xx,4,2,0,0,0,0,2,0,4,0.5714285714285714,1,0.0,0,0,0,0,2,0,0,2,0,0,4,1
9282,125793,xpwei0fjDTwQJLJhl5FjMPXksqpuR5GG,7GRhBDsirIGkRZBtSMEzNTyDr2JQm4xx,85,83,31,87,26,0,20,0,247,35.285714285714285,3,0.0,44,31,87,26,39,0,0,20,0,188,59,0
9283,125803,UgRvVqO3twMvJzAlD49rqrTbxTS8yLpX,7GRhBDsirIGkRZBtSMEzNTyDr2JQm4xx,5,4,1,0,1,0,2,0,8,1.1428571428571428,2,0.0,0,1,0,1,4,0,0,2,0,2,6,1
9284,125837,k0z6RGGewAn8TOLu7gTAfbvZpKAlaO9s,7GRhBDsirIGkRZBtSMEzNTyDr2JQm4xx,1,0,0,0,0,0,1,0,1,0.14285714285714285,1,0.0,0,0,0,0,0,0,0,1,0,0,1,1
9285,125844,PmtrviA6hBub1PH85YXqVyZgghNsuc4g,7GRhBDsirIGkRZBtSMEzNTyDr2JQm4xx,1,0,0,0,0,0,1,0,1,0.14285714285714285,1,0.0,0,0,0,0,0,0,0,1,0,0,1,1
9286,125847,z1ruPoQWI2YQpUKGJMJN29iqd6Mz8fk8,7GRhBDsirIGkRZBtSMEzNTyDr2JQm4xx,8,8,0,4,2,1,2,0,17,2.4285714285714284,1,0.0,4,0,3,2,4,1,1,2,0,9,8,1
9287,125865,PKH12j56WyhhHbwNNO7EjzMEo1oeOneA,7GRhBDsirIGkRZBtSMEzNTyDr2JQm4xx,1,0,0,0,0,0,1,0,1,0.14285714285714285,1,0.0,0,0,0,0,0,0,0,1,0,0,1,1
9288,125959,d8nG3CRjdRKOgHNCQ97Y2ebOYVCkXw4D,7GRhBDsirIGkRZBtSMEzNTyDr2JQm4xx,2,0,0,0,0,0,2,0,2,0.2857142857142857,2,0.0,0,0,0,0,0,0,0,2,0,0,2,1
9289,125993,YNJKXpmmDE2uZ1c64Ovdnu4MZUQJ0A5j,7GRhBDsirIGkRZBtSMEzNTyDr2JQm4xx,1,0,0,0,0,0,1,0,1,0.14285714285714285,1,0.0,0,0,0,0,0,0,0,1,0,0,1,1
9290,126003,Vao6JycAVhIhWbjbxKbLXiDUK1ZHKwjo,7GRhBDsirIGkRZBtSMEzNTyDr2JQm4xx,25,34,15,36,2,7,3,0,97,13.857142857142858,2,0.0,9,15,33,2,25,7,3,3,0,59,38,1
9291,126612,OvRHQPlJQt08MjvBAsm9o6SalVx0kpxp,fbPkOYLVPtPgIt0MxizjfFJov3JbHyAi,6,15,1,0,1,0,5,0,22,3.142857142857143,1,0.0,2,1,0,1,13,0,0,5,0,4,18,1
9292,126613,Zl05tzo85snAXIri6adShvvUNKe0OymE,fbPkOYLVPtPgIt0MxizjfFJov3JbHyAi,6,9,3,0,2,0,7,0,21,3.0,1,0.0,4,3,0,2,5,0,0,7,0,9,12,1
9293,126614,heqH52ArHeSze97HDhxIHtMU3K7IMrRM,fbPkOYLVPtPgIt0MxizjfFJov3JbHyAi,9,7,3,0,3,0,6,0,19,2.7142857142857144,1,0.0,2,3,0,3,5,0,0,6,0,8,11,1
9294,126615,YxqQc0FBDNSpG3MFOKGx9ekKufVhxrPh,fbPkOYLVPtPgIt0MxizjfFJov3JbHyAi,16,9,7,0,7,0,3,0,26,3.7142857142857144,1,0.0,0,7,0,7,9,0,0,3,0,14,12,1
9295,126616,uieKgiKz9M2OwhKZvR7kKiTuoDNfJUlP,fbPkOYLVPtPgIt0MxizjfFJov3JbHyAi,2,0,0,0,0,0,5,0,5,0.7142857142857143,1,0.0,0,0,0,0,0,0,0,5,0,0,5,1
9296,126617,ysDhewvMwqkWHpjR0j6mtjJo9sLvpRAM,fbPkOYLVPtPgIt0MxizjfFJov3JbHyAi,16,23,9,2,11,15,18,1,79,11.285714285714286,2,0.0,11,9,2,11,12,15,0,18,1,33,46,1
9297,126618,fbJQhb9qJhxn4GPcwi4AErVjPsHJbyL7,fbPkOYLVPtPgIt0MxizjfFJov3JbHyAi,7,12,4,0,5,0,5,0,26,3.7142857142857144,2,0.0,2,4,0,5,10,0,0,5,0,11,15,1
9298,126620,LSVa2jpU1dF8RnC5rzovm0tv2cSNIe8I,fbPkOYLVPtPgIt0MxizjfFJov3JbHyAi,10,9,6,4,4,0,3,0,26,3.7142857142857144,2,0.0,1,6,3,4,8,0,1,3,0,14,12,1
9299,126621,L1D39t7woJJ3WRGAxRtS5wF9BZQP2EYr,fbPkOYLVPtPgIt0MxizjfFJov3JbHyAi,6,5,3,0,3,0,3,0,14,2.0,1,0.0,0,3,0,3,5,0,0,3,0,6,8,1
9300,126625,arRLaw4hZnmx5zrjvIy48oXkTK5DrU7i,fbPkOYLVPtPgIt0MxizjfFJov3JbHyAi,6,4,2,0,1,2,7,0,16,2.2857142857142856,2,0.0,0,2,0,1,4,2,0,7,0,3,13,1
9301,126626,0PTt7yojLQH47Ob79awcf5jvqfHw2L3I,fbPkOYLVPtPgIt0MxizjfFJov3JbHyAi,43,53,27,40,21,18,11,2,172,24.571428571428573,5,0.0,11,27,33,21,42,18,7,11,2,92,80,1
9302,126627,810MRx7l0r4ApLZ3yM1jRSAg5LUkiCFn,fbPkOYLVPtPgIt0MxizjfFJov3JbHyAi,4,2,1,0,1,0,1,0,5,0.7142857142857143,1,0.0,0,1,0,1,2,0,0,1,0,2,3,1
9303,126628,gdWTcSZVoKN1pGf7JyovC0vqfcnT9h18,fbPkOYLVPtPgIt0MxizjfFJov3JbHyAi,8,10,5,0,6,0,15,0,36,5.142857142857143,4,0.0,2,5,0,6,8,0,0,15,0,13,23,1
9304,126629,0hd5ExdLnNdKHQRTwwTLHmDaSlTLMdvd,fbPkOYLVPtPgIt0MxizjfFJov3JbHyAi,5,2,1,0,1,0,4,0,8,1.1428571428571428,1,0.0,0,1,0,1,2,0,0,4,0,2,6,1
9305,126631,I2ghGumCKIaVsnJOGZA0xyJzTnEm5KtW,fbPkOYLVPtPgIt0MxizjfFJov3JbHyAi,14,13,8,4,4,10,7,1,47,6.714285714285714,3,0.0,1,8,3,4,12,10,1,7,1,16,31,1
9306,126634,euBhTje23sMDM8PPQbKVpH6OVKTfG91O,fbPkOYLVPtPgIt0MxizjfFJov3JbHyAi,1,0,0,0,0,0,1,0,1,0.14285714285714285,1,0.0,0,0,0,0,0,0,0,1,0,0,1,1
9307,126635,bA4tnPZD0UU4XAL3OkL7nUjtkAzbgj9d,fbPkOYLVPtPgIt0MxizjfFJov3JbHyAi,7,4,2,0,2,6,2,0,16,2.2857142857142856,1,0.0,0,2,0,2,4,6,0,2,0,4,12,1
9308,126636,P2xHl8oxJOV4TMoYrxym6L2dPSAdMMJs,fbPkOYLVPtPgIt0MxizjfFJov3JbHyAi,4,2,1,0,1,0,1,0,5,0.7142857142857143,1,0.0,0,1,0,1,2,0,0,1,0,2,3,1
9309,126637,c8TFm45r0bfBe26eBlEeUAKDBoTJT9yV,fbPkOYLVPtPgIt0MxizjfFJov3JbHyAi,8,4,3,0,3,0,1,0,11,1.5714285714285714,1,0.0,0,3,0,3,4,0,0,1,0,6,5,0
9310,126638,IBEBjXb2AhSAQmCEtwVxNy77qVPKcclm,fbPkOYLVPtPgIt0MxizjfFJov3JbHyAi,6,4,2,0,1,2,3,0,12,1.7142857142857142,1,0.0,0,2,0,1,4,2,0,3,0,3,9,1
9311,126639,x6BtQH70uuLHaxqzHA21U9wmfT0SxzD9,fbPkOYLVPtPgIt0MxizjfFJov3JbHyAi,6,2,0,0,0,0,5,1,8,1.1428571428571428,2,0.0,0,0,0,0,2,0,0,5,1,0,8,1
9312,126640,99YWSjgqR4hZD4KPEunWhlG5MDGBBYbJ,fbPkOYLVPtPgIt0MxizjfFJov3JbHyAi,6,3,1,0,1,0,2,0,7,1.0,1,0.0,0,1,0,1,3,0,0,2,0,2,5,1
9313,126642,OseLd0Vj4CawbZPfZRznLZH5tivxQP68,fbPkOYLVPtPgIt0MxizjfFJov3JbHyAi,7,4,2,0,2,0,4,0,12,1.7142857142857142,2,0.0,1,2,0,2,3,0,0,4,0,5,7,1
9314,126643,lRTCAuzQcWWtA62pbQwh7xYqG6ghwvm9,fbPkOYLVPtPgIt0MxizjfFJov3JbHyAi,12,17,5,9,10,3,8,0,52,7.428571428571429,1,0.0,11,5,7,10,6,3,2,8,0,33,19,1
9315,126644,N1bQ5aFhcb1yr21loPYJqu2BbdxHrcfB,fbPkOYLVPtPgIt0MxizjfFJov3JbHyAi,11,8,6,0,2,1,6,1,24,3.4285714285714284,1,0.0,0,6,0,2,8,1,0,6,1,8,16,1
9316,126646,mb7Zd70aH6w6tsEQr8q9cAr4RlsgpSEG,fbPkOYLVPtPgIt0MxizjfFJov3JbHyAi,2,0,0,0,0,0,7,0,7,1.0,1,0.0,0,0,0,0,0,0,0,7,0,0,7,1
9317,126647,1tMY1MpuZPW690JnedcAZZYFmf6foWjL,fbPkOYLVPtPgIt0MxizjfFJov3JbHyAi,7,5,3,0,2,7,2,0,19,2.7142857142857144,1,0.0,0,3,0,2,5,7,0,2,0,5,14,1
9318,126649,wdjY1oC33XqL52RaIYWlfwM88qICxfHB,fbPkOYLVPtPgIt0MxizjfFJov3JbHyAi,8,9,5,0,5,4,3,0,26,3.7142857142857144,1,0.0,2,5,0,5,7,4,0,3,0,12,14,0
9319,126650,LD7pbuVHju3VTu9U8udNh6I7JCsw9ECG,fbPkOYLVPtPgIt0MxizjfFJov3JbHyAi,52,65,36,45,23,0,14,0,183,26.142857142857142,5,0.0,20,36,36,23,45,0,9,14,0,115,68,0
9320,126651,ctraTKVJ2JhUCIHyavrJWUiIknGdQbqc,fbPkOYLVPtPgIt0MxizjfFJov3JbHyAi,2,0,0,0,0,0,5,0,5,0.7142857142857143,1,0.0,0,0,0,0,0,0,0,5,0,0,5,1
9321,126654,YLJf06fjaksgc6NESkSC4nTSBafk5Yoh,fbPkOYLVPtPgIt0MxizjfFJov3JbHyAi,7,9,2,0,2,0,2,0,15,2.142857142857143,1,0.0,0,2,0,2,9,0,0,2,0,4,11,1
9322,126656,vXwf4MSRd0xkinwiIqWQdnJoLNdmsOvm,fbPkOYLVPtPgIt0MxizjfFJov3JbHyAi,7,3,2,0,2,0,5,0,12,1.7142857142857142,1,0.0,0,2,0,2,3,0,0,5,0,4,8,1
9323,126657,A6zX6I2GfUhXHkfxx6hY7fkYNihUgWzR,fbPkOYLVPtPgIt0MxizjfFJov3JbHyAi,6,6,2,0,2,0,1,0,11,1.5714285714285714,1,0.0,1,2,0,2,5,0,0,1,0,5,6,1
9324,126658,bwZYXSIDocrsg9B80u5hz1s4TUzxdjem,fbPkOYLVPtPgIt0MxizjfFJov3JbHyAi,8,6,2,0,3,0,5,0,16,2.2857142857142856,1,0.0,2,2,0,3,4,0,0,5,0,7,9,1
9325,126659,lUOW63ZIGkmagy3rVXMv25n4vumPKUfs,fbPkOYLVPtPgIt0MxizjfFJov3JbHyAi,5,2,1,0,1,0,3,0,7,1.0,1,0.0,0,1,0,1,2,0,0,3,0,2,5,1
9326,126660,e2CxwSKYgRRxAYL99ajalycn9caM2cox,fbPkOYLVPtPgIt0MxizjfFJov3JbHyAi,5,2,1,0,1,2,6,0,12,1.7142857142857142,1,0.0,0,1,0,1,2,2,0,6,0,2,10,1
9327,126661,7dkSnitaOk46bh4JzUzQh70jkQ2SBZcu,fbPkOYLVPtPgIt0MxizjfFJov3JbHyAi,3,2,1,0,0,0,1,0,4,0.5714285714285714,1,0.0,0,1,0,0,2,0,0,1,0,1,3,1
9328,126662,wUoZ0jO9cvYMtyUP7nefHwtNjYQG7VUS,fbPkOYLVPtPgIt0MxizjfFJov3JbHyAi,2,0,0,0,0,0,7,0,7,1.0,1,0.0,0,0,0,0,0,0,0,7,0,0,7,1
9329,126663,AAbYMvj6N4kPLfJSTWdxJHOFF7gGokhv,fbPkOYLVPtPgIt0MxizjfFJov3JbHyAi,7,3,2,0,2,0,5,0,12,1.7142857142857142,1,0.0,0,2,0,2,3,0,0,5,0,4,8,1
9330,126665,paTNeCrMrWcChojlLsspaorcmQjiSxoH,fbPkOYLVPtPgIt0MxizjfFJov3JbHyAi,2,0,0,0,0,0,3,0,3,0.42857142857142855,1,0.0,0,0,0,0,0,0,0,3,0,0,3,1
9331,126668,GbCaM9AUbbkCquP0Qap7xohw6uCLXYPC,fbPkOYLVPtPgIt0MxizjfFJov3JbHyAi,6,9,0,0,0,3,7,2,21,3.0,2,0.0,0,0,0,0,9,3,0,7,2,0,21,1
9332,126669,pEzMNyrul10BaiwI0ZVRc6CziruRKt37,fbPkOYLVPtPgIt0MxizjfFJov3JbHyAi,1,0,0,0,0,0,1,0,1,0.14285714285714285,1,0.0,0,0,0,0,0,0,0,1,0,0,1,1
9333,126670,G4gv3psLUg6DraQbf90HcUcwjZl74koo,fbPkOYLVPtPgIt0MxizjfFJov3JbHyAi,7,2,2,0,2,0,2,0,8,1.1428571428571428,1,0.0,0,2,0,2,2,0,0,2,0,4,4,1
9334,126672,cAt3kAq8A4nBNACWncm3aidYAQ1d8bbM,fbPkOYLVPtPgIt0MxizjfFJov3JbHyAi,7,6,4,0,2,0,2,0,14,2.0,2,0.0,0,4,0,2,6,0,0,2,0,6,8,1
9335,126673,9iDcxmHxr3SmvjvcATJP2YvHEz7UDHIB,fbPkOYLVPtPgIt0MxizjfFJov3JbHyAi,1,0,0,0,0,0,1,0,1,0.14285714285714285,1,0.0,0,0,0,0,0,0,0,1,0,0,1,1
9336,126674,LqQpVFQv4lJ36VdzJ4TLAuyE3Ov82MrP,fbPkOYLVPtPgIt0MxizjfFJov3JbHyAi,14,13,8,0,6,9,6,1,43,6.142857142857143,2,0.0,1,8,0,6,12,9,0,6,1,15,28,1
9337,126675,IDaqGyhjD6ErPQOFlyvvPqvNK1bXBxI0,fbPkOYLVPtPgIt0MxizjfFJov3JbHyAi,5,3,2,0,2,5,0,0,12,1.7142857142857142,1,0.0,0,2,0,2,3,5,0,0,0,4,8,1
9338,126676,wmND65rZOV8Cdq3Mq9MmFLy7XUHHSgIW,fbPkOYLVPtPgIt0MxizjfFJov3JbHyAi,1,0,0,0,0,0,1,0,1,0.14285714285714285,1,0.0,0,0,0,0,0,0,0,1,0,0,1,1
9339,126682,gCWKTntdRCeMdOtUiFg2mfCjgrvO2vpV,fbPkOYLVPtPgIt0MxizjfFJov3JbHyAi,10,7,5,0,3,0,2,0,17,2.4285714285714284,1,0.0,0,5,0,3,7,0,0,2,0,8,9,1
9340,126684,4nv50J1wZS6kPdidLB1Y9lmEShhD8gDr,fbPkOYLVPtPgIt0MxizjfFJov3JbHyAi,4,2,1,0,1,0,1,0,5,0.7142857142857143,1,0.0,0,1,0,1,2,0,0,1,0,2,3,1
9341,126686,twUid3xG1muFotfbhs814Ag7sscFy0p2,fbPkOYLVPtPgIt0MxizjfFJov3JbHyAi,8,7,3,0,3,0,2,0,15,2.142857142857143,1,0.0,2,3,0,3,5,0,0,2,0,8,7,1
9342,126687,h5bSBTzGWadYMvrkMiapQR2U8CQzOFmW,fbPkOYLVPtPgIt0MxizjfFJov3JbHyAi,6,3,1,0,1,0,2,0,7,1.0,1,0.0,0,1,0,1,3,0,0,2,0,2,5,1
9343,126690,RhUtXI34T3ZAxfPNMapta5ryhpUSWnVk,fbPkOYLVPtPgIt0MxizjfFJov3JbHyAi,4,2,0,0,0,0,3,0,5,0.7142857142857143,2,0.0,0,0,0,0,2,0,0,3,0,0,5,1
9344,126693,v6oH0XZ7BYoM6ZOy0T23nm7pBiES9NPB,fbPkOYLVPtPgIt0MxizjfFJov3JbHyAi,8,10,4,0,4,8,9,0,35,5.0,2,0.0,2,4,0,4,8,8,0,9,0,10,25,1
9345,126694,zn2X74vvqUQRINz90WjZLsSsFglpYr7o,fbPkOYLVPtPgIt0MxizjfFJov3JbHyAi,10,9,6,0,3,6,8,1,33,4.714285714285714,3,0.0,0,6,0,3,9,6,0,8,1,9,24,1
9346,126695,HSi3yW2yFW0jz9rvJLhKsLbntRdoY32a,fbPkOYLVPtPgIt0MxizjfFJov3JbHyAi,8,4,3,0,3,0,1,0,11,1.5714285714285714,1,0.0,0,3,0,3,4,0,0,1,0,6,5,1
9347,126696,XMNENeqGvf1rZdMY0iLZGJZMfiQXuZuC,fbPkOYLVPtPgIt0MxizjfFJov3JbHyAi,9,12,5,0,4,0,3,0,24,3.4285714285714284,2,0.0,2,5,0,4,10,0,0,3,0,11,13,1
9348,126698,9LD2dY2JJUiq4N2gerCXLTVCO162xgQP,fbPkOYLVPtPgIt0MxizjfFJov3JbHyAi,11,14,7,0,0,21,18,2,62,8.857142857142858,2,0.0,0,7,0,0,14,21,0,18,2,7,55,1
9349,126700,ltYfR4c85t4WE2sNzApQ2jUPBpU7b957,fbPkOYLVPtPgIt0MxizjfFJov3JbHyAi,7,6,3,0,2,0,8,0,19,2.7142857142857144,2,0.0,0,3,0,2,6,0,0,8,0,5,14,1
9350,126702,dUZiaQQxyKZymoXkd4PU7n1DsSWSaoIy,fbPkOYLVPtPgIt0MxizjfFJov3JbHyAi,8,4,1,0,1,3,15,0,24,3.4285714285714284,2,0.0,0,1,0,1,4,3,0,15,0,2,22,1
9351,126704,T8cbb1vJp70svkAiDdRu3fMjKB52qGra,fbPkOYLVPtPgIt0MxizjfFJov3JbHyAi,18,20,14,0,11,2,4,0,51,7.285714285714286,2,0.0,0,14,0,11,20,2,0,4,0,25,26,1
9352,126706,wRfmNw7A5BDFV6ZZ1hHimgxOa1BKzUIG,fbPkOYLVPtPgIt0MxizjfFJov3JbHyAi,5,2,1,0,1,0,4,0,8,1.1428571428571428,1,0.0,0,1,0,1,2,0,0,4,0,2,6,1
9353,126707,J1iCM60eAwVKTPRoP9hdyFlEQf6db3YF,fbPkOYLVPtPgIt0MxizjfFJov3JbHyAi,5,2,1,0,1,0,2,0,6,0.8571428571428571,1,0.0,0,1,0,1,2,0,0,2,0,2,4,1
9354,126709,xJHRW2pP02hpKUueg876ng5RKQuuRj6e,fbPkOYLVPtPgIt0MxizjfFJov3JbHyAi,7,2,1,0,1,5,5,2,16,2.2857142857142856,1,0.0,0,1,0,1,2,5,0,5,2,2,14,1
9355,126710,74SN75RPs9smmLOI0EXp2s3BwIneUL6f,fbPkOYLVPtPgIt0MxizjfFJov3JbHyAi,4,2,1,0,1,0,1,0,5,0.7142857142857143,1,0.0,0,1,0,1,2,0,0,1,0,2,3,1
9356,126716,nKDNYUTGPAPqMmlfE7Ub4Qe4fIY0CgoN,fbPkOYLVPtPgIt0MxizjfFJov3JbHyAi,7,3,2,0,2,0,2,0,9,1.2857142857142858,1,0.0,0,2,0,2,3,0,0,2,0,4,5,1
9357,126719,ubotMSWIUOxiTHzx65PiC1ieC4BwcBY3,fbPkOYLVPtPgIt0MxizjfFJov3JbHyAi,7,6,4,0,3,0,8,0,21,3.0,1,0.0,0,4,0,3,6,0,0,8,0,7,14,1
9358,126720,ILgj2bRC3L9liHZTpRi1J62GsWMdjm7i,fbPkOYLVPtPgIt0MxizjfFJov3JbHyAi,44,60,40,27,27,40,11,0,205,29.285714285714285,3,0.0,11,40,23,27,49,40,4,11,0,101,104,0
9359,126721,svRBzwXocvDcjjQhiBGtiJ9xaG6TSovy,fbPkOYLVPtPgIt0MxizjfFJov3JbHyAi,7,13,3,0,3,0,2,0,21,3.0,1,0.0,6,3,0,3,7,0,0,2,0,12,9,1
9360,126723,CEB1n53vwmUc8FHZoBrt4V9IQdrhTfqS,fbPkOYLVPtPgIt0MxizjfFJov3JbHyAi,1,0,0,0,0,0,1,0,1,0.14285714285714285,1,0.0,0,0,0,0,0,0,0,1,0,0,1,1
9361,126725,qad1013ZPW8FX2puHq0BQB5FRF6ADJuZ,fbPkOYLVPtPgIt0MxizjfFJov3JbHyAi,1,0,0,0,0,0,1,0,1,0.14285714285714285,1,0.0,0,0,0,0,0,0,0,1,0,0,1,1
9362,126726,jwPZuNOmAMKPf75y5B5RjmpRb6aVkyKO,fbPkOYLVPtPgIt0MxizjfFJov3JbHyAi,8,5,2,0,2,0,4,0,13,1.8571428571428572,1,0.0,0,2,0,2,5,0,0,4,0,4,9,1
9363,126727,okqN4nBVKRYYrkYonKicKGOmPqVGYjZh,fbPkOYLVPtPgIt0MxizjfFJov3JbHyAi,12,19,9,0,10,0,19,0,57,8.142857142857142,5,0.0,0,9,0,10,19,0,0,19,0,19,38,0
9364,126732,c3bBGCRAwL0HZQ0vFzkQ6CAecfLWPbLO,fbPkOYLVPtPgIt0MxizjfFJov3JbHyAi,7,3,2,0,2,0,6,0,13,1.8571428571428572,1,0.0,0,2,0,2,3,0,0,6,0,4,9,1
9365,126733,eGYk5KFWT4Pvjbd5cX2RH5CTBhiHI9SQ,fbPkOYLVPtPgIt0MxizjfFJov3JbHyAi,17,32,6,25,15,0,6,0,84,12.0,1,0.0,25,6,21,15,7,0,4,6,0,67,17,1
9366,126734,AbrmwZ5WdO7ReOka4PEAhehW5B0axP5g,fbPkOYLVPtPgIt0MxizjfFJov3JbHyAi,10,4,2,0,2,4,10,1,23,3.2857142857142856,1,0.0,1,2,0,2,3,4,0,10,1,5,18,1
9367,126735,FXETNH4OzV3fwI4YkwpBpnk1E19ob1X2,fbPkOYLVPtPgIt0MxizjfFJov3JbHyAi,2,0,0,0,0,0,2,0,2,0.2857142857142857,1,0.0,0,0,0,0,0,0,0,2,0,0,2,1
9368,126736,rrBwc9DqMP8jnv9AB7ljubWYdmiLkI0q,fbPkOYLVPtPgIt0MxizjfFJov3JbHyAi,1,0,0,0,0,0,1,0,1,0.14285714285714285,1,0.0,0,0,0,0,0,0,0,1,0,0,1,1
9369,126738,7M93OdpUvlNXQzkFgbb1jjdCwfDx9GtM,fbPkOYLVPtPgIt0MxizjfFJov3JbHyAi,13,7,5,0,5,0,7,0,24,3.4285714285714284,1,0.0,0,5,0,5,7,0,0,7,0,10,14,1
9370,126740,5lk9vcvlk4ZCLjblktkMYKVUtSVMBE5E,fbPkOYLVPtPgIt0MxizjfFJov3JbHyAi,6,8,1,0,2,3,6,0,20,2.857142857142857,1,0.0,2,1,0,2,6,3,0,6,0,5,15,1
9371,126741,lkSkVgerjbY9elu2HritmYHEIObp7PjN,fbPkOYLVPtPgIt0MxizjfFJov3JbHyAi,20,30,13,12,12,0,12,0,79,11.285714285714286,5,0.0,14,13,10,12,16,0,2,12,0,49,30,1
9372,126743,lkPumIFIPcAu2WGl2L8VJbRmISnkyI8O,fbPkOYLVPtPgIt0MxizjfFJov3JbHyAi,1,0,0,0,0,0,1,0,1,0.14285714285714285,1,0.0,0,0,0,0,0,0,0,1,0,0,1,1
9373,126744,oGufUk3TlimKTfZlaD6U33grjPc0CIXa,fbPkOYLVPtPgIt0MxizjfFJov3JbHyAi,1,0,0,0,0,0,1,0,1,0.14285714285714285,1,0.0,0,0,0,0,0,0,0,1,0,0,1,1
9374,126745,LNdimqsJkOxQDP9dT4IGwewg9YvH7zfV,fbPkOYLVPtPgIt0MxizjfFJov3JbHyAi,1,0,0,0,0,0,1,0,1,0.14285714285714285,1,0.0,0,0,0,0,0,0,0,1,0,0,1,1
9375,126747,N8IThlIYSn8Fy4uyyTQSpl5K0TGz5NzT,fbPkOYLVPtPgIt0MxizjfFJov3JbHyAi,1,0,0,0,0,0,1,0,1,0.14285714285714285,1,0.0,0,0,0,0,0,0,0,1,0,0,1,1
9376,126749,dhYRwzeTF8ZdKZPmARZOAee0piLEqFbu,fbPkOYLVPtPgIt0MxizjfFJov3JbHyAi,10,12,5,0,3,3,11,0,34,4.857142857142857,1,0.0,1,5,0,3,11,3,0,11,0,9,25,1
9377,126752,WIgM6nvV9YFBo82xFhtQp6923xmcbs69,fbPkOYLVPtPgIt0MxizjfFJov3JbHyAi,1,0,0,0,0,0,1,0,1,0.14285714285714285,1,0.0,0,0,0,0,0,0,0,1,0,0,1,1
9378,126754,xGbsJo4oJvVhF60tIqZnizNX71bTSMlF,fbPkOYLVPtPgIt0MxizjfFJov3JbHyAi,5,3,1,0,1,0,2,0,7,1.0,1,0.0,0,1,0,1,3,0,0,2,0,2,5,1
9379,126755,sfmDw8Mu24TwJAISRGKb3tkGixPCex4a,fbPkOYLVPtPgIt0MxizjfFJov3JbHyAi,1,0,0,0,0,0,1,0,1,0.14285714285714285,1,0.0,0,0,0,0,0,0,0,1,0,0,1,1
9380,126757,6Rep3wtvxTeRNedCLfqY7iMeUZ3V82V5,fbPkOYLVPtPgIt0MxizjfFJov3JbHyAi,1,0,0,0,0,0,1,0,1,0.14285714285714285,1,0.0,0,0,0,0,0,0,0,1,0,0,1,1
9381,126758,bATDoM6JXGnyb4V3IABuJhs4a0vjJZc3,fbPkOYLVPtPgIt0MxizjfFJov3JbHyAi,7,3,2,0,2,0,2,0,9,1.2857142857142858,1,0.0,0,2,0,2,3,0,0,2,0,4,5,1
9382,126760,VAqYNROCUp4auixkrMgowB877fUTXjiq,fbPkOYLVPtPgIt0MxizjfFJov3JbHyAi,9,4,2,0,1,0,5,1,13,1.8571428571428572,1,0.0,0,2,0,1,4,0,0,5,1,3,10,1
9383,126762,tedGThhHMqVARfBh6zyzyocTKbTJYJpB,fbPkOYLVPtPgIt0MxizjfFJov3JbHyAi,10,13,9,0,5,11,9,0,47,6.714285714285714,4,0.0,0,9,0,5,13,11,0,9,0,14,33,0
9384,126763,paw4uFNhxlmHKr4qI1FVQJCklV7n0vFs,fbPkOYLVPtPgIt0MxizjfFJov3JbHyAi,2,0,0,0,0,0,3,0,3,0.42857142857142855,1,0.0,0,0,0,0,0,0,0,3,0,0,3,1
9385,126764,dzZvmhMBCZUS7A4bdHQZaWrZNWx9wlnR,fbPkOYLVPtPgIt0MxizjfFJov3JbHyAi,5,2,1,0,1,0,2,0,6,0.8571428571428571,1,0.0,0,1,0,1,2,0,0,2,0,2,4,0
9386,126766,YDTJdQorIvDsVBFXmCLdVqB4blieQHew,fbPkOYLVPtPgIt0MxizjfFJov3JbHyAi,8,3,1,0,1,0,6,0,11,1.5714285714285714,1,0.0,0,1,0,1,3,0,0,6,0,2,9,1
9387,126767,xPpQ4dt3yAtdD8kr7bwSICTMyO3G9j2v,fbPkOYLVPtPgIt0MxizjfFJov3JbHyAi,2,0,0,0,0,0,2,0,2,0.2857142857142857,1,0.0,0,0,0,0,0,0,0,2,0,0,2,1
9388,126768,0WQD9JgXnh1Oc60hHZOmb4uDwk3oDBzG,fbPkOYLVPtPgIt0MxizjfFJov3JbHyAi,1,0,0,0,0,0,1,0,1,0.14285714285714285,1,0.0,0,0,0,0,0,0,0,1,0,0,1,1
9389,126771,xMKGcYeHMuhMu436Dx8qNr2iLxqOhlEy,fbPkOYLVPtPgIt0MxizjfFJov3JbHyAi,6,6,3,0,1,0,4,0,14,2.0,1,0.0,0,3,0,1,6,0,0,4,0,4,10,1
9390,126773,BD211S7WnIRsylhDTuEdNrGmy3W7uQ04,fbPkOYLVPtPgIt0MxizjfFJov3JbHyAi,4,2,1,0,0,0,2,0,5,0.7142857142857143,1,0.0,0,1,0,0,2,0,0,2,0,1,4,1
9391,126774,4FlFuHK6TBPGfbsvWig6oHoWLKBiaFvx,fbPkOYLVPtPgIt0MxizjfFJov3JbHyAi,29,42,17,20,20,5,10,1,115,16.428571428571427,4,0.0,20,17,17,20,22,5,3,10,1,74,41,1
9392,126778,ukV83h2gop6RgQ4r0p0CZA73Nn6q15H2,fbPkOYLVPtPgIt0MxizjfFJov3JbHyAi,9,5,4,0,3,0,5,0,17,2.4285714285714284,1,0.0,0,4,0,3,5,0,0,5,0,7,10,1
9393,126780,k0j1JTbNvF4wEJZ0EFYHSB55VWnrDKJ0,fbPkOYLVPtPgIt0MxizjfFJov3JbHyAi,1,0,0,0,0,0,1,0,1,0.14285714285714285,1,0.0,0,0,0,0,0,0,0,1,0,0,1,1
9394,126783,fZTrS29Fp3monLBfDxON161JJDMC3kWz,fbPkOYLVPtPgIt0MxizjfFJov3JbHyAi,8,7,0,0,0,2,5,0,14,2.0,2,0.0,0,0,0,0,7,2,0,5,0,0,14,1
9395,126786,2urzmdkueRAEgx9jksBRYegBWc6qjd5N,fbPkOYLVPtPgIt0MxizjfFJov3JbHyAi,7,3,2,0,2,0,2,0,9,1.2857142857142858,1,0.0,0,2,0,2,3,0,0,2,0,4,5,1
9396,126787,SudTrjctDId1aP2BFyvfpzdEUNt4tVpn,fbPkOYLVPtPgIt0MxizjfFJov3JbHyAi,1,0,0,0,0,0,1,0,1,0.14285714285714285,1,0.0,0,0,0,0,0,0,0,1,0,0,1,1
9397,126788,oAeA1FcKJgCgppNdDO8cyAq9ijjrn0WR,fbPkOYLVPtPgIt0MxizjfFJov3JbHyAi,7,2,1,0,1,0,5,0,9,1.2857142857142858,1,0.0,0,1,0,1,2,0,0,5,0,2,7,1
9398,126789,9TAoWA17iJi4aGxReuxcPCWmtwK9xK5D,fbPkOYLVPtPgIt0MxizjfFJov3JbHyAi,4,2,1,0,0,0,2,0,5,0.7142857142857143,1,0.0,0,1,0,0,2,0,0,2,0,1,4,1
9399,126790,bXfZmQuCdk4kcCEmwkhxKTGNfBpAQ8z2,fbPkOYLVPtPgIt0MxizjfFJov3JbHyAi,6,3,2,0,2,0,1,0,8,1.1428571428571428,1,0.0,0,2,0,2,3,0,0,1,0,4,4,1
9400,126791,fx2VHlFzMiSpt4HdfnAJod2kZRWQGzoD,fbPkOYLVPtPgIt0MxizjfFJov3JbHyAi,8,5,3,0,2,1,9,0,20,2.857142857142857,2,0.0,0,3,0,2,5,1,0,9,0,5,15,0
9401,126792,i2PPXz5Z5PB2ZfiVAI64TcWxYgJR1QQ1,fbPkOYLVPtPgIt0MxizjfFJov3JbHyAi,10,7,5,0,4,0,4,0,20,2.857142857142857,2,0.0,0,5,0,4,7,0,0,4,0,9,11,1
9402,126793,w81M8LsxqroaoVvhuOiOu12ogu2TTrVp,fbPkOYLVPtPgIt0MxizjfFJov3JbHyAi,10,5,3,0,2,0,6,0,16,2.2857142857142856,1,0.0,0,3,0,2,5,0,0,6,0,5,11,1
9403,126794,9og5l3kBrvNmeUS7WEJnLIW5U5JOFnlr,fbPkOYLVPtPgIt0MxizjfFJov3JbHyAi,1,0,0,0,0,0,1,0,1,0.14285714285714285,1,0.0,0,0,0,0,0,0,0,1,0,0,1,1
9404,126795,dlcs3mIk1dQaLsNVv2V1gEVdgllvLwJb,fbPkOYLVPtPgIt0MxizjfFJov3JbHyAi,1,0,0,0,0,0,1,0,1,0.14285714285714285,1,0.0,0,0,0,0,0,0,0,1,0,0,1,1
9405,126796,nRLTavEl1bXxEwhFINnyKEh9SYy7D5ak,fbPkOYLVPtPgIt0MxizjfFJov3JbHyAi,5,3,1,0,1,0,1,0,6,0.8571428571428571,1,0.0,0,1,0,1,3,0,0,1,0,2,4,1
9406,126799,GZEmn2jDYiPNelTXdP84Wl4gxgVXz7UQ,fbPkOYLVPtPgIt0MxizjfFJov3JbHyAi,7,7,4,0,2,0,3,0,16,2.2857142857142856,1,0.0,1,4,0,2,6,0,0,3,0,7,9,1
9407,126800,03LSJMJGCEPYScMXgYv3wZ9A4zZCWROs,fbPkOYLVPtPgIt0MxizjfFJov3JbHyAi,5,2,1,0,1,0,3,0,7,1.0,2,0.0,0,1,0,1,2,0,0,3,0,2,5,1
9408,126802,Ae7TpzHEpVWIeUEcofOMHxfQYB9IZpIZ,fbPkOYLVPtPgIt0MxizjfFJov3JbHyAi,4,3,0,0,0,0,2,0,5,0.7142857142857143,1,0.0,1,0,0,0,2,0,0,2,0,1,4,1
9409,126803,baVXGFYC1QSmRnztVLPGhtEiVUNUt9jm,fbPkOYLVPtPgIt0MxizjfFJov3JbHyAi,9,13,8,0,4,7,5,0,37,5.285714285714286,2,0.0,0,8,0,4,13,7,0,5,0,12,25,1
9410,126804,udjvqTKwWnl3kdnagqtGxHOib49LhYFP,fbPkOYLVPtPgIt0MxizjfFJov3JbHyAi,1,0,0,0,0,0,1,0,1,0.14285714285714285,1,0.0,0,0,0,0,0,0,0,1,0,0,1,1
9411,126805,tb2OgRXfqTZBzkHrdlQDSZ9zV3ijuuxF,fbPkOYLVPtPgIt0MxizjfFJov3JbHyAi,5,0,0,0,0,2,14,5,21,3.0,2,0.0,0,0,0,0,0,2,0,14,5,0,21,1
9412,126807,9a82SEYCdqbKx1WLnzqNRiSe6ROiwLtA,fbPkOYLVPtPgIt0MxizjfFJov3JbHyAi,8,2,1,0,1,1,6,1,12,1.7142857142857142,1,0.0,0,1,0,1,2,1,0,6,1,2,10,1
9413,126808,fwOw0LJBQGN43wSD5bc3nLA7e72R3dmo,fbPkOYLVPtPgIt0MxizjfFJov3JbHyAi,1,0,0,0,0,0,1,0,1,0.14285714285714285,1,0.0,0,0,0,0,0,0,0,1,0,0,1,1
9414,126809,hcIMsJjzliCUSfKNV7VjadwRGqNrlbcK,fbPkOYLVPtPgIt0MxizjfFJov3JbHyAi,5,7,6,0,0,0,2,0,15,2.142857142857143,1,0.0,0,6,0,0,7,0,0,2,0,6,9,0
9415,126812,HO2p5gxVWMQedHP7d588CVyHIhMACwbO,fbPkOYLVPtPgIt0MxizjfFJov3JbHyAi,7,4,2,0,2,0,7,0,15,2.142857142857143,1,0.0,0,2,0,2,4,0,0,7,0,4,11,1
9416,126818,UKVpy6yMY2LOCbd33JRDxwPZtMJSUcsq,fbPkOYLVPtPgIt0MxizjfFJov3JbHyAi,1,0,0,0,0,0,1,0,1,0.14285714285714285,1,0.0,0,0,0,0,0,0,0,1,0,0,1,1
9417,126819,bmUODmp9W7t1pFfRc25oTW8BqLenSXaz,fbPkOYLVPtPgIt0MxizjfFJov3JbHyAi,4,2,0,0,0,0,2,0,4,0.5714285714285714,1,0.0,0,0,0,0,2,0,0,2,0,0,4,1
9418,126820,qDTU2XGTiB220mLDzlsck7xSj3wUhIhe,fbPkOYLVPtPgIt0MxizjfFJov3JbHyAi,8,3,1,0,1,3,7,1,16,2.2857142857142856,2,0.0,0,1,0,1,3,3,0,7,1,2,14,1
9419,130035,GWG8afsUfRei9CIZYg1Y2sBsF64D5J9k,7GRhBDsirIGkRZBtSMEzNTyDr2JQm4xx,5,4,1,0,0,0,4,0,9,1.2857142857142858,3,0.0,0,1,0,0,4,0,0,4,0,1,8,1
9420,130039,Z5sEt151hX78nE6qWmPF09aVI6QGewvL,7GRhBDsirIGkRZBtSMEzNTyDr2JQm4xx,21,33,0,6,2,0,10,1,52,7.428571428571429,2,0.0,15,0,3,2,18,0,3,10,1,20,32,0
9421,130041,tlBnmsKf0J20KHkh9Qq2FoTYGO7e78wj,7GRhBDsirIGkRZBtSMEzNTyDr2JQm4xx,22,20,8,81,3,0,5,0,117,16.714285714285715,1,0.0,12,8,68,3,8,0,13,5,0,91,26,1
9422,130047,jcZzyelmNOUxuY7TWiZZyoS3gSdLYxDW,7GRhBDsirIGkRZBtSMEzNTyDr2JQm4xx,24,25,7,8,12,1,5,0,58,8.285714285714286,1,0.0,18,7,4,12,7,1,4,5,0,41,17,1
9423,130051,V6I2tWMT4J6OaEfYWYGJXMvy6YbJ0vQk,7GRhBDsirIGkRZBtSMEzNTyDr2JQm4xx,36,46,13,55,0,0,3,0,117,16.714285714285715,3,0.0,22,13,53,0,24,0,2,3,0,88,29,0
9424,130052,zJ1cXp5NsbaO1h7ITMq3mqJ8kisUpMMv,7GRhBDsirIGkRZBtSMEzNTyDr2JQm4xx,47,36,12,108,10,0,3,0,169,24.142857142857142,1,0.0,22,12,100,10,14,0,8,3,0,144,25,1
9425,130059,1xcKG4Eeqo6PRlQtqz4lRNBDzvKhe7qL,7GRhBDsirIGkRZBtSMEzNTyDr2JQm4xx,35,76,11,56,9,21,28,3,204,29.142857142857142,6,0.0,35,11,46,9,41,21,10,28,3,101,103,0
9426,130126,Kt9qeiacR1tBDeKKHUR6O60ehH5pm7C9,7GRhBDsirIGkRZBtSMEzNTyDr2JQm4xx,9,18,1,2,0,0,3,0,24,3.4285714285714284,2,0.0,4,1,2,0,14,0,0,3,0,7,17,1
9427,130170,bVkBiR8Ol1DpipPI05IgYIPbLOO6oZNi,7GRhBDsirIGkRZBtSMEzNTyDr2JQm4xx,57,116,35,63,20,13,24,5,276,39.42857142857143,2,0.0,49,35,56,20,67,13,7,24,5,160,116,0
9428,130205,D5GqwXfacfySSvxPJ9v7ORjiX9Oa23f1,7GRhBDsirIGkRZBtSMEzNTyDr2JQm4xx,103,133,47,185,47,11,38,7,468,66.85714285714286,7,0.0,78,47,158,47,55,11,27,38,7,330,138,1
9429,130239,ECkqmAuIkv3ncN9wNJby8oOn15qTd9kR,7GRhBDsirIGkRZBtSMEzNTyDr2JQm4xx,1,0,0,0,0,0,1,0,1,0.14285714285714285,1,0.0,0,0,0,0,0,0,0,1,0,0,1,0
9430,130318,Mms6sMIkW4Omst3uLD38oJJ4C0ZCQcDW,7GRhBDsirIGkRZBtSMEzNTyDr2JQm4xx,11,17,1,0,1,0,6,0,25,3.5714285714285716,2,0.0,1,1,0,1,16,0,0,6,0,3,22,1
9431,130321,gzS6aH9DKKq1TfiY1ctxHgUplSbkMYNf,7GRhBDsirIGkRZBtSMEzNTyDr2JQm4xx,11,8,4,6,1,0,10,0,29,4.142857142857143,1,0.0,4,4,5,1,4,0,1,10,0,14,15,1
9432,134909,GfFjXeeiX86hNL5LrfmBqRsIDiX1X26k,SpATywNh6bZuzm8s1ceuBUnMUAeoAHHw,28,39,21,30,9,1,6,0,106,15.142857142857142,3,0.0,10,21,27,9,29,1,3,6,0,67,39,1
9433,134917,yNC8T7gdWO96Y2q3tzTQeJUMY0F51xnO,RXDvfPUBYFlVdlueBFbLW0mhhAyGEqpt,42,27,16,52,8,0,5,0,108,15.428571428571429,4,0.0,7,16,52,8,20,0,0,5,0,83,25,1
9434,134918,IFqWOl32JJm0W3Ap2jxVCpJeXeLJlYDp,A3fsA9Zfv1X2fVEQhTw51lKENdNrEqT3,8,11,6,0,0,0,6,0,23,3.2857142857142856,4,0.0,0,6,0,0,11,0,0,6,0,6,17,1
9435,134919,DLOMX6N4LOgxba8fGitXr3UEhtTSXCQd,bWdj2GDclj5ofokWjzoa5jAwMkxCykd6,7,9,1,0,2,0,3,0,15,2.142857142857143,2,0.0,2,1,0,2,7,0,0,3,0,5,10,1
9436,134934,mWx2Nz03jP9JKc9PS0gQU6sG6k2C9F0d,SpATywNh6bZuzm8s1ceuBUnMUAeoAHHw,15,31,1,22,1,24,2,0,81,11.571428571428571,2,0.0,9,1,20,1,22,24,2,2,0,31,50,0
9437,134936,NOmOOlAJE5nKLDW211ZOVqBtRY1AgNoT,bWdj2GDclj5ofokWjzoa5jAwMkxCykd6,12,21,2,0,0,1,7,0,31,4.428571428571429,1,0.0,1,2,0,0,20,1,0,7,0,3,28,1
9438,134958,vZY5RTyvAOyjF1AYeCntOYrEo9bIz6lQ,G8EPVSXsOYB5YQWZGiz1aVq5Pgr2GrQu,1,0,0,0,0,0,1,0,1,0.14285714285714285,1,0.0,0,0,0,0,0,0,0,1,0,0,1,1
9439,134959,pvIpspZXePJsFKRHWlM49ptwJQDbUcRt,SpATywNh6bZuzm8s1ceuBUnMUAeoAHHw,3,2,0,0,0,0,1,0,3,0.42857142857142855,1,0.0,0,0,0,0,2,0,0,1,0,0,3,1
9440,134961,oqS6zzIbAzdLBJLSTonEDuhKDtanqUaf,SpATywNh6bZuzm8s1ceuBUnMUAeoAHHw,22,25,0,31,0,17,7,0,80,11.428571428571429,2,0.0,7,0,26,0,18,17,5,7,0,33,47,1
9441,134982,CW7Zlsz0NoDYd7q0tu1Krgi9b7wpQUwQ,A3fsA9Zfv1X2fVEQhTw51lKENdNrEqT3,11,11,6,4,1,0,12,0,34,4.857142857142857,4,0.0,0,6,3,1,11,0,1,12,0,10,24,0
9442,134994,eSBIcO9jl3TmHpUt3HWb9pXo82kpOmfn,bWdj2GDclj5ofokWjzoa5jAwMkxCykd6,7,4,2,0,2,0,1,0,9,1.2857142857142858,1,0.0,0,2,0,2,4,0,0,1,0,4,5,1
9443,135002,Vr0kaKAkI4p2upUYNB1MMKsTShBZob66,A3fsA9Zfv1X2fVEQhTw51lKENdNrEqT3,10,10,5,0,2,13,6,0,36,5.142857142857143,3,0.0,0,5,0,2,10,13,0,6,0,7,29,1
9444,135005,8roapIDCTFIdbLoaqBbYR8jsy1UP5sGP,RXDvfPUBYFlVdlueBFbLW0mhhAyGEqpt,11,9,6,0,3,1,4,0,23,3.2857142857142856,1,0.0,0,6,0,3,9,1,0,4,0,9,14,1
9445,135010,ABF7qktVQ6rBIirYNSz5GNtRM330ID0h,A3fsA9Zfv1X2fVEQhTw51lKENdNrEqT3,1,0,0,0,0,0,2,0,2,0.2857142857142857,1,0.0,0,0,0,0,0,0,0,2,0,0,2,1
9446,135021,TCrdvmbavAJVW5bPiEeyt89TcS6pYL1D,A3fsA9Zfv1X2fVEQhTw51lKENdNrEqT3,2,0,0,0,0,0,3,0,3,0.42857142857142855,1,0.0,0,0,0,0,0,0,0,3,0,0,3,1
9447,135022,f0rWHmI4rV7ssYizy9jzg3UxqKTtG19Y,SpATywNh6bZuzm8s1ceuBUnMUAeoAHHw,21,44,0,20,0,1,18,0,83,11.857142857142858,5,0.0,18,0,17,0,26,1,3,18,0,35,48,0
9448,135025,tedGThhHMqVARfBh6zyzyocTKbTJYJpB,SpATywNh6bZuzm8s1ceuBUnMUAeoAHHw,22,29,15,15,5,11,9,1,85,12.142857142857142,4,0.0,10,15,12,5,19,11,3,9,1,42,43,1
9449,135026,Cue1j1CEK4ByBYziFbTJAskjanGgrJp6,SpATywNh6bZuzm8s1ceuBUnMUAeoAHHw,17,16,0,10,0,9,2,0,37,5.285714285714286,2,0.0,0,0,10,0,16,9,0,2,0,10,27,0
9450,135035,wQjDRlC3tPpszGzQ3Dfiq7I6azQztJ02,A3fsA9Zfv1X2fVEQhTw51lKENdNrEqT3,13,9,6,4,4,0,3,0,26,3.7142857142857144,2,0.0,2,6,4,4,7,0,0,3,0,16,10,1
9451,135040,QflUMQYqgKuyQPnCteHvz3LqhJ9AwCga,A3fsA9Zfv1X2fVEQhTw51lKENdNrEqT3,2,0,0,0,0,0,9,0,9,1.2857142857142858,1,0.0,0,0,0,0,0,0,0,9,0,0,9,1
9452,135060,UJeg7gRsnH7RZFT5Iv8Y0tTilR96sXcV,A3fsA9Zfv1X2fVEQhTw51lKENdNrEqT3,3,2,0,0,0,0,2,0,4,0.5714285714285714,1,0.0,0,0,0,0,2,0,0,2,0,0,4,1
9453,135065,g9QyBrQkEVh9IC3JA81b7KgVa01DwgUa,SpATywNh6bZuzm8s1ceuBUnMUAeoAHHw,30,29,18,26,10,5,8,2,98,14.0,2,0.0,8,18,25,10,21,5,1,8,2,61,37,1
9454,135079,GFArLd1huQSmyLkNR2x5AlhFrFWDXs0N,SpATywNh6bZuzm8s1ceuBUnMUAeoAHHw,14,40,9,26,3,0,3,0,81,11.571428571428571,5,0.0,24,9,21,3,16,0,5,3,0,57,24,0
9455,135095,e09uq36QgLuBVK5DERoejsHeMH2uPMRM,bWdj2GDclj5ofokWjzoa5jAwMkxCykd6,1,0,0,0,0,0,1,0,1,0.14285714285714285,1,0.0,0,0,0,0,0,0,0,1,0,0,1,1
9456,135097,EbZIIypapfDMAa5QP57XCFF2cfAshgSo,RXDvfPUBYFlVdlueBFbLW0mhhAyGEqpt,1,0,0,0,0,0,2,0,2,0.2857142857142857,1,0.0,0,0,0,0,0,0,0,2,0,0,2,1
9457,135104,gZWf27ETcHz4bBmwZPjiPumw55JZ4IOR,A3fsA9Zfv1X2fVEQhTw51lKENdNrEqT3,1,0,0,0,0,0,1,0,1,0.14285714285714285,1,0.0,0,0,0,0,0,0,0,1,0,0,1,1
9458,135115,qknWf2eBme9z3XgVNwZwbwdoI0FKipkj,A3fsA9Zfv1X2fVEQhTw51lKENdNrEqT3,40,25,16,70,12,4,13,0,140,20.0,3,0.0,6,16,55,12,19,4,15,13,0,89,51,1
9459,135119,czraR8jl3tjb5vvHKbMcAmZkpcCxXmtq,bWdj2GDclj5ofokWjzoa5jAwMkxCykd6,7,3,2,0,2,1,3,0,11,1.5714285714285714,1,0.0,0,2,0,2,3,1,0,3,0,4,7,1
9460,135128,jbfQf8j93qEc8QCxEb0dikXBABlkLrcO,G8EPVSXsOYB5YQWZGiz1aVq5Pgr2GrQu,1,0,0,0,0,0,1,0,1,0.14285714285714285,1,0.0,0,0,0,0,0,0,0,1,0,0,1,1
9461,135137,A3FGIvcpmP9UeVzECTe66iC9lFbKmHRb,A3fsA9Zfv1X2fVEQhTw51lKENdNrEqT3,41,27,21,68,11,0,5,0,132,18.857142857142858,4,0.0,1,21,60,11,26,0,8,5,0,93,39,1
9462,135143,LbQhhYRYGsyaTkO1QusAxgXnsVSB1OSE,SpATywNh6bZuzm8s1ceuBUnMUAeoAHHw,7,1,1,0,1,1,6,1,11,1.5714285714285714,1,0.0,0,1,0,1,1,1,0,6,1,2,9,1
9463,135168,wMQxNrryGKgbGXsy17gJPlh2fJdDvt8s,bWdj2GDclj5ofokWjzoa5jAwMkxCykd6,13,19,6,72,5,9,3,0,114,16.285714285714285,2,0.0,8,6,65,5,11,9,7,3,0,84,30,1
9464,135172,qLscbApWydA7z1h7Ht7RN2UnF0mvGZpF,RXDvfPUBYFlVdlueBFbLW0mhhAyGEqpt,13,20,1,0,0,1,8,1,31,4.428571428571429,3,0.0,0,1,0,0,20,1,0,8,1,1,30,1
9465,135188,qhmgArW8a15UOGQrFTosGi03wE1TjPeN,G8EPVSXsOYB5YQWZGiz1aVq5Pgr2GrQu,32,54,2,38,6,0,3,0,103,14.714285714285714,2,0.0,34,2,24,6,20,0,14,3,0,66,37,1
9466,135190,wLSijvQvjlVUQosga79Y2P2NJWJt5aXA,SpATywNh6bZuzm8s1ceuBUnMUAeoAHHw,15,24,11,20,4,3,3,0,65,9.285714285714286,1,0.0,4,11,16,4,20,3,4,3,0,35,30,0
9467,135205,ps2zbzmz8NQnCm6f0pvJpkBQkQh2tR1v,bWdj2GDclj5ofokWjzoa5jAwMkxCykd6,23,67,48,50,21,0,12,0,198,28.285714285714285,3,0.0,6,48,43,21,61,0,7,12,0,118,80,1
9468,135209,XPNYQB8BXxVJKoqXsnIXNkzgmqWM9Jf1,bWdj2GDclj5ofokWjzoa5jAwMkxCykd6,1,0,0,0,0,0,1,0,1,0.14285714285714285,1,0.0,0,0,0,0,0,0,0,1,0,0,1,0
9469,135219,njjQXvcpocYF8aiLDJ8yZfLnv69cMgqm,SpATywNh6bZuzm8s1ceuBUnMUAeoAHHw,18,10,9,0,8,0,2,0,29,4.142857142857143,1,0.0,0,9,0,8,10,0,0,2,0,17,12,1
9470,135222,MpTAgw3ozhmeD7C8xc95FgAYRb7j4nGM,SpATywNh6bZuzm8s1ceuBUnMUAeoAHHw,6,2,1,0,1,0,3,0,7,1.0,1,0.0,0,1,0,1,2,0,0,3,0,2,5,1
9471,135232,ZfIQYurnR6gJbWxLJ81cU3ZqzX4mpHm0,A3fsA9Zfv1X2fVEQhTw51lKENdNrEqT3,34,73,36,4,21,2,34,2,172,24.571428571428573,4,0.0,3,36,4,21,70,2,0,34,2,64,108,1
9472,135234,8JTz84ZDdJm6tvsd7hgyCl1RB6wU6r2e,A3fsA9Zfv1X2fVEQhTw51lKENdNrEqT3,6,3,2,0,1,0,2,0,8,1.1428571428571428,1,0.0,0,2,0,1,3,0,0,2,0,3,5,1
9473,135242,JJ57bFsns5I0rz7X8YoOwiZazG9JNmlR,SpATywNh6bZuzm8s1ceuBUnMUAeoAHHw,1,0,0,0,0,0,1,0,1,0.14285714285714285,1,0.0,0,0,0,0,0,0,0,1,0,0,1,1
9474,135247,n67Q6gA8OyrfjvaOwbClftMWf4trlmyC,A3fsA9Zfv1X2fVEQhTw51lKENdNrEqT3,16,12,8,0,7,0,5,0,32,4.571428571428571,2,0.0,0,8,0,7,12,0,0,5,0,15,17,1
9475,135252,1umo7etGwkx7NcpFxVialzDD37NdyqRT,G8EPVSXsOYB5YQWZGiz1aVq5Pgr2GrQu,43,77,35,58,8,0,4,0,182,26.0,2,0.0,38,35,37,8,39,0,21,4,0,118,64,0
9476,135271,orkLWN7Jw88UrSJVImY9WyAA9wO3axVi,A3fsA9Zfv1X2fVEQhTw51lKENdNrEqT3,1,0,0,0,0,0,1,0,1,0.14285714285714285,1,0.0,0,0,0,0,0,0,0,1,0,0,1,1
9477,135272,MZomFQTbHAKaDGd0B9fv7KQ9MRsZJ7m6,bWdj2GDclj5ofokWjzoa5jAwMkxCykd6,4,4,1,0,0,0,2,0,7,1.0,1,0.0,0,1,0,0,4,0,0,2,0,1,6,1
9478,135304,43KrXQWA5nPYKCMGBRnIKMf2ytZWgrcW,bWdj2GDclj5ofokWjzoa5jAwMkxCykd6,1,0,0,0,0,0,1,0,1,0.14285714285714285,1,0.0,0,0,0,0,0,0,0,1,0,0,1,1
9479,135305,43KrXQWA5nPYKCMGBRnIKMf2ytZWgrcW,A3fsA9Zfv1X2fVEQhTw51lKENdNrEqT3,1,0,0,0,0,0,2,0,2,0.2857142857142857,1,0.0,0,0,0,0,0,0,0,2,0,0,2,1
9480,135319,XRgwz0GPwgb7aVdSZ4HGlz0QU2iMHxW2,A3fsA9Zfv1X2fVEQhTw51lKENdNrEqT3,8,3,2,0,2,1,3,2,13,1.8571428571428572,1,0.0,0,2,0,2,3,1,0,3,2,4,9,1
9481,135335,NXrRVU4FxMGO3zABXLL6x3AW8OEzmOAP,SpATywNh6bZuzm8s1ceuBUnMUAeoAHHw,3,0,0,0,0,0,3,0,3,0.42857142857142855,1,0.0,0,0,0,0,0,0,0,3,0,0,3,1
9482,135337,1Qo7KMYcvZsuiBzdvEuPj5kKA7qUbqJV,RXDvfPUBYFlVdlueBFbLW0mhhAyGEqpt,1,0,0,0,0,0,1,0,1,0.14285714285714285,1,0.0,0,0,0,0,0,0,0,1,0,0,1,1
9483,135358,ENiSmEGDuCang79gWrzmkKVXvQ2o3noj,SpATywNh6bZuzm8s1ceuBUnMUAeoAHHw,13,21,3,0,3,0,4,0,31,4.428571428571429,4,0.0,0,3,0,3,21,0,0,4,0,6,25,1
9484,135377,ZfIQYurnR6gJbWxLJ81cU3ZqzX4mpHm0,SpATywNh6bZuzm8s1ceuBUnMUAeoAHHw,30,65,26,21,8,3,13,0,136,19.428571428571427,4,0.0,18,26,16,8,47,3,5,13,0,68,68,0
9485,135390,IGFSjvLtGQCYdnhMcrAQcaIreY53ybWv,bWdj2GDclj5ofokWjzoa5jAwMkxCykd6,50,90,31,139,22,40,22,2,346,49.42857142857143,9,0.0,16,31,117,22,74,40,22,22,2,186,160,0
9486,135396,g5cfvDvYqz1BC4LMGanzPaVPPBmwbapa,SpATywNh6bZuzm8s1ceuBUnMUAeoAHHw,15,12,9,0,6,0,4,0,31,4.428571428571429,3,0.0,0,9,0,6,12,0,0,4,0,15,16,0
9487,135399,46rTxBSjCmRWQay8Ou4hIiZJB66kf2no,RXDvfPUBYFlVdlueBFbLW0mhhAyGEqpt,6,1,1,0,1,0,6,0,9,1.2857142857142858,1,0.0,0,1,0,1,1,0,0,6,0,2,7,1
9488,135412,kdSYbpVWFVGC6Yy5JRVMZRVsatOK3Lvr,SpATywNh6bZuzm8s1ceuBUnMUAeoAHHw,14,8,5,11,3,0,2,0,29,4.142857142857143,1,0.0,2,5,11,3,6,0,0,2,0,21,8,1
9489,135415,HshUJf4SCu4uNEnMGOCihwqMFgpruX2A,bWdj2GDclj5ofokWjzoa5jAwMkxCykd6,13,13,7,20,7,11,4,1,63,9.0,1,0.0,3,7,17,7,10,11,3,4,1,34,29,0
9490,135418,OdctoiqHnsBGK57e7GpH3g9wz0WU5g5f,SpATywNh6bZuzm8s1ceuBUnMUAeoAHHw,1,0,0,0,0,0,1,0,1,0.14285714285714285,1,0.0,0,0,0,0,0,0,0,1,0,0,1,1
9491,135420,58eQNUjs318sjON50Y8nkDIw70NM1q5r,SpATywNh6bZuzm8s1ceuBUnMUAeoAHHw,15,24,0,17,0,1,6,0,48,6.857142857142857,3,0.0,12,0,14,0,12,1,3,6,0,26,22,1
9492,135425,LoyL1dLg21zF03lUMGts7AHY1XLphBvU,SpATywNh6bZuzm8s1ceuBUnMUAeoAHHw,30,54,17,29,10,1,11,1,123,17.571428571428573,4,0.0,16,17,27,10,38,1,2,11,1,70,53,1
9493,135428,yNBmodc8EXXXXDprMuN3jSh3qPXFcpn8,bWdj2GDclj5ofokWjzoa5jAwMkxCykd6,3,5,1,0,0,0,1,0,7,1.0,1,0.0,0,1,0,0,5,0,0,1,0,1,6,1
9494,135442,x6BtQH70uuLHaxqzHA21U9wmfT0SxzD9,RXDvfPUBYFlVdlueBFbLW0mhhAyGEqpt,10,17,1,0,1,2,13,1,35,5.0,4,0.0,0,1,0,1,17,2,0,13,1,2,33,1
9495,135447,ivxBGUbA7UT7tzED0gKK31cJU8Lv97zd,A3fsA9Zfv1X2fVEQhTw51lKENdNrEqT3,6,5,1,0,1,0,3,1,11,1.5714285714285714,1,0.0,0,1,0,1,5,0,0,3,1,2,9,1
9496,135458,l3gXcoEEAi47BjXtnIC98tO9tYDIMoBh,SpATywNh6bZuzm8s1ceuBUnMUAeoAHHw,1,0,0,0,0,0,1,0,1,0.14285714285714285,1,0.0,0,0,0,0,0,0,0,1,0,0,1,1
9497,135459,EXZ81qqSldwR1xdBEwBZ7wmgbTHF86sl,bWdj2GDclj5ofokWjzoa5jAwMkxCykd6,43,93,55,159,36,24,12,3,382,54.57142857142857,4,0.0,16,55,133,36,77,24,26,12,3,240,142,0
9498,135464,LpEtIb2L9alLwOQca0Li1HTQlgRpqszP,SpATywNh6bZuzm8s1ceuBUnMUAeoAHHw,5,2,1,0,1,0,2,0,6,0.8571428571428571,1,0.0,0,1,0,1,2,0,0,2,0,2,4,0
9499,135482,AbI9GGAE5Qd4SVmAdr7BeGuvfhPX7Wtw,SpATywNh6bZuzm8s1ceuBUnMUAeoAHHw,9,9,0,6,1,0,2,0,18,2.5714285714285716,1,0.0,0,0,5,1,9,0,1,2,0,6,12,1
9500,135484,gPVsxFydsCsfu82yACdpzeHHS3WY2N6x,SpATywNh6bZuzm8s1ceuBUnMUAeoAHHw,5,2,1,0,1,0,2,0,6,0.8571428571428571,1,0.0,0,1,0,1,2,0,0,2,0,2,4,1
9501,135499,MgBJbfRXH0QNEJmIiGY28SpmFvbhxSoF,A3fsA9Zfv1X2fVEQhTw51lKENdNrEqT3,4,2,1,0,0,5,2,0,10,1.4285714285714286,1,0.0,0,1,0,0,2,5,0,2,0,1,9,1
9502,135507,irZDaKqT4KdxcZGgiOHoDpvTtZyUugWP,A3fsA9Zfv1X2fVEQhTw51lKENdNrEqT3,21,11,5,60,2,0,4,0,82,11.714285714285714,2,0.0,0,5,49,2,11,0,11,4,0,56,26,1
9503,135529,ibuUKEEpKQv3Ka1yViFkKH0Ap8k9qs3g,SpATywNh6bZuzm8s1ceuBUnMUAeoAHHw,3,4,0,0,0,0,1,0,5,0.7142857142857143,1,0.0,0,0,0,0,4,0,0,1,0,0,5,1
9504,135533,oM7zTsGBhypmiyvXB06I1GE7QqwfEoSV,SpATywNh6bZuzm8s1ceuBUnMUAeoAHHw,1,0,0,0,0,0,1,0,1,0.14285714285714285,1,0.0,0,0,0,0,0,0,0,1,0,0,1,1
9505,135535,oM7zTsGBhypmiyvXB06I1GE7QqwfEoSV,bWdj2GDclj5ofokWjzoa5jAwMkxCykd6,1,0,0,0,0,0,1,0,1,0.14285714285714285,1,0.0,0,0,0,0,0,0,0,1,0,0,1,1
9506,135536,oM7zTsGBhypmiyvXB06I1GE7QqwfEoSV,A3fsA9Zfv1X2fVEQhTw51lKENdNrEqT3,2,0,0,0,0,0,3,0,3,0.42857142857142855,1,0.0,0,0,0,0,0,0,0,3,0,0,3,1
9507,135547,XuaSoIyzQwXQTlS6fvGcmzTRqL1S8Nnj,A3fsA9Zfv1X2fVEQhTw51lKENdNrEqT3,6,4,0,0,0,0,7,0,11,1.5714285714285714,1,0.0,0,0,0,0,4,0,0,7,0,0,11,1
9508,135552,oaQkoDjpR1FzyXXhOzFvMONGKXrM2zS0,SpATywNh6bZuzm8s1ceuBUnMUAeoAHHw,6,3,1,0,1,0,2,0,7,1.0,1,0.0,0,1,0,1,3,0,0,2,0,2,5,1
9509,135553,HQ9RppyfbU41Pv363qQe8zqkh0OzGsvv,SpATywNh6bZuzm8s1ceuBUnMUAeoAHHw,17,12,8,14,4,0,3,0,41,5.857142857142857,2,0.0,2,8,13,4,10,0,1,3,0,27,14,1
9510,135554,nrNRU1bochGfgxXZNdc89zA9KtJYIKVZ,SpATywNh6bZuzm8s1ceuBUnMUAeoAHHw,24,37,23,8,14,0,8,0,90,12.857142857142858,4,0.0,7,23,8,14,30,0,0,8,0,52,38,0
9511,135560,p7o6CUVxTvhF5zDZdbTejHoySKfqycmC,A3fsA9Zfv1X2fVEQhTw51lKENdNrEqT3,7,5,3,0,1,0,3,0,12,1.7142857142857142,2,0.0,0,3,0,1,5,0,0,3,0,4,8,1
9512,135566,vycvLwIlVlbz3tEwZzvFj0YINSM3Ga0S,A3fsA9Zfv1X2fVEQhTw51lKENdNrEqT3,2,0,0,0,0,0,5,0,5,0.7142857142857143,1,0.0,0,0,0,0,0,0,0,5,0,0,5,1
9513,135570,JoLD64z5yUuFbScCfKMnv8dODXOTXhRU,RXDvfPUBYFlVdlueBFbLW0mhhAyGEqpt,51,54,3,91,7,5,9,3,172,24.571428571428573,4,0.0,15,3,84,7,39,5,7,9,3,109,63,1
9514,135590,VYMfm0tgVS6x4Eosz9NPpRPYpCrgFsMy,RXDvfPUBYFlVdlueBFbLW0mhhAyGEqpt,63,53,32,173,13,13,11,0,295,42.142857142857146,4,0.0,14,32,157,13,39,13,16,11,0,216,79,0
9515,135613,8lCrBaMkcXk8KsL7M8AYgjnsyFuSP4yK,SpATywNh6bZuzm8s1ceuBUnMUAeoAHHw,17,17,8,13,4,6,8,1,57,8.142857142857142,5,0.0,4,8,11,4,13,6,2,8,1,27,30,0
9516,135614,jWsLxS98Uf5iPgurn9PRvQM3beT2rSkF,RXDvfPUBYFlVdlueBFbLW0mhhAyGEqpt,8,5,4,0,2,0,1,0,12,1.7142857142857142,1,0.0,0,4,0,2,5,0,0,1,0,6,6,1
9517,135619,dmVv4oc5Gy8IXIoX1c6y61vCY7ZjC5c1,SpATywNh6bZuzm8s1ceuBUnMUAeoAHHw,29,45,21,12,6,7,19,0,110,15.714285714285714,7,0.0,7,21,12,6,38,7,0,19,0,46,64,1
9518,135624,MwZAtUJAIGUF9YvAxz812Aiz5L37mA7l,A3fsA9Zfv1X2fVEQhTw51lKENdNrEqT3,8,3,0,0,0,0,9,1,13,1.8571428571428572,1,0.0,0,0,0,0,3,0,0,9,1,0,13,1
9519,135627,p8PDk7PIRcdv8OilLQ1EB9K2d3Uc8Sea,SpATywNh6bZuzm8s1ceuBUnMUAeoAHHw,21,38,19,0,8,0,9,0,74,10.571428571428571,6,0.0,9,19,0,8,29,0,0,9,0,36,38,1
9520,135651,8E88mVxxHiSEV3ReMbiLkIuYAxJ6YXeO,A3fsA9Zfv1X2fVEQhTw51lKENdNrEqT3,12,18,12,0,3,0,7,0,40,5.714285714285714,4,0.0,0,12,0,3,18,0,0,7,0,15,25,0
9521,135653,ZtI7VkDL2OGaTLjYGXUs2OJh9j1CJRBG,A3fsA9Zfv1X2fVEQhTw51lKENdNrEqT3,1,0,0,0,0,0,1,0,1,0.14285714285714285,1,0.0,0,0,0,0,0,0,0,1,0,0,1,1
9522,135660,700mBNy8Tl4Vnb1y2ttxNbwsqHUl4IAM,RXDvfPUBYFlVdlueBFbLW0mhhAyGEqpt,2,0,0,0,0,0,3,0,3,0.42857142857142855,2,0.0,0,0,0,0,0,0,0,3,0,0,3,0
9523,135683,tK1ujwYOutLxYQ1M2MwQkyt3NUvkvmdS,SpATywNh6bZuzm8s1ceuBUnMUAeoAHHw,7,3,2,0,2,0,2,0,9,1.2857142857142858,1,0.0,0,2,0,2,3,0,0,2,0,4,5,1
9524,135687,txe41Ukj2eG7YicOJ2zPZM0lmaXGVXJ2,bWdj2GDclj5ofokWjzoa5jAwMkxCykd6,2,0,0,0,0,0,3,0,3,0.42857142857142855,1,0.0,0,0,0,0,0,0,0,3,0,0,3,1
9525,135692,txe41Ukj2eG7YicOJ2zPZM0lmaXGVXJ2,A3fsA9Zfv1X2fVEQhTw51lKENdNrEqT3,1,0,0,0,0,0,2,0,2,0.2857142857142857,1,0.0,0,0,0,0,0,0,0,2,0,0,2,1
9526,135701,0JlJQUp9pPJEAtzsQAEQWYAKuWMKB5Wj,SpATywNh6bZuzm8s1ceuBUnMUAeoAHHw,1,0,0,0,0,0,1,0,1,0.14285714285714285,1,0.0,0,0,0,0,0,0,0,1,0,0,1,1
9527,135703,1i94xoT1OVM1lTP3R294JlD5odSrEcP5,SpATywNh6bZuzm8s1ceuBUnMUAeoAHHw,16,34,0,0,0,3,10,1,48,6.857142857142857,5,0.0,7,0,0,0,27,3,0,10,1,7,41,1
9528,135709,EvNxwwShcQXgwZllGhuS7z5fGOL08A9A,SpATywNh6bZuzm8s1ceuBUnMUAeoAHHw,29,118,52,16,17,24,43,7,277,39.57142857142857,11,0.0,18,52,15,17,100,24,1,43,7,102,175,0
9529,135710,W1eC8dDo2Br41T5aJYgOhKyFK29UHKkl,bWdj2GDclj5ofokWjzoa5jAwMkxCykd6,1,0,0,0,0,0,1,0,1,0.14285714285714285,1,0.0,0,0,0,0,0,0,0,1,0,0,1,1
9530,135713,uw4petWia8mRNE3kHXaUdR4MrfrMeMii,SpATywNh6bZuzm8s1ceuBUnMUAeoAHHw,15,23,12,0,6,0,4,0,45,6.428571428571429,4,0.0,3,12,0,6,20,0,0,4,0,21,24,0
9531,135718,P3c6lZK14dvErTUVPURdGKdrWTycrHyk,SpATywNh6bZuzm8s1ceuBUnMUAeoAHHw,8,5,2,0,2,0,3,0,12,1.7142857142857142,1,0.0,0,2,0,2,5,0,0,3,0,4,8,1
9532,135730,H8XaU1gbefHT7MZ45ya2B80ofczKeIUJ,bWdj2GDclj5ofokWjzoa5jAwMkxCykd6,37,57,31,136,13,26,42,1,306,43.714285714285715,6,0.0,11,31,124,13,46,26,12,42,1,179,127,0
9533,135731,NBdBSIIhFodg28Tlkf7g5CN58dT0AVfw,A3fsA9Zfv1X2fVEQhTw51lKENdNrEqT3,5,1,1,0,0,6,11,0,19,2.7142857142857144,3,0.0,0,1,0,0,1,6,0,11,0,1,18,1
9534,135750,S9HR7eC8Gw4zo138FI1zxgIn4ZjLPEI1,RXDvfPUBYFlVdlueBFbLW0mhhAyGEqpt,2,0,0,0,0,0,5,0,5,0.7142857142857143,1,0.0,0,0,0,0,0,0,0,5,0,0,5,1
9535,135760,S9HR7eC8Gw4zo138FI1zxgIn4ZjLPEI1,SpATywNh6bZuzm8s1ceuBUnMUAeoAHHw,1,0,0,0,0,0,1,0,1,0.14285714285714285,1,0.0,0,0,0,0,0,0,0,1,0,0,1,1
9536,135772,B5AczbKF5ZPxp6QPkgM4LlavowE2gAlY,bWdj2GDclj5ofokWjzoa5jAwMkxCykd6,1,0,0,0,0,0,1,0,1,0.14285714285714285,1,0.0,0,0,0,0,0,0,0,1,0,0,1,1
9537,135789,PCI2iKpgTMjPS1xfOSmpWNe7sqLAlttf,G8EPVSXsOYB5YQWZGiz1aVq5Pgr2GrQu,1,0,0,0,0,0,1,0,1,0.14285714285714285,1,0.0,0,0,0,0,0,0,0,1,0,0,1,1
9538,135794,FpBG6AfbqT8rtlNKLvRAodERdOKPGQfD,A3fsA9Zfv1X2fVEQhTw51lKENdNrEqT3,7,3,2,0,2,0,2,0,9,1.2857142857142858,1,0.0,0,2,0,2,3,0,0,2,0,4,5,1
9539,135795,CAnNKDdlHhDJqz95kWpWwBuKgmoUwH3k,RXDvfPUBYFlVdlueBFbLW0mhhAyGEqpt,5,2,1,0,1,0,2,0,6,0.8571428571428571,1,0.0,0,1,0,1,2,0,0,2,0,2,4,1
9540,135813,E4hjF5LL5g3DmDyETJzEmj6OhjarBopN,A3fsA9Zfv1X2fVEQhTw51lKENdNrEqT3,7,3,1,0,0,1,11,1,17,2.4285714285714284,2,0.0,0,1,0,0,3,1,0,11,1,1,16,1
9541,135826,ETvKJXrBLwN7msxC91B5PIQrzaf0kAW1,A3fsA9Zfv1X2fVEQhTw51lKENdNrEqT3,1,0,0,0,0,0,1,0,1,0.14285714285714285,1,0.0,0,0,0,0,0,0,0,1,0,0,1,1
9542,135829,iyNW22GLVn7ltcBOUiQmam3mjjq9r9cL,A3fsA9Zfv1X2fVEQhTw51lKENdNrEqT3,7,7,1,0,1,0,3,0,12,1.7142857142857142,3,0.0,0,1,0,1,7,0,0,3,0,2,10,1
9543,135840,Pk1zvEWPdVckXHLEawuIZZjckq66QamN,A3fsA9Zfv1X2fVEQhTw51lKENdNrEqT3,12,12,3,0,1,0,16,1,33,4.714285714285714,2,0.0,0,3,0,1,12,0,0,16,1,4,29,1
9544,135843,QGuKTIBC2KLaYpPdOnB4nXCWgxMM1Dog,bWdj2GDclj5ofokWjzoa5jAwMkxCykd6,24,62,31,38,16,0,13,0,160,22.857142857142858,6,0.0,10,31,32,16,52,0,6,13,0,89,71,0
9545,135862,vVomSgkHkyw3sqrRqYKc3zE1eWaa2d4G,A3fsA9Zfv1X2fVEQhTw51lKENdNrEqT3,29,7,3,52,1,30,34,1,128,18.285714285714285,1,0.0,3,3,51,1,4,30,1,34,1,58,70,0
9546,135882,tTG3Ne3P3A1gAXhNVMiXz0Ee3ILsYPsk,7GRhBDsirIGkRZBtSMEzNTyDr2JQm4xx,1,0,0,0,0,0,1,0,1,0.14285714285714285,1,0.0,0,0,0,0,0,0,0,1,0,0,1,1
9547,135909,s1vgWbMezqTHWPlvrms0WJFKvZbaN3cw,7GRhBDsirIGkRZBtSMEzNTyDr2JQm4xx,22,24,13,16,7,3,6,0,69,9.857142857142858,3,0.0,5,13,13,7,19,3,3,6,0,38,31,1
9548,135962,sd2HYLRck3MQjoR7Fod62oDtNeNgK3C5,A3fsA9Zfv1X2fVEQhTw51lKENdNrEqT3,14,17,12,0,9,0,7,0,45,6.428571428571429,2,0.0,1,12,0,9,16,0,0,7,0,22,23,1
9549,135969,QiJcxNGmLOdmB6eeGiBPeeCTz8AUKVVD,A3fsA9Zfv1X2fVEQhTw51lKENdNrEqT3,5,3,1,0,1,1,1,0,7,1.0,1,0.0,0,1,0,1,3,1,0,1,0,2,5,1
9550,136004,XpLwBNjV7lkbo9HRLwBFqy6jHSpPfym2,SpATywNh6bZuzm8s1ceuBUnMUAeoAHHw,12,9,6,2,3,0,4,0,24,3.4285714285714284,3,0.0,0,6,2,3,9,0,0,4,0,11,13,0
9551,136010,7bBbNS8igBUmtAlhgWeyPaLpz7A08m0l,7GRhBDsirIGkRZBtSMEzNTyDr2JQm4xx,23,43,18,35,16,2,3,0,117,16.714285714285715,2,0.0,21,18,31,16,22,2,4,3,0,86,31,1
9552,136060,K6gZA7sjhdZCSz3L5n4Avap9MqiCE3Mp,7GRhBDsirIGkRZBtSMEzNTyDr2JQm4xx,1,0,0,0,0,0,1,0,1,0.14285714285714285,1,0.0,0,0,0,0,0,0,0,1,0,0,1,1
9553,136085,ISRJxWtuG9U7GF6GcMl2UZgUHAWLyOgM,A3fsA9Zfv1X2fVEQhTw51lKENdNrEqT3,7,3,2,0,2,4,4,0,15,2.142857142857143,2,0.0,0,2,0,2,3,4,0,4,0,4,11,0
9554,136090,1ml1ZIUtZXpkL0JmFSahYiWnT7jKIk9A,7GRhBDsirIGkRZBtSMEzNTyDr2JQm4xx,35,100,41,64,23,28,14,4,274,39.142857142857146,4,0.0,49,41,58,23,51,28,6,14,4,171,103,1
9555,136150,7aQ6rvmUrAZhXOumaP4VW6FvjX4qSmMG,SpATywNh6bZuzm8s1ceuBUnMUAeoAHHw,26,21,14,14,7,4,2,0,62,8.857142857142858,1,0.0,6,14,14,7,15,4,0,2,0,41,21,1
9556,136153,UTOVD7URrJRdTcIox1GiNWQleZgjmsMx,SpATywNh6bZuzm8s1ceuBUnMUAeoAHHw,12,34,15,0,6,2,6,0,63,9.0,2,0.0,4,15,0,6,30,2,0,6,0,25,38,0
9557,136155,GgCLl5NjwqMgkh5JCvkbSguhpqbBPXLG,7GRhBDsirIGkRZBtSMEzNTyDr2JQm4xx,18,29,1,12,4,1,7,0,54,7.714285714285714,3,0.0,11,1,10,4,18,1,2,7,0,26,28,1
9558,136220,kJR7SORW78mX9yl9TvMAdIrYcwnnZz4r,7GRhBDsirIGkRZBtSMEzNTyDr2JQm4xx,27,62,30,28,11,0,6,0,137,19.571428571428573,4,0.0,28,30,28,11,34,0,0,6,0,97,40,1
9559,136257,8uSQsFhnhoJeSVZylwMfyqKR37MO9Qyr,SpATywNh6bZuzm8s1ceuBUnMUAeoAHHw,15,17,7,26,1,6,10,0,67,9.571428571428571,4,0.0,4,7,25,1,13,6,1,10,0,37,30,0
9560,136275,khelYX1bk51SSadsVaUzKR0zRRNCX0tK,7GRhBDsirIGkRZBtSMEzNTyDr2JQm4xx,37,99,36,121,1,0,21,1,279,39.857142857142854,5,0.0,49,36,109,1,50,0,12,21,1,195,84,1
9561,136280,1pbL8yRf5isuKA2AbZrt88AKZzNS9VL8,SpATywNh6bZuzm8s1ceuBUnMUAeoAHHw,5,4,3,0,3,0,3,0,13,1.8571428571428572,2,0.0,0,3,0,3,4,0,0,3,0,6,7,1
9562,136282,no2ug7TKVsupL4LU2a5jY2GhYHkskTdw,SpATywNh6bZuzm8s1ceuBUnMUAeoAHHw,27,38,24,18,12,1,9,0,102,14.571428571428571,5,0.0,7,24,17,12,31,1,1,9,0,60,42,0
9563,136299,4R8cjmGXnx8F1dFD5UPDPTI5U03hvnfJ,G8EPVSXsOYB5YQWZGiz1aVq5Pgr2GrQu,9,4,3,0,3,0,4,1,15,2.142857142857143,1,0.0,0,3,0,3,4,0,0,4,1,6,9,1
9564,136368,3RPGU51kghTa1yQ8sk1JkQkDTlLpjaeu,A3fsA9Zfv1X2fVEQhTw51lKENdNrEqT3,34,23,2,64,1,0,5,0,95,13.571428571428571,2,0.0,3,2,50,1,20,0,14,5,0,56,39,1
9565,136386,FM7LvWy0SQdmiC09CRsUT44n0BqWWa2S,SpATywNh6bZuzm8s1ceuBUnMUAeoAHHw,15,74,19,0,14,0,12,0,119,17.0,7,0.0,0,19,0,14,74,0,0,12,0,33,86,0
9566,136410,4veNYFa5yTlgZEZ3CkxGfwseJV8Djm6t,bWdj2GDclj5ofokWjzoa5jAwMkxCykd6,7,4,0,0,0,0,8,0,12,1.7142857142857142,1,0.0,0,0,0,0,4,0,0,8,0,0,12,1
9567,136411,AUmfgp7YjPBzDSEEKYtmp5NT1ZaUbwCu,A3fsA9Zfv1X2fVEQhTw51lKENdNrEqT3,72,40,29,148,18,18,13,2,268,38.285714285714285,1,0.0,4,29,128,18,36,18,20,13,2,179,89,0
9568,136421,hB4yTUnQMne1LtjUUKgpcnhj6jq7S5Co,SpATywNh6bZuzm8s1ceuBUnMUAeoAHHw,30,36,20,18,10,1,12,0,97,13.857142857142858,3,0.0,11,20,17,10,25,1,1,12,0,58,39,0
9569,136442,TOTNiRasgzo7kH1hlyiehLV3DbzVA61v,7GRhBDsirIGkRZBtSMEzNTyDr2JQm4xx,56,81,20,104,25,56,25,0,311,44.42857142857143,5,0.0,56,20,87,25,25,56,17,25,0,188,123,1
9570,136447,ecut1h0rhjLzcs1jrL1hILYqwNtlJCKC,7GRhBDsirIGkRZBtSMEzNTyDr2JQm4xx,59,176,55,100,27,16,17,1,392,56.0,6,0.0,62,55,95,27,114,16,5,17,1,239,153,1
9571,136460,66UIy9DsqvecX9deVURN28A6eUmaxM2O,7GRhBDsirIGkRZBtSMEzNTyDr2JQm4xx,7,3,1,0,1,2,8,0,15,2.142857142857143,2,0.0,0,1,0,1,3,2,0,8,0,2,13,1
9572,136491,NcracMTfiaTPMbO6SSDnt9CDc4SnvBs9,7GRhBDsirIGkRZBtSMEzNTyDr2JQm4xx,12,29,7,0,7,0,2,0,45,6.428571428571429,1,0.0,21,7,0,7,8,0,0,2,0,35,10,1
9573,136495,EbKjJZq8GOECUxJBvCCbIZN8O8RweU4z,A3fsA9Zfv1X2fVEQhTw51lKENdNrEqT3,5,2,1,0,1,0,2,0,6,0.8571428571428571,1,0.0,0,1,0,1,2,0,0,2,0,2,4,1
9574,136513,hZR4MwcYec4g0GoOyJFngJGEyWOySpv2,bWdj2GDclj5ofokWjzoa5jAwMkxCykd6,9,10,7,0,2,5,9,0,33,4.714285714285714,2,0.0,1,7,0,2,9,5,0,9,0,10,23,0
9575,136514,ODBJIDcvWCzkG2XoiGFYE0mdoqG7tfRb,7GRhBDsirIGkRZBtSMEzNTyDr2JQm4xx,2,0,0,0,0,0,2,0,2,0.2857142857142857,1,0.0,0,0,0,0,0,0,0,2,0,0,2,1
9576,136521,i15PHia6n9agkYRoEhdWcUwrhqvX8pmC,7GRhBDsirIGkRZBtSMEzNTyDr2JQm4xx,1,0,0,0,0,0,1,0,1,0.14285714285714285,1,0.0,0,0,0,0,0,0,0,1,0,0,1,1
9577,136529,jia7n6yiGa4HNwul2FwX7WuWnOCMgFMl,7GRhBDsirIGkRZBtSMEzNTyDr2JQm4xx,21,39,10,21,6,5,1,0,82,11.714285714285714,1,0.0,27,10,21,6,12,5,0,1,0,64,18,1
9578,136530,hZR4MwcYec4g0GoOyJFngJGEyWOySpv2,G8EPVSXsOYB5YQWZGiz1aVq5Pgr2GrQu,20,30,14,0,9,6,14,0,73,10.428571428571429,2,0.0,9,14,0,9,21,6,0,14,0,32,41,0
9579,136533,ZC5rnhfF0O0RN6wj4xnmSbFJHTipD7b4,7GRhBDsirIGkRZBtSMEzNTyDr2JQm4xx,2,0,0,0,0,0,2,0,2,0.2857142857142857,1,0.0,0,0,0,0,0,0,0,2,0,0,2,1
9580,136558,Cv1aavObJnuABKfipF6OGePzg0BnGPFs,7GRhBDsirIGkRZBtSMEzNTyDr2JQm4xx,8,6,3,4,0,0,4,0,17,2.4285714285714284,1,0.0,3,3,4,0,3,0,0,4,0,10,7,1
9581,136562,UUf7W9nrVz0icOeIhIvztvvypaJKgHhN,SpATywNh6bZuzm8s1ceuBUnMUAeoAHHw,20,24,13,16,3,0,12,0,68,9.714285714285714,6,0.0,4,13,16,3,20,0,0,12,0,36,32,1
9582,136566,wamlK8Nx9pa9kXzI19EF5HF3fhJv3sWN,7GRhBDsirIGkRZBtSMEzNTyDr2JQm4xx,4,2,0,0,0,0,2,0,4,0.5714285714285714,1,0.0,0,0,0,0,2,0,0,2,0,0,4,1
9583,136576,wmN4PPC7Vh1X3pevAvwrqSI7HI55oZD6,A3fsA9Zfv1X2fVEQhTw51lKENdNrEqT3,11,8,6,0,6,0,5,1,26,3.7142857142857144,1,0.0,0,6,0,6,8,0,0,5,1,12,14,1
9584,136586,XvNNzv39b8VqKid0q4fV9ms2wVNAdWks,7GRhBDsirIGkRZBtSMEzNTyDr2JQm4xx,3,3,1,0,0,0,2,0,6,0.8571428571428571,2,0.0,0,1,0,0,3,0,0,2,0,1,5,1
9585,136588,KdKmzuUNmhXxN946vW23lms2nowQCTiW,7GRhBDsirIGkRZBtSMEzNTyDr2JQm4xx,6,0,0,0,0,0,17,2,19,2.7142857142857144,1,0.0,0,0,0,0,0,0,0,17,2,0,19,1
9586,136611,X7TCdJnOYqrDdC7umXZiC7RNUdfK8e7D,7GRhBDsirIGkRZBtSMEzNTyDr2JQm4xx,5,3,1,0,1,0,1,0,6,0.8571428571428571,1,0.0,0,1,0,1,3,0,0,1,0,2,4,1
9587,136615,Cv1aavObJnuABKfipF6OGePzg0BnGPFs,RXDvfPUBYFlVdlueBFbLW0mhhAyGEqpt,51,30,17,75,0,3,13,0,138,19.714285714285715,2,0.0,11,17,75,0,19,3,0,13,0,103,35,1
9588,136641,ndSSvoqRP9UOBqRicNUijfD0pPNDqiTJ,7GRhBDsirIGkRZBtSMEzNTyDr2JQm4xx,70,149,84,83,87,3,36,2,444,63.42857142857143,10,0.0,56,84,78,87,93,3,5,36,2,305,139,0
9589,136658,i6Z64SjIvtG8bIYKBDvv4gEAv5H6yeWe,7GRhBDsirIGkRZBtSMEzNTyDr2JQm4xx,1,0,0,0,0,0,2,0,2,0.2857142857142857,1,0.0,0,0,0,0,0,0,0,2,0,0,2,1
9590,136683,J3FKLxbUlPTor4lyG8lMpHc8oUQEjfcp,RXDvfPUBYFlVdlueBFbLW0mhhAyGEqpt,40,46,30,14,27,8,17,2,144,20.571428571428573,4,0.0,4,30,13,27,42,8,1,17,2,74,70,0
9591,136697,ZbpLZuhcPXDt8MCBlzIEU31Qmn57Ldle,G8EPVSXsOYB5YQWZGiz1aVq5Pgr2GrQu,5,9,4,0,1,0,6,0,20,2.857142857142857,4,0.0,0,4,0,1,9,0,0,6,0,5,15,0
9592,136701,0Vr5nGGnd8VQ31kkuDTufqDyRIq6gvkS,RXDvfPUBYFlVdlueBFbLW0mhhAyGEqpt,45,28,11,68,7,1,5,0,120,17.142857142857142,1,0.0,7,11,68,7,21,1,0,5,0,93,27,1
9593,136709,gx5zIbRkvVmYAkHaGQMR5zm5BpTwVwIe,A3fsA9Zfv1X2fVEQhTw51lKENdNrEqT3,10,6,1,8,0,0,2,0,17,2.4285714285714284,1,0.0,0,1,7,0,6,0,1,2,0,8,9,0
9594,136765,Jpxsd7AQ90urdftfAf3y5kTy6w3x8OIk,7GRhBDsirIGkRZBtSMEzNTyDr2JQm4xx,1,0,0,0,0,0,1,0,1,0.14285714285714285,1,0.0,0,0,0,0,0,0,0,1,0,0,1,1
9595,136798,i8t7Go6rdZ7c7uD9bC7IIvAKxqbWTCzk,7GRhBDsirIGkRZBtSMEzNTyDr2JQm4xx,9,10,3,0,3,0,4,0,20,2.857142857142857,1,0.0,0,3,0,3,10,0,0,4,0,6,14,1
9596,136811,MgBJbfRXH0QNEJmIiGY28SpmFvbhxSoF,7GRhBDsirIGkRZBtSMEzNTyDr2JQm4xx,4,2,0,0,0,1,3,0,6,0.8571428571428571,2,0.0,0,0,0,0,2,1,0,3,0,0,6,1
9597,136845,OmBhuxpgNHza1UgJ4sJoDmhlFXyn8dEO,SpATywNh6bZuzm8s1ceuBUnMUAeoAHHw,26,93,17,37,8,1,23,3,182,26.0,4,0.0,18,17,32,8,75,1,5,23,3,75,107,0
9598,136896,0CZrf1rdgKFCFIVyDqGwyjQ94p1TBewg,SpATywNh6bZuzm8s1ceuBUnMUAeoAHHw,10,9,1,0,1,1,7,1,20,2.857142857142857,1,0.0,1,1,0,1,8,1,0,7,1,3,17,1
9599,136961,Cx9UgN9CA3ZQNCspfULD8FGJJpSFtxJF,bWdj2GDclj5ofokWjzoa5jAwMkxCykd6,36,55,27,104,10,8,15,3,222,31.714285714285715,3,0.0,19,27,96,10,36,8,8,15,3,152,70,0
9600,136994,UaiNqahLufAkWkzNVXpp9zyadIeXFDQ2,7GRhBDsirIGkRZBtSMEzNTyDr2JQm4xx,2,0,0,0,0,0,4,0,4,0.5714285714285714,1,0.0,0,0,0,0,0,0,0,4,0,0,4,1
9601,136997,azSMvYaBlxi8sVQgX0j44wgyxslA1ZOv,bWdj2GDclj5ofokWjzoa5jAwMkxCykd6,4,2,0,0,0,17,6,0,25,3.5714285714285716,1,0.0,0,0,0,0,2,17,0,6,0,0,25,0
9602,137007,1vvo0r6a7F7cnmAi2geIjNYeLW8STOBo,bWdj2GDclj5ofokWjzoa5jAwMkxCykd6,29,43,16,58,0,4,18,3,142,20.285714285714285,2,0.0,13,16,54,0,30,4,4,18,3,83,59,0
9603,137015,C7bvV9WgtivYIxdtA0RvlWoiA6KPa8KB,A3fsA9Zfv1X2fVEQhTw51lKENdNrEqT3,6,6,1,0,1,0,4,0,12,1.7142857142857142,2,0.0,0,1,0,1,6,0,0,4,0,2,10,1
9604,137018,xwVxmiN6s5Ty9myiVUNDBrV8mOb9D8yx,7GRhBDsirIGkRZBtSMEzNTyDr2JQm4xx,6,13,3,0,1,0,1,0,18,2.5714285714285716,1,0.0,9,3,0,1,4,0,0,1,0,13,5,1
9605,137027,qggUO4B0NhIPqMhJwgIAZM8ZaIbpr9nE,A3fsA9Zfv1X2fVEQhTw51lKENdNrEqT3,99,52,42,180,27,9,26,3,339,48.42857142857143,2,0.0,5,42,167,27,47,9,13,26,3,241,98,0
9606,137066,ysgn6TuMNCSCCc3YWRE4ykee40CF0ytw,SpATywNh6bZuzm8s1ceuBUnMUAeoAHHw,9,9,4,0,2,0,8,1,24,3.4285714285714284,1,0.0,4,4,0,2,5,0,0,8,1,10,14,0
9607,137067,3AKxcSEV1jrslQIrEuinY7HEzBYlVr1w,7GRhBDsirIGkRZBtSMEzNTyDr2JQm4xx,1,0,0,0,0,0,1,0,1,0.14285714285714285,1,0.0,0,0,0,0,0,0,0,1,0,0,1,1
9608,137075,D5GqwXfacfySSvxPJ9v7ORjiX9Oa23f1,A3fsA9Zfv1X2fVEQhTw51lKENdNrEqT3,1,0,0,0,0,0,2,0,2,0.2857142857142857,1,0.0,0,0,0,0,0,0,0,2,0,0,2,1
9609,137106,ysgn6TuMNCSCCc3YWRE4ykee40CF0ytw,G8EPVSXsOYB5YQWZGiz1aVq5Pgr2GrQu,4,0,0,0,0,0,4,1,5,0.7142857142857143,1,0.0,0,0,0,0,0,0,0,4,1,0,5,1
9610,137107,XWnCbgeYVoaeV4iWRMUFAsMH4LdV0YRz,7GRhBDsirIGkRZBtSMEzNTyDr2JQm4xx,19,21,8,20,1,0,8,0,58,8.285714285714286,2,0.0,5,8,18,1,16,0,2,8,0,32,26,1
9611,137117,TXBaUi0GpvXZWCDXsKlkFWTtfaT87UMz,A3fsA9Zfv1X2fVEQhTw51lKENdNrEqT3,7,4,2,0,0,3,5,1,15,2.142857142857143,1,0.0,1,2,0,0,3,3,0,5,1,3,12,1
9612,137120,TXBaUi0GpvXZWCDXsKlkFWTtfaT87UMz,7GRhBDsirIGkRZBtSMEzNTyDr2JQm4xx,1,0,0,0,0,0,1,0,1,0.14285714285714285,1,0.0,0,0,0,0,0,0,0,1,0,0,1,1
9613,137193,PmtrviA6hBub1PH85YXqVyZgghNsuc4g,RXDvfPUBYFlVdlueBFbLW0mhhAyGEqpt,8,8,2,0,1,0,2,0,13,1.8571428571428572,1,0.0,0,2,0,1,8,0,0,2,0,3,10,0
9614,137201,xHyTBb0oAY3Apc4pTvqPrWVv46063zDF,bWdj2GDclj5ofokWjzoa5jAwMkxCykd6,5,0,0,0,0,0,4,1,5,0.7142857142857143,1,0.0,0,0,0,0,0,0,0,4,1,0,5,1
9615,137231,ZSEIlb9ma209LSHLrk2K3oKNlkQui4gF,7GRhBDsirIGkRZBtSMEzNTyDr2JQm4xx,38,55,22,43,16,4,7,0,147,21.0,3,0.0,28,22,38,16,27,4,5,7,0,104,43,1
9616,137244,v8s2hAX8tQgFD6i9MrUt2cuWPYPq3DuN,7GRhBDsirIGkRZBtSMEzNTyDr2JQm4xx,29,69,30,31,19,12,9,0,170,24.285714285714285,8,0.0,30,30,28,19,39,12,3,9,0,107,63,0
9617,137259,jx3H6f2miwKbLN02Gt82PEqx2tCxuPiz,SpATywNh6bZuzm8s1ceuBUnMUAeoAHHw,20,26,9,7,6,5,23,1,77,11.0,5,0.0,4,9,7,6,22,5,0,23,1,26,51,0
9618,137268,qDignCY8ZSbFAHDmfGr6um90qnmxvInL,7GRhBDsirIGkRZBtSMEzNTyDr2JQm4xx,7,5,2,4,2,0,1,0,14,2.0,1,0.0,2,2,3,2,3,0,1,1,0,9,5,1
9619,137277,bAAKqYTvNa29c4TuCorKR61JLnTy6u4P,SpATywNh6bZuzm8s1ceuBUnMUAeoAHHw,1,0,0,0,0,0,1,0,1,0.14285714285714285,1,0.0,0,0,0,0,0,0,0,1,0,0,1,1
9620,137291,zhx9FAttDf9KfTt4QYbmf4kGhKS1JatC,fbPkOYLVPtPgIt0MxizjfFJov3JbHyAi,6,2,0,0,0,8,8,1,19,2.7142857142857144,1,0.0,0,0,0,0,2,8,0,8,1,0,19,1
9621,137293,aJRPciowZ4Uphw6R6OHAqScxIuuZ6bxP,fbPkOYLVPtPgIt0MxizjfFJov3JbHyAi,1,0,0,0,0,0,1,0,1,0.14285714285714285,1,0.0,0,0,0,0,0,0,0,1,0,0,1,0
9622,137294,2AVqf09WA2itMEZz0u7FX3Fi3x3FZzPg,fbPkOYLVPtPgIt0MxizjfFJov3JbHyAi,19,31,15,0,11,5,9,0,71,10.142857142857142,4,0.0,2,15,0,11,29,5,0,9,0,28,43,1
9623,137295,VaoxktacOI8C5q8hn2iIjPvNhrMgUBA1,fbPkOYLVPtPgIt0MxizjfFJov3JbHyAi,1,0,0,0,0,0,1,0,1,0.14285714285714285,1,0.0,0,0,0,0,0,0,0,1,0,0,1,1
9624,137297,YkKsB5X9vnptYYEdKXeE2TLVCO4MMdOc,fbPkOYLVPtPgIt0MxizjfFJov3JbHyAi,6,6,3,0,2,0,3,0,14,2.0,1,0.0,0,3,0,2,6,0,0,3,0,5,9,1
9625,137298,c8WJAdYLV71mOx4ZXSglpCNd0dBUR3Om,fbPkOYLVPtPgIt0MxizjfFJov3JbHyAi,10,8,3,3,2,3,5,0,24,3.4285714285714284,1,0.0,1,3,2,2,7,3,1,5,0,8,16,1
9626,137302,qfe1MUR6a62dAgiCJR4API4cCHsYlsVO,fbPkOYLVPtPgIt0MxizjfFJov3JbHyAi,6,4,3,0,3,0,1,0,11,1.5714285714285714,1,0.0,0,3,0,3,4,0,0,1,0,6,5,1
9627,137303,RUYKIgG46teji8tqIoyMK9d2o6MFKma5,fbPkOYLVPtPgIt0MxizjfFJov3JbHyAi,10,5,3,0,3,0,6,0,17,2.4285714285714284,1,0.0,0,3,0,3,5,0,0,6,0,6,11,1
9628,137305,Z1uIScALT37BtyCtbFy33E9DuvHO2hks,fbPkOYLVPtPgIt0MxizjfFJov3JbHyAi,12,47,8,3,5,2,15,1,81,11.571428571428571,1,0.0,10,8,3,5,37,2,0,15,1,26,55,1
9629,137307,CgQYjUs70RSn4QebA63eL3Qm5MtCUzhj,fbPkOYLVPtPgIt0MxizjfFJov3JbHyAi,6,4,2,0,2,0,1,0,9,1.2857142857142858,1,0.0,1,2,0,2,3,0,0,1,0,5,4,0
9630,137310,3dtK0EXsDFiqPIgXhR4S028y6RGCztxN,fbPkOYLVPtPgIt0MxizjfFJov3JbHyAi,9,6,2,0,3,0,7,0,18,2.5714285714285716,1,0.0,3,2,0,3,3,0,0,7,0,8,10,1
9631,137311,bAltXvR0FBKFy91atPslJEMIb77R3lRC,fbPkOYLVPtPgIt0MxizjfFJov3JbHyAi,5,3,2,0,2,3,6,0,16,2.2857142857142856,2,0.0,0,2,0,2,3,3,0,6,0,4,12,1
9632,137312,yG9o9nU1hVydCMiwULHDO2ptGPwb3jNJ,fbPkOYLVPtPgIt0MxizjfFJov3JbHyAi,10,7,4,0,5,0,6,0,22,3.142857142857143,1,0.0,2,4,0,5,5,0,0,6,0,11,11,1
9633,137314,yQcq1gJWEi9sb58vjqz4cWvz65K4he0Q,fbPkOYLVPtPgIt0MxizjfFJov3JbHyAi,5,2,1,0,1,0,7,0,11,1.5714285714285714,1,0.0,0,1,0,1,2,0,0,7,0,2,9,1
9634,137316,xmbjcbay9FhXPDAWN6ffVRxetrr8jeM4,fbPkOYLVPtPgIt0MxizjfFJov3JbHyAi,16,9,7,0,6,11,14,1,48,6.857142857142857,1,0.0,0,7,0,6,9,11,0,14,1,13,35,1
9635,137317,55wDwHImP2KSV7dhBC7nPdVPLu4YizxX,fbPkOYLVPtPgIt0MxizjfFJov3JbHyAi,5,3,1,0,1,0,6,0,11,1.5714285714285714,1,0.0,0,1,0,1,3,0,0,6,0,2,9,1
9636,137318,5R4vzdx33VN10wY0ny2PCajdeF7dJThU,fbPkOYLVPtPgIt0MxizjfFJov3JbHyAi,5,2,1,0,1,0,3,0,7,1.0,1,0.0,0,1,0,1,2,0,0,3,0,2,5,1
9637,137320,8XstJLDa8agdHppUFVVZbvtgkIjc1hSo,fbPkOYLVPtPgIt0MxizjfFJov3JbHyAi,8,6,3,0,2,3,5,0,19,2.7142857142857144,2,0.0,0,3,0,2,6,3,0,5,0,5,14,1
9638,137322,7YUms5oSq8SOTxahUEH4CgK97RwpzrJL,fbPkOYLVPtPgIt0MxizjfFJov3JbHyAi,1,0,0,0,0,0,1,0,1,0.14285714285714285,1,0.0,0,0,0,0,0,0,0,1,0,0,1,1
9639,137327,4QLYsScyK6MU5AtBG0Whf2A1TPnb1x0x,fbPkOYLVPtPgIt0MxizjfFJov3JbHyAi,4,2,1,0,1,0,1,0,5,0.7142857142857143,1,0.0,0,1,0,1,2,0,0,1,0,2,3,1
9640,137328,DRsh16n3YrIgDiEC23najFM1m1jqkwJO,fbPkOYLVPtPgIt0MxizjfFJov3JbHyAi,5,3,1,0,1,0,1,0,6,0.8571428571428571,1,0.0,0,1,0,1,3,0,0,1,0,2,4,1
9641,137330,VThmvfwuMXDnKChVAYvsJFXoC4zUM0D9,fbPkOYLVPtPgIt0MxizjfFJov3JbHyAi,4,2,1,0,1,0,1,0,5,0.7142857142857143,1,0.0,0,1,0,1,2,0,0,1,0,2,3,1
9642,137333,gctoOufeRjSEdr00xmWUSLYVm7c6Ovl4,fbPkOYLVPtPgIt0MxizjfFJov3JbHyAi,2,0,0,0,0,0,4,0,4,0.5714285714285714,1,0.0,0,0,0,0,0,0,0,4,0,0,4,1
9643,137334,bzOuF27O1YGS02SMyouUKFo24T7mHVXd,fbPkOYLVPtPgIt0MxizjfFJov3JbHyAi,8,6,3,0,4,0,4,0,17,2.4285714285714284,1,0.0,1,3,0,4,5,0,0,4,0,8,9,1
9644,137337,SO9qUKDjuES2bMkck2Ro41uio1RDDMn4,fbPkOYLVPtPgIt0MxizjfFJov3JbHyAi,4,2,0,0,0,0,2,0,4,0.5714285714285714,1,0.0,0,0,0,0,2,0,0,2,0,0,4,1
9645,137338,i1dAtk6qr0Yjyjyw021VWnqB4cTdL0zR,fbPkOYLVPtPgIt0MxizjfFJov3JbHyAi,20,16,11,0,9,12,10,3,61,8.714285714285714,1,0.0,0,11,0,9,16,12,0,10,3,20,41,1
9646,137344,UUY3BPLR7A3Xa6FGsztMCn6xCbxtdCYu,fbPkOYLVPtPgIt0MxizjfFJov3JbHyAi,4,2,1,0,1,0,1,0,5,0.7142857142857143,1,0.0,0,1,0,1,2,0,0,1,0,2,3,1
9647,137346,LhTbpdQPj8McUYLExnN4ONQebEAJlctK,fbPkOYLVPtPgIt0MxizjfFJov3JbHyAi,5,2,1,0,1,0,2,0,6,0.8571428571428571,1,0.0,0,1,0,1,2,0,0,2,0,2,4,1
9648,137347,OilNA0H2OqGoAWakPxAdVr8srp2M8Kk5,fbPkOYLVPtPgIt0MxizjfFJov3JbHyAi,5,2,1,0,1,0,9,0,13,1.8571428571428572,2,0.0,0,1,0,1,2,0,0,9,0,2,11,1
9649,137349,hTAo9KiAJdTi42ZGMp48lMwTSPkKJERF,fbPkOYLVPtPgIt0MxizjfFJov3JbHyAi,2,0,0,0,0,0,4,0,4,0.5714285714285714,1,0.0,0,0,0,0,0,0,0,4,0,0,4,1
9650,137350,LUzWKYsqqChsro86iNB09MI9Og8MojLk,fbPkOYLVPtPgIt0MxizjfFJov3JbHyAi,6,6,2,0,2,0,4,0,14,2.0,1,0.0,3,2,0,2,3,0,0,4,0,7,7,1
9651,137351,wOJGPiHQhntwjEFJywVCc6H0XBUUrn4W,fbPkOYLVPtPgIt0MxizjfFJov3JbHyAi,5,2,1,0,1,0,4,0,8,1.1428571428571428,1,0.0,0,1,0,1,2,0,0,4,0,2,6,1
9652,137352,cuefNHr7cmtAeAOTeZH62xK2M7JgCzzm,fbPkOYLVPtPgIt0MxizjfFJov3JbHyAi,6,3,1,0,1,0,4,0,9,1.2857142857142858,1,0.0,0,1,0,1,3,0,0,4,0,2,7,1
9653,137354,WtDMxixQmy03wB9jEWr2xYQPm36rgbzM,fbPkOYLVPtPgIt0MxizjfFJov3JbHyAi,12,23,4,6,5,0,11,0,49,7.0,2,0.0,9,4,6,5,14,0,0,11,0,24,25,1
9654,137356,ADL0cXowUMs4wyiAOHKMOrtTHu5tmUqi,fbPkOYLVPtPgIt0MxizjfFJov3JbHyAi,5,3,2,0,1,0,3,0,9,1.2857142857142858,1,0.0,0,2,0,1,3,0,0,3,0,3,6,1
9655,137359,tg3C5tAthjtIE6hVso6iXfcLGroduOx8,fbPkOYLVPtPgIt0MxizjfFJov3JbHyAi,6,4,1,0,1,0,3,0,9,1.2857142857142858,1,0.0,0,1,0,1,4,0,0,3,0,2,7,1
9656,137360,NEKO6BLQdSSPIkqL9Q7yxqF7YpsLWJ2i,fbPkOYLVPtPgIt0MxizjfFJov3JbHyAi,7,4,2,0,1,1,8,0,16,2.2857142857142856,1,0.0,0,2,0,1,4,1,0,8,0,3,13,1
9657,137362,6OO2RXg4fKLY0L2CDQWPbDzS9qYFNLhY,fbPkOYLVPtPgIt0MxizjfFJov3JbHyAi,7,2,1,0,1,2,11,1,18,2.5714285714285716,1,0.0,0,1,0,1,2,2,0,11,1,2,16,1
9658,137363,PG5DcX6LvCCrfUIpAzQI5ebaNfLqaT2x,fbPkOYLVPtPgIt0MxizjfFJov3JbHyAi,9,8,4,0,3,19,6,1,41,5.857142857142857,1,0.0,3,4,0,3,5,19,0,6,1,10,31,1
9659,137364,PNltRKReLHuKml6LKXYu0Xf2LLMAke1h,fbPkOYLVPtPgIt0MxizjfFJov3JbHyAi,5,5,0,0,0,0,4,0,9,1.2857142857142858,1,0.0,0,0,0,0,5,0,0,4,0,0,9,1
9660,137365,X285XxvFlCKmuDlV3vzMxZpCu1V9X67P,fbPkOYLVPtPgIt0MxizjfFJov3JbHyAi,7,8,4,0,3,7,1,0,23,3.2857142857142856,1,0.0,2,4,0,3,6,7,0,1,0,9,14,1
9661,137366,0TSJej9rL1Sb8axummfeQPMEkUPlnJtY,fbPkOYLVPtPgIt0MxizjfFJov3JbHyAi,4,2,1,0,1,0,1,0,5,0.7142857142857143,1,0.0,0,1,0,1,2,0,0,1,0,2,3,1
9662,137367,yUbOTxLRPrMBKeEJQgeZAYWE44xjkzqj,fbPkOYLVPtPgIt0MxizjfFJov3JbHyAi,3,0,0,0,0,7,5,0,12,1.7142857142857142,1,0.0,0,0,0,0,0,7,0,5,0,0,12,1
9663,137368,fWcDM7NTKsDIL7vPWRWhQ3HiIwO7ubW6,fbPkOYLVPtPgIt0MxizjfFJov3JbHyAi,5,3,2,0,1,0,4,0,10,1.4285714285714286,1,0.0,0,2,0,1,3,0,0,4,0,3,7,1
9664,137369,llbduCly6ZFemSI4OiW2PWc2ZsNUujfV,fbPkOYLVPtPgIt0MxizjfFJov3JbHyAi,5,2,1,0,1,2,2,0,8,1.1428571428571428,1,0.0,0,1,0,1,2,2,0,2,0,2,6,1
9665,137371,IDAegjDGT88IxffhIlPXozfrAIyenr6d,fbPkOYLVPtPgIt0MxizjfFJov3JbHyAi,9,11,5,0,3,8,16,0,43,6.142857142857143,1,0.0,3,5,0,3,8,8,0,16,0,11,32,0
9666,137374,XnBCBUkc42wLmZebmQm45ZhzN8434GYt,fbPkOYLVPtPgIt0MxizjfFJov3JbHyAi,9,3,2,0,2,1,8,1,17,2.4285714285714284,1,0.0,0,2,0,2,3,1,0,8,1,4,13,1
9667,137376,xudT2FGfOf7lnAynFZztXlYI3LpEGyZP,fbPkOYLVPtPgIt0MxizjfFJov3JbHyAi,6,5,3,0,2,2,7,0,19,2.7142857142857144,1,0.0,0,3,0,2,5,2,0,7,0,5,14,1
9668,137378,1wIqcRX58Bpw6RXvGnbxsc6WbPwWGwXd,fbPkOYLVPtPgIt0MxizjfFJov3JbHyAi,5,7,4,0,2,4,5,0,22,3.142857142857143,3,0.0,0,4,0,2,7,4,0,5,0,6,16,1
9669,137380,yNFkVq3WBH36gbFucxZddTEItgWhR2NG,fbPkOYLVPtPgIt0MxizjfFJov3JbHyAi,7,5,2,0,3,0,2,0,12,1.7142857142857142,1,0.0,2,2,0,3,3,0,0,2,0,7,5,1
9670,137381,XE05vZThEHf17O6FM08AySNf2qZFgNWa,fbPkOYLVPtPgIt0MxizjfFJov3JbHyAi,7,6,3,1,4,0,1,0,15,2.142857142857143,1,0.0,2,3,1,4,4,0,0,1,0,10,5,1
9671,137382,nkm4i9oKKVu0C5FrCnxvTBLSuiaAGdZs,fbPkOYLVPtPgIt0MxizjfFJov3JbHyAi,6,3,2,0,2,0,1,0,8,1.1428571428571428,1,0.0,0,2,0,2,3,0,0,1,0,4,4,1
9672,137385,Cil3ne7R9WaXD5p2VZEmRDvLwX0ITQx4,fbPkOYLVPtPgIt0MxizjfFJov3JbHyAi,5,2,1,0,1,1,3,0,8,1.1428571428571428,1,0.0,0,1,0,1,2,1,0,3,0,2,6,1
9673,137387,KpMidRbqlnB1jsFzzXeXD9SSZ9cT4DEn,fbPkOYLVPtPgIt0MxizjfFJov3JbHyAi,2,0,0,0,0,0,2,0,2,0.2857142857142857,1,0.0,0,0,0,0,0,0,0,2,0,0,2,1
9674,137389,tsTDNHtkzUQqr6Le5CiKzEb1J3ub8XpE,fbPkOYLVPtPgIt0MxizjfFJov3JbHyAi,1,0,0,0,0,0,1,0,1,0.14285714285714285,1,0.0,0,0,0,0,0,0,0,1,0,0,1,1
9675,137390,WGBXR80uiaxU0rQGqPRIQBTLpC89XbJW,fbPkOYLVPtPgIt0MxizjfFJov3JbHyAi,2,0,0,0,0,0,2,0,2,0.2857142857142857,1,0.0,0,0,0,0,0,0,0,2,0,0,2,1
9676,137392,5iWOSqpJMywqKPlLQJ5aQLOawtvw8Iyp,fbPkOYLVPtPgIt0MxizjfFJov3JbHyAi,5,2,1,0,1,0,8,0,12,1.7142857142857142,1,0.0,0,1,0,1,2,0,0,8,0,2,10,1
9677,137393,iRCtUk9qJG1ZNpyYOkrIzRzmwV1jkfTG,fbPkOYLVPtPgIt0MxizjfFJov3JbHyAi,2,0,0,0,0,0,6,0,6,0.8571428571428571,1,0.0,0,0,0,0,0,0,0,6,0,0,6,1
9678,137394,C8zDhaG0vPsQegBtS55u3JZHiYuueFnE,fbPkOYLVPtPgIt0MxizjfFJov3JbHyAi,5,2,1,0,1,0,4,0,8,1.1428571428571428,1,0.0,0,1,0,1,2,0,0,4,0,2,6,1
9679,137395,174L1V9TprbRTHroQ9FWwbu1TqCVlQjk,fbPkOYLVPtPgIt0MxizjfFJov3JbHyAi,5,2,1,0,1,0,2,0,6,0.8571428571428571,1,0.0,0,1,0,1,2,0,0,2,0,2,4,1
9680,137396,mSgxVbbf83kCrpd2JLuv7BfCExmUt2C4,fbPkOYLVPtPgIt0MxizjfFJov3JbHyAi,8,4,2,0,2,2,4,1,15,2.142857142857143,1,0.0,1,2,0,2,3,2,0,4,1,5,10,0
9681,137398,Kc3YlgMAuK3aPMXYbr7Lb1W7MBNaKMiR,fbPkOYLVPtPgIt0MxizjfFJov3JbHyAi,6,3,2,0,2,0,1,0,8,1.1428571428571428,1,0.0,0,2,0,2,3,0,0,1,0,4,4,1
9682,137400,a5h0uXVhrD32xi14HjckmWeHNJHW3EMf,fbPkOYLVPtPgIt0MxizjfFJov3JbHyAi,4,15,2,0,0,0,1,0,18,2.5714285714285716,1,0.0,0,2,0,0,15,0,0,1,0,2,16,1
9683,137401,kQsVPicmVfwF40LR0Bwbh20EXwnKbn92,fbPkOYLVPtPgIt0MxizjfFJov3JbHyAi,18,42,13,9,16,20,17,2,119,17.0,3,0.0,28,13,8,16,14,20,1,17,2,65,54,1
9684,137402,C8KvwWwhKVcH5gZKcH7dQig9dEhWoVOu,fbPkOYLVPtPgIt0MxizjfFJov3JbHyAi,2,0,0,0,0,0,3,0,3,0.42857142857142855,1,0.0,0,0,0,0,0,0,0,3,0,0,3,1
9685,137403,3rZRyyAqQR0LHT7iXSTyhR4wZI7IzOpN,fbPkOYLVPtPgIt0MxizjfFJov3JbHyAi,6,6,2,0,3,0,1,0,12,1.7142857142857142,1,0.0,3,2,0,3,3,0,0,1,0,8,4,1
9686,137404,nOvIog5xbz5ZKA2OUeEwDTOaSy9QOHTT,fbPkOYLVPtPgIt0MxizjfFJov3JbHyAi,8,8,4,0,3,0,12,0,27,3.857142857142857,1,0.0,0,4,0,3,8,0,0,12,0,7,20,1
9687,137409,OD1pqN8En0iNd52vQpaf4DwGLH3W4dof,fbPkOYLVPtPgIt0MxizjfFJov3JbHyAi,9,7,5,0,3,0,3,0,18,2.5714285714285716,2,0.0,0,5,0,3,7,0,0,3,0,8,10,1
9688,137413,uCu7X2FM1qO7UaWcT7yafBpyCKsVxRuo,fbPkOYLVPtPgIt0MxizjfFJov3JbHyAi,7,2,1,0,1,3,6,1,14,2.0,1,0.0,0,1,0,1,2,3,0,6,1,2,12,1
9689,137416,A41hdT15T7mumzDW53QCDXRUsOilvTI0,fbPkOYLVPtPgIt0MxizjfFJov3JbHyAi,30,52,37,0,22,15,12,0,138,19.714285714285715,3,0.0,0,37,0,22,52,15,0,12,0,59,79,0
9690,137419,wCdkG2gdJ13TsTuESZCgsx6c9HoUuD9s,fbPkOYLVPtPgIt0MxizjfFJov3JbHyAi,8,10,4,7,4,0,1,0,26,3.7142857142857144,1,0.0,4,4,6,4,6,0,1,1,0,18,8,1
9691,137422,cH7MXJwZ1B11Byd6oixA8vDtJ38H8Xie,fbPkOYLVPtPgIt0MxizjfFJov3JbHyAi,5,1,1,0,1,0,3,0,6,0.8571428571428571,1,0.0,0,1,0,1,1,0,0,3,0,2,4,1
9692,137423,BEEx400Zym1Adj0LXV9O094DcgDYxMgU,fbPkOYLVPtPgIt0MxizjfFJov3JbHyAi,4,2,1,0,1,0,1,0,5,0.7142857142857143,1,0.0,0,1,0,1,2,0,0,1,0,2,3,1
9693,137424,bqKMJ5OUNpA2Wgq0oxWCoJ7xNwTYKmHM,fbPkOYLVPtPgIt0MxizjfFJov3JbHyAi,12,9,7,0,6,0,1,0,23,3.2857142857142856,1,0.0,0,7,0,6,9,0,0,1,0,13,10,1
9694,137425,X6JW84BYI57qMmiEsexKiPAn78X5H1sY,fbPkOYLVPtPgIt0MxizjfFJov3JbHyAi,3,2,0,0,0,0,1,0,3,0.42857142857142855,1,0.0,0,0,0,0,2,0,0,1,0,0,3,1
9695,137426,45lJHu4OdGTQsQvp0urXXWXHjLHgbztG,fbPkOYLVPtPgIt0MxizjfFJov3JbHyAi,2,0,0,0,0,0,2,0,2,0.2857142857142857,1,0.0,0,0,0,0,0,0,0,2,0,0,2,1
9696,137428,Q7kz14DBsTywLRi7Bx0P7HkElJgTxbaA,fbPkOYLVPtPgIt0MxizjfFJov3JbHyAi,4,3,2,0,0,0,3,0,8,1.1428571428571428,1,0.0,0,2,0,0,3,0,0,3,0,2,6,1
9697,137430,zEaDEiE5fac9Y3NT8JaitlDl9a7ILbFn,fbPkOYLVPtPgIt0MxizjfFJov3JbHyAi,6,1,1,0,1,0,9,0,12,1.7142857142857142,1,0.0,0,1,0,1,1,0,0,9,0,2,10,1
9698,137432,4foS4JAYOnNJdWly53kH9VyAeI8ZpoB9,fbPkOYLVPtPgIt0MxizjfFJov3JbHyAi,8,5,3,0,2,0,4,0,14,2.0,1,0.0,0,3,0,2,5,0,0,4,0,5,9,1
9699,137433,MXpZg6Y3WvwOURUS1VvgXTxhk1pXKVY7,fbPkOYLVPtPgIt0MxizjfFJov3JbHyAi,7,6,2,0,3,3,2,0,16,2.2857142857142856,1,0.0,3,2,0,3,3,3,0,2,0,8,8,1
9700,137435,2kGVAArEEN0LJBurgHk38pEMZThzj1T0,fbPkOYLVPtPgIt0MxizjfFJov3JbHyAi,6,3,2,0,2,0,1,0,8,1.1428571428571428,1,0.0,0,2,0,2,3,0,0,1,0,4,4,1
9701,137436,NOuxSmdis5r1BA64zbAkvC5MyhRcV1wd,fbPkOYLVPtPgIt0MxizjfFJov3JbHyAi,2,0,0,0,0,0,11,0,11,1.5714285714285714,1,0.0,0,0,0,0,0,0,0,11,0,0,11,1
9702,137437,tQSlSaSXXQMbulfRrarng77t6SPsEo7N,fbPkOYLVPtPgIt0MxizjfFJov3JbHyAi,6,7,4,0,5,0,1,0,17,2.4285714285714284,1,0.0,2,4,0,5,5,0,0,1,0,11,6,1
9703,137439,0PoVNnWMSVMNUD7YbDeAnDdYFFtJNZml,fbPkOYLVPtPgIt0MxizjfFJov3JbHyAi,5,2,1,0,1,0,2,0,6,0.8571428571428571,1,0.0,0,1,0,1,2,0,0,2,0,2,4,1
9704,137441,4hHmnOenTXav8CdwQUU4bXbhMHCuz22G,fbPkOYLVPtPgIt0MxizjfFJov3JbHyAi,12,29,5,8,7,3,12,2,66,9.428571428571429,2,0.0,12,5,8,7,17,3,0,12,2,32,34,1
9705,137442,1LtLQwRGDjWRPORAmpPeWuHr93qsG62M,fbPkOYLVPtPgIt0MxizjfFJov3JbHyAi,3,3,0,0,0,4,1,0,8,1.1428571428571428,1,0.0,0,0,0,0,3,4,0,1,0,0,8,1
9706,137444,7J7CDZ99WfuIWgF8UjFLGxW2Gw1ELsrr,fbPkOYLVPtPgIt0MxizjfFJov3JbHyAi,5,3,1,0,1,0,2,0,7,1.0,1,0.0,1,1,0,1,2,0,0,2,0,3,4,1
9707,137445,CuHzzfkniWARJNGhM9Z8TfGkX4QBNw5S,fbPkOYLVPtPgIt0MxizjfFJov3JbHyAi,2,0,0,0,0,0,5,0,5,0.7142857142857143,1,0.0,0,0,0,0,0,0,0,5,0,0,5,1
9708,137447,ucnh7Je2Ujv5K3Q3wjC5gWq40jwh8dv6,fbPkOYLVPtPgIt0MxizjfFJov3JbHyAi,5,8,3,0,1,0,2,0,14,2.0,1,0.0,0,3,0,1,8,0,0,2,0,4,10,1
9709,137448,ELrr1JfnDsWjEvT48HXDtL9YqiQpfZmF,fbPkOYLVPtPgIt0MxizjfFJov3JbHyAi,6,2,1,0,1,0,9,0,13,1.8571428571428572,1,0.0,0,1,0,1,2,0,0,9,0,2,11,1
9710,137450,nGWRzCfLEHu3fioeTp2MrUVqCTeaWKKh,fbPkOYLVPtPgIt0MxizjfFJov3JbHyAi,8,3,2,0,2,1,5,0,13,1.8571428571428572,1,0.0,0,2,0,2,3,1,0,5,0,4,9,1
9711,137452,OyUzOGgEg3D1ADlF5EJGg06nY3QmnkdW,fbPkOYLVPtPgIt0MxizjfFJov3JbHyAi,2,0,0,0,0,0,4,0,4,0.5714285714285714,1,0.0,0,0,0,0,0,0,0,4,0,0,4,1
9712,137454,U324n6nKpAIcARSxYaybih33hdfe43Hg,fbPkOYLVPtPgIt0MxizjfFJov3JbHyAi,1,0,0,0,0,0,1,0,1,0.14285714285714285,1,0.0,0,0,0,0,0,0,0,1,0,0,1,1
9713,137455,LLnSYhSyIZOYJyyJOzJg3NGJiWH34163,fbPkOYLVPtPgIt0MxizjfFJov3JbHyAi,1,0,0,0,0,0,1,0,1,0.14285714285714285,1,0.0,0,0,0,0,0,0,0,1,0,0,1,1
9714,137456,lYv59CqFZ5WNS1LpSdwbwYgAB1AnSa2W,fbPkOYLVPtPgIt0MxizjfFJov3JbHyAi,10,5,3,0,2,4,7,2,23,3.2857142857142856,1,0.0,0,3,0,2,5,4,0,7,2,5,18,1
9715,137457,5hA99qfStHjQqEYR2bkieX1UEObLPtIn,fbPkOYLVPtPgIt0MxizjfFJov3JbHyAi,5,3,0,0,0,0,2,0,5,0.7142857142857143,1,0.0,0,0,0,0,3,0,0,2,0,0,5,1
9716,137458,ccrvrr39fWp2aVbnA3k1bH1sjmwx7FQs,fbPkOYLVPtPgIt0MxizjfFJov3JbHyAi,8,25,2,0,0,0,9,0,36,5.142857142857143,2,0.0,0,2,0,0,25,0,0,9,0,2,34,1
9717,137459,Rr92BzwqUyCtPYHU3DwB1aivajxBRTFz,fbPkOYLVPtPgIt0MxizjfFJov3JbHyAi,4,2,1,0,1,0,1,0,5,0.7142857142857143,1,0.0,0,1,0,1,2,0,0,1,0,2,3,1
9718,138172,jb9pTa916Vn2VeH0D7ExYaf2JyoI9zrO,7GRhBDsirIGkRZBtSMEzNTyDr2JQm4xx,66,131,3,62,21,43,34,1,295,42.142857142857146,4,0.0,59,3,51,21,72,43,11,34,1,134,161,0
9719,138175,mLD9g4ezOv6SvPMWLaj047DaKrptKosJ,7GRhBDsirIGkRZBtSMEzNTyDr2JQm4xx,4,4,3,0,3,1,1,0,12,1.7142857142857142,1,0.0,0,3,0,3,4,1,0,1,0,6,6,1
9720,138199,x29OOChdmJGXK62DnUpwKbwJurqULmnD,7GRhBDsirIGkRZBtSMEzNTyDr2JQm4xx,7,6,2,0,3,0,2,0,13,1.8571428571428572,1,0.0,3,2,0,3,3,0,0,2,0,8,5,0
9721,138201,irIVLRvkXyea4TMdg5wZQ17APoQLOStn,7GRhBDsirIGkRZBtSMEzNTyDr2JQm4xx,5,2,1,0,1,0,2,0,6,0.8571428571428571,1,0.0,0,1,0,1,2,0,0,2,0,2,4,1
9722,138215,RgBHZtppWNmiRr4zn4KqEhMkv6vEscGZ,7GRhBDsirIGkRZBtSMEzNTyDr2JQm4xx,29,41,15,67,14,3,1,0,141,20.142857142857142,1,0.0,24,15,58,14,17,3,9,1,0,111,30,0
9723,138232,MfzRriitP2kzeiTWJO2r85qGclUEFMNK,7GRhBDsirIGkRZBtSMEzNTyDr2JQm4xx,6,3,1,0,1,0,5,0,10,1.4285714285714286,1,0.0,0,1,0,1,3,0,0,5,0,2,8,1
9724,138264,45E6hpwDMHp9Q3Pt1xT8q04bbowKk87g,7GRhBDsirIGkRZBtSMEzNTyDr2JQm4xx,33,92,25,30,22,1,10,0,180,25.714285714285715,2,0.0,63,25,28,22,29,1,2,10,0,138,42,0
9725,138266,pAkhnLI0s5vboktZycO7Tobv6jbspULh,G8EPVSXsOYB5YQWZGiz1aVq5Pgr2GrQu,17,15,8,6,8,0,2,0,39,5.571428571428571,2,0.0,5,8,5,8,10,0,1,2,0,26,13,0
9726,138267,pAkhnLI0s5vboktZycO7Tobv6jbspULh,7GRhBDsirIGkRZBtSMEzNTyDr2JQm4xx,3,2,1,0,0,0,1,0,4,0.5714285714285714,1,0.0,0,1,0,0,2,0,0,1,0,1,3,1
9727,138314,W6AT73CXG4URTyD2I7QWXXVZx4oeh86N,7GRhBDsirIGkRZBtSMEzNTyDr2JQm4xx,16,24,13,0,7,0,11,0,55,7.857142857142857,3,0.0,4,13,0,7,20,0,0,11,0,24,31,1
9728,138319,yq5rHqpCTagxs6XCaAXxmCSySzn2U3u8,SpATywNh6bZuzm8s1ceuBUnMUAeoAHHw,20,22,14,12,10,1,4,0,63,9.0,2,0.0,3,14,9,10,19,1,3,4,0,36,27,1
9729,138324,lVwgv61cg8fkhW9rg5b1PIPnuUWxb0Vk,7GRhBDsirIGkRZBtSMEzNTyDr2JQm4xx,1,0,0,0,0,0,1,0,1,0.14285714285714285,1,0.0,0,0,0,0,0,0,0,1,0,0,1,1
9730,138326,t4tnBhQAPqBnCFRCjzr4Y2gSOW7MaWb7,SpATywNh6bZuzm8s1ceuBUnMUAeoAHHw,5,6,2,0,1,0,4,0,13,1.8571428571428572,3,0.0,0,2,0,1,6,0,0,4,0,3,10,0
9731,138327,yq5rHqpCTagxs6XCaAXxmCSySzn2U3u8,A3fsA9Zfv1X2fVEQhTw51lKENdNrEqT3,43,6,3,146,1,0,6,0,162,23.142857142857142,1,0.0,2,3,119,1,4,0,27,6,0,125,37,1
9732,138338,V8TGMBMhFLQdnr9mQNCNr5CucGxVWBvw,RXDvfPUBYFlVdlueBFbLW0mhhAyGEqpt,8,6,5,0,3,0,1,0,15,2.142857142857143,1,0.0,0,5,0,3,6,0,0,1,0,8,7,1
9733,138346,dd7Jtt1fMMutX1RG7iWTpWNKUpGu8Lqf,SpATywNh6bZuzm8s1ceuBUnMUAeoAHHw,23,52,21,28,0,34,11,3,149,21.285714285714285,1,0.0,15,21,26,0,37,34,2,11,3,62,87,0
9734,138351,drMAzq4nC1GseQmyuPqctPxioPnjLJpD,A3fsA9Zfv1X2fVEQhTw51lKENdNrEqT3,2,0,0,0,0,0,2,0,2,0.2857142857142857,1,0.0,0,0,0,0,0,0,0,2,0,0,2,1
9735,138358,8RGLvfdludl70fdPksu2JYtYCxSVr9FR,SpATywNh6bZuzm8s1ceuBUnMUAeoAHHw,13,17,0,20,0,0,2,0,39,5.571428571428571,1,0.0,2,0,16,0,15,0,4,2,0,18,21,1
9736,138367,KAW52VBDXCvurEAry0tITiLWjcxVkV8S,SpATywNh6bZuzm8s1ceuBUnMUAeoAHHw,31,54,24,29,8,63,19,1,198,28.285714285714285,5,0.0,19,24,25,8,35,63,4,19,1,76,122,0
9737,138373,0I055s9vaRQ6PXqeLKyD6l9kPxlReBT2,7GRhBDsirIGkRZBtSMEzNTyDr2JQm4xx,1,0,0,0,0,0,1,0,1,0.14285714285714285,1,0.0,0,0,0,0,0,0,0,1,0,0,1,1
9738,138379,NgtHGelgTuQd8iaakUkaIRT8CwQkRy7Z,SpATywNh6bZuzm8s1ceuBUnMUAeoAHHw,30,27,18,37,10,10,8,1,111,15.857142857142858,1,0.0,5,18,33,10,22,10,4,8,1,66,45,1
9739,138406,73Lo5aiYTeasg8R5eGVwIsechNk0OHx6,SpATywNh6bZuzm8s1ceuBUnMUAeoAHHw,12,6,4,0,3,0,6,0,19,2.7142857142857144,2,0.0,0,4,0,3,6,0,0,6,0,7,12,1
9740,138420,GGf1UPTxgLShqKb7PDIL9hAwpCBcU4fs,SpATywNh6bZuzm8s1ceuBUnMUAeoAHHw,6,3,2,0,2,0,1,0,8,1.1428571428571428,1,0.0,0,2,0,2,3,0,0,1,0,4,4,1
9741,138456,jSWk10JJ0OWajXDG9k2ujEK46fA1leIF,7GRhBDsirIGkRZBtSMEzNTyDr2JQm4xx,2,0,0,0,0,0,2,0,2,0.2857142857142857,1,0.0,0,0,0,0,0,0,0,2,0,0,2,1
9742,138467,LN6esXV3qnIoLg44h6fXbTBvNC9pi5Ym,7GRhBDsirIGkRZBtSMEzNTyDr2JQm4xx,1,0,0,0,0,0,1,0,1,0.14285714285714285,1,0.0,0,0,0,0,0,0,0,1,0,0,1,1
9743,138510,eh4s2O0xG3K7bB3gC9QI2pZbmOHi0FkP,7GRhBDsirIGkRZBtSMEzNTyDr2JQm4xx,6,2,1,0,1,0,3,0,7,1.0,1,0.0,0,1,0,1,2,0,0,3,0,2,5,1
9744,138515,2Vr8sMi8Nmtw7GvPlYj3ww9EzMgjDWh8,SpATywNh6bZuzm8s1ceuBUnMUAeoAHHw,31,154,57,27,13,19,28,3,301,43.0,5,0.0,46,57,26,13,108,19,1,28,3,142,159,0
9745,138523,BhCvmy8WtOEti83wDjK9xOLWP4oCctij,RXDvfPUBYFlVdlueBFbLW0mhhAyGEqpt,19,29,1,34,2,2,4,0,72,10.285714285714286,3,0.0,11,1,32,2,18,2,2,4,0,46,26,1
9746,138534,ilUzpPaeFISeGNY7Nt0DehBLL3wxQX0O,7GRhBDsirIGkRZBtSMEzNTyDr2JQm4xx,9,1,1,0,1,0,8,0,11,1.5714285714285714,1,0.0,0,1,0,1,1,0,0,8,0,2,9,1
9747,138537,e3wyIozlRLlcs7B7d4wJ9CCyj0Cy9HNB,7GRhBDsirIGkRZBtSMEzNTyDr2JQm4xx,7,2,1,0,1,0,4,1,9,1.2857142857142858,1,0.0,0,1,0,1,2,0,0,4,1,2,7,1
9748,138553,okqN4nBVKRYYrkYonKicKGOmPqVGYjZh,SpATywNh6bZuzm8s1ceuBUnMUAeoAHHw,15,34,17,15,6,0,17,0,89,12.714285714285714,5,0.0,3,17,14,6,31,0,1,17,0,40,49,0
9749,138559,WNxlasM9yolV5j0jIrxkqf7jn6zMrkGu,SpATywNh6bZuzm8s1ceuBUnMUAeoAHHw,14,20,5,23,0,2,5,0,55,7.857142857142857,3,0.0,13,5,21,0,7,2,2,5,0,39,16,0
9750,138605,0TwmbDZ9MIyhTy6dnWnLvFIAROrnAMuZ,A3fsA9Zfv1X2fVEQhTw51lKENdNrEqT3,11,9,6,0,4,0,11,0,30,4.285714285714286,1,0.0,1,6,0,4,8,0,0,11,0,11,19,0
9751,138621,dgFOOUSNfQK8xIrT47Av0Q04bBFeE21W,RXDvfPUBYFlVdlueBFbLW0mhhAyGEqpt,1,0,0,0,0,0,1,0,1,0.14285714285714285,1,0.0,0,0,0,0,0,0,0,1,0,0,1,1
9752,138627,QZoi4xpkEVVH2rbYL53oYFfYungIuUup,7GRhBDsirIGkRZBtSMEzNTyDr2JQm4xx,35,42,13,63,11,5,13,3,150,21.428571428571427,2,0.0,24,13,56,11,18,5,7,13,3,104,46,1
9753,138638,fUQHFT4QEMRSPqJAQlXlvlyNwca9Q0dU,7GRhBDsirIGkRZBtSMEzNTyDr2JQm4xx,2,0,0,0,0,0,2,0,2,0.2857142857142857,1,0.0,0,0,0,0,0,0,0,2,0,0,2,1
9754,138692,ixs1CEJxkJS0gIphbPcsPzQNrY8VNX7l,bWdj2GDclj5ofokWjzoa5jAwMkxCykd6,16,23,10,46,9,34,14,2,138,19.714285714285715,2,0.0,8,10,45,9,15,34,1,14,2,72,66,1
9755,138711,2mcFXXl5IuZRP6QuFfHO1XF6KcVjhONf,SpATywNh6bZuzm8s1ceuBUnMUAeoAHHw,11,5,4,8,3,0,2,0,22,3.142857142857143,1,0.0,0,4,6,3,5,0,2,2,0,13,9,0
9756,138716,bWXDTeHwMBrcFvsHEHi16Kcz6vnkKBkc,SpATywNh6bZuzm8s1ceuBUnMUAeoAHHw,2,0,0,0,0,0,3,0,3,0.42857142857142855,1,0.0,0,0,0,0,0,0,0,3,0,0,3,1
9757,138728,kcajSl3XvPJzA8r8jTipqgj4EAGyDqJf,7GRhBDsirIGkRZBtSMEzNTyDr2JQm4xx,15,47,1,16,5,1,3,0,73,10.428571428571429,1,0.0,23,1,14,5,24,1,2,3,0,43,30,1
9758,138731,Za7TsRG0IgcPg4zI5JWLKyABDBTbji9K,7GRhBDsirIGkRZBtSMEzNTyDr2JQm4xx,25,64,2,64,5,0,5,0,140,20.0,3,0.0,33,2,56,5,31,0,8,5,0,96,44,1
9759,138736,Sz9JtbyfGasFOcDw3qsqx6peODd97ECd,7GRhBDsirIGkRZBtSMEzNTyDr2JQm4xx,5,2,1,0,1,0,2,0,6,0.8571428571428571,2,0.0,0,1,0,1,2,0,0,2,0,2,4,1
9760,138808,wZxGcsfZmDyO3eZaMEp8V4Qxwmu1n6lt,A3fsA9Zfv1X2fVEQhTw51lKENdNrEqT3,69,42,31,168,16,17,13,0,287,41.0,4,0.0,4,31,135,16,38,17,33,13,0,186,101,0
9761,138810,KarP5JDxaA55wR1ThEFPoGYFsHmbBCZf,SpATywNh6bZuzm8s1ceuBUnMUAeoAHHw,12,11,4,6,2,0,3,0,26,3.7142857142857144,2,0.0,3,4,6,2,8,0,0,3,0,15,11,1
9762,138873,lLp4bdT6ycggmaUdjHCcgWeQnh0T1b1d,SpATywNh6bZuzm8s1ceuBUnMUAeoAHHw,11,26,10,0,5,0,3,0,44,6.285714285714286,2,0.0,8,10,0,5,18,0,0,3,0,23,21,1
9763,138898,mSs5bB1Rxg3xYWjWjJY9pVTt7WAiMgyu,RXDvfPUBYFlVdlueBFbLW0mhhAyGEqpt,8,9,6,0,1,0,11,0,27,3.857142857142857,1,0.0,0,6,0,1,9,0,0,11,0,7,20,0
9764,138921,SdmxANaN4VeJNVCXABSOs77O0krJ65nl,SpATywNh6bZuzm8s1ceuBUnMUAeoAHHw,31,48,26,35,10,10,20,5,154,22.0,4,0.0,5,26,30,10,43,10,5,20,5,71,83,1
9765,138933,YbQfcgwKrjskWW3wyOzQUUJYzdeHmY82,7GRhBDsirIGkRZBtSMEzNTyDr2JQm4xx,18,37,8,6,9,0,2,0,62,8.857142857142858,1,0.0,18,8,6,9,19,0,0,2,0,41,21,1
9766,138979,9Mbi6CksSOlTvzJd1jV7pzorOP4mmF9E,SpATywNh6bZuzm8s1ceuBUnMUAeoAHHw,21,30,13,6,6,0,11,0,66,9.428571428571429,6,0.0,3,13,5,6,27,0,1,11,0,27,39,0
9767,139001,PLKaanKvHCtHMqtCskLE9sVgrYP9vmXy,SpATywNh6bZuzm8s1ceuBUnMUAeoAHHw,17,34,13,34,1,0,8,1,91,13.0,4,0.0,15,13,30,1,19,0,4,8,1,59,32,0
9768,139009,ucdoEtZyBMBpMuHw7eldMzgNsB5u9NZD,7GRhBDsirIGkRZBtSMEzNTyDr2JQm4xx,2,0,0,0,0,0,2,0,2,0.2857142857142857,1,0.0,0,0,0,0,0,0,0,2,0,0,2,1
9769,139030,nZH2h9tRgS1XihszFT0Gsl3zQK5yTzdn,7GRhBDsirIGkRZBtSMEzNTyDr2JQm4xx,1,0,0,0,0,0,2,0,2,0.2857142857142857,1,0.0,0,0,0,0,0,0,0,2,0,0,2,1
9770,139077,sTlxlEkJ3MbMUAeSajnaHOGfpyW9hgq1,7GRhBDsirIGkRZBtSMEzNTyDr2JQm4xx,4,3,1,0,1,0,1,0,6,0.8571428571428571,1,0.0,0,1,0,1,3,0,0,1,0,2,4,1
9771,139091,FqxZInDGuTXmPgpy2HmrKGvUbRHydqL9,A3fsA9Zfv1X2fVEQhTw51lKENdNrEqT3,43,38,29,72,14,12,10,3,178,25.428571428571427,2,0.0,3,29,59,14,35,12,13,10,3,105,73,1
9772,139097,rJa06nlcyBimvgL7PoPXhuOUbmR9mddR,7GRhBDsirIGkRZBtSMEzNTyDr2JQm4xx,1,0,0,0,0,0,1,0,1,0.14285714285714285,1,0.0,0,0,0,0,0,0,0,1,0,0,1,1
9773,139128,QaUj3eOwCavlOK096M7ra3BPeu9HLHwH,SpATywNh6bZuzm8s1ceuBUnMUAeoAHHw,6,3,1,0,1,0,2,0,7,1.0,1,0.0,0,1,0,1,3,0,0,2,0,2,5,0
9774,139138,pLMdR2T5UiKa0jLlBQ6JAVdYxLS2oAZC,7GRhBDsirIGkRZBtSMEzNTyDr2JQm4xx,9,8,6,0,5,0,3,0,22,3.142857142857143,2,0.0,0,6,0,5,8,0,0,3,0,11,11,1
9775,139165,emLy0wxTS6s6x2ntzW39vmfcR0P0HK07,G8EPVSXsOYB5YQWZGiz1aVq5Pgr2GrQu,6,6,4,0,1,0,2,0,13,1.8571428571428572,2,0.0,0,4,0,1,6,0,0,2,0,5,8,1
9776,139172,vQiAys6oOekX5OV9gzy071CxobZT5OY1,7GRhBDsirIGkRZBtSMEzNTyDr2JQm4xx,1,0,0,0,0,0,1,0,1,0.14285714285714285,1,0.0,0,0,0,0,0,0,0,1,0,0,1,1
9777,139207,RIjNzTzWwuMpVu0vcsF9N8cORAAtLFQn,bWdj2GDclj5ofokWjzoa5jAwMkxCykd6,6,5,1,0,2,0,3,0,11,1.5714285714285714,1,0.0,2,1,0,2,3,0,0,3,0,5,6,1
9778,139217,OOIu03NBEHePUSUIFa86FGFP5M136EAn,RXDvfPUBYFlVdlueBFbLW0mhhAyGEqpt,61,107,40,137,22,12,33,4,355,50.714285714285715,7,0.0,15,40,127,22,92,12,10,33,4,204,151,0
9779,139222,St6usTSSgX5U9v7wchuMWqmBKoCcDwN2,bWdj2GDclj5ofokWjzoa5jAwMkxCykd6,5,4,0,0,0,0,2,0,6,0.8571428571428571,2,0.0,0,0,0,0,4,0,0,2,0,0,6,1
9780,139230,Az3rIdfQyspbBZOuftkV0XmT1mpRRVMU,G8EPVSXsOYB5YQWZGiz1aVq5Pgr2GrQu,10,5,4,0,4,0,2,0,15,2.142857142857143,1,0.0,0,4,0,4,5,0,0,2,0,8,7,1
9781,139246,3nkAYJy31glMu7RttArFOqU7gmkfxNPM,SpATywNh6bZuzm8s1ceuBUnMUAeoAHHw,18,48,9,39,3,0,12,3,114,16.285714285714285,5,0.0,38,9,35,3,10,0,4,12,3,85,29,0
9782,139252,AKVd0gnvEJlgz6OnGwqybMUQOVjHL58y,SpATywNh6bZuzm8s1ceuBUnMUAeoAHHw,25,41,27,35,15,7,10,0,135,19.285714285714285,5,0.0,4,27,31,15,37,7,4,10,0,77,58,0
9783,139262,CQI3ipMoYWvyV7ZuewrTlOYAM3gikvMq,7GRhBDsirIGkRZBtSMEzNTyDr2JQm4xx,14,16,8,4,5,0,5,0,38,5.428571428571429,2,0.0,4,8,4,5,12,0,0,5,0,21,17,1
9784,139270,9W6HDa8nbr3i4rkBKbOa5qCJz73HRO2D,7GRhBDsirIGkRZBtSMEzNTyDr2JQm4xx,18,20,9,25,8,0,4,0,66,9.428571428571429,2,0.0,9,9,21,8,11,0,4,4,0,47,19,1
9785,139322,AAAvWauitKfXD0xRpNsfpOKQu223kCXG,A3fsA9Zfv1X2fVEQhTw51lKENdNrEqT3,13,10,6,0,3,1,4,0,24,3.4285714285714284,1,0.0,1,6,0,3,9,1,0,4,0,10,14,1
9786,139324,hT3A3NhtOhvHOWKsgHNINVDyTB0qBxh1,SpATywNh6bZuzm8s1ceuBUnMUAeoAHHw,20,54,14,31,6,3,11,1,120,17.142857142857142,3,0.0,14,14,27,6,40,3,4,11,1,61,59,0
9787,139331,jIQxdn4syEISmeL05XWgww3FZktzs7MC,SpATywNh6bZuzm8s1ceuBUnMUAeoAHHw,30,48,28,31,8,7,25,0,147,21.0,4,0.0,11,28,28,8,37,7,3,25,0,75,72,0
9788,139332,IAgEmatHzKUXARhFStPcCuJqOEJArzMq,SpATywNh6bZuzm8s1ceuBUnMUAeoAHHw,1,0,0,0,0,0,1,0,1,0.14285714285714285,1,0.0,0,0,0,0,0,0,0,1,0,0,1,0
9789,139342,iO8wfk9CJpGr60f1tg17Yoor3BIrLyLv,bWdj2GDclj5ofokWjzoa5jAwMkxCykd6,2,0,0,0,0,0,3,0,3,0.42857142857142855,1,0.0,0,0,0,0,0,0,0,3,0,0,3,1
9790,139344,h4B8ffuSXL9NZaxc0msh2EYaxC0hStsr,7GRhBDsirIGkRZBtSMEzNTyDr2JQm4xx,5,2,0,0,0,0,3,1,6,0.8571428571428571,1,0.0,0,0,0,0,2,0,0,3,1,0,6,1
9791,139369,aXYyJMDvVYwwKBbiO4CB25XlnDBfWYNg,A3fsA9Zfv1X2fVEQhTw51lKENdNrEqT3,7,4,2,0,1,10,3,0,20,2.857142857142857,1,0.0,1,2,0,1,3,10,0,3,0,4,16,1
9792,139376,wx3mAGKFM6cge9w8piWfsYKppmWVhkYO,7GRhBDsirIGkRZBtSMEzNTyDr2JQm4xx,5,10,2,0,2,0,1,0,15,2.142857142857143,1,0.0,0,2,0,2,10,0,0,1,0,4,11,1
9793,139380,LIoGzJO9iWdcU74H9UnplKXzxcDk8cHj,SpATywNh6bZuzm8s1ceuBUnMUAeoAHHw,10,12,1,12,0,0,1,0,26,3.7142857142857144,1,0.0,4,1,10,0,8,0,2,1,0,15,11,0
9794,139404,fgEJIqkp4SMlTSJ7SAm1OLRW7sHHzj7J,RXDvfPUBYFlVdlueBFbLW0mhhAyGEqpt,8,8,6,0,2,0,5,1,22,3.142857142857143,2,0.0,0,6,0,2,8,0,0,5,1,8,14,0
9795,139428,abzlLtUVw5Pp8kU9DAXNl6SvnA5wbEox,7GRhBDsirIGkRZBtSMEzNTyDr2JQm4xx,1,0,0,0,0,0,2,0,2,0.2857142857142857,1,0.0,0,0,0,0,0,0,0,2,0,0,2,1
9796,139436,YOvd9uht0tZm889aIFQH8jd68xtH7inE,bWdj2GDclj5ofokWjzoa5jAwMkxCykd6,38,68,27,110,7,2,21,0,235,33.57142857142857,7,0.0,18,27,93,7,50,2,17,21,0,145,90,0
9797,139465,zbo9FGjTmUUlBLDkbpFTLQYtMVFawINZ,7GRhBDsirIGkRZBtSMEzNTyDr2JQm4xx,1,0,0,0,0,0,2,0,2,0.2857142857142857,1,0.0,0,0,0,0,0,0,0,2,0,0,2,1
9798,139535,S33lH053HmB7Cz0IWipiL27cwx1QXBWr,SpATywNh6bZuzm8s1ceuBUnMUAeoAHHw,12,17,1,8,0,0,10,0,36,5.142857142857143,2,0.0,4,1,7,0,13,0,1,10,0,12,24,0
9799,139544,G8fLPL9uAaHZvdz6ZdYfgDC2jOIdMG4b,7GRhBDsirIGkRZBtSMEzNTyDr2JQm4xx,1,0,0,0,0,0,1,0,1,0.14285714285714285,1,0.0,0,0,0,0,0,0,0,1,0,0,1,1
9800,139596,7u3azzypzNqPYEFxf0DcbGOgDVhkOXos,7GRhBDsirIGkRZBtSMEzNTyDr2JQm4xx,32,37,8,42,8,4,9,0,108,15.428571428571429,2,0.0,21,8,37,8,16,4,5,9,0,74,34,1
9801,139598,bHMSPD6TpG4I9IyQFzHZ8oywImP9IiZd,7GRhBDsirIGkRZBtSMEzNTyDr2JQm4xx,1,0,0,0,0,0,1,0,1,0.14285714285714285,1,0.0,0,0,0,0,0,0,0,1,0,0,1,1
9802,139666,OiCP77rDGj7m0OeIgoy8NyAC1iklb2Wq,A3fsA9Zfv1X2fVEQhTw51lKENdNrEqT3,3,0,0,0,0,0,3,0,3,0.42857142857142855,1,0.0,0,0,0,0,0,0,0,3,0,0,3,1
9803,139703,MDn3CtIIZuEXDPhMfThc5BfvVlOiIwwt,7GRhBDsirIGkRZBtSMEzNTyDr2JQm4xx,9,7,1,0,0,1,9,1,19,2.7142857142857144,1,0.0,0,1,0,0,7,1,0,9,1,1,18,1
9804,139706,BGq4CkiKFU4S6hRTjQFWEyJE9fTf2RIS,7GRhBDsirIGkRZBtSMEzNTyDr2JQm4xx,2,0,0,0,0,0,2,0,2,0.2857142857142857,1,0.0,0,0,0,0,0,0,0,2,0,0,2,1
9805,139713,n51reZ5FTJkHLnQwBqURrmxGDzwEsEjy,7GRhBDsirIGkRZBtSMEzNTyDr2JQm4xx,4,2,1,0,1,0,1,0,5,0.7142857142857143,1,0.0,0,1,0,1,2,0,0,1,0,2,3,1
9806,140068,dRD1DS5DuggVygcG59W7832HdVYwtgOn,7GRhBDsirIGkRZBtSMEzNTyDr2JQm4xx,7,6,1,0,1,0,7,0,15,2.142857142857143,4,0.0,0,1,0,1,6,0,0,7,0,2,13,1
9807,140129,OEm3RfkF7zW7QGdEGDuqH9AvGYPU4cwb,7GRhBDsirIGkRZBtSMEzNTyDr2JQm4xx,1,0,0,0,0,0,1,0,1,0.14285714285714285,1,0.0,0,0,0,0,0,0,0,1,0,0,1,1
9808,140136,SzHyVEPONSslDMujP3r42FOEaBM1wLth,7GRhBDsirIGkRZBtSMEzNTyDr2JQm4xx,11,9,2,0,1,0,9,2,23,3.2857142857142856,2,0.0,0,2,0,1,9,0,0,9,2,3,20,1
9809,140141,EAibjZcnMEl7Giq03ulFFl7NUllRXm8X,7GRhBDsirIGkRZBtSMEzNTyDr2JQm4xx,1,0,0,0,0,0,2,0,2,0.2857142857142857,2,0.0,0,0,0,0,0,0,0,2,0,0,2,1
9810,140151,KFG6G55toGAeaWBt5UmyioW5n1NVxSjT,7GRhBDsirIGkRZBtSMEzNTyDr2JQm4xx,1,0,0,0,0,0,1,0,1,0.14285714285714285,1,0.0,0,0,0,0,0,0,0,1,0,0,1,1
9811,140155,B0ju9Oei4oSfT1FPNsvUdPiFSJAhjLX7,7GRhBDsirIGkRZBtSMEzNTyDr2JQm4xx,4,2,1,0,0,0,3,0,6,0.8571428571428571,2,0.0,0,1,0,0,2,0,0,3,0,1,5,1
9812,140161,QP61WzTD88M7Z43YJUY0WRxs9mL5DaLN,7GRhBDsirIGkRZBtSMEzNTyDr2JQm4xx,8,1,0,0,0,1,12,0,14,2.0,2,0.0,0,0,0,0,1,1,0,12,0,0,14,1
9813,140165,4NbBJgtOnvI4dKJO6U04PsO19ilNdxDa,7GRhBDsirIGkRZBtSMEzNTyDr2JQm4xx,8,2,1,0,1,1,6,2,13,1.8571428571428572,1,0.0,0,1,0,1,2,1,0,6,2,2,11,1
9814,140282,xcD6YWhnGA2xukGmX4eaYrm6VS9ffz1H,7GRhBDsirIGkRZBtSMEzNTyDr2JQm4xx,30,77,3,56,5,7,17,0,165,23.571428571428573,4,0.0,33,3,46,5,44,7,10,17,0,87,78,0
9815,140306,Ob79Za99PdIwrqcyAnuLEFhl9GSQ6Xz6,7GRhBDsirIGkRZBtSMEzNTyDr2JQm4xx,1,0,0,0,0,0,1,0,1,0.14285714285714285,1,0.0,0,0,0,0,0,0,0,1,0,0,1,1
9816,140329,H3cyUU6nxPSmVjGMKYWWKOtYQjRDHxeD,7GRhBDsirIGkRZBtSMEzNTyDr2JQm4xx,1,0,0,0,0,0,1,0,1,0.14285714285714285,1,0.0,0,0,0,0,0,0,0,1,0,0,1,1
9817,140341,IUMl6TF9SZyzdSkTs0p0M3q4lvkSdDmi,7GRhBDsirIGkRZBtSMEzNTyDr2JQm4xx,13,15,5,0,6,4,19,4,53,7.571428571428571,1,0.0,8,5,0,6,7,4,0,19,4,19,34,1
9818,140358,XawXAsPAfBtlXBQzpKPcgk3ZhHAMJWNJ,7GRhBDsirIGkRZBtSMEzNTyDr2JQm4xx,54,82,14,87,8,1,35,0,227,32.42857142857143,4,0.0,34,14,72,8,48,1,15,35,0,128,99,1
9819,140617,jxqH1Y0Ll1dSqJHW2X4uLUdvrbgDj0Cd,7GRhBDsirIGkRZBtSMEzNTyDr2JQm4xx,6,2,1,0,1,0,3,0,7,1.0,1,0.0,0,1,0,1,2,0,0,3,0,2,5,1
9820,140630,TYNUH36wQX48EZFChTHsXflAW5aqSPOs,7GRhBDsirIGkRZBtSMEzNTyDr2JQm4xx,3,0,0,0,0,3,2,0,5,0.7142857142857143,1,0.0,0,0,0,0,0,3,0,2,0,0,5,1
9821,140636,2lTrV3r5iXOtPSrHMTWqISMwiAr82ziw,7GRhBDsirIGkRZBtSMEzNTyDr2JQm4xx,5,2,1,0,1,0,2,0,6,0.8571428571428571,1,0.0,0,1,0,1,2,0,0,2,0,2,4,1
9822,140660,w8Pvw8WQP7Chw590vs3wc2RvlZ6Vvee0,7GRhBDsirIGkRZBtSMEzNTyDr2JQm4xx,20,31,0,14,0,6,10,1,62,8.857142857142858,1,0.0,9,0,7,0,22,6,7,10,1,16,46,0
9823,140667,yq9vHLk2LjPpNFyoMkV6FPLMiEC0nSyT,7GRhBDsirIGkRZBtSMEzNTyDr2JQm4xx,26,20,11,4,7,5,9,1,57,8.142857142857142,1,0.0,6,11,3,7,14,5,1,9,1,27,30,1
9824,143597,0cz0w0x5qzuunbgfeQV0i5L0OMvyWFxQ,SpATywNh6bZuzm8s1ceuBUnMUAeoAHHw,13,10,7,0,5,3,17,4,46,6.571428571428571,2,0.0,0,7,0,5,10,3,0,17,4,12,34,1
9825,143602,Jm4nQ05ndX10jbofbWx6S0r9VXrqia6S,A3fsA9Zfv1X2fVEQhTw51lKENdNrEqT3,10,9,6,0,2,0,2,0,19,2.7142857142857144,1,0.0,0,6,0,2,9,0,0,2,0,8,11,0
9826,143603,nWxN8tjySUVOGOns5lP09DIo5v1ke7EL,A3fsA9Zfv1X2fVEQhTw51lKENdNrEqT3,8,9,4,0,3,0,2,0,18,2.5714285714285716,1,0.0,0,4,0,3,9,0,0,2,0,7,11,1
9827,143605,nWxN8tjySUVOGOns5lP09DIo5v1ke7EL,bWdj2GDclj5ofokWjzoa5jAwMkxCykd6,8,4,2,0,1,2,11,2,22,3.142857142857143,1,0.0,0,2,0,1,4,2,0,11,2,3,19,1
9828,143607,3iJrlZJEv2h7DgWBpz6wZtSXPXEy6IAY,bWdj2GDclj5ofokWjzoa5jAwMkxCykd6,8,8,5,0,3,0,3,0,19,2.7142857142857144,3,0.0,0,5,0,3,8,0,0,3,0,8,11,1
9829,143614,n2GF9Yeq4eisQG7nka32xYSXt9etqVaZ,G8EPVSXsOYB5YQWZGiz1aVq5Pgr2GrQu,6,5,3,0,0,1,2,0,11,1.5714285714285714,1,0.0,0,3,0,0,5,1,0,2,0,3,8,1
9830,143623,HtMha1d9fNJoHGbwIKcB3HWdDU94w7Lj,SpATywNh6bZuzm8s1ceuBUnMUAeoAHHw,18,25,14,17,6,0,7,1,70,10.0,3,0.0,6,14,16,6,19,0,1,7,1,42,28,1
9831,143629,tkMGC5CG4kemHaNbBo6MMddbuqCxk8Qb,SpATywNh6bZuzm8s1ceuBUnMUAeoAHHw,5,5,3,0,1,0,2,0,11,1.5714285714285714,3,0.0,0,3,0,1,5,0,0,2,0,4,7,1
9832,143631,GNXZVEHsVeYck60C0KBPWHG0mMcY0UQQ,SpATywNh6bZuzm8s1ceuBUnMUAeoAHHw,15,20,2,7,3,9,4,0,45,6.428571428571429,5,0.0,2,2,7,3,18,9,0,4,0,14,31,0
9833,143641,Uux0jHna4HKcvE72hnPMG7xrHByftJPh,bWdj2GDclj5ofokWjzoa5jAwMkxCykd6,5,2,1,0,1,0,2,0,6,0.8571428571428571,1,0.0,0,1,0,1,2,0,0,2,0,2,4,1
9834,143650,iyNW22GLVn7ltcBOUiQmam3mjjq9r9cL,bWdj2GDclj5ofokWjzoa5jAwMkxCykd6,1,0,0,0,0,0,1,0,1,0.14285714285714285,1,0.0,0,0,0,0,0,0,0,1,0,0,1,1
9835,143652,NNxm4wTuqK3vBr5exeeaxNmVWigp9kZd,RXDvfPUBYFlVdlueBFbLW0mhhAyGEqpt,9,9,1,0,0,0,4,0,14,2.0,2,0.0,0,1,0,0,9,0,0,4,0,1,13,1
9836,143653,E7W9iVWrVUAUJsVKnfZDdWhC9kKNiFWd,A3fsA9Zfv1X2fVEQhTw51lKENdNrEqT3,4,2,1,0,1,0,1,0,5,0.7142857142857143,1,0.0,0,1,0,1,2,0,0,1,0,2,3,0
9837,143683,oArXTDKLwWKfXkZ74yUJJtvr4UhDGsgG,SpATywNh6bZuzm8s1ceuBUnMUAeoAHHw,7,4,0,0,1,0,2,0,7,1.0,1,0.0,0,0,0,1,4,0,0,2,0,1,6,1
9838,143687,zXaIFCKxfdY9z9fVBcdJ9CKQhYz4fcsP,A3fsA9Zfv1X2fVEQhTw51lKENdNrEqT3,8,4,1,8,1,0,2,0,16,2.2857142857142856,1,0.0,1,1,8,1,3,0,0,2,0,11,5,1
9839,143689,ZaW4RrWrF9gJ30CuAjw5a2IkcpF7An5C,G8EPVSXsOYB5YQWZGiz1aVq5Pgr2GrQu,10,8,3,0,2,5,12,2,32,4.571428571428571,2,0.0,2,3,0,2,6,5,0,12,2,7,25,1
9840,143690,9l6PGZqklFaIeCC4cIui4TvC3Cf7mMtA,G8EPVSXsOYB5YQWZGiz1aVq5Pgr2GrQu,8,3,2,0,2,1,8,1,17,2.4285714285714284,1,0.0,0,2,0,2,3,1,0,8,1,4,13,1
9841,143695,MiA88xKunqu6yy0duOdvLI06Oy5UMt4X,RXDvfPUBYFlVdlueBFbLW0mhhAyGEqpt,4,2,1,0,1,0,1,0,5,0.7142857142857143,1,0.0,0,1,0,1,2,0,0,1,0,2,3,1
9842,143715,vFHaopWeOsxXSRudDrGgOuVKmzwec37W,SpATywNh6bZuzm8s1ceuBUnMUAeoAHHw,13,19,0,9,1,0,4,0,33,4.714285714285714,1,0.0,4,0,9,1,15,0,0,4,0,14,19,1
9843,143722,VzxoAK96NBZMonMzFBNCEGPOgDpcMczp,A3fsA9Zfv1X2fVEQhTw51lKENdNrEqT3,8,2,1,0,1,10,6,1,21,3.0,1,0.0,0,1,0,1,2,10,0,6,1,2,19,1
9844,143731,X2xaI3ENq0OZDZ0s1ETxwXOMaEJnZn8K,A3fsA9Zfv1X2fVEQhTw51lKENdNrEqT3,8,4,3,0,3,0,1,0,11,1.5714285714285714,2,0.0,0,3,0,3,4,0,0,1,0,6,5,1
9845,143736,a2kYXY4DZduwKkGJa8fQrbG6TxHBB94I,A3fsA9Zfv1X2fVEQhTw51lKENdNrEqT3,6,2,1,0,1,0,9,0,13,1.8571428571428572,1,0.0,0,1,0,1,2,0,0,9,0,2,11,1
9846,143739,j1ZwHmxsEQ0TgQEQqgxbWG7UscEDky1c,SpATywNh6bZuzm8s1ceuBUnMUAeoAHHw,13,22,0,11,0,0,8,0,41,5.857142857142857,2,0.0,10,0,10,0,12,0,1,8,0,20,21,1
9847,143745,ravD1f2MIgZP9srRrYJQsdPSYhRi83XU,SpATywNh6bZuzm8s1ceuBUnMUAeoAHHw,16,27,4,21,1,2,13,1,69,9.857142857142858,3,0.0,9,4,18,1,18,2,3,13,1,32,37,0
9848,143749,cZbR6FMlSKlEaK0BZQEtqLknk5lBVQRh,SpATywNh6bZuzm8s1ceuBUnMUAeoAHHw,14,16,1,12,1,12,8,1,51,7.285714285714286,1,0.0,5,1,10,1,11,12,2,8,1,17,34,1
9849,143750,ldpyoNVLH614iuNg2P99R7SYjvFOfdM2,G8EPVSXsOYB5YQWZGiz1aVq5Pgr2GrQu,11,14,6,0,4,1,4,0,29,4.142857142857143,3,0.0,3,6,0,4,11,1,0,4,0,13,16,1
9850,143762,m7fPOqd4GotPyK3pn7xq2eK9izwTqrAR,A3fsA9Zfv1X2fVEQhTw51lKENdNrEqT3,5,1,1,0,1,1,2,0,6,0.8571428571428571,1,0.0,0,1,0,1,1,1,0,2,0,2,4,1
9851,143766,CDMI3gQZrAOAZ9Cf4jB5NzA4daPYwjjn,A3fsA9Zfv1X2fVEQhTw51lKENdNrEqT3,20,16,13,0,7,5,11,4,56,8.0,2,0.0,0,13,0,7,16,5,0,11,4,20,36,1
9852,143772,D0Q5uZnA6QMJZo17g9opktHEQj6b5d5E,SpATywNh6bZuzm8s1ceuBUnMUAeoAHHw,3,0,0,0,0,0,3,0,3,0.42857142857142855,1,0.0,0,0,0,0,0,0,0,3,0,0,3,0
9853,143796,JGBLBGhiZQ8K0PQBUKKu5a6jYm04SHA0,A3fsA9Zfv1X2fVEQhTw51lKENdNrEqT3,2,0,0,0,0,0,2,0,2,0.2857142857142857,1,0.0,0,0,0,0,0,0,0,2,0,0,2,1
9854,143804,qmiNvBvBVayyfYSGvn9Ww6fyfbmmg8Ju,SpATywNh6bZuzm8s1ceuBUnMUAeoAHHw,1,0,0,0,0,0,1,0,1,0.14285714285714285,1,0.0,0,0,0,0,0,0,0,1,0,0,1,1
9855,143810,bACQsAWyyrjdiMPqSUjAzVKv7ajw33ro,SpATywNh6bZuzm8s1ceuBUnMUAeoAHHw,8,7,5,0,4,2,5,1,24,3.4285714285714284,1,0.0,0,5,0,4,7,2,0,5,1,9,15,1
9856,143814,65NT4Vy4CWsCo0yJt0Ser3pgvYWBcuzx,G8EPVSXsOYB5YQWZGiz1aVq5Pgr2GrQu,10,4,2,0,2,1,4,1,14,2.0,1,0.0,0,2,0,2,4,1,0,4,1,4,10,1
9857,143816,dmgKCClueSUfvNvbgn76P7yZNOrcqS51,SpATywNh6bZuzm8s1ceuBUnMUAeoAHHw,5,5,2,0,0,0,5,0,12,1.7142857142857142,1,0.0,0,2,0,0,5,0,0,5,0,2,10,1
9858,143826,vWKarVz9MLdkaeCnowC5zORVIjWhxnGT,A3fsA9Zfv1X2fVEQhTw51lKENdNrEqT3,41,17,11,56,8,1,10,1,104,14.857142857142858,1,0.0,4,11,49,8,13,1,7,10,1,72,32,1
9859,143827,icWbBG6yTFIZ32qTSFWaJeU4GOLom0j8,SpATywNh6bZuzm8s1ceuBUnMUAeoAHHw,12,12,8,0,3,6,12,2,43,6.142857142857143,2,0.0,0,8,0,3,12,6,0,12,2,11,32,1
9860,143828,e0M6WM1PijCu34LKse7mmvSD1YWuaWbQ,SpATywNh6bZuzm8s1ceuBUnMUAeoAHHw,13,10,1,5,1,1,6,1,25,3.5714285714285716,1,0.0,4,1,5,1,6,1,0,6,1,11,14,1
9861,143833,O8HOTucc0KEJXoqiM5XCMFFloSFDXkri,SpATywNh6bZuzm8s1ceuBUnMUAeoAHHw,10,8,3,0,2,0,6,0,19,2.7142857142857144,3,0.0,0,3,0,2,8,0,0,6,0,5,14,0
9862,143840,kuZwBvEdgeUtKZ495C2FptBbxEtLtmVH,bWdj2GDclj5ofokWjzoa5jAwMkxCykd6,6,14,5,0,1,0,6,0,26,3.7142857142857144,3,0.0,2,5,0,1,12,0,0,6,0,8,18,1
9863,143841,U9j28kbZjF4W0VB5A2yieyyacPtOxvwt,bWdj2GDclj5ofokWjzoa5jAwMkxCykd6,11,69,23,10,11,2,18,1,134,19.142857142857142,4,0.0,28,23,10,11,41,2,0,18,1,72,62,1
9864,143856,k5QrgarfuSQsGSVQQrcJTwJdAAKzf9gw,A3fsA9Zfv1X2fVEQhTw51lKENdNrEqT3,2,0,0,0,0,0,2,0,2,0.2857142857142857,1,0.0,0,0,0,0,0,0,0,2,0,0,2,1
9865,143858,uVezMKauDUYUFjTOlrwzQHcegaGFiPmr,A3fsA9Zfv1X2fVEQhTw51lKENdNrEqT3,35,26,2,62,2,0,10,0,102,14.571428571428571,2,0.0,1,2,58,2,25,0,4,10,0,63,39,1
9866,143860,kMzMJEHy7fAHiNUZU0um3I2BsPC7gMll,SpATywNh6bZuzm8s1ceuBUnMUAeoAHHw,1,0,0,0,0,0,2,0,2,0.2857142857142857,2,0.0,0,0,0,0,0,0,0,2,0,0,2,1
9867,143863,cQR8w7MfHX2zVKP2ObrWt7YmSX4BnmzU,SpATywNh6bZuzm8s1ceuBUnMUAeoAHHw,5,3,2,0,0,0,2,0,7,1.0,1,0.0,0,2,0,0,3,0,0,2,0,2,5,1
9868,143864,RCdcltNaQLfcoxT7YKTjQxAYUbCmzzKd,bWdj2GDclj5ofokWjzoa5jAwMkxCykd6,9,13,9,0,8,2,5,0,37,5.285714285714286,2,0.0,3,9,0,8,10,2,0,5,0,20,17,1
9869,143865,wovmcysU3CVvWe03Rf3D2PLI3no54RS2,SpATywNh6bZuzm8s1ceuBUnMUAeoAHHw,5,2,1,0,1,0,3,0,7,1.0,1,0.0,0,1,0,1,2,0,0,3,0,2,5,1
9870,143866,cQR8w7MfHX2zVKP2ObrWt7YmSX4BnmzU,bWdj2GDclj5ofokWjzoa5jAwMkxCykd6,1,0,0,0,0,0,1,0,1,0.14285714285714285,1,0.0,0,0,0,0,0,0,0,1,0,0,1,1
9871,143867,Pnezq6slEV4CIBxIFIPqhlGLNILa8T8M,SpATywNh6bZuzm8s1ceuBUnMUAeoAHHw,25,36,7,20,3,4,8,0,78,11.142857142857142,6,0.0,8,7,18,3,28,4,2,8,0,36,42,0
9872,143880,zAobqpIInEgToh5g3mHxVZCEkz5XFqde,SpATywNh6bZuzm8s1ceuBUnMUAeoAHHw,10,23,1,18,0,0,3,0,45,6.428571428571429,2,0.0,13,1,17,0,10,0,1,3,0,31,14,1
9873,143881,g5rASgrCPlNIsJec3wFullHkMrOBGptd,SpATywNh6bZuzm8s1ceuBUnMUAeoAHHw,10,7,5,4,4,0,2,0,22,3.142857142857143,1,0.0,0,5,3,4,7,0,1,2,0,12,10,1
9874,143887,SKJH5bhXUHUXBV3YRjTcw0Oe5kVFAmnw,SpATywNh6bZuzm8s1ceuBUnMUAeoAHHw,8,10,6,4,2,0,4,0,26,3.7142857142857144,2,0.0,0,6,3,2,10,0,1,4,0,11,15,1
9875,143888,CdBS5mGJVzgaGDeY8NzEjALJKus99MGR,SpATywNh6bZuzm8s1ceuBUnMUAeoAHHw,21,44,13,16,6,8,16,0,103,14.714285714285714,4,0.0,6,13,14,6,38,8,2,16,0,39,64,1
9876,143891,UpT5KvhktZoGfL90nOmM9gx3GU38kT3j,bWdj2GDclj5ofokWjzoa5jAwMkxCykd6,17,14,1,38,3,11,16,1,84,12.0,4,0.0,5,1,33,3,9,11,5,16,1,42,42,0
9877,143897,BhOp2rSiJ2q2zT4ZZzNtPz6Fovfll5Yb,SpATywNh6bZuzm8s1ceuBUnMUAeoAHHw,12,8,5,1,3,0,7,2,26,3.7142857142857144,3,0.0,1,5,1,3,7,0,0,7,2,10,16,1
9878,143900,NWUbBzN3rFqJYQQKuHujeEDgr8fxabPr,SpATywNh6bZuzm8s1ceuBUnMUAeoAHHw,26,48,9,52,3,42,13,0,167,23.857142857142858,7,0.0,16,9,43,3,32,42,9,13,0,71,96,0
9879,143901,mvgC6breSmhPTVyyPyUMeu7XoIQqVA6J,bWdj2GDclj5ofokWjzoa5jAwMkxCykd6,1,0,0,0,0,0,1,0,1,0.14285714285714285,1,0.0,0,0,0,0,0,0,0,1,0,0,1,1
9880,143902,qDW8D89X9oTRJFDDcQZTLb3PUIxnDi04,bWdj2GDclj5ofokWjzoa5jAwMkxCykd6,5,2,1,0,1,0,2,0,6,0.8571428571428571,1,0.0,0,1,0,1,2,0,0,2,0,2,4,1
9881,143908,nwFT4lnmg30fCvHRB6tbALo9FpcanuLx,SpATywNh6bZuzm8s1ceuBUnMUAeoAHHw,10,11,1,0,1,0,10,0,23,3.2857142857142856,5,0.0,2,1,0,1,9,0,0,10,0,4,19,0
9882,143909,nwFT4lnmg30fCvHRB6tbALo9FpcanuLx,A3fsA9Zfv1X2fVEQhTw51lKENdNrEqT3,5,5,1,0,0,0,6,0,12,1.7142857142857142,4,0.0,0,1,0,0,5,0,0,6,0,1,11,1
9883,143927,2WRiAgv5S6kcFPY2blVGjs9g0YNkJyLP,A3fsA9Zfv1X2fVEQhTw51lKENdNrEqT3,12,6,5,0,5,0,1,0,17,2.4285714285714284,1,0.0,0,5,0,5,6,0,0,1,0,10,7,1
9884,143933,Mi4V9PN04XHkOYjYbsNOyLc2HUiygd5R,SpATywNh6bZuzm8s1ceuBUnMUAeoAHHw,19,35,1,18,1,0,7,0,62,8.857142857142858,4,0.0,0,1,16,1,35,0,2,7,0,18,44,1
9885,143940,rMQIZQBxSTMFTRmvcfmpoYqCAUhMol3Y,A3fsA9Zfv1X2fVEQhTw51lKENdNrEqT3,11,11,2,0,2,0,3,0,18,2.5714285714285716,3,0.0,0,2,0,2,11,0,0,3,0,4,14,1
9886,143941,QZzKa5b6BbNwk1LIn6xlSQQLnIzRsZka,SpATywNh6bZuzm8s1ceuBUnMUAeoAHHw,13,15,0,16,0,2,14,3,50,7.142857142857143,3,0.0,2,0,14,0,13,2,2,14,3,16,34,1
9887,143945,U0EvfjsY5qqb8sRRReWuk6YqXYpCTRVc,SpATywNh6bZuzm8s1ceuBUnMUAeoAHHw,31,64,26,32,11,0,9,0,142,20.285714285714285,5,0.0,30,26,30,11,34,0,2,9,0,97,45,0
9888,143948,PM49kyPCpZaIfMyV0vVvEZLNApBiy9hl,G8EPVSXsOYB5YQWZGiz1aVq5Pgr2GrQu,18,16,11,22,3,4,29,7,92,13.142857142857142,2,0.0,0,11,17,3,16,4,5,29,7,31,61,0
9889,143956,BjRnjY2o7a3tMcpDhDIkBnAHWrC67ajb,bWdj2GDclj5ofokWjzoa5jAwMkxCykd6,11,13,1,30,4,0,1,0,49,7.0,1,0.0,8,1,28,4,5,0,2,1,0,41,8,1
9890,143959,qE4hwNlGPGhoA6O5q5uX2JQSuwb75VXN,SpATywNh6bZuzm8s1ceuBUnMUAeoAHHw,12,5,4,0,2,5,8,1,25,3.5714285714285716,2,0.0,0,4,0,2,5,5,0,8,1,6,19,1
9891,143964,J4CQZgZBlOmytRfPs9vqhW9gDDIzfvcP,SpATywNh6bZuzm8s1ceuBUnMUAeoAHHw,14,14,8,9,5,0,2,0,38,5.428571428571429,2,0.0,4,8,9,5,10,0,0,2,0,26,12,1
9892,143970,yepbpI2oB7GcEIjPPhcQSpqMxzy4YG1o,A3fsA9Zfv1X2fVEQhTw51lKENdNrEqT3,17,16,11,0,9,0,3,0,39,5.571428571428571,2,0.0,0,11,0,9,16,0,0,3,0,20,19,1
9893,143971,nVB1o73xluQXZjoI2dUYHGxbCDG8qiCL,SpATywNh6bZuzm8s1ceuBUnMUAeoAHHw,9,13,9,0,5,18,8,0,53,7.571428571428571,2,0.0,0,9,0,5,13,18,0,8,0,14,39,0
9894,143981,sNbuAEBvvCL9s1FspvGXLJVjQkFzxwpw,A3fsA9Zfv1X2fVEQhTw51lKENdNrEqT3,2,0,0,0,0,0,3,0,3,0.42857142857142855,2,0.0,0,0,0,0,0,0,0,3,0,0,3,1
9895,143982,4GJSwwikGuUWXSajcKoSlvfsoiC8eEZq,SpATywNh6bZuzm8s1ceuBUnMUAeoAHHw,8,11,2,0,1,0,3,0,17,2.4285714285714284,2,0.0,3,2,0,1,8,0,0,3,0,6,11,1
9896,144006,BNzSA1bHraXMmngTyyc8aHsRdjDVh5h7,bWdj2GDclj5ofokWjzoa5jAwMkxCykd6,6,0,0,0,0,1,7,1,9,1.2857142857142858,1,0.0,0,0,0,0,0,1,0,7,1,0,9,1
9897,144007,jSNLRK8jxSbbcqhbWW7DXZqoGlvGgXDY,SpATywNh6bZuzm8s1ceuBUnMUAeoAHHw,17,48,6,10,0,8,12,0,84,12.0,7,0.0,8,6,9,0,40,8,1,12,0,23,61,0
9898,144009,xbYSqp0T7Uu69VoCNyfTCvQcS3HV3UeU,A3fsA9Zfv1X2fVEQhTw51lKENdNrEqT3,7,15,8,0,0,12,8,0,43,6.142857142857143,4,0.0,1,8,0,0,14,12,0,8,0,9,34,1
9899,144012,tShEWwQUmNvdJJLgb6IWQwSvspfEXM5K,A3fsA9Zfv1X2fVEQhTw51lKENdNrEqT3,4,2,1,0,1,0,1,0,5,0.7142857142857143,1,0.0,0,1,0,1,2,0,0,1,0,2,3,1
9900,144016,pV3LNiRBcnB0okGlxsutPlVeupVbHeL3,SpATywNh6bZuzm8s1ceuBUnMUAeoAHHw,6,3,2,0,1,0,2,0,8,1.1428571428571428,1,0.0,0,2,0,1,3,0,0,2,0,3,5,1
9901,144037,nCjvWGBuFy5INkXPz8A7SRdydYBldjvQ,SpATywNh6bZuzm8s1ceuBUnMUAeoAHHw,4,2,0,0,0,0,2,0,4,0.5714285714285714,1,0.0,0,0,0,0,2,0,0,2,0,0,4,1
9902,144041,oqyavd6F0mKguMPCfvp0hDFA1MAPWGfD,SpATywNh6bZuzm8s1ceuBUnMUAeoAHHw,16,21,10,17,7,0,2,0,57,8.142857142857142,3,0.0,8,10,14,7,13,0,3,2,0,39,18,0
9903,144045,X6wKs7o7iaOCvuOiKVJE8ObJhZymqim9,A3fsA9Zfv1X2fVEQhTw51lKENdNrEqT3,2,0,0,0,0,0,2,0,2,0.2857142857142857,1,0.0,0,0,0,0,0,0,0,2,0,0,2,1
9904,144054,3gXxAS6JQyT6kaPyX2q9IFEYv8Hv4qpf,SpATywNh6bZuzm8s1ceuBUnMUAeoAHHw,1,0,0,0,0,0,2,0,2,0.2857142857142857,1,0.0,0,0,0,0,0,0,0,2,0,0,2,1
9905,144058,JaYbgvhgx43SysY9J8DaCR3IcdUzCcUf,A3fsA9Zfv1X2fVEQhTw51lKENdNrEqT3,14,26,2,0,2,0,4,0,34,4.857142857142857,3,0.0,0,2,0,2,26,0,0,4,0,4,30,1
9906,144068,lWBDQVwIQrjtFGVOoBxPlW4CU3O2tpal,bWdj2GDclj5ofokWjzoa5jAwMkxCykd6,6,10,3,0,5,0,2,0,20,2.857142857142857,1,0.0,6,3,0,5,4,0,0,2,0,14,6,0
9907,144071,N3PF6286hfkTToYfzWd10OYG6jiYeyxL,A3fsA9Zfv1X2fVEQhTw51lKENdNrEqT3,34,20,10,76,6,2,8,0,122,17.428571428571427,3,0.0,4,10,65,6,16,2,11,8,0,85,37,1
9908,144073,J308vOrLkdYqLmDeq0FXdJXMsr1GuQ4w,SpATywNh6bZuzm8s1ceuBUnMUAeoAHHw,6,4,2,0,1,0,2,0,9,1.2857142857142858,1,0.0,0,2,0,1,4,0,0,2,0,3,6,1
9909,144076,M8cV3FHZsXmaSmJz43zOWXbhj6ecftQ6,A3fsA9Zfv1X2fVEQhTw51lKENdNrEqT3,1,0,0,0,0,0,1,0,1,0.14285714285714285,1,0.0,0,0,0,0,0,0,0,1,0,0,1,1
9910,144079,0MJO2AqnpIZ1IQnC9vPe2n4pS7b47XJt,bWdj2GDclj5ofokWjzoa5jAwMkxCykd6,5,10,8,0,6,0,2,0,26,3.7142857142857144,3,0.0,0,8,0,6,10,0,0,2,0,14,12,1
9911,144084,oM7kzBqhrhvKM9TULmlTbBtomZs2uMAz,bWdj2GDclj5ofokWjzoa5jAwMkxCykd6,7,7,1,0,1,0,3,0,12,1.7142857142857142,1,0.0,1,1,0,1,6,0,0,3,0,3,9,1
9912,144093,xOQ7AnZhBVXWatzUYsH22obdE4ihFc1J,bWdj2GDclj5ofokWjzoa5jAwMkxCykd6,6,11,4,0,2,0,5,0,22,3.142857142857143,2,0.0,4,4,0,2,7,0,0,5,0,10,12,1
9913,144104,8wj2Kr145taRtViYKZRdPMwAZeP9BDRs,A3fsA9Zfv1X2fVEQhTw51lKENdNrEqT3,10,9,1,0,1,0,4,0,15,2.142857142857143,2,0.0,0,1,0,1,9,0,0,4,0,2,13,1
9914,144107,QR8UITZg856bsXeO3qqb9HBw7LvT4WYt,G8EPVSXsOYB5YQWZGiz1aVq5Pgr2GrQu,14,15,2,6,2,1,7,1,34,4.857142857142857,1,0.0,6,2,5,2,9,1,1,7,1,15,19,1
9915,144112,A41hdT15T7mumzDW53QCDXRUsOilvTI0,A3fsA9Zfv1X2fVEQhTw51lKENdNrEqT3,11,13,8,0,5,0,6,0,32,4.571428571428571,3,0.0,0,8,0,5,13,0,0,6,0,13,19,0
9916,144120,rqoGLMWp7ee8Ppu4OdHSBl6vmRxDZvKU,A3fsA9Zfv1X2fVEQhTw51lKENdNrEqT3,7,8,2,0,2,0,1,0,13,1.8571428571428572,2,0.0,0,2,0,2,8,0,0,1,0,4,9,1
9917,144140,5F9PaqbFd1lCE07rWZ8QBm5IEOOVBjgP,G8EPVSXsOYB5YQWZGiz1aVq5Pgr2GrQu,48,16,13,96,10,0,5,0,140,20.0,1,0.0,1,13,75,10,15,0,21,5,0,99,41,1
9918,144144,IXIS4Shtcigf6RcvylwWobSKfmofV0Nt,SpATywNh6bZuzm8s1ceuBUnMUAeoAHHw,6,6,3,0,1,0,3,0,13,1.8571428571428572,2,0.0,0,3,0,1,6,0,0,3,0,4,9,1
9919,144158,LfOTQoQ2fSLvFDTNyvPm8DKwqfdrfE91,SpATywNh6bZuzm8s1ceuBUnMUAeoAHHw,17,20,10,6,5,0,4,1,46,6.571428571428571,1,0.0,8,10,6,5,12,0,0,4,1,29,17,1
9920,144159,vSPx0Rg8IfOWpaATb7kkPj0mZPaLkdwk,A3fsA9Zfv1X2fVEQhTw51lKENdNrEqT3,7,7,0,0,0,0,5,0,12,1.7142857142857142,1,0.0,0,0,0,0,7,0,0,5,0,0,12,1
9921,144162,vSPx0Rg8IfOWpaATb7kkPj0mZPaLkdwk,bWdj2GDclj5ofokWjzoa5jAwMkxCykd6,6,6,2,0,3,0,2,0,13,1.8571428571428572,1,0.0,2,2,0,3,4,0,0,2,0,7,6,1
9922,144163,Mi04UWZgqcHrMSZckQSYxOftI8OPYCzT,G8EPVSXsOYB5YQWZGiz1aVq5Pgr2GrQu,71,33,2,260,2,6,14,0,317,45.285714285714285,2,0.0,6,2,222,2,27,6,38,14,0,232,85,0
9923,144168,TTLR6K3ZlbSrGOfX2kjd2U4ChldGiopU,A3fsA9Zfv1X2fVEQhTw51lKENdNrEqT3,9,25,0,0,0,0,4,0,29,4.142857142857143,2,0.0,1,0,0,0,24,0,0,4,0,1,28,1
9924,144172,mSs5bB1Rxg3xYWjWjJY9pVTt7WAiMgyu,G8EPVSXsOYB5YQWZGiz1aVq5Pgr2GrQu,1,0,0,0,0,0,3,0,3,0.42857142857142855,2,0.0,0,0,0,0,0,0,0,3,0,0,3,0
9925,144173,mSs5bB1Rxg3xYWjWjJY9pVTt7WAiMgyu,A3fsA9Zfv1X2fVEQhTw51lKENdNrEqT3,9,6,4,0,2,2,12,0,26,3.7142857142857144,2,0.0,0,4,0,2,6,2,0,12,0,6,20,0
9926,144177,vang2CBp79w46FuP8PHdcPzohOKhBOq7,SpATywNh6bZuzm8s1ceuBUnMUAeoAHHw,8,3,2,0,2,0,3,0,10,1.4285714285714286,2,0.0,0,2,0,2,3,0,0,3,0,4,6,1
9927,144182,vaHtIA00RCulwKK7VIyzWyzyLmevfcyF,RXDvfPUBYFlVdlueBFbLW0mhhAyGEqpt,1,0,0,0,0,0,1,0,1,0.14285714285714285,1,0.0,0,0,0,0,0,0,0,1,0,0,1,1
9928,144190,lxaN8cMu58kiTAIgLqzjn8LLROF5HL13,SpATywNh6bZuzm8s1ceuBUnMUAeoAHHw,1,0,0,0,0,0,2,0,2,0.2857142857142857,2,0.0,0,0,0,0,0,0,0,2,0,0,2,1
9929,144195,TLRNemgJ2qb9k6dqDLHmoeJOx0QEylHX,A3fsA9Zfv1X2fVEQhTw51lKENdNrEqT3,7,3,2,0,2,0,4,0,11,1.5714285714285714,1,0.0,0,2,0,2,3,0,0,4,0,4,7,1
9930,144201,qz846pl1l6yGERGHSFYtB9X4bZxpZ3Ym,SpATywNh6bZuzm8s1ceuBUnMUAeoAHHw,4,2,1,0,1,0,1,0,5,0.7142857142857143,1,0.0,0,1,0,1,2,0,0,1,0,2,3,1
9931,144203,Dd8BaN0Npmwg2omUrerhRcBJi9Zv0QF5,G8EPVSXsOYB5YQWZGiz1aVq5Pgr2GrQu,22,27,16,34,8,1,16,1,103,14.714285714285714,3,0.0,0,16,30,8,27,1,4,16,1,54,49,0
9932,144208,7fciuEa5Xf2g36Xi6ZmKVyrNCJiVORwj,G8EPVSXsOYB5YQWZGiz1aVq5Pgr2GrQu,1,0,0,0,0,0,1,0,1,0.14285714285714285,1,0.0,0,0,0,0,0,0,0,1,0,0,1,1
9933,144209,7fciuEa5Xf2g36Xi6ZmKVyrNCJiVORwj,RXDvfPUBYFlVdlueBFbLW0mhhAyGEqpt,1,0,0,0,0,0,1,0,1,0.14285714285714285,1,0.0,0,0,0,0,0,0,0,1,0,0,1,1
9934,144212,vIAdh2clW8FkvdVniXHQiMyPfgIo07gQ,SpATywNh6bZuzm8s1ceuBUnMUAeoAHHw,4,0,0,0,0,0,3,1,4,0.5714285714285714,1,0.0,0,0,0,0,0,0,0,3,1,0,4,1
9935,144213,P89UxuMs18mdXj4DGhJJSZRF8BUJV2uZ,A3fsA9Zfv1X2fVEQhTw51lKENdNrEqT3,34,13,11,40,10,0,4,0,78,11.142857142857142,2,0.0,1,11,36,10,12,0,4,4,0,58,20,1
9936,144222,s2jX5TZHNhVfY48YU4SNM5eF0Y5PZev6,SpATywNh6bZuzm8s1ceuBUnMUAeoAHHw,5,2,1,0,1,0,2,0,6,0.8571428571428571,1,0.0,0,1,0,1,2,0,0,2,0,2,4,1
9937,144223,lnkkWGyIr1b44KiKgAFL6qVeebRfNJt3,SpATywNh6bZuzm8s1ceuBUnMUAeoAHHw,5,2,1,0,1,0,2,0,6,0.8571428571428571,1,0.0,0,1,0,1,2,0,0,2,0,2,4,1
9938,144237,YCrhaujUJb2ysdJEAlnTFggfP634EwtZ,bWdj2GDclj5ofokWjzoa5jAwMkxCykd6,1,0,0,0,0,0,1,0,1,0.14285714285714285,1,0.0,0,0,0,0,0,0,0,1,0,0,1,1
9939,144240,BPLF5bOPHidVrP3JGHCr9npCCCPEhz1g,SpATywNh6bZuzm8s1ceuBUnMUAeoAHHw,29,61,22,32,10,6,20,2,153,21.857142857142858,4,0.0,31,22,30,10,30,6,2,20,2,93,60,1
9940,144244,y3GJh8xEC6iboTvFOS91chZLMqYyEapH,G8EPVSXsOYB5YQWZGiz1aVq5Pgr2GrQu,22,35,4,0,4,1,9,2,55,7.857142857142857,4,0.0,7,4,0,4,28,1,0,9,2,15,40,1
9941,144259,PGj1B7s4Yw1PBLMA6crSiWk0Zk66XU5n,SpATywNh6bZuzm8s1ceuBUnMUAeoAHHw,1,0,0,0,0,0,1,0,1,0.14285714285714285,1,0.0,0,0,0,0,0,0,0,1,0,0,1,1
9942,144260,NxRna5VYeAvwKdtdFMhqdPkmD703DSHi,SpATywNh6bZuzm8s1ceuBUnMUAeoAHHw,17,40,19,18,7,13,15,0,112,16.0,5,0.0,10,19,16,7,30,13,2,15,0,52,60,1
9943,144290,QX3ApvDJvO9Hor69Bz89tLVK3rkHTGIJ,SpATywNh6bZuzm8s1ceuBUnMUAeoAHHw,2,0,0,0,0,0,2,0,2,0.2857142857142857,1,0.0,0,0,0,0,0,0,0,2,0,0,2,1
9944,144292,ObRNFdACerskEaO6OwPXBsUqKEYRJtIa,SpATywNh6bZuzm8s1ceuBUnMUAeoAHHw,7,3,2,0,2,0,2,0,9,1.2857142857142858,1,0.0,0,2,0,2,3,0,0,2,0,4,5,1
9945,144302,pWZNevyPOl4ouTcnYPIT4PYWT7cW7Aq7,SpATywNh6bZuzm8s1ceuBUnMUAeoAHHw,1,0,0,0,0,0,1,0,1,0.14285714285714285,1,0.0,0,0,0,0,0,0,0,1,0,0,1,1
9946,144315,8lCrBaMkcXk8KsL7M8AYgjnsyFuSP4yK,A3fsA9Zfv1X2fVEQhTw51lKENdNrEqT3,18,18,16,0,16,0,1,0,51,7.285714285714286,1,0.0,0,16,0,16,18,0,0,1,0,32,19,1
9947,144325,IKQYwh1PoPanPyuEqIIRzDtzc0tOUD2x,SpATywNh6bZuzm8s1ceuBUnMUAeoAHHw,16,28,5,15,1,1,22,1,73,10.428571428571429,7,0.0,5,5,12,1,23,1,3,22,1,23,50,0
9948,144327,SKemaavr5OG5spO92jXls0zhTMuWKDja,A3fsA9Zfv1X2fVEQhTw51lKENdNrEqT3,61,57,31,118,13,0,9,2,230,32.857142857142854,5,0.0,4,31,107,13,53,0,11,9,2,155,75,1
9949,144331,G4MfAXnz0EbVaCbavnksnUIxHSPSMOp9,SpATywNh6bZuzm8s1ceuBUnMUAeoAHHw,7,7,1,0,1,0,2,0,11,1.5714285714285714,2,0.0,0,1,0,1,7,0,0,2,0,2,9,0
9950,144349,0Xxh6UWDrWwPPLaMpUv0ZEdnE00mPUSR,A3fsA9Zfv1X2fVEQhTw51lKENdNrEqT3,16,12,5,0,3,1,10,1,32,4.571428571428571,3,0.0,0,5,0,3,12,1,0,10,1,8,24,0
9951,144357,Ie7mkAUCVVaLYxvosre748ADQJqirOJg,SpATywNh6bZuzm8s1ceuBUnMUAeoAHHw,6,3,1,0,1,0,2,0,7,1.0,1,0.0,0,1,0,1,3,0,0,2,0,2,5,1
9952,144363,svmQRfMWV47ki33Dy8s4c1zTDx5xyqqy,SpATywNh6bZuzm8s1ceuBUnMUAeoAHHw,22,27,0,29,0,1,5,0,62,8.857142857142858,2,0.0,9,0,26,0,18,1,3,5,0,35,27,1
9953,144370,BdodnRCsey53xS6PtugKwlzojwI7pwLX,bWdj2GDclj5ofokWjzoa5jAwMkxCykd6,6,5,3,0,2,0,3,0,13,1.8571428571428572,2,0.0,0,3,0,2,5,0,0,3,0,5,8,0
9954,144381,fcKXv9ZhNMmLocipK5ZZiRQ1LDYoPfgB,G8EPVSXsOYB5YQWZGiz1aVq5Pgr2GrQu,10,5,4,0,4,0,3,1,17,2.4285714285714284,2,0.0,0,4,0,4,5,0,0,3,1,8,9,1
9955,144387,sxauqKQQUFpXy4JZb43frlkE4bOqyCWY,G8EPVSXsOYB5YQWZGiz1aVq5Pgr2GrQu,9,5,3,0,2,0,8,0,18,2.5714285714285716,1,0.0,0,3,0,2,5,0,0,8,0,5,13,1
9956,144395,o8axHOLhofevJLu5TvKmRFieQionk0uo,bWdj2GDclj5ofokWjzoa5jAwMkxCykd6,6,10,1,0,2,0,3,0,16,2.2857142857142856,2,0.0,0,1,0,2,10,0,0,3,0,3,13,1
9957,144401,4xrSOv0Zb9s9Mfulum5aoHlVB6c6SKgp,RXDvfPUBYFlVdlueBFbLW0mhhAyGEqpt,24,21,6,37,9,5,13,5,96,13.714285714285714,3,0.0,9,6,32,9,12,5,5,13,5,56,40,1
9958,144405,m0LuTHIjrSW3BF8YSCNgkHg0UqSBwWqE,bWdj2GDclj5ofokWjzoa5jAwMkxCykd6,7,23,6,0,5,0,7,0,41,5.857142857142857,3,0.0,6,6,0,5,17,0,0,7,0,17,24,1
9959,144413,SG7N8DhpCuhIu06IIzLX0CSolbyIDsIx,bWdj2GDclj5ofokWjzoa5jAwMkxCykd6,11,11,5,0,2,1,10,1,30,4.285714285714286,4,0.0,1,5,0,2,10,1,0,10,1,8,22,1
9960,144415,6ElmeAobgOVWMQKbfyTe96fhVbG33C2X,SpATywNh6bZuzm8s1ceuBUnMUAeoAHHw,5,2,1,0,1,0,3,0,7,1.0,3,0.0,0,1,0,1,2,0,0,3,0,2,5,1
9961,144420,yntRyPnV06sPev3xKXJHMzKiUHpX97Sd,bWdj2GDclj5ofokWjzoa5jAwMkxCykd6,4,3,1,0,0,0,4,0,8,1.1428571428571428,1,0.0,0,1,0,0,3,0,0,4,0,1,7,1
9962,144425,cDfX3cMJgUCBkullLQDAvI97VlFeM2Mm,SpATywNh6bZuzm8s1ceuBUnMUAeoAHHw,1,0,0,0,0,0,1,0,1,0.14285714285714285,1,0.0,0,0,0,0,0,0,0,1,0,0,1,1
9963,144427,tVItbLut2hv4GIKzxM0DVZ7s3PzDPaT6,A3fsA9Zfv1X2fVEQhTw51lKENdNrEqT3,1,0,0,0,0,0,1,0,1,0.14285714285714285,1,0.0,0,0,0,0,0,0,0,1,0,0,1,1
9964,144430,04LxEQ3nhSzj7dXc7lrpbpcFvVUWGlZI,SpATywNh6bZuzm8s1ceuBUnMUAeoAHHw,16,17,9,18,4,4,10,1,63,9.0,2,0.0,4,9,15,4,13,4,3,10,1,32,31,0
9965,144435,v8vHTBb2c8b6hXbbCm3oZZxhG00wE2vP,SpATywNh6bZuzm8s1ceuBUnMUAeoAHHw,14,14,0,15,0,0,8,0,37,5.285714285714286,2,0.0,5,0,14,0,9,0,1,8,0,19,18,1
9966,144441,SSjG9q1bzvgdf9EkFqx8YjsCqQBg1XFt,A3fsA9Zfv1X2fVEQhTw51lKENdNrEqT3,21,12,9,0,7,0,8,1,37,5.285714285714286,2,0.0,0,9,0,7,12,0,0,8,1,16,21,0
9967,144464,lZNtuG4kxIFp0PJuciNw1EckZr8BFEk1,G8EPVSXsOYB5YQWZGiz1aVq5Pgr2GrQu,9,8,3,0,3,0,2,0,16,2.2857142857142856,1,0.0,4,3,0,3,4,0,0,2,0,10,6,1
9968,144468,mU6A1Eh1Sbu4ybvtOk62E6H19PAtCNgh,SpATywNh6bZuzm8s1ceuBUnMUAeoAHHw,29,40,22,31,8,4,23,2,130,18.571428571428573,6,0.0,8,22,25,8,32,4,6,23,2,63,67,1
9969,144470,3DA03ejzzYcn7ZLRW08jG2ITijpoufwN,G8EPVSXsOYB5YQWZGiz1aVq5Pgr2GrQu,12,17,1,6,1,0,4,1,30,4.285714285714286,1,0.0,7,1,3,1,10,0,3,4,1,12,18,1
9970,144475,JyrEAC8QBM1FImevyuACZ1OHrDsTde69,G8EPVSXsOYB5YQWZGiz1aVq5Pgr2GrQu,5,3,1,0,1,0,1,0,6,0.8571428571428571,1,0.0,0,1,0,1,3,0,0,1,0,2,4,1
9971,144476,uCAoWg5FaKwY0ioNKZmmoCVVstQhRxsa,SpATywNh6bZuzm8s1ceuBUnMUAeoAHHw,6,2,1,0,1,2,6,2,14,2.0,1,0.0,0,1,0,1,2,2,0,6,2,2,12,1
9972,144477,Lrv4yyy1oRPtpNW8S56NcLTs3dActQgc,SpATywNh6bZuzm8s1ceuBUnMUAeoAHHw,10,3,2,0,2,14,5,4,30,4.285714285714286,1,0.0,0,2,0,2,3,14,0,5,4,4,26,1
9973,144479,85biSqbQ9pgTGTSoZq3mDHUWbBBUYgJi,SpATywNh6bZuzm8s1ceuBUnMUAeoAHHw,20,29,18,12,13,5,8,0,85,12.142857142857142,3,0.0,8,18,11,13,21,5,1,8,0,50,35,0
9974,144491,liAQef8wjw79hEo9eOQyUXxysuTaQycU,A3fsA9Zfv1X2fVEQhTw51lKENdNrEqT3,2,0,0,0,0,0,2,0,2,0.2857142857142857,1,0.0,0,0,0,0,0,0,0,2,0,0,2,1
9975,144501,rFLQgLWbBhSut44kCW6TkgnVsL5AzEC5,SpATywNh6bZuzm8s1ceuBUnMUAeoAHHw,11,9,3,0,3,0,2,0,17,2.4285714285714284,2,0.0,0,3,0,3,9,0,0,2,0,6,11,1
9976,144506,bEN4cDdCBNI6z1gBK5oUDg5Tkh0maAFl,SpATywNh6bZuzm8s1ceuBUnMUAeoAHHw,9,6,5,0,3,0,2,0,16,2.2857142857142856,1,0.0,0,5,0,3,6,0,0,2,0,8,8,1
9977,144513,CDMI3gQZrAOAZ9Cf4jB5NzA4daPYwjjn,SpATywNh6bZuzm8s1ceuBUnMUAeoAHHw,1,0,0,0,0,0,1,0,1,0.14285714285714285,1,0.0,0,0,0,0,0,0,0,1,0,0,1,1
9978,144521,uCAoWg5FaKwY0ioNKZmmoCVVstQhRxsa,G8EPVSXsOYB5YQWZGiz1aVq5Pgr2GrQu,2,0,0,0,0,0,2,0,2,0.2857142857142857,1,0.0,0,0,0,0,0,0,0,2,0,0,2,1
9979,144526,9lksmcPg7FQE2FGQIA9VvWum1Z9DYrHM,G8EPVSXsOYB5YQWZGiz1aVq5Pgr2GrQu,1,0,0,0,0,0,1,0,1,0.14285714285714285,1,0.0,0,0,0,0,0,0,0,1,0,0,1,1
9980,144527,V76hQrNxMwZx40IX3yjuclMj7tgBsXTX,G8EPVSXsOYB5YQWZGiz1aVq5Pgr2GrQu,2,0,0,0,0,0,2,0,2,0.2857142857142857,1,0.0,0,0,0,0,0,0,0,2,0,0,2,1
9981,144536,393Iwr9LCShShn3ZP9MDE1iyGNI2KLnH,A3fsA9Zfv1X2fVEQhTw51lKENdNrEqT3,13,7,4,0,3,0,6,1,21,3.0,1,0.0,0,4,0,3,7,0,0,6,1,7,14,1
9982,144568,oBzLCci1yorqxivOBJW1dKnQofqyR5pw,A3fsA9Zfv1X2fVEQhTw51lKENdNrEqT3,2,0,0,0,0,0,2,0,2,0.2857142857142857,1,0.0,0,0,0,0,0,0,0,2,0,0,2,1
9983,144578,OUsTbnD6QZatQvggR5YjMxWOH6TYQEkw,SpATywNh6bZuzm8s1ceuBUnMUAeoAHHw,10,8,4,0,4,1,6,2,25,3.5714285714285716,4,0.0,0,4,0,4,8,1,0,6,2,8,17,1
9984,144590,aiKrSmMzCgtO0agHJchvzxr28vyUxQZz,G8EPVSXsOYB5YQWZGiz1aVq5Pgr2GrQu,8,3,2,0,2,0,3,1,11,1.5714285714285714,1,0.0,0,2,0,2,3,0,0,3,1,4,7,1
9985,144593,K938KGiMd2B4Ec49syEZjpINF1qucFfC,A3fsA9Zfv1X2fVEQhTw51lKENdNrEqT3,6,3,2,0,2,0,2,0,9,1.2857142857142858,1,0.0,0,2,0,2,3,0,0,2,0,4,5,1
9986,144599,KkSinTdG2PbGrJIRATMZos8HES46UawO,SpATywNh6bZuzm8s1ceuBUnMUAeoAHHw,5,3,1,0,1,0,2,0,7,1.0,2,0.0,0,1,0,1,3,0,0,2,0,2,5,1
9987,144600,9loONblFsvKeToe2mgBZCeASeNdXOJTu,A3fsA9Zfv1X2fVEQhTw51lKENdNrEqT3,1,0,0,0,0,0,1,0,1,0.14285714285714285,1,0.0,0,0,0,0,0,0,0,1,0,0,1,1
9988,144604,5ehf4EFN8WhDbvmb2WvfZwpaBD0cj1oj,A3fsA9Zfv1X2fVEQhTw51lKENdNrEqT3,69,30,3,158,1,0,7,0,199,28.428571428571427,2,0.0,8,3,156,1,22,0,2,7,0,168,31,1
9989,144606,AeCrxYByugIwu4XUBpI0LhoTguBozLAa,SpATywNh6bZuzm8s1ceuBUnMUAeoAHHw,18,36,17,15,9,1,19,1,98,14.0,3,0.0,3,17,14,9,33,1,1,19,1,43,55,1
9990,144610,6oCDtYWE1YbVTX7pVBS5Cflb4KyRNNI9,bWdj2GDclj5ofokWjzoa5jAwMkxCykd6,7,2,0,0,0,1,7,1,11,1.5714285714285714,1,0.0,0,0,0,0,2,1,0,7,1,0,11,1
9991,144633,qpV3C2IZjB1ICwVxeuRFosLbHBid3MJt,A3fsA9Zfv1X2fVEQhTw51lKENdNrEqT3,22,14,10,0,8,1,6,1,40,5.714285714285714,1,0.0,2,10,0,8,12,1,0,6,1,20,20,1
9992,144638,PUdcV8hfT4fAKFK5ZdHY1Ahxf6WKmDC8,A3fsA9Zfv1X2fVEQhTw51lKENdNrEqT3,6,5,2,0,2,0,1,0,10,1.4285714285714286,1,0.0,0,2,0,2,5,0,0,1,0,4,6,1
9993,144639,VY7imgBCSjRZotznUQIcU9HEMteCD7Vu,SpATywNh6bZuzm8s1ceuBUnMUAeoAHHw,8,3,1,0,1,1,5,0,11,1.5714285714285714,2,0.0,0,1,0,1,3,1,0,5,0,2,9,1
9994,144642,9qlyY7aaGl7nuKeZpypgQ9ZpHmFszatV,A3fsA9Zfv1X2fVEQhTw51lKENdNrEqT3,50,32,23,62,18,1,15,1,152,21.714285714285715,3,0.0,3,23,53,18,29,1,9,15,1,97,55,1
9995,144648,2LaA70mUgBYc8D3OKr2EYK4J2QrpGRxB,A3fsA9Zfv1X2fVEQhTw51lKENdNrEqT3,30,9,6,54,4,0,4,0,77,11.0,2,0.0,2,6,48,4,7,0,6,4,0,60,17,1
9996,144650,nv8B6ZD44hAnu4T6PFDyOO5rZhYIZjTq,SpATywNh6bZuzm8s1ceuBUnMUAeoAHHw,8,10,2,0,2,0,6,0,20,2.857142857142857,3,0.0,0,2,0,2,10,0,0,6,0,4,16,1
9997,144659,ObnmYfTIiUEvUBHUZwAwe98p78F42lKP,SpATywNh6bZuzm8s1ceuBUnMUAeoAHHw,11,23,1,17,0,0,1,0,42,6.0,1,0.0,13,1,15,0,10,0,2,1,0,29,13,0
9998,144661,K1P5HkkD06S9UwpMzKhPLUcedpL6qD5q,G8EPVSXsOYB5YQWZGiz1aVq5Pgr2GrQu,1,0,0,0,0,0,1,0,1,0.14285714285714285,1,0.0,0,0,0,0,0,0,0,1,0,0,1,1
9999,144664,ZZTvad4Qf03uG7FsvH1m57TKBNy8UI9m,SpATywNh6bZuzm8s1ceuBUnMUAeoAHHw,6,5,2,0,1,0,5,0,13,1.8571428571428572,2,0.0,2,2,0,1,3,0,0,5,0,5,8,1
10000,144667,uk1SKekwkpaHXYRLjN8ZintRuJ2tncOb,SpATywNh6bZuzm8s1ceuBUnMUAeoAHHw,13,20,11,0,10,0,4,0,45,6.428571428571429,2,0.0,2,11,0,10,18,0,0,4,0,23,22,0
10001,144669,IX7RiRPOSUbuV2fcXoS0ynYb5Bmt0H4j,G8EPVSXsOYB5YQWZGiz1aVq5Pgr2GrQu,13,8,2,16,2,2,6,1,37,5.285714285714286,1,0.0,5,2,13,2,3,2,3,6,1,22,15,0
10002,144671,2LaA70mUgBYc8D3OKr2EYK4J2QrpGRxB,bWdj2GDclj5ofokWjzoa5jAwMkxCykd6,8,5,3,0,2,0,8,0,18,2.5714285714285716,2,0.0,0,3,0,2,5,0,0,8,0,5,13,1
10003,144683,qpL2vcjziNlnSRSNpZZmRQfFObDSNaQD,A3fsA9Zfv1X2fVEQhTw51lKENdNrEqT3,2,0,0,0,0,0,2,0,2,0.2857142857142857,1,0.0,0,0,0,0,0,0,0,2,0,0,2,1
10004,144686,mp93D5T5EosRPeX8VQcgmycIpnu3UAVQ,SpATywNh6bZuzm8s1ceuBUnMUAeoAHHw,10,6,4,0,3,0,3,0,16,2.2857142857142856,1,0.0,0,4,0,3,6,0,0,3,0,7,9,1
10005,144695,BWZzwZgEWlPhZ8O1NZ0qWUnIi8M3MM7E,RXDvfPUBYFlVdlueBFbLW0mhhAyGEqpt,2,0,0,0,0,0,2,0,2,0.2857142857142857,1,0.0,0,0,0,0,0,0,0,2,0,0,2,1
10006,144700,SgWqRh3XmeJpz6RfUb8yXu2ZkH0AleuJ,A3fsA9Zfv1X2fVEQhTw51lKENdNrEqT3,1,0,0,0,0,0,1,0,1,0.14285714285714285,1,0.0,0,0,0,0,0,0,0,1,0,0,1,1
10007,144702,Edq6Echk8wEs8ShX5RBw5c8Yx8ANHVje,SpATywNh6bZuzm8s1ceuBUnMUAeoAHHw,4,2,0,0,0,0,3,0,5,0.7142857142857143,2,0.0,0,0,0,0,2,0,0,3,0,0,5,1
10008,144703,Edq6Echk8wEs8ShX5RBw5c8Yx8ANHVje,A3fsA9Zfv1X2fVEQhTw51lKENdNrEqT3,6,8,3,0,0,0,5,0,16,2.2857142857142856,3,0.0,0,3,0,0,8,0,0,5,0,3,13,1
10009,144708,Edq6Echk8wEs8ShX5RBw5c8Yx8ANHVje,G8EPVSXsOYB5YQWZGiz1aVq5Pgr2GrQu,5,2,1,0,1,0,3,0,7,1.0,2,0.0,0,1,0,1,2,0,0,3,0,2,5,1
10010,144709,Edq6Echk8wEs8ShX5RBw5c8Yx8ANHVje,RXDvfPUBYFlVdlueBFbLW0mhhAyGEqpt,9,10,4,0,0,0,7,1,22,3.142857142857143,3,0.0,0,4,0,0,10,0,0,7,1,4,18,1
10011,144711,5W6zUlMsjNEU65Ree05lYmcDiOLewtR2,A3fsA9Zfv1X2fVEQhTw51lKENdNrEqT3,13,14,0,0,0,0,4,0,18,2.5714285714285716,2,0.0,0,0,0,0,14,0,0,4,0,0,18,1
10012,144722,0PHNMn5JYsQigYaNxUJgIv4qow2cWlQK,A3fsA9Zfv1X2fVEQhTw51lKENdNrEqT3,2,0,0,0,0,0,2,0,2,0.2857142857142857,1,0.0,0,0,0,0,0,0,0,2,0,0,2,1
10013,144723,TkLeStjoXAMG5nRKUJ5tMauLM6wlBb8U,SpATywNh6bZuzm8s1ceuBUnMUAeoAHHw,16,13,5,16,3,0,4,0,41,5.857142857142857,1,0.0,6,5,14,3,7,0,2,4,0,28,13,1
10014,144729,Myt16IMVzxwRTOZLb6UMMq0vewiso7Vm,SpATywNh6bZuzm8s1ceuBUnMUAeoAHHw,15,27,1,12,1,8,9,2,60,8.571428571428571,3,0.0,15,1,9,1,12,8,3,9,2,26,34,1
10015,144733,X7TtqcEziDolV47iXb7vXuzoIflttREX,A3fsA9Zfv1X2fVEQhTw51lKENdNrEqT3,2,0,0,0,0,0,2,0,2,0.2857142857142857,1,0.0,0,0,0,0,0,0,0,2,0,0,2,1
10016,144739,i3sBPnecqsJtCmiHMtv0ri41qFT4LGFd,SpATywNh6bZuzm8s1ceuBUnMUAeoAHHw,1,0,0,0,0,0,1,0,1,0.14285714285714285,1,0.0,0,0,0,0,0,0,0,1,0,0,1,1
10017,144750,CWRrmCimMLwDXZTgPsiO3B49woTmmP7J,SpATywNh6bZuzm8s1ceuBUnMUAeoAHHw,4,3,0,0,0,0,2,0,5,0.7142857142857143,1,0.0,0,0,0,0,3,0,0,2,0,0,5,1
10018,144755,0eMlSFoZScU7zUCIgAM0BWfQh50FQz3i,RXDvfPUBYFlVdlueBFbLW0mhhAyGEqpt,22,18,15,10,9,1,2,0,55,7.857142857142857,3,0.0,1,15,8,9,17,1,2,2,0,33,22,1
10019,144758,iEsrSdCjyin4iFARTXOj17FWObSkkW7Y,A3fsA9Zfv1X2fVEQhTw51lKENdNrEqT3,4,2,0,0,0,0,5,0,7,1.0,1,0.0,0,0,0,0,2,0,0,5,0,0,7,1
10020,144761,0xrj8jMy7DRmz2206OV6CH0SXBZh0mT4,SpATywNh6bZuzm8s1ceuBUnMUAeoAHHw,7,3,2,0,2,0,2,0,9,1.2857142857142858,1,0.0,0,2,0,2,3,0,0,2,0,4,5,1
10021,144772,yB2j2tPO2DVKCBBdsLv8a1lbHtfWINMh,A3fsA9Zfv1X2fVEQhTw51lKENdNrEqT3,29,29,23,0,18,0,8,0,78,11.142857142857142,6,0.0,0,23,0,18,29,0,0,8,0,41,37,0
10022,144775,WQI2O3Oijx2QlB8hE2TltFPDzjM5E22B,A3fsA9Zfv1X2fVEQhTw51lKENdNrEqT3,1,0,0,0,0,0,1,0,1,0.14285714285714285,1,0.0,0,0,0,0,0,0,0,1,0,0,1,1
10023,144776,jOKGDo32k5y1tQ1HBtDhmlq3GlvnMuW4,RXDvfPUBYFlVdlueBFbLW0mhhAyGEqpt,5,2,1,0,1,0,2,0,6,0.8571428571428571,1,0.0,0,1,0,1,2,0,0,2,0,2,4,1
10024,144791,qhMicTW8kXbgpTyOx2V27yOmKQOouISe,SpATywNh6bZuzm8s1ceuBUnMUAeoAHHw,17,19,8,19,3,5,7,1,62,8.857142857142858,2,0.0,8,8,16,3,11,5,3,7,1,35,27,1
10025,144792,PbpiZjozcQl91esiggJPwCEQesHzXMge,SpATywNh6bZuzm8s1ceuBUnMUAeoAHHw,4,2,0,0,0,0,3,0,5,0.7142857142857143,1,0.0,0,0,0,0,2,0,0,3,0,0,5,1
10026,144793,Q4yECXO7W1LpqtiMAu4zBn3zpNL7asTt,RXDvfPUBYFlVdlueBFbLW0mhhAyGEqpt,30,29,3,49,2,5,12,3,103,14.714285714285714,7,0.0,5,3,45,2,24,5,4,12,3,55,48,1
10027,144807,jOmJWWKjeEAibobmUGCNZpRQTVi2zu3q,SpATywNh6bZuzm8s1ceuBUnMUAeoAHHw,5,2,1,0,1,0,3,0,7,1.0,1,0.0,0,1,0,1,2,0,0,3,0,2,5,1
10028,144812,2plfHoT1TmtCwY9OYRzSThXWtZ22ORll,SpATywNh6bZuzm8s1ceuBUnMUAeoAHHw,4,3,1,0,1,0,1,0,6,0.8571428571428571,1,0.0,0,1,0,1,3,0,0,1,0,2,4,1
10029,144816,kQbCL3ZvWis8hkLoQgkRd3flhuUVeNwO,SpATywNh6bZuzm8s1ceuBUnMUAeoAHHw,5,2,0,0,1,0,2,0,5,0.7142857142857143,1,0.0,0,0,0,1,2,0,0,2,0,1,4,1
10030,144821,CQWretzMoQOL7mDTUjZusG4cd4L6wPQK,SpATywNh6bZuzm8s1ceuBUnMUAeoAHHw,11,8,6,0,4,0,3,0,21,3.0,2,0.0,0,6,0,4,8,0,0,3,0,10,11,1
10031,144822,0xrj8jMy7DRmz2206OV6CH0SXBZh0mT4,A3fsA9Zfv1X2fVEQhTw51lKENdNrEqT3,7,3,2,0,2,0,2,0,9,1.2857142857142858,1,0.0,0,2,0,2,3,0,0,2,0,4,5,0
10032,144828,KiabjnGWKx4XDSpmz6cnPElBww0X3aaK,SpATywNh6bZuzm8s1ceuBUnMUAeoAHHw,16,21,7,22,3,0,5,0,58,8.285714285714286,1,0.0,9,7,19,3,12,0,3,5,0,38,20,1
10033,144838,afGDIbGbSLFIkIVgYTcsM0nZrlLAYXP9,SpATywNh6bZuzm8s1ceuBUnMUAeoAHHw,10,9,6,0,5,1,20,1,42,6.0,2,0.0,0,6,0,5,9,1,0,20,1,11,31,1
10034,144839,59I5in7ieFGusS8qxVtrv60LZ3ifOtyr,A3fsA9Zfv1X2fVEQhTw51lKENdNrEqT3,3,3,0,0,0,0,2,0,5,0.7142857142857143,2,0.0,0,0,0,0,3,0,0,2,0,0,5,1
10035,144841,5o27t78wmU6kJM7l11bepi10qooi6vTp,A3fsA9Zfv1X2fVEQhTw51lKENdNrEqT3,3,0,0,0,0,2,2,0,4,0.5714285714285714,1,0.0,0,0,0,0,0,2,0,2,0,0,4,1
10036,144845,FfUXMT7mZqZTunyhx99wOtQUuUI4jlLj,A3fsA9Zfv1X2fVEQhTw51lKENdNrEqT3,11,7,4,0,4,0,2,0,17,2.4285714285714284,2,0.0,0,4,0,4,7,0,0,2,0,8,9,1
10037,144851,Msnkbi5gSjnXMGVMwapulzDXPJT7PsEO,RXDvfPUBYFlVdlueBFbLW0mhhAyGEqpt,2,0,0,0,0,0,2,0,2,0.2857142857142857,1,0.0,0,0,0,0,0,0,0,2,0,0,2,1
10038,144856,raoWM7iEQ4dq4BWNCSh69Fo9jIIvs47M,RXDvfPUBYFlVdlueBFbLW0mhhAyGEqpt,1,0,0,0,0,0,1,0,1,0.14285714285714285,1,0.0,0,0,0,0,0,0,0,1,0,0,1,1
10039,144861,ytxaMMjv4jRoSu72s5GHMltMaCAqKKcw,A3fsA9Zfv1X2fVEQhTw51lKENdNrEqT3,6,4,1,0,0,0,4,0,9,1.2857142857142858,1,0.0,0,1,0,0,4,0,0,4,0,1,8,1
10040,144862,7ZV5hVKM33Il4ZphKUROohrBCk5SoM3Q,RXDvfPUBYFlVdlueBFbLW0mhhAyGEqpt,8,25,14,0,0,0,1,0,40,5.714285714285714,1,0.0,8,14,0,0,17,0,0,1,0,22,18,1
10041,144865,T9c92JfvB6Kfucc01WIFC70LXWVeMAod,SpATywNh6bZuzm8s1ceuBUnMUAeoAHHw,15,23,0,18,0,13,9,1,64,9.142857142857142,1,0.0,8,0,15,0,15,13,3,9,1,23,41,1
10042,144877,ooFElJ4ZPOLTBMQwigtvKfnHk0DNrR2R,bWdj2GDclj5ofokWjzoa5jAwMkxCykd6,2,0,0,0,0,0,2,0,2,0.2857142857142857,1,0.0,0,0,0,0,0,0,0,2,0,0,2,1
10043,144882,ng2LeRo6bYVrW9ExHXJ3akhqh2xVsMqB,G8EPVSXsOYB5YQWZGiz1aVq5Pgr2GrQu,6,4,0,0,1,4,2,0,11,1.5714285714285714,1,0.0,0,0,0,1,4,4,0,2,0,1,10,1
10044,144904,oIHEiOwjcaMd5CeWZdkq4rXU3yelDWwT,bWdj2GDclj5ofokWjzoa5jAwMkxCykd6,1,0,0,0,0,0,1,0,1,0.14285714285714285,1,0.0,0,0,0,0,0,0,0,1,0,0,1,1
10045,144918,PZdxFgKpeQmexjsFXHDQYKHzq3CXEabo,SpATywNh6bZuzm8s1ceuBUnMUAeoAHHw,7,2,2,0,2,0,2,0,8,1.1428571428571428,1,0.0,0,2,0,2,2,0,0,2,0,4,4,1
10046,144921,1ygmKyxuE9zTchPBrLxYZHBa3CxHnvGx,SpATywNh6bZuzm8s1ceuBUnMUAeoAHHw,1,0,0,0,0,0,1,0,1,0.14285714285714285,1,0.0,0,0,0,0,0,0,0,1,0,0,1,1
10047,144922,1whtO6jrHXBMnMCSb8vftfOcDZoI6lpk,SpATywNh6bZuzm8s1ceuBUnMUAeoAHHw,2,0,0,0,0,0,2,0,2,0.2857142857142857,1,0.0,0,0,0,0,0,0,0,2,0,0,2,1
10048,144930,0ItSpPGfnBPXWyzwV4fknfpLDkx7tWJ8,SpATywNh6bZuzm8s1ceuBUnMUAeoAHHw,1,0,0,0,0,0,1,0,1,0.14285714285714285,1,0.0,0,0,0,0,0,0,0,1,0,0,1,1
10049,144934,WiWr9LeARPPUMTXasnYbOZNxI6vKEOag,SpATywNh6bZuzm8s1ceuBUnMUAeoAHHw,9,12,8,0,6,0,3,0,29,4.142857142857143,1,0.0,0,8,0,6,12,0,0,3,0,14,15,0
10050,144942,sJvbEmQSLPUSlzQVliesQ54qeaDrLfvx,A3fsA9Zfv1X2fVEQhTw51lKENdNrEqT3,1,0,0,0,0,0,1,0,1,0.14285714285714285,1,0.0,0,0,0,0,0,0,0,1,0,0,1,0
10051,144962,Tknw6wFyBHibLmhWsLFULGANgYkknQHe,bWdj2GDclj5ofokWjzoa5jAwMkxCykd6,8,6,0,0,0,0,6,0,12,1.7142857142857142,2,0.0,0,0,0,0,6,0,0,6,0,0,12,1
10052,144964,5x6p4rljKsrejQoWBLOKiqqWs4gJF7v5,bWdj2GDclj5ofokWjzoa5jAwMkxCykd6,4,2,0,0,0,0,2,0,4,0.5714285714285714,1,0.0,0,0,0,0,2,0,0,2,0,0,4,1
10053,144979,AO5lBD55aLiSGI6wc1OCl02CqUcrTOsS,G8EPVSXsOYB5YQWZGiz1aVq5Pgr2GrQu,7,6,2,2,3,0,2,0,15,2.142857142857143,1,0.0,3,2,1,3,3,0,1,2,0,9,6,0
10054,144984,mco1H2E00EJyxVOQ1f2JUOahUZWPVYSV,G8EPVSXsOYB5YQWZGiz1aVq5Pgr2GrQu,12,16,11,0,5,1,9,0,42,6.0,3,0.0,0,11,0,5,16,1,0,9,0,16,26,1
10055,144988,r2BlY5kx3gPU1opGlfjFI0ngbnfS5jKE,bWdj2GDclj5ofokWjzoa5jAwMkxCykd6,1,0,0,0,0,0,2,0,2,0.2857142857142857,1,0.0,0,0,0,0,0,0,0,2,0,0,2,1
10056,144998,QbBXesiuS3b5lRVZqzzdKh71YLAIKh1k,A3fsA9Zfv1X2fVEQhTw51lKENdNrEqT3,25,19,12,0,8,2,13,2,56,8.0,3,0.0,0,12,0,8,19,2,0,13,2,20,36,0
10057,144999,KQvub9kHQ3XpwpO5JgmmZp67zs4af3TX,SpATywNh6bZuzm8s1ceuBUnMUAeoAHHw,9,7,4,0,1,2,8,1,23,3.2857142857142856,1,0.0,0,4,0,1,7,2,0,8,1,5,18,1
10058,145000,FsN3EYiAfRxm9msVQNiGujMlmaZjdiLV,A3fsA9Zfv1X2fVEQhTw51lKENdNrEqT3,10,5,3,0,2,0,6,0,16,2.2857142857142856,2,0.0,0,3,0,2,5,0,0,6,0,5,11,1
10059,145001,cZxcDNlAnm0tcnrjnkTKyh2S3nRuNP2Z,G8EPVSXsOYB5YQWZGiz1aVq5Pgr2GrQu,7,5,1,0,1,0,3,0,10,1.4285714285714286,1,0.0,2,1,0,1,3,0,0,3,0,4,6,1
10060,145005,GkMFrAPlA6A09ccGhHn8t14lF9MeMrXS,SpATywNh6bZuzm8s1ceuBUnMUAeoAHHw,4,5,2,0,0,0,1,0,8,1.1428571428571428,1,0.0,0,2,0,0,5,0,0,1,0,2,6,1
10061,145008,1ORn2IwJawkKgC86QfIvIvcPRotoBurY,RXDvfPUBYFlVdlueBFbLW0mhhAyGEqpt,1,0,0,0,0,0,1,0,1,0.14285714285714285,1,0.0,0,0,0,0,0,0,0,1,0,0,1,1
10062,145013,yIWNRaHiP3wQHGf1Y6WI0xVXEdSpULNT,SpATywNh6bZuzm8s1ceuBUnMUAeoAHHw,6,3,2,0,2,0,1,0,8,1.1428571428571428,1,0.0,0,2,0,2,3,0,0,1,0,4,4,1
10063,145018,sPPWsacmUhKicl9IkMyPoW9C9Hv6wkAR,SpATywNh6bZuzm8s1ceuBUnMUAeoAHHw,11,13,2,0,1,0,4,0,20,2.857142857142857,2,0.0,0,2,0,1,13,0,0,4,0,3,17,1
10064,145030,ZvJHkcI26nhwqsVV9yaOoOyrIpy66iPT,A3fsA9Zfv1X2fVEQhTw51lKENdNrEqT3,6,6,1,0,1,0,1,0,9,1.2857142857142858,1,0.0,0,1,0,1,6,0,0,1,0,2,7,1
10065,145041,yIWNRaHiP3wQHGf1Y6WI0xVXEdSpULNT,bWdj2GDclj5ofokWjzoa5jAwMkxCykd6,5,2,1,0,1,0,2,0,6,0.8571428571428571,1,0.0,0,1,0,1,2,0,0,2,0,2,4,1
10066,145052,xvgAWMkP6HI1IM5orrHyjEEETuOd15kx,A3fsA9Zfv1X2fVEQhTw51lKENdNrEqT3,1,0,0,0,0,0,1,0,1,0.14285714285714285,1,0.0,0,0,0,0,0,0,0,1,0,0,1,1
10067,145055,rL34nWMQELY22w9bM5KXtMtPPdNRd6Vz,bWdj2GDclj5ofokWjzoa5jAwMkxCykd6,8,4,3,0,3,0,2,0,12,1.7142857142857142,1,0.0,0,3,0,3,4,0,0,2,0,6,6,1
10068,145059,0ZuqaZpF1uAdriF9eidLtJ5iuMfVy2xj,SpATywNh6bZuzm8s1ceuBUnMUAeoAHHw,11,16,4,0,2,10,5,0,37,5.285714285714286,2,0.0,0,4,0,2,16,10,0,5,0,6,31,1
10069,145106,DyTFy9Maa2ONHa1kuv16yd2JfoXtDQiQ,A3fsA9Zfv1X2fVEQhTw51lKENdNrEqT3,2,0,0,0,0,0,2,0,2,0.2857142857142857,1,0.0,0,0,0,0,0,0,0,2,0,0,2,1
10070,145109,PnK7IG5mVnL9F5P0hCKqF8uvfGfnI7Zr,SpATywNh6bZuzm8s1ceuBUnMUAeoAHHw,18,15,8,14,3,1,23,4,68,9.714285714285714,2,0.0,5,8,11,3,10,1,3,23,4,27,41,1
10071,145115,s4uxePGHFu7vUUg0QFSUrIPUr6ntECxH,SpATywNh6bZuzm8s1ceuBUnMUAeoAHHw,11,4,3,0,2,1,8,1,19,2.7142857142857144,2,0.0,0,3,0,2,4,1,0,8,1,5,14,1
10072,145116,TQ3ME8oXFjG9uPuJF9DlrWFS3Mh17Asw,SpATywNh6bZuzm8s1ceuBUnMUAeoAHHw,12,14,1,12,0,7,7,1,42,6.0,1,0.0,6,1,9,0,8,7,3,7,1,16,26,1
10073,145118,QoxAfK1F7spDZI2801beWPeXZSdQfP03,SpATywNh6bZuzm8s1ceuBUnMUAeoAHHw,9,14,1,9,0,16,5,0,45,6.428571428571429,2,0.0,10,1,9,0,4,16,0,5,0,20,25,1
10074,145120,iMAPtNJrTh9vdZVbGuGpFbwdggkaxy45,SpATywNh6bZuzm8s1ceuBUnMUAeoAHHw,13,14,9,0,5,4,6,0,38,5.428571428571429,2,0.0,2,9,0,5,12,4,0,6,0,16,22,1
10075,145134,nA58ZDkDJW4coPbkDAFQTIrhFRBe6rSy,G8EPVSXsOYB5YQWZGiz1aVq5Pgr2GrQu,8,14,2,0,0,0,4,0,20,2.857142857142857,2,0.0,4,2,0,0,10,0,0,4,0,6,14,1
10076,145135,ryorMC5bEintyqBNOh5gLfjxAx4QoH5u,A3fsA9Zfv1X2fVEQhTw51lKENdNrEqT3,17,22,13,0,4,12,19,3,73,10.428571428571429,2,0.0,1,13,0,4,21,12,0,19,3,18,55,1
10077,145137,yCZXjIGq001xO7v4MWCrl9HykbxmZHu1,SpATywNh6bZuzm8s1ceuBUnMUAeoAHHw,13,32,11,38,0,0,3,0,84,12.0,2,0.0,18,11,30,0,14,0,8,3,0,59,25,0
10078,145143,sytW49I21SJ70ElOkXGU5SHeeHl1E3fL,RXDvfPUBYFlVdlueBFbLW0mhhAyGEqpt,1,0,0,0,0,0,1,0,1,0.14285714285714285,1,0.0,0,0,0,0,0,0,0,1,0,0,1,1
10079,145155,BohRHH2vBIgnEZGZjM3WnHwJbVFmITRG,bWdj2GDclj5ofokWjzoa5jAwMkxCykd6,1,0,0,0,0,0,2,0,2,0.2857142857142857,1,0.0,0,0,0,0,0,0,0,2,0,0,2,1
10080,145161,K9rvD8Iu0wq956P4CDD0WYKLX5TfMvJ0,SpATywNh6bZuzm8s1ceuBUnMUAeoAHHw,7,3,2,0,2,0,3,0,10,1.4285714285714286,2,0.0,0,2,0,2,3,0,0,3,0,4,6,1
10081,145165,6h1KbHhbSaGcIKRFEHiX0UdDPCB3E5BQ,A3fsA9Zfv1X2fVEQhTw51lKENdNrEqT3,7,3,2,0,2,0,3,0,10,1.4285714285714286,1,0.0,0,2,0,2,3,0,0,3,0,4,6,1
10082,145167,q1fsTZpD3tHg9RFkIri5aJQcs8ZtVzZU,A3fsA9Zfv1X2fVEQhTw51lKENdNrEqT3,1,0,0,0,0,0,1,0,1,0.14285714285714285,1,0.0,0,0,0,0,0,0,0,1,0,0,1,1
10083,145182,JkokNSOVQ0CmVMNuEphopYOXBxfXEJtF,SpATywNh6bZuzm8s1ceuBUnMUAeoAHHw,16,38,13,19,3,0,10,0,83,11.857142857142858,4,0.0,19,13,17,3,19,0,2,10,0,52,31,1
10084,145183,l5XRpi9H4fQ2XUHeEPRXRHL6Y4BckIOB,bWdj2GDclj5ofokWjzoa5jAwMkxCykd6,6,13,4,0,5,0,2,0,24,3.4285714285714284,3,0.0,4,4,0,5,9,0,0,2,0,13,11,1
10085,145195,XOKsEN36DokXwcr1smPc9nspsVQlK0Oq,bWdj2GDclj5ofokWjzoa5jAwMkxCykd6,5,2,1,0,0,0,3,0,6,0.8571428571428571,1,0.0,0,1,0,0,2,0,0,3,0,1,5,1
10086,145204,HnmJeuwsJxtO6k1CT8974Qo3Mu0GibPm,SpATywNh6bZuzm8s1ceuBUnMUAeoAHHw,6,3,1,0,1,0,3,0,8,1.1428571428571428,1,0.0,0,1,0,1,3,0,0,3,0,2,6,1
10087,145206,GQtHf5FrRCd4lKlDjEvxcTzFdncOzUUt,SpATywNh6bZuzm8s1ceuBUnMUAeoAHHw,4,2,0,0,0,0,3,0,5,0.7142857142857143,2,0.0,0,0,0,0,2,0,0,3,0,0,5,1
10088,145208,oGbJmKuU02t3nWH0tibgF9TroQlaGQUL,SpATywNh6bZuzm8s1ceuBUnMUAeoAHHw,13,14,8,0,3,0,10,0,35,5.0,1,0.0,2,8,0,3,12,0,0,10,0,13,22,1
10089,145217,TvUMV7rQqIP7XtKwTDDoLxmalP29Ttuw,SpATywNh6bZuzm8s1ceuBUnMUAeoAHHw,15,15,5,20,3,0,3,0,46,6.571428571428571,1,0.0,9,5,17,3,6,0,3,3,0,34,12,1
10090,145226,OpGwtUbMGweipJr0vMybah9tM3IHgiea,G8EPVSXsOYB5YQWZGiz1aVq5Pgr2GrQu,7,8,0,0,0,0,3,0,11,1.5714285714285714,1,0.0,0,0,0,0,8,0,0,3,0,0,11,1
10091,145236,DaYS7gf8DVgCD84ya5YqgMFFiGYw1ps2,bWdj2GDclj5ofokWjzoa5jAwMkxCykd6,10,14,1,0,3,0,7,1,26,3.7142857142857144,2,0.0,5,1,0,3,9,0,0,7,1,9,17,1
10092,145239,OtjE6pGePvcycREQhVmfTMoFJDvUV70D,SpATywNh6bZuzm8s1ceuBUnMUAeoAHHw,11,6,5,2,2,0,3,0,18,2.5714285714285716,1,0.0,0,5,2,2,6,0,0,3,0,9,9,1
10093,145253,5CjxInsWcHYdL9qJZYHVK4nh5ZsDhwos,A3fsA9Zfv1X2fVEQhTw51lKENdNrEqT3,6,3,1,0,1,0,2,0,7,1.0,1,0.0,0,1,0,1,3,0,0,2,0,2,5,1
10094,145259,5CjxInsWcHYdL9qJZYHVK4nh5ZsDhwos,bWdj2GDclj5ofokWjzoa5jAwMkxCykd6,10,16,3,0,3,2,7,1,32,4.571428571428571,2,0.0,0,3,0,3,16,2,0,7,1,6,26,1
10095,145264,EvNxwwShcQXgwZllGhuS7z5fGOL08A9A,G8EPVSXsOYB5YQWZGiz1aVq5Pgr2GrQu,1,0,0,0,0,0,1,0,1,0.14285714285714285,1,0.0,0,0,0,0,0,0,0,1,0,0,1,1
10096,145306,gB1oK8asvoVWRzgcHWrM4vY7Z3TLvmEu,G8EPVSXsOYB5YQWZGiz1aVq5Pgr2GrQu,14,29,2,0,2,1,14,1,49,7.0,2,0.0,0,2,0,2,29,1,0,14,1,4,45,1
10097,145308,UdRvlfQEjfzv2meiEECQoQ6VdSnYEWcK,bWdj2GDclj5ofokWjzoa5jAwMkxCykd6,1,0,0,0,0,0,1,0,1,0.14285714285714285,1,0.0,0,0,0,0,0,0,0,1,0,0,1,1
10098,145314,0G4cec511TtDyNtXCTS7DRIqOcOGSzxj,bWdj2GDclj5ofokWjzoa5jAwMkxCykd6,2,0,0,0,0,0,4,0,4,0.5714285714285714,2,0.0,0,0,0,0,0,0,0,4,0,0,4,1
10099,145324,eb3SHueTE6ugnDkhYnh0RBSPDS20VwLZ,SpATywNh6bZuzm8s1ceuBUnMUAeoAHHw,10,13,6,0,3,0,4,0,26,3.7142857142857144,2,0.0,2,6,0,3,11,0,0,4,0,11,15,1
10100,145327,fB0i7xObEYSWbMZwNEun6y9gdH9iF6Ca,bWdj2GDclj5ofokWjzoa5jAwMkxCykd6,6,4,1,0,0,0,3,0,8,1.1428571428571428,1,0.0,0,1,0,0,4,0,0,3,0,1,7,1
10101,145344,rrHRbXLg6i4u3JAIzGOFXJzGViekqHta,A3fsA9Zfv1X2fVEQhTw51lKENdNrEqT3,5,4,2,0,1,1,3,0,11,1.5714285714285714,2,0.0,0,2,0,1,4,1,0,3,0,3,8,1
10102,145354,KF5OPToc2HXGCGomze0nhcEx5XKSQ0eb,A3fsA9Zfv1X2fVEQhTw51lKENdNrEqT3,1,0,0,0,0,0,1,0,1,0.14285714285714285,1,0.0,0,0,0,0,0,0,0,1,0,0,1,1
10103,145359,KF5OPToc2HXGCGomze0nhcEx5XKSQ0eb,bWdj2GDclj5ofokWjzoa5jAwMkxCykd6,7,6,1,0,0,0,5,1,13,1.8571428571428572,2,0.0,0,1,0,0,6,0,0,5,1,1,12,1
10104,145362,UTEysxng8QdAA1HDzCSMUfK51MYoUK0I,SpATywNh6bZuzm8s1ceuBUnMUAeoAHHw,18,23,8,17,3,1,9,1,62,8.857142857142858,2,0.0,10,8,15,3,13,1,2,9,1,36,26,1
10105,145365,pG2ElR6wLgS0VIoYkLxmyVPOZz4q1huq,SpATywNh6bZuzm8s1ceuBUnMUAeoAHHw,5,3,1,0,1,0,4,0,9,1.2857142857142858,1,0.0,0,1,0,1,3,0,0,4,0,2,7,1
10106,145367,D9K6eWkEOoVrLczNZaGo49KoERtz2c6V,SpATywNh6bZuzm8s1ceuBUnMUAeoAHHw,16,23,13,11,4,0,6,0,57,8.142857142857142,4,0.0,4,13,10,4,19,0,1,6,0,31,26,1
10107,145368,705a1tvxnZT7omctMx7Fjakho000VDxN,A3fsA9Zfv1X2fVEQhTw51lKENdNrEqT3,1,0,0,0,0,0,2,0,2,0.2857142857142857,1,0.0,0,0,0,0,0,0,0,2,0,0,2,1
10108,145378,cMwTVyssxspl1RAprFyXqPmiVK2Z3yGe,SpATywNh6bZuzm8s1ceuBUnMUAeoAHHw,6,3,1,0,1,0,2,0,7,1.0,1,0.0,0,1,0,1,3,0,0,2,0,2,5,1
10109,145380,hZsYKh9WLvB4Wt2hCg4xVcKygpRAuxj7,A3fsA9Zfv1X2fVEQhTw51lKENdNrEqT3,25,10,9,16,8,0,4,0,47,6.714285714285714,2,0.0,0,9,14,8,10,0,2,4,0,31,16,1
10110,145389,TRYKApgWJsELbbCq5WSkTNwaxvbHHyCj,A3fsA9Zfv1X2fVEQhTw51lKENdNrEqT3,2,0,0,0,0,0,3,0,3,0.42857142857142855,1,0.0,0,0,0,0,0,0,0,3,0,0,3,1
10111,145391,H1aKLEBJtpAOAOCXptqn2WzikG0W6HkP,SpATywNh6bZuzm8s1ceuBUnMUAeoAHHw,3,0,0,0,0,0,2,1,3,0.42857142857142855,1,0.0,0,0,0,0,0,0,0,2,1,0,3,1
10112,145403,NO22WSq5lVGwq6WPEcqalEaMjYIZxX3u,SpATywNh6bZuzm8s1ceuBUnMUAeoAHHw,4,2,0,0,0,0,2,0,4,0.5714285714285714,2,0.0,0,0,0,0,2,0,0,2,0,0,4,1
10113,145411,sETZmDR5b3CheYe2K5IvWb1lrRsZmOT8,bWdj2GDclj5ofokWjzoa5jAwMkxCykd6,7,4,0,0,0,0,6,1,11,1.5714285714285714,2,0.0,0,0,0,0,4,0,0,6,1,0,11,1
10114,145461,XGghmqZSDFp0iwrgmPDUKXBdusY5a7fx,bWdj2GDclj5ofokWjzoa5jAwMkxCykd6,4,3,1,0,1,0,1,0,6,0.8571428571428571,1,0.0,0,1,0,1,3,0,0,1,0,2,4,1
10115,145471,cRlXLJdkIX4KH74JKLBjP86zQb3lppxR,A3fsA9Zfv1X2fVEQhTw51lKENdNrEqT3,9,4,3,0,3,0,2,0,12,1.7142857142857142,1,0.0,0,3,0,3,4,0,0,2,0,6,6,1
10116,145473,UNqMz63UOiLuXMnJzd7YWyfD3qIuNdaK,A3fsA9Zfv1X2fVEQhTw51lKENdNrEqT3,96,26,21,176,17,0,13,0,253,36.142857142857146,4,0.0,3,21,158,17,23,0,18,13,0,199,54,1
10117,145474,cRlXLJdkIX4KH74JKLBjP86zQb3lppxR,SpATywNh6bZuzm8s1ceuBUnMUAeoAHHw,5,2,1,0,1,0,2,0,6,0.8571428571428571,1,0.0,0,1,0,1,2,0,0,2,0,2,4,1
10118,145483,wAirqcgeWs2CREKJhWAsWOo902skDwiw,SpATywNh6bZuzm8s1ceuBUnMUAeoAHHw,1,0,0,0,0,0,1,0,1,0.14285714285714285,1,0.0,0,0,0,0,0,0,0,1,0,0,1,1
10119,145487,3nvYm1DKrH5EOHAw44wBVldk53PpV7TA,A3fsA9Zfv1X2fVEQhTw51lKENdNrEqT3,14,10,7,0,5,2,2,0,26,3.7142857142857144,1,0.0,0,7,0,5,10,2,0,2,0,12,14,1
10120,145490,cKkpvGwYNdrpPwFgGI1Q3ssqlyxAIVaB,SpATywNh6bZuzm8s1ceuBUnMUAeoAHHw,7,7,4,0,3,0,1,0,15,2.142857142857143,1,0.0,2,4,0,3,5,0,0,1,0,9,6,1
10121,145493,BQyaQ0QwoGWbtLuf0oWIdmIpVjKe7O2x,A3fsA9Zfv1X2fVEQhTw51lKENdNrEqT3,7,4,3,0,2,0,2,0,11,1.5714285714285714,1,0.0,0,3,0,2,4,0,0,2,0,5,6,1
10122,145494,ySy2zYThCkVZr5MjEXuKxq60wfOynxkJ,bWdj2GDclj5ofokWjzoa5jAwMkxCykd6,1,0,0,0,0,0,1,0,1,0.14285714285714285,1,0.0,0,0,0,0,0,0,0,1,0,0,1,1
10123,145496,zhoGGW9mWTf0e7saIpd0Zh4kN5TE5GWq,SpATywNh6bZuzm8s1ceuBUnMUAeoAHHw,10,8,2,0,1,0,7,0,18,2.5714285714285716,1,0.0,0,2,0,1,8,0,0,7,0,3,15,1
10124,145522,vbUXBKy2vKu4AOOOd2rJki0btGiFQNDk,G8EPVSXsOYB5YQWZGiz1aVq5Pgr2GrQu,1,0,0,0,0,0,1,0,1,0.14285714285714285,1,0.0,0,0,0,0,0,0,0,1,0,0,1,1
10125,145525,x9kyeNXnVmIKLkyrDIOwE7AbD5ZpbAEs,RXDvfPUBYFlVdlueBFbLW0mhhAyGEqpt,1,0,0,0,0,0,1,0,1,0.14285714285714285,1,0.0,0,0,0,0,0,0,0,1,0,0,1,1
10126,145545,2CCQpD8tgu5ha7nXCDy4k1uINvkP56Wv,7GRhBDsirIGkRZBtSMEzNTyDr2JQm4xx,2,0,0,0,0,0,5,0,5,0.7142857142857143,1,0.0,0,0,0,0,0,0,0,5,0,0,5,1
10127,145547,rT3zpA0g6rjJ1jZXfn6mCIcHmMcmU756,7GRhBDsirIGkRZBtSMEzNTyDr2JQm4xx,44,62,22,54,23,1,14,0,176,25.142857142857142,3,0.0,30,22,44,23,32,1,10,14,0,119,57,0
10128,145550,RuTxY8DaJW8mZYxEAeQrQJD3l4wbq41Q,7GRhBDsirIGkRZBtSMEzNTyDr2JQm4xx,6,3,0,0,0,0,3,0,6,0.8571428571428571,1,0.0,0,0,0,0,3,0,0,3,0,0,6,0
10129,145552,J9NhhdMcyji8QpxegDrg5mXOQMf3xBRf,7GRhBDsirIGkRZBtSMEzNTyDr2JQm4xx,1,0,0,0,0,0,1,0,1,0.14285714285714285,1,0.0,0,0,0,0,0,0,0,1,0,0,1,1
10130,145560,vGQAID39BKk1FvQYReBWX247x3QlYrgz,7GRhBDsirIGkRZBtSMEzNTyDr2JQm4xx,6,15,4,0,1,0,2,0,22,3.142857142857143,1,0.0,6,4,0,1,9,0,0,2,0,11,11,1
10131,145583,iiP1QVGLP2M3sIU07s5hEwnMnf9UaC7w,7GRhBDsirIGkRZBtSMEzNTyDr2JQm4xx,5,3,1,0,1,0,1,0,6,0.8571428571428571,1,0.0,0,1,0,1,3,0,0,1,0,2,4,1
10132,145608,3kzqQ9nu0puySXndbv8HvzuMPwBlBjfc,7GRhBDsirIGkRZBtSMEzNTyDr2JQm4xx,25,68,19,31,6,9,25,1,159,22.714285714285715,4,0.0,32,19,22,6,36,9,9,25,1,79,80,1
10133,145620,S9UJJr8IVX3RcksPSP43kxazIyd4D4o5,7GRhBDsirIGkRZBtSMEzNTyDr2JQm4xx,1,0,0,0,0,0,1,0,1,0.14285714285714285,1,0.0,0,0,0,0,0,0,0,1,0,0,1,1
10134,145622,520kTOJ5a6HoTMe30flreSub2cyQqOhY,7GRhBDsirIGkRZBtSMEzNTyDr2JQm4xx,30,79,31,52,19,11,6,0,198,28.285714285714285,3,0.0,37,31,45,19,42,11,7,6,0,132,66,1
10135,145653,NCnx21IrphITLHEQy42s0jDfFa8Z92Kq,7GRhBDsirIGkRZBtSMEzNTyDr2JQm4xx,27,32,0,48,6,3,2,0,91,13.0,1,0.0,21,0,43,6,11,3,5,2,0,70,21,1
10136,145667,dNsNKeQao2yeFH4xZSLIDRMA5I5s2F7t,7GRhBDsirIGkRZBtSMEzNTyDr2JQm4xx,10,4,1,4,0,1,8,1,19,2.7142857142857144,1,0.0,2,1,3,0,2,1,1,8,1,6,13,1
10137,145672,J2mZhHnfnDU9Z2NM0dfjKg8jCciGVkrO,7GRhBDsirIGkRZBtSMEzNTyDr2JQm4xx,1,0,0,0,0,0,1,0,1,0.14285714285714285,1,0.0,0,0,0,0,0,0,0,1,0,0,1,1
10138,145700,4w6yJxocEKgAV94E61slsyKYrolKgTdS,7GRhBDsirIGkRZBtSMEzNTyDr2JQm4xx,2,0,0,0,0,0,2,0,2,0.2857142857142857,1,0.0,0,0,0,0,0,0,0,2,0,0,2,1
10139,145706,VQbP5QE49Z71QPyvJxZhD4TLO56u1QUG,7GRhBDsirIGkRZBtSMEzNTyDr2JQm4xx,10,11,3,9,2,0,2,0,27,3.857142857142857,1,0.0,7,3,8,2,4,0,1,2,0,20,7,1
10140,145733,j2PX858BWhrQRgl6BBT72xW4SDvQKpBb,7GRhBDsirIGkRZBtSMEzNTyDr2JQm4xx,1,0,0,0,0,0,1,0,1,0.14285714285714285,1,0.0,0,0,0,0,0,0,0,1,0,0,1,1
10141,145753,6UQSgDDlbey2YMMKaSOEpDJ0KQllZPpX,7GRhBDsirIGkRZBtSMEzNTyDr2JQm4xx,4,0,0,0,0,0,4,0,4,0.5714285714285714,1,0.0,0,0,0,0,0,0,0,4,0,0,4,1
10142,145763,lnkkWGyIr1b44KiKgAFL6qVeebRfNJt3,7GRhBDsirIGkRZBtSMEzNTyDr2JQm4xx,17,28,0,37,0,0,4,0,69,9.857142857142858,2,0.0,16,0,32,0,12,0,5,4,0,48,21,1
10143,145766,IL2QJO9D8DzgZ0CQ8CMzPpcGTIPKd3bR,7GRhBDsirIGkRZBtSMEzNTyDr2JQm4xx,1,0,0,0,0,0,1,0,1,0.14285714285714285,1,0.0,0,0,0,0,0,0,0,1,0,0,1,1
10144,145774,UtbznsHbbIxKlUqw2M2px85X4bXZRgMG,7GRhBDsirIGkRZBtSMEzNTyDr2JQm4xx,1,0,0,0,0,0,1,0,1,0.14285714285714285,1,0.0,0,0,0,0,0,0,0,1,0,0,1,1
10145,145785,r1hSpHaWwriGvone6pflJV8zZcv0Gdcl,7GRhBDsirIGkRZBtSMEzNTyDr2JQm4xx,2,0,0,0,0,0,2,0,2,0.2857142857142857,1,0.0,0,0,0,0,0,0,0,2,0,0,2,1
10146,145795,yEBTzrvNFAmfa9M4QYcbmiIM6sJKI3UY,7GRhBDsirIGkRZBtSMEzNTyDr2JQm4xx,2,0,0,0,0,0,4,0,4,0.5714285714285714,1,0.0,0,0,0,0,0,0,0,4,0,0,4,1
10147,145817,sqxWpMhcYtYMOXwrr0icUXKE79UdB0Zx,7GRhBDsirIGkRZBtSMEzNTyDr2JQm4xx,16,28,2,2,2,0,10,1,45,6.428571428571429,3,0.0,1,2,2,2,27,0,0,10,1,7,38,1
10148,145827,dgFOOUSNfQK8xIrT47Av0Q04bBFeE21W,7GRhBDsirIGkRZBtSMEzNTyDr2JQm4xx,1,0,0,0,0,0,1,0,1,0.14285714285714285,1,0.0,0,0,0,0,0,0,0,1,0,0,1,0
10149,145897,amg8X8B8QF6NtkilqTdjsvKuhYv7sNrc,7GRhBDsirIGkRZBtSMEzNTyDr2JQm4xx,5,7,2,0,0,0,2,0,11,1.5714285714285714,1,0.0,0,2,0,0,7,0,0,2,0,2,9,1
10150,145980,HAj954mCjfBGJQsjyOUvywwmDcTn3cfv,7GRhBDsirIGkRZBtSMEzNTyDr2JQm4xx,3,2,1,0,0,0,1,0,4,0.5714285714285714,1,0.0,0,1,0,0,2,0,0,1,0,1,3,1
10151,145993,FTJVq9TWMdAK3okD5xbyDXGZ8r3m7Y4p,7GRhBDsirIGkRZBtSMEzNTyDr2JQm4xx,3,2,0,0,0,0,1,0,3,0.42857142857142855,1,0.0,0,0,0,0,2,0,0,1,0,0,3,1
10152,145997,xZ2FRlEfvjMgYQGaQTIBwdHmWyFrjfGH,7GRhBDsirIGkRZBtSMEzNTyDr2JQm4xx,2,1,0,0,0,0,2,0,3,0.42857142857142855,1,0.0,0,0,0,0,1,0,0,2,0,0,3,0
10153,146003,0Jy5agBaIEKZmcjIoKNgJ60hHPcSDAap,7GRhBDsirIGkRZBtSMEzNTyDr2JQm4xx,1,0,0,0,0,0,1,0,1,0.14285714285714285,1,0.0,0,0,0,0,0,0,0,1,0,0,1,1
10154,146593,dnF4V3J1QcZ16kz7ecUJEPAkM9rOV7wb,7GRhBDsirIGkRZBtSMEzNTyDr2JQm4xx,1,0,0,0,0,0,1,0,1,0.14285714285714285,1,0.0,0,0,0,0,0,0,0,1,0,0,1,1
10155,146597,hZ1mlUhiSpFjS9yt4BS7Q5R6oePk7XBR,7GRhBDsirIGkRZBtSMEzNTyDr2JQm4xx,2,0,0,0,0,0,2,0,2,0.2857142857142857,1,0.0,0,0,0,0,0,0,0,2,0,0,2,1
10156,146615,rmeg7X4GVDaLpVKMtXig1xBKyxmbOLNP,7GRhBDsirIGkRZBtSMEzNTyDr2JQm4xx,1,0,0,0,0,0,1,0,1,0.14285714285714285,1,0.0,0,0,0,0,0,0,0,1,0,0,1,0
10157,146916,nC3nlEcInfZBkfWiBAFT0QImutSJIRDp,RXDvfPUBYFlVdlueBFbLW0mhhAyGEqpt,1,0,0,0,0,0,1,0,1,0.14285714285714285,1,0.0,0,0,0,0,0,0,0,1,0,0,1,1
10158,146924,gNoniBDFX51Yjk2gJg2vMlrLeNPSUasm,G8EPVSXsOYB5YQWZGiz1aVq5Pgr2GrQu,1,0,0,0,0,0,2,0,2,0.2857142857142857,1,0.0,0,0,0,0,0,0,0,2,0,0,2,1
10159,146944,w8NrkUwgMqb3O2jCUrmWBqs2yypNb8dq,RXDvfPUBYFlVdlueBFbLW0mhhAyGEqpt,18,28,3,28,1,0,11,0,71,10.142857142857142,3,0.0,3,3,26,1,25,0,2,11,0,33,38,1
10160,147012,T9AvdYMob6A7XymtAVQOWMZ2VKIDwWSx,RXDvfPUBYFlVdlueBFbLW0mhhAyGEqpt,8,4,0,0,0,1,9,2,16,2.2857142857142856,3,0.0,0,0,0,0,4,1,0,9,2,0,16,1
10161,147075,wVwBkRoAPUoV5PewFP4svSYnl1ZXoHnc,G8EPVSXsOYB5YQWZGiz1aVq5Pgr2GrQu,1,0,0,0,0,0,1,0,1,0.14285714285714285,1,0.0,0,0,0,0,0,0,0,1,0,0,1,1
10162,147096,MZsWffL53WPYhfyCR8aX3Mp9egHMC4ie,RXDvfPUBYFlVdlueBFbLW0mhhAyGEqpt,1,0,0,0,0,0,1,0,1,0.14285714285714285,1,0.0,0,0,0,0,0,0,0,1,0,0,1,1
10163,147103,114X1vLT3OTzchhxfRGg24FTsgrs6Boi,RXDvfPUBYFlVdlueBFbLW0mhhAyGEqpt,1,0,0,0,0,0,2,0,2,0.2857142857142857,1,0.0,0,0,0,0,0,0,0,2,0,0,2,1
10164,147112,sL5jw3pLWZoRI7avI17oM60mfF67Acgz,G8EPVSXsOYB5YQWZGiz1aVq5Pgr2GrQu,1,0,0,0,0,0,2,0,2,0.2857142857142857,2,0.0,0,0,0,0,0,0,0,2,0,0,2,0
10165,147144,a91ewPLjlp1X8KqwrnZISs7xgERRXuh7,RXDvfPUBYFlVdlueBFbLW0mhhAyGEqpt,1,0,0,0,0,0,1,0,1,0.14285714285714285,1,0.0,0,0,0,0,0,0,0,1,0,0,1,1
10166,147223,uUyznY5p2fw7hVKlngBtP5z29uUZt16H,RXDvfPUBYFlVdlueBFbLW0mhhAyGEqpt,1,0,0,0,0,0,1,0,1,0.14285714285714285,1,0.0,0,0,0,0,0,0,0,1,0,0,1,1
10167,147232,bkdCLvSthS1MubyKzxMCvPKPGG70pOZC,G8EPVSXsOYB5YQWZGiz1aVq5Pgr2GrQu,1,0,0,0,0,0,1,0,1,0.14285714285714285,1,0.0,0,0,0,0,0,0,0,1,0,0,1,0
10168,147287,yB2j2tPO2DVKCBBdsLv8a1lbHtfWINMh,RXDvfPUBYFlVdlueBFbLW0mhhAyGEqpt,1,0,0,0,0,0,1,0,1,0.14285714285714285,1,0.0,0,0,0,0,0,0,0,1,0,0,1,1
10169,147309,UfUYHtn7EFCFULfAAiVnfhKrcOfMt4Ug,G8EPVSXsOYB5YQWZGiz1aVq5Pgr2GrQu,1,0,0,0,0,0,1,0,1,0.14285714285714285,1,0.0,0,0,0,0,0,0,0,1,0,0,1,1
10170,147318,GONTKb318b2pNzO4RSf2Oav2TmqJo6yi,G8EPVSXsOYB5YQWZGiz1aVq5Pgr2GrQu,1,0,0,0,0,0,1,0,1,0.14285714285714285,1,0.0,0,0,0,0,0,0,0,1,0,0,1,1
10171,147344,fE8AsLCA0TCwN2lFIpEAgt949Oz2zi2M,G8EPVSXsOYB5YQWZGiz1aVq5Pgr2GrQu,1,0,0,0,0,0,1,0,1,0.14285714285714285,1,0.0,0,0,0,0,0,0,0,1,0,0,1,1
10172,147349,hRH67nWa9zgJtoi4yrmT3KmNMJoVcNRr,G8EPVSXsOYB5YQWZGiz1aVq5Pgr2GrQu,1,0,0,0,0,0,1,0,1,0.14285714285714285,1,0.0,0,0,0,0,0,0,0,1,0,0,1,1
10173,147376,aBcd5xuaSGFcCFUKcCSjEaSoJEfIPYAN,G8EPVSXsOYB5YQWZGiz1aVq5Pgr2GrQu,1,0,0,0,0,0,1,0,1,0.14285714285714285,1,0.0,0,0,0,0,0,0,0,1,0,0,1,1
10174,147407,SVxtFny9oPYbtoixSK2PAs9XNkM3e8hn,RXDvfPUBYFlVdlueBFbLW0mhhAyGEqpt,12,11,1,2,3,0,6,1,24,3.4285714285714284,2,0.0,4,1,2,3,7,0,0,6,1,10,14,1
10175,147416,Wi6NsYPSasqtq71046KwRwCUoJ7gSxqZ,G8EPVSXsOYB5YQWZGiz1aVq5Pgr2GrQu,29,42,24,44,0,38,28,3,179,25.571428571428573,3,0.0,12,24,30,0,30,38,14,28,3,66,113,1
10176,147480,SLkozwcHBufe0UPB64m4o1Ao551WfuNu,G8EPVSXsOYB5YQWZGiz1aVq5Pgr2GrQu,1,0,0,0,0,0,1,0,1,0.14285714285714285,1,0.0,0,0,0,0,0,0,0,1,0,0,1,1
10177,147501,Rw0pJvwCeS9P2HJebYz4vjMvliFwRI8o,G8EPVSXsOYB5YQWZGiz1aVq5Pgr2GrQu,9,2,1,0,1,0,7,2,13,1.8571428571428572,2,0.0,0,1,0,1,2,0,0,7,2,2,11,1
10178,147517,t3323TFWjEAQScP83AS7oMF9sZ2WNapI,G8EPVSXsOYB5YQWZGiz1aVq5Pgr2GrQu,1,0,0,0,0,0,1,0,1,0.14285714285714285,1,0.0,0,0,0,0,0,0,0,1,0,0,1,1
10179,147588,USLTnsAwagwK2c83KXd1SNEeENnzkTTo,RXDvfPUBYFlVdlueBFbLW0mhhAyGEqpt,1,0,0,0,0,0,1,0,1,0.14285714285714285,1,0.0,0,0,0,0,0,0,0,1,0,0,1,1
10180,147597,jN2uzyXO5CSzMfW3pp82AVUf4pDPwJuY,RXDvfPUBYFlVdlueBFbLW0mhhAyGEqpt,1,0,0,0,0,0,1,0,1,0.14285714285714285,1,0.0,0,0,0,0,0,0,0,1,0,0,1,1
10181,147600,cvwnd07iniLpbhx37I857HZu05eA9OFE,RXDvfPUBYFlVdlueBFbLW0mhhAyGEqpt,16,24,15,2,5,15,13,2,76,10.857142857142858,2,0.0,1,15,2,5,23,15,0,13,2,23,53,1
10182,147610,xLkdbbKQJbd2pVZCFImtrA3GPATvYGgD,G8EPVSXsOYB5YQWZGiz1aVq5Pgr2GrQu,1,0,0,0,0,0,1,0,1,0.14285714285714285,1,0.0,0,0,0,0,0,0,0,1,0,0,1,1
10183,147639,MU6JKjzSFjezaWPFdc0IJW3L2fftgaQZ,RXDvfPUBYFlVdlueBFbLW0mhhAyGEqpt,1,0,0,0,0,0,1,0,1,0.14285714285714285,1,0.0,0,0,0,0,0,0,0,1,0,0,1,1
10184,147658,htYzFBi86rzWlzEtyu7aNqTtL2SW6jzn,G8EPVSXsOYB5YQWZGiz1aVq5Pgr2GrQu,1,0,0,0,0,0,1,0,1,0.14285714285714285,1,0.0,0,0,0,0,0,0,0,1,0,0,1,1
10185,147673,5kCR1wjWWz9eEHdizA4crFyxKTH4mIdl,RXDvfPUBYFlVdlueBFbLW0mhhAyGEqpt,1,0,0,0,0,0,1,0,1,0.14285714285714285,1,0.0,0,0,0,0,0,0,0,1,0,0,1,1
10186,147711,Z96ghDF2SEO6eJyjMUuyfBwUaW4sni8D,G8EPVSXsOYB5YQWZGiz1aVq5Pgr2GrQu,11,21,3,4,3,0,4,1,36,5.142857142857143,2,0.0,11,3,2,3,10,0,2,4,1,19,17,1
10187,147717,i4fgy4BVHlpEBMVrUkI9gWLihOonqgFN,G8EPVSXsOYB5YQWZGiz1aVq5Pgr2GrQu,15,13,4,16,2,2,9,1,47,6.714285714285714,3,0.0,5,4,14,2,8,2,2,9,1,25,22,1
10188,147725,DJXPEOqclxMbkJva0g6MJfihz48JHIVn,G8EPVSXsOYB5YQWZGiz1aVq5Pgr2GrQu,1,0,0,0,0,0,1,0,1,0.14285714285714285,1,0.0,0,0,0,0,0,0,0,1,0,0,1,1
10189,147730,J5FkxM9o8L4y51xbaKwQjZuay8KpJMzH,G8EPVSXsOYB5YQWZGiz1aVq5Pgr2GrQu,1,0,0,0,0,0,1,0,1,0.14285714285714285,1,0.0,0,0,0,0,0,0,0,1,0,0,1,1
10190,147737,eXv6ACzt62C4hMSoDSIQMvmz4LEnGBtm,G8EPVSXsOYB5YQWZGiz1aVq5Pgr2GrQu,1,0,0,0,0,0,1,0,1,0.14285714285714285,1,0.0,0,0,0,0,0,0,0,1,0,0,1,1
10191,147758,jEGqrC42iEC0MkvaQaekkhZsW8YPZGtW,fbPkOYLVPtPgIt0MxizjfFJov3JbHyAi,1,0,0,0,0,0,1,0,1,0.14285714285714285,1,0.0,0,0,0,0,0,0,0,1,0,0,1,1
10192,147759,pFE82fh5DH8NUVtvV1y83suNQP2lNeAe,fbPkOYLVPtPgIt0MxizjfFJov3JbHyAi,7,11,5,0,2,0,4,0,22,3.142857142857143,3,0.0,1,5,0,2,10,0,0,4,0,8,14,1
10193,147761,6lr9avMLLLHkFmJUiXzIeIFidbBgUCxs,fbPkOYLVPtPgIt0MxizjfFJov3JbHyAi,4,2,1,0,1,0,2,0,6,0.8571428571428571,1,0.0,0,1,0,1,2,0,0,2,0,2,4,1
10194,147762,h6gp6OLQCLhKTyjanK3TbnUuf19NH0Ob,fbPkOYLVPtPgIt0MxizjfFJov3JbHyAi,1,0,0,0,0,0,1,0,1,0.14285714285714285,1,0.0,0,0,0,0,0,0,0,1,0,0,1,1
10195,147763,Eth5NiW62QeegjonEwzsKZ7huvzhHIVn,fbPkOYLVPtPgIt0MxizjfFJov3JbHyAi,1,0,0,0,0,0,1,0,1,0.14285714285714285,1,0.0,0,0,0,0,0,0,0,1,0,0,1,1
10196,147764,J2kOdVfbOVzDYlg6JttZzYj1ijMbmOfa,fbPkOYLVPtPgIt0MxizjfFJov3JbHyAi,9,5,3,0,3,0,2,0,13,1.8571428571428572,1,0.0,1,3,0,3,4,0,0,2,0,7,6,1
10197,147768,1YQhKlVbSWSyRB9mcpedGa7M41YWFSmU,fbPkOYLVPtPgIt0MxizjfFJov3JbHyAi,8,2,1,0,1,3,7,1,15,2.142857142857143,1,0.0,0,1,0,1,2,3,0,7,1,2,13,1
10198,147769,KDxyrbt1mVWE3rzc84dyTK3d2hDl8n9y,fbPkOYLVPtPgIt0MxizjfFJov3JbHyAi,5,0,0,0,0,0,5,1,6,0.8571428571428571,1,0.0,0,0,0,0,0,0,0,5,1,0,6,1
10199,147770,tKs772tHpR5tE8Ceee9VXQcqKPNhx6zt,fbPkOYLVPtPgIt0MxizjfFJov3JbHyAi,1,0,0,0,0,0,1,0,1,0.14285714285714285,1,0.0,0,0,0,0,0,0,0,1,0,0,1,1
10200,147771,o1Z0mcnOVXV8qXjqUo78WebzsF68mpLE,fbPkOYLVPtPgIt0MxizjfFJov3JbHyAi,6,5,3,0,3,0,3,0,14,2.0,1,0.0,1,3,0,3,4,0,0,3,0,7,7,1
10201,147772,mFN7ZQWOcVa7LiP8Oo1W0WPTVxvqcwqO,fbPkOYLVPtPgIt0MxizjfFJov3JbHyAi,13,11,8,0,5,3,1,0,28,4.0,1,0.0,2,8,0,5,9,3,0,1,0,15,13,1
10202,147773,PvYWxw3yEbAoadQAkzpd3k3f7OpG6DoE,fbPkOYLVPtPgIt0MxizjfFJov3JbHyAi,5,2,1,0,1,0,2,0,6,0.8571428571428571,1,0.0,0,1,0,1,2,0,0,2,0,2,4,1
10203,147774,GwBsELCYAYNo2pcJ3Hwab6UtiG3ye1Qj,fbPkOYLVPtPgIt0MxizjfFJov3JbHyAi,22,23,15,0,9,6,14,0,67,9.571428571428571,6,0.0,0,15,0,9,23,6,0,14,0,24,43,1
10204,147775,wm3H7yjZZekKOdpMLsAK0Ro798c59IP1,fbPkOYLVPtPgIt0MxizjfFJov3JbHyAi,5,2,1,0,1,0,2,0,6,0.8571428571428571,1,0.0,0,1,0,1,2,0,0,2,0,2,4,1
10205,147776,aeUD1Q8xXZqlrQjVnPDT03gNdmvseEAG,fbPkOYLVPtPgIt0MxizjfFJov3JbHyAi,1,0,0,0,0,0,1,0,1,0.14285714285714285,1,0.0,0,0,0,0,0,0,0,1,0,0,1,1
10206,147778,UqdW6exgqWwrDooHrQBPDZ2CP0Vab4m7,fbPkOYLVPtPgIt0MxizjfFJov3JbHyAi,5,2,1,0,1,0,2,0,6,0.8571428571428571,1,0.0,0,1,0,1,2,0,0,2,0,2,4,1
10207,147780,Ov4mGbTBr19epZTdyb8WcJdW9YbNKnAm,fbPkOYLVPtPgIt0MxizjfFJov3JbHyAi,6,4,1,0,1,0,4,0,10,1.4285714285714286,1,0.0,0,1,0,1,4,0,0,4,0,2,8,1
10208,147781,5xOYe3GtSFIz24skQDwp2bS5mtMryo1i,fbPkOYLVPtPgIt0MxizjfFJov3JbHyAi,5,2,1,0,1,0,3,0,7,1.0,1,0.0,0,1,0,1,2,0,0,3,0,2,5,1
10209,147782,D1P1Hsf44r0eDI7GpWUjS6UCddknnKAg,fbPkOYLVPtPgIt0MxizjfFJov3JbHyAi,1,0,0,0,0,0,1,0,1,0.14285714285714285,1,0.0,0,0,0,0,0,0,0,1,0,0,1,1
10210,147783,T24KPVGcghdv6P7ytQKE6lhStbj1tDHE,fbPkOYLVPtPgIt0MxizjfFJov3JbHyAi,7,3,2,0,2,0,2,0,9,1.2857142857142858,1,0.0,0,2,0,2,3,0,0,2,0,4,5,1
10211,147784,K1OObDgsc7SijBamTjkwfIoFyHtZ3ZU6,fbPkOYLVPtPgIt0MxizjfFJov3JbHyAi,11,14,8,0,6,1,7,1,37,5.285714285714286,1,0.0,2,8,0,6,12,1,0,7,1,16,21,1
10212,147785,hOKkjeN6nHMO6D4VBHXzVFHaUdaVhrEZ,fbPkOYLVPtPgIt0MxizjfFJov3JbHyAi,6,3,1,0,1,6,6,0,17,2.4285714285714284,1,0.0,0,1,0,1,3,6,0,6,0,2,15,1
10213,147786,TuaZjf9Q9UcuuonmpyeQa8sFOZhELQm1,fbPkOYLVPtPgIt0MxizjfFJov3JbHyAi,8,3,2,0,2,0,9,0,16,2.2857142857142856,1,0.0,0,2,0,2,3,0,0,9,0,4,12,1
10214,147787,H69WO9aanRW4gzX23LgvL4SatIAdfXLh,fbPkOYLVPtPgIt0MxizjfFJov3JbHyAi,1,0,0,0,0,0,1,0,1,0.14285714285714285,1,0.0,0,0,0,0,0,0,0,1,0,0,1,1
10215,147789,xJLiT7aQ8wJaqtjbqZPuNyUe7xsRIYUx,fbPkOYLVPtPgIt0MxizjfFJov3JbHyAi,10,5,2,0,3,0,8,2,20,2.857142857142857,1,0.0,2,2,0,3,3,0,0,8,2,7,13,1
10216,147790,EQQGIzDw0KP7FL3ru9SVFlekfV91SRlx,fbPkOYLVPtPgIt0MxizjfFJov3JbHyAi,7,3,2,0,2,0,2,0,9,1.2857142857142858,1,0.0,0,2,0,2,3,0,0,2,0,4,5,1
10217,147791,UGbvFlSQXPNfRziPAOx4kHkl79A7jmGG,fbPkOYLVPtPgIt0MxizjfFJov3JbHyAi,18,29,9,12,12,1,3,0,66,9.428571428571429,2,0.0,8,9,12,12,21,1,0,3,0,41,25,1
10218,147793,UHhf3OS5KTsSmirrMDTBosghF0Ip6ptz,fbPkOYLVPtPgIt0MxizjfFJov3JbHyAi,1,0,0,0,0,0,1,0,1,0.14285714285714285,1,0.0,0,0,0,0,0,0,0,1,0,0,1,1
10219,147794,KsHIB2XNLK7Fs02PF75Xmf4i3fa72rIT,fbPkOYLVPtPgIt0MxizjfFJov3JbHyAi,2,0,0,0,0,0,2,0,2,0.2857142857142857,1,0.0,0,0,0,0,0,0,0,2,0,0,2,1
10220,148334,7gxdF7npc77h7z0KnU9ezGYqtBJqY4fQ,7GRhBDsirIGkRZBtSMEzNTyDr2JQm4xx,39,55,20,52,17,3,10,2,159,22.714285714285715,4,0.0,30,20,48,17,25,3,4,10,2,115,44,0
10221,148351,UuZ3VzxMOcv1pgBQfP1NUeudFRRQ1mRU,fbPkOYLVPtPgIt0MxizjfFJov3JbHyAi,8,3,2,0,2,0,4,0,11,1.5714285714285714,1,0.0,0,2,0,2,3,0,0,4,0,4,7,1
10222,148352,jHtmhjYvIQCrHvgDxRflQ5IxXJSVFYuQ,fbPkOYLVPtPgIt0MxizjfFJov3JbHyAi,3,2,0,0,0,0,1,0,3,0.42857142857142855,1,0.0,0,0,0,0,2,0,0,1,0,0,3,1
10223,148354,l20aBHleNKjK0XwZQWFPyPJB0cuojdw9,fbPkOYLVPtPgIt0MxizjfFJov3JbHyAi,5,2,1,0,1,0,4,0,8,1.1428571428571428,1,0.0,0,1,0,1,2,0,0,4,0,2,6,1
10224,148355,8PiAS0TmnQl9QEf7dgpgPmWaNztmfJVP,fbPkOYLVPtPgIt0MxizjfFJov3JbHyAi,9,7,4,0,4,0,3,0,18,2.5714285714285716,1,0.0,2,4,0,4,5,0,0,3,0,10,8,1
10225,148356,1FMoEHMl48zOO2kttHN9vLOQurH54seC,fbPkOYLVPtPgIt0MxizjfFJov3JbHyAi,6,7,3,0,2,0,4,0,16,2.2857142857142856,1,0.0,0,3,0,2,7,0,0,4,0,5,11,1
10226,148357,fyc4dkjFagB2LcZciRyqSJPoegzypBzy,fbPkOYLVPtPgIt0MxizjfFJov3JbHyAi,6,5,3,0,2,0,3,0,13,1.8571428571428572,1,0.0,0,3,0,2,5,0,0,3,0,5,8,1
10227,148359,uZ1O39GxSmePAndNprQEBYYChQSQNkhB,fbPkOYLVPtPgIt0MxizjfFJov3JbHyAi,23,30,18,13,11,0,9,1,82,11.714285714285714,4,0.0,4,18,11,11,26,0,2,9,1,44,38,1
10228,148360,wJP9G4aa97RALoz7jgfom2Is1dozR5XV,fbPkOYLVPtPgIt0MxizjfFJov3JbHyAi,8,10,7,0,4,0,3,0,24,3.4285714285714284,2,0.0,0,7,0,4,10,0,0,3,0,11,13,1
10229,148361,X0S4TDZgj5AsEY7rj0bHgFBmM1wEHl8g,fbPkOYLVPtPgIt0MxizjfFJov3JbHyAi,5,2,1,0,1,0,3,0,7,1.0,1,0.0,0,1,0,1,2,0,0,3,0,2,5,1
10230,148362,zo3To03Q5Rdok3x4Zu1wNdsKqNDBlzyd,fbPkOYLVPtPgIt0MxizjfFJov3JbHyAi,7,3,2,0,2,0,4,0,11,1.5714285714285714,1,0.0,0,2,0,2,3,0,0,4,0,4,7,1
10231,148363,mvWG8WfFoikkAB9Wg1mtbCZJVje4NMeg,fbPkOYLVPtPgIt0MxizjfFJov3JbHyAi,2,0,0,0,0,2,1,0,3,0.42857142857142855,1,0.0,0,0,0,0,0,2,0,1,0,0,3,1
10232,148364,8TsC1FJM6vJWYXxMn4XOpAyFu9uyBcwT,fbPkOYLVPtPgIt0MxizjfFJov3JbHyAi,3,0,0,0,0,0,3,0,3,0.42857142857142855,1,0.0,0,0,0,0,0,0,0,3,0,0,3,1
10233,148365,lQTp6SekPVZwhVL0coTG7jI0NerwwRXX,fbPkOYLVPtPgIt0MxizjfFJov3JbHyAi,1,0,0,0,0,0,1,0,1,0.14285714285714285,1,0.0,0,0,0,0,0,0,0,1,0,0,1,1
10234,148369,BZslXVbbVc1YaW2k5ccBUS6eiDl1WM07,fbPkOYLVPtPgIt0MxizjfFJov3JbHyAi,5,4,1,0,1,0,5,0,11,1.5714285714285714,1,0.0,2,1,0,1,2,0,0,5,0,4,7,1
10235,148370,O3TF3GdRfaqFBn0EbABVcwycS92XFqQI,fbPkOYLVPtPgIt0MxizjfFJov3JbHyAi,8,2,1,0,1,0,4,1,9,1.2857142857142858,1,0.0,0,1,0,1,2,0,0,4,1,2,7,1
10236,148372,RVf6e28k6GsRGb8DN1lRFhzAihWj6uwr,fbPkOYLVPtPgIt0MxizjfFJov3JbHyAi,6,6,1,0,2,0,2,0,11,1.5714285714285714,1,0.0,3,1,0,2,3,0,0,2,0,6,5,1
10237,148373,ajZe5IV50P9q1MwLuSJJxiEXkVsZl5Va,fbPkOYLVPtPgIt0MxizjfFJov3JbHyAi,9,4,2,0,3,0,2,0,11,1.5714285714285714,1,0.0,0,2,0,3,4,0,0,2,0,5,6,1
10238,148374,SkGT6P4CYkjpyqSl3XDsa9OtVYpbNLKc,fbPkOYLVPtPgIt0MxizjfFJov3JbHyAi,5,2,1,0,1,0,2,0,6,0.8571428571428571,1,0.0,0,1,0,1,2,0,0,2,0,2,4,1
10239,148376,OektSQ9TNN3cEy3ZKuUs35c7BdSOqtaQ,fbPkOYLVPtPgIt0MxizjfFJov3JbHyAi,6,5,3,0,2,0,5,0,15,2.142857142857143,1,0.0,0,3,0,2,5,0,0,5,0,5,10,1
10240,148377,9DQIIj4A47ahx19xY3qY5HPiF8T9NzKd,fbPkOYLVPtPgIt0MxizjfFJov3JbHyAi,5,3,1,0,1,0,2,0,7,1.0,1,0.0,0,1,0,1,3,0,0,2,0,2,5,1
10241,148380,mmXnUf3Xp68sXzzvqqAwsEL8YCYNkHx6,fbPkOYLVPtPgIt0MxizjfFJov3JbHyAi,12,11,7,0,6,0,6,0,30,4.285714285714286,2,0.0,2,7,0,6,9,0,0,6,0,15,15,1
10242,148386,3J1rNe3uRvedZitqeCdyMGosrBYsQChl,fbPkOYLVPtPgIt0MxizjfFJov3JbHyAi,5,2,1,0,1,0,2,0,6,0.8571428571428571,1,0.0,0,1,0,1,2,0,0,2,0,2,4,0
10243,148387,LZ4FjsgtwzNif1KtUcVyAos1pH68eZ72,fbPkOYLVPtPgIt0MxizjfFJov3JbHyAi,1,0,0,0,0,0,1,0,1,0.14285714285714285,1,0.0,0,0,0,0,0,0,0,1,0,0,1,1
10244,148389,CSh5hGbaSFu2yCb31iVMOVwKocrH471Q,fbPkOYLVPtPgIt0MxizjfFJov3JbHyAi,5,2,1,0,1,0,2,0,6,0.8571428571428571,1,0.0,0,1,0,1,2,0,0,2,0,2,4,1
10245,148454,te56qI7gFuKkLlkl183DRyiCJEOrbcwN,G8EPVSXsOYB5YQWZGiz1aVq5Pgr2GrQu,19,6,5,26,4,0,3,0,44,6.285714285714286,1,0.0,0,5,22,4,6,0,4,3,0,31,13,1
10246,148458,VMUftRICmOOnQZ0My9Or4atgcbBsD9Pm,A3fsA9Zfv1X2fVEQhTw51lKENdNrEqT3,11,5,4,0,4,0,3,0,16,2.2857142857142856,2,0.0,0,4,0,4,5,0,0,3,0,8,8,1
10247,148471,kvxGydllm6BLbdP0nm9jaxgMVk1FHTYp,bWdj2GDclj5ofokWjzoa5jAwMkxCykd6,6,6,3,0,0,0,4,0,13,1.8571428571428572,2,0.0,0,3,0,0,6,0,0,4,0,3,10,1
10248,148482,RyilkQdPLBJZ4lFr5oZI0Ei4sfkfiESh,A3fsA9Zfv1X2fVEQhTw51lKENdNrEqT3,11,5,4,0,4,0,2,0,15,2.142857142857143,1,0.0,0,4,0,4,5,0,0,2,0,8,7,1
10249,148536,uUMzdUTmgEhjr2EnA8XtLfriryCG2TOf,SpATywNh6bZuzm8s1ceuBUnMUAeoAHHw,22,21,0,18,0,10,7,2,58,8.285714285714286,1,0.0,9,0,16,0,12,10,2,7,2,25,33,0
10250,148537,Wz31P9oU8oqAKC2lD9NdSTmdPqPDYHDG,SpATywNh6bZuzm8s1ceuBUnMUAeoAHHw,12,11,7,2,3,0,3,0,26,3.7142857142857144,2,0.0,0,7,2,3,11,0,0,3,0,12,14,0
10251,148584,57XEpd7q9eLjUEqADz7df27SQD70MfYe,A3fsA9Zfv1X2fVEQhTw51lKENdNrEqT3,1,0,0,0,0,0,1,0,1,0.14285714285714285,1,0.0,0,0,0,0,0,0,0,1,0,0,1,1
10252,148587,LIH6u87VTR1542727Uc42mhP2iK5GaFP,SpATywNh6bZuzm8s1ceuBUnMUAeoAHHw,14,20,1,6,1,11,4,7,50,7.142857142857143,1,0.0,3,1,5,1,17,11,1,4,7,10,40,0
10253,148653,fO1rPCd8LF1QZM5kj2eXZwLqI6uO4Zpz,A3fsA9Zfv1X2fVEQhTw51lKENdNrEqT3,58,57,43,54,19,6,14,1,194,27.714285714285715,5,0.0,2,43,43,19,55,6,11,14,1,107,87,1
10254,148683,yIj21E2mCqn2XcQ0nicOfMS257aUaO89,A3fsA9Zfv1X2fVEQhTw51lKENdNrEqT3,1,0,0,0,0,0,1,0,1,0.14285714285714285,1,0.0,0,0,0,0,0,0,0,1,0,0,1,1
10255,148692,XydvMA0BgL1Al10q3L0D2wz1Y6wVb2rC,A3fsA9Zfv1X2fVEQhTw51lKENdNrEqT3,21,21,13,0,9,0,6,0,49,7.0,3,0.0,0,13,0,9,21,0,0,6,0,22,27,0
10256,148694,XydvMA0BgL1Al10q3L0D2wz1Y6wVb2rC,bWdj2GDclj5ofokWjzoa5jAwMkxCykd6,19,20,14,0,11,0,6,1,52,7.428571428571429,2,0.0,2,14,0,11,18,0,0,6,1,27,25,0
10257,148706,uhhlffPGiUyqHwKWs4eYUM0KXbbqijwF,A3fsA9Zfv1X2fVEQhTw51lKENdNrEqT3,4,2,1,0,1,0,1,0,5,0.7142857142857143,2,0.0,0,1,0,1,2,0,0,1,0,2,3,1
10258,148727,ztmaclrddFYSGIsZoWSUrGCZBLNiuvyf,A3fsA9Zfv1X2fVEQhTw51lKENdNrEqT3,8,6,1,0,1,0,3,0,11,1.5714285714285714,2,0.0,0,1,0,1,6,0,0,3,0,2,9,1
10259,148830,9Se0fuNtnF0aDoUMyiU1YG9IfxiIm4MD,SpATywNh6bZuzm8s1ceuBUnMUAeoAHHw,3,0,0,0,0,0,3,0,3,0.42857142857142855,1,0.0,0,0,0,0,0,0,0,3,0,0,3,1
10260,148843,El7h5k9dEnkCTNiRD6ocpDGK1aq9r5Q4,SpATywNh6bZuzm8s1ceuBUnMUAeoAHHw,23,39,0,33,0,14,13,4,103,14.714285714285714,2,0.0,12,0,30,0,27,14,3,13,4,42,61,1
10261,148848,R2arBlVQ5DlnqBrwRZJfviZdapFQUxuy,A3fsA9Zfv1X2fVEQhTw51lKENdNrEqT3,7,4,3,0,3,0,6,0,16,2.2857142857142856,2,0.0,0,3,0,3,4,0,0,6,0,6,10,1
10262,148853,GMzSpgZQ6jzVsfHn8W8i83JsYNxnP00b,SpATywNh6bZuzm8s1ceuBUnMUAeoAHHw,27,37,18,38,10,0,6,0,109,15.571428571428571,4,0.0,12,18,31,10,25,0,7,6,0,71,38,0
10263,148855,i7oHLg2mT287Keuj3rMh6YGhkeP2LXJu,SpATywNh6bZuzm8s1ceuBUnMUAeoAHHw,9,16,5,12,0,0,3,0,36,5.142857142857143,1,0.0,6,5,10,0,10,0,2,3,0,21,15,0
10264,148860,19rBJNWc3TdUmLpZx1LViNSUBx0S4WJI,RXDvfPUBYFlVdlueBFbLW0mhhAyGEqpt,6,2,0,0,0,1,6,0,9,1.2857142857142858,1,0.0,0,0,0,0,2,1,0,6,0,0,9,0
10265,148904,xIxATd7wQJbG534PldlbQAAGp3iomo3s,SpATywNh6bZuzm8s1ceuBUnMUAeoAHHw,27,39,13,29,6,0,3,0,90,12.857142857142858,1,0.0,17,13,28,6,22,0,1,3,0,64,26,1
10266,148949,KVBhg9xLiQ9g29dG7acnqU2JhAhcB1WP,SpATywNh6bZuzm8s1ceuBUnMUAeoAHHw,5,5,4,0,1,8,3,0,21,3.0,2,0.0,0,4,0,1,5,8,0,3,0,5,16,1
10267,148972,nCi2pdM7sw91EDGAoZtmNoRGljKaB4FL,SpATywNh6bZuzm8s1ceuBUnMUAeoAHHw,12,23,9,23,5,0,1,0,61,8.714285714285714,1,0.0,13,9,19,5,10,0,4,1,0,46,15,0
10268,149024,7FIeNTQkn5xTpBcMu7fzrbX3yIgG7ERg,SpATywNh6bZuzm8s1ceuBUnMUAeoAHHw,18,36,29,0,20,1,10,0,96,13.714285714285714,3,0.0,0,29,0,20,36,1,0,10,0,49,47,0
10269,149033,SfdcNKoJXbzDoiv0d6m3J1MnlTZjsesZ,SpATywNh6bZuzm8s1ceuBUnMUAeoAHHw,5,3,1,0,0,0,2,0,6,0.8571428571428571,1,0.0,0,1,0,0,3,0,0,2,0,1,5,1
10270,149077,tvs2CHlzCZXNqvPsCXS6KuyuottEQsCw,A3fsA9Zfv1X2fVEQhTw51lKENdNrEqT3,11,20,6,0,2,3,15,1,47,6.714285714285714,4,0.0,0,6,0,2,20,3,0,15,1,8,39,1
10271,149087,SneRH8JK6KCMhHOEHp7Zi9NRJB5DLBI8,SpATywNh6bZuzm8s1ceuBUnMUAeoAHHw,10,14,1,5,1,6,2,0,29,4.142857142857143,1,0.0,6,1,4,1,8,6,1,2,0,12,17,1
10272,149088,VdBr9evtUZMzf2druMXhbLcZsJI81UOn,A3fsA9Zfv1X2fVEQhTw51lKENdNrEqT3,43,25,14,50,11,0,6,0,106,15.142857142857142,2,0.0,4,14,46,11,21,0,4,6,0,75,31,1
10273,149100,L6Z8ewPMlWVkLltZWo9qRrYBvHNEsyN9,SpATywNh6bZuzm8s1ceuBUnMUAeoAHHw,10,16,3,0,2,0,7,1,29,4.142857142857143,3,0.0,1,3,0,2,15,0,0,7,1,6,23,0
10274,149109,5is3QPvmCTb2wCYPovTArJero2U5eHRU,SpATywNh6bZuzm8s1ceuBUnMUAeoAHHw,14,29,10,24,0,10,11,1,85,12.142857142857142,4,0.0,14,10,19,0,15,10,5,11,1,43,42,0
10275,149160,aJHRT3LiLupkaY9OS8kHMvtwJmIsdmDj,A3fsA9Zfv1X2fVEQhTw51lKENdNrEqT3,1,0,0,0,0,0,1,0,1,0.14285714285714285,1,0.0,0,0,0,0,0,0,0,1,0,0,1,1
10276,149168,g1J6BQ7EhQE8jfd7gZPRzLZeukbRbkuA,SpATywNh6bZuzm8s1ceuBUnMUAeoAHHw,5,3,1,0,1,0,4,0,9,1.2857142857142858,1,0.0,0,1,0,1,3,0,0,4,0,2,7,0
10277,149169,SG7N8DhpCuhIu06IIzLX0CSolbyIDsIx,A3fsA9Zfv1X2fVEQhTw51lKENdNrEqT3,16,10,7,0,7,0,4,0,28,4.0,4,0.0,0,7,0,7,10,0,0,4,0,14,14,1
10278,149173,MTBFJm3bIEaE6OQdIPJiDEIIoJhDDIeA,A3fsA9Zfv1X2fVEQhTw51lKENdNrEqT3,33,15,1,50,1,0,6,0,73,10.428571428571429,2,0.0,1,1,49,1,14,0,1,6,0,52,21,1
10279,149251,nK3rDT3I0HOsKd8MAJyaw5mnBzHCmQCb,SpATywNh6bZuzm8s1ceuBUnMUAeoAHHw,5,2,1,0,1,0,2,0,6,0.8571428571428571,1,0.0,0,1,0,1,2,0,0,2,0,2,4,1
10280,149281,SSmzTwHw2pJ3n53tqYFDDB8Zh2JeAHoz,SpATywNh6bZuzm8s1ceuBUnMUAeoAHHw,15,24,9,17,4,1,5,0,60,8.571428571428571,1,0.0,15,9,15,4,9,1,2,5,0,43,17,1
10281,149287,XqrZf8R9BrkWGkETcqhxlHJsow5TwWGG,SpATywNh6bZuzm8s1ceuBUnMUAeoAHHw,5,2,1,0,1,0,3,0,7,1.0,1,0.0,0,1,0,1,2,0,0,3,0,2,5,1
10282,149303,qVL008tAQyHTveNNTUZJN2fiJMviNw9f,A3fsA9Zfv1X2fVEQhTw51lKENdNrEqT3,11,14,1,0,1,12,8,1,37,5.285714285714286,2,0.0,0,1,0,1,14,12,0,8,1,2,35,1
10283,149332,9d8tCYKPfh5NHPKNlwRKmrZh3Cuf1Ls2,SpATywNh6bZuzm8s1ceuBUnMUAeoAHHw,24,45,15,0,7,3,8,2,80,11.428571428571429,1,0.0,0,15,0,7,45,3,0,8,2,22,58,0
10284,149365,TiIxJTIN7tI8yF4YwMuZjwFItOZJF5Yy,A3fsA9Zfv1X2fVEQhTw51lKENdNrEqT3,4,2,0,0,0,0,2,0,4,0.5714285714285714,1,0.0,0,0,0,0,2,0,0,2,0,0,4,1
10285,149416,PFJhF2sNLYftHHb21pjL43RM5viviTlT,SpATywNh6bZuzm8s1ceuBUnMUAeoAHHw,28,46,21,16,10,0,3,0,96,13.714285714285714,3,0.0,9,21,16,10,37,0,0,3,0,56,40,0
10286,149423,Pdvh6UTK9FXuCE4WVrV5Y121aJBdVbkt,RXDvfPUBYFlVdlueBFbLW0mhhAyGEqpt,30,43,29,21,7,7,11,1,119,17.0,2,0.0,6,29,21,7,37,7,0,11,1,63,56,0
10287,149431,I45Q3yivyiRN2kHVhbV8bUCfrXvtpUvU,SpATywNh6bZuzm8s1ceuBUnMUAeoAHHw,28,27,16,17,9,0,7,0,76,10.857142857142858,5,0.0,5,16,17,9,22,0,0,7,0,47,29,0
10288,149449,RthO8kTkOrnZ3vUDn574hHyfG3vroBt1,RXDvfPUBYFlVdlueBFbLW0mhhAyGEqpt,27,53,27,0,15,2,9,0,106,15.142857142857142,2,0.0,12,27,0,15,41,2,0,9,0,54,52,0
10289,149458,bw2aO24aZZlJC7FupBFz9UeLH8ZisJZV,A3fsA9Zfv1X2fVEQhTw51lKENdNrEqT3,1,0,0,0,0,0,1,0,1,0.14285714285714285,1,0.0,0,0,0,0,0,0,0,1,0,0,1,1
10290,149492,Ev6KS9MaK9gTGqPDnT9PUK5kybHZnCjh,RXDvfPUBYFlVdlueBFbLW0mhhAyGEqpt,41,110,53,21,35,20,30,14,283,40.42857142857143,5,0.0,2,53,15,35,108,20,6,30,14,105,178,1
10291,149522,WqAusnIIyrtKc88YNA1pWn9FFnkfXjMW,A3fsA9Zfv1X2fVEQhTw51lKENdNrEqT3,12,20,2,0,1,0,12,0,35,5.0,1,0.0,0,2,0,1,20,0,0,12,0,3,32,1
10292,149525,HPkALZZsSIxF1Lb5N1jgVgi94EMe9pvG,SpATywNh6bZuzm8s1ceuBUnMUAeoAHHw,8,2,2,0,2,0,6,0,12,1.7142857142857142,2,0.0,0,2,0,2,2,0,0,6,0,4,8,1
10293,149526,CW7Zlsz0NoDYd7q0tu1Krgi9b7wpQUwQ,bWdj2GDclj5ofokWjzoa5jAwMkxCykd6,16,15,7,26,4,9,14,1,76,10.857142857142858,2,0.0,4,7,25,4,11,9,1,14,1,40,36,0
10294,149534,M6hmghWj9c26PhfYNN6D8AlzAKngSx0i,SpATywNh6bZuzm8s1ceuBUnMUAeoAHHw,1,0,1,0,0,0,0,0,1,0.14285714285714285,1,0.0,0,1,0,0,0,0,0,0,0,1,0,0
10295,149572,PD0QXI0Ip2PVwJ6kJaKkkINkj7BvGZMC,A3fsA9Zfv1X2fVEQhTw51lKENdNrEqT3,3,1,0,0,0,0,12,0,13,1.8571428571428572,2,0.0,0,0,0,0,1,0,0,12,0,0,13,1
10296,149612,dhNL51CrFkHxhMt1kiIq7Iu6BdYInJEB,RXDvfPUBYFlVdlueBFbLW0mhhAyGEqpt,20,34,2,8,1,21,7,15,88,12.571428571428571,3,0.0,0,2,7,1,34,21,1,7,15,10,78,1
10297,149642,BvI5CiGNtYcKpjVG9fTMezMQs6vWmHfH,A3fsA9Zfv1X2fVEQhTw51lKENdNrEqT3,6,2,0,0,0,0,6,0,8,1.1428571428571428,2,0.0,0,0,0,0,2,0,0,6,0,0,8,1
10298,149665,0k9erSYQLRK4wIQFPxo1tbDP6EMqZIo0,A3fsA9Zfv1X2fVEQhTw51lKENdNrEqT3,43,14,12,56,11,3,18,1,115,16.428571428571427,2,0.0,2,12,51,11,12,3,5,18,1,76,39,1
10299,149666,pAkhnLI0s5vboktZycO7Tobv6jbspULh,A3fsA9Zfv1X2fVEQhTw51lKENdNrEqT3,1,0,0,0,0,0,1,0,1,0.14285714285714285,1,0.0,0,0,0,0,0,0,0,1,0,0,1,1
10300,149743,E7Frt6tr6owhsgLSRkD2PqDaTSKmNLId,RXDvfPUBYFlVdlueBFbLW0mhhAyGEqpt,1,0,0,0,0,0,1,0,1,0.14285714285714285,1,0.0,0,0,0,0,0,0,0,1,0,0,1,1
10301,149756,3gPbGxzoDDN9YTm77syKKM4Upb2G3bUj,A3fsA9Zfv1X2fVEQhTw51lKENdNrEqT3,18,13,8,0,6,0,6,0,33,4.714285714285714,1,0.0,0,8,0,6,13,0,0,6,0,14,19,1
10302,149764,nKMPTOF6v1sp7aVmO78zmSRg9f9QXrTf,bWdj2GDclj5ofokWjzoa5jAwMkxCykd6,26,59,35,30,12,28,19,3,186,26.571428571428573,6,0.0,7,35,27,12,52,28,3,19,3,81,105,0
10303,149820,iSiPEDuhdTDGTEOpkEJzXCeneTDhblqT,A3fsA9Zfv1X2fVEQhTw51lKENdNrEqT3,10,6,4,0,3,0,8,0,21,3.0,2,0.0,0,4,0,3,6,0,0,8,0,7,14,1
10304,149821,j7cR8MulZ7sIljFq9IIvuWVX0W2fGIFM,SpATywNh6bZuzm8s1ceuBUnMUAeoAHHw,26,36,17,24,6,12,16,0,111,15.857142857142858,7,0.0,6,17,20,6,30,12,4,16,0,49,62,0
10305,149848,C8zDhaG0vPsQegBtS55u3JZHiYuueFnE,RXDvfPUBYFlVdlueBFbLW0mhhAyGEqpt,9,12,2,0,2,0,5,0,21,3.0,3,0.0,0,2,0,2,12,0,0,5,0,4,17,1
10306,149884,Z95Ku89uNGg04oFkXKdLR1VrvyAEL044,SpATywNh6bZuzm8s1ceuBUnMUAeoAHHw,13,14,1,4,0,0,2,0,21,3.0,1,0.0,2,1,4,0,12,0,0,2,0,7,14,0
10307,149938,zEQiQScIpc1hSOgBtA0a2snrDFq0NA2H,SpATywNh6bZuzm8s1ceuBUnMUAeoAHHw,10,14,4,20,1,0,3,0,42,6.0,1,0.0,9,4,17,1,5,0,3,3,0,31,11,1
10308,150005,D5IkCYseUCO88GE1B1rMaRAAZyqCPk5T,SpATywNh6bZuzm8s1ceuBUnMUAeoAHHw,14,60,8,0,2,8,17,2,97,13.857142857142858,4,0.0,14,8,0,2,46,8,0,17,2,24,73,0
10309,150034,dU7DqQeRV0VJw1owh3rH0rASxy6mSG05,RXDvfPUBYFlVdlueBFbLW0mhhAyGEqpt,7,3,2,0,2,2,2,0,11,1.5714285714285714,1,0.0,0,2,0,2,3,2,0,2,0,4,7,1
10310,150066,kFq2dX2idryINNQb9BQiBNQL0jaWL2j5,A3fsA9Zfv1X2fVEQhTw51lKENdNrEqT3,11,5,4,0,4,0,8,0,21,3.0,1,0.0,0,4,0,4,5,0,0,8,0,8,13,1
10311,150105,G2qtWwR1edRN2N5qfu1AgRch8m00Htg9,SpATywNh6bZuzm8s1ceuBUnMUAeoAHHw,29,35,16,18,9,9,8,0,95,13.571428571428571,5,0.0,5,16,18,9,30,9,0,8,0,48,47,1
10312,150109,gi01S7jVC7j5JiJq4Tw62NMLgY0GYZHL,A3fsA9Zfv1X2fVEQhTw51lKENdNrEqT3,45,28,17,80,10,15,9,2,161,23.0,2,0.0,2,17,62,10,26,15,18,9,2,91,70,1
10313,152855,GPbq86k98Rz9tUbijEEopIymy9u0Fcyf,7GRhBDsirIGkRZBtSMEzNTyDr2JQm4xx,7,6,1,2,1,0,2,0,12,1.7142857142857142,2,0.0,3,1,2,1,3,0,0,2,0,7,5,1
10314,152864,hCBb0btCYW2ppCBVarI67JyCO4pJ7eb9,7GRhBDsirIGkRZBtSMEzNTyDr2JQm4xx,1,0,0,0,0,0,1,0,1,0.14285714285714285,1,0.0,0,0,0,0,0,0,0,1,0,0,1,1
10315,152879,dqSfWCCLLdDoawrlG8LB6YtjPp851gTf,7GRhBDsirIGkRZBtSMEzNTyDr2JQm4xx,1,0,0,0,0,0,1,0,1,0.14285714285714285,1,0.0,0,0,0,0,0,0,0,1,0,0,1,1
10316,152931,bKVslXuzEQ1pv4c6iV5mVjs6X6avUbmL,7GRhBDsirIGkRZBtSMEzNTyDr2JQm4xx,39,83,21,60,16,3,5,0,188,26.857142857142858,5,0.0,26,21,51,16,57,3,9,5,0,114,74,1
10317,152938,Lf93y7eBw6lMLWUxl2k8Aa6sTuqt3rkX,7GRhBDsirIGkRZBtSMEzNTyDr2JQm4xx,42,72,20,57,21,2,19,3,194,27.714285714285715,2,0.0,31,20,51,21,41,2,6,19,3,123,71,1
10318,152954,sITNvJWxCzf6WaNIdOh2TIdks7kOsSJ9,7GRhBDsirIGkRZBtSMEzNTyDr2JQm4xx,1,0,0,0,0,0,1,0,1,0.14285714285714285,1,0.0,0,0,0,0,0,0,0,1,0,0,1,1
10319,152987,AzVjKFfX4LhEl6lfJyI7leulN5tgJJFC,7GRhBDsirIGkRZBtSMEzNTyDr2JQm4xx,2,0,0,0,0,0,2,0,2,0.2857142857142857,1,0.0,0,0,0,0,0,0,0,2,0,0,2,1
10320,152991,8x5LnIwANrYRfzVuO8KI6hCDTjG995Zm,7GRhBDsirIGkRZBtSMEzNTyDr2JQm4xx,36,34,9,214,0,0,2,0,259,37.0,1,0.0,16,9,191,0,18,0,23,2,0,216,43,1
10321,152997,Bos3zEEnAcYzPXQktMkJJ0ak5mhGWCAf,7GRhBDsirIGkRZBtSMEzNTyDr2JQm4xx,40,44,15,170,0,0,3,0,232,33.142857142857146,1,0.0,17,15,159,0,27,0,11,3,0,191,41,1
10322,153006,S2jcDn3vCeFbqJDKmfQ5CtCJMDMc0dCL,7GRhBDsirIGkRZBtSMEzNTyDr2JQm4xx,1,0,0,0,0,0,1,0,1,0.14285714285714285,1,0.0,0,0,0,0,0,0,0,1,0,0,1,1
10323,153011,MU2dpqeoXpRCc5hjW6jEYEhmjukPgsDA,7GRhBDsirIGkRZBtSMEzNTyDr2JQm4xx,1,0,0,0,0,0,1,0,1,0.14285714285714285,1,0.0,0,0,0,0,0,0,0,1,0,0,1,1
10324,153055,DQfW4bOWdBOe4SfBmetTmbxwKFxrUYju,7GRhBDsirIGkRZBtSMEzNTyDr2JQm4xx,29,51,2,68,4,17,9,1,152,21.714285714285715,1,0.0,24,2,58,4,27,17,10,9,1,88,64,1
10325,153110,G1Fi5Ihmt1UntL9sxYjXIiKyHUtRhwud,7GRhBDsirIGkRZBtSMEzNTyDr2JQm4xx,1,0,0,0,0,0,1,0,1,0.14285714285714285,1,0.0,0,0,0,0,0,0,0,1,0,0,1,1
10326,153161,wFvodFqghxL7iISMFbYXkYNq6P6eK5gH,7GRhBDsirIGkRZBtSMEzNTyDr2JQm4xx,1,0,0,0,0,0,1,0,1,0.14285714285714285,1,0.0,0,0,0,0,0,0,0,1,0,0,1,1
10327,153184,VhcJDUnonrNMNnFkqYhfbm6haKp8kch0,7GRhBDsirIGkRZBtSMEzNTyDr2JQm4xx,10,16,4,0,5,4,4,0,33,4.714285714285714,1,0.0,5,4,0,5,11,4,0,4,0,14,19,1
10328,153191,eYNvtk5CsI9HdFompLA9hNZLZOidbC7w,7GRhBDsirIGkRZBtSMEzNTyDr2JQm4xx,2,0,0,0,0,0,2,0,2,0.2857142857142857,1,0.0,0,0,0,0,0,0,0,2,0,0,2,1
10329,153231,cYX89S5aEiRwSUpLGmwi2u7t2zEOcoD7,SpATywNh6bZuzm8s1ceuBUnMUAeoAHHw,6,5,3,0,2,0,3,0,13,1.8571428571428572,2,0.0,0,3,0,2,5,0,0,3,0,5,8,1
10330,153253,DKdrh8xgsWflkjgGhFow61asDvGQGw1P,bWdj2GDclj5ofokWjzoa5jAwMkxCykd6,13,33,11,98,4,3,10,2,161,23.0,2,0.0,6,11,96,4,27,3,2,10,2,117,44,1
10331,153256,KLnx64Dkkv51tfpLPbQ8sIJ698FwQUkp,bWdj2GDclj5ofokWjzoa5jAwMkxCykd6,4,2,0,0,0,0,4,0,6,0.8571428571428571,1,0.0,0,0,0,0,2,0,0,4,0,0,6,1
10332,153264,yN30P4SLRbmDewtu5A5YdbrNC6oNgNQn,SpATywNh6bZuzm8s1ceuBUnMUAeoAHHw,22,33,1,26,1,3,7,0,71,10.142857142857142,2,0.0,8,1,25,1,25,3,1,7,0,35,36,1
10333,153286,qzyzNBM5k9TrDdDhv4o4ZBzLquisQf0j,bWdj2GDclj5ofokWjzoa5jAwMkxCykd6,5,11,1,0,0,0,2,0,14,2.0,2,0.0,2,1,0,0,9,0,0,2,0,3,11,1
10334,153297,vljlAhHGhHZt2ciFpy2bQxMoEL2SUwdk,A3fsA9Zfv1X2fVEQhTw51lKENdNrEqT3,7,6,0,0,0,0,2,0,8,1.1428571428571428,1,0.0,0,0,0,0,6,0,0,2,0,0,8,1
10335,153306,I45Q3yivyiRN2kHVhbV8bUCfrXvtpUvU,A3fsA9Zfv1X2fVEQhTw51lKENdNrEqT3,9,4,3,0,3,0,2,0,12,1.7142857142857142,1,0.0,0,3,0,3,4,0,0,2,0,6,6,1
10336,153308,erktNoGO81kr4QkrHCOsCmKD0qcxd37Z,bWdj2GDclj5ofokWjzoa5jAwMkxCykd6,5,2,1,0,1,0,2,0,6,0.8571428571428571,1,0.0,0,1,0,1,2,0,0,2,0,2,4,1
10337,153326,AZlc6zt0IWDCnhebkR8dcDm8Jn7On2BO,G8EPVSXsOYB5YQWZGiz1aVq5Pgr2GrQu,3,0,0,0,0,31,9,0,40,5.714285714285714,2,0.0,0,0,0,0,0,31,0,9,0,0,40,1
10338,153339,kgtwfSxV6DlyR7XWJO7BpLSg33UPKjB8,SpATywNh6bZuzm8s1ceuBUnMUAeoAHHw,1,0,0,0,0,0,1,0,1,0.14285714285714285,1,0.0,0,0,0,0,0,0,0,1,0,0,1,1
10339,153348,rew0c3O7roxnm8EfAzYQGMCDX1NNxnod,bWdj2GDclj5ofokWjzoa5jAwMkxCykd6,5,2,1,0,1,0,2,0,6,0.8571428571428571,1,0.0,0,1,0,1,2,0,0,2,0,2,4,1
10340,153362,NAuTAy6LFtpkSTeaDzpzRRxCaq6qJCQ5,bWdj2GDclj5ofokWjzoa5jAwMkxCykd6,1,0,0,0,0,0,1,0,1,0.14285714285714285,1,0.0,0,0,0,0,0,0,0,1,0,0,1,1
10341,153375,EnaSTRqxkWjMR8pSWQe4ipdWniwPtGKE,A3fsA9Zfv1X2fVEQhTw51lKENdNrEqT3,1,0,0,0,0,0,1,0,1,0.14285714285714285,1,0.0,0,0,0,0,0,0,0,1,0,0,1,1
10342,153391,afQkAxUvdLu532EqkP2BO2E822Re7HYk,SpATywNh6bZuzm8s1ceuBUnMUAeoAHHw,1,0,0,0,0,0,1,0,1,0.14285714285714285,1,0.0,0,0,0,0,0,0,0,1,0,0,1,1
10343,153397,HQm7nMTOyi7HCPaL4vs2tkbd4DWxfE67,A3fsA9Zfv1X2fVEQhTw51lKENdNrEqT3,8,4,2,0,2,0,5,0,13,1.8571428571428572,1,0.0,1,2,0,2,3,0,0,5,0,5,8,1
10344,153405,SQBW44VzMb5zXQWTfzFzAP2RU7qxP2su,A3fsA9Zfv1X2fVEQhTw51lKENdNrEqT3,4,3,2,0,1,0,1,0,7,1.0,2,0.0,0,2,0,1,3,0,0,1,0,3,4,1
10345,153410,0akUPLtvQvvS6uDU84fTYZNIPYPvoH52,A3fsA9Zfv1X2fVEQhTw51lKENdNrEqT3,8,4,1,0,1,1,5,1,13,1.8571428571428572,1,0.0,0,1,0,1,4,1,0,5,1,2,11,1
10346,153427,BtyJK9nVdN1kc0SoyvBwk9Why1olo9fX,SpATywNh6bZuzm8s1ceuBUnMUAeoAHHw,4,2,1,0,0,0,2,0,5,0.7142857142857143,1,0.0,0,1,0,0,2,0,0,2,0,1,4,1
10347,153440,piC2LAhWCCsSJOB3RH6MaHzy9gHIudvG,RXDvfPUBYFlVdlueBFbLW0mhhAyGEqpt,1,0,0,0,0,0,1,0,1,0.14285714285714285,1,0.0,0,0,0,0,0,0,0,1,0,0,1,1
10348,153480,pwnvfCtqibSBzw9gewKZFVOUFkyHecrp,RXDvfPUBYFlVdlueBFbLW0mhhAyGEqpt,1,0,0,0,0,0,1,0,1,0.14285714285714285,1,0.0,0,0,0,0,0,0,0,1,0,0,1,1
10349,153509,EzJJd1vaXRdhAvKq2Q0XoWVWiA4HWk5i,bWdj2GDclj5ofokWjzoa5jAwMkxCykd6,7,4,1,6,1,0,7,0,19,2.7142857142857144,2,0.0,1,1,4,1,3,0,2,7,0,7,12,1
10350,153514,63urTnMQ6906ju0tncFpKl8xLgyyTd5d,SpATywNh6bZuzm8s1ceuBUnMUAeoAHHw,12,9,2,0,2,2,9,1,25,3.5714285714285716,2,0.0,0,2,0,2,9,2,0,9,1,4,21,1
10351,153534,am1ujnojA2ZUYWhKXji6KHqg6kwAFj5z,SpATywNh6bZuzm8s1ceuBUnMUAeoAHHw,7,3,2,0,2,0,2,0,9,1.2857142857142858,1,0.0,0,2,0,2,3,0,0,2,0,4,5,1
10352,153550,CfbsMYGg57bCv0HnMFe2zrw0mAeXuZTI,SpATywNh6bZuzm8s1ceuBUnMUAeoAHHw,2,0,0,0,0,0,2,0,2,0.2857142857142857,1,0.0,0,0,0,0,0,0,0,2,0,0,2,1
10353,153555,YqtqVDKc4pZH2IHRYh05LZbT8NkeJ2tA,bWdj2GDclj5ofokWjzoa5jAwMkxCykd6,10,8,3,0,2,1,8,1,23,3.2857142857142856,1,0.0,3,3,0,2,5,1,0,8,1,8,15,1
10354,153561,AxjnggPTKyT2aYQCBpgnjenDZZbNsOpc,G8EPVSXsOYB5YQWZGiz1aVq5Pgr2GrQu,6,6,2,0,2,0,5,0,15,2.142857142857143,1,0.0,0,2,0,2,6,0,0,5,0,4,11,1
10355,153566,UBlBWZ3qSNiPpjfNB2f0HBLc8JT09fQp,A3fsA9Zfv1X2fVEQhTw51lKENdNrEqT3,13,9,6,0,4,0,11,3,33,4.714285714285714,1,0.0,0,6,0,4,9,0,0,11,3,10,23,1
10356,153568,jR4AfVlqsecU2OD2EAAPnmIP3mzjfI1q,RXDvfPUBYFlVdlueBFbLW0mhhAyGEqpt,3,0,0,0,0,0,3,0,3,0.42857142857142855,1,0.0,0,0,0,0,0,0,0,3,0,0,3,1
10357,153581,6VwrXuZWbgcjNNDx17wfxtM1n4lp5Lty,SpATywNh6bZuzm8s1ceuBUnMUAeoAHHw,5,3,1,0,1,0,2,0,7,1.0,1,0.0,0,1,0,1,3,0,0,2,0,2,5,1
10358,153583,ManuYhUk0ydtDbFYHqGK5HcrqUDdhmXT,A3fsA9Zfv1X2fVEQhTw51lKENdNrEqT3,17,9,1,12,1,2,7,1,33,4.714285714285714,1,0.0,0,1,10,1,9,2,2,7,1,12,21,1
10359,153586,JtIk3EAEhmwR0FR2ilwFzJTkMTjDzXA6,bWdj2GDclj5ofokWjzoa5jAwMkxCykd6,5,4,2,0,2,0,2,0,10,1.4285714285714286,1,0.0,1,2,0,2,3,0,0,2,0,5,5,1
10360,153597,6eigRKdKORgy46hn8ZqOQWxZJBzNbSVK,SpATywNh6bZuzm8s1ceuBUnMUAeoAHHw,12,13,0,45,0,10,1,0,69,9.857142857142858,1,0.0,8,0,38,0,5,10,7,1,0,46,23,0
10361,153624,TQ1Tb2cgiG68xs6aUf696l3C3zHYq6fS,A3fsA9Zfv1X2fVEQhTw51lKENdNrEqT3,4,3,2,0,0,0,1,0,6,0.8571428571428571,1,0.0,0,2,0,0,3,0,0,1,0,2,4,1
10362,153627,Cx9UgN9CA3ZQNCspfULD8FGJJpSFtxJF,A3fsA9Zfv1X2fVEQhTw51lKENdNrEqT3,30,20,17,0,13,0,6,0,56,8.0,2,0.0,0,17,0,13,20,0,0,6,0,30,26,1
10363,153633,IRpbgsWkgoZJzwjoe9EnoRzUlAbnuMfL,SpATywNh6bZuzm8s1ceuBUnMUAeoAHHw,7,10,3,0,2,0,1,0,16,2.2857142857142856,1,0.0,0,3,0,2,10,0,0,1,0,5,11,1
10364,153667,htua1xywlnpsMMY7EJSOsurL86GI912X,SpATywNh6bZuzm8s1ceuBUnMUAeoAHHw,31,41,22,24,9,2,10,1,109,15.571428571428571,3,0.0,10,22,18,9,31,2,6,10,1,59,50,1
10365,153670,9CQfIvDiQz4gDArSnTXOgxNKUwJW75pD,G8EPVSXsOYB5YQWZGiz1aVq5Pgr2GrQu,7,5,3,0,1,0,2,0,11,1.5714285714285714,1,0.0,0,3,0,1,5,0,0,2,0,4,7,1
10366,153672,GLPmzj5hXdU3lPOHJ5T9KsJUoi44XCjZ,bWdj2GDclj5ofokWjzoa5jAwMkxCykd6,8,3,2,0,2,0,3,1,11,1.5714285714285714,1,0.0,0,2,0,2,3,0,0,3,1,4,7,1
10367,153675,ncZpzPYvUtQjJgcrnY99CiTzo4JQVsl8,A3fsA9Zfv1X2fVEQhTw51lKENdNrEqT3,1,0,0,0,0,0,1,0,1,0.14285714285714285,1,0.0,0,0,0,0,0,0,0,1,0,0,1,1
10368,153676,rMQIZQBxSTMFTRmvcfmpoYqCAUhMol3Y,bWdj2GDclj5ofokWjzoa5jAwMkxCykd6,14,38,1,58,4,2,18,8,129,18.428571428571427,3,0.0,13,1,54,4,25,2,4,18,8,72,57,0
10369,153677,ncZpzPYvUtQjJgcrnY99CiTzo4JQVsl8,RXDvfPUBYFlVdlueBFbLW0mhhAyGEqpt,1,0,0,0,0,0,1,0,1,0.14285714285714285,1,0.0,0,0,0,0,0,0,0,1,0,0,1,1
10370,153683,X9vm4W9jxNs3PEUtGGsO0Yn0aFWIbkg5,SpATywNh6bZuzm8s1ceuBUnMUAeoAHHw,11,21,8,0,0,0,2,0,31,4.428571428571429,1,0.0,6,8,0,0,15,0,0,2,0,14,17,1
10371,153696,kQrbauxiC7YRwJ9kMbwlTSfqUjp3UrEF,SpATywNh6bZuzm8s1ceuBUnMUAeoAHHw,15,12,5,19,3,0,3,0,42,6.0,3,0.0,4,5,17,3,8,0,2,3,0,29,13,1
10372,153712,GQQgnryyOjGmrLa2rKAbo7L18aO95YIN,SpATywNh6bZuzm8s1ceuBUnMUAeoAHHw,8,6,4,0,4,0,1,0,15,2.142857142857143,1,0.0,0,4,0,4,6,0,0,1,0,8,7,1
10373,153714,hMspMrStrcDDx9Uzg5qhswDwr2Wyqchl,bWdj2GDclj5ofokWjzoa5jAwMkxCykd6,5,5,4,0,1,0,1,0,11,1.5714285714285714,1,0.0,0,4,0,1,5,0,0,1,0,5,6,1
10374,153717,ikhBAd1BuMTyBJimuuSlAf6s44URi8zu,A3fsA9Zfv1X2fVEQhTw51lKENdNrEqT3,14,6,4,0,3,6,10,5,34,4.857142857142857,1,0.0,1,4,0,3,5,6,0,10,5,8,26,1
10375,153719,9AI5pszWPE25mtEwaHMtbhaDZrYN4oZ9,SpATywNh6bZuzm8s1ceuBUnMUAeoAHHw,5,2,1,0,1,0,2,0,6,0.8571428571428571,1,0.0,0,1,0,1,2,0,0,2,0,2,4,1
10376,153723,TqRaDvXJpdWXGkJNi0RDsTtg47jRUl81,bWdj2GDclj5ofokWjzoa5jAwMkxCykd6,1,0,0,0,0,0,1,0,1,0.14285714285714285,1,0.0,0,0,0,0,0,0,0,1,0,0,1,0
10377,153728,58eQNUjs318sjON50Y8nkDIw70NM1q5r,A3fsA9Zfv1X2fVEQhTw51lKENdNrEqT3,3,1,0,0,0,0,2,0,3,0.42857142857142855,1,0.0,0,0,0,0,1,0,0,2,0,0,3,1
10378,153736,PjOclk6Yw0TIvLC3mHiumPaKYTUJC7i8,G8EPVSXsOYB5YQWZGiz1aVq5Pgr2GrQu,1,0,0,0,0,0,2,0,2,0.2857142857142857,1,0.0,0,0,0,0,0,0,0,2,0,0,2,1
10379,153740,EVmZGFFbud1idCrJ2HZ0M1Xnc7jp4QF2,SpATywNh6bZuzm8s1ceuBUnMUAeoAHHw,1,0,0,0,0,0,1,0,1,0.14285714285714285,1,0.0,0,0,0,0,0,0,0,1,0,0,1,1
10380,153751,sUtQh78DXyhh3vE9rxqMUoIBjqNSKrC0,A3fsA9Zfv1X2fVEQhTw51lKENdNrEqT3,9,4,3,0,3,0,2,1,13,1.8571428571428572,1,0.0,0,3,0,3,4,0,0,2,1,6,7,1
10381,153752,sUtQh78DXyhh3vE9rxqMUoIBjqNSKrC0,bWdj2GDclj5ofokWjzoa5jAwMkxCykd6,2,0,0,0,0,0,2,0,2,0.2857142857142857,1,0.0,0,0,0,0,0,0,0,2,0,0,2,1
10382,153760,sUtQh78DXyhh3vE9rxqMUoIBjqNSKrC0,RXDvfPUBYFlVdlueBFbLW0mhhAyGEqpt,1,0,0,0,0,0,1,0,1,0.14285714285714285,1,0.0,0,0,0,0,0,0,0,1,0,0,1,1
10383,153765,JTN1G4IwNqBxpxjKApCtLeoFv6NT4I58,SpATywNh6bZuzm8s1ceuBUnMUAeoAHHw,18,28,11,18,5,10,9,1,82,11.714285714285714,3,0.0,10,11,15,5,18,10,3,9,1,41,41,1
10384,153767,mUDgTVmygSuewvWeFS0TPPpUtE7wznA7,SpATywNh6bZuzm8s1ceuBUnMUAeoAHHw,5,2,1,0,1,0,2,0,6,0.8571428571428571,1,0.0,0,1,0,1,2,0,0,2,0,2,4,0
10385,153791,qScEGLnewgguP1Ewzar5maJbQBA27NyN,SpATywNh6bZuzm8s1ceuBUnMUAeoAHHw,13,21,0,17,0,6,5,0,49,7.0,1,0.0,9,0,14,0,12,6,3,5,0,23,26,1
10386,153809,57xBvLPGpSkzxqkLuJgHQNjPmsEoPQJW,A3fsA9Zfv1X2fVEQhTw51lKENdNrEqT3,5,6,1,0,0,0,2,0,9,1.2857142857142858,2,0.0,0,1,0,0,6,0,0,2,0,1,8,1
10387,153818,LM1rmZxY7OzUOcYjeqeOXcU9AGsbnd9q,SpATywNh6bZuzm8s1ceuBUnMUAeoAHHw,5,2,1,0,1,0,2,0,6,0.8571428571428571,1,0.0,0,1,0,1,2,0,0,2,0,2,4,1
10388,153819,HkcPmWCSdk3INCYsquWGQGZKijdTCD0w,SpATywNh6bZuzm8s1ceuBUnMUAeoAHHw,15,14,2,8,1,3,9,1,38,5.428571428571429,3,0.0,2,2,7,1,12,3,1,9,1,12,26,1
10389,153821,57xBvLPGpSkzxqkLuJgHQNjPmsEoPQJW,bWdj2GDclj5ofokWjzoa5jAwMkxCykd6,3,6,0,0,0,2,1,0,9,1.2857142857142858,1,0.0,1,0,0,0,5,2,0,1,0,1,8,1
10390,153822,GmUgGkHH917kYWGPPkvD4RSeUx3CJaej,SpATywNh6bZuzm8s1ceuBUnMUAeoAHHw,15,17,0,14,0,5,7,1,44,6.285714285714286,1,0.0,10,0,11,0,7,5,3,7,1,21,23,1
10391,153823,wsHwZ3NkY1tqHKUuOn0buAOnr2acx1MP,bWdj2GDclj5ofokWjzoa5jAwMkxCykd6,3,0,0,0,0,0,3,0,3,0.42857142857142855,1,0.0,0,0,0,0,0,0,0,3,0,0,3,1
10392,153831,uhU9XFMHqXe19d0SBpTzsSNqTtdSMXBT,bWdj2GDclj5ofokWjzoa5jAwMkxCykd6,1,0,0,0,0,0,1,0,1,0.14285714285714285,1,0.0,0,0,0,0,0,0,0,1,0,0,1,1
10393,153842,bdZOWERl4VN1w1rz4KfnRlahupg4gIpq,bWdj2GDclj5ofokWjzoa5jAwMkxCykd6,10,17,10,64,0,16,7,2,116,16.571428571428573,1,0.0,3,10,62,0,14,16,2,7,2,75,41,1
10394,153862,WCBxImuXCQhe4JCGgmUbhM2fHJqNW9fo,A3fsA9Zfv1X2fVEQhTw51lKENdNrEqT3,8,11,5,0,3,0,2,0,21,3.0,1,0.0,0,5,0,3,11,0,0,2,0,8,13,1
10395,153869,Ya9PqShf5x9jueZxN5yIDpfhkNWrfHAh,RXDvfPUBYFlVdlueBFbLW0mhhAyGEqpt,9,4,4,0,3,1,3,0,15,2.142857142857143,1,0.0,0,4,0,3,4,1,0,3,0,7,8,1
10396,153871,kyU7VEeDwoGKq58Y5h10sPBzrIAFqfVi,bWdj2GDclj5ofokWjzoa5jAwMkxCykd6,5,2,1,0,1,0,2,0,6,0.8571428571428571,1,0.0,0,1,0,1,2,0,0,2,0,2,4,1
10397,153873,lHqG7UT3evpRhAVEeXMKWozC3OBfRB6b,A3fsA9Zfv1X2fVEQhTw51lKENdNrEqT3,1,0,0,0,0,0,1,0,1,0.14285714285714285,1,0.0,0,0,0,0,0,0,0,1,0,0,1,1
10398,153874,KSxx5GQKyHs39JznmMANF7eJRsaveHfw,A3fsA9Zfv1X2fVEQhTw51lKENdNrEqT3,7,8,2,0,0,5,9,2,26,3.7142857142857144,2,0.0,0,2,0,0,8,5,0,9,2,2,24,1
10399,153892,d2NzzaJnxOD8hORDU0JQIrwAo12srVeO,SpATywNh6bZuzm8s1ceuBUnMUAeoAHHw,14,17,10,0,6,12,17,7,69,9.857142857142858,4,0.0,0,10,0,6,17,12,0,17,7,16,53,1
10400,153895,f3YcaJisiu4LNXF8c0nltyQqDOirQ4G3,bWdj2GDclj5ofokWjzoa5jAwMkxCykd6,8,7,4,0,2,5,5,1,24,3.4285714285714284,1,0.0,0,4,0,2,7,5,0,5,1,6,18,1
10401,153899,RuTxY8DaJW8mZYxEAeQrQJD3l4wbq41Q,bWdj2GDclj5ofokWjzoa5jAwMkxCykd6,5,3,1,0,1,0,2,0,7,1.0,1,0.0,0,1,0,1,3,0,0,2,0,2,5,1
10402,153900,idxxWwMKAxBMibSoM88bXM2M515R6wYi,SpATywNh6bZuzm8s1ceuBUnMUAeoAHHw,5,2,1,0,1,0,2,0,6,0.8571428571428571,1,0.0,0,1,0,1,2,0,0,2,0,2,4,1
10403,153903,XmbkXRvCaUzUbqcHrpRU9UVMv582qDRu,G8EPVSXsOYB5YQWZGiz1aVq5Pgr2GrQu,17,7,4,20,2,2,9,1,45,6.428571428571429,1,0.0,0,4,18,2,7,2,2,9,1,24,21,1
10404,153928,rWCtYQJxLY6x4HYR2cUOUU68SSwJtOXD,SpATywNh6bZuzm8s1ceuBUnMUAeoAHHw,1,0,0,0,0,0,1,0,1,0.14285714285714285,1,0.0,0,0,0,0,0,0,0,1,0,0,1,1
10405,153935,xCtx9oK39TlKlw1wuTfbxFcC7lD8Tvmu,SpATywNh6bZuzm8s1ceuBUnMUAeoAHHw,6,11,3,0,1,0,3,0,18,2.5714285714285716,1,0.0,0,3,0,1,11,0,0,3,0,4,14,1
10406,153936,UU4MEikmCGklRVK3djHNSk7yxxkesa3p,SpATywNh6bZuzm8s1ceuBUnMUAeoAHHw,6,5,0,0,1,0,2,0,8,1.1428571428571428,1,0.0,0,0,0,1,5,0,0,2,0,1,7,1
10407,153941,ECkqmAuIkv3ncN9wNJby8oOn15qTd9kR,A3fsA9Zfv1X2fVEQhTw51lKENdNrEqT3,1,0,0,0,0,0,1,0,1,0.14285714285714285,1,0.0,0,0,0,0,0,0,0,1,0,0,1,1
10408,153950,4IJ56QlJSL8avuRQEkrBcEyhUIO3LIP3,A3fsA9Zfv1X2fVEQhTw51lKENdNrEqT3,53,31,16,72,5,0,21,0,145,20.714285714285715,5,0.0,6,16,72,5,25,0,0,21,0,99,46,0
10409,153951,QcAEBwtOda13Q2hwEpOzUuFeV6Y52Ggz,SpATywNh6bZuzm8s1ceuBUnMUAeoAHHw,15,27,2,20,0,0,4,0,53,7.571428571428571,3,0.0,9,2,17,0,18,0,3,4,0,28,25,1
10410,153958,LhMGo1H458StfoGsiIJMkiDJEIOqqbKe,SpATywNh6bZuzm8s1ceuBUnMUAeoAHHw,19,23,17,0,9,0,3,0,52,7.428571428571429,2,0.0,3,17,0,9,20,0,0,3,0,29,23,0
10411,153988,vN0Rkga5RDQhnR6Qd8HVKAqnd5DqO9Q9,G8EPVSXsOYB5YQWZGiz1aVq5Pgr2GrQu,6,3,1,0,1,0,5,0,10,1.4285714285714286,2,0.0,0,1,0,1,3,0,0,5,0,2,8,1
10412,153989,lqbdGj6Vu3etzwWvEelu4TAXnkcY6ywX,SpATywNh6bZuzm8s1ceuBUnMUAeoAHHw,5,2,1,0,1,0,2,0,6,0.8571428571428571,1,0.0,0,1,0,1,2,0,0,2,0,2,4,1
10413,153990,wUS4QMZENKgcJOovrFGfoZniw3fDJWWg,SpATywNh6bZuzm8s1ceuBUnMUAeoAHHw,17,19,10,22,2,0,9,0,62,8.857142857142858,7,0.0,5,10,20,2,14,0,2,9,0,37,25,0
10414,153995,Bj2SxvASGVcIXgTPxMzZPlX3DzMVAgje,bWdj2GDclj5ofokWjzoa5jAwMkxCykd6,6,4,1,2,2,0,3,0,12,1.7142857142857142,1,0.0,2,1,2,2,2,0,0,3,0,7,5,1
10415,153996,7IjzbYGXgciR2DhqsqrtMeDkNMFINoYx,SpATywNh6bZuzm8s1ceuBUnMUAeoAHHw,20,37,15,5,5,1,23,1,87,12.428571428571429,2,0.0,13,15,5,5,24,1,0,23,1,38,49,1
10416,153997,zdA78Dg0BGWLvIRxkEt1PHhxNyG6hsIH,SpATywNh6bZuzm8s1ceuBUnMUAeoAHHw,1,0,0,0,0,0,1,0,1,0.14285714285714285,1,0.0,0,0,0,0,0,0,0,1,0,0,1,1
10417,154002,oO8PkmS40wsHMDT2LhD46mYGdAQ8FooI,bWdj2GDclj5ofokWjzoa5jAwMkxCykd6,15,28,11,48,8,14,5,0,114,16.285714285714285,2,0.0,10,11,45,8,18,14,3,5,0,74,40,1
10418,154011,u1aZFlVWlqtE11RPrh292EwKCdah7ek7,SpATywNh6bZuzm8s1ceuBUnMUAeoAHHw,4,2,0,0,0,0,2,0,4,0.5714285714285714,1,0.0,0,0,0,0,2,0,0,2,0,0,4,1
10419,154040,zWXhTxTG418YOfBpnhuFBg2UPPJXEdZa,SpATywNh6bZuzm8s1ceuBUnMUAeoAHHw,5,3,1,0,1,0,1,0,6,0.8571428571428571,1,0.0,0,1,0,1,3,0,0,1,0,2,4,1
10420,154056,3v4pf4Z2sq302espsMpIgHq4VUPDIN8A,SpATywNh6bZuzm8s1ceuBUnMUAeoAHHw,5,2,1,0,1,1,2,0,7,1.0,1,0.0,0,1,0,1,2,1,0,2,0,2,5,1
10421,154062,TSAIY3YjXsZdZc9oVcWWYSbgnOAvAP3E,G8EPVSXsOYB5YQWZGiz1aVq5Pgr2GrQu,5,3,1,0,1,0,2,0,7,1.0,1,0.0,0,1,0,1,3,0,0,2,0,2,5,1
10422,154066,BJOmIWRDihyZz3o40vbdAfCNe0WIbLc5,SpATywNh6bZuzm8s1ceuBUnMUAeoAHHw,6,2,1,0,1,0,3,0,7,1.0,1,0.0,0,1,0,1,2,0,0,3,0,2,5,1
10423,154076,22YNnFMji9XXRm4684KBVp3G0eZTCIft,A3fsA9Zfv1X2fVEQhTw51lKENdNrEqT3,13,8,5,0,4,0,8,0,25,3.5714285714285716,1,0.0,0,5,0,4,8,0,0,8,0,9,16,1
10424,154091,3FZ7859u0AJ285S0tHRE6ylhfDMJda8K,SpATywNh6bZuzm8s1ceuBUnMUAeoAHHw,1,0,0,0,0,0,1,0,1,0.14285714285714285,1,0.0,0,0,0,0,0,0,0,1,0,0,1,1
10425,154093,p6TgFJdLQMaMzbR16kycIPcRPnBj3paK,SpATywNh6bZuzm8s1ceuBUnMUAeoAHHw,4,2,1,0,1,0,2,0,6,0.8571428571428571,2,0.0,0,1,0,1,2,0,0,2,0,2,4,1
10426,154101,SS2LhAp5I5Z43oIfHH4Ih7CTNU5vDf5h,SpATywNh6bZuzm8s1ceuBUnMUAeoAHHw,1,0,0,0,0,0,1,0,1,0.14285714285714285,1,0.0,0,0,0,0,0,0,0,1,0,0,1,1
10427,154104,9Jy1wR1kNKfVIlzkWjf6DnrfYfDGnPzT,SpATywNh6bZuzm8s1ceuBUnMUAeoAHHw,20,31,19,12,11,16,12,1,102,14.571428571428571,4,0.0,7,19,12,11,24,16,0,12,1,49,53,0
10428,154109,Cx9AvhpaoGF7JJ71AI7APeANc2Vipt9I,SpATywNh6bZuzm8s1ceuBUnMUAeoAHHw,1,0,0,0,0,0,1,0,1,0.14285714285714285,1,0.0,0,0,0,0,0,0,0,1,0,0,1,1
10429,154111,fKBgr7W6Vaq7CaM5NPYdwouK9aGfjKnk,SpATywNh6bZuzm8s1ceuBUnMUAeoAHHw,4,3,0,0,0,0,5,0,8,1.1428571428571428,1,0.0,0,0,0,0,3,0,0,5,0,0,8,1
10430,154128,bw9Orpcerztec7DXXrZLdtk0pUJ9Agjc,RXDvfPUBYFlVdlueBFbLW0mhhAyGEqpt,12,6,1,3,1,1,3,0,15,2.142857142857143,1,0.0,1,1,3,1,5,1,0,3,0,6,9,1
10431,154145,MUAq8cgExXjyCvVsMiE64RjE0HwCMEx8,A3fsA9Zfv1X2fVEQhTw51lKENdNrEqT3,7,2,1,0,1,0,6,1,11,1.5714285714285714,1,0.0,0,1,0,1,2,0,0,6,1,2,9,1
10432,154161,YtJbqHCfQeko1zihs9n6E1Ly00ndbcI5,bWdj2GDclj5ofokWjzoa5jAwMkxCykd6,4,1,0,0,0,0,4,0,5,0.7142857142857143,1,0.0,0,0,0,0,1,0,0,4,0,0,5,1
10433,154171,2m1f0GkzC3lXY6f5kS8aatrSNoeQ2Cc4,SpATywNh6bZuzm8s1ceuBUnMUAeoAHHw,11,17,10,0,6,3,12,0,48,6.857142857142857,2,0.0,3,10,0,6,14,3,0,12,0,19,29,1
10434,154190,fZpfLVVUEp7GXISLcNFyxWveiOP0dldp,SpATywNh6bZuzm8s1ceuBUnMUAeoAHHw,8,15,0,0,0,0,1,0,16,2.2857142857142856,1,0.0,1,0,0,0,14,0,0,1,0,1,15,0
10435,154193,6HPRmmMDN5OSycgmfnsrqG7YAJbfsWTK,SpATywNh6bZuzm8s1ceuBUnMUAeoAHHw,19,25,8,29,3,0,3,0,68,9.714285714285714,2,0.0,8,8,27,3,17,0,2,3,0,46,22,1
10436,154199,bZtNzDzO2qmGZ75gSzCr8t2M40vhOtlI,A3fsA9Zfv1X2fVEQhTw51lKENdNrEqT3,9,4,2,0,1,2,10,1,20,2.857142857142857,2,0.0,0,2,0,1,4,2,0,10,1,3,17,0
10437,154200,ADL0cXowUMs4wyiAOHKMOrtTHu5tmUqi,bWdj2GDclj5ofokWjzoa5jAwMkxCykd6,15,23,14,0,7,3,17,1,65,9.285714285714286,7,0.0,0,14,0,7,23,3,0,17,1,21,44,1
10438,154221,1L7XwCOwn8nIJFjaEmGoI47SzrXbe8CM,SpATywNh6bZuzm8s1ceuBUnMUAeoAHHw,27,41,3,36,2,71,32,7,192,27.428571428571427,5,0.0,14,3,30,2,27,71,6,32,7,49,143,0
10439,154253,QweH7yTZRdri03OUSokKH99D0caZDv7H,7GRhBDsirIGkRZBtSMEzNTyDr2JQm4xx,7,4,1,0,2,1,3,0,11,1.5714285714285714,1,0.0,2,1,0,2,2,1,0,3,0,5,6,1
10440,154284,QCIxkwrtd7EyHnigeiQpqn6l0kVuCgK4,7GRhBDsirIGkRZBtSMEzNTyDr2JQm4xx,9,6,2,0,1,2,6,1,18,2.5714285714285716,1,0.0,0,2,0,1,6,2,0,6,1,3,15,1
10441,154301,Q95csmmf8N84WQQSbOMc5rN6dm3wzDuG,SpATywNh6bZuzm8s1ceuBUnMUAeoAHHw,19,65,2,16,1,2,5,0,91,13.0,2,0.0,0,2,13,1,65,2,3,5,0,16,75,0
10442,154314,ulqdtzoaFKnUas51E4T9qwtZYnxyLzzg,7GRhBDsirIGkRZBtSMEzNTyDr2JQm4xx,3,0,0,0,0,0,9,0,9,1.2857142857142858,1,0.0,0,0,0,0,0,0,0,9,0,0,9,1
10443,154361,Zz1hYW3bIv4cloYkUjUfNR6Tk0kO8ZBM,7GRhBDsirIGkRZBtSMEzNTyDr2JQm4xx,1,0,0,0,0,0,1,0,1,0.14285714285714285,1,0.0,0,0,0,0,0,0,0,1,0,0,1,1
10444,154367,EqDMtLRDV3YTsfyNsZW3gWT7QJ22Zgxb,7GRhBDsirIGkRZBtSMEzNTyDr2JQm4xx,1,0,0,0,0,0,1,0,1,0.14285714285714285,1,0.0,0,0,0,0,0,0,0,1,0,0,1,1
10445,154398,5dFDKTPyqIzDoJ1o2UMmJJhGPtehK3JJ,7GRhBDsirIGkRZBtSMEzNTyDr2JQm4xx,3,0,0,0,0,0,3,0,3,0.42857142857142855,1,0.0,0,0,0,0,0,0,0,3,0,0,3,1
10446,154407,sL5jw3pLWZoRI7avI17oM60mfF67Acgz,SpATywNh6bZuzm8s1ceuBUnMUAeoAHHw,1,0,0,0,0,0,1,0,1,0.14285714285714285,1,0.0,0,0,0,0,0,0,0,1,0,0,1,0
10447,154416,sL5jw3pLWZoRI7avI17oM60mfF67Acgz,A3fsA9Zfv1X2fVEQhTw51lKENdNrEqT3,1,0,0,0,0,0,1,0,1,0.14285714285714285,1,0.0,0,0,0,0,0,0,0,1,0,0,1,0
10448,154427,OykLnAMH2CQ2oGjpNacvJNT6LnoApkhT,7GRhBDsirIGkRZBtSMEzNTyDr2JQm4xx,2,0,0,0,0,0,2,0,2,0.2857142857142857,1,0.0,0,0,0,0,0,0,0,2,0,0,2,1
10449,154428,Xbjcs0h4iqswHrts5r1qniR6WxCj6WXz,SpATywNh6bZuzm8s1ceuBUnMUAeoAHHw,8,2,1,0,1,1,6,1,12,1.7142857142857142,1,0.0,0,1,0,1,2,1,0,6,1,2,10,1
10450,154448,lhlon92qtIm50z28ydik0v6JhWIxsC1U,7GRhBDsirIGkRZBtSMEzNTyDr2JQm4xx,1,0,0,0,0,0,1,0,1,0.14285714285714285,1,0.0,0,0,0,0,0,0,0,1,0,0,1,1
10451,154474,iZp3ALNWwOETx9Rhz5RySkBkkPAlDqst,7GRhBDsirIGkRZBtSMEzNTyDr2JQm4xx,28,54,16,38,10,9,3,0,130,18.571428571428573,1,0.0,36,16,32,10,18,9,6,3,0,94,36,1
10452,154475,wMQxNrryGKgbGXsy17gJPlh2fJdDvt8s,7GRhBDsirIGkRZBtSMEzNTyDr2JQm4xx,6,3,2,0,2,0,1,0,8,1.1428571428571428,1,0.0,0,2,0,2,3,0,0,1,0,4,4,1
10453,154484,iacqYcgHTn7FZ8NE4roe5kgAUjDF0efr,7GRhBDsirIGkRZBtSMEzNTyDr2JQm4xx,13,18,10,6,5,1,16,1,57,8.142857142857142,5,0.0,2,10,5,5,16,1,1,16,1,22,35,1
10454,154517,oT3mLzHF4Tpr8bcFPMHSPaLobLxRQRsd,7GRhBDsirIGkRZBtSMEzNTyDr2JQm4xx,1,0,0,0,0,0,1,0,1,0.14285714285714285,1,0.0,0,0,0,0,0,0,0,1,0,0,1,1
10455,154521,BFTedJpOGn9f3lzS2daZGbUvWzaKCeH4,RXDvfPUBYFlVdlueBFbLW0mhhAyGEqpt,7,2,2,0,2,0,2,0,8,1.1428571428571428,1,0.0,0,2,0,2,2,0,0,2,0,4,4,1
10456,154583,asAtaJoAJHlf2G0ikRIi1BJt6dsbnxvW,7GRhBDsirIGkRZBtSMEzNTyDr2JQm4xx,19,44,2,26,4,0,15,0,91,13.0,6,0.0,16,2,22,4,28,0,4,15,0,44,47,1
10457,154596,LKQRwZ0wiIjNtxj2rwmRK6v48vwGtrYE,7GRhBDsirIGkRZBtSMEzNTyDr2JQm4xx,1,0,0,0,0,0,1,0,1,0.14285714285714285,1,0.0,0,0,0,0,0,0,0,1,0,0,1,1
10458,154635,futyrc5ZKHBBJxaxN8pRQj4FOD0yyEl8,7GRhBDsirIGkRZBtSMEzNTyDr2JQm4xx,38,107,26,64,36,2,4,0,239,34.142857142857146,3,0.0,42,26,58,36,65,2,6,4,0,162,77,1
10459,154664,wmND65rZOV8Cdq3Mq9MmFLy7XUHHSgIW,7GRhBDsirIGkRZBtSMEzNTyDr2JQm4xx,4,2,1,0,1,0,2,0,6,0.8571428571428571,1,0.0,0,1,0,1,2,0,0,2,0,2,4,1
10460,154665,wmND65rZOV8Cdq3Mq9MmFLy7XUHHSgIW,RXDvfPUBYFlVdlueBFbLW0mhhAyGEqpt,23,22,10,28,5,8,6,0,79,11.285714285714286,1,0.0,4,10,24,5,18,8,4,6,0,43,36,1
10461,154673,Bb6y6KL5R1oXKLejmEf2ogmY60nmHSEg,7GRhBDsirIGkRZBtSMEzNTyDr2JQm4xx,15,19,0,4,0,1,6,0,30,4.285714285714286,1,0.0,4,0,4,0,15,1,0,6,0,8,22,1
10462,154719,bQS9TypVeSJHdaY7Zz5SfbkFkeJ7Xy7P,G8EPVSXsOYB5YQWZGiz1aVq5Pgr2GrQu,11,9,1,0,0,3,9,1,23,3.2857142857142856,1,0.0,0,1,0,0,9,3,0,9,1,1,22,1
10463,154721,JkBKsyFO0Yc8vpbIVFPRsgPENSXQYzwJ,7GRhBDsirIGkRZBtSMEzNTyDr2JQm4xx,7,4,3,0,3,0,3,0,13,1.8571428571428572,1,0.0,0,3,0,3,4,0,0,3,0,6,7,1
10464,154750,9022MHPvnYCQFW4Qbw5KRQ2IXKBbqJc6,7GRhBDsirIGkRZBtSMEzNTyDr2JQm4xx,9,4,3,0,0,6,7,1,21,3.0,1,0.0,0,3,0,0,4,6,0,7,1,3,18,1
10465,154759,9g6cYAmFbDY0CjADcdMWUoQ4H4YvgLXQ,7GRhBDsirIGkRZBtSMEzNTyDr2JQm4xx,1,0,0,0,0,0,1,0,1,0.14285714285714285,1,0.0,0,0,0,0,0,0,0,1,0,0,1,1
10466,154764,BPDxtvSmkKR4nTdKjes8gGxzoOprTkK2,SpATywNh6bZuzm8s1ceuBUnMUAeoAHHw,16,22,12,19,8,8,8,1,78,11.142857142857142,2,0.0,6,12,16,8,16,8,3,8,1,42,36,1
10467,154808,qk3k8D6g4BBZslMQhuZKH29auh1oUGgB,SpATywNh6bZuzm8s1ceuBUnMUAeoAHHw,7,12,7,2,2,0,2,0,25,3.5714285714285716,1,0.0,4,7,2,2,8,0,0,2,0,15,10,0
10468,154820,Xf0Og50NXKhKGIY0WPfCy8ERJ7r6XgJl,7GRhBDsirIGkRZBtSMEzNTyDr2JQm4xx,1,0,0,0,0,0,1,0,1,0.14285714285714285,1,0.0,0,0,0,0,0,0,0,1,0,0,1,1
10469,154862,I1340YsGXK2BIG96XRWppOvFniqpKDu7,7GRhBDsirIGkRZBtSMEzNTyDr2JQm4xx,1,0,0,0,0,0,1,0,1,0.14285714285714285,1,0.0,0,0,0,0,0,0,0,1,0,0,1,1
10470,154911,yGvIE15GH4VA1DDC2IJtfMXXasgYhTMz,7GRhBDsirIGkRZBtSMEzNTyDr2JQm4xx,1,0,0,0,0,0,1,0,1,0.14285714285714285,1,0.0,0,0,0,0,0,0,0,1,0,0,1,1
10471,154913,j9DMqIZkavMsFdWoxVo3EuIrdKBeRzf9,RXDvfPUBYFlVdlueBFbLW0mhhAyGEqpt,46,44,24,47,15,5,9,0,144,20.571428571428573,1,0.0,12,24,47,15,32,5,0,9,0,98,46,1
10472,154940,MxhxHMlOpo3bTyeulVXY5tLPOxuKgX9g,RXDvfPUBYFlVdlueBFbLW0mhhAyGEqpt,10,5,4,0,2,2,4,3,20,2.857142857142857,1,0.0,0,4,0,2,5,2,0,4,3,6,14,1
10473,155027,PexOV0LWT1fDCzyfhjsaD6ViAyGfZwtP,SpATywNh6bZuzm8s1ceuBUnMUAeoAHHw,18,16,8,22,6,0,4,0,56,8.0,3,0.0,4,8,18,6,12,0,4,4,0,36,20,1
10474,155048,OqBkXI62rrUk2ckZzlCRqJd1hz7KQTiD,7GRhBDsirIGkRZBtSMEzNTyDr2JQm4xx,15,27,1,12,3,0,3,1,47,6.714285714285714,1,0.0,15,1,10,3,12,0,2,3,1,29,18,1
10475,155050,791uZs1oletLjsDrEfx07tDuNe91zVsB,7GRhBDsirIGkRZBtSMEzNTyDr2JQm4xx,7,3,2,0,2,0,2,0,9,1.2857142857142858,1,0.0,0,2,0,2,3,0,0,2,0,4,5,1
10476,155101,JbB7hpnQ5hVzqELznLtzJLRyOZ2rdnyH,A3fsA9Zfv1X2fVEQhTw51lKENdNrEqT3,27,19,10,58,0,19,14,1,121,17.285714285714285,2,0.0,3,10,50,0,16,19,8,14,1,63,58,1
10477,155102,JbB7hpnQ5hVzqELznLtzJLRyOZ2rdnyH,7GRhBDsirIGkRZBtSMEzNTyDr2JQm4xx,4,2,1,0,1,0,1,0,5,0.7142857142857143,1,0.0,0,1,0,1,2,0,0,1,0,2,3,1
10478,155129,t8qBiDTvOvYmrxcVIErRuEOf38tywm6t,7GRhBDsirIGkRZBtSMEzNTyDr2JQm4xx,26,46,22,30,13,36,4,1,152,21.714285714285715,1,0.0,19,22,25,13,27,36,5,4,1,79,73,1
10479,155141,PUySp8Qi7ahosRvBWR6xsbTAmeC3pRdT,SpATywNh6bZuzm8s1ceuBUnMUAeoAHHw,24,45,21,14,7,3,15,0,105,15.0,5,0.0,6,21,12,7,39,3,2,15,0,46,59,0
10480,155157,YBxdZNwXHdHfvV2eXmAcEoLMgpOYOPHS,7GRhBDsirIGkRZBtSMEzNTyDr2JQm4xx,9,8,5,8,5,0,2,0,28,4.0,1,0.0,3,5,7,5,5,0,1,2,0,20,8,1
10481,155173,JHfmlel9KNxicHtEPCs7j50mTEJgnt8P,7GRhBDsirIGkRZBtSMEzNTyDr2JQm4xx,1,0,0,0,0,0,1,0,1,0.14285714285714285,1,0.0,0,0,0,0,0,0,0,1,0,0,1,1
10482,155247,NfNQzrIJhmgRP7158cjFmvfhx6PtMoIG,7GRhBDsirIGkRZBtSMEzNTyDr2JQm4xx,7,0,0,0,0,2,6,1,9,1.2857142857142858,1,0.0,0,0,0,0,0,2,0,6,1,0,9,1
10483,155262,B1DHRbN7OgYmrICROsReSgvpNCm4AE9D,A3fsA9Zfv1X2fVEQhTw51lKENdNrEqT3,1,0,0,0,0,0,1,0,1,0.14285714285714285,1,0.0,0,0,0,0,0,0,0,1,0,0,1,1
10484,155268,5WJ9TRmJQHZjCB6N96s5yxRqedfFf2EC,7GRhBDsirIGkRZBtSMEzNTyDr2JQm4xx,5,2,1,0,1,0,2,0,6,0.8571428571428571,1,0.0,0,1,0,1,2,0,0,2,0,2,4,1
10485,155315,2DvkJl9UVozMaO0xGaO2ndEJOUw63HiE,7GRhBDsirIGkRZBtSMEzNTyDr2JQm4xx,4,2,1,0,1,0,1,0,5,0.7142857142857143,1,0.0,0,1,0,1,2,0,0,1,0,2,3,1
10486,155324,Bw1W3aypNX1U28lPbdggaNPof0tcfoYy,7GRhBDsirIGkRZBtSMEzNTyDr2JQm4xx,12,27,7,10,6,0,3,0,53,7.571428571428571,2,0.0,6,7,8,6,21,0,2,3,0,27,26,1
10487,155398,V6OdAS3CbYkwbVZibmDB3Td15gp0rTCi,7GRhBDsirIGkRZBtSMEzNTyDr2JQm4xx,4,2,1,0,1,0,1,0,5,0.7142857142857143,1,0.0,0,1,0,1,2,0,0,1,0,2,3,1
10488,155427,CORJXNhWUR52sdjQNNf8qLspXXnCgswJ,A3fsA9Zfv1X2fVEQhTw51lKENdNrEqT3,4,3,3,0,0,0,4,0,10,1.4285714285714286,1,0.0,0,3,0,0,3,0,0,4,0,3,7,1
10489,155458,anKy5XeCNcJg717tYlt4WP7NvJptZoH3,RXDvfPUBYFlVdlueBFbLW0mhhAyGEqpt,37,24,22,0,17,0,26,1,90,12.857142857142858,5,0.0,0,22,0,17,24,0,0,26,1,39,51,1
10490,155485,QjfVyTofFZLLFWX1ehKLt5ilQSOSAPiY,SpATywNh6bZuzm8s1ceuBUnMUAeoAHHw,28,30,16,38,7,9,4,0,104,14.857142857142858,1,0.0,13,16,33,7,17,9,5,4,0,69,35,1
10491,155497,QXCbenecbpNtho5u82xZRFTWClxbJ6H8,bWdj2GDclj5ofokWjzoa5jAwMkxCykd6,7,2,1,0,1,0,5,1,10,1.4285714285714286,1,0.0,0,1,0,1,2,0,0,5,1,2,8,1
10492,155502,4fggBiTulBMhqyvK9Klo3I0joX8sXLqR,G8EPVSXsOYB5YQWZGiz1aVq5Pgr2GrQu,1,0,0,0,0,0,1,0,1,0.14285714285714285,1,0.0,0,0,0,0,0,0,0,1,0,0,1,1
10493,155526,90qbve2c7woP8H6gtxTaHw527Ldlfcdt,SpATywNh6bZuzm8s1ceuBUnMUAeoAHHw,1,0,0,0,0,0,1,0,1,0.14285714285714285,1,0.0,0,0,0,0,0,0,0,1,0,0,1,1
10494,155529,90qbve2c7woP8H6gtxTaHw527Ldlfcdt,G8EPVSXsOYB5YQWZGiz1aVq5Pgr2GrQu,1,0,0,0,0,0,1,0,1,0.14285714285714285,1,0.0,0,0,0,0,0,0,0,1,0,0,1,1
10495,155530,j46DNjv2CGqL26N5PDFntx4e9zPVHO6p,G8EPVSXsOYB5YQWZGiz1aVq5Pgr2GrQu,2,0,0,0,0,0,2,0,2,0.2857142857142857,1,0.0,0,0,0,0,0,0,0,2,0,0,2,1
10496,155552,M3hg5TCyBFjaInA6DUnH93lf18qdYvu6,SpATywNh6bZuzm8s1ceuBUnMUAeoAHHw,10,3,2,0,2,8,8,1,24,3.4285714285714284,1,0.0,1,2,0,2,2,8,0,8,1,5,19,1
10497,155562,f7tZxTkA0B7yOxMWeydGO2hW0y86mAhD,RXDvfPUBYFlVdlueBFbLW0mhhAyGEqpt,14,9,6,0,5,0,5,0,25,3.5714285714285716,2,0.0,1,6,0,5,8,0,0,5,0,12,13,1
10498,155577,zvUmozhQnyXBySuAzEdyMCBcHeR55dKC,A3fsA9Zfv1X2fVEQhTw51lKENdNrEqT3,18,6,5,22,3,2,9,0,47,6.714285714285714,1,0.0,0,5,17,3,6,2,5,9,0,25,22,1
10499,155581,2ZRBFnStzt5cjrck9eS6oYGoTRuicZMh,G8EPVSXsOYB5YQWZGiz1aVq5Pgr2GrQu,10,11,2,0,2,0,2,0,17,2.4285714285714284,3,0.0,0,2,0,2,11,0,0,2,0,4,13,1
10500,155587,SKemaavr5OG5spO92jXls0zhTMuWKDja,bWdj2GDclj5ofokWjzoa5jAwMkxCykd6,1,0,0,0,0,0,1,0,1,0.14285714285714285,1,0.0,0,0,0,0,0,0,0,1,0,0,1,1
10501,155596,0qCFkatyVPL7csU80HaaNwiBF9ooLuJC,A3fsA9Zfv1X2fVEQhTw51lKENdNrEqT3,1,0,0,0,0,0,1,0,1,0.14285714285714285,1,0.0,0,0,0,0,0,0,0,1,0,0,1,1
10502,155605,SMXR6YI3QoKLXckr7byjkvJilyN0KrgC,bWdj2GDclj5ofokWjzoa5jAwMkxCykd6,5,7,2,0,3,0,5,0,17,2.4285714285714284,1,0.0,3,2,0,3,4,0,0,5,0,8,9,1
10503,155606,2rS9ufrltSIJVkQHjlKCjTvqcoR7anzz,bWdj2GDclj5ofokWjzoa5jAwMkxCykd6,4,3,1,0,1,0,1,0,6,0.8571428571428571,1,0.0,1,1,0,1,2,0,0,1,0,3,3,1
10504,155616,k0sbAnWIfD9ltAd5PyrJMhpQMWff3kVq,SpATywNh6bZuzm8s1ceuBUnMUAeoAHHw,10,16,7,0,7,0,1,0,31,4.428571428571429,2,0.0,0,7,0,7,16,0,0,1,0,14,17,1
10505,155617,VgnlAlKyJJS2tvM35xxyHRWLD1lxYQBK,SpATywNh6bZuzm8s1ceuBUnMUAeoAHHw,10,17,7,0,0,5,12,3,44,6.285714285714286,2,0.0,3,7,0,0,14,5,0,12,3,10,34,1
10506,155618,s6FY1tnJFeJCup1Eko54ROGWiTGeTtYm,SpATywNh6bZuzm8s1ceuBUnMUAeoAHHw,6,3,2,0,1,3,3,2,14,2.0,2,0.0,0,2,0,1,3,3,0,3,2,3,11,0
10507,155629,R5PVQLHQfRcyGqt0KVpTkwcmfBgB3rs1,A3fsA9Zfv1X2fVEQhTw51lKENdNrEqT3,4,0,0,0,0,0,11,0,11,1.5714285714285714,2,0.0,0,0,0,0,0,0,0,11,0,0,11,0
10508,155640,dd7Jtt1fMMutX1RG7iWTpWNKUpGu8Lqf,bWdj2GDclj5ofokWjzoa5jAwMkxCykd6,8,13,7,18,0,11,13,0,62,8.857142857142858,3,0.0,2,7,17,0,11,11,1,13,0,26,36,1
10509,155648,RDFpcJ9K2LX0Y5xHquXqcoe5PIHy9Vd3,A3fsA9Zfv1X2fVEQhTw51lKENdNrEqT3,46,56,22,68,18,12,11,3,190,27.142857142857142,1,0.0,3,22,65,18,53,12,3,11,3,108,82,1
10510,155665,8958pt2z4OHwTl32JK0k9CAPziEN4Bzu,A3fsA9Zfv1X2fVEQhTw51lKENdNrEqT3,17,16,10,0,5,1,6,0,38,5.428571428571429,3,0.0,0,10,0,5,16,1,0,6,0,15,23,1
10511,155671,3s8l6Oo3c1fXiiE9X1tB8PxtDiwQqFs1,SpATywNh6bZuzm8s1ceuBUnMUAeoAHHw,12,10,0,36,0,0,1,0,47,6.714285714285714,1,0.0,5,0,31,0,5,0,5,1,0,36,11,1
10512,155683,8958pt2z4OHwTl32JK0k9CAPziEN4Bzu,bWdj2GDclj5ofokWjzoa5jAwMkxCykd6,19,32,14,20,4,22,27,3,122,17.428571428571427,3,0.0,3,14,14,4,29,22,6,27,3,35,87,1
10513,155689,f7tZxTkA0B7yOxMWeydGO2hW0y86mAhD,SpATywNh6bZuzm8s1ceuBUnMUAeoAHHw,1,0,0,0,0,0,1,0,1,0.14285714285714285,1,0.0,0,0,0,0,0,0,0,1,0,0,1,1
10514,155693,f7tZxTkA0B7yOxMWeydGO2hW0y86mAhD,G8EPVSXsOYB5YQWZGiz1aVq5Pgr2GrQu,1,0,0,0,0,0,1,0,1,0.14285714285714285,1,0.0,0,0,0,0,0,0,0,1,0,0,1,1
10515,155695,PFQeRq3Dsbcn80aUj0YZWAW88oFDtPF9,SpATywNh6bZuzm8s1ceuBUnMUAeoAHHw,2,0,0,0,0,0,2,0,2,0.2857142857142857,1,0.0,0,0,0,0,0,0,0,2,0,0,2,1
10516,155704,CFhLEVkKrtcBJJ6gRh8HSuSfw1jMfUb7,bWdj2GDclj5ofokWjzoa5jAwMkxCykd6,2,0,0,0,0,0,2,0,2,0.2857142857142857,1,0.0,0,0,0,0,0,0,0,2,0,0,2,1
10517,155706,vxDKJhpoE0ZU5RIXhXpWK5bdxd3obhJ3,SpATywNh6bZuzm8s1ceuBUnMUAeoAHHw,1,0,0,0,0,0,1,0,1,0.14285714285714285,1,0.0,0,0,0,0,0,0,0,1,0,0,1,1
10518,155758,t5V0ixfffVZaZSFsWXyfGfVsjL4VioUW,A3fsA9Zfv1X2fVEQhTw51lKENdNrEqT3,2,0,0,0,0,0,2,0,2,0.2857142857142857,1,0.0,0,0,0,0,0,0,0,2,0,0,2,1
10519,155802,rdXoyX5PzGEa2IlOBAhmWFuNeQw6DxzT,SpATywNh6bZuzm8s1ceuBUnMUAeoAHHw,1,0,0,0,0,0,3,0,3,0.42857142857142855,1,0.0,0,0,0,0,0,0,0,3,0,0,3,1
10520,155808,rdXoyX5PzGEa2IlOBAhmWFuNeQw6DxzT,A3fsA9Zfv1X2fVEQhTw51lKENdNrEqT3,1,0,0,0,0,0,1,0,1,0.14285714285714285,1,0.0,0,0,0,0,0,0,0,1,0,0,1,1
10521,155810,IzKetdEf2SXOpqRxnB5y7Dzf3jbTkLdh,SpATywNh6bZuzm8s1ceuBUnMUAeoAHHw,2,0,0,0,0,1,1,0,2,0.2857142857142857,1,0.0,0,0,0,0,0,1,0,1,0,0,2,1
10522,155814,JlBcK2LKfnCBQn41BaZyu4VHnRO1Fg7Y,SpATywNh6bZuzm8s1ceuBUnMUAeoAHHw,8,9,2,14,0,0,4,0,29,4.142857142857143,1,0.0,6,2,13,0,3,0,1,4,0,21,8,0
10523,155840,ONg1SelorbsBSSFMlaPS8zkHzOEuFXME,RXDvfPUBYFlVdlueBFbLW0mhhAyGEqpt,10,13,1,0,1,0,6,0,21,3.0,1,0.0,0,1,0,1,13,0,0,6,0,2,19,1
10524,155852,2hFUtWkuc2dxIm3EniXMbBFapm5m6LBh,RXDvfPUBYFlVdlueBFbLW0mhhAyGEqpt,13,8,7,0,3,0,2,0,20,2.857142857142857,1,0.0,0,7,0,3,8,0,0,2,0,10,10,1
10525,155869,A5TywkowEbOHLvVVnqjs9APzsGZaYsjO,SpATywNh6bZuzm8s1ceuBUnMUAeoAHHw,7,3,2,0,2,0,2,0,9,1.2857142857142858,1,0.0,0,2,0,2,3,0,0,2,0,4,5,1
10526,155880,N9KQH02KbukvyuWvom0gbDomFEZReA7X,SpATywNh6bZuzm8s1ceuBUnMUAeoAHHw,13,10,2,0,2,0,6,1,21,3.0,1,0.0,0,2,0,2,10,0,0,6,1,4,17,1
10527,155893,4G4cusC28dHeOh2Typ91i1q3Okbvvqth,SpATywNh6bZuzm8s1ceuBUnMUAeoAHHw,18,27,14,24,7,0,5,0,77,11.0,2,0.0,6,14,20,7,21,0,4,5,0,47,30,0
10528,155904,mbBmZOvWFQnr2jr80Xest0JLKlAyyOuX,A3fsA9Zfv1X2fVEQhTw51lKENdNrEqT3,22,14,13,0,12,0,7,1,47,6.714285714285714,1,0.0,0,13,0,12,14,0,0,7,1,25,22,1
10529,155908,kui6N1aCNXaCsOCuisWh9NWzU01ICH8U,A3fsA9Zfv1X2fVEQhTw51lKENdNrEqT3,1,0,0,0,0,0,1,0,1,0.14285714285714285,1,0.0,0,0,0,0,0,0,0,1,0,0,1,1
10530,155948,4fYqS5i8zH5iFL9FCzQ9Jw4wAZdnrAvU,A3fsA9Zfv1X2fVEQhTw51lKENdNrEqT3,7,4,3,0,3,0,2,0,12,1.7142857142857142,1,0.0,0,3,0,3,4,0,0,2,0,6,6,1
10531,155949,27kP6FdDHuUVxPZHHeymFgogwQfiPjhl,RXDvfPUBYFlVdlueBFbLW0mhhAyGEqpt,10,9,6,0,3,9,4,0,31,4.428571428571429,2,0.0,0,6,0,3,9,9,0,4,0,9,22,1
10532,155984,CCCbrBYe8XRHX4ZhfNEK7mAQPHEjIWLc,A3fsA9Zfv1X2fVEQhTw51lKENdNrEqT3,10,6,3,0,2,1,7,0,19,2.7142857142857144,1,0.0,0,3,0,2,6,1,0,7,0,5,14,1
10533,155994,xSvCHzbSKemMKYEdGEAC5YZv1OdVf9nN,A3fsA9Zfv1X2fVEQhTw51lKENdNrEqT3,1,0,0,0,0,0,1,0,1,0.14285714285714285,1,0.0,0,0,0,0,0,0,0,1,0,0,1,1
10534,156005,AEtcQOknCsZXTvFkJ2Dw6PQ26CmvNLPh,SpATywNh6bZuzm8s1ceuBUnMUAeoAHHw,1,0,0,0,0,0,1,0,1,0.14285714285714285,1,0.0,0,0,0,0,0,0,0,1,0,0,1,1
10535,156021,PTBT7vCebvS4BFc8gXeo7jxunCeWBjOU,SpATywNh6bZuzm8s1ceuBUnMUAeoAHHw,2,0,0,0,0,0,2,0,2,0.2857142857142857,1,0.0,0,0,0,0,0,0,0,2,0,0,2,1
10536,156050,LIH6u87VTR1542727Uc42mhP2iK5GaFP,RXDvfPUBYFlVdlueBFbLW0mhhAyGEqpt,1,0,0,0,0,0,2,0,2,0.2857142857142857,2,0.0,0,0,0,0,0,0,0,2,0,0,2,1
10537,156071,gSloYsDed4N39YdVhV4tNTApSxYbZ2HF,A3fsA9Zfv1X2fVEQhTw51lKENdNrEqT3,1,0,0,0,0,0,1,0,1,0.14285714285714285,1,0.0,0,0,0,0,0,0,0,1,0,0,1,1
10538,156076,kJbPd4KyCeUkny294dkEDUG2lkV9m74w,RXDvfPUBYFlVdlueBFbLW0mhhAyGEqpt,6,3,1,0,0,0,5,0,9,1.2857142857142858,1,0.0,0,1,0,0,3,0,0,5,0,1,8,1
10539,156079,NLfKoJ9aC8i7mKu1ZdgdkE6zG1FgejH0,SpATywNh6bZuzm8s1ceuBUnMUAeoAHHw,4,3,1,0,0,0,2,0,6,0.8571428571428571,1,0.0,0,1,0,0,3,0,0,2,0,1,5,1
10540,156083,65WrAm7LwtsX3nVDTLh1bnXt0L79cL04,bWdj2GDclj5ofokWjzoa5jAwMkxCykd6,9,11,6,0,1,2,8,1,29,4.142857142857143,2,0.0,0,6,0,1,11,2,0,8,1,7,22,0
10541,156096,VPJtyjlRgoD1Uh96mtOqMndW9SwTakqy,bWdj2GDclj5ofokWjzoa5jAwMkxCykd6,1,0,0,0,0,0,1,0,1,0.14285714285714285,1,0.0,0,0,0,0,0,0,0,1,0,0,1,0
10542,156099,GxWg4h8gAiKctUf8VxaJMnstU2gEPNkZ,SpATywNh6bZuzm8s1ceuBUnMUAeoAHHw,13,15,6,36,0,0,2,0,59,8.428571428571429,2,0.0,6,6,31,0,9,0,5,2,0,43,16,1
10543,156119,RK4dzyspr24Rnz8TQ13QOCSoSUcsVTY4,SpATywNh6bZuzm8s1ceuBUnMUAeoAHHw,5,4,2,0,0,0,4,0,10,1.4285714285714286,2,0.0,0,2,0,0,4,0,0,4,0,2,8,1
10544,156145,15UKel3wmzTW7LtBYJPrTEQPhHIKX4AO,A3fsA9Zfv1X2fVEQhTw51lKENdNrEqT3,2,0,0,0,0,0,2,0,2,0.2857142857142857,1,0.0,0,0,0,0,0,0,0,2,0,0,2,1
10545,156168,COpqi7PB37yJZ0BYYjHIpqMxiJ4vAe0U,bWdj2GDclj5ofokWjzoa5jAwMkxCykd6,1,0,0,0,0,0,1,0,1,0.14285714285714285,1,0.0,0,0,0,0,0,0,0,1,0,0,1,1
10546,156179,sGlMvtHnoZ3VKCRj86vjviJ0RxBg0FOx,SpATywNh6bZuzm8s1ceuBUnMUAeoAHHw,23,31,0,35,0,11,8,1,86,12.285714285714286,1,0.0,9,0,30,0,22,11,5,8,1,39,47,0
10547,156188,8o3Hi98AoLvhH8lRB2OWB562ZTdBh0M9,A3fsA9Zfv1X2fVEQhTw51lKENdNrEqT3,1,0,0,0,0,0,1,0,1,0.14285714285714285,1,0.0,0,0,0,0,0,0,0,1,0,0,1,1
10548,156211,KDWP2k3afTGhSxEaH7oA3UMXbJchV5C0,SpATywNh6bZuzm8s1ceuBUnMUAeoAHHw,8,7,3,0,2,0,3,0,15,2.142857142857143,2,0.0,0,3,0,2,7,0,0,3,0,5,10,0
10549,156223,EgnWqiW3LiA7qLbsztCmkjoYm253Rxt1,SpATywNh6bZuzm8s1ceuBUnMUAeoAHHw,1,0,0,0,0,0,1,0,1,0.14285714285714285,1,0.0,0,0,0,0,0,0,0,1,0,0,1,1
10550,156248,2rcvhx1rR5YxLdJduMzgm4BAqYgFhtji,G8EPVSXsOYB5YQWZGiz1aVq5Pgr2GrQu,6,3,1,0,1,0,4,0,9,1.2857142857142858,2,0.0,0,1,0,1,3,0,0,4,0,2,7,1
10551,156255,3MlpYZJz2aixs29anq45r6qVwlCBHq0f,G8EPVSXsOYB5YQWZGiz1aVq5Pgr2GrQu,8,3,1,0,1,1,4,0,10,1.4285714285714286,1,0.0,0,1,0,1,3,1,0,4,0,2,8,1
10552,156260,TVPORDuXFZycPf0Vi3wZKRTY1n2f7P3G,A3fsA9Zfv1X2fVEQhTw51lKENdNrEqT3,17,18,7,14,2,14,26,3,84,12.0,3,0.0,1,7,13,2,17,14,1,26,3,23,61,1
10553,156335,GMYiFsIWS5fNg7F5TvdvcvWY8TKSFKZz,SpATywNh6bZuzm8s1ceuBUnMUAeoAHHw,2,0,0,0,0,0,3,0,3,0.42857142857142855,1,0.0,0,0,0,0,0,0,0,3,0,0,3,1
10554,156341,4j0oreGLK5cXhR86icYUGacmhPp1TTs2,G8EPVSXsOYB5YQWZGiz1aVq5Pgr2GrQu,7,3,2,0,2,0,3,0,10,1.4285714285714286,1,0.0,0,2,0,2,3,0,0,3,0,4,6,1
10555,156384,eQeAZJfAlQDBFNhBayGkUGtYxXtMJqJ1,A3fsA9Zfv1X2fVEQhTw51lKENdNrEqT3,20,39,23,4,9,1,13,0,89,12.714285714285714,5,0.0,0,23,3,9,39,1,1,13,0,35,54,1
10556,156391,HptaxHcLRNNIglVlBAbROpX7eNhSXE5r,G8EPVSXsOYB5YQWZGiz1aVq5Pgr2GrQu,3,0,0,0,0,0,3,0,3,0.42857142857142855,1,0.0,0,0,0,0,0,0,0,3,0,0,3,1
10557,156411,wVyNNZlShsUBKENfExM0aYsh2zqsJcHZ,SpATywNh6bZuzm8s1ceuBUnMUAeoAHHw,1,0,0,0,0,0,1,0,1,0.14285714285714285,1,0.0,0,0,0,0,0,0,0,1,0,0,1,1
10558,156418,BJqHNXVOuknKXVN8kWe148UD34ryhX5w,A3fsA9Zfv1X2fVEQhTw51lKENdNrEqT3,9,5,3,0,3,0,1,0,12,1.7142857142857142,1,0.0,0,3,0,3,5,0,0,1,0,6,6,1
10559,156442,yLIplHU7bk7trasZvaOCHx4t4qY5x8AA,A3fsA9Zfv1X2fVEQhTw51lKENdNrEqT3,4,0,0,0,0,0,6,0,6,0.8571428571428571,1,0.0,0,0,0,0,0,0,0,6,0,0,6,1
10560,156446,grhneBVDCBhvBD53OXACTDGfdH3pEWQ2,G8EPVSXsOYB5YQWZGiz1aVq5Pgr2GrQu,3,2,0,0,0,0,1,0,3,0.42857142857142855,1,0.0,0,0,0,0,2,0,0,1,0,0,3,1
10561,156452,kiukAy7oxipXUU8Ys4wcsL36Pp7URsoj,RXDvfPUBYFlVdlueBFbLW0mhhAyGEqpt,21,21,2,0,2,0,5,0,30,4.285714285714286,3,0.0,0,2,0,2,21,0,0,5,0,4,26,0
10562,156454,Uylyq7LmmNSvSWdWZxt9uRF9NmGdfp0A,A3fsA9Zfv1X2fVEQhTw51lKENdNrEqT3,12,13,10,0,7,0,5,0,35,5.0,2,0.0,0,10,0,7,13,0,0,5,0,17,18,1
10563,156455,e2xISjGUnUd5kxkj4EP9L59IdMd1R2EQ,SpATywNh6bZuzm8s1ceuBUnMUAeoAHHw,5,2,1,0,1,0,3,0,7,1.0,1,0.0,0,1,0,1,2,0,0,3,0,2,5,1
10564,156458,Xv79C7MvAlcrBgCLn9VASALUsdTDRY9k,A3fsA9Zfv1X2fVEQhTw51lKENdNrEqT3,1,0,0,0,0,0,1,0,1,0.14285714285714285,1,0.0,0,0,0,0,0,0,0,1,0,0,1,1
10565,156460,Xv79C7MvAlcrBgCLn9VASALUsdTDRY9k,bWdj2GDclj5ofokWjzoa5jAwMkxCykd6,4,3,1,0,0,0,2,0,6,0.8571428571428571,1,0.0,1,1,0,0,2,0,0,2,0,2,4,1
10566,156481,1MYBio9DblM2ma2YQCVmpn2rr8cupAiN,A3fsA9Zfv1X2fVEQhTw51lKENdNrEqT3,1,0,0,0,0,0,1,0,1,0.14285714285714285,1,0.0,0,0,0,0,0,0,0,1,0,0,1,1
10567,156483,1MYBio9DblM2ma2YQCVmpn2rr8cupAiN,G8EPVSXsOYB5YQWZGiz1aVq5Pgr2GrQu,1,0,0,0,0,0,1,0,1,0.14285714285714285,1,0.0,0,0,0,0,0,0,0,1,0,0,1,1
10568,156484,QCbtKC2wY9sgozuVQgVgy7Djz4UhLkqZ,SpATywNh6bZuzm8s1ceuBUnMUAeoAHHw,5,2,1,0,1,0,2,0,6,0.8571428571428571,1,0.0,0,1,0,1,2,0,0,2,0,2,4,1
10569,156522,pOXPjpm9uh7g9vxK8UCO5j9l2hW4sztB,G8EPVSXsOYB5YQWZGiz1aVq5Pgr2GrQu,5,1,1,0,1,0,4,0,7,1.0,1,0.0,0,1,0,1,1,0,0,4,0,2,5,1
10570,156559,Un3EzEE4Sz8i5Z84q9e50URbIAEkkVSB,bWdj2GDclj5ofokWjzoa5jAwMkxCykd6,11,9,3,0,3,1,16,2,34,4.857142857142857,4,0.0,0,3,0,3,9,1,0,16,2,6,28,1
10571,156565,MTBFJm3bIEaE6OQdIPJiDEIIoJhDDIeA,SpATywNh6bZuzm8s1ceuBUnMUAeoAHHw,8,2,2,0,2,0,3,0,9,1.2857142857142858,1,0.0,0,2,0,2,2,0,0,3,0,4,5,1
10572,156571,OLSxCkluLildKVrVnzRIsj47tt9tVHj9,RXDvfPUBYFlVdlueBFbLW0mhhAyGEqpt,5,2,1,0,1,0,4,0,8,1.1428571428571428,2,0.0,0,1,0,1,2,0,0,4,0,2,6,1
10573,156582,Vdk84P68xIHXBGrWqw3oEozZYT063dLv,SpATywNh6bZuzm8s1ceuBUnMUAeoAHHw,5,2,1,0,1,0,2,0,6,0.8571428571428571,1,0.0,0,1,0,1,2,0,0,2,0,2,4,0
10574,156591,j7YtZasgspNNzi8PoR1n8xBZYl8hPf0G,bWdj2GDclj5ofokWjzoa5jAwMkxCykd6,1,0,0,0,0,0,2,0,2,0.2857142857142857,1,0.0,0,0,0,0,0,0,0,2,0,0,2,1
10575,156611,zCl6F2bpK7NJ4O3NtU8qe3DgIKVmj35C,SpATywNh6bZuzm8s1ceuBUnMUAeoAHHw,5,2,1,0,1,0,2,0,6,0.8571428571428571,1,0.0,0,1,0,1,2,0,0,2,0,2,4,1
10576,156627,yoNF71FjmlchDw8CrVsPoTImtdirrSh8,SpATywNh6bZuzm8s1ceuBUnMUAeoAHHw,12,11,1,7,1,0,1,0,21,3.0,1,0.0,2,1,6,1,9,0,1,1,0,10,11,1
10577,156691,YSuxkE1Xqan24aiv5kdAAXS5OHLY0Aml,A3fsA9Zfv1X2fVEQhTw51lKENdNrEqT3,16,12,9,18,5,1,5,0,50,7.142857142857143,2,0.0,1,9,15,5,11,1,3,5,0,30,20,0
10578,156708,qzgqMBszLUnJd9ZV8Zyg9x0an59yJyuH,A3fsA9Zfv1X2fVEQhTw51lKENdNrEqT3,63,71,48,104,19,12,31,2,287,41.0,5,0.0,6,48,89,19,65,12,15,31,2,162,125,1
10579,156714,gLb9HBNsGES4iiLngE7LJlzcsHLIiWPc,bWdj2GDclj5ofokWjzoa5jAwMkxCykd6,6,5,0,0,1,0,2,0,8,1.1428571428571428,1,0.0,0,0,0,1,5,0,0,2,0,1,7,1
10580,156721,CUbueK74RGsaWBcRtztdoMN84Z7TxEjm,A3fsA9Zfv1X2fVEQhTw51lKENdNrEqT3,1,0,0,0,0,0,1,0,1,0.14285714285714285,1,0.0,0,0,0,0,0,0,0,1,0,0,1,0
10581,156738,OektSQ9TNN3cEy3ZKuUs35c7BdSOqtaQ,A3fsA9Zfv1X2fVEQhTw51lKENdNrEqT3,6,4,2,0,1,0,4,0,11,1.5714285714285714,2,0.0,0,2,0,1,4,0,0,4,0,3,8,1
10582,156741,uafClU57KYzpGT2uPAu1Hr0wJXO4izc7,bWdj2GDclj5ofokWjzoa5jAwMkxCykd6,2,0,0,0,0,0,3,0,3,0.42857142857142855,1,0.0,0,0,0,0,0,0,0,3,0,0,3,1
10583,156745,QtwtavP81h42E4zJzMznn2bf4MZADbs3,A3fsA9Zfv1X2fVEQhTw51lKENdNrEqT3,4,1,0,0,0,0,4,0,5,0.7142857142857143,1,0.0,0,0,0,0,1,0,0,4,0,0,5,1
10584,156757,MOcMwRKo0dtFqZ5xWBgRzquuZGKtQyf4,bWdj2GDclj5ofokWjzoa5jAwMkxCykd6,5,4,2,0,1,0,2,0,9,1.2857142857142858,2,0.0,0,2,0,1,4,0,0,2,0,3,6,1
10585,156758,Bt5rX9oXtFoN3UVn5z9aey4iI5wtlrvh,A3fsA9Zfv1X2fVEQhTw51lKENdNrEqT3,41,18,10,80,6,0,5,0,119,17.0,2,0.0,5,10,71,6,13,0,9,5,0,92,27,0
10586,156771,509hMngiUm6zrKoE3SecqGuN8tx0I6r6,SpATywNh6bZuzm8s1ceuBUnMUAeoAHHw,4,5,0,0,0,0,0,0,5,0.7142857142857143,1,0.0,0,0,0,0,5,0,0,0,0,0,5,1
10587,156772,509hMngiUm6zrKoE3SecqGuN8tx0I6r6,A3fsA9Zfv1X2fVEQhTw51lKENdNrEqT3,3,3,0,0,0,0,0,0,3,0.42857142857142855,1,0.0,0,0,0,0,3,0,0,0,0,0,3,1
10588,156782,5vvAIYSZAT26IXVwYTJynoQoKJk6ajG9,SpATywNh6bZuzm8s1ceuBUnMUAeoAHHw,7,3,2,0,2,0,3,0,10,1.4285714285714286,1,0.0,0,2,0,2,3,0,0,3,0,4,6,1
10589,156784,foHHzg8y8kVV0aOnqOspjjxNSKCSJYQ9,SpATywNh6bZuzm8s1ceuBUnMUAeoAHHw,9,7,5,0,3,0,3,0,18,2.5714285714285716,2,0.0,0,5,0,3,7,0,0,3,0,8,10,1
10590,156811,nqSXUXXEr4UIgbMex1vOrc4sZti4WIMg,bWdj2GDclj5ofokWjzoa5jAwMkxCykd6,4,4,2,0,0,0,2,0,8,1.1428571428571428,1,0.0,1,2,0,0,3,0,0,2,0,3,5,1
10591,156816,3yoGJn4wINiLioKDt9oLKFssOQfyQK8Z,SpATywNh6bZuzm8s1ceuBUnMUAeoAHHw,18,22,1,28,0,5,6,1,63,9.0,1,0.0,5,1,25,0,17,5,3,6,1,31,32,1
10592,157175,ZzYVZYoFRu6qmqfcBrYTS7mqaBTKsIny,7GRhBDsirIGkRZBtSMEzNTyDr2JQm4xx,1,0,0,0,0,0,1,0,1,0.14285714285714285,1,0.0,0,0,0,0,0,0,0,1,0,0,1,1
10593,157186,z6ogSWESGLxUuhgsxETNGPj2TtNqAMAt,7GRhBDsirIGkRZBtSMEzNTyDr2JQm4xx,2,0,0,0,0,0,2,0,2,0.2857142857142857,1,0.0,0,0,0,0,0,0,0,2,0,0,2,1
10594,157192,caQBTqoYm97O8lwsyp08CNg4MqbUA2Eo,7GRhBDsirIGkRZBtSMEzNTyDr2JQm4xx,7,6,3,0,1,0,5,0,15,2.142857142857143,1,0.0,0,3,0,1,6,0,0,5,0,4,11,1
10595,157193,i7vqGsozRewVYx6giRpm4P211SLUVjxQ,7GRhBDsirIGkRZBtSMEzNTyDr2JQm4xx,1,0,0,0,0,0,1,0,1,0.14285714285714285,1,0.0,0,0,0,0,0,0,0,1,0,0,1,1
10596,157196,YrBOxIkMDTPHtQeP4ha6MwTNuOzQva6q,7GRhBDsirIGkRZBtSMEzNTyDr2JQm4xx,2,0,0,0,0,0,8,0,8,1.1428571428571428,1,0.0,0,0,0,0,0,0,0,8,0,0,8,1
10597,157197,LpTOzhB0melA572OJERO4db65eD7w0cu,7GRhBDsirIGkRZBtSMEzNTyDr2JQm4xx,6,4,2,0,0,1,4,0,11,1.5714285714285714,1,0.0,1,2,0,0,3,1,0,4,0,3,8,1
10598,157201,0XtimRygN8aPS4UsgNYsDLh7g7VQkUin,7GRhBDsirIGkRZBtSMEzNTyDr2JQm4xx,2,0,0,0,0,0,3,0,3,0.42857142857142855,1,0.0,0,0,0,0,0,0,0,3,0,0,3,1
10599,157205,c3IQaJpJUkPE2qecKNSJwAyLl2PKb8yr,7GRhBDsirIGkRZBtSMEzNTyDr2JQm4xx,2,0,0,0,0,0,4,0,4,0.5714285714285714,1,0.0,0,0,0,0,0,0,0,4,0,0,4,1
10600,157207,1q7fbJprMr3n3JslWMG8Y37W51nC2LZB,7GRhBDsirIGkRZBtSMEzNTyDr2JQm4xx,5,3,1,0,1,1,4,0,10,1.4285714285714286,1,0.0,0,1,0,1,3,1,0,4,0,2,8,1
10601,157208,u1kEY9BTucDdRevAFNS3TzvwB9cnTuyG,7GRhBDsirIGkRZBtSMEzNTyDr2JQm4xx,2,0,0,0,0,0,2,0,2,0.2857142857142857,1,0.0,0,0,0,0,0,0,0,2,0,0,2,1
10602,157244,hrE2wqQITNDujGOu31qZ9nVLSRudlDFi,7GRhBDsirIGkRZBtSMEzNTyDr2JQm4xx,47,76,23,30,28,16,7,0,180,25.714285714285715,4,0.0,21,23,18,28,55,16,12,7,0,90,90,0
10603,157269,ZW10p50itaf2NuSU5aKpQEE3l8rBuIkc,7GRhBDsirIGkRZBtSMEzNTyDr2JQm4xx,1,0,0,0,0,0,1,0,1,0.14285714285714285,1,0.0,0,0,0,0,0,0,0,1,0,0,1,0
10604,157276,rw1CeO1TCa8fgCdp1zXNf3dRKMz7g6nk,7GRhBDsirIGkRZBtSMEzNTyDr2JQm4xx,2,0,0,0,0,0,2,0,2,0.2857142857142857,1,0.0,0,0,0,0,0,0,0,2,0,0,2,1
10605,157293,0Rc9QmalpGXvwxh2iIaT1Kf7aHCEMOJW,7GRhBDsirIGkRZBtSMEzNTyDr2JQm4xx,4,3,1,0,1,0,1,0,6,0.8571428571428571,1,0.0,0,1,0,1,3,0,0,1,0,2,4,1
10606,157295,RkMMgfrDoCy0k6xciXBqfQqum2o9XEow,7GRhBDsirIGkRZBtSMEzNTyDr2JQm4xx,5,2,0,0,0,0,4,0,6,0.8571428571428571,1,0.0,0,0,0,0,2,0,0,4,0,0,6,1
10607,157300,0a6HihupPBi4xpjolN637qOYG6WSN1Gx,7GRhBDsirIGkRZBtSMEzNTyDr2JQm4xx,10,9,5,0,5,0,4,0,23,3.2857142857142856,1,0.0,2,5,0,5,7,0,0,4,0,12,11,1
10608,157312,9FHojamNYxBNrQ6PYQ6fNVNJw4Al6wFf,7GRhBDsirIGkRZBtSMEzNTyDr2JQm4xx,30,72,5,8,8,3,19,2,117,16.714285714285715,2,0.0,28,5,6,8,44,3,2,19,2,47,70,1
10609,157338,cOx2ivO0cjd2S3OxGikx2UdSMlRcgy0Q,7GRhBDsirIGkRZBtSMEzNTyDr2JQm4xx,1,0,0,0,0,0,3,0,3,0.42857142857142855,2,0.0,0,0,0,0,0,0,0,3,0,0,3,1
10610,157363,lBHUi5hQhqG9vQMxFTu02cmFxiJKc01u,7GRhBDsirIGkRZBtSMEzNTyDr2JQm4xx,2,0,0,0,0,0,2,0,2,0.2857142857142857,1,0.0,0,0,0,0,0,0,0,2,0,0,2,1
10611,157493,oBNu1yheXNm4QzvTpRG6uVhpeMCjpi7n,7GRhBDsirIGkRZBtSMEzNTyDr2JQm4xx,21,18,14,10,10,0,3,0,55,7.857142857142857,2,0.0,2,14,10,10,16,0,0,3,0,36,19,1
10612,157525,1cJ3IiBP3iso6zCDFOfl79OCcoYhGWhv,7GRhBDsirIGkRZBtSMEzNTyDr2JQm4xx,1,0,0,0,0,0,1,0,1,0.14285714285714285,1,0.0,0,0,0,0,0,0,0,1,0,0,1,1
10613,157538,Qzxs3prleGy5HanVMqS0iFlTNJtBW0w6,7GRhBDsirIGkRZBtSMEzNTyDr2JQm4xx,1,0,0,0,0,0,1,0,1,0.14285714285714285,1,0.0,0,0,0,0,0,0,0,1,0,0,1,1
10614,157552,HkZ9cpNX2CkQYteixnJNqLUCAlpOg3MZ,7GRhBDsirIGkRZBtSMEzNTyDr2JQm4xx,1,0,0,0,0,0,1,0,1,0.14285714285714285,1,0.0,0,0,0,0,0,0,0,1,0,0,1,1
10615,157566,k3v7Eyu7Dh3B7oRJvMZeSglihGPbIbyB,7GRhBDsirIGkRZBtSMEzNTyDr2JQm4xx,2,0,0,0,0,0,2,0,2,0.2857142857142857,1,0.0,0,0,0,0,0,0,0,2,0,0,2,1
10616,157576,V1tEn8Shi0xM6f4Xd1g5Spwc7qOHvOqG,7GRhBDsirIGkRZBtSMEzNTyDr2JQm4xx,5,3,2,0,2,0,4,0,11,1.5714285714285714,2,0.0,0,2,0,2,3,0,0,4,0,4,7,1
10617,157622,mUDgTVmygSuewvWeFS0TPPpUtE7wznA7,7GRhBDsirIGkRZBtSMEzNTyDr2JQm4xx,13,27,14,0,1,1,2,0,45,6.428571428571429,1,0.0,7,14,0,1,20,1,0,2,0,22,23,1
10618,160311,0dBn4alo7QBTd62VD5XO0yNMbQ5QN2OQ,7GRhBDsirIGkRZBtSMEzNTyDr2JQm4xx,7,7,5,0,0,0,4,0,16,2.2857142857142856,1,0.0,0,5,0,0,7,0,0,4,0,5,11,1
10619,160315,bwArOOJKwGOF13mHU5aKU9fUr71McJvH,7GRhBDsirIGkRZBtSMEzNTyDr2JQm4xx,5,2,1,0,1,0,2,0,6,0.8571428571428571,1,0.0,0,1,0,1,2,0,0,2,0,2,4,1
10620,160320,DJenb7iikHj085JzrOjjcdsjyfa241f7,7GRhBDsirIGkRZBtSMEzNTyDr2JQm4xx,24,21,14,0,12,0,2,0,49,7.0,3,0.0,5,14,0,12,16,0,0,2,0,31,18,1
10621,160384,k0UdEkfpJlSzidBudzci9vFF4yrsXxgQ,7GRhBDsirIGkRZBtSMEzNTyDr2JQm4xx,1,0,0,0,0,0,1,0,1,0.14285714285714285,1,0.0,0,0,0,0,0,0,0,1,0,0,1,0
10622,160389,4TYIBYUjGx5Az0xYJI94tEHK7klSyatr,7GRhBDsirIGkRZBtSMEzNTyDr2JQm4xx,40,50,16,28,23,0,3,0,120,17.142857142857142,1,0.0,31,16,19,23,19,0,9,3,0,89,31,1
10623,160396,zO6yqNtTJB4M08etRFNDLB7i6krzXD0l,7GRhBDsirIGkRZBtSMEzNTyDr2JQm4xx,3,0,0,0,0,0,5,0,5,0.7142857142857143,1,0.0,0,0,0,0,0,0,0,5,0,0,5,1
10624,160401,rPClLoAvWie6mQgFe052QTDjrbW05Z38,7GRhBDsirIGkRZBtSMEzNTyDr2JQm4xx,9,9,6,0,4,7,4,0,30,4.285714285714286,1,0.0,1,6,0,4,8,7,0,4,0,11,19,1
10625,160411,5D8TCJus8jJePlvJzQ7Sr3SBFEIyS2MR,7GRhBDsirIGkRZBtSMEzNTyDr2JQm4xx,2,0,0,0,0,0,2,0,2,0.2857142857142857,1,0.0,0,0,0,0,0,0,0,2,0,0,2,1
10626,160432,uPwo7A29gDp2eZiRxT2ZvOEZhimArTNp,7GRhBDsirIGkRZBtSMEzNTyDr2JQm4xx,2,0,0,0,0,0,2,0,2,0.2857142857142857,1,0.0,0,0,0,0,0,0,0,2,0,0,2,1
10627,160442,YkNwKcv9lSDkBPqsMb0WziNidETs7ep9,7GRhBDsirIGkRZBtSMEzNTyDr2JQm4xx,2,0,0,0,0,0,2,0,2,0.2857142857142857,1,0.0,0,0,0,0,0,0,0,2,0,0,2,1
10628,160444,KBuOxjKuU610PCeSJDQZDprlbjuZT4li,7GRhBDsirIGkRZBtSMEzNTyDr2JQm4xx,21,36,14,8,11,0,3,0,72,10.285714285714286,1,0.0,19,14,4,11,17,0,4,3,0,48,24,1
10629,160471,PBSAJnWnXGHZ7IVhIZxN6aQTQb0G2vO7,7GRhBDsirIGkRZBtSMEzNTyDr2JQm4xx,1,0,0,0,0,0,1,0,1,0.14285714285714285,1,0.0,0,0,0,0,0,0,0,1,0,0,1,1
10630,160476,hD4u7K20MkeesFqmBh9Esq7QUUZdGCv9,7GRhBDsirIGkRZBtSMEzNTyDr2JQm4xx,3,0,0,0,0,0,3,0,3,0.42857142857142855,1,0.0,0,0,0,0,0,0,0,3,0,0,3,1
10631,160480,oYErMzphr0xt2i2tKTG42QELMDaumLkL,7GRhBDsirIGkRZBtSMEzNTyDr2JQm4xx,6,7,3,0,1,0,2,0,13,1.8571428571428572,1,0.0,1,3,0,1,6,0,0,2,0,5,8,1
10632,160486,GGB9bCfhLsvvSPzNJWyTOJucbjEzgrET,7GRhBDsirIGkRZBtSMEzNTyDr2JQm4xx,1,0,0,0,0,0,1,0,1,0.14285714285714285,1,0.0,0,0,0,0,0,0,0,1,0,0,1,1
10633,160500,KOlXIysOb8VF04tCZjd1kg0II2kb2mYu,7GRhBDsirIGkRZBtSMEzNTyDr2JQm4xx,1,0,0,0,0,0,1,0,1,0.14285714285714285,1,0.0,0,0,0,0,0,0,0,1,0,0,1,1
10634,160506,VJsbRtMXxy8aqyccEZDzV7pPAGBosBu1,7GRhBDsirIGkRZBtSMEzNTyDr2JQm4xx,1,0,0,0,0,0,1,0,1,0.14285714285714285,1,0.0,0,0,0,0,0,0,0,1,0,0,1,1
10635,160508,RoGFusJTdgK8k3Zd6iMFweLZIxW5k7pS,7GRhBDsirIGkRZBtSMEzNTyDr2JQm4xx,6,6,4,0,1,0,4,0,15,2.142857142857143,1,0.0,0,4,0,1,6,0,0,4,0,5,10,1
10636,160518,PRY10k18YynTwKp6d8DErN4q5S6hJbG0,7GRhBDsirIGkRZBtSMEzNTyDr2JQm4xx,3,2,0,0,0,0,1,0,3,0.42857142857142855,1,0.0,0,0,0,0,2,0,0,1,0,0,3,1
10637,160528,56J91Yo5ifJy5MJXjIh6Ft8DpaRkdQsg,7GRhBDsirIGkRZBtSMEzNTyDr2JQm4xx,1,0,0,0,0,0,1,0,1,0.14285714285714285,1,0.0,0,0,0,0,0,0,0,1,0,0,1,1
10638,160533,93Zm4nrRg1wL0XUZJzZZ7TfOboLDGoxJ,7GRhBDsirIGkRZBtSMEzNTyDr2JQm4xx,5,0,0,0,0,0,4,2,6,0.8571428571428571,1,0.0,0,0,0,0,0,0,0,4,2,0,6,1
10639,160536,jV3IFI6hAwcYex0pw7Nq9u1gcioXGewT,7GRhBDsirIGkRZBtSMEzNTyDr2JQm4xx,1,0,0,0,0,0,1,0,1,0.14285714285714285,1,0.0,0,0,0,0,0,0,0,1,0,0,1,1
10640,160678,08OTJovI4mN1P4AUjCgqGCGzY3HAu3jj,A3fsA9Zfv1X2fVEQhTw51lKENdNrEqT3,1,0,0,0,0,0,1,0,1,0.14285714285714285,1,0.0,0,0,0,0,0,0,0,1,0,0,1,1
10641,160762,JqVdWoQHyNqeUwMTtrPuJeUxrm3Ef7QH,SpATywNh6bZuzm8s1ceuBUnMUAeoAHHw,17,21,5,19,2,0,4,0,51,7.285714285714286,2,0.0,11,5,18,2,10,0,1,4,0,36,15,1
10642,160775,ZgNdO7hyoQRmg00lVh0JR0YxTL2sBLXr,SpATywNh6bZuzm8s1ceuBUnMUAeoAHHw,12,7,3,0,2,0,20,1,33,4.714285714285714,2,0.0,0,3,0,2,7,0,0,20,1,5,28,0
10643,160837,3f8TEYsxw8fTx61szmPewZsIJHdQMPuP,SpATywNh6bZuzm8s1ceuBUnMUAeoAHHw,15,11,6,12,3,13,11,0,56,8.0,1,0.0,3,6,12,3,8,13,0,11,0,24,32,0
10644,160842,ffjWC7PpsqUyQ4g8h9cR2OgJ4csHrEGY,7GRhBDsirIGkRZBtSMEzNTyDr2JQm4xx,1,0,0,0,0,0,1,0,1,0.14285714285714285,1,0.0,0,0,0,0,0,0,0,1,0,0,1,1
10645,160932,OAT2DaBS2qqaVHQUCn9wipcvqj5Upvl2,A3fsA9Zfv1X2fVEQhTw51lKENdNrEqT3,1,0,0,0,0,0,1,0,1,0.14285714285714285,1,0.0,0,0,0,0,0,0,0,1,0,0,1,1
10646,160956,3G8UKlMnri0uMjx4kTUdEFUnuVu9MqyS,7GRhBDsirIGkRZBtSMEzNTyDr2JQm4xx,4,4,1,0,2,0,2,0,9,1.2857142857142858,1,0.0,2,1,0,2,2,0,0,2,0,5,4,1
10647,160963,W4swLEiF6xa4CU1Ee5z4jQMNXyEDiyxR,SpATywNh6bZuzm8s1ceuBUnMUAeoAHHw,4,2,0,0,0,2,2,0,6,0.8571428571428571,1,0.0,0,0,0,0,2,2,0,2,0,0,6,1
10648,160991,fDaxh7N7NdJHdXsnAIuELHd50CNN3hz9,7GRhBDsirIGkRZBtSMEzNTyDr2JQm4xx,2,0,0,0,0,0,2,0,2,0.2857142857142857,1,0.0,0,0,0,0,0,0,0,2,0,0,2,1
10649,161027,CetRT5zy2dJHyaPU2zMnW0reXnT8Dv2y,bWdj2GDclj5ofokWjzoa5jAwMkxCykd6,2,0,0,0,0,0,4,0,4,0.5714285714285714,1,0.0,0,0,0,0,0,0,0,4,0,0,4,0
10650,161071,kD7KrEgPns8NN7pPH4RunWGvMBAYF6OW,7GRhBDsirIGkRZBtSMEzNTyDr2JQm4xx,4,2,0,0,0,0,3,0,5,0.7142857142857143,1,0.0,0,0,0,0,2,0,0,3,0,0,5,1
10651,161076,BbvGM92sGSMMIrRMXDFdD1GEnySzXRYT,A3fsA9Zfv1X2fVEQhTw51lKENdNrEqT3,1,0,0,0,0,0,1,0,1,0.14285714285714285,1,0.0,0,0,0,0,0,0,0,1,0,0,1,0
10652,161079,JDFQZtkjaBhYZM0MLFNIDJC3MmDM3j4N,SpATywNh6bZuzm8s1ceuBUnMUAeoAHHw,17,16,9,10,4,12,14,1,66,9.428571428571429,4,0.0,5,9,8,4,11,12,2,14,1,26,40,0
10653,161120,bAABlYXwSxLGjyoM2mZWwlEcMoay9TKF,7GRhBDsirIGkRZBtSMEzNTyDr2JQm4xx,34,49,20,36,13,13,25,8,164,23.428571428571427,1,0.0,23,20,33,13,26,13,3,25,8,89,75,1
10654,161146,wKtjicmtXDLrlymiwnuOgL0XJQtQSxfX,7GRhBDsirIGkRZBtSMEzNTyDr2JQm4xx,2,0,0,0,0,0,2,0,2,0.2857142857142857,1,0.0,0,0,0,0,0,0,0,2,0,0,2,1
10655,161208,FgKGJkcyrlk2UGTZTaDtYvcpTKr0lNLA,7GRhBDsirIGkRZBtSMEzNTyDr2JQm4xx,11,12,6,10,4,0,7,0,39,5.571428571428571,2,0.0,4,6,8,4,8,0,2,7,0,22,17,1
10656,161246,B5jlZpEDxUNGCe4UQsaYbJ99Z8y5d2lN,A3fsA9Zfv1X2fVEQhTw51lKENdNrEqT3,1,0,0,0,0,0,1,0,1,0.14285714285714285,1,0.0,0,0,0,0,0,0,0,1,0,0,1,0
10657,161273,vuVnTFCBfdzSvUffWnstx1XETLzOHwWp,SpATywNh6bZuzm8s1ceuBUnMUAeoAHHw,9,10,6,0,5,0,1,0,22,3.142857142857143,1,0.0,0,6,0,5,10,0,0,1,0,11,11,0
10658,161286,ZfEmNtZnnnOMQU2ZxafVmay1LudDsU5A,A3fsA9Zfv1X2fVEQhTw51lKENdNrEqT3,5,2,1,0,1,0,2,0,6,0.8571428571428571,1,0.0,0,1,0,1,2,0,0,2,0,2,4,1
10659,161290,jMYQxsCNKY5cLAg44E5z2BIKSAvgdfQc,7GRhBDsirIGkRZBtSMEzNTyDr2JQm4xx,5,2,1,0,1,0,2,0,6,0.8571428571428571,1,0.0,0,1,0,1,2,0,0,2,0,2,4,1
10660,161354,8mGbGwW0kqMWmEPWmvTNX7d3rQGPeEB8,SpATywNh6bZuzm8s1ceuBUnMUAeoAHHw,2,0,0,0,0,0,2,0,2,0.2857142857142857,1,0.0,0,0,0,0,0,0,0,2,0,0,2,0
10661,161386,adfbW7xBPY784GRXAIq3fInFogIbD6ro,SpATywNh6bZuzm8s1ceuBUnMUAeoAHHw,25,37,17,21,0,2,14,2,93,13.285714285714286,4,0.0,9,17,19,0,28,2,2,14,2,45,48,0
10662,161412,uqHSgHtPqI0pLXHTpUBns1eF4e9jsvt1,7GRhBDsirIGkRZBtSMEzNTyDr2JQm4xx,1,0,0,0,0,0,1,0,1,0.14285714285714285,1,0.0,0,0,0,0,0,0,0,1,0,0,1,1
10663,161432,7Y5C8uyNuEClb8hOu715XyJadaHTCp61,SpATywNh6bZuzm8s1ceuBUnMUAeoAHHw,4,2,1,0,1,0,1,0,5,0.7142857142857143,1,0.0,0,1,0,1,2,0,0,1,0,2,3,1
10664,161465,QwzgqwSHCQGBlqpFzwe8sYcM8CZG7iZ9,SpATywNh6bZuzm8s1ceuBUnMUAeoAHHw,6,5,1,0,1,0,3,0,10,1.4285714285714286,1,0.0,0,1,0,1,5,0,0,3,0,2,8,1
10665,161577,Khe9KlmSoSTsax6cgkl9d8UgiAE6YdMj,7GRhBDsirIGkRZBtSMEzNTyDr2JQm4xx,8,6,3,0,1,0,3,0,13,1.8571428571428572,1,0.0,0,3,0,1,6,0,0,3,0,4,9,1
10666,161606,JyZKV6Cx4T3sb5lEewrPu89ztBDJpjHB,7GRhBDsirIGkRZBtSMEzNTyDr2JQm4xx,1,0,0,0,0,0,1,0,1,0.14285714285714285,1,0.0,0,0,0,0,0,0,0,1,0,0,1,1
10667,161622,0PgvslXgC0pgpIZFL5uHzeqmbNWkjEcF,7GRhBDsirIGkRZBtSMEzNTyDr2JQm4xx,15,17,1,0,1,6,7,1,33,4.714285714285714,1,0.0,2,1,0,1,15,6,0,7,1,4,29,1
10668,161667,q1QqcOJEpZrZKGZXfigMjZ8ytnCI74VX,7GRhBDsirIGkRZBtSMEzNTyDr2JQm4xx,2,0,0,0,0,0,2,0,2,0.2857142857142857,1,0.0,0,0,0,0,0,0,0,2,0,0,2,1
10669,161706,2XDpaAo3slMsrFQXFgtVX89IlqkzpX74,7GRhBDsirIGkRZBtSMEzNTyDr2JQm4xx,25,46,4,45,0,9,4,0,108,15.428571428571429,2,0.0,23,4,37,0,23,9,8,4,0,64,44,1
10670,161713,ySy2zYThCkVZr5MjEXuKxq60wfOynxkJ,7GRhBDsirIGkRZBtSMEzNTyDr2JQm4xx,1,0,0,0,0,0,1,0,1,0.14285714285714285,1,0.0,0,0,0,0,0,0,0,1,0,0,1,1
10671,161720,xdxiKeJYKflgdr88D3HSJXuR1e81YpjG,7GRhBDsirIGkRZBtSMEzNTyDr2JQm4xx,11,10,3,6,3,0,4,1,27,3.857142857142857,2,0.0,5,3,6,3,5,0,0,4,1,17,10,1
10672,161747,i7uheDJIh5lOS1HvZimsF1kp1fKEvbnh,7GRhBDsirIGkRZBtSMEzNTyDr2JQm4xx,1,0,0,0,0,0,1,0,1,0.14285714285714285,1,0.0,0,0,0,0,0,0,0,1,0,0,1,1
10673,161754,Xipj7T5lLiw1KZ1W0l4R2RMWExB1p24F,7GRhBDsirIGkRZBtSMEzNTyDr2JQm4xx,1,0,0,0,0,0,2,0,2,0.2857142857142857,2,0.0,0,0,0,0,0,0,0,2,0,0,2,1
10674,161876,rwuM6JXyr9NW5skD2mjToJGXTpHNXOXm,7GRhBDsirIGkRZBtSMEzNTyDr2JQm4xx,14,11,5,4,4,4,11,0,39,5.571428571428571,2,0.0,3,5,3,4,8,4,1,11,0,15,24,1
10675,161903,UtNvwiEIu7iQRo2Po9FxglHJbAYaDW68,7GRhBDsirIGkRZBtSMEzNTyDr2JQm4xx,34,69,4,81,1,23,10,0,188,26.857142857142858,4,0.0,39,4,65,1,30,23,16,10,0,109,79,0
10676,161916,UwYS4S13mN9PKtlnG61IUx3MqUPXsSwd,7GRhBDsirIGkRZBtSMEzNTyDr2JQm4xx,1,0,0,0,0,0,1,0,1,0.14285714285714285,1,0.0,0,0,0,0,0,0,0,1,0,0,1,1
10677,161917,ClHMnOLy9vZKRtNjcA9yPWajeNvRCNdE,7GRhBDsirIGkRZBtSMEzNTyDr2JQm4xx,56,109,23,119,17,1,4,0,273,39.0,2,0.0,48,23,106,17,61,1,13,4,0,194,79,1
10678,161935,uKGXhzbiDEpxCHjVlf9dmkGcQbxLosVe,7GRhBDsirIGkRZBtSMEzNTyDr2JQm4xx,18,16,11,0,8,1,9,1,46,6.571428571428571,2,0.0,0,11,0,8,16,1,0,9,1,19,27,1
10679,161939,5kEshmgSAUGvBEOsnsKU8IViB0lkOwoD,7GRhBDsirIGkRZBtSMEzNTyDr2JQm4xx,10,5,0,48,0,0,2,0,55,7.857142857142857,1,0.0,2,0,43,0,3,0,5,2,0,45,10,1
10680,161972,MXpZg6Y3WvwOURUS1VvgXTxhk1pXKVY7,7GRhBDsirIGkRZBtSMEzNTyDr2JQm4xx,13,11,5,12,6,0,1,0,35,5.0,1,0.0,5,5,10,6,6,0,2,1,0,26,9,1
10681,161994,ePOpOKycvORTPdc6DfieYb44dd8ej3gR,7GRhBDsirIGkRZBtSMEzNTyDr2JQm4xx,1,0,0,0,0,0,1,0,1,0.14285714285714285,1,0.0,0,0,0,0,0,0,0,1,0,0,1,1
10682,162062,J8ozccvPLhHs7wXw9VrsAZ8xFj3qhhGw,7GRhBDsirIGkRZBtSMEzNTyDr2JQm4xx,9,14,6,4,1,1,3,0,29,4.142857142857143,2,0.0,2,6,3,1,12,1,1,3,0,12,17,1
10683,162105,iJS4NO25TGJOkDkxwNThNbes0mRasAmQ,7GRhBDsirIGkRZBtSMEzNTyDr2JQm4xx,19,19,11,16,12,0,4,0,62,8.857142857142858,2,0.0,4,11,14,12,15,0,2,4,0,41,21,1
10684,162121,jjgQ4rbsYW6nenx45QcLulM61xyCV5lA,7GRhBDsirIGkRZBtSMEzNTyDr2JQm4xx,1,0,0,0,0,0,1,0,1,0.14285714285714285,1,0.0,0,0,0,0,0,0,0,1,0,0,1,1
10685,162160,oBhK6ZD6VFllj6i4Noya3bCJzaI8iNet,7GRhBDsirIGkRZBtSMEzNTyDr2JQm4xx,1,0,0,0,0,0,1,0,1,0.14285714285714285,1,0.0,0,0,0,0,0,0,0,1,0,0,1,1
10686,162259,ZttplEH5TKj1WzPyzoO9Df2vFzi15P8B,7GRhBDsirIGkRZBtSMEzNTyDr2JQm4xx,5,2,1,0,1,0,2,0,6,0.8571428571428571,1,0.0,0,1,0,1,2,0,0,2,0,2,4,0
10687,162270,CXpq1UcG0elhHuiCZeD2FXcwR7rCcPqM,7GRhBDsirIGkRZBtSMEzNTyDr2JQm4xx,1,0,0,0,0,0,1,0,1,0.14285714285714285,1,0.0,0,0,0,0,0,0,0,1,0,0,1,1
10688,162310,IY2XGmMLdQpnN2CAArJJlJXjbbQc8pm5,7GRhBDsirIGkRZBtSMEzNTyDr2JQm4xx,9,3,3,0,3,0,4,1,14,2.0,1,0.0,0,3,0,3,3,0,0,4,1,6,8,1
10689,162313,Ql4EosuzRo0tVj3lvTLhkLOyEsWZly6m,7GRhBDsirIGkRZBtSMEzNTyDr2JQm4xx,18,17,6,27,7,3,4,0,64,9.142857142857142,1,0.0,8,6,24,7,9,3,3,4,0,45,19,1
10690,162315,eLddk0FueVUEJUwpfOsyoO4vLUtPFHIZ,7GRhBDsirIGkRZBtSMEzNTyDr2JQm4xx,2,0,0,0,0,0,2,0,2,0.2857142857142857,1,0.0,0,0,0,0,0,0,0,2,0,0,2,1
10691,162321,FRqEtBjptiNhO97ht9j9vzryGlyCBOWn,7GRhBDsirIGkRZBtSMEzNTyDr2JQm4xx,1,0,0,0,0,0,1,0,1,0.14285714285714285,1,0.0,0,0,0,0,0,0,0,1,0,0,1,1
10692,162361,SRWyybFCyRnJ5WkAnmW9p9zBXOYVWjli,7GRhBDsirIGkRZBtSMEzNTyDr2JQm4xx,8,4,3,0,3,0,3,1,14,2.0,1,0.0,0,3,0,3,4,0,0,3,1,6,8,1
10693,162368,1YVvREjW4GG7vGtDdZTgfavzuWoJyEQ1,7GRhBDsirIGkRZBtSMEzNTyDr2JQm4xx,3,2,1,0,0,0,1,0,4,0.5714285714285714,1,0.0,0,1,0,0,2,0,0,1,0,1,3,1
10694,162648,Nc3ZZeizgzMQ7ljgRcfUdDiH0EOAXMpI,fbPkOYLVPtPgIt0MxizjfFJov3JbHyAi,10,16,10,2,6,0,6,0,40,5.714285714285714,4,0.0,1,10,2,6,15,0,0,6,0,19,21,1
10695,162649,0KUBjckzhPh04pcpref906kWaVGOckIo,fbPkOYLVPtPgIt0MxizjfFJov3JbHyAi,1,0,0,0,0,0,1,0,1,0.14285714285714285,1,0.0,0,0,0,0,0,0,0,1,0,0,1,1
10696,162650,V6E1tx9saR5jAji0JFYWv5QlYX2evnTz,fbPkOYLVPtPgIt0MxizjfFJov3JbHyAi,5,4,1,0,1,0,1,0,7,1.0,1,0.0,0,1,0,1,4,0,0,1,0,2,5,1
10697,162651,YowQZlyvBksxQT6KgTXhQMJmbU93kRLD,fbPkOYLVPtPgIt0MxizjfFJov3JbHyAi,9,4,3,0,2,0,6,0,15,2.142857142857143,2,0.0,0,3,0,2,4,0,0,6,0,5,10,1
10698,162652,ez8FDX1i0b7pyEME5JxBBRyGHo5i1NxT,fbPkOYLVPtPgIt0MxizjfFJov3JbHyAi,5,2,1,0,1,0,11,0,15,2.142857142857143,1,0.0,0,1,0,1,2,0,0,11,0,2,13,1
10699,162656,KSRVmTGtqcEHSDvxEeA6R7dUXFztkOiS,fbPkOYLVPtPgIt0MxizjfFJov3JbHyAi,9,3,2,0,2,1,10,0,18,2.5714285714285716,1,0.0,0,2,0,2,3,1,0,10,0,4,14,1
10700,162657,2D1HXSTD406ltsrZw4ApG5jDeXzE2KN2,fbPkOYLVPtPgIt0MxizjfFJov3JbHyAi,9,4,3,0,3,0,6,1,17,2.4285714285714284,1,0.0,0,3,0,3,4,0,0,6,1,6,11,1
10701,162658,xC5auIx5EjJCsJXVxhOLOCVWQh5LEXXH,fbPkOYLVPtPgIt0MxizjfFJov3JbHyAi,6,7,4,0,0,0,1,0,12,1.7142857142857142,1,0.0,0,4,0,0,7,0,0,1,0,4,8,1
10702,162659,WSgIm6djd7gHeBntYx8K78vnaXdzEUiL,fbPkOYLVPtPgIt0MxizjfFJov3JbHyAi,1,0,0,0,0,0,1,0,1,0.14285714285714285,1,0.0,0,0,0,0,0,0,0,1,0,0,1,1
10703,162660,llYG1mfEDeV8Y5AFdIVbdEPymP3mr3rj,fbPkOYLVPtPgIt0MxizjfFJov3JbHyAi,6,2,1,0,1,0,3,0,7,1.0,1,0.0,0,1,0,1,2,0,0,3,0,2,5,1
10704,162661,KZBxo2oXfcrXYFa3c9hEkQ12gjuvG6yO,fbPkOYLVPtPgIt0MxizjfFJov3JbHyAi,15,28,12,0,5,0,9,0,54,7.714285714285714,2,0.0,2,12,0,5,26,0,0,9,0,19,35,1
10705,162666,naFnVVivN8IeDypOt2hjD9CIwDCj76XP,fbPkOYLVPtPgIt0MxizjfFJov3JbHyAi,9,4,3,0,3,0,4,0,14,2.0,1,0.0,0,3,0,3,4,0,0,4,0,6,8,1
10706,162671,MH888ZUNYQEtzY7davmN9IOBnnNRrZa7,fbPkOYLVPtPgIt0MxizjfFJov3JbHyAi,2,0,0,0,0,0,6,0,6,0.8571428571428571,1,0.0,0,0,0,0,0,0,0,6,0,0,6,1
10707,162673,7l3GpI16MslYkR5zIHoJyawqfDaUFhUp,fbPkOYLVPtPgIt0MxizjfFJov3JbHyAi,15,33,10,16,13,7,8,0,87,12.428571428571429,3,0.0,15,10,13,13,18,7,3,8,0,51,36,1
10708,162676,yYnx2Djc2xdWmysqfYS5LaytJ644aZht,fbPkOYLVPtPgIt0MxizjfFJov3JbHyAi,10,14,7,0,6,3,6,1,37,5.285714285714286,1,0.0,4,7,0,6,10,3,0,6,1,17,20,1
10709,162678,QLkjPbhzjYBuoRyN6jpM1zgzPhFcXPgV,fbPkOYLVPtPgIt0MxizjfFJov3JbHyAi,7,2,1,0,1,0,6,1,11,1.5714285714285714,1,0.0,0,1,0,1,2,0,0,6,1,2,9,1
10710,162679,4wGoSTuzJXBCojeNmaxk9GbR1KaCV7ql,fbPkOYLVPtPgIt0MxizjfFJov3JbHyAi,1,0,0,0,0,0,1,0,1,0.14285714285714285,1,0.0,0,0,0,0,0,0,0,1,0,0,1,1
10711,162680,Zt0s8z7D4BOSO5NcolkhNghzd1kCk6hq,fbPkOYLVPtPgIt0MxizjfFJov3JbHyAi,1,0,0,0,0,0,1,0,1,0.14285714285714285,1,0.0,0,0,0,0,0,0,0,1,0,0,1,1
10712,162681,uoKTE5T5YjIuFpYd6T7OJca437ewpV5r,fbPkOYLVPtPgIt0MxizjfFJov3JbHyAi,7,4,3,0,2,1,5,0,15,2.142857142857143,1,0.0,0,3,0,2,4,1,0,5,0,5,10,1
10713,162682,pvA5hAXeC4hqGygcnZUaZJq577cEj1jy,fbPkOYLVPtPgIt0MxizjfFJov3JbHyAi,4,2,0,0,0,0,4,0,6,0.8571428571428571,1,0.0,0,0,0,0,2,0,0,4,0,0,6,1
10714,162685,VW6QI6YQieHfuGH7gHn8hEJuMvSxxHAp,fbPkOYLVPtPgIt0MxizjfFJov3JbHyAi,7,6,4,0,3,0,2,0,15,2.142857142857143,1,0.0,0,4,0,3,6,0,0,2,0,7,8,1
10715,162687,y8AdDSbHENRUD5ii0AuyONW5YY98sBlv,fbPkOYLVPtPgIt0MxizjfFJov3JbHyAi,2,0,0,0,0,0,2,0,2,0.2857142857142857,1,0.0,0,0,0,0,0,0,0,2,0,0,2,1
10716,162689,OY5aMjVZYmvVnPhf0Ien1tS1qoTzYCve,fbPkOYLVPtPgIt0MxizjfFJov3JbHyAi,1,0,0,0,0,0,1,0,1,0.14285714285714285,1,0.0,0,0,0,0,0,0,0,1,0,0,1,1
10717,162690,4fAtuZyf3pqLNg4NAgnHL2LTveUsNAHR,fbPkOYLVPtPgIt0MxizjfFJov3JbHyAi,12,13,0,0,0,0,10,2,25,3.5714285714285716,2,0.0,1,0,0,0,12,0,0,10,2,1,24,1
10718,162691,RXL48ch4QpTtcFwRepyduTfKEKrGyTKN,fbPkOYLVPtPgIt0MxizjfFJov3JbHyAi,9,16,8,0,4,2,10,0,40,5.714285714285714,2,0.0,1,8,0,4,15,2,0,10,0,13,27,1
10719,162692,gwOQCfMjy3mPEOM9frEBJIEoEp54k479,fbPkOYLVPtPgIt0MxizjfFJov3JbHyAi,7,5,2,0,2,0,4,0,13,1.8571428571428572,1,0.0,2,2,0,2,3,0,0,4,0,6,7,1
10720,162693,cAiYY43X2fHcaVTtJkfbXwU4uE2YSYcT,fbPkOYLVPtPgIt0MxizjfFJov3JbHyAi,1,0,0,0,0,0,1,0,1,0.14285714285714285,1,0.0,0,0,0,0,0,0,0,1,0,0,1,1
10721,162694,Ht6ACDtkBUDQYG2zJ9PW4yD5omwx8FOt,fbPkOYLVPtPgIt0MxizjfFJov3JbHyAi,14,13,10,0,7,1,10,0,41,5.857142857142857,2,0.0,0,10,0,7,13,1,0,10,0,17,24,1
10722,162695,HjTLxjkRtxfAyk5V8KdvHAETDClCPqM8,fbPkOYLVPtPgIt0MxizjfFJov3JbHyAi,2,0,0,0,0,0,2,0,2,0.2857142857142857,1,0.0,0,0,0,0,0,0,0,2,0,0,2,1
10723,162696,d0rOxeHVhXN56S1SdxDqutEizIO79l17,fbPkOYLVPtPgIt0MxizjfFJov3JbHyAi,7,2,1,0,1,0,5,0,9,1.2857142857142858,1,0.0,0,1,0,1,2,0,0,5,0,2,7,1
10724,162697,itGGfLzW4kinBqXhqpdYcm0uN1rV3AUu,fbPkOYLVPtPgIt0MxizjfFJov3JbHyAi,8,2,1,0,1,35,10,1,50,7.142857142857143,1,0.0,0,1,0,1,2,35,0,10,1,2,48,1
10725,162698,Qkc0CJeX5rSUk4cMC7WmTWxFf636HopV,fbPkOYLVPtPgIt0MxizjfFJov3JbHyAi,7,3,2,0,2,0,2,0,9,1.2857142857142858,2,0.0,0,2,0,2,3,0,0,2,0,4,5,1
10726,162699,zOMqB2xbzDTe4odeoQFhdTt3CHQxy4f2,fbPkOYLVPtPgIt0MxizjfFJov3JbHyAi,5,2,1,0,1,0,3,0,7,1.0,1,0.0,0,1,0,1,2,0,0,3,0,2,5,1
10727,162701,CqDZkF3Y4Ub1OGba7JosAdKhIi9VL2wR,fbPkOYLVPtPgIt0MxizjfFJov3JbHyAi,8,3,2,0,2,0,3,0,10,1.4285714285714286,1,0.0,0,2,0,2,3,0,0,3,0,4,6,1
10728,162703,Vvmg4GFkxtES0j2sr2rm1vhisTqz0hYp,fbPkOYLVPtPgIt0MxizjfFJov3JbHyAi,1,0,0,0,0,0,1,0,1,0.14285714285714285,1,0.0,0,0,0,0,0,0,0,1,0,0,1,1
10729,162705,EXeNK59x0ypZcTmicRInOt3hG7yAskPL,fbPkOYLVPtPgIt0MxizjfFJov3JbHyAi,1,0,0,0,0,0,1,0,1,0.14285714285714285,1,0.0,0,0,0,0,0,0,0,1,0,0,1,1
10730,162707,cqdnmjbJq0lDv2xgeKuzXqVr5xQytWr0,fbPkOYLVPtPgIt0MxizjfFJov3JbHyAi,1,0,0,0,0,0,1,0,1,0.14285714285714285,1,0.0,0,0,0,0,0,0,0,1,0,0,1,1
10731,162709,gD7dR7qYBA1tFY5jHEs9UR01plTA8iId,fbPkOYLVPtPgIt0MxizjfFJov3JbHyAi,8,8,5,0,2,0,4,0,19,2.7142857142857144,1,0.0,0,5,0,2,8,0,0,4,0,7,12,1
10732,162712,cXYqUXWJSTT7g3JkZOD6VVFxaOdV583i,fbPkOYLVPtPgIt0MxizjfFJov3JbHyAi,12,10,7,0,7,0,1,0,25,3.5714285714285716,1,0.0,1,7,0,7,9,0,0,1,0,15,10,1
10733,162714,HwZxiuOTyvjMb92UmTQViLX9URtxzqcc,fbPkOYLVPtPgIt0MxizjfFJov3JbHyAi,5,3,1,0,1,0,2,0,7,1.0,1,0.0,0,1,0,1,3,0,0,2,0,2,5,1
10734,163119,roYkXgGyx3GWrvCQLlmWjFgv8fXNpbMZ,7GRhBDsirIGkRZBtSMEzNTyDr2JQm4xx,15,13,4,74,2,0,2,0,95,13.571428571428571,1,0.0,6,4,66,2,7,0,8,2,0,78,17,1
10735,163123,Fyuejl2dlbgFcYdGhx8H5nzT5OEI84Gi,7GRhBDsirIGkRZBtSMEzNTyDr2JQm4xx,14,23,0,12,1,6,1,0,43,6.142857142857143,1,0.0,14,0,6,1,9,6,6,1,0,21,22,1
10736,163143,0Hsb4jmfnz1a6io2949XgCNHeNRXVX7s,7GRhBDsirIGkRZBtSMEzNTyDr2JQm4xx,2,0,0,0,0,0,2,0,2,0.2857142857142857,1,0.0,0,0,0,0,0,0,0,2,0,0,2,1
10737,163169,tZMtcgGsCq7JvLpFL4lhYMv0agvGaZe2,7GRhBDsirIGkRZBtSMEzNTyDr2JQm4xx,10,6,1,0,1,1,6,0,15,2.142857142857143,2,0.0,0,1,0,1,6,1,0,6,0,2,13,1
10738,163179,s6B1c6HsYtYgFfNQaANtHBiEvk3BxrNI,7GRhBDsirIGkRZBtSMEzNTyDr2JQm4xx,4,1,0,0,0,5,4,0,10,1.4285714285714286,1,0.0,0,0,0,0,1,5,0,4,0,0,10,1
10739,163201,3Mkd8wUIycmVOp3bXkQhrkLLJQvE7obi,7GRhBDsirIGkRZBtSMEzNTyDr2JQm4xx,1,0,0,0,0,0,2,0,2,0.2857142857142857,1,0.0,0,0,0,0,0,0,0,2,0,0,2,1
10740,163212,qPinNnuwG11dRyXbHR9eoc8JbfTOf2YH,7GRhBDsirIGkRZBtSMEzNTyDr2JQm4xx,1,0,0,0,0,0,1,0,1,0.14285714285714285,1,0.0,0,0,0,0,0,0,0,1,0,0,1,1
10741,163220,8Cr8Vd1mU7TZdVM3CmCM42IjN2PAOQUN,7GRhBDsirIGkRZBtSMEzNTyDr2JQm4xx,32,42,14,24,11,0,2,0,93,13.285714285714286,1,0.0,22,14,13,11,20,0,11,2,0,60,33,0
10742,163260,xWEkYGAfNptAwZnPYzVBCVMgcZk3qKaB,7GRhBDsirIGkRZBtSMEzNTyDr2JQm4xx,7,21,1,2,0,0,2,0,26,3.7142857142857144,1,0.0,5,1,1,0,16,0,1,2,0,7,19,1
10743,163270,qnvX4ck8f7yWnykYmnmSide0xnZ2M9gG,7GRhBDsirIGkRZBtSMEzNTyDr2JQm4xx,7,5,2,0,3,0,4,1,15,2.142857142857143,1,0.0,2,2,0,3,3,0,0,4,1,7,8,1
10744,163297,QjCKOuadW7uvxwklu6VUWdeXSYG5ZySL,7GRhBDsirIGkRZBtSMEzNTyDr2JQm4xx,5,2,1,0,1,0,2,0,6,0.8571428571428571,1,0.0,0,1,0,1,2,0,0,2,0,2,4,1
10745,163306,Wd5Y51TL4njlLeYHUjz5D9nrsHvDXUZ8,7GRhBDsirIGkRZBtSMEzNTyDr2JQm4xx,1,0,0,0,0,0,1,0,1,0.14285714285714285,1,0.0,0,0,0,0,0,0,0,1,0,0,1,1
10746,163445,xXU9KJwMH5fbM7NnMKoHs3jEsDiPaALW,bWdj2GDclj5ofokWjzoa5jAwMkxCykd6,8,9,0,4,1,0,11,0,25,3.5714285714285716,2,0.0,5,0,3,1,4,0,1,11,0,9,16,1
10747,163449,vrjYYhgraDUMACavD1Jq29AQHFh2bMGk,SpATywNh6bZuzm8s1ceuBUnMUAeoAHHw,10,17,0,14,0,0,2,0,33,4.714285714285714,2,0.0,11,0,13,0,6,0,1,2,0,24,9,1
10748,163466,ASnkRnrOf1WwhiZJlBu5Rdb7kpMknjcy,SpATywNh6bZuzm8s1ceuBUnMUAeoAHHw,1,0,0,0,0,0,1,0,1,0.14285714285714285,1,0.0,0,0,0,0,0,0,0,1,0,0,1,1
10749,163470,vbOiF6cnlAMZD8LbHyglMTSugmHV6DHA,RXDvfPUBYFlVdlueBFbLW0mhhAyGEqpt,17,31,13,0,7,0,24,5,80,11.428571428571429,5,0.0,2,13,0,7,29,0,0,24,5,22,58,1
10750,163475,H8YHtkra0xamWmCl1rG6GNG1DeiG8zbG,bWdj2GDclj5ofokWjzoa5jAwMkxCykd6,15,32,0,104,0,14,9,0,159,22.714285714285715,1,0.0,6,0,97,0,26,14,7,9,0,103,56,1
10751,163480,6hX10Wu1E2KDRE7mYGP1VPoNRkdF7lrL,RXDvfPUBYFlVdlueBFbLW0mhhAyGEqpt,6,6,3,0,2,0,2,0,13,1.8571428571428572,1,0.0,0,3,0,2,6,0,0,2,0,5,8,1
10752,163483,pDYlcAIvVnBJ5nJ6t9DMrTdONniDYlEW,RXDvfPUBYFlVdlueBFbLW0mhhAyGEqpt,4,4,0,0,0,3,2,0,9,1.2857142857142858,1,0.0,0,0,0,0,4,3,0,2,0,0,9,1
10753,163490,QP9mUTxIKar5wOD0pjJi5ToJRWI6Qe58,G8EPVSXsOYB5YQWZGiz1aVq5Pgr2GrQu,9,11,0,0,0,0,6,0,17,2.4285714285714284,1,0.0,2,0,0,0,9,0,0,6,0,2,15,0
10754,163507,kGtpt8jv2taW68U9XPA4K4mRWM6eie4a,SpATywNh6bZuzm8s1ceuBUnMUAeoAHHw,9,7,5,0,4,0,4,1,21,3.0,1,0.0,0,5,0,4,7,0,0,4,1,9,12,1
10755,163509,z98RxEOJ89VINRwVTX4KbTlJYz09XMrh,SpATywNh6bZuzm8s1ceuBUnMUAeoAHHw,1,0,0,0,0,0,1,0,1,0.14285714285714285,1,0.0,0,0,0,0,0,0,0,1,0,0,1,1
10756,163510,5oLMWOENowYuBiosAAPZhmNDox994GEM,SpATywNh6bZuzm8s1ceuBUnMUAeoAHHw,14,25,13,16,0,6,26,8,94,13.428571428571429,2,0.0,5,13,13,0,20,6,3,26,8,31,63,1
10757,163514,VulnA8EYzLxbOoYdrjgIqZbvSkkMTK23,RXDvfPUBYFlVdlueBFbLW0mhhAyGEqpt,9,11,1,0,1,0,1,0,14,2.0,1,0.0,0,1,0,1,11,0,0,1,0,2,12,1
10758,163516,cnF5YfjX3CQt7JMSCL8P4leqdmCPbBni,bWdj2GDclj5ofokWjzoa5jAwMkxCykd6,5,2,1,0,1,0,2,0,6,0.8571428571428571,1,0.0,0,1,0,1,2,0,0,2,0,2,4,1
10759,163518,ljvQidttDf2jbMq0Dhco00ANs1OMPP2n,SpATywNh6bZuzm8s1ceuBUnMUAeoAHHw,7,2,1,0,1,1,6,0,11,1.5714285714285714,1,0.0,0,1,0,1,2,1,0,6,0,2,9,1
10760,163533,fkHyrrcfJ6oe60xqsar56Gz0YRl5rHzC,SpATywNh6bZuzm8s1ceuBUnMUAeoAHHw,1,0,0,0,0,0,2,0,2,0.2857142857142857,1,0.0,0,0,0,0,0,0,0,2,0,0,2,1
10761,163542,CSh5hGbaSFu2yCb31iVMOVwKocrH471Q,G8EPVSXsOYB5YQWZGiz1aVq5Pgr2GrQu,5,2,1,0,1,0,3,0,7,1.0,3,0.0,0,1,0,1,2,0,0,3,0,2,5,1
10762,163549,kD7KrEgPns8NN7pPH4RunWGvMBAYF6OW,RXDvfPUBYFlVdlueBFbLW0mhhAyGEqpt,10,8,4,0,2,0,6,0,20,2.857142857142857,3,0.0,0,4,0,2,8,0,0,6,0,6,14,0
10763,163562,H7BcZUb2MJ3mV3eWcUeltHh62X1WzBrw,SpATywNh6bZuzm8s1ceuBUnMUAeoAHHw,1,0,0,0,0,0,1,0,1,0.14285714285714285,1,0.0,0,0,0,0,0,0,0,1,0,0,1,1
10764,163569,C5uVsSF0OJOzgwE9vgQEq40axD3ffZTd,RXDvfPUBYFlVdlueBFbLW0mhhAyGEqpt,7,6,2,0,1,0,8,0,17,2.4285714285714284,2,0.0,0,2,0,1,6,0,0,8,0,3,14,1
10765,163571,F3TqBHACHIYM9Yg9wui66QV7ygJkp22V,bWdj2GDclj5ofokWjzoa5jAwMkxCykd6,7,1,1,0,1,2,6,1,12,1.7142857142857142,1,0.0,0,1,0,1,1,2,0,6,1,2,10,1
10766,163577,Uy2krOPQuopj6gsLDrvSnNpCmzlDZ3lx,G8EPVSXsOYB5YQWZGiz1aVq5Pgr2GrQu,35,44,2,70,0,0,6,0,122,17.428571428571427,2,0.0,24,2,48,0,20,0,22,6,0,74,48,1
10767,163582,eYxD3pCXsuNAtHKPOm6JQVNldqcoc61X,RXDvfPUBYFlVdlueBFbLW0mhhAyGEqpt,9,6,2,0,2,4,5,1,20,2.857142857142857,2,0.0,0,2,0,2,6,4,0,5,1,4,16,1
10768,163588,pvAe37z1FjLTGYdwlJFjXex25zlpyHtu,RXDvfPUBYFlVdlueBFbLW0mhhAyGEqpt,1,0,0,0,0,0,1,0,1,0.14285714285714285,1,0.0,0,0,0,0,0,0,0,1,0,0,1,1
10769,163589,lQAYhw1UzsQa6D4iHlC81XAZ1ajKb7gC,SpATywNh6bZuzm8s1ceuBUnMUAeoAHHw,5,2,1,0,1,1,2,0,7,1.0,1,0.0,0,1,0,1,2,1,0,2,0,2,5,1
10770,163590,vagG6fUZaIryVQfvx8v2uowaOCAY1cdW,G8EPVSXsOYB5YQWZGiz1aVq5Pgr2GrQu,7,5,1,0,1,0,4,0,11,1.5714285714285714,1,0.0,0,1,0,1,5,0,0,4,0,2,9,1
10771,163600,S1y1GaZipa7CZ4Lvwv6Z3UIIwux9mVs2,SpATywNh6bZuzm8s1ceuBUnMUAeoAHHw,6,3,2,0,2,0,1,0,8,1.1428571428571428,1,0.0,0,2,0,2,3,0,0,1,0,4,4,1
10772,163601,XqqzFQNJmn3Nj5uaNCNXStUfXUCSgi1X,SpATywNh6bZuzm8s1ceuBUnMUAeoAHHw,6,3,2,0,2,0,1,0,8,1.1428571428571428,1,0.0,0,2,0,2,3,0,0,1,0,4,4,1
10773,163614,cfOhX0waxJYI0ZiTf440b9KQ8z56ZELH,SpATywNh6bZuzm8s1ceuBUnMUAeoAHHw,13,10,5,0,3,0,7,5,30,4.285714285714286,2,0.0,4,5,0,3,6,0,0,7,5,12,18,1
10774,163618,w1CA5COiIiNblmqtUGzNLlwoBIorG5nj,SpATywNh6bZuzm8s1ceuBUnMUAeoAHHw,13,14,0,7,0,1,6,1,29,4.142857142857143,2,0.0,5,0,7,0,9,1,0,6,1,12,17,1
10775,163619,Fa1mAVxGk4kVn9jd6eDkxLNhUbCZP7qX,G8EPVSXsOYB5YQWZGiz1aVq5Pgr2GrQu,16,8,6,0,5,0,6,0,25,3.5714285714285716,2,0.0,0,6,0,5,8,0,0,6,0,11,14,1
10776,163622,L1AaE8JRIRIV3lw2DVe2AIMIzykmc89e,G8EPVSXsOYB5YQWZGiz1aVq5Pgr2GrQu,26,68,22,26,15,1,11,3,146,20.857142857142858,1,0.0,29,22,23,15,39,1,3,11,3,89,57,1
10777,163625,YMDTxwTCTCMBG5LWHOVv3uaqDpUsACxE,SpATywNh6bZuzm8s1ceuBUnMUAeoAHHw,1,0,0,0,0,0,1,0,1,0.14285714285714285,1,0.0,0,0,0,0,0,0,0,1,0,0,1,1
10778,163631,F3LkPjPg6vCRHLtL3FvDerZrs5n7emOU,SpATywNh6bZuzm8s1ceuBUnMUAeoAHHw,7,6,5,0,5,0,3,0,19,2.7142857142857144,2,0.0,0,5,0,5,6,0,0,3,0,10,9,1
10779,163632,PCPmtsqEtkHe7GooXQswbqyH8cnukgFn,SpATywNh6bZuzm8s1ceuBUnMUAeoAHHw,5,2,0,0,0,0,3,0,5,0.7142857142857143,1,0.0,0,0,0,0,2,0,0,3,0,0,5,1
10780,163638,DyoNdvHG07mU6Bz7r3h8R4ubHxjNBfTA,SpATywNh6bZuzm8s1ceuBUnMUAeoAHHw,6,5,2,0,1,1,2,0,11,1.5714285714285714,1,0.0,0,2,0,1,5,1,0,2,0,3,8,1
10781,163643,C4OZeIeoVWL85YLgAEXLqPH3ncq3XA6k,SpATywNh6bZuzm8s1ceuBUnMUAeoAHHw,8,2,1,0,1,1,6,1,12,1.7142857142857142,1,0.0,0,1,0,1,2,1,0,6,1,2,10,1
10782,163650,wi94HT3Va3Hif8CpMS1WVbL5a71j9CMb,RXDvfPUBYFlVdlueBFbLW0mhhAyGEqpt,15,10,7,8,2,15,6,8,56,8.0,1,0.0,1,7,7,2,9,15,1,6,8,17,39,1
10783,163654,mlnhYrciKajvXbMdJptDLVlFyYAjST94,G8EPVSXsOYB5YQWZGiz1aVq5Pgr2GrQu,7,3,0,0,0,8,5,13,29,4.142857142857143,1,0.0,0,0,0,0,3,8,0,5,13,0,29,1
10784,163656,hsKZoLrdrvPaRbEyzj2NgfRJmBw1qqW5,SpATywNh6bZuzm8s1ceuBUnMUAeoAHHw,11,34,17,0,0,11,23,4,89,12.714285714285714,2,0.0,11,17,0,0,23,11,0,23,4,28,61,1
10785,163660,WIulMAW8PLfyLvnliYk0w4Xs9IJHKZPS,bWdj2GDclj5ofokWjzoa5jAwMkxCykd6,6,2,1,0,0,1,5,1,10,1.4285714285714286,2,0.0,0,1,0,0,2,1,0,5,1,1,9,1
10786,163675,0kNhy59h1x4o0Ij6YScRdNhibpvh4SDd,SpATywNh6bZuzm8s1ceuBUnMUAeoAHHw,1,0,0,0,0,0,1,0,1,0.14285714285714285,1,0.0,0,0,0,0,0,0,0,1,0,0,1,0
10787,163678,u40Wnz941IKPEKg6evh8MfJNEbnPlztD,bWdj2GDclj5ofokWjzoa5jAwMkxCykd6,5,2,1,0,1,6,2,0,12,1.7142857142857142,1,0.0,0,1,0,1,2,6,0,2,0,2,10,1
10788,163681,lyMxC1IigTgGwaO3VxYbmlReQwCiDGpV,RXDvfPUBYFlVdlueBFbLW0mhhAyGEqpt,11,14,0,0,0,4,5,2,25,3.5714285714285716,1,0.0,0,0,0,0,14,4,0,5,2,0,25,1
10789,163684,ewJfXKCM3UIjcsxxypCAlFJ00OIwALVK,SpATywNh6bZuzm8s1ceuBUnMUAeoAHHw,16,26,15,23,6,18,11,2,101,14.428571428571429,2,0.0,6,15,19,6,20,18,4,11,2,46,55,1
10790,163689,Ex7M4i0hxnSRXjh3Gag0IYca3K61Kn2n,SpATywNh6bZuzm8s1ceuBUnMUAeoAHHw,13,10,6,10,5,0,3,0,34,4.857142857142857,1,0.0,3,6,8,5,7,0,2,3,0,22,12,1
10791,163699,QZzKa5b6BbNwk1LIn6xlSQQLnIzRsZka,RXDvfPUBYFlVdlueBFbLW0mhhAyGEqpt,9,6,2,0,2,0,4,0,14,2.0,1,0.0,0,2,0,2,6,0,0,4,0,4,10,1
10792,163702,wf4tYLDC26NonKlhHYQJXmb4zsRVp9vv,RXDvfPUBYFlVdlueBFbLW0mhhAyGEqpt,2,1,0,0,0,0,2,0,3,0.42857142857142855,1,0.0,0,0,0,0,1,0,0,2,0,0,3,1
10793,163705,Np4pKivCInwrNv4VDIJNvSdKsE4Ykhes,SpATywNh6bZuzm8s1ceuBUnMUAeoAHHw,7,2,1,0,1,1,4,1,10,1.4285714285714286,1,0.0,0,1,0,1,2,1,0,4,1,2,8,1
10794,163709,pdSGmGjIheArtjBU79xTfiS3vhBu2KPT,SpATywNh6bZuzm8s1ceuBUnMUAeoAHHw,6,2,1,0,1,0,3,0,7,1.0,1,0.0,0,1,0,1,2,0,0,3,0,2,5,1
10795,163717,s7VOudb8mAmGtu7aUQI1pKU0VJWMkjoX,G8EPVSXsOYB5YQWZGiz1aVq5Pgr2GrQu,5,2,1,0,1,0,2,0,6,0.8571428571428571,1,0.0,0,1,0,1,2,0,0,2,0,2,4,1
10796,163721,qefyjSYUZQgFnIvwhQLXYc5FeLuyNtLR,SpATywNh6bZuzm8s1ceuBUnMUAeoAHHw,4,2,0,0,0,0,2,0,4,0.5714285714285714,1,0.0,0,0,0,0,2,0,0,2,0,0,4,1
10797,163725,2jbBgSBiRnod35BsxMp6TsDQi1nWOPvD,SpATywNh6bZuzm8s1ceuBUnMUAeoAHHw,7,3,2,0,2,0,2,0,9,1.2857142857142858,1,0.0,0,2,0,2,3,0,0,2,0,4,5,1
10798,163726,GEJT2aBPUnilxjCoBwgHhTPS1ahoPkLE,RXDvfPUBYFlVdlueBFbLW0mhhAyGEqpt,8,6,5,0,5,0,1,0,17,2.4285714285714284,3,0.0,0,5,0,5,6,0,0,1,0,10,7,1
10799,163732,CEHfXzpDz8lIH5e7jnl07zaS2wVnOurM,bWdj2GDclj5ofokWjzoa5jAwMkxCykd6,1,0,0,0,0,0,2,0,2,0.2857142857142857,1,0.0,0,0,0,0,0,0,0,2,0,0,2,1
10800,163733,XlmyWP3uzEka8XsoWFimEg5Beb9mAoVO,SpATywNh6bZuzm8s1ceuBUnMUAeoAHHw,13,9,2,21,2,1,3,0,38,5.428571428571429,1,0.0,4,2,19,2,5,1,2,3,0,27,11,0
10801,163737,ltg49XAFIsj12MvcvVinx0U6nQzosGwX,SpATywNh6bZuzm8s1ceuBUnMUAeoAHHw,1,0,0,0,0,0,1,0,1,0.14285714285714285,1,0.0,0,0,0,0,0,0,0,1,0,0,1,1
10802,163742,p0fw4v0FzqDHoIprXWv2PhAw9MEKisrS,SpATywNh6bZuzm8s1ceuBUnMUAeoAHHw,11,35,29,0,16,9,8,0,97,13.857142857142858,2,0.0,2,29,0,16,33,9,0,8,0,47,50,1
10803,163746,T40Q6IsSToScgVshLJURvbaPdMvC0SSz,SpATywNh6bZuzm8s1ceuBUnMUAeoAHHw,3,2,0,0,0,0,2,0,4,0.5714285714285714,1,0.0,0,0,0,0,2,0,0,2,0,0,4,1
10804,163749,fyTJxX25s6bGEKgBLCJRWjXtah1KWf2a,SpATywNh6bZuzm8s1ceuBUnMUAeoAHHw,7,3,2,0,0,1,5,1,12,1.7142857142857142,1,0.0,0,2,0,0,3,1,0,5,1,2,10,1
10805,163751,WIulMAW8PLfyLvnliYk0w4Xs9IJHKZPS,RXDvfPUBYFlVdlueBFbLW0mhhAyGEqpt,2,0,0,0,0,0,3,0,3,0.42857142857142855,2,0.0,0,0,0,0,0,0,0,3,0,0,3,1
10806,163755,ePj7Vg45LclsHx65E6l7TrkRBcgJnatl,SpATywNh6bZuzm8s1ceuBUnMUAeoAHHw,16,22,9,23,3,1,5,1,64,9.142857142857142,1,0.0,10,9,19,3,12,1,4,5,1,41,23,1
10807,163762,8frCsvLNU0A4TOJYDtM515jTF7T871uZ,SpATywNh6bZuzm8s1ceuBUnMUAeoAHHw,1,0,0,0,0,0,1,0,1,0.14285714285714285,1,0.0,0,0,0,0,0,0,0,1,0,0,1,1
10808,163764,J1eFEaKfAoVdTBUtGJyjHKFZqTtKoDt7,SpATywNh6bZuzm8s1ceuBUnMUAeoAHHw,2,0,0,0,0,0,2,0,2,0.2857142857142857,2,0.0,0,0,0,0,0,0,0,2,0,0,2,1
10809,163772,4IvlesNs2H0RowHre7RAgbEkJVMxR7AN,SpATywNh6bZuzm8s1ceuBUnMUAeoAHHw,10,8,5,0,4,5,5,0,27,3.857142857142857,1,0.0,0,5,0,4,8,5,0,5,0,9,18,1
10810,163774,MByqWSIhrOuR5hLDV5SDwmnefy1Zfii8,SpATywNh6bZuzm8s1ceuBUnMUAeoAHHw,14,15,2,19,0,2,12,1,51,7.285714285714286,3,0.0,2,2,15,0,13,2,4,12,1,19,32,1
10811,163782,mxBhue6G5uamvaszDl3iuMbiHnjieccs,SpATywNh6bZuzm8s1ceuBUnMUAeoAHHw,6,4,1,0,1,0,2,0,8,1.1428571428571428,2,0.0,1,1,0,1,3,0,0,2,0,3,5,1
10812,163783,uPwSB0CSQ1ut2moqiJ7QCNXIo4WCZY1E,bWdj2GDclj5ofokWjzoa5jAwMkxCykd6,1,0,0,0,0,0,1,0,1,0.14285714285714285,1,0.0,0,0,0,0,0,0,0,1,0,0,1,1
10813,163785,9d3JQQBsPcAu5WcxhfhApcP84UgGH4MP,SpATywNh6bZuzm8s1ceuBUnMUAeoAHHw,6,3,2,0,2,0,1,0,8,1.1428571428571428,1,0.0,0,2,0,2,3,0,0,1,0,4,4,1
10814,163787,8VYVEiIEY85awvLQk1iQtn3EDF8rq6g1,RXDvfPUBYFlVdlueBFbLW0mhhAyGEqpt,1,0,0,0,0,0,1,0,1,0.14285714285714285,1,0.0,0,0,0,0,0,0,0,1,0,0,1,1
10815,163791,D42av4RgpD46CqlOrc3UqYUQGU69fX7w,G8EPVSXsOYB5YQWZGiz1aVq5Pgr2GrQu,10,14,5,8,3,0,2,0,32,4.571428571428571,2,0.0,3,5,5,3,11,0,3,2,0,16,16,1
10816,163803,OTTt0WwDCNei2O0TEm6JKkoSswKCnrig,bWdj2GDclj5ofokWjzoa5jAwMkxCykd6,7,4,2,0,1,2,3,1,13,1.8571428571428572,1,0.0,0,2,0,1,4,2,0,3,1,3,10,1
10817,163805,RGr3DE14hb7Ufb3qkxo2JnrYRs9POJfu,bWdj2GDclj5ofokWjzoa5jAwMkxCykd6,2,0,0,0,0,0,2,0,2,0.2857142857142857,1,0.0,0,0,0,0,0,0,0,2,0,0,2,1
10818,163806,VROspqrlv0dK4X4QLAJe4l0nslgLETjg,SpATywNh6bZuzm8s1ceuBUnMUAeoAHHw,11,21,13,0,0,0,7,1,42,6.0,1,0.0,5,13,0,0,16,0,0,7,1,18,24,1
10819,163808,Zt87siQCmnS8kLlyv5Y5utZhnc1bMPCO,SpATywNh6bZuzm8s1ceuBUnMUAeoAHHw,4,2,0,0,0,0,2,0,4,0.5714285714285714,1,0.0,0,0,0,0,2,0,0,2,0,0,4,1
10820,163814,RmNdouduvikY6rwKOzMijwxrRPvXpOqe,SpATywNh6bZuzm8s1ceuBUnMUAeoAHHw,1,0,0,0,0,0,1,0,1,0.14285714285714285,1,0.0,0,0,0,0,0,0,0,1,0,0,1,1
10821,163822,RGr3DE14hb7Ufb3qkxo2JnrYRs9POJfu,RXDvfPUBYFlVdlueBFbLW0mhhAyGEqpt,2,0,0,0,0,0,2,0,2,0.2857142857142857,1,0.0,0,0,0,0,0,0,0,2,0,0,2,1
10822,163824,8VGorZlY7mV29XrBVXKId31ils1jK6e4,SpATywNh6bZuzm8s1ceuBUnMUAeoAHHw,11,10,1,16,0,0,3,0,30,4.285714285714286,1,0.0,5,1,14,0,5,0,2,3,0,20,10,1
10823,163831,TRkoMMGdlwDWhj0QSrRowmh4NkQmbVQQ,RXDvfPUBYFlVdlueBFbLW0mhhAyGEqpt,7,5,0,0,0,0,2,0,7,1.0,1,0.0,0,0,0,0,5,0,0,2,0,0,7,1
10824,163832,PiD5rrce1Y4GmQw7bDUPO9xN5t3xVeMb,bWdj2GDclj5ofokWjzoa5jAwMkxCykd6,1,0,0,0,0,0,1,0,1,0.14285714285714285,1,0.0,0,0,0,0,0,0,0,1,0,0,1,1
10825,163833,KVtMqoPC0QDsoF45TzGd0BaG4fzRLrFd,SpATywNh6bZuzm8s1ceuBUnMUAeoAHHw,14,18,4,0,1,5,5,0,33,4.714285714285714,2,0.0,0,4,0,1,18,5,0,5,0,5,28,1
10826,163836,SQBW44VzMb5zXQWTfzFzAP2RU7qxP2su,SpATywNh6bZuzm8s1ceuBUnMUAeoAHHw,7,13,5,0,2,0,3,0,23,3.2857142857142856,3,0.0,4,5,0,2,9,0,0,3,0,11,12,1
10827,163841,VOYGsHw00bDlJPevH6j2b9TjHm4MTXPJ,bWdj2GDclj5ofokWjzoa5jAwMkxCykd6,7,5,4,0,4,0,4,0,17,2.4285714285714284,1,0.0,0,4,0,4,5,0,0,4,0,8,9,0
10828,163865,5OhxkZY6VrmzMIEqEJk4w0eM2XdsVdBQ,bWdj2GDclj5ofokWjzoa5jAwMkxCykd6,1,0,0,0,0,0,1,0,1,0.14285714285714285,1,0.0,0,0,0,0,0,0,0,1,0,0,1,1
10829,163879,nu1pV8lIFpyulfHtXPUt3mWowV7EAjTM,SpATywNh6bZuzm8s1ceuBUnMUAeoAHHw,1,0,0,0,0,0,2,0,2,0.2857142857142857,1,0.0,0,0,0,0,0,0,0,2,0,0,2,1
10830,163886,Bos3zEEnAcYzPXQktMkJJ0ak5mhGWCAf,bWdj2GDclj5ofokWjzoa5jAwMkxCykd6,14,31,10,32,3,2,7,1,86,12.285714285714286,3,0.0,9,10,31,3,22,2,1,7,1,53,33,0
10831,163895,IdPX4c7Aq1sETI8RH1NYOE4mt2Ch4lHK,G8EPVSXsOYB5YQWZGiz1aVq5Pgr2GrQu,12,6,5,16,2,0,3,0,32,4.571428571428571,1,0.0,0,5,14,2,6,0,2,3,0,21,11,1
10832,163900,3RcsrMTbPrb8ZHYXLlgwoRK7zrqTGSuq,SpATywNh6bZuzm8s1ceuBUnMUAeoAHHw,1,0,0,0,0,0,1,0,1,0.14285714285714285,1,0.0,0,0,0,0,0,0,0,1,0,0,1,1
10833,163902,35YnYP4Tkn7xvOTt0M51AeVR3m7l2sIt,G8EPVSXsOYB5YQWZGiz1aVq5Pgr2GrQu,7,5,1,0,1,0,2,0,9,1.2857142857142858,2,0.0,0,1,0,1,5,0,0,2,0,2,7,1
10834,163908,NrHk4qmJXuD0TsjkQSnghKpk9ZjGAOyU,RXDvfPUBYFlVdlueBFbLW0mhhAyGEqpt,5,3,2,0,2,0,2,0,9,1.2857142857142858,1,0.0,0,2,0,2,3,0,0,2,0,4,5,1
10835,163909,omRh5Z9AcNowwMlq7wsAXczLrDoDOAwv,bWdj2GDclj5ofokWjzoa5jAwMkxCykd6,8,14,7,2,2,0,2,0,27,3.857142857142857,2,0.0,2,7,2,2,12,0,0,2,0,13,14,1
10836,163911,O1GQCvqX78WHj4bvuBKl7CpHmRzidVy9,SpATywNh6bZuzm8s1ceuBUnMUAeoAHHw,4,6,3,0,0,0,1,0,10,1.4285714285714286,1,0.0,2,3,0,0,4,0,0,1,0,5,5,1
10837,163914,ncIBIt1kRS23NRG3HklaOrwS2ep1UY7z,G8EPVSXsOYB5YQWZGiz1aVq5Pgr2GrQu,14,15,6,12,3,0,1,0,37,5.285714285714286,1,0.0,6,6,7,3,9,0,5,1,0,22,15,1
10838,163916,lntlNyrTcmBgMyWfooLFXfRIXX7mctQs,bWdj2GDclj5ofokWjzoa5jAwMkxCykd6,3,1,0,0,0,0,2,0,3,0.42857142857142855,1,0.0,0,0,0,0,1,0,0,2,0,0,3,1
10839,163922,ncIBIt1kRS23NRG3HklaOrwS2ep1UY7z,bWdj2GDclj5ofokWjzoa5jAwMkxCykd6,5,4,1,0,0,0,3,0,8,1.1428571428571428,1,0.0,0,1,0,0,4,0,0,3,0,1,7,1
10840,163925,TbdeJU00oP9V3i4nJearCAXrCR8nfsK3,SpATywNh6bZuzm8s1ceuBUnMUAeoAHHw,7,9,4,0,2,1,2,0,18,2.5714285714285716,2,0.0,0,4,0,2,9,1,0,2,0,6,12,1
10841,163928,VjsjgdvHeFwreLXV4d0cm1ICJk30LzPH,bWdj2GDclj5ofokWjzoa5jAwMkxCykd6,1,0,0,0,0,0,2,0,2,0.2857142857142857,1,0.0,0,0,0,0,0,0,0,2,0,0,2,1
10842,163934,5NIrDL6VpBxdJ6CyWDkvlKDqSlFChzvA,SpATywNh6bZuzm8s1ceuBUnMUAeoAHHw,22,20,15,8,7,0,6,0,56,8.0,4,0.0,0,15,8,7,20,0,0,6,0,30,26,0
10843,163936,58CuB3m4LabodooAfWkSdyPNtGlVJfdv,SpATywNh6bZuzm8s1ceuBUnMUAeoAHHw,2,0,0,0,0,0,2,0,2,0.2857142857142857,1,0.0,0,0,0,0,0,0,0,2,0,0,2,1
10844,163940,Kt9qeiacR1tBDeKKHUR6O60ehH5pm7C9,RXDvfPUBYFlVdlueBFbLW0mhhAyGEqpt,1,0,0,0,0,0,1,0,1,0.14285714285714285,1,0.0,0,0,0,0,0,0,0,1,0,0,1,1
10845,163944,k8NseCRyuonMJqIA9r5ZttySeYFCZkvS,bWdj2GDclj5ofokWjzoa5jAwMkxCykd6,2,0,0,0,0,0,2,0,2,0.2857142857142857,1,0.0,0,0,0,0,0,0,0,2,0,0,2,1
10846,163961,NNIDIi1G7HKDU1709vBEwzpydUygCNLC,SpATywNh6bZuzm8s1ceuBUnMUAeoAHHw,15,25,9,21,4,0,7,0,66,9.428571428571429,3,0.0,12,9,18,4,13,0,3,7,0,43,23,1
10847,163972,83J9IXuPcwdDBJoFENdSQFWzvgELVzeu,SpATywNh6bZuzm8s1ceuBUnMUAeoAHHw,1,0,0,0,0,0,1,0,1,0.14285714285714285,1,0.0,0,0,0,0,0,0,0,1,0,0,1,1
10848,163975,dbtlJh8uWixqUAz5pHAMwXOZNVVUTuzi,bWdj2GDclj5ofokWjzoa5jAwMkxCykd6,7,9,4,0,3,0,5,0,21,3.0,1,0.0,2,4,0,3,7,0,0,5,0,9,12,1
10849,163982,cikSh880jtc26b154AaVhDiV1L6H6F3g,SpATywNh6bZuzm8s1ceuBUnMUAeoAHHw,30,36,23,34,13,1,17,0,124,17.714285714285715,5,0.0,6,23,31,13,30,1,3,17,0,73,51,0
10850,163983,Is7lqncTs1EDN9QmzrTbcU6KnB0BCGNX,bWdj2GDclj5ofokWjzoa5jAwMkxCykd6,5,2,1,0,1,0,2,0,6,0.8571428571428571,1,0.0,0,1,0,1,2,0,0,2,0,2,4,1
10851,163986,YgxPec9PZk03SxcMpde0DWwnbgHU13wT,RXDvfPUBYFlVdlueBFbLW0mhhAyGEqpt,1,0,0,0,0,0,1,0,1,0.14285714285714285,1,0.0,0,0,0,0,0,0,0,1,0,0,1,1
10852,163993,EQtZU9INEuWvmS0EVA02NQr3rav8vOCw,SpATywNh6bZuzm8s1ceuBUnMUAeoAHHw,1,0,0,0,0,0,1,0,1,0.14285714285714285,1,0.0,0,0,0,0,0,0,0,1,0,0,1,1
10853,163995,EQtZU9INEuWvmS0EVA02NQr3rav8vOCw,bWdj2GDclj5ofokWjzoa5jAwMkxCykd6,1,0,0,0,0,0,1,0,1,0.14285714285714285,1,0.0,0,0,0,0,0,0,0,1,0,0,1,1
10854,163996,HE0yFYNeyW3jGh5EhXv7uoc6O18ATk5R,bWdj2GDclj5ofokWjzoa5jAwMkxCykd6,9,8,4,0,2,0,4,0,18,2.5714285714285716,3,0.0,0,4,0,2,8,0,0,4,0,6,12,1
10855,163997,KZBxo2oXfcrXYFa3c9hEkQ12gjuvG6yO,SpATywNh6bZuzm8s1ceuBUnMUAeoAHHw,5,3,1,0,1,0,1,0,6,0.8571428571428571,1,0.0,0,1,0,1,3,0,0,1,0,2,4,1
10856,164001,XFqiUKRJW4dHHhbAyhg0HRvuoT5jA7Ib,SpATywNh6bZuzm8s1ceuBUnMUAeoAHHw,8,9,7,0,5,0,3,0,24,3.4285714285714284,2,0.0,0,7,0,5,9,0,0,3,0,12,12,1
10857,164004,RcOO7zh8NeavIcr1ab7xjfpMRrA97BXt,G8EPVSXsOYB5YQWZGiz1aVq5Pgr2GrQu,6,2,1,0,1,0,3,0,7,1.0,1,0.0,0,1,0,1,2,0,0,3,0,2,5,1
10858,164005,DhiB4cJ1TCjmSH3ZWP9m0OqNyBdGeS5P,SpATywNh6bZuzm8s1ceuBUnMUAeoAHHw,10,14,1,16,1,0,1,0,33,4.714285714285714,3,0.0,4,1,14,1,10,0,2,1,0,20,13,1
10859,164006,BMjIPGqtYoLatxXDEHrhiIMt72Ckp0Wf,RXDvfPUBYFlVdlueBFbLW0mhhAyGEqpt,19,16,1,26,0,0,5,1,49,7.0,1,0.0,5,1,25,0,11,0,1,5,1,31,18,1
10860,164008,0sPJG21Jmy137j2MeTN2RYjy8hYUDlLs,G8EPVSXsOYB5YQWZGiz1aVq5Pgr2GrQu,10,11,2,16,1,0,3,0,33,4.714285714285714,1,0.0,4,2,13,1,7,0,3,3,0,20,13,1
10861,164009,g3902agYIRHzac78MKVZlvljLMXXNpQ7,bWdj2GDclj5ofokWjzoa5jAwMkxCykd6,6,3,2,0,2,0,5,0,12,1.7142857142857142,1,0.0,0,2,0,2,3,0,0,5,0,4,8,1
10862,164013,1l8gTBWE0zew7p1xhFmmlqlIh8QPXivD,RXDvfPUBYFlVdlueBFbLW0mhhAyGEqpt,1,0,0,0,0,0,1,0,1,0.14285714285714285,1,0.0,0,0,0,0,0,0,0,1,0,0,1,1
10863,164024,s5CJLvNaNPk4PiGqc6NTFvObROYB0OQQ,SpATywNh6bZuzm8s1ceuBUnMUAeoAHHw,22,46,0,27,0,20,13,0,106,15.142857142857142,5,0.0,12,0,25,0,34,20,2,13,0,37,69,0
10864,164030,1KSlK2xXHUc3PjC1CsQEQaomGBagqDXf,bWdj2GDclj5ofokWjzoa5jAwMkxCykd6,5,2,1,0,1,0,2,0,6,0.8571428571428571,1,0.0,0,1,0,1,2,0,0,2,0,2,4,1
10865,164032,zQ5BnttGrAYjfbNnxAVeHGUEjC3wWZZU,SpATywNh6bZuzm8s1ceuBUnMUAeoAHHw,26,47,27,21,16,8,24,0,143,20.428571428571427,6,0.0,4,27,18,16,43,8,3,24,0,65,78,0
10866,164035,HnIhmL6C5c5V3yK8mmGh4fDvVHyYVu6T,SpATywNh6bZuzm8s1ceuBUnMUAeoAHHw,17,27,4,18,4,0,13,1,67,9.571428571428571,2,0.0,9,4,15,4,18,0,3,13,1,32,35,1
10867,164038,muYojhkvYaqc1I2tE62ZyLEtlEpDYqtR,SpATywNh6bZuzm8s1ceuBUnMUAeoAHHw,10,8,2,0,2,1,6,1,20,2.857142857142857,1,0.0,0,2,0,2,8,1,0,6,1,4,16,1
10868,164048,ZhPOxBDoDGtWvBUdn6MZkcPVAapzwktO,SpATywNh6bZuzm8s1ceuBUnMUAeoAHHw,15,32,1,22,0,2,11,1,69,9.857142857142858,3,0.0,13,1,19,0,19,2,3,11,1,33,36,1
10869,164050,frevGWOFyf2Wo6uQjpFNvZnyWeFbKP0E,bWdj2GDclj5ofokWjzoa5jAwMkxCykd6,3,3,0,0,0,0,1,0,4,0.5714285714285714,1,0.0,1,0,0,0,2,0,0,1,0,1,3,1
10870,164051,frevGWOFyf2Wo6uQjpFNvZnyWeFbKP0E,RXDvfPUBYFlVdlueBFbLW0mhhAyGEqpt,9,13,1,0,0,0,1,0,15,2.142857142857143,1,0.0,4,1,0,0,9,0,0,1,0,5,10,1
10871,164053,C0k0i5iW9Kp3SljhwW4D102xschKnWU2,RXDvfPUBYFlVdlueBFbLW0mhhAyGEqpt,1,0,0,0,0,0,1,0,1,0.14285714285714285,1,0.0,0,0,0,0,0,0,0,1,0,0,1,1
10872,164059,KNSr5UQyphUzZdobhnLn0kvEqH22GN8U,G8EPVSXsOYB5YQWZGiz1aVq5Pgr2GrQu,2,0,0,0,0,0,2,0,2,0.2857142857142857,1,0.0,0,0,0,0,0,0,0,2,0,0,2,1
10873,164064,uuxrUSHn3GpYFneZnY8GpLgr5XiyDABs,bWdj2GDclj5ofokWjzoa5jAwMkxCykd6,9,19,7,0,6,13,10,3,58,8.285714285714286,1,0.0,8,7,0,6,11,13,0,10,3,21,37,1
10874,164068,83H2FVc0DUlyPpMlZsbpGsFQRMFc6fan,bWdj2GDclj5ofokWjzoa5jAwMkxCykd6,3,4,0,0,0,0,2,0,6,0.8571428571428571,1,0.0,0,0,0,0,4,0,0,2,0,0,6,1
10875,164072,KRDbzApPGunbpzFiIxAlDnKcVqmXz93Z,SpATywNh6bZuzm8s1ceuBUnMUAeoAHHw,9,9,0,0,0,1,5,1,16,2.2857142857142856,1,0.0,0,0,0,0,9,1,0,5,1,0,16,1
10876,164075,Qfoj47ZFH9kFoOklCPtfSf7qImKKODGj,bWdj2GDclj5ofokWjzoa5jAwMkxCykd6,1,0,0,0,0,0,1,0,1,0.14285714285714285,1,0.0,0,0,0,0,0,0,0,1,0,0,1,1
10877,164078,WsP1VDhZbOPlkd3sbnAsknbzVniUGVR6,SpATywNh6bZuzm8s1ceuBUnMUAeoAHHw,11,18,6,12,3,0,2,0,41,5.857142857142857,1,0.0,6,6,11,3,12,0,1,2,0,26,15,1
10878,164089,O3lqSpngMxAwSEkWjBn3tk145jZG19Vi,SpATywNh6bZuzm8s1ceuBUnMUAeoAHHw,8,8,5,0,4,1,5,1,24,3.4285714285714284,1,0.0,0,5,0,4,8,1,0,5,1,9,15,1
10879,164094,ndz80WiJUz0adE8axEB4JuY9X6KNPO7X,SpATywNh6bZuzm8s1ceuBUnMUAeoAHHw,1,0,0,0,0,0,1,0,1,0.14285714285714285,1,0.0,0,0,0,0,0,0,0,1,0,0,1,1
10880,164095,yPIqHEe4AecQ4GX5I2LJPYqjiV9xQfx2,SpATywNh6bZuzm8s1ceuBUnMUAeoAHHw,7,3,2,0,2,0,2,0,9,1.2857142857142858,1,0.0,0,2,0,2,3,0,0,2,0,4,5,1
10881,164097,yKlpCOv4oX3vHTFVM0BhF8OwgGT3xUhB,G8EPVSXsOYB5YQWZGiz1aVq5Pgr2GrQu,11,22,0,2,0,0,1,0,25,3.5714285714285716,1,0.0,6,0,2,0,16,0,0,1,0,8,17,0
10882,164105,UjuYob8V8C70Onzp78W1rkt8ybxbAbwx,RXDvfPUBYFlVdlueBFbLW0mhhAyGEqpt,9,4,3,0,1,2,5,1,16,2.2857142857142856,1,0.0,1,3,0,1,3,2,0,5,1,5,11,0
10883,164114,7ynsHGhJ1N4494Hez57ckblgtBNGbed9,bWdj2GDclj5ofokWjzoa5jAwMkxCykd6,7,2,1,0,0,24,12,2,41,5.857142857142857,1,0.0,0,1,0,0,2,24,0,12,2,1,40,1
10884,164128,3iB62eqNt3nRiXslxHuT1UtvhrRX1eLs,SpATywNh6bZuzm8s1ceuBUnMUAeoAHHw,14,19,14,0,8,10,11,3,65,9.285714285714286,2,0.0,0,14,0,8,19,10,0,11,3,22,43,0
10885,164135,blaKT90TeOTAa2RsAkTxWQqeLxEi93Qu,G8EPVSXsOYB5YQWZGiz1aVq5Pgr2GrQu,16,28,1,0,1,0,3,0,33,4.714285714285714,1,0.0,6,1,0,1,22,0,0,3,0,8,25,0
10886,164143,Rfx55so0bnrgOG7iRmEYhpikxS2TaZXD,SpATywNh6bZuzm8s1ceuBUnMUAeoAHHw,6,6,4,0,2,0,4,0,16,2.2857142857142856,1,0.0,0,4,0,2,6,0,0,4,0,6,10,1
10887,164152,DFbejjY7iFDbzUdxXNh2pDwgdrX3wa4i,SpATywNh6bZuzm8s1ceuBUnMUAeoAHHw,14,28,8,24,3,10,5,1,79,11.285714285714286,2,0.0,12,8,18,3,16,10,6,5,1,41,38,1
10888,164156,RJbtfdnDfiKYbXA54RnQnnmr6xKZwlkg,bWdj2GDclj5ofokWjzoa5jAwMkxCykd6,8,9,1,20,1,3,6,0,40,5.714285714285714,1,0.0,4,1,18,1,5,3,2,6,0,24,16,1
10889,164158,uZwtgzrFploohPWTfTTW4oFbLgraM3NM,RXDvfPUBYFlVdlueBFbLW0mhhAyGEqpt,5,6,4,0,1,0,1,0,12,1.7142857142857142,2,0.0,0,4,0,1,6,0,0,1,0,5,7,1
10890,164162,8rrasDTB21WkgxqQeAJWm6ZLoQBQi4Tp,SpATywNh6bZuzm8s1ceuBUnMUAeoAHHw,9,3,2,0,1,1,7,1,15,2.142857142857143,1,0.0,0,2,0,1,3,1,0,7,1,3,12,1
10891,164163,GY3gjlGW984FFVVjyCHJw8AVsx1rzHGL,SpATywNh6bZuzm8s1ceuBUnMUAeoAHHw,1,0,0,0,0,0,2,0,2,0.2857142857142857,1,0.0,0,0,0,0,0,0,0,2,0,0,2,1
10892,164167,g8GaCwXJUf6SPnVxk3h41vOpn1g2rMNj,SpATywNh6bZuzm8s1ceuBUnMUAeoAHHw,17,26,11,17,5,0,7,0,66,9.428571428571429,2,0.0,8,11,15,5,18,0,2,7,0,39,27,1
10893,164173,o3O6sFZEm4uYUPzBaiRjRHoiv6fwyQLX,bWdj2GDclj5ofokWjzoa5jAwMkxCykd6,11,7,5,0,3,0,6,0,21,3.0,2,0.0,1,5,0,3,6,0,0,6,0,9,12,1
10894,164180,Lwf7mfGJ3FePZ7LRuU8J3HhoGD7wCy3e,bWdj2GDclj5ofokWjzoa5jAwMkxCykd6,6,0,0,0,0,3,11,1,15,2.142857142857143,1,0.0,0,0,0,0,0,3,0,11,1,0,15,1
10895,164181,9Gcg3d2ByGJfHaOgn8q1nODMxGfTga0V,SpATywNh6bZuzm8s1ceuBUnMUAeoAHHw,4,2,1,0,1,0,1,0,5,0.7142857142857143,1,0.0,0,1,0,1,2,0,0,1,0,2,3,1
10896,164182,ztJdAnCpBgEgLx5fhRggF88Y3Pxlvyek,SpATywNh6bZuzm8s1ceuBUnMUAeoAHHw,5,5,1,0,1,0,1,0,8,1.1428571428571428,1,0.0,0,1,0,1,5,0,0,1,0,2,6,1
10897,164189,vFfdM0ONqhREkb5cy2nDN88l9Gb7gZxp,SpATywNh6bZuzm8s1ceuBUnMUAeoAHHw,12,14,7,9,4,2,17,0,53,7.571428571428571,1,0.0,3,7,7,4,11,2,2,17,0,21,32,1
10898,164190,9ygKD7mdzmGQqRwlKeL15CcGPS61a1pB,SpATywNh6bZuzm8s1ceuBUnMUAeoAHHw,1,0,0,0,0,0,1,0,1,0.14285714285714285,1,0.0,0,0,0,0,0,0,0,1,0,0,1,1
10899,164196,CXOtKVmMQojq2XNTO0iupqinfdnG9ZHO,SpATywNh6bZuzm8s1ceuBUnMUAeoAHHw,12,23,5,13,0,19,4,0,64,9.142857142857142,1,0.0,13,5,11,0,10,19,2,4,0,29,35,1
10900,164198,w0MOevkqL7TIdK3soXlSk0InhRt5D2OI,SpATywNh6bZuzm8s1ceuBUnMUAeoAHHw,7,15,0,0,0,10,5,0,30,4.285714285714286,3,0.0,1,0,0,0,14,10,0,5,0,1,29,1
10901,164199,Fk4hjEUqgyLHxBlk1cbfR9hWyVsJsJLo,bWdj2GDclj5ofokWjzoa5jAwMkxCykd6,9,10,5,0,2,0,2,0,19,2.7142857142857144,2,0.0,0,5,0,2,10,0,0,2,0,7,12,1
10902,164202,BlqNhk6hbhpwG32KfW3xxRFbNDrCRljo,bWdj2GDclj5ofokWjzoa5jAwMkxCykd6,9,18,11,0,0,16,19,3,67,9.571428571428571,2,0.0,0,11,0,0,18,16,0,19,3,11,56,1
10903,164204,Yp9LyEPv40Da5bhTi9YoLgYAzGahNHA7,RXDvfPUBYFlVdlueBFbLW0mhhAyGEqpt,13,19,14,0,6,2,5,0,46,6.571428571428571,2,0.0,1,14,0,6,18,2,0,5,0,21,25,1
10904,164211,o4jfOgo2dfLmNdqfH47BtVPD4gDTd4tS,RXDvfPUBYFlVdlueBFbLW0mhhAyGEqpt,3,0,0,0,0,4,5,0,9,1.2857142857142858,2,0.0,0,0,0,0,0,4,0,5,0,0,9,1
10905,164212,BqQvzvKumSuXZDEF5Fpfkr95tleas1E0,bWdj2GDclj5ofokWjzoa5jAwMkxCykd6,1,0,0,0,0,0,1,0,1,0.14285714285714285,1,0.0,0,0,0,0,0,0,0,1,0,0,1,1
10906,164213,wFvodFqghxL7iISMFbYXkYNq6P6eK5gH,RXDvfPUBYFlVdlueBFbLW0mhhAyGEqpt,6,5,0,0,0,0,6,0,11,1.5714285714285714,1,0.0,0,0,0,0,5,0,0,6,0,0,11,1
10907,164214,HDmenaP9dq5AQ9fnpOe9TUOGtyNR5hfW,bWdj2GDclj5ofokWjzoa5jAwMkxCykd6,5,2,1,0,1,0,4,0,8,1.1428571428571428,1,0.0,0,1,0,1,2,0,0,4,0,2,6,1
10908,164218,a8UKs1NxAK1Rc6mTIgzTKX0mHyAKUP88,G8EPVSXsOYB5YQWZGiz1aVq5Pgr2GrQu,12,14,5,8,4,0,1,0,32,4.571428571428571,1,0.0,8,5,5,4,6,0,3,1,0,22,10,1
10909,164219,cderIDaWBR3ykedbqXoG7yh75mThXkpL,SpATywNh6bZuzm8s1ceuBUnMUAeoAHHw,7,2,1,0,1,0,5,1,10,1.4285714285714286,1,0.0,0,1,0,1,2,0,0,5,1,2,8,1
10910,164223,dXCvdD4j2gSkM89QjHdpheWOht9HZ4w4,SpATywNh6bZuzm8s1ceuBUnMUAeoAHHw,13,12,4,20,3,0,2,0,41,5.857142857142857,1,0.0,7,4,16,3,5,0,4,2,0,30,11,1
10911,164226,ylaFiKTL5M7uyaxbJV4j95mbCqvhbcFS,G8EPVSXsOYB5YQWZGiz1aVq5Pgr2GrQu,26,98,3,26,8,26,8,1,170,24.285714285714285,2,0.0,27,3,23,8,71,26,3,8,1,61,109,1
10912,164229,m7lUxDgRiiqzb1cDzFb6FRFrHWjmnS0E,bWdj2GDclj5ofokWjzoa5jAwMkxCykd6,15,21,10,28,6,2,11,1,79,11.285714285714286,2,0.0,5,10,25,6,16,2,3,11,1,46,33,1
10913,164237,ZfIQYurnR6gJbWxLJ81cU3ZqzX4mpHm0,RXDvfPUBYFlVdlueBFbLW0mhhAyGEqpt,6,4,2,0,1,0,3,0,10,1.4285714285714286,1,0.0,0,2,0,1,4,0,0,3,0,3,7,1
10914,164238,mQPNS4mAXxHsb5X4ulTZ0rUofu82I30M,SpATywNh6bZuzm8s1ceuBUnMUAeoAHHw,4,0,0,0,0,1,4,0,5,0.7142857142857143,1,0.0,0,0,0,0,0,1,0,4,0,0,5,1
10915,164243,wFvodFqghxL7iISMFbYXkYNq6P6eK5gH,G8EPVSXsOYB5YQWZGiz1aVq5Pgr2GrQu,1,0,0,0,0,0,1,0,1,0.14285714285714285,1,0.0,0,0,0,0,0,0,0,1,0,0,1,1
10916,164253,s53Goue7PBVQuWwuk4njE0FTuXBFYzWT,bWdj2GDclj5ofokWjzoa5jAwMkxCykd6,5,2,1,0,1,0,2,0,6,0.8571428571428571,1,0.0,0,1,0,1,2,0,0,2,0,2,4,1
10917,164257,yLdwUTmew1kIx5gdbRjo7r2vOLkom0w2,RXDvfPUBYFlVdlueBFbLW0mhhAyGEqpt,1,0,0,0,0,0,1,0,1,0.14285714285714285,1,0.0,0,0,0,0,0,0,0,1,0,0,1,1
10918,164266,JHhY30IKFzw4LWcyrHuTEglWNqRkqdDU,G8EPVSXsOYB5YQWZGiz1aVq5Pgr2GrQu,16,13,7,22,3,0,7,0,52,7.428571428571429,1,0.0,6,7,19,3,7,0,3,7,0,35,17,1
10919,164273,wg7LkabhS9jTmBy5bEF3lQSLJkluKGUF,SpATywNh6bZuzm8s1ceuBUnMUAeoAHHw,5,2,1,0,1,0,2,0,6,0.8571428571428571,1,0.0,0,1,0,1,2,0,0,2,0,2,4,1
10920,164276,mdAxXzEXQEyyjCtALtGRFZS9oxIIimgr,G8EPVSXsOYB5YQWZGiz1aVq5Pgr2GrQu,1,0,0,0,0,0,5,0,5,0.7142857142857143,1,0.0,0,0,0,0,0,0,0,5,0,0,5,1
10921,164277,VCOGW9OE6DqAZaAneJJM4ZOSOc2aI6o3,SpATywNh6bZuzm8s1ceuBUnMUAeoAHHw,1,0,0,0,0,0,1,0,1,0.14285714285714285,1,0.0,0,0,0,0,0,0,0,1,0,0,1,1
10922,164283,44FzEVxwFpCY2dQQ0BkdyMwLoRQRjARq,bWdj2GDclj5ofokWjzoa5jAwMkxCykd6,5,2,1,0,1,0,2,0,6,0.8571428571428571,1,0.0,0,1,0,1,2,0,0,2,0,2,4,1
10923,164288,VD6TkymcxBFMdB1MoYEexj8K6lT6eEyR,SpATywNh6bZuzm8s1ceuBUnMUAeoAHHw,13,9,6,14,5,5,3,0,42,6.0,2,0.0,2,6,11,5,7,5,3,3,0,24,18,1
10924,164293,5iSY38QlsciL98g4h2hbNSbA8fYeSyCj,SpATywNh6bZuzm8s1ceuBUnMUAeoAHHw,5,6,2,0,1,0,2,0,11,1.5714285714285714,2,0.0,1,2,0,1,5,0,0,2,0,4,7,1
10925,164295,R6At1oAc7WZXNfKoQsgcMko62fJQGIiO,SpATywNh6bZuzm8s1ceuBUnMUAeoAHHw,2,0,0,0,0,0,2,0,2,0.2857142857142857,1,0.0,0,0,0,0,0,0,0,2,0,0,2,1
10926,164297,XpHgf5hU50AoSdtBhnyxR1OezCcdtpcw,SpATywNh6bZuzm8s1ceuBUnMUAeoAHHw,2,0,0,0,0,0,2,0,2,0.2857142857142857,1,0.0,0,0,0,0,0,0,0,2,0,0,2,1
10927,164299,4PiVkHMvtEasaFMOjyfke8CDtZnJS1Ch,G8EPVSXsOYB5YQWZGiz1aVq5Pgr2GrQu,5,1,1,0,1,0,2,0,5,0.7142857142857143,1,0.0,0,1,0,1,1,0,0,2,0,2,3,1
10928,164300,4pta5bIC2z8xvBYipNvHjqZfFKDEeM7X,SpATywNh6bZuzm8s1ceuBUnMUAeoAHHw,3,2,0,0,0,0,1,0,3,0.42857142857142855,1,0.0,0,0,0,0,2,0,0,1,0,0,3,0
10929,164304,P61EBU96iANevNQaamAZ1nmVdv1hlahG,RXDvfPUBYFlVdlueBFbLW0mhhAyGEqpt,5,2,1,0,1,0,2,0,6,0.8571428571428571,1,0.0,0,1,0,1,2,0,0,2,0,2,4,1
10930,164310,3kLiq8d9Yk709I1l6E6cFZpYQ45LBOgu,bWdj2GDclj5ofokWjzoa5jAwMkxCykd6,13,13,5,24,5,8,4,1,60,8.571428571428571,1,0.0,6,5,22,5,7,8,2,4,1,38,22,1
10931,164321,u889jcGO7u4YLeZfY23r5rctOxqBf6PA,SpATywNh6bZuzm8s1ceuBUnMUAeoAHHw,4,2,1,0,1,0,1,0,5,0.7142857142857143,1,0.0,0,1,0,1,2,0,0,1,0,2,3,1
10932,164323,KhocfHwmF39ufDx3XWH1QBLAW0hrIea9,SpATywNh6bZuzm8s1ceuBUnMUAeoAHHw,5,2,1,0,1,0,2,0,6,0.8571428571428571,1,0.0,0,1,0,1,2,0,0,2,0,2,4,1
10933,164326,Elyv0DBesmIDtda22RvPoYHZeyVOycgU,SpATywNh6bZuzm8s1ceuBUnMUAeoAHHw,13,16,5,13,3,0,5,0,42,6.0,2,0.0,6,5,13,3,10,0,0,5,0,27,15,0
10934,164333,pDmI6y2Fn3FHC3y8A6z8rbPnUAwXuAZ7,bWdj2GDclj5ofokWjzoa5jAwMkxCykd6,5,12,1,0,2,0,1,0,16,2.2857142857142856,2,0.0,2,1,0,2,10,0,0,1,0,5,11,1
10935,164338,vcmcxuoPWSwobaWPUxsfdhKEplWa2ces,SpATywNh6bZuzm8s1ceuBUnMUAeoAHHw,1,0,0,0,0,0,1,0,1,0.14285714285714285,1,0.0,0,0,0,0,0,0,0,1,0,0,1,1
10936,164341,vxGkTn6WfGBki29hwuSV6Xuc1hbgzs4I,bWdj2GDclj5ofokWjzoa5jAwMkxCykd6,1,0,0,0,0,0,1,0,1,0.14285714285714285,1,0.0,0,0,0,0,0,0,0,1,0,0,1,1
10937,164346,yB2j2tPO2DVKCBBdsLv8a1lbHtfWINMh,SpATywNh6bZuzm8s1ceuBUnMUAeoAHHw,7,14,7,0,5,0,3,0,29,4.142857142857143,3,0.0,1,7,0,5,13,0,0,3,0,13,16,1
10938,164356,MVnPWBm2d0gRS2GY8sfJnIUDF0K4iyE8,SpATywNh6bZuzm8s1ceuBUnMUAeoAHHw,1,0,0,0,0,0,1,0,1,0.14285714285714285,1,0.0,0,0,0,0,0,0,0,1,0,0,1,1
10939,164357,JsqrqubnjjSuqmmuivzKTDyASkdX1tsp,bWdj2GDclj5ofokWjzoa5jAwMkxCykd6,4,2,1,0,1,0,1,0,5,0.7142857142857143,1,0.0,0,1,0,1,2,0,0,1,0,2,3,1
10940,164378,Gt7xzQhw88EwESh7Xb4lU1zFZmxNJNIK,SpATywNh6bZuzm8s1ceuBUnMUAeoAHHw,9,7,4,0,1,2,7,1,22,3.142857142857143,2,0.0,0,4,0,1,7,2,0,7,1,5,17,1
10941,164387,ocTIjxG8zBs0mQRpUtpuAKc7MDpzU7Sd,SpATywNh6bZuzm8s1ceuBUnMUAeoAHHw,18,37,15,16,4,54,21,4,151,21.571428571428573,5,0.0,12,15,14,4,25,54,2,21,4,45,106,0
10942,164395,TAkEj78WoaHvO22LXzTn955rJBXiVudz,SpATywNh6bZuzm8s1ceuBUnMUAeoAHHw,1,0,0,0,0,0,1,0,1,0.14285714285714285,1,0.0,0,0,0,0,0,0,0,1,0,0,1,1
10943,164400,PUS8mu8K3BWjJGC8YlXjmQjHGQC9v5P9,SpATywNh6bZuzm8s1ceuBUnMUAeoAHHw,6,6,1,0,0,0,2,0,9,1.2857142857142858,1,0.0,0,1,0,0,6,0,0,2,0,1,8,1
10944,164403,ORIXOLqWtzi0s28E5aG42qOb01NSXSRE,SpATywNh6bZuzm8s1ceuBUnMUAeoAHHw,1,0,0,0,0,0,1,0,1,0.14285714285714285,1,0.0,0,0,0,0,0,0,0,1,0,0,1,1
10945,164404,mR38LOzPkDgy4Z7CZO92yHt4TSlNwfzC,bWdj2GDclj5ofokWjzoa5jAwMkxCykd6,14,31,1,50,1,12,23,6,124,17.714285714285715,3,0.0,10,1,45,1,21,12,5,23,6,57,67,1
10946,164407,KFG6G55toGAeaWBt5UmyioW5n1NVxSjT,SpATywNh6bZuzm8s1ceuBUnMUAeoAHHw,6,6,4,0,3,0,3,0,16,2.2857142857142856,1,0.0,0,4,0,3,6,0,0,3,0,7,9,1
10947,164411,y0PkAopIdLmRFrkWC9eBHvWT77KfVWMh,G8EPVSXsOYB5YQWZGiz1aVq5Pgr2GrQu,7,15,8,0,6,4,11,0,44,6.285714285714286,2,0.0,1,8,0,6,14,4,0,11,0,15,29,1
10948,164412,Z8r3kWGF2ZuWSy5TZGg00SEG4qfRh2Ag,bWdj2GDclj5ofokWjzoa5jAwMkxCykd6,5,6,3,0,1,0,5,0,15,2.142857142857143,3,0.0,0,3,0,1,6,0,0,5,0,4,11,1
10949,164415,GJ6G7nOOlt6NQXt3GWs6ppYe9Y1fZaES,bWdj2GDclj5ofokWjzoa5jAwMkxCykd6,1,0,0,0,0,0,1,0,1,0.14285714285714285,1,0.0,0,0,0,0,0,0,0,1,0,0,1,1
10950,164425,GJ6G7nOOlt6NQXt3GWs6ppYe9Y1fZaES,SpATywNh6bZuzm8s1ceuBUnMUAeoAHHw,1,0,0,0,0,0,1,0,1,0.14285714285714285,1,0.0,0,0,0,0,0,0,0,1,0,0,1,1
10951,164433,kaAc9OSRmTYmUacyuwJF8uvWHTHZhU6I,RXDvfPUBYFlVdlueBFbLW0mhhAyGEqpt,27,17,11,35,8,0,1,0,72,10.285714285714286,1,0.0,5,11,31,8,12,0,4,1,0,55,17,1
10952,164435,notZnFUBIqcbpWIYWbyK9wwcfdCEbsj2,RXDvfPUBYFlVdlueBFbLW0mhhAyGEqpt,6,2,1,0,1,0,3,0,7,1.0,1,0.0,0,1,0,1,2,0,0,3,0,2,5,1
10953,164436,Dqr6qIWfTOfWtI2PbseZL8Rm5WmdZOyL,SpATywNh6bZuzm8s1ceuBUnMUAeoAHHw,8,12,0,15,0,23,1,0,51,7.285714285714286,1,0.0,6,0,14,0,6,23,1,1,0,20,31,1
10954,164444,R7nlNg2K1A6D7NxbdpuHIgXqttVlWJcu,RXDvfPUBYFlVdlueBFbLW0mhhAyGEqpt,1,0,0,0,0,0,1,0,1,0.14285714285714285,1,0.0,0,0,0,0,0,0,0,1,0,0,1,1
10955,164447,JfftjOGdDbpgbrupi0Gwr899R0jzXikJ,bWdj2GDclj5ofokWjzoa5jAwMkxCykd6,11,16,8,0,4,5,9,2,44,6.285714285714286,4,0.0,0,8,0,4,16,5,0,9,2,12,32,1
10956,164452,LLZV0fRwNBkHHCO0iJlbUS4AGPQGvo8C,SpATywNh6bZuzm8s1ceuBUnMUAeoAHHw,10,15,0,14,1,0,2,0,32,4.571428571428571,1,0.0,8,0,13,1,7,0,1,2,0,22,10,1
10957,164456,QYjw7Y4e4Czbt9G691x4dA9fq3fXHjUR,bWdj2GDclj5ofokWjzoa5jAwMkxCykd6,6,2,1,0,1,7,6,0,17,2.4285714285714284,2,0.0,0,1,0,1,2,7,0,6,0,2,15,1
10958,164457,RNMplhTvSIPFgFZTfBAvIrYzbjwGfRpO,RXDvfPUBYFlVdlueBFbLW0mhhAyGEqpt,16,17,9,6,6,0,8,8,54,7.714285714285714,2,0.0,2,9,6,6,15,0,0,8,8,23,31,1
10959,164474,WLXtV9xU02TWrBcV5JQ79YomKzdOBWBA,bWdj2GDclj5ofokWjzoa5jAwMkxCykd6,4,5,2,0,0,0,2,0,9,1.2857142857142858,2,0.0,0,2,0,0,5,0,0,2,0,2,7,1
10960,164475,PrXGfRfcXAOp5eyOk9i7xyvPZyDLOEXf,SpATywNh6bZuzm8s1ceuBUnMUAeoAHHw,1,0,0,0,0,0,1,0,1,0.14285714285714285,1,0.0,0,0,0,0,0,0,0,1,0,0,1,1
10961,164476,1QkcpD1DfxC2p3XNS9AeGnCICPIyGC1C,SpATywNh6bZuzm8s1ceuBUnMUAeoAHHw,6,3,2,0,2,0,1,0,8,1.1428571428571428,1,0.0,0,2,0,2,3,0,0,1,0,4,4,1
10962,164478,lcxEu4F2dIRGolbGM8J7dkDro6hPXvBJ,SpATywNh6bZuzm8s1ceuBUnMUAeoAHHw,12,21,9,8,1,4,11,0,54,7.714285714285714,2,0.0,8,9,8,1,13,4,0,11,0,26,28,0
10963,164487,NA8Wgtfbm0wtXt1SByxQO0XvsqhkLzxE,SpATywNh6bZuzm8s1ceuBUnMUAeoAHHw,5,3,1,0,1,0,1,0,6,0.8571428571428571,1,0.0,0,1,0,1,3,0,0,1,0,2,4,1
10964,164489,rZSqEDajDij6VIcQBEDrdSlRO8swoKNK,SpATywNh6bZuzm8s1ceuBUnMUAeoAHHw,7,1,1,0,1,1,4,1,9,1.2857142857142858,1,0.0,0,1,0,1,1,1,0,4,1,2,7,1
10965,164491,Gcm2rqLAF1kWEJPfH2gzQRI0pndoww3G,bWdj2GDclj5ofokWjzoa5jAwMkxCykd6,8,8,5,0,3,0,6,0,22,3.142857142857143,2,0.0,0,5,0,3,8,0,0,6,0,8,14,1
10966,164492,p3tXqS62uMFoMZgoBWInrsBqScyEVB75,RXDvfPUBYFlVdlueBFbLW0mhhAyGEqpt,9,13,6,0,4,1,13,3,40,5.714285714285714,1,0.0,0,6,0,4,13,1,0,13,3,10,30,1
10967,164497,r0yZNwEG828V0TMkCl61Reya5Y5HO5aR,SpATywNh6bZuzm8s1ceuBUnMUAeoAHHw,13,24,12,0,7,2,9,2,56,8.0,3,0.0,0,12,0,7,24,2,0,9,2,19,37,1
10968,164505,yL460nvgMDqeAUMg6jxieurwSdj92YoI,SpATywNh6bZuzm8s1ceuBUnMUAeoAHHw,12,17,0,20,1,35,5,1,79,11.285714285714286,3,0.0,5,0,16,1,12,35,4,5,1,22,57,1
10969,164513,AaS8GsfaaiK26oA6b0QdGhs8opVCkjvV,RXDvfPUBYFlVdlueBFbLW0mhhAyGEqpt,1,0,0,0,0,0,1,0,1,0.14285714285714285,1,0.0,0,0,0,0,0,0,0,1,0,0,1,1
10970,164515,7wCkCmm5cR5EEXcCUnyxM6sXtrHGDdV9,SpATywNh6bZuzm8s1ceuBUnMUAeoAHHw,6,3,0,0,1,0,2,0,6,0.8571428571428571,1,0.0,0,0,0,1,3,0,0,2,0,1,5,1
10971,164516,kdAMRS8ek5nIImAJzh3SQaTESbJTFYQj,SpATywNh6bZuzm8s1ceuBUnMUAeoAHHw,14,10,5,9,3,0,5,2,34,4.857142857142857,1,0.0,3,5,8,3,7,0,1,5,2,19,15,1
10972,164522,KsAGy1yiN8nYXJpS6DHcH3mgCmV9iuno,RXDvfPUBYFlVdlueBFbLW0mhhAyGEqpt,19,14,12,0,8,0,2,0,36,5.142857142857143,2,0.0,0,12,0,8,14,0,0,2,0,20,16,1
10973,164523,plzzrHT4KCGyPPQGvIdYTvuIq5SPXcu1,RXDvfPUBYFlVdlueBFbLW0mhhAyGEqpt,7,1,1,0,1,2,9,2,16,2.2857142857142856,1,0.0,0,1,0,1,1,2,0,9,2,2,14,1
10974,164524,T9Cyxm8vF5hMWVEQAwASNLuJdzjdg5o1,SpATywNh6bZuzm8s1ceuBUnMUAeoAHHw,1,0,0,0,0,0,1,0,1,0.14285714285714285,1,0.0,0,0,0,0,0,0,0,1,0,0,1,1
10975,164529,Ldp7KDHbr0atRXYQ3DSiKhwRPw9nfvPl,SpATywNh6bZuzm8s1ceuBUnMUAeoAHHw,1,0,0,0,0,0,1,0,1,0.14285714285714285,1,0.0,0,0,0,0,0,0,0,1,0,0,1,1
10976,164534,8yNyyy8aPKd19nuqwaynaLkU67KuROpn,SpATywNh6bZuzm8s1ceuBUnMUAeoAHHw,4,3,1,0,1,0,1,0,6,0.8571428571428571,1,0.0,0,1,0,1,3,0,0,1,0,2,4,1
10977,164537,9poFqdhDn1jEwJp6tGIQlD3gMA14zAqO,RXDvfPUBYFlVdlueBFbLW0mhhAyGEqpt,15,38,0,13,1,0,8,0,60,8.571428571428571,4,0.0,2,0,13,1,36,0,0,8,0,16,44,1
10978,164539,TMVDThY2bkgDg7sHqM0GQP2XTTPMcYfY,SpATywNh6bZuzm8s1ceuBUnMUAeoAHHw,8,6,3,0,2,7,4,0,22,3.142857142857143,1,0.0,0,3,0,2,6,7,0,4,0,5,17,1
10979,164542,8p1yDT05QCsKrFjaE90DCIRByQyt5uxS,bWdj2GDclj5ofokWjzoa5jAwMkxCykd6,5,2,0,0,0,0,3,0,5,0.7142857142857143,1,0.0,0,0,0,0,2,0,0,3,0,0,5,1
10980,164552,SOZQ09msP4gFSDHArJmMSKrG8q4wIkm6,bWdj2GDclj5ofokWjzoa5jAwMkxCykd6,5,3,1,0,1,0,2,0,7,1.0,1,0.0,0,1,0,1,3,0,0,2,0,2,5,1
10981,164557,xN8qQh9NkfWvTtFHmPyQN8TpX680eL1v,SpATywNh6bZuzm8s1ceuBUnMUAeoAHHw,8,4,3,0,3,0,1,0,11,1.5714285714285714,1,0.0,0,3,0,3,4,0,0,1,0,6,5,1
10982,164565,s6KPq1RjdqeVgQrh8kntPjnSOHQAM1j3,SpATywNh6bZuzm8s1ceuBUnMUAeoAHHw,4,4,1,0,0,2,2,0,9,1.2857142857142858,2,0.0,0,1,0,0,4,2,0,2,0,1,8,1
10983,164568,y79Bz5Pe0nNA2zswV3Szg0JL3sj7FjTw,SpATywNh6bZuzm8s1ceuBUnMUAeoAHHw,7,8,0,10,0,1,1,0,20,2.857142857142857,1,0.0,4,0,9,0,4,1,1,1,0,13,7,1
10984,164575,bNBhDpviOcrLuVFG9Qda6S7fiYJ6jIvc,RXDvfPUBYFlVdlueBFbLW0mhhAyGEqpt,16,16,12,11,7,0,5,0,51,7.285714285714286,1,0.0,1,12,9,7,15,0,2,5,0,29,22,1
10985,164576,mFgVeo284zyRw0AHsEf7Tlutzf0jRu5y,G8EPVSXsOYB5YQWZGiz1aVq5Pgr2GrQu,38,42,24,38,15,0,12,2,133,19.0,3,0.0,12,24,26,15,30,0,12,12,2,77,56,1
10986,164583,4M7imMvvjejITdlkdL2tmwikUUTIrCPh,SpATywNh6bZuzm8s1ceuBUnMUAeoAHHw,5,2,1,0,1,3,2,0,9,1.2857142857142858,1,0.0,0,1,0,1,2,3,0,2,0,2,7,1
10987,164586,z1G7LpYxsjwTZY4hppMJzutv7SFcW56t,bWdj2GDclj5ofokWjzoa5jAwMkxCykd6,5,8,5,0,3,1,3,0,20,2.857142857142857,2,0.0,0,5,0,3,8,1,0,3,0,8,12,1
10988,164588,LqURTBP4yk5vSqNo0hCLASnfQyzdI5Pp,SpATywNh6bZuzm8s1ceuBUnMUAeoAHHw,5,7,0,0,0,1,2,0,10,1.4285714285714286,1,0.0,0,0,0,0,7,1,0,2,0,0,10,1
10989,164596,huVRXsZzo8sJwzNaUCXkQqT8IVauIRmI,G8EPVSXsOYB5YQWZGiz1aVq5Pgr2GrQu,5,3,1,0,1,0,1,0,6,0.8571428571428571,1,0.0,0,1,0,1,3,0,0,1,0,2,4,1
10990,164599,3eIemZUCKErDOaY2n5eaZc2Nb7KmqL3h,SpATywNh6bZuzm8s1ceuBUnMUAeoAHHw,7,3,1,0,1,0,4,0,9,1.2857142857142858,1,0.0,0,1,0,1,3,0,0,4,0,2,7,1
10991,164604,D5T00vfAoymuLZctUEYUqWRUSFLxc6S2,SpATywNh6bZuzm8s1ceuBUnMUAeoAHHw,17,13,8,6,5,0,16,9,57,8.142857142857142,1,0.0,2,8,6,5,11,0,0,16,9,21,36,1
10992,164609,KGwvzr0w0g2Ui1Ce7HWqcTPb5LubNTcC,bWdj2GDclj5ofokWjzoa5jAwMkxCykd6,16,26,11,132,7,0,7,0,183,26.142857142857142,1,0.0,14,11,128,7,12,0,4,7,0,160,23,1
10993,164612,vMgdrowUhfs65egdim3M3Ibio1bafxKv,SpATywNh6bZuzm8s1ceuBUnMUAeoAHHw,3,2,0,0,0,0,1,0,3,0.42857142857142855,1,0.0,0,0,0,0,2,0,0,1,0,0,3,1
10994,164614,Ia1CTpUugiWywdlf9kz3F5HfoicyRI2a,SpATywNh6bZuzm8s1ceuBUnMUAeoAHHw,10,12,0,22,0,0,8,0,42,6.0,1,0.0,6,0,17,0,6,0,5,8,0,23,19,1
10995,164618,GMzSpgZQ6jzVsfHn8W8i83JsYNxnP00b,bWdj2GDclj5ofokWjzoa5jAwMkxCykd6,3,2,0,0,0,0,1,0,3,0.42857142857142855,1,0.0,0,0,0,0,2,0,0,1,0,0,3,1
10996,164621,OK36i7c8u9GmSfG9DXL0YN94pRFkcmzE,bWdj2GDclj5ofokWjzoa5jAwMkxCykd6,10,14,4,62,3,0,3,1,87,12.428571428571429,1,0.0,9,4,62,3,5,0,0,3,1,78,9,1
10997,164623,rk9NUxSXr4iC638u7CUrQUKNTm3BCpYr,bWdj2GDclj5ofokWjzoa5jAwMkxCykd6,5,5,0,0,0,0,2,0,7,1.0,1,0.0,0,0,0,0,5,0,0,2,0,0,7,1
10998,164624,h3Oxw2qM6MZeJxbxgclKfxWrkznzqR3o,SpATywNh6bZuzm8s1ceuBUnMUAeoAHHw,1,0,0,0,0,0,1,0,1,0.14285714285714285,1,0.0,0,0,0,0,0,0,0,1,0,0,1,1
10999,164625,9BDe6DEjC6kCZdUf85MYhGs6ssX3Yd66,SpATywNh6bZuzm8s1ceuBUnMUAeoAHHw,2,0,0,0,0,0,2,0,2,0.2857142857142857,1,0.0,0,0,0,0,0,0,0,2,0,0,2,1
11000,164629,SVcpJb6gXZcQDuOEWDQYFqv2P86R1Xaj,bWdj2GDclj5ofokWjzoa5jAwMkxCykd6,1,0,0,0,0,0,2,0,2,0.2857142857142857,1,0.0,0,0,0,0,0,0,0,2,0,0,2,1
11001,164630,MWkXS8wTteiq3wnUOJQXQCzRJDoS4fUl,SpATywNh6bZuzm8s1ceuBUnMUAeoAHHw,8,11,1,0,1,2,8,2,25,3.5714285714285716,2,0.0,0,1,0,1,11,2,0,8,2,2,23,1
11002,164633,jQaCxlcrIW3B0ti76HtzjtRZOLJHPbzy,SpATywNh6bZuzm8s1ceuBUnMUAeoAHHw,6,8,4,0,0,0,1,0,13,1.8571428571428572,1,0.0,0,4,0,0,8,0,0,1,0,4,9,1
11003,164639,ZRcEnEYSSBQbkjzMu7sidjbxasfrmw8l,bWdj2GDclj5ofokWjzoa5jAwMkxCykd6,3,6,1,0,1,0,1,0,9,1.2857142857142858,1,0.0,2,1,0,1,4,0,0,1,0,4,5,1
11004,164650,WQKKwzu8xDLLktMRV89tUbRag4kJ87WF,SpATywNh6bZuzm8s1ceuBUnMUAeoAHHw,11,6,3,0,2,1,5,1,18,2.5714285714285716,1,0.0,0,3,0,2,6,1,0,5,1,5,13,1
11005,164652,pOBmP02v5rRyUAaKAfr6us8i87HHPyHg,G8EPVSXsOYB5YQWZGiz1aVq5Pgr2GrQu,8,6,3,0,3,0,7,0,19,2.7142857142857144,3,0.0,0,3,0,3,6,0,0,7,0,6,13,1
11006,164654,kW1xniKv3zwqO5oh82gt2iROU6EwbCnD,bWdj2GDclj5ofokWjzoa5jAwMkxCykd6,9,5,1,18,1,0,3,0,28,4.0,1,0.0,2,1,17,1,3,0,1,3,0,21,7,1
11007,164662,4lIBX7jVNURqeuVw7y54KWNhg5lYseZ6,SpATywNh6bZuzm8s1ceuBUnMUAeoAHHw,8,7,5,0,1,0,3,0,16,2.2857142857142856,2,0.0,0,5,0,1,7,0,0,3,0,6,10,1
11008,164669,Ib8KHMHKfyTwrkbnwsSOuVq4nV1vOamx,bWdj2GDclj5ofokWjzoa5jAwMkxCykd6,6,6,1,0,2,0,2,0,11,1.5714285714285714,1,0.0,3,1,0,2,3,0,0,2,0,6,5,1
11009,164672,JnItsaXrVUFk1SorJ52og61s5dE3TwDr,SpATywNh6bZuzm8s1ceuBUnMUAeoAHHw,13,18,2,15,0,0,7,1,43,6.142857142857143,2,0.0,8,2,14,0,10,0,1,7,1,24,19,1
11010,164694,uUMf8oHT3hYC8oh9guwKDiIUlL3eooGH,RXDvfPUBYFlVdlueBFbLW0mhhAyGEqpt,6,5,0,0,0,0,1,0,6,0.8571428571428571,1,0.0,0,0,0,0,5,0,0,1,0,0,6,1
11011,164698,xKvX1ldWoix080dPRcCCrhtY6KsUvocI,SpATywNh6bZuzm8s1ceuBUnMUAeoAHHw,6,3,2,0,1,0,3,0,9,1.2857142857142858,2,0.0,0,2,0,1,3,0,0,3,0,3,6,1
11012,164708,QRKDYncXtzqUo7eYzl5ZNiNJ63G2lU5V,bWdj2GDclj5ofokWjzoa5jAwMkxCykd6,3,3,1,0,0,0,2,0,6,0.8571428571428571,1,0.0,0,1,0,0,3,0,0,2,0,1,5,1
11013,164710,T4zdcGe48q1WGzA0YIvniMTWo2k6dk59,SpATywNh6bZuzm8s1ceuBUnMUAeoAHHw,3,2,0,0,0,0,1,0,3,0.42857142857142855,1,0.0,0,0,0,0,2,0,0,1,0,0,3,1
11014,164715,D5IkCYseUCO88GE1B1rMaRAAZyqCPk5T,G8EPVSXsOYB5YQWZGiz1aVq5Pgr2GrQu,1,0,0,0,0,0,1,0,1,0.14285714285714285,1,0.0,0,0,0,0,0,0,0,1,0,0,1,1
11015,164718,YHt0dZJFvCE3vP08l7NFcQ3cbtNDgaRS,SpATywNh6bZuzm8s1ceuBUnMUAeoAHHw,7,6,3,0,2,0,3,0,14,2.0,1,0.0,0,3,0,2,6,0,0,3,0,5,9,1
11016,164720,6CAW15U7onmNe5U8VRNHyhImgcvFA6AP,G8EPVSXsOYB5YQWZGiz1aVq5Pgr2GrQu,7,3,2,0,2,0,2,0,9,1.2857142857142858,1,0.0,0,2,0,2,3,0,0,2,0,4,5,1
11017,164721,WhbpJZxh93gnEo0Bkb56Vi4OStNv0BeR,G8EPVSXsOYB5YQWZGiz1aVq5Pgr2GrQu,6,4,2,0,1,0,2,0,9,1.2857142857142858,1,0.0,0,2,0,1,4,0,0,2,0,3,6,1
11018,164725,dpMiuMIGfVjkJNBGAa2GW5Vztul0ul4C,SpATywNh6bZuzm8s1ceuBUnMUAeoAHHw,14,26,6,23,2,19,6,0,82,11.714285714285714,2,0.0,15,6,20,2,11,19,3,6,0,43,39,1
11019,164731,haO9EV3Nk4mk3OeBYKT0QOiPfUTqVhFn,SpATywNh6bZuzm8s1ceuBUnMUAeoAHHw,10,16,0,6,0,0,2,0,24,3.4285714285714284,1,0.0,4,0,6,0,12,0,0,2,0,10,14,1
11020,164737,IaoTQrvjcHkJTQC9F8CfKXXVgVZXu8JB,SpATywNh6bZuzm8s1ceuBUnMUAeoAHHw,5,2,1,0,1,0,5,0,9,1.2857142857142858,1,0.0,0,1,0,1,2,0,0,5,0,2,7,1
11021,164746,ikRlhkwZCU39UKjMqWVQGSSX3n2hrElG,SpATywNh6bZuzm8s1ceuBUnMUAeoAHHw,1,0,0,0,0,0,2,0,2,0.2857142857142857,1,0.0,0,0,0,0,0,0,0,2,0,0,2,1
11022,164749,DVyimdGTTnbLGYwEpoGlJAG1kt7yY9fR,SpATywNh6bZuzm8s1ceuBUnMUAeoAHHw,4,2,1,0,1,0,1,0,5,0.7142857142857143,1,0.0,0,1,0,1,2,0,0,1,0,2,3,1
11023,164755,hgQRm8OL4JkmLyk7gplu1M4NKLxrHiyO,SpATywNh6bZuzm8s1ceuBUnMUAeoAHHw,4,2,1,0,1,0,1,0,5,0.7142857142857143,1,0.0,0,1,0,1,2,0,0,1,0,2,3,1
11024,164769,w14rTBVaKAEl5wo1WnNS26mWscctUzrO,SpATywNh6bZuzm8s1ceuBUnMUAeoAHHw,17,14,8,14,7,1,2,0,46,6.571428571428571,2,0.0,5,8,12,7,9,1,2,2,0,32,14,1
11025,164771,qOfaZTBIbb7J17xXt4ZWUinnClou9TNY,SpATywNh6bZuzm8s1ceuBUnMUAeoAHHw,13,19,0,17,0,11,11,2,60,8.571428571428571,1,0.0,13,0,15,0,6,11,2,11,2,28,32,1
11026,164775,s8rbNwiDb6Ued6nUvpbwuDl2s256fOiD,bWdj2GDclj5ofokWjzoa5jAwMkxCykd6,8,4,1,0,1,1,5,1,13,1.8571428571428572,1,0.0,0,1,0,1,4,1,0,5,1,2,11,1
11027,164791,6aBFBdVzdNrq3IlbLV8DRjoHXWBDTkRv,bWdj2GDclj5ofokWjzoa5jAwMkxCykd6,1,0,0,0,0,0,1,0,1,0.14285714285714285,1,0.0,0,0,0,0,0,0,0,1,0,0,1,1
11028,164793,VD6TkymcxBFMdB1MoYEexj8K6lT6eEyR,bWdj2GDclj5ofokWjzoa5jAwMkxCykd6,9,6,2,18,2,13,5,1,47,6.714285714285714,1,0.0,3,2,18,2,3,13,0,5,1,25,22,1
11029,164798,jmSgKLjYRvCwLEN3cPhxDpejaRW1URFZ,SpATywNh6bZuzm8s1ceuBUnMUAeoAHHw,4,2,1,0,1,0,1,0,5,0.7142857142857143,1,0.0,0,1,0,1,2,0,0,1,0,2,3,1
11030,164799,pPZkiQmDPKqQ9IZ0jTf8ExIfHdZSz9Tp,SpATywNh6bZuzm8s1ceuBUnMUAeoAHHw,14,18,7,18,4,11,5,1,64,9.142857142857142,2,0.0,9,7,15,4,9,11,3,5,1,35,29,1
11031,164800,Exq64VXC5vAwuYwY4YHzQg0BjMOxcioB,G8EPVSXsOYB5YQWZGiz1aVq5Pgr2GrQu,1,0,0,0,0,0,1,0,1,0.14285714285714285,1,0.0,0,0,0,0,0,0,0,1,0,0,1,1
11032,164805,BBfiARXlf8DQ4mmAXStqrzMqGcJUzid6,bWdj2GDclj5ofokWjzoa5jAwMkxCykd6,4,4,0,0,0,1,1,0,6,0.8571428571428571,1,0.0,0,0,0,0,4,1,0,1,0,0,6,1
11033,164807,aKmGG28IIMsmRYbcnkO5kp7ipo4I9wj0,bWdj2GDclj5ofokWjzoa5jAwMkxCykd6,1,0,0,0,0,0,1,0,1,0.14285714285714285,1,0.0,0,0,0,0,0,0,0,1,0,0,1,1
11034,164813,cZWFemuqv22LyBzJ62hqYFI8OPrcmsVO,RXDvfPUBYFlVdlueBFbLW0mhhAyGEqpt,1,0,0,0,0,0,1,0,1,0.14285714285714285,1,0.0,0,0,0,0,0,0,0,1,0,0,1,1
11035,164816,2uLwwxMo6zi7FYS0noJqK7cA1dw8HmPb,SpATywNh6bZuzm8s1ceuBUnMUAeoAHHw,1,0,0,0,0,0,1,0,1,0.14285714285714285,1,0.0,0,0,0,0,0,0,0,1,0,0,1,1
11036,164817,WTwb8dUqzcP0BlBT1I9MZd2r9gTEXFM0,bWdj2GDclj5ofokWjzoa5jAwMkxCykd6,5,2,1,0,1,0,2,0,6,0.8571428571428571,1,0.0,0,1,0,1,2,0,0,2,0,2,4,1
11037,164818,7xT79xUxciGCPT2px4CYK4DLm3lIDEn8,bWdj2GDclj5ofokWjzoa5jAwMkxCykd6,3,2,1,0,0,0,1,0,4,0.5714285714285714,1,0.0,0,1,0,0,2,0,0,1,0,1,3,1
11038,164819,td1qPqbY65yQMbPFzvqLZhtQGNGi89Aa,SpATywNh6bZuzm8s1ceuBUnMUAeoAHHw,21,25,11,25,4,0,16,1,82,11.714285714285714,3,0.0,11,11,21,4,14,0,4,16,1,47,35,1
11039,164820,opdILbT2IBFIYJvyIT5NXM7ymKeuMTcM,bWdj2GDclj5ofokWjzoa5jAwMkxCykd6,4,3,2,0,2,0,3,0,10,1.4285714285714286,1,0.0,0,2,0,2,3,0,0,3,0,4,6,1
11040,164823,xdClWt95AonMUbXmVncDz7pyQAF4u9BG,SpATywNh6bZuzm8s1ceuBUnMUAeoAHHw,4,2,0,0,0,0,3,0,5,0.7142857142857143,1,0.0,0,0,0,0,2,0,0,3,0,0,5,1
11041,164825,IfM7NFN1EcMfjBhCGt0UvdSV1gN33bRZ,bWdj2GDclj5ofokWjzoa5jAwMkxCykd6,2,0,0,0,0,0,4,0,4,0.5714285714285714,1,0.0,0,0,0,0,0,0,0,4,0,0,4,1
11042,164828,v7OTUgukPaXTchqClaPcgxRHfeAHlZs8,SpATywNh6bZuzm8s1ceuBUnMUAeoAHHw,9,4,3,0,2,0,3,1,13,1.8571428571428572,1,0.0,0,3,0,2,4,0,0,3,1,5,8,1
11043,164831,yNygMjDRQbsmQrkdzv6Ni3gEhrA9rC9T,RXDvfPUBYFlVdlueBFbLW0mhhAyGEqpt,2,0,0,0,0,0,2,0,2,0.2857142857142857,1,0.0,0,0,0,0,0,0,0,2,0,0,2,1
11044,164832,DmjOQ53VXOobMBTmNf8WzrNOpoPBXteN,G8EPVSXsOYB5YQWZGiz1aVq5Pgr2GrQu,10,9,3,0,3,0,3,0,18,2.5714285714285716,2,0.0,0,3,0,3,9,0,0,3,0,6,12,1
11045,164833,Vdk84P68xIHXBGrWqw3oEozZYT063dLv,bWdj2GDclj5ofokWjzoa5jAwMkxCykd6,6,2,1,0,1,0,3,0,7,1.0,1,0.0,0,1,0,1,2,0,0,3,0,2,5,1
11046,164839,k0fNZidBUd2gbryk31YveUTLLwvsjsHF,bWdj2GDclj5ofokWjzoa5jAwMkxCykd6,6,5,2,56,1,0,1,0,65,9.285714285714286,1,0.0,2,2,55,1,3,0,1,1,0,60,5,1
11047,164840,MSOPexvB5Mxvh6qEAn5PDvoAxMalQijS,SpATywNh6bZuzm8s1ceuBUnMUAeoAHHw,8,3,2,0,2,0,3,0,10,1.4285714285714286,1,0.0,0,2,0,2,3,0,0,3,0,4,6,1
11048,164843,oVaXXkgNP2VtEgRht0YdjYINkh8LeLTs,bWdj2GDclj5ofokWjzoa5jAwMkxCykd6,7,4,1,0,0,0,4,0,9,1.2857142857142858,1,0.0,0,1,0,0,4,0,0,4,0,1,8,1
11049,164854,iCakYP1w40pz3A1o7VgcbnomKTMQfUiT,RXDvfPUBYFlVdlueBFbLW0mhhAyGEqpt,1,0,0,0,0,0,1,0,1,0.14285714285714285,1,0.0,0,0,0,0,0,0,0,1,0,0,1,1
11050,164859,dgFOOUSNfQK8xIrT47Av0Q04bBFeE21W,SpATywNh6bZuzm8s1ceuBUnMUAeoAHHw,6,3,1,0,1,0,4,0,9,1.2857142857142858,2,0.0,0,1,0,1,3,0,0,4,0,2,7,1
11051,164870,6lI1WuhNHXlfVKzmWVMcaMqLcjUDqRef,SpATywNh6bZuzm8s1ceuBUnMUAeoAHHw,13,17,10,0,6,4,12,1,50,7.142857142857143,2,0.0,5,10,0,6,12,4,0,12,1,21,29,1
11052,164877,jqdafBVztOaU7B8oBuajiXxvz1FDItGv,RXDvfPUBYFlVdlueBFbLW0mhhAyGEqpt,1,0,0,0,0,0,1,0,1,0.14285714285714285,1,0.0,0,0,0,0,0,0,0,1,0,0,1,1
11053,164884,1vSzQDGr3DRQD3m17X46GyHlBw9UnL8Y,SpATywNh6bZuzm8s1ceuBUnMUAeoAHHw,5,2,1,0,1,0,2,0,6,0.8571428571428571,1,0.0,0,1,0,1,2,0,0,2,0,2,4,1
11054,164885,qOfaZTBIbb7J17xXt4ZWUinnClou9TNY,G8EPVSXsOYB5YQWZGiz1aVq5Pgr2GrQu,1,0,0,0,0,0,1,0,1,0.14285714285714285,1,0.0,0,0,0,0,0,0,0,1,0,0,1,1
11055,164894,d1YpWm8ZrJHw6yZFmSUUfwiG1uncdFaC,SpATywNh6bZuzm8s1ceuBUnMUAeoAHHw,7,8,6,0,5,0,2,0,21,3.0,2,0.0,0,6,0,5,8,0,0,2,0,11,10,1
11056,164897,OfowGKzB14DtDFMAzalSIqF59FGJmwsI,SpATywNh6bZuzm8s1ceuBUnMUAeoAHHw,7,4,3,0,2,0,1,0,10,1.4285714285714286,1,0.0,0,3,0,2,4,0,0,1,0,5,5,1
11057,164899,hJaHVe8Xh44z9hukeLNeR2pNBHqQdjsc,SpATywNh6bZuzm8s1ceuBUnMUAeoAHHw,8,5,2,0,2,0,2,0,11,1.5714285714285714,1,0.0,0,2,0,2,5,0,0,2,0,4,7,1
11058,164901,i7nraLaHwBYgXZfTke5TbxgaFvaS9vbl,SpATywNh6bZuzm8s1ceuBUnMUAeoAHHw,9,9,2,0,0,3,8,1,23,3.2857142857142856,2,0.0,2,2,0,0,7,3,0,8,1,4,19,1
11059,164902,kBQcF47B5gP441lpSW9ys93OU4QAjKEG,RXDvfPUBYFlVdlueBFbLW0mhhAyGEqpt,1,0,0,0,0,0,1,0,1,0.14285714285714285,1,0.0,0,0,0,0,0,0,0,1,0,0,1,1
11060,164903,kBQcF47B5gP441lpSW9ys93OU4QAjKEG,G8EPVSXsOYB5YQWZGiz1aVq5Pgr2GrQu,2,0,0,0,0,0,2,0,2,0.2857142857142857,1,0.0,0,0,0,0,0,0,0,2,0,0,2,1
11061,164905,plHbrJsV4vYGjRBOcUzcsYwkbv9wQX5B,SpATywNh6bZuzm8s1ceuBUnMUAeoAHHw,7,3,2,0,1,0,6,1,13,1.8571428571428572,1,0.0,0,2,0,1,3,0,0,6,1,3,10,1
11062,164913,0Gs9Qa1O3WvMBUAbfZOfCgWR0kizA6yM,bWdj2GDclj5ofokWjzoa5jAwMkxCykd6,6,2,0,0,0,0,8,0,10,1.4285714285714286,1,0.0,0,0,0,0,2,0,0,8,0,0,10,1
11063,164921,ID4lEXkhsumNcBZAAsLvwOjDHErWPU9z,RXDvfPUBYFlVdlueBFbLW0mhhAyGEqpt,7,7,2,0,2,0,2,0,13,1.8571428571428572,1,0.0,0,2,0,2,7,0,0,2,0,4,9,1
11064,164925,AI4uNtWiMMh2sMzoXDYV3Lbf88yJL8Br,SpATywNh6bZuzm8s1ceuBUnMUAeoAHHw,14,24,10,17,7,2,11,0,71,10.142857142857142,2,0.0,4,10,15,7,20,2,2,11,0,36,35,1
11065,164933,oz2lIvXgN1G19jRJoPetgndSl9b9808T,bWdj2GDclj5ofokWjzoa5jAwMkxCykd6,8,6,3,0,4,0,1,0,14,2.0,2,0.0,2,3,0,4,4,0,0,1,0,9,5,1
11066,164941,j0ueLtQ2R4YY5IElzCXogrNJYFltC4bt,G8EPVSXsOYB5YQWZGiz1aVq5Pgr2GrQu,13,21,4,0,5,0,5,0,35,5.0,3,0.0,3,4,0,5,18,0,0,5,0,12,23,1
11067,164948,aGKf0W7DbO5pZNcjJ5sGrg9jyzAmLXkB,bWdj2GDclj5ofokWjzoa5jAwMkxCykd6,8,11,4,0,2,0,8,0,25,3.5714285714285716,1,0.0,0,4,0,2,11,0,0,8,0,6,19,1
11068,164949,QJffKxs9lkFscQquMcfEw8hYo0ArYTkN,SpATywNh6bZuzm8s1ceuBUnMUAeoAHHw,6,7,1,0,1,0,3,0,12,1.7142857142857142,4,0.0,0,1,0,1,7,0,0,3,0,2,10,1
11069,164952,oZPmpjOeoiaunM2zVcQx8binL7fSfr4d,SpATywNh6bZuzm8s1ceuBUnMUAeoAHHw,1,0,0,0,0,0,1,0,1,0.14285714285714285,1,0.0,0,0,0,0,0,0,0,1,0,0,1,1
11070,164955,5BBW4T6qopgkCdcRVxFBI93aopzlZ3Vz,bWdj2GDclj5ofokWjzoa5jAwMkxCykd6,5,5,3,0,1,0,2,0,11,1.5714285714285714,2,0.0,0,3,0,1,5,0,0,2,0,4,7,1
11071,164957,1d49ijo1gfMUzl6uYLthfVZwQuAtGF5H,SpATywNh6bZuzm8s1ceuBUnMUAeoAHHw,1,0,0,0,0,0,1,0,1,0.14285714285714285,1,0.0,0,0,0,0,0,0,0,1,0,0,1,1
11072,164958,d9MkkuCn04Toz7g1JpLdUJWD9xM5braA,SpATywNh6bZuzm8s1ceuBUnMUAeoAHHw,1,0,0,0,0,0,1,0,1,0.14285714285714285,1,0.0,0,0,0,0,0,0,0,1,0,0,1,1
11073,164962,IwDrIHJtpM1SKA7Se5PnSGFRi77bmt0i,G8EPVSXsOYB5YQWZGiz1aVq5Pgr2GrQu,1,0,0,0,0,0,1,0,1,0.14285714285714285,1,0.0,0,0,0,0,0,0,0,1,0,0,1,1
11074,164963,IwDrIHJtpM1SKA7Se5PnSGFRi77bmt0i,bWdj2GDclj5ofokWjzoa5jAwMkxCykd6,2,0,0,0,0,0,2,0,2,0.2857142857142857,1,0.0,0,0,0,0,0,0,0,2,0,0,2,1
11075,164967,Jk09qA6alwSJzVuIqHppbDvZyk5u7ZHA,SpATywNh6bZuzm8s1ceuBUnMUAeoAHHw,23,26,0,33,0,10,13,3,85,12.142857142857142,3,0.0,10,0,29,0,16,10,4,13,3,39,46,1
11076,164978,NimtbKU9auo6KOsWhgU5KdNhvgw88gOw,bWdj2GDclj5ofokWjzoa5jAwMkxCykd6,5,2,1,0,1,0,2,0,6,0.8571428571428571,1,0.0,0,1,0,1,2,0,0,2,0,2,4,1
11077,164983,idGQZu8btUqvVr9UadRnlmVq4UYW0mU2,SpATywNh6bZuzm8s1ceuBUnMUAeoAHHw,1,0,0,0,0,0,1,0,1,0.14285714285714285,1,0.0,0,0,0,0,0,0,0,1,0,0,1,1
11078,164999,muJ6MIRhOdDL6SrbHsZ7Ks5a50Iz9AeC,G8EPVSXsOYB5YQWZGiz1aVq5Pgr2GrQu,40,54,19,24,14,1,5,0,117,16.714285714285715,1,0.0,12,19,13,14,42,1,11,5,0,58,59,0
11079,165000,nazeZS8BdRMOGGuVriyb5M21Pn5Qng36,G8EPVSXsOYB5YQWZGiz1aVq5Pgr2GrQu,1,0,0,0,0,0,1,0,1,0.14285714285714285,1,0.0,0,0,0,0,0,0,0,1,0,0,1,1
11080,165009,z79FxI6IxKXksSKIwsXSYM1kOlaP8f6r,A3fsA9Zfv1X2fVEQhTw51lKENdNrEqT3,3,3,0,0,0,0,1,0,4,0.5714285714285714,1,0.0,0,0,0,0,3,0,0,1,0,0,4,1
11081,165020,D1bGDJ4bL5x58ejhrACWlbqkfYdH5dQ6,G8EPVSXsOYB5YQWZGiz1aVq5Pgr2GrQu,2,0,0,0,0,0,5,0,5,0.7142857142857143,1,0.0,0,0,0,0,0,0,0,5,0,0,5,1
11082,165028,l1eQ9gI2TTb4dmIRNT0TZDzdHfiIL8H7,SpATywNh6bZuzm8s1ceuBUnMUAeoAHHw,4,2,1,0,1,0,1,0,5,0.7142857142857143,1,0.0,0,1,0,1,2,0,0,1,0,2,3,1
11083,165035,qKfZusm0R8jxltESvgi15dswdw73Gjlp,SpATywNh6bZuzm8s1ceuBUnMUAeoAHHw,4,6,3,0,0,0,2,0,11,1.5714285714285714,1,0.0,2,3,0,0,4,0,0,2,0,5,6,1
11084,165038,Im85u8aENweba95uFnFOR6zdQWFnfDOq,A3fsA9Zfv1X2fVEQhTw51lKENdNrEqT3,2,0,0,0,0,0,2,0,2,0.2857142857142857,1,0.0,0,0,0,0,0,0,0,2,0,0,2,1
11085,165043,WLEMGeSXBUEafvCWOKhfcrxNQOC05nqM,bWdj2GDclj5ofokWjzoa5jAwMkxCykd6,6,2,1,0,1,0,5,1,10,1.4285714285714286,1,0.0,0,1,0,1,2,0,0,5,1,2,8,1
11086,165045,WzO2F8mFL9S6WyVuaBKRnAo7AfpK6MFq,SpATywNh6bZuzm8s1ceuBUnMUAeoAHHw,7,8,3,0,4,0,2,0,17,2.4285714285714284,2,0.0,0,3,0,4,8,0,0,2,0,7,10,1
11087,165056,AOCx0foyQMeiMTgZQ1N4fT75yVQcQ0J9,A3fsA9Zfv1X2fVEQhTw51lKENdNrEqT3,13,15,7,0,3,0,3,0,28,4.0,2,0.0,0,7,0,3,15,0,0,3,0,10,18,0
11088,165064,PXNipZTrm6ag7nUFRb8wDcb09bEqCKm5,bWdj2GDclj5ofokWjzoa5jAwMkxCykd6,16,7,4,72,1,0,3,0,87,12.428571428571429,1,0.0,0,4,62,1,7,0,10,3,0,67,20,1
11089,165066,jaOmqqWd0RurZsiyeEDBNOhHZZXgisPQ,G8EPVSXsOYB5YQWZGiz1aVq5Pgr2GrQu,124,123,60,300,20,14,34,2,553,79.0,5,0.0,47,60,238,20,76,14,62,34,2,365,188,1
11090,165067,Wm4d7ifDaTgcR0GfUqwJt5OZKbYglRCq,bWdj2GDclj5ofokWjzoa5jAwMkxCykd6,1,0,0,0,0,0,1,0,1,0.14285714285714285,1,0.0,0,0,0,0,0,0,0,1,0,0,1,1
11091,165074,ij6lhOw7nYbJY8ZynpI4C6NhJmjCSNsH,bWdj2GDclj5ofokWjzoa5jAwMkxCykd6,12,13,7,0,6,1,6,1,34,4.857142857142857,2,0.0,3,7,0,6,10,1,0,6,1,16,18,1
11092,165075,ij6lhOw7nYbJY8ZynpI4C6NhJmjCSNsH,A3fsA9Zfv1X2fVEQhTw51lKENdNrEqT3,2,0,0,0,0,0,2,0,2,0.2857142857142857,1,0.0,0,0,0,0,0,0,0,2,0,0,2,1
11093,165079,5B9CBBwEycq9mrKyjhnz4JxWbxAUtqXx,bWdj2GDclj5ofokWjzoa5jAwMkxCykd6,2,0,0,0,0,0,3,0,3,0.42857142857142855,1,0.0,0,0,0,0,0,0,0,3,0,0,3,1
11094,165087,M4k2b8losoqUFktWiKn58aOnUoYhQVU3,A3fsA9Zfv1X2fVEQhTw51lKENdNrEqT3,9,5,4,0,4,0,10,0,23,3.2857142857142856,3,0.0,0,4,0,4,5,0,0,10,0,8,15,0
11095,165098,zX1TLWT3E7MpbG4kzvZO6rEOvxyi9iAE,SpATywNh6bZuzm8s1ceuBUnMUAeoAHHw,4,2,1,0,1,0,1,0,5,0.7142857142857143,1,0.0,0,1,0,1,2,0,0,1,0,2,3,1
11096,165102,8IsnQQnfLzKrobCqyqui1F07ZqYQDg46,G8EPVSXsOYB5YQWZGiz1aVq5Pgr2GrQu,38,99,5,90,12,1,14,2,223,31.857142857142858,2,0.0,54,5,62,12,45,1,28,14,2,133,90,1
11097,165103,Tc9HVYhVH0mbvYBIDHqjba6NetUmurJg,SpATywNh6bZuzm8s1ceuBUnMUAeoAHHw,1,0,0,0,0,0,1,0,1,0.14285714285714285,1,0.0,0,0,0,0,0,0,0,1,0,0,1,1
11098,165110,o0yBW91wJfDjK5Q4nsWKulavXcIg9y1s,SpATywNh6bZuzm8s1ceuBUnMUAeoAHHw,1,0,0,0,0,0,1,0,1,0.14285714285714285,1,0.0,0,0,0,0,0,0,0,1,0,0,1,1
11099,165112,Ml3VPfyUCPhgR4WxRurT5TFwkYDGbSwH,SpATywNh6bZuzm8s1ceuBUnMUAeoAHHw,13,8,6,0,3,2,6,1,26,3.7142857142857144,1,0.0,0,6,0,3,8,2,0,6,1,9,17,1
11100,165114,o0yBW91wJfDjK5Q4nsWKulavXcIg9y1s,bWdj2GDclj5ofokWjzoa5jAwMkxCykd6,1,0,0,0,0,0,1,0,1,0.14285714285714285,1,0.0,0,0,0,0,0,0,0,1,0,0,1,1
11101,165115,o0yBW91wJfDjK5Q4nsWKulavXcIg9y1s,A3fsA9Zfv1X2fVEQhTw51lKENdNrEqT3,1,0,0,0,0,0,1,0,1,0.14285714285714285,1,0.0,0,0,0,0,0,0,0,1,0,0,1,1
11102,165124,h3uJUtBmEvmKgQr2Q8BC6FJ5GRugm894,bWdj2GDclj5ofokWjzoa5jAwMkxCykd6,3,0,0,0,0,0,3,0,3,0.42857142857142855,1,0.0,0,0,0,0,0,0,0,3,0,0,3,1
11103,165134,kaAc9OSRmTYmUacyuwJF8uvWHTHZhU6I,SpATywNh6bZuzm8s1ceuBUnMUAeoAHHw,3,2,0,0,0,0,1,0,3,0.42857142857142855,1,0.0,0,0,0,0,2,0,0,1,0,0,3,1
11104,165142,6PDeQOxrHkZQRUh0DA1ORZrJ9fgsXVig,SpATywNh6bZuzm8s1ceuBUnMUAeoAHHw,6,1,1,0,1,0,3,0,6,0.8571428571428571,1,0.0,0,1,0,1,1,0,0,3,0,2,4,1
11105,165148,pdZm7VuSx559JxocpNxvzJ1tzNwrAivH,SpATywNh6bZuzm8s1ceuBUnMUAeoAHHw,11,6,3,2,2,0,5,0,18,2.5714285714285716,1,0.0,2,3,2,2,4,0,0,5,0,9,9,1
11106,165152,KOUX6K1HiyGmH7Bu8fXQloWlM5ql067i,SpATywNh6bZuzm8s1ceuBUnMUAeoAHHw,1,0,0,0,0,0,1,0,1,0.14285714285714285,1,0.0,0,0,0,0,0,0,0,1,0,0,1,1
11107,165164,OhaXK8lO0kUyQn9GvgyzAKVV6q7Nf881,G8EPVSXsOYB5YQWZGiz1aVq5Pgr2GrQu,17,17,9,6,7,2,6,0,47,6.714285714285714,1,0.0,5,9,3,7,12,2,3,6,0,24,23,1
11108,165183,oBIU2QyRoi1Laa10XMgxHQ2fgzYMbfW0,RXDvfPUBYFlVdlueBFbLW0mhhAyGEqpt,7,4,3,0,1,0,2,0,10,1.4285714285714286,1,0.0,0,3,0,1,4,0,0,2,0,4,6,1
11109,165187,Wm4d7ifDaTgcR0GfUqwJt5OZKbYglRCq,SpATywNh6bZuzm8s1ceuBUnMUAeoAHHw,12,12,6,0,4,0,3,0,25,3.5714285714285716,2,0.0,0,6,0,4,12,0,0,3,0,10,15,1
11110,165190,gR8vpBOtEmg1p0U3mlFoyPZ2gKmD8M8k,bWdj2GDclj5ofokWjzoa5jAwMkxCykd6,1,0,0,0,0,0,1,0,1,0.14285714285714285,1,0.0,0,0,0,0,0,0,0,1,0,0,1,1
11111,165194,Qn3OccgDXQpcut9yLA9jXfau6FPbS72n,bWdj2GDclj5ofokWjzoa5jAwMkxCykd6,1,0,0,0,0,0,3,0,3,0.42857142857142855,2,0.0,0,0,0,0,0,0,0,3,0,0,3,1
11112,165204,gfT397rHr4ZgHPLGZxZdcWxic55z4KQu,A3fsA9Zfv1X2fVEQhTw51lKENdNrEqT3,5,4,1,0,0,0,3,0,8,1.1428571428571428,2,0.0,0,1,0,0,4,0,0,3,0,1,7,1
11113,165205,EP7JoIZBfkdGbLwYL5xgvZ6bevF26Inu,SpATywNh6bZuzm8s1ceuBUnMUAeoAHHw,10,7,5,0,4,1,6,1,24,3.4285714285714284,1,0.0,0,5,0,4,7,1,0,6,1,9,15,1
11114,165208,kERhRnhdT9O0KrRIFldGxnMdaroWZIzP,bWdj2GDclj5ofokWjzoa5jAwMkxCykd6,8,4,0,0,0,2,6,1,13,1.8571428571428572,1,0.0,0,0,0,0,4,2,0,6,1,0,13,1
11115,165211,xNRLLiS6E0KC8Qrwk7McgtlhyqJ4FeFj,SpATywNh6bZuzm8s1ceuBUnMUAeoAHHw,1,0,0,0,0,0,1,0,1,0.14285714285714285,1,0.0,0,0,0,0,0,0,0,1,0,0,1,1
11116,165214,PaIBEPuJYWYGsLlp86uNBuTjQqpfezDI,G8EPVSXsOYB5YQWZGiz1aVq5Pgr2GrQu,6,3,1,0,1,0,2,0,7,1.0,1,0.0,0,1,0,1,3,0,0,2,0,2,5,1
11117,165215,1ak0eRZu8M5MlKljzewZoOjF7rom18Lp,SpATywNh6bZuzm8s1ceuBUnMUAeoAHHw,14,13,5,19,3,0,2,0,42,6.0,1,0.0,6,5,16,3,7,0,3,2,0,30,12,1
11118,165216,wricgx1QoMh70qtCt5pQGc1O8zgAKC8W,SpATywNh6bZuzm8s1ceuBUnMUAeoAHHw,6,2,2,0,0,1,3,0,8,1.1428571428571428,1,0.0,0,2,0,0,2,1,0,3,0,2,6,1
11119,165225,ofD9EgkVhROhMeSiR6CvxPzrkKAVlk9e,SpATywNh6bZuzm8s1ceuBUnMUAeoAHHw,4,2,0,0,0,0,2,0,4,0.5714285714285714,1,0.0,0,0,0,0,2,0,0,2,0,0,4,1
11120,165230,frKiIgyfjqTyVCSr7oHYXE3h3ahmBYPu,SpATywNh6bZuzm8s1ceuBUnMUAeoAHHw,9,4,3,0,3,0,2,0,12,1.7142857142857142,1,0.0,0,3,0,3,4,0,0,2,0,6,6,1
11121,165231,kERhRnhdT9O0KrRIFldGxnMdaroWZIzP,A3fsA9Zfv1X2fVEQhTw51lKENdNrEqT3,6,3,1,0,1,0,2,0,7,1.0,1,0.0,0,1,0,1,3,0,0,2,0,2,5,1
11122,165232,0tHH7qf3NqLHNPGNzZQ6gb0TO9yXFipC,SpATywNh6bZuzm8s1ceuBUnMUAeoAHHw,6,2,1,0,1,0,3,0,7,1.0,1,0.0,0,1,0,1,2,0,0,3,0,2,5,1
11123,165233,dVeRIohjfohGjzEkLsaU11h0LM0FLGYK,A3fsA9Zfv1X2fVEQhTw51lKENdNrEqT3,1,0,0,0,0,0,1,0,1,0.14285714285714285,1,0.0,0,0,0,0,0,0,0,1,0,0,1,1
11124,165249,luS4LypZudLH1I2R9ITqSmx2yCBqIuBV,A3fsA9Zfv1X2fVEQhTw51lKENdNrEqT3,5,0,0,0,0,0,10,2,12,1.7142857142857142,1,0.0,0,0,0,0,0,0,0,10,2,0,12,1
11125,165251,pQwQ7lq50KHnzLX18552MmFyRyK2NBh3,SpATywNh6bZuzm8s1ceuBUnMUAeoAHHw,16,34,16,19,6,0,3,0,78,11.142857142857142,3,0.0,13,16,18,6,21,0,1,3,0,53,25,1
11126,165254,SHOQyzWMzeXzTVojp4arGhfbJLLjl3Lx,A3fsA9Zfv1X2fVEQhTw51lKENdNrEqT3,33,20,11,68,4,0,6,0,109,15.571428571428571,2,0.0,1,11,68,4,19,0,0,6,0,84,25,1
11127,165256,z9oiQyplHlMmhFVKenfY0OjMOlRO24Ty,SpATywNh6bZuzm8s1ceuBUnMUAeoAHHw,10,20,9,0,6,0,3,0,38,5.428571428571429,2,0.0,0,9,0,6,20,0,0,3,0,15,23,0
11128,165259,5pl9QZtfcLF7zmReytidQLwrDKpwL5AY,G8EPVSXsOYB5YQWZGiz1aVq5Pgr2GrQu,18,14,10,0,9,0,5,1,39,5.571428571428571,1,0.0,2,10,0,9,12,0,0,5,1,21,18,1
11129,165269,NrHk4qmJXuD0TsjkQSnghKpk9ZjGAOyU,bWdj2GDclj5ofokWjzoa5jAwMkxCykd6,17,16,12,0,9,3,7,1,48,6.857142857142857,2,0.0,0,12,0,9,16,3,0,7,1,21,27,1
11130,165274,2EVUeEjVIM9F9OWjZ4WZKUdJeVQtpas5,SpATywNh6bZuzm8s1ceuBUnMUAeoAHHw,1,0,0,0,0,0,1,0,1,0.14285714285714285,1,0.0,0,0,0,0,0,0,0,1,0,0,1,0
11131,165275,nIaUSG86MljehwfWdoHPVChPOF3VCDSs,SpATywNh6bZuzm8s1ceuBUnMUAeoAHHw,7,2,0,0,0,1,7,1,11,1.5714285714285714,3,0.0,0,0,0,0,2,1,0,7,1,0,11,1
11132,165277,2HOmNQE0nDdyZUXCoC3g1k9N8rwQhnPY,RXDvfPUBYFlVdlueBFbLW0mhhAyGEqpt,3,1,0,0,0,0,2,0,3,0.42857142857142855,1,0.0,0,0,0,0,1,0,0,2,0,0,3,1
11133,165314,k1lsxE5YiR3LJaUe06e2F2PB8Llyh0eb,SpATywNh6bZuzm8s1ceuBUnMUAeoAHHw,7,3,2,0,2,0,2,0,9,1.2857142857142858,1,0.0,0,2,0,2,3,0,0,2,0,4,5,1
11134,165315,SZwbwmX9qJUPYLRS3g1l8moP7xnTFUCL,G8EPVSXsOYB5YQWZGiz1aVq5Pgr2GrQu,7,2,0,0,0,0,7,3,12,1.7142857142857142,1,0.0,0,0,0,0,2,0,0,7,3,0,12,1
11135,165316,QjeOsFvzphzL2UBVpgKTVxr9nbyzd09u,SpATywNh6bZuzm8s1ceuBUnMUAeoAHHw,5,4,3,0,3,0,2,0,12,1.7142857142857142,1,0.0,0,3,0,3,4,0,0,2,0,6,6,1
11136,165318,H5hq1RXMZvjdgAVV42G1HlcBUWfqaAQD,SpATywNh6bZuzm8s1ceuBUnMUAeoAHHw,10,16,3,0,1,2,13,0,35,5.0,2,0.0,0,3,0,1,16,2,0,13,0,4,31,1
11137,165319,ELnpGakFfMjgNeN5VeZv7LPxT1yvRGG2,SpATywNh6bZuzm8s1ceuBUnMUAeoAHHw,16,8,4,10,3,1,8,1,35,5.0,2,0.0,3,4,10,3,5,1,0,8,1,20,15,1
11138,165320,mvS4OjvaKNqVV60dVhvpTVSSCBc97FlN,A3fsA9Zfv1X2fVEQhTw51lKENdNrEqT3,1,0,0,0,0,0,2,0,2,0.2857142857142857,1,0.0,0,0,0,0,0,0,0,2,0,0,2,1
11139,165333,Vi6OE1s5C9epsDKkpv5rYzlTigz225uK,SpATywNh6bZuzm8s1ceuBUnMUAeoAHHw,7,3,2,0,2,1,2,0,10,1.4285714285714286,1,0.0,0,2,0,2,3,1,0,2,0,4,6,1
11140,165334,FsXs9JXJ9sX8GX6pr0IRKZCa3w12SCYq,G8EPVSXsOYB5YQWZGiz1aVq5Pgr2GrQu,5,2,1,0,1,0,3,0,7,1.0,1,0.0,0,1,0,1,2,0,0,3,0,2,5,1
11141,165337,SiDEVAV0vWeEC76b25xnijgEBNeEhRJy,SpATywNh6bZuzm8s1ceuBUnMUAeoAHHw,1,0,0,0,0,0,1,0,1,0.14285714285714285,1,0.0,0,0,0,0,0,0,0,1,0,0,1,1
11142,165340,oaoj9be4jW2Hot8wYgYrzLRvB0RU4KYy,SpATywNh6bZuzm8s1ceuBUnMUAeoAHHw,14,14,6,14,1,0,7,0,42,6.0,4,0.0,4,6,14,1,10,0,0,7,0,25,17,1
11143,165342,oaoj9be4jW2Hot8wYgYrzLRvB0RU4KYy,A3fsA9Zfv1X2fVEQhTw51lKENdNrEqT3,5,8,4,0,1,0,5,0,18,2.5714285714285716,4,0.0,0,4,0,1,8,0,0,5,0,5,13,0
11144,165353,SiDEVAV0vWeEC76b25xnijgEBNeEhRJy,bWdj2GDclj5ofokWjzoa5jAwMkxCykd6,1,0,0,0,0,0,1,0,1,0.14285714285714285,1,0.0,0,0,0,0,0,0,0,1,0,0,1,1
11145,165359,SiDEVAV0vWeEC76b25xnijgEBNeEhRJy,A3fsA9Zfv1X2fVEQhTw51lKENdNrEqT3,1,0,0,0,0,0,1,0,1,0.14285714285714285,1,0.0,0,0,0,0,0,0,0,1,0,0,1,1
11146,165373,PhwD1ZKLhvgbOMQEx5zAfzeK2oPW1QkC,SpATywNh6bZuzm8s1ceuBUnMUAeoAHHw,1,0,0,0,0,0,1,0,1,0.14285714285714285,1,0.0,0,0,0,0,0,0,0,1,0,0,1,1
11147,165376,yR0NraAWygNs5cts7Fvc0zvbt2sGOVtI,SpATywNh6bZuzm8s1ceuBUnMUAeoAHHw,19,15,13,0,11,0,6,0,45,6.428571428571429,3,0.0,0,13,0,11,15,0,0,6,0,24,21,1
11148,165378,H3h5uLXB3vbpRqjJs3VxBW591kIrIfb3,SpATywNh6bZuzm8s1ceuBUnMUAeoAHHw,4,3,1,0,1,0,2,0,7,1.0,1,0.0,0,1,0,1,3,0,0,2,0,2,5,0
11149,165390,QNGWdAKV7t5cBffSfxkRIBFN3DRIwrkT,SpATywNh6bZuzm8s1ceuBUnMUAeoAHHw,5,2,1,0,1,0,2,0,6,0.8571428571428571,1,0.0,0,1,0,1,2,0,0,2,0,2,4,1
11150,165393,yfeIcWRmFLjQgBIM196kRoHXCKG0ateC,A3fsA9Zfv1X2fVEQhTw51lKENdNrEqT3,24,21,14,0,9,3,11,0,58,8.285714285714286,3,0.0,3,14,0,9,18,3,0,11,0,26,32,1
11151,165398,4BWY4WoZwowebQpACrizuzaSUpqFUPYV,A3fsA9Zfv1X2fVEQhTw51lKENdNrEqT3,1,0,0,0,0,0,2,0,2,0.2857142857142857,1,0.0,0,0,0,0,0,0,0,2,0,0,2,1
11152,165402,RDChRApYRv6Sfe9dw6iFymmd1hK0JhGY,A3fsA9Zfv1X2fVEQhTw51lKENdNrEqT3,1,0,0,0,0,0,1,0,1,0.14285714285714285,1,0.0,0,0,0,0,0,0,0,1,0,0,1,1
11153,165419,G6cW0d2bzLHgB0vreFbhNx3GSiMBKbtv,bWdj2GDclj5ofokWjzoa5jAwMkxCykd6,4,3,1,0,1,0,1,0,6,0.8571428571428571,1,0.0,0,1,0,1,3,0,0,1,0,2,4,1
11154,165422,rROYd0uArbh5iBXaNezR5YmAESEuia7u,bWdj2GDclj5ofokWjzoa5jAwMkxCykd6,2,0,0,0,0,0,2,0,2,0.2857142857142857,1,0.0,0,0,0,0,0,0,0,2,0,0,2,1
11155,165427,QDpN8D19Mr8RZumTONWpZNlCWcHCCTbH,RXDvfPUBYFlVdlueBFbLW0mhhAyGEqpt,1,0,0,0,0,0,1,0,1,0.14285714285714285,1,0.0,0,0,0,0,0,0,0,1,0,0,1,1
11156,165428,MCX6PserzHPOVcVElkM3aC5c5GhSLDKg,SpATywNh6bZuzm8s1ceuBUnMUAeoAHHw,7,6,4,0,1,0,4,0,15,2.142857142857143,1,0.0,0,4,0,1,6,0,0,4,0,5,10,1
11157,165431,DrolXxynktOsAUhkf2q3qgLe9PvqdRq3,A3fsA9Zfv1X2fVEQhTw51lKENdNrEqT3,1,0,0,0,0,0,1,0,1,0.14285714285714285,1,0.0,0,0,0,0,0,0,0,1,0,0,1,1
11158,165432,171vdjJg3ZQqEKQGGQqQb3EXy77TiE88,SpATywNh6bZuzm8s1ceuBUnMUAeoAHHw,2,0,0,0,0,0,2,0,2,0.2857142857142857,1,0.0,0,0,0,0,0,0,0,2,0,0,2,1
11159,165446,bWVYIzoXIGQmlYVnRkh7UPWZa7BftJJn,SpATywNh6bZuzm8s1ceuBUnMUAeoAHHw,2,0,0,0,0,0,2,0,2,0.2857142857142857,1,0.0,0,0,0,0,0,0,0,2,0,0,2,1
11160,165458,MQKEfJfHQjDI3xyJjnjmz4WwmQkpOvq2,bWdj2GDclj5ofokWjzoa5jAwMkxCykd6,6,4,2,0,1,0,4,0,11,1.5714285714285714,2,0.0,0,2,0,1,4,0,0,4,0,3,8,1
11161,165462,0RrAM7mPLzd3skZgaRP9NKB2Gqbiiam3,SpATywNh6bZuzm8s1ceuBUnMUAeoAHHw,3,2,0,0,0,0,2,0,4,0.5714285714285714,1,0.0,0,0,0,0,2,0,0,2,0,0,4,1
11162,165485,WXsAy1py6xNoAtmIQsPWN4rhdvzggrq1,SpATywNh6bZuzm8s1ceuBUnMUAeoAHHw,1,0,0,0,0,0,1,0,1,0.14285714285714285,1,0.0,0,0,0,0,0,0,0,1,0,0,1,1
11163,165489,WXsAy1py6xNoAtmIQsPWN4rhdvzggrq1,RXDvfPUBYFlVdlueBFbLW0mhhAyGEqpt,16,28,4,0,4,0,7,0,43,6.142857142857143,4,0.0,0,4,0,4,28,0,0,7,0,8,35,1
11164,165491,wg9kzusa79hS4fFC5hU9Laht66GWJcDA,RXDvfPUBYFlVdlueBFbLW0mhhAyGEqpt,1,0,0,0,0,0,1,0,1,0.14285714285714285,1,0.0,0,0,0,0,0,0,0,1,0,0,1,1
11165,165509,E7ohNiXaqWq4qLMuCCQXRkjiO7PGgPyS,A3fsA9Zfv1X2fVEQhTw51lKENdNrEqT3,1,0,0,0,0,0,1,0,1,0.14285714285714285,1,0.0,0,0,0,0,0,0,0,1,0,0,1,1
11166,165524,8wyKs5vTbaPjVAzqiPgYkv71kXMupepX,SpATywNh6bZuzm8s1ceuBUnMUAeoAHHw,6,3,1,0,1,2,2,0,9,1.2857142857142858,1,0.0,0,1,0,1,3,2,0,2,0,2,7,1
11167,165525,pLYG36p2jiNeVIQQxkAjPMCy7LTje21i,bWdj2GDclj5ofokWjzoa5jAwMkxCykd6,1,0,0,0,0,0,1,0,1,0.14285714285714285,1,0.0,0,0,0,0,0,0,0,1,0,0,1,1
11168,165530,2g49Uxh0o7UNSAoA6NR0GAmfGLF8JjXt,SpATywNh6bZuzm8s1ceuBUnMUAeoAHHw,11,14,0,23,1,7,3,0,48,6.857142857142857,1,0.0,8,0,20,1,6,7,3,3,0,29,19,1
11169,165531,srCZOXVyb44qlEge30QR25H9jokNeHzQ,SpATywNh6bZuzm8s1ceuBUnMUAeoAHHw,3,2,0,0,0,0,1,0,3,0.42857142857142855,1,0.0,0,0,0,0,2,0,0,1,0,0,3,0
11170,165536,1ImGMKyV7Di3tjZEdKRuDKDVzc7buyQG,SpATywNh6bZuzm8s1ceuBUnMUAeoAHHw,6,7,1,0,1,0,2,0,11,1.5714285714285714,1,0.0,0,1,0,1,7,0,0,2,0,2,9,1
11171,165539,GKKPaN5cNHTg4FgODePiiUlUMrULEfiu,SpATywNh6bZuzm8s1ceuBUnMUAeoAHHw,8,6,4,0,3,0,2,0,15,2.142857142857143,1,0.0,0,4,0,3,6,0,0,2,0,7,8,1
11172,165563,OIJqLsLQ0l4P9wwH2Os3C8W1InCTTS4l,SpATywNh6bZuzm8s1ceuBUnMUAeoAHHw,1,0,0,0,0,0,1,0,1,0.14285714285714285,1,0.0,0,0,0,0,0,0,0,1,0,0,1,1
11173,165566,Ml5BpcJCzlIYi0qFUUXB9FVaOk4IObDm,SpATywNh6bZuzm8s1ceuBUnMUAeoAHHw,5,4,0,0,0,0,2,0,6,0.8571428571428571,1,0.0,0,0,0,0,4,0,0,2,0,0,6,1
11174,165576,5fYqTmVKkWf8WeRMHDLJyPdR1zqgEtLM,SpATywNh6bZuzm8s1ceuBUnMUAeoAHHw,6,2,1,0,1,0,3,0,7,1.0,1,0.0,0,1,0,1,2,0,0,3,0,2,5,1
11175,165581,cp1vQuxrP7S8Bxj7ORUE5wjTIrRPfe4O,SpATywNh6bZuzm8s1ceuBUnMUAeoAHHw,7,8,0,0,0,0,5,1,14,2.0,1,0.0,2,0,0,0,6,0,0,5,1,2,12,1
11176,165592,JWwJ8KbdNh7FB84c1h8AD4pHgPCC9uj6,SpATywNh6bZuzm8s1ceuBUnMUAeoAHHw,8,4,3,0,3,0,1,0,11,1.5714285714285714,1,0.0,0,3,0,3,4,0,0,1,0,6,5,1
11177,165596,QqNuARzccJUP5HNszzjljOhC9t53eZLk,A3fsA9Zfv1X2fVEQhTw51lKENdNrEqT3,46,30,15,66,10,5,12,8,146,20.857142857142858,3,0.0,4,15,57,10,26,5,9,12,8,86,60,1
11178,165606,XmbLwxmQRLXz9T2ULgWW6uwVskMK6ds2,SpATywNh6bZuzm8s1ceuBUnMUAeoAHHw,17,23,0,12,0,0,1,0,36,5.142857142857143,1,0.0,4,0,12,0,19,0,0,1,0,16,20,1
11179,165612,KL4xQqmMI37CKNQsNsMM9emaoJIOAgLu,SpATywNh6bZuzm8s1ceuBUnMUAeoAHHw,8,9,2,0,1,0,3,0,15,2.142857142857143,1,0.0,0,2,0,1,9,0,0,3,0,3,12,1
11180,165617,fB4iAxEUCZ6aGoIPtPsbdJRsMMg2k42A,SpATywNh6bZuzm8s1ceuBUnMUAeoAHHw,10,8,5,2,1,0,3,0,19,2.7142857142857144,1,0.0,1,5,2,1,7,0,0,3,0,9,10,1
11181,165620,llrEAs9SMv6dYcefFrAK178vmmmglVzw,SpATywNh6bZuzm8s1ceuBUnMUAeoAHHw,9,5,3,0,2,1,6,1,18,2.5714285714285716,1,0.0,0,3,0,2,5,1,0,6,1,5,13,1
11182,165626,85DVIn1pw5TUgdo2ZtmymnwN8xrWNYCJ,G8EPVSXsOYB5YQWZGiz1aVq5Pgr2GrQu,1,0,0,0,0,0,1,0,1,0.14285714285714285,1,0.0,0,0,0,0,0,0,0,1,0,0,1,1
11183,165635,OLNUzQUHvlNsi2WFlH5eEyaieqKXrEz7,RXDvfPUBYFlVdlueBFbLW0mhhAyGEqpt,1,0,0,0,0,0,1,0,1,0.14285714285714285,1,0.0,0,0,0,0,0,0,0,1,0,0,1,1
11184,165636,OLNUzQUHvlNsi2WFlH5eEyaieqKXrEz7,A3fsA9Zfv1X2fVEQhTw51lKENdNrEqT3,1,0,0,0,0,0,1,0,1,0.14285714285714285,1,0.0,0,0,0,0,0,0,0,1,0,0,1,1
11185,165640,GOWvSpqnQlbRYn3L1ovF5Dk4awbNrqjv,bWdj2GDclj5ofokWjzoa5jAwMkxCykd6,8,6,3,0,3,0,1,0,13,1.8571428571428572,1,0.0,0,3,0,3,6,0,0,1,0,6,7,1
11186,165648,45RDvtjbfAzQUYoMqYnUCNheNvdQTBQf,SpATywNh6bZuzm8s1ceuBUnMUAeoAHHw,1,0,0,0,0,0,1,0,1,0.14285714285714285,1,0.0,0,0,0,0,0,0,0,1,0,0,1,1
11187,165678,u5R8HPCpot8dC2SKEeIgSJg3TYEfNk6j,SpATywNh6bZuzm8s1ceuBUnMUAeoAHHw,5,2,1,0,1,0,2,0,6,0.8571428571428571,1,0.0,0,1,0,1,2,0,0,2,0,2,4,1
11188,165681,zZk0zQJxr08CnTp44rAPtrScPbsUq7U7,SpATywNh6bZuzm8s1ceuBUnMUAeoAHHw,7,5,3,0,1,0,6,0,15,2.142857142857143,2,0.0,0,3,0,1,5,0,0,6,0,4,11,0
11189,165689,WVNZbdoXW7KA02SSLbuMYRv36MSZshQF,SpATywNh6bZuzm8s1ceuBUnMUAeoAHHw,5,3,2,0,2,0,2,0,9,1.2857142857142858,1,0.0,0,2,0,2,3,0,0,2,0,4,5,1
11190,165692,VKQwP2UGxFr8cW02yW69JgEmp944MwNR,SpATywNh6bZuzm8s1ceuBUnMUAeoAHHw,12,13,8,0,5,0,2,0,28,4.0,2,0.0,2,8,0,5,11,0,0,2,0,15,13,0
11191,165693,h7XFnfSxsjydwMPLvMejh0cg5xL1ZDd5,SpATywNh6bZuzm8s1ceuBUnMUAeoAHHw,5,2,1,0,1,0,2,0,6,0.8571428571428571,1,0.0,0,1,0,1,2,0,0,2,0,2,4,1
11192,165694,oNStIislotbuK2XCCskaFe8CInb3EbrY,SpATywNh6bZuzm8s1ceuBUnMUAeoAHHw,4,2,0,0,0,0,2,0,4,0.5714285714285714,1,0.0,0,0,0,0,2,0,0,2,0,0,4,1
11193,165697,0gS5Q732yxgOQo1BReYmVwLNG0PEmJtw,RXDvfPUBYFlVdlueBFbLW0mhhAyGEqpt,1,0,0,0,0,0,2,0,2,0.2857142857142857,1,0.0,0,0,0,0,0,0,0,2,0,0,2,1
11194,165703,9gwK2SMO9RzFmbR3NVs20xNig2HGOi8l,SpATywNh6bZuzm8s1ceuBUnMUAeoAHHw,16,21,7,18,4,0,3,0,53,7.571428571428571,2,0.0,11,7,14,4,10,0,4,3,0,36,17,1
11195,165705,jFvQpyb1OqXqTZx0rW1xHWEtpgyxk2Lr,A3fsA9Zfv1X2fVEQhTw51lKENdNrEqT3,1,0,0,0,0,0,1,0,1,0.14285714285714285,1,0.0,0,0,0,0,0,0,0,1,0,0,1,1
11196,165707,XOhs3C3hEbYCXLCkazKW0gKNbUWn1jg2,G8EPVSXsOYB5YQWZGiz1aVq5Pgr2GrQu,1,0,0,0,0,0,1,0,1,0.14285714285714285,1,0.0,0,0,0,0,0,0,0,1,0,0,1,1
11197,165710,ZSl6vjDvuQwmk9tpCIu9AiiDVVFMdktp,bWdj2GDclj5ofokWjzoa5jAwMkxCykd6,3,2,1,0,0,0,2,0,5,0.7142857142857143,2,0.0,0,1,0,0,2,0,0,2,0,1,4,1
11198,165713,0beqYHGnxE1kTUwjVs54066oNfD5qFpw,A3fsA9Zfv1X2fVEQhTw51lKENdNrEqT3,4,3,1,0,1,0,1,0,6,0.8571428571428571,1,0.0,0,1,0,1,3,0,0,1,0,2,4,1
11199,165723,M2gu56p2gwP0LePGc68gh6Y3xSriA9x3,A3fsA9Zfv1X2fVEQhTw51lKENdNrEqT3,2,2,0,0,0,0,0,0,2,0.2857142857142857,1,0.0,0,0,0,0,2,0,0,0,0,0,2,1
11200,165738,rHhFTy1MHghalNQn9kKgxeI72dfIAI1Z,SpATywNh6bZuzm8s1ceuBUnMUAeoAHHw,2,0,0,0,0,0,2,0,2,0.2857142857142857,1,0.0,0,0,0,0,0,0,0,2,0,0,2,0
11201,165748,GrUpT0uWeNhnYmy4WRpw1EFafAAAhhi9,SpATywNh6bZuzm8s1ceuBUnMUAeoAHHw,22,39,0,31,1,10,9,0,90,12.857142857142858,2,0.0,10,0,31,1,29,10,0,9,0,42,48,0
11202,165758,BqlRpJCqwZj92xSZouRWh3sD1AZZKBEX,G8EPVSXsOYB5YQWZGiz1aVq5Pgr2GrQu,1,0,0,0,0,0,1,0,1,0.14285714285714285,1,0.0,0,0,0,0,0,0,0,1,0,0,1,1
11203,165760,zfQZFTiqHKQUgpAItjpYn7ZjkbIcP825,G8EPVSXsOYB5YQWZGiz1aVq5Pgr2GrQu,10,6,4,4,2,0,10,0,26,3.7142857142857144,2,0.0,0,4,3,2,6,0,1,10,0,9,17,1
11204,165762,6WkOKMKB5P2APoB7vbWWLXwAR3emifoG,A3fsA9Zfv1X2fVEQhTw51lKENdNrEqT3,44,36,24,68,12,0,7,0,147,21.0,3,0.0,6,24,58,12,30,0,10,7,0,100,47,1
11205,165763,ON4mKUtTdsRS7Qi2xUjPqd2ovm0Dg75e,SpATywNh6bZuzm8s1ceuBUnMUAeoAHHw,9,11,5,6,0,1,4,0,27,3.857142857142857,2,0.0,1,5,5,0,10,1,1,4,0,11,16,1
11206,165768,hbzbE3YW3TFJZGn3KQWHVTTu9qGbrE8v,A3fsA9Zfv1X2fVEQhTw51lKENdNrEqT3,2,0,0,0,0,0,2,0,2,0.2857142857142857,1,0.0,0,0,0,0,0,0,0,2,0,0,2,1
11207,165781,hyGNNqxhAyFxbHW9ng6YRyMeUCWAgj0x,A3fsA9Zfv1X2fVEQhTw51lKENdNrEqT3,3,2,0,0,0,0,1,0,3,0.42857142857142855,1,0.0,0,0,0,0,2,0,0,1,0,0,3,0
11208,165785,rh0SgumcqbNnCp7Kv0VptrPMVPtrWDm8,A3fsA9Zfv1X2fVEQhTw51lKENdNrEqT3,7,8,2,0,1,0,4,0,15,2.142857142857143,1,0.0,2,2,0,1,6,0,0,4,0,5,10,1
11209,165793,NKdzAvohqx5ZB0phtZyAtuBxXKa68OBU,SpATywNh6bZuzm8s1ceuBUnMUAeoAHHw,8,8,0,0,0,0,4,0,12,1.7142857142857142,2,0.0,0,0,0,0,8,0,0,4,0,0,12,1
11210,165799,tWEnJYIhXMJ03Foo959mubaAJUHZPTw0,RXDvfPUBYFlVdlueBFbLW0mhhAyGEqpt,1,0,0,0,0,0,2,0,2,0.2857142857142857,2,0.0,0,0,0,0,0,0,0,2,0,0,2,1
11211,165814,0vxIliccHyPsFqS3FXAcl5CXDHX5ju89,SpATywNh6bZuzm8s1ceuBUnMUAeoAHHw,1,0,0,0,0,0,1,0,1,0.14285714285714285,1,0.0,0,0,0,0,0,0,0,1,0,0,1,1
11212,165819,RgSsBQ3nqtDrfLpSobr2YuUHRErLTR4s,RXDvfPUBYFlVdlueBFbLW0mhhAyGEqpt,11,7,6,0,5,0,1,0,19,2.7142857142857144,1,0.0,0,6,0,5,7,0,0,1,0,11,8,1
11213,165820,wcSIko8HPcmbs4cOPlImi3EyazICOLlR,A3fsA9Zfv1X2fVEQhTw51lKENdNrEqT3,1,0,0,0,0,0,2,0,2,0.2857142857142857,1,0.0,0,0,0,0,0,0,0,2,0,0,2,1
11214,165925,rPvLSBoy5Xxf5EmxbjvWGnOcsq8vXrWM,fbPkOYLVPtPgIt0MxizjfFJov3JbHyAi,7,2,1,0,1,0,4,1,9,1.2857142857142858,1,0.0,0,1,0,1,2,0,0,4,1,2,7,1
11215,165926,904Wr172N0WscSeMXJsTOyh1uuS7vDSG,fbPkOYLVPtPgIt0MxizjfFJov3JbHyAi,18,29,1,22,3,20,26,3,104,14.857142857142858,2,0.0,10,1,15,3,19,20,7,26,3,29,75,1
11216,165927,I527mLJhEnsnDN6Y7GHh8lgX5gYIWWow,fbPkOYLVPtPgIt0MxizjfFJov3JbHyAi,5,2,1,0,1,0,2,0,6,0.8571428571428571,1,0.0,0,1,0,1,2,0,0,2,0,2,4,1
11217,165928,KxL8nW6SNMH0yE9CjF6IkKPffZ4Ij1gU,fbPkOYLVPtPgIt0MxizjfFJov3JbHyAi,1,0,0,0,0,0,1,0,1,0.14285714285714285,1,0.0,0,0,0,0,0,0,0,1,0,0,1,1
11218,165930,W3Xzt3Uf7lx9itZ3S5DNN9hHwJZa9KRt,fbPkOYLVPtPgIt0MxizjfFJov3JbHyAi,7,3,2,0,2,0,3,0,10,1.4285714285714286,1,0.0,0,2,0,2,3,0,0,3,0,4,6,1
11219,165931,gS1462mjlX01iqp5mKCqQb48nCyM3t3B,fbPkOYLVPtPgIt0MxizjfFJov3JbHyAi,2,0,0,0,0,0,4,0,4,0.5714285714285714,1,0.0,0,0,0,0,0,0,0,4,0,0,4,1
11220,165934,b7To0QTiTYgZuoVzyuSEPS7F21SjVad4,fbPkOYLVPtPgIt0MxizjfFJov3JbHyAi,1,0,0,0,0,0,1,0,1,0.14285714285714285,1,0.0,0,0,0,0,0,0,0,1,0,0,1,1
11221,165939,ZNl8B1FHwYbYTfFDFqmJVkUQSDcZskKg,fbPkOYLVPtPgIt0MxizjfFJov3JbHyAi,9,9,6,0,3,0,6,0,24,3.4285714285714284,1,0.0,0,6,0,3,9,0,0,6,0,9,15,1
11222,165942,XGHgNQW6UqpJ7yEgcu0NHkLF9rVPokqB,fbPkOYLVPtPgIt0MxizjfFJov3JbHyAi,5,2,1,0,1,0,2,0,6,0.8571428571428571,1,0.0,0,1,0,1,2,0,0,2,0,2,4,1
11223,165943,a3LnV0Oo3dtcjCRZGppIsWuGj51V5eh2,fbPkOYLVPtPgIt0MxizjfFJov3JbHyAi,1,0,0,0,0,0,1,0,1,0.14285714285714285,1,0.0,0,0,0,0,0,0,0,1,0,0,1,1
11224,165944,6sTapLZsQ6AY8DHIM1OkTraivy1QDm3b,fbPkOYLVPtPgIt0MxizjfFJov3JbHyAi,11,7,6,0,6,0,2,0,21,3.0,1,0.0,0,6,0,6,7,0,0,2,0,12,9,1
11225,165947,PUhxV7BpYunwLMY1Fopzcxx9OAbpHDbj,fbPkOYLVPtPgIt0MxizjfFJov3JbHyAi,5,2,1,0,1,0,3,0,7,1.0,1,0.0,0,1,0,1,2,0,0,3,0,2,5,1
11226,165949,8WeCoc3LtA2zjcaZdCNg8zvUfjT2Msxf,fbPkOYLVPtPgIt0MxizjfFJov3JbHyAi,1,0,0,0,0,0,1,0,1,0.14285714285714285,1,0.0,0,0,0,0,0,0,0,1,0,0,1,1
11227,165951,P1bfM85NxrtE5GDV4Jjq3FQWhmzLv4fy,fbPkOYLVPtPgIt0MxizjfFJov3JbHyAi,1,0,0,0,0,0,1,0,1,0.14285714285714285,1,0.0,0,0,0,0,0,0,0,1,0,0,1,1
11228,165954,uFdzPnm0JPIeUpj3xMTZBNmEB1ozRTVJ,fbPkOYLVPtPgIt0MxizjfFJov3JbHyAi,5,2,1,0,1,0,2,0,6,0.8571428571428571,1,0.0,0,1,0,1,2,0,0,2,0,2,4,1
11229,165955,FDszCioKrM3p5Ww8Z6KhIumuxTlgQRlZ,fbPkOYLVPtPgIt0MxizjfFJov3JbHyAi,11,17,10,0,7,4,10,1,49,7.0,1,0.0,3,10,0,7,14,4,0,10,1,20,29,1
11230,165956,S1v43tmmk9czADWjyf7UYULOIOI7xfyL,fbPkOYLVPtPgIt0MxizjfFJov3JbHyAi,8,5,3,0,2,0,12,0,22,3.142857142857143,2,0.0,0,3,0,2,5,0,0,12,0,5,17,1
11231,165957,p45WUPIH3G1AOOJwU2wuCfHKdtB0xm6o,fbPkOYLVPtPgIt0MxizjfFJov3JbHyAi,8,2,1,0,1,2,5,1,12,1.7142857142857142,1,0.0,0,1,0,1,2,2,0,5,1,2,10,1
11232,165958,8SNKPwETcHAWtjYz28VSsqsWvRN9FLFQ,fbPkOYLVPtPgIt0MxizjfFJov3JbHyAi,1,0,0,0,0,0,1,0,1,0.14285714285714285,1,0.0,0,0,0,0,0,0,0,1,0,0,1,1
11233,165961,u889jcGO7u4YLeZfY23r5rctOxqBf6PA,fbPkOYLVPtPgIt0MxizjfFJov3JbHyAi,1,0,0,0,0,0,1,0,1,0.14285714285714285,1,0.0,0,0,0,0,0,0,0,1,0,0,1,1
11234,165963,HagPPbBJUvEmCdoqrDllEDEMmLNeq2iZ,fbPkOYLVPtPgIt0MxizjfFJov3JbHyAi,9,4,3,0,2,0,5,0,14,2.0,1,0.0,0,3,0,2,4,0,0,5,0,5,9,1
11235,165964,fR1Af80YYdXTiASRMfpJrGeUuotptcVr,fbPkOYLVPtPgIt0MxizjfFJov3JbHyAi,6,4,2,0,1,0,4,0,11,1.5714285714285714,1,0.0,0,2,0,1,4,0,0,4,0,3,8,1
11236,165965,Ni1JLdqzOxkLUpUAAhMXu8rPflxVDz5x,fbPkOYLVPtPgIt0MxizjfFJov3JbHyAi,1,0,0,0,0,0,1,0,1,0.14285714285714285,1,0.0,0,0,0,0,0,0,0,1,0,0,1,1
11237,165967,wDiJr7mYUlLmlRXPgZ91Gun6O95gTskL,fbPkOYLVPtPgIt0MxizjfFJov3JbHyAi,2,0,0,0,0,0,4,0,4,0.5714285714285714,1,0.0,0,0,0,0,0,0,0,4,0,0,4,1
11238,165969,spNi8Q5WiDgxakh0uckmQbexani6DCOh,fbPkOYLVPtPgIt0MxizjfFJov3JbHyAi,2,0,0,0,0,0,2,0,2,0.2857142857142857,1,0.0,0,0,0,0,0,0,0,2,0,0,2,0
11239,165970,iwWfjFQpV0JEdS2sLknknEHjLyTBDPKw,fbPkOYLVPtPgIt0MxizjfFJov3JbHyAi,9,5,2,0,2,1,4,1,15,2.142857142857143,1,0.0,2,2,0,2,3,1,0,4,1,6,9,1
11240,165974,hCvYtvOSJvPXrRc5VlUnEsp4YsplFn8e,fbPkOYLVPtPgIt0MxizjfFJov3JbHyAi,1,0,0,0,0,0,1,0,1,0.14285714285714285,1,0.0,0,0,0,0,0,0,0,1,0,0,1,1
11241,165975,qPpO6ViDO8p9Brl7zj83O8kE30x6kZ9T,fbPkOYLVPtPgIt0MxizjfFJov3JbHyAi,6,3,0,0,0,0,4,2,9,1.2857142857142858,1,0.0,0,0,0,0,3,0,0,4,2,0,9,1
11242,165976,5y3Cd3dGN1d00I5lwTujgeZECpSTe7zr,fbPkOYLVPtPgIt0MxizjfFJov3JbHyAi,1,0,0,0,0,0,1,0,1,0.14285714285714285,1,0.0,0,0,0,0,0,0,0,1,0,0,1,1
11243,165977,37ndc95rjuQyww4myZAV2pRajSa1vaet,fbPkOYLVPtPgIt0MxizjfFJov3JbHyAi,6,5,1,0,1,0,2,0,9,1.2857142857142858,1,0.0,0,1,0,1,5,0,0,2,0,2,7,1
11244,165978,0seZo711Nu6ZHdbNw0yAvl5v1wAAFkoU,fbPkOYLVPtPgIt0MxizjfFJov3JbHyAi,7,7,1,0,1,1,2,0,12,1.7142857142857142,1,0.0,0,1,0,1,7,1,0,2,0,2,10,1
11245,165979,1uzmYtVGAWS7t6COUTYsC7mZnu6avern,fbPkOYLVPtPgIt0MxizjfFJov3JbHyAi,5,2,1,0,1,0,2,0,6,0.8571428571428571,1,0.0,0,1,0,1,2,0,0,2,0,2,4,1
11246,165982,8EUQcb1E8DABiNIX80rEHPv9Sif56saE,fbPkOYLVPtPgIt0MxizjfFJov3JbHyAi,1,0,0,0,0,0,1,0,1,0.14285714285714285,1,0.0,0,0,0,0,0,0,0,1,0,0,1,1
11247,165983,h0jqPvJTofkhvn5R8iQDcsLGVojVRAC5,fbPkOYLVPtPgIt0MxizjfFJov3JbHyAi,8,4,3,0,3,0,1,0,11,1.5714285714285714,1,0.0,0,3,0,3,4,0,0,1,0,6,5,1
11248,165986,vUR2Rb4rC27WC9JMCKdgkNsSu9OE2g4Q,fbPkOYLVPtPgIt0MxizjfFJov3JbHyAi,8,6,4,0,3,0,3,0,16,2.2857142857142856,1,0.0,0,4,0,3,6,0,0,3,0,7,9,1
11249,165987,Z9EzO8SxShTXDAFqt77CSsGSze2gBnhK,fbPkOYLVPtPgIt0MxizjfFJov3JbHyAi,5,2,0,0,1,0,2,0,5,0.7142857142857143,1,0.0,0,0,0,1,2,0,0,2,0,1,4,1
11250,165990,ALLdRiupr5XE7F2FwbjCFY7Qd3WjBiQd,fbPkOYLVPtPgIt0MxizjfFJov3JbHyAi,10,3,2,0,2,1,6,2,16,2.2857142857142856,1,0.0,0,2,0,2,3,1,0,6,2,4,12,1
11251,165991,kr4lZ3nLoz0aX6j9TExEEntiFfGYyCjd,fbPkOYLVPtPgIt0MxizjfFJov3JbHyAi,1,0,0,0,0,0,1,0,1,0.14285714285714285,1,0.0,0,0,0,0,0,0,0,1,0,0,1,1
11252,165997,EGFrdPbQlZ45sFe1ldxnO4L7OBI2JHpu,fbPkOYLVPtPgIt0MxizjfFJov3JbHyAi,1,0,0,0,0,0,1,0,1,0.14285714285714285,1,0.0,0,0,0,0,0,0,0,1,0,0,1,1
11253,165998,F9bdhIa6mSzXfjRuqNv5xPUxLFQQSQPN,fbPkOYLVPtPgIt0MxizjfFJov3JbHyAi,1,0,0,0,0,0,1,0,1,0.14285714285714285,1,0.0,0,0,0,0,0,0,0,1,0,0,1,1
11254,165999,hvRHXkr5ZlhMWU7A6w9HeJGvJ6CsaNfS,fbPkOYLVPtPgIt0MxizjfFJov3JbHyAi,5,5,2,0,2,0,2,0,11,1.5714285714285714,1,0.0,0,2,0,2,5,0,0,2,0,4,7,1
11255,166002,caJeHwBfKoz4X9ir6E77hAcZOUW1xE69,fbPkOYLVPtPgIt0MxizjfFJov3JbHyAi,11,7,4,0,2,3,9,1,26,3.7142857142857144,1,0.0,1,4,0,2,6,3,0,9,1,7,19,1
11256,166003,sUgRMzV2VHvt6HuQejcpp5Z8McRxUZjg,fbPkOYLVPtPgIt0MxizjfFJov3JbHyAi,1,0,0,0,0,0,1,0,1,0.14285714285714285,1,0.0,0,0,0,0,0,0,0,1,0,0,1,1
11257,166005,PGGGHjUA1ku4qHrXObJrJMvRvyQ4ONL0,fbPkOYLVPtPgIt0MxizjfFJov3JbHyAi,5,2,0,0,0,0,5,0,7,1.0,2,0.0,0,0,0,0,2,0,0,5,0,0,7,1
11258,166006,Nc7kINeTdCLSL76oJ5133gWG2CsY0W54,fbPkOYLVPtPgIt0MxizjfFJov3JbHyAi,2,0,0,0,0,0,3,0,3,0.42857142857142855,2,0.0,0,0,0,0,0,0,0,3,0,0,3,1
11259,166009,mXNyb3sDzfYTKd0Jgpoq0ZfQhY7qZUdq,fbPkOYLVPtPgIt0MxizjfFJov3JbHyAi,6,3,2,0,1,0,2,0,8,1.1428571428571428,1,0.0,0,2,0,1,3,0,0,2,0,3,5,1
11260,166012,e312Bg0txOy7uWpjDbFsC3TLW38EvbT4,fbPkOYLVPtPgIt0MxizjfFJov3JbHyAi,7,2,1,0,1,1,6,1,12,1.7142857142857142,1,0.0,0,1,0,1,2,1,0,6,1,2,10,1
11261,166013,FIkFMKcyvR9UWi0Myle8WGVGpGy1qcBD,fbPkOYLVPtPgIt0MxizjfFJov3JbHyAi,5,2,1,0,1,0,2,0,6,0.8571428571428571,1,0.0,0,1,0,1,2,0,0,2,0,2,4,1
11262,166014,g3902agYIRHzac78MKVZlvljLMXXNpQ7,fbPkOYLVPtPgIt0MxizjfFJov3JbHyAi,1,0,0,0,0,0,1,0,1,0.14285714285714285,1,0.0,0,0,0,0,0,0,0,1,0,0,1,1
11263,166015,FcnD0Ciq8TWyjGNFUvJIbmP6wTYBGqdt,fbPkOYLVPtPgIt0MxizjfFJov3JbHyAi,2,0,0,0,0,0,5,0,5,0.7142857142857143,1,0.0,0,0,0,0,0,0,0,5,0,0,5,1
11264,166018,uAiXtjZln558M2i3rYEEm2XkgYlhSfMT,fbPkOYLVPtPgIt0MxizjfFJov3JbHyAi,5,2,1,0,1,0,2,0,6,0.8571428571428571,1,0.0,0,1,0,1,2,0,0,2,0,2,4,1
11265,166019,OdutB2jwjn089D8EX2NAa3HnsFlikWQS,fbPkOYLVPtPgIt0MxizjfFJov3JbHyAi,6,3,2,0,2,0,1,0,8,1.1428571428571428,1,0.0,0,2,0,2,3,0,0,1,0,4,4,1
11266,166036,wCZGolOXIHC0m5ValHsltDi5uu5i6G63,fbPkOYLVPtPgIt0MxizjfFJov3JbHyAi,4,3,1,0,1,0,1,0,6,0.8571428571428571,1,0.0,0,1,0,1,3,0,0,1,0,2,4,1
11267,166037,wc8ABOXSHDqwIaE5k0JYlZP66W8tdlRo,fbPkOYLVPtPgIt0MxizjfFJov3JbHyAi,12,12,6,0,2,8,13,1,42,6.0,2,0.0,0,6,0,2,12,8,0,13,1,8,34,1
11268,166038,FFaLaJRa89FKW6pVYuJ3dXumxZUbwjZC,fbPkOYLVPtPgIt0MxizjfFJov3JbHyAi,1,0,0,0,0,0,1,0,1,0.14285714285714285,1,0.0,0,0,0,0,0,0,0,1,0,0,1,1
11269,166039,ESUjI9FMN0bUSmI9r3u304t5lebCsXMM,fbPkOYLVPtPgIt0MxizjfFJov3JbHyAi,6,2,1,0,0,1,5,1,10,1.4285714285714286,1,0.0,0,1,0,0,2,1,0,5,1,1,9,1
11270,166040,fcgIoTowNoXtysmcakqXD5rIrFDMOLMS,fbPkOYLVPtPgIt0MxizjfFJov3JbHyAi,4,2,1,0,1,0,1,0,5,0.7142857142857143,1,0.0,0,1,0,1,2,0,0,1,0,2,3,1
11271,166042,fTFCMd76UjKBUrosPwesoa2JcVylSbm0,fbPkOYLVPtPgIt0MxizjfFJov3JbHyAi,15,57,2,14,7,1,10,2,93,13.285714285714286,1,0.0,14,2,11,7,43,1,3,10,2,34,59,1
11272,166044,yImV3f0xQc91646kWaaTCoHPHfLcFyiE,fbPkOYLVPtPgIt0MxizjfFJov3JbHyAi,4,2,1,0,1,0,1,0,5,0.7142857142857143,1,0.0,0,1,0,1,2,0,0,1,0,2,3,1
11273,166045,fOR5X73Jlz0p1e9noRgVbo5kXcgdZJVO,fbPkOYLVPtPgIt0MxizjfFJov3JbHyAi,7,3,2,0,2,0,2,0,9,1.2857142857142858,1,0.0,0,2,0,2,3,0,0,2,0,4,5,1
11274,166047,vqP7fSXyXiWaT2K7Qf3eA0zXPxAvIBz4,fbPkOYLVPtPgIt0MxizjfFJov3JbHyAi,6,3,2,0,2,0,1,0,8,1.1428571428571428,1,0.0,0,2,0,2,3,0,0,1,0,4,4,1
11275,166048,aih3bUgUWJe7LHDxPrKqUKv7M1PtyZMy,fbPkOYLVPtPgIt0MxizjfFJov3JbHyAi,7,3,2,0,2,0,2,0,9,1.2857142857142858,1,0.0,0,2,0,2,3,0,0,2,0,4,5,1
11276,166049,wDXghK2BIM2TBsqSOrjDvr9Ut4FXTmRS,fbPkOYLVPtPgIt0MxizjfFJov3JbHyAi,7,3,2,0,2,0,3,0,10,1.4285714285714286,1,0.0,0,2,0,2,3,0,0,3,0,4,6,1
11277,166053,DhiB4cJ1TCjmSH3ZWP9m0OqNyBdGeS5P,fbPkOYLVPtPgIt0MxizjfFJov3JbHyAi,3,0,0,0,0,1,2,0,3,0.42857142857142855,1,0.0,0,0,0,0,0,1,0,2,0,0,3,1
11278,166057,y23uUtZASm6un1sOo8Z3FtFtr7wmEBUC,fbPkOYLVPtPgIt0MxizjfFJov3JbHyAi,8,3,1,0,1,2,5,1,13,1.8571428571428572,1,0.0,0,1,0,1,3,2,0,5,1,2,11,1
11279,166058,u3Es5hUyjf5nk8KFgVLYAoNUWyPWxnEj,fbPkOYLVPtPgIt0MxizjfFJov3JbHyAi,6,7,4,0,2,0,6,0,19,2.7142857142857144,1,0.0,0,4,0,2,7,0,0,6,0,6,13,1
11280,166059,tDLUr7SnRwxXyYOlr1OOOB7neeYu2GfR,fbPkOYLVPtPgIt0MxizjfFJov3JbHyAi,2,0,0,0,0,0,3,0,3,0.42857142857142855,1,0.0,0,0,0,0,0,0,0,3,0,0,3,1
11281,166060,NcjYJr1XLJ9a71yX9v2oEtoXLbIWWmNa,fbPkOYLVPtPgIt0MxizjfFJov3JbHyAi,7,10,1,1,2,0,4,0,18,2.5714285714285716,1,0.0,4,1,1,2,6,0,0,4,0,8,10,1
11282,166062,RQ6jHOF0XaVCtNO9cGrCBZ0SdqPrnq0p,fbPkOYLVPtPgIt0MxizjfFJov3JbHyAi,5,2,1,0,1,0,2,0,6,0.8571428571428571,1,0.0,0,1,0,1,2,0,0,2,0,2,4,1
11283,166066,0nSJm9RR2EHSZbxafc9dMAvqeh04T45l,fbPkOYLVPtPgIt0MxizjfFJov3JbHyAi,18,10,9,0,8,0,2,0,29,4.142857142857143,1,0.0,0,9,0,8,10,0,0,2,0,17,12,1
11284,166071,wdYj6Nt0ckfUFBd2Af4u2WMsP126y1D7,fbPkOYLVPtPgIt0MxizjfFJov3JbHyAi,7,2,2,0,1,0,3,0,8,1.1428571428571428,1,0.0,0,2,0,1,2,0,0,3,0,3,5,1
11285,166072,xzTUXMkATDrzXhPVq5lWKfyqNyH6U4X9,fbPkOYLVPtPgIt0MxizjfFJov3JbHyAi,1,0,0,0,0,0,1,0,1,0.14285714285714285,1,0.0,0,0,0,0,0,0,0,1,0,0,1,1
11286,166074,Xy9hY2jzdaXdVDhVwpfMWrmwNRASq6RF,fbPkOYLVPtPgIt0MxizjfFJov3JbHyAi,7,3,2,0,2,0,3,0,10,1.4285714285714286,1,0.0,0,2,0,2,3,0,0,3,0,4,6,1
11287,166075,AeNkuMZiCOxqxMy4dCnuYLHaK5F326HO,fbPkOYLVPtPgIt0MxizjfFJov3JbHyAi,1,0,0,0,0,0,1,0,1,0.14285714285714285,1,0.0,0,0,0,0,0,0,0,1,0,0,1,1
11288,166098,FGCLu23qz5rUrelYuCtqPnMTqZtXAAMw,fbPkOYLVPtPgIt0MxizjfFJov3JbHyAi,1,0,0,0,0,0,2,0,2,0.2857142857142857,2,0.0,0,0,0,0,0,0,0,2,0,0,2,1
11289,166131,3qQdqfR3bXaxIIbbDNHql7PNKozwWJ0T,fbPkOYLVPtPgIt0MxizjfFJov3JbHyAi,7,5,2,0,2,0,2,0,11,1.5714285714285714,1,0.0,0,2,0,2,5,0,0,2,0,4,7,1
11290,166132,QH6lZrx6rTkTliuU8RlNmWQ26j8fabUH,fbPkOYLVPtPgIt0MxizjfFJov3JbHyAi,5,2,1,0,1,0,2,0,6,0.8571428571428571,1,0.0,0,1,0,1,2,0,0,2,0,2,4,1
11291,166133,IzageoSKsdXfc6SUEzsqUc9gQrqXXlhN,fbPkOYLVPtPgIt0MxizjfFJov3JbHyAi,18,34,16,25,15,6,10,2,108,15.428571428571429,1,0.0,13,16,21,15,21,6,4,10,2,65,43,1
11292,166134,M9r7XEg2B3D5ZR9GVCwEti8ZRWwHOp49,fbPkOYLVPtPgIt0MxizjfFJov3JbHyAi,1,0,0,0,0,0,1,0,1,0.14285714285714285,1,0.0,0,0,0,0,0,0,0,1,0,0,1,1
11293,166135,rH5NF332Zl0fvCKU7fDfkywLMxP5O2d8,fbPkOYLVPtPgIt0MxizjfFJov3JbHyAi,31,44,20,17,16,5,9,1,112,16.0,2,0.0,21,20,14,16,23,5,3,9,1,71,41,1
11294,166138,Rdvgrardg53H2oeCgmOt8vFxIUu5nogb,fbPkOYLVPtPgIt0MxizjfFJov3JbHyAi,11,10,5,4,4,0,2,0,25,3.5714285714285716,1,0.0,2,5,3,4,8,0,1,2,0,14,11,1
11295,166139,D8yJX6fJMCIpExk8o6FLH29T9XoXppFE,fbPkOYLVPtPgIt0MxizjfFJov3JbHyAi,3,0,0,0,0,0,3,0,3,0.42857142857142855,1,0.0,0,0,0,0,0,0,0,3,0,0,3,1
11296,166140,uM0mO72xR8FGxE8Qbk3uLYE3hJhpQzfR,fbPkOYLVPtPgIt0MxizjfFJov3JbHyAi,12,8,4,8,4,0,5,0,29,4.142857142857143,1,0.0,2,4,6,4,6,0,2,5,0,16,13,1
11297,166141,5onphScHMomc2vbgBcVESDnXfbNkWfY9,fbPkOYLVPtPgIt0MxizjfFJov3JbHyAi,1,0,0,0,0,0,1,0,1,0.14285714285714285,1,0.0,0,0,0,0,0,0,0,1,0,0,1,1
11298,166142,PsafF2SVukKJJLRMVxFeBBFQRkjLQ2oJ,fbPkOYLVPtPgIt0MxizjfFJov3JbHyAi,1,0,0,0,0,0,2,0,2,0.2857142857142857,1,0.0,0,0,0,0,0,0,0,2,0,0,2,1
11299,166143,Dc0PKVAv0QU3JBz2nVIWZwdXyqJ69QN3,fbPkOYLVPtPgIt0MxizjfFJov3JbHyAi,2,0,0,0,0,0,4,0,4,0.5714285714285714,1,0.0,0,0,0,0,0,0,0,4,0,0,4,1
11300,166144,aNJE1B7Om5LHj59YkXIa7Cp0ZqypQHhy,fbPkOYLVPtPgIt0MxizjfFJov3JbHyAi,1,0,0,0,0,0,1,0,1,0.14285714285714285,1,0.0,0,0,0,0,0,0,0,1,0,0,1,1
11301,166150,jEHens5h7cgKFnZtp09sIGIhAFBD7Jkg,fbPkOYLVPtPgIt0MxizjfFJov3JbHyAi,7,7,0,0,0,0,6,0,13,1.8571428571428572,1,0.0,0,0,0,0,7,0,0,6,0,0,13,1
11302,166151,BfWyYyUZnv5SdLMFrh8TGsAFKZNgKNeG,fbPkOYLVPtPgIt0MxizjfFJov3JbHyAi,8,5,4,0,3,0,5,0,17,2.4285714285714284,1,0.0,0,4,0,3,5,0,0,5,0,7,10,1
11303,166152,FXa0AcfgcW9wGv6x58fnAsUuMIzAEhoi,fbPkOYLVPtPgIt0MxizjfFJov3JbHyAi,9,9,4,0,3,0,4,0,20,2.857142857142857,1,0.0,0,4,0,3,9,0,0,4,0,7,13,1
11304,166159,9k6LwDB3o9YdtwgjHMlgmEiFhRXLRRJ9,fbPkOYLVPtPgIt0MxizjfFJov3JbHyAi,6,2,1,0,1,0,3,0,7,1.0,1,0.0,0,1,0,1,2,0,0,3,0,2,5,1
11305,166161,30rq8lRkOZXWqMCfPyVsaAPbaaM041Av,fbPkOYLVPtPgIt0MxizjfFJov3JbHyAi,11,9,6,0,4,17,9,3,48,6.857142857142857,1,0.0,0,6,0,4,9,17,0,9,3,10,38,1
11306,166162,NJgJq3P8IUUdiKHxAPOJ9vpHV39AmbrT,fbPkOYLVPtPgIt0MxizjfFJov3JbHyAi,10,7,4,0,3,0,8,0,22,3.142857142857143,1,0.0,0,4,0,3,7,0,0,8,0,7,15,1
11307,166165,4G4kKKQKhb6jz9KfkGMaSkBm1b7Ng8Fb,fbPkOYLVPtPgIt0MxizjfFJov3JbHyAi,9,6,4,0,3,1,8,4,26,3.7142857142857144,1,0.0,0,4,0,3,6,1,0,8,4,7,19,1
11308,166166,jUkfka13Wwz7qRRzZH3uNtDuXxBE9Awx,fbPkOYLVPtPgIt0MxizjfFJov3JbHyAi,9,4,2,0,1,1,7,1,16,2.2857142857142856,1,0.0,0,2,0,1,4,1,0,7,1,3,13,1
11309,166167,APZilLYYSE3pgnSCxo2zN4jsnzixmfIm,fbPkOYLVPtPgIt0MxizjfFJov3JbHyAi,8,13,4,0,2,0,4,0,23,3.2857142857142856,2,0.0,0,4,0,2,13,0,0,4,0,6,17,1
11310,166169,XR3klDTIaDghb3t3EKC7lItRK7pmZtK2,fbPkOYLVPtPgIt0MxizjfFJov3JbHyAi,5,2,1,0,1,0,2,0,6,0.8571428571428571,1,0.0,0,1,0,1,2,0,0,2,0,2,4,1
11311,166171,hTJ6uBnBZrjcmQsSdLFl27Z53HcqXPhu,fbPkOYLVPtPgIt0MxizjfFJov3JbHyAi,5,3,2,0,0,0,2,0,7,1.0,1,0.0,0,2,0,0,3,0,0,2,0,2,5,1
11312,166172,7APFlbQcu9slKLT1djMsjN8yfRoP5SXu,fbPkOYLVPtPgIt0MxizjfFJov3JbHyAi,5,2,1,0,1,0,4,0,8,1.1428571428571428,1,0.0,0,1,0,1,2,0,0,4,0,2,6,1
11313,166173,D7q0MzB6OQnySW7fFe0PsdLrln5h0cWD,fbPkOYLVPtPgIt0MxizjfFJov3JbHyAi,2,0,0,0,0,0,4,0,4,0.5714285714285714,1,0.0,0,0,0,0,0,0,0,4,0,0,4,1
11314,166174,PcwkLBV8GqMq4LN5muiU92scrdGQ7V6h,fbPkOYLVPtPgIt0MxizjfFJov3JbHyAi,7,3,1,0,1,3,6,0,14,2.0,1,0.0,0,1,0,1,3,3,0,6,0,2,12,1
11315,166176,4qYb0mwN1QXf1hE7gaSGAEjSfScRbt40,fbPkOYLVPtPgIt0MxizjfFJov3JbHyAi,1,0,0,0,0,0,1,0,1,0.14285714285714285,1,0.0,0,0,0,0,0,0,0,1,0,0,1,1
11316,166178,pE4phvQUtMVk8HRczaNhPWPwQSM1R9mD,fbPkOYLVPtPgIt0MxizjfFJov3JbHyAi,1,0,0,0,0,0,1,0,1,0.14285714285714285,1,0.0,0,0,0,0,0,0,0,1,0,0,1,1
11317,166179,VskbKna85vnBg6NRvImzwmzgF97qcqNl,fbPkOYLVPtPgIt0MxizjfFJov3JbHyAi,1,0,0,0,0,0,1,0,1,0.14285714285714285,1,0.0,0,0,0,0,0,0,0,1,0,0,1,1
11318,166180,gx7Co0YFNqJP8BvMpO5sc6zAa3XLv4OC,fbPkOYLVPtPgIt0MxizjfFJov3JbHyAi,1,0,0,0,0,0,1,0,1,0.14285714285714285,1,0.0,0,0,0,0,0,0,0,1,0,0,1,1
11319,166181,WavpPVbOYUl8MN821vVFxD4UKy4r5Gk2,fbPkOYLVPtPgIt0MxizjfFJov3JbHyAi,9,10,6,0,4,0,5,0,25,3.5714285714285716,1,0.0,2,6,0,4,8,0,0,5,0,12,13,1
11320,166183,pYc3zOC10Ig1Wz1Rc4vkJqpNCY1sRttg,fbPkOYLVPtPgIt0MxizjfFJov3JbHyAi,1,0,0,0,0,0,1,0,1,0.14285714285714285,1,0.0,0,0,0,0,0,0,0,1,0,0,1,1
11321,166184,PCr9TFHQnY1v0mGiWpUIzzoDKl5BgvEm,fbPkOYLVPtPgIt0MxizjfFJov3JbHyAi,7,5,2,0,2,0,2,0,11,1.5714285714285714,1,0.0,0,2,0,2,5,0,0,2,0,4,7,1
11322,166185,0AOM3Xsog3TT6hti2vJTJuPdhrxxQzqx,fbPkOYLVPtPgIt0MxizjfFJov3JbHyAi,1,0,0,0,0,0,1,0,1,0.14285714285714285,1,0.0,0,0,0,0,0,0,0,1,0,0,1,1
11323,166190,m0ftathRLrGnJCnhmZSV8vDms8QzsQ7P,fbPkOYLVPtPgIt0MxizjfFJov3JbHyAi,41,30,15,41,12,0,3,0,101,14.428571428571429,2,0.0,12,15,33,12,18,0,8,3,0,72,29,1
11324,166191,LSYyQey0vUBbPFiPb4RkXPSgn5CNqwVT,fbPkOYLVPtPgIt0MxizjfFJov3JbHyAi,5,2,1,0,1,0,2,0,6,0.8571428571428571,1,0.0,0,1,0,1,2,0,0,2,0,2,4,1
11325,166192,4WOIlm8GAd1KWxkI5IGSFyO5T1vsPvxi,fbPkOYLVPtPgIt0MxizjfFJov3JbHyAi,6,5,1,0,1,0,2,0,9,1.2857142857142858,1,0.0,0,1,0,1,5,0,0,2,0,2,7,1
11326,166193,rTT3Jo5pfzKPV7jQyyGPjKpE7vCtTnIg,fbPkOYLVPtPgIt0MxizjfFJov3JbHyAi,6,3,1,0,1,0,2,0,7,1.0,1,0.0,0,1,0,1,3,0,0,2,0,2,5,1
11327,166195,zswbtSZTlApL8NcRWKlBizb4x3nFlj4t,fbPkOYLVPtPgIt0MxizjfFJov3JbHyAi,1,0,0,0,0,0,1,0,1,0.14285714285714285,1,0.0,0,0,0,0,0,0,0,1,0,0,1,1
11328,166196,ajmRO2ByCJVVIxORXq9TY2juCehadeoK,fbPkOYLVPtPgIt0MxizjfFJov3JbHyAi,1,0,0,0,0,0,1,0,1,0.14285714285714285,1,0.0,0,0,0,0,0,0,0,1,0,0,1,1
11329,166197,7cis0UjQRmYBnfx6HjOswg5edwgBgCpE,fbPkOYLVPtPgIt0MxizjfFJov3JbHyAi,1,0,0,0,0,0,1,0,1,0.14285714285714285,1,0.0,0,0,0,0,0,0,0,1,0,0,1,1
11330,166199,Z2csWIUYxogRjTAASMgDj8yUhj5wsQf6,fbPkOYLVPtPgIt0MxizjfFJov3JbHyAi,1,0,0,0,0,0,1,0,1,0.14285714285714285,1,0.0,0,0,0,0,0,0,0,1,0,0,1,1
11331,166200,oFHquhoEL97QZy2GgeAYH2i1t5qjNxiI,fbPkOYLVPtPgIt0MxizjfFJov3JbHyAi,1,0,0,0,0,0,1,0,1,0.14285714285714285,1,0.0,0,0,0,0,0,0,0,1,0,0,1,1
11332,166201,WdyV9xz939F7AYWm4x7LDb09zLG7KCGo,fbPkOYLVPtPgIt0MxizjfFJov3JbHyAi,5,0,0,0,0,1,4,0,5,0.7142857142857143,1,0.0,0,0,0,0,0,1,0,4,0,0,5,1
11333,166202,iRTkgYZLUCCMjEju8FAVkQmJQ4dxsVf6,fbPkOYLVPtPgIt0MxizjfFJov3JbHyAi,7,3,2,0,2,0,2,0,9,1.2857142857142858,1,0.0,0,2,0,2,3,0,0,2,0,4,5,1
11334,166205,wu2GU267aApPVHAuPTRg0Nigjmr9Z1gM,fbPkOYLVPtPgIt0MxizjfFJov3JbHyAi,5,2,0,0,0,0,3,0,5,0.7142857142857143,1,0.0,0,0,0,0,2,0,0,3,0,0,5,1
11335,166206,jHAeFRHIxhlq1VuAgQnHiSkHKEAGqDQQ,fbPkOYLVPtPgIt0MxizjfFJov3JbHyAi,1,0,0,0,0,0,1,0,1,0.14285714285714285,1,0.0,0,0,0,0,0,0,0,1,0,0,1,1
11336,166208,c5e9iH45YdJ4nzTDABvuqRhlji3DhWTZ,fbPkOYLVPtPgIt0MxizjfFJov3JbHyAi,1,0,0,0,0,0,1,0,1,0.14285714285714285,1,0.0,0,0,0,0,0,0,0,1,0,0,1,1
11337,166209,ZhQM1oVDGLY3PxKguad7zSF6itqVpVMw,fbPkOYLVPtPgIt0MxizjfFJov3JbHyAi,6,0,0,0,0,0,5,1,6,0.8571428571428571,1,0.0,0,0,0,0,0,0,0,5,1,0,6,1
11338,166211,535rqCxCBVvAkDc6bSBePBKNVyS23A04,fbPkOYLVPtPgIt0MxizjfFJov3JbHyAi,7,5,3,0,4,0,2,0,14,2.0,2,0.0,0,3,0,4,5,0,0,2,0,7,7,1
11339,166212,fvgTgMEEp9KwLpfVkpXX8oOhoWnoroKM,fbPkOYLVPtPgIt0MxizjfFJov3JbHyAi,4,2,1,0,0,0,2,0,5,0.7142857142857143,1,0.0,0,1,0,0,2,0,0,2,0,1,4,1
11340,166214,yDrPM411aoK4cy4pMUjRFGutYfIXnaY7,fbPkOYLVPtPgIt0MxizjfFJov3JbHyAi,9,4,3,0,3,0,2,0,12,1.7142857142857142,1,0.0,0,3,0,3,4,0,0,2,0,6,6,1
11341,166216,CYPNBoGwuLNGB9o6c5ymOZ8c1CNfYFkE,fbPkOYLVPtPgIt0MxizjfFJov3JbHyAi,5,2,1,0,1,1,4,0,9,1.2857142857142858,1,0.0,0,1,0,1,2,1,0,4,0,2,7,1
11342,166218,KFATKUNqDDFsPoUS8ZrDkYqpQpRP4f4L,fbPkOYLVPtPgIt0MxizjfFJov3JbHyAi,2,0,0,0,0,0,2,0,2,0.2857142857142857,1,0.0,0,0,0,0,0,0,0,2,0,0,2,1
11343,166219,pbVSIAGDAO8zkre7dnH0sTveAs2oHKDL,fbPkOYLVPtPgIt0MxizjfFJov3JbHyAi,5,3,2,0,0,1,2,0,8,1.1428571428571428,1,0.0,0,2,0,0,3,1,0,2,0,2,6,1
11344,166221,FCQ3GzlLjljyV0TB5O3VUpS5tYpT90fC,fbPkOYLVPtPgIt0MxizjfFJov3JbHyAi,1,0,0,0,0,0,1,0,1,0.14285714285714285,1,0.0,0,0,0,0,0,0,0,1,0,0,1,1
11345,166223,zn0OAApVYD2Uy6WJtu6WKbBPSOUAbiQP,fbPkOYLVPtPgIt0MxizjfFJov3JbHyAi,5,2,1,0,1,0,2,0,6,0.8571428571428571,1,0.0,0,1,0,1,2,0,0,2,0,2,4,1
11346,166224,VzrtRKXjnxu3j4Ng8zH1lMIMaH7VXugk,fbPkOYLVPtPgIt0MxizjfFJov3JbHyAi,11,8,5,0,3,9,9,2,36,5.142857142857143,1,0.0,0,5,0,3,8,9,0,9,2,8,28,1
11347,166226,Jc1XpiNQCchHcqFzVFHc90zIRXa0BSrx,fbPkOYLVPtPgIt0MxizjfFJov3JbHyAi,1,0,0,0,0,0,1,0,1,0.14285714285714285,1,0.0,0,0,0,0,0,0,0,1,0,0,1,1
11348,166228,lwLS4JZCmr2Z32OMnVpRrqT2jg66CVWM,fbPkOYLVPtPgIt0MxizjfFJov3JbHyAi,4,2,1,0,0,0,2,0,5,0.7142857142857143,1,0.0,0,1,0,0,2,0,0,2,0,1,4,1
11349,166234,cobl7A5HnM7LyfJMOxE7IO6H5ynMSZHE,fbPkOYLVPtPgIt0MxizjfFJov3JbHyAi,20,21,11,0,9,1,14,1,57,8.142857142857142,2,0.0,6,11,0,9,15,1,0,14,1,26,31,1
11350,166235,bZyPcrH7OrkATlDjIsQifL6bmPAhovyA,fbPkOYLVPtPgIt0MxizjfFJov3JbHyAi,1,0,0,0,0,0,1,0,1,0.14285714285714285,1,0.0,0,0,0,0,0,0,0,1,0,0,1,1
11351,166236,jZTOrC76oKbilWqOTQaLbKbRc8Z13tjL,fbPkOYLVPtPgIt0MxizjfFJov3JbHyAi,2,0,0,0,0,0,4,0,4,0.5714285714285714,1,0.0,0,0,0,0,0,0,0,4,0,0,4,1
11352,166238,K2ZkeKtW7K8uncjR7BZKciYiqiq9yWln,fbPkOYLVPtPgIt0MxizjfFJov3JbHyAi,1,0,0,0,0,0,1,0,1,0.14285714285714285,1,0.0,0,0,0,0,0,0,0,1,0,0,1,1
11353,166240,lGwFkUBS8Ax5ZfSjmM23Vm33yIAwYDi5,fbPkOYLVPtPgIt0MxizjfFJov3JbHyAi,3,0,0,0,0,0,4,0,4,0.5714285714285714,1,0.0,0,0,0,0,0,0,0,4,0,0,4,1
11354,166243,UO4mrSrrMyolBODgCqJnfueJEWhli7II,fbPkOYLVPtPgIt0MxizjfFJov3JbHyAi,1,0,0,0,0,0,2,0,2,0.2857142857142857,1,0.0,0,0,0,0,0,0,0,2,0,0,2,1
11355,166245,2jYgAHtB8HMROduTNzSC8WwjfYYRrdrW,fbPkOYLVPtPgIt0MxizjfFJov3JbHyAi,7,7,2,0,0,1,6,1,17,2.4285714285714284,1,0.0,0,2,0,0,7,1,0,6,1,2,15,1
11356,166246,DjTBWAUbIg70BCHJh9sAtqxHus5ltwy7,fbPkOYLVPtPgIt0MxizjfFJov3JbHyAi,7,2,1,0,1,1,5,0,10,1.4285714285714286,1,0.0,0,1,0,1,2,1,0,5,0,2,8,1
11357,166247,A0zXPJodVr0E8hKOlKGfpSvxe7QILd2e,fbPkOYLVPtPgIt0MxizjfFJov3JbHyAi,8,9,5,0,3,0,6,0,23,3.2857142857142856,1,0.0,0,5,0,3,9,0,0,6,0,8,15,1
11358,166248,RMepYbdXgEw3uPAlKurEbNiPXr5gNPWt,fbPkOYLVPtPgIt0MxizjfFJov3JbHyAi,10,10,4,0,5,0,2,0,21,3.0,1,0.0,2,4,0,5,8,0,0,2,0,11,10,1
11359,166249,4IRetwwONx8QH1sGkNwhu5Kz3lKUue7Z,fbPkOYLVPtPgIt0MxizjfFJov3JbHyAi,13,11,7,0,4,13,6,0,41,5.857142857142857,1,0.0,0,7,0,4,11,13,0,6,0,11,30,1
11360,166250,KlA2x8wP6TBpECd0ZN1eFvozBu7s4Isi,fbPkOYLVPtPgIt0MxizjfFJov3JbHyAi,7,3,2,0,2,0,2,0,9,1.2857142857142858,1,0.0,0,2,0,2,3,0,0,2,0,4,5,1
11361,166252,CA0MkNgNmIkfEXL0dnDRrevPXK8YBuup,fbPkOYLVPtPgIt0MxizjfFJov3JbHyAi,18,35,22,9,12,0,7,0,85,12.142857142857142,1,0.0,10,22,8,12,25,0,1,7,0,52,33,1
11362,166253,7IMXfuLxE8gGKFgkWFaN1RvRbpf1UO2y,fbPkOYLVPtPgIt0MxizjfFJov3JbHyAi,2,0,0,0,0,0,2,0,2,0.2857142857142857,1,0.0,0,0,0,0,0,0,0,2,0,0,2,1
11363,166255,kowHY6WB64zBwKrTN3ILoCz5UNyxhnFJ,fbPkOYLVPtPgIt0MxizjfFJov3JbHyAi,8,3,2,0,2,0,4,0,11,1.5714285714285714,1,0.0,0,2,0,2,3,0,0,4,0,4,7,1
11364,166257,wqiVx47rXEFqYvMIBdEO3TZz5x4INOeH,fbPkOYLVPtPgIt0MxizjfFJov3JbHyAi,1,0,0,0,0,0,2,0,2,0.2857142857142857,1,0.0,0,0,0,0,0,0,0,2,0,0,2,1
11365,166258,UOnQZubkkaxGovWrfoxkBtdZ1OIJQqVB,fbPkOYLVPtPgIt0MxizjfFJov3JbHyAi,10,6,3,0,2,1,5,1,18,2.5714285714285716,1,0.0,1,3,0,2,5,1,0,5,1,6,12,1
11366,166259,MnSTippsWfG9Oaeik7VL8PjJAAryn478,fbPkOYLVPtPgIt0MxizjfFJov3JbHyAi,1,0,0,0,0,0,1,0,1,0.14285714285714285,1,0.0,0,0,0,0,0,0,0,1,0,0,1,1
11367,166260,lgavhxj31ME1Vj5ukLJHRWTlXwDGQoVr,fbPkOYLVPtPgIt0MxizjfFJov3JbHyAi,5,3,1,0,1,0,5,0,10,1.4285714285714286,1,0.0,0,1,0,1,3,0,0,5,0,2,8,1
11368,166261,dVdgfUMBulFX4jVAvRAGPzBu21Uo5ky5,fbPkOYLVPtPgIt0MxizjfFJov3JbHyAi,2,0,0,0,0,0,2,0,2,0.2857142857142857,1,0.0,0,0,0,0,0,0,0,2,0,0,2,1
11369,166262,yKKt8zt4iB4hr1OVUIw42HenRNY3LaDc,fbPkOYLVPtPgIt0MxizjfFJov3JbHyAi,1,0,0,0,0,0,1,0,1,0.14285714285714285,1,0.0,0,0,0,0,0,0,0,1,0,0,1,1
11370,166263,9wJidXC6DsBSt4XJeGmG8tllGZ0Bh2yE,fbPkOYLVPtPgIt0MxizjfFJov3JbHyAi,5,0,0,0,0,1,5,1,7,1.0,1,0.0,0,0,0,0,0,1,0,5,1,0,7,1
11371,166264,h7D7NcJeqnvOSuVnZSj39Mgs0UPnBWOp,fbPkOYLVPtPgIt0MxizjfFJov3JbHyAi,11,19,9,0,6,3,9,1,47,6.714285714285714,1,0.0,2,9,0,6,17,3,0,9,1,17,30,1
11372,166267,2mlxTydWoLZJ5NQWesHHKUelrVUBGoHh,fbPkOYLVPtPgIt0MxizjfFJov3JbHyAi,6,4,2,0,2,0,2,0,10,1.4285714285714286,1,0.0,0,2,0,2,4,0,0,2,0,4,6,1
11373,166282,EUmZ5qzjwgko2PIWEnctkvYh7APnUrX9,SpATywNh6bZuzm8s1ceuBUnMUAeoAHHw,2,0,0,0,0,0,3,0,3,0.42857142857142855,1,0.0,0,0,0,0,0,0,0,3,0,0,3,1
11374,166304,cr6Tgf9hnYbWIgXq8hI7G8mwIYtkpuPn,SpATywNh6bZuzm8s1ceuBUnMUAeoAHHw,9,13,9,0,0,0,14,0,36,5.142857142857143,5,0.0,0,9,0,0,13,0,0,14,0,9,27,1
11375,166307,C1W6BmVEm6dSkmMKEomLuJgZ8sQ5WGlZ,SpATywNh6bZuzm8s1ceuBUnMUAeoAHHw,10,16,5,0,3,0,2,0,26,3.7142857142857144,2,0.0,4,5,0,3,12,0,0,2,0,12,14,1
11376,166334,O9GgLjRVV0VZ4XM2UvjBFBWJXBSS6aK0,SpATywNh6bZuzm8s1ceuBUnMUAeoAHHw,19,25,15,15,10,5,10,0,80,11.428571428571429,3,0.0,4,15,13,10,21,5,2,10,0,42,38,1
11377,166336,dy0MHAcBl717YgRGnv4iZjdkJ8Cv0Ubw,SpATywNh6bZuzm8s1ceuBUnMUAeoAHHw,5,2,1,0,1,0,2,0,6,0.8571428571428571,1,0.0,0,1,0,1,2,0,0,2,0,2,4,1
11378,166338,VGpsDdnTGsfrp3adgxkdRhxpkaNF7Bg2,SpATywNh6bZuzm8s1ceuBUnMUAeoAHHw,15,14,7,0,6,0,5,0,32,4.571428571428571,2,0.0,0,7,0,6,14,0,0,5,0,13,19,1
11379,166345,eBrNdoyiSxVd9fyLx3AqJC03wGlgXEr8,SpATywNh6bZuzm8s1ceuBUnMUAeoAHHw,2,0,0,0,0,0,2,0,2,0.2857142857142857,1,0.0,0,0,0,0,0,0,0,2,0,0,2,1
11380,166348,LdN96v488mT9MyrF8Dltq2COgz4qXNUV,SpATywNh6bZuzm8s1ceuBUnMUAeoAHHw,2,0,0,0,0,0,3,0,3,0.42857142857142855,1,0.0,0,0,0,0,0,0,0,3,0,0,3,1
11381,166382,aMWucSAl7KcOtmgcqhgckjtfv6QnsKKi,G8EPVSXsOYB5YQWZGiz1aVq5Pgr2GrQu,8,8,1,0,1,0,4,0,14,2.0,1,0.0,1,1,0,1,7,0,0,4,0,3,11,1
11382,166387,WO9GKA0lZwTMWZPNOUikUeUkOH5TeVRT,A3fsA9Zfv1X2fVEQhTw51lKENdNrEqT3,19,10,9,0,9,0,3,0,31,4.428571428571429,1,0.0,0,9,0,9,10,0,0,3,0,18,13,1
11383,166392,FR3djrgj8pkYcAIqYiRiT862Pvu77Ath,A3fsA9Zfv1X2fVEQhTw51lKENdNrEqT3,1,0,0,0,0,0,1,0,1,0.14285714285714285,1,0.0,0,0,0,0,0,0,0,1,0,0,1,1
11384,166398,KSpo19A6th76vdA61eFiN0BiY6Yi086y,bWdj2GDclj5ofokWjzoa5jAwMkxCykd6,6,2,1,0,1,0,4,0,8,1.1428571428571428,1,0.0,0,1,0,1,2,0,0,4,0,2,6,1
11385,166400,aJMNcTer76nTaYZZR58xtdmLr8BYq1Op,G8EPVSXsOYB5YQWZGiz1aVq5Pgr2GrQu,13,17,7,8,4,0,6,1,43,6.142857142857143,2,0.0,3,7,5,4,14,0,3,6,1,19,24,0
11386,166409,iIkBXne7Ob9Fgz6Oa5wXMKZwMdTiJR2o,SpATywNh6bZuzm8s1ceuBUnMUAeoAHHw,9,7,6,0,6,2,5,1,27,3.857142857142857,2,0.0,0,6,0,6,7,2,0,5,1,12,15,1
11387,166414,NkHKP7XmU89AhYrwGvkJ0gX5lfpDGkiJ,G8EPVSXsOYB5YQWZGiz1aVq5Pgr2GrQu,6,1,1,0,1,0,3,0,6,0.8571428571428571,1,0.0,0,1,0,1,1,0,0,3,0,2,4,1
11388,166445,yOLWJeEIp9ncdhH4y673tuFZt1rt1tLc,G8EPVSXsOYB5YQWZGiz1aVq5Pgr2GrQu,25,46,0,32,1,0,4,0,83,11.857142857142858,1,0.0,26,0,16,1,20,0,16,4,0,43,40,1
11389,166469,EpdHS9GR8oqIUKzHvPkVQRgoyyohb0m0,SpATywNh6bZuzm8s1ceuBUnMUAeoAHHw,3,2,1,0,0,0,1,0,4,0.5714285714285714,1,0.0,0,1,0,0,2,0,0,1,0,1,3,1
11390,166473,qMHt2pvEDzVNHM7ZHWzleDlEr3OuwQXq,SpATywNh6bZuzm8s1ceuBUnMUAeoAHHw,17,14,11,2,4,7,7,1,46,6.571428571428571,1,0.0,2,11,2,4,12,7,0,7,1,19,27,1
11391,166486,oGxuj25E6wfFXJnzkTIOBzgSMs7mphqX,SpATywNh6bZuzm8s1ceuBUnMUAeoAHHw,4,7,3,0,0,0,1,0,11,1.5714285714285714,1,0.0,3,3,0,0,4,0,0,1,0,6,5,1
11392,166495,YbJnM4aRUVyy4lj5U7KoiyOh79gNSdfq,A3fsA9Zfv1X2fVEQhTw51lKENdNrEqT3,9,5,4,0,4,0,2,0,15,2.142857142857143,2,0.0,0,4,0,4,5,0,0,2,0,8,7,1
11393,166507,lJQiDaJvMiupKv6v8L85WToj3Rei5ozq,SpATywNh6bZuzm8s1ceuBUnMUAeoAHHw,10,5,4,0,3,1,3,0,16,2.2857142857142856,1,0.0,0,4,0,3,5,1,0,3,0,7,9,1
11394,166508,8yNx2UHmvaqcPAlV7kUX1ya1n3dGGkKQ,SpATywNh6bZuzm8s1ceuBUnMUAeoAHHw,1,0,0,0,0,0,1,0,1,0.14285714285714285,1,0.0,0,0,0,0,0,0,0,1,0,0,1,1
11395,166523,QjfVyTofFZLLFWX1ehKLt5ilQSOSAPiY,G8EPVSXsOYB5YQWZGiz1aVq5Pgr2GrQu,24,19,12,22,9,0,4,1,67,9.571428571428571,1,0.0,0,12,19,9,19,0,3,4,1,40,27,1
11396,166543,5UIbCqH63Z5JY1aEquv4Lx7GZPK1n1Oz,RXDvfPUBYFlVdlueBFbLW0mhhAyGEqpt,1,0,0,0,0,0,1,0,1,0.14285714285714285,1,0.0,0,0,0,0,0,0,0,1,0,0,1,1
11397,166582,L3RDijFpI0BxbfI282CDkn8oc75EdrdD,SpATywNh6bZuzm8s1ceuBUnMUAeoAHHw,1,0,0,0,0,0,1,0,1,0.14285714285714285,1,0.0,0,0,0,0,0,0,0,1,0,0,1,1
11398,166584,EUmZ5qzjwgko2PIWEnctkvYh7APnUrX9,A3fsA9Zfv1X2fVEQhTw51lKENdNrEqT3,12,15,0,0,0,0,3,0,18,2.5714285714285716,1,0.0,0,0,0,0,15,0,0,3,0,0,18,1
11399,166631,XXGnjStFLZ9sx615YBVWt5w8zGA5PvJ7,SpATywNh6bZuzm8s1ceuBUnMUAeoAHHw,9,17,0,0,0,0,4,0,21,3.0,1,0.0,0,0,0,0,17,0,0,4,0,0,21,1
11400,166681,EQyfXomfeQ2aGwvJID8K9GdghyNxd6oh,bWdj2GDclj5ofokWjzoa5jAwMkxCykd6,14,27,12,60,6,1,6,0,112,16.0,2,0.0,6,12,59,6,21,1,1,6,0,83,29,1
11401,166691,Plovj3UdbSJXyESPLaHVaVRAVAVFjh4G,bWdj2GDclj5ofokWjzoa5jAwMkxCykd6,1,0,0,0,0,0,1,0,1,0.14285714285714285,1,0.0,0,0,0,0,0,0,0,1,0,0,1,1
11402,166751,ywzPrbVlDcrG4QIQVcquX0yb7l2KxUz1,SpATywNh6bZuzm8s1ceuBUnMUAeoAHHw,1,0,0,0,0,0,1,0,1,0.14285714285714285,1,0.0,0,0,0,0,0,0,0,1,0,0,1,1
11403,166755,e8Y4G90611rG6C14GJNj4shj65JVFISl,A3fsA9Zfv1X2fVEQhTw51lKENdNrEqT3,60,19,9,140,0,0,3,0,171,24.428571428571427,2,0.0,3,9,136,0,16,0,4,3,0,148,23,1
11404,166763,PtZQYu2omSISCEPobEkK00G9lPsFCpAH,SpATywNh6bZuzm8s1ceuBUnMUAeoAHHw,1,0,0,0,0,0,1,0,1,0.14285714285714285,1,0.0,0,0,0,0,0,0,0,1,0,0,1,1
11405,166767,CNzOzTxB6slz6reBTGQew76XrENqSZZu,A3fsA9Zfv1X2fVEQhTw51lKENdNrEqT3,6,6,0,0,0,0,5,0,11,1.5714285714285714,1,0.0,0,0,0,0,6,0,0,5,0,0,11,1
11406,166769,F5WXvUA8z1Vfdvlva1pujweut7tGE04r,bWdj2GDclj5ofokWjzoa5jAwMkxCykd6,5,0,0,0,0,2,4,1,7,1.0,1,0.0,0,0,0,0,0,2,0,4,1,0,7,1
11407,166778,AtDlkFSnWTgMt7xJ3PkbVdpoMvsEJuZd,SpATywNh6bZuzm8s1ceuBUnMUAeoAHHw,9,6,2,0,2,0,3,0,13,1.8571428571428572,2,0.0,0,2,0,2,6,0,0,3,0,4,9,1
11408,166787,35YnYP4Tkn7xvOTt0M51AeVR3m7l2sIt,SpATywNh6bZuzm8s1ceuBUnMUAeoAHHw,21,18,7,10,7,1,7,1,51,7.285714285714286,2,0.0,4,7,9,7,14,1,1,7,1,27,24,1
11409,166850,TeBMvAv5VyOBol7RYdEZZqCEFBEIGxYI,SpATywNh6bZuzm8s1ceuBUnMUAeoAHHw,8,4,3,0,3,0,1,0,11,1.5714285714285714,1,0.0,0,3,0,3,4,0,0,1,0,6,5,1
11410,166855,7EXxZBxaHj6q1B0SK4ceBEflKEmD8hvL,bWdj2GDclj5ofokWjzoa5jAwMkxCykd6,3,0,0,0,0,0,8,0,8,1.1428571428571428,2,0.0,0,0,0,0,0,0,0,8,0,0,8,1
11411,166860,oJHnnpnFBdflow5PBV5uje04XEG79lqu,A3fsA9Zfv1X2fVEQhTw51lKENdNrEqT3,10,4,0,0,0,1,16,1,22,3.142857142857143,3,0.0,0,0,0,0,4,1,0,16,1,0,22,0
11412,166873,PDNsiMyTk72mYrcSTgVVhe2c68BJ17Ar,bWdj2GDclj5ofokWjzoa5jAwMkxCykd6,20,16,10,0,8,0,11,1,46,6.571428571428571,1,0.0,2,10,0,8,14,0,0,11,1,20,26,1
11413,166928,my33FPQMSZttKqR0p8zRP2Bz5eCFTYNb,bWdj2GDclj5ofokWjzoa5jAwMkxCykd6,16,21,4,6,4,1,15,0,51,7.285714285714286,3,0.0,3,4,6,4,18,1,0,15,0,17,34,1
11414,166942,4kvP66ucXESl9aXSUioaBWcuWa5i6uFa,SpATywNh6bZuzm8s1ceuBUnMUAeoAHHw,1,0,0,0,0,0,1,0,1,0.14285714285714285,1,0.0,0,0,0,0,0,0,0,1,0,0,1,1
11415,166981,KoUza1X6kek4yLxwsTzshNuuseZEHFu6,bWdj2GDclj5ofokWjzoa5jAwMkxCykd6,1,0,0,0,0,0,1,0,1,0.14285714285714285,1,0.0,0,0,0,0,0,0,0,1,0,0,1,1
11416,166987,49oypRKmbhsESvRt5ynYhyueQezYQsCQ,A3fsA9Zfv1X2fVEQhTw51lKENdNrEqT3,1,0,0,0,0,0,1,0,1,0.14285714285714285,1,0.0,0,0,0,0,0,0,0,1,0,0,1,1
11417,166991,H1TM0tfwQGan808kaqC5vLvGV8fCUgtO,SpATywNh6bZuzm8s1ceuBUnMUAeoAHHw,13,8,6,0,3,3,7,1,28,4.0,1,0.0,0,6,0,3,8,3,0,7,1,9,19,1
11418,167005,NLhSHOlvNcAzXTnIuTXBlyWdelKO6Po8,SpATywNh6bZuzm8s1ceuBUnMUAeoAHHw,1,0,0,0,0,0,1,0,1,0.14285714285714285,1,0.0,0,0,0,0,0,0,0,1,0,0,1,1
11419,167006,Sn4V2T6RAiQ47UvRCtMkFCdxnmF36LZI,G8EPVSXsOYB5YQWZGiz1aVq5Pgr2GrQu,4,4,2,0,2,0,1,0,9,1.2857142857142858,1,0.0,1,2,0,2,3,0,0,1,0,5,4,0
11420,167012,6x1ORFJhWxzWx07uL4IvCItSXSuL8CVc,G8EPVSXsOYB5YQWZGiz1aVq5Pgr2GrQu,6,3,1,0,1,0,2,0,7,1.0,1,0.0,0,1,0,1,3,0,0,2,0,2,5,1
11421,167024,lSXJXGWdv2XbDDcmfVzMwBcHxgsJFtm2,SpATywNh6bZuzm8s1ceuBUnMUAeoAHHw,1,0,0,0,0,0,1,0,1,0.14285714285714285,1,0.0,0,0,0,0,0,0,0,1,0,0,1,1
11422,167032,xMKGcYeHMuhMu436Dx8qNr2iLxqOhlEy,SpATywNh6bZuzm8s1ceuBUnMUAeoAHHw,10,6,4,2,3,0,1,0,16,2.2857142857142856,1,0.0,1,4,2,3,5,0,0,1,0,10,6,1
11423,167038,C3LGGw6vM3GlX5Dw8258DOqpO1L1iYv7,A3fsA9Zfv1X2fVEQhTw51lKENdNrEqT3,15,17,8,0,3,1,10,2,41,5.857142857142857,1,0.0,0,8,0,3,17,1,0,10,2,11,30,0
11424,167045,CNckAsfMKSEbkBf2UCjHJpPoGTdJKeyS,SpATywNh6bZuzm8s1ceuBUnMUAeoAHHw,1,0,0,0,0,0,1,0,1,0.14285714285714285,1,0.0,0,0,0,0,0,0,0,1,0,0,1,1
11425,167055,tcOuPvspwR8RIsYVlB8hdFhNn4mHp1dB,A3fsA9Zfv1X2fVEQhTw51lKENdNrEqT3,6,5,2,0,1,0,2,0,10,1.4285714285714286,1,0.0,0,2,0,1,5,0,0,2,0,3,7,1
11426,167070,hfflCpa9jLkmfdXytJuPOg7rRc5Xg9VZ,G8EPVSXsOYB5YQWZGiz1aVq5Pgr2GrQu,1,0,0,0,0,0,1,0,1,0.14285714285714285,1,0.0,0,0,0,0,0,0,0,1,0,0,1,1
11427,167084,OtGMx6eKyVYjbz3L87VVmC99kyg1WjEl,SpATywNh6bZuzm8s1ceuBUnMUAeoAHHw,31,61,24,46,8,28,18,4,189,27.0,5,0.0,20,24,36,8,41,28,10,18,4,88,101,0
11428,167109,riXqOkhR5seretWfUGQsZViiD6naR0Fb,G8EPVSXsOYB5YQWZGiz1aVq5Pgr2GrQu,14,17,9,0,3,5,4,0,38,5.428571428571429,2,0.0,0,9,0,3,17,5,0,4,0,12,26,1
11429,167110,EcPuYKhDy2VQKZUDtISpnuVnvHl1yyoH,A3fsA9Zfv1X2fVEQhTw51lKENdNrEqT3,11,8,2,0,2,0,6,0,18,2.5714285714285716,2,0.0,0,2,0,2,8,0,0,6,0,4,14,1
11430,167153,zLzrsjVhPiaEb3EDibB8rvomdeM0jowN,A3fsA9Zfv1X2fVEQhTw51lKENdNrEqT3,6,8,1,0,0,0,2,0,11,1.5714285714285714,1,0.0,0,1,0,0,8,0,0,2,0,1,10,1
11431,167160,qWdJx4ntsNtLd8GM8vVdR8CfHZUb8VJ1,SpATywNh6bZuzm8s1ceuBUnMUAeoAHHw,7,7,0,0,0,0,4,5,16,2.2857142857142856,1,0.0,0,0,0,0,7,0,0,4,5,0,16,0
11432,167164,AMZsJ16nuDGvS9hfq5BFOrn6l1y3GwHs,bWdj2GDclj5ofokWjzoa5jAwMkxCykd6,1,0,0,0,0,0,1,0,1,0.14285714285714285,1,0.0,0,0,0,0,0,0,0,1,0,0,1,1
11433,167174,jQg5UakMQRKmdDEXjxxf2nAUZSauWzhl,bWdj2GDclj5ofokWjzoa5jAwMkxCykd6,1,0,0,0,0,0,1,0,1,0.14285714285714285,1,0.0,0,0,0,0,0,0,0,1,0,0,1,1
11434,167177,UMYeL3JvH5xCKyH0vQfSARajUrJikDyh,SpATywNh6bZuzm8s1ceuBUnMUAeoAHHw,1,0,0,0,0,0,1,0,1,0.14285714285714285,1,0.0,0,0,0,0,0,0,0,1,0,0,1,1
11435,167207,l6rkobnqEUKXFQnaBVgonlwU5l25TkcG,A3fsA9Zfv1X2fVEQhTw51lKENdNrEqT3,30,9,6,54,4,1,5,1,80,11.428571428571429,2,0.0,1,6,53,4,8,1,1,5,1,64,16,0
11436,167210,6ihb1oofKKDBkRZUjaHYZlnMwyNG8Px4,SpATywNh6bZuzm8s1ceuBUnMUAeoAHHw,11,5,4,0,4,0,3,0,16,2.2857142857142856,1,0.0,0,4,0,4,5,0,0,3,0,8,8,1
11437,167213,M3at3k1rzNLIb1jD1sERLP1bmTcUThqC,A3fsA9Zfv1X2fVEQhTw51lKENdNrEqT3,13,20,0,0,0,0,15,2,37,5.285714285714286,2,0.0,0,0,0,0,20,0,0,15,2,0,37,1
11438,167220,Me95BqnMi7W18LuJ9CGsC9vdXTLZ2e0Y,bWdj2GDclj5ofokWjzoa5jAwMkxCykd6,6,2,1,0,1,0,4,0,8,1.1428571428571428,1,0.0,0,1,0,1,2,0,0,4,0,2,6,1
11439,167228,3wg8Fx16VgJsTbW93ZS5qb0oY4bANqoR,A3fsA9Zfv1X2fVEQhTw51lKENdNrEqT3,51,24,11,164,2,0,14,0,215,30.714285714285715,1,0.0,3,11,135,2,21,0,29,14,0,151,64,1
11440,167230,EIH1YpezRj2Lrs71q1s3kjWajWGWK1FM,bWdj2GDclj5ofokWjzoa5jAwMkxCykd6,4,3,1,0,0,0,2,0,6,0.8571428571428571,1,0.0,0,1,0,0,3,0,0,2,0,1,5,1
11441,167243,XFT0aKbgPIc1KxMgUm9PqHuvehKJNjDt,A3fsA9Zfv1X2fVEQhTw51lKENdNrEqT3,1,0,0,0,0,0,1,0,1,0.14285714285714285,1,0.0,0,0,0,0,0,0,0,1,0,0,1,1
11442,167265,srnnzUkIJr2Uisav8LfnV4SnpbNw9CLp,RXDvfPUBYFlVdlueBFbLW0mhhAyGEqpt,1,0,0,0,0,0,1,0,1,0.14285714285714285,1,0.0,0,0,0,0,0,0,0,1,0,0,1,1
11443,167271,SG7N8DhpCuhIu06IIzLX0CSolbyIDsIx,RXDvfPUBYFlVdlueBFbLW0mhhAyGEqpt,1,0,0,0,0,0,1,0,1,0.14285714285714285,1,0.0,0,0,0,0,0,0,0,1,0,0,1,1
11444,167283,ilday4HM3BCIYcolQVgtTOYVZxbISCZm,G8EPVSXsOYB5YQWZGiz1aVq5Pgr2GrQu,15,21,9,6,7,3,11,0,57,8.142857142857142,3,0.0,4,9,3,7,17,3,3,11,0,23,34,1
11445,167288,sm9cSvIl5TlGsEwD0oTwnhmYMTLPLj8P,bWdj2GDclj5ofokWjzoa5jAwMkxCykd6,7,3,2,0,2,0,2,0,9,1.2857142857142858,1,0.0,0,2,0,2,3,0,0,2,0,4,5,1
11446,167295,4uAdkCJ4XUaD1NQGV93nNifOuyurJNKS,bWdj2GDclj5ofokWjzoa5jAwMkxCykd6,5,3,1,0,1,0,2,0,7,1.0,1,0.0,0,1,0,1,3,0,0,2,0,2,5,1
11447,167326,yAxjMvvPF3HDitgCGIcnFlXrbnOszGcQ,A3fsA9Zfv1X2fVEQhTw51lKENdNrEqT3,1,0,0,0,0,0,1,0,1,0.14285714285714285,1,0.0,0,0,0,0,0,0,0,1,0,0,1,1
11448,167329,cGTjqosEXx9XAIsx39Oilmuyj8U0yqfw,A3fsA9Zfv1X2fVEQhTw51lKENdNrEqT3,2,0,0,0,0,0,2,0,2,0.2857142857142857,1,0.0,0,0,0,0,0,0,0,2,0,0,2,1
11449,167340,3wg8Fx16VgJsTbW93ZS5qb0oY4bANqoR,bWdj2GDclj5ofokWjzoa5jAwMkxCykd6,1,0,0,0,0,0,1,0,1,0.14285714285714285,1,0.0,0,0,0,0,0,0,0,1,0,0,1,1
11450,167358,dr13KuqOo10EJH5V4oOgMy17ewEUhD7o,bWdj2GDclj5ofokWjzoa5jAwMkxCykd6,8,5,3,0,3,0,1,0,12,1.7142857142857142,1,0.0,1,3,0,3,4,0,0,1,0,7,5,1
11451,167361,IrJFtwV20e4gt61fm0xRhF7i2xKfc3Wt,SpATywNh6bZuzm8s1ceuBUnMUAeoAHHw,6,3,1,0,1,0,3,0,8,1.1428571428571428,1,0.0,0,1,0,1,3,0,0,3,0,2,6,1
11452,167380,OId7ihHovZuj6RIQGiERiMwv6zBqdO48,SpATywNh6bZuzm8s1ceuBUnMUAeoAHHw,18,16,10,0,5,1,5,0,37,5.285714285714286,4,0.0,1,10,0,5,15,1,0,5,0,16,21,1
11453,167394,igrS7a4fgJSjVbKCLW8mOgk95ysQ2GkN,A3fsA9Zfv1X2fVEQhTw51lKENdNrEqT3,3,3,0,0,0,0,2,0,5,0.7142857142857143,1,0.0,0,0,0,0,3,0,0,2,0,0,5,1
11454,167407,eyR9iuqRP6NAP1R3ifarfP0UWEdrKp8A,A3fsA9Zfv1X2fVEQhTw51lKENdNrEqT3,2,0,0,0,0,0,2,0,2,0.2857142857142857,1,0.0,0,0,0,0,0,0,0,2,0,0,2,1
11455,167432,hb0tSuKbMyuHgl5YJ3vO5EnQOpHuAODO,SpATywNh6bZuzm8s1ceuBUnMUAeoAHHw,1,0,0,0,0,0,1,0,1,0.14285714285714285,1,0.0,0,0,0,0,0,0,0,1,0,0,1,1
11456,167440,6ne76rFv6J6TLXUe0mStK4MXCR4J8Kt5,A3fsA9Zfv1X2fVEQhTw51lKENdNrEqT3,6,5,2,0,2,0,4,0,13,1.8571428571428572,1,0.0,0,2,0,2,5,0,0,4,0,4,9,1
11457,167449,1sNCO2I2ugkApY4LVRJ2DyXeH2mxSN1W,G8EPVSXsOYB5YQWZGiz1aVq5Pgr2GrQu,5,12,0,0,0,0,2,0,14,2.0,1,0.0,0,0,0,0,12,0,0,2,0,0,14,1
11458,167465,sQxRXgPzRqzU7G3Pdnh2A5U6A9WnaHY5,bWdj2GDclj5ofokWjzoa5jAwMkxCykd6,7,1,1,0,1,0,4,0,7,1.0,1,0.0,0,1,0,1,1,0,0,4,0,2,5,1
11459,167491,qT76Xe5xaEtKYZkUI7rFvt9ufvg3XeEH,SpATywNh6bZuzm8s1ceuBUnMUAeoAHHw,7,5,4,0,1,0,1,0,11,1.5714285714285714,1,0.0,0,4,0,1,5,0,0,1,0,5,6,0
11460,167492,kMJdIf6lyKBj8d5FH5wYfeAvXu9zJZ2k,A3fsA9Zfv1X2fVEQhTw51lKENdNrEqT3,26,8,4,86,0,0,10,0,108,15.428571428571429,3,0.0,1,4,71,0,7,0,15,10,0,76,32,1
11461,167496,Yq1D9nN2WOKWLjCOIlbnWTVJWZSUTem6,A3fsA9Zfv1X2fVEQhTw51lKENdNrEqT3,2,0,0,0,0,0,2,0,2,0.2857142857142857,1,0.0,0,0,0,0,0,0,0,2,0,0,2,1
11462,167503,Mg6dUwdl29Cw5DED2LH0q16XcuO0xYuD,SpATywNh6bZuzm8s1ceuBUnMUAeoAHHw,8,6,2,0,2,1,4,0,15,2.142857142857143,2,0.0,0,2,0,2,6,1,0,4,0,4,11,1
11463,167509,pqW9PtvFaMrdSQupCOglYiHhuFKzGBi5,RXDvfPUBYFlVdlueBFbLW0mhhAyGEqpt,13,8,7,0,5,0,2,0,22,3.142857142857143,1,0.0,0,7,0,5,8,0,0,2,0,12,10,0
11464,167523,qT76Xe5xaEtKYZkUI7rFvt9ufvg3XeEH,G8EPVSXsOYB5YQWZGiz1aVq5Pgr2GrQu,4,2,1,0,1,0,1,0,5,0.7142857142857143,1,0.0,0,1,0,1,2,0,0,1,0,2,3,0
11465,167525,ySjZqVrtQh1EozvnE2NZCLTibblBWXx9,RXDvfPUBYFlVdlueBFbLW0mhhAyGEqpt,1,0,0,0,0,0,1,0,1,0.14285714285714285,1,0.0,0,0,0,0,0,0,0,1,0,0,1,1
11466,167544,9eohUJjz99qBfLZrerzU9mvxKvUKHTKa,SpATywNh6bZuzm8s1ceuBUnMUAeoAHHw,7,5,2,0,2,0,2,0,11,1.5714285714285714,1,0.0,0,2,0,2,5,0,0,2,0,4,7,1
11467,167558,gKnyqrdfTVsXquWsv3SHAmERz5CaeqZp,SpATywNh6bZuzm8s1ceuBUnMUAeoAHHw,6,2,1,0,1,0,3,1,8,1.1428571428571428,1,0.0,0,1,0,1,2,0,0,3,1,2,6,1
11468,167561,E8lMjkJcqZcrPtGwbo8pVkzTRx8M7QkS,A3fsA9Zfv1X2fVEQhTw51lKENdNrEqT3,1,0,0,0,0,0,1,0,1,0.14285714285714285,1,0.0,0,0,0,0,0,0,0,1,0,0,1,1
11469,167569,YfnUrAEbnMAPhZfA8XApGAMCNnmussT1,SpATywNh6bZuzm8s1ceuBUnMUAeoAHHw,1,0,0,0,0,0,2,0,2,0.2857142857142857,1,0.0,0,0,0,0,0,0,0,2,0,0,2,1
11470,167584,f8jfFGo37bmeRi1spfYTASayMTQa0E3F,A3fsA9Zfv1X2fVEQhTw51lKENdNrEqT3,7,8,1,0,0,0,4,0,13,1.8571428571428572,1,0.0,0,1,0,0,8,0,0,4,0,1,12,1
11471,167605,mkvoAcdNQZUqkTrSjEQHebVQkgmiPVSS,SpATywNh6bZuzm8s1ceuBUnMUAeoAHHw,6,6,0,0,0,0,2,0,8,1.1428571428571428,1,0.0,2,0,0,0,4,0,0,2,0,2,6,1
11472,167633,JRUKMEmBZ3p5F0JpSVHv1lQEiMQUvro3,bWdj2GDclj5ofokWjzoa5jAwMkxCykd6,1,0,0,0,0,0,1,0,1,0.14285714285714285,1,0.0,0,0,0,0,0,0,0,1,0,0,1,1
11473,167636,DTg7EG4lfjPjfkpYaGZXFcsjykgIpZH4,RXDvfPUBYFlVdlueBFbLW0mhhAyGEqpt,16,14,7,0,5,0,5,0,31,4.428571428571429,2,0.0,0,7,0,5,14,0,0,5,0,12,19,1
11474,167638,JRUKMEmBZ3p5F0JpSVHv1lQEiMQUvro3,RXDvfPUBYFlVdlueBFbLW0mhhAyGEqpt,1,0,0,0,0,0,1,0,1,0.14285714285714285,1,0.0,0,0,0,0,0,0,0,1,0,0,1,1
11475,167656,j5JRftGHwmY5lwmELzjqtaSr20rFNwcA,SpATywNh6bZuzm8s1ceuBUnMUAeoAHHw,1,0,0,0,0,0,1,0,1,0.14285714285714285,1,0.0,0,0,0,0,0,0,0,1,0,0,1,1
11476,167678,IoHuXwpFj6jpaLOU2cjm2xo4xL3oc4iA,G8EPVSXsOYB5YQWZGiz1aVq5Pgr2GrQu,2,0,0,0,0,0,2,0,2,0.2857142857142857,1,0.0,0,0,0,0,0,0,0,2,0,0,2,1
11477,167684,IwkHnS79j7DCN6kQlSDresD36YsGD4iB,G8EPVSXsOYB5YQWZGiz1aVq5Pgr2GrQu,1,0,0,0,0,0,1,0,1,0.14285714285714285,1,0.0,0,0,0,0,0,0,0,1,0,0,1,1
11478,167693,bEOs2EB6LytAmhUESt0L1yFXZPfFAnOp,A3fsA9Zfv1X2fVEQhTw51lKENdNrEqT3,9,4,1,0,1,0,7,1,14,2.0,1,0.0,0,1,0,1,4,0,0,7,1,2,12,1
11479,167700,Ujm7XeJHYzYOVDc0hFmfxPzKGkFTVoYw,SpATywNh6bZuzm8s1ceuBUnMUAeoAHHw,10,5,1,0,1,3,7,1,18,2.5714285714285716,1,0.0,1,1,0,1,4,3,0,7,1,3,15,1
11480,167701,YEYMa1UeAbDmjG2cCwIOrTIjhyXHc5JO,SpATywNh6bZuzm8s1ceuBUnMUAeoAHHw,5,2,1,0,1,0,3,0,7,1.0,1,0.0,0,1,0,1,2,0,0,3,0,2,5,1
11481,167712,JhqtKTVVZhx2wzcUoD48zfOf7XJtvv55,SpATywNh6bZuzm8s1ceuBUnMUAeoAHHw,9,9,5,0,2,0,7,0,23,3.2857142857142856,2,0.0,0,5,0,2,9,0,0,7,0,7,16,1
11482,167714,nyH7Jx4kN1AdDJdwkZQoUDqYoovHgbk5,G8EPVSXsOYB5YQWZGiz1aVq5Pgr2GrQu,17,39,19,12,13,0,4,0,87,12.428571428571429,4,0.0,13,19,8,13,26,0,4,4,0,53,34,1
11483,167723,W5xQOH5MemwXn7klqn6rjd1MM4WzuzQi,G8EPVSXsOYB5YQWZGiz1aVq5Pgr2GrQu,1,0,0,0,0,0,1,0,1,0.14285714285714285,1,0.0,0,0,0,0,0,0,0,1,0,0,1,1
11484,167725,4SwPkRwXa5n6GEnAhisQz0yWI5GHdoml,SpATywNh6bZuzm8s1ceuBUnMUAeoAHHw,1,0,0,0,0,0,1,0,1,0.14285714285714285,1,0.0,0,0,0,0,0,0,0,1,0,0,1,1
11485,167730,eJb0xHKhoVkWPAATxA33vCcHjeoUzUdU,SpATywNh6bZuzm8s1ceuBUnMUAeoAHHw,1,0,0,0,0,0,1,0,1,0.14285714285714285,1,0.0,0,0,0,0,0,0,0,1,0,0,1,1
11486,167732,KTO4rcwcNqZCBYJ04kXZU7uzHTeP1Eer,bWdj2GDclj5ofokWjzoa5jAwMkxCykd6,1,0,0,0,0,0,1,0,1,0.14285714285714285,1,0.0,0,0,0,0,0,0,0,1,0,0,1,1
11487,167733,qj8NUYtUMoWd1xGdKnBiRi4xrQOuNSyr,SpATywNh6bZuzm8s1ceuBUnMUAeoAHHw,7,4,0,0,0,11,8,2,25,3.5714285714285716,1,0.0,0,0,0,0,4,11,0,8,2,0,25,0
11488,167734,KTO4rcwcNqZCBYJ04kXZU7uzHTeP1Eer,A3fsA9Zfv1X2fVEQhTw51lKENdNrEqT3,27,5,3,54,0,0,4,0,66,9.428571428571429,1,0.0,1,3,48,0,4,0,6,4,0,52,14,1
11489,167736,T9568NbVeTbUTmE4rk1xM0kbLMHudWM2,SpATywNh6bZuzm8s1ceuBUnMUAeoAHHw,2,0,0,0,0,0,2,0,2,0.2857142857142857,1,0.0,0,0,0,0,0,0,0,2,0,0,2,1
11490,167738,8MuGb55gUM18pukCITXgZoTSobqXs9G4,A3fsA9Zfv1X2fVEQhTw51lKENdNrEqT3,44,5,0,154,0,0,6,0,165,23.571428571428573,3,0.0,0,0,154,0,5,0,0,6,0,154,11,1
11491,167739,mzdlx6QFLX0FKvpMfsWw3ZhcYcqCwlK5,SpATywNh6bZuzm8s1ceuBUnMUAeoAHHw,25,34,12,34,4,9,8,1,102,14.571428571428571,2,0.0,16,12,29,4,18,9,5,8,1,61,41,0
11492,167752,X7ZRKY7iYfh1hBkF13Zq6r3vncHYgHEH,A3fsA9Zfv1X2fVEQhTw51lKENdNrEqT3,1,0,0,0,0,0,1,0,1,0.14285714285714285,1,0.0,0,0,0,0,0,0,0,1,0,0,1,1
11493,167762,HubxyoHMVvWQ9uDYtdMVwcYvuPNvagty,SpATywNh6bZuzm8s1ceuBUnMUAeoAHHw,7,4,3,0,3,0,2,0,12,1.7142857142857142,1,0.0,0,3,0,3,4,0,0,2,0,6,6,1
11494,167767,8MuGb55gUM18pukCITXgZoTSobqXs9G4,bWdj2GDclj5ofokWjzoa5jAwMkxCykd6,4,3,0,0,0,0,4,0,7,1.0,3,0.0,0,0,0,0,3,0,0,4,0,0,7,1
11495,167777,BWZyBrJDBbkcDEXyE3CSVFoVlT2CRRku,bWdj2GDclj5ofokWjzoa5jAwMkxCykd6,5,3,0,0,0,3,7,0,13,1.8571428571428572,2,0.0,1,0,0,0,2,3,0,7,0,1,12,1
11496,167781,HhHFHVl0FdyFAQQ7F70xD2HQyGMqv85Q,G8EPVSXsOYB5YQWZGiz1aVq5Pgr2GrQu,9,11,3,0,2,0,3,0,19,2.7142857142857144,1,0.0,0,3,0,2,11,0,0,3,0,5,14,1
11497,167800,0LL9QDirPHiGZNR0VQr3Nl4vTFkZYpx9,SpATywNh6bZuzm8s1ceuBUnMUAeoAHHw,1,0,0,0,0,0,1,0,1,0.14285714285714285,1,0.0,0,0,0,0,0,0,0,1,0,0,1,1
11498,167802,RPbVtB8AwN8yynuRyP2nQSNV9Qygwfwj,bWdj2GDclj5ofokWjzoa5jAwMkxCykd6,1,0,0,0,0,0,1,0,1,0.14285714285714285,1,0.0,0,0,0,0,0,0,0,1,0,0,1,1
11499,167804,t1cN3fKfmsp5Xu7Bxx5kMtJx0UaXo72h,A3fsA9Zfv1X2fVEQhTw51lKENdNrEqT3,1,0,0,0,0,0,1,0,1,0.14285714285714285,1,0.0,0,0,0,0,0,0,0,1,0,0,1,1
11500,167809,cec6apEZZ4OuI8Z1bq3hYVAQOrfIot0q,G8EPVSXsOYB5YQWZGiz1aVq5Pgr2GrQu,5,2,1,0,1,0,5,0,9,1.2857142857142858,1,0.0,0,1,0,1,2,0,0,5,0,2,7,0
11501,167815,5sps38f5Y5pZOFcONQeuy3Uw9461fahZ,bWdj2GDclj5ofokWjzoa5jAwMkxCykd6,5,2,1,0,1,0,2,0,6,0.8571428571428571,1,0.0,0,1,0,1,2,0,0,2,0,2,4,1
11502,168016,Xdurokd2SSgNf25hifq07OxoiHEDcyiq,fbPkOYLVPtPgIt0MxizjfFJov3JbHyAi,5,6,4,0,0,2,4,0,16,2.2857142857142856,1,0.0,0,4,0,0,6,2,0,4,0,4,12,1
11503,169705,Qty87BeKrf3ZgzVA2PT9rBe28vADAPbJ,fbPkOYLVPtPgIt0MxizjfFJov3JbHyAi,1,0,0,0,0,0,1,0,1,0.14285714285714285,1,0.0,0,0,0,0,0,0,0,1,0,0,1,1
11504,169725,udxFfabXtaVUvVlT3wEleIvfDBGe9yE2,fbPkOYLVPtPgIt0MxizjfFJov3JbHyAi,7,3,2,0,2,0,3,0,10,1.4285714285714286,1,0.0,0,2,0,2,3,0,0,3,0,4,6,1
11505,169735,5IM8g7YMOYo5qH7Yu3x31T3JkVOH9iqe,7GRhBDsirIGkRZBtSMEzNTyDr2JQm4xx,5,2,1,0,1,0,2,0,6,0.8571428571428571,2,0.0,0,1,0,1,2,0,0,2,0,2,4,1
11506,169772,l1rg3D8Gp1lv7dbBBYKvzTS3OZ5DRjWH,A3fsA9Zfv1X2fVEQhTw51lKENdNrEqT3,1,0,0,0,0,0,1,0,1,0.14285714285714285,1,0.0,0,0,0,0,0,0,0,1,0,0,1,1
11507,169800,g3902agYIRHzac78MKVZlvljLMXXNpQ7,7GRhBDsirIGkRZBtSMEzNTyDr2JQm4xx,10,7,4,4,2,0,6,0,23,3.2857142857142856,1,0.0,1,4,4,2,6,0,0,6,0,11,12,1
11508,169865,FUKsUHV3URSaK57Jrek7EonPjAGWSjXW,7GRhBDsirIGkRZBtSMEzNTyDr2JQm4xx,3,2,1,0,0,0,2,0,5,0.7142857142857143,1,0.0,0,1,0,0,2,0,0,2,0,1,4,1
11509,169885,BSj3AAnB5ipEkdnoMrRkK2tTYOV9mAFC,7GRhBDsirIGkRZBtSMEzNTyDr2JQm4xx,9,9,3,4,1,2,5,0,24,3.4285714285714284,2,0.0,2,3,3,1,7,2,1,5,0,9,15,1
11510,169911,2j6SiYhVaWD27toQPxUbfR6IzUCgWGsO,7GRhBDsirIGkRZBtSMEzNTyDr2JQm4xx,1,0,0,0,0,0,1,0,1,0.14285714285714285,1,0.0,0,0,0,0,0,0,0,1,0,0,1,1
11511,169914,EX4mN8VqjmDrg8vjZaJJar6Z7qHJihO0,SpATywNh6bZuzm8s1ceuBUnMUAeoAHHw,16,18,6,14,3,1,6,1,49,7.0,1,0.0,9,6,14,3,9,1,0,6,1,32,17,0
11512,169943,BLyKMpisIDss4MmDNKRytNOAQZEOycAU,7GRhBDsirIGkRZBtSMEzNTyDr2JQm4xx,1,0,0,0,0,0,1,0,1,0.14285714285714285,1,0.0,0,0,0,0,0,0,0,1,0,0,1,1
11513,169955,ZQcqpVyhrZVshH7yyuAn3ze3B9JEoNBU,SpATywNh6bZuzm8s1ceuBUnMUAeoAHHw,1,0,0,0,0,0,1,0,1,0.14285714285714285,1,0.0,0,0,0,0,0,0,0,1,0,0,1,1
11514,169971,bNG7kJA3jy4DW8PDzMNAT9OoyHwhutqS,7GRhBDsirIGkRZBtSMEzNTyDr2JQm4xx,3,2,1,0,0,0,1,0,4,0.5714285714285714,1,0.0,0,1,0,0,2,0,0,1,0,1,3,1
11515,170020,nVB1o73xluQXZjoI2dUYHGxbCDG8qiCL,7GRhBDsirIGkRZBtSMEzNTyDr2JQm4xx,5,2,1,0,1,0,10,0,14,2.0,3,0.0,0,1,0,1,2,0,0,10,0,2,12,1
11516,170032,GlWFWKrBQhsgqjbmoDsRUa17h8chqAsd,G8EPVSXsOYB5YQWZGiz1aVq5Pgr2GrQu,9,6,1,14,1,0,2,0,24,3.4285714285714284,1,0.0,3,1,11,1,3,0,3,2,0,16,8,1
11517,170040,qqtHlVJpcH8uxc5327KA4fBoZNP0U5Xd,7GRhBDsirIGkRZBtSMEzNTyDr2JQm4xx,6,4,3,0,0,0,2,0,9,1.2857142857142858,1,0.0,0,3,0,0,4,0,0,2,0,3,6,1
11518,170061,tfoakS3EMOjWuYWNRSgWZTjBxe3Mf9Te,7GRhBDsirIGkRZBtSMEzNTyDr2JQm4xx,1,0,0,0,0,0,1,0,1,0.14285714285714285,1,0.0,0,0,0,0,0,0,0,1,0,0,1,1
11519,170075,nmifCUUA8im6jjkFk86bK5knz02SLRlN,7GRhBDsirIGkRZBtSMEzNTyDr2JQm4xx,7,4,2,0,2,0,2,0,10,1.4285714285714286,1,0.0,0,2,0,2,4,0,0,2,0,4,6,1
11520,170100,R0iGmWkfHC0JwSUufNxBJOtu3BmW7cey,7GRhBDsirIGkRZBtSMEzNTyDr2JQm4xx,10,21,6,0,4,2,3,0,36,5.142857142857143,1,0.0,13,6,0,4,8,2,0,3,0,23,13,1
11521,170206,mKHQM9iW9olu6z2WamdxK7ySH3UwX3JX,bWdj2GDclj5ofokWjzoa5jAwMkxCykd6,1,0,0,0,0,0,1,0,1,0.14285714285714285,1,0.0,0,0,0,0,0,0,0,1,0,0,1,1
11522,170213,dRpHvWsltBuE4KgJgZUdCQKV5v7VQuHh,7GRhBDsirIGkRZBtSMEzNTyDr2JQm4xx,10,2,1,0,1,3,8,4,19,2.7142857142857144,1,0.0,0,1,0,1,2,3,0,8,4,2,17,1
11523,170244,GdGI6ZUeHNfDd16CDy7Y3YMvqdJfsIRh,7GRhBDsirIGkRZBtSMEzNTyDr2JQm4xx,1,0,0,0,0,0,2,0,2,0.2857142857142857,1,0.0,0,0,0,0,0,0,0,2,0,0,2,1
11524,170247,vaWLVKWyrsUzDV0qs20ZUq8M3VNW01Uk,7GRhBDsirIGkRZBtSMEzNTyDr2JQm4xx,9,4,2,6,2,5,3,0,22,3.142857142857143,2,0.0,1,2,5,2,3,5,1,3,0,10,12,1
11525,170250,7jkKKf5Pb7FrtJ3WnuF11G7ePioUPJm3,bWdj2GDclj5ofokWjzoa5jAwMkxCykd6,3,2,1,0,0,1,1,0,5,0.7142857142857143,1,0.0,0,1,0,0,2,1,0,1,0,1,4,1
11526,170257,UYAHgDyJ2Tcd8fTB7PMLIt7CemKCJ2QW,SpATywNh6bZuzm8s1ceuBUnMUAeoAHHw,5,3,1,0,1,0,2,0,7,1.0,1,0.0,0,1,0,1,3,0,0,2,0,2,5,0
11527,170262,RHsk3gHUm8VEfb9FwEFf8vBDNKZZ0LWe,bWdj2GDclj5ofokWjzoa5jAwMkxCykd6,40,52,32,118,20,19,18,1,260,37.142857142857146,2,0.0,13,32,92,20,39,19,26,18,1,157,103,0
11528,170274,eb3SHueTE6ugnDkhYnh0RBSPDS20VwLZ,7GRhBDsirIGkRZBtSMEzNTyDr2JQm4xx,16,26,12,0,7,0,2,0,47,6.714285714285714,2,0.0,0,12,0,7,26,0,0,2,0,19,28,1
11529,170284,3RtHMyLQOrBsDYp6yo5VYdmS72cr3PBJ,bWdj2GDclj5ofokWjzoa5jAwMkxCykd6,5,1,1,0,1,0,3,0,6,0.8571428571428571,1,0.0,0,1,0,1,1,0,0,3,0,2,4,1
11530,170320,pqBs8sN0PT2UoBL7VKu89PIVTchItwDs,7GRhBDsirIGkRZBtSMEzNTyDr2JQm4xx,4,2,0,0,0,0,5,0,7,1.0,1,0.0,0,0,0,0,2,0,0,5,0,0,7,1
11531,170347,ung1DnQyYgd0tfz7mAKTwJrrm5UPHWt1,7GRhBDsirIGkRZBtSMEzNTyDr2JQm4xx,1,0,0,0,0,0,1,0,1,0.14285714285714285,1,0.0,0,0,0,0,0,0,0,1,0,0,1,1
11532,170400,qlV7NVEcCnAsxKC17kpoGCtCEpV1bUS5,A3fsA9Zfv1X2fVEQhTw51lKENdNrEqT3,11,4,3,0,3,3,4,0,17,2.4285714285714284,1,0.0,0,3,0,3,4,3,0,4,0,6,11,1
11533,170403,TY1XSpzUxZYHUqU0tQYtstvuwKCsGYpR,SpATywNh6bZuzm8s1ceuBUnMUAeoAHHw,3,2,0,0,0,0,2,0,4,0.5714285714285714,1,0.0,0,0,0,0,2,0,0,2,0,0,4,1
11534,170412,Z6SakRvyvh7ZuaV4DHEE1b3QLOpPcfOm,SpATywNh6bZuzm8s1ceuBUnMUAeoAHHw,18,19,2,26,0,0,9,1,57,8.142857142857142,4,0.0,4,2,25,0,15,0,1,9,1,31,26,0
11535,170432,CDy3wblikhG2TGdNI3LhbAglknKqeMeq,7GRhBDsirIGkRZBtSMEzNTyDr2JQm4xx,1,0,0,0,0,0,1,0,1,0.14285714285714285,1,0.0,0,0,0,0,0,0,0,1,0,0,1,1
11536,170458,DIfj5Ba2axfDE4LFDWqKjVBCgesW8XXW,A3fsA9Zfv1X2fVEQhTw51lKENdNrEqT3,1,0,0,0,0,0,1,0,1,0.14285714285714285,1,0.0,0,0,0,0,0,0,0,1,0,0,1,1
11537,170460,m8tZWvMesr1zQS0esJJogsiMlXHxe2Cd,7GRhBDsirIGkRZBtSMEzNTyDr2JQm4xx,1,0,0,0,0,0,1,0,1,0.14285714285714285,1,0.0,0,0,0,0,0,0,0,1,0,0,1,1
11538,170490,2H6KbsPWrpdsyjI0g4q0nnMN85W6it1n,7GRhBDsirIGkRZBtSMEzNTyDr2JQm4xx,1,0,0,0,0,0,1,0,1,0.14285714285714285,1,0.0,0,0,0,0,0,0,0,1,0,0,1,1
11539,170572,lyUyYIfExuGOGDXTlbgjuS96P5Iv4Fw9,SpATywNh6bZuzm8s1ceuBUnMUAeoAHHw,18,27,10,21,4,21,17,5,105,15.0,2,0.0,12,10,18,4,15,21,3,17,5,44,61,1
11540,170619,SSjJLhqPp3KtEjhygN5aGwtbWcKsJk4h,7GRhBDsirIGkRZBtSMEzNTyDr2JQm4xx,1,0,0,0,0,0,2,0,2,0.2857142857142857,1,0.0,0,0,0,0,0,0,0,2,0,0,2,1
11541,170650,WJvUM8vrAZx3jP5SMFm1lAFz7l2iXld4,7GRhBDsirIGkRZBtSMEzNTyDr2JQm4xx,5,2,1,0,1,0,2,0,6,0.8571428571428571,1,0.0,0,1,0,1,2,0,0,2,0,2,4,1
11542,170674,GfrMOiCcFGorw9y2zYLBWSI6Ij42MMT7,7GRhBDsirIGkRZBtSMEzNTyDr2JQm4xx,1,0,0,0,0,0,1,0,1,0.14285714285714285,1,0.0,0,0,0,0,0,0,0,1,0,0,1,1
11543,170681,cJJis1Eo88AzCRowxVa7rzvY4ZLonXwZ,A3fsA9Zfv1X2fVEQhTw51lKENdNrEqT3,6,2,1,0,1,0,4,0,8,1.1428571428571428,1,0.0,0,1,0,1,2,0,0,4,0,2,6,1
11544,170692,Hm7TJQq1vAhYsYwItY96s4Me02Vfs6zP,7GRhBDsirIGkRZBtSMEzNTyDr2JQm4xx,1,0,0,0,0,0,1,0,1,0.14285714285714285,1,0.0,0,0,0,0,0,0,0,1,0,0,1,1
11545,172603,3Qa8OwRnF6RlLJIaj65bDtbQqyemzMgL,7GRhBDsirIGkRZBtSMEzNTyDr2JQm4xx,2,0,0,0,0,0,4,0,4,0.5714285714285714,1,0.0,0,0,0,0,0,0,0,4,0,0,4,1
11546,172607,NzrnPyQE2ugty7kkveeBlkFqr7w3UxlN,7GRhBDsirIGkRZBtSMEzNTyDr2JQm4xx,2,0,0,0,0,0,4,0,4,0.5714285714285714,1,0.0,0,0,0,0,0,0,0,4,0,0,4,1
11547,172625,6rGO7hPQfiSxYr5WLMk6ADh5tZXWjo5G,7GRhBDsirIGkRZBtSMEzNTyDr2JQm4xx,6,1,1,0,1,0,4,0,7,1.0,1,0.0,0,1,0,1,1,0,0,4,0,2,5,1
11548,172633,dbB5wvpXcG9crHY0IBSgcjC2RaEiLaLJ,7GRhBDsirIGkRZBtSMEzNTyDr2JQm4xx,33,44,12,45,7,1,2,0,111,15.857142857142858,1,0.0,30,12,36,7,14,1,9,2,0,85,26,1
11549,172648,4dKHuxqIxqkgnnPsJVGzxbywZwnO5Gk5,7GRhBDsirIGkRZBtSMEzNTyDr2JQm4xx,2,0,0,0,0,0,2,0,2,0.2857142857142857,1,0.0,0,0,0,0,0,0,0,2,0,0,2,1
11550,172664,qVPmJ4VDzezTrYKhrdeTeAkmNVvDpxTN,7GRhBDsirIGkRZBtSMEzNTyDr2JQm4xx,1,0,0,0,0,0,1,0,1,0.14285714285714285,1,0.0,0,0,0,0,0,0,0,1,0,0,1,1
11551,172672,tN0VqNMvyp7i1ARB8nPF5OPuXHimNIVo,7GRhBDsirIGkRZBtSMEzNTyDr2JQm4xx,2,0,0,0,0,0,2,0,2,0.2857142857142857,1,0.0,0,0,0,0,0,0,0,2,0,0,2,1
11552,172674,AEIKxehDViGug4MCURfXcZNkb3lq7o1x,7GRhBDsirIGkRZBtSMEzNTyDr2JQm4xx,19,14,10,0,10,0,4,0,38,5.428571428571429,1,0.0,0,10,0,10,14,0,0,4,0,20,18,1
11553,172706,ExYCcuGVzDNcCtA4rQqosA267qlGxHih,7GRhBDsirIGkRZBtSMEzNTyDr2JQm4xx,7,0,0,0,0,0,7,1,8,1.1428571428571428,1,0.0,0,0,0,0,0,0,0,7,1,0,8,1
11554,172707,JnYcKFBPT6ke8yr2Se5J0qjNCbQC2Yzq,7GRhBDsirIGkRZBtSMEzNTyDr2JQm4xx,7,5,1,0,0,0,6,1,13,1.8571428571428572,1,0.0,0,1,0,0,5,0,0,6,1,1,12,1
11555,172733,oKu6VLpnoojteApzRKKjWrPb4vBoBjWk,7GRhBDsirIGkRZBtSMEzNTyDr2JQm4xx,1,0,0,0,0,0,1,0,1,0.14285714285714285,1,0.0,0,0,0,0,0,0,0,1,0,0,1,1
11556,172761,sL5jw3pLWZoRI7avI17oM60mfF67Acgz,fbPkOYLVPtPgIt0MxizjfFJov3JbHyAi,4,0,0,0,0,1,5,0,6,0.8571428571428571,2,0.0,0,0,0,0,0,1,0,5,0,0,6,0
11557,172778,u9U6O6GxVn6L6EV5GIFg6G5cI8qZfIM1,fbPkOYLVPtPgIt0MxizjfFJov3JbHyAi,5,3,2,0,1,0,2,0,8,1.1428571428571428,1,0.0,0,2,0,1,3,0,0,2,0,3,5,1
11558,173101,Sy0IBVghIdDN5uhsYaAtE4EZP4lbDR6C,bWdj2GDclj5ofokWjzoa5jAwMkxCykd6,6,3,2,0,2,0,1,0,8,1.1428571428571428,2,0.0,0,2,0,2,3,0,0,1,0,4,4,1
11559,173108,uRoRagoJb7klyYml2W2nJUADMGnmCLCh,A3fsA9Zfv1X2fVEQhTw51lKENdNrEqT3,5,5,0,0,0,0,2,0,7,1.0,1,0.0,0,0,0,0,5,0,0,2,0,0,7,1
11560,173115,WhBYED4roEqwKdd7WRGAiWGZl1X7zVBC,SpATywNh6bZuzm8s1ceuBUnMUAeoAHHw,22,17,8,18,7,0,2,0,52,7.428571428571429,1,0.0,2,8,15,7,15,0,3,2,0,32,20,1
11561,173122,MeAthuGTC0Mssqzv92bAUQ6CjEcP1h8d,A3fsA9Zfv1X2fVEQhTw51lKENdNrEqT3,71,85,64,188,27,52,18,2,436,62.285714285714285,3,0.0,3,64,139,27,82,52,49,18,2,233,203,0
11562,173128,6qUqUreFzudXqhzjQZQMQuj6XiqDCHSF,bWdj2GDclj5ofokWjzoa5jAwMkxCykd6,9,8,4,0,2,0,3,0,17,2.4285714285714284,1,0.0,0,4,0,2,8,0,0,3,0,6,11,1
11563,173137,jV4bQZTO8NhEnxumKD5qHxnk6auhtohn,SpATywNh6bZuzm8s1ceuBUnMUAeoAHHw,17,16,6,25,2,0,5,0,54,7.714285714285714,2,0.0,6,6,23,2,10,0,2,5,0,37,17,0
11564,173147,60Dduz8CDLu92eVkbOGEahQqaVwXLhUV,A3fsA9Zfv1X2fVEQhTw51lKENdNrEqT3,16,10,7,0,7,0,5,0,29,4.142857142857143,2,0.0,0,7,0,7,10,0,0,5,0,14,15,1
11565,173166,84jM92o4oluSWHz68fjJdNU1O5aejzX8,A3fsA9Zfv1X2fVEQhTw51lKENdNrEqT3,1,0,0,0,0,0,1,0,1,0.14285714285714285,1,0.0,0,0,0,0,0,0,0,1,0,0,1,1
11566,173167,R2PVhKsPZcwfUBkw7hJ62cbr2j1XWSh4,SpATywNh6bZuzm8s1ceuBUnMUAeoAHHw,12,17,10,0,6,1,5,2,41,5.857142857142857,2,0.0,4,10,0,6,13,1,0,5,2,20,21,1
11567,173171,HsOuSjJr2KKry0RFy7J8sS4QwH7Xk1dF,SpATywNh6bZuzm8s1ceuBUnMUAeoAHHw,23,27,17,0,12,13,11,1,81,11.571428571428571,2,0.0,7,17,0,12,20,13,0,11,1,36,45,1
11568,173202,GhGGPl8wZwtcLQZXvpUQjKC1TVd0CdDS,bWdj2GDclj5ofokWjzoa5jAwMkxCykd6,8,1,1,0,1,1,9,1,14,2.0,1,0.0,0,1,0,1,1,1,0,9,1,2,12,1
11569,173205,CXCWo7FvfWmDFvByuj4kADS8SZwH1QxN,SpATywNh6bZuzm8s1ceuBUnMUAeoAHHw,2,0,0,0,0,0,2,0,2,0.2857142857142857,1,0.0,0,0,0,0,0,0,0,2,0,0,2,1
11570,173217,55qFOvzjFp79P87tCKKcDPlhphK7gh3v,A3fsA9Zfv1X2fVEQhTw51lKENdNrEqT3,1,0,0,0,0,0,1,0,1,0.14285714285714285,1,0.0,0,0,0,0,0,0,0,1,0,0,1,1
11571,173218,RXXY4sAswYRo10grAYknhMWNw9Y2YFYb,SpATywNh6bZuzm8s1ceuBUnMUAeoAHHw,16,11,5,11,5,0,20,0,52,7.428571428571429,2,0.0,1,5,10,5,10,0,1,20,0,21,31,0
11572,173228,v7cnqM7vYgsjiGOlSwxgim0qVwuXESGN,RXDvfPUBYFlVdlueBFbLW0mhhAyGEqpt,7,4,2,0,1,0,2,0,9,1.2857142857142858,1,0.0,0,2,0,1,4,0,0,2,0,3,6,1
11573,173243,XPZ2qUEZKADAXZXErutkhGpDp6JKqGtI,SpATywNh6bZuzm8s1ceuBUnMUAeoAHHw,15,13,6,14,4,0,6,0,43,6.142857142857143,1,0.0,6,6,13,4,7,0,1,6,0,29,14,1
11574,173247,WLAmx1xu6Oqj4DvlomeHAJXvMyktUiPG,SpATywNh6bZuzm8s1ceuBUnMUAeoAHHw,18,25,1,14,0,0,7,0,47,6.714285714285714,3,0.0,4,1,14,0,21,0,0,7,0,19,28,0
11575,173251,R5nDIhuemBUVJIMEekOzsWhsz8ABh67H,SpATywNh6bZuzm8s1ceuBUnMUAeoAHHw,3,2,0,0,0,0,2,0,4,0.5714285714285714,1,0.0,0,0,0,0,2,0,0,2,0,0,4,1
11576,173255,Utj92TYHIWVfdmSDWLIJybQdBOyLbHqU,SpATywNh6bZuzm8s1ceuBUnMUAeoAHHw,7,2,0,0,0,0,7,1,10,1.4285714285714286,1,0.0,0,0,0,0,2,0,0,7,1,0,10,1
11577,173261,0S6LD77Xb8NCAw50mR3BuCC8qj8MNTO7,SpATywNh6bZuzm8s1ceuBUnMUAeoAHHw,4,2,1,0,0,2,3,0,8,1.1428571428571428,1,0.0,0,1,0,0,2,2,0,3,0,1,7,1
11578,173271,5uCuxLE5XjM4y4nmjuWckCuNM8tm7Xz4,RXDvfPUBYFlVdlueBFbLW0mhhAyGEqpt,41,40,2,115,3,11,6,1,178,25.428571428571427,2,0.0,15,2,108,3,25,11,7,6,1,128,50,1
11579,173306,8NK3iaPYRi5tDjzHZVNIqLtQMUnR3yyG,SpATywNh6bZuzm8s1ceuBUnMUAeoAHHw,2,0,0,0,0,0,2,0,2,0.2857142857142857,1,0.0,0,0,0,0,0,0,0,2,0,0,2,1
11580,173325,CS2NVGM14Xy1CNBgiOvv29fLyH8Y1bY8,SpATywNh6bZuzm8s1ceuBUnMUAeoAHHw,5,3,2,0,0,0,2,0,7,1.0,1,0.0,0,2,0,0,3,0,0,2,0,2,5,1
11581,173333,ljhELjrE7nbOy1tZAQRzQ0d2zvHLtBFk,bWdj2GDclj5ofokWjzoa5jAwMkxCykd6,4,5,2,0,2,0,1,0,10,1.4285714285714286,1,0.0,0,2,0,2,5,0,0,1,0,4,6,1
11582,173335,XXmlSdsGrMmHZfufZWdeObNOjT4zg6AW,G8EPVSXsOYB5YQWZGiz1aVq5Pgr2GrQu,16,11,1,34,0,0,2,0,48,6.857142857142857,1,0.0,0,1,28,0,11,0,6,2,0,29,19,1
11583,173337,d5wcSNGd1z76FQrsNvFOCxhoOHps5LtC,bWdj2GDclj5ofokWjzoa5jAwMkxCykd6,1,0,0,0,0,0,1,0,1,0.14285714285714285,1,0.0,0,0,0,0,0,0,0,1,0,0,1,1
11584,173342,WsU7antS0XD0DLnUCoai3UEBgeJYqPfD,A3fsA9Zfv1X2fVEQhTw51lKENdNrEqT3,2,0,0,0,0,0,4,0,4,0.5714285714285714,1,0.0,0,0,0,0,0,0,0,4,0,0,4,1
11585,173356,SNwjM74zr1JfG7EVwxCRYPHz9bZcobb2,SpATywNh6bZuzm8s1ceuBUnMUAeoAHHw,1,0,0,0,0,0,1,0,1,0.14285714285714285,1,0.0,0,0,0,0,0,0,0,1,0,0,1,0
11586,173360,yZNPokdjhDRHAxyvIoZvfNcgrX1hi17e,SpATywNh6bZuzm8s1ceuBUnMUAeoAHHw,4,2,1,0,1,0,1,0,5,0.7142857142857143,2,0.0,0,1,0,1,2,0,0,1,0,2,3,1
11587,173369,2k8fsIzv9gal41vCmwSZyNE8PhUZWRlf,SpATywNh6bZuzm8s1ceuBUnMUAeoAHHw,18,16,7,23,3,1,10,1,61,8.714285714285714,1,0.0,4,7,19,3,12,1,4,10,1,33,28,0
11588,173371,gx5zIbRkvVmYAkHaGQMR5zm5BpTwVwIe,SpATywNh6bZuzm8s1ceuBUnMUAeoAHHw,6,3,1,0,1,0,2,0,7,1.0,1,0.0,0,1,0,1,3,0,0,2,0,2,5,1
11589,173397,PUvUSLbNhJCmhl8hY6hN43xWGmaNTEJm,SpATywNh6bZuzm8s1ceuBUnMUAeoAHHw,4,4,1,0,0,0,3,0,8,1.1428571428571428,2,0.0,0,1,0,0,4,0,0,3,0,1,7,1
11590,173411,Mum77MZ1mdjN6HFQFByj0Ds7jbAp3P8k,G8EPVSXsOYB5YQWZGiz1aVq5Pgr2GrQu,6,0,0,0,0,1,5,0,6,0.8571428571428571,1,0.0,0,0,0,0,0,1,0,5,0,0,6,1
11591,173420,OIunh5VlGgmCbVp6rN8NSUpYr9NyGfUf,SpATywNh6bZuzm8s1ceuBUnMUAeoAHHw,7,6,3,0,2,0,1,0,12,1.7142857142857142,1,0.0,0,3,0,2,6,0,0,1,0,5,7,1
11592,173454,j5Ehqr4JpEaPpLQaRCbPvKZDUsPQTugX,bWdj2GDclj5ofokWjzoa5jAwMkxCykd6,1,0,0,0,0,0,1,0,1,0.14285714285714285,1,0.0,0,0,0,0,0,0,0,1,0,0,1,1
11593,173461,l1rg3D8Gp1lv7dbBBYKvzTS3OZ5DRjWH,G8EPVSXsOYB5YQWZGiz1aVq5Pgr2GrQu,1,0,0,0,0,0,1,0,1,0.14285714285714285,1,0.0,0,0,0,0,0,0,0,1,0,0,1,1
11594,173473,drbDbeyMCCsWxOOyHvPueP03lfvUAkGe,bWdj2GDclj5ofokWjzoa5jAwMkxCykd6,1,0,0,0,0,0,2,0,2,0.2857142857142857,1,0.0,0,0,0,0,0,0,0,2,0,0,2,1
11595,173485,Gj6yrFuP2L0UySRxwG1ZhYaHhmyFPckw,SpATywNh6bZuzm8s1ceuBUnMUAeoAHHw,8,7,4,0,3,0,3,0,17,2.4285714285714284,2,0.0,1,4,0,3,6,0,0,3,0,8,9,1
11596,173497,2XXif95hPztKoUUhClFIQsvkcA4F6WPm,SpATywNh6bZuzm8s1ceuBUnMUAeoAHHw,1,0,0,0,0,0,1,0,1,0.14285714285714285,1,0.0,0,0,0,0,0,0,0,1,0,0,1,1
11597,173503,MCzItgyS8iSbD1IkbXNJceX9NOFHlbyx,SpATywNh6bZuzm8s1ceuBUnMUAeoAHHw,1,0,0,0,0,0,1,0,1,0.14285714285714285,1,0.0,0,0,0,0,0,0,0,1,0,0,1,1
11598,173504,r5DVNivQqR7zEdPGXI8XjDMOM8jGXSCY,bWdj2GDclj5ofokWjzoa5jAwMkxCykd6,14,12,8,10,8,0,3,0,41,5.857142857142857,1,0.0,2,8,8,8,10,0,2,3,0,26,15,1
11599,173506,aV96dKmuiAXZCpnpQwDdasPAhwqE3nqd,A3fsA9Zfv1X2fVEQhTw51lKENdNrEqT3,2,0,0,0,0,0,2,0,2,0.2857142857142857,1,0.0,0,0,0,0,0,0,0,2,0,0,2,1
11600,173511,AhSpjmDGb1sSCvDYt3Ot7jjy0f3gxRE7,SpATywNh6bZuzm8s1ceuBUnMUAeoAHHw,9,12,7,0,3,1,9,2,34,4.857142857142857,2,0.0,0,7,0,3,12,1,0,9,2,10,24,1
11601,173512,6bfN4bZg88fPQ84WPMXzkUepeo1lqShn,SpATywNh6bZuzm8s1ceuBUnMUAeoAHHw,18,11,9,10,6,1,4,0,41,5.857142857142857,1,0.0,0,9,9,6,11,1,1,4,0,24,17,1
11602,173522,3g8DXQOSCHdJiP6LWe15l41X630A24i1,SpATywNh6bZuzm8s1ceuBUnMUAeoAHHw,1,0,0,0,0,0,1,0,1,0.14285714285714285,1,0.0,0,0,0,0,0,0,0,1,0,0,1,1
11603,173530,Zf1Jc5QcquhjoJHRxG4pap7I4hzRTYJR,A3fsA9Zfv1X2fVEQhTw51lKENdNrEqT3,7,3,2,0,2,0,2,0,9,1.2857142857142858,1,0.0,0,2,0,2,3,0,0,2,0,4,5,1
11604,173535,uZJ608ZEkxlVFGqNKhsCeDZLWUbA4PD1,SpATywNh6bZuzm8s1ceuBUnMUAeoAHHw,6,4,1,0,1,0,2,0,8,1.1428571428571428,1,0.0,0,1,0,1,4,0,0,2,0,2,6,1
11605,173548,4FxJMUgmuz0VWA8d9le3ZfFA82TMBA1F,SpATywNh6bZuzm8s1ceuBUnMUAeoAHHw,2,0,0,0,0,0,3,0,3,0.42857142857142855,1,0.0,0,0,0,0,0,0,0,3,0,0,3,1
11606,173567,ikPOJW9YXh94C3mCvABDqiGTiH3LcmdS,SpATywNh6bZuzm8s1ceuBUnMUAeoAHHw,7,4,1,0,0,0,3,0,8,1.1428571428571428,1,0.0,0,1,0,0,4,0,0,3,0,1,7,1
11607,173571,G8jKS2LX80mKysjSCHh84D1ShEGtlmZQ,SpATywNh6bZuzm8s1ceuBUnMUAeoAHHw,7,4,3,0,3,0,2,0,12,1.7142857142857142,1,0.0,0,3,0,3,4,0,0,2,0,6,6,1
11608,173591,qggUO4B0NhIPqMhJwgIAZM8ZaIbpr9nE,SpATywNh6bZuzm8s1ceuBUnMUAeoAHHw,4,2,1,0,1,0,1,0,5,0.7142857142857143,1,0.0,0,1,0,1,2,0,0,1,0,2,3,1
11609,173594,fPM57KFy9Z8MO9ygSzYz3vMhCvMUYCpW,SpATywNh6bZuzm8s1ceuBUnMUAeoAHHw,5,5,0,0,0,0,2,0,7,1.0,2,0.0,0,0,0,0,5,0,0,2,0,0,7,1
11610,173599,5tgxttwTGvGdqr8cj2QgTLRxUmP4TAY4,G8EPVSXsOYB5YQWZGiz1aVq5Pgr2GrQu,7,6,4,0,0,0,1,0,11,1.5714285714285714,1,0.0,0,4,0,0,6,0,0,1,0,4,7,1
11611,173608,cVDuOruQUULBpBiSrn6neQHWcaxV13ev,SpATywNh6bZuzm8s1ceuBUnMUAeoAHHw,5,3,0,0,0,0,2,0,5,0.7142857142857143,1,0.0,0,0,0,0,3,0,0,2,0,0,5,1
11612,173619,NEbJzZEXqlwyFwC2i2g8PArymW3iyx3y,SpATywNh6bZuzm8s1ceuBUnMUAeoAHHw,10,10,1,4,0,0,1,0,16,2.2857142857142856,1,0.0,3,1,4,0,7,0,0,1,0,8,8,1
11613,173626,aEIz8d9s1BC7n4fBeFuKK0VhLVqwpGhk,SpATywNh6bZuzm8s1ceuBUnMUAeoAHHw,29,25,14,28,6,38,24,3,138,19.714285714285715,2,0.0,6,14,24,6,19,38,4,24,3,50,88,0
11614,173633,XuL8lTuXJkhtcwxnA03sTLCPIFTjXstS,bWdj2GDclj5ofokWjzoa5jAwMkxCykd6,2,0,0,0,0,0,2,0,2,0.2857142857142857,1,0.0,0,0,0,0,0,0,0,2,0,0,2,0
11615,173640,CP7mFPmxcr1zJrcc0p3DHzVha0nwF2aG,SpATywNh6bZuzm8s1ceuBUnMUAeoAHHw,1,0,0,0,0,0,1,0,1,0.14285714285714285,1,0.0,0,0,0,0,0,0,0,1,0,0,1,1
11616,173668,3HZ5DvQGYoFNduhiKa7ozq49cGyUlk4Z,SpATywNh6bZuzm8s1ceuBUnMUAeoAHHw,6,5,2,0,2,0,2,0,11,1.5714285714285714,1,0.0,0,2,0,2,5,0,0,2,0,4,7,0
11617,173683,zKbFB2XJ8gemmfPKgB0q2D34TEqFCaPJ,SpATywNh6bZuzm8s1ceuBUnMUAeoAHHw,14,15,9,2,5,1,4,0,36,5.142857142857143,2,0.0,2,9,2,5,13,1,0,4,0,18,18,1
11618,173716,egPy9UABAfgaiori25BYfS5YDOglEmVj,A3fsA9Zfv1X2fVEQhTw51lKENdNrEqT3,2,0,0,0,0,0,3,0,3,0.42857142857142855,1,0.0,0,0,0,0,0,0,0,3,0,0,3,0
11619,173736,4c2V13oAQFO59UU1chPRZLOl7FAujTC1,SpATywNh6bZuzm8s1ceuBUnMUAeoAHHw,6,3,1,0,1,0,2,0,7,1.0,1,0.0,0,1,0,1,3,0,0,2,0,2,5,1
11620,173756,erRTxWjweQfemDfGIdFiZtJElfHYWRHc,bWdj2GDclj5ofokWjzoa5jAwMkxCykd6,7,7,4,0,1,0,1,0,13,1.8571428571428572,1,0.0,1,4,0,1,6,0,0,1,0,6,7,1
11621,173759,OO1JwGoh4BUjbVi8UpZSb7D59mBcs3nt,bWdj2GDclj5ofokWjzoa5jAwMkxCykd6,9,9,4,0,3,0,2,0,18,2.5714285714285716,2,0.0,0,4,0,3,9,0,0,2,0,7,11,1
11622,173769,V1ZkNQzruX55Th98WMMJPdYTYscmY4w6,G8EPVSXsOYB5YQWZGiz1aVq5Pgr2GrQu,4,3,1,0,0,0,2,0,6,0.8571428571428571,1,0.0,0,1,0,0,3,0,0,2,0,1,5,1
11623,173785,0fD6SAnP4saPahYnGKjue5y2gN1ArEeV,SpATywNh6bZuzm8s1ceuBUnMUAeoAHHw,5,5,0,0,0,0,1,0,6,0.8571428571428571,1,0.0,1,0,0,0,4,0,0,1,0,1,5,1
11624,173789,V49kN7knz1Exa9SGBoqDofPGVg1bZJ1X,SpATywNh6bZuzm8s1ceuBUnMUAeoAHHw,5,2,0,0,0,0,4,0,6,0.8571428571428571,1,0.0,0,0,0,0,2,0,0,4,0,0,6,1
11625,173799,4c2V13oAQFO59UU1chPRZLOl7FAujTC1,bWdj2GDclj5ofokWjzoa5jAwMkxCykd6,1,0,0,0,0,0,1,0,1,0.14285714285714285,1,0.0,0,0,0,0,0,0,0,1,0,0,1,1
11626,173800,dGPrMGXdE7T0kXaLgwTiDqQes2xGwEfE,SpATywNh6bZuzm8s1ceuBUnMUAeoAHHw,5,2,1,0,1,0,2,0,6,0.8571428571428571,1,0.0,0,1,0,1,2,0,0,2,0,2,4,1
11627,173809,5hyT5z1JULhKBFcJhS5p5DOzWWc2tHLq,RXDvfPUBYFlVdlueBFbLW0mhhAyGEqpt,4,4,0,0,0,0,2,0,6,0.8571428571428571,1,0.0,0,0,0,0,4,0,0,2,0,0,6,1
11628,173822,7OJn5p0XJ3SSGp9HZOHLtXBrnpU9Ao4g,SpATywNh6bZuzm8s1ceuBUnMUAeoAHHw,2,0,0,0,0,0,2,0,2,0.2857142857142857,1,0.0,0,0,0,0,0,0,0,2,0,0,2,1
11629,173833,XM8B0k6MFN508SQSrRkwnYc2DfmjmqwC,SpATywNh6bZuzm8s1ceuBUnMUAeoAHHw,6,5,3,0,3,0,1,0,12,1.7142857142857142,1,0.0,0,3,0,3,5,0,0,1,0,6,6,1
11630,173841,L0oAkWkSvsRVgCYEWBvSdFU8AYt2U4nO,A3fsA9Zfv1X2fVEQhTw51lKENdNrEqT3,1,0,0,0,0,0,1,0,1,0.14285714285714285,1,0.0,0,0,0,0,0,0,0,1,0,0,1,1
11631,173846,0OgHQAVhQz83ex7oEMaYHMGoui5vuRU7,A3fsA9Zfv1X2fVEQhTw51lKENdNrEqT3,1,0,0,0,0,0,1,0,1,0.14285714285714285,1,0.0,0,0,0,0,0,0,0,1,0,0,1,1
11632,173849,quIYM1jY47tlZKkC1EmJRDFcBV4a3Pzy,SpATywNh6bZuzm8s1ceuBUnMUAeoAHHw,1,0,0,0,0,0,2,0,2,0.2857142857142857,1,0.0,0,0,0,0,0,0,0,2,0,0,2,1
11633,173856,CZSUlXr6WslbpIsEEc2qwnkdO6NycdZe,G8EPVSXsOYB5YQWZGiz1aVq5Pgr2GrQu,15,21,0,6,1,1,8,0,37,5.285714285714286,3,0.0,6,0,3,1,15,1,3,8,0,10,27,0
11634,173879,8jJMgDkLCzStXvEhF0AcTzprTsXGO4BQ,SpATywNh6bZuzm8s1ceuBUnMUAeoAHHw,6,3,2,0,2,0,1,0,8,1.1428571428571428,1,0.0,0,2,0,2,3,0,0,1,0,4,4,1
11635,173885,worFKZrD9eECXAuz5EQKtbbV0K7MG3Jl,bWdj2GDclj5ofokWjzoa5jAwMkxCykd6,7,3,2,0,2,0,2,0,9,1.2857142857142858,1,0.0,0,2,0,2,3,0,0,2,0,4,5,1
11636,173898,ufiE5JBFPedCyqKTJCAri6PUpUEK2djS,A3fsA9Zfv1X2fVEQhTw51lKENdNrEqT3,9,4,3,0,3,0,2,0,12,1.7142857142857142,1,0.0,0,3,0,3,4,0,0,2,0,6,6,1
11637,173920,5meVJnfzVUZ3TsgkTSkPAZOA5DSRKfSE,SpATywNh6bZuzm8s1ceuBUnMUAeoAHHw,6,3,1,0,1,0,3,0,8,1.1428571428571428,3,0.0,0,1,0,1,3,0,0,3,0,2,6,1
11638,173927,2jcDulxQhwaZp6ERelJB4WRzpPoEb0N3,G8EPVSXsOYB5YQWZGiz1aVq5Pgr2GrQu,28,25,12,46,9,5,12,0,109,15.571428571428571,3,0.0,9,12,38,9,16,5,8,12,0,68,41,1
11639,173940,f05G8U1bqnSeHR5uQ0LJ86uC0GQPzhAD,A3fsA9Zfv1X2fVEQhTw51lKENdNrEqT3,8,3,2,0,2,0,3,1,11,1.5714285714285714,1,0.0,0,2,0,2,3,0,0,3,1,4,7,1
11640,173941,wyGIkmkgUJs3OEbZedPOFJN1j5K0BFAm,SpATywNh6bZuzm8s1ceuBUnMUAeoAHHw,7,3,2,0,2,0,2,0,9,1.2857142857142858,1,0.0,0,2,0,2,3,0,0,2,0,4,5,1
11641,173954,wLc4w0avBex1xIgZCkms6IVr5BNBkA7D,SpATywNh6bZuzm8s1ceuBUnMUAeoAHHw,2,0,0,0,0,0,3,0,3,0.42857142857142855,1,0.0,0,0,0,0,0,0,0,3,0,0,3,1
11642,174004,GEhSrQJnDGIPtxSV48fF8cpqKVHJt54S,RXDvfPUBYFlVdlueBFbLW0mhhAyGEqpt,1,0,0,0,0,0,1,0,1,0.14285714285714285,1,0.0,0,0,0,0,0,0,0,1,0,0,1,1
11643,174006,GEhSrQJnDGIPtxSV48fF8cpqKVHJt54S,G8EPVSXsOYB5YQWZGiz1aVq5Pgr2GrQu,1,0,0,0,0,0,2,0,2,0.2857142857142857,1,0.0,0,0,0,0,0,0,0,2,0,0,2,1
11644,174007,ylJgBhkBjfNNAcgSF9OKq7fmYB5lgYf4,G8EPVSXsOYB5YQWZGiz1aVq5Pgr2GrQu,15,16,0,6,2,1,9,1,35,5.0,1,0.0,8,0,3,2,8,1,3,9,1,13,22,1
11645,174023,qCRa9Z4oZ6HdXxtc9b3V1X8DNEfTKusC,SpATywNh6bZuzm8s1ceuBUnMUAeoAHHw,9,10,6,0,0,0,7,1,24,3.4285714285714284,2,0.0,1,6,0,0,9,0,0,7,1,7,17,1
11646,174033,5meVJnfzVUZ3TsgkTSkPAZOA5DSRKfSE,G8EPVSXsOYB5YQWZGiz1aVq5Pgr2GrQu,16,13,3,28,3,0,4,0,51,7.285714285714286,3,0.0,1,3,25,3,12,0,3,4,0,32,19,1
11647,174069,kj5o7wMZl1s4q0cggcmipnm7O7L6g4Ps,A3fsA9Zfv1X2fVEQhTw51lKENdNrEqT3,4,2,1,0,1,0,1,0,5,0.7142857142857143,1,0.0,0,1,0,1,2,0,0,1,0,2,3,1
11648,174113,exn3Chqg3cdAcaAWKVncMLTyArQT03uh,SpATywNh6bZuzm8s1ceuBUnMUAeoAHHw,1,0,0,0,0,0,1,0,1,0.14285714285714285,1,0.0,0,0,0,0,0,0,0,1,0,0,1,1
11649,174123,vAGOe6e2RHZZ1EaDZrX2SIPJIAyfl840,SpATywNh6bZuzm8s1ceuBUnMUAeoAHHw,16,20,11,14,7,1,6,0,59,8.428571428571429,3,0.0,7,11,14,7,13,1,0,6,0,39,20,1
11650,174132,JCoigkJDdJ3HsiIMjInfwYucYJL9vwo0,SpATywNh6bZuzm8s1ceuBUnMUAeoAHHw,3,0,0,0,0,3,2,0,5,0.7142857142857143,1,0.0,0,0,0,0,0,3,0,2,0,0,5,1
11651,174137,bpg5GXp9dzB6QmyT9ugqcjAogW2XrJ6V,A3fsA9Zfv1X2fVEQhTw51lKENdNrEqT3,13,21,5,0,3,1,11,1,42,6.0,2,0.0,3,5,0,3,18,1,0,11,1,11,31,1
11652,174145,hkyduknaDdkH1HJr9UkRJTFi9zraFQAD,bWdj2GDclj5ofokWjzoa5jAwMkxCykd6,1,0,0,0,0,0,1,0,1,0.14285714285714285,1,0.0,0,0,0,0,0,0,0,1,0,0,1,1
11653,174164,osRDAcCAd45utdgmq4pkwlsU7g3nJpqb,SpATywNh6bZuzm8s1ceuBUnMUAeoAHHw,9,5,3,0,1,1,8,1,19,2.7142857142857144,1,0.0,0,3,0,1,5,1,0,8,1,4,15,1
11654,174176,w0gcF7HyzsXAZFiicWTJytmCnNq4PSCG,bWdj2GDclj5ofokWjzoa5jAwMkxCykd6,2,0,0,0,0,0,2,0,2,0.2857142857142857,1,0.0,0,0,0,0,0,0,0,2,0,0,2,0
11655,174180,IcbiyGfugViHKrRGeKalQAZxzQcRgoyB,A3fsA9Zfv1X2fVEQhTw51lKENdNrEqT3,21,24,12,4,9,0,2,0,51,7.285714285714286,2,0.0,0,12,3,9,24,0,1,2,0,24,27,0
11656,174191,nzlGlMNKXi0UdFirNX3xHB3tsyudhSZw,bWdj2GDclj5ofokWjzoa5jAwMkxCykd6,3,2,0,0,0,0,2,0,4,0.5714285714285714,1,0.0,0,0,0,0,2,0,0,2,0,0,4,1
11657,174215,nzlGlMNKXi0UdFirNX3xHB3tsyudhSZw,A3fsA9Zfv1X2fVEQhTw51lKENdNrEqT3,2,0,0,0,0,0,2,0,2,0.2857142857142857,1,0.0,0,0,0,0,0,0,0,2,0,0,2,1
11658,174216,6CvCYVrFGBiuqZvZsIm2rGLzCSub3t09,SpATywNh6bZuzm8s1ceuBUnMUAeoAHHw,1,0,0,0,0,0,1,0,1,0.14285714285714285,1,0.0,0,0,0,0,0,0,0,1,0,0,1,0
11659,174245,AUQbcN6sP8jOc3r7pDcomR6R8baoxLvG,A3fsA9Zfv1X2fVEQhTw51lKENdNrEqT3,1,0,0,0,0,0,1,0,1,0.14285714285714285,1,0.0,0,0,0,0,0,0,0,1,0,0,1,1
11660,174261,9D8Fr85Y0xJSTSvXENunTRQkQQzpKKhe,A3fsA9Zfv1X2fVEQhTw51lKENdNrEqT3,2,0,0,0,0,3,1,0,4,0.5714285714285714,1,0.0,0,0,0,0,0,3,0,1,0,0,4,1
11661,174270,JBAytsWAbTeV6GWhSZsHWNpJgF2JgbBV,SpATywNh6bZuzm8s1ceuBUnMUAeoAHHw,10,10,5,0,3,0,4,0,22,3.142857142857143,1,0.0,0,5,0,3,10,0,0,4,0,8,14,1
11662,174330,J3VXT3AGxePcqOmM7ZzWzkqh6USRsZv2,bWdj2GDclj5ofokWjzoa5jAwMkxCykd6,1,0,0,0,0,0,1,0,1,0.14285714285714285,1,0.0,0,0,0,0,0,0,0,1,0,0,1,1
11663,174333,J3VXT3AGxePcqOmM7ZzWzkqh6USRsZv2,A3fsA9Zfv1X2fVEQhTw51lKENdNrEqT3,1,0,0,0,0,0,1,0,1,0.14285714285714285,1,0.0,0,0,0,0,0,0,0,1,0,0,1,1
11664,174343,z5b37rtZXpcAYDG2omaxcs76JrGc20dV,SpATywNh6bZuzm8s1ceuBUnMUAeoAHHw,14,16,11,0,7,0,4,0,38,5.428571428571429,1,0.0,0,11,0,7,16,0,0,4,0,18,20,0
11665,174366,NiXPZUmEILmWUPwXexYxtHvaIL7QdjCQ,G8EPVSXsOYB5YQWZGiz1aVq5Pgr2GrQu,1,0,0,0,0,0,1,0,1,0.14285714285714285,1,0.0,0,0,0,0,0,0,0,1,0,0,1,1
11666,174374,kv6R7WjolUetaoWMs79hGLWsktu3yDdz,A3fsA9Zfv1X2fVEQhTw51lKENdNrEqT3,6,3,1,0,1,0,2,0,7,1.0,1,0.0,0,1,0,1,3,0,0,2,0,2,5,1
11667,174379,BeoWdDFNsVFqWVq3B4qjYh8vNjNTgwSB,A3fsA9Zfv1X2fVEQhTw51lKENdNrEqT3,9,13,7,0,1,0,18,0,39,5.571428571428571,3,0.0,1,7,0,1,12,0,0,18,0,9,30,1
11668,174420,LKippngJk3cGSHQFQuBifcn7F1qfi1gi,A3fsA9Zfv1X2fVEQhTw51lKENdNrEqT3,7,3,2,0,2,0,2,0,9,1.2857142857142858,1,0.0,0,2,0,2,3,0,0,2,0,4,5,1
11669,174441,TVb48KNX44nTfeYliD6K0aUmcz1Uhqk3,SpATywNh6bZuzm8s1ceuBUnMUAeoAHHw,1,0,0,0,0,0,3,0,3,0.42857142857142855,1,0.0,0,0,0,0,0,0,0,3,0,0,3,1
11670,174444,2dsmXUwyJ6i3C5akCdjurWqi0Hs9JJIw,A3fsA9Zfv1X2fVEQhTw51lKENdNrEqT3,4,2,1,0,1,0,1,0,5,0.7142857142857143,1,0.0,0,1,0,1,2,0,0,1,0,2,3,1
11671,174476,2N9sOZSDFqgItMU0I0RAvak4oCcmSCqn,SpATywNh6bZuzm8s1ceuBUnMUAeoAHHw,1,0,0,0,0,0,1,0,1,0.14285714285714285,1,0.0,0,0,0,0,0,0,0,1,0,0,1,1
11672,174511,4JCvqkgGduxKKeDEkCNb6gSmycI4iKkL,SpATywNh6bZuzm8s1ceuBUnMUAeoAHHw,6,3,2,0,1,0,2,0,8,1.1428571428571428,1,0.0,0,2,0,1,3,0,0,2,0,3,5,1
11673,174524,OHjVywgSVBuE3jor7Q0ui9J2rATPYj5o,bWdj2GDclj5ofokWjzoa5jAwMkxCykd6,8,3,2,0,2,0,5,0,12,1.7142857142857142,1,0.0,0,2,0,2,3,0,0,5,0,4,8,1
11674,174526,YGWpaBK18BI7gxW0S5kJOHKnKUXsGFtx,SpATywNh6bZuzm8s1ceuBUnMUAeoAHHw,1,0,0,0,0,0,1,0,1,0.14285714285714285,1,0.0,0,0,0,0,0,0,0,1,0,0,1,1
11675,174534,uxH2QBwZxSFN9LkkI09Zd3NZx6wgvi3y,A3fsA9Zfv1X2fVEQhTw51lKENdNrEqT3,7,4,1,0,1,0,2,0,8,1.1428571428571428,1,0.0,0,1,0,1,4,0,0,2,0,2,6,1
11676,174562,wtDZ1vT1vZnNtf66B6E3homHnmEWYVrg,RXDvfPUBYFlVdlueBFbLW0mhhAyGEqpt,9,6,0,0,0,0,4,2,12,1.7142857142857142,1,0.0,0,0,0,0,6,0,0,4,2,0,12,1
11677,174588,GvWLI1Mjpde6Jh0s8HrsDR9KjfiyAndZ,SpATywNh6bZuzm8s1ceuBUnMUAeoAHHw,1,0,0,0,0,0,1,0,1,0.14285714285714285,1,0.0,0,0,0,0,0,0,0,1,0,0,1,1
11678,174592,Q80okLXehG3FaUclazDQaglICbThrfeN,A3fsA9Zfv1X2fVEQhTw51lKENdNrEqT3,12,4,2,0,2,0,9,1,18,2.5714285714285716,1,0.0,0,2,0,2,4,0,0,9,1,4,14,1
11679,174599,zbOrtc172Sp0ZiF8CTU6kMNb51nYxkNM,G8EPVSXsOYB5YQWZGiz1aVq5Pgr2GrQu,7,3,2,0,2,0,2,0,9,1.2857142857142858,1,0.0,0,2,0,2,3,0,0,2,0,4,5,1
11680,174614,TEtpertndC0kxUAzNDZsnaaHXZ1UiUgn,A3fsA9Zfv1X2fVEQhTw51lKENdNrEqT3,6,2,1,0,1,0,4,3,11,1.5714285714285714,1,0.0,0,1,0,1,2,0,0,4,3,2,9,1
11681,174621,egEAM55ohFZCeKZbLS4kJXezxBBDUuZO,SpATywNh6bZuzm8s1ceuBUnMUAeoAHHw,5,2,1,0,1,0,2,0,6,0.8571428571428571,1,0.0,0,1,0,1,2,0,0,2,0,2,4,1
11682,174624,oGK3c8nk6Ftl3V2u1zOvslszD4LDLr3w,SpATywNh6bZuzm8s1ceuBUnMUAeoAHHw,8,19,12,0,5,0,7,0,43,6.142857142857143,3,0.0,2,12,0,5,17,0,0,7,0,19,24,1
11683,174627,egEAM55ohFZCeKZbLS4kJXezxBBDUuZO,G8EPVSXsOYB5YQWZGiz1aVq5Pgr2GrQu,5,2,1,0,1,0,2,0,6,0.8571428571428571,1,0.0,0,1,0,1,2,0,0,2,0,2,4,1
11684,174642,AuxkP8NAszvIKyEBwpG0mQcLLw7Eoojr,SpATywNh6bZuzm8s1ceuBUnMUAeoAHHw,6,4,1,0,1,0,2,0,8,1.1428571428571428,1,0.0,0,1,0,1,4,0,0,2,0,2,6,1
11685,174645,lJdTg9WUYwumFfeQmhmLXhBEAFP0NsAi,A3fsA9Zfv1X2fVEQhTw51lKENdNrEqT3,1,0,0,0,0,0,1,0,1,0.14285714285714285,1,0.0,0,0,0,0,0,0,0,1,0,0,1,1
11686,174652,mKdNKRnKsY7oY3LUCJFqlU9FBtiBixdP,SpATywNh6bZuzm8s1ceuBUnMUAeoAHHw,2,0,0,0,0,0,3,0,3,0.42857142857142855,1,0.0,0,0,0,0,0,0,0,3,0,0,3,1
11687,174664,6FBBfTPa9rAGe2i9z04q5KK2WXVduwvy,bWdj2GDclj5ofokWjzoa5jAwMkxCykd6,5,3,2,0,2,0,2,0,9,1.2857142857142858,1,0.0,0,2,0,2,3,0,0,2,0,4,5,1
11688,174670,Nt2MuvKq8ehhC9cDQZ9wTGuVcTn0ishD,bWdj2GDclj5ofokWjzoa5jAwMkxCykd6,1,0,0,0,0,0,1,0,1,0.14285714285714285,1,0.0,0,0,0,0,0,0,0,1,0,0,1,1
11689,174671,oseHKim5ugRciFh8lXIQ174blllPPfFO,G8EPVSXsOYB5YQWZGiz1aVq5Pgr2GrQu,6,5,2,0,1,0,2,0,10,1.4285714285714286,1,0.0,0,2,0,1,5,0,0,2,0,3,7,1
11690,174672,N5iDERl36Pe29yDG8gDe9a99dYgqwB7y,A3fsA9Zfv1X2fVEQhTw51lKENdNrEqT3,1,0,0,0,0,0,1,0,1,0.14285714285714285,1,0.0,0,0,0,0,0,0,0,1,0,0,1,1
11691,174690,DsHBF70w6SbplBHmPm6nRUC7pSdaJJWa,G8EPVSXsOYB5YQWZGiz1aVq5Pgr2GrQu,10,6,1,0,1,0,3,0,11,1.5714285714285714,1,0.0,0,1,0,1,6,0,0,3,0,2,9,1
11692,174691,5CEPXEXe8kyZX8bu6GUTNCOjuQHWI7O6,G8EPVSXsOYB5YQWZGiz1aVq5Pgr2GrQu,11,15,1,10,0,1,3,0,30,4.285714285714286,1,0.0,9,1,7,0,6,1,3,3,0,17,13,1
11693,174695,mu7Zdr1ChN6xNMWE8Otd7Si7TQhm7pEQ,bWdj2GDclj5ofokWjzoa5jAwMkxCykd6,6,5,3,0,2,0,5,0,15,2.142857142857143,2,0.0,0,3,0,2,5,0,0,5,0,5,10,1
11694,174696,5OhdzLluLI4b0UetZ6QtwaKcHtelD4GM,SpATywNh6bZuzm8s1ceuBUnMUAeoAHHw,1,0,0,0,0,0,1,0,1,0.14285714285714285,1,0.0,0,0,0,0,0,0,0,1,0,0,1,1
11695,174705,Ec3rYw74ZqWh1F7dxiEcLU29Nc2ci1fM,SpATywNh6bZuzm8s1ceuBUnMUAeoAHHw,1,0,0,0,0,0,1,0,1,0.14285714285714285,1,0.0,0,0,0,0,0,0,0,1,0,0,1,1
11696,174721,ogurveh5dgwQ7omkU0IctcIseCFtiniL,bWdj2GDclj5ofokWjzoa5jAwMkxCykd6,1,0,0,0,0,0,1,0,1,0.14285714285714285,1,0.0,0,0,0,0,0,0,0,1,0,0,1,0
11697,174722,ynJJFwajTtaKh2c9i2j2wRxuEmNuGHmW,SpATywNh6bZuzm8s1ceuBUnMUAeoAHHw,11,10,1,0,1,0,3,0,15,2.142857142857143,1,0.0,0,1,0,1,10,0,0,3,0,2,13,1
11698,174743,RGm3JAeEXLRP4KOsIq5BNnrMmXFgjKxb,SpATywNh6bZuzm8s1ceuBUnMUAeoAHHw,6,2,1,0,1,0,6,0,10,1.4285714285714286,1,0.0,0,1,0,1,2,0,0,6,0,2,8,1
11699,174771,wKNO0Jje7WXvAVQ9yfigFflnCrR4q8AL,RXDvfPUBYFlVdlueBFbLW0mhhAyGEqpt,2,0,0,0,0,0,2,0,2,0.2857142857142857,1,0.0,0,0,0,0,0,0,0,2,0,0,2,1
11700,174774,gPm1W1ZGaxTMbwnt8Qfxv6TCL5SZrMk2,SpATywNh6bZuzm8s1ceuBUnMUAeoAHHw,5,3,1,0,1,0,2,0,7,1.0,1,0.0,0,1,0,1,3,0,0,2,0,2,5,1
11701,174803,t0EDN5m0sWGzS7LPSyhC6BROmEBzl1eB,SpATywNh6bZuzm8s1ceuBUnMUAeoAHHw,7,3,2,0,2,0,2,0,9,1.2857142857142858,1,0.0,0,2,0,2,3,0,0,2,0,4,5,1
11702,174807,UqNrOaSixV1onFxLeaR8LpJ04uyM9vCP,SpATywNh6bZuzm8s1ceuBUnMUAeoAHHw,6,5,2,0,1,0,2,0,10,1.4285714285714286,1,0.0,2,2,0,1,3,0,0,2,0,5,5,1
11703,174811,JdEJSTgj9mzyZgP3wbpkgBRlhmZAWyOb,A3fsA9Zfv1X2fVEQhTw51lKENdNrEqT3,8,6,1,0,1,0,3,0,11,1.5714285714285714,1,0.0,0,1,0,1,6,0,0,3,0,2,9,1
11704,174815,EUIAvqEpYGuf3oElkvmsxEBDGD0USQRc,SpATywNh6bZuzm8s1ceuBUnMUAeoAHHw,8,2,1,0,1,1,5,1,11,1.5714285714285714,1,0.0,0,1,0,1,2,1,0,5,1,2,9,1
11705,174834,jlfxlhUtD2UxnrEYxTWNdi2LKtu0owFx,SpATywNh6bZuzm8s1ceuBUnMUAeoAHHw,12,12,1,0,1,0,5,0,19,2.7142857142857144,1,0.0,0,1,0,1,12,0,0,5,0,2,17,1
11706,174850,JsUvqozri9AItThk54BBjEwYIqDey9JK,SpATywNh6bZuzm8s1ceuBUnMUAeoAHHw,29,70,24,34,11,0,8,0,147,21.0,5,0.0,12,24,30,11,58,0,4,8,0,77,70,1
11707,174851,wlfhNc0EqwNzSbWGuR5Gw22PX4idrOB9,bWdj2GDclj5ofokWjzoa5jAwMkxCykd6,6,4,3,0,2,0,2,0,11,1.5714285714285714,1,0.0,0,3,0,2,4,0,0,2,0,5,6,1
11708,174852,B4ycicxBkvAvNmF15lIWWxxW3Xn9MHa9,SpATywNh6bZuzm8s1ceuBUnMUAeoAHHw,1,0,0,0,0,0,1,0,1,0.14285714285714285,1,0.0,0,0,0,0,0,0,0,1,0,0,1,1
11709,174889,JsUvqozri9AItThk54BBjEwYIqDey9JK,bWdj2GDclj5ofokWjzoa5jAwMkxCykd6,1,0,0,0,0,0,1,0,1,0.14285714285714285,1,0.0,0,0,0,0,0,0,0,1,0,0,1,1
11710,174890,JsUvqozri9AItThk54BBjEwYIqDey9JK,A3fsA9Zfv1X2fVEQhTw51lKENdNrEqT3,1,0,0,0,0,0,1,0,1,0.14285714285714285,1,0.0,0,0,0,0,0,0,0,1,0,0,1,1
11711,174896,W38DcguBOORgyx8AQARyx9O00yMNPg6e,A3fsA9Zfv1X2fVEQhTw51lKENdNrEqT3,24,25,13,0,8,0,4,0,50,7.142857142857143,2,0.0,0,13,0,8,25,0,0,4,0,21,29,1
11712,174921,MkluYfJDefHhcRPY3QsRGiWxg2BDcm18,G8EPVSXsOYB5YQWZGiz1aVq5Pgr2GrQu,1,0,0,0,0,0,1,0,1,0.14285714285714285,1,0.0,0,0,0,0,0,0,0,1,0,0,1,1
11713,174933,OAGaZXcjJISx6VWaj2xIjx8JDYNnZK9L,SpATywNh6bZuzm8s1ceuBUnMUAeoAHHw,6,3,1,0,1,0,3,1,9,1.2857142857142858,1,0.0,0,1,0,1,3,0,0,3,1,2,7,1
11714,174947,YXkiTHpE2a6E2kDFUh3HT5sKHSlA7gXq,A3fsA9Zfv1X2fVEQhTw51lKENdNrEqT3,21,16,10,0,8,0,3,0,37,5.285714285714286,1,0.0,5,10,0,8,11,0,0,3,0,23,14,1
11715,174955,FdYyZ3eUFT2W1b2FuK1FqAPaILYLChJS,SpATywNh6bZuzm8s1ceuBUnMUAeoAHHw,9,6,1,0,0,0,3,2,12,1.7142857142857142,1,0.0,0,1,0,0,6,0,0,3,2,1,11,0
11716,174972,3e3NS2FF76Q2Wd0Q299lzVRy95TZUP9V,SpATywNh6bZuzm8s1ceuBUnMUAeoAHHw,4,2,0,0,0,0,3,0,5,0.7142857142857143,1,0.0,0,0,0,0,2,0,0,3,0,0,5,1
11717,174973,igeK6rUQT7Ehyj7yY5oAEj8DvOITiuBO,G8EPVSXsOYB5YQWZGiz1aVq5Pgr2GrQu,19,11,9,32,6,0,2,0,60,8.571428571428571,1,0.0,0,9,27,6,11,0,5,2,0,42,18,1
11718,174983,ZzaZO5citAcoeYBQ4xnco2bMgq0deP0c,bWdj2GDclj5ofokWjzoa5jAwMkxCykd6,14,14,0,12,2,6,7,1,42,6.0,2,0.0,5,0,10,2,9,6,2,7,1,17,25,0
11719,174987,U9FricROMjKQqr8IqFFHC3G0wWxulVGt,G8EPVSXsOYB5YQWZGiz1aVq5Pgr2GrQu,4,6,1,0,1,0,2,0,10,1.4285714285714286,1,0.0,2,1,0,1,4,0,0,2,0,4,6,1
11720,175011,fC8iLtYIOHY1gQcgztWp75xXkE8muKRF,bWdj2GDclj5ofokWjzoa5jAwMkxCykd6,6,5,2,0,1,0,3,0,11,1.5714285714285714,1,0.0,1,2,0,1,4,0,0,3,0,4,7,1
11721,175031,fiQPKilJkIFWShuteKFoAKrsoRjAoTQq,G8EPVSXsOYB5YQWZGiz1aVq5Pgr2GrQu,14,14,7,22,2,3,7,0,55,7.857142857142857,3,0.0,1,7,20,2,13,3,2,7,0,30,25,1
11722,175032,7OUEidh05JWByOEFcemhEZFfVFKOEreA,SpATywNh6bZuzm8s1ceuBUnMUAeoAHHw,7,4,2,0,2,0,2,0,10,1.4285714285714286,1,0.0,0,2,0,2,4,0,0,2,0,4,6,1
11723,175034,QXR5sUbv4S12yRWxM4AzFUAlm7Vhd4VU,bWdj2GDclj5ofokWjzoa5jAwMkxCykd6,7,2,1,0,1,0,6,1,11,1.5714285714285714,1,0.0,0,1,0,1,2,0,0,6,1,2,9,1
11724,175038,LeinRShMpys6hI3Pst69nKDdXo0lcJFw,bWdj2GDclj5ofokWjzoa5jAwMkxCykd6,3,2,0,0,0,0,1,0,3,0.42857142857142855,1,0.0,0,0,0,0,2,0,0,1,0,0,3,1
11725,175042,fN9yVRde7R2H7fN2gH8pJh2bfcNVmJQE,SpATywNh6bZuzm8s1ceuBUnMUAeoAHHw,15,19,7,13,3,1,6,1,50,7.142857142857143,2,0.0,9,7,11,3,10,1,2,6,1,30,20,1
11726,175054,WoXtpP4H4ghgkRBv3UuiyrHP7GFAl55y,SpATywNh6bZuzm8s1ceuBUnMUAeoAHHw,1,0,0,0,0,0,1,0,1,0.14285714285714285,1,0.0,0,0,0,0,0,0,0,1,0,0,1,1
11727,175059,WoXtpP4H4ghgkRBv3UuiyrHP7GFAl55y,RXDvfPUBYFlVdlueBFbLW0mhhAyGEqpt,1,0,0,0,0,0,1,0,1,0.14285714285714285,1,0.0,0,0,0,0,0,0,0,1,0,0,1,1
11728,175061,WoXtpP4H4ghgkRBv3UuiyrHP7GFAl55y,A3fsA9Zfv1X2fVEQhTw51lKENdNrEqT3,1,0,0,0,0,0,1,0,1,0.14285714285714285,1,0.0,0,0,0,0,0,0,0,1,0,0,1,1
11729,175080,04NERqmo4Pna5vlN4nEAbOXFR0ZTnfBC,RXDvfPUBYFlVdlueBFbLW0mhhAyGEqpt,1,0,0,0,0,0,0,1,1,0.14285714285714285,1,0.0,0,0,0,0,0,0,0,0,1,0,1,1
11730,175088,tRdhN0lgigOD57KMBTj72ZVM1o7s8RGj,SpATywNh6bZuzm8s1ceuBUnMUAeoAHHw,3,0,0,0,0,1,2,1,4,0.5714285714285714,1,0.0,0,0,0,0,0,1,0,2,1,0,4,1
11731,175089,BCJye2AaALRUT5f6ppYoCiYPMviVlBsr,G8EPVSXsOYB5YQWZGiz1aVq5Pgr2GrQu,1,0,0,0,0,0,1,0,1,0.14285714285714285,1,0.0,0,0,0,0,0,0,0,1,0,0,1,1
11732,175094,8udxV2CUMzjrYKDDJj8ojQtJ8oHj3KH6,SpATywNh6bZuzm8s1ceuBUnMUAeoAHHw,1,0,0,0,0,0,1,0,1,0.14285714285714285,1,0.0,0,0,0,0,0,0,0,1,0,0,1,1
11733,175096,wqGS9CBgLL8X8ANSg0Bc9uExUh5JuoRs,SpATywNh6bZuzm8s1ceuBUnMUAeoAHHw,6,4,1,0,1,1,2,0,9,1.2857142857142858,1,0.0,0,1,0,1,4,1,0,2,0,2,7,1
11734,175099,YaVHU5tTcyyfMEQ1RbrZTjEqZdgwcEOg,SpATywNh6bZuzm8s1ceuBUnMUAeoAHHw,1,0,0,0,0,0,1,0,1,0.14285714285714285,1,0.0,0,0,0,0,0,0,0,1,0,0,1,1
11735,175102,9quScdvVngFePST1NL7WzZK7VxMmTv5I,SpATywNh6bZuzm8s1ceuBUnMUAeoAHHw,2,0,0,0,0,0,2,0,2,0.2857142857142857,1,0.0,0,0,0,0,0,0,0,2,0,0,2,1
11736,175103,GqIgVQOxdNB1N6Xk3EJGvsEMXjZzOyVC,RXDvfPUBYFlVdlueBFbLW0mhhAyGEqpt,1,0,0,0,0,0,1,0,1,0.14285714285714285,1,0.0,0,0,0,0,0,0,0,1,0,0,1,1
11737,175109,cKCzrCCCXe9nkBgWepq9AEXje7SITRTz,SpATywNh6bZuzm8s1ceuBUnMUAeoAHHw,1,0,0,0,0,0,1,0,1,0.14285714285714285,1,0.0,0,0,0,0,0,0,0,1,0,0,1,1
11738,175119,EssEs0A6tGxDo6Ay7pdYrTC6BG7PsXvp,SpATywNh6bZuzm8s1ceuBUnMUAeoAHHw,3,2,1,0,0,0,1,0,4,0.5714285714285714,1,0.0,0,1,0,0,2,0,0,1,0,1,3,1
11739,175124,bI8WLmS7QAEP1Zf4KEJ36LOr2fpYMzKz,SpATywNh6bZuzm8s1ceuBUnMUAeoAHHw,1,0,0,0,0,0,1,0,1,0.14285714285714285,1,0.0,0,0,0,0,0,0,0,1,0,0,1,1
11740,175139,Vdk84P68xIHXBGrWqw3oEozZYT063dLv,A3fsA9Zfv1X2fVEQhTw51lKENdNrEqT3,12,11,8,0,7,0,6,0,32,4.571428571428571,2,0.0,0,8,0,7,11,0,0,6,0,15,17,1
11741,175145,U6qE2fx7rlT2WEmACzAkhjUhd8LCbR1p,A3fsA9Zfv1X2fVEQhTw51lKENdNrEqT3,8,4,3,0,3,0,1,0,11,1.5714285714285714,1,0.0,0,3,0,3,4,0,0,1,0,6,5,1
11742,175146,JJM4kJdvA7b7ijrHBmkFLiNbnfS1jEmD,bWdj2GDclj5ofokWjzoa5jAwMkxCykd6,16,13,6,84,5,0,7,0,115,16.428571428571427,1,0.0,7,6,80,5,6,0,4,7,0,98,17,1
11743,175161,rgXYdeKsNCNQdUbzf1eDuMPLA1J24DWk,G8EPVSXsOYB5YQWZGiz1aVq5Pgr2GrQu,6,3,2,0,1,0,2,0,8,1.1428571428571428,1,0.0,0,2,0,1,3,0,0,2,0,3,5,1
11744,175167,o9SCOAY5nuSxaVorNF1mq3E0AGKQbCox,SpATywNh6bZuzm8s1ceuBUnMUAeoAHHw,15,17,0,4,1,7,3,0,32,4.571428571428571,1,0.0,6,0,3,1,11,7,1,3,0,10,22,1
11745,175169,lRD6FNYJFilie5IwmFYNqrJax7QPJsdZ,bWdj2GDclj5ofokWjzoa5jAwMkxCykd6,6,2,1,0,1,3,5,0,12,1.7142857142857142,1,0.0,0,1,0,1,2,3,0,5,0,2,10,1
11746,175170,o9SCOAY5nuSxaVorNF1mq3E0AGKQbCox,A3fsA9Zfv1X2fVEQhTw51lKENdNrEqT3,1,0,0,0,0,0,1,0,1,0.14285714285714285,1,0.0,0,0,0,0,0,0,0,1,0,0,1,1
11747,175176,wKRwl5IweKiDuBtEeNntISPadPzFvRK2,SpATywNh6bZuzm8s1ceuBUnMUAeoAHHw,4,2,1,0,0,0,2,0,5,0.7142857142857143,1,0.0,0,1,0,0,2,0,0,2,0,1,4,1
11748,175187,bF4ZkA0Htjy5dPXooPjuHY2mhd8vbWYM,bWdj2GDclj5ofokWjzoa5jAwMkxCykd6,4,3,2,0,2,0,1,0,8,1.1428571428571428,1,0.0,0,2,0,2,3,0,0,1,0,4,4,1
11749,175193,8RK6HQkv51lSsSE1n9EptQjyHrkMwfO0,G8EPVSXsOYB5YQWZGiz1aVq5Pgr2GrQu,1,0,0,0,0,0,1,0,1,0.14285714285714285,1,0.0,0,0,0,0,0,0,0,1,0,0,1,1
11750,175205,ieuEScQs74mRiAwwPAhRyLP4C41miyHf,SpATywNh6bZuzm8s1ceuBUnMUAeoAHHw,4,9,4,0,0,0,1,0,14,2.0,1,0.0,0,4,0,0,9,0,0,1,0,4,10,1
11751,175256,jdfd8H9lnYttHWf9Izxs2MscynFXyhGW,A3fsA9Zfv1X2fVEQhTw51lKENdNrEqT3,4,5,1,0,0,0,1,0,7,1.0,1,0.0,0,1,0,0,5,0,0,1,0,1,6,0
11752,175264,jiPhRLmAJuGQCkjQnkZRItYBXUJwjlNA,RXDvfPUBYFlVdlueBFbLW0mhhAyGEqpt,8,2,1,0,1,1,5,1,11,1.5714285714285714,1,0.0,0,1,0,1,2,1,0,5,1,2,9,1
11753,175272,vmZoErHPHgTkQX32S5GK0CiVkZhSYU5z,bWdj2GDclj5ofokWjzoa5jAwMkxCykd6,1,0,0,0,0,0,1,0,1,0.14285714285714285,1,0.0,0,0,0,0,0,0,0,1,0,0,1,1
11754,175288,0UufwnomhqqyQLnmEpyIsrXn6C4McKHM,SpATywNh6bZuzm8s1ceuBUnMUAeoAHHw,1,0,0,0,0,0,1,0,1,0.14285714285714285,1,0.0,0,0,0,0,0,0,0,1,0,0,1,1
11755,175292,0UufwnomhqqyQLnmEpyIsrXn6C4McKHM,RXDvfPUBYFlVdlueBFbLW0mhhAyGEqpt,1,0,0,0,0,0,1,0,1,0.14285714285714285,1,0.0,0,0,0,0,0,0,0,1,0,0,1,1
11756,175293,m4eQNvYwZjYoMZYM2VsuhiDxtIFSYKWh,RXDvfPUBYFlVdlueBFbLW0mhhAyGEqpt,9,8,1,0,2,0,2,0,13,1.8571428571428572,1,0.0,3,1,0,2,5,0,0,2,0,6,7,1
11757,175305,SZHxM16r0lTBVocJi0Li5OQAgxZ4K7jz,bWdj2GDclj5ofokWjzoa5jAwMkxCykd6,1,0,0,0,0,0,1,0,1,0.14285714285714285,1,0.0,0,0,0,0,0,0,0,1,0,0,1,1
11758,175309,qAxjBZuCZJr25UpKUqhYPsfHWE6cqLNR,bWdj2GDclj5ofokWjzoa5jAwMkxCykd6,6,3,1,0,2,1,4,0,11,1.5714285714285714,1,0.0,2,1,0,2,1,1,0,4,0,5,6,1
11759,175322,YaeMtpEn02jmas25d0067kgG6T0CswLK,A3fsA9Zfv1X2fVEQhTw51lKENdNrEqT3,1,0,0,0,0,0,1,0,1,0.14285714285714285,1,0.0,0,0,0,0,0,0,0,1,0,0,1,1
11760,175335,7NbjM2q5TtspVGtHsqtgwdUTaXZ3QvNC,SpATywNh6bZuzm8s1ceuBUnMUAeoAHHw,7,3,1,0,0,0,4,1,9,1.2857142857142858,1,0.0,0,1,0,0,3,0,0,4,1,1,8,1
11761,175337,4jGp0wM4bWQL7YeW1fZnRYCrYjnWjDPp,A3fsA9Zfv1X2fVEQhTw51lKENdNrEqT3,2,0,0,0,0,0,2,0,2,0.2857142857142857,1,0.0,0,0,0,0,0,0,0,2,0,0,2,1
11762,175344,2uB3uMcrVV3zJUl7YzGLBsKaaqyb6VDm,bWdj2GDclj5ofokWjzoa5jAwMkxCykd6,1,0,0,0,0,0,1,0,1,0.14285714285714285,1,0.0,0,0,0,0,0,0,0,1,0,0,1,1
11763,175349,JISGCdjNZHYHcQ6XpDypgJiHQutxiO7F,bWdj2GDclj5ofokWjzoa5jAwMkxCykd6,1,0,0,0,0,0,1,0,1,0.14285714285714285,1,0.0,0,0,0,0,0,0,0,1,0,0,1,1
11764,175376,JwpnWAbXqqokshNbyxBH2QHaOUPb8wrj,SpATywNh6bZuzm8s1ceuBUnMUAeoAHHw,5,1,1,0,1,0,2,0,5,0.7142857142857143,1,0.0,0,1,0,1,1,0,0,2,0,2,3,0
11765,175380,xyhTJkgGghEribeWkvfmDO529PeI6BOD,A3fsA9Zfv1X2fVEQhTw51lKENdNrEqT3,23,16,11,0,11,0,4,0,42,6.0,1,0.0,0,11,0,11,16,0,0,4,0,22,20,1
11766,175382,YcbMhXf6WOxBHwzY0X9hWTypvQthAicg,SpATywNh6bZuzm8s1ceuBUnMUAeoAHHw,5,3,2,0,1,0,2,0,8,1.1428571428571428,2,0.0,0,2,0,1,3,0,0,2,0,3,5,1
11767,175390,EvySN154YDM9eHA8rncD5Y4XnKitTOWj,SpATywNh6bZuzm8s1ceuBUnMUAeoAHHw,1,0,0,0,0,0,1,0,1,0.14285714285714285,1,0.0,0,0,0,0,0,0,0,1,0,0,1,1
11768,175392,7MT1Ev8neQja0JRLlNFWlmHGJaMzca7N,SpATywNh6bZuzm8s1ceuBUnMUAeoAHHw,1,0,0,0,0,0,1,0,1,0.14285714285714285,1,0.0,0,0,0,0,0,0,0,1,0,0,1,1
11769,175393,EvySN154YDM9eHA8rncD5Y4XnKitTOWj,bWdj2GDclj5ofokWjzoa5jAwMkxCykd6,1,0,0,0,0,0,1,0,1,0.14285714285714285,1,0.0,0,0,0,0,0,0,0,1,0,0,1,1
11770,175396,EvySN154YDM9eHA8rncD5Y4XnKitTOWj,A3fsA9Zfv1X2fVEQhTw51lKENdNrEqT3,1,0,0,0,0,0,1,0,1,0.14285714285714285,1,0.0,0,0,0,0,0,0,0,1,0,0,1,1
11771,175397,MoQLSLdgc8N78DNeGEQHypzHbyf063p0,bWdj2GDclj5ofokWjzoa5jAwMkxCykd6,1,0,0,0,0,0,1,0,1,0.14285714285714285,1,0.0,0,0,0,0,0,0,0,1,0,0,1,1
11772,175398,MoQLSLdgc8N78DNeGEQHypzHbyf063p0,A3fsA9Zfv1X2fVEQhTw51lKENdNrEqT3,1,0,0,0,0,0,1,0,1,0.14285714285714285,1,0.0,0,0,0,0,0,0,0,1,0,0,1,1
11773,175417,kEoxxa2otTzPL6nc12ZeJYYFyGEjvH7q,SpATywNh6bZuzm8s1ceuBUnMUAeoAHHw,1,0,0,0,0,0,1,0,1,0.14285714285714285,1,0.0,0,0,0,0,0,0,0,1,0,0,1,1
11774,175422,JLpYHpRsamf04qcVxCPYwLYYhT8v6H5r,A3fsA9Zfv1X2fVEQhTw51lKENdNrEqT3,9,4,3,0,3,0,2,0,12,1.7142857142857142,1,0.0,0,3,0,3,4,0,0,2,0,6,6,1
11775,175424,qMTyC3MFcCmdQ8Eat2z9hmr6N3Nnskt1,SpATywNh6bZuzm8s1ceuBUnMUAeoAHHw,6,2,1,0,0,3,5,0,11,1.5714285714285714,1,0.0,0,1,0,0,2,3,0,5,0,1,10,1
11776,175437,Ht8gQquuDWuHnE8TA1lycaHJ8C9MVf20,fbPkOYLVPtPgIt0MxizjfFJov3JbHyAi,1,0,0,0,0,0,1,0,1,0.14285714285714285,1,0.0,0,0,0,0,0,0,0,1,0,0,1,1
11777,175438,dcYgKBzujpMIqe60unjrhnmHIEGafOxK,fbPkOYLVPtPgIt0MxizjfFJov3JbHyAi,1,0,0,0,0,0,1,0,1,0.14285714285714285,1,0.0,0,0,0,0,0,0,0,1,0,0,1,1
11778,175441,bcbHJfb8lY4U1KCijmTk7gJHSF0OiBaV,fbPkOYLVPtPgIt0MxizjfFJov3JbHyAi,8,4,4,0,4,0,4,0,16,2.2857142857142856,1,0.0,0,4,0,4,4,0,0,4,0,8,8,1
11779,175442,VMKrpzh7jQOpngYePozoQTNizGUgxuvX,fbPkOYLVPtPgIt0MxizjfFJov3JbHyAi,5,0,0,0,0,3,6,1,10,1.4285714285714286,1,0.0,0,0,0,0,0,3,0,6,1,0,10,0
11780,175443,uOJVnPYi8EJLtbdq5vki7NQKzKS5WxlN,fbPkOYLVPtPgIt0MxizjfFJov3JbHyAi,9,23,2,0,2,0,8,1,36,5.142857142857143,1,0.0,7,2,0,2,16,0,0,8,1,11,25,1
11781,175448,8Ify4dSBeSQhnw6uYnkYU0v4wr7gJcMS,fbPkOYLVPtPgIt0MxizjfFJov3JbHyAi,9,8,2,0,4,0,8,1,23,3.2857142857142856,1,0.0,5,2,0,4,3,0,0,8,1,11,12,1
11782,175449,wR7MeRMuDjqJzIdX6xUDIhHYl6LZetsZ,fbPkOYLVPtPgIt0MxizjfFJov3JbHyAi,1,0,0,0,0,0,1,0,1,0.14285714285714285,1,0.0,0,0,0,0,0,0,0,1,0,0,1,1
11783,175452,UGrzFFoMUY8lyETY7WUVQiSf705Madpt,fbPkOYLVPtPgIt0MxizjfFJov3JbHyAi,1,0,0,0,0,0,1,0,1,0.14285714285714285,1,0.0,0,0,0,0,0,0,0,1,0,0,1,1
11784,175454,xMTEKIKt8iJP63Gwx7tRgqa1pIDmZgMk,fbPkOYLVPtPgIt0MxizjfFJov3JbHyAi,1,0,0,0,0,0,1,0,1,0.14285714285714285,1,0.0,0,0,0,0,0,0,0,1,0,0,1,1
11785,175455,QLDHYthOyr0cclZ1Sc6usIODjIEumKpI,fbPkOYLVPtPgIt0MxizjfFJov3JbHyAi,7,3,2,0,2,0,2,0,9,1.2857142857142858,1,0.0,0,2,0,2,3,0,0,2,0,4,5,1
11786,175456,OTIaOWnuQGJS24y1xroPuPud7cEKSrq6,fbPkOYLVPtPgIt0MxizjfFJov3JbHyAi,7,8,2,0,4,0,2,0,16,2.2857142857142856,1,0.0,5,2,0,4,3,0,0,2,0,11,5,1
11787,175457,5p4xnVU1oXqeHfhqOsPC09VPLJWVQgy1,fbPkOYLVPtPgIt0MxizjfFJov3JbHyAi,7,4,3,0,3,0,2,0,12,1.7142857142857142,1,0.0,0,3,0,3,4,0,0,2,0,6,6,1
11788,175461,XB0CsTWEqiEaZYtZLlV2XbWJ8POYjAA4,fbPkOYLVPtPgIt0MxizjfFJov3JbHyAi,7,4,2,0,2,0,4,0,12,1.7142857142857142,1,0.0,1,2,0,2,3,0,0,4,0,5,7,1
11789,175465,YhKyManCtFjOHDUhvEEwYRA6Sue32NUJ,fbPkOYLVPtPgIt0MxizjfFJov3JbHyAi,10,6,4,0,2,6,9,3,30,4.285714285714286,1,0.0,0,4,0,2,6,6,0,9,3,6,24,1
11790,175467,Ato56ooa6y54tphZfyEFBMuiinGkCdDC,fbPkOYLVPtPgIt0MxizjfFJov3JbHyAi,5,3,1,0,1,0,2,0,7,1.0,1,0.0,0,1,0,1,3,0,0,2,0,2,5,1
11791,175468,nV17iCvBE2XN1lp2NOww0UgnrnPkpny4,fbPkOYLVPtPgIt0MxizjfFJov3JbHyAi,13,16,5,11,7,1,13,3,56,8.0,1,0.0,8,5,8,7,8,1,3,13,3,28,28,1
11792,175469,3Un500IqBW3emCZEkVYOgMvAW5xeb1AP,fbPkOYLVPtPgIt0MxizjfFJov3JbHyAi,1,0,0,0,0,0,1,0,1,0.14285714285714285,1,0.0,0,0,0,0,0,0,0,1,0,0,1,1
11793,175471,Ar7wri6od2sIMOfx95hPmMwDttR4wtOC,fbPkOYLVPtPgIt0MxizjfFJov3JbHyAi,1,0,0,0,0,0,1,0,1,0.14285714285714285,1,0.0,0,0,0,0,0,0,0,1,0,0,1,1
11794,175474,Y1jXhPhCX2kJOjFXBIjhhtIcj4SJDjMI,fbPkOYLVPtPgIt0MxizjfFJov3JbHyAi,7,3,2,0,2,0,2,0,9,1.2857142857142858,1,0.0,0,2,0,2,3,0,0,2,0,4,5,1
11795,175475,1w0szCmbk0c8fTIiC10xTGm5aiOfXQpV,fbPkOYLVPtPgIt0MxizjfFJov3JbHyAi,5,2,1,0,1,0,3,0,7,1.0,1,0.0,0,1,0,1,2,0,0,3,0,2,5,1
11796,175476,CobcodAmjDEWWm8RdgM2qfuZmhHbHRNU,fbPkOYLVPtPgIt0MxizjfFJov3JbHyAi,6,3,1,0,1,0,6,0,11,1.5714285714285714,1,0.0,1,1,0,1,2,0,0,6,0,3,8,1
11797,175477,YK7kIznrzD8DIJpIXSwoLltRvaesCrfj,fbPkOYLVPtPgIt0MxizjfFJov3JbHyAi,6,3,2,0,2,0,2,0,9,1.2857142857142858,1,0.0,0,2,0,2,3,0,0,2,0,4,5,1
11798,175478,FIQFfdFooB5Qr3t4W3Ez4CHK8yaDPL6r,fbPkOYLVPtPgIt0MxizjfFJov3JbHyAi,8,7,3,0,2,5,2,1,20,2.857142857142857,1,0.0,0,3,0,2,7,5,0,2,1,5,15,1
11799,175479,5257BfDOFjjC1F8tPsdm817yJFHm3nJq,fbPkOYLVPtPgIt0MxizjfFJov3JbHyAi,5,2,1,0,1,0,2,0,6,0.8571428571428571,1,0.0,0,1,0,1,2,0,0,2,0,2,4,1
11800,175480,GCbj5MX1kqm8CtGBmbuXpnp1WMiRGaCo,fbPkOYLVPtPgIt0MxizjfFJov3JbHyAi,4,2,0,0,0,0,2,0,4,0.5714285714285714,1,0.0,0,0,0,0,2,0,0,2,0,0,4,1
11801,175481,ofogRZ8rNViMcr7xZw7tGZINwIkOUuzb,fbPkOYLVPtPgIt0MxizjfFJov3JbHyAi,7,3,2,0,2,0,3,0,10,1.4285714285714286,1,0.0,0,2,0,2,3,0,0,3,0,4,6,1
11802,175484,6EaK0gHFiSwbLJpDVBHv9ZNNoyIiEert,fbPkOYLVPtPgIt0MxizjfFJov3JbHyAi,1,0,0,0,0,0,1,0,1,0.14285714285714285,1,0.0,0,0,0,0,0,0,0,1,0,0,1,1
11803,175485,9karhKHktKTUl1g2B756WZohKwl0YF1K,fbPkOYLVPtPgIt0MxizjfFJov3JbHyAi,2,0,0,0,0,0,3,0,3,0.42857142857142855,1,0.0,0,0,0,0,0,0,0,3,0,0,3,1
11804,175486,om0KjvovtBK0gZUSboAPRv5A6Jkm00Ei,fbPkOYLVPtPgIt0MxizjfFJov3JbHyAi,7,5,2,0,2,0,4,0,13,1.8571428571428572,1,0.0,0,2,0,2,5,0,0,4,0,4,9,0
11805,175487,wNSaTBieURYU9eqRBVXTHwg7UnVH1LNG,fbPkOYLVPtPgIt0MxizjfFJov3JbHyAi,7,8,2,0,3,0,4,0,17,2.4285714285714284,1,0.0,2,2,0,3,6,0,0,4,0,7,10,1
11806,175489,gqg82ZlqVKWjlS0c4NNxNoHosWhYfCyK,fbPkOYLVPtPgIt0MxizjfFJov3JbHyAi,7,3,2,0,2,0,2,0,9,1.2857142857142858,1,0.0,0,2,0,2,3,0,0,2,0,4,5,1
11807,175490,PnA6r0X1SYV0NubfDqVTrMnAW0y3wbco,fbPkOYLVPtPgIt0MxizjfFJov3JbHyAi,8,5,2,0,3,0,5,1,16,2.2857142857142856,1,0.0,2,2,0,3,3,0,0,5,1,7,9,1
11808,175492,BsdltKARtL2vwhO9E4jy6NsRDyZPduO2,fbPkOYLVPtPgIt0MxizjfFJov3JbHyAi,6,3,1,0,1,0,2,0,7,1.0,1,0.0,0,1,0,1,3,0,0,2,0,2,5,1
11809,175493,LAOj1accETKmU8VQwigRsaQa5A7qsGPe,fbPkOYLVPtPgIt0MxizjfFJov3JbHyAi,7,5,2,0,2,0,4,0,13,1.8571428571428572,1,0.0,0,2,0,2,5,0,0,4,0,4,9,1
11810,175494,drW0fI24E8OPT5rwVcYcGjFLcooZDvPF,fbPkOYLVPtPgIt0MxizjfFJov3JbHyAi,7,5,3,0,2,0,2,0,12,1.7142857142857142,2,0.0,0,3,0,2,5,0,0,2,0,5,7,1
11811,175496,e5SHaCJ1YwrfRF0jQyBahObK2P8hYPve,fbPkOYLVPtPgIt0MxizjfFJov3JbHyAi,5,2,1,0,1,0,2,0,6,0.8571428571428571,1,0.0,0,1,0,1,2,0,0,2,0,2,4,1
11812,175497,IbpttTpyCGfZ6D6p8wXVxA8GNM8MhK7W,fbPkOYLVPtPgIt0MxizjfFJov3JbHyAi,1,0,0,0,0,0,1,0,1,0.14285714285714285,1,0.0,0,0,0,0,0,0,0,1,0,0,1,1
11813,175499,qbL2YHzrsuMmEiJasxtJywxONtOZbPqY,fbPkOYLVPtPgIt0MxizjfFJov3JbHyAi,5,3,1,0,1,0,4,0,9,1.2857142857142858,1,0.0,0,1,0,1,3,0,0,4,0,2,7,1
11814,175500,052V26a8dvnnaUmI4wUAzyjC2b7PSOrg,fbPkOYLVPtPgIt0MxizjfFJov3JbHyAi,5,5,2,0,2,0,2,0,11,1.5714285714285714,2,0.0,0,2,0,2,5,0,0,2,0,4,7,1
11815,175501,m9TcnazDdqlnNxcGRCE8U6df3FfqDKf1,fbPkOYLVPtPgIt0MxizjfFJov3JbHyAi,4,3,1,0,0,0,2,0,6,0.8571428571428571,1,0.0,0,1,0,0,3,0,0,2,0,1,5,1
11816,175502,CGrFKacz6p4gJHwJ4xqUr7POA26XzDqd,fbPkOYLVPtPgIt0MxizjfFJov3JbHyAi,4,2,1,0,1,0,1,0,5,0.7142857142857143,2,0.0,0,1,0,1,2,0,0,1,0,2,3,1
11817,175503,LTwrn8iO2pRbLrTnW6wOA9gDNQYv9ip1,fbPkOYLVPtPgIt0MxizjfFJov3JbHyAi,6,3,2,0,2,0,1,0,8,1.1428571428571428,1,0.0,0,2,0,2,3,0,0,1,0,4,4,1
11818,175504,3N5sXtJHk0S0MyzqJoRxaXFTELV1xCPn,fbPkOYLVPtPgIt0MxizjfFJov3JbHyAi,7,8,4,0,4,0,1,0,17,2.4285714285714284,1,0.0,2,4,0,4,6,0,0,1,0,10,7,1
11819,175505,WHZrYzY9tohLccoqyQSfSqyUPDUl9WdE,fbPkOYLVPtPgIt0MxizjfFJov3JbHyAi,7,3,2,0,2,0,2,0,9,1.2857142857142858,1,0.0,0,2,0,2,3,0,0,2,0,4,5,1
11820,175506,qTno0LLDbZSn2CC4rZpUMVqkfAX6tLBw,fbPkOYLVPtPgIt0MxizjfFJov3JbHyAi,1,0,0,0,0,0,1,0,1,0.14285714285714285,1,0.0,0,0,0,0,0,0,0,1,0,0,1,1
11821,175507,CFYmGwr95iYII1Xahjw54NZCjdk2d4Wp,fbPkOYLVPtPgIt0MxizjfFJov3JbHyAi,6,6,1,0,1,0,2,0,10,1.4285714285714286,1,0.0,1,1,0,1,5,0,0,2,0,3,7,1
11822,175508,XyCxlADmHDxfuETiOd9Qt3MOPKhTmOlb,fbPkOYLVPtPgIt0MxizjfFJov3JbHyAi,6,4,1,0,1,0,2,0,8,1.1428571428571428,1,0.0,0,1,0,1,4,0,0,2,0,2,6,1
11823,175510,kY9yPgTd7RyYG1qUhQ8Q0xOuR3Fox0Ti,fbPkOYLVPtPgIt0MxizjfFJov3JbHyAi,2,0,0,0,0,0,4,0,4,0.5714285714285714,1,0.0,0,0,0,0,0,0,0,4,0,0,4,1
11824,175515,R3pJN0fTux9sFYOjyzF0EbS2c0Xrmde3,fbPkOYLVPtPgIt0MxizjfFJov3JbHyAi,6,6,3,0,2,0,10,0,21,3.0,1,0.0,2,3,0,2,4,0,0,10,0,7,14,1
11825,175516,ldm7FcdWlJdLvNLq5omS5m0FzdvPxViY,fbPkOYLVPtPgIt0MxizjfFJov3JbHyAi,7,8,3,0,4,0,2,0,17,2.4285714285714284,1,0.0,2,3,0,4,6,0,0,2,0,9,8,1
11826,175518,tLauqU6m7jR9M9FVV91XHWWjOVljDHTA,fbPkOYLVPtPgIt0MxizjfFJov3JbHyAi,18,31,14,16,12,2,6,0,81,11.571428571428571,1,0.0,13,14,12,12,18,2,4,6,0,51,30,1
11827,175520,tkWTBuD8nrYklSlgsF9aKVPineGUm2wd,fbPkOYLVPtPgIt0MxizjfFJov3JbHyAi,7,10,2,0,1,0,3,0,16,2.2857142857142856,1,0.0,0,2,0,1,10,0,0,3,0,3,13,1
11828,175523,cv7s2nnOAGwzgfER5oZNesmUBbRGxCps,fbPkOYLVPtPgIt0MxizjfFJov3JbHyAi,7,3,2,0,2,0,2,0,9,1.2857142857142858,1,0.0,0,2,0,2,3,0,0,2,0,4,5,1
11829,175524,VeDeV6aD6kowERv1ygPjE9YEMgMJMOAv,fbPkOYLVPtPgIt0MxizjfFJov3JbHyAi,1,0,0,0,0,0,1,0,1,0.14285714285714285,1,0.0,0,0,0,0,0,0,0,1,0,0,1,1
11830,175526,ucQjAvDjYoqpSh3nQps3rSAEs5u7Mvtk,fbPkOYLVPtPgIt0MxizjfFJov3JbHyAi,2,0,0,0,0,0,2,0,2,0.2857142857142857,1,0.0,0,0,0,0,0,0,0,2,0,0,2,1
11831,175528,mz46tnsW5yzzVlL3u3XwzrxNaj8Gctbo,fbPkOYLVPtPgIt0MxizjfFJov3JbHyAi,1,0,0,0,0,0,1,0,1,0.14285714285714285,1,0.0,0,0,0,0,0,0,0,1,0,0,1,1
11832,175531,eXM1gBg4CSAoJIkchTxClftGT7trcN3I,fbPkOYLVPtPgIt0MxizjfFJov3JbHyAi,5,2,1,0,1,0,2,0,6,0.8571428571428571,1,0.0,0,1,0,1,2,0,0,2,0,2,4,1
11833,175533,TL1aA8ITe7VP42GX52yE5M5UsjXNCOS3,fbPkOYLVPtPgIt0MxizjfFJov3JbHyAi,7,5,3,0,2,5,2,0,17,2.4285714285714284,2,0.0,0,3,0,2,5,5,0,2,0,5,12,1
11834,175534,UtAqhqB3FX1II4t3OmHm0AmqSdhnUJww,fbPkOYLVPtPgIt0MxizjfFJov3JbHyAi,1,0,0,0,0,0,1,0,1,0.14285714285714285,1,0.0,0,0,0,0,0,0,0,1,0,0,1,1
11835,175535,Bf0qullIcB7YMd6p0ga3kapcfp1HAy4D,fbPkOYLVPtPgIt0MxizjfFJov3JbHyAi,4,2,1,0,1,0,1,0,5,0.7142857142857143,1,0.0,0,1,0,1,2,0,0,1,0,2,3,1
11836,175536,UGeVqsUEeFxkRpYFM0kXm2U5Cm8I1M7Q,fbPkOYLVPtPgIt0MxizjfFJov3JbHyAi,9,5,3,0,3,0,2,0,13,1.8571428571428572,1,0.0,1,3,0,3,4,0,0,2,0,7,6,1
11837,175537,nTUP3gEuwVy2Io3TzQXGmuh9VvJxgHk3,fbPkOYLVPtPgIt0MxizjfFJov3JbHyAi,1,0,0,0,0,0,1,0,1,0.14285714285714285,1,0.0,0,0,0,0,0,0,0,1,0,0,1,1
11838,175539,1CCZmdq6Gb6gZ6uKsuQ6KwhvPKPrUh2U,fbPkOYLVPtPgIt0MxizjfFJov3JbHyAi,5,2,1,0,1,0,4,0,8,1.1428571428571428,1,0.0,0,1,0,1,2,0,0,4,0,2,6,1
11839,175540,xB6Yoh3Jxp1w9CTAondnOiYqF7QVxKDy,fbPkOYLVPtPgIt0MxizjfFJov3JbHyAi,10,10,6,0,3,12,4,0,35,5.0,2,0.0,0,6,0,3,10,12,0,4,0,9,26,1
11840,175542,B02fY98iRJpi5vADl4eH2XHtzf1uLIV2,fbPkOYLVPtPgIt0MxizjfFJov3JbHyAi,5,3,1,0,1,0,2,0,7,1.0,1,0.0,0,1,0,1,3,0,0,2,0,2,5,1
11841,175543,O9Ru4jbLuBmSjAvyVz5x9pDKgWs38Hwv,fbPkOYLVPtPgIt0MxizjfFJov3JbHyAi,5,2,1,0,1,0,2,0,6,0.8571428571428571,1,0.0,0,1,0,1,2,0,0,2,0,2,4,1
11842,175544,U4zrVJHh3FaieGmYntHxuYMlUehDirPp,fbPkOYLVPtPgIt0MxizjfFJov3JbHyAi,4,2,1,0,1,0,1,0,5,0.7142857142857143,1,0.0,0,1,0,1,2,0,0,1,0,2,3,1
11843,175545,1R1CKWtxnh6YgR55bjp2SqlcSVpP0TFg,fbPkOYLVPtPgIt0MxizjfFJov3JbHyAi,5,4,0,0,0,4,4,0,12,1.7142857142857142,1,0.0,0,0,0,0,4,4,0,4,0,0,12,1
11844,175547,KjHPeZFepHZBGvn3dcFcrV9gz6Gs9Ua1,fbPkOYLVPtPgIt0MxizjfFJov3JbHyAi,1,0,0,0,0,0,1,0,1,0.14285714285714285,1,0.0,0,0,0,0,0,0,0,1,0,0,1,1
11845,176351,WnfN1AUOAXHdbXdeEDhl2CVqkvTuIggL,fbPkOYLVPtPgIt0MxizjfFJov3JbHyAi,5,7,1,0,1,0,1,0,10,1.4285714285714286,1,0.0,0,1,0,1,7,0,0,1,0,2,8,1
11846,176352,0Tg2flbTUdD7fODqYIfpiJiK0IDdFiOP,fbPkOYLVPtPgIt0MxizjfFJov3JbHyAi,10,11,8,0,3,9,5,1,37,5.285714285714286,2,0.0,0,8,0,3,11,9,0,5,1,11,26,1
11847,176355,KJS7r9EjJHKntMFiDb2wMANmClPA9sbb,fbPkOYLVPtPgIt0MxizjfFJov3JbHyAi,1,0,0,0,0,0,1,0,1,0.14285714285714285,1,0.0,0,0,0,0,0,0,0,1,0,0,1,1
11848,176360,KRoFm4XNv5Pgle2ZS0CeLtv9ebvwgu1y,fbPkOYLVPtPgIt0MxizjfFJov3JbHyAi,9,10,4,0,3,4,4,0,25,3.5714285714285716,1,0.0,1,4,0,3,9,4,0,4,0,8,17,1
11849,176361,BmuAMS4WfX6ydPmjIcZND4OORiH4QIrO,fbPkOYLVPtPgIt0MxizjfFJov3JbHyAi,7,3,2,0,2,0,2,0,9,1.2857142857142858,1,0.0,0,2,0,2,3,0,0,2,0,4,5,1
11850,176365,Cm2FzbnvftvXUAfd52plpEGocR1jnm3F,fbPkOYLVPtPgIt0MxizjfFJov3JbHyAi,7,4,2,0,2,0,2,0,10,1.4285714285714286,1,0.0,1,2,0,2,3,0,0,2,0,5,5,1
11851,176368,p62NLzlqSMU9iNFHUVvUYCz9yDIitTLP,fbPkOYLVPtPgIt0MxizjfFJov3JbHyAi,7,3,0,0,0,0,7,1,11,1.5714285714285714,1,0.0,0,0,0,0,3,0,0,7,1,0,11,1
11852,176370,i9CWvduTcskommMHOeHEvsItP05JGHxW,fbPkOYLVPtPgIt0MxizjfFJov3JbHyAi,1,0,0,0,0,0,2,0,2,0.2857142857142857,1,0.0,0,0,0,0,0,0,0,2,0,0,2,1
11853,176372,ScH0NQfTgHr8NVyVOwPwgUgAUDqKXQgu,fbPkOYLVPtPgIt0MxizjfFJov3JbHyAi,2,0,0,0,0,0,4,0,4,0.5714285714285714,1,0.0,0,0,0,0,0,0,0,4,0,0,4,1
11854,176384,QU5veVGVoBVElxn9NViHXdfKseQ4NUTU,7GRhBDsirIGkRZBtSMEzNTyDr2JQm4xx,25,27,16,12,14,1,2,0,72,10.285714285714286,1,0.0,10,16,7,14,17,1,5,2,0,47,25,1
11855,176401,NwyEsAPgfXRjtBVHC91OfF1dna6dk38d,7GRhBDsirIGkRZBtSMEzNTyDr2JQm4xx,19,26,11,0,9,0,4,0,50,7.142857142857143,1,0.0,0,11,0,9,26,0,0,4,0,20,30,1
11856,176427,38HaiNGogMQZ7XFJyXto2il2akhOzypw,7GRhBDsirIGkRZBtSMEzNTyDr2JQm4xx,4,3,2,0,0,0,1,0,6,0.8571428571428571,1,0.0,0,2,0,0,3,0,0,1,0,2,4,1
11857,176450,7rsrCVMWlOWL1EBL5oTIUxzrypr861Ec,7GRhBDsirIGkRZBtSMEzNTyDr2JQm4xx,22,27,11,14,8,1,2,0,63,9.0,1,0.0,14,11,7,8,13,1,7,2,0,40,23,1
11858,176472,H3iVkRV8UPZvsbvYrU1dnbX51IlHemsF,7GRhBDsirIGkRZBtSMEzNTyDr2JQm4xx,1,0,0,0,0,0,1,0,1,0.14285714285714285,1,0.0,0,0,0,0,0,0,0,1,0,0,1,1
11859,176497,TdvOfODULzKCo3CRrsWuoBlElu9vlzI6,7GRhBDsirIGkRZBtSMEzNTyDr2JQm4xx,12,6,4,0,4,0,2,0,16,2.2857142857142856,1,0.0,0,4,0,4,6,0,0,2,0,8,8,1
11860,176512,uymreEOSNmNZtilEkQpiM8TbwZcRYgYz,7GRhBDsirIGkRZBtSMEzNTyDr2JQm4xx,6,7,3,0,3,0,4,0,17,2.4285714285714284,1,0.0,0,3,0,3,7,0,0,4,0,6,11,1
11861,176530,FwNBQnrMN6SVYSed0kgql3TnqU22qpDv,7GRhBDsirIGkRZBtSMEzNTyDr2JQm4xx,11,6,5,0,5,0,2,0,18,2.5714285714285716,1,0.0,0,5,0,5,6,0,0,2,0,10,8,1
11862,176578,Vrnp33q5W6vex5c7FhvE2pEw2kHEQLPj,SpATywNh6bZuzm8s1ceuBUnMUAeoAHHw,1,0,0,0,0,0,1,0,1,0.14285714285714285,1,0.0,0,0,0,0,0,0,0,1,0,0,1,1
11863,176580,WlyNOREFyee6wG3QSx9dsILJnChCOzeS,SpATywNh6bZuzm8s1ceuBUnMUAeoAHHw,1,0,0,0,0,0,1,0,1,0.14285714285714285,1,0.0,0,0,0,0,0,0,0,1,0,0,1,1
11864,176585,WlyNOREFyee6wG3QSx9dsILJnChCOzeS,bWdj2GDclj5ofokWjzoa5jAwMkxCykd6,1,0,0,0,0,0,1,0,1,0.14285714285714285,1,0.0,0,0,0,0,0,0,0,1,0,0,1,1
11865,176586,WlyNOREFyee6wG3QSx9dsILJnChCOzeS,A3fsA9Zfv1X2fVEQhTw51lKENdNrEqT3,1,0,0,0,0,0,1,0,1,0.14285714285714285,1,0.0,0,0,0,0,0,0,0,1,0,0,1,1
11866,176615,pIooitOY4Kj1UbygmuPfxFwwpH2R7NzD,bWdj2GDclj5ofokWjzoa5jAwMkxCykd6,1,0,0,0,0,0,1,0,1,0.14285714285714285,1,0.0,0,0,0,0,0,0,0,1,0,0,1,1
11867,176631,dgs5q517os0QP00EQ3rFo0TcrFNCs1kW,SpATywNh6bZuzm8s1ceuBUnMUAeoAHHw,13,12,4,13,3,0,2,0,34,4.857142857142857,1,0.0,4,4,13,3,8,0,0,2,0,24,10,1
11868,176634,t0m1BPy97jwvYrf5NqXFqeULLwloyg62,SpATywNh6bZuzm8s1ceuBUnMUAeoAHHw,11,19,0,18,0,0,3,0,40,5.714285714285714,1,0.0,11,0,15,0,8,0,3,3,0,26,14,0
11869,176642,K7nFLJJvhJnytzTEuQJeoArapKXlhdtY,A3fsA9Zfv1X2fVEQhTw51lKENdNrEqT3,3,2,1,0,0,0,2,0,5,0.7142857142857143,1,0.0,0,1,0,0,2,0,0,2,0,1,4,1
11870,176663,wQnqFfzf7T1nceXQBoyROaQMybFqk9YC,A3fsA9Zfv1X2fVEQhTw51lKENdNrEqT3,31,16,0,62,0,0,3,0,81,11.571428571428571,1,0.0,2,0,53,0,14,0,9,3,0,55,26,1
11871,176683,lsVTRIeOvE3c9uyXSsVkOz4L2qHzzgXN,bWdj2GDclj5ofokWjzoa5jAwMkxCykd6,6,4,2,0,1,0,4,0,11,1.5714285714285714,1,0.0,0,2,0,1,4,0,0,4,0,3,8,1
11872,176693,cZxcDNlAnm0tcnrjnkTKyh2S3nRuNP2Z,SpATywNh6bZuzm8s1ceuBUnMUAeoAHHw,7,3,1,0,1,0,3,1,9,1.2857142857142858,1,0.0,0,1,0,1,3,0,0,3,1,2,7,1
11873,176694,n5TgHqozAvMVxs3uLQhdtzkk63PUtkZ4,SpATywNh6bZuzm8s1ceuBUnMUAeoAHHw,3,2,0,0,0,0,1,0,3,0.42857142857142855,1,0.0,0,0,0,0,2,0,0,1,0,0,3,1
11874,176702,ngw0H084neoLUSHjmsnAwizUxOwdmBjF,SpATywNh6bZuzm8s1ceuBUnMUAeoAHHw,7,3,2,0,2,0,2,0,9,1.2857142857142858,1,0.0,0,2,0,2,3,0,0,2,0,4,5,1
11875,176703,M3Xa5IFPEZiaLK2rAjKqcPYFncjR6IsA,SpATywNh6bZuzm8s1ceuBUnMUAeoAHHw,2,0,0,0,0,0,2,0,2,0.2857142857142857,1,0.0,0,0,0,0,0,0,0,2,0,0,2,1
11876,176709,WMHw9zFx2owqfPWjdqgQ3dXmYN0CSXui,SpATywNh6bZuzm8s1ceuBUnMUAeoAHHw,4,3,2,0,0,0,1,0,6,0.8571428571428571,1,0.0,0,2,0,0,3,0,0,1,0,2,4,1
11877,176712,r9RAlcNOEU4tSJ3VTxa7tKQ4IwaYSNfB,A3fsA9Zfv1X2fVEQhTw51lKENdNrEqT3,2,0,0,0,0,0,4,0,4,0.5714285714285714,1,0.0,0,0,0,0,0,0,0,4,0,0,4,1
11878,176734,44GafVKSjOefcGtCUMS1SAXmrzlFFSGG,SpATywNh6bZuzm8s1ceuBUnMUAeoAHHw,6,4,1,0,1,0,2,0,8,1.1428571428571428,2,0.0,0,1,0,1,4,0,0,2,0,2,6,1
11879,176771,vP6SXmTWZNLDpRliX4cZDs2mXlaBaub0,A3fsA9Zfv1X2fVEQhTw51lKENdNrEqT3,4,0,0,0,0,0,5,0,5,0.7142857142857143,1,0.0,0,0,0,0,0,0,0,5,0,0,5,1
11880,176781,V073dr3Ejc08S0Z4K4o33HIYkTog3ITe,SpATywNh6bZuzm8s1ceuBUnMUAeoAHHw,23,16,13,10,9,0,4,0,52,7.428571428571429,1,0.0,2,13,9,9,14,0,1,4,0,33,19,1
11881,176829,UGilWCcjcjXGcBN3IoOXTqqH7xZPNWuh,A3fsA9Zfv1X2fVEQhTw51lKENdNrEqT3,9,6,0,0,0,10,12,0,28,4.0,1,0.0,0,0,0,0,6,10,0,12,0,0,28,1
11882,176834,1Ud2Nlb0y9uKsOXhkhM9qhPj1Xv6ImgU,SpATywNh6bZuzm8s1ceuBUnMUAeoAHHw,2,0,0,0,0,0,3,0,3,0.42857142857142855,1,0.0,0,0,0,0,0,0,0,3,0,0,3,1
11883,176845,tkxwTpjNIcKspgIQFJ1HEHtxSp5ThNsq,A3fsA9Zfv1X2fVEQhTw51lKENdNrEqT3,16,9,7,0,6,2,2,0,26,3.7142857142857144,1,0.0,0,7,0,6,9,2,0,2,0,13,13,1
11884,176849,IqdQlZEDPmhIudkuSm1qvVaQ2dYiBuyU,SpATywNh6bZuzm8s1ceuBUnMUAeoAHHw,7,3,1,0,1,1,4,0,10,1.4285714285714286,1,0.0,0,1,0,1,3,1,0,4,0,2,8,1
11885,176862,TBj8ERKtARA6ABLjSlKdebgRJkBjpHod,A3fsA9Zfv1X2fVEQhTw51lKENdNrEqT3,2,0,0,0,0,0,2,0,2,0.2857142857142857,1,0.0,0,0,0,0,0,0,0,2,0,0,2,1
11886,176907,RVhulbNKnSbDIMoCPANZFAOa0qbIDxQt,A3fsA9Zfv1X2fVEQhTw51lKENdNrEqT3,1,0,0,0,0,0,1,0,1,0.14285714285714285,1,0.0,0,0,0,0,0,0,0,1,0,0,1,1
11887,176932,oqfmspVsCDU25zVJJu97mvH8ZAyQzgs4,SpATywNh6bZuzm8s1ceuBUnMUAeoAHHw,6,8,0,0,0,0,2,0,10,1.4285714285714286,1,0.0,0,0,0,0,8,0,0,2,0,0,10,1
11888,176945,DnNU68583OkMDFomIoumeRI68tNSmB88,SpATywNh6bZuzm8s1ceuBUnMUAeoAHHw,1,0,0,0,0,0,1,0,1,0.14285714285714285,1,0.0,0,0,0,0,0,0,0,1,0,0,1,1
11889,176950,WczGVRZMmNzgMggUe3ZQ1bOs2IuTwUWO,bWdj2GDclj5ofokWjzoa5jAwMkxCykd6,1,0,0,0,0,0,1,0,1,0.14285714285714285,1,0.0,0,0,0,0,0,0,0,1,0,0,1,1
11890,176966,SzAtQzNOap38B7fNAidQGz1HfRyu6YSS,bWdj2GDclj5ofokWjzoa5jAwMkxCykd6,5,0,0,0,0,0,5,1,6,0.8571428571428571,1,0.0,0,0,0,0,0,0,0,5,1,0,6,1
11891,176967,bgwwZSIxTFRvIry4LocWcmZ15RQwBsJD,SpATywNh6bZuzm8s1ceuBUnMUAeoAHHw,1,0,0,0,0,0,1,0,1,0.14285714285714285,1,0.0,0,0,0,0,0,0,0,1,0,0,1,1
11892,176987,5JmpnTGe6ZHNgssYgcMaiqkF3B7C3AfJ,A3fsA9Zfv1X2fVEQhTw51lKENdNrEqT3,2,0,0,0,0,0,2,0,2,0.2857142857142857,1,0.0,0,0,0,0,0,0,0,2,0,0,2,1
11893,176988,AgYA7iHpk58icD4xPuYLYI9kpuqj6y1t,A3fsA9Zfv1X2fVEQhTw51lKENdNrEqT3,10,9,5,0,2,0,6,0,22,3.142857142857143,1,0.0,2,5,0,2,7,0,0,6,0,9,13,1
11894,176989,lBPkWmGWjMVGl7rjICN5T6By1CpF3Oh1,bWdj2GDclj5ofokWjzoa5jAwMkxCykd6,4,3,2,0,2,0,1,0,8,1.1428571428571428,1,0.0,0,2,0,2,3,0,0,1,0,4,4,1
11895,177051,QTuqQxk5mfpTPo5vfXzRqFyeBm1ocbxg,bWdj2GDclj5ofokWjzoa5jAwMkxCykd6,11,5,4,0,2,4,6,1,22,3.142857142857143,1,0.0,0,4,0,2,5,4,0,6,1,6,16,1
11896,177063,me3X50gZnHqxKqokwhcjCSa6sPS8gx2x,bWdj2GDclj5ofokWjzoa5jAwMkxCykd6,4,2,1,0,1,0,1,0,5,0.7142857142857143,1,0.0,0,1,0,1,2,0,0,1,0,2,3,1
11897,177084,KGMUqHbYYqeF4kil6zUa1qpianJR3FpM,SpATywNh6bZuzm8s1ceuBUnMUAeoAHHw,9,8,1,0,0,0,8,2,19,2.7142857142857144,3,0.0,1,1,0,0,7,0,0,8,2,2,17,1
11898,177087,9G22TFSpifXf2dRYsg4E8vgkMWfro3Ct,bWdj2GDclj5ofokWjzoa5jAwMkxCykd6,6,7,1,0,0,0,9,0,17,2.4285714285714284,2,0.0,0,1,0,0,7,0,0,9,0,1,16,1
11899,177109,EPVEir3f8DxjouE65Q4kYI9YaQMxGE89,A3fsA9Zfv1X2fVEQhTw51lKENdNrEqT3,7,7,1,0,0,4,3,0,15,2.142857142857143,1,0.0,0,1,0,0,7,4,0,3,0,1,14,1
11900,177111,niznzPsNcmf0qkvKVIABVzsBAFOWmMfr,bWdj2GDclj5ofokWjzoa5jAwMkxCykd6,2,0,0,0,0,0,2,0,2,0.2857142857142857,1,0.0,0,0,0,0,0,0,0,2,0,0,2,1
11901,177114,wingMAl29ucopfiyx66jxxaUInzOOQW5,SpATywNh6bZuzm8s1ceuBUnMUAeoAHHw,24,46,14,0,9,2,10,0,81,11.571428571428571,2,0.0,4,14,0,9,42,2,0,10,0,27,54,1
11902,177140,sN7SpMjN00gTdmZynEw6AXtweTyZtD7L,A3fsA9Zfv1X2fVEQhTw51lKENdNrEqT3,7,4,2,0,1,0,4,0,11,1.5714285714285714,1,0.0,1,2,0,1,3,0,0,4,0,4,7,1
11903,177146,GHoD8AIr3r5Mp1AqZoXIC9i225P9RubE,bWdj2GDclj5ofokWjzoa5jAwMkxCykd6,5,2,1,0,1,0,2,0,6,0.8571428571428571,1,0.0,0,1,0,1,2,0,0,2,0,2,4,1
11904,177154,1quHb10fObuEEg4CZXYAqSIkbHHSbI1d,SpATywNh6bZuzm8s1ceuBUnMUAeoAHHw,1,0,0,0,0,0,1,0,1,0.14285714285714285,1,0.0,0,0,0,0,0,0,0,1,0,0,1,1
11905,177191,RzpNewewHDhOLk08WWwTdZBpVAjeuouY,SpATywNh6bZuzm8s1ceuBUnMUAeoAHHw,1,0,0,0,0,0,1,0,1,0.14285714285714285,1,0.0,0,0,0,0,0,0,0,1,0,0,1,1
11906,177194,5K1YQb6WOjDwHsAIqvYsCK3LL78wZoyl,SpATywNh6bZuzm8s1ceuBUnMUAeoAHHw,5,2,1,0,1,0,2,0,6,0.8571428571428571,1,0.0,0,1,0,1,2,0,0,2,0,2,4,1
11907,177220,3iyvvUD6yZB0z0YjGBWx9vW081IJua41,A3fsA9Zfv1X2fVEQhTw51lKENdNrEqT3,4,2,0,0,0,0,4,0,6,0.8571428571428571,1,0.0,0,0,0,0,2,0,0,4,0,0,6,0
11908,177248,VJ6kjzPollQLDbYztoyg8LEnFGMc5bZx,bWdj2GDclj5ofokWjzoa5jAwMkxCykd6,2,0,0,0,0,0,3,0,3,0.42857142857142855,1,0.0,0,0,0,0,0,0,0,3,0,0,3,0
11909,177253,LxsrJ5jQBHgpoDvJjmW7B1PIBB1B9rOy,A3fsA9Zfv1X2fVEQhTw51lKENdNrEqT3,2,0,0,0,0,0,2,0,2,0.2857142857142857,1,0.0,0,0,0,0,0,0,0,2,0,0,2,1
11910,177267,QiYah6MaRTZX43IYRVARS0cRIO6IdBSv,A3fsA9Zfv1X2fVEQhTw51lKENdNrEqT3,1,0,0,0,0,0,1,0,1,0.14285714285714285,1,0.0,0,0,0,0,0,0,0,1,0,0,1,1
11911,177287,GFHYWWeeAuj1pePvOmCpIpIQDTy4Q3Iv,A3fsA9Zfv1X2fVEQhTw51lKENdNrEqT3,1,0,0,0,0,0,1,0,1,0.14285714285714285,1,0.0,0,0,0,0,0,0,0,1,0,0,1,1
11912,177292,MCY34unG8KB7lFkmy7ruLaHeUqkrRhUd,SpATywNh6bZuzm8s1ceuBUnMUAeoAHHw,13,18,6,4,3,0,2,0,33,4.714285714285714,1,0.0,7,6,4,3,11,0,0,2,0,20,13,1
11913,177294,0xRWiMAkDSQyarQpahb5IxRgJIgg5cjl,SpATywNh6bZuzm8s1ceuBUnMUAeoAHHw,1,0,0,0,0,0,1,0,1,0.14285714285714285,1,0.0,0,0,0,0,0,0,0,1,0,0,1,1
11914,177312,Vnz3YQtaGP9Lud4eJsx4REuNf7a7Z6K7,A3fsA9Zfv1X2fVEQhTw51lKENdNrEqT3,8,6,4,0,2,0,6,0,18,2.5714285714285716,2,0.0,0,4,0,2,6,0,0,6,0,6,12,1
11915,177338,ls1F2KUi19ehHJYjRRU9ukCpIm6Mq0QX,bWdj2GDclj5ofokWjzoa5jAwMkxCykd6,7,11,3,0,2,2,8,1,27,3.857142857142857,1,0.0,3,3,0,2,8,2,0,8,1,8,19,1
11916,177342,ukV83h2gop6RgQ4r0p0CZA73Nn6q15H2,SpATywNh6bZuzm8s1ceuBUnMUAeoAHHw,15,16,9,8,5,0,4,0,42,6.0,2,0.0,4,9,8,5,12,0,0,4,0,26,16,1
11917,177357,bvUZAD2pQ0JG1rSj4fd4oSXQV1yLwXI1,bWdj2GDclj5ofokWjzoa5jAwMkxCykd6,1,0,0,0,0,0,1,0,1,0.14285714285714285,1,0.0,0,0,0,0,0,0,0,1,0,0,1,1
11918,177359,rrdUVc7PxY1K5CKjH5FZPZeykLw0CqkU,SpATywNh6bZuzm8s1ceuBUnMUAeoAHHw,5,3,1,0,1,0,6,0,11,1.5714285714285714,1,0.0,0,1,0,1,3,0,0,6,0,2,9,1
11919,177362,dGWL5aQxrmUKcXwkRJNonE7KRjTXcSnx,SpATywNh6bZuzm8s1ceuBUnMUAeoAHHw,4,3,0,0,0,0,2,0,5,0.7142857142857143,1,0.0,0,0,0,0,3,0,0,2,0,0,5,0
11920,177411,P5T4sFdQt6aGZ3iihRY0M991VNl2H2j2,SpATywNh6bZuzm8s1ceuBUnMUAeoAHHw,7,4,1,0,1,3,5,0,14,2.0,1,0.0,1,1,0,1,3,3,0,5,0,3,11,1
11921,177441,uUdFMnM36oHfhjmWTDXFNgr7FNTKYZUv,A3fsA9Zfv1X2fVEQhTw51lKENdNrEqT3,5,2,1,0,1,0,2,0,6,0.8571428571428571,1,0.0,0,1,0,1,2,0,0,2,0,2,4,0
11922,177447,ONzOWoX8tSfcZlukia6Q8bk2oPYRBqMN,bWdj2GDclj5ofokWjzoa5jAwMkxCykd6,1,0,0,0,0,0,1,0,1,0.14285714285714285,1,0.0,0,0,0,0,0,0,0,1,0,0,1,1
11923,177493,K3eaSd5rYP9Gkimldqt40pigYQrGeLsH,A3fsA9Zfv1X2fVEQhTw51lKENdNrEqT3,28,26,18,0,8,0,5,0,57,8.142857142857142,2,0.0,0,18,0,8,26,0,0,5,0,26,31,1
11924,177506,TL1aA8ITe7VP42GX52yE5M5UsjXNCOS3,SpATywNh6bZuzm8s1ceuBUnMUAeoAHHw,14,11,7,14,4,23,3,0,62,8.857142857142858,2,0.0,2,7,11,4,9,23,3,3,0,24,38,1
11925,177521,UtuMMiTcYdEIPqLGUrTySvaHfGG20tSq,bWdj2GDclj5ofokWjzoa5jAwMkxCykd6,4,2,1,0,1,0,1,0,5,0.7142857142857143,1,0.0,0,1,0,1,2,0,0,1,0,2,3,1
11926,177534,y4HEate091nZSs6CdPCmi4GDN3wtU4uQ,bWdj2GDclj5ofokWjzoa5jAwMkxCykd6,1,0,0,0,0,0,1,0,1,0.14285714285714285,1,0.0,0,0,0,0,0,0,0,1,0,0,1,1
11927,177538,r4ZoHGMZmqAV8283r1kkNHYmSCMouZ71,SpATywNh6bZuzm8s1ceuBUnMUAeoAHHw,1,0,0,0,0,0,1,0,1,0.14285714285714285,1,0.0,0,0,0,0,0,0,0,1,0,0,1,1
11928,177648,XTgYONXtkRAl3sCFaGFF8e1mU9AMcEwg,A3fsA9Zfv1X2fVEQhTw51lKENdNrEqT3,1,0,0,0,0,0,1,0,1,0.14285714285714285,1,0.0,0,0,0,0,0,0,0,1,0,0,1,1
11929,177656,3EOSgrGzaBOPj9C9GS5Q7Pv420ga9IOi,SpATywNh6bZuzm8s1ceuBUnMUAeoAHHw,16,16,8,0,6,0,2,0,32,4.571428571428571,2,0.0,0,8,0,6,16,0,0,2,0,14,18,1
11930,177671,pGYLDmhkSj1iBp1YljlDSId0XSrjZNZR,G8EPVSXsOYB5YQWZGiz1aVq5Pgr2GrQu,1,0,0,0,0,0,1,0,1,0.14285714285714285,1,0.0,0,0,0,0,0,0,0,1,0,0,1,1
11931,177692,EovGqmWXTyV2r8yAXv2wZ0VYOf33vn0t,SpATywNh6bZuzm8s1ceuBUnMUAeoAHHw,8,9,2,0,2,0,4,0,17,2.4285714285714284,1,0.0,1,2,0,2,8,0,0,4,0,5,12,1
11932,177701,vvZAdi1giBsqNJd2MIMUF2BeNIuSYzIL,A3fsA9Zfv1X2fVEQhTw51lKENdNrEqT3,1,0,0,0,0,0,1,0,1,0.14285714285714285,1,0.0,0,0,0,0,0,0,0,1,0,0,1,1
11933,177704,M2AmcvqhvMtUlyRV6vMvvoM2IhrMmAwT,RXDvfPUBYFlVdlueBFbLW0mhhAyGEqpt,5,2,1,0,1,0,3,0,7,1.0,1,0.0,0,1,0,1,2,0,0,3,0,2,5,1
11934,177705,wlzAgdvhO4A4jv5wZbftQLCtHeMZtcKt,A3fsA9Zfv1X2fVEQhTw51lKENdNrEqT3,8,1,1,0,1,1,11,1,16,2.2857142857142856,1,0.0,0,1,0,1,1,1,0,11,1,2,14,1
11935,177706,Hw8jmGp4VI4tAz6cfKhHDOeLB2t7MJ9z,A3fsA9Zfv1X2fVEQhTw51lKENdNrEqT3,1,0,0,0,0,0,1,0,1,0.14285714285714285,1,0.0,0,0,0,0,0,0,0,1,0,0,1,1
11936,177712,bkuP1EtN8mdTFJXvfsUwoFetipNOKV1x,bWdj2GDclj5ofokWjzoa5jAwMkxCykd6,4,2,0,0,0,0,2,0,4,0.5714285714285714,1,0.0,0,0,0,0,2,0,0,2,0,0,4,0
11937,177716,YeSu5vnyd7NLR6mjoon0rNurw7LtWHKM,SpATywNh6bZuzm8s1ceuBUnMUAeoAHHw,5,2,1,0,1,0,2,0,6,0.8571428571428571,1,0.0,0,1,0,1,2,0,0,2,0,2,4,1
11938,177731,nWfmkEV4YCKZ7mcPyrthk5xsFNQD6yNN,SpATywNh6bZuzm8s1ceuBUnMUAeoAHHw,15,13,2,11,0,0,2,0,28,4.0,1,0.0,0,2,10,0,13,0,1,2,0,12,16,1
11939,177737,F7IgmS7BQy7wghj5xQppsiqo1bYAbUaS,A3fsA9Zfv1X2fVEQhTw51lKENdNrEqT3,2,0,0,0,0,0,3,0,3,0.42857142857142855,1,0.0,0,0,0,0,0,0,0,3,0,0,3,1
11940,177744,7MJ8Lhv2PsjCppkY7orFcs7zn9hmP4MG,A3fsA9Zfv1X2fVEQhTw51lKENdNrEqT3,5,2,1,0,1,0,3,0,7,1.0,2,0.0,0,1,0,1,2,0,0,3,0,2,5,1
11941,177746,FTdbZ3S8aZZ61DWcRvHq8VI8NuRVTtYB,SpATywNh6bZuzm8s1ceuBUnMUAeoAHHw,5,3,1,0,1,0,1,0,6,0.8571428571428571,1,0.0,0,1,0,1,3,0,0,1,0,2,4,1
11942,177781,Fjsr4YVijnhHCyav53zNG4j0ri6wctia,SpATywNh6bZuzm8s1ceuBUnMUAeoAHHw,5,2,1,0,1,1,2,0,7,1.0,1,0.0,0,1,0,1,2,1,0,2,0,2,5,1
11943,177802,IfuP3wsHPcoufqx0FyqFKUytwStvSPv8,SpATywNh6bZuzm8s1ceuBUnMUAeoAHHw,8,7,1,0,1,0,2,0,11,1.5714285714285714,1,0.0,0,1,0,1,7,0,0,2,0,2,9,1
11944,177808,h1QswJ31uhxfyhfP3OhNVJBUvcTub6pW,A3fsA9Zfv1X2fVEQhTw51lKENdNrEqT3,6,2,1,0,1,0,3,0,7,1.0,1,0.0,0,1,0,1,2,0,0,3,0,2,5,1
11945,177815,bntZ4rfkG0kbpKVyaZN5dpSYAjphN7lA,SpATywNh6bZuzm8s1ceuBUnMUAeoAHHw,2,0,0,0,0,0,4,0,4,0.5714285714285714,1,0.0,0,0,0,0,0,0,0,4,0,0,4,1
11946,177823,obnzTYQwwpz4VOaAZpvzueXnEk1orSl6,RXDvfPUBYFlVdlueBFbLW0mhhAyGEqpt,1,0,0,0,0,0,1,0,1,0.14285714285714285,1,0.0,0,0,0,0,0,0,0,1,0,0,1,1
11947,177826,6Orjf1CvaLA2u5CajSzbONgKa1cSGpsp,SpATywNh6bZuzm8s1ceuBUnMUAeoAHHw,5,2,1,0,1,0,2,0,6,0.8571428571428571,1,0.0,0,1,0,1,2,0,0,2,0,2,4,1
11948,177833,WfZHYsGW1JdLRZrh0HxeGf3PWw6Zaiy6,SpATywNh6bZuzm8s1ceuBUnMUAeoAHHw,5,2,1,0,1,0,2,0,6,0.8571428571428571,1,0.0,0,1,0,1,2,0,0,2,0,2,4,1
11949,177838,sJcjGGS4IqxtZ0yUL13beAzln7dowOpj,SpATywNh6bZuzm8s1ceuBUnMUAeoAHHw,1,0,0,0,0,0,1,0,1,0.14285714285714285,1,0.0,0,0,0,0,0,0,0,1,0,0,1,1
11950,177841,M8GvXQvqlItd1uaUuAOKL5aVksmfHCxv,G8EPVSXsOYB5YQWZGiz1aVq5Pgr2GrQu,3,3,1,0,0,0,1,0,5,0.7142857142857143,1,0.0,0,1,0,0,3,0,0,1,0,1,4,1
11951,177874,vCeaWq9tqFyvtajgk87uB8epKyzp49he,SpATywNh6bZuzm8s1ceuBUnMUAeoAHHw,13,12,5,11,2,1,4,0,35,5.0,1,0.0,5,5,9,2,7,1,2,4,0,21,14,1
11952,177879,M8C9BDFICk4ida59GU0jjp556zazDEi1,G8EPVSXsOYB5YQWZGiz1aVq5Pgr2GrQu,7,5,3,0,1,0,4,0,13,1.8571428571428572,2,0.0,0,3,0,1,5,0,0,4,0,4,9,1
11953,177882,EwT4gfO7FSX1b89EA44scYJQueULJfeO,SpATywNh6bZuzm8s1ceuBUnMUAeoAHHw,5,2,1,0,1,0,2,0,6,0.8571428571428571,1,0.0,0,1,0,1,2,0,0,2,0,2,4,1
11954,177889,Ccj8NEsaoMQRZnTXAxQZ3mlzMKhmRScC,SpATywNh6bZuzm8s1ceuBUnMUAeoAHHw,16,23,10,6,4,0,3,0,46,6.571428571428571,1,0.0,6,10,6,4,17,0,0,3,0,26,20,0
11955,177896,A6tOI6UQdaIkkVbh2LcanNew6i5iO2fH,bWdj2GDclj5ofokWjzoa5jAwMkxCykd6,1,0,0,0,0,0,2,0,2,0.2857142857142857,1,0.0,0,0,0,0,0,0,0,2,0,0,2,1
11956,177916,x5efWjoRyi52rQ7JepSo4abkhsClgbZ4,bWdj2GDclj5ofokWjzoa5jAwMkxCykd6,2,0,0,0,0,0,2,0,2,0.2857142857142857,1,0.0,0,0,0,0,0,0,0,2,0,0,2,1
11957,177918,Ck862YJ4TKsW5xBb6Obw9gcSWBzSDmoA,SpATywNh6bZuzm8s1ceuBUnMUAeoAHHw,10,12,0,19,0,0,2,0,33,4.714285714285714,1,0.0,4,0,15,0,8,0,4,2,0,19,14,1
11958,177946,fsYAWTSjas5dj2ZT4ziu6J8GfCN2A543,SpATywNh6bZuzm8s1ceuBUnMUAeoAHHw,8,2,1,0,1,1,5,1,11,1.5714285714285714,1,0.0,0,1,0,1,2,1,0,5,1,2,9,1
11959,177947,t0soD7aQ6w7DGyhmXz7wyAfUbtBWT4NA,RXDvfPUBYFlVdlueBFbLW0mhhAyGEqpt,25,14,13,0,11,0,2,0,40,5.714285714285714,1,0.0,0,13,0,11,14,0,0,2,0,24,16,0
11960,178015,IZxwz54TsYvU9RDBY0Jd0dZSoQSefAFM,SpATywNh6bZuzm8s1ceuBUnMUAeoAHHw,3,0,0,0,0,0,7,0,7,1.0,1,0.0,0,0,0,0,0,0,0,7,0,0,7,1
11961,178018,EQaS3CpcvDJhQrwHEK3TrEH3gvn0Dpxt,A3fsA9Zfv1X2fVEQhTw51lKENdNrEqT3,1,0,0,0,0,0,1,0,1,0.14285714285714285,1,0.0,0,0,0,0,0,0,0,1,0,0,1,1
11962,178031,dH1fJFd4EUa9cDGkzaH97LNe2YTOAGRI,bWdj2GDclj5ofokWjzoa5jAwMkxCykd6,1,0,0,0,0,0,2,0,2,0.2857142857142857,1,0.0,0,0,0,0,0,0,0,2,0,0,2,1
11963,178048,ZnF4cH0Rkfun3Ujybr1tuGGeHps3w9hO,A3fsA9Zfv1X2fVEQhTw51lKENdNrEqT3,20,10,9,0,8,0,3,0,30,4.285714285714286,2,0.0,0,9,0,8,10,0,0,3,0,17,13,1
11964,178057,vOyNIvbmr9YMEBhwQMSd5QWgWHEvzCE0,SpATywNh6bZuzm8s1ceuBUnMUAeoAHHw,9,8,1,10,1,0,3,0,23,3.2857142857142856,1,0.0,2,1,9,1,6,0,1,3,0,13,10,1
11965,178058,xk56WEVJEAYlfTe18KDPHjwyCpm6eESo,G8EPVSXsOYB5YQWZGiz1aVq5Pgr2GrQu,19,37,20,30,10,0,5,0,102,14.571428571428571,2,0.0,7,20,29,10,30,0,1,5,0,66,36,1
11966,178065,Cwlc0kvvLoKXxEuXNQkjFRo818TDMpZS,A3fsA9Zfv1X2fVEQhTw51lKENdNrEqT3,12,6,5,0,5,0,1,0,17,2.4285714285714284,1,0.0,0,5,0,5,6,0,0,1,0,10,7,1
11967,178071,8uKfJT3Ferex7gSStlreZzcbQrGyXHDu,A3fsA9Zfv1X2fVEQhTw51lKENdNrEqT3,13,5,4,22,3,0,1,0,35,5.0,1,0.0,0,4,19,3,5,0,3,1,0,26,9,1
11968,178091,YRvoydpc37Vpysmtw8O9rzowfgsZu7lO,SpATywNh6bZuzm8s1ceuBUnMUAeoAHHw,5,5,2,0,1,3,1,0,12,1.7142857142857142,1,0.0,2,2,0,1,3,3,0,1,0,5,7,1
11969,178094,esEoFNEKF5IP6OxWYdt6tpHD0Qc2cHks,SpATywNh6bZuzm8s1ceuBUnMUAeoAHHw,4,4,1,0,1,0,1,0,7,1.0,1,0.0,0,1,0,1,4,0,0,1,0,2,5,1
11970,178095,44onQpYi5VTnyFsvK7UkRriRlwhqqD0U,SpATywNh6bZuzm8s1ceuBUnMUAeoAHHw,1,0,0,0,0,0,1,0,1,0.14285714285714285,1,0.0,0,0,0,0,0,0,0,1,0,0,1,1
11971,178097,dAqrHPlMsXnPrglFnOZUeJrfWBb2qFZV,G8EPVSXsOYB5YQWZGiz1aVq5Pgr2GrQu,1,0,0,0,0,0,2,0,2,0.2857142857142857,1,0.0,0,0,0,0,0,0,0,2,0,0,2,1
11972,178108,gSVv2aL3mlSaSez3uclTs7guBwBPusEU,A3fsA9Zfv1X2fVEQhTw51lKENdNrEqT3,1,0,0,0,0,0,1,0,1,0.14285714285714285,1,0.0,0,0,0,0,0,0,0,1,0,0,1,1
11973,178129,NMPg56MDKMVC7ti0J9mAofQpqCKjpKCl,bWdj2GDclj5ofokWjzoa5jAwMkxCykd6,8,5,1,0,2,1,6,1,16,2.2857142857142856,1,0.0,3,1,0,2,2,1,0,6,1,6,10,1
11974,178130,NMPg56MDKMVC7ti0J9mAofQpqCKjpKCl,A3fsA9Zfv1X2fVEQhTw51lKENdNrEqT3,1,0,0,0,0,0,1,0,1,0.14285714285714285,1,0.0,0,0,0,0,0,0,0,1,0,0,1,1
11975,178173,yuqt6qA4ywnzzkfFkXqBct0eJDj9XUsS,SpATywNh6bZuzm8s1ceuBUnMUAeoAHHw,6,1,1,0,1,0,3,0,6,0.8571428571428571,1,0.0,0,1,0,1,1,0,0,3,0,2,4,1
11976,178184,fKYKLbyU9DEbtWWdd9SkLOt7DfIpocNH,G8EPVSXsOYB5YQWZGiz1aVq5Pgr2GrQu,10,7,1,0,0,1,9,1,19,2.7142857142857144,1,0.0,0,1,0,0,7,1,0,9,1,1,18,0
11977,178187,3THLA2KuYKQhJc7rfDiBcIyyI3oWoZEW,bWdj2GDclj5ofokWjzoa5jAwMkxCykd6,1,0,0,0,0,0,1,0,1,0.14285714285714285,1,0.0,0,0,0,0,0,0,0,1,0,0,1,1
11978,178206,vYYhKPJ8OWf68zu55Ez1PMsu8DH2KE0M,A3fsA9Zfv1X2fVEQhTw51lKENdNrEqT3,7,5,4,0,4,1,3,0,17,2.4285714285714284,1,0.0,0,4,0,4,5,1,0,3,0,8,9,1
11979,178214,ZgFCLkDPzcdiy0sIzPjvfQAgjdD1TUt9,A3fsA9Zfv1X2fVEQhTw51lKENdNrEqT3,8,6,3,0,1,2,9,2,23,3.2857142857142856,1,0.0,0,3,0,1,6,2,0,9,2,4,19,1
11980,179095,oSzwRDot26Gzbo9Z51q8vW83UZefXQx4,A3fsA9Zfv1X2fVEQhTw51lKENdNrEqT3,1,0,0,0,0,0,1,0,1,0.14285714285714285,1,0.0,0,0,0,0,0,0,0,1,0,0,1,1
11981,179270,qdIBYHN1oo81Fn2PDQ4pWy5luAxUSnv8,A3fsA9Zfv1X2fVEQhTw51lKENdNrEqT3,2,0,0,0,0,0,2,0,2,0.2857142857142857,1,0.0,0,0,0,0,0,0,0,2,0,0,2,1
11982,179272,XydvMA0BgL1Al10q3L0D2wz1Y6wVb2rC,RXDvfPUBYFlVdlueBFbLW0mhhAyGEqpt,23,15,14,0,10,0,2,0,41,5.857142857142857,1,0.0,0,14,0,10,15,0,0,2,0,24,17,1
11983,179280,zeHCiMpomPiZgVEBNBLYszozi2RaN6ma,SpATywNh6bZuzm8s1ceuBUnMUAeoAHHw,7,3,1,0,1,0,4,0,9,1.2857142857142858,1,0.0,0,1,0,1,3,0,0,4,0,2,7,0
11984,179288,D9NEjP5of3onbOL7hxFUdKxRWVR3Zio0,A3fsA9Zfv1X2fVEQhTw51lKENdNrEqT3,4,2,1,0,1,0,1,0,5,0.7142857142857143,1,0.0,0,1,0,1,2,0,0,1,0,2,3,1
11985,179289,Yu225AU92v57j3uCc612YKq3vIxaCm7A,A3fsA9Zfv1X2fVEQhTw51lKENdNrEqT3,8,3,2,0,2,0,5,0,12,1.7142857142857142,1,0.0,0,2,0,2,3,0,0,5,0,4,8,1
11986,179318,0islXLiLHhX22socdAlKCtW1OjyrNJz9,SpATywNh6bZuzm8s1ceuBUnMUAeoAHHw,7,3,2,0,2,0,2,0,9,1.2857142857142858,1,0.0,0,2,0,2,3,0,0,2,0,4,5,1
11987,179369,4s7Pp1HkR1BKGnSREpCdC6xzkb7JZ7RX,A3fsA9Zfv1X2fVEQhTw51lKENdNrEqT3,10,5,4,0,4,0,2,0,15,2.142857142857143,1,0.0,0,4,0,4,5,0,0,2,0,8,7,1
11988,179406,QvbJWpQltbObszIwAlZse9I8csJFcFSS,A3fsA9Zfv1X2fVEQhTw51lKENdNrEqT3,1,0,0,0,0,0,1,0,1,0.14285714285714285,1,0.0,0,0,0,0,0,0,0,1,0,0,1,1
11989,179416,XDzOWUNLzBmGsjdfGLXHCvH3VtT0wXJy,A3fsA9Zfv1X2fVEQhTw51lKENdNrEqT3,2,0,0,0,0,0,2,0,2,0.2857142857142857,1,0.0,0,0,0,0,0,0,0,2,0,0,2,1
11990,179423,P2OYdgxBYF5HxGzcA6vhmPz346TpPX0X,A3fsA9Zfv1X2fVEQhTw51lKENdNrEqT3,9,4,2,0,2,0,5,0,13,1.8571428571428572,1,0.0,0,2,0,2,4,0,0,5,0,4,9,1
11991,179424,RyFLXBVd2U304JMB6ECFi9FilOybDHpw,SpATywNh6bZuzm8s1ceuBUnMUAeoAHHw,12,7,1,17,0,0,4,2,31,4.428571428571429,1,0.0,3,1,16,0,4,0,1,4,2,20,11,1
11992,179447,sRKFcCOCmJuLZB6RUcOH6aSVKmD3A5OQ,SpATywNh6bZuzm8s1ceuBUnMUAeoAHHw,1,0,0,0,0,0,1,0,1,0.14285714285714285,1,0.0,0,0,0,0,0,0,0,1,0,0,1,1
11993,179498,20eWtdYsYJ2HaokCydmTS0vY6S0PepZS,A3fsA9Zfv1X2fVEQhTw51lKENdNrEqT3,12,12,3,0,2,0,7,0,24,3.4285714285714284,2,0.0,0,3,0,2,12,0,0,7,0,5,19,1
11994,179562,0gS5Q732yxgOQo1BReYmVwLNG0PEmJtw,A3fsA9Zfv1X2fVEQhTw51lKENdNrEqT3,23,16,6,40,1,0,8,0,71,10.142857142857142,1,0.0,0,6,34,1,16,0,6,8,0,41,30,1
11995,179578,sgSB1EsUBw19mWgGeblLKNJdgffkgrqj,A3fsA9Zfv1X2fVEQhTw51lKENdNrEqT3,7,3,2,0,2,0,2,0,9,1.2857142857142858,1,0.0,0,2,0,2,3,0,0,2,0,4,5,1
11996,179672,bUAApLDRSsYoejMOs9wtzojFHzl0leoA,A3fsA9Zfv1X2fVEQhTw51lKENdNrEqT3,5,2,1,0,1,0,2,0,6,0.8571428571428571,1,0.0,0,1,0,1,2,0,0,2,0,2,4,1
11997,179724,NqjFMzdUzAzJwedggie2ZM67JdWuAq4g,A3fsA9Zfv1X2fVEQhTw51lKENdNrEqT3,5,5,1,0,0,0,1,0,7,1.0,1,0.0,0,1,0,0,5,0,0,1,0,1,6,1
11998,179732,GnMMDgMkehWbrroCw3WzwugiIkCP2y33,G8EPVSXsOYB5YQWZGiz1aVq5Pgr2GrQu,18,14,9,34,6,7,4,0,74,10.571428571428571,1,0.0,2,9,29,6,12,7,5,4,0,46,28,1
11999,179739,yYsW32kCOP4EgbR8poMa9E3lg8DNZAYh,SpATywNh6bZuzm8s1ceuBUnMUAeoAHHw,1,0,0,0,0,0,1,0,1,0.14285714285714285,1,0.0,0,0,0,0,0,0,0,1,0,0,1,1
12000,179772,StY7mIcclc0vcUIJFTvL9RrXxdUXnEhh,SpATywNh6bZuzm8s1ceuBUnMUAeoAHHw,14,13,7,6,5,3,2,0,36,5.142857142857143,1,0.0,5,7,6,5,8,3,0,2,0,23,13,1
12001,179801,fIbdXFPoTOYlPmaY1ETJ8qg0oyUmhp0g,A3fsA9Zfv1X2fVEQhTw51lKENdNrEqT3,1,0,0,0,0,0,1,0,1,0.14285714285714285,1,0.0,0,0,0,0,0,0,0,1,0,0,1,1
12002,179802,fIbdXFPoTOYlPmaY1ETJ8qg0oyUmhp0g,bWdj2GDclj5ofokWjzoa5jAwMkxCykd6,1,0,0,0,0,0,1,0,1,0.14285714285714285,1,0.0,0,0,0,0,0,0,0,1,0,0,1,1
12003,179825,UeMhoIxbaZNEu0tYucIi541fjxr7wtKF,A3fsA9Zfv1X2fVEQhTw51lKENdNrEqT3,2,0,0,0,0,0,2,0,2,0.2857142857142857,1,0.0,0,0,0,0,0,0,0,2,0,0,2,1
12004,179834,ymWpwD3GRW9ut1JiVBQeAWpoDiatjwOa,A3fsA9Zfv1X2fVEQhTw51lKENdNrEqT3,11,13,11,0,8,0,3,0,35,5.0,2,0.0,1,11,0,8,12,0,0,3,0,20,15,1
12005,179930,y5aBZF9M42jQ3dd47gvkF1IzOdkUj0pK,A3fsA9Zfv1X2fVEQhTw51lKENdNrEqT3,2,0,0,0,0,0,2,0,2,0.2857142857142857,1,0.0,0,0,0,0,0,0,0,2,0,0,2,0
12006,179940,Atic9bcAYez6iPYGWH9qjmSkP3PGX2jq,A3fsA9Zfv1X2fVEQhTw51lKENdNrEqT3,9,13,5,0,3,6,5,0,32,4.571428571428571,1,0.0,0,5,0,3,13,6,0,5,0,8,24,1
12007,179998,xI5OWiIHjz0Mm9IrFHWY7FdkKyLqt0kf,A3fsA9Zfv1X2fVEQhTw51lKENdNrEqT3,6,11,2,0,0,0,7,0,20,2.857142857142857,1,0.0,0,2,0,0,11,0,0,7,0,2,18,1
12008,180006,5I4Sxxub5eHlZ4uVi2doKTMQ77gD08Kz,SpATywNh6bZuzm8s1ceuBUnMUAeoAHHw,3,2,0,0,0,0,2,0,4,0.5714285714285714,1,0.0,0,0,0,0,2,0,0,2,0,0,4,1
12009,180029,KdOpYQwRTjGuX2z1c0SW0st7uOc9iGrk,A3fsA9Zfv1X2fVEQhTw51lKENdNrEqT3,9,5,4,0,3,0,2,0,14,2.0,1,0.0,0,4,0,3,5,0,0,2,0,7,7,1
12010,180039,279AIREJbSXhdF4OGkzTGbmlv4S3xwdE,A3fsA9Zfv1X2fVEQhTw51lKENdNrEqT3,19,7,6,0,6,4,7,1,31,4.428571428571429,1,0.0,0,6,0,6,7,4,0,7,1,12,19,0
12011,180043,IB6QwGjfRbp7aWxgSMpIkngT9FviLi1Z,bWdj2GDclj5ofokWjzoa5jAwMkxCykd6,1,0,0,0,0,0,1,0,1,0.14285714285714285,1,0.0,0,0,0,0,0,0,0,1,0,0,1,1
12012,180050,yAFOzDqu62VOeEElP9JgOlIiP2xoZYrS,7GRhBDsirIGkRZBtSMEzNTyDr2JQm4xx,1,0,0,0,0,0,1,0,1,0.14285714285714285,1,0.0,0,0,0,0,0,0,0,1,0,0,1,1
12013,180099,jrgM1oW0TWS88MYVs7LRUQjqPhGPE54P,7GRhBDsirIGkRZBtSMEzNTyDr2JQm4xx,46,72,36,50,20,32,23,0,233,33.285714285714285,1,0.0,31,36,44,20,41,32,6,23,0,131,102,1
12014,180179,SFfKdrEty3lLCn3Lw45FtRZTydUXwmxu,7GRhBDsirIGkRZBtSMEzNTyDr2JQm4xx,5,2,1,0,1,0,2,0,6,0.8571428571428571,1,0.0,0,1,0,1,2,0,0,2,0,2,4,1
12015,180216,QSaImtnwSyIvS5AffCcxoWPOjD7SK8AN,7GRhBDsirIGkRZBtSMEzNTyDr2JQm4xx,1,0,0,0,0,0,1,0,1,0.14285714285714285,1,0.0,0,0,0,0,0,0,0,1,0,0,1,1
12016,180269,oPqCsuIFtZAPoNsyhKvigrqOFJmD29Ve,7GRhBDsirIGkRZBtSMEzNTyDr2JQm4xx,13,16,7,4,2,10,13,1,53,7.571428571428571,2,0.0,2,7,3,2,14,10,1,13,1,14,39,1
12017,180318,Hf0URgVFicQOS2VXZZFuo5o8pUWE4p7E,7GRhBDsirIGkRZBtSMEzNTyDr2JQm4xx,1,0,0,0,0,0,1,0,1,0.14285714285714285,1,0.0,0,0,0,0,0,0,0,1,0,0,1,1
12018,180326,vIJUyeZxiAlOeYPEqKJHsdkNk5HQVTjW,7GRhBDsirIGkRZBtSMEzNTyDr2JQm4xx,1,0,0,0,0,0,1,0,1,0.14285714285714285,1,0.0,0,0,0,0,0,0,0,1,0,0,1,1
12019,182109,Gwa0DmAnwS7uFof0niE4PXKO0jXe3Slf,fbPkOYLVPtPgIt0MxizjfFJov3JbHyAi,1,0,0,0,0,0,1,0,1,0.14285714285714285,1,0.0,0,0,0,0,0,0,0,1,0,0,1,1
12020,182112,zlwQbpNIekZraqM3friulFpxhiOo1ayo,fbPkOYLVPtPgIt0MxizjfFJov3JbHyAi,10,15,5,12,5,0,1,0,38,5.428571428571429,1,0.0,8,5,10,5,7,0,2,1,0,28,10,1
12021,182113,GYgjnVWPCrydBlTq2p9TNsOMewn9I740,fbPkOYLVPtPgIt0MxizjfFJov3JbHyAi,7,3,2,0,2,1,2,0,10,1.4285714285714286,1,0.0,0,2,0,2,3,1,0,2,0,4,6,1
12022,182116,hHZ1kUumh00Z1O4WNdKmul7qhC5wFHpp,fbPkOYLVPtPgIt0MxizjfFJov3JbHyAi,2,0,0,0,0,0,2,0,2,0.2857142857142857,1,0.0,0,0,0,0,0,0,0,2,0,0,2,1
12023,182119,3cxRLD4ivD6Xixr11d6ir7hAedI4FyWB,fbPkOYLVPtPgIt0MxizjfFJov3JbHyAi,4,4,0,0,0,0,2,0,6,0.8571428571428571,1,0.0,0,0,0,0,4,0,0,2,0,0,6,1
12024,182120,6VA6nLOi6ahJ2WGPKX7ioAOUNgqPHvUs,fbPkOYLVPtPgIt0MxizjfFJov3JbHyAi,2,0,0,0,0,0,6,0,6,0.8571428571428571,1,0.0,0,0,0,0,0,0,0,6,0,0,6,1
12025,182121,E6bBR9HWJxY6CHMf6HUGhFy5mb5tOylJ,fbPkOYLVPtPgIt0MxizjfFJov3JbHyAi,11,8,5,0,5,0,7,0,25,3.5714285714285716,1,0.0,0,5,0,5,8,0,0,7,0,10,15,1
12026,182122,5YQOb4e4NWGumJICWtGzlXhZqNgwWRbu,fbPkOYLVPtPgIt0MxizjfFJov3JbHyAi,4,2,1,0,1,0,2,0,6,0.8571428571428571,1,0.0,0,1,0,1,2,0,0,2,0,2,4,1
12027,182123,ymJ3Ly9A46GdjQR1wi3rfZi54oWQxUId,fbPkOYLVPtPgIt0MxizjfFJov3JbHyAi,18,18,10,0,5,3,10,1,47,6.714285714285714,1,0.0,0,10,0,5,18,3,0,10,1,15,32,1
12028,182126,olMbWc9RSQc0Tu4bEWQzOnwezTDWcrs8,fbPkOYLVPtPgIt0MxizjfFJov3JbHyAi,6,5,1,0,1,0,2,0,9,1.2857142857142858,1,0.0,0,1,0,1,5,0,0,2,0,2,7,1
12029,182127,vRSgOJQhE6Dmiwqh3C4hk74qCb0K1GB9,fbPkOYLVPtPgIt0MxizjfFJov3JbHyAi,10,11,3,0,5,6,8,1,34,4.857142857142857,1,0.0,5,3,0,5,6,6,0,8,1,13,21,1
12030,182129,KZwRHcnI3AfT8vnaT6jXgPBnofHOQ7LC,fbPkOYLVPtPgIt0MxizjfFJov3JbHyAi,7,3,2,0,2,0,2,0,9,1.2857142857142858,1,0.0,0,2,0,2,3,0,0,2,0,4,5,1
12031,182130,NYIqoSfm9poo24TZ0kcwGlXtybBgVCOL,fbPkOYLVPtPgIt0MxizjfFJov3JbHyAi,11,13,6,4,6,13,6,1,49,7.0,1,0.0,5,6,4,6,8,13,0,6,1,21,28,1
12032,182131,fNApL5o3nJBE8hTLknxUE86rJy4pC3GT,fbPkOYLVPtPgIt0MxizjfFJov3JbHyAi,4,3,0,0,0,0,8,0,11,1.5714285714285714,1,0.0,0,0,0,0,3,0,0,8,0,0,11,1
12033,182132,hl9NS7ZQVsxPwew9lFoMcbw555xXfA7K,fbPkOYLVPtPgIt0MxizjfFJov3JbHyAi,7,5,2,0,1,4,3,0,15,2.142857142857143,1,0.0,0,2,0,1,5,4,0,3,0,3,12,1
12034,182133,UyFXTBkXJQGbTK6ia4vV9zDaXqtiIBQm,fbPkOYLVPtPgIt0MxizjfFJov3JbHyAi,7,8,2,0,3,0,2,0,15,2.142857142857143,1,0.0,5,2,0,3,3,0,0,2,0,10,5,1
12035,182136,X4KSPkBIdPEeXdEy4Fa5NvixCQZdfNj3,fbPkOYLVPtPgIt0MxizjfFJov3JbHyAi,4,2,1,0,1,2,1,0,7,1.0,1,0.0,0,1,0,1,2,2,0,1,0,2,5,0
12036,182137,y20f09CxhvS55Wblm8XZJQuRockZgjId,fbPkOYLVPtPgIt0MxizjfFJov3JbHyAi,7,6,2,0,3,0,4,0,15,2.142857142857143,1,0.0,3,2,0,3,3,0,0,4,0,8,7,1
12037,182140,CspzBeiHo2fn2vKCGW8HrTuVGO5NjODD,fbPkOYLVPtPgIt0MxizjfFJov3JbHyAi,7,7,4,0,3,1,1,0,16,2.2857142857142856,1,0.0,1,4,0,3,6,1,0,1,0,8,8,1
12038,182141,AauRkOnfsQwSVeed7CUEfyrgZR6O3N4f,fbPkOYLVPtPgIt0MxizjfFJov3JbHyAi,9,3,2,0,2,1,5,1,14,2.0,1,0.0,0,2,0,2,3,1,0,5,1,4,10,1
12039,182142,ZpH2lTvJnGFaqS5AMOBCpvMR4Yj9r7Pd,fbPkOYLVPtPgIt0MxizjfFJov3JbHyAi,9,3,2,0,2,0,6,1,14,2.0,1,0.0,0,2,0,2,3,0,0,6,1,4,10,1
12040,182148,QXkIuj2oxPauvAqRj9R3CrSpnC0ZZZoj,fbPkOYLVPtPgIt0MxizjfFJov3JbHyAi,1,0,0,0,0,0,1,0,1,0.14285714285714285,1,0.0,0,0,0,0,0,0,0,1,0,0,1,1
12041,182149,Gk8pzlz0IYhW1OkJmVAg6JK1p1uZlJAZ,fbPkOYLVPtPgIt0MxizjfFJov3JbHyAi,1,0,0,0,0,0,1,0,1,0.14285714285714285,1,0.0,0,0,0,0,0,0,0,1,0,0,1,1
12042,182150,7DufOZH7uJb86RSw7kwej322YsuvsAOn,fbPkOYLVPtPgIt0MxizjfFJov3JbHyAi,8,7,3,0,2,0,2,0,14,2.0,1,0.0,0,3,0,2,7,0,0,2,0,5,9,1
12043,182151,9IwP7y3bv6FVCnKXUMMCB32M5XkaXZUv,fbPkOYLVPtPgIt0MxizjfFJov3JbHyAi,4,2,1,0,1,3,1,0,8,1.1428571428571428,1,0.0,0,1,0,1,2,3,0,1,0,2,6,1
12044,182153,LYRECt7UvWAQo3p4ZaUgaxhi8hvbxrUh,fbPkOYLVPtPgIt0MxizjfFJov3JbHyAi,8,3,2,0,2,4,4,1,16,2.2857142857142856,1,0.0,0,2,0,2,3,4,0,4,1,4,12,1
12045,182157,qjvNhzawDTohg4QJduwMXhiyYQLWnwRL,fbPkOYLVPtPgIt0MxizjfFJov3JbHyAi,5,2,1,0,1,0,5,0,9,1.2857142857142858,1,0.0,0,1,0,1,2,0,0,5,0,2,7,1
12046,182158,EbhEKkK0InsrxKv61aHGTKOc8r6D96CH,fbPkOYLVPtPgIt0MxizjfFJov3JbHyAi,5,2,1,0,1,4,5,0,13,1.8571428571428572,1,0.0,0,1,0,1,2,4,0,5,0,2,11,1
12047,182161,fnqTxztLKveM5YvxSzdyiaXhOlLMcpQz,fbPkOYLVPtPgIt0MxizjfFJov3JbHyAi,6,3,2,0,2,0,1,0,8,1.1428571428571428,1,0.0,0,2,0,2,3,0,0,1,0,4,4,1
12048,182290,5toCKkjnRq0eSPOLqtFoS578XbzD4wBw,G8EPVSXsOYB5YQWZGiz1aVq5Pgr2GrQu,1,0,0,0,0,0,1,0,1,0.14285714285714285,1,0.0,0,0,0,0,0,0,0,1,0,0,1,1
12049,182291,cQRD9R1lgeOAK9gupu9KhB7dk2fRklcD,SpATywNh6bZuzm8s1ceuBUnMUAeoAHHw,1,0,0,0,0,0,1,0,1,0.14285714285714285,1,0.0,0,0,0,0,0,0,0,1,0,0,1,1
12050,182293,rjvGhIVc59Kfmh4NTR3DXDqHucpB5jFj,SpATywNh6bZuzm8s1ceuBUnMUAeoAHHw,1,0,0,0,0,0,1,0,1,0.14285714285714285,1,0.0,0,0,0,0,0,0,0,1,0,0,1,1
12051,182294,yzxOtAUXbE94zTY0JAZtWSh2NXgDCsgD,RXDvfPUBYFlVdlueBFbLW0mhhAyGEqpt,1,0,0,0,0,0,2,0,2,0.2857142857142857,1,0.0,0,0,0,0,0,0,0,2,0,0,2,1
12052,182295,zDSSBRMWP1Y5CJVqlFdftdl4OIpV063x,G8EPVSXsOYB5YQWZGiz1aVq5Pgr2GrQu,5,5,2,0,2,0,9,0,18,2.5714285714285716,1,0.0,2,2,0,2,3,0,0,9,0,6,12,1
12053,182301,kSqoYJOiSgMSgk1xmaagqD7swBESTNnk,SpATywNh6bZuzm8s1ceuBUnMUAeoAHHw,1,0,0,0,0,0,1,0,1,0.14285714285714285,1,0.0,0,0,0,0,0,0,0,1,0,0,1,1
12054,182303,6V0aEecugZSGEGjp9sOtqKaVX0hdaxfx,SpATywNh6bZuzm8s1ceuBUnMUAeoAHHw,1,0,0,0,0,0,1,0,1,0.14285714285714285,1,0.0,0,0,0,0,0,0,0,1,0,0,1,1
12055,182311,v2pq4xsqndqpApLtzn0qeg9IWIRhaLtH,RXDvfPUBYFlVdlueBFbLW0mhhAyGEqpt,1,0,0,0,0,0,1,0,1,0.14285714285714285,1,0.0,0,0,0,0,0,0,0,1,0,0,1,1
12056,182316,PlkufWXrNLS9iN2k0xnVvGFQQ3lcdAbM,G8EPVSXsOYB5YQWZGiz1aVq5Pgr2GrQu,1,0,0,0,0,0,1,0,1,0.14285714285714285,1,0.0,0,0,0,0,0,0,0,1,0,0,1,1
12057,182317,pCLzLzljqYC5o1UQJ6Cha7geyVzPY5Vr,SpATywNh6bZuzm8s1ceuBUnMUAeoAHHw,6,3,0,0,0,12,12,2,29,4.142857142857143,1,0.0,0,0,0,0,3,12,0,12,2,0,29,1
12058,182319,dVj05AozpSMnDp2rhv4XKLX2a6Zq0Qtw,G8EPVSXsOYB5YQWZGiz1aVq5Pgr2GrQu,1,0,0,0,0,0,1,0,1,0.14285714285714285,1,0.0,0,0,0,0,0,0,0,1,0,0,1,1
12059,182326,Sw8bR12uIoqYzcTEWiNrFu21bYIsPZ21,SpATywNh6bZuzm8s1ceuBUnMUAeoAHHw,8,3,1,0,1,4,11,1,21,3.0,2,0.0,0,1,0,1,3,4,0,11,1,2,19,1
12060,182335,o4d7pEXcgiRK88QgwrazSAkO64S1An1t,SpATywNh6bZuzm8s1ceuBUnMUAeoAHHw,5,0,0,0,0,1,6,1,8,1.1428571428571428,1,0.0,0,0,0,0,0,1,0,6,1,0,8,1
12061,182339,Xx5J61LsGAAIQtOy53VIgrfa1jCLAM7p,SpATywNh6bZuzm8s1ceuBUnMUAeoAHHw,6,4,0,0,0,0,9,3,16,2.2857142857142856,1,0.0,0,0,0,0,4,0,0,9,3,0,16,1
12062,182340,0hNxT6GuoMZdI4yowbLV9KqXkZO6tOr5,bWdj2GDclj5ofokWjzoa5jAwMkxCykd6,2,0,0,0,0,0,2,0,2,0.2857142857142857,1,0.0,0,0,0,0,0,0,0,2,0,0,2,1
12063,182347,HtQh4lek05i0a5loRX7CCHUQbHgEiPqt,G8EPVSXsOYB5YQWZGiz1aVq5Pgr2GrQu,1,0,0,0,0,0,1,0,1,0.14285714285714285,1,0.0,0,0,0,0,0,0,0,1,0,0,1,1
12064,182353,WO9GKA0lZwTMWZPNOUikUeUkOH5TeVRT,bWdj2GDclj5ofokWjzoa5jAwMkxCykd6,5,1,0,0,0,1,3,0,5,0.7142857142857143,1,0.0,0,0,0,0,1,1,0,3,0,0,5,1
12065,182356,Bk9dV86JsBuitZPucHUYfkNksrS8wdwY,G8EPVSXsOYB5YQWZGiz1aVq5Pgr2GrQu,1,0,0,0,0,0,1,0,1,0.14285714285714285,1,0.0,0,0,0,0,0,0,0,1,0,0,1,1
12066,182364,sHXZP4MEjEMzkkOQfvmTepwt8uTqOiyM,bWdj2GDclj5ofokWjzoa5jAwMkxCykd6,1,0,0,0,0,0,2,0,2,0.2857142857142857,1,0.0,0,0,0,0,0,0,0,2,0,0,2,1
12067,182373,JQ5HcehgeZikB3gBiE8cU639NjwVjWKa,SpATywNh6bZuzm8s1ceuBUnMUAeoAHHw,6,2,0,0,0,4,12,1,19,2.7142857142857144,1,0.0,0,0,0,0,2,4,0,12,1,0,19,1
12068,182381,qaaVUOEYbrLxp7YRueHtvaFuKfMUdZFu,SpATywNh6bZuzm8s1ceuBUnMUAeoAHHw,4,1,0,0,0,0,5,0,6,0.8571428571428571,1,0.0,0,0,0,0,1,0,0,5,0,0,6,1
12069,182382,GaGH1fy9jH1iKzXu03szgy9cHdGLnq5i,SpATywNh6bZuzm8s1ceuBUnMUAeoAHHw,5,3,0,0,0,1,8,1,13,1.8571428571428572,1,0.0,0,0,0,0,3,1,0,8,1,0,13,0
12070,182386,qPi2PGJwgnVJqcFYKHdGLm3vb4xL3Vqe,SpATywNh6bZuzm8s1ceuBUnMUAeoAHHw,3,1,0,0,0,0,2,1,4,0.5714285714285714,1,0.0,0,0,0,0,1,0,0,2,1,0,4,1
12071,182390,1b8W57uM2By4uHrSNMMSnzGhkYIXdyHL,SpATywNh6bZuzm8s1ceuBUnMUAeoAHHw,8,12,6,0,0,17,9,1,45,6.428571428571429,1,0.0,0,6,0,0,12,17,0,9,1,6,39,1
12072,182396,zp4PyZk9acvJn0zAHSStMGVB47KHiGqV,SpATywNh6bZuzm8s1ceuBUnMUAeoAHHw,4,2,0,0,0,1,6,0,9,1.2857142857142858,1,0.0,0,0,0,0,2,1,0,6,0,0,9,1
12073,182408,guVBQQJjeYDSTq5MuNRM97IJcEbUqgcR,bWdj2GDclj5ofokWjzoa5jAwMkxCykd6,1,0,0,0,0,0,1,0,1,0.14285714285714285,1,0.0,0,0,0,0,0,0,0,1,0,0,1,1
12074,182409,Ts2aYicZBB6YO6VPNN4UcEdjhKngsoNN,SpATywNh6bZuzm8s1ceuBUnMUAeoAHHw,5,7,2,0,1,0,4,0,14,2.0,1,0.0,0,2,0,1,7,0,0,4,0,3,11,1
12075,182410,LF2KQyoh29W4ySeHppAbd59MSPNMzEhL,SpATywNh6bZuzm8s1ceuBUnMUAeoAHHw,7,4,3,0,3,0,3,0,13,1.8571428571428572,1,0.0,0,3,0,3,4,0,0,3,0,6,7,1
12076,182412,nWBGuFtxvcnIdby83CLlwrZAI2gdEnIT,SpATywNh6bZuzm8s1ceuBUnMUAeoAHHw,12,23,0,32,0,0,5,0,60,8.571428571428571,1,0.0,15,0,31,0,8,0,1,5,0,46,14,1
12077,182413,GXDOLXInBDPENmCe7wGStFtoPK2oUX4s,SpATywNh6bZuzm8s1ceuBUnMUAeoAHHw,1,0,0,0,0,0,7,0,7,1.0,1,0.0,0,0,0,0,0,0,0,7,0,0,7,1
12078,182431,FvzTIFO6hWFbSbURKzXHQcilBAcLEPtg,SpATywNh6bZuzm8s1ceuBUnMUAeoAHHw,7,6,4,0,2,1,1,0,14,2.0,1,0.0,0,4,0,2,6,1,0,1,0,6,8,1
12079,182432,42bX0uPWOXgBHMwF4wqdnl1Ve6wIHNQe,RXDvfPUBYFlVdlueBFbLW0mhhAyGEqpt,1,0,0,0,0,0,1,0,1,0.14285714285714285,1,0.0,0,0,0,0,0,0,0,1,0,0,1,1
12080,182435,HxeyM7hnjqqrHkT4PVJnwDZtWwoxUMiy,SpATywNh6bZuzm8s1ceuBUnMUAeoAHHw,11,10,1,0,1,1,6,1,20,2.857142857142857,1,0.0,2,1,0,1,8,1,0,6,1,4,16,1
12081,182437,6tKFS11agpQ0olDkx5j9iNHGPGSGzhhI,SpATywNh6bZuzm8s1ceuBUnMUAeoAHHw,5,2,1,0,1,0,3,0,7,1.0,1,0.0,0,1,0,1,2,0,0,3,0,2,5,1
12082,182438,Lj5uTbeKi1sufoHMuLZiALNDuJSM9yU6,SpATywNh6bZuzm8s1ceuBUnMUAeoAHHw,8,12,6,0,4,22,6,0,50,7.142857142857143,1,0.0,0,6,0,4,12,22,0,6,0,10,40,1
12083,182440,kEYZryUXXrs1JDEn4cAws8bSjO65yGwg,SpATywNh6bZuzm8s1ceuBUnMUAeoAHHw,10,4,3,0,2,0,5,0,14,2.0,1,0.0,0,3,0,2,4,0,0,5,0,5,9,1
12084,182443,xS1af9TI3CHZS0INarz6NC45nSv9EYbw,SpATywNh6bZuzm8s1ceuBUnMUAeoAHHw,4,3,1,0,0,0,2,0,6,0.8571428571428571,1,0.0,0,1,0,0,3,0,0,2,0,1,5,0
12085,182456,N48ctBBocxdq0KkO9X20oV13gY0Gjyl2,SpATywNh6bZuzm8s1ceuBUnMUAeoAHHw,5,3,2,0,2,0,2,0,9,1.2857142857142858,1,0.0,0,2,0,2,3,0,0,2,0,4,5,1
12086,182460,GjfYG8nVkFnRE6YCq1jd11CdDUHtJYRI,RXDvfPUBYFlVdlueBFbLW0mhhAyGEqpt,2,0,0,0,0,0,2,0,2,0.2857142857142857,1,0.0,0,0,0,0,0,0,0,2,0,0,2,1
12087,182462,SKgefBsbooOLi1DQ2ANZv6uhR5LclYyt,SpATywNh6bZuzm8s1ceuBUnMUAeoAHHw,2,0,0,0,0,0,2,0,2,0.2857142857142857,1,0.0,0,0,0,0,0,0,0,2,0,0,2,1
12088,182469,3kzqQ9nu0puySXndbv8HvzuMPwBlBjfc,SpATywNh6bZuzm8s1ceuBUnMUAeoAHHw,5,2,1,0,1,0,3,0,7,1.0,1,0.0,0,1,0,1,2,0,0,3,0,2,5,1
12089,182474,jhtAULfQ5yICMx2IFQr24sJJ4xrsxsJG,SpATywNh6bZuzm8s1ceuBUnMUAeoAHHw,5,2,1,0,1,0,2,0,6,0.8571428571428571,1,0.0,0,1,0,1,2,0,0,2,0,2,4,1
12090,182475,mN4qYBgpy4Qxh2rSlBkY5ZDyLEZtAHu9,SpATywNh6bZuzm8s1ceuBUnMUAeoAHHw,6,5,3,0,1,4,3,1,17,2.4285714285714284,2,0.0,0,3,0,1,5,4,0,3,1,4,13,1
12091,182481,vyEmNT9CTTZs1s1eotM7mTmxUqBkMZB7,RXDvfPUBYFlVdlueBFbLW0mhhAyGEqpt,1,0,0,0,0,0,1,0,1,0.14285714285714285,1,0.0,0,0,0,0,0,0,0,1,0,0,1,1
12092,182485,z17j9VE8hh3UoPkOgrySRSueL3ju2tA5,SpATywNh6bZuzm8s1ceuBUnMUAeoAHHw,5,2,1,0,1,0,2,0,6,0.8571428571428571,1,0.0,0,1,0,1,2,0,0,2,0,2,4,1
12093,182486,m5upFVNgYoX0YbIT8oOeY2wNVmvYCqj2,SpATywNh6bZuzm8s1ceuBUnMUAeoAHHw,14,16,0,8,0,0,11,1,36,5.142857142857143,2,0.0,2,0,8,0,14,0,0,11,1,10,26,1
12094,182487,nVOg10sq8HgH3D4DlsGdX3NFr8soVHEc,RXDvfPUBYFlVdlueBFbLW0mhhAyGEqpt,3,0,0,0,0,1,2,1,4,0.5714285714285714,1,0.0,0,0,0,0,0,1,0,2,1,0,4,1
12095,182489,NrHk4qmJXuD0TsjkQSnghKpk9ZjGAOyU,SpATywNh6bZuzm8s1ceuBUnMUAeoAHHw,6,4,3,0,3,0,1,0,11,1.5714285714285714,1,0.0,0,3,0,3,4,0,0,1,0,6,5,1
12096,182494,zsHSwvXoubMUxhT2AYVzfcvRGMppEBUX,SpATywNh6bZuzm8s1ceuBUnMUAeoAHHw,1,0,0,0,0,0,1,0,1,0.14285714285714285,1,0.0,0,0,0,0,0,0,0,1,0,0,1,1
12097,182500,VBP5PzVQEKJYFH0y5ffEek5WfP9EW7uc,RXDvfPUBYFlVdlueBFbLW0mhhAyGEqpt,1,0,0,0,0,0,1,0,1,0.14285714285714285,1,0.0,0,0,0,0,0,0,0,1,0,0,1,1
12098,182502,kAraFi42vk7T3fSVrfxFu4iOqntHqrmm,SpATywNh6bZuzm8s1ceuBUnMUAeoAHHw,5,2,1,0,1,0,2,0,6,0.8571428571428571,1,0.0,0,1,0,1,2,0,0,2,0,2,4,1
12099,182505,m0a4B9CqoOZviuEOZZDt94aINv2ug5oe,SpATywNh6bZuzm8s1ceuBUnMUAeoAHHw,12,12,0,18,0,1,5,1,37,5.285714285714286,1,0.0,7,0,16,0,5,1,2,5,1,23,14,1
12100,182512,6hJQXXKt3z1MdoT6ARo6T723NTe1XSxK,SpATywNh6bZuzm8s1ceuBUnMUAeoAHHw,5,3,2,0,0,0,2,0,7,1.0,1,0.0,0,2,0,0,3,0,0,2,0,2,5,1
12101,182517,ks5e3RcWAMPB7dYikwZWJXfUkWO8gZ3N,SpATywNh6bZuzm8s1ceuBUnMUAeoAHHw,4,3,0,0,1,0,1,0,5,0.7142857142857143,1,0.0,0,0,0,1,3,0,0,1,0,1,4,1
12102,182521,T5B0wanX0DF5aMvlnBdjCYkcuibanyPc,SpATywNh6bZuzm8s1ceuBUnMUAeoAHHw,7,3,2,0,2,1,2,0,10,1.4285714285714286,1,0.0,0,2,0,2,3,1,0,2,0,4,6,1
12103,182523,84Vq27rxsidbGJFxLO0cd5e2CSiXRChu,bWdj2GDclj5ofokWjzoa5jAwMkxCykd6,9,5,3,0,2,0,5,0,15,2.142857142857143,2,0.0,0,3,0,2,5,0,0,5,0,5,10,1
12104,182525,cPdYTPvgiw01Ix09y30D3fRJUN12tLct,SpATywNh6bZuzm8s1ceuBUnMUAeoAHHw,4,2,1,0,1,0,1,0,5,0.7142857142857143,1,0.0,0,1,0,1,2,0,0,1,0,2,3,1
12105,182528,9BiLYY350hgtHO5tL7nbMfcZU0JcfZbs,bWdj2GDclj5ofokWjzoa5jAwMkxCykd6,13,32,11,26,8,6,15,3,101,14.428571428571429,2,0.0,7,11,25,8,25,6,1,15,3,51,50,1
12106,182532,hnqQN2i26CUAGHIpVFZ6rAak8SqbOivU,SpATywNh6bZuzm8s1ceuBUnMUAeoAHHw,14,12,7,0,4,12,6,2,43,6.142857142857143,1,0.0,3,7,0,4,9,12,0,6,2,14,29,1
12107,182535,Y6X26XefNz3sdpw3wkwyK5sCZwXPgnq9,G8EPVSXsOYB5YQWZGiz1aVq5Pgr2GrQu,1,0,0,0,0,0,1,0,1,0.14285714285714285,1,0.0,0,0,0,0,0,0,0,1,0,0,1,1
12108,182537,1MlRC5B28v0ZYaZMhNewOGPdpzQmr9tm,G8EPVSXsOYB5YQWZGiz1aVq5Pgr2GrQu,1,0,0,0,0,0,2,0,2,0.2857142857142857,1,0.0,0,0,0,0,0,0,0,2,0,0,2,1
12109,182549,95du6AurTX5krUoy6t3WLkl60ccYr4Yy,SpATywNh6bZuzm8s1ceuBUnMUAeoAHHw,7,6,3,0,2,0,1,0,12,1.7142857142857142,1,0.0,0,3,0,2,6,0,0,1,0,5,7,1
12110,182550,s7vJJA7T1Y0Q1LgIP8wcUZxSj1YxtrKh,SpATywNh6bZuzm8s1ceuBUnMUAeoAHHw,5,2,1,0,1,0,2,0,6,0.8571428571428571,1,0.0,0,1,0,1,2,0,0,2,0,2,4,1
12111,182551,TzUoSJ3pyMjwCKLIHuVSKLad9h9hLr5U,bWdj2GDclj5ofokWjzoa5jAwMkxCykd6,4,4,0,0,0,0,2,0,6,0.8571428571428571,2,0.0,0,0,0,0,4,0,0,2,0,0,6,1
12112,182562,abjQNDbGZHBvhV75LOq4Zq7eUXUW7X3t,SpATywNh6bZuzm8s1ceuBUnMUAeoAHHw,5,2,1,0,1,16,4,0,24,3.4285714285714284,1,0.0,0,1,0,1,2,16,0,4,0,2,22,1
12113,182564,9TiNdK7h4B0s8IwXYYwGBHmjweOZzBSB,SpATywNh6bZuzm8s1ceuBUnMUAeoAHHw,6,3,2,0,2,0,1,0,8,1.1428571428571428,1,0.0,0,2,0,2,3,0,0,1,0,4,4,1
12114,182566,d5l2AueqCUuxelNqQjpUQXmepKxeL9RK,SpATywNh6bZuzm8s1ceuBUnMUAeoAHHw,2,0,0,0,0,0,3,0,3,0.42857142857142855,1,0.0,0,0,0,0,0,0,0,3,0,0,3,1
12115,182578,2lL4O2JkoYHXEIhykvPcKhzBe5EQva7N,SpATywNh6bZuzm8s1ceuBUnMUAeoAHHw,10,6,4,0,3,1,4,0,18,2.5714285714285716,1,0.0,0,4,0,3,6,1,0,4,0,7,11,1
12116,182580,Sg8cI88TycyqBJF3IvR4MAi6ZTHZwK4Y,SpATywNh6bZuzm8s1ceuBUnMUAeoAHHw,8,4,2,0,2,0,2,0,10,1.4285714285714286,1,0.0,0,2,0,2,4,0,0,2,0,4,6,1
12117,182581,jU374KwiA6GV2KDGbAoaF4QnL7rMxEi0,G8EPVSXsOYB5YQWZGiz1aVq5Pgr2GrQu,2,0,0,0,0,0,2,0,2,0.2857142857142857,1,0.0,0,0,0,0,0,0,0,2,0,0,2,1
12118,182585,2a0JX3oGEViqf41bSYpVwPl2biPpAdoF,SpATywNh6bZuzm8s1ceuBUnMUAeoAHHw,1,0,0,0,0,0,2,0,2,0.2857142857142857,1,0.0,0,0,0,0,0,0,0,2,0,0,2,1
12119,182588,0PHNMn5JYsQigYaNxUJgIv4qow2cWlQK,RXDvfPUBYFlVdlueBFbLW0mhhAyGEqpt,1,0,0,0,0,0,1,0,1,0.14285714285714285,1,0.0,0,0,0,0,0,0,0,1,0,0,1,1
12120,182594,i1weaEaafaiWi31Ms4bwoF6JM4IRf714,RXDvfPUBYFlVdlueBFbLW0mhhAyGEqpt,4,2,1,0,1,0,1,0,5,0.7142857142857143,1,0.0,0,1,0,1,2,0,0,1,0,2,3,1
12121,182597,yP6YIcdT0zgy1EQJGlMcTsst8ErbjUGy,SpATywNh6bZuzm8s1ceuBUnMUAeoAHHw,15,12,7,8,4,0,4,0,35,5.0,1,0.0,2,7,8,4,10,0,0,4,0,21,14,1
12122,182601,ryvCYWNER8Ti86HxjplPmDOVtkpCfcHF,SpATywNh6bZuzm8s1ceuBUnMUAeoAHHw,5,2,0,3,0,0,3,0,8,1.1428571428571428,1,0.0,1,0,3,0,1,0,0,3,0,4,4,1
12123,182603,pC6FwYDHxh9swUa6nvJYcLLtE0AYC1Cg,G8EPVSXsOYB5YQWZGiz1aVq5Pgr2GrQu,1,0,0,0,0,0,1,0,1,0.14285714285714285,1,0.0,0,0,0,0,0,0,0,1,0,0,1,1
12124,182606,DgUbD2nFaZ1xgkcPsb7gJ6lYqMu1fGiD,SpATywNh6bZuzm8s1ceuBUnMUAeoAHHw,10,3,3,0,3,1,8,1,19,2.7142857142857144,1,0.0,0,3,0,3,3,1,0,8,1,6,13,1
12125,182607,wMgpdygsXgp7CzOQBDeaQc0sjt2NDO9y,SpATywNh6bZuzm8s1ceuBUnMUAeoAHHw,9,13,6,0,3,0,3,0,25,3.5714285714285716,1,0.0,0,6,0,3,13,0,0,3,0,9,16,1
12126,182612,0hrKpjkp9zkhrQR2RoP7TZCXn5cdSG8v,SpATywNh6bZuzm8s1ceuBUnMUAeoAHHw,9,12,3,1,2,0,5,0,23,3.2857142857142856,1,0.0,3,3,1,2,9,0,0,5,0,9,14,1
12127,182615,gnekWLWeAJ1MVfJL4ZXLvhc4aznPtP4v,RXDvfPUBYFlVdlueBFbLW0mhhAyGEqpt,18,24,18,0,8,0,6,0,56,8.0,1,0.0,2,18,0,8,22,0,0,6,0,28,28,1
12128,182616,8JTz84ZDdJm6tvsd7hgyCl1RB6wU6r2e,SpATywNh6bZuzm8s1ceuBUnMUAeoAHHw,5,3,2,0,1,0,1,0,7,1.0,1,0.0,0,2,0,1,3,0,0,1,0,3,4,1
12129,182620,pmyN5Lpd7zPzDMrdwaddb9OujjdVFpIA,SpATywNh6bZuzm8s1ceuBUnMUAeoAHHw,1,0,0,0,0,0,1,0,1,0.14285714285714285,1,0.0,0,0,0,0,0,0,0,1,0,0,1,1
12130,182621,uLzTTG1K0rlYPSkAfYE7pAYKyeT5Eqlp,bWdj2GDclj5ofokWjzoa5jAwMkxCykd6,14,24,9,78,4,0,4,0,119,17.0,2,0.0,10,9,71,4,14,0,7,4,0,94,25,1
12131,182622,99qhCmy07rsquumjTFRELTtrLHpQpj07,SpATywNh6bZuzm8s1ceuBUnMUAeoAHHw,9,9,4,0,3,0,1,0,17,2.4285714285714284,1,0.0,0,4,0,3,9,0,0,1,0,7,10,1
12132,182625,pmyN5Lpd7zPzDMrdwaddb9OujjdVFpIA,G8EPVSXsOYB5YQWZGiz1aVq5Pgr2GrQu,1,0,0,0,0,0,1,0,1,0.14285714285714285,1,0.0,0,0,0,0,0,0,0,1,0,0,1,1
12133,182631,jvMxvmnfDR2nX2SDb9U9vK3bZQo5n6aS,SpATywNh6bZuzm8s1ceuBUnMUAeoAHHw,8,4,2,0,2,0,2,0,10,1.4285714285714286,1,0.0,0,2,0,2,4,0,0,2,0,4,6,1
12134,182632,JDFQZtkjaBhYZM0MLFNIDJC3MmDM3j4N,G8EPVSXsOYB5YQWZGiz1aVq5Pgr2GrQu,1,0,0,0,0,0,1,0,1,0.14285714285714285,1,0.0,0,0,0,0,0,0,0,1,0,0,1,1
12135,182635,xQkXRLMidDA6kOSlXJCwzS4szskglPiE,SpATywNh6bZuzm8s1ceuBUnMUAeoAHHw,8,2,2,0,2,0,6,0,12,1.7142857142857142,1,0.0,0,2,0,2,2,0,0,6,0,4,8,1
12136,182642,1KbKxaDkaJs93myqaKszRgBW1gxYyrTr,SpATywNh6bZuzm8s1ceuBUnMUAeoAHHw,7,3,2,0,2,0,2,0,9,1.2857142857142858,1,0.0,0,2,0,2,3,0,0,2,0,4,5,1
12137,182652,OvE6fswKcyt8W4X23yrGAT3owgNKqghE,SpATywNh6bZuzm8s1ceuBUnMUAeoAHHw,5,2,1,0,1,1,2,0,7,1.0,1,0.0,0,1,0,1,2,1,0,2,0,2,5,1
12138,182653,kNUYVfCCGHx63xQDhqVhj2cbZ7iw47SV,SpATywNh6bZuzm8s1ceuBUnMUAeoAHHw,15,18,11,12,5,10,8,0,64,9.142857142857142,1,0.0,2,11,12,5,16,10,0,8,0,30,34,1
12139,182656,3jm0outqyG6Dt6oUYnLDUhzCWjwa7f0d,SpATywNh6bZuzm8s1ceuBUnMUAeoAHHw,5,3,1,0,1,0,2,0,7,1.0,1,0.0,0,1,0,1,3,0,0,2,0,2,5,1
12140,182657,NgSAymzGStRSHltSswQtmpS99cSj4EzE,SpATywNh6bZuzm8s1ceuBUnMUAeoAHHw,14,23,8,20,5,2,4,0,62,8.857142857142858,1,0.0,12,8,17,5,11,2,3,4,0,42,20,1
12141,182659,42WJ8lF0jtc8jUDcyiUTsDeA2HGhhgcv,SpATywNh6bZuzm8s1ceuBUnMUAeoAHHw,5,2,1,0,1,0,3,0,7,1.0,1,0.0,0,1,0,1,2,0,0,3,0,2,5,1
12142,182676,Tqsu4RE8c8PTxIWjwbo0acp1R4rHJLQK,G8EPVSXsOYB5YQWZGiz1aVq5Pgr2GrQu,1,0,0,0,0,0,1,0,1,0.14285714285714285,1,0.0,0,0,0,0,0,0,0,1,0,0,1,1
12143,182681,wIYlooJ3PkONzNoU7I0nxWGWuqjalYcP,SpATywNh6bZuzm8s1ceuBUnMUAeoAHHw,7,5,0,0,0,0,2,0,7,1.0,1,0.0,0,0,0,0,5,0,0,2,0,0,7,1
12144,182683,PmtrviA6hBub1PH85YXqVyZgghNsuc4g,bWdj2GDclj5ofokWjzoa5jAwMkxCykd6,5,6,2,0,1,0,3,0,12,1.7142857142857142,1,0.0,0,2,0,1,6,0,0,3,0,3,9,0
12145,182684,u1buUEFv61yp0wROjZxTLttJ3M1La8iE,bWdj2GDclj5ofokWjzoa5jAwMkxCykd6,5,2,1,0,1,0,2,0,6,0.8571428571428571,1,0.0,0,1,0,1,2,0,0,2,0,2,4,1
12146,182691,PhL2ZyLw1V28vd4DfOVSi8FZIcPFQkVx,RXDvfPUBYFlVdlueBFbLW0mhhAyGEqpt,9,9,0,15,0,0,1,0,25,3.5714285714285716,1,0.0,1,0,14,0,8,0,1,1,0,15,10,1
12147,182692,Dtr7OzFhzoVvzJKeK0urGyJsIrB0TIJH,bWdj2GDclj5ofokWjzoa5jAwMkxCykd6,4,2,0,0,0,0,3,0,5,0.7142857142857143,1,0.0,0,0,0,0,2,0,0,3,0,0,5,1
12148,182700,bpGrzhHHu1EmIR8DPqrwGOVi55Jq7xh3,SpATywNh6bZuzm8s1ceuBUnMUAeoAHHw,1,0,0,0,0,0,1,0,1,0.14285714285714285,1,0.0,0,0,0,0,0,0,0,1,0,0,1,1
12149,182707,vCFSDawXLqrnXpNrVBnTFno2SpXSvGWp,SpATywNh6bZuzm8s1ceuBUnMUAeoAHHw,9,4,3,0,3,0,2,0,12,1.7142857142857142,1,0.0,0,3,0,3,4,0,0,2,0,6,6,1
12150,182709,RGPmxfpZ3Hotrw69jr331xicKNruhw9Y,SpATywNh6bZuzm8s1ceuBUnMUAeoAHHw,9,11,0,1,0,0,3,0,15,2.142857142857143,1,0.0,1,0,1,0,10,0,0,3,0,2,13,1
12151,182713,CZTcq7wzEt9ONvni7ZzjQbcLcDeC1DZ4,SpATywNh6bZuzm8s1ceuBUnMUAeoAHHw,1,0,0,0,0,0,1,0,1,0.14285714285714285,1,0.0,0,0,0,0,0,0,0,1,0,0,1,1
12152,182715,l70wRZ2DS0s6LjbT7C4gRoGrF27x9p2H,RXDvfPUBYFlVdlueBFbLW0mhhAyGEqpt,3,2,0,0,0,0,1,0,3,0.42857142857142855,1,0.0,0,0,0,0,2,0,0,1,0,0,3,1
12153,182719,E2SmOalca4Mn2HYnea1ltBRrUmhkEunr,RXDvfPUBYFlVdlueBFbLW0mhhAyGEqpt,2,0,0,0,0,0,2,0,2,0.2857142857142857,1,0.0,0,0,0,0,0,0,0,2,0,0,2,1
12154,182728,YyGH9YI1z47bsz19P5wTavf6fegO5GlF,SpATywNh6bZuzm8s1ceuBUnMUAeoAHHw,7,8,4,0,3,0,1,0,16,2.2857142857142856,1,0.0,3,4,0,3,5,0,0,1,0,10,6,1
12155,182729,AdlQluSNsa5qamKMPw9WD0mzbeMDsH2H,SpATywNh6bZuzm8s1ceuBUnMUAeoAHHw,4,4,0,0,0,0,4,0,8,1.1428571428571428,1,0.0,2,0,0,0,2,0,0,4,0,2,6,1
12156,182732,58s2cb7fdRQwJqQoDBtdpi70NOxjg3qZ,SpATywNh6bZuzm8s1ceuBUnMUAeoAHHw,4,2,1,0,1,0,1,0,5,0.7142857142857143,1,0.0,0,1,0,1,2,0,0,1,0,2,3,1
12157,182733,sTHTvkTsGG8vLnHKJRukF2jRzSiTp03D,SpATywNh6bZuzm8s1ceuBUnMUAeoAHHw,5,0,0,0,0,1,5,1,7,1.0,1,0.0,0,0,0,0,0,1,0,5,1,0,7,1
12158,182734,4CoRulGyQ4icBbm2v9jyxX1ENJFCtIe4,SpATywNh6bZuzm8s1ceuBUnMUAeoAHHw,15,20,11,27,7,15,5,0,85,12.142857142857142,1,0.0,8,11,21,7,12,15,6,5,0,47,38,1
12159,182737,m2BGUVswXHBZPtMgyVgsV42eoIMpIlIe,SpATywNh6bZuzm8s1ceuBUnMUAeoAHHw,4,0,0,0,0,0,4,0,4,0.5714285714285714,1,0.0,0,0,0,0,0,0,0,4,0,0,4,1
12160,182740,mSs5bB1Rxg3xYWjWjJY9pVTt7WAiMgyu,bWdj2GDclj5ofokWjzoa5jAwMkxCykd6,1,0,0,0,0,0,2,0,2,0.2857142857142857,1,0.0,0,0,0,0,0,0,0,2,0,0,2,1
12161,182741,TDJgAusC4tcAuKVU8oHZGKrqhY6Lp4X4,SpATywNh6bZuzm8s1ceuBUnMUAeoAHHw,9,10,1,25,0,0,1,0,37,5.285714285714286,1,0.0,4,1,20,0,6,0,5,1,0,25,12,1
12162,182747,y8tduZmgWrgzcw2L4zthOZlXWzNlHnmJ,SpATywNh6bZuzm8s1ceuBUnMUAeoAHHw,5,2,1,0,1,0,2,0,6,0.8571428571428571,1,0.0,0,1,0,1,2,0,0,2,0,2,4,1
12163,182748,qBpMFzKW2718794c3zfgwmEpIQp9kP8K,SpATywNh6bZuzm8s1ceuBUnMUAeoAHHw,1,0,0,0,0,0,1,0,1,0.14285714285714285,1,0.0,0,0,0,0,0,0,0,1,0,0,1,1
12164,182758,2HbabEHSEnqM0bBaiJs30PG9549v5yOk,bWdj2GDclj5ofokWjzoa5jAwMkxCykd6,6,7,4,0,2,10,5,0,28,4.0,1,0.0,0,4,0,2,7,10,0,5,0,6,22,1
12165,182767,sNbJ7pzaVnDxlASTW0niTKovpFXjQSy0,SpATywNh6bZuzm8s1ceuBUnMUAeoAHHw,5,5,3,0,1,3,2,0,14,2.0,1,0.0,0,3,0,1,5,3,0,2,0,4,10,1
12166,182770,VyinneBSnu52o8UNYSCuv49XXxRYrO53,bWdj2GDclj5ofokWjzoa5jAwMkxCykd6,1,0,0,0,0,0,2,0,2,0.2857142857142857,1,0.0,0,0,0,0,0,0,0,2,0,0,2,1
12167,182774,TzCu0qgQvcoK9kO9NBGEPpkuqzoJ6woq,RXDvfPUBYFlVdlueBFbLW0mhhAyGEqpt,20,15,11,28,4,8,4,0,70,10.0,2,0.0,2,11,26,4,13,8,2,4,0,43,27,1
12168,182780,yMIQHZsn323wNw1rKC7KVgV21MZHgiuz,bWdj2GDclj5ofokWjzoa5jAwMkxCykd6,2,0,0,0,0,0,2,0,2,0.2857142857142857,1,0.0,0,0,0,0,0,0,0,2,0,0,2,1
12169,182782,9tOn7goHN9N7J9eojiuTfPcShVM7kNFp,SpATywNh6bZuzm8s1ceuBUnMUAeoAHHw,5,9,1,0,1,0,1,0,12,1.7142857142857142,1,0.0,0,1,0,1,9,0,0,1,0,2,10,1
12170,182784,VWOXBW9EkYxZ0T2dOO4SxzMKxSN8bgNI,G8EPVSXsOYB5YQWZGiz1aVq5Pgr2GrQu,12,11,3,0,3,6,23,1,47,6.714285714285714,1,0.0,2,3,0,3,9,6,0,23,1,8,39,0
12171,182798,IkIRLi9Hmy3B5WcPYXBnOiu1cJErCZKt,RXDvfPUBYFlVdlueBFbLW0mhhAyGEqpt,8,7,0,13,2,0,5,0,27,3.857142857142857,1,0.0,6,0,10,2,1,0,3,5,0,18,9,1
12172,182808,kCXzR6ce1eaurKGud1Yjcq6ND5eQQb6c,G8EPVSXsOYB5YQWZGiz1aVq5Pgr2GrQu,19,25,13,60,5,3,10,2,118,16.857142857142858,1,0.0,8,13,53,5,17,3,7,10,2,79,39,1
12173,182810,kqM4LD5JOLaYmtsmvPLTUDaTCfv2YPdG,SpATywNh6bZuzm8s1ceuBUnMUAeoAHHw,1,0,0,0,0,0,1,0,1,0.14285714285714285,1,0.0,0,0,0,0,0,0,0,1,0,0,1,1
12174,182813,mSXZKJ9e3RCTXopgrFUphpxYgeKp7tlG,G8EPVSXsOYB5YQWZGiz1aVq5Pgr2GrQu,11,16,7,0,4,7,2,0,36,5.142857142857143,1,0.0,7,7,0,4,9,7,0,2,0,18,18,1
12175,182814,jhJWgDURvdBA1kmFGY4Ezste38F8s208,SpATywNh6bZuzm8s1ceuBUnMUAeoAHHw,6,2,0,0,0,4,6,1,13,1.8571428571428572,1,0.0,0,0,0,0,2,4,0,6,1,0,13,1
12176,182819,p7Mr6Ok0a4vcUFYBslKXHXBRGQMy3QGf,G8EPVSXsOYB5YQWZGiz1aVq5Pgr2GrQu,5,2,0,0,0,0,3,0,5,0.7142857142857143,1,0.0,0,0,0,0,2,0,0,3,0,0,5,1
12177,182820,o3hN6q5KODtoiHqaRQtCHeenQfWWwJmZ,bWdj2GDclj5ofokWjzoa5jAwMkxCykd6,8,3,1,0,1,3,6,1,15,2.142857142857143,1,0.0,1,1,0,1,2,3,0,6,1,3,12,1
12178,182823,YkXExE2iZQg9FZbuDDBEUmC7J16BAywt,SpATywNh6bZuzm8s1ceuBUnMUAeoAHHw,7,3,2,0,2,0,2,0,9,1.2857142857142858,1,0.0,0,2,0,2,3,0,0,2,0,4,5,1
12179,182824,HguVwcZaqEwGXJzY3HP39fA7Ctl2ESJX,SpATywNh6bZuzm8s1ceuBUnMUAeoAHHw,3,0,0,0,0,0,3,0,3,0.42857142857142855,1,0.0,0,0,0,0,0,0,0,3,0,0,3,1
12180,182825,akObaqJGuxjG1OPwZ5IUA6gd9nOx4oJA,SpATywNh6bZuzm8s1ceuBUnMUAeoAHHw,6,3,2,0,2,0,1,0,8,1.1428571428571428,1,0.0,0,2,0,2,3,0,0,1,0,4,4,1
12181,182834,9MvSiFhTOIXzdJdkvHVmHtDUCykt8hMb,RXDvfPUBYFlVdlueBFbLW0mhhAyGEqpt,1,0,0,0,0,0,1,0,1,0.14285714285714285,1,0.0,0,0,0,0,0,0,0,1,0,0,1,1
12182,182835,RkK6wAnzc2qyntdfmCfNZV178HOs8z1G,SpATywNh6bZuzm8s1ceuBUnMUAeoAHHw,7,3,2,0,2,0,2,0,9,1.2857142857142858,1,0.0,0,2,0,2,3,0,0,2,0,4,5,1
12183,182836,vIwO29pFDuU0ivIbuEkS0ajYobih9mJy,SpATywNh6bZuzm8s1ceuBUnMUAeoAHHw,1,0,0,0,0,0,1,0,1,0.14285714285714285,1,0.0,0,0,0,0,0,0,0,1,0,0,1,1
12184,182839,1i94xoT1OVM1lTP3R294JlD5odSrEcP5,G8EPVSXsOYB5YQWZGiz1aVq5Pgr2GrQu,4,8,0,0,1,0,1,0,10,1.4285714285714286,1,0.0,3,0,0,1,5,0,0,1,0,4,6,1
12185,182850,Klt9qoufCaIWdba44x7MkMWwmjaj9rrO,SpATywNh6bZuzm8s1ceuBUnMUAeoAHHw,7,3,2,0,2,0,2,0,9,1.2857142857142858,1,0.0,0,2,0,2,3,0,0,2,0,4,5,1
12186,182854,JO39AO6t7PlfqwBybyNaLNHxe7KK1KKl,SpATywNh6bZuzm8s1ceuBUnMUAeoAHHw,5,2,1,0,1,0,2,0,6,0.8571428571428571,1,0.0,0,1,0,1,2,0,0,2,0,2,4,1
12187,182855,NaGWxZf58IyW9QoVHeBvFF43QTruA6pk,G8EPVSXsOYB5YQWZGiz1aVq5Pgr2GrQu,5,3,1,0,1,0,1,0,6,0.8571428571428571,1,0.0,0,1,0,1,3,0,0,1,0,2,4,1
12188,182863,HXHzL7PqrUL6ax4VV0BL6WUNfIFy8UXd,bWdj2GDclj5ofokWjzoa5jAwMkxCykd6,5,2,1,0,1,0,2,0,6,0.8571428571428571,1,0.0,0,1,0,1,2,0,0,2,0,2,4,1
12189,182874,wfWgaSJojVTsOWnu0Zw38TJ4gTxVsstc,SpATywNh6bZuzm8s1ceuBUnMUAeoAHHw,10,8,5,0,3,0,2,0,18,2.5714285714285716,1,0.0,0,5,0,3,8,0,0,2,0,8,10,1
12190,182875,PdvjXH7022Nj56iHc15p9NRzsFaRES9J,SpATywNh6bZuzm8s1ceuBUnMUAeoAHHw,6,7,2,0,0,0,3,0,12,1.7142857142857142,1,0.0,0,2,0,0,7,0,0,3,0,2,10,1
12191,182886,zcNroqWUiRIsPxABKRrWkwPAId27OxZy,SpATywNh6bZuzm8s1ceuBUnMUAeoAHHw,1,0,0,0,0,0,1,0,1,0.14285714285714285,1,0.0,0,0,0,0,0,0,0,1,0,0,1,1
12192,182891,fdJXQSSucuzaRljy096jXgInnW2TakHQ,G8EPVSXsOYB5YQWZGiz1aVq5Pgr2GrQu,1,0,0,0,0,0,1,0,1,0.14285714285714285,1,0.0,0,0,0,0,0,0,0,1,0,0,1,1
12193,182894,Wm4d7ifDaTgcR0GfUqwJt5OZKbYglRCq,RXDvfPUBYFlVdlueBFbLW0mhhAyGEqpt,1,0,0,0,0,0,1,0,1,0.14285714285714285,1,0.0,0,0,0,0,0,0,0,1,0,0,1,1
12194,182899,LgLijvJ6nDDZDXZheZk4D1S1H0ok87z5,SpATywNh6bZuzm8s1ceuBUnMUAeoAHHw,10,7,5,0,4,0,3,0,19,2.7142857142857144,1,0.0,0,5,0,4,7,0,0,3,0,9,10,1
12195,182900,CqHYUR2wxaYgHzOmefYHdYFAqnjgWzGT,G8EPVSXsOYB5YQWZGiz1aVq5Pgr2GrQu,9,4,1,0,2,1,9,1,18,2.5714285714285716,1,0.0,2,1,0,2,2,1,0,9,1,5,13,1
12196,182906,DYhVLGAPWOAx4wB3gzSHS1w7MxX73feL,RXDvfPUBYFlVdlueBFbLW0mhhAyGEqpt,5,4,1,0,1,0,2,0,8,1.1428571428571428,1,0.0,0,1,0,1,4,0,0,2,0,2,6,1
12197,182912,effsEtqrwknjHEr0npnCFm7KOzCTSt0r,SpATywNh6bZuzm8s1ceuBUnMUAeoAHHw,7,2,1,0,1,0,4,1,9,1.2857142857142858,1,0.0,0,1,0,1,2,0,0,4,1,2,7,0
12198,182916,QBj5ZW5uQiE9SstQccaFKwhAjo1qH9Dk,RXDvfPUBYFlVdlueBFbLW0mhhAyGEqpt,1,0,0,0,0,0,1,0,1,0.14285714285714285,1,0.0,0,0,0,0,0,0,0,1,0,0,1,1
12199,182917,HidChEYUkwCd57tLyDRaYOVeEhFDQ3Gw,bWdj2GDclj5ofokWjzoa5jAwMkxCykd6,5,8,0,53,2,0,1,0,64,9.142857142857142,1,0.0,5,0,52,2,3,0,1,1,0,59,5,1
12200,182918,7kTFcvgxY9P1Hkw99pjiwbkFh98nJXIE,RXDvfPUBYFlVdlueBFbLW0mhhAyGEqpt,6,5,4,0,2,0,1,0,12,1.7142857142857142,1,0.0,0,4,0,2,5,0,0,1,0,6,6,1
12201,182920,Dtrw7jIOc6N9cJtQZ4pVW9s2qBJPFTTc,SpATywNh6bZuzm8s1ceuBUnMUAeoAHHw,7,2,1,0,1,1,4,1,10,1.4285714285714286,1,0.0,0,1,0,1,2,1,0,4,1,2,8,1
12202,182922,TulvnxhxqY9XFV1SbRR2w0EFWo4ahEEO,SpATywNh6bZuzm8s1ceuBUnMUAeoAHHw,10,27,8,0,0,1,21,3,60,8.571428571428571,2,0.0,19,8,0,0,8,1,0,21,3,27,33,1
12203,182924,eCJN0zxGlTEvXWXpm18IFLjiZf0BGvPo,SpATywNh6bZuzm8s1ceuBUnMUAeoAHHw,9,7,4,0,3,0,5,0,19,2.7142857142857144,2,0.0,1,4,0,3,6,0,0,5,0,8,11,1
12204,182925,VU8zmf7Owaz6sNWcWKLdrCl3ZTLYDEQY,SpATywNh6bZuzm8s1ceuBUnMUAeoAHHw,1,0,0,0,0,0,1,0,1,0.14285714285714285,1,0.0,0,0,0,0,0,0,0,1,0,0,1,1
12205,182931,jtsbnKKZ9XPpwCclPqSDCMPCyLbC3Ksj,SpATywNh6bZuzm8s1ceuBUnMUAeoAHHw,12,36,0,13,0,72,11,4,136,19.428571428571427,1,0.0,24,0,11,0,12,72,2,11,4,35,101,0
12206,182940,FIgFPRNDKi4WgyVVOEDupBUIDsQ9EQjV,bWdj2GDclj5ofokWjzoa5jAwMkxCykd6,6,3,2,0,2,0,1,0,8,1.1428571428571428,1,0.0,0,2,0,2,3,0,0,1,0,4,4,1
12207,182941,rwSODbQgRDu2S1bK7vXZWKLJHo1nYnGp,RXDvfPUBYFlVdlueBFbLW0mhhAyGEqpt,5,2,1,0,1,0,3,0,7,1.0,1,0.0,0,1,0,1,2,0,0,3,0,2,5,1
12208,182946,vxHy8fVeIc8PK6sLXnCDyEMZZSM3Rj0M,RXDvfPUBYFlVdlueBFbLW0mhhAyGEqpt,10,9,1,0,1,0,3,0,14,2.0,2,0.0,0,1,0,1,9,0,0,3,0,2,12,1
12209,182948,vag4ySgp6Xv9LLImwgHsnSu0uSrwUg8z,SpATywNh6bZuzm8s1ceuBUnMUAeoAHHw,7,5,1,0,1,0,4,0,11,1.5714285714285714,1,0.0,0,1,0,1,5,0,0,4,0,2,9,1
12210,182949,ffGclPAQxsNqhgZk4UCZvcIXCepIlinY,SpATywNh6bZuzm8s1ceuBUnMUAeoAHHw,4,2,0,0,0,0,4,0,6,0.8571428571428571,1,0.0,0,0,0,0,2,0,0,4,0,0,6,1
12211,182952,IBE9FtQ9x1E7k3ZNC16nikEg5d3E4b8O,bWdj2GDclj5ofokWjzoa5jAwMkxCykd6,14,25,0,51,2,10,11,4,103,14.714285714285714,1,0.0,17,0,48,2,8,10,3,11,4,67,36,1
12212,182954,c6Fui1ajX2dPIYhG2OvpvJJxojMFsXjs,SpATywNh6bZuzm8s1ceuBUnMUAeoAHHw,3,2,0,0,0,0,2,0,4,0.5714285714285714,1,0.0,0,0,0,0,2,0,0,2,0,0,4,1
12213,182968,XARPe6DPXR8KDgKnXuqN5NP0VHFMzwUO,SpATywNh6bZuzm8s1ceuBUnMUAeoAHHw,6,1,1,0,1,0,3,0,6,0.8571428571428571,1,0.0,0,1,0,1,1,0,0,3,0,2,4,1
12214,182984,2hadEUwp57oaCSemFWbiVdojDARXylA4,SpATywNh6bZuzm8s1ceuBUnMUAeoAHHw,16,25,6,6,4,6,5,2,54,7.714285714285714,1,0.0,18,6,6,4,7,6,0,5,2,34,20,1
12215,182985,EHr9i7DrAmLY9IIcFmxYuvipqCAk2sM7,SpATywNh6bZuzm8s1ceuBUnMUAeoAHHw,1,0,0,0,0,0,1,0,1,0.14285714285714285,1,0.0,0,0,0,0,0,0,0,1,0,0,1,1
12216,182987,CflmnNLx1El6KrTaSWqI7nU1TsN8LeKr,G8EPVSXsOYB5YQWZGiz1aVq5Pgr2GrQu,5,2,1,0,1,0,2,0,6,0.8571428571428571,1,0.0,0,1,0,1,2,0,0,2,0,2,4,1
12217,182993,ZxyDDY406MYSLk3FLUMvDHc7n6my0jWC,bWdj2GDclj5ofokWjzoa5jAwMkxCykd6,10,4,2,0,1,21,14,4,46,6.571428571428571,1,0.0,0,2,0,1,4,21,0,14,4,3,43,1
12218,183001,bG2jmidl1bDsU5kwFldO2hSfMzLKGTZ3,SpATywNh6bZuzm8s1ceuBUnMUAeoAHHw,1,0,0,0,0,0,1,0,1,0.14285714285714285,1,0.0,0,0,0,0,0,0,0,1,0,0,1,1
12219,183002,qeZsVtb8AWeyVhfs2hYQ0ujp2PobwrVT,RXDvfPUBYFlVdlueBFbLW0mhhAyGEqpt,6,3,0,0,0,0,4,0,7,1.0,1,0.0,0,0,0,0,3,0,0,4,0,0,7,1
12220,183004,hzI7F4aEa5EKvJiM87cs2lRhWvluO07x,SpATywNh6bZuzm8s1ceuBUnMUAeoAHHw,18,28,13,9,4,2,18,4,78,11.142857142857142,2,0.0,8,13,8,4,20,2,1,18,4,33,45,0
12221,183007,bXjfWJe04qOx78zkMNdSaPRQzOnTNGYL,SpATywNh6bZuzm8s1ceuBUnMUAeoAHHw,4,3,1,0,1,0,1,0,6,0.8571428571428571,1,0.0,0,1,0,1,3,0,0,1,0,2,4,1
12222,183009,hPhWVQjBXU898finCJGmzk0KCmEwCOvP,SpATywNh6bZuzm8s1ceuBUnMUAeoAHHw,1,0,0,0,0,0,1,0,1,0.14285714285714285,1,0.0,0,0,0,0,0,0,0,1,0,0,1,1
12223,183010,5PoE3YvA0iZFEwystRRucVmekQOUvlOx,RXDvfPUBYFlVdlueBFbLW0mhhAyGEqpt,1,0,0,0,0,0,2,0,2,0.2857142857142857,1,0.0,0,0,0,0,0,0,0,2,0,0,2,1
12224,183016,GQxqlKBuTHN1s8soumNB9QXxdu6crGoG,bWdj2GDclj5ofokWjzoa5jAwMkxCykd6,3,1,0,0,0,0,3,0,4,0.5714285714285714,1,0.0,0,0,0,0,1,0,0,3,0,0,4,1
12225,183024,Yb5pEK7VjcxeVZ9fUeqOSZHX1vLfJthY,SpATywNh6bZuzm8s1ceuBUnMUAeoAHHw,9,4,2,0,1,1,9,1,18,2.5714285714285716,1,0.0,0,2,0,1,4,1,0,9,1,3,15,1
12226,183026,rVKS9MvAzj9bHO6qj6FhT80Vyfah5rgx,RXDvfPUBYFlVdlueBFbLW0mhhAyGEqpt,2,0,0,0,0,0,3,0,3,0.42857142857142855,1,0.0,0,0,0,0,0,0,0,3,0,0,3,1
12227,183033,5RiaRbVAffy243QN8cvvydK7FTo8Ge7y,SpATywNh6bZuzm8s1ceuBUnMUAeoAHHw,6,3,2,0,2,0,1,0,8,1.1428571428571428,1,0.0,0,2,0,2,3,0,0,1,0,4,4,1
12228,183038,AvefIGzCaOx0Wgqe3dv7u8LN0NNvyUzu,RXDvfPUBYFlVdlueBFbLW0mhhAyGEqpt,11,3,2,12,2,0,5,0,24,3.4285714285714284,2,0.0,1,2,11,2,2,0,1,5,0,16,8,1
12229,183040,PybrMIHJW5iPpVWCSYrCV4jYePWbXmcH,SpATywNh6bZuzm8s1ceuBUnMUAeoAHHw,4,2,0,0,0,1,4,1,8,1.1428571428571428,1,0.0,0,0,0,0,2,1,0,4,1,0,8,1
12230,183041,b07lyeDRIGTDb23WDQrqmxKnx7uJ6kqa,RXDvfPUBYFlVdlueBFbLW0mhhAyGEqpt,6,2,0,0,0,0,5,2,9,1.2857142857142858,1,0.0,0,0,0,0,2,0,0,5,2,0,9,1
12231,183042,43XnUoAZbDkvxCOgOY8IuFHvhpNa62ol,SpATywNh6bZuzm8s1ceuBUnMUAeoAHHw,1,0,0,0,0,0,1,0,1,0.14285714285714285,1,0.0,0,0,0,0,0,0,0,1,0,0,1,1
12232,183048,oeQ1nHqbsofIU4Gddro5UkGg44HCxqO8,SpATywNh6bZuzm8s1ceuBUnMUAeoAHHw,8,9,3,0,2,0,2,0,16,2.2857142857142856,1,0.0,1,3,0,2,8,0,0,2,0,6,10,1
12233,183050,aBjPpLZjZVQXphzIZ2ZdW0Gy5cspTPuz,SpATywNh6bZuzm8s1ceuBUnMUAeoAHHw,8,3,1,0,1,0,4,2,11,1.5714285714285714,1,0.0,0,1,0,1,3,0,0,4,2,2,9,1
12234,183056,h6N9SyV6dQj6If7QxGp31IQ94XXyWUIO,bWdj2GDclj5ofokWjzoa5jAwMkxCykd6,4,2,1,0,1,0,2,0,6,0.8571428571428571,1,0.0,0,1,0,1,2,0,0,2,0,2,4,0
12235,183059,6xyaVeSZsCu6Nqe5h1ruYj89xweZsGkX,SpATywNh6bZuzm8s1ceuBUnMUAeoAHHw,8,2,1,0,1,0,10,1,15,2.142857142857143,1,0.0,0,1,0,1,2,0,0,10,1,2,13,1
12236,183066,Oq9Z1hsv3NeEDP3Q4F964BpI3HU1uf4u,RXDvfPUBYFlVdlueBFbLW0mhhAyGEqpt,41,87,26,104,14,19,3,0,253,36.142857142857146,1,0.0,28,26,97,14,59,19,7,3,0,165,88,1
12237,183075,8SwolTrUbLeQIryGNwnSraj6AIJcPhi1,RXDvfPUBYFlVdlueBFbLW0mhhAyGEqpt,8,3,2,0,0,1,6,2,14,2.0,1,0.0,0,2,0,0,3,1,0,6,2,2,12,1
12238,183076,kE46GjSqE5uiUhF9LbgXs97FJQSvErKB,SpATywNh6bZuzm8s1ceuBUnMUAeoAHHw,18,14,9,8,5,2,9,1,48,6.857142857142857,3,0.0,2,9,8,5,12,2,0,9,1,24,24,0
12239,183079,UZQMHBD59LcFUBlLzTajpfngFoDhvuqd,bWdj2GDclj5ofokWjzoa5jAwMkxCykd6,2,0,0,0,0,0,2,0,2,0.2857142857142857,1,0.0,0,0,0,0,0,0,0,2,0,0,2,0
12240,183082,IKXwL3bDtlAxjRP4WWhZczJlcbIhG3ib,bWdj2GDclj5ofokWjzoa5jAwMkxCykd6,5,2,1,0,1,0,3,0,7,1.0,1,0.0,0,1,0,1,2,0,0,3,0,2,5,1
12241,183083,EbfkLutG3Wlnfk5dlvXr0Vcdn1M25FU9,bWdj2GDclj5ofokWjzoa5jAwMkxCykd6,13,21,11,0,7,15,10,1,65,9.285714285714286,2,0.0,4,11,0,7,17,15,0,10,1,22,43,1
12242,183092,xrcBYo5W41za7iW83F0KEtd3oYoFiOrz,SpATywNh6bZuzm8s1ceuBUnMUAeoAHHw,6,3,2,0,2,0,2,0,9,1.2857142857142858,1,0.0,0,2,0,2,3,0,0,2,0,4,5,1
12243,183094,LielUY2CViAshyTPFVeBFjcM9c8YHKw6,SpATywNh6bZuzm8s1ceuBUnMUAeoAHHw,4,2,0,0,0,0,2,0,4,0.5714285714285714,1,0.0,0,0,0,0,2,0,0,2,0,0,4,1
12244,183098,iYmkUVGHT7OvfSsIIRGv9c31sCISp6uV,bWdj2GDclj5ofokWjzoa5jAwMkxCykd6,3,2,0,0,0,0,2,0,4,0.5714285714285714,2,0.0,0,0,0,0,2,0,0,2,0,0,4,1
12245,183100,zgTz7w4MQKVAfOVf6tj5uMnkGGy77PYu,SpATywNh6bZuzm8s1ceuBUnMUAeoAHHw,8,3,1,0,1,1,4,1,11,1.5714285714285714,1,0.0,0,1,0,1,3,1,0,4,1,2,9,1
12246,183105,HTGHrKrt9bt2no7NEjeTqA36pNapNLke,bWdj2GDclj5ofokWjzoa5jAwMkxCykd6,1,0,0,0,0,0,1,0,1,0.14285714285714285,1,0.0,0,0,0,0,0,0,0,1,0,0,1,1
12247,183106,5UgB7WrC5inA92uoZPywCX6RsZIYfbPF,SpATywNh6bZuzm8s1ceuBUnMUAeoAHHw,7,5,2,0,2,6,4,0,19,2.7142857142857144,1,0.0,0,2,0,2,5,6,0,4,0,4,15,1
12248,183110,53fG4qjpoEeWdWNP9xPO2S2BFstrPjGH,RXDvfPUBYFlVdlueBFbLW0mhhAyGEqpt,9,5,0,0,0,1,10,11,27,3.857142857142857,2,0.0,0,0,0,0,5,1,0,10,11,0,27,1
12249,183113,PHVZqegG7Zevy6zLiqsCasCOZvoRRNNg,SpATywNh6bZuzm8s1ceuBUnMUAeoAHHw,7,5,4,0,3,0,2,0,14,2.0,1,0.0,0,4,0,3,5,0,0,2,0,7,7,1
12250,183114,g1dFQ3mnVnBiIhnsU4zqK21biH9l5lF9,bWdj2GDclj5ofokWjzoa5jAwMkxCykd6,8,5,1,0,1,0,4,1,12,1.7142857142857142,1,0.0,0,1,0,1,5,0,0,4,1,2,10,1
12251,183117,WDD9a1qNUJX21r5OnYzYbe9snqA1PiYA,G8EPVSXsOYB5YQWZGiz1aVq5Pgr2GrQu,10,7,4,0,3,0,3,0,17,2.4285714285714284,1,0.0,1,4,0,3,6,0,0,3,0,8,9,1
12252,183118,Xebl2a1reCTgb3CZmsapTzbcj94w3H8B,SpATywNh6bZuzm8s1ceuBUnMUAeoAHHw,1,0,0,0,0,0,2,0,2,0.2857142857142857,1,0.0,0,0,0,0,0,0,0,2,0,0,2,1
12253,183125,juPgseiv6fz8BUaq09A165VVR6UHjpbU,SpATywNh6bZuzm8s1ceuBUnMUAeoAHHw,5,2,1,0,1,1,2,1,8,1.1428571428571428,1,0.0,0,1,0,1,2,1,0,2,1,2,6,1
12254,183127,Hm8PhmgumYGSpnWdU16xXCEPyBtXct0m,G8EPVSXsOYB5YQWZGiz1aVq5Pgr2GrQu,6,3,0,0,0,0,3,0,6,0.8571428571428571,1,0.0,0,0,0,0,3,0,0,3,0,0,6,1
12255,183128,JChnJwlkYSD6G5rkj5DhsEWsQiOBTkEx,G8EPVSXsOYB5YQWZGiz1aVq5Pgr2GrQu,8,2,1,0,1,1,6,1,12,1.7142857142857142,1,0.0,0,1,0,1,2,1,0,6,1,2,10,1
12256,183135,TVBdP57RgHmXdzDOQxhhxrruZniECnNa,G8EPVSXsOYB5YQWZGiz1aVq5Pgr2GrQu,10,5,3,0,2,3,11,1,25,3.5714285714285716,2,0.0,0,3,0,2,5,3,0,11,1,5,20,0
12257,183136,Wh6uG1HOxpwP3HtqSjbX0A0Sk2Rn3Ci7,SpATywNh6bZuzm8s1ceuBUnMUAeoAHHw,3,0,0,0,0,0,3,0,3,0.42857142857142855,1,0.0,0,0,0,0,0,0,0,3,0,0,3,1
12258,183137,HIa1PFcWZWr32eqQoCfZvVHM2iyl701E,G8EPVSXsOYB5YQWZGiz1aVq5Pgr2GrQu,8,13,4,0,2,1,3,0,23,3.2857142857142856,1,0.0,3,4,0,2,10,1,0,3,0,9,14,1
12259,183142,DZfIhfsDxjKeEsV2YKbtNB2Ii6s7pc9Z,G8EPVSXsOYB5YQWZGiz1aVq5Pgr2GrQu,5,2,1,0,1,0,2,0,6,0.8571428571428571,1,0.0,0,1,0,1,2,0,0,2,0,2,4,1
12260,183145,Jur8wTdD1tDMuHkI3CFyF52Um8NeR9PV,G8EPVSXsOYB5YQWZGiz1aVq5Pgr2GrQu,37,31,8,71,7,0,1,0,118,16.857142857142858,1,0.0,20,8,48,7,11,0,23,1,0,83,35,1
12261,183155,ZjtLHxVaFYGXpjpGEU4pMEKPyHOa2BQR,SpATywNh6bZuzm8s1ceuBUnMUAeoAHHw,4,3,1,0,1,0,1,0,6,0.8571428571428571,1,0.0,0,1,0,1,3,0,0,1,0,2,4,1
12262,183157,uxG0FJsqPkZSNzWDeidAA0UNFfE5AajW,SpATywNh6bZuzm8s1ceuBUnMUAeoAHHw,17,26,11,22,7,17,9,2,94,13.428571428571429,1,0.0,11,11,19,7,15,17,3,9,2,48,46,1
12263,183159,hiXDc0k3aCbg2PlfMmAMtnsGGLI4iZVQ,SpATywNh6bZuzm8s1ceuBUnMUAeoAHHw,1,0,0,0,0,0,1,0,1,0.14285714285714285,1,0.0,0,0,0,0,0,0,0,1,0,0,1,1
12264,183161,giWgdBNdbd331HsBTghzm2Zz7pyTR32i,bWdj2GDclj5ofokWjzoa5jAwMkxCykd6,7,4,1,0,1,10,8,2,26,3.7142857142857144,1,0.0,2,1,0,1,2,10,0,8,2,4,22,1
12265,183162,OKPZyRTenUKO4uf828hjTvwVhuS9Ozxv,SpATywNh6bZuzm8s1ceuBUnMUAeoAHHw,4,2,1,0,1,0,1,0,5,0.7142857142857143,1,0.0,0,1,0,1,2,0,0,1,0,2,3,1
12266,183164,7RSTSE7CX0EZRW2RDRnKS7CJkHtK7gJx,RXDvfPUBYFlVdlueBFbLW0mhhAyGEqpt,6,5,3,0,0,4,2,0,14,2.0,1,0.0,0,3,0,0,5,4,0,2,0,3,11,1
12267,183165,ZsigjPuCWauQ6fedPh3KulNWQfy4Omyd,bWdj2GDclj5ofokWjzoa5jAwMkxCykd6,16,22,9,34,2,5,10,1,83,11.857142857142858,1,0.0,7,9,30,2,15,5,4,10,1,48,35,1
12268,183168,HwQlDqQYrfHrBUx2SSkCNQ3Dej1xgfkf,bWdj2GDclj5ofokWjzoa5jAwMkxCykd6,6,6,0,0,0,4,3,0,13,1.8571428571428572,1,0.0,0,0,0,0,6,4,0,3,0,0,13,1
12269,183172,8UbjMY8dXKhktWVxiVJfz8pElgxOXJnG,G8EPVSXsOYB5YQWZGiz1aVq5Pgr2GrQu,12,20,10,18,6,0,1,0,55,7.857142857142857,1,0.0,8,10,16,6,12,0,2,1,0,40,15,1
12270,183180,hc7DHMNIyA27xd52J4BHXtmpErxPTaQY,SpATywNh6bZuzm8s1ceuBUnMUAeoAHHw,4,2,1,0,1,0,2,0,6,0.8571428571428571,1,0.0,0,1,0,1,2,0,0,2,0,2,4,1
12271,183184,QBUSyyOSif4bY2k2ASnON62QDLzUWAXK,SpATywNh6bZuzm8s1ceuBUnMUAeoAHHw,6,2,1,0,1,1,3,1,9,1.2857142857142858,1,0.0,0,1,0,1,2,1,0,3,1,2,7,1
12272,183188,CUbueK74RGsaWBcRtztdoMN84Z7TxEjm,SpATywNh6bZuzm8s1ceuBUnMUAeoAHHw,1,0,0,0,0,0,1,0,1,0.14285714285714285,1,0.0,0,0,0,0,0,0,0,1,0,0,1,1
12273,183194,Ck862YJ4TKsW5xBb6Obw9gcSWBzSDmoA,bWdj2GDclj5ofokWjzoa5jAwMkxCykd6,2,0,0,0,0,0,2,0,2,0.2857142857142857,1,0.0,0,0,0,0,0,0,0,2,0,0,2,1
12274,183196,MHxssLIOse4kgwRMC6Bd41Ph9QZkPYqP,SpATywNh6bZuzm8s1ceuBUnMUAeoAHHw,12,7,5,0,3,1,3,1,20,2.857142857142857,1,0.0,0,5,0,3,7,1,0,3,1,8,12,1
12275,183198,Bb87wS5DPfEgqeumUQCP2v4mASdjKigL,RXDvfPUBYFlVdlueBFbLW0mhhAyGEqpt,7,2,1,0,1,7,5,2,18,2.5714285714285716,1,0.0,0,1,0,1,2,7,0,5,2,2,16,1
12276,183200,JxLtKAnMek98G5fWpyeTaKlh0zheuNnU,SpATywNh6bZuzm8s1ceuBUnMUAeoAHHw,8,4,2,0,2,0,4,0,12,1.7142857142857142,1,0.0,0,2,0,2,4,0,0,4,0,4,8,0
12277,183209,OO1JwGoh4BUjbVi8UpZSb7D59mBcs3nt,RXDvfPUBYFlVdlueBFbLW0mhhAyGEqpt,7,5,3,0,1,0,2,0,11,1.5714285714285714,1,0.0,0,3,0,1,5,0,0,2,0,4,7,1
12278,183211,oqLAJu8zdqUr5XPQYn4bKVmvqSIRanjc,bWdj2GDclj5ofokWjzoa5jAwMkxCykd6,9,9,1,0,2,8,6,1,27,3.857142857142857,1,0.0,2,1,0,2,7,8,0,6,1,5,22,1
12279,183214,4zGb8KPKuLvneJBtnBUfe0LzhdWsYBWD,G8EPVSXsOYB5YQWZGiz1aVq5Pgr2GrQu,12,4,3,0,3,3,6,1,20,2.857142857142857,1,0.0,0,3,0,3,4,3,0,6,1,6,14,1
12280,183215,AIHzQdi1VPMOsdN6EyZk6CRIyb9n7SRR,SpATywNh6bZuzm8s1ceuBUnMUAeoAHHw,3,1,0,0,0,0,2,0,3,0.42857142857142855,1,0.0,0,0,0,0,1,0,0,2,0,0,3,1
12281,183220,e3UIGG7UQFKXGRFOxu4N5schAIY0VK0V,SpATywNh6bZuzm8s1ceuBUnMUAeoAHHw,9,9,6,0,3,0,1,0,19,2.7142857142857144,1,0.0,2,6,0,3,7,0,0,1,0,11,8,1
12282,183224,tgGXquDTTGvx5MwsNQ6vkm5pQoRrWFlX,SpATywNh6bZuzm8s1ceuBUnMUAeoAHHw,4,2,0,0,0,0,2,0,4,0.5714285714285714,1,0.0,0,0,0,0,2,0,0,2,0,0,4,1
12283,183231,FBOPqv9eeto5z974B2QRTSbPP2n29lzH,SpATywNh6bZuzm8s1ceuBUnMUAeoAHHw,14,10,1,9,1,5,10,1,37,5.285714285714286,1,0.0,1,1,8,1,9,5,1,10,1,11,26,0
12284,183234,u2dRmVeIaLoDMHF5VEceAEEDchUnRMzS,SpATywNh6bZuzm8s1ceuBUnMUAeoAHHw,2,0,0,0,0,0,2,0,2,0.2857142857142857,1,0.0,0,0,0,0,0,0,0,2,0,0,2,1
12285,183240,5tBgJZtV2IcrOsT8dEGT5vR2wgUVL0Ki,RXDvfPUBYFlVdlueBFbLW0mhhAyGEqpt,7,9,0,0,1,0,1,0,11,1.5714285714285714,1,0.0,0,0,0,1,9,0,0,1,0,1,10,1
12286,183242,bOMNnv3BcmeLvNMeUxuJFunXB0SEjjhL,G8EPVSXsOYB5YQWZGiz1aVq5Pgr2GrQu,6,5,0,0,0,0,1,0,6,0.8571428571428571,1,0.0,0,0,0,0,5,0,0,1,0,0,6,1
12287,183243,FGCLu23qz5rUrelYuCtqPnMTqZtXAAMw,SpATywNh6bZuzm8s1ceuBUnMUAeoAHHw,3,2,0,0,0,0,1,0,3,0.42857142857142855,1,0.0,0,0,0,0,2,0,0,1,0,0,3,1
12288,183246,0XGLQ2e4IRT7VYRVdCJkoQRc2HBjT9PI,SpATywNh6bZuzm8s1ceuBUnMUAeoAHHw,6,3,2,0,2,1,5,4,17,2.4285714285714284,1,0.0,0,2,0,2,3,1,0,5,4,4,13,1
12289,183255,o0L0ZsTU5fXkPgqce1TgnefJury1RfBP,SpATywNh6bZuzm8s1ceuBUnMUAeoAHHw,1,0,0,0,0,0,1,0,1,0.14285714285714285,1,0.0,0,0,0,0,0,0,0,1,0,0,1,1
12290,183256,Hqq2J56mzskAJKg1DKQGyeniCWvGpIGe,G8EPVSXsOYB5YQWZGiz1aVq5Pgr2GrQu,8,5,0,0,0,0,14,1,20,2.857142857142857,1,0.0,0,0,0,0,5,0,0,14,1,0,20,1
12291,183259,oAeA1FcKJgCgppNdDO8cyAq9ijjrn0WR,SpATywNh6bZuzm8s1ceuBUnMUAeoAHHw,1,0,0,0,0,0,1,0,1,0.14285714285714285,1,0.0,0,0,0,0,0,0,0,1,0,0,1,1
12292,183263,sRTon1VBBuP0uvdQE1lWLIce29YVBv8J,G8EPVSXsOYB5YQWZGiz1aVq5Pgr2GrQu,7,8,4,0,0,1,6,0,19,2.7142857142857144,1,0.0,0,4,0,0,8,1,0,6,0,4,15,1
12293,183270,7nQB7cjVdr2HijR82OoX1oMRPa42JjfY,SpATywNh6bZuzm8s1ceuBUnMUAeoAHHw,15,20,7,16,5,4,8,2,62,8.857142857142858,1,0.0,12,7,14,5,8,4,2,8,2,38,24,1
12294,183275,xQCtMoNknB0tylWKH0fJbJooatlzGcif,bWdj2GDclj5ofokWjzoa5jAwMkxCykd6,2,0,0,0,0,0,2,0,2,0.2857142857142857,1,0.0,0,0,0,0,0,0,0,2,0,0,2,1
12295,183278,GPLdxh0c6YlbU65pqQa5Y6COOTFoYUCD,bWdj2GDclj5ofokWjzoa5jAwMkxCykd6,1,0,0,0,0,0,1,0,1,0.14285714285714285,1,0.0,0,0,0,0,0,0,0,1,0,0,1,1
12296,183281,QCcqcVaEKUPWiTK3zDmg4MUzFmU49Qen,G8EPVSXsOYB5YQWZGiz1aVq5Pgr2GrQu,8,8,0,4,0,2,4,0,18,2.5714285714285716,1,0.0,5,0,2,0,3,2,2,4,0,7,11,1
12297,183282,eOxm8XEI11Xs6eiBi1Nu5QzIagZXwEm9,bWdj2GDclj5ofokWjzoa5jAwMkxCykd6,8,9,3,0,3,3,4,0,22,3.142857142857143,1,0.0,4,3,0,3,5,3,0,4,0,10,12,1
12298,183283,3uajdhCj0s2q50MqyB5gJCI3ZNoF8Pn6,SpATywNh6bZuzm8s1ceuBUnMUAeoAHHw,20,33,1,33,0,9,6,0,82,11.714285714285714,3,0.0,12,1,28,0,21,9,5,6,0,41,41,0
12299,183287,myIIBocNFelldmuN47bMrRiORGKDSj7S,bWdj2GDclj5ofokWjzoa5jAwMkxCykd6,5,2,1,0,1,0,2,0,6,0.8571428571428571,1,0.0,0,1,0,1,2,0,0,2,0,2,4,1
12300,183295,pjhJt7Jli5gOZV2lL76izW3SObuDigHu,SpATywNh6bZuzm8s1ceuBUnMUAeoAHHw,6,6,1,0,1,0,1,0,9,1.2857142857142858,1,0.0,0,1,0,1,6,0,0,1,0,2,7,1
12301,183298,JazzJWzkixijQw0lzFOQdWkrQaVq1jug,SpATywNh6bZuzm8s1ceuBUnMUAeoAHHw,1,0,0,0,0,0,1,0,1,0.14285714285714285,1,0.0,0,0,0,0,0,0,0,1,0,0,1,1
12302,183302,UVJV0Z8LgePBFvFPqKCGcnBV2sDOhrhM,SpATywNh6bZuzm8s1ceuBUnMUAeoAHHw,9,9,5,0,2,3,15,2,36,5.142857142857143,1,0.0,0,5,0,2,9,3,0,15,2,7,29,1
12303,183304,xyEiirOhDK1UDi4PZ4UKu6B69xftDWtO,G8EPVSXsOYB5YQWZGiz1aVq5Pgr2GrQu,3,1,0,0,0,0,2,0,3,0.42857142857142855,1,0.0,0,0,0,0,1,0,0,2,0,0,3,1
12304,183314,8lLmfOvYbkWA0I629B3U62LfaD1fwQEn,RXDvfPUBYFlVdlueBFbLW0mhhAyGEqpt,4,3,0,0,0,0,1,0,4,0.5714285714285714,1,0.0,0,0,0,0,3,0,0,1,0,0,4,1
12305,183318,5ZZ7ac02MMtLItQmBAzvselJyRLR3oem,RXDvfPUBYFlVdlueBFbLW0mhhAyGEqpt,13,8,6,14,4,0,1,0,33,4.714285714285714,1,0.0,1,6,13,4,7,0,1,1,0,24,9,1
12306,183322,aoDqbYwTSNONO0ewp0wUEkLRTmINlnHL,bWdj2GDclj5ofokWjzoa5jAwMkxCykd6,4,2,1,0,1,0,2,0,6,0.8571428571428571,1,0.0,0,1,0,1,2,0,0,2,0,2,4,0
12307,183335,DfGFChbBes1JC5MAOGd9A1oO26eP1NW8,SpATywNh6bZuzm8s1ceuBUnMUAeoAHHw,5,2,1,0,1,0,2,0,6,0.8571428571428571,1,0.0,0,1,0,1,2,0,0,2,0,2,4,1
12308,183336,tMAhwsb1zwYUL3evTh1bPfibKP5Qon6G,SpATywNh6bZuzm8s1ceuBUnMUAeoAHHw,14,26,12,23,0,16,12,3,92,13.142857142857142,1,0.0,11,12,19,0,15,16,4,12,3,42,50,1
12309,183338,AwyuEC08S0bk8UcEbhYUOEEzGzNqDKU8,SpATywNh6bZuzm8s1ceuBUnMUAeoAHHw,15,13,7,10,4,0,5,0,39,5.571428571428571,1,0.0,2,7,10,4,11,0,0,5,0,23,16,1
12310,183339,6mOQPHYetbEhBA0tIxsajGc8MOtDRaKo,SpATywNh6bZuzm8s1ceuBUnMUAeoAHHw,14,9,4,12,3,2,4,0,34,4.857142857142857,1,0.0,4,4,9,3,5,2,3,4,0,20,14,1
12311,183341,idNHVa5qTuX7uet3LgzHDgeF9ZtnSDQ3,bWdj2GDclj5ofokWjzoa5jAwMkxCykd6,5,4,2,0,2,0,4,0,12,1.7142857142857142,2,0.0,1,2,0,2,3,0,0,4,0,5,7,1
12312,183349,jM6CIVoPwE4qSBrp1fYyKBxxPBT1cEI7,SpATywNh6bZuzm8s1ceuBUnMUAeoAHHw,13,18,0,13,0,22,5,1,59,8.428571428571429,1,0.0,9,0,11,0,9,22,2,5,1,20,39,1
12313,183352,F60PWu4BLsLJcl06zQNatmmupVqE7UvO,SpATywNh6bZuzm8s1ceuBUnMUAeoAHHw,8,2,1,0,1,41,6,1,52,7.428571428571429,1,0.0,0,1,0,1,2,41,0,6,1,2,50,1
12314,183355,E2ARe3Bjs7AnrUVutsjVawfNV9IbxIpY,SpATywNh6bZuzm8s1ceuBUnMUAeoAHHw,10,2,2,0,2,1,6,1,14,2.0,1,0.0,0,2,0,2,2,1,0,6,1,4,10,1
12315,183356,dgFOOUSNfQK8xIrT47Av0Q04bBFeE21W,bWdj2GDclj5ofokWjzoa5jAwMkxCykd6,5,2,1,0,1,0,3,0,7,1.0,1,0.0,0,1,0,1,2,0,0,3,0,2,5,0
12316,183359,ks16hCmKEY3uCrrfZAVFFF4H8o1iqNYf,SpATywNh6bZuzm8s1ceuBUnMUAeoAHHw,2,0,0,0,0,0,2,0,2,0.2857142857142857,1,0.0,0,0,0,0,0,0,0,2,0,0,2,1
12317,183360,9s0JhEhDR0DB5lchGcAvAZmTtIRHEPQm,G8EPVSXsOYB5YQWZGiz1aVq5Pgr2GrQu,4,3,0,0,0,0,2,0,5,0.7142857142857143,1,0.0,0,0,0,0,3,0,0,2,0,0,5,1
12318,183364,wVXoala8XOb2iYKmDwv4j0mTTabnjV0o,SpATywNh6bZuzm8s1ceuBUnMUAeoAHHw,3,3,0,0,0,1,2,0,6,0.8571428571428571,1,0.0,0,0,0,0,3,1,0,2,0,0,6,1
12319,183366,lRau52E8JZjvrp0KLukaOoqpUzIxzIMQ,bWdj2GDclj5ofokWjzoa5jAwMkxCykd6,1,0,0,0,0,0,1,0,1,0.14285714285714285,1,0.0,0,0,0,0,0,0,0,1,0,0,1,1
12320,183371,kqNwxNjHDwzzgcfuymv6Zjh6rnLpzjX1,G8EPVSXsOYB5YQWZGiz1aVq5Pgr2GrQu,4,2,1,0,1,0,1,0,5,0.7142857142857143,1,0.0,0,1,0,1,2,0,0,1,0,2,3,0
12321,183373,BhK0qN7yCyRENwc0cuo4sVnEheX7uuVm,RXDvfPUBYFlVdlueBFbLW0mhhAyGEqpt,4,2,1,0,1,0,1,0,5,0.7142857142857143,1,0.0,0,1,0,1,2,0,0,1,0,2,3,1
12322,183375,t5Hw0caPG6L3nFHgMe2ewZ65zHyUbUJs,G8EPVSXsOYB5YQWZGiz1aVq5Pgr2GrQu,2,0,0,0,0,0,2,0,2,0.2857142857142857,1,0.0,0,0,0,0,0,0,0,2,0,0,2,1
12323,183376,bBc0KX5JgaSX0V8JzMsfaXljJJH0L4ZY,bWdj2GDclj5ofokWjzoa5jAwMkxCykd6,1,0,0,0,0,0,1,0,1,0.14285714285714285,1,0.0,0,0,0,0,0,0,0,1,0,0,1,0
12324,183377,IEfUasRNK7F4OXmh9ZRgY5RLlk7j6VcY,SpATywNh6bZuzm8s1ceuBUnMUAeoAHHw,5,6,2,0,1,0,1,0,10,1.4285714285714286,1,0.0,3,2,0,1,3,0,0,1,0,6,4,1
12325,183379,qHIKvxolHHwVyfUrUuTQ7lCeMbWX7sYP,RXDvfPUBYFlVdlueBFbLW0mhhAyGEqpt,14,16,2,6,3,1,1,0,29,4.142857142857143,1,0.0,5,2,6,3,11,1,0,1,0,16,13,1
12326,183381,I2UwAjBakgo7ulEE8gv6S9DLeFdNO1pr,bWdj2GDclj5ofokWjzoa5jAwMkxCykd6,3,0,0,0,0,0,2,1,3,0.42857142857142855,1,0.0,0,0,0,0,0,0,0,2,1,0,3,1
12327,183386,O7fzJfuKfqlfMIjfhNwbu2i8Ce4wMF9H,SpATywNh6bZuzm8s1ceuBUnMUAeoAHHw,2,0,0,0,0,0,2,0,2,0.2857142857142857,1,0.0,0,0,0,0,0,0,0,2,0,0,2,1
12328,183387,AT7MUJLyTRujCGftxJSRLnutVHzi2W6K,bWdj2GDclj5ofokWjzoa5jAwMkxCykd6,1,0,0,0,0,0,1,0,1,0.14285714285714285,1,0.0,0,0,0,0,0,0,0,1,0,0,1,1
12329,183394,rEeBeKGH612kEsTNiutHYC8nvtLgJLl3,bWdj2GDclj5ofokWjzoa5jAwMkxCykd6,6,4,1,0,2,8,5,0,20,2.857142857142857,1,0.0,2,1,0,2,2,8,0,5,0,5,15,1
12330,183395,3ypTaFxEmzRhgWt1V6ubGImksm3gaDqi,G8EPVSXsOYB5YQWZGiz1aVq5Pgr2GrQu,6,6,0,0,0,0,3,0,9,1.2857142857142858,1,0.0,1,0,0,0,5,0,0,3,0,1,8,1
12331,183402,uZccjrlfbKn6BDCm3jPoxZprWusdhQYC,RXDvfPUBYFlVdlueBFbLW0mhhAyGEqpt,8,3,2,0,0,2,6,1,14,2.0,1,0.0,0,2,0,0,3,2,0,6,1,2,12,1
12332,183404,StBmEv3I1e5i7om3Qal9RCxtr12zGldK,SpATywNh6bZuzm8s1ceuBUnMUAeoAHHw,3,2,1,0,0,0,1,0,4,0.5714285714285714,1,0.0,0,1,0,0,2,0,0,1,0,1,3,1
12333,183406,6x4B9nu8vwEEwbbJ91dM7syOmh6Wd3T4,RXDvfPUBYFlVdlueBFbLW0mhhAyGEqpt,15,12,8,0,9,0,7,0,36,5.142857142857143,2,0.0,3,8,0,9,9,0,0,7,0,20,16,1
12334,183409,p2WxyRGvLvUMOSoEWtLVx9Ca2AiCwjk0,SpATywNh6bZuzm8s1ceuBUnMUAeoAHHw,10,7,4,10,0,0,2,0,23,3.2857142857142856,1,0.0,2,4,8,0,5,0,2,2,0,14,9,1
12335,183414,e2iZvNKfdNseGOCno9jVScN4rf0x278a,G8EPVSXsOYB5YQWZGiz1aVq5Pgr2GrQu,10,6,2,10,1,0,3,0,22,3.142857142857143,1,0.0,3,2,7,1,3,0,3,3,0,13,9,1
12336,183423,CViRSkXaB71kW0MpqfES8A240EKnhiKp,bWdj2GDclj5ofokWjzoa5jAwMkxCykd6,6,6,3,0,2,0,2,0,13,1.8571428571428572,1,0.0,2,3,0,2,4,0,0,2,0,7,6,1
12337,183427,BYDzZvbHlPLB5l5C8F0sCY7jgUh5E5kF,SpATywNh6bZuzm8s1ceuBUnMUAeoAHHw,4,3,2,0,0,0,1,0,6,0.8571428571428571,1,0.0,0,2,0,0,3,0,0,1,0,2,4,1
12338,183430,MofLU1eAzpaUKN6d2uNrYpUKgP1lpdHE,RXDvfPUBYFlVdlueBFbLW0mhhAyGEqpt,15,16,11,12,3,3,7,1,53,7.571428571428571,1,0.0,0,11,10,3,16,3,2,7,1,24,29,1
12339,183431,8BTLZqMynI47lpeExrpUyf3Ycam7Kqwv,SpATywNh6bZuzm8s1ceuBUnMUAeoAHHw,9,28,10,0,0,0,4,0,42,6.0,1,0.0,3,10,0,0,25,0,0,4,0,13,29,1
12340,183435,t4uSkzpGvWF0mtXEP739NS9nOIoxwvm0,RXDvfPUBYFlVdlueBFbLW0mhhAyGEqpt,6,4,0,0,0,0,2,0,6,0.8571428571428571,1,0.0,0,0,0,0,4,0,0,2,0,0,6,1
12341,183440,EtfxOXHEuVBMaj0eMSXrIIrSQlTvW9sK,bWdj2GDclj5ofokWjzoa5jAwMkxCykd6,1,0,0,0,0,0,1,0,1,0.14285714285714285,1,0.0,0,0,0,0,0,0,0,1,0,0,1,1
12342,183442,v9EzyBMgqrHmKu64Jm356JCxNk5lnRyw,G8EPVSXsOYB5YQWZGiz1aVq5Pgr2GrQu,2,0,0,0,0,0,2,0,2,0.2857142857142857,1,0.0,0,0,0,0,0,0,0,2,0,0,2,1
12343,183452,RnIxYOCcvRkH5SmLcSLbuQiMmbZTCV4X,bWdj2GDclj5ofokWjzoa5jAwMkxCykd6,7,4,2,0,1,2,3,1,13,1.8571428571428572,1,0.0,0,2,0,1,4,2,0,3,1,3,10,1
12344,183456,InAOZGiL3znHtTGfF0VCl2ivku6eLEMF,RXDvfPUBYFlVdlueBFbLW0mhhAyGEqpt,20,30,16,35,14,1,7,11,114,16.285714285714285,1,0.0,12,16,30,14,18,1,5,7,11,72,42,1
12345,183465,Mie6PMLFZ6GTGAAMZLvUdpU4rgeHjvP2,bWdj2GDclj5ofokWjzoa5jAwMkxCykd6,5,2,1,0,1,0,2,0,6,0.8571428571428571,1,0.0,0,1,0,1,2,0,0,2,0,2,4,1
12346,183466,nwVilrO2xxpsCBw1FRKGSujEDxCOupgS,SpATywNh6bZuzm8s1ceuBUnMUAeoAHHw,6,6,2,0,1,1,4,0,14,2.0,1,0.0,0,2,0,1,6,1,0,4,0,3,11,1
12347,183467,PFkCedTA1DArZVlA7QIlGHqePzUVifGy,SpATywNh6bZuzm8s1ceuBUnMUAeoAHHw,1,0,0,0,0,0,1,0,1,0.14285714285714285,1,0.0,0,0,0,0,0,0,0,1,0,0,1,1
12348,183468,SSM7wEvdZo8FZW0zxJcXGwdA1S6Vbn5Q,SpATywNh6bZuzm8s1ceuBUnMUAeoAHHw,10,9,5,13,0,1,3,0,31,4.428571428571429,2,0.0,3,5,11,0,6,1,2,3,0,19,12,0
12349,183471,ZWE0n8BTbJ9FUQALYDITtcmVETezeafV,bWdj2GDclj5ofokWjzoa5jAwMkxCykd6,10,8,2,40,2,1,4,1,58,8.285714285714286,1,0.0,5,2,39,2,3,1,1,4,1,48,10,1
12350,183472,UJgg3Z7RMqrOzehAajABZyrolXDOj0JJ,G8EPVSXsOYB5YQWZGiz1aVq5Pgr2GrQu,3,2,0,0,0,0,2,0,4,0.5714285714285714,1,0.0,0,0,0,0,2,0,0,2,0,0,4,1
12351,183474,pk69em2bhNfGTrrqysMHCMfzjd22WDJE,SpATywNh6bZuzm8s1ceuBUnMUAeoAHHw,13,8,4,2,3,0,4,1,22,3.142857142857143,1,0.0,0,4,2,3,8,0,0,4,1,9,13,1
12352,183475,bz5GKxlsbJHiQ5yHN3mGDylrAg3DXi5E,SpATywNh6bZuzm8s1ceuBUnMUAeoAHHw,9,9,8,0,5,0,2,0,24,3.4285714285714284,1,0.0,0,8,0,5,9,0,0,2,0,13,11,1
12353,183480,pumsIIBvkIDHPLuElv7OSuQxwiyrjr12,SpATywNh6bZuzm8s1ceuBUnMUAeoAHHw,14,27,8,20,4,1,5,0,65,9.285714285714286,1,0.0,9,8,18,4,18,1,2,5,0,39,26,1
12354,183491,hMsNCldAkGadwgGX6yjkMuu7X3GLTjYs,bWdj2GDclj5ofokWjzoa5jAwMkxCykd6,12,14,10,8,7,10,11,0,60,8.571428571428571,2,0.0,1,10,6,7,13,10,2,11,0,24,36,1
12355,183493,wTO6PriqUjklZvIhTLmF52Ryme8SIc0k,SpATywNh6bZuzm8s1ceuBUnMUAeoAHHw,1,0,0,0,0,0,1,0,1,0.14285714285714285,1,0.0,0,0,0,0,0,0,0,1,0,0,1,1
12356,183495,O6uNlqe4D6fw6uKpeBg3BRdXTyp6hhXG,RXDvfPUBYFlVdlueBFbLW0mhhAyGEqpt,1,0,0,0,0,0,1,0,1,0.14285714285714285,1,0.0,0,0,0,0,0,0,0,1,0,0,1,1
12357,183498,cQingcIr6b1ihV5kJhN5qPmtxp0KcxRT,G8EPVSXsOYB5YQWZGiz1aVq5Pgr2GrQu,7,6,3,0,2,3,3,0,17,2.4285714285714284,1,0.0,0,3,0,2,6,3,0,3,0,5,12,1
12358,183506,VtCUQBk0TlN0AJOAq0bEC4tTAH6HVrBA,RXDvfPUBYFlVdlueBFbLW0mhhAyGEqpt,5,3,1,0,1,0,1,0,6,0.8571428571428571,1,0.0,0,1,0,1,3,0,0,1,0,2,4,1
12359,183507,dRkGRhgEz0P6Cj2gSWKZ3jwm6LAB5sTl,RXDvfPUBYFlVdlueBFbLW0mhhAyGEqpt,6,14,10,0,0,0,5,0,29,4.142857142857143,1,0.0,0,10,0,0,14,0,0,5,0,10,19,1
12360,183510,UjlYIZQOEINWayGhC3yn2Cik0ILUnmNg,RXDvfPUBYFlVdlueBFbLW0mhhAyGEqpt,10,11,7,0,4,0,10,0,32,4.571428571428571,1,0.0,0,7,0,4,11,0,0,10,0,11,21,1
12361,183512,DhiB4cJ1TCjmSH3ZWP9m0OqNyBdGeS5P,bWdj2GDclj5ofokWjzoa5jAwMkxCykd6,5,6,0,0,0,0,2,0,8,1.1428571428571428,1,0.0,0,0,0,0,6,0,0,2,0,0,8,1
12362,183515,dRbINtWX4PACMb6CoPwzFcGIwIksepgL,SpATywNh6bZuzm8s1ceuBUnMUAeoAHHw,1,0,0,0,0,0,1,0,1,0.14285714285714285,1,0.0,0,0,0,0,0,0,0,1,0,0,1,1
12363,183516,AwMbVkwoHOO4RwVeu0kWHW1pZCX6cyCm,bWdj2GDclj5ofokWjzoa5jAwMkxCykd6,2,0,0,0,0,0,2,0,2,0.2857142857142857,1,0.0,0,0,0,0,0,0,0,2,0,0,2,1
12364,183519,B4PjpXbBdKDLR1d4bTEW8nYb1XQ8zgOw,RXDvfPUBYFlVdlueBFbLW0mhhAyGEqpt,3,2,1,0,0,0,1,0,4,0.5714285714285714,1,0.0,0,1,0,0,2,0,0,1,0,1,3,1
12365,183520,1D6eUyCJP5alahovvE13UJeLeWGqXCSN,SpATywNh6bZuzm8s1ceuBUnMUAeoAHHw,1,0,0,0,0,0,1,0,1,0.14285714285714285,1,0.0,0,0,0,0,0,0,0,1,0,0,1,0
12366,183522,jdDAkKv7CXlTSONMrkYEJDMOqMZv4NO7,G8EPVSXsOYB5YQWZGiz1aVq5Pgr2GrQu,7,5,1,0,1,0,3,0,10,1.4285714285714286,1,0.0,0,1,0,1,5,0,0,3,0,2,8,1
12367,183523,uvHFiZDnxbLoaMgYUEvYxJ8fEqaBGtVR,SpATywNh6bZuzm8s1ceuBUnMUAeoAHHw,6,3,2,0,1,0,2,0,8,1.1428571428571428,1,0.0,0,2,0,1,3,0,0,2,0,3,5,1
12368,183525,l4fUBbt2UkEBI1IQ0gPXz6asVAEuAAgG,SpATywNh6bZuzm8s1ceuBUnMUAeoAHHw,8,6,6,0,4,0,5,0,21,3.0,3,0.0,0,6,0,4,6,0,0,5,0,10,11,1
12369,183529,Nqn3ANjR8SmFf4pF0O8Kve4CiSpmex7G,SpATywNh6bZuzm8s1ceuBUnMUAeoAHHw,1,0,0,0,0,0,1,0,1,0.14285714285714285,1,0.0,0,0,0,0,0,0,0,1,0,0,1,1
12370,183532,vrlk2ULHn3q7og5F7d4moUFSIP81jWhe,SpATywNh6bZuzm8s1ceuBUnMUAeoAHHw,5,2,1,0,1,0,2,0,6,0.8571428571428571,1,0.0,0,1,0,1,2,0,0,2,0,2,4,1
12371,183533,M75L90OOMTV1kEiI3n7vM0ty47YBFna9,SpATywNh6bZuzm8s1ceuBUnMUAeoAHHw,3,3,0,0,0,0,1,0,4,0.5714285714285714,1,0.0,0,0,0,0,3,0,0,1,0,0,4,1
12372,183544,pIUA4CxUOhlZMOg4cOlVb2la0FCnmRD3,RXDvfPUBYFlVdlueBFbLW0mhhAyGEqpt,11,6,5,0,3,0,2,0,16,2.2857142857142856,1,0.0,0,5,0,3,6,0,0,2,0,8,8,1
12373,183554,4gFDIkwCKsDbUhjdoZqM1BZ32HnFPqUv,bWdj2GDclj5ofokWjzoa5jAwMkxCykd6,2,0,0,0,0,0,2,0,2,0.2857142857142857,1,0.0,0,0,0,0,0,0,0,2,0,0,2,1
12374,183562,AWvgwCQmPH4OGAIYypj87Tg2RKpUEZjK,RXDvfPUBYFlVdlueBFbLW0mhhAyGEqpt,23,42,2,36,4,3,4,2,93,13.285714285714286,1,0.0,29,2,31,4,13,3,5,4,2,66,27,1
12375,183563,Edq6Echk8wEs8ShX5RBw5c8Yx8ANHVje,bWdj2GDclj5ofokWjzoa5jAwMkxCykd6,5,2,1,0,1,0,5,0,9,1.2857142857142858,1,0.0,0,1,0,1,2,0,0,5,0,2,7,1
12376,183564,K7VioOgkoW2bG7ynS7EVbYmEm9sNay8P,bWdj2GDclj5ofokWjzoa5jAwMkxCykd6,8,3,2,0,2,0,3,0,10,1.4285714285714286,1,0.0,0,2,0,2,3,0,0,3,0,4,6,1
12377,183568,lRbeD3dHMTos4W2d1Naqv6Hm53gM6ove,RXDvfPUBYFlVdlueBFbLW0mhhAyGEqpt,5,5,3,0,0,0,3,0,11,1.5714285714285714,1,0.0,0,3,0,0,5,0,0,3,0,3,8,1
12378,183574,kGkU7DU5zOC0IQHNRlo6r0rouCnUfi6R,bWdj2GDclj5ofokWjzoa5jAwMkxCykd6,1,0,0,0,0,0,1,0,1,0.14285714285714285,1,0.0,0,0,0,0,0,0,0,1,0,0,1,1
12379,183575,dTjL08in9jKZ00BA9Kf6biDJuIA4OzlF,bWdj2GDclj5ofokWjzoa5jAwMkxCykd6,1,0,0,0,0,0,1,0,1,0.14285714285714285,1,0.0,0,0,0,0,0,0,0,1,0,0,1,1
12380,183578,b1g4AWG6A2zG5plnQY4paLSHRFnrgObC,bWdj2GDclj5ofokWjzoa5jAwMkxCykd6,3,2,0,0,0,0,2,0,4,0.5714285714285714,1,0.0,0,0,0,0,2,0,0,2,0,0,4,1
12381,183580,3t9ZicXafEarB5kevklUjZj2RJMyb5VH,bWdj2GDclj5ofokWjzoa5jAwMkxCykd6,1,0,0,0,0,0,1,0,1,0.14285714285714285,1,0.0,0,0,0,0,0,0,0,1,0,0,1,1
12382,183583,eDzTwNhYw5qEG2zvbZVjOixJZpRNeUjf,SpATywNh6bZuzm8s1ceuBUnMUAeoAHHw,16,12,6,14,4,3,8,2,49,7.0,1,0.0,4,6,12,4,8,3,2,8,2,26,23,1
12383,183584,9KpScbHudyYdTVutfkp65lLJaFeSgBWp,SpATywNh6bZuzm8s1ceuBUnMUAeoAHHw,4,3,1,0,0,0,2,0,6,0.8571428571428571,1,0.0,0,1,0,0,3,0,0,2,0,1,5,1
12384,183597,Eh6H4i1zHStqzSkD6GI2c0vx2yJEOPJN,RXDvfPUBYFlVdlueBFbLW0mhhAyGEqpt,1,0,0,0,0,0,1,0,1,0.14285714285714285,1,0.0,0,0,0,0,0,0,0,1,0,0,1,1
12385,183600,0ZbsYtS35s7opWGwTDlJClFUqsKIqJ5M,SpATywNh6bZuzm8s1ceuBUnMUAeoAHHw,9,3,2,0,2,1,4,1,13,1.8571428571428572,1,0.0,0,2,0,2,3,1,0,4,1,4,9,1
12386,183602,VRgPAzuxIaYkNO2Qx5nEdyuDaVR0Pn8E,SpATywNh6bZuzm8s1ceuBUnMUAeoAHHw,7,5,4,0,3,0,4,0,16,2.2857142857142856,1,0.0,0,4,0,3,5,0,0,4,0,7,9,1
12387,183604,SKEZ0daa2ls5AsPymaWXx3HMK7ugoFOQ,SpATywNh6bZuzm8s1ceuBUnMUAeoAHHw,3,2,0,0,0,0,2,0,4,0.5714285714285714,1,0.0,0,0,0,0,2,0,0,2,0,0,4,1
12388,183605,u4EZDHauXLY7CQOXsbgjEXdCMOX1ZIIi,bWdj2GDclj5ofokWjzoa5jAwMkxCykd6,8,6,1,0,2,0,9,1,19,2.7142857142857144,1,0.0,3,1,0,2,3,0,0,9,1,6,13,1
12389,183608,5Qb7U49ZGB6vPwkkfqIlX0DILe5PUAX7,SpATywNh6bZuzm8s1ceuBUnMUAeoAHHw,4,3,1,0,0,0,2,0,6,0.8571428571428571,1,0.0,0,1,0,0,3,0,0,2,0,1,5,1
12390,183615,jcXoYFaI9QPcliotiwIgOLeObkrSUvNn,bWdj2GDclj5ofokWjzoa5jAwMkxCykd6,1,0,0,0,0,0,1,0,1,0.14285714285714285,1,0.0,0,0,0,0,0,0,0,1,0,0,1,1
12391,183617,Pv9LrfjnRw1WO1VwPNHCu7aKxUz6zC8i,SpATywNh6bZuzm8s1ceuBUnMUAeoAHHw,9,11,6,8,0,0,4,0,29,4.142857142857143,2,0.0,4,6,6,0,7,0,2,4,0,16,13,1
12392,183618,Fy49pMsTJR4qc7kCFAlWxZsMejdzrbbw,SpATywNh6bZuzm8s1ceuBUnMUAeoAHHw,6,2,1,0,1,0,3,1,8,1.1428571428571428,1,0.0,0,1,0,1,2,0,0,3,1,2,6,1
12393,183620,8f6cUr3CdC0FEH3V0o2H0iLNd9nVyUsV,SpATywNh6bZuzm8s1ceuBUnMUAeoAHHw,6,0,0,0,0,1,7,1,9,1.2857142857142858,1,0.0,0,0,0,0,0,1,0,7,1,0,9,1
12394,183623,7wyfXvc1g99QNmXzEb4w8C1vE0Vi2bHm,bWdj2GDclj5ofokWjzoa5jAwMkxCykd6,4,2,0,0,0,0,4,0,6,0.8571428571428571,1,0.0,0,0,0,0,2,0,0,4,0,0,6,1
12395,183626,Qntf4pjwhrrlpkPkdw7xTOHA3tqEKwZo,SpATywNh6bZuzm8s1ceuBUnMUAeoAHHw,1,0,0,0,0,0,1,0,1,0.14285714285714285,1,0.0,0,0,0,0,0,0,0,1,0,0,1,1
12396,183627,vpIRkrpJz2fnOEDQ7QyDeADagL23RUmm,SpATywNh6bZuzm8s1ceuBUnMUAeoAHHw,5,2,1,0,1,0,3,0,7,1.0,1,0.0,0,1,0,1,2,0,0,3,0,2,5,1
12397,183628,r3xrbycrTBTOJ8lVkbmPIEtnYkwuySp0,G8EPVSXsOYB5YQWZGiz1aVq5Pgr2GrQu,7,7,1,0,1,0,1,0,10,1.4285714285714286,1,0.0,1,1,0,1,6,0,0,1,0,3,7,1
12398,183642,mbEX76fVD9CfdxvS9S0YmboTh2OQRRH9,SpATywNh6bZuzm8s1ceuBUnMUAeoAHHw,9,10,0,10,0,23,1,0,44,6.285714285714286,1,0.0,4,0,9,0,6,23,1,1,0,13,31,1
12399,183647,a4RYqILKcnu8c617gYSbD0KQIm9DqZnc,RXDvfPUBYFlVdlueBFbLW0mhhAyGEqpt,6,5,4,0,2,0,1,0,12,1.7142857142857142,1,0.0,0,4,0,2,5,0,0,1,0,6,6,1
12400,183667,H01qgmsAzE6UZ02rpT0g0cPQbKgigwE6,SpATywNh6bZuzm8s1ceuBUnMUAeoAHHw,1,0,0,0,0,0,1,0,1,0.14285714285714285,1,0.0,0,0,0,0,0,0,0,1,0,0,1,1
12401,183668,NMciPbdIeB9uIZwCMcw6mXU2i3BtnB5v,RXDvfPUBYFlVdlueBFbLW0mhhAyGEqpt,13,8,5,15,3,0,1,0,32,4.571428571428571,1,0.0,1,5,12,3,7,0,3,1,0,21,11,0
12402,183677,3kAfPhBAdLqCd25fZapuQy7eXOe7UiZ6,SpATywNh6bZuzm8s1ceuBUnMUAeoAHHw,2,0,0,0,0,0,3,0,3,0.42857142857142855,1,0.0,0,0,0,0,0,0,0,3,0,0,3,1
12403,183678,00w736SmRTShB1yHSNNQKxZ90wTM71uT,SpATywNh6bZuzm8s1ceuBUnMUAeoAHHw,1,0,0,0,0,0,1,0,1,0.14285714285714285,1,0.0,0,0,0,0,0,0,0,1,0,0,1,1
12404,183681,tUa09YYOUnb3wVzvjQGH0FvIpZ5hsZpt,SpATywNh6bZuzm8s1ceuBUnMUAeoAHHw,13,18,1,0,0,1,6,1,27,3.857142857142857,2,0.0,0,1,0,0,18,1,0,6,1,1,26,1
12405,183683,Hqlgf2n4GScNbLk3LnpSlhqbXS4k1V5Y,bWdj2GDclj5ofokWjzoa5jAwMkxCykd6,2,0,0,0,0,0,2,0,2,0.2857142857142857,1,0.0,0,0,0,0,0,0,0,2,0,0,2,1
12406,183684,PJVOwbqsSqxmbQfiqysBeUsqu2d0RHYt,SpATywNh6bZuzm8s1ceuBUnMUAeoAHHw,1,0,0,0,0,0,1,0,1,0.14285714285714285,1,0.0,0,0,0,0,0,0,0,1,0,0,1,1
12407,183685,srrwedRjbv42svoIh3SiJfl8lc5wqthR,SpATywNh6bZuzm8s1ceuBUnMUAeoAHHw,8,6,1,0,1,0,3,1,12,1.7142857142857142,1,0.0,0,1,0,1,6,0,0,3,1,2,10,1
12408,183690,LrnqEdfBj0D0yEwqlIwYFq7gG4yeMv2F,RXDvfPUBYFlVdlueBFbLW0mhhAyGEqpt,5,3,2,0,2,0,2,0,9,1.2857142857142858,1,0.0,0,2,0,2,3,0,0,2,0,4,5,1
12409,183692,pGwYJRrX7MfzhhSwNLSQAMurehSIgkJ9,bWdj2GDclj5ofokWjzoa5jAwMkxCykd6,9,5,3,16,2,8,7,1,42,6.0,2,0.0,1,3,16,2,4,8,0,7,1,22,20,1
12410,183696,5507vCg0B1i7QYbqjYirkMGFioj9q8do,bWdj2GDclj5ofokWjzoa5jAwMkxCykd6,7,3,3,0,3,0,2,0,11,1.5714285714285714,1,0.0,0,3,0,3,3,0,0,2,0,6,5,1
12411,183697,XTAgcCcMxVaOaQnxZJfZgo5L5IIUp6vo,SpATywNh6bZuzm8s1ceuBUnMUAeoAHHw,7,4,1,0,1,0,4,0,10,1.4285714285714286,1,0.0,0,1,0,1,4,0,0,4,0,2,8,1
12412,183703,0tUsWRwcM5Diph5ritKgQygdUhSNn96x,SpATywNh6bZuzm8s1ceuBUnMUAeoAHHw,6,2,1,0,1,0,2,0,6,0.8571428571428571,1,0.0,0,1,0,1,2,0,0,2,0,2,4,1
12413,183705,fsTTrbfLLX3LLKI2ivzhVe8zchwg73pj,SpATywNh6bZuzm8s1ceuBUnMUAeoAHHw,15,12,6,14,3,1,5,0,41,5.857142857142857,1,0.0,4,6,13,3,8,1,1,5,0,26,15,1
12414,183706,0eu2uHXXHlrxtRapovPIpFp8IooLmBew,SpATywNh6bZuzm8s1ceuBUnMUAeoAHHw,5,2,1,0,1,0,2,0,6,0.8571428571428571,1,0.0,0,1,0,1,2,0,0,2,0,2,4,1
12415,183707,NaRJmQnyQzKeB0w8DDGDf6ZmsPHjlThO,SpATywNh6bZuzm8s1ceuBUnMUAeoAHHw,10,6,0,6,0,0,4,1,17,2.4285714285714284,1,0.0,1,0,5,0,5,0,1,4,1,6,11,1
12416,183721,j77DK4hco4PDLnfPsujP1vD7LFaP7p4V,SpATywNh6bZuzm8s1ceuBUnMUAeoAHHw,10,10,0,0,1,3,5,3,22,3.142857142857143,1,0.0,1,0,0,1,9,3,0,5,3,2,20,1
12417,183725,GfV76YxFEig6L2nHg6sIaPDE5VPf3uRt,SpATywNh6bZuzm8s1ceuBUnMUAeoAHHw,8,4,3,0,3,0,3,0,13,1.8571428571428572,1,0.0,0,3,0,3,4,0,0,3,0,6,7,1
12418,183728,wjS8ie6ACTxewSCQo7zpBy0tu4z4RYPD,RXDvfPUBYFlVdlueBFbLW0mhhAyGEqpt,1,0,0,0,0,0,1,0,1,0.14285714285714285,1,0.0,0,0,0,0,0,0,0,1,0,0,1,1
12419,183730,eDzTwNhYw5qEG2zvbZVjOixJZpRNeUjf,bWdj2GDclj5ofokWjzoa5jAwMkxCykd6,11,14,8,10,4,0,7,0,43,6.142857142857143,1,0.0,1,8,8,4,13,0,2,7,0,21,22,1
12420,183732,Cu4fMSI1LUWMJcNR5zM13WUwE6Hxc1yL,SpATywNh6bZuzm8s1ceuBUnMUAeoAHHw,10,7,4,11,0,0,2,0,24,3.4285714285714284,1,0.0,2,4,10,0,5,0,1,2,0,16,8,1
12421,183733,MlcE1JFENTunAHw0ocZkMchxf8NdWNFO,bWdj2GDclj5ofokWjzoa5jAwMkxCykd6,3,4,1,0,1,0,1,0,7,1.0,1,0.0,2,1,0,1,2,0,0,1,0,4,3,1
12422,183735,68jxA2PUjT1NQfZbUcdmPfGR0u6r2zeM,RXDvfPUBYFlVdlueBFbLW0mhhAyGEqpt,1,0,0,0,0,0,1,0,1,0.14285714285714285,1,0.0,0,0,0,0,0,0,0,1,0,0,1,1
12423,183745,FR3djrgj8pkYcAIqYiRiT862Pvu77Ath,SpATywNh6bZuzm8s1ceuBUnMUAeoAHHw,1,0,0,0,0,0,1,0,1,0.14285714285714285,1,0.0,0,0,0,0,0,0,0,1,0,0,1,1
12424,183748,hD4qEuZFDZPZ2RLgArJFuhYLdzuJCt01,bWdj2GDclj5ofokWjzoa5jAwMkxCykd6,7,5,1,0,0,0,5,0,11,1.5714285714285714,1,0.0,0,1,0,0,5,0,0,5,0,1,10,1
12425,183750,G7MC8DJ4FubRjcyO7f3yIgxskIjZSZjx,SpATywNh6bZuzm8s1ceuBUnMUAeoAHHw,1,0,0,0,0,0,1,0,1,0.14285714285714285,1,0.0,0,0,0,0,0,0,0,1,0,0,1,1
12426,183751,hJq2MbZS4JBSMT1a0Z3Gv6HKBJY6P875,bWdj2GDclj5ofokWjzoa5jAwMkxCykd6,1,0,0,0,0,0,1,0,1,0.14285714285714285,1,0.0,0,0,0,0,0,0,0,1,0,0,1,1
12427,183752,bxybXAkYqJdxWDLSPlh74sjGoIJub8gI,SpATywNh6bZuzm8s1ceuBUnMUAeoAHHw,4,3,1,0,1,0,1,0,6,0.8571428571428571,1,0.0,0,1,0,1,3,0,0,1,0,2,4,1
12428,183756,hJq2MbZS4JBSMT1a0Z3Gv6HKBJY6P875,G8EPVSXsOYB5YQWZGiz1aVq5Pgr2GrQu,1,0,0,0,0,0,1,0,1,0.14285714285714285,1,0.0,0,0,0,0,0,0,0,1,0,0,1,1
12429,183762,o1et1l3gB2UO6Zee7jdvT3mFoSzRmTnv,SpATywNh6bZuzm8s1ceuBUnMUAeoAHHw,11,67,43,0,0,2,18,1,131,18.714285714285715,1,0.0,11,43,0,0,56,2,0,18,1,54,77,1
12430,183763,VeIUrvtz2WpmBOVKmRi9CiIdJh5W97e2,RXDvfPUBYFlVdlueBFbLW0mhhAyGEqpt,6,1,1,0,1,0,4,0,7,1.0,1,0.0,0,1,0,1,1,0,0,4,0,2,5,1
12431,183764,Nlh27vHI7XhT6kQrXYnVdjcOvglbank1,G8EPVSXsOYB5YQWZGiz1aVq5Pgr2GrQu,5,4,1,0,0,0,1,0,6,0.8571428571428571,1,0.0,0,1,0,0,4,0,0,1,0,1,5,1
12432,183765,rQAguOaTDu3xVeM76HB96fgatKOO1sTk,SpATywNh6bZuzm8s1ceuBUnMUAeoAHHw,1,0,0,0,0,0,1,0,1,0.14285714285714285,1,0.0,0,0,0,0,0,0,0,1,0,0,1,1
12433,183769,YV5fQTL2YvQLATfqnj9sLfcWGppiWs4n,bWdj2GDclj5ofokWjzoa5jAwMkxCykd6,9,12,5,0,2,0,6,1,26,3.7142857142857144,1,0.0,0,5,0,2,12,0,0,6,1,7,19,1
12434,183771,rQAguOaTDu3xVeM76HB96fgatKOO1sTk,bWdj2GDclj5ofokWjzoa5jAwMkxCykd6,1,0,0,0,0,0,1,0,1,0.14285714285714285,1,0.0,0,0,0,0,0,0,0,1,0,0,1,1
12435,183772,cYRBWOkDMP7C555Y2eZz5GOKMhCVJBvZ,SpATywNh6bZuzm8s1ceuBUnMUAeoAHHw,8,5,3,0,2,0,4,0,14,2.0,1,0.0,0,3,0,2,5,0,0,4,0,5,9,1
12436,183773,aXiJW8ayzWdjAFuCXJZEkZEM0lQLoZYD,SpATywNh6bZuzm8s1ceuBUnMUAeoAHHw,1,0,0,0,0,0,1,0,1,0.14285714285714285,1,0.0,0,0,0,0,0,0,0,1,0,0,1,1
12437,183776,K8gGtH4J6AjA9U9FV7bczDiv6su7TqD9,SpATywNh6bZuzm8s1ceuBUnMUAeoAHHw,2,0,0,0,0,0,2,0,2,0.2857142857142857,1,0.0,0,0,0,0,0,0,0,2,0,0,2,1
12438,183778,jVE9J6XTbZz7EeUuDkD5BDSnxkl65G8L,bWdj2GDclj5ofokWjzoa5jAwMkxCykd6,6,7,4,0,1,6,4,0,22,3.142857142857143,1,0.0,0,4,0,1,7,6,0,4,0,5,17,1
12439,183782,wzcKXGYxAENlw35KZ5i9A0UYj84yOcRo,SpATywNh6bZuzm8s1ceuBUnMUAeoAHHw,1,0,0,0,0,0,1,0,1,0.14285714285714285,1,0.0,0,0,0,0,0,0,0,1,0,0,1,1
12440,183794,oqyLKKVVYW9EATjohuVL1hNLHTIkDxiu,RXDvfPUBYFlVdlueBFbLW0mhhAyGEqpt,9,6,3,0,1,1,7,1,19,2.7142857142857144,1,0.0,0,3,0,1,6,1,0,7,1,4,15,1
12441,183795,8u2jHFBQdYbssbxd155XumepML5OnCFA,SpATywNh6bZuzm8s1ceuBUnMUAeoAHHw,9,3,2,0,1,1,5,1,13,1.8571428571428572,1,0.0,0,2,0,1,3,1,0,5,1,3,10,1
12442,183797,vlHmtLHxbw7S6zxC5oHlY3I9JCi1BY6K,bWdj2GDclj5ofokWjzoa5jAwMkxCykd6,1,0,0,0,0,0,1,0,1,0.14285714285714285,1,0.0,0,0,0,0,0,0,0,1,0,0,1,1
12443,183799,bxybXAkYqJdxWDLSPlh74sjGoIJub8gI,bWdj2GDclj5ofokWjzoa5jAwMkxCykd6,7,5,2,0,1,0,4,0,12,1.7142857142857142,2,0.0,0,2,0,1,5,0,0,4,0,3,9,1
12444,183807,nB4B19Wi7VjyTtJDPkIXAAww5TaYMuNU,G8EPVSXsOYB5YQWZGiz1aVq5Pgr2GrQu,6,5,3,0,1,0,2,0,11,1.5714285714285714,1,0.0,0,3,0,1,5,0,0,2,0,4,7,0
12445,183809,hr7uGA6N7pm5Wb3vahUIH4sx0GWC6IQD,G8EPVSXsOYB5YQWZGiz1aVq5Pgr2GrQu,5,2,1,0,1,0,3,0,7,1.0,1,0.0,0,1,0,1,2,0,0,3,0,2,5,1
12446,183811,YXm8bq7zaK4Xr5i1u3w8eLm5WwHCxSwx,bWdj2GDclj5ofokWjzoa5jAwMkxCykd6,2,0,0,0,0,4,1,0,5,0.7142857142857143,1,0.0,0,0,0,0,0,4,0,1,0,0,5,1
12447,183814,aOe6ryD5RYplhCYczJ8onj52Uh9OP4Rs,SpATywNh6bZuzm8s1ceuBUnMUAeoAHHw,7,7,1,0,1,1,3,0,13,1.8571428571428572,1,0.0,0,1,0,1,7,1,0,3,0,2,11,1
12448,183815,cfg2dvjgHRrRXnLKehwyxBIarxQiiXUS,bWdj2GDclj5ofokWjzoa5jAwMkxCykd6,4,2,0,0,1,0,1,0,4,0.5714285714285714,1,0.0,0,0,0,1,2,0,0,1,0,1,3,1
12449,183816,1y8Z7kbql2eWHeUppugE1NMIawh69MAq,SpATywNh6bZuzm8s1ceuBUnMUAeoAHHw,1,0,0,0,0,0,2,0,2,0.2857142857142857,1,0.0,0,0,0,0,0,0,0,2,0,0,2,1
12450,183820,RtJIi7yt7eqxxsJXnxUwVJPkYwTwddBt,SpATywNh6bZuzm8s1ceuBUnMUAeoAHHw,1,0,0,0,0,0,1,0,1,0.14285714285714285,1,0.0,0,0,0,0,0,0,0,1,0,0,1,1
12451,183824,ijNpE1ugmA4mkAddk2e3bQh6TJ0jb7HD,RXDvfPUBYFlVdlueBFbLW0mhhAyGEqpt,5,2,1,0,1,10,2,1,17,2.4285714285714284,1,0.0,0,1,0,1,2,10,0,2,1,2,15,1
12452,183826,GZEmn2jDYiPNelTXdP84Wl4gxgVXz7UQ,SpATywNh6bZuzm8s1ceuBUnMUAeoAHHw,7,4,3,0,2,1,2,0,12,1.7142857142857142,1,0.0,0,3,0,2,4,1,0,2,0,5,7,1
12453,183828,KyIbCsqzwxfjreA4vfXflB0Ayn4dl9kJ,SpATywNh6bZuzm8s1ceuBUnMUAeoAHHw,16,15,7,18,3,22,8,2,75,10.714285714285714,1,0.0,6,7,15,3,9,22,3,8,2,31,44,1
12454,183831,G4FZ5Oaaa2T6hGa1xufDgayvfMZLCg3D,bWdj2GDclj5ofokWjzoa5jAwMkxCykd6,2,0,0,0,0,0,2,0,2,0.2857142857142857,1,0.0,0,0,0,0,0,0,0,2,0,0,2,1
12455,183832,114X1vLT3OTzchhxfRGg24FTsgrs6Boi,SpATywNh6bZuzm8s1ceuBUnMUAeoAHHw,6,3,1,0,1,1,2,0,8,1.1428571428571428,1,0.0,0,1,0,1,3,1,0,2,0,2,6,1
12456,183833,vjbajDbPbQrGXYYcs1rbmRr6ezhDtDUy,bWdj2GDclj5ofokWjzoa5jAwMkxCykd6,1,0,0,0,0,0,1,0,1,0.14285714285714285,1,0.0,0,0,0,0,0,0,0,1,0,0,1,1
12457,183837,9veooDPdHGt0QPXOfcP4HtwqJxaobeIU,SpATywNh6bZuzm8s1ceuBUnMUAeoAHHw,11,17,3,14,0,8,5,1,48,6.857142857142857,1,0.0,10,3,13,0,7,8,1,5,1,26,22,1
12458,183838,aHceKEl94riboDVp8PRLPCY1XwhHlQv5,SpATywNh6bZuzm8s1ceuBUnMUAeoAHHw,1,0,0,0,0,0,1,0,1,0.14285714285714285,1,0.0,0,0,0,0,0,0,0,1,0,0,1,1
12459,183840,nxF8oaRxp1kRmW1R62DpnweCKcBsKTqd,SpATywNh6bZuzm8s1ceuBUnMUAeoAHHw,10,17,8,0,3,17,4,0,49,7.0,1,0.0,2,8,0,3,15,17,0,4,0,13,36,1
12460,183841,EytS791DMHkWPyEwKtiaQ332ujzLnBwF,bWdj2GDclj5ofokWjzoa5jAwMkxCykd6,5,10,1,0,1,0,2,0,14,2.0,1,0.0,0,1,0,1,10,0,0,2,0,2,12,1
12461,183846,umctuhbIVZDh6EHjPhWargzhNqVIeFMx,RXDvfPUBYFlVdlueBFbLW0mhhAyGEqpt,2,0,0,0,0,0,2,0,2,0.2857142857142857,1,0.0,0,0,0,0,0,0,0,2,0,0,2,1
12462,183861,DIfWHwFZNZPga0SgQhZ5mLJfHSTndMBk,G8EPVSXsOYB5YQWZGiz1aVq5Pgr2GrQu,4,0,0,0,0,1,3,1,5,0.7142857142857143,1,0.0,0,0,0,0,0,1,0,3,1,0,5,1
12463,183863,OyUzOGgEg3D1ADlF5EJGg06nY3QmnkdW,RXDvfPUBYFlVdlueBFbLW0mhhAyGEqpt,15,10,10,0,8,0,7,0,35,5.0,3,0.0,0,10,0,8,10,0,0,7,0,18,17,1
12464,183866,lLsAMLGXDOsZeatceMnZJfI2N4EJjHne,G8EPVSXsOYB5YQWZGiz1aVq5Pgr2GrQu,1,0,0,0,0,0,4,0,4,0.5714285714285714,1,0.0,0,0,0,0,0,0,0,4,0,0,4,1
12465,183878,EnOE2zcU3adIQka8zXE5uaDcwrIceQaF,bWdj2GDclj5ofokWjzoa5jAwMkxCykd6,3,2,0,0,0,0,2,0,4,0.5714285714285714,1,0.0,0,0,0,0,2,0,0,2,0,0,4,1
12466,183879,5wfiCJMdbkN7MkoUGvo3cfz8jV3jCktA,SpATywNh6bZuzm8s1ceuBUnMUAeoAHHw,4,2,1,0,1,0,1,0,5,0.7142857142857143,1,0.0,0,1,0,1,2,0,0,1,0,2,3,1
12467,183881,8qABUnBBHxxZkfUhEQNUn5NNMSRrqvPC,bWdj2GDclj5ofokWjzoa5jAwMkxCykd6,7,4,1,36,0,0,3,1,45,6.428571428571429,1,0.0,2,1,35,0,2,0,1,3,1,38,7,1
12468,183888,TL1aA8ITe7VP42GX52yE5M5UsjXNCOS3,RXDvfPUBYFlVdlueBFbLW0mhhAyGEqpt,14,6,4,10,2,5,4,3,34,4.857142857142857,1,0.0,1,4,9,2,5,5,1,4,3,16,18,1
12469,183892,4wMgOAufqnPs3VhoygBeCYo4HP5tpnQt,SpATywNh6bZuzm8s1ceuBUnMUAeoAHHw,13,22,0,17,0,27,14,2,82,11.714285714285714,2,0.0,6,0,16,0,16,27,1,14,2,22,60,1
12470,183896,0a6HihupPBi4xpjolN637qOYG6WSN1Gx,bWdj2GDclj5ofokWjzoa5jAwMkxCykd6,1,0,0,0,0,0,1,0,1,0.14285714285714285,1,0.0,0,0,0,0,0,0,0,1,0,0,1,1
12471,183897,0a6HihupPBi4xpjolN637qOYG6WSN1Gx,G8EPVSXsOYB5YQWZGiz1aVq5Pgr2GrQu,1,0,0,0,0,0,1,0,1,0.14285714285714285,1,0.0,0,0,0,0,0,0,0,1,0,0,1,1
12472,183902,Z0eVgz6SGtmMg7DreMuN7iJOutansTOw,SpATywNh6bZuzm8s1ceuBUnMUAeoAHHw,5,2,1,0,1,0,2,0,6,0.8571428571428571,1,0.0,0,1,0,1,2,0,0,2,0,2,4,1
12473,183903,Pe0BOQruXYclUh2pOuaZXsDRh9S1JXgK,G8EPVSXsOYB5YQWZGiz1aVq5Pgr2GrQu,15,19,2,14,2,0,2,0,39,5.571428571428571,2,0.0,0,2,13,2,19,0,1,2,0,17,22,1
12474,183927,1dSFrGV3jJZZA6qD4kOvZZNlB08eN9yU,SpATywNh6bZuzm8s1ceuBUnMUAeoAHHw,5,2,1,0,1,0,2,0,6,0.8571428571428571,1,0.0,0,1,0,1,2,0,0,2,0,2,4,1
12475,183929,BDdKHYPp1edgylVPYUBHaWJ6W3VobGdR,bWdj2GDclj5ofokWjzoa5jAwMkxCykd6,1,0,0,0,0,0,1,0,1,0.14285714285714285,1,0.0,0,0,0,0,0,0,0,1,0,0,1,1
12476,183936,MQT2DULvI9Dh4Sv1Ybk3xSqbqkDpET5t,RXDvfPUBYFlVdlueBFbLW0mhhAyGEqpt,5,1,1,0,1,0,3,0,6,0.8571428571428571,1,0.0,0,1,0,1,1,0,0,3,0,2,4,1
12477,183944,OB9oqmKPpcpFDkINdhqqXHF5hvJxfFBy,RXDvfPUBYFlVdlueBFbLW0mhhAyGEqpt,10,6,3,0,4,4,3,1,21,3.0,1,0.0,2,3,0,4,4,4,0,3,1,9,12,1
12478,183945,eswhmtF9u6PPevIa1f1kWFAOOSBwFxOH,SpATywNh6bZuzm8s1ceuBUnMUAeoAHHw,11,12,0,17,0,6,11,0,46,6.571428571428571,1,0.0,5,0,15,0,7,6,2,11,0,20,26,1
12479,183948,FFv9BpeuCytTk0cAY5ewtWqnPg8thMxr,SpATywNh6bZuzm8s1ceuBUnMUAeoAHHw,6,4,1,0,1,0,2,0,8,1.1428571428571428,1,0.0,0,1,0,1,4,0,0,2,0,2,6,1
12480,183956,qWnVRlOPWMpKhlz6DOCzqOXTcukhQiSA,bWdj2GDclj5ofokWjzoa5jAwMkxCykd6,3,2,0,0,0,0,1,0,3,0.42857142857142855,1,0.0,0,0,0,0,2,0,0,1,0,0,3,1
12481,183960,Q1yHZhB4hdcEznkeMey1ms0QifJ1CmdJ,G8EPVSXsOYB5YQWZGiz1aVq5Pgr2GrQu,1,0,0,0,0,0,1,0,1,0.14285714285714285,1,0.0,0,0,0,0,0,0,0,1,0,0,1,1
12482,183961,EWfsPxhCOXyE5eAI95GRpmzvT2SBrtgo,bWdj2GDclj5ofokWjzoa5jAwMkxCykd6,5,2,1,0,1,0,2,0,6,0.8571428571428571,1,0.0,0,1,0,1,2,0,0,2,0,2,4,1
12483,183975,f87pZCpThW6wNSnbexp1IWcK6VsMLCVr,RXDvfPUBYFlVdlueBFbLW0mhhAyGEqpt,19,11,7,14,4,0,2,0,38,5.428571428571429,1,0.0,3,7,14,4,8,0,0,2,0,28,10,1
12484,183982,Y87S79gsUH7x23XztCpMBa6RocL8Wlfk,bWdj2GDclj5ofokWjzoa5jAwMkxCykd6,5,4,0,0,1,0,5,0,10,1.4285714285714286,1,0.0,2,0,0,1,2,0,0,5,0,3,7,0
12485,183983,SEGJwH5xjhu0GixnmBSSBGNuHPRYimOx,SpATywNh6bZuzm8s1ceuBUnMUAeoAHHw,6,4,3,0,3,0,2,0,12,1.7142857142857142,1,0.0,0,3,0,3,4,0,0,2,0,6,6,1
12486,183985,GkZnrGaNbm07rAcHFJINai1bqc5xBBHT,SpATywNh6bZuzm8s1ceuBUnMUAeoAHHw,13,9,5,14,3,0,2,0,33,4.714285714285714,1,0.0,3,5,12,3,6,0,2,2,0,23,10,1
12487,183986,fNmDgjJniXOszcIHzS3zC4fz25NLjlFC,SpATywNh6bZuzm8s1ceuBUnMUAeoAHHw,1,0,0,0,0,0,1,0,1,0.14285714285714285,1,0.0,0,0,0,0,0,0,0,1,0,0,1,1
12488,183989,m4zdr76CpU472F6wsJffFbslI27LpI4g,SpATywNh6bZuzm8s1ceuBUnMUAeoAHHw,4,2,1,0,1,0,1,0,5,0.7142857142857143,1,0.0,0,1,0,1,2,0,0,1,0,2,3,1
12489,183993,dHF0lmwAWj90dNkEJgjhA3G1B2pjJava,bWdj2GDclj5ofokWjzoa5jAwMkxCykd6,1,0,0,0,0,0,1,0,1,0.14285714285714285,1,0.0,0,0,0,0,0,0,0,1,0,0,1,1
12490,183996,37daqGAbA6x2VvXkiqdWX1nBv2Tqqgte,SpATywNh6bZuzm8s1ceuBUnMUAeoAHHw,5,6,2,0,0,0,4,0,12,1.7142857142857142,1,0.0,0,2,0,0,6,0,0,4,0,2,10,1
12491,184009,wB8pBt76NTGPtrvjIdU3pN9EwIWhKGQo,SpATywNh6bZuzm8s1ceuBUnMUAeoAHHw,1,0,0,0,0,0,1,0,1,0.14285714285714285,1,0.0,0,0,0,0,0,0,0,1,0,0,1,1
12492,184012,mEFKCYz8MVHPZugokUhGo6T9qmLFE897,SpATywNh6bZuzm8s1ceuBUnMUAeoAHHw,16,28,10,13,5,2,8,2,68,9.714285714285714,2,0.0,8,10,13,5,20,2,0,8,2,36,32,1
12493,184033,BMzXa4F1HK4MbDTdR0pGzLHAAodUPJ6y,bWdj2GDclj5ofokWjzoa5jAwMkxCykd6,1,0,0,0,0,0,1,0,1,0.14285714285714285,1,0.0,0,0,0,0,0,0,0,1,0,0,1,1
12494,184038,Q12SmIgxAUIk1yKqjdfp0LXtJMgJdL9G,G8EPVSXsOYB5YQWZGiz1aVq5Pgr2GrQu,4,2,1,0,1,0,1,0,5,0.7142857142857143,1,0.0,0,1,0,1,2,0,0,1,0,2,3,1
12495,184039,GuBhksrnBhutuN529M1YtfTMCYIFJ6lY,G8EPVSXsOYB5YQWZGiz1aVq5Pgr2GrQu,12,10,5,0,4,0,2,0,21,3.0,1,0.0,0,5,0,4,10,0,0,2,0,9,12,1
12496,184047,XGJyrNdICrlEhPA3ZH7TFUF5DLeflEqn,SpATywNh6bZuzm8s1ceuBUnMUAeoAHHw,5,2,1,0,1,0,2,0,6,0.8571428571428571,1,0.0,0,1,0,1,2,0,0,2,0,2,4,1
12497,184048,k03NkUiM55XNDdygu6sbcCzBSQB1ke1d,RXDvfPUBYFlVdlueBFbLW0mhhAyGEqpt,11,17,1,0,1,0,4,0,23,3.2857142857142856,2,0.0,4,1,0,1,13,0,0,4,0,6,17,1
12498,184049,e41xflW3FJ2sfkSYCVTAw1yP2aJoqexe,SpATywNh6bZuzm8s1ceuBUnMUAeoAHHw,8,3,2,0,2,0,3,0,10,1.4285714285714286,1,0.0,0,2,0,2,3,0,0,3,0,4,6,1
12499,184060,BggPiWvKnxZgtt6PObC5h6pkP2Vpotku,SpATywNh6bZuzm8s1ceuBUnMUAeoAHHw,6,6,0,0,0,0,1,0,7,1.0,1,0.0,1,0,0,0,5,0,0,1,0,1,6,1
12500,184061,f5Mcw4567TFpDJkhEoRSw0Jz1pQ2BFAk,bWdj2GDclj5ofokWjzoa5jAwMkxCykd6,8,3,2,0,1,9,6,1,22,3.142857142857143,1,0.0,0,2,0,1,3,9,0,6,1,3,19,1
12501,184062,0CZR6JiyNyPl8nfnIp1u7wOec3poXsdF,SpATywNh6bZuzm8s1ceuBUnMUAeoAHHw,2,0,0,0,0,0,3,0,3,0.42857142857142855,1,0.0,0,0,0,0,0,0,0,3,0,0,3,1
12502,184063,Dpc0zozzlSgsLSateIgSdps1xubS3wT6,SpATywNh6bZuzm8s1ceuBUnMUAeoAHHw,7,3,2,0,2,0,2,0,9,1.2857142857142858,1,0.0,0,2,0,2,3,0,0,2,0,4,5,1
12503,184064,4RuLKPumIDuBK6n356cKgw9GML4wpFFR,SpATywNh6bZuzm8s1ceuBUnMUAeoAHHw,3,2,0,0,0,0,1,0,3,0.42857142857142855,1,0.0,0,0,0,0,2,0,0,1,0,0,3,1
12504,184066,qgG4OU0HRuoi21bBKmy9fO5g8h7KcP6E,SpATywNh6bZuzm8s1ceuBUnMUAeoAHHw,1,0,0,0,0,0,2,0,2,0.2857142857142857,1,0.0,0,0,0,0,0,0,0,2,0,0,2,1
12505,184067,OQfqRWOxxNsIi3nGxNChuaOEpiwW2MKx,RXDvfPUBYFlVdlueBFbLW0mhhAyGEqpt,5,2,1,0,1,0,2,0,6,0.8571428571428571,1,0.0,0,1,0,1,2,0,0,2,0,2,4,1
12506,184068,4RuLKPumIDuBK6n356cKgw9GML4wpFFR,bWdj2GDclj5ofokWjzoa5jAwMkxCykd6,1,0,0,0,0,0,1,0,1,0.14285714285714285,1,0.0,0,0,0,0,0,0,0,1,0,0,1,1
12507,184069,8KiAWlLGlDWFZP4JQG4AIAZhrqwvN88h,SpATywNh6bZuzm8s1ceuBUnMUAeoAHHw,3,2,1,0,0,1,2,0,6,0.8571428571428571,1,0.0,0,1,0,0,2,1,0,2,0,1,5,1
12508,184071,BpUC3MNCHd8FaxSe6moajPD8WZk6dYxr,SpATywNh6bZuzm8s1ceuBUnMUAeoAHHw,8,7,3,0,1,0,5,0,16,2.2857142857142856,2,0.0,1,3,0,1,6,0,0,5,0,5,11,1
12509,184075,ZGG633YrnGbNzVczhlK5S0rasrudTzhc,bWdj2GDclj5ofokWjzoa5jAwMkxCykd6,5,2,1,0,1,0,2,0,6,0.8571428571428571,1,0.0,0,1,0,1,2,0,0,2,0,2,4,1
12510,184076,1WYr5BJIApYgFHMSnNu25YjtJhDOUsgy,SpATywNh6bZuzm8s1ceuBUnMUAeoAHHw,6,3,2,0,2,0,1,0,8,1.1428571428571428,1,0.0,0,2,0,2,3,0,0,1,0,4,4,1
12511,184079,CbIcKD0jazBhPd3ibnu0zTtemqpWb0KP,bWdj2GDclj5ofokWjzoa5jAwMkxCykd6,2,0,0,0,0,0,4,0,4,0.5714285714285714,1,0.0,0,0,0,0,0,0,0,4,0,0,4,1
12512,184083,1KWQQsGdbVWUkaTLPILtfeXnjhFZjqBM,G8EPVSXsOYB5YQWZGiz1aVq5Pgr2GrQu,9,17,5,10,0,0,1,0,33,4.714285714285714,1,0.0,11,5,7,0,6,0,3,1,0,23,10,1
12513,184088,NslicJCNMxB9cZhzoMFtRxmqPnqyw5Ii,bWdj2GDclj5ofokWjzoa5jAwMkxCykd6,2,0,0,0,0,0,2,0,2,0.2857142857142857,1,0.0,0,0,0,0,0,0,0,2,0,0,2,1
12514,184089,OcFLLEI56U80V98vNeJ7LrlE5FWxkkpp,G8EPVSXsOYB5YQWZGiz1aVq5Pgr2GrQu,3,0,0,0,0,0,3,0,3,0.42857142857142855,1,0.0,0,0,0,0,0,0,0,3,0,0,3,1
12515,184094,CJe4pjtrcC0FOMy3krEkccqFJZO0Cqq4,bWdj2GDclj5ofokWjzoa5jAwMkxCykd6,1,0,0,0,0,0,1,0,1,0.14285714285714285,1,0.0,0,0,0,0,0,0,0,1,0,0,1,1
12516,184095,P3USQ4ceul2wiH8GV6NzM8M3iSKwMNo4,SpATywNh6bZuzm8s1ceuBUnMUAeoAHHw,5,4,0,0,0,0,3,0,7,1.0,1,0.0,0,0,0,0,4,0,0,3,0,0,7,1
12517,184098,z6xFpyaGUcaO2LWirVvA3M3GqpWgJhqS,SpATywNh6bZuzm8s1ceuBUnMUAeoAHHw,1,0,0,0,0,0,1,0,1,0.14285714285714285,1,0.0,0,0,0,0,0,0,0,1,0,0,1,1
12518,184101,PgqyyO7ndxsbTeXX946lNioQkjXip4tO,SpATywNh6bZuzm8s1ceuBUnMUAeoAHHw,16,16,5,3,4,2,5,1,36,5.142857142857143,1,0.0,4,5,3,4,12,2,0,5,1,16,20,1
12519,184107,qZ6pNkd000rAjy9LHfRpNpwESWSmgGUc,bWdj2GDclj5ofokWjzoa5jAwMkxCykd6,5,1,1,0,1,0,2,0,5,0.7142857142857143,1,0.0,0,1,0,1,1,0,0,2,0,2,3,1
12520,184110,CDBOTUK7uywn5HAqBz0EsxjWXDFENYqJ,SpATywNh6bZuzm8s1ceuBUnMUAeoAHHw,7,5,3,0,2,2,4,1,17,2.4285714285714284,1,0.0,0,3,0,2,5,2,0,4,1,5,12,1
12521,184113,87SYGQjFYUtEWda0pG12bcNker0JGBy3,G8EPVSXsOYB5YQWZGiz1aVq5Pgr2GrQu,4,5,0,0,0,0,1,0,6,0.8571428571428571,1,0.0,0,0,0,0,5,0,0,1,0,0,6,1
12522,184118,s26PJmkfPL2SwqWbKoi56ybE6GBIg4Tm,SpATywNh6bZuzm8s1ceuBUnMUAeoAHHw,7,2,0,0,0,1,7,1,11,1.5714285714285714,1,0.0,0,0,0,0,2,1,0,7,1,0,11,1
12523,184122,uUI9pQoArlf6QZxuJL0Anm2VUW5XAEuG,SpATywNh6bZuzm8s1ceuBUnMUAeoAHHw,6,2,1,0,1,0,3,0,7,1.0,1,0.0,0,1,0,1,2,0,0,3,0,2,5,1
12524,184126,6MUx7O8xcYuB5a5sYqWaf93meZNmeUNV,SpATywNh6bZuzm8s1ceuBUnMUAeoAHHw,1,0,0,0,0,0,1,0,1,0.14285714285714285,1,0.0,0,0,0,0,0,0,0,1,0,0,1,1
12525,184133,4YlVfpMODnahyqQ3n65BCTHXZpXYZLKw,G8EPVSXsOYB5YQWZGiz1aVq5Pgr2GrQu,6,5,1,0,0,0,4,0,10,1.4285714285714286,1,0.0,0,1,0,0,5,0,0,4,0,1,9,1
12526,184142,drGvqw10fBGceNSK8gYikgxOQZE0vxto,SpATywNh6bZuzm8s1ceuBUnMUAeoAHHw,7,6,4,0,3,0,1,0,14,2.0,1,0.0,0,4,0,3,6,0,0,1,0,7,7,1
12527,184150,Ywa3CoCRvYFskTMBH1zQHBLyzuQWtUYW,RXDvfPUBYFlVdlueBFbLW0mhhAyGEqpt,1,0,0,0,0,0,1,0,1,0.14285714285714285,1,0.0,0,0,0,0,0,0,0,1,0,0,1,1
12528,184153,Pb9hmoXos06ovaJ97f9maK0LR5EwPgFN,SpATywNh6bZuzm8s1ceuBUnMUAeoAHHw,1,0,0,0,0,0,1,0,1,0.14285714285714285,1,0.0,0,0,0,0,0,0,0,1,0,0,1,1
12529,184154,4DUZBFD9Fwl71r8i0SB6pVZCzmNoxKnn,RXDvfPUBYFlVdlueBFbLW0mhhAyGEqpt,4,2,1,0,1,0,1,0,5,0.7142857142857143,1,0.0,0,1,0,1,2,0,0,1,0,2,3,1
12530,184156,4DUZBFD9Fwl71r8i0SB6pVZCzmNoxKnn,bWdj2GDclj5ofokWjzoa5jAwMkxCykd6,6,3,2,0,2,0,1,0,8,1.1428571428571428,1,0.0,0,2,0,2,3,0,0,1,0,4,4,1
12531,184160,h58kvDL22TD1HjsSMB6VxjCw9rBsMnsj,SpATywNh6bZuzm8s1ceuBUnMUAeoAHHw,15,18,9,6,5,4,4,0,46,6.571428571428571,2,0.0,7,9,6,5,11,4,0,4,0,27,19,1
12532,184165,oQLN4c1EqhMjc5I7s4sQvYxTs3qNNEKF,SpATywNh6bZuzm8s1ceuBUnMUAeoAHHw,1,0,0,0,0,0,1,0,1,0.14285714285714285,1,0.0,0,0,0,0,0,0,0,1,0,0,1,1
12533,184169,CalIeuRUuDsI51PX7a2T0B5AXb9dl64K,SpATywNh6bZuzm8s1ceuBUnMUAeoAHHw,1,0,0,0,0,0,1,0,1,0.14285714285714285,1,0.0,0,0,0,0,0,0,0,1,0,0,1,1
12534,184170,zx92A3etlZOmjWi19IMDYlwaWCkvF08z,bWdj2GDclj5ofokWjzoa5jAwMkxCykd6,3,2,0,0,0,0,2,0,4,0.5714285714285714,1,0.0,0,0,0,0,2,0,0,2,0,0,4,0
12535,184180,w0NgQbkpBdIfJsaBSOoX4c1UgwA7dN8N,RXDvfPUBYFlVdlueBFbLW0mhhAyGEqpt,11,5,5,0,4,1,4,2,21,3.0,1,0.0,0,5,0,4,5,1,0,4,2,9,12,1
12536,184182,7EvTIqysZmn3AonROhXlIbdOubKSMiWg,G8EPVSXsOYB5YQWZGiz1aVq5Pgr2GrQu,5,2,1,0,1,0,2,0,6,0.8571428571428571,1,0.0,0,1,0,1,2,0,0,2,0,2,4,1
12537,184183,i39wrwOFUT4cBFVx9tMMQ3lQ2qJwZK9W,bWdj2GDclj5ofokWjzoa5jAwMkxCykd6,11,9,4,38,2,2,4,1,60,8.571428571428571,1,0.0,1,4,35,2,8,2,3,4,1,42,18,1
12538,184189,wTZQy1XFMokTUfJmtWSLn3pA2hHc02jP,G8EPVSXsOYB5YQWZGiz1aVq5Pgr2GrQu,13,13,7,0,1,0,15,1,37,5.285714285714286,1,0.0,0,7,0,1,13,0,0,15,1,8,29,1
12539,184192,t5YYcIeNMVb3RFW5w6rNVr5dnA806rKL,SpATywNh6bZuzm8s1ceuBUnMUAeoAHHw,7,4,3,0,3,8,3,0,21,3.0,1,0.0,0,3,0,3,4,8,0,3,0,6,15,1
12540,184195,pumsIIBvkIDHPLuElv7OSuQxwiyrjr12,bWdj2GDclj5ofokWjzoa5jAwMkxCykd6,4,4,1,0,1,0,1,0,7,1.0,1,0.0,1,1,0,1,3,0,0,1,0,3,4,1
12541,184201,AFZF0g5bqQh2xcoSPcZTvnmo1YmyGZbs,bWdj2GDclj5ofokWjzoa5jAwMkxCykd6,6,5,2,0,2,0,3,0,12,1.7142857142857142,2,0.0,0,2,0,2,5,0,0,3,0,4,8,1
12542,184202,XAN5G2SZeU8Zht7MvC5iqTKg1rYC9VmO,G8EPVSXsOYB5YQWZGiz1aVq5Pgr2GrQu,5,7,0,2,1,0,2,0,12,1.7142857142857142,1,0.0,5,0,1,1,2,0,1,2,0,7,5,1
12543,184203,cCvHnoX6St5OTmXQ2AOInGyMnqlmS6DL,bWdj2GDclj5ofokWjzoa5jAwMkxCykd6,5,2,1,0,1,0,4,0,8,1.1428571428571428,1,0.0,0,1,0,1,2,0,0,4,0,2,6,1
12544,184207,CR6hbwvXPZHEYYcI4AAX4civM4Pp6Aex,SpATywNh6bZuzm8s1ceuBUnMUAeoAHHw,5,2,1,0,1,0,2,0,6,0.8571428571428571,1,0.0,0,1,0,1,2,0,0,2,0,2,4,1
12545,184209,H3w465L7hDzZfQglT7xQ9IAtKqV2E37U,bWdj2GDclj5ofokWjzoa5jAwMkxCykd6,1,0,0,0,0,0,1,0,1,0.14285714285714285,1,0.0,0,0,0,0,0,0,0,1,0,0,1,1
12546,185697,sZk8u46TtWwCnXAO1CfZDLpjuO4MvayN,SpATywNh6bZuzm8s1ceuBUnMUAeoAHHw,1,0,0,0,0,0,1,0,1,0.14285714285714285,1,0.0,0,0,0,0,0,0,0,1,0,0,1,1
12547,185699,iHtSvehLiNBG0wCDW2WxQ7UVFKpHQkCr,G8EPVSXsOYB5YQWZGiz1aVq5Pgr2GrQu,7,2,0,0,1,0,5,1,9,1.2857142857142858,2,0.0,0,0,0,1,2,0,0,5,1,1,8,1
12548,185701,V02ryEmMmqjGIIiLHIkYu0vvVMLeyKKP,SpATywNh6bZuzm8s1ceuBUnMUAeoAHHw,4,2,0,0,0,0,2,0,4,0.5714285714285714,1,0.0,0,0,0,0,2,0,0,2,0,0,4,1
12549,185711,uhhlffPGiUyqHwKWs4eYUM0KXbbqijwF,bWdj2GDclj5ofokWjzoa5jAwMkxCykd6,5,2,1,0,1,0,3,0,7,1.0,1,0.0,0,1,0,1,2,0,0,3,0,2,5,1
12550,185712,cqvPqhuUpY41CAAgpjP0jUqubyRnUma9,A3fsA9Zfv1X2fVEQhTw51lKENdNrEqT3,12,10,0,10,0,0,4,0,24,3.4285714285714284,1,0.0,0,0,9,0,10,0,1,4,0,9,15,1
12551,185717,xMPYVkKLJasLVs71q8GhDTIiypmAhLbm,bWdj2GDclj5ofokWjzoa5jAwMkxCykd6,4,2,0,0,0,0,2,0,4,0.5714285714285714,1,0.0,0,0,0,0,2,0,0,2,0,0,4,1
12552,185719,DedOVhQ90meYxq6Misau3AEJ23SFBM8N,SpATywNh6bZuzm8s1ceuBUnMUAeoAHHw,3,0,0,0,0,0,3,1,4,0.5714285714285714,1,0.0,0,0,0,0,0,0,0,3,1,0,4,1
12553,185720,pnqwjatzPNd5f8exo5KMAGnQXVJnxQke,bWdj2GDclj5ofokWjzoa5jAwMkxCykd6,1,0,0,0,0,0,1,0,1,0.14285714285714285,1,0.0,0,0,0,0,0,0,0,1,0,0,1,1
12554,185721,9SQvvdARLUcjeNs1HN0rEVcQQDFBRIFU,SpATywNh6bZuzm8s1ceuBUnMUAeoAHHw,13,20,8,22,5,0,6,0,61,8.714285714285714,4,0.0,4,8,18,5,16,0,4,6,0,35,26,0
12555,185735,IO3o6QwloFvMHM9ifw0qIeLDZXWrcK99,G8EPVSXsOYB5YQWZGiz1aVq5Pgr2GrQu,11,25,7,2,4,0,6,0,44,6.285714285714286,1,0.0,7,7,2,4,18,0,0,6,0,20,24,1
12556,185740,alnogGpZqhBWQHh6ZLeZUIXk896ksLOu,A3fsA9Zfv1X2fVEQhTw51lKENdNrEqT3,8,13,1,0,0,0,8,2,24,3.4285714285714284,1,0.0,0,1,0,0,13,0,0,8,2,1,23,1
12557,185749,4iA1ycKJBUtgZZkZgkIUFUIpxxqEAlGx,bWdj2GDclj5ofokWjzoa5jAwMkxCykd6,2,0,0,0,0,0,2,0,2,0.2857142857142857,1,0.0,0,0,0,0,0,0,0,2,0,0,2,1
12558,185751,MbewcgzgToNhp9B6eaNSolme5R0M2nkY,SpATywNh6bZuzm8s1ceuBUnMUAeoAHHw,13,17,1,10,0,0,4,0,32,4.571428571428571,1,0.0,5,1,9,0,12,0,1,4,0,15,17,1
12559,185762,wi94HT3Va3Hif8CpMS1WVbL5a71j9CMb,A3fsA9Zfv1X2fVEQhTw51lKENdNrEqT3,23,3,2,84,0,0,4,0,93,13.285714285714286,1,0.0,1,2,65,0,2,0,19,4,0,68,25,1
12560,185773,VDLlgOqW7FFpT6uHqFXXlnnZR1JOz0x8,SpATywNh6bZuzm8s1ceuBUnMUAeoAHHw,2,0,0,0,0,0,2,0,2,0.2857142857142857,1,0.0,0,0,0,0,0,0,0,2,0,0,2,1
12561,185778,oIHEiOwjcaMd5CeWZdkq4rXU3yelDWwT,A3fsA9Zfv1X2fVEQhTw51lKENdNrEqT3,40,25,13,50,11,0,10,0,109,15.571428571428571,1,0.0,1,13,50,11,24,0,0,10,0,75,34,1
12562,185781,b247UYxQmorWoByqHaWMP4yZ1NRODrQz,SpATywNh6bZuzm8s1ceuBUnMUAeoAHHw,8,4,0,0,0,0,6,1,11,1.5714285714285714,1,0.0,0,0,0,0,4,0,0,6,1,0,11,1
12563,185783,XLVBkGRL2w5Wpk8oB8gzWVUvCGz9Rhlw,SpATywNh6bZuzm8s1ceuBUnMUAeoAHHw,1,0,0,0,0,0,1,0,1,0.14285714285714285,1,0.0,0,0,0,0,0,0,0,1,0,0,1,1
12564,185788,ggqCYexsMA3gqHfUfLE6gTs4JZ2aYAma,G8EPVSXsOYB5YQWZGiz1aVq5Pgr2GrQu,5,2,1,0,1,2,2,0,8,1.1428571428571428,1,0.0,0,1,0,1,2,2,0,2,0,2,6,1
12565,185789,KsZJWOsbWvg6N1GJmMWPndE2481JZ5k3,A3fsA9Zfv1X2fVEQhTw51lKENdNrEqT3,12,9,3,0,2,1,8,0,23,3.2857142857142856,1,0.0,0,3,0,2,9,1,0,8,0,5,18,1
12566,185799,5vZRuON34JUuUxkGF08Mu94iTiQzZas4,A3fsA9Zfv1X2fVEQhTw51lKENdNrEqT3,14,11,7,0,4,0,5,0,27,3.857142857142857,2,0.0,0,7,0,4,11,0,0,5,0,11,16,1
12567,185800,UiNc6Olm5OJvjLtbHiGutXVBHbKcOCGc,G8EPVSXsOYB5YQWZGiz1aVq5Pgr2GrQu,9,5,2,0,2,0,4,1,14,2.0,1,0.0,0,2,0,2,5,0,0,4,1,4,10,1
12568,185802,OuF01YeNHtVi6Jk1MFlWzs0i66xxscb1,bWdj2GDclj5ofokWjzoa5jAwMkxCykd6,4,2,0,0,0,0,3,0,5,0.7142857142857143,1,0.0,0,0,0,0,2,0,0,3,0,0,5,1
12569,185803,p54dVByd9epbS397rAmrAwTW19iwa3UI,A3fsA9Zfv1X2fVEQhTw51lKENdNrEqT3,2,0,0,0,0,0,2,0,2,0.2857142857142857,2,0.0,0,0,0,0,0,0,0,2,0,0,2,1
12570,185805,ggqCYexsMA3gqHfUfLE6gTs4JZ2aYAma,A3fsA9Zfv1X2fVEQhTw51lKENdNrEqT3,1,0,0,0,0,0,1,0,1,0.14285714285714285,1,0.0,0,0,0,0,0,0,0,1,0,0,1,1
12571,185808,ggqCYexsMA3gqHfUfLE6gTs4JZ2aYAma,RXDvfPUBYFlVdlueBFbLW0mhhAyGEqpt,1,0,0,0,0,0,1,0,1,0.14285714285714285,1,0.0,0,0,0,0,0,0,0,1,0,0,1,1
12572,185810,ggqCYexsMA3gqHfUfLE6gTs4JZ2aYAma,bWdj2GDclj5ofokWjzoa5jAwMkxCykd6,1,0,0,0,0,0,1,0,1,0.14285714285714285,1,0.0,0,0,0,0,0,0,0,1,0,0,1,1
12573,185816,lMDmp2qNyRczEhhMTcMnsuhXMIgG5u4z,SpATywNh6bZuzm8s1ceuBUnMUAeoAHHw,8,5,2,0,2,0,4,0,13,1.8571428571428572,1,0.0,0,2,0,2,5,0,0,4,0,4,9,1
12574,185822,xr2T8ak6swOOfU9oanYvPbQ4STab9s9f,A3fsA9Zfv1X2fVEQhTw51lKENdNrEqT3,17,19,1,2,1,0,8,0,31,4.428571428571429,3,0.0,0,1,2,1,19,0,0,8,0,4,27,1
12575,185827,BiROhpVKZVE8DbOW78DzcMxwLwnrk2vP,SpATywNh6bZuzm8s1ceuBUnMUAeoAHHw,4,2,0,0,0,0,2,0,4,0.5714285714285714,1,0.0,0,0,0,0,2,0,0,2,0,0,4,1
12576,185865,KqT70GlMbxQHBXiXc69IrkuqKmM7JyJa,A3fsA9Zfv1X2fVEQhTw51lKENdNrEqT3,1,0,0,0,0,0,1,0,1,0.14285714285714285,1,0.0,0,0,0,0,0,0,0,1,0,0,1,1
12577,185873,fjIKsKO6rizBomnPFn2db56S1nui3RlN,RXDvfPUBYFlVdlueBFbLW0mhhAyGEqpt,10,7,5,0,3,4,5,0,24,3.4285714285714284,1,0.0,1,5,0,3,6,4,0,5,0,9,15,1
12578,185875,a7oEKWybXixFIxItLioFkgXev62XcPSx,SpATywNh6bZuzm8s1ceuBUnMUAeoAHHw,7,3,2,0,2,0,2,0,9,1.2857142857142858,1,0.0,0,2,0,2,3,0,0,2,0,4,5,1
12579,185876,BCr2GOpOyeEKOuzlRV7PJCL1CEnRyr6Q,bWdj2GDclj5ofokWjzoa5jAwMkxCykd6,1,0,0,0,0,0,1,0,1,0.14285714285714285,1,0.0,0,0,0,0,0,0,0,1,0,0,1,1
12580,185888,GHTsld2FtHJjs2ejBig6RPBMNqBTieZV,G8EPVSXsOYB5YQWZGiz1aVq5Pgr2GrQu,1,0,0,0,0,0,1,0,1,0.14285714285714285,1,0.0,0,0,0,0,0,0,0,1,0,0,1,1
12581,185899,HXRY1mkagv1TklYNb6z2U5DQSLEv5d2U,bWdj2GDclj5ofokWjzoa5jAwMkxCykd6,3,2,0,0,0,0,2,0,4,0.5714285714285714,1,0.0,0,0,0,0,2,0,0,2,0,0,4,1
12582,185912,l6rkobnqEUKXFQnaBVgonlwU5l25TkcG,SpATywNh6bZuzm8s1ceuBUnMUAeoAHHw,7,4,3,0,3,0,3,0,13,1.8571428571428572,1,0.0,0,3,0,3,4,0,0,3,0,6,7,1
12583,185917,qU5mfkjhD9M0R49RmBMaCeXLeTqIOyhm,bWdj2GDclj5ofokWjzoa5jAwMkxCykd6,7,8,1,0,0,1,7,2,19,2.7142857142857144,1,0.0,0,1,0,0,8,1,0,7,2,1,18,1
12584,185926,BFrfDseDfXCBvtTfCsJAy36Ogk6b0Rfx,bWdj2GDclj5ofokWjzoa5jAwMkxCykd6,6,5,2,0,2,0,1,0,10,1.4285714285714286,1,0.0,0,2,0,2,5,0,0,1,0,4,6,1
12585,185934,YisM8PtG7Ux1VoDWsMxvoOKtYDxnQIkB,SpATywNh6bZuzm8s1ceuBUnMUAeoAHHw,6,4,1,0,0,0,2,0,7,1.0,1,0.0,0,1,0,0,4,0,0,2,0,1,6,0
12586,185935,g3k1QLHPwEzAuA17RgcYJkFPtaOb0o3B,SpATywNh6bZuzm8s1ceuBUnMUAeoAHHw,6,3,1,0,1,0,2,0,7,1.0,1,0.0,0,1,0,1,3,0,0,2,0,2,5,1
12587,185940,JpOYg97nyPxwnn3z2vFN1FK1LYz5DhTY,A3fsA9Zfv1X2fVEQhTw51lKENdNrEqT3,6,2,1,0,1,0,3,0,7,1.0,1,0.0,0,1,0,1,2,0,0,3,0,2,5,1
12588,185947,ztsQNM9uMd9SZEOM5x5YQ0KVKbbr5L7g,SpATywNh6bZuzm8s1ceuBUnMUAeoAHHw,5,2,1,0,1,0,2,0,6,0.8571428571428571,1,0.0,0,1,0,1,2,0,0,2,0,2,4,1
12589,185967,pyMEb6x72KY9mgbYMOoJOte9pQweaRy0,A3fsA9Zfv1X2fVEQhTw51lKENdNrEqT3,4,2,0,0,0,0,2,0,4,0.5714285714285714,1,0.0,0,0,0,0,2,0,0,2,0,0,4,1
12590,185977,q3IBH9ErSFzy7COPLzEQoKQuyHgNCnZt,SpATywNh6bZuzm8s1ceuBUnMUAeoAHHw,4,2,1,0,1,0,2,0,6,0.8571428571428571,1,0.0,0,1,0,1,2,0,0,2,0,2,4,1
12591,185981,9GkiQywusvhD7mWAdJSKQKuF3YnhYHyY,SpATywNh6bZuzm8s1ceuBUnMUAeoAHHw,4,4,0,0,0,0,3,0,7,1.0,1,0.0,0,0,0,0,4,0,0,3,0,0,7,1
12592,185989,HHr7pweQNhEg4xRoOlqDUkqUpKwnfVTC,bWdj2GDclj5ofokWjzoa5jAwMkxCykd6,4,2,1,0,1,0,1,0,5,0.7142857142857143,1,0.0,0,1,0,1,2,0,0,1,0,2,3,1
12593,185993,4lIBX7jVNURqeuVw7y54KWNhg5lYseZ6,A3fsA9Zfv1X2fVEQhTw51lKENdNrEqT3,16,15,10,0,0,6,9,0,40,5.714285714285714,1,0.0,0,10,0,0,15,6,0,9,0,10,30,1
12594,185996,rqLYGFT8OdZ1rVwTL6aA81jhg4BwFBcq,SpATywNh6bZuzm8s1ceuBUnMUAeoAHHw,11,26,15,4,8,7,5,0,65,9.285714285714286,3,0.0,4,15,4,8,22,7,0,5,0,31,34,1
12595,186008,OQ7W8hYEVefBsrV36TMIjyhMvo7kqJ6U,bWdj2GDclj5ofokWjzoa5jAwMkxCykd6,1,0,0,0,0,0,1,0,1,0.14285714285714285,1,0.0,0,0,0,0,0,0,0,1,0,0,1,1
12596,186010,pwdsR2guw7jGBDVAdaksGODr7uJoy6bJ,A3fsA9Zfv1X2fVEQhTw51lKENdNrEqT3,13,5,4,0,4,21,8,1,43,6.142857142857143,1,0.0,0,4,0,4,5,21,0,8,1,8,35,1
12597,186017,3kmVKNRbGOm4fMFsW3dgnHkHEGKHE1G0,SpATywNh6bZuzm8s1ceuBUnMUAeoAHHw,1,0,0,0,0,0,1,0,1,0.14285714285714285,1,0.0,0,0,0,0,0,0,0,1,0,0,1,1
12598,186024,mshtCxMsmXSptJoESXKNMH3UVCFV33v0,bWdj2GDclj5ofokWjzoa5jAwMkxCykd6,7,6,2,0,1,0,5,0,14,2.0,1,0.0,0,2,0,1,6,0,0,5,0,3,11,1
12599,186027,eGRaiLXqwboqQlaTTQYr1FB1cM61jV4I,bWdj2GDclj5ofokWjzoa5jAwMkxCykd6,16,38,8,80,5,0,10,0,141,20.142857142857142,3,0.0,9,8,73,5,29,0,7,10,0,95,46,0
12600,186030,WgIzAwP7DckFZQVcLeYgUBCqWImeGyjc,bWdj2GDclj5ofokWjzoa5jAwMkxCykd6,1,0,0,0,0,0,1,0,1,0.14285714285714285,1,0.0,0,0,0,0,0,0,0,1,0,0,1,1
12601,186033,oBeAGLSBA1xupWifcihdC6keBG4wuecB,SpATywNh6bZuzm8s1ceuBUnMUAeoAHHw,12,14,6,0,4,0,5,5,34,4.857142857142857,1,0.0,6,6,0,4,8,0,0,5,5,16,18,1
12602,186034,VKd5p4d9iO6xk39JhIOj5DwKdihmd0lg,SpATywNh6bZuzm8s1ceuBUnMUAeoAHHw,1,0,0,0,0,0,2,0,2,0.2857142857142857,1,0.0,0,0,0,0,0,0,0,2,0,0,2,1
12603,186053,pwdsR2guw7jGBDVAdaksGODr7uJoy6bJ,G8EPVSXsOYB5YQWZGiz1aVq5Pgr2GrQu,1,0,0,0,0,0,1,0,1,0.14285714285714285,1,0.0,0,0,0,0,0,0,0,1,0,0,1,1
12604,186054,pwdsR2guw7jGBDVAdaksGODr7uJoy6bJ,RXDvfPUBYFlVdlueBFbLW0mhhAyGEqpt,1,0,0,0,0,0,1,0,1,0.14285714285714285,1,0.0,0,0,0,0,0,0,0,1,0,0,1,1
12605,186069,1Qo7KMYcvZsuiBzdvEuPj5kKA7qUbqJV,bWdj2GDclj5ofokWjzoa5jAwMkxCykd6,1,0,0,0,0,0,1,0,1,0.14285714285714285,1,0.0,0,0,0,0,0,0,0,1,0,0,1,1
12606,186070,TCINPpi4BOwqMGx315JhuBgHLWH5YLIC,SpATywNh6bZuzm8s1ceuBUnMUAeoAHHw,11,11,5,0,4,0,3,0,23,3.2857142857142856,1,0.0,0,5,0,4,11,0,0,3,0,9,14,1
12607,186080,k1v3XdotdB8LdO3icpee6tW4PUfHmiil,SpATywNh6bZuzm8s1ceuBUnMUAeoAHHw,1,0,0,0,0,0,1,0,1,0.14285714285714285,1,0.0,0,0,0,0,0,0,0,1,0,0,1,1
12608,186090,RKevUFoWjA4gBXEFiCKb5AP4PJvgxsMD,SpATywNh6bZuzm8s1ceuBUnMUAeoAHHw,7,21,4,0,0,1,2,2,30,4.285714285714286,1,0.0,15,4,0,0,6,1,0,2,2,19,11,1
12609,186093,4RiemE5r88jWq9gaL0lVYzjeUhWq3sNP,bWdj2GDclj5ofokWjzoa5jAwMkxCykd6,5,2,1,0,1,0,2,0,6,0.8571428571428571,1,0.0,0,1,0,1,2,0,0,2,0,2,4,1
12610,186105,H7QRgEunakiQpSkvgA6e0kPLJYMsizvQ,RXDvfPUBYFlVdlueBFbLW0mhhAyGEqpt,20,12,6,20,5,1,4,2,50,7.142857142857143,1,0.0,4,6,17,5,8,1,3,4,2,32,18,1
12611,186108,movFtkKyZ7KF2alge61BByZFH1juXwvn,G8EPVSXsOYB5YQWZGiz1aVq5Pgr2GrQu,6,20,5,0,5,0,3,0,33,4.714285714285714,1,0.0,6,5,0,5,14,0,0,3,0,16,17,0
12612,186126,v7J9oMmutdLnNr3JZvwlkpjW9LXfiVjj,bWdj2GDclj5ofokWjzoa5jAwMkxCykd6,1,0,0,0,0,0,3,0,3,0.42857142857142855,1,0.0,0,0,0,0,0,0,0,3,0,0,3,1
12613,186149,3RleWWZim0t3JTvkySadKrLWZcHXfb0j,SpATywNh6bZuzm8s1ceuBUnMUAeoAHHw,5,2,1,0,1,1,2,0,7,1.0,1,0.0,0,1,0,1,2,1,0,2,0,2,5,1
12614,186152,U7gTTHbgIV4F5dvLWAHaZprd34m8Q6vZ,A3fsA9Zfv1X2fVEQhTw51lKENdNrEqT3,2,0,0,0,0,0,3,0,3,0.42857142857142855,1,0.0,0,0,0,0,0,0,0,3,0,0,3,1
12615,186160,76AvlH3YIWFXw8S2TlpvkGfhwLRoEd9v,G8EPVSXsOYB5YQWZGiz1aVq5Pgr2GrQu,1,0,0,0,0,0,1,0,1,0.14285714285714285,1,0.0,0,0,0,0,0,0,0,1,0,0,1,1
12616,186167,vmgNze76nhe4Mg9lRleNqfB4tioADZEi,SpATywNh6bZuzm8s1ceuBUnMUAeoAHHw,5,2,1,0,1,0,2,0,6,0.8571428571428571,1,0.0,0,1,0,1,2,0,0,2,0,2,4,1
12617,186172,eC7mMb2gTYoACNwQi5SJ70EXu79ikkpz,G8EPVSXsOYB5YQWZGiz1aVq5Pgr2GrQu,15,26,2,16,2,1,11,1,59,8.428571428571429,2,0.0,4,2,12,2,22,1,4,11,1,20,39,0
12618,186188,7I0I1azNl6RTMt3ii9CU0GnkhQk3GlzK,bWdj2GDclj5ofokWjzoa5jAwMkxCykd6,4,2,1,0,1,0,1,0,5,0.7142857142857143,1,0.0,0,1,0,1,2,0,0,1,0,2,3,1
12619,186217,joApt9vAdh8Ppf8VaTUE5PED1Gnaa6Cg,SpATywNh6bZuzm8s1ceuBUnMUAeoAHHw,9,6,3,0,1,0,6,0,16,2.2857142857142856,2,0.0,2,3,0,1,4,0,0,6,0,6,10,1
12620,186219,9hgjLw4OD5u1XjZx0s9EMRnEguVXBlYy,bWdj2GDclj5ofokWjzoa5jAwMkxCykd6,5,3,2,0,1,0,1,0,7,1.0,1,0.0,0,2,0,1,3,0,0,1,0,3,4,1
12621,186226,NJMgv4F05c0UQYudEdfqMGLsHyyDDfGS,bWdj2GDclj5ofokWjzoa5jAwMkxCykd6,1,0,0,0,0,0,1,0,1,0.14285714285714285,1,0.0,0,0,0,0,0,0,0,1,0,0,1,1
12622,186239,6LXzBe3NOudMerEzgOt0MkAbIrREFpjB,SpATywNh6bZuzm8s1ceuBUnMUAeoAHHw,6,2,1,0,1,0,8,0,12,1.7142857142857142,1,0.0,0,1,0,1,2,0,0,8,0,2,10,1
12623,186260,CYN3tl2d8PV3r7FRKTn3DmaQTLhkh777,bWdj2GDclj5ofokWjzoa5jAwMkxCykd6,4,4,0,0,0,0,4,0,8,1.1428571428571428,1,0.0,0,0,0,0,4,0,0,4,0,0,8,1
12624,186262,qtck8S6SMYpkxbIZosuQoFSB26vuEbBy,SpATywNh6bZuzm8s1ceuBUnMUAeoAHHw,12,13,6,0,2,2,6,1,30,4.285714285714286,1,0.0,5,6,0,2,8,2,0,6,1,13,17,1
12625,186265,O54CNBN3NKMMQYcBy9CQbkmesf27d5tK,bWdj2GDclj5ofokWjzoa5jAwMkxCykd6,8,7,3,0,4,0,1,0,15,2.142857142857143,1,0.0,3,3,0,4,4,0,0,1,0,10,5,1
12626,186274,UjdXV2LbbZ78dbdYSbQt8OX1VfVSyWoG,RXDvfPUBYFlVdlueBFbLW0mhhAyGEqpt,1,0,0,0,0,0,1,0,1,0.14285714285714285,1,0.0,0,0,0,0,0,0,0,1,0,0,1,1
12627,186278,tRniyBbP3M0j7k24AHpOwHltcVZ3Mvlp,G8EPVSXsOYB5YQWZGiz1aVq5Pgr2GrQu,19,7,6,10,4,4,12,1,44,6.285714285714286,1,0.0,0,6,9,4,7,4,1,12,1,19,25,1
12628,186282,NbCrL52EtsGx8vVNfWSZpmpE4q33iGMd,bWdj2GDclj5ofokWjzoa5jAwMkxCykd6,1,0,0,0,0,0,1,0,1,0.14285714285714285,1,0.0,0,0,0,0,0,0,0,1,0,0,1,1
12629,186293,dN9FTYZkbDCdtR1BnEY22uyGdtBZPVhu,bWdj2GDclj5ofokWjzoa5jAwMkxCykd6,13,12,7,20,4,0,2,0,45,6.428571428571429,2,0.0,2,7,17,4,10,0,3,2,0,30,15,1
12630,186296,B72h1YINVnIBuQnVvUdewAz5RbHuw445,SpATywNh6bZuzm8s1ceuBUnMUAeoAHHw,7,10,1,0,0,0,5,0,16,2.2857142857142856,1,0.0,0,1,0,0,10,0,0,5,0,1,15,1
12631,186306,4i4PHyTAjN8h3LruWdRgGB0UcB2mKwQS,G8EPVSXsOYB5YQWZGiz1aVq5Pgr2GrQu,7,5,4,0,4,0,2,0,15,2.142857142857143,1,0.0,0,4,0,4,5,0,0,2,0,8,7,1
12632,186307,LDAJhM2EkTXhEhkZMewkMv22tm6tjZRZ,G8EPVSXsOYB5YQWZGiz1aVq5Pgr2GrQu,11,17,7,0,0,1,9,1,35,5.0,1,0.0,6,7,0,0,11,1,0,9,1,13,22,1
12633,186310,oiCPMPa63rog2k5BPZRkJCoJXfrcSy1e,SpATywNh6bZuzm8s1ceuBUnMUAeoAHHw,11,8,5,0,3,0,5,2,23,3.2857142857142856,1,0.0,1,5,0,3,7,0,0,5,2,9,14,1
12634,186315,8UDPY0GORYpQM3S1dtt5YkG0CDkJUfAi,G8EPVSXsOYB5YQWZGiz1aVq5Pgr2GrQu,1,0,0,0,0,0,1,0,1,0.14285714285714285,1,0.0,0,0,0,0,0,0,0,1,0,0,1,1
12635,186316,JKjbqPpgyVuFohWzcaEzU3vXeEuQMCY2,SpATywNh6bZuzm8s1ceuBUnMUAeoAHHw,6,6,2,0,1,0,3,0,12,1.7142857142857142,1,0.0,4,2,0,1,2,0,0,3,0,7,5,1
12636,186326,oXcCXnNaPGvzw5MpNzQ49lDnTqlhdcyO,RXDvfPUBYFlVdlueBFbLW0mhhAyGEqpt,6,4,3,0,2,0,2,0,11,1.5714285714285714,1,0.0,0,3,0,2,4,0,0,2,0,5,6,1
12637,186327,5YRs7upinP21LnBzrkpoBo8Kvhb3lSkQ,SpATywNh6bZuzm8s1ceuBUnMUAeoAHHw,9,14,9,0,7,0,9,0,39,5.571428571428571,1,0.0,2,9,0,7,12,0,0,9,0,18,21,1
12638,186343,hNSGUbGCRW7qjA1g49kHgu4SIBbwJo9q,SpATywNh6bZuzm8s1ceuBUnMUAeoAHHw,9,5,4,0,4,0,2,0,15,2.142857142857143,1,0.0,0,4,0,4,5,0,0,2,0,8,7,1
12639,186346,0tNPU3kkt3CooZ4NeVBPjpcYXq8dTU8q,SpATywNh6bZuzm8s1ceuBUnMUAeoAHHw,5,2,1,0,1,0,3,0,7,1.0,1,0.0,0,1,0,1,2,0,0,3,0,2,5,1
12640,186361,ia27UAQHt7F9XiRQIIX7AOZPA1Z4gISX,G8EPVSXsOYB5YQWZGiz1aVq5Pgr2GrQu,24,16,12,0,13,0,14,4,59,8.428571428571429,1,0.0,3,12,0,13,13,0,0,14,4,28,31,1
12641,186368,ihKJAzCpK1sJmaODICQLggyYKl8s1XF0,A3fsA9Zfv1X2fVEQhTw51lKENdNrEqT3,2,0,0,0,0,0,4,0,4,0.5714285714285714,1,0.0,0,0,0,0,0,0,0,4,0,0,4,1
12642,186369,trBO4BEJIC9uXexHjtiN83f66AEsM41a,RXDvfPUBYFlVdlueBFbLW0mhhAyGEqpt,7,3,2,0,2,0,2,0,9,1.2857142857142858,1,0.0,0,2,0,2,3,0,0,2,0,4,5,1
12643,186372,4lhCwJo7yYXKFlssNpVO8DZHuYKFBvLp,bWdj2GDclj5ofokWjzoa5jAwMkxCykd6,5,2,1,0,1,0,2,0,6,0.8571428571428571,1,0.0,0,1,0,1,2,0,0,2,0,2,4,1
12644,186376,61PsrnqGMh19xjWowe2Lz8ELqYCTUUqE,A3fsA9Zfv1X2fVEQhTw51lKENdNrEqT3,6,5,2,0,1,0,3,0,11,1.5714285714285714,1,0.0,0,2,0,1,5,0,0,3,0,3,8,1
12645,186385,TREm1kp17GnbcApEfZDyA7Kp4fSLmJio,SpATywNh6bZuzm8s1ceuBUnMUAeoAHHw,2,0,0,0,0,0,3,0,3,0.42857142857142855,1,0.0,0,0,0,0,0,0,0,3,0,0,3,1
12646,186390,AeCrxYByugIwu4XUBpI0LhoTguBozLAa,G8EPVSXsOYB5YQWZGiz1aVq5Pgr2GrQu,26,28,6,66,4,0,3,0,107,15.285714285714286,1,0.0,16,6,48,4,12,0,18,3,0,74,33,1
12647,186417,gLeI9VliEYF371soyxZF0epS12DLfvFA,SpATywNh6bZuzm8s1ceuBUnMUAeoAHHw,10,14,1,12,0,0,1,0,28,4.0,1,0.0,6,1,11,0,8,0,1,1,0,18,10,0
12648,186425,Vgv9Vbo4BqJtU7GBUbwfi1DvG0Q1nDxJ,A3fsA9Zfv1X2fVEQhTw51lKENdNrEqT3,6,3,2,0,1,0,2,0,8,1.1428571428571428,1,0.0,0,2,0,1,3,0,0,2,0,3,5,1
12649,186430,s5UknTeAXWW62hajP9UwOYzwqzInPkkx,SpATywNh6bZuzm8s1ceuBUnMUAeoAHHw,7,2,1,0,1,0,4,0,8,1.1428571428571428,1,0.0,0,1,0,1,2,0,0,4,0,2,6,1
12650,186455,ocTIjxG8zBs0mQRpUtpuAKc7MDpzU7Sd,A3fsA9Zfv1X2fVEQhTw51lKENdNrEqT3,7,4,2,0,1,32,10,0,49,7.0,3,0.0,0,2,0,1,4,32,0,10,0,3,46,0
12651,186465,qJgl58YR6SFE9WBZ5w9d3OO6sin62mbS,G8EPVSXsOYB5YQWZGiz1aVq5Pgr2GrQu,5,2,1,0,1,0,2,0,6,0.8571428571428571,1,0.0,0,1,0,1,2,0,0,2,0,2,4,1
12652,186482,xTif7TWTzpmMlOz25LEjdVnoxKR0Djir,bWdj2GDclj5ofokWjzoa5jAwMkxCykd6,1,0,0,0,0,0,1,0,1,0.14285714285714285,1,0.0,0,0,0,0,0,0,0,1,0,0,1,1
12653,186507,Ws3AQXJqw3VTjixWLsavB7mzhprdidTH,G8EPVSXsOYB5YQWZGiz1aVq5Pgr2GrQu,4,2,1,0,1,0,1,0,5,0.7142857142857143,1,0.0,0,1,0,1,2,0,0,1,0,2,3,1
12654,186513,bieYN909hTRWSvc3EaZDiQYQdygsSUNW,SpATywNh6bZuzm8s1ceuBUnMUAeoAHHw,7,6,3,0,3,0,3,0,15,2.142857142857143,1,0.0,0,3,0,3,6,0,0,3,0,6,9,1
12655,186514,bYD2u7vuN3G54awyDYPdRiZI3O4zw6kx,A3fsA9Zfv1X2fVEQhTw51lKENdNrEqT3,9,7,4,0,2,4,5,0,22,3.142857142857143,2,0.0,1,4,0,2,6,4,0,5,0,7,15,1
12656,186522,xe3aQO2zOncGcTg3GZj4Ju1vwkPuneGt,A3fsA9Zfv1X2fVEQhTw51lKENdNrEqT3,26,21,16,6,11,2,7,1,64,9.142857142857142,2,0.0,0,16,5,11,21,2,1,7,1,32,32,1
12657,186541,k9uZHzVbTw2SpPQ5TgMY9urRyaKHQ7D1,SpATywNh6bZuzm8s1ceuBUnMUAeoAHHw,11,10,0,3,0,0,5,0,18,2.5714285714285716,1,0.0,5,0,3,0,5,0,0,5,0,8,10,1
12658,186552,fiJeUe4rD7XOpUxN73ysB6UZAqbfZlmt,SpATywNh6bZuzm8s1ceuBUnMUAeoAHHw,8,2,2,0,2,0,3,0,9,1.2857142857142858,1,0.0,0,2,0,2,2,0,0,3,0,4,5,1
12659,186565,7ho1Tg0rPKs5S3R4MH5byApVMAoQWEXh,RXDvfPUBYFlVdlueBFbLW0mhhAyGEqpt,10,4,3,0,2,12,10,5,36,5.142857142857143,1,0.0,0,3,0,2,4,12,0,10,5,5,31,1
12660,186574,2hFnq94PJL4XDwPjj8ZoE3JMQah41FEA,SpATywNh6bZuzm8s1ceuBUnMUAeoAHHw,5,3,2,0,1,0,2,0,8,1.1428571428571428,2,0.0,0,2,0,1,3,0,0,2,0,3,5,1
12661,186576,dCkOxG7NzEIrFHNAIlnaKMlesPlFB6No,bWdj2GDclj5ofokWjzoa5jAwMkxCykd6,3,0,0,0,0,1,3,0,4,0.5714285714285714,1,0.0,0,0,0,0,0,1,0,3,0,0,4,1
12662,186587,rBTUDXHsyVAHRzecZ0JrUNZO0FdtzEgU,SpATywNh6bZuzm8s1ceuBUnMUAeoAHHw,12,13,0,11,1,0,3,0,28,4.0,1,0.0,4,0,10,1,9,0,1,3,0,15,13,1
12663,186595,QZIRHdwFgibI2SBehTrmLAZxED1F4JL7,bWdj2GDclj5ofokWjzoa5jAwMkxCykd6,3,3,0,0,0,0,2,0,5,0.7142857142857143,1,0.0,0,0,0,0,3,0,0,2,0,0,5,1
12664,186611,aZ82NGvfiihxQfhlR4uS7n77c1b4mi5Z,G8EPVSXsOYB5YQWZGiz1aVq5Pgr2GrQu,6,4,1,0,1,0,3,0,9,1.2857142857142858,1,0.0,0,1,0,1,4,0,0,3,0,2,7,1
12665,186626,0zEvDhRJYIh90RBOGZBHRBqiMwb7D8PK,SpATywNh6bZuzm8s1ceuBUnMUAeoAHHw,1,0,0,0,0,0,1,0,1,0.14285714285714285,1,0.0,0,0,0,0,0,0,0,1,0,0,1,1
12666,186632,65P7KaQODeqWFWqHnCldB0bW07lJUhzD,A3fsA9Zfv1X2fVEQhTw51lKENdNrEqT3,7,5,3,0,1,0,2,0,11,1.5714285714285714,1,0.0,0,3,0,1,5,0,0,2,0,4,7,1
12667,186643,GOc4kNORXKPP2dp4IaPI0qi7cdZjVMoK,bWdj2GDclj5ofokWjzoa5jAwMkxCykd6,1,0,0,0,0,0,1,0,1,0.14285714285714285,1,0.0,0,0,0,0,0,0,0,1,0,0,1,1
12668,186660,G6IoTlb3c3ZQL96Z5jLVHovz7cxEUWx5,SpATywNh6bZuzm8s1ceuBUnMUAeoAHHw,5,2,1,0,1,0,2,0,6,0.8571428571428571,1,0.0,0,1,0,1,2,0,0,2,0,2,4,1
12669,186668,Q3SCEqfg6AiZK4k6l6uETosmZAruIeRz,bWdj2GDclj5ofokWjzoa5jAwMkxCykd6,5,2,1,0,1,0,2,0,6,0.8571428571428571,1,0.0,0,1,0,1,2,0,0,2,0,2,4,1
12670,186671,fWFaAKdCQbV0w3S48FeXgmzcwLTDxziF,RXDvfPUBYFlVdlueBFbLW0mhhAyGEqpt,2,0,0,0,0,0,2,0,2,0.2857142857142857,1,0.0,0,0,0,0,0,0,0,2,0,0,2,1
12671,186690,C7zqVICfiC5LB2CDdZC77m5k2umUb3cp,SpATywNh6bZuzm8s1ceuBUnMUAeoAHHw,18,27,10,9,4,0,13,1,64,9.142857142857142,2,0.0,11,10,9,4,16,0,0,13,1,34,30,1
12672,186696,XWqfdH6YA4Zk74Kdlw1zAAjKNGLWzY2X,A3fsA9Zfv1X2fVEQhTw51lKENdNrEqT3,5,0,0,0,0,1,4,1,6,0.8571428571428571,1,0.0,0,0,0,0,0,1,0,4,1,0,6,1
12673,186698,cdSk14IbXqFAl31nStZhqBGbvhRNZQDG,A3fsA9Zfv1X2fVEQhTw51lKENdNrEqT3,2,0,0,0,0,0,2,0,2,0.2857142857142857,1,0.0,0,0,0,0,0,0,0,2,0,0,2,1
12674,186710,i8nr5dg8z4enS0u6hepa5rlWzI5t4l3G,SpATywNh6bZuzm8s1ceuBUnMUAeoAHHw,6,6,0,0,0,0,7,0,13,1.8571428571428572,2,0.0,0,0,0,0,6,0,0,7,0,0,13,1
12675,186711,VrzXB04D4NAWNSSnAJBQgbBcugtgsrsf,SpATywNh6bZuzm8s1ceuBUnMUAeoAHHw,5,2,1,0,1,0,3,0,7,1.0,1,0.0,0,1,0,1,2,0,0,3,0,2,5,1
12676,186716,yTPe4A1Cw5qKDjYpFW5H73VItf0UPFbm,A3fsA9Zfv1X2fVEQhTw51lKENdNrEqT3,4,2,1,0,1,0,1,0,5,0.7142857142857143,1,0.0,0,1,0,1,2,0,0,1,0,2,3,1
12677,186723,XO4yOVP7eCwBTi6pYIgtRmMh0ft7YdHb,A3fsA9Zfv1X2fVEQhTw51lKENdNrEqT3,9,12,1,0,1,0,4,0,18,2.5714285714285716,1,0.0,0,1,0,1,12,0,0,4,0,2,16,1
12678,186727,rwCHpAN1sY0GvFYG7zQQk2qpgkOBz9O3,A3fsA9Zfv1X2fVEQhTw51lKENdNrEqT3,1,0,0,0,0,0,1,0,1,0.14285714285714285,1,0.0,0,0,0,0,0,0,0,1,0,0,1,1
12679,186740,ctYjDizjossnFRGdONqI7hfhQiNCx3Il,SpATywNh6bZuzm8s1ceuBUnMUAeoAHHw,5,2,1,0,1,0,2,0,6,0.8571428571428571,1,0.0,0,1,0,1,2,0,0,2,0,2,4,1
12680,186744,5QmsfWrr8re1QceHmRAqqM6UDRZ5H0Jh,A3fsA9Zfv1X2fVEQhTw51lKENdNrEqT3,1,0,0,0,0,0,1,0,1,0.14285714285714285,1,0.0,0,0,0,0,0,0,0,1,0,0,1,1
12681,186749,sHd9Ol41vgPIb8hQT0QvUGTmi4Ucq4PU,A3fsA9Zfv1X2fVEQhTw51lKENdNrEqT3,7,5,1,0,1,0,2,1,10,1.4285714285714286,1,0.0,0,1,0,1,5,0,0,2,1,2,8,0
12682,186757,hDObtbeavxijehIK2xeebS18vJ3HSLBF,G8EPVSXsOYB5YQWZGiz1aVq5Pgr2GrQu,20,13,2,28,2,8,9,2,64,9.142857142857142,1,0.0,7,2,22,2,6,8,6,9,2,33,31,1
12683,186771,EEukb1HtBZxlb0jW8bNwwOHInCYodyW7,SpATywNh6bZuzm8s1ceuBUnMUAeoAHHw,10,8,5,0,3,1,2,0,19,2.7142857142857144,1,0.0,2,5,0,3,6,1,0,2,0,10,9,1
12684,186772,FfI4UUUkiQJXZUOcZvQpEfxlQuZiIFGh,SpATywNh6bZuzm8s1ceuBUnMUAeoAHHw,16,21,6,19,3,1,7,1,58,8.285714285714286,1,0.0,15,6,16,3,6,1,3,7,1,40,18,1
12685,186778,RPs2tKrisA27ObcW2SBs1xNMfhflcdme,A3fsA9Zfv1X2fVEQhTw51lKENdNrEqT3,26,16,13,0,10,2,7,1,49,7.0,1,0.0,1,13,0,10,15,2,0,7,1,24,25,1
12686,186781,7AJKHqkajNqeFVOiguDrQip0qHhqaIRR,SpATywNh6bZuzm8s1ceuBUnMUAeoAHHw,4,3,0,0,0,0,4,0,7,1.0,1,0.0,0,0,0,0,3,0,0,4,0,0,7,1
12687,186783,gGYcWzk2NzIvua4pLrzA2aQChS7C946h,bWdj2GDclj5ofokWjzoa5jAwMkxCykd6,1,0,0,0,0,0,1,0,1,0.14285714285714285,1,0.0,0,0,0,0,0,0,0,1,0,0,1,1
12688,186784,gGYcWzk2NzIvua4pLrzA2aQChS7C946h,A3fsA9Zfv1X2fVEQhTw51lKENdNrEqT3,1,0,0,0,0,0,1,0,1,0.14285714285714285,1,0.0,0,0,0,0,0,0,0,1,0,0,1,1
12689,186800,5dOCb3tuN0oLC3HIthm7sT5KORDlaOZw,bWdj2GDclj5ofokWjzoa5jAwMkxCykd6,1,0,0,0,0,0,1,0,1,0.14285714285714285,1,0.0,0,0,0,0,0,0,0,1,0,0,1,1
12690,186810,fOtwdZktYnpxoylqFRzXhWQ4IRQZkjMB,bWdj2GDclj5ofokWjzoa5jAwMkxCykd6,2,0,0,0,0,0,2,0,2,0.2857142857142857,1,0.0,0,0,0,0,0,0,0,2,0,0,2,1
12691,186813,YxZ9FmNlyuWdg66eoHTORDjjSmjY5VNG,G8EPVSXsOYB5YQWZGiz1aVq5Pgr2GrQu,1,0,0,0,0,0,1,0,1,0.14285714285714285,1,0.0,0,0,0,0,0,0,0,1,0,0,1,1
12692,186814,CBTOHCGcjccQ2o1Vrrh64wBXcjBq7Z16,SpATywNh6bZuzm8s1ceuBUnMUAeoAHHw,1,0,0,0,0,0,1,0,1,0.14285714285714285,1,0.0,0,0,0,0,0,0,0,1,0,0,1,1
12693,186847,hz69aGX7TSXJFEooFn03184YEuUmyXMU,A3fsA9Zfv1X2fVEQhTw51lKENdNrEqT3,1,0,0,0,0,0,1,0,1,0.14285714285714285,1,0.0,0,0,0,0,0,0,0,1,0,0,1,1
12694,186850,UgDeDsY1WA9fQwWE8jwZFiYA6EyOF0ZW,SpATywNh6bZuzm8s1ceuBUnMUAeoAHHw,8,10,6,0,4,0,5,0,25,3.5714285714285716,2,0.0,0,6,0,4,10,0,0,5,0,10,15,1
12695,186853,LsOIP6tIKtIJyz4AzkO8CiGUDMpbTeCo,A3fsA9Zfv1X2fVEQhTw51lKENdNrEqT3,6,13,2,0,0,0,2,0,17,2.4285714285714284,1,0.0,5,2,0,0,8,0,0,2,0,7,10,1
12696,186855,nxuexUreiYSzpSapqT3MF6tzgH9I1i5D,SpATywNh6bZuzm8s1ceuBUnMUAeoAHHw,2,0,0,0,0,0,2,0,2,0.2857142857142857,1,0.0,0,0,0,0,0,0,0,2,0,0,2,1
12697,186856,LsOIP6tIKtIJyz4AzkO8CiGUDMpbTeCo,bWdj2GDclj5ofokWjzoa5jAwMkxCykd6,3,0,0,0,0,0,5,0,5,0.7142857142857143,1,0.0,0,0,0,0,0,0,0,5,0,0,5,1
12698,186860,6wrpSaMSo2sFDvbkUAkMpT5um9Gim187,RXDvfPUBYFlVdlueBFbLW0mhhAyGEqpt,7,4,2,0,1,0,2,0,9,1.2857142857142858,2,0.0,0,2,0,1,4,0,0,2,0,3,6,1
12699,186863,8Sv91LR7V2lE7Zyit6yFhnYKBfbSa4xP,bWdj2GDclj5ofokWjzoa5jAwMkxCykd6,1,0,0,0,0,0,1,0,1,0.14285714285714285,1,0.0,0,0,0,0,0,0,0,1,0,0,1,1
12700,186871,gCagcmlQCSqfTruAye7CNDK3pgpCGf84,G8EPVSXsOYB5YQWZGiz1aVq5Pgr2GrQu,5,2,1,0,1,0,2,0,6,0.8571428571428571,2,0.0,0,1,0,1,2,0,0,2,0,2,4,1
12701,186872,qyt4OAUG4MKvi1Q9hL19EWAbFxfkdehH,SpATywNh6bZuzm8s1ceuBUnMUAeoAHHw,1,0,0,0,0,0,1,0,1,0.14285714285714285,1,0.0,0,0,0,0,0,0,0,1,0,0,1,1
12702,186890,3eKiIXhRJU4AcaSK2OGxb5hm0pCKaHgd,A3fsA9Zfv1X2fVEQhTw51lKENdNrEqT3,39,13,11,46,10,6,2,0,88,12.571428571428571,2,0.0,1,11,45,10,12,6,1,2,0,67,21,1
12703,188085,zRnOVNOS86llNSo73YXoV5gxm1bqsSCm,SpATywNh6bZuzm8s1ceuBUnMUAeoAHHw,5,2,1,0,1,0,2,0,6,0.8571428571428571,1,0.0,0,1,0,1,2,0,0,2,0,2,4,1
12704,188090,ybIzxkMDLWLrDVExEcMDqo8WM6vEGkZZ,SpATywNh6bZuzm8s1ceuBUnMUAeoAHHw,1,0,0,0,0,0,1,0,1,0.14285714285714285,1,0.0,0,0,0,0,0,0,0,1,0,0,1,1
12705,188094,ThbgWOtxqhoj3CitI04NYmRPUH8AcwTc,bWdj2GDclj5ofokWjzoa5jAwMkxCykd6,5,2,1,0,1,0,2,0,6,0.8571428571428571,1,0.0,0,1,0,1,2,0,0,2,0,2,4,1
12706,188109,OH3E8d7hl8qczf2rbzD7q87CuSXHDkzd,SpATywNh6bZuzm8s1ceuBUnMUAeoAHHw,7,3,2,0,2,0,2,0,9,1.2857142857142858,1,0.0,0,2,0,2,3,0,0,2,0,4,5,1
12707,188110,C3IAtr3DP6X43hGuQp5cpcBsS3W9ZHlR,A3fsA9Zfv1X2fVEQhTw51lKENdNrEqT3,9,6,4,0,2,0,4,0,16,2.2857142857142856,3,0.0,0,4,0,2,6,0,0,4,0,6,10,1
12708,188116,MK8k0hhUdWdpYmj0isuX8T1dViy4UCt1,SpATywNh6bZuzm8s1ceuBUnMUAeoAHHw,18,19,6,18,4,0,5,0,52,7.428571428571429,2,0.0,8,6,15,4,11,0,3,5,0,33,19,1
12709,188130,yf5lbvaFDQkrMlGgcstn1q64tRnOCok9,SpATywNh6bZuzm8s1ceuBUnMUAeoAHHw,1,0,0,0,0,0,1,0,1,0.14285714285714285,1,0.0,0,0,0,0,0,0,0,1,0,0,1,1
12710,188131,M16e8QYaHQdZuQp8Y763VwuDYhM2nJCJ,bWdj2GDclj5ofokWjzoa5jAwMkxCykd6,1,0,0,0,0,0,1,0,1,0.14285714285714285,1,0.0,0,0,0,0,0,0,0,1,0,0,1,1
12711,188142,rUr3hxt1niPeDbjT1dWASqAoHDERYMHJ,A3fsA9Zfv1X2fVEQhTw51lKENdNrEqT3,16,3,1,58,0,0,2,0,64,9.142857142857142,1,0.0,0,1,50,0,3,0,8,2,0,51,13,1
12712,188154,iiOxy6ZHzLGvKGuYRdh7FVWh0KnEKqfO,bWdj2GDclj5ofokWjzoa5jAwMkxCykd6,2,0,0,0,0,0,2,0,2,0.2857142857142857,1,0.0,0,0,0,0,0,0,0,2,0,0,2,1
12713,188159,7Yp7JtPvuAevQOAXXsHTKvHnWR7urZQ4,G8EPVSXsOYB5YQWZGiz1aVq5Pgr2GrQu,13,10,6,0,5,1,9,1,32,4.571428571428571,1,0.0,0,6,0,5,10,1,0,9,1,11,21,1
12714,188164,CHnoo745rkdwAbtfBdiAFrd16E9EwOo7,SpATywNh6bZuzm8s1ceuBUnMUAeoAHHw,7,3,2,0,2,0,2,0,9,1.2857142857142858,1,0.0,0,2,0,2,3,0,0,2,0,4,5,1
12715,188166,CHnoo745rkdwAbtfBdiAFrd16E9EwOo7,A3fsA9Zfv1X2fVEQhTw51lKENdNrEqT3,2,0,0,0,0,0,2,0,2,0.2857142857142857,1,0.0,0,0,0,0,0,0,0,2,0,0,2,1
12716,188187,L4jaFu0vxNsfaC1OhafSk08ztmq6goZk,bWdj2GDclj5ofokWjzoa5jAwMkxCykd6,1,0,0,0,0,0,1,0,1,0.14285714285714285,1,0.0,0,0,0,0,0,0,0,1,0,0,1,1
12717,188194,ZbaPpC6DlaDgy5Ic6oj7YX9qkm2j3Pmr,bWdj2GDclj5ofokWjzoa5jAwMkxCykd6,1,0,0,0,0,0,1,0,1,0.14285714285714285,1,0.0,0,0,0,0,0,0,0,1,0,0,1,1
12718,188195,GSVK27iuI3PAZqwurTaJZ7s4wwjamYAo,bWdj2GDclj5ofokWjzoa5jAwMkxCykd6,1,0,0,0,0,0,1,0,1,0.14285714285714285,1,0.0,0,0,0,0,0,0,0,1,0,0,1,1
12719,188217,aXH2LOKFA6E3yNtljCtC3Nc8jVn6ci1H,A3fsA9Zfv1X2fVEQhTw51lKENdNrEqT3,1,0,0,0,0,0,1,0,1,0.14285714285714285,1,0.0,0,0,0,0,0,0,0,1,0,0,1,1
12720,188219,ycZck16llBAZloBk10bwfMcnaMnaXQWK,G8EPVSXsOYB5YQWZGiz1aVq5Pgr2GrQu,8,8,1,4,1,0,3,0,17,2.4285714285714284,1,0.0,0,1,3,1,8,0,1,3,0,5,12,1
12721,188239,zItJ3nxDMUzUt8KfP7wnRxeJL6qP12Ql,SpATywNh6bZuzm8s1ceuBUnMUAeoAHHw,21,16,10,19,7,1,3,1,57,8.142857142857142,1,0.0,5,10,16,7,11,1,3,3,1,38,19,0
12722,188247,BKY6uxinHYYQ0SbTdivOCWOjfYsvPMBo,G8EPVSXsOYB5YQWZGiz1aVq5Pgr2GrQu,21,37,30,36,19,0,7,1,130,18.571428571428573,1,0.0,2,30,35,19,35,0,1,7,1,86,44,1
12723,188261,JxIBkz7Ac4cigQzgeXEdcv5rttnqlmPu,SpATywNh6bZuzm8s1ceuBUnMUAeoAHHw,7,13,6,0,5,0,1,0,25,3.5714285714285716,1,0.0,0,6,0,5,13,0,0,1,0,11,14,1
12724,188265,4M7QUx9Fzm9ZPaWRvEUxQx27jAilEGAL,SpATywNh6bZuzm8s1ceuBUnMUAeoAHHw,1,0,0,0,0,0,1,0,1,0.14285714285714285,1,0.0,0,0,0,0,0,0,0,1,0,0,1,1
12725,188285,VDLlgOqW7FFpT6uHqFXXlnnZR1JOz0x8,bWdj2GDclj5ofokWjzoa5jAwMkxCykd6,5,2,1,0,1,0,2,0,6,0.8571428571428571,1,0.0,0,1,0,1,2,0,0,2,0,2,4,1
12726,188303,jIZxfoiSxH2AO4xoJAniqOuewjPFpPI5,bWdj2GDclj5ofokWjzoa5jAwMkxCykd6,2,0,0,0,0,0,2,0,2,0.2857142857142857,1,0.0,0,0,0,0,0,0,0,2,0,0,2,1
12727,188309,YBtKAFQt6fk6EIukc4Ut5J2kdzYxomaP,G8EPVSXsOYB5YQWZGiz1aVq5Pgr2GrQu,4,2,0,0,0,0,2,1,5,0.7142857142857143,1,0.0,0,0,0,0,2,0,0,2,1,0,5,1
12728,188313,Z34rmr1DW5f5nfzpsFgtbvoODrTWS0gR,A3fsA9Zfv1X2fVEQhTw51lKENdNrEqT3,10,6,5,0,3,0,2,0,16,2.2857142857142856,1,0.0,0,5,0,3,6,0,0,2,0,8,8,1
12729,188317,SgxzSZm3WqSNUUUyFr3EYdvWEPQiCYXc,SpATywNh6bZuzm8s1ceuBUnMUAeoAHHw,5,4,1,0,0,1,3,0,9,1.2857142857142858,1,0.0,0,1,0,0,4,1,0,3,0,1,8,1
12730,188340,lXbqqhFQBJZOyvWBPJdHT24KBsdCctUo,A3fsA9Zfv1X2fVEQhTw51lKENdNrEqT3,2,0,0,0,0,0,2,0,2,0.2857142857142857,1,0.0,0,0,0,0,0,0,0,2,0,0,2,1
12731,188349,OiGglfoFWXujNzXY3OeV6ty8l3z95RBT,G8EPVSXsOYB5YQWZGiz1aVq5Pgr2GrQu,5,2,1,0,1,0,4,0,8,1.1428571428571428,1,0.0,0,1,0,1,2,0,0,4,0,2,6,1
12732,188350,jafkqz7Ls6SMq5HQIDonLkyeZrg5LRjK,bWdj2GDclj5ofokWjzoa5jAwMkxCykd6,2,0,0,0,0,0,3,0,3,0.42857142857142855,1,0.0,0,0,0,0,0,0,0,3,0,0,3,1
12733,188365,4ly9tFjgsKJLiMP1XUHFz2i27nHiXdvU,bWdj2GDclj5ofokWjzoa5jAwMkxCykd6,2,0,0,0,0,0,2,0,2,0.2857142857142857,1,0.0,0,0,0,0,0,0,0,2,0,0,2,1
12734,188366,Qb1CgQ8SxoQQTE8swhxPBVi0nI23eAzb,A3fsA9Zfv1X2fVEQhTw51lKENdNrEqT3,30,15,6,52,2,0,6,0,81,11.571428571428571,2,0.0,2,6,51,2,13,0,1,6,0,61,20,1
12735,188380,YvqXtgBNC43WLi1Y1OHrc4YV5wJZj5BZ,SpATywNh6bZuzm8s1ceuBUnMUAeoAHHw,1,0,0,0,0,0,1,0,1,0.14285714285714285,1,0.0,0,0,0,0,0,0,0,1,0,0,1,1
12736,188395,3RtHMyLQOrBsDYp6yo5VYdmS72cr3PBJ,A3fsA9Zfv1X2fVEQhTw51lKENdNrEqT3,4,4,1,0,0,0,2,0,7,1.0,1,0.0,0,1,0,0,4,0,0,2,0,1,6,1
12737,188404,vN6O2x0QSqyADqu8ib3CnGtyQMSLegp0,SpATywNh6bZuzm8s1ceuBUnMUAeoAHHw,6,5,2,0,1,0,3,0,11,1.5714285714285714,1,0.0,0,2,0,1,5,0,0,3,0,3,8,1
12738,188429,O1acx8tASPAKCowx3gb1g3tmN6Tc39LY,SpATywNh6bZuzm8s1ceuBUnMUAeoAHHw,5,3,1,0,1,0,2,0,7,1.0,1,0.0,0,1,0,1,3,0,0,2,0,2,5,1
12739,188437,xGSY8Cd0Vf3OB8ao8DFjx5u3ZfaDhjub,SpATywNh6bZuzm8s1ceuBUnMUAeoAHHw,4,2,0,0,0,0,3,0,5,0.7142857142857143,1,0.0,0,0,0,0,2,0,0,3,0,0,5,1
12740,188443,2I5ebzNsijWnJvqjKSef4ff3wTM7uHNA,SpATywNh6bZuzm8s1ceuBUnMUAeoAHHw,19,21,13,18,6,1,6,1,66,9.428571428571429,1,0.0,5,13,15,6,16,1,3,6,1,39,27,1
12741,188449,Pp88hiBrGOv2jXNIxXAtL4Okpq7q1gT0,SpATywNh6bZuzm8s1ceuBUnMUAeoAHHw,9,10,4,4,0,0,2,0,20,2.857142857142857,1,0.0,4,4,3,0,6,0,1,2,0,11,9,1
12742,188453,hVaGaJRn8sLkma0vlTnpuIvccDoCcRmU,SpATywNh6bZuzm8s1ceuBUnMUAeoAHHw,11,9,1,10,0,0,3,0,23,3.2857142857142856,1,0.0,1,1,9,0,8,0,1,3,0,11,12,1
12743,188457,gKGgdSFWPcygAewBStBoLPqo60qbmH1E,SpATywNh6bZuzm8s1ceuBUnMUAeoAHHw,6,3,1,0,1,0,2,0,7,1.0,1,0.0,0,1,0,1,3,0,0,2,0,2,5,1
12744,188473,A5GOsdnH2EcjC6B3eZFXiZImo9yFgAgf,SpATywNh6bZuzm8s1ceuBUnMUAeoAHHw,7,5,1,0,1,0,2,0,9,1.2857142857142858,1,0.0,0,1,0,1,5,0,0,2,0,2,7,1
12745,188474,T2bqEEIIeGnaI1g4yvbhFPGfktTUZc7r,A3fsA9Zfv1X2fVEQhTw51lKENdNrEqT3,2,0,0,0,0,0,3,0,3,0.42857142857142855,1,0.0,0,0,0,0,0,0,0,3,0,0,3,1
12746,188485,DnH0S2FmhfjVrDlDj5ZYyy4G86Cb3LMh,A3fsA9Zfv1X2fVEQhTw51lKENdNrEqT3,20,8,7,0,7,1,8,1,32,4.571428571428571,1,0.0,0,7,0,7,8,1,0,8,1,14,18,1
12747,188490,V6YPbhCrTroTd2oOIiUcM7kFRRLU5vrj,A3fsA9Zfv1X2fVEQhTw51lKENdNrEqT3,10,5,4,0,4,0,1,0,14,2.0,1,0.0,0,4,0,4,5,0,0,1,0,8,6,1
12748,188492,Bm156uclJazpLCklS4EEwaPxoPGPtFcp,SpATywNh6bZuzm8s1ceuBUnMUAeoAHHw,5,2,1,0,1,0,2,0,6,0.8571428571428571,1,0.0,0,1,0,1,2,0,0,2,0,2,4,1
12749,188500,j6ThnD1jS0Zu8CWEKNbNRNMNGJz47quI,SpATywNh6bZuzm8s1ceuBUnMUAeoAHHw,19,18,13,14,11,3,1,0,60,8.571428571428571,1,0.0,3,13,14,11,15,3,0,1,0,41,19,1
12750,188505,YnmpFl6RHXV2PnbToNbHTDGl7f0k3wEj,SpATywNh6bZuzm8s1ceuBUnMUAeoAHHw,7,3,2,0,2,0,2,0,9,1.2857142857142858,1,0.0,0,2,0,2,3,0,0,2,0,4,5,1
12751,188513,Vr0kaKAkI4p2upUYNB1MMKsTShBZob66,bWdj2GDclj5ofokWjzoa5jAwMkxCykd6,1,0,0,0,0,0,1,0,1,0.14285714285714285,1,0.0,0,0,0,0,0,0,0,1,0,0,1,1
12752,188517,udLbdwzexRvhhTaiAuWi3yugEk6gj6AD,SpATywNh6bZuzm8s1ceuBUnMUAeoAHHw,6,5,4,0,4,0,1,0,14,2.0,1,0.0,0,4,0,4,5,0,0,1,0,8,6,1
12753,188521,bK37SC4aHpDxnD3Rvkijz9Wy2oAlQRmW,bWdj2GDclj5ofokWjzoa5jAwMkxCykd6,6,2,0,0,0,0,7,1,10,1.4285714285714286,1,0.0,0,0,0,0,2,0,0,7,1,0,10,1
12754,188530,1NKuiSaTPUbZFDACCyv5YoUfO7qDer9w,SpATywNh6bZuzm8s1ceuBUnMUAeoAHHw,3,3,1,0,0,0,1,0,5,0.7142857142857143,1,0.0,0,1,0,0,3,0,0,1,0,1,4,1
12755,188532,3sMwGCOGCL2RAMMG6tfFT0UobGq5flFz,SpATywNh6bZuzm8s1ceuBUnMUAeoAHHw,6,3,2,0,2,0,1,0,8,1.1428571428571428,1,0.0,0,2,0,2,3,0,0,1,0,4,4,1
12756,188535,DVNRZ0Vb68sNhFssev2X8FTZcbZTVgAF,RXDvfPUBYFlVdlueBFbLW0mhhAyGEqpt,1,0,0,0,0,0,1,0,1,0.14285714285714285,1,0.0,0,0,0,0,0,0,0,1,0,0,1,1
12757,188543,JV1BgG1khCT6s4RU5oY7ZOSmwW31Qjbp,A3fsA9Zfv1X2fVEQhTw51lKENdNrEqT3,3,0,0,0,0,1,2,0,3,0.42857142857142855,1,0.0,0,0,0,0,0,1,0,2,0,0,3,1
12758,188551,SSoRd5SzkY86SEd4leqERj2oURCXSCvn,SpATywNh6bZuzm8s1ceuBUnMUAeoAHHw,5,2,1,0,1,0,2,0,6,0.8571428571428571,1,0.0,0,1,0,1,2,0,0,2,0,2,4,1
12759,188559,pGYLDmhkSj1iBp1YljlDSId0XSrjZNZR,A3fsA9Zfv1X2fVEQhTw51lKENdNrEqT3,9,7,5,0,4,0,3,0,19,2.7142857142857144,2,0.0,0,5,0,4,7,0,0,3,0,9,10,1
12760,188560,5gty34EJtQfrhgxngYuTOUGIUr24foZa,SpATywNh6bZuzm8s1ceuBUnMUAeoAHHw,2,0,0,0,0,0,2,0,2,0.2857142857142857,1,0.0,0,0,0,0,0,0,0,2,0,0,2,1
12761,188567,j6ThnD1jS0Zu8CWEKNbNRNMNGJz47quI,A3fsA9Zfv1X2fVEQhTw51lKENdNrEqT3,10,7,5,0,5,0,1,0,18,2.5714285714285716,1,0.0,1,5,0,5,6,0,0,1,0,11,7,1
12762,188572,y9xw5DVwyk92GMkn6gBPMifXrAjYvHji,A3fsA9Zfv1X2fVEQhTw51lKENdNrEqT3,13,10,6,0,3,0,6,2,27,3.857142857142857,1,0.0,2,6,0,3,8,0,0,6,2,11,16,1
12763,188593,urj2Kr7Ws5qXQZp6biE11Qihh39xd0AE,SpATywNh6bZuzm8s1ceuBUnMUAeoAHHw,1,0,0,0,0,0,1,0,1,0.14285714285714285,1,0.0,0,0,0,0,0,0,0,1,0,0,1,1
12764,188618,xteF5FHjR9QQQGxa0LyAUB4pHnIcVbG6,SpATywNh6bZuzm8s1ceuBUnMUAeoAHHw,1,0,0,0,0,0,1,0,1,0.14285714285714285,1,0.0,0,0,0,0,0,0,0,1,0,0,1,1
12765,188635,0sfQp4STEjfvmoiPU7wK8kVHvDAbzKnN,SpATywNh6bZuzm8s1ceuBUnMUAeoAHHw,7,3,1,0,2,0,2,0,8,1.1428571428571428,1,0.0,0,1,0,2,3,0,0,2,0,3,5,1
12766,188643,16lFu8CHy4ustz36vrR0Ab5cogeu487w,A3fsA9Zfv1X2fVEQhTw51lKENdNrEqT3,2,0,0,0,0,0,2,0,2,0.2857142857142857,1,0.0,0,0,0,0,0,0,0,2,0,0,2,1
12767,188933,Xtlrv3IpXCAfEIMntfnxIykrduMXBwb6,7GRhBDsirIGkRZBtSMEzNTyDr2JQm4xx,1,0,0,0,0,0,1,0,1,0.14285714285714285,1,0.0,0,0,0,0,0,0,0,1,0,0,1,1
12768,188937,7gxdF7npc77h7z0KnU9ezGYqtBJqY4fQ,A3fsA9Zfv1X2fVEQhTw51lKENdNrEqT3,1,0,0,0,0,0,2,0,2,0.2857142857142857,1,0.0,0,0,0,0,0,0,0,2,0,0,2,1
12769,188963,bGjzMxOC88rUacNGu6kshAaxdH2zKDK7,7GRhBDsirIGkRZBtSMEzNTyDr2JQm4xx,2,0,0,0,0,0,2,0,2,0.2857142857142857,1,0.0,0,0,0,0,0,0,0,2,0,0,2,1
12770,188974,KcVR47mhsCByukl6kUhifp06p0t9ddmf,7GRhBDsirIGkRZBtSMEzNTyDr2JQm4xx,1,0,0,0,0,0,1,0,1,0.14285714285714285,1,0.0,0,0,0,0,0,0,0,1,0,0,1,1
12771,188976,hlny1PkYo5JEvtbsehOwAyHgv8hye7Vl,7GRhBDsirIGkRZBtSMEzNTyDr2JQm4xx,1,0,0,0,0,0,1,0,1,0.14285714285714285,1,0.0,0,0,0,0,0,0,0,1,0,0,1,1
12772,188979,XoKIP4RGpnZk163890vUyWhLOIUSaapU,7GRhBDsirIGkRZBtSMEzNTyDr2JQm4xx,28,58,22,50,13,2,1,0,146,20.857142857142858,1,0.0,35,22,40,13,23,2,10,1,0,110,36,1
12773,188986,pDtmXyCxgvpAGK1UHOqTKB1Mk4ad0Obx,7GRhBDsirIGkRZBtSMEzNTyDr2JQm4xx,2,0,0,0,0,0,3,0,3,0.42857142857142855,1,0.0,0,0,0,0,0,0,0,3,0,0,3,1
12774,188997,vDLgajPV6eBsq6waPGg2sGMVCdUz10kh,7GRhBDsirIGkRZBtSMEzNTyDr2JQm4xx,6,0,0,0,0,0,9,1,10,1.4285714285714286,1,0.0,0,0,0,0,0,0,0,9,1,0,10,1
12775,189038,CaO6lbKucftN7Eu0LZWcCZKQchWcKCTo,7GRhBDsirIGkRZBtSMEzNTyDr2JQm4xx,6,0,0,0,0,0,6,0,6,0.8571428571428571,1,0.0,0,0,0,0,0,0,0,6,0,0,6,1
12776,189121,v4Sdqo21VERdMlPPJ5lxFzea2Futc16m,7GRhBDsirIGkRZBtSMEzNTyDr2JQm4xx,10,5,3,7,3,1,2,1,22,3.142857142857143,1,0.0,1,3,6,3,4,1,1,2,1,13,9,1
12777,189123,f3G4rcF7hvAe5fW36C69obxNMOERmdUr,7GRhBDsirIGkRZBtSMEzNTyDr2JQm4xx,2,0,0,0,0,0,2,0,2,0.2857142857142857,1,0.0,0,0,0,0,0,0,0,2,0,0,2,1
12778,189125,BlhCYC8woOBcOY9B6dneqhiXvmHLTuKE,7GRhBDsirIGkRZBtSMEzNTyDr2JQm4xx,2,0,0,0,0,0,2,0,2,0.2857142857142857,1,0.0,0,0,0,0,0,0,0,2,0,0,2,1
12779,189138,jiFzFGisDkK72ZBTna8wrY4pq5bLzUOt,SpATywNh6bZuzm8s1ceuBUnMUAeoAHHw,4,2,1,0,1,0,1,0,5,0.7142857142857143,1,0.0,0,1,0,1,2,0,0,1,0,2,3,1
12780,189142,skSnSfH7XcyX8lYXpZBS74pGLHKMwWNm,7GRhBDsirIGkRZBtSMEzNTyDr2JQm4xx,1,0,0,0,0,0,1,0,1,0.14285714285714285,1,0.0,0,0,0,0,0,0,0,1,0,0,1,1
12781,189149,RD8IEsnXxFXH4Z6OD9WSAuQqmJ27nHhK,7GRhBDsirIGkRZBtSMEzNTyDr2JQm4xx,2,0,0,0,0,0,2,0,2,0.2857142857142857,1,0.0,0,0,0,0,0,0,0,2,0,0,2,1
12782,189157,KADzrQcaGi7TzZIKCqh7I8E0i863BBoH,7GRhBDsirIGkRZBtSMEzNTyDr2JQm4xx,2,0,0,0,0,0,2,0,2,0.2857142857142857,1,0.0,0,0,0,0,0,0,0,2,0,0,2,1
12783,189163,YdCaKimqYb8kuFiHEtjPDsCbtIch1tfO,7GRhBDsirIGkRZBtSMEzNTyDr2JQm4xx,8,9,2,0,0,1,5,2,19,2.7142857142857144,1,0.0,5,2,0,0,4,1,0,5,2,7,12,1
12784,189178,UpLwu6T0ULbCdikK3k55n17m75BbWAqs,7GRhBDsirIGkRZBtSMEzNTyDr2JQm4xx,7,4,1,0,2,0,4,0,11,1.5714285714285714,1,0.0,2,1,0,2,2,0,0,4,0,5,6,1
12785,189180,De3af8LDoF4IXXnUzXAiZVCskiGXJoAd,7GRhBDsirIGkRZBtSMEzNTyDr2JQm4xx,11,11,4,4,2,15,9,3,48,6.857142857142857,1,0.0,2,4,3,2,9,15,1,9,3,11,37,1
12786,189185,waDceRgc2N0BjPJorKWJj1WtKs87R7xP,7GRhBDsirIGkRZBtSMEzNTyDr2JQm4xx,4,2,0,0,0,0,2,0,4,0.5714285714285714,1,0.0,0,0,0,0,2,0,0,2,0,0,4,1
12787,189190,hz69aGX7TSXJFEooFn03184YEuUmyXMU,7GRhBDsirIGkRZBtSMEzNTyDr2JQm4xx,2,0,0,0,0,0,2,0,2,0.2857142857142857,1,0.0,0,0,0,0,0,0,0,2,0,0,2,1
12788,189200,jxw4QkqvvdLlUDAf97E2SumJv5ThdQ3m,7GRhBDsirIGkRZBtSMEzNTyDr2JQm4xx,2,0,0,0,0,0,5,0,5,0.7142857142857143,1,0.0,0,0,0,0,0,0,0,5,0,0,5,1
12789,189217,S685sFeuH7ep81myXbWJBadTSgXcwR6Q,7GRhBDsirIGkRZBtSMEzNTyDr2JQm4xx,5,2,1,0,1,0,3,0,7,1.0,1,0.0,0,1,0,1,2,0,0,3,0,2,5,1
12790,189225,V1EykxyqrSjJS8SrSU1L9A5qCk92mw9z,7GRhBDsirIGkRZBtSMEzNTyDr2JQm4xx,23,34,18,24,17,1,2,0,96,13.714285714285714,1,0.0,8,18,21,17,26,1,3,2,0,64,32,1
12791,189237,XqzZzhc9uB2wCLtNHGWt7epj98UW1aCq,7GRhBDsirIGkRZBtSMEzNTyDr2JQm4xx,2,0,0,0,0,0,2,0,2,0.2857142857142857,1,0.0,0,0,0,0,0,0,0,2,0,0,2,1
12792,189251,gKEmxl73O6lgpzCm5W5THfmE7UMUjyMT,7GRhBDsirIGkRZBtSMEzNTyDr2JQm4xx,6,1,1,0,0,5,4,3,14,2.0,1,0.0,0,1,0,0,1,5,0,4,3,1,13,1
12793,189258,vKg7m5YebaxRd5kf6WsIAhVoxmBX8DKD,7GRhBDsirIGkRZBtSMEzNTyDr2JQm4xx,2,0,0,0,0,0,2,0,2,0.2857142857142857,1,0.0,0,0,0,0,0,0,0,2,0,0,2,1
12794,189329,IDVV2jtBUYHXvZRwUeupKpLFwBDZmMvi,7GRhBDsirIGkRZBtSMEzNTyDr2JQm4xx,3,2,0,0,0,0,1,0,3,0.42857142857142855,1,0.0,0,0,0,0,2,0,0,1,0,0,3,1
12795,189332,xhCV750Vmz3Zc8n6WSG04S1Of863qTkW,7GRhBDsirIGkRZBtSMEzNTyDr2JQm4xx,1,0,0,0,0,0,1,0,1,0.14285714285714285,1,0.0,0,0,0,0,0,0,0,1,0,0,1,1
12796,189336,y71lRBqIdu5iPiLn9Yi5PQm6GFIvgLwB,7GRhBDsirIGkRZBtSMEzNTyDr2JQm4xx,1,0,0,0,0,0,1,0,1,0.14285714285714285,1,0.0,0,0,0,0,0,0,0,1,0,0,1,1
12797,189381,d9mMxxcMI65zEdojLuYluBZegkL9kaO9,7GRhBDsirIGkRZBtSMEzNTyDr2JQm4xx,2,0,0,0,0,0,2,0,2,0.2857142857142857,1,0.0,0,0,0,0,0,0,0,2,0,0,2,1
12798,189401,PB7h0UvHpsEAKo6BKDI2Oe83oHx4FlRv,7GRhBDsirIGkRZBtSMEzNTyDr2JQm4xx,5,4,1,0,2,0,2,0,9,1.2857142857142858,1,0.0,2,1,0,2,2,0,0,2,0,5,4,1
12799,189408,XsZuRX3JjxC6rjjGF8ce2xx3yowgSNne,7GRhBDsirIGkRZBtSMEzNTyDr2JQm4xx,8,3,2,0,2,0,4,0,11,1.5714285714285714,1,0.0,0,2,0,2,3,0,0,4,0,4,7,1
12800,189412,B8lBbNEso7Bw3KF9oTlYX1eUGmqw99RL,SpATywNh6bZuzm8s1ceuBUnMUAeoAHHw,3,2,0,0,0,0,1,0,3,0.42857142857142855,1,0.0,0,0,0,0,2,0,0,1,0,0,3,1
12801,189442,ifnHK7elzUrx6FoT7eceCrEZMhAwQ98l,7GRhBDsirIGkRZBtSMEzNTyDr2JQm4xx,5,3,1,4,1,0,2,0,11,1.5714285714285714,1,0.0,1,1,3,1,2,0,1,2,0,6,5,1
12802,189444,HO1jCcwERynGUi1jR0hjkSfXZ85j5jaW,7GRhBDsirIGkRZBtSMEzNTyDr2JQm4xx,1,0,0,0,0,0,1,0,1,0.14285714285714285,1,0.0,0,0,0,0,0,0,0,1,0,0,1,1
12803,189448,opKUJLQunILYTzpA0JfEP9KQkwUgY37v,7GRhBDsirIGkRZBtSMEzNTyDr2JQm4xx,16,8,5,0,3,3,10,1,30,4.285714285714286,1,0.0,0,5,0,3,8,3,0,10,1,8,22,1
12804,189453,CwPtG0pQpatgEgPUJC1fzC45UnY2lgMF,7GRhBDsirIGkRZBtSMEzNTyDr2JQm4xx,10,11,7,10,5,0,4,0,37,5.285714285714286,2,0.0,3,7,8,5,8,0,2,4,0,23,14,1
12805,189519,W44EUSPSAj1fZWLor5hD25joUoQF1Axq,7GRhBDsirIGkRZBtSMEzNTyDr2JQm4xx,9,6,0,2,1,0,2,0,11,1.5714285714285714,1,0.0,1,0,2,1,5,0,0,2,0,4,7,1
12806,189520,xPkJLyddSzkSguLc8iFCPUKp6SiHPVYA,7GRhBDsirIGkRZBtSMEzNTyDr2JQm4xx,1,0,0,0,0,0,1,0,1,0.14285714285714285,1,0.0,0,0,0,0,0,0,0,1,0,0,1,1
12807,189576,QGuKTIBC2KLaYpPdOnB4nXCWgxMM1Dog,7GRhBDsirIGkRZBtSMEzNTyDr2JQm4xx,1,0,0,0,0,0,1,0,1,0.14285714285714285,1,0.0,0,0,0,0,0,0,0,1,0,0,1,1
12808,189593,MgVP6LodMhznTbusy8mYmerhW0RKcSCB,7GRhBDsirIGkRZBtSMEzNTyDr2JQm4xx,1,0,0,0,0,0,1,0,1,0.14285714285714285,1,0.0,0,0,0,0,0,0,0,1,0,0,1,1
12809,189605,yrczal0ybDrTDoOYd1WvgcBQApn5E29e,7GRhBDsirIGkRZBtSMEzNTyDr2JQm4xx,1,0,0,0,0,0,1,0,1,0.14285714285714285,1,0.0,0,0,0,0,0,0,0,1,0,0,1,1
12810,189608,1HkkpfSVTiT6CtY9J3aLZcX4FRE5LVLz,7GRhBDsirIGkRZBtSMEzNTyDr2JQm4xx,3,0,0,0,0,3,2,0,5,0.7142857142857143,1,0.0,0,0,0,0,0,3,0,2,0,0,5,1
12811,189614,5PZBmKEXGmnHhrok7M9vaGB06CAzFVOO,7GRhBDsirIGkRZBtSMEzNTyDr2JQm4xx,6,4,1,2,1,0,1,0,9,1.2857142857142858,1,0.0,1,1,2,1,3,0,0,1,0,5,4,0
12812,189666,lbgTV2YMskSv2TX4EXpaazpMVWfsftEV,7GRhBDsirIGkRZBtSMEzNTyDr2JQm4xx,1,0,0,0,0,0,1,0,1,0.14285714285714285,1,0.0,0,0,0,0,0,0,0,1,0,0,1,1
12813,189696,PMZJ7vxYEpwybeGWTMZuFimiDLzBBGfH,7GRhBDsirIGkRZBtSMEzNTyDr2JQm4xx,9,7,1,0,1,0,2,0,11,1.5714285714285714,1,0.0,0,1,0,1,7,0,0,2,0,2,9,1
12814,189792,tr8E6i6LhPPOpsyObFM4xo1Myl86ILao,A3fsA9Zfv1X2fVEQhTw51lKENdNrEqT3,4,3,0,0,0,0,1,0,4,0.5714285714285714,1,0.0,0,0,0,0,3,0,0,1,0,0,4,1
12815,189835,vXT2w57VYk2IRPGUPSaMsXQX7TQrsaxB,7GRhBDsirIGkRZBtSMEzNTyDr2JQm4xx,1,0,0,0,0,0,1,0,1,0.14285714285714285,1,0.0,0,0,0,0,0,0,0,1,0,0,1,1
12816,189836,xgQYbfvDEw17v13YEvx2pY52YvDa4jfG,7GRhBDsirIGkRZBtSMEzNTyDr2JQm4xx,12,6,5,0,5,0,1,0,17,2.4285714285714284,1,0.0,0,5,0,5,6,0,0,1,0,10,7,0
12817,189841,c6EQxl5Y5srE1l7qShfQ6CExe7ZkgJ6z,7GRhBDsirIGkRZBtSMEzNTyDr2JQm4xx,12,17,7,4,2,2,5,0,37,5.285714285714286,2,0.0,5,7,3,2,12,2,1,5,0,17,20,0
12818,189872,tvbjaq3OPKemCIT5KViqtpbuzjmnk9iv,7GRhBDsirIGkRZBtSMEzNTyDr2JQm4xx,1,0,0,0,0,0,1,0,1,0.14285714285714285,1,0.0,0,0,0,0,0,0,0,1,0,0,1,1
12819,189878,EuByZSROH9lLZ2dnd4GXxahw8RdkgjTd,7GRhBDsirIGkRZBtSMEzNTyDr2JQm4xx,5,2,1,0,1,0,4,0,8,1.1428571428571428,1,0.0,0,1,0,1,2,0,0,4,0,2,6,1
12820,189962,vqeyrkQOvY6ito5wie8yXLKkDfcoR2Qk,7GRhBDsirIGkRZBtSMEzNTyDr2JQm4xx,1,0,0,0,0,0,1,0,1,0.14285714285714285,1,0.0,0,0,0,0,0,0,0,1,0,0,1,1
12821,189987,VAnGmjZDe4mKyUygxHcsKkNd3a9DThub,7GRhBDsirIGkRZBtSMEzNTyDr2JQm4xx,9,8,2,4,3,0,3,0,20,2.857142857142857,1,0.0,3,2,3,3,5,0,1,3,0,11,9,1
12822,190043,9NL6pIdeoq3qoMYjmrqicRwQF6as6xWO,7GRhBDsirIGkRZBtSMEzNTyDr2JQm4xx,6,7,1,0,1,0,3,0,12,1.7142857142857142,1,0.0,0,1,0,1,7,0,0,3,0,2,10,1
12823,190059,zX9pboSJ4vJa1gdfSLlOQHMTjhsQEp32,7GRhBDsirIGkRZBtSMEzNTyDr2JQm4xx,1,0,0,0,0,0,1,0,1,0.14285714285714285,1,0.0,0,0,0,0,0,0,0,1,0,0,1,1
12824,190148,WQMZ2fhdRzqYNsK6k2GeqeA3Ess2PfYw,7GRhBDsirIGkRZBtSMEzNTyDr2JQm4xx,1,0,0,0,0,0,1,0,1,0.14285714285714285,1,0.0,0,0,0,0,0,0,0,1,0,0,1,1
12825,190207,LuEM6Ji2sbchJvZp3E6DXQ6Q9idvBGe0,7GRhBDsirIGkRZBtSMEzNTyDr2JQm4xx,5,1,1,0,1,2,2,0,7,1.0,1,0.0,0,1,0,1,1,2,0,2,0,2,5,1
12826,190718,DpxuYKp6sa0JAnGuKmqElQRmCDtXLEpJ,SpATywNh6bZuzm8s1ceuBUnMUAeoAHHw,1,0,0,0,0,0,1,0,1,0.14285714285714285,1,0.0,0,0,0,0,0,0,0,1,0,0,1,1
12827,190722,Ms1kL8mhYcPEiDk8tgcaN8I4C5LMNZxp,G8EPVSXsOYB5YQWZGiz1aVq5Pgr2GrQu,11,9,1,19,0,0,1,0,30,4.285714285714286,1,0.0,4,1,15,0,5,0,4,1,0,20,10,1
12828,190727,37BDHc0OYB1UI75qIorGre2ofEZmPc4J,A3fsA9Zfv1X2fVEQhTw51lKENdNrEqT3,1,0,0,0,0,0,1,0,1,0.14285714285714285,1,0.0,0,0,0,0,0,0,0,1,0,0,1,1
12829,190733,qwFC3xpje0fSY3HguoMOOzyv51OIHJQc,SpATywNh6bZuzm8s1ceuBUnMUAeoAHHw,5,2,1,0,1,0,2,0,6,0.8571428571428571,1,0.0,0,1,0,1,2,0,0,2,0,2,4,1
12830,190740,MK8n1r3R3tfWcasYdKrOSnVNYSZNSOlt,SpATywNh6bZuzm8s1ceuBUnMUAeoAHHw,13,33,4,23,0,1,7,2,70,10.0,1,0.0,10,4,20,0,23,1,3,7,2,34,36,1
12831,190746,TCMrwUanMGda0OSNc9BMWUDLbksnXQ2Q,SpATywNh6bZuzm8s1ceuBUnMUAeoAHHw,11,13,7,0,4,5,6,1,36,5.142857142857143,1,0.0,0,7,0,4,13,5,0,6,1,11,25,0
12832,190751,wIcAqiIkhVke6PQk1FQ10LQjFUOa268K,A3fsA9Zfv1X2fVEQhTw51lKENdNrEqT3,1,0,0,0,0,0,2,0,2,0.2857142857142857,1,0.0,0,0,0,0,0,0,0,2,0,0,2,1
12833,190753,d91YjGHVAp34DYQkswrOrvZeIJcGcFNO,SpATywNh6bZuzm8s1ceuBUnMUAeoAHHw,13,13,5,12,4,0,2,0,36,5.142857142857143,1,0.0,6,5,11,4,7,0,1,2,0,26,10,1
12834,190765,3RcsrMTbPrb8ZHYXLlgwoRK7zrqTGSuq,RXDvfPUBYFlVdlueBFbLW0mhhAyGEqpt,4,2,1,0,1,0,1,0,5,0.7142857142857143,1,0.0,0,1,0,1,2,0,0,1,0,2,3,1
12835,190772,HBKLIFAfKd9tCUbnjwmqE9j7uloBEJrv,bWdj2GDclj5ofokWjzoa5jAwMkxCykd6,6,8,1,0,1,5,6,0,21,3.0,2,0.0,0,1,0,1,8,5,0,6,0,2,19,1
12836,190777,Ah2AGzYhaU2T8uPD2EY56TT31dJPAut5,SpATywNh6bZuzm8s1ceuBUnMUAeoAHHw,6,3,1,0,1,0,2,0,7,1.0,1,0.0,0,1,0,1,3,0,0,2,0,2,5,1
12837,190783,jImHfNEIObE674KdIbKVj7cCJ4ufqzHJ,bWdj2GDclj5ofokWjzoa5jAwMkxCykd6,6,6,2,0,0,10,4,0,22,3.142857142857143,1,0.0,1,2,0,0,5,10,0,4,0,3,19,1
12838,190788,ub8WyOqIuzODPtpQPBgjCOsRi8689oKs,bWdj2GDclj5ofokWjzoa5jAwMkxCykd6,9,16,6,34,6,0,3,0,65,9.285714285714286,1,0.0,7,6,33,6,9,0,1,3,0,52,13,1
12839,190789,OVHTSfVPYj0AbzU459n1EpNOKwcVwoC1,SpATywNh6bZuzm8s1ceuBUnMUAeoAHHw,6,1,1,0,1,0,5,0,8,1.1428571428571428,1,0.0,0,1,0,1,1,0,0,5,0,2,6,1
12840,190799,4e4wTy2Vsuz8jVFYgJOgi1kIGDWREiPH,A3fsA9Zfv1X2fVEQhTw51lKENdNrEqT3,1,0,0,0,0,0,1,0,1,0.14285714285714285,1,0.0,0,0,0,0,0,0,0,1,0,0,1,1
12841,190810,kKpnSjKhiG2j5iddaCKIyt4CCm1rwmVr,bWdj2GDclj5ofokWjzoa5jAwMkxCykd6,2,0,0,0,0,0,2,0,2,0.2857142857142857,1,0.0,0,0,0,0,0,0,0,2,0,0,2,0
12842,190812,3GA2inbDa4Qb67FoyO0TodCHsf82hLjI,bWdj2GDclj5ofokWjzoa5jAwMkxCykd6,7,9,0,0,0,0,6,0,15,2.142857142857143,2,0.0,0,0,0,0,9,0,0,6,0,0,15,1
12843,190843,hfNogWjrbSkOb5OMhhVjR3oNpdgCCLmb,SpATywNh6bZuzm8s1ceuBUnMUAeoAHHw,3,0,0,0,0,0,3,0,3,0.42857142857142855,1,0.0,0,0,0,0,0,0,0,3,0,0,3,1
12844,190859,ckUpblr5wnpb1JdYLODP4lr2g04VPwJ3,SpATywNh6bZuzm8s1ceuBUnMUAeoAHHw,6,8,4,0,4,0,1,0,17,2.4285714285714284,1,0.0,3,4,0,4,5,0,0,1,0,11,6,1
12845,190862,6ZrLKRxT6wri7cDqZ6Wete0KvsW58pUp,SpATywNh6bZuzm8s1ceuBUnMUAeoAHHw,3,2,0,0,0,0,1,0,3,0.42857142857142855,1,0.0,0,0,0,0,2,0,0,1,0,0,3,1
12846,190865,tE94PJyjcpdWxXLDLcWw5U2hOs3lOnfb,SpATywNh6bZuzm8s1ceuBUnMUAeoAHHw,12,4,3,0,3,1,5,1,17,2.4285714285714284,1,0.0,0,3,0,3,4,1,0,5,1,6,11,1
12847,190871,DanoP5XpHODQZmwuFGZgNKBiu5nY9yH1,bWdj2GDclj5ofokWjzoa5jAwMkxCykd6,5,3,1,0,1,1,2,1,9,1.2857142857142858,1,0.0,1,1,0,1,2,1,0,2,1,3,6,1
12848,190878,XZVdP9VG9V0aFXSF7pNpI4xf6QSEG5Qi,SpATywNh6bZuzm8s1ceuBUnMUAeoAHHw,1,0,0,0,0,0,1,0,1,0.14285714285714285,1,0.0,0,0,0,0,0,0,0,1,0,0,1,1
12849,190881,qKdcEew3Ozu2wI3f7P370tw3NiiGDkW3,bWdj2GDclj5ofokWjzoa5jAwMkxCykd6,1,0,0,0,0,0,1,0,1,0.14285714285714285,1,0.0,0,0,0,0,0,0,0,1,0,0,1,1
12850,190890,9Yh9BGNzlB70iEC7VABYNXfepXjXz9Ik,A3fsA9Zfv1X2fVEQhTw51lKENdNrEqT3,1,0,0,0,0,0,3,0,3,0.42857142857142855,1,0.0,0,0,0,0,0,0,0,3,0,0,3,1
12851,190896,jGtiVf5HYLqgOasCrKGgOBMBFuA9x4ae,SpATywNh6bZuzm8s1ceuBUnMUAeoAHHw,7,6,2,0,2,0,2,0,12,1.7142857142857142,1,0.0,0,2,0,2,6,0,0,2,0,4,8,1
12852,190918,withnGSnYLu5h0Gra5Fz5vQjZTgJGD3V,SpATywNh6bZuzm8s1ceuBUnMUAeoAHHw,7,3,2,0,2,0,4,0,11,1.5714285714285714,1,0.0,0,2,0,2,3,0,0,4,0,4,7,1
12853,190922,tbFJlVh7YWaPwir5TDxmcNNiJWy4IdR6,SpATywNh6bZuzm8s1ceuBUnMUAeoAHHw,7,8,5,0,3,0,3,0,19,2.7142857142857144,1,0.0,0,5,0,3,8,0,0,3,0,8,11,1
12854,190929,KK8c9Dmj5I63bhg4LxlQHTWu5jCGLVNt,SpATywNh6bZuzm8s1ceuBUnMUAeoAHHw,1,0,0,0,0,0,1,0,1,0.14285714285714285,1,0.0,0,0,0,0,0,0,0,1,0,0,1,1
12855,190932,gWQVeEY6kY0Jw04P2MZyClMk9GLvVaq0,RXDvfPUBYFlVdlueBFbLW0mhhAyGEqpt,14,11,8,19,2,0,11,0,51,7.285714285714286,1,0.0,1,8,16,2,10,0,3,11,0,27,24,1
12856,190938,QxwH5Fww2hdJXhksXEKBkHoArOFw3LA7,bWdj2GDclj5ofokWjzoa5jAwMkxCykd6,1,0,0,0,0,0,1,0,1,0.14285714285714285,1,0.0,0,0,0,0,0,0,0,1,0,0,1,1
12857,190943,2AimReANoYwzi4n9y5GufQBbWWeoLfr2,bWdj2GDclj5ofokWjzoa5jAwMkxCykd6,1,0,0,0,0,0,1,0,1,0.14285714285714285,1,0.0,0,0,0,0,0,0,0,1,0,0,1,1
12858,190946,NzGQ6qHi5I7oDznlM4iA1Evelv3MLoFE,SpATywNh6bZuzm8s1ceuBUnMUAeoAHHw,10,16,5,4,0,2,6,0,33,4.714285714285714,1,0.0,1,5,3,0,15,2,1,6,0,9,24,1
12859,190948,BwqiPFy1sDFuBLb3rSXiF0IO3CLelW7L,SpATywNh6bZuzm8s1ceuBUnMUAeoAHHw,14,14,5,16,2,13,8,4,62,8.857142857142858,2,0.0,8,5,14,2,6,13,2,8,4,29,33,1
12860,190950,9Yh9BGNzlB70iEC7VABYNXfepXjXz9Ik,bWdj2GDclj5ofokWjzoa5jAwMkxCykd6,4,2,0,0,0,3,4,0,9,1.2857142857142858,1,0.0,0,0,0,0,2,3,0,4,0,0,9,1
12861,190952,C4ydYZ7sRMBYk7EGihDGPeJUEQIdQEOw,SpATywNh6bZuzm8s1ceuBUnMUAeoAHHw,8,18,10,0,6,0,4,0,38,5.428571428571429,3,0.0,0,10,0,6,18,0,0,4,0,16,22,0
12862,190956,MBe2FxezhNNSk0O4l1Td85ufwdvtDvm8,SpATywNh6bZuzm8s1ceuBUnMUAeoAHHw,14,7,4,12,3,7,4,0,37,5.285714285714286,1,0.0,2,4,10,3,5,7,2,4,0,19,18,1
12863,190963,AilYGUB2b7U7u3L7JzReiarkucWyF0Uz,SpATywNh6bZuzm8s1ceuBUnMUAeoAHHw,2,0,0,0,0,0,4,0,4,0.5714285714285714,1,0.0,0,0,0,0,0,0,0,4,0,0,4,1
12864,190970,LLbWHvDvBPRMaeOD85m6rAaUvdLFucgj,bWdj2GDclj5ofokWjzoa5jAwMkxCykd6,3,0,0,0,0,0,4,0,4,0.5714285714285714,2,0.0,0,0,0,0,0,0,0,4,0,0,4,1
12865,190979,pMptAyZDeGXiIThstiLzNxB1KwRjAXpm,SpATywNh6bZuzm8s1ceuBUnMUAeoAHHw,1,0,0,0,0,0,1,0,1,0.14285714285714285,1,0.0,0,0,0,0,0,0,0,1,0,0,1,1
12866,190983,FiovvlFjZXQo41RA25FaJ17VJEgdj2le,SpATywNh6bZuzm8s1ceuBUnMUAeoAHHw,9,17,1,20,0,0,1,0,39,5.571428571428571,1,0.0,8,1,17,0,9,0,3,1,0,26,13,0
12867,191003,hupbjCOx448dHGDJQGqmUPOcvI9LWbzv,SpATywNh6bZuzm8s1ceuBUnMUAeoAHHw,4,2,1,0,0,7,3,0,13,1.8571428571428572,2,0.0,0,1,0,0,2,7,0,3,0,1,12,1
12868,191006,Q8nnFnGSO36eBGAiyp2wP0aveYg77DlE,G8EPVSXsOYB5YQWZGiz1aVq5Pgr2GrQu,5,6,1,0,2,1,2,0,12,1.7142857142857142,1,0.0,2,1,0,2,4,1,0,2,0,5,7,1
12869,191018,co3nb33nJ0Krxm21xnzLNxLQgo7GndnG,SpATywNh6bZuzm8s1ceuBUnMUAeoAHHw,1,0,0,0,0,0,1,0,1,0.14285714285714285,1,0.0,0,0,0,0,0,0,0,1,0,0,1,1
12870,191019,NCCp8fTS5s1iyttaNh3WkMeHCOcN3tb4,bWdj2GDclj5ofokWjzoa5jAwMkxCykd6,2,0,0,0,0,0,2,0,2,0.2857142857142857,1,0.0,0,0,0,0,0,0,0,2,0,0,2,1
12871,191021,nNXCDU7pCvXdQPycxWESwEGIIRWvHKWv,SpATywNh6bZuzm8s1ceuBUnMUAeoAHHw,3,2,1,0,0,0,1,0,4,0.5714285714285714,1,0.0,0,1,0,0,2,0,0,1,0,1,3,1
12872,191027,uFHm9PGn5yQICMVzgF44FzRtCVKrar2K,SpATywNh6bZuzm8s1ceuBUnMUAeoAHHw,7,2,1,0,1,1,4,0,9,1.2857142857142858,1,0.0,0,1,0,1,2,1,0,4,0,2,7,0
12873,191029,qSgfNAK24EhdWunFvzpQNvLLVkPV61Hr,A3fsA9Zfv1X2fVEQhTw51lKENdNrEqT3,1,0,0,0,0,0,1,0,1,0.14285714285714285,1,0.0,0,0,0,0,0,0,0,1,0,0,1,1
12874,191038,Sc510MM1IFPp0fhdgDOEyRVvZYZOxuoR,A3fsA9Zfv1X2fVEQhTw51lKENdNrEqT3,1,0,0,0,0,0,1,0,1,0.14285714285714285,1,0.0,0,0,0,0,0,0,0,1,0,0,1,1
12875,191041,trENMyltvkElnFRacDKrV1O2HLSxf35j,A3fsA9Zfv1X2fVEQhTw51lKENdNrEqT3,5,2,1,0,1,0,2,0,6,0.8571428571428571,2,0.0,0,1,0,1,2,0,0,2,0,2,4,1
12876,191050,Y3qAEqzdKJewEkb06n8n2BrJMQzX9urI,SpATywNh6bZuzm8s1ceuBUnMUAeoAHHw,15,13,5,19,3,7,6,1,54,7.714285714285714,1,0.0,8,5,16,3,5,7,3,6,1,32,22,1
12877,191063,nRHQUNRUIsIinoYx4tQlxNnAC0I3YYVk,G8EPVSXsOYB5YQWZGiz1aVq5Pgr2GrQu,41,59,33,88,16,0,11,5,212,30.285714285714285,1,0.0,20,33,75,16,39,0,13,11,5,144,68,1
12878,191064,yB2j2tPO2DVKCBBdsLv8a1lbHtfWINMh,bWdj2GDclj5ofokWjzoa5jAwMkxCykd6,1,0,0,0,0,0,1,0,1,0.14285714285714285,1,0.0,0,0,0,0,0,0,0,1,0,0,1,1
12879,191078,hjK9g2c0CglrLajBSxgIKqI54vivYEKM,SpATywNh6bZuzm8s1ceuBUnMUAeoAHHw,1,0,0,0,0,0,1,0,1,0.14285714285714285,1,0.0,0,0,0,0,0,0,0,1,0,0,1,1
12880,191102,etudbAO9CMrW6LcXYzcIWXUJFoLMbVh9,SpATywNh6bZuzm8s1ceuBUnMUAeoAHHw,10,5,3,0,2,9,5,1,25,3.5714285714285716,1,0.0,0,3,0,2,5,9,0,5,1,5,20,1
12881,191103,917C36aL5o1yjdcDTH5lZyAgXpc01Gk5,SpATywNh6bZuzm8s1ceuBUnMUAeoAHHw,4,2,0,0,0,1,2,1,6,0.8571428571428571,1,0.0,0,0,0,0,2,1,0,2,1,0,6,1
12882,191106,geEAXwfPbJ0MhEZG0COad1UptHNAilTd,bWdj2GDclj5ofokWjzoa5jAwMkxCykd6,2,0,0,0,0,0,2,0,2,0.2857142857142857,1,0.0,0,0,0,0,0,0,0,2,0,0,2,1
12883,191129,SHOQyzWMzeXzTVojp4arGhfbJLLjl3Lx,bWdj2GDclj5ofokWjzoa5jAwMkxCykd6,4,2,1,0,1,0,1,0,5,0.7142857142857143,1,0.0,0,1,0,1,2,0,0,1,0,2,3,1
12884,191131,HcFsEHTYadygQKRPBb3uDSEv8jpRHr6D,A3fsA9Zfv1X2fVEQhTw51lKENdNrEqT3,1,0,0,0,0,0,2,0,2,0.2857142857142857,1,0.0,0,0,0,0,0,0,0,2,0,0,2,1
12885,191132,deraFog8y0MjwcE23P6Rs0pGeytN3xmN,SpATywNh6bZuzm8s1ceuBUnMUAeoAHHw,9,11,0,0,0,2,14,4,31,4.428571428571429,1,0.0,0,0,0,0,11,2,0,14,4,0,31,1
12886,191135,OPQKWFr5Ag3gYEWW9i0rWdZ5Gc0wk3FB,SpATywNh6bZuzm8s1ceuBUnMUAeoAHHw,5,2,1,0,1,0,4,0,8,1.1428571428571428,1,0.0,0,1,0,1,2,0,0,4,0,2,6,1
12887,191143,KarP5JDxaA55wR1ThEFPoGYFsHmbBCZf,bWdj2GDclj5ofokWjzoa5jAwMkxCykd6,5,2,1,0,1,0,2,0,6,0.8571428571428571,1,0.0,0,1,0,1,2,0,0,2,0,2,4,1
12888,191147,21VuQSD13OpzBWnKCJ94z3vzUwy0J7cg,SpATywNh6bZuzm8s1ceuBUnMUAeoAHHw,9,7,3,0,0,0,5,1,16,2.2857142857142856,1,0.0,1,3,0,0,6,0,0,5,1,4,12,1
12889,191149,2KkJ2RPeYYnwpoBmLIbDX3SHVzQ9KAtd,SpATywNh6bZuzm8s1ceuBUnMUAeoAHHw,1,0,0,0,0,0,1,0,1,0.14285714285714285,1,0.0,0,0,0,0,0,0,0,1,0,0,1,1
12890,191155,S1LmT8vUaszGt2C5KVBW9KkkZ6u3e67K,SpATywNh6bZuzm8s1ceuBUnMUAeoAHHw,1,0,0,0,0,0,1,0,1,0.14285714285714285,1,0.0,0,0,0,0,0,0,0,1,0,0,1,1
12891,191165,XKiESHLmmxxFLSNhNTicMKXZo07ga8rR,bWdj2GDclj5ofokWjzoa5jAwMkxCykd6,2,0,0,0,0,0,2,0,2,0.2857142857142857,1,0.0,0,0,0,0,0,0,0,2,0,0,2,1
12892,191170,SfAUcZmUPYD4dsdFfOX7wSpg4mGcve5n,RXDvfPUBYFlVdlueBFbLW0mhhAyGEqpt,1,0,0,0,0,0,1,0,1,0.14285714285714285,1,0.0,0,0,0,0,0,0,0,1,0,0,1,1
12893,191179,wFv26V6AwzjCWPgCKpY50WBZiVw3xNw6,SpATywNh6bZuzm8s1ceuBUnMUAeoAHHw,7,4,3,0,3,0,2,0,12,1.7142857142857142,1,0.0,0,3,0,3,4,0,0,2,0,6,6,1
12894,191183,fXZkHvfRnLNWddfTwlt8RK2cRTiOmg3N,A3fsA9Zfv1X2fVEQhTw51lKENdNrEqT3,1,0,0,0,0,0,1,0,1,0.14285714285714285,1,0.0,0,0,0,0,0,0,0,1,0,0,1,1
12895,191190,aapkW8QMW8TztGeQlTnDfKEKcZX1vbn1,G8EPVSXsOYB5YQWZGiz1aVq5Pgr2GrQu,13,9,5,0,3,4,15,3,39,5.571428571428571,2,0.0,0,5,0,3,9,4,0,15,3,8,31,1
12896,191209,p8HUn53OHQxlBbPvpqicSSSkhMnoLuUk,A3fsA9Zfv1X2fVEQhTw51lKENdNrEqT3,1,0,0,0,0,0,1,0,1,0.14285714285714285,1,0.0,0,0,0,0,0,0,0,1,0,0,1,1
12897,191216,Rrclmw0iWTQ4R8VbZgEecyKPKpTh2o7K,SpATywNh6bZuzm8s1ceuBUnMUAeoAHHw,6,2,0,0,0,12,9,4,27,3.857142857142857,1,0.0,0,0,0,0,2,12,0,9,4,0,27,1
12898,191217,ecMZFfPrfYojsNqJQgwYc4hJSMzDZMZK,A3fsA9Zfv1X2fVEQhTw51lKENdNrEqT3,3,0,0,0,0,0,5,0,5,0.7142857142857143,2,0.0,0,0,0,0,0,0,0,5,0,0,5,1
12899,191224,3g91EUZkauWqcKpU9xr8zVzrn0H8G1A9,bWdj2GDclj5ofokWjzoa5jAwMkxCykd6,1,0,0,0,0,0,1,0,1,0.14285714285714285,1,0.0,0,0,0,0,0,0,0,1,0,0,1,1
12900,191240,z79FxI6IxKXksSKIwsXSYM1kOlaP8f6r,SpATywNh6bZuzm8s1ceuBUnMUAeoAHHw,4,5,0,0,0,0,1,0,6,0.8571428571428571,1,0.0,0,0,0,0,5,0,0,1,0,0,6,1
12901,191243,6lzjvaZGtQnKLrqzhDE3hBesO66bNsQN,SpATywNh6bZuzm8s1ceuBUnMUAeoAHHw,1,0,0,0,0,0,1,0,1,0.14285714285714285,1,0.0,0,0,0,0,0,0,0,1,0,0,1,1
12902,191248,Vl2QqZFE2XGfXDYVL2VXW5So0Zc5MScE,A3fsA9Zfv1X2fVEQhTw51lKENdNrEqT3,1,0,0,0,0,0,1,0,1,0.14285714285714285,1,0.0,0,0,0,0,0,0,0,1,0,0,1,1
12903,191266,eSnXFXUMyU3QpBQqVY71joco7MnEt79W,SpATywNh6bZuzm8s1ceuBUnMUAeoAHHw,8,5,1,0,1,0,2,0,9,1.2857142857142858,1,0.0,0,1,0,1,5,0,0,2,0,2,7,1
12904,191276,VFwcKDLRscQsLZ6sHhxlnjIEC63BsTj9,SpATywNh6bZuzm8s1ceuBUnMUAeoAHHw,5,5,0,0,0,0,1,0,6,0.8571428571428571,1,0.0,0,0,0,0,5,0,0,1,0,0,6,1
12905,191277,rqoGLMWp7ee8Ppu4OdHSBl6vmRxDZvKU,bWdj2GDclj5ofokWjzoa5jAwMkxCykd6,5,2,1,0,1,2,3,0,9,1.2857142857142858,1,0.0,0,1,0,1,2,2,0,3,0,2,7,1
12906,191282,ThbUQJBeO3JBYqtYMPK5UU7NNpR9FBno,SpATywNh6bZuzm8s1ceuBUnMUAeoAHHw,7,2,1,0,0,1,6,1,11,1.5714285714285714,1,0.0,0,1,0,0,2,1,0,6,1,1,10,1
12907,191294,bQTEZZd4jSi2B0W0A1TlEJEWBwzOd8zQ,SpATywNh6bZuzm8s1ceuBUnMUAeoAHHw,1,0,0,0,0,0,2,0,2,0.2857142857142857,1,0.0,0,0,0,0,0,0,0,2,0,0,2,1
12908,191295,kpqLFmJCsamYXFuknK3QXbLEc5jdZhta,RXDvfPUBYFlVdlueBFbLW0mhhAyGEqpt,1,0,0,0,0,0,1,0,1,0.14285714285714285,1,0.0,0,0,0,0,0,0,0,1,0,0,1,1
12909,191296,UfBZxbp3dHdvs4dmjpPF1a599SiVHfq9,SpATywNh6bZuzm8s1ceuBUnMUAeoAHHw,1,0,0,0,0,0,1,0,1,0.14285714285714285,1,0.0,0,0,0,0,0,0,0,1,0,0,1,1
12910,191301,UfBZxbp3dHdvs4dmjpPF1a599SiVHfq9,A3fsA9Zfv1X2fVEQhTw51lKENdNrEqT3,1,0,0,0,0,0,1,0,1,0.14285714285714285,1,0.0,0,0,0,0,0,0,0,1,0,0,1,0
12911,191326,bqKGVuyOqvCYIWLNoZkiDVBShCS1Solh,bWdj2GDclj5ofokWjzoa5jAwMkxCykd6,7,3,2,0,2,0,2,0,9,1.2857142857142858,1,0.0,0,2,0,2,3,0,0,2,0,4,5,1
12912,191328,d5HAnSQkztXQmCBt7mWJteYbuGp9eXK9,SpATywNh6bZuzm8s1ceuBUnMUAeoAHHw,17,11,5,16,3,1,6,1,43,6.142857142857143,1,0.0,4,5,13,3,7,1,3,6,1,25,18,0
12913,191333,u2lFPFqaHTPOsPVzurefGhIungrLsH3I,G8EPVSXsOYB5YQWZGiz1aVq5Pgr2GrQu,4,2,1,0,1,0,1,0,5,0.7142857142857143,1,0.0,0,1,0,1,2,0,0,1,0,2,3,1
12914,191336,2XCqRCsUPBJ1NAgHMrTgcxY6YdxrycrK,G8EPVSXsOYB5YQWZGiz1aVq5Pgr2GrQu,4,2,0,0,0,0,2,0,4,0.5714285714285714,1,0.0,0,0,0,0,2,0,0,2,0,0,4,1
12915,191348,SI69wwcTWVHmHvMK3iTZ6yjmoQxbU7l5,SpATywNh6bZuzm8s1ceuBUnMUAeoAHHw,10,12,0,22,0,8,5,1,48,6.857142857142857,1,0.0,6,0,20,0,6,8,2,5,1,26,22,1
12916,191352,9I8c8L7WQpD9ZtJRhVVfTlPNfkSlIEEb,SpATywNh6bZuzm8s1ceuBUnMUAeoAHHw,14,17,1,22,0,4,9,1,54,7.714285714285714,2,0.0,8,1,20,0,9,4,2,9,1,29,25,0
12917,191361,uvyVPWEsqLIlBRKFxrhWDmK1U2rKG8GE,SpATywNh6bZuzm8s1ceuBUnMUAeoAHHw,18,44,20,20,10,11,17,3,125,17.857142857142858,2,0.0,17,20,16,10,27,11,4,17,3,63,62,1
12918,191363,fayEZWE6L5NpkIRwMpEH7DP3Ho4nLIru,RXDvfPUBYFlVdlueBFbLW0mhhAyGEqpt,7,4,0,0,0,0,3,0,7,1.0,1,0.0,0,0,0,0,4,0,0,3,0,0,7,1
12919,191366,CRRYXyAc4ijr26PN9CuVczNnv8kJ91AK,SpATywNh6bZuzm8s1ceuBUnMUAeoAHHw,9,8,4,0,2,0,5,0,19,2.7142857142857144,1,0.0,2,4,0,2,6,0,0,5,0,8,11,1
12920,191379,Ieqd5itEcYJJN0R1exEtlEqnGZPAbCE6,bWdj2GDclj5ofokWjzoa5jAwMkxCykd6,4,3,1,0,1,0,1,0,6,0.8571428571428571,1,0.0,0,1,0,1,3,0,0,1,0,2,4,1
12921,191384,dmUrk0xMCS6SDyaouVCuyhAM6JJFFbys,SpATywNh6bZuzm8s1ceuBUnMUAeoAHHw,5,3,0,0,0,2,4,0,9,1.2857142857142858,1,0.0,0,0,0,0,3,2,0,4,0,0,9,1
12922,191389,smdC4Gk5L0XnGuMq4y1IOb0E2yVqYROb,SpATywNh6bZuzm8s1ceuBUnMUAeoAHHw,3,0,0,0,0,1,2,0,3,0.42857142857142855,1,0.0,0,0,0,0,0,1,0,2,0,0,3,1
12923,191398,ArHJamcmypPdkqgLXvwA7Xp8QRSvXxlF,SpATywNh6bZuzm8s1ceuBUnMUAeoAHHw,7,3,2,0,2,0,2,0,9,1.2857142857142858,1,0.0,0,2,0,2,3,0,0,2,0,4,5,1
12924,191409,uIv1Q8Ye5xXUaFW9tumYDZDxTsrCfpst,SpATywNh6bZuzm8s1ceuBUnMUAeoAHHw,1,0,0,0,0,0,1,0,1,0.14285714285714285,1,0.0,0,0,0,0,0,0,0,1,0,0,1,1
12925,191419,S4sULDuFAQWAEdmQxVT34py82agUl29W,bWdj2GDclj5ofokWjzoa5jAwMkxCykd6,6,1,1,0,1,0,3,0,6,0.8571428571428571,1,0.0,0,1,0,1,1,0,0,3,0,2,4,1
12926,191424,dnQdmZcm7uKA0vljQm6kJeP4CqW8fiMU,SpATywNh6bZuzm8s1ceuBUnMUAeoAHHw,5,2,1,0,1,0,2,0,6,0.8571428571428571,1,0.0,0,1,0,1,2,0,0,2,0,2,4,1
12927,191440,y1w3D4hQ1692TSq31BiNSwe5l2ooxLrJ,SpATywNh6bZuzm8s1ceuBUnMUAeoAHHw,7,2,1,0,1,0,4,0,8,1.1428571428571428,1,0.0,0,1,0,1,2,0,0,4,0,2,6,1
12928,191458,N9XRkzLdEnO1yDrNCc5jLvv7TriIRXAT,SpATywNh6bZuzm8s1ceuBUnMUAeoAHHw,9,4,2,0,1,0,8,1,16,2.2857142857142856,1,0.0,0,2,0,1,4,0,0,8,1,3,13,1
12929,191479,lcq8rKaAKyasaLAhf4XgwtdTDaLQpKXs,G8EPVSXsOYB5YQWZGiz1aVq5Pgr2GrQu,1,0,0,0,0,0,1,0,1,0.14285714285714285,1,0.0,0,0,0,0,0,0,0,1,0,0,1,1
12930,191482,qV9YvOiEawMvqxu18S9WhO9WLokOJG0e,SpATywNh6bZuzm8s1ceuBUnMUAeoAHHw,16,26,13,16,5,10,11,1,82,11.714285714285714,1,0.0,7,13,14,5,19,10,2,11,1,39,43,1
12931,191505,MRzfDn8Dt6xZQHTAuGEWQiuznoHxxpTX,G8EPVSXsOYB5YQWZGiz1aVq5Pgr2GrQu,1,0,0,0,0,0,1,0,1,0.14285714285714285,1,0.0,0,0,0,0,0,0,0,1,0,0,1,1
12932,191507,JIbJQhNgua4oE3gk86Jkguj8qmM444Gu,A3fsA9Zfv1X2fVEQhTw51lKENdNrEqT3,1,0,0,0,0,0,1,0,1,0.14285714285714285,1,0.0,0,0,0,0,0,0,0,1,0,0,1,1
12933,191531,zFJwABbnu7ecHOUlCE6eTmrBM1zbvMVg,SpATywNh6bZuzm8s1ceuBUnMUAeoAHHw,7,3,2,0,2,0,2,0,9,1.2857142857142858,1,0.0,0,2,0,2,3,0,0,2,0,4,5,1
12934,191534,wme4hkVddg0xzeatj2MinEZLWEQ5E7bR,SpATywNh6bZuzm8s1ceuBUnMUAeoAHHw,1,0,0,0,0,0,1,0,1,0.14285714285714285,1,0.0,0,0,0,0,0,0,0,1,0,0,1,1
12935,191545,xe9PdHtL47ijNdtrDmdC73RUGIc061NJ,SpATywNh6bZuzm8s1ceuBUnMUAeoAHHw,7,5,2,0,2,0,2,0,11,1.5714285714285714,1,0.0,0,2,0,2,5,0,0,2,0,4,7,1
12936,191560,lQY8mxQRqkTrX8U3ZBCC39fTp3ibXjgY,A3fsA9Zfv1X2fVEQhTw51lKENdNrEqT3,1,0,0,0,0,0,1,0,1,0.14285714285714285,1,0.0,0,0,0,0,0,0,0,1,0,0,1,1
12937,191562,LzUunErgfx3QBtzhgVcWGMItAqeQB5qb,bWdj2GDclj5ofokWjzoa5jAwMkxCykd6,10,20,7,44,8,0,16,0,95,13.571428571428571,2,0.0,3,7,42,8,17,0,2,16,0,60,35,1
12938,191570,8O8F8lqVhamnWAYoriozJh1JpqbQqAoe,SpATywNh6bZuzm8s1ceuBUnMUAeoAHHw,15,34,14,18,7,1,7,1,82,11.714285714285714,1,0.0,12,14,17,7,22,1,1,7,1,50,32,1
12939,191577,O9WtdqogfiBdd3zkscxK6K63kFz00EHp,SpATywNh6bZuzm8s1ceuBUnMUAeoAHHw,4,3,1,0,1,0,1,0,6,0.8571428571428571,1,0.0,0,1,0,1,3,0,0,1,0,2,4,1
12940,191578,BPpNiGtPp3VJWjhMdlZulJsFMsfFBZVO,SpATywNh6bZuzm8s1ceuBUnMUAeoAHHw,1,0,0,0,0,0,1,0,1,0.14285714285714285,1,0.0,0,0,0,0,0,0,0,1,0,0,1,1
12941,191579,ZP3SwNjKPikYYkMi8mCd8YXWyZ9QqocI,SpATywNh6bZuzm8s1ceuBUnMUAeoAHHw,15,13,6,16,5,0,6,0,46,6.571428571428571,1,0.0,6,6,13,5,7,0,3,6,0,30,16,1
12942,191585,7GKeqKRq8nTlHW07udIOaXEQQyokdI9X,G8EPVSXsOYB5YQWZGiz1aVq5Pgr2GrQu,12,9,5,6,5,0,2,0,27,3.857142857142857,1,0.0,3,5,3,5,6,0,3,2,0,16,11,1
12943,191591,PowQ1NVYMTVwKWPXrRw8LaXCisXsIuwA,SpATywNh6bZuzm8s1ceuBUnMUAeoAHHw,8,7,2,0,1,0,4,0,14,2.0,1,0.0,0,2,0,1,7,0,0,4,0,3,11,1
12944,191594,HaJu4RsCsmkTJbtFh34ypsakOUnNCikb,SpATywNh6bZuzm8s1ceuBUnMUAeoAHHw,1,0,0,0,0,0,1,0,1,0.14285714285714285,1,0.0,0,0,0,0,0,0,0,1,0,0,1,1
12945,191598,9Gr4ivUbGE9SyepAFZz19vI7kz7neHyv,SpATywNh6bZuzm8s1ceuBUnMUAeoAHHw,4,1,0,0,0,0,4,0,5,0.7142857142857143,1,0.0,0,0,0,0,1,0,0,4,0,0,5,1
12946,191608,K3reDywuca5r3zDnGu7WqoG47Og2VsxH,SpATywNh6bZuzm8s1ceuBUnMUAeoAHHw,8,10,5,0,2,1,12,0,30,4.285714285714286,1,0.0,0,5,0,2,10,1,0,12,0,7,23,0
12947,191621,01qQ2I7uJit5AcT5N3y2JZTjrStNpmSM,A3fsA9Zfv1X2fVEQhTw51lKENdNrEqT3,1,0,0,0,0,0,1,0,1,0.14285714285714285,1,0.0,0,0,0,0,0,0,0,1,0,0,1,1
12948,191628,WlHV3frRLxQmTIY14HccRXj4N1zg8F2y,bWdj2GDclj5ofokWjzoa5jAwMkxCykd6,1,0,0,0,0,0,1,0,1,0.14285714285714285,1,0.0,0,0,0,0,0,0,0,1,0,0,1,1
12949,191645,2m7SzUThbQ51vSBFUnCl1CYaMYSooUEI,bWdj2GDclj5ofokWjzoa5jAwMkxCykd6,4,2,1,0,1,0,1,0,5,0.7142857142857143,1,0.0,0,1,0,1,2,0,0,1,0,2,3,1
12950,191648,Xl3alXCSFw7Pm6L09eZSxygjyh6OTCwK,SpATywNh6bZuzm8s1ceuBUnMUAeoAHHw,7,4,2,0,2,1,2,0,11,1.5714285714285714,1,0.0,0,2,0,2,4,1,0,2,0,4,7,1
12951,191653,5MNPQvl4M43vX9Ck1VibapAl5kRKA0Ky,SpATywNh6bZuzm8s1ceuBUnMUAeoAHHw,5,3,1,0,1,0,1,0,6,0.8571428571428571,1,0.0,0,1,0,1,3,0,0,1,0,2,4,1
12952,191654,pOCc4XSnI7H8LGdDjvbS3fdE3PxuanE9,SpATywNh6bZuzm8s1ceuBUnMUAeoAHHw,4,2,1,0,1,2,2,0,8,1.1428571428571428,1,0.0,0,1,0,1,2,2,0,2,0,2,6,1
12953,191658,rrHRbXLg6i4u3JAIzGOFXJzGViekqHta,bWdj2GDclj5ofokWjzoa5jAwMkxCykd6,1,0,0,0,0,0,1,0,1,0.14285714285714285,1,0.0,0,0,0,0,0,0,0,1,0,0,1,1
12954,191667,jLTXtk76CIwYt4vY9Qrj5n40JdJeuHTk,SpATywNh6bZuzm8s1ceuBUnMUAeoAHHw,10,8,1,20,0,9,7,1,46,6.571428571428571,2,0.0,2,1,16,0,6,9,4,7,1,19,27,1
12955,191673,eEQqKnaUGHJzSnB7MrBGgZfDTYsV36xI,SpATywNh6bZuzm8s1ceuBUnMUAeoAHHw,5,2,1,0,1,0,2,0,6,0.8571428571428571,1,0.0,0,1,0,1,2,0,0,2,0,2,4,1
12956,191681,poTjed6dzFzOdJfGIhM72y1g95A9uYj5,SpATywNh6bZuzm8s1ceuBUnMUAeoAHHw,4,2,1,0,1,0,1,0,5,0.7142857142857143,1,0.0,0,1,0,1,2,0,0,1,0,2,3,1
12957,191683,hzmNiaPcq2EodwDNxyNnOX6tvxR9MJ1N,SpATywNh6bZuzm8s1ceuBUnMUAeoAHHw,5,2,1,0,1,0,2,0,6,0.8571428571428571,1,0.0,0,1,0,1,2,0,0,2,0,2,4,1
12958,191684,voXAnjlRro0uKeE7Bhzlc3B8ctN5va8G,A3fsA9Zfv1X2fVEQhTw51lKENdNrEqT3,1,0,0,0,0,0,1,0,1,0.14285714285714285,1,0.0,0,0,0,0,0,0,0,1,0,0,1,1
12959,191689,KNNMSW3oLxGqEqv2czanNkhQgdUkOWgY,SpATywNh6bZuzm8s1ceuBUnMUAeoAHHw,1,0,0,0,0,0,1,0,1,0.14285714285714285,1,0.0,0,0,0,0,0,0,0,1,0,0,1,1
12960,191694,WpYtemwKZQxcuLGpndx0lQojfh6o5GOv,A3fsA9Zfv1X2fVEQhTw51lKENdNrEqT3,1,0,0,0,0,0,1,0,1,0.14285714285714285,1,0.0,0,0,0,0,0,0,0,1,0,0,1,1
12961,191705,GfTG7Jl5LqR9ys6qGsGxQl3P09Y2SKWt,SpATywNh6bZuzm8s1ceuBUnMUAeoAHHw,6,4,1,0,1,0,2,0,8,1.1428571428571428,1,0.0,0,1,0,1,4,0,0,2,0,2,6,1
12962,191718,eIW9M0Trkt0EiuTzN2HuEtF6QnUOm4E9,G8EPVSXsOYB5YQWZGiz1aVq5Pgr2GrQu,1,0,0,0,0,0,1,0,1,0.14285714285714285,1,0.0,0,0,0,0,0,0,0,1,0,0,1,1
12963,191719,KFU9DDalEkLY57CnYLljzPh20kfkJgg1,SpATywNh6bZuzm8s1ceuBUnMUAeoAHHw,1,0,0,0,0,0,3,0,3,0.42857142857142855,1,0.0,0,0,0,0,0,0,0,3,0,0,3,1
12964,191736,7891kkT0UkgzTiNar1WxxiRFlwbJEBnB,SpATywNh6bZuzm8s1ceuBUnMUAeoAHHw,10,24,10,3,5,0,2,0,44,6.285714285714286,1,0.0,5,10,3,5,19,0,0,2,0,23,21,1
12965,191746,Yy2T8AQun3h4tOt3dyFcuzCw5XOF0cCp,SpATywNh6bZuzm8s1ceuBUnMUAeoAHHw,1,0,0,0,0,0,2,0,2,0.2857142857142857,1,0.0,0,0,0,0,0,0,0,2,0,0,2,1
12966,191756,Nw8BNhwzOdO3iOxqT3HR1nBiyOtFleo0,SpATywNh6bZuzm8s1ceuBUnMUAeoAHHw,1,0,0,0,0,0,1,0,1,0.14285714285714285,1,0.0,0,0,0,0,0,0,0,1,0,0,1,1
12967,191760,xdfT7UfbG0ewFi6FNN3zlNGBGpobyBrO,RXDvfPUBYFlVdlueBFbLW0mhhAyGEqpt,6,6,0,0,0,0,5,2,13,1.8571428571428572,1,0.0,0,0,0,0,6,0,0,5,2,0,13,1
12968,191773,LuPgMCIdX2ugHzDAngaEsA394qOat0id,A3fsA9Zfv1X2fVEQhTw51lKENdNrEqT3,11,10,5,0,1,0,6,0,22,3.142857142857143,2,0.0,0,5,0,1,10,0,0,6,0,6,16,1
12969,191798,HsUrz2Tvq8sRzoPDsx1zZZFVKu21a9Fj,A3fsA9Zfv1X2fVEQhTw51lKENdNrEqT3,1,0,0,0,0,0,1,0,1,0.14285714285714285,1,0.0,0,0,0,0,0,0,0,1,0,0,1,1
12970,191799,sxhiQuS3HfySJYy4LOfQjplyCzgTKScO,SpATywNh6bZuzm8s1ceuBUnMUAeoAHHw,7,8,4,0,0,0,6,3,21,3.0,1,0.0,0,4,0,0,8,0,0,6,3,4,17,1
12971,191802,kadlP2QWuFIFKLOUJo5sW8v7B7XAv9LQ,SpATywNh6bZuzm8s1ceuBUnMUAeoAHHw,5,3,1,0,1,0,2,0,7,1.0,1,0.0,0,1,0,1,3,0,0,2,0,2,5,1
12972,191804,MU4dVyJTD7iIRSTZIdJZ9VoLOxogfKQN,bWdj2GDclj5ofokWjzoa5jAwMkxCykd6,2,0,0,0,0,0,2,0,2,0.2857142857142857,1,0.0,0,0,0,0,0,0,0,2,0,0,2,1
12973,191808,QhgZ8WnXOcD5WE8AKIXP6yesa48bioAv,G8EPVSXsOYB5YQWZGiz1aVq5Pgr2GrQu,1,0,0,0,0,0,1,0,1,0.14285714285714285,1,0.0,0,0,0,0,0,0,0,1,0,0,1,1
12974,191812,glVCC77LfitTkPbkpypiclvPPbAnhs5Z,SpATywNh6bZuzm8s1ceuBUnMUAeoAHHw,1,0,0,0,0,0,1,0,1,0.14285714285714285,1,0.0,0,0,0,0,0,0,0,1,0,0,1,1
12975,191821,IERsxa1qtpNEp0IX6fqnPIs58eKAo4jM,RXDvfPUBYFlVdlueBFbLW0mhhAyGEqpt,3,2,1,0,0,0,1,0,4,0.5714285714285714,1,0.0,0,1,0,0,2,0,0,1,0,1,3,1
12976,191834,xFQWFF18peOPGJbc58SGDlEI5nMMZqZ4,SpATywNh6bZuzm8s1ceuBUnMUAeoAHHw,16,11,4,19,3,1,6,1,45,6.428571428571429,1,0.0,6,4,17,3,5,1,2,6,1,30,15,1
12977,191845,HL02PKMnOIDdiDp79NgTxbZJpjcKEWWT,SpATywNh6bZuzm8s1ceuBUnMUAeoAHHw,5,5,1,0,1,0,1,0,8,1.1428571428571428,1,0.0,0,1,0,1,5,0,0,1,0,2,6,1
12978,191893,F90BMBHCwVLSbJKgbHhGlOavE20yEHNs,SpATywNh6bZuzm8s1ceuBUnMUAeoAHHw,7,1,1,0,1,1,4,1,9,1.2857142857142858,1,0.0,0,1,0,1,1,1,0,4,1,2,7,1
12979,191919,eh0y0gctBGer07yOzwET1ULsjXcAMiHK,A3fsA9Zfv1X2fVEQhTw51lKENdNrEqT3,1,0,0,0,0,0,1,0,1,0.14285714285714285,1,0.0,0,0,0,0,0,0,0,1,0,0,1,1
12980,191927,e7i4vctFK9ije7n1OkadHlIYbLm8AOao,A3fsA9Zfv1X2fVEQhTw51lKENdNrEqT3,1,0,0,0,0,0,1,0,1,0.14285714285714285,1,0.0,0,0,0,0,0,0,0,1,0,0,1,1
12981,191930,Y0uNzgYoq3o4UIUWA7DyI9uIWevNL2UZ,SpATywNh6bZuzm8s1ceuBUnMUAeoAHHw,1,0,0,0,0,0,1,0,1,0.14285714285714285,1,0.0,0,0,0,0,0,0,0,1,0,0,1,1
12982,191936,pVHJZ63Y7JdfMuJUTvroL7qbSGOfkgFO,SpATywNh6bZuzm8s1ceuBUnMUAeoAHHw,1,0,0,0,0,0,1,0,1,0.14285714285714285,1,0.0,0,0,0,0,0,0,0,1,0,0,1,1
12983,191946,X14gKVD1ZKu0qL0NchpqxwhoYSEpz9QI,A3fsA9Zfv1X2fVEQhTw51lKENdNrEqT3,1,0,0,0,0,0,1,0,1,0.14285714285714285,1,0.0,0,0,0,0,0,0,0,1,0,0,1,1
12984,191949,5nY7bkwDkC2HlVFlWmyBFJRNx9a0SeRf,SpATywNh6bZuzm8s1ceuBUnMUAeoAHHw,6,6,2,0,1,0,2,0,11,1.5714285714285714,1,0.0,2,2,0,1,4,0,0,2,0,5,6,1
12985,191957,q8qv4J0WokPksYuUIg2pKKJs5I4YE8LL,bWdj2GDclj5ofokWjzoa5jAwMkxCykd6,7,5,3,0,1,0,4,0,13,1.8571428571428572,1,0.0,0,3,0,1,5,0,0,4,0,4,9,1
12986,191961,XirdNKPxR3QK6AqsS5xwiQuah55CHklz,SpATywNh6bZuzm8s1ceuBUnMUAeoAHHw,6,4,1,0,1,0,2,0,8,1.1428571428571428,1,0.0,0,1,0,1,4,0,0,2,0,2,6,1
12987,191970,guhTAC2wGHeGVbnCgc8qjrM4m2j0yBgB,bWdj2GDclj5ofokWjzoa5jAwMkxCykd6,7,5,2,0,3,0,3,0,13,1.8571428571428572,1,0.0,2,2,0,3,3,0,0,3,0,7,6,1
12988,191977,ECkqmAuIkv3ncN9wNJby8oOn15qTd9kR,SpATywNh6bZuzm8s1ceuBUnMUAeoAHHw,3,2,0,0,0,0,4,0,6,0.8571428571428571,2,0.0,0,0,0,0,2,0,0,4,0,0,6,1
12989,191981,1kpLB0DAS1b0ejanJYSedd5z8Kef2r9d,SpATywNh6bZuzm8s1ceuBUnMUAeoAHHw,6,5,3,0,2,0,3,0,13,1.8571428571428572,2,0.0,0,3,0,2,5,0,0,3,0,5,8,1
12990,191987,guhTAC2wGHeGVbnCgc8qjrM4m2j0yBgB,A3fsA9Zfv1X2fVEQhTw51lKENdNrEqT3,20,11,8,0,5,2,8,1,35,5.0,2,0.0,0,8,0,5,11,2,0,8,1,13,22,0
12991,191992,LW6zzfd6Z7RUZZtZGyYDx5y4SX3cBpdo,SpATywNh6bZuzm8s1ceuBUnMUAeoAHHw,4,6,0,0,0,0,3,0,9,1.2857142857142858,1,0.0,0,0,0,0,6,0,0,3,0,0,9,1
12992,192004,E3N8Ml469xlgFPJmAY5Sxe1V7qT3zvY6,SpATywNh6bZuzm8s1ceuBUnMUAeoAHHw,5,2,1,0,1,0,2,0,6,0.8571428571428571,1,0.0,0,1,0,1,2,0,0,2,0,2,4,1
12993,192005,co2tEDTUQOPBlFecfyW4CBakQdUodp0x,A3fsA9Zfv1X2fVEQhTw51lKENdNrEqT3,1,0,0,0,0,0,1,0,1,0.14285714285714285,1,0.0,0,0,0,0,0,0,0,1,0,0,1,1
12994,192010,tAelht5FQdpcbtZQoKgvZA90XQy6zeRb,SpATywNh6bZuzm8s1ceuBUnMUAeoAHHw,1,0,0,0,0,0,1,0,1,0.14285714285714285,1,0.0,0,0,0,0,0,0,0,1,0,0,1,1
12995,192012,br6ITMcvmAAwree2VNmUR9deXubPoM9q,G8EPVSXsOYB5YQWZGiz1aVq5Pgr2GrQu,3,0,0,0,0,0,3,0,3,0.42857142857142855,1,0.0,0,0,0,0,0,0,0,3,0,0,3,1
12996,192018,eotRm6Y2SbyKhVlLkGLDzSxdsKqSBO9y,SpATywNh6bZuzm8s1ceuBUnMUAeoAHHw,6,3,2,0,2,0,1,0,8,1.1428571428571428,1,0.0,0,2,0,2,3,0,0,1,0,4,4,1
12997,192024,Q12SmIgxAUIk1yKqjdfp0LXtJMgJdL9G,SpATywNh6bZuzm8s1ceuBUnMUAeoAHHw,6,3,2,0,2,0,1,0,8,1.1428571428571428,1,0.0,0,2,0,2,3,0,0,1,0,4,4,1
12998,192034,6BEGVp3lU36uMYUemMIuUfA5VThOFY5Z,SpATywNh6bZuzm8s1ceuBUnMUAeoAHHw,3,2,0,0,0,0,1,0,3,0.42857142857142855,1,0.0,0,0,0,0,2,0,0,1,0,0,3,0
12999,192039,JuuQdyakOE1dmJoAhQzVgyBgj45A1hjb,G8EPVSXsOYB5YQWZGiz1aVq5Pgr2GrQu,6,2,1,0,1,0,3,0,7,1.0,1,0.0,0,1,0,1,2,0,0,3,0,2,5,1
13000,192050,dQYdXrn6Y9f5Ts4mUHKMqkz2QoUbyo9u,SpATywNh6bZuzm8s1ceuBUnMUAeoAHHw,10,16,7,0,0,1,6,1,31,4.428571428571429,1,0.0,6,7,0,0,10,1,0,6,1,13,18,1
13001,192058,rv4ArbR8ug8w4z8sISrvrxALsLkp46Ty,bWdj2GDclj5ofokWjzoa5jAwMkxCykd6,6,23,0,0,0,0,5,0,28,4.0,1,0.0,4,0,0,0,19,0,0,5,0,4,24,1
13002,192065,FaNPo4Qqcy5TdmFUv8WUTRgDMV0ZgbCp,RXDvfPUBYFlVdlueBFbLW0mhhAyGEqpt,19,10,7,22,5,0,2,0,46,6.571428571428571,1,0.0,2,7,20,5,8,0,2,2,0,34,12,1
13003,192091,dmhkL35doRyRiXlb3XuDnJlpO05GLvg1,SpATywNh6bZuzm8s1ceuBUnMUAeoAHHw,4,3,1,0,1,0,2,0,7,1.0,1,0.0,0,1,0,1,3,0,0,2,0,2,5,1
13004,192098,LTXDIL613XcTInp5rf7qYUY6DFOgTe7d,G8EPVSXsOYB5YQWZGiz1aVq5Pgr2GrQu,6,4,1,0,2,0,7,0,14,2.0,1,0.0,2,1,0,2,2,0,0,7,0,5,9,0
13005,192109,BlzehVS9w06tJmaZKz9FlNz9VFUjaNUH,G8EPVSXsOYB5YQWZGiz1aVq5Pgr2GrQu,5,2,0,0,0,0,3,0,5,0.7142857142857143,1,0.0,0,0,0,0,2,0,0,3,0,0,5,1
13006,192117,TiNNJ9dGwnc8LtrTW4Oq8UzJGxXCWpRS,A3fsA9Zfv1X2fVEQhTw51lKENdNrEqT3,1,0,0,0,0,0,1,0,1,0.14285714285714285,1,0.0,0,0,0,0,0,0,0,1,0,0,1,1
13007,192125,PhoKgDlJTLmZpXJ7XlrprWN3ANMNNAAs,SpATywNh6bZuzm8s1ceuBUnMUAeoAHHw,7,3,1,0,1,0,5,0,10,1.4285714285714286,1,0.0,0,1,0,1,3,0,0,5,0,2,8,1
13008,192134,vsDIa2pTzMsANsuFnkRlfs0CNdNFRShO,bWdj2GDclj5ofokWjzoa5jAwMkxCykd6,1,0,0,0,0,0,1,0,1,0.14285714285714285,1,0.0,0,0,0,0,0,0,0,1,0,0,1,1
13009,192141,vsDIa2pTzMsANsuFnkRlfs0CNdNFRShO,RXDvfPUBYFlVdlueBFbLW0mhhAyGEqpt,1,0,0,0,0,0,1,0,1,0.14285714285714285,1,0.0,0,0,0,0,0,0,0,1,0,0,1,1
13010,192147,luNGlNTmJ26UVXohAPNf4yZNgIUDcpxK,RXDvfPUBYFlVdlueBFbLW0mhhAyGEqpt,1,0,0,0,0,0,1,0,1,0.14285714285714285,1,0.0,0,0,0,0,0,0,0,1,0,0,1,1
13011,192149,kz806LJqSjCWsOsMbb4QF8SkTWd8OARr,bWdj2GDclj5ofokWjzoa5jAwMkxCykd6,5,2,0,0,0,0,9,0,11,1.5714285714285714,1,0.0,0,0,0,0,2,0,0,9,0,0,11,1
13012,192150,luNGlNTmJ26UVXohAPNf4yZNgIUDcpxK,A3fsA9Zfv1X2fVEQhTw51lKENdNrEqT3,1,0,0,0,0,0,1,0,1,0.14285714285714285,1,0.0,0,0,0,0,0,0,0,1,0,0,1,1
13013,192176,UAWEvfipqNVrtAY7A1ItWPIZCE9n4bC0,A3fsA9Zfv1X2fVEQhTw51lKENdNrEqT3,1,0,0,0,0,0,1,0,1,0.14285714285714285,1,0.0,0,0,0,0,0,0,0,1,0,0,1,1
13014,192185,REBUdT3PdwenVsbHSd8vx9j28veewpFY,G8EPVSXsOYB5YQWZGiz1aVq5Pgr2GrQu,1,0,0,0,0,0,3,0,3,0.42857142857142855,1,0.0,0,0,0,0,0,0,0,3,0,0,3,1
13015,192186,JQ24AQoZsOQkDbcWerb6XGxtCwcxcjqd,SpATywNh6bZuzm8s1ceuBUnMUAeoAHHw,4,2,0,0,0,0,2,0,4,0.5714285714285714,1,0.0,0,0,0,0,2,0,0,2,0,0,4,1
13016,192194,lHTZAvBbd0zcUoZ0ZCqy0WxYTp3sveXN,SpATywNh6bZuzm8s1ceuBUnMUAeoAHHw,3,2,0,0,0,0,1,0,3,0.42857142857142855,1,0.0,0,0,0,0,2,0,0,1,0,0,3,1
13017,192209,Qws7jSORIWaamW2WkksSfXYG3Zz7g3Xb,SpATywNh6bZuzm8s1ceuBUnMUAeoAHHw,5,2,1,0,1,0,3,0,7,1.0,1,0.0,0,1,0,1,2,0,0,3,0,2,5,1
13018,192216,WqVnvIDeqK0FV6SVy7LE13jQheJAXDUI,SpATywNh6bZuzm8s1ceuBUnMUAeoAHHw,6,3,0,0,1,0,2,0,6,0.8571428571428571,1,0.0,0,0,0,1,3,0,0,2,0,1,5,1
13019,192217,AcQwcLzGnWU6HJG1JegBGJmpymCdTsiJ,SpATywNh6bZuzm8s1ceuBUnMUAeoAHHw,1,0,0,0,0,0,1,0,1,0.14285714285714285,1,0.0,0,0,0,0,0,0,0,1,0,0,1,1
13020,192223,DtCbpRVw6ZPHzvqt3yEtockBy9bOvWMU,SpATywNh6bZuzm8s1ceuBUnMUAeoAHHw,15,31,9,18,5,0,3,0,66,9.428571428571429,1,0.0,13,9,16,5,18,0,2,3,0,43,23,1
13021,192225,RFIYCucE5KCs9Bz4puoVDGPVmKoCQR4H,SpATywNh6bZuzm8s1ceuBUnMUAeoAHHw,1,0,0,0,0,0,1,0,1,0.14285714285714285,1,0.0,0,0,0,0,0,0,0,1,0,0,1,1
13022,192230,SMcFR1tzrGAErGanrAOTaiQacFJ5UscL,SpATywNh6bZuzm8s1ceuBUnMUAeoAHHw,6,2,1,0,1,0,3,1,8,1.1428571428571428,1,0.0,0,1,0,1,2,0,0,3,1,2,6,1
13023,192233,Av0so8JeZkL37S3USay6JyAc2H9w3WcS,SpATywNh6bZuzm8s1ceuBUnMUAeoAHHw,8,8,1,0,1,0,2,0,12,1.7142857142857142,1,0.0,1,1,0,1,7,0,0,2,0,3,9,1
13024,192236,4WRiJt7yDLRdAnLXyL07imUb9PD066er,SpATywNh6bZuzm8s1ceuBUnMUAeoAHHw,7,1,1,0,1,1,9,3,16,2.2857142857142856,2,0.0,0,1,0,1,1,1,0,9,3,2,14,1
13025,192247,HR02YAHzGFr2hdShoIiTumT2tyoMXoiF,SpATywNh6bZuzm8s1ceuBUnMUAeoAHHw,7,5,0,0,0,0,5,1,11,1.5714285714285714,2,0.0,0,0,0,0,5,0,0,5,1,0,11,1
13026,192248,Qb1CgQ8SxoQQTE8swhxPBVi0nI23eAzb,bWdj2GDclj5ofokWjzoa5jAwMkxCykd6,11,21,9,16,6,1,6,1,60,8.571428571428571,2,0.0,3,9,16,6,18,1,0,6,1,34,26,1
13027,192253,HTVs7V0e4g4fF28WOVqp2vXklALtMpIX,RXDvfPUBYFlVdlueBFbLW0mhhAyGEqpt,1,0,0,0,0,0,1,0,1,0.14285714285714285,1,0.0,0,0,0,0,0,0,0,1,0,0,1,1
13028,192265,NE6VVAXhm16C7ZaHLYFeGaAbJXqSbS5P,SpATywNh6bZuzm8s1ceuBUnMUAeoAHHw,1,0,0,0,0,0,1,0,1,0.14285714285714285,1,0.0,0,0,0,0,0,0,0,1,0,0,1,1
13029,192272,AE77uBYkDOA4olq3PELAlnphtU2v0TDL,A3fsA9Zfv1X2fVEQhTw51lKENdNrEqT3,1,0,0,0,0,0,1,0,1,0.14285714285714285,1,0.0,0,0,0,0,0,0,0,1,0,0,1,1
13030,192281,oOq0KGCcuj3zSTyAkLmOA3bz1mpT4Cy2,SpATywNh6bZuzm8s1ceuBUnMUAeoAHHw,1,0,0,0,0,0,1,0,1,0.14285714285714285,1,0.0,0,0,0,0,0,0,0,1,0,0,1,1
13031,192285,DanoP5XpHODQZmwuFGZgNKBiu5nY9yH1,RXDvfPUBYFlVdlueBFbLW0mhhAyGEqpt,6,5,4,0,2,0,1,0,12,1.7142857142857142,1,0.0,0,4,0,2,5,0,0,1,0,6,6,1
13032,192293,k0fNZidBUd2gbryk31YveUTLLwvsjsHF,A3fsA9Zfv1X2fVEQhTw51lKENdNrEqT3,1,0,0,0,0,0,1,0,1,0.14285714285714285,1,0.0,0,0,0,0,0,0,0,1,0,0,1,1
13033,192300,4YD7ENfnhFTRFL7ILKgGgEPnhlw4hbFM,SpATywNh6bZuzm8s1ceuBUnMUAeoAHHw,6,3,1,0,1,0,2,0,7,1.0,1,0.0,0,1,0,1,3,0,0,2,0,2,5,1
13034,192306,ypGCuSMoTu4jFEklb1OmiXvUyZSt3GFy,A3fsA9Zfv1X2fVEQhTw51lKENdNrEqT3,1,0,0,0,0,0,1,0,1,0.14285714285714285,1,0.0,0,0,0,0,0,0,0,1,0,0,1,1
13035,192308,5Vw6FQuIrDyG4P6UKq7rbidOHP4recgB,SpATywNh6bZuzm8s1ceuBUnMUAeoAHHw,1,0,0,0,0,0,1,0,1,0.14285714285714285,1,0.0,0,0,0,0,0,0,0,1,0,0,1,1
13036,192310,pr4S9UwIGe9A49oNuW5UlWpQYB2ZSYV0,SpATywNh6bZuzm8s1ceuBUnMUAeoAHHw,2,0,0,0,0,0,2,0,2,0.2857142857142857,1,0.0,0,0,0,0,0,0,0,2,0,0,2,1
13037,192329,SgmklvgEB9LRwbyM7mjtFwPn2s1gjHGn,A3fsA9Zfv1X2fVEQhTw51lKENdNrEqT3,1,0,0,0,0,0,1,0,1,0.14285714285714285,1,0.0,0,0,0,0,0,0,0,1,0,0,1,1
13038,192356,3T8jD055VA7hJ3tuRSbjf4ntse0zAX7A,bWdj2GDclj5ofokWjzoa5jAwMkxCykd6,8,15,4,0,2,1,8,1,31,4.428571428571429,1,0.0,6,4,0,2,9,1,0,8,1,12,19,1
13039,192365,ooAUGXFOFAguQ9s1QlStBjM610gDeFBk,bWdj2GDclj5ofokWjzoa5jAwMkxCykd6,8,7,4,0,3,0,3,0,17,2.4285714285714284,1,0.0,0,4,0,3,7,0,0,3,0,7,10,1
13040,192376,JuG3mNYUQgxAVzPcc7Ar48FfL6xAPMUZ,SpATywNh6bZuzm8s1ceuBUnMUAeoAHHw,6,6,1,0,1,0,2,0,10,1.4285714285714286,1,0.0,3,1,0,1,3,0,0,2,0,5,5,1
13041,192381,cfgt4lcsD0BLDwVvHK3CK5jqeK8KZQhZ,SpATywNh6bZuzm8s1ceuBUnMUAeoAHHw,8,2,1,0,1,2,5,2,13,1.8571428571428572,1,0.0,0,1,0,1,2,2,0,5,2,2,11,1
13042,192384,eGRaiLXqwboqQlaTTQYr1FB1cM61jV4I,RXDvfPUBYFlVdlueBFbLW0mhhAyGEqpt,2,0,0,0,0,0,2,0,2,0.2857142857142857,1,0.0,0,0,0,0,0,0,0,2,0,0,2,1
13043,192402,waC8kf8PXJ6GslXvkly6fK7T4isyWaN7,bWdj2GDclj5ofokWjzoa5jAwMkxCykd6,11,6,4,0,3,3,8,1,25,3.5714285714285716,2,0.0,0,4,0,3,6,3,0,8,1,7,18,1
13044,192404,FmxPauZCcN5TsI90By7Uh5tN8Q2Qo10j,A3fsA9Zfv1X2fVEQhTw51lKENdNrEqT3,1,0,0,0,0,0,2,0,2,0.2857142857142857,1,0.0,0,0,0,0,0,0,0,2,0,0,2,1
13045,192407,RVzC5vQBqN30AW6Su7sjAfdP0iWczm3N,G8EPVSXsOYB5YQWZGiz1aVq5Pgr2GrQu,13,8,5,0,3,0,9,0,25,3.5714285714285716,1,0.0,0,5,0,3,8,0,0,9,0,8,17,1
13046,192413,1StpqFExawTnYrEXKci6A5cFxEzx53P4,RXDvfPUBYFlVdlueBFbLW0mhhAyGEqpt,3,3,1,0,0,0,1,0,5,0.7142857142857143,1,0.0,0,1,0,0,3,0,0,1,0,1,4,1
13047,192425,GyLB5V57I2KbnfFgZclSqyQAUY6eRpjt,bWdj2GDclj5ofokWjzoa5jAwMkxCykd6,1,0,0,0,0,0,1,0,1,0.14285714285714285,1,0.0,0,0,0,0,0,0,0,1,0,0,1,1
13048,192426,o4zmJwxCaOlZRS6sjq7iHLRJ7DThOMe1,G8EPVSXsOYB5YQWZGiz1aVq5Pgr2GrQu,7,5,1,0,1,0,2,0,9,1.2857142857142858,1,0.0,0,1,0,1,5,0,0,2,0,2,7,1
13049,192431,OZzcwN4ObB1Nk33MS2zCa76PywvXNHRC,SpATywNh6bZuzm8s1ceuBUnMUAeoAHHw,5,5,1,0,1,0,1,0,8,1.1428571428571428,1,0.0,0,1,0,1,5,0,0,1,0,2,6,1
13050,192434,c1BXmJNemroOPh6WUefTBD28s2WzSNwi,G8EPVSXsOYB5YQWZGiz1aVq5Pgr2GrQu,1,0,0,0,0,0,1,0,1,0.14285714285714285,1,0.0,0,0,0,0,0,0,0,1,0,0,1,1
13051,192441,s1qTQc7ciJLP829kxDx1Q2usdHCCY2Ax,SpATywNh6bZuzm8s1ceuBUnMUAeoAHHw,2,0,0,0,0,0,2,0,2,0.2857142857142857,1,0.0,0,0,0,0,0,0,0,2,0,0,2,1
13052,192449,IihMsyE33bR2W1CinvLERaFEike0N1tI,SpATywNh6bZuzm8s1ceuBUnMUAeoAHHw,1,0,0,0,0,0,1,0,1,0.14285714285714285,1,0.0,0,0,0,0,0,0,0,1,0,0,1,1
13053,192450,fm4PPCUPLg6L0eK2GymW6alb9TJFqvnn,SpATywNh6bZuzm8s1ceuBUnMUAeoAHHw,1,0,0,0,0,0,1,0,1,0.14285714285714285,1,0.0,0,0,0,0,0,0,0,1,0,0,1,1
13054,192464,FnLRbhWfyqv6yBzd4jhbaUJyw3LJoL3p,SpATywNh6bZuzm8s1ceuBUnMUAeoAHHw,1,0,0,0,0,0,1,0,1,0.14285714285714285,1,0.0,0,0,0,0,0,0,0,1,0,0,1,0
13055,192468,XKJKqrTlrk5aKXeVOrE6ycEvLm3u912L,SpATywNh6bZuzm8s1ceuBUnMUAeoAHHw,1,0,0,0,0,0,1,0,1,0.14285714285714285,1,0.0,0,0,0,0,0,0,0,1,0,0,1,1
13056,192471,D2lFXeOodglgSTRNVccRvVrNvHlYgfLJ,SpATywNh6bZuzm8s1ceuBUnMUAeoAHHw,1,0,0,0,0,0,1,0,1,0.14285714285714285,1,0.0,0,0,0,0,0,0,0,1,0,0,1,1
13057,192474,cRUmHDnCm3xvppfYUcJkwRqBBl5OBCgi,SpATywNh6bZuzm8s1ceuBUnMUAeoAHHw,1,0,0,0,0,0,1,0,1,0.14285714285714285,1,0.0,0,0,0,0,0,0,0,1,0,0,1,1
13058,193458,YerAIqIks5QGT3cyYvkkT2PQJt80wdlv,bWdj2GDclj5ofokWjzoa5jAwMkxCykd6,3,2,0,0,0,0,1,0,3,0.42857142857142855,1,0.0,0,0,0,0,2,0,0,1,0,0,3,1
13059,193466,zoOHCo5ZSJYPyewUp3ZVEkAmNnY7HYHv,SpATywNh6bZuzm8s1ceuBUnMUAeoAHHw,8,5,3,0,3,0,3,0,14,2.0,1,0.0,0,3,0,3,5,0,0,3,0,6,8,1
13060,193475,GmYDZTMhI5TgBC2IOLdvnmJEf5uX4LR3,bWdj2GDclj5ofokWjzoa5jAwMkxCykd6,14,15,9,0,8,0,5,0,37,5.285714285714286,1,0.0,2,9,0,8,13,0,0,5,0,19,18,1
13061,193480,13q6Q2ftAOPzmfv0eOg5HLLohXKvBJn0,G8EPVSXsOYB5YQWZGiz1aVq5Pgr2GrQu,39,32,17,90,5,0,6,0,150,21.428571428571427,1,0.0,1,17,74,5,31,0,16,6,0,97,53,1
13062,193491,eDVRcT3oA39R4stYZnLSVwEtXbMKHF03,SpATywNh6bZuzm8s1ceuBUnMUAeoAHHw,3,1,0,0,0,0,2,0,3,0.42857142857142855,1,0.0,0,0,0,0,1,0,0,2,0,0,3,0
13063,193492,bershY3L5dsrOquW1lgM7Vxvmeies3St,A3fsA9Zfv1X2fVEQhTw51lKENdNrEqT3,8,5,1,0,1,0,2,0,9,1.2857142857142858,1,0.0,0,1,0,1,5,0,0,2,0,2,7,1
13064,193493,SBtS69Ct6IHarcvlSoYZArZJi3eatyfh,bWdj2GDclj5ofokWjzoa5jAwMkxCykd6,1,0,0,0,0,0,1,0,1,0.14285714285714285,1,0.0,0,0,0,0,0,0,0,1,0,0,1,1
13065,193497,SBtS69Ct6IHarcvlSoYZArZJi3eatyfh,SpATywNh6bZuzm8s1ceuBUnMUAeoAHHw,1,0,0,0,0,0,1,0,1,0.14285714285714285,1,0.0,0,0,0,0,0,0,0,1,0,0,1,1
13066,193518,cqIrvI5GKO10bpbizT8U9PReNX8yRrno,G8EPVSXsOYB5YQWZGiz1aVq5Pgr2GrQu,19,15,7,34,5,0,6,0,67,9.571428571428571,1,0.0,8,7,31,5,7,0,3,6,0,51,16,1
13067,193551,xwBZbOE6F0kqpjHJoYX4YfzqsGNvKWLp,A3fsA9Zfv1X2fVEQhTw51lKENdNrEqT3,2,0,0,0,0,0,2,0,2,0.2857142857142857,1,0.0,0,0,0,0,0,0,0,2,0,0,2,1
13068,193556,E5gNyf8gzkIFqEMMzFfX1babw0jRMtve,G8EPVSXsOYB5YQWZGiz1aVq5Pgr2GrQu,2,0,0,0,0,0,2,0,2,0.2857142857142857,1,0.0,0,0,0,0,0,0,0,2,0,0,2,1
13069,193606,0lEKKJq7wgGTJZ13dxv0HcjHfYwzJrxA,SpATywNh6bZuzm8s1ceuBUnMUAeoAHHw,1,0,0,0,0,0,1,0,1,0.14285714285714285,1,0.0,0,0,0,0,0,0,0,1,0,0,1,1
13070,193612,NpeRs7t4bBCf621U45j2j6LzoAMg7Erp,A3fsA9Zfv1X2fVEQhTw51lKENdNrEqT3,7,9,2,0,1,0,2,0,14,2.0,1,0.0,0,2,0,1,9,0,0,2,0,3,11,1
13071,193619,t7E1vZtGQbSSizV4xYOd5KHhRDOCUCjx,A3fsA9Zfv1X2fVEQhTw51lKENdNrEqT3,1,0,0,0,0,0,1,0,1,0.14285714285714285,1,0.0,0,0,0,0,0,0,0,1,0,0,1,1
13072,193635,XWdgQujmo1P2VLjvmb7PkUqKleCwQ4ss,A3fsA9Zfv1X2fVEQhTw51lKENdNrEqT3,11,7,5,0,3,0,4,0,19,2.7142857142857144,1,0.0,0,5,0,3,7,0,0,4,0,8,11,1
13073,193656,e5o0ZhPldcalqrDMbMLWYdrV0kqK4jyi,A3fsA9Zfv1X2fVEQhTw51lKENdNrEqT3,27,18,1,52,1,0,9,0,81,11.571428571428571,1,0.0,0,1,45,1,18,0,7,9,0,47,34,1
13074,193667,598cj7AyOso6FYrmmNL9sAZebmTaquiE,SpATywNh6bZuzm8s1ceuBUnMUAeoAHHw,1,0,0,0,0,0,1,0,1,0.14285714285714285,1,0.0,0,0,0,0,0,0,0,1,0,0,1,1
13075,193685,VAqYNROCUp4auixkrMgowB877fUTXjiq,SpATywNh6bZuzm8s1ceuBUnMUAeoAHHw,31,30,16,18,9,16,9,2,100,14.285714285714286,1,0.0,8,16,17,9,22,16,1,9,2,50,50,1
13076,193691,VwBmQMjyoGFc84WCvHOjmFbeW8jbYRgl,A3fsA9Zfv1X2fVEQhTw51lKENdNrEqT3,1,0,0,0,0,0,1,0,1,0.14285714285714285,1,0.0,0,0,0,0,0,0,0,1,0,0,1,1
13077,193695,GR5uAqC8TkTRctStVcrTSN6GkRpM0Sgw,A3fsA9Zfv1X2fVEQhTw51lKENdNrEqT3,10,9,6,0,4,0,3,0,22,3.142857142857143,1,0.0,0,6,0,4,9,0,0,3,0,10,12,1
13078,193727,9sblSYhBcICCvIfDQzNd8urCtUZhCG20,G8EPVSXsOYB5YQWZGiz1aVq5Pgr2GrQu,4,2,1,0,1,0,1,0,5,0.7142857142857143,1,0.0,0,1,0,1,2,0,0,1,0,2,3,1
13079,193742,dIBmr3CPQOqWuT2RbNcEQBxcZ3iYYFKJ,SpATywNh6bZuzm8s1ceuBUnMUAeoAHHw,5,0,0,0,0,1,4,1,6,0.8571428571428571,1,0.0,0,0,0,0,0,1,0,4,1,0,6,1
13080,193747,GTb2BLvnbd5mZTOqXcKad8NiMQFrBvAc,SpATywNh6bZuzm8s1ceuBUnMUAeoAHHw,18,23,10,14,6,0,6,0,59,8.428571428571429,1,0.0,2,10,11,6,21,0,3,6,0,29,30,1
13081,193748,hjvKRw9pmlUHPnwBerxV034YiZ4Sdtt0,G8EPVSXsOYB5YQWZGiz1aVq5Pgr2GrQu,9,6,5,0,5,0,2,0,18,2.5714285714285716,1,0.0,0,5,0,5,6,0,0,2,0,10,8,1
13082,193760,YbMwXn5lVdcJUwxsrilaG1YZqfrME5Ts,G8EPVSXsOYB5YQWZGiz1aVq5Pgr2GrQu,1,0,0,0,0,0,1,0,1,0.14285714285714285,1,0.0,0,0,0,0,0,0,0,1,0,0,1,1
13083,193761,DooyrB9PbCqKIV8AnNe2Wg3x6dZeRNaT,SpATywNh6bZuzm8s1ceuBUnMUAeoAHHw,7,6,2,0,0,0,3,2,13,1.8571428571428572,1,0.0,0,2,0,0,6,0,0,3,2,2,11,1
13084,193763,rKeYwK2azWmbL5uxRkzD5SXs7NFGZVCo,SpATywNh6bZuzm8s1ceuBUnMUAeoAHHw,6,3,0,0,0,0,4,0,7,1.0,1,0.0,0,0,0,0,3,0,0,4,0,0,7,1
13085,193788,j3WvRsPrA16gNidaQCOf3oXIUr2Xe5Lw,A3fsA9Zfv1X2fVEQhTw51lKENdNrEqT3,5,2,1,0,1,0,3,0,7,1.0,1,0.0,0,1,0,1,2,0,0,3,0,2,5,1
13086,193801,7ZZMGT0pRIPOqiHOaJOX6RxFZ8zRhWxt,A3fsA9Zfv1X2fVEQhTw51lKENdNrEqT3,8,3,2,0,2,1,3,0,11,1.5714285714285714,1,0.0,0,2,0,2,3,1,0,3,0,4,7,1
13087,193819,3vhCoT2dzeVdCpmcedhNzxK4VNLZ2l0r,bWdj2GDclj5ofokWjzoa5jAwMkxCykd6,1,0,0,0,0,0,1,0,1,0.14285714285714285,1,0.0,0,0,0,0,0,0,0,1,0,0,1,0
13088,193825,3VQVtsFphnOA3h1KWYRcAEMgfViLsPnF,bWdj2GDclj5ofokWjzoa5jAwMkxCykd6,4,3,1,0,0,0,2,0,6,0.8571428571428571,1,0.0,0,1,0,0,3,0,0,2,0,1,5,1
13089,193829,hvOZRLKsEVBLKIHheUWv5UUSup3awqeH,A3fsA9Zfv1X2fVEQhTw51lKENdNrEqT3,4,3,2,0,0,0,1,0,6,0.8571428571428571,1,0.0,0,2,0,0,3,0,0,1,0,2,4,1
13090,193835,FMDDO6Y1UiugRDKpi0pVbHvW0zsQHjbn,bWdj2GDclj5ofokWjzoa5jAwMkxCykd6,1,0,0,0,0,0,1,0,1,0.14285714285714285,1,0.0,0,0,0,0,0,0,0,1,0,0,1,1
13091,193836,WXzb3Y6xA6QJw9uAvme4qAoRdy9Swxz3,bWdj2GDclj5ofokWjzoa5jAwMkxCykd6,5,2,1,0,1,0,2,0,6,0.8571428571428571,1,0.0,0,1,0,1,2,0,0,2,0,2,4,1
13092,193842,z7DdTbSj1Gj3ZtxvkXQiSHlxkjIq13Om,A3fsA9Zfv1X2fVEQhTw51lKENdNrEqT3,2,0,0,0,0,0,2,0,2,0.2857142857142857,1,0.0,0,0,0,0,0,0,0,2,0,0,2,1
13093,193864,K9qobabPo7pZQt2fKdAjWYuJRDpZrqC7,RXDvfPUBYFlVdlueBFbLW0mhhAyGEqpt,11,5,4,0,4,0,2,0,15,2.142857142857143,1,0.0,0,4,0,4,5,0,0,2,0,8,7,1
13094,193885,F9X9HFVZRhtKo9yeebrZ2KAiEJUTDJRY,G8EPVSXsOYB5YQWZGiz1aVq5Pgr2GrQu,2,0,0,0,0,0,2,0,2,0.2857142857142857,1,0.0,0,0,0,0,0,0,0,2,0,0,2,1
13095,193887,8WWQhxaHRXxYqCPIQW9GmAgjD0ozXXnf,A3fsA9Zfv1X2fVEQhTw51lKENdNrEqT3,4,2,1,0,0,0,3,0,6,0.8571428571428571,1,0.0,0,1,0,0,2,0,0,3,0,1,5,0
13096,193897,45E6hpwDMHp9Q3Pt1xT8q04bbowKk87g,A3fsA9Zfv1X2fVEQhTw51lKENdNrEqT3,1,0,0,0,0,0,1,0,1,0.14285714285714285,1,0.0,0,0,0,0,0,0,0,1,0,0,1,1
13097,193929,e6mMhCeN7w5EZEy3n1NRYNLGTJO2KA59,SpATywNh6bZuzm8s1ceuBUnMUAeoAHHw,1,0,0,0,0,0,1,0,1,0.14285714285714285,1,0.0,0,0,0,0,0,0,0,1,0,0,1,1
13098,193932,B3ZfBfSKmpVIANk9dvhtttx7UlfawxPq,A3fsA9Zfv1X2fVEQhTw51lKENdNrEqT3,1,0,0,0,0,0,1,0,1,0.14285714285714285,1,0.0,0,0,0,0,0,0,0,1,0,0,1,1
13099,193941,Y3dD0pffbJaLSFte0rosi5cTQO2WHCFH,bWdj2GDclj5ofokWjzoa5jAwMkxCykd6,1,0,0,0,0,0,2,0,2,0.2857142857142857,1,0.0,0,0,0,0,0,0,0,2,0,0,2,1
13100,193942,hOgVLmzr652IyemyxTuY6cW83fi0l5Hj,G8EPVSXsOYB5YQWZGiz1aVq5Pgr2GrQu,1,0,0,0,0,0,1,0,1,0.14285714285714285,1,0.0,0,0,0,0,0,0,0,1,0,0,1,1
13101,193973,6KzTREX6cWCQkku3medBN2WKozKVI3fS,SpATywNh6bZuzm8s1ceuBUnMUAeoAHHw,3,2,0,0,0,0,2,0,4,0.5714285714285714,1,0.0,0,0,0,0,2,0,0,2,0,0,4,1
13102,193978,DysXuoUoTtoCjfxHxEQdZhXHC6tNfwru,bWdj2GDclj5ofokWjzoa5jAwMkxCykd6,7,3,2,0,1,0,9,0,15,2.142857142857143,1,0.0,0,2,0,1,3,0,0,9,0,3,12,1
13103,193993,S84ond6hhLSjNul8oHBvYzb7CeUyBJp8,SpATywNh6bZuzm8s1ceuBUnMUAeoAHHw,7,5,0,0,0,2,7,2,16,2.2857142857142856,1,0.0,0,0,0,0,5,2,0,7,2,0,16,1
13104,193996,3IFRUpYOJSQEJERfx1oONgKb2XoWBUXe,A3fsA9Zfv1X2fVEQhTw51lKENdNrEqT3,4,2,1,0,1,0,1,0,5,0.7142857142857143,1,0.0,0,1,0,1,2,0,0,1,0,2,3,1
13105,193997,eOxm8XEI11Xs6eiBi1Nu5QzIagZXwEm9,G8EPVSXsOYB5YQWZGiz1aVq5Pgr2GrQu,11,23,12,6,0,3,2,0,46,6.571428571428571,1,0.0,9,12,6,0,14,3,0,2,0,27,19,0
13106,193998,TV2QJkXjXW9uFHAZ7SV4Umcd3jhniZYh,A3fsA9Zfv1X2fVEQhTw51lKENdNrEqT3,1,0,0,0,0,0,1,0,1,0.14285714285714285,1,0.0,0,0,0,0,0,0,0,1,0,0,1,1
13107,194012,jnzTLvRDRqiUyW9xELuzH3YTLwUlWLlc,A3fsA9Zfv1X2fVEQhTw51lKENdNrEqT3,10,3,2,0,2,0,9,2,18,2.5714285714285716,1,0.0,0,2,0,2,3,0,0,9,2,4,14,1
13108,194028,jnzTLvRDRqiUyW9xELuzH3YTLwUlWLlc,bWdj2GDclj5ofokWjzoa5jAwMkxCykd6,6,0,0,0,0,1,6,2,9,1.2857142857142858,1,0.0,0,0,0,0,0,1,0,6,2,0,9,1
13109,194039,Zi4TkBqsB6TMu9rM1cOGrFhYXBZRNO2C,bWdj2GDclj5ofokWjzoa5jAwMkxCykd6,5,3,1,20,0,0,2,0,26,3.7142857142857144,1,0.0,1,1,19,0,2,0,1,2,0,21,5,1
13110,194043,DIV0XhnvCWVZ3iA9CwmqKCB9ziYsXVmI,A3fsA9Zfv1X2fVEQhTw51lKENdNrEqT3,40,35,13,46,8,1,5,0,108,15.428571428571429,1,0.0,3,13,43,8,32,1,3,5,0,67,41,1
13111,194050,mpIXHW5sILjjHOwn1u3NkBPJs6lkxDFU,bWdj2GDclj5ofokWjzoa5jAwMkxCykd6,7,2,1,0,1,0,7,1,12,1.7142857142857142,1,0.0,0,1,0,1,2,0,0,7,1,2,10,1
13112,194079,CuAHJ0dQPPKM3jbCnUFrdX2jG6XCUieg,G8EPVSXsOYB5YQWZGiz1aVq5Pgr2GrQu,2,0,0,0,0,0,3,0,3,0.42857142857142855,1,0.0,0,0,0,0,0,0,0,3,0,0,3,1
13113,194087,ss3omMaxz8HNXcYUFu5YCrRY08Nxx8VE,bWdj2GDclj5ofokWjzoa5jAwMkxCykd6,1,0,0,0,0,0,1,0,1,0.14285714285714285,1,0.0,0,0,0,0,0,0,0,1,0,0,1,1
13114,194124,YpnxbgvlHOSkecYk2lPrRwAg5SZiWPmr,bWdj2GDclj5ofokWjzoa5jAwMkxCykd6,1,0,0,0,0,0,1,0,1,0.14285714285714285,1,0.0,0,0,0,0,0,0,0,1,0,0,1,1
13115,194130,JijbcO7wMC3H8jX3AIAMeKa5y6Yx30jd,SpATywNh6bZuzm8s1ceuBUnMUAeoAHHw,3,3,1,0,0,0,2,0,6,0.8571428571428571,1,0.0,0,1,0,0,3,0,0,2,0,1,5,1
13116,194141,AEmia2YozeXaHvFO7t97makRXH4xCDlp,bWdj2GDclj5ofokWjzoa5jAwMkxCykd6,2,0,0,0,0,0,2,0,2,0.2857142857142857,1,0.0,0,0,0,0,0,0,0,2,0,0,2,1
13117,194152,7zIWtEX0UqW89kjtfLjI3UwXu7RlQqmU,SpATywNh6bZuzm8s1ceuBUnMUAeoAHHw,5,1,1,0,0,1,3,0,6,0.8571428571428571,1,0.0,0,1,0,0,1,1,0,3,0,1,5,1
13118,194158,D9eQoamtTDpiMV0b0OdGca728kthGUV3,G8EPVSXsOYB5YQWZGiz1aVq5Pgr2GrQu,17,7,2,50,0,0,3,0,62,8.857142857142858,1,0.0,0,2,43,0,7,0,7,3,0,45,17,0
13119,194167,2Dq9sTJAh9p2mCX2aKqNadJZj5lSg7Gc,SpATywNh6bZuzm8s1ceuBUnMUAeoAHHw,5,2,1,0,1,2,2,0,8,1.1428571428571428,1,0.0,0,1,0,1,2,2,0,2,0,2,6,1
13120,194168,GK7sYKSl1UGrgHpbh9Be7dVcfb79qHt9,SpATywNh6bZuzm8s1ceuBUnMUAeoAHHw,1,0,0,0,0,0,1,0,1,0.14285714285714285,1,0.0,0,0,0,0,0,0,0,1,0,0,1,1
13121,194184,l8hBRAS7ogrjP9TtrcfhUTQvRrT69YER,G8EPVSXsOYB5YQWZGiz1aVq5Pgr2GrQu,5,2,1,0,1,0,2,0,6,0.8571428571428571,1,0.0,0,1,0,1,2,0,0,2,0,2,4,1
13122,194188,OPg8TE3YHncvc9lX5Qzwkp0eoPsxjeaJ,SpATywNh6bZuzm8s1ceuBUnMUAeoAHHw,1,0,0,0,0,0,1,0,1,0.14285714285714285,1,0.0,0,0,0,0,0,0,0,1,0,0,1,1
13123,194198,1GmDhTbDGwGy4bZMeoK4qCn6roKlLWL8,G8EPVSXsOYB5YQWZGiz1aVq5Pgr2GrQu,1,0,0,0,0,0,1,0,1,0.14285714285714285,1,0.0,0,0,0,0,0,0,0,1,0,0,1,1
13124,194207,N3GQz89WFoRVhyYvEOMDsOOoq6FMOJl1,A3fsA9Zfv1X2fVEQhTw51lKENdNrEqT3,7,2,1,0,1,0,4,0,8,1.1428571428571428,1,0.0,0,1,0,1,2,0,0,4,0,2,6,1
13125,194209,2VapaY28kspg4nCvtglCw2KKfbfMlxS8,SpATywNh6bZuzm8s1ceuBUnMUAeoAHHw,5,3,1,0,1,0,1,0,6,0.8571428571428571,1,0.0,0,1,0,1,3,0,0,1,0,2,4,1
13126,194212,OvbupWSPA81Tk7Ur62Bs2bcQ5LB2mCRC,G8EPVSXsOYB5YQWZGiz1aVq5Pgr2GrQu,2,0,0,0,0,0,3,0,3,0.42857142857142855,1,0.0,0,0,0,0,0,0,0,3,0,0,3,0
13127,194214,OvbupWSPA81Tk7Ur62Bs2bcQ5LB2mCRC,A3fsA9Zfv1X2fVEQhTw51lKENdNrEqT3,2,0,0,0,0,0,2,0,2,0.2857142857142857,1,0.0,0,0,0,0,0,0,0,2,0,0,2,1
13128,194219,HFdRVQ3AaPvRF7mZbj3u7qUCAaYBGTcm,SpATywNh6bZuzm8s1ceuBUnMUAeoAHHw,1,0,0,0,0,0,1,0,1,0.14285714285714285,1,0.0,0,0,0,0,0,0,0,1,0,0,1,1
13129,194239,lxKYdDOq1adV5jGN5i0lYRRTeDyNW3Hr,SpATywNh6bZuzm8s1ceuBUnMUAeoAHHw,7,5,3,0,3,0,1,0,12,1.7142857142857142,1,0.0,0,3,0,3,5,0,0,1,0,6,6,1
13130,194245,BX7A5l848o20PbI9pokip60ZP55PjOzN,G8EPVSXsOYB5YQWZGiz1aVq5Pgr2GrQu,4,4,0,0,1,0,2,0,7,1.0,1,0.0,2,0,0,1,2,0,0,2,0,3,4,1
13131,194247,cpjQZOHgh4ZTeyEYZfjNyABlYC6nYoj2,A3fsA9Zfv1X2fVEQhTw51lKENdNrEqT3,7,6,5,0,0,0,3,0,14,2.0,1,0.0,0,5,0,0,6,0,0,3,0,5,9,1
13132,194267,hMqCjJdtfaejzSQ83KyhyoOldYIdBdX3,SpATywNh6bZuzm8s1ceuBUnMUAeoAHHw,1,0,0,0,0,0,1,0,1,0.14285714285714285,1,0.0,0,0,0,0,0,0,0,1,0,0,1,1
13133,194268,kITwW1gHtEbLza4IRMvPlhsE9m2pSgys,SpATywNh6bZuzm8s1ceuBUnMUAeoAHHw,11,7,4,1,3,1,2,0,18,2.5714285714285716,1,0.0,2,4,1,3,5,1,0,2,0,10,8,1
13134,194270,C5PwR3SXfivaQr9O4Dxv6rN0h0XMnUVV,SpATywNh6bZuzm8s1ceuBUnMUAeoAHHw,1,0,0,0,0,0,1,0,1,0.14285714285714285,1,0.0,0,0,0,0,0,0,0,1,0,0,1,1
13135,194286,Otjo8813Dg7RT9KCV4W4ruW1YbtDERlU,SpATywNh6bZuzm8s1ceuBUnMUAeoAHHw,4,2,0,0,0,0,2,0,4,0.5714285714285714,1,0.0,0,0,0,0,2,0,0,2,0,0,4,1
13136,194294,TrGtovPIL2DHRKTJya0pAHN8Ll5iZ4bG,bWdj2GDclj5ofokWjzoa5jAwMkxCykd6,9,7,2,0,3,0,6,0,18,2.5714285714285716,1,0.0,4,2,0,3,3,0,0,6,0,9,9,1
13137,194302,wOwiWQdQ27i4GIc2oZMP91541bkLucBc,SpATywNh6bZuzm8s1ceuBUnMUAeoAHHw,1,0,0,0,0,0,2,0,2,0.2857142857142857,1,0.0,0,0,0,0,0,0,0,2,0,0,2,1
13138,194321,y2Bn8Fz28yytP2MIRmHuQaPFEsenFCug,A3fsA9Zfv1X2fVEQhTw51lKENdNrEqT3,1,0,0,0,0,0,1,0,1,0.14285714285714285,1,0.0,0,0,0,0,0,0,0,1,0,0,1,1
13139,194322,OZuOlHrYkbmhjVMCUismPKuxxMPY633r,A3fsA9Zfv1X2fVEQhTw51lKENdNrEqT3,1,0,0,0,0,0,1,0,1,0.14285714285714285,1,0.0,0,0,0,0,0,0,0,1,0,0,1,1
13140,194334,hY4FeHGzGwAjlLDbag2MaeYtVg1riH9c,SpATywNh6bZuzm8s1ceuBUnMUAeoAHHw,8,8,4,0,3,0,2,1,18,2.5714285714285716,1,0.0,0,4,0,3,8,0,0,2,1,7,11,1
13141,194345,1qu57qTStFt2PB3HKgCdjae4zjIQPzMS,SpATywNh6bZuzm8s1ceuBUnMUAeoAHHw,2,0,0,0,0,0,2,0,2,0.2857142857142857,1,0.0,0,0,0,0,0,0,0,2,0,0,2,1
13142,194377,ebb0eUpPkZciTEOOrks9iaKBNMYE9SZU,SpATywNh6bZuzm8s1ceuBUnMUAeoAHHw,2,0,0,0,0,0,2,0,2,0.2857142857142857,1,0.0,0,0,0,0,0,0,0,2,0,0,2,1
13143,194388,hvbDeZzn9OgzafKXcnS1f48LEouOk3BF,bWdj2GDclj5ofokWjzoa5jAwMkxCykd6,1,0,0,0,0,0,1,0,1,0.14285714285714285,1,0.0,0,0,0,0,0,0,0,1,0,0,1,1
13144,194390,hvbDeZzn9OgzafKXcnS1f48LEouOk3BF,A3fsA9Zfv1X2fVEQhTw51lKENdNrEqT3,6,0,0,0,0,1,5,0,6,0.8571428571428571,1,0.0,0,0,0,0,0,1,0,5,0,0,6,1
13145,194406,WjTwXU0UqHfY2vRQjeMISV15DHgkpGUt,A3fsA9Zfv1X2fVEQhTw51lKENdNrEqT3,33,11,7,54,4,2,10,0,88,12.571428571428571,1,0.0,1,7,48,4,10,2,6,10,0,60,28,1
13146,194424,q43mSthmSExfF85hVnaL1eLCzsnwUSmi,SpATywNh6bZuzm8s1ceuBUnMUAeoAHHw,1,0,0,0,0,0,1,0,1,0.14285714285714285,1,0.0,0,0,0,0,0,0,0,1,0,0,1,1
13147,194471,uugcqDT99r37esUG18otF2qi3eWqvBzw,A3fsA9Zfv1X2fVEQhTw51lKENdNrEqT3,1,0,0,0,0,0,1,0,1,0.14285714285714285,1,0.0,0,0,0,0,0,0,0,1,0,0,1,1
13148,194476,48cQDxCvkp2Kfh2llKaDd9ViunV47JS8,SpATywNh6bZuzm8s1ceuBUnMUAeoAHHw,4,3,0,0,0,0,2,0,5,0.7142857142857143,1,0.0,0,0,0,0,3,0,0,2,0,0,5,1
13149,194479,onTUKKbDoguwNYZBVtONhnnEUSuWUV8S,G8EPVSXsOYB5YQWZGiz1aVq5Pgr2GrQu,9,3,1,0,1,0,5,1,11,1.5714285714285714,1,0.0,0,1,0,1,3,0,0,5,1,2,9,1
13150,194483,uWA9XLuGA6XEQSt93Q0BaDvrrOLPsSDK,SpATywNh6bZuzm8s1ceuBUnMUAeoAHHw,7,3,2,0,2,0,2,0,9,1.2857142857142858,1,0.0,0,2,0,2,3,0,0,2,0,4,5,1
13151,194504,Idacmra5qZXQ5ItNCju8xTvAUotHMPrs,SpATywNh6bZuzm8s1ceuBUnMUAeoAHHw,6,8,5,0,0,1,5,0,19,2.7142857142857144,1,0.0,1,5,0,0,7,1,0,5,0,6,13,1
13152,194507,FlQozMQpruyYmAqeyZEzRE9TkM48Rlw4,RXDvfPUBYFlVdlueBFbLW0mhhAyGEqpt,4,2,1,0,1,0,1,0,5,0.7142857142857143,1,0.0,0,1,0,1,2,0,0,1,0,2,3,1
13153,194511,34PiVxaMQlPDCBhflVVNOJYBNiFJq4sd,G8EPVSXsOYB5YQWZGiz1aVq5Pgr2GrQu,4,2,0,0,0,0,2,0,4,0.5714285714285714,1,0.0,0,0,0,0,2,0,0,2,0,0,4,1
13154,194515,YwHqDHYDccXkxjPE1B044eDwvxiVBTeO,SpATywNh6bZuzm8s1ceuBUnMUAeoAHHw,3,2,1,0,0,0,1,0,4,0.5714285714285714,1,0.0,0,1,0,0,2,0,0,1,0,1,3,1
13155,194534,H3KvIatiAwzsCPQBVABALz431TkTR6tW,bWdj2GDclj5ofokWjzoa5jAwMkxCykd6,1,0,0,0,0,0,1,0,1,0.14285714285714285,1,0.0,0,0,0,0,0,0,0,1,0,0,1,1
13156,194544,p8BRO2js5DMFomuFhLGv1L7bXBEJtOjM,SpATywNh6bZuzm8s1ceuBUnMUAeoAHHw,2,0,0,0,0,0,3,0,3,0.42857142857142855,1,0.0,0,0,0,0,0,0,0,3,0,0,3,1
13157,194549,om0KjvovtBK0gZUSboAPRv5A6Jkm00Ei,G8EPVSXsOYB5YQWZGiz1aVq5Pgr2GrQu,1,0,0,0,0,0,2,0,2,0.2857142857142857,1,0.0,0,0,0,0,0,0,0,2,0,0,2,1
13158,194556,AsOrTv5l2WGfE3oCrdncC2RTwz7dm912,bWdj2GDclj5ofokWjzoa5jAwMkxCykd6,2,0,0,0,0,0,3,0,3,0.42857142857142855,1,0.0,0,0,0,0,0,0,0,3,0,0,3,1
13159,194581,XFUUwZmtEN3cKElSp0idT6cWlW88ytvr,SpATywNh6bZuzm8s1ceuBUnMUAeoAHHw,1,0,0,0,0,0,2,0,2,0.2857142857142857,1,0.0,0,0,0,0,0,0,0,2,0,0,2,1
13160,194597,MYuwori4SZLwwApulVomE37Zmv9CBJsc,SpATywNh6bZuzm8s1ceuBUnMUAeoAHHw,1,0,0,0,0,0,1,0,1,0.14285714285714285,1,0.0,0,0,0,0,0,0,0,1,0,0,1,1
13161,194619,8IMVGvB09WRKHeXEjWGkZOVu6CXmlVXA,G8EPVSXsOYB5YQWZGiz1aVq5Pgr2GrQu,1,0,0,0,0,0,1,0,1,0.14285714285714285,1,0.0,0,0,0,0,0,0,0,1,0,0,1,1
13162,194625,cDJMTZrtYqA5Zzp6GydZkLUzHLBofVka,G8EPVSXsOYB5YQWZGiz1aVq5Pgr2GrQu,6,2,1,0,1,5,4,0,13,1.8571428571428572,1,0.0,0,1,0,1,2,5,0,4,0,2,11,0
13163,194626,xxqm3MFvp9JeD1lH1hC9xIrY8O1L8Xjf,SpATywNh6bZuzm8s1ceuBUnMUAeoAHHw,3,2,0,0,0,1,1,0,4,0.5714285714285714,1,0.0,0,0,0,0,2,1,0,1,0,0,4,1
13164,194629,mRThjjGON0zU0Y2plEdpqVN16fEiXwSr,A3fsA9Zfv1X2fVEQhTw51lKENdNrEqT3,1,0,0,0,0,0,2,0,2,0.2857142857142857,1,0.0,0,0,0,0,0,0,0,2,0,0,2,1
13165,194632,mhoMg2u4vZZCHMZwVbOPSr9rKeZ90EyX,SpATywNh6bZuzm8s1ceuBUnMUAeoAHHw,1,0,0,0,0,0,1,0,1,0.14285714285714285,1,0.0,0,0,0,0,0,0,0,1,0,0,1,1
13166,194633,NLv4FgxnCzxez4sx4x5czDhMA2RThzip,G8EPVSXsOYB5YQWZGiz1aVq5Pgr2GrQu,11,8,1,0,1,0,3,0,13,1.8571428571428572,1,0.0,0,1,0,1,8,0,0,3,0,2,11,0
13167,194655,Ntq8V5vAbhpRqfZVmDonWfflMXALrE62,A3fsA9Zfv1X2fVEQhTw51lKENdNrEqT3,7,5,3,0,1,0,4,0,13,1.8571428571428572,1,0.0,0,3,0,1,5,0,0,4,0,4,9,1
13168,194658,YTC5509AOhIkCtNjrBmjv9Yv2oK29NsL,SpATywNh6bZuzm8s1ceuBUnMUAeoAHHw,6,1,1,0,1,0,3,0,6,0.8571428571428571,1,0.0,0,1,0,1,1,0,0,3,0,2,4,1
13169,194667,sbaCeCpavj6HRFMhWrWMN8T04nCg0Bj4,SpATywNh6bZuzm8s1ceuBUnMUAeoAHHw,4,3,1,0,1,0,2,0,7,1.0,1,0.0,0,1,0,1,3,0,0,2,0,2,5,1
13170,194668,1sJ6YPYoSHma92rhmUGAalTdAYX4i2lG,SpATywNh6bZuzm8s1ceuBUnMUAeoAHHw,7,5,3,0,3,0,2,0,13,1.8571428571428572,1,0.0,0,3,0,3,5,0,0,2,0,6,7,1
13171,194674,VK6VYsFJEy8hhWdKq52KmrJkO3b6jNbn,bWdj2GDclj5ofokWjzoa5jAwMkxCykd6,4,2,1,0,1,0,1,0,5,0.7142857142857143,1,0.0,0,1,0,1,2,0,0,1,0,2,3,1
13172,194677,D0i6ZcBzVub6eIaIAw4ckCiIW5ThBWQ4,A3fsA9Zfv1X2fVEQhTw51lKENdNrEqT3,1,0,0,0,0,0,1,0,1,0.14285714285714285,1,0.0,0,0,0,0,0,0,0,1,0,0,1,1
13173,194678,96DWLTPjQt7WYS8cwfEQ2OGqQgPivHHX,SpATywNh6bZuzm8s1ceuBUnMUAeoAHHw,6,5,4,0,2,2,3,0,16,2.2857142857142856,1,0.0,0,4,0,2,5,2,0,3,0,6,10,1
13174,194684,d5TfbEyt4nCHCAaoxySwtX2WVur5Z8A1,A3fsA9Zfv1X2fVEQhTw51lKENdNrEqT3,1,0,0,0,0,0,1,0,1,0.14285714285714285,1,0.0,0,0,0,0,0,0,0,1,0,0,1,1
13175,194685,1YrPSVRax2MbGnGgOZ0qdLQfDXuMb3FP,SpATywNh6bZuzm8s1ceuBUnMUAeoAHHw,4,2,1,0,1,0,1,0,5,0.7142857142857143,1,0.0,0,1,0,1,2,0,0,1,0,2,3,1
13176,194693,8TF2Yz03M0ctxPaKqQO9uTaRyGlE3FTS,bWdj2GDclj5ofokWjzoa5jAwMkxCykd6,1,0,0,0,0,0,1,0,1,0.14285714285714285,1,0.0,0,0,0,0,0,0,0,1,0,0,1,1
13177,194694,6Ypoz1HptUjxpuR7fZtuIow2vA2n53uM,A3fsA9Zfv1X2fVEQhTw51lKENdNrEqT3,1,0,0,0,0,0,1,0,1,0.14285714285714285,1,0.0,0,0,0,0,0,0,0,1,0,0,1,1
13178,194713,aMZE4hDrTfaO5VrIlGdTGgvjbzOnIun0,A3fsA9Zfv1X2fVEQhTw51lKENdNrEqT3,1,0,0,0,0,0,1,0,1,0.14285714285714285,1,0.0,0,0,0,0,0,0,0,1,0,0,1,1
13179,194719,wj7PR2dOTCSENZUxdS1JrjKR8466zZVl,bWdj2GDclj5ofokWjzoa5jAwMkxCykd6,8,2,1,0,1,1,6,1,12,1.7142857142857142,1,0.0,0,1,0,1,2,1,0,6,1,2,10,1
13180,194722,4rwe5BmciR8qkFj7YwyJ3a5aK2xp9xod,A3fsA9Zfv1X2fVEQhTw51lKENdNrEqT3,6,5,3,0,2,0,3,0,13,1.8571428571428572,1,0.0,0,3,0,2,5,0,0,3,0,5,8,1
13181,194729,yWWr0HnJqf4TxBLaD1ZmBW6mPdbU2NXV,SpATywNh6bZuzm8s1ceuBUnMUAeoAHHw,5,4,1,0,1,0,4,0,10,1.4285714285714286,1,0.0,0,1,0,1,4,0,0,4,0,2,8,1
13182,194733,MBzpq6BeyrKVsFmJlf8cgHZW8NmCppoM,bWdj2GDclj5ofokWjzoa5jAwMkxCykd6,5,2,1,0,1,0,2,0,6,0.8571428571428571,1,0.0,0,1,0,1,2,0,0,2,0,2,4,1
13183,194734,55FtCsTJdMN32PE70MZj9DHqTCxXeYP2,SpATywNh6bZuzm8s1ceuBUnMUAeoAHHw,6,3,2,0,2,0,1,0,8,1.1428571428571428,1,0.0,0,2,0,2,3,0,0,1,0,4,4,1
13184,194739,ivSdmGnxv1Uz6NLl4IGvBJeRY1HBPrVZ,SpATywNh6bZuzm8s1ceuBUnMUAeoAHHw,9,4,1,0,1,8,5,1,20,2.857142857142857,1,0.0,0,1,0,1,4,8,0,5,1,2,18,1
13185,194753,Bxz1zTHFCCx9o1kJA9B0Pzm3PnmqKxr5,A3fsA9Zfv1X2fVEQhTw51lKENdNrEqT3,7,3,2,0,2,0,2,0,9,1.2857142857142858,1,0.0,0,2,0,2,3,0,0,2,0,4,5,1
13186,194767,i4NsQYAbaUfmQ6n2VMTiVWggNWktkrDX,bWdj2GDclj5ofokWjzoa5jAwMkxCykd6,5,10,3,0,0,0,5,0,18,2.5714285714285716,1,0.0,0,3,0,0,10,0,0,5,0,3,15,0
13187,194779,KheifBHmTnDsYBIH7TBBDpXQ1Bd1UA3a,SpATywNh6bZuzm8s1ceuBUnMUAeoAHHw,1,0,0,0,0,0,1,0,1,0.14285714285714285,1,0.0,0,0,0,0,0,0,0,1,0,0,1,1
13188,194784,LDPCm5FHAiMLt4xJYeSbtfjm8D9WglxJ,SpATywNh6bZuzm8s1ceuBUnMUAeoAHHw,16,15,7,14,3,0,5,0,44,6.285714285714286,1,0.0,4,7,14,3,11,0,0,5,0,28,16,1
13189,194788,BH0g3wVCilU6qeEv507COxWXunEVyQCt,A3fsA9Zfv1X2fVEQhTw51lKENdNrEqT3,4,6,3,0,0,0,2,0,11,1.5714285714285714,1,0.0,0,3,0,0,6,0,0,2,0,3,8,1
13190,194803,YqqcH0qThFMdLP4k9i9U0gJ4gpbELjkv,SpATywNh6bZuzm8s1ceuBUnMUAeoAHHw,8,8,6,0,0,0,5,2,21,3.0,1,0.0,0,6,0,0,8,0,0,5,2,6,15,1
13191,194806,FF4dRvqzL3V5nW7v3NbN8PsUIVH4lz6F,SpATywNh6bZuzm8s1ceuBUnMUAeoAHHw,1,0,0,0,0,0,1,0,1,0.14285714285714285,1,0.0,0,0,0,0,0,0,0,1,0,0,1,1
13192,194807,tyVcDsPvN4UjeaGnK8HkYLM1DiaISxPh,A3fsA9Zfv1X2fVEQhTw51lKENdNrEqT3,10,10,5,0,1,12,13,0,41,5.857142857142857,2,0.0,2,5,0,1,8,12,0,13,0,8,33,1
13193,194810,mNLR1O6gqXF6Zqi4uIf130gITni9gN1A,SpATywNh6bZuzm8s1ceuBUnMUAeoAHHw,7,3,2,0,2,0,2,0,9,1.2857142857142858,1,0.0,0,2,0,2,3,0,0,2,0,4,5,0
13194,194813,pFd3DZfpKrECGIK8sknjrUy2fJFwKULW,G8EPVSXsOYB5YQWZGiz1aVq5Pgr2GrQu,2,0,0,0,0,0,3,0,3,0.42857142857142855,1,0.0,0,0,0,0,0,0,0,3,0,0,3,1
13195,194817,7HNfi5OY69fAwtBXY2Bx1G7GFcGZh7Ly,SpATywNh6bZuzm8s1ceuBUnMUAeoAHHw,1,0,0,0,0,0,1,0,1,0.14285714285714285,1,0.0,0,0,0,0,0,0,0,1,0,0,1,1
13196,194820,W3q5xabVGlYtHwCF6azkr4rDuBoAdzu5,SpATywNh6bZuzm8s1ceuBUnMUAeoAHHw,4,2,1,0,1,0,1,0,5,0.7142857142857143,1,0.0,0,1,0,1,2,0,0,1,0,2,3,1
13197,194822,oLy9nBdTYL8NCOYS922zyTRG6EziMvh0,SpATywNh6bZuzm8s1ceuBUnMUAeoAHHw,5,2,1,0,1,0,2,0,6,0.8571428571428571,1,0.0,0,1,0,1,2,0,0,2,0,2,4,1
13198,194837,h1POuqYbxnxgGkE4pWe2S8wS54aC8n19,SpATywNh6bZuzm8s1ceuBUnMUAeoAHHw,7,2,1,0,1,1,4,1,10,1.4285714285714286,1,0.0,0,1,0,1,2,1,0,4,1,2,8,1
13199,194844,V6I2tWMT4J6OaEfYWYGJXMvy6YbJ0vQk,RXDvfPUBYFlVdlueBFbLW0mhhAyGEqpt,1,0,0,0,0,0,1,0,1,0.14285714285714285,1,0.0,0,0,0,0,0,0,0,1,0,0,1,1
13200,194852,nq0fTUXEyf4zNsnzbVQxJGqu2ei3Zzxd,SpATywNh6bZuzm8s1ceuBUnMUAeoAHHw,1,0,0,0,0,0,1,0,1,0.14285714285714285,1,0.0,0,0,0,0,0,0,0,1,0,0,1,1
13201,194853,SSxnRLkRY8Nz6yCXbxisiyKLbaiWbjIK,bWdj2GDclj5ofokWjzoa5jAwMkxCykd6,1,0,0,0,0,0,1,0,1,0.14285714285714285,1,0.0,0,0,0,0,0,0,0,1,0,0,1,1
13202,194862,cW4Q7k8uorP2ZaATVwEYmHiYgqZDhGz3,SpATywNh6bZuzm8s1ceuBUnMUAeoAHHw,5,2,1,0,1,2,2,0,8,1.1428571428571428,1,0.0,0,1,0,1,2,2,0,2,0,2,6,1
13203,194870,4sHw1UrsiyaJNXlPeVCwFs89kPI7rFXb,RXDvfPUBYFlVdlueBFbLW0mhhAyGEqpt,1,0,0,0,0,0,1,0,1,0.14285714285714285,1,0.0,0,0,0,0,0,0,0,1,0,0,1,1
13204,194886,AYPzYs86vNA5oOhv1GafopaYTci4zq2u,SpATywNh6bZuzm8s1ceuBUnMUAeoAHHw,3,3,0,0,0,0,2,0,5,0.7142857142857143,1,0.0,0,0,0,0,3,0,0,2,0,0,5,1
13205,194887,QUGraFxtzCQNNKP2kQzaB6kauOeKIjbk,SpATywNh6bZuzm8s1ceuBUnMUAeoAHHw,5,2,1,0,1,0,2,0,6,0.8571428571428571,1,0.0,0,1,0,1,2,0,0,2,0,2,4,1
13206,194888,nfvdVPsl73HsB5v26CK2d3kpAhmyAPaZ,SpATywNh6bZuzm8s1ceuBUnMUAeoAHHw,2,0,0,0,0,0,2,0,2,0.2857142857142857,1,0.0,0,0,0,0,0,0,0,2,0,0,2,1
13207,194896,50aSuabL02e7lLNBHTRXsMQnBChV2lSX,SpATywNh6bZuzm8s1ceuBUnMUAeoAHHw,9,4,3,0,3,0,2,0,12,1.7142857142857142,1,0.0,0,3,0,3,4,0,0,2,0,6,6,0
13208,194907,r8kATVhVTFWwFIt4UfjEkmBJAJ9dIcZn,SpATywNh6bZuzm8s1ceuBUnMUAeoAHHw,11,10,3,0,1,6,8,2,30,4.285714285714286,1,0.0,4,3,0,1,6,6,0,8,2,8,22,1
13209,194908,FtHUJIDgcRIKvAk6G0aJG28BljfTCpR1,SpATywNh6bZuzm8s1ceuBUnMUAeoAHHw,3,0,0,0,0,2,2,0,4,0.5714285714285714,1,0.0,0,0,0,0,0,2,0,2,0,0,4,1
13210,194921,coZTr10eytnE55me2AxqRWq6qrVXEB7M,bWdj2GDclj5ofokWjzoa5jAwMkxCykd6,1,0,0,0,0,0,1,0,1,0.14285714285714285,1,0.0,0,0,0,0,0,0,0,1,0,0,1,1
13211,194930,4pOcM6UwGexWSApv8Q2hzDn3Wxf1tNaX,G8EPVSXsOYB5YQWZGiz1aVq5Pgr2GrQu,2,0,0,0,0,0,4,0,4,0.5714285714285714,1,0.0,0,0,0,0,0,0,0,4,0,0,4,1
13212,194932,XzsCpdFAPGr3HoHuPSOeqUJ9vrQ1cDvx,SpATywNh6bZuzm8s1ceuBUnMUAeoAHHw,1,0,0,0,0,0,1,0,1,0.14285714285714285,1,0.0,0,0,0,0,0,0,0,1,0,0,1,1
13213,194941,WOgCErvth3RYtZvlZwUgSVLnOS4A1Eul,SpATywNh6bZuzm8s1ceuBUnMUAeoAHHw,1,0,0,0,0,0,1,0,1,0.14285714285714285,1,0.0,0,0,0,0,0,0,0,1,0,0,1,1
13214,194948,gDo9M8HDbXmLQPxqqLTsn9N4ZUEPKvcn,SpATywNh6bZuzm8s1ceuBUnMUAeoAHHw,7,10,1,0,0,0,2,0,13,1.8571428571428572,1,0.0,3,1,0,0,7,0,0,2,0,4,9,1
13215,194949,88fLpsc97HhNfdaSPlKqNnhAVgW27BAo,SpATywNh6bZuzm8s1ceuBUnMUAeoAHHw,5,3,0,0,0,0,3,1,7,1.0,1,0.0,0,0,0,0,3,0,0,3,1,0,7,1
13216,194965,FuiskmcpMN6lu4pckLk8iCQBFUYbh2yw,G8EPVSXsOYB5YQWZGiz1aVq5Pgr2GrQu,6,3,1,0,1,0,2,0,7,1.0,1,0.0,0,1,0,1,3,0,0,2,0,2,5,1
13217,194968,Jx42Ejc8m7xjALEiD0Ys2DAnttPYIxMG,A3fsA9Zfv1X2fVEQhTw51lKENdNrEqT3,17,14,0,0,0,12,7,1,34,4.857142857142857,1,0.0,1,0,0,0,13,12,0,7,1,1,33,1
13218,194972,sESOR36K7nBM311FFRUj2nLw7gbYwiJz,SpATywNh6bZuzm8s1ceuBUnMUAeoAHHw,7,7,3,0,2,0,3,0,15,2.142857142857143,1,0.0,1,3,0,2,6,0,0,3,0,6,9,1
13219,194974,Io5gLr8QOxaBw8nFReloAXOpt3IlZ5WE,bWdj2GDclj5ofokWjzoa5jAwMkxCykd6,1,0,0,0,0,0,1,0,1,0.14285714285714285,1,0.0,0,0,0,0,0,0,0,1,0,0,1,1
13220,194975,Io5gLr8QOxaBw8nFReloAXOpt3IlZ5WE,A3fsA9Zfv1X2fVEQhTw51lKENdNrEqT3,1,0,0,0,0,0,1,0,1,0.14285714285714285,1,0.0,0,0,0,0,0,0,0,1,0,0,1,1
13221,194980,z2EPdF3qYcFLBwhpfABa73PTR23asQuU,A3fsA9Zfv1X2fVEQhTw51lKENdNrEqT3,9,3,1,0,1,2,7,1,15,2.142857142857143,1,0.0,0,1,0,1,3,2,0,7,1,2,13,1
13222,194982,1GEou0jUAwSZvf4K9js5E10dDnbmQpAC,A3fsA9Zfv1X2fVEQhTw51lKENdNrEqT3,8,2,1,0,1,0,5,1,10,1.4285714285714286,1,0.0,0,1,0,1,2,0,0,5,1,2,8,1
13223,194988,uiws4KxaJyhkKSkkHMDme11rXJg9xyaL,SpATywNh6bZuzm8s1ceuBUnMUAeoAHHw,11,13,7,0,4,2,13,1,40,5.714285714285714,1,0.0,3,7,0,4,10,2,0,13,1,14,26,1
13224,195002,LfNMIOZFn9FNdYWiUKFIdgjlnXx6yIVQ,SpATywNh6bZuzm8s1ceuBUnMUAeoAHHw,12,14,1,2,1,0,6,0,24,3.4285714285714284,1,0.0,0,1,2,1,14,0,0,6,0,4,20,1
13225,195013,Y8EaHrodQDFZUcVDuYNEubkGRhsaWq8Y,RXDvfPUBYFlVdlueBFbLW0mhhAyGEqpt,6,0,0,0,0,0,10,3,13,1.8571428571428572,1,0.0,0,0,0,0,0,0,0,10,3,0,13,1
13226,195022,0FxfzBL8lExhKYYcGcci82l6xBLomyet,SpATywNh6bZuzm8s1ceuBUnMUAeoAHHw,9,5,4,0,4,0,3,0,16,2.2857142857142856,1,0.0,0,4,0,4,5,0,0,3,0,8,8,1
13227,195029,3bqYNHEttQnrSXCOjNHPi8cuvQEsNCSU,bWdj2GDclj5ofokWjzoa5jAwMkxCykd6,1,0,0,0,0,0,1,0,1,0.14285714285714285,1,0.0,0,0,0,0,0,0,0,1,0,0,1,1
13228,195031,2wS8JVpw1CsKg56Cx9G9VOnhu3l1G4I0,SpATywNh6bZuzm8s1ceuBUnMUAeoAHHw,17,21,11,15,4,9,8,2,70,10.0,1,0.0,4,11,14,4,17,9,1,8,2,33,37,1
13229,195033,IPw8SBo730f13L9fdyPJQsRb6dxi5glI,G8EPVSXsOYB5YQWZGiz1aVq5Pgr2GrQu,7,6,0,0,0,0,2,0,8,1.1428571428571428,1,0.0,0,0,0,0,6,0,0,2,0,0,8,1
13230,195036,A8zAoi2Uw9AkuLfLEgj43RiYhGLMNj18,SpATywNh6bZuzm8s1ceuBUnMUAeoAHHw,5,5,1,0,1,0,1,0,8,1.1428571428571428,1,0.0,0,1,0,1,5,0,0,1,0,2,6,1
13231,195039,I9J4QWiXHWCNKaic0XgJQZKgGASYH4yX,SpATywNh6bZuzm8s1ceuBUnMUAeoAHHw,7,6,4,0,3,0,1,0,14,2.0,1,0.0,0,4,0,3,6,0,0,1,0,7,7,1
13232,195040,B8Q6zzQbCDmmGJ2Jkpuj3FBNKJuawYVo,G8EPVSXsOYB5YQWZGiz1aVq5Pgr2GrQu,4,4,0,0,0,0,2,0,6,0.8571428571428571,1,0.0,0,0,0,0,4,0,0,2,0,0,6,1
13233,195057,NikqZ1qZg3zBUaGWiNf6mGXz34uqYANW,bWdj2GDclj5ofokWjzoa5jAwMkxCykd6,7,3,1,0,1,0,5,6,16,2.2857142857142856,1,0.0,1,1,0,1,2,0,0,5,6,3,13,1
13234,195059,4LHx8JspDAj57obmMYSAAyDYEzuHjEJP,A3fsA9Zfv1X2fVEQhTw51lKENdNrEqT3,2,0,0,0,0,0,2,0,2,0.2857142857142857,1,0.0,0,0,0,0,0,0,0,2,0,0,2,1
13235,195062,9YkZ5i0tAbds4GKPFoxObCx79Yv0yxVA,G8EPVSXsOYB5YQWZGiz1aVq5Pgr2GrQu,22,21,13,26,7,1,4,0,72,10.285714285714286,1,0.0,6,13,19,7,15,1,7,4,0,45,27,0
13236,195066,xsq0NNhfMlJSps1up5uJcRMXvgRrV0sJ,SpATywNh6bZuzm8s1ceuBUnMUAeoAHHw,1,0,0,0,0,0,1,0,1,0.14285714285714285,1,0.0,0,0,0,0,0,0,0,1,0,0,1,1
13237,195089,qX3w4IgztgXyu9swieirFObama3kJyza,SpATywNh6bZuzm8s1ceuBUnMUAeoAHHw,2,0,0,0,0,0,3,0,3,0.42857142857142855,1,0.0,0,0,0,0,0,0,0,3,0,0,3,1
13238,195091,L8lHLh6Mth1S7I3sErP5oDZD885a1BOh,SpATywNh6bZuzm8s1ceuBUnMUAeoAHHw,5,3,2,0,2,0,2,0,9,1.2857142857142858,1,0.0,0,2,0,2,3,0,0,2,0,4,5,1
13239,195092,aBOCGRJtSTLes0jxdeecmLlgi9rWLU2d,SpATywNh6bZuzm8s1ceuBUnMUAeoAHHw,4,1,0,0,0,0,3,0,4,0.5714285714285714,1,0.0,0,0,0,0,1,0,0,3,0,0,4,1
13240,195103,vxGkTn6WfGBki29hwuSV6Xuc1hbgzs4I,SpATywNh6bZuzm8s1ceuBUnMUAeoAHHw,1,0,0,0,0,0,1,0,1,0.14285714285714285,1,0.0,0,0,0,0,0,0,0,1,0,0,1,1
13241,195104,90Hur8PGj0IjqXgPOcR65ST1YxNz0ds7,A3fsA9Zfv1X2fVEQhTw51lKENdNrEqT3,12,9,3,0,2,0,7,1,22,3.142857142857143,2,0.0,0,3,0,2,9,0,0,7,1,5,17,1
13242,195119,aWAFF1Fze4LYlsUU8ERMTgVYzoyOI6Lv,SpATywNh6bZuzm8s1ceuBUnMUAeoAHHw,5,3,0,0,1,0,1,0,5,0.7142857142857143,1,0.0,0,0,0,1,3,0,0,1,0,1,4,1
13243,195127,jg3jOKfanNJPAzYxAIsKTejRcuHuYakD,SpATywNh6bZuzm8s1ceuBUnMUAeoAHHw,2,1,0,0,0,0,1,0,2,0.2857142857142857,1,0.0,0,0,0,0,1,0,0,1,0,0,2,1
13244,195132,TAT1t0HA0deInUIqMQU3qN2hNwJUolWn,SpATywNh6bZuzm8s1ceuBUnMUAeoAHHw,10,8,6,3,4,0,2,0,23,3.2857142857142856,1,0.0,1,6,3,4,7,0,0,2,0,14,9,1
13245,195149,lxP21JAeoGw4N8j8NgjQVcD64XYgvMHQ,SpATywNh6bZuzm8s1ceuBUnMUAeoAHHw,3,2,0,0,0,0,1,0,3,0.42857142857142855,1,0.0,0,0,0,0,2,0,0,1,0,0,3,1
13246,195158,YwfI8H5GXP8M3NnSeLcRy7i15qMPqaXk,SpATywNh6bZuzm8s1ceuBUnMUAeoAHHw,7,4,1,0,1,0,3,1,10,1.4285714285714286,1,0.0,0,1,0,1,4,0,0,3,1,2,8,1
13247,195169,S3f0JK9oaNTPyiRDrmkpSKmLckAAblqI,SpATywNh6bZuzm8s1ceuBUnMUAeoAHHw,6,5,3,0,1,0,1,0,10,1.4285714285714286,1,0.0,0,3,0,1,5,0,0,1,0,4,6,1
13248,195174,iXadVTWz0gSvLWs1uknu7xrsEL401uhz,SpATywNh6bZuzm8s1ceuBUnMUAeoAHHw,3,0,0,0,0,0,3,0,3,0.42857142857142855,1,0.0,0,0,0,0,0,0,0,3,0,0,3,1
13249,195175,02LTWEFxRPP3VB0zkhjBsebsLQ1XAvEO,G8EPVSXsOYB5YQWZGiz1aVq5Pgr2GrQu,1,0,0,0,0,0,1,0,1,0.14285714285714285,1,0.0,0,0,0,0,0,0,0,1,0,0,1,1
13250,195179,xEHo4X1rukdspRGBdfJyX5P4IZVyDEcz,SpATywNh6bZuzm8s1ceuBUnMUAeoAHHw,7,3,2,0,2,0,2,0,9,1.2857142857142858,1,0.0,0,2,0,2,3,0,0,2,0,4,5,1
13251,195184,NtEul7SVttJozgojuYe5lpg4GBGEyM2O,G8EPVSXsOYB5YQWZGiz1aVq5Pgr2GrQu,6,0,0,0,0,1,5,1,7,1.0,1,0.0,0,0,0,0,0,1,0,5,1,0,7,1
13252,195208,L2VtKU10xoYfk9AeXI4ucBlRANoxyJAj,SpATywNh6bZuzm8s1ceuBUnMUAeoAHHw,7,30,3,0,0,0,7,0,40,5.714285714285714,1,0.0,0,3,0,0,30,0,0,7,0,3,37,1
13253,195219,Nvud1QIhR4FBjW055r9HSxywupZk5GAR,RXDvfPUBYFlVdlueBFbLW0mhhAyGEqpt,10,6,1,0,1,0,6,3,17,2.4285714285714284,1,0.0,0,1,0,1,6,0,0,6,3,2,15,0
13254,195223,jtdJ8s2kyNzwf06KTNChcN9oAOS9ZmYk,A3fsA9Zfv1X2fVEQhTw51lKENdNrEqT3,8,5,2,0,2,0,3,0,12,1.7142857142857142,1,0.0,0,2,0,2,5,0,0,3,0,4,8,1
13255,195227,bONRCO0uATZ9orvOXASjWia0swY9AaMZ,A3fsA9Zfv1X2fVEQhTw51lKENdNrEqT3,6,2,1,0,1,0,8,0,12,1.7142857142857142,1,0.0,0,1,0,1,2,0,0,8,0,2,10,1
13256,195231,8qABUnBBHxxZkfUhEQNUn5NNMSRrqvPC,A3fsA9Zfv1X2fVEQhTw51lKENdNrEqT3,7,8,5,0,0,0,2,0,15,2.142857142857143,2,0.0,0,5,0,0,8,0,0,2,0,5,10,1
13257,195235,fIET0xNMcDIlnjd0AnC9TZEnn5s3AA6i,G8EPVSXsOYB5YQWZGiz1aVq5Pgr2GrQu,21,23,5,18,4,1,5,0,56,8.0,1,0.0,15,5,9,4,8,1,9,5,0,33,23,1
13258,195240,nhwZ1i3tBLPpKZ1jf7waw2ZZrzqPTraF,A3fsA9Zfv1X2fVEQhTw51lKENdNrEqT3,1,0,0,0,0,0,2,0,2,0.2857142857142857,1,0.0,0,0,0,0,0,0,0,2,0,0,2,1
13259,195246,hNV2TDc5kXTQn8foo4aRN6FCIXLNr4nn,SpATywNh6bZuzm8s1ceuBUnMUAeoAHHw,6,0,0,0,0,1,6,1,8,1.1428571428571428,1,0.0,0,0,0,0,0,1,0,6,1,0,8,1
13260,195253,K6R10YCm4EKgUGnQY53FYbuIV8YOCHd6,A3fsA9Zfv1X2fVEQhTw51lKENdNrEqT3,14,11,9,0,6,0,3,0,29,4.142857142857143,1,0.0,0,9,0,6,11,0,0,3,0,15,14,1
13261,195255,nFy3S5ktNxWHxSxQEsVxABtdYtTHm2QG,SpATywNh6bZuzm8s1ceuBUnMUAeoAHHw,10,6,1,6,0,0,5,0,18,2.5714285714285716,1,0.0,1,1,5,0,5,0,1,5,0,7,11,1
13262,195259,7dlRqTed9Vz3lG7sCkGqwL4Rf479l4Lf,SpATywNh6bZuzm8s1ceuBUnMUAeoAHHw,3,2,0,0,0,0,1,0,3,0.42857142857142855,1,0.0,0,0,0,0,2,0,0,1,0,0,3,1
13263,195260,sbaJoVFlMLyfg1PbRG67GWzU7ygSqHEa,G8EPVSXsOYB5YQWZGiz1aVq5Pgr2GrQu,4,6,0,0,0,0,4,0,10,1.4285714285714286,1,0.0,0,0,0,0,6,0,0,4,0,0,10,0
13264,195275,JIBg2bFQYc7ncSPQhvBWrAlcobShyiXA,SpATywNh6bZuzm8s1ceuBUnMUAeoAHHw,11,8,1,11,0,0,3,1,24,3.4285714285714284,1,0.0,2,1,10,0,6,0,1,3,1,13,11,1
13265,195278,8cxCnT3STAEth9x4HzjOcerWufkhGlX3,A3fsA9Zfv1X2fVEQhTw51lKENdNrEqT3,1,0,0,0,0,0,1,0,1,0.14285714285714285,1,0.0,0,0,0,0,0,0,0,1,0,0,1,1
13266,195303,ouhJVRUNWH7xFlD4xC7qUWcBbb5kOVSM,SpATywNh6bZuzm8s1ceuBUnMUAeoAHHw,7,3,0,0,0,0,8,0,11,1.5714285714285714,1,0.0,0,0,0,0,3,0,0,8,0,0,11,1
13267,195307,3PN3AyL6tfmtfTSkHxR5sSs7QxGCrkua,SpATywNh6bZuzm8s1ceuBUnMUAeoAHHw,1,0,0,0,0,0,1,0,1,0.14285714285714285,1,0.0,0,0,0,0,0,0,0,1,0,0,1,1
13268,195309,qqPuA4adS4zWJNjZeIJQCgaT64XJRtor,A3fsA9Zfv1X2fVEQhTw51lKENdNrEqT3,32,31,16,14,11,8,8,0,88,12.571428571428571,1,0.0,0,16,13,11,31,8,1,8,0,40,48,1
13269,195318,ee58foeX64HQVEJT3urOlMI7BjSHbs8j,G8EPVSXsOYB5YQWZGiz1aVq5Pgr2GrQu,5,5,0,0,0,0,4,0,9,1.2857142857142858,1,0.0,0,0,0,0,5,0,0,4,0,0,9,1
13270,195323,PQAJu1VB3GuaUzJI11vB182M1L2se1PX,SpATywNh6bZuzm8s1ceuBUnMUAeoAHHw,10,3,2,0,2,1,6,2,16,2.2857142857142856,1,0.0,0,2,0,2,3,1,0,6,2,4,12,1
13271,195326,0Si73COGxildPoctZYuOxLe1rgf9eDaM,RXDvfPUBYFlVdlueBFbLW0mhhAyGEqpt,8,3,1,0,1,0,3,0,8,1.1428571428571428,1,0.0,0,1,0,1,3,0,0,3,0,2,6,1
13272,195328,kKCWVPsmOCuRmD5n3b0FhPNIyXfeeMNV,SpATywNh6bZuzm8s1ceuBUnMUAeoAHHw,3,2,0,0,0,0,1,0,3,0.42857142857142855,1,0.0,0,0,0,0,2,0,0,1,0,0,3,1
13273,195336,cA8asOLHRHcK3Kr0VMyGtrDdcfovAiM5,A3fsA9Zfv1X2fVEQhTw51lKENdNrEqT3,21,11,10,0,8,0,3,0,32,4.571428571428571,1,0.0,1,10,0,8,10,0,0,3,0,19,13,1
13274,195357,rYmd6vnR5Pxkj69jVuGfihv9dJd27d4j,SpATywNh6bZuzm8s1ceuBUnMUAeoAHHw,7,3,2,0,2,0,2,0,9,1.2857142857142858,1,0.0,0,2,0,2,3,0,0,2,0,4,5,1
13275,195359,v4pwVH1VWldeBobir3iEqSHO6IoG1mdb,SpATywNh6bZuzm8s1ceuBUnMUAeoAHHw,14,17,6,12,4,0,2,0,41,5.857142857142857,1,0.0,4,6,11,4,13,0,1,2,0,25,16,1
13276,195361,v4pwVH1VWldeBobir3iEqSHO6IoG1mdb,A3fsA9Zfv1X2fVEQhTw51lKENdNrEqT3,10,9,3,0,3,0,2,0,17,2.4285714285714284,1,0.0,0,3,0,3,9,0,0,2,0,6,11,1
13277,195368,YPWJVK9ueaONJH89FoDwiyUXkyNj3an5,SpATywNh6bZuzm8s1ceuBUnMUAeoAHHw,7,3,2,0,2,0,2,0,9,1.2857142857142858,1,0.0,0,2,0,2,3,0,0,2,0,4,5,1
13278,195397,Px3zRsOzY6lifmzZgnqcwuqsaYej1KKL,A3fsA9Zfv1X2fVEQhTw51lKENdNrEqT3,1,0,0,0,0,0,1,0,1,0.14285714285714285,1,0.0,0,0,0,0,0,0,0,1,0,0,1,0
13279,195413,bvN6XOPoER6NVEf5NoGSs2X6xsEr92h3,SpATywNh6bZuzm8s1ceuBUnMUAeoAHHw,8,3,1,0,1,0,4,1,10,1.4285714285714286,1,0.0,0,1,0,1,3,0,0,4,1,2,8,1
13280,195423,5qPjBVti4pvxDDFGs1UFTjnAG1OLcLcB,RXDvfPUBYFlVdlueBFbLW0mhhAyGEqpt,3,2,0,0,0,0,1,0,3,0.42857142857142855,1,0.0,0,0,0,0,2,0,0,1,0,0,3,1
13281,195425,izM8opj3xJHFbPsERjrPScHIIGoVU3sL,SpATywNh6bZuzm8s1ceuBUnMUAeoAHHw,6,0,0,0,0,1,12,1,14,2.0,1,0.0,0,0,0,0,0,1,0,12,1,0,14,1
13282,195430,fHIOg4CLMDgqxwisMJ0FCaIJdtYNnnlj,SpATywNh6bZuzm8s1ceuBUnMUAeoAHHw,4,2,1,0,1,0,1,0,5,0.7142857142857143,1,0.0,0,1,0,1,2,0,0,1,0,2,3,1
13283,195432,LICyXxeZEgLwXHk4xrNu6rCpPIKDNqKx,bWdj2GDclj5ofokWjzoa5jAwMkxCykd6,4,0,0,0,0,2,3,1,6,0.8571428571428571,1,0.0,0,0,0,0,0,2,0,3,1,0,6,0
13284,195452,k57D5r1HBQsYTFYwjCvC4VLOFbsyC3KY,bWdj2GDclj5ofokWjzoa5jAwMkxCykd6,5,2,1,0,1,0,2,0,6,0.8571428571428571,1,0.0,0,1,0,1,2,0,0,2,0,2,4,1
13285,195453,k57D5r1HBQsYTFYwjCvC4VLOFbsyC3KY,A3fsA9Zfv1X2fVEQhTw51lKENdNrEqT3,9,4,3,0,3,0,2,0,12,1.7142857142857142,1,0.0,0,3,0,3,4,0,0,2,0,6,6,1
13286,195458,fp4riRNidjgqRkLYeMfperPsuliabiil,A3fsA9Zfv1X2fVEQhTw51lKENdNrEqT3,2,0,0,0,0,0,2,0,2,0.2857142857142857,1,0.0,0,0,0,0,0,0,0,2,0,0,2,1
13287,195463,Vc1baHxuYCOF9wXqOziB65UR0NyB8LSm,A3fsA9Zfv1X2fVEQhTw51lKENdNrEqT3,4,2,1,0,1,0,1,0,5,0.7142857142857143,1,0.0,0,1,0,1,2,0,0,1,0,2,3,1
13288,195471,VCHjbUg5mmZIrDffSGKLebg8S6dLXnyn,SpATywNh6bZuzm8s1ceuBUnMUAeoAHHw,2,0,0,0,0,0,2,0,2,0.2857142857142857,1,0.0,0,0,0,0,0,0,0,2,0,0,2,1
13289,195475,VCHjbUg5mmZIrDffSGKLebg8S6dLXnyn,RXDvfPUBYFlVdlueBFbLW0mhhAyGEqpt,2,0,0,0,0,0,2,0,2,0.2857142857142857,1,0.0,0,0,0,0,0,0,0,2,0,0,2,0
13290,195495,s6FY1tnJFeJCup1Eko54ROGWiTGeTtYm,bWdj2GDclj5ofokWjzoa5jAwMkxCykd6,1,0,0,0,0,0,1,0,1,0.14285714285714285,1,0.0,0,0,0,0,0,0,0,1,0,0,1,1
13291,195497,s6FY1tnJFeJCup1Eko54ROGWiTGeTtYm,A3fsA9Zfv1X2fVEQhTw51lKENdNrEqT3,2,0,0,0,0,0,2,0,2,0.2857142857142857,1,0.0,0,0,0,0,0,0,0,2,0,0,2,1
13292,195501,Sy7PnSgnanE6MmRmOk45JZv7731jQKG6,SpATywNh6bZuzm8s1ceuBUnMUAeoAHHw,4,3,0,0,0,0,3,0,6,0.8571428571428571,1,0.0,0,0,0,0,3,0,0,3,0,0,6,1
13293,195511,KzP79COW0J6jugsTdx8JCjyWx6PlJCcn,bWdj2GDclj5ofokWjzoa5jAwMkxCykd6,4,0,0,0,0,1,3,0,4,0.5714285714285714,1,0.0,0,0,0,0,0,1,0,3,0,0,4,1
13294,195530,OuoRlyFtQHB6CBdOhxOFsh6hGiNcDFNC,SpATywNh6bZuzm8s1ceuBUnMUAeoAHHw,1,0,0,0,0,0,1,0,1,0.14285714285714285,1,0.0,0,0,0,0,0,0,0,1,0,0,1,1
13295,195542,BXV7sGq2IrRSqCFuLKgoxpKYDPSPpUSj,SpATywNh6bZuzm8s1ceuBUnMUAeoAHHw,9,3,2,0,1,0,6,1,13,1.8571428571428572,1,0.0,0,2,0,1,3,0,0,6,1,3,10,1
13296,195544,BXV7sGq2IrRSqCFuLKgoxpKYDPSPpUSj,G8EPVSXsOYB5YQWZGiz1aVq5Pgr2GrQu,1,0,0,0,0,0,1,0,1,0.14285714285714285,1,0.0,0,0,0,0,0,0,0,1,0,0,1,1
13297,195552,xNnZt1wpctMu8RWBLbfzbKE1cqLvtEr3,G8EPVSXsOYB5YQWZGiz1aVq5Pgr2GrQu,1,0,0,0,0,0,1,0,1,0.14285714285714285,1,0.0,0,0,0,0,0,0,0,1,0,0,1,1
13298,195557,23A4h0mJIxgdd7Lfc0ogX2OGnwyxoL13,SpATywNh6bZuzm8s1ceuBUnMUAeoAHHw,5,9,1,0,1,0,1,0,12,1.7142857142857142,1,0.0,0,1,0,1,9,0,0,1,0,2,10,1
13299,195558,xUhDcXiX03QQg1jNR3Lksh9CrGcRUkPg,SpATywNh6bZuzm8s1ceuBUnMUAeoAHHw,1,0,0,0,0,0,1,0,1,0.14285714285714285,1,0.0,0,0,0,0,0,0,0,1,0,0,1,0
13300,195562,mfr902ctNImyZnb2hOpmu3P3IkYTM2W3,G8EPVSXsOYB5YQWZGiz1aVq5Pgr2GrQu,37,55,14,64,7,0,1,0,141,20.142857142857142,1,0.0,32,14,43,7,23,0,21,1,0,96,45,1
13301,195570,UcPGwduguQweVEpy1bHMRcDAVjaxDzZ7,G8EPVSXsOYB5YQWZGiz1aVq5Pgr2GrQu,7,3,2,0,2,0,2,0,9,1.2857142857142858,1,0.0,0,2,0,2,3,0,0,2,0,4,5,1
13302,195572,SSpeewBDHUNKkvUJM5ASinNHvMXIOEwr,A3fsA9Zfv1X2fVEQhTw51lKENdNrEqT3,2,0,0,0,0,2,2,0,4,0.5714285714285714,1,0.0,0,0,0,0,0,2,0,2,0,0,4,1
13303,195616,Kcq3gQRtZRNf9DA8M7wqRqrJH838UPPz,7GRhBDsirIGkRZBtSMEzNTyDr2JQm4xx,17,30,12,6,5,17,8,0,78,11.142857142857142,1,0.0,8,12,3,5,22,17,3,8,0,28,50,1
13304,195619,DS74xqPNpZwZQjbZ7YGZYJfVghg7Q9HH,7GRhBDsirIGkRZBtSMEzNTyDr2JQm4xx,5,3,1,0,1,0,2,0,7,1.0,1,0.0,1,1,0,1,2,0,0,2,0,3,4,1
13305,195622,Tcaf2GTbOMScFZKlh1LFlKzosiyvJhfT,7GRhBDsirIGkRZBtSMEzNTyDr2JQm4xx,1,0,0,0,0,0,1,0,1,0.14285714285714285,1,0.0,0,0,0,0,0,0,0,1,0,0,1,1
13306,195648,juzfwxHXCKii6ul7funGUBQbDVPCyrBB,7GRhBDsirIGkRZBtSMEzNTyDr2JQm4xx,1,0,0,0,0,0,1,0,1,0.14285714285714285,1,0.0,0,0,0,0,0,0,0,1,0,0,1,1
13307,195720,GWmVmhZO8RKaiQ4dKIoawnWCScVz2MBi,7GRhBDsirIGkRZBtSMEzNTyDr2JQm4xx,2,0,0,0,0,0,2,0,2,0.2857142857142857,1,0.0,0,0,0,0,0,0,0,2,0,0,2,1
13308,195758,MpTAgw3ozhmeD7C8xc95FgAYRb7j4nGM,7GRhBDsirIGkRZBtSMEzNTyDr2JQm4xx,3,2,1,0,0,0,2,0,5,0.7142857142857143,1,0.0,0,1,0,0,2,0,0,2,0,1,4,1
13309,195772,E61JfTQnEaIkaCE4GRNSaG2A1gMqzhfA,7GRhBDsirIGkRZBtSMEzNTyDr2JQm4xx,1,0,0,0,0,0,1,0,1,0.14285714285714285,1,0.0,0,0,0,0,0,0,0,1,0,0,1,1
13310,195779,5AbPWjZ6ixqm6XZz56tS5VZ41TKzUcUl,7GRhBDsirIGkRZBtSMEzNTyDr2JQm4xx,1,0,0,0,0,0,1,0,1,0.14285714285714285,1,0.0,0,0,0,0,0,0,0,1,0,0,1,1
13311,195780,xyxmqhkuTJtB1dPu1gtPCQSBFbuRU8fb,7GRhBDsirIGkRZBtSMEzNTyDr2JQm4xx,9,6,0,4,0,1,6,3,20,2.857142857142857,1,0.0,2,0,3,0,4,1,1,6,3,5,15,1
13312,197544,FySmfd2hS941zbI2PjxLl96G2jk3gIlQ,bWdj2GDclj5ofokWjzoa5jAwMkxCykd6,1,0,0,0,0,0,1,0,1,0.14285714285714285,1,0.0,0,0,0,0,0,0,0,1,0,0,1,1
13313,197561,1sxU5u2tB4cfcS6yRjPgL8Lbs961wxI1,A3fsA9Zfv1X2fVEQhTw51lKENdNrEqT3,1,0,0,0,0,0,1,0,1,0.14285714285714285,1,0.0,0,0,0,0,0,0,0,1,0,0,1,1
13314,197565,cSPs7Fdln4Ch49nnOhLrL6tMXQVWaRtw,SpATywNh6bZuzm8s1ceuBUnMUAeoAHHw,1,0,0,0,0,0,1,0,1,0.14285714285714285,1,0.0,0,0,0,0,0,0,0,1,0,0,1,1
13315,197581,3UIhyDBe2cVwfnPbxOe5VWApIlUgpsbX,bWdj2GDclj5ofokWjzoa5jAwMkxCykd6,1,0,0,0,0,0,1,0,1,0.14285714285714285,1,0.0,0,0,0,0,0,0,0,1,0,0,1,1
13316,197585,wrEd0NIQV39m2xEAHNuU1Ww6eryiacbC,SpATywNh6bZuzm8s1ceuBUnMUAeoAHHw,11,15,0,21,0,4,3,0,43,6.142857142857143,1,0.0,7,0,18,0,8,4,3,3,0,25,18,1
13317,197592,ECkqmAuIkv3ncN9wNJby8oOn15qTd9kR,RXDvfPUBYFlVdlueBFbLW0mhhAyGEqpt,1,0,0,0,0,0,2,0,2,0.2857142857142857,1,0.0,0,0,0,0,0,0,0,2,0,0,2,1
13318,197598,RCC0chPMKpWYHBcYuZNQFLP3RQicCreS,SpATywNh6bZuzm8s1ceuBUnMUAeoAHHw,2,0,0,0,0,0,3,0,3,0.42857142857142855,1,0.0,0,0,0,0,0,0,0,3,0,0,3,1
13319,197603,xOGjXyyeq87fCMSZ9z7Yuds9sMvR7Ohh,A3fsA9Zfv1X2fVEQhTw51lKENdNrEqT3,20,12,10,0,10,0,1,0,33,4.714285714285714,1,0.0,0,10,0,10,12,0,0,1,0,20,13,1
13320,197604,xWQhq9RZKw08hANIa0LgFXN2DnwycQf4,bWdj2GDclj5ofokWjzoa5jAwMkxCykd6,5,2,1,0,1,0,2,0,6,0.8571428571428571,1,0.0,0,1,0,1,2,0,0,2,0,2,4,1
13321,197622,d8GXnhJ8BgnDSKpTLyLaGdg2jK5wWL8e,G8EPVSXsOYB5YQWZGiz1aVq5Pgr2GrQu,27,31,11,10,12,0,9,0,73,10.428571428571429,1,0.0,17,11,6,12,14,0,4,9,0,46,27,1
13322,197629,pyv0DnRM0PUGZlRUjUkquPGtUI5wlNKd,bWdj2GDclj5ofokWjzoa5jAwMkxCykd6,3,0,0,0,0,0,3,0,3,0.42857142857142855,1,0.0,0,0,0,0,0,0,0,3,0,0,3,1
13323,197633,klchONEdPI3u3wOB4C8jNpM0hCX3C5RZ,RXDvfPUBYFlVdlueBFbLW0mhhAyGEqpt,24,23,17,7,12,0,4,0,63,9.0,1,0.0,3,17,7,12,20,0,0,4,0,39,24,1
13324,197640,ybqXs1BYgb66Ubmo4CtWBedAmyNUZkNR,SpATywNh6bZuzm8s1ceuBUnMUAeoAHHw,5,2,1,0,1,0,3,0,7,1.0,1,0.0,0,1,0,1,2,0,0,3,0,2,5,1
13325,197645,hbSZ24mH4oabI0uhhWxmu9uILNkjYUT4,SpATywNh6bZuzm8s1ceuBUnMUAeoAHHw,6,1,1,0,1,0,3,0,6,0.8571428571428571,1,0.0,0,1,0,1,1,0,0,3,0,2,4,1
13326,197658,VhMVe0e0vgyahnrJinzgUUFfkUYIGngP,bWdj2GDclj5ofokWjzoa5jAwMkxCykd6,1,0,0,0,0,0,1,0,1,0.14285714285714285,1,0.0,0,0,0,0,0,0,0,1,0,0,1,1
13327,197660,4fYqS5i8zH5iFL9FCzQ9Jw4wAZdnrAvU,RXDvfPUBYFlVdlueBFbLW0mhhAyGEqpt,8,5,4,0,2,0,1,0,12,1.7142857142857142,1,0.0,0,4,0,2,5,0,0,1,0,6,6,1
13328,197671,bRDOwsDzRQZuxjrOsoP53hDwwMbqZqej,SpATywNh6bZuzm8s1ceuBUnMUAeoAHHw,1,0,0,0,0,0,1,0,1,0.14285714285714285,1,0.0,0,0,0,0,0,0,0,1,0,0,1,1
13329,197673,f0YMm9i9boHqaqH06EMyOVgZ4eqVoTpv,SpATywNh6bZuzm8s1ceuBUnMUAeoAHHw,9,10,7,0,0,1,9,1,28,4.0,1,0.0,0,7,0,0,10,1,0,9,1,7,21,0
13330,197674,PpAhko9wN0CoGGKMK5cOihgQKnJKH7vJ,SpATywNh6bZuzm8s1ceuBUnMUAeoAHHw,1,0,0,0,0,0,1,0,1,0.14285714285714285,1,0.0,0,0,0,0,0,0,0,1,0,0,1,1
13331,197684,1oYUpAzbanZgtAfH9FWjQtyhbjb42Xx4,bWdj2GDclj5ofokWjzoa5jAwMkxCykd6,1,0,0,0,0,0,1,0,1,0.14285714285714285,1,0.0,0,0,0,0,0,0,0,1,0,0,1,1
13332,197685,1oYUpAzbanZgtAfH9FWjQtyhbjb42Xx4,RXDvfPUBYFlVdlueBFbLW0mhhAyGEqpt,1,0,0,0,0,0,1,0,1,0.14285714285714285,1,0.0,0,0,0,0,0,0,0,1,0,0,1,1
13333,197695,4fYqS5i8zH5iFL9FCzQ9Jw4wAZdnrAvU,bWdj2GDclj5ofokWjzoa5jAwMkxCykd6,4,2,1,0,1,0,1,0,5,0.7142857142857143,1,0.0,0,1,0,1,2,0,0,1,0,2,3,1
13334,197700,iKVVP8eq0ppb7OxMxmGwiOY8iziYmfHr,A3fsA9Zfv1X2fVEQhTw51lKENdNrEqT3,1,0,0,0,0,0,2,0,2,0.2857142857142857,1,0.0,0,0,0,0,0,0,0,2,0,0,2,1
13335,197708,HE0yFYNeyW3jGh5EhXv7uoc6O18ATk5R,A3fsA9Zfv1X2fVEQhTw51lKENdNrEqT3,19,10,8,0,8,0,1,0,27,3.857142857142857,1,0.0,0,8,0,8,10,0,0,1,0,16,11,1
13336,197723,A2szMVZ2xHQSx9WPUKhhkvBSuScZqBJF,A3fsA9Zfv1X2fVEQhTw51lKENdNrEqT3,13,7,5,0,5,0,1,0,18,2.5714285714285716,1,0.0,0,5,0,5,7,0,0,1,0,10,8,1
13337,197732,jqN3FAeYERU2lkKz9K4K9sLSZnaWl5Zg,SpATywNh6bZuzm8s1ceuBUnMUAeoAHHw,4,3,1,0,1,0,3,0,8,1.1428571428571428,1,0.0,0,1,0,1,3,0,0,3,0,2,6,1
13338,197737,HhuDqntCSTLCVngcOF2eAHqFrhEVuPmX,SpATywNh6bZuzm8s1ceuBUnMUAeoAHHw,4,2,0,0,0,0,2,0,4,0.5714285714285714,1,0.0,0,0,0,0,2,0,0,2,0,0,4,1
13339,197803,vtBnoyzeCC8wZr284IGH2R9KjVsQkSSy,SpATywNh6bZuzm8s1ceuBUnMUAeoAHHw,1,0,0,0,0,0,1,0,1,0.14285714285714285,1,0.0,0,0,0,0,0,0,0,1,0,0,1,1
13340,197827,mVLfrQRFV4YD7pibAFgNSJRdbeuiy0Sw,G8EPVSXsOYB5YQWZGiz1aVq5Pgr2GrQu,1,0,0,0,0,0,1,0,1,0.14285714285714285,1,0.0,0,0,0,0,0,0,0,1,0,0,1,1
13341,197843,1AZmjj77W8BIGEE1Hrm2nLFWlidLNL1Q,G8EPVSXsOYB5YQWZGiz1aVq5Pgr2GrQu,3,1,0,0,0,0,2,0,3,0.42857142857142855,1,0.0,0,0,0,0,1,0,0,2,0,0,3,1
13342,197860,kukBD4x4uH6xHKp8zwbeAlZ5XIJZfUlp,SpATywNh6bZuzm8s1ceuBUnMUAeoAHHw,5,2,1,0,1,0,2,0,6,0.8571428571428571,1,0.0,0,1,0,1,2,0,0,2,0,2,4,1
13343,197865,UmYxiFu6na7ioq4pFJaZYbHcM2Oxxqgd,SpATywNh6bZuzm8s1ceuBUnMUAeoAHHw,11,8,5,8,3,0,5,0,29,4.142857142857143,1,0.0,2,5,8,3,6,0,0,5,0,18,11,1
13344,197867,NvxM2w7KuHaUb4w9IwWeNWL1FPcoZWlg,SpATywNh6bZuzm8s1ceuBUnMUAeoAHHw,4,3,2,0,0,0,1,0,6,0.8571428571428571,1,0.0,0,2,0,0,3,0,0,1,0,2,4,1
13345,197891,ew6rgTKhfFlJk0TBM29erpe2hVQwpNiX,bWdj2GDclj5ofokWjzoa5jAwMkxCykd6,3,0,0,0,0,0,3,0,3,0.42857142857142855,1,0.0,0,0,0,0,0,0,0,3,0,0,3,1
13346,197901,3E2J8oODQN7NkqxkMAgArJcF2FBjPre3,G8EPVSXsOYB5YQWZGiz1aVq5Pgr2GrQu,10,5,3,0,3,0,4,0,15,2.142857142857143,1,0.0,0,3,0,3,5,0,0,4,0,6,9,1
13347,197903,quZIfUvhbgq4XxK5fzctoX77uKRPby0l,SpATywNh6bZuzm8s1ceuBUnMUAeoAHHw,5,4,1,0,1,0,1,0,7,1.0,1,0.0,0,1,0,1,4,0,0,1,0,2,5,1
13348,197906,kSxsrTO5exODRPeD7VJyPIeGcMKlqOQM,A3fsA9Zfv1X2fVEQhTw51lKENdNrEqT3,1,0,0,0,0,0,1,0,1,0.14285714285714285,1,0.0,0,0,0,0,0,0,0,1,0,0,1,1
13349,197912,OM3FARUmSrkVmJXDiM3P0y6LhqqplIHH,SpATywNh6bZuzm8s1ceuBUnMUAeoAHHw,6,2,1,0,1,0,4,0,8,1.1428571428571428,1,0.0,0,1,0,1,2,0,0,4,0,2,6,1
13350,197920,Jmn2E7XgQKFifDbJIxuDxMHLi4YpW3jx,G8EPVSXsOYB5YQWZGiz1aVq5Pgr2GrQu,3,0,0,0,0,4,2,0,6,0.8571428571428571,1,0.0,0,0,0,0,0,4,0,2,0,0,6,1
13351,197928,oqI20pdqFt40phk7jIrltWVMqWvZcban,A3fsA9Zfv1X2fVEQhTw51lKENdNrEqT3,1,0,0,0,0,0,1,0,1,0.14285714285714285,1,0.0,0,0,0,0,0,0,0,1,0,0,1,1
13352,197963,xp0PGlV4qhp60qYyxRe8xCxRmmPbM3Jj,bWdj2GDclj5ofokWjzoa5jAwMkxCykd6,1,0,0,0,0,0,4,0,4,0.5714285714285714,1,0.0,0,0,0,0,0,0,0,4,0,0,4,1
13353,197968,Kc8b3JW1MQKQC6TGWRiZEShHUO8QsHV5,SpATywNh6bZuzm8s1ceuBUnMUAeoAHHw,1,0,0,0,0,0,1,0,1,0.14285714285714285,1,0.0,0,0,0,0,0,0,0,1,0,0,1,1
13354,197975,xlZo0JM0E05KNiKs7UHaCnGkhTzmaKtg,SpATywNh6bZuzm8s1ceuBUnMUAeoAHHw,2,0,0,0,0,0,2,0,2,0.2857142857142857,1,0.0,0,0,0,0,0,0,0,2,0,0,2,1
13355,197977,WbJsJWqKM3lS43E1ayfblK0uOswvkrBy,bWdj2GDclj5ofokWjzoa5jAwMkxCykd6,2,0,0,0,0,0,3,0,3,0.42857142857142855,1,0.0,0,0,0,0,0,0,0,3,0,0,3,1
13356,197984,h4sY8Ph1vbc191O1JmHGbdnyocsoSDQO,G8EPVSXsOYB5YQWZGiz1aVq5Pgr2GrQu,5,10,1,0,0,0,3,0,14,2.0,1,0.0,0,1,0,0,10,0,0,3,0,1,13,1
13357,197985,qMtHlzOZxaTrhiGkJGWyjk6FQrkiMtpo,SpATywNh6bZuzm8s1ceuBUnMUAeoAHHw,4,3,0,0,0,0,3,0,6,0.8571428571428571,1,0.0,0,0,0,0,3,0,0,3,0,0,6,1
13358,197986,UZPajHzpSX5mbiv3Scxfu2s5ueCVoTcN,RXDvfPUBYFlVdlueBFbLW0mhhAyGEqpt,5,0,0,0,0,0,5,1,6,0.8571428571428571,1,0.0,0,0,0,0,0,0,0,5,1,0,6,1
13359,197990,EH79kaJEIeXcrssngPKoTUSLUCjHUazt,A3fsA9Zfv1X2fVEQhTw51lKENdNrEqT3,2,0,0,0,0,0,4,0,4,0.5714285714285714,1,0.0,0,0,0,0,0,0,0,4,0,0,4,1
13360,197996,6hX10Wu1E2KDRE7mYGP1VPoNRkdF7lrL,A3fsA9Zfv1X2fVEQhTw51lKENdNrEqT3,3,0,0,0,0,0,3,0,3,0.42857142857142855,1,0.0,0,0,0,0,0,0,0,3,0,0,3,0
13361,197999,NVzsLV2hJQHxCBnLyaDpT9HrhRSWUOfa,A3fsA9Zfv1X2fVEQhTw51lKENdNrEqT3,2,0,0,0,0,0,2,0,2,0.2857142857142857,1,0.0,0,0,0,0,0,0,0,2,0,0,2,1
13362,198002,Juod2UGp1EISVAlVAqDeLcVK1OmKMlrq,A3fsA9Zfv1X2fVEQhTw51lKENdNrEqT3,5,2,1,0,1,1,4,0,9,1.2857142857142858,1,0.0,0,1,0,1,2,1,0,4,0,2,7,1
13363,198015,G40CqBl9Wk8vBpLpRLZfdLIUELNw0IuK,bWdj2GDclj5ofokWjzoa5jAwMkxCykd6,11,20,7,32,6,1,8,0,74,10.571428571428571,1,0.0,8,7,30,6,12,1,2,8,0,51,23,1
13364,198020,mBkByOktWGTfbLjZh4oUEAyrYqB4PqkG,A3fsA9Zfv1X2fVEQhTw51lKENdNrEqT3,5,3,1,0,1,0,2,0,7,1.0,1,0.0,0,1,0,1,3,0,0,2,0,2,5,1
13365,198037,ptvJrZNOUMqIwb7dgd5momqDwhHuKgqy,A3fsA9Zfv1X2fVEQhTw51lKENdNrEqT3,1,0,0,0,0,0,1,0,1,0.14285714285714285,1,0.0,0,0,0,0,0,0,0,1,0,0,1,1
13366,198039,mBkByOktWGTfbLjZh4oUEAyrYqB4PqkG,bWdj2GDclj5ofokWjzoa5jAwMkxCykd6,7,7,2,10,1,0,2,0,22,3.142857142857143,1,0.0,2,2,9,1,5,0,1,2,0,14,8,1
13367,198040,hwsOMQoQpEm6hpx9rFynsAz9z0b8kZIy,SpATywNh6bZuzm8s1ceuBUnMUAeoAHHw,6,3,1,0,0,0,3,1,8,1.1428571428571428,1,0.0,0,1,0,0,3,0,0,3,1,1,7,1
13368,198057,ZPbUovw1YoDeaWUVrbGEj5A5WdIXTYjf,A3fsA9Zfv1X2fVEQhTw51lKENdNrEqT3,41,20,16,58,10,4,3,0,111,15.857142857142858,1,0.0,1,16,52,10,19,4,6,3,0,79,32,1
13369,198059,THP1XMjHSxStaFTc2EbpYMi7w0ocTWsv,A3fsA9Zfv1X2fVEQhTw51lKENdNrEqT3,2,0,0,0,0,0,2,0,2,0.2857142857142857,1,0.0,0,0,0,0,0,0,0,2,0,0,2,1
13370,198064,FmREEBmKaoWQV1gJ6HLZOzgC3kziEupI,SpATywNh6bZuzm8s1ceuBUnMUAeoAHHw,9,6,3,5,2,0,2,0,18,2.5714285714285716,1,0.0,2,3,4,2,4,0,1,2,0,11,7,1
13371,198072,ydSu1htsBf3RzcwY9UTcwNk58kfOh1CK,A3fsA9Zfv1X2fVEQhTw51lKENdNrEqT3,1,0,0,0,0,0,1,0,1,0.14285714285714285,1,0.0,0,0,0,0,0,0,0,1,0,0,1,1
13372,198075,Zh41FGMVAot9ISpRqN7C51AlQVbP6TRp,G8EPVSXsOYB5YQWZGiz1aVq5Pgr2GrQu,1,0,0,0,0,0,1,0,1,0.14285714285714285,1,0.0,0,0,0,0,0,0,0,1,0,0,1,1
13373,198089,1Y8zyxJNFqsbAxngaSR4MBCJMYy7aumA,A3fsA9Zfv1X2fVEQhTw51lKENdNrEqT3,1,0,0,0,0,0,1,0,1,0.14285714285714285,1,0.0,0,0,0,0,0,0,0,1,0,0,1,1
13374,198092,7qSkKlCfwbOANWGSAwfdpq7Q0evXlyXJ,A3fsA9Zfv1X2fVEQhTw51lKENdNrEqT3,2,0,0,0,0,0,2,0,2,0.2857142857142857,1,0.0,0,0,0,0,0,0,0,2,0,0,2,1
13375,198094,NVHlXFJKdfwucYR5YquGJkYfegUD35pC,bWdj2GDclj5ofokWjzoa5jAwMkxCykd6,1,0,0,0,0,0,1,0,1,0.14285714285714285,1,0.0,0,0,0,0,0,0,0,1,0,0,1,1
13376,198096,gQqEJZs7B37MmzRexP5otRszUHd2KLYy,A3fsA9Zfv1X2fVEQhTw51lKENdNrEqT3,18,11,9,0,7,0,4,0,31,4.428571428571429,1,0.0,0,9,0,7,11,0,0,4,0,16,15,1
13377,198102,UmMUmfW7iDbccQsjMsWCLdabczIvW3k8,G8EPVSXsOYB5YQWZGiz1aVq5Pgr2GrQu,10,20,7,10,4,0,4,0,45,6.428571428571429,1,0.0,10,7,6,4,10,0,4,4,0,27,18,1
13378,198108,tpRB0Y2odcJ8wbxdjaREs5gktwFdDR2h,A3fsA9Zfv1X2fVEQhTw51lKENdNrEqT3,46,72,30,82,21,41,15,3,264,37.714285714285715,1,0.0,1,30,64,21,71,41,18,15,3,116,148,1
13379,198110,Psbjgi8UNl2rcrsYIe1cv0JHA13unwqh,A3fsA9Zfv1X2fVEQhTw51lKENdNrEqT3,9,6,4,0,3,0,1,0,14,2.0,1,0.0,0,4,0,3,6,0,0,1,0,7,7,1
13380,198119,ivQxpA3T4qXcNV0IuvLDkzJLb00vpKY1,A3fsA9Zfv1X2fVEQhTw51lKENdNrEqT3,9,5,4,0,4,0,3,0,16,2.2857142857142856,1,0.0,0,4,0,4,5,0,0,3,0,8,8,1
13381,198123,Bobzv8PFDIeID7NJyzm72ZPzBi51TYoj,G8EPVSXsOYB5YQWZGiz1aVq5Pgr2GrQu,4,1,0,0,0,0,6,0,7,1.0,1,0.0,0,0,0,0,1,0,0,6,0,0,7,1
13382,198126,EuJrP6kozTqtmrZ2kvjKbbdLy1MAtd6Q,G8EPVSXsOYB5YQWZGiz1aVq5Pgr2GrQu,5,2,0,0,0,0,3,0,5,0.7142857142857143,1,0.0,0,0,0,0,2,0,0,3,0,0,5,1
13383,198127,NRHQ3tSUEv4DHf8jZg8RV7YWaKkLB0Yk,A3fsA9Zfv1X2fVEQhTw51lKENdNrEqT3,4,3,0,0,0,0,2,0,5,0.7142857142857143,1,0.0,1,0,0,0,2,0,0,2,0,1,4,1
13384,198148,PumYHOn9wm04kyhWSxqPbI3SWXpAfHRE,bWdj2GDclj5ofokWjzoa5jAwMkxCykd6,5,11,3,0,3,0,2,0,19,2.7142857142857144,1,0.0,4,3,0,3,7,0,0,2,0,10,9,1
13385,198151,1DCeTt0CkcmxoPvN3IFKoXhg62qIczOd,G8EPVSXsOYB5YQWZGiz1aVq5Pgr2GrQu,7,4,1,0,1,0,3,0,9,1.2857142857142858,1,0.0,0,1,0,1,4,0,0,3,0,2,7,1
13386,198157,BnOHUZJJ8tQ0RqiSOgsTvzjr9EqA1Ahw,A3fsA9Zfv1X2fVEQhTw51lKENdNrEqT3,2,0,0,0,0,0,4,0,4,0.5714285714285714,1,0.0,0,0,0,0,0,0,0,4,0,0,4,1
13387,198160,BAyN80jjR5TuHhGoBQcino62lPw8bhBn,A3fsA9Zfv1X2fVEQhTw51lKENdNrEqT3,8,7,5,0,3,0,5,0,20,2.857142857142857,1,0.0,0,5,0,3,7,0,0,5,0,8,12,1
13388,198164,Wm4d7ifDaTgcR0GfUqwJt5OZKbYglRCq,A3fsA9Zfv1X2fVEQhTw51lKENdNrEqT3,1,0,0,0,0,0,1,0,1,0.14285714285714285,1,0.0,0,0,0,0,0,0,0,1,0,0,1,1
13389,198174,sN8O8pu3Q2qKEwnDCRLYVlmO1uAJE4Tm,bWdj2GDclj5ofokWjzoa5jAwMkxCykd6,2,0,0,0,0,0,2,0,2,0.2857142857142857,1,0.0,0,0,0,0,0,0,0,2,0,0,2,1
13390,198185,sAxHVWDxoGkBRa6727BiAQz0xOxKCIGR,A3fsA9Zfv1X2fVEQhTw51lKENdNrEqT3,13,12,6,12,5,0,4,0,39,5.571428571428571,1,0.0,0,6,10,5,12,0,2,4,0,21,18,1
13391,198188,l5G8UW1TXnTSjtyKClgVOnqQm4ApNaj0,SpATywNh6bZuzm8s1ceuBUnMUAeoAHHw,1,0,0,0,0,0,1,0,1,0.14285714285714285,1,0.0,0,0,0,0,0,0,0,1,0,0,1,1
13392,198191,5bHmfN0X9wT3swMDlkpW5ii5MZXZrCFW,SpATywNh6bZuzm8s1ceuBUnMUAeoAHHw,15,22,6,19,4,2,4,0,57,8.142857142857142,1,0.0,15,6,16,4,7,2,3,4,0,41,16,1
13393,198193,LFKsM29SPdpn03mCOLrrK3FdXPUDZBKB,A3fsA9Zfv1X2fVEQhTw51lKENdNrEqT3,5,2,1,0,1,0,5,0,9,1.2857142857142858,1,0.0,0,1,0,1,2,0,0,5,0,2,7,1
13394,198197,SC8FL9WL3BPOx8OCkTnqw5xmr73Pqs8z,A3fsA9Zfv1X2fVEQhTw51lKENdNrEqT3,7,4,3,0,3,0,2,0,12,1.7142857142857142,1,0.0,0,3,0,3,4,0,0,2,0,6,6,1
13395,198198,93Os1dPmyvzf4unZeLzWAm1E98vamZ7f,SpATywNh6bZuzm8s1ceuBUnMUAeoAHHw,5,2,1,0,1,0,2,0,6,0.8571428571428571,1,0.0,0,1,0,1,2,0,0,2,0,2,4,1
13396,198209,xudoA9elSC5Ik0l8XT7ohHiAxUwBFTwg,SpATywNh6bZuzm8s1ceuBUnMUAeoAHHw,14,9,6,11,4,0,2,0,32,4.571428571428571,1,0.0,2,6,9,4,7,0,2,2,0,21,11,1
13397,198227,NXiIb9Dcpvf6m1gIchCaIvmdnXDXN6rC,A3fsA9Zfv1X2fVEQhTw51lKENdNrEqT3,21,10,9,0,9,1,12,1,42,6.0,1,0.0,0,9,0,9,10,1,0,12,1,18,24,1
13398,198228,So8gZ8cXseEZ7lXf4idNMqcN46bXtlIA,bWdj2GDclj5ofokWjzoa5jAwMkxCykd6,4,2,1,0,1,0,1,0,5,0.7142857142857143,1,0.0,0,1,0,1,2,0,0,1,0,2,3,1
13399,198231,tblYMREbAeB7j9qmk5L4ctIeWrhD9ybH,A3fsA9Zfv1X2fVEQhTw51lKENdNrEqT3,1,0,0,0,0,0,1,0,1,0.14285714285714285,1,0.0,0,0,0,0,0,0,0,1,0,0,1,1
13400,198245,qq2f8Akny1ajULPtgXYv9fMRWduKMr9q,A3fsA9Zfv1X2fVEQhTw51lKENdNrEqT3,7,2,1,0,1,0,4,1,9,1.2857142857142858,1,0.0,0,1,0,1,2,0,0,4,1,2,7,1
13401,198253,eZIzehl9YTnThSDhfRvumYM9JAWW8X94,A3fsA9Zfv1X2fVEQhTw51lKENdNrEqT3,9,6,1,0,1,1,5,3,17,2.4285714285714284,1,0.0,0,1,0,1,6,1,0,5,3,2,15,1
13402,198257,FM9F7roZRXjjLVpKJMa3bf9FDgpJfg8g,A3fsA9Zfv1X2fVEQhTw51lKENdNrEqT3,1,0,0,0,0,0,1,0,1,0.14285714285714285,1,0.0,0,0,0,0,0,0,0,1,0,0,1,1
13403,198260,84GcjGYfYBEDW8RMth7eOtG4XRkKowY7,SpATywNh6bZuzm8s1ceuBUnMUAeoAHHw,5,5,2,0,1,0,2,0,10,1.4285714285714286,1,0.0,0,2,0,1,5,0,0,2,0,3,7,1
13404,198261,2dPSdalUbHtu7nWWfNnHcWGVd8UXHjrQ,SpATywNh6bZuzm8s1ceuBUnMUAeoAHHw,16,16,5,11,3,1,4,2,42,6.0,1,0.0,7,5,10,3,9,1,1,4,2,25,17,1
13405,198266,itycNCCvd4Cws5pdd4hKIkDKI4KaE5Jt,A3fsA9Zfv1X2fVEQhTw51lKENdNrEqT3,27,11,10,16,9,0,1,0,47,6.714285714285714,1,0.0,0,10,16,9,11,0,0,1,0,35,12,1
13406,198268,aIL1NEjCe1OHtEKm6JpGdIdTZNDD6Wwu,SpATywNh6bZuzm8s1ceuBUnMUAeoAHHw,1,0,0,0,0,0,1,0,1,0.14285714285714285,1,0.0,0,0,0,0,0,0,0,1,0,0,1,1
13407,198273,3UZJYrArdmpKznqwnck7MTEpjxG34pMK,SpATywNh6bZuzm8s1ceuBUnMUAeoAHHw,5,2,1,0,1,0,2,0,6,0.8571428571428571,1,0.0,0,1,0,1,2,0,0,2,0,2,4,1
13408,198284,TPwZPOPBUdCaLSbv54gObUYtfBQKaJVW,A3fsA9Zfv1X2fVEQhTw51lKENdNrEqT3,1,0,0,0,0,0,1,0,1,0.14285714285714285,1,0.0,0,0,0,0,0,0,0,1,0,0,1,1
13409,198297,bpXV0HZ9yixzCGyJdeSxqm4EvQYi9XKg,SpATywNh6bZuzm8s1ceuBUnMUAeoAHHw,2,0,0,0,0,0,3,0,3,0.42857142857142855,1,0.0,0,0,0,0,0,0,0,3,0,0,3,1
13410,198303,qzSOzKpDnUaSHLwAqVpSpGcUMfaOhDjD,G8EPVSXsOYB5YQWZGiz1aVq5Pgr2GrQu,5,2,1,0,1,0,2,0,6,0.8571428571428571,1,0.0,0,1,0,1,2,0,0,2,0,2,4,1
13411,198310,Cgmx3Ujcxc92HHP4N1UU0TjRl5xBcyRy,A3fsA9Zfv1X2fVEQhTw51lKENdNrEqT3,8,5,3,0,3,0,1,0,12,1.7142857142857142,1,0.0,1,3,0,3,4,0,0,1,0,7,5,1
13412,198312,nrvDpyOlV5T6ZU5wiBAqPXpBwJOtawqO,bWdj2GDclj5ofokWjzoa5jAwMkxCykd6,9,9,3,0,2,6,7,4,31,4.428571428571429,1,0.0,1,3,0,2,8,6,0,7,4,6,25,1
13413,198314,d6GKFo7VpAwS4H9iF45HPuBB7oVkM6uC,SpATywNh6bZuzm8s1ceuBUnMUAeoAHHw,10,8,3,16,2,0,2,0,31,4.428571428571429,1,0.0,4,3,13,2,4,0,3,2,0,22,9,1
13414,198319,hM78zuTWvc2c2WdiFwwJZnLKCiMEzZwE,RXDvfPUBYFlVdlueBFbLW0mhhAyGEqpt,5,4,3,0,2,0,1,0,10,1.4285714285714286,1,0.0,0,3,0,2,4,0,0,1,0,5,5,1
13415,198322,ZdxnlwASEXds7VOuv4UniogqFzAjU71x,G8EPVSXsOYB5YQWZGiz1aVq5Pgr2GrQu,4,0,0,0,0,1,3,0,4,0.5714285714285714,1,0.0,0,0,0,0,0,1,0,3,0,0,4,1
13416,198342,X3X3klM03RXeGUjty93sg2SlkZrg3xpQ,SpATywNh6bZuzm8s1ceuBUnMUAeoAHHw,1,0,0,0,0,0,1,0,1,0.14285714285714285,1,0.0,0,0,0,0,0,0,0,1,0,0,1,1
13417,198343,7XiYdmZTSPhaWzjUuGCUAw2ynyRrmxfl,SpATywNh6bZuzm8s1ceuBUnMUAeoAHHw,8,12,4,0,2,3,2,0,23,3.2857142857142856,1,0.0,6,4,0,2,6,3,0,2,0,12,11,1
13418,198344,walE7JsvJqHl8yLz0PR8Oim32Lz4OIQ0,A3fsA9Zfv1X2fVEQhTw51lKENdNrEqT3,1,0,0,0,0,0,1,0,1,0.14285714285714285,1,0.0,0,0,0,0,0,0,0,1,0,0,1,1
13419,198353,ByX3sCZWzA6bGb4zKqYogAA175eLOyAG,SpATywNh6bZuzm8s1ceuBUnMUAeoAHHw,11,8,6,2,3,0,1,0,20,2.857142857142857,1,0.0,1,6,2,3,7,0,0,1,0,12,8,1
13420,198372,hl3CIQ0lpvTB8gq9L7ARkQJG7PfzlcBL,RXDvfPUBYFlVdlueBFbLW0mhhAyGEqpt,1,0,0,0,0,0,1,0,1,0.14285714285714285,1,0.0,0,0,0,0,0,0,0,1,0,0,1,1
13421,198374,5fiIK7VmqPKr4nf6AwCLv5FpXOs8AmIF,A3fsA9Zfv1X2fVEQhTw51lKENdNrEqT3,4,2,1,0,1,0,2,0,6,0.8571428571428571,1,0.0,0,1,0,1,2,0,0,2,0,2,4,1
13422,198378,xsoPQiWD0DInR2Sgur0NcgW3AIl7NeY0,SpATywNh6bZuzm8s1ceuBUnMUAeoAHHw,5,3,1,0,1,0,2,0,7,1.0,1,0.0,0,1,0,1,3,0,0,2,0,2,5,1
13423,198379,dgFOOUSNfQK8xIrT47Av0Q04bBFeE21W,A3fsA9Zfv1X2fVEQhTw51lKENdNrEqT3,7,3,2,0,2,0,3,0,10,1.4285714285714286,1,0.0,0,2,0,2,3,0,0,3,0,4,6,0
13424,198388,zum8lmwUciqBOjRcsKypiYs2OlSb1h15,A3fsA9Zfv1X2fVEQhTw51lKENdNrEqT3,9,6,1,0,1,0,4,0,12,1.7142857142857142,1,0.0,0,1,0,1,6,0,0,4,0,2,10,0
13425,198398,83TQNbmBQ9BH29WB1QIy1fMhXfCV72jv,A3fsA9Zfv1X2fVEQhTw51lKENdNrEqT3,1,0,0,0,0,0,1,0,1,0.14285714285714285,1,0.0,0,0,0,0,0,0,0,1,0,0,1,1
13426,198400,C23sTQ3IqWj72FdxhbjBadlgfhNvNhLt,bWdj2GDclj5ofokWjzoa5jAwMkxCykd6,4,2,1,0,0,0,2,0,5,0.7142857142857143,1,0.0,0,1,0,0,2,0,0,2,0,1,4,1
13427,198403,Dq2cCGdJlkpRnI9Tq5kE4JyzjGIGvpDz,A3fsA9Zfv1X2fVEQhTw51lKENdNrEqT3,9,5,3,0,3,0,4,0,15,2.142857142857143,1,0.0,0,3,0,3,5,0,0,4,0,6,9,1
13428,198404,hrPjKcL9rUfM1fnC8qta4lu2HmlsBLv6,A3fsA9Zfv1X2fVEQhTw51lKENdNrEqT3,12,6,5,0,5,0,1,0,17,2.4285714285714284,1,0.0,0,5,0,5,6,0,0,1,0,10,7,1
13429,198410,Kkww4jmevg0ZHJyNJmjfSGoxXiVH3qc9,SpATywNh6bZuzm8s1ceuBUnMUAeoAHHw,5,2,1,0,1,3,3,0,10,1.4285714285714286,1,0.0,0,1,0,1,2,3,0,3,0,2,8,1
13430,198411,6dJBpGT7qNr0NTuZjVXnITeb9R9DQeyE,SpATywNh6bZuzm8s1ceuBUnMUAeoAHHw,2,0,0,0,0,0,2,0,2,0.2857142857142857,1,0.0,0,0,0,0,0,0,0,2,0,0,2,1
13431,198416,KhKCxhPBpm8wuQfuIb6HFYBHnnvZJlex,RXDvfPUBYFlVdlueBFbLW0mhhAyGEqpt,1,0,0,0,0,0,1,0,1,0.14285714285714285,1,0.0,0,0,0,0,0,0,0,1,0,0,1,1
13432,198417,2uLHED4iY9VmLy5RW7Mfy2sLsR8ze3u7,RXDvfPUBYFlVdlueBFbLW0mhhAyGEqpt,1,0,0,0,0,0,1,0,1,0.14285714285714285,1,0.0,0,0,0,0,0,0,0,1,0,0,1,1
13433,198429,Fm0KmurJVBFEZiRcw3nlgAYLTArGnQaR,SpATywNh6bZuzm8s1ceuBUnMUAeoAHHw,16,30,1,14,1,20,14,4,84,12.0,1,0.0,7,1,12,1,23,20,2,14,4,21,63,1
13434,198446,P4gIdHzF607L8e8VPH3Qb09lxgNZRJFa,SpATywNh6bZuzm8s1ceuBUnMUAeoAHHw,4,3,0,0,0,0,1,0,4,0.5714285714285714,1,0.0,0,0,0,0,3,0,0,1,0,0,4,0
13435,198448,brW82YOCdOnTyLjpAh6QOg0ROSIhJ2Rz,A3fsA9Zfv1X2fVEQhTw51lKENdNrEqT3,2,0,0,0,0,0,3,0,3,0.42857142857142855,1,0.0,0,0,0,0,0,0,0,3,0,0,3,1
13436,198449,ncZpzPYvUtQjJgcrnY99CiTzo4JQVsl8,SpATywNh6bZuzm8s1ceuBUnMUAeoAHHw,4,2,0,0,0,0,2,0,4,0.5714285714285714,1,0.0,0,0,0,0,2,0,0,2,0,0,4,1
13437,198454,MqwnKklVqrb7jfevVzyfhGQMDPOkys7S,A3fsA9Zfv1X2fVEQhTw51lKENdNrEqT3,6,2,0,0,0,1,7,1,11,1.5714285714285714,1,0.0,0,0,0,0,2,1,0,7,1,0,11,1
13438,198475,Wq2ch7EEtsSKF9Vm0sUqWsaIHScTXudA,SpATywNh6bZuzm8s1ceuBUnMUAeoAHHw,4,2,1,0,1,0,1,0,5,0.7142857142857143,1,0.0,0,1,0,1,2,0,0,1,0,2,3,1
13439,198479,zHNYns4eYsvaD0PCrPbR7JoIqflHxrEv,A3fsA9Zfv1X2fVEQhTw51lKENdNrEqT3,1,0,0,0,0,0,1,0,1,0.14285714285714285,1,0.0,0,0,0,0,0,0,0,1,0,0,1,1
13440,198486,jHa0rWGu66mtR6qdZK3honEGURZjLRQo,SpATywNh6bZuzm8s1ceuBUnMUAeoAHHw,4,4,3,0,3,0,1,0,11,1.5714285714285714,1,0.0,0,3,0,3,4,0,0,1,0,6,5,0
13441,198492,SZnZ9mw8U8WzrYPDnWgxJCTIBCqTF6rB,SpATywNh6bZuzm8s1ceuBUnMUAeoAHHw,2,0,0,0,0,0,2,0,2,0.2857142857142857,1,0.0,0,0,0,0,0,0,0,2,0,0,2,1
13442,198495,OO2Ag6HEFKkZRtZuzzt1ya8SiL4BLCOC,RXDvfPUBYFlVdlueBFbLW0mhhAyGEqpt,1,0,0,0,0,0,1,0,1,0.14285714285714285,1,0.0,0,0,0,0,0,0,0,1,0,0,1,1
13443,198496,byyujsciSYId0rQQrEakxEnXcWLiLPay,SpATywNh6bZuzm8s1ceuBUnMUAeoAHHw,10,9,1,0,1,1,9,1,22,3.142857142857143,1,0.0,0,1,0,1,9,1,0,9,1,2,20,1
13444,198497,AfmdKPTL0IbcupndNMlY5c7PImPraChY,A3fsA9Zfv1X2fVEQhTw51lKENdNrEqT3,13,7,5,0,5,0,1,0,18,2.5714285714285716,1,0.0,0,5,0,5,7,0,0,1,0,10,8,1
13445,198500,dN2hlyHLZZp4dyg60YxnWe6xCUBAX5se,bWdj2GDclj5ofokWjzoa5jAwMkxCykd6,4,3,1,0,1,0,2,0,7,1.0,1,0.0,0,1,0,1,3,0,0,2,0,2,5,1
13446,198501,EwaALzeaojV7pPZOsHFx7jzB7xjVDGvQ,bWdj2GDclj5ofokWjzoa5jAwMkxCykd6,8,4,0,14,0,1,3,1,23,3.2857142857142856,1,0.0,1,0,14,0,3,1,0,3,1,15,8,1
13447,198503,F16OuTgaH1ZbsvG4bVnrHtSG2xmdMXNR,A3fsA9Zfv1X2fVEQhTw51lKENdNrEqT3,7,5,2,0,2,0,2,1,12,1.7142857142857142,1,0.0,0,2,0,2,5,0,0,2,1,4,8,1
13448,198506,sVvZPZ3GVHWR4Hg1FcQf4FWks0TLCNOR,A3fsA9Zfv1X2fVEQhTw51lKENdNrEqT3,14,7,5,0,3,1,8,1,25,3.5714285714285716,1,0.0,0,5,0,3,7,1,0,8,1,8,17,1
13449,198517,xIuD143aD9LhLXzAc6byVmIGYF4SpJsZ,A3fsA9Zfv1X2fVEQhTw51lKENdNrEqT3,1,0,0,0,0,0,1,0,1,0.14285714285714285,1,0.0,0,0,0,0,0,0,0,1,0,0,1,1
13450,198518,eEUIScknc9SimnLuPMm5Vf07ulWcWd92,A3fsA9Zfv1X2fVEQhTw51lKENdNrEqT3,1,0,0,0,0,0,1,0,1,0.14285714285714285,1,0.0,0,0,0,0,0,0,0,1,0,0,1,1
13451,198529,eBQTzPv3v3TV7mZrXSw0RrOHTLWkqz5k,bWdj2GDclj5ofokWjzoa5jAwMkxCykd6,7,4,2,0,2,0,2,0,10,1.4285714285714286,1,0.0,1,2,0,2,3,0,0,2,0,5,5,1
13452,198539,w7s7CbDlE2P2RGY2w8kEYH9keSavEsec,bWdj2GDclj5ofokWjzoa5jAwMkxCykd6,2,0,0,0,0,0,2,0,2,0.2857142857142857,1,0.0,0,0,0,0,0,0,0,2,0,0,2,1
13453,198547,2kSwVlbsGRMwb7boxmMBKvNiRXYYeI1Y,SpATywNh6bZuzm8s1ceuBUnMUAeoAHHw,2,0,0,0,0,0,2,0,2,0.2857142857142857,1,0.0,0,0,0,0,0,0,0,2,0,0,2,1
13454,198550,dYWKoJoBpKPEwdcqoTPZCoTIyvG7V1Tu,A3fsA9Zfv1X2fVEQhTw51lKENdNrEqT3,6,3,1,0,1,6,5,0,16,2.2857142857142856,1,0.0,0,1,0,1,3,6,0,5,0,2,14,1
13455,198555,s37SmpVU3dTE3yD2mQmjjcBs0sjjoAwz,SpATywNh6bZuzm8s1ceuBUnMUAeoAHHw,15,28,0,18,0,4,8,3,61,8.714285714285714,1,0.0,18,0,17,0,10,4,1,8,3,35,26,1
13456,198560,b0mgWZqNzMdtJFxZULQczG8Tc3XpTILP,bWdj2GDclj5ofokWjzoa5jAwMkxCykd6,9,6,3,2,3,0,1,0,15,2.142857142857143,1,0.0,2,3,2,3,4,0,0,1,0,10,5,0
13457,198562,dYWKoJoBpKPEwdcqoTPZCoTIyvG7V1Tu,bWdj2GDclj5ofokWjzoa5jAwMkxCykd6,7,5,2,0,2,0,1,0,10,1.4285714285714286,1,0.0,0,2,0,2,5,0,0,1,0,4,6,1
13458,198566,zhF9aamFaaPbw8uvKpkg1m1HOa3rg91T,A3fsA9Zfv1X2fVEQhTw51lKENdNrEqT3,18,9,8,0,8,0,1,0,26,3.7142857142857144,1,0.0,0,8,0,8,9,0,0,1,0,16,10,1
13459,198567,4GJSwwikGuUWXSajcKoSlvfsoiC8eEZq,A3fsA9Zfv1X2fVEQhTw51lKENdNrEqT3,12,16,14,0,0,0,4,0,34,4.857142857142857,1,0.0,0,14,0,0,16,0,0,4,0,14,20,1
13460,198575,IR9p9WuPGPaaA4f6RkgkUYRRmOTg8aPE,SpATywNh6bZuzm8s1ceuBUnMUAeoAHHw,1,0,0,0,0,0,1,0,1,0.14285714285714285,1,0.0,0,0,0,0,0,0,0,1,0,0,1,1
13461,198576,M75L90OOMTV1kEiI3n7vM0ty47YBFna9,A3fsA9Zfv1X2fVEQhTw51lKENdNrEqT3,5,7,1,0,1,0,2,0,11,1.5714285714285714,1,0.0,0,1,0,1,7,0,0,2,0,2,9,1
13462,198577,QXph4cOoRqm5422pzQXvVGuiJ0zPyE5f,SpATywNh6bZuzm8s1ceuBUnMUAeoAHHw,7,4,3,0,3,0,2,0,12,1.7142857142857142,1,0.0,0,3,0,3,4,0,0,2,0,6,6,1
13463,198580,iJRgFwBj3cEAZI5JrvtGnB3yvPVZ5Cdq,bWdj2GDclj5ofokWjzoa5jAwMkxCykd6,8,2,2,0,2,0,3,0,9,1.2857142857142858,1,0.0,0,2,0,2,2,0,0,3,0,4,5,1
13464,198581,W5wwRspxUk4ZCYBlSnCmonKbHdsPqzQn,SpATywNh6bZuzm8s1ceuBUnMUAeoAHHw,2,0,0,0,0,0,2,0,2,0.2857142857142857,1,0.0,0,0,0,0,0,0,0,2,0,0,2,1
13465,198584,0q3P6YGkZ2dxtBIeVbo5DKpZyIRZVZAM,A3fsA9Zfv1X2fVEQhTw51lKENdNrEqT3,1,0,0,0,0,0,1,0,1,0.14285714285714285,1,0.0,0,0,0,0,0,0,0,1,0,0,1,1
13466,198596,ZfjfwFl0JPdJif1Zgl3u0FEb4C4l2Zxn,A3fsA9Zfv1X2fVEQhTw51lKENdNrEqT3,8,4,2,0,3,0,1,0,10,1.4285714285714286,1,0.0,0,2,0,3,4,0,0,1,0,5,5,1
13467,198603,fsydotVTfs3IO9vO0Vkp2xRbb1WB0CCz,SpATywNh6bZuzm8s1ceuBUnMUAeoAHHw,8,3,1,0,1,0,7,1,13,1.8571428571428572,1,0.0,0,1,0,1,3,0,0,7,1,2,11,1
13468,198605,pnnKMIXc9aatMHlNextjL8MoSsu3IuzR,SpATywNh6bZuzm8s1ceuBUnMUAeoAHHw,5,2,1,0,1,0,2,0,6,0.8571428571428571,1,0.0,0,1,0,1,2,0,0,2,0,2,4,1
13469,198637,CUEyHbsjLlbX6I7tsbnNjxFI1v5Lj4iD,bWdj2GDclj5ofokWjzoa5jAwMkxCykd6,5,2,1,0,1,0,2,0,6,0.8571428571428571,1,0.0,0,1,0,1,2,0,0,2,0,2,4,1
13470,198643,6lxqO6gucEPo0iFbRZ4Psmditgm2GZdr,SpATywNh6bZuzm8s1ceuBUnMUAeoAHHw,10,7,4,6,0,0,3,0,20,2.857142857142857,1,0.0,2,4,6,0,5,0,0,3,0,12,8,1
13471,198646,iCEb35gaygczCVXBPDGlI3sXrSsDaVej,bWdj2GDclj5ofokWjzoa5jAwMkxCykd6,1,0,0,0,0,0,2,0,2,0.2857142857142857,1,0.0,0,0,0,0,0,0,0,2,0,0,2,1
13472,198656,mXfwwTIVjHMqoVKAh2iEQbinKUCJHwTp,A3fsA9Zfv1X2fVEQhTw51lKENdNrEqT3,8,6,3,0,2,0,8,0,19,2.7142857142857144,1,0.0,0,3,0,2,6,0,0,8,0,5,14,1
13473,198671,34cVbMGyVO1SqQjOK9RNk00q4uKA3nIE,SpATywNh6bZuzm8s1ceuBUnMUAeoAHHw,5,2,1,0,1,0,2,0,6,0.8571428571428571,1,0.0,0,1,0,1,2,0,0,2,0,2,4,1
13474,198676,8OMQVFIkmUspkJuyYp0KATDRhux0sdCZ,A3fsA9Zfv1X2fVEQhTw51lKENdNrEqT3,5,0,0,0,0,1,5,1,7,1.0,1,0.0,0,0,0,0,0,1,0,5,1,0,7,1
13475,198682,O1JCj9IRlzuPnXGSMFH3o6nPheXmI0dk,A3fsA9Zfv1X2fVEQhTw51lKENdNrEqT3,5,2,0,0,0,0,3,1,6,0.8571428571428571,1,0.0,0,0,0,0,2,0,0,3,1,0,6,1
13476,198700,iJRgFwBj3cEAZI5JrvtGnB3yvPVZ5Cdq,A3fsA9Zfv1X2fVEQhTw51lKENdNrEqT3,6,1,1,0,1,0,3,0,6,0.8571428571428571,1,0.0,0,1,0,1,1,0,0,3,0,2,4,1
13477,198709,JlndvP2EuIlwJAySHuL6QfQBf6i8elGn,G8EPVSXsOYB5YQWZGiz1aVq5Pgr2GrQu,2,0,0,0,0,0,2,0,2,0.2857142857142857,1,0.0,0,0,0,0,0,0,0,2,0,0,2,1
13478,198711,5Lnagj9S1Vv0G8cjSfxcxK2ro2WrQMdB,G8EPVSXsOYB5YQWZGiz1aVq5Pgr2GrQu,4,2,0,0,0,0,5,0,7,1.0,1,0.0,0,0,0,0,2,0,0,5,0,0,7,1
13479,198722,ITvb0EWV8ZZ88RI4SBwUoVbHLyVcwZRP,A3fsA9Zfv1X2fVEQhTw51lKENdNrEqT3,13,12,1,0,0,0,2,0,15,2.142857142857143,1,0.0,0,1,0,0,12,0,0,2,0,1,14,1
13480,198734,QCY6rb7yvcagouaf25uIFV9RWdPPOb7l,SpATywNh6bZuzm8s1ceuBUnMUAeoAHHw,5,4,0,0,0,0,1,0,5,0.7142857142857143,1,0.0,0,0,0,0,4,0,0,1,0,0,5,1
13481,198739,QvUtN7NvmMmWACtjGZbRh5vUGOqoadOI,SpATywNh6bZuzm8s1ceuBUnMUAeoAHHw,1,0,0,0,0,0,1,0,1,0.14285714285714285,1,0.0,0,0,0,0,0,0,0,1,0,0,1,1
13482,198740,ilMjmMVbiUSUOOjXRXyXhngOcMKQcGhx,G8EPVSXsOYB5YQWZGiz1aVq5Pgr2GrQu,2,0,0,0,0,0,2,0,2,0.2857142857142857,1,0.0,0,0,0,0,0,0,0,2,0,0,2,1
13483,198747,ScmiDI5AINzZbjcs2bWNBHbp8udIsqgh,SpATywNh6bZuzm8s1ceuBUnMUAeoAHHw,7,7,2,0,1,0,3,0,13,1.8571428571428572,1,0.0,0,2,0,1,7,0,0,3,0,3,10,1
13484,198755,l99Zcol89MEEF7ym4ZK8FY1ESaelZnlP,A3fsA9Zfv1X2fVEQhTw51lKENdNrEqT3,8,5,4,0,4,0,1,0,14,2.0,1,0.0,0,4,0,4,5,0,0,1,0,8,6,0
13485,198761,ONe4iInwtHkZ5gtlbWN831JopVHbaD8L,SpATywNh6bZuzm8s1ceuBUnMUAeoAHHw,3,0,0,0,0,2,5,0,7,1.0,1,0.0,0,0,0,0,0,2,0,5,0,0,7,1
13486,198769,XduGpggqMznFnxTLbAhFUOyKgFLNMc8n,SpATywNh6bZuzm8s1ceuBUnMUAeoAHHw,4,2,1,0,1,0,1,0,5,0.7142857142857143,1,0.0,0,1,0,1,2,0,0,1,0,2,3,1
13487,198792,g1dFQ3mnVnBiIhnsU4zqK21biH9l5lF9,A3fsA9Zfv1X2fVEQhTw51lKENdNrEqT3,1,0,0,0,0,0,1,0,1,0.14285714285714285,1,0.0,0,0,0,0,0,0,0,1,0,0,1,1
13488,198793,QrIpd1N2l4iqQkNACgUM7iTDn2RZjb2Z,A3fsA9Zfv1X2fVEQhTw51lKENdNrEqT3,1,0,0,0,0,0,1,0,1,0.14285714285714285,1,0.0,0,0,0,0,0,0,0,1,0,0,1,1
13489,198807,FrcNdFNfLYMOg5fdBzjs15qKbgtHEYZH,A3fsA9Zfv1X2fVEQhTw51lKENdNrEqT3,5,2,1,0,1,0,2,0,6,0.8571428571428571,1,0.0,0,1,0,1,2,0,0,2,0,2,4,0
13490,198812,DxsFVZh699mkeWBLgWLRdSxOs5e2KIgS,SpATywNh6bZuzm8s1ceuBUnMUAeoAHHw,11,8,4,0,2,3,7,1,25,3.5714285714285716,1,0.0,2,4,0,2,6,3,0,7,1,8,17,1
13491,198820,chD7Ekz0CCeTW4cvhA1an0KXokkNIvTf,SpATywNh6bZuzm8s1ceuBUnMUAeoAHHw,1,0,0,0,0,0,1,0,1,0.14285714285714285,1,0.0,0,0,0,0,0,0,0,1,0,0,1,1
13492,198822,uZbzvdzFyR1ceRxI8f80IsSKw8Wzuev1,SpATywNh6bZuzm8s1ceuBUnMUAeoAHHw,7,7,1,0,1,0,2,0,11,1.5714285714285714,1,0.0,0,1,0,1,7,0,0,2,0,2,9,0
13493,198823,2ENDZhPlfPQ7xqwHjrfLuuWg5Duw7ZBj,G8EPVSXsOYB5YQWZGiz1aVq5Pgr2GrQu,4,4,1,0,1,0,1,0,7,1.0,1,0.0,1,1,0,1,3,0,0,1,0,3,4,1
13494,198832,PKdKWqW1VQJFocRWfF0D5fFjfdW8ENqW,SpATywNh6bZuzm8s1ceuBUnMUAeoAHHw,2,0,0,0,0,0,2,0,2,0.2857142857142857,1,0.0,0,0,0,0,0,0,0,2,0,0,2,1
13495,198844,9xn3imvdiJkc9HcKhWV1Hhylco4OVjiR,SpATywNh6bZuzm8s1ceuBUnMUAeoAHHw,2,0,0,0,0,0,2,0,2,0.2857142857142857,1,0.0,0,0,0,0,0,0,0,2,0,0,2,1
13496,198849,9xn3imvdiJkc9HcKhWV1Hhylco4OVjiR,G8EPVSXsOYB5YQWZGiz1aVq5Pgr2GrQu,7,13,0,0,0,0,4,0,17,2.4285714285714284,1,0.0,1,0,0,0,12,0,0,4,0,1,16,1
13497,198863,ZWKBU7cFyL8Xqx9wqUlqIH5ujAlqP1xm,A3fsA9Zfv1X2fVEQhTw51lKENdNrEqT3,8,7,3,0,2,0,3,0,15,2.142857142857143,1,0.0,0,3,0,2,7,0,0,3,0,5,10,1
13498,198865,AUCcjgWVaeHbyOo7n1ZoCM3NX1aTzthI,G8EPVSXsOYB5YQWZGiz1aVq5Pgr2GrQu,7,4,0,0,0,0,5,0,9,1.2857142857142858,1,0.0,0,0,0,0,4,0,0,5,0,0,9,1
13499,198866,cGujrM5GGnHFlTqKFoeVE54jkUOVyngH,A3fsA9Zfv1X2fVEQhTw51lKENdNrEqT3,1,0,0,0,0,0,1,0,1,0.14285714285714285,1,0.0,0,0,0,0,0,0,0,1,0,0,1,1
13500,198868,rlQIqtgsDfEVihltHvVH3EnaOkFIJWY2,A3fsA9Zfv1X2fVEQhTw51lKENdNrEqT3,1,0,0,0,0,0,1,0,1,0.14285714285714285,1,0.0,0,0,0,0,0,0,0,1,0,0,1,1
13501,198869,TSm2R7cUPaXhbTrj1LddmwVL7dduRSSa,A3fsA9Zfv1X2fVEQhTw51lKENdNrEqT3,8,3,2,0,2,8,6,1,22,3.142857142857143,1,0.0,0,2,0,2,3,8,0,6,1,4,18,1
13502,198870,3Ayux0uPJ6ML3SyziM62LSRrG0V1OgIm,SpATywNh6bZuzm8s1ceuBUnMUAeoAHHw,17,18,11,10,6,1,6,1,53,7.571428571428571,1,0.0,5,11,9,6,13,1,1,6,1,31,22,1
13503,198874,JdraUX9nFc2Y8K2LiincPu5HyHjoquI8,A3fsA9Zfv1X2fVEQhTw51lKENdNrEqT3,8,6,0,0,0,1,10,1,18,2.5714285714285716,1,0.0,3,0,0,0,3,1,0,10,1,3,15,1
13504,198894,nKVAY2GHYnzf4BfG261ddlVdtqvsIA9B,A3fsA9Zfv1X2fVEQhTw51lKENdNrEqT3,6,4,2,0,2,0,1,0,9,1.2857142857142858,1,0.0,0,2,0,2,4,0,0,1,0,4,5,1
13505,198899,ctoSfpAfvm3av2aqkT0D3Yq8icDxZKCx,A3fsA9Zfv1X2fVEQhTw51lKENdNrEqT3,1,0,0,0,0,0,1,0,1,0.14285714285714285,1,0.0,0,0,0,0,0,0,0,1,0,0,1,1
13506,198902,pSRqXJrhW3cpcIMqshrNJY13lAR5UPwX,G8EPVSXsOYB5YQWZGiz1aVq5Pgr2GrQu,2,0,0,0,0,0,2,0,2,0.2857142857142857,1,0.0,0,0,0,0,0,0,0,2,0,0,2,1
13507,198903,iUqEEHE7KFlYvrJ9lttneq6sdDOxoE0o,SpATywNh6bZuzm8s1ceuBUnMUAeoAHHw,1,0,0,0,0,0,1,0,1,0.14285714285714285,1,0.0,0,0,0,0,0,0,0,1,0,0,1,0
13508,198910,pSRqXJrhW3cpcIMqshrNJY13lAR5UPwX,A3fsA9Zfv1X2fVEQhTw51lKENdNrEqT3,2,0,0,0,0,0,2,0,2,0.2857142857142857,1,0.0,0,0,0,0,0,0,0,2,0,0,2,1
13509,198915,5RFNEnBqW8mdktbwEzjZ2lPhm72vzWhr,SpATywNh6bZuzm8s1ceuBUnMUAeoAHHw,8,4,3,0,2,0,2,0,11,1.5714285714285714,1,0.0,0,3,0,2,4,0,0,2,0,5,6,1
13510,198936,QO42SHgXwWqLSSYHUVMAX8sjMgYnpZEl,G8EPVSXsOYB5YQWZGiz1aVq5Pgr2GrQu,7,3,2,0,2,0,2,0,9,1.2857142857142858,1,0.0,0,2,0,2,3,0,0,2,0,4,5,1
13511,198955,25eiJkNBguZOcrPXS1ZGiSW1nfaRn05c,SpATywNh6bZuzm8s1ceuBUnMUAeoAHHw,7,3,2,0,2,0,2,0,9,1.2857142857142858,1,0.0,0,2,0,2,3,0,0,2,0,4,5,1
13512,198956,GyLB5V57I2KbnfFgZclSqyQAUY6eRpjt,A3fsA9Zfv1X2fVEQhTw51lKENdNrEqT3,2,0,0,0,0,0,2,0,2,0.2857142857142857,1,0.0,0,0,0,0,0,0,0,2,0,0,2,1
13513,198963,WAnB7c5F1PHHqCCd4HzBf0vmVEoM8DG4,SpATywNh6bZuzm8s1ceuBUnMUAeoAHHw,6,3,0,0,0,2,6,0,11,1.5714285714285714,1,0.0,0,0,0,0,3,2,0,6,0,0,11,1
13514,198965,9og5l3kBrvNmeUS7WEJnLIW5U5JOFnlr,SpATywNh6bZuzm8s1ceuBUnMUAeoAHHw,5,1,1,0,1,0,2,0,5,0.7142857142857143,1,0.0,0,1,0,1,1,0,0,2,0,2,3,1
13515,198975,2oTvbzieHn2y5oozeOgSnruqE6N0BtR5,bWdj2GDclj5ofokWjzoa5jAwMkxCykd6,11,11,6,0,5,7,4,0,33,4.714285714285714,1,0.0,2,6,0,5,9,7,0,4,0,13,20,1
13516,198976,qJSVGIIBKQpzllCeTCwG3pgdEZIo3QRz,bWdj2GDclj5ofokWjzoa5jAwMkxCykd6,1,0,0,0,0,0,1,0,1,0.14285714285714285,1,0.0,0,0,0,0,0,0,0,1,0,0,1,1
13517,198979,U5aocuOsbgg0bKahFwFd1In2DcDc3oBc,G8EPVSXsOYB5YQWZGiz1aVq5Pgr2GrQu,7,5,2,0,2,0,2,0,11,1.5714285714285714,1,0.0,0,2,0,2,5,0,0,2,0,4,7,1
13518,198991,mSWRBlOsrbB7GjQNoTuNmuW3YOy77l6X,bWdj2GDclj5ofokWjzoa5jAwMkxCykd6,1,0,0,0,0,0,1,0,1,0.14285714285714285,1,0.0,0,0,0,0,0,0,0,1,0,0,1,1
13519,198993,mSWRBlOsrbB7GjQNoTuNmuW3YOy77l6X,A3fsA9Zfv1X2fVEQhTw51lKENdNrEqT3,1,0,0,0,0,0,1,0,1,0.14285714285714285,1,0.0,0,0,0,0,0,0,0,1,0,0,1,1
13520,199000,4UScXtt088oGe9dJ2KJws6faWfnlaEO8,G8EPVSXsOYB5YQWZGiz1aVq5Pgr2GrQu,8,12,0,0,0,0,4,0,16,2.2857142857142856,1,0.0,0,0,0,0,12,0,0,4,0,0,16,1
13521,199004,wB1zTvSxiuMnQ6mG62KhRDH75H6JzCKK,G8EPVSXsOYB5YQWZGiz1aVq5Pgr2GrQu,1,0,0,0,0,0,1,0,1,0.14285714285714285,1,0.0,0,0,0,0,0,0,0,1,0,0,1,1
13522,199009,UoLm4A2shVKJTBQjYq1cnhy9CVAb6BPB,SpATywNh6bZuzm8s1ceuBUnMUAeoAHHw,1,0,0,0,0,0,2,0,2,0.2857142857142857,1,0.0,0,0,0,0,0,0,0,2,0,0,2,1
13523,199016,C4ciI1Hxrse5ND4h1rvhsDGjFinNO7RJ,bWdj2GDclj5ofokWjzoa5jAwMkxCykd6,8,9,1,0,1,1,10,5,27,3.857142857142857,1,0.0,5,1,0,1,4,1,0,10,5,7,20,1
13524,199018,YQQ0U1ySGhxQGw2MpzkqAJru8VuefP0L,bWdj2GDclj5ofokWjzoa5jAwMkxCykd6,4,5,2,0,0,0,2,0,9,1.2857142857142858,1,0.0,2,2,0,0,3,0,0,2,0,4,5,1
13525,199029,cderIDaWBR3ykedbqXoG7yh75mThXkpL,bWdj2GDclj5ofokWjzoa5jAwMkxCykd6,1,0,0,0,0,0,1,0,1,0.14285714285714285,1,0.0,0,0,0,0,0,0,0,1,0,0,1,1
13526,199032,aTQ4Ypzwh1rImg9ZYH1ng3j22ZvxNJg3,SpATywNh6bZuzm8s1ceuBUnMUAeoAHHw,1,0,0,0,0,0,1,0,1,0.14285714285714285,1,0.0,0,0,0,0,0,0,0,1,0,0,1,1
13527,199036,Cj6qzoa736NxMqt5KsDr9YuISfsEJCrb,SpATywNh6bZuzm8s1ceuBUnMUAeoAHHw,6,3,1,0,1,0,2,0,7,1.0,1,0.0,0,1,0,1,3,0,0,2,0,2,5,1
13528,199044,nmlYjXdaqWSjPWm2kQhmjZqjjBKhkQAm,bWdj2GDclj5ofokWjzoa5jAwMkxCykd6,6,3,2,0,2,1,4,1,13,1.8571428571428572,1,0.0,0,2,0,2,3,1,0,4,1,4,9,1
13529,199046,xcyypTvwSo3LXkXsaePEIK0Y1mo0nQoS,SpATywNh6bZuzm8s1ceuBUnMUAeoAHHw,13,15,8,4,3,0,2,0,32,4.571428571428571,1,0.0,6,8,4,3,9,0,0,2,0,21,11,1
13530,199049,Yer7ST1oiQQLYYgjANCmG1MBkWuTCohH,bWdj2GDclj5ofokWjzoa5jAwMkxCykd6,1,0,0,0,0,0,1,0,1,0.14285714285714285,1,0.0,0,0,0,0,0,0,0,1,0,0,1,1
13531,199051,uufXnXOfmStAymRAiMYAROVtj5hPlDvd,A3fsA9Zfv1X2fVEQhTw51lKENdNrEqT3,1,0,0,0,0,0,1,0,1,0.14285714285714285,1,0.0,0,0,0,0,0,0,0,1,0,0,1,1
13532,199056,OGCl7FuINJMmIPxVehaSeriK0obhKOqa,SpATywNh6bZuzm8s1ceuBUnMUAeoAHHw,8,6,4,0,3,0,1,0,14,2.0,1,0.0,0,4,0,3,6,0,0,1,0,7,7,1
13533,199057,AW3qB37tEUxBhbQEUxhofJkaUbKF4F7i,bWdj2GDclj5ofokWjzoa5jAwMkxCykd6,2,0,0,0,0,4,1,0,5,0.7142857142857143,1,0.0,0,0,0,0,0,4,0,1,0,0,5,1
13534,199058,VeLCqoeC0RO3eUOAMmBgbUdlxxqFnwbN,SpATywNh6bZuzm8s1ceuBUnMUAeoAHHw,4,4,0,0,0,0,2,0,6,0.8571428571428571,1,0.0,0,0,0,0,4,0,0,2,0,0,6,0
13535,199069,M45QNJ6951iGJajsprAeFVhHViiX50AV,A3fsA9Zfv1X2fVEQhTw51lKENdNrEqT3,22,12,10,0,9,5,5,1,42,6.0,1,0.0,0,10,0,9,12,5,0,5,1,19,23,1
13536,199078,pXGBcTffNYWAUeYw1RFCIuTgQsIvI4OJ,G8EPVSXsOYB5YQWZGiz1aVq5Pgr2GrQu,5,2,1,0,1,0,2,0,6,0.8571428571428571,1,0.0,0,1,0,1,2,0,0,2,0,2,4,0
13537,200157,CykijlBvrfCnopTb9AaXgis5gSkvGwzC,fbPkOYLVPtPgIt0MxizjfFJov3JbHyAi,7,1,1,0,1,1,7,1,12,1.7142857142857142,1,0.0,0,1,0,1,1,1,0,7,1,2,10,1
13538,200159,t9QYODxZ0thus7iFGBwx6fkPWEXFSW7S,fbPkOYLVPtPgIt0MxizjfFJov3JbHyAi,7,5,2,0,2,0,2,0,11,1.5714285714285714,1,0.0,0,2,0,2,5,0,0,2,0,4,7,1
13539,200162,dzURuE7IlCH80LFSI2yTw30zsMgWkp29,fbPkOYLVPtPgIt0MxizjfFJov3JbHyAi,6,2,0,0,0,0,8,0,10,1.4285714285714286,1,0.0,0,0,0,0,2,0,0,8,0,0,10,1
13540,200163,bNjBiMsX33gdPcYQXoqSFOjUJgLcFbHE,fbPkOYLVPtPgIt0MxizjfFJov3JbHyAi,7,4,2,0,2,0,6,0,14,2.0,1,0.0,1,2,0,2,3,0,0,6,0,5,9,1
13541,200165,SwWiPD24oHM8AndfY3AAAjHvKl9MggTk,fbPkOYLVPtPgIt0MxizjfFJov3JbHyAi,2,0,0,0,0,0,2,0,2,0.2857142857142857,1,0.0,0,0,0,0,0,0,0,2,0,0,2,1
13542,200166,Gv890Y8tWqdQL73srFfKZXsLtPUpIe2C,fbPkOYLVPtPgIt0MxizjfFJov3JbHyAi,8,3,1,0,1,0,5,0,10,1.4285714285714286,1,0.0,0,1,0,1,3,0,0,5,0,2,8,1
13543,200169,LiyIa3B6QhI7xyW0IVAj2eKqmqAeHza7,fbPkOYLVPtPgIt0MxizjfFJov3JbHyAi,10,3,2,0,2,0,8,1,16,2.2857142857142856,1,0.0,0,2,0,2,3,0,0,8,1,4,12,1
13544,200171,b42x9fEviD2KrosQFgO4BDKrSzPFH9d9,fbPkOYLVPtPgIt0MxizjfFJov3JbHyAi,29,29,13,20,15,3,9,1,90,12.857142857142858,1,0.0,14,13,15,15,15,3,5,9,1,57,33,1
13545,200173,uQYu0hHVc5jntgCyzuDA9TaZrd7lJp3t,fbPkOYLVPtPgIt0MxizjfFJov3JbHyAi,1,0,0,0,0,0,1,0,1,0.14285714285714285,1,0.0,0,0,0,0,0,0,0,1,0,0,1,1
13546,200175,D8LAFp7BvA55dAaLzF6AX6GIJkGB1HJQ,fbPkOYLVPtPgIt0MxizjfFJov3JbHyAi,1,0,0,0,0,0,1,0,1,0.14285714285714285,1,0.0,0,0,0,0,0,0,0,1,0,0,1,1
13547,200177,I463Z3P8xxMeNa2OIR0bwDIF8VjojVtU,fbPkOYLVPtPgIt0MxizjfFJov3JbHyAi,2,0,0,0,0,0,2,0,2,0.2857142857142857,1,0.0,0,0,0,0,0,0,0,2,0,0,2,1
13548,200178,kdbKnHrfUetCNFpkVPUjd1YS7pY3Y1xS,fbPkOYLVPtPgIt0MxizjfFJov3JbHyAi,7,4,3,0,3,0,2,0,12,1.7142857142857142,1,0.0,0,3,0,3,4,0,0,2,0,6,6,1
13549,200179,nONpoqUpw0PURu6ZnXs9gQtQMOWOg8ue,fbPkOYLVPtPgIt0MxizjfFJov3JbHyAi,7,3,2,0,2,0,2,0,9,1.2857142857142858,1,0.0,0,2,0,2,3,0,0,2,0,4,5,1
13550,200180,N1H6FHZ3dNzEs8oMwW9QQdJ6c3gTcjMQ,fbPkOYLVPtPgIt0MxizjfFJov3JbHyAi,1,0,0,0,0,0,1,0,1,0.14285714285714285,1,0.0,0,0,0,0,0,0,0,1,0,0,1,1
13551,200181,5AVv64HGNDPJGZDwAOSJQtcGvZuBdS1I,fbPkOYLVPtPgIt0MxizjfFJov3JbHyAi,1,0,0,0,0,0,1,0,1,0.14285714285714285,1,0.0,0,0,0,0,0,0,0,1,0,0,1,1
13552,200182,4TP43TWBhiZRfTTi5JD8xgUB7xZqttTW,fbPkOYLVPtPgIt0MxizjfFJov3JbHyAi,1,0,0,0,0,0,1,0,1,0.14285714285714285,1,0.0,0,0,0,0,0,0,0,1,0,0,1,1
